Id,Label,timeset,gen,type,weighted indegree,weighted outdegree,Weighted Degree
8_0,,,,2,2,1,3
C(C(CO)O)=O,,,1,1,319,370,689
8_1,,,,2,2,1,3
10_0,,,,2,2,1,3
C(C(C(CO)O)O)=O,,,1,1,76,70,146
10_1,,,,2,2,1,3
11_0,,,,2,1,1,2
C(CO)=O,,,0,1,972,1903,2875
14_0,,,,2,3,2,5
C(O)=O,,,1,1,4328,0,4328
CO,,,1,1,2622,259,2881
14_1,,,,2,3,2,5
16_0,,,,2,3,2,5
C(CO)O,,,1,1,9,91,100
18_0,,,,2,3,2,5
C(CO)(O)=O,,,1,1,138,277,415
20_0,,,,2,3,5,8
[H+],,,0,1,2046,1825,3871
[Fe+2],,,0,1,2458,2012,4470
C(C=O)=O,,,1,1,647,711,1358
21_0,,,,2,4,4,8
23_0,,,,2,2,1,3
C(C(C(C(CO)O)O)O)=O,,,2,1,22,23,45
23_1,,,,2,2,1,3
25_0,,,,2,2,1,3
C(C(C(C(C(CO)O)O)O)O)=O,,,2,1,16,19,35
25_1,,,,2,2,1,3
27_0,,,,2,2,1,3
C(C(C(C=O)O)O)=O,,,2,1,69,60,129
27_1,,,,2,2,1,3
28_0,,,,2,2,1,3
28_1,,,,2,2,1,3
29_0,,,,2,1,2,3
O,,,0,1,13922,10992,24914
30_0,,,,2,1,2,3
C=O,,,0,1,2050,10048,12098
30_1,,,,2,1,2,3
31_0,,,,2,1,2,3
31_1,,,,2,1,2,3
33_0,,,,2,1,1,2
C(CO)(CO)=O,,,2,1,243,339,582
35_0,,,,2,1,1,2
C(CO)(C(CO)O)=O,,,2,1,96,95,191
37_0,,,,2,3,2,5
C(C(CO)O)O,,,2,1,11,46,57
39_0,,,,2,3,2,5
C(C(C(CO)O)O)O,,,2,1,6,9,15
40_0,,,,2,3,2,5
42_0,,,,2,3,2,5
C(C(CO)O)(O)=O,,,2,1,69,103,172
44_0,,,,2,3,2,5
C(C(C(CO)O)O)(O)=O,,,2,1,19,23,42
46_0,,,,2,3,2,5
C(C(O)=O)=O,,,2,1,280,298,578
48_0,,,,2,2,1,3
C(C(CO)(C(C(CO)O)O)O)=O,,,2,1,14,16,30
48_1,,,,2,2,1,3
50_0,,,,2,2,1,3
C(C(CO)(C(C=O)O)O)=O,,,2,1,23,26,49
50_1,,,,2,2,1,3
52_0,,,,2,2,1,3
C(C(CO)(CO)O)=O,,,2,1,25,25,50
52_1,,,,2,2,1,3
54_0,,,,2,2,1,3
C(C(CO)(C(CO)O)O)=O,,,2,1,13,14,27
54_1,,,,2,2,1,3
56_0,,,,2,2,1,3
C(C(C(CO)O)(C(C=O)O)O)=O,,,2,1,16,22,38
56_1,,,,2,2,1,3
57_0,,,,2,2,1,3
57_1,,,,2,2,1,3
59_0,,,,2,2,1,3
C(C(C(CO)O)(C(CO)O)O)=O,,,2,1,7,9,16
59_1,,,,2,2,1,3
61_0,,,,2,2,1,3
C(C(C(C(CO)O)O)O)(O)=O,,,2,1,15,13,28
63_0,,,,2,2,1,3
C(C(C(C(C(CO)O)O)O)O)(O)=O,,,2,1,15,14,29
65_0,,,,2,2,1,3
C(C(C(C=O)O)O)(O)=O,,,2,1,39,43,82
66_0,,,,2,2,1,3
67_0,,,,2,2,1,3
69_0,,,,2,1,2,3
C(C(C)=O)=O,,,2,1,567,920,1487
71_0,,,,2,1,2,3
C(CC=O)=O,,,2,1,382,875,1257
73_0,,,,2,1,2,3
C(C(CCO)=O)=O,,,2,1,151,193,344
75_0,,,,2,1,2,3
C(CC(C=O)O)=O,,,2,1,188,234,422
77_0,,,,2,1,2,3
C(CC(CO)=O)=O,,,2,1,189,270,459
79_0,,,,2,1,2,3
C(C(C(C)=O)O)=O,,,2,1,190,230,420
81_0,,,,2,1,2,3
C(C)=O,,,2,1,1103,2830,3933
83_0,,,,2,1,1,2
C1C(C(C(O)O1)O)O,,,2,1,7,17,24
84_0,,,,2,3,5,8
86_0,,,,2,2,2,4
[Fe+3],,,0,1,2142,2588,4730
C(C(C)O)(O)=O,,,2,1,77,144,221
88_0,,,,2,2,2,4
C(C(CCO)O)(O)=O,,,2,1,26,30,56
90_0,,,,2,3,5,8
C(C(CO)=O)=O,,,2,1,371,467,838
92_0,,,,2,3,5,8
C(C(C(CO)O)=O)=O,,,2,1,90,82,172
93_0,,,,2,5,3,8
94_0,,,,2,4,4,8
95_0,,,,2,4,4,8
97_0,,,,2,2,1,3
C(CC(C(C(C(CO)O)O)O)O)=O,,,3,1,14,14,28
99_0,,,,2,2,1,3
C(C(C(C(CC(C=O)=O)O)O)O)=O,,,3,1,25,26,51
101_0,,,,2,2,1,3
C(C(C=O)C(C(C(C=O)O)O)O)=O,,,3,1,19,20,39
101_1,,,,2,2,1,3
103_0,,,,2,2,1,3
C(CC(C(C(C=O)O)O)O)=O,,,3,1,24,28,52
105_0,,,,2,2,1,3
C(C(C(C(C(C=O)O)O)O)O)=O,,,3,1,12,15,27
105_1,,,,2,2,1,3
107_0,,,,2,2,1,3
C(CO)(C(C(CO)(CO)O)O)=O,,,3,1,9,7,16
107_1,,,,2,2,1,3
109_0,,,,2,2,1,3
C(C(CC(CO)(CO)O)=O)=O,,,3,1,13,14,27
111_0,,,,2,2,1,3
C(C(C=O)C(CO)(CO)O)=O,,,3,1,9,9,18
111_1,,,,2,2,1,3
113_0,,,,2,2,1,3
C(C(C(CO)C(CO)(CO)O)=O)=O,,,3,1,14,13,27
113_1,,,,2,2,1,3
115_0,,,,2,2,1,3
C(C(C(CO)(CO)O)C(C=O)O)=O,,,3,1,13,14,27
115_1,,,,2,2,1,3
117_0,,,,2,2,1,3
C(C(C(CO)=O)C(CO)(CO)O)=O,,,3,1,10,9,19
117_1,,,,2,2,1,3
119_0,,,,2,2,1,3
C(CC(C(C(CO)(CO)O)O)=O)=O,,,3,1,10,10,20
119_1,,,,2,2,1,3
121_0,,,,2,2,1,3
C(C(C(CC(CO)(CO)O)=O)O)=O,,,3,1,9,9,18
123_0,,,,2,2,1,3
C(CC(CO)(CO)O)=O,,,3,1,21,24,45
125_0,,,,2,2,1,3
C(C(C(C(CO)(CO)O)O)=O)=O,,,3,1,11,14,25
125_1,,,,2,2,1,3
127_0,,,,2,2,1,3
C(C(C(CO)(CO)O)O)=O,,,3,1,17,17,34
127_1,,,,2,2,1,3
129_0,,,,2,2,1,3
C(C(C(C(CO)=O)O)O)(O)=O,,,3,1,21,17,38
129_1,,,,2,2,1,3
131_0,,,,2,2,1,3
C(C(C)(C(C(CO)=O)O)O)=O,,,3,1,16,17,33
131_1,,,,2,2,1,3
133_0,,,,2,2,1,3
C(C)(C(C(C(CO)=O)O)O)=O,,,3,1,24,21,45
133_1,,,,2,2,1,3
135_0,,,,2,2,1,3
C(CC(C(C(CO)=O)O)O)=O,,,3,1,21,21,42
135_1,,,,2,2,1,3
137_0,,,,2,2,1,3
C(C(CCO)(C(C(CO)=O)O)O)=O,,,3,1,15,15,30
137_1,,,,2,2,1,3
139_0,,,,2,2,1,3
C(C(C(C(CCO)=O)O)O)(CO)=O,,,3,1,19,17,36
139_1,,,,2,2,1,3
141_0,,,,2,2,1,3
C(CC(C(C(C(CO)=O)O)O)O)=O,,,3,1,21,20,41
141_1,,,,2,2,1,3
143_0,,,,2,2,1,3
C(C(CC(C(C(CO)=O)O)O)O)=O,,,3,1,21,19,40
143_1,,,,2,2,1,3
145_0,,,,2,2,1,3
C(CO)(CC(C(C(CO)=O)O)O)=O,,,3,1,18,16,34
145_1,,,,2,2,1,3
147_0,,,,2,2,1,3
C(CC(CO)(C(C(CO)=O)O)O)=O,,,3,1,16,15,31
147_1,,,,2,2,1,3
149_0,,,,2,2,1,3
C(C)(C(C(C(C(CO)=O)O)O)O)=O,,,3,1,18,17,35
149_1,,,,2,2,1,3
151_0,,,,2,2,1,3
C(C(C(C)(C(C(CO)=O)O)O)O)=O,,,3,1,17,17,34
151_1,,,,2,2,1,3
153_0,,,,2,2,1,3
C(CO)(C(C(C)O)O)=O,,,3,1,35,38,73
153_1,,,,2,2,1,3
155_0,,,,2,2,1,3
C(C(CO)(C(C(CO)=O)O)O)=O,,,3,1,16,18,34
155_1,,,,2,2,1,3
157_0,,,,2,2,1,3
C(CO)(C(C(C(CO)=O)O)O)=O,,,3,1,9,8,17
157_1,,,,2,2,1,3
159_0,,,,2,2,1,3
C(CO)(C(C(C(CO)O)O)O)=O,,,3,1,14,12,26
159_1,,,,2,2,1,3
161_0,,,,2,2,1,3
C(C(C(C(CO)=O)O)O)=O,,,3,1,37,37,74
161_1,,,,2,2,1,3
162_0,,,,2,2,1,3
162_1,,,,2,2,1,3
164_0,,,,2,2,1,3
C(CO)(C(C(CO)O)O)=O,,,3,1,25,22,47
164_1,,,,2,2,1,3
166_0,,,,2,2,1,3
C(C(CC(CO)(C(CO)O)O)=O)=O,,,3,1,16,15,31
168_0,,,,2,2,1,3
C(C(C=O)C(CO)(C(CO)O)O)=O,,,3,1,12,11,23
168_1,,,,2,2,1,3
170_0,,,,2,2,1,3
C(CC(CO)(C(CO)O)O)=O,,,3,1,14,14,28
172_0,,,,2,2,1,3
C(C(C(CO)(C(CO)O)O)O)=O,,,3,1,14,15,29
172_1,,,,2,2,1,3
174_0,,,,2,2,1,3
C(C(C(C(O)=O)O)O)(C(CO)O)=O,,,3,1,18,16,34
174_1,,,,2,2,1,3
176_0,,,,2,2,1,3
C(C(C)(C(C(C(CO)O)=O)O)O)=O,,,3,1,17,17,34
176_1,,,,2,2,1,3
178_0,,,,2,2,1,3
C(C(C(C(C(CO)O)=O)O)O)(C)=O,,,3,1,20,18,38
178_1,,,,2,2,1,3
180_0,,,,2,2,1,3
C(CC(C(C(C(CO)O)=O)O)O)=O,,,3,1,18,17,35
180_1,,,,2,2,1,3
182_0,,,,2,2,1,3
C(C(C(C)O)O)(C(CO)O)=O,,,3,1,18,15,33
182_1,,,,2,2,1,3
184_0,,,,2,2,1,3
C(C(C(C=O)O)O)(C(CO)O)=O,,,3,1,20,22,42
184_1,,,,2,2,1,3
186_0,,,,2,2,1,3
C(C(CO)O)(C(CO)O)=O,,,3,1,14,12,26
186_1,,,,2,2,1,3
188_0,,,,2,2,1,3
C(C(C(CO)O)O)(C(CO)O)=O,,,3,1,15,13,28
188_1,,,,2,2,1,3
190_0,,,,2,2,1,3
C(C(CC(C=O)=O)O)(O)=O,,,3,1,25,24,49
192_0,,,,2,2,1,3
C(C(C=O)C(C(O)=O)O)=O,,,3,1,19,16,35
192_1,,,,2,2,1,3
194_0,,,,2,2,1,3
C(C(C(C(C=O)=O)CO)O)(O)=O,,,3,1,19,19,38
194_1,,,,2,2,1,3
196_0,,,,2,2,1,3
C(C(C(C=O)C(C=O)O)O)(O)=O,,,3,1,17,20,37
196_1,,,,2,2,1,3
198_0,,,,2,2,1,3
C(C(C(CO)=O)C(C(O)=O)O)=O,,,3,1,16,14,30
198_1,,,,2,2,1,3
200_0,,,,2,2,1,3
C(CC(C(C(C(O)=O)O)O)=O)=O,,,3,1,19,18,37
200_1,,,,2,2,1,3
202_0,,,,2,2,1,3
C(C(C(CC(C(O)=O)O)=O)O)=O,,,3,1,16,15,31
204_0,,,,2,2,1,3
C(C(CC=O)O)(O)=O,,,3,1,71,78,149
206_0,,,,2,2,1,3
C(C(C(C(C=O)=O)O)O)(O)=O,,,3,1,21,21,42
206_1,,,,2,2,1,3
207_0,,,,2,2,1,3
207_1,,,,2,2,1,3
209_0,,,,2,2,1,3
C(C(CO)(C(C(CC=O)O)O)O)=O,,,3,1,17,20,37
211_0,,,,2,2,1,3
C(CC(C(CO)(C(C=O)O)O)O)=O,,,3,1,20,20,40
213_0,,,,2,2,1,3
C(C(CC(C(CO)(CO)O)O)=O)=O,,,3,1,11,11,22
215_0,,,,2,2,1,3
C(C(C=O)C(C(CO)(CO)O)O)=O,,,3,1,7,8,15
215_1,,,,2,2,1,3
217_0,,,,2,2,1,3
C(CC(C(CO)(CO)O)O)=O,,,3,1,10,11,21
219_0,,,,2,2,1,3
C(C(C(C(CO)(CO)O)O)O)=O,,,3,1,11,14,25
219_1,,,,2,2,1,3
221_0,,,,2,2,1,3
C(CC(C(CO)(C(CO)O)O)O)=O,,,3,1,13,12,25
223_0,,,,2,2,1,3
C(CC(C(C(C(O)=O)O)O)O)=O,,,3,1,18,18,36
225_0,,,,2,2,1,3
C(C(C(C(C(C=O)O)O)O)O)(O)=O,,,3,1,21,22,43
225_1,,,,2,2,1,3
227_0,,,,2,2,1,3
C(C(C)(CC(C=O)=O)O)=O,,,3,1,17,21,38
229_0,,,,2,2,1,3
C(C(C=O)C(C=O)(C)O)=O,,,3,1,13,14,27
229_1,,,,2,2,1,3
231_0,,,,2,2,1,3
C(C(C)(C(C(C=O)=O)CO)O)=O,,,3,1,14,18,32
231_1,,,,2,2,1,3
233_0,,,,2,2,1,3
C(C(C(C=O)C(C=O)(C)O)O)=O,,,3,1,12,19,31
233_1,,,,2,2,1,3
235_0,,,,2,2,1,3
C(C(C)(C(C=O)C(CO)=O)O)=O,,,3,1,13,15,28
235_1,,,,2,2,1,3
237_0,,,,2,2,1,3
C(C(C)(C(C(CC=O)=O)O)O)=O,,,3,1,12,17,29
237_1,,,,2,2,1,3
239_0,,,,2,2,1,3
C(C(C)(CC(C(C=O)O)=O)O)=O,,,3,1,12,15,27
241_0,,,,2,2,1,3
C(C(C)(CC=O)O)=O,,,3,1,68,78,146
243_0,,,,2,2,1,3
C(C(C)(C(C(C=O)=O)O)O)=O,,,3,1,12,18,30
243_1,,,,2,2,1,3
245_0,,,,2,2,1,3
C(C(C)(C(C=O)O)O)=O,,,3,1,30,33,63
245_1,,,,2,2,1,3
247_0,,,,2,2,1,3
C(C)(C(CC(C=O)=O)O)=O,,,3,1,29,28,57
249_0,,,,2,2,1,3
C(C(C=O)C(C(C)=O)O)=O,,,3,1,24,20,44
249_1,,,,2,2,1,3
251_0,,,,2,2,1,3
C(C(C(C(C=O)=O)CO)O)(C)=O,,,3,1,17,19,36
251_1,,,,2,2,1,3
253_0,,,,2,2,1,3
C(C(C(C=O)C(C(C)=O)O)O)=O,,,3,1,15,20,35
253_1,,,,2,2,1,3
255_0,,,,2,2,1,3
C(C(C(CO)=O)C(C(C)=O)O)=O,,,3,1,16,16,32
255_1,,,,2,2,1,3
257_0,,,,2,2,1,3
C(CC(C(C(C(C)=O)O)O)=O)=O,,,3,1,20,21,41
257_1,,,,2,2,1,3
259_0,,,,2,2,1,3
C(C(C(CC(C(C)=O)O)=O)O)=O,,,3,1,17,17,34
261_0,,,,2,2,1,3
C(CC(C(C)=O)O)=O,,,3,1,111,113,224
263_0,,,,2,2,1,3
C(C)(C(C(C(C=O)=O)O)O)=O,,,3,1,21,23,44
263_1,,,,2,2,1,3
265_0,,,,2,2,1,3
C(C(C(C(C)=O)O)O)=O,,,3,1,52,54,106
265_1,,,,2,2,1,3
267_0,,,,2,2,1,3
C(CC(CC(C=O)=O)O)=O,,,3,1,28,31,59
269_0,,,,2,2,1,3
C(C(CCO)(CC(C=O)=O)O)=O,,,3,1,12,16,28
271_0,,,,2,2,1,3
C(C(CC(C=O)=O)O)(CCO)=O,,,3,1,16,18,34
273_0,,,,2,2,1,3
C(CC(C(CC(C=O)=O)O)O)=O,,,3,1,20,25,45
275_0,,,,2,2,1,3
C(C(CC(CC(C=O)=O)O)O)=O,,,3,1,19,23,42
277_0,,,,2,2,1,3
C(CO)(CC(CC(C=O)=O)O)=O,,,3,1,18,20,38
279_0,,,,2,2,1,3
C(CC(CO)(CC(C=O)=O)O)=O,,,3,1,16,20,36
281_0,,,,2,2,1,3
C(C)(C(C(CC(C=O)=O)O)O)=O,,,3,1,19,21,40
283_0,,,,2,2,1,3
C(C(C(C)(CC(C=O)=O)O)O)=O,,,3,1,17,22,39
285_0,,,,2,2,1,3
C(C(CC(C)O)=O)=O,,,3,1,71,83,154
287_0,,,,2,2,1,3
C(C(CO)(CC(C=O)=O)O)=O,,,3,1,13,18,31
289_0,,,,2,2,1,3
C(CO)(C(CC(C=O)=O)O)=O,,,3,1,21,22,43
291_0,,,,2,2,1,3
C(C(C(CO)O)(CC(C=O)=O)O)=O,,,3,1,14,16,30
293_0,,,,2,2,1,3
C(C(CC(C=O)=O)O)(C(CO)O)=O,,,3,1,20,18,38
295_0,,,,2,2,1,3
C(C(CC(C(CO)O)O)=O)=O,,,3,1,18,19,37
297_0,,,,2,2,1,3
C(C(CC(C(C(CO)O)O)O)=O)=O,,,3,1,16,16,32
299_0,,,,2,2,1,3
C(C(CC(C=O)=O)O)=O,,,3,1,38,43,81
300_0,,,,2,2,1,3
302_0,,,,2,2,1,3
C(C(CC(CO)O)=O)=O,,,3,1,30,34,64
304_0,,,,2,2,1,3
C(C(C=O)C(CC=O)O)=O,,,3,1,22,22,44
304_1,,,,2,2,1,3
306_0,,,,2,2,1,3
C(CC(C(C(C=O)=O)CO)O)=O,,,3,1,18,22,40
306_1,,,,2,2,1,3
308_0,,,,2,2,1,3
C(CC(C(C=O)C(C=O)O)O)=O,,,3,1,18,24,42
308_1,,,,2,2,1,3
310_0,,,,2,2,1,3
C(CC(C(C=O)C(CO)=O)O)=O,,,3,1,15,17,32
310_1,,,,2,2,1,3
312_0,,,,2,2,1,3
C(CC(C(C(CC=O)=O)O)O)=O,,,3,1,17,21,38
312_1,,,,2,2,1,3
314_0,,,,2,2,1,3
C(C(C(CC(CC=O)O)=O)O)=O,,,3,1,16,19,35
316_0,,,,2,2,1,3
C(CC(CC=O)O)=O,,,3,1,50,59,109
318_0,,,,2,2,1,3
C(CC(C(C(C=O)=O)O)O)=O,,,3,1,19,24,43
318_1,,,,2,2,1,3
320_0,,,,2,2,1,3
C(CC(C(C=O)O)O)=O,,,3,1,42,49,91
320_1,,,,2,2,1,3
322_0,,,,2,2,1,3
C(C(C=O)C(C=O)(CCO)O)=O,,,3,1,9,12,21
322_1,,,,2,2,1,3
324_0,,,,2,2,1,3
C(C(C=O)C(C(CCO)=O)O)=O,,,3,1,12,13,25
324_1,,,,2,2,1,3
326_0,,,,2,2,1,3
C(C(C=O)C(C(CC=O)O)O)=O,,,3,1,15,18,33
326_1,,,,2,2,1,3
328_0,,,,2,2,1,3
C(C(C=O)C(CC(C=O)O)O)=O,,,3,1,14,17,31
328_1,,,,2,2,1,3
330_0,,,,2,2,1,3
C(C(C=O)C(CC(CO)=O)O)=O,,,3,1,12,13,25
330_1,,,,2,2,1,3
332_0,,,,2,2,1,3
C(C(C=O)C(CO)(CC=O)O)=O,,,3,1,11,14,25
332_1,,,,2,2,1,3
334_0,,,,2,2,1,3
C(C(C=O)C(C(C(C)=O)O)O)=O,,,3,1,12,14,26
334_1,,,,2,2,1,3
336_0,,,,2,2,1,3
C(C(C=O)C(C)(C(C=O)O)O)=O,,,3,1,11,16,27
336_1,,,,2,2,1,3
338_0,,,,2,2,1,3
C(C(C=O)C(C)O)=O,,,3,1,52,48,100
338_1,,,,2,2,1,3
340_0,,,,2,2,1,3
C(C(C=O)C(C=O)(CO)O)=O,,,3,1,9,13,22
340_1,,,,2,2,1,3
342_0,,,,2,2,1,3
C(C(C=O)C(C(CO)=O)O)=O,,,3,1,16,15,31
342_1,,,,2,2,1,3
344_0,,,,2,2,1,3
C(C(C=O)C(C=O)(C(CO)O)O)=O,,,3,1,11,13,24
344_1,,,,2,2,1,3
346_0,,,,2,2,1,3
C(C(C=O)C(C(C(CO)O)=O)O)=O,,,3,1,15,14,29
346_1,,,,2,2,1,3
348_0,,,,2,2,1,3
C(C(C=O)C(C(CO)O)O)=O,,,3,1,13,13,26
348_1,,,,2,2,1,3
350_0,,,,2,2,1,3
C(C(C=O)C(C(C(CO)O)O)O)=O,,,3,1,13,13,26
350_1,,,,2,2,1,3
352_0,,,,2,2,1,3
C(C(C=O)C(C=O)O)=O,,,3,1,32,31,63
352_1,,,,2,2,1,3
354_0,,,,2,2,1,3
C(C(C=O)CO)=O,,,3,1,94,107,201
354_1,,,,2,2,1,3
356_0,,,,2,2,1,3
C(C(C=O)C(CO)O)=O,,,3,1,21,21,42
356_1,,,,2,2,1,3
358_0,,,,2,2,1,3
C(C(CCO)(CC=O)O)=O,,,3,1,17,19,36
360_0,,,,2,2,1,3
C(C(CCO)(C(C(C=O)=O)O)O)=O,,,3,1,13,16,29
360_1,,,,2,2,1,3
362_0,,,,2,2,1,3
C(C(CCO)(C(C=O)O)O)=O,,,3,1,14,18,32
362_1,,,,2,2,1,3
364_0,,,,2,2,1,3
C(CC(C(CCO)=O)O)=O,,,3,1,31,29,60
366_0,,,,2,2,1,3
C(C(C(C(C=O)=O)O)O)(CCO)=O,,,3,1,18,19,37
366_1,,,,2,2,1,3
368_0,,,,2,2,1,3
C(C(C(C=O)O)O)(CCO)=O,,,3,1,24,25,49
368_1,,,,2,2,1,3
370_0,,,,2,2,1,3
C(C(C(CO)C(C)O)=O)=O,,,3,1,20,20,40
370_1,,,,2,2,1,3
372_0,,,,2,2,1,3
C(C(CO)(C(C(C=O)=O)CO)O)=O,,,3,1,15,17,32
372_1,,,,2,2,1,3
374_0,,,,2,2,1,3
C(C(C(C(C=O)=O)CO)O)(CO)=O,,,3,1,19,19,38
374_1,,,,2,2,1,3
376_0,,,,2,2,1,3
C(C(C(CO)C(C(CO)O)O)=O)=O,,,3,1,19,18,37
376_1,,,,2,2,1,3
378_0,,,,2,2,1,3
C(C(C(C(C=O)=O)CO)O)=O,,,3,1,19,22,41
378_1,,,,2,2,1,3
380_0,,,,2,2,1,3
C(C(C(CO)CO)=O)=O,,,3,1,24,24,48
380_1,,,,2,2,1,3
382_0,,,,2,2,1,3
C(C(C(CO)C(CO)O)=O)=O,,,3,1,19,19,38
382_1,,,,2,2,1,3
384_0,,,,2,2,1,3
C(CC(C(CC=O)O)O)=O,,,3,1,15,16,31
386_0,,,,2,2,1,3
C(CC(C(C(C(C=O)=O)O)O)O)=O,,,3,1,22,24,46
386_1,,,,2,2,1,3
387_0,,,,2,2,1,3
387_1,,,,2,2,1,3
389_0,,,,2,2,1,3
C(CC(CC(C=O)O)O)=O,,,3,1,27,28,55
391_0,,,,2,2,1,3
C(C(CC(C(C(C=O)=O)O)O)O)=O,,,3,1,22,22,44
391_1,,,,2,2,1,3
393_0,,,,2,2,1,3
C(C(C(CC(C=O)O)O)O)=O,,,3,1,23,26,49
393_1,,,,2,2,1,3
395_0,,,,2,2,1,3
C(C(C(C)O)C(C=O)O)=O,,,3,1,23,24,47
395_1,,,,2,2,1,3
397_0,,,,2,2,1,3
C(C(C(C=O)C(C=O)(CO)O)O)=O,,,3,1,14,18,32
397_1,,,,2,2,1,3
399_0,,,,2,2,1,3
C(C(C(C=O)C(C(CO)=O)O)O)=O,,,3,1,18,20,38
399_1,,,,2,2,1,3
401_0,,,,2,2,1,3
C(C(C(C(CO)O)O)C(C=O)O)=O,,,3,1,18,19,37
401_1,,,,2,2,1,3
403_0,,,,2,2,1,3
C(C(C(C=O)C(C=O)O)O)=O,,,3,1,11,14,25
403_1,,,,2,2,1,3
405_0,,,,2,2,1,3
C(C(CO)C(C=O)O)=O,,,3,1,37,36,73
405_1,,,,2,2,1,3
407_0,,,,2,2,1,3
C(C(C(CO)O)C(C=O)O)=O,,,3,1,19,21,40
407_1,,,,2,2,1,3
409_0,,,,2,2,1,3
C(CC(CC(CO)=O)O)=O,,,3,1,32,32,64
411_0,,,,2,2,1,3
C(CO)(CC(C(C(C=O)=O)O)O)=O,,,3,1,19,20,39
411_1,,,,2,2,1,3
413_0,,,,2,2,1,3
C(C(C(CC(CO)=O)O)O)=O,,,3,1,22,24,46
413_1,,,,2,2,1,3
415_0,,,,2,2,1,3
C(CC(CO)(CC=O)O)=O,,,3,1,14,14,28
417_0,,,,2,2,1,3
C(CC(CO)(C(C(C=O)=O)O)O)=O,,,3,1,16,18,34
417_1,,,,2,2,1,3
419_0,,,,2,2,1,3
C(CC(CO)(C(C=O)O)O)=O,,,3,1,18,21,39
419_1,,,,2,2,1,3
421_0,,,,2,2,1,3
C(C(C(CO)=O)C(C)O)=O,,,3,1,23,21,44
421_1,,,,2,2,1,3
423_0,,,,2,2,1,3
C(C(CO)(C(C=O)C(CO)=O)O)=O,,,3,1,13,15,28
423_1,,,,2,2,1,3
425_0,,,,2,2,1,3
C(C(C(CO)=O)C(C(CO)=O)O)=O,,,3,1,17,17,34
425_1,,,,2,2,1,3
427_0,,,,2,2,1,3
C(C(C(CO)=O)C(C(CO)O)O)=O,,,3,1,15,14,29
427_1,,,,2,2,1,3
429_0,,,,2,2,1,3
C(C(C(CO)=O)C(C=O)O)=O,,,3,1,20,21,41
429_1,,,,2,2,1,3
431_0,,,,2,2,1,3
C(C(C(CO)=O)CO)=O,,,3,1,36,36,72
431_1,,,,2,2,1,3
433_0,,,,2,2,1,3
C(C(C(CO)=O)C(CO)O)=O,,,3,1,18,16,34
433_1,,,,2,2,1,3
435_0,,,,2,2,1,3
C(CC(C(C(C)O)O)=O)=O,,,3,1,25,26,51
435_1,,,,2,2,1,3
437_0,,,,2,2,1,3
C(C(CO)(C(C(CC=O)=O)O)O)=O,,,3,1,16,19,35
437_1,,,,2,2,1,3
439_0,,,,2,2,1,3
C(CC(C(C(C(CO)=O)O)O)=O)=O,,,3,1,22,21,43
439_1,,,,2,2,1,3
441_0,,,,2,2,1,3
C(CC(C(C(C(CO)O)O)O)=O)=O,,,3,1,15,15,30
441_1,,,,2,2,1,3
443_0,,,,2,2,1,3
C(CC(C(C(C=O)O)O)=O)=O,,,3,1,26,29,55
443_1,,,,2,2,1,3
445_0,,,,2,2,1,3
C(CC(C(CO)O)=O)=O,,,3,1,40,44,84
445_1,,,,2,2,1,3
447_0,,,,2,2,1,3
C(CC(C(C(CO)O)O)=O)=O,,,3,1,19,19,38
447_1,,,,2,2,1,3
449_0,,,,2,2,1,3
C(CC(C(C(C)=O)O)O)=O,,,3,1,31,30,61
451_0,,,,2,2,1,3
C(C)(C(C(C(C(C=O)=O)O)O)O)=O,,,3,1,20,21,41
451_1,,,,2,2,1,3
453_0,,,,2,2,1,3
C(C(C(C(C(C)=O)O)O)O)=O,,,3,1,22,24,46
453_1,,,,2,2,1,3
455_0,,,,2,2,1,3
C(CC(C)(C(C=O)O)O)=O,,,3,1,26,29,55
457_0,,,,2,2,1,3
C(C(C(C)(C(C(C=O)=O)O)O)O)=O,,,3,1,18,20,38
457_1,,,,2,2,1,3
459_0,,,,2,2,1,3
C(C(C(C)(C(C=O)O)O)O)=O,,,3,1,10,12,22
459_1,,,,2,2,1,3
461_0,,,,2,2,1,3
C(C(C(CC(C)O)=O)O)=O,,,3,1,23,24,47
463_0,,,,2,2,1,3
C(C(CO)(CC(C(C=O)O)=O)O)=O,,,3,1,13,15,28
465_0,,,,2,2,1,3
C(C(C(CC(C(CO)=O)O)=O)O)=O,,,3,1,18,17,35
467_0,,,,2,2,1,3
C(C(C(CC(C(CO)O)O)=O)O)=O,,,3,1,13,13,26
469_0,,,,2,2,1,3
C(C(C(CC(C=O)O)=O)O)=O,,,3,1,22,23,45
471_0,,,,2,2,1,3
C(C(C(CCO)=O)O)=O,,,3,1,39,42,81
473_0,,,,2,2,1,3
C(C(C(CC(CO)O)=O)O)=O,,,3,1,17,17,34
475_0,,,,2,2,1,3
C(CC(C)O)=O,,,3,1,226,388,614
477_0,,,,2,2,1,3
C(C(C(C(C)O)O)=O)=O,,,3,1,29,34,63
477_1,,,,2,2,1,3
479_0,,,,2,2,1,3
C(C(C(C)O)O)=O,,,3,1,137,161,298
479_1,,,,2,2,1,3
481_0,,,,2,2,1,3
C(C(CO)(CC=O)O)=O,,,3,1,27,31,58
483_0,,,,2,2,1,3
C(CC(C(CO)=O)O)=O,,,3,1,47,49,96
485_0,,,,2,2,1,3
C(C(C(CO)O)(CC=O)O)=O,,,3,1,13,17,30
487_0,,,,2,2,1,3
C(CC(C(C(CO)O)=O)O)=O,,,3,1,22,20,42
489_0,,,,2,2,1,3
C(CC(C(CO)O)O)=O,,,3,1,25,30,55
491_0,,,,2,2,1,3
C(CC(C(C(CO)O)O)O)=O,,,3,1,15,16,31
492_0,,,,2,2,1,3
494_0,,,,2,2,1,3
C(CCO)=O,,,3,1,356,847,1203
496_0,,,,2,2,1,3
C(CC(CO)O)=O,,,3,1,99,158,257
498_0,,,,2,2,1,3
C(C(CO)(C(C(C=O)=O)O)O)=O,,,3,1,14,22,36
498_1,,,,2,2,1,3
499_0,,,,2,2,1,3
499_1,,,,2,2,1,3
501_0,,,,2,2,1,3
C(CO)(C(C(C(C=O)=O)O)O)=O,,,3,1,18,22,40
501_1,,,,2,2,1,3
502_0,,,,2,2,1,3
502_1,,,,2,2,1,3
504_0,,,,2,2,1,3
C(C(C(C(C(CO)O)O)O)=O)=O,,,3,1,17,20,37
504_1,,,,2,2,1,3
506_0,,,,2,2,1,3
C(C(C(C(C=O)=O)O)O)=O,,,3,1,29,35,64
506_1,,,,2,2,1,3
507_0,,,,2,2,1,3
507_1,,,,2,2,1,3
509_0,,,,2,2,1,3
C(C(C(C(CO)O)O)=O)=O,,,3,1,23,24,47
509_1,,,,2,2,1,3
510_0,,,,2,2,1,3
510_1,,,,2,2,1,3
511_0,,,,2,2,1,3
511_1,,,,2,2,1,3
512_0,,,,2,2,1,3
512_1,,,,2,2,1,3
513_0,,,,2,2,1,3
513_1,,,,2,2,1,3
514_0,,,,2,2,1,3
514_1,,,,2,2,1,3
515_0,,,,2,2,1,3
515_1,,,,2,2,1,3
516_0,,,,2,1,2,3
517_0,,,,2,1,2,3
518_0,,,,2,1,2,3
519_0,,,,2,1,2,3
521_0,,,,2,1,2,3
C(C(C(C=O)=O)O)=O,,,3,1,101,94,195
522_0,,,,2,1,2,3
523_0,,,,2,1,2,3
524_0,,,,2,1,2,3
524_1,,,,2,1,2,3
525_0,,,,2,1,2,3
525_1,,,,2,1,2,3
526_0,,,,2,1,2,3
526_1,,,,2,1,2,3
527_0,,,,2,1,2,3
527_1,,,,2,1,2,3
528_0,,,,2,1,2,3
528_1,,,,2,1,2,3
528_2,,,,2,1,2,3
529_0,,,,2,1,2,3
529_1,,,,2,1,2,3
529_2,,,,2,1,2,3
530_0,,,,2,1,2,3
530_1,,,,2,1,2,3
531_0,,,,2,1,2,3
531_1,,,,2,1,2,3
531_2,,,,2,1,2,3
532_0,,,,2,1,2,3
532_1,,,,2,1,2,3
532_2,,,,2,1,2,3
533_0,,,,2,1,2,3
533_1,,,,2,1,2,3
533_2,,,,2,1,2,3
534_0,,,,2,1,2,3
534_1,,,,2,1,2,3
534_2,,,,2,1,2,3
535_0,,,,2,1,2,3
535_1,,,,2,1,2,3
535_2,,,,2,1,2,3
536_0,,,,2,1,2,3
536_1,,,,2,1,2,3
537_0,,,,2,1,2,3
537_1,,,,2,1,2,3
537_2,,,,2,1,2,3
538_0,,,,2,1,2,3
538_1,,,,2,1,2,3
538_2,,,,2,1,2,3
539_0,,,,2,1,2,3
539_1,,,,2,1,2,3
539_2,,,,2,1,2,3
540_0,,,,2,1,2,3
540_1,,,,2,1,2,3
541_0,,,,2,1,2,3
542_0,,,,2,1,2,3
543_0,,,,2,1,2,3
544_0,,,,2,1,2,3
544_1,,,,2,1,2,3
545_0,,,,2,1,2,3
546_0,,,,2,1,1,2
547_0,,,,2,1,1,2
549_0,,,,2,1,1,2
C(C(C(CO)=O)O)=O,,,3,1,114,109,223
550_0,,,,2,1,1,2
551_0,,,,2,1,1,2
552_0,,,,2,1,1,2
554_0,,,,2,1,1,2
C(C(C(CO)=O)(CO)O)=O,,,3,1,16,16,32
556_0,,,,2,1,1,2
C(C(C(CO)=O)(C(CO)O)O)=O,,,3,1,12,12,24
558_0,,,,2,1,1,2
C(C(C(CO)=O)O)(O)=O,,,3,1,37,35,72
559_0,,,,2,1,1,2
560_0,,,,2,1,1,2
562_0,,,,2,1,1,2
C(C(CO)=O)(C)=O,,,3,1,163,228,391
564_0,,,,2,1,1,2
C(C(C(C)O)=O)=O,,,3,1,141,152,293
566_0,,,,2,1,1,2
C(C(C=O)O)=O,,,3,1,256,342,598
567_0,,,,2,1,1,2
569_0,,,,2,3,2,5
C(C(C(C(CO)O)O)O)O,,,3,1,5,4,9
571_0,,,,2,3,2,5
C(C(C(C(C(CO)O)O)O)O)O,,,3,1,6,5,11
572_0,,,,2,3,2,5
573_0,,,,2,3,2,5
575_0,,,,2,3,2,5
C(C(CO)(C(C(CO)O)O)O)O,,,3,1,8,6,14
576_0,,,,2,3,2,5
577_0,,,,2,3,2,5
579_0,,,,2,3,2,5
C(C(CO)(CO)O)O,,,3,1,3,4,7
581_0,,,,2,3,2,5
C(C(CO)(C(CO)O)O)O,,,3,1,6,4,10
582_0,,,,2,3,2,5
583_0,,,,2,3,2,5
585_0,,,,2,3,2,5
C(C(C(CO)O)(C(CO)O)O)O,,,3,1,6,4,10
586_0,,,,2,3,2,5
588_0,,,,2,3,2,5
C(C)(CO)=O,,,3,1,499,1077,1576
589_0,,,,2,3,2,5
591_0,,,,2,3,2,5
C(CO)(CCO)=O,,,3,1,152,234,386
592_0,,,,2,3,2,5
594_0,,,,2,3,2,5
C(C(CCO)O)=O,,,3,1,106,118,224
595_0,,,,2,3,2,5
597_0,,,,2,3,2,5
C(C)(C(CO)O)=O,,,3,1,157,196,353
599_0,,,,2,3,2,5
CCO,,,3,1,11,291,302
600_0,,,,2,3,2,5
601_0,,,,2,3,2,5
602_0,,,,2,3,2,5
603_0,,,,2,3,2,5
604_0,,,,2,3,2,5
606_0,,,,2,3,2,5
C(C(O)=O)(O)=O,,,3,1,2,3,5
608_0,,,,2,3,2,5
C(C(CO)(C(C(CO)O)O)O)(O)=O,,,3,1,14,13,27
610_0,,,,2,3,2,5
C(C(CO)(C(C(O)=O)O)O)=O,,,3,1,16,17,33
612_0,,,,2,3,2,5
C(C(CO)(C(C=O)O)O)(O)=O,,,3,1,18,18,36
614_0,,,,2,3,2,5
C(C(CO)(CO)O)(O)=O,,,3,1,6,5,11
616_0,,,,2,3,2,5
C(C(CO)(C(CO)O)O)(O)=O,,,3,1,12,10,22
618_0,,,,2,3,2,5
C(C(C(CO)O)(C(C(O)=O)O)O)=O,,,3,1,17,18,35
620_0,,,,2,3,2,5
C(C(C(CO)O)(C(C=O)O)O)(O)=O,,,3,1,18,18,36
622_0,,,,2,3,2,5
C(C(C(CO)O)(C(CO)O)O)(O)=O,,,3,1,8,7,15
624_0,,,,2,3,2,5
C(C(C(C(O)=O)O)O)(O)=O,,,3,1,11,11,22
626_0,,,,2,3,2,5
C(C(C)=O)(O)=O,,,3,1,176,245,421
628_0,,,,2,3,2,5
C(CC(O)=O)=O,,,3,1,208,343,551
630_0,,,,2,3,2,5
C(C(CCO)=O)(O)=O,,,3,1,53,61,114
631_0,,,,2,3,2,5
633_0,,,,2,3,2,5
C(CC(C=O)O)(O)=O,,,3,1,69,61,130
635_0,,,,2,3,2,5
C(CC(CO)=O)(O)=O,,,3,1,80,91,171
637_0,,,,2,3,2,5
C(C(C(C)=O)O)(O)=O,,,3,1,79,75,154
639_0,,,,2,3,2,5
C(C)(O)=O,,,3,1,47,90,137
641_0,,,,2,3,2,5
C(C(CO)=O)(O)=O,,,3,1,94,136,230
643_0,,,,2,3,2,5
C(C(C(CO)O)=O)(O)=O,,,3,1,25,26,51
645_0,,,,2,2,1,3
C(C(C(C)O)(C(C(CO)O)O)O)=O,,,3,1,14,16,30
645_1,,,,2,2,1,3
646_0,,,,2,2,1,3
646_1,,,,2,2,1,3
648_0,,,,2,2,1,3
C(C(C(C=O)(C(C=O)O)O)O)(O)=O,,,3,1,19,21,40
648_1,,,,2,2,1,3
650_0,,,,2,2,1,3
C(C(C(C=O)(C(C=O)(C)O)O)O)=O,,,3,1,13,19,32
650_1,,,,2,2,1,3
652_0,,,,2,2,1,3
C(C(C(C=O)(C(C(C)=O)O)O)O)=O,,,3,1,17,21,38
652_1,,,,2,2,1,3
654_0,,,,2,2,1,3
C(CC(C(C=O)(C(C=O)O)O)O)=O,,,3,1,20,24,44
654_1,,,,2,2,1,3
656_0,,,,2,2,1,3
C(C(C(C)O)(C(C=O)O)O)=O,,,3,1,15,21,36
656_1,,,,2,2,1,3
658_0,,,,2,2,1,3
C(C(C(C=O)(C(C=O)O)O)O)=O,,,3,1,8,14,22
658_1,,,,2,2,1,3
659_0,,,,2,2,1,3
659_1,,,,2,2,1,3
660_0,,,,2,2,1,3
660_1,,,,2,2,1,3
662_0,,,,2,2,1,3
C(C(CO)(C(CO)(CO)O)O)(O)=O,,,3,1,10,8,18
662_1,,,,2,2,1,3
664_0,,,,2,2,1,3
C(C(C(C)=O)(C(CO)(CO)O)O)=O,,,3,1,6,7,13
664_1,,,,2,2,1,3
666_0,,,,2,2,1,3
C(C(CO)(C(CO)(CO)O)O)=O,,,3,1,9,11,20
666_1,,,,2,2,1,3
668_0,,,,2,2,1,3
C(CO)(C(CO)(C(C(O)=O)O)O)=O,,,3,1,16,15,31
668_1,,,,2,2,1,3
670_0,,,,2,2,1,3
C(C(C)(C(C(CO)=O)(CO)O)O)=O,,,3,1,14,16,30
670_1,,,,2,2,1,3
672_0,,,,2,2,1,3
C(CO)(C(CO)(C(C(C)=O)O)O)=O,,,3,1,17,17,34
672_1,,,,2,2,1,3
674_0,,,,2,2,1,3
C(CC(C(C(CO)=O)(CO)O)O)=O,,,3,1,16,17,33
674_1,,,,2,2,1,3
676_0,,,,2,2,1,3
C(CO)(C(CO)(C(C)O)O)=O,,,3,1,12,12,24
676_1,,,,2,2,1,3
678_0,,,,2,2,1,3
C(CO)(C(CO)(C(C=O)O)O)=O,,,3,1,17,20,37
678_1,,,,2,2,1,3
680_0,,,,2,2,1,3
C(CO)(C(CO)(CO)O)=O,,,3,1,13,12,25
680_1,,,,2,2,1,3
682_0,,,,2,2,1,3
C(CO)(C(CO)(C(CO)O)O)=O,,,3,1,13,12,25
682_1,,,,2,2,1,3
684_0,,,,2,2,1,3
C(C(CO)(C(C(O)=O)O)O)(O)=O,,,3,1,15,12,27
684_1,,,,2,2,1,3
686_0,,,,2,2,1,3
C(C(CO)(C(C=O)(C)O)O)(O)=O,,,3,1,12,13,25
686_1,,,,2,2,1,3
688_0,,,,2,2,1,3
C(C(CO)(C(C(C)=O)O)O)(O)=O,,,3,1,15,13,28
688_1,,,,2,2,1,3
690_0,,,,2,2,1,3
C(C(CO)(C(CC=O)O)O)(O)=O,,,3,1,15,15,30
690_1,,,,2,2,1,3
692_0,,,,2,2,1,3
C(C(CO)(C(C)O)O)(O)=O,,,3,1,10,8,18
692_1,,,,2,2,1,3
694_0,,,,2,2,1,3
C(C(CO)(C(C=O)(CO)O)O)(O)=O,,,3,1,16,17,33
694_1,,,,2,2,1,3
696_0,,,,2,2,1,3
C(C(CO)(C(C(CO)=O)O)O)(O)=O,,,3,1,16,14,30
696_1,,,,2,2,1,3
697_0,,,,2,2,1,3
697_1,,,,2,2,1,3
698_0,,,,2,2,1,3
698_1,,,,2,2,1,3
699_0,,,,2,2,1,3
699_1,,,,2,2,1,3
700_0,,,,2,2,1,3
700_1,,,,2,2,1,3
702_0,,,,2,2,1,3
C(C(C(CO)O)(C(C)O)O)(O)=O,,,3,1,12,11,23
702_1,,,,2,2,1,3
703_0,,,,2,2,1,3
703_1,,,,2,2,1,3
704_0,,,,2,2,1,3
704_1,,,,2,2,1,3
705_0,,,,2,2,1,3
705_1,,,,2,2,1,3
707_0,,,,2,2,1,3
C(C(C(C)=O)(C(C(O)=O)O)O)=O,,,3,1,12,12,24
707_1,,,,2,2,1,3
709_0,,,,2,2,1,3
C(C(C(C(C=O)=O)(CO)O)O)(O)=O,,,3,1,18,19,37
709_1,,,,2,2,1,3
710_0,,,,2,2,1,3
710_1,,,,2,2,1,3
711_0,,,,2,2,1,3
711_1,,,,2,2,1,3
713_0,,,,2,2,1,3
C(C(C(C)O)(C(C=O)(CO)O)O)=O,,,3,1,14,19,33
713_1,,,,2,2,1,3
715_0,,,,2,2,1,3
C(C(CO)(C(C=O)(CO)O)O)=O,,,3,1,7,10,17
715_1,,,,2,2,1,3
716_0,,,,2,2,1,3
716_1,,,,2,2,1,3
718_0,,,,2,2,1,3
C(C(C(C)O)(C(C(O)=O)O)O)=O,,,3,1,14,16,30
718_1,,,,2,2,1,3
719_0,,,,2,2,1,3
719_1,,,,2,2,1,3
720_0,,,,2,2,1,3
720_1,,,,2,2,1,3
721_0,,,,2,2,1,3
721_1,,,,2,2,1,3
723_0,,,,2,2,1,3
C(C(C(C)O)(C(C=O)O)O)(O)=O,,,3,1,15,17,32
723_1,,,,2,2,1,3
725_0,,,,2,2,1,3
C(C(C(C=O)O)(C(C=O)O)O)(O)=O,,,3,1,11,11,22
725_1,,,,2,2,1,3
726_0,,,,2,2,1,3
726_1,,,,2,2,1,3
727_0,,,,2,2,1,3
727_1,,,,2,2,1,3
729_0,,,,2,2,1,3
C(C(C)(C(C=O)(C(C)=O)O)O)=O,,,3,1,6,12,18
729_1,,,,2,2,1,3
731_0,,,,2,2,1,3
C(C(C)(C(C(C=O)=O)(CO)O)O)=O,,,3,1,12,17,29
731_1,,,,2,2,1,3
733_0,,,,2,2,1,3
C(C(CO)(C(C=O)(C)O)O)=O,,,3,1,9,15,24
733_1,,,,2,2,1,3
735_0,,,,2,2,1,3
C(C(C(CO)O)(C(C=O)(C)O)O)=O,,,3,1,13,17,30
735_1,,,,2,2,1,3
737_0,,,,2,2,1,3
C(C(C(C)=O)(C(C(C)=O)O)O)=O,,,3,1,11,14,25
737_1,,,,2,2,1,3
739_0,,,,2,2,1,3
C(C(C(C(C=O)=O)(CO)O)O)(C)=O,,,3,1,16,19,35
739_1,,,,2,2,1,3
741_0,,,,2,2,1,3
C(C(CO)(C(C(C)=O)O)O)=O,,,3,1,17,19,36
741_1,,,,2,2,1,3
743_0,,,,2,2,1,3
C(C(C(CO)O)(C(C(C)=O)O)O)=O,,,3,1,16,18,34
743_1,,,,2,2,1,3
745_0,,,,2,2,1,3
C(CC(C(C=O)(C(C)=O)O)O)=O,,,3,1,9,14,23
745_1,,,,2,2,1,3
747_0,,,,2,2,1,3
C(CC(C(C(C=O)=O)(CO)O)O)=O,,,3,1,16,20,36
747_1,,,,2,2,1,3
749_0,,,,2,2,1,3
C(C(CO)(C(CC=O)O)O)=O,,,3,1,14,19,33
749_1,,,,2,2,1,3
751_0,,,,2,2,1,3
C(C(C(CC=O)O)(C(CO)O)O)=O,,,3,1,15,18,33
751_1,,,,2,2,1,3
753_0,,,,2,2,1,3
C(C(CCO)(C(C=O)(CO)O)O)=O,,,3,1,13,16,29
753_1,,,,2,2,1,3
755_0,,,,2,2,1,3
C(C(CO)(C(C(CCO)=O)O)O)=O,,,3,1,17,18,35
755_1,,,,2,2,1,3
756_0,,,,2,2,1,3
756_1,,,,2,2,1,3
758_0,,,,2,2,1,3
C(C(CO)(C(CC(C=O)O)O)O)=O,,,3,1,17,19,36
758_1,,,,2,2,1,3
760_0,,,,2,2,1,3
C(C(CO)(C(CC(CO)=O)O)O)=O,,,3,1,16,17,33
760_1,,,,2,2,1,3
762_0,,,,2,2,1,3
C(C(CO)(C(CO)(CC=O)O)O)=O,,,3,1,14,16,30
762_1,,,,2,2,1,3
764_0,,,,2,2,1,3
C(C(C(C)=O)(C(C)O)O)=O,,,3,1,11,13,24
764_1,,,,2,2,1,3
766_0,,,,2,2,1,3
C(C(CO)(C(C=O)(C(C)=O)O)O)=O,,,3,1,11,15,26
766_1,,,,2,2,1,3
768_0,,,,2,2,1,3
C(C(C(C)=O)(C(C(CO)=O)O)O)=O,,,3,1,15,16,31
768_1,,,,2,2,1,3
770_0,,,,2,2,1,3
C(C(C(C)=O)(C(C(CO)O)O)O)=O,,,3,1,12,13,25
770_1,,,,2,2,1,3
772_0,,,,2,2,1,3
C(C(C(C)=O)(C(C=O)O)O)=O,,,3,1,13,18,31
772_1,,,,2,2,1,3
774_0,,,,2,2,1,3
C(C(C(C)=O)(CO)O)=O,,,3,1,19,21,40
774_1,,,,2,2,1,3
776_0,,,,2,2,1,3
C(C(C(C)=O)(C(CO)O)O)=O,,,3,1,10,12,22
776_1,,,,2,2,1,3
778_0,,,,2,2,1,3
C(C(CO)(C(C(C(C)=O)O)O)O)=O,,,3,1,16,18,34
778_1,,,,2,2,1,3
780_0,,,,2,2,1,3
C(C(CO)(C(C)(C(C=O)O)O)O)=O,,,3,1,15,18,33
780_1,,,,2,2,1,3
782_0,,,,2,2,1,3
C(C(C(CO)(C(C)O)O)=O)=O,,,3,1,12,17,29
782_1,,,,2,2,1,3
784_0,,,,2,2,1,3
C(C(CO)(C(C)O)O)=O,,,3,1,12,17,29
784_1,,,,2,2,1,3
786_0,,,,2,2,1,3
C(C(C(CO)O)(C(C)O)O)=O,,,3,1,11,14,25
786_1,,,,2,2,1,3
787_0,,,,2,2,1,3
787_1,,,,2,2,1,3
788_0,,,,2,2,1,3
788_1,,,,2,2,1,3
790_0,,,,2,2,1,3
C(C(C(C(C=O)=O)(CO)O)O)=O,,,3,1,16,24,40
790_1,,,,2,2,1,3
792_0,,,,2,2,1,3
C(C(C(CO)(CO)O)=O)=O,,,3,1,10,13,23
792_1,,,,2,2,1,3
794_0,,,,2,2,1,3
C(C(C(CO)(C(CO)O)O)=O)=O,,,3,1,16,20,36
794_1,,,,2,2,1,3
795_0,,,,2,2,1,3
797_0,,,,2,2,1,3
C(C(C(CO)(CO)O)(CC=O)O)=O,,,3,1,8,10,18
799_0,,,,2,2,1,3
C(C(C)(C(CO)(CO)O)O)(O)=O,,,3,1,6,5,11
801_0,,,,2,2,1,3
C(C(C(CO)(CO)O)O)(O)=O,,,3,1,11,8,19
803_0,,,,2,2,1,3
C(C(C(CO)(C(CO)O)O)O)(O)=O,,,3,1,13,11,24
805_0,,,,2,2,1,3
C(C(C(C=O)(CC=O)O)O)(O)=O,,,3,1,14,16,30
807_0,,,,2,2,1,3
C(C(C)(C(C(O)=O)O)O)(O)=O,,,3,1,13,10,23
809_0,,,,2,2,1,3
C(C(CCO)(C(C(O)=O)O)O)(O)=O,,,3,1,13,11,24
810_0,,,,2,2,1,3
812_0,,,,2,2,1,3
C(C(C(C(CO)(CO)O)O)O)(O)=O,,,3,1,11,9,20
814_0,,,,2,2,1,3
C(CC(C=O)(C(C=O)(C)O)O)=O,,,3,1,7,15,22
816_0,,,,2,2,1,3
C(C(C)(C(C=O)(C)O)O)(O)=O,,,3,1,7,9,16
818_0,,,,2,2,1,3
C(C(CCO)(C(C=O)(C)O)O)(O)=O,,,3,1,10,11,21
820_0,,,,2,2,1,3
C(C(C)(C(C(O)=O)O)O)=O,,,3,1,15,17,32
822_0,,,,2,2,1,3
C(CC(C=O)(C(C(C)=O)O)O)=O,,,3,1,12,17,29
824_0,,,,2,2,1,3
C(C(C)(C(C(C)=O)O)O)(O)=O,,,3,1,14,12,26
826_0,,,,2,2,1,3
C(C(CCO)(C(C(C)=O)O)O)(O)=O,,,3,1,12,11,23
828_0,,,,2,2,1,3
C(C(C(C(C)=O)O)O)(O)=O,,,3,1,29,26,55
830_0,,,,2,2,1,3
C(CC(C(C=O)(CC=O)O)O)=O,,,3,1,14,21,35
832_0,,,,2,2,1,3
C(C(C)(C(CC=O)O)O)(O)=O,,,3,1,12,13,25
834_0,,,,2,2,1,3
C(C(C(CC=O)O)(CCO)O)(O)=O,,,3,1,12,12,24
836_0,,,,2,2,1,3
C(CC(C(C(O)=O)O)O)=O,,,3,1,25,25,50
838_0,,,,2,2,1,3
C(C(C)(C(C=O)(CCO)O)O)(O)=O,,,3,1,10,11,21
840_0,,,,2,2,1,3
C(C(CCO)(C(C(O)=O)O)O)=O,,,3,1,13,13,26
842_0,,,,2,2,1,3
C(C(C)(C(C(CCO)=O)O)O)(O)=O,,,3,1,12,11,23
844_0,,,,2,2,1,3
C(C(C(C(O)=O)O)O)(CCO)=O,,,3,1,16,13,29
846_0,,,,2,2,1,3
C(C(C(C)O)(CC=O)O)=O,,,3,1,16,20,36
848_0,,,,2,2,1,3
C(CC(C=O)(C(C=O)(CO)O)O)=O,,,3,1,12,17,29
850_0,,,,2,2,1,3
C(CC(C=O)(C(C(CO)=O)O)O)=O,,,3,1,16,18,34
852_0,,,,2,2,1,3
C(C(C(C(CO)O)O)(CC=O)O)=O,,,3,1,14,16,30
854_0,,,,2,2,1,3
C(CC(C=O)(C(C=O)O)O)=O,,,3,1,15,22,37
855_0,,,,2,2,1,3
856_0,,,,2,2,1,3
858_0,,,,2,2,1,3
C(C(C)(C(C(CC=O)O)O)O)(O)=O,,,3,1,12,13,25
859_0,,,,2,2,1,3
861_0,,,,2,2,1,3
C(C(C)(C(CC(C=O)O)O)O)(O)=O,,,3,1,12,13,25
863_0,,,,2,2,1,3
C(C(C(CC(C=O)O)O)O)(O)=O,,,3,1,17,18,35
865_0,,,,2,2,1,3
C(C(C)(C(CC(CO)=O)O)O)(O)=O,,,3,1,11,10,21
867_0,,,,2,2,1,3
C(C(C(CC(CO)=O)O)O)(O)=O,,,3,1,15,12,27
869_0,,,,2,2,1,3
C(C(C)(C(CO)(CC=O)O)O)(O)=O,,,3,1,11,11,22
871_0,,,,2,2,1,3
C(CC(CO)(C(C(O)=O)O)O)=O,,,3,1,15,14,29
873_0,,,,2,2,1,3
C(C(C)(C(C(C(C)=O)O)O)O)(O)=O,,,3,1,12,12,24
875_0,,,,2,2,1,3
C(C(C(C(C(C)=O)O)O)O)(O)=O,,,3,1,16,14,30
877_0,,,,2,2,1,3
C(C(C)(C(C)(C(C=O)O)O)O)(O)=O,,,3,1,12,13,25
879_0,,,,2,2,1,3
C(C(C(C)(C(C=O)O)O)O)(O)=O,,,3,1,15,16,31
881_0,,,,2,2,1,3
C(C(C)(C(C)O)O)(O)=O,,,3,1,6,8,14
883_0,,,,2,2,1,3
C(C(C(C)O)(CCO)O)(O)=O,,,3,1,8,7,15
885_0,,,,2,2,1,3
C(C(C(C)O)O)(O)=O,,,3,1,36,47,83
887_0,,,,2,2,1,3
C(C(C)(C(C=O)(CO)O)O)(O)=O,,,3,1,11,14,25
889_0,,,,2,2,1,3
C(C(C)(C(C(CO)=O)O)O)(O)=O,,,3,1,11,10,21
891_0,,,,2,2,1,3
C(C(C)(C(C(CO)O)O)O)(O)=O,,,3,1,10,10,20
893_0,,,,2,2,1,3
C(C(C)(C(C=O)O)O)(O)=O,,,3,1,19,19,38
895_0,,,,2,2,1,3
C(C(CO)(C)O)(O)=O,,,3,1,8,10,18
897_0,,,,2,2,1,3
C(C(C)(C(CO)O)O)(O)=O,,,3,1,8,7,15
899_0,,,,2,2,1,3
C(C(CCO)(C(C=O)O)O)(O)=O,,,3,1,13,15,28
901_0,,,,2,2,1,3
C(C(CO)(CCO)O)(O)=O,,,3,1,8,6,14
903_0,,,,2,2,1,3
C(C(C(CO)O)(CCO)O)(O)=O,,,3,1,10,9,19
904_0,,,,2,2,1,3
905_0,,,,2,2,1,3
906_0,,,,2,2,1,3
907_0,,,,2,2,1,3
908_0,,,,2,1,2,3
909_0,,,,2,1,2,3
910_0,,,,2,1,2,3
911_0,,,,2,1,2,3
912_0,,,,2,1,2,3
913_0,,,,2,1,2,3
915_0,,,,2,1,2,3
C(C(CC(CO)=O)O)=O,,,3,1,47,51,98
916_0,,,,2,1,2,3
917_0,,,,2,1,2,3
918_0,,,,2,1,2,3
919_0,,,,2,1,2,3
920_0,,,,2,1,2,3
922_0,,,,2,1,2,3
C(CC(C=O)O)(C(CO)O)=O,,,3,1,23,22,45
923_0,,,,2,1,2,3
924_0,,,,2,1,2,3
925_0,,,,2,1,2,3
926_0,,,,2,1,2,3
927_0,,,,2,1,2,3
928_0,,,,2,1,2,3
930_0,,,,2,1,2,3
C(CC(C=O)=O)=O,,,3,1,173,278,451
931_0,,,,2,1,2,3
932_0,,,,2,1,2,3
933_0,,,,2,1,2,3
934_0,,,,2,1,2,3
935_0,,,,2,1,2,3
936_0,,,,2,1,2,3
937_0,,,,2,1,2,3
938_0,,,,2,1,2,3
939_0,,,,2,1,2,3
940_0,,,,2,1,2,3
941_0,,,,2,1,2,3
942_0,,,,2,1,2,3
943_0,,,,2,1,2,3
945_0,,,,2,1,2,3
C(C(CO)(CC(CO)=O)O)=O,,,3,1,15,17,32
946_0,,,,2,1,2,3
948_0,,,,2,1,2,3
C(C(C(CCO)=O)(CO)O)=O,,,3,1,9,12,21
950_0,,,,2,1,2,3
C(C(C(C(CO)O)=O)CO)=O,,,3,1,18,17,35
951_0,,,,2,1,2,3
952_0,,,,2,1,2,3
954_0,,,,2,1,2,3
C(C(C(C=O)=O)CO)=O,,,3,1,29,30,59
955_0,,,,2,1,2,3
956_0,,,,2,1,2,3
957_0,,,,2,1,2,3
958_0,,,,2,1,2,3
959_0,,,,2,1,2,3
960_0,,,,2,1,2,3
962_0,,,,2,1,2,3
C(C(C(C=O)=O)C(CO)O)=O,,,3,1,16,19,35
963_0,,,,2,1,2,3
964_0,,,,2,1,2,3
965_0,,,,2,1,2,3
966_0,,,,2,1,2,3
967_0,,,,2,1,2,3
968_0,,,,2,1,2,3
970_0,,,,2,1,2,3
C(C(CC(CO)O)=O)(O)=O,,,3,1,16,18,34
972_0,,,,2,1,2,3
C(C(CC(CO)=O)O)(O)=O,,,3,1,27,24,51
973_0,,,,2,1,2,3
975_0,,,,2,1,2,3
C(CC(C(CO)O)=O)(O)=O,,,3,1,23,23,46
977_0,,,,2,1,2,3
C(C(C(CCO)=O)O)(O)=O,,,3,1,25,21,46
978_0,,,,2,1,2,3
980_0,,,,2,1,2,3
C(C(CC(C(CO)O)O)=O)(O)=O,,,3,1,12,15,27
982_0,,,,2,1,2,3
C(CC(C(O)=O)O)(C(CO)O)=O,,,3,1,16,13,29
983_0,,,,2,1,2,3
985_0,,,,2,1,2,3
C(CC(C(C(CO)O)O)=O)(O)=O,,,3,1,12,14,26
987_0,,,,2,1,2,3
C(C(C(CC(CO)O)=O)O)(O)=O,,,3,1,14,12,26
988_0,,,,2,1,2,3
989_0,,,,2,1,2,3
990_0,,,,2,1,2,3
992_0,,,,2,1,2,3
C(CC(C=O)=O)(O)=O,,,3,1,69,76,145
994_0,,,,2,1,2,3
C(CC(C(O)=O)=O)=O,,,3,1,67,75,142
996_0,,,,2,1,2,3
C1(COCC1O)=O,,,3,1,163,231,394
998_0,,,,2,1,2,3
C1(C(O)OCC1)=O,,,3,1,139,193,332
1000_0,,,,2,1,2,3
C1(CC(CO1)O)=O,,,3,1,39,68,107
1002_0,,,,2,1,2,3
C1(COC(C1)O)=O,,,3,1,140,234,374
1003_0,,,,2,1,2,3
1005_0,,,,2,1,2,3
C(C(C(C)=O)=O)=O,,,3,1,147,221,368
1007_0,,,,2,1,2,3
C=CC(C=O)=O,,,3,1,284,495,779
1009_0,,,,2,1,2,3
C(C=CC=O)=O,,,3,1,189,344,533
1011_0,,,,2,1,2,3
C=CC(O)=O,,,3,1,146,405,551
1013_0,,,,2,1,2,3
C(CO)=CC(O)=O,,,3,1,39,73,112
1015_0,,,,2,1,2,3
C(C(C=C)O)(O)=O,,,3,1,34,54,88
1016_0,,,,2,2,1,3
1017_0,,,,2,2,1,3
1018_0,,,,2,2,1,3
1019_0,,,,2,2,1,3
1020_0,,,,2,2,1,3
1021_0,,,,2,2,1,3
1022_0,,,,2,2,1,3
1023_0,,,,2,2,1,3
1025_0,,,,2,1,1,2
C(C1C(C(C(O)O1)O)O)O,,,3,1,3,5,8
1027_0,,,,2,1,1,2
C(C(C1C(C(C(O)O1)O)O)O)O,,,3,1,6,7,13
1029_0,,,,2,1,1,2
C1(C(CO)(C(C(CO)O1)O)O)O,,,3,1,3,4,7
1031_0,,,,2,1,1,2
C(C1(COC(C1O)O)O)=O,,,3,1,6,11,17
1033_0,,,,2,1,1,2
C1C(C(C(O)O1)(CO)O)O,,,3,1,3,4,7
1035_0,,,,2,1,1,2
C(C1(C(CO)OC(C1O)O)O)=O,,,3,1,7,11,18
1037_0,,,,2,1,1,2
C(C(C1(C(O)OCC1O)O)O)=O,,,3,1,9,13,22
1039_0,,,,2,1,1,2
C1C(C(C(O)O1)(C(CO)O)O)O,,,3,1,6,6,12
1041_0,,,,2,1,1,2
C1(C(C(C(O)O1)O)O)=O,,,3,1,13,21,34
1042_0,,,,2,1,1,2
1043_0,,,,2,1,1,2
1045_0,,,,2,1,1,2
C1(C(O)OCC1O)=O,,,3,1,85,76,161
1047_0,,,,2,1,1,2
C1C(C(C(C(O)O1)O)O)O,,,3,1,5,7,12
1049_0,,,,2,1,1,2
C(C1C(C(C(C(O)O1)O)O)O)O,,,3,1,6,7,13
1051_0,,,,2,1,1,2
C1C(C(C(C(O)O1)(CO)O)O)O,,,3,1,5,6,11
1053_0,,,,2,1,1,2
C(C1(C(C(O)OCC1O)O)O)=O,,,3,1,8,14,22
1055_0,,,,2,1,1,2
C1C(C(C(C(C(O)O1)O)O)O)O,,,3,1,7,9,16
1056_0,,,,2,1,1,2
1058_0,,,,2,1,2,3
C(=O)=O,,,3,1,806,1524,2330
1060_0,,,,2,1,2,3
C1(C(C(CO1)O)O)=O,,,3,1,33,44,77
1062_0,,,,2,1,2,3
C1(C(C(C(CO)O1)O)O)=O,,,3,1,11,9,20
1064_0,,,,2,1,2,3
C1(C(C(C(C(CO)O)O1)O)O)=O,,,3,1,10,5,15
1066_0,,,,2,1,2,3
C1(C(CCO1)O)=O,,,3,1,35,68,103
1068_0,,,,2,1,2,3
C1(C(C(C(CO1)O)O)O)=O,,,3,1,12,12,24
1070_0,,,,2,1,2,3
C1(C(C(C(C(CO)O1)O)O)O)=O,,,3,1,9,6,15
1072_0,,,,2,1,2,3
C1(C(C(C(C(CO1)O)O)O)O)=O,,,3,1,9,9,18
1073_0,,,,2,3,5,8
1074_0,,,,2,3,5,8
1076_0,,,,2,3,5,8
C(C(C(C(CO)O)O)=O)(O)=O,,,3,1,14,15,29
1078_0,,,,2,3,5,8
C(C(C(C(C(CO)O)O)O)=O)(O)=O,,,3,1,14,17,31
1080_0,,,,2,3,5,8
C(C(C(C(O)=O)=O)O)=O,,,3,1,26,28,54
1081_0,,,,2,3,5,8
1082_0,,,,2,3,5,8
1083_0,,,,2,5,3,8
1085_0,,,,2,2,2,4
C(C(CC(CO)O)O)(O)=O,,,3,1,13,11,24
1087_0,,,,2,2,2,4
C(C(CC(C(CO)O)O)O)(O)=O,,,3,1,13,11,24
1088_0,,,,2,2,2,4
1090_0,,,,2,2,2,4
C(CC(C(O)=O)O)(O)=O,,,3,1,18,18,36
1091_0,,,,2,3,5,8
1092_0,,,,2,3,5,8
1093_0,,,,2,3,5,8
1095_0,,,,2,3,5,8
C(C(C(C=O)=O)(CO)O)=O,,,3,1,11,16,27
1097_0,,,,2,3,5,8
C(C(C(C=O)=O)(C(CO)O)O)=O,,,3,1,12,18,30
1099_0,,,,2,3,5,8
C(C(C(C=O)=O)O)(O)=O,,,3,1,31,30,61
1100_0,,,,2,3,5,8
1102_0,,,,2,5,3,8
C(C(O)O)=O,,,3,1,323,572,895
1104_0,,,,2,5,3,8
C(C(C)O)=O,,,3,1,376,615,991
1105_0,,,,2,5,3,8
1106_0,,,,2,5,3,8
1107_0,,,,2,5,3,8
1108_0,,,,2,4,4,8
1109_0,,,,2,4,4,8
1110_0,,,,2,4,4,8
1111_0,,,,2,4,4,8
1112_0,,,,2,4,4,8
1113_0,,,,2,4,4,8
1114_0,,,,2,4,4,8
1115_0,,,,2,4,4,8
1117_0,,,,2,4,3,7
[CH](C(O)=O)O,,,3,1,85,275,360
1119_0,,,,2,1,1,2
C(C(C1C(C(C(C1O)O)O)O)=O)=O,,,4,1,2,13,15
1119_1,,,,2,1,1,2
1121_0,,,,2,1,1,2
C(C1C(C(C(C1O)O)O)O)=O,,,4,1,3,12,15
1121_1,,,,2,1,1,2
1123_0,,,,2,1,1,2
C1(C(C(C(C)(C1O)O)O)O)=O,,,4,1,11,15,26
1123_1,,,,2,1,1,2
1124_0,,,,2,1,1,2
1124_1,,,,2,1,1,2
1126_0,,,,2,1,1,2
C1(C(C(C(CO)(C1)O)O)O)=O,,,4,1,6,16,22
1128_0,,,,2,1,1,2
C1(C(C(CC(C1O)O)O)O)=O,,,4,1,5,8,13
1128_1,,,,2,1,1,2
1130_0,,,,2,1,1,2
C1(C(C(C(C1O)O)(CCO)O)O)=O,,,4,1,6,14,20
1130_1,,,,2,1,1,2
1131_0,,,,2,1,1,2
1131_1,,,,2,1,1,2
1133_0,,,,2,1,1,2
C1(C(C(C(CO)(C1CO)O)O)O)=O,,,4,1,8,15,23
1133_1,,,,2,1,1,2
1135_0,,,,2,1,1,2
C1(C(C(C(CC(C1O)O)O)O)O)=O,,,4,1,5,16,21
1135_1,,,,2,1,1,2
1137_0,,,,2,1,1,2
C(C1C(C(C(C1(CO)O)O)O)O)=O,,,4,1,6,18,24
1137_1,,,,2,1,1,2
1138_0,,,,2,1,1,2
1138_1,,,,2,1,1,2
1140_0,,,,2,1,1,2
C1(C(C(CO)(CC(C1O)O)O)O)=O,,,4,1,5,14,19
1140_1,,,,2,1,1,2
1142_0,,,,2,1,1,2
C1(C(C(CO)(C(C(C1)O)O)O)O)=O,,,4,1,6,13,19
1142_1,,,,2,1,1,2
1143_0,,,,2,1,1,2
1143_1,,,,2,1,1,2
1145_0,,,,2,1,1,2
C1(C(C(C)(C(C(C1O)O)O)O)O)=O,,,4,1,4,14,18
1145_1,,,,2,1,1,2
1147_0,,,,2,1,1,2
C1(C(C(C(C(CO)(C1)O)O)O)O)=O,,,4,1,4,14,18
1148_0,,,,2,1,1,2
1148_1,,,,2,1,1,2
1150_0,,,,2,1,1,2
C1(C(C(C(CO)(C1O)O)O)O)=O,,,4,1,8,13,21
1150_1,,,,2,1,1,2
1151_0,,,,2,1,1,2
1151_1,,,,2,1,1,2
1153_0,,,,2,1,1,2
C1(C(C(C(C1O)O)O)O)=O,,,4,1,6,13,19
1153_1,,,,2,1,1,2
1155_0,,,,2,1,1,2
C1(C(C(C(C(CO)O)(C1)O)O)O)=O,,,4,1,5,15,20
1157_0,,,,2,1,1,2
C(C1C(C(CO)(C(C1O)O)O)O)=O,,,4,1,7,18,25
1157_1,,,,2,1,1,2
1158_0,,,,2,1,1,2
1158_1,,,,2,1,1,2
1160_0,,,,2,1,1,2
C(C1C(C(C(C1(C)O)O)O)=O)=O,,,4,1,5,18,23
1160_1,,,,2,1,1,2
1162_0,,,,2,1,1,2
C(C1C(C(C(C)(C1O)O)O)=O)=O,,,4,1,5,17,22
1162_1,,,,2,1,1,2
1164_0,,,,2,1,1,2
C(C1(CC(C(C1)=O)O)O)=O,,,4,1,5,21,26
1166_0,,,,2,1,1,2
C1(CC(C(CC1O)=O)O)=O,,,4,1,4,14,18
1168_0,,,,2,1,1,2
C(C1C(CC(C1O)=O)O)=O,,,4,1,9,27,36
1170_0,,,,2,1,1,2
C(C1(C(CO)C(C(C1)=O)O)O)=O,,,4,1,2,14,16
1172_0,,,,2,1,1,2
C1(C(C(C(C(C1)O)=O)CO)O)=O,,,4,1,6,14,20
1174_0,,,,2,1,1,2
C(C1C(C(CC(C1O)=O)O)O)=O,,,4,1,6,20,26
1176_0,,,,2,1,1,2
C1(C(C(C(C1)O)C(C=O)O)O)=O,,,4,1,2,18,20
1178_0,,,,2,1,1,2
C(CO)(C1C(CC(C1O)=O)O)=O,,,4,1,7,16,23
1180_0,,,,2,1,1,2
C(C1C(CO)(CC(C1O)=O)O)=O,,,4,1,7,17,24
1181_0,,,,2,1,1,2
1181_1,,,,2,1,1,2
1183_0,,,,2,1,1,2
C1(C(C(C(CC(C1)O)=O)O)O)=O,,,4,1,3,7,10
1185_0,,,,2,1,1,2
C(CC1(C(C(C(C1)=O)O)O)O)=O,,,4,1,4,19,23
1186_0,,,,2,1,1,2
1186_1,,,,2,1,1,2
1188_0,,,,2,1,1,2
C1(CC(C(CC(C1O)O)=O)O)=O,,,4,1,4,13,17
1190_0,,,,2,1,1,2
C1(C(CC(C(C=O)O)(C1)O)O)=O,,,4,1,2,19,21
1192_0,,,,2,1,1,2
C1(C(CC(C1)O)O)=O,,,4,1,4,82,86
1194_0,,,,2,1,1,2
C(C1(C(C(C(C1)=O)O)O)O)=O,,,4,1,6,19,25
1196_0,,,,2,1,1,2
C1(C(C(C(CC1O)=O)O)O)=O,,,4,1,10,19,29
1198_0,,,,2,1,1,2
C1(C(C(C(C1)O)O)O)=O,,,4,1,9,40,49
1199_0,,,,2,1,1,2
1199_1,,,,2,1,1,2
1201_0,,,,2,1,1,2
C1(C(CO)C(C=O)(CC1O)O)=O,,,4,1,6,15,21
1201_1,,,,2,1,1,2
1202_0,,,,2,1,1,2
1202_1,,,,2,1,1,2
1204_0,,,,2,1,1,2
C(C(C1C(C(CC1O)O)O)=O)=O,,,4,1,4,22,26
1204_1,,,,2,1,1,2
1206_0,,,,2,1,1,2
C(C1C(C(CC1(C=O)O)O)O)=O,,,4,1,5,21,26
1206_1,,,,2,1,1,2
1207_0,,,,2,1,1,2
1207_1,,,,2,1,1,2
1208_0,,,,2,1,1,2
1208_1,,,,2,1,1,2
1210_0,,,,2,1,1,2
C(C1(CC(CC(C1O)=O)O)O)=O,,,4,1,4,17,21
1210_1,,,,2,1,1,2
1211_0,,,,2,1,1,2
1211_1,,,,2,1,1,2
1212_0,,,,2,1,1,2
1212_1,,,,2,1,1,2
1213_0,,,,2,1,1,2
1213_1,,,,2,1,1,2
1215_0,,,,2,1,1,2
C(C1(CC(C(C(C1)=O)O)O)O)=O,,,4,1,3,17,20
1216_0,,,,2,1,1,2
1218_0,,,,2,1,1,2
C(C1(CC(C(C1O)=O)O)O)=O,,,4,1,7,16,23
1218_1,,,,2,1,1,2
1219_0,,,,2,1,1,2
1219_1,,,,2,1,1,2
1221_0,,,,2,1,1,2
C(C1C(C(C(C1O)=O)CO)O)=O,,,4,1,10,19,29
1221_1,,,,2,1,1,2
1223_0,,,,2,1,1,2
C(C1C(C(C=O)C(C1O)O)O)=O,,,4,1,5,12,17
1223_1,,,,2,1,1,2
1225_0,,,,2,1,1,2
C(C1C(C(C(CC1O)O)O)=O)=O,,,4,1,5,17,22
1225_1,,,,2,1,1,2
1227_0,,,,2,1,1,2
C(C1C(CC(C(C1O)O)=O)O)=O,,,4,1,8,19,27
1227_1,,,,2,1,1,2
1228_0,,,,2,1,1,2
1228_1,,,,2,1,1,2
1229_0,,,,2,1,1,2
1229_1,,,,2,1,1,2
1231_0,,,,2,1,1,2
C(C1C(C(C(C1O)=O)O)O)=O,,,4,1,12,21,33
1231_1,,,,2,1,1,2
1232_0,,,,2,1,1,2
1232_1,,,,2,1,1,2
1233_0,,,,2,1,1,2
1233_1,,,,2,1,1,2
1234_0,,,,2,1,1,2
1234_1,,,,2,1,1,2
1235_0,,,,2,1,1,2
1236_0,,,,2,1,1,2
1236_1,,,,2,1,1,2
1238_0,,,,2,1,1,2
C1(C(CC(C1CO)O)O)=O,,,4,1,4,17,21
1238_1,,,,2,1,1,2
1240_0,,,,2,1,1,2
C1(C(CO)C(C=O)(C(C1O)O)O)=O,,,4,1,6,18,24
1240_1,,,,2,1,1,2
1242_0,,,,2,1,1,2
C1(C(C(C(C(C1CO)O)=O)O)O)=O,,,4,1,6,17,23
1242_1,,,,2,1,1,2
1244_0,,,,2,1,1,2
C1(C(C(C(C1CO)O)O)O)=O,,,4,1,7,17,24
1244_1,,,,2,1,1,2
1246_0,,,,2,1,1,2
C(C1(C(CO)C(C(C1O)=O)O)O)=O,,,4,1,3,16,19
1246_1,,,,2,1,1,2
1247_0,,,,2,1,1,2
1247_1,,,,2,1,1,2
1249_0,,,,2,1,1,2
C(C1C(C(CC1O)O)O)=O,,,4,1,4,19,23
1249_1,,,,2,1,1,2
1251_0,,,,2,1,1,2
C(C1C(C(C(C1(C=O)O)O)O)O)=O,,,4,1,5,23,28
1251_1,,,,2,1,1,2
1253_0,,,,2,1,1,2
C(C1C(C(C(C(C1O)=O)O)O)O)=O,,,4,1,6,21,27
1253_1,,,,2,1,1,2
1254_0,,,,2,1,1,2
1254_1,,,,2,1,1,2
1255_0,,,,2,1,1,2
1255_1,,,,2,1,1,2
1257_0,,,,2,1,1,2
C(C(C1C(C(C(C1O)=O)O)O)O)=O,,,4,1,4,20,24
1257_1,,,,2,1,1,2
1259_0,,,,2,1,1,2
C1(C(C(CC(C1)O)O)O)=O,,,4,1,3,23,26
1259_1,,,,2,1,1,2
1261_0,,,,2,1,1,2
C(C1(C(C(CC(C1O)=O)O)O)O)=O,,,4,1,7,21,28
1261_1,,,,2,1,1,2
1263_0,,,,2,1,1,2
C(CO)(C1C(C(C(C1O)=O)O)O)=O,,,4,1,8,19,27
1263_1,,,,2,1,1,2
1265_0,,,,2,1,1,2
C1(C(C(C(C(C(C1)O)O)=O)O)O)=O,,,4,1,8,17,25
1265_1,,,,2,1,1,2
1267_0,,,,2,1,1,2
C1(C(C(C(C(C1)O)O)O)O)=O,,,4,1,4,16,20
1267_1,,,,2,1,1,2
1269_0,,,,2,1,1,2
C(C1C(CO)(C(C(C1O)=O)O)O)=O,,,4,1,7,18,25
1269_1,,,,2,1,1,2
1271_0,,,,2,1,1,2
C(C1C(C(C(C1(CO)O)O)O)=O)=O,,,4,1,5,18,23
1271_1,,,,2,1,1,2
1273_0,,,,2,1,1,2
C(C1C(C(C(CO)(C1O)O)O)=O)=O,,,4,1,5,18,23
1273_1,,,,2,1,1,2
1274_0,,,,2,1,1,2
1274_1,,,,2,1,1,2
1275_0,,,,2,1,1,2
1275_1,,,,2,1,1,2
1277_0,,,,2,1,1,2
C(C1C(C(C(C1O)O)O)=O)=O,,,4,1,7,21,28
1277_1,,,,2,1,1,2
1278_0,,,,2,1,1,2
1278_1,,,,2,1,1,2
1279_0,,,,2,1,1,2
1279_1,,,,2,1,1,2
1280_0,,,,2,1,1,2
1280_1,,,,2,1,1,2
1282_0,,,,2,1,1,2
C(CC1(C(C(C(C1O)=O)O)O)O)=O,,,4,1,5,19,24
1282_1,,,,2,1,1,2
1283_0,,,,2,1,1,2
1283_1,,,,2,1,1,2
1284_0,,,,2,1,1,2
1286_0,,,,2,1,1,2
C(C1(C(C(C(C(C1)=O)O)O)O)O)=O,,,4,1,4,19,23
1288_0,,,,2,1,1,2
C1(CC(C(C(C(C1O)O)O)=O)O)=O,,,4,1,6,17,23
1289_0,,,,2,1,1,2
1290_0,,,,2,1,1,2
1290_1,,,,2,1,1,2
1292_0,,,,2,1,1,2
C(C(C1(CC(C(C1O)=O)O)O)O)=O,,,4,1,2,19,21
1292_1,,,,2,1,1,2
1294_0,,,,2,1,1,2
C1(C(C(CC1O)O)O)=O,,,4,1,8,33,41
1294_1,,,,2,1,1,2
1296_0,,,,2,1,1,2
C(C1(C(C(C(C1O)=O)O)O)O)=O,,,4,1,9,20,29
1296_1,,,,2,1,1,2
1298_0,,,,2,1,1,2
C1(C(C(C(C(C1O)O)=O)O)O)=O,,,4,1,2,4,6
1298_1,,,,2,1,1,2
1300_0,,,,2,1,1,2
C1(C(C(C(C1)O)(C(C=O)O)O)O)=O,,,4,1,4,19,23
1301_0,,,,2,1,1,2
1303_0,,,,2,1,1,2
C(C1C(C(C=O)(C(C1O)O)O)O)=O,,,4,1,8,24,32
1303_1,,,,2,1,1,2
1305_0,,,,2,1,1,2
C1(C(C(C(C)(C1(CO)O)O)O)O)=O,,,4,1,7,14,21
1305_1,,,,2,1,1,2
1307_0,,,,2,1,1,2
C1(C(C(C)(C(C1(CO)O)O)O)O)=O,,,4,1,7,14,21
1307_1,,,,2,1,1,2
1309_0,,,,2,1,1,2
C1(C(C(CO)(C(CO)(C1)O)O)O)=O,,,4,1,3,12,15
1311_0,,,,2,1,1,2
C1(C(C(CC(C1(CO)O)O)O)O)=O,,,4,1,7,15,22
1311_1,,,,2,1,1,2
1313_0,,,,2,1,1,2
C1(C(C(C(C1(CO)O)O)O)O)=O,,,4,1,8,15,23
1313_1,,,,2,1,1,2
1315_0,,,,2,1,1,2
C(C1(C(CC(C1(C)O)O)=O)O)=O,,,4,1,3,12,15
1317_0,,,,2,1,1,2
C(C)(C1(C(CC(C1O)=O)O)O)=O,,,4,1,8,16,24
1319_0,,,,2,1,1,2
C(C1(C(C)(CC(C1O)=O)O)O)=O,,,4,1,5,16,21
1321_0,,,,2,1,1,2
C(C1(C(CC(C)(C1O)O)=O)O)=O,,,4,1,3,13,16
1323_0,,,,2,1,1,2
C(C1(C(CO)(C(C(C1)=O)O)O)O)=O,,,4,1,2,15,17
1325_0,,,,2,1,1,2
C1(C(C(C(C(C1)O)=O)(CO)O)O)=O,,,4,1,5,16,21
1327_0,,,,2,1,1,2
C1(C(C(C(C1)O)(CO)O)O)=O,,,4,1,8,15,23
1329_0,,,,2,1,1,2
C1(C(C(C(C1)O)(C(CO)O)O)O)=O,,,4,1,7,14,21
1331_0,,,,2,1,1,2
C(C1(C(CC(CC1O)O)=O)O)=O,,,4,1,3,12,15
1333_0,,,,2,1,1,2
C(C1C(C(C(C1O)=O)(CO)O)O)=O,,,4,1,9,20,29
1333_1,,,,2,1,1,2
1335_0,,,,2,1,1,2
C1(C(C(CO)(C(C1CO)O)O)O)=O,,,4,1,8,14,22
1335_1,,,,2,1,1,2
1337_0,,,,2,1,1,2
C1(C(C(C(C(C1)O)(CO)O)O)O)=O,,,4,1,4,12,16
1337_1,,,,2,1,1,2
1339_0,,,,2,1,1,2
C(C1(C(CC(C1(CO)O)O)=O)O)=O,,,4,1,3,13,16
1341_0,,,,2,1,1,2
C(C1(C(CC(CO)(C1O)O)=O)O)=O,,,4,1,3,15,18
1343_0,,,,2,1,1,2
C(C)(C1(C(C(C(C1O)=O)O)O)O)=O,,,4,1,9,19,28
1343_1,,,,2,1,1,2
1345_0,,,,2,1,1,2
C(C1(C(C)(C(C(C1O)=O)O)O)O)=O,,,4,1,6,18,24
1345_1,,,,2,1,1,2
1347_0,,,,2,1,1,2
C(C1(C(CC(C1O)O)=O)O)=O,,,4,1,4,15,19
1348_0,,,,2,1,1,2
1350_0,,,,2,1,1,2
C(CC1(C(CC(C1O)=O)O)O)=O,,,4,1,4,17,21
1351_0,,,,2,1,1,2
1353_0,,,,2,1,1,2
C(C1C(C(C=O)(CC1O)O)O)=O,,,4,1,4,20,24
1353_1,,,,2,1,1,2
1355_0,,,,2,1,1,2
C(C1C(CC(C1(C=O)O)O)O)=O,,,4,1,6,20,26
1355_1,,,,2,1,1,2
1356_0,,,,2,1,1,2
1356_1,,,,2,1,1,2
1358_0,,,,2,1,1,2
C(C1(CC(C(C(C1O)=O)O)O)O)=O,,,4,1,5,19,24
1358_1,,,,2,1,1,2
1359_0,,,,2,1,1,2
1359_1,,,,2,1,1,2
1360_0,,,,2,1,1,2
1360_1,,,,2,1,1,2
1362_0,,,,2,2,1,3
C(C(CO)C(C(C(C=O)O)O)O)=O,,,4,1,13,24,37
1362_1,,,,2,2,1,3
1363_0,,,,2,2,1,3
1363_1,,,,2,2,1,3
1365_0,,,,2,2,1,3
C(CC(CC(CO)(CO)O)O)=O,,,4,1,2,10,12
1367_0,,,,2,2,1,3
C(C(C(CC(CO)(CO)O)O)O)=O,,,4,1,5,13,18
1367_1,,,,2,2,1,3
1369_0,,,,2,2,1,3
C(C(C=O)C(CO)(CO)O)(O)=O,,,4,1,7,11,18
1369_1,,,,2,2,1,3
1370_0,,,,2,2,1,3
1370_1,,,,2,2,1,3
1372_0,,,,2,2,1,3
C(C(C(C)O)C(CO)(CO)O)=O,,,4,1,5,12,17
1372_1,,,,2,2,1,3
1374_0,,,,2,2,1,3
C(C(CO)C(CO)(CO)O)=O,,,4,1,7,12,19
1374_1,,,,2,2,1,3
1376_0,,,,2,2,1,3
C(C(C(CO)O)C(CO)(CO)O)=O,,,4,1,7,12,19
1376_1,,,,2,2,1,3
1378_0,,,,2,2,1,3
C(CC(C(C(CO)(CO)O)O)O)=O,,,4,1,4,10,14
1379_0,,,,2,2,1,3
1379_1,,,,2,2,1,3
1380_0,,,,2,2,1,3
1380_1,,,,2,2,1,3
1381_0,,,,2,2,1,3
1382_0,,,,2,2,1,3
1382_1,,,,2,2,1,3
1384_0,,,,2,2,1,3
C(C(CO)C(C(C(CO)=O)O)O)=O,,,4,1,11,18,29
1384_1,,,,2,2,1,3
1385_0,,,,2,2,1,3
1385_1,,,,2,2,1,3
1387_0,,,,2,2,1,3
C(CC(CO)(C(C(C)O)O)O)=O,,,4,1,2,13,15
1389_0,,,,2,2,1,3
C(C(C(CO)(C(C(C)O)O)O)O)=O,,,4,1,7,14,21
1389_1,,,,2,2,1,3
1391_0,,,,2,2,1,3
C(C(C(C(C(C)O)O)=O)O)(O)=O,,,4,1,9,12,21
1391_1,,,,2,2,1,3
1393_0,,,,2,2,1,3
C(C(C(C=O)O)O)(C(C(C)O)O)=O,,,4,1,7,21,28
1393_1,,,,2,2,1,3
1395_0,,,,2,2,1,3
C(C(C(C)O)O)(C(C(C)O)O)=O,,,4,1,2,6,8
1395_1,,,,2,2,1,3
1396_0,,,,2,2,1,3
1396_1,,,,2,2,1,3
1398_0,,,,2,2,1,3
C(C(C(CO)O)O)(C(C(C)O)O)=O,,,4,1,7,14,21
1398_1,,,,2,2,1,3
1399_0,,,,2,2,1,3
1401_0,,,,2,2,1,3
C(CC(CO)(C(C(C=O)O)O)O)=O,,,4,1,10,22,32
1403_0,,,,2,2,1,3
C(C(C(C(C(C=O)O)O)=O)O)(O)=O,,,4,1,10,21,31
1403_1,,,,2,2,1,3
1404_0,,,,2,2,1,3
1404_1,,,,2,2,1,3
1405_0,,,,2,2,1,3
1405_1,,,,2,2,1,3
1407_0,,,,2,2,1,3
C(CC(CO)(C(C(CO)O)O)O)=O,,,4,1,8,13,21
1409_0,,,,2,2,1,3
C(C(C(C(C(CO)O)O)=O)O)(O)=O,,,4,1,11,15,26
1409_1,,,,2,2,1,3
1410_0,,,,2,2,1,3
1410_1,,,,2,2,1,3
1411_0,,,,2,2,1,3
1411_1,,,,2,2,1,3
1413_0,,,,2,2,1,3
C(C(CO)C(CO)(C(CO)O)O)=O,,,4,1,9,14,23
1413_1,,,,2,2,1,3
1415_0,,,,2,2,1,3
C(CC(C(CO)O)(C(CO)O)O)=O,,,4,1,4,8,12
1417_0,,,,2,2,1,3
C(C(CC(C=O)(CC=O)O)O)(O)=O,,,4,1,7,14,21
1419_0,,,,2,2,1,3
C(C(CC(C(CC=O)O)=O)O)(O)=O,,,4,1,7,14,21
1421_0,,,,2,2,1,3
C(C(C(C=O)=O)C(C(O)=O)O)(O)=O,,,4,1,8,14,22
1421_1,,,,2,2,1,3
1423_0,,,,2,2,1,3
C(C(C(C(C=O)=O)C(C)O)O)(O)=O,,,4,1,6,16,22
1423_1,,,,2,2,1,3
1424_0,,,,2,2,1,3
1424_1,,,,2,2,1,3
1426_0,,,,2,2,1,3
C(CC(C(C=O)C(C(O)=O)O)O)=O,,,4,1,10,17,27
1428_0,,,,2,2,1,3
C(C(CO)C(CC(C(O)=O)O)O)=O,,,4,1,11,16,27
1428_1,,,,2,2,1,3
1430_0,,,,2,2,1,3
C(C(CC(C(C(C)=O)O)O)O)(O)=O,,,4,1,8,14,22
1430_1,,,,2,2,1,3
1432_0,,,,2,2,1,3
C(C(CC(CC(CO)=O)O)O)(O)=O,,,4,1,9,11,20
1434_0,,,,2,2,1,3
C(C(CC(CC(C=O)=O)O)O)(O)=O,,,4,1,8,15,23
1436_0,,,,2,2,1,3
C(C(C=O)C(CC(C(O)=O)O)O)=O,,,4,1,8,12,20
1436_1,,,,2,2,1,3
1438_0,,,,2,2,1,3
C(CC(CC(C(O)=O)O)O)=O,,,4,1,10,16,26
1440_0,,,,2,2,1,3
C(C(CC(C(C=O)O)O)O)(O)=O,,,4,1,13,19,32
1440_1,,,,2,2,1,3
1442_0,,,,2,2,1,3
C(C(C(CCO)O)C(C(O)=O)O)=O,,,4,1,10,15,25
1442_1,,,,2,2,1,3
1444_0,,,,2,2,1,3
C(C(C(CO)(C)O)C(C(O)=O)O)=O,,,4,1,10,15,25
1444_1,,,,2,2,1,3
1446_0,,,,2,2,1,3
C(C(C=O)C(C(O)=O)O)(O)=O,,,4,1,12,14,26
1446_1,,,,2,2,1,3
1448_0,,,,2,2,1,3
C(C(C(C(O)O)O)C(C(O)=O)O)=O,,,4,1,9,15,24
1448_1,,,,2,2,1,3
1450_0,,,,2,2,1,3
C(C(C(C(C)O)O)C(C(O)=O)O)=O,,,4,1,9,16,25
1450_1,,,,2,2,1,3
1451_0,,,,2,2,1,3
1451_1,,,,2,2,1,3
1453_0,,,,2,2,1,3
C(C(C(C=O)C(C(O)=O)O)O)(O)=O,,,4,1,7,9,16
1453_1,,,,2,2,1,3
1455_0,,,,2,2,1,3
C(C(C(C=O)C(C=O)(C)O)O)(O)=O,,,4,1,9,15,24
1455_1,,,,2,2,1,3
1457_0,,,,2,2,1,3
C(C(C(C=O)C(C(C)=O)O)O)(O)=O,,,4,1,9,15,24
1457_1,,,,2,2,1,3
1458_0,,,,2,2,1,3
1458_1,,,,2,2,1,3
1460_0,,,,2,2,1,3
C(C(C(C)O)C(C(O)=O)O)=O,,,4,1,11,16,27
1460_1,,,,2,2,1,3
1462_0,,,,2,2,1,3
C(C(CO)C(C(O)=O)O)=O,,,4,1,15,20,35
1462_1,,,,2,2,1,3
1464_0,,,,2,2,1,3
C(C(C(CO)O)C(C(O)=O)O)=O,,,4,1,14,17,31
1464_1,,,,2,2,1,3
1466_0,,,,2,2,1,3
C(C(CO)C(C(CO)(CO)O)O)=O,,,4,1,7,11,18
1466_1,,,,2,2,1,3
1468_0,,,,2,2,1,3
C(C(C)(CC(C=O)(CC=O)O)O)=O,,,4,1,1,13,14
1470_0,,,,2,2,1,3
C(CC(C(CC(C=O)(C)O)=O)O)=O,,,4,1,2,15,17
1472_0,,,,2,2,1,3
C(CC(C(C)(CC(C=O)=O)O)O)=O,,,4,1,2,19,21
1474_0,,,,2,2,1,3
C(C(C(C=O)=O)C(C=O)(C)O)(O)=O,,,4,1,6,12,18
1474_1,,,,2,2,1,3
1476_0,,,,2,2,1,3
C(C(C)(C(C(C=O)=O)C(C)O)O)=O,,,4,1,4,14,18
1476_1,,,,2,2,1,3
1477_0,,,,2,2,1,3
1477_1,,,,2,2,1,3
1479_0,,,,2,2,1,3
C(CC(C(C=O)C(C=O)(C)O)O)=O,,,4,1,5,16,21
1481_0,,,,2,2,1,3
C(C(C=O)C(C)(C(CC=O)O)O)=O,,,4,1,3,14,17
1483_0,,,,2,2,1,3
C(C(CO)C(CC(C=O)(C)O)O)=O,,,4,1,5,15,20
1483_1,,,,2,2,1,3
1485_0,,,,2,2,1,3
C(C(C)(CC(C(C(C)=O)O)O)O)=O,,,4,1,2,15,17
1485_1,,,,2,2,1,3
1487_0,,,,2,2,1,3
C(C(C)(CC(CC(CO)=O)O)O)=O,,,4,1,2,13,15
1489_0,,,,2,2,1,3
C(C(C)(CC(CC(C=O)=O)O)O)=O,,,4,1,1,14,15
1491_0,,,,2,2,1,3
C(C(C=O)C(CC(C=O)(C)O)O)=O,,,4,1,2,11,13
1491_1,,,,2,2,1,3
1493_0,,,,2,2,1,3
C(C(C)(CC(CC=O)O)O)=O,,,4,1,3,16,19
1495_0,,,,2,2,1,3
C(C(C)(CC(C(C=O)O)O)O)=O,,,4,1,4,20,24
1495_1,,,,2,2,1,3
1497_0,,,,2,2,1,3
C(C(CO)C(C(C)(CC=O)O)O)=O,,,4,1,6,18,24
1497_1,,,,2,2,1,3
1499_0,,,,2,2,1,3
C(CC(C)(C(C(C(C)=O)O)O)O)=O,,,4,1,3,18,21
1499_1,,,,2,2,1,3
1501_0,,,,2,2,1,3
C(CC(C)(C(CC(CO)=O)O)O)=O,,,4,1,3,16,19
1503_0,,,,2,2,1,3
C(CC(C)(C(CC(C=O)=O)O)O)=O,,,4,1,2,19,21
1505_0,,,,2,2,1,3
C(C(C=O)C(C(C)(CC=O)O)O)=O,,,4,1,3,14,17
1505_1,,,,2,2,1,3
1507_0,,,,2,2,1,3
C(CC(C(C)(CC=O)O)O)=O,,,4,1,6,22,28
1509_0,,,,2,2,1,3
C(CC(C)(C(C(C=O)O)O)O)=O,,,4,1,3,24,27
1509_1,,,,2,2,1,3
1511_0,,,,2,2,1,3
C(C(C(CCO)O)C(C=O)(C)O)=O,,,4,1,5,14,19
1511_1,,,,2,2,1,3
1513_0,,,,2,2,1,3
C(C(C(CO)(C)O)C(C=O)(C)O)=O,,,4,1,5,14,19
1513_1,,,,2,2,1,3
1515_0,,,,2,2,1,3
C(C(C=O)C(C=O)(C)O)(O)=O,,,4,1,6,13,19
1515_1,,,,2,2,1,3
1517_0,,,,2,2,1,3
C(C(C(C(O)O)O)C(C=O)(C)O)=O,,,4,1,4,14,18
1517_1,,,,2,2,1,3
1519_0,,,,2,2,1,3
C(C(C(C(C)O)O)C(C=O)(C)O)=O,,,4,1,4,15,19
1519_1,,,,2,2,1,3
1520_0,,,,2,2,1,3
1520_1,,,,2,2,1,3
1521_0,,,,2,2,1,3
1521_1,,,,2,2,1,3
1523_0,,,,2,2,1,3
C(C(C)(C(C=O)C(C=O)(C)O)O)=O,,,4,1,2,7,9
1523_1,,,,2,2,1,3
1525_0,,,,2,2,1,3
C(C(C(C=O)C(C=O)(C)O)O)(C)=O,,,4,1,4,14,18
1525_1,,,,2,2,1,3
1526_0,,,,2,2,1,3
1526_1,,,,2,2,1,3
1528_0,,,,2,2,1,3
C(C(C(C)O)C(C=O)(C)O)=O,,,4,1,4,15,19
1528_1,,,,2,2,1,3
1530_0,,,,2,2,1,3
C(C(CO)C(C=O)(C)O)=O,,,4,1,8,18,26
1530_1,,,,2,2,1,3
1532_0,,,,2,2,1,3
C(C(C(CO)O)C(C=O)(C)O)=O,,,4,1,7,17,24
1532_1,,,,2,2,1,3
1534_0,,,,2,2,1,3
C(C(C)(C(C(CC=O)O)O)O)=O,,,4,1,4,18,22
1536_0,,,,2,2,1,3
C(C(C)(C(C(C(C=O)O)O)O)O)=O,,,4,1,8,21,29
1536_1,,,,2,2,1,3
1538_0,,,,2,2,1,3
C(CC(C(C)(C(C=O)O)O)O)=O,,,4,1,4,22,26
1540_0,,,,2,2,1,3
C(C(C(C(C)(C(C=O)O)O)O)O)=O,,,4,1,8,24,32
1540_1,,,,2,2,1,3
1542_0,,,,2,2,1,3
C(C)(C(CC(C=O)(CC=O)O)O)=O,,,4,1,1,15,16
1544_0,,,,2,2,1,3
C(CC(C(CC(C(C)=O)O)=O)O)=O,,,4,1,2,17,19
1545_0,,,,2,2,1,3
1547_0,,,,2,2,1,3
C(C(C(C=O)=O)C(C(C)=O)O)(O)=O,,,4,1,6,13,19
1547_1,,,,2,2,1,3
1549_0,,,,2,2,1,3
C(C(C(C(C=O)=O)C(C)O)O)(C)=O,,,4,1,4,15,19
1549_1,,,,2,2,1,3
1550_0,,,,2,2,1,3
1550_1,,,,2,2,1,3
1552_0,,,,2,2,1,3
C(CC(C(CC(C=O)=O)O)=O)(O)=O,,,4,1,3,14,17
1554_0,,,,2,2,1,3
C(C(CC(C=O)=O)O)(CC(C)O)=O,,,4,1,2,14,16
1555_0,,,,2,2,1,3
1557_0,,,,2,2,1,3
C(CC(C(C=O)C(C(C)=O)O)O)=O,,,4,1,5,18,23
1558_0,,,,2,2,1,3
1560_0,,,,2,2,1,3
C(C(C=O)C(C(CC(O)=O)=O)O)=O,,,4,1,4,11,15
1562_0,,,,2,2,1,3
C(C(C=O)C(C(CC(C)O)=O)O)=O,,,4,1,3,11,14
1563_0,,,,2,2,1,3
1565_0,,,,2,2,1,3
C(C(CO)C(CC(C(C)=O)O)O)=O,,,4,1,5,16,21
1565_1,,,,2,2,1,3
1567_0,,,,2,2,1,3
C(C)(C(C(CC(C(C)=O)O)O)O)=O,,,4,1,2,16,18
1567_1,,,,2,2,1,3
1569_0,,,,2,2,1,3
C(C)(C(CC(CC(CO)=O)O)O)=O,,,4,1,2,14,16
1571_0,,,,2,2,1,3
C(C)(C(CC(CC(C=O)=O)O)O)=O,,,4,1,1,17,18
1573_0,,,,2,2,1,3
C(C(C=O)C(CC(C(C)=O)O)O)=O,,,4,1,2,12,14
1573_1,,,,2,2,1,3
1575_0,,,,2,2,1,3
C(CC(CC(C(C)=O)O)O)=O,,,4,1,5,19,24
1577_0,,,,2,2,1,3
C(C(C(CC(C(C)=O)O)O)O)=O,,,4,1,5,21,26
1577_1,,,,2,2,1,3
1579_0,,,,2,2,1,3
C(C(CO)C(C)(C(CC=O)O)O)=O,,,4,1,6,18,24
1579_1,,,,2,2,1,3
1581_0,,,,2,2,1,3
C(CC(C(C)(C(C(C)=O)O)O)O)=O,,,4,1,3,17,20
1581_1,,,,2,2,1,3
1583_0,,,,2,2,1,3
C(CC(C(C)(CC(CO)=O)O)O)=O,,,4,1,3,16,19
1584_0,,,,2,2,1,3
1585_0,,,,2,2,1,3
1585_1,,,,2,2,1,3
1586_0,,,,2,2,1,3
1587_0,,,,2,2,1,3
1587_1,,,,2,2,1,3
1589_0,,,,2,2,1,3
C(C(C(CCO)O)C(C(C)=O)O)=O,,,4,1,5,14,19
1589_1,,,,2,2,1,3
1591_0,,,,2,2,1,3
C(C(C(CO)(C)O)C(C(C)=O)O)=O,,,4,1,5,14,19
1591_1,,,,2,2,1,3
1593_0,,,,2,2,1,3
C(C(C=O)C(C(C)=O)O)(O)=O,,,4,1,10,15,25
1593_1,,,,2,2,1,3
1595_0,,,,2,2,1,3
C(C(C(C(O)O)O)C(C(C)=O)O)=O,,,4,1,4,14,18
1595_1,,,,2,2,1,3
1597_0,,,,2,2,1,3
C(C(C(C(C)O)O)C(C(C)=O)O)=O,,,4,1,4,15,19
1597_1,,,,2,2,1,3
1598_0,,,,2,2,1,3
1598_1,,,,2,2,1,3
1599_0,,,,2,2,1,3
1599_1,,,,2,2,1,3
1600_0,,,,2,2,1,3
1600_1,,,,2,2,1,3
1602_0,,,,2,2,1,3
C(C(C(C(C)=O)O)C(C(C)=O)O)=O,,,4,1,2,8,10
1602_1,,,,2,2,1,3
1603_0,,,,2,2,1,3
1603_1,,,,2,2,1,3
1605_0,,,,2,2,1,3
C(C(C(C)O)C(C(C)=O)O)=O,,,4,1,8,17,25
1605_1,,,,2,2,1,3
1607_0,,,,2,2,1,3
C(C(CO)C(C(C)=O)O)=O,,,4,1,15,24,39
1607_1,,,,2,2,1,3
1609_0,,,,2,2,1,3
C(C(C(CO)O)C(C(C)=O)O)=O,,,4,1,8,17,25
1609_1,,,,2,2,1,3
1611_0,,,,2,2,1,3
C(CC(C(CC(CCO)O)=O)O)=O,,,4,1,3,12,15
1613_0,,,,2,2,1,3
C(CC(C(CC(CO)(C)O)=O)O)=O,,,4,1,3,12,15
1615_0,,,,2,2,1,3
C(CC(C(CC=O)O)=O)(O)=O,,,4,1,9,18,27
1617_0,,,,2,2,1,3
C(CC(C(CC(C(O)O)O)=O)O)=O,,,4,1,2,12,14
1619_0,,,,2,2,1,3
C(CC(C(CC(C(C)O)O)=O)O)=O,,,4,1,2,13,15
1621_0,,,,2,2,1,3
C(CC(C(CC(C=O)O)=O)O)=O,,,4,1,8,22,30
1622_0,,,,2,2,1,3
1623_0,,,,2,2,1,3
1624_0,,,,2,2,1,3
1626_0,,,,2,2,1,3
C(CC(C(CC(CC=O)O)=O)O)=O,,,4,1,3,18,21
1628_0,,,,2,2,1,3
C(CC(C(CC(C)O)=O)O)=O,,,4,1,6,18,24
1629_0,,,,2,2,1,3
1631_0,,,,2,2,1,3
C(CC(C(CC(CO)O)=O)O)=O,,,4,1,4,15,19
1632_0,,,,2,2,1,3
1634_0,,,,2,2,1,3
C(CC(C(C(C(C)=O)O)O)O)=O,,,4,1,6,21,27
1636_0,,,,2,2,1,3
C(C(C(C(C(C(C)=O)O)O)O)O)=O,,,4,1,9,24,33
1636_1,,,,2,2,1,3
1637_0,,,,2,2,1,3
1638_0,,,,2,2,1,3
1638_1,,,,2,2,1,3
1640_0,,,,2,2,1,3
C(CC(C(C(C=O)O)O)=O)(O)=O,,,4,1,8,21,29
1642_0,,,,2,2,1,3
C(C(C(C(CC(C=O)O)=O)O)O)=O,,,4,1,12,26,38
1644_0,,,,2,2,1,3
C(C(C(C=O)O)O)(CC(C)O)=O,,,4,1,5,20,25
1645_0,,,,2,2,1,3
1647_0,,,,2,2,1,3
C(C(C(C=O)O)O)(CC(CO)O)=O,,,4,1,8,19,27
1649_0,,,,2,2,1,3
C(CC(CC(CC(C=O)=O)O)O)=O,,,4,1,3,19,22
1651_0,,,,2,2,1,3
C(CC(CC(C=O)(CC=O)O)O)=O,,,4,1,2,18,20
1652_0,,,,2,2,1,3
1654_0,,,,2,2,1,3
C(C(C=O)C(CC(C=O)=O)O)(O)=O,,,4,1,7,14,21
1654_1,,,,2,2,1,3
1656_0,,,,2,2,1,3
C(C(C(CC(C=O)=O)O)C(C)O)=O,,,4,1,6,16,22
1656_1,,,,2,2,1,3
1658_0,,,,2,2,1,3
C(C(CO)C(CC(C=O)=O)O)=O,,,4,1,10,21,31
1658_1,,,,2,2,1,3
1660_0,,,,2,2,1,3
C(C(C(C=O)=O)C(CC=O)O)(O)=O,,,4,1,7,15,22
1660_1,,,,2,2,1,3
1662_0,,,,2,2,1,3
C(CC(C(C(C=O)=O)C(C)O)O)=O,,,4,1,6,17,23
1662_1,,,,2,2,1,3
1663_0,,,,2,2,1,3
1663_1,,,,2,2,1,3
1665_0,,,,2,2,1,3
C(C(CO)C(C=O)(CC(C)O)O)=O,,,4,1,5,14,19
1665_1,,,,2,2,1,3
1667_0,,,,2,2,1,3
C(C(CC(C)O)(C(C(C)=O)O)O)=O,,,4,1,3,13,16
1667_1,,,,2,2,1,3
1669_0,,,,2,2,1,3
C(C(CC(C)O)(CC(CO)=O)O)=O,,,4,1,2,12,14
1671_0,,,,2,2,1,3
C(C(CC(C)O)(CC(C=O)=O)O)=O,,,4,1,1,12,13
1673_0,,,,2,2,1,3
C(C(C=O)C(C=O)(CC(C)O)O)=O,,,4,1,2,10,12
1673_1,,,,2,2,1,3
1675_0,,,,2,2,1,3
C(C(CC(C)O)(CC=O)O)=O,,,4,1,3,14,17
1677_0,,,,2,2,1,3
C(C(CC(C)O)(C(C=O)O)O)=O,,,4,1,3,17,20
1677_1,,,,2,2,1,3
1679_0,,,,2,2,1,3
C(C(CO)C(C(CC(C)O)=O)O)=O,,,4,1,6,15,21
1679_1,,,,2,2,1,3
1681_0,,,,2,2,1,3
C(C(C(C(CC(C)O)=O)O)O)(C)=O,,,4,1,5,15,20
1681_1,,,,2,2,1,3
1683_0,,,,2,2,1,3
C(CC(C(CC(C)O)=O)O)(CO)=O,,,4,1,3,13,16
1684_0,,,,2,2,1,3
1685_0,,,,2,2,1,3
1685_1,,,,2,2,1,3
1686_0,,,,2,2,1,3
1687_0,,,,2,2,1,3
1687_1,,,,2,2,1,3
1689_0,,,,2,2,1,3
C(C(C(C(C)O)C(CCO)O)=O)=O,,,4,1,5,15,20
1689_1,,,,2,2,1,3
1691_0,,,,2,2,1,3
C(C(C(C(C)O)C(C)(CO)O)=O)=O,,,4,1,5,15,20
1691_1,,,,2,2,1,3
1693_0,,,,2,2,1,3
C(C(C(C=O)=O)C(C)O)(O)=O,,,4,1,10,15,25
1693_1,,,,2,2,1,3
1695_0,,,,2,2,1,3
C(C(C(C(C(O)O)O)C(C)O)=O)=O,,,4,1,4,15,19
1695_1,,,,2,2,1,3
1697_0,,,,2,2,1,3
C(C(C(C(C)O)C(C(C)O)O)=O)=O,,,4,1,4,16,20
1697_1,,,,2,2,1,3
1699_0,,,,2,2,1,3
C(C(C(C(C=O)=O)C(C)O)O)=O,,,4,1,4,21,25
1699_1,,,,2,2,1,3
1700_0,,,,2,2,1,3
1700_1,,,,2,2,1,3
1701_0,,,,2,2,1,3
1701_1,,,,2,2,1,3
1702_0,,,,2,2,1,3
1702_1,,,,2,2,1,3
1703_0,,,,2,2,1,3
1703_1,,,,2,2,1,3
1705_0,,,,2,2,1,3
C(C(C(C(C)O)C(C)O)=O)=O,,,4,1,4,12,16
1705_1,,,,2,2,1,3
1706_0,,,,2,2,1,3
1706_1,,,,2,2,1,3
1708_0,,,,2,2,1,3
C(C(C(C(CO)O)C(C)O)=O)=O,,,4,1,5,19,24
1708_1,,,,2,2,1,3
1709_0,,,,2,2,1,3
1709_1,,,,2,2,1,3
1710_0,,,,2,2,1,3
1710_1,,,,2,2,1,3
1711_0,,,,2,2,1,3
1711_1,,,,2,2,1,3
1712_0,,,,2,2,1,3
1712_1,,,,2,2,1,3
1713_0,,,,2,2,1,3
1714_0,,,,2,2,1,3
1714_1,,,,2,2,1,3
1716_0,,,,2,2,1,3
C(C(CC(C=O)(CC=O)O)O)=O,,,4,1,7,20,27
1718_0,,,,2,2,1,3
C(C(CC(C=O)(C(C=O)O)O)O)=O,,,4,1,9,21,30
1718_1,,,,2,2,1,3
1719_0,,,,2,2,1,3
1720_0,,,,2,2,1,3
1720_1,,,,2,2,1,3
1722_0,,,,2,2,1,3
C(C(C(C=O)=O)C(C=O)O)(O)=O,,,4,1,8,19,27
1722_1,,,,2,2,1,3
1724_0,,,,2,2,1,3
C(C(C(C(C=O)=O)C(C=O)O)O)=O,,,4,1,2,10,12
1724_1,,,,2,2,1,3
1725_0,,,,2,2,1,3
1725_1,,,,2,2,1,3
1726_0,,,,2,2,1,3
1726_1,,,,2,2,1,3
1728_0,,,,2,2,1,3
C(C(C(C(C=O)=O)C(CO)O)O)=O,,,4,1,5,19,24
1728_1,,,,2,2,1,3
1730_0,,,,2,2,1,3
C(C(CC(CO)O)(CC=O)O)=O,,,4,1,2,15,17
1732_0,,,,2,2,1,3
C(C(CC(CO)O)(C(C=O)O)O)=O,,,4,1,5,17,22
1732_1,,,,2,2,1,3
1733_0,,,,2,2,1,3
1734_0,,,,2,2,1,3
1734_1,,,,2,2,1,3
1736_0,,,,2,2,1,3
C(C(C(C=O)=O)C(CO)O)(O)=O,,,4,1,9,18,27
1736_1,,,,2,2,1,3
1737_0,,,,2,2,1,3
1737_1,,,,2,2,1,3
1738_0,,,,2,2,1,3
1738_1,,,,2,2,1,3
1739_0,,,,2,2,1,3
1739_1,,,,2,2,1,3
1741_0,,,,2,2,1,3
C(C(C(C(CO)O)C(CO)O)=O)=O,,,4,1,3,10,13
1741_1,,,,2,2,1,3
1743_0,,,,2,2,1,3
C(C(C(CC=O)O)C(CC=O)O)=O,,,4,1,3,10,13
1745_0,,,,2,2,1,3
C(C(C=O)C(CC(CC=O)O)O)=O,,,4,1,3,14,17
1747_0,,,,2,2,1,3
C(C(C=O)C(C(C=O)C=O)O)(O)=O,,,4,1,6,11,17
1747_1,,,,2,2,1,3
1749_0,,,,2,2,1,3
C(C(C=O)C(C(C=O)C(C)O)O)=O,,,4,1,6,13,19
1749_1,,,,2,2,1,3
1751_0,,,,2,2,1,3
C(C(C=O)C(C(C=O)CO)O)=O,,,4,1,8,16,24
1751_1,,,,2,2,1,3
1753_0,,,,2,2,1,3
C(C(CO)C(CC(CC=O)O)O)=O,,,4,1,6,17,23
1753_1,,,,2,2,1,3
1755_0,,,,2,2,1,3
C(CC(CC(C(C(C)=O)O)O)O)=O,,,4,1,3,18,21
1755_1,,,,2,2,1,3
1757_0,,,,2,2,1,3
C(CC(CC(CC(CO)=O)O)O)=O,,,4,1,4,16,20
1758_0,,,,2,2,1,3
1759_0,,,,2,2,1,3
1759_1,,,,2,2,1,3
1761_0,,,,2,2,1,3
C(CC(CC(CC=O)O)O)=O,,,4,1,4,11,15
1763_0,,,,2,2,1,3
C(CC(CC(C(C=O)O)O)O)=O,,,4,1,7,24,31
1763_1,,,,2,2,1,3
1765_0,,,,2,2,1,3
C(C(C(CC=O)O)C(CCO)O)=O,,,4,1,6,14,20
1765_1,,,,2,2,1,3
1767_0,,,,2,2,1,3
C(C(C(CC=O)O)C(C)(CO)O)=O,,,4,1,6,15,21
1767_1,,,,2,2,1,3
1769_0,,,,2,2,1,3
C(C(C=O)C(CC=O)O)(O)=O,,,4,1,10,17,27
1769_1,,,,2,2,1,3
1771_0,,,,2,2,1,3
C(C(C(CC=O)O)C(C(O)O)O)=O,,,4,1,5,15,20
1771_1,,,,2,2,1,3
1773_0,,,,2,2,1,3
C(C(C(CC=O)O)C(C(C)O)O)=O,,,4,1,5,16,21
1773_1,,,,2,2,1,3
1774_0,,,,2,2,1,3
1774_1,,,,2,2,1,3
1775_0,,,,2,2,1,3
1775_1,,,,2,2,1,3
1776_0,,,,2,2,1,3
1776_1,,,,2,2,1,3
1777_0,,,,2,2,1,3
1777_1,,,,2,2,1,3
1778_0,,,,2,2,1,3
1778_1,,,,2,2,1,3
1780_0,,,,2,2,1,3
C(C(C(CC=O)O)C(C)O)=O,,,4,1,9,19,28
1780_1,,,,2,2,1,3
1782_0,,,,2,2,1,3
C(C(CO)C(CC=O)O)=O,,,4,1,17,26,43
1782_1,,,,2,2,1,3
1784_0,,,,2,2,1,3
C(C(C(CC=O)O)C(CO)O)=O,,,4,1,9,19,28
1784_1,,,,2,2,1,3
1786_0,,,,2,2,1,3
C(C(CO)C(C(C(C=O)=O)O)O)=O,,,4,1,9,20,29
1786_1,,,,2,2,1,3
1788_0,,,,2,2,1,3
C(CC(C(C(CC=O)O)O)O)=O,,,4,1,2,11,13
1790_0,,,,2,2,1,3
C(CC(C(C(C(C=O)O)O)O)O)=O,,,4,1,9,24,33
1790_1,,,,2,2,1,3
1791_0,,,,2,2,1,3
1793_0,,,,2,2,1,3
C(C(C(CC(C(C=O)O)O)O)O)=O,,,4,1,4,13,17
1793_1,,,,2,2,1,3
1795_0,,,,2,2,1,3
C(C(C=O)C(C(C=O)O)O)(O)=O,,,4,1,9,21,30
1795_1,,,,2,2,1,3
1797_0,,,,2,2,1,3
C(C(C(C(C=O)C(C=O)O)O)O)=O,,,4,1,15,25,40
1797_1,,,,2,2,1,3
1799_0,,,,2,2,1,3
C(C(C(C(C=O)O)O)C(C)O)=O,,,4,1,8,22,30
1799_1,,,,2,2,1,3
1801_0,,,,2,2,1,3
C(C(CO)C(C(C=O)O)O)=O,,,4,1,15,24,39
1801_1,,,,2,2,1,3
1803_0,,,,2,2,1,3
C(C(C(C(C=O)O)O)C(CO)O)=O,,,4,1,11,21,32
1803_1,,,,2,2,1,3
1805_0,,,,2,2,1,3
C(C(CO)C(C(C=O)C(C)O)O)=O,,,4,1,9,17,26
1805_1,,,,2,2,1,3
1807_0,,,,2,2,1,3
C(C(C(C(C(C)=O)O)O)C(C)O)=O,,,4,1,7,16,23
1807_1,,,,2,2,1,3
1809_0,,,,2,2,1,3
C(C(C(CC(CO)=O)O)C(C)O)=O,,,4,1,7,15,22
1810_0,,,,2,2,1,3
1811_0,,,,2,2,1,3
1811_1,,,,2,2,1,3
1812_0,,,,2,2,1,3
1813_0,,,,2,2,1,3
1813_1,,,,2,2,1,3
1814_0,,,,2,2,1,3
1814_1,,,,2,2,1,3
1815_0,,,,2,2,1,3
1816_0,,,,2,2,1,3
1816_1,,,,2,2,1,3
1817_0,,,,2,2,1,3
1818_0,,,,2,2,1,3
1818_1,,,,2,2,1,3
1819_0,,,,2,2,1,3
1819_1,,,,2,2,1,3
1821_0,,,,2,2,1,3
C(C(CO)C(C(C=O)CO)O)=O,,,4,1,6,10,16
1821_1,,,,2,2,1,3
1823_0,,,,2,2,1,3
C(C(CO)C(C(C(C)=O)O)O)=O,,,4,1,10,18,28
1823_1,,,,2,2,1,3
1825_0,,,,2,2,1,3
C(C(CO)C(CC(CO)=O)O)=O,,,4,1,10,17,27
1827_0,,,,2,2,1,3
C(C(CO)C(CC(C(O)=O)=O)O)=O,,,4,1,8,16,24
1829_0,,,,2,2,1,3
C(C(C=O)C(C(C=O)CO)O)(O)=O,,,4,1,10,16,26
1829_1,,,,2,2,1,3
1830_0,,,,2,2,1,3
1830_1,,,,2,2,1,3
1831_0,,,,2,2,1,3
1832_0,,,,2,2,1,3
1832_1,,,,2,2,1,3
1833_0,,,,2,2,1,3
1834_0,,,,2,2,1,3
1834_1,,,,2,2,1,3
1835_0,,,,2,2,1,3
1835_1,,,,2,2,1,3
1836_0,,,,2,2,1,3
1837_0,,,,2,2,1,3
1837_1,,,,2,2,1,3
1839_0,,,,2,2,1,3
C(C(CCO)(CC(CC=O)O)O)=O,,,4,1,2,13,15
1841_0,,,,2,2,1,3
C(CC(C(CCO)(CC=O)O)O)=O,,,4,1,2,17,19
1843_0,,,,2,2,1,3
C(C(C=O)C(C=O)(CCO)O)(O)=O,,,4,1,8,13,21
1843_1,,,,2,2,1,3
1845_0,,,,2,2,1,3
C(C(C(C)O)C(C=O)(CCO)O)=O,,,4,1,7,14,21
1845_1,,,,2,2,1,3
1847_0,,,,2,2,1,3
C(C(CO)C(C=O)(CCO)O)=O,,,4,1,9,16,25
1847_1,,,,2,2,1,3
1849_0,,,,2,2,1,3
C(CC(CC(C(CCO)=O)O)O)=O,,,4,1,2,15,17
1850_0,,,,2,2,1,3
1852_0,,,,2,2,1,3
C(C(C=O)C(C(CCO)=O)O)(O)=O,,,4,1,8,14,22
1852_1,,,,2,2,1,3
1854_0,,,,2,2,1,3
C(C(C(C)O)C(C(CCO)=O)O)=O,,,4,1,7,15,22
1854_1,,,,2,2,1,3
1856_0,,,,2,2,1,3
C(C(CO)C(C(CCO)=O)O)=O,,,4,1,10,17,27
1856_1,,,,2,2,1,3
1858_0,,,,2,2,1,3
C(CC(C(C(C(O)=O)CO)=O)O)=O,,,4,1,6,13,19
1858_1,,,,2,2,1,3
1860_0,,,,2,2,1,3
C(CC(C(C(CO)C(C)O)=O)O)=O,,,4,1,5,14,19
1860_1,,,,2,2,1,3
1862_0,,,,2,2,1,3
C(CC(C(C(CO)CO)=O)O)=O,,,4,1,5,12,17
1862_1,,,,2,2,1,3
1864_0,,,,2,2,1,3
C(C(C(C=O)O)O)(C(CO)CO)=O,,,4,1,9,16,25
1864_1,,,,2,2,1,3
1866_0,,,,2,2,1,3
C(C(C(CO)C(C)O)(CC=O)O)=O,,,4,1,2,12,14
1867_0,,,,2,2,1,3
1869_0,,,,2,2,1,3
C(C(C(CO)CO)(CC=O)O)=O,,,4,1,2,11,13
1871_0,,,,2,2,1,3
C(C(C(CO)CO)(C(C=O)O)O)=O,,,4,1,5,13,18
1871_1,,,,2,2,1,3
1872_0,,,,2,2,1,3
1873_0,,,,2,2,1,3
1873_1,,,,2,2,1,3
1875_0,,,,2,2,1,3
C(CC(C(CC(CC=O)O)O)O)=O,,,4,1,2,18,20
1877_0,,,,2,2,1,3
C(C(C=O)C(C(CC=O)O)O)(O)=O,,,4,1,7,18,25
1877_1,,,,2,2,1,3
1879_0,,,,2,2,1,3
C(C(C(C(CC=O)O)O)C(C)O)=O,,,4,1,6,19,25
1879_1,,,,2,2,1,3
1881_0,,,,2,2,1,3
C(C(CO)C(C(CC=O)O)O)=O,,,4,1,9,22,31
1881_1,,,,2,2,1,3
1883_0,,,,2,2,1,3
C(CC(CC(CC(C=O)O)O)O)=O,,,4,1,3,16,19
1884_0,,,,2,2,1,3
1886_0,,,,2,2,1,3
C(C(C=O)C(CC(C=O)O)O)(O)=O,,,4,1,8,17,25
1886_1,,,,2,2,1,3
1888_0,,,,2,2,1,3
C(C(C(C)O)C(CC(C=O)O)O)=O,,,4,1,7,18,25
1888_1,,,,2,2,1,3
1890_0,,,,2,2,1,3
C(C(CO)C(CC(C=O)O)O)=O,,,4,1,9,21,30
1890_1,,,,2,2,1,3
1891_0,,,,2,2,1,3
1893_0,,,,2,2,1,3
C(CC(C(C(C)O)C(C=O)O)O)=O,,,4,1,3,17,20
1894_0,,,,2,2,1,3
1895_0,,,,2,2,1,3
1895_1,,,,2,2,1,3
1897_0,,,,2,2,1,3
C(CC(C(CO)C(C=O)O)O)=O,,,4,1,5,20,25
1899_0,,,,2,2,1,3
C(C(C(C(CO)C(C=O)O)O)O)=O,,,4,1,7,22,29
1899_1,,,,2,2,1,3
1900_0,,,,2,2,1,3
1902_0,,,,2,2,1,3
C(CC(CC(CO)(CC=O)O)O)=O,,,4,1,4,17,21
1904_0,,,,2,2,1,3
C(C(C=O)C(CC(CO)=O)O)(O)=O,,,4,1,8,14,22
1904_1,,,,2,2,1,3
1905_0,,,,2,2,1,3
1905_1,,,,2,2,1,3
1906_0,,,,2,2,1,3
1906_1,,,,2,2,1,3
1908_0,,,,2,2,1,3
C(CC(C(C(O)=O)C(CO)=O)O)=O,,,4,1,8,14,22
1908_1,,,,2,2,1,3
1910_0,,,,2,2,1,3
C(CC(C(C(CO)=O)C(C)O)O)=O,,,4,1,7,15,22
1910_1,,,,2,2,1,3
1912_0,,,,2,2,1,3
C(CC(C(C(CO)=O)CO)O)=O,,,4,1,10,17,27
1912_1,,,,2,2,1,3
1914_0,,,,2,2,1,3
C(C(C(CC(CC=O)O)=O)O)(O)=O,,,4,1,8,13,21
1914_1,,,,2,2,1,3
1916_0,,,,2,2,1,3
C(CC(CC(C(C(C)O)O)=O)O)=O,,,4,1,4,14,18
1916_1,,,,2,2,1,3
1918_0,,,,2,2,1,3
C(CC(CC(C(CO)O)=O)O)=O,,,4,1,8,16,24
1918_1,,,,2,2,1,3
1920_0,,,,2,2,1,3
C(C(C(C(C(CO)=O)CO)O)O)=O,,,4,1,12,20,32
1920_1,,,,2,2,1,3
1922_0,,,,2,2,1,3
C(C(CO)O)(CC(C(C=O)O)O)=O,,,4,1,10,19,29
1922_1,,,,2,2,1,3
1923_0,,,,2,2,1,3
1925_0,,,,2,2,1,3
C(C(C=O)C(CO)(CC=O)O)(O)=O,,,4,1,9,14,23
1925_1,,,,2,2,1,3
1927_0,,,,2,2,1,3
C(C(C(C)O)C(CO)(CC=O)O)=O,,,4,1,8,15,23
1927_1,,,,2,2,1,3
1929_0,,,,2,2,1,3
C(C(CO)C(CO)(CC=O)O)=O,,,4,1,11,18,29
1929_1,,,,2,2,1,3
1931_0,,,,2,2,1,3
C(C(CO)C(CO)(C(C=O)O)O)=O,,,4,1,10,18,28
1931_1,,,,2,2,1,3
1932_0,,,,2,2,1,3
1933_0,,,,2,2,1,3
1935_0,,,,2,2,1,3
C(C(C(C(C(O)=O)O)=O)C(C)O)=O,,,4,1,4,12,16
1935_1,,,,2,2,1,3
1937_0,,,,2,2,1,3
C(C(C(C(C(C)O)O)=O)C(C)O)=O,,,4,1,5,13,18
1937_1,,,,2,2,1,3
1939_0,,,,2,2,1,3
C(C(C(C(CO)O)=O)C(C)O)=O,,,4,1,7,15,22
1939_1,,,,2,2,1,3
1941_0,,,,2,2,1,3
C(C(CO)O)(C(C=O)C(C=O)O)=O,,,4,1,8,18,26
1941_1,,,,2,2,1,3
1942_0,,,,2,2,1,3
1943_0,,,,2,2,1,3
1943_1,,,,2,2,1,3
1944_0,,,,2,2,1,3
1945_0,,,,2,2,1,3
1945_1,,,,2,2,1,3
1947_0,,,,2,2,1,3
C(C(C(C(C(O)=O)O)=O)CO)=O,,,4,1,8,14,22
1947_1,,,,2,2,1,3
1949_0,,,,2,2,1,3
C(C(C(C(C(C=O)O)O)=O)CO)=O,,,4,1,8,21,29
1949_1,,,,2,2,1,3
1951_0,,,,2,2,1,3
C(C(C(C(C(C)O)O)=O)CO)=O,,,4,1,7,15,22
1951_1,,,,2,2,1,3
1952_0,,,,2,2,1,3
1952_1,,,,2,2,1,3
1954_0,,,,2,2,1,3
C(C(C(C(C(CO)O)O)=O)CO)=O,,,4,1,11,15,26
1954_1,,,,2,2,1,3
1956_0,,,,2,2,1,3
C(C(C(C(CO)O)=O)C(CO)O)=O,,,4,1,10,15,25
1956_1,,,,2,2,1,3
1957_0,,,,2,2,1,3
1959_0,,,,2,2,1,3
C(CC(C(C(C)O)O)(CC=O)O)=O,,,4,1,1,9,10
1961_0,,,,2,2,1,3
C(C(C=O)C(C(C(C)O)O)=O)(O)=O,,,4,1,5,13,18
1961_1,,,,2,2,1,3
1962_0,,,,2,2,1,3
1962_1,,,,2,2,1,3
1963_0,,,,2,2,1,3
1963_1,,,,2,2,1,3
1964_0,,,,2,2,1,3
1964_1,,,,2,2,1,3
1965_0,,,,2,2,1,3
1966_0,,,,2,2,1,3
1966_1,,,,2,2,1,3
1968_0,,,,2,2,1,3
C(CC(C(CO)O)(CC=O)O)=O,,,4,1,2,10,12
1970_0,,,,2,2,1,3
C(CC(C(CO)O)(C(C=O)O)O)=O,,,4,1,5,17,22
1970_1,,,,2,2,1,3
1972_0,,,,2,2,1,3
C(C(C=O)C(C(CO)O)=O)(O)=O,,,4,1,8,15,23
1972_1,,,,2,2,1,3
1973_0,,,,2,2,1,3
1973_1,,,,2,2,1,3
1974_0,,,,2,2,1,3
1974_1,,,,2,2,1,3
1975_0,,,,2,2,1,3
1975_1,,,,2,2,1,3
1976_0,,,,2,2,1,3
1976_1,,,,2,2,1,3
1977_0,,,,2,2,1,3
1977_1,,,,2,2,1,3
1978_0,,,,2,2,1,3
1980_0,,,,2,2,1,3
C(CC(C)(C(C(CC=O)O)O)O)=O,,,4,1,2,18,20
1982_0,,,,2,2,1,3
C(C(C=O)C(C(C(C)=O)O)O)(O)=O,,,4,1,8,15,23
1982_1,,,,2,2,1,3
1983_0,,,,2,2,1,3
1983_1,,,,2,2,1,3
1984_0,,,,2,2,1,3
1984_1,,,,2,2,1,3
1986_0,,,,2,2,1,3
C(CC(C(C(CC(O)=O)=O)O)O)=O,,,4,1,5,15,20
1988_0,,,,2,2,1,3
C(CC(C(C(CC(C)O)=O)O)O)=O,,,4,1,4,14,18
1990_0,,,,2,2,1,3
C(CC(C(C(CCO)=O)O)O)=O,,,4,1,7,16,23
1992_0,,,,2,2,1,3
C(C(C(C(C=O)O)O)O)(CCO)=O,,,4,1,11,19,30
1994_0,,,,2,2,1,3
C(CC(CC(C)(C(C=O)O)O)O)=O,,,4,1,1,19,20
1995_0,,,,2,2,1,3
1997_0,,,,2,2,1,3
C(C(C=O)C(C)(C(C=O)O)O)(O)=O,,,4,1,7,16,23
1997_1,,,,2,2,1,3
1999_0,,,,2,2,1,3
C(C(C(C)O)C(C)(C(C=O)O)O)=O,,,4,1,6,17,23
1999_1,,,,2,2,1,3
2001_0,,,,2,2,1,3
C(C(CO)C(C)(C(C=O)O)O)=O,,,4,1,10,20,30
2001_1,,,,2,2,1,3
2002_0,,,,2,2,1,3
2004_0,,,,2,2,1,3
C(CC(CC(C)O)(C(C=O)O)O)=O,,,4,1,1,15,16
2006_0,,,,2,2,1,3
C(C(C(C(C=O)O)=O)C(C)O)(O)=O,,,4,1,4,12,16
2006_1,,,,2,2,1,3
2008_0,,,,2,2,1,3
C(C(C(C(C(C)O)C(C)O)=O)O)=O,,,4,1,2,8,10
2008_1,,,,2,2,1,3
2010_0,,,,2,2,1,3
C(C(C(C(CO)C(C)O)=O)O)=O,,,4,1,5,15,20
2010_1,,,,2,2,1,3
2012_0,,,,2,2,1,3
C(C(CO)C(C=O)O)(C(C=O)O)=O,,,4,1,6,19,25
2012_1,,,,2,2,1,3
2013_0,,,,2,2,1,3
2014_0,,,,2,2,1,3
2014_1,,,,2,2,1,3
2016_0,,,,2,2,1,3
C(CC(CCO)(C(C=O)O)O)=O,,,4,1,3,18,21
2018_0,,,,2,2,1,3
C(C(C(CCO)(C(C=O)O)O)O)=O,,,4,1,2,10,12
2018_1,,,,2,2,1,3
2020_0,,,,2,2,1,3
C(C(C(C(C=O)O)=O)CO)(O)=O,,,4,1,6,14,20
2020_1,,,,2,2,1,3
2021_0,,,,2,2,1,3
2021_1,,,,2,2,1,3
2022_0,,,,2,2,1,3
2022_1,,,,2,2,1,3
2024_0,,,,2,2,1,3
C(C(C(C(CO)CO)=O)O)=O,,,4,1,7,13,20
2024_1,,,,2,2,1,3
2026_0,,,,2,2,1,3
C(C(C(C(CO)C(CO)O)=O)O)=O,,,4,1,5,15,20
2026_1,,,,2,2,1,3
2027_0,,,,2,2,1,3
2027_1,,,,2,2,1,3
2029_0,,,,2,2,1,3
C(C(C(C)O)C(CC(C)O)O)=O,,,4,1,4,14,18
2029_1,,,,2,2,1,3
2031_0,,,,2,2,1,3
C(C(CO)C(CC(C)O)O)=O,,,4,1,5,14,19
2031_1,,,,2,2,1,3
2033_0,,,,2,2,1,3
C(C(C(CO)O)C(CC(C)O)O)=O,,,4,1,5,14,19
2033_1,,,,2,2,1,3
2035_0,,,,2,2,1,3
C(C(C)=O)(C(C(CC(C)O)O)O)=O,,,4,1,2,12,14
2035_1,,,,2,2,1,3
2037_0,,,,2,2,1,3
C(C(CO)=O)(CC(CC(C)O)O)=O,,,4,1,3,10,13
2039_0,,,,2,2,1,3
C(C)(C(C(CC(C)O)O)O)=O,,,4,1,6,13,19
2039_1,,,,2,2,1,3
2041_0,,,,2,2,1,3
C(CO)(CC(CC(C)O)O)=O,,,4,1,6,12,18
2043_0,,,,2,2,1,3
C(C(C(CC(C)O)O)O)(CCO)=O,,,4,1,4,11,15
2043_1,,,,2,2,1,3
2045_0,,,,2,2,1,3
C(CO)(C(CO)C(CC(C)O)O)=O,,,4,1,6,11,17
2045_1,,,,2,2,1,3
2047_0,,,,2,2,1,3
C(C(CO)O)(CC(CC(C)O)O)=O,,,4,1,4,11,15
2049_0,,,,2,2,1,3
C(C(CC(CC(C)O)O)=O)(O)=O,,,4,1,2,12,14
2051_0,,,,2,2,1,3
C(C(C=O)C(CC(C)O)O)(O)=O,,,4,1,6,13,19
2051_1,,,,2,2,1,3
2053_0,,,,2,2,1,3
C(C(C(C(CC(C)O)O)O)=O)(O)=O,,,4,1,3,14,17
2053_1,,,,2,2,1,3
2055_0,,,,2,2,1,3
C(C(C(C=O)=O)C(CC(C)O)O)=O,,,4,1,3,13,16
2055_1,,,,2,2,1,3
2057_0,,,,2,2,1,3
C1(C(C(CC(C)O)O)OCC1O)=O,,,4,1,2,7,9
2057_1,,,,2,2,1,3
2059_0,,,,2,2,1,3
C1(C(O)OCC1C(CC(C)O)O)=O,,,4,1,3,9,12
2059_1,,,,2,2,1,3
2061_0,,,,2,2,1,3
C1(COC(C1C(CC(C)O)O)O)=O,,,4,1,3,11,14
2061_1,,,,2,2,1,3
2063_0,,,,2,2,1,3
C1(C(C(CC(C)O)O)OC(C1)O)=O,,,4,1,3,9,12
2063_1,,,,2,2,1,3
2065_0,,,,2,2,1,3
C(C(C(CC(CC(C)O)O)=O)=O)=O,,,4,1,1,10,11
2067_0,,,,2,2,1,3
C(CO)(C(C(CC(C)O)O)O)=O,,,4,1,3,10,13
2067_1,,,,2,2,1,3
2069_0,,,,2,2,1,3
C(C(CC(CC(C)O)O)=O)=O,,,4,1,4,16,20
2071_0,,,,2,2,1,3
C(C(C=O)C(CC(C)O)O)=O,,,4,1,5,11,16
2071_1,,,,2,2,1,3
2073_0,,,,2,2,1,3
C(C(C(CO)C(CC(C)O)O)=O)=O,,,4,1,6,15,21
2073_1,,,,2,2,1,3
2075_0,,,,2,2,1,3
C(C(C(CC(C)O)O)C(C=O)O)=O,,,4,1,6,16,22
2075_1,,,,2,2,1,3
2077_0,,,,2,2,1,3
C(C(C(CO)=O)C(CC(C)O)O)=O,,,4,1,5,11,16
2077_1,,,,2,2,1,3
2079_0,,,,2,2,1,3
C(CC(C(C(CC(C)O)O)O)=O)=O,,,4,1,3,12,15
2079_1,,,,2,2,1,3
2081_0,,,,2,2,1,3
C(C(C(CC(CC(C)O)O)=O)O)=O,,,4,1,2,10,12
2083_0,,,,2,2,1,3
C(CC(CC(C)O)O)=O,,,4,1,12,29,41
2085_0,,,,2,2,1,3
C(C(C(C(CC(C)O)O)O)=O)=O,,,4,1,2,17,19
2085_1,,,,2,2,1,3
2087_0,,,,2,2,1,3
C(C(C(CC(C)O)O)O)=O,,,4,1,11,21,32
2087_1,,,,2,2,1,3
2089_0,,,,2,2,1,3
C(C(C(C)O)C(C(C(C)O)O)O)=O,,,4,1,4,15,19
2089_1,,,,2,2,1,3
2091_0,,,,2,2,1,3
C(C(C(C)O)C(CCO)O)=O,,,4,1,5,14,19
2091_1,,,,2,2,1,3
2093_0,,,,2,2,1,3
C(C(C(C)O)C(CC(CO)O)O)=O,,,4,1,5,14,19
2093_1,,,,2,2,1,3
2095_0,,,,2,2,1,3
C(C(C(C)O)C(C(C)=O)(CO)O)=O,,,4,1,6,14,20
2095_1,,,,2,2,1,3
2097_0,,,,2,2,1,3
C(C(C(C)O)C(C(CO)=O)(C)O)=O,,,4,1,6,14,20
2097_1,,,,2,2,1,3
2099_0,,,,2,2,1,3
C(C(C(C)O)C(C=O)(C(C)O)O)=O,,,4,1,6,15,21
2099_1,,,,2,2,1,3
2101_0,,,,2,2,1,3
C(C(C(C)O)C(C(C(C)O)=O)O)=O,,,4,1,7,14,21
2101_1,,,,2,2,1,3
2102_0,,,,2,2,1,3
2102_1,,,,2,2,1,3
2104_0,,,,2,2,1,3
C(C(C(C)O)C(C)(CO)O)=O,,,4,1,5,14,19
2104_1,,,,2,2,1,3
2106_0,,,,2,2,1,3
C(C(C(C)O)C(CO)(CCO)O)=O,,,4,1,6,13,19
2106_1,,,,2,2,1,3
2108_0,,,,2,2,1,3
C(C(C(C(CCO)O)O)C(C)O)=O,,,4,1,5,14,19
2108_1,,,,2,2,1,3
2110_0,,,,2,2,1,3
C(C(C(C)O)C(C)(C(CO)O)O)=O,,,4,1,5,14,19
2110_1,,,,2,2,1,3
2112_0,,,,2,2,1,3
C(C(C(C)O)C(C(O)=O)(C)O)=O,,,4,1,5,14,19
2112_1,,,,2,2,1,3
2114_0,,,,2,2,1,3
C(C(C(CC(O)=O)O)C(C)O)=O,,,4,1,5,13,18
2114_1,,,,2,2,1,3
2116_0,,,,2,2,1,3
C(C(C(C)O)C(C(O)=O)(CO)O)=O,,,4,1,7,14,21
2116_1,,,,2,2,1,3
2118_0,,,,2,2,1,3
C(CC(C=O)(C(C=O)C(C)O)O)=O,,,4,1,5,14,19
2118_1,,,,2,2,1,3
2120_0,,,,2,2,1,3
C(C(C(C)O)C(C(CC=O)=O)O)=O,,,4,1,4,16,20
2120_1,,,,2,2,1,3
2121_0,,,,2,2,1,3
2121_1,,,,2,2,1,3
2123_0,,,,2,2,1,3
C(C(C(C)O)C1(COCC1O)O)=O,,,4,1,4,10,14
2123_1,,,,2,2,1,3
2125_0,,,,2,2,1,3
C(C(C(C)O)C1(C(O)OCC1)O)=O,,,4,1,5,12,17
2125_1,,,,2,2,1,3
2127_0,,,,2,2,1,3
C(C(C(C)O)C1(COC(C1)O)O)=O,,,4,1,5,12,17
2127_1,,,,2,2,1,3
2129_0,,,,2,2,1,3
C(C(C(C)O)C(C=O)(C(C)=O)O)=O,,,4,1,4,12,16
2129_1,,,,2,2,1,3
2131_0,,,,2,2,1,3
C(C(C(C)O)C(C(C(C)=O)=O)O)=O,,,4,1,4,13,17
2131_1,,,,2,2,1,3
2133_0,,,,2,2,1,3
C(C(C(C)O)C(C(C=O)=O)(C)O)=O,,,4,1,5,14,19
2133_1,,,,2,2,1,3
2135_0,,,,2,2,1,3
C(C(C=C)(C(C=O)C(C)O)O)=O,,,4,1,6,15,21
2135_1,,,,2,2,1,3
2137_0,,,,2,2,1,3
C(C(C(C)O)C(C(C=C)=O)O)=O,,,4,1,6,17,23
2137_1,,,,2,2,1,3
2139_0,,,,2,2,1,3
C(C(C(C)O)C(C=CC=O)O)=O,,,4,1,6,16,22
2139_1,,,,2,2,1,3
2141_0,,,,2,2,1,3
C(C(C=O)C(C)O)(O)=O,,,4,1,8,21,29
2141_1,,,,2,2,1,3
2143_0,,,,2,2,1,3
C(C(C(C(O)O)O)C(C)O)=O,,,4,1,4,14,18
2143_1,,,,2,2,1,3
2145_0,,,,2,2,1,3
C(C(C(C)O)C(C(C)O)O)=O,,,4,1,4,15,19
2145_1,,,,2,2,1,3
2147_0,,,,2,2,1,3
C(C(C(C)O)C(C(CO)O)O)=O,,,4,1,8,16,24
2147_1,,,,2,2,1,3
2148_0,,,,2,2,1,3
2148_1,,,,2,2,1,3
2149_0,,,,2,2,1,3
2149_1,,,,2,2,1,3
2150_0,,,,2,2,1,3
2150_1,,,,2,2,1,3
2151_0,,,,2,2,1,3
2151_1,,,,2,2,1,3
2152_0,,,,2,2,1,3
2152_1,,,,2,2,1,3
2153_0,,,,2,2,1,3
2153_1,,,,2,2,1,3
2154_0,,,,2,2,1,3
2154_1,,,,2,2,1,3
2155_0,,,,2,2,1,3
2155_1,,,,2,2,1,3
2156_0,,,,2,2,1,3
2156_1,,,,2,2,1,3
2157_0,,,,2,2,1,3
2157_1,,,,2,2,1,3
2158_0,,,,2,2,1,3
2158_1,,,,2,2,1,3
2159_0,,,,2,2,1,3
2159_1,,,,2,2,1,3
2160_0,,,,2,2,1,3
2160_1,,,,2,2,1,3
2161_0,,,,2,2,1,3
2161_1,,,,2,2,1,3
2163_0,,,,2,2,1,3
C(C(C(C)O)C(C)O)=O,,,4,1,4,19,23
2163_1,,,,2,2,1,3
2165_0,,,,2,2,1,3
C(C(C(C)O)C(C=O)(CO)O)=O,,,4,1,6,17,23
2165_1,,,,2,2,1,3
2167_0,,,,2,2,1,3
C(C(C(C)O)C(C(CO)=O)O)=O,,,4,1,6,16,22
2167_1,,,,2,2,1,3
2169_0,,,,2,2,1,3
C(C(CO)C(C)O)=O,,,4,1,9,54,63
2169_1,,,,2,2,1,3
2171_0,,,,2,2,1,3
C(C(C(CO)O)C(C)O)=O,,,4,1,8,17,25
2171_1,,,,2,2,1,3
2173_0,,,,2,2,1,3
C(C(C(C(C)O)O)(CC=O)O)=O,,,4,1,3,16,19
2175_0,,,,2,2,1,3
C(C(C(C(C)O)O)(C(C=O)O)O)=O,,,4,1,10,20,30
2175_1,,,,2,2,1,3
2177_0,,,,2,2,1,3
C(CC(C(C(C(C)O)O)=O)O)=O,,,4,1,5,16,21
2178_0,,,,2,2,1,3
2178_1,,,,2,2,1,3
2180_0,,,,2,2,1,3
C(C(CO)C(C(C(C)O)O)O)=O,,,4,1,5,16,21
2180_1,,,,2,2,1,3
2182_0,,,,2,2,1,3
C(C)(C(C(C(C(C)O)O)O)O)=O,,,4,1,2,13,15
2182_1,,,,2,2,1,3
2184_0,,,,2,2,1,3
C(CO)(CC(C(C(C)O)O)O)=O,,,4,1,2,11,13
2186_0,,,,2,2,1,3
C(C(CC(C(C(C)O)O)O)=O)(O)=O,,,4,1,2,15,17
2188_0,,,,2,2,1,3
C(C(C=O)C(C(C(C)O)O)O)(O)=O,,,4,1,5,15,20
2188_1,,,,2,2,1,3
2190_0,,,,2,2,1,3
C(CO)(C(C(C(C(C)O)O)O)O)=O,,,4,1,5,13,18
2190_1,,,,2,2,1,3
2192_0,,,,2,2,1,3
C(C(CC(C(C(C)O)O)O)=O)=O,,,4,1,1,18,19
2194_0,,,,2,2,1,3
C(C(C=O)C(C(C(C)O)O)O)=O,,,4,1,3,13,16
2194_1,,,,2,2,1,3
2196_0,,,,2,2,1,3
C(CC(C(C(C)O)O)O)=O,,,4,1,8,19,27
2198_0,,,,2,2,1,3
C(C(C(C(C(C(C)O)O)O)O)=O)=O,,,4,1,4,18,22
2198_1,,,,2,2,1,3
2200_0,,,,2,2,1,3
C(C(C(C(C(C)O)O)O)O)=O,,,4,1,10,19,29
2200_1,,,,2,2,1,3
2202_0,,,,2,2,1,3
C(CC(C(CO)(CC=O)O)O)=O,,,4,1,6,20,26
2203_0,,,,2,2,1,3
2203_1,,,,2,2,1,3
2205_0,,,,2,2,1,3
C(C(CO)(CC(CC=O)O)O)=O,,,4,1,2,17,19
2207_0,,,,2,2,1,3
C(C(CO)(CC(C(C=O)O)O)O)=O,,,4,1,7,20,27
2207_1,,,,2,2,1,3
2209_0,,,,2,2,1,3
C(C(C=O)C(C=O)(CO)O)(O)=O,,,4,1,7,16,23
2209_1,,,,2,2,1,3
2210_0,,,,2,2,1,3
2210_1,,,,2,2,1,3
2211_0,,,,2,2,1,3
2211_1,,,,2,2,1,3
2213_0,,,,2,2,1,3
C(C(CO)C(C=O)(CO)O)=O,,,4,1,9,17,26
2213_1,,,,2,2,1,3
2215_0,,,,2,2,1,3
C(C(C(CO)O)C(C=O)(CO)O)=O,,,4,1,10,17,27
2215_1,,,,2,2,1,3
2216_0,,,,2,2,1,3
2217_0,,,,2,2,1,3
2217_1,,,,2,2,1,3
2219_0,,,,2,2,1,3
C(CC(CC(C(CO)=O)O)O)=O,,,4,1,4,16,20
2221_0,,,,2,2,1,3
C(C(C(CC(C(CO)=O)O)O)O)=O,,,4,1,11,20,31
2221_1,,,,2,2,1,3
2223_0,,,,2,2,1,3
C(C(C(C(CC=O)O)=O)O)(O)=O,,,4,1,8,15,23
2223_1,,,,2,2,1,3
2225_0,,,,2,2,1,3
C(C(C(C(C(CC=O)O)=O)O)O)=O,,,4,1,11,25,36
2225_1,,,,2,2,1,3
2226_0,,,,2,2,1,3
2226_1,,,,2,2,1,3
2227_0,,,,2,2,1,3
2227_1,,,,2,2,1,3
2229_0,,,,2,2,1,3
C(CC(C(C(C(CO)O)O)=O)O)=O,,,4,1,10,16,26
2229_1,,,,2,2,1,3
2231_0,,,,2,2,1,3
C(C(C=O)C(C(CO)=O)O)(O)=O,,,4,1,8,15,23
2231_1,,,,2,2,1,3
2232_0,,,,2,2,1,3
2232_1,,,,2,2,1,3
2233_0,,,,2,2,1,3
2233_1,,,,2,2,1,3
2235_0,,,,2,2,1,3
C(C(CO)C(C(CO)=O)O)=O,,,4,1,13,19,32
2235_1,,,,2,2,1,3
2237_0,,,,2,2,1,3
C(C(C(CO)O)C(C(CO)=O)O)=O,,,4,1,9,17,26
2237_1,,,,2,2,1,3
2239_0,,,,2,2,1,3
C(C(CO)C(C=O)(C(CO)O)O)=O,,,4,1,12,17,29
2239_1,,,,2,2,1,3
2241_0,,,,2,2,1,3
C(C(CO)C(C(C(CO)O)=O)O)=O,,,4,1,13,18,31
2241_1,,,,2,2,1,3
2243_0,,,,2,2,1,3
C(CC(CC(C(CO)O)O)O)=O,,,4,1,4,13,17
2245_0,,,,2,2,1,3
C(C(C(CC(C(CO)O)O)O)O)=O,,,4,1,8,16,24
2245_1,,,,2,2,1,3
2247_0,,,,2,2,1,3
C(C(C=O)C(C(CO)O)O)(O)=O,,,4,1,9,16,25
2247_1,,,,2,2,1,3
2248_0,,,,2,2,1,3
2248_1,,,,2,2,1,3
2249_0,,,,2,2,1,3
2249_1,,,,2,2,1,3
2251_0,,,,2,2,1,3
C(C(CO)C(C(CO)O)O)=O,,,4,1,9,16,25
2251_1,,,,2,2,1,3
2253_0,,,,2,2,1,3
C(C(C(CO)O)C(C(CO)O)O)=O,,,4,1,10,16,26
2253_1,,,,2,2,1,3
2255_0,,,,2,2,1,3
C(C(CO)C(C(C(CO)O)O)O)=O,,,4,1,10,16,26
2255_1,,,,2,2,1,3
2257_0,,,,2,2,1,3
C(C(CO)C(CCO)O)=O,,,4,1,8,16,24
2257_1,,,,2,2,1,3
2259_0,,,,2,2,1,3
C(C(C(CO)O)C(CCO)O)=O,,,4,1,7,15,22
2259_1,,,,2,2,1,3
2261_0,,,,2,2,1,3
C(C(C(C(C(CCO)O)O)=O)O)=O,,,4,1,5,13,18
2261_1,,,,2,2,1,3
2263_0,,,,2,2,1,3
C(C(C)=O)(C(C(CCO)O)O)=O,,,4,1,5,13,18
2263_1,,,,2,2,1,3
2265_0,,,,2,2,1,3
C(C(CO)=O)(CC(CCO)O)=O,,,4,1,5,11,16
2267_0,,,,2,2,1,3
C(C)(C(C(CCO)O)O)=O,,,4,1,11,19,30
2267_1,,,,2,2,1,3
2269_0,,,,2,2,1,3
C(CO)(CC(CCO)O)=O,,,4,1,13,20,33
2271_0,,,,2,2,1,3
C(C(C(CCO)O)O)(CCO)=O,,,4,1,6,11,17
2271_1,,,,2,2,1,3
2273_0,,,,2,2,1,3
C(CO)(C(CO)C(CCO)O)=O,,,4,1,8,11,19
2273_1,,,,2,2,1,3
2275_0,,,,2,2,1,3
C(C(CO)O)(CC(CCO)O)=O,,,4,1,6,11,17
2277_0,,,,2,2,1,3
C(C(CC(CCO)O)=O)(O)=O,,,4,1,6,13,19
2279_0,,,,2,2,1,3
C(C(C=O)C(CCO)O)(O)=O,,,4,1,7,13,20
2279_1,,,,2,2,1,3
2281_0,,,,2,2,1,3
C(C(C(CO)C(CCO)O)=O)(O)=O,,,4,1,7,15,22
2281_1,,,,2,2,1,3
2283_0,,,,2,2,1,3
C(C(C(CO)=O)C(CCO)O)(O)=O,,,4,1,8,11,19
2283_1,,,,2,2,1,3
2285_0,,,,2,2,1,3
C(CC(C(C(CCO)O)O)=O)(O)=O,,,4,1,5,12,17
2285_1,,,,2,2,1,3
2287_0,,,,2,2,1,3
C(C(C(CC(CCO)O)=O)O)(O)=O,,,4,1,8,10,18
2289_0,,,,2,2,1,3
C(C(C(C(CCO)O)O)=O)(O)=O,,,4,1,7,13,20
2289_1,,,,2,2,1,3
2291_0,,,,2,2,1,3
C(C(C(C=O)=O)C(CCO)O)=O,,,4,1,7,18,25
2291_1,,,,2,2,1,3
2293_0,,,,2,2,1,3
C(C(C(C=O)=O)C(CCO)O)(O)=O,,,4,1,7,14,21
2293_1,,,,2,2,1,3
2295_0,,,,2,2,1,3
C(C(C(C(O)=O)=O)C(CCO)O)=O,,,4,1,5,14,19
2295_1,,,,2,2,1,3
2297_0,,,,2,2,1,3
C1(C(C(CCO)O)OCC1O)=O,,,4,1,3,6,9
2297_1,,,,2,2,1,3
2299_0,,,,2,2,1,3
C1(C(O)OCC1C(CCO)O)=O,,,4,1,4,9,13
2299_1,,,,2,2,1,3
2301_0,,,,2,2,1,3
C1(COC(C1C(CCO)O)O)=O,,,4,1,4,11,15
2301_1,,,,2,2,1,3
2303_0,,,,2,2,1,3
C1(C(C(CCO)O)OC(C1)O)=O,,,4,1,4,9,13
2303_1,,,,2,2,1,3
2305_0,,,,2,2,1,3
C(C(C(CC(CCO)O)=O)=O)=O,,,4,1,4,14,18
2307_0,,,,2,2,1,3
C(CO)(C(C(CCO)O)O)=O,,,4,1,11,13,24
2307_1,,,,2,2,1,3
2309_0,,,,2,2,1,3
C(C(C(CCO)O)O)(C(CO)O)=O,,,4,1,9,13,22
2309_1,,,,2,2,1,3
2311_0,,,,2,2,1,3
C(C(CC(CCO)O)=O)=O,,,4,1,12,21,33
2313_0,,,,2,2,1,3
C(C(C=O)C(CCO)O)=O,,,4,1,10,13,23
2313_1,,,,2,2,1,3
2315_0,,,,2,2,1,3
C(C(C(CO)C(CCO)O)=O)=O,,,4,1,8,18,26
2315_1,,,,2,2,1,3
2317_0,,,,2,2,1,3
C(C(C(CCO)O)C(C=O)O)=O,,,4,1,8,19,27
2317_1,,,,2,2,1,3
2319_0,,,,2,2,1,3
C(C(C(CO)=O)C(CCO)O)=O,,,4,1,8,13,21
2319_1,,,,2,2,1,3
2321_0,,,,2,2,1,3
C(CC(C(C(CCO)O)O)=O)=O,,,4,1,5,14,19
2321_1,,,,2,2,1,3
2323_0,,,,2,2,1,3
C(C(C(CC(CCO)O)=O)O)=O,,,4,1,3,12,15
2325_0,,,,2,2,1,3
C(CC(CCO)O)=O,,,4,1,22,68,90
2327_0,,,,2,2,1,3
C(C(C(C(CCO)O)O)=O)=O,,,4,1,10,18,28
2327_1,,,,2,2,1,3
2329_0,,,,2,2,1,3
C(C(C(CCO)O)O)=O,,,4,1,21,32,53
2329_1,,,,2,2,1,3
2331_0,,,,2,2,1,3
C(C(CO)C(CC(CO)O)O)=O,,,4,1,6,15,21
2331_1,,,,2,2,1,3
2332_0,,,,2,2,1,3
2332_1,,,,2,2,1,3
2334_0,,,,2,2,1,3
C(C(CO)C(C(C(C=O)O)=O)O)=O,,,4,1,8,18,26
2334_1,,,,2,2,1,3
2336_0,,,,2,2,1,3
C(C(C(C=O)(C(C=O)CO)O)O)=O,,,4,1,10,19,29
2336_1,,,,2,2,1,3
2337_0,,,,2,2,1,3
2337_1,,,,2,2,1,3
2338_0,,,,2,2,1,3
2338_1,,,,2,2,1,3
2340_0,,,,2,2,1,3
C(C(CO)C(C(C)=O)(CO)O)=O,,,4,1,9,16,25
2340_1,,,,2,2,1,3
2342_0,,,,2,2,1,3
C(C(CO)C(C(CO)=O)(C)O)=O,,,4,1,7,15,22
2342_1,,,,2,2,1,3
2344_0,,,,2,2,1,3
C(C(CO)C(C=O)(C(C)O)O)=O,,,4,1,8,17,25
2344_1,,,,2,2,1,3
2346_0,,,,2,2,1,3
C(C(CO)C(C(C(C)O)=O)O)=O,,,4,1,8,15,23
2346_1,,,,2,2,1,3
2347_0,,,,2,2,1,3
2347_1,,,,2,2,1,3
2349_0,,,,2,2,1,3
C(C(CO)C(C)(CO)O)=O,,,4,1,7,16,23
2349_1,,,,2,2,1,3
2351_0,,,,2,2,1,3
C(C(CO)C(CO)(CCO)O)=O,,,4,1,7,14,21
2351_1,,,,2,2,1,3
2353_0,,,,2,2,1,3
C(C(CO)C(C(CCO)O)O)=O,,,4,1,6,15,21
2353_1,,,,2,2,1,3
2355_0,,,,2,2,1,3
C(C(CO)C(C)(C(CO)O)O)=O,,,4,1,6,15,21
2355_1,,,,2,2,1,3
2357_0,,,,2,2,1,3
C(C(CO)C(C(O)=O)(C)O)=O,,,4,1,9,14,23
2357_1,,,,2,2,1,3
2359_0,,,,2,2,1,3
C(C(CO)C(CC(O)=O)O)=O,,,4,1,7,14,21
2359_1,,,,2,2,1,3
2361_0,,,,2,2,1,3
C(C(CO)C(C(O)=O)(CCO)O)=O,,,4,1,9,14,23
2361_1,,,,2,2,1,3
2363_0,,,,2,2,1,3
C(C(CO)C(C(CC(O)=O)O)O)=O,,,4,1,6,15,21
2363_1,,,,2,2,1,3
2365_0,,,,2,2,1,3
C(C(CO)C(CO)(CC(O)=O)O)=O,,,4,1,7,13,20
2365_1,,,,2,2,1,3
2367_0,,,,2,2,1,3
C(C(CO)C(C)(C(C(O)=O)O)O)=O,,,4,1,10,15,25
2367_1,,,,2,2,1,3
2369_0,,,,2,2,1,3
C(C(CO)C(C(O)=O)(CO)O)=O,,,4,1,11,15,26
2369_1,,,,2,2,1,3
2371_0,,,,2,2,1,3
C(CC(C=O)(C(C=O)CO)O)=O,,,4,1,9,18,27
2371_1,,,,2,2,1,3
2373_0,,,,2,2,1,3
C(C(CO)C(C(CC=O)=O)O)=O,,,4,1,10,20,30
2373_1,,,,2,2,1,3
2374_0,,,,2,2,1,3
2374_1,,,,2,2,1,3
2376_0,,,,2,2,1,3
C(CC(C=O)(C(C=O)CO)O)(O)=O,,,4,1,6,13,19
2376_1,,,,2,2,1,3
2378_0,,,,2,2,1,3
C(C(CO)C(C(CC(O)=O)=O)O)=O,,,4,1,7,16,23
2378_1,,,,2,2,1,3
2379_0,,,,2,2,1,3
2379_1,,,,2,2,1,3
2381_0,,,,2,2,1,3
C(CC(C(O)=O)(C(C=O)CO)O)=O,,,4,1,8,15,23
2381_1,,,,2,2,1,3
2383_0,,,,2,2,1,3
C(C(CO)C1(COCC1O)O)=O,,,4,1,5,11,16
2383_1,,,,2,2,1,3
2385_0,,,,2,2,1,3
C(C(CO)C1(C(O)OCC1)O)=O,,,4,1,6,13,19
2385_1,,,,2,2,1,3
2387_0,,,,2,2,1,3
C(C(CO)C1(COC(C1)O)O)=O,,,4,1,6,13,19
2387_1,,,,2,2,1,3
2389_0,,,,2,2,1,3
C(C(CO)C(C=O)(C(C)=O)O)=O,,,4,1,8,15,23
2389_1,,,,2,2,1,3
2391_0,,,,2,2,1,3
C(C(CO)C(C(C(C)=O)=O)O)=O,,,4,1,9,16,25
2391_1,,,,2,2,1,3
2393_0,,,,2,2,1,3
C(C(CO)C(C(C=O)=O)(C)O)=O,,,4,1,8,18,26
2393_1,,,,2,2,1,3
2395_0,,,,2,2,1,3
C(C(C=C)(C(C=O)CO)O)=O,,,4,1,7,15,22
2395_1,,,,2,2,1,3
2397_0,,,,2,2,1,3
C(C(CO)C(C(C=C)=O)O)=O,,,4,1,7,18,25
2397_1,,,,2,2,1,3
2399_0,,,,2,2,1,3
C(C(CO)C(C=CC=O)O)=O,,,4,1,7,16,23
2399_1,,,,2,2,1,3
2401_0,,,,2,2,1,3
C(C(CO)C1(C(O)OCC1O)O)=O,,,4,1,6,12,18
2401_1,,,,2,2,1,3
2403_0,,,,2,2,1,3
C(C(C=O)CO)(O)=O,,,4,1,10,46,56
2403_1,,,,2,2,1,3
2405_0,,,,2,2,1,3
C(C(CO)C(C(O)O)O)=O,,,4,1,6,16,22
2405_1,,,,2,2,1,3
2407_0,,,,2,2,1,3
C(C(CO)C(C(C)O)O)=O,,,4,1,6,17,23
2407_1,,,,2,2,1,3
2408_0,,,,2,2,1,3
2408_1,,,,2,2,1,3
2409_0,,,,2,2,1,3
2409_1,,,,2,2,1,3
2410_0,,,,2,2,1,3
2410_1,,,,2,2,1,3
2411_0,,,,2,2,1,3
2411_1,,,,2,2,1,3
2412_0,,,,2,2,1,3
2412_1,,,,2,2,1,3
2413_0,,,,2,2,1,3
2413_1,,,,2,2,1,3
2414_0,,,,2,2,1,3
2414_1,,,,2,2,1,3
2415_0,,,,2,2,1,3
2415_1,,,,2,2,1,3
2416_0,,,,2,2,1,3
2416_1,,,,2,2,1,3
2417_0,,,,2,2,1,3
2417_1,,,,2,2,1,3
2418_0,,,,2,2,1,3
2418_1,,,,2,2,1,3
2419_0,,,,2,2,1,3
2419_1,,,,2,2,1,3
2420_0,,,,2,2,1,3
2420_1,,,,2,2,1,3
2421_0,,,,2,2,1,3
2421_1,,,,2,2,1,3
2422_0,,,,2,2,1,3
2422_1,,,,2,2,1,3
2423_0,,,,2,2,1,3
2423_1,,,,2,2,1,3
2424_0,,,,2,2,1,3
2424_1,,,,2,2,1,3
2425_0,,,,2,2,1,3
2425_1,,,,2,2,1,3
2426_0,,,,2,2,1,3
2426_1,,,,2,2,1,3
2427_0,,,,2,2,1,3
2427_1,,,,2,2,1,3
2428_0,,,,2,2,1,3
2428_1,,,,2,2,1,3
2429_0,,,,2,2,1,3
2429_1,,,,2,2,1,3
2430_0,,,,2,2,1,3
2430_1,,,,2,2,1,3
2431_0,,,,2,2,1,3
2431_1,,,,2,2,1,3
2433_0,,,,2,2,1,3
C(C(CO)CO)=O,,,4,1,7,107,114
2433_1,,,,2,2,1,3
2435_0,,,,2,2,1,3
C(C(CO)C(CO)O)=O,,,4,1,12,25,37
2435_1,,,,2,2,1,3
2437_0,,,,2,2,1,3
C(C)(C(C(CC(CO)O)O)O)=O,,,4,1,3,12,15
2437_1,,,,2,2,1,3
2439_0,,,,2,2,1,3
C(CO)(CC(CC(CO)O)O)=O,,,4,1,3,10,13
2441_0,,,,2,2,1,3
C(C(CC(CC(CO)O)O)=O)(O)=O,,,4,1,3,13,16
2443_0,,,,2,2,1,3
C(C(C=O)C(CC(CO)O)O)(O)=O,,,4,1,6,14,20
2443_1,,,,2,2,1,3
2445_0,,,,2,2,1,3
C(CO)(C(C(CC(CO)O)O)O)=O,,,4,1,4,12,16
2445_1,,,,2,2,1,3
2447_0,,,,2,2,1,3
C(C(CC(CC(CO)O)O)=O)=O,,,4,1,2,16,18
2449_0,,,,2,2,1,3
C(C(C=O)C(CC(CO)O)O)=O,,,4,1,4,12,16
2449_1,,,,2,2,1,3
2451_0,,,,2,2,1,3
C(CC(CC(CO)O)O)=O,,,4,1,9,18,27
2453_0,,,,2,2,1,3
C(C(C(C(CC(CO)O)O)O)=O)=O,,,4,1,4,16,20
2453_1,,,,2,2,1,3
2455_0,,,,2,2,1,3
C(C(C(CC(CO)O)O)O)=O,,,4,1,9,18,27
2455_1,,,,2,2,1,3
2456_0,,,,2,2,1,3
2456_1,,,,2,2,1,3
2458_0,,,,2,2,1,3
C(C(C(CO)O)C(C)(CO)O)=O,,,4,1,6,15,21
2458_1,,,,2,2,1,3
2460_0,,,,2,2,1,3
C(C(C(CO)O)C(C(O)=O)(C)O)=O,,,4,1,9,15,24
2460_1,,,,2,2,1,3
2462_0,,,,2,2,1,3
C(C(C(CC(O)=O)O)C(CO)O)=O,,,4,1,6,14,20
2462_1,,,,2,2,1,3
2464_0,,,,2,2,1,3
C(C(C=C)(C(C=O)C(CO)O)O)=O,,,4,1,5,13,18
2464_1,,,,2,2,1,3
2466_0,,,,2,2,1,3
C(C(C(CO)O)C(C(C=C)=O)O)=O,,,4,1,5,16,21
2466_1,,,,2,2,1,3
2468_0,,,,2,2,1,3
C(C(C(CO)O)C(C=CC=O)O)=O,,,4,1,5,13,18
2468_1,,,,2,2,1,3
2470_0,,,,2,2,1,3
C(C(C=O)C(CO)O)(O)=O,,,4,1,8,16,24
2470_1,,,,2,2,1,3
2472_0,,,,2,2,1,3
C(C(C(CO)O)C(C(O)O)O)=O,,,4,1,5,15,20
2472_1,,,,2,2,1,3
2474_0,,,,2,2,1,3
C(C(C(CO)O)C(C(C)O)O)=O,,,4,1,5,16,21
2474_1,,,,2,2,1,3
2475_0,,,,2,2,1,3
2475_1,,,,2,2,1,3
2476_0,,,,2,2,1,3
2476_1,,,,2,2,1,3
2477_0,,,,2,2,1,3
2477_1,,,,2,2,1,3
2478_0,,,,2,2,1,3
2478_1,,,,2,2,1,3
2479_0,,,,2,2,1,3
2479_1,,,,2,2,1,3
2480_0,,,,2,2,1,3
2480_1,,,,2,2,1,3
2481_0,,,,2,2,1,3
2481_1,,,,2,2,1,3
2482_0,,,,2,2,1,3
2482_1,,,,2,2,1,3
2483_0,,,,2,2,1,3
2483_1,,,,2,2,1,3
2484_0,,,,2,2,1,3
2484_1,,,,2,2,1,3
2485_0,,,,2,2,1,3
2485_1,,,,2,2,1,3
2487_0,,,,2,2,1,3
C(C(C(CO)O)C(CO)O)=O,,,4,1,6,10,16
2487_1,,,,2,2,1,3
2488_0,,,,2,2,1,3
2490_0,,,,2,2,1,3
C(C(C(C(C=O)(CC=O)O)O)O)=O,,,4,1,9,23,32
2491_0,,,,2,2,1,3
2492_0,,,,2,2,1,3
2493_0,,,,2,2,1,3
2494_0,,,,2,2,1,3
2494_1,,,,2,2,1,3
2495_0,,,,2,2,1,3
2497_0,,,,2,2,1,3
C(C=O)(CC(C(C(C=O)=O)O)O)=O,,,4,1,6,20,26
2499_0,,,,2,2,1,3
C(C(C=O)C(C(C(C=O)=O)O)O)=O,,,4,1,6,15,21
2499_1,,,,2,2,1,3
2500_0,,,,2,2,1,3
2502_0,,,,2,2,1,3
C(C(C(C(C(C=O)=O)O)O)O)=O,,,4,1,14,27,41
2502_1,,,,2,2,1,3
2504_0,,,,2,2,1,3
C(C(C(C(C(C(C)=O)O)O)=O)O)=O,,,4,1,9,20,29
2504_1,,,,2,2,1,3
2506_0,,,,2,2,1,3
C(C(C(C(CC(CO)=O)O)=O)O)=O,,,4,1,11,18,29
2508_0,,,,2,2,1,3
C(C(C(C(CC(C=O)=O)O)=O)O)=O,,,4,1,3,18,21
2510_0,,,,2,2,1,3
C(C(C=O)C(C(C(C=O)O)=O)O)=O,,,4,1,3,13,16
2510_1,,,,2,2,1,3
2512_0,,,,2,2,1,3
C(C(C(C(CC=O)O)=O)O)=O,,,4,1,16,22,38
2514_0,,,,2,2,1,3
C(C(C(C(C(C=O)O)O)=O)O)=O,,,4,1,12,25,37
2514_1,,,,2,2,1,3
2515_0,,,,2,2,1,3
2515_1,,,,2,2,1,3
2517_0,,,,2,2,1,3
C(C(C(C=O)(CC(CO)=O)O)O)=O,,,4,1,9,19,28
2519_0,,,,2,2,1,3
C(C(C(C=O)(CC(C=O)=O)O)O)=O,,,4,1,5,18,23
2521_0,,,,2,2,1,3
C(C(C=O)C(C=O)(C(C=O)O)O)=O,,,4,1,5,14,19
2521_1,,,,2,2,1,3
2522_0,,,,2,2,1,3
2523_0,,,,2,2,1,3
2523_1,,,,2,2,1,3
2525_0,,,,2,2,1,3
C(C(C(CO)(C(C(C)=O)O)O)O)=O,,,4,1,10,16,26
2525_1,,,,2,2,1,3
2527_0,,,,2,2,1,3
C(C(C(CO)(CC(CO)=O)O)O)=O,,,4,1,10,16,26
2529_0,,,,2,2,1,3
C(C(C(CO)(CC(C=O)=O)O)O)=O,,,4,1,6,19,25
2531_0,,,,2,2,1,3
C(C(C=O)C(CO)(C(C=O)O)O)=O,,,4,1,8,14,22
2531_1,,,,2,2,1,3
2532_0,,,,2,2,1,3
2534_0,,,,2,2,1,3
C(C(C(CO)(C(C=O)O)O)O)=O,,,4,1,7,11,18
2534_1,,,,2,2,1,3
2535_0,,,,2,2,1,3
2535_1,,,,2,2,1,3
2536_0,,,,2,2,1,3
2538_0,,,,2,2,1,3
C(CO)(C(C(CC(C=O)=O)O)O)=O,,,4,1,15,20,35
2540_0,,,,2,2,1,3
C(C(C=O)C(C(C(CO)=O)O)O)=O,,,4,1,7,14,21
2540_1,,,,2,2,1,3
2541_0,,,,2,2,1,3
2543_0,,,,2,2,1,3
C(C(C(C(C(CO)=O)O)O)O)=O,,,4,1,13,21,34
2543_1,,,,2,2,1,3
2545_0,,,,2,2,1,3
C(C(C(C(C(CO)(C)O)O)=O)O)=O,,,4,1,3,13,16
2545_1,,,,2,2,1,3
2547_0,,,,2,2,1,3
C(C(C(C(C=O)O)=O)O)(O)=O,,,4,1,10,16,26
2547_1,,,,2,2,1,3
2549_0,,,,2,2,1,3
C(C(C(C(C(C(O)O)O)O)=O)O)=O,,,4,1,2,14,16
2549_1,,,,2,2,1,3
2551_0,,,,2,2,1,3
C(C(C(C(C(C(C)O)O)O)=O)O)=O,,,4,1,5,15,20
2551_1,,,,2,2,1,3
2552_0,,,,2,2,1,3
2552_1,,,,2,2,1,3
2554_0,,,,2,2,1,3
C(C(C(C(C(C(O)=O)O)O)=O)O)=O,,,4,1,8,18,26
2554_1,,,,2,2,1,3
2556_0,,,,2,2,1,3
C(C(C)(C(C(C(C=O)O)=O)O)O)=O,,,4,1,4,16,20
2556_1,,,,2,2,1,3
2557_0,,,,2,2,1,3
2557_1,,,,2,2,1,3
2559_0,,,,2,2,1,3
C(CC(C(C(C(C=O)O)=O)O)O)=O,,,4,1,5,19,24
2559_1,,,,2,2,1,3
2561_0,,,,2,2,1,3
C(C(C(C(C(C)O)O)=O)O)=O,,,4,1,9,17,26
2561_1,,,,2,2,1,3
2563_0,,,,2,2,1,3
C(C(C(C(CO)O)=O)O)=O,,,4,1,18,26,44
2563_1,,,,2,2,1,3
2565_0,,,,2,2,1,3
C(C(C(C(C(CO)O)O)=O)O)=O,,,4,1,11,16,27
2565_1,,,,2,2,1,3
2566_0,,,,2,2,1,3
2567_0,,,,2,2,1,3
2569_0,,,,2,2,1,3
C(C(C(C(C(O)=O)O)=O)(CO)O)=O,,,4,1,7,13,20
2569_1,,,,2,2,1,3
2571_0,,,,2,2,1,3
C(C(C(C(C(C)O)O)=O)(CO)O)=O,,,4,1,6,13,19
2571_1,,,,2,2,1,3
2573_0,,,,2,2,1,3
C(C(C(C(CO)O)=O)(CO)O)=O,,,4,1,8,13,21
2573_1,,,,2,2,1,3
2574_0,,,,2,2,1,3
2576_0,,,,2,2,1,3
C(C(C(CO)(C(C=O)O)O)O)(O)=O,,,4,1,14,16,30
2576_1,,,,2,2,1,3
2578_0,,,,2,2,1,3
C(C(C(C(C(O)=O)O)=O)O)(O)=O,,,4,1,5,6,11
2578_1,,,,2,2,1,3
2579_0,,,,2,2,1,3
2579_1,,,,2,2,1,3
2580_0,,,,2,2,1,3
2580_1,,,,2,2,1,3
2582_0,,,,2,2,1,3
C(C(C(C(CO)O)=O)O)(O)=O,,,4,1,17,15,32
2582_1,,,,2,2,1,3
2583_0,,,,2,2,1,3
2583_1,,,,2,2,1,3
2585_0,,,,2,2,1,3
C(C)(C(CO)(C(C(C)=O)O)O)=O,,,4,1,9,16,25
2585_1,,,,2,2,1,3
2587_0,,,,2,2,1,3
C(C)(C(CO)(CC(CO)=O)O)=O,,,4,1,6,13,19
2589_0,,,,2,2,1,3
C(C)(C(CO)(CC(C(O)=O)=O)O)=O,,,4,1,4,13,17
2591_0,,,,2,2,1,3
C(C(C=O)C(C(C)=O)(CO)O)(O)=O,,,4,1,7,13,20
2591_1,,,,2,2,1,3
2593_0,,,,2,2,1,3
C(C)(C(CO)(C(C(CO)=O)O)O)=O,,,4,1,9,17,26
2593_1,,,,2,2,1,3
2595_0,,,,2,2,1,3
C(C)(C(CO)(CC(C=O)=O)O)=O,,,4,1,5,17,22
2597_0,,,,2,2,1,3
C(C(C=O)C(C(C)=O)(CO)O)=O,,,4,1,6,12,18
2597_1,,,,2,2,1,3
2599_0,,,,2,2,1,3
C(C)(C(CO)(CC=O)O)=O,,,4,1,14,22,36
2601_0,,,,2,2,1,3
C(C)(C(CO)(C(C(C=O)=O)O)O)=O,,,4,1,8,19,27
2601_1,,,,2,2,1,3
2603_0,,,,2,2,1,3
C(C)(C(CO)(C(C=O)O)O)=O,,,4,1,17,21,38
2603_1,,,,2,2,1,3
2605_0,,,,2,2,1,3
C(CO)(C(C)(C(C(C)=O)O)O)=O,,,4,1,5,13,18
2605_1,,,,2,2,1,3
2607_0,,,,2,2,1,3
C(CO)(C(C)(CC(CO)=O)O)=O,,,4,1,4,12,16
2609_0,,,,2,2,1,3
C(CO)(C(C)(CC(C(O)=O)=O)O)=O,,,4,1,4,13,17
2611_0,,,,2,2,1,3
C(C(C=O)C(C(CO)=O)(C)O)(O)=O,,,4,1,7,13,20
2611_1,,,,2,2,1,3
2613_0,,,,2,2,1,3
C(CO)(C(C)(C(C(CO)=O)O)O)=O,,,4,1,6,15,21
2613_1,,,,2,2,1,3
2615_0,,,,2,2,1,3
C(CO)(C(C)(CC(C=O)=O)O)=O,,,4,1,3,17,20
2617_0,,,,2,2,1,3
C(C(C=O)C(C(CO)=O)(C)O)=O,,,4,1,5,11,16
2617_1,,,,2,2,1,3
2619_0,,,,2,2,1,3
C(CO)(C(C)(CC=O)O)=O,,,4,1,10,24,34
2621_0,,,,2,2,1,3
C(CO)(C(C)(C(C(C=O)=O)O)O)=O,,,4,1,5,18,23
2621_1,,,,2,2,1,3
2623_0,,,,2,2,1,3
C(CO)(C(C)(C(C=O)O)O)=O,,,4,1,10,19,29
2623_1,,,,2,2,1,3
2625_0,,,,2,2,1,3
C(C(C(C(C(C(C)=O)=O)O)O)O)=O,,,4,1,7,21,28
2625_1,,,,2,2,1,3
2627_0,,,,2,2,1,3
C(C(C)=O)(C(C(CO)(C)O)O)=O,,,4,1,4,12,16
2627_1,,,,2,2,1,3
2629_0,,,,2,2,1,3
C(C(C)(C(C(C(C)=O)=O)O)O)(O)=O,,,4,1,4,11,15
2629_1,,,,2,2,1,3
2631_0,,,,2,2,1,3
C(CC(C(C(C(C)=O)=O)O)O)(O)=O,,,4,1,3,12,15
2631_1,,,,2,2,1,3
2633_0,,,,2,2,1,3
C(C(C=C)(C(C(C(C)=O)=O)O)O)=O,,,4,1,3,10,13
2633_1,,,,2,2,1,3
2635_0,,,,2,2,1,3
C=CC(C(C(C(C(C)=O)=O)O)O)=O,,,4,1,4,13,17
2635_1,,,,2,2,1,3
2637_0,,,,2,2,1,3
C(C(C(C(C(C)=O)=O)O)O)=CC=O,,,4,1,2,12,14
2637_1,,,,2,2,1,3
2639_0,,,,2,2,1,3
C(C(C(C(C)=O)=O)O)(O)=O,,,4,1,9,19,28
2639_1,,,,2,2,1,3
2641_0,,,,2,2,1,3
C(C(C)=O)(C(C(C(O)O)O)O)=O,,,4,1,3,13,16
2641_1,,,,2,2,1,3
2643_0,,,,2,2,1,3
C(C(C)=O)(C(C(C(C)O)O)O)=O,,,4,1,4,14,18
2643_1,,,,2,2,1,3
2645_0,,,,2,2,1,3
C(C(C)=O)(C(C(C(CO)O)O)O)=O,,,4,1,9,15,24
2645_1,,,,2,2,1,3
2647_0,,,,2,2,1,3
C(C(C(C(C(C)=O)=O)O)O)=O,,,4,1,12,23,35
2647_1,,,,2,2,1,3
2649_0,,,,2,2,1,3
C(C(C)=O)(C(C(CO)(CO)O)O)=O,,,4,1,4,9,13
2649_1,,,,2,2,1,3
2651_0,,,,2,2,1,3
C(C(C(C(C(C)=O)=O)O)O)(O)=O,,,4,1,6,14,20
2651_1,,,,2,2,1,3
2653_0,,,,2,2,1,3
C(C(C)(C(C(C(C)=O)=O)O)O)=O,,,4,1,4,14,18
2653_1,,,,2,2,1,3
2655_0,,,,2,2,1,3
C(C)(C(C(C(C(C)=O)=O)O)O)=O,,,4,1,8,16,24
2655_1,,,,2,2,1,3
2657_0,,,,2,2,1,3
C(CC(C(C(C(C)=O)=O)O)O)=O,,,4,1,8,18,26
2657_1,,,,2,2,1,3
2659_0,,,,2,2,1,3
C(C(C)=O)(C(C(C)O)O)=O,,,4,1,5,21,26
2659_1,,,,2,2,1,3
2661_0,,,,2,2,1,3
C(C(CO)(C(C(C(C)=O)=O)O)O)=O,,,4,1,8,17,25
2661_1,,,,2,2,1,3
2663_0,,,,2,2,1,3
C(CO)(C(C(C(C(C)=O)=O)O)O)=O,,,4,1,8,18,26
2663_1,,,,2,2,1,3
2665_0,,,,2,2,1,3
C(C(C)=O)(C(CO)O)=O,,,4,1,18,36,54
2665_1,,,,2,2,1,3
2667_0,,,,2,2,1,3
C(C(C)=O)(C(C(CO)O)O)=O,,,4,1,9,16,25
2667_1,,,,2,2,1,3
2669_0,,,,2,2,1,3
C(C(C(CC(C(CO)=O)=O)O)O)=O,,,4,1,7,19,26
2671_0,,,,2,2,1,3
C(C(CO)=O)(CC(CO)(C)O)=O,,,4,1,4,11,15
2673_0,,,,2,2,1,3
C(C(C)(CC(C(CO)=O)=O)O)(O)=O,,,4,1,4,10,14
2675_0,,,,2,2,1,3
C(CC(CC(C(CO)=O)=O)O)(O)=O,,,4,1,4,9,13
2677_0,,,,2,2,1,3
C(C(C=C)(CC(C(CO)=O)=O)O)=O,,,4,1,3,9,12
2679_0,,,,2,2,1,3
C=CC(C(CC(C(CO)=O)=O)O)=O,,,4,1,3,11,14
2681_0,,,,2,2,1,3
C(C(CC(C(CO)=O)=O)O)=CC=O,,,4,1,3,11,14
2683_0,,,,2,2,1,3
C(CC(C(CO)=O)=O)(O)=O,,,4,1,10,22,32
2685_0,,,,2,2,1,3
C(C(CO)=O)(CC(C(O)O)O)=O,,,4,1,3,11,14
2687_0,,,,2,2,1,3
C(C(CO)=O)(CC(C(C)O)O)=O,,,4,1,4,12,16
2689_0,,,,2,2,1,3
C(C(CO)=O)(CC(C(CO)O)O)=O,,,4,1,8,13,21
2691_0,,,,2,2,1,3
C(C(CC(C(CO)=O)=O)O)=O,,,4,1,8,20,28
2693_0,,,,2,2,1,3
C(C(CO)=O)(CC(CO)(CO)O)=O,,,4,1,4,8,12
2695_0,,,,2,2,1,3
C(C(CC(C(CO)=O)=O)O)(O)=O,,,4,1,8,12,20
2697_0,,,,2,2,1,3
C(C(C)(CC(C(CO)=O)=O)O)=O,,,4,1,4,13,17
2699_0,,,,2,2,1,3
C(C)(C(CC(C(CO)=O)=O)O)=O,,,4,1,5,14,19
2701_0,,,,2,2,1,3
C(CC(CC(C(CO)=O)=O)O)=O,,,4,1,6,16,22
2703_0,,,,2,2,1,3
C(C(CO)=O)(CC(C)O)=O,,,4,1,4,22,26
2705_0,,,,2,2,1,3
C(C(CO)(CC(C(CO)=O)=O)O)=O,,,4,1,4,14,18
2707_0,,,,2,2,1,3
C(CO)(C(CC(C(CO)=O)=O)O)=O,,,4,1,4,16,20
2709_0,,,,2,2,1,3
C(C(CO)=O)(CCO)=O,,,4,1,18,40,58
2711_0,,,,2,2,1,3
C(C(CO)=O)(CC(CO)O)=O,,,4,1,8,15,23
2713_0,,,,2,2,1,3
C(C(C(C)O)(C(C(C)=O)O)O)=O,,,4,1,8,17,25
2713_1,,,,2,2,1,3
2715_0,,,,2,2,1,3
C(C(C(C)O)(CC(CO)=O)O)=O,,,4,1,5,14,19
2717_0,,,,2,2,1,3
C(C(C(C)O)(CC(C(O)=O)=O)O)=O,,,4,1,4,14,18
2719_0,,,,2,2,1,3
C(C(C=O)C(C=O)(C(C)O)O)(O)=O,,,4,1,7,14,21
2719_1,,,,2,2,1,3
2721_0,,,,2,2,1,3
C(C(C(C)O)(C(C(CO)=O)O)O)=O,,,4,1,9,18,27
2721_1,,,,2,2,1,3
2723_0,,,,2,2,1,3
C(C(C(C)O)(CC(C=O)=O)O)=O,,,4,1,4,17,21
2725_0,,,,2,2,1,3
C(C(C=O)C(C=O)(C(C)O)O)=O,,,4,1,5,13,18
2725_1,,,,2,2,1,3
2726_0,,,,2,2,1,3
2728_0,,,,2,2,1,3
C(C(C(C)O)(C(C(C=O)=O)O)O)=O,,,4,1,8,19,27
2728_1,,,,2,2,1,3
2729_0,,,,2,2,1,3
2729_1,,,,2,2,1,3
2731_0,,,,2,2,1,3
C(C(C(C(C(C)O)=O)O)O)(C)=O,,,4,1,6,14,20
2731_1,,,,2,2,1,3
2733_0,,,,2,2,1,3
C(CC(C(C(C)O)=O)O)(CO)=O,,,4,1,4,12,16
2735_0,,,,2,2,1,3
C(C(CC(C(O)=O)=O)O)(C(C)O)=O,,,4,1,4,13,17
2737_0,,,,2,2,1,3
C(C(C=O)C(C(C(C)O)=O)O)(O)=O,,,4,1,8,13,21
2737_1,,,,2,2,1,3
2739_0,,,,2,2,1,3
C(C(C(C(C(C)O)=O)O)O)(CO)=O,,,4,1,8,16,24
2739_1,,,,2,2,1,3
2741_0,,,,2,2,1,3
C(C(CC(C=O)=O)O)(C(C)O)=O,,,4,1,3,16,19
2743_0,,,,2,2,1,3
C(C(C=O)C(C(C(C)O)=O)O)=O,,,4,1,5,11,16
2743_1,,,,2,2,1,3
2745_0,,,,2,2,1,3
C(CC(C(C(C)O)=O)O)=O,,,4,1,13,24,37
2747_0,,,,2,2,1,3
C(C(C(C(C=O)=O)O)O)(C(C)O)=O,,,4,1,6,18,24
2747_1,,,,2,2,1,3
2749_0,,,,2,2,1,3
C(C(C(C=O)O)O)(C(C)O)=O,,,4,1,13,22,35
2749_1,,,,2,2,1,3
2750_0,,,,2,2,1,3
2750_1,,,,2,2,1,3
2751_0,,,,2,2,1,3
2752_0,,,,2,2,1,3
2752_1,,,,2,2,1,3
2753_0,,,,2,2,1,3
2753_1,,,,2,2,1,3
2754_0,,,,2,2,1,3
2756_0,,,,2,2,1,3
C(C(C(CC(C(O)=O)=O)O)O)=O,,,4,1,8,20,28
2757_0,,,,2,2,1,3
2757_1,,,,2,2,1,3
2759_0,,,,2,2,1,3
C(C(C(C(C(C(O)=O)=O)O)O)O)=O,,,4,1,10,21,31
2759_1,,,,2,2,1,3
2761_0,,,,2,2,1,3
C(C(C(C=O)=O)C(C(C=O)O)O)=O,,,4,1,6,20,26
2761_1,,,,2,2,1,3
2763_0,,,,2,2,1,3
C(C(C(C1C(C(CO1)O)=O)O)O)=O,,,4,1,3,15,18
2763_1,,,,2,2,1,3
2765_0,,,,2,2,1,3
C(C(C(C1C(C(O)OC1)=O)O)O)=O,,,4,1,6,16,22
2765_1,,,,2,2,1,3
2767_0,,,,2,2,1,3
C(C(C(C1C(COC1O)=O)O)O)=O,,,4,1,4,19,23
2767_1,,,,2,2,1,3
2769_0,,,,2,2,1,3
C(C(C(C1C(CC(O1)O)=O)O)O)=O,,,4,1,4,16,20
2769_1,,,,2,2,1,3
2771_0,,,,2,2,1,3
C(C(C(CC(C(C=O)=O)=O)O)O)=O,,,4,1,4,20,24
2772_0,,,,2,2,1,3
2772_1,,,,2,2,1,3
2774_0,,,,2,2,1,3
C(C(C(CC(C=O)=O)O)O)=O,,,4,1,17,27,44
2776_0,,,,2,2,1,3
C(C(C=O)C(C(C=O)O)O)=O,,,4,1,10,20,30
2776_1,,,,2,2,1,3
2778_0,,,,2,2,1,3
C(C(C(C(C(C=O)=O)CO)O)O)=O,,,4,1,11,23,34
2778_1,,,,2,2,1,3
2779_0,,,,2,2,1,3
2779_1,,,,2,2,1,3
2781_0,,,,2,2,1,3
C(C(C(C(C=O)C(CO)=O)O)O)=O,,,4,1,9,19,28
2781_1,,,,2,2,1,3
2783_0,,,,2,2,1,3
C(CC(C(C(C(C=O)O)O)O)=O)=O,,,4,1,9,23,32
2783_1,,,,2,2,1,3
2785_0,,,,2,2,1,3
C(CC(C(C=O)O)O)(C(C=O)O)=O,,,4,1,6,21,27
2786_0,,,,2,2,1,3
2787_0,,,,2,2,1,3
2787_1,,,,2,2,1,3
2789_0,,,,2,2,1,3
C(C(C(C(C=O)O)O)O)=O,,,4,1,14,18,32
2789_1,,,,2,2,1,3
2791_0,,,,2,2,1,3
C(C)(C(C(CO)(C)O)O)=O,,,4,1,10,18,28
2791_1,,,,2,2,1,3
2793_0,,,,2,2,1,3
C(CO)(CC(CO)(C)O)=O,,,4,1,11,20,31
2795_0,,,,2,2,1,3
C(C(C(CO)(C)O)O)(CCO)=O,,,4,1,5,10,15
2795_1,,,,2,2,1,3
2797_0,,,,2,2,1,3
C(CO)(C(CO)C(CO)(C)O)=O,,,4,1,7,11,18
2797_1,,,,2,2,1,3
2799_0,,,,2,2,1,3
C(C(CO)O)(CC(CO)(C)O)=O,,,4,1,5,11,16
2801_0,,,,2,2,1,3
C(C(CC(C)(CO)O)=O)(O)=O,,,4,1,5,13,18
2803_0,,,,2,2,1,3
C(C(C=O)C(C)(CO)O)(O)=O,,,4,1,7,13,20
2803_1,,,,2,2,1,3
2805_0,,,,2,2,1,3
C(C(C(CO)C(C)(CO)O)=O)(O)=O,,,4,1,7,15,22
2805_1,,,,2,2,1,3
2807_0,,,,2,2,1,3
C(C(C(CO)=O)C(CO)(C)O)(O)=O,,,4,1,8,11,19
2807_1,,,,2,2,1,3
2809_0,,,,2,2,1,3
C(CC(C(C(CO)(C)O)O)=O)(O)=O,,,4,1,5,12,17
2809_1,,,,2,2,1,3
2811_0,,,,2,2,1,3
C(C(C(CC(CO)(C)O)=O)O)(O)=O,,,4,1,8,11,19
2813_0,,,,2,2,1,3
C(C(C(C(CO)(C)O)O)=O)(O)=O,,,4,1,4,12,16
2813_1,,,,2,2,1,3
2815_0,,,,2,2,1,3
C(C(C(C=O)=O)C(C)(CO)O)=O,,,4,1,7,18,25
2815_1,,,,2,2,1,3
2817_0,,,,2,2,1,3
C(C(C(C=O)=O)C(C)(CO)O)(O)=O,,,4,1,7,14,21
2817_1,,,,2,2,1,3
2819_0,,,,2,2,1,3
C(C(C(C(O)=O)=O)C(C)(CO)O)=O,,,4,1,5,14,19
2819_1,,,,2,2,1,3
2821_0,,,,2,2,1,3
C1(C(C(CO)(C)O)OCC1O)=O,,,4,1,3,6,9
2821_1,,,,2,2,1,3
2823_0,,,,2,2,1,3
C1(C(O)OCC1C(CO)(C)O)=O,,,4,1,4,9,13
2823_1,,,,2,2,1,3
2825_0,,,,2,2,1,3
C1(COC(C1C(CO)(C)O)O)=O,,,4,1,4,11,15
2825_1,,,,2,2,1,3
2827_0,,,,2,2,1,3
C1(C(C(CO)(C)O)OC(C1)O)=O,,,4,1,4,9,13
2827_1,,,,2,2,1,3
2829_0,,,,2,2,1,3
C(C(C(CC(C)(CO)O)=O)=O)=O,,,4,1,3,15,18
2831_0,,,,2,2,1,3
C(CO)(C(C(CO)(C)O)O)=O,,,4,1,9,12,21
2831_1,,,,2,2,1,3
2833_0,,,,2,2,1,3
C(C(C(CO)(C)O)O)(C(CO)O)=O,,,4,1,8,12,20
2833_1,,,,2,2,1,3
2835_0,,,,2,2,1,3
C(C(CC(C)(CO)O)=O)=O,,,4,1,10,21,31
2837_0,,,,2,2,1,3
C(C(C=O)C(C)(CO)O)=O,,,4,1,10,13,23
2837_1,,,,2,2,1,3
2839_0,,,,2,2,1,3
C(C(C(CO)C(C)(CO)O)=O)=O,,,4,1,7,18,25
2839_1,,,,2,2,1,3
2841_0,,,,2,2,1,3
C(C(C(CO)(C)O)C(C=O)O)=O,,,4,1,7,19,26
2841_1,,,,2,2,1,3
2843_0,,,,2,2,1,3
C(C(C(CO)=O)C(CO)(C)O)=O,,,4,1,8,13,21
2843_1,,,,2,2,1,3
2845_0,,,,2,2,1,3
C(CC(C(C(CO)(C)O)O)=O)=O,,,4,1,5,14,19
2845_1,,,,2,2,1,3
2847_0,,,,2,2,1,3
C(C(C(CC(CO)(C)O)=O)O)=O,,,4,1,3,13,16
2849_0,,,,2,2,1,3
C(CC(C)(CO)O)=O,,,4,1,21,65,86
2851_0,,,,2,2,1,3
C(C(C(C(CO)(C)O)O)=O)=O,,,4,1,6,17,23
2851_1,,,,2,2,1,3
2853_0,,,,2,2,1,3
C(C(C(CO)(C)O)O)=O,,,4,1,17,29,46
2853_1,,,,2,2,1,3
2855_0,,,,2,2,1,3
C(C)(C(C(CO)(CCO)O)O)=O,,,4,1,4,10,14
2855_1,,,,2,2,1,3
2857_0,,,,2,2,1,3
C(C)(C(C(C(CCO)O)O)O)=O,,,4,1,4,12,16
2857_1,,,,2,2,1,3
2859_0,,,,2,2,1,3
C(C)(C(C(C)(C(CO)O)O)O)=O,,,4,1,3,11,14
2859_1,,,,2,2,1,3
2860_0,,,,2,2,1,3
2860_1,,,,2,2,1,3
2862_0,,,,2,2,1,3
C(CC(C(C(C)=O)O)O)(O)=O,,,4,1,8,13,21
2862_1,,,,2,2,1,3
2863_0,,,,2,2,1,3
2863_1,,,,2,2,1,3
2865_0,,,,2,2,1,3
C(CC(C(C(C(C)=O)O)O)O)(O)=O,,,4,1,3,13,16
2865_1,,,,2,2,1,3
2867_0,,,,2,2,1,3
C(CC(CO)(C(C(C)=O)O)O)(O)=O,,,4,1,4,10,14
2867_1,,,,2,2,1,3
2869_0,,,,2,2,1,3
C(C(C(C)(C(C(C)=O)O)O)O)(O)=O,,,4,1,6,12,18
2869_1,,,,2,2,1,3
2870_0,,,,2,2,1,3
2870_1,,,,2,2,1,3
2871_0,,,,2,2,1,3
2871_1,,,,2,2,1,3
2872_0,,,,2,2,1,3
2872_1,,,,2,2,1,3
2873_0,,,,2,2,1,3
2873_1,,,,2,2,1,3
2875_0,,,,2,2,1,3
C(CC(C=O)(C(C(C)=O)O)O)(O)=O,,,4,1,4,12,16
2875_1,,,,2,2,1,3
2877_0,,,,2,2,1,3
C(CC(C(C(C(C)=O)O)O)=O)(O)=O,,,4,1,6,16,22
2877_1,,,,2,2,1,3
2879_0,,,,2,2,1,3
C(C)(C(C(CC(C(O)=O)=O)O)O)=O,,,4,1,6,15,21
2879_1,,,,2,2,1,3
2881_0,,,,2,2,1,3
C(C(CC=O)(C(C(C)=O)O)O)(O)=O,,,4,1,5,13,18
2881_1,,,,2,2,1,3
2883_0,,,,2,2,1,3
C(C)(C(C1(COCC1O)O)O)=O,,,4,1,2,7,9
2883_1,,,,2,2,1,3
2885_0,,,,2,2,1,3
C(C)(C(C1(C(O)OCC1)O)O)=O,,,4,1,3,9,12
2885_1,,,,2,2,1,3
2887_0,,,,2,2,1,3
C(C)(C(C1(COC(C1)O)O)O)=O,,,4,1,3,9,12
2887_1,,,,2,2,1,3
2888_0,,,,2,2,1,3
2888_1,,,,2,2,1,3
2889_0,,,,2,2,1,3
2889_1,,,,2,2,1,3
2891_0,,,,2,2,1,3
C(C(C(C(C=O)=O)(C)O)O)(C)=O,,,4,1,7,17,24
2891_1,,,,2,2,1,3
2893_0,,,,2,2,1,3
C(C(C=C)(C(C(C)=O)O)O)=O,,,4,1,10,15,25
2893_1,,,,2,2,1,3
2895_0,,,,2,2,1,3
C(C)(C(C(C(C=C)=O)O)O)=O,,,4,1,10,20,30
2895_1,,,,2,2,1,3
2897_0,,,,2,2,1,3
C(C)(C(C(C=CC=O)O)O)=O,,,4,1,9,18,27
2897_1,,,,2,2,1,3
2899_0,,,,2,2,1,3
C(C)(C(C1(C(O)OCC1O)O)O)=O,,,4,1,4,9,13
2899_1,,,,2,2,1,3
2900_0,,,,2,2,1,3
2900_1,,,,2,2,1,3
2902_0,,,,2,2,1,3
C(C)(C(C(C(O)O)O)O)=O,,,4,1,9,19,28
2902_1,,,,2,2,1,3
2904_0,,,,2,2,1,3
C(C)(C(C(C(C)O)O)O)=O,,,4,1,9,20,29
2904_1,,,,2,2,1,3
2906_0,,,,2,2,1,3
C(C)(C(C(C(CO)O)O)O)=O,,,4,1,13,15,28
2906_1,,,,2,2,1,3
2908_0,,,,2,2,1,3
C(C)(C(C(C(C(CO)O)O)O)O)=O,,,4,1,8,14,22
2908_1,,,,2,2,1,3
2909_0,,,,2,2,1,3
2909_1,,,,2,2,1,3
2910_0,,,,2,2,1,3
2910_1,,,,2,2,1,3
2912_0,,,,2,2,1,3
C(C)(C(C(CO)(CO)O)O)=O,,,4,1,9,10,19
2912_1,,,,2,2,1,3
2914_0,,,,2,2,1,3
C(C)(C(C(CO)(C(CO)O)O)O)=O,,,4,1,8,11,19
2914_1,,,,2,2,1,3
2915_0,,,,2,2,1,3
2915_1,,,,2,2,1,3
2917_0,,,,2,2,1,3
C(C)(C(C(C(CO)(CO)O)O)O)=O,,,4,1,4,9,13
2917_1,,,,2,2,1,3
2919_0,,,,2,2,1,3
C(C(C)(C(C(C)=O)O)O)=O,,,4,1,14,22,36
2919_1,,,,2,2,1,3
2921_0,,,,2,2,1,3
C(C)(C(C(C(C)=O)O)O)=O,,,4,1,12,16,28
2921_1,,,,2,2,1,3
2922_0,,,,2,2,1,3
2922_1,,,,2,2,1,3
2924_0,,,,2,2,1,3
C(C(CCO)(C(C(C)=O)O)O)=O,,,4,1,7,14,21
2924_1,,,,2,2,1,3
2926_0,,,,2,2,1,3
C(C(C(C(CCO)=O)O)O)(C)=O,,,4,1,9,16,25
2926_1,,,,2,2,1,3
2927_0,,,,2,2,1,3
2927_1,,,,2,2,1,3
2929_0,,,,2,2,1,3
C(C(CC(C(C(C)=O)O)O)O)=O,,,4,1,6,20,26
2929_1,,,,2,2,1,3
2931_0,,,,2,2,1,3
C(C)(C(C(CC(CO)=O)O)O)=O,,,4,1,8,15,23
2931_1,,,,2,2,1,3
2933_0,,,,2,2,1,3
C(CC(CO)(C(C(C)=O)O)O)=O,,,4,1,8,15,23
2933_1,,,,2,2,1,3
2935_0,,,,2,2,1,3
C(C)(C(C(C(C(C)=O)O)O)O)=O,,,4,1,4,8,12
2935_1,,,,2,2,1,3
2937_0,,,,2,2,1,3
C(C(C(C)(C(C(C)=O)O)O)O)=O,,,4,1,4,17,21
2937_1,,,,2,2,1,3
2939_0,,,,2,2,1,3
C(C)(C(C(C)O)O)=O,,,4,1,22,83,105
2939_1,,,,2,2,1,3
2940_0,,,,2,2,1,3
2940_1,,,,2,2,1,3
2941_0,,,,2,2,1,3
2941_1,,,,2,2,1,3
2942_0,,,,2,2,1,3
2942_1,,,,2,2,1,3
2943_0,,,,2,2,1,3
2943_1,,,,2,2,1,3
2944_0,,,,2,2,1,3
2944_1,,,,2,2,1,3
2946_0,,,,2,2,1,3
C(C)(C(C(CO)O)O)=O,,,4,1,19,34,53
2946_1,,,,2,2,1,3
2948_0,,,,2,2,1,3
C(CO)(CC(CO)(CCO)O)=O,,,4,1,4,9,13
2950_0,,,,2,2,1,3
C(CO)(CC(C(CCO)O)O)=O,,,4,1,4,10,14
2952_0,,,,2,2,1,3
C(CO)(CC(C)(C(CO)O)O)=O,,,4,1,3,10,13
2954_0,,,,2,2,1,3
C(C(C)(CC(CO)=O)O)(O)=O,,,4,1,9,12,21
2956_0,,,,2,2,1,3
C(CC(CC(CO)=O)O)(O)=O,,,4,1,9,12,21
2958_0,,,,2,2,1,3
C(C(CCO)(CC(CO)=O)O)(O)=O,,,4,1,5,10,15
2960_0,,,,2,2,1,3
C(CC(C(CC(CO)=O)O)O)(O)=O,,,4,1,3,10,13
2962_0,,,,2,2,1,3
C(CC(CO)(CC(CO)=O)O)(O)=O,,,4,1,4,9,13
2964_0,,,,2,2,1,3
C(C(C(C)(CC(CO)=O)O)O)(O)=O,,,4,1,7,11,18
2966_0,,,,2,2,1,3
C(C(CO)(CC(CO)=O)O)(O)=O,,,4,1,7,10,17
2968_0,,,,2,2,1,3
C(CC(C=O)(CC(CO)=O)O)=O,,,4,1,10,17,27
2970_0,,,,2,2,1,3
C(CC(C(CC(CO)=O)O)=O)=O,,,4,1,12,19,31
2971_0,,,,2,2,1,3
2973_0,,,,2,2,1,3
C(CC(C=O)(CC(CO)=O)O)(O)=O,,,4,1,3,11,14
2975_0,,,,2,2,1,3
C(CC(C(CC(CO)=O)O)=O)(O)=O,,,4,1,4,13,17
2977_0,,,,2,2,1,3
C(CO)(CC(CC(C(O)=O)=O)O)=O,,,4,1,6,13,19
2979_0,,,,2,2,1,3
C(C(CC=O)(CC(CO)=O)O)(O)=O,,,4,1,5,13,18
2981_0,,,,2,2,1,3
C(CO)(CC1(COCC1O)O)=O,,,4,1,2,6,8
2983_0,,,,2,2,1,3
C(CO)(CC1(C(O)OCC1)O)=O,,,4,1,3,8,11
2985_0,,,,2,2,1,3
C(CO)(CC1(COC(C1)O)O)=O,,,4,1,3,8,11
2987_0,,,,2,2,1,3
C(C(C(C)=O)(CC(CO)=O)O)=O,,,4,1,6,14,20
2989_0,,,,2,2,1,3
C(CO)(CC(C(C(C)=O)=O)O)=O,,,4,1,9,15,24
2991_0,,,,2,2,1,3
C(CC(C(C=O)=O)(C)O)(CO)=O,,,4,1,7,17,24
2993_0,,,,2,2,1,3
C(C(C=C)(CC(CO)=O)O)=O,,,4,1,9,15,24
2995_0,,,,2,2,1,3
C(CO)(CC(C(C=C)=O)O)=O,,,4,1,8,18,26
2997_0,,,,2,2,1,3
C(CO)(CC(C=CC=O)O)=O,,,4,1,9,18,27
2999_0,,,,2,2,1,3
C(CO)(CC1(C(O)OCC1O)O)=O,,,4,1,3,8,11
3000_0,,,,2,2,1,3
3002_0,,,,2,2,1,3
C(CO)(CC(C(O)O)O)=O,,,4,1,10,20,30
3004_0,,,,2,2,1,3
C(CO)(CC(C(C)O)O)=O,,,4,1,10,21,31
3006_0,,,,2,2,1,3
C(CO)(CC(C(CO)O)O)=O,,,4,1,11,14,25
3008_0,,,,2,2,1,3
C(CO)(CC(C(C(CO)O)O)O)=O,,,4,1,8,12,20
3009_0,,,,2,2,1,3
3011_0,,,,2,2,1,3
C(C(C(C(CC(CO)=O)O)O)O)=O,,,4,1,11,22,33
3013_0,,,,2,2,1,3
C(CO)(CC(CO)(CO)O)=O,,,4,1,9,10,19
3015_0,,,,2,2,1,3
C(CO)(CC(CO)(C(CO)O)O)=O,,,4,1,7,10,17
3016_0,,,,2,2,1,3
3018_0,,,,2,2,1,3
C(CO)(CC(C(CO)(CO)O)O)=O,,,4,1,5,7,12
3020_0,,,,2,2,1,3
C(C(C)(CC(CO)=O)O)=O,,,4,1,13,24,37
3022_0,,,,2,2,1,3
C(C)(C(CC(CO)=O)O)=O,,,4,1,20,30,50
3023_0,,,,2,2,1,3
3025_0,,,,2,2,1,3
C(C(CCO)(CC(CO)=O)O)=O,,,4,1,7,13,20
3027_0,,,,2,2,1,3
C(CC(C(CCO)=O)O)(CO)=O,,,4,1,8,14,22
3029_0,,,,2,2,1,3
C(CC(C(CC(CO)=O)O)O)=O,,,4,1,7,19,26
3031_0,,,,2,2,1,3
C(C(CC(CC(CO)=O)O)O)=O,,,4,1,7,18,25
3033_0,,,,2,2,1,3
C(CO)(CC(CC(CO)=O)O)=O,,,4,1,4,7,11
3035_0,,,,2,2,1,3
C(CC(CO)(CC(CO)=O)O)=O,,,4,1,9,15,24
3036_0,,,,2,2,1,3
3038_0,,,,2,2,1,3
C(C(C(C)(CC(CO)=O)O)O)=O,,,4,1,7,17,24
3040_0,,,,2,2,1,3
C(CO)(CC(C)O)=O,,,4,1,31,97,128
3041_0,,,,2,2,1,3
3043_0,,,,2,2,1,3
C(CO)(C(CC(CO)=O)O)=O,,,4,1,15,19,34
3045_0,,,,2,2,1,3
C(C(C(CO)O)(CC(CO)=O)O)=O,,,4,1,11,15,26
3047_0,,,,2,2,1,3
C(CC(C(C(CO)O)=O)O)(CO)=O,,,4,1,11,16,27
3048_0,,,,2,2,1,3
3050_0,,,,2,2,1,3
C(CO)(CC(CO)O)=O,,,4,1,19,38,57
3052_0,,,,2,2,1,3
C(C(CC(CO)(CCO)O)=O)(O)=O,,,4,1,4,13,17
3054_0,,,,2,2,1,3
C(C(C=O)C(CO)(CCO)O)(O)=O,,,4,1,7,13,20
3054_1,,,,2,2,1,3
3056_0,,,,2,2,1,3
C(CO)(C(C(CO)(CCO)O)O)=O,,,4,1,5,10,15
3056_1,,,,2,2,1,3
3058_0,,,,2,2,1,3
C(C(CC(CO)(CCO)O)=O)=O,,,4,1,3,16,19
3060_0,,,,2,2,1,3
C(C(C=O)C(CO)(CCO)O)=O,,,4,1,5,11,16
3060_1,,,,2,2,1,3
3062_0,,,,2,2,1,3
C(CC(CO)(CCO)O)=O,,,4,1,12,17,29
3064_0,,,,2,2,1,3
C(C(C(C(CO)(CCO)O)O)=O)=O,,,4,1,4,15,19
3064_1,,,,2,2,1,3
3066_0,,,,2,2,1,3
C(C(C(CO)(CCO)O)O)=O,,,4,1,7,15,22
3066_1,,,,2,2,1,3
3067_0,,,,2,2,1,3
3067_1,,,,2,2,1,3
3069_0,,,,2,2,1,3
C(CC(C(C(CCO)=O)O)O)(O)=O,,,4,1,5,10,15
3069_1,,,,2,2,1,3
3071_0,,,,2,2,1,3
C(C(C=C)(C(C(CCO)=O)O)O)=O,,,4,1,5,12,17
3071_1,,,,2,2,1,3
3073_0,,,,2,2,1,3
C(C(C(C(C=C)=O)O)O)(CCO)=O,,,4,1,6,16,22
3073_1,,,,2,2,1,3
3075_0,,,,2,2,1,3
C(C(C(C=CC=O)O)O)(CCO)=O,,,4,1,4,14,18
3075_1,,,,2,2,1,3
3076_0,,,,2,2,1,3
3076_1,,,,2,2,1,3
3078_0,,,,2,2,1,3
C(C(C(C(O)O)O)O)(CCO)=O,,,4,1,4,11,15
3078_1,,,,2,2,1,3
3080_0,,,,2,2,1,3
C(C(C(C(C)O)O)O)(CCO)=O,,,4,1,4,12,16
3080_1,,,,2,2,1,3
3082_0,,,,2,2,1,3
C(C(C(C(CO)O)O)O)(CCO)=O,,,4,1,8,13,21
3082_1,,,,2,2,1,3
3083_0,,,,2,2,1,3
3083_1,,,,2,2,1,3
3085_0,,,,2,2,1,3
C(C(C(CO)(CO)O)O)(CCO)=O,,,4,1,6,8,14
3085_1,,,,2,2,1,3
3086_0,,,,2,2,1,3
3086_1,,,,2,2,1,3
3088_0,,,,2,2,1,3
C(C(C)(C(C(CCO)=O)O)O)=O,,,4,1,7,15,22
3088_1,,,,2,2,1,3
3089_0,,,,2,2,1,3
3089_1,,,,2,2,1,3
3090_0,,,,2,2,1,3
3090_1,,,,2,2,1,3
3092_0,,,,2,2,1,3
C(C(C(C)O)O)(CCO)=O,,,4,1,5,22,27
3092_1,,,,2,2,1,3
3093_0,,,,2,2,1,3
3093_1,,,,2,2,1,3
3094_0,,,,2,2,1,3
3094_1,,,,2,2,1,3
3096_0,,,,2,2,1,3
C(C(CO)O)(CCO)=O,,,4,1,21,39,60
3096_1,,,,2,2,1,3
3098_0,,,,2,2,1,3
C(C(C(CO)O)O)(CCO)=O,,,4,1,8,15,23
3098_1,,,,2,2,1,3
3100_0,,,,2,2,1,3
C(C(C)(C(C(CO)=O)CO)O)(O)=O,,,4,1,8,12,20
3100_1,,,,2,2,1,3
3102_0,,,,2,2,1,3
C(CC(C(C(CO)=O)CO)O)(O)=O,,,4,1,7,11,18
3102_1,,,,2,2,1,3
3104_0,,,,2,2,1,3
C(C(C=C)(C(C(CO)=O)CO)O)=O,,,4,1,6,12,18
3104_1,,,,2,2,1,3
3106_0,,,,2,2,1,3
C(CO)(C(CO)C(C(C=C)=O)O)=O,,,4,1,6,15,21
3106_1,,,,2,2,1,3
3108_0,,,,2,2,1,3
C(CO)(C(CO)C(C=CC=O)O)=O,,,4,1,6,12,18
3108_1,,,,2,2,1,3
3110_0,,,,2,2,1,3
C(C(C(CO)=O)CO)(O)=O,,,4,1,13,18,31
3110_1,,,,2,2,1,3
3112_0,,,,2,2,1,3
C(CO)(C(CO)C(C(O)O)O)=O,,,4,1,6,11,17
3112_1,,,,2,2,1,3
3114_0,,,,2,2,1,3
C(CO)(C(CO)C(C(C)O)O)=O,,,4,1,6,12,18
3114_1,,,,2,2,1,3
3116_0,,,,2,2,1,3
C(CO)(C(CO)C(C(CO)O)O)=O,,,4,1,10,13,23
3116_1,,,,2,2,1,3
3118_0,,,,2,2,1,3
C(CO)(C(CO)C(C=O)O)=O,,,4,1,16,21,37
3118_1,,,,2,2,1,3
3120_0,,,,2,2,1,3
C(CO)(C(CO)C(CO)(CO)O)=O,,,4,1,8,9,17
3120_1,,,,2,2,1,3
3122_0,,,,2,2,1,3
C(CO)(C(CO)C(C(O)=O)O)=O,,,4,1,13,13,26
3122_1,,,,2,2,1,3
3124_0,,,,2,2,1,3
C(C(C)(C(C(CO)=O)CO)O)=O,,,4,1,8,15,23
3124_1,,,,2,2,1,3
3126_0,,,,2,2,1,3
C(CO)(C(CO)C(C(C)=O)O)=O,,,4,1,9,15,24
3126_1,,,,2,2,1,3
3127_0,,,,2,2,1,3
3127_1,,,,2,2,1,3
3129_0,,,,2,2,1,3
C(CO)(C(CO)C(C)O)=O,,,4,1,10,19,29
3129_1,,,,2,2,1,3
3131_0,,,,2,2,1,3
C(C(CO)(C(C(CO)=O)CO)O)=O,,,4,1,11,16,27
3131_1,,,,2,2,1,3
3133_0,,,,2,2,1,3
C(CO)(C(CO)C(C(CO)=O)O)=O,,,4,1,10,16,26
3133_1,,,,2,2,1,3
3135_0,,,,2,2,1,3
C(CO)(C(CO)CO)=O,,,4,1,12,29,41
3135_1,,,,2,2,1,3
3137_0,,,,2,2,1,3
C(CO)(C(CO)C(CO)O)=O,,,4,1,11,14,25
3137_1,,,,2,2,1,3
3139_0,,,,2,2,1,3
C(C(CC(C(CCO)O)O)=O)(O)=O,,,4,1,3,13,16
3141_0,,,,2,2,1,3
C(C(C=O)C(C(CCO)O)O)(O)=O,,,4,1,6,14,20
3141_1,,,,2,2,1,3
3143_0,,,,2,2,1,3
C(CO)(C(C(C(CCO)O)O)O)=O,,,4,1,6,12,18
3143_1,,,,2,2,1,3
3145_0,,,,2,2,1,3
C(C(CC(C(CCO)O)O)=O)=O,,,4,1,2,16,18
3147_0,,,,2,2,1,3
C(C(C=O)C(C(CCO)O)O)=O,,,4,1,4,12,16
3147_1,,,,2,2,1,3
3149_0,,,,2,2,1,3
C(CC(C(CCO)O)O)=O,,,4,1,10,18,28
3151_0,,,,2,2,1,3
C(C(C(C(C(CCO)O)O)O)=O)=O,,,4,1,6,16,22
3151_1,,,,2,2,1,3
3153_0,,,,2,2,1,3
C(C(C(C(CCO)O)O)O)=O,,,4,1,10,18,28
3153_1,,,,2,2,1,3
3155_0,,,,2,2,1,3
C(C(CC(C)(C(CO)O)O)=O)(O)=O,,,4,1,3,14,17
3157_0,,,,2,2,1,3
C(C(C=O)C(C)(C(CO)O)O)(O)=O,,,4,1,6,14,20
3157_1,,,,2,2,1,3
3159_0,,,,2,2,1,3
C(CO)(C(C(C)(C(CO)O)O)O)=O,,,4,1,4,11,15
3159_1,,,,2,2,1,3
3161_0,,,,2,2,1,3
C(C(CC(C)(C(CO)O)O)=O)=O,,,4,1,2,17,19
3163_0,,,,2,2,1,3
C(C(C=O)C(C)(C(CO)O)O)=O,,,4,1,4,12,16
3163_1,,,,2,2,1,3
3165_0,,,,2,2,1,3
C(CC(C)(C(CO)O)O)=O,,,4,1,9,18,27
3167_0,,,,2,2,1,3
C(C(C(C(C)(C(CO)O)O)O)=O)=O,,,4,1,3,16,19
3167_1,,,,2,2,1,3
3169_0,,,,2,2,1,3
C(C(C(C)(C(CO)O)O)O)=O,,,4,1,8,16,24
3169_1,,,,2,2,1,3
3171_0,,,,2,2,1,3
C(C(C)(CC(C(CO)O)=O)O)(O)=O,,,4,1,8,12,20
3173_0,,,,2,2,1,3
C(CC(CC(C(CO)O)=O)O)(O)=O,,,4,1,5,10,15
3175_0,,,,2,2,1,3
C(C(C=C)(CC(C(CO)O)=O)O)=O,,,4,1,4,12,16
3177_0,,,,2,2,1,3
C(CC(C(C=C)=O)O)(C(CO)O)=O,,,4,1,4,15,19
3179_0,,,,2,2,1,3
C(CC(C=CC=O)O)(C(CO)O)=O,,,4,1,4,14,18
3180_0,,,,2,2,1,3
3182_0,,,,2,2,1,3
C(C(CO)O)(CC(C(O)O)O)=O,,,4,1,4,11,15
3184_0,,,,2,2,1,3
C(C(CO)O)(CC(C(C)O)O)=O,,,4,1,4,12,16
3186_0,,,,2,2,1,3
C(C(CO)O)(CC(C(CO)O)O)=O,,,4,1,8,13,21
3187_0,,,,2,2,1,3
3189_0,,,,2,2,1,3
C(C(CO)O)(CC(CO)(CO)O)=O,,,4,1,5,9,14
3190_0,,,,2,2,1,3
3192_0,,,,2,2,1,3
C(C(C)(CC(C(CO)O)=O)O)=O,,,4,1,5,15,20
3194_0,,,,2,2,1,3
C(CC(C(C)=O)O)(C(CO)O)=O,,,4,1,6,15,21
3195_0,,,,2,2,1,3
3197_0,,,,2,2,1,3
C(C(CO)O)(CC(C)O)=O,,,4,1,6,22,28
3199_0,,,,2,2,1,3
C(C(CO)(CC(C(CO)O)=O)O)=O,,,4,1,8,16,24
3201_0,,,,2,2,1,3
C(CC(C(CO)=O)O)(C(CO)O)=O,,,4,1,7,16,23
3202_0,,,,2,2,1,3
3204_0,,,,2,2,1,3
C(C(CO)O)(CC(CO)O)=O,,,4,1,9,15,24
3206_0,,,,2,2,1,3
C(C(C)(CC(C(O)=O)=O)O)(O)=O,,,4,1,3,11,14
3208_0,,,,2,2,1,3
C(C(C=O)C(C(O)=O)(C)O)(O)=O,,,4,1,7,12,19
3208_1,,,,2,2,1,3
3210_0,,,,2,2,1,3
C(C(C)(C(C(C(O)=O)=O)O)O)(O)=O,,,4,1,4,13,17
3210_1,,,,2,2,1,3
3212_0,,,,2,2,1,3
C(C(C(C=O)=O)C(C(O)=O)(C)O)=O,,,4,1,4,12,16
3212_1,,,,2,2,1,3
3214_0,,,,2,2,1,3
C(C(C)(C1C(C(CO1)O)=O)O)(O)=O,,,4,1,3,7,10
3214_1,,,,2,2,1,3
3216_0,,,,2,2,1,3
C(C(C)(C1C(C(O)OC1)=O)O)(O)=O,,,4,1,4,9,13
3216_1,,,,2,2,1,3
3218_0,,,,2,2,1,3
C(C(C)(C1C(COC1O)=O)O)(O)=O,,,4,1,4,11,15
3218_1,,,,2,2,1,3
3220_0,,,,2,2,1,3
C(C(C)(C1C(CC(O1)O)=O)O)(O)=O,,,4,1,4,9,13
3220_1,,,,2,2,1,3
3222_0,,,,2,2,1,3
C(C(C)(CC(C(C=O)=O)=O)O)(O)=O,,,4,1,2,10,12
3223_0,,,,2,2,1,3
3223_1,,,,2,2,1,3
3225_0,,,,2,2,1,3
C(C(C)(CC(C=O)=O)O)(O)=O,,,4,1,7,15,22
3227_0,,,,2,2,1,3
C(C(C=O)C(C(O)=O)(C)O)=O,,,4,1,6,10,16
3227_1,,,,2,2,1,3
3229_0,,,,2,2,1,3
C(C(C)(C(C(C=O)=O)CO)O)(O)=O,,,4,1,8,15,23
3229_1,,,,2,2,1,3
3231_0,,,,2,2,1,3
C(C(C)(C(C=O)C(C=O)O)O)(O)=O,,,4,1,8,16,24
3231_1,,,,2,2,1,3
3233_0,,,,2,2,1,3
C(C(C)(C(C=O)C(CO)=O)O)(O)=O,,,4,1,6,11,17
3233_1,,,,2,2,1,3
3235_0,,,,2,2,1,3
C(C(C)(C(C(CC=O)=O)O)O)(O)=O,,,4,1,5,12,17
3235_1,,,,2,2,1,3
3237_0,,,,2,2,1,3
C(C(C)(CC(C(C=O)O)=O)O)(O)=O,,,4,1,3,11,14
3239_0,,,,2,2,1,3
C(C(C)(CC=O)O)(O)=O,,,4,1,15,25,40
3241_0,,,,2,2,1,3
C(C(C)(C(C(C=O)=O)O)O)(O)=O,,,4,1,5,16,21
3241_1,,,,2,2,1,3
3242_0,,,,2,2,1,3
3242_1,,,,2,2,1,3
3244_0,,,,2,2,1,3
C(CC(CC(C(O)=O)=O)O)(O)=O,,,4,1,4,10,14
3246_0,,,,2,2,1,3
C(C(CO)(CC(C(O)=O)=O)O)(O)=O,,,4,1,4,13,17
3248_0,,,,2,2,1,3
C(CC(C=O)(CC(C(O)=O)=O)O)=O,,,4,1,4,12,16
3250_0,,,,2,2,1,3
C(CC(C(CC(C(O)=O)=O)O)=O)=O,,,4,1,2,14,16
3252_0,,,,2,2,1,3
C(C(CC(CC(C=O)=O)O)=O)(O)=O,,,4,1,5,14,19
3254_0,,,,2,2,1,3
C(C(CC1(COCC1O)O)=O)(O)=O,,,4,1,2,9,11
3256_0,,,,2,2,1,3
C(C(CC1(C(O)OCC1)O)=O)(O)=O,,,4,1,3,11,14
3258_0,,,,2,2,1,3
C(C(CC1(COC(C1)O)O)=O)(O)=O,,,4,1,3,11,14
3260_0,,,,2,2,1,3
C(C(C(C)=O)(CC(C(O)=O)=O)O)=O,,,4,1,2,10,12
3262_0,,,,2,2,1,3
C(C(CC(C(C(C)=O)=O)O)=O)(O)=O,,,4,1,2,11,13
3264_0,,,,2,2,1,3
C(C=O)(C(C)(CC(C(O)=O)=O)O)=O,,,4,1,3,12,15
3266_0,,,,2,2,1,3
C(C(C=C)(CC(C(O)=O)=O)O)=O,,,4,1,4,12,16
3268_0,,,,2,2,1,3
C=CC(C(CC(C(O)=O)=O)O)=O,,,4,1,4,12,16
3270_0,,,,2,2,1,3
C(C(CC(C(O)=O)=O)O)=CC=O,,,4,1,4,13,17
3272_0,,,,2,2,1,3
C(CC(C(O)=O)=O)(O)=O,,,4,1,11,23,34
3274_0,,,,2,2,1,3
C(C(CC(C(O)O)O)=O)(O)=O,,,4,1,4,13,17
3276_0,,,,2,2,1,3
C(C(CC(C(C)O)O)=O)(O)=O,,,4,1,5,14,19
3277_0,,,,2,2,1,3
3279_0,,,,2,2,1,3
C(C(CC(C(O)=O)=O)O)=O,,,4,1,13,24,37
3281_0,,,,2,2,1,3
C(C(CC(CO)(CO)O)=O)(O)=O,,,4,1,5,10,15
3283_0,,,,2,2,1,3
C(C(CC(C(O)=O)=O)O)(O)=O,,,4,1,12,14,26
3285_0,,,,2,2,1,3
C(C(C)(CC(C(O)=O)=O)O)=O,,,4,1,6,13,19
3287_0,,,,2,2,1,3
C(C)(C(CC(C(O)=O)=O)O)=O,,,4,1,10,15,25
3289_0,,,,2,2,1,3
C(CC(CC(C(O)=O)=O)O)=O,,,4,1,10,17,27
3291_0,,,,2,2,1,3
C(C(CCO)(CC(C(O)=O)=O)O)=O,,,4,1,6,13,19
3293_0,,,,2,2,1,3
C(C(CC(C(O)=O)=O)O)(CCO)=O,,,4,1,6,13,19
3295_0,,,,2,2,1,3
C(CC(C(CC(C(O)=O)=O)O)O)=O,,,4,1,5,18,23
3297_0,,,,2,2,1,3
C(C(CC(CC(C(O)=O)=O)O)O)=O,,,4,1,6,17,23
3298_0,,,,2,2,1,3
3300_0,,,,2,2,1,3
C(CC(CO)(CC(C(O)=O)=O)O)=O,,,4,1,7,14,21
3301_0,,,,2,2,1,3
3303_0,,,,2,2,1,3
C(C(C(C)(CC(C(O)=O)=O)O)O)=O,,,4,1,7,16,23
3305_0,,,,2,2,1,3
C(C(CC(C)O)=O)(O)=O,,,4,1,8,26,34
3307_0,,,,2,2,1,3
C(C(CO)(CC(C(O)=O)=O)O)=O,,,4,1,5,15,20
3309_0,,,,2,2,1,3
C(CO)(C(CC(C(O)=O)=O)O)=O,,,4,1,6,14,20
3310_0,,,,2,2,1,3
3311_0,,,,2,2,1,3
3313_0,,,,2,2,1,3
C(C(C=O)C(CC(O)=O)O)(O)=O,,,4,1,7,11,18
3313_1,,,,2,2,1,3
3315_0,,,,2,2,1,3
C(CC(C(C(C(O)=O)=O)O)O)(O)=O,,,4,1,5,13,18
3315_1,,,,2,2,1,3
3317_0,,,,2,2,1,3
C(C(C(C=O)=O)C(CC(O)=O)O)=O,,,4,1,4,12,16
3317_1,,,,2,2,1,3
3319_0,,,,2,2,1,3
C(CC(C1C(C(CO1)O)=O)O)(O)=O,,,4,1,3,6,9
3319_1,,,,2,2,1,3
3321_0,,,,2,2,1,3
C(CC(C1C(C(O)OC1)=O)O)(O)=O,,,4,1,4,8,12
3321_1,,,,2,2,1,3
3323_0,,,,2,2,1,3
C(CC(C1C(COC1O)=O)O)(O)=O,,,4,1,4,10,14
3323_1,,,,2,2,1,3
3325_0,,,,2,2,1,3
C(CC(C1C(CC(O1)O)=O)O)(O)=O,,,4,1,4,7,11
3325_1,,,,2,2,1,3
3327_0,,,,2,2,1,3
C(CC(CC(C(C=O)=O)=O)O)(O)=O,,,4,1,2,10,12
3329_0,,,,2,2,1,3
C(CC(C(C(CO)=O)O)O)(O)=O,,,4,1,7,10,17
3329_1,,,,2,2,1,3
3331_0,,,,2,2,1,3
C(CC(CC(C=O)=O)O)(O)=O,,,4,1,7,16,23
3333_0,,,,2,2,1,3
C(C(C=O)C(CC(O)=O)O)=O,,,4,1,6,10,16
3333_1,,,,2,2,1,3
3335_0,,,,2,2,1,3
C(CC(C(C(C=O)=O)CO)O)(O)=O,,,4,1,7,15,22
3335_1,,,,2,2,1,3
3337_0,,,,2,2,1,3
C(CC(C(C=O)C(C=O)O)O)(O)=O,,,4,1,7,16,23
3337_1,,,,2,2,1,3
3339_0,,,,2,2,1,3
C(CC(C(C=O)C(CO)=O)O)(O)=O,,,4,1,6,10,16
3339_1,,,,2,2,1,3
3341_0,,,,2,2,1,3
C(CC(C(C(CC=O)=O)O)O)(O)=O,,,4,1,4,12,16
3341_1,,,,2,2,1,3
3343_0,,,,2,2,1,3
C(C(C(CC(CC(O)=O)O)=O)O)=O,,,4,1,3,10,13
3345_0,,,,2,2,1,3
C(CC(CC=O)O)(O)=O,,,4,1,15,31,46
3347_0,,,,2,2,1,3
C(CC(C(C(C=O)=O)O)O)(O)=O,,,4,1,5,17,22
3347_1,,,,2,2,1,3
3349_0,,,,2,2,1,3
C(CC(C(C=O)O)O)(O)=O,,,4,1,12,23,35
3349_1,,,,2,2,1,3
3351_0,,,,2,2,1,3
C(C(C=O)C(C(O)=O)(CO)O)(O)=O,,,4,1,7,13,20
3351_1,,,,2,2,1,3
3353_0,,,,2,2,1,3
C(C(C=O)C(C=O)(CC=O)O)(O)=O,,,4,1,6,12,18
3353_1,,,,2,2,1,3
3355_0,,,,2,2,1,3
C(C(C=O)C(C(CC=O)=O)O)(O)=O,,,4,1,5,14,19
3355_1,,,,2,2,1,3
3356_0,,,,2,2,1,3
3356_1,,,,2,2,1,3
3358_0,,,,2,2,1,3
C(C(C=O)C1(COCC1O)O)(O)=O,,,4,1,5,9,14
3358_1,,,,2,2,1,3
3360_0,,,,2,2,1,3
C(C(C=O)C1(C(O)OCC1)O)(O)=O,,,4,1,6,11,17
3360_1,,,,2,2,1,3
3362_0,,,,2,2,1,3
C(C(C=O)C1(COC(C1)O)O)(O)=O,,,4,1,6,11,17
3362_1,,,,2,2,1,3
3364_0,,,,2,2,1,3
C(C(C=O)C(C=O)(C(C)=O)O)(O)=O,,,4,1,5,10,15
3364_1,,,,2,2,1,3
3366_0,,,,2,2,1,3
C(C(C=O)C(C(C(C)=O)=O)O)(O)=O,,,4,1,5,11,16
3366_1,,,,2,2,1,3
3368_0,,,,2,2,1,3
C(C(C=O)C(C(C=O)=O)(C)O)(O)=O,,,4,1,6,12,18
3368_1,,,,2,2,1,3
3370_0,,,,2,2,1,3
C(C(C=O)C(C=O)(C=C)O)(O)=O,,,4,1,8,13,21
3370_1,,,,2,2,1,3
3372_0,,,,2,2,1,3
C(C(C=O)C(C(C=C)=O)O)(O)=O,,,4,1,8,13,21
3372_1,,,,2,2,1,3
3374_0,,,,2,2,1,3
C(C(C=O)C(C=CC=O)O)(O)=O,,,4,1,8,13,21
3374_1,,,,2,2,1,3
3376_0,,,,2,2,1,3
C(C(C(O)=O)C(O)=O)=O,,,4,1,4,14,18
3376_1,,,,2,2,1,3
3378_0,,,,2,2,1,3
C(C(C=O)C(C(O)O)O)(O)=O,,,4,1,6,13,19
3378_1,,,,2,2,1,3
3380_0,,,,2,2,1,3
C(C(C=O)C(C(C)O)O)(O)=O,,,4,1,6,14,20
3380_1,,,,2,2,1,3
3381_0,,,,2,2,1,3
3381_1,,,,2,2,1,3
3383_0,,,,2,2,1,3
C(C(C=O)C(C=O)O)(O)=O,,,4,1,18,22,40
3383_1,,,,2,2,1,3
3384_0,,,,2,2,1,3
3384_1,,,,2,2,1,3
3385_0,,,,2,2,1,3
3385_1,,,,2,2,1,3
3386_0,,,,2,2,1,3
3386_1,,,,2,2,1,3
3387_0,,,,2,2,1,3
3387_1,,,,2,2,1,3
3388_0,,,,2,2,1,3
3388_1,,,,2,2,1,3
3389_0,,,,2,2,1,3
3389_1,,,,2,2,1,3
3390_0,,,,2,2,1,3
3390_1,,,,2,2,1,3
3391_0,,,,2,2,1,3
3391_1,,,,2,2,1,3
3392_0,,,,2,2,1,3
3392_1,,,,2,2,1,3
3393_0,,,,2,2,1,3
3393_1,,,,2,2,1,3
3394_0,,,,2,2,1,3
3394_1,,,,2,2,1,3
3395_0,,,,2,2,1,3
3395_1,,,,2,2,1,3
3396_0,,,,2,2,1,3
3396_1,,,,2,2,1,3
3397_0,,,,2,2,1,3
3397_1,,,,2,2,1,3
3398_0,,,,2,2,1,3
3398_1,,,,2,2,1,3
3399_0,,,,2,2,1,3
3399_1,,,,2,2,1,3
3400_0,,,,2,2,1,3
3400_1,,,,2,2,1,3
3401_0,,,,2,2,1,3
3401_1,,,,2,2,1,3
3403_0,,,,2,2,1,3
C(C(CCO)(CC(C=O)=O)O)(O)=O,,,4,1,4,13,17
3405_0,,,,2,2,1,3
C(C(C=O)C(C(O)=O)(CCO)O)=O,,,4,1,4,10,14
3405_1,,,,2,2,1,3
3407_0,,,,2,2,1,3
C(C(CCO)(CC=O)O)(O)=O,,,4,1,7,13,20
3408_0,,,,2,2,1,3
3408_1,,,,2,2,1,3
3410_0,,,,2,2,1,3
C(C(C(C(O)=O)=O)CO)(O)=O,,,4,1,9,12,21
3410_1,,,,2,2,1,3
3412_0,,,,2,2,1,3
C(C(C(CO)C(C(O)O)O)=O)(O)=O,,,4,1,6,15,21
3412_1,,,,2,2,1,3
3414_0,,,,2,2,1,3
C(C(C(CO)C(C(C)O)O)=O)(O)=O,,,4,1,6,16,22
3414_1,,,,2,2,1,3
3416_0,,,,2,2,1,3
C(C(C(C(C(O)=O)=O)CO)O)=O,,,4,1,10,19,29
3416_1,,,,2,2,1,3
3418_0,,,,2,2,1,3
C(C(C(C(C(O)=O)=O)CO)O)(O)=O,,,4,1,11,16,27
3418_1,,,,2,2,1,3
3420_0,,,,2,2,1,3
C(C(C)(C(C(C(O)=O)=O)CO)O)=O,,,4,1,7,15,22
3420_1,,,,2,2,1,3
3422_0,,,,2,2,1,3
C(C(C(C(C(O)=O)=O)CO)O)(C)=O,,,4,1,7,15,22
3422_1,,,,2,2,1,3
3424_0,,,,2,2,1,3
C(CC(C(C(C(O)=O)=O)CO)O)=O,,,4,1,8,16,24
3424_1,,,,2,2,1,3
3426_0,,,,2,2,1,3
C(C(C(CO)C(C)O)=O)(O)=O,,,4,1,8,14,22
3426_1,,,,2,2,1,3
3428_0,,,,2,2,1,3
C(C(C(CO)CO)=O)(O)=O,,,4,1,6,12,18
3428_1,,,,2,2,1,3
3430_0,,,,2,2,1,3
C(C(C(CO)C(CO)O)=O)(O)=O,,,4,1,10,16,26
3430_1,,,,2,2,1,3
3432_0,,,,2,2,1,3
C(CC(C(CC(C=O)=O)O)O)(O)=O,,,4,1,2,14,16
3434_0,,,,2,2,1,3
C(C(C=O)C(C(CC(O)=O)O)O)=O,,,4,1,3,11,14
3434_1,,,,2,2,1,3
3436_0,,,,2,2,1,3
C(CC(C(CC=O)O)O)(O)=O,,,4,1,5,15,20
3438_0,,,,2,2,1,3
C(CC(C(C(C=O)O)O)O)(O)=O,,,4,1,7,18,25
3438_1,,,,2,2,1,3
3440_0,,,,2,2,1,3
C(CC(CO)(CC(C=O)=O)O)(O)=O,,,4,1,3,13,16
3442_0,,,,2,2,1,3
C(C(C=O)C(CO)(CC(O)=O)O)=O,,,4,1,4,9,13
3442_1,,,,2,2,1,3
3444_0,,,,2,2,1,3
C(CC(CO)(CC=O)O)(O)=O,,,4,1,7,13,20
3446_0,,,,2,2,1,3
C(CC(CO)(C(C=O)O)O)(O)=O,,,4,1,4,14,18
3446_1,,,,2,2,1,3
3448_0,,,,2,2,1,3
C(C(C(O)=O)C(CO)=O)(O)=O,,,4,1,8,8,16
3448_1,,,,2,2,1,3
3450_0,,,,2,2,1,3
C(C(C(CO)=O)C(C(O)O)O)(O)=O,,,4,1,7,11,18
3450_1,,,,2,2,1,3
3452_0,,,,2,2,1,3
C(C(C(CO)=O)C(C(C)O)O)(O)=O,,,4,1,7,12,19
3452_1,,,,2,2,1,3
3454_0,,,,2,2,1,3
C(C(C(CO)=O)C(C=O)O)(O)=O,,,4,1,9,17,26
3454_1,,,,2,2,1,3
3456_0,,,,2,2,1,3
C(C(C(CO)=O)C(C(O)=O)O)(O)=O,,,4,1,9,12,21
3456_1,,,,2,2,1,3
3458_0,,,,2,2,1,3
C(C(C)(C(C(O)=O)C(CO)=O)O)=O,,,4,1,7,13,20
3458_1,,,,2,2,1,3
3460_0,,,,2,2,1,3
C(C(C(CO)=O)C(C(C)=O)O)(O)=O,,,4,1,7,13,20
3460_1,,,,2,2,1,3
3461_0,,,,2,2,1,3
3461_1,,,,2,2,1,3
3463_0,,,,2,2,1,3
C(C(C(CO)=O)C(C)O)(O)=O,,,4,1,10,12,22
3463_1,,,,2,2,1,3
3464_0,,,,2,2,1,3
3464_1,,,,2,2,1,3
3466_0,,,,2,2,1,3
C(C(C(CO)=O)C(CO)O)(O)=O,,,4,1,9,12,21
3466_1,,,,2,2,1,3
3468_0,,,,2,2,1,3
C(CC(C(C(O)=O)O)=O)(O)=O,,,4,1,14,13,27
3468_1,,,,2,2,1,3
3470_0,,,,2,2,1,3
C(CC(C(C(C(O)O)O)O)=O)(O)=O,,,4,1,4,13,17
3470_1,,,,2,2,1,3
3472_0,,,,2,2,1,3
C(CC(C(C(C(C)O)O)O)=O)(O)=O,,,4,1,4,14,18
3472_1,,,,2,2,1,3
3473_0,,,,2,2,1,3
3473_1,,,,2,2,1,3
3475_0,,,,2,2,1,3
C(CC(C(C(C(O)=O)O)O)=O)(O)=O,,,4,1,7,14,21
3475_1,,,,2,2,1,3
3477_0,,,,2,2,1,3
C(C(C)(C(C(CC(O)=O)=O)O)O)=O,,,4,1,5,15,20
3477_1,,,,2,2,1,3
3478_0,,,,2,2,1,3
3478_1,,,,2,2,1,3
3479_0,,,,2,2,1,3
3479_1,,,,2,2,1,3
3481_0,,,,2,2,1,3
C(CC(C(C(C)O)O)=O)(O)=O,,,4,1,8,15,23
3481_1,,,,2,2,1,3
3482_0,,,,2,2,1,3
3482_1,,,,2,2,1,3
3483_0,,,,2,2,1,3
3483_1,,,,2,2,1,3
3485_0,,,,2,2,1,3
C(C(C(C)(CC(C=O)=O)O)O)(O)=O,,,4,1,6,16,22
3487_0,,,,2,2,1,3
C(C(C=O)C(C)(C(C(O)=O)O)O)=O,,,4,1,7,11,18
3487_1,,,,2,2,1,3
3489_0,,,,2,2,1,3
C(CC(C)(C(C(O)=O)O)O)=O,,,4,1,9,16,25
3490_0,,,,2,2,1,3
3490_1,,,,2,2,1,3
3491_0,,,,2,2,1,3
3493_0,,,,2,2,1,3
C(C(C(CC(C(O)O)O)=O)O)(O)=O,,,4,1,7,11,18
3495_0,,,,2,2,1,3
C(C(C(CC(C(C)O)O)=O)O)(O)=O,,,4,1,7,12,19
3497_0,,,,2,2,1,3
C(C(C(CC(C=O)O)=O)O)(O)=O,,,4,1,9,17,26
3499_0,,,,2,2,1,3
C(C(C(CC(C(O)=O)O)=O)O)(O)=O,,,4,1,10,12,22
3501_0,,,,2,2,1,3
C(C(C)(CC(C(C(O)=O)O)=O)O)=O,,,4,1,7,13,20
3503_0,,,,2,2,1,3
C(C(C(CC(C(C)=O)O)=O)O)(O)=O,,,4,1,7,13,20
3504_0,,,,2,2,1,3
3506_0,,,,2,2,1,3
C(C(C(CC(C)O)=O)O)(O)=O,,,4,1,10,13,23
3507_0,,,,2,2,1,3
3508_0,,,,2,2,1,3
3509_0,,,,2,2,1,3
3509_1,,,,2,2,1,3
3511_0,,,,2,2,1,3
C(C(CO)(CC(C=O)=O)O)(O)=O,,,4,1,6,16,22
3513_0,,,,2,2,1,3
C(C(C=O)C(C(O)=O)(CO)O)=O,,,4,1,6,11,17
3513_1,,,,2,2,1,3
3515_0,,,,2,2,1,3
C(C(CO)(CC=O)O)(O)=O,,,4,1,13,17,30
3517_0,,,,2,2,1,3
C(C(CO)(C(C(C=O)=O)O)O)(O)=O,,,4,1,9,18,27
3517_1,,,,2,2,1,3
3518_0,,,,2,2,1,3
3518_1,,,,2,2,1,3
3520_0,,,,2,2,1,3
C(C(C=C)(C(C(C(O)=O)=O)O)O)=O,,,4,1,3,12,15
3520_1,,,,2,2,1,3
3522_0,,,,2,2,1,3
C=CC(C(C(C(C(O)=O)=O)O)O)=O,,,4,1,3,14,17
3522_1,,,,2,2,1,3
3524_0,,,,2,2,1,3
C(C(C(C(C(O)=O)=O)O)O)=CC=O,,,4,1,3,12,15
3524_1,,,,2,2,1,3
3526_0,,,,2,2,1,3
C(C(C(C(O)=O)=O)O)(O)=O,,,4,1,11,15,26
3526_1,,,,2,2,1,3
3528_0,,,,2,2,1,3
C(C(C(C(C(O)O)O)O)=O)(O)=O,,,4,1,3,13,16
3528_1,,,,2,2,1,3
3530_0,,,,2,2,1,3
C(C(C(C(C(C)O)O)O)=O)(O)=O,,,4,1,5,14,19
3530_1,,,,2,2,1,3
3531_0,,,,2,2,1,3
3531_1,,,,2,2,1,3
3533_0,,,,2,2,1,3
C(C(C(C(C(O)=O)=O)O)O)=O,,,4,1,14,22,36
3533_1,,,,2,2,1,3
3535_0,,,,2,2,1,3
C(C(C(C(CO)(CO)O)O)=O)(O)=O,,,4,1,6,11,17
3535_1,,,,2,2,1,3
3537_0,,,,2,2,1,3
C(C(C(C(C(O)=O)=O)O)O)(O)=O,,,4,1,9,14,23
3537_1,,,,2,2,1,3
3539_0,,,,2,2,1,3
C(C(C)(C(C(C(O)=O)=O)O)O)=O,,,4,1,4,14,18
3539_1,,,,2,2,1,3
3541_0,,,,2,2,1,3
C(C)(C(C(C(C(O)=O)=O)O)O)=O,,,4,1,6,15,21
3541_1,,,,2,2,1,3
3543_0,,,,2,2,1,3
C(CC(C(C(C(O)=O)=O)O)O)=O,,,4,1,8,16,24
3543_1,,,,2,2,1,3
3545_0,,,,2,2,1,3
C(C(C(C(C)O)O)=O)(O)=O,,,4,1,10,17,27
3545_1,,,,2,2,1,3
3547_0,,,,2,2,1,3
C(C(CO)(C(C(C(O)=O)=O)O)O)=O,,,4,1,7,19,26
3547_1,,,,2,2,1,3
3549_0,,,,2,2,1,3
C(CO)(C(C(C(C(O)=O)=O)O)O)=O,,,4,1,6,18,24
3549_1,,,,2,2,1,3
3550_0,,,,2,2,1,3
3550_1,,,,2,2,1,3
3551_0,,,,2,2,1,3
3551_1,,,,2,2,1,3
3553_0,,,,2,2,1,3
C(C(C(CO)O)(CC=O)O)(O)=O,,,4,1,8,14,22
3554_0,,,,2,2,1,3
3554_1,,,,2,2,1,3
3556_0,,,,2,2,1,3
C(C(CO)O)(C(CO)(C(C)O)O)=O,,,4,1,8,14,22
3556_1,,,,2,2,1,3
3558_0,,,,2,2,1,3
C(CC(CO)(C(CO)(CO)O)O)=O,,,4,1,5,8,13
3560_0,,,,2,2,1,3
C(C(C(C(CO)(CO)O)=O)O)(O)=O,,,4,1,9,10,19
3560_1,,,,2,2,1,3
3562_0,,,,2,2,1,3
C(C(C(C)O)O)(C(CO)(CO)O)=O,,,4,1,6,10,16
3562_1,,,,2,2,1,3
3564_0,,,,2,2,1,3
C(C(CO)O)(C(CO)(CO)O)=O,,,4,1,10,9,19
3564_1,,,,2,2,1,3
3565_0,,,,2,2,1,3
3567_0,,,,2,2,1,3
C(C(CO)C(C(C=O)(CO)O)O)=O,,,4,1,10,19,29
3567_1,,,,2,2,1,3
3569_0,,,,2,2,1,3
C(CC(C(C(C)=O)(C(C)O)O)O)=O,,,4,1,5,15,20
3571_0,,,,2,2,1,3
C(C(C(C)O)(C(C)(CC=O)O)O)=O,,,4,1,5,15,20
3573_0,,,,2,2,1,3
C(C(C(CC(O)=O)=O)(C(C)O)O)=O,,,4,1,3,11,14
3575_0,,,,2,2,1,3
C(C(C(CC(C)O)=O)(C(C)O)O)=O,,,4,1,3,10,13
3577_0,,,,2,2,1,3
C(C(C(CCO)=O)(C(C)O)O)=O,,,4,1,4,11,15
3579_0,,,,2,2,1,3
C(CCO)(C(C=O)(C(C=O)O)O)=O,,,4,1,5,16,21
3581_0,,,,2,2,1,3
C(CC(C(C(C)=O)(CO)O)O)=O,,,4,1,8,17,25
3583_0,,,,2,2,1,3
C(C(C(C(C(C)=O)(CO)O)O)O)=O,,,4,1,10,20,30
3583_1,,,,2,2,1,3
3585_0,,,,2,2,1,3
C(C(CO)(C(C)(CC=O)O)O)=O,,,4,1,6,17,23
3586_0,,,,2,2,1,3
3586_1,,,,2,2,1,3
3588_0,,,,2,2,1,3
C(C(C(CC(O)=O)=O)(CO)O)=O,,,4,1,4,12,16
3590_0,,,,2,2,1,3
C(CC(C=O)O)(C(C=O)(CO)O)=O,,,4,1,4,14,18
3592_0,,,,2,2,1,3
C(C(C(CC(C)O)=O)(CO)O)=O,,,4,1,4,11,15
3593_0,,,,2,2,1,3
3595_0,,,,2,2,1,3
C(C(C(CC(CO)O)=O)(CO)O)=O,,,4,1,7,12,19
3597_0,,,,2,2,1,3
C(C(C(CCO)=O)(C(CO)O)O)=O,,,4,1,7,12,19
3599_0,,,,2,2,1,3
C(CC(C(CO)(C(C)O)O)O)=O,,,4,1,4,12,16
3601_0,,,,2,2,1,3
C(C(C(C(CO)(C(C)O)O)O)O)=O,,,4,1,6,15,21
3601_1,,,,2,2,1,3
3602_0,,,,2,2,1,3
3604_0,,,,2,2,1,3
C(CC(C(C(CO)(CO)O)=O)O)=O,,,4,1,6,10,16
3606_0,,,,2,2,1,3
C(CC(C(C)(C(C(O)=O)O)O)O)=O,,,4,1,6,15,21
3607_0,,,,2,2,1,3
3609_0,,,,2,2,1,3
C(CC(C)(C(C(C(O)=O)O)O)O)=O,,,4,1,4,16,20
3610_0,,,,2,2,1,3
3612_0,,,,2,2,1,3
C(C(C(C(O)=O)O)O)(CC(C)O)=O,,,4,1,6,13,19
3613_0,,,,2,2,1,3
3615_0,,,,2,2,1,3
C(C(CO)C(C(C(O)=O)(C)O)O)=O,,,4,1,7,14,21
3615_1,,,,2,2,1,3
3617_0,,,,2,2,1,3
C(CC(CC(C(C(O)=O)O)O)O)=O,,,4,1,6,15,21
3619_0,,,,2,2,1,3
C(C(C=O)C(C(C(O)=O)O)O)(O)=O,,,4,1,7,15,22
3619_1,,,,2,2,1,3
3621_0,,,,2,2,1,3
C(C(C(C(C(O)=O)O)O)C(C)O)=O,,,4,1,7,16,23
3621_1,,,,2,2,1,3
3623_0,,,,2,2,1,3
C(C(CO)C(C(C(O)=O)O)O)=O,,,4,1,10,17,27
3623_1,,,,2,2,1,3
3625_0,,,,2,2,1,3
C(CC(C(CC=O)O)(C(C)O)O)=O,,,4,1,2,17,19
3627_0,,,,2,2,1,3
C(C(C(C)O)(CC(CC=O)O)O)=O,,,4,1,2,15,17
3628_0,,,,2,2,1,3
3628_1,,,,2,2,1,3
3629_0,,,,2,2,1,3
3629_1,,,,2,2,1,3
3630_0,,,,2,2,1,3
3630_1,,,,2,2,1,3
3631_0,,,,2,2,1,3
3631_1,,,,2,2,1,3
3632_0,,,,2,2,1,3
3633_0,,,,2,2,1,3
3634_0,,,,2,2,1,3
3634_1,,,,2,2,1,3
3636_0,,,,2,2,1,3
C(CC(CO)(CC(C=O)O)O)=O,,,4,1,6,20,26
3638_0,,,,2,2,1,3
C(C(CC(CO)(C(C=O)O)O)O)=O,,,4,1,6,20,26
3638_1,,,,2,2,1,3
3639_0,,,,2,2,1,3
3639_1,,,,2,2,1,3
3641_0,,,,2,2,1,3
C(C(C(C(CO)=O)C(C=O)O)O)=O,,,4,1,3,11,14
3641_1,,,,2,2,1,3
3643_0,,,,2,2,1,3
C(CO)(C(C(C)O)C(C=O)O)=O,,,4,1,5,18,23
3643_1,,,,2,2,1,3
3644_0,,,,2,2,1,3
3644_1,,,,2,2,1,3
3646_0,,,,2,2,1,3
C(CO)(C(C(CO)O)C(C=O)O)=O,,,4,1,6,18,24
3646_1,,,,2,2,1,3
3647_0,,,,2,2,1,3
3647_1,,,,2,2,1,3
3648_0,,,,2,2,1,3
3648_1,,,,2,2,1,3
3650_0,,,,2,2,1,3
C(CC(C=O)O)(C(C(C)O)O)=O,,,4,1,3,18,21
3650_1,,,,2,2,1,3
3651_0,,,,2,2,1,3
3651_1,,,,2,2,1,3
3653_0,,,,2,2,1,3
C(CC(C=O)O)(C(C(CO)O)O)=O,,,4,1,8,17,25
3653_1,,,,2,2,1,3
3655_0,,,,2,2,1,3
C(C(CO)C(C=O)O)(C(CO)O)=O,,,4,1,11,19,30
3655_1,,,,2,2,1,3
3656_0,,,,2,2,1,3
3656_1,,,,2,2,1,3
3658_0,,,,2,2,1,3
C(CC(C=O)(CC(C=O)=O)O)=O,,,4,1,6,18,24
3660_0,,,,2,2,1,3
C(C(C=O)C(C=O)(CC=O)O)=O,,,4,1,5,13,18
3660_1,,,,2,2,1,3
3662_0,,,,2,2,1,3
C(CC(C=O)(CC=O)O)=O,,,4,1,10,15,25
3664_0,,,,2,2,1,3
C(CC(C=O)(C(C(C=O)=O)O)O)=O,,,4,1,5,17,22
3664_1,,,,2,2,1,3
3665_0,,,,2,2,1,3
3665_1,,,,2,2,1,3
3666_0,,,,2,2,1,3
3666_1,,,,2,2,1,3
3668_0,,,,2,2,1,3
C(CC(C(CC(C=O)=O)O)=O)=O,,,4,1,5,21,26
3670_0,,,,2,2,1,3
C(C(C=O)C(C(CC=O)=O)O)=O,,,4,1,5,15,20
3670_1,,,,2,2,1,3
3672_0,,,,2,2,1,3
C(CC(C(CC=O)O)=O)=O,,,4,1,17,33,50
3674_0,,,,2,2,1,3
C(CC(C(C(C(C=O)=O)O)O)=O)=O,,,4,1,5,21,26
3674_1,,,,2,2,1,3
3675_0,,,,2,2,1,3
3675_1,,,,2,2,1,3
3676_0,,,,2,2,1,3
3676_1,,,,2,2,1,3
3678_0,,,,2,2,1,3
C(C(CC(CC(C=O)=O)O)=O)=O,,,4,1,4,11,15
3680_0,,,,2,2,1,3
C(C(C=O)C(CC(C=O)=O)O)=O,,,4,1,7,16,23
3680_1,,,,2,2,1,3
3681_0,,,,2,2,1,3
3682_0,,,,2,2,1,3
3682_1,,,,2,2,1,3
3683_0,,,,2,2,1,3
3683_1,,,,2,2,1,3
3685_0,,,,2,2,1,3
C(C(C(C=O)=O)C(C=O)(C=C)O)=O,,,4,1,3,8,11
3685_1,,,,2,2,1,3
3687_0,,,,2,2,1,3
C(C(C(C=O)=O)C(C(C=C)=O)O)=O,,,4,1,3,9,12
3687_1,,,,2,2,1,3
3689_0,,,,2,2,1,3
C(C(C(C=O)=O)C(C=CC=O)O)=O,,,4,1,3,9,12
3689_1,,,,2,2,1,3
3691_0,,,,2,2,1,3
C(C(C(O)=O)C(C=O)=O)=O,,,4,1,11,18,29
3691_1,,,,2,2,1,3
3693_0,,,,2,2,1,3
C(C(C(C=O)=O)C(C(O)O)O)=O,,,4,1,6,18,24
3693_1,,,,2,2,1,3
3695_0,,,,2,2,1,3
C(C(C(C=O)=O)C(C(C)O)O)=O,,,4,1,6,19,25
3695_1,,,,2,2,1,3
3697_0,,,,2,2,1,3
C(C(C(C=O)=O)C(C(CO)O)O)=O,,,4,1,6,17,23
3697_1,,,,2,2,1,3
3699_0,,,,2,2,1,3
C(C(C(C=O)=O)C(C=O)O)=O,,,4,1,11,20,31
3699_1,,,,2,2,1,3
3701_0,,,,2,2,1,3
C(C(C(C=O)=O)C(CO)(CO)O)=O,,,4,1,4,11,15
3701_1,,,,2,2,1,3
3703_0,,,,2,2,1,3
C(C(C(C=O)=O)C(C(O)=O)O)=O,,,4,1,8,18,26
3703_1,,,,2,2,1,3
3705_0,,,,2,2,1,3
C(C(C(C=O)=O)C(C=O)(C)O)=O,,,4,1,6,16,22
3705_1,,,,2,2,1,3
3707_0,,,,2,2,1,3
C(C(C(C=O)=O)C(C(C)=O)O)=O,,,4,1,7,18,25
3707_1,,,,2,2,1,3
3709_0,,,,2,2,1,3
C(C(C(C=O)=O)C(CC=O)O)=O,,,4,1,8,20,28
3709_1,,,,2,2,1,3
3711_0,,,,2,2,1,3
C(C(C(C=O)=O)C(C)O)=O,,,4,1,10,20,30
3711_1,,,,2,2,1,3
3713_0,,,,2,2,1,3
C(C(C(C=O)=O)C(C=O)(CO)O)=O,,,4,1,4,14,18
3713_1,,,,2,2,1,3
3715_0,,,,2,2,1,3
C(C(C(C=O)=O)C(C(CO)=O)O)=O,,,4,1,4,18,22
3715_1,,,,2,2,1,3
3716_0,,,,2,2,1,3
3716_1,,,,2,2,1,3
3717_0,,,,2,2,1,3
3717_1,,,,2,2,1,3
3718_0,,,,2,2,1,3
3718_1,,,,2,2,1,3
3719_0,,,,2,2,1,3
3719_1,,,,2,2,1,3
3721_0,,,,2,2,1,3
C(C(C(C(CO)CO)=O)(CO)O)=O,,,4,1,5,9,14
3721_1,,,,2,2,1,3
3722_0,,,,2,2,1,3
3723_0,,,,2,2,1,3
3723_1,,,,2,2,1,3
3725_0,,,,2,2,1,3
C(CC(C(C(C=O)CO)=O)O)=O,,,4,1,9,18,27
3726_0,,,,2,2,1,3
3726_1,,,,2,2,1,3
3727_0,,,,2,2,1,3
3728_0,,,,2,2,1,3
3728_1,,,,2,2,1,3
3730_0,,,,2,2,1,3
C(C(CC(CO)O)(CC=O)O)(O)=O,,,4,1,3,13,16
3732_0,,,,2,2,1,3
C(C(C(C(O)=O)=O)C(CO)O)(O)=O,,,4,1,7,15,22
3732_1,,,,2,2,1,3
3734_0,,,,2,2,1,3
C(C(C(C(CO)O)C(C)O)=O)(O)=O,,,4,1,5,16,21
3734_1,,,,2,2,1,3
3735_0,,,,2,2,1,3
3735_1,,,,2,2,1,3
3737_0,,,,2,2,1,3
C(CC(CO)(CC(C(O)=O)O)O)=O,,,4,1,9,14,23
3738_0,,,,2,2,1,3
3738_1,,,,2,2,1,3
3740_0,,,,2,2,1,3
C(CO)(C(C(C)O)C(C(O)=O)O)=O,,,4,1,7,13,20
3740_1,,,,2,2,1,3
3741_0,,,,2,2,1,3
3741_1,,,,2,2,1,3
3742_0,,,,2,2,1,3
3742_1,,,,2,2,1,3
3744_0,,,,2,2,1,3
C(CC(C(O)=O)O)(C(C(C)O)O)=O,,,4,1,6,13,19
3744_1,,,,2,2,1,3
3745_0,,,,2,2,1,3
3745_1,,,,2,2,1,3
3747_0,,,,2,2,1,3
C(CC(C(CO)O)(CC=O)O)(O)=O,,,4,1,2,12,14
3749_0,,,,2,2,1,3
C(C(C(O)=O)C(C(CO)O)=O)(O)=O,,,4,1,5,9,14
3749_1,,,,2,2,1,3
3751_0,,,,2,2,1,3
C(C(C(C(CO)O)=O)C(C)O)(O)=O,,,4,1,8,13,21
3751_1,,,,2,2,1,3
3753_0,,,,2,2,1,3
C(C(C(C(CO)O)=O)CO)(O)=O,,,4,1,12,13,25
3753_1,,,,2,2,1,3
3755_0,,,,2,2,1,3
C(CC(CCO)(C(C(O)=O)O)O)=O,,,4,1,4,13,17
3757_0,,,,2,2,1,3
C(C(C(C(C(O)=O)O)=O)CO)(O)=O,,,4,1,9,12,21
3757_1,,,,2,2,1,3
3759_0,,,,2,2,1,3
C(C(C(C(CO)C(C)O)=O)O)(O)=O,,,4,1,9,13,22
3759_1,,,,2,2,1,3
3761_0,,,,2,2,1,3
C(C(C(C(CO)CO)=O)O)(O)=O,,,4,1,10,9,19
3761_1,,,,2,2,1,3
3763_0,,,,2,2,1,3
C(CC(C=O)(CC(C=O)=O)O)(O)=O,,,4,1,2,11,13
3765_0,,,,2,2,1,3
C(C(C=O)C(C=O)(CC(O)=O)O)=O,,,4,1,3,8,11
3765_1,,,,2,2,1,3
3767_0,,,,2,2,1,3
C(CC(C=O)(CC=O)O)(O)=O,,,4,1,6,13,19
3769_0,,,,2,2,1,3
C(CC(C=O)(C(C=O)O)O)(O)=O,,,4,1,6,16,22
3769_1,,,,2,2,1,3
3770_0,,,,2,2,1,3
3771_0,,,,2,2,1,3
3771_1,,,,2,2,1,3
3772_0,,,,2,2,1,3
3773_0,,,,2,2,1,3
3773_1,,,,2,2,1,3
3775_0,,,,2,2,1,3
C(C(C(O)=O)C(C=O)=O)(O)=O,,,4,1,6,10,16
3775_1,,,,2,2,1,3
3777_0,,,,2,2,1,3
C(C(C(C=O)=O)C(C(O)O)O)(O)=O,,,4,1,6,14,20
3777_1,,,,2,2,1,3
3779_0,,,,2,2,1,3
C(C(C(C=O)=O)C(C(C)O)O)(O)=O,,,4,1,6,15,21
3779_1,,,,2,2,1,3
3780_0,,,,2,2,1,3
3780_1,,,,2,2,1,3
3781_0,,,,2,2,1,3
3781_1,,,,2,2,1,3
3782_0,,,,2,2,1,3
3782_1,,,,2,2,1,3
3783_0,,,,2,2,1,3
3783_1,,,,2,2,1,3
3784_0,,,,2,2,1,3
3784_1,,,,2,2,1,3
3785_0,,,,2,2,1,3
3785_1,,,,2,2,1,3
3787_0,,,,2,2,1,3
C(C(C(C=O)=O)CO)(O)=O,,,4,1,16,18,34
3787_1,,,,2,2,1,3
3788_0,,,,2,2,1,3
3788_1,,,,2,2,1,3
3789_0,,,,2,2,1,3
3791_0,,,,2,2,1,3
C(C(C=O)C(CC(C(O)=O)=O)O)=O,,,4,1,5,11,16
3791_1,,,,2,2,1,3
3792_0,,,,2,2,1,3
3793_0,,,,2,2,1,3
3793_1,,,,2,2,1,3
3795_0,,,,2,2,1,3
C(C(CC=O)(CC(C=O)=O)O)(O)=O,,,4,1,3,14,17
3797_0,,,,2,2,1,3
C(C(C=O)C(C(O)=O)(CC=O)O)=O,,,4,1,4,10,14
3797_1,,,,2,2,1,3
3799_0,,,,2,2,1,3
C(C(CC=O)(CC=O)O)(O)=O,,,4,1,6,9,15
3801_0,,,,2,2,1,3
C(C(CC=O)(C(C=O)O)O)(O)=O,,,4,1,7,18,25
3801_1,,,,2,2,1,3
3803_0,,,,2,2,1,3
C(C(C(O)=O)C(C(O)=O)=O)=O,,,4,1,7,12,19
3803_1,,,,2,2,1,3
3805_0,,,,2,2,1,3
C(C(C(C(O)=O)=O)C(C(O)O)O)=O,,,4,1,4,14,18
3805_1,,,,2,2,1,3
3807_0,,,,2,2,1,3
C(C(C(C(O)=O)=O)C(C(C)O)O)=O,,,4,1,4,15,19
3807_1,,,,2,2,1,3
3809_0,,,,2,2,1,3
C(C(C(C(O)=O)=O)C(C=O)O)=O,,,4,1,7,18,25
3809_1,,,,2,2,1,3
3811_0,,,,2,2,1,3
C(C(C(C(O)=O)=O)C(C(O)=O)O)=O,,,4,1,6,14,20
3811_1,,,,2,2,1,3
3813_0,,,,2,2,1,3
C(C(C(C(O)=O)=O)C(C=O)(C)O)=O,,,4,1,4,12,16
3813_1,,,,2,2,1,3
3815_0,,,,2,2,1,3
C(C(C(C(O)=O)=O)C(C(C)=O)O)=O,,,4,1,4,13,17
3815_1,,,,2,2,1,3
3817_0,,,,2,2,1,3
C(C(C(C(O)=O)=O)C(CC=O)O)=O,,,4,1,5,13,18
3817_1,,,,2,2,1,3
3819_0,,,,2,2,1,3
C(C(C(C(O)=O)=O)C(C)O)=O,,,4,1,6,14,20
3819_1,,,,2,2,1,3
3821_0,,,,2,2,1,3
C(C(C(C(O)=O)=O)CO)=O,,,4,1,9,17,26
3821_1,,,,2,2,1,3
3823_0,,,,2,2,1,3
C(C(C(C(O)=O)=O)C(CO)O)=O,,,4,1,9,17,26
3823_1,,,,2,2,1,3
3825_0,,,,2,2,1,3
C(CO)(C(C1(COCC1O)O)O)=O,,,4,1,3,7,10
3825_1,,,,2,2,1,3
3827_0,,,,2,2,1,3
C(C(CC1(COCC1O)O)=O)=O,,,4,1,1,12,13
3829_0,,,,2,2,1,3
C(C(C=O)C1(COCC1O)O)=O,,,4,1,3,8,11
3829_1,,,,2,2,1,3
3831_0,,,,2,2,1,3
C(CC1(COCC1O)O)=O,,,4,1,8,14,22
3833_0,,,,2,2,1,3
C(C(C(C1(COCC1O)O)O)=O)=O,,,4,1,2,11,13
3833_1,,,,2,2,1,3
3835_0,,,,2,2,1,3
C(C(C1(COCC1O)O)O)=O,,,4,1,5,12,17
3835_1,,,,2,2,1,3
3837_0,,,,2,2,1,3
C(C(C=C)(C1C(C(CO1)O)=O)O)=O,,,4,1,2,7,9
3837_1,,,,2,2,1,3
3839_0,,,,2,2,1,3
C1(C(C(C(C=C)=O)O)OCC1O)=O,,,4,1,2,10,12
3839_1,,,,2,2,1,3
3841_0,,,,2,2,1,3
C1(C(C(C=CC=O)O)OCC1O)=O,,,4,1,2,10,12
3841_1,,,,2,2,1,3
3843_0,,,,2,2,1,3
C(C1C(C(CO1)O)=O)(O)=O,,,4,1,3,17,20
3843_1,,,,2,2,1,3
3845_0,,,,2,2,1,3
C1(C(C(C(O)O)O)OCC1O)=O,,,4,1,2,6,8
3845_1,,,,2,2,1,3
3847_0,,,,2,2,1,3
C1(C(C(C(C)O)O)OCC1O)=O,,,4,1,2,7,9
3847_1,,,,2,2,1,3
3849_0,,,,2,2,1,3
C1(C(C(C(CO)O)O)OCC1O)=O,,,4,1,5,9,14
3849_1,,,,2,2,1,3
3851_0,,,,2,2,1,3
C(C(C1C(C(CO1)O)=O)O)=O,,,4,1,5,17,22
3851_1,,,,2,2,1,3
3853_0,,,,2,2,1,3
C1(C(C(CO)(CO)O)OCC1O)=O,,,4,1,3,5,8
3853_1,,,,2,2,1,3
3855_0,,,,2,2,1,3
C(C(C1C(C(CO1)O)=O)O)(O)=O,,,4,1,4,7,11
3855_1,,,,2,2,1,3
3857_0,,,,2,2,1,3
C(C(C)(C1C(C(CO1)O)=O)O)=O,,,4,1,2,9,11
3857_1,,,,2,2,1,3
3859_0,,,,2,2,1,3
C(C(C1C(C(CO1)O)=O)O)(C)=O,,,4,1,3,9,12
3859_1,,,,2,2,1,3
3861_0,,,,2,2,1,3
C(CC(C1C(C(CO1)O)=O)O)=O,,,4,1,3,11,14
3861_1,,,,2,2,1,3
3863_0,,,,2,2,1,3
C1(C(C(C)O)OCC1O)=O,,,4,1,2,17,19
3863_1,,,,2,2,1,3
3865_0,,,,2,2,1,3
C(C(CO)(C1C(C(CO1)O)=O)O)=O,,,4,1,4,12,16
3865_1,,,,2,2,1,3
3867_0,,,,2,2,1,3
C(C(C1C(C(CO1)O)=O)O)(CO)=O,,,4,1,3,11,14
3867_1,,,,2,2,1,3
3869_0,,,,2,2,1,3
C1(C(CO)OCC1O)=O,,,4,1,4,34,38
3869_1,,,,2,2,1,3
3871_0,,,,2,2,1,3
C1(C(C(CO)O)OCC1O)=O,,,4,1,5,10,15
3871_1,,,,2,2,1,3
3873_0,,,,2,2,1,3
C(CO)(C(C1(C(O)OCC1)O)O)=O,,,4,1,4,9,13
3873_1,,,,2,2,1,3
3875_0,,,,2,2,1,3
C(C(CC1(C(O)OCC1)O)=O)=O,,,4,1,2,14,16
3877_0,,,,2,2,1,3
C(C(C=O)C1(C(O)OCC1)O)=O,,,4,1,4,10,14
3877_1,,,,2,2,1,3
3879_0,,,,2,2,1,3
C(CC1(C(O)OCC1)O)=O,,,4,1,9,16,25
3881_0,,,,2,2,1,3
C(C(C(C1(C(O)OCC1)O)O)=O)=O,,,4,1,3,13,16
3881_1,,,,2,2,1,3
3883_0,,,,2,2,1,3
C(C(C1(C(O)OCC1)O)O)=O,,,4,1,6,14,20
3883_1,,,,2,2,1,3
3885_0,,,,2,2,1,3
C(C(C=C)(C1C(C(O)OC1)=O)O)=O,,,4,1,3,8,11
3885_1,,,,2,2,1,3
3887_0,,,,2,2,1,3
C1(C(O)OCC1C(C(C=C)=O)O)=O,,,4,1,3,11,14
3887_1,,,,2,2,1,3
3889_0,,,,2,2,1,3
C1(C(O)OCC1C(C=CC=O)O)=O,,,4,1,3,9,12
3889_1,,,,2,2,1,3
3891_0,,,,2,2,1,3
C(C1C(C(O)OC1)=O)(O)=O,,,4,1,5,13,18
3891_1,,,,2,2,1,3
3893_0,,,,2,2,1,3
C1(C(O)OCC1C(C(O)O)O)=O,,,4,1,3,9,12
3893_1,,,,2,2,1,3
3895_0,,,,2,2,1,3
C1(C(O)OCC1C(C(C)O)O)=O,,,4,1,3,10,13
3895_1,,,,2,2,1,3
3897_0,,,,2,2,1,3
C1(C(O)OCC1C(C(CO)O)O)=O,,,4,1,6,11,17
3897_1,,,,2,2,1,3
3899_0,,,,2,2,1,3
C1(C(O)OCC1C(C=O)O)=O,,,4,1,5,16,21
3899_1,,,,2,2,1,3
3901_0,,,,2,2,1,3
C1(C(O)OCC1C(CO)(CO)O)=O,,,4,1,4,7,11
3901_1,,,,2,2,1,3
3903_0,,,,2,2,1,3
C1(C(O)OCC1C(C(O)=O)O)=O,,,4,1,5,10,15
3903_1,,,,2,2,1,3
3905_0,,,,2,2,1,3
C(C(C)(C1C(C(O)OC1)=O)O)=O,,,4,1,3,11,14
3905_1,,,,2,2,1,3
3907_0,,,,2,2,1,3
C(C(C1C(C(O)OC1)=O)O)(C)=O,,,4,1,4,11,15
3907_1,,,,2,2,1,3
3909_0,,,,2,2,1,3
C(CC(C1C(C(O)OC1)=O)O)=O,,,4,1,6,13,19
3909_1,,,,2,2,1,3
3911_0,,,,2,2,1,3
C1(C(O)OCC1C(C)O)=O,,,4,1,3,14,17
3911_1,,,,2,2,1,3
3913_0,,,,2,2,1,3
C(C(CO)(C1C(C(O)OC1)=O)O)=O,,,4,1,4,12,16
3913_1,,,,2,2,1,3
3915_0,,,,2,2,1,3
C(C(C1C(C(O)OC1)=O)O)(CO)=O,,,4,1,4,12,16
3915_1,,,,2,2,1,3
3917_0,,,,2,2,1,3
C1(C(O)OCC1CO)=O,,,4,1,5,25,30
3917_1,,,,2,2,1,3
3919_0,,,,2,2,1,3
C1(C(O)OCC1C(CO)O)=O,,,4,1,5,11,16
3919_1,,,,2,2,1,3
3921_0,,,,2,2,1,3
C(CO)(C(C1(COC(C1)O)O)O)=O,,,4,1,4,9,13
3921_1,,,,2,2,1,3
3923_0,,,,2,2,1,3
C(C(CC1(COC(C1)O)O)=O)=O,,,4,1,2,14,16
3925_0,,,,2,2,1,3
C(C(C=O)C1(COC(C1)O)O)=O,,,4,1,4,10,14
3925_1,,,,2,2,1,3
3927_0,,,,2,2,1,3
C(CC1(COC(C1)O)O)=O,,,4,1,10,16,26
3929_0,,,,2,2,1,3
C(C(C(C1(COC(C1)O)O)O)=O)=O,,,4,1,3,13,16
3929_1,,,,2,2,1,3
3931_0,,,,2,2,1,3
C(C(C1(COC(C1)O)O)O)=O,,,4,1,6,14,20
3931_1,,,,2,2,1,3
3933_0,,,,2,2,1,3
C(C(C=C)(C1C(COC1O)=O)O)=O,,,4,1,3,11,14
3933_1,,,,2,2,1,3
3935_0,,,,2,2,1,3
C1(COC(C1C(C(C=C)=O)O)O)=O,,,4,1,3,14,17
3935_1,,,,2,2,1,3
3937_0,,,,2,2,1,3
C1(COC(C1C(C=CC=O)O)O)=O,,,4,1,3,12,15
3937_1,,,,2,2,1,3
3939_0,,,,2,2,1,3
C(C1C(COC1O)=O)(O)=O,,,4,1,3,17,20
3939_1,,,,2,2,1,3
3941_0,,,,2,2,1,3
C1(COC(C1C(C(O)O)O)O)=O,,,4,1,3,11,14
3941_1,,,,2,2,1,3
3943_0,,,,2,2,1,3
C1(COC(C1C(C(C)O)O)O)=O,,,4,1,3,12,15
3943_1,,,,2,2,1,3
3945_0,,,,2,2,1,3
C1(COC(C1C(C(CO)O)O)O)=O,,,4,1,6,13,19
3945_1,,,,2,2,1,3
3947_0,,,,2,2,1,3
C1(COC(C1C(C=O)O)O)=O,,,4,1,6,20,26
3947_1,,,,2,2,1,3
3949_0,,,,2,2,1,3
C1(COC(C1C(CO)(CO)O)O)=O,,,4,1,4,9,13
3949_1,,,,2,2,1,3
3951_0,,,,2,2,1,3
C1(COC(C1C(C(O)=O)O)O)=O,,,4,1,6,12,18
3951_1,,,,2,2,1,3
3953_0,,,,2,2,1,3
C(C(C)(C1C(COC1O)=O)O)=O,,,4,1,4,14,18
3953_1,,,,2,2,1,3
3955_0,,,,2,2,1,3
C1(COC(C1C(C(C)=O)O)O)=O,,,4,1,5,14,19
3955_1,,,,2,2,1,3
3957_0,,,,2,2,1,3
C(CC(C1C(COC1O)=O)O)=O,,,4,1,5,16,21
3957_1,,,,2,2,1,3
3959_0,,,,2,2,1,3
C1(COC(C1C(C)O)O)=O,,,4,1,4,19,23
3959_1,,,,2,2,1,3
3961_0,,,,2,2,1,3
C(C(CO)(C1C(COC1O)=O)O)=O,,,4,1,4,15,19
3961_1,,,,2,2,1,3
3963_0,,,,2,2,1,3
C1(COC(C1C(C(CO)=O)O)O)=O,,,4,1,4,15,19
3963_1,,,,2,2,1,3
3965_0,,,,2,2,1,3
C1(COC(C1CO)O)=O,,,4,1,6,33,39
3965_1,,,,2,2,1,3
3967_0,,,,2,2,1,3
C1(COC(C1C(CO)O)O)=O,,,4,1,5,14,19
3967_1,,,,2,2,1,3
3969_0,,,,2,2,1,3
C(C(C=C)(C1C(CC(O1)O)=O)O)=O,,,4,1,3,9,12
3969_1,,,,2,2,1,3
3971_0,,,,2,2,1,3
C1(C(C(C(C=C)=O)O)OC(C1)O)=O,,,4,1,3,12,15
3971_1,,,,2,2,1,3
3973_0,,,,2,2,1,3
C1(C(C(C=CC=O)O)OC(C1)O)=O,,,4,1,3,12,15
3973_1,,,,2,2,1,3
3975_0,,,,2,2,1,3
C(C1C(CC(O1)O)=O)(O)=O,,,4,1,3,20,23
3975_1,,,,2,2,1,3
3977_0,,,,2,2,1,3
C1(C(C(C(O)O)O)OC(C1)O)=O,,,4,1,3,9,12
3977_1,,,,2,2,1,3
3979_0,,,,2,2,1,3
C1(C(C(C(C)O)O)OC(C1)O)=O,,,4,1,3,10,13
3979_1,,,,2,2,1,3
3981_0,,,,2,2,1,3
C1(C(C(C(CO)O)O)OC(C1)O)=O,,,4,1,6,11,17
3981_1,,,,2,2,1,3
3983_0,,,,2,2,1,3
C(C(C1C(CC(O1)O)=O)O)=O,,,4,1,7,20,27
3983_1,,,,2,2,1,3
3985_0,,,,2,2,1,3
C1(C(C(CO)(CO)O)OC(C1)O)=O,,,4,1,4,7,11
3985_1,,,,2,2,1,3
3987_0,,,,2,2,1,3
C(C(C1C(CC(O1)O)=O)O)(O)=O,,,4,1,6,10,16
3987_1,,,,2,2,1,3
3989_0,,,,2,2,1,3
C(C(C)(C1C(CC(O1)O)=O)O)=O,,,4,1,3,12,15
3989_1,,,,2,2,1,3
3991_0,,,,2,2,1,3
C(C(C1C(CC(O1)O)=O)O)(C)=O,,,4,1,4,12,16
3991_1,,,,2,2,1,3
3993_0,,,,2,2,1,3
C(CC(C1C(CC(O1)O)=O)O)=O,,,4,1,4,13,17
3993_1,,,,2,2,1,3
3995_0,,,,2,2,1,3
C1(C(C(C)O)OC(C1)O)=O,,,4,1,3,20,23
3995_1,,,,2,2,1,3
3997_0,,,,2,2,1,3
C(C(CO)(C1C(CC(O1)O)=O)O)=O,,,4,1,5,14,19
3997_1,,,,2,2,1,3
3999_0,,,,2,2,1,3
C(C(C1C(CC(O1)O)=O)O)(CO)=O,,,4,1,4,13,17
3999_1,,,,2,2,1,3
4001_0,,,,2,2,1,3
C1(C(CO)OC(C1)O)=O,,,4,1,6,37,43
4001_1,,,,2,2,1,3
4003_0,,,,2,2,1,3
C1(C(C(CO)O)OC(C1)O)=O,,,4,1,5,13,18
4003_1,,,,2,2,1,3
4004_0,,,,2,2,1,3
4004_1,,,,2,2,1,3
4006_0,,,,2,2,1,3
C(C(C(C)=O)(CC(C=O)=O)O)=O,,,4,1,3,14,17
4008_0,,,,2,2,1,3
C(C(C=O)C(C=O)(C(C)=O)O)=O,,,4,1,4,10,14
4008_1,,,,2,2,1,3
4010_0,,,,2,2,1,3
C(C(C(C)=O)(CC=O)O)=O,,,4,1,12,21,33
4012_0,,,,2,2,1,3
C(C(C(C)=O)(C(C(C=O)=O)O)O)=O,,,4,1,5,14,19
4012_1,,,,2,2,1,3
4013_0,,,,2,2,1,3
4013_1,,,,2,2,1,3
4014_0,,,,2,2,1,3
4014_1,,,,2,2,1,3
4016_0,,,,2,2,1,3
C(C(CC(C(C(C)=O)=O)O)=O)=O,,,4,1,6,15,21
4018_0,,,,2,2,1,3
C(C(C=O)C(C(C(C)=O)=O)O)=O,,,4,1,4,11,15
4018_1,,,,2,2,1,3
4020_0,,,,2,2,1,3
C(CC(C(C(C)=O)=O)O)=O,,,4,1,16,25,41
4022_0,,,,2,2,1,3
C(C(C(C(C(C(C)=O)=O)O)O)=O)=O,,,4,1,5,16,21
4022_1,,,,2,2,1,3
4023_0,,,,2,2,1,3
4023_1,,,,2,2,1,3
4025_0,,,,2,2,1,3
C(C(C(C(C=O)=O)(C)O)O)(CO)=O,,,4,1,9,18,27
4025_1,,,,2,2,1,3
4027_0,,,,2,2,1,3
C(C=O)(C(C)(CC(C=O)=O)O)=O,,,4,1,4,16,20
4029_0,,,,2,2,1,3
C(C(C=O)C(C(C=O)=O)(C)O)=O,,,4,1,5,13,18
4029_1,,,,2,2,1,3
4031_0,,,,2,2,1,3
C(CC(C(C=O)=O)(C)O)=O,,,4,1,11,21,32
4033_0,,,,2,2,1,3
C(C=O)(C(C)(C(C(C=O)=O)O)O)=O,,,4,1,5,15,20
4033_1,,,,2,2,1,3
4035_0,,,,2,2,1,3
C(C(C(C(C=O)=O)(C)O)O)=O,,,4,1,9,20,29
4035_1,,,,2,2,1,3
4037_0,,,,2,2,1,3
C(C(C=C)(CC(C(C=O)=O)=O)O)=O,,,4,1,1,6,7
4039_0,,,,2,2,1,3
C=CC(C(CC(C(C=O)=O)=O)O)=O,,,4,1,1,8,9
4041_0,,,,2,2,1,3
C(C(CC(C(C=O)=O)=O)O)=CC=O,,,4,1,1,8,9
4043_0,,,,2,2,1,3
C(CC(C(C=O)=O)=O)(O)=O,,,4,1,5,19,24
4045_0,,,,2,2,1,3
C(C(C(CC(C(O)O)O)=O)=O)=O,,,4,1,2,15,17
4047_0,,,,2,2,1,3
C(C(C(CC(C(C)O)O)=O)=O)=O,,,4,1,3,16,19
4049_0,,,,2,2,1,3
C(C(C(CC(C(CO)O)O)=O)=O)=O,,,4,1,6,14,20
4051_0,,,,2,2,1,3
C(C(CC(C(C=O)=O)=O)O)=O,,,4,1,6,19,25
4053_0,,,,2,2,1,3
C(C(C(CC(CO)(CO)O)=O)=O)=O,,,4,1,2,9,11
4055_0,,,,2,2,1,3
C(C(CC(C(C=O)=O)=O)O)(O)=O,,,4,1,5,16,21
4057_0,,,,2,2,1,3
C(C(C)(CC(C(C=O)=O)=O)O)=O,,,4,1,3,13,16
4059_0,,,,2,2,1,3
C(C)(C(CC(C(C=O)=O)=O)O)=O,,,4,1,4,16,20
4061_0,,,,2,2,1,3
C(CC(CC(C(C=O)=O)=O)O)=O,,,4,1,6,19,25
4063_0,,,,2,2,1,3
C(C(C(CC(C)O)=O)=O)=O,,,4,1,3,20,23
4065_0,,,,2,2,1,3
C(C(CO)(CC(C(C=O)=O)=O)O)=O,,,4,1,2,12,14
4067_0,,,,2,2,1,3
C(CO)(C(CC(C(C=O)=O)=O)O)=O,,,4,1,2,16,18
4069_0,,,,2,2,1,3
C(C(C(CCO)=O)=O)=O,,,4,1,11,33,44
4071_0,,,,2,2,1,3
C(C(C(CC(CO)O)=O)=O)=O,,,4,1,6,17,23
4073_0,,,,2,2,1,3
C(C(C=C)(C(C(CO)=O)O)O)=O,,,4,1,6,14,20
4073_1,,,,2,2,1,3
4075_0,,,,2,2,1,3
C(C(C=C)(CC(C=O)=O)O)=O,,,4,1,6,15,21
4077_0,,,,2,2,1,3
C(C(C=O)C(C=O)(C=C)O)=O,,,4,1,7,11,18
4077_1,,,,2,2,1,3
4079_0,,,,2,2,1,3
C(C(C=C)(C(C(C=O)=O)CO)O)=O,,,4,1,6,12,18
4079_1,,,,2,2,1,3
4081_0,,,,2,2,1,3
C(C(C=C)(C(C=O)C(C=O)O)O)=O,,,4,1,6,13,19
4081_1,,,,2,2,1,3
4083_0,,,,2,2,1,3
C(C(C(CO)=O)C(C=O)(C=C)O)=O,,,4,1,5,10,15
4083_1,,,,2,2,1,3
4085_0,,,,2,2,1,3
C(C(C=C)(C(C(CC=O)=O)O)O)=O,,,4,1,4,12,16
4085_1,,,,2,2,1,3
4087_0,,,,2,2,1,3
C(C(C=C)(CC(C(C=O)O)=O)O)=O,,,4,1,2,10,12
4089_0,,,,2,2,1,3
C(C(C=C)(CC=O)O)=O,,,4,1,15,35,50
4091_0,,,,2,2,1,3
C(C(C=C)(C(C(C=O)=O)O)O)=O,,,4,1,5,17,22
4091_1,,,,2,2,1,3
4093_0,,,,2,2,1,3
C(C(C=C)(C(C=O)O)O)=O,,,4,1,12,22,34
4093_1,,,,2,2,1,3
4095_0,,,,2,2,1,3
C(CO)(C(C(C(C=C)=O)O)O)=O,,,4,1,7,16,23
4095_1,,,,2,2,1,3
4097_0,,,,2,2,1,3
C=CC(C(CC(C=O)=O)O)=O,,,4,1,6,17,23
4099_0,,,,2,2,1,3
C(C(C=O)C(C(C=C)=O)O)=O,,,4,1,7,13,20
4099_1,,,,2,2,1,3
4101_0,,,,2,2,1,3
C=CC(C(C(C(C=O)=O)CO)O)=O,,,4,1,6,14,20
4101_1,,,,2,2,1,3
4103_0,,,,2,2,1,3
C(C(C(C=O)C(C(C=C)=O)O)O)=O,,,4,1,6,15,21
4103_1,,,,2,2,1,3
4105_0,,,,2,2,1,3
C(C(C(CO)=O)C(C(C=C)=O)O)=O,,,4,1,5,12,17
4105_1,,,,2,2,1,3
4107_0,,,,2,2,1,3
C(CC(C(C(C(C=C)=O)O)O)=O)=O,,,4,1,5,17,22
4107_1,,,,2,2,1,3
4109_0,,,,2,2,1,3
C(C(C(CC(C(C=C)=O)O)=O)O)=O,,,4,1,2,13,15
4111_0,,,,2,2,1,3
C(CC(C(C=C)=O)O)=O,,,4,1,16,55,71
4113_0,,,,2,2,1,3
C=CC(C(C(C(C=O)=O)O)O)=O,,,4,1,6,18,24
4113_1,,,,2,2,1,3
4115_0,,,,2,2,1,3
C(C(C(C(C=C)=O)O)O)=O,,,4,1,13,34,47
4115_1,,,,2,2,1,3
4117_0,,,,2,2,1,3
C(CO)(C(C(C=CC=O)O)O)=O,,,4,1,6,15,21
4117_1,,,,2,2,1,3
4119_0,,,,2,2,1,3
C(C(CC(C=O)=O)O)=CC=O,,,4,1,6,18,24
4121_0,,,,2,2,1,3
C(C(C=O)C(C=CC=O)O)=O,,,4,1,7,13,20
4121_1,,,,2,2,1,3
4123_0,,,,2,2,1,3
C(C(C(C(C=O)=O)CO)O)=CC=O,,,4,1,6,12,18
4123_1,,,,2,2,1,3
4125_0,,,,2,2,1,3
C(C(C(C=O)C(C=CC=O)O)O)=O,,,4,1,6,14,20
4125_1,,,,2,2,1,3
4127_0,,,,2,2,1,3
C(C(C(CO)=O)C(C=CC=O)O)=O,,,4,1,5,11,16
4127_1,,,,2,2,1,3
4129_0,,,,2,2,1,3
C(CC(C(C(C=CC=O)O)O)=O)=O,,,4,1,3,14,17
4129_1,,,,2,2,1,3
4131_0,,,,2,2,1,3
C(C(C(CC(C=CC=O)O)=O)O)=O,,,4,1,2,12,14
4133_0,,,,2,2,1,3
C(CC(C=CC=O)O)=O,,,4,1,15,49,64
4135_0,,,,2,2,1,3
C(C(C(C(C=O)=O)O)O)=CC=O,,,4,1,4,18,22
4135_1,,,,2,2,1,3
4137_0,,,,2,2,1,3
C(C(C(C=CC=O)O)O)=O,,,4,1,14,28,42
4137_1,,,,2,2,1,3
4139_0,,,,2,2,1,3
C(CC(C1(COC(C1O)O)O)O)=O,,,4,1,3,11,14
4141_0,,,,2,2,1,3
C(C(CC1(C(O)OCC1O)O)=O)=O,,,4,1,2,12,14
4143_0,,,,2,2,1,3
C(C(C=O)C1(C(O)OCC1O)O)=O,,,4,1,3,9,12
4143_1,,,,2,2,1,3
4145_0,,,,2,2,1,3
C(CC1(C(O)OCC1O)O)=O,,,4,1,5,12,17
4146_0,,,,2,2,1,3
4146_1,,,,2,2,1,3
4147_0,,,,2,2,1,3
4147_1,,,,2,2,1,3
4148_0,,,,2,2,1,3
4148_1,,,,2,2,1,3
4149_0,,,,2,2,1,3
4151_0,,,,2,2,1,3
C(C(C=O)C(O)=O)=O,,,4,1,34,37,71
4151_1,,,,2,2,1,3
4152_0,,,,2,2,1,3
4152_1,,,,2,2,1,3
4153_0,,,,2,2,1,3
4153_1,,,,2,2,1,3
4155_0,,,,2,2,1,3
C(C(C=O)C(CO)=O)(O)=O,,,4,1,19,20,39
4155_1,,,,2,2,1,3
4157_0,,,,2,2,1,3
C(C(C(CC=O)=O)O)(O)=O,,,4,1,21,24,45
4157_1,,,,2,2,1,3
4159_0,,,,2,2,1,3
C(CC(C(C=O)O)=O)(O)=O,,,4,1,16,24,40
4160_0,,,,2,2,1,3
4161_0,,,,2,2,1,3
4161_1,,,,2,2,1,3
4163_0,,,,2,2,1,3
C(C(C=O)O)(O)=O,,,4,1,80,139,219
4163_1,,,,2,2,1,3
4164_0,,,,2,2,1,3
4165_0,,,,2,2,1,3
4165_1,,,,2,2,1,3
4166_0,,,,2,2,1,3
4167_0,,,,2,2,1,3
4167_1,,,,2,2,1,3
4168_0,,,,2,2,1,3
4170_0,,,,2,2,1,3
C(CC(C(C(C=O)(CO)O)=O)O)=O,,,4,1,6,14,20
4171_0,,,,2,2,1,3
4172_0,,,,2,2,1,3
4173_0,,,,2,2,1,3
4173_1,,,,2,2,1,3
4174_0,,,,2,2,1,3
4175_0,,,,2,2,1,3
4175_1,,,,2,2,1,3
4177_0,,,,2,2,1,3
C(CO)(C(C(C(O)O)O)O)=O,,,4,1,8,13,21
4177_1,,,,2,2,1,3
4179_0,,,,2,2,1,3
C(C(C(C(O)O)O)O)(C(CO)O)=O,,,4,1,7,13,20
4179_1,,,,2,2,1,3
4181_0,,,,2,2,1,3
C(C(CC(C(O)O)O)=O)=O,,,4,1,9,21,30
4183_0,,,,2,2,1,3
C(C(C=O)C(C(O)O)O)=O,,,4,1,9,13,22
4183_1,,,,2,2,1,3
4185_0,,,,2,2,1,3
C(C(C(CO)C(C(O)O)O)=O)=O,,,4,1,6,18,24
4185_1,,,,2,2,1,3
4187_0,,,,2,2,1,3
C(C(C(C(O)O)O)C(C=O)O)=O,,,4,1,6,19,25
4187_1,,,,2,2,1,3
4189_0,,,,2,2,1,3
C(C(C(CO)=O)C(C(O)O)O)=O,,,4,1,7,13,20
4189_1,,,,2,2,1,3
4191_0,,,,2,2,1,3
C(CC(C(C(C(O)O)O)O)=O)=O,,,4,1,4,15,19
4191_1,,,,2,2,1,3
4193_0,,,,2,2,1,3
C(C(C(CC(C(O)O)O)=O)O)=O,,,4,1,2,13,15
4195_0,,,,2,2,1,3
C(CC(C(O)O)O)=O,,,4,1,20,65,85
4197_0,,,,2,2,1,3
C(C(C(C(C(O)O)O)O)=O)=O,,,4,1,5,18,23
4197_1,,,,2,2,1,3
4199_0,,,,2,2,1,3
C(C(C(C(O)O)O)O)=O,,,4,1,15,31,46
4199_1,,,,2,2,1,3
4201_0,,,,2,2,1,3
C(CO)(C(C(C(C)O)O)O)=O,,,4,1,11,14,25
4201_1,,,,2,2,1,3
4203_0,,,,2,2,1,3
C(C(C(C(C)O)O)O)(C(CO)O)=O,,,4,1,9,14,23
4203_1,,,,2,2,1,3
4205_0,,,,2,2,1,3
C(C(CC(C(C)O)O)=O)=O,,,4,1,10,22,32
4207_0,,,,2,2,1,3
C(C(C=O)C(C(C)O)O)=O,,,4,1,9,14,23
4207_1,,,,2,2,1,3
4209_0,,,,2,2,1,3
C(C(C(CO)C(C(C)O)O)=O)=O,,,4,1,7,19,26
4209_1,,,,2,2,1,3
4211_0,,,,2,2,1,3
C(C(C(C(C)O)O)C(C=O)O)=O,,,4,1,7,20,27
4211_1,,,,2,2,1,3
4213_0,,,,2,2,1,3
C(C(C(CO)=O)C(C(C)O)O)=O,,,4,1,7,14,21
4213_1,,,,2,2,1,3
4215_0,,,,2,2,1,3
C(CC(C(C(C(C)O)O)O)=O)=O,,,4,1,5,16,21
4215_1,,,,2,2,1,3
4217_0,,,,2,2,1,3
C(C(C(CC(C(C)O)O)=O)O)=O,,,4,1,2,14,16
4219_0,,,,2,2,1,3
C(CC(C(C)O)O)=O,,,4,1,20,69,89
4221_0,,,,2,2,1,3
C(C(C(C(C(C)O)O)O)=O)=O,,,4,1,10,19,29
4221_1,,,,2,2,1,3
4223_0,,,,2,2,1,3
C(C(C(C(C)O)O)O)=O,,,4,1,20,33,53
4223_1,,,,2,2,1,3
4225_0,,,,2,2,1,3
C(C(CC(CO)(CO)O)O)(O)=O,,,4,1,7,7,14
4225_1,,,,2,2,1,3
4226_0,,,,2,2,1,3
4226_1,,,,2,2,1,3
4228_0,,,,2,2,1,3
C(C(CC(C(O)=O)O)O)(O)=O,,,4,1,6,6,12
4228_1,,,,2,2,1,3
4230_0,,,,2,2,1,3
C(C(C(CO)C(C(O)=O)O)O)(O)=O,,,4,1,6,7,13
4230_1,,,,2,2,1,3
4232_0,,,,2,2,1,3
C(C(C(C(C(O)=O)O)O)O)(O)=O,,,4,1,8,7,15
4232_1,,,,2,2,1,3
4234_0,,,,2,2,1,3
C(C(C)(CC(C(O)=O)O)O)=O,,,4,1,6,11,17
4234_1,,,,2,2,1,3
4236_0,,,,2,2,1,3
C(C(C)(C(CO)C(C(O)=O)O)O)=O,,,4,1,6,12,18
4236_1,,,,2,2,1,3
4238_0,,,,2,2,1,3
C(C(C)(C(C(C(O)=O)O)O)O)=O,,,4,1,8,14,22
4238_1,,,,2,2,1,3
4240_0,,,,2,2,1,3
C(C(CC(C(C)=O)O)O)(O)=O,,,4,1,8,12,20
4240_1,,,,2,2,1,3
4242_0,,,,2,2,1,3
C(C(C(CO)C(C(C)=O)O)O)(O)=O,,,4,1,6,11,17
4242_1,,,,2,2,1,3
4243_0,,,,2,2,1,3
4243_1,,,,2,2,1,3
4244_0,,,,2,2,1,3
4244_1,,,,2,2,1,3
4246_0,,,,2,2,1,3
C(C(CC(C(O)=O)O)(CCO)O)=O,,,4,1,7,12,19
4246_1,,,,2,2,1,3
4248_0,,,,2,2,1,3
C(C(CC(C(O)=O)O)O)(CCO)=O,,,4,1,7,10,17
4248_1,,,,2,2,1,3
4250_0,,,,2,2,1,3
C(CC(C(CC(C(O)=O)O)O)O)=O,,,4,1,7,14,21
4250_1,,,,2,2,1,3
4252_0,,,,2,2,1,3
C(C(CC(CC(C=O)O)O)O)(O)=O,,,4,1,8,14,22
4252_1,,,,2,2,1,3
4253_0,,,,2,2,1,3
4253_1,,,,2,2,1,3
4254_0,,,,2,2,1,3
4254_1,,,,2,2,1,3
4255_0,,,,2,2,1,3
4255_1,,,,2,2,1,3
4257_0,,,,2,2,1,3
C(C(CC(C)(C(C=O)O)O)O)(O)=O,,,4,1,8,16,24
4257_1,,,,2,2,1,3
4259_0,,,,2,2,1,3
C(C(CC(C)O)O)(O)=O,,,4,1,6,16,22
4259_1,,,,2,2,1,3
4261_0,,,,2,2,1,3
C(C(CO)(CC(C(O)=O)O)O)=O,,,4,1,7,13,20
4261_1,,,,2,2,1,3
4263_0,,,,2,2,1,3
C(C(CC(C(CO)=O)O)O)(O)=O,,,4,1,10,10,20
4263_1,,,,2,2,1,3
4264_0,,,,2,2,1,3
4264_1,,,,2,2,1,3
4266_0,,,,2,2,1,3
C(C(CC(C=O)O)O)(O)=O,,,4,1,12,19,31
4266_1,,,,2,2,1,3
4267_0,,,,2,2,1,3
4267_1,,,,2,2,1,3
4269_0,,,,2,2,1,3
C(CC(C(CO)C(C(O)=O)O)O)=O,,,4,1,7,14,21
4269_1,,,,2,2,1,3
4270_0,,,,2,2,1,3
4270_1,,,,2,2,1,3
4272_0,,,,2,2,1,3
C(C(C(CO)C(C)O)O)(O)=O,,,4,1,6,9,15
4272_1,,,,2,2,1,3
4274_0,,,,2,2,1,3
C(C(C(CO)C(C=O)O)O)(O)=O,,,4,1,10,15,25
4274_1,,,,2,2,1,3
4276_0,,,,2,2,1,3
C(C(C(CO)CO)O)(O)=O,,,4,1,6,8,14
4276_1,,,,2,2,1,3
4278_0,,,,2,2,1,3
C(C(C(CO)C(CO)O)O)(O)=O,,,4,1,7,10,17
4278_1,,,,2,2,1,3
4280_0,,,,2,2,1,3
C(C(C(C(C)O)O)O)(O)=O,,,4,1,12,15,27
4280_1,,,,2,2,1,3
4282_0,,,,2,2,1,3
C(C(CO)(C(C(C(O)=O)O)O)O)=O,,,4,1,13,18,31
4282_1,,,,2,2,1,3
4284_0,,,,2,2,1,3
C(C(C(C(C(CO)=O)O)O)O)(O)=O,,,4,1,13,15,28
4284_1,,,,2,2,1,3
4285_0,,,,2,2,1,3
4285_1,,,,2,2,1,3
4287_0,,,,2,2,1,3
C(C(C(C(C=O)O)O)O)(O)=O,,,4,1,19,22,41
4287_1,,,,2,2,1,3
4288_0,,,,2,2,1,3
4288_1,,,,2,2,1,3
4289_0,,,,2,2,1,3
4289_1,,,,2,2,1,3
4290_0,,,,2,2,1,3
4291_0,,,,2,2,1,3
4291_1,,,,2,2,1,3
4293_0,,,,2,2,1,3
C(C(C(CO)(C(C)O)O)O)(O)=O,,,4,1,9,9,18
4293_1,,,,2,2,1,3
4294_0,,,,2,2,1,3
4294_1,,,,2,2,1,3
4295_0,,,,2,2,1,3
4295_1,,,,2,2,1,3
4296_0,,,,2,2,1,3
4296_1,,,,2,2,1,3
4297_0,,,,2,2,1,3
4297_1,,,,2,2,1,3
4298_0,,,,2,2,1,3
4298_1,,,,2,2,1,3
4299_0,,,,2,2,1,3
4299_1,,,,2,2,1,3
4300_0,,,,2,2,1,3
4300_1,,,,2,2,1,3
4301_0,,,,2,2,1,3
4301_1,,,,2,2,1,3
4303_0,,,,2,2,1,3
C(C(C=O)(C)O)(O)=O,,,4,1,15,24,39
4304_0,,,,2,2,1,3
4304_1,,,,2,2,1,3
4305_0,,,,2,2,1,3
4305_1,,,,2,2,1,3
4306_0,,,,2,2,1,3
4306_1,,,,2,2,1,3
4307_0,,,,2,2,1,3
4307_1,,,,2,2,1,3
4309_0,,,,2,1,2,3
C(CO)(C(C(C=O)=O)O)=O,,,4,1,15,28,43
4311_0,,,,2,1,2,3
C(C(CO)O)(C(C(C=O)=O)O)=O,,,4,1,7,19,26
4313_0,,,,2,1,2,3
C(C(CC(C=O)=O)=O)=O,,,4,1,10,32,42
4315_0,,,,2,1,2,3
C(C(C=O)C(C=O)=O)=O,,,4,1,10,29,39
4317_0,,,,2,1,2,3
C(C(C(C(C=O)=O)CO)=O)=O,,,4,1,5,11,16
4318_0,,,,2,1,2,3
4320_0,,,,2,1,2,3
C(C(C(CO)=O)C(C=O)=O)=O,,,4,1,7,19,26
4322_0,,,,2,1,2,3
C(CC(C(C(C=O)=O)O)=O)=O,,,4,1,4,19,23
4324_0,,,,2,1,2,3
C(C(C(CC(C=O)=O)=O)O)=O,,,4,1,6,20,26
4325_0,,,,2,1,2,3
4327_0,,,,2,1,2,3
C(C(C(C(C=O)=O)O)=O)=O,,,4,1,6,15,21
4328_0,,,,2,1,2,3
4329_0,,,,2,1,2,3
4331_0,,,,2,1,2,3
C(C(C(CO)=O)=O)=O,,,4,1,23,91,114
4333_0,,,,2,1,2,3
C(C(CO)=O)(C(C(CO)O)O)=O,,,4,1,8,14,22
4334_0,,,,2,1,2,3
4336_0,,,,2,1,2,3
C(C(C(C(CO)=O)=O)O)=O,,,4,1,11,27,38
4338_0,,,,2,1,2,3
C(C(CO)=O)(CO)=O,,,4,1,22,54,76
4340_0,,,,2,1,2,3
C(C(CO)=O)(C(CO)O)=O,,,4,1,15,24,39
4341_0,,,,2,1,2,3
4343_0,,,,2,1,2,3
C(C(C(C(C(CO)O)=O)=O)O)=O,,,4,1,8,18,26
4345_0,,,,2,1,2,3
C(C(C(CO)O)=O)(C(CO)O)=O,,,4,1,7,8,15
4346_0,,,,2,1,2,3
4347_0,,,,2,1,2,3
4349_0,,,,2,1,2,3
C(C(C(C=O)=O)(C(C=O)O)O)=O,,,4,1,6,19,25
4351_0,,,,2,1,2,3
C(C(CO)=O)(C(CO)(CO)O)=O,,,4,1,6,9,15
4353_0,,,,2,1,2,3
C(CO)(C(C(C=O)=O)(CO)O)=O,,,4,1,8,16,24
4355_0,,,,2,1,2,3
C(C(C(C=O)=O)(CO)O)(O)=O,,,4,1,10,14,24
4357_0,,,,2,1,2,3
C(C(C(C(CO)=O)=O)O)(O)=O,,,4,1,7,14,21
4359_0,,,,2,1,2,3
C(C(C(C(CO)=O)=O)(C)O)=O,,,4,1,2,12,14
4361_0,,,,2,1,2,3
C(C)(C(C(C(CO)=O)=O)O)=O,,,4,1,4,16,20
4363_0,,,,2,1,2,3
C(CC(C(C(CO)=O)=O)O)=O,,,4,1,5,18,23
4365_0,,,,2,1,2,3
C(C(CO)=O)(C(C)O)=O,,,4,1,9,33,42
4367_0,,,,2,1,2,3
C(C(C(C(CO)=O)=O)(CO)O)=O,,,4,1,4,14,18
4369_0,,,,2,1,2,3
C(CO)(C(C(C(CO)=O)=O)O)=O,,,4,1,3,14,17
4371_0,,,,2,1,2,3
C(C(C(C)O)=O)(C(CO)O)=O,,,4,1,7,14,21
4373_0,,,,2,1,2,3
C(C(C(C)=O)(C(C=O)=O)O)=O,,,4,1,3,11,14
4375_0,,,,2,1,2,3
C(C(C(C(C=O)=O)(CO)O)=O)=O,,,4,1,4,11,15
4377_0,,,,2,1,2,3
C(C(C(C=O)=O)(C(C)O)O)=O,,,4,1,5,14,19
4379_0,,,,2,1,2,3
C(C(C(C(C(C)O)=O)=O)O)=O,,,4,1,4,15,19
4381_0,,,,2,1,2,3
C(C(C(C(C(C=O)O)=O)=O)O)=O,,,4,1,2,10,12
4383_0,,,,2,1,2,3
C(C(C)=O)(C(CO)(CO)O)=O,,,4,1,6,9,15
4384_0,,,,2,1,2,3
4385_0,,,,2,1,2,3
4387_0,,,,2,1,2,3
C(C(C(C=O)=O)(CC=O)O)=O,,,4,1,4,15,19
4388_0,,,,2,1,2,3
4390_0,,,,2,1,2,3
C(C(C(C=O)=O)(C)O)(O)=O,,,4,1,5,12,17
4392_0,,,,2,1,2,3
C(C(C(C(CCO)=O)=O)O)(O)=O,,,4,1,9,12,21
4394_0,,,,2,1,2,3
C(C(C(C=O)=O)(CCO)O)(O)=O,,,4,1,4,14,18
4395_0,,,,2,1,2,3
4397_0,,,,2,1,2,3
C(C(C(C(C)=O)=O)(C)O)=O,,,4,1,4,13,17
4399_0,,,,2,1,2,3
C(C(C(C(CCO)=O)=O)(C)O)=O,,,4,1,4,12,16
4401_0,,,,2,1,2,3
C(C(C(C=O)=O)(C)O)=O,,,4,1,13,19,32
4403_0,,,,2,1,2,3
C(C)(C(C(C(C)=O)=O)O)=O,,,4,1,7,23,30
4405_0,,,,2,1,2,3
C(C)(C(C(C(CCO)=O)=O)O)=O,,,4,1,5,13,18
4407_0,,,,2,1,2,3
C(C)(C(C(C=O)=O)O)=O,,,4,1,17,39,56
4408_0,,,,2,1,2,3
4410_0,,,,2,1,2,3
C(CC(C(C(CCO)=O)=O)O)=O,,,4,1,6,14,20
4412_0,,,,2,1,2,3
C(CC(C(C=O)=O)O)=O,,,4,1,19,41,60
4414_0,,,,2,1,2,3
C(C(C(C(C)=O)=O)(CCO)O)=O,,,4,1,2,11,13
4416_0,,,,2,1,2,3
C(C(C(C=O)=O)(CCO)O)=O,,,4,1,4,13,17
4418_0,,,,2,1,2,3
C(CCO)(C(C(C(C)=O)=O)O)=O,,,4,1,5,13,18
4420_0,,,,2,1,2,3
C(CCO)(C(C(C=O)=O)O)=O,,,4,1,6,19,25
4421_0,,,,2,1,2,3
4423_0,,,,2,1,2,3
C(C(CC(C(C(C)=O)=O)O)O)=O,,,4,1,4,16,20
4425_0,,,,2,1,2,3
C(C(CC(C(C=O)=O)O)O)=O,,,4,1,9,20,29
4426_0,,,,2,1,2,3
4428_0,,,,2,1,2,3
C(CO)(CC(C(C=O)=O)O)=O,,,4,1,11,22,33
4430_0,,,,2,1,2,3
C(CC(C(C(C)=O)=O)(CO)O)=O,,,4,1,4,14,18
4432_0,,,,2,1,2,3
C(CC(C(C=O)=O)(CO)O)=O,,,4,1,8,18,26
4433_0,,,,2,1,2,3
4434_0,,,,2,1,2,3
4436_0,,,,2,1,2,3
C(C(C(C(C(C)=O)=O)(C)O)O)=O,,,4,1,3,16,19
4437_0,,,,2,1,2,3
4439_0,,,,2,1,2,3
C(C(C)=O)(C(C)O)=O,,,4,1,12,78,90
4441_0,,,,2,1,2,3
C(C(C(C)O)=O)(CCO)=O,,,4,1,5,19,24
4442_0,,,,2,1,2,3
4444_0,,,,2,1,2,3
C(C(C(C(C)=O)=O)(CO)O)=O,,,4,1,4,12,16
4446_0,,,,2,1,2,3
C(CO)(C(C(C(C)=O)=O)O)=O,,,4,1,5,16,21
4447_0,,,,2,1,2,3
4449_0,,,,2,1,2,3
C(C(C(C(C)=O)=O)O)=O,,,4,1,17,38,55
4450_0,,,,2,1,2,3
4451_0,,,,2,1,2,3
4453_0,,,,2,1,2,3
C(C(C(C(CCO)=O)=O)O)=O,,,4,1,6,18,24
4454_0,,,,2,1,2,3
4456_0,,,,2,1,2,3
C(C(C(CO)O)=O)(CCO)=O,,,4,1,10,16,26
4458_0,,,,2,1,2,3
C(CO)(CC(C=O)=O)=O,,,4,1,21,47,68
4459_0,,,,2,1,2,3
4461_0,,,,2,1,2,3
C(C(CO)O)(CC(C=O)=O)=O,,,4,1,12,22,34
4462_0,,,,2,1,2,3
4463_0,,,,2,1,2,3
4464_0,,,,2,1,2,3
4465_0,,,,2,1,2,3
4466_0,,,,2,1,2,3
4468_0,,,,2,1,2,3
C(C(C(C=O)=O)=O)=O,,,4,1,10,41,51
4469_0,,,,2,1,2,3
4470_0,,,,2,1,2,3
4471_0,,,,2,1,2,3
4471_1,,,,2,1,2,3
4472_0,,,,2,1,2,3
4472_1,,,,2,1,2,3
4473_0,,,,2,1,2,3
4473_1,,,,2,1,2,3
4474_0,,,,2,1,2,3
4475_0,,,,2,1,2,3
4475_1,,,,2,1,2,3
4476_0,,,,2,1,2,3
4476_1,,,,2,1,2,3
4477_0,,,,2,1,2,3
4477_1,,,,2,1,2,3
4478_0,,,,2,1,2,3
4479_0,,,,2,1,2,3
4479_1,,,,2,1,2,3
4480_0,,,,2,1,2,3
4480_1,,,,2,1,2,3
4481_0,,,,2,1,2,3
4481_1,,,,2,1,2,3
4482_0,,,,2,1,2,3
4482_1,,,,2,1,2,3
4483_0,,,,2,1,2,3
4483_1,,,,2,1,2,3
4484_0,,,,2,1,2,3
4484_1,,,,2,1,2,3
4485_0,,,,2,1,2,3
4485_1,,,,2,1,2,3
4486_0,,,,2,1,2,3
4487_0,,,,2,1,2,3
4488_0,,,,2,1,2,3
4488_1,,,,2,1,2,3
4489_0,,,,2,1,2,3
4490_0,,,,2,1,2,3
4490_1,,,,2,1,2,3
4491_0,,,,2,1,2,3
4491_1,,,,2,1,2,3
4492_0,,,,2,1,2,3
4492_1,,,,2,1,2,3
4493_0,,,,2,1,2,3
4493_1,,,,2,1,2,3
4494_0,,,,2,1,2,3
4494_1,,,,2,1,2,3
4495_0,,,,2,1,2,3
4495_1,,,,2,1,2,3
4496_0,,,,2,1,2,3
4497_0,,,,2,1,2,3
4497_1,,,,2,1,2,3
4498_0,,,,2,1,2,3
4498_1,,,,2,1,2,3
4499_0,,,,2,1,2,3
4499_1,,,,2,1,2,3
4500_0,,,,2,1,2,3
4500_1,,,,2,1,2,3
4501_0,,,,2,1,2,3
4502_0,,,,2,1,2,3
4502_1,,,,2,1,2,3
4503_0,,,,2,1,2,3
4504_0,,,,2,1,2,3
4504_1,,,,2,1,2,3
4505_0,,,,2,1,2,3
4505_1,,,,2,1,2,3
4506_0,,,,2,1,2,3
4507_0,,,,2,1,2,3
4507_1,,,,2,1,2,3
4509_0,,,,2,1,2,3
C(CO)(C(C(CO)=O)O)=O,,,4,1,10,16,26
4510_0,,,,2,1,2,3
4510_1,,,,2,1,2,3
4511_0,,,,2,1,2,3
4511_1,,,,2,1,2,3
4512_0,,,,2,1,2,3
4512_1,,,,2,1,2,3
4514_0,,,,2,1,2,3
C(CO)(C(C(C)=O)O)=O,,,4,1,21,44,65
4514_1,,,,2,1,2,3
4515_0,,,,2,1,2,3
4515_1,,,,2,1,2,3
4516_0,,,,2,1,2,3
4516_1,,,,2,1,2,3
4517_0,,,,2,1,2,3
4517_1,,,,2,1,2,3
4517_2,,,,2,1,2,3
4518_0,,,,2,1,2,3
4518_1,,,,2,1,2,3
4518_2,,,,2,1,2,3
4519_0,,,,2,1,2,3
4519_1,,,,2,1,2,3
4520_0,,,,2,1,2,3
4520_1,,,,2,1,2,3
4521_0,,,,2,1,2,3
4521_1,,,,2,1,2,3
4522_0,,,,2,1,2,3
4522_1,,,,2,1,2,3
4523_0,,,,2,1,2,3
4523_1,,,,2,1,2,3
4524_0,,,,2,1,2,3
4524_1,,,,2,1,2,3
4525_0,,,,2,1,2,3
4526_0,,,,2,1,2,3
4526_1,,,,2,1,2,3
4527_0,,,,2,1,2,3
4528_0,,,,2,1,2,3
4528_1,,,,2,1,2,3
4529_0,,,,2,1,2,3
4529_1,,,,2,1,2,3
4530_0,,,,2,1,2,3
4530_1,,,,2,1,2,3
4531_0,,,,2,1,2,3
4531_1,,,,2,1,2,3
4532_0,,,,2,1,2,3
4532_1,,,,2,1,2,3
4533_0,,,,2,1,2,3
4533_1,,,,2,1,2,3
4534_0,,,,2,1,2,3
4534_1,,,,2,1,2,3
4535_0,,,,2,1,2,3
4535_1,,,,2,1,2,3
4536_0,,,,2,1,2,3
4536_1,,,,2,1,2,3
4537_0,,,,2,1,2,3
4538_0,,,,2,1,2,3
4538_1,,,,2,1,2,3
4539_0,,,,2,1,2,3
4539_1,,,,2,1,2,3
4540_0,,,,2,1,2,3
4540_1,,,,2,1,2,3
4541_0,,,,2,1,2,3
4541_1,,,,2,1,2,3
4542_0,,,,2,1,2,3
4542_1,,,,2,1,2,3
4543_0,,,,2,1,2,3
4543_1,,,,2,1,2,3
4544_0,,,,2,1,2,3
4544_1,,,,2,1,2,3
4545_0,,,,2,1,2,3
4545_1,,,,2,1,2,3
4546_0,,,,2,1,2,3
4546_1,,,,2,1,2,3
4547_0,,,,2,1,2,3
4547_1,,,,2,1,2,3
4548_0,,,,2,1,2,3
4549_0,,,,2,1,2,3
4549_1,,,,2,1,2,3
4550_0,,,,2,1,2,3
4550_1,,,,2,1,2,3
4551_0,,,,2,1,2,3
4551_1,,,,2,1,2,3
4552_0,,,,2,1,2,3
4552_1,,,,2,1,2,3
4553_0,,,,2,1,2,3
4553_1,,,,2,1,2,3
4554_0,,,,2,1,2,3
4554_1,,,,2,1,2,3
4555_0,,,,2,1,2,3
4555_1,,,,2,1,2,3
4556_0,,,,2,1,2,3
4557_0,,,,2,1,2,3
4558_0,,,,2,1,2,3
4558_1,,,,2,1,2,3
4559_0,,,,2,1,2,3
4560_0,,,,2,1,2,3
4561_0,,,,2,1,2,3
4561_1,,,,2,1,2,3
4561_2,,,,2,1,2,3
4562_0,,,,2,1,2,3
4562_1,,,,2,1,2,3
4562_2,,,,2,1,2,3
4563_0,,,,2,1,2,3
4564_0,,,,2,1,2,3
4564_1,,,,2,1,2,3
4565_0,,,,2,1,2,3
4566_0,,,,2,1,2,3
4566_1,,,,2,1,2,3
4567_0,,,,2,1,2,3
4568_0,,,,2,1,2,3
4568_1,,,,2,1,2,3
4569_0,,,,2,1,2,3
4570_0,,,,2,1,2,3
4571_0,,,,2,1,2,3
4571_1,,,,2,1,2,3
4572_0,,,,2,1,2,3
4573_0,,,,2,1,2,3
4573_1,,,,2,1,2,3
4574_0,,,,2,1,2,3
4574_1,,,,2,1,2,3
4575_0,,,,2,1,2,3
4575_1,,,,2,1,2,3
4576_0,,,,2,1,2,3
4576_1,,,,2,1,2,3
4577_0,,,,2,1,2,3
4577_1,,,,2,1,2,3
4578_0,,,,2,1,2,3
4578_1,,,,2,1,2,3
4579_0,,,,2,1,2,3
4579_1,,,,2,1,2,3
4580_0,,,,2,1,2,3
4580_1,,,,2,1,2,3
4581_0,,,,2,1,2,3
4582_0,,,,2,1,2,3
4583_0,,,,2,1,2,3
4583_1,,,,2,1,2,3
4585_0,,,,2,1,2,3
C(C(C=O)(C)O)=O,,,4,1,21,55,76
4587_0,,,,2,1,2,3
C(C(C=O)=O)=O,,,4,1,108,248,356
4587_1,,,,2,1,2,3
4588_0,,,,2,1,2,3
4588_1,,,,2,1,2,3
4589_0,,,,2,1,2,3
4589_1,,,,2,1,2,3
4590_0,,,,2,1,2,3
4591_0,,,,2,1,2,3
4591_1,,,,2,1,2,3
4592_0,,,,2,1,2,3
4592_1,,,,2,1,2,3
4593_0,,,,2,1,2,3
4593_1,,,,2,1,2,3
4594_0,,,,2,1,2,3
4594_1,,,,2,1,2,3
4595_0,,,,2,1,2,3
4595_1,,,,2,1,2,3
4596_0,,,,2,1,2,3
4596_1,,,,2,1,2,3
4597_0,,,,2,1,2,3
4597_1,,,,2,1,2,3
4598_0,,,,2,1,2,3
4598_1,,,,2,1,2,3
4599_0,,,,2,1,2,3
4600_0,,,,2,1,2,3
4601_0,,,,2,1,2,3
4601_1,,,,2,1,2,3
4602_0,,,,2,1,2,3
4603_0,,,,2,1,2,3
4603_1,,,,2,1,2,3
4604_0,,,,2,1,2,3
4604_1,,,,2,1,2,3
4605_0,,,,2,1,2,3
4605_1,,,,2,1,2,3
4606_0,,,,2,1,2,3
4607_0,,,,2,1,2,3
4608_0,,,,2,1,2,3
4609_0,,,,2,1,2,3
4610_0,,,,2,1,2,3
4611_0,,,,2,1,2,3
4612_0,,,,2,1,2,3
4613_0,,,,2,1,2,3
4614_0,,,,2,1,2,3
4615_0,,,,2,1,2,3
4616_0,,,,2,1,2,3
4617_0,,,,2,1,2,3
4618_0,,,,2,1,2,3
4618_1,,,,2,1,2,3
4619_0,,,,2,1,2,3
4621_0,,,,2,1,2,3
C(C)(CC(C=O)=O)=O,,,4,1,16,140,156
4621_1,,,,2,1,2,3
4622_0,,,,2,1,2,3
4623_0,,,,2,1,2,3
4624_0,,,,2,1,2,3
4624_1,,,,2,1,2,3
4625_0,,,,2,1,2,3
4626_0,,,,2,1,2,3
4627_0,,,,2,1,2,3
4627_1,,,,2,1,2,3
4628_0,,,,2,1,2,3
4629_0,,,,2,1,2,3
4629_1,,,,2,1,2,3
4630_0,,,,2,1,2,3
4631_0,,,,2,1,2,3
4632_0,,,,2,1,2,3
4633_0,,,,2,1,2,3
4634_0,,,,2,1,2,3
4635_0,,,,2,1,2,3
4635_1,,,,2,1,2,3
4637_0,,,,2,1,2,3
C(C(C=O)C=O)=O,,,4,1,23,105,128
4638_0,,,,2,1,2,3
4638_1,,,,2,1,2,3
4639_0,,,,2,1,2,3
4639_1,,,,2,1,2,3
4640_0,,,,2,1,2,3
4641_0,,,,2,1,2,3
4641_1,,,,2,1,2,3
4642_0,,,,2,1,2,3
4642_1,,,,2,1,2,3
4643_0,,,,2,1,2,3
4644_0,,,,2,1,2,3
4644_1,,,,2,1,2,3
4646_0,,,,2,1,2,3
C(C(C=O)C(CO)=O)=O,,,4,1,16,31,47
4647_0,,,,2,1,2,3
4647_1,,,,2,1,2,3
4649_0,,,,2,1,2,3
C(CC(C(C=O)O)=O)=O,,,4,1,14,45,59
4650_0,,,,2,1,2,3
4651_0,,,,2,1,2,3
4652_0,,,,2,1,2,3
4653_0,,,,2,1,2,3
4653_1,,,,2,1,2,3
4654_0,,,,2,1,2,3
4655_0,,,,2,1,2,3
4656_0,,,,2,1,2,3
4656_1,,,,2,1,2,3
4657_0,,,,2,1,2,3
4658_0,,,,2,1,2,3
4658_1,,,,2,1,2,3
4659_0,,,,2,1,2,3
4660_0,,,,2,1,2,3
4660_1,,,,2,1,2,3
4661_0,,,,2,1,2,3
4662_0,,,,2,1,2,3
4662_1,,,,2,1,2,3
4663_0,,,,2,1,2,3
4663_1,,,,2,1,2,3
4664_0,,,,2,1,2,3
4665_0,,,,2,1,2,3
4665_1,,,,2,1,2,3
4666_0,,,,2,1,2,3
4667_0,,,,2,1,2,3
4667_1,,,,2,1,2,3
4668_0,,,,2,1,2,3
4668_1,,,,2,1,2,3
4669_0,,,,2,1,2,3
4669_1,,,,2,1,2,3
4671_0,,,,2,1,2,3
C(C(C=O)C(C)=O)=O,,,4,1,11,90,101
4671_1,,,,2,1,2,3
4672_0,,,,2,1,2,3
4672_1,,,,2,1,2,3
4673_0,,,,2,1,2,3
4673_1,,,,2,1,2,3
4674_0,,,,2,1,2,3
4674_1,,,,2,1,2,3
4675_0,,,,2,1,2,3
4675_1,,,,2,1,2,3
4676_0,,,,2,1,2,3
4676_1,,,,2,1,2,3
4677_0,,,,2,1,2,3
4677_1,,,,2,1,2,3
4678_0,,,,2,1,2,3
4678_1,,,,2,1,2,3
4679_0,,,,2,1,2,3
4679_1,,,,2,1,2,3
4680_0,,,,2,1,2,3
4680_1,,,,2,1,2,3
4681_0,,,,2,1,2,3
4681_1,,,,2,1,2,3
4682_0,,,,2,1,2,3
4682_1,,,,2,1,2,3
4683_0,,,,2,1,2,3
4683_1,,,,2,1,2,3
4684_0,,,,2,1,2,3
4684_1,,,,2,1,2,3
4685_0,,,,2,1,2,3
4685_1,,,,2,1,2,3
4686_0,,,,2,1,2,3
4687_0,,,,2,1,2,3
4687_1,,,,2,1,2,3
4689_0,,,,2,1,2,3
C(C(C=O)(CCO)O)=O,,,4,1,7,10,17
4690_0,,,,2,1,2,3
4690_1,,,,2,1,2,3
4691_0,,,,2,1,2,3
4691_1,,,,2,1,2,3
4692_0,,,,2,1,2,3
4692_1,,,,2,1,2,3
4693_0,,,,2,1,2,3
4694_0,,,,2,1,2,3
4695_0,,,,2,1,2,3
4695_1,,,,2,1,2,3
4696_0,,,,2,1,2,3
4697_0,,,,2,1,2,3
4697_1,,,,2,1,2,3
4698_0,,,,2,1,2,3
4699_0,,,,2,1,2,3
4699_1,,,,2,1,2,3
4700_0,,,,2,1,2,3
4700_1,,,,2,1,2,3
4701_0,,,,2,1,2,3
4702_0,,,,2,1,2,3
4702_1,,,,2,1,2,3
4703_0,,,,2,1,2,3
4703_1,,,,2,1,2,3
4704_0,,,,2,1,2,3
4704_1,,,,2,1,2,3
4705_0,,,,2,1,2,3
4705_1,,,,2,1,2,3
4706_0,,,,2,1,2,3
4706_1,,,,2,1,2,3
4707_0,,,,2,1,2,3
4707_1,,,,2,1,2,3
4708_0,,,,2,1,2,3
4708_1,,,,2,1,2,3
4709_0,,,,2,1,2,3
4709_1,,,,2,1,2,3
4710_0,,,,2,1,2,3
4710_1,,,,2,1,2,3
4711_0,,,,2,1,2,3
4711_1,,,,2,1,2,3
4712_0,,,,2,1,2,3
4712_1,,,,2,1,2,3
4713_0,,,,2,1,2,3
4713_1,,,,2,1,2,3
4714_0,,,,2,1,2,3
4714_1,,,,2,1,2,3
4715_0,,,,2,1,2,3
4715_1,,,,2,1,2,3
4716_0,,,,2,1,2,3
4717_0,,,,2,1,2,3
4717_1,,,,2,1,2,3
4718_0,,,,2,1,2,3
4719_0,,,,2,1,2,3
4720_0,,,,2,1,2,3
4721_0,,,,2,1,2,3
4721_1,,,,2,1,2,3
4723_0,,,,2,1,2,3
C(C(CC(C=O)O)O)=O,,,4,1,14,18,32
4724_0,,,,2,1,2,3
4724_1,,,,2,1,2,3
4725_0,,,,2,1,2,3
4725_1,,,,2,1,2,3
4726_0,,,,2,1,2,3
4726_1,,,,2,1,2,3
4727_0,,,,2,1,2,3
4727_1,,,,2,1,2,3
4728_0,,,,2,1,2,3
4728_1,,,,2,1,2,3
4729_0,,,,2,1,2,3
4729_1,,,,2,1,2,3
4730_0,,,,2,1,2,3
4730_1,,,,2,1,2,3
4731_0,,,,2,1,2,3
4731_1,,,,2,1,2,3
4732_0,,,,2,1,2,3
4732_1,,,,2,1,2,3
4733_0,,,,2,1,2,3
4733_1,,,,2,1,2,3
4734_0,,,,2,1,2,3
4734_1,,,,2,1,2,3
4735_0,,,,2,1,2,3
4735_1,,,,2,1,2,3
4736_0,,,,2,1,2,3
4736_1,,,,2,1,2,3
4737_0,,,,2,1,2,3
4737_1,,,,2,1,2,3
4738_0,,,,2,1,2,3
4738_1,,,,2,1,2,3
4739_0,,,,2,1,2,3
4740_0,,,,2,1,2,3
4741_0,,,,2,1,2,3
4741_1,,,,2,1,2,3
4742_0,,,,2,1,2,3
4743_0,,,,2,1,2,3
4744_0,,,,2,1,2,3
4744_1,,,,2,1,2,3
4745_0,,,,2,1,2,3
4746_0,,,,2,1,2,3
4747_0,,,,2,1,2,3
4747_1,,,,2,1,2,3
4748_0,,,,2,1,2,3
4749_0,,,,2,1,2,3
4750_0,,,,2,1,2,3
4750_1,,,,2,1,2,3
4751_0,,,,2,1,2,3
4752_0,,,,2,1,2,3
4752_1,,,,2,1,2,3
4753_0,,,,2,1,2,3
4753_1,,,,2,1,2,3
4754_0,,,,2,1,2,3
4754_1,,,,2,1,2,3
4755_0,,,,2,1,2,3
4755_1,,,,2,1,2,3
4756_0,,,,2,1,2,3
4756_1,,,,2,1,2,3
4757_0,,,,2,1,2,3
4757_1,,,,2,1,2,3
4758_0,,,,2,1,2,3
4758_1,,,,2,1,2,3
4759_0,,,,2,1,2,3
4759_1,,,,2,1,2,3
4760_0,,,,2,1,2,3
4760_1,,,,2,1,2,3
4761_0,,,,2,1,2,3
4761_1,,,,2,1,2,3
4761_2,,,,2,1,2,3
4762_0,,,,2,1,2,3
4762_1,,,,2,1,2,3
4762_2,,,,2,1,2,3
4763_0,,,,2,1,2,3
4763_1,,,,2,1,2,3
4764_0,,,,2,1,2,3
4764_1,,,,2,1,2,3
4765_0,,,,2,1,2,3
4765_1,,,,2,1,2,3
4766_0,,,,2,1,2,3
4766_1,,,,2,1,2,3
4767_0,,,,2,1,2,3
4767_1,,,,2,1,2,3
4768_0,,,,2,1,2,3
4768_1,,,,2,1,2,3
4769_0,,,,2,1,2,3
4769_1,,,,2,1,2,3
4770_0,,,,2,1,2,3
4770_1,,,,2,1,2,3
4771_0,,,,2,1,2,3
4772_0,,,,2,1,2,3
4772_1,,,,2,1,2,3
4773_0,,,,2,1,2,3
4773_1,,,,2,1,2,3
4774_0,,,,2,1,2,3
4775_0,,,,2,1,2,3
4775_1,,,,2,1,2,3
4776_0,,,,2,1,2,3
4776_1,,,,2,1,2,3
4777_0,,,,2,1,2,3
4777_1,,,,2,1,2,3
4778_0,,,,2,1,2,3
4780_0,,,,2,1,2,3
C(CC(C)=O)=O,,,4,1,41,618,659
4780_1,,,,2,1,2,3
4781_0,,,,2,1,2,3
4781_1,,,,2,1,2,3
4782_0,,,,2,1,2,3
4783_0,,,,2,1,2,3
4783_1,,,,2,1,2,3
4784_0,,,,2,1,2,3
4784_1,,,,2,1,2,3
4785_0,,,,2,1,2,3
4786_0,,,,2,1,2,3
4786_1,,,,2,1,2,3
4787_0,,,,2,1,2,3
4788_0,,,,2,1,2,3
4789_0,,,,2,1,2,3
4790_0,,,,2,1,2,3
4791_0,,,,2,1,2,3
4792_0,,,,2,1,2,3
4793_0,,,,2,1,2,3
4794_0,,,,2,1,2,3
4794_1,,,,2,1,2,3
4795_0,,,,2,1,2,3
4796_0,,,,2,1,2,3
4796_1,,,,2,1,2,3
4797_0,,,,2,1,2,3
4797_1,,,,2,1,2,3
4798_0,,,,2,1,2,3
4799_0,,,,2,1,2,3
4800_0,,,,2,1,2,3
4800_1,,,,2,1,2,3
4801_0,,,,2,1,2,3
4802_0,,,,2,1,2,3
4802_1,,,,2,1,2,3
4803_0,,,,2,1,2,3
4804_0,,,,2,1,2,3
4805_0,,,,2,1,2,3
4806_0,,,,2,1,2,3
4807_0,,,,2,1,2,3
4808_0,,,,2,1,2,3
4808_1,,,,2,1,2,3
4810_0,,,,2,1,2,3
C(C(C=O)(CO)O)=O,,,4,1,16,25,41
4811_0,,,,2,1,2,3
4811_1,,,,2,1,2,3
4811_2,,,,2,1,2,3
4812_0,,,,2,1,2,3
4812_1,,,,2,1,2,3
4812_2,,,,2,1,2,3
4813_0,,,,2,1,2,3
4813_1,,,,2,1,2,3
4814_0,,,,2,1,2,3
4815_0,,,,2,1,2,3
4815_1,,,,2,1,2,3
4816_0,,,,2,1,2,3
4816_1,,,,2,1,2,3
4817_0,,,,2,1,2,3
4818_0,,,,2,1,2,3
4818_1,,,,2,1,2,3
4819_0,,,,2,1,2,3
4819_1,,,,2,1,2,3
4820_0,,,,2,1,2,3
4821_0,,,,2,1,2,3
4821_1,,,,2,1,2,3
4822_0,,,,2,1,2,3
4823_0,,,,2,1,2,3
4824_0,,,,2,1,2,3
4824_1,,,,2,1,2,3
4824_2,,,,2,1,2,3
4825_0,,,,2,1,2,3
4825_1,,,,2,1,2,3
4825_2,,,,2,1,2,3
4826_0,,,,2,1,2,3
4826_1,,,,2,1,2,3
4827_0,,,,2,1,2,3
4828_0,,,,2,1,2,3
4829_0,,,,2,1,2,3
4830_0,,,,2,1,2,3
4830_1,,,,2,1,2,3
4831_0,,,,2,1,2,3
4831_1,,,,2,1,2,3
4831_2,,,,2,1,2,3
4832_0,,,,2,1,2,3
4832_1,,,,2,1,2,3
4832_2,,,,2,1,2,3
4833_0,,,,2,1,2,3
4833_1,,,,2,1,2,3
4834_0,,,,2,1,2,3
4834_1,,,,2,1,2,3
4834_2,,,,2,1,2,3
4835_0,,,,2,1,2,3
4835_1,,,,2,1,2,3
4835_2,,,,2,1,2,3
4836_0,,,,2,1,2,3
4836_1,,,,2,1,2,3
4837_0,,,,2,1,2,3
4837_1,,,,2,1,2,3
4838_0,,,,2,1,2,3
4839_0,,,,2,1,2,3
4839_1,,,,2,1,2,3
4840_0,,,,2,1,2,3
4840_1,,,,2,1,2,3
4841_0,,,,2,1,2,3
4841_1,,,,2,1,2,3
4842_0,,,,2,1,2,3
4842_1,,,,2,1,2,3
4842_2,,,,2,1,2,3
4843_0,,,,2,1,2,3
4843_1,,,,2,1,2,3
4843_2,,,,2,1,2,3
4844_0,,,,2,1,2,3
4844_1,,,,2,1,2,3
4844_2,,,,2,1,2,3
4845_0,,,,2,1,2,3
4845_1,,,,2,1,2,3
4845_2,,,,2,1,2,3
4846_0,,,,2,1,2,3
4846_1,,,,2,1,2,3
4847_0,,,,2,1,2,3
4847_1,,,,2,1,2,3
4848_0,,,,2,1,2,3
4848_1,,,,2,1,2,3
4848_2,,,,2,1,2,3
4849_0,,,,2,1,2,3
4849_1,,,,2,1,2,3
4849_2,,,,2,1,2,3
4850_0,,,,2,1,2,3
4850_1,,,,2,1,2,3
4851_0,,,,2,1,2,3
4851_1,,,,2,1,2,3
4852_0,,,,2,1,2,3
4852_1,,,,2,1,2,3
4852_2,,,,2,1,2,3
4853_0,,,,2,1,2,3
4853_1,,,,2,1,2,3
4853_2,,,,2,1,2,3
4854_0,,,,2,1,2,3
4854_1,,,,2,1,2,3
4856_0,,,,2,1,2,3
C(C(C=O)(C(C=O)O)O)=O,,,4,1,14,21,35
4857_0,,,,2,1,2,3
4857_1,,,,2,1,2,3
4857_2,,,,2,1,2,3
4858_0,,,,2,1,2,3
4858_1,,,,2,1,2,3
4858_2,,,,2,1,2,3
4859_0,,,,2,1,2,3
4859_1,,,,2,1,2,3
4860_0,,,,2,1,2,3
4860_1,,,,2,1,2,3
4860_2,,,,2,1,2,3
4861_0,,,,2,1,2,3
4861_1,,,,2,1,2,3
4861_2,,,,2,1,2,3
4862_0,,,,2,1,2,3
4862_1,,,,2,1,2,3
4863_0,,,,2,1,2,3
4863_1,,,,2,1,2,3
4864_0,,,,2,1,2,3
4864_1,,,,2,1,2,3
4864_2,,,,2,1,2,3
4865_0,,,,2,1,2,3
4865_1,,,,2,1,2,3
4865_2,,,,2,1,2,3
4866_0,,,,2,1,2,3
4866_1,,,,2,1,2,3
4866_2,,,,2,1,2,3
4867_0,,,,2,1,2,3
4867_1,,,,2,1,2,3
4867_2,,,,2,1,2,3
4868_0,,,,2,1,2,3
4868_1,,,,2,1,2,3
4868_2,,,,2,1,2,3
4869_0,,,,2,1,2,3
4869_1,,,,2,1,2,3
4869_2,,,,2,1,2,3
4870_0,,,,2,1,2,3
4870_1,,,,2,1,2,3
4871_0,,,,2,1,2,3
4871_1,,,,2,1,2,3
4871_2,,,,2,1,2,3
4872_0,,,,2,1,2,3
4872_1,,,,2,1,2,3
4872_2,,,,2,1,2,3
4873_0,,,,2,1,2,3
4873_1,,,,2,1,2,3
4874_0,,,,2,1,2,3
4874_1,,,,2,1,2,3
4874_2,,,,2,1,2,3
4875_0,,,,2,1,2,3
4875_1,,,,2,1,2,3
4875_2,,,,2,1,2,3
4876_0,,,,2,1,2,3
4877_0,,,,2,1,2,3
4877_1,,,,2,1,2,3
4877_2,,,,2,1,2,3
4878_0,,,,2,1,2,3
4878_1,,,,2,1,2,3
4878_2,,,,2,1,2,3
4879_0,,,,2,1,2,3
4879_1,,,,2,1,2,3
4879_2,,,,2,1,2,3
4880_0,,,,2,1,2,3
4880_1,,,,2,1,2,3
4880_2,,,,2,1,2,3
4881_0,,,,2,1,2,3
4881_1,,,,2,1,2,3
4882_0,,,,2,1,2,3
4882_1,,,,2,1,2,3
4882_2,,,,2,1,2,3
4883_0,,,,2,1,2,3
4883_1,,,,2,1,2,3
4883_2,,,,2,1,2,3
4884_0,,,,2,1,2,3
4884_1,,,,2,1,2,3
4884_2,,,,2,1,2,3
4885_0,,,,2,1,2,3
4885_1,,,,2,1,2,3
4885_2,,,,2,1,2,3
4886_0,,,,2,1,2,3
4886_1,,,,2,1,2,3
4886_2,,,,2,1,2,3
4887_0,,,,2,1,2,3
4887_1,,,,2,1,2,3
4888_0,,,,2,1,2,3
4888_1,,,,2,1,2,3
4890_0,,,,2,1,2,3
C(C(C=O)(CO)O)(O)=O,,,4,1,13,12,25
4891_0,,,,2,1,2,3
4891_1,,,,2,1,2,3
4891_2,,,,2,1,2,3
4892_0,,,,2,1,2,3
4892_1,,,,2,1,2,3
4892_2,,,,2,1,2,3
4893_0,,,,2,1,2,3
4893_1,,,,2,1,2,3
4894_0,,,,2,1,2,3
4894_1,,,,2,1,2,3
4894_2,,,,2,1,2,3
4895_0,,,,2,1,2,3
4895_1,,,,2,1,2,3
4895_2,,,,2,1,2,3
4896_0,,,,2,1,2,3
4896_1,,,,2,1,2,3
4896_2,,,,2,1,2,3
4897_0,,,,2,1,2,3
4898_0,,,,2,1,2,3
4898_1,,,,2,1,2,3
4898_2,,,,2,1,2,3
4899_0,,,,2,1,2,3
4899_1,,,,2,1,2,3
4899_2,,,,2,1,2,3
4900_0,,,,2,1,2,3
4900_1,,,,2,1,2,3
4900_2,,,,2,1,2,3
4901_0,,,,2,1,2,3
4901_1,,,,2,1,2,3
4901_2,,,,2,1,2,3
4902_0,,,,2,1,2,3
4902_1,,,,2,1,2,3
4902_2,,,,2,1,2,3
4903_0,,,,2,1,2,3
4903_1,,,,2,1,2,3
4903_2,,,,2,1,2,3
4904_0,,,,2,1,2,3
4904_1,,,,2,1,2,3
4904_2,,,,2,1,2,3
4905_0,,,,2,1,2,3
4905_1,,,,2,1,2,3
4905_2,,,,2,1,2,3
4907_0,,,,2,1,2,3
C(C(C(C)O)=O)(O)=O,,,4,1,20,43,63
4907_1,,,,2,1,2,3
4908_0,,,,2,1,2,3
4908_1,,,,2,1,2,3
4909_0,,,,2,1,2,3
4909_1,,,,2,1,2,3
4909_2,,,,2,1,2,3
4910_0,,,,2,1,2,3
4910_1,,,,2,1,2,3
4911_0,,,,2,1,2,3
4911_1,,,,2,1,2,3
4911_2,,,,2,1,2,3
4912_0,,,,2,1,2,3
4912_1,,,,2,1,2,3
4912_2,,,,2,1,2,3
4914_0,,,,2,1,2,3
C(C(C(CO)=O)(C)O)=O,,,4,1,13,25,38
4915_0,,,,2,1,2,3
4915_1,,,,2,1,2,3
4916_0,,,,2,1,2,3
4916_1,,,,2,1,2,3
4916_2,,,,2,1,2,3
4917_0,,,,2,1,2,3
4917_1,,,,2,1,2,3
4917_2,,,,2,1,2,3
4918_0,,,,2,1,2,3
4918_1,,,,2,1,2,3
4919_0,,,,2,1,2,3
4919_1,,,,2,1,2,3
4919_2,,,,2,1,2,3
4920_0,,,,2,1,2,3
4920_1,,,,2,1,2,3
4920_2,,,,2,1,2,3
4921_0,,,,2,1,2,3
4921_1,,,,2,1,2,3
4922_0,,,,2,1,2,3
4922_1,,,,2,1,2,3
4922_2,,,,2,1,2,3
4923_0,,,,2,1,2,3
4923_1,,,,2,1,2,3
4924_0,,,,2,1,2,3
4924_1,,,,2,1,2,3
4924_2,,,,2,1,2,3
4925_0,,,,2,1,2,3
4925_1,,,,2,1,2,3
4925_2,,,,2,1,2,3
4926_0,,,,2,1,2,3
4927_0,,,,2,1,2,3
4927_1,,,,2,1,2,3
4928_0,,,,2,1,2,3
4928_1,,,,2,1,2,3
4928_2,,,,2,1,2,3
4929_0,,,,2,1,2,3
4929_1,,,,2,1,2,3
4929_2,,,,2,1,2,3
4930_0,,,,2,1,2,3
4930_1,,,,2,1,2,3
4931_0,,,,2,1,2,3
4931_1,,,,2,1,2,3
4931_2,,,,2,1,2,3
4932_0,,,,2,1,2,3
4932_1,,,,2,1,2,3
4932_2,,,,2,1,2,3
4933_0,,,,2,1,2,3
4933_1,,,,2,1,2,3
4934_0,,,,2,1,2,3
4934_1,,,,2,1,2,3
4934_2,,,,2,1,2,3
4936_0,,,,2,1,2,3
C(C(C=O)(C(C)=O)O)=O,,,4,1,9,16,25
4937_0,,,,2,1,2,3
4937_1,,,,2,1,2,3
4937_2,,,,2,1,2,3
4938_0,,,,2,1,2,3
4938_1,,,,2,1,2,3
4938_2,,,,2,1,2,3
4939_0,,,,2,1,2,3
4940_0,,,,2,1,2,3
4941_0,,,,2,1,2,3
4941_1,,,,2,1,2,3
4941_2,,,,2,1,2,3
4942_0,,,,2,1,2,3
4942_1,,,,2,1,2,3
4942_2,,,,2,1,2,3
4943_0,,,,2,1,2,3
4944_0,,,,2,1,2,3
4944_1,,,,2,1,2,3
4944_2,,,,2,1,2,3
4945_0,,,,2,1,2,3
4945_1,,,,2,1,2,3
4945_2,,,,2,1,2,3
4947_0,,,,2,1,2,3
C(C(C=O)(C(CO)O)O)=O,,,4,1,8,10,18
4948_0,,,,2,1,2,3
4948_1,,,,2,1,2,3
4948_2,,,,2,1,2,3
4949_0,,,,2,1,2,3
4949_1,,,,2,1,2,3
4949_2,,,,2,1,2,3
4950_0,,,,2,1,2,3
4950_1,,,,2,1,2,3
4951_0,,,,2,1,2,3
4951_1,,,,2,1,2,3
4951_2,,,,2,1,2,3
4952_0,,,,2,1,2,3
4952_1,,,,2,1,2,3
4952_2,,,,2,1,2,3
4953_0,,,,2,1,2,3
4953_1,,,,2,1,2,3
4954_0,,,,2,1,2,3
4955_0,,,,2,1,2,3
4955_1,,,,2,1,2,3
4955_2,,,,2,1,2,3
4956_0,,,,2,1,2,3
4956_1,,,,2,1,2,3
4956_2,,,,2,1,2,3
4957_0,,,,2,1,2,3
4957_1,,,,2,1,2,3
4957_2,,,,2,1,2,3
4958_0,,,,2,1,2,3
4958_1,,,,2,1,2,3
4958_2,,,,2,1,2,3
4959_0,,,,2,1,2,3
4960_0,,,,2,1,2,3
4960_1,,,,2,1,2,3
4960_2,,,,2,1,2,3
4961_0,,,,2,1,2,3
4961_1,,,,2,1,2,3
4961_2,,,,2,1,2,3
4962_0,,,,2,1,2,3
4963_0,,,,2,1,2,3
4963_1,,,,2,1,2,3
4963_2,,,,2,1,2,3
4964_0,,,,2,1,2,3
4964_1,,,,2,1,2,3
4964_2,,,,2,1,2,3
4965_0,,,,2,1,2,3
4965_1,,,,2,1,2,3
4965_2,,,,2,1,2,3
4966_0,,,,2,1,2,3
4966_1,,,,2,1,2,3
4966_2,,,,2,1,2,3
4967_0,,,,2,1,2,3
4967_1,,,,2,1,2,3
4968_0,,,,2,1,2,3
4968_1,,,,2,1,2,3
4968_2,,,,2,1,2,3
4969_0,,,,2,1,2,3
4969_1,,,,2,1,2,3
4969_2,,,,2,1,2,3
4970_0,,,,2,1,2,3
4970_1,,,,2,1,2,3
4971_0,,,,2,1,2,3
4971_1,,,,2,1,2,3
4971_2,,,,2,1,2,3
4972_0,,,,2,1,2,3
4972_1,,,,2,1,2,3
4972_2,,,,2,1,2,3
4973_0,,,,2,1,2,3
4973_1,,,,2,1,2,3
4973_2,,,,2,1,2,3
4974_0,,,,2,1,2,3
4974_1,,,,2,1,2,3
4974_2,,,,2,1,2,3
4975_0,,,,2,1,2,3
4975_1,,,,2,1,2,3
4975_2,,,,2,1,2,3
4976_0,,,,2,1,2,3
4976_1,,,,2,1,2,3
4977_0,,,,2,1,2,3
4977_1,,,,2,1,2,3
4977_2,,,,2,1,2,3
4978_0,,,,2,1,2,3
4978_1,,,,2,1,2,3
4978_2,,,,2,1,2,3
4979_0,,,,2,1,2,3
4979_1,,,,2,1,2,3
4980_0,,,,2,1,2,3
4980_1,,,,2,1,2,3
4980_2,,,,2,1,2,3
4981_0,,,,2,1,2,3
4981_1,,,,2,1,2,3
4981_2,,,,2,1,2,3
4983_0,,,,2,1,2,3
C(CO)(C(C)O)=O,,,4,1,63,193,256
4984_0,,,,2,1,2,3
4984_1,,,,2,1,2,3
4984_2,,,,2,1,2,3
4985_0,,,,2,1,2,3
4985_1,,,,2,1,2,3
4985_2,,,,2,1,2,3
4986_0,,,,2,1,2,3
4986_1,,,,2,1,2,3
4986_2,,,,2,1,2,3
4987_0,,,,2,1,2,3
4987_1,,,,2,1,2,3
4987_2,,,,2,1,2,3
4988_0,,,,2,1,2,3
4988_1,,,,2,1,2,3
4989_0,,,,2,1,2,3
4989_1,,,,2,1,2,3
4989_2,,,,2,1,2,3
4990_0,,,,2,1,2,3
4990_1,,,,2,1,2,3
4990_2,,,,2,1,2,3
4991_0,,,,2,1,2,3
4992_0,,,,2,1,2,3
4992_1,,,,2,1,2,3
4992_2,,,,2,1,2,3
4993_0,,,,2,1,2,3
4994_0,,,,2,1,2,3
4994_1,,,,2,1,2,3
4994_2,,,,2,1,2,3
4995_0,,,,2,1,2,3
4995_1,,,,2,1,2,3
4995_2,,,,2,1,2,3
4996_0,,,,2,1,2,3
4997_0,,,,2,1,2,3
4997_1,,,,2,1,2,3
4998_0,,,,2,1,2,3
4999_0,,,,2,1,2,3
4999_1,,,,2,1,2,3
5000_0,,,,2,1,2,3
5001_0,,,,2,1,2,3
5001_1,,,,2,1,2,3
5002_0,,,,2,1,2,3
5003_0,,,,2,1,2,3
5003_1,,,,2,1,2,3
5004_0,,,,2,1,2,3
5004_1,,,,2,1,2,3
5005_0,,,,2,1,2,3
5005_1,,,,2,1,2,3
5006_0,,,,2,1,2,3
5006_1,,,,2,1,2,3
5007_0,,,,2,1,2,3
5007_1,,,,2,1,2,3
5008_0,,,,2,1,2,3
5009_0,,,,2,1,2,3
5009_1,,,,2,1,2,3
5010_0,,,,2,1,2,3
5010_1,,,,2,1,2,3
5011_0,,,,2,1,2,3
5011_1,,,,2,1,2,3
5012_0,,,,2,1,2,3
5012_1,,,,2,1,2,3
5013_0,,,,2,1,2,3
5013_1,,,,2,1,2,3
5014_0,,,,2,1,2,3
5016_0,,,,2,1,2,3
C(C(C=O)(CC=O)O)=O,,,4,1,8,26,34
5017_0,,,,2,1,2,3
5019_0,,,,2,1,2,3
C(C(C=O)(CCO)O)(O)=O,,,4,1,6,9,15
5020_0,,,,2,1,2,3
5021_0,,,,2,1,2,3
5021_1,,,,2,1,2,3
5022_0,,,,2,1,2,3
5022_1,,,,2,1,2,3
5023_0,,,,2,1,2,3
5023_1,,,,2,1,2,3
5024_0,,,,2,1,2,3
5025_0,,,,2,1,2,3
5025_1,,,,2,1,2,3
5026_0,,,,2,1,2,3
5027_0,,,,2,1,2,3
5027_1,,,,2,1,2,3
5028_0,,,,2,1,2,3
5029_0,,,,2,1,2,3
5029_1,,,,2,1,2,3
5029_2,,,,2,1,2,3
5030_0,,,,2,1,2,3
5030_1,,,,2,1,2,3
5030_2,,,,2,1,2,3
5031_0,,,,2,1,2,3
5031_1,,,,2,1,2,3
5032_0,,,,2,1,2,3
5033_0,,,,2,1,2,3
5033_1,,,,2,1,2,3
5034_0,,,,2,1,2,3
5034_1,,,,2,1,2,3
5035_0,,,,2,1,2,3
5036_0,,,,2,1,2,3
5036_1,,,,2,1,2,3
5037_0,,,,2,1,2,3
5038_0,,,,2,1,2,3
5038_1,,,,2,1,2,3
5039_0,,,,2,1,2,3
5039_1,,,,2,1,2,3
5040_0,,,,2,1,2,3
5041_0,,,,2,1,2,3
5042_0,,,,2,1,2,3
5043_0,,,,2,1,2,3
5045_0,,,,2,1,2,3
C(C(C(CO)=O)(C)O)(O)=O,,,4,1,8,12,20
5046_0,,,,2,1,2,3
5047_0,,,,2,1,2,3
5047_1,,,,2,1,2,3
5048_0,,,,2,1,2,3
5048_1,,,,2,1,2,3
5050_0,,,,2,1,2,3
C(C(C(C)=O)(C)O)(O)=O,,,4,1,5,15,20
5050_1,,,,2,1,2,3
5051_0,,,,2,1,2,3
5051_1,,,,2,1,2,3
5052_0,,,,2,1,2,3
5052_1,,,,2,1,2,3
5052_2,,,,2,1,2,3
5053_0,,,,2,1,2,3
5053_1,,,,2,1,2,3
5053_2,,,,2,1,2,3
5054_0,,,,2,1,2,3
5054_1,,,,2,1,2,3
5055_0,,,,2,1,2,3
5055_1,,,,2,1,2,3
5056_0,,,,2,1,2,3
5056_1,,,,2,1,2,3
5057_0,,,,2,1,2,3
5058_0,,,,2,1,2,3
5059_0,,,,2,1,2,3
5059_1,,,,2,1,2,3
5060_0,,,,2,1,2,3
5061_0,,,,2,1,2,3
5061_1,,,,2,1,2,3
5062_0,,,,2,1,2,3
5063_0,,,,2,1,2,3
5063_1,,,,2,1,2,3
5063_2,,,,2,1,2,3
5064_0,,,,2,1,2,3
5064_1,,,,2,1,2,3
5065_0,,,,2,1,2,3
5065_1,,,,2,1,2,3
5066_0,,,,2,1,2,3
5066_1,,,,2,1,2,3
5067_0,,,,2,1,2,3
5067_1,,,,2,1,2,3
5068_0,,,,2,1,2,3
5069_0,,,,2,1,2,3
5070_0,,,,2,1,2,3
5070_1,,,,2,1,2,3
5071_0,,,,2,1,2,3
5071_1,,,,2,1,2,3
5072_0,,,,2,1,2,3
5072_1,,,,2,1,2,3
5073_0,,,,2,1,2,3
5074_0,,,,2,1,2,3
5075_0,,,,2,1,2,3
5076_0,,,,2,1,2,3
5076_1,,,,2,1,2,3
5077_0,,,,2,1,2,3
5077_1,,,,2,1,2,3
5078_0,,,,2,1,2,3
5078_1,,,,2,1,2,3
5079_0,,,,2,1,2,3
5079_1,,,,2,1,2,3
5080_0,,,,2,1,2,3
5081_0,,,,2,1,2,3
5081_1,,,,2,1,2,3
5083_0,,,,2,1,1,2
C(OCC(C)=O)=O,,,4,1,1,182,183
5085_0,,,,2,1,1,2
C(C(COC(C=O)O)O)=O,,,4,1,5,24,29
5085_1,,,,2,1,1,2
5085_2,,,,2,1,1,2
5087_0,,,,2,1,1,2
C(C(C(CO)OC(C=O)O)O)=O,,,4,1,5,14,19
5087_1,,,,2,1,1,2
5087_2,,,,2,1,1,2
5088_0,,,,2,1,2,3
5088_1,,,,2,1,2,3
5090_0,,,,2,1,1,2
C(C(C(COC(C=O)O)O)O)=O,,,4,1,5,18,23
5090_1,,,,2,1,1,2
5090_2,,,,2,1,1,2
5092_0,,,,2,1,1,2
C(C(C(C(OCC=O)O)O)O)=O,,,4,1,5,19,24
5092_1,,,,2,1,1,2
5092_2,,,,2,1,1,2
5093_0,,,,2,1,2,3
5093_1,,,,2,1,2,3
5094_0,,,,2,1,2,3
5094_1,,,,2,1,2,3
5095_0,,,,2,1,2,3
5095_1,,,,2,1,2,3
5095_2,,,,2,1,2,3
5096_0,,,,2,1,2,3
5097_0,,,,2,1,2,3
5097_1,,,,2,1,2,3
5097_2,,,,2,1,2,3
5098_0,,,,2,1,2,3
5099_0,,,,2,1,2,3
5099_1,,,,2,1,2,3
5100_0,,,,2,1,2,3
5101_0,,,,2,1,1,2
5102_0,,,,2,1,1,2
5103_0,,,,2,1,1,2
5104_0,,,,2,1,1,2
5105_0,,,,2,1,1,2
5106_0,,,,2,1,1,2
5107_0,,,,2,1,1,2
5108_0,,,,2,1,1,2
5109_0,,,,2,1,1,2
5110_0,,,,2,1,1,2
5112_0,,,,2,1,1,2
C(C(C(CC(CO)(CO)O)O)=O)=O,,,4,1,4,11,15
5114_0,,,,2,1,1,2
C(C(C(C(CO)(CO)O)=O)O)=O,,,4,1,6,11,17
5115_0,,,,2,1,1,2
5116_0,,,,2,1,1,2
5117_0,,,,2,1,1,2
5119_0,,,,2,1,1,2
C(C(C(C(CO)O)=O)(C)O)=O,,,4,1,6,12,18
5121_0,,,,2,1,1,2
C(C(C)(C(C(C=O)O)O)O)=O,,,4,1,6,20,26
5123_0,,,,2,1,1,2
C(C(C)O)(C(C(CO)=O)O)=O,,,4,1,9,12,21
5125_0,,,,2,1,1,2
C(C(CO)O)(C(C(C)=O)O)=O,,,4,1,10,15,25
5126_0,,,,2,1,1,2
5127_0,,,,2,1,1,2
5128_0,,,,2,1,1,2
5130_0,,,,2,1,1,2
C(C(C(C(CO)O)=O)(CCO)O)=O,,,4,1,6,12,18
5132_0,,,,2,1,1,2
C(C(C(C(C=O)O)O)(CCO)O)=O,,,4,1,7,18,25
5134_0,,,,2,1,1,2
C(C(CCO)O)(C(C(CO)=O)O)=O,,,4,1,3,10,13
5136_0,,,,2,1,1,2
C(CCO)(C(C(C(CO)O)=O)O)=O,,,4,1,8,12,20
5137_0,,,,2,1,1,2
5138_0,,,,2,1,1,2
5139_0,,,,2,1,1,2
5140_0,,,,2,1,1,2
5142_0,,,,2,1,1,2
C(C(CC(C(C(CO)O)=O)O)O)=O,,,4,1,9,16,25
5144_0,,,,2,1,1,2
C(C(C(C(CC(C=O)O)O)O)O)=O,,,4,1,7,23,30
5145_0,,,,2,1,1,2
5146_0,,,,2,1,1,2
5147_0,,,,2,1,1,2
5149_0,,,,2,1,1,2
C(C(CO)(CC=O)O)(C(CO)O)=O,,,4,1,9,16,25
5150_0,,,,2,1,1,2
5151_0,,,,2,1,1,2
5152_0,,,,2,1,1,2
5153_0,,,,2,1,1,2
5154_0,,,,2,1,1,2
5156_0,,,,2,1,1,2
C(C(C)(C(C=O)O)O)(C(CO)O)=O,,,4,1,8,18,26
5157_0,,,,2,1,1,2
5159_0,,,,2,1,1,2
C(C(CO)O)(C(C)O)=O,,,4,1,12,32,44
5160_0,,,,2,1,1,2
5161_0,,,,2,1,1,2
5163_0,,,,2,1,1,2
C(C(CO)(C(C(C=O)O)O)O)=O,,,4,1,11,23,34
5165_0,,,,2,1,1,2
C(C(CO)O)(C(C(CO)=O)O)=O,,,4,1,11,11,22
5166_0,,,,2,1,1,2
5167_0,,,,2,1,1,2
5168_0,,,,2,1,1,2
5169_0,,,,2,1,1,2
5170_0,,,,2,1,1,2
5171_0,,,,2,1,1,2
5172_0,,,,2,1,1,2
5173_0,,,,2,1,1,2
5174_0,,,,2,1,1,2
5175_0,,,,2,1,1,2
5176_0,,,,2,1,1,2
5178_0,,,,2,1,1,2
C(C(C(C(C(CO)O)O)=O)(C)O)=O,,,4,1,5,13,18
5180_0,,,,2,1,1,2
C(C(C)(C(C(C(CO)=O)O)O)O)=O,,,4,1,7,16,23
5182_0,,,,2,1,1,2
C(C(CO)O)(C(C(C(C)O)=O)O)=O,,,4,1,5,12,17
5184_0,,,,2,1,1,2
C(C(C(CO)O)O)(C(C(C)=O)O)=O,,,4,1,7,13,20
5185_0,,,,2,1,1,2
5186_0,,,,2,1,1,2
5187_0,,,,2,1,1,2
5189_0,,,,2,1,1,2
C(C(C(CO)O)O)(C(C)O)=O,,,4,1,7,13,20
5190_0,,,,2,1,1,2
5191_0,,,,2,1,1,2
5192_0,,,,2,1,1,2
5193_0,,,,2,1,1,2
5194_0,,,,2,1,1,2
5195_0,,,,2,1,1,2
5196_0,,,,2,1,1,2
5197_0,,,,2,1,1,2
5198_0,,,,2,1,1,2
5199_0,,,,2,1,1,2
5200_0,,,,2,1,1,2
5202_0,,,,2,1,1,2
C(C(CC(C(C=O)=O)O)O)(O)=O,,,4,1,6,17,23
5203_0,,,,2,1,1,2
5204_0,,,,2,1,1,2
5205_0,,,,2,1,1,2
5206_0,,,,2,1,1,2
5207_0,,,,2,1,1,2
5208_0,,,,2,1,1,2
5210_0,,,,2,1,1,2
C(CC(C(C(C=O)(C)O)=O)O)=O,,,4,1,3,13,16
5211_0,,,,2,1,1,2
5213_0,,,,2,1,1,2
C(C(C)(CC(C(C=O)=O)O)O)=O,,,4,1,3,15,18
5215_0,,,,2,1,1,2
C(C(C(C(C=O)O)=O)(C)O)=O,,,4,1,2,12,14
5216_0,,,,2,1,1,2
5218_0,,,,2,1,1,2
C(C(C)O)(CC(C=O)=O)=O,,,4,1,5,24,29
5220_0,,,,2,1,1,2
C(C(C=O)C(C(C)O)=O)=O,,,4,1,3,15,18
5222_0,,,,2,1,1,2
C(C(C)O)(C(C(C=O)=O)CO)=O,,,4,1,4,16,20
5223_0,,,,2,1,1,2
5225_0,,,,2,1,1,2
C(C(C)O)(C(C=O)C(C=O)O)=O,,,4,1,5,17,22
5226_0,,,,2,1,1,2
5228_0,,,,2,1,1,2
C(C(C)O)(C(C=O)C(CO)=O)=O,,,4,1,5,12,17
5230_0,,,,2,1,1,2
C(CC(C(C(C(C)=O)O)=O)O)=O,,,4,1,5,16,21
5232_0,,,,2,1,1,2
C(CC(C(C(C(C)O)=O)O)=O)=O,,,4,1,2,12,14
5233_0,,,,2,1,1,2
5235_0,,,,2,1,1,2
C(C)(C(CC(C(C=O)=O)O)O)=O,,,4,1,5,17,22
5237_0,,,,2,1,1,2
C(C(C=O)O)(CC(C(C)O)=O)=O,,,4,1,2,13,15
5239_0,,,,2,1,1,2
C(CC(C(C)O)=O)=O,,,4,1,5,96,101
5241_0,,,,2,1,1,2
C(C(C(C(C(C)=O)O)=O)O)=O,,,4,1,7,16,23
5243_0,,,,2,1,1,2
C(C(C)O)(C(C(C=O)=O)O)=O,,,4,1,7,16,23
5244_0,,,,2,1,1,2
5246_0,,,,2,1,1,2
C(C(C(C(C)O)=O)O)=O,,,4,1,18,35,53
5248_0,,,,2,1,1,2
C(C(CCO)O)(CC(C=O)=O)=O,,,4,1,3,15,18
5249_0,,,,2,1,1,2
5250_0,,,,2,1,1,2
5251_0,,,,2,1,1,2
5252_0,,,,2,1,1,2
5253_0,,,,2,1,1,2
5254_0,,,,2,1,1,2
5256_0,,,,2,1,1,2
C(C(C(CO)O)O)(CC(C=O)=O)=O,,,4,1,8,17,25
5257_0,,,,2,1,1,2
5258_0,,,,2,1,1,2
5259_0,,,,2,1,1,2
5260_0,,,,2,1,1,2
5262_0,,,,2,1,1,2
C(CC(C(C(CC=O)O)=O)O)=O,,,4,1,3,10,13
5263_0,,,,2,1,1,2
5265_0,,,,2,1,1,2
C(CC(CC(C(C=O)=O)O)O)=O,,,4,1,8,22,30
5266_0,,,,2,1,1,2
5267_0,,,,2,1,1,2
5269_0,,,,2,1,1,2
C(C(C=O)C(C(CCO)O)=O)=O,,,4,1,3,10,13
5270_0,,,,2,1,1,2
5271_0,,,,2,1,1,2
5272_0,,,,2,1,1,2
5273_0,,,,2,1,1,2
5275_0,,,,2,1,1,2
C(C(C=O)C(C(CO)O)=O)=O,,,4,1,5,14,19
5276_0,,,,2,1,1,2
5278_0,,,,2,1,1,2
C(C(C=O)C(C(C(CO)O)O)=O)=O,,,4,1,3,12,15
5279_0,,,,2,1,1,2
5280_0,,,,2,1,1,2
5282_0,,,,2,1,1,2
C(C(C(C(C=O)O)=O)(CCO)O)=O,,,4,1,1,11,12
5284_0,,,,2,1,1,2
C(C(C(CO)=O)(CCO)O)=O,,,4,1,7,10,17
5286_0,,,,2,1,1,2
C(CC(C(CCO)O)=O)=O,,,4,1,5,21,26
5288_0,,,,2,1,1,2
C(C(C(C(C(CCO)=O)O)=O)O)=O,,,4,1,2,12,14
5290_0,,,,2,1,1,2
C(C(CCO)O)(C(C(C=O)=O)O)=O,,,4,1,1,13,14
5292_0,,,,2,1,1,2
C(CCO)(C(C(CO)=O)O)=O,,,4,1,9,14,23
5294_0,,,,2,1,1,2
C(C(C(C(CCO)O)=O)O)=O,,,4,1,8,14,22
5296_0,,,,2,1,1,2
C(C(CO)O)(C(C(C=O)=O)CO)=O,,,4,1,8,17,25
5297_0,,,,2,1,1,2
5299_0,,,,2,1,1,2
C(CO)(C(C(C=O)=O)CO)=O,,,4,1,12,19,31
5300_0,,,,2,1,1,2
5301_0,,,,2,1,1,2
5303_0,,,,2,1,1,2
C(C(C(C(CC(C=O)O)O)=O)O)=O,,,4,1,4,17,21
5304_0,,,,2,1,1,2
5306_0,,,,2,1,1,2
C(C(CC(C(CO)=O)O)O)=O,,,4,1,9,18,27
5307_0,,,,2,1,1,2
5308_0,,,,2,1,1,2
5309_0,,,,2,1,1,2
5310_0,,,,2,1,1,2
5311_0,,,,2,1,1,2
5312_0,,,,2,1,1,2
5313_0,,,,2,1,1,2
5314_0,,,,2,1,1,2
5315_0,,,,2,1,1,2
5316_0,,,,2,1,1,2
5317_0,,,,2,1,1,2
5318_0,,,,2,1,1,2
5319_0,,,,2,1,1,2
5320_0,,,,2,1,1,2
5321_0,,,,2,1,1,2
5323_0,,,,2,1,1,2
C(C(CO)(CC=O)O)(C(C=O)O)=O,,,4,1,3,17,20
5325_0,,,,2,1,1,2
C(CO)(C(CO)(CC=O)O)=O,,,4,1,9,17,26
5326_0,,,,2,1,1,2
5327_0,,,,2,1,1,2
5329_0,,,,2,1,1,2
C(C(CO)O)(C(C=O)C(CO)=O)=O,,,4,1,4,13,17
5330_0,,,,2,1,1,2
5331_0,,,,2,1,1,2
5332_0,,,,2,1,1,2
5334_0,,,,2,1,1,2
C(C(C(CO)=O)C(CO)=O)=O,,,4,1,7,10,17
5335_0,,,,2,1,1,2
5336_0,,,,2,1,1,2
5337_0,,,,2,1,1,2
5338_0,,,,2,1,1,2
5339_0,,,,2,1,1,2
5341_0,,,,2,1,1,2
C(CC(C(C(C(CO)O)=O)O)=O)=O,,,4,1,3,14,17
5342_0,,,,2,1,1,2
5344_0,,,,2,1,1,2
C(CC(C(C(C(CO)=O)O)=O)O)=O,,,4,1,5,16,21
5345_0,,,,2,1,1,2
5347_0,,,,2,1,1,2
C(CC(C(C(CO)=O)O)=O)=O,,,4,1,9,18,27
5348_0,,,,2,1,1,2
5349_0,,,,2,1,1,2
5350_0,,,,2,1,1,2
5351_0,,,,2,1,1,2
5352_0,,,,2,1,1,2
5353_0,,,,2,1,1,2
5354_0,,,,2,1,1,2
5355_0,,,,2,1,1,2
5356_0,,,,2,1,1,2
5358_0,,,,2,1,1,2
C(C(C)(C(C=O)O)O)(C(C=O)O)=O,,,4,1,4,19,23
5359_0,,,,2,1,1,2
5360_0,,,,2,1,1,2
5361_0,,,,2,1,1,2
5363_0,,,,2,1,1,2
C(C(C(CC(C)O)O)=O)=O,,,4,1,4,17,21
5364_0,,,,2,1,1,2
5366_0,,,,2,1,1,2
C(C(CO)(CC(C(C=O)=O)O)O)=O,,,4,1,3,15,18
5368_0,,,,2,1,1,2
C(C(C=O)O)(CC(C(CO)O)=O)=O,,,4,1,3,14,17
5369_0,,,,2,1,1,2
5370_0,,,,2,1,1,2
5372_0,,,,2,1,1,2
C(CO)(C(CC(C(C=O)=O)O)O)=O,,,4,1,3,17,20
5373_0,,,,2,1,1,2
5375_0,,,,2,1,1,2
C(C(C(CC(C(CO)O)O)O)=O)=O,,,4,1,5,15,20
5377_0,,,,2,1,1,2
C(C(C=O)O)(CC(CO)=O)=O,,,4,1,10,19,29
5378_0,,,,2,1,1,2
5379_0,,,,2,1,1,2
5380_0,,,,2,1,1,2
5382_0,,,,2,1,1,2
C(C(C(CCO)O)=O)=O,,,4,1,12,26,38
5383_0,,,,2,1,1,2
5385_0,,,,2,1,1,2
C(C(C(CC(CO)O)O)=O)=O,,,4,1,5,16,21
5386_0,,,,2,1,1,2
5387_0,,,,2,1,1,2
5388_0,,,,2,1,1,2
5389_0,,,,2,1,1,2
5390_0,,,,2,1,1,2
5391_0,,,,2,1,1,2
5393_0,,,,2,1,1,2
C(C(C(C(C=O)O)=O)(CO)O)=O,,,4,1,4,14,18
5395_0,,,,2,1,1,2
C(C(C(C(C(CO)=O)O)=O)O)=O,,,4,1,6,14,20
5396_0,,,,2,1,1,2
5397_0,,,,2,1,1,2
5398_0,,,,2,1,1,2
5399_0,,,,2,1,1,2
5401_0,,,,2,1,1,2
C(C(C(C(C=O)O)=O)O)=O,,,4,1,7,14,21
5402_0,,,,2,1,1,2
5403_0,,,,2,1,1,2
5404_0,,,,2,1,1,2
5405_0,,,,2,1,1,2
5406_0,,,,2,1,1,2
5407_0,,,,2,1,1,2
5408_0,,,,2,1,1,2
5409_0,,,,2,1,1,2
5410_0,,,,2,1,1,2
5411_0,,,,2,1,1,2
5412_0,,,,2,1,1,2
5413_0,,,,2,1,1,2
5414_0,,,,2,1,1,2
5415_0,,,,2,1,1,2
5416_0,,,,2,1,1,2
5417_0,,,,2,1,1,2
5418_0,,,,2,1,1,2
5420_0,,,,2,1,1,2
C(C(C(CO)=O)(CO)O)(O)=O,,,4,1,12,10,22
5422_0,,,,2,1,1,2
C(C(C(CO)=O)(C(CO)O)O)(O)=O,,,4,1,9,12,21
5423_0,,,,2,1,1,2
5424_0,,,,2,1,1,2
5425_0,,,,2,1,1,2
5426_0,,,,2,1,1,2
5427_0,,,,2,1,1,2
5429_0,,,,2,1,1,2
C(C(C(CO)=O)(C(C(O)=O)O)O)=O,,,4,1,8,13,21
5431_0,,,,2,1,1,2
C(C(C)(C(C=O)(C(CO)=O)O)O)=O,,,4,1,5,13,18
5433_0,,,,2,1,1,2
C(C(C)O)(C(C=O)(C(C=O)O)O)=O,,,4,1,3,15,18
5435_0,,,,2,1,1,2
C(C(C(CO)=O)(C(C(C)=O)O)O)=O,,,4,1,7,15,22
5437_0,,,,2,1,1,2
C(CC(C(C=O)(C(CO)=O)O)O)=O,,,4,1,4,14,18
5439_0,,,,2,1,1,2
C(C(C(CO)=O)(C(C)O)O)=O,,,4,1,6,11,17
5441_0,,,,2,1,1,2
C(C(C(CO)=O)(C(C=O)O)O)=O,,,4,1,8,18,26
5442_0,,,,2,1,1,2
5444_0,,,,2,1,1,2
C(C(C)(C(CO)(C(C=O)O)O)O)=O,,,4,1,8,15,23
5446_0,,,,2,1,1,2
C(C(C)O)(C(C(CO)=O)(CO)O)=O,,,4,1,5,9,14
5447_0,,,,2,1,1,2
5448_0,,,,2,1,1,2
5450_0,,,,2,1,1,2
C(C(C(CO)(C(C)O)O)O)=O,,,4,1,10,15,25
5452_0,,,,2,1,1,2
C(CO)(C(C(CO)=O)(CO)O)=O,,,4,1,6,6,12
5453_0,,,,2,1,1,2
5454_0,,,,2,1,1,2
5455_0,,,,2,1,1,2
5457_0,,,,2,1,1,2
C(C(C(C(C)O)=O)(CO)O)(O)=O,,,4,1,6,9,15
5459_0,,,,2,1,1,2
C(C(C(C(CO)O)=O)(CO)O)(O)=O,,,4,1,10,13,23
5461_0,,,,2,1,1,2
C(C(CO)(C(C(C=O)O)O)O)(O)=O,,,4,1,13,19,32
5463_0,,,,2,1,1,2
C(C(C(CO)=O)(C(C)O)O)(O)=O,,,4,1,8,9,17
5465_0,,,,2,1,1,2
C(C(C(CO)=O)(C(C=O)O)O)(O)=O,,,4,1,9,17,26
5467_0,,,,2,1,1,2
C(C(C)O)(C(C=O)(C(C)=O)O)=O,,,4,1,2,7,9
5469_0,,,,2,1,1,2
C(C(C)O)(C(C(C=O)=O)(CO)O)=O,,,4,1,3,13,16
5471_0,,,,2,1,1,2
C(C(C(C(C)O)=O)(CO)O)=O,,,4,1,5,10,15
5473_0,,,,2,1,1,2
C(C(C(C(C)O)=O)(C(CO)O)O)=O,,,4,1,7,12,19
5475_0,,,,2,1,1,2
C(C(C(C(CCO)O)=O)(CO)O)=O,,,4,1,5,11,16
5476_0,,,,2,1,1,2
5477_0,,,,2,1,1,2
5479_0,,,,2,1,1,2
C(C(CO)O)(C(C=O)(C(C)=O)O)=O,,,4,1,3,10,13
5481_0,,,,2,1,1,2
C(C(C(C(C=O)(C(C)=O)O)O)O)=O,,,4,1,7,17,24
5483_0,,,,2,1,1,2
C(C(C(CO)=O)(C(C)=O)O)=O,,,4,1,6,9,15
5485_0,,,,2,1,1,2
C(C(CO)(C(C(C(C)O)=O)O)O)=O,,,4,1,11,17,28
5487_0,,,,2,1,1,2
C(C(CO)(C(C(CO)=O)(C)O)O)=O,,,4,1,9,16,25
5488_0,,,,2,1,1,2
5490_0,,,,2,1,1,2
C(C(C)O)(C(C=O)(CC=O)O)=O,,,4,1,2,12,14
5492_0,,,,2,1,1,2
C(C(C(C(C)O)=O)(C)O)(O)=O,,,4,1,1,7,8
5494_0,,,,2,1,1,2
C(C(C(C(C)O)=O)(CCO)O)(O)=O,,,4,1,1,9,10
5496_0,,,,2,1,1,2
C(C(C(C(C)O)=O)O)(O)=O,,,4,1,10,17,27
5498_0,,,,2,1,1,2
C(C(C(C(CCO)O)=O)(C)O)(O)=O,,,4,1,1,9,10
5500_0,,,,2,1,1,2
C(C(C(C(CCO)O)=O)O)(O)=O,,,4,1,8,10,18
5502_0,,,,2,1,1,2
C(C(CO)O)(C(C=O)(CC=O)O)=O,,,4,1,3,15,18
5503_0,,,,2,1,1,2
5505_0,,,,2,1,1,2
C(C(C(CO)=O)(CC=O)O)=O,,,4,1,8,16,24
5506_0,,,,2,1,1,2
5507_0,,,,2,1,1,2
5508_0,,,,2,1,1,2
5509_0,,,,2,1,1,2
5511_0,,,,2,1,1,2
C(C(C)(C(C(C(C)O)=O)O)O)(O)=O,,,4,1,6,11,17
5513_0,,,,2,1,1,2
C(C(C(C(O)=O)O)O)(C(C)O)=O,,,4,1,10,12,22
5515_0,,,,2,1,1,2
C(C(C)(C(C(CO)=O)(C)O)O)(O)=O,,,4,1,5,9,14
5517_0,,,,2,1,1,2
C(CO)(C(C)(C(C(O)=O)O)O)=O,,,4,1,6,10,16
5519_0,,,,2,1,1,2
C(C(C(C(CO)O)=O)(C)O)(O)=O,,,4,1,5,10,15
5521_0,,,,2,1,1,2
C(C(C)(C(C(C=O)O)O)O)(O)=O,,,4,1,8,17,25
5522_0,,,,2,1,1,2
5524_0,,,,2,1,1,2
C(C(C(CO)=O)(CCO)O)(O)=O,,,4,1,6,8,14
5526_0,,,,2,1,1,2
C(CO)(CC(CO)=O)=O,,,4,1,11,32,43
5527_0,,,,2,1,1,2
5529_0,,,,2,1,1,2
C(C(CO)O)(CC(CO)=O)=O,,,4,1,11,17,28
5530_0,,,,2,1,1,2
5532_0,,,,2,1,1,2
C(C(CO)(CC(C=O)O)O)=O,,,4,1,4,16,20
5533_0,,,,2,1,1,2
5534_0,,,,2,1,1,2
5536_0,,,,2,1,1,2
C(CC(C(CO)=O)O)(O)=O,,,4,1,7,18,25
5538_0,,,,2,1,1,2
C(C(C(CCO)O)=O)(O)=O,,,4,1,7,12,19
5539_0,,,,2,1,1,2
5541_0,,,,2,1,1,2
C(CC(C(C(CO)O)=O)O)(O)=O,,,4,1,7,10,17
5543_0,,,,2,1,1,2
C(C(C(CC(CO)O)O)=O)(O)=O,,,4,1,5,12,17
5544_0,,,,2,1,1,2
5545_0,,,,2,1,1,2
5547_0,,,,2,1,1,2
C(CO)(C1(C(O)OCC1O)O)=O,,,4,1,3,10,13
5548_0,,,,2,1,1,2
5550_0,,,,2,1,1,2
C1(COC(C1O)O)=O,,,4,1,10,95,105
5551_0,,,,2,1,1,2
5552_0,,,,2,1,1,2
5554_0,,,,2,1,1,2
C(C(C(CO)=O)=O)(O)=O,,,4,1,10,26,36
5555_0,,,,2,1,1,2
5556_0,,,,2,1,1,2
5557_0,,,,2,1,1,2
5558_0,,,,2,1,1,2
5560_0,,,,2,3,2,5
C(C(C(C(C(CCO)O)O)O)O)O,,,4,1,5,10,15
5561_0,,,,2,3,2,5
5562_0,,,,2,3,2,5
5563_0,,,,2,3,2,5
5564_0,,,,2,3,2,5
5565_0,,,,2,3,2,5
5566_0,,,,2,3,2,5
5567_0,,,,2,3,2,5
5568_0,,,,2,3,2,5
5569_0,,,,2,3,2,5
5570_0,,,,2,3,2,5
5571_0,,,,2,3,2,5
5573_0,,,,2,3,2,5
C(C(C(CO)C(CO)(CO)O)O)=O,,,4,1,4,10,14
5574_0,,,,2,3,2,5
5575_0,,,,2,3,2,5
5576_0,,,,2,3,2,5
5578_0,,,,2,3,2,5
C(C(CO)(CCO)O)O,,,4,1,2,6,8
5579_0,,,,2,3,2,5
5580_0,,,,2,3,2,5
5581_0,,,,2,3,2,5
5582_0,,,,2,3,2,5
5583_0,,,,2,3,2,5
5584_0,,,,2,3,2,5
5585_0,,,,2,3,2,5
5586_0,,,,2,3,2,5
5587_0,,,,2,3,2,5
5588_0,,,,2,3,2,5
5589_0,,,,2,3,2,5
5590_0,,,,2,3,2,5
5591_0,,,,2,3,2,5
5593_0,,,,2,3,2,5
C(C(C(CO)(CCO)O)O)O,,,4,1,4,6,10
5594_0,,,,2,3,2,5
5595_0,,,,2,3,2,5
5596_0,,,,2,3,2,5
5597_0,,,,2,3,2,5
5598_0,,,,2,3,2,5
5599_0,,,,2,3,2,5
5600_0,,,,2,3,2,5
5601_0,,,,2,3,2,5
5602_0,,,,2,3,2,5
5603_0,,,,2,3,2,5
5604_0,,,,2,3,2,5
5605_0,,,,2,3,2,5
5606_0,,,,2,3,2,5
5607_0,,,,2,3,2,5
5609_0,,,,2,3,2,5
C(C(CO)(C(C(CCO)O)O)O)=O,,,4,1,7,15,22
5610_0,,,,2,3,2,5
5612_0,,,,2,3,2,5
C(C(C(CO)(C(CCO)O)O)O)=O,,,4,1,8,13,21
5613_0,,,,2,3,2,5
5614_0,,,,2,3,2,5
5615_0,,,,2,3,2,5
5617_0,,,,2,3,2,5
C(C(CO)(C(CCO)O)O)O,,,4,1,3,4,7
5618_0,,,,2,3,2,5
5620_0,,,,2,3,2,5
C(C(C(CO)(C(CCO)O)O)O)O,,,4,1,6,7,13
5622_0,,,,2,3,2,5
C(C(C(C(CCO)O)O)O)(O)=O,,,4,1,9,11,20
5623_0,,,,2,3,2,5
5624_0,,,,2,3,2,5
5625_0,,,,2,3,2,5
5626_0,,,,2,3,2,5
5627_0,,,,2,3,2,5
5628_0,,,,2,3,2,5
5629_0,,,,2,3,2,5
5630_0,,,,2,3,2,5
5632_0,,,,2,3,2,5
C(C(C)(C(CO)C(C=O)O)O)=O,,,4,1,3,15,18
5633_0,,,,2,3,2,5
5634_0,,,,2,3,2,5
5635_0,,,,2,3,2,5
5636_0,,,,2,3,2,5
5637_0,,,,2,3,2,5
5638_0,,,,2,3,2,5
5639_0,,,,2,3,2,5
5641_0,,,,2,3,2,5
C(C(C)(CCO)O)=O,,,4,1,1,31,32
5642_0,,,,2,3,2,5
5643_0,,,,2,3,2,5
5644_0,,,,2,3,2,5
5646_0,,,,2,3,2,5
C(C(C)(C(CO)O)O)=O,,,4,1,4,15,19
5647_0,,,,2,3,2,5
5648_0,,,,2,3,2,5
5649_0,,,,2,3,2,5
5650_0,,,,2,3,2,5
5651_0,,,,2,3,2,5
5653_0,,,,2,3,2,5
C(C(C(CO)C(C(C)=O)O)O)=O,,,4,1,4,15,19
5654_0,,,,2,3,2,5
5655_0,,,,2,3,2,5
5656_0,,,,2,3,2,5
5658_0,,,,2,3,2,5
C(C)(C(CCO)O)=O,,,4,1,5,65,70
5659_0,,,,2,3,2,5
5660_0,,,,2,3,2,5
5661_0,,,,2,3,2,5
5662_0,,,,2,3,2,5
5663_0,,,,2,3,2,5
5664_0,,,,2,3,2,5
5665_0,,,,2,3,2,5
5666_0,,,,2,3,2,5
5667_0,,,,2,3,2,5
5668_0,,,,2,3,2,5
5669_0,,,,2,3,2,5
5670_0,,,,2,3,2,5
5671_0,,,,2,3,2,5
5672_0,,,,2,3,2,5
5673_0,,,,2,3,2,5
5674_0,,,,2,3,2,5
5675_0,,,,2,3,2,5
5676_0,,,,2,3,2,5
5677_0,,,,2,3,2,5
5678_0,,,,2,3,2,5
5679_0,,,,2,3,2,5
5680_0,,,,2,3,2,5
5681_0,,,,2,3,2,5
5682_0,,,,2,3,2,5
5683_0,,,,2,3,2,5
5684_0,,,,2,3,2,5
5685_0,,,,2,3,2,5
5686_0,,,,2,3,2,5
5687_0,,,,2,3,2,5
5688_0,,,,2,3,2,5
5689_0,,,,2,3,2,5
5690_0,,,,2,3,2,5
5691_0,,,,2,3,2,5
5692_0,,,,2,3,2,5
5693_0,,,,2,3,2,5
5694_0,,,,2,3,2,5
5695_0,,,,2,3,2,5
5696_0,,,,2,3,2,5
5697_0,,,,2,3,2,5
5698_0,,,,2,3,2,5
5699_0,,,,2,3,2,5
5700_0,,,,2,3,2,5
5701_0,,,,2,3,2,5
5702_0,,,,2,3,2,5
5703_0,,,,2,3,2,5
5704_0,,,,2,3,2,5
5705_0,,,,2,3,2,5
5706_0,,,,2,3,2,5
5707_0,,,,2,3,2,5
5708_0,,,,2,3,2,5
5709_0,,,,2,3,2,5
5710_0,,,,2,3,2,5
5711_0,,,,2,3,2,5
5712_0,,,,2,3,2,5
5713_0,,,,2,3,2,5
5714_0,,,,2,3,2,5
5715_0,,,,2,3,2,5
5716_0,,,,2,3,2,5
5717_0,,,,2,3,2,5
5718_0,,,,2,3,2,5
5719_0,,,,2,3,2,5
5720_0,,,,2,3,2,5
5721_0,,,,2,3,2,5
5722_0,,,,2,3,2,5
5723_0,,,,2,3,2,5
5724_0,,,,2,3,2,5
5725_0,,,,2,3,2,5
5726_0,,,,2,3,2,5
5727_0,,,,2,3,2,5
5728_0,,,,2,3,2,5
5729_0,,,,2,3,2,5
5730_0,,,,2,3,2,5
5731_0,,,,2,3,2,5
5733_0,,,,2,3,2,5
C(C(CCO)(CCO)O)=O,,,4,1,1,6,7
5734_0,,,,2,3,2,5
5735_0,,,,2,3,2,5
5736_0,,,,2,3,2,5
5738_0,,,,2,3,2,5
C(C(C(CO)O)(CCO)O)=O,,,4,1,5,11,16
5739_0,,,,2,3,2,5
5741_0,,,,2,3,2,5
C(C(CCO)O)(CCO)=O,,,4,1,5,17,22
5742_0,,,,2,3,2,5
5743_0,,,,2,3,2,5
5744_0,,,,2,3,2,5
5745_0,,,,2,3,2,5
5746_0,,,,2,3,2,5
5747_0,,,,2,3,2,5
5748_0,,,,2,3,2,5
5749_0,,,,2,3,2,5
5750_0,,,,2,3,2,5
5751_0,,,,2,3,2,5
5752_0,,,,2,3,2,5
5753_0,,,,2,3,2,5
5754_0,,,,2,3,2,5
5755_0,,,,2,3,2,5
5757_0,,,,2,3,2,5
C(C(CC(CCO)O)O)=O,,,4,1,3,15,18
5758_0,,,,2,3,2,5
5759_0,,,,2,3,2,5
5760_0,,,,2,3,2,5
5762_0,,,,2,3,2,5
C(C(CC(C(CO)O)O)O)=O,,,4,1,6,15,21
5763_0,,,,2,3,2,5
5764_0,,,,2,3,2,5
5766_0,,,,2,3,2,5
C(C(C(CO)C(C)O)O)=O,,,4,1,3,15,18
5767_0,,,,2,3,2,5
5768_0,,,,2,3,2,5
5770_0,,,,2,3,2,5
C(C(CO)(C(CO)C(C=O)O)O)=O,,,4,1,6,15,21
5771_0,,,,2,3,2,5
5773_0,,,,2,3,2,5
C(C(C(CO)C(C(CO)=O)O)O)=O,,,4,1,7,15,22
5774_0,,,,2,3,2,5
5776_0,,,,2,3,2,5
C(C(C(CO)C(C(CO)O)O)O)=O,,,4,1,6,14,20
5777_0,,,,2,3,2,5
5779_0,,,,2,3,2,5
C(C(C(CO)C(C=O)O)O)=O,,,4,1,7,10,17
5780_0,,,,2,3,2,5
5782_0,,,,2,3,2,5
C(C(C(CO)CO)O)=O,,,4,1,6,20,26
5783_0,,,,2,3,2,5
5785_0,,,,2,3,2,5
C(C(C(CO)C(CO)O)O)=O,,,4,1,5,14,19
5786_0,,,,2,3,2,5
5787_0,,,,2,3,2,5
5788_0,,,,2,3,2,5
5789_0,,,,2,3,2,5
5790_0,,,,2,3,2,5
5791_0,,,,2,3,2,5
5792_0,,,,2,3,2,5
5793_0,,,,2,3,2,5
5794_0,,,,2,3,2,5
5795_0,,,,2,3,2,5
5796_0,,,,2,3,2,5
5797_0,,,,2,3,2,5
5798_0,,,,2,3,2,5
5799_0,,,,2,3,2,5
5800_0,,,,2,3,2,5
5801_0,,,,2,3,2,5
5802_0,,,,2,3,2,5
5803_0,,,,2,3,2,5
5804_0,,,,2,3,2,5
5805_0,,,,2,3,2,5
5806_0,,,,2,3,2,5
5807_0,,,,2,3,2,5
5808_0,,,,2,3,2,5
5809_0,,,,2,3,2,5
5810_0,,,,2,3,2,5
5811_0,,,,2,3,2,5
5812_0,,,,2,3,2,5
5813_0,,,,2,3,2,5
5814_0,,,,2,3,2,5
5816_0,,,,2,3,2,5
C(C(C(C)(CCO)O)O)=O,,,4,1,1,19,20
5817_0,,,,2,3,2,5
5818_0,,,,2,3,2,5
5819_0,,,,2,3,2,5
5820_0,,,,2,3,2,5
5821_0,,,,2,3,2,5
5822_0,,,,2,3,2,5
5823_0,,,,2,3,2,5
5824_0,,,,2,3,2,5
5825_0,,,,2,3,2,5
5826_0,,,,2,3,2,5
5827_0,,,,2,3,2,5
5828_0,,,,2,3,2,5
5829_0,,,,2,3,2,5
5831_0,,,,2,3,2,5
CC(CCO)O,,,4,1,1,91,92
5832_0,,,,2,3,2,5
5834_0,,,,2,3,2,5
CC(C(CO)O)O,,,4,1,2,41,43
5835_0,,,,2,3,2,5
5837_0,,,,2,3,2,5
C(C(CO)(CCO)O)=O,,,4,1,5,14,19
5839_0,,,,2,3,2,5
C(CO)(C(CCO)O)=O,,,4,1,13,30,43
5840_0,,,,2,3,2,5
5841_0,,,,2,3,2,5
5843_0,,,,2,3,2,5
C(C(CCO)O)(C(CO)O)=O,,,4,1,8,12,20
5845_0,,,,2,3,2,5
C(C(C(CCO)O)O)O,,,4,1,4,11,15
5847_0,,,,2,3,2,5
C(C(C(C(CCO)O)O)O)O,,,4,1,6,8,14
5849_0,,,,2,3,2,5
C(CCO)O,,,4,1,2,85,87
5851_0,,,,2,3,2,5
C(C(CCO)O)O,,,4,1,2,40,42
5852_0,,,,2,3,2,5
5853_0,,,,2,3,2,5
5854_0,,,,2,3,2,5
5855_0,,,,2,3,2,5
5856_0,,,,2,3,2,5
5857_0,,,,2,3,2,5
5858_0,,,,2,3,2,5
5859_0,,,,2,3,2,5
5860_0,,,,2,3,2,5
5861_0,,,,2,3,2,5
5862_0,,,,2,3,2,5
5863_0,,,,2,3,2,5
5864_0,,,,2,3,2,5
5865_0,,,,2,3,2,5
5866_0,,,,2,3,2,5
5867_0,,,,2,3,2,5
5868_0,,,,2,3,2,5
5869_0,,,,2,3,2,5
5870_0,,,,2,3,2,5
5872_0,,,,2,3,2,5
C(CCO)(O)=O,,,4,1,5,142,147
5874_0,,,,2,3,2,5
C(CC(CO)O)(O)=O,,,4,1,6,29,35
5876_0,,,,2,3,2,5
CC(C(CO)(C(C(CO)O)O)O)O,,,4,1,4,8,12
5877_0,,,,2,3,2,5
5878_0,,,,2,3,2,5
5880_0,,,,2,3,2,5
C(C(C(CO)(C)O)(C(C=O)O)O)=O,,,4,1,10,18,28
5881_0,,,,2,3,2,5
5882_0,,,,2,3,2,5
5883_0,,,,2,3,2,5
5884_0,,,,2,3,2,5
5886_0,,,,2,3,2,5
C(C(C(CCO)O)(C(C=O)O)O)=O,,,4,1,11,19,30
5887_0,,,,2,3,2,5
5888_0,,,,2,3,2,5
5889_0,,,,2,3,2,5
5890_0,,,,2,3,2,5
5891_0,,,,2,3,2,5
5892_0,,,,2,3,2,5
5894_0,,,,2,3,2,5
C(C)(C(CO)(C(CO)(CO)O)O)=O,,,4,1,7,9,16
5896_0,,,,2,3,2,5
C(C(CO)(C(CO)(CO)O)O)O,,,4,1,2,1,3
5898_0,,,,2,3,2,5
C(CO)(C(CO)(C(CO)(C)O)O)=O,,,4,1,8,11,19
5900_0,,,,2,3,2,5
C(CO)(C(CO)(C(CCO)O)O)=O,,,4,1,9,12,21
5901_0,,,,2,3,2,5
5903_0,,,,2,3,2,5
C(C(CO)(C(CO)(C)O)O)(O)=O,,,4,1,7,9,16
5905_0,,,,2,3,2,5
C(C(CO)(C(CCO)O)O)(O)=O,,,4,1,7,10,17
5906_0,,,,2,3,2,5
5908_0,,,,2,3,2,5
C(C)(C(CO)(C(C(O)=O)O)O)=O,,,4,1,12,14,26
5909_0,,,,2,3,2,5
5911_0,,,,2,3,2,5
C(C(CO)(C(CO)(C(C)O)O)O)=O,,,4,1,6,13,19
5913_0,,,,2,3,2,5
C(C(C(C)O)(C(CO)(CO)O)O)=O,,,4,1,6,11,17
5914_0,,,,2,3,2,5
5915_0,,,,2,3,2,5
5916_0,,,,2,3,2,5
5917_0,,,,2,3,2,5
5919_0,,,,2,3,2,5
C(C(C)(C(C(C)=O)(CO)O)O)=O,,,4,1,7,15,22
5921_0,,,,2,3,2,5
C(C(C(C)=O)(C(CO)(C)O)O)=O,,,4,1,4,10,14
5922_0,,,,2,3,2,5
5924_0,,,,2,3,2,5
C(C(C(CO)(C(CO)(C)O)O)=O)=O,,,4,1,8,16,24
5926_0,,,,2,3,2,5
C(C(C)(C(CO)(CO)O)O)=O,,,4,1,3,7,10
5928_0,,,,2,3,2,5
C(C(CO)(C(CO)(C)O)O)=O,,,4,1,7,12,19
5930_0,,,,2,3,2,5
C(C(C)(C(CO)(C(CO)O)O)O)=O,,,4,1,7,11,18
5932_0,,,,2,3,2,5
C(C(C(CO)O)(C(CO)(C)O)O)=O,,,4,1,9,14,23
5933_0,,,,2,3,2,5
5934_0,,,,2,3,2,5
5935_0,,,,2,3,2,5
5936_0,,,,2,3,2,5
5937_0,,,,2,3,2,5
5939_0,,,,2,3,2,5
C(C(C(C)=O)(C(CCO)O)O)=O,,,4,1,4,11,15
5940_0,,,,2,3,2,5
5942_0,,,,2,3,2,5
C(C(C(CO)(C(CCO)O)O)=O)=O,,,4,1,10,17,27
5943_0,,,,2,3,2,5
5945_0,,,,2,3,2,5
C(C(CO)(C(CCO)O)O)=O,,,4,1,7,13,20
5946_0,,,,2,3,2,5
5948_0,,,,2,3,2,5
C(C(C(CO)O)(C(CCO)O)O)=O,,,4,1,9,15,24
5950_0,,,,2,3,2,5
C(C(CCO)(C(CO)(CO)O)O)=O,,,4,1,4,8,12
5952_0,,,,2,3,2,5
C(C(CO)(C(CO)(CCO)O)O)=O,,,4,1,8,13,21
5953_0,,,,2,3,2,5
5955_0,,,,2,3,2,5
C(C(CC(C(CO)(CO)O)O)O)=O,,,4,1,4,10,14
5957_0,,,,2,3,2,5
C(C(CO)(C(CC(CO)O)O)O)=O,,,4,1,7,15,22
5958_0,,,,2,3,2,5
5959_0,,,,2,3,2,5
5960_0,,,,2,3,2,5
5962_0,,,,2,3,2,5
C(C)(C(CO)(C(C)O)O)=O,,,4,1,8,14,22
5963_0,,,,2,3,2,5
5965_0,,,,2,3,2,5
C(C(CO)(C(C(C)=O)(CO)O)O)=O,,,4,1,12,18,30
5966_0,,,,2,3,2,5
5968_0,,,,2,3,2,5
C(C)(C(CO)(C(C(CO)O)O)O)=O,,,4,1,10,14,24
5969_0,,,,2,3,2,5
5970_0,,,,2,3,2,5
5972_0,,,,2,3,2,5
C(C)(C(CO)(CO)O)=O,,,4,1,12,16,28
5974_0,,,,2,3,2,5
C(C)(C(CO)(C(CO)O)O)=O,,,4,1,10,13,23
5975_0,,,,2,3,2,5
5977_0,,,,2,3,2,5
C(C(C(C)(C(CO)(CO)O)O)O)=O,,,4,1,5,10,15
5979_0,,,,2,3,2,5
C(C(CO)(C(C)(C(CO)O)O)O)=O,,,4,1,8,14,22
5980_0,,,,2,3,2,5
5982_0,,,,2,3,2,5
CC(C(CO)(CO)O)O,,,4,1,2,6,8
5984_0,,,,2,3,2,5
CC(C(CO)(C(CO)O)O)O,,,4,1,6,6,12
5985_0,,,,2,3,2,5
5986_0,,,,2,3,2,5
5987_0,,,,2,3,2,5
5988_0,,,,2,3,2,5
5989_0,,,,2,3,2,5
5990_0,,,,2,3,2,5
5991_0,,,,2,3,2,5
5992_0,,,,2,3,2,5
5994_0,,,,2,3,2,5
C(C(C)(C(CO)(CC=O)O)O)=O,,,4,1,6,14,20
5996_0,,,,2,3,2,5
C(C(CCO)(C(C=O)(C)O)O)=O,,,4,1,5,13,18
5998_0,,,,2,3,2,5
C(C(C(CO)(C)O)(CC=O)O)=O,,,4,1,4,14,18
6000_0,,,,2,3,2,5
C(C(C)(C(CO)(C)O)O)(O)=O,,,4,1,3,6,9
6002_0,,,,2,3,2,5
C(C(CCO)(C(CO)(C)O)O)(O)=O,,,4,1,5,8,13
6004_0,,,,2,3,2,5
C(C(C(CO)(C)O)O)(O)=O,,,4,1,10,13,23
6005_0,,,,2,3,2,5
6006_0,,,,2,3,2,5
6007_0,,,,2,3,2,5
6009_0,,,,2,3,2,5
C(C(C(CC=O)O)(CCO)O)=O,,,4,1,4,15,19
6011_0,,,,2,3,2,5
C(C(C(CCO)O)(CC=O)O)=O,,,4,1,4,15,19
6013_0,,,,2,3,2,5
C(C(C)(C(CCO)O)O)(O)=O,,,4,1,3,7,10
6015_0,,,,2,3,2,5
C(C(CCO)(C(CCO)O)O)(O)=O,,,4,1,5,9,14
6017_0,,,,2,3,2,5
C(C(C(CCO)O)O)(O)=O,,,4,1,12,14,26
6019_0,,,,2,3,2,5
C(C(C)(C(CO)(CCO)O)O)(O)=O,,,4,1,4,8,12
6021_0,,,,2,3,2,5
C(C(C(CO)(CCO)O)O)(O)=O,,,4,1,5,9,14
6023_0,,,,2,3,2,5
C(CC(CO)(C(C)O)O)=O,,,4,1,4,17,21
6025_0,,,,2,3,2,5
C(C(C(C)O)(CCO)O)=O,,,4,1,2,10,12
6026_0,,,,2,3,2,5
6027_0,,,,2,3,2,5
6028_0,,,,2,3,2,5
6029_0,,,,2,3,2,5
6030_0,,,,2,3,2,5
6031_0,,,,2,3,2,5
6033_0,,,,2,3,2,5
C(C(CCO)(C(C(CO)O)O)O)=O,,,4,1,7,13,20
6034_0,,,,2,3,2,5
6035_0,,,,2,3,2,5
6036_0,,,,2,3,2,5
6038_0,,,,2,3,2,5
C(C(C)(C(C(CCO)O)O)O)(O)=O,,,4,1,4,10,14
6040_0,,,,2,3,2,5
C(C(C)(C(CC(CO)O)O)O)(O)=O,,,4,1,3,10,13
6042_0,,,,2,3,2,5
C(C(C(CC(CO)O)O)O)(O)=O,,,4,1,8,11,19
6043_0,,,,2,3,2,5
6044_0,,,,2,3,2,5
6046_0,,,,2,3,2,5
C(C(C)(C(C)(C(CO)O)O)O)(O)=O,,,4,1,3,9,12
6048_0,,,,2,3,2,5
C(C(C(C)(C(CO)O)O)O)(O)=O,,,4,1,7,10,17
6049_0,,,,2,3,2,5
6050_0,,,,2,3,2,5
6051_0,,,,2,3,2,5
6052_0,,,,2,3,2,5
6053_0,,,,2,3,2,5
6054_0,,,,2,3,2,5
6055_0,,,,2,3,2,5
6056_0,,,,2,3,2,5
6058_0,,,,2,3,2,5
C(CCO)(C(CO)(CO)O)=O,,,4,1,6,9,15
6060_0,,,,2,3,2,5
C(C(CO)O)(C(CO)CO)=O,,,4,1,8,12,20
6061_0,,,,2,3,2,5
6062_0,,,,2,3,2,5
6063_0,,,,2,3,2,5
6064_0,,,,2,3,2,5
6065_0,,,,2,3,2,5
6066_0,,,,2,3,2,5
6067_0,,,,2,3,2,5
6069_0,,,,2,3,2,5
C=CC(CO)=O,,,4,1,63,532,595
6071_0,,,,2,3,2,5
C(CO)=CC=O,,,4,1,12,323,335
6073_0,,,,2,3,2,5
C1C(CO)(C(C(O)O1)O)O,,,4,1,4,5,9
6075_0,,,,2,3,2,5
C1(C(C(CO)(C(CO)O1)O)O)O,,,4,1,4,5,9
6076_0,,,,2,3,2,5
6078_0,,,,2,3,2,5
C1C(C(CO)(C(C(O)O1)O)O)O,,,4,1,4,6,10
6079_0,,,,2,3,2,5
6080_0,,,,2,3,2,5
6081_0,,,,2,3,2,5
6082_0,,,,2,3,2,5
6083_0,,,,2,3,2,5
6084_0,,,,2,3,2,5
6086_0,,,,2,3,2,5
C(C(O)O)O,,,4,1,1,86,87
6088_0,,,,2,3,2,5
CC(CO)O,,,4,1,2,129,131
6089_0,,,,2,3,2,5
6090_0,,,,2,3,2,5
6091_0,,,,2,3,2,5
6092_0,,,,2,3,2,5
6093_0,,,,2,3,2,5
6095_0,,,,2,3,2,5
C(CC(CO)(CO)O)(O)=O,,,4,1,2,6,8
6096_0,,,,2,3,2,5
6097_0,,,,2,3,2,5
6098_0,,,,2,3,2,5
6099_0,,,,2,3,2,5
6100_0,,,,2,3,2,5
6101_0,,,,2,3,2,5
6103_0,,,,2,3,2,5
C(CC(CO)(C(CO)O)O)(O)=O,,,4,1,4,8,12
6104_0,,,,2,3,2,5
6105_0,,,,2,3,2,5
6106_0,,,,2,3,2,5
6107_0,,,,2,3,2,5
6108_0,,,,2,3,2,5
6109_0,,,,2,3,2,5
6111_0,,,,2,3,2,5
C(C(C(C(O)=O)C(C=O)O)O)(O)=O,,,4,1,9,14,23
6112_0,,,,2,3,2,5
6113_0,,,,2,3,2,5
6114_0,,,,2,3,2,5
6115_0,,,,2,3,2,5
6116_0,,,,2,3,2,5
6118_0,,,,2,3,2,5
C(CC(C(CO)(CO)O)O)(O)=O,,,4,1,3,5,8
6119_0,,,,2,3,2,5
6121_0,,,,2,3,2,5
C(CC(C(C(C(O)=O)O)O)O)(O)=O,,,4,1,8,12,20
6122_0,,,,2,3,2,5
6123_0,,,,2,3,2,5
6124_0,,,,2,3,2,5
6125_0,,,,2,3,2,5
6126_0,,,,2,3,2,5
6127_0,,,,2,3,2,5
6128_0,,,,2,3,2,5
6130_0,,,,2,3,2,5
C(C(C(C(O)=O)C(C=O)(C)O)O)=O,,,4,1,5,13,18
6131_0,,,,2,3,2,5
6132_0,,,,2,3,2,5
6133_0,,,,2,3,2,5
6134_0,,,,2,3,2,5
6135_0,,,,2,3,2,5
6136_0,,,,2,3,2,5
6137_0,,,,2,3,2,5
6139_0,,,,2,3,2,5
C(C(C)(CC(O)=O)O)=O,,,4,1,3,16,19
6140_0,,,,2,3,2,5
6141_0,,,,2,3,2,5
6142_0,,,,2,3,2,5
6143_0,,,,2,3,2,5
6144_0,,,,2,3,2,5
6145_0,,,,2,3,2,5
6146_0,,,,2,3,2,5
6147_0,,,,2,3,2,5
6148_0,,,,2,3,2,5
6150_0,,,,2,3,2,5
C(C(C(C=O)O)C(C(C)=O)O)(O)=O,,,4,1,5,13,18
6151_0,,,,2,3,2,5
6152_0,,,,2,3,2,5
6153_0,,,,2,3,2,5
6155_0,,,,2,3,2,5
C(CC(C(C)=O)O)(O)=O,,,4,1,6,28,34
6156_0,,,,2,3,2,5
6157_0,,,,2,3,2,5
6158_0,,,,2,3,2,5
6159_0,,,,2,3,2,5
6160_0,,,,2,3,2,5
6161_0,,,,2,3,2,5
6162_0,,,,2,3,2,5
6163_0,,,,2,3,2,5
6164_0,,,,2,3,2,5
6165_0,,,,2,3,2,5
6166_0,,,,2,3,2,5
6167_0,,,,2,3,2,5
6168_0,,,,2,3,2,5
6169_0,,,,2,3,2,5
6170_0,,,,2,3,2,5
6171_0,,,,2,3,2,5
6172_0,,,,2,3,2,5
6173_0,,,,2,3,2,5
6174_0,,,,2,3,2,5
6175_0,,,,2,3,2,5
6176_0,,,,2,3,2,5
6177_0,,,,2,3,2,5
6178_0,,,,2,3,2,5
6179_0,,,,2,3,2,5
6180_0,,,,2,3,2,5
6181_0,,,,2,3,2,5
6182_0,,,,2,3,2,5
6183_0,,,,2,3,2,5
6184_0,,,,2,3,2,5
6185_0,,,,2,3,2,5
6187_0,,,,2,3,2,5
C(C(C(CC=O)O)C(C=O)O)(O)=O,,,4,1,6,17,23
6188_0,,,,2,3,2,5
6189_0,,,,2,3,2,5
6190_0,,,,2,3,2,5
6191_0,,,,2,3,2,5
6192_0,,,,2,3,2,5
6193_0,,,,2,3,2,5
6194_0,,,,2,3,2,5
6195_0,,,,2,3,2,5
6196_0,,,,2,3,2,5
6197_0,,,,2,3,2,5
6198_0,,,,2,3,2,5
6199_0,,,,2,3,2,5
6200_0,,,,2,3,2,5
6201_0,,,,2,3,2,5
6202_0,,,,2,3,2,5
6203_0,,,,2,3,2,5
6204_0,,,,2,3,2,5
6205_0,,,,2,3,2,5
6206_0,,,,2,3,2,5
6207_0,,,,2,3,2,5
6208_0,,,,2,3,2,5
6209_0,,,,2,3,2,5
6210_0,,,,2,3,2,5
6211_0,,,,2,3,2,5
6212_0,,,,2,3,2,5
6213_0,,,,2,3,2,5
6214_0,,,,2,3,2,5
6215_0,,,,2,3,2,5
6216_0,,,,2,3,2,5
6217_0,,,,2,3,2,5
6218_0,,,,2,3,2,5
6219_0,,,,2,3,2,5
6220_0,,,,2,3,2,5
6221_0,,,,2,3,2,5
6223_0,,,,2,3,2,5
C(C(CCO)(CC(O)=O)O)=O,,,4,1,3,9,12
6224_0,,,,2,3,2,5
6225_0,,,,2,3,2,5
6226_0,,,,2,3,2,5
6228_0,,,,2,3,2,5
C(CC(C(CCO)=O)O)(O)=O,,,4,1,4,11,15
6229_0,,,,2,3,2,5
6230_0,,,,2,3,2,5
6231_0,,,,2,3,2,5
6232_0,,,,2,3,2,5
6233_0,,,,2,3,2,5
6234_0,,,,2,3,2,5
6235_0,,,,2,3,2,5
6237_0,,,,2,3,2,5
C(CC(CC(C=O)O)O)(O)=O,,,4,1,3,14,17
6238_0,,,,2,3,2,5
6239_0,,,,2,3,2,5
6240_0,,,,2,3,2,5
6241_0,,,,2,3,2,5
6243_0,,,,2,3,2,5
C(C(C(C)O)C(C=O)O)(O)=O,,,4,1,5,14,19
6244_0,,,,2,3,2,5
6246_0,,,,2,3,2,5
C(C(C(C=O)O)C(C=O)O)(O)=O,,,4,1,4,9,13
6247_0,,,,2,3,2,5
6249_0,,,,2,3,2,5
C(C(CO)C(C=O)O)(O)=O,,,4,1,7,18,25
6250_0,,,,2,3,2,5
6252_0,,,,2,3,2,5
C(C(C(CO)O)C(C=O)O)(O)=O,,,4,1,8,15,23
6253_0,,,,2,3,2,5
6254_0,,,,2,3,2,5
6255_0,,,,2,3,2,5
6256_0,,,,2,3,2,5
6257_0,,,,2,3,2,5
6258_0,,,,2,3,2,5
6259_0,,,,2,3,2,5
6260_0,,,,2,3,2,5
6261_0,,,,2,3,2,5
6262_0,,,,2,3,2,5
6263_0,,,,2,3,2,5
6264_0,,,,2,3,2,5
6265_0,,,,2,3,2,5
6266_0,,,,2,3,2,5
6267_0,,,,2,3,2,5
6268_0,,,,2,3,2,5
6269_0,,,,2,3,2,5
6271_0,,,,2,3,2,5
C(CC(C)(C(C=O)O)O)(O)=O,,,4,1,3,15,18
6272_0,,,,2,3,2,5
6273_0,,,,2,3,2,5
6274_0,,,,2,3,2,5
6275_0,,,,2,3,2,5
6276_0,,,,2,3,2,5
6277_0,,,,2,3,2,5
6278_0,,,,2,3,2,5
6280_0,,,,2,3,2,5
C(CC(C)O)(O)=O,,,4,1,3,69,72
6281_0,,,,2,3,2,5
6282_0,,,,2,3,2,5
6283_0,,,,2,3,2,5
6285_0,,,,2,3,2,5
C(C(CO)(CC(O)=O)O)=O,,,4,1,3,12,15
6286_0,,,,2,3,2,5
6287_0,,,,2,3,2,5
6289_0,,,,2,3,2,5
C(C(C(CO)O)(CC(O)=O)O)=O,,,4,1,5,12,17
6290_0,,,,2,3,2,5
6292_0,,,,2,3,2,5
C(CC(C(CO)O)O)(O)=O,,,4,1,5,10,15
6294_0,,,,2,3,2,5
C(CC(C(C(CO)O)O)O)(O)=O,,,4,1,7,10,17
6295_0,,,,2,3,2,5
6296_0,,,,2,3,2,5
6297_0,,,,2,3,2,5
6298_0,,,,2,3,2,5
6299_0,,,,2,3,2,5
6300_0,,,,2,3,2,5
6301_0,,,,2,3,2,5
6302_0,,,,2,3,2,5
6303_0,,,,2,3,2,5
6304_0,,,,2,3,2,5
6305_0,,,,2,3,2,5
6306_0,,,,2,3,2,5
6307_0,,,,2,3,2,5
6308_0,,,,2,3,2,5
6309_0,,,,2,3,2,5
6310_0,,,,2,3,2,5
6311_0,,,,2,3,2,5
6312_0,,,,2,3,2,5
6313_0,,,,2,3,2,5
6315_0,,,,2,3,2,5
C(CC(O)=O)(O)=O,,,4,1,3,50,53
6316_0,,,,2,3,2,5
6317_0,,,,2,3,2,5
6318_0,,,,2,3,2,5
6319_0,,,,2,3,2,5
6320_0,,,,2,3,2,5
6321_0,,,,2,3,2,5
6322_0,,,,2,3,2,5
6324_0,,,,2,3,2,5
C(C(CO)(C(C(O)=O)(C)O)O)(O)=O,,,4,1,9,11,20
6326_0,,,,2,3,2,5
C(C(CO)(C(CC(O)=O)O)O)(O)=O,,,4,1,7,11,18
6328_0,,,,2,3,2,5
C(C(C(C)=O)(C(C(O)=O)O)O)(O)=O,,,4,1,8,11,19
6329_0,,,,2,3,2,5
6331_0,,,,2,3,2,5
C(C(C(C)O)(C(C(O)=O)O)O)(O)=O,,,4,1,11,13,24
6332_0,,,,2,3,2,5
6334_0,,,,2,3,2,5
C(C(C)(C(C(O)=O)(C(C)=O)O)O)=O,,,4,1,6,11,17
6336_0,,,,2,3,2,5
C(C(C)(C(C=O)(C(C)=O)O)O)(O)=O,,,4,1,4,9,13
6337_0,,,,2,3,2,5
6338_0,,,,2,3,2,5
6340_0,,,,2,3,2,5
C(C(C(C)=O)(C(C(C)=O)O)O)(O)=O,,,4,1,7,12,19
6341_0,,,,2,3,2,5
6343_0,,,,2,3,2,5
C(CC(C(C(O)=O)(C(C)=O)O)O)=O,,,4,1,6,12,18
6345_0,,,,2,3,2,5
C(CC(C(C=O)(C(C)=O)O)O)(O)=O,,,4,1,3,9,12
6346_0,,,,2,3,2,5
6348_0,,,,2,3,2,5
C(C(CO)(C(CC(O)=O)O)O)=O,,,4,1,7,14,21
6350_0,,,,2,3,2,5
C(C(C(C)=O)(C(C)O)O)(O)=O,,,4,1,7,9,16
6351_0,,,,2,3,2,5
6353_0,,,,2,3,2,5
C(C(C(C)=O)(C(C=O)O)O)(O)=O,,,4,1,8,16,24
6355_0,,,,2,3,2,5
C(C(C(C)=O)(CO)O)(O)=O,,,4,1,10,11,21
6357_0,,,,2,3,2,5
C(C(C(C)=O)(C(CO)O)O)(O)=O,,,4,1,8,11,19
6359_0,,,,2,3,2,5
C(C(C(CO)(C(C)O)O)=O)(O)=O,,,4,1,8,14,22
6360_0,,,,2,3,2,5
6361_0,,,,2,3,2,5
6362_0,,,,2,3,2,5
6364_0,,,,2,3,2,5
C(C(C(C(C(O)=O)=O)(CO)O)O)=O,,,4,1,13,20,33
6366_0,,,,2,3,2,5
C(C(C(CO)(CO)O)=O)(O)=O,,,4,1,6,8,14
6368_0,,,,2,3,2,5
C(C(C(CO)(C(CO)O)O)=O)(O)=O,,,4,1,11,17,28
6370_0,,,,2,3,2,5
C(C(C(C(O)=O)(CC=O)O)O)(O)=O,,,4,1,6,13,19
6372_0,,,,2,3,2,5
C(CC(C=O)(C(C(O)=O)O)O)(O)=O,,,4,1,5,12,17
6374_0,,,,2,3,2,5
C(CC(C(O)=O)(C(C=O)(C)O)O)=O,,,4,1,4,12,16
6376_0,,,,2,3,2,5
C(CC(C=O)(C(C=O)(C)O)O)(O)=O,,,4,1,3,11,14
6378_0,,,,2,3,2,5
C(C(C)(C(C=O)(CC=O)O)O)(O)=O,,,4,1,4,12,16
6380_0,,,,2,3,2,5
C(C(C)(C(C(O)=O)(C)O)O)(O)=O,,,4,1,2,4,6
6381_0,,,,2,3,2,5
6382_0,,,,2,3,2,5
6383_0,,,,2,3,2,5
6385_0,,,,2,3,2,5
C(C(C(CC=O)O)(CC=O)O)(O)=O,,,4,1,4,17,21
6387_0,,,,2,3,2,5
C(CC(C(C=O)(CC(O)=O)O)O)=O,,,4,1,2,13,15
6389_0,,,,2,3,2,5
C(CC(C(C=O)(CC=O)O)O)(O)=O,,,4,1,2,13,15
6391_0,,,,2,3,2,5
C(C(C)(C(CC(O)=O)O)O)(O)=O,,,4,1,3,7,10
6393_0,,,,2,3,2,5
C(CC(C(C(O)=O)O)O)(O)=O,,,4,1,6,11,17
6394_0,,,,2,3,2,5
6396_0,,,,2,3,2,5
C(C(C(C)O)(CC=O)O)(O)=O,,,4,1,4,13,17
6398_0,,,,2,3,2,5
C(C(C(C)O)(CC(O)=O)O)=O,,,4,1,3,10,13
6399_0,,,,2,3,2,5
6400_0,,,,2,3,2,5
6401_0,,,,2,3,2,5
6403_0,,,,2,3,2,5
C(C(C(CC(C(O)=O)O)O)O)(O)=O,,,4,1,11,13,24
6405_0,,,,2,3,2,5
C(CC(CO)(C(C(O)=O)O)O)(O)=O,,,4,1,5,10,15
6407_0,,,,2,3,2,5
C(C(C(C)(C(C(O)=O)O)O)O)(O)=O,,,4,1,5,7,12
6408_0,,,,2,3,2,5
6409_0,,,,2,3,2,5
6410_0,,,,2,3,2,5
6411_0,,,,2,3,2,5
6412_0,,,,2,3,2,5
6413_0,,,,2,3,2,5
6414_0,,,,2,3,2,5
6415_0,,,,2,3,2,5
6417_0,,,,2,3,2,5
C(C(C(CCO)=O)(CO)O)(O)=O,,,4,1,9,10,19
6418_0,,,,2,3,2,5
6419_0,,,,2,3,2,5
6420_0,,,,2,3,2,5
6421_0,,,,2,3,2,5
6422_0,,,,2,3,2,5
6423_0,,,,2,3,2,5
6424_0,,,,2,3,2,5
6426_0,,,,2,3,2,5
C(C(C(C)=O)=O)(O)=O,,,4,1,18,56,74
6428_0,,,,2,3,2,5
C=CC(C(O)=O)=O,,,4,1,25,122,147
6430_0,,,,2,3,2,5
C(C=CC(O)=O)=O,,,4,1,6,191,197
6432_0,,,,2,3,2,5
C(C1(COC(C1O)O)O)(O)=O,,,4,1,3,8,11
6434_0,,,,2,3,2,5
C(C1(C(CO)OC(C1O)O)O)(O)=O,,,4,1,3,9,12
6436_0,,,,2,3,2,5
C(C(C1(C(O)OCC1O)O)O)(O)=O,,,4,1,7,9,16
6438_0,,,,2,3,2,5
C(C1(C(C(O)OCC1O)O)O)(O)=O,,,4,1,2,11,13
6439_0,,,,2,3,2,5
6441_0,,,,2,3,2,5
C(C(C(C(O)=O)=O)(CO)O)=O,,,4,1,5,11,16
6442_0,,,,2,3,2,5
6444_0,,,,2,3,2,5
C(C(C(C(O)=O)=O)(C(CO)O)O)=O,,,4,1,8,15,23
6446_0,,,,2,3,2,5
C(C(C(C=O)=O)(C(CO)O)O)(O)=O,,,4,1,7,16,23
6447_0,,,,2,3,2,5
6449_0,,,,2,3,2,5
C(C(O)O)(O)=O,,,4,1,3,121,124
6450_0,,,,2,3,2,5
6452_0,,,,2,1,1,2
C(C1(C(C(CC1(C=O)O)O)O)O)=O,,,4,1,5,21,26
6452_1,,,,2,1,1,2
6453_0,,,,2,1,1,2
6453_1,,,,2,1,1,2
6455_0,,,,2,1,1,2
C(C1(C=O)C(C(C(C1O)O)O)O)=O,,,4,1,1,8,9
6456_0,,,,2,1,1,2
6456_1,,,,2,1,1,2
6458_0,,,,2,1,1,2
C(C1(C(C(CC1O)O)O)O)=O,,,4,1,4,16,20
6458_1,,,,2,1,1,2
6460_0,,,,2,1,1,2
C(C1(C(C(C(C1O)O)O)O)O)=O,,,4,1,6,11,17
6460_1,,,,2,1,1,2
6462_0,,,,2,1,1,2
C(CO)(C1(C(C(CC1O)O)O)O)=O,,,4,1,5,15,20
6462_1,,,,2,1,1,2
6463_0,,,,2,1,1,2
6463_1,,,,2,1,1,2
6464_0,,,,2,1,1,2
6464_1,,,,2,1,1,2
6465_0,,,,2,1,1,2
6465_1,,,,2,1,1,2
6466_0,,,,2,1,1,2
6466_1,,,,2,1,1,2
6467_0,,,,2,1,1,2
6467_1,,,,2,1,1,2
6469_0,,,,2,1,1,2
C(C1(C(CC(C1O)=O)O)O)(O)=O,,,4,1,9,15,24
6469_1,,,,2,1,1,2
6471_0,,,,2,1,1,2
C(C1(C(CC(C1(CO)O)O)O)O)=O,,,4,1,6,15,21
6471_1,,,,2,1,1,2
6473_0,,,,2,1,1,2
C(C1(C(C(CC1O)O)O)O)(O)=O,,,4,1,5,13,18
6473_1,,,,2,1,1,2
6475_0,,,,2,1,1,2
C(C1(C(C(C(C1O)O)O)O)O)(O)=O,,,4,1,5,9,14
6475_1,,,,2,1,1,2
6476_0,,,,2,1,1,2
6476_1,,,,2,1,1,2
6477_0,,,,2,1,1,2
6477_1,,,,2,1,1,2
6478_0,,,,2,1,1,2
6478_1,,,,2,1,1,2
6479_0,,,,2,1,1,2
6479_1,,,,2,1,1,2
6480_0,,,,2,1,1,2
6480_1,,,,2,1,1,2
6482_0,,,,2,1,1,2
C1(C(CO)(C(C=O)(CC1O)O)O)=O,,,4,1,5,16,21
6482_1,,,,2,1,1,2
6483_0,,,,2,1,1,2
6483_1,,,,2,1,1,2
6484_0,,,,2,1,1,2
6484_1,,,,2,1,1,2
6486_0,,,,2,1,1,2
C(C1(C=O)C(C(CC1O)O)O)=O,,,4,1,2,12,14
6487_0,,,,2,1,1,2
6488_0,,,,2,1,1,2
6488_1,,,,2,1,1,2
6490_0,,,,2,1,1,2
C(C(C1(C(C(CC1O)O)O)O)=O)=O,,,4,1,4,21,25
6490_1,,,,2,1,1,2
6491_0,,,,2,1,1,2
6491_1,,,,2,1,1,2
6492_0,,,,2,1,1,2
6492_1,,,,2,1,1,2
6494_0,,,,2,1,1,2
C(CO)(C1(C(CC(C1O)=O)O)O)=O,,,4,1,6,18,24
6494_1,,,,2,1,1,2
6496_0,,,,2,1,1,2
C(C1(C(CC(C1O)=O)O)O)=O,,,4,1,8,20,28
6496_1,,,,2,1,1,2
6497_0,,,,2,1,1,2
6497_1,,,,2,1,1,2
6498_0,,,,2,1,1,2
6498_1,,,,2,1,1,2
6499_0,,,,2,1,1,2
6499_1,,,,2,1,1,2
6500_0,,,,2,1,1,2
6500_1,,,,2,1,1,2
6501_0,,,,2,1,1,2
6501_1,,,,2,1,1,2
6503_0,,,,2,1,1,2
C1(C(CC(C1(CO)O)O)O)=O,,,4,1,5,12,17
6503_1,,,,2,1,1,2
6505_0,,,,2,1,1,2
C(C1(C(CC(C1(C=O)O)O)O)O)=O,,,4,1,2,11,13
6505_1,,,,2,1,1,2
6506_0,,,,2,1,1,2
6506_1,,,,2,1,1,2
6508_0,,,,2,1,1,2
C1(CC(C(C1(CO)O)O)O)=O,,,4,1,6,15,21
6508_1,,,,2,1,1,2
6509_0,,,,2,2,1,3
6509_1,,,,2,2,1,3
6511_0,,,,2,2,1,3
C(C(C=O)(CO)C(CO)(CO)O)=O,,,4,1,3,7,10
6513_0,,,,2,2,1,3
C(C(C=O)(C(CO)(CO)O)O)(O)=O,,,4,1,7,9,16
6513_1,,,,2,2,1,3
6514_0,,,,2,2,1,3
6514_1,,,,2,2,1,3
6515_0,,,,2,2,1,3
6515_1,,,,2,2,1,3
6516_0,,,,2,2,1,3
6516_1,,,,2,2,1,3
6517_0,,,,2,2,1,3
6517_1,,,,2,2,1,3
6518_0,,,,2,2,1,3
6518_1,,,,2,2,1,3
6519_0,,,,2,2,1,3
6519_1,,,,2,2,1,3
6520_0,,,,2,2,1,3
6520_1,,,,2,2,1,3
6521_0,,,,2,2,1,3
6521_1,,,,2,2,1,3
6522_0,,,,2,2,1,3
6522_1,,,,2,2,1,3
6524_0,,,,2,2,1,3
C(CO)(C(C(C)O)(C(C=O)O)O)=O,,,4,1,7,19,26
6524_1,,,,2,2,1,3
6526_0,,,,2,2,1,3
C(CO)(C(C(C)O)(C(C)O)O)=O,,,4,1,3,6,9
6526_1,,,,2,2,1,3
6527_0,,,,2,2,1,3
6527_1,,,,2,2,1,3
6529_0,,,,2,2,1,3
C(CO)(C(C(CO)O)(C(C)O)O)=O,,,4,1,7,13,20
6529_1,,,,2,2,1,3
6531_0,,,,2,2,1,3
C(C(C=O)(C(C(CO)=O)O)O)(O)=O,,,4,1,6,16,22
6531_1,,,,2,2,1,3
6532_0,,,,2,2,1,3
6532_1,,,,2,2,1,3
6533_0,,,,2,2,1,3
6533_1,,,,2,2,1,3
6534_0,,,,2,2,1,3
6534_1,,,,2,2,1,3
6535_0,,,,2,2,1,3
6535_1,,,,2,2,1,3
6536_0,,,,2,2,1,3
6536_1,,,,2,2,1,3
6537_0,,,,2,2,1,3
6537_1,,,,2,2,1,3
6538_0,,,,2,2,1,3
6538_1,,,,2,2,1,3
6539_0,,,,2,2,1,3
6539_1,,,,2,2,1,3
6540_0,,,,2,2,1,3
6540_1,,,,2,2,1,3
6541_0,,,,2,2,1,3
6541_1,,,,2,2,1,3
6542_0,,,,2,2,1,3
6542_1,,,,2,2,1,3
6543_0,,,,2,2,1,3
6543_1,,,,2,2,1,3
6544_0,,,,2,2,1,3
6544_1,,,,2,2,1,3
6546_0,,,,2,2,1,3
C(C(C=O)(C=O)C(C(O)=O)O)(O)=O,,,4,1,4,8,12
6548_0,,,,2,2,1,3
C(C(C=O)(C(C)O)C(C(O)=O)O)=O,,,4,1,4,10,14
6550_0,,,,2,2,1,3
C(C(C=O)(CO)C(C(O)=O)O)=O,,,4,1,4,10,14
6551_0,,,,2,2,1,3
6551_1,,,,2,2,1,3
6552_0,,,,2,2,1,3
6552_1,,,,2,2,1,3
6554_0,,,,2,2,1,3
C(C(C=O)(C=O)C(C=O)(C)O)(O)=O,,,4,1,2,7,9
6556_0,,,,2,2,1,3
C(C(C=O)(C(C)O)C(C=O)(C)O)=O,,,4,1,2,9,11
6558_0,,,,2,2,1,3
C(C(C=O)(CO)C(C=O)(C)O)=O,,,4,1,2,10,12
6559_0,,,,2,2,1,3
6559_1,,,,2,2,1,3
6561_0,,,,2,2,1,3
C(C(C=O)(C(C=O)(C)O)O)(O)=O,,,4,1,5,13,18
6561_1,,,,2,2,1,3
6562_0,,,,2,2,1,3
6562_1,,,,2,2,1,3
6564_0,,,,2,2,1,3
C(C(C(C)O)(C(C=O)(C)O)O)=O,,,4,1,6,16,22
6564_1,,,,2,2,1,3
6565_0,,,,2,2,1,3
6565_1,,,,2,2,1,3
6566_0,,,,2,2,1,3
6566_1,,,,2,2,1,3
6568_0,,,,2,2,1,3
C(C(C=O)(C=O)C(C(C)=O)O)(O)=O,,,4,1,2,7,9
6570_0,,,,2,2,1,3
C(C(C=O)(C(C)O)C(C(C)=O)O)=O,,,4,1,2,9,11
6572_0,,,,2,2,1,3
C(C(C=O)(CO)C(C(C)=O)O)=O,,,4,1,3,10,13
6573_0,,,,2,2,1,3
6573_1,,,,2,2,1,3
6574_0,,,,2,2,1,3
6574_1,,,,2,2,1,3
6576_0,,,,2,2,1,3
C(C(C=O)(C(C(C)=O)O)O)(O)=O,,,4,1,7,14,21
6576_1,,,,2,2,1,3
6577_0,,,,2,2,1,3
6577_1,,,,2,2,1,3
6578_0,,,,2,2,1,3
6578_1,,,,2,2,1,3
6579_0,,,,2,2,1,3
6579_1,,,,2,2,1,3
6580_0,,,,2,2,1,3
6580_1,,,,2,2,1,3
6581_0,,,,2,2,1,3
6581_1,,,,2,2,1,3
6583_0,,,,2,2,1,3
C(C(C(C(C)=O)(C(C=O)O)O)O)=O,,,4,1,4,11,15
6583_1,,,,2,2,1,3
6585_0,,,,2,2,1,3
C(C)(C(C(C)O)(C(C=O)O)O)=O,,,4,1,6,19,25
6585_1,,,,2,2,1,3
6586_0,,,,2,2,1,3
6586_1,,,,2,2,1,3
6588_0,,,,2,2,1,3
C(C)(C(C(CO)O)(C(C=O)O)O)=O,,,4,1,8,19,27
6588_1,,,,2,2,1,3
6590_0,,,,2,2,1,3
C(C(C=O)(C=O)C(CC=O)O)(O)=O,,,4,1,2,8,10
6592_0,,,,2,2,1,3
C(C(C=O)(C(CC=O)O)C(C)O)=O,,,4,1,2,10,12
6594_0,,,,2,2,1,3
C(C(C=O)(CO)C(CC=O)O)=O,,,4,1,3,12,15
6595_0,,,,2,2,1,3
6595_1,,,,2,2,1,3
6597_0,,,,2,2,1,3
C(C(C=O)(C(CC=O)O)O)(O)=O,,,4,1,7,15,22
6597_1,,,,2,2,1,3
6598_0,,,,2,2,1,3
6598_1,,,,2,2,1,3
6600_0,,,,2,2,1,3
C(C(C(CC=O)O)(C(C)O)O)=O,,,4,1,6,18,24
6600_1,,,,2,2,1,3
6601_0,,,,2,2,1,3
6601_1,,,,2,2,1,3
6602_0,,,,2,2,1,3
6602_1,,,,2,2,1,3
6604_0,,,,2,2,1,3
C(C(C=O)(C(C)O)C(CCO)O)=O,,,4,1,3,9,12
6606_0,,,,2,2,1,3
C(C(C=O)(C(C)O)C(C)(CO)O)=O,,,4,1,3,9,12
6608_0,,,,2,2,1,3
C(C(C=O)(C=O)C(C)O)(O)=O,,,4,1,2,6,8
6610_0,,,,2,2,1,3
C(C(C=O)(C(C(O)O)O)C(C)O)=O,,,4,1,2,9,11
6612_0,,,,2,2,1,3
C(C(C=O)(C(C)O)C(C(C)O)O)=O,,,4,1,2,10,12
6614_0,,,,2,2,1,3
C(C(C=O)(C(C)O)C(C=O)O)=O,,,4,1,2,13,15
6615_0,,,,2,2,1,3
6616_0,,,,2,2,1,3
6617_0,,,,2,2,1,3
6618_0,,,,2,2,1,3
6620_0,,,,2,2,1,3
C(C(C=O)(C(C)O)C(C)O)=O,,,4,1,1,5,6
6622_0,,,,2,2,1,3
C(C(C=O)(CO)C(C)O)=O,,,4,1,2,8,10
6624_0,,,,2,2,1,3
C(C(C=O)(C(CO)O)C(C)O)=O,,,4,1,3,10,13
6626_0,,,,2,2,1,3
C(C(C=O)(CO)C(C=O)(CO)O)=O,,,4,1,3,11,14
6628_0,,,,2,2,1,3
C(C(C=O)(CO)C(C(CO)=O)O)=O,,,4,1,3,11,14
6630_0,,,,2,2,1,3
C(C(C=O)(CO)C(C(CO)O)O)=O,,,4,1,5,11,16
6632_0,,,,2,2,1,3
C(C(C=O)(C=O)C(C=O)O)(O)=O,,,4,1,2,11,13
6634_0,,,,2,2,1,3
C(C(C=O)(C(C=O)O)C(C=O)O)=O,,,4,1,1,7,8
6635_0,,,,2,2,1,3
6637_0,,,,2,2,1,3
C(C(C=O)(CO)C(C=O)O)=O,,,4,1,4,13,17
6639_0,,,,2,2,1,3
C(C(C=O)(C(CO)O)C(C=O)O)=O,,,4,1,3,13,16
6641_0,,,,2,2,1,3
C(C(C=O)(CO)C(CC(C)O)O)=O,,,4,1,2,9,11
6643_0,,,,2,2,1,3
C(C(C=O)(CO)C(CCO)O)=O,,,4,1,3,9,12
6645_0,,,,2,2,1,3
C(C(C=O)(CO)C(C(C=O)O)O)=O,,,4,1,3,15,18
6647_0,,,,2,2,1,3
C(C(C=O)(CO)C(C)(CO)O)=O,,,4,1,3,9,12
6649_0,,,,2,2,1,3
C(C(C=O)(CO)C(C(O)=O)(C)O)=O,,,4,1,3,9,12
6651_0,,,,2,2,1,3
C(C(C=O)(CO)C(CC(O)=O)O)=O,,,4,1,3,8,11
6653_0,,,,2,2,1,3
C(C(C=O)(CO)C(C=O)(C=C)O)=O,,,4,1,2,7,9
6655_0,,,,2,2,1,3
C(C(C=O)(CO)C(C(C=C)=O)O)=O,,,4,1,2,8,10
6657_0,,,,2,2,1,3
C(C(C=O)(CO)C(C=CC=O)O)=O,,,4,1,2,6,8
6659_0,,,,2,2,1,3
C(C(C=O)(C=O)CO)(O)=O,,,4,1,2,6,8
6661_0,,,,2,2,1,3
C(C(C=O)(CO)C(C(O)O)O)=O,,,4,1,2,9,11
6663_0,,,,2,2,1,3
C(C(C=O)(CO)C(C(C)O)O)=O,,,4,1,2,10,12
6664_0,,,,2,2,1,3
6665_0,,,,2,2,1,3
6666_0,,,,2,2,1,3
6667_0,,,,2,2,1,3
6668_0,,,,2,2,1,3
6669_0,,,,2,2,1,3
6670_0,,,,2,2,1,3
6671_0,,,,2,2,1,3
6672_0,,,,2,2,1,3
6673_0,,,,2,2,1,3
6675_0,,,,2,2,1,3
C(C(C=O)(CO)CO)=O,,,4,1,1,8,9
6677_0,,,,2,2,1,3
C(C(C=O)(CO)C(CO)O)=O,,,4,1,3,9,12
6679_0,,,,2,2,1,3
C(C(C=O)(C(C(C=O)CO)O)O)=O,,,4,1,4,14,18
6679_1,,,,2,2,1,3
6680_0,,,,2,2,1,3
6680_1,,,,2,2,1,3
6682_0,,,,2,2,1,3
C(C(C=O)(C=O)C(CO)O)(O)=O,,,4,1,3,9,12
6683_0,,,,2,2,1,3
6684_0,,,,2,2,1,3
6685_0,,,,2,2,1,3
6687_0,,,,2,2,1,3
C(C(C=O)(C(CO)O)C(CO)O)=O,,,4,1,2,6,8
6688_0,,,,2,2,1,3
6688_1,,,,2,2,1,3
6689_0,,,,2,2,1,3
6689_1,,,,2,2,1,3
6691_0,,,,2,2,1,3
C(C(CO)(C(C=O)O)O)(CCO)=O,,,4,1,11,19,30
6691_1,,,,2,2,1,3
6693_0,,,,2,2,1,3
C(C(C(C=O)=O)(CO)C(C)O)(O)=O,,,4,1,4,11,15
6695_0,,,,2,2,1,3
C(C(C(CO)(C(C)O)C(C)O)=O)=O,,,4,1,2,9,11
6697_0,,,,2,2,1,3
C(C(C(CO)(CO)C(C)O)=O)=O,,,4,1,3,12,15
6699_0,,,,2,2,1,3
C(C(C(C(C=O)=O)(CO)CO)O)=O,,,4,1,3,12,15
6701_0,,,,2,2,1,3
C(C(C(C=O)=O)(CO)CO)(O)=O,,,4,1,4,10,14
6702_0,,,,2,2,1,3
6703_0,,,,2,2,1,3
6705_0,,,,2,2,1,3
C(C(C(CO)(CO)CO)=O)=O,,,4,1,2,8,10
6707_0,,,,2,2,1,3
C(C(C(CO)(CO)C(CO)O)=O)=O,,,4,1,4,12,16
6708_0,,,,2,2,1,3
6709_0,,,,2,2,1,3
6709_1,,,,2,2,1,3
6711_0,,,,2,2,1,3
C(C(C=O)(C(C)O)C(C=O)O)(O)=O,,,4,1,5,12,17
6713_0,,,,2,2,1,3
C(C(C(C)O)(C(C)O)C(C=O)O)=O,,,4,1,3,10,13
6715_0,,,,2,2,1,3
C(C(CO)(C(C)O)C(C=O)O)=O,,,4,1,6,16,22
6717_0,,,,2,2,1,3
C(C(CO)(C(C=O)O)C(C=O)O)=O,,,4,1,5,10,15
6719_0,,,,2,2,1,3
C(C(C=O)(CO)C(C=O)O)(O)=O,,,4,1,7,14,21
6720_0,,,,2,2,1,3
6721_0,,,,2,2,1,3
6723_0,,,,2,2,1,3
C(C(CO)(CO)C(C=O)O)=O,,,4,1,5,13,18
6725_0,,,,2,2,1,3
C(C(CO)(C(CO)O)C(C=O)O)=O,,,4,1,7,16,23
6726_0,,,,2,2,1,3
6727_0,,,,2,2,1,3
6727_1,,,,2,2,1,3
6728_0,,,,2,2,1,3
6728_1,,,,2,2,1,3
6730_0,,,,2,2,1,3
C(C(C=O)(C(CO)=O)C(C)O)(O)=O,,,4,1,3,8,11
6732_0,,,,2,2,1,3
C(C(C(CO)=O)(C(C)O)C(C)O)=O,,,4,1,2,6,8
6734_0,,,,2,2,1,3
C(C(C(CO)=O)(CO)C(C)O)=O,,,4,1,4,9,13
6736_0,,,,2,2,1,3
C(CO)(C(C=O)(CO)C(C=O)O)=O,,,4,1,4,14,18
6738_0,,,,2,2,1,3
C(C(C=O)(C(CO)=O)CO)(O)=O,,,4,1,4,8,12
6739_0,,,,2,2,1,3
6740_0,,,,2,2,1,3
6742_0,,,,2,2,1,3
C(C(C(CO)=O)(CO)CO)=O,,,4,1,5,8,13
6744_0,,,,2,2,1,3
C(C(C(CO)=O)(CO)C(CO)O)=O,,,4,1,5,11,16
6745_0,,,,2,2,1,3
6747_0,,,,2,2,1,3
C(C(C(CC=O)=O)(C(C)O)O)(O)=O,,,4,1,4,11,15
6747_1,,,,2,2,1,3
6749_0,,,,2,2,1,3
C(CC(C(C(C)O)(C(C)O)O)=O)=O,,,4,1,2,8,10
6749_1,,,,2,2,1,3
6751_0,,,,2,2,1,3
C(CC(C(CO)(C(C)O)O)=O)=O,,,4,1,6,16,22
6751_1,,,,2,2,1,3
6752_0,,,,2,2,1,3
6752_1,,,,2,2,1,3
6754_0,,,,2,2,1,3
C(C(CO)(C(C=O)O)O)(CC=O)=O,,,4,1,8,22,30
6754_1,,,,2,2,1,3
6756_0,,,,2,2,1,3
C(C(C(CC=O)=O)(CO)O)(O)=O,,,4,1,6,13,19
6756_1,,,,2,2,1,3
6757_0,,,,2,2,1,3
6757_1,,,,2,2,1,3
6758_0,,,,2,2,1,3
6758_1,,,,2,2,1,3
6760_0,,,,2,2,1,3
C(CC(C(CO)(CO)O)=O)=O,,,4,1,7,12,19
6760_1,,,,2,2,1,3
6762_0,,,,2,2,1,3
C(CC(C(CO)(C(CO)O)O)=O)=O,,,4,1,7,16,23
6762_1,,,,2,2,1,3
6763_0,,,,2,2,1,3
6763_1,,,,2,2,1,3
6764_0,,,,2,2,1,3
6764_1,,,,2,2,1,3
6765_0,,,,2,2,1,3
6765_1,,,,2,2,1,3
6766_0,,,,2,2,1,3
6766_1,,,,2,2,1,3
6767_0,,,,2,2,1,3
6767_1,,,,2,2,1,3
6768_0,,,,2,2,1,3
6768_1,,,,2,2,1,3
6770_0,,,,2,2,1,3
C(C(C=O)(C(C)(CC=O)O)O)(O)=O,,,4,1,5,12,17
6770_1,,,,2,2,1,3
6771_0,,,,2,2,1,3
6771_1,,,,2,2,1,3
6772_0,,,,2,2,1,3
6772_1,,,,2,2,1,3
6773_0,,,,2,2,1,3
6773_1,,,,2,2,1,3
6775_0,,,,2,2,1,3
C(C(C=O)(C(CC(C)O)=O)O)(O)=O,,,4,1,3,8,11
6775_1,,,,2,2,1,3
6776_0,,,,2,2,1,3
6776_1,,,,2,2,1,3
6777_0,,,,2,2,1,3
6777_1,,,,2,2,1,3
6778_0,,,,2,2,1,3
6778_1,,,,2,2,1,3
6780_0,,,,2,2,1,3
C(C(C=O)(C(CCO)=O)O)(O)=O,,,4,1,4,9,13
6780_1,,,,2,2,1,3
6781_0,,,,2,2,1,3
6781_1,,,,2,2,1,3
6782_0,,,,2,2,1,3
6782_1,,,,2,2,1,3
6783_0,,,,2,2,1,3
6783_1,,,,2,2,1,3
6784_0,,,,2,2,1,3
6784_1,,,,2,2,1,3
6785_0,,,,2,2,1,3
6785_1,,,,2,2,1,3
6787_0,,,,2,2,1,3
C(C(C(C)O)(C(CC(C)O)O)O)=O,,,4,1,4,14,18
6787_1,,,,2,2,1,3
6789_0,,,,2,2,1,3
C(C(C=O)(C(CC(C)O)O)O)=O,,,4,1,2,10,12
6789_1,,,,2,2,1,3
6791_0,,,,2,2,1,3
C(C)(C(CO)(C(CC(C)O)O)O)=O,,,4,1,5,12,17
6791_1,,,,2,2,1,3
6793_0,,,,2,2,1,3
C1(COCC1(C(CC(C)O)O)O)=O,,,4,1,2,8,10
6793_1,,,,2,2,1,3
6795_0,,,,2,2,1,3
C1(C(C(CO1)O)C(CC(C)O)O)=O,,,4,1,1,8,9
6797_0,,,,2,2,1,3
C(C(CO)(C(CC(C)O)O)O)=O,,,4,1,6,14,20
6797_1,,,,2,2,1,3
6799_0,,,,2,2,1,3
C(C(CO)(C(CC(C)O)O)O)(O)=O,,,4,1,6,11,17
6799_1,,,,2,2,1,3
6801_0,,,,2,2,1,3
C(C(C(C)=O)(C(CC(C)O)O)O)=O,,,4,1,2,10,12
6801_1,,,,2,2,1,3
6803_0,,,,2,2,1,3
C(C(C(C=O)=O)(C(C)O)O)(O)=O,,,4,1,7,15,22
6803_1,,,,2,2,1,3
6805_0,,,,2,2,1,3
C(C(C(C(C=O)=O)(C(C)O)O)O)=O,,,4,1,4,20,24
6805_1,,,,2,2,1,3
6807_0,,,,2,2,1,3
C(C(C(C(C)O)(C(C)O)O)=O)=O,,,4,1,2,12,14
6807_1,,,,2,2,1,3
6808_0,,,,2,2,1,3
6808_1,,,,2,2,1,3
6810_0,,,,2,2,1,3
C(C(C(C(CO)O)(C(C)O)O)=O)=O,,,4,1,5,18,23
6810_1,,,,2,2,1,3
6812_0,,,,2,2,1,3
C(C(C(C)O)(C(CCO)O)O)=O,,,4,1,5,14,19
6812_1,,,,2,2,1,3
6814_0,,,,2,2,1,3
C(C(C(C(C=O)O)O)(C(C)O)O)=O,,,4,1,9,21,30
6814_1,,,,2,2,1,3
6816_0,,,,2,2,1,3
C(C(C(C)O)(C(CO)(C)O)O)=O,,,4,1,5,13,18
6816_1,,,,2,2,1,3
6818_0,,,,2,2,1,3
C(C(C)(C(C=O)(C(C)O)O)O)(O)=O,,,4,1,7,14,21
6818_1,,,,2,2,1,3
6820_0,,,,2,2,1,3
C(C(C(CC(O)=O)O)(C(C)O)O)=O,,,4,1,5,14,19
6820_1,,,,2,2,1,3
6822_0,,,,2,2,1,3
C(C(C=C)(C(C=O)(C(C)O)O)O)=O,,,4,1,5,13,18
6822_1,,,,2,2,1,3
6824_0,,,,2,2,1,3
C(C(C(C)O)(C(C(C=C)=O)O)O)=O,,,4,1,6,16,22
6824_1,,,,2,2,1,3
6826_0,,,,2,2,1,3
C(C(C(C)O)(C(C=CC=O)O)O)=O,,,4,1,4,12,16
6826_1,,,,2,2,1,3
6828_0,,,,2,2,1,3
C(C(C=O)(C(C)O)O)(O)=O,,,4,1,6,10,16
6828_1,,,,2,2,1,3
6830_0,,,,2,2,1,3
C(C(C(C(O)O)O)(C(C)O)O)=O,,,4,1,4,14,18
6830_1,,,,2,2,1,3
6832_0,,,,2,2,1,3
C(C(C(C)O)(C(C(C)O)O)O)=O,,,4,1,4,15,19
6832_1,,,,2,2,1,3
6833_0,,,,2,2,1,3
6833_1,,,,2,2,1,3
6834_0,,,,2,2,1,3
6834_1,,,,2,2,1,3
6835_0,,,,2,2,1,3
6835_1,,,,2,2,1,3
6836_0,,,,2,2,1,3
6836_1,,,,2,2,1,3
6837_0,,,,2,2,1,3
6837_1,,,,2,2,1,3
6838_0,,,,2,2,1,3
6838_1,,,,2,2,1,3
6839_0,,,,2,2,1,3
6839_1,,,,2,2,1,3
6841_0,,,,2,2,1,3
C(C(C(C)O)(C(C)O)O)=O,,,4,1,2,8,10
6841_1,,,,2,2,1,3
6842_0,,,,2,2,1,3
6842_1,,,,2,2,1,3
6843_0,,,,2,2,1,3
6843_1,,,,2,2,1,3
6844_0,,,,2,2,1,3
6844_1,,,,2,2,1,3
6845_0,,,,2,2,1,3
6845_1,,,,2,2,1,3
6847_0,,,,2,2,1,3
C(C(C=O)(C(C(C(C)O)O)O)O)=O,,,4,1,2,12,14
6847_1,,,,2,2,1,3
6849_0,,,,2,2,1,3
C(C(CO)(C(C(C(C)O)O)O)O)=O,,,4,1,8,16,24
6849_1,,,,2,2,1,3
6850_0,,,,2,2,1,3
6850_1,,,,2,2,1,3
6852_0,,,,2,2,1,3
C(C(C(C=O)=O)(C(CCO)O)O)=O,,,4,1,4,14,18
6852_1,,,,2,2,1,3
6854_0,,,,2,2,1,3
C(C(C(CO)=O)(C(CCO)O)O)=O,,,4,1,6,11,17
6854_1,,,,2,2,1,3
6856_0,,,,2,2,1,3
C(C(C=O)(C(CCO)O)O)=O,,,4,1,4,9,13
6856_1,,,,2,2,1,3
6858_0,,,,2,2,1,3
C(C)(C(CO)(C(CCO)O)O)=O,,,4,1,7,12,19
6858_1,,,,2,2,1,3
6860_0,,,,2,2,1,3
C(C(C(CCO)O)C(C=O)O)(O)=O,,,4,1,5,13,18
6862_0,,,,2,2,1,3
C(C(C(C)=O)(C(CCO)O)O)(O)=O,,,4,1,6,10,16
6862_1,,,,2,2,1,3
6864_0,,,,2,2,1,3
C(C(C(C)O)(C(CCO)O)O)(O)=O,,,4,1,7,11,18
6864_1,,,,2,2,1,3
6866_0,,,,2,2,1,3
C1(COCC1(C(CCO)O)O)=O,,,4,1,3,7,10
6866_1,,,,2,2,1,3
6868_0,,,,2,2,1,3
C1(C(C(CO1)O)C(CCO)O)=O,,,4,1,2,7,9
6870_0,,,,2,2,1,3
C1(C(O)OCC1(C(CCO)O)O)=O,,,4,1,4,9,13
6870_1,,,,2,2,1,3
6872_0,,,,2,2,1,3
C1(C(C(CO1)O)(C(CCO)O)O)=O,,,4,1,3,9,12
6872_1,,,,2,2,1,3
6873_0,,,,2,2,1,3
6873_1,,,,2,2,1,3
6874_0,,,,2,2,1,3
6874_1,,,,2,2,1,3
6875_0,,,,2,2,1,3
6875_1,,,,2,2,1,3
6876_0,,,,2,2,1,3
6876_1,,,,2,2,1,3
6877_0,,,,2,2,1,3
6877_1,,,,2,2,1,3
6878_0,,,,2,2,1,3
6878_1,,,,2,2,1,3
6879_0,,,,2,2,1,3
6879_1,,,,2,2,1,3
6881_0,,,,2,2,1,3
C(C(C=O)(C(CC(CO)O)O)O)=O,,,4,1,4,11,15
6881_1,,,,2,2,1,3
6882_0,,,,2,2,1,3
6882_1,,,,2,2,1,3
6884_0,,,,2,2,1,3
C(C(C=O)(C(C(C=O)=O)O)O)(O)=O,,,4,1,4,16,20
6884_1,,,,2,2,1,3
6885_0,,,,2,2,1,3
6885_1,,,,2,2,1,3
6886_0,,,,2,2,1,3
6886_1,,,,2,2,1,3
6888_0,,,,2,2,1,3
C(C(C(C=O)=O)(C(C=O)O)O)(O)=O,,,4,1,6,17,23
6888_1,,,,2,2,1,3
6889_0,,,,2,2,1,3
6889_1,,,,2,2,1,3
6890_0,,,,2,2,1,3
6890_1,,,,2,2,1,3
6891_0,,,,2,2,1,3
6891_1,,,,2,2,1,3
6892_0,,,,2,2,1,3
6892_1,,,,2,2,1,3
6893_0,,,,2,2,1,3
6893_1,,,,2,2,1,3
6895_0,,,,2,2,1,3
C(C(C(C=O)=O)(C(CO)(C)O)O)=O,,,4,1,4,13,17
6895_1,,,,2,2,1,3
6897_0,,,,2,2,1,3
C(C(C=O)(C(C=O)=O)O)(O)=O,,,4,1,4,11,15
6897_1,,,,2,2,1,3
6899_0,,,,2,2,1,3
C(C(C(C=O)=O)(C(C(O)O)O)O)=O,,,4,1,3,14,17
6899_1,,,,2,2,1,3
6901_0,,,,2,2,1,3
C(C(C(C=O)=O)(C(C(C)O)O)O)=O,,,4,1,3,15,18
6901_1,,,,2,2,1,3
6902_0,,,,2,2,1,3
6902_1,,,,2,2,1,3
6904_0,,,,2,2,1,3
C(C(C(C=O)=O)(C(C(O)=O)O)O)=O,,,4,1,6,15,21
6904_1,,,,2,2,1,3
6906_0,,,,2,2,1,3
C(C(C(C=O)=O)(C(C=O)(C)O)O)=O,,,4,1,4,12,16
6906_1,,,,2,2,1,3
6908_0,,,,2,2,1,3
C(C(C(C=O)=O)(C(C(C)=O)O)O)=O,,,4,1,5,15,20
6908_1,,,,2,2,1,3
6910_0,,,,2,2,1,3
C(C(C(C=O)=O)(C(CC=O)O)O)=O,,,4,1,3,15,18
6910_1,,,,2,2,1,3
6911_0,,,,2,2,1,3
6911_1,,,,2,2,1,3
6912_0,,,,2,2,1,3
6912_1,,,,2,2,1,3
6913_0,,,,2,2,1,3
6913_1,,,,2,2,1,3
6915_0,,,,2,2,1,3
C(C(C(CO)=O)(C(CO)(C)O)O)=O,,,4,1,5,10,15
6915_1,,,,2,2,1,3
6917_0,,,,2,2,1,3
C(C(C=O)(C(CO)=O)O)(O)=O,,,4,1,4,9,13
6917_1,,,,2,2,1,3
6919_0,,,,2,2,1,3
C(C(C(CO)=O)(C(C(O)O)O)O)=O,,,4,1,4,11,15
6919_1,,,,2,2,1,3
6921_0,,,,2,2,1,3
C(C(C(CO)=O)(C(C(C)O)O)O)=O,,,4,1,5,12,17
6921_1,,,,2,2,1,3
6922_0,,,,2,2,1,3
6922_1,,,,2,2,1,3
6923_0,,,,2,2,1,3
6923_1,,,,2,2,1,3
6924_0,,,,2,2,1,3
6924_1,,,,2,2,1,3
6925_0,,,,2,2,1,3
6925_1,,,,2,2,1,3
6926_0,,,,2,2,1,3
6926_1,,,,2,2,1,3
6927_0,,,,2,2,1,3
6927_1,,,,2,2,1,3
6928_0,,,,2,2,1,3
6928_1,,,,2,2,1,3
6929_0,,,,2,2,1,3
6929_1,,,,2,2,1,3
6931_0,,,,2,2,1,3
C(C(C(O)=O)(C(CO)=O)O)(O)=O,,,4,1,5,4,9
6931_1,,,,2,2,1,3
6932_0,,,,2,2,1,3
6932_1,,,,2,2,1,3
6933_0,,,,2,2,1,3
6933_1,,,,2,2,1,3
6934_0,,,,2,2,1,3
6934_1,,,,2,2,1,3
6935_0,,,,2,2,1,3
6935_1,,,,2,2,1,3
6937_0,,,,2,2,1,3
C(C(C=O)(C(C(C)=O)(CO)O)O)=O,,,4,1,7,13,20
6937_1,,,,2,2,1,3
6938_0,,,,2,2,1,3
6938_1,,,,2,2,1,3
6940_0,,,,2,2,1,3
C(C(C=O)(C(C(CO)=O)(C)O)O)=O,,,4,1,5,11,16
6940_1,,,,2,2,1,3
6941_0,,,,2,2,1,3
6941_1,,,,2,2,1,3
6943_0,,,,2,2,1,3
C(C(C=O)(C(C=O)(C(C)O)O)O)=O,,,4,1,7,14,21
6943_1,,,,2,2,1,3
6944_0,,,,2,2,1,3
6944_1,,,,2,2,1,3
6946_0,,,,2,2,1,3
C(C(C=O)(C(C(C(C)O)=O)O)O)=O,,,4,1,6,12,18
6946_1,,,,2,2,1,3
6947_0,,,,2,2,1,3
6947_1,,,,2,2,1,3
6949_0,,,,2,2,1,3
C(C(C=O)(C(C(C=O)O)O)O)=O,,,4,1,3,18,21
6949_1,,,,2,2,1,3
6951_0,,,,2,2,1,3
C(C(C=O)(C(CO)(C)O)O)=O,,,4,1,3,8,11
6951_1,,,,2,2,1,3
6953_0,,,,2,2,1,3
C(C(C=O)(C(CO)(CCO)O)O)=O,,,4,1,4,9,13
6953_1,,,,2,2,1,3
6955_0,,,,2,2,1,3
C(C(C=O)(C(C(CCO)O)O)O)=O,,,4,1,4,11,15
6955_1,,,,2,2,1,3
6957_0,,,,2,2,1,3
C(C(C=O)(C(C)(C(CO)O)O)O)=O,,,4,1,3,10,13
6957_1,,,,2,2,1,3
6959_0,,,,2,2,1,3
C(C(C=O)(C(C(O)=O)(C)O)O)=O,,,4,1,4,9,13
6959_1,,,,2,2,1,3
6961_0,,,,2,2,1,3
C(C(C=O)(C(CC(O)=O)O)O)=O,,,4,1,3,9,12
6961_1,,,,2,2,1,3
6963_0,,,,2,2,1,3
C(C(C=O)(C(C(O)=O)(CO)O)O)=O,,,4,1,7,12,19
6963_1,,,,2,2,1,3
6965_0,,,,2,2,1,3
C(C(C=O)(C(C=O)(CC=O)O)O)=O,,,4,1,3,11,14
6965_1,,,,2,2,1,3
6967_0,,,,2,2,1,3
C(C(C=O)(C(C(CC=O)=O)O)O)=O,,,4,1,4,13,17
6967_1,,,,2,2,1,3
6969_0,,,,2,2,1,3
C(C(C=O)(C(CC(C=O)=O)O)O)=O,,,4,1,3,12,15
6969_1,,,,2,2,1,3
6971_0,,,,2,2,1,3
C(C(C=O)(C1(COCC1O)O)O)=O,,,4,1,2,6,8
6971_1,,,,2,2,1,3
6973_0,,,,2,2,1,3
C(C(C=O)(C1(C(O)OCC1)O)O)=O,,,4,1,3,8,11
6973_1,,,,2,2,1,3
6975_0,,,,2,2,1,3
C(C(C=O)(C1(COC(C1)O)O)O)=O,,,4,1,3,8,11
6975_1,,,,2,2,1,3
6977_0,,,,2,2,1,3
C(C(C=O)(C(C=O)(C(C)=O)O)O)=O,,,4,1,4,9,13
6977_1,,,,2,2,1,3
6979_0,,,,2,2,1,3
C(C(C=O)(C(C(C(C)=O)=O)O)O)=O,,,4,1,4,11,15
6979_1,,,,2,2,1,3
6981_0,,,,2,2,1,3
C(C(C=O)(C(C(C=O)=O)(C)O)O)=O,,,4,1,4,11,15
6981_1,,,,2,2,1,3
6983_0,,,,2,2,1,3
C(C(C=O)(C(C=O)(C=C)O)O)=O,,,4,1,5,11,16
6983_1,,,,2,2,1,3
6985_0,,,,2,2,1,3
C(C(C=O)(C(C(C=C)=O)O)O)=O,,,4,1,6,11,17
6985_1,,,,2,2,1,3
6987_0,,,,2,2,1,3
C(C(C=O)(C(C=CC=O)O)O)=O,,,4,1,4,10,14
6987_1,,,,2,2,1,3
6989_0,,,,2,2,1,3
C(C(C=O)(C=O)O)(O)=O,,,4,1,6,7,13
6989_1,,,,2,2,1,3
6991_0,,,,2,2,1,3
C(C(C=O)(C(C(O)O)O)O)=O,,,4,1,2,9,11
6991_1,,,,2,2,1,3
6993_0,,,,2,2,1,3
C(C(C=O)(C(C(C)O)O)O)=O,,,4,1,3,10,13
6993_1,,,,2,2,1,3
6995_0,,,,2,2,1,3
C(C(C=O)(C(C(CO)O)O)O)=O,,,4,1,6,12,18
6995_1,,,,2,2,1,3
6996_0,,,,2,2,1,3
6996_1,,,,2,2,1,3
6998_0,,,,2,2,1,3
C(C(C=O)(C(CO)(CO)O)O)=O,,,4,1,3,7,10
6998_1,,,,2,2,1,3
7000_0,,,,2,2,1,3
C(C(C=O)(C(C(O)=O)O)O)=O,,,4,1,8,12,20
7000_1,,,,2,2,1,3
7002_0,,,,2,2,1,3
C(C(C=O)(C(C=O)(C)O)O)=O,,,4,1,3,10,13
7002_1,,,,2,2,1,3
7004_0,,,,2,2,1,3
C(C(C=O)(C(C(C)=O)O)O)=O,,,4,1,10,14,24
7004_1,,,,2,2,1,3
7006_0,,,,2,2,1,3
C(C(C=O)(C(CC=O)O)O)=O,,,4,1,5,14,19
7006_1,,,,2,2,1,3
7008_0,,,,2,2,1,3
C(C(C=O)(C(C=O)(CCO)O)O)=O,,,4,1,6,11,17
7008_1,,,,2,2,1,3
7010_0,,,,2,2,1,3
C(C(C=O)(C(C(CCO)=O)O)O)=O,,,4,1,7,13,20
7010_1,,,,2,2,1,3
7012_0,,,,2,2,1,3
C(C(C=O)(C(C(CC=O)O)O)O)=O,,,4,1,6,15,21
7012_1,,,,2,2,1,3
7014_0,,,,2,2,1,3
C(C(C=O)(C(CC(C=O)O)O)O)=O,,,4,1,6,14,20
7014_1,,,,2,2,1,3
7016_0,,,,2,2,1,3
C(C(C=O)(C(CC(CO)=O)O)O)=O,,,4,1,4,12,16
7016_1,,,,2,2,1,3
7018_0,,,,2,2,1,3
C(C(C=O)(C(CO)(CC=O)O)O)=O,,,4,1,5,11,16
7018_1,,,,2,2,1,3
7020_0,,,,2,2,1,3
C(C(C=O)(C(C(C(C)=O)O)O)O)=O,,,4,1,3,13,16
7020_1,,,,2,2,1,3
7022_0,,,,2,2,1,3
C(C(C=O)(C(C)(C(C=O)O)O)O)=O,,,4,1,6,13,19
7022_1,,,,2,2,1,3
7024_0,,,,2,2,1,3
C(C(C=O)(C(C)O)O)=O,,,4,1,8,12,20
7024_1,,,,2,2,1,3
7026_0,,,,2,2,1,3
C(C(C=O)(C(C=O)(CO)O)O)=O,,,4,1,6,15,21
7026_1,,,,2,2,1,3
7028_0,,,,2,2,1,3
C(C(C=O)(C(C(CO)=O)O)O)=O,,,4,1,7,13,20
7028_1,,,,2,2,1,3
7029_0,,,,2,2,1,3
7029_1,,,,2,2,1,3
7030_0,,,,2,2,1,3
7030_1,,,,2,2,1,3
7031_0,,,,2,2,1,3
7031_1,,,,2,2,1,3
7033_0,,,,2,2,1,3
C(C(C(C1(C(COC1)=O)O)O)O)=O,,,4,1,5,16,21
7033_1,,,,2,2,1,3
7035_0,,,,2,2,1,3
C1(C(C(C(C=O)O)O)C(CO1)O)=O,,,4,1,2,14,16
7036_0,,,,2,2,1,3
7036_1,,,,2,2,1,3
7037_0,,,,2,2,1,3
7037_1,,,,2,2,1,3
7038_0,,,,2,2,1,3
7038_1,,,,2,2,1,3
7040_0,,,,2,2,1,3
C(C)(C(CO)(C(CO)(C)O)O)=O,,,4,1,6,11,17
7040_1,,,,2,2,1,3
7042_0,,,,2,2,1,3
C(C(C(CO)(C)O)C(C=O)O)(O)=O,,,4,1,5,13,18
7044_0,,,,2,2,1,3
C(C(C(C)=O)(C(CO)(C)O)O)(O)=O,,,4,1,6,9,15
7044_1,,,,2,2,1,3
7046_0,,,,2,2,1,3
C(C(C(C)O)(C(CO)(C)O)O)(O)=O,,,4,1,7,10,17
7046_1,,,,2,2,1,3
7048_0,,,,2,2,1,3
C1(COCC1(C(CO)(C)O)O)=O,,,4,1,3,6,9
7048_1,,,,2,2,1,3
7050_0,,,,2,2,1,3
C1(C(C(CO1)O)C(C)(CO)O)=O,,,4,1,2,7,9
7052_0,,,,2,2,1,3
C1(C(O)OCC1(C(CO)(C)O)O)=O,,,4,1,4,8,12
7052_1,,,,2,2,1,3
7054_0,,,,2,2,1,3
C1(C(C(CO1)O)(C(CO)(C)O)O)=O,,,4,1,3,8,11
7054_1,,,,2,2,1,3
7055_0,,,,2,2,1,3
7055_1,,,,2,2,1,3
7056_0,,,,2,2,1,3
7056_1,,,,2,2,1,3
7057_0,,,,2,2,1,3
7057_1,,,,2,2,1,3
7058_0,,,,2,2,1,3
7058_1,,,,2,2,1,3
7059_0,,,,2,2,1,3
7059_1,,,,2,2,1,3
7060_0,,,,2,2,1,3
7060_1,,,,2,2,1,3
7061_0,,,,2,2,1,3
7061_1,,,,2,2,1,3
7062_0,,,,2,2,1,3
7062_1,,,,2,2,1,3
7063_0,,,,2,2,1,3
7063_1,,,,2,2,1,3
7065_0,,,,2,2,1,3
C(C(C)(C(C(C)=O)(CO)O)O)(O)=O,,,4,1,7,12,19
7065_1,,,,2,2,1,3
7067_0,,,,2,2,1,3
C(CC(C(C(C)=O)(CO)O)O)(O)=O,,,4,1,6,12,18
7067_1,,,,2,2,1,3
7069_0,,,,2,2,1,3
C(C(C=C)(C(C(C)=O)(CO)O)O)=O,,,4,1,6,12,18
7069_1,,,,2,2,1,3
7071_0,,,,2,2,1,3
C(C)(C(CO)(C(C(C=C)=O)O)O)=O,,,4,1,7,15,22
7071_1,,,,2,2,1,3
7073_0,,,,2,2,1,3
C(C)(C(CO)(C(C=CC=O)O)O)=O,,,4,1,5,11,16
7073_1,,,,2,2,1,3
7074_0,,,,2,2,1,3
7074_1,,,,2,2,1,3
7076_0,,,,2,2,1,3
C(C)(C(CO)(C(C(O)O)O)O)=O,,,4,1,5,12,17
7076_1,,,,2,2,1,3
7078_0,,,,2,2,1,3
C(C)(C(CO)(C(C(C)O)O)O)=O,,,4,1,5,13,18
7078_1,,,,2,2,1,3
7079_0,,,,2,2,1,3
7079_1,,,,2,2,1,3
7080_0,,,,2,2,1,3
7080_1,,,,2,2,1,3
7081_0,,,,2,2,1,3
7081_1,,,,2,2,1,3
7082_0,,,,2,2,1,3
7082_1,,,,2,2,1,3
7083_0,,,,2,2,1,3
7083_1,,,,2,2,1,3
7084_0,,,,2,2,1,3
7084_1,,,,2,2,1,3
7085_0,,,,2,2,1,3
7085_1,,,,2,2,1,3
7086_0,,,,2,2,1,3
7086_1,,,,2,2,1,3
7087_0,,,,2,2,1,3
7087_1,,,,2,2,1,3
7088_0,,,,2,2,1,3
7088_1,,,,2,2,1,3
7089_0,,,,2,2,1,3
7089_1,,,,2,2,1,3
7090_0,,,,2,2,1,3
7090_1,,,,2,2,1,3
7091_0,,,,2,2,1,3
7091_1,,,,2,2,1,3
7092_0,,,,2,2,1,3
7092_1,,,,2,2,1,3
7093_0,,,,2,2,1,3
7093_1,,,,2,2,1,3
7095_0,,,,2,2,1,3
C(C(C(O)=O)(C(C(O)=O)O)O)(O)=O,,,4,1,9,8,17
7095_1,,,,2,2,1,3
7096_0,,,,2,2,1,3
7096_1,,,,2,2,1,3
7097_0,,,,2,2,1,3
7097_1,,,,2,2,1,3
7099_0,,,,2,2,1,3
C(C(C)(C1(C(COC1)=O)O)O)(O)=O,,,4,1,3,7,10
7099_1,,,,2,2,1,3
7101_0,,,,2,2,1,3
C1(C(C(CO1)O)C(C(O)=O)(C)O)=O,,,4,1,2,8,10
7102_0,,,,2,2,1,3
7102_1,,,,2,2,1,3
7103_0,,,,2,2,1,3
7103_1,,,,2,2,1,3
7104_0,,,,2,2,1,3
7104_1,,,,2,2,1,3
7106_0,,,,2,2,1,3
C(CC(C1(C(COC1)=O)O)O)(O)=O,,,4,1,3,7,10
7106_1,,,,2,2,1,3
7108_0,,,,2,2,1,3
C1(C(C(CC(O)=O)O)C(CO1)O)=O,,,4,1,2,7,9
7109_0,,,,2,2,1,3
7109_1,,,,2,2,1,3
7110_0,,,,2,2,1,3
7110_1,,,,2,2,1,3
7111_0,,,,2,2,1,3
7111_1,,,,2,2,1,3
7113_0,,,,2,2,1,3
C(C(C(O)=O)C(C=O)O)(O)=O,,,4,1,5,11,16
7115_0,,,,2,2,1,3
C(C(C(C(O)O)O)C(C=O)O)(O)=O,,,4,1,4,13,17
7117_0,,,,2,2,1,3
C(C(C(C(C)O)O)C(C=O)O)(O)=O,,,4,1,4,14,18
7118_0,,,,2,2,1,3
7119_0,,,,2,2,1,3
7120_0,,,,2,2,1,3
7121_0,,,,2,2,1,3
7122_0,,,,2,2,1,3
7123_0,,,,2,2,1,3
7124_0,,,,2,2,1,3
7125_0,,,,2,2,1,3
7127_0,,,,2,2,1,3
C(C(C(O)=O)(C(C)=O)O)(O)=O,,,4,1,5,4,9
7127_1,,,,2,2,1,3
7129_0,,,,2,2,1,3
C(C(C(C)=O)(C(C(O)O)O)O)(O)=O,,,4,1,5,10,15
7129_1,,,,2,2,1,3
7131_0,,,,2,2,1,3
C(C(C(C)=O)(C(C(C)O)O)O)(O)=O,,,4,1,5,11,16
7131_1,,,,2,2,1,3
7132_0,,,,2,2,1,3
7132_1,,,,2,2,1,3
7133_0,,,,2,2,1,3
7133_1,,,,2,2,1,3
7134_0,,,,2,2,1,3
7134_1,,,,2,2,1,3
7135_0,,,,2,2,1,3
7135_1,,,,2,2,1,3
7136_0,,,,2,2,1,3
7136_1,,,,2,2,1,3
7137_0,,,,2,2,1,3
7137_1,,,,2,2,1,3
7138_0,,,,2,2,1,3
7138_1,,,,2,2,1,3
7139_0,,,,2,2,1,3
7139_1,,,,2,2,1,3
7140_0,,,,2,2,1,3
7140_1,,,,2,2,1,3
7142_0,,,,2,2,1,3
C(C(C(C(O)=O)=O)(CO)O)(O)=O,,,4,1,9,11,20
7142_1,,,,2,2,1,3
7143_0,,,,2,2,1,3
7143_1,,,,2,2,1,3
7144_0,,,,2,2,1,3
7144_1,,,,2,2,1,3
7145_0,,,,2,2,1,3
7145_1,,,,2,2,1,3
7146_0,,,,2,2,1,3
7146_1,,,,2,2,1,3
7147_0,,,,2,2,1,3
7147_1,,,,2,2,1,3
7148_0,,,,2,2,1,3
7148_1,,,,2,2,1,3
7149_0,,,,2,2,1,3
7149_1,,,,2,2,1,3
7150_0,,,,2,2,1,3
7150_1,,,,2,2,1,3
7151_0,,,,2,2,1,3
7151_1,,,,2,2,1,3
7153_0,,,,2,2,1,3
C(C(C(O)=O)(C(C=O)(C)O)O)(O)=O,,,4,1,5,8,13
7153_1,,,,2,2,1,3
7155_0,,,,2,2,1,3
C(C(C(C)O)(C(C=O)(C)O)O)(O)=O,,,4,1,7,13,20
7155_1,,,,2,2,1,3
7156_0,,,,2,2,1,3
7156_1,,,,2,2,1,3
7157_0,,,,2,2,1,3
7157_1,,,,2,2,1,3
7159_0,,,,2,2,1,3
C(C(C(O)=O)(C(C(C)=O)O)O)(O)=O,,,4,1,5,8,13
7159_1,,,,2,2,1,3
7161_0,,,,2,2,1,3
C(C(C(C)O)(C(C(C)=O)O)O)(O)=O,,,4,1,8,13,21
7161_1,,,,2,2,1,3
7162_0,,,,2,2,1,3
7162_1,,,,2,2,1,3
7163_0,,,,2,2,1,3
7163_1,,,,2,2,1,3
7165_0,,,,2,2,1,3
C(C)(C(C(C)O)(C(C(O)=O)O)O)=O,,,4,1,7,14,21
7165_1,,,,2,2,1,3
7166_0,,,,2,2,1,3
7166_1,,,,2,2,1,3
7168_0,,,,2,2,1,3
C(C(C(O)=O)(C(CC=O)O)O)(O)=O,,,4,1,5,9,14
7168_1,,,,2,2,1,3
7170_0,,,,2,2,1,3
C(C(C(CC=O)O)(C(C)O)O)(O)=O,,,4,1,7,14,21
7170_1,,,,2,2,1,3
7171_0,,,,2,2,1,3
7171_1,,,,2,2,1,3
7172_0,,,,2,2,1,3
7172_1,,,,2,2,1,3
7174_0,,,,2,2,1,3
C(C(C(O)=O)(C(C)O)O)(O)=O,,,4,1,6,5,11
7174_1,,,,2,2,1,3
7176_0,,,,2,2,1,3
C(C(C(C(O)O)O)(C(C)O)O)(O)=O,,,4,1,6,11,17
7176_1,,,,2,2,1,3
7178_0,,,,2,2,1,3
C(C(C(C)O)(C(C(C)O)O)O)(O)=O,,,4,1,6,12,18
7178_1,,,,2,2,1,3
7179_0,,,,2,2,1,3
7179_1,,,,2,2,1,3
7180_0,,,,2,2,1,3
7180_1,,,,2,2,1,3
7181_0,,,,2,2,1,3
7181_1,,,,2,2,1,3
7182_0,,,,2,2,1,3
7182_1,,,,2,2,1,3
7183_0,,,,2,2,1,3
7183_1,,,,2,2,1,3
7185_0,,,,2,2,1,3
C(C(C(C)O)(C(C)O)O)(O)=O,,,4,1,4,5,9
7185_1,,,,2,2,1,3
7186_0,,,,2,2,1,3
7186_1,,,,2,2,1,3
7187_0,,,,2,2,1,3
7187_1,,,,2,2,1,3
7189_0,,,,2,2,1,3
C(C(C=O)(C(C(O)=O)(C)O)O)(O)=O,,,4,1,6,11,17
7189_1,,,,2,2,1,3
7190_0,,,,2,2,1,3
7190_1,,,,2,2,1,3
7191_0,,,,2,2,1,3
7191_1,,,,2,2,1,3
7193_0,,,,2,2,1,3
C(CC(C=O)O)(C(CO)(CO)O)=O,,,4,1,5,11,16
7193_1,,,,2,2,1,3
7194_0,,,,2,2,1,3
7194_1,,,,2,2,1,3
7195_0,,,,2,2,1,3
7195_1,,,,2,2,1,3
7197_0,,,,2,2,1,3
C(C(CO)(C(CC(C=O)=O)O)O)=O,,,4,1,8,18,26
7197_1,,,,2,2,1,3
7199_0,,,,2,2,1,3
C(C(C(C(CO)(CO)O)=O)CO)=O,,,4,1,4,10,14
7199_1,,,,2,2,1,3
7201_0,,,,2,2,1,3
C(C(C(C(CO)O)=O)(CO)CO)=O,,,4,1,3,10,13
7203_0,,,,2,2,1,3
C(C(C=O)(C(C=O)=O)CO)(O)=O,,,4,1,3,12,15
7205_0,,,,2,2,1,3
C(C(C(C=O)=O)(CO)C(C=O)O)=O,,,4,1,3,13,16
7207_0,,,,2,2,1,3
C(C(C(C=O)=O)(CO)C(C)O)=O,,,4,1,3,14,17
7209_0,,,,2,2,1,3
C(C(C(C=O)=O)(CO)CO)=O,,,4,1,2,10,12
7211_0,,,,2,2,1,3
C(C(C(C=O)=O)(CO)C(CO)O)=O,,,4,1,4,14,18
7212_0,,,,2,2,1,3
7214_0,,,,2,2,1,3
C(C(C(CC(O)=O)=O)(CO)O)(O)=O,,,4,1,7,11,18
7214_1,,,,2,2,1,3
7216_0,,,,2,2,1,3
C(CC(C(CO)(C(C)O)O)=O)(O)=O,,,4,1,7,14,21
7216_1,,,,2,2,1,3
7218_0,,,,2,2,1,3
C(CC(C(CO)(CO)O)=O)(O)=O,,,4,1,6,9,15
7218_1,,,,2,2,1,3
7220_0,,,,2,2,1,3
C(C(C(O)=O)(C(CCO)=O)O)(O)=O,,,4,1,4,5,9
7220_1,,,,2,2,1,3
7222_0,,,,2,2,1,3
C(C(C(CCO)=O)(C(C)O)O)(O)=O,,,4,1,7,10,17
7222_1,,,,2,2,1,3
7223_0,,,,2,2,1,3
7223_1,,,,2,2,1,3
7225_0,,,,2,2,1,3
C(C(C=C)(C1(C(COC1)=O)O)O)=O,,,4,1,2,8,10
7225_1,,,,2,2,1,3
7227_0,,,,2,2,1,3
C1(COCC1(C(C(C=C)=O)O)O)=O,,,4,1,2,11,13
7227_1,,,,2,2,1,3
7229_0,,,,2,2,1,3
C1(COCC1(C(C=CC=O)O)O)=O,,,4,1,2,8,10
7229_1,,,,2,2,1,3
7231_0,,,,2,2,1,3
C(C1(C(COC1)=O)O)(O)=O,,,4,1,4,9,13
7231_1,,,,2,2,1,3
7233_0,,,,2,2,1,3
C1(COCC1(C(C(O)O)O)O)=O,,,4,1,2,7,9
7233_1,,,,2,2,1,3
7235_0,,,,2,2,1,3
C1(COCC1(C(C(C)O)O)O)=O,,,4,1,2,8,10
7235_1,,,,2,2,1,3
7237_0,,,,2,2,1,3
C1(COCC1(C(C(CO)O)O)O)=O,,,4,1,5,10,15
7237_1,,,,2,2,1,3
7239_0,,,,2,2,1,3
C1(COCC1(C(C=O)O)O)=O,,,4,1,5,17,22
7239_1,,,,2,2,1,3
7241_0,,,,2,2,1,3
C1(COCC1(C(CO)(CO)O)O)=O,,,4,1,3,5,8
7241_1,,,,2,2,1,3
7243_0,,,,2,2,1,3
C1(COCC1(C(C(O)=O)O)O)=O,,,4,1,4,8,12
7243_1,,,,2,2,1,3
7245_0,,,,2,2,1,3
C(C(C)(C1(C(COC1)=O)O)O)=O,,,4,1,2,10,12
7245_1,,,,2,2,1,3
7247_0,,,,2,2,1,3
C1(COCC1(C(C(C)=O)O)O)=O,,,4,1,3,11,14
7247_1,,,,2,2,1,3
7249_0,,,,2,2,1,3
C(CC(C1(C(COC1)=O)O)O)=O,,,4,1,5,12,17
7249_1,,,,2,2,1,3
7251_0,,,,2,2,1,3
C1(COCC1(C(C)O)O)=O,,,4,1,2,12,14
7251_1,,,,2,2,1,3
7253_0,,,,2,2,1,3
C(C(CO)(C1(C(COC1)=O)O)O)=O,,,4,1,4,14,18
7253_1,,,,2,2,1,3
7255_0,,,,2,2,1,3
C1(COCC1(C(C(CO)=O)O)O)=O,,,4,1,3,13,16
7255_1,,,,2,2,1,3
7257_0,,,,2,2,1,3
C1(COCC1(CO)O)=O,,,4,1,4,22,26
7257_1,,,,2,2,1,3
7259_0,,,,2,2,1,3
C1(COCC1(C(CO)O)O)=O,,,4,1,4,9,13
7259_1,,,,2,2,1,3
7261_0,,,,2,2,1,3
C(C(CO)(C1(COCC1O)O)O)=O,,,4,1,6,10,16
7261_1,,,,2,2,1,3
7263_0,,,,2,2,1,3
C(C(CO)(C1(C(O)OCC1)O)O)=O,,,4,1,7,12,19
7263_1,,,,2,2,1,3
7265_0,,,,2,2,1,3
C(C(C=C)(C1C(OCC1O)=O)O)=O,,,4,1,1,6,7
7267_0,,,,2,2,1,3
C1(C(C(CO1)O)C(C(C=C)=O)O)=O,,,4,1,1,9,10
7269_0,,,,2,2,1,3
C1(C(C(CO1)O)C(C=CC=O)O)=O,,,4,1,1,7,8
7271_0,,,,2,2,1,3
C1(C(C(O)=O)C(CO1)O)=O,,,4,1,1,6,7
7273_0,,,,2,2,1,3
C1(C(C(C(O)O)O)C(CO1)O)=O,,,4,1,1,7,8
7275_0,,,,2,2,1,3
C1(C(C(CO1)O)C(C(C)O)O)=O,,,4,1,1,8,9
7277_0,,,,2,2,1,3
C1(C(C(CO1)O)C(C(CO)O)O)=O,,,4,1,4,10,14
7279_0,,,,2,2,1,3
C1(C(C(CO1)O)C(C=O)O)=O,,,4,1,5,12,17
7281_0,,,,2,2,1,3
C1(C(C(CO1)O)C(CO)(CO)O)=O,,,4,1,2,6,8
7283_0,,,,2,2,1,3
C1(C(C(CO1)O)C(C(O)=O)O)=O,,,4,1,5,8,13
7285_0,,,,2,2,1,3
C1(C(C(CO1)O)C(C=O)(C)O)=O,,,4,1,2,8,10
7287_0,,,,2,2,1,3
C1(C(C(CO1)O)C(C(C)=O)O)=O,,,4,1,3,7,10
7289_0,,,,2,2,1,3
C1(C(C(CC=O)O)C(CO1)O)=O,,,4,1,3,10,13
7291_0,,,,2,2,1,3
C1(C(C(C)O)C(CO1)O)=O,,,4,1,2,8,10
7293_0,,,,2,2,1,3
C1(C(C(CO1)O)C(C=O)(CO)O)=O,,,4,1,2,10,12
7295_0,,,,2,2,1,3
C1(C(C(CO1)O)C(C(CO)=O)O)=O,,,4,1,2,8,10
7297_0,,,,2,2,1,3
C1(C(CO)C(CO1)O)=O,,,4,1,2,14,16
7299_0,,,,2,2,1,3
C1(C(C(CO)O)C(CO1)O)=O,,,4,1,4,8,12
7301_0,,,,2,2,1,3
C(C(CO)(C1(COC(C1)O)O)O)=O,,,4,1,7,12,19
7301_1,,,,2,2,1,3
7302_0,,,,2,2,1,3
7302_1,,,,2,2,1,3
7303_0,,,,2,2,1,3
7303_1,,,,2,2,1,3
7305_0,,,,2,2,1,3
C(C(CO)(C(C(C=O)=O)(C)O)O)=O,,,4,1,9,17,26
7305_1,,,,2,2,1,3
7307_0,,,,2,2,1,3
C(C(C=C)(C(C=O)(CO)O)O)=O,,,4,1,9,16,25
7307_1,,,,2,2,1,3
7309_0,,,,2,2,1,3
C(C(C=C)(C(C(O)=O)(CO)O)O)=O,,,4,1,7,11,18
7309_1,,,,2,2,1,3
7311_0,,,,2,2,1,3
C(C(C=C)(C(C=O)(C(C)=O)O)O)=O,,,4,1,3,8,11
7311_1,,,,2,2,1,3
7313_0,,,,2,2,1,3
C(C(CO)(C(C(C=C)=O)O)O)=O,,,4,1,10,17,27
7313_1,,,,2,2,1,3
7315_0,,,,2,2,1,3
C(C(CO)(C(C(C=C)=O)O)O)(O)=O,,,4,1,8,13,21
7315_1,,,,2,2,1,3
7317_0,,,,2,2,1,3
C(C(C(C)=O)(C(C(C=C)=O)O)O)=O,,,4,1,4,10,14
7317_1,,,,2,2,1,3
7319_0,,,,2,2,1,3
C(C(CO)(C(C=CC=O)O)O)=O,,,4,1,8,14,22
7319_1,,,,2,2,1,3
7321_0,,,,2,2,1,3
C(C(CO)(C(C=CC=O)O)O)(O)=O,,,4,1,6,8,14
7321_1,,,,2,2,1,3
7323_0,,,,2,2,1,3
C(C(C(C)=O)(C(C=CC=O)O)O)=O,,,4,1,2,8,10
7323_1,,,,2,2,1,3
7325_0,,,,2,2,1,3
C1(C(C(O)=O)(C(C(O)O1)O)O)=O,,,4,1,3,8,11
7325_1,,,,2,2,1,3
7327_0,,,,2,2,1,3
C1(C(C(C(O)O1)O)(C(C=O)O)O)=O,,,4,1,5,16,21
7327_1,,,,2,2,1,3
7329_0,,,,2,2,1,3
C1(C(C(C)O)(C(C(O)O1)O)O)=O,,,4,1,4,10,14
7329_1,,,,2,2,1,3
7331_0,,,,2,2,1,3
C1(C(CO)(C(C(O)O1)O)O)=O,,,4,1,4,9,13
7331_1,,,,2,2,1,3
7333_0,,,,2,2,1,3
C1(C(C(CO)O)(C(C(O)O1)O)O)=O,,,4,1,5,11,16
7333_1,,,,2,2,1,3
7335_0,,,,2,2,1,3
C(C1(C(C(O)OC1)=O)O)(O)=O,,,4,1,4,6,10
7335_1,,,,2,2,1,3
7337_0,,,,2,2,1,3
C1(C(O)OCC1(C(C(O)O)O)O)=O,,,4,1,3,9,12
7337_1,,,,2,2,1,3
7339_0,,,,2,2,1,3
C1(C(O)OCC1(C(C(C)O)O)O)=O,,,4,1,3,10,13
7339_1,,,,2,2,1,3
7341_0,,,,2,2,1,3
C1(C(O)OCC1(C(C=O)O)O)=O,,,4,1,3,15,18
7341_1,,,,2,2,1,3
7343_0,,,,2,2,1,3
C1(C(O)OCC1(C(C(O)=O)O)O)=O,,,4,1,5,11,16
7343_1,,,,2,2,1,3
7345_0,,,,2,2,1,3
C(C(C)(C1(C(C(O)OC1)=O)O)O)=O,,,4,1,3,11,14
7345_1,,,,2,2,1,3
7347_0,,,,2,2,1,3
C(C(C1(C(C(O)OC1)=O)O)O)(C)=O,,,4,1,3,12,15
7347_1,,,,2,2,1,3
7349_0,,,,2,2,1,3
C(CC(C1(C(C(O)OC1)=O)O)O)=O,,,4,1,4,12,16
7349_1,,,,2,2,1,3
7351_0,,,,2,2,1,3
C1(C(O)OCC1(C(C)O)O)=O,,,4,1,3,8,11
7351_1,,,,2,2,1,3
7353_0,,,,2,2,1,3
C1(C(O)OCC1(CO)O)=O,,,4,1,6,10,16
7353_1,,,,2,2,1,3
7355_0,,,,2,2,1,3
C1(C(O)OCC1(C(CO)O)O)=O,,,4,1,4,9,13
7355_1,,,,2,2,1,3
7357_0,,,,2,2,1,3
C1(C(C(O)=O)(C(CO1)O)O)=O,,,4,1,3,4,7
7357_1,,,,2,2,1,3
7359_0,,,,2,2,1,3
C1(C(C(O)=O)(C(C(CO)O1)O)O)=O,,,4,1,3,5,8
7359_1,,,,2,2,1,3
7361_0,,,,2,2,1,3
C1(C(C(O)=O)(C(C(CO1)O)O)O)=O,,,4,1,2,8,10
7361_1,,,,2,2,1,3
7363_0,,,,2,2,1,3
C(C(C=O)(C(C(O)=O)=O)O)(O)=O,,,4,1,4,9,13
7363_1,,,,2,2,1,3
7365_0,,,,2,2,1,3
C(C(C(O)=O)C(C(O)=O)O)(O)=O,,,4,1,7,6,13
7367_0,,,,2,2,1,3
C(C(C(O)=O)(C(C=O)=O)O)(O)=O,,,4,1,5,9,14
7367_1,,,,2,2,1,3
7368_0,,,,2,2,1,3
7368_1,,,,2,2,1,3
7370_0,,,,2,2,1,3
C(C(C=O)(C(CO)O)O)(O)=O,,,4,1,9,12,21
7370_1,,,,2,2,1,3
7372_0,,,,2,2,1,3
C(C(C=O)(C(C(CO)O)O)O)(O)=O,,,4,1,10,15,25
7372_1,,,,2,2,1,3
7374_0,,,,2,2,1,3
C(C(C=O)(C(C=O)O)O)(O)=O,,,4,1,11,18,29
7374_1,,,,2,2,1,3
7375_0,,,,2,2,1,3
7375_1,,,,2,2,1,3
7377_0,,,,2,2,1,3
C(C(C(O)=O)(CO)O)(O)=O,,,4,1,7,4,11
7377_1,,,,2,2,1,3
7379_0,,,,2,2,1,3
C(C(C(O)=O)(C(CO)O)O)(O)=O,,,4,1,9,7,16
7379_1,,,,2,2,1,3
7381_0,,,,2,2,1,3
C(C(C=O)(C(C=O)(CO)O)O)(O)=O,,,4,1,8,17,25
7381_1,,,,2,2,1,3
7383_0,,,,2,2,1,3
C(C(C=O)(C(C(O)=O)O)O)(O)=O,,,4,1,11,13,24
7383_1,,,,2,2,1,3
7385_0,,,,2,2,1,3
C(C(C(O)=O)(C(C=O)O)O)(O)=O,,,4,1,9,12,21
7385_1,,,,2,2,1,3
7387_0,,,,2,2,1,3
C(C(C=O)(C(C)=O)O)(O)=O,,,4,1,8,10,18
7387_1,,,,2,2,1,3
7388_0,,,,2,2,1,3
7388_1,,,,2,2,1,3
7390_0,,,,2,2,1,3
C1(C(C(C(O)O)O)(C(CO1)O)O)=O,,,4,1,2,9,11
7390_1,,,,2,2,1,3
7392_0,,,,2,2,1,3
C1(C(C(CO1)O)(C(C(C)O)O)O)=O,,,4,1,2,10,12
7392_1,,,,2,2,1,3
7394_0,,,,2,2,1,3
C1(C(C(CO1)O)(C(C=O)O)O)=O,,,4,1,5,14,19
7394_1,,,,2,2,1,3
7396_0,,,,2,2,1,3
C1(C(C(CO1)O)(C(C(O)=O)O)O)=O,,,4,1,5,11,16
7396_1,,,,2,2,1,3
7398_0,,,,2,2,1,3
C1(C(C(CO1)O)(C(C=O)(C)O)O)=O,,,4,1,3,10,13
7398_1,,,,2,2,1,3
7400_0,,,,2,2,1,3
C1(C(C(CO1)O)(C(C(C)=O)O)O)=O,,,4,1,4,10,14
7400_1,,,,2,2,1,3
7402_0,,,,2,2,1,3
C1(C(C(CC=O)O)(C(CO1)O)O)=O,,,4,1,2,11,13
7402_1,,,,2,2,1,3
7404_0,,,,2,2,1,3
C1(C(C(C)O)(C(CO1)O)O)=O,,,4,1,3,7,10
7404_1,,,,2,2,1,3
7406_0,,,,2,2,1,3
C1(C(CO)(C(CO1)O)O)=O,,,4,1,3,6,9
7406_1,,,,2,2,1,3
7408_0,,,,2,2,1,3
C1(C(C(CO)O)(C(CO1)O)O)=O,,,4,1,5,9,14
7408_1,,,,2,2,1,3
7410_0,,,,2,2,1,3
C1(C(C(C)O)(C(C(CO)O1)O)O)=O,,,4,1,3,7,10
7410_1,,,,2,2,1,3
7412_0,,,,2,2,1,3
C1(C(CO)(C(C(CO)O1)O)O)=O,,,4,1,4,6,10
7412_1,,,,2,2,1,3
7414_0,,,,2,2,1,3
C1(C(C(C)O)(C(C(CO1)O)O)O)=O,,,4,1,2,10,12
7414_1,,,,2,2,1,3
7416_0,,,,2,2,1,3
C1(C(CO)(C(C(CO1)O)O)O)=O,,,4,1,3,9,12
7416_1,,,,2,2,1,3
7417_0,,,,2,2,1,3
7417_1,,,,2,2,1,3
7419_0,,,,2,2,1,3
C(C(C(C(O)=O)=O)(C(C=O)O)O)=O,,,4,1,4,16,20
7419_1,,,,2,2,1,3
7421_0,,,,2,2,1,3
C(C(C(C(O)=O)=O)(C(C)O)O)=O,,,4,1,5,12,17
7421_1,,,,2,2,1,3
7422_0,,,,2,2,1,3
7422_1,,,,2,2,1,3
7423_0,,,,2,2,1,3
7423_1,,,,2,2,1,3
7424_0,,,,2,2,1,3
7426_0,,,,2,2,1,3
C(C(C(C)O)C(C(O)=O)O)(O)=O,,,4,1,7,9,16
7428_0,,,,2,2,1,3
C(C(CO)C(C(O)=O)O)(O)=O,,,4,1,10,10,20
7430_0,,,,2,2,1,3
C(C(C(CO)O)C(C(O)=O)O)(O)=O,,,4,1,10,12,22
7431_0,,,,2,2,1,3
7431_1,,,,2,2,1,3
7432_0,,,,2,2,1,3
7432_1,,,,2,2,1,3
7433_0,,,,2,2,1,3
7433_1,,,,2,2,1,3
7434_0,,,,2,2,1,3
7434_1,,,,2,2,1,3
7436_0,,,,2,2,1,3
C(C(CO)(C(C(O)O)O)O)=O,,,4,1,6,13,19
7436_1,,,,2,2,1,3
7438_0,,,,2,2,1,3
C(C(C(C(O)O)O)(C(CO)O)O)=O,,,4,1,8,15,23
7438_1,,,,2,2,1,3
7440_0,,,,2,2,1,3
C(C(C(C(O)O)O)(C(C=O)O)O)=O,,,4,1,7,19,26
7440_1,,,,2,2,1,3
7442_0,,,,2,2,1,3
C(CO)(C(CO)(C(C(O)O)O)O)=O,,,4,1,7,12,19
7442_1,,,,2,2,1,3
7444_0,,,,2,2,1,3
C(C(CO)(C(C(O)O)O)O)(O)=O,,,4,1,6,10,16
7444_1,,,,2,2,1,3
7446_0,,,,2,2,1,3
C(C(C(C)=O)(C(C(O)O)O)O)=O,,,4,1,3,11,14
7446_1,,,,2,2,1,3
7448_0,,,,2,2,1,3
C(C(C(CO)(C(C(O)O)O)O)=O)=O,,,4,1,7,17,24
7448_1,,,,2,2,1,3
7450_0,,,,2,2,1,3
C(C(CO)(C(C(C)O)O)O)=O,,,4,1,6,14,20
7450_1,,,,2,2,1,3
7452_0,,,,2,2,1,3
C(C(C(CO)O)(C(C(C)O)O)O)=O,,,4,1,8,16,24
7452_1,,,,2,2,1,3
7453_0,,,,2,2,1,3
7453_1,,,,2,2,1,3
7455_0,,,,2,2,1,3
C(CO)(C(CO)(C(C(C)O)O)O)=O,,,4,1,8,13,21
7455_1,,,,2,2,1,3
7457_0,,,,2,2,1,3
C(C(CO)(C(C(C)O)O)O)(O)=O,,,4,1,6,11,17
7457_1,,,,2,2,1,3
7459_0,,,,2,2,1,3
C(C(C(C)=O)(C(C(C)O)O)O)=O,,,4,1,3,12,15
7459_1,,,,2,2,1,3
7461_0,,,,2,2,1,3
C(C(C(CO)(C(C(C)O)O)O)=O)=O,,,4,1,9,18,27
7461_1,,,,2,2,1,3
7463_0,,,,2,1,1,2
C(C1(CC(C(C1(CO)O)O)O)O)=O,,,4,1,4,14,18
7465_0,,,,2,1,1,2
C(C1(C(C(C(C1)=O)O)O)O)(O)=O,,,4,1,6,15,21
7467_0,,,,2,1,1,2
C(C)(C1(C(C(C(C1)=O)O)O)O)=O,,,4,1,5,15,20
7469_0,,,,2,1,1,2
C(C1(CC(CC1(C=O)O)O)O)=O,,,4,1,1,8,9
7470_0,,,,2,1,1,2
7471_0,,,,2,1,1,2
7472_0,,,,2,1,1,2
7474_0,,,,2,1,1,2
C(C1(C(CC(C1)O)O)O)=O,,,4,1,1,12,13
7475_0,,,,2,1,1,2
7476_0,,,,2,1,1,2
7478_0,,,,2,1,1,2
C(C1(C(C(C(C1)O)O)O)O)=O,,,4,1,2,15,17
7480_0,,,,2,1,1,2
C(CO)(C1(C(C(C(C1)=O)O)O)O)=O,,,4,1,1,17,18
7481_0,,,,2,1,1,2
7483_0,,,,2,1,1,2
C(C1(C(C(CO)(C(C1)O)O)O)O)=O,,,4,1,2,15,17
7485_0,,,,2,2,1,3
C(C(C(O)=O)(CC(C=O)=O)O)(O)=O,,,4,1,2,8,10
7487_0,,,,2,2,1,3
C(C(C(C)O)(CC(C=O)=O)O)(O)=O,,,4,1,3,13,16
7488_0,,,,2,2,1,3
7490_0,,,,2,2,1,3
C(C(C(O)=O)(C(C=O)C=O)O)(O)=O,,,4,1,2,6,8
7492_0,,,,2,2,1,3
C(C(C=O)C(C(O)=O)(C(C)O)O)=O,,,4,1,4,10,14
7493_0,,,,2,2,1,3
7495_0,,,,2,2,1,3
C(C(C(CCO)O)(CC=O)O)(O)=O,,,4,1,4,12,16
7497_0,,,,2,2,1,3
C(C(C(CO)(C)O)(CC=O)O)(O)=O,,,4,1,3,11,14
7499_0,,,,2,2,1,3
C(C(C(O)=O)(CC=O)O)(O)=O,,,4,1,3,9,12
7501_0,,,,2,2,1,3
C(C(C(C(O)O)O)(CC=O)O)(O)=O,,,4,1,2,12,14
7503_0,,,,2,2,1,3
C(C(C(C(C)O)O)(CC=O)O)(O)=O,,,4,1,3,13,16
7504_0,,,,2,2,1,3
7505_0,,,,2,2,1,3
7506_0,,,,2,2,1,3
7507_0,,,,2,2,1,3
7508_0,,,,2,2,1,3
7509_0,,,,2,2,1,3
7510_0,,,,2,2,1,3
7511_0,,,,2,2,1,3
7513_0,,,,2,2,1,3
C(C(CC(C(C=O)(O)O)O)O)(O)=O,,,4,1,7,13,20
7515_0,,,,2,2,1,3
C(C(C)(C(CC(C(O)=O)O)O)O)=O,,,4,1,7,14,21
7517_0,,,,2,2,1,3
C(C(CC([C](C(O)=O)O)O)O)(O)=O,,,4,1,7,10,17
7518_0,,,,2,2,1,3
7520_0,,,,2,2,1,3
C(C(C)(CC(C(C=O)(O)O)O)O)=O,,,4,1,1,11,12
7522_0,,,,2,2,1,3
C(C(C)(CC(C(C=O)(C)O)O)O)=O,,,4,1,1,12,13
7524_0,,,,2,2,1,3
C(C(C)(CC([C](C(O)=O)O)O)O)=O,,,4,1,1,10,11
7526_0,,,,2,2,1,3
C(C(C)(CC(C(C(O)=O)O)O)O)=O,,,4,1,5,15,20
7528_0,,,,2,2,1,3
C(CC(C)(C(C(C=O)(O)O)O)O)=O,,,4,1,2,14,16
7530_0,,,,2,2,1,3
C(C(C)(C(C(C)(CC=O)O)O)O)=O,,,4,1,2,15,17
7532_0,,,,2,2,1,3
C(CC(C)(C([C](C(O)=O)O)O)O)=O,,,4,1,2,11,13
7533_0,,,,2,2,1,3
7535_0,,,,2,2,1,3
C(C(C(C)=O)(CC(C=O)=O)O)(O)=O,,,4,1,3,11,14
7537_0,,,,2,2,1,3
C(C)(C(C(C)O)(CC(C=O)=O)O)=O,,,4,1,2,13,15
7538_0,,,,2,2,1,3
7540_0,,,,2,2,1,3
C(C(C=O)C(C(O)=O)(C(C)=O)O)=O,,,4,1,4,8,12
7542_0,,,,2,2,1,3
C(C(C=O)C(C(C)=O)(C(C)O)O)=O,,,4,1,3,10,13
7543_0,,,,2,2,1,3
7545_0,,,,2,2,1,3
C(C)(C(C(CCO)O)(CC=O)O)=O,,,4,1,2,12,14
7547_0,,,,2,2,1,3
C(C)(C(C(CO)(C)O)(CC=O)O)=O,,,4,1,2,11,13
7549_0,,,,2,2,1,3
C(C(C(C)=O)(CC=O)O)(O)=O,,,4,1,6,13,19
7551_0,,,,2,2,1,3
C(C)(C(C(C(O)O)O)(CC=O)O)=O,,,4,1,1,12,13
7553_0,,,,2,2,1,3
C(C)(C(C(C(C)O)O)(CC=O)O)=O,,,4,1,2,13,15
7555_0,,,,2,2,1,3
C(CC(C(C)=O)(C(C=O)O)O)=O,,,4,1,6,19,25
7557_0,,,,2,2,1,3
C(C(C(C(C)=O)(CC=O)O)O)(O)=O,,,4,1,5,13,18
7559_0,,,,2,2,1,3
C(CC(C(C)=O)(C(C=O)(C)O)O)=O,,,4,1,3,12,15
7561_0,,,,2,2,1,3
C(CC(C(C)=O)(C(C(C)=O)O)O)=O,,,4,1,4,14,18
7563_0,,,,2,2,1,3
C(C)(C(C(CC=O)O)(CC=O)O)=O,,,4,1,3,17,20
7565_0,,,,2,2,1,3
C(C)(C(C(C)O)(CC=O)O)=O,,,4,1,3,15,18
7566_0,,,,2,2,1,3
7568_0,,,,2,2,1,3
C(C)(C(C(CO)O)(CC=O)O)=O,,,4,1,4,15,19
7570_0,,,,2,2,1,3
C(C(C(CC(C(C)=O)O)O)(O)O)=O,,,4,1,1,12,13
7572_0,,,,2,2,1,3
C(C(C)(C(CC(C(C)=O)O)O)O)=O,,,4,1,1,13,14
7574_0,,,,2,2,1,3
C(C)(C(CC([C](C(O)=O)O)O)O)=O,,,4,1,1,9,10
7576_0,,,,2,2,1,3
C(C(C(CC(C(C)=O)O)O)O)(O)=O,,,4,1,5,14,19
7578_0,,,,2,2,1,3
C(CC(C(C)(C(C=O)(O)O)O)O)=O,,,4,1,2,13,15
7580_0,,,,2,2,1,3
C(C(C)(C(C)(C(CC=O)O)O)O)=O,,,4,1,2,14,16
7582_0,,,,2,2,1,3
C(CC(C([C](C(O)=O)O)(C)O)O)=O,,,4,1,2,10,12
7583_0,,,,2,2,1,3
7585_0,,,,2,2,1,3
C(C(CC(C)O)(C(C=O)(O)O)O)=O,,,4,1,1,11,12
7587_0,,,,2,2,1,3
C(C(CC(C)O)(C(C=O)(C)O)O)=O,,,4,1,2,12,14
7589_0,,,,2,2,1,3
C(C([C](C(O)=O)O)(CC(C)O)O)=O,,,4,1,1,10,11
7591_0,,,,2,2,1,3
C(C(CC(C)O)(C(C(O)=O)O)O)=O,,,4,1,4,13,17
7593_0,,,,2,2,1,3
C(C(C(C=O)(O)O)O)(CC(C)O)=O,,,4,1,2,13,15
7595_0,,,,2,2,1,3
C(C(C)(C(C(CC(C)O)=O)O)O)=O,,,4,1,4,14,18
7597_0,,,,2,2,1,3
C(CC(C)O)(C([C](C(O)=O)O)O)=O,,,4,1,2,10,12
7598_0,,,,2,2,1,3
7600_0,,,,2,2,1,3
C(CO)(C(CO)(CC(C=O)=O)O)=O,,,4,1,4,17,21
7602_0,,,,2,2,1,3
C(C(C=O)(CC(C=O)=O)O)(O)=O,,,4,1,1,15,16
7603_0,,,,2,2,1,3
7604_0,,,,2,2,1,3
7605_0,,,,2,2,1,3
7606_0,,,,2,2,1,3
7608_0,,,,2,2,1,3
C(CC(CC(C(C=O)(O)O)O)O)=O,,,4,1,2,14,16
7610_0,,,,2,2,1,3
C(C(C)(C(CC(CC=O)O)O)O)=O,,,4,1,2,15,17
7612_0,,,,2,2,1,3
C(CC(CC([C](C(O)=O)O)O)O)=O,,,4,1,2,10,12
7613_0,,,,2,2,1,3
7615_0,,,,2,2,1,3
C(C(C(C(C=O)(O)O)O)C(C)O)=O,,,4,1,3,14,17
7617_0,,,,2,2,1,3
C(C(C(C(C=O)(C)O)O)C(C)O)=O,,,4,1,5,15,20
7619_0,,,,2,2,1,3
C(C(C(C)O)C([C](C(O)=O)O)O)=O,,,4,1,3,13,16
7620_0,,,,2,2,1,3
7622_0,,,,2,2,1,3
C(C(C=O)C(C(CO)=O)(CO)O)=O,,,4,1,5,12,17
7624_0,,,,2,2,1,3
C(C(C=O)(C(C=O)C=O)O)(O)=O,,,4,1,2,11,13
7625_0,,,,2,2,1,3
7626_0,,,,2,2,1,3
7627_0,,,,2,2,1,3
7628_0,,,,2,2,1,3
7630_0,,,,2,2,1,3
C(C(CO)C(C(C=O)(O)O)O)=O,,,4,1,4,16,20
7632_0,,,,2,2,1,3
C(C(CO)C(C(C=O)(C)O)O)=O,,,4,1,6,17,23
7634_0,,,,2,2,1,3
C(C(CO)C([C](C(O)=O)O)O)=O,,,4,1,4,14,18
7635_0,,,,2,2,1,3
7636_0,,,,2,2,1,3
7638_0,,,,2,2,1,3
C(CCO)(C(C(O)=O)(CC=O)O)=O,,,4,1,4,12,16
7640_0,,,,2,2,1,3
C(C(C(C)O)(CC=O)O)(CCO)=O,,,4,1,3,13,16
7642_0,,,,2,2,1,3
C(C(CO)(CC=O)O)(CCO)=O,,,4,1,5,15,20
7643_0,,,,2,2,1,3
7645_0,,,,2,2,1,3
C(C(C=O)(CC(CC=O)O)O)(O)=O,,,4,1,3,14,17
7646_0,,,,2,2,1,3
7647_0,,,,2,2,1,3
7648_0,,,,2,2,1,3
7650_0,,,,2,2,1,3
C(C(C=O)(C(C=O)C(C)O)O)(O)=O,,,4,1,3,14,17
7651_0,,,,2,2,1,3
7652_0,,,,2,2,1,3
7653_0,,,,2,2,1,3
7655_0,,,,2,2,1,3
C(C(C=O)(C(C=O)CO)O)(O)=O,,,4,1,6,16,22
7656_0,,,,2,2,1,3
7657_0,,,,2,2,1,3
7658_0,,,,2,2,1,3
7659_0,,,,2,2,1,3
7660_0,,,,2,2,1,3
7661_0,,,,2,2,1,3
7662_0,,,,2,2,1,3
7664_0,,,,2,2,1,3
C(C(C(C)(C(CC(C)O)O)O)=O)=O,,,4,1,1,13,14
7666_0,,,,2,2,1,3
C(C(CCO)(C(CC(C)O)O)O)=O,,,4,1,2,11,13
7668_0,,,,2,2,1,3
C1(C(C(CC(C)O)O)(O)OCC1)=O,,,4,1,1,8,9
7670_0,,,,2,2,1,3
C(C(C=C)(C(CC(C)O)O)O)(O)=O,,,4,1,1,8,9
7672_0,,,,2,2,1,3
C1(C(CCO1)(C(CC(C)O)O)O)=O,,,4,1,1,7,8
7674_0,,,,2,2,1,3
C(C(C(CC(C)O)O)(O)O)=O,,,4,1,1,9,10
7676_0,,,,2,2,1,3
C(C(C)(C(CC(C)O)O)O)=O,,,4,1,1,10,11
7678_0,,,,2,2,1,3
[C](C(O)=O)(C(CC(C)O)O)O,,,4,1,1,6,7
7680_0,,,,2,2,1,3
C(C(C(CC(C)O)O)O)(O)=O,,,4,1,7,11,18
7682_0,,,,2,2,1,3
C(C(C(CC(C)O)O)(CC=O)O)=O,,,4,1,2,13,15
7684_0,,,,2,2,1,3
C(C(C)(C(CC(C)O)O)O)(O)=O,,,4,1,2,8,10
7686_0,,,,2,2,1,3
C(C(C(C(C(C)O)O)O)(O)O)=O,,,4,1,1,12,13
7688_0,,,,2,2,1,3
C(C(C)(C(C(C(C)O)O)O)O)=O,,,4,1,1,13,14
7690_0,,,,2,2,1,3
[C](C(O)=O)(C(C(C(C)O)O)O)O,,,4,1,2,9,11
7692_0,,,,2,2,1,3
C(C(C(C(C(C)O)O)O)O)(O)=O,,,4,1,9,12,21
7694_0,,,,2,2,1,3
C(C(C)(C(C(C(C)O)O)O)O)(O)=O,,,4,1,3,11,14
7696_0,,,,2,2,1,3
C(C(C(CO)=O)(CC=O)O)(O)=O,,,4,1,6,13,19
7698_0,,,,2,2,1,3
C(CC(C(CO)=O)(C(C=O)O)O)=O,,,4,1,4,19,23
7700_0,,,,2,2,1,3
C(CO)(C(C(C)O)(CC=O)O)=O,,,4,1,3,14,17
7701_0,,,,2,2,1,3
7703_0,,,,2,2,1,3
C(CO)(C(C(CO)O)(CC=O)O)=O,,,4,1,4,15,19
7704_0,,,,2,2,1,3
7706_0,,,,2,2,1,3
C(C(C(C)(C(CCO)O)O)=O)=O,,,4,1,2,15,17
7708_0,,,,2,2,1,3
C(C(CCO)(C(CCO)O)O)=O,,,4,1,3,11,14
7710_0,,,,2,2,1,3
C(C(C(CCO)O)(CC(O)=O)O)=O,,,4,1,3,11,14
7712_0,,,,2,2,1,3
C1(C(C(CCO)O)(O)OCC1)=O,,,4,1,2,8,10
7714_0,,,,2,2,1,3
C(C(C=C)(C(CCO)O)O)(O)=O,,,4,1,4,9,13
7716_0,,,,2,2,1,3
C1(C(C(CCO)O)(O)OCC1O)=O,,,4,1,2,8,10
7718_0,,,,2,2,1,3
C1(C(CCO1)(C(CCO)O)O)=O,,,4,1,3,6,9
7720_0,,,,2,2,1,3
C(C(C(CCO)O)(O)O)=O,,,4,1,2,9,11
7722_0,,,,2,2,1,3
C(C(C)(C(CCO)O)O)=O,,,4,1,2,10,12
7724_0,,,,2,2,1,3
[C](C(O)=O)(C(CCO)O)O,,,4,1,3,5,8
7725_0,,,,2,2,1,3
7726_0,,,,2,2,1,3
7727_0,,,,2,2,1,3
7728_0,,,,2,2,1,3
7730_0,,,,2,2,1,3
C(C(C(CC(CO)O)O)(O)O)=O,,,4,1,2,11,13
7732_0,,,,2,2,1,3
C(C(C)(C(CC(CO)O)O)O)=O,,,4,1,2,12,14
7734_0,,,,2,2,1,3
[C](C(O)=O)(C(CC(CO)O)O)O,,,4,1,3,8,11
7735_0,,,,2,2,1,3
7736_0,,,,2,2,1,3
7738_0,,,,2,2,1,3
C(C(C(C(C(C=O)=O)O)O)(O)O)=O,,,4,1,3,16,19
7740_0,,,,2,2,1,3
C(C(C)(C(C(C(C=O)=O)O)O)O)=O,,,4,1,6,17,23
7742_0,,,,2,2,1,3
C([C](C(C(C(C=O)=O)O)O)O)(O)=O,,,4,1,3,16,19
7744_0,,,,2,2,1,3
C(C(C(C(C(C=O)=O)O)O)O)(O)=O,,,4,1,8,21,29
7746_0,,,,2,2,1,3
C(C(C(C(C(C=O)(O)O)O)=O)O)=O,,,4,1,2,15,17
7747_0,,,,2,2,1,3
7749_0,,,,2,2,1,3
C(C(C(C([C](C(O)=O)O)O)=O)O)=O,,,4,1,2,13,15
7750_0,,,,2,2,1,3
7752_0,,,,2,2,1,3
C(C(C(C=O)(C(C=O)(O)O)O)O)=O,,,4,1,3,18,21
7753_0,,,,2,2,1,3
7755_0,,,,2,2,1,3
C(C([C](C(O)=O)O)(C(C=O)O)O)=O,,,4,1,4,18,22
7756_0,,,,2,2,1,3
7758_0,,,,2,2,1,3
C(C(C(CO)(C(C=O)(O)O)O)O)=O,,,4,1,2,14,16
7759_0,,,,2,2,1,3
7761_0,,,,2,2,1,3
C(C(C([C](C(O)=O)O)(CO)O)O)=O,,,4,1,3,13,16
7762_0,,,,2,2,1,3
7764_0,,,,2,2,1,3
C(C(C(C(C(CO)=O)O)O)(O)O)=O,,,4,1,4,15,19
7765_0,,,,2,2,1,3
7767_0,,,,2,2,1,3
C(CO)(C(C([C](C(O)=O)O)O)O)=O,,,4,1,5,12,17
7768_0,,,,2,2,1,3
7770_0,,,,2,2,1,3
C(C)(C(CO)(C(C=O)(O)O)O)=O,,,4,1,5,14,19
7771_0,,,,2,2,1,3
7773_0,,,,2,2,1,3
C(C)(C([C](C(O)=O)O)(CO)O)=O,,,4,1,5,11,16
7774_0,,,,2,2,1,3
7775_0,,,,2,2,1,3
7777_0,,,,2,2,1,3
C(CO)(C(C)(C(C=O)(O)O)O)=O,,,4,1,3,11,14
7779_0,,,,2,2,1,3
C(C(C)(C(C(CO)=O)(C)O)O)=O,,,4,1,4,12,16
7781_0,,,,2,2,1,3
C(CO)(C([C](C(O)=O)O)(C)O)=O,,,4,1,3,7,10
7782_0,,,,2,2,1,3
7783_0,,,,2,2,1,3
7785_0,,,,2,2,1,3
C(C(C(C(C(C=O)=O)(C)O)O)O)=O,,,4,1,7,21,28
7787_0,,,,2,2,1,3
C(C(C(C)(C(CO)(C)O)O)=O)=O,,,4,1,2,14,16
7789_0,,,,2,2,1,3
C(C(C)(C(C(C=O)=O)(C)O)O)(O)=O,,,4,1,4,12,16
7791_0,,,,2,2,1,3
C(CC(C(C(C=O)=O)(C)O)O)(O)=O,,,4,1,2,13,15
7793_0,,,,2,2,1,3
C(C(C=C)(C(C(C=O)=O)(C)O)O)=O,,,4,1,2,10,12
7795_0,,,,2,2,1,3
C=CC(C(C(C(C=O)=O)(C)O)O)=O,,,4,1,3,12,15
7797_0,,,,2,2,1,3
C(C(C(C(C=O)=O)(C)O)O)=CC=O,,,4,1,1,9,10
7798_0,,,,2,2,1,3
7800_0,,,,2,2,1,3
C(C(C(C)(C(C(O)O)O)O)=O)=O,,,4,1,1,15,16
7802_0,,,,2,2,1,3
C(C(C(C)(C(C(C)O)O)O)=O)=O,,,4,1,1,16,17
7804_0,,,,2,2,1,3
C(C(C(C)(C(C(CO)O)O)O)=O)=O,,,4,1,6,16,22
7805_0,,,,2,2,1,3
7807_0,,,,2,2,1,3
C(C(C(C)(C(CO)(CO)O)O)=O)=O,,,4,1,5,10,15
7809_0,,,,2,2,1,3
C(C(C(C(C=O)=O)(C)O)O)(O)=O,,,4,1,7,16,23
7811_0,,,,2,2,1,3
C(C(C)(C(C(C=O)=O)(C)O)O)=O,,,4,1,5,15,20
7812_0,,,,2,2,1,3
7814_0,,,,2,2,1,3
C(CC(C(C(C=O)=O)(C)O)O)=O,,,4,1,6,19,25
7816_0,,,,2,2,1,3
C(C(C(C)(C(C)O)O)=O)=O,,,4,1,2,14,16
7817_0,,,,2,2,1,3
7818_0,,,,2,2,1,3
7820_0,,,,2,2,1,3
C(C(C(CO)(C)O)=O)=O,,,4,1,10,19,29
7822_0,,,,2,2,1,3
C(C(C(C)(C(CO)O)O)=O)=O,,,4,1,6,15,21
7824_0,,,,2,2,1,3
C(C(C(C)O)(C(C=O)(O)O)O)=O,,,4,1,4,15,19
7825_0,,,,2,2,1,3
7827_0,,,,2,2,1,3
C(C([C](C(O)=O)O)(C(C)O)O)=O,,,4,1,5,13,18
7828_0,,,,2,2,1,3
7829_0,,,,2,2,1,3
7831_0,,,,2,2,1,3
C(C(C(C=O)(O)O)O)(C(C)O)=O,,,4,1,3,12,15
7833_0,,,,2,2,1,3
C(C(C)(C(C(C(C)O)=O)O)O)=O,,,4,1,5,13,18
7835_0,,,,2,2,1,3
C(C(C)O)(C([C](C(O)=O)O)O)=O,,,4,1,3,9,12
7836_0,,,,2,2,1,3
7837_0,,,,2,2,1,3
7838_0,,,,2,2,1,3
7840_0,,,,2,2,1,3
C(C(C(C1(C(CCO1)=O)O)O)O)=O,,,4,1,2,16,18
7842_0,,,,2,2,1,3
C(C(C=C)(C(C(C=O)O)O)O)(O)=O,,,4,1,2,15,17
7844_0,,,,2,2,1,3
C1(C(C(C(C=O)O)O)(CCO1)O)=O,,,4,1,2,13,15
7846_0,,,,2,2,1,3
C(C(C(C(C=O)(O)O)O)O)=O,,,4,1,2,19,21
7847_0,,,,2,2,1,3
7849_0,,,,2,2,1,3
C(C(C([C](C(O)=O)O)O)O)=O,,,4,1,3,17,20
7850_0,,,,2,2,1,3
7851_0,,,,2,2,1,3
7852_0,,,,2,2,1,3
7854_0,,,,2,2,1,3
C(C(CCO)(C(CO)(C)O)O)=O,,,4,1,3,10,13
7856_0,,,,2,2,1,3
C(C(C(CO)(C)O)(CC(O)=O)O)=O,,,4,1,3,10,13
7858_0,,,,2,2,1,3
C1(C(C(CO)(C)O)(O)OCC1)=O,,,4,1,2,7,9
7860_0,,,,2,2,1,3
C(C(C=C)(C(CO)(C)O)O)(O)=O,,,4,1,4,8,12
7862_0,,,,2,2,1,3
C1(C(C(CO)(C)O)(O)OCC1O)=O,,,4,1,2,7,9
7864_0,,,,2,2,1,3
C1(C(CCO1)(C(CO)(C)O)O)=O,,,4,1,3,5,8
7866_0,,,,2,2,1,3
C(C(C(CO)(C)O)(O)O)=O,,,4,1,2,8,10
7868_0,,,,2,2,1,3
C(C(C)(C(CO)(C)O)O)=O,,,4,1,2,9,11
7870_0,,,,2,2,1,3
[C](C(O)=O)(C(CO)(C)O)O,,,4,1,2,4,6
7871_0,,,,2,2,1,3
7872_0,,,,2,2,1,3
7873_0,,,,2,2,1,3
7874_0,,,,2,2,1,3
7876_0,,,,2,2,1,3
C(C(C(CO)(CCO)O)(O)O)=O,,,4,1,3,9,12
7878_0,,,,2,2,1,3
C(C(C)(C(CO)(CCO)O)O)=O,,,4,1,3,10,13
7880_0,,,,2,2,1,3
[C](C(O)=O)(C(CO)(CCO)O)O,,,4,1,3,6,9
7881_0,,,,2,2,1,3
7882_0,,,,2,2,1,3
7883_0,,,,2,2,1,3
7885_0,,,,2,2,1,3
C(C(C(CC(O)=O)O)(CCO)O)=O,,,4,1,3,11,14
7887_0,,,,2,2,1,3
C(C(C=C)(C(C=O)(CCO)O)O)=O,,,4,1,3,10,13
7889_0,,,,2,2,1,3
C(C(CCO)(C(C(C=C)=O)O)O)=O,,,4,1,4,13,17
7891_0,,,,2,2,1,3
C(C(CCO)(C(C=CC=O)O)O)=O,,,4,1,2,9,11
7892_0,,,,2,2,1,3
7894_0,,,,2,2,1,3
C(C(C(C(O)O)O)(CCO)O)=O,,,4,1,2,11,13
7896_0,,,,2,2,1,3
C(C(CCO)(C(C(C)O)O)O)=O,,,4,1,2,12,14
7897_0,,,,2,2,1,3
7898_0,,,,2,2,1,3
7899_0,,,,2,2,1,3
7900_0,,,,2,2,1,3
7901_0,,,,2,2,1,3
7902_0,,,,2,2,1,3
7903_0,,,,2,2,1,3
7904_0,,,,2,2,1,3
7905_0,,,,2,2,1,3
7906_0,,,,2,2,1,3
7907_0,,,,2,2,1,3
7908_0,,,,2,2,1,3
7910_0,,,,2,2,1,3
C(C(C(C(CCO)O)O)(O)O)=O,,,4,1,2,11,13
7912_0,,,,2,2,1,3
C(C(C)(C(C(CCO)O)O)O)=O,,,4,1,2,12,14
7914_0,,,,2,2,1,3
[C](C(O)=O)(C(C(CCO)O)O)O,,,4,1,3,8,11
7915_0,,,,2,2,1,3
7916_0,,,,2,2,1,3
7918_0,,,,2,2,1,3
C(C(C(C)(C(CO)O)O)(O)O)=O,,,4,1,2,10,12
7920_0,,,,2,2,1,3
C(C(C)(C(C)(C(CO)O)O)O)=O,,,4,1,2,11,13
7922_0,,,,2,2,1,3
[C](C(O)=O)(C(C)(C(CO)O)O)O,,,4,1,2,7,9
7923_0,,,,2,2,1,3
7924_0,,,,2,2,1,3
7926_0,,,,2,2,1,3
C(C(C)(C1(C(CCO1)=O)O)O)(O)=O,,,4,1,2,7,9
7928_0,,,,2,2,1,3
C(C(C=C)(C(C(O)=O)(C)O)O)(O)=O,,,4,1,4,7,11
7930_0,,,,2,2,1,3
C1(C(CCO1)(C(C(O)=O)(C)O)O)=O,,,4,1,3,6,9
7932_0,,,,2,2,1,3
C(C(C)(C(C=O)(O)O)O)(O)=O,,,4,1,2,8,10
7933_0,,,,2,2,1,3
7935_0,,,,2,2,1,3
C(C([C](C(O)=O)O)(C)O)(O)=O,,,4,1,3,5,8
7936_0,,,,2,2,1,3
7937_0,,,,2,2,1,3
7938_0,,,,2,2,1,3
7940_0,,,,2,2,1,3
C(CC(C1(C(CCO1)=O)O)O)(O)=O,,,4,1,2,7,9
7942_0,,,,2,2,1,3
C(C(C=C)(C(CC(O)=O)O)O)(O)=O,,,4,1,2,7,9
7944_0,,,,2,2,1,3
C1(C(C(CC(O)=O)O)(CCO1)O)=O,,,4,1,2,6,8
7946_0,,,,2,2,1,3
C(CC(C(C=O)(O)O)O)(O)=O,,,4,1,2,9,11
7948_0,,,,2,2,1,3
C(C(C)(C(CC(O)=O)O)O)=O,,,4,1,2,10,12
7950_0,,,,2,2,1,3
C(CC([C](C(O)=O)O)O)(O)=O,,,4,1,2,6,8
7951_0,,,,2,2,1,3
7952_0,,,,2,2,1,3
7953_0,,,,2,2,1,3
7955_0,,,,2,2,1,3
C(C(CCO)(C(C=O)(O)O)O)(O)=O,,,4,1,3,10,13
7956_0,,,,2,2,1,3
7958_0,,,,2,2,1,3
C(C([C](C(O)=O)O)(CCO)O)(O)=O,,,4,1,4,8,12
7959_0,,,,2,2,1,3
7961_0,,,,2,2,1,3
C(C(C=O)(CC(O)=O)O)(O)=O,,,4,1,3,8,11
7963_0,,,,2,2,1,3
C(C(C(C(O)O)O)(CC(O)=O)O)=O,,,4,1,2,11,13
7965_0,,,,2,2,1,3
C(C(C(C(C)O)O)(CC(O)=O)O)=O,,,4,1,2,12,14
7966_0,,,,2,2,1,3
7967_0,,,,2,2,1,3
7968_0,,,,2,2,1,3
7969_0,,,,2,2,1,3
7970_0,,,,2,2,1,3
7971_0,,,,2,2,1,3
7972_0,,,,2,2,1,3
7973_0,,,,2,2,1,3
7975_0,,,,2,2,1,3
C(CC(C(C(C=O)(O)O)O)O)(O)=O,,,4,1,2,12,14
7977_0,,,,2,2,1,3
C(C(C)(C(C(CC(O)=O)O)O)O)=O,,,4,1,2,13,15
7979_0,,,,2,2,1,3
C(CC(C([C](C(O)=O)O)O)O)(O)=O,,,4,1,3,9,12
7980_0,,,,2,2,1,3
7982_0,,,,2,2,1,3
C(CC(CO)(C(C=O)(O)O)O)(O)=O,,,4,1,3,9,12
7984_0,,,,2,2,1,3
C(C(C)(C(CO)(CC(O)=O)O)O)=O,,,4,1,3,10,13
7986_0,,,,2,2,1,3
C(CC([C](C(O)=O)O)(CO)O)(O)=O,,,4,1,3,7,10
7987_0,,,,2,2,1,3
7989_0,,,,2,2,1,3
C(C(C(C)(C(C=O)(O)O)O)O)(O)=O,,,4,1,5,11,16
7991_0,,,,2,2,1,3
C(C(C)(C(C)(C(C(O)=O)O)O)O)=O,,,4,1,5,12,17
7993_0,,,,2,2,1,3
C(C(C([C](C(O)=O)O)(C)O)O)(O)=O,,,4,1,5,9,14
7994_0,,,,2,2,1,3
7996_0,,,,2,2,1,3
C(C(CO)(C(C=O)(O)O)O)(O)=O,,,4,1,4,12,16
7997_0,,,,2,2,1,3
7999_0,,,,2,2,1,3
C(C([C](C(O)=O)O)(CO)O)(O)=O,,,4,1,5,9,14
8000_0,,,,2,2,1,3
8001_0,,,,2,2,1,3
8003_0,,,,2,2,1,3
C(C(C=O)(CC(CO)=O)O)(O)=O,,,4,1,6,13,19
8004_0,,,,2,2,1,3
8005_0,,,,2,2,1,3
8006_0,,,,2,2,1,3
8007_0,,,,2,2,1,3
8008_0,,,,2,2,1,3
8010_0,,,,2,2,1,3
C(CC(C=O)(C(C=O)(O)O)O)=O,,,4,1,2,14,16
8011_0,,,,2,2,1,3
8013_0,,,,2,2,1,3
C(C([C](C(O)=O)O)(CC=O)O)=O,,,4,1,3,13,16
8014_0,,,,2,2,1,3
8015_0,,,,2,2,1,3
8017_0,,,,2,2,1,3
C(CC(C(C(C=O)(O)O)O)=O)=O,,,4,1,3,16,19
8018_0,,,,2,2,1,3
8020_0,,,,2,2,1,3
C(CC(C([C](C(O)=O)O)O)=O)=O,,,4,1,4,13,17
8021_0,,,,2,2,1,3
8022_0,,,,2,2,1,3
8024_0,,,,2,2,1,3
C(C(C(CC(C=O)=O)O)(O)O)=O,,,4,1,4,16,20
8026_0,,,,2,2,1,3
C(C(C)(C(CC(C=O)=O)O)O)=O,,,4,1,5,17,22
8028_0,,,,2,2,1,3
C([C](C(CC(C=O)=O)O)O)(O)=O,,,4,1,4,15,19
8030_0,,,,2,2,1,3
C(C(C(CC(C=O)=O)O)O)(O)=O,,,4,1,9,20,29
8032_0,,,,2,2,1,3
C(C(C)(C(CC(C=O)=O)O)O)(O)=O,,,4,1,5,13,18
8034_0,,,,2,2,1,3
C(C(C(O)=O)(CC(CO)=O)O)(O)=O,,,4,1,3,6,9
8036_0,,,,2,2,1,3
C(C(C(C)O)(CC(CO)=O)O)(O)=O,,,4,1,4,10,14
8037_0,,,,2,2,1,3
8039_0,,,,2,2,1,3
C(CC(C=O)(C(C=O)(O)O)O)(O)=O,,,4,1,2,10,12
8040_0,,,,2,2,1,3
8042_0,,,,2,2,1,3
C(C([C](C(O)=O)O)(CC(O)=O)O)=O,,,4,1,2,9,11
8043_0,,,,2,2,1,3
8045_0,,,,2,2,1,3
C(CC(C(C(C=O)(O)O)O)=O)(O)=O,,,4,1,3,14,17
8046_0,,,,2,2,1,3
8048_0,,,,2,2,1,3
C(CC(C([C](C(O)=O)O)O)=O)(O)=O,,,4,1,3,11,14
8049_0,,,,2,2,1,3
8051_0,,,,2,2,1,3
C(C(C(CC(C(O)=O)=O)O)(O)O)=O,,,4,1,3,13,16
8053_0,,,,2,2,1,3
C(C(C)(C(CC(C(O)=O)=O)O)O)=O,,,4,1,4,14,18
8055_0,,,,2,2,1,3
C(C(CC([C](C(O)=O)O)O)=O)(O)=O,,,4,1,3,12,15
8057_0,,,,2,2,1,3
C(C(C(CC(C(O)=O)=O)O)O)(O)=O,,,4,1,6,15,21
8059_0,,,,2,2,1,3
C(C(CC=O)(C(C=O)(O)O)O)(O)=O,,,4,1,2,11,13
8060_0,,,,2,2,1,3
8062_0,,,,2,2,1,3
C(C([C](C(O)=O)O)(CC=O)O)(O)=O,,,4,1,2,10,12
8063_0,,,,2,2,1,3
8065_0,,,,2,2,1,3
C(C(C1(COCC1O)O)(O)O)=O,,,4,1,1,6,7
8067_0,,,,2,2,1,3
C(C(C)(C1(COCC1O)O)O)=O,,,4,1,1,7,8
8069_0,,,,2,2,1,3
[C](C(O)=O)(C1(COCC1O)O)O,,,4,1,1,3,4
8071_0,,,,2,2,1,3
C(C(C1(COCC1O)O)O)(O)=O,,,4,1,3,6,9
8073_0,,,,2,2,1,3
C(C(C)(C1(COCC1O)O)O)(O)=O,,,4,1,2,5,7
8075_0,,,,2,2,1,3
C(C(C=C)(C1(C(CCO1)=O)O)O)=O,,,4,1,1,8,9
8077_0,,,,2,2,1,3
C1(C(C(C(C=C)=O)O)(O)OCC1)=O,,,4,1,1,11,12
8079_0,,,,2,2,1,3
C1(C(C(C=CC=O)O)(O)OCC1)=O,,,4,1,1,9,10
8081_0,,,,2,2,1,3
C(C1(C(CCO1)=O)O)(O)=O,,,4,1,3,11,14
8083_0,,,,2,2,1,3
C1(C(C(C(O)O)O)(O)OCC1)=O,,,4,1,1,8,9
8085_0,,,,2,2,1,3
C1(C(C(C(C)O)O)(O)OCC1)=O,,,4,1,1,9,10
8087_0,,,,2,2,1,3
C1(C(C(C(CO)O)O)(O)OCC1)=O,,,4,1,4,10,14
8089_0,,,,2,2,1,3
C(C(C1(C(CCO1)=O)O)O)=O,,,4,1,5,18,23
8091_0,,,,2,2,1,3
C1(C(C(CO)(CO)O)(O)OCC1)=O,,,4,1,2,5,7
8093_0,,,,2,2,1,3
C(C(C1(C(CCO1)=O)O)O)(O)=O,,,4,1,4,9,13
8095_0,,,,2,2,1,3
C(C(C)(C1(C(CCO1)=O)O)O)=O,,,4,1,2,11,13
8097_0,,,,2,2,1,3
C(C(C1(C(CCO1)=O)O)O)(C)=O,,,4,1,3,12,15
8099_0,,,,2,2,1,3
C(CC(C1(C(CCO1)=O)O)O)=O,,,4,1,3,13,16
8101_0,,,,2,2,1,3
C1(C(C(C)O)(O)OCC1)=O,,,4,1,2,13,15
8103_0,,,,2,2,1,3
C(C(CO)(C1(C(CCO1)=O)O)O)=O,,,4,1,3,14,17
8105_0,,,,2,2,1,3
C(C(C1(C(CCO1)=O)O)O)(CO)=O,,,4,1,2,13,15
8107_0,,,,2,2,1,3
C1(C(CO)(O)OCC1)=O,,,4,1,3,23,26
8109_0,,,,2,2,1,3
C1(C(C(CO)O)(O)OCC1)=O,,,4,1,4,10,14
8111_0,,,,2,2,1,3
C(C(C1(C(O)OCC1)O)(O)O)=O,,,4,1,2,8,10
8113_0,,,,2,2,1,3
C(C(C)(C1(C(O)OCC1)O)O)=O,,,4,1,2,9,11
8115_0,,,,2,2,1,3
[C](C(O)=O)(C1(C(O)OCC1)O)O,,,4,1,2,5,7
8117_0,,,,2,2,1,3
C(C(C1(C(O)OCC1)O)O)(O)=O,,,4,1,4,8,12
8119_0,,,,2,2,1,3
C(C(C)(C1(C(O)OCC1)O)O)(O)=O,,,4,1,3,7,10
8121_0,,,,2,2,1,3
C(C(C1(COC(C1)O)O)(O)O)=O,,,4,1,2,8,10
8123_0,,,,2,2,1,3
C(C(C)(C1(COC(C1)O)O)O)=O,,,4,1,2,9,11
8125_0,,,,2,2,1,3
[C](C(O)=O)(C1(COC(C1)O)O)O,,,4,1,2,5,7
8127_0,,,,2,2,1,3
C(C(C1(COC(C1)O)O)O)(O)=O,,,4,1,4,8,12
8129_0,,,,2,2,1,3
C(C(C)(C1(COC(C1)O)O)O)(O)=O,,,4,1,3,7,10
8131_0,,,,2,2,1,3
C(C(C(C)=O)(C(C=O)(O)O)O)=O,,,4,1,2,11,13
8132_0,,,,2,2,1,3
8134_0,,,,2,2,1,3
C(C(C(C)=O)([C](C(O)=O)O)O)=O,,,4,1,3,9,12
8135_0,,,,2,2,1,3
8136_0,,,,2,2,1,3
8138_0,,,,2,2,1,3
C(C(C(C(C(C)=O)=O)O)(O)O)=O,,,4,1,2,13,15
8139_0,,,,2,2,1,3
8141_0,,,,2,2,1,3
[C](C(O)=O)(C(C(C(C)=O)=O)O)O,,,4,1,2,11,13
8142_0,,,,2,2,1,3
8143_0,,,,2,2,1,3
8145_0,,,,2,2,1,3
C(C(C(C(C=O)=O)(C)O)(O)O)=O,,,4,1,3,14,17
8146_0,,,,2,2,1,3
8148_0,,,,2,2,1,3
[C](C(O)=O)(C(C(C=O)=O)(C)O)O,,,4,1,3,13,16
8149_0,,,,2,2,1,3
8150_0,,,,2,2,1,3
8152_0,,,,2,2,1,3
C(C(C=C)(C(C(O)=O)(C=C)O)O)=O,,,4,1,2,7,9
8154_0,,,,2,2,1,3
C(C(C=C)(C1(C(OCC1)=O)O)O)=O,,,4,1,2,5,7
8156_0,,,,2,2,1,3
C(C(C=C)(C(C=O)(O)O)O)=O,,,4,1,3,10,13
8158_0,,,,2,2,1,3
C(C(C=C)(C(C=O)(C)O)O)=O,,,4,1,4,11,15
8160_0,,,,2,2,1,3
C(C(C=C)([C](C(O)=O)O)O)=O,,,4,1,3,8,11
8162_0,,,,2,2,1,3
C(C(C=C)(C(C(O)=O)O)O)=O,,,4,1,8,13,21
8164_0,,,,2,2,1,3
C(C(C=C)(C(C=O)(CC=O)O)O)=O,,,4,1,2,10,12
8166_0,,,,2,2,1,3
C(C(C=C)(C(C(O)=O)(C)O)O)=O,,,4,1,5,10,15
8168_0,,,,2,2,1,3
C(C(C=C)(C(C(C=C)=O)O)O)(O)=O,,,4,1,3,8,11
8170_0,,,,2,2,1,3
C1(C(CCO1)(C(C(C=C)=O)O)O)=O,,,4,1,3,8,11
8172_0,,,,2,2,1,3
C(C(C(C(C=C)=O)O)(O)O)=O,,,4,1,3,13,16
8174_0,,,,2,2,1,3
C(C(C)(C(C(C=C)=O)O)O)=O,,,4,1,5,15,20
8176_0,,,,2,2,1,3
C=CC(C([C](C(O)=O)O)O)=O,,,4,1,3,11,14
8178_0,,,,2,2,1,3
C(C(C(C(C=C)=O)O)O)(O)=O,,,4,1,9,17,26
8180_0,,,,2,2,1,3
C(CC(C=O)(C(C(C=C)=O)O)O)=O,,,4,1,3,12,15
8182_0,,,,2,2,1,3
C(C(C)(C(C(C=C)=O)O)O)(O)=O,,,4,1,6,11,17
8184_0,,,,2,2,1,3
C(C(C=C)(C(C=CC=O)O)O)(O)=O,,,4,1,1,5,6
8186_0,,,,2,2,1,3
C1(C(CCO1)(C(C=CC=O)O)O)=O,,,4,1,1,5,6
8188_0,,,,2,2,1,3
C(C(C(C=CC=O)O)(O)O)=O,,,4,1,3,10,13
8190_0,,,,2,2,1,3
C(C(C)(C(C=CC=O)O)O)=O,,,4,1,3,11,14
8192_0,,,,2,2,1,3
C(C([C](C(O)=O)O)O)=CC=O,,,4,1,3,7,10
8194_0,,,,2,2,1,3
C(C(C(C=CC=O)O)O)(O)=O,,,4,1,9,14,23
8196_0,,,,2,2,1,3
C(CC(C=O)(C(C=CC=O)O)O)=O,,,4,1,2,11,13
8198_0,,,,2,2,1,3
C(C(C)(C(C=CC=O)O)O)(O)=O,,,4,1,4,8,12
8200_0,,,,2,2,1,3
C(C(C(O)=O)(C=C)O)(O)=O,,,4,1,3,4,7
8202_0,,,,2,2,1,3
C(C(C=C)(C(C(O)O)O)O)(O)=O,,,4,1,3,9,12
8204_0,,,,2,2,1,3
C(C(C=C)(C(C(C)O)O)O)(O)=O,,,4,1,3,10,13
8206_0,,,,2,2,1,3
C(C(C=C)(C(C(CO)O)O)O)(O)=O,,,4,1,5,10,15
8208_0,,,,2,2,1,3
C(C(C=C)(C(C=O)O)O)(O)=O,,,4,1,9,16,25
8210_0,,,,2,2,1,3
C(C(C=C)(C(CO)(CO)O)O)(O)=O,,,4,1,2,5,7
8212_0,,,,2,2,1,3
C(C(C=C)(C(C(O)=O)O)O)(O)=O,,,4,1,7,10,17
8214_0,,,,2,2,1,3
C(C(C=C)(C(C=O)(C)O)O)(O)=O,,,4,1,5,11,16
8216_0,,,,2,2,1,3
C(C(C=C)(C(C(C)=O)O)O)(O)=O,,,4,1,7,11,18
8218_0,,,,2,2,1,3
C(C(C=C)(C(CC=O)O)O)(O)=O,,,4,1,4,13,17
8220_0,,,,2,2,1,3
C(C(C=C)(C(C)O)O)(O)=O,,,4,1,3,7,10
8222_0,,,,2,2,1,3
C(C(C=C)(C(C=O)(CO)O)O)(O)=O,,,4,1,6,13,19
8224_0,,,,2,2,1,3
C(C(C=C)(C(C(CO)=O)O)O)(O)=O,,,4,1,5,10,15
8226_0,,,,2,2,1,3
C(C(C=C)(CO)O)(O)=O,,,4,1,4,7,11
8228_0,,,,2,2,1,3
C(C(C=C)(C(CO)O)O)(O)=O,,,4,1,5,9,14
8230_0,,,,2,2,1,3
C(C1(C(C(CO1)O)=O)O)(O)=O,,,4,1,1,7,8
8232_0,,,,2,2,1,3
C1(C(C(C(O)O)O)(O)OCC1O)=O,,,4,1,1,8,9
8234_0,,,,2,2,1,3
C1(C(C(C(C)O)O)(O)OCC1O)=O,,,4,1,1,9,10
8236_0,,,,2,2,1,3
C(C(C1(C(C(CO1)O)=O)O)O)=O,,,4,1,2,15,17
8238_0,,,,2,2,1,3
C(C(C1(C(C(CO1)O)=O)O)O)(O)=O,,,4,1,3,10,13
8240_0,,,,2,2,1,3
C(C(C)(C1(C(C(CO1)O)=O)O)O)=O,,,4,1,1,11,12
8242_0,,,,2,2,1,3
C(C(C1(C(C(CO1)O)=O)O)O)(C)=O,,,4,1,1,12,13
8244_0,,,,2,2,1,3
C(CC(C1(C(C(CO1)O)=O)O)O)=O,,,4,1,1,12,13
8246_0,,,,2,2,1,3
C1(C(C(C)O)(O)OCC1O)=O,,,4,1,2,8,10
8248_0,,,,2,2,1,3
C1(C(CO)(O)OCC1O)=O,,,4,1,2,12,14
8250_0,,,,2,2,1,3
C1(C(C(CO)O)(O)OCC1O)=O,,,4,1,3,8,11
8252_0,,,,2,2,1,3
C(C(C1(C(O)OCC1O)O)(O)O)=O,,,4,1,2,8,10
8254_0,,,,2,2,1,3
C(C(C)(C1(C(O)OCC1O)O)O)=O,,,4,1,3,9,12
8256_0,,,,2,2,1,3
[C](C(O)=O)(C1(C(O)OCC1O)O)O,,,4,1,2,6,8
8257_0,,,,2,2,1,3
8259_0,,,,2,2,1,3
C1(C(C(O)=O)(CCO1)O)=O,,,4,1,2,2,4
8261_0,,,,2,2,1,3
C(C(C(O)=O)(CC(CO)O)O)(O)=O,,,4,1,2,7,9
8263_0,,,,2,2,1,3
C(C(C(O)=O)(CC(O)=O)O)(O)=O,,,4,1,3,3,6
8265_0,,,,2,2,1,3
C(C(C=O)(O)O)(O)=O,,,4,1,1,20,21
8266_0,,,,2,2,1,3
8268_0,,,,2,2,1,3
C([C](C(O)=O)O)(O)=O,,,4,1,1,0,1
8270_0,,,,2,2,1,3
C(C(C(O)=O)O)(O)=O,,,4,1,19,37,56
8272_0,,,,2,2,1,3
C(C(C=O)(CC=O)O)(O)=O,,,4,1,10,18,28
8274_0,,,,2,2,1,3
C(C(C(O)=O)(C)O)(O)=O,,,4,1,3,3,6
8276_0,,,,2,2,1,3
C(C(C(O)=O)(CCO)O)(O)=O,,,4,1,5,4,9
8278_0,,,,2,2,1,3
C1(C(C(C(O)O)O)(CCO1)O)=O,,,4,1,2,6,8
8280_0,,,,2,2,1,3
C1(C(CCO1)(C(C(C)O)O)O)=O,,,4,1,2,7,9
8282_0,,,,2,2,1,3
C1(C(CCO1)(C(C(CO)O)O)O)=O,,,4,1,4,9,13
8284_0,,,,2,2,1,3
C1(C(CCO1)(C(C=O)O)O)=O,,,4,1,7,12,19
8286_0,,,,2,2,1,3
C1(C(CCO1)(C(CO)(CO)O)O)=O,,,4,1,2,4,6
8288_0,,,,2,2,1,3
C1(C(CCO1)(C(C(O)=O)O)O)=O,,,4,1,6,7,13
8290_0,,,,2,2,1,3
C1(C(CCO1)(C(C=O)(C)O)O)=O,,,4,1,3,7,10
8292_0,,,,2,2,1,3
C1(C(CCO1)(C(C(C)=O)O)O)=O,,,4,1,5,7,12
8294_0,,,,2,2,1,3
C1(C(C(CC=O)O)(CCO1)O)=O,,,4,1,3,9,12
8296_0,,,,2,2,1,3
C1(C(C(C)O)(CCO1)O)=O,,,4,1,2,4,6
8298_0,,,,2,2,1,3
C1(C(CCO1)(C(C=O)(CO)O)O)=O,,,4,1,5,11,16
8300_0,,,,2,2,1,3
C1(C(CCO1)(C(C(CO)=O)O)O)=O,,,4,1,4,8,12
8302_0,,,,2,2,1,3
C1(C(CO)(CCO1)O)=O,,,4,1,2,6,8
8304_0,,,,2,2,1,3
C1(C(C(CO)O)(CCO1)O)=O,,,4,1,4,6,10
8306_0,,,,2,2,1,3
C(C(C(C)O)(CC(CO)O)O)(O)=O,,,4,1,1,10,11
8308_0,,,,2,2,1,3
C(C(CO)(CC(CO)O)O)(O)=O,,,4,1,2,9,11
8310_0,,,,2,2,1,3
C(CC(C(O)=O)(C(C=O)O)O)(O)=O,,,4,1,5,13,18
8312_0,,,,2,2,1,3
C(C(C(C)O)(CC(O)=O)O)(O)=O,,,4,1,4,7,11
8314_0,,,,2,2,1,3
C(C(CO)(CC(O)=O)O)(O)=O,,,4,1,6,7,13
8316_0,,,,2,2,1,3
C(C(C(CO)O)(CC(O)=O)O)(O)=O,,,4,1,5,10,15
8318_0,,,,2,2,1,3
C(C(C(C(O)O)O)(O)O)=O,,,4,1,1,9,10
8320_0,,,,2,2,1,3
C(C(C(C(C)O)O)(O)O)=O,,,4,1,1,10,11
8322_0,,,,2,2,1,3
C(C(C(C(CO)O)O)(O)O)=O,,,4,1,4,11,15
8324_0,,,,2,2,1,3
C(C(C(C(C(CO)O)O)O)(O)O)=O,,,4,1,6,13,19
8326_0,,,,2,2,1,3
C(C(C(C=O)(O)O)O)=O,,,4,1,17,31,48
8328_0,,,,2,2,1,3
C(C(C(C(C(C=O)(O)O)O)O)O)=O,,,4,1,7,20,27
8330_0,,,,2,2,1,3
C(C(C(CO)(CO)O)(O)O)=O,,,4,1,2,6,8
8332_0,,,,2,2,1,3
C(C(C(CO)(C(CO)O)O)(O)O)=O,,,4,1,5,10,15
8334_0,,,,2,2,1,3
C(C(C(C=O)(O)O)O)(O)=O,,,4,1,5,16,21
8336_0,,,,2,2,1,3
C(C(C(C(CO)(CO)O)O)(O)O)=O,,,4,1,2,8,10
8338_0,,,,2,2,1,3
C(C(C)(C(C=O)(O)O)O)=O,,,4,1,2,11,13
8340_0,,,,2,2,1,3
C(C(C(C(C)=O)O)(O)O)=O,,,4,1,10,21,31
8342_0,,,,2,2,1,3
C(CC(C(C=O)(O)O)O)=O,,,4,1,8,19,27
8344_0,,,,2,2,1,3
C(C(CCO)(C(C=O)(O)O)O)=O,,,4,1,4,12,16
8346_0,,,,2,2,1,3
C(C(C(C=O)(O)O)O)(CCO)=O,,,4,1,5,14,19
8348_0,,,,2,2,1,3
C(CC(C(C(C=O)(O)O)O)O)=O,,,4,1,4,17,21
8350_0,,,,2,2,1,3
C(C(CC(C(C=O)(O)O)O)O)=O,,,4,1,4,16,20
8352_0,,,,2,2,1,3
C(C(C(CC(CO)=O)O)(O)O)=O,,,4,1,4,13,17
8354_0,,,,2,2,1,3
C(CC(CO)(C(C=O)(O)O)O)=O,,,4,1,5,13,18
8356_0,,,,2,2,1,3
C(C(C(C(C(C)=O)O)O)(O)O)=O,,,4,1,3,14,17
8358_0,,,,2,2,1,3
C(C(C(C)(C(C=O)(O)O)O)O)=O,,,4,1,3,15,18
8360_0,,,,2,2,1,3
C(C(C(C)O)(O)O)=O,,,4,1,1,28,29
8362_0,,,,2,2,1,3
C(C(CO)(C(C=O)(O)O)O)=O,,,4,1,3,14,17
8364_0,,,,2,2,1,3
C(C(C(C(CO)=O)O)(O)O)=O,,,4,1,4,16,20
8366_0,,,,2,2,1,3
C(C(C(CO)O)(C(C=O)(O)O)O)=O,,,4,1,7,16,23
8368_0,,,,2,2,1,3
C(C(C(C=O)(O)O)O)(C(CO)O)=O,,,4,1,7,16,23
8370_0,,,,2,2,1,3
C(C(CO)(O)O)=O,,,4,1,1,57,58
8372_0,,,,2,2,1,3
C(C(C(CO)O)(O)O)=O,,,4,1,2,13,15
8374_0,,,,2,2,1,3
C(C(C)(C(C(O)O)O)O)=O,,,4,1,1,10,11
8376_0,,,,2,2,1,3
[C](C(O)=O)(C(C(O)O)O)O,,,4,1,1,5,6
8378_0,,,,2,2,1,3
C(C(C(C(O)O)O)O)(O)=O,,,4,1,7,14,21
8380_0,,,,2,2,1,3
C(C(C(C(O)O)O)(CC=O)O)=O,,,4,1,2,15,17
8382_0,,,,2,2,1,3
C(C(C)(C(C(O)O)O)O)(O)=O,,,4,1,2,7,9
8384_0,,,,2,2,1,3
C(C(C(C(O)O)O)(CCO)O)(O)=O,,,4,1,4,9,13
8386_0,,,,2,2,1,3
C(C(C)(C(C(C)O)O)O)=O,,,4,1,1,11,12
8388_0,,,,2,2,1,3
C(C(C)(C(C(CO)O)O)O)=O,,,4,1,5,12,17
8390_0,,,,2,2,1,3
C(C(C)(C(C(C(CO)O)O)O)O)=O,,,4,1,7,14,21
8391_0,,,,2,2,1,3
8392_0,,,,2,2,1,3
8393_0,,,,2,2,1,3
8394_0,,,,2,2,1,3
8395_0,,,,2,2,1,3
8397_0,,,,2,2,1,3
C(C(C)(C(C(CO)(CO)O)O)O)=O,,,4,1,2,9,11
8399_0,,,,2,2,1,3
C(C(C)(C(C=O)(C)O)O)=O,,,4,1,2,6,8
8400_0,,,,2,2,1,3
8402_0,,,,2,2,1,3
C(C(C)(C(CC=O)O)O)=O,,,4,1,9,20,29
8403_0,,,,2,2,1,3
8404_0,,,,2,2,1,3
8405_0,,,,2,2,1,3
8407_0,,,,2,2,1,3
C(C(C)(C(CC(C=O)O)O)O)=O,,,4,1,4,17,21
8409_0,,,,2,2,1,3
C(C(C)(C(CC(CO)=O)O)O)=O,,,4,1,5,14,19
8410_0,,,,2,2,1,3
8412_0,,,,2,2,1,3
C(C(C)(C(C(C(C)=O)O)O)O)=O,,,4,1,5,15,20
8414_0,,,,2,2,1,3
C(C(C)(C(C)(C(C=O)O)O)O)=O,,,4,1,3,16,19
8416_0,,,,2,2,1,3
C(C(C)(C(C)O)O)=O,,,4,1,1,32,33
8417_0,,,,2,2,1,3
8418_0,,,,2,2,1,3
8419_0,,,,2,2,1,3
8420_0,,,,2,2,1,3
8422_0,,,,2,2,1,3
C(C(CO)(C)O)=O,,,4,1,4,67,71
8423_0,,,,2,2,1,3
8425_0,,,,2,2,1,3
[C](C(O)=O)(C(C(C)O)O)O,,,4,1,2,6,8
8426_0,,,,2,2,1,3
8427_0,,,,2,2,1,3
8429_0,,,,2,2,1,3
C(C(C)(C(C(C)O)O)O)(O)=O,,,4,1,3,8,11
8431_0,,,,2,2,1,3
C(C(CCO)(C(C(C)O)O)O)(O)=O,,,4,1,4,10,14
8433_0,,,,2,2,1,3
[C](C(O)=O)(C(C(CO)O)O)O,,,4,1,5,8,13
8435_0,,,,2,2,1,3
[C](C(O)=O)(C(C(C(CO)O)O)O)O,,,4,1,7,11,18
8437_0,,,,2,2,1,3
C(C([C](C(O)=O)O)O)=O,,,4,1,18,26,44
8439_0,,,,2,2,1,3
C(C(C(C([C](C(O)=O)O)O)O)O)=O,,,4,1,8,17,25
8441_0,,,,2,2,1,3
[C](C(O)=O)(C(CO)(CO)O)O,,,4,1,3,3,6
8443_0,,,,2,2,1,3
[C](C(O)=O)(C(CO)(C(CO)O)O)O,,,4,1,6,8,14
8445_0,,,,2,2,1,3
C(C([C](C(O)=O)O)O)(O)=O,,,4,1,6,12,18
8447_0,,,,2,2,1,3
[C](C(O)=O)(C(C(CO)(CO)O)O)O,,,4,1,3,6,9
8449_0,,,,2,2,1,3
C(C([C](C(O)=O)O)(C)O)=O,,,4,1,3,8,11
8451_0,,,,2,2,1,3
C(C)(C([C](C(O)=O)O)O)=O,,,4,1,11,17,28
8453_0,,,,2,2,1,3
C(CC([C](C(O)=O)O)O)=O,,,4,1,9,16,25
8455_0,,,,2,2,1,3
C(C([C](C(O)=O)O)(CCO)O)=O,,,4,1,5,10,15
8457_0,,,,2,2,1,3
C(CCO)(C([C](C(O)=O)O)O)=O,,,4,1,6,10,16
8459_0,,,,2,2,1,3
C(CC(C([C](C(O)=O)O)O)O)=O,,,4,1,5,13,18
8461_0,,,,2,2,1,3
C(C(CC([C](C(O)=O)O)O)O)=O,,,4,1,5,13,18
8463_0,,,,2,2,1,3
C(CO)(CC([C](C(O)=O)O)O)=O,,,4,1,5,9,14
8465_0,,,,2,2,1,3
C(CC([C](C(O)=O)O)(CO)O)=O,,,4,1,6,11,17
8467_0,,,,2,2,1,3
C(C)(C(C([C](C(O)=O)O)O)O)=O,,,4,1,4,11,15
8469_0,,,,2,2,1,3
C(C(C([C](C(O)=O)O)(C)O)O)=O,,,4,1,4,13,17
8471_0,,,,2,2,1,3
[C](C(O)=O)(C(C)O)O,,,4,1,2,9,11
8473_0,,,,2,2,1,3
C(C([C](C(O)=O)O)(CO)O)=O,,,4,1,4,12,16
8475_0,,,,2,2,1,3
C(CO)(C([C](C(O)=O)O)O)=O,,,4,1,5,12,17
8477_0,,,,2,2,1,3
C(C([C](C(O)=O)O)(C(CO)O)O)=O,,,4,1,8,15,23
8479_0,,,,2,2,1,3
C(C(CO)O)(C([C](C(O)=O)O)O)=O,,,4,1,8,13,21
8481_0,,,,2,2,1,3
C([C](CO)O)(O)=O,,,4,1,2,11,13
8483_0,,,,2,2,1,3
[C](C(O)=O)(C(CO)O)O,,,4,1,4,7,11
8484_0,,,,2,1,2,3
8484_1,,,,2,1,2,3
8485_0,,,,2,1,2,3
8485_1,,,,2,1,2,3
8486_0,,,,2,1,2,3
8486_1,,,,2,1,2,3
8487_0,,,,2,1,2,3
8487_1,,,,2,1,2,3
8488_0,,,,2,1,2,3
8488_1,,,,2,1,2,3
8489_0,,,,2,1,2,3
8489_1,,,,2,1,2,3
8490_0,,,,2,1,2,3
8490_1,,,,2,1,2,3
8491_0,,,,2,1,2,3
8491_1,,,,2,1,2,3
8492_0,,,,2,1,2,3
8492_1,,,,2,1,2,3
8493_0,,,,2,1,2,3
8493_1,,,,2,1,2,3
8494_0,,,,2,1,2,3
8494_1,,,,2,1,2,3
8495_0,,,,2,1,2,3
8495_1,,,,2,1,2,3
8496_0,,,,2,1,2,3
8496_1,,,,2,1,2,3
8497_0,,,,2,1,2,3
8497_1,,,,2,1,2,3
8498_0,,,,2,1,2,3
8498_1,,,,2,1,2,3
8499_0,,,,2,1,2,3
8499_1,,,,2,1,2,3
8500_0,,,,2,1,2,3
8500_1,,,,2,1,2,3
8501_0,,,,2,1,2,3
8501_1,,,,2,1,2,3
8502_0,,,,2,1,2,3
8502_1,,,,2,1,2,3
8503_0,,,,2,1,2,3
8503_1,,,,2,1,2,3
8504_0,,,,2,1,2,3
8504_1,,,,2,1,2,3
8505_0,,,,2,1,2,3
8505_1,,,,2,1,2,3
8506_0,,,,2,1,2,3
8506_1,,,,2,1,2,3
8507_0,,,,2,1,2,3
8507_1,,,,2,1,2,3
8508_0,,,,2,1,2,3
8508_1,,,,2,1,2,3
8509_0,,,,2,1,2,3
8509_1,,,,2,1,2,3
8510_0,,,,2,1,2,3
8510_1,,,,2,1,2,3
8511_0,,,,2,1,2,3
8511_1,,,,2,1,2,3
8512_0,,,,2,1,2,3
8512_1,,,,2,1,2,3
8513_0,,,,2,1,2,3
8513_1,,,,2,1,2,3
8514_0,,,,2,1,2,3
8514_1,,,,2,1,2,3
8515_0,,,,2,1,2,3
8516_0,,,,2,1,2,3
8517_0,,,,2,1,2,3
8518_0,,,,2,1,2,3
8519_0,,,,2,1,2,3
8520_0,,,,2,1,2,3
8521_0,,,,2,1,2,3
8522_0,,,,2,1,2,3
8523_0,,,,2,1,2,3
8524_0,,,,2,1,2,3
8525_0,,,,2,1,2,3
8526_0,,,,2,1,2,3
8527_0,,,,2,1,2,3
8528_0,,,,2,1,2,3
8529_0,,,,2,1,2,3
8530_0,,,,2,1,2,3
8531_0,,,,2,1,2,3
8532_0,,,,2,1,2,3
8533_0,,,,2,1,2,3
8534_0,,,,2,1,2,3
8535_0,,,,2,1,2,3
8536_0,,,,2,1,2,3
8537_0,,,,2,1,2,3
8538_0,,,,2,1,2,3
8539_0,,,,2,1,2,3
8540_0,,,,2,1,2,3
8541_0,,,,2,1,2,3
8542_0,,,,2,1,2,3
8543_0,,,,2,1,2,3
8544_0,,,,2,1,2,3
8545_0,,,,2,1,2,3
8546_0,,,,2,1,2,3
8547_0,,,,2,1,2,3
8548_0,,,,2,1,2,3
8549_0,,,,2,1,2,3
8550_0,,,,2,1,2,3
8551_0,,,,2,1,2,3
8552_0,,,,2,1,2,3
8553_0,,,,2,1,2,3
8554_0,,,,2,1,2,3
8555_0,,,,2,1,2,3
8556_0,,,,2,1,2,3
8557_0,,,,2,1,2,3
8558_0,,,,2,1,2,3
8559_0,,,,2,1,2,3
8560_0,,,,2,1,2,3
8561_0,,,,2,1,2,3
8562_0,,,,2,1,2,3
8563_0,,,,2,1,2,3
8564_0,,,,2,1,2,3
8565_0,,,,2,1,2,3
8566_0,,,,2,1,2,3
8567_0,,,,2,1,2,3
8568_0,,,,2,1,2,3
8569_0,,,,2,1,2,3
8570_0,,,,2,1,2,3
8571_0,,,,2,1,2,3
8572_0,,,,2,1,2,3
8573_0,,,,2,1,2,3
8574_0,,,,2,1,2,3
8576_0,,,,2,1,1,2
C(CO)(OC(C=O)O)=O,,,4,1,1,23,24
8578_0,,,,2,1,1,2
C(CO)(OCC=O)=O,,,4,1,7,73,80
8580_0,,,,2,1,1,2
C(C(CO)OC(CO)=O)=O,,,4,1,3,15,18
8582_0,,,,2,1,1,2
C(C(C(CO)O)OC(CO)=O)=O,,,4,1,3,8,11
8584_0,,,,2,1,1,2
C(C(COC(CO)=O)O)=O,,,4,1,2,16,18
8586_0,,,,2,1,1,2
C(C(C(CO)OC(CO)=O)O)=O,,,4,1,2,7,9
8588_0,,,,2,1,1,2
C(C(C(COC(CO)=O)O)O)=O,,,4,1,7,11,18
8590_0,,,,2,1,2,3
C(CCC=O)(C(C(CO)O)O)=O,,,4,1,3,16,19
8591_0,,,,2,1,2,3
8593_0,,,,2,1,2,3
C(CC(CC(C(CO)O)O)=O)=O,,,4,1,4,15,19
8594_0,,,,2,1,2,3
8595_0,,,,2,1,2,3
8596_0,,,,2,1,2,3
8597_0,,,,2,1,2,3
8598_0,,,,2,1,2,3
8600_0,,,,2,1,2,3
C(C(C(CCC(C=O)=O)=O)O)=O,,,4,1,3,19,22
8601_0,,,,2,1,2,3
8603_0,,,,2,1,2,3
C(C(CC(CC(C=O)=O)=O)O)=O,,,4,1,5,23,28
8604_0,,,,2,1,2,3
8606_0,,,,2,1,2,3
C(C(C=O)CC(C(C=O)O)=O)=O,,,4,1,2,13,15
8607_0,,,,2,1,2,3
8609_0,,,,2,1,2,3
C(C(C=O)C(CC(C=O)O)=O)=O,,,4,1,4,15,19
8610_0,,,,2,1,2,3
8612_0,,,,2,1,2,3
C(C(C(CCC=O)=O)O)=O,,,4,1,7,28,35
8613_0,,,,2,1,2,3
8615_0,,,,2,1,2,3
C(CC(CC(C=O)O)=O)=O,,,4,1,12,34,46
8616_0,,,,2,1,2,3
8617_0,,,,2,1,2,3
8618_0,,,,2,1,2,3
8619_0,,,,2,1,2,3
8621_0,,,,2,1,2,3
C(C(CO)=O)(C(CO)CO)=O,,,4,1,6,11,17
8622_0,,,,2,1,2,3
8624_0,,,,2,1,2,3
C(C(CO)CC(C=O)=O)=O,,,4,1,7,23,30
8626_0,,,,2,1,2,3
C(C(C=O)C(C=O)CO)=O,,,4,1,6,18,24
8628_0,,,,2,1,2,3
C(C(CO)C(C(C=O)=O)CO)=O,,,4,1,8,19,27
8630_0,,,,2,1,2,3
C(C(C(C=O)C(C=O)CO)O)=O,,,4,1,9,20,29
8632_0,,,,2,1,2,3
C(C(CO)C(C=O)C(CO)=O)=O,,,4,1,7,17,24
8634_0,,,,2,1,2,3
C(CC(C(C(CO)CO)=O)=O)=O,,,4,1,5,12,17
8635_0,,,,2,1,2,3
8637_0,,,,2,1,2,3
C(C(CO)CC(C(C=O)O)=O)=O,,,4,1,6,18,24
8639_0,,,,2,1,2,3
C(C(CO)CC=O)=O,,,4,1,8,83,91
8641_0,,,,2,1,2,3
C(C(C(C(CO)CO)=O)=O)=O,,,4,1,5,12,17
8643_0,,,,2,1,2,3
C(C(CO)C(C(C=O)=O)O)=O,,,4,1,10,20,30
8644_0,,,,2,1,2,3
8645_0,,,,2,1,2,3
8647_0,,,,2,1,2,3
C(CO)(CC(C(O)=O)=O)=O,,,4,1,13,23,36
8648_0,,,,2,1,2,3
8650_0,,,,2,1,2,3
C(C(C(C(CO)=O)=O)C)=O,,,4,1,4,22,26
8652_0,,,,2,1,2,3
C(CO)(CC(C(C)=O)=O)=O,,,4,1,11,28,39
8654_0,,,,2,1,2,3
C(C)(CC(C(CO)=O)=O)=O,,,4,1,7,28,35
8656_0,,,,2,1,2,3
C(CC(CC(CO)=O)=O)=O,,,4,1,12,32,44
8658_0,,,,2,1,2,3
C(CCC(C(CO)=O)=O)=O,,,4,1,7,25,32
8660_0,,,,2,1,2,3
C(C(C(C(CO)=O)=O)CCO)=O,,,4,1,3,15,18
8662_0,,,,2,1,2,3
C(CO)(CC(C(CCO)=O)=O)=O,,,4,1,5,15,20
8664_0,,,,2,1,2,3
C(CCO)(CC(C(CO)=O)=O)=O,,,4,1,6,15,21
8666_0,,,,2,1,2,3
C(CC(CC(C(CO)=O)O)=O)=O,,,4,1,6,18,24
8668_0,,,,2,1,2,3
C(CCC(C(C(CO)=O)O)=O)=O,,,4,1,3,14,17
8670_0,,,,2,1,2,3
C(CC(C(CC(CO)=O)=O)O)=O,,,4,1,9,17,26
8671_0,,,,2,1,2,3
8673_0,,,,2,1,2,3
C(C(CC(CC(CO)=O)=O)O)=O,,,4,1,7,18,25
8675_0,,,,2,1,2,3
C(C(CCC(C(CO)=O)=O)O)=O,,,4,1,3,16,19
8677_0,,,,2,1,2,3
C(CC(CO)=O)(CC(CO)=O)=O,,,4,1,3,7,10
8679_0,,,,2,1,2,3
C(CO)(CCC(C(CO)=O)=O)=O,,,4,1,5,15,20
8681_0,,,,2,1,2,3
C(CC(C=O)C(C(CO)=O)O)=O,,,4,1,7,18,25
8683_0,,,,2,1,2,3
C(CC(C(C(CO)=O)=O)CO)=O,,,4,1,4,15,19
8685_0,,,,2,1,2,3
C(CO)(C(CC(C(C)=O)=O)O)=O,,,4,1,5,15,20
8687_0,,,,2,1,2,3
C(C(C(CO)=O)O)(CC(C)=O)=O,,,4,1,3,12,15
8689_0,,,,2,1,2,3
C(C(C(C)=O)O)(CC(CO)=O)=O,,,4,1,4,12,16
8690_0,,,,2,1,2,3
8692_0,,,,2,1,2,3
C(C(C(C(C=O)=O)C)O)(CO)=O,,,4,1,3,17,20
8694_0,,,,2,1,2,3
C(C(C(C(C(CO)=O)=O)C)O)=O,,,4,1,3,15,18
8696_0,,,,2,1,2,3
C(C)(CC(CO)=O)=O,,,4,1,17,126,143
8698_0,,,,2,1,2,3
C(C(CO)=O)(CC)=O,,,4,1,7,93,100
8699_0,,,,2,1,2,3
8701_0,,,,2,1,2,3
C(C(C(C(CO)=O)=O)CO)=O,,,4,1,6,17,23
8703_0,,,,2,1,2,3
C(CO)(CC(C(CO)=O)=O)=O,,,4,1,8,19,27
8704_0,,,,2,1,2,3
8705_0,,,,2,1,2,3
8706_0,,,,2,1,2,3
8707_0,,,,2,1,2,3
8708_0,,,,2,1,2,3
8709_0,,,,2,1,2,3
8710_0,,,,2,1,2,3
8712_0,,,,2,1,2,3
C(CC(C(CO)=O)=O)=O,,,4,1,16,45,61
8713_0,,,,2,1,2,3
8714_0,,,,2,1,2,3
8715_0,,,,2,1,2,3
8716_0,,,,2,1,2,3
8718_0,,,,2,1,2,3
C(C(C(CO)O)CC(C=O)=O)=O,,,4,1,6,19,25
8719_0,,,,2,1,2,3
8721_0,,,,2,1,2,3
C(CO)(C(CO)CC(C=O)=O)=O,,,4,1,5,19,24
8722_0,,,,2,1,2,3
8724_0,,,,2,1,2,3
C(C(C=O)C(C=O)C(CO)O)=O,,,4,1,7,14,21
8725_0,,,,2,1,2,3
8727_0,,,,2,1,2,3
C(C(C=O)C(C(CO)=O)CO)=O,,,4,1,6,12,18
8728_0,,,,2,1,2,3
8730_0,,,,2,1,2,3
C(C(C(CO)O)CC=O)=O,,,4,1,8,22,30
8731_0,,,,2,1,2,3
8733_0,,,,2,1,2,3
C(CO)(C(CO)CC=O)=O,,,4,1,6,26,32
8734_0,,,,2,1,2,3
8735_0,,,,2,1,2,3
8736_0,,,,2,1,2,3
8737_0,,,,2,1,2,3
8738_0,,,,2,1,2,3
8739_0,,,,2,1,2,3
8741_0,,,,2,1,2,3
C(C(CO)O)(CC(C(O)=O)=O)=O,,,4,1,9,15,24
8743_0,,,,2,1,2,3
C(CC(C(C(CO)O)=O)=O)(O)=O,,,4,1,7,14,21
8744_0,,,,2,1,2,3
8745_0,,,,2,1,2,3
8747_0,,,,2,1,2,3
C(C(C(C(C(CO)O)=O)=O)C)=O,,,4,1,4,16,20
8748_0,,,,2,1,2,3
8749_0,,,,2,1,2,3
8751_0,,,,2,1,2,3
C(C(CO)O)(CC(C(C)=O)=O)=O,,,4,1,7,16,23
8753_0,,,,2,1,2,3
C(C)(CC(C(C(CO)O)=O)=O)=O,,,4,1,5,16,21
8754_0,,,,2,1,2,3
8755_0,,,,2,1,2,3
8757_0,,,,2,1,2,3
C(CC(CC(C(CO)O)=O)=O)=O,,,4,1,8,16,24
8759_0,,,,2,1,2,3
C(CCC(C(C(CO)O)=O)=O)=O,,,4,1,5,15,20
8760_0,,,,2,1,2,3
8761_0,,,,2,1,2,3
8763_0,,,,2,1,2,3
C(C(CO)O)(CC(C)=O)=O,,,4,1,7,27,34
8765_0,,,,2,1,2,3
C(C(C(CO)O)=O)(CC)=O,,,4,1,4,20,24
8766_0,,,,2,1,2,3
8767_0,,,,2,1,2,3
8768_0,,,,2,1,2,3
8770_0,,,,2,1,2,3
C(CC(C(C(CO)O)=O)=O)=O,,,4,1,7,20,27
8771_0,,,,2,1,2,3
8772_0,,,,2,1,2,3
8773_0,,,,2,1,2,3
8774_0,,,,2,1,2,3
8775_0,,,,2,1,2,3
8776_0,,,,2,1,2,3
8777_0,,,,2,1,2,3
8778_0,,,,2,1,2,3
8779_0,,,,2,1,2,3
8780_0,,,,2,1,2,3
8782_0,,,,2,1,2,3
C(CC(C(CC(O)=O)=O)=O)=O,,,4,1,5,16,21
8784_0,,,,2,1,2,3
C(CC(CC(C(O)=O)=O)=O)=O,,,4,1,6,15,21
8785_0,,,,2,1,2,3
8787_0,,,,2,1,2,3
C(C(CC(C(O)=O)=O)=O)=O,,,4,1,10,21,31
8789_0,,,,2,1,2,3
C(C(C(CCC=O)=O)(CO)O)=O,,,4,1,5,13,18
8790_0,,,,2,1,2,3
8792_0,,,,2,1,2,3
C(C(CO)(CC(CC=O)=O)O)=O,,,4,1,6,17,23
8793_0,,,,2,1,2,3
8794_0,,,,2,1,2,3
8796_0,,,,2,1,2,3
C(C(CO)C(C=O)O)(CC=O)=O,,,4,1,10,22,32
8797_0,,,,2,1,2,3
8798_0,,,,2,1,2,3
8800_0,,,,2,1,2,3
C(C(CO)CO)(CC(C=O)=O)=O,,,4,1,4,14,18
8801_0,,,,2,1,2,3
8803_0,,,,2,1,2,3
C(C(C=O)C(C(CO)CO)=O)=O,,,4,1,4,9,13
8804_0,,,,2,1,2,3
8806_0,,,,2,1,2,3
C(CC(C(CO)CO)=O)=O,,,4,1,5,20,25
8807_0,,,,2,1,2,3
8808_0,,,,2,1,2,3
8809_0,,,,2,1,2,3
8810_0,,,,2,1,2,3
8811_0,,,,2,1,2,3
8812_0,,,,2,1,2,3
8813_0,,,,2,1,2,3
8815_0,,,,2,1,2,3
C(CC(C(CO)C(CO)O)=O)=O,,,4,1,7,17,24
8816_0,,,,2,1,2,3
8818_0,,,,2,1,2,3
C(C(C(CCC=O)=O)O)(O)=O,,,4,1,8,16,24
8819_0,,,,2,1,2,3
8821_0,,,,2,1,2,3
C(CC(CC(C(O)=O)O)=O)=O,,,4,1,10,18,28
8822_0,,,,2,1,2,3
8823_0,,,,2,1,2,3
8824_0,,,,2,1,2,3
8825_0,,,,2,1,2,3
8826_0,,,,2,1,2,3
8827_0,,,,2,1,2,3
8828_0,,,,2,1,2,3
8830_0,,,,2,1,2,3
C(C(C(C(CC=O)=O)=O)C)=O,,,4,1,2,15,17
8832_0,,,,2,1,2,3
C(C(C(C(C=O)=O)=O)C)=O,,,4,1,1,19,20
8834_0,,,,2,1,2,3
C(C(C(C=O)=O)C)=O,,,4,1,5,98,103
8836_0,,,,2,1,2,3
C(CC(C(CC(C)=O)=O)=O)=O,,,4,1,3,19,22
8838_0,,,,2,1,2,3
C(CC=O)(CC(C(C)=O)=O)=O,,,4,1,5,17,22
8840_0,,,,2,1,2,3
C(C)(CC(C(C=O)=O)=O)=O,,,4,1,4,28,32
8842_0,,,,2,1,2,3
C(C(CC(C(C)=O)=O)=O)=O,,,4,1,9,29,38
8843_0,,,,2,1,2,3
8845_0,,,,2,1,2,3
C(CC(C(C)=O)=O)=O,,,4,1,22,138,160
8847_0,,,,2,1,2,3
C(CC(CCC(C=O)=O)=O)=O,,,4,1,3,20,23
8849_0,,,,2,1,2,3
C(CCC(CC(C=O)=O)=O)=O,,,4,1,2,20,22
8851_0,,,,2,1,2,3
C(CC(C=O)CC(C=O)=O)=O,,,4,1,9,17,26
8853_0,,,,2,1,2,3
C(C(CCC(C(C)=O)=O)=O)=O,,,4,1,3,14,17
8855_0,,,,2,1,2,3
C(CC(C)=O)(CC(C=O)=O)=O,,,4,1,2,19,21
8857_0,,,,2,1,2,3
C(C=O)(C(C)CC(C=O)=O)=O,,,4,1,1,14,15
8859_0,,,,2,1,2,3
C(C(C=O)CC(C=O)=O)=O,,,4,1,3,22,25
8860_0,,,,2,1,2,3
8862_0,,,,2,1,2,3
C(C(C(CO)=O)CC(C=O)=O)=O,,,4,1,3,18,21
8863_0,,,,2,1,2,3
8864_0,,,,2,1,2,3
8865_0,,,,2,1,2,3
8867_0,,,,2,1,2,3
C(CO)(CCC(C=O)=O)=O,,,4,1,10,29,39
8868_0,,,,2,1,2,3
8870_0,,,,2,1,2,3
C(CCO)(CC(C=O)=O)=O,,,4,1,11,29,40
8871_0,,,,2,1,2,3
8873_0,,,,2,1,2,3
C(CCC(C=O)=O)(C(CO)O)=O,,,4,1,8,19,27
8874_0,,,,2,1,2,3
8876_0,,,,2,1,2,3
C(CC(CO)O)(CC(C=O)=O)=O,,,4,1,7,18,25
8877_0,,,,2,1,2,3
8878_0,,,,2,1,2,3
8879_0,,,,2,1,2,3
8881_0,,,,2,1,2,3
C(CCC(C=O)=O)=O,,,4,1,21,119,140
8882_0,,,,2,1,2,3
8884_0,,,,2,1,2,3
C(CC(C(CCC=O)=O)=O)=O,,,4,1,3,17,20
8886_0,,,,2,1,2,3
C(CC(CC(CC=O)=O)=O)=O,,,4,1,2,11,13
8888_0,,,,2,1,2,3
C(CCC(C(C=O)=O)=O)=O,,,4,1,4,24,28
8890_0,,,,2,1,2,3
C(CC(CC(C=O)=O)=O)=O,,,4,1,9,35,44
8891_0,,,,2,1,2,3
8893_0,,,,2,1,2,3
C(CC(CC=O)=O)=O,,,4,1,10,89,99
8895_0,,,,2,1,2,3
C(C(C=O)CC(CC=O)=O)=O,,,4,1,3,15,18
8897_0,,,,2,1,2,3
C(C(C=O)C(CCC=O)=O)=O,,,4,1,3,13,16
8899_0,,,,2,1,2,3
C(C(C=O)C(C=O)CC=O)=O,,,4,1,7,13,20
8901_0,,,,2,1,2,3
C(C(C=O)CC(C(C)=O)=O)=O,,,4,1,3,10,13
8903_0,,,,2,1,2,3
C(C(C=O)C(CC(C)=O)=O)=O,,,4,1,3,12,15
8905_0,,,,2,1,2,3
C(C(C=O)C(C(C=O)=O)C)=O,,,4,1,2,11,13
8907_0,,,,2,1,2,3
C(C(C=O)C(C=O)C=O)=O,,,4,1,1,9,10
8908_0,,,,2,1,2,3
8910_0,,,,2,1,2,3
C(C(C=O)C(C=O)C(CO)=O)=O,,,4,1,4,12,16
8911_0,,,,2,1,2,3
8912_0,,,,2,1,2,3
8913_0,,,,2,1,2,3
8915_0,,,,2,1,2,3
C(C(C=O)CC(CO)=O)=O,,,4,1,6,22,28
8916_0,,,,2,1,2,3
8918_0,,,,2,1,2,3
C(C(C=O)C(CCO)=O)=O,,,4,1,6,19,25
8919_0,,,,2,1,2,3
8921_0,,,,2,1,2,3
C(C(C=O)CC(C(CO)O)=O)=O,,,4,1,7,13,20
8922_0,,,,2,1,2,3
8924_0,,,,2,1,2,3
C(C(C=O)C(CC(CO)O)=O)=O,,,4,1,7,12,19
8925_0,,,,2,1,2,3
8926_0,,,,2,1,2,3
8927_0,,,,2,1,2,3
8929_0,,,,2,1,2,3
C(C(C=O)CC=O)=O,,,4,1,18,98,116
8930_0,,,,2,1,2,3
8932_0,,,,2,1,2,3
C(C(C(C(C=O)=O)=O)CCO)=O,,,4,1,1,15,16
8934_0,,,,2,1,2,3
C(C(C(C=O)=O)CCO)=O,,,4,1,4,20,24
8936_0,,,,2,1,2,3
C(CCO)(CC(C(C=O)=O)=O)=O,,,4,1,3,16,19
8938_0,,,,2,1,2,3
C(C(CC(C(CCO)=O)=O)=O)=O,,,4,1,4,17,21
8939_0,,,,2,1,2,3
8941_0,,,,2,1,2,3
C(CC(C(CCO)=O)=O)=O,,,4,1,10,27,37
8943_0,,,,2,1,2,3
C(C(C=O)C(C(C=O)=O)CO)=O,,,4,1,3,14,17
8945_0,,,,2,1,2,3
C(CC(C(C=O)=O)CO)(CO)=O,,,4,1,4,19,23
8946_0,,,,2,1,2,3
8948_0,,,,2,1,2,3
C(CCO)(C(C(C=O)=O)CO)=O,,,4,1,7,18,25
8949_0,,,,2,1,2,3
8951_0,,,,2,1,2,3
C(CC(C(C=O)=O)CO)=O,,,4,1,7,23,30
8953_0,,,,2,1,2,3
C(C)(C(C(C=O)=O)CO)=O,,,4,1,7,22,29
8955_0,,,,2,1,2,3
C(CC(CCC=O)=O)=O,,,4,1,3,61,64
8956_0,,,,2,1,2,3
8958_0,,,,2,1,2,3
C(CC(CC(C(C=O)=O)O)=O)=O,,,4,1,2,20,22
8960_0,,,,2,1,2,3
C(CC(C(CC(C=O)=O)=O)O)=O,,,4,1,7,22,29
8962_0,,,,2,1,2,3
C(CCC(C(C(C=O)=O)O)=O)=O,,,4,1,1,18,19
8964_0,,,,2,1,2,3
C(C(CCC(C(C=O)=O)=O)O)=O,,,4,1,2,18,20
8965_0,,,,2,1,2,3
8967_0,,,,2,1,2,3
C(C(CCC(C=O)=O)O)=O,,,4,1,12,25,37
8968_0,,,,2,1,2,3
8970_0,,,,2,1,2,3
C(C(C=O)C(C=O)C(C=O)O)=O,,,4,1,5,15,20
8972_0,,,,2,1,2,3
C(C(C(C=O)CC(CO)=O)O)=O,,,4,1,5,20,25
8973_0,,,,2,1,2,3
8975_0,,,,2,1,2,3
C(CCO)(C(C=O)C(C=O)O)=O,,,4,1,8,19,27
8976_0,,,,2,1,2,3
8978_0,,,,2,1,2,3
C(CC(C=O)C(C=O)O)=O,,,4,1,13,27,40
8980_0,,,,2,1,2,3
C(C(C(C)=O)C(C=O)O)=O,,,4,1,10,26,36
8982_0,,,,2,1,2,3
C(CO)(CCC(C(C=O)=O)=O)=O,,,4,1,3,17,20
8984_0,,,,2,1,2,3
C(CC(CO)=O)(CC(C=O)=O)=O,,,4,1,5,18,23
8985_0,,,,2,1,2,3
8986_0,,,,2,1,2,3
8988_0,,,,2,1,2,3
C(CC(C=O)CC=O)=O,,,4,1,14,27,41
8990_0,,,,2,1,2,3
C(CC(C(C(C=O)=O)=O)CO)=O,,,4,1,2,16,18
8992_0,,,,2,1,2,3
C(CC(C=O)C(C(C=O)=O)O)=O,,,4,1,5,18,23
8993_0,,,,2,1,2,3
8994_0,,,,2,1,2,3
8995_0,,,,2,1,2,3
8997_0,,,,2,1,2,3
C(C(C(CO)=O)CC(CO)=O)=O,,,4,1,4,17,21
8998_0,,,,2,1,2,3
9000_0,,,,2,1,2,3
C(CCO)(C(C=O)C(CO)=O)=O,,,4,1,5,13,18
9001_0,,,,2,1,2,3
9003_0,,,,2,1,2,3
C(C(C(CO)=O)CC=O)=O,,,4,1,9,27,36
9005_0,,,,2,1,2,3
C(C(C(C)=O)C(CO)=O)=O,,,4,1,9,24,33
9007_0,,,,2,1,2,3
C(CC(CC(C)=O)=O)=O,,,4,1,4,66,70
9009_0,,,,2,1,2,3
C(CC(C(CC)=O)=O)=O,,,4,1,2,49,51
9010_0,,,,2,1,2,3
9012_0,,,,2,1,2,3
C(C(C(C(CC=O)=O)=O)CO)=O,,,4,1,5,17,22
9014_0,,,,2,1,2,3
C(CC=O)(CC(C(CO)=O)=O)=O,,,4,1,2,16,18
9016_0,,,,2,1,2,3
C(CC(C(CC(CO)=O)=O)=O)=O,,,4,1,2,18,20
9017_0,,,,2,1,2,3
9018_0,,,,2,1,2,3
9020_0,,,,2,1,2,3
C(CC(C(C(CCO)=O)O)=O)=O,,,4,1,5,13,18
9021_0,,,,2,1,2,3
9022_0,,,,2,1,2,3
9024_0,,,,2,1,2,3
C(CC(C(CC(CO)O)=O)=O)=O,,,4,1,6,16,22
9025_0,,,,2,1,2,3
9027_0,,,,2,1,2,3
C(CC(C(CC=O)=O)=O)=O,,,4,1,5,18,23
9028_0,,,,2,1,2,3
9029_0,,,,2,1,2,3
9030_0,,,,2,1,2,3
9032_0,,,,2,1,2,3
C(CC(C(C(C)=O)O)=O)=O,,,4,1,7,27,34
9033_0,,,,2,1,2,3
9034_0,,,,2,1,2,3
9036_0,,,,2,1,2,3
C(CCC(C(C)=O)=O)=O,,,4,1,2,49,51
9037_0,,,,2,1,2,3
9038_0,,,,2,1,2,3
9040_0,,,,2,1,2,3
C(C(C(CC(C(C)=O)=O)O)=O)=O,,,4,1,2,15,17
9042_0,,,,2,1,2,3
C(C(C(C)=O)O)(CC(C=O)=O)=O,,,4,1,3,16,19
9044_0,,,,2,1,2,3
C(C(C(C=O)=O)O)(CC(C)=O)=O,,,4,1,1,16,17
9045_0,,,,2,1,2,3
9047_0,,,,2,1,2,3
C(C(CC(C(C)=O)=O)O)=O,,,4,1,7,27,34
9048_0,,,,2,1,2,3
9050_0,,,,2,1,2,3
C(C(C=O)O)(CC(C)=O)=O,,,4,1,8,28,36
9052_0,,,,2,1,2,3
C(CC(C(C=O)=O)C)=O,,,4,1,1,36,37
9054_0,,,,2,1,2,3
C(C(C(C(C(C=O)=O)=O)C)O)=O,,,4,1,2,16,18
9056_0,,,,2,1,2,3
C(C=O)(C(C)C(C(C=O)=O)O)=O,,,4,1,2,16,18
9058_0,,,,2,1,2,3
C(C(C(C(C=O)=O)C)O)=O,,,4,1,5,23,28
9059_0,,,,2,1,2,3
9061_0,,,,2,1,2,3
C(C(C(CCC(CO)=O)=O)O)=O,,,4,1,4,17,21
9062_0,,,,2,1,2,3
9064_0,,,,2,1,2,3
C(C(C=O)O)(CC(CCO)=O)=O,,,4,1,5,14,19
9065_0,,,,2,1,2,3
9066_0,,,,2,1,2,3
9067_0,,,,2,1,2,3
9069_0,,,,2,1,2,3
C(C(C(CC)=O)=O)=O,,,4,1,2,95,97
9070_0,,,,2,1,2,3
9072_0,,,,2,1,2,3
C(C(CC)=O)=O,,,4,1,12,409,421
9073_0,,,,2,1,2,3
9074_0,,,,2,1,2,3
9075_0,,,,2,1,2,3
9076_0,,,,2,1,2,3
9077_0,,,,2,1,2,3
9078_0,,,,2,1,2,3
9079_0,,,,2,1,2,3
9081_0,,,,2,1,2,3
C(CCC(CO)=O)=O,,,4,1,12,113,125
9082_0,,,,2,1,2,3
9084_0,,,,2,1,2,3
C(CC(CCO)=O)=O,,,4,1,19,113,132
9085_0,,,,2,1,2,3
9087_0,,,,2,1,2,3
C(CCC=O)(C(CO)O)=O,,,4,1,7,27,34
9088_0,,,,2,1,2,3
9090_0,,,,2,1,2,3
C(CC(CC(CO)O)=O)=O,,,4,1,9,26,35
9091_0,,,,2,1,2,3
9092_0,,,,2,1,2,3
9093_0,,,,2,1,2,3
9095_0,,,,2,1,2,3
C(CCC=O)=O,,,4,1,48,257,305
9096_0,,,,2,1,2,3
9098_0,,,,2,1,2,3
C(C(C(C(C=O)=O)=O)CO)=O,,,4,1,5,15,20
9100_0,,,,2,1,2,3
C(C(C=O)C(C(C=O)=O)O)=O,,,4,1,4,15,19
9102_0,,,,2,1,2,3
C(CO)(CC(C(C=O)=O)=O)=O,,,4,1,4,19,23
9104_0,,,,2,1,2,3
C(C(CC(C(CO)=O)=O)=O)=O,,,4,1,5,20,25
9105_0,,,,2,1,2,3
9106_0,,,,2,1,2,3
9107_0,,,,2,1,2,3
9108_0,,,,2,1,2,3
9109_0,,,,2,1,2,3
9110_0,,,,2,1,2,3
9111_0,,,,2,1,2,3
9113_0,,,,2,1,2,3
C(CC(C(C=O)=O)=O)=O,,,4,1,8,43,51
9114_0,,,,2,1,2,3
9115_0,,,,2,1,2,3
9116_0,,,,2,1,2,3
9117_0,,,,2,1,2,3
9118_0,,,,2,1,2,3
9119_0,,,,2,1,2,3
9120_0,,,,2,1,2,3
9121_0,,,,2,1,2,3
9122_0,,,,2,1,2,3
9123_0,,,,2,1,2,3
9124_0,,,,2,1,2,3
9125_0,,,,2,1,2,3
9126_0,,,,2,1,2,3
9127_0,,,,2,1,2,3
9128_0,,,,2,1,2,3
9129_0,,,,2,1,2,3
9130_0,,,,2,1,2,3
9131_0,,,,2,1,2,3
9132_0,,,,2,1,2,3
9133_0,,,,2,1,2,3
9134_0,,,,2,1,2,3
9135_0,,,,2,1,2,3
9136_0,,,,2,1,2,3
9137_0,,,,2,1,2,3
9138_0,,,,2,1,2,3
9139_0,,,,2,1,2,3
9140_0,,,,2,1,2,3
9141_0,,,,2,1,2,3
9142_0,,,,2,1,2,3
9143_0,,,,2,1,2,3
9144_0,,,,2,1,2,3
9145_0,,,,2,1,2,3
9147_0,,,,2,1,2,3
C(C(C)=O)(C)=O,,,4,1,9,256,265
9148_0,,,,2,1,2,3
9149_0,,,,2,1,2,3
9150_0,,,,2,1,2,3
9151_0,,,,2,1,2,3
9152_0,,,,2,1,2,3
9153_0,,,,2,1,2,3
9154_0,,,,2,1,2,3
9155_0,,,,2,1,2,3
9156_0,,,,2,1,2,3
9157_0,,,,2,1,2,3
9158_0,,,,2,1,2,3
9159_0,,,,2,1,2,3
9160_0,,,,2,1,2,3
9161_0,,,,2,1,2,3
9162_0,,,,2,1,2,3
9163_0,,,,2,1,2,3
9164_0,,,,2,1,2,3
9165_0,,,,2,1,2,3
9166_0,,,,2,1,2,3
9167_0,,,,2,1,2,3
9168_0,,,,2,1,2,3
9169_0,,,,2,1,2,3
9170_0,,,,2,1,2,3
9171_0,,,,2,1,2,3
9172_0,,,,2,1,2,3
9173_0,,,,2,1,2,3
9174_0,,,,2,1,2,3
9175_0,,,,2,1,2,3
9176_0,,,,2,1,2,3
9177_0,,,,2,1,2,3
9179_0,,,,2,1,2,3
C(C(C(C)=O)C(C(CO)O)O)=O,,,4,1,5,16,21
9180_0,,,,2,1,2,3
9181_0,,,,2,1,2,3
9182_0,,,,2,1,2,3
9183_0,,,,2,1,2,3
9184_0,,,,2,1,2,3
9185_0,,,,2,1,2,3
9186_0,,,,2,1,2,3
9187_0,,,,2,1,2,3
9189_0,,,,2,1,2,3
C(C(C(C(C)=O)=O)C(C=O)O)=O,,,4,1,5,17,22
9190_0,,,,2,1,2,3
9192_0,,,,2,1,2,3
C(C(C(CC=O)=O)C(C=O)O)=O,,,4,1,6,20,26
9193_0,,,,2,1,2,3
9194_0,,,,2,1,2,3
9195_0,,,,2,1,2,3
9196_0,,,,2,1,2,3
9197_0,,,,2,1,2,3
9198_0,,,,2,1,2,3
9199_0,,,,2,1,2,3
9200_0,,,,2,1,2,3
9201_0,,,,2,1,2,3
9203_0,,,,2,1,2,3
C(CO)(C(C(C(O)=O)=O)CO)=O,,,4,1,10,13,23
9204_0,,,,2,1,2,3
9205_0,,,,2,1,2,3
9207_0,,,,2,1,2,3
C(CO)(C(C(C(C)=O)=O)CO)=O,,,4,1,5,14,19
9208_0,,,,2,1,2,3
9210_0,,,,2,1,2,3
C(CC=O)(C(C(CO)=O)CO)=O,,,4,1,7,15,22
9211_0,,,,2,1,2,3
9213_0,,,,2,1,2,3
C(C)(C(C(CO)=O)CO)=O,,,4,1,7,22,29
9214_0,,,,2,1,2,3
9215_0,,,,2,1,2,3
9216_0,,,,2,1,2,3
9217_0,,,,2,1,2,3
9218_0,,,,2,1,2,3
9220_0,,,,2,1,2,3
C(C)(C(C(CO)=O)(CO)O)=O,,,4,1,8,10,18
9222_0,,,,2,1,2,3
C(CO)(C(C(CO)=O)CO)=O,,,4,1,7,9,16
9223_0,,,,2,1,2,3
9224_0,,,,2,1,2,3
9225_0,,,,2,1,2,3
9226_0,,,,2,1,2,3
9228_0,,,,2,1,2,3
C(C(C(C(C)=O)=O)CO)(O)=O,,,4,1,5,12,17
9229_0,,,,2,1,2,3
9231_0,,,,2,1,2,3
C(C(C(CC=O)=O)CO)(O)=O,,,4,1,7,15,22
9232_0,,,,2,1,2,3
9234_0,,,,2,1,2,3
C(C(C(C)=O)CO)(O)=O,,,4,1,4,25,29
9235_0,,,,2,1,2,3
9236_0,,,,2,1,2,3
9237_0,,,,2,1,2,3
9239_0,,,,2,1,2,3
C(C(C(C(CO)=O)=O)CO)(O)=O,,,4,1,7,12,19
9240_0,,,,2,1,2,3
9242_0,,,,2,1,2,3
C(C(C(C)=O)C(CO)O)(O)=O,,,4,1,5,13,18
9243_0,,,,2,1,2,3
9244_0,,,,2,1,2,3
9245_0,,,,2,1,2,3
9247_0,,,,2,1,2,3
C(C(C(C)=O)C(C(O)=O)=O)=O,,,4,1,5,13,18
9248_0,,,,2,1,2,3
9250_0,,,,2,1,2,3
C(C(C(C(C=O)=O)CO)=O)(O)=O,,,4,1,8,17,25
9252_0,,,,2,1,2,3
C(C(CO)(C(C=O)C(C)=O)O)=O,,,4,1,6,16,22
9253_0,,,,2,1,2,3
9254_0,,,,2,1,2,3
9256_0,,,,2,1,2,3
C(C(C(C)=O)C(C(O)=O)O)=O,,,4,1,10,15,25
9257_0,,,,2,1,2,3
9259_0,,,,2,1,2,3
C(C(C(C)=O)C(C=O)O)(O)=O,,,4,1,5,17,22
9260_0,,,,2,1,2,3
9261_0,,,,2,1,2,3
9262_0,,,,2,1,2,3
9263_0,,,,2,1,2,3
9264_0,,,,2,1,2,3
9265_0,,,,2,1,2,3
9266_0,,,,2,1,2,3
9268_0,,,,2,1,2,3
C(C(C(C)=O)C(C(C)=O)=O)=O,,,4,1,3,14,17
9269_0,,,,2,1,2,3
9271_0,,,,2,1,2,3
C(C(C(C(C(C)=O)=O)CO)=O)=O,,,4,1,5,16,21
9272_0,,,,2,1,2,3
9274_0,,,,2,1,2,3
C(C(C(C(C)=O)=O)CO)=O,,,4,1,7,20,27
9275_0,,,,2,1,2,3
9276_0,,,,2,1,2,3
9277_0,,,,2,1,2,3
9279_0,,,,2,1,2,3
C(C(C(C(C)=O)=O)C(CO)O)=O,,,4,1,8,16,24
9281_0,,,,2,1,2,3
C(C(C(CC=O)=O)C(C)=O)=O,,,4,1,3,15,18
9282_0,,,,2,1,2,3
9284_0,,,,2,1,2,3
C(CC=O)(C(C(C=O)=O)CO)=O,,,4,1,7,18,25
9285_0,,,,2,1,2,3
9287_0,,,,2,1,2,3
C(C(C(CC=O)=O)CO)=O,,,4,1,6,24,30
9288_0,,,,2,1,2,3
9289_0,,,,2,1,2,3
9290_0,,,,2,1,2,3
9292_0,,,,2,1,2,3
C(C(C(CC=O)=O)C(CO)O)=O,,,4,1,9,17,26
9293_0,,,,2,1,2,3
9294_0,,,,2,1,2,3
9296_0,,,,2,1,2,3
C(C(C(C(CCO)=O)=O)CO)=O,,,4,1,7,16,23
9297_0,,,,2,1,2,3
9299_0,,,,2,1,2,3
C(CC(C=O)O)(C(C=O)CO)=O,,,4,1,8,19,27
9300_0,,,,2,1,2,3
9302_0,,,,2,1,2,3
C(C(C(CC(CO)=O)=O)CO)=O,,,4,1,6,15,21
9303_0,,,,2,1,2,3
9305_0,,,,2,1,2,3
C(CC(C=O)C(C=O)(CO)O)=O,,,4,1,7,17,24
9307_0,,,,2,1,2,3
C(C(C(C)=O)C(C)=O)=O,,,4,1,2,31,33
9308_0,,,,2,1,2,3
9310_0,,,,2,1,2,3
C(C(C(C)=O)C(C(CO)=O)=O)=O,,,4,1,1,16,17
9311_0,,,,2,1,2,3
9312_0,,,,2,1,2,3
9314_0,,,,2,1,2,3
C(CCO)(C(C=O)(C(C)=O)O)=O,,,4,1,3,8,11
9316_0,,,,2,1,2,3
C(C(CO)O)(C(C=O)C(C)=O)=O,,,4,1,6,15,21
9317_0,,,,2,1,2,3
9319_0,,,,2,1,2,3
C(C(C(C)=O)C(C=O)=O)=O,,,4,1,7,25,32
9320_0,,,,2,1,2,3
9321_0,,,,2,1,2,3
9323_0,,,,2,1,2,3
C(C(C(C)=O)(C(C)=O)O)=O,,,4,1,2,8,10
9324_0,,,,2,1,2,3
9325_0,,,,2,1,2,3
9327_0,,,,2,1,2,3
C(C(CO)(CC(C(C)=O)=O)O)=O,,,4,1,5,14,19
9329_0,,,,2,1,2,3
C(C(C(C(C(C)=O)O)=O)CO)=O,,,4,1,5,13,18
9331_0,,,,2,1,2,3
C(C(C(CC(C)=O)=O)(CO)O)=O,,,4,1,6,12,18
9332_0,,,,2,1,2,3
9334_0,,,,2,1,2,3
C(C(CO)(C(C(C=O)=O)C)O)=O,,,4,1,4,16,20
9335_0,,,,2,1,2,3
9336_0,,,,2,1,2,3
9337_0,,,,2,1,2,3
9339_0,,,,2,1,2,3
C(C(C(C)=O)CO)=O,,,4,1,11,81,92
9340_0,,,,2,1,2,3
9341_0,,,,2,1,2,3
9342_0,,,,2,1,2,3
9344_0,,,,2,1,2,3
C(C(C(C)=O)C(CO)O)=O,,,4,1,8,20,28
9345_0,,,,2,1,2,3
9346_0,,,,2,1,2,3
9347_0,,,,2,1,2,3
9348_0,,,,2,1,2,3
9350_0,,,,2,1,2,3
C(C)(C(C(C=O)=O)(CO)O)=O,,,4,1,7,14,21
9351_0,,,,2,1,2,3
9352_0,,,,2,1,2,3
9353_0,,,,2,1,2,3
9354_0,,,,2,1,2,3
9355_0,,,,2,1,2,3
9356_0,,,,2,1,2,3
9357_0,,,,2,1,2,3
9358_0,,,,2,1,2,3
9359_0,,,,2,1,2,3
9360_0,,,,2,1,2,3
9361_0,,,,2,1,2,3
9363_0,,,,2,1,2,3
C(C(C(C(O)=O)=O)CC=O)=O,,,4,1,5,14,19
9365_0,,,,2,1,2,3
C(C(C(C(O)=O)=O)C)(O)=O,,,4,1,4,11,15
9367_0,,,,2,1,2,3
C(C(C(C(O)=O)=O)CCO)(O)=O,,,4,1,3,12,15
9368_0,,,,2,1,2,3
9369_0,,,,2,1,2,3
9370_0,,,,2,1,2,3
9371_0,,,,2,1,2,3
9373_0,,,,2,1,2,3
C(C(C(C(O)=O)=O)C)=O,,,4,1,2,22,24
9375_0,,,,2,1,2,3
C(C(C(C(C)=O)=O)CC=O)=O,,,4,1,5,14,19
9377_0,,,,2,1,2,3
C(C(C(C(C)=O)=O)C)(O)=O,,,4,1,3,14,17
9379_0,,,,2,1,2,3
C(C(C(C(C)=O)=O)CCO)(O)=O,,,4,1,1,11,12
9381_0,,,,2,1,2,3
C(C)(CC(C(O)=O)=O)=O,,,4,1,9,33,42
9383_0,,,,2,1,2,3
C(CC(C(C)=O)=O)(O)=O,,,4,1,7,32,39
9385_0,,,,2,1,2,3
C(C(C(CC=O)=O)CC=O)=O,,,4,1,4,18,22
9387_0,,,,2,1,2,3
C(CC=O)(C(C(O)=O)C)=O,,,4,1,2,19,21
9389_0,,,,2,1,2,3
C(C(C(CC=O)=O)CCO)(O)=O,,,4,1,1,13,14
9391_0,,,,2,1,2,3
C(CCC(C(O)=O)=O)=O,,,4,1,5,28,33
9393_0,,,,2,1,2,3
C(CC(CC(O)=O)=O)=O,,,4,1,7,40,47
9395_0,,,,2,1,2,3
C(C(C(C(O)=O)=O)CCO)=O,,,4,1,3,14,17
9397_0,,,,2,1,2,3
C(C(C(C(CCO)=O)=O)C)(O)=O,,,4,1,2,10,12
9399_0,,,,2,1,2,3
C(CCO)(CC(C(O)=O)=O)=O,,,4,1,7,15,22
9401_0,,,,2,1,2,3
C(CC(C(CCO)=O)=O)(O)=O,,,4,1,5,14,19
9403_0,,,,2,1,2,3
C(C(C(C)=O)CC=O)=O,,,4,1,8,51,59
9404_0,,,,2,1,2,3
9406_0,,,,2,1,2,3
C(C(C(C(CO)=O)=O)CC=O)=O,,,4,1,2,16,18
9407_0,,,,2,1,2,3
9408_0,,,,2,1,2,3
9410_0,,,,2,1,2,3
C(CCO)(C(C=O)(CC=O)O)=O,,,4,1,4,14,18
9412_0,,,,2,1,2,3
C(C(CO)O)(C(C=O)CC=O)=O,,,4,1,8,18,26
9413_0,,,,2,1,2,3
9415_0,,,,2,1,2,3
C(C(C(C=O)=O)CC=O)=O,,,4,1,7,26,33
9417_0,,,,2,1,2,3
C(C(C)(CC(CC=O)=O)O)(O)=O,,,4,1,4,12,16
9419_0,,,,2,1,2,3
C(CC(C(C(C(O)=O)C)=O)O)=O,,,4,1,2,12,14
9421_0,,,,2,1,2,3
C(C(C(CCC=O)=O)(C)O)(O)=O,,,4,1,1,9,10
9423_0,,,,2,1,2,3
C(CC(C=O)O)(C(C(O)=O)C)=O,,,4,1,3,14,17
9425_0,,,,2,1,2,3
C(C(CCC(C(O)=O)=O)O)=O,,,4,1,5,16,21
9427_0,,,,2,1,2,3
C(CC(CC(C=O)O)=O)(O)=O,,,4,1,5,20,25
9429_0,,,,2,1,2,3
C(C(C(CC(CO)=O)=O)C)(O)=O,,,4,1,2,9,11
9431_0,,,,2,1,2,3
C(CO)(CCC(C(O)=O)=O)=O,,,4,1,5,15,20
9433_0,,,,2,1,2,3
C(CC(CC(CO)=O)=O)(O)=O,,,4,1,6,15,21
9435_0,,,,2,1,2,3
C(C(C)(C(C=O)CC=O)O)(O)=O,,,4,1,6,14,20
9437_0,,,,2,1,2,3
C(CC(C(C(O)=O)=O)CO)=O,,,4,1,5,15,20
9439_0,,,,2,1,2,3
C(C(C(C=O)CC=O)O)(O)=O,,,4,1,10,17,27
9441_0,,,,2,1,2,3
C(C(C)(CC(C(C)=O)=O)O)(O)=O,,,4,1,3,10,13
9443_0,,,,2,1,2,3
C(C(C(C(C(C)=O)O)=O)C)(O)=O,,,4,1,1,8,9
9445_0,,,,2,1,2,3
C(C(C(CC(C)=O)=O)(C)O)(O)=O,,,4,1,1,8,9
9446_0,,,,2,1,2,3
9448_0,,,,2,1,2,3
C(C(CC(C(C)=O)=O)O)(O)=O,,,4,1,8,14,22
9450_0,,,,2,1,2,3
C(CC(C(C(C)=O)O)=O)(O)=O,,,4,1,3,13,16
9452_0,,,,2,1,2,3
C(C(C(O)=O)O)(CC(C)=O)=O,,,4,1,9,14,23
9454_0,,,,2,1,2,3
C(C(C)(C(C(C=O)=O)C)O)(O)=O,,,4,1,2,13,15
9456_0,,,,2,1,2,3
C(C(C(C(C(O)=O)=O)C)O)=O,,,4,1,3,15,18
9458_0,,,,2,1,2,3
C(C(C(C(C=O)=O)C)O)(O)=O,,,4,1,4,15,19
9460_0,,,,2,1,2,3
C(C)(C(C(O)=O)C)=O,,,4,1,2,61,63
9462_0,,,,2,1,2,3
C(C(C(C)=O)CCO)(O)=O,,,4,1,1,15,16
9464_0,,,,2,1,2,3
C(C(O)=O)(CC)=O,,,4,1,6,105,111
9466_0,,,,2,1,2,3
C(CC(C)=O)(O)=O,,,4,1,12,185,197
9467_0,,,,2,1,2,3
9469_0,,,,2,1,2,3
C(C(C(C(CO)=O)=O)C)(O)=O,,,4,1,3,11,14
9470_0,,,,2,1,2,3
9471_0,,,,2,1,2,3
9473_0,,,,2,1,2,3
C(C(C(CCO)=O)(C)O)(O)=O,,,4,1,2,9,11
9475_0,,,,2,1,2,3
C(C(C(C(CO)O)=O)C)(O)=O,,,4,1,5,13,18
9476_0,,,,2,1,2,3
9478_0,,,,2,1,2,3
C(C(C(C=O)=O)C)(O)=O,,,4,1,5,23,28
9480_0,,,,2,1,2,3
C(C(C(O)=O)C)=O,,,4,1,2,106,108
9481_0,,,,2,1,2,3
9482_0,,,,2,1,2,3
9484_0,,,,2,1,2,3
C(C(C(CO)=O)C)(O)=O,,,4,1,4,29,33
9486_0,,,,2,1,2,3
C(C(C(C=O)=O)CCO)(O)=O,,,4,1,3,15,18
9488_0,,,,2,1,2,3
C(C(C=O)CCO)(O)=O,,,4,1,2,21,23
9489_0,,,,2,1,2,3
9491_0,,,,2,1,2,3
C(C(C(C)=O)(CCO)O)(O)=O,,,4,1,3,8,11
9493_0,,,,2,1,2,3
C(C(C(CO)=O)CCO)(O)=O,,,4,1,2,12,14
9494_0,,,,2,1,2,3
9495_0,,,,2,1,2,3
9496_0,,,,2,1,2,3
9497_0,,,,2,1,2,3
9498_0,,,,2,1,2,3
9499_0,,,,2,1,2,3
9500_0,,,,2,1,2,3
9501_0,,,,2,1,2,3
9502_0,,,,2,1,2,3
9503_0,,,,2,1,2,3
9504_0,,,,2,1,2,3
9505_0,,,,2,1,2,3
9506_0,,,,2,1,2,3
9507_0,,,,2,1,2,3
9508_0,,,,2,1,2,3
9509_0,,,,2,1,2,3
9510_0,,,,2,1,2,3
9511_0,,,,2,1,2,3
9512_0,,,,2,1,2,3
9513_0,,,,2,1,2,3
9514_0,,,,2,1,2,3
9515_0,,,,2,1,2,3
9516_0,,,,2,1,2,3
9517_0,,,,2,1,2,3
9519_0,,,,2,1,2,3
C1(COC(CO)C1O)=O,,,4,1,2,33,35
9521_0,,,,2,1,2,3
C1(C(O)OC(CO)C1)=O,,,4,1,5,29,34
9523_0,,,,2,1,2,3
C1(CC(C(CO)O1)O)=O,,,4,1,6,11,17
9524_0,,,,2,1,2,3
9526_0,,,,2,1,2,3
C1(COC(C(CO)O)C1O)=O,,,4,1,2,9,11
9528_0,,,,2,1,2,3
C1(C(O)OC(C(CO)O)C1)=O,,,4,1,6,10,16
9530_0,,,,2,1,2,3
C1(CC(C(C(CO)O)O1)O)=O,,,4,1,4,4,8
9531_0,,,,2,1,2,3
9533_0,,,,2,1,2,3
C(CC1C(C(C(O)O1)O)O)=O,,,4,1,3,13,16
9535_0,,,,2,1,2,3
C(C)(C1C(C(C(O1)O)O)O)=O,,,4,1,3,12,15
9537_0,,,,2,1,2,3
C1(C(CO)OC(C1CO)O)=O,,,4,1,6,13,19
9539_0,,,,2,1,2,3
C1(C(CO)C(C(CO)O1)O)=O,,,4,1,3,5,8
9541_0,,,,2,1,2,3
C(C1C(O)OC(CO)C1O)=O,,,4,1,2,12,14
9543_0,,,,2,1,2,3
C(C1(C(COC1)=O)O)=O,,,4,1,4,22,26
9545_0,,,,2,1,2,3
C(C1C(C(O)OC1)=O)=O,,,4,1,6,28,34
9547_0,,,,2,1,2,3
C(C1(COC(C1)=O)O)=O,,,4,1,4,14,18
9548_0,,,,2,1,2,3
9549_0,,,,2,1,2,3
9551_0,,,,2,1,2,3
C(C1C(O)OCC1O)=O,,,4,1,2,23,25
9553_0,,,,2,1,2,3
C(C1(C(COC1CO)=O)O)=O,,,4,1,1,6,7
9555_0,,,,2,1,2,3
C(C1C(C(O)OC1CO)=O)=O,,,4,1,3,11,14
9557_0,,,,2,1,2,3
C(C1(C(CO)OC(C1)=O)O)=O,,,4,1,3,5,8
9559_0,,,,2,1,2,3
C(C(C1C(O)OCC1O)=O)=O,,,4,1,3,16,19
9560_0,,,,2,1,2,3
9561_0,,,,2,1,2,3
9562_0,,,,2,1,2,3
9563_0,,,,2,1,2,3
9564_0,,,,2,1,2,3
9566_0,,,,2,1,2,3
C(CO)(C1C(O)OCC1O)=O,,,4,1,4,12,16
9568_0,,,,2,1,2,3
C(C)(C1(C(O)OCC1O)O)=O,,,4,1,2,11,13
9570_0,,,,2,1,2,3
C1(C(C(CO1)=O)O)=O,,,4,1,5,87,92
9572_0,,,,2,1,2,3
C1(CC(C(O)O1)=O)=O,,,4,1,2,73,75
9574_0,,,,2,1,2,3
C1(CC(C(O1)=O)O)=O,,,4,1,5,39,44
9576_0,,,,2,1,2,3
C1(C(CC(O)O1)=O)=O,,,4,1,2,58,60
9578_0,,,,2,1,2,3
C1(COCC(C1O)O)=O,,,4,1,1,36,37
9580_0,,,,2,1,2,3
C1(C(O)OCC(C1)O)=O,,,4,1,4,30,34
9582_0,,,,2,1,2,3
C1(CC(C(CO1)O)O)=O,,,4,1,5,14,19
9584_0,,,,2,1,2,3
C1(COC(C(C1)O)O)=O,,,4,1,4,37,41
9586_0,,,,2,1,2,3
C1(C(COC(C1)O)O)=O,,,4,1,5,36,41
9588_0,,,,2,1,2,3
C1(C(C(O)OCC1)O)=O,,,4,1,5,38,43
9590_0,,,,2,1,2,3
C1(COC(CO)C(C1O)O)=O,,,4,1,1,10,11
9592_0,,,,2,1,2,3
C1(C(O)OC(CO)C(C1)O)=O,,,4,1,4,9,13
9594_0,,,,2,1,2,3
C1(CC(C(C(CO)O1)O)O)=O,,,4,1,3,5,8
9596_0,,,,2,1,2,3
C1(C(CO)OC(C(C1)O)O)=O,,,4,1,5,12,17
9598_0,,,,2,1,2,3
C1(C(C(CO)OC(C1)O)O)=O,,,4,1,4,10,14
9600_0,,,,2,1,2,3
C1(C(C(O)OC(CO)C1)O)=O,,,4,1,3,12,15
9602_0,,,,2,1,2,3
C1(COC(C(CO)(C1)O)O)=O,,,4,1,2,11,13
9604_0,,,,2,1,2,3
C1(CCOC(C1(CO)O)O)=O,,,4,1,4,12,16
9606_0,,,,2,1,2,3
C1(C(COC(C1CO)O)O)=O,,,4,1,4,12,16
9608_0,,,,2,1,2,3
C1(C(CO)C(C(CO1)O)O)=O,,,4,1,2,8,10
9610_0,,,,2,1,2,3
C(C1C(O)OCC(C1O)O)=O,,,4,1,2,14,16
9612_0,,,,2,1,2,3
C(C1(C(COCC1O)=O)O)=O,,,4,1,1,8,9
9614_0,,,,2,1,2,3
C(C1C(C(O)OCC1O)=O)=O,,,4,1,3,12,15
9616_0,,,,2,1,2,3
C(C1(C(COC(C1)=O)O)O)=O,,,4,1,2,8,10
9618_0,,,,2,1,2,3
C(C1C(COC(C1O)O)=O)=O,,,4,1,3,14,17
9620_0,,,,2,1,2,3
C1(COCC(C(C1O)O)O)=O,,,4,1,1,12,13
9622_0,,,,2,1,2,3
C1(C(O)OCC(C(C1)O)O)=O,,,4,1,4,11,15
9624_0,,,,2,1,2,3
C1(CC(C(C(CO1)O)O)O)=O,,,4,1,2,8,10
9626_0,,,,2,1,2,3
C1(C(COC(C(C1)O)O)O)=O,,,4,1,2,12,14
9628_0,,,,2,1,2,3
C1(C(C(C(O)OCC1)O)O)=O,,,4,1,2,14,16
9630_0,,,,2,1,2,3
C1(C(C(COC(C1)O)O)O)=O,,,4,1,3,13,16
9632_0,,,,2,1,2,3
C1(C(C(O)OCC(C1)O)O)=O,,,4,1,2,13,15
9634_0,,,,2,1,2,3
C1(COC(C(C(C1)O)O)O)=O,,,4,1,2,13,15
9636_0,,,,2,1,2,3
C1(C(OCC1)=O)=O,,,4,1,38,191,229
9638_0,,,,2,1,2,3
C1(CC(CO1)=O)=O,,,4,1,10,299,309
9640_0,,,,2,1,2,3
C1(C(CC(CO)O1)=O)=O,,,4,1,3,20,23
9642_0,,,,2,1,2,3
C1(CC(C(CO)O1)=O)=O,,,4,1,5,33,38
9644_0,,,,2,1,2,3
C1(C(CC(C(CO)O)O1)=O)=O,,,4,1,4,7,11
9646_0,,,,2,1,2,3
C1(CC(C(C(CO)O)O1)=O)=O,,,4,1,6,10,16
9648_0,,,,2,1,2,3
C(CC1C(C(C(O1)=O)O)O)=O,,,4,1,3,14,17
9650_0,,,,2,1,2,3
C1(C(C(C(C(C)=O)O1)O)O)=O,,,4,1,3,12,15
9652_0,,,,2,1,2,3
C1(C(CC(CO1)O)=O)=O,,,4,1,3,22,25
9654_0,,,,2,1,2,3
C1(C(CC(CO1)=O)O)=O,,,4,1,4,39,43
9656_0,,,,2,1,2,3
C1(CC(C(CO1)O)=O)=O,,,4,1,2,33,35
9658_0,,,,2,1,2,3
C1(C(C(CCO1)=O)O)=O,,,4,1,2,32,34
9660_0,,,,2,1,2,3
C1(C(CC(C(CO)O1)O)=O)=O,,,4,1,4,7,11
9662_0,,,,2,1,2,3
C1(CC(C(OC1CO)=O)O)=O,,,4,1,6,10,16
9664_0,,,,2,1,2,3
C1(CC(C(C(CO)O1)O)=O)=O,,,4,1,3,8,11
9666_0,,,,2,1,2,3
C1(C(C(CC(CO)O1)=O)O)=O,,,4,1,3,7,10
9668_0,,,,2,1,2,3
C1(C(CC(C(CO1)O)O)=O)=O,,,4,1,3,10,13
9670_0,,,,2,1,2,3
C1(CC(C(OCC1O)=O)O)=O,,,4,1,2,10,12
9672_0,,,,2,1,2,3
C1(C(C(C(OCC1)=O)O)O)=O,,,4,1,2,13,15
9674_0,,,,2,1,2,3
C1(CC(C(C(CO1)O)O)=O)=O,,,4,1,2,12,14
9676_0,,,,2,1,2,3
C1(C(C(CC(CO1)O)=O)O)=O,,,4,1,2,9,11
9678_0,,,,2,1,2,3
C1(C(C(CC(CO1)=O)O)O)=O,,,4,1,3,13,16
9679_0,,,,2,1,2,3
9681_0,,,,2,1,2,3
C(C)(C(C(C(O)=O)=O)O)=O,,,4,1,6,18,24
9683_0,,,,2,1,2,3
C(C(C(CCO)=O)=O)(O)=O,,,4,1,6,17,23
9685_0,,,,2,1,2,3
C(CC(C(C(O)=O)=O)O)=O,,,4,1,7,21,28
9686_0,,,,2,1,2,3
9688_0,,,,2,1,2,3
C(CCO)(C(C(C(O)=O)=O)O)=O,,,4,1,6,11,17
9690_0,,,,2,1,2,3
C(C(C(CC(CO)O)=O)=O)(O)=O,,,4,1,4,14,18
9691_0,,,,2,1,2,3
9693_0,,,,2,1,2,3
C(CO)(CC(C(C(O)=O)=O)O)=O,,,4,1,6,13,19
9694_0,,,,2,1,2,3
9696_0,,,,2,1,2,3
C(C(CC(C)=O)O)(O)=O,,,4,1,9,37,46
9698_0,,,,2,1,2,3
C(CCC(C(O)=O)O)=O,,,4,1,6,27,33
9700_0,,,,2,1,2,3
C(CC(C(O)=O)O)(CCO)=O,,,4,1,8,15,23
9701_0,,,,2,1,2,3
9703_0,,,,2,1,2,3
C(C(CCC(CO)=O)O)(O)=O,,,4,1,8,13,21
9704_0,,,,2,1,2,3
9705_0,,,,2,1,2,3
9706_0,,,,2,1,2,3
9707_0,,,,2,1,2,3
9708_0,,,,2,1,2,3
9710_0,,,,2,1,2,3
C(C(C(C(CO)O)O)O)=CC=O,,,4,1,4,11,15
9712_0,,,,2,1,2,3
C(C(C(C=CC(C=O)=O)O)O)=O,,,4,1,3,21,24
9714_0,,,,2,1,2,3
C(C(C(C=C(C=O)C=O)O)O)=O,,,4,1,3,16,19
9715_0,,,,2,1,2,3
9717_0,,,,2,1,2,3
C(CO)(CO)=CC(C=O)=O,,,4,1,3,13,16
9719_0,,,,2,1,2,3
C(CO)(CO)=C(C=O)C=O,,,4,1,2,9,11
9721_0,,,,2,1,2,3
C=C(C(C=O)=O)C(CO)(CO)O,,,4,1,3,12,15
9723_0,,,,2,1,2,3
C(CO)(CO)=C(C(C=O)=O)CO,,,4,1,2,9,11
9725_0,,,,2,1,2,3
C(C=C(C=O)C(CO)(CO)O)=O,,,4,1,3,9,12
9727_0,,,,2,1,2,3
C(C(C(C=O)=C(CO)CO)O)=O,,,4,1,4,10,14
9729_0,,,,2,1,2,3
C(CO)(CO)=C(C=O)C(CO)=O,,,4,1,3,6,9
9731_0,,,,2,1,2,3
C(C(C(C=C(CO)CO)=O)O)=O,,,4,1,2,7,9
9733_0,,,,2,1,2,3
C(CO)(CO)=CC=O,,,4,1,5,51,56
9735_0,,,,2,1,2,3
C(CO)(C(C(C=O)=C)O)=O,,,4,1,8,26,34
9737_0,,,,2,1,2,3
C(CO)(C(C=CC=O)O)=O,,,4,1,9,23,32
9739_0,,,,2,1,2,3
C(CO)(C(C(C=O)=CCO)O)=O,,,4,1,4,11,15
9740_0,,,,2,1,2,3
9741_0,,,,2,1,2,3
9742_0,,,,2,1,2,3
9743_0,,,,2,1,2,3
9745_0,,,,2,1,2,3
C(C(C=CC(C(CO)=O)O)O)=O,,,4,1,4,13,17
9747_0,,,,2,1,2,3
C(CO)(C(C=CC(CO)=O)O)=O,,,4,1,3,9,12
9749_0,,,,2,1,2,3
C(CO)(C(C(CO)=CC=O)O)=O,,,4,1,4,9,13
9751_0,,,,2,1,2,3
C(C(C(C(C(CO)=O)O)=C)O)=O,,,4,1,4,14,18
9753_0,,,,2,1,2,3
C(CO)(C(C=C)O)=O,,,4,1,7,74,81
9755_0,,,,2,1,2,3
C(CO)(C(CO)O)=CC(C=O)=O,,,4,1,3,9,12
9757_0,,,,2,1,2,3
C(CO)(C(CO)O)=C(C=O)C=O,,,4,1,3,6,9
9759_0,,,,2,1,2,3
C(CO)(C(CO)O)=CC=O,,,4,1,5,11,16
9761_0,,,,2,1,2,3
C(C(CO)O)(C(C(C=O)=C)O)=O,,,4,1,5,17,22
9763_0,,,,2,1,2,3
C(C(CO)O)(C(C=CC=O)O)=O,,,4,1,6,13,19
9765_0,,,,2,1,2,3
C(C(CO)O)(C(C=C)O)=O,,,4,1,5,18,23
9767_0,,,,2,1,2,3
C(C(C=CC(O)=O)=O)=O,,,4,1,3,36,39
9769_0,,,,2,1,2,3
C(C(C=O)=CC(O)=O)=O,,,4,1,2,29,31
9771_0,,,,2,1,2,3
C(C(C(C(C=O)=O)=C)O)(O)=O,,,4,1,5,16,21
9773_0,,,,2,1,2,3
C(C(C(CO)=CC(O)=O)=O)=O,,,4,1,2,12,14
9775_0,,,,2,1,2,3
C(C(C(C=O)=CC=O)O)(O)=O,,,4,1,4,14,18
9777_0,,,,2,1,2,3
C(C(C(C=O)=CC(O)=O)O)=O,,,4,1,4,14,18
9779_0,,,,2,1,2,3
C(C(C(CO)=O)=CC(O)=O)=O,,,4,1,3,11,14
9781_0,,,,2,1,2,3
C(C(C(C=CC(O)=O)=O)O)=O,,,4,1,2,12,14
9782_0,,,,2,1,2,3
9783_0,,,,2,1,2,3
9785_0,,,,2,1,2,3
C(C(C(C=CC=O)(CO)O)O)=O,,,4,1,9,16,25
9787_0,,,,2,1,2,3
C(C(CO)(CO)O)=CC(C=O)=O,,,4,1,2,8,10
9789_0,,,,2,1,2,3
C(C(CO)(CO)O)=C(C=O)C=O,,,4,1,1,5,6
9791_0,,,,2,1,2,3
C(C(CO)(CO)O)=CC=O,,,4,1,3,10,13
9793_0,,,,2,1,2,3
C(C(CO)(C(CO)O)O)=CC=O,,,4,1,4,8,12
9794_0,,,,2,1,2,3
9796_0,,,,2,1,2,3
C(C(C)=CC(C=O)=O)=O,,,4,1,2,57,59
9798_0,,,,2,1,2,3
C=C(C=O)CC(C=O)=O,,,4,1,3,57,60
9800_0,,,,2,1,2,3
C(C(C=O)=C(C=O)C)=O,,,4,1,1,47,48
9802_0,,,,2,1,2,3
C(C(C=O)C(C=O)=C)=O,,,4,1,3,47,50
9804_0,,,,2,1,2,3
C(C(C(C(C=O)=O)=C)(C)O)=O,,,4,1,2,13,15
9806_0,,,,2,1,2,3
C(C(C(CO)=C(C=O)C)=O)=O,,,4,1,1,13,14
9808_0,,,,2,1,2,3
C=C(C=O)C(C(C=O)=O)CO,,,4,1,3,16,19
9810_0,,,,2,1,2,3
C(C(C(C=O)=CC=O)(C)O)=O,,,4,1,2,12,14
9812_0,,,,2,1,2,3
C(C(C(C=O)=C(C=O)C)O)=O,,,4,1,2,15,17
9814_0,,,,2,1,2,3
C(C(C(C=O)=C)C(C=O)O)=O,,,4,1,4,18,22
9816_0,,,,2,1,2,3
C(C(C(CO)=O)=C(C=O)C)=O,,,4,1,2,14,16
9818_0,,,,2,1,2,3
C(C(C(CO)=O)C(C=O)=C)=O,,,4,1,5,18,23
9820_0,,,,2,1,2,3
C(CC(C(C(C=O)=C)O)=O)=O,,,4,1,3,18,21
9822_0,,,,2,1,2,3
C(C(C(C=C(C=O)C)=O)O)=O,,,4,1,1,15,16
9824_0,,,,2,1,2,3
C(C(C(CC(C=O)=C)=O)O)=O,,,4,1,2,18,20
9826_0,,,,2,1,2,3
C(C(C)=CC=O)=O,,,4,1,2,292,294
9828_0,,,,2,1,2,3
C(CC(C=O)=C)=O,,,4,1,9,283,292
9830_0,,,,2,1,2,3
C=C(C=O)C(C(C=O)=O)O,,,4,1,4,24,28
9832_0,,,,2,1,2,3
C(C(C(C=O)=C)O)=O,,,4,1,14,104,118
9834_0,,,,2,1,2,3
C(C(C=CC(C)=O)=O)=O,,,4,1,4,69,73
9836_0,,,,2,1,2,3
C(C(C=O)=CC(C)=O)=O,,,4,1,3,58,61
9838_0,,,,2,1,2,3
C(C)(C(C(C(C=O)=O)=C)O)=O,,,4,1,3,17,20
9840_0,,,,2,1,2,3
C(C(C(CO)=CC(C)=O)=O)=O,,,4,1,2,15,17
9842_0,,,,2,1,2,3
C(C)(C(C(C=O)=CC=O)O)=O,,,4,1,3,16,19
9844_0,,,,2,1,2,3
C(C(C(C=O)=CC(C)=O)O)=O,,,4,1,3,17,20
9846_0,,,,2,1,2,3
C(C(C(CO)=O)=CC(C)=O)=O,,,4,1,3,16,19
9848_0,,,,2,1,2,3
C(C(C(C=CC(C)=O)=O)O)=O,,,4,1,2,17,19
9850_0,,,,2,1,2,3
C(C=CC(C)=O)=O,,,4,1,4,357,361
9852_0,,,,2,1,2,3
C(CC(C=O)=O)=CC=O,,,4,1,5,57,62
9854_0,,,,2,1,2,3
C(CC=CC(C=O)=O)=O,,,4,1,4,58,62
9856_0,,,,2,1,2,3
C(CO)=C(C=O)CC(C=O)=O,,,4,1,2,12,14
9857_0,,,,2,1,2,3
9859_0,,,,2,1,2,3
C(C(C=C(C=O)CCO)=O)=O,,,4,1,1,13,14
9860_0,,,,2,1,2,3
9862_0,,,,2,1,2,3
C(C(C=CC(CCO)=O)=O)=O,,,4,1,3,19,22
9863_0,,,,2,1,2,3
9865_0,,,,2,1,2,3
C(CC(C=CC(C=O)=O)O)=O,,,4,1,4,19,23
9866_0,,,,2,1,2,3
9868_0,,,,2,1,2,3
C(C(C=CCC(C=O)=O)O)=O,,,4,1,3,18,21
9870_0,,,,2,1,2,3
C(C(CC=CC(C=O)=O)O)=O,,,4,1,2,17,19
9872_0,,,,2,1,2,3
C(CC(C=O)=O)=CC(CO)=O,,,4,1,3,17,20
9874_0,,,,2,1,2,3
C(CO)(CC=CC(C=O)=O)=O,,,4,1,3,18,21
9876_0,,,,2,1,2,3
C(CO)(CC(C=O)=O)=CC=O,,,4,1,1,14,15
9878_0,,,,2,1,2,3
C(CC(CO)=CC(C=O)=O)=O,,,4,1,2,14,16
9880_0,,,,2,1,2,3
C(C)(C(C=CC(C=O)=O)O)=O,,,4,1,3,15,18
9882_0,,,,2,1,2,3
C(C(C(CC(C=O)=O)=C)O)=O,,,4,1,1,18,19
9884_0,,,,2,1,2,3
C(C(C(C)=CC(C=O)=O)O)=O,,,4,1,1,15,16
9886_0,,,,2,1,2,3
C=CCC(C=O)=O,,,4,1,3,209,212
9888_0,,,,2,1,2,3
C(C)=CC(C=O)=O,,,4,1,2,218,220
9890_0,,,,2,1,2,3
C(C(CO)=CC(C=O)=O)=O,,,4,1,4,22,26
9892_0,,,,2,1,2,3
C(C(C=CC(CO)=O)=O)=O,,,4,1,9,32,41
9894_0,,,,2,1,2,3
C(C(C=C(C=O)C(CO)O)=O)=O,,,4,1,1,13,14
9896_0,,,,2,1,2,3
C(C(C=CC(C(CO)O)=O)=O)=O,,,4,1,3,17,20
9898_0,,,,2,1,2,3
C(C(CO)O)=CC(C=O)=O,,,4,1,6,15,21
9900_0,,,,2,1,2,3
C(C(C(CO)O)O)=CC(C=O)=O,,,4,1,7,11,18
9902_0,,,,2,1,2,3
C(C(C=CC=O)=O)=O,,,4,1,18,168,186
9904_0,,,,2,1,2,3
C(CO)=CC(C=O)=O,,,4,1,6,80,86
9906_0,,,,2,1,2,3
C(CC=C(C=O)C=O)=O,,,4,1,2,47,49
9908_0,,,,2,1,2,3
C(C(C=O)C=CC=O)=O,,,4,1,2,47,49
9910_0,,,,2,1,2,3
C(CC(C(C(C=O)=O)=C)O)=O,,,4,1,4,19,23
9912_0,,,,2,1,2,3
C(CC=C(C(C=O)=O)CO)=O,,,4,1,2,15,17
9914_0,,,,2,1,2,3
C(C(C(C=O)=O)CO)=CC=O,,,4,1,3,15,18
9916_0,,,,2,1,2,3
C(CC(C(C=O)=CC=O)O)=O,,,4,1,4,18,22
9918_0,,,,2,1,2,3
C(CC=C(C=O)C(C=O)O)=O,,,4,1,3,18,21
9920_0,,,,2,1,2,3
C(C(C=CC=O)C(C=O)O)=O,,,4,1,4,18,22
9922_0,,,,2,1,2,3
C(CC=C(C=O)C(CO)=O)=O,,,4,1,3,15,18
9924_0,,,,2,1,2,3
C(C(C(CO)=O)C=CC=O)=O,,,4,1,4,16,20
9926_0,,,,2,1,2,3
C(CC(C(C=CC=O)O)=O)=O,,,4,1,2,16,18
9928_0,,,,2,1,2,3
C(CC=CC(C(C=O)O)=O)=O,,,4,1,2,17,19
9930_0,,,,2,1,2,3
C(C(C(CC=CC=O)=O)O)=O,,,4,1,1,16,17
9932_0,,,,2,1,2,3
C(CC=CC=O)=O,,,4,1,4,283,287
9934_0,,,,2,1,2,3
C(C(C(C=O)=O)O)=CC=O,,,4,1,8,23,31
9936_0,,,,2,1,2,3
C(C(C=CC=O)O)=O,,,4,1,13,103,116
9938_0,,,,2,1,2,3
C(C(C=O)C(C=O)=CCO)=O,,,4,1,3,9,12
9939_0,,,,2,1,2,3
9941_0,,,,2,1,2,3
C(C(C=O)=C(C=O)CCO)=O,,,4,1,1,10,11
9942_0,,,,2,1,2,3
9944_0,,,,2,1,2,3
C(C(C=O)=CC(CCO)=O)=O,,,4,1,3,14,17
9945_0,,,,2,1,2,3
9947_0,,,,2,1,2,3
C(CC(C=C(C=O)C=O)O)=O,,,4,1,3,14,17
9948_0,,,,2,1,2,3
9950_0,,,,2,1,2,3
C(C(C=O)C=CC(C=O)O)=O,,,4,1,3,14,17
9952_0,,,,2,1,2,3
C(C(CC=C(C=O)C=O)O)=O,,,4,1,2,13,15
9954_0,,,,2,1,2,3
C(C(C=O)C=CC(CO)=O)=O,,,4,1,3,12,15
9956_0,,,,2,1,2,3
C(CO)(CC=C(C=O)C=O)=O,,,4,1,3,12,15
9958_0,,,,2,1,2,3
C(C(C=O)C(CO)=CC=O)=O,,,4,1,2,10,12
9960_0,,,,2,1,2,3
C(CC(CO)=C(C=O)C=O)=O,,,4,1,2,10,12
9962_0,,,,2,1,2,3
C(C)(C(C=C(C=O)C=O)O)=O,,,4,1,2,10,12
9964_0,,,,2,1,2,3
C(C(C=O)C(C(C=O)O)=C)=O,,,4,1,2,13,15
9966_0,,,,2,1,2,3
C(C(C(C)=C(C=O)C=O)O)=O,,,4,1,1,11,12
9968_0,,,,2,1,2,3
C(C(C=O)C=C)=O,,,4,1,2,148,150
9970_0,,,,2,1,2,3
C(C)=C(C=O)C=O,,,4,1,1,157,158
9972_0,,,,2,1,2,3
C(C(C=O)=C(C=O)CO)=O,,,4,1,1,18,19
9974_0,,,,2,1,2,3
C(C(C=O)=CC(CO)=O)=O,,,4,1,4,26,30
9976_0,,,,2,1,2,3
C(C(C=O)=C(C=O)C(CO)O)=O,,,4,1,1,10,11
9978_0,,,,2,1,2,3
C(C(C=O)=CC(C(CO)O)=O)=O,,,4,1,3,12,15
9980_0,,,,2,1,2,3
C(C(CO)O)=C(C=O)C=O,,,4,1,3,11,14
9982_0,,,,2,1,2,3
C(C(C(CO)O)O)=C(C=O)C=O,,,4,1,6,8,14
9984_0,,,,2,1,2,3
C(C(C=O)=CC=O)=O,,,4,1,12,138,150
9986_0,,,,2,1,2,3
C=C(C=O)C=O,,,4,1,6,345,351
9988_0,,,,2,1,2,3
C(CO)=C(C=O)C=O,,,4,1,5,59,64
9990_0,,,,2,1,2,3
C(C=C(C=O)CCO)=O,,,4,1,1,40,41
9992_0,,,,2,1,2,3
C(CC(C=O)=CCO)=O,,,4,1,3,37,40
9993_0,,,,2,1,2,3
9995_0,,,,2,1,2,3
C(CO)=C(C=O)C(C(C=O)=O)O,,,4,1,1,12,13
9996_0,,,,2,1,2,3
9998_0,,,,2,1,2,3
C(C(C(C=O)=CCO)O)=O,,,4,1,7,19,26
9999_0,,,,2,1,2,3
10001_0,,,,2,1,2,3
C(C=CC(CCO)=O)=O,,,4,1,3,58,61
10002_0,,,,2,1,2,3
10003_0,,,,2,1,2,3
10004_0,,,,2,1,2,3
10006_0,,,,2,1,2,3
C=CC(C(C=O)=O)CO,,,4,1,2,31,33
10008_0,,,,2,1,2,3
C(C)=C(C(C=O)=O)CO,,,4,1,1,31,32
10010_0,,,,2,1,2,3
C=C(C(C=O)=O)C(C)O,,,4,1,3,32,35
10012_0,,,,2,1,2,3
C(C(C(CO)=C(C=O)CO)=O)=O,,,4,1,1,12,13
10014_0,,,,2,1,2,3
C(C(C(C(C=O)=O)=C)(CO)O)=O,,,4,1,4,16,20
10016_0,,,,2,1,2,3
C(C(C(CO)=CC(CO)=O)=O)=O,,,4,1,1,14,15
10018_0,,,,2,1,2,3
C(CO)(C(C(C(C=O)=O)=C)O)=O,,,4,1,3,18,21
10020_0,,,,2,1,2,3
C(C(CO)O)=C(C(C=O)=O)CO,,,4,1,3,11,14
10022_0,,,,2,1,2,3
C=C(C(C=O)=O)C(C(CO)O)O,,,4,1,4,18,22
10024_0,,,,2,1,2,3
C(C(C(CO)=CC=O)=O)=O,,,4,1,7,23,30
10026_0,,,,2,1,2,3
C(C(C(C(C=O)=O)=C)O)=O,,,4,1,6,26,32
10028_0,,,,2,1,2,3
C=C(C(C=O)=O)CO,,,4,1,7,82,89
10030_0,,,,2,1,2,3
C(CO)=C(C(C=O)=O)CO,,,4,1,3,15,18
10032_0,,,,2,1,2,3
C=C(C(C=O)=O)C(CO)O,,,4,1,3,19,22
10033_0,,,,2,1,2,3
10034_0,,,,2,1,2,3
10036_0,,,,2,1,2,3
C(C(CC=CC=O)O)=O,,,4,1,3,41,44
10037_0,,,,2,1,2,3
10039_0,,,,2,1,2,3
C(CC=CC(C=O)O)=O,,,4,1,3,40,43
10040_0,,,,2,1,2,3
10042_0,,,,2,1,2,3
C(C(C=CC(C(C=O)=O)O)O)=O,,,4,1,2,17,19
10043_0,,,,2,1,2,3
10045_0,,,,2,1,2,3
C(C(C=CC(C=O)O)O)=O,,,4,1,4,11,15
10047_0,,,,2,1,2,3
C(C(C=C)C(C=O)O)=O,,,4,1,3,40,43
10049_0,,,,2,1,2,3
C(C(C(C=O)=CC)O)=O,,,4,1,2,40,42
10051_0,,,,2,1,2,3
C(C=C(C=O)C(C)O)=O,,,4,1,3,40,43
10053_0,,,,2,1,2,3
C(C(C(C=O)=C(C=O)CO)O)=O,,,4,1,3,13,16
10055_0,,,,2,1,2,3
C(C(C(C=O)=CC=O)(CO)O)=O,,,4,1,3,13,16
10057_0,,,,2,1,2,3
C(C(C(C=O)=CC(CO)=O)O)=O,,,4,1,3,15,18
10059_0,,,,2,1,2,3
C(CO)(C(C(C=O)=CC=O)O)=O,,,4,1,2,15,17
10061_0,,,,2,1,2,3
C(C(C(C=O)=CC(CO)O)O)=O,,,4,1,5,12,17
10063_0,,,,2,1,2,3
C(C=C(C=O)C(C(CO)O)O)=O,,,4,1,4,14,18
10065_0,,,,2,1,2,3
C(C(C(C=O)=CC=O)O)=O,,,4,1,8,28,36
10066_0,,,,2,1,2,3
10068_0,,,,2,1,2,3
C(C(CO)=CC=O)=O,,,4,1,8,110,118
10069_0,,,,2,1,2,3
10071_0,,,,2,1,2,3
C(C=C(C=O)C(CO)O)=O,,,4,1,4,20,24
10073_0,,,,2,1,2,3
C(CO)(CC=CC=O)=O,,,4,1,4,54,58
10075_0,,,,2,1,2,3
C(CC=CC(CO)=O)=O,,,4,1,3,54,57
10077_0,,,,2,1,2,3
C(C(C(C=O)=O)O)=CC(CO)=O,,,4,1,4,14,18
10079_0,,,,2,1,2,3
C(C(C=CC(CO)=O)O)=O,,,4,1,6,25,31
10081_0,,,,2,1,2,3
C(CC(CO)=CC=O)=O,,,4,1,2,38,40
10083_0,,,,2,1,2,3
C(CO)(C(C(C=O)=O)O)=CC=O,,,4,1,1,13,14
10085_0,,,,2,1,2,3
C(C(C(CO)=CC=O)O)=O,,,4,1,6,19,25
10087_0,,,,2,1,2,3
C(C(C(CO)=O)C=C)=O,,,4,1,4,44,48
10089_0,,,,2,1,2,3
C(C)=C(C=O)C(CO)=O,,,4,1,2,44,46
10091_0,,,,2,1,2,3
C(C(C(CO)=O)=C(C=O)CO)=O,,,4,1,2,11,13
10093_0,,,,2,1,2,3
C(C(C(CO)=O)=CC(CO)=O)=O,,,4,1,2,13,15
10095_0,,,,2,1,2,3
C(C(CO)O)=C(C=O)C(CO)=O,,,4,1,4,8,12
10097_0,,,,2,1,2,3
C(C(C(CO)=O)=CC=O)=O,,,4,1,6,30,36
10099_0,,,,2,1,2,3
C=C(C=O)C(CO)=O,,,4,1,10,121,131
10101_0,,,,2,1,2,3
C(CO)=C(C=O)C(CO)=O,,,4,1,5,18,23
10103_0,,,,2,1,2,3
C(CC(C(C=C)O)=O)=O,,,4,1,4,44,48
10105_0,,,,2,1,2,3
C(C)(C(C=CC=O)O)=O,,,4,1,4,45,49
10107_0,,,,2,1,2,3
C(C(C(C)=CC=O)O)=O,,,4,1,1,39,40
10109_0,,,,2,1,2,3
C(CC(C(C=O)O)=C)=O,,,4,1,1,39,40
10111_0,,,,2,1,2,3
C(C(C(C(C(C=O)=O)O)=C)O)=O,,,4,1,1,18,19
10113_0,,,,2,1,2,3
C(C(C(C(C=O)O)=C)O)=O,,,4,1,5,12,17
10115_0,,,,2,1,2,3
C(C(C(CC=C)=O)O)=O,,,4,1,1,44,45
10117_0,,,,2,1,2,3
C(C(C(C=CC)=O)O)=O,,,4,1,1,45,46
10119_0,,,,2,1,2,3
C(C(C(C=C(C=O)CO)=O)O)=O,,,4,1,2,12,14
10121_0,,,,2,1,2,3
C(C(C(C=CC(CO)=O)=O)O)=O,,,4,1,3,14,17
10123_0,,,,2,1,2,3
C(C(C(C=CC(CO)O)=O)O)=O,,,4,1,3,9,12
10125_0,,,,2,1,2,3
C(C(C(C=CC=O)=O)O)=O,,,4,1,7,31,38
10127_0,,,,2,1,2,3
C(C(C(C=C)=O)O)=O,,,4,1,11,122,133
10129_0,,,,2,1,2,3
C(C(C(C=CCO)=O)O)=O,,,4,1,3,19,22
10131_0,,,,2,1,2,3
C(C)=CC=O,,,4,1,2,934,936
10133_0,,,,2,1,2,3
C(CC=C)=O,,,4,1,2,804,806
10135_0,,,,2,1,2,3
C=CC(C(C=O)=O)O,,,4,1,5,73,78
10137_0,,,,2,1,2,3
C(C(C=C)O)=O,,,4,1,62,261,323
10138_0,,,,2,1,2,3
10140_0,,,,2,1,2,3
C(C=CC(CO)=O)=O,,,4,1,15,152,167
10141_0,,,,2,1,2,3
10143_0,,,,2,1,2,3
C(C=CC(C(CO)O)=O)=O,,,4,1,7,28,35
10145_0,,,,2,1,2,3
C(C(CO)O)=CC=O,,,4,1,8,56,64
10147_0,,,,2,1,2,3
C(C(C(CO)O)O)=CC=O,,,4,1,7,13,20
10149_0,,,,2,1,2,3
C=CC=O,,,4,1,24,1716,1740
10150_0,,,,2,1,2,3
10151_0,,,,2,1,2,3
10152_0,,,,2,1,2,3
10153_0,,,,2,1,2,3
10154_0,,,,2,1,2,3
10156_0,,,,2,1,2,3
C=C,,,4,1,2,1,3
10157_0,,,,2,1,2,3
10158_0,,,,2,1,2,3
10160_0,,,,2,1,2,3
C(C(C=C)(C(C(CO)O)O)O)=O,,,4,1,5,13,18
10162_0,,,,2,1,2,3
C(C(C(C=O)=C)(C(C=O)O)O)=O,,,4,1,5,18,23
10164_0,,,,2,1,2,3
C(C(C=CC=O)(C(C=O)O)O)=O,,,4,1,5,18,23
10165_0,,,,2,1,2,3
10167_0,,,,2,1,2,3
C(CO)(C(C(C=O)=C)(CO)O)=O,,,4,1,4,14,18
10169_0,,,,2,1,2,3
C(CO)(C(C=CC=O)(CO)O)=O,,,4,1,5,10,15
10171_0,,,,2,1,2,3
C(CO)(C(C=C)(CO)O)=O,,,4,1,4,13,17
10173_0,,,,2,1,2,3
C(C(C(C=O)=C)(CO)O)(O)=O,,,4,1,4,12,16
10175_0,,,,2,1,2,3
C(C(C=CC=O)(CO)O)(O)=O,,,4,1,3,9,12
10176_0,,,,2,1,2,3
10177_0,,,,2,1,2,3
10178_0,,,,2,1,2,3
10179_0,,,,2,1,2,3
10180_0,,,,2,1,2,3
10182_0,,,,2,1,2,3
C(C(C(C)=O)(C(C=O)=C)O)=O,,,4,1,3,12,15
10184_0,,,,2,1,2,3
C=C(C=O)C(C(C=O)=O)(CO)O,,,4,1,2,16,18
10186_0,,,,2,1,2,3
C(C(C(C=O)=C)(CO)O)=O,,,4,1,4,17,21
10188_0,,,,2,1,2,3
C(C(C(C=O)=C)(C(CO)O)O)=O,,,4,1,7,16,23
10190_0,,,,2,1,2,3
C(C(C(C)=O)(C=CC=O)O)=O,,,4,1,2,10,12
10192_0,,,,2,1,2,3
C(C(C(C=O)=O)(CO)O)=CC=O,,,4,1,3,14,17
10194_0,,,,2,1,2,3
C(C(C=CC=O)(CO)O)=O,,,4,1,4,15,19
10196_0,,,,2,1,2,3
C(C(C=CC=O)(C(CO)O)O)=O,,,4,1,7,12,19
10198_0,,,,2,1,2,3
C(C(C(C=O)=CCO)(CO)O)=O,,,4,1,5,11,16
10199_0,,,,2,1,2,3
10200_0,,,,2,1,2,3
10201_0,,,,2,1,2,3
10203_0,,,,2,1,2,3
C(C(C=CC(C=O)O)(CO)O)=O,,,4,1,5,13,18
10205_0,,,,2,1,2,3
C(C(C=CC(CO)=O)(CO)O)=O,,,4,1,4,10,14
10207_0,,,,2,1,2,3
C(C(C(CO)=CC=O)(CO)O)=O,,,4,1,5,10,15
10209_0,,,,2,1,2,3
C(C(C(C)=O)(C=C)O)=O,,,4,1,3,23,26
10211_0,,,,2,1,2,3
C(C(C(C(C=O)O)=C)(CO)O)=O,,,4,1,5,15,20
10213_0,,,,2,1,2,3
C=CC(C(C=O)=O)(CO)O,,,4,1,2,14,16
10215_0,,,,2,1,2,3
C(C(C=C)(CO)O)=O,,,4,1,4,26,30
10217_0,,,,2,1,2,3
C(C(C=C)(C(CO)O)O)=O,,,4,1,7,11,18
10218_0,,,,2,1,2,3
10220_0,,,,2,1,2,3
C=C(C(O)=O)C(CO)(CO)O,,,4,1,2,5,7
10221_0,,,,2,1,2,3
10223_0,,,,2,1,2,3
C(C(C(C(O)=O)=C)O)(O)=O,,,4,1,5,13,18
10225_0,,,,2,1,2,3
C(C(C(C(O)=O)=CCO)O)(O)=O,,,4,1,5,6,11
10226_0,,,,2,1,2,3
10227_0,,,,2,1,2,3
10229_0,,,,2,1,2,3
C(C(C(C=O)=C)(CC=O)O)=O,,,4,1,4,15,19
10231_0,,,,2,1,2,3
C(C(C(C(O)=O)=C)(C)O)=O,,,4,1,1,11,12
10233_0,,,,2,1,2,3
C(C(C(C=O)=C)(C)O)(O)=O,,,4,1,2,14,16
10235_0,,,,2,1,2,3
C(C(C(C(O)=O)=CCO)(C)O)=O,,,4,1,1,6,7
10236_0,,,,2,1,2,3
10238_0,,,,2,1,2,3
C(C(C(C=O)=C)(CCO)O)(O)=O,,,4,1,2,13,15
10240_0,,,,2,1,2,3
C(C(C(C=O)=C)O)(O)=O,,,4,1,8,27,35
10241_0,,,,2,1,2,3
10243_0,,,,2,1,2,3
C(C)(C(C(C(O)=O)=C)O)=O,,,4,1,3,17,20
10245_0,,,,2,1,2,3
C(C)(C(C(C(O)=O)=CCO)O)=O,,,4,1,1,6,7
10246_0,,,,2,1,2,3
10247_0,,,,2,1,2,3
10249_0,,,,2,1,2,3
C(C(C=CC=O)(CC=O)O)=O,,,4,1,4,16,20
10251_0,,,,2,1,2,3
C(CC(C(C(O)=O)=C)O)=O,,,4,1,2,19,21
10253_0,,,,2,1,2,3
C(C(C=CC=O)(C)O)(O)=O,,,4,1,1,12,13
10255_0,,,,2,1,2,3
C(CC(C(C(O)=O)=CCO)O)=O,,,4,1,1,8,9
10256_0,,,,2,1,2,3
10258_0,,,,2,1,2,3
C(C(C=CC=O)(CCO)O)(O)=O,,,4,1,1,9,10
10260_0,,,,2,1,2,3
C(C(C=CC=O)O)(O)=O,,,4,1,7,25,32
10262_0,,,,2,1,2,3
C(C(C(C(O)=O)=C)(CCO)O)=O,,,4,1,1,10,11
10264_0,,,,2,1,2,3
C(C(C(C=O)=CCO)(C)O)(O)=O,,,4,1,2,9,11
10265_0,,,,2,1,2,3
10267_0,,,,2,1,2,3
C(C(C(C=O)=CCO)O)(O)=O,,,4,1,7,11,18
10268_0,,,,2,1,2,3
10270_0,,,,2,1,2,3
C(CCO)(C(C(C(O)=O)=C)O)=O,,,4,1,2,10,12
10271_0,,,,2,1,2,3
10272_0,,,,2,1,2,3
10273_0,,,,2,1,2,3
10274_0,,,,2,1,2,3
10275_0,,,,2,1,2,3
10276_0,,,,2,1,2,3
10277_0,,,,2,1,2,3
10278_0,,,,2,1,2,3
10280_0,,,,2,1,2,3
C(CC(C(C(C(O)=O)=C)O)O)=O,,,4,1,2,13,15
10281_0,,,,2,1,2,3
10283_0,,,,2,1,2,3
C(C(CC(C(C(O)=O)=C)O)O)=O,,,4,1,2,13,15
10284_0,,,,2,1,2,3
10286_0,,,,2,1,2,3
C(C(C=CC(C=O)O)(C)O)(O)=O,,,4,1,2,10,12
10287_0,,,,2,1,2,3
10289_0,,,,2,1,2,3
C(C(C=CC(C=O)O)O)(O)=O,,,4,1,5,13,18
10291_0,,,,2,1,2,3
C(CO)(CC(C(C(O)=O)=C)O)=O,,,4,1,2,9,11
10293_0,,,,2,1,2,3
C(C(C=CC(CO)=O)(C)O)(O)=O,,,4,1,2,6,8
10295_0,,,,2,1,2,3
C(C(C=CC(CO)=O)O)(O)=O,,,4,1,7,10,17
10297_0,,,,2,1,2,3
C(CC(C(C(O)=O)=C)(CO)O)=O,,,4,1,1,11,12
10299_0,,,,2,1,2,3
C(C(C(CO)=CC=O)(C)O)(O)=O,,,4,1,1,8,9
10301_0,,,,2,1,2,3
C(C(C(CO)=CC=O)O)(O)=O,,,4,1,7,10,17
10303_0,,,,2,1,2,3
C(C)(C(C(C(C(O)=O)=C)O)O)=O,,,4,1,1,11,12
10305_0,,,,2,1,2,3
C(C(C(C(C(O)=O)=C)(C)O)O)=O,,,4,1,1,13,14
10307_0,,,,2,1,2,3
C(C(C(C(C=O)O)=C)(C)O)(O)=O,,,4,1,1,13,14
10309_0,,,,2,1,2,3
C(C(C(C(C=O)O)=C)O)(O)=O,,,4,1,7,15,22
10311_0,,,,2,1,2,3
C=C(C(O)=O)C(C)O,,,4,1,1,37,38
10313_0,,,,2,1,2,3
C(C(C=C)(C)O)(O)=O,,,4,1,1,8,9
10315_0,,,,2,1,2,3
C(CO)=C(C(O)=O)C(C)O,,,4,1,1,7,8
10316_0,,,,2,1,2,3
10318_0,,,,2,1,2,3
C(C(C=C)(CCO)O)(O)=O,,,4,1,1,7,8
10319_0,,,,2,1,2,3
10321_0,,,,2,1,2,3
C(C(C(C(O)=O)=C)(CO)O)=O,,,4,1,3,10,13
10323_0,,,,2,1,2,3
C(CO)(C(C(C(O)=O)=C)O)=O,,,4,1,2,11,13
10325_0,,,,2,1,2,3
C=C(C(O)=O)C(C(CO)O)O,,,4,1,3,10,13
10327_0,,,,2,1,2,3
C(C(C(C(O)=O)=C)O)=O,,,4,1,7,26,33
10329_0,,,,2,1,2,3
C=C(C(O)=O)CO,,,4,1,2,72,74
10331_0,,,,2,1,2,3
C=C(C(O)=O)C(CO)O,,,4,1,2,15,17
10333_0,,,,2,1,2,3
C(C(C(C(O)=O)=CCO)O)=O,,,4,1,3,10,13
10334_0,,,,2,1,2,3
10336_0,,,,2,1,2,3
C(CO)=C(C(O)=O)CO,,,4,1,2,12,14
10337_0,,,,2,1,2,3
10339_0,,,,2,1,2,3
C(CO)=C(C(O)=O)C(CO)O,,,4,1,2,6,8
10340_0,,,,2,1,2,3
10341_0,,,,2,1,2,3
10342_0,,,,2,1,2,3
10344_0,,,,2,1,2,3
C(C(CO)=CC(CO)=O)=O,,,4,1,4,24,28
10346_0,,,,2,1,2,3
C(C(C(C=C)=O)(CO)O)=O,,,4,1,4,15,19
10348_0,,,,2,1,2,3
C=C(C=O)C(C(CO)O)=O,,,4,1,5,24,29
10350_0,,,,2,1,2,3
C=C(C=O)C(C=O)=O,,,4,1,11,129,140
10352_0,,,,2,1,2,3
C(CO)=C(C=O)C(C=O)=O,,,4,1,4,17,21
10354_0,,,,2,1,2,3
C(CO)=CC(C(O)=O)=O,,,4,1,5,17,22
10356_0,,,,2,1,2,3
C(C=CC(CO)=O)(O)=O,,,4,1,6,36,42
10358_0,,,,2,1,2,3
C(C(C(C=C)=O)O)(O)=O,,,4,1,7,30,37
10360_0,,,,2,1,2,3
C(C(CO)O)=CC(C(O)=O)=O,,,4,1,4,8,12
10362_0,,,,2,1,2,3
C(C=CC(C(CO)O)=O)(O)=O,,,4,1,6,13,19
10364_0,,,,2,1,2,3
C(C(C(C=CCO)=O)O)(O)=O,,,4,1,4,9,13
10366_0,,,,2,1,2,3
C1COC(C=1)=O,,,4,1,2,234,236
10368_0,,,,2,1,2,3
C1OCC(C=1)=O,,,4,1,1,480,481
10369_0,,,,2,1,2,3
10371_0,,,,2,1,2,3
C(C(CO)O)=CC(O)=O,,,4,1,4,15,19
10373_0,,,,2,1,2,3
C(C(C=CCO)O)(O)=O,,,4,1,6,13,19
10375_0,,,,2,1,2,3
C(C(C(CO)O)O)=CC(O)=O,,,4,1,4,8,12
10377_0,,,,2,1,2,3
C(C(C=CC(CO)O)O)(O)=O,,,4,1,6,8,14
10379_0,,,,2,1,2,3
C(C=CC(O)=O)(O)=O,,,4,1,2,30,32
10380_0,,,,2,1,2,3
10381_0,,,,2,2,1,3
10382_0,,,,2,2,1,3
10383_0,,,,2,2,1,3
10384_0,,,,2,2,1,3
10385_0,,,,2,2,1,3
10386_0,,,,2,2,1,3
10387_0,,,,2,2,1,3
10388_0,,,,2,2,1,3
10389_0,,,,2,2,1,3
10390_0,,,,2,2,1,3
10391_0,,,,2,2,1,3
10392_0,,,,2,2,1,3
10393_0,,,,2,2,1,3
10394_0,,,,2,2,1,3
10395_0,,,,2,2,1,3
10396_0,,,,2,2,1,3
10397_0,,,,2,2,1,3
10398_0,,,,2,2,1,3
10399_0,,,,2,2,1,3
10400_0,,,,2,2,1,3
10401_0,,,,2,2,1,3
10402_0,,,,2,2,1,3
10403_0,,,,2,2,1,3
10404_0,,,,2,2,1,3
10405_0,,,,2,2,1,3
10406_0,,,,2,2,1,3
10407_0,,,,2,2,1,3
10408_0,,,,2,2,1,3
10409_0,,,,2,2,1,3
10410_0,,,,2,2,1,3
10411_0,,,,2,2,1,3
10412_0,,,,2,2,1,3
10413_0,,,,2,2,1,3
10414_0,,,,2,2,1,3
10415_0,,,,2,2,1,3
10416_0,,,,2,2,1,3
10417_0,,,,2,2,1,3
10418_0,,,,2,2,1,3
10419_0,,,,2,2,1,3
10420_0,,,,2,2,1,3
10421_0,,,,2,2,1,3
10422_0,,,,2,2,1,3
10423_0,,,,2,2,1,3
10424_0,,,,2,2,1,3
10425_0,,,,2,2,1,3
10426_0,,,,2,2,1,3
10427_0,,,,2,2,1,3
10428_0,,,,2,2,1,3
10429_0,,,,2,2,1,3
10430_0,,,,2,2,1,3
10431_0,,,,2,2,1,3
10432_0,,,,2,2,1,3
10433_0,,,,2,2,1,3
10434_0,,,,2,2,1,3
10435_0,,,,2,2,1,3
10436_0,,,,2,2,1,3
10437_0,,,,2,2,1,3
10438_0,,,,2,2,1,3
10439_0,,,,2,2,1,3
10440_0,,,,2,2,1,3
10441_0,,,,2,2,1,3
10442_0,,,,2,2,1,3
10443_0,,,,2,2,1,3
10444_0,,,,2,2,1,3
10445_0,,,,2,2,1,3
10446_0,,,,2,2,1,3
10447_0,,,,2,2,1,3
10448_0,,,,2,2,1,3
10449_0,,,,2,2,1,3
10450_0,,,,2,2,1,3
10451_0,,,,2,2,1,3
10452_0,,,,2,2,1,3
10453_0,,,,2,2,1,3
10454_0,,,,2,2,1,3
10455_0,,,,2,2,1,3
10456_0,,,,2,2,1,3
10457_0,,,,2,2,1,3
10458_0,,,,2,2,1,3
10459_0,,,,2,2,1,3
10460_0,,,,2,2,1,3
10461_0,,,,2,2,1,3
10462_0,,,,2,2,1,3
10463_0,,,,2,2,1,3
10464_0,,,,2,2,1,3
10465_0,,,,2,2,1,3
10466_0,,,,2,2,1,3
10467_0,,,,2,2,1,3
10468_0,,,,2,2,1,3
10469_0,,,,2,2,1,3
10470_0,,,,2,2,1,3
10471_0,,,,2,2,1,3
10472_0,,,,2,2,1,3
10473_0,,,,2,2,1,3
10474_0,,,,2,2,1,3
10475_0,,,,2,2,1,3
10476_0,,,,2,2,1,3
10477_0,,,,2,2,1,3
10478_0,,,,2,2,1,3
10479_0,,,,2,2,1,3
10480_0,,,,2,2,1,3
10481_0,,,,2,2,1,3
10482_0,,,,2,2,1,3
10483_0,,,,2,2,1,3
10484_0,,,,2,2,1,3
10485_0,,,,2,2,1,3
10486_0,,,,2,2,1,3
10487_0,,,,2,2,1,3
10488_0,,,,2,2,1,3
10489_0,,,,2,2,1,3
10490_0,,,,2,2,1,3
10491_0,,,,2,2,1,3
10492_0,,,,2,2,1,3
10493_0,,,,2,2,1,3
10494_0,,,,2,2,1,3
10495_0,,,,2,2,1,3
10496_0,,,,2,2,1,3
10497_0,,,,2,2,1,3
10498_0,,,,2,2,1,3
10499_0,,,,2,2,1,3
10500_0,,,,2,2,1,3
10501_0,,,,2,2,1,3
10502_0,,,,2,2,1,3
10503_0,,,,2,2,1,3
10504_0,,,,2,2,1,3
10505_0,,,,2,2,1,3
10506_0,,,,2,2,1,3
10507_0,,,,2,2,1,3
10508_0,,,,2,2,1,3
10509_0,,,,2,2,1,3
10510_0,,,,2,2,1,3
10511_0,,,,2,2,1,3
10512_0,,,,2,2,1,3
10513_0,,,,2,2,1,3
10514_0,,,,2,2,1,3
10515_0,,,,2,2,1,3
10516_0,,,,2,2,1,3
10517_0,,,,2,2,1,3
10518_0,,,,2,2,1,3
10519_0,,,,2,2,1,3
10520_0,,,,2,2,1,3
10521_0,,,,2,2,1,3
10522_0,,,,2,2,1,3
10523_0,,,,2,2,1,3
10524_0,,,,2,2,1,3
10525_0,,,,2,2,1,3
10526_0,,,,2,2,1,3
10527_0,,,,2,2,1,3
10528_0,,,,2,2,1,3
10529_0,,,,2,2,1,3
10530_0,,,,2,2,1,3
10531_0,,,,2,2,1,3
10532_0,,,,2,2,1,3
10533_0,,,,2,2,1,3
10534_0,,,,2,2,1,3
10535_0,,,,2,2,1,3
10536_0,,,,2,2,1,3
10537_0,,,,2,2,1,3
10538_0,,,,2,2,1,3
10539_0,,,,2,2,1,3
10540_0,,,,2,2,1,3
10541_0,,,,2,2,1,3
10542_0,,,,2,2,1,3
10543_0,,,,2,2,1,3
10544_0,,,,2,2,1,3
10545_0,,,,2,2,1,3
10546_0,,,,2,2,1,3
10547_0,,,,2,2,1,3
10548_0,,,,2,2,1,3
10549_0,,,,2,2,1,3
10550_0,,,,2,2,1,3
10551_0,,,,2,2,1,3
10552_0,,,,2,2,1,3
10553_0,,,,2,2,1,3
10554_0,,,,2,2,1,3
10555_0,,,,2,2,1,3
10556_0,,,,2,2,1,3
10557_0,,,,2,2,1,3
10558_0,,,,2,2,1,3
10559_0,,,,2,2,1,3
10560_0,,,,2,2,1,3
10561_0,,,,2,2,1,3
10562_0,,,,2,2,1,3
10563_0,,,,2,2,1,3
10564_0,,,,2,2,1,3
10565_0,,,,2,2,1,3
10566_0,,,,2,2,1,3
10567_0,,,,2,2,1,3
10568_0,,,,2,2,1,3
10569_0,,,,2,2,1,3
10570_0,,,,2,2,1,3
10571_0,,,,2,2,1,3
10572_0,,,,2,2,1,3
10573_0,,,,2,2,1,3
10574_0,,,,2,2,1,3
10575_0,,,,2,2,1,3
10576_0,,,,2,2,1,3
10577_0,,,,2,2,1,3
10578_0,,,,2,2,1,3
10579_0,,,,2,2,1,3
10580_0,,,,2,2,1,3
10581_0,,,,2,2,1,3
10582_0,,,,2,2,1,3
10583_0,,,,2,2,1,3
10584_0,,,,2,2,1,3
10585_0,,,,2,2,1,3
10586_0,,,,2,2,1,3
10587_0,,,,2,2,1,3
10588_0,,,,2,2,1,3
10589_0,,,,2,2,1,3
10590_0,,,,2,2,1,3
10591_0,,,,2,2,1,3
10592_0,,,,2,2,1,3
10593_0,,,,2,2,1,3
10594_0,,,,2,2,1,3
10595_0,,,,2,2,1,3
10596_0,,,,2,2,1,3
10597_0,,,,2,2,1,3
10598_0,,,,2,2,1,3
10599_0,,,,2,2,1,3
10600_0,,,,2,2,1,3
10601_0,,,,2,2,1,3
10602_0,,,,2,2,1,3
10603_0,,,,2,2,1,3
10604_0,,,,2,2,1,3
10605_0,,,,2,2,1,3
10606_0,,,,2,2,1,3
10607_0,,,,2,2,1,3
10608_0,,,,2,2,1,3
10609_0,,,,2,2,1,3
10610_0,,,,2,2,1,3
10611_0,,,,2,2,1,3
10612_0,,,,2,2,1,3
10613_0,,,,2,2,1,3
10614_0,,,,2,1,2,3
10616_0,,,,2,1,2,3
C=CCO,,,4,1,5,92,97
10617_0,,,,2,1,2,3
10619_0,,,,2,1,1,2
C(C(C(C1C(CC(O)O1)O)O)O)O,,,4,1,1,7,8
10621_0,,,,2,1,1,2
C(C(C(C1CC(C(O)O1)=O)O)O)=O,,,4,1,3,17,20
10623_0,,,,2,1,1,2
C(C(CC1C(C(C(O)O1)O)O)=O)=O,,,4,1,1,12,13
10625_0,,,,2,1,1,2
C(C(C1C(CC(C=O)(O)O1)O)O)=O,,,4,1,1,13,14
10627_0,,,,2,1,1,2
C(C(C=O)C1C(C(C(O)O1)O)O)=O,,,4,1,1,9,10
10629_0,,,,2,1,1,2
C(C1C(O)OC(C1O)C(C=O)O)=O,,,4,1,1,17,18
10630_0,,,,2,1,1,2
10632_0,,,,2,1,1,2
C(C(C1C(CC(O)O1)O)O)=O,,,4,1,6,12,18
10634_0,,,,2,1,1,2
C(C(C1C(C(C(O)O1)O)O)O)=O,,,4,1,2,13,15
10636_0,,,,2,1,1,2
C1C(CO)(C(C(CO)(O)O1)O)O,,,4,1,3,5,8
10638_0,,,,2,1,1,2
C1(C(O)OC(CO)(CO)C1)=O,,,4,1,5,7,12
10640_0,,,,2,1,1,2
C(C1(CC(CO)(CO1)O)O)=O,,,4,1,2,8,10
10642_0,,,,2,1,1,2
C(C1C(O)OCC1(CO)O)=O,,,4,1,3,13,16
10644_0,,,,2,1,1,2
C1(C(O)OC(CO)(CO)C1CO)=O,,,4,1,4,6,10
10645_0,,,,2,1,1,2
10647_0,,,,2,1,1,2
C(C1(C(CO)C(CO)(CO1)O)O)=O,,,4,1,2,9,11
10649_0,,,,2,1,1,2
C(C1C(C(O)OC1(CO)CO)O)=O,,,4,1,2,9,11
10651_0,,,,2,1,1,2
C(C(C1C(O)OCC1(CO)O)O)=O,,,4,1,3,11,14
10652_0,,,,2,1,1,2
10654_0,,,,2,1,1,2
C(CO)(C1C(O)OCC1(CO)O)=O,,,4,1,3,10,13
10656_0,,,,2,1,1,2
C(C1C(CO)(O)OCC1(CO)O)=O,,,4,1,2,12,14
10657_0,,,,2,1,1,2
10659_0,,,,2,1,1,2
C(CC1(C(C(CO1)(CO)O)O)O)=O,,,4,1,2,10,12
10661_0,,,,2,1,1,2
C(C(C1(CC(CO1)(CO)O)O)O)=O,,,4,1,2,12,14
10663_0,,,,2,1,1,2
C1C(CO)(CC(O)O1)O,,,4,1,2,8,10
10665_0,,,,2,1,1,2
C1(C(O)OC(CO)(CO)C1O)=O,,,4,1,2,4,6
10667_0,,,,2,1,1,2
C(C1(C(C(CO)(CO1)O)O)O)=O,,,4,1,2,10,12
10668_0,,,,2,1,1,2
10670_0,,,,2,1,1,2
C1(C(C(C(CO)(O)O1)O)O)=O,,,4,1,4,8,12
10672_0,,,,2,1,1,2
C(CO)(C1C(CC(O1)O)O)=O,,,4,1,8,10,18
10673_0,,,,2,1,1,2
10675_0,,,,2,1,1,2
C(CC1C(C(C(CO)(O)O1)O)O)=O,,,4,1,2,9,11
10677_0,,,,2,1,1,2
C(CO)(C(C1C(CC(O)O1)O)O)=O,,,4,1,3,7,10
10679_0,,,,2,1,1,2
C(CO)(C(C1CC(C(O)O1)O)O)=O,,,4,1,2,8,10
10681_0,,,,2,1,1,2
C(CO)(C1C(CC(CO)(O1)O)O)=O,,,4,1,2,8,10
10682_0,,,,2,1,1,2
10684_0,,,,2,1,1,2
C(CC1(COC(CO)(C1O)O)O)=O,,,4,1,2,10,12
10686_0,,,,2,1,1,2
C(CO)(C1C(CO)(CC(O1)O)O)=O,,,4,1,3,8,11
10688_0,,,,2,1,1,2
C(C)(C1C(C(C(CO)(O1)O)O)O)=O,,,4,1,2,9,11
10690_0,,,,2,1,1,2
C(CO)(C1C(C(C(C)(O1)O)O)O)=O,,,4,1,2,9,11
10692_0,,,,2,1,1,2
C(C1C(C)(C(C(CO)(O1)O)O)O)=O,,,4,1,2,10,12
10694_0,,,,2,1,1,2
C(CO)(C1C(C)(C(C(O1)O)O)O)=O,,,4,1,2,9,11
10696_0,,,,2,1,1,2
C(C1(COC(CO)(C1O)O)O)=O,,,4,1,2,11,13
10698_0,,,,2,1,1,2
C(C1(C(C(C(CO)O1)O)O)O)O,,,4,1,2,5,7
10700_0,,,,2,1,1,2
C1C(C(C(CO)(O)O1)O)O,,,4,1,3,5,8
10702_0,,,,2,1,1,2
C1(C(O)OC(CO)(C(CO)O)C1)=O,,,4,1,3,7,10
10704_0,,,,2,1,1,2
C(C1(CC(CO1)(C(CO)O)O)O)=O,,,4,1,2,10,12
10706_0,,,,2,1,1,2
C(C1(CC(CO)(C(CO)O1)O)O)=O,,,4,1,2,8,10
10708_0,,,,2,1,1,2
C(C1C(O)OCC1(C(CO)O)O)=O,,,4,1,2,13,15
10710_0,,,,2,1,1,2
C(C1C(O)OC(CO)C1(CO)O)=O,,,4,1,2,11,13
10712_0,,,,2,1,1,2
C1C(CC(O)O1)(C(CO)O)O,,,4,1,3,6,9
10714_0,,,,2,1,1,2
C(C1(CC(O)OC1CO)O)O,,,4,1,3,4,7
10716_0,,,,2,1,1,2
C1C(C(C(O)O1)O)(C(CO)O)O,,,4,1,3,7,10
10717_0,,,,2,1,1,2
10719_0,,,,2,1,1,2
C1(C(C(C(C(CO)O)(O)O1)O)O)=O,,,4,1,2,8,10
10721_0,,,,2,1,1,2
C(C1C(CC(O1)O)O)(C(CO)O)=O,,,4,1,5,10,15
10723_0,,,,2,1,1,2
C1C(C(C(C(CO)O)(O)O1)O)O,,,4,1,3,7,10
10725_0,,,,2,1,1,2
C(C1CC(C(O)O1)=O)(O)=O,,,4,1,4,18,22
10727_0,,,,2,1,1,2
C1(C(CC(C=O)(O)O1)O)=O,,,4,1,1,10,11
10729_0,,,,2,1,1,2
C(C1C(O)OC(C1O)=O)=O,,,4,1,2,17,19
10731_0,,,,2,1,1,2
C1(C(OC(C(O)=O)C1CO)O)=O,,,4,1,4,9,13
10732_0,,,,2,1,1,2
10734_0,,,,2,1,1,2
C1(C(C(CO)C(C=O)(O)O1)O)=O,,,4,1,1,8,9
10736_0,,,,2,1,1,2
C(C1C(C(OC1C(O)=O)O)O)=O,,,4,1,2,13,15
10738_0,,,,2,1,1,2
C1(C(C(C(O)O1)C(C=O)O)O)=O,,,4,1,2,11,13
10739_0,,,,2,1,1,2
10741_0,,,,2,1,1,2
C(CO)(C1C(O)OC(C1O)=O)=O,,,4,1,3,9,12
10743_0,,,,2,1,1,2
C(C1C(CO)(O)OC(C1O)=O)=O,,,4,1,2,12,14
10744_0,,,,2,1,1,2
10746_0,,,,2,1,1,2
C(CC1(C(C(C(O1)=O)O)O)O)=O,,,4,1,2,14,16
10748_0,,,,2,1,1,2
C1(C(CC(C(C=O)O)(O)O1)O)=O,,,4,1,1,13,14
10750_0,,,,2,1,1,2
C1(C(CC(O)O1)O)=O,,,4,1,1,28,29
10752_0,,,,2,1,1,2
C(C1C(C(C(O)O1)=O)O)(O)=O,,,4,1,5,11,16
10754_0,,,,2,1,1,2
C1(C(C(C(C=O)(O)O1)O)O)=O,,,4,1,1,12,13
10756_0,,,,2,1,1,2
C(CC1C(C(C(O)O1)(CO)O)O)=O,,,4,1,2,9,11
10758_0,,,,2,1,1,2
C(C(CO)(C1C(CC(O)O1)O)O)=O,,,4,1,4,10,14
10760_0,,,,2,1,1,2
C(CC1C(CO)(C(C(O)O1)O)O)=O,,,4,1,4,10,14
10762_0,,,,2,1,1,2
C(C(C1(CO)C(CC(O)O1)O)O)=O,,,4,1,4,9,13
10763_0,,,,2,1,1,2
10765_0,,,,2,1,1,2
C1(C(O)OC(C(CO)(CO)O)C1)=O,,,4,1,1,5,6
10767_0,,,,2,1,1,2
C(C1(CC(C(CO)(CO)O1)O)O)=O,,,4,1,1,6,7
10769_0,,,,2,1,1,2
C(C1C(O)OC(CO)(CO)C1O)=O,,,4,1,1,9,10
10771_0,,,,2,1,1,2
C(C1(CO)C(CC(O)O1)O)O,,,4,1,2,3,5
10773_0,,,,2,1,1,2
C(C1(CO)C(C(C(O)O1)O)O)O,,,4,1,2,5,7
10775_0,,,,2,1,1,2
C(C(C1(CO)C(CC(O)O1)O)O)O,,,4,1,3,5,8
10777_0,,,,2,1,1,2
C(C(C1C(CC(O)O1)O)O)(O)=O,,,4,1,5,7,12
10779_0,,,,2,1,1,2
C(C(C1C(C(C(O)O1)O)O)O)(O)=O,,,4,1,4,10,14
10781_0,,,,2,1,1,2
C(C1(C)CC(C(O1)O)=O)=O,,,4,1,3,16,19
10783_0,,,,2,1,1,2
C(C1(C)C(C(C(O1)O)=O)CO)=O,,,4,1,3,9,12
10784_0,,,,2,1,1,2
10786_0,,,,2,1,1,2
C(C(C1COC(C1(C)O)O)=O)=O,,,4,1,1,15,16
10788_0,,,,2,1,1,2
C(C1C(C)(C(OC1C=O)O)O)=O,,,4,1,1,13,14
10790_0,,,,2,1,1,2
C(C1C(C(OC1(C=O)C)O)O)=O,,,4,1,1,13,14
10791_0,,,,2,1,1,2
10792_0,,,,2,1,1,2
10794_0,,,,2,1,1,2
C(C1(C)C(C(C(O1)O)=O)O)=O,,,4,1,4,10,14
10796_0,,,,2,1,1,2
C(C)(C1CC(C(O)O1)=O)=O,,,4,1,6,22,28
10798_0,,,,2,1,1,2
C(C1C(C(C(O1)O)=O)CO)(C)=O,,,4,1,4,9,13
10799_0,,,,2,1,1,2
10801_0,,,,2,1,1,2
C(C(C1COC(C)(C1O)O)=O)=O,,,4,1,1,15,16
10803_0,,,,2,1,1,2
C(C1C(C(C)(OC1C=O)O)O)=O,,,4,1,1,13,14
10805_0,,,,2,1,1,2
C(C1C(C(OC1C(C)=O)O)O)=O,,,4,1,2,13,15
10806_0,,,,2,1,1,2
10807_0,,,,2,1,1,2
10809_0,,,,2,1,1,2
C1(C(O)OC(C(C)=O)C1O)=O,,,4,1,6,13,19
10811_0,,,,2,1,1,2
C(CC1CC(C(O)O1)=O)=O,,,4,1,5,25,30
10812_0,,,,2,1,1,2
10814_0,,,,2,1,1,2
C(C1(CCO)CC(C(O1)O)=O)=O,,,4,1,1,8,9
10816_0,,,,2,1,1,2
C1(C(OC(C(CCO)=O)C1)O)=O,,,4,1,3,9,12
10818_0,,,,2,1,1,2
C(CC1C(CC(C=O)(O)O1)O)=O,,,4,1,2,13,15
10820_0,,,,2,1,1,2
C(C(CC1C(CC(O)O1)O)=O)=O,,,4,1,1,12,13
10822_0,,,,2,1,1,2
C(CC(C1CC(C(O)O1)=O)O)=O,,,4,1,3,14,17
10824_0,,,,2,1,1,2
C(C(CC1CC(C(O)O1)O)=O)=O,,,4,1,1,13,14
10826_0,,,,2,1,1,2
C(C(CC1CC(C(O)O1)=O)O)=O,,,4,1,2,14,16
10828_0,,,,2,1,1,2
C(CO)(CC1CC(C(O)O1)=O)=O,,,4,1,3,10,13
10829_0,,,,2,1,1,2
10831_0,,,,2,1,1,2
C(CC1(COC(C=O)(C1)O)O)=O,,,4,1,2,14,16
10833_0,,,,2,1,1,2
C(CC1(CO)CC(C(O)O1)=O)=O,,,4,1,2,10,12
10835_0,,,,2,1,1,2
C(C1(CC(C(C(C)=O)O1)O)O)=O,,,4,1,2,10,12
10837_0,,,,2,1,1,2
C(C)(C(C1CC(C(O)O1)=O)O)=O,,,4,1,2,9,11
10839_0,,,,2,1,1,2
C(C1C(C)(CC(C=O)(O1)O)O)=O,,,4,1,1,11,12
10841_0,,,,2,1,1,2
C(C(C1(C)CC(C(O)O1)=O)O)=O,,,4,1,1,11,12
10843_0,,,,2,1,1,2
C1(C(O)OC(C)C1)=O,,,4,1,3,79,82
10845_0,,,,2,1,1,2
C(C1(COC(C=O)(C1)O)O)=O,,,4,1,1,9,10
10847_0,,,,2,1,1,2
C(C1(CO)CC(C(O1)O)=O)=O,,,4,1,4,11,15
10849_0,,,,2,1,1,2
C1(C(O)OC(C(CO)=O)C1)=O,,,4,1,5,13,18
10851_0,,,,2,1,1,2
C(C1(CC(C=O)(O)OC1CO)O)=O,,,4,1,1,9,10
10852_0,,,,2,1,1,2
10854_0,,,,2,1,1,2
C(C1(C(CO)O)CC(C(O1)O)=O)=O,,,4,1,2,10,12
10856_0,,,,2,1,1,2
C1(C(OC(C(C(CO)O)=O)C1)O)=O,,,4,1,3,11,14
10858_0,,,,2,1,1,2
C(C1(CC(C(CO)O1)O)O)=O,,,4,1,1,7,8
10859_0,,,,2,1,1,2
10861_0,,,,2,1,1,2
C(C1(CC(C(C(CO)O)O1)O)O)=O,,,4,1,4,8,12
10863_0,,,,2,1,1,2
C1(C(O)OC(C(C(CO)O)O)C1)=O,,,4,1,6,9,15
10865_0,,,,2,1,1,2
C(C1CC(C(O)O1)=O)=O,,,4,1,10,38,48
10867_0,,,,2,1,1,2
C(C1(CC(CO1)O)O)=O,,,4,1,1,12,13
10868_0,,,,2,1,1,2
10870_0,,,,2,1,1,2
C(CC1C(C(C(O)O1)=O)CO)=O,,,4,1,5,12,17
10871_0,,,,2,1,1,2
10873_0,,,,2,1,1,2
C(C1C(CC=O)OC(C1O)O)=O,,,4,1,3,15,18
10874_0,,,,2,1,1,2
10875_0,,,,2,1,1,2
10877_0,,,,2,1,1,2
C(CC(C1C(CC(O1)O)O)=O)=O,,,4,1,2,10,12
10879_0,,,,2,1,1,2
C(C(C1C(CC(O1)O)O)=O)=O,,,4,1,6,14,20
10881_0,,,,2,1,1,2
C(CC1C(C(C(O)O1)=O)O)=O,,,4,1,5,14,19
10883_0,,,,2,1,1,2
C(C1C(CC(O1)O)O)=O,,,4,1,11,26,37
10884_0,,,,2,1,1,2
10886_0,,,,2,1,1,2
C(C1C(O)OC(C1O)CC=O)=O,,,4,1,3,18,21
10888_0,,,,2,1,1,2
C(C(C=O)C1C(CC(O)O1)O)=O,,,4,1,2,8,10
10890_0,,,,2,1,1,2
C(C(C=O)C1CC(C(O)O1)O)=O,,,4,1,2,9,11
10891_0,,,,2,1,1,2
10893_0,,,,2,1,1,2
C(C1C(O)OCC1(CC=O)O)=O,,,4,1,3,16,19
10895_0,,,,2,1,1,2
C(C1C(C(C(C)=O)OC1O)O)=O,,,4,1,3,14,17
10897_0,,,,2,1,1,2
C(C1C(OC(C=O)C1(C)O)O)=O,,,4,1,2,15,17
10899_0,,,,2,1,1,2
C(C1C(O)OCC1(C=O)O)=O,,,4,1,2,14,16
10901_0,,,,2,1,1,2
C(C1C(O)OC(CO)C1(C=O)O)=O,,,4,1,1,12,13
10902_0,,,,2,1,1,2
10903_0,,,,2,1,1,2
10905_0,,,,2,1,1,2
C(C1C(O)OC(C1O)C(CO)O)=O,,,4,1,4,12,16
10906_0,,,,2,1,1,2
10907_0,,,,2,1,1,2
10909_0,,,,2,1,1,2
C(C1(CCO)C(C(C(O1)O)=O)O)=O,,,4,1,1,9,10
10910_0,,,,2,1,1,2
10911_0,,,,2,1,1,2
10913_0,,,,2,1,1,2
C(C1C(C(C(O1)O)=O)O)(CCO)=O,,,4,1,2,10,12
10915_0,,,,2,1,1,2
C1(C(O)OC(C)C1CO)=O,,,4,1,3,13,16
10916_0,,,,2,1,1,2
10918_0,,,,2,1,1,2
C(C1(COC(C=O)(C1CO)O)O)=O,,,4,1,1,10,11
10920_0,,,,2,1,1,2
C(C1(CO)C(C(C(O1)O)=O)CO)=O,,,4,1,4,10,14
10922_0,,,,2,1,1,2
C(C(C1COC(C1(CO)O)O)=O)=O,,,4,1,1,13,14
10923_0,,,,2,1,1,2
10925_0,,,,2,1,1,2
C(C1C(C(C(O1)O)=O)CO)(CO)=O,,,4,1,3,10,13
10927_0,,,,2,1,1,2
C(C(C1COC(CO)(C1O)O)=O)=O,,,4,1,1,13,14
10928_0,,,,2,1,1,2
10930_0,,,,2,1,1,2
C(C1(C(CO)C(C(CO)O1)O)O)=O,,,4,1,1,8,9
10932_0,,,,2,1,1,2
C1(C(O)OC(C(CO)O)C1CO)=O,,,4,1,5,9,14
10933_0,,,,2,1,1,2
10935_0,,,,2,1,1,2
C1(C(OC(C=O)C1CO)O)=O,,,4,1,5,12,17
10937_0,,,,2,1,1,2
C(C(C1COC(C1O)O)=O)=O,,,4,1,1,16,17
10938_0,,,,2,1,1,2
10939_0,,,,2,1,1,2
10941_0,,,,2,1,1,2
C(C1(C(CO)C(CO1)O)O)=O,,,4,1,2,8,10
10943_0,,,,2,1,1,2
C1(C(O)OC(CO)C1CO)=O,,,4,1,6,9,15
10944_0,,,,2,1,1,2
10946_0,,,,2,1,1,2
C(CC1C(CC(O)O1)O)=O,,,4,1,2,15,17
10948_0,,,,2,1,1,2
C(CC(C1C(C(C(O)O1)=O)O)O)=O,,,4,1,2,13,15
10950_0,,,,2,1,1,2
C(C(C(C1C(CC(O)O1)O)O)=O)=O,,,4,1,1,10,11
10952_0,,,,2,1,1,2
C(CC1C(C(C(C=O)(O)O1)O)O)=O,,,4,1,1,14,15
10954_0,,,,2,1,1,2
C(CC1CC(C(O)O1)O)=O,,,4,1,1,16,17
10956_0,,,,2,1,1,2
C(C(CC1C(C(C(O)O1)=O)O)O)=O,,,4,1,2,13,15
10958_0,,,,2,1,1,2
C(C(C(C1CC(C(O)O1)O)O)=O)=O,,,4,1,1,11,12
10960_0,,,,2,1,1,2
C(C(C1CC(C(O)O1)O)O)=O,,,4,1,4,13,17
10962_0,,,,2,1,1,2
C(C1C(C)OC(C1O)O)=O,,,4,1,1,14,15
10964_0,,,,2,1,1,2
C(C1(COC(C1C(C=O)O)O)O)=O,,,4,1,2,12,14
10966_0,,,,2,1,1,2
C(C1C(CO)(C(OC1C=O)O)O)=O,,,4,1,1,12,13
10968_0,,,,2,1,1,2
C(C1C(C(OC1(C=O)CO)O)O)=O,,,4,1,2,13,15
10970_0,,,,2,1,1,2
C(C1C(C(CO)(OC1C=O)O)O)=O,,,4,1,1,12,13
10972_0,,,,2,1,1,2
C(C1C(C(OC1C(CO)=O)O)O)=O,,,4,1,1,13,14
10974_0,,,,2,1,1,2
C(C(C1C(O)OC(CO)C1O)O)=O,,,4,1,2,10,12
10976_0,,,,2,1,1,2
C(C1C(C(CO)O)OC(C1O)O)=O,,,4,1,3,12,15
10978_0,,,,2,1,1,2
C(C1C(C(OC1C=O)O)O)=O,,,4,1,3,15,18
10980_0,,,,2,1,1,2
C(C1COC(C1O)O)=O,,,4,1,2,23,25
10982_0,,,,2,1,1,2
C(C(C1C(O)OCC1O)O)=O,,,4,1,3,12,15
10984_0,,,,2,1,1,2
C(C1C(CO)OC(C1O)O)=O,,,4,1,3,12,15
10986_0,,,,2,1,1,2
C(C(C1C(CC(CO)(O1)O)O)=O)=O,,,4,1,1,11,12
10988_0,,,,2,1,1,2
C(CO)(CC1C(C(C(O)O1)=O)O)=O,,,4,1,2,10,12
10990_0,,,,2,1,1,2
C(C1C(CC(CO)(O1)O)O)=O,,,4,1,4,11,15
10991_0,,,,2,1,1,2
10993_0,,,,2,1,1,2
C(C(C1C(CO)(CC(O1)O)O)=O)=O,,,4,1,1,12,13
10995_0,,,,2,1,1,2
C(CC1(CO)C(C(C(O)O1)=O)O)=O,,,4,1,1,9,10
10997_0,,,,2,1,1,2
C(CC1(COC(C=O)(C1O)O)O)=O,,,4,1,1,14,15
10998_0,,,,2,1,1,2
11000_0,,,,2,1,1,2
C(C1C(CO)(CC(O1)O)O)=O,,,4,1,5,11,16
11002_0,,,,2,1,1,2
C(CC1(COC(C1O)O)O)=O,,,4,1,3,13,16
11003_0,,,,2,1,1,2
11004_0,,,,2,1,1,2
11006_0,,,,2,1,1,2
C(C1(COC(C1C(CO)=O)O)O)=O,,,4,1,2,13,15
11008_0,,,,2,1,1,2
C(C1C(CO)(O)OCC1(C=O)O)=O,,,4,1,1,13,14
11009_0,,,,2,1,1,2
11010_0,,,,2,1,1,2
11012_0,,,,2,1,1,2
C(CO)(C1C(O)OC(CO)C1O)=O,,,4,1,2,9,11
11014_0,,,,2,1,1,2
C(C1C(CO)(O)OC(CO)C1O)=O,,,4,1,1,11,12
11015_0,,,,2,1,1,2
11016_0,,,,2,1,1,2
11017_0,,,,2,1,1,2
11018_0,,,,2,1,1,2
11020_0,,,,2,1,1,2
C(C1C(CO)(O)OCC1O)=O,,,4,1,3,13,16
11021_0,,,,2,1,1,2
11022_0,,,,2,1,1,2
11024_0,,,,2,1,1,2
C(C1(COC(C1O)(CC=O)O)O)=O,,,4,1,1,15,16
11025_0,,,,2,1,1,2
11026_0,,,,2,1,1,2
11028_0,,,,2,1,1,2
C(CC1(C(C(C(CO)O1)O)O)O)=O,,,4,1,1,9,10
11029_0,,,,2,1,1,2
11030_0,,,,2,1,1,2
11031_0,,,,2,1,1,2
11033_0,,,,2,1,1,2
C(CC1(C(C(CO1)O)O)O)=O,,,4,1,2,13,15
11034_0,,,,2,1,1,2
11036_0,,,,2,1,1,2
C(C)(C1C(CC(O1)O)O)=O,,,4,1,2,16,18
11038_0,,,,2,1,1,2
C(C(C1C(C(C(C)(O1)O)O)O)=O)=O,,,4,1,1,13,14
11040_0,,,,2,1,1,2
C(C)(C(C1C(C(C(O)O1)=O)O)O)=O,,,4,1,1,9,10
11042_0,,,,2,1,1,2
C(C1(C(C(C(C(C)=O)O1)O)O)O)=O,,,4,1,1,12,13
11044_0,,,,2,1,1,2
C(C1C(C(C(C)(O1)O)O)O)=O,,,4,1,4,12,16
11045_0,,,,2,1,1,2
11047_0,,,,2,1,1,2
C(C1C(C)(CC(O1)O)O)=O,,,4,1,1,15,16
11049_0,,,,2,1,1,2
C(C(C1C(C)(C(C(O1)O)O)O)=O)=O,,,4,1,1,13,14
11051_0,,,,2,1,1,2
C(C(C1(C)C(C(C(O)O1)=O)O)O)=O,,,4,1,1,10,11
11053_0,,,,2,1,1,2
C(C1C(C)(C(C(C=O)(O1)O)O)O)=O,,,4,1,1,12,13
11055_0,,,,2,1,1,2
C(C1C(C)(C(C(O1)O)O)O)=O,,,4,1,4,12,16
11057_0,,,,2,1,1,2
C(C1(COC(C1)(C(C=O)O)O)O)=O,,,4,1,1,15,16
11059_0,,,,2,1,1,2
C(C(C1(CC(C(CO)O1)O)O)O)=O,,,4,1,1,10,11
11061_0,,,,2,1,1,2
C(C(C1(CC(CO1)O)O)O)=O,,,4,1,1,14,15
11063_0,,,,2,1,1,2
C1(C(O)OC(C)C1O)=O,,,4,1,4,28,32
11065_0,,,,2,1,1,2
C(C1(COC(C1)O)O)=O,,,4,1,2,12,14
11067_0,,,,2,1,1,2
C(C1(C(CO)OC(C1)O)O)=O,,,4,1,2,7,9
11068_0,,,,2,1,1,2
11070_0,,,,2,1,1,2
C(C1C(CC(O)O1)O)O,,,4,1,2,8,10
11072_0,,,,2,1,1,2
C(C(C1C(CC(O)O1)O)O)O,,,4,1,4,5,9
11074_0,,,,2,1,1,2
C1C(CC(O)O1)O,,,4,1,1,39,40
11076_0,,,,2,1,1,2
C(C1(CO)C(C(C(O1)O)=O)O)=O,,,4,1,3,12,15
11078_0,,,,2,1,1,2
C(C1(COC(C=O)(C1O)O)O)=O,,,4,1,1,14,15
11080_0,,,,2,1,1,2
C1(C(O)OC(C(CO)=O)C1O)=O,,,4,1,1,9,10
11082_0,,,,2,1,1,2
C(C1(C(C(C(CO)O1)O)O)O)=O,,,4,1,2,10,12
11084_0,,,,2,1,1,2
C1(C(O)OC(C(CO)O)C1O)=O,,,4,1,3,7,10
11086_0,,,,2,1,1,2
C(C1C(C(C(O)O1)=O)O)=O,,,4,1,8,24,32
11088_0,,,,2,1,1,2
C(C1(C(C(CO1)O)O)O)=O,,,4,1,2,10,12
11090_0,,,,2,1,1,2
C1(C(O)OC(CO)C1O)=O,,,4,1,6,14,20
11091_0,,,,2,1,1,2
11093_0,,,,2,1,1,2
C1(COC(C1(CO)O)O)=O,,,4,1,4,16,20
11095_0,,,,2,1,1,2
C1(COC(C1(C(CO)O)O)O)=O,,,4,1,3,12,15
11097_0,,,,2,1,1,2
C(C1(C(CO)(O)OCC1O)O)=O,,,4,1,2,12,14
11098_0,,,,2,1,1,2
11100_0,,,,2,1,1,2
C1CC(C(O)O1)O,,,4,1,1,40,41
11102_0,,,,2,1,1,2
C1(C(C(CO)(C(O)O1)O)O)=O,,,4,1,4,7,11
11103_0,,,,2,1,1,2
11104_0,,,,2,1,1,2
11106_0,,,,2,1,1,2
C1(C(C(C(O)O1)(C(CO)O)O)O)=O,,,4,1,5,7,12
11107_0,,,,2,1,1,2
11108_0,,,,2,1,1,2
11109_0,,,,2,1,1,2
11111_0,,,,2,1,1,2
C1(CC(C(O)O1)O)=O,,,4,1,1,29,30
11113_0,,,,2,1,1,2
CC(C1(C(O)OC(CO)C1O)O)O,,,4,1,1,5,6
11115_0,,,,2,1,1,2
C1(C(C(C(O)O1)(C(C=O)O)O)O)=O,,,4,1,3,12,15
11117_0,,,,2,1,1,2
C(C1(C(C(OC1C(O)=O)O)O)O)=O,,,4,1,2,13,15
11119_0,,,,2,1,1,2
C(C1(C(C(OC1C=O)O)(C)O)O)=O,,,4,1,1,12,13
11121_0,,,,2,1,1,2
C(C1(C(C(OC1(C=O)C)O)O)O)=O,,,4,1,1,13,14
11123_0,,,,2,1,1,2
C(C1(C(C(C)(OC1C=O)O)O)O)=O,,,4,1,1,13,14
11125_0,,,,2,1,1,2
C(C1(C(C(OC1C(C)=O)O)O)O)=O,,,4,1,1,13,14
11127_0,,,,2,1,1,2
C(C1(C(CC(O1)O)O)C(C=O)O)=O,,,4,1,3,15,18
11129_0,,,,2,1,1,2
C(C1(C(CC=O)OC(C1O)O)O)=O,,,4,1,1,13,14
11131_0,,,,2,1,1,2
C(C1(C(C)OC(C1O)O)O)=O,,,4,1,1,10,11
11133_0,,,,2,1,1,2
C(C1(C(C(OC1C=O)O)O)O)=O,,,4,1,1,15,16
11135_0,,,,2,1,1,2
C(C)(C1(C(O)OCC1(CO)O)O)=O,,,4,1,2,10,12
11137_0,,,,2,1,1,2
C(C1(C(C)(O)OCC1(CO)O)O)=O,,,4,1,2,11,13
11139_0,,,,2,1,1,2
C1C(CO)(C(C(O)O1)(CO)O)O,,,4,1,3,4,7
11141_0,,,,2,1,1,2
C1(C(C(CO)(C(CO)(O)O1)O)O)=O,,,4,1,3,5,8
11143_0,,,,2,1,1,2
C(CO)(C1(COC(C1(C)O)O)O)=O,,,4,1,2,8,10
11145_0,,,,2,1,1,2
C(CO)(C1(COC(C)(C1O)O)O)=O,,,4,1,2,9,11
11147_0,,,,2,1,1,2
C(CO)(C1(CO)C(CC(O1)O)O)=O,,,4,1,5,10,15
11149_0,,,,2,1,1,2
C(CO)(C1(COC(C1O)O)O)=O,,,4,1,2,9,11
11151_0,,,,2,1,1,2
C1C(C(CO)(C(CO)(O)O1)O)O,,,4,1,4,4,8
11153_0,,,,2,1,1,2
C1(C(CO)(C(C)(C(O)O1)O)O)=O,,,4,1,3,8,11
11155_0,,,,2,1,1,2
C(C1(COC(C1(C)O)O)O)(O)=O,,,4,1,2,7,9
11157_0,,,,2,1,1,2
C1(C(CO)(C(C(C)(O)O1)O)O)=O,,,4,1,3,9,12
11159_0,,,,2,1,1,2
C(C1(COC(C)(C1O)O)O)(O)=O,,,4,1,2,8,10
11161_0,,,,2,1,1,2
C(C1(CO)C(CC(O1)O)O)(O)=O,,,4,1,4,8,12
11163_0,,,,2,1,1,2
C1(C(CO)(C(CO)(C(O)O1)O)O)=O,,,4,1,3,8,11
11165_0,,,,2,1,1,2
C(C1(COC(C1(CO)O)O)O)(O)=O,,,4,1,2,8,10
11167_0,,,,2,1,1,2
C1(C(CO)(C(C(CO)(O)O1)O)O)=O,,,4,1,3,9,12
11169_0,,,,2,1,1,2
C(C1(COC(CO)(C1O)O)O)(O)=O,,,4,1,2,9,11
11171_0,,,,2,1,1,2
C(C)(C1(C(O)OC(C1O)=O)O)=O,,,4,1,2,11,13
11173_0,,,,2,1,1,2
C(C1(C(C)(O)OC(C1O)=O)O)=O,,,4,1,1,12,13
11174_0,,,,2,1,1,2
11176_0,,,,2,1,1,2
C1(C(OC(C(O)=O)C1(CO)O)O)=O,,,4,1,4,10,14
11178_0,,,,2,1,1,2
C1(C(C(CO)(C(C=O)(O)O1)O)O)=O,,,4,1,1,9,10
11180_0,,,,2,1,1,2
C(C1(C(C)OC(C1(CO)O)O)O)=O,,,4,1,1,9,10
11182_0,,,,2,1,1,2
C(C1(COC(C1(C(C)O)O)O)O)=O,,,4,1,1,10,11
11184_0,,,,2,1,1,2
C(C1(COC(C1(CO)O)O)O)=O,,,4,1,2,10,12
11186_0,,,,2,1,1,2
C1(C(C(C(O)O1)(C(C)O)O)O)=O,,,4,1,1,6,7
11187_0,,,,2,1,1,2
11189_0,,,,2,1,1,2
C(C1(C(C)OC(C1O)O)O)(O)=O,,,4,1,2,8,10
11190_0,,,,2,1,1,2
11192_0,,,,2,1,1,2
C(C1(C(C(OC1C=O)O)O)O)(O)=O,,,4,1,2,13,15
11193_0,,,,2,1,1,2
11195_0,,,,2,1,1,2
C(C(C1(COC(C1(C)O)O)O)=O)=O,,,4,1,1,12,13
11197_0,,,,2,1,1,2
C(C1(C)C(C(C(O1)O)=O)(CO)O)=O,,,4,1,3,10,13
11199_0,,,,2,1,1,2
C(C1(COC(C1(C)O)O)O)=O,,,4,1,1,9,10
11201_0,,,,2,1,1,2
C(C1(C(CO)OC(C1(C)O)O)O)=O,,,4,1,2,9,11
11202_0,,,,2,1,1,2
11203_0,,,,2,1,1,2
11205_0,,,,2,1,1,2
C(C(C1(COC(C)(C1O)O)O)=O)=O,,,4,1,1,13,14
11207_0,,,,2,1,1,2
C(C1C(C(C(O1)O)=O)(CO)O)(C)=O,,,4,1,3,10,13
11209_0,,,,2,1,1,2
C(C1(COC(C)(C1O)O)O)=O,,,4,1,1,10,11
11211_0,,,,2,1,1,2
C(C1(C(CO)OC(C)(C1O)O)O)=O,,,4,1,2,10,12
11212_0,,,,2,1,1,2
11214_0,,,,2,1,1,2
C(C1(C(C)=O)C(CC(O1)O)O)=O,,,4,1,2,9,11
11216_0,,,,2,1,1,2
C(C(C1(CO)C(CC(O1)O)O)=O)=O,,,4,1,4,14,18
11217_0,,,,2,1,1,2
11219_0,,,,2,1,1,2
C(CC1C(C(C(O)O1)=O)(CO)O)=O,,,4,1,3,11,14
11221_0,,,,2,1,1,2
C(C1(CO)C(CC(O1)O)O)=O,,,4,1,3,11,14
11223_0,,,,2,1,1,2
C(C1(C(CO)O)C(CC(O1)O)O)=O,,,4,1,6,13,19
11225_0,,,,2,1,1,2
C(CC(C1(C(O)OCC1O)O)O)=O,,,4,1,2,10,12
11227_0,,,,2,1,1,2
C(C1(COC(C1(CCO)O)O)O)=O,,,4,1,2,10,12
11228_0,,,,2,1,1,2
11230_0,,,,2,1,1,2
C(C1(COC(C1O)(CCO)O)O)=O,,,4,1,2,11,13
11232_0,,,,2,1,1,2
C(C(CO)(C1CC(C(O)O1)O)O)=O,,,4,1,4,11,15
11234_0,,,,2,1,1,2
C(C1(CO)C(CC(CO)(O1)O)O)=O,,,4,1,3,12,15
11236_0,,,,2,1,1,2
C(C1(CO)C(CO)(CC(O1)O)O)=O,,,4,1,4,12,16
11238_0,,,,2,1,1,2
C(CC1(COC(C1(CO)O)O)O)=O,,,4,1,3,9,12
11239_0,,,,2,1,1,2
11241_0,,,,2,1,1,2
C(C1(COC(C1(C(C)=O)O)O)O)=O,,,4,1,1,14,15
11243_0,,,,2,1,1,2
C(C1(C(C)(O)OCC1(C=O)O)O)=O,,,4,1,1,14,15
11245_0,,,,2,1,1,2
C(C)(C1(C(O)OC(CO)C1O)O)=O,,,4,1,1,10,11
11247_0,,,,2,1,1,2
C(C1(C(C)(O)OC(CO)C1O)O)=O,,,4,1,1,11,12
11248_0,,,,2,1,1,2
11250_0,,,,2,1,1,2
C(C1(C(C)(O)OCC1O)O)=O,,,4,1,1,11,12
11252_0,,,,2,1,1,2
C(C1(CO)C(C(C(C)(O1)O)O)O)=O,,,4,1,3,13,16
11254_0,,,,2,1,1,2
C(C)(C1C(C(CO)(C(O1)O)O)O)=O,,,4,1,2,8,10
11256_0,,,,2,1,1,2
C(C1(CO)C(C)(C(C(O1)O)O)O)=O,,,4,1,3,13,16
11258_0,,,,2,1,1,2
C(C1C(C)(C(CO)(C(O1)O)O)O)=O,,,4,1,2,9,11
11259_0,,,,2,1,1,2
11261_0,,,,2,1,1,2
C1(C(O)OC(C)C1(CO)O)=O,,,4,1,3,7,10
11263_0,,,,2,1,1,2
C1C(C(C(O)O1)(C(C)O)O)O,,,4,1,2,5,7
11265_0,,,,2,1,1,2
C(C(C1(COC(C1O)O)O)=O)=O,,,4,1,1,16,17
11266_0,,,,2,1,1,2
11268_0,,,,2,1,1,2
C1(C(OC(C=O)C1(CO)O)O)=O,,,4,1,3,11,14
11269_0,,,,2,1,1,2
11271_0,,,,2,1,1,2
C(C1(C(CO)(C(CO1)O)O)O)=O,,,4,1,3,9,12
11272_0,,,,2,1,1,2
11274_0,,,,2,1,1,2
C1(C(O)OC(CO)C1(CO)O)=O,,,4,1,6,7,13
11276_0,,,,2,1,1,2
C(C1(CC(O)OC1(CO)CO)O)=O,,,4,1,2,6,8
11278_0,,,,2,1,1,2
C(CC1(C(O)OCC1(CO)O)O)=O,,,4,1,3,9,12
11280_0,,,,2,1,1,2
C(C1(CC(OC1C(O)=O)O)O)=O,,,4,1,2,9,11
11282_0,,,,2,1,1,2
C(CC1(C(O)OC(C1O)=O)O)=O,,,4,1,3,11,14
11284_0,,,,2,1,1,2
C(C1(CC(OC1(C=O)C)O)O)=O,,,4,1,1,10,11
11286_0,,,,2,1,1,2
C1(C(C)(C(C)(C(O)O1)O)O)=O,,,4,1,1,5,6
11288_0,,,,2,1,1,2
C1(C(CCO)(C(C)(C(O)O1)O)O)=O,,,4,1,1,6,7
11290_0,,,,2,1,1,2
C1(C(C(C)(C(O)O1)O)O)=O,,,4,1,3,11,14
11292_0,,,,2,1,1,2
C(C1(CC(OC1C(C)=O)O)O)=O,,,4,1,2,10,12
11294_0,,,,2,1,1,2
C1(C(C)(C(C(C)(O)O1)O)O)=O,,,4,1,1,6,7
11296_0,,,,2,1,1,2
C1(C(CCO)(C(C(C)(O)O1)O)O)=O,,,4,1,1,7,8
11298_0,,,,2,1,1,2
C1(C(C(C(C)(O)O1)O)O)=O,,,4,1,3,12,15
11300_0,,,,2,1,1,2
C(C1(C(CC(O1)O)O)CC=O)=O,,,4,1,2,12,14
11302_0,,,,2,1,1,2
C(C1(C(CC=O)OC(C1)O)O)=O,,,4,1,2,11,13
11304_0,,,,2,1,1,2
C(C1(C)C(CC(O1)O)O)(O)=O,,,4,1,1,5,6
11306_0,,,,2,1,1,2
C(C1(CCO)C(CC(O1)O)O)(O)=O,,,4,1,1,7,8
11308_0,,,,2,1,1,2
C(C1C(CC(O1)O)O)(O)=O,,,4,1,4,11,15
11310_0,,,,2,1,1,2
C1(C(C)(C(C(O)O1)(CCO)O)O)=O,,,4,1,1,6,7
11311_0,,,,2,1,1,2
11313_0,,,,2,1,1,2
C1(C(C(C(O)O1)(CCO)O)O)=O,,,4,1,2,6,8
11314_0,,,,2,1,1,2
11316_0,,,,2,1,1,2
C1(C(C)(C(C(CCO)(O)O1)O)O)=O,,,4,1,1,7,8
11318_0,,,,2,1,1,2
C1(C(C(C(CCO)(O)O1)O)O)=O,,,4,1,2,7,9
11320_0,,,,2,1,1,2
C(C1(C(C)OC(C1)O)O)=O,,,4,1,1,7,8
11322_0,,,,2,1,1,2
C(C1(COC(C1(CC=O)O)O)O)=O,,,4,1,2,12,14
11324_0,,,,2,1,1,2
C(C1(CC(OC1(C=O)CO)O)O)=O,,,4,1,3,13,16
11326_0,,,,2,1,1,2
C(C1(CC(OC1C(CO)=O)O)O)=O,,,4,1,1,11,12
11328_0,,,,2,1,1,2
C(CC1(C(O)OC(CO)C1O)O)=O,,,4,1,2,9,11
11330_0,,,,2,1,1,2
C(C1(CC(O)OC1C(CO)O)O)=O,,,4,1,3,9,12
11332_0,,,,2,1,1,2
C(C1(CC(OC1C=O)O)O)=O,,,4,1,4,12,16
11334_0,,,,2,1,1,2
C(C(C)(C1C(CC(O)O1)O)O)(O)=O,,,4,1,1,7,8
11336_0,,,,2,1,1,2
C(C(C)(C1CC(C(O)O1)O)O)(O)=O,,,4,1,1,8,9
11338_0,,,,2,1,1,2
C(C(C1CC(C(O)O1)O)O)(O)=O,,,4,1,3,8,11
11340_0,,,,2,1,1,2
C(C1(C)C(CC(CO)(O1)O)O)(O)=O,,,4,1,1,7,8
11342_0,,,,2,1,1,2
C(C1C(CC(CO)(O1)O)O)(O)=O,,,4,1,2,7,9
11344_0,,,,2,1,1,2
C(C1(C)C(CO)(CC(O1)O)O)(O)=O,,,4,1,1,7,8
11345_0,,,,2,1,1,2
11347_0,,,,2,1,1,2
C(C1C(CO)(CC(O1)O)O)(O)=O,,,4,1,3,7,10
11348_0,,,,2,1,1,2
11350_0,,,,2,1,1,2
C(C1(C)C(C(C(C)(O1)O)O)O)(O)=O,,,4,1,1,8,9
11352_0,,,,2,1,1,2
C(C1C(C(C(C)(O1)O)O)O)(O)=O,,,4,1,2,8,10
11354_0,,,,2,1,1,2
C(C1(C)C(C)(C(C(O1)O)O)O)(O)=O,,,4,1,1,8,9
11356_0,,,,2,1,1,2
C(C1C(C)(C(C(O1)O)O)O)(O)=O,,,4,1,2,8,10
11358_0,,,,2,1,1,2
C1(C(C)(C(CO)(C(O)O1)O)O)=O,,,4,1,1,5,6
11360_0,,,,2,1,1,2
C1(C(C)(C(C(CO)(O)O1)O)O)=O,,,4,1,1,6,7
11362_0,,,,2,1,1,2
C1(C(C)(C(C(O)O1)O)O)=O,,,4,1,2,6,8
11364_0,,,,2,1,1,2
C1(C(C(C(O)O1)O)(CCO)O)=O,,,4,1,3,7,10
11366_0,,,,2,1,1,2
C(C1(COC(CO)(C1)O)O)=O,,,4,1,2,8,10
11367_0,,,,2,1,1,2
11368_0,,,,2,1,1,2
11369_0,,,,2,1,1,2
11371_0,,,,2,1,1,2
C(C1C(COC1(C=O)O)O)=O,,,4,1,2,14,16
11372_0,,,,2,1,1,2
11374_0,,,,2,1,1,2
C(C1(CC(CO1)O)O)(O)=O,,,4,1,2,5,7
11376_0,,,,2,1,1,2
C1(C(CC(CO)(O)O1)O)=O,,,4,1,2,7,9
11378_0,,,,2,1,1,2
C(C1(CC(C(CO)O1)O)O)(O)=O,,,4,1,2,6,8
11380_0,,,,2,1,1,2
C1(C(CC(C(CO)O)(O)O1)O)=O,,,4,1,2,6,8
11382_0,,,,2,1,1,2
C(CC1(C(C(CO1)O)O)O)(O)=O,,,4,1,2,7,9
11384_0,,,,2,1,1,2
C(C(C1(CC(CO1)O)O)O)(O)=O,,,4,1,3,8,11
11385_0,,,,2,1,1,2
11386_0,,,,2,1,1,2
11388_0,,,,2,1,1,2
C1C2(C(O)OC(C2O)O1)O,,,4,1,1,3,4
11390_0,,,,2,1,1,2
C12C(C(C(O)O1)(C(CO)O2)O)O,,,4,1,1,3,4
11392_0,,,,2,1,1,2
C1C2C(C(O)O1)(C(C(O)O2)O)O,,,4,1,2,6,8
11393_0,,,,2,1,1,2
11395_0,,,,2,1,1,2
C12C(C(CO1)O)(C(C(O)O2)O)O,,,4,1,1,5,6
11397_0,,,,2,1,1,2
C12C(C(C(O)O1)(C(CO2)O)O)O,,,4,1,1,4,5
11399_0,,,,2,1,1,2
C(C1(C(C(CO1)O)O)O)(O)=O,,,4,1,3,7,10
11401_0,,,,2,1,1,2
C(C1(C(C(C(CO)O1)O)O)O)(O)=O,,,4,1,2,8,10
11403_0,,,,2,1,1,2
C1(C(C(C(O)O1)O)=O)=O,,,4,1,4,23,27
11405_0,,,,2,1,1,2
C(C1(C(C(O)OC1)=O)O)=O,,,4,1,3,10,13
11407_0,,,,2,1,1,2
C(C1(C(C(O)OC1CO)=O)O)=O,,,4,1,1,7,8
11409_0,,,,2,1,1,2
C(C1(C(COC1(C=O)O)O)O)=O,,,4,1,1,15,16
11411_0,,,,2,1,1,2
C(C(C1(C(O)OCC1O)O)=O)=O,,,4,1,3,17,20
11413_0,,,,2,1,1,2
C1(C(C(C(O)O1)=O)O)=O,,,4,1,5,26,31
11415_0,,,,2,1,1,2
C(C(C1C(C(CC(O)O1)O)O)O)O,,,4,1,1,7,8
11417_0,,,,2,1,1,2
C(C(C1C(CC(C(O)O1)=O)O)O)=O,,,4,1,1,14,15
11419_0,,,,2,1,1,2
C(C1C(C(CC(C=O)(O1)O)O)O)=O,,,4,1,1,12,13
11421_0,,,,2,1,1,2
C(C1C(OC(C=O)C(C1O)O)O)=O,,,4,1,1,18,19
11423_0,,,,2,1,1,2
C(C1C(C(CC(O1)O)O)O)=O,,,4,1,4,12,16
11425_0,,,,2,1,1,2
C(C1C(C(C(C(O1)O)O)O)O)=O,,,4,1,6,13,19
11427_0,,,,2,1,1,2
C1(C(O)OCC(CO)(C1)O)=O,,,4,1,5,10,15
11429_0,,,,2,1,1,2
C1(C(O)OCC(CO)(C1CO)O)=O,,,4,1,4,10,14
11431_0,,,,2,1,1,2
C(C1C(C(O)OCC1(CO)O)O)=O,,,4,1,2,13,15
11433_0,,,,2,1,1,2
C1(C(C(CO)(CO)OC(C1)O)O)=O,,,4,1,2,5,7
11435_0,,,,2,1,1,2
C1(C(C(O)OC(CO)(CO)C1)O)=O,,,4,1,2,7,9
11437_0,,,,2,1,1,2
C1(C(O)OCC(CO)(C1O)O)=O,,,4,1,2,8,10
11439_0,,,,2,1,1,2
C1(COC(C(C)(C1O)O)O)=O,,,4,1,6,11,17
11441_0,,,,2,1,1,2
C1(COC(C)(C(C1O)O)O)=O,,,4,1,6,12,18
11443_0,,,,2,1,1,2
C(C1(CCOC(CO)(C1O)O)O)=O,,,4,1,2,10,12
11445_0,,,,2,1,1,2
C1(COC(C(CCO)(C1O)O)O)=O,,,4,1,2,9,11
11447_0,,,,2,1,1,2
C1(COC(C(C1O)O)(CCO)O)=O,,,4,1,2,10,12
11449_0,,,,2,1,1,2
C(CO)(C1C(C(CC(O1)O)O)O)=O,,,4,1,2,9,11
11451_0,,,,2,1,1,2
C(C1CC(C(C(CO)(O1)O)O)O)=O,,,4,1,2,9,11
11453_0,,,,2,1,1,2
C(CO)(C1C(CC(C(O1)O)O)O)=O,,,4,1,2,9,11
11455_0,,,,2,1,1,2
C1(COC(C(CO)(C1O)O)O)=O,,,4,1,2,8,10
11457_0,,,,2,1,1,2
C1(COC(CO)(C(C1O)O)O)=O,,,4,1,2,9,11
11459_0,,,,2,1,1,2
C1C(C(C(C(CO)(O)O1)O)O)O,,,4,1,2,7,9
11461_0,,,,2,1,1,2
C1(COC(C(C1O)O)O)=O,,,4,1,6,21,27
11463_0,,,,2,1,1,2
C1(C(O)OCC(C(CO)O)(C1)O)=O,,,4,1,2,9,11
11465_0,,,,2,1,1,2
C1(C(O)OC(CO)C(CO)(C1)O)=O,,,4,1,2,7,9
11467_0,,,,2,1,1,2
C(C1(CC(CO)(C(CO1)O)O)O)=O,,,4,1,2,9,11
11469_0,,,,2,1,1,2
C(C1C(O)OCC(C1(CO)O)O)=O,,,4,1,2,12,14
11471_0,,,,2,1,1,2
C1C(C(CO)(CC(O)O1)O)O,,,4,1,2,5,7
11472_0,,,,2,1,1,2
11474_0,,,,2,1,1,2
C1(C(CO)OC(C(C)(C1O)O)O)=O,,,4,1,3,9,12
11476_0,,,,2,1,1,2
C1(C(CO)OC(C(C1O)O)(C)O)=O,,,4,1,3,10,13
11478_0,,,,2,1,1,2
C1(C(CO)OC(C(C1O)O)O)=O,,,4,1,3,10,13
11480_0,,,,2,1,1,2
C1(C(CC(C(O)O1)=O)O)=O,,,4,1,3,18,21
11482_0,,,,2,1,1,2
C1(C(O)OC(C(C1CO)O)=O)=O,,,4,1,3,9,12
11484_0,,,,2,1,1,2
C(C1C(C(O)OC(C1O)=O)O)=O,,,4,1,2,13,15
11486_0,,,,2,1,1,2
C1(C(C(C(O)=O)OC(C1)O)O)=O,,,4,1,3,8,11
11488_0,,,,2,1,1,2
C1(CC(C(O)=O)OC(C1O)O)=O,,,4,1,3,10,13
11490_0,,,,2,1,1,2
C1(C(C(C(C(O)O1)=O)O)O)=O,,,4,1,4,13,17
11492_0,,,,2,1,1,2
C(C1(CO)C(C(CC(O1)O)O)O)=O,,,4,1,3,13,16
11494_0,,,,2,1,1,2
C(C(C1(COC(CC1O)O)O)O)=O,,,4,1,6,12,18
11496_0,,,,2,1,1,2
C(C1C(CO)(C(CC(O1)O)O)O)=O,,,4,1,3,10,13
11498_0,,,,2,1,1,2
C1(C(O)OC(CO)(CO)C(C1)O)=O,,,4,1,1,5,6
11500_0,,,,2,1,1,2
C(C1(CC(C(CO)(CO1)O)O)O)=O,,,4,1,1,9,10
11502_0,,,,2,1,1,2
C(C1C(O)OCC(CO)(C1O)O)=O,,,4,1,1,12,13
11504_0,,,,2,1,1,2
C1C(CO)(C(CC(O)O1)O)O,,,4,1,2,5,7
11506_0,,,,2,1,1,2
C1C(CO)(C(C(C(O)O1)O)O)O,,,4,1,2,7,9
11508_0,,,,2,1,1,2
C1C(C(CO)O)(C(CC(O)O1)O)O,,,4,1,2,7,9
11510_0,,,,2,1,1,2
C(C1(C(CO)OC(CC1O)O)O)O,,,4,1,3,5,8
11512_0,,,,2,1,1,2
C(C1C(C(CC(O1)O)O)O)(O)=O,,,4,1,2,8,10
11514_0,,,,2,1,1,2
C(C1C(C(C(C(O1)O)O)O)O)(O)=O,,,4,1,4,11,15
11516_0,,,,2,1,1,2
C(C1C(COC(C1(C)O)O)=O)=O,,,4,1,3,11,14
11518_0,,,,2,1,1,2
C(C1(C)C(C(CC(O1)O)=O)O)=O,,,4,1,1,11,12
11520_0,,,,2,1,1,2
C(C1C(CC(C)(C(O1)O)O)=O)=O,,,4,1,1,9,10
11522_0,,,,2,1,1,2
C(C1(C)CC(C(C(O1)O)O)=O)=O,,,4,1,1,12,13
11524_0,,,,2,1,1,2
C(C1C(COC(C)(C1O)O)=O)=O,,,4,1,3,11,14
11526_0,,,,2,1,1,2
C1(C(C(C(C)=O)OC(C1)O)O)=O,,,4,1,2,11,13
11528_0,,,,2,1,1,2
C(C1C(CC(C(C)(O1)O)O)=O)=O,,,4,1,1,9,10
11530_0,,,,2,1,1,2
C1(CC(C(C)=O)OC(C1O)O)=O,,,4,1,2,12,14
11532_0,,,,2,1,1,2
C(C1(CC(C=O)(O)OCC1)O)=O,,,4,1,1,10,11
11534_0,,,,2,1,1,2
C(CC1C(CC(C(O)O1)=O)O)=O,,,4,1,2,14,16
11536_0,,,,2,1,1,2
C(C1CC(CC(C=O)(O1)O)O)=O,,,4,1,1,10,11
11538_0,,,,2,1,1,2
C(CC1(COC(C(C1)=O)O)O)=O,,,4,1,2,12,14
11540_0,,,,2,1,1,2
C(C)(C1C(CC(C(O1)O)=O)O)=O,,,4,1,2,9,11
11542_0,,,,2,1,1,2
C(C1C(C)(CC(C(O1)O)=O)O)=O,,,4,1,1,10,11
11544_0,,,,2,1,1,2
C(C1(COC(C(C1)=O)O)O)=O,,,4,1,3,12,15
11546_0,,,,2,1,1,2
C(C1(CC(C(CO1)=O)O)O)=O,,,4,1,3,10,13
11548_0,,,,2,1,1,2
C(C1(C(CO)OC(C(C1)=O)O)O)=O,,,4,1,1,9,10
11550_0,,,,2,1,1,2
C(C1(CC(C=O)(O)OCC1O)O)=O,,,4,1,1,11,12
11552_0,,,,2,1,1,2
C1(C(CC(C=O)(OC1CO)O)O)=O,,,4,1,3,8,11
11553_0,,,,2,1,1,2
11555_0,,,,2,1,1,2
C(C1(CC(C(CO1)O)O)O)=O,,,4,1,1,9,10
11557_0,,,,2,1,1,2
C1(C(O)OC(C(C1)O)C(CO)O)=O,,,4,1,4,8,12
11559_0,,,,2,1,1,2
C(C1(CC(C(C(CO)O1)O)O)O)=O,,,4,1,2,8,10
11560_0,,,,2,1,1,2
11562_0,,,,2,1,1,2
C(C(C1COC(CC1O)O)=O)=O,,,4,1,2,15,17
11564_0,,,,2,1,1,2
C(C1C(CC(OC1C=O)O)O)=O,,,4,1,2,13,15
11566_0,,,,2,1,1,2
C(CC1C(C(CC(O)O1)=O)O)=O,,,4,1,2,11,13
11568_0,,,,2,1,1,2
C(CC1CC(C(C(O)O1)O)=O)=O,,,4,1,2,13,15
11570_0,,,,2,1,1,2
C(C1C(O)OCCC1(C=O)O)=O,,,4,1,2,14,16
11572_0,,,,2,1,1,2
C(C1C(OC(C=O)CC1O)O)=O,,,4,1,2,16,18
11574_0,,,,2,1,1,2
C(C1C(OCC(C1O)=O)O)=O,,,4,1,4,17,21
11576_0,,,,2,1,1,2
C(C1C(O)OCC(C1(C=O)O)O)=O,,,4,1,1,14,15
11578_0,,,,2,1,1,2
C(C1C(OC(C(C1O)=O)CO)O)=O,,,4,1,3,14,17
11579_0,,,,2,1,1,2
11581_0,,,,2,1,1,2
C(C1C(O)OC(CO)C(C1O)O)=O,,,4,1,2,12,14
11583_0,,,,2,1,1,2
C(C1(CC(O)OCC1)O)=O,,,4,1,1,8,9
11585_0,,,,2,1,1,2
C(C1(C(C(C=O)(O)OCC1)O)O)=O,,,4,1,1,12,13
11587_0,,,,2,1,1,2
C(C1(C(C(O)OCC1)O)O)=O,,,4,1,1,10,11
11589_0,,,,2,1,1,2
C(C1(COC(C(C1CO)=O)O)O)=O,,,4,1,3,12,15
11591_0,,,,2,1,1,2
C(C1(C(CO)C(C(CO1)=O)O)O)=O,,,4,1,1,9,10
11593_0,,,,2,1,1,2
C1(C(O)OC(CO)C(C1CO)O)=O,,,4,1,3,9,12
11595_0,,,,2,1,1,2
C(C1(C(CO)C(C(CO1)O)O)O)=O,,,4,1,1,10,11
11597_0,,,,2,1,1,2
C1(C(O)OCC(C1CO)O)=O,,,4,1,5,11,16
11599_0,,,,2,1,1,2
C(C(C1C(C(CC(O1)O)O)O)=O)=O,,,4,1,1,12,13
11601_0,,,,2,1,1,2
C(CC1C(C(C(C(O)O1)=O)O)O)=O,,,4,1,1,15,16
11603_0,,,,2,1,1,2
C(C1CC(CC(O1)O)O)=O,,,4,1,1,11,12
11605_0,,,,2,1,1,2
C(C(C1C(CC(C(O1)O)O)O)=O)=O,,,4,1,1,12,13
11607_0,,,,2,1,1,2
C(C1CC(C(C(C=O)(O1)O)O)O)=O,,,4,1,1,12,13
11609_0,,,,2,1,1,2
C(C1C(CC(C(O1)O)O)O)=O,,,4,1,4,12,16
11611_0,,,,2,1,1,2
C(C1CC(C(C(O1)O)O)O)=O,,,4,1,1,11,12
11613_0,,,,2,1,1,2
C(C1C(C(O)OCC1(C=O)O)O)=O,,,4,1,1,14,15
11615_0,,,,2,1,1,2
C(C(C1C(OCC(C1O)=O)O)O)=O,,,4,1,2,13,15
11617_0,,,,2,1,1,2
C(C1C(C(O)OC(CO)C1O)O)=O,,,4,1,1,12,13
11619_0,,,,2,1,1,2
C(C(C1C(O)OCC(C1O)O)O)=O,,,4,1,2,12,14
11621_0,,,,2,1,1,2
C(C1C(C(O)OCC1O)O)=O,,,4,1,2,14,16
11623_0,,,,2,1,1,2
C(CC1(COC(C(C1O)=O)O)O)=O,,,4,1,1,12,13
11625_0,,,,2,1,1,2
C(C1C(COC(C1(CO)O)O)=O)=O,,,4,1,1,10,11
11627_0,,,,2,1,1,2
C(CO)(C1C(OCC(C1O)=O)O)=O,,,4,1,2,14,16
11629_0,,,,2,1,1,2
C(C1C(CO)(OCC(C1O)=O)O)=O,,,4,1,1,14,15
11631_0,,,,2,1,1,2
C(C1C(COC(CO)(C1O)O)=O)=O,,,4,1,1,10,11
11633_0,,,,2,1,1,2
C(CO)(C1C(O)OCC(C1O)O)=O,,,4,1,2,11,13
11635_0,,,,2,1,1,2
C(C1C(CO)(O)OCC(C1O)O)=O,,,4,1,1,13,14
11636_0,,,,2,1,1,2
11638_0,,,,2,1,1,2
C1(C(C(C)OC(C1)O)O)=O,,,4,1,1,18,19
11640_0,,,,2,1,1,2
C(C1(CO)C(C(CC(O1)O)=O)O)=O,,,4,1,3,14,17
11642_0,,,,2,1,1,2
C(CC1(C(C(C(CO1)=O)O)O)O)=O,,,4,1,1,18,19
11644_0,,,,2,1,1,2
C1(C(C(C(CO)=O)OC(C1)O)O)=O,,,4,1,1,12,13
11646_0,,,,2,1,1,2
C(CC1(C(C(C(CO1)O)O)O)O)=O,,,4,1,1,12,13
11648_0,,,,2,1,1,2
C1(C(C(C(CO)O)OC(C1)O)O)=O,,,4,1,3,8,11
11650_0,,,,2,1,1,2
C1(C(C(C=O)OC(C1)O)O)=O,,,4,1,5,17,22
11651_0,,,,2,1,1,2
11652_0,,,,2,1,1,2
11654_0,,,,2,1,1,2
C(C)(C1C(C(C(C(O1)O)=O)O)O)=O,,,4,1,1,11,12
11656_0,,,,2,1,1,2
C(C1C(C)(C(C(C(O1)O)=O)O)O)=O,,,4,1,1,11,12
11658_0,,,,2,1,1,2
C1(C(C(O)OC(C)C1)O)=O,,,4,1,1,20,21
11660_0,,,,2,1,1,2
C(C1C(CC(CO)(C(O1)O)O)=O)=O,,,4,1,1,9,10
11662_0,,,,2,1,1,2
C(C1(CO)CC(C(C(O1)O)O)=O)=O,,,4,1,2,13,15
11664_0,,,,2,1,1,2
C(C(C1(CC(C(CO1)=O)O)O)O)=O,,,4,1,1,17,18
11666_0,,,,2,1,1,2
C(C1C(CC(C(CO)(O1)O)O)=O)=O,,,4,1,1,8,9
11668_0,,,,2,1,1,2
C1(CC(C(CO)=O)OC(C1O)O)=O,,,4,1,1,13,14
11670_0,,,,2,1,1,2
C(C(C1(CC(C(CO1)O)O)O)O)=O,,,4,1,1,13,14
11672_0,,,,2,1,1,2
C1(C(C(O)OC(C(CO)O)C1)O)=O,,,4,1,3,10,13
11674_0,,,,2,1,1,2
C(C1C(CC(C(O1)O)O)=O)=O,,,4,1,2,13,15
11676_0,,,,2,1,1,2
C1(CC(C=O)OC(C1O)O)=O,,,4,1,4,17,21
11677_0,,,,2,1,1,2
11678_0,,,,2,1,1,2
11680_0,,,,2,1,1,2
C1(COC(CC1O)O)=O,,,4,1,7,29,36
11682_0,,,,2,1,1,2
C(C1(C(COC(C1)O)O)O)=O,,,4,1,1,9,10
11684_0,,,,2,1,1,2
C1(C(CO)OC(CC1O)O)=O,,,4,1,4,9,13
11686_0,,,,2,1,1,2
C1C(C(CC(O)O1)O)O,,,4,1,1,10,11
11688_0,,,,2,1,1,2
C(C1C(C(CC(O)O1)O)O)O,,,4,1,2,5,7
11690_0,,,,2,1,1,2
C(C1(COC(C(C1O)=O)O)O)=O,,,4,1,1,13,14
11692_0,,,,2,1,1,2
C(C1(C(C(C(CO1)=O)O)O)O)=O,,,4,1,1,12,13
11694_0,,,,2,1,1,2
C1(C(O)OC(CO)C(C1O)O)=O,,,4,1,1,8,9
11696_0,,,,2,1,1,2
C(C1(C(C(C(CO1)O)O)O)O)=O,,,4,1,2,12,14
11698_0,,,,2,1,1,2
C1(C(O)OCC(C1O)O)=O,,,4,1,5,17,22
11699_0,,,,2,1,1,2
11701_0,,,,2,1,1,2
C1C(C(C(C(O)O1)(C(C)O)O)O)O,,,4,1,1,7,8
11703_0,,,,2,1,1,2
C(C1(C(C(O)OC(C1O)=O)O)O)=O,,,4,1,1,14,15
11705_0,,,,2,1,1,2
C(C1(C(CC(OC1C=O)O)O)O)=O,,,4,1,1,13,14
11707_0,,,,2,1,1,2
C1(COC(C(C)(C1(CO)O)O)O)=O,,,4,1,4,10,14
11709_0,,,,2,1,1,2
C1(COC(C)(C(C1(CO)O)O)O)=O,,,4,1,4,11,15
11711_0,,,,2,1,1,2
C(CO)(C1(COC(CC1O)O)O)=O,,,4,1,3,9,12
11713_0,,,,2,1,1,2
C1(COC(C(C1(CO)O)O)O)=O,,,4,1,4,11,15
11715_0,,,,2,1,1,2
C1(C(CO)(C(CC(O)O1)O)O)=O,,,4,1,3,9,12
11717_0,,,,2,1,1,2
C(C1(COC(CC1O)O)O)(O)=O,,,4,1,2,8,10
11719_0,,,,2,1,1,2
C1(C(O)OC(C(C1(CO)O)O)=O)=O,,,4,1,3,11,14
11721_0,,,,2,1,1,2
C(C1(C(COC(C1(C)O)O)O)O)=O,,,4,1,2,12,14
11723_0,,,,2,1,1,2
C(C1(C(COC(C)(C1O)O)O)O)=O,,,4,1,2,13,15
11725_0,,,,2,1,1,2
C(C(C1(COC(CC1O)O)O)=O)=O,,,4,1,2,13,15
11727_0,,,,2,1,1,2
C(C1(COC(CC1O)O)O)=O,,,4,1,1,10,11
11729_0,,,,2,1,1,2
C(C1(C(CO)OC(CC1O)O)O)=O,,,4,1,2,10,12
11731_0,,,,2,1,1,2
C(C1(CCOC(C1(CO)O)O)O)=O,,,4,1,2,9,11
11733_0,,,,2,1,1,2
C(C1(CO)C(CC(C(O1)O)O)O)=O,,,4,1,3,13,16
11735_0,,,,2,1,1,2
C(C1CC(C(CO)(C(O1)O)O)O)=O,,,4,1,2,9,11
11737_0,,,,2,1,1,2
C(C1(COC(CO)(CC1O)O)O)=O,,,4,1,1,11,12
11739_0,,,,2,1,1,2
C(C1(COC(CC1(CO)O)O)O)=O,,,4,1,2,10,12
11741_0,,,,2,1,1,2
C(C)(C1(C(OCC(C1O)=O)O)O)=O,,,4,1,1,15,16
11743_0,,,,2,1,1,2
C(C1(C(C)(OCC(C1O)=O)O)O)=O,,,4,1,1,15,16
11745_0,,,,2,1,1,2
C(C)(C1(C(O)OCC(C1O)O)O)=O,,,4,1,1,12,13
11747_0,,,,2,1,1,2
C(C1(C(C)(O)OCC(C1O)O)O)=O,,,4,1,1,13,14
11749_0,,,,2,1,1,2
C(C1(COC(C)(C(C1O)O)O)O)=O,,,4,1,1,12,13
11751_0,,,,2,1,1,2
C(C1(COC(C(C1(C)O)O)O)O)=O,,,4,1,1,11,12
11753_0,,,,2,1,1,2
C1(C(O)OCC(C1(CO)O)O)=O,,,4,1,5,10,15
11755_0,,,,2,1,1,2
C(C1(CC(O)OCC1(CO)O)O)=O,,,4,1,2,9,11
11757_0,,,,2,1,1,2
C(C1(CC(O)OC(C1O)=O)O)=O,,,4,1,1,10,11
11759_0,,,,2,1,1,2
C(C1(CCOC(C1(C)O)O)O)(O)=O,,,4,1,1,7,8
11761_0,,,,2,1,1,2
C(C1(CCOC(C)(C1O)O)O)(O)=O,,,4,1,1,8,9
11763_0,,,,2,1,1,2
C1(C(C)(C(CC(O)O1)O)O)=O,,,4,1,1,6,7
11765_0,,,,2,1,1,2
C1(C(CCO)(C(CC(O)O1)O)O)=O,,,4,1,1,7,8
11767_0,,,,2,1,1,2
C1(C(C(CC(O)O1)O)O)=O,,,4,1,3,12,15
11769_0,,,,2,1,1,2
C(C1(CC(O)OCC1(C=O)O)O)=O,,,4,1,1,12,13
11771_0,,,,2,1,1,2
C(CC1(C(OCC(C1O)=O)O)O)=O,,,4,1,1,13,14
11773_0,,,,2,1,1,2
C(C1(CC(O)OC(CO)C1O)O)=O,,,4,1,1,9,10
11775_0,,,,2,1,1,2
C(CC1(C(O)OCC(C1O)O)O)=O,,,4,1,2,11,13
11777_0,,,,2,1,1,2
C(C1(C)C(C(CC(O1)O)O)O)(O)=O,,,4,1,1,8,9
11779_0,,,,2,1,1,2
C(C1(C)C(CC(C(O1)O)O)O)(O)=O,,,4,1,1,8,9
11781_0,,,,2,1,1,2
C(C1C(CC(C(O1)O)O)O)(O)=O,,,4,1,2,8,10
11783_0,,,,2,1,1,2
C1(C(C)(C(CC(CO)(O)O1)O)O)=O,,,4,1,1,7,8
11785_0,,,,2,1,1,2
C1(C(C(CC(CO)(O)O1)O)O)=O,,,4,1,1,7,8
11787_0,,,,2,1,1,2
C1(C(C)(C(CO)(CC(O)O1)O)O)=O,,,4,1,1,6,7
11789_0,,,,2,1,1,2
C1(C(C(CO)(CC(O)O1)O)O)=O,,,4,1,2,6,8
11791_0,,,,2,1,1,2
C1(C(C)(C(C(C(C)(O)O1)O)O)O)=O,,,4,1,1,8,9
11793_0,,,,2,1,1,2
C1(C(C(C(C(C)(O)O1)O)O)O)=O,,,4,1,1,8,9
11795_0,,,,2,1,1,2
C1(C(C)(C(C)(C(C(O)O1)O)O)O)=O,,,4,1,1,7,8
11797_0,,,,2,1,1,2
C1(C(C(C)(C(C(O)O1)O)O)O)=O,,,4,1,1,7,8
11799_0,,,,2,1,1,2
C(C1(C(C(O)OCC1)O)O)(O)=O,,,4,1,2,8,10
11800_0,,,,2,1,1,2
11801_0,,,,2,1,1,2
11802_0,,,,2,1,1,2
11803_0,,,,2,1,1,2
11804_0,,,,2,1,1,2
11805_0,,,,2,1,1,2
11807_0,,,,2,1,1,2
C(C1(CC(C(CO1)O)O)O)(O)=O,,,4,1,2,8,10
11809_0,,,,2,1,1,2
C(C1(C(C(C(CO1)O)O)O)O)(O)=O,,,4,1,2,10,12
11811_0,,,,2,1,1,2
C(C1(C(C(O)OCC1O)=O)O)=O,,,4,1,1,9,10
11813_0,,,,2,1,1,2
C(C1C(C(C(CC(O)O1)O)O)O)O,,,4,1,1,7,8
11815_0,,,,2,1,1,2
C(C1C(C(CC(C(O1)O)=O)O)O)=O,,,4,1,1,13,14
11817_0,,,,2,1,1,2
C1(C(C(COC(C1)O)(CO)O)O)=O,,,4,1,2,9,11
11819_0,,,,2,1,1,2
C1(C(C(O)OCC(CO)(C1)O)O)=O,,,4,1,2,10,12
11821_0,,,,2,1,1,2
C1(COC(CC(C1O)O)O)=O,,,4,1,7,12,19
11823_0,,,,2,1,1,2
C1(C(C(C(CO)(O)OCC1)O)O)=O,,,4,1,2,10,12
11825_0,,,,2,1,1,2
C1(COC(CO)(C(C(C1)O)O)O)=O,,,4,1,2,9,11
11827_0,,,,2,1,1,2
C1(COC(CO)(CC(C1O)O)O)=O,,,4,1,1,10,11
11829_0,,,,2,1,1,2
C1(COC(CC(CO)(C1O)O)O)=O,,,4,1,2,9,11
11831_0,,,,2,1,1,2
C1(COC(C)(C(C(C1O)O)O)O)=O,,,4,1,2,11,13
11833_0,,,,2,1,1,2
C1(COC(C(C(C)(C1O)O)O)O)=O,,,4,1,1,10,11
11835_0,,,,2,1,1,2
C1(C(O)OCC(C(CO)(C1)O)O)=O,,,4,1,2,8,10
11837_0,,,,2,1,1,2
C1(C(C(C(O)OCC1O)(C)O)O)=O,,,4,1,1,9,10
11839_0,,,,2,1,1,2
C1(C(C(C(C)(O)OCC1O)O)O)=O,,,4,1,2,10,12
11841_0,,,,2,1,1,2
C1(C(CO)OC(CC(C1O)O)O)=O,,,4,1,3,10,13
11843_0,,,,2,1,1,2
C1(C(C(C(O)OCC1O)O)O)=O,,,4,1,1,10,11
11845_0,,,,2,1,1,2
C1(C(C(C(OC(C1)O)=O)O)O)=O,,,4,1,2,10,12
11847_0,,,,2,1,1,2
C1(CC(C(OC(C1O)O)=O)O)=O,,,4,1,2,9,11
11849_0,,,,2,1,1,2
C(C1(COC(CC(C1O)O)O)O)=O,,,4,1,1,12,13
11851_0,,,,2,1,1,2
C1(C(O)OCC(CO)(C(C1)O)O)=O,,,4,1,1,8,9
11853_0,,,,2,1,1,2
C1C(C(CO)(C(CC(O)O1)O)O)O,,,4,1,2,6,8
11855_0,,,,2,1,1,2
C1(C(C(C(CC(O)O1)O)O)O)=O,,,4,1,1,8,9
11857_0,,,,2,1,1,2
C1(C(C(C(C(C(O)O1)O)O)O)O)=O,,,4,1,3,10,13
11859_0,,,,2,1,1,2
C(C1(CCOC(C(C1)=O)O)O)=O,,,4,1,1,10,11
11861_0,,,,2,1,1,2
C1(C(CC(C=O)(O)OCC1)O)=O,,,4,1,2,11,13
11863_0,,,,2,1,1,2
C(C1CC(CC(C(O1)O)=O)O)=O,,,4,1,1,11,12
11865_0,,,,2,1,1,2
C(C1(CC(CC(CO1)=O)O)O)=O,,,4,1,2,11,13
11867_0,,,,2,1,1,2
C1(COC(C(CC1O)=O)O)=O,,,4,1,5,12,17
11869_0,,,,2,1,1,2
C(C1(C(COC(C(C1)=O)O)O)O)=O,,,4,1,1,11,12
11871_0,,,,2,1,1,2
C1(C(OC(C(C(C1)O)=O)CO)O)=O,,,4,1,3,8,11
11873_0,,,,2,1,1,2
C1(C(COC(C=O)(CC1O)O)O)=O,,,4,1,1,11,12
11874_0,,,,2,1,1,2
11876_0,,,,2,1,1,2
C1(C(O)OC(CO)C(C(C1)O)O)=O,,,4,1,2,8,10
11878_0,,,,2,1,1,2
C(C1(CC(C(C(CO1)O)O)O)O)=O,,,4,1,3,11,14
11880_0,,,,2,1,1,2
C(C1C(COC(CC1O)O)=O)=O,,,4,1,3,11,14
11882_0,,,,2,1,1,2
C(C1C(CC(CC(O1)O)O)=O)=O,,,4,1,1,9,10
11884_0,,,,2,1,1,2
C(C1C(O)OCCC(C1O)=O)=O,,,4,1,3,15,18
11886_0,,,,2,1,1,2
C(C1C(CC(COC1O)=O)O)=O,,,4,1,3,15,18
11888_0,,,,2,1,1,2
C(C1C(O)OCC(C(C1O)=O)O)=O,,,4,1,1,14,15
11890_0,,,,2,1,1,2
C(C1C(O)OCC(C(C1O)O)O)=O,,,4,1,3,14,17
11892_0,,,,2,1,1,2
C(C1(CCOC(C(C1O)=O)O)O)=O,,,4,1,1,12,13
11894_0,,,,2,1,1,2
C1(C(CC(O)OCC1)O)=O,,,4,1,2,16,18
11896_0,,,,2,1,1,2
C1(C(C(C(C=O)(O)OCC1)O)O)=O,,,4,1,1,14,15
11897_0,,,,2,1,1,2
11899_0,,,,2,1,1,2
C1(C(OCC(C(C1CO)O)=O)O)=O,,,4,1,3,10,13
11901_0,,,,2,1,1,2
C1(C(O)OCC(C(C1CO)O)O)=O,,,4,1,3,11,14
11903_0,,,,2,1,1,2
C(C1CC(C(C(C(O1)O)=O)O)O)=O,,,4,1,1,13,14
11905_0,,,,2,1,1,2
C(C1C(C(OCC(C1O)=O)O)O)=O,,,4,1,1,15,16
11907_0,,,,2,1,1,2
C(C1C(C(O)OCC(C1O)O)O)=O,,,4,1,1,14,15
11909_0,,,,2,1,1,2
C1(COC(CC(C1)O)O)=O,,,4,1,2,19,21
11911_0,,,,2,1,1,2
C(C1(C(C(CC(CO1)=O)O)O)O)=O,,,4,1,1,13,14
11912_0,,,,2,1,1,2
11914_0,,,,2,1,1,2
C(C1(COC(CC(C1O)=O)O)O)=O,,,4,1,1,14,15
11916_0,,,,2,1,1,2
C1(C(C(C(CO)OC(C1)O)O)O)=O,,,4,1,1,9,10
11917_0,,,,2,1,1,2
11919_0,,,,2,1,1,2
C(C1(COC(C(C(C1)=O)O)O)O)=O,,,4,1,1,13,14
11921_0,,,,2,1,1,2
C1(C(C(O)OC(C(C1)O)CO)O)=O,,,4,1,1,9,10
11922_0,,,,2,1,1,2
11924_0,,,,2,1,1,2
C1(C(CC(O)OCC1O)O)=O,,,4,1,3,9,12
11926_0,,,,2,1,1,2
C1C(C(C(CC(O)O1)O)O)O,,,4,1,3,7,10
11928_0,,,,2,1,1,2
C1(COC(C(C(C1O)O)=O)O)=O,,,4,1,1,10,11
11930_0,,,,2,1,1,2
C1(C(O)OCC(C(C1O)O)O)=O,,,4,1,1,10,11
11932_0,,,,2,1,1,2
C1(COC(CC(C1(CO)O)O)O)=O,,,4,1,4,11,15
11934_0,,,,2,1,1,2
C(C1(C(COC(CC1O)O)O)O)=O,,,4,1,2,13,15
11936_0,,,,2,1,1,2
C1(C(C(C(O)OCC1)(CO)O)O)=O,,,4,1,2,9,11
11938_0,,,,2,1,1,2
C(C1(COC(C(CC1O)O)O)O)=O,,,4,1,1,12,13
11940_0,,,,2,1,1,2
C1(COC(C(CO)(C(C1)O)O)O)=O,,,4,1,2,8,10
11942_0,,,,2,1,1,2
C(C1(CCOC(CC1O)O)O)(O)=O,,,4,1,1,8,9
11944_0,,,,2,1,1,2
C(C1(CC(OCC(C1O)=O)O)O)=O,,,4,1,1,13,14
11946_0,,,,2,1,1,2
C(C1(CC(O)OCC(C1O)O)O)=O,,,4,1,1,11,12
11948_0,,,,2,1,1,2
C1(C(C)(C(C(CC(O)O1)O)O)O)=O,,,4,1,1,8,9
11950_0,,,,2,1,1,2
C1(C(C)(C(CC(C(O)O1)O)O)O)=O,,,4,1,1,8,9
11952_0,,,,2,1,1,2
C1(C(C(CC(C(O)O1)O)O)O)=O,,,4,1,1,8,9
11953_0,,,,2,1,1,2
11954_0,,,,2,1,1,2
11955_0,,,,2,1,1,2
11956_0,,,,2,1,1,2
11957_0,,,,2,1,1,2
11958_0,,,,2,1,1,2
11959_0,,,,2,1,1,2
11960_0,,,,2,1,1,2
11961_0,,,,2,1,1,2
11962_0,,,,2,1,1,2
11963_0,,,,2,1,1,2
11964_0,,,,2,1,1,2
11965_0,,,,2,1,1,2
11966_0,,,,2,1,1,2
11967_0,,,,2,1,1,2
11968_0,,,,2,1,1,2
11969_0,,,,2,1,1,2
11970_0,,,,2,1,1,2
11971_0,,,,2,1,2,3
11972_0,,,,2,1,2,3
11973_0,,,,2,1,2,3
11974_0,,,,2,1,2,3
11975_0,,,,2,1,2,3
11976_0,,,,2,1,2,3
11977_0,,,,2,1,2,3
11978_0,,,,2,1,2,3
11979_0,,,,2,1,2,3
11980_0,,,,2,1,2,3
11981_0,,,,2,1,2,3
11983_0,,,,2,1,2,3
C1(C(C(C(C=O)=O)CO1)O)=O,,,4,1,1,12,13
11985_0,,,,2,1,2,3
C1(C(C(C=O)C(C=O)O1)O)=O,,,4,1,2,12,14
11986_0,,,,2,1,2,3
11988_0,,,,2,1,2,3
C1(C(C(C(C(C=O)O)O1)O)O)=O,,,4,1,2,12,14
11989_0,,,,2,1,2,3
11990_0,,,,2,1,2,3
11992_0,,,,2,1,2,3
C(C1(COC(C1O)=O)O)=O,,,4,1,5,14,19
11993_0,,,,2,1,2,3
11995_0,,,,2,1,2,3
C(C1(C(CO)OC(C1O)=O)O)=O,,,4,1,4,8,12
11996_0,,,,2,1,2,3
11997_0,,,,2,1,2,3
11999_0,,,,2,1,2,3
C1(C(C(C(O1)=O)O)O)=O,,,4,1,5,15,20
12000_0,,,,2,1,2,3
12001_0,,,,2,1,2,3
12003_0,,,,2,1,2,3
C1(C(C(CO1)O)=O)=O,,,4,1,16,55,71
12005_0,,,,2,1,2,3
C1(C(C(C=O)(C(C=O)O1)O)O)=O,,,4,1,1,12,13
12007_0,,,,2,1,2,3
C1(C(CO)(C(CO)(CO1)O)O)=O,,,4,1,5,7,12
12009_0,,,,2,1,2,3
C(CO)(C1(COC(C1O)=O)O)=O,,,4,1,3,7,10
12011_0,,,,2,1,2,3
C1(C(CO)(C(C(O1)=O)O)O)=O,,,4,1,4,10,14
12013_0,,,,2,1,2,3
C(C1(COC(C1O)=O)O)(O)=O,,,4,1,4,8,12
12015_0,,,,2,1,2,3
C1(C(CO)(C(C=O)(CO1)O)O)=O,,,4,1,3,11,14
12016_0,,,,2,1,2,3
12018_0,,,,2,1,2,3
C1(C(C(C(C=O)=O)(CO1)O)O)=O,,,4,1,1,12,13
12020_0,,,,2,1,2,3
C(C1(C(C)OC(C1O)=O)O)=O,,,4,1,1,9,10
12022_0,,,,2,1,2,3
C1(C(C)(C(CO)(CO1)O)O)=O,,,4,1,3,4,7
12024_0,,,,2,1,2,3
C1(C(C(CO)(CO1)O)O)=O,,,4,1,7,10,17
12026_0,,,,2,1,2,3
C1(C(C(CO1)(C(CO)O)O)O)=O,,,4,1,5,7,12
12028_0,,,,2,1,2,3
C1(C(C(CO)(C(CO)O1)O)O)=O,,,4,1,5,4,9
12030_0,,,,2,1,2,3
C1(C(C)(C(C(O1)=O)O)O)=O,,,4,1,1,10,11
12031_0,,,,2,1,2,3
12033_0,,,,2,1,2,3
C1(C(CCO)(C(C(O1)=O)O)O)=O,,,4,1,3,7,10
12035_0,,,,2,1,2,3
C1(C(C(C(CO)(CO)O1)O)O)=O,,,4,1,3,3,6
12036_0,,,,2,1,2,3
12037_0,,,,2,1,2,3
12038_0,,,,2,1,2,3
12040_0,,,,2,1,2,3
C1(C(C)(C(C(CC=O)O1)O)O)=O,,,4,1,1,8,9
12042_0,,,,2,1,2,3
C1(C(C)(C(CO1)(CC=O)O)O)=O,,,4,1,1,8,9
12044_0,,,,2,1,2,3
C(CC1(COC(C1O)=O)O)=O,,,4,1,3,12,15
12046_0,,,,2,1,2,3
C1(C(C)(C(C(C(C)=O)O1)O)O)=O,,,4,1,1,7,8
12047_0,,,,2,1,2,3
12049_0,,,,2,1,2,3
C1(C(C)(C(C)(C(C=O)O1)O)O)=O,,,4,1,1,8,9
12051_0,,,,2,1,2,3
C1(C(C(C)(C(C=O)O1)O)O)=O,,,4,1,1,12,13
12052_0,,,,2,1,2,3
12054_0,,,,2,1,2,3
C1(C(C)(C(C=O)(CO1)O)O)=O,,,4,1,1,7,8
12056_0,,,,2,1,2,3
C1(C(C)(C(C(CO)O1)O)O)=O,,,4,1,2,3,5
12058_0,,,,2,1,2,3
C1(C(C)(C(CO1)O)O)=O,,,4,1,1,6,7
12059_0,,,,2,1,2,3
12060_0,,,,2,1,2,3
12062_0,,,,2,1,2,3
C1(C(C(CO1)O)(CCO)O)=O,,,4,1,2,5,7
12063_0,,,,2,1,2,3
12064_0,,,,2,1,2,3
12065_0,,,,2,1,2,3
12066_0,,,,2,1,2,3
12067_0,,,,2,1,2,3
12068_0,,,,2,1,1,2
12069_0,,,,2,1,1,2
12070_0,,,,2,1,1,2
12072_0,,,,2,1,2,3
C1(C(C(C(CO)O1)O)=O)=O,,,4,1,2,9,11
12074_0,,,,2,1,2,3
C1(C(C(C(C(CO)O)O1)O)=O)=O,,,4,1,3,5,8
12076_0,,,,2,1,2,3
C1(C(CC(CO)O1)O)=O,,,4,1,3,11,14
12078_0,,,,2,1,2,3
C1(C(CC(C(CO)O)O1)O)=O,,,4,1,4,4,8
12079_0,,,,2,1,2,3
12081_0,,,,2,1,2,3
C1(C(C(C(CO1)=O)O)O)=O,,,4,1,9,25,34
12083_0,,,,2,1,2,3
C1(C(C(C(OC1CO)=O)O)O)=O,,,4,1,4,8,12
12085_0,,,,2,1,2,3
C(C1C(COC(C1O)=O)=O)=O,,,4,1,4,11,15
12087_0,,,,2,1,2,3
C(C1C(CC(C(O1)=O)O)=O)=O,,,4,1,2,12,14
12089_0,,,,2,1,2,3
C1(C(C(C(C(C=O)O1)O)O)O)=O,,,4,1,2,14,16
12090_0,,,,2,1,2,3
12092_0,,,,2,1,2,3
C(C1(C(COC(C1O)=O)O)O)=O,,,4,1,3,12,15
12094_0,,,,2,1,2,3
C1(COC(C(C1(CO)O)O)=O)=O,,,4,1,5,10,15
12096_0,,,,2,1,2,3
C1(C(CO)(C(C(CO1)=O)O)O)=O,,,4,1,3,10,13
12098_0,,,,2,1,2,3
C1(C(C(CO)(C(CO1)O)O)O)=O,,,4,1,4,6,10
12100_0,,,,2,1,2,3
C(C1(CCOC(C1O)=O)O)(O)=O,,,4,1,3,6,9
12102_0,,,,2,1,2,3
C1(C(C(C(CO)(CO1)O)O)O)=O,,,4,1,3,7,10
12104_0,,,,2,1,2,3
C1(C(C)(C(C=O)(CCO1)O)O)=O,,,4,1,1,7,8
12106_0,,,,2,1,2,3
C(C1(CCOC(C1O)=O)O)=O,,,4,1,1,9,10
12108_0,,,,2,1,2,3
C1(C(C)(C(CC(C=O)O1)O)O)=O,,,4,1,2,8,10
12110_0,,,,2,1,2,3
C1(C(C(CC(C=O)O1)O)O)=O,,,4,1,2,13,15
12112_0,,,,2,1,2,3
C1(C(C)(C(C(CO1)=O)O)O)=O,,,4,1,1,10,11
12114_0,,,,2,1,2,3
C1(C(C)(C(C(CO1)O)O)O)=O,,,4,1,1,6,7
12115_0,,,,2,1,2,3
12116_0,,,,2,1,2,3
12117_0,,,,2,1,2,3
12118_0,,,,2,1,2,3
12119_0,,,,2,1,2,3
12120_0,,,,2,1,2,3
12121_0,,,,2,1,2,3
12122_0,,,,2,1,2,3
12123_0,,,,2,1,1,2
12125_0,,,,2,1,2,3
C1(C(C(C(CO1)O)O)=O)=O,,,4,1,2,13,15
12127_0,,,,2,1,2,3
C1(C(C(C(C(CO)O1)O)O)=O)=O,,,4,1,3,7,10
12129_0,,,,2,1,2,3
C1(C(CC(CO1)O)O)=O,,,4,1,2,13,15
12131_0,,,,2,1,2,3
C1(C(CC(C(CO)O1)O)O)=O,,,4,1,3,4,7
12133_0,,,,2,1,2,3
C1(C(C(C(OCC1O)=O)O)O)=O,,,4,1,1,8,9
12135_0,,,,2,1,2,3
C1(C(C)(C(C(CCO1)=O)O)O)=O,,,4,1,1,7,8
12136_0,,,,2,1,2,3
12138_0,,,,2,1,2,3
C1(C(C)(C(CC(CO1)=O)O)O)=O,,,4,1,2,7,9
12139_0,,,,2,1,2,3
12140_0,,,,2,1,2,3
12141_0,,,,2,1,2,3
12142_0,,,,2,1,2,3
12143_0,,,,2,1,2,3
12145_0,,,,2,1,2,3
C1(C(C(C(C(CO1)O)O)O)=O)=O,,,4,1,2,10,12
12147_0,,,,2,1,2,3
C1(C(CC(C(CO1)O)O)O)=O,,,4,1,2,7,9
12149_0,,,,2,2,1,3
C(CCC(C=O)C(C(O)=O)O)(O)=O,,,4,1,8,11,19
12151_0,,,,2,2,1,3
C(CCC(C(O)=O)(CC=O)O)(O)=O,,,4,1,2,10,12
12153_0,,,,2,2,1,3
C(CCC(C=O)C(C=O)(C)O)(O)=O,,,4,1,2,10,12
12155_0,,,,2,2,1,3
C(CCCC(C=O)(CC=O)O)(O)=O,,,4,1,2,8,10
12157_0,,,,2,2,1,3
C(CCC(C=O)C(C(C)=O)O)(O)=O,,,4,1,2,10,12
12159_0,,,,2,2,1,3
C(C)(C(CCC(O)=O)(CC=O)O)=O,,,4,1,1,9,10
12161_0,,,,2,2,1,3
C(CCCC(C(CC=O)O)=O)(O)=O,,,4,1,3,9,12
12163_0,,,,2,2,1,3
C(CCC(C)(CC(C=O)=O)O)(O)=O,,,4,1,1,10,11
12165_0,,,,2,2,1,3
C(CCCC(CC(C=O)=O)O)(O)=O,,,4,1,2,8,10
12167_0,,,,2,2,1,3
C(CCC(C(C=O)=O)C(C)O)(O)=O,,,4,1,3,11,14
12169_0,,,,2,2,1,3
C(C(CCC(O)=O)C(CC=O)O)=O,,,4,1,3,10,13
12171_0,,,,2,2,1,3
C(CCC(CC=O)(CC=O)O)(O)=O,,,4,1,1,7,8
12173_0,,,,2,2,1,3
C(C(C=O)C(C)(CCC(O)=O)O)=O,,,4,1,1,9,10
12175_0,,,,2,2,1,3
C(C(C=O)C(CCCC(O)=O)O)=O,,,4,1,3,7,10
12177_0,,,,2,2,1,3
C(C(C=O)(CCC(O)=O)C(C)O)=O,,,4,1,2,7,9
12179_0,,,,2,2,1,3
C(C(C=O)C(CCC(C=O)=O)O)=O,,,4,1,3,13,16
12181_0,,,,2,2,1,3
C(C(C(C(C=O)C=O)O)CC=O)=O,,,4,1,4,12,16
12183_0,,,,2,2,1,3
C(C(C=O)C(CCC(O)=O)O)=O,,,4,1,2,10,12
12185_0,,,,2,2,1,3
C(C(C=O)(CCC(C=O)=O)CO)=O,,,4,1,2,8,10
12187_0,,,,2,2,1,3
C(CC(C=O)C(C=O)(C=O)CO)=O,,,4,1,2,9,11
12189_0,,,,2,2,1,3
C(C(C=O)(CCC(O)=O)CO)=O,,,4,1,2,7,9
12191_0,,,,2,2,1,3
C(C(CCC(C=O)=O)C(C)O)=O,,,4,1,2,17,19
12193_0,,,,2,2,1,3
C(CC(C=O)C(C=O)C(C)O)=O,,,4,1,4,17,21
12195_0,,,,2,2,1,3
C(C(CCC(O)=O)C(C)O)=O,,,4,1,2,11,13
12197_0,,,,2,2,1,3
C(C(C(CO)CC(O)=O)C(C)O)=O,,,4,1,2,13,15
12199_0,,,,2,2,1,3
C(CC(C)(CCC(C=O)=O)O)=O,,,4,1,1,21,22
12201_0,,,,2,2,1,3
C(CC(C)(C(C=O)CC=O)O)=O,,,4,1,3,19,22
12203_0,,,,2,2,1,3
C(CCC(C)(CC=O)O)(O)=O,,,4,1,1,12,13
12205_0,,,,2,2,1,3
C(CC(CO)C(C)(CC=O)O)(O)=O,,,4,1,1,12,13
12207_0,,,,2,2,1,3
C(CC(CCCC(C=O)=O)O)=O,,,4,1,2,20,22
12209_0,,,,2,2,1,3
C(CC(CC(C=O)CC=O)O)=O,,,4,1,4,21,25
12211_0,,,,2,2,1,3
C(CCCC(CC=O)O)(O)=O,,,4,1,2,10,12
12213_0,,,,2,2,1,3
C(CC(CO)CC(CC=O)O)(O)=O,,,4,1,2,10,12
12215_0,,,,2,2,1,3
C(C(CCC(C=O)=O)(C(C)O)O)=O,,,4,1,2,13,15
12217_0,,,,2,2,1,3
C(CC(C=O)C(C=O)(C(C)O)O)=O,,,4,1,3,13,16
12219_0,,,,2,2,1,3
C(C(CCC(O)=O)(C(C)O)O)=O,,,4,1,2,11,13
12221_0,,,,2,2,1,3
C(C(C(CCC(C=O)=O)(C)O)O)=O,,,4,1,2,20,22
12223_0,,,,2,2,1,3
C(C(C(C)(C(C=O)CC=O)O)O)=O,,,4,1,5,18,23
12225_0,,,,2,2,1,3
C(CCC(C)(C(C=O)O)O)(O)=O,,,4,1,2,14,16
12227_0,,,,2,2,1,3
C(C(C(CCCC(C=O)=O)O)O)=O,,,4,1,4,20,24
12229_0,,,,2,2,1,3
C(C(C(CC(C=O)CC=O)O)O)=O,,,4,1,5,22,27
12231_0,,,,2,2,1,3
C(CCCC(C(C=O)O)O)(O)=O,,,4,1,4,14,18
12233_0,,,,2,2,1,3
C(CC(CCC(C=O)=O)O)=O,,,4,1,4,23,27
12235_0,,,,2,2,1,3
C(CC(C(C=O)CC=O)O)=O,,,4,1,6,22,28
12237_0,,,,2,2,1,3
C(CCC(CC=O)O)(O)=O,,,4,1,3,16,19
12239_0,,,,2,2,1,3
C(CC(CO)C(CC=O)O)(O)=O,,,4,1,2,13,15
12241_0,,,,2,2,1,3
C(C(CCC(C=O)=O)CO)=O,,,4,1,4,18,22
12243_0,,,,2,2,1,3
C(CC(C=O)C(C=O)CO)=O,,,4,1,6,18,24
12245_0,,,,2,2,1,3
C(C(CCC(O)=O)CO)=O,,,4,1,5,13,18
12247_0,,,,2,2,1,3
C(C(CO)C(CO)CC(O)=O)=O,,,4,1,4,14,18
12249_0,,,,2,2,1,3
C(CC(C(CCC(C=O)=O)O)O)=O,,,4,1,2,19,21
12251_0,,,,2,2,1,3
C(CC(C(C(C=O)CC=O)O)O)=O,,,4,1,3,20,23
12253_0,,,,2,2,1,3
C(CCC(C(CC=O)O)O)(O)=O,,,4,1,3,12,15
12255_0,,,,2,2,1,3
C(CC(CCC(C=O)=O)(CO)O)=O,,,4,1,3,18,21
12257_0,,,,2,2,1,3
C(CC(CO)(C(C=O)CC=O)O)=O,,,4,1,4,16,20
12259_0,,,,2,2,1,3
C(CCC(CO)(CC=O)O)(O)=O,,,4,1,3,12,15
12261_0,,,,2,2,1,3
C(C(CCC(C=O)=O)C(CO)O)=O,,,4,1,3,14,17
12263_0,,,,2,2,1,3
C(CC(C=O)C(C=O)C(CO)O)=O,,,4,1,4,15,19
12265_0,,,,2,2,1,3
C(C(CCC(O)=O)C(CO)O)=O,,,4,1,4,13,17
12267_0,,,,2,2,1,3
C(C(C(C=O)=O)(CCC(O)=O)O)=O,,,4,1,2,10,12
12269_0,,,,2,2,1,3
C(CCC(C(C(C=O)O)=O)O)(O)=O,,,4,1,2,10,12
12271_0,,,,2,2,1,3
C(CCC(C=O)(C(CO)=O)O)(O)=O,,,4,1,3,9,12
12273_0,,,,2,2,1,3
C(C=O)(CCC(C(C(C)=O)=O)O)=O,,,4,1,1,12,13
12275_0,,,,2,2,1,3
C(CC(C=O)C(C(C(C)=O)=O)O)=O,,,4,1,2,11,13
12277_0,,,,2,2,1,3
C(CCC(C(C(C)=O)=O)O)(O)=O,,,4,1,3,9,12
12279_0,,,,2,2,1,3
C(C=O)(CCCC(C(CO)=O)=O)=O,,,4,1,3,12,15
12281_0,,,,2,2,1,3
C(CC(C=O)CC(C(CO)=O)=O)=O,,,4,1,3,12,15
12283_0,,,,2,2,1,3
C(CCCC(C(CO)=O)=O)(O)=O,,,4,1,5,8,13
12285_0,,,,2,2,1,3
C(C=O)(CCCC(C(C=O)=O)O)=O,,,4,1,3,14,17
12287_0,,,,2,2,1,3
C(C(CC(C(C=O)=O)O)CC=O)=O,,,4,1,4,14,18
12289_0,,,,2,2,1,3
C(CCCC(C(C=O)=O)O)(O)=O,,,4,1,4,11,15
12291_0,,,,2,2,1,3
C(C=O)(C(C)(CCC(C=O)=O)O)=O,,,4,1,2,11,13
12293_0,,,,2,2,1,3
C(CC(C=O)C(C(C=O)=O)(C)O)=O,,,4,1,3,11,14
12295_0,,,,2,2,1,3
C(CCC(C(C=O)=O)(C)O)(O)=O,,,4,1,3,12,15
12297_0,,,,2,2,1,3
C(C(C=O)(CCC(C=O)=O)O)=O,,,4,1,1,12,13
12299_0,,,,2,2,1,3
C(C(C=O)(C(C=O)CC=O)O)=O,,,4,1,3,12,15
12301_0,,,,2,2,1,3
C(C(C=O)(CCC(O)=O)O)=O,,,4,1,1,6,7
12303_0,,,,2,2,1,3
C(C(C=O)(C(CO)CC(O)=O)O)=O,,,4,1,1,9,10
12305_0,,,,2,2,1,3
C(CCC(C(CO)(CO)O)O)(O)=O,,,4,1,2,7,9
12307_0,,,,2,2,1,3
C(C)(C(CCC(C=O)=O)O)=O,,,4,1,6,18,24
12309_0,,,,2,2,1,3
C(CC(C=O)C(C(C)=O)O)=O,,,4,1,8,18,26
12311_0,,,,2,2,1,3
C(CCC(C(C)=O)O)(O)=O,,,4,1,8,13,21
12313_0,,,,2,2,1,3
C(CC(CO)C(C(C)=O)O)(O)=O,,,4,1,2,10,12
12315_0,,,,2,2,1,3
C(CO)(CCCC(C=O)=O)=O,,,4,1,8,20,28
12317_0,,,,2,2,1,3
C(CC(C=O)CC(CO)=O)=O,,,4,1,9,20,29
12319_0,,,,2,2,1,3
C(CCCC(CO)=O)(O)=O,,,4,1,12,16,28
12321_0,,,,2,2,1,3
C(CC(CO)CC(CO)=O)(O)=O,,,4,1,4,11,15
12323_0,,,,2,2,1,3
C(C(CCC(C=O)=O)O)(CCO)=O,,,4,1,3,14,17
12325_0,,,,2,2,1,3
C(C(C(C=O)CC=O)O)(CCO)=O,,,4,1,4,14,18
12327_0,,,,2,2,1,3
C(CCC(C(CCO)=O)O)(O)=O,,,4,1,4,8,12
12329_0,,,,2,2,1,3
C(CO)(CC(CCC(C=O)=O)O)=O,,,4,1,4,18,22
12331_0,,,,2,2,1,3
C(CO)(CC(C(C=O)CC=O)O)=O,,,4,1,5,17,22
12333_0,,,,2,2,1,3
C(CCC(CC(CO)=O)O)(O)=O,,,4,1,4,8,12
12335_0,,,,2,2,1,3
C(CO)(C(CO)CCC(C=O)=O)=O,,,4,1,5,15,20
12337_0,,,,2,2,1,3
C(CO)(C(CO)C(C=O)CC=O)=O,,,4,1,5,16,21
12339_0,,,,2,2,1,3
C(CCC(C(CO)=O)CO)(O)=O,,,4,1,6,9,15
12341_0,,,,2,2,1,3
C(C(CCC(C=O)=O)(CCO)O)=O,,,4,1,2,11,13
12343_0,,,,2,2,1,3
C(CC(C=O)C(C=O)(CCO)O)=O,,,4,1,3,12,15
12345_0,,,,2,2,1,3
C(C(CCC(O)=O)(CCO)O)=O,,,4,1,2,10,12
12347_0,,,,2,2,1,3
C(C(CC(CCC(C=O)=O)O)O)=O,,,4,1,3,16,19
12349_0,,,,2,2,1,3
C(C(CC(C(C=O)CC=O)O)O)=O,,,4,1,4,18,22
12351_0,,,,2,2,1,3
C(CCC(CC(C=O)O)O)(O)=O,,,4,1,3,12,15
12353_0,,,,2,2,1,3
C(C(C(CCC(C=O)=O)CO)O)=O,,,4,1,4,16,20
12355_0,,,,2,2,1,3
C(C(C(CO)C(C=O)CC=O)O)=O,,,4,1,5,17,22
12357_0,,,,2,2,1,3
C(CCC(CO)C(C=O)O)(O)=O,,,4,1,4,12,16
12359_0,,,,2,2,1,3
C(C)(C(CO)(CCC(C=O)=O)O)=O,,,4,1,3,13,16
12361_0,,,,2,2,1,3
C(C)(C(CO)(C(C=O)CC=O)O)=O,,,4,1,4,13,17
12363_0,,,,2,2,1,3
C(CCC(C(C)=O)(CO)O)(O)=O,,,4,1,4,9,13
12365_0,,,,2,2,1,3
C(C)(C(C(CCC(C=O)=O)O)O)=O,,,4,1,3,20,23
12367_0,,,,2,2,1,3
C(C)(C(C(C(C=O)CC=O)O)O)=O,,,4,1,4,18,22
12369_0,,,,2,2,1,3
C(CCC(C(C(C)=O)O)O)(O)=O,,,4,1,2,11,13
12371_0,,,,2,2,1,3
C(C(CO)O)(CCCC(C=O)=O)=O,,,4,1,4,15,19
12373_0,,,,2,2,1,3
C(CC(C=O)CC=O)(C(CO)O)=O,,,4,1,5,16,21
12375_0,,,,2,2,1,3
C(CCCC(C(CO)O)=O)(O)=O,,,4,1,5,10,15
12377_0,,,,2,2,1,3
C(C(CCC(C)O)=O)=O,,,4,1,2,27,29
12379_0,,,,2,2,1,3
C(C(C(C)O)CC=O)=O,,,4,1,4,33,37
12381_0,,,,2,2,1,3
C(CCC(C)O)(O)=O,,,4,1,1,16,17
12383_0,,,,2,2,1,3
C(CC(CO)C(C)O)(O)=O,,,4,1,1,7,8
12385_0,,,,2,2,1,3
C(C(CCCCO)=O)=O,,,4,1,2,26,28
12387_0,,,,2,2,1,3
C(C(CCO)CC=O)=O,,,4,1,4,27,31
12389_0,,,,2,2,1,3
C(CCCCO)(O)=O,,,4,1,2,15,17
12391_0,,,,2,2,1,3
C(CC(CO)CCO)(O)=O,,,4,1,2,6,8
12393_0,,,,2,2,1,3
C(C(CCCC(C(O)=O)=O)=O)=O,,,4,1,5,14,19
12395_0,,,,2,2,1,3
C(CC(C=O)CC(C(O)=O)=O)=O,,,4,1,5,14,19
12397_0,,,,2,2,1,3
C(CCCC(C(O)=O)=O)(O)=O,,,4,1,6,9,15
12399_0,,,,2,2,1,3
C(CC(CO)CC(C(O)=O)=O)(O)=O,,,4,1,4,13,17
12401_0,,,,2,2,1,3
C(C(C(O)=O)CCC(C=O)=O)=O,,,4,1,4,16,20
12403_0,,,,2,2,1,3
C(C(C(O)=O)C(C=O)CC=O)=O,,,4,1,5,15,20
12405_0,,,,2,2,1,3
C(C(C(O)=O)CCC(O)=O)=O,,,4,1,4,10,14
12407_0,,,,2,2,1,3
C(C(C=O)C(CO)CC(O)=O)(O)=O,,,4,1,3,13,16
12409_0,,,,2,2,1,3
C(CCC(CC(C(O)=O)=O)O)(O)=O,,,4,1,3,10,13
12411_0,,,,2,2,1,3
C(CCC(C(C(O)=O)=O)CO)(O)=O,,,4,1,5,11,16
12413_0,,,,2,2,1,3
C(CCC(C=O)(CC(O)=O)O)(O)=O,,,4,1,2,8,10
12415_0,,,,2,2,1,3
C(CCC(C(O)=O)C(C=O)O)(O)=O,,,4,1,5,10,15
12417_0,,,,2,2,1,3
C(CCC(C(O)=O)C(CO)=O)(O)=O,,,4,1,5,9,14
12419_0,,,,2,2,1,3
C(CCC(C(CC(O)=O)=O)O)(O)=O,,,4,1,3,8,11
12421_0,,,,2,2,1,3
C(CCC(C(O)=O)(C(C)=O)O)(O)=O,,,4,1,3,7,10
12423_0,,,,2,2,1,3
C(C(C(CCCC(O)=O)=O)O)(O)=O,,,4,1,8,8,16
12425_0,,,,2,2,1,3
C(CCCC(C=O)=O)(O)=O,,,4,1,13,15,28
12427_0,,,,2,2,1,3
C(CC(C=O)CC(O)=O)=O,,,4,1,4,15,19
12429_0,,,,2,2,1,3
C(CCCC(O)=O)(O)=O,,,4,1,2,4,6
12431_0,,,,2,2,1,3
C(CC(CO)CC(O)=O)(O)=O,,,4,1,2,5,7
12433_0,,,,2,2,1,3
C(C=O)(CCC(C(C(O)=O)=O)O)=O,,,4,1,3,12,15
12435_0,,,,2,2,1,3
C(CC(C=O)C(C(C(O)=O)=O)O)=O,,,4,1,3,12,15
12437_0,,,,2,2,1,3
C(CCC(C(C(O)=O)=O)O)(O)=O,,,4,1,3,9,12
12439_0,,,,2,2,1,3
C(C(CCC(O)=O)(C(C)O)O)(O)=O,,,4,1,4,9,13
12441_0,,,,2,2,1,3
C(CCC(C)(C(C(O)=O)O)O)(O)=O,,,4,1,5,10,15
12443_0,,,,2,2,1,3
C(CCCC(C(C(O)=O)O)O)(O)=O,,,4,1,6,9,15
12445_0,,,,2,2,1,3
C(C(C)(C(CCC(O)=O)O)O)(O)=O,,,4,1,2,9,11
12447_0,,,,2,2,1,3
C(C(CO)(CCCC(O)=O)O)(O)=O,,,4,1,3,8,11
12449_0,,,,2,2,1,3
C(C(C(C=O)=O)CCC(C=O)=O)=O,,,4,1,3,9,12
12451_0,,,,2,2,1,3
C(C(C(C=O)=O)C(C=O)CC=O)=O,,,4,1,2,8,10
12453_0,,,,2,2,1,3
C(C(C(C=O)=O)CCC(O)=O)=O,,,4,1,6,14,20
12455_0,,,,2,2,1,3
C(C(C(C=O)=O)CCC(O)=O)(O)=O,,,4,1,4,10,14
12457_0,,,,2,2,1,3
C(C(C(C(O)=O)=O)CCC(O)=O)=O,,,4,1,3,10,13
12459_0,,,,2,2,1,3
C1(C(CCC(C=O)=O)OCC1O)=O,,,4,1,2,10,12
12461_0,,,,2,2,1,3
C(CC(C=O)C1C(C(CO1)O)=O)=O,,,4,1,2,10,12
12463_0,,,,2,2,1,3
C(CCC1C(C(CO1)O)=O)(O)=O,,,4,1,3,4,7
12465_0,,,,2,2,1,3
C1(COC(CCC(C=O)=O)C1O)=O,,,4,1,2,15,17
12467_0,,,,2,2,1,3
C(C(C1C(C(CO1)=O)O)CC=O)=O,,,4,1,2,13,15
12469_0,,,,2,2,1,3
C(CCC1C(C(CO1)=O)O)(O)=O,,,4,1,3,4,7
12471_0,,,,2,2,1,3
C1(COCC1(CCC(C=O)=O)O)=O,,,4,1,1,10,11
12473_0,,,,2,2,1,3
C1(COCC1(C(C=O)CC=O)O)=O,,,4,1,1,10,11
12475_0,,,,2,2,1,3
C(CCC1(C(COC1)=O)O)(O)=O,,,4,1,2,4,6
12477_0,,,,2,2,1,3
C1(C(CCC(C=O)=O)(O)OCC1)=O,,,4,1,1,11,12
12479_0,,,,2,2,1,3
C(CC(C=O)C1(C(CCO1)=O)O)=O,,,4,1,1,11,12
12481_0,,,,2,2,1,3
C(CCC1(C(CCO1)=O)O)(O)=O,,,4,1,2,6,8
12483_0,,,,2,2,1,3
C1(C(O)OC(CCC(C=O)=O)C1)=O,,,4,1,2,12,14
12485_0,,,,2,2,1,3
C(CC(C=O)C1CC(C(O)O1)=O)=O,,,4,1,2,11,13
12487_0,,,,2,2,1,3
C(CCC1CC(C(O)O1)=O)(O)=O,,,4,1,3,5,8
12489_0,,,,2,2,1,3
C1(C(O)OCC1CCC(C=O)=O)=O,,,4,1,2,10,12
12491_0,,,,2,2,1,3
C1(C(O)OCC1C(C=O)CC=O)=O,,,4,1,2,11,13
12493_0,,,,2,2,1,3
C(CCC1C(C(O)OC1)=O)(O)=O,,,4,1,3,7,10
12495_0,,,,2,2,1,3
C1(C(CCC(C=O)=O)C(CO1)O)=O,,,4,1,1,8,9
12497_0,,,,2,2,1,3
C1(C(C(CO1)O)C(C=O)CC=O)=O,,,4,1,1,8,9
12499_0,,,,2,2,1,3
C1(C(CCC(O)=O)C(CO1)O)=O,,,4,1,2,5,7
12501_0,,,,2,2,1,3
C1(CC(C(CCC(C=O)=O)O1)O)=O,,,4,1,1,8,9
12503_0,,,,2,2,1,3
C1(CC(C(C(C=O)CC=O)O1)O)=O,,,4,1,1,8,9
12505_0,,,,2,2,1,3
C1(CC(C(CCC(O)=O)O1)O)=O,,,4,1,2,3,5
12507_0,,,,2,2,1,3
C1(CC(CO1)(CCC(C=O)=O)O)=O,,,4,1,1,9,10
12509_0,,,,2,2,1,3
C1(CC(CO1)(C(C=O)CC=O)O)=O,,,4,1,2,8,10
12511_0,,,,2,2,1,3
C1(CC(CO1)(CCC(O)=O)O)=O,,,4,1,2,5,7
12513_0,,,,2,2,1,3
C1(COC(C1CCC(C=O)=O)O)=O,,,4,1,2,14,16
12515_0,,,,2,2,1,3
C1(COC(C1C(C=O)CC=O)O)=O,,,4,1,2,14,16
12517_0,,,,2,2,1,3
C(CCC1C(COC1O)=O)(O)=O,,,4,1,3,8,11
12519_0,,,,2,2,1,3
C1(COC(CCC(C=O)=O)(C1)O)=O,,,4,1,1,18,19
12521_0,,,,2,2,1,3
C1(COC(C(C=O)CC=O)(C1)O)=O,,,4,1,1,16,17
12523_0,,,,2,2,1,3
C(CCC1(CC(CO1)=O)O)(O)=O,,,4,1,2,8,10
12525_0,,,,2,2,1,3
C1(C(CCC(C=O)=O)OC(C1)O)=O,,,4,1,2,11,13
12527_0,,,,2,2,1,3
C1(C(C(C=O)CC=O)OC(C1)O)=O,,,4,1,2,11,13
12529_0,,,,2,2,1,3
C(CCC1C(CC(O1)O)=O)(O)=O,,,4,1,3,6,9
12531_0,,,,2,2,1,3
C(C(CCCC(C(C=O)=O)=O)=O)=O,,,4,1,1,8,9
12533_0,,,,2,2,1,3
C(CC(C=O)CC(C(C=O)=O)=O)=O,,,4,1,1,7,8
12535_0,,,,2,2,1,3
C(CCCC(C(C=O)=O)=O)(O)=O,,,4,1,3,10,13
12537_0,,,,2,2,1,3
C(C(CCC(C=O)=O)O)=CC(O)=O,,,4,1,1,7,8
12539_0,,,,2,2,1,3
C(C(C=C)(CCC(C=O)=O)O)(O)=O,,,4,1,1,10,11
12541_0,,,,2,2,1,3
C1(C(CCC(C=O)=O)(CCO1)O)=O,,,4,1,1,7,8
12543_0,,,,2,2,1,3
C1(C(CC(CCC(C=O)=O)O1)O)=O,,,4,1,2,7,9
12545_0,,,,2,2,1,3
C1(C(C(CCC(C=O)=O)CO1)O)=O,,,4,1,2,8,10
12547_0,,,,2,2,1,3
C(C(CCC(C=O)=O)(O)O)=O,,,4,1,1,13,14
12549_0,,,,2,2,1,3
C(C(C)(CCC(C=O)=O)O)=O,,,4,1,2,14,16
12551_0,,,,2,2,1,3
C(C(CCCC(C=O)=O)O)=O,,,4,1,3,20,23
12553_0,,,,2,2,1,3
C(C(CC[C](C(O)=O)O)=O)=O,,,4,1,1,13,14
12555_0,,,,2,2,1,3
C(C(CO)(CCC(C=O)=O)O)=O,,,4,1,5,17,22
12557_0,,,,2,2,1,3
C(C(C(CCC(C=O)=O)O)O)=O,,,4,1,9,27,36
12559_0,,,,2,2,1,3
C(C(CCCO)=O)=O,,,4,1,6,67,73
12561_0,,,,2,2,1,3
C(C(CCC(CO)O)=O)=O,,,4,1,4,19,23
12563_0,,,,2,2,1,3
C(C(CCC(C=O)=O)O)(O)=O,,,4,1,7,17,24
12565_0,,,,2,2,1,3
C(CO)(C(CCC(C=O)=O)O)=O,,,4,1,6,18,24
12567_0,,,,2,2,1,3
C(C(CCC(CO)(CO)O)=O)=O,,,4,1,4,13,17
12569_0,,,,2,2,1,3
C(C(CCC(C(CO)O)O)=O)=O,,,4,1,6,17,23
12571_0,,,,2,2,1,3
C(C(CO)(CCC(C=O)=O)O)(O)=O,,,4,1,4,13,17
12573_0,,,,2,2,1,3
C(C(C(CCC(C=O)=O)O)O)(O)=O,,,4,1,8,18,26
12575_0,,,,2,2,1,3
C(C(CCCC(C=O)=O)=O)=O,,,4,1,6,9,15
12577_0,,,,2,2,1,3
C(C(C=O)CCC(C=O)=O)=O,,,4,1,5,14,19
12579_0,,,,2,2,1,3
C(C(CCC(CC(C=O)=O)O)=O)=O,,,4,1,4,17,21
12581_0,,,,2,2,1,3
C(C=O)(C(CCC(C=O)=O)CO)=O,,,4,1,6,13,19
12583_0,,,,2,2,1,3
C(C(CCC(C=O)=O)(CC=O)O)=O,,,4,1,1,15,16
12585_0,,,,2,2,1,3
C(C(CCC(C=O)=O)C(C=O)O)=O,,,4,1,5,16,21
12587_0,,,,2,2,1,3
C(C(C(CO)=O)CCC(C=O)=O)=O,,,4,1,5,13,18
12589_0,,,,2,2,1,3
C(CC(C(CCC(C=O)=O)O)=O)=O,,,4,1,2,15,17
12591_0,,,,2,2,1,3
C(C(C(C)=O)(CCC(C=O)=O)O)=O,,,4,1,1,9,10
12593_0,,,,2,2,1,3
C(C(C(CCCC(C=O)=O)=O)O)=O,,,4,1,4,14,18
12595_0,,,,2,2,1,3
C(CCCC(C=O)=O)=O,,,4,1,14,46,60
12597_0,,,,2,2,1,3
C(C(C)(CCC(C=O)=O)O)(O)=O,,,4,1,3,14,17
12599_0,,,,2,2,1,3
C(C(CCCC(C=O)=O)O)(O)=O,,,4,1,7,15,22
12601_0,,,,2,2,1,3
C(C=O)(CCC(C(C=O)=O)O)=O,,,4,1,4,19,23
12602_0,,,,2,2,1,3
12604_0,,,,2,2,1,3
C(CC(C=O)C(C=CC(O)=O)O)=O,,,4,1,2,7,9
12606_0,,,,2,2,1,3
C(C(C=C)(C(C=O)CC=O)O)(O)=O,,,4,1,2,10,12
12608_0,,,,2,2,1,3
C1(C(CCO1)(C(C=O)CC=O)O)=O,,,4,1,2,7,9
12610_0,,,,2,2,1,3
C1(C(CC(C(C=O)CC=O)O1)O)=O,,,4,1,2,8,10
12612_0,,,,2,2,1,3
C1(C(C(CO1)C(C=O)CC=O)O)=O,,,4,1,2,9,11
12614_0,,,,2,2,1,3
C(CC(C=O)C(C=O)(O)O)=O,,,4,1,2,14,16
12616_0,,,,2,2,1,3
C(CC(C=O)C(C=O)(C)O)=O,,,4,1,4,15,19
12618_0,,,,2,2,1,3
C(C(CC(C=O)CC=O)O)=O,,,4,1,5,20,25
12620_0,,,,2,2,1,3
C(C([C](C(O)=O)O)CC=O)=O,,,4,1,3,14,17
12621_0,,,,2,2,1,3
12623_0,,,,2,2,1,3
C(C(C(C(C=O)CC=O)O)O)=O,,,4,1,10,25,35
12624_0,,,,2,2,1,3
12625_0,,,,2,2,1,3
12626_0,,,,2,2,1,3
12627_0,,,,2,2,1,3
12629_0,,,,2,2,1,3
C(C(C(CO)(CO)O)CC=O)=O,,,4,1,6,13,19
12631_0,,,,2,2,1,3
C(C(C(C(CO)O)O)CC=O)=O,,,4,1,8,18,26
12633_0,,,,2,2,1,3
C(C(CO)(C(C=O)CC=O)O)(O)=O,,,4,1,6,13,19
12635_0,,,,2,2,1,3
C(C(C(C(C=O)CC=O)O)O)(O)=O,,,4,1,9,17,26
12636_0,,,,2,2,1,3
12637_0,,,,2,2,1,3
12639_0,,,,2,2,1,3
C(C(C(CC(C=O)=O)O)CC=O)=O,,,4,1,5,16,21
12641_0,,,,2,2,1,3
C(CC(C=O)C(C(C=O)=O)CO)=O,,,4,1,6,13,19
12643_0,,,,2,2,1,3
C(CC(C=O)(C(C=O)CC=O)O)=O,,,4,1,3,13,16
12645_0,,,,2,2,1,3
C(CC(C=O)C(C=O)C(C=O)O)=O,,,4,1,5,15,20
12647_0,,,,2,2,1,3
C(C(C(CO)=O)C(C=O)CC=O)=O,,,4,1,5,13,18
12649_0,,,,2,2,1,3
C(CC(C(C(C=O)CC=O)O)=O)=O,,,4,1,3,15,18
12651_0,,,,2,2,1,3
C(C(C(C)=O)(C(C=O)CC=O)O)=O,,,4,1,2,9,11
12653_0,,,,2,2,1,3
C(C(C(CC(C=O)CC=O)=O)O)=O,,,4,1,4,14,18
12654_0,,,,2,2,1,3
12655_0,,,,2,2,1,3
12657_0,,,,2,2,1,3
C(C(CC(C=O)CC=O)O)(O)=O,,,4,1,9,16,25
12658_0,,,,2,2,1,3
12659_0,,,,2,2,1,3
12661_0,,,,2,2,1,3
C(CCC(C=CC(O)=O)O)(O)=O,,,4,1,2,6,8
12663_0,,,,2,2,1,3
C(C(C=C)(CCC(O)=O)O)(O)=O,,,4,1,3,8,11
12665_0,,,,2,2,1,3
C(CCC1(C(C(CO1)O)=O)O)(O)=O,,,4,1,1,7,8
12667_0,,,,2,2,1,3
C(CCC1C(C(C(O)O1)=O)O)(O)=O,,,4,1,2,6,8
12669_0,,,,2,2,1,3
C(CCC1(C(C(O)OC1)=O)O)(O)=O,,,4,1,2,7,9
12671_0,,,,2,2,1,3
C1(C(CCC(O)=O)(C(CO1)O)O)=O,,,4,1,1,7,8
12673_0,,,,2,2,1,3
C(CCC1C(C(C(O1)=O)O)O)(O)=O,,,4,1,2,6,8
12675_0,,,,2,2,1,3
C(CCC1(COC(C1O)=O)O)(O)=O,,,4,1,2,7,9
12677_0,,,,2,2,1,3
C1(C(CCC(O)=O)(CCO1)O)=O,,,4,1,2,5,7
12679_0,,,,2,2,1,3
C(CCC1CC(C(O1)=O)O)(O)=O,,,4,1,3,3,6
12681_0,,,,2,2,1,3
C(CCC1COC(C1O)=O)(O)=O,,,4,1,3,4,7
12683_0,,,,2,2,1,3
C(CCC(C=O)(O)O)(O)=O,,,4,1,1,7,8
12685_0,,,,2,2,1,3
C(C(C)(CCC(O)=O)O)=O,,,4,1,1,8,9
12687_0,,,,2,2,1,3
C(CCCC(C=O)O)(O)=O,,,4,1,3,13,16
12689_0,,,,2,2,1,3
C(CC[C](C(O)=O)O)(O)=O,,,4,1,1,4,5
12691_0,,,,2,2,1,3
C(C(CO)(CCC(O)=O)O)=O,,,4,1,4,10,14
12693_0,,,,2,2,1,3
C(CCC(C(C=O)O)O)(O)=O,,,4,1,7,17,24
12695_0,,,,2,2,1,3
C(C(CCC(O)=O)(C(CO)O)O)=O,,,4,1,7,13,20
12697_0,,,,2,2,1,3
C(CCC(C(C(C=O)O)O)O)(O)=O,,,4,1,9,16,25
12699_0,,,,2,2,1,3
C(CCC(CO)(C(C=O)O)O)(O)=O,,,4,1,7,14,21
12701_0,,,,2,2,1,3
C(CCCO)(O)=O,,,4,1,1,30,31
12703_0,,,,2,2,1,3
C(CCC(CO)O)(O)=O,,,4,1,3,10,13
12705_0,,,,2,2,1,3
C(CCC(C(O)=O)O)(O)=O,,,4,1,7,9,16
12707_0,,,,2,2,1,3
C(CCC(C=O)(C(C=O)O)O)(O)=O,,,4,1,5,15,20
12709_0,,,,2,2,1,3
C(CCC(C(CO)=O)O)(O)=O,,,4,1,7,10,17
12711_0,,,,2,2,1,3
C(CCC(C(C(CO)O)=O)O)(O)=O,,,4,1,7,11,18
12713_0,,,,2,2,1,3
C(CCC(C(C(CO)=O)O)O)(O)=O,,,4,1,5,11,16
12715_0,,,,2,2,1,3
C(CCC(C(CO)=O)(CO)O)(O)=O,,,4,1,6,10,16
12717_0,,,,2,2,1,3
C(CCC(CO)(CO)O)(O)=O,,,4,1,3,5,8
12719_0,,,,2,2,1,3
C(CCC(C(CO)O)O)(O)=O,,,4,1,5,9,14
12721_0,,,,2,2,1,3
C(CCC(CO)(C(CO)O)O)(O)=O,,,4,1,7,10,17
12723_0,,,,2,2,1,3
C(CCC(C(C(CO)O)O)O)(O)=O,,,4,1,7,11,18
12725_0,,,,2,2,1,3
C(C(CO)(CCC(O)=O)O)(O)=O,,,4,1,4,8,12
12727_0,,,,2,2,1,3
C(CCC(C(C(O)=O)O)O)(O)=O,,,4,1,7,10,17
12729_0,,,,2,2,1,3
C(C(CO)(C(CCC(O)=O)O)O)=O,,,4,1,4,15,19
12730_0,,,,2,2,1,3
12732_0,,,,2,2,1,3
C(C(C=O)CCC(O)=O)=O,,,4,1,9,10,19
12734_0,,,,2,2,1,3
C(CCC(CC(C=O)=O)O)(O)=O,,,4,1,5,13,18
12736_0,,,,2,2,1,3
C(CCC(C(C=O)=O)CO)(O)=O,,,4,1,8,14,22
12738_0,,,,2,2,1,3
C(CCC(C=O)(CC=O)O)(O)=O,,,4,1,2,12,14
12740_0,,,,2,2,1,3
C(CCC(C=O)C(C=O)O)(O)=O,,,4,1,6,15,21
12742_0,,,,2,2,1,3
C(CCC(C=O)C(CO)=O)(O)=O,,,4,1,7,11,18
12744_0,,,,2,2,1,3
C(CCC(C(CC=O)=O)O)(O)=O,,,4,1,4,10,14
12746_0,,,,2,2,1,3
C(CCC(C=O)(C(C)=O)O)(O)=O,,,4,1,2,8,10
12748_0,,,,2,2,1,3
C(C(C(CCCC(O)=O)=O)O)=O,,,4,1,5,10,15
12750_0,,,,2,2,1,3
C(CCCC(O)=O)=O,,,4,1,22,47,69
12752_0,,,,2,2,1,3
C(CCC1(C(O)OCC1O)O)(O)=O,,,4,1,3,8,11
12754_0,,,,2,2,1,3
C(CCC1(C(C(CO1)O)O)O)(O)=O,,,4,1,3,9,12
12756_0,,,,2,2,1,3
C(CCC1C(C(C(O)O1)O)O)(O)=O,,,4,1,4,8,12
12758_0,,,,2,2,1,3
C(CCC1(COC(C1O)O)O)(O)=O,,,4,1,3,9,12
12760_0,,,,2,2,1,3
C(C(C)(CCC(O)=O)O)(O)=O,,,4,1,2,6,8
12762_0,,,,2,2,1,3
C(CCCC(C(O)=O)O)(O)=O,,,4,1,8,7,15
12764_0,,,,2,2,1,3
C(C(CCC(O)=O)(CCO)O)(O)=O,,,4,1,4,9,13
12766_0,,,,2,2,1,3
C(CCC(CC(C(O)=O)O)O)(O)=O,,,4,1,8,9,17
12768_0,,,,2,2,1,3
C(CCC(CO)C(C(O)=O)O)(O)=O,,,4,1,7,9,16
12770_0,,,,2,2,1,3
C(CCC(C(C=O)=O)O)(O)=O,,,4,1,5,13,18
12772_0,,,,2,2,1,3
C(CCC(C(C(C=O)=O)O)O)(O)=O,,,4,1,5,14,19
12774_0,,,,2,2,1,3
C(CCC(C(C=O)=O)(CO)O)(O)=O,,,4,1,6,13,19
12776_0,,,,2,2,1,3
C(CCC(C=O)O)(O)=O,,,4,1,14,21,35
12778_0,,,,2,2,1,3
C(CC(CO)C(C=O)(O)O)(O)=O,,,4,1,1,10,11
12780_0,,,,2,2,1,3
C(C(C)(C(CO)CC(O)=O)O)=O,,,4,1,1,11,12
12782_0,,,,2,2,1,3
C(CC(CO)CC(C=O)O)(O)=O,,,4,1,3,13,16
12784_0,,,,2,2,1,3
C(CC([C](C(O)=O)O)CO)(O)=O,,,4,1,1,8,9
12786_0,,,,2,2,1,3
C(C(CO)(C(CO)CC(O)=O)O)=O,,,4,1,4,13,17
12788_0,,,,2,2,1,3
C(CC(CO)C(C(C=O)O)O)(O)=O,,,4,1,4,17,21
12790_0,,,,2,2,1,3
C(CC(CO)CO)(O)=O,,,4,1,1,6,7
12792_0,,,,2,2,1,3
C(CC(CO)C(CO)O)(O)=O,,,4,1,4,9,13
12794_0,,,,2,2,1,3
C(CC(CO)C(C(O)=O)O)(O)=O,,,4,1,3,10,13
12796_0,,,,2,2,1,3
C(CC(CO)C(C(CO)=O)O)(O)=O,,,4,1,3,11,14
12798_0,,,,2,2,1,3
C(CC(CO)C(CO)(CO)O)(O)=O,,,4,1,3,8,11
12800_0,,,,2,2,1,3
C(CC(CO)C(C(CO)O)O)(O)=O,,,4,1,6,12,18
12802_0,,,,2,2,1,3
C(CC(CO)CC(C=O)=O)(O)=O,,,4,1,5,16,21
12804_0,,,,2,2,1,3
C(C(C=O)C(CO)CC(O)=O)=O,,,4,1,3,11,14
12806_0,,,,2,2,1,3
C(CC(CO)CC=O)(O)=O,,,4,1,10,15,25
12808_0,,,,2,2,1,3
C(C(C)(C(CO)CC(O)=O)O)(O)=O,,,4,1,2,10,12
12810_0,,,,2,2,1,3
C(CC(CO)CC(C(O)=O)O)(O)=O,,,4,1,7,10,17
12812_0,,,,2,2,1,3
C(CC(CO)C(C(C=O)=O)O)(O)=O,,,4,1,2,14,16
12814_0,,,,2,2,1,3
C(CC(CO)C(C=O)O)(O)=O,,,4,1,3,14,17
12816_0,,,,2,3,5,8
C(CO)(C(C(C(O)=O)=O)O)=O,,,4,1,11,13,24
12818_0,,,,2,3,5,8
C(C(CO)O)(C(C(C(O)=O)=O)O)=O,,,4,1,6,15,21
12819_0,,,,2,3,5,8
12821_0,,,,2,3,5,8
C(C(C=O)C(C(O)=O)=O)=O,,,4,1,6,13,19
12822_0,,,,2,3,5,8
12823_0,,,,2,3,5,8
12825_0,,,,2,3,5,8
C(C(C(CO)=O)C(C(O)=O)=O)=O,,,4,1,7,14,21
12827_0,,,,2,3,5,8
C(CC(C(C(C(O)=O)=O)O)=O)=O,,,4,1,4,12,16
12829_0,,,,2,3,5,8
C(C(C(CC(C(O)=O)=O)=O)O)=O,,,4,1,5,14,19
12830_0,,,,2,3,5,8
12832_0,,,,2,3,5,8
C(C(C(C(C=O)=O)O)=O)(O)=O,,,4,1,7,15,22
12833_0,,,,2,3,5,8
12834_0,,,,2,3,5,8
12835_0,,,,2,3,5,8
12836_0,,,,2,3,5,8
12837_0,,,,2,3,5,8
12838_0,,,,2,3,5,8
12840_0,,,,2,3,5,8
C(CO)(C(C(C(O)=O)=O)(CO)O)=O,,,4,1,7,12,19
12841_0,,,,2,3,5,8
12843_0,,,,2,3,5,8
C(C(C(C)=O)(C(C(O)=O)=O)O)=O,,,4,1,3,8,11
12845_0,,,,2,3,5,8
C(C(C(C(C=O)=O)(CO)O)=O)(O)=O,,,4,1,5,14,19
12846_0,,,,2,3,5,8
12847_0,,,,2,3,5,8
12848_0,,,,2,3,5,8
12850_0,,,,2,3,5,8
C(C(C(C(O)=O)=O)(CC=O)O)=O,,,4,1,3,12,15
12852_0,,,,2,3,5,8
C(C(C(C(O)=O)=O)(C)O)(O)=O,,,4,1,4,7,11
12854_0,,,,2,3,5,8
C(C(C(C(O)=O)=O)(CCO)O)(O)=O,,,4,1,4,11,15
12855_0,,,,2,3,5,8
12857_0,,,,2,3,5,8
C(C(C(C(O)=O)=O)(C)O)=O,,,4,1,3,9,12
12858_0,,,,2,3,5,8
12859_0,,,,2,3,5,8
12861_0,,,,2,3,5,8
C(C(C(C(O)=O)=O)(CCO)O)=O,,,4,1,3,11,14
12862_0,,,,2,3,5,8
12864_0,,,,2,3,5,8
C(C(CC(C(C(O)=O)=O)O)O)=O,,,4,1,4,15,19
12865_0,,,,2,3,5,8
12867_0,,,,2,3,5,8
C(CC(C(C(O)=O)=O)(CO)O)=O,,,4,1,7,14,21
12868_0,,,,2,3,5,8
12870_0,,,,2,3,5,8
C(C(C(C(C(O)=O)=O)(C)O)O)=O,,,4,1,5,16,21
12871_0,,,,2,3,5,8
12872_0,,,,2,3,5,8
12873_0,,,,2,3,5,8
12874_0,,,,2,3,5,8
12875_0,,,,2,3,5,8
12876_0,,,,2,3,5,8
12877_0,,,,2,3,5,8
12878_0,,,,2,5,3,8
12879_0,,,,2,5,3,8
12880_0,,,,2,5,3,8
12881_0,,,,2,5,3,8
12882_0,,,,2,5,3,8
12883_0,,,,2,5,3,8
12884_0,,,,2,5,3,8
12885_0,,,,2,5,3,8
12886_0,,,,2,5,3,8
12887_0,,,,2,5,3,8
12888_0,,,,2,5,3,8
12889_0,,,,2,2,2,4
12890_0,,,,2,2,2,4
12891_0,,,,2,2,2,4
12892_0,,,,2,2,2,4
12893_0,,,,2,2,2,4
12894_0,,,,2,2,2,4
12895_0,,,,2,2,2,4
12896_0,,,,2,2,2,4
12897_0,,,,2,2,2,4
12898_0,,,,2,2,2,4
12899_0,,,,2,2,2,4
12901_0,,,,2,2,2,4
C(C(CCC(C=O)O)O)(O)=O,,,4,1,6,15,21
12902_0,,,,2,2,2,4
12903_0,,,,2,2,2,4
12904_0,,,,2,2,2,4
12906_0,,,,2,2,2,4
C(C(CC)O)(O)=O,,,4,1,4,70,74
12907_0,,,,2,2,2,4
12908_0,,,,2,3,5,8
12909_0,,,,2,3,5,8
12910_0,,,,2,3,5,8
12911_0,,,,2,3,5,8
12912_0,,,,2,3,5,8
12913_0,,,,2,3,5,8
12914_0,,,,2,3,5,8
12915_0,,,,2,3,5,8
12916_0,,,,2,3,5,8
12917_0,,,,2,3,5,8
12918_0,,,,2,3,5,8
12919_0,,,,2,3,5,8
12920_0,,,,2,3,5,8
12921_0,,,,2,3,5,8
12922_0,,,,2,3,5,8
12923_0,,,,2,3,5,8
12924_0,,,,2,3,5,8
12925_0,,,,2,3,5,8
12926_0,,,,2,3,5,8
12927_0,,,,2,3,5,8
12928_0,,,,2,3,5,8
12929_0,,,,2,3,5,8
12930_0,,,,2,3,5,8
12931_0,,,,2,3,5,8
12932_0,,,,2,3,5,8
12933_0,,,,2,3,5,8
12934_0,,,,2,3,5,8
12935_0,,,,2,3,5,8
12936_0,,,,2,3,5,8
12937_0,,,,2,3,5,8
12938_0,,,,2,3,5,8
12939_0,,,,2,3,5,8
12940_0,,,,2,3,5,8
12941_0,,,,2,3,5,8
12942_0,,,,2,3,5,8
12943_0,,,,2,3,5,8
12944_0,,,,2,3,5,8
12945_0,,,,2,3,5,8
12946_0,,,,2,3,5,8
12947_0,,,,2,3,5,8
12948_0,,,,2,3,5,8
12949_0,,,,2,3,5,8
12950_0,,,,2,3,5,8
12951_0,,,,2,3,5,8
12952_0,,,,2,3,5,8
12953_0,,,,2,3,5,8
12954_0,,,,2,3,5,8
12955_0,,,,2,3,5,8
12956_0,,,,2,3,5,8
12957_0,,,,2,3,5,8
12958_0,,,,2,3,5,8
12959_0,,,,2,3,5,8
12960_0,,,,2,3,5,8
12961_0,,,,2,3,5,8
12962_0,,,,2,3,5,8
12963_0,,,,2,3,5,8
12964_0,,,,2,3,5,8
12965_0,,,,2,3,5,8
12966_0,,,,2,3,5,8
12967_0,,,,2,3,5,8
12968_0,,,,2,3,5,8
12969_0,,,,2,3,5,8
12970_0,,,,2,3,5,8
12971_0,,,,2,3,5,8
12972_0,,,,2,3,5,8
12973_0,,,,2,3,5,8
12974_0,,,,2,3,5,8
12975_0,,,,2,3,5,8
12976_0,,,,2,3,5,8
12977_0,,,,2,3,5,8
12978_0,,,,2,3,5,8
12979_0,,,,2,3,5,8
12980_0,,,,2,3,5,8
12981_0,,,,2,3,5,8
12982_0,,,,2,3,5,8
12983_0,,,,2,3,5,8
12984_0,,,,2,3,5,8
12985_0,,,,2,3,5,8
12986_0,,,,2,3,5,8
12987_0,,,,2,3,5,8
12988_0,,,,2,3,5,8
12989_0,,,,2,5,3,8
12991_0,,,,2,5,3,8
C(C(CC(CO)(CO)O)O)=O,,,4,1,4,11,15
12992_0,,,,2,5,3,8
12993_0,,,,2,5,3,8
12995_0,,,,2,5,3,8
C(C(CC(CO)(C(CO)O)O)O)=O,,,4,1,6,13,19
12996_0,,,,2,5,3,8
12997_0,,,,2,5,3,8
12998_0,,,,2,5,3,8
12999_0,,,,2,5,3,8
13001_0,,,,2,5,3,8
C(C(C)(CC(C=O)O)O)=O,,,4,1,2,17,19
13002_0,,,,2,5,3,8
13003_0,,,,2,5,3,8
13005_0,,,,2,5,3,8
C(C(CC(C(C)=O)O)O)=O,,,4,1,5,23,28
13006_0,,,,2,5,3,8
13007_0,,,,2,5,3,8
13008_0,,,,2,5,3,8
13010_0,,,,2,5,3,8
C(C(CC(C=O)O)(CCO)O)=O,,,4,1,3,15,18
13012_0,,,,2,5,3,8
C(C(CC(C=O)O)O)(CCO)=O,,,4,1,4,15,19
13014_0,,,,2,5,3,8
C(CC(C(CC(C=O)O)O)O)=O,,,4,1,4,21,25
13016_0,,,,2,5,3,8
C(C(CC(CC(C=O)O)O)O)=O,,,4,1,2,10,12
13017_0,,,,2,5,3,8
13018_0,,,,2,5,3,8
13019_0,,,,2,5,3,8
13021_0,,,,2,5,3,8
C(C(CC(C)(C(C=O)O)O)O)=O,,,4,1,2,22,24
13023_0,,,,2,5,3,8
C(C(CC(C)O)O)=O,,,4,1,16,53,69
13024_0,,,,2,5,3,8
13025_0,,,,2,5,3,8
13027_0,,,,2,5,3,8
C(C(CC(C=O)O)(C(CO)O)O)=O,,,4,1,6,16,22
13028_0,,,,2,5,3,8
13029_0,,,,2,5,3,8
13031_0,,,,2,5,3,8
C(C(CC(C(C(CO)O)O)O)O)=O,,,4,1,8,14,22
13032_0,,,,2,5,3,8
13034_0,,,,2,5,3,8
C(C(CC(CO)O)O)=O,,,4,1,8,24,32
13035_0,,,,2,5,3,8
13036_0,,,,2,5,3,8
13037_0,,,,2,5,3,8
13038_0,,,,2,5,3,8
13039_0,,,,2,5,3,8
13040_0,,,,2,5,3,8
13041_0,,,,2,5,3,8
13042_0,,,,2,5,3,8
13043_0,,,,2,5,3,8
13044_0,,,,2,5,3,8
13045_0,,,,2,5,3,8
13046_0,,,,2,5,3,8
13047_0,,,,2,5,3,8
13048_0,,,,2,5,3,8
13049_0,,,,2,5,3,8
13050_0,,,,2,5,3,8
13051_0,,,,2,5,3,8
13052_0,,,,2,5,3,8
13053_0,,,,2,5,3,8
13054_0,,,,2,5,3,8
13055_0,,,,2,5,3,8
13056_0,,,,2,5,3,8
13057_0,,,,2,5,3,8
13058_0,,,,2,5,3,8
13059_0,,,,2,5,3,8
13060_0,,,,2,5,3,8
13061_0,,,,2,5,3,8
13062_0,,,,2,5,3,8
13063_0,,,,2,5,3,8
13064_0,,,,2,5,3,8
13065_0,,,,2,5,3,8
13066_0,,,,2,5,3,8
13067_0,,,,2,5,3,8
13068_0,,,,2,5,3,8
13069_0,,,,2,5,3,8
13070_0,,,,2,5,3,8
13071_0,,,,2,5,3,8
13072_0,,,,2,5,3,8
13073_0,,,,2,5,3,8
13074_0,,,,2,5,3,8
13075_0,,,,2,5,3,8
13076_0,,,,2,4,4,8
13077_0,,,,2,4,4,8
13078_0,,,,2,4,4,8
13079_0,,,,2,4,4,8
13080_0,,,,2,4,4,8
13081_0,,,,2,4,4,8
13082_0,,,,2,4,4,8
13083_0,,,,2,4,4,8
13084_0,,,,2,4,4,8
13085_0,,,,2,4,4,8
13086_0,,,,2,4,4,8
13087_0,,,,2,4,4,8
13088_0,,,,2,4,4,8
13089_0,,,,2,4,4,8
13090_0,,,,2,4,4,8
13091_0,,,,2,4,4,8
13092_0,,,,2,4,4,8
13093_0,,,,2,4,4,8
13094_0,,,,2,4,4,8
13095_0,,,,2,4,4,8
13096_0,,,,2,4,4,8
13097_0,,,,2,4,4,8
13098_0,,,,2,4,4,8
13099_0,,,,2,4,4,8
13100_0,,,,2,4,4,8
13101_0,,,,2,4,4,8
13102_0,,,,2,4,4,8
13103_0,,,,2,4,4,8
13104_0,,,,2,4,4,8
13105_0,,,,2,4,4,8
13106_0,,,,2,4,4,8
13107_0,,,,2,4,4,8
13108_0,,,,2,4,4,8
13109_0,,,,2,4,4,8
13110_0,,,,2,4,4,8
13111_0,,,,2,4,4,8
13112_0,,,,2,4,4,8
13113_0,,,,2,4,4,8
13114_0,,,,2,4,4,8
13115_0,,,,2,4,4,8
13116_0,,,,2,4,4,8
13117_0,,,,2,4,4,8
13118_0,,,,2,4,4,8
13119_0,,,,2,4,4,8
13120_0,,,,2,4,4,8
13121_0,,,,2,4,4,8
13122_0,,,,2,4,4,8
13123_0,,,,2,4,4,8
13124_0,,,,2,4,4,8
13125_0,,,,2,4,4,8
13126_0,,,,2,4,4,8
13127_0,,,,2,4,4,8
13128_0,,,,2,4,4,8
13129_0,,,,2,4,4,8
13130_0,,,,2,4,4,8
13131_0,,,,2,4,4,8
13132_0,,,,2,4,4,8
13133_0,,,,2,4,4,8
13134_0,,,,2,4,4,8
13135_0,,,,2,4,4,8
13136_0,,,,2,4,4,8
13137_0,,,,2,4,4,8
13138_0,,,,2,4,4,8
13139_0,,,,2,4,4,8
13140_0,,,,2,4,4,8
13141_0,,,,2,4,4,8
13142_0,,,,2,4,4,8
13143_0,,,,2,4,4,8
13144_0,,,,2,4,4,8
13145_0,,,,2,4,4,8
13146_0,,,,2,4,4,8
13148_0,,,,2,4,3,7
[C](C(O)=O)(O)O,,,4,1,1,0,1
13150_0,,,,2,4,3,7
C([C](C)O)(O)=O,,,4,1,1,23,24
13152_0,,,,2,4,3,7
[C](C(O)=O)(CCO)O,,,4,1,2,9,11
13153_0,,,,2,4,3,7
13154_0,,,,2,4,3,7
13156_0,,,,2,4,3,7
[C](C(O)=O)(CC(CO)O)O,,,4,1,1,6,7
13158_0,,,,2,4,3,7
[C](C(O)=O)(CC(C(CO)O)O)O,,,4,1,1,9,10
13160_0,,,,2,4,3,7
C(C[C](C(O)=O)O)=O,,,4,1,2,57,59
13161_0,,,,2,4,3,7
13162_0,,,,2,4,3,7
13163_0,,,,2,4,3,7
13165_0,,,,2,1,1,2
C1(C(C2C(C1C(C2O)O)O)O)=O,,,5,1,4,0,4
13165_1,,,,2,1,1,2
13166_0,,,,2,1,1,2
13166_1,,,,2,1,1,2
13168_0,,,,2,1,1,2
C1(C(C2(C(C1C(C2)O)O)O)O)=O,,,5,1,6,0,6
13168_1,,,,2,1,1,2
13169_0,,,,2,1,1,2
13169_1,,,,2,1,1,2
13171_0,,,,2,1,1,2
C1(C(C2(C(C1C(C2O)O)O)O)O)=O,,,5,1,6,0,6
13171_1,,,,2,1,1,2
13172_0,,,,2,1,1,2
13172_1,,,,2,1,1,2
13173_0,,,,2,1,1,2
13173_1,,,,2,1,1,2
13175_0,,,,2,1,1,2
C1(CC2(C(C1(C(C2)O)O)O)O)=O,,,5,1,5,0,5
13177_0,,,,2,1,1,2
C1(CC2(C(C1(C(C2O)O)O)O)O)=O,,,5,1,3,0,3
13178_0,,,,2,1,1,2
13178_1,,,,2,1,1,2
13180_0,,,,2,1,1,2
C1(C(C(C(CO)C(C1O)O)O)O)=O,,,5,1,2,0,2
13180_1,,,,2,1,1,2
13181_0,,,,2,1,1,2
13181_1,,,,2,1,1,2
13183_0,,,,2,1,1,2
C1(C(C(CC1O)O)C(C(O)=O)O)=O,,,5,1,4,0,4
13183_1,,,,2,1,1,2
13185_0,,,,2,1,1,2
C1(C(C(C(C1)O)C(C(O)=O)O)O)=O,,,5,1,3,0,3
13187_0,,,,2,1,1,2
C(C1C(C(C)(CC1(C=O)O)O)O)=O,,,5,1,4,0,4
13187_1,,,,2,1,1,2
13189_0,,,,2,1,1,2
C1(C(C(CC1O)O)C(C=O)(C)O)=O,,,5,1,4,0,4
13189_1,,,,2,1,1,2
13191_0,,,,2,1,1,2
C(C1C(C(C)(CC(C1O)=O)O)O)=O,,,5,1,5,0,5
13191_1,,,,2,1,1,2
13193_0,,,,2,1,1,2
C(C(C1C(CC(C1(C)O)O)O)=O)=O,,,5,1,4,0,4
13193_1,,,,2,1,1,2
13194_0,,,,2,1,1,2
13194_1,,,,2,1,1,2
13195_0,,,,2,1,1,2
13195_1,,,,2,1,1,2
13197_0,,,,2,1,1,2
C(C1C(C(C=O)C(C)(C1O)O)O)=O,,,5,1,8,0,8
13197_1,,,,2,1,1,2
13198_0,,,,2,1,1,2
13198_1,,,,2,1,1,2
13200_0,,,,2,1,1,2
C1(C(C(CC(C(C1)O)(C)O)O)O)=O,,,5,1,3,0,3
13202_0,,,,2,1,1,2
C1(C(C(C(C)(CC(C1)O)O)O)O)=O,,,5,1,3,0,3
13202_1,,,,2,1,1,2
13204_0,,,,2,1,1,2
C(CO)(C1C(C(C)(CC1O)O)O)=O,,,5,1,4,0,4
13204_1,,,,2,1,1,2
13206_0,,,,2,1,1,2
C(C(C1C(C(C)(CC1O)O)O)=O)=O,,,5,1,4,0,4
13206_1,,,,2,1,1,2
13208_0,,,,2,1,1,2
C(C1C(C(C)(CC1O)O)O)=O,,,5,1,4,0,4
13208_1,,,,2,1,1,2
13210_0,,,,2,1,1,2
C(C1C(C(CO)C(C1(C)O)O)O)=O,,,5,1,2,0,2
13210_1,,,,2,1,1,2
13212_0,,,,2,1,1,2
C(C1C(C)(C(C(C1(C)O)O)O)O)=O,,,5,1,2,0,2
13212_1,,,,2,1,1,2
13213_0,,,,2,1,1,2
13215_0,,,,2,1,1,2
C(C1C(CO)(CC(C1(C)O)O)O)=O,,,5,1,2,0,2
13215_1,,,,2,1,1,2
13216_0,,,,2,1,1,2
13216_1,,,,2,1,1,2
13217_0,,,,2,1,1,2
13217_1,,,,2,1,1,2
13219_0,,,,2,1,1,2
C(C1C(C)(C(CC1(C=O)O)O)O)=O,,,5,1,4,0,4
13219_1,,,,2,1,1,2
13221_0,,,,2,1,1,2
C(C1C(C(CC(C1O)=O)O)(C)O)=O,,,5,1,5,0,5
13221_1,,,,2,1,1,2
13222_0,,,,2,1,1,2
13222_1,,,,2,1,1,2
13223_0,,,,2,1,1,2
13223_1,,,,2,1,1,2
13225_0,,,,2,1,1,2
C(C1C(CC(C1(C)O)O)O)=O,,,5,1,4,0,4
13225_1,,,,2,1,1,2
13226_0,,,,2,1,1,2
13226_1,,,,2,1,1,2
13228_0,,,,2,1,1,2
C(C1C(C(C(C1(C)O)O)O)O)=O,,,5,1,4,0,4
13228_1,,,,2,1,1,2
13230_0,,,,2,1,1,2
C(C(C)(C1C(CC(C1O)=O)O)O)=O,,,5,1,1,0,1
13231_0,,,,2,1,1,2
13233_0,,,,2,1,1,2
C(C1C(C(C)(C(C1O)O)O)O)=O,,,5,1,4,0,4
13233_1,,,,2,1,1,2
13234_0,,,,2,1,1,2
13234_1,,,,2,1,1,2
13236_0,,,,2,1,1,2
C(C1(CC(C(CC(C1)O)=O)O)O)=O,,,5,1,1,0,1
13238_0,,,,2,1,1,2
C(CC1(C(CC(C(C1)O)=O)O)O)=O,,,5,1,2,0,2
13239_0,,,,2,1,1,2
13239_1,,,,2,1,1,2
13241_0,,,,2,1,1,2
C1(C(C(CC1O)O)C(C(C)=O)O)=O,,,5,1,4,0,4
13241_1,,,,2,1,1,2
13243_0,,,,2,1,1,2
C1(CC(C(CC(CC1O)O)=O)O)=O,,,5,1,2,0,2
13245_0,,,,2,1,1,2
C(CC(C1(CC(C(C1)=O)O)O)O)=O,,,5,1,2,0,2
13246_0,,,,2,1,1,2
13246_1,,,,2,1,1,2
13248_0,,,,2,1,1,2
C(C1C(C(CC1(C=O)O)=O)O)(O)=O,,,5,1,2,0,2
13250_0,,,,2,1,1,2
C(C1C(C(CC(C1O)=O)O)=O)(O)=O,,,5,1,5,0,5
13252_0,,,,2,1,1,2
C(C1(C(C(C)O)C(C(C1)=O)O)O)=O,,,5,1,1,0,1
13254_0,,,,2,1,1,2
C1(C(C(C(C(C1)O)=O)C(C)O)O)=O,,,5,1,5,0,5
13256_0,,,,2,1,1,2
C1(C(CC(C=O)(C1C(O)=O)O)O)=O,,,5,1,4,0,4
13256_1,,,,2,1,1,2
13257_0,,,,2,1,1,2
13257_1,,,,2,1,1,2
13259_0,,,,2,1,1,2
C1(C(C(C)O)C(C=O)(CC1O)O)=O,,,5,1,4,0,4
13259_1,,,,2,1,1,2
13260_0,,,,2,1,1,2
13260_1,,,,2,1,1,2
13262_0,,,,2,1,1,2
C(C1C(CC(CC(C1O)=O)O)O)=O,,,5,1,5,0,5
13264_0,,,,2,1,1,2
C(CC(C1C(CC(C1O)=O)O)O)=O,,,5,1,2,0,2
13265_0,,,,2,1,1,2
13265_1,,,,2,1,1,2
13267_0,,,,2,1,1,2
C(C1C(C(C(O)=O)C(C1O)=O)O)=O,,,5,1,6,0,6
13267_1,,,,2,1,1,2
13269_0,,,,2,1,1,2
C(C1C(C(C(C1O)=O)C(C)O)O)=O,,,5,1,6,0,6
13269_1,,,,2,1,1,2
13271_0,,,,2,1,1,2
C1(C(CC(C(C(C1)O)CO)O)O)=O,,,5,1,1,0,1
13273_0,,,,2,1,1,2
C1(C(CC(C(C(C)(C1)O)O)O)O)=O,,,5,1,1,0,1
13275_0,,,,2,1,1,2
C1(C(C(CC(C(C)(C1)O)O)O)O)=O,,,5,1,3,0,3
13277_0,,,,2,1,1,2
C1(C(CC(CC(CO)(C1)O)O)O)=O,,,5,1,1,0,1
13279_0,,,,2,1,1,2
C1(C(C(C)(C(CC(C1)O)O)O)O)=O,,,5,1,3,0,3
13279_1,,,,2,1,1,2
13281_0,,,,2,1,1,2
C(CO)(C1C(CC(C1(C)O)O)O)=O,,,5,1,4,0,4
13281_1,,,,2,1,1,2
13283_0,,,,2,1,1,2
C(C1(CC(CC(C(C1)=O)O)O)O)=O,,,5,1,1,0,1
13284_0,,,,2,1,1,2
13285_0,,,,2,1,1,2
13285_1,,,,2,1,1,2
13287_0,,,,2,1,1,2
C(C1C(CC(C(CC1O)O)=O)O)=O,,,5,1,3,0,3
13289_0,,,,2,1,1,2
C1(C(CC(CC(C1)O)O)O)=O,,,5,1,1,0,1
13290_0,,,,2,1,1,2
13290_1,,,,2,1,1,2
13292_0,,,,2,1,1,2
C1(C(CC(C(C(C1)O)O)O)O)=O,,,5,1,1,0,1
13294_0,,,,2,1,1,2
C(C1C(C(C)(C(CO)C1O)O)O)=O,,,5,1,2,0,2
13294_1,,,,2,1,1,2
13296_0,,,,2,1,1,2
C(C1C(C(C)(C(C1(C)O)O)O)O)=O,,,5,1,4,0,4
13296_1,,,,2,1,1,2
13297_0,,,,2,1,1,2
13299_0,,,,2,1,1,2
C(C1C(C(C)(CC1(CO)O)O)O)=O,,,5,1,2,0,2
13299_1,,,,2,1,1,2
13300_0,,,,2,1,1,2
13300_1,,,,2,1,1,2
13301_0,,,,2,1,1,2
13301_1,,,,2,1,1,2
13303_0,,,,2,1,1,2
C1(C(C(C(C1)O)C(CCO)O)O)=O,,,5,1,1,0,1
13305_0,,,,2,1,1,2
C1(C(C(C(C1)O)C(CO)(C)O)O)=O,,,5,1,1,0,1
13307_0,,,,2,1,1,2
C(C1C(CC(C1O)=O)O)(O)=O,,,5,1,3,0,3
13309_0,,,,2,1,1,2
C1(C(C(C(C1)O)C(C(O)O)O)O)=O,,,5,1,1,0,1
13311_0,,,,2,1,1,2
C1(C(C(C(C1)O)C(C(C)O)O)O)=O,,,5,1,1,0,1
13312_0,,,,2,1,1,2
13314_0,,,,2,1,1,2
C1(C(C(C(C1)O)C(C(C)=O)O)O)=O,,,5,1,1,0,1
13316_0,,,,2,1,1,2
C1(C(C(C(C1)O)C(C)O)O)=O,,,5,1,1,0,1
13318_0,,,,2,1,1,2
C1(C(C(C(C1)O)CO)O)=O,,,5,1,3,0,3
13320_0,,,,2,1,1,2
C1(C(C(C(C1)O)C(CO)O)O)=O,,,5,1,2,0,2
13322_0,,,,2,1,1,2
C1(C(CC(C1C(CCO)O)O)O)=O,,,5,1,4,0,4
13322_1,,,,2,1,1,2
13324_0,,,,2,1,1,2
C1(C(CC(C1C(CO)(C)O)O)O)=O,,,5,1,4,0,4
13324_1,,,,2,1,1,2
13326_0,,,,2,1,1,2
C(C1C(C(CC1O)O)=O)(O)=O,,,5,1,5,0,5
13326_1,,,,2,1,1,2
13328_0,,,,2,1,1,2
C1(C(CC(C1C(C(O)O)O)O)O)=O,,,5,1,4,0,4
13328_1,,,,2,1,1,2
13330_0,,,,2,1,1,2
C1(C(CC(C1C(C(C)O)O)O)O)=O,,,5,1,4,0,4
13330_1,,,,2,1,1,2
13331_0,,,,2,1,1,2
13331_1,,,,2,1,1,2
13333_0,,,,2,1,1,2
C1(C(C(CC1O)O)C(C=O)O)=O,,,5,1,5,0,5
13333_1,,,,2,1,1,2
13334_0,,,,2,1,1,2
13334_1,,,,2,1,1,2
13335_0,,,,2,1,1,2
13335_1,,,,2,1,1,2
13337_0,,,,2,1,1,2
C(CC(C1C(C(CC1O)O)=O)O)=O,,,5,1,4,0,4
13337_1,,,,2,1,1,2
13339_0,,,,2,1,1,2
C1(C(CC(C1C(C)O)O)O)=O,,,5,1,4,0,4
13339_1,,,,2,1,1,2
13341_0,,,,2,1,1,2
C1(C(CC(C1C(CO)O)O)O)=O,,,5,1,4,0,4
13341_1,,,,2,1,1,2
13343_0,,,,2,1,1,2
C1(C(C(C(CC(C1)O)O)O)O)=O,,,5,1,3,0,3
13344_0,,,,2,1,1,2
13344_1,,,,2,1,1,2
13346_0,,,,2,1,1,2
C1(C(C(C(C(C(C1)O)O)O)O)O)=O,,,5,1,5,0,5
13348_0,,,,2,1,1,2
C(C1C(C(C(C1O)O)O)=O)(O)=O,,,5,1,8,0,8
13348_1,,,,2,1,1,2
13350_0,,,,2,1,1,2
C1(C(C(C(C1O)O)O)C(C=O)O)=O,,,5,1,7,0,7
13350_1,,,,2,1,1,2
13352_0,,,,2,1,1,2
C1(C(C(C(C1C(C)O)O)O)O)=O,,,5,1,6,0,6
13352_1,,,,2,1,1,2
13354_0,,,,2,1,1,2
C1(C(C(C(C1C(CO)O)O)O)O)=O,,,5,1,6,0,6
13354_1,,,,2,1,1,2
13356_0,,,,2,1,1,2
C(C(C1C(CC(CC1O)O)O)=O)=O,,,5,1,2,0,2
13356_1,,,,2,1,1,2
13358_0,,,,2,1,1,2
C(C1C(CC(CC1(C=O)O)O)O)=O,,,5,1,4,0,4
13358_1,,,,2,1,1,2
13359_0,,,,2,1,1,2
13359_1,,,,2,1,1,2
13361_0,,,,2,1,1,2
C(C1C(CC(C=O)(CC1O)O)O)=O,,,5,1,2,0,2
13361_1,,,,2,1,1,2
13362_0,,,,2,1,1,2
13362_1,,,,2,1,1,2
13364_0,,,,2,1,1,2
C(C1C(C(CC1O)(CC=O)O)O)=O,,,5,1,3,0,3
13364_1,,,,2,1,1,2
13365_0,,,,2,1,1,2
13365_1,,,,2,1,1,2
13366_0,,,,2,1,1,2
13366_1,,,,2,1,1,2
13368_0,,,,2,1,1,2
C1(C(C(C(C1)O)(CC(C)O)O)O)=O,,,5,1,3,0,3
13370_0,,,,2,1,1,2
C1(C(C(C(CC(C)O)(C1)O)O)O)=O,,,5,1,3,0,3
13370_1,,,,2,1,1,2
13372_0,,,,2,1,1,2
C1(C(C(CO)C(C1C(C)O)O)O)=O,,,5,1,2,0,2
13372_1,,,,2,1,1,2
13374_0,,,,2,1,1,2
C1(C(C(C(C)(C1C(C)O)O)O)O)=O,,,5,1,2,0,2
13374_1,,,,2,1,1,2
13375_0,,,,2,1,1,2
13377_0,,,,2,1,1,2
C1(C(CC(CO)(C1C(C)O)O)O)=O,,,5,1,2,0,2
13377_1,,,,2,1,1,2
13378_0,,,,2,1,1,2
13378_1,,,,2,1,1,2
13379_0,,,,2,1,1,2
13379_1,,,,2,1,1,2
13381_0,,,,2,1,1,2
C(C1C(C(C=O)C(CC1O)O)O)=O,,,5,1,4,0,4
13381_1,,,,2,1,1,2
13382_0,,,,2,1,1,2
13382_1,,,,2,1,1,2
13384_0,,,,2,1,1,2
C(C1C(C(CO)C(CC1O)O)O)=O,,,5,1,2,0,2
13384_1,,,,2,1,1,2
13386_0,,,,2,1,1,2
C(C1C(CC(C(C1(C)O)O)O)O)=O,,,5,1,4,0,4
13386_1,,,,2,1,1,2
13388_0,,,,2,1,1,2
C1(C(C(CC(CC(C1)O)O)O)O)=O,,,5,1,3,0,3
13390_0,,,,2,1,1,2
C(C1C(CC(CC1(CO)O)O)O)=O,,,5,1,4,0,4
13390_1,,,,2,1,1,2
13391_0,,,,2,1,1,2
13391_1,,,,2,1,1,2
13393_0,,,,2,1,1,2
C(CO)(C1C(CC(CC1O)O)O)=O,,,5,1,2,0,2
13393_1,,,,2,1,1,2
13395_0,,,,2,1,1,2
C(C1C(CC(CC1O)O)O)=O,,,5,1,2,0,2
13395_1,,,,2,1,1,2
13397_0,,,,2,1,1,2
C(C1C(C(C(CC1O)O)O)O)=O,,,5,1,4,0,4
13397_1,,,,2,1,1,2
13398_0,,,,2,1,1,2
13398_1,,,,2,1,1,2
13400_0,,,,2,1,1,2
C(C1C(C(C(C(C1O)O)O)O)O)=O,,,5,1,4,0,4
13400_1,,,,2,1,1,2
13402_0,,,,2,1,1,2
C1(C(C(C(C(C1)O)C(C)O)O)O)=O,,,5,1,3,0,3
13403_0,,,,2,1,1,2
13403_1,,,,2,1,1,2
13405_0,,,,2,1,1,2
C1(C(C(C(C(C1)O)CO)O)O)=O,,,5,1,4,0,4
13406_0,,,,2,1,1,2
13406_1,,,,2,1,1,2
13408_0,,,,2,1,1,2
C(C1C(C(CC1O)(CCO)O)O)=O,,,5,1,4,0,4
13408_1,,,,2,1,1,2
13410_0,,,,2,1,1,2
C(C1C(CC(C1(CCO)O)O)O)=O,,,5,1,4,0,4
13410_1,,,,2,1,1,2
13411_0,,,,2,1,1,2
13411_1,,,,2,1,1,2
13413_0,,,,2,1,1,2
C1(C(CC(CC(C1CO)O)O)O)=O,,,5,1,2,0,2
13413_1,,,,2,1,1,2
13414_0,,,,2,1,1,2
13414_1,,,,2,1,1,2
13416_0,,,,2,1,1,2
C(C1C(C(C(C1O)=O)CO)O)(O)=O,,,5,1,4,0,4
13416_1,,,,2,1,1,2
13418_0,,,,2,1,1,2
C1(C(C(C(C1CO)O)C(C)O)O)=O,,,5,1,2,0,2
13418_1,,,,2,1,1,2
13420_0,,,,2,1,1,2
C1(C(C(CO)C(C1CO)O)O)=O,,,5,1,3,0,3
13420_1,,,,2,1,1,2
13422_0,,,,2,1,1,2
C(C1C(C(CC(CC1O)O)O)O)=O,,,5,1,4,0,4
13422_1,,,,2,1,1,2
13424_0,,,,2,1,1,2
C(C1C(CC(C(CC1O)O)O)O)=O,,,5,1,2,0,2
13424_1,,,,2,1,1,2
13426_0,,,,2,1,1,2
C(C1C(C(C=O)C(C1O)O)O)(O)=O,,,5,1,7,0,7
13426_1,,,,2,1,1,2
13428_0,,,,2,1,1,2
C(C1C(C(C(C1O)O)C(C)O)O)=O,,,5,1,4,0,4
13428_1,,,,2,1,1,2
13430_0,,,,2,1,1,2
C(C1C(C(CO)C(C1O)O)O)=O,,,5,1,5,0,5
13430_1,,,,2,1,1,2
13431_0,,,,2,1,1,2
13431_1,,,,2,1,1,2
13432_0,,,,2,1,1,2
13432_1,,,,2,1,1,2
13433_0,,,,2,1,1,2
13433_1,,,,2,1,1,2
13435_0,,,,2,1,1,2
C(C1C(CC(CO)(CC1O)O)O)=O,,,5,1,2,0,2
13435_1,,,,2,1,1,2
13436_0,,,,2,1,1,2
13436_1,,,,2,1,1,2
13438_0,,,,2,1,1,2
C(C1C(CC(C(C1O)O)=O)O)(O)=O,,,5,1,6,0,6
13438_1,,,,2,1,1,2
13440_0,,,,2,1,1,2
C(C1C(C(C(CC1O)O)O)=O)(O)=O,,,5,1,7,0,7
13440_1,,,,2,1,1,2
13442_0,,,,2,1,1,2
C1(C(C(CC(C1C(C)O)O)O)O)=O,,,5,1,6,0,6
13442_1,,,,2,1,1,2
13444_0,,,,2,1,1,2
C1(C(C(CC(C1CO)O)O)O)=O,,,5,1,7,0,7
13444_1,,,,2,1,1,2
13446_0,,,,2,1,1,2
C1(C(C(C(C(C1CO)O)O)O)O)=O,,,5,1,7,0,7
13446_1,,,,2,1,1,2
13448_0,,,,2,1,1,2
C(C1C(C(C(C)(CC1O)O)O)O)=O,,,5,1,4,0,4
13448_1,,,,2,1,1,2
13449_0,,,,2,1,1,2
13449_1,,,,2,1,1,2
13450_0,,,,2,1,1,2
13451_0,,,,2,1,1,2
13451_1,,,,2,1,1,2
13452_0,,,,2,1,1,2
13452_1,,,,2,1,1,2
13453_0,,,,2,1,1,2
13453_1,,,,2,1,1,2
13454_0,,,,2,1,1,2
13454_1,,,,2,1,1,2
13455_0,,,,2,1,1,2
13455_1,,,,2,1,1,2
13457_0,,,,2,1,1,2
C1(CC(C(C(C)O)C1(CO)O)O)=O,,,5,1,1,0,1
13459_0,,,,2,1,1,2
C1(C(C(C(C(C)O)C1(C)O)O)O)=O,,,5,1,2,0,2
13459_1,,,,2,1,1,2
13461_0,,,,2,1,1,2
C(C1C(C(C(C1O)C(C)O)O)=O)=O,,,5,1,2,0,2
13461_1,,,,2,1,1,2
13463_0,,,,2,1,1,2
C(C1(C(CC(C1C(C)O)O)=O)O)=O,,,5,1,1,0,1
13465_0,,,,2,1,1,2
C1(C(C(C(C(C1)O)C(C)O)O)=O)=O,,,5,1,1,0,1
13467_0,,,,2,1,1,2
C1(C(C(C(C1O)O)C(C)O)O)=O,,,5,1,2,0,2
13467_1,,,,2,1,1,2
13469_0,,,,2,1,1,2
C(C1C(CC(C1(CO)O)O)O)=O,,,5,1,5,0,5
13469_1,,,,2,1,1,2
13471_0,,,,2,1,1,2
C(C1C(C(CO)(CC1O)O)O)=O,,,5,1,5,0,5
13471_1,,,,2,1,1,2
13472_0,,,,2,1,1,2
13472_1,,,,2,1,1,2
13474_0,,,,2,1,1,2
C1(C(C(CC(CC1O)O)O)O)=O,,,5,1,2,0,2
13474_1,,,,2,1,1,2
13475_0,,,,2,1,1,2
13475_1,,,,2,1,1,2
13477_0,,,,2,1,1,2
C1(C(C(C(C(CC1O)O)O)O)O)=O,,,5,1,3,0,3
13477_1,,,,2,1,1,2
13478_0,,,,2,1,1,2
13478_1,,,,2,1,1,2
13480_0,,,,2,1,1,2
C(C1C(C(C(C1O)=O)O)O)(O)=O,,,5,1,4,0,4
13480_1,,,,2,1,1,2
13482_0,,,,2,1,1,2
C1(C(C(C(CO)C1O)O)O)=O,,,5,1,4,0,4
13482_1,,,,2,1,1,2
13484_0,,,,2,1,1,2
C1(C(C(C(C1O)O)C(CO)O)O)=O,,,5,1,3,0,3
13484_1,,,,2,1,1,2
13486_0,,,,2,1,1,2
C1(CC(C(CO)C1(CO)O)O)=O,,,5,1,1,0,1
13488_0,,,,2,1,1,2
C1(C(C(C(CO)C1(C)O)O)O)=O,,,5,1,2,0,2
13488_1,,,,2,1,1,2
13490_0,,,,2,1,1,2
C(C1C(C(C(CO)C1O)O)=O)=O,,,5,1,3,0,3
13490_1,,,,2,1,1,2
13492_0,,,,2,1,1,2
C(C1C(C(C(CO)C1O)O)=O)(O)=O,,,5,1,2,0,2
13492_1,,,,2,1,1,2
13494_0,,,,2,1,1,2
C(C1(C(CC(C1CO)O)=O)O)=O,,,5,1,1,0,1
13496_0,,,,2,1,1,2
C1(C(C(C(C(C1)O)CO)O)=O)=O,,,5,1,1,0,1
13497_0,,,,2,1,1,2
13497_1,,,,2,1,1,2
13499_0,,,,2,1,1,2
C1(C(C(C(C=O)=O)C(C1O)O)O)=O,,,5,1,7,0,7
13499_1,,,,2,1,1,2
13500_0,,,,2,1,1,2
13502_0,,,,2,1,1,2
C1(C(C(C(C(C=O)O)(C1)O)O)O)=O,,,5,1,5,0,5
13503_0,,,,2,1,1,2
13503_1,,,,2,1,1,2
13504_0,,,,2,1,1,2
13504_1,,,,2,1,1,2
13505_0,,,,2,1,1,2
13505_1,,,,2,1,1,2
13506_0,,,,2,1,1,2
13506_1,,,,2,1,1,2
13507_0,,,,2,1,1,2
13507_1,,,,2,1,1,2
13508_0,,,,2,1,1,2
13508_1,,,,2,1,1,2
13509_0,,,,2,1,1,2
13509_1,,,,2,1,1,2
13510_0,,,,2,1,1,2
13511_0,,,,2,1,1,2
13511_1,,,,2,1,1,2
13512_0,,,,2,1,1,2
13512_1,,,,2,1,1,2
13513_0,,,,2,1,1,2
13513_1,,,,2,1,1,2
13515_0,,,,2,1,1,2
C(C1C(C(C(C(C1O)O)=O)O)O)=O,,,5,1,5,0,5
13515_1,,,,2,1,1,2
13517_0,,,,2,1,1,2
C1(C(C(C(C(C1O)O)O)O)O)=O,,,5,1,3,0,3
13517_1,,,,2,1,1,2
13518_0,,,,2,1,1,2
13518_1,,,,2,1,1,2
13520_0,,,,2,1,1,2
C1(CC(C)(C(C1(CO)O)O)O)=O,,,5,1,4,0,4
13522_0,,,,2,1,1,2
C1(C(C(CO)(C(C)(C1)O)O)O)=O,,,5,1,4,0,4
13524_0,,,,2,1,1,2
C1(CC(CO)(CC1(CO)O)O)=O,,,5,1,1,0,1
13526_0,,,,2,1,1,2
C1(C(C(C)(C(CO)(C1)O)O)O)=O,,,5,1,3,0,3
13526_1,,,,2,1,1,2
13528_0,,,,2,1,1,2
C(C1(CC(C(C1)=O)(CO)O)O)(O)=O,,,5,1,1,0,1
13530_0,,,,2,1,1,2
C(C1C(CC(C1(CO)O)=O)O)(O)=O,,,5,1,2,0,2
13532_0,,,,2,1,1,2
C1(CC(CO)(C(C1(CO)O)O)O)=O,,,5,1,6,0,6
13534_0,,,,2,1,1,2
C1(C(C(CO)(C(C)(C1O)O)O)O)=O,,,5,1,6,0,6
13534_1,,,,2,1,1,2
13536_0,,,,2,1,1,2
C(C1(CC(C(C1)=O)(CO)O)O)=O,,,5,1,2,0,2
13538_0,,,,2,1,1,2
C1(CC(C(CC1(CO)O)=O)O)=O,,,5,1,4,0,4
13540_0,,,,2,1,1,2
C(C1C(CC(C1(CO)O)=O)O)=O,,,5,1,5,0,5
13542_0,,,,2,1,1,2
C1(CC(CC1(CO)O)O)=O,,,5,1,2,0,2
13544_0,,,,2,1,1,2
C(C1(C(C(C(C1)=O)(CO)O)O)O)=O,,,5,1,4,0,4
13546_0,,,,2,1,1,2
C1(CC(C(C(C1(CO)O)O)=O)O)=O,,,5,1,5,0,5
13547_0,,,,2,1,1,2
13549_0,,,,2,1,1,2
C1(C(C(C)(C(C1(C)O)O)O)O)=O,,,5,1,3,0,3
13549_1,,,,2,1,1,2
13550_0,,,,2,1,1,2
13552_0,,,,2,1,1,2
C1(C(C(CO)(CC1(C)O)O)O)=O,,,5,1,2,0,2
13552_1,,,,2,1,1,2
13553_0,,,,2,1,1,2
13553_1,,,,2,1,1,2
13555_0,,,,2,1,1,2
C(C1(CC(C(C1O)=O)(C)O)O)(O)=O,,,5,1,2,0,2
13555_1,,,,2,1,1,2
13557_0,,,,2,1,1,2
C(C1C(C(C(C1(C)O)=O)O)O)(O)=O,,,5,1,3,0,3
13557_1,,,,2,1,1,2
13559_0,,,,2,1,1,2
C1(C(C(CO)(C(C1(C)O)O)O)O)=O,,,5,1,4,0,4
13559_1,,,,2,1,1,2
13560_0,,,,2,1,1,2
13560_1,,,,2,1,1,2
13562_0,,,,2,1,1,2
C(C1(CC(C(C1O)=O)(C)O)O)=O,,,5,1,2,0,2
13562_1,,,,2,1,1,2
13564_0,,,,2,1,1,2
C1(C(C(C(C(C)(C1)O)=O)O)O)=O,,,5,1,5,0,5
13564_1,,,,2,1,1,2
13566_0,,,,2,1,1,2
C(C1C(C(C(C1(C)O)=O)O)O)=O,,,5,1,4,0,4
13566_1,,,,2,1,1,2
13568_0,,,,2,1,1,2
C1(C(C(CC1(C)O)O)O)=O,,,5,1,2,0,2
13568_1,,,,2,1,1,2
13570_0,,,,2,1,1,2
C(C1(C(C(C(C1O)=O)(C)O)O)O)=O,,,5,1,5,0,5
13570_1,,,,2,1,1,2
13572_0,,,,2,1,1,2
C1(C(C(C(C(C1(C)O)O)=O)O)O)=O,,,5,1,7,0,7
13572_1,,,,2,1,1,2
13574_0,,,,2,1,1,2
C1(C(C(C(C1(C)O)O)O)O)=O,,,5,1,4,0,4
13574_1,,,,2,1,1,2
13576_0,,,,2,1,1,2
C1(C(C(C(C(C(C1)O)O)O)O)=O)=O,,,5,1,3,0,3
13578_0,,,,2,1,1,2
C(C1(C(CC(C(C1O)=O)=O)O)O)=C,,,5,1,3,0,3
13580_0,,,,2,1,1,2
C(C1(C(C(C(C(C1)=O)=O)O)O)O)=C,,,5,1,3,0,3
13582_0,,,,2,1,1,2
C1C(C(C(C(CC(C=1)O)=O)=O)O)O,,,5,1,3,0,3
13584_0,,,,2,1,1,2
C1(C(C(C(C(C1)O)O)O)=O)=O,,,5,1,3,0,3
13586_0,,,,2,1,1,2
C1(C(C(C(C(C1)O)(C)O)O)=O)=O,,,5,1,4,0,4
13588_0,,,,2,1,1,2
C1(C(C(C(C(C)(C1)O)O)O)=O)=O,,,5,1,3,0,3
13589_0,,,,2,1,1,2
13590_0,,,,2,1,1,2
13592_0,,,,2,1,1,2
C1(C(C(C(CC(C1)O)O)O)=O)=O,,,5,1,4,0,4
13593_0,,,,2,1,1,2
13593_1,,,,2,1,1,2
13595_0,,,,2,1,1,2
C1(C(C(C(C(C1)O)(CO)O)O)=O)=O,,,5,1,3,0,3
13597_0,,,,2,1,1,2
C1(C(C(C(C(CO)(C1)O)O)O)=O)=O,,,5,1,3,0,3
13598_0,,,,2,1,1,2
13598_1,,,,2,1,1,2
13599_0,,,,2,1,1,2
13599_1,,,,2,1,1,2
13600_0,,,,2,1,1,2
13600_1,,,,2,1,1,2
13601_0,,,,2,1,1,2
13601_1,,,,2,1,1,2
13602_0,,,,2,1,1,2
13602_1,,,,2,1,1,2
13603_0,,,,2,1,1,2
13603_1,,,,2,1,1,2
13605_0,,,,2,1,1,2
C1C(C(C(C(CO)=O)=O)C(C=1)O)O,,,5,1,2,0,2
13605_1,,,,2,1,1,2
13606_0,,,,2,1,1,2
13606_1,,,,2,1,1,2
13607_0,,,,2,1,1,2
13607_1,,,,2,1,1,2
13608_0,,,,2,1,1,2
13608_1,,,,2,1,1,2
13609_0,,,,2,1,1,2
13611_0,,,,2,1,1,2
C(CO)(C1(CC(C(C1)=O)O)O)=O,,,5,1,2,0,2
13612_0,,,,2,1,1,2
13612_1,,,,2,1,1,2
13613_0,,,,2,1,1,2
13613_1,,,,2,1,1,2
13614_0,,,,2,1,1,2
13614_1,,,,2,1,1,2
13615_0,,,,2,1,1,2
13615_1,,,,2,1,1,2
13616_0,,,,2,1,1,2
13616_1,,,,2,1,1,2
13618_0,,,,2,1,1,2
C(CO)(C1(CC(C(C1O)=O)O)O)=O,,,5,1,5,0,5
13618_1,,,,2,1,1,2
13620_0,,,,2,1,1,2
C1(C(C(C(C1)O)(C(C)O)O)O)=O,,,5,1,3,0,3
13622_0,,,,2,1,1,2
C1(C(C(C(C(C)O)(C1)O)O)O)=O,,,5,1,3,0,3
13622_1,,,,2,1,1,2
13624_0,,,,2,1,1,2
C1(C(C(C(C1O)O)(C(C)O)O)O)=O,,,5,1,4,0,4
13624_1,,,,2,1,1,2
13625_0,,,,2,1,1,2
13626_0,,,,2,1,1,2
13626_1,,,,2,1,1,2
13627_0,,,,2,1,1,2
13627_1,,,,2,1,1,2
13629_0,,,,2,1,1,2
C1(C2C(C(C(C1C(O2)O)O)O)O)=O,,,5,1,4,0,4
13629_1,,,,2,1,1,2
13630_0,,,,2,1,1,2
13630_1,,,,2,1,1,2
13632_0,,,,2,1,1,2
C(C1C(C(C(C(C1O)O)O)O)=O)=O,,,5,1,5,0,5
13632_1,,,,2,1,1,2
13633_0,,,,2,1,1,2
13633_1,,,,2,1,1,2
13635_0,,,,2,1,1,2
C(CC1(C(CC(C1O)=O)O)O)(O)=O,,,5,1,4,0,4
13637_0,,,,2,1,1,2
C(CC1(C(C(C(C1)=O)O)O)O)(O)=O,,,5,1,4,0,4
13639_0,,,,2,1,1,2
C(C1C(C(C(C1(C)O)O)O)=O)(O)=O,,,5,1,5,0,5
13639_1,,,,2,1,1,2
13641_0,,,,2,1,1,2
C(C1(CC(C(C(C1)=O)O)O)O)(O)=O,,,5,1,4,0,4
13643_0,,,,2,1,1,2
C(C1(CC(CC(C1O)=O)O)O)(O)=O,,,5,1,5,0,5
13645_0,,,,2,1,1,2
C(C1(C(C)(C(C(C1)=O)O)O)O)=O,,,5,1,3,0,3
13647_0,,,,2,1,1,2
C1(C(C(C(C(C1)O)=O)(C)O)O)=O,,,5,1,4,0,4
13649_0,,,,2,1,1,2
C1(C(C(C=C)(C(C1)O)O)O)=O,,,5,1,3,0,3
13651_0,,,,2,1,1,2
C1(CC(C=C)(C(C1O)O)O)=O,,,5,1,3,0,3
13653_0,,,,2,1,1,2
C1(CC(C=CC(C1O)O)O)=O,,,5,1,3,0,3
13655_0,,,,2,1,1,2
C1(C(C(C(C1)O)(C)O)O)=O,,,5,1,3,0,3
13657_0,,,,2,1,1,2
C1(C(C(C(C)(C1)O)O)O)=O,,,5,1,3,0,3
13659_0,,,,2,1,1,2
C1(C(C(C(C1)O)(CCO)O)O)=O,,,5,1,4,0,4
13661_0,,,,2,1,1,2
C1(C(C(C(CCO)(C1)O)O)O)=O,,,5,1,4,0,4
13663_0,,,,2,1,1,2
C1(C(C(C(C)(C1CO)O)O)O)=O,,,5,1,5,0,5
13663_1,,,,2,1,1,2
13665_0,,,,2,1,1,2
C1(C(C(CC(C(C1)O)O)O)O)=O,,,5,1,3,0,3
13667_0,,,,2,1,1,2
C1(C(C(CC(CO)(C1)O)O)O)=O,,,5,1,4,0,4
13669_0,,,,2,1,1,2
C1(C(C(C)(C(C(C1)O)O)O)O)=O,,,5,1,3,0,3
13669_1,,,,2,1,1,2
13671_0,,,,2,1,1,2
C1(C(C(CO)(CC(C1)O)O)O)=O,,,5,1,4,0,4
13673_0,,,,2,1,1,2
C1(C(C(C(C(C)(C1)O)O)O)O)=O,,,5,1,3,0,3
13674_0,,,,2,1,1,2
13675_0,,,,2,1,1,2
13675_1,,,,2,1,1,2
13676_0,,,,2,1,1,2
13676_1,,,,2,1,1,2
13677_0,,,,2,1,1,2
13677_1,,,,2,1,1,2
13678_0,,,,2,1,1,2
13678_1,,,,2,1,1,2
13679_0,,,,2,1,1,2
13679_1,,,,2,1,1,2
13681_0,,,,2,1,1,2
C(C1C(C(CC1(CO)O)O)=O)=O,,,5,1,3,0,3
13681_1,,,,2,1,1,2
13682_0,,,,2,1,1,2
13682_1,,,,2,1,1,2
13683_0,,,,2,1,1,2
13683_1,,,,2,1,1,2
13685_0,,,,2,1,1,2
C(C1C(C(CC1(CO)O)O)=O)(O)=O,,,5,1,2,0,2
13685_1,,,,2,1,1,2
13686_0,,,,2,1,1,2
13686_1,,,,2,1,1,2
13687_0,,,,2,1,1,2
13687_1,,,,2,1,1,2
13688_0,,,,2,1,1,2
13688_1,,,,2,1,1,2
13689_0,,,,2,1,1,2
13689_1,,,,2,1,1,2
13691_0,,,,2,1,1,2
C(C1(C(CC(CO)(C1)O)=O)O)=O,,,5,1,1,0,1
13692_0,,,,2,1,1,2
13692_1,,,,2,1,1,2
13693_0,,,,2,1,1,2
13693_1,,,,2,1,1,2
13695_0,,,,2,1,1,2
C1(C(C(CC(CO)(C1)O)O)=O)=O,,,5,1,1,0,1
13696_0,,,,2,1,1,2
13696_1,,,,2,1,1,2
13697_0,,,,2,1,1,2
13697_1,,,,2,1,1,2
13698_0,,,,2,1,1,2
13698_1,,,,2,1,1,2
13699_0,,,,2,1,1,2
13699_1,,,,2,1,1,2
13700_0,,,,2,1,1,2
13700_1,,,,2,1,1,2
13702_0,,,,2,1,1,2
C(CO)(C1C(C=CC1O)O)=O,,,5,1,2,0,2
13702_1,,,,2,1,1,2
13703_0,,,,2,1,1,2
13703_1,,,,2,1,1,2
13705_0,,,,2,1,1,2
C(CO)(C1C(C(C(C1O)O)O)O)=O,,,5,1,4,0,4
13705_1,,,,2,1,1,2
13706_0,,,,2,1,1,2
13706_1,,,,2,1,1,2
13707_0,,,,2,1,1,2
13707_1,,,,2,1,1,2
13709_0,,,,2,1,1,2
C1(C(CC(CO)(C1)O)O)=O,,,5,1,2,0,2
13710_0,,,,2,1,1,2
13710_1,,,,2,1,1,2
13711_0,,,,2,1,1,2
13711_1,,,,2,1,1,2
13713_0,,,,2,1,1,2
C1(C(CC(CO)(C1CO)O)O)=O,,,5,1,3,0,3
13713_1,,,,2,1,1,2
13714_0,,,,2,1,1,2
13714_1,,,,2,1,1,2
13716_0,,,,2,1,1,2
C(CO)(C1C(C(CC1O)O)O)=O,,,5,1,5,0,5
13716_1,,,,2,1,1,2
13718_0,,,,2,1,1,2
C(C1C(C(CC1(CO)O)O)O)=O,,,5,1,5,0,5
13718_1,,,,2,1,1,2
13719_0,,,,2,1,1,2
13719_1,,,,2,1,1,2
13720_0,,,,2,1,1,2
13720_1,,,,2,1,1,2
13721_0,,,,2,1,1,2
13721_1,,,,2,1,1,2
13722_0,,,,2,1,1,2
13722_1,,,,2,1,1,2
13723_0,,,,2,1,1,2
13723_1,,,,2,1,1,2
13724_0,,,,2,1,1,2
13724_1,,,,2,1,1,2
13726_0,,,,2,1,1,2
C1(C(CC(CO)(C1O)O)O)=O,,,5,1,4,0,4
13726_1,,,,2,1,1,2
13727_0,,,,2,1,1,2
13727_1,,,,2,1,1,2
13728_0,,,,2,1,1,2
13728_1,,,,2,1,1,2
13730_0,,,,2,1,1,2
C1(C(C(C=C)(C(C1CO)O)O)O)=O,,,5,1,4,0,4
13730_1,,,,2,1,1,2
13732_0,,,,2,1,1,2
C1(C(CO)C(C=C)(C(C1O)O)O)=O,,,5,1,4,0,4
13732_1,,,,2,1,1,2
13734_0,,,,2,1,1,2
C1(C(C(C=CC(C1CO)O)O)O)=O,,,5,1,4,0,4
13734_1,,,,2,1,1,2
13736_0,,,,2,1,1,2
C1(C(C(C)(C(C1CO)O)O)O)=O,,,5,1,5,0,5
13736_1,,,,2,1,1,2
13737_0,,,,2,1,1,2
13737_1,,,,2,1,1,2
13738_0,,,,2,1,1,2
13738_1,,,,2,1,1,2
13739_0,,,,2,1,1,2
13739_1,,,,2,1,1,2
13740_0,,,,2,1,1,2
13740_1,,,,2,1,1,2
13741_0,,,,2,1,1,2
13741_1,,,,2,1,1,2
13742_0,,,,2,1,1,2
13742_1,,,,2,1,1,2
13744_0,,,,2,1,1,2
C1(C(C(CO)C(CO)(C1)O)O)=O,,,5,1,3,0,3
13745_0,,,,2,1,1,2
13745_1,,,,2,1,1,2
13746_0,,,,2,1,1,2
13746_1,,,,2,1,1,2
13748_0,,,,2,1,1,2
C1(C(C(CO)(C(CO)C1O)O)O)=O,,,5,1,5,0,5
13748_1,,,,2,1,1,2
13750_0,,,,2,1,1,2
C(C1C(C=CC1O)O)(C(CO)O)=O,,,5,1,2,0,2
13750_1,,,,2,1,1,2
13752_0,,,,2,1,1,2
C1(C(CC(C(CO)O)(C1)O)O)=O,,,5,1,2,0,2
13754_0,,,,2,1,1,2
C1(C(C(CC1O)(C(CO)O)O)O)=O,,,5,1,4,0,4
13754_1,,,,2,1,1,2
13756_0,,,,2,1,1,2
C1(C(C(C(C(O)=O)=O)C(C1)O)O)=O,,,5,1,5,0,5
13756_1,,,,2,1,1,2
13758_0,,,,2,1,1,2
C1(C(CC(C(O)=O)(C1C=O)O)O)=O,,,5,1,2,0,2
13758_1,,,,2,1,1,2
13759_0,,,,2,1,1,2
13759_1,,,,2,1,1,2
13761_0,,,,2,1,1,2
C(C1(CC(C=O)(C(C1)=O)O)O)(O)=O,,,5,1,1,0,1
13763_0,,,,2,1,1,2
C(C1(CC(C(C(C1)=O)=O)O)O)(O)=O,,,5,1,1,0,1
13765_0,,,,2,1,1,2
C1C(C(C(C(O)=O)=O)C(C=1)O)O,,,5,1,2,0,2
13765_1,,,,2,1,1,2
13767_0,,,,2,1,1,2
C(C1(CC(C(C1)=O)O)O)(O)=O,,,5,1,2,0,2
13769_0,,,,2,1,1,2
C1(C(CO)C(C(O)=O)(CC1O)O)=O,,,5,1,3,0,3
13769_1,,,,2,1,1,2
13771_0,,,,2,1,1,2
C(C(C1C(C(CC1O)O)O)=O)(O)=O,,,5,1,5,0,5
13771_1,,,,2,1,1,2
13773_0,,,,2,1,1,2
C(C1C(C(CC1(C(O)=O)O)O)O)=O,,,5,1,3,0,3
13773_1,,,,2,1,1,2
13774_0,,,,2,1,1,2
13774_1,,,,2,1,1,2
13776_0,,,,2,1,1,2
C(C1(CC(C(C1O)=O)O)O)(O)=O,,,5,1,5,0,5
13776_1,,,,2,1,1,2
13778_0,,,,2,1,1,2
C(C1C(C(C=O)C(C1O)=O)O)(O)=O,,,5,1,3,0,3
13778_1,,,,2,1,1,2
13780_0,,,,2,1,1,2
C1(CC(C(C(O)=O)C1(C=O)O)O)=O,,,5,1,2,0,2
13782_0,,,,2,1,1,2
C(C1C(CC(C(C1O)=O)=O)O)(O)=O,,,5,1,2,0,2
13784_0,,,,2,1,1,2
C(C1(C(CO)C(C(C1)=O)O)O)(O)=O,,,5,1,2,0,2
13785_0,,,,2,1,1,2
13785_1,,,,2,1,1,2
13786_0,,,,2,1,1,2
13786_1,,,,2,1,1,2
13788_0,,,,2,1,1,2
C(C1C(C(C(C)(C1O)O)O)=O)(O)=O,,,5,1,5,0,5
13788_1,,,,2,1,1,2
13790_0,,,,2,1,1,2
C(C1C(CO)(CC(C1O)=O)O)(O)=O,,,5,1,3,0,3
13791_0,,,,2,1,1,2
13791_1,,,,2,1,1,2
13793_0,,,,2,1,1,2
C1(C(CC(C(C(O)=O)O)(C1)O)O)=O,,,5,1,3,0,3
13794_0,,,,2,1,1,2
13796_0,,,,2,1,1,2
C(C1(C(C(C(C1O)=O)O)O)O)(O)=O,,,5,1,9,0,9
13796_1,,,,2,1,1,2
13798_0,,,,2,1,1,2
C1(CC(CC(C1(C(C)O)O)O)O)=O,,,5,1,5,0,5
13800_0,,,,2,1,1,2
C(C1(C(C(CO)C(C1O)O)=O)O)=O,,,5,1,6,0,6
13800_1,,,,2,1,1,2
13802_0,,,,2,1,1,2
C1(CC(CC(C1(CO)O)O)O)=O,,,5,1,6,0,6
13804_0,,,,2,1,1,2
C1(CC(C(C(C1(CO)O)O)O)O)=O,,,5,1,5,0,5
13806_0,,,,2,1,1,2
C(C1C(CC(C1(C(C)O)O)O)O)=O,,,5,1,2,0,2
13806_1,,,,2,1,1,2
13808_0,,,,2,1,1,2
C(C1C(C(CC1O)(C(C)O)O)O)=O,,,5,1,4,0,4
13808_1,,,,2,1,1,2
13809_0,,,,2,1,1,2
13809_1,,,,2,1,1,2
13810_0,,,,2,1,1,2
13810_1,,,,2,1,1,2
13811_0,,,,2,1,1,2
13811_1,,,,2,1,1,2
13812_0,,,,2,1,1,2
13812_1,,,,2,1,1,2
13813_0,,,,2,1,1,2
13813_1,,,,2,1,1,2
13815_0,,,,2,1,1,2
C(C1(CC(C(C1C=O)O)=O)O)=O,,,5,1,7,0,7
13815_1,,,,2,1,1,2
13817_0,,,,2,1,1,2
C(C1(C(C(C(C1C=O)O)=O)O)O)=O,,,5,1,4,0,4
13817_1,,,,2,1,1,2
13819_0,,,,2,1,1,2
C1(C(CC(C=O)(C1C=O)O)O)=O,,,5,1,4,0,4
13819_1,,,,2,1,1,2
13821_0,,,,2,1,1,2
C(C1C(C(CC(C1O)=O)O)=O)=O,,,5,1,5,0,5
13821_1,,,,2,1,1,2
13823_0,,,,2,1,1,2
C1(C(C(C(C=O)=O)C(C1)O)O)=O,,,5,1,8,0,8
13823_1,,,,2,1,1,2
13825_0,,,,2,1,1,2
C(C1C(C(C=O)C(C1O)=O)O)=O,,,5,1,7,0,7
13825_1,,,,2,1,1,2
13827_0,,,,2,1,1,2
C(C1C(C(CC1O)O)=O)=O,,,5,1,5,0,5
13827_1,,,,2,1,1,2
13828_0,,,,2,1,1,2
13828_1,,,,2,1,1,2
13830_0,,,,2,1,1,2
C1(C(C(C(C=O)(C1C=O)O)O)O)=O,,,5,1,2,0,2
13830_1,,,,2,1,1,2
13832_0,,,,2,1,1,2
C(C1C(C(C(C(C1O)=O)O)O)=O)=O,,,5,1,4,0,4
13832_1,,,,2,1,1,2
13833_0,,,,2,1,1,2
13833_1,,,,2,1,1,2
13834_0,,,,2,1,1,2
13835_0,,,,2,1,1,2
13836_0,,,,2,1,1,2
13837_0,,,,2,1,1,2
13837_1,,,,2,1,1,2
13838_0,,,,2,1,1,2
13838_1,,,,2,1,1,2
13839_0,,,,2,1,1,2
13839_1,,,,2,1,1,2
13840_0,,,,2,1,1,2
13840_1,,,,2,1,1,2
13841_0,,,,2,1,1,2
13841_1,,,,2,1,1,2
13843_0,,,,2,1,1,2
C(C1(CC(C(C1C=O)O)=O)O)(O)=O,,,5,1,3,0,3
13843_1,,,,2,1,1,2
13844_0,,,,2,1,1,2
13845_0,,,,2,1,1,2
13847_0,,,,2,1,1,2
C1(C(C2C(C(CO2)O)(C1)O)O)=O,,,5,1,1,0,1
13849_0,,,,2,1,1,2
C1(C(C2(C(C1O)OCC2O)O)O)=O,,,5,1,2,0,2
13849_1,,,,2,1,1,2
13851_0,,,,2,1,1,2
C1(C(C2COC(C2(C1)O)O)O)=O,,,5,1,2,0,2
13853_0,,,,2,1,1,2
C1(C(C2(C(O)OCC2C1O)O)O)=O,,,5,1,3,0,3
13853_1,,,,2,1,1,2
13855_0,,,,2,1,1,2
C1(C2C(C(C=C)(C1C(O2)O)O)O)=O,,,5,1,4,0,4
13855_1,,,,2,1,1,2
13857_0,,,,2,1,1,2
C1(C2C(C=C)(C(C1C(O2)O)O)O)=O,,,5,1,4,0,4
13857_1,,,,2,1,1,2
13859_0,,,,2,1,1,2
C1(C2C(C=CC(C1C(O2)O)O)O)=O,,,5,1,4,0,4
13859_1,,,,2,1,1,2
13861_0,,,,2,1,1,2
C1(C2C(C(C1C(O2)O)O)O)=O,,,5,1,6,0,6
13861_1,,,,2,1,1,2
13863_0,,,,2,1,1,2
C1(C2C(C(C)(C1C(O2)O)O)O)=O,,,5,1,6,0,6
13863_1,,,,2,1,1,2
13865_0,,,,2,1,1,2
C1(C2C(C)(C(C1C(O2)O)O)O)=O,,,5,1,6,0,6
13865_1,,,,2,1,1,2
13867_0,,,,2,1,1,2
C1(C(C2C(O)OCC2(C1)O)O)=O,,,5,1,2,0,2
13869_0,,,,2,1,1,2
C1(C2C(CC(C1C(O2)O)O)O)=O,,,5,1,6,0,6
13869_1,,,,2,1,1,2
13871_0,,,,2,1,1,2
C1(C2C(C(CO)(C1C(O2)O)O)O)=O,,,5,1,6,0,6
13871_1,,,,2,1,1,2
13873_0,,,,2,1,1,2
C1(C2C(CO)(C(C1C(O2)O)O)O)=O,,,5,1,6,0,6
13873_1,,,,2,1,1,2
13875_0,,,,2,1,1,2
C1(C(C2(COC(C2C1O)O)O)O)=O,,,5,1,3,0,3
13875_1,,,,2,1,1,2
13876_0,,,,2,1,1,2
13876_1,,,,2,1,1,2
13877_0,,,,2,1,1,2
13877_1,,,,2,1,1,2
13878_0,,,,2,1,1,2
13878_1,,,,2,1,1,2
13879_0,,,,2,1,1,2
13879_1,,,,2,1,1,2
13880_0,,,,2,1,1,2
13880_1,,,,2,1,1,2
13881_0,,,,2,1,1,2
13881_1,,,,2,1,1,2
13883_0,,,,2,1,1,2
C1(C(C2C(CC(O)O2)(C1)O)O)=O,,,5,1,2,0,2
13884_0,,,,2,1,1,2
13884_1,,,,2,1,1,2
13885_0,,,,2,1,1,2
13885_1,,,,2,1,1,2
13886_0,,,,2,1,1,2
13886_1,,,,2,1,1,2
13888_0,,,,2,1,1,2
C1(C(C2(C(C1O)OC(C2)O)O)O)=O,,,5,1,3,0,3
13888_1,,,,2,1,1,2
13890_0,,,,2,1,1,2
C(C1(CC(C=O)(C(C1)=O)O)O)=O,,,5,1,1,0,1
13892_0,,,,2,1,1,2
C(C1(C(CC(C(C1)=O)O)=O)O)=O,,,5,1,3,0,3
13894_0,,,,2,1,1,2
C1(CC(C(C=O)C1(C=O)O)O)=O,,,5,1,5,0,5
13896_0,,,,2,1,1,2
C(C1(C(CC(C1)O)=O)O)=O,,,5,1,2,0,2
13898_0,,,,2,1,1,2
C(C1(C(C(C=O)(C(C1)=O)O)O)O)=O,,,5,1,1,0,1
13900_0,,,,2,1,1,2
C(C1(C(CC(C(C1O)=O)O)=O)O)=O,,,5,1,3,0,3
13902_0,,,,2,1,1,2
C(C1(CC(C(C(C1)=O)=O)O)O)=O,,,5,1,1,0,1
13904_0,,,,2,1,1,2
C1(CC(C(C(CC1O)=O)=O)O)=O,,,5,1,3,0,3
13906_0,,,,2,1,1,2
C(C1C(CC(C(C1O)=O)=O)O)=O,,,5,1,4,0,4
13908_0,,,,2,1,1,2
C1(C(C(CC(C1)O)O)=O)=O,,,5,1,1,0,1
13910_0,,,,2,1,1,2
C(C1(C(C(C(C(C1)=O)=O)O)O)O)=O,,,5,1,1,0,1
13912_0,,,,2,1,1,2
C1(C(C(C(C(CC1O)=O)=O)O)O)=O,,,5,1,3,0,3
13913_0,,,,2,1,1,2
13913_1,,,,2,1,1,2
13914_0,,,,2,1,1,2
13914_1,,,,2,1,1,2
13916_0,,,,2,1,1,2
C1C(C(C(C(C=O)=O)=O)C(C=1)O)O,,,5,1,2,0,2
13916_1,,,,2,1,1,2
13917_0,,,,2,1,1,2
13918_0,,,,2,1,1,2
13920_0,,,,2,1,1,2
C1(CC(C(C=O)=O)(CC1O)O)=O,,,5,1,2,0,2
13921_0,,,,2,1,1,2
13921_1,,,,2,1,1,2
13922_0,,,,2,1,1,2
13922_1,,,,2,1,1,2
13923_0,,,,2,1,1,2
13923_1,,,,2,1,1,2
13924_0,,,,2,1,1,2
13924_1,,,,2,1,1,2
13926_0,,,,2,1,1,2
C1(C(C(C(C=O)=O)(CC1O)O)O)=O,,,5,1,3,0,3
13926_1,,,,2,1,1,2
13928_0,,,,2,1,1,2
C1(C(C(C=C)(C(C1O)O)O)O)=O,,,5,1,5,0,5
13928_1,,,,2,1,1,2
13930_0,,,,2,1,1,2
C1(C(C(C(C=C)(C1C=O)O)O)O)=O,,,5,1,4,0,4
13930_1,,,,2,1,1,2
13932_0,,,,2,1,1,2
C(C1C(C(C(C=C)(C1O)O)O)=O)=O,,,5,1,4,0,4
13932_1,,,,2,1,1,2
13933_0,,,,2,1,1,2
13933_1,,,,2,1,1,2
13934_0,,,,2,1,1,2
13934_1,,,,2,1,1,2
13935_0,,,,2,1,1,2
13935_1,,,,2,1,1,2
13937_0,,,,2,1,1,2
C1(C(C(C=CC(C1O)O)O)O)=O,,,5,1,3,0,3
13937_1,,,,2,1,1,2
13939_0,,,,2,1,1,2
C1C(C(C(C=O)=O)C(C=1)O)O,,,5,1,3,0,3
13939_1,,,,2,1,1,2
13941_0,,,,2,1,1,2
C(C1C(C(C(C=CC1O)O)O)=O)=O,,,5,1,4,0,4
13941_1,,,,2,1,1,2
13942_0,,,,2,1,1,2
13942_1,,,,2,1,1,2
13944_0,,,,2,1,1,2
C(C(C(C1C(C=CC1O)O)=O)O)=O,,,5,1,2,0,2
13944_1,,,,2,1,1,2
13946_0,,,,2,1,1,2
C(C1C(C=CC1O)O)=O,,,5,1,3,0,3
13946_1,,,,2,1,1,2
13947_0,,,,2,1,1,2
13947_1,,,,2,1,1,2
13949_0,,,,2,1,1,2
C1(C(C(C(C1O)=O)O)O)=O,,,5,1,3,0,3
13949_1,,,,2,1,1,2
13951_0,,,,2,1,1,2
C(C1C(C(C(C1=O)O)O)=O)=O,,,5,1,2,0,2
13951_1,,,,2,1,1,2
13953_0,,,,2,1,1,2
C(C1C(C(C(C1O)=O)O)=O)=O,,,5,1,3,0,3
13953_1,,,,2,1,1,2
13955_0,,,,2,1,1,2
C1(C(C(C(C1O)O)O)=O)=O,,,5,1,2,0,2
13955_1,,,,2,1,1,2
13957_0,,,,2,1,1,2
C1(C(C(C(C1(CO)O)=O)O)O)=O,,,5,1,2,0,2
13957_1,,,,2,1,1,2
13959_0,,,,2,1,1,2
C1(C(C(C(C1(C)O)O)O)=O)=O,,,5,1,3,0,3
13959_1,,,,2,1,1,2
13961_0,,,,2,1,1,2
C1(C(C(C(C)(C1O)O)O)=O)=O,,,5,1,2,0,2
13961_1,,,,2,1,1,2
13963_0,,,,2,1,1,2
C1(C(CO)(CC(C1O)=O)O)=O,,,5,1,2,0,2
13965_0,,,,2,1,1,2
C1(C(C(CC(C1O)O)O)=O)=O,,,5,1,3,0,3
13965_1,,,,2,1,1,2
13967_0,,,,2,1,1,2
C1(C(C(C(C1(CO)O)O)O)=O)=O,,,5,1,4,0,4
13967_1,,,,2,1,1,2
13969_0,,,,2,1,1,2
C1(C(C(C(CO)(C1O)O)O)=O)=O,,,5,1,2,0,2
13969_1,,,,2,1,1,2
13971_0,,,,2,1,1,2
C1(C(CO)(C(C(C1O)=O)O)O)=O,,,5,1,4,0,4
13971_1,,,,2,1,1,2
13973_0,,,,2,1,1,2
C(C1(C(C(CC1=O)O)=O)O)=O,,,5,1,1,0,1
13975_0,,,,2,1,1,2
C1(C(CC(C1(C)O)O)=O)=O,,,5,1,1,0,1
13977_0,,,,2,1,1,2
C1(C(C(C(C1CO)O)(C)O)=O)=O,,,5,1,2,0,2
13977_1,,,,2,1,1,2
13979_0,,,,2,1,1,2
C1(C(C)(CC(C1O)=O)O)=O,,,5,1,1,0,1
13981_0,,,,2,1,1,2
C1(C(C(C(C)(C1)O)O)=O)=O,,,5,1,4,0,4
13983_0,,,,2,1,1,2
C1(C(CCO)(CC(C1O)=O)O)=O,,,5,1,1,0,1
13985_0,,,,2,1,1,2
C1(C(C(C(C)(C1CO)O)O)=O)=O,,,5,1,2,0,2
13985_1,,,,2,1,1,2
13987_0,,,,2,1,1,2
C1(C(CC(C1O)=O)O)=O,,,5,1,7,0,7
13989_0,,,,2,1,1,2
C1(C(C(CC(C1CO)O)O)=O)=O,,,5,1,2,0,2
13989_1,,,,2,1,1,2
13991_0,,,,2,1,1,2
C1(C(CC(C1(CCO)O)O)=O)=O,,,5,1,1,0,1
13993_0,,,,2,1,1,2
C1(C(CO)C(C(C1O)=O)(C)O)=O,,,5,1,2,0,2
13993_1,,,,2,1,1,2
13995_0,,,,2,1,1,2
C1(C(C(C(CCO)(C1)O)O)=O)=O,,,5,1,4,0,4
13997_0,,,,2,1,1,2
C1(C(CO)C(C(C1O)=O)O)=O,,,5,1,3,0,3
13997_1,,,,2,1,1,2
13999_0,,,,2,1,1,2
C1(C(C(CC(C(C1)O)O)O)=O)=O,,,5,1,1,0,1
14000_0,,,,2,1,1,2
14000_1,,,,2,1,1,2
14001_0,,,,2,1,1,2
14001_1,,,,2,1,1,2
14003_0,,,,2,1,1,2
C1(C(CC(CC1(CO)O)O)=O)=O,,,5,1,1,0,1
14005_0,,,,2,1,1,2
C1(C(CC(C(C1(C)O)O)O)=O)=O,,,5,1,1,0,1
14007_0,,,,2,1,1,2
C1(C(CC(C1(CO)O)O)=O)=O,,,5,1,4,0,4
14009_0,,,,2,1,1,2
C1(C(C(C(CO)(C1)O)O)=O)=O,,,5,1,4,0,4
14011_0,,,,2,1,1,2
C1(C(C)(C(C(C1O)=O)O)O)=O,,,5,1,3,0,3
14011_1,,,,2,1,1,2
14013_0,,,,2,1,1,2
C1(C(C(C(C1)O)O)=O)=O,,,5,1,4,0,4
14015_0,,,,2,1,1,2
C1(C(C(C(C1CO)O)O)=O)=O,,,5,1,5,0,5
14015_1,,,,2,1,1,2
14017_0,,,,2,1,1,2
C1(C(C(C(C1)=O)O)O)=O,,,5,1,4,0,4
14017_1,,,,2,1,1,2
14019_0,,,,2,1,1,2
C1(CC(C(C1)=O)O)=O,,,5,1,5,0,5
14020_0,,,,2,1,1,2
14020_1,,,,2,1,1,2
14022_0,,,,2,1,1,2
C1(C(C(C(C)(C(C1O)O)O)O)O)=O,,,5,1,3,0,3
14022_1,,,,2,1,1,2
14024_0,,,,2,1,1,2
C(C1C(C(C(C1O)=O)(C)O)O)=O,,,5,1,6,0,6
14024_1,,,,2,1,1,2
14026_0,,,,2,1,1,2
C1(CC(CC(C(C1O)=O)O)O)=O,,,5,1,2,0,2
14028_0,,,,2,1,1,2
C(C1C(C)(C(C(C1O)=O)O)O)=O,,,5,1,3,0,3
14028_1,,,,2,1,1,2
14030_0,,,,2,1,1,2
C(C1(C(CC(C(C1)=O)O)O)O)=O,,,5,1,2,0,2
14032_0,,,,2,1,1,2
C1(CC(C(C(CC1O)O)=O)O)=O,,,5,1,2,0,2
14034_0,,,,2,1,1,2
C1(CC(C(C(C1O)=O)O)O)=O,,,5,1,4,0,4
14036_0,,,,2,1,1,2
C(C1C(CC(C(C1O)=O)O)O)=O,,,5,1,6,0,6
14036_1,,,,2,1,1,2
14037_0,,,,2,1,1,2
14037_1,,,,2,1,1,2
14038_0,,,,2,1,1,2
14038_1,,,,2,1,1,2
14040_0,,,,2,1,1,2
C1(C(CO)C(C(C(C1O)=O)O)O)=O,,,5,1,3,0,3
14040_1,,,,2,1,1,2
14042_0,,,,2,1,1,2
C1(C(C(C(C1CO)=O)O)O)=O,,,5,1,3,0,3
14042_1,,,,2,1,1,2
14044_0,,,,2,1,1,2
C1(C(C(C(CC1O)O)O)O)=O,,,5,1,4,0,4
14044_1,,,,2,1,1,2
14046_0,,,,2,1,1,2
C(C1C(C(C(C1(CO)O)=O)O)O)=O,,,5,1,6,0,6
14046_1,,,,2,1,1,2
14048_0,,,,2,1,1,2
C1(C(C(CC1(CO)O)O)O)=O,,,5,1,3,0,3
14048_1,,,,2,1,1,2
14049_0,,,,2,1,1,2
14049_1,,,,2,1,1,2
14051_0,,,,2,1,1,2
C1(C(C(CC(C(C1O)=O)O)O)O)=O,,,5,1,3,0,3
14051_1,,,,2,1,1,2
14052_0,,,,2,1,1,2
14052_1,,,,2,1,1,2
14054_0,,,,2,1,1,2
C(C1(C(CC(C(C1O)=O)O)O)O)=O,,,5,1,4,0,4
14054_1,,,,2,1,1,2
14056_0,,,,2,1,1,2
C1(C(C(C(C(CC1O)O)=O)O)O)=O,,,5,1,3,0,3
14056_1,,,,2,1,1,2
14058_0,,,,2,1,1,2
C1(C(C(C(C(C1)=O)O)O)O)=O,,,5,1,3,0,3
14058_1,,,,2,1,1,2
14060_0,,,,2,1,1,2
C1(C(C(C(C(C1O)=O)O)O)O)=O,,,5,1,3,0,3
14060_1,,,,2,1,1,2
14062_0,,,,2,1,1,2
C(C1(C(C(C(C1(C)O)O)O)=O)O)=O,,,5,1,5,0,5
14062_1,,,,2,1,1,2
14064_0,,,,2,1,1,2
C(C1(C(C(C(C)(C1O)O)O)=O)O)=O,,,5,1,4,0,4
14064_1,,,,2,1,1,2
14065_0,,,,2,1,1,2
14067_0,,,,2,1,1,2
C(C1(C(CO)(CC(C1O)=O)O)O)=O,,,5,1,3,0,3
14069_0,,,,2,1,1,2
C(C1(C(C(C(CC1O)O)O)=O)O)=O,,,5,1,4,0,4
14069_1,,,,2,1,1,2
14071_0,,,,2,1,1,2
C(C1(C(C(C(C1O)O)O)=O)O)=O,,,5,1,5,0,5
14071_1,,,,2,1,1,2
14073_0,,,,2,1,1,2
C(C1(C(C(C(C1O)O)O)=O)O)(O)=O,,,5,1,6,0,6
14073_1,,,,2,1,1,2
14075_0,,,,2,1,1,2
C(C1(C(CC(C(C1O)O)O)=O)O)=O,,,5,1,3,0,3
14077_0,,,,2,1,1,2
C1(C(C(C(CO)(C1(C)O)O)O)O)=O,,,5,1,3,0,3
14077_1,,,,2,1,1,2
14079_0,,,,2,1,1,2
C(C1(C(C(C(C1)O)O)=O)O)=O,,,5,1,3,0,3
14079_1,,,,2,1,1,2
14081_0,,,,2,1,1,2
C1(C(C(CO)C(C(C1)O)O)O)=O,,,5,1,2,0,2
14083_0,,,,2,1,1,2
C1(C(C(CO)C(C(C1O)O)O)O)=O,,,5,1,3,0,3
14083_1,,,,2,1,1,2
14085_0,,,,2,1,1,2
C1(CC(C(C)(C1(CO)O)O)O)=O,,,5,1,4,0,4
14087_0,,,,2,1,1,2
C1(CC(C(CO)(C1(CO)O)O)O)=O,,,5,1,6,0,6
14089_0,,,,2,1,1,2
C(C1C(C(CC(C1O)=O)O)O)(O)=O,,,5,1,3,0,3
14090_0,,,,2,1,1,2
14090_1,,,,2,1,1,2
14092_0,,,,2,1,1,2
C(C1(C(CC(C1(C)O)O)=O)O)(O)=O,,,5,1,4,0,4
14094_0,,,,2,1,1,2
C(C1(C(C)(CC(C1O)=O)O)O)(O)=O,,,5,1,4,0,4
14096_0,,,,2,1,1,2
C(C1(C(CC(C)(C1O)O)=O)O)(O)=O,,,5,1,4,0,4
14098_0,,,,2,1,1,2
C(C1(C(CC(CC1O)O)=O)O)(O)=O,,,5,1,6,0,6
14100_0,,,,2,1,1,2
C(C1(C(CC(C1O)O)=O)O)(O)=O,,,5,1,7,0,7
14102_0,,,,2,1,1,2
C(C1C(C(C(O)=O)(CC1O)O)O)=O,,,5,1,6,0,6
14102_1,,,,2,1,1,2
14104_0,,,,2,1,1,2
C(C1C(CC(C1(C(O)=O)O)O)O)=O,,,5,1,4,0,4
14104_1,,,,2,1,1,2
14106_0,,,,2,1,1,2
C1(C(C2(C(C1(C(C2)O)O)O)O)O)=O,,,5,1,6,0,6
14106_1,,,,2,1,1,2
14108_0,,,,2,1,1,2
C1(C(C(C(C1(C(C)O)O)O)O)O)=O,,,5,1,6,0,6
14108_1,,,,2,1,1,2
14109_0,,,,2,1,1,2
14109_1,,,,2,1,1,2
14111_0,,,,2,1,1,2
C(C1(C=O)C(CC(C1O)=O)O)(O)=O,,,5,1,4,0,4
14113_0,,,,2,1,1,2
C(C1(C(CC(C1O)=O)O)C(C)O)=O,,,5,1,4,0,4
14115_0,,,,2,1,1,2
C(C1(CO)C(CC(C1O)=O)O)=O,,,5,1,4,0,4
14116_0,,,,2,1,1,2
14118_0,,,,2,1,1,2
C1(C(C(C(C1)O)O)(C(C=O)O)O)=O,,,5,1,5,0,5
14120_0,,,,2,1,1,2
C1(CC(C(C1(C(C)O)O)O)O)=O,,,5,1,5,0,5
14122_0,,,,2,1,1,2
C1(CC(C(C1(C(CO)O)O)O)O)=O,,,5,1,5,0,5
14124_0,,,,2,1,1,2
C(C1(CO)C(C(C(C1O)=O)O)O)=O,,,5,1,5,0,5
14124_1,,,,2,1,1,2
14126_0,,,,2,1,1,2
C1(C(CO)(C(C(C1CO)O)O)O)=O,,,5,1,8,0,8
14126_1,,,,2,1,1,2
14128_0,,,,2,1,1,2
C(C1(C(C(C(C1O)O)O)=O)CO)=O,,,5,1,4,0,4
14128_1,,,,2,1,1,2
14130_0,,,,2,1,1,2
C(C1C(C(CO)(C(C1O)O)O)=O)=O,,,5,1,6,0,6
14130_1,,,,2,1,1,2
14132_0,,,,2,1,1,2
C1(C(C(C(C=O)=O)(C(C1)O)O)O)=O,,,5,1,6,0,6
14134_0,,,,2,1,1,2
C(C1(C(C(CC(C1O)=O)O)=O)O)=O,,,5,1,3,0,3
14136_0,,,,2,1,1,2
C(C1(CC(C(C1(C=O)O)O)=O)O)=O,,,5,1,3,0,3
14138_0,,,,2,1,1,2
C(C1C(C(C=O)(C(C1O)=O)O)O)=O,,,5,1,4,0,4
14138_1,,,,2,1,1,2
14140_0,,,,2,1,1,2
C1(C(CO)(C(C=O)(C(C1)O)O)O)=O,,,5,1,7,0,7
14142_0,,,,2,1,1,2
C1(C(C)(C(C=O)(C(C1O)O)O)O)=O,,,5,1,8,0,8
14142_1,,,,2,1,1,2
14144_0,,,,2,1,1,2
C(C1(C(C(C=O)C(C1O)=O)O)O)=O,,,5,1,4,0,4
14144_1,,,,2,1,1,2
14146_0,,,,2,1,1,2
C1(CC(C(C=O)(C1(C=O)O)O)O)=O,,,5,1,3,0,3
14148_0,,,,2,1,1,2
C(C1(C(CC(C(C1O)=O)=O)O)O)=O,,,5,1,3,0,3
14149_0,,,,2,1,1,2
14151_0,,,,2,1,1,2
C(C1(C(C(C(C1O)=O)CO)O)O)=O,,,5,1,8,0,8
14151_1,,,,2,1,1,2
14152_0,,,,2,1,1,2
14152_1,,,,2,1,1,2
14154_0,,,,2,1,1,2
C(C1(C(CC(C(C1O)O)=O)O)O)=O,,,5,1,7,0,7
14154_1,,,,2,1,1,2
14155_0,,,,2,1,1,2
14156_0,,,,2,1,1,2
14156_1,,,,2,1,1,2
14158_0,,,,2,1,1,2
C1(C2C(C(C(C1(CO2)O)O)O)O)=O,,,5,1,4,0,4
14158_1,,,,2,1,1,2
14160_0,,,,2,1,1,2
C1(C(CO)(C(C=C)(C(C1)O)O)O)=O,,,5,1,3,0,3
14162_0,,,,2,1,1,2
C1(CC(C=C)(C(C1(CO)O)O)O)=O,,,5,1,3,0,3
14164_0,,,,2,1,1,2
C1(CC(C=CC(C1(CO)O)O)O)=O,,,5,1,3,0,3
14166_0,,,,2,1,1,2
C1(C2(COC1C(C2(C=C)O)O)O)=O,,,5,1,4,0,4
14166_1,,,,2,1,1,2
14168_0,,,,2,1,1,2
C1(C2C(C=C)(C(C1(CO2)O)O)O)=O,,,5,1,4,0,4
14168_1,,,,2,1,1,2
14170_0,,,,2,1,1,2
C1(C2C(C=CC(C1(CO2)O)O)O)=O,,,5,1,4,0,4
14170_1,,,,2,1,1,2
14172_0,,,,2,1,1,2
C1(C2C(C(C1(CO2)O)O)O)=O,,,5,1,4,0,4
14172_1,,,,2,1,1,2
14174_0,,,,2,1,1,2
C1(C2C(C(C)(C1(CO2)O)O)O)=O,,,5,1,4,0,4
14174_1,,,,2,1,1,2
14176_0,,,,2,1,1,2
C1(C2C(C)(C(C1(CO2)O)O)O)=O,,,5,1,4,0,4
14176_1,,,,2,1,1,2
14178_0,,,,2,1,1,2
C1(C(C2(COCC2(C1)O)O)O)=O,,,5,1,1,0,1
14180_0,,,,2,1,1,2
C1(C2C(CC(C1(CO2)O)O)O)=O,,,5,1,4,0,4
14180_1,,,,2,1,1,2
14182_0,,,,2,1,1,2
C1(C2C(C(CO)(C1(CO2)O)O)O)=O,,,5,1,4,0,4
14182_1,,,,2,1,1,2
14184_0,,,,2,1,1,2
C1(C2C(CO)(C(C1(CO2)O)O)O)=O,,,5,1,4,0,4
14184_1,,,,2,1,1,2
14186_0,,,,2,1,1,2
C1(C(C2(COCC2(C1O)O)O)O)=O,,,5,1,2,0,2
14186_1,,,,2,1,1,2
14188_0,,,,2,1,1,2
C1(CC(C(C=C)(C1(C=O)O)O)O)=O,,,5,1,3,0,3
14190_0,,,,2,1,1,2
C(C1(C(CC(C=C)(C1O)O)=O)O)=O,,,5,1,3,0,3
14192_0,,,,2,1,1,2
C(C1(C(CC(C=CC1O)O)=O)O)=O,,,5,1,3,0,3
14194_0,,,,2,1,1,2
C1(C(C2(COC(C2(C1)O)O)O)O)=O,,,5,1,2,0,2
14196_0,,,,2,1,1,2
C1(CC2(CC1(C(C2O)O)O)O)=O,,,5,1,2,0,2
14198_0,,,,2,1,1,2
C1(C(C2(CC1(C(C2O)O)O)O)O)=O,,,5,1,3,0,3
14198_1,,,,2,1,1,2
14200_0,,,,2,1,1,2
C(C1C(C(C(C1(C)O)O)(O)O)O)=O,,,5,1,2,0,2
14200_1,,,,2,1,1,2
14201_0,,,,2,1,1,2
14201_1,,,,2,1,1,2
14203_0,,,,2,1,1,2
C(C1(CC(C(O)=O)(C(C1)=O)O)O)=O,,,5,1,2,0,2
14205_0,,,,2,1,1,2
C(C1(C(CC(C(C1)=O)O)=O)O)(O)=O,,,5,1,2,0,2
14207_0,,,,2,1,1,2
C(C1(CC(C(C1)=O)(C(C)O)O)O)=O,,,5,1,2,0,2
14209_0,,,,2,1,1,2
C1(CC(C(CC1(C(C)O)O)=O)O)=O,,,5,1,2,0,2
14211_0,,,,2,1,1,2
C1(CC(C(C=O)C1(C(O)=O)O)O)=O,,,5,1,2,0,2
14213_0,,,,2,1,1,2
C(C1C(CC(C1(C(C)O)O)=O)O)=O,,,5,1,2,0,2
14215_0,,,,2,1,1,2
C1(CC(CC1(C(CCO)O)O)O)=O,,,5,1,2,0,2
14217_0,,,,2,1,1,2
C1(CC(CC1(C(CO)(C)O)O)O)=O,,,5,1,2,0,2
14219_0,,,,2,1,1,2
C(C1(C(CC(C1)O)=O)O)(O)=O,,,5,1,2,0,2
14221_0,,,,2,1,1,2
C1(CC(CC1(C(C(O)O)O)O)O)=O,,,5,1,2,0,2
14223_0,,,,2,1,1,2
C1(CC(CC1(C(C(C)O)O)O)O)=O,,,5,1,2,0,2
14225_0,,,,2,1,1,2
C1(C(C(C(C1)O)O)(CC=O)O)=O,,,5,1,2,0,2
14227_0,,,,2,1,1,2
C1(C(CC(C1)O)(C(C=O)O)O)=O,,,5,1,2,0,2
14229_0,,,,2,1,1,2
C1(C(CC(C1)O)(C(C(O)=O)O)O)=O,,,5,1,2,0,2
14231_0,,,,2,1,1,2
C1(C(C(C(C1)O)(C)O)(CC=O)O)=O,,,5,1,2,0,2
14233_0,,,,2,1,1,2
C1(C(CC(C1)O)(C(C=O)(C)O)O)=O,,,5,1,2,0,2
14235_0,,,,2,1,1,2
C1(C(C(C(C)(C1)O)O)(CC=O)O)=O,,,5,1,2,0,2
14237_0,,,,2,1,1,2
C(C)(C1(CC(CC(C1O)=O)O)O)=O,,,5,1,2,0,2
14239_0,,,,2,1,1,2
C1(C(CC(C1)O)(C(C(C)=O)O)O)=O,,,5,1,2,0,2
14241_0,,,,2,1,1,2
C(CC1(C(C)(CC(C1O)=O)O)O)=O,,,5,1,1,0,1
14243_0,,,,2,1,1,2
C(C1C(CC(C1(C(C)=O)O)O)O)=O,,,5,1,3,0,3
14243_1,,,,2,1,1,2
14245_0,,,,2,1,1,2
C1(C(C(CC(C1)O)O)(CC=O)O)=O,,,5,1,2,0,2
14247_0,,,,2,1,1,2
C(C1C(C(C(C)=O)(CC1O)O)O)=O,,,5,1,3,0,3
14247_1,,,,2,1,1,2
14249_0,,,,2,1,1,2
C1(CC(CC1(C(CC=O)O)O)O)=O,,,5,1,2,0,2
14251_0,,,,2,1,1,2
C1(CC(CC1(C(C)O)O)O)=O,,,5,1,2,0,2
14253_0,,,,2,1,1,2
C1(CC(CC1(C(CO)O)O)O)=O,,,5,1,2,0,2
14255_0,,,,2,1,1,2
C1(C(CC(C(C(C1)O)(O)O)O)O)=O,,,5,1,1,0,1
14257_0,,,,2,1,1,2
C1(C(CC(C(C(C1)O)(C)O)O)O)=O,,,5,1,1,0,1
14259_0,,,,2,1,1,2
C(C1C(C(C)(C(C1O)(O)O)O)O)=O,,,5,1,2,0,2
14259_1,,,,2,1,1,2
14261_0,,,,2,1,1,2
C(C1C(C(C)(C(C)(C1O)O)O)O)=O,,,5,1,2,0,2
14261_1,,,,2,1,1,2
14263_0,,,,2,1,1,2
C1(C(C(C(C1C(C)O)O)(O)O)O)=O,,,5,1,2,0,2
14263_1,,,,2,1,1,2
14265_0,,,,2,1,1,2
C1(C(C(C)(C(C1C(C)O)O)O)O)=O,,,5,1,2,0,2
14265_1,,,,2,1,1,2
14267_0,,,,2,1,1,2
C(C1(CC(C(C1O)=O)(CO)O)O)=O,,,5,1,3,0,3
14267_1,,,,2,1,1,2
14269_0,,,,2,1,1,2
C1(C(C(C(C(CO)(C1)O)=O)O)O)=O,,,5,1,3,0,3
14269_1,,,,2,1,1,2
14271_0,,,,2,1,1,2
C(C1C(CC(C(C1O)(O)O)O)O)=O,,,5,1,2,0,2
14271_1,,,,2,1,1,2
14273_0,,,,2,1,1,2
C(C1C(C(C)(C(CC1O)O)O)O)=O,,,5,1,2,0,2
14273_1,,,,2,1,1,2
14274_0,,,,2,1,1,2
14274_1,,,,2,1,1,2
14276_0,,,,2,1,1,2
C(C1(C(C(CO)C(C1)O)=O)O)(O)=O,,,5,1,3,0,3
14276_1,,,,2,1,1,2
14278_0,,,,2,1,1,2
C1(C(C(C)O)(CC(C1CO)O)O)=O,,,5,1,3,0,3
14278_1,,,,2,1,1,2
14280_0,,,,2,1,1,2
C1(C(CO)(CC(C1CO)O)O)=O,,,5,1,3,0,3
14280_1,,,,2,1,1,2
14281_0,,,,2,1,1,2
14281_1,,,,2,1,1,2
14283_0,,,,2,1,1,2
C(C1(C(C(C(C1)O)O)=O)O)(O)=O,,,5,1,3,0,3
14283_1,,,,2,1,1,2
14285_0,,,,2,1,1,2
C1(C(C(C(C1O)O)O)(CC=O)O)=O,,,5,1,4,0,4
14285_1,,,,2,1,1,2
14287_0,,,,2,1,1,2
C1(C(CC(C1O)O)(C(C=O)O)O)=O,,,5,1,4,0,4
14287_1,,,,2,1,1,2
14289_0,,,,2,1,1,2
C1(C(C(CC1(C(C)O)O)O)O)=O,,,5,1,3,0,3
14289_1,,,,2,1,1,2
14291_0,,,,2,1,1,2
C1(C(C(CC1(C(CO)O)O)O)O)=O,,,5,1,3,0,3
14291_1,,,,2,1,1,2
14293_0,,,,2,1,1,2
C1(C(C(C(C(C1O)O)(O)O)O)O)=O,,,5,1,2,0,2
14293_1,,,,2,1,1,2
14295_0,,,,2,1,1,2
C1(CC(C(C1(CO)O)(O)O)O)=O,,,5,1,1,0,1
14297_0,,,,2,1,1,2
C1(C(C(C(C1(C)O)(O)O)O)O)=O,,,5,1,2,0,2
14297_1,,,,2,1,1,2
14299_0,,,,2,1,1,2
C1(C(C(C(C)(C1(C)O)O)O)O)=O,,,5,1,3,0,3
14299_1,,,,2,1,1,2
14300_0,,,,2,1,1,2
14300_1,,,,2,1,1,2
14302_0,,,,2,1,1,2
C1(C2(C(C(C(C1CO2)O)O)O)O)=O,,,5,1,3,0,3
14302_1,,,,2,1,1,2
14303_0,,,,2,1,1,2
14303_1,,,,2,1,1,2
14305_0,,,,2,1,1,2
C(C1C(C(C(C1O)(O)O)O)=O)=O,,,5,1,2,0,2
14305_1,,,,2,1,1,2
14307_0,,,,2,1,1,2
C(C1C(C(C(C1O)(O)O)O)=O)(O)=O,,,5,1,2,0,2
14307_1,,,,2,1,1,2
14309_0,,,,2,1,1,2
C1(C2(C(C=C)(C(C1CO2)O)O)O)=O,,,5,1,3,0,3
14309_1,,,,2,1,1,2
14311_0,,,,2,1,1,2
C1(C2(C(C(C=C)(C1CO2)O)O)O)=O,,,5,1,3,0,3
14311_1,,,,2,1,1,2
14313_0,,,,2,1,1,2
C1(C2(C(C=CC(C1CO2)O)O)O)=O,,,5,1,3,0,3
14313_1,,,,2,1,1,2
14315_0,,,,2,1,1,2
C1(C2(C(C(C1CO2)O)O)O)=O,,,5,1,3,0,3
14315_1,,,,2,1,1,2
14317_0,,,,2,1,1,2
C1(C2(C(C)(C(C1CO2)O)O)O)=O,,,5,1,3,0,3
14317_1,,,,2,1,1,2
14319_0,,,,2,1,1,2
C1(C2(C(C(C)(C1CO2)O)O)O)=O,,,5,1,3,0,3
14319_1,,,,2,1,1,2
14321_0,,,,2,1,1,2
C1(C(C2(C(CCO2)(C1)O)O)O)=O,,,5,1,1,0,1
14323_0,,,,2,1,1,2
C1(C2(C(CC(C1CO2)O)O)O)=O,,,5,1,3,0,3
14323_1,,,,2,1,1,2
14325_0,,,,2,1,1,2
C1(C2(C(CO)(C(C1CO2)O)O)O)=O,,,5,1,3,0,3
14325_1,,,,2,1,1,2
14327_0,,,,2,1,1,2
C1(C2(C(C(CO)(C1CO2)O)O)O)=O,,,5,1,3,0,3
14327_1,,,,2,1,1,2
14329_0,,,,2,1,1,2
C1(C(C2(C(C1O)(O)OCC2)O)O)=O,,,5,1,2,0,2
14329_1,,,,2,1,1,2
14331_0,,,,2,1,1,2
C(C1(C(CC(C1(O)O)O)=O)O)=O,,,5,1,1,0,1
14333_0,,,,2,1,1,2
C1(C(C(C(C(C1)O)(O)O)O)=O)=O,,,5,1,1,0,1
14335_0,,,,2,1,1,2
C(C1(C(C=CC(C1C=O)O)O)O)=O,,,5,1,3,0,3
14335_1,,,,2,1,1,2
14337_0,,,,2,1,1,2
C1(C(C2(C(C(CO2)O)(C1)O)O)O)=O,,,5,1,1,0,1
14339_0,,,,2,1,1,2
C1(C(C(C(C1)O)(O)O)O)=O,,,5,1,1,0,1
14341_0,,,,2,1,1,2
C1(C(C(C(C1CO)O)(O)O)O)=O,,,5,1,2,0,2
14341_1,,,,2,1,1,2
14343_0,,,,2,1,1,2
C(C1C(C(C(C1O)O)(O)O)O)=O,,,5,1,2,0,2
14343_1,,,,2,1,1,2
14345_0,,,,2,1,1,2
C1(C(C(C(C(C1)O)(O)O)O)O)=O,,,5,1,3,0,3
14345_1,,,,2,1,1,2
14346_0,,,,2,1,1,2
14348_0,,,,2,1,1,2
C1(C(C(C(C1O)O)(O)O)O)=O,,,5,1,2,0,2
14348_1,,,,2,1,1,2
14350_0,,,,2,1,1,2
C1(C(C(C(C(C1)O)(C)O)O)O)=O,,,5,1,3,0,3
14350_1,,,,2,1,1,2
14351_0,,,,2,1,1,2
14353_0,,,,2,1,1,2
C1(CC(C(C=O)=O)C(C1O)O)=O,,,5,1,3,0,3
14355_0,,,,2,1,1,2
C(C(C1C(CC(C1O)=O)=O)O)=O,,,5,1,4,0,4
14355_1,,,,2,1,1,2
14357_0,,,,2,1,1,2
C1(CC(C(C1C(C=O)=O)O)O)=O,,,5,1,4,0,4
14357_1,,,,2,1,1,2
14359_0,,,,2,1,1,2
C(C1C(C(C(C1)=O)O)O)=O,,,5,1,6,0,6
14361_0,,,,2,1,1,2
C(C1C(CC(C1O)O)=O)=O,,,5,1,6,0,6
14361_1,,,,2,1,1,2
14363_0,,,,2,1,1,2
C(C1C(C(C(C1CO)O)O)=O)=O,,,5,1,2,0,2
14363_1,,,,2,1,1,2
14365_0,,,,2,1,1,2
C1(C(C(C(C1C)O)O)=O)=O,,,5,1,3,0,3
14365_1,,,,2,1,1,2
14367_0,,,,2,1,1,2
C1(C(C)(C(C(C1)=O)O)O)=O,,,5,1,4,0,4
14367_1,,,,2,1,1,2
14369_0,,,,2,1,1,2
C1(C(CC(CO)(C1)O)=O)=O,,,5,1,2,0,2
14370_0,,,,2,1,1,2
14370_1,,,,2,1,1,2
14372_0,,,,2,1,1,2
C1(C(CO)(CC(C1)=O)O)=O,,,5,1,3,0,3
14374_0,,,,2,1,1,2
C1(CC(C(C(C1)=O)O)O)=O,,,5,1,5,0,5
14374_1,,,,2,1,1,2
14376_0,,,,2,1,1,2
C1(C(C(C(CC1)O)O)=O)=O,,,5,1,3,0,3
14376_1,,,,2,1,1,2
14378_0,,,,2,1,1,2
C1(C(C(C(C1CCO)O)O)=O)=O,,,5,1,3,0,3
14378_1,,,,2,1,1,2
14380_0,,,,2,1,1,2
C1(C(CCO)(C(C(C1)=O)O)O)=O,,,5,1,4,0,4
14380_1,,,,2,1,1,2
14382_0,,,,2,1,1,2
C1(C(CC(CO)(C1CO)O)=O)=O,,,5,1,5,0,5
14382_1,,,,2,1,1,2
14383_0,,,,2,1,1,2
14383_1,,,,2,1,1,2
14385_0,,,,2,1,1,2
C1(C(CO)C(C(C1)=O)(CO)O)=O,,,5,1,3,0,3
14385_1,,,,2,1,1,2
14387_0,,,,2,1,1,2
C(CC1(CC(C(C1O)=O)O)O)=O,,,5,1,3,0,3
14387_1,,,,2,1,1,2
14389_0,,,,2,1,1,2
C1(CC(C(C(C(C1)O)O)=O)O)=O,,,5,1,3,0,3
14389_1,,,,2,1,1,2
14391_0,,,,2,1,1,2
C(C1C(CC(C1(CO)O)O)=O)=O,,,5,1,5,0,5
14391_1,,,,2,1,1,2
14393_0,,,,2,1,1,2
C1(CCC(C(C(C1O)=O)O)O)=O,,,5,1,3,0,3
14393_1,,,,2,1,1,2
14395_0,,,,2,1,1,2
C(C1C(CO)(C(C(C1)=O)O)O)=O,,,5,1,5,0,5
14397_0,,,,2,1,1,2
C1(C(CC(C1C(CO)=O)O)O)=O,,,5,1,4,0,4
14397_1,,,,2,1,1,2
14399_0,,,,2,1,1,2
C1(C(C(CC(C(C1)=O)O)O)O)=O,,,5,1,4,0,4
14399_1,,,,2,1,1,2
14400_0,,,,2,1,1,2
14400_1,,,,2,1,1,2
14402_0,,,,2,1,1,2
C1(CC(C(C1C(CO)=O)O)O)=O,,,5,1,3,0,3
14402_1,,,,2,1,1,2
14404_0,,,,2,1,1,2
C1(CC(C(C(C(C1)=O)O)O)O)=O,,,5,1,3,0,3
14404_1,,,,2,1,1,2
14406_0,,,,2,1,1,2
C1(C(C(C(C(CC1)O)O)O)=O)=O,,,5,1,3,0,3
14406_1,,,,2,1,1,2
14408_0,,,,2,1,1,2
C1(CC(CO)(C(C(C1)=O)O)O)=O,,,5,1,6,0,6
14408_1,,,,2,1,1,2
14410_0,,,,2,1,1,2
C1(C(C(C(CC1)(CO)O)O)=O)=O,,,5,1,3,0,3
14410_1,,,,2,1,1,2
14412_0,,,,2,1,1,2
C1(CCC(C(C1(CO)O)O)=O)=O,,,5,1,5,0,5
14412_1,,,,2,1,1,2
14414_0,,,,2,1,1,2
C(CO)(C1(CCC(C1O)=O)O)=O,,,5,1,4,0,4
14414_1,,,,2,1,1,2
14416_0,,,,2,1,1,2
C(C1CC(C(C(C1O)=O)O)O)=O,,,5,1,4,0,4
14416_1,,,,2,1,1,2
14418_0,,,,2,1,1,2
C(CC1C(C(C(C1O)=O)O)O)=O,,,5,1,4,0,4
14418_1,,,,2,1,1,2
14420_0,,,,2,1,1,2
C1(C(C(C(CC1CO)O)O)=O)=O,,,5,1,3,0,3
14420_1,,,,2,1,1,2
14422_0,,,,2,1,1,2
C(C)(C1(CC(C(C1O)=O)O)O)=O,,,5,1,4,0,4
14422_1,,,,2,1,1,2
14424_0,,,,2,1,1,2
C1(CC(C(C(C1(C)O)O)=O)O)=O,,,5,1,3,0,3
14424_1,,,,2,1,1,2
14426_0,,,,2,1,1,2
C1(C(CC(CO)(C(C1)O)O)=O)=O,,,5,1,4,0,4
14428_0,,,,2,1,1,2
C1(CC(C)(C(C(C1O)=O)O)O)=O,,,5,1,3,0,3
14428_1,,,,2,1,1,2
14429_0,,,,2,1,1,2
14431_0,,,,2,1,1,2
C1(C(C(C)(C(C(C1)=O)O)O)O)=O,,,5,1,3,0,3
14431_1,,,,2,1,1,2
14433_0,,,,2,1,1,2
C1(CC(CO)(CC(C1O)=O)O)=O,,,5,1,2,0,2
14435_0,,,,2,1,1,2
C(C1(C(C)C(C(C1O)=O)O)O)=O,,,5,1,2,0,2
14435_1,,,,2,1,1,2
14437_0,,,,2,1,1,2
C1(C(C(C(C(C1C)O)=O)O)O)=O,,,5,1,3,0,3
14437_1,,,,2,1,1,2
14439_0,,,,2,1,1,2
C1(C(C(C(C(C1C)O)O)O)=O)=O,,,5,1,3,0,3
14439_1,,,,2,1,1,2
14440_0,,,,2,1,1,2
14440_1,,,,2,1,1,2
14442_0,,,,2,1,1,2
C1(C(CO)(C(C(C1)=O)O)O)=O,,,5,1,6,0,6
14442_1,,,,2,1,1,2
14443_0,,,,2,1,1,2
14443_1,,,,2,1,1,2
14444_0,,,,2,1,1,2
14444_1,,,,2,1,1,2
14446_0,,,,2,1,1,2
C(C1(CC(C(C1O)=O)CO)O)=O,,,5,1,2,0,2
14446_1,,,,2,1,1,2
14448_0,,,,2,1,1,2
C1(C(C(C(C(CO)C1)=O)O)O)=O,,,5,1,5,0,5
14448_1,,,,2,1,1,2
14450_0,,,,2,1,1,2
C1(C(CO)C(C=O)C(C1O)O)=O,,,5,1,4,0,4
14450_1,,,,2,1,1,2
14452_0,,,,2,1,1,2
C1(C(C(CC1CO)O)O)=O,,,5,1,2,0,2
14452_1,,,,2,1,1,2
14454_0,,,,2,1,1,2
C1(C(CC(C(CO)O)(C1)O)=O)=O,,,5,1,2,0,2
14456_0,,,,2,1,1,2
C1(C(C(CO)O)(CC(C1)=O)O)=O,,,5,1,2,0,2
14458_0,,,,2,1,1,2
C(C1C(C(CC1O)=O)=O)(O)=O,,,5,1,3,0,3
14458_1,,,,2,1,1,2
14460_0,,,,2,1,1,2
C(C1C(C(C(C1)=O)(CO)O)O)=O,,,5,1,4,0,4
14462_0,,,,2,1,1,2
C(C1C(CC(CO)(C1O)O)=O)=O,,,5,1,3,0,3
14462_1,,,,2,1,1,2
14464_0,,,,2,1,1,2
C(C1C(C(CO)C(C1O)O)=O)=O,,,5,1,5,0,5
14464_1,,,,2,1,1,2
14466_0,,,,2,1,1,2
C(C1C(C(C(C)C1O)=O)=O)=O,,,5,1,3,0,3
14466_1,,,,2,1,1,2
14468_0,,,,2,1,1,2
C(C)(C1C(C(CC1O)=O)=O)=O,,,5,1,4,0,4
14468_1,,,,2,1,1,2
14470_0,,,,2,1,1,2
C1(CC(CC(C(C1)=O)=O)O)=O,,,5,1,3,0,3
14472_0,,,,2,1,1,2
C(CC1(C(CC(C1)=O)=O)O)=O,,,5,1,2,0,2
14474_0,,,,2,1,1,2
C(C1C(C(CC1(C)O)=O)=O)=O,,,5,1,5,0,5
14474_1,,,,2,1,1,2
14475_0,,,,2,1,1,2
14477_0,,,,2,1,1,2
C(CC1(CC(C(C1)=O)=O)O)=O,,,5,1,2,0,2
14479_0,,,,2,1,1,2
C1(C(C=O)C(C(C1)=O)(C)O)=O,,,5,1,3,0,3
14479_1,,,,2,1,1,2
14481_0,,,,2,1,1,2
C(C1(C(CC(C1)=O)=O)O)=O,,,5,1,3,0,3
14483_0,,,,2,1,1,2
C1(CC(C(C(C1)=O)=O)O)=O,,,5,1,2,0,2
14485_0,,,,2,1,1,2
C(C1(CC(C(C1)=O)=O)O)=O,,,5,1,2,0,2
14487_0,,,,2,1,1,2
C1(C(CC(C(C1)=O)=O)O)=O,,,5,1,2,0,2
14489_0,,,,2,1,1,2
C1(C(CC(C1)O)=O)=O,,,5,1,2,0,2
14491_0,,,,2,1,1,2
C1(CC(C(C=O)=O)C(C1)O)=O,,,5,1,3,0,3
14493_0,,,,2,1,1,2
C1(CCC(C=O)(C1C=O)O)=O,,,5,1,3,0,3
14493_1,,,,2,1,1,2
14495_0,,,,2,1,1,2
C(C1C(CCC(C1O)=O)=O)=O,,,5,1,3,0,3
14495_1,,,,2,1,1,2
14497_0,,,,2,1,1,2
C1(CCC(C1C(C=O)=O)O)=O,,,5,1,3,0,3
14497_1,,,,2,1,1,2
14499_0,,,,2,1,1,2
C(C1(CC(CC1C=O)=O)O)=O,,,5,1,2,0,2
14501_0,,,,2,1,1,2
C(CC1C(CC(C1O)=O)=O)=O,,,5,1,2,0,2
14503_0,,,,2,1,1,2
C(C1CC(CC(C1O)=O)=O)=O,,,5,1,2,0,2
14505_0,,,,2,1,1,2
C(C1CC(C(C1C=O)O)=O)=O,,,5,1,3,0,3
14507_0,,,,2,1,1,2
C(C1(CCC(C(C1)=O)=O)O)=O,,,5,1,2,0,2
14509_0,,,,2,1,1,2
C1(CCC(C(CC1O)=O)=O)=O,,,5,1,2,0,2
14511_0,,,,2,1,1,2
C(C1(CC(CC(C1)=O)=O)O)=O,,,5,1,2,0,2
14513_0,,,,2,1,1,2
C1(CC(C(C1C(C)=O)O)=O)=O,,,5,1,3,0,3
14513_1,,,,2,1,1,2
14515_0,,,,2,1,1,2
C1(CC(CC(C(C1)=O)O)=O)=O,,,5,1,2,0,2
14517_0,,,,2,1,1,2
C(C1(CC(C=O)C(C1O)=O)O)=O,,,5,1,2,0,2
14517_1,,,,2,1,1,2
14519_0,,,,2,1,1,2
C(C1C(C(C(C(C1)=O)O)O)=O)=O,,,5,1,3,0,3
14519_1,,,,2,1,1,2
14521_0,,,,2,1,1,2
C(C1(CCC(C1O)=O)O)=O,,,5,1,5,0,5
14521_1,,,,2,1,1,2
14523_0,,,,2,1,1,2
C1(CCC(C(C1O)O)=O)=O,,,5,1,3,0,3
14523_1,,,,2,1,1,2
14525_0,,,,2,1,1,2
C1(C(CO)C(C(C1)=O)O)=O,,,5,1,4,0,4
14525_1,,,,2,1,1,2
14527_0,,,,2,1,1,2
C1(C(C(CO)O)C(C(C1)=O)O)=O,,,5,1,3,0,3
14527_1,,,,2,1,1,2
14529_0,,,,2,1,1,2
C(CC1C(C(CC1O)=O)=O)=O,,,5,1,3,0,3
14531_0,,,,2,1,1,2
C(C1C(CC(C(C1)=O)=O)O)=O,,,5,1,3,0,3
14533_0,,,,2,1,1,2
C(C1C(C(CCC1O)=O)=O)=O,,,5,1,3,0,3
14533_1,,,,2,1,1,2
14535_0,,,,2,1,1,2
C(C1C(CC(CC1O)=O)=O)=O,,,5,1,5,0,5
14535_1,,,,2,1,1,2
14537_0,,,,2,1,1,2
C(C1CC(C(C1O)=O)=O)=O,,,5,1,2,0,2
14539_0,,,,2,1,1,2
C(C1C(CC(C1O)=O)=O)=O,,,5,1,5,0,5
14539_1,,,,2,1,1,2
14541_0,,,,2,1,1,2
C(C1C(C(C=O)C(C1)=O)O)=O,,,5,1,4,0,4
14541_1,,,,2,1,1,2
14542_0,,,,2,1,1,2
14543_0,,,,2,1,1,2
14544_0,,,,2,1,1,2
14546_0,,,,2,1,1,2
C1(C(C(C(C=O)C1C=O)O)O)=O,,,5,1,4,0,4
14546_1,,,,2,1,1,2
14547_0,,,,2,1,1,2
14547_1,,,,2,1,1,2
14549_0,,,,2,1,1,2
C1(C(C=O)(C(C(C1)=O)CO)O)=O,,,5,1,4,0,4
14549_1,,,,2,1,1,2
14551_0,,,,2,1,1,2
C1(C(CO)C(C(C(C1)=O)=O)O)=O,,,5,1,3,0,3
14551_1,,,,2,1,1,2
14553_0,,,,2,1,1,2
C(C1(CC(C(C1CO)=O)=O)O)=O,,,5,1,5,0,5
14553_1,,,,2,1,1,2
14555_0,,,,2,1,1,2
C1(C(C(C(C(C1)=O)=O)CO)O)=O,,,5,1,3,0,3
14555_1,,,,2,1,1,2
14557_0,,,,2,1,1,2
C1(C(CC(C1CO)O)=O)=O,,,5,1,5,0,5
14557_1,,,,2,1,1,2
14559_0,,,,2,1,1,2
C(C1(C(CO)CC(C1O)=O)O)=O,,,5,1,2,0,2
14559_1,,,,2,1,1,2
14560_0,,,,2,1,1,2
14560_1,,,,2,1,1,2
14562_0,,,,2,1,1,2
C1(C(CO)C(C(C1CO)=O)O)=O,,,5,1,3,0,3
14562_1,,,,2,1,1,2
14564_0,,,,2,1,1,2
C1(CC(C(C1CO)=O)O)=O,,,5,1,4,0,4
14566_0,,,,2,1,1,2
C(C1C(CCC1O)=O)=O,,,5,1,3,0,3
14566_1,,,,2,1,1,2
14568_0,,,,2,1,1,2
C(C1C(CC(C1)=O)O)=O,,,5,1,3,0,3
14570_0,,,,2,1,1,2
C1(CC(C(C=O)(C1C=O)O)O)=O,,,5,1,5,0,5
14570_1,,,,2,1,1,2
14572_0,,,,2,1,1,2
C(C1C(CC(C(C1O)=O)O)=O)=O,,,5,1,3,0,3
14572_1,,,,2,1,1,2
14573_0,,,,2,1,1,2
14573_1,,,,2,1,1,2
14575_0,,,,2,1,1,2
C(C1C(C(CC(C1O)=O)=O)O)=O,,,5,1,3,0,3
14575_1,,,,2,1,1,2
14577_0,,,,2,1,1,2
C1(C(CC(C1C(C=O)=O)O)O)=O,,,5,1,3,0,3
14577_1,,,,2,1,1,2
14579_0,,,,2,1,1,2
C(C1(C(C(CC1C=O)=O)O)O)=O,,,5,1,2,0,2
14581_0,,,,2,1,1,2
C(CC1C(C(C(C1O)=O)O)=O)=O,,,5,1,2,0,2
14583_0,,,,2,1,1,2
C(C1C(C(C(C(C1)=O)O)=O)O)=O,,,5,1,2,0,2
14585_0,,,,2,1,1,2
C(C1C(C(C(C(C1)=O)O)O)O)=O,,,5,1,3,0,3
14585_1,,,,2,1,1,2
14587_0,,,,2,1,1,2
C1(C(C(C(C(C=O)O)C1)O)O)=O,,,5,1,2,0,2
14587_1,,,,2,1,1,2
14588_0,,,,2,1,1,2
14588_1,,,,2,1,1,2
14589_0,,,,2,1,1,2
14591_0,,,,2,1,1,2
C(C1(C(CCC(C1O)=O)=O)O)=O,,,5,1,5,0,5
14591_1,,,,2,1,1,2
14593_0,,,,2,1,1,2
C(CO)(C1CC(C(C1O)=O)=O)=O,,,5,1,2,0,2
14595_0,,,,2,1,1,2
C1(CCC(C(C(C1O)O)=O)=O)=O,,,5,1,3,0,3
14595_1,,,,2,1,1,2
14597_0,,,,2,1,1,2
C1(C(C(C(C=O)=O)(CC1)O)O)=O,,,5,1,4,0,4
14597_1,,,,2,1,1,2
14599_0,,,,2,1,1,2
C(C1(CC(CC(C1O)=O)=O)O)=O,,,5,1,7,0,7
14599_1,,,,2,1,1,2
14601_0,,,,2,1,1,2
C1(CC(C(C1C(CO)=O)O)=O)=O,,,5,1,4,0,4
14601_1,,,,2,1,1,2
14603_0,,,,2,1,1,2
C1(CC(C(C(C(C1)=O)O)O)=O)=O,,,5,1,3,0,3
14603_1,,,,2,1,1,2
14605_0,,,,2,1,1,2
C(C1C(C(C(C1CO)=O)=O)O)=O,,,5,1,2,0,2
14607_0,,,,2,1,1,2
C(C1C(C(C(C1C=O)O)=O)O)=O,,,5,1,3,0,3
14609_0,,,,2,1,1,2
C(C1C(C(C(CO)(C1)O)O)=O)=O,,,5,1,2,0,2
14609_1,,,,2,1,1,2
14611_0,,,,2,1,1,2
C(CO)(C1C(C(C(C1)=O)O)O)=O,,,5,1,4,0,4
14611_1,,,,2,1,1,2
14612_0,,,,2,1,1,2
14612_1,,,,2,1,1,2
14614_0,,,,2,1,1,2
C(C1C(C(C(C1)O)O)=O)=O,,,5,1,4,0,4
14614_1,,,,2,1,1,2
14616_0,,,,2,1,1,2
C1(CC(CC(C1)=O)O)=O,,,5,1,2,0,2
14618_0,,,,2,1,1,2
C1(C(CC(C1C)O)=O)=O,,,5,1,1,0,1
14620_0,,,,2,1,1,2
C(C1C(C(C(CO)C1O)=O)=O)=O,,,5,1,3,0,3
14620_1,,,,2,1,1,2
14622_0,,,,2,1,1,2
C1(C(C=O)C(C(C1)=O)(CO)O)=O,,,5,1,3,0,3
14622_1,,,,2,1,1,2
14624_0,,,,2,1,1,2
C1(CC(C(C(C(C1)=O)=O)O)O)=O,,,5,1,3,0,3
14624_1,,,,2,1,1,2
14626_0,,,,2,1,1,2
C(CC1(C(C(C(C1)=O)=O)O)O)=O,,,5,1,3,0,3
14626_1,,,,2,1,1,2
14628_0,,,,2,1,1,2
C(C1C(C(CC1(CO)O)=O)=O)=O,,,5,1,3,0,3
14628_1,,,,2,1,1,2
14630_0,,,,2,1,1,2
C(CO)(C1C(C(CC1O)=O)=O)=O,,,5,1,3,0,3
14630_1,,,,2,1,1,2
14632_0,,,,2,1,1,2
C1(C(C(CC(C(C1)=O)=O)O)O)=O,,,5,1,3,0,3
14632_1,,,,2,1,1,2
14634_0,,,,2,1,1,2
C(CC1(C(CC(C1O)=O)=O)O)=O,,,5,1,4,0,4
14634_1,,,,2,1,1,2
14636_0,,,,2,1,1,2
C1(C(CO)C(CC(C1O)=O)O)=O,,,5,1,4,0,4
14636_1,,,,2,1,1,2
14638_0,,,,2,1,1,2
C1(C(CC(C1C(CO)O)O)=O)=O,,,5,1,4,0,4
14638_1,,,,2,1,1,2
14640_0,,,,2,1,1,2
C(C1C(C(CC1O)=O)=O)=O,,,5,1,4,0,4
14640_1,,,,2,1,1,2
14642_0,,,,2,1,1,2
C1(CC(CC(C1O)=O)O)=O,,,5,1,2,0,2
14644_0,,,,2,1,1,2
C1(C(CC(CC1)O)=O)=O,,,5,1,2,0,2
14646_0,,,,2,1,1,2
C(C1(C(CC(C(C1)=O)=O)O)O)=O,,,5,1,2,0,2
14648_0,,,,2,1,1,2
C1(C(CC(C(CC1O)=O)=O)O)=O,,,5,1,2,0,2
14650_0,,,,2,1,1,2
C(C1(CC(C(C(C1)=O)O)=O)O)=O,,,5,1,2,0,2
14652_0,,,,2,1,1,2
C1(C(C(CC(C(C1)=O)O)=O)O)=O,,,5,1,2,0,2
14653_0,,,,2,1,1,2
14655_0,,,,2,1,1,2
C1(C(C(C(C1C(C)=O)O)=O)O)=O,,,5,1,3,0,3
14655_1,,,,2,1,1,2
14657_0,,,,2,1,1,2
C1(C(C(C(CC(C1)=O)O)=O)O)=O,,,5,1,2,0,2
14659_0,,,,2,1,1,2
C1(C(CC(C(C1)O)O)=O)=O,,,5,1,2,0,2
14660_0,,,,2,1,1,2
14661_0,,,,2,1,1,2
14663_0,,,,2,1,1,2
C1(CCC(C(C(C1O)O)O)=O)=O,,,5,1,2,0,2
14663_1,,,,2,1,1,2
14665_0,,,,2,1,1,2
C1(C(C(CC1)(C(C=O)O)O)O)=O,,,5,1,2,0,2
14665_1,,,,2,1,1,2
14667_0,,,,2,1,1,2
C1(C(CO)C(C(C(C1)=O)O)O)=O,,,5,1,5,0,5
14667_1,,,,2,1,1,2
14669_0,,,,2,1,1,2
C1(C(C(CC1)O)O)=O,,,5,1,2,0,2
14669_1,,,,2,1,1,2
14671_0,,,,2,1,1,2
C(C1(C(CC(C1O)=O)=O)O)=O,,,5,1,5,0,5
14671_1,,,,2,1,1,2
14673_0,,,,2,1,1,2
C1(C(C(C(C(C1)=O)=O)O)O)=O,,,5,1,6,0,6
14673_1,,,,2,1,1,2
14675_0,,,,2,1,1,2
C(C1(CC(C(C1O)=O)=O)O)=O,,,5,1,4,0,4
14675_1,,,,2,1,1,2
14676_0,,,,2,1,1,2
14676_1,,,,2,1,1,2
14678_0,,,,2,1,1,2
C(C(C1C(C(CC1O)=O)=O)O)=O,,,5,1,2,0,2
14680_0,,,,2,1,1,2
C(C1C(C(CC(C1O)O)=O)=O)=O,,,5,1,2,0,2
14682_0,,,,2,1,1,2
C(C1C(C(C=O)C(C1O)O)=O)=O,,,5,1,3,0,3
14682_1,,,,2,1,1,2
14684_0,,,,2,1,1,2
C1(C(C)(C(C(C1CO)=O)O)O)=O,,,5,1,4,0,4
14684_1,,,,2,1,1,2
14685_0,,,,2,1,1,2
14687_0,,,,2,1,1,2
C1(CC(C(C(C1CO)=O)O)O)=O,,,5,1,3,0,3
14687_1,,,,2,1,1,2
14688_0,,,,2,1,1,2
14690_0,,,,2,1,1,2
C(C1C(CC(C1O)O)=O)(O)=O,,,5,1,4,0,4
14691_0,,,,2,1,1,2
14692_0,,,,2,1,1,2
14694_0,,,,2,1,1,2
C1(C(C)(CC(C1C=O)=O)O)=O,,,5,1,2,0,2
14695_0,,,,2,1,1,2
14697_0,,,,2,1,1,2
C1(C(CC(C(C1CO)=O)=O)O)=O,,,5,1,2,0,2
14698_0,,,,2,1,1,2
14699_0,,,,2,1,1,2
14701_0,,,,2,1,1,2
C(C1C(CC(CC1=O)O)=O)=O,,,5,1,2,0,2
14703_0,,,,2,1,1,2
C1(C(C=O)C(C(C1CO)=O)O)=O,,,5,1,3,0,3
14703_1,,,,2,1,1,2
14705_0,,,,2,1,1,2
C1(C(C(CO)C(C1CO)O)=O)=O,,,5,1,3,0,3
14705_1,,,,2,1,1,2
14706_0,,,,2,1,1,2
14706_1,,,,2,1,1,2
14708_0,,,,2,1,1,2
C1(C(CO)(CC(C1C=O)=O)O)=O,,,5,1,2,0,2
14710_0,,,,2,1,1,2
C(C)(C1C(C(C(C1O)O)=O)=O)=O,,,5,1,3,0,3
14710_1,,,,2,1,1,2
14712_0,,,,2,1,1,2
C(C1C(C(C(C1(C)O)O)=O)=O)=O,,,5,1,3,0,3
14712_1,,,,2,1,1,2
14714_0,,,,2,1,1,2
C(C1C(CC(C1=O)O)=O)=O,,,5,1,3,0,3
14715_0,,,,2,1,1,2
14716_0,,,,2,1,1,2
14718_0,,,,2,1,1,2
C1(C(CO)(C(CC(C1)=O)O)O)=O,,,5,1,5,0,5
14720_0,,,,2,1,1,2
C1(CC(C(C1(CO)O)=O)O)=O,,,5,1,2,0,2
14721_0,,,,2,1,1,2
14723_0,,,,2,1,1,2
C(C1C(C(CC(C1)O)=O)=O)=O,,,5,1,2,0,2
14725_0,,,,2,1,1,2
C(C1C(C(C=O)C(C1)O)=O)=O,,,5,1,3,0,3
14725_1,,,,2,1,1,2
14727_0,,,,2,1,1,2
C1(CC(C(C=O)C1C=O)O)=O,,,5,1,2,0,2
14729_0,,,,2,1,1,2
C(C1C(CC(C1)O)=O)=O,,,5,1,2,0,2
14731_0,,,,2,1,1,2
C(CC1C(C(C(C1O)O)=O)=O)=O,,,5,1,3,0,3
14731_1,,,,2,1,1,2
14733_0,,,,2,1,1,2
C(C1C(C(C(C(C1)O)O)=O)=O)=O,,,5,1,3,0,3
14733_1,,,,2,1,1,2
14735_0,,,,2,1,1,2
C(C1(C(C(CO)C(C1)O)=O)O)=O,,,5,1,3,0,3
14735_1,,,,2,1,1,2
14736_0,,,,2,1,1,2
14736_1,,,,2,1,1,2
14738_0,,,,2,1,1,2
C(C1(CCC(C1O)=O)O)(O)=O,,,5,1,4,0,4
14738_1,,,,2,1,1,2
14739_0,,,,2,1,1,2
14739_1,,,,2,1,1,2
14741_0,,,,2,1,1,2
C1(C(C(C(C1O)=C)O)O)=O,,,5,1,3,0,3
14741_1,,,,2,1,1,2
14743_0,,,,2,1,1,2
C1(C(C(C=CC1O)O)O)=O,,,5,1,3,0,3
14743_1,,,,2,1,1,2
14745_0,,,,2,1,1,2
C1(C(C(C(C1O)=CCO)O)O)=O,,,5,1,3,0,3
14745_1,,,,2,1,1,2
14747_0,,,,2,1,1,2
C1(C(C(C(C=CC1O)O)O)O)=O,,,5,1,3,0,3
14747_1,,,,2,1,1,2
14749_0,,,,2,1,1,2
C1(C(C(C=CC1O)(CO)O)O)=O,,,5,1,3,0,3
14749_1,,,,2,1,1,2
14751_0,,,,2,1,1,2
C1C(C(CO)(C(C(C=1)=O)O)O)O,,,5,1,3,0,3
14751_1,,,,2,1,1,2
14753_0,,,,2,1,1,2
C1(C(C(C=C(CO)C1O)O)O)=O,,,5,1,3,0,3
14753_1,,,,2,1,1,2
14755_0,,,,2,1,1,2
C1(C(C(C(C(C1O)=C)O)O)O)=O,,,5,1,3,0,3
14755_1,,,,2,1,1,2
14757_0,,,,2,1,1,2
C1(C)C(C(C(C=1C=O)=O)O)O,,,5,1,3,0,3
14757_1,,,,2,1,1,2
14759_0,,,,2,1,1,2
C(C1C(C(C(C1=C)O)O)=O)=O,,,5,1,3,0,3
14759_1,,,,2,1,1,2
14761_0,,,,2,1,1,2
C(C1C(C(C(C1O)=C)O)=O)=O,,,5,1,3,0,3
14761_1,,,,2,1,1,2
14763_0,,,,2,1,1,2
C(C1(C=CC(C1)=O)O)=O,,,5,1,2,0,2
14765_0,,,,2,1,1,2
C1(C=CC(C(C1)O)=O)=O,,,5,1,2,0,2
14767_0,,,,2,1,1,2
C(C1C(CC(C=1)=O)O)=O,,,5,1,2,0,2
14769_0,,,,2,1,1,2
C(C1(C(C(C(C1)=O)O)=C)O)=O,,,5,1,2,0,2
14771_0,,,,2,1,1,2
C1(CC(C(C(C1O)=C)=O)O)=O,,,5,1,2,0,2
14773_0,,,,2,1,1,2
C(C1(C(CO)=CC(C1)=O)O)=O,,,5,1,2,0,2
14775_0,,,,2,1,1,2
C1(C(CO)=CC(CC1O)=O)=O,,,5,1,2,0,2
14777_0,,,,2,1,1,2
C1(CC(C=C(C=O)C1O)O)=O,,,5,1,3,0,3
14779_0,,,,2,1,1,2
C1(CC(C(C1O)=CC=O)O)=O,,,5,1,3,0,3
14781_0,,,,2,1,1,2
C1(C=C(C=O)C(C(C1)O)O)=O,,,5,1,2,0,2
14783_0,,,,2,1,1,2
C(C(C1C(CC(C=1)=O)O)O)=O,,,5,1,2,0,2
14785_0,,,,2,1,1,2
C(C1C(CC(C=1)=O)O)(CO)=O,,,5,1,2,0,2
14787_0,,,,2,1,1,2
C(C1C(CO)(CC(C=1)=O)O)=O,,,5,1,2,0,2
14789_0,,,,2,1,1,2
C1C(C)(C(C(C=1C=O)=O)O)O,,,5,1,3,0,3
14789_1,,,,2,1,1,2
14791_0,,,,2,1,1,2
C1(C=CC(C(C(C1)O)O)=O)=O,,,5,1,2,0,2
14793_0,,,,2,1,1,2
C(C(C1(C=CC(C1)=O)O)O)=O,,,5,1,2,0,2
14795_0,,,,2,1,1,2
C1C(CC(C=1)=O)O,,,5,1,2,0,2
14797_0,,,,2,1,1,2
C(C1C=CC(C1O)=O)=O,,,5,1,2,0,2
14799_0,,,,2,1,1,2
C(C1(C=CC(C1CO)=O)O)=O,,,5,1,3,0,3
14799_1,,,,2,1,1,2
14801_0,,,,2,1,1,2
C1(C=CC(C(C1CO)O)=O)=O,,,5,1,3,0,3
14801_1,,,,2,1,1,2
14803_0,,,,2,1,1,2
C(C1(C=CC(C1C=O)O)O)=O,,,5,1,6,0,6
14803_1,,,,2,1,1,2
14805_0,,,,2,1,1,2
C(C1C(C(C=CC1O)=O)O)=O,,,5,1,3,0,3
14805_1,,,,2,1,1,2
14807_0,,,,2,1,1,2
C1C(C(C=O)=O)C(C(C=1)O)O,,,5,1,2,0,2
14809_0,,,,2,1,1,2
C(C1(CC=CC(C1O)=O)O)=O,,,5,1,4,0,4
14809_1,,,,2,1,1,2
14811_0,,,,2,1,1,2
C1(C(C(C(C=CC1)=O)O)O)=O,,,5,1,5,0,5
14811_1,,,,2,1,1,2
14813_0,,,,2,1,1,2
C(C1(C=CCC(C1O)=O)O)=O,,,5,1,4,0,4
14813_1,,,,2,1,1,2
14815_0,,,,2,1,1,2
C(CO)(C1C=CC(C1O)=O)=O,,,5,1,2,0,2
14816_0,,,,2,1,1,2
14816_1,,,,2,1,1,2
14818_0,,,,2,1,1,2
C(C1C(CO)=CC(C1O)=O)=O,,,5,1,2,0,2
14820_0,,,,2,1,1,2
C(C1(C=CC(C(C1)=O)O)O)=O,,,5,1,2,0,2
14822_0,,,,2,1,1,2
C1(CC(C(C=CC1O)=O)O)=O,,,5,1,2,0,2
14824_0,,,,2,1,1,2
C(C1(C=CC(C1O)=O)O)=O,,,5,1,4,0,4
14824_1,,,,2,1,1,2
14826_0,,,,2,1,1,2
C1(C=CC(C(C1O)O)=O)=O,,,5,1,3,0,3
14826_1,,,,2,1,1,2
14828_0,,,,2,1,1,2
C(C1C(C(C(C1O)=O)=C)O)=O,,,5,1,3,0,3
14828_1,,,,2,1,1,2
14830_0,,,,2,1,1,2
C(C1C=C(C(C1O)=O)CO)=O,,,5,1,2,0,2
14832_0,,,,2,1,1,2
C(C1C(C(C=O)=CC1O)O)=O,,,5,1,6,0,6
14832_1,,,,2,1,1,2
14834_0,,,,2,1,1,2
C(C1C=C(C=O)C(C1O)O)=O,,,5,1,2,0,2
14836_0,,,,2,1,1,2
C1CC(C(C(C=1C=O)=O)O)O,,,5,1,3,0,3
14836_1,,,,2,1,1,2
14838_0,,,,2,1,1,2
C(C1C(C(C(C=C1)O)O)=O)=O,,,5,1,3,0,3
14838_1,,,,2,1,1,2
14840_0,,,,2,1,1,2
C(C1C(C(C=CC1O)O)=O)=O,,,5,1,3,0,3
14840_1,,,,2,1,1,2
14842_0,,,,2,1,1,2
C(C1C=CC(C(C1O)O)=O)=O,,,5,1,4,0,4
14844_0,,,,2,1,1,2
C1(C=C(C=O)C(C1CO)O)=O,,,5,1,3,0,3
14844_1,,,,2,1,1,2
14845_0,,,,2,1,1,2
14845_1,,,,2,1,1,2
14846_0,,,,2,1,1,2
14846_1,,,,2,1,1,2
14848_0,,,,2,1,1,2
C1(C(C(C(C=O)=CC1)O)O)=O,,,5,1,3,0,3
14848_1,,,,2,1,1,2
14850_0,,,,2,1,1,2
C1(CC(C(C=O)=CC1O)O)=O,,,5,1,2,0,2
14852_0,,,,2,1,1,2
C(C1C(C(C(C=1)=O)O)O)=O,,,5,1,4,0,4
14852_1,,,,2,1,1,2
14854_0,,,,2,1,1,2
C1C(C(C(C=1)=O)CO)O,,,5,1,3,0,3
14854_1,,,,2,1,1,2
14856_0,,,,2,1,1,2
C(C1(C(CO)=CC(C1O)=O)O)=O,,,5,1,3,0,3
14856_1,,,,2,1,1,2
14858_0,,,,2,1,1,2
C1(C(CO)=CC(C(C1O)O)=O)=O,,,5,1,3,0,3
14858_1,,,,2,1,1,2
14860_0,,,,2,1,1,2
C(C1(C(C(C(C1O)=O)O)=C)O)=O,,,5,1,5,0,5
14860_1,,,,2,1,1,2
14862_0,,,,2,1,1,2
C1(C(C(C(C(C1O)=C)=O)O)O)=O,,,5,1,3,0,3
14862_1,,,,2,1,1,2
14864_0,,,,2,1,1,2
C(C1C=CC(C1O)O)=O,,,5,1,2,0,2
14866_0,,,,2,1,1,2
C(C1C(C(C(C(C=1)=O)O)O)O)=O,,,5,1,4,0,4
14866_1,,,,2,1,1,2
14868_0,,,,2,1,1,2
C(C(C1C(C(C(C=1)=O)O)O)O)=O,,,5,1,3,0,3
14868_1,,,,2,1,1,2
14870_0,,,,2,1,1,2
C1(C(C(C=C(C=O)C1O)O)O)=O,,,5,1,4,0,4
14870_1,,,,2,1,1,2
14872_0,,,,2,1,1,2
C1(C(C(C(C1O)=CC=O)O)O)=O,,,5,1,4,0,4
14872_1,,,,2,1,1,2
14874_0,,,,2,1,1,2
C1(C(C(C=CC1)O)O)=O,,,5,1,3,0,3
14874_1,,,,2,1,1,2
14876_0,,,,2,1,1,2
C1CC(C(C(C=1)=O)O)O,,,5,1,3,0,3
14876_1,,,,2,1,1,2
14878_0,,,,2,1,1,2
C(C1(C(C(C=CC1O)=O)O)O)=O,,,5,1,5,0,5
14878_1,,,,2,1,1,2
14880_0,,,,2,1,1,2
C1(C(C(C(C=CC1O)=O)O)O)=O,,,5,1,3,0,3
14880_1,,,,2,1,1,2
14882_0,,,,2,1,1,2
C1C(C(C(C(C=1)=O)O)O)O,,,5,1,3,0,3
14882_1,,,,2,1,1,2
14884_0,,,,2,1,1,2
C1(CO)C(C(C(C=1C=O)=O)O)O,,,5,1,3,0,3
14884_1,,,,2,1,1,2
14886_0,,,,2,1,1,2
C1C(CO)(C(C(C=1C=O)=O)O)O,,,5,1,3,0,3
14886_1,,,,2,1,1,2
14888_0,,,,2,1,1,2
C(C1C(C(C(C=1)=O)O)O)(CO)=O,,,5,1,4,0,4
14888_1,,,,2,1,1,2
14890_0,,,,2,1,1,2
C(C1C(CO)(C(C(C=1)=O)O)O)=O,,,5,1,4,0,4
14890_1,,,,2,1,1,2
14892_0,,,,2,1,1,2
C1C(C(C(C=1C=O)=O)O)O,,,5,1,3,0,3
14892_1,,,,2,1,1,2
14894_0,,,,2,1,1,2
C1(CC(C=CC1O)O)=O,,,5,1,2,0,2
14896_0,,,,2,1,1,2
C1(C=CC(C(C(C1O)O)O)=O)=O,,,5,1,3,0,3
14896_1,,,,2,1,1,2
14898_0,,,,2,1,1,2
C(C(C1(C=CC(C1O)=O)O)O)=O,,,5,1,4,0,4
14898_1,,,,2,1,1,2
14900_0,,,,2,1,1,2
C1C(C(C(C=1)=O)O)O,,,5,1,4,0,4
14900_1,,,,2,1,1,2
14902_0,,,,2,1,1,2
C1(C(C(C(C1(CO)O)=C)O)O)=O,,,5,1,3,0,3
14902_1,,,,2,1,1,2
14904_0,,,,2,1,1,2
C1(C(C(C=CC1(CO)O)O)O)=O,,,5,1,3,0,3
14904_1,,,,2,1,1,2
14906_0,,,,2,1,1,2
C(C1(C(CC(C1=C)O)=O)O)=O,,,5,1,2,0,2
14908_0,,,,2,1,1,2
C(C1(C(CC(C=C1)O)=O)O)=O,,,5,1,2,0,2
14910_0,,,,2,1,1,2
C1C(CO)(C(C(C(C=1)=O)O)O)O,,,5,1,3,0,3
14910_1,,,,2,1,1,2
14911_0,,,,2,1,1,2
14911_1,,,,2,1,1,2
14913_0,,,,2,1,1,2
C1(CO)C(C(C(C=1)=O)O)O,,,5,1,3,0,3
14913_1,,,,2,1,1,2
14915_0,,,,2,1,1,2
C1(C(O)OC2C(C(C(C12)O)O)O)=O,,,5,1,3,0,3
14915_1,,,,2,1,1,2
14917_0,,,,2,1,1,2
C1(C2CC(C(O2)O)(C1)O)=O,,,5,1,3,0,3
14919_0,,,,2,1,1,2
C1(C2C(CO)C(C(O2)O)(C1)O)=O,,,5,1,3,0,3
14921_0,,,,2,1,1,2
C1(C2C(C(C1)O)C(C(O2)O)O)=O,,,5,1,2,0,2
14923_0,,,,2,1,1,2
C1(C2C(C(C(O2)O)(C1)O)O)=O,,,5,1,3,0,3
14925_0,,,,2,1,1,2
C1(C2CC(C(O2)O)(C1CO)O)=O,,,5,1,4,0,4
14925_1,,,,2,1,1,2
14927_0,,,,2,1,1,2
C(C1C2C(CC(C1O)(O)O2)O)=O,,,5,1,3,0,3
14927_1,,,,2,1,1,2
14929_0,,,,2,1,1,2
C1(C(O)OC2C(CC(C12)O)O)=O,,,5,1,3,0,3
14929_1,,,,2,1,1,2
14931_0,,,,2,1,1,2
C(C1C(C2CC1(C(O)O2)O)O)=O,,,5,1,4,0,4
14931_1,,,,2,1,1,2
14933_0,,,,2,1,1,2
C1(C(O)OC2CC(C(C12)O)O)=O,,,5,1,3,0,3
14933_1,,,,2,1,1,2
14935_0,,,,2,1,1,2
C1(C(C2(C(O)OC(C2)C1)O)O)=O,,,5,1,4,0,4
14935_1,,,,2,1,1,2
14937_0,,,,2,1,1,2
C(C1C(C2(CC1(CO2)O)O)O)=O,,,5,1,4,0,4
14937_1,,,,2,1,1,2
14939_0,,,,2,1,1,2
C1(C2C(CC(C(C1)O)(O2)O)O)=O,,,5,1,3,0,3
14941_0,,,,2,1,1,2
C1(C(C2CC(C(O)O2)(C1)O)O)=O,,,5,1,3,0,3
14943_0,,,,2,1,1,2
C1(C2CC(C(O2)O)(C1O)O)=O,,,5,1,4,0,4
14943_1,,,,2,1,1,2
14945_0,,,,2,1,1,2
C(C1C2C(C(C(O)O2)C1O)O)=O,,,5,1,4,0,4
14945_1,,,,2,1,1,2
14947_0,,,,2,1,1,2
C1(C2C(C(C(C1)O)C(O2)O)O)=O,,,5,1,5,0,5
14949_0,,,,2,1,1,2
C1(C2C(C(C(O2)O)(C1CO)O)O)=O,,,5,1,4,0,4
14949_1,,,,2,1,1,2
14951_0,,,,2,1,1,2
C1(C2C(CO)C(C(O2)O)(C1O)O)=O,,,5,1,4,0,4
14951_1,,,,2,1,1,2
14953_0,,,,2,1,1,2
C(C1C(C2C(C1(C(O)O2)O)O)O)=O,,,5,1,4,0,4
14953_1,,,,2,1,1,2
14955_0,,,,2,1,1,2
C(C1C2C(C(C(C1O)(O)O2)O)O)=O,,,5,1,3,0,3
14955_1,,,,2,1,1,2
14957_0,,,,2,1,1,2
C1(C2C(C(C1O)O)C(C(O2)O)O)=O,,,5,1,3,0,3
14957_1,,,,2,1,1,2
14959_0,,,,2,1,1,2
C1(C(C2(C(O)OC(C2O)C1)O)O)=O,,,5,1,4,0,4
14959_1,,,,2,1,1,2
14961_0,,,,2,1,1,2
C(C1C(C2(C(C1(CO2)O)O)O)O)=O,,,5,1,4,0,4
14961_1,,,,2,1,1,2
14963_0,,,,2,1,1,2
C1(C(C(C2(COC(C12)O)O)O)O)=O,,,5,1,3,0,3
14963_1,,,,2,1,1,2
14965_0,,,,2,1,1,2
C(C1C(C2(COC1(C2O)O)O)O)=O,,,5,1,4,0,4
14965_1,,,,2,1,1,2
14967_0,,,,2,1,1,2
C1(C(C2C(C(C(O)O2)(C1)O)O)O)=O,,,5,1,3,0,3
14969_0,,,,2,1,1,2
C1(C2C(C(C(C(C1)O)(O2)O)O)O)=O,,,5,1,3,0,3
14971_0,,,,2,1,1,2
C1(C2C(C(C(O2)O)(C1O)O)O)=O,,,5,1,4,0,4
14971_1,,,,2,1,1,2
14973_0,,,,2,1,1,2
C1(C2C(C(C1)O)(C(C(O2)O)O)O)=O,,,5,1,2,0,2
14975_0,,,,2,1,1,2
C1(C2C(CO)(C(C(O2)O)(C1)O)O)=O,,,5,1,3,0,3
14977_0,,,,2,1,1,2
C1(CC(C2(COC(C12O)O)O)O)=O,,,5,1,2,0,2
14979_0,,,,2,1,1,2
C1(C2C(C(C1)O)(CC(O2)O)O)=O,,,5,1,2,0,2
14981_0,,,,2,1,1,2
C1(C2C(C(C1O)O)(CC(O2)O)O)=O,,,5,1,3,0,3
14981_1,,,,2,1,1,2
14983_0,,,,2,1,1,2
C1(C(O)OC2C(C1C(C2O)O)O)=O,,,5,1,6,0,6
14983_1,,,,2,1,1,2
14985_0,,,,2,1,1,2
C1(C(C2(C)C(C1C(O)O2)O)O)=O,,,5,1,4,0,4
14985_1,,,,2,1,1,2
14987_0,,,,2,1,1,2
C1(C2C(C(CC(O2)O)(C1)O)O)=O,,,5,1,3,0,3
14989_0,,,,2,1,1,2
C1(C(C2C(C)(C1C(O)O2)O)O)=O,,,5,1,4,0,4
14989_1,,,,2,1,1,2
14991_0,,,,2,1,1,2
C1(C2CC(C(C(O2)O)O)(C1)O)=O,,,5,1,3,0,3
14993_0,,,,2,1,1,2
C1(C(O)OC2C(C1C(C2)O)O)=O,,,5,1,6,0,6
14993_1,,,,2,1,1,2
14995_0,,,,2,1,1,2
C(C1C2C(CC1(C(O)O2)O)O)=O,,,5,1,4,0,4
14995_1,,,,2,1,1,2
14997_0,,,,2,1,1,2
C1(C2C(CC(C(O2)O)(C1)O)O)=O,,,5,1,2,0,2
14999_0,,,,2,1,1,2
C1(C(C2CC(C1C(O)O2)O)O)=O,,,5,1,3,0,3
14999_1,,,,2,1,1,2
15001_0,,,,2,1,1,2
C1(C2C(C(C(O2)O)C1O)O)=O,,,5,1,4,0,4
15001_1,,,,2,1,1,2
15003_0,,,,2,1,1,2
C(C1C2C(C(C1(C(O)O2)O)O)O)=O,,,5,1,4,0,4
15003_1,,,,2,1,1,2
15005_0,,,,2,1,1,2
C1(C2C(C(C(C(O2)O)C1O)O)O)=O,,,5,1,3,0,3
15005_1,,,,2,1,1,2
15007_0,,,,2,1,1,2
C1(C(C2(COC(C1C2O)O)O)O)=O,,,5,1,6,0,6
15007_1,,,,2,1,1,2
15009_0,,,,2,1,1,2
C1(C2C(CO)(C(C(O2)O)C1O)O)=O,,,5,1,4,0,4
15009_1,,,,2,1,1,2
15011_0,,,,2,1,1,2
C1(C2C(C(C(CO)(O2)O)C1O)O)=O,,,5,1,4,0,4
15011_1,,,,2,1,1,2
15013_0,,,,2,1,1,2
C1(C(C2(CO)C(C1C(O)O2)O)O)=O,,,5,1,4,0,4
15013_1,,,,2,1,1,2
15015_0,,,,2,1,1,2
C(C1C2(C(C(C1(CO2)O)O)O)O)=O,,,5,1,4,0,4
15015_1,,,,2,1,1,2
15017_0,,,,2,1,1,2
C1(C2C(CC(C(C1O)O)(O2)O)O)=O,,,5,1,4,0,4
15017_1,,,,2,1,1,2
15019_0,,,,2,1,1,2
C1(C(C2C(CO)(C1C(O)O2)O)O)=O,,,5,1,4,0,4
15019_1,,,,2,1,1,2
15021_0,,,,2,1,1,2
C1(C2C(C(CC(O2)O)(C1O)O)O)=O,,,5,1,6,0,6
15021_1,,,,2,1,1,2
15023_0,,,,2,1,1,2
C1(C(C2C(C1C(O)O2)O)O)=O,,,5,1,4,0,4
15023_1,,,,2,1,1,2
15025_0,,,,2,1,1,2
C1(C2C(C(C(C(O2)O)(C1)O)O)O)=O,,,5,1,2,0,2
15027_0,,,,2,1,1,2
C1(C2C(C(C(CC1O)(O2)O)O)O)=O,,,5,1,4,0,4
15027_1,,,,2,1,1,2
15029_0,,,,2,1,1,2
C1(C2CC(C(C(O2)O)O)(C1O)O)=O,,,5,1,4,0,4
15029_1,,,,2,1,1,2
15031_0,,,,2,1,1,2
C1(CC2(COC(C1(C2O)O)O)O)=O,,,5,1,5,0,5
15033_0,,,,2,1,1,2
C1(C2C(C)(C(C(O2)O)(C1O)O)O)=O,,,5,1,4,0,4
15033_1,,,,2,1,1,2
15035_0,,,,2,1,1,2
C1(C2C(C(C(C)(O2)O)(C1O)O)O)=O,,,5,1,4,0,4
15035_1,,,,2,1,1,2
15037_0,,,,2,1,1,2
C1(C2C(CC(C(O2)O)(C1O)O)O)=O,,,5,1,3,0,3
15037_1,,,,2,1,1,2
15038_0,,,,2,1,1,2
15038_1,,,,2,1,1,2
15040_0,,,,2,1,1,2
C1(C(CC2(C(C1CO2)O)O)O)=O,,,5,1,4,0,4
15040_1,,,,2,1,1,2
15041_0,,,,2,1,1,2
15041_1,,,,2,1,1,2
15043_0,,,,2,1,1,2
C1(COC2(C(C1C(C2)O)O)O)=O,,,5,1,4,0,4
15043_1,,,,2,1,1,2
15045_0,,,,2,1,1,2
C1(C(C2C(O)OCC1C2O)O)=O,,,5,1,4,0,4
15045_1,,,,2,1,1,2
15046_0,,,,2,1,1,2
15046_1,,,,2,1,1,2
15048_0,,,,2,1,1,2
C1(C(C(C2(C(C1CO2)O)O)O)O)=O,,,5,1,4,0,4
15048_1,,,,2,1,1,2
15050_0,,,,2,1,1,2
C1(C2C(C(C(C(O2)O)O)C1O)O)=O,,,5,1,4,0,4
15050_1,,,,2,1,1,2
15052_0,,,,2,1,1,2
C1(COC2(C(C1C(C2O)O)O)O)=O,,,5,1,4,0,4
15052_1,,,,2,1,1,2
15053_0,,,,2,1,1,2
15053_1,,,,2,1,1,2
15054_0,,,,2,1,1,2
15054_1,,,,2,1,1,2
15056_0,,,,2,1,1,2
C(CCC1C(CC(C1O)=O)O)(O)=O,,,5,1,2,0,2
15058_0,,,,2,1,1,2
C1(CC(CC1(CCC(O)=O)O)O)=O,,,5,1,2,0,2
15060_0,,,,2,1,1,2
C(CCC1C(C(CC1O)O)=O)(O)=O,,,5,1,2,0,2
15062_0,,,,2,1,1,2
C(C1C(C(C(C=O)=O)CC1O)O)=O,,,5,1,1,0,1
15064_0,,,,2,1,1,2
C(C1C(C(C=O)C(C=O)C1O)O)=O,,,5,1,1,0,1
15066_0,,,,2,1,1,2
C(C1C(C)(CCC1(C=O)O)O)=O,,,5,1,2,0,2
15066_1,,,,2,1,1,2
15068_0,,,,2,1,1,2
C(C1C(CCC(C1O)=O)(C)O)=O,,,5,1,3,0,3
15068_1,,,,2,1,1,2
15070_0,,,,2,1,1,2
C(C(C1CC(C)(CC1O)O)=O)=O,,,5,1,1,0,1
15072_0,,,,2,1,1,2
C(C1CC(C(C=O)C1(C)O)O)=O,,,5,1,2,0,2
15072_1,,,,2,1,1,2
15074_0,,,,2,1,1,2
C(C1C(C)(CC(C1C=O)O)O)=O,,,5,1,1,0,1
15076_0,,,,2,1,1,2
C(C1C(CCCC1(C=O)O)O)=O,,,5,1,2,0,2
15076_1,,,,2,1,1,2
15078_0,,,,2,1,1,2
C(C1C(CCCC(C1O)=O)O)=O,,,5,1,3,0,3
15078_1,,,,2,1,1,2
15080_0,,,,2,1,1,2
C(C(C1CCC(CC1O)O)=O)=O,,,5,1,1,0,1
15082_0,,,,2,1,1,2
C(C1C(C(CC1O)CC=O)O)=O,,,5,1,3,0,3
15082_1,,,,2,1,1,2
15084_0,,,,2,1,1,2
C(C1CC(C(C=O)C(C1)O)O)=O,,,5,1,2,0,2
15084_1,,,,2,1,1,2
15086_0,,,,2,1,1,2
C(C1CC(CC(C1C=O)O)O)=O,,,5,1,1,0,1
15088_0,,,,2,1,1,2
C(C(C1CC(C)(C(C1O)O)O)=O)=O,,,5,1,1,0,1
15090_0,,,,2,1,1,2
C(C1C(C)(C(C(C1C=O)O)O)O)=O,,,5,1,2,0,2
15092_0,,,,2,1,1,2
C(C(C1CCC(C(C1O)O)O)=O)=O,,,5,1,1,0,1
15094_0,,,,2,1,1,2
C(C1CC(C(C(C1C=O)O)O)O)=O,,,5,1,1,0,1
15096_0,,,,2,1,1,2
C(C1C(CCC1(C=O)O)O)=O,,,5,1,2,0,2
15096_1,,,,2,1,1,2
15098_0,,,,2,1,1,2
C(C1C(CCC(C1O)=O)O)=O,,,5,1,3,0,3
15098_1,,,,2,1,1,2
15100_0,,,,2,1,1,2
C(C(C1CC(CC1O)O)=O)=O,,,5,1,1,0,1
15102_0,,,,2,1,1,2
C(C1C(C(C=O)C(C1)O)O)=O,,,5,1,2,0,2
15102_1,,,,2,1,1,2
15104_0,,,,2,1,1,2
C(C1C(CC(C1C=O)O)O)=O,,,5,1,1,0,1
15106_0,,,,2,1,1,2
C(C1C(C(CCC1(C=O)O)O)O)=O,,,5,1,2,0,2
15106_1,,,,2,1,1,2
15108_0,,,,2,1,1,2
C(C1C(C(CCC(C1O)=O)O)O)=O,,,5,1,3,0,3
15108_1,,,,2,1,1,2
15110_0,,,,2,1,1,2
C(C(C1CC(C(CC1O)O)O)=O)=O,,,5,1,1,0,1
15112_0,,,,2,1,1,2
C(C1C(C(C(C1O)CC=O)O)O)=O,,,5,1,3,0,3
15112_1,,,,2,1,1,2
15114_0,,,,2,1,1,2
C(C1C(C(C(C=O)CC1O)O)O)=O,,,5,1,2,0,2
15114_1,,,,2,1,1,2
15116_0,,,,2,1,1,2
C(C1C(C(CC(C1C=O)O)O)O)=O,,,5,1,2,0,2
15118_0,,,,2,1,1,2
C(C1C(CO)(CCC1(C=O)O)O)=O,,,5,1,2,0,2
15118_1,,,,2,1,1,2
15120_0,,,,2,1,1,2
C(C1C(CCC(C1O)=O)(CO)O)=O,,,5,1,3,0,3
15120_1,,,,2,1,1,2
15122_0,,,,2,1,1,2
C(C(C1CC(CO)(CC1O)O)=O)=O,,,5,1,1,0,1
15124_0,,,,2,1,1,2
C(C1C(CC(C=O)C1(CO)O)O)=O,,,5,1,2,0,2
15124_1,,,,2,1,1,2
15126_0,,,,2,1,1,2
C(C1C(CC(CO)(C1C=O)O)O)=O,,,5,1,2,0,2
15128_0,,,,2,1,1,2
C(C1(CCC(C(C(C1)=O)=O)O)O)=O,,,5,1,1,0,1
15130_0,,,,2,1,1,2
C1(C(CC(C(C(CC1)O)=O)=O)O)=O,,,5,1,2,0,2
15132_0,,,,2,1,1,2
C1(C(C)(C(C(C=O)=O)CC1O)O)=O,,,5,1,1,0,1
15134_0,,,,2,1,1,2
C(CC1C(CC(C(C1O)=O)=O)O)=O,,,5,1,2,0,2
15136_0,,,,2,1,1,2
C(C1CC(CC(C(C1O)=O)=O)O)=O,,,5,1,1,0,1
15138_0,,,,2,1,1,2
C1(C(C(C=O)C(C=O)C1(C)O)O)=O,,,5,1,2,0,2
15140_0,,,,2,1,1,2
C(C1(CCCC(C(C1O)=O)=O)O)=O,,,5,1,2,0,2
15140_1,,,,2,1,1,2
15142_0,,,,2,1,1,2
C1(C(C(C(C(CCC1)=O)=O)O)O)=O,,,5,1,3,0,3
15142_1,,,,2,1,1,2
15144_0,,,,2,1,1,2
C1(C(C(C(C(CO)=O)=O)CC1)O)=O,,,5,1,2,0,2
15146_0,,,,2,1,1,2
C1(C(CO)(C(C(C=O)=O)CC1)O)=O,,,5,1,1,0,1
15148_0,,,,2,1,1,2
C(CC1C(C(C(C(C1)=O)=O)O)O)=O,,,5,1,3,0,3
15148_1,,,,2,1,1,2
15150_0,,,,2,1,1,2
C(C1CC(C(C(C(C1)=O)=O)O)O)=O,,,5,1,2,0,2
15150_1,,,,2,1,1,2
15152_0,,,,2,1,1,2
C1(CC(C=O)C(C=O)C1(CO)O)=O,,,5,1,1,0,1
15154_0,,,,2,1,1,2
C(C1(C(CCC1C(C=O)=O)O)O)=O,,,5,1,1,0,1
15156_0,,,,2,1,1,2
C1(C(C(C(C=O)=O)CCC1O)O)=O,,,5,1,1,0,1
15158_0,,,,2,1,1,2
C(C1CC(C(C=O)(C1C=O)O)O)=O,,,5,1,2,0,2
15160_0,,,,2,1,1,2
C1(C(C(C=O)C(C=O)CC1O)O)=O,,,5,1,1,0,1
15162_0,,,,2,1,1,2
C1(C(C(C(C=O)=O)CC1(C)O)O)=O,,,5,1,1,0,1
15163_0,,,,2,1,1,2
15165_0,,,,2,1,1,2
C(C1(CCC(C(C1)=O)O)O)=O,,,5,1,1,0,1
15167_0,,,,2,1,1,2
C1(CC(C(CCC1O)=O)O)=O,,,5,1,2,0,2
15169_0,,,,2,1,1,2
C(CC1C(CC(C1O)=O)O)=O,,,5,1,2,0,2
15171_0,,,,2,1,1,2
C(C1CC(CC(C1O)=O)O)=O,,,5,1,1,0,1
15173_0,,,,2,1,1,2
C(C1(CCCC(C1O)=O)O)=O,,,5,1,4,0,4
15173_1,,,,2,1,1,2
15175_0,,,,2,1,1,2
C1(C(C(C(CCC1)=O)O)O)=O,,,5,1,3,0,3
15175_1,,,,2,1,1,2
15177_0,,,,2,1,1,2
C(CO)(C1CCC(C1O)=O)=O,,,5,1,2,0,2
15179_0,,,,2,1,1,2
C(CC1C(C(C(C1)=O)O)O)=O,,,5,1,3,0,3
15179_1,,,,2,1,1,2
15181_0,,,,2,1,1,2
C(C1CC(C(C(C1)=O)O)O)=O,,,5,1,2,0,2
15181_1,,,,2,1,1,2
15183_0,,,,2,1,1,2
C1(C(CO)C(C=O)(CCC1O)O)=O,,,5,1,2,0,2
15183_1,,,,2,1,1,2
15185_0,,,,2,1,1,2
C1(C(CO)C(C(CCC1O)=O)O)=O,,,5,1,3,0,3
15185_1,,,,2,1,1,2
15187_0,,,,2,1,1,2
C(CC1C(C(C(C1O)=O)CO)O)=O,,,5,1,3,0,3
15187_1,,,,2,1,1,2
15189_0,,,,2,1,1,2
C(C1CC(C(C(C1O)=O)CO)O)=O,,,5,1,2,0,2
15189_1,,,,2,1,1,2
15191_0,,,,2,1,1,2
C(C1(CCC(CC(C1O)=O)O)O)=O,,,5,1,2,0,2
15191_1,,,,2,1,1,2
15193_0,,,,2,1,1,2
C(C1(CCC(C1C(CO)=O)O)O)=O,,,5,1,2,0,2
15193_1,,,,2,1,1,2
15195_0,,,,2,1,1,2
C1(C(C(C(CCC(C1)O)=O)O)O)=O,,,5,1,3,0,3
15195_1,,,,2,1,1,2
15197_0,,,,2,1,1,2
C(CO)(C1C(CCC(C1O)=O)O)=O,,,5,1,3,0,3
15197_1,,,,2,1,1,2
15199_0,,,,2,1,1,2
C(C(C1CC(CC1(CO)O)O)=O)=O,,,5,1,1,0,1
15201_0,,,,2,1,1,2
C(CC1C(CC(C(C1O)O)=O)O)=O,,,5,1,5,0,5
15201_1,,,,2,1,1,2
15203_0,,,,2,1,1,2
C(C1C(CC(C(C(C1)O)O)=O)O)=O,,,5,1,2,0,2
15203_1,,,,2,1,1,2
15205_0,,,,2,1,1,2
C(C1C(C(C(CO)=O)C(C1)O)O)=O,,,5,1,2,0,2
15205_1,,,,2,1,1,2
15206_0,,,,2,1,1,2
15208_0,,,,2,1,1,2
C(C1(CCC(C(C1O)=O)CO)O)=O,,,5,1,2,0,2
15208_1,,,,2,1,1,2
15210_0,,,,2,1,1,2
C1(C(C(C(CCC1CO)=O)O)O)=O,,,5,1,3,0,3
15210_1,,,,2,1,1,2
15212_0,,,,2,1,1,2
C(CC1C(C(C(C1CO)=O)O)O)=O,,,5,1,3,0,3
15212_1,,,,2,1,1,2
15214_0,,,,2,1,1,2
C1(C(CO)C(C=O)CC(C1O)O)=O,,,5,1,2,0,2
15214_1,,,,2,1,1,2
15216_0,,,,2,1,1,2
C(C(C1CC(CC(C1O)O)O)=O)=O,,,5,1,1,0,1
15217_0,,,,2,1,1,2
15219_0,,,,2,1,1,2
C(C(C1CC(CO)C(C1O)O)=O)=O,,,5,1,1,0,1
15221_0,,,,2,1,1,2
C(C1C(C(C(CO)C1C=O)O)O)=O,,,5,1,1,0,1
15223_0,,,,2,1,1,2
C(C1(CCC(C(C1)=O)(CO)O)O)=O,,,5,1,1,0,1
15225_0,,,,2,1,1,2
C1(CC(C(CCC1(CO)O)=O)O)=O,,,5,1,2,0,2
15227_0,,,,2,1,1,2
C1(CC(C(CC=O)C1(CO)O)O)=O,,,5,1,2,0,2
15229_0,,,,2,1,1,2
C(C1CC(CC(C1(CO)O)=O)O)=O,,,5,1,1,0,1
15231_0,,,,2,1,1,2
C(C1(CCC(C(C(C1)=O)O)O)O)=O,,,5,1,1,0,1
15233_0,,,,2,1,1,2
C1(CC(C(CCC(C1O)O)=O)O)=O,,,5,1,2,0,2
15235_0,,,,2,1,1,2
C(C(C1CC(C(C1(C)O)O)O)=O)=O,,,5,1,1,0,1
15236_0,,,,2,1,1,2
15238_0,,,,2,1,1,2
C(C1C(C(C(CC(C1)O)=O)O)O)=O,,,5,1,1,0,1
15239_0,,,,2,1,1,2
15241_0,,,,2,1,1,2
C(C1CCC(C1O)=O)(C(CO)O)=O,,,5,1,2,0,2
15243_0,,,,2,1,1,2
C1(C(C(C(C(O)=O)=O)CC1)O)=O,,,5,1,2,0,2
15245_0,,,,2,1,1,2
C(C1C(C(C(C(C=O)=O)C1)O)=O)=O,,,5,1,1,0,1
15247_0,,,,2,1,1,2
C(C1C(C(C(C=O)C1C=O)O)=O)=O,,,5,1,1,0,1
15249_0,,,,2,1,1,2
C(C1(CCC2C(C(C1O2)=O)O)O)=O,,,5,1,2,0,2
15249_1,,,,2,1,1,2
15251_0,,,,2,1,1,2
C1(C(C2C(C(C(CC1)O2)O)=O)O)=O,,,5,1,3,0,3
15251_1,,,,2,1,1,2
15253_0,,,,2,1,1,2
C(C(C1CC2C(C1(CO2)O)O)=O)=O,,,5,1,1,0,1
15255_0,,,,2,1,1,2
C(CC1C2C(C(C(C1O)O2)=O)O)=O,,,5,1,3,0,3
15255_1,,,,2,1,1,2
15257_0,,,,2,1,1,2
C(C1C2C(C(C(C(C1)O)O2)=O)O)=O,,,5,1,2,0,2
15257_1,,,,2,1,1,2
15259_0,,,,2,1,1,2
C(C1C2(COC(C2O)C1C=O)O)=O,,,5,1,1,0,1
15261_0,,,,2,1,1,2
C(C1(CCC2(C(C1OC2)=O)O)O)=O,,,5,1,2,0,2
15261_1,,,,2,1,1,2
15263_0,,,,2,1,1,2
C1(C(C2C(C(CO2)(CC1)O)=O)O)=O,,,5,1,3,0,3
15263_1,,,,2,1,1,2
15265_0,,,,2,1,1,2
C(CC1C(C2C(C1(CO2)O)=O)O)=O,,,5,1,3,0,3
15265_1,,,,2,1,1,2
15267_0,,,,2,1,1,2
C(C1CC(C2C(C1(CO2)O)=O)O)=O,,,5,1,2,0,2
15267_1,,,,2,1,1,2
15269_0,,,,2,1,1,2
C1(C2(CCC(C=O)(C1CO2)O)O)=O,,,5,1,2,0,2
15269_1,,,,2,1,1,2
15271_0,,,,2,1,1,2
C1(C2(CCC(C(C1CO2)O)=O)O)=O,,,5,1,3,0,3
15271_1,,,,2,1,1,2
15273_0,,,,2,1,1,2
C(CC1C(C2C(C1(O)OC2)=O)O)=O,,,5,1,3,0,3
15273_1,,,,2,1,1,2
15275_0,,,,2,1,1,2
C(C1CC(C2C(C1(O)OC2)=O)O)=O,,,5,1,2,0,2
15275_1,,,,2,1,1,2
15277_0,,,,2,1,1,2
C(C1(CCC2C1C(C(O)O2)=O)O)=O,,,5,1,2,0,2
15277_1,,,,2,1,1,2
15279_0,,,,2,1,1,2
C1(C(C2C(C(O)OC2CC1)=O)O)=O,,,5,1,3,0,3
15279_1,,,,2,1,1,2
15281_0,,,,2,1,1,2
C(C(C1CC2CC1(C(O)O2)O)=O)=O,,,5,1,1,0,1
15283_0,,,,2,1,1,2
C(C1C2C(C(C(O)O2)=O)C(C1)O)=O,,,5,1,2,0,2
15283_1,,,,2,1,1,2
15285_0,,,,2,1,1,2
C(C1C2CC(C(O)O2)(C1C=O)O)=O,,,5,1,1,0,1
15287_0,,,,2,1,1,2
C(C1(CCC2C(C1OC2O)=O)O)=O,,,5,1,2,0,2
15287_1,,,,2,1,1,2
15289_0,,,,2,1,1,2
C1(C(C2C(C(C(O2)O)CC1)=O)O)=O,,,5,1,3,0,3
15289_1,,,,2,1,1,2
15291_0,,,,2,1,1,2
C(CC1C(C2C(C1C(O2)O)=O)O)=O,,,5,1,3,0,3
15291_1,,,,2,1,1,2
15293_0,,,,2,1,1,2
C1(C2C(OC1C(CC2C=O)O)O)=O,,,5,1,2,0,2
15293_1,,,,2,1,1,2
15295_0,,,,2,1,1,2
C(C1(CCC2(C1C(CO2)=O)O)O)=O,,,5,1,2,0,2
15295_1,,,,2,1,1,2
15297_0,,,,2,1,1,2
C(C1(CCC2(CC(C1O2)=O)O)O)=O,,,5,1,2,0,2
15297_1,,,,2,1,1,2
15299_0,,,,2,1,1,2
C1(COC2(CCC(C(C12)O)=O)O)=O,,,5,1,3,0,3
15299_1,,,,2,1,1,2
15301_0,,,,2,1,1,2
C1(C(C2C(CC(CC1)(O2)O)=O)O)=O,,,5,1,3,0,3
15301_1,,,,2,1,1,2
15303_0,,,,2,1,1,2
C(C(C1CC2(CC1(CO2)O)O)=O)=O,,,5,1,1,0,1
15305_0,,,,2,1,1,2
C(CC1C(C2C(CC1(O2)O)=O)O)=O,,,5,1,3,0,3
15305_1,,,,2,1,1,2
15307_0,,,,2,1,1,2
C(C1C2(C(C(CO2)=O)C(C1)O)O)=O,,,5,1,2,0,2
15307_1,,,,2,1,1,2
15309_0,,,,2,1,1,2
C(C1C2(CC(C(C(C1)O)O2)=O)O)=O,,,5,1,2,0,2
15309_1,,,,2,1,1,2
15311_0,,,,2,1,1,2
C(C1C2(COC(C2)(C1C=O)O)O)=O,,,5,1,1,0,1
15313_0,,,,2,1,1,2
C1(C2CCC(C=O)(C1C(O2)O)O)=O,,,5,1,2,0,2
15313_1,,,,2,1,1,2
15315_0,,,,2,1,1,2
C1(C2CCC(C(C1C(O2)O)O)=O)=O,,,5,1,3,0,3
15315_1,,,,2,1,1,2
15317_0,,,,2,1,1,2
C(CC1C(C2C(C1OC2O)=O)O)=O,,,5,1,3,0,3
15317_1,,,,2,1,1,2
15319_0,,,,2,1,1,2
C(C1CC(C2C(C1OC2O)=O)O)=O,,,5,1,2,0,2
15319_1,,,,2,1,1,2
15321_0,,,,2,1,1,2
C1(C(C(C(C(C=O)=O)=O)CC1)O)=O,,,5,1,2,0,2
15323_0,,,,2,1,1,2
C1(CCC(C(C=O)=O)C1(C=O)O)=O,,,5,1,1,0,1
15325_0,,,,2,1,1,2
C1(C(C(C(C(C=O)=O)CC1)O)=O)=O,,,5,1,1,0,1
15327_0,,,,2,1,1,2
C(C1(C(CC(C=O)C1C=O)=O)O)=O,,,5,1,1,0,1
15329_0,,,,2,1,1,2
C(C1CC(C(C(C1C=O)O)=O)=O)=O,,,5,1,1,0,1
15331_0,,,,2,1,1,2
C(C(C1CCC(C1O)O)=O)=O,,,5,1,1,0,1
15333_0,,,,2,1,1,2
C(C(C1CC(C(C1O)O)O)=O)=O,,,5,1,2,0,2
15335_0,,,,2,1,1,2
C(C1(CCC(C(C1O)=O)O)O)=O,,,5,1,2,0,2
15335_1,,,,2,1,1,2
15337_0,,,,2,1,1,2
C1(C(C(C(C(CC1)O)=O)O)O)=O,,,5,1,3,0,3
15337_1,,,,2,1,1,2
15339_0,,,,2,1,1,2
C1(C(C(C(C=O)=O)CC1)O)=O,,,5,1,3,0,3
15341_0,,,,2,1,1,2
C(C1(CC(CC1C(C=O)=O)O)O)=O,,,5,1,1,0,1
15343_0,,,,2,1,1,2
C1(C(C(C(C=O)=O)CC(C1)O)O)=O,,,5,1,1,0,1
15345_0,,,,2,1,1,2
C(C1(CCC(C1C(C=O)=O)O)O)=O,,,5,1,2,0,2
15345_1,,,,2,1,1,2
15347_0,,,,2,1,1,2
C1(C(C(C(C=O)=O)C(CC1)O)O)=O,,,5,1,3,0,3
15347_1,,,,2,1,1,2
15349_0,,,,2,1,1,2
C1(C(C(C(C=O)=O)CC1CO)O)=O,,,5,1,1,0,1
15351_0,,,,2,1,1,2
C(C1(CC(C(C=O)=O)C(C1)O)O)=O,,,5,1,1,0,1
15353_0,,,,2,1,1,2
C(C1(CCC(C=O)(C1C=O)O)O)=O,,,5,1,2,0,2
15353_1,,,,2,1,1,2
15355_0,,,,2,1,1,2
C1(C(C(C=O)C(C=O)(CC1)O)O)=O,,,5,1,3,0,3
15355_1,,,,2,1,1,2
15357_0,,,,2,1,1,2
C(C1CC(C(C=O)=O)C(C1O)O)=O,,,5,1,1,0,1
15359_0,,,,2,1,1,2
C(C1(CCC(C=O)C(C1O)=O)O)=O,,,5,1,2,0,2
15359_1,,,,2,1,1,2
15361_0,,,,2,1,1,2
C(C1C(C(C(C(CC1)=O)O)O)=O)=O,,,5,1,3,0,3
15361_1,,,,2,1,1,2
15363_0,,,,2,1,1,2
C1(C(CC(C(C=O)=O)C(C1)O)O)=O,,,5,1,1,0,1
15365_0,,,,2,1,1,2
C1(C(CCC(C=O)(C1C=O)O)O)=O,,,5,1,2,0,2
15365_1,,,,2,1,1,2
15367_0,,,,2,1,1,2
C1(C(CCC(C(C1C=O)O)=O)O)=O,,,5,1,3,0,3
15367_1,,,,2,1,1,2
15369_0,,,,2,1,1,2
C(C1(CCC(C=O)(C(C1)=O)O)O)=O,,,5,1,1,0,1
15371_0,,,,2,1,1,2
C1(CC(C(CCC1(C=O)O)=O)O)=O,,,5,1,2,0,2
15373_0,,,,2,1,1,2
C1(C(C(C(C(C=O)=O)CC1)O)O)=O,,,5,1,1,0,1
15375_0,,,,2,1,1,2
C(C1CCC(C1O)=O)(C(C=O)O)=O,,,5,1,2,0,2
15377_0,,,,2,1,1,2
C(C1CCC(C1O)=O)=O,,,5,1,2,0,2
15379_0,,,,2,1,1,2
C1(C(C(C(C=O)=O)CC1O)O)=O,,,5,1,3,0,3
15381_0,,,,2,1,1,2
C(C1CC(C(C1C=O)O)O)=O,,,5,1,1,0,1
15383_0,,,,2,1,1,2
C(C1C(C(C(C1C=O)O)O)O)=O,,,5,1,3,0,3
15385_0,,,,2,1,1,2
C(C1C(CC(C=O)(C1C=O)O)O)=O,,,5,1,2,0,2
15387_0,,,,2,1,1,2
C1(C(C(C=O)C(C=O)C(C1)O)O)=O,,,5,1,2,0,2
15389_0,,,,2,1,1,2
C(C1C(C(C(C=O)=O)C(C1)O)O)=O,,,5,1,2,0,2
15389_1,,,,2,1,1,2
15391_0,,,,2,1,1,2
C1(C(C(C=O)C(C=O)C1CO)O)=O,,,5,1,1,0,1
15392_0,,,,2,1,1,2
15394_0,,,,2,1,1,2
C(C1C(CC(C=O)C1(C=O)O)O)=O,,,5,1,2,0,2
15394_1,,,,2,1,1,2
15396_0,,,,2,1,1,2
C(C1C(C(C(C=O)C1C=O)O)O)=O,,,5,1,1,0,1
15398_0,,,,2,1,1,2
C(CC1C(C(C(C1C=O)=O)O)O)=O,,,5,1,3,0,3
15398_1,,,,2,1,1,2
15400_0,,,,2,1,1,2
C1(C(C(CC(C=O)C1C=O)O)O)=O,,,5,1,2,0,2
15400_1,,,,2,1,1,2
15401_0,,,,2,1,1,2
15403_0,,,,2,1,1,2
C(CC1C(C(C=O)C(C1O)=O)O)=O,,,5,1,3,0,3
15403_1,,,,2,1,1,2
15405_0,,,,2,1,1,2
C(C1CC(C(C=O)C(C1O)=O)O)=O,,,5,1,2,0,2
15405_1,,,,2,1,1,2
15407_0,,,,2,1,1,2
C(C1(C(CC(C1CC=O)O)=O)O)=O,,,5,1,2,0,2
15409_0,,,,2,1,1,2
C1(CC(CC(C=O)C1(C=O)O)O)=O,,,5,1,1,0,1
15411_0,,,,2,1,1,2
C1(CC(C=O)C(C=O)C(C1O)O)=O,,,5,1,1,0,1
15413_0,,,,2,1,1,2
C1(C(CC(C(C1)O)O)O)=O,,,5,1,1,0,1
15415_0,,,,2,1,1,2
C1(C(CC(C(C1CO)O)O)O)=O,,,5,1,2,0,2
15415_1,,,,2,1,1,2
15417_0,,,,2,1,1,2
C(C1C(C(CC(C1O)O)O)O)=O,,,5,1,2,0,2
15417_1,,,,2,1,1,2
15418_0,,,,2,2,1,3
15418_1,,,,2,2,1,3
15420_0,,,,2,2,1,3
C(CC1(C(C(C(C1O)O)O)O)O)=O,,,5,1,3,0,3
15421_0,,,,2,2,1,3
15423_0,,,,2,2,1,3
C(C1(CC(C(C1)O)(CC=O)O)O)=O,,,5,1,1,0,1
15424_0,,,,2,2,1,3
15424_1,,,,2,2,1,3
15425_0,,,,2,2,1,3
15425_1,,,,2,2,1,3
15426_0,,,,2,2,1,3
15426_1,,,,2,2,1,3
15427_0,,,,2,2,1,3
15428_0,,,,2,2,1,3
15428_1,,,,2,2,1,3
15429_0,,,,2,2,1,3
15429_1,,,,2,2,1,3
15430_0,,,,2,2,1,3
15430_1,,,,2,2,1,3
15431_0,,,,2,2,1,3
15432_0,,,,2,2,1,3
15433_0,,,,2,2,1,3
15433_1,,,,2,2,1,3
15434_0,,,,2,2,1,3
15434_1,,,,2,2,1,3
15435_0,,,,2,2,1,3
15435_1,,,,2,2,1,3
15437_0,,,,2,2,1,3
C(C(C=C)C1(CC(CC1O)O)O)=O,,,5,1,1,0,1
15439_0,,,,2,2,1,3
C(C(CC1(CC(CC1O)O)O)=O)=O,,,5,1,1,0,1
15441_0,,,,2,2,1,3
C(C(C=O)C1(CC(CC1O)O)O)=O,,,5,1,2,0,2
15441_1,,,,2,2,1,3
15443_0,,,,2,2,1,3
C(CC1(CC(CC1O)O)O)=O,,,5,1,1,0,1
15445_0,,,,2,2,1,3
C(C(CO)C1(CC(CC1O)O)O)=O,,,5,1,2,0,2
15445_1,,,,2,2,1,3
15447_0,,,,2,2,1,3
C(C)(C(C1(C(CC(C1)O)O)O)O)=O,,,5,1,2,0,2
15447_1,,,,2,2,1,3
15449_0,,,,2,2,1,3
C(CO)(CC1(C(CC(C1)O)O)O)=O,,,5,1,1,0,1
15451_0,,,,2,2,1,3
C(C(C1(C(CC(C1)O)O)O)O)=O,,,5,1,2,0,2
15451_1,,,,2,2,1,3
15453_0,,,,2,2,1,3
C1(C(C(CC1O)O)C(C=CC)O)=O,,,5,1,2,0,2
15453_1,,,,2,2,1,3
15455_0,,,,2,2,1,3
C1(C(CC(C1C(CC=C)O)O)O)=O,,,5,1,2,0,2
15455_1,,,,2,2,1,3
15457_0,,,,2,2,1,3
C1(C(C(CC1O)O)C(C=C)O)=O,,,5,1,2,0,2
15457_1,,,,2,2,1,3
15458_0,,,,2,2,1,3
15458_1,,,,2,2,1,3
15459_0,,,,2,2,1,3
15459_1,,,,2,2,1,3
15460_0,,,,2,2,1,3
15460_1,,,,2,2,1,3
15461_0,,,,2,2,1,3
15461_1,,,,2,2,1,3
15462_0,,,,2,2,1,3
15462_1,,,,2,2,1,3
15463_0,,,,2,2,1,3
15463_1,,,,2,2,1,3
15464_0,,,,2,2,1,3
15464_1,,,,2,2,1,3
15465_0,,,,2,2,1,3
15465_1,,,,2,2,1,3
15466_0,,,,2,2,1,3
15466_1,,,,2,2,1,3
15467_0,,,,2,2,1,3
15467_1,,,,2,2,1,3
15468_0,,,,2,2,1,3
15468_1,,,,2,2,1,3
15469_0,,,,2,2,1,3
15469_1,,,,2,2,1,3
15470_0,,,,2,2,1,3
15470_1,,,,2,2,1,3
15471_0,,,,2,2,1,3
15471_1,,,,2,2,1,3
15472_0,,,,2,2,1,3
15472_1,,,,2,2,1,3
15474_0,,,,2,2,1,3
C(CC1(CC(C(C1O)O)O)O)=O,,,5,1,1,0,1
15476_0,,,,2,2,1,3
C(C(C1(C(C(C(C1)O)O)O)O)O)=O,,,5,1,3,0,3
15476_1,,,,2,2,1,3
15478_0,,,,2,2,1,3
C1(C(C(C(C1O)O)O)C(C=C)O)=O,,,5,1,2,0,2
15478_1,,,,2,2,1,3
15479_0,,,,2,2,1,3
15479_1,,,,2,2,1,3
15480_0,,,,2,2,1,3
15480_1,,,,2,2,1,3
15481_0,,,,2,2,1,3
15481_1,,,,2,2,1,3
15482_0,,,,2,2,1,3
15482_1,,,,2,2,1,3
15483_0,,,,2,2,1,3
15483_1,,,,2,2,1,3
15485_0,,,,2,2,1,3
C(CC1(C(CC(C1CO)O)O)O)=O,,,5,1,1,0,1
15487_0,,,,2,2,1,3
C(CC(C1C(C(CC1O)O)O)O)=O,,,5,1,1,0,1
15489_0,,,,2,2,1,3
C(CC1(CC(CC(C1O)O)O)O)=O,,,5,1,1,0,1
15490_0,,,,2,2,1,3
15490_1,,,,2,2,1,3
15491_0,,,,2,2,1,3
15491_1,,,,2,2,1,3
15492_0,,,,2,2,1,3
15492_1,,,,2,2,1,3
15493_0,,,,2,2,1,3
15493_1,,,,2,2,1,3
15495_0,,,,2,2,1,3
C(CC1(C(C(CC1O)O)O)O)=O,,,5,1,1,0,1
15497_0,,,,2,2,1,3
C(C(C1(C(C(CC1O)O)O)O)O)=O,,,5,1,5,0,5
15497_1,,,,2,2,1,3
15498_0,,,,2,2,1,3
15498_1,,,,2,2,1,3
15499_0,,,,2,2,1,3
15499_1,,,,2,2,1,3
15500_0,,,,2,2,1,3
15500_1,,,,2,2,1,3
15501_0,,,,2,2,1,3
15502_0,,,,2,2,1,3
15502_1,,,,2,2,1,3
15503_0,,,,2,2,1,3
15503_1,,,,2,2,1,3
15504_0,,,,2,2,1,3
15504_1,,,,2,2,1,3
15506_0,,,,2,2,1,3
C(C(C)(C(CO)C(CC=O)O)O)=O,,,5,1,2,0,2
15507_0,,,,2,2,1,3
15508_0,,,,2,2,1,3
15508_1,,,,2,2,1,3
15509_0,,,,2,2,1,3
15510_0,,,,2,2,1,3
15511_0,,,,2,2,1,3
15513_0,,,,2,2,1,3
C(CC(C(CO)C(C(C)=O)O)O)=O,,,5,1,2,0,2
15514_0,,,,2,2,1,3
15515_0,,,,2,2,1,3
15516_0,,,,2,2,1,3
15517_0,,,,2,2,1,3
15518_0,,,,2,2,1,3
15518_1,,,,2,2,1,3
15519_0,,,,2,2,1,3
15519_1,,,,2,2,1,3
15520_0,,,,2,2,1,3
15520_1,,,,2,2,1,3
15521_0,,,,2,2,1,3
15521_1,,,,2,2,1,3
15522_0,,,,2,2,1,3
15522_1,,,,2,2,1,3
15523_0,,,,2,2,1,3
15523_1,,,,2,2,1,3
15524_0,,,,2,2,1,3
15524_1,,,,2,2,1,3
15525_0,,,,2,2,1,3
15525_1,,,,2,2,1,3
15527_0,,,,2,2,1,3
C(CC(C(CO)C(CC=O)O)O)=O,,,5,1,2,0,2
15528_0,,,,2,2,1,3
15529_0,,,,2,2,1,3
15529_1,,,,2,2,1,3
15530_0,,,,2,2,1,3
15530_1,,,,2,2,1,3
15531_0,,,,2,2,1,3
15531_1,,,,2,2,1,3
15532_0,,,,2,2,1,3
15533_0,,,,2,2,1,3
15533_1,,,,2,2,1,3
15534_0,,,,2,2,1,3
15534_1,,,,2,2,1,3
15535_0,,,,2,2,1,3
15535_1,,,,2,2,1,3
15537_0,,,,2,2,1,3
C(CC(CC(CC(C)O)O)O)=O,,,5,1,1,0,1
15539_0,,,,2,2,1,3
C(C(C(CC(CC(C)O)O)O)O)=O,,,5,1,2,0,2
15539_1,,,,2,2,1,3
15541_0,,,,2,2,1,3
C(C(C(CC(C)O)O)C(C=C)O)=O,,,5,1,2,0,2
15541_1,,,,2,2,1,3
15542_0,,,,2,2,1,3
15542_1,,,,2,2,1,3
15543_0,,,,2,2,1,3
15543_1,,,,2,2,1,3
15544_0,,,,2,2,1,3
15544_1,,,,2,2,1,3
15545_0,,,,2,2,1,3
15545_1,,,,2,2,1,3
15546_0,,,,2,2,1,3
15546_1,,,,2,2,1,3
15548_0,,,,2,2,1,3
C(CC(C(C(CC(C)O)O)O)O)=O,,,5,1,1,0,1
15550_0,,,,2,2,1,3
C(C(C(CC=O)O)C(C)O)(O)=O,,,5,1,4,0,4
15552_0,,,,2,2,1,3
C(C(C(C(C=O)O)O)C(C)O)(O)=O,,,5,1,5,0,5
15552_1,,,,2,2,1,3
15554_0,,,,2,2,1,3
C(CC(C(C(C)O)C(C)O)O)=O,,,5,1,1,0,1
15556_0,,,,2,2,1,3
C(C(C(C(C(C)O)C(C)O)O)O)=O,,,5,1,2,0,2
15556_1,,,,2,2,1,3
15558_0,,,,2,2,1,3
C(C(C=C)C(C(CO)C(C)O)O)=O,,,5,1,1,0,1
15560_0,,,,2,2,1,3
C(C(CC(C(CO)C(C)O)O)=O)=O,,,5,1,2,0,2
15562_0,,,,2,2,1,3
C(C(C=O)C(C(CO)C(C)O)O)=O,,,5,1,3,0,3
15562_1,,,,2,2,1,3
15564_0,,,,2,2,1,3
C(CC(C(CO)C(C)O)O)=O,,,5,1,2,0,2
15566_0,,,,2,2,1,3
C(C(CO)C(C(CO)C(C)O)O)=O,,,5,1,3,0,3
15566_1,,,,2,2,1,3
15568_0,,,,2,2,1,3
C(C)(C(C(C(CO)C(C)O)O)O)=O,,,5,1,3,0,3
15568_1,,,,2,2,1,3
15570_0,,,,2,2,1,3
C(CO)(CC(C(CO)C(C)O)O)=O,,,5,1,2,0,2
15572_0,,,,2,2,1,3
C(C(C(C(CO)C(C)O)O)O)=O,,,5,1,3,0,3
15572_1,,,,2,2,1,3
15574_0,,,,2,2,1,3
C(CC(C(C(CO)O)C(C)O)O)=O,,,5,1,2,0,2
15576_0,,,,2,2,1,3
C(CC(CC(C(C(C)O)O)O)O)=O,,,5,1,1,0,1
15577_0,,,,2,2,1,3
15577_1,,,,2,2,1,3
15578_0,,,,2,2,1,3
15578_1,,,,2,2,1,3
15579_0,,,,2,2,1,3
15579_1,,,,2,2,1,3
15580_0,,,,2,2,1,3
15580_1,,,,2,2,1,3
15582_0,,,,2,2,1,3
C(CC(C(CO)C(CCO)O)O)=O,,,5,1,2,0,2
15584_0,,,,2,2,1,3
C(CC(C)(C(C(CCO)O)O)O)=O,,,5,1,2,0,2
15586_0,,,,2,2,1,3
C(C(C(CCO)O)O)(CC(C)O)=O,,,5,1,4,0,4
15587_0,,,,2,2,1,3
15588_0,,,,2,2,1,3
15590_0,,,,2,2,1,3
C(CC(CO)(CC(CCO)O)O)=O,,,5,1,2,0,2
15592_0,,,,2,2,1,3
C(C(C(C)O)O)(CC(CCO)O)=O,,,5,1,4,0,4
15592_1,,,,2,2,1,3
15593_0,,,,2,2,1,3
15593_1,,,,2,2,1,3
15594_0,,,,2,2,1,3
15594_1,,,,2,2,1,3
15596_0,,,,2,2,1,3
C(CO)(C(C(C)O)C(CCO)O)=O,,,5,1,6,0,6
15596_1,,,,2,2,1,3
15597_0,,,,2,2,1,3
15597_1,,,,2,2,1,3
15598_0,,,,2,2,1,3
15598_1,,,,2,2,1,3
15599_0,,,,2,2,1,3
15599_1,,,,2,2,1,3
15600_0,,,,2,2,1,3
15600_1,,,,2,2,1,3
15602_0,,,,2,2,1,3
C(C(CC(CCO)O)(CC=O)O)=O,,,5,1,2,0,2
15603_0,,,,2,2,1,3
15604_0,,,,2,2,1,3
15604_1,,,,2,2,1,3
15605_0,,,,2,2,1,3
15605_1,,,,2,2,1,3
15606_0,,,,2,2,1,3
15606_1,,,,2,2,1,3
15607_0,,,,2,2,1,3
15609_0,,,,2,2,1,3
C(C(C=C)C(CC(CCO)O)O)=O,,,5,1,1,0,1
15611_0,,,,2,2,1,3
C(C(CC(CC(CCO)O)O)=O)=O,,,5,1,2,0,2
15613_0,,,,2,2,1,3
C(C(C=O)C(CC(CCO)O)O)=O,,,5,1,3,0,3
15613_1,,,,2,2,1,3
15615_0,,,,2,2,1,3
C(CC(CC(CCO)O)O)=O,,,5,1,2,0,2
15617_0,,,,2,2,1,3
C(C(CO)C(CC(CCO)O)O)=O,,,5,1,3,0,3
15617_1,,,,2,2,1,3
15619_0,,,,2,2,1,3
C(C)(C(C(CC(CCO)O)O)O)=O,,,5,1,3,0,3
15619_1,,,,2,2,1,3
15621_0,,,,2,2,1,3
C(CO)(CC(CC(CCO)O)O)=O,,,5,1,2,0,2
15623_0,,,,2,2,1,3
C(C(C(CC(CCO)O)O)O)=O,,,5,1,3,0,3
15623_1,,,,2,2,1,3
15625_0,,,,2,2,1,3
C(C(C(CCO)O)C(C=CC)O)=O,,,5,1,2,0,2
15625_1,,,,2,2,1,3
15627_0,,,,2,2,1,3
C(C(C(CC=C)O)C(CCO)O)=O,,,5,1,2,0,2
15627_1,,,,2,2,1,3
15629_0,,,,2,2,1,3
C(C(C(CCO)O)C(C=C)O)=O,,,5,1,2,0,2
15629_1,,,,2,2,1,3
15630_0,,,,2,2,1,3
15630_1,,,,2,2,1,3
15631_0,,,,2,2,1,3
15631_1,,,,2,2,1,3
15632_0,,,,2,2,1,3
15632_1,,,,2,2,1,3
15633_0,,,,2,2,1,3
15633_1,,,,2,2,1,3
15634_0,,,,2,2,1,3
15634_1,,,,2,2,1,3
15635_0,,,,2,2,1,3
15635_1,,,,2,2,1,3
15637_0,,,,2,2,1,3
C(C(C(CCO)O)C(CCO)O)=O,,,5,1,3,0,3
15637_1,,,,2,2,1,3
15639_0,,,,2,2,1,3
C(C(C(CCO)O)C(C)(CO)O)=O,,,5,1,6,0,6
15639_1,,,,2,2,1,3
15640_0,,,,2,2,1,3
15640_1,,,,2,2,1,3
15642_0,,,,2,2,1,3
C(C(C(C(O)O)O)C(CCO)O)=O,,,5,1,5,0,5
15642_1,,,,2,2,1,3
15644_0,,,,2,2,1,3
C(C(C(C(C)O)O)C(CCO)O)=O,,,5,1,5,0,5
15644_1,,,,2,2,1,3
15645_0,,,,2,2,1,3
15645_1,,,,2,2,1,3
15646_0,,,,2,2,1,3
15646_1,,,,2,2,1,3
15648_0,,,,2,2,1,3
C(CC(C(C(CCO)O)O)O)=O,,,5,1,3,0,3
15650_0,,,,2,2,1,3
C(C(C(C(C(CCO)O)O)O)O)=O,,,5,1,8,0,8
15650_1,,,,2,2,1,3
15652_0,,,,2,2,1,3
C(CC(C(CO)C(C)(CO)O)O)=O,,,5,1,2,0,2
15654_0,,,,2,2,1,3
C(C(C=C)C(C(C(O)=O)CO)O)=O,,,5,1,2,0,2
15656_0,,,,2,2,1,3
C(C(CO)C(CC(C=O)=O)O)(O)=O,,,5,1,5,0,5
15658_0,,,,2,2,1,3
C(C(C=O)C(C(C(O)=O)CO)O)=O,,,5,1,6,0,6
15658_1,,,,2,2,1,3
15660_0,,,,2,2,1,3
C(C(CO)C(CC=O)O)(O)=O,,,5,1,6,0,6
15662_0,,,,2,2,1,3
C(C(CO)C(C(C=O)CO)O)(O)=O,,,5,1,6,0,6
15662_1,,,,2,2,1,3
15664_0,,,,2,2,1,3
C(C(CO)C(C(C(C)=O)O)O)(O)=O,,,5,1,7,0,7
15664_1,,,,2,2,1,3
15666_0,,,,2,2,1,3
C(C(CO)C(CC(CO)=O)O)(O)=O,,,5,1,6,0,6
15668_0,,,,2,2,1,3
C(C(CO)C(C(C=O)O)O)(O)=O,,,5,1,7,0,7
15668_1,,,,2,2,1,3
15670_0,,,,2,2,1,3
C(CC(C(CO)C(C(O)O)O)O)=O,,,5,1,2,0,2
15672_0,,,,2,2,1,3
C(CC(C(CO)C(C(C)O)O)O)=O,,,5,1,2,0,2
15674_0,,,,2,2,1,3
C(C(C(C)=O)C(C(CO)CO)O)=O,,,5,1,2,0,2
15674_1,,,,2,2,1,3
15676_0,,,,2,2,1,3
C(CC(CC(C(CO)CO)O)=O)=O,,,5,1,1,0,1
15678_0,,,,2,2,1,3
C=CC(C(C(C(CO)CO)O)O)=O,,,5,1,2,0,2
15678_1,,,,2,2,1,3
15680_0,,,,2,2,1,3
C(C(C(C)C(C(CO)CO)O)=O)=O,,,5,1,1,0,1
15682_0,,,,2,2,1,3
C(C(C(C(CO)CO)O)CC=O)=O,,,5,1,1,0,1
15684_0,,,,2,2,1,3
C(C(C)=O)(CC(C(CO)CO)O)=O,,,5,1,1,0,1
15686_0,,,,2,2,1,3
C(C(C=C)C(C(CO)CO)O)=O,,,5,1,1,0,1
15688_0,,,,2,2,1,3
C1OC(C(C=1)=O)C(C(CO)CO)O,,,5,1,2,0,2
15688_1,,,,2,2,1,3
15690_0,,,,2,2,1,3
C(CO)(C(C(C(CO)CO)O)O)=O,,,5,1,3,0,3
15690_1,,,,2,2,1,3
15692_0,,,,2,2,1,3
C(C(CC(C(CO)CO)O)=O)=O,,,5,1,2,0,2
15694_0,,,,2,2,1,3
C(C(C=O)C(C(CO)CO)O)=O,,,5,1,3,0,3
15694_1,,,,2,2,1,3
15696_0,,,,2,2,1,3
C(CC(C(CO)CO)O)=O,,,5,1,2,0,2
15698_0,,,,2,2,1,3
C(C(C(C(C(CO)CO)O)O)=O)=O,,,5,1,4,0,4
15698_1,,,,2,2,1,3
15700_0,,,,2,2,1,3
C(C(C(C)O)C(C(CO)CO)O)=O,,,5,1,3,0,3
15700_1,,,,2,2,1,3
15702_0,,,,2,2,1,3
C(C(CO)C(C(CO)CO)O)=O,,,5,1,3,0,3
15702_1,,,,2,2,1,3
15704_0,,,,2,2,1,3
C(C)(C(C(C(CO)CO)O)O)=O,,,5,1,3,0,3
15704_1,,,,2,2,1,3
15706_0,,,,2,2,1,3
C(CO)(CC(C(CO)CO)O)=O,,,5,1,2,0,2
15708_0,,,,2,2,1,3
C(C(CC(C(CO)CO)O)=O)(O)=O,,,5,1,2,0,2
15710_0,,,,2,2,1,3
C(C(C=O)C(C(CO)CO)O)(O)=O,,,5,1,3,0,3
15710_1,,,,2,2,1,3
15712_0,,,,2,2,1,3
C(C(C(C(CO)CO)O)O)=O,,,5,1,4,0,4
15712_1,,,,2,2,1,3
15714_0,,,,2,2,1,3
C(CC(C(CO)C(CO)O)O)=O,,,5,1,3,0,3
15716_0,,,,2,2,1,3
C(C(C(C(CO)C(CO)O)O)O)=O,,,5,1,5,0,5
15716_1,,,,2,2,1,3
15718_0,,,,2,2,1,3
C(CC(CC(CC(CO)O)O)O)=O,,,5,1,2,0,2
15719_0,,,,2,2,1,3
15719_1,,,,2,2,1,3
15720_0,,,,2,2,1,3
15720_1,,,,2,2,1,3
15721_0,,,,2,2,1,3
15721_1,,,,2,2,1,3
15723_0,,,,2,2,1,3
C(C(C(CC=O)O)C(CO)O)(O)=O,,,5,1,6,0,6
15724_0,,,,2,2,1,3
15724_1,,,,2,2,1,3
15725_0,,,,2,2,1,3
15726_0,,,,2,2,1,3
15728_0,,,,2,2,1,3
C(CC(CC(C(C)=O)(CO)O)O)=O,,,5,1,2,0,2
15730_0,,,,2,2,1,3
C(CC(C)(C(CO)(CC=O)O)O)=O,,,5,1,3,0,3
15731_0,,,,2,2,1,3
15731_1,,,,2,2,1,3
15732_0,,,,2,2,1,3
15732_1,,,,2,2,1,3
15733_0,,,,2,2,1,3
15733_1,,,,2,2,1,3
15735_0,,,,2,2,1,3
C(C(CO)(CC=O)O)(CC(C)O)=O,,,5,1,3,0,3
15737_0,,,,2,2,1,3
C(C(CO)(CC=O)O)(CC(O)=O)=O,,,5,1,3,0,3
15738_0,,,,2,2,1,3
15739_0,,,,2,2,1,3
15741_0,,,,2,2,1,3
C(CC(CC(C(CO)=O)(C)O)O)=O,,,5,1,2,0,2
15742_0,,,,2,2,1,3
15743_0,,,,2,2,1,3
15743_1,,,,2,2,1,3
15744_0,,,,2,2,1,3
15744_1,,,,2,2,1,3
15745_0,,,,2,2,1,3
15745_1,,,,2,2,1,3
15747_0,,,,2,2,1,3
C(C(C)(CC=O)O)(C(C(C)O)O)=O,,,5,1,3,0,3
15747_1,,,,2,2,1,3
15749_0,,,,2,2,1,3
C(C(C)(CC=O)O)(C(C(O)=O)O)=O,,,5,1,3,0,3
15749_1,,,,2,2,1,3
15751_0,,,,2,2,1,3
C(C(C)(CC=O)O)(C(CO)O)=O,,,5,1,3,0,3
15751_1,,,,2,2,1,3
15752_0,,,,2,2,1,3
15752_1,,,,2,2,1,3
15753_0,,,,2,2,1,3
15754_0,,,,2,2,1,3
15756_0,,,,2,2,1,3
C(C(C(C(CC(C)O)=O)=O)O)(O)=O,,,5,1,3,0,3
15758_0,,,,2,2,1,3
C(CC(C(C(C(O)=O)O)=O)=O)(O)=O,,,5,1,3,0,3
15759_0,,,,2,2,1,3
15761_0,,,,2,2,1,3
C(C(C(C(C(CCO)=O)=O)O)O)=O,,,5,1,8,0,8
15762_0,,,,2,2,1,3
15763_0,,,,2,2,1,3
15765_0,,,,2,2,1,3
C(C(C(C(C)O)O)=O)(CC(C)O)=O,,,5,1,3,0,3
15767_0,,,,2,2,1,3
C(CC(C(C(C(C)O)O)=O)=O)(O)=O,,,5,1,3,0,3
15769_0,,,,2,2,1,3
C(C(C(C(C)O)O)=O)(CCO)=O,,,5,1,6,0,6
15770_0,,,,2,2,1,3
15771_0,,,,2,2,1,3
15771_1,,,,2,2,1,3
15772_0,,,,2,2,1,3
15773_0,,,,2,2,1,3
15773_1,,,,2,2,1,3
15775_0,,,,2,2,1,3
C=CC(CC(C(C(CO)O)=O)=O)O,,,5,1,1,0,1
15777_0,,,,2,2,1,3
C(C(CC(C(C(CO)O)=O)=O)O)=O,,,5,1,3,0,3
15779_0,,,,2,2,1,3
C(C(C(CO)O)=O)(CC(C)O)=O,,,5,1,4,0,4
15780_0,,,,2,2,1,3
15781_0,,,,2,2,1,3
15783_0,,,,2,2,1,3
C(C(C(CO)O)=O)(CC(CO)O)=O,,,5,1,6,0,6
15785_0,,,,2,2,1,3
C(C(C(C(CO)O)O)=O)(CCO)=O,,,5,1,8,0,8
15786_0,,,,2,2,1,3
15788_0,,,,2,2,1,3
C(CC(C(CO)=O)(CC=O)O)(O)=O,,,5,1,1,0,1
15789_0,,,,2,2,1,3
15789_1,,,,2,2,1,3
15790_0,,,,2,2,1,3
15790_1,,,,2,2,1,3
15791_0,,,,2,2,1,3
15791_1,,,,2,2,1,3
15793_0,,,,2,2,1,3
C(C(C(C(CO)=O)=O)C(C)O)(O)=O,,,5,1,5,0,5
15793_1,,,,2,2,1,3
15795_0,,,,2,2,1,3
C(C(C(O)=O)C(C(CO)=O)=O)(O)=O,,,5,1,2,0,2
15795_1,,,,2,2,1,3
15796_0,,,,2,2,1,3
15796_1,,,,2,2,1,3
15797_0,,,,2,2,1,3
15797_1,,,,2,2,1,3
15799_0,,,,2,2,1,3
C(C(C(C(C(CO)=O)=O)CO)O)=O,,,5,1,5,0,5
15799_1,,,,2,2,1,3
15800_0,,,,2,2,1,3
15802_0,,,,2,2,1,3
C(CO)(C(CC(C)O)(CC=O)O)=O,,,5,1,2,0,2
15803_0,,,,2,2,1,3
15803_1,,,,2,2,1,3
15804_0,,,,2,2,1,3
15804_1,,,,2,2,1,3
15805_0,,,,2,2,1,3
15805_1,,,,2,2,1,3
15807_0,,,,2,2,1,3
C(C(CO)=O)(C(C(C)O)C(C)O)=O,,,5,1,3,0,3
15807_1,,,,2,2,1,3
15808_0,,,,2,2,1,3
15808_1,,,,2,2,1,3
15810_0,,,,2,2,1,3
C(C(CO)=O)(C(CO)C(C)O)=O,,,5,1,5,0,5
15810_1,,,,2,2,1,3
15811_0,,,,2,2,1,3
15812_0,,,,2,2,1,3
15812_1,,,,2,2,1,3
15814_0,,,,2,2,1,3
C(CO)(C(CCO)(CC=O)O)=O,,,5,1,2,0,2
15816_0,,,,2,2,1,3
C(CO)(C(CCO)(C(C=O)O)O)=O,,,5,1,5,0,5
15816_1,,,,2,2,1,3
15818_0,,,,2,2,1,3
C=CC(C(C(C(CCO)=O)=O)O)O,,,5,1,2,0,2
15818_1,,,,2,2,1,3
15819_0,,,,2,2,1,3
15819_1,,,,2,2,1,3
15820_0,,,,2,2,1,3
15820_1,,,,2,2,1,3
15821_0,,,,2,2,1,3
15821_1,,,,2,2,1,3
15822_0,,,,2,2,1,3
15822_1,,,,2,2,1,3
15823_0,,,,2,2,1,3
15823_1,,,,2,2,1,3
15825_0,,,,2,2,1,3
C=CC(C(C(C(CO)=O)=O)CO)O,,,5,1,2,0,2
15825_1,,,,2,2,1,3
15826_0,,,,2,2,1,3
15826_1,,,,2,2,1,3
15827_0,,,,2,2,1,3
15827_1,,,,2,2,1,3
15828_0,,,,2,2,1,3
15828_1,,,,2,2,1,3
15829_0,,,,2,2,1,3
15829_1,,,,2,2,1,3
15831_0,,,,2,2,1,3
C(C(CO)=O)(C(CO)C(CO)O)=O,,,5,1,6,0,6
15831_1,,,,2,2,1,3
15832_0,,,,2,2,1,3
15832_1,,,,2,2,1,3
15833_0,,,,2,2,1,3
15833_1,,,,2,2,1,3
15835_0,,,,2,2,1,3
C(CC(CC(C(C(C)O)=O)O)O)=O,,,5,1,3,0,3
15836_0,,,,2,2,1,3
15837_0,,,,2,2,1,3
15837_1,,,,2,2,1,3
15838_0,,,,2,2,1,3
15838_1,,,,2,2,1,3
15839_0,,,,2,2,1,3
15839_1,,,,2,2,1,3
15840_0,,,,2,2,1,3
15840_1,,,,2,2,1,3
15841_0,,,,2,2,1,3
15843_0,,,,2,2,1,3
C(CC(C)(C(C(C)(CO)O)O)O)=O,,,5,1,2,0,2
15845_0,,,,2,2,1,3
C(C(C(CO)(C)O)O)(CC(C)O)=O,,,5,1,4,0,4
15846_0,,,,2,2,1,3
15847_0,,,,2,2,1,3
15849_0,,,,2,2,1,3
C(CC(CO)(CC(C)(CO)O)O)=O,,,5,1,1,0,1
15851_0,,,,2,2,1,3
C(C(C(C)O)O)(CC(CO)(C)O)=O,,,5,1,3,0,3
15851_1,,,,2,2,1,3
15852_0,,,,2,2,1,3
15852_1,,,,2,2,1,3
15853_0,,,,2,2,1,3
15853_1,,,,2,2,1,3
15855_0,,,,2,2,1,3
C(CO)(C(C(C)O)C(CO)(C)O)=O,,,5,1,5,0,5
15855_1,,,,2,2,1,3
15856_0,,,,2,2,1,3
15856_1,,,,2,2,1,3
15857_0,,,,2,2,1,3
15857_1,,,,2,2,1,3
15858_0,,,,2,2,1,3
15858_1,,,,2,2,1,3
15859_0,,,,2,2,1,3
15859_1,,,,2,2,1,3
15861_0,,,,2,2,1,3
C(C(CC(CO)(C)O)(CC=O)O)=O,,,5,1,2,0,2
15862_0,,,,2,2,1,3
15863_0,,,,2,2,1,3
15863_1,,,,2,2,1,3
15864_0,,,,2,2,1,3
15864_1,,,,2,2,1,3
15865_0,,,,2,2,1,3
15865_1,,,,2,2,1,3
15866_0,,,,2,2,1,3
15868_0,,,,2,2,1,3
C(C(C=C)C(CC(C)(CO)O)O)=O,,,5,1,1,0,1
15870_0,,,,2,2,1,3
C(C(CC(CC(C)(CO)O)O)=O)=O,,,5,1,2,0,2
15872_0,,,,2,2,1,3
C(C(C=O)C(CC(C)(CO)O)O)=O,,,5,1,3,0,3
15872_1,,,,2,2,1,3
15874_0,,,,2,2,1,3
C(CC(CC(C)(CO)O)O)=O,,,5,1,2,0,2
15876_0,,,,2,2,1,3
C(C(CO)C(CC(C)(CO)O)O)=O,,,5,1,3,0,3
15876_1,,,,2,2,1,3
15878_0,,,,2,2,1,3
C(C)(C(C(CC(CO)(C)O)O)O)=O,,,5,1,3,0,3
15878_1,,,,2,2,1,3
15880_0,,,,2,2,1,3
C(CO)(CC(CC(CO)(C)O)O)=O,,,5,1,2,0,2
15882_0,,,,2,2,1,3
C(C(C(CC(CO)(C)O)O)O)=O,,,5,1,3,0,3
15882_1,,,,2,2,1,3
15884_0,,,,2,2,1,3
C(C(C(CO)(C)O)C(C=CC)O)=O,,,5,1,2,0,2
15884_1,,,,2,2,1,3
15886_0,,,,2,2,1,3
C(C(C(CC=C)O)C(C)(CO)O)=O,,,5,1,2,0,2
15886_1,,,,2,2,1,3
15888_0,,,,2,2,1,3
C(C(C(CO)(C)O)C(C=C)O)=O,,,5,1,2,0,2
15888_1,,,,2,2,1,3
15889_0,,,,2,2,1,3
15889_1,,,,2,2,1,3
15890_0,,,,2,2,1,3
15890_1,,,,2,2,1,3
15891_0,,,,2,2,1,3
15891_1,,,,2,2,1,3
15892_0,,,,2,2,1,3
15892_1,,,,2,2,1,3
15893_0,,,,2,2,1,3
15893_1,,,,2,2,1,3
15894_0,,,,2,2,1,3
15894_1,,,,2,2,1,3
15895_0,,,,2,2,1,3
15895_1,,,,2,2,1,3
15897_0,,,,2,2,1,3
C(C(C(C)(CO)O)C(C)(CO)O)=O,,,5,1,3,0,3
15897_1,,,,2,2,1,3
15898_0,,,,2,2,1,3
15898_1,,,,2,2,1,3
15900_0,,,,2,2,1,3
C(C(C(C(O)O)O)C(C)(CO)O)=O,,,5,1,5,0,5
15900_1,,,,2,2,1,3
15902_0,,,,2,2,1,3
C(C(C(C(C)O)O)C(C)(CO)O)=O,,,5,1,5,0,5
15902_1,,,,2,2,1,3
15903_0,,,,2,2,1,3
15903_1,,,,2,2,1,3
15904_0,,,,2,2,1,3
15904_1,,,,2,2,1,3
15906_0,,,,2,2,1,3
C(CC(C(C(C)(CO)O)O)O)=O,,,5,1,2,0,2
15908_0,,,,2,2,1,3
C(C(C(C(C(CO)(C)O)O)O)O)=O,,,5,1,5,0,5
15908_1,,,,2,2,1,3
15909_0,,,,2,2,1,3
15910_0,,,,2,2,1,3
15911_0,,,,2,2,1,3
15912_0,,,,2,2,1,3
15914_0,,,,2,2,1,3
C(CC(C)(C(C(C(O)O)O)O)O)=O,,,5,1,1,0,1
15916_0,,,,2,2,1,3
C(C(C(C(O)O)O)O)(CC(C)O)=O,,,5,1,3,0,3
15917_0,,,,2,2,1,3
15918_0,,,,2,2,1,3
15920_0,,,,2,2,1,3
C(CC(C)(C(C(C(C)O)O)O)O)=O,,,5,1,1,0,1
15922_0,,,,2,2,1,3
C(C(C(C(C)O)O)O)(CC(C)O)=O,,,5,1,3,0,3
15923_0,,,,2,2,1,3
15924_0,,,,2,2,1,3
15925_0,,,,2,2,1,3
15926_0,,,,2,2,1,3
15927_0,,,,2,2,1,3
15928_0,,,,2,2,1,3
15929_0,,,,2,2,1,3
15930_0,,,,2,2,1,3
15931_0,,,,2,2,1,3
15932_0,,,,2,2,1,3
15933_0,,,,2,2,1,3
15934_0,,,,2,2,1,3
15935_0,,,,2,2,1,3
15937_0,,,,2,2,1,3
C(C(C=C)C(C)(C(C(C)O)O)O)=O,,,5,1,1,0,1
15939_0,,,,2,2,1,3
C(C(CC(C)(C(C(C)O)O)O)=O)=O,,,5,1,1,0,1
15941_0,,,,2,2,1,3
C(C(C=O)C(C)(C(C(C)O)O)O)=O,,,5,1,2,0,2
15941_1,,,,2,2,1,3
15943_0,,,,2,2,1,3
C(CC(C)(C(C(C)O)O)O)=O,,,5,1,1,0,1
15945_0,,,,2,2,1,3
C(C(CO)C(C)(C(C(C)O)O)O)=O,,,5,1,2,0,2
15945_1,,,,2,2,1,3
15947_0,,,,2,2,1,3
C(C)(C(C(C)(C(C(C)O)O)O)O)=O,,,5,1,2,0,2
15947_1,,,,2,2,1,3
15949_0,,,,2,2,1,3
C(CO)(CC(C)(C(C(C)O)O)O)=O,,,5,1,1,0,1
15951_0,,,,2,2,1,3
C(C(C(C)(C(C(C)O)O)O)O)=O,,,5,1,3,0,3
15951_1,,,,2,2,1,3
15953_0,,,,2,2,1,3
C(CC(C=CC)O)(C(C(C)O)O)=O,,,5,1,1,0,1
15955_0,,,,2,2,1,3
C(C(C(C)O)O)(CC(CC=C)O)=O,,,5,1,1,0,1
15957_0,,,,2,2,1,3
C(CC(C=C)O)(C(C(C)O)O)=O,,,5,1,1,0,1
15958_0,,,,2,2,1,3
15959_0,,,,2,2,1,3
15961_0,,,,2,2,1,3
C(C(C)(CC(C(C(C)O)O)=O)O)=O,,,5,1,3,0,3
15963_0,,,,2,2,1,3
C(CC(C(C)=O)O)(C(C(C)O)O)=O,,,5,1,3,0,3
15964_0,,,,2,2,1,3
15966_0,,,,2,2,1,3
C(C(C(C)O)O)(CC(C)O)=O,,,5,1,3,0,3
15967_0,,,,2,2,1,3
15968_0,,,,2,2,1,3
15969_0,,,,2,2,1,3
15971_0,,,,2,2,1,3
C(C(C(C)O)O)(CC(C(O)O)O)=O,,,5,1,3,0,3
15973_0,,,,2,2,1,3
C(C(C(C)O)O)(CC(C(C)O)O)=O,,,5,1,3,0,3
15974_0,,,,2,2,1,3
15976_0,,,,2,2,1,3
C(C(C(C)O)O)(CC(CO)O)=O,,,5,1,4,0,4
15978_0,,,,2,2,1,3
C(CC(C)(C(C(CO)O)O)O)=O,,,5,1,3,0,3
15980_0,,,,2,2,1,3
C(C(C(C)(C(C(CO)O)O)O)O)=O,,,5,1,7,0,7
15980_1,,,,2,2,1,3
15982_0,,,,2,2,1,3
C(CC(C=C)O)(C(C(CO)O)O)=O,,,5,1,1,0,1
15983_0,,,,2,2,1,3
15985_0,,,,2,2,1,3
C(C(C(CO)O)O)(CC(C)O)=O,,,5,1,5,0,5
15986_0,,,,2,2,1,3
15987_0,,,,2,2,1,3
15989_0,,,,2,2,1,3
C(C(C(CO)O)O)(CC(CO)O)=O,,,5,1,7,0,7
15990_0,,,,2,2,1,3
15990_1,,,,2,2,1,3
15991_0,,,,2,2,1,3
15991_1,,,,2,2,1,3
15992_0,,,,2,2,1,3
15992_1,,,,2,2,1,3
15993_0,,,,2,2,1,3
15993_1,,,,2,2,1,3
15994_0,,,,2,2,1,3
15994_1,,,,2,2,1,3
15995_0,,,,2,2,1,3
15995_1,,,,2,2,1,3
15996_0,,,,2,2,1,3
15996_1,,,,2,2,1,3
15997_0,,,,2,2,1,3
15997_1,,,,2,2,1,3
15998_0,,,,2,2,1,3
15998_1,,,,2,2,1,3
15999_0,,,,2,2,1,3
15999_1,,,,2,2,1,3
16001_0,,,,2,2,1,3
C(CC(CO)(CC(C(O)O)O)O)=O,,,5,1,1,0,1
16002_0,,,,2,2,1,3
16002_1,,,,2,2,1,3
16003_0,,,,2,2,1,3
16003_1,,,,2,2,1,3
16004_0,,,,2,2,1,3
16004_1,,,,2,2,1,3
16006_0,,,,2,2,1,3
C(CO)(C(C(C(O)O)O)C(C)O)=O,,,5,1,5,0,5
16006_1,,,,2,2,1,3
16007_0,,,,2,2,1,3
16007_1,,,,2,2,1,3
16008_0,,,,2,2,1,3
16008_1,,,,2,2,1,3
16010_0,,,,2,2,1,3
C(CC(CO)(CC(C(C)O)O)O)=O,,,5,1,1,0,1
16011_0,,,,2,2,1,3
16011_1,,,,2,2,1,3
16012_0,,,,2,2,1,3
16012_1,,,,2,2,1,3
16013_0,,,,2,2,1,3
16013_1,,,,2,2,1,3
16015_0,,,,2,2,1,3
C(CO)(C(C(C)O)C(C(C)O)O)=O,,,5,1,5,0,5
16015_1,,,,2,2,1,3
16016_0,,,,2,2,1,3
16016_1,,,,2,2,1,3
16017_0,,,,2,2,1,3
16017_1,,,,2,2,1,3
16018_0,,,,2,2,1,3
16018_1,,,,2,2,1,3
16019_0,,,,2,2,1,3
16019_1,,,,2,2,1,3
16020_0,,,,2,2,1,3
16020_1,,,,2,2,1,3
16021_0,,,,2,2,1,3
16021_1,,,,2,2,1,3
16022_0,,,,2,2,1,3
16024_0,,,,2,2,1,3
C(C(C)(CC(CO)(CC=O)O)O)=O,,,5,1,2,0,2
16025_0,,,,2,2,1,3
16025_1,,,,2,2,1,3
16026_0,,,,2,2,1,3
16026_1,,,,2,2,1,3
16027_0,,,,2,2,1,3
16027_1,,,,2,2,1,3
16029_0,,,,2,2,1,3
C(C(C)(C(C(CO)=O)C(C)O)O)=O,,,5,1,5,0,5
16029_1,,,,2,2,1,3
16030_0,,,,2,2,1,3
16030_1,,,,2,2,1,3
16031_0,,,,2,2,1,3
16031_1,,,,2,2,1,3
16032_0,,,,2,2,1,3
16034_0,,,,2,2,1,3
C(CC(CO)(CC(C(C)=O)O)O)=O,,,5,1,2,0,2
16035_0,,,,2,2,1,3
16036_0,,,,2,2,1,3
16037_0,,,,2,2,1,3
16038_0,,,,2,2,1,3
16038_1,,,,2,2,1,3
16039_0,,,,2,2,1,3
16039_1,,,,2,2,1,3
16040_0,,,,2,2,1,3
16040_1,,,,2,2,1,3
16042_0,,,,2,2,1,3
C(CO)(C(C(C)O)C(C(C)=O)O)=O,,,5,1,5,0,5
16042_1,,,,2,2,1,3
16043_0,,,,2,2,1,3
16043_1,,,,2,2,1,3
16044_0,,,,2,2,1,3
16044_1,,,,2,2,1,3
16046_0,,,,2,2,1,3
C(C(C=C)C(CO)(CC(C)O)O)=O,,,5,1,1,0,1
16048_0,,,,2,2,1,3
C(C(CC(CO)(CC(C)O)O)=O)=O,,,5,1,2,0,2
16050_0,,,,2,2,1,3
C(C(C=O)C(CO)(CC(C)O)O)=O,,,5,1,3,0,3
16050_1,,,,2,2,1,3
16052_0,,,,2,2,1,3
C(CC(CO)(CC(C)O)O)=O,,,5,1,2,0,2
16054_0,,,,2,2,1,3
C(C(CO)C(CO)(CC(C)O)O)=O,,,5,1,3,0,3
16054_1,,,,2,2,1,3
16056_0,,,,2,2,1,3
C(C)(C(C(CO)(CC(C)O)O)O)=O,,,5,1,3,0,3
16056_1,,,,2,2,1,3
16058_0,,,,2,2,1,3
C(CO)(CC(CO)(CC(C)O)O)=O,,,5,1,2,0,2
16060_0,,,,2,2,1,3
C(C(C(CO)(CC(C)O)O)O)=O,,,5,1,3,0,3
16060_1,,,,2,2,1,3
16062_0,,,,2,2,1,3
C(C(C(C=CC)O)O)(CC(C)O)=O,,,5,1,2,0,2
16062_1,,,,2,2,1,3
16064_0,,,,2,2,1,3
C(C(C(CC=C)O)O)(CC(C)O)=O,,,5,1,2,0,2
16064_1,,,,2,2,1,3
16066_0,,,,2,2,1,3
C(C(C(C=C)O)O)(CC(C)O)=O,,,5,1,2,0,2
16066_1,,,,2,2,1,3
16067_0,,,,2,2,1,3
16067_1,,,,2,2,1,3
16068_0,,,,2,2,1,3
16068_1,,,,2,2,1,3
16069_0,,,,2,2,1,3
16069_1,,,,2,2,1,3
16070_0,,,,2,2,1,3
16070_1,,,,2,2,1,3
16071_0,,,,2,2,1,3
16071_1,,,,2,2,1,3
16072_0,,,,2,2,1,3
16072_1,,,,2,2,1,3
16073_0,,,,2,2,1,3
16073_1,,,,2,2,1,3
16074_0,,,,2,2,1,3
16074_1,,,,2,2,1,3
16075_0,,,,2,2,1,3
16075_1,,,,2,2,1,3
16076_0,,,,2,2,1,3
16076_1,,,,2,2,1,3
16077_0,,,,2,2,1,3
16077_1,,,,2,2,1,3
16078_0,,,,2,2,1,3
16078_1,,,,2,2,1,3
16079_0,,,,2,2,1,3
16079_1,,,,2,2,1,3
16081_0,,,,2,2,1,3
C(CO)(C(C(C)O)C(C=CC)O)=O,,,5,1,2,0,2
16081_1,,,,2,2,1,3
16083_0,,,,2,2,1,3
C(CO)(C(C(CC=C)O)C(C)O)=O,,,5,1,2,0,2
16083_1,,,,2,2,1,3
16085_0,,,,2,2,1,3
C(CO)(C(C(C)O)C(C=C)O)=O,,,5,1,2,0,2
16085_1,,,,2,2,1,3
16086_0,,,,2,2,1,3
16086_1,,,,2,2,1,3
16087_0,,,,2,2,1,3
16087_1,,,,2,2,1,3
16088_0,,,,2,2,1,3
16088_1,,,,2,2,1,3
16089_0,,,,2,2,1,3
16089_1,,,,2,2,1,3
16090_0,,,,2,2,1,3
16090_1,,,,2,2,1,3
16092_0,,,,2,2,1,3
C(CO)(C(C(C)O)C(C)O)=O,,,5,1,3,0,3
16092_1,,,,2,2,1,3
16093_0,,,,2,2,1,3
16093_1,,,,2,2,1,3
16094_0,,,,2,2,1,3
16094_1,,,,2,2,1,3
16095_0,,,,2,2,1,3
16095_1,,,,2,2,1,3
16096_0,,,,2,2,1,3
16096_1,,,,2,2,1,3
16097_0,,,,2,2,1,3
16097_1,,,,2,2,1,3
16098_0,,,,2,2,1,3
16098_1,,,,2,2,1,3
16100_0,,,,2,2,1,3
C(CO)(C(C(CO)O)C(C)O)=O,,,5,1,6,0,6
16100_1,,,,2,2,1,3
16101_0,,,,2,2,1,3
16101_1,,,,2,2,1,3
16102_0,,,,2,2,1,3
16102_1,,,,2,2,1,3
16103_0,,,,2,2,1,3
16103_1,,,,2,2,1,3
16105_0,,,,2,2,1,3
C(CC(CO)(CC(CO)O)O)=O,,,5,1,3,0,3
16107_0,,,,2,2,1,3
C(C(C(CO)(CC(CO)O)O)O)=O,,,5,1,4,0,4
16107_1,,,,2,2,1,3
16109_0,,,,2,2,1,3
C(C(C(C=C)O)O)(CC(CO)O)=O,,,5,1,2,0,2
16109_1,,,,2,2,1,3
16110_0,,,,2,2,1,3
16110_1,,,,2,2,1,3
16111_0,,,,2,2,1,3
16111_1,,,,2,2,1,3
16112_0,,,,2,2,1,3
16112_1,,,,2,2,1,3
16113_0,,,,2,2,1,3
16113_1,,,,2,2,1,3
16114_0,,,,2,2,1,3
16114_1,,,,2,2,1,3
16116_0,,,,2,2,1,3
C(CO)(C(C(CO)O)C(C=C)O)=O,,,5,1,2,0,2
16116_1,,,,2,2,1,3
16117_0,,,,2,2,1,3
16117_1,,,,2,2,1,3
16118_0,,,,2,2,1,3
16118_1,,,,2,2,1,3
16119_0,,,,2,2,1,3
16119_1,,,,2,2,1,3
16120_0,,,,2,2,1,3
16120_1,,,,2,2,1,3
16122_0,,,,2,2,1,3
C(CO)(C(C(CO)O)C(CO)O)=O,,,5,1,4,0,4
16122_1,,,,2,2,1,3
16124_0,,,,2,2,1,3
C(CC(CC(CO)(CCO)O)O)=O,,,5,1,3,0,3
16125_0,,,,2,2,1,3
16125_1,,,,2,2,1,3
16126_0,,,,2,2,1,3
16126_1,,,,2,2,1,3
16127_0,,,,2,2,1,3
16127_1,,,,2,2,1,3
16129_0,,,,2,2,1,3
C(CC(CCO)(C(C(C)O)O)O)=O,,,5,1,2,0,2
16131_0,,,,2,2,1,3
C(C(C(C)O)O)(C(CO)C(C)O)=O,,,5,1,5,0,5
16131_1,,,,2,2,1,3
16133_0,,,,2,2,1,3
C(C(C(C(C(C)O)O)=O)CO)(O)=O,,,5,1,8,0,8
16133_1,,,,2,2,1,3
16135_0,,,,2,2,1,3
C(C(C(C)O)O)(C(CO)CO)=O,,,5,1,5,0,5
16135_1,,,,2,2,1,3
16137_0,,,,2,2,1,3
C(CC(CCO)(C(CO)O)O)=O,,,5,1,3,0,3
16139_0,,,,2,2,1,3
C(C(C(C(CO)O)(CCO)O)O)=O,,,5,1,5,0,5
16139_1,,,,2,2,1,3
16141_0,,,,2,2,1,3
C(C(CO)C(C=C)O)(C(CO)O)=O,,,5,1,2,0,2
16141_1,,,,2,2,1,3
16142_0,,,,2,2,1,3
16142_1,,,,2,2,1,3
16144_0,,,,2,2,1,3
C(C(CO)O)(C(CO)C(C)O)=O,,,5,1,9,0,9
16144_1,,,,2,2,1,3
16145_0,,,,2,2,1,3
16145_1,,,,2,2,1,3
16146_0,,,,2,2,1,3
16146_1,,,,2,2,1,3
16148_0,,,,2,2,1,3
C(C(CO)O)(C(CO)C(CO)O)=O,,,5,1,10,0,10
16148_1,,,,2,2,1,3
16150_0,,,,2,2,1,3
C(C(C(CO)O)O)(C(CO)CO)=O,,,5,1,7,0,7
16150_1,,,,2,2,1,3
16152_0,,,,2,2,1,3
C(C(CO)C(CO)(CC=O)O)(O)=O,,,5,1,6,0,6
16153_0,,,,2,2,1,3
16153_1,,,,2,2,1,3
16154_0,,,,2,2,1,3
16154_1,,,,2,2,1,3
16155_0,,,,2,2,1,3
16155_1,,,,2,2,1,3
16156_0,,,,2,2,1,3
16156_1,,,,2,2,1,3
16158_0,,,,2,2,1,3
C(CC(CO)(C(CO)C(C)O)O)=O,,,5,1,3,0,3
16159_0,,,,2,2,1,3
16159_1,,,,2,2,1,3
16160_0,,,,2,2,1,3
16160_1,,,,2,2,1,3
16161_0,,,,2,2,1,3
16161_1,,,,2,2,1,3
16163_0,,,,2,2,1,3
C(CC(CO)(C(CO)CO)O)=O,,,5,1,3,0,3
16165_0,,,,2,2,1,3
C(C(C(CO)(C(CO)CO)O)O)=O,,,5,1,4,0,4
16165_1,,,,2,2,1,3
16167_0,,,,2,2,1,3
C(C(C(C=C)O)O)(C(CO)CO)=O,,,5,1,2,0,2
16167_1,,,,2,2,1,3
16168_0,,,,2,2,1,3
16168_1,,,,2,2,1,3
16169_0,,,,2,2,1,3
16169_1,,,,2,2,1,3
16170_0,,,,2,2,1,3
16170_1,,,,2,2,1,3
16171_0,,,,2,2,1,3
16171_1,,,,2,2,1,3
16172_0,,,,2,2,1,3
16172_1,,,,2,2,1,3
16173_0,,,,2,2,1,3
16173_1,,,,2,2,1,3
16175_0,,,,2,2,1,3
C(CC(CC(C(CCO)O)O)O)=O,,,5,1,2,0,2
16176_0,,,,2,2,1,3
16176_1,,,,2,2,1,3
16177_0,,,,2,2,1,3
16177_1,,,,2,2,1,3
16178_0,,,,2,2,1,3
16178_1,,,,2,2,1,3
16180_0,,,,2,2,1,3
C(CC(CC(C)(C(CO)O)O)O)=O,,,5,1,2,0,2
16181_0,,,,2,2,1,3
16181_1,,,,2,2,1,3
16182_0,,,,2,2,1,3
16182_1,,,,2,2,1,3
16183_0,,,,2,2,1,3
16183_1,,,,2,2,1,3
16185_0,,,,2,2,1,3
C(CC(CC(C)O)(C(CO)O)O)=O,,,5,1,2,0,2
16187_0,,,,2,2,1,3
C(C(CO)O)(C(C(C)O)C(C)O)=O,,,5,1,3,0,3
16187_1,,,,2,2,1,3
16188_0,,,,2,2,1,3
16188_1,,,,2,2,1,3
16189_0,,,,2,2,1,3
16189_1,,,,2,2,1,3
16190_0,,,,2,2,1,3
16190_1,,,,2,2,1,3
16191_0,,,,2,2,1,3
16191_1,,,,2,2,1,3
16193_0,,,,2,2,1,3
C(C(C)(CC(CC=O)O)O)(O)=O,,,5,1,2,0,2
16195_0,,,,2,2,1,3
C(C(C)(CC(C(C=O)O)O)O)(O)=O,,,5,1,6,0,6
16195_1,,,,2,2,1,3
16197_0,,,,2,2,1,3
C(C(C)(C(C=O)C(C=C)O)O)(O)=O,,,5,1,2,0,2
16197_1,,,,2,2,1,3
16198_0,,,,2,2,1,3
16198_1,,,,2,2,1,3
16199_0,,,,2,2,1,3
16199_1,,,,2,2,1,3
16200_0,,,,2,2,1,3
16200_1,,,,2,2,1,3
16201_0,,,,2,2,1,3
16201_1,,,,2,2,1,3
16202_0,,,,2,2,1,3
16202_1,,,,2,2,1,3
16204_0,,,,2,2,1,3
C(CC(C(O)=O)(CC=O)O)(O)=O,,,5,1,6,0,6
16205_0,,,,2,2,1,3
16205_1,,,,2,2,1,3
16207_0,,,,2,2,1,3
C(C(C(C(O)=O)=O)C(C=C)O)(O)=O,,,5,1,2,0,2
16207_1,,,,2,2,1,3
16209_0,,,,2,2,1,3
C(C(C(C(O)=O)=O)C(C=O)O)(O)=O,,,5,1,7,0,7
16209_1,,,,2,2,1,3
16211_0,,,,2,2,1,3
C(C(C(C(O)=O)=O)C(C)O)(O)=O,,,5,1,8,0,8
16211_1,,,,2,2,1,3
16213_0,,,,2,2,1,3
C(C(C(O)=O)C(C(O)=O)=O)(O)=O,,,5,1,6,0,6
16213_1,,,,2,2,1,3
16214_0,,,,2,2,1,3
16214_1,,,,2,2,1,3
16215_0,,,,2,2,1,3
16215_1,,,,2,2,1,3
16216_0,,,,2,2,1,3
16216_1,,,,2,2,1,3
16217_0,,,,2,2,1,3
16217_1,,,,2,2,1,3
16218_0,,,,2,2,1,3
16220_0,,,,2,2,1,3
C(C(CC(C=O)O)(CC=O)O)(O)=O,,,5,1,4,0,4
16222_0,,,,2,2,1,3
C(C(C(C(C(O)=O)=O)C(C)O)O)=O,,,5,1,5,0,5
16222_1,,,,2,2,1,3
16223_0,,,,2,2,1,3
16223_1,,,,2,2,1,3
16224_0,,,,2,2,1,3
16224_1,,,,2,2,1,3
16225_0,,,,2,2,1,3
16225_1,,,,2,2,1,3
16226_0,,,,2,2,1,3
16226_1,,,,2,2,1,3
16227_0,,,,2,2,1,3
16228_0,,,,2,2,1,3
16228_1,,,,2,2,1,3
16229_0,,,,2,2,1,3
16229_1,,,,2,2,1,3
16230_0,,,,2,2,1,3
16230_1,,,,2,2,1,3
16232_0,,,,2,2,1,3
C(C(CC(C)O)(CC=O)O)(O)=O,,,5,1,2,0,2
16234_0,,,,2,2,1,3
C(C(CC(C)O)(C(C=O)O)O)(O)=O,,,5,1,4,0,4
16234_1,,,,2,2,1,3
16236_0,,,,2,2,1,3
C=CC(C(C(C(O)=O)=O)C(C)O)O,,,5,1,2,0,2
16236_1,,,,2,2,1,3
16237_0,,,,2,2,1,3
16237_1,,,,2,2,1,3
16239_0,,,,2,2,1,3
C(C(C(C(C)O)C(C)O)=O)(O)=O,,,5,1,3,0,3
16239_1,,,,2,2,1,3
16240_0,,,,2,2,1,3
16240_1,,,,2,2,1,3
16241_0,,,,2,2,1,3
16241_1,,,,2,2,1,3
16242_0,,,,2,2,1,3
16242_1,,,,2,2,1,3
16243_0,,,,2,2,1,3
16243_1,,,,2,2,1,3
16245_0,,,,2,2,1,3
C(CC(CC(CC=O)O)O)(O)=O,,,5,1,2,0,2
16247_0,,,,2,2,1,3
C(CC(CC(C(C=O)O)O)O)(O)=O,,,5,1,3,0,3
16247_1,,,,2,2,1,3
16249_0,,,,2,2,1,3
C(CC(C(C=O)C(C=C)O)O)(O)=O,,,5,1,2,0,2
16249_1,,,,2,2,1,3
16250_0,,,,2,2,1,3
16250_1,,,,2,2,1,3
16251_0,,,,2,2,1,3
16251_1,,,,2,2,1,3
16252_0,,,,2,2,1,3
16252_1,,,,2,2,1,3
16253_0,,,,2,2,1,3
16253_1,,,,2,2,1,3
16254_0,,,,2,2,1,3
16254_1,,,,2,2,1,3
16256_0,,,,2,2,1,3
C(CC(C(C(CC=O)O)O)O)(O)=O,,,5,1,2,0,2
16258_0,,,,2,2,1,3
C(C(C(O)=O)C(CC=O)O)(O)=O,,,5,1,4,0,4
16260_0,,,,2,2,1,3
C(C(C(O)=O)C(C(C=O)O)O)(O)=O,,,5,1,5,0,5
16260_1,,,,2,2,1,3
16261_0,,,,2,2,1,3
16262_0,,,,2,2,1,3
16263_0,,,,2,2,1,3
16263_1,,,,2,2,1,3
16265_0,,,,2,2,1,3
C(C(C(CO)CO)(CC=O)O)(O)=O,,,5,1,4,0,4
16266_0,,,,2,2,1,3
16266_1,,,,2,2,1,3
16267_0,,,,2,2,1,3
16267_1,,,,2,2,1,3
16268_0,,,,2,2,1,3
16268_1,,,,2,2,1,3
16269_0,,,,2,2,1,3
16269_1,,,,2,2,1,3
16270_0,,,,2,2,1,3
16270_1,,,,2,2,1,3
16271_0,,,,2,2,1,3
16271_1,,,,2,2,1,3
16272_0,,,,2,2,1,3
16272_1,,,,2,2,1,3
16273_0,,,,2,2,1,3
16273_1,,,,2,2,1,3
16275_0,,,,2,2,1,3
C(C(CO)(CC(CC=O)O)O)(O)=O,,,5,1,5,0,5
16276_0,,,,2,2,1,3
16276_1,,,,2,2,1,3
16277_0,,,,2,2,1,3
16277_1,,,,2,2,1,3
16278_0,,,,2,2,1,3
16278_1,,,,2,2,1,3
16279_0,,,,2,2,1,3
16280_0,,,,2,2,1,3
16281_0,,,,2,2,1,3
16283_0,,,,2,2,1,3
C(CC(C(CC=O)O)(CC=O)O)=O,,,5,1,2,0,2
16284_0,,,,2,2,1,3
16284_1,,,,2,2,1,3
16285_0,,,,2,2,1,3
16285_1,,,,2,2,1,3
16286_0,,,,2,2,1,3
16286_1,,,,2,2,1,3
16288_0,,,,2,2,1,3
C(CC(CC(C(CC=O)=O)O)O)=O,,,5,1,2,0,2
16289_0,,,,2,2,1,3
16290_0,,,,2,2,1,3
16291_0,,,,2,2,1,3
16291_1,,,,2,2,1,3
16292_0,,,,2,2,1,3
16292_1,,,,2,2,1,3
16293_0,,,,2,2,1,3
16293_1,,,,2,2,1,3
16295_0,,,,2,2,1,3
C(CC(C(C(C=O)C(C)O)=O)O)=O,,,5,1,4,0,4
16295_1,,,,2,2,1,3
16297_0,,,,2,2,1,3
C(C(C=O)C(C(CC=O)O)=O)(O)=O,,,5,1,4,0,4
16297_1,,,,2,2,1,3
16298_0,,,,2,2,1,3
16298_1,,,,2,2,1,3
16299_0,,,,2,2,1,3
16300_0,,,,2,2,1,3
16301_0,,,,2,2,1,3
16302_0,,,,2,2,1,3
16303_0,,,,2,2,1,3
16304_0,,,,2,2,1,3
16305_0,,,,2,2,1,3
16305_1,,,,2,2,1,3
16307_0,,,,2,2,1,3
C(C(CO)C(C=O)(CC=O)O)(O)=O,,,5,1,5,0,5
16308_0,,,,2,2,1,3
16309_0,,,,2,2,1,3
16309_1,,,,2,2,1,3
16310_0,,,,2,2,1,3
16311_0,,,,2,2,1,3
16313_0,,,,2,2,1,3
C(CC(CC1(COCC1O)O)O)=O,,,5,1,1,0,1
16314_0,,,,2,2,1,3
16314_1,,,,2,2,1,3
16315_0,,,,2,2,1,3
16315_1,,,,2,2,1,3
16316_0,,,,2,2,1,3
16316_1,,,,2,2,1,3
16318_0,,,,2,2,1,3
C(CC1(C(COC1C(O)=O)O)O)=O,,,5,1,1,0,1
16320_0,,,,2,2,1,3
C(CC1(C(C(C)O)OCC1O)O)=O,,,5,1,1,0,1
16322_0,,,,2,2,1,3
C(CC1(C(CO)OCC1O)O)=O,,,5,1,1,0,1
16324_0,,,,2,2,1,3
C(C(C1(C(CO)OCC1O)O)O)=O,,,5,1,2,0,2
16324_1,,,,2,2,1,3
16326_0,,,,2,2,1,3
C(CC(CC1(C(O)OCC1)O)O)=O,,,5,1,2,0,2
16327_0,,,,2,2,1,3
16327_1,,,,2,2,1,3
16328_0,,,,2,2,1,3
16328_1,,,,2,2,1,3
16329_0,,,,2,2,1,3
16329_1,,,,2,2,1,3
16331_0,,,,2,2,1,3
C(C1COC(C1(CC=O)O)O)(O)=O,,,5,1,1,0,1
16333_0,,,,2,2,1,3
C(CC1(C(O)OCC1C(C)O)O)=O,,,5,1,2,0,2
16335_0,,,,2,2,1,3
C(CC1(C(O)OCC1CO)O)=O,,,5,1,2,0,2
16337_0,,,,2,2,1,3
C(C(C1(C(O)OCC1CO)O)O)=O,,,5,1,3,0,3
16337_1,,,,2,2,1,3
16339_0,,,,2,2,1,3
C(CC(CC1(COC(C1)O)O)O)=O,,,5,1,2,0,2
16340_0,,,,2,2,1,3
16340_1,,,,2,2,1,3
16341_0,,,,2,2,1,3
16341_1,,,,2,2,1,3
16342_0,,,,2,2,1,3
16342_1,,,,2,2,1,3
16344_0,,,,2,2,1,3
C(C1C(O)OCC1(CC=O)O)(O)=O,,,5,1,3,0,3
16346_0,,,,2,2,1,3
C(C1C(C(C(C)O)OC1O)=O)(O)=O,,,5,1,5,0,5
16346_1,,,,2,2,1,3
16348_0,,,,2,2,1,3
C(C1C(C(C(O)=O)OC1O)=O)(O)=O,,,5,1,4,0,4
16348_1,,,,2,2,1,3
16350_0,,,,2,2,1,3
C(C1C(C(CO)OC1O)=O)(O)=O,,,5,1,5,0,5
16350_1,,,,2,2,1,3
16352_0,,,,2,2,1,3
C1(C(CO)OC(C1C(C=O)O)O)=O,,,5,1,5,0,5
16352_1,,,,2,2,1,3
16354_0,,,,2,2,1,3
C(CC1(COC(C1C(C)O)O)O)=O,,,5,1,2,0,2
16356_0,,,,2,2,1,3
C1(C(C(C)O)OC(C1C(C)O)O)=O,,,5,1,5,0,5
16356_1,,,,2,2,1,3
16358_0,,,,2,2,1,3
C(C1C(C(C(O1)O)C(C)O)=O)(O)=O,,,5,1,5,0,5
16358_1,,,,2,2,1,3
16360_0,,,,2,2,1,3
C1(C(CO)OC(C1C(C)O)O)=O,,,5,1,6,0,6
16360_1,,,,2,2,1,3
16362_0,,,,2,2,1,3
C(CC1(COC(C1CO)O)O)=O,,,5,1,3,0,3
16364_0,,,,2,2,1,3
C(C(C1(COC(C1CO)O)O)O)=O,,,5,1,3,0,3
16364_1,,,,2,2,1,3
16366_0,,,,2,2,1,3
C1(C(C(C=C)O)OC(C1CO)O)=O,,,5,1,2,0,2
16366_1,,,,2,2,1,3
16368_0,,,,2,2,1,3
C(C(C1C(C(C(O1)O)CO)=O)O)=O,,,5,1,5,0,5
16368_1,,,,2,2,1,3
16370_0,,,,2,2,1,3
C1(C(C(C)O)OC(C1CO)O)=O,,,5,1,5,0,5
16370_1,,,,2,2,1,3
16372_0,,,,2,2,1,3
C(C1C(C(CO)C(O1)O)=O)(O)=O,,,5,1,5,0,5
16372_1,,,,2,2,1,3
16373_0,,,,2,2,1,3
16373_1,,,,2,2,1,3
16375_0,,,,2,2,1,3
C1(C(C(CO)O)OC(C1CO)O)=O,,,5,1,5,0,5
16375_1,,,,2,2,1,3
16377_0,,,,2,2,1,3
C1(C(CO)OC(C1C(CO)O)O)=O,,,5,1,5,0,5
16377_1,,,,2,2,1,3
16379_0,,,,2,2,1,3
C(CC1(CC(OC1C(O)=O)O)O)=O,,,5,1,1,0,1
16380_0,,,,2,2,1,3
16380_1,,,,2,2,1,3
16381_0,,,,2,2,1,3
16381_1,,,,2,2,1,3
16382_0,,,,2,2,1,3
16382_1,,,,2,2,1,3
16383_0,,,,2,2,1,3
16383_1,,,,2,2,1,3
16385_0,,,,2,2,1,3
C(CC1(C(C(C)O)OC(C1)O)O)=O,,,5,1,2,0,2
16386_0,,,,2,2,1,3
16386_1,,,,2,2,1,3
16387_0,,,,2,2,1,3
16387_1,,,,2,2,1,3
16388_0,,,,2,2,1,3
16388_1,,,,2,2,1,3
16390_0,,,,2,2,1,3
C(CC1(C(CO)OC(C1)O)O)=O,,,5,1,2,0,2
16392_0,,,,2,2,1,3
C(C(C1(C(CO)OC(C1)O)O)O)=O,,,5,1,3,0,3
16392_1,,,,2,2,1,3
16394_0,,,,2,2,1,3
C1(C(CO)OC(C1C(C=C)O)O)=O,,,5,1,2,0,2
16394_1,,,,2,2,1,3
16395_0,,,,2,2,1,3
16395_1,,,,2,2,1,3
16396_0,,,,2,2,1,3
16396_1,,,,2,2,1,3
16397_0,,,,2,2,1,3
16397_1,,,,2,2,1,3
16398_0,,,,2,2,1,3
16398_1,,,,2,2,1,3
16399_0,,,,2,2,1,3
16399_1,,,,2,2,1,3
16400_0,,,,2,2,1,3
16400_1,,,,2,2,1,3
16402_0,,,,2,2,1,3
C(CC(CC(C=O)(C(C)=O)O)O)=O,,,5,1,1,0,1
16403_0,,,,2,2,1,3
16405_0,,,,2,2,1,3
C(CC(C)(C(C=O)(CC=O)O)O)=O,,,5,1,3,0,3
16406_0,,,,2,2,1,3
16406_1,,,,2,2,1,3
16407_0,,,,2,2,1,3
16407_1,,,,2,2,1,3
16408_0,,,,2,2,1,3
16408_1,,,,2,2,1,3
16410_0,,,,2,2,1,3
C(CC(C)O)(C(C=O)(CC=O)O)=O,,,5,1,2,0,2
16412_0,,,,2,2,1,3
C(C(C(CC(O)=O)=O)(CC=O)O)=O,,,5,1,2,0,2
16413_0,,,,2,2,1,3
16415_0,,,,2,2,1,3
C(CC(CC(C(C(C)=O)=O)O)O)=O,,,5,1,1,0,1
16416_0,,,,2,2,1,3
16418_0,,,,2,2,1,3
C(CC(C(C(C)(CC=O)O)=O)O)=O,,,5,1,2,0,2
16419_0,,,,2,2,1,3
16419_1,,,,2,2,1,3
16420_0,,,,2,2,1,3
16420_1,,,,2,2,1,3
16421_0,,,,2,2,1,3
16421_1,,,,2,2,1,3
16423_0,,,,2,2,1,3
C(CC(C(C(CC(C)O)=O)=O)O)=O,,,5,1,2,0,2
16425_0,,,,2,2,1,3
C(CC(C(C(CC=O)O)=O)=O)(O)=O,,,5,1,2,0,2
16426_0,,,,2,2,1,3
16428_0,,,,2,2,1,3
C(CC(CC(C(C=O)=O)(C)O)O)=O,,,5,1,2,0,2
16429_0,,,,2,2,1,3
16430_0,,,,2,2,1,3
16431_0,,,,2,2,1,3
16431_1,,,,2,2,1,3
16432_0,,,,2,2,1,3
16432_1,,,,2,2,1,3
16433_0,,,,2,2,1,3
16433_1,,,,2,2,1,3
16434_0,,,,2,2,1,3
16435_0,,,,2,2,1,3
16437_0,,,,2,2,1,3
C(CC(C(C=O)=O)(CC=O)O)(O)=O,,,5,1,1,0,1
16439_0,,,,2,2,1,3
C(C(C(C(C=O)=O)=O)C(C)O)(O)=O,,,5,1,4,0,4
16439_1,,,,2,2,1,3
16441_0,,,,2,2,1,3
C(C(C(O)=O)C(C(C=O)=O)=O)(O)=O,,,5,1,2,0,2
16441_1,,,,2,2,1,3
16443_0,,,,2,2,1,3
C(C(C(C(C=O)=O)=O)CO)(O)=O,,,5,1,7,0,7
16443_1,,,,2,2,1,3
16445_0,,,,2,2,1,3
C(C(C(C(C(C=O)=O)=O)CO)O)=O,,,5,1,4,0,4
16445_1,,,,2,2,1,3
16446_0,,,,2,2,1,3
16447_0,,,,2,2,1,3
16449_0,,,,2,2,1,3
C(CC(C(C=O)=O)(CC(C)O)O)=O,,,5,1,2,0,2
16451_0,,,,2,2,1,3
C(C(C(C(C(C)O)C(C)O)=O)=O)=O,,,5,1,2,0,2
16451_1,,,,2,2,1,3
16452_0,,,,2,2,1,3
16452_1,,,,2,2,1,3
16454_0,,,,2,2,1,3
C(C(C(C(CO)C(C)O)=O)=O)=O,,,5,1,5,0,5
16454_1,,,,2,2,1,3
16455_0,,,,2,2,1,3
16456_0,,,,2,2,1,3
16456_1,,,,2,2,1,3
16457_0,,,,2,2,1,3
16458_0,,,,2,2,1,3
16458_1,,,,2,2,1,3
16460_0,,,,2,2,1,3
C(CC(C(C=O)=O)(CCO)O)=O,,,5,1,3,0,3
16462_0,,,,2,2,1,3
C(C(C(C(C=O)=O)(CCO)O)O)=O,,,5,1,4,0,4
16462_1,,,,2,2,1,3
16464_0,,,,2,2,1,3
C=CC(C(C(C(C=O)=O)=O)CO)O,,,5,1,2,0,2
16464_1,,,,2,2,1,3
16465_0,,,,2,2,1,3
16465_1,,,,2,2,1,3
16466_0,,,,2,2,1,3
16466_1,,,,2,2,1,3
16467_0,,,,2,2,1,3
16467_1,,,,2,2,1,3
16468_0,,,,2,2,1,3
16468_1,,,,2,2,1,3
16470_0,,,,2,2,1,3
C(C(C(C(CO)C(CO)O)=O)=O)=O,,,5,1,5,0,5
16470_1,,,,2,2,1,3
16471_0,,,,2,2,1,3
16471_1,,,,2,2,1,3
16472_0,,,,2,2,1,3
16472_1,,,,2,2,1,3
16474_0,,,,2,2,1,3
C(C(C=C)C(CC(C=O)(C=C)O)O)=O,,,5,1,1,0,1
16476_0,,,,2,2,1,3
C(C(C=C)(CC(CC=O)O)O)=O,,,5,1,3,0,3
16478_0,,,,2,2,1,3
C(C(C=C)(CC(C(C=O)O)O)O)=O,,,5,1,2,0,2
16478_1,,,,2,2,1,3
16480_0,,,,2,2,1,3
C(C(C=C)C(C(C=C)(CC=O)O)O)=O,,,5,1,1,0,1
16482_0,,,,2,2,1,3
C(CC(C(C=C)(CC=O)O)O)=O,,,5,1,4,0,4
16484_0,,,,2,2,1,3
C(C(C(C(C=C)(CC=O)O)O)O)=O,,,5,1,3,0,3
16484_1,,,,2,2,1,3
16486_0,,,,2,2,1,3
C(C(C=C)(C(C=O)C(C=CC)O)O)=O,,,5,1,2,0,2
16486_1,,,,2,2,1,3
16488_0,,,,2,2,1,3
C(C(C=C)(C(C=O)C(CC=C)O)O)=O,,,5,1,2,0,2
16488_1,,,,2,2,1,3
16490_0,,,,2,2,1,3
C(C(C=C)(C(C=O)C(C=C)O)O)=O,,,5,1,2,0,2
16490_1,,,,2,2,1,3
16491_0,,,,2,2,1,3
16491_1,,,,2,2,1,3
16492_0,,,,2,2,1,3
16492_1,,,,2,2,1,3
16493_0,,,,2,2,1,3
16493_1,,,,2,2,1,3
16494_0,,,,2,2,1,3
16494_1,,,,2,2,1,3
16495_0,,,,2,2,1,3
16495_1,,,,2,2,1,3
16497_0,,,,2,2,1,3
C(C(C=C)(C(C(CC=O)O)O)O)=O,,,5,1,2,0,2
16499_0,,,,2,2,1,3
C(CC(C(C=C)(C(C=O)O)O)O)=O,,,5,1,3,0,3
16500_0,,,,2,2,1,3
16500_1,,,,2,2,1,3
16502_0,,,,2,2,1,3
C(C(C=C)C(CC(C(C=C)=O)O)O)=O,,,5,1,1,0,1
16504_0,,,,2,2,1,3
C(CC(CC(C(C=C)=O)O)O)=O,,,5,1,2,0,2
16506_0,,,,2,2,1,3
C(C(C(CC(C(C=C)=O)O)O)O)=O,,,5,1,2,0,2
16506_1,,,,2,2,1,3
16508_0,,,,2,2,1,3
C(CC(C(C=C)(C(C=O)C=C)O)O)=O,,,5,1,1,0,1
16509_0,,,,2,2,1,3
16510_0,,,,2,2,1,3
16510_1,,,,2,2,1,3
16512_0,,,,2,2,1,3
C(C(C(C=CC)O)C(C(C=C)=O)O)=O,,,5,1,2,0,2
16512_1,,,,2,2,1,3
16514_0,,,,2,2,1,3
C(C(C(CC=C)O)C(C(C=C)=O)O)=O,,,5,1,2,0,2
16514_1,,,,2,2,1,3
16516_0,,,,2,2,1,3
C(C(C(C=C)O)C(C(C=C)=O)O)=O,,,5,1,2,0,2
16516_1,,,,2,2,1,3
16517_0,,,,2,2,1,3
16517_1,,,,2,2,1,3
16518_0,,,,2,2,1,3
16518_1,,,,2,2,1,3
16519_0,,,,2,2,1,3
16519_1,,,,2,2,1,3
16520_0,,,,2,2,1,3
16520_1,,,,2,2,1,3
16521_0,,,,2,2,1,3
16521_1,,,,2,2,1,3
16523_0,,,,2,2,1,3
C(CC(C(C(C(C=C)=O)O)O)O)=O,,,5,1,3,0,3
16524_0,,,,2,2,1,3
16525_0,,,,2,2,1,3
16525_1,,,,2,2,1,3
16527_0,,,,2,2,1,3
C(C(C=C)C(CC(C=CC=O)O)O)=O,,,5,1,1,0,1
16529_0,,,,2,2,1,3
C(CC(CC(C=CC=O)O)O)=O,,,5,1,3,0,3
16531_0,,,,2,2,1,3
C(C(C(CC(C=CC=O)O)O)O)=O,,,5,1,2,0,2
16531_1,,,,2,2,1,3
16533_0,,,,2,2,1,3
C(C(C=C)C(C=CC(CC=O)O)O)=O,,,5,1,1,0,1
16535_0,,,,2,2,1,3
C(CC(C=CC(CC=O)O)O)=O,,,5,1,2,0,2
16537_0,,,,2,2,1,3
C(C(C(C=CC(CC=O)O)O)O)=O,,,5,1,3,0,3
16537_1,,,,2,2,1,3
16539_0,,,,2,2,1,3
C(C(C(C=CC)O)C(C=CC=O)O)=O,,,5,1,2,0,2
16539_1,,,,2,2,1,3
16541_0,,,,2,2,1,3
C(C(C(CC=C)O)C(C=CC=O)O)=O,,,5,1,2,0,2
16541_1,,,,2,2,1,3
16543_0,,,,2,2,1,3
C(C(C(C=C)O)C(C=CC=O)O)=O,,,5,1,2,0,2
16543_1,,,,2,2,1,3
16544_0,,,,2,2,1,3
16544_1,,,,2,2,1,3
16545_0,,,,2,2,1,3
16545_1,,,,2,2,1,3
16546_0,,,,2,2,1,3
16546_1,,,,2,2,1,3
16547_0,,,,2,2,1,3
16547_1,,,,2,2,1,3
16548_0,,,,2,2,1,3
16548_1,,,,2,2,1,3
16550_0,,,,2,2,1,3
C(CC(C(C(C=CC=O)O)O)O)=O,,,5,1,1,0,1
16551_0,,,,2,2,1,3
16552_0,,,,2,2,1,3
16552_1,,,,2,2,1,3
16554_0,,,,2,2,1,3
C(C(C=C)C(C(C(O)=O)C=O)O)=O,,,5,1,3,0,3
16555_0,,,,2,2,1,3
16556_0,,,,2,2,1,3
16556_1,,,,2,2,1,3
16557_0,,,,2,2,1,3
16558_0,,,,2,2,1,3
16558_1,,,,2,2,1,3
16559_0,,,,2,2,1,3
16559_1,,,,2,2,1,3
16560_0,,,,2,2,1,3
16561_0,,,,2,2,1,3
16561_1,,,,2,2,1,3
16562_0,,,,2,2,1,3
16563_0,,,,2,2,1,3
16564_0,,,,2,2,1,3
16564_1,,,,2,2,1,3
16566_0,,,,2,2,1,3
C(C(C=O)C(C(C(O)=O)O)=O)(O)=O,,,5,1,4,0,4
16566_1,,,,2,2,1,3
16567_0,,,,2,2,1,3
16567_1,,,,2,2,1,3
16568_0,,,,2,2,1,3
16570_0,,,,2,2,1,3
C(CC(C(C(O)=O)O)(CC=O)O)=O,,,5,1,2,0,2
16571_0,,,,2,2,1,3
16571_1,,,,2,2,1,3
16572_0,,,,2,2,1,3
16572_1,,,,2,2,1,3
16573_0,,,,2,2,1,3
16573_1,,,,2,2,1,3
16574_0,,,,2,2,1,3
16576_0,,,,2,2,1,3
C(CC(C(C=O)O)(CC=O)O)(O)=O,,,5,1,3,0,3
16577_0,,,,2,2,1,3
16577_1,,,,2,2,1,3
16579_0,,,,2,2,1,3
C(C(C(O)=O)C(C(C=O)O)=O)(O)=O,,,5,1,2,0,2
16579_1,,,,2,2,1,3
16580_0,,,,2,2,1,3
16580_1,,,,2,2,1,3
16582_0,,,,2,2,1,3
C(C(C(C(C=O)C(C)=O)O)O)(O)=O,,,5,1,3,0,3
16582_1,,,,2,2,1,3
16584_0,,,,2,2,1,3
C(CC(C(C(O)=O)O)O)(CC=O)=O,,,5,1,4,0,4
16586_0,,,,2,2,1,3
C(C(C(C(C(C=C)=O)O)O)O)(O)=O,,,5,1,7,0,7
16586_1,,,,2,2,1,3
16588_0,,,,2,2,1,3
C(C(C(C(C(C=O)=O)C)O)O)(O)=O,,,5,1,4,0,4
16589_0,,,,2,2,1,3
16591_0,,,,2,2,1,3
C(C(C(CC(C(C)=O)=O)O)O)(O)=O,,,5,1,4,0,4
16593_0,,,,2,2,1,3
C(C(C=C)C(C(C(O)=O)O)O)=O,,,5,1,3,0,3
16595_0,,,,2,2,1,3
C(C(C(C1C(C=CO1)=O)O)O)(O)=O,,,5,1,2,0,2
16595_1,,,,2,2,1,3
16596_0,,,,2,2,1,3
16596_1,,,,2,2,1,3
16597_0,,,,2,2,1,3
16599_0,,,,2,2,1,3
C(C(C=O)C(C(C(O)=O)O)O)=O,,,5,1,8,0,8
16599_1,,,,2,2,1,3
16600_0,,,,2,2,1,3
16601_0,,,,2,2,1,3
16601_1,,,,2,2,1,3
16602_0,,,,2,2,1,3
16602_1,,,,2,2,1,3
16603_0,,,,2,2,1,3
16603_1,,,,2,2,1,3
16604_0,,,,2,2,1,3
16604_1,,,,2,2,1,3
16605_0,,,,2,2,1,3
16606_0,,,,2,2,1,3
16607_0,,,,2,2,1,3
16607_1,,,,2,2,1,3
16608_0,,,,2,2,1,3
16608_1,,,,2,2,1,3
16609_0,,,,2,2,1,3
16609_1,,,,2,2,1,3
16611_0,,,,2,2,1,3
C(C(CC(C(O)O)O)(CC=O)O)=O,,,5,1,1,0,1
16612_0,,,,2,2,1,3
16613_0,,,,2,2,1,3
16613_1,,,,2,2,1,3
16614_0,,,,2,2,1,3
16614_1,,,,2,2,1,3
16615_0,,,,2,2,1,3
16615_1,,,,2,2,1,3
16616_0,,,,2,2,1,3
16618_0,,,,2,2,1,3
C(C(C=C)C(CC(C(O)O)O)O)=O,,,5,1,1,0,1
16620_0,,,,2,2,1,3
C(C(CC(CC(C(O)O)O)O)=O)=O,,,5,1,1,0,1
16622_0,,,,2,2,1,3
C(C(C=O)C(CC(C(O)O)O)O)=O,,,5,1,2,0,2
16622_1,,,,2,2,1,3
16624_0,,,,2,2,1,3
C(CC(CC(C(O)O)O)O)=O,,,5,1,1,0,1
16626_0,,,,2,2,1,3
C(C(CO)C(CC(C(O)O)O)O)=O,,,5,1,2,0,2
16626_1,,,,2,2,1,3
16628_0,,,,2,2,1,3
C(C)(C(C(CC(C(O)O)O)O)O)=O,,,5,1,2,0,2
16628_1,,,,2,2,1,3
16630_0,,,,2,2,1,3
C(CO)(CC(CC(C(O)O)O)O)=O,,,5,1,1,0,1
16632_0,,,,2,2,1,3
C(C(C(CC(C(O)O)O)O)O)=O,,,5,1,2,0,2
16632_1,,,,2,2,1,3
16634_0,,,,2,2,1,3
C(C(C(C(O)O)O)C(C=CC)O)=O,,,5,1,2,0,2
16634_1,,,,2,2,1,3
16636_0,,,,2,2,1,3
C(C(C(CC=C)O)C(C(O)O)O)=O,,,5,1,2,0,2
16636_1,,,,2,2,1,3
16638_0,,,,2,2,1,3
C(C(C(C(O)O)O)C(C=C)O)=O,,,5,1,2,0,2
16638_1,,,,2,2,1,3
16639_0,,,,2,2,1,3
16639_1,,,,2,2,1,3
16640_0,,,,2,2,1,3
16640_1,,,,2,2,1,3
16641_0,,,,2,2,1,3
16641_1,,,,2,2,1,3
16642_0,,,,2,2,1,3
16642_1,,,,2,2,1,3
16643_0,,,,2,2,1,3
16643_1,,,,2,2,1,3
16644_0,,,,2,2,1,3
16644_1,,,,2,2,1,3
16645_0,,,,2,2,1,3
16645_1,,,,2,2,1,3
16646_0,,,,2,2,1,3
16646_1,,,,2,2,1,3
16647_0,,,,2,2,1,3
16647_1,,,,2,2,1,3
16649_0,,,,2,2,1,3
C(C(C(C(O)O)O)C(C(O)O)O)=O,,,5,1,2,0,2
16649_1,,,,2,2,1,3
16651_0,,,,2,2,1,3
C(C(C(C(O)O)O)C(C(C)O)O)=O,,,5,1,4,0,4
16651_1,,,,2,2,1,3
16652_0,,,,2,2,1,3
16652_1,,,,2,2,1,3
16653_0,,,,2,2,1,3
16653_1,,,,2,2,1,3
16655_0,,,,2,2,1,3
C(CC(C(C(C(O)O)O)O)O)=O,,,5,1,1,0,1
16657_0,,,,2,2,1,3
C(C(C(C(C(C(O)O)O)O)O)O)=O,,,5,1,4,0,4
16657_1,,,,2,2,1,3
16658_0,,,,2,2,1,3
16658_1,,,,2,2,1,3
16660_0,,,,2,2,1,3
C(C(CC(C(C)O)O)(CC=O)O)=O,,,5,1,1,0,1
16661_0,,,,2,2,1,3
16662_0,,,,2,2,1,3
16662_1,,,,2,2,1,3
16663_0,,,,2,2,1,3
16663_1,,,,2,2,1,3
16664_0,,,,2,2,1,3
16664_1,,,,2,2,1,3
16665_0,,,,2,2,1,3
16667_0,,,,2,2,1,3
C(C(C=C)C(CC(C(C)O)O)O)=O,,,5,1,1,0,1
16669_0,,,,2,2,1,3
C(C(CC(CC(C(C)O)O)O)=O)=O,,,5,1,1,0,1
16671_0,,,,2,2,1,3
C(C(C=O)C(CC(C(C)O)O)O)=O,,,5,1,2,0,2
16671_1,,,,2,2,1,3
16673_0,,,,2,2,1,3
C(CC(CC(C(C)O)O)O)=O,,,5,1,1,0,1
16675_0,,,,2,2,1,3
C(C(CO)C(CC(C(C)O)O)O)=O,,,5,1,2,0,2
16675_1,,,,2,2,1,3
16677_0,,,,2,2,1,3
C(C)(C(C(CC(C(C)O)O)O)O)=O,,,5,1,2,0,2
16677_1,,,,2,2,1,3
16679_0,,,,2,2,1,3
C(CO)(CC(CC(C(C)O)O)O)=O,,,5,1,1,0,1
16681_0,,,,2,2,1,3
C(C(C(CC(C(C)O)O)O)O)=O,,,5,1,2,0,2
16681_1,,,,2,2,1,3
16683_0,,,,2,2,1,3
C(C(C(C(C)O)O)C(C=CC)O)=O,,,5,1,2,0,2
16683_1,,,,2,2,1,3
16685_0,,,,2,2,1,3
C(C(C(CC=C)O)C(C(C)O)O)=O,,,5,1,2,0,2
16685_1,,,,2,2,1,3
16687_0,,,,2,2,1,3
C(C(C(C(C)O)O)C(C=C)O)=O,,,5,1,2,0,2
16687_1,,,,2,2,1,3
16688_0,,,,2,2,1,3
16688_1,,,,2,2,1,3
16689_0,,,,2,2,1,3
16689_1,,,,2,2,1,3
16690_0,,,,2,2,1,3
16690_1,,,,2,2,1,3
16691_0,,,,2,2,1,3
16691_1,,,,2,2,1,3
16692_0,,,,2,2,1,3
16692_1,,,,2,2,1,3
16693_0,,,,2,2,1,3
16693_1,,,,2,2,1,3
16694_0,,,,2,2,1,3
16694_1,,,,2,2,1,3
16695_0,,,,2,2,1,3
16695_1,,,,2,2,1,3
16696_0,,,,2,2,1,3
16696_1,,,,2,2,1,3
16697_0,,,,2,2,1,3
16697_1,,,,2,2,1,3
16699_0,,,,2,2,1,3
C(C(C(C(C)O)O)C(C(C)O)O)=O,,,5,1,2,0,2
16699_1,,,,2,2,1,3
16700_0,,,,2,2,1,3
16700_1,,,,2,2,1,3
16701_0,,,,2,2,1,3
16701_1,,,,2,2,1,3
16703_0,,,,2,2,1,3
C(CC(C(C(C(C)O)O)O)O)=O,,,5,1,2,0,2
16705_0,,,,2,2,1,3
C(C(C(C(C(C(C)O)O)O)O)O)=O,,,5,1,9,0,9
16705_1,,,,2,2,1,3
16706_0,,,,2,2,1,3
16707_0,,,,2,2,1,3
16709_0,,,,2,2,1,3
C(C(C=C)C(C(C(O)=O)(C)O)O)=O,,,5,1,2,0,2
16710_0,,,,2,2,1,3
16712_0,,,,2,2,1,3
C(C(C=O)C(C(C(O)=O)(C)O)O)=O,,,5,1,4,0,4
16712_1,,,,2,2,1,3
16713_0,,,,2,2,1,3
16714_0,,,,2,2,1,3
16714_1,,,,2,2,1,3
16715_0,,,,2,2,1,3
16715_1,,,,2,2,1,3
16716_0,,,,2,2,1,3
16717_0,,,,2,2,1,3
16717_1,,,,2,2,1,3
16718_0,,,,2,2,1,3
16719_0,,,,2,2,1,3
16720_0,,,,2,2,1,3
16722_0,,,,2,2,1,3
C(C(C(C)O)O)(C(C(C=O)=O)O)=O,,,5,1,5,0,5
16722_1,,,,2,2,1,3
16724_0,,,,2,2,1,3
C(C(C(C(C(C=O)=O)O)=O)O)(O)=O,,,5,1,3,0,3
16724_1,,,,2,2,1,3
16725_0,,,,2,2,1,3
16725_1,,,,2,2,1,3
16727_0,,,,2,2,1,3
C(C(C=C)C(C=O)(CC(C=O)=O)O)=O,,,5,1,1,0,1
16728_0,,,,2,2,1,3
16729_0,,,,2,2,1,3
16729_1,,,,2,2,1,3
16731_0,,,,2,2,1,3
C(C(C=C)C(C(CC(C=O)=O)=O)O)=O,,,5,1,1,0,1
16732_0,,,,2,2,1,3
16734_0,,,,2,2,1,3
C(C(C(C(CC(C=O)=O)=O)O)O)=O,,,5,1,6,0,6
16734_1,,,,2,2,1,3
16736_0,,,,2,2,1,3
C(C)=CC(C(C(C=O)=O)C(C=O)=O)O,,,5,1,2,0,2
16736_1,,,,2,2,1,3
16738_0,,,,2,2,1,3
C=CCC(C(C(C=O)=O)C(C=O)=O)O,,,5,1,2,0,2
16738_1,,,,2,2,1,3
16740_0,,,,2,2,1,3
C=CC(C(C(C=O)=O)C(C=O)=O)O,,,5,1,2,0,2
16740_1,,,,2,2,1,3
16742_0,,,,2,2,1,3
C(C(C(C(C=O)=O)C(C=O)=O)O)=O,,,5,1,3,0,3
16742_1,,,,2,2,1,3
16744_0,,,,2,2,1,3
C(C(C(C(C=O)=O)C(C)O)=O)=O,,,5,1,5,0,5
16744_1,,,,2,2,1,3
16746_0,,,,2,2,1,3
C(C(C(C=O)=O)C(C=O)=O)(O)=O,,,5,1,5,0,5
16746_1,,,,2,2,1,3
16747_0,,,,2,2,1,3
16747_1,,,,2,2,1,3
16749_0,,,,2,2,1,3
C(C(C(C(C=O)=O)C(CO)O)=O)=O,,,5,1,3,0,3
16749_1,,,,2,2,1,3
16751_0,,,,2,2,1,3
C(C(C=C)C(C(C=O)C(C=O)=O)O)=O,,,5,1,3,0,3
16752_0,,,,2,2,1,3
16753_0,,,,2,2,1,3
16753_1,,,,2,2,1,3
16755_0,,,,2,2,1,3
C(C(C=C)C(C=O)(C(C=O)C=O)O)=O,,,5,1,1,0,1
16756_0,,,,2,2,1,3
16757_0,,,,2,2,1,3
16757_1,,,,2,2,1,3
16759_0,,,,2,2,1,3
C(C(C=O)C(C(C(C=O)C=C)O)=O)=O,,,5,1,1,0,1
16761_0,,,,2,2,1,3
C(C(C=O)C(C(CC=O)O)=O)=O,,,5,1,5,0,5
16763_0,,,,2,2,1,3
C(C(C=O)C(C(C(C=O)O)O)=O)=O,,,5,1,5,0,5
16763_1,,,,2,2,1,3
16765_0,,,,2,2,1,3
C(C(C(C(CO)O)=O)C(C=O)=O)=O,,,5,1,4,0,4
16765_1,,,,2,2,1,3
16767_0,,,,2,2,1,3
C(C(C(C(C(C=O)=O)O)=O)CO)=O,,,5,1,3,0,3
16767_1,,,,2,2,1,3
16769_0,,,,2,2,1,3
C(C(C=O)O)(C(C(C=O)=O)CO)=O,,,5,1,3,0,3
16769_1,,,,2,2,1,3
16770_0,,,,2,2,1,3
16772_0,,,,2,2,1,3
C(CC(C(C(C(C=O)=O)O)=O)O)=O,,,5,1,3,0,3
16774_0,,,,2,2,1,3
C(C(C=C)C(C(C=O)=O)(CO)O)=O,,,5,1,1,0,1
16776_0,,,,2,2,1,3
C(C=O)(C(CO)(CC(C=O)=O)O)=O,,,5,1,2,0,2
16778_0,,,,2,2,1,3
C(C(C=O)C(C(C=O)=O)(CO)O)=O,,,5,1,4,0,4
16778_1,,,,2,2,1,3
16779_0,,,,2,2,1,3
16781_0,,,,2,2,1,3
C(C(CO)C(C(C=O)=O)(CO)O)=O,,,5,1,8,0,8
16781_1,,,,2,2,1,3
16782_0,,,,2,2,1,3
16782_1,,,,2,2,1,3
16784_0,,,,2,2,1,3
C(CC(C(C=O)=O)(CO)O)(CO)=O,,,5,1,4,0,4
16785_0,,,,2,2,1,3
16785_1,,,,2,2,1,3
16787_0,,,,2,2,1,3
C(C(C=C)C(C(C(CO)=O)=O)O)=O,,,5,1,1,0,1
16789_0,,,,2,2,1,3
C(C(CC(C(C(CO)=O)=O)O)=O)=O,,,5,1,2,0,2
16791_0,,,,2,2,1,3
C(C(C=O)C(C(C(CO)=O)=O)O)=O,,,5,1,3,0,3
16791_1,,,,2,2,1,3
16792_0,,,,2,2,1,3
16794_0,,,,2,2,1,3
C(C(CO)C(C(C(CO)=O)=O)O)=O,,,5,1,5,0,5
16794_1,,,,2,2,1,3
16796_0,,,,2,2,1,3
C(C)(C(C(C(C(CO)=O)=O)O)O)=O,,,5,1,6,0,6
16796_1,,,,2,2,1,3
16798_0,,,,2,2,1,3
C(CO)(CC(C(C(CO)=O)=O)O)=O,,,5,1,6,0,6
16800_0,,,,2,2,1,3
C(C(C(C(C(CO)=O)=O)O)O)=O,,,5,1,9,0,9
16800_1,,,,2,2,1,3
16802_0,,,,2,2,1,3
C(C(C=C)C(C=O)(C(CO)=O)O)=O,,,5,1,1,0,1
16804_0,,,,2,2,1,3
C(C(C(CO)=O)(CC(C=O)=O)O)=O,,,5,1,2,0,2
16806_0,,,,2,2,1,3
C(C(C=O)C(C=O)(C(CO)=O)O)=O,,,5,1,3,0,3
16806_1,,,,2,2,1,3
16807_0,,,,2,2,1,3
16809_0,,,,2,2,1,3
C(C(CO)C(C=O)(C(CO)=O)O)=O,,,5,1,6,0,6
16809_1,,,,2,2,1,3
16810_0,,,,2,2,1,3
16810_1,,,,2,2,1,3
16812_0,,,,2,2,1,3
C(C(C(CO)=O)(CC(CO)=O)O)=O,,,5,1,7,0,7
16813_0,,,,2,2,1,3
16813_1,,,,2,2,1,3
16815_0,,,,2,2,1,3
C(C(C(C(C(C=O)=O)=O)O)O)=CC,,,5,1,2,0,2
16815_1,,,,2,2,1,3
16817_0,,,,2,2,1,3
C(CC(C(C(C(C=O)=O)=O)O)O)=C,,,5,1,2,0,2
16817_1,,,,2,2,1,3
16819_0,,,,2,2,1,3
C=CC(C(C(C(C=O)=O)=O)O)O,,,5,1,2,0,2
16819_1,,,,2,2,1,3
16821_0,,,,2,2,1,3
C(C(C(C(C(C=O)=O)=O)O)O)=O,,,5,1,5,0,5
16821_1,,,,2,2,1,3
16823_0,,,,2,2,1,3
C(C(C(C(C(C=O)=O)=O)O)O)(O)=O,,,5,1,3,0,3
16823_1,,,,2,2,1,3
16825_0,,,,2,2,1,3
C(C(C)(C(C(C(C=O)=O)=O)O)O)=O,,,5,1,3,0,3
16825_1,,,,2,2,1,3
16827_0,,,,2,2,1,3
C(C)(C(C(C(C(C=O)=O)=O)O)O)=O,,,5,1,4,0,4
16827_1,,,,2,2,1,3
16829_0,,,,2,2,1,3
C(CC(C(C(C(C=O)=O)=O)O)O)=O,,,5,1,2,0,2
16829_1,,,,2,2,1,3
16831_0,,,,2,2,1,3
C(C(C(C(C(C)O)O)=O)=O)=O,,,5,1,5,0,5
16831_1,,,,2,2,1,3
16833_0,,,,2,2,1,3
C(C(C(C(C(CCO)O)O)=O)=O)=O,,,5,1,4,0,4
16833_1,,,,2,2,1,3
16835_0,,,,2,2,1,3
C(C(C(C(C(CO)(C)O)O)=O)=O)=O,,,5,1,2,0,2
16835_1,,,,2,2,1,3
16837_0,,,,2,2,1,3
C(C(C(C(C=O)=O)=O)O)(O)=O,,,5,1,5,0,5
16837_1,,,,2,2,1,3
16839_0,,,,2,2,1,3
C(C(C(C(C(C(O)O)O)O)=O)=O)=O,,,5,1,2,0,2
16839_1,,,,2,2,1,3
16841_0,,,,2,2,1,3
C(C(C(C(C(C(C)O)O)O)=O)=O)=O,,,5,1,2,0,2
16841_1,,,,2,2,1,3
16843_0,,,,2,2,1,3
C(C(C(C(CO)O)=O)=O)=O,,,5,1,7,0,7
16843_1,,,,2,2,1,3
16845_0,,,,2,2,1,3
C(C(C(C(C(CO)O)O)=O)=O)=O,,,5,1,6,0,6
16845_1,,,,2,2,1,3
16847_0,,,,2,2,1,3
C(CC(C(C(C(CO)=O)=O)O)O)=O,,,5,1,6,0,6
16848_0,,,,2,2,1,3
16849_0,,,,2,2,1,3
16851_0,,,,2,2,1,3
C(C(C(C(C(C(C)O)O)=O)=O)O)=O,,,5,1,2,0,2
16851_1,,,,2,2,1,3
16853_0,,,,2,2,1,3
C(C(C(C(C(C=O)O)=O)=O)O)(O)=O,,,5,1,4,0,4
16853_1,,,,2,2,1,3
16854_0,,,,2,2,1,3
16854_1,,,,2,2,1,3
16856_0,,,,2,2,1,3
C(C(C=C)C(C(CO)=O)(CO)O)=O,,,5,1,1,0,1
16857_0,,,,2,2,1,3
16858_0,,,,2,2,1,3
16858_1,,,,2,2,1,3
16859_0,,,,2,2,1,3
16861_0,,,,2,2,1,3
C(C(CO)C(C(CO)=O)(CO)O)=O,,,5,1,9,0,9
16861_1,,,,2,2,1,3
16862_0,,,,2,2,1,3
16862_1,,,,2,2,1,3
16864_0,,,,2,2,1,3
C(CO)(C(CO)(CC(CO)=O)O)=O,,,5,1,7,0,7
16865_0,,,,2,2,1,3
16865_1,,,,2,2,1,3
16867_0,,,,2,2,1,3
C(C)=CC(C(C(C(CO)=O)=O)O)O,,,5,1,2,0,2
16867_1,,,,2,2,1,3
16869_0,,,,2,2,1,3
C(CC(C(C(C(CO)=O)=O)O)O)=C,,,5,1,2,0,2
16869_1,,,,2,2,1,3
16871_0,,,,2,2,1,3
C=CC(C(C(C(CO)=O)=O)O)O,,,5,1,2,0,2
16871_1,,,,2,2,1,3
16872_0,,,,2,2,1,3
16872_1,,,,2,2,1,3
16874_0,,,,2,2,1,3
C(C(C(C(C(CO)=O)=O)O)O)(O)=O,,,5,1,4,0,4
16874_1,,,,2,2,1,3
16876_0,,,,2,2,1,3
C(C(C)(C(C(C(CO)=O)=O)O)O)=O,,,5,1,4,0,4
16876_1,,,,2,2,1,3
16877_0,,,,2,2,1,3
16877_1,,,,2,2,1,3
16878_0,,,,2,2,1,3
16878_1,,,,2,2,1,3
16880_0,,,,2,2,1,3
C(C(CO)=O)(C(C(C)O)O)=O,,,5,1,6,0,6
16880_1,,,,2,2,1,3
16882_0,,,,2,2,1,3
C(C(CO)=O)(C(C(CCO)O)O)=O,,,5,1,5,0,5
16882_1,,,,2,2,1,3
16884_0,,,,2,2,1,3
C(C(CO)=O)(C(C(CO)(C)O)O)=O,,,5,1,3,0,3
16884_1,,,,2,2,1,3
16885_0,,,,2,2,1,3
16885_1,,,,2,2,1,3
16887_0,,,,2,2,1,3
C(C(CO)=O)(C(C(C(O)O)O)O)=O,,,5,1,3,0,3
16887_1,,,,2,2,1,3
16889_0,,,,2,2,1,3
C(C(CO)=O)(C(C(C(C)O)O)O)=O,,,5,1,3,0,3
16889_1,,,,2,2,1,3
16890_0,,,,2,2,1,3
16890_1,,,,2,2,1,3
16891_0,,,,2,2,1,3
16891_1,,,,2,2,1,3
16892_0,,,,2,2,1,3
16893_0,,,,2,2,1,3
16895_0,,,,2,2,1,3
C(C(C(CO)O)=O)(C(C(C)O)O)=O,,,5,1,5,0,5
16895_1,,,,2,2,1,3
16897_0,,,,2,2,1,3
C(C(C(C(C(CO)O)=O)=O)O)(O)=O,,,5,1,8,0,8
16897_1,,,,2,2,1,3
16898_0,,,,2,2,1,3
16898_1,,,,2,2,1,3
16899_0,,,,2,2,1,3
16899_1,,,,2,2,1,3
16901_0,,,,2,2,1,3
C(C(C(C(C(CO)O)=O)=O)(C)O)=O,,,5,1,3,0,3
16901_1,,,,2,2,1,3
16903_0,,,,2,2,1,3
C(CCO)(C(C(C(CO)=O)=O)O)=O,,,5,1,2,0,2
16905_0,,,,2,2,1,3
C(C)(C(C(C(C(CO)O)=O)=O)O)=O,,,5,1,3,0,3
16905_1,,,,2,2,1,3
16906_0,,,,2,2,1,3
16906_1,,,,2,2,1,3
16908_0,,,,2,2,1,3
C(CC(C(C(C(CO)O)=O)=O)O)=O,,,5,1,5,0,5
16908_1,,,,2,2,1,3
16910_0,,,,2,2,1,3
C(C(CO)(CC=O)O)(C(C)O)=O,,,5,1,4,0,4
16912_0,,,,2,2,1,3
C(C(CO)(C(C=O)O)O)(C(C)O)=O,,,5,1,12,0,12
16912_1,,,,2,2,1,3
16913_0,,,,2,2,1,3
16914_0,,,,2,2,1,3
16914_1,,,,2,2,1,3
16916_0,,,,2,2,1,3
C=CC(C(C(C(C(C)O)=O)=O)O)O,,,5,1,2,0,2
16916_1,,,,2,2,1,3
16918_0,,,,2,2,1,3
C(C(C(C(C(C(C)O)=O)=O)O)O)=O,,,5,1,2,0,2
16918_1,,,,2,2,1,3
16920_0,,,,2,2,1,3
C(C(C(C)O)=O)(C(C(C)O)O)=O,,,5,1,3,0,3
16920_1,,,,2,2,1,3
16922_0,,,,2,2,1,3
C(C(C(C(C(C)O)=O)=O)O)(O)=O,,,5,1,5,0,5
16922_1,,,,2,2,1,3
16923_0,,,,2,2,1,3
16923_1,,,,2,2,1,3
16925_0,,,,2,2,1,3
C(C(C(C)O)=O)(C(C(CO)O)O)=O,,,5,1,4,0,4
16925_1,,,,2,2,1,3
16927_0,,,,2,2,1,3
C(C(C(CCO)=O)(C(C=O)=O)O)=O,,,5,1,2,0,2
16929_0,,,,2,2,1,3
C(C(CCO)=O)(C(CO)(CO)O)=O,,,5,1,5,0,5
16931_0,,,,2,2,1,3
C(C(C(C=O)=O)(C(C=O)CO)O)=O,,,5,1,5,0,5
16931_1,,,,2,2,1,3
16932_0,,,,2,2,1,3
16934_0,,,,2,2,1,3
C(CC(C(C(C(O)=O)(C)O)=O)O)=O,,,5,1,4,0,4
16935_0,,,,2,2,1,3
16937_0,,,,2,2,1,3
C(C(C)(CC=O)O)(C(C=O)(C)O)=O,,,5,1,1,0,1
16939_0,,,,2,2,1,3
C(CC(C(C(C(C)=O)=O)(C)O)O)=O,,,5,1,2,0,2
16941_0,,,,2,2,1,3
C(C(C(C(CC(C)O)=O)=O)(C)O)=O,,,5,1,1,0,1
16943_0,,,,2,2,1,3
C(C(C(C(CC(O)=O)=O)=O)(C)O)=O,,,5,1,1,0,1
16944_0,,,,2,2,1,3
16945_0,,,,2,2,1,3
16946_0,,,,2,2,1,3
16946_1,,,,2,2,1,3
16947_0,,,,2,2,1,3
16949_0,,,,2,2,1,3
C(C(C(C(C(C=O)O)O)=O)(C)O)=O,,,5,1,5,0,5
16949_1,,,,2,2,1,3
16950_0,,,,2,2,1,3
16951_0,,,,2,2,1,3
16951_1,,,,2,2,1,3
16952_0,,,,2,2,1,3
16954_0,,,,2,2,1,3
C(C)(C(C(C(C)(CC=O)O)=O)O)=O,,,5,1,1,0,1
16956_0,,,,2,2,1,3
C(CC(C)(C(C(C(C)=O)=O)O)O)=O,,,5,1,3,0,3
16958_0,,,,2,2,1,3
C(C)(C(C(C(CC(C)O)=O)=O)O)=O,,,5,1,1,0,1
16960_0,,,,2,2,1,3
C(CC(C(C(C(C)=O)O)=O)=O)(O)=O,,,5,1,1,0,1
16961_0,,,,2,2,1,3
16963_0,,,,2,2,1,3
C(CC(C)O)(C(C(C(C)=O)=O)O)=O,,,5,1,1,0,1
16965_0,,,,2,2,1,3
C(CC(C(C(C(C)=O)=O)O)=O)(O)=O,,,5,1,1,0,1
16966_0,,,,2,2,1,3
16967_0,,,,2,2,1,3
16968_0,,,,2,2,1,3
16968_1,,,,2,2,1,3
16969_0,,,,2,2,1,3
16971_0,,,,2,2,1,3
C(C(C(C(C(C(C)=O)O)=O)O)O)=O,,,5,1,10,0,10
16971_1,,,,2,2,1,3
16973_0,,,,2,2,1,3
C(CC(C)(C(C(C=O)=O)O)O)=O,,,5,1,6,0,6
16974_0,,,,2,2,1,3
16974_1,,,,2,2,1,3
16976_0,,,,2,2,1,3
C(CC(C=C)O)(C(C(C=O)=O)O)=O,,,5,1,1,0,1
16978_0,,,,2,2,1,3
C(C(CC(C(C(C=O)=O)O)=O)O)=O,,,5,1,2,0,2
16980_0,,,,2,2,1,3
C(CC(C)O)(C(C(C=O)=O)O)=O,,,5,1,4,0,4
16982_0,,,,2,2,1,3
C(CC(C(C(C=O)=O)O)=O)(O)=O,,,5,1,5,0,5
16983_0,,,,2,2,1,3
16985_0,,,,2,2,1,3
C(CC(CO)O)(C(C(C=O)=O)O)=O,,,5,1,4,0,4
16986_0,,,,2,2,1,3
16987_0,,,,2,2,1,3
16987_1,,,,2,2,1,3
16988_0,,,,2,2,1,3
16989_0,,,,2,2,1,3
16989_1,,,,2,2,1,3
16990_0,,,,2,2,1,3
16992_0,,,,2,2,1,3
C(C(C(CC(C(C=O)=O)O)O)O)=O,,,5,1,12,0,12
16992_1,,,,2,2,1,3
16994_0,,,,2,2,1,3
C(C(C(C(C=O)=O)O)C(C=C)O)=O,,,5,1,2,0,2
16994_1,,,,2,2,1,3
16996_0,,,,2,2,1,3
C(C(C(C=O)C(C(C=O)=O)O)O)=O,,,5,1,5,0,5
16996_1,,,,2,2,1,3
16998_0,,,,2,2,1,3
C(C(C(C)O)C(C(C=O)=O)O)=O,,,5,1,6,0,6
16998_1,,,,2,2,1,3
17000_0,,,,2,2,1,3
C(C(C=O)C(C(C=O)=O)O)(O)=O,,,5,1,8,0,8
17000_1,,,,2,2,1,3
17001_0,,,,2,2,1,3
17001_1,,,,2,2,1,3
17003_0,,,,2,2,1,3
C(C(C(CO)O)C(C(C=O)=O)O)=O,,,5,1,8,0,8
17003_1,,,,2,2,1,3
17005_0,,,,2,2,1,3
C(C(CO)CO)(C(C(C=O)=O)O)=O,,,5,1,3,0,3
17005_1,,,,2,2,1,3
17007_0,,,,2,2,1,3
C(CO)(C(CO)C(C(C=O)=O)O)=O,,,5,1,7,0,7
17007_1,,,,2,2,1,3
17009_0,,,,2,2,1,3
C(CC(C(C=O)=O)O)(C(CO)O)=O,,,5,1,9,0,9
17009_1,,,,2,2,1,3
17010_0,,,,2,2,1,3
17010_1,,,,2,2,1,3
17012_0,,,,2,2,1,3
C(C(C=C)C(C(C)=O)(C(C)O)O)=O,,,5,1,1,0,1
17013_0,,,,2,2,1,3
17014_0,,,,2,2,1,3
17014_1,,,,2,2,1,3
17015_0,,,,2,2,1,3
17017_0,,,,2,2,1,3
C(C(CO)C(C(C)=O)(C(C)O)O)=O,,,5,1,6,0,6
17017_1,,,,2,2,1,3
17019_0,,,,2,2,1,3
C(C)(C(C(C)O)(C(C(C)=O)O)O)=O,,,5,1,6,0,6
17019_1,,,,2,2,1,3
17021_0,,,,2,2,1,3
C(C)(C(C(C)O)(CC(CO)=O)O)=O,,,5,1,3,0,3
17022_0,,,,2,2,1,3
17022_1,,,,2,2,1,3
17024_0,,,,2,2,1,3
C(C(C=C)C(C(C(C)O)=O)(C)O)=O,,,5,1,1,0,1
17026_0,,,,2,2,1,3
C(C(C)(CC(C=O)=O)O)(C(C)O)=O,,,5,1,1,0,1
17028_0,,,,2,2,1,3
C(C(C=O)C(C(C(C)O)=O)(C)O)=O,,,5,1,2,0,2
17028_1,,,,2,2,1,3
17030_0,,,,2,2,1,3
C(C(C)(CC=O)O)(C(C)O)=O,,,5,1,1,0,1
17032_0,,,,2,2,1,3
C(C(CO)C(C(C(C)O)=O)(C)O)=O,,,5,1,2,0,2
17032_1,,,,2,2,1,3
17034_0,,,,2,2,1,3
C(C(C)(C(C(C)=O)O)O)(C(C)O)=O,,,5,1,2,0,2
17034_1,,,,2,2,1,3
17036_0,,,,2,2,1,3
C(C(C)(CC(CO)=O)O)(C(C)O)=O,,,5,1,1,0,1
17038_0,,,,2,2,1,3
C(C(C)(C(C=O)O)O)(C(C)O)=O,,,5,1,3,0,3
17038_1,,,,2,2,1,3
17040_0,,,,2,2,1,3
C(C)=CC(CC(C(C(C)O)=O)=O)O,,,5,1,1,0,1
17042_0,,,,2,2,1,3
C(CC(CC(C(C(C)O)=O)=O)O)=C,,,5,1,1,0,1
17044_0,,,,2,2,1,3
C=CC(CC(C(C(C)O)=O)=O)O,,,5,1,1,0,1
17046_0,,,,2,2,1,3
C(C(CC(C(C(C)O)=O)=O)O)=O,,,5,1,1,0,1
17048_0,,,,2,2,1,3
C(C(CC(C(C(C)O)=O)=O)O)(O)=O,,,5,1,1,0,1
17050_0,,,,2,2,1,3
C(C(C)(CC(C(C(C)O)=O)=O)O)=O,,,5,1,1,0,1
17052_0,,,,2,2,1,3
C(C(CC(C(C(C)O)=O)=O)O)(C)=O,,,5,1,1,0,1
17054_0,,,,2,2,1,3
C(CC(CC(C(C(C)O)=O)=O)O)=O,,,5,1,1,0,1
17056_0,,,,2,2,1,3
C(C(C(C)O)=O)(CC(C)O)=O,,,5,1,1,0,1
17058_0,,,,2,2,1,3
C(C(C(C)O)=O)(CC(CCO)O)=O,,,5,1,1,0,1
17060_0,,,,2,2,1,3
C(C(C(C)O)=O)(CC(CO)(C)O)=O,,,5,1,1,0,1
17062_0,,,,2,2,1,3
C(CC(C(C(C)O)=O)=O)(O)=O,,,5,1,4,0,4
17064_0,,,,2,2,1,3
C(C(C(C)O)=O)(CC(C(O)O)O)=O,,,5,1,1,0,1
17066_0,,,,2,2,1,3
C(C(C(C)O)=O)(CC(C(C)O)O)=O,,,5,1,1,0,1
17067_0,,,,2,2,1,3
17069_0,,,,2,2,1,3
C(C(C(C)O)=O)(CC(CO)O)=O,,,5,1,2,0,2
17070_0,,,,2,2,1,3
17072_0,,,,2,2,1,3
C(C(CCO)(CC=O)O)(C(C)O)=O,,,5,1,1,0,1
17074_0,,,,2,2,1,3
C(C(C(C)O)=O)(C(CO)C(C)O)=O,,,5,1,2,0,2
17074_1,,,,2,2,1,3
17076_0,,,,2,2,1,3
C(C(C(C(C(C)O)=O)=O)CO)(O)=O,,,5,1,2,0,2
17076_1,,,,2,2,1,3
17078_0,,,,2,2,1,3
C(C(C(C)O)=O)(C(CO)CO)=O,,,5,1,2,0,2
17078_1,,,,2,2,1,3
17080_0,,,,2,2,1,3
C(C(C(C(CCO)=O)=O)(CO)O)=O,,,5,1,4,0,4
17082_0,,,,2,2,1,3
C(C(CO)O)(C(C(C(C)=O)=O)O)=O,,,5,1,3,0,3
17082_1,,,,2,2,1,3
17084_0,,,,2,2,1,3
C(CO)(C(C(C(CCO)=O)=O)O)=O,,,5,1,2,0,2
17085_0,,,,2,2,1,3
17086_0,,,,2,2,1,3
17086_1,,,,2,2,1,3
17088_0,,,,2,2,1,3
C(C(C)(CC=O)O)(C(C=O)O)=O,,,5,1,2,0,2
17089_0,,,,2,2,1,3
17089_1,,,,2,2,1,3
17090_0,,,,2,2,1,3
17091_0,,,,2,2,1,3
17091_1,,,,2,2,1,3
17093_0,,,,2,2,1,3
C(C(C(C(CC(C=C)O)=O)=O)O)=O,,,5,1,1,0,1
17095_0,,,,2,2,1,3
C(C(C(C(CC(C=O)O)=O)=O)O)=O,,,5,1,1,0,1
17097_0,,,,2,2,1,3
C(C(C(C(CC(C)O)=O)=O)O)=O,,,5,1,3,0,3
17099_0,,,,2,2,1,3
C(CC(C(C(C=O)O)=O)=O)(O)=O,,,5,1,4,0,4
17100_0,,,,2,2,1,3
17102_0,,,,2,2,1,3
C(C(C(C(CC(CO)O)=O)=O)O)=O,,,5,1,1,0,1
17104_0,,,,2,2,1,3
C(C(C(C(C(CO)CO)=O)=O)O)=O,,,5,1,2,0,2
17104_1,,,,2,2,1,3
17106_0,,,,2,2,1,3
C(C(C(CO)O)=O)(C(CO)CO)=O,,,5,1,5,0,5
17106_1,,,,2,2,1,3
17107_0,,,,2,2,1,3
17108_0,,,,2,2,1,3
17108_1,,,,2,2,1,3
17109_0,,,,2,2,1,3
17111_0,,,,2,2,1,3
C(C(C(C(CC(CO)=O)=O)O)O)=O,,,5,1,8,0,8
17111_1,,,,2,2,1,3
17112_0,,,,2,2,1,3
17113_0,,,,2,2,1,3
17113_1,,,,2,2,1,3
17115_0,,,,2,2,1,3
C(CO)(C(C(C=O)=O)C(C=C)O)=O,,,5,1,2,0,2
17115_1,,,,2,2,1,3
17117_0,,,,2,2,1,3
C(C(C(C(CO)=O)C(C=O)=O)O)=O,,,5,1,4,0,4
17117_1,,,,2,2,1,3
17119_0,,,,2,2,1,3
C(CO)(C(C(C=O)=O)C(C)O)=O,,,5,1,8,0,8
17119_1,,,,2,2,1,3
17121_0,,,,2,2,1,3
C(C(C(CO)=O)C(C=O)=O)(O)=O,,,5,1,9,0,9
17121_1,,,,2,2,1,3
17122_0,,,,2,2,1,3
17122_1,,,,2,2,1,3
17124_0,,,,2,2,1,3
C(CO)(C(C(C=O)=O)C(CO)O)=O,,,5,1,4,0,4
17124_1,,,,2,2,1,3
17126_0,,,,2,2,1,3
C(C(C(C=C)O)O)(CC(C=O)=O)=O,,,5,1,2,0,2
17126_1,,,,2,2,1,3
17127_0,,,,2,2,1,3
17127_1,,,,2,2,1,3
17129_0,,,,2,2,1,3
C(C(C(C)O)O)(CC(C=O)=O)=O,,,5,1,8,0,8
17129_1,,,,2,2,1,3
17131_0,,,,2,2,1,3
C(C(C(CC(C=O)=O)=O)O)(O)=O,,,5,1,8,0,8
17131_1,,,,2,2,1,3
17132_0,,,,2,2,1,3
17132_1,,,,2,2,1,3
17133_0,,,,2,2,1,3
17133_1,,,,2,2,1,3
17134_0,,,,2,2,1,3
17134_1,,,,2,2,1,3
17136_0,,,,2,2,1,3
C(C(C=C)C(C=O)(C(C=O)=O)O)=O,,,5,1,1,0,1
17138_0,,,,2,2,1,3
C(C(C(C=O)=O)(C1C(C=CO1)=O)O)=O,,,5,1,2,0,2
17138_1,,,,2,2,1,3
17140_0,,,,2,2,1,3
C(C(C(C=O)=O)(CC(C=O)=O)O)=O,,,5,1,2,0,2
17142_0,,,,2,2,1,3
C(C(C=O)C(C=O)(C(C=O)=O)O)=O,,,5,1,3,0,3
17142_1,,,,2,2,1,3
17143_0,,,,2,2,1,3
17144_0,,,,2,2,1,3
17144_1,,,,2,2,1,3
17145_0,,,,2,2,1,3
17145_1,,,,2,2,1,3
17147_0,,,,2,2,1,3
C(C(C(C=O)=O)(CC(CO)=O)O)=O,,,5,1,2,0,2
17148_0,,,,2,2,1,3
17148_1,,,,2,2,1,3
17150_0,,,,2,2,1,3
C(C(C=C)C(C(C(C=O)=O)=O)O)=O,,,5,1,1,0,1
17152_0,,,,2,2,1,3
C1OC(C(C=1)=O)C(C(C(C=O)=O)=O)O,,,5,1,2,0,2
17152_1,,,,2,2,1,3
17154_0,,,,2,2,1,3
C(C(CC(C(C(C=O)=O)=O)O)=O)=O,,,5,1,1,0,1
17156_0,,,,2,2,1,3
C(C(C=O)C(C(C(C=O)=O)=O)O)=O,,,5,1,2,0,2
17156_1,,,,2,2,1,3
17158_0,,,,2,2,1,3
C(CC(C(C(C=O)=O)=O)O)=O,,,5,1,4,0,4
17160_0,,,,2,2,1,3
C(C(CO)C(C(C(C=O)=O)=O)O)=O,,,5,1,2,0,2
17160_1,,,,2,2,1,3
17161_0,,,,2,2,1,3
17161_1,,,,2,2,1,3
17163_0,,,,2,2,1,3
C(CO)(CC(C(C(C=O)=O)=O)O)=O,,,5,1,1,0,1
17164_0,,,,2,2,1,3
17164_1,,,,2,2,1,3
17165_0,,,,2,2,1,3
17167_0,,,,2,2,1,3
C(C(C(C)O)O)(C(C(CO)=O)O)=O,,,5,1,5,0,5
17167_1,,,,2,2,1,3
17169_0,,,,2,2,1,3
C(C(C(C(C(CO)=O)O)=O)O)(O)=O,,,5,1,6,0,6
17169_1,,,,2,2,1,3
17170_0,,,,2,2,1,3
17170_1,,,,2,2,1,3
17172_0,,,,2,2,1,3
C(CC(C)(C(C(CO)=O)O)O)=O,,,5,1,5,0,5
17173_0,,,,2,2,1,3
17173_1,,,,2,2,1,3
17174_0,,,,2,2,1,3
17175_0,,,,2,2,1,3
17175_1,,,,2,2,1,3
17177_0,,,,2,2,1,3
C(CC(C=C)O)(C(C(CO)=O)O)=O,,,5,1,1,0,1
17179_0,,,,2,2,1,3
C(C(CC(C(C(CO)=O)O)=O)O)=O,,,5,1,4,0,4
17181_0,,,,2,2,1,3
C(CC(C)O)(C(C(CO)=O)O)=O,,,5,1,3,0,3
17183_0,,,,2,2,1,3
C(CC(C(C(CO)=O)O)=O)(O)=O,,,5,1,6,0,6
17184_0,,,,2,2,1,3
17186_0,,,,2,2,1,3
C(CC(CO)O)(C(C(CO)=O)O)=O,,,5,1,4,0,4
17188_0,,,,2,2,1,3
C(C(C(C=C)O)O)(C(C(C)=O)O)=O,,,5,1,2,0,2
17188_1,,,,2,2,1,3
17189_0,,,,2,2,1,3
17189_1,,,,2,2,1,3
17191_0,,,,2,2,1,3
C(C(C(C)O)O)(C(C(C)=O)O)=O,,,5,1,5,0,5
17191_1,,,,2,2,1,3
17193_0,,,,2,2,1,3
C(C(C(C(C(C)=O)O)=O)O)(O)=O,,,5,1,7,0,7
17193_1,,,,2,2,1,3
17194_0,,,,2,2,1,3
17194_1,,,,2,2,1,3
17195_0,,,,2,2,1,3
17195_1,,,,2,2,1,3
17197_0,,,,2,2,1,3
C(C(C)(C(C(C=O)C(C)=O)O)O)=O,,,5,1,3,0,3
17197_1,,,,2,2,1,3
17199_0,,,,2,2,1,3
C(C(C)(C(CC(CC=O)=O)O)O)=O,,,5,1,2,0,2
17201_0,,,,2,2,1,3
C(C(C)(C(C(C(C=C)=O)O)O)O)=O,,,5,1,3,0,3
17201_1,,,,2,2,1,3
17203_0,,,,2,2,1,3
C(C(C(C(C(C=O)=O)C)O)(C)O)=O,,,5,1,2,0,2
17205_0,,,,2,2,1,3
C(C(C)(C(C(C=O)CC=O)O)O)=O,,,5,1,3,0,3
17207_0,,,,2,2,1,3
C(C(C)(C(CC(C(C)=O)=O)O)O)=O,,,5,1,2,0,2
17209_0,,,,2,2,1,3
C(C(C=C)C(C(C=O)(C)O)O)=O,,,5,1,3,0,3
17211_0,,,,2,2,1,3
C(C(C)(C(C1C(C=CO1)=O)O)O)=O,,,5,1,2,0,2
17211_1,,,,2,2,1,3
17212_0,,,,2,2,1,3
17212_1,,,,2,2,1,3
17213_0,,,,2,2,1,3
17215_0,,,,2,2,1,3
C(C(C=O)C(C(C=O)(C)O)O)=O,,,5,1,3,0,3
17215_1,,,,2,2,1,3
17216_0,,,,2,2,1,3
17217_0,,,,2,2,1,3
17217_1,,,,2,2,1,3
17218_0,,,,2,2,1,3
17218_1,,,,2,2,1,3
17219_0,,,,2,2,1,3
17219_1,,,,2,2,1,3
17220_0,,,,2,2,1,3
17220_1,,,,2,2,1,3
17221_0,,,,2,2,1,3
17222_0,,,,2,2,1,3
17224_0,,,,2,2,1,3
C(C(C=O)C(C(C=O)(C)O)O)(O)=O,,,5,1,5,0,5
17224_1,,,,2,2,1,3
17225_0,,,,2,2,1,3
17225_1,,,,2,2,1,3
17227_0,,,,2,2,1,3
C(C(C(C)=O)C(C=O)(C=O)O)=O,,,5,1,4,0,4
17227_1,,,,2,2,1,3
17229_0,,,,2,2,1,3
C(C(C=O)(CC(CC=O)=O)O)=O,,,5,1,2,0,2
17230_0,,,,2,2,1,3
17230_1,,,,2,2,1,3
17232_0,,,,2,2,1,3
C(OCC(CC(C=O)(C=O)O)=O)=O,,,5,1,1,0,1
17234_0,,,,2,2,1,3
C(OC(C(C)=O)C(C=O)(C=O)O)=O,,,5,1,2,0,2
17234_1,,,,2,2,1,3
17235_0,,,,2,2,1,3
17235_1,,,,2,2,1,3
17237_0,,,,2,2,1,3
C(C(C=O)(C(C(C=O)=O)C)O)=O,,,5,1,2,0,2
17238_0,,,,2,2,1,3
17240_0,,,,2,2,1,3
C(C(C=O)(CC(C(C)=O)=O)O)=O,,,5,1,2,0,2
17242_0,,,,2,2,1,3
C(C(C=O)(C(C(C(O)=O)=O)C)O)=O,,,5,1,1,0,1
17244_0,,,,2,2,1,3
C(C(C(C)=O)C(C=O)(C=O)O)(O)=O,,,5,1,2,0,2
17244_1,,,,2,2,1,3
17246_0,,,,2,2,1,3
C(C(C=O)(CC(CC(O)=O)=O)O)=O,,,5,1,1,0,1
17248_0,,,,2,2,1,3
C(C(C=O)(C1C(C(OC1)=O)=O)O)=O,,,5,1,2,0,2
17248_1,,,,2,2,1,3
17250_0,,,,2,2,1,3
C1(C(C(CO1)=O)C(C=O)(C=O)O)=O,,,5,1,2,0,2
17250_1,,,,2,2,1,3
17252_0,,,,2,2,1,3
C(C(C=O)(C1C(CC(O1)=O)=O)O)=O,,,5,1,2,0,2
17252_1,,,,2,2,1,3
17254_0,,,,2,2,1,3
C(C(C(C=O)=C)C(C=O)(C=O)O)=O,,,5,1,1,0,1
17256_0,,,,2,2,1,3
C(C(C=O)(CC(C=CC=O)=O)O)=O,,,5,1,1,0,1
17258_0,,,,2,2,1,3
C(C(C=O)(C(C=C)C(C=O)=O)O)=O,,,5,1,1,0,1
17260_0,,,,2,2,1,3
C(C(C=CC=O)C(C=O)(C=O)O)=O,,,5,1,1,0,1
17262_0,,,,2,2,1,3
C(C(C=C)C(C=O)(C=O)O)=O,,,5,1,1,0,1
17264_0,,,,2,2,1,3
C(C(C=O)(C1C(C=CO1)=O)O)=O,,,5,1,2,0,2
17264_1,,,,2,2,1,3
17265_0,,,,2,2,1,3
17265_1,,,,2,2,1,3
17267_0,,,,2,2,1,3
C(C(C=O)(CC(C=O)=O)O)=O,,,5,1,2,0,2
17269_0,,,,2,2,1,3
C(C(C=O)C(C=O)(C=O)O)=O,,,5,1,3,0,3
17269_1,,,,2,2,1,3
17271_0,,,,2,2,1,3
C(C(C=O)(C(C(C=O)=O)CO)O)=O,,,5,1,2,0,2
17271_1,,,,2,2,1,3
17273_0,,,,2,2,1,3
C(C(C=O)(C(C=O)C(C=O)O)O)=O,,,5,1,4,0,4
17273_1,,,,2,2,1,3
17275_0,,,,2,2,1,3
C(C(C(CO)=O)C(C=O)(C=O)O)=O,,,5,1,2,0,2
17275_1,,,,2,2,1,3
17276_0,,,,2,2,1,3
17276_1,,,,2,2,1,3
17278_0,,,,2,2,1,3
C(C(C=O)(CC(C(C=O)O)=O)O)=O,,,5,1,1,0,1
17279_0,,,,2,2,1,3
17281_0,,,,2,2,1,3
C(C(C=O)(C(C(C=O)=O)O)O)=O,,,5,1,5,0,5
17281_1,,,,2,2,1,3
17283_0,,,,2,2,1,3
C(C(C=O)(C(C=O)C(C)O)O)=O,,,5,1,4,0,4
17283_1,,,,2,2,1,3
17285_0,,,,2,2,1,3
C(C(C=O)(C(C=O)CO)O)=O,,,5,1,6,0,6
17285_1,,,,2,2,1,3
17287_0,,,,2,2,1,3
C(C(C=O)(C(C=O)C(CO)O)O)=O,,,5,1,6,0,6
17287_1,,,,2,2,1,3
17288_0,,,,2,2,1,3
17288_1,,,,2,2,1,3
17290_0,,,,2,2,1,3
C(C(C=O)(CC(C(CO)=O)=O)O)=O,,,5,1,1,0,1
17291_0,,,,2,2,1,3
17291_1,,,,2,2,1,3
17293_0,,,,2,2,1,3
C(C(C=O)(CC(CO)=O)O)=O,,,5,1,5,0,5
17294_0,,,,2,2,1,3
17294_1,,,,2,2,1,3
17296_0,,,,2,2,1,3
C(C(C=O)(C(C(CO)=O)CO)O)=O,,,5,1,4,0,4
17296_1,,,,2,2,1,3
17298_0,,,,2,2,1,3
C(C(C=O)(CC(C(CO)O)=O)O)=O,,,5,1,2,0,2
17300_0,,,,2,2,1,3
C(C(C=O)(CC(C(O)=O)=O)O)=O,,,5,1,1,0,1
17302_0,,,,2,2,1,3
C(C(C=O)C(C=O)(C=O)O)(O)=O,,,5,1,5,0,5
17302_1,,,,2,2,1,3
17304_0,,,,2,2,1,3
C(C(C=O)(C(C(C(O)=O)=O)O)O)=O,,,5,1,2,0,2
17304_1,,,,2,2,1,3
17306_0,,,,2,2,1,3
C(C(C(C=O)=O)C(C=O)(C=O)O)=O,,,5,1,2,0,2
17306_1,,,,2,2,1,3
17308_0,,,,2,2,1,3
C(C(C=O)(C1C(C(CO1)O)=O)O)=O,,,5,1,2,0,2
17308_1,,,,2,2,1,3
17310_0,,,,2,2,1,3
C(C(C=O)(C1C(C(O)OC1)=O)O)=O,,,5,1,2,0,2
17310_1,,,,2,2,1,3
17312_0,,,,2,2,1,3
C(C(C=O)(C1C(COC1O)=O)O)=O,,,5,1,2,0,2
17312_1,,,,2,2,1,3
17314_0,,,,2,2,1,3
C(C(C=O)(C1C(CC(O1)O)=O)O)=O,,,5,1,3,0,3
17314_1,,,,2,2,1,3
17316_0,,,,2,2,1,3
C(C(C=O)(CC(C(C=O)=O)=O)O)=O,,,5,1,1,0,1
17317_0,,,,2,2,1,3
17317_1,,,,2,2,1,3
17319_0,,,,2,2,1,3
C(C(C(C)=O)C(C(C=O)=O)O)=O,,,5,1,4,0,4
17319_1,,,,2,2,1,3
17320_0,,,,2,2,1,3
17321_0,,,,2,2,1,3
17321_1,,,,2,2,1,3
17323_0,,,,2,2,1,3
C(OCC(CC(C(C=O)=O)O)=O)=O,,,5,1,1,0,1
17325_0,,,,2,2,1,3
C(OC(C(C)=O)C(C(C=O)=O)O)=O,,,5,1,2,0,2
17325_1,,,,2,2,1,3
17326_0,,,,2,2,1,3
17326_1,,,,2,2,1,3
17327_0,,,,2,2,1,3
17328_0,,,,2,2,1,3
17329_0,,,,2,2,1,3
17331_0,,,,2,2,1,3
C(C(O)=O)(C(C)C(C(C=O)=O)O)=O,,,5,1,2,0,2
17333_0,,,,2,2,1,3
C(C(C(C)=O)C(C(C=O)=O)O)(O)=O,,,5,1,2,0,2
17333_1,,,,2,2,1,3
17335_0,,,,2,2,1,3
C(CC(CC(C(C=O)=O)O)=O)(O)=O,,,5,1,2,0,2
17337_0,,,,2,2,1,3
C1(C(OCC1C(C(C=O)=O)O)=O)=O,,,5,1,2,0,2
17337_1,,,,2,2,1,3
17339_0,,,,2,2,1,3
C1(C(C(CO1)=O)C(C(C=O)=O)O)=O,,,5,1,2,0,2
17339_1,,,,2,2,1,3
17341_0,,,,2,2,1,3
C1(CC(C(C(C(C=O)=O)O)O1)=O)=O,,,5,1,2,0,2
17341_1,,,,2,2,1,3
17343_0,,,,2,2,1,3
C(C(C(C=O)=C)C(C(C=O)=O)O)=O,,,5,1,1,0,1
17345_0,,,,2,2,1,3
C(C(C(CC(C=CC=O)=O)O)=O)=O,,,5,1,1,0,1
17347_0,,,,2,2,1,3
C=CC(C(C=O)=O)C(C(C=O)=O)O,,,5,1,1,0,1
17349_0,,,,2,2,1,3
C(C(C=CC=O)C(C(C=O)=O)O)=O,,,5,1,1,0,1
17351_0,,,,2,2,1,3
C(C(C=C)C(C(C=O)=O)O)=O,,,5,1,1,0,1
17353_0,,,,2,2,1,3
C1OC(C(C=1)=O)C(C(C=O)=O)O,,,5,1,2,0,2
17353_1,,,,2,2,1,3
17354_0,,,,2,2,1,3
17354_1,,,,2,2,1,3
17356_0,,,,2,2,1,3
C(C(CC(C(C=O)=O)O)=O)=O,,,5,1,7,0,7
17357_0,,,,2,2,1,3
17357_1,,,,2,2,1,3
17359_0,,,,2,2,1,3
C(C=O)(C(CO)C(C(C=O)=O)O)=O,,,5,1,3,0,3
17359_1,,,,2,2,1,3
17360_0,,,,2,2,1,3
17360_1,,,,2,2,1,3
17362_0,,,,2,2,1,3
C(C(C(CO)=O)C(C(C=O)=O)O)=O,,,5,1,3,0,3
17362_1,,,,2,2,1,3
17363_0,,,,2,2,1,3
17363_1,,,,2,2,1,3
17365_0,,,,2,2,1,3
C(C(C(CC(C(C=O)=O)O)=O)O)=O,,,5,1,2,0,2
17366_0,,,,2,2,1,3
17368_0,,,,2,2,1,3
C(C(C(C(C(C=O)=O)O)O)=O)=O,,,5,1,4,0,4
17368_1,,,,2,2,1,3
17369_0,,,,2,2,1,3
17369_1,,,,2,2,1,3
17370_0,,,,2,2,1,3
17370_1,,,,2,2,1,3
17371_0,,,,2,2,1,3
17371_1,,,,2,2,1,3
17372_0,,,,2,2,1,3
17372_1,,,,2,2,1,3
17374_0,,,,2,2,1,3
C(C(C(CC(C(CO)=O)=O)O)=O)=O,,,5,1,2,0,2
17375_0,,,,2,2,1,3
17375_1,,,,2,2,1,3
17376_0,,,,2,2,1,3
17377_0,,,,2,2,1,3
17377_1,,,,2,2,1,3
17378_0,,,,2,2,1,3
17378_1,,,,2,2,1,3
17379_0,,,,2,2,1,3
17381_0,,,,2,2,1,3
C(C(CC(C(C=O)=O)O)=O)(O)=O,,,5,1,6,0,6
17382_0,,,,2,2,1,3
17382_1,,,,2,2,1,3
17384_0,,,,2,2,1,3
C(C(C(C(C(C=O)=O)O)O)=O)(O)=O,,,5,1,4,0,4
17384_1,,,,2,2,1,3
17386_0,,,,2,2,1,3
C(C(C(C=O)=O)C(C(C=O)=O)O)=O,,,5,1,3,0,3
17386_1,,,,2,2,1,3
17388_0,,,,2,2,1,3
C1(C(C(C(C=O)=O)O)OCC1O)=O,,,5,1,3,0,3
17388_1,,,,2,2,1,3
17390_0,,,,2,2,1,3
C1(C(O)OCC1C(C(C=O)=O)O)=O,,,5,1,3,0,3
17390_1,,,,2,2,1,3
17392_0,,,,2,2,1,3
C1(COC(C1C(C(C=O)=O)O)O)=O,,,5,1,3,0,3
17392_1,,,,2,2,1,3
17394_0,,,,2,2,1,3
C1(C(C(C(C=O)=O)O)OC(C1)O)=O,,,5,1,4,0,4
17394_1,,,,2,2,1,3
17396_0,,,,2,2,1,3
C(C(C(CC(C(C=O)=O)=O)O)=O)=O,,,5,1,2,0,2
17397_0,,,,2,2,1,3
17397_1,,,,2,2,1,3
17399_0,,,,2,2,1,3
C(C(C=C)C(C)(CC(C=O)=O)O)=O,,,5,1,1,0,1
17401_0,,,,2,2,1,3
C1OC(C(C=1)=O)C(C)(CC(C=O)=O)O,,,5,1,2,0,2
17401_1,,,,2,2,1,3
17403_0,,,,2,2,1,3
C(C(CC(C)(CC(C=O)=O)O)=O)=O,,,5,1,1,0,1
17405_0,,,,2,2,1,3
C(C(C=O)C(C)(CC(C=O)=O)O)=O,,,5,1,3,0,3
17405_1,,,,2,2,1,3
17407_0,,,,2,2,1,3
C(CC(C)(CC(C=O)=O)O)=O,,,5,1,4,0,4
17409_0,,,,2,2,1,3
C(C(CO)C(C)(CC(C=O)=O)O)=O,,,5,1,3,0,3
17409_1,,,,2,2,1,3
17411_0,,,,2,2,1,3
C(C)(C(C(C)(CC(C=O)=O)O)O)=O,,,5,1,2,0,2
17411_1,,,,2,2,1,3
17413_0,,,,2,2,1,3
C(CO)(CC(C)(CC(C=O)=O)O)=O,,,5,1,2,0,2
17414_0,,,,2,2,1,3
17414_1,,,,2,2,1,3
17416_0,,,,2,2,1,3
C(C(C=C)C(C=O)(CC(C)=O)O)=O,,,5,1,1,0,1
17418_0,,,,2,2,1,3
C(C(CC(C)=O)(C1C(C=CO1)=O)O)=O,,,5,1,2,0,2
17418_1,,,,2,2,1,3
17420_0,,,,2,2,1,3
C(C(CC(C=O)=O)(CC(C)=O)O)=O,,,5,1,1,0,1
17422_0,,,,2,2,1,3
C(C(C=O)C(C=O)(CC(C)=O)O)=O,,,5,1,2,0,2
17422_1,,,,2,2,1,3
17424_0,,,,2,2,1,3
C(CC(C=O)(CC(C)=O)O)=O,,,5,1,3,0,3
17426_0,,,,2,2,1,3
C(CC(C=O)(C(C=O)CO)O)(C)=O,,,5,1,2,0,2
17426_1,,,,2,2,1,3
17428_0,,,,2,2,1,3
C(C(CC(C)=O)(C(C(C)=O)O)O)=O,,,5,1,2,0,2
17428_1,,,,2,2,1,3
17430_0,,,,2,2,1,3
C(C(CC(C)=O)(CC(CO)=O)O)=O,,,5,1,1,0,1
17432_0,,,,2,2,1,3
C(C(C(C=O)(CC(C)=O)O)O)=O,,,5,1,5,0,5
17432_1,,,,2,2,1,3
17434_0,,,,2,2,1,3
C(C(C=C)C(C(CC(C)=O)=O)O)=O,,,5,1,1,0,1
17436_0,,,,2,2,1,3
C(C(C1C(C=CO1)=O)O)(CC(C)=O)=O,,,5,1,2,0,2
17436_1,,,,2,2,1,3
17438_0,,,,2,2,1,3
C(C(CC(C=O)=O)O)(CC(C)=O)=O,,,5,1,1,0,1
17440_0,,,,2,2,1,3
C(C(C=O)C(C(CC(C)=O)=O)O)=O,,,5,1,2,0,2
17440_1,,,,2,2,1,3
17442_0,,,,2,2,1,3
C(CC(C(CC(C)=O)=O)O)=O,,,5,1,4,0,4
17444_0,,,,2,2,1,3
C(C(CO)C(C(CC(C)=O)=O)O)=O,,,5,1,2,0,2
17444_1,,,,2,2,1,3
17446_0,,,,2,2,1,3
C(C)(CC(C(C(C(C)=O)O)O)=O)=O,,,5,1,4,0,4
17446_1,,,,2,2,1,3
17448_0,,,,2,2,1,3
C(C)(CC(C(CC(CO)=O)O)=O)=O,,,5,1,1,0,1
17450_0,,,,2,2,1,3
C(C(C(C(CC(C)=O)=O)O)O)=O,,,5,1,14,0,14
17450_1,,,,2,2,1,3
17452_0,,,,2,2,1,3
C(CC(C(C=O)=C)O)(CC(C=O)=O)=O,,,5,1,1,0,1
17454_0,,,,2,2,1,3
C(CC(C=CC)O)(CC(C=O)=O)=O,,,5,1,1,0,1
17456_0,,,,2,2,1,3
C(CC(CC=C)O)(CC(C=O)=O)=O,,,5,1,1,0,1
17458_0,,,,2,2,1,3
C(CC(C=C)O)(CC(C=O)=O)=O,,,5,1,1,0,1
17460_0,,,,2,2,1,3
C(CC1(C=COC1)O)(CC(C=O)=O)=O,,,5,1,1,0,1
17461_0,,,,2,2,1,3
17463_0,,,,2,2,1,3
C(C(CC(CC(C=O)=O)=O)O)(O)=O,,,5,1,3,0,3
17465_0,,,,2,2,1,3
C(C(C)(CC(CC(C=O)=O)=O)O)=O,,,5,1,1,0,1
17467_0,,,,2,2,1,3
C(CC(C(C)=O)O)(CC(C=O)=O)=O,,,5,1,1,0,1
17469_0,,,,2,2,1,3
C(CC(CC(CC(C=O)=O)=O)O)=O,,,5,1,2,0,2
17471_0,,,,2,2,1,3
C(CC(C)O)(CC(C=O)=O)=O,,,5,1,4,0,4
17473_0,,,,2,2,1,3
C(CC(CCO)O)(CC(C=O)=O)=O,,,5,1,1,0,1
17475_0,,,,2,2,1,3
C(CC(C)(CO)O)(CC(C=O)=O)=O,,,5,1,1,0,1
17477_0,,,,2,2,1,3
C(C(C=C)(CC(CC(C=O)=O)=O)O)=O,,,5,1,1,0,1
17479_0,,,,2,2,1,3
C(CC(C(C=C)=O)O)(CC(C=O)=O)=O,,,5,1,1,0,1
17481_0,,,,2,2,1,3
C(CC(C=CC=O)O)(CC(C=O)=O)=O,,,5,1,1,0,1
17483_0,,,,2,2,1,3
C(CC(CC(C=O)=O)=O)(O)=O,,,5,1,6,0,6
17485_0,,,,2,2,1,3
C(CC(C(O)O)O)(CC(C=O)=O)=O,,,5,1,1,0,1
17487_0,,,,2,2,1,3
C(CC(C(C)O)O)(CC(C=O)=O)=O,,,5,1,1,0,1
17488_0,,,,2,2,1,3
17489_0,,,,2,2,1,3
17491_0,,,,2,2,1,3
C(C)(C(C(C=O)=O)C(C(C=O)=C)O)=O,,,5,1,2,0,2
17491_1,,,,2,2,1,3
17493_0,,,,2,2,1,3
C(C)(C(C(C=O)=O)C(C=CC)O)=O,,,5,1,2,0,2
17493_1,,,,2,2,1,3
17495_0,,,,2,2,1,3
C(C)(C(C(C=O)=O)C(CC=C)O)=O,,,5,1,2,0,2
17495_1,,,,2,2,1,3
17497_0,,,,2,2,1,3
C(C)(C(C(C=O)=O)C(C=C)O)=O,,,5,1,2,0,2
17497_1,,,,2,2,1,3
17499_0,,,,2,2,1,3
C(C)(C(C(C=O)=O)C1(C=COC1)O)=O,,,5,1,2,0,2
17499_1,,,,2,2,1,3
17501_0,,,,2,2,1,3
C(C(C(C(C)=O)C(C=O)=O)O)=O,,,5,1,5,0,5
17501_1,,,,2,2,1,3
17503_0,,,,2,2,1,3
C(C(C(C(C)=O)C(C=O)=O)O)(O)=O,,,5,1,2,0,2
17503_1,,,,2,2,1,3
17505_0,,,,2,2,1,3
C(C(C)(C(C(C)=O)C(C=O)=O)O)=O,,,5,1,2,0,2
17505_1,,,,2,2,1,3
17507_0,,,,2,2,1,3
C(C)(C(C(C=O)=O)C(C(C)=O)O)=O,,,5,1,2,0,2
17507_1,,,,2,2,1,3
17509_0,,,,2,2,1,3
C(CC(C(C(C)=O)C(C=O)=O)O)=O,,,5,1,3,0,3
17509_1,,,,2,2,1,3
17511_0,,,,2,2,1,3
C(C)(C(C(C=O)=O)C(C)O)=O,,,5,1,5,0,5
17511_1,,,,2,2,1,3
17513_0,,,,2,2,1,3
C(C)(C(C(C=O)=O)C(CCO)O)=O,,,5,1,2,0,2
17513_1,,,,2,2,1,3
17515_0,,,,2,2,1,3
C(C)(C(C(C=O)=O)C(C)(CO)O)=O,,,5,1,2,0,2
17515_1,,,,2,2,1,3
17517_0,,,,2,2,1,3
C(C(C=C)(C(C(C)=O)C(C=O)=O)O)=O,,,5,1,2,0,2
17517_1,,,,2,2,1,3
17519_0,,,,2,2,1,3
C(C)(C(C(C=O)=O)C(C(C=C)=O)O)=O,,,5,1,2,0,2
17519_1,,,,2,2,1,3
17521_0,,,,2,2,1,3
C(C)(C(C(C=O)=O)C(C=CC=O)O)=O,,,5,1,2,0,2
17521_1,,,,2,2,1,3
17523_0,,,,2,2,1,3
C(C(C(C)=O)C(C=O)=O)(O)=O,,,5,1,7,0,7
17523_1,,,,2,2,1,3
17525_0,,,,2,2,1,3
C(C)(C(C(C=O)=O)C(C(O)O)O)=O,,,5,1,2,0,2
17525_1,,,,2,2,1,3
17527_0,,,,2,2,1,3
C(C)(C(C(C=O)=O)C(C(C)O)O)=O,,,5,1,2,0,2
17527_1,,,,2,2,1,3
17528_0,,,,2,2,1,3
17528_1,,,,2,2,1,3
17530_0,,,,2,2,1,3
C(C)(C(C(C=O)=O)C(CO)O)=O,,,5,1,5,0,5
17530_1,,,,2,2,1,3
17532_0,,,,2,2,1,3
C(C(C=O)C(C(C=O)C(C)=O)O)=O,,,5,1,4,0,4
17532_1,,,,2,2,1,3
17534_0,,,,2,2,1,3
C(C(C=O)C(CC(CC=O)=O)O)=O,,,5,1,3,0,3
17536_0,,,,2,2,1,3
C(C(C=O)C(C(C(C=C)=O)O)O)=O,,,5,1,4,0,4
17536_1,,,,2,2,1,3
17538_0,,,,2,2,1,3
C(C(C=O)C(C(C(C=O)=O)C)O)=O,,,5,1,3,0,3
17539_0,,,,2,2,1,3
17541_0,,,,2,2,1,3
C(C(C=O)C(CC(C(C)=O)=O)O)=O,,,5,1,3,0,3
17543_0,,,,2,2,1,3
C(C(C(C=O)=C)C(C(C=O)C=O)O)=O,,,5,1,3,0,3
17545_0,,,,2,2,1,3
C(C(C=O)C(CC(C=CC=O)=O)O)=O,,,5,1,1,0,1
17547_0,,,,2,2,1,3
C(C(C=O)C(C(C=C)C(C=O)=O)O)=O,,,5,1,1,0,1
17549_0,,,,2,2,1,3
C(C(C=CC=O)C(C(C=O)C=O)O)=O,,,5,1,3,0,3
17551_0,,,,2,2,1,3
C(C(C=C)C(C(C=O)C=O)O)=O,,,5,1,4,0,4
17553_0,,,,2,2,1,3
C(C(C=O)C(C1C(C=CO1)=O)O)=O,,,5,1,2,0,2
17553_1,,,,2,2,1,3
17554_0,,,,2,2,1,3
17554_1,,,,2,2,1,3
17555_0,,,,2,2,1,3
17557_0,,,,2,2,1,3
C(C(C=O)C(C(C=O)C=O)O)=O,,,5,1,2,0,2
17557_1,,,,2,2,1,3
17558_0,,,,2,2,1,3
17559_0,,,,2,2,1,3
17559_1,,,,2,2,1,3
17560_0,,,,2,2,1,3
17560_1,,,,2,2,1,3
17561_0,,,,2,2,1,3
17561_1,,,,2,2,1,3
17562_0,,,,2,2,1,3
17562_1,,,,2,2,1,3
17563_0,,,,2,2,1,3
17564_0,,,,2,2,1,3
17565_0,,,,2,2,1,3
17565_1,,,,2,2,1,3
17566_0,,,,2,2,1,3
17566_1,,,,2,2,1,3
17567_0,,,,2,2,1,3
17568_0,,,,2,2,1,3
17568_1,,,,2,2,1,3
17569_0,,,,2,2,1,3
17570_0,,,,2,2,1,3
17570_1,,,,2,2,1,3
17572_0,,,,2,2,1,3
C(C(C=O)C(C(C(C=C)O)O)=O)=O,,,5,1,2,0,2
17572_1,,,,2,2,1,3
17573_0,,,,2,2,1,3
17573_1,,,,2,2,1,3
17575_0,,,,2,2,1,3
C(C(C=O)C(C(C(C)O)O)=O)=O,,,5,1,6,0,6
17575_1,,,,2,2,1,3
17577_0,,,,2,2,1,3
C(C(C=O)C(C(C(O)=O)O)=O)=O,,,5,1,3,0,3
17577_1,,,,2,2,1,3
17578_0,,,,2,2,1,3
17578_1,,,,2,2,1,3
17579_0,,,,2,2,1,3
17579_1,,,,2,2,1,3
17580_0,,,,2,2,1,3
17581_0,,,,2,2,1,3
17581_1,,,,2,2,1,3
17583_0,,,,2,2,1,3
C(CC(C(C=O)O)(CC=O)O)=O,,,5,1,4,0,4
17585_0,,,,2,2,1,3
C(CC(C(C=O)O)(C(C=O)O)O)=O,,,5,1,4,0,4
17585_1,,,,2,2,1,3
17586_0,,,,2,2,1,3
17587_0,,,,2,2,1,3
17587_1,,,,2,2,1,3
17589_0,,,,2,2,1,3
C(C(C(C(C=O)O)=O)C(C=C)O)=O,,,5,1,2,0,2
17589_1,,,,2,2,1,3
17591_0,,,,2,2,1,3
C(C(C(C(C=O)O)=O)C(C=O)O)=O,,,5,1,2,0,2
17591_1,,,,2,2,1,3
17593_0,,,,2,2,1,3
C(C(C(C(C=O)O)=O)C(C)O)=O,,,5,1,4,0,4
17593_1,,,,2,2,1,3
17595_0,,,,2,2,1,3
C(C(C=O)C(C(C=O)O)=O)(O)=O,,,5,1,2,0,2
17595_1,,,,2,2,1,3
17597_0,,,,2,2,1,3
C(C(C(C(C=O)O)=O)CO)=O,,,5,1,7,0,7
17597_1,,,,2,2,1,3
17599_0,,,,2,2,1,3
C(C(C(C(C=O)O)=O)C(CO)O)=O,,,5,1,2,0,2
17599_1,,,,2,2,1,3
17601_0,,,,2,2,1,3
C(C(C=C)C(C)(C(C=O)C=O)O)=O,,,5,1,1,0,1
17603_0,,,,2,2,1,3
C(C(C=O)C(C)(C1C(C=CO1)=O)O)=O,,,5,1,2,0,2
17603_1,,,,2,2,1,3
17604_0,,,,2,2,1,3
17606_0,,,,2,2,1,3
C(C(C=O)C(C)(C(C=O)C=O)O)=O,,,5,1,2,0,2
17606_1,,,,2,2,1,3
17608_0,,,,2,2,1,3
C(C(C=O)C(C)(CC=O)O)=O,,,5,1,5,0,5
17610_0,,,,2,2,1,3
C(C(C=O)C(C)(C(C=O)CO)O)=O,,,5,1,4,0,4
17610_1,,,,2,2,1,3
17612_0,,,,2,2,1,3
C(C(C=O)C(C)(C(C(C)=O)O)O)=O,,,5,1,2,0,2
17612_1,,,,2,2,1,3
17614_0,,,,2,2,1,3
C(C(C=O)C(C)(CC(CO)=O)O)=O,,,5,1,3,0,3
17615_0,,,,2,2,1,3
17615_1,,,,2,2,1,3
17617_0,,,,2,2,1,3
C(C(C=C)C(C(C=O)C(C)=O)O)=O,,,5,1,3,0,3
17619_0,,,,2,2,1,3
C(C(C(C)=O)C(C1C(C=CO1)=O)O)=O,,,5,1,2,0,2
17619_1,,,,2,2,1,3
17621_0,,,,2,2,1,3
C(C(C(C)=O)C(CC(C=O)=O)O)=O,,,5,1,3,0,3
17622_0,,,,2,2,1,3
17622_1,,,,2,2,1,3
17624_0,,,,2,2,1,3
C(CC(C(C=O)C(C)=O)O)=O,,,5,1,7,0,7
17626_0,,,,2,2,1,3
C(C(CO)C(C(C=O)C(C)=O)O)=O,,,5,1,4,0,4
17626_1,,,,2,2,1,3
17628_0,,,,2,2,1,3
C(C(C(C)=O)C(C(C(C)=O)O)O)=O,,,5,1,4,0,4
17628_1,,,,2,2,1,3
17630_0,,,,2,2,1,3
C(C)(C(C=O)C(CC(CO)=O)O)=O,,,5,1,3,0,3
17632_0,,,,2,2,1,3
C(C(C(C(C=O)C(C)=O)O)O)=O,,,5,1,8,0,8
17632_1,,,,2,2,1,3
17634_0,,,,2,2,1,3
C(C(C=O)C(CC(C(C=O)=C)O)=O)=O,,,5,1,1,0,1
17636_0,,,,2,2,1,3
C(C(C=O)C(CC(C=CC)O)=O)=O,,,5,1,1,0,1
17638_0,,,,2,2,1,3
C(C(C=O)C(CC(CC=C)O)=O)=O,,,5,1,1,0,1
17640_0,,,,2,2,1,3
C(C(C=O)C(CC(C=C)O)=O)=O,,,5,1,1,0,1
17642_0,,,,2,2,1,3
C(C(C=O)C(CC1(C=COC1)O)=O)=O,,,5,1,1,0,1
17643_0,,,,2,2,1,3
17645_0,,,,2,2,1,3
C(C(C=O)C(CC(C(O)=O)O)=O)=O,,,5,1,3,0,3
17647_0,,,,2,2,1,3
C(C(C)(CC(C(C=O)C=O)=O)O)=O,,,5,1,1,0,1
17649_0,,,,2,2,1,3
C(C(C=O)C(CC(C(C)=O)O)=O)=O,,,5,1,1,0,1
17651_0,,,,2,2,1,3
C(C(C=O)C(CC(CC=O)O)=O)=O,,,5,1,1,0,1
17653_0,,,,2,2,1,3
C(C(C=O)C(CC(C)O)=O)=O,,,5,1,4,0,4
17655_0,,,,2,2,1,3
C(C(C=O)C(CC(CCO)O)=O)=O,,,5,1,1,0,1
17657_0,,,,2,2,1,3
C(C(C=O)C(CC(C)(CO)O)=O)=O,,,5,1,1,0,1
17659_0,,,,2,2,1,3
C(C(C=O)C(CC(C=O)(C=C)O)=O)=O,,,5,1,1,0,1
17661_0,,,,2,2,1,3
C(C(C=O)C(CC(C(C=C)=O)O)=O)=O,,,5,1,1,0,1
17663_0,,,,2,2,1,3
C(C(C=O)C(CC(C=CC=O)O)=O)=O,,,5,1,1,0,1
17665_0,,,,2,2,1,3
C(C(C=O)C(CC(O)=O)=O)=O,,,5,1,3,0,3
17667_0,,,,2,2,1,3
C(C(C=O)C(CC(C(O)O)O)=O)=O,,,5,1,1,0,1
17669_0,,,,2,2,1,3
C(C(C=O)C(CC(C(C)O)O)=O)=O,,,5,1,1,0,1
17670_0,,,,2,2,1,3
17671_0,,,,2,2,1,3
17672_0,,,,2,2,1,3
17673_0,,,,2,2,1,3
17673_1,,,,2,2,1,3
17674_0,,,,2,2,1,3
17675_0,,,,2,2,1,3
17675_1,,,,2,2,1,3
17677_0,,,,2,2,1,3
C(C(C(C)=O)C(CC(C)=O)O)=O,,,5,1,2,0,2
17677_1,,,,2,2,1,3
17679_0,,,,2,2,1,3
C(CC(CC(C)=O)O)(CC=O)=O,,,5,1,1,0,1
17681_0,,,,2,2,1,3
C(C(C(CC(C)=O)O)O)(C(C)O)=O,,,5,1,2,0,2
17681_1,,,,2,2,1,3
17683_0,,,,2,2,1,3
C(C)(CC(CC(COC=O)=O)O)=O,,,5,1,1,0,1
17685_0,,,,2,2,1,3
C(OC(C(C)=O)C(CC(C)=O)O)=O,,,5,1,2,0,2
17685_1,,,,2,2,1,3
17687_0,,,,2,2,1,3
C(C)(CC(C(C(C=C)=O)O)O)=O,,,5,1,2,0,2
17687_1,,,,2,2,1,3
17689_0,,,,2,2,1,3
C(C)(CC(C(C(C=O)=O)C)O)=O,,,5,1,1,0,1
17691_0,,,,2,2,1,3
C(C)(CC(C(C=O)CC=O)O)=O,,,5,1,1,0,1
17693_0,,,,2,2,1,3
C(C)(CC(CC(C(C)=O)=O)O)=O,,,5,1,1,0,1
17695_0,,,,2,2,1,3
C(C)(CC(C(C(C(O)=O)=O)C)O)=O,,,5,1,1,0,1
17697_0,,,,2,2,1,3
C(C(C(C)=O)C(CC(C)=O)O)(O)=O,,,5,1,2,0,2
17697_1,,,,2,2,1,3
17699_0,,,,2,2,1,3
C(CC(CC(C)=O)O)(CC(O)=O)=O,,,5,1,1,0,1
17701_0,,,,2,2,1,3
C(C)(CC(C1C(C(OC1)=O)=O)O)=O,,,5,1,2,0,2
17701_1,,,,2,2,1,3
17703_0,,,,2,2,1,3
C(C)(CC(C1C(OCC1=O)=O)O)=O,,,5,1,2,0,2
17703_1,,,,2,2,1,3
17705_0,,,,2,2,1,3
C1(C(C(CC(C)=O)O)OC(C1)=O)=O,,,5,1,2,0,2
17705_1,,,,2,2,1,3
17707_0,,,,2,2,1,3
C(C(C(C=O)=C)C(CC(C)=O)O)=O,,,5,1,1,0,1
17709_0,,,,2,2,1,3
C(C)(CC(CC(C=CC=O)=O)O)=O,,,5,1,1,0,1
17711_0,,,,2,2,1,3
C(C)(CC(C(C=C)C(C=O)=O)O)=O,,,5,1,1,0,1
17713_0,,,,2,2,1,3
C(C(C=CC=O)C(CC(C)=O)O)=O,,,5,1,1,0,1
17715_0,,,,2,2,1,3
C(C(C=C)C(CC(C)=O)O)=O,,,5,1,1,0,1
17717_0,,,,2,2,1,3
C(C)(CC(C1C(C=CO1)=O)O)=O,,,5,1,2,0,2
17717_1,,,,2,2,1,3
17719_0,,,,2,2,1,3
C(C)(CC(C(C(CO)=O)O)O)=O,,,5,1,4,0,4
17719_1,,,,2,2,1,3
17721_0,,,,2,2,1,3
C(C)(CC(CC(C=O)=O)O)=O,,,5,1,3,0,3
17723_0,,,,2,2,1,3
C(C(C=O)C(CC(C)=O)O)=O,,,5,1,4,0,4
17723_1,,,,2,2,1,3
17725_0,,,,2,2,1,3
C(C)(CC(C(C(C=O)=O)CO)O)=O,,,5,1,2,0,2
17725_1,,,,2,2,1,3
17727_0,,,,2,2,1,3
C(C)(CC(C(C=O)C(C=O)O)O)=O,,,5,1,2,0,2
17727_1,,,,2,2,1,3
17729_0,,,,2,2,1,3
C(C)(CC(C(C=O)C(CO)=O)O)=O,,,5,1,2,0,2
17729_1,,,,2,2,1,3
17731_0,,,,2,2,1,3
C(C(C(CC(C)=O)O)O)(CC=O)=O,,,5,1,2,0,2
17731_1,,,,2,2,1,3
17733_0,,,,2,2,1,3
C(CC(CC(C)=O)O)(C(C=O)O)=O,,,5,1,1,0,1
17735_0,,,,2,2,1,3
C(CC(CC(C)=O)O)=O,,,5,1,5,0,5
17737_0,,,,2,2,1,3
C(C)(CC(C(C(C=O)=O)O)O)=O,,,5,1,5,0,5
17737_1,,,,2,2,1,3
17739_0,,,,2,2,1,3
C(C(C(CC(C)=O)O)C(C)O)=O,,,5,1,4,0,4
17739_1,,,,2,2,1,3
17741_0,,,,2,2,1,3
C(C(CO)C(CC(C)=O)O)=O,,,5,1,4,0,4
17741_1,,,,2,2,1,3
17743_0,,,,2,2,1,3
C(C(C(CC(C)=O)O)C(CO)O)=O,,,5,1,2,0,2
17743_1,,,,2,2,1,3
17745_0,,,,2,2,1,3
C(C)(CC(C(C(C(C)=O)=O)O)O)=O,,,5,1,2,0,2
17745_1,,,,2,2,1,3
17747_0,,,,2,2,1,3
C(C)(CC(CC(C(CO)=O)=O)O)=O,,,5,1,1,0,1
17749_0,,,,2,2,1,3
C(C)(CC(C(C(C)=O)O)O)=O,,,5,1,4,0,4
17749_1,,,,2,2,1,3
17751_0,,,,2,2,1,3
C(C)(CC(CC(CO)=O)O)=O,,,5,1,3,0,3
17753_0,,,,2,2,1,3
C(C(C(CC(C)=O)O)O)(CCO)=O,,,5,1,2,0,2
17753_1,,,,2,2,1,3
17755_0,,,,2,2,1,3
C(C)(CC(C(C(CO)=O)CO)O)=O,,,5,1,2,0,2
17755_1,,,,2,2,1,3
17757_0,,,,2,2,1,3
C(C(CO)O)(CC(CC(C)=O)O)=O,,,5,1,1,0,1
17759_0,,,,2,2,1,3
C(C)(CC(CC(C(O)=O)=O)O)=O,,,5,1,3,0,3
17761_0,,,,2,2,1,3
C(C(C=O)C(CC(C)=O)O)(O)=O,,,5,1,4,0,4
17761_1,,,,2,2,1,3
17763_0,,,,2,2,1,3
C(C)(CC(C(C(C(O)=O)=O)O)O)=O,,,5,1,2,0,2
17763_1,,,,2,2,1,3
17765_0,,,,2,2,1,3
C(C(C(C=O)=O)C(CC(C)=O)O)=O,,,5,1,2,0,2
17765_1,,,,2,2,1,3
17767_0,,,,2,2,1,3
C1(C(C(CC(C)=O)O)OCC1O)=O,,,5,1,2,0,2
17767_1,,,,2,2,1,3
17769_0,,,,2,2,1,3
C(C)(CC(C1C(C(O)OC1)=O)O)=O,,,5,1,2,0,2
17769_1,,,,2,2,1,3
17771_0,,,,2,2,1,3
C(C)(CC(C1C(COC1O)=O)O)=O,,,5,1,2,0,2
17771_1,,,,2,2,1,3
17773_0,,,,2,2,1,3
C1(C(C(CC(C)=O)O)OC(C1)O)=O,,,5,1,2,0,2
17773_1,,,,2,2,1,3
17775_0,,,,2,2,1,3
C(C)(CC(CC(C(C=O)=O)=O)O)=O,,,5,1,1,0,1
17777_0,,,,2,2,1,3
C(C(C(CC(C)=O)O)O)=O,,,5,1,5,0,5
17777_1,,,,2,2,1,3
17779_0,,,,2,2,1,3
C(CC(C)(C(C=O)C(C)=O)O)=O,,,5,1,4,0,4
17779_1,,,,2,2,1,3
17781_0,,,,2,2,1,3
C(CC(CC(C)(CC=O)O)=O)=O,,,5,1,3,0,3
17783_0,,,,2,2,1,3
C(CC(C)(C(C(C(C)O)=O)O)O)=O,,,5,1,3,0,3
17783_1,,,,2,2,1,3
17785_0,,,,2,2,1,3
C(CC(C)(CC(COC=O)=O)O)=O,,,5,1,1,0,1
17787_0,,,,2,2,1,3
C(CC(C)(C(C(C)=O)OC=O)O)=O,,,5,1,2,0,2
17787_1,,,,2,2,1,3
17789_0,,,,2,2,1,3
C(CC(C)(C(C(C=C)=O)O)O)=O,,,5,1,2,0,2
17789_1,,,,2,2,1,3
17791_0,,,,2,2,1,3
C(CC(C)(C(C(C=O)=O)C)O)=O,,,5,1,1,0,1
17792_0,,,,2,2,1,3
17794_0,,,,2,2,1,3
C(CC(C)(CC(C(C)=O)=O)O)=O,,,5,1,2,0,2
17796_0,,,,2,2,1,3
C(CC(C)(C(C(C(O)=O)=O)C)O)=O,,,5,1,1,0,1
17798_0,,,,2,2,1,3
C(CC(C)(C(C(O)=O)C(C)=O)O)=O,,,5,1,2,0,2
17798_1,,,,2,2,1,3
17800_0,,,,2,2,1,3
C(CC(CC(C)(CC=O)O)=O)(O)=O,,,5,1,1,0,1
17802_0,,,,2,2,1,3
C(CC(C)(C1C(C(OC1)=O)=O)O)=O,,,5,1,2,0,2
17802_1,,,,2,2,1,3
17804_0,,,,2,2,1,3
C(CC(C)(C1C(OCC1=O)=O)O)=O,,,5,1,2,0,2
17804_1,,,,2,2,1,3
17806_0,,,,2,2,1,3
C(CC(C)(C1C(CC(O1)=O)=O)O)=O,,,5,1,2,0,2
17806_1,,,,2,2,1,3
17808_0,,,,2,2,1,3
C(C(C(C=O)=C)C(C)(CC=O)O)=O,,,5,1,1,0,1
17810_0,,,,2,2,1,3
C(CC(C)(CC(C=CC=O)=O)O)=O,,,5,1,1,0,1
17812_0,,,,2,2,1,3
C(CC(C)(C(C=C)C(C=O)=O)O)=O,,,5,1,1,0,1
17814_0,,,,2,2,1,3
C(C(C=CC=O)C(C)(CC=O)O)=O,,,5,1,1,0,1
17816_0,,,,2,2,1,3
C(C(C=C)C(C)(CC=O)O)=O,,,5,1,1,0,1
17818_0,,,,2,2,1,3
C(CC(C)(C1C(C=CO1)=O)O)=O,,,5,1,2,0,2
17818_1,,,,2,2,1,3
17819_0,,,,2,2,1,3
17819_1,,,,2,2,1,3
17820_0,,,,2,2,1,3
17821_0,,,,2,2,1,3
17821_1,,,,2,2,1,3
17823_0,,,,2,2,1,3
C(CC(C)(C(C(C=O)=O)CO)O)=O,,,5,1,3,0,3
17823_1,,,,2,2,1,3
17825_0,,,,2,2,1,3
C(CC(C)(C(C=O)C(C=O)O)O)=O,,,5,1,3,0,3
17825_1,,,,2,2,1,3
17827_0,,,,2,2,1,3
C(CC(C)(C(C=O)C(CO)=O)O)=O,,,5,1,3,0,3
17827_1,,,,2,2,1,3
17829_0,,,,2,2,1,3
C(CC(C)(C(C(CC=O)=O)O)O)=O,,,5,1,3,0,3
17829_1,,,,2,2,1,3
17831_0,,,,2,2,1,3
C(C(C(CC(C)(CC=O)O)=O)O)=O,,,5,1,2,0,2
17833_0,,,,2,2,1,3
C(CC(C)(CC=O)O)=O,,,5,1,2,0,2
17834_0,,,,2,2,1,3
17834_1,,,,2,2,1,3
17836_0,,,,2,2,1,3
C(C(C(C)O)C(C)(CC=O)O)=O,,,5,1,3,0,3
17836_1,,,,2,2,1,3
17838_0,,,,2,2,1,3
C(C(CO)C(C)(CC=O)O)=O,,,5,1,4,0,4
17838_1,,,,2,2,1,3
17840_0,,,,2,2,1,3
C(C(C(CO)O)C(C)(CC=O)O)=O,,,5,1,4,0,4
17840_1,,,,2,2,1,3
17841_0,,,,2,2,1,3
17841_1,,,,2,2,1,3
17843_0,,,,2,2,1,3
C(CC(C)(CC(C(CO)=O)=O)O)=O,,,5,1,2,0,2
17845_0,,,,2,2,1,3
C(CC(C)(C(C(C)=O)O)O)=O,,,5,1,3,0,3
17845_1,,,,2,2,1,3
17847_0,,,,2,2,1,3
C(CC(C)(CC(CO)=O)O)=O,,,5,1,3,0,3
17849_0,,,,2,2,1,3
C(CC(C)(C(C(CCO)=O)O)O)=O,,,5,1,2,0,2
17849_1,,,,2,2,1,3
17851_0,,,,2,2,1,3
C(CC(C)(C(C(CO)=O)CO)O)=O,,,5,1,3,0,3
17851_1,,,,2,2,1,3
17853_0,,,,2,2,1,3
C(CC(C)(CC(C(CO)O)=O)O)=O,,,5,1,2,0,2
17855_0,,,,2,2,1,3
C(CC(C)(CC(C(O)=O)=O)O)=O,,,5,1,4,0,4
17857_0,,,,2,2,1,3
C(C(C=O)C(C)(CC=O)O)(O)=O,,,5,1,3,0,3
17857_1,,,,2,2,1,3
17859_0,,,,2,2,1,3
C(CC(C)(C(C(C(O)=O)=O)O)O)=O,,,5,1,4,0,4
17859_1,,,,2,2,1,3
17861_0,,,,2,2,1,3
C(C(C(C=O)=O)C(C)(CC=O)O)=O,,,5,1,3,0,3
17861_1,,,,2,2,1,3
17863_0,,,,2,2,1,3
C(CC(C)(C1C(C(CO1)O)=O)O)=O,,,5,1,2,0,2
17863_1,,,,2,2,1,3
17865_0,,,,2,2,1,3
C(CC(C)(C1C(C(O)OC1)=O)O)=O,,,5,1,2,0,2
17865_1,,,,2,2,1,3
17867_0,,,,2,2,1,3
C(CC(C)(C1C(COC1O)=O)O)=O,,,5,1,2,0,2
17867_1,,,,2,2,1,3
17869_0,,,,2,2,1,3
C(CC(C)(C1C(CC(O1)O)=O)O)=O,,,5,1,2,0,2
17869_1,,,,2,2,1,3
17871_0,,,,2,2,1,3
C(CC(C)(CC(C(C=O)=O)=O)O)=O,,,5,1,2,0,2
17872_0,,,,2,2,1,3
17872_1,,,,2,2,1,3
17874_0,,,,2,2,1,3
C(C(C(C)=O)C(CO)(C(C)O)O)=O,,,5,1,2,0,2
17874_1,,,,2,2,1,3
17876_0,,,,2,2,1,3
C(OCC(C)(C(C=O)C(C)=O)O)=O,,,5,1,2,0,2
17876_1,,,,2,2,1,3
17878_0,,,,2,2,1,3
C(C(C(C)=O)C(C=C)(CO)O)=O,,,5,1,2,0,2
17878_1,,,,2,2,1,3
17880_0,,,,2,2,1,3
C(C(C(C)=O)C(C=CCO)O)=O,,,5,1,2,0,2
17880_1,,,,2,2,1,3
17882_0,,,,2,2,1,3
C(C(C(C)=O)C(C(O)=O)(C=C)O)=O,,,5,1,2,0,2
17882_1,,,,2,2,1,3
17884_0,,,,2,2,1,3
C(C(C(C)=O)C(C=CC(O)=O)O)=O,,,5,1,2,0,2
17884_1,,,,2,2,1,3
17886_0,,,,2,2,1,3
C(C(C(C)=O)C(C(CO)(O)O)O)=O,,,5,1,2,0,2
17886_1,,,,2,2,1,3
17888_0,,,,2,2,1,3
C(C(C(C)=O)C(C(C)(CO)O)O)=O,,,5,1,2,0,2
17888_1,,,,2,2,1,3
17890_0,,,,2,2,1,3
C(C(CC)(C(C=O)C(C)=O)O)=O,,,5,1,2,0,2
17890_1,,,,2,2,1,3
17892_0,,,,2,2,1,3
C(C)(C(C=O)C(C(CC)=O)O)=O,,,5,1,2,0,2
17892_1,,,,2,2,1,3
17894_0,,,,2,2,1,3
C(CCC(C(C=O)C(C)=O)O)=O,,,5,1,3,0,3
17894_1,,,,2,2,1,3
17896_0,,,,2,2,1,3
C(C(C(C)=O)C(C(C)=O)(C)O)=O,,,5,1,2,0,2
17896_1,,,,2,2,1,3
17898_0,,,,2,2,1,3
C(C(CC)(C(C=O)C(C)=O)O)(O)=O,,,5,1,2,0,2
17898_1,,,,2,2,1,3
17900_0,,,,2,2,1,3
C(CC(C)(C(C=O)C(C)=O)O)(O)=O,,,5,1,2,0,2
17900_1,,,,2,2,1,3
17902_0,,,,2,2,1,3
C(C(C)C(C(C=O)C(C)=O)O)(O)=O,,,5,1,2,0,2
17902_1,,,,2,2,1,3
17904_0,,,,2,2,1,3
C1(C(CCO1)(C(C=O)C(C)=O)O)=O,,,5,1,2,0,2
17904_1,,,,2,2,1,3
17906_0,,,,2,2,1,3
C1(CC(CO1)(C(C=O)C(C)=O)O)=O,,,5,1,2,0,2
17906_1,,,,2,2,1,3
17908_0,,,,2,2,1,3
C(C(C(C)=O)C(C=C(C=O)C)O)=O,,,5,1,2,0,2
17908_1,,,,2,2,1,3
17910_0,,,,2,2,1,3
C(C(C(C)=O)C(C(C)=CC=O)O)=O,,,5,1,2,0,2
17910_1,,,,2,2,1,3
17912_0,,,,2,2,1,3
C(C(C(C)=O)C(CC(C=O)=C)O)=O,,,5,1,2,0,2
17912_1,,,,2,2,1,3
17914_0,,,,2,2,1,3
C(C(C(C)=O)C(C(CC=O)=C)O)=O,,,5,1,2,0,2
17914_1,,,,2,2,1,3
17916_0,,,,2,2,1,3
C(C(C(C)=O)C(C=CC(C)=O)O)=O,,,5,1,2,0,2
17916_1,,,,2,2,1,3
17918_0,,,,2,2,1,3
C(C(C(C)=O)C(C=CC=O)(C)O)=O,,,5,1,2,0,2
17918_1,,,,2,2,1,3
17920_0,,,,2,2,1,3
C(C(C(C)=O)C(C=O)(CC=C)O)=O,,,5,1,2,0,2
17920_1,,,,2,2,1,3
17922_0,,,,2,2,1,3
C(C(C(C)=O)C(C(CC=C)=O)O)=O,,,5,1,2,0,2
17922_1,,,,2,2,1,3
17924_0,,,,2,2,1,3
C(C(C(C)=O)C(C=O)(C=CC)O)=O,,,5,1,2,0,2
17924_1,,,,2,2,1,3
17926_0,,,,2,2,1,3
C(C(C(C)=O)C(C(C=CC)=O)O)=O,,,5,1,2,0,2
17926_1,,,,2,2,1,3
17928_0,,,,2,2,1,3
C(C(C(C)=O)C(C=CC(C=O)=O)O)=O,,,5,1,2,0,2
17928_1,,,,2,2,1,3
17930_0,,,,2,2,1,3
C(C(C(C)=O)C(C=O)(C=CC=O)O)=O,,,5,1,2,0,2
17930_1,,,,2,2,1,3
17932_0,,,,2,2,1,3
C(C(C(C)=O)C(C(C=CC=O)=O)O)=O,,,5,1,2,0,2
17932_1,,,,2,2,1,3
17934_0,,,,2,2,1,3
C(C(C(C)=O)C(C=CCC=O)O)=O,,,5,1,2,0,2
17934_1,,,,2,2,1,3
17936_0,,,,2,2,1,3
C(C(C(C)=O)C(CC=CC=O)O)=O,,,5,1,2,0,2
17936_1,,,,2,2,1,3
17937_0,,,,2,2,1,3
17937_1,,,,2,2,1,3
17939_0,,,,2,2,1,3
C(C(C(C)=O)C(C(C=O)=CC)O)=O,,,5,1,2,0,2
17939_1,,,,2,2,1,3
17941_0,,,,2,2,1,3
C(C(C(C)=O)C(C=C(C=O)C=O)O)=O,,,5,1,2,0,2
17941_1,,,,2,2,1,3
17943_0,,,,2,2,1,3
C(C(C(C)=O)C(C(C=O)=CC=O)O)=O,,,5,1,2,0,2
17943_1,,,,2,2,1,3
17945_0,,,,2,2,1,3
C(C(C(C)=O)C(C(C=O)=C)O)=O,,,5,1,2,0,2
17945_1,,,,2,2,1,3
17947_0,,,,2,2,1,3
C(C(C(C)=O)C(C=CC)O)=O,,,5,1,2,0,2
17947_1,,,,2,2,1,3
17949_0,,,,2,2,1,3
C(C(C(C)=O)C(CC=C)O)=O,,,5,1,2,0,2
17949_1,,,,2,2,1,3
17951_0,,,,2,2,1,3
C(C(C(C)=O)C(C(C=C)O)O)=O,,,5,1,2,0,2
17951_1,,,,2,2,1,3
17953_0,,,,2,2,1,3
C(C(C(C)=O)C(C=C)O)=O,,,5,1,2,0,2
17953_1,,,,2,2,1,3
17955_0,,,,2,2,1,3
C(C(C(C)=O)C(C=O)(C(C=O)=C)O)=O,,,5,1,2,0,2
17955_1,,,,2,2,1,3
17957_0,,,,2,2,1,3
C(C(C(C)=O)C(C(C(C=O)=C)=O)O)=O,,,5,1,2,0,2
17957_1,,,,2,2,1,3
17959_0,,,,2,2,1,3
C(C(C(C)=O)C(C(C(C=O)=O)=C)O)=O,,,5,1,2,0,2
17959_1,,,,2,2,1,3
17961_0,,,,2,2,1,3
C(C(C(C)=O)C1(C=COC1)O)=O,,,5,1,2,0,2
17961_1,,,,2,2,1,3
17962_0,,,,2,2,1,3
17962_1,,,,2,2,1,3
17963_0,,,,2,2,1,3
17963_1,,,,2,2,1,3
17965_0,,,,2,2,1,3
C(C(C(C)=O)C(CO)(CO)O)=O,,,5,1,6,0,6
17965_1,,,,2,2,1,3
17966_0,,,,2,2,1,3
17966_1,,,,2,2,1,3
17968_0,,,,2,2,1,3
C(C(C)(C(C=O)C(C)=O)O)=O,,,5,1,5,0,5
17968_1,,,,2,2,1,3
17970_0,,,,2,2,1,3
C(C(C(C)=O)C(C(C)=O)O)=O,,,5,1,6,0,6
17970_1,,,,2,2,1,3
17971_0,,,,2,2,1,3
17971_1,,,,2,2,1,3
17973_0,,,,2,2,1,3
C(C(CCO)(C(C=O)C(C)=O)O)=O,,,5,1,2,0,2
17973_1,,,,2,2,1,3
17975_0,,,,2,2,1,3
C(C)(C(C=O)C(C(CCO)=O)O)=O,,,5,1,2,0,2
17975_1,,,,2,2,1,3
17977_0,,,,2,2,1,3
C(CC(C(C(C=O)C(C)=O)O)O)=O,,,5,1,3,0,3
17977_1,,,,2,2,1,3
17979_0,,,,2,2,1,3
C(C(CC(C(C=O)C(C)=O)O)O)=O,,,5,1,2,0,2
17979_1,,,,2,2,1,3
17980_0,,,,2,2,1,3
17980_1,,,,2,2,1,3
17982_0,,,,2,2,1,3
C(CC(CO)(C(C=O)C(C)=O)O)=O,,,5,1,3,0,3
17982_1,,,,2,2,1,3
17983_0,,,,2,2,1,3
17983_1,,,,2,2,1,3
17985_0,,,,2,2,1,3
C(C(C(C)(C(C=O)C(C)=O)O)O)=O,,,5,1,4,0,4
17985_1,,,,2,2,1,3
17987_0,,,,2,2,1,3
C(C(C(C)=O)C(C)O)=O,,,5,1,8,0,8
17987_1,,,,2,2,1,3
17988_0,,,,2,2,1,3
17988_1,,,,2,2,1,3
17990_0,,,,2,2,1,3
C(C(C(C)=O)C(C(CO)=O)O)=O,,,5,1,6,0,6
17990_1,,,,2,2,1,3
17991_0,,,,2,2,1,3
17991_1,,,,2,2,1,3
17993_0,,,,2,2,1,3
C(C(C(C)=O)C(CC(C)O)O)=O,,,5,1,5,0,5
17993_1,,,,2,2,1,3
17995_0,,,,2,2,1,3
C(C(C(C)=O)C(C(C(C)O)O)O)=O,,,5,1,2,0,2
17995_1,,,,2,2,1,3
17997_0,,,,2,2,1,3
C(C(C(C)=O)C(CCO)O)=O,,,5,1,5,0,5
17997_1,,,,2,2,1,3
17999_0,,,,2,2,1,3
C(C(C(C)=O)C(CC(CO)O)O)=O,,,5,1,2,0,2
17999_1,,,,2,2,1,3
18001_0,,,,2,2,1,3
C(C(C(C)=O)C(C(C)=O)(CO)O)=O,,,5,1,2,0,2
18001_1,,,,2,2,1,3
18003_0,,,,2,2,1,3
C(C)(C(C=O)C(C(CO)=O)(C)O)=O,,,5,1,2,0,2
18003_1,,,,2,2,1,3
18005_0,,,,2,2,1,3
C(C(C(C)O)(C(C=O)C(C)=O)O)=O,,,5,1,3,0,3
18005_1,,,,2,2,1,3
18007_0,,,,2,2,1,3
C(C)(C(C=O)C(C(C(C)O)=O)O)=O,,,5,1,2,0,2
18007_1,,,,2,2,1,3
18008_0,,,,2,2,1,3
18008_1,,,,2,2,1,3
18010_0,,,,2,2,1,3
C(C(C(C)=O)C(C)(CO)O)=O,,,5,1,5,0,5
18010_1,,,,2,2,1,3
18012_0,,,,2,2,1,3
C(C(C(C)=O)C(CO)(CCO)O)=O,,,5,1,2,0,2
18012_1,,,,2,2,1,3
18014_0,,,,2,2,1,3
C(C(C(C)=O)C(C(CCO)O)O)=O,,,5,1,2,0,2
18014_1,,,,2,2,1,3
18016_0,,,,2,2,1,3
C(C(C(C)=O)C(C)(C(CO)O)O)=O,,,5,1,2,0,2
18016_1,,,,2,2,1,3
18018_0,,,,2,2,1,3
C(C(C)(C(C=O)C(C)=O)O)(O)=O,,,5,1,6,0,6
18018_1,,,,2,2,1,3
18020_0,,,,2,2,1,3
C(CC(C(C=O)C(C)=O)O)(O)=O,,,5,1,5,0,5
18020_1,,,,2,2,1,3
18022_0,,,,2,2,1,3
C(C(CO)(C(C=O)C(C)=O)O)(O)=O,,,5,1,5,0,5
18022_1,,,,2,2,1,3
18024_0,,,,2,2,1,3
C(C(C(C)=O)C(C=O)(CC=O)O)=O,,,5,1,3,0,3
18024_1,,,,2,2,1,3
18026_0,,,,2,2,1,3
C(C(C(C)=O)C(C(CC=O)=O)O)=O,,,5,1,2,0,2
18026_1,,,,2,2,1,3
18027_0,,,,2,2,1,3
18027_1,,,,2,2,1,3
18029_0,,,,2,2,1,3
C(C(C(C)=O)C1(COCC1O)O)=O,,,5,1,2,0,2
18029_1,,,,2,2,1,3
18031_0,,,,2,2,1,3
C(C(C(C)=O)C1(C(O)OCC1)O)=O,,,5,1,2,0,2
18031_1,,,,2,2,1,3
18033_0,,,,2,2,1,3
C(C(C(C)=O)C1(COC(C1)O)O)=O,,,5,1,2,0,2
18033_1,,,,2,2,1,3
18035_0,,,,2,2,1,3
C(C(C(C)=O)C(C=O)(C(C)=O)O)=O,,,5,1,2,0,2
18035_1,,,,2,2,1,3
18037_0,,,,2,2,1,3
C(C(C(C)=O)C(C(C(C)=O)=O)O)=O,,,5,1,2,0,2
18037_1,,,,2,2,1,3
18039_0,,,,2,2,1,3
C(C(C(C)=O)C(C(C=O)=O)(C)O)=O,,,5,1,2,0,2
18039_1,,,,2,2,1,3
18041_0,,,,2,2,1,3
C(C(C(C)=O)C(C=O)(C=C)O)=O,,,5,1,5,0,5
18041_1,,,,2,2,1,3
18043_0,,,,2,2,1,3
C(C(C(C)=O)C(C(C=C)=O)O)=O,,,5,1,5,0,5
18043_1,,,,2,2,1,3
18045_0,,,,2,2,1,3
C(C(C(C)=O)C(C=CC=O)O)=O,,,5,1,5,0,5
18045_1,,,,2,2,1,3
18047_0,,,,2,2,1,3
C(C(C(O)=O)C(C)=O)=O,,,5,1,9,0,9
18047_1,,,,2,2,1,3
18049_0,,,,2,2,1,3
C(C(C(C)=O)C(C(O)O)O)=O,,,5,1,5,0,5
18049_1,,,,2,2,1,3
18051_0,,,,2,2,1,3
C(C(C(C)=O)C(C(C)O)O)=O,,,5,1,5,0,5
18051_1,,,,2,2,1,3
18052_0,,,,2,2,1,3
18052_1,,,,2,2,1,3
18053_0,,,,2,2,1,3
18053_1,,,,2,2,1,3
18055_0,,,,2,2,1,3
C(CC(CC(CO)(C(C)O)O)=O)=O,,,5,1,1,0,1
18057_0,,,,2,2,1,3
C(OCC(C)(CC(CC=O)=O)O)=O,,,5,1,1,0,1
18059_0,,,,2,2,1,3
C(CC(CC(C=C)(CO)O)=O)=O,,,5,1,1,0,1
18061_0,,,,2,2,1,3
C(CC(CC(C=CCO)O)=O)=O,,,5,1,1,0,1
18063_0,,,,2,2,1,3
C(C(C=C)(CC(CC=O)=O)O)(O)=O,,,5,1,1,0,1
18065_0,,,,2,2,1,3
C(CC(CC(C=CC(O)=O)O)=O)=O,,,5,1,1,0,1
18067_0,,,,2,2,1,3
C(CC(CC(C(CO)(O)O)O)=O)=O,,,5,1,1,0,1
18069_0,,,,2,2,1,3
C(CC(CC(C(C)(CO)O)O)=O)=O,,,5,1,1,0,1
18071_0,,,,2,2,1,3
C(C(CC)(CC(CC=O)=O)O)=O,,,5,1,1,0,1
18073_0,,,,2,2,1,3
C(CC(C(CC)=O)O)(CC=O)=O,,,5,1,1,0,1
18075_0,,,,2,2,1,3
C(CC(CC(CCC=O)O)=O)=O,,,5,1,2,0,2
18077_0,,,,2,2,1,3
C(C)(C(C)(CC(CC=O)=O)O)=O,,,5,1,1,0,1
18079_0,,,,2,2,1,3
C(C(CC)(CC(CC=O)=O)O)(O)=O,,,5,1,1,0,1
18081_0,,,,2,2,1,3
C(CC(CC(C)(CC(O)=O)O)=O)=O,,,5,1,1,0,1
18083_0,,,,2,2,1,3
C(C(C)C(CC(CC=O)=O)O)(O)=O,,,5,1,1,0,1
18085_0,,,,2,2,1,3
C1(C(CCO1)(CC(CC=O)=O)O)=O,,,5,1,1,0,1
18087_0,,,,2,2,1,3
C(CC(CC1(COC(C1)=O)O)=O)=O,,,5,1,1,0,1
18089_0,,,,2,2,1,3
C(CC(CC(C=C(C=O)C)O)=O)=O,,,5,1,1,0,1
18091_0,,,,2,2,1,3
C(CC(CC(C(C)=CC=O)O)=O)=O,,,5,1,1,0,1
18093_0,,,,2,2,1,3
C(CC(CC(CC(C=O)=C)O)=O)=O,,,5,1,1,0,1
18095_0,,,,2,2,1,3
C(CC(C(CC(CC=O)=O)O)=C)=O,,,5,1,1,0,1
18097_0,,,,2,2,1,3
C(CC(CC(C=CC(C)=O)O)=O)=O,,,5,1,1,0,1
18099_0,,,,2,2,1,3
C(CC(CC(C=CC=O)(C)O)=O)=O,,,5,1,1,0,1
18101_0,,,,2,2,1,3
C(CC(CC(C=O)(CC=C)O)=O)=O,,,5,1,1,0,1
18103_0,,,,2,2,1,3
C(CC(CC(C(CC=C)=O)O)=O)=O,,,5,1,1,0,1
18105_0,,,,2,2,1,3
C(C(C=CC)(CC(CC=O)=O)O)=O,,,5,1,1,0,1
18107_0,,,,2,2,1,3
C(CC(CC(C(C=CC)=O)O)=O)=O,,,5,1,1,0,1
18109_0,,,,2,2,1,3
C(CC(CC(C=CC(C=O)=O)O)=O)=O,,,5,1,1,0,1
18111_0,,,,2,2,1,3
C(C(C=CC=O)(CC(CC=O)=O)O)=O,,,5,1,1,0,1
18113_0,,,,2,2,1,3
C(CC(CC(C(C=CC=O)=O)O)=O)=O,,,5,1,1,0,1
18115_0,,,,2,2,1,3
C(CC=CC(CC(CC=O)=O)O)=O,,,5,1,1,0,1
18117_0,,,,2,2,1,3
C(CC(CC(CC=CC=O)O)=O)=O,,,5,1,1,0,1
18119_0,,,,2,2,1,3
C(C(C=C)C(CC(CC=O)=O)O)=O,,,5,1,2,0,2
18121_0,,,,2,2,1,3
C(CC(CC(C(C=O)=CC)O)=O)=O,,,5,1,1,0,1
18123_0,,,,2,2,1,3
C(CC(CC(C=C(C=O)C=O)O)=O)=O,,,5,1,1,0,1
18125_0,,,,2,2,1,3
C(CC(CC(C(C=O)=CC=O)O)=O)=O,,,5,1,1,0,1
18127_0,,,,2,2,1,3
C(CC(CC(C(C=O)=C)O)=O)=O,,,5,1,1,0,1
18129_0,,,,2,2,1,3
C(CC(CC(C=CC)O)=O)=O,,,5,1,1,0,1
18131_0,,,,2,2,1,3
C(CC(CC(CC=C)O)=O)=O,,,5,1,1,0,1
18133_0,,,,2,2,1,3
C(CC(C(C=C)O)O)(CC=O)=O,,,5,1,1,0,1
18135_0,,,,2,2,1,3
C(CC(CC(C=C)O)=O)=O,,,5,1,1,0,1
18137_0,,,,2,2,1,3
C(C(C(C=O)=C)(CC(CC=O)=O)O)=O,,,5,1,1,0,1
18139_0,,,,2,2,1,3
C(CC(CC(C(C(C=O)=C)=O)O)=O)=O,,,5,1,1,0,1
18141_0,,,,2,2,1,3
C(CC(CC(C(C(C=O)=O)=C)O)=O)=O,,,5,1,1,0,1
18143_0,,,,2,2,1,3
C(CC(CC1(C=COC1)O)=O)=O,,,5,1,1,0,1
18144_0,,,,2,2,1,3
18145_0,,,,2,2,1,3
18147_0,,,,2,2,1,3
C(CC(CC(CO)(CO)O)=O)=O,,,5,1,5,0,5
18148_0,,,,2,2,1,3
18150_0,,,,2,2,1,3
C(C(C)(CC(CC=O)=O)O)=O,,,5,1,4,0,4
18152_0,,,,2,2,1,3
C(CC(CC(C(C)=O)O)=O)=O,,,5,1,5,0,5
18154_0,,,,2,2,1,3
C(CC(CC(CC=O)O)=O)=O,,,5,1,6,0,6
18156_0,,,,2,2,1,3
C(C(CCO)(CC(CC=O)=O)O)=O,,,5,1,1,0,1
18158_0,,,,2,2,1,3
C(CC(C(CCO)=O)O)(CC=O)=O,,,5,1,1,0,1
18160_0,,,,2,2,1,3
C(CC(CC(C(CC=O)O)O)=O)=O,,,5,1,2,0,2
18162_0,,,,2,2,1,3
C(CC(CC(C=O)O)O)(CC=O)=O,,,5,1,1,0,1
18164_0,,,,2,2,1,3
C(CC(CC(CO)=O)O)(CC=O)=O,,,5,1,2,0,2
18166_0,,,,2,2,1,3
C(CC(CC(CO)(CC=O)O)=O)=O,,,5,1,2,0,2
18168_0,,,,2,2,1,3
C(CC(C(C(C)=O)O)O)(CC=O)=O,,,5,1,3,0,3
18170_0,,,,2,2,1,3
C(CC(C)(C(C=O)O)O)(CC=O)=O,,,5,1,3,0,3
18172_0,,,,2,2,1,3
C(CC(CC(C)O)=O)=O,,,5,1,6,0,6
18173_0,,,,2,2,1,3
18174_0,,,,2,2,1,3
18176_0,,,,2,2,1,3
C(C(CO)C(CC(CC=O)=O)O)=O,,,5,1,3,0,3
18178_0,,,,2,2,1,3
C(CC(CC(CC(C)O)O)=O)=O,,,5,1,2,0,2
18180_0,,,,2,2,1,3
C(CC(CC(C(C(C)O)O)O)=O)=O,,,5,1,1,0,1
18182_0,,,,2,2,1,3
C(CC(CC(CCO)O)=O)=O,,,5,1,2,0,2
18184_0,,,,2,2,1,3
C(CC(CC(CC(CO)O)O)=O)=O,,,5,1,1,0,1
18186_0,,,,2,2,1,3
C(C)(C(CO)(CC(CC=O)=O)O)=O,,,5,1,1,0,1
18188_0,,,,2,2,1,3
C(CO)(C(C)(CC(CC=O)=O)O)=O,,,5,1,1,0,1
18190_0,,,,2,2,1,3
C(C(C(C)O)(CC(CC=O)=O)O)=O,,,5,1,2,0,2
18192_0,,,,2,2,1,3
C(CC(C(C(C)O)=O)O)(CC=O)=O,,,5,1,1,0,1
18194_0,,,,2,2,1,3
C(CC(C(C=O)O)O)(CC=O)=O,,,5,1,10,0,10
18196_0,,,,2,2,1,3
C(CC(CC(C)(CO)O)=O)=O,,,5,1,2,0,2
18198_0,,,,2,2,1,3
C(CC(CC(CO)(CCO)O)=O)=O,,,5,1,1,0,1
18200_0,,,,2,2,1,3
C(CC(CC(C(CCO)O)O)=O)=O,,,5,1,1,0,1
18202_0,,,,2,2,1,3
C(CC(CC(C)(C(CO)O)O)=O)=O,,,5,1,1,0,1
18203_0,,,,2,2,1,3
18205_0,,,,2,2,1,3
C(CC(CC(CC(O)=O)O)=O)=O,,,5,1,2,0,2
18207_0,,,,2,2,1,3
C(C(CO)(CC(CC=O)=O)O)(O)=O,,,5,1,4,0,4
18209_0,,,,2,2,1,3
C(CC(CC(C=O)(CC=O)O)=O)=O,,,5,1,2,0,2
18211_0,,,,2,2,1,3
C(CC(CC(C(CC=O)=O)O)=O)=O,,,5,1,1,0,1
18213_0,,,,2,2,1,3
C(CC(CC(CC(C=O)=O)O)=O)=O,,,5,1,2,0,2
18215_0,,,,2,2,1,3
C(CC(CC1(COCC1O)O)=O)=O,,,5,1,1,0,1
18217_0,,,,2,2,1,3
C(CC(CC1(C(O)OCC1)O)=O)=O,,,5,1,1,0,1
18219_0,,,,2,2,1,3
C(CC(CC1(COC(C1)O)O)=O)=O,,,5,1,1,0,1
18221_0,,,,2,2,1,3
C(C(C(C)=O)(CC(CC=O)=O)O)=O,,,5,1,1,0,1
18223_0,,,,2,2,1,3
C(CC(CC(C(C(C)=O)=O)O)=O)=O,,,5,1,1,0,1
18225_0,,,,2,2,1,3
C(CC(CC(C(C=O)=O)(C)O)=O)=O,,,5,1,1,0,1
18227_0,,,,2,2,1,3
C(C(C=C)(CC(CC=O)=O)O)=O,,,5,1,2,0,2
18229_0,,,,2,2,1,3
C(CC(CC(C(C=C)=O)O)=O)=O,,,5,1,2,0,2
18231_0,,,,2,2,1,3
C(CC(CC(C=CC=O)O)=O)=O,,,5,1,2,0,2
18232_0,,,,2,2,1,3
18234_0,,,,2,2,1,3
C(CC(CC(C(O)O)O)=O)=O,,,5,1,2,0,2
18236_0,,,,2,2,1,3
C(CC(CC(C(C)O)O)=O)=O,,,5,1,2,0,2
18237_0,,,,2,2,1,3
18238_0,,,,2,2,1,3
18240_0,,,,2,2,1,3
C(C(C=C)C(C(C=O)(CO)O)O)=O,,,5,1,3,0,3
18241_0,,,,2,2,1,3
18243_0,,,,2,2,1,3
C(C(C=O)C(C(C=O)(CO)O)O)=O,,,5,1,6,0,6
18243_1,,,,2,2,1,3
18244_0,,,,2,2,1,3
18245_0,,,,2,2,1,3
18245_1,,,,2,2,1,3
18246_0,,,,2,2,1,3
18246_1,,,,2,2,1,3
18247_0,,,,2,2,1,3
18248_0,,,,2,2,1,3
18248_1,,,,2,2,1,3
18249_0,,,,2,2,1,3
18250_0,,,,2,2,1,3
18251_0,,,,2,2,1,3
18252_0,,,,2,2,1,3
18252_1,,,,2,2,1,3
18254_0,,,,2,2,1,3
C(C(C=C)C(C(O)=O)(C(C)O)O)=O,,,5,1,1,0,1
18255_0,,,,2,2,1,3
18256_0,,,,2,2,1,3
18256_1,,,,2,2,1,3
18257_0,,,,2,2,1,3
18259_0,,,,2,2,1,3
C(C(CO)C(C(O)=O)(C(C)O)O)=O,,,5,1,7,0,7
18259_1,,,,2,2,1,3
18260_0,,,,2,2,1,3
18260_1,,,,2,2,1,3
18261_0,,,,2,2,1,3
18262_0,,,,2,2,1,3
18262_1,,,,2,2,1,3
18263_0,,,,2,2,1,3
18264_0,,,,2,2,1,3
18264_1,,,,2,2,1,3
18266_0,,,,2,2,1,3
C(CC(C(C(CO)=O)(C)O)O)=O,,,5,1,4,0,4
18268_0,,,,2,2,1,3
C(C(C(C(C(CO)=O)(C)O)O)O)=O,,,5,1,8,0,8
18268_1,,,,2,2,1,3
18270_0,,,,2,2,1,3
C(C(C(C(C(C=C)O)O)=O)(C)O)=O,,,5,1,2,0,2
18270_1,,,,2,2,1,3
18271_0,,,,2,2,1,3
18271_1,,,,2,2,1,3
18273_0,,,,2,2,1,3
C(C(C(C(C(C)O)O)=O)(C)O)=O,,,5,1,3,0,3
18273_1,,,,2,2,1,3
18275_0,,,,2,2,1,3
C(C(C(C(C(O)=O)O)=O)(C)O)=O,,,5,1,5,0,5
18275_1,,,,2,2,1,3
18276_0,,,,2,2,1,3
18276_1,,,,2,2,1,3
18277_0,,,,2,2,1,3
18277_1,,,,2,2,1,3
18278_0,,,,2,2,1,3
18279_0,,,,2,2,1,3
18279_1,,,,2,2,1,3
18281_0,,,,2,2,1,3
C(C(C=O)(C(C)(CC=O)O)O)=O,,,5,1,4,0,4
18282_0,,,,2,2,1,3
18282_1,,,,2,2,1,3
18284_0,,,,2,2,1,3
C(C(C=O)(C(CC(C=C)O)=O)O)=O,,,5,1,1,0,1
18286_0,,,,2,2,1,3
C(C(C=O)(C(CC(C=O)O)=O)O)=O,,,5,1,1,0,1
18288_0,,,,2,2,1,3
C(C(C=O)(C(CC(C)O)=O)O)=O,,,5,1,2,0,2
18290_0,,,,2,2,1,3
C(C(C=O)(C(CC(O)=O)=O)O)=O,,,5,1,1,0,1
18292_0,,,,2,2,1,3
C(C(C=O)(C(CCO)=O)O)=O,,,5,1,2,0,2
18294_0,,,,2,2,1,3
C(C(C=O)(C(CC(CO)O)=O)O)=O,,,5,1,1,0,1
18295_0,,,,2,2,1,3
18297_0,,,,2,2,1,3
C=CC(C(C(CO)(C(C)O)O)O)=O,,,5,1,4,0,4
18297_1,,,,2,2,1,3
18299_0,,,,2,2,1,3
C(C(C(C)C(CO)(C(C)O)O)=O)=O,,,5,1,1,0,1
18301_0,,,,2,2,1,3
C(C(C(CO)(C(C)O)O)CC=O)=O,,,5,1,4,0,4
18303_0,,,,2,2,1,3
C(C(C)=O)(CC(CO)(C(C)O)O)=O,,,5,1,1,0,1
18305_0,,,,2,2,1,3
C(C(C=C)C(CO)(C(C)O)O)=O,,,5,1,1,0,1
18307_0,,,,2,2,1,3
C1OC(C(C=1)=O)C(CO)(C(C)O)O,,,5,1,2,0,2
18307_1,,,,2,2,1,3
18309_0,,,,2,2,1,3
C(CO)(C(C(CO)(C(C)O)O)O)=O,,,5,1,6,0,6
18309_1,,,,2,2,1,3
18311_0,,,,2,2,1,3
C(C(CC(CO)(C(C)O)O)=O)=O,,,5,1,3,0,3
18313_0,,,,2,2,1,3
C(C(C=O)C(CO)(C(C)O)O)=O,,,5,1,4,0,4
18313_1,,,,2,2,1,3
18314_0,,,,2,2,1,3
18316_0,,,,2,2,1,3
C(C(C(C(CO)(C(C)O)O)O)=O)=O,,,5,1,4,0,4
18316_1,,,,2,2,1,3
18318_0,,,,2,2,1,3
C(C(C(C)O)C(CO)(C(C)O)O)=O,,,5,1,5,0,5
18318_1,,,,2,2,1,3
18320_0,,,,2,2,1,3
C(C(CO)C(CO)(C(C)O)O)=O,,,5,1,5,0,5
18320_1,,,,2,2,1,3
18322_0,,,,2,2,1,3
C(C)(C(C(CO)(C(C)O)O)O)=O,,,5,1,5,0,5
18322_1,,,,2,2,1,3
18324_0,,,,2,2,1,3
C(CO)(CC(CO)(C(C)O)O)=O,,,5,1,3,0,3
18326_0,,,,2,2,1,3
C(C(CC(CO)(C(C)O)O)=O)(O)=O,,,5,1,2,0,2
18328_0,,,,2,2,1,3
C(C(C=O)C(CO)(C(C)O)O)(O)=O,,,5,1,5,0,5
18328_1,,,,2,2,1,3
18329_0,,,,2,2,1,3
18329_1,,,,2,2,1,3
18331_0,,,,2,2,1,3
C(C(C(C=C)(CO)O)O)(C(C)O)=O,,,5,1,2,0,2
18331_1,,,,2,2,1,3
18333_0,,,,2,2,1,3
C(C(C(C=CCO)O)O)(C(C)O)=O,,,5,1,2,0,2
18333_1,,,,2,2,1,3
18335_0,,,,2,2,1,3
C(C(CC)(C(C(C(C)O)=O)O)O)=O,,,5,1,2,0,2
18335_1,,,,2,2,1,3
18337_0,,,,2,2,1,3
C(C(C(C(C(C)O)=O)O)O)(CC)=O,,,5,1,2,0,2
18337_1,,,,2,2,1,3
18339_0,,,,2,2,1,3
C(CCC(C(C(C(C)O)=O)O)O)=O,,,5,1,3,0,3
18339_1,,,,2,2,1,3
18341_0,,,,2,2,1,3
C(C)(C(C)(C(C(C(C)O)=O)O)O)=O,,,5,1,2,0,2
18341_1,,,,2,2,1,3
18343_0,,,,2,2,1,3
C(C(C(C(C=O)=C)O)O)(C(C)O)=O,,,5,1,2,0,2
18343_1,,,,2,2,1,3
18345_0,,,,2,2,1,3
C(C(C(C=CC)O)O)(C(C)O)=O,,,5,1,2,0,2
18345_1,,,,2,2,1,3
18347_0,,,,2,2,1,3
C(C(C(CC=C)O)O)(C(C)O)=O,,,5,1,2,0,2
18347_1,,,,2,2,1,3
18349_0,,,,2,2,1,3
C(C(C)O)(C(C(C(C=C)O)O)O)=O,,,5,1,2,0,2
18349_1,,,,2,2,1,3
18351_0,,,,2,2,1,3
C(C(C(C=C)O)O)(C(C)O)=O,,,5,1,2,0,2
18351_1,,,,2,2,1,3
18353_0,,,,2,2,1,3
C(C(C1(C=COC1)O)O)(C(C)O)=O,,,5,1,2,0,2
18353_1,,,,2,2,1,3
18355_0,,,,2,2,1,3
C(C(C(C(CO)O)O)O)(C(C)O)=O,,,5,1,6,0,6
18355_1,,,,2,2,1,3
18356_0,,,,2,2,1,3
18356_1,,,,2,2,1,3
18358_0,,,,2,2,1,3
C(C(C(CO)(CO)O)O)(C(C)O)=O,,,5,1,6,0,6
18358_1,,,,2,2,1,3
18359_0,,,,2,2,1,3
18359_1,,,,2,2,1,3
18360_0,,,,2,2,1,3
18360_1,,,,2,2,1,3
18361_0,,,,2,2,1,3
18361_1,,,,2,2,1,3
18363_0,,,,2,2,1,3
C(CC(C(C(C(C)O)=O)O)O)=O,,,5,1,5,0,5
18363_1,,,,2,2,1,3
18365_0,,,,2,2,1,3
C(C(C(C)O)O)(C(C)O)=O,,,5,1,3,0,3
18365_1,,,,2,2,1,3
18366_0,,,,2,2,1,3
18366_1,,,,2,2,1,3
18367_0,,,,2,2,1,3
18367_1,,,,2,2,1,3
18369_0,,,,2,2,1,3
C(C(C(CC(C)O)O)O)(C(C)O)=O,,,5,1,2,0,2
18369_1,,,,2,2,1,3
18371_0,,,,2,2,1,3
C(C(C(CCO)O)O)(C(C)O)=O,,,5,1,3,0,3
18371_1,,,,2,2,1,3
18373_0,,,,2,2,1,3
C(C(C(C(C(C(C)O)=O)O)O)O)=O,,,5,1,11,0,11
18373_1,,,,2,2,1,3
18375_0,,,,2,2,1,3
C(C(C(CO)(C)O)O)(C(C)O)=O,,,5,1,3,0,3
18375_1,,,,2,2,1,3
18376_0,,,,2,2,1,3
18376_1,,,,2,2,1,3
18378_0,,,,2,2,1,3
C(CC(C(C(C(C)O)=O)O)O)(O)=O,,,5,1,3,0,3
18378_1,,,,2,2,1,3
18380_0,,,,2,2,1,3
C(C(C=C)(C(C(C(C)O)=O)O)O)=O,,,5,1,3,0,3
18380_1,,,,2,2,1,3
18382_0,,,,2,2,1,3
C(C(C(C(C=C)=O)O)O)(C(C)O)=O,,,5,1,4,0,4
18382_1,,,,2,2,1,3
18384_0,,,,2,2,1,3
C(C(C(C=CC=O)O)O)(C(C)O)=O,,,5,1,2,0,2
18384_1,,,,2,2,1,3
18385_0,,,,2,2,1,3
18385_1,,,,2,2,1,3
18387_0,,,,2,2,1,3
C(C(C(C(O)O)O)O)(C(C)O)=O,,,5,1,2,0,2
18387_1,,,,2,2,1,3
18389_0,,,,2,2,1,3
C(C(C(C(C)O)O)O)(C(C)O)=O,,,5,1,4,0,4
18389_1,,,,2,2,1,3
18390_0,,,,2,2,1,3
18390_1,,,,2,2,1,3
18391_0,,,,2,2,1,3
18391_1,,,,2,2,1,3
18392_0,,,,2,2,1,3
18393_0,,,,2,2,1,3
18393_1,,,,2,2,1,3
18395_0,,,,2,2,1,3
C(C(C=O)(CC(CC=O)O)O)=O,,,5,1,4,0,4
18397_0,,,,2,2,1,3
C(C(C=O)(CC(C(C=O)O)O)O)=O,,,5,1,4,0,4
18397_1,,,,2,2,1,3
18399_0,,,,2,2,1,3
C(C(C=O)(C(C=O)C(C=C)O)O)=O,,,5,1,2,0,2
18399_1,,,,2,2,1,3
18400_0,,,,2,2,1,3
18400_1,,,,2,2,1,3
18401_0,,,,2,2,1,3
18401_1,,,,2,2,1,3
18402_0,,,,2,2,1,3
18402_1,,,,2,2,1,3
18403_0,,,,2,2,1,3
18403_1,,,,2,2,1,3
18404_0,,,,2,2,1,3
18404_1,,,,2,2,1,3
18405_0,,,,2,2,1,3
18406_0,,,,2,2,1,3
18408_0,,,,2,2,1,3
C(C(C(C(C(C)O)O)=O)(C)O)(O)=O,,,5,1,4,0,4
18408_1,,,,2,2,1,3
18410_0,,,,2,2,1,3
C(C(C(C(C(O)=O)O)=O)(C)O)(O)=O,,,5,1,4,0,4
18410_1,,,,2,2,1,3
18411_0,,,,2,2,1,3
18411_1,,,,2,2,1,3
18413_0,,,,2,2,1,3
C(C(C)(C(C)(CC=O)O)O)(O)=O,,,5,1,3,0,3
18414_0,,,,2,2,1,3
18414_1,,,,2,2,1,3
18416_0,,,,2,2,1,3
C(CC(C=C)O)(C(C(O)=O)(C)O)=O,,,5,1,1,0,1
18418_0,,,,2,2,1,3
C(CC(C=O)O)(C(C(O)=O)(C)O)=O,,,5,1,1,0,1
18420_0,,,,2,2,1,3
C(C(C(CC(C)O)=O)(C)O)(O)=O,,,5,1,2,0,2
18422_0,,,,2,2,1,3
C(C(C(CC(O)=O)=O)(C)O)(O)=O,,,5,1,1,0,1
18423_0,,,,2,2,1,3
18425_0,,,,2,2,1,3
C(C(C(CC(CO)O)=O)(C)O)(O)=O,,,5,1,3,0,3
18427_0,,,,2,2,1,3
C(OCC(C)(C(C(C=C)=O)O)O)=O,,,5,1,2,0,2
18427_1,,,,2,2,1,3
18429_0,,,,2,2,1,3
C(OCC(C)(C(C(C=O)=O)C)O)=O,,,5,1,1,0,1
18431_0,,,,2,2,1,3
C(C(C(C)(COC=O)O)CC=O)=O,,,5,1,1,0,1
18433_0,,,,2,2,1,3
C(OCC(C)(CC(C(C)=O)=O)O)=O,,,5,1,1,0,1
18435_0,,,,2,2,1,3
C(OCC(C)(C(C=O)C=C)O)=O,,,5,1,1,0,1
18437_0,,,,2,2,1,3
C(OCC(C)(C1C(C=CO1)=O)O)=O,,,5,1,2,0,2
18437_1,,,,2,2,1,3
18439_0,,,,2,2,1,3
C(OCC(C)(C(C(CO)=O)O)O)=O,,,5,1,2,0,2
18439_1,,,,2,2,1,3
18441_0,,,,2,2,1,3
C(OCC(C)(CC(C=O)=O)O)=O,,,5,1,1,0,1
18443_0,,,,2,2,1,3
C(OCC(C)(C(C=O)C=O)O)=O,,,5,1,2,0,2
18443_1,,,,2,2,1,3
18445_0,,,,2,2,1,3
C(OCC(C)(CC=O)O)=O,,,5,1,1,0,1
18447_0,,,,2,2,1,3
C(OCC(C)(C(C(C=O)=O)O)O)=O,,,5,1,2,0,2
18447_1,,,,2,2,1,3
18449_0,,,,2,2,1,3
C(OCC(C)(C(C=O)C(C)O)O)=O,,,5,1,2,0,2
18449_1,,,,2,2,1,3
18451_0,,,,2,2,1,3
C(OCC(C)(C(C=O)CO)O)=O,,,5,1,2,0,2
18451_1,,,,2,2,1,3
18453_0,,,,2,2,1,3
C(OCC(C)(C(C(C)=O)O)O)=O,,,5,1,2,0,2
18453_1,,,,2,2,1,3
18455_0,,,,2,2,1,3
C(OCC(C)(CC(CO)=O)O)=O,,,5,1,1,0,1
18457_0,,,,2,2,1,3
C(OCC(C)(CC(C(O)=O)=O)O)=O,,,5,1,1,0,1
18459_0,,,,2,2,1,3
C(OCC(C)(C(C(O)=O)C=O)O)=O,,,5,1,2,0,2
18459_1,,,,2,2,1,3
18461_0,,,,2,2,1,3
C(OCC(C)(C(C=O)O)O)=O,,,5,1,2,0,2
18461_1,,,,2,2,1,3
18463_0,,,,2,2,1,3
C(OCC(CC(C=C)(CO)O)=O)=O,,,5,1,1,0,1
18465_0,,,,2,2,1,3
C(OCC(CC(C=CCO)O)=O)=O,,,5,1,1,0,1
18467_0,,,,2,2,1,3
C(C(CC)(CC(COC=O)=O)O)=O,,,5,1,1,0,1
18469_0,,,,2,2,1,3
C(COC=O)(CC(C(CC)=O)O)=O,,,5,1,1,0,1
18471_0,,,,2,2,1,3
C(CCC(CC(COC=O)=O)O)=O,,,5,1,1,0,1
18473_0,,,,2,2,1,3
C(C)(C(C)(CC(COC=O)=O)O)=O,,,5,1,1,0,1
18475_0,,,,2,2,1,3
C(OCC(CC(C(C=O)=C)O)=O)=O,,,5,1,1,0,1
18477_0,,,,2,2,1,3
C(OCC(CC(C=CC)O)=O)=O,,,5,1,1,0,1
18479_0,,,,2,2,1,3
C(OCC(CC(CC=C)O)=O)=O,,,5,1,1,0,1
18481_0,,,,2,2,1,3
C(OCC(CC(C(C=C)O)O)=O)=O,,,5,1,1,0,1
18483_0,,,,2,2,1,3
C(OCC(CC(C=C)O)=O)=O,,,5,1,1,0,1
18485_0,,,,2,2,1,3
C(OCC(CC1(C=COC1)O)=O)=O,,,5,1,1,0,1
18487_0,,,,2,2,1,3
C(OCC(CC(C(CO)O)O)=O)=O,,,5,1,3,0,3
18489_0,,,,2,2,1,3
C(OCC(CC(C=O)O)=O)=O,,,5,1,3,0,3
18491_0,,,,2,2,1,3
C(OCC(CC(CO)(CO)O)=O)=O,,,5,1,3,0,3
18493_0,,,,2,2,1,3
C(OCC(CC(C(O)=O)O)=O)=O,,,5,1,3,0,3
18495_0,,,,2,2,1,3
C(C(C)(CC(COC=O)=O)O)=O,,,5,1,3,0,3
18497_0,,,,2,2,1,3
C(OCC(CC(C(C)=O)O)=O)=O,,,5,1,3,0,3
18499_0,,,,2,2,1,3
C(CC(CC(COC=O)=O)O)=O,,,5,1,5,0,5
18501_0,,,,2,2,1,3
C(OCC(CC(C)O)=O)=O,,,5,1,3,0,3
18503_0,,,,2,2,1,3
C(C(CO)(CC(COC=O)=O)O)=O,,,5,1,3,0,3
18505_0,,,,2,2,1,3
C(OCC(CC(C(CO)=O)O)=O)=O,,,5,1,3,0,3
18507_0,,,,2,2,1,3
C(OCC(CC(CC(C)O)O)=O)=O,,,5,1,3,0,3
18509_0,,,,2,2,1,3
C(OCC(CC(CCO)O)=O)=O,,,5,1,3,0,3
18511_0,,,,2,2,1,3
C(C(C(CC(COC=O)=O)O)O)=O,,,5,1,3,0,3
18513_0,,,,2,2,1,3
C(OCC(CC(C)(CO)O)=O)=O,,,5,1,3,0,3
18515_0,,,,2,2,1,3
C(C(C)(CC(COC=O)=O)O)(O)=O,,,5,1,3,0,3
18517_0,,,,2,2,1,3
C(CC(CC(COC=O)=O)O)(O)=O,,,5,1,3,0,3
18519_0,,,,2,2,1,3
C(OCC(CC(C=O)(C=C)O)=O)=O,,,5,1,3,0,3
18521_0,,,,2,2,1,3
C(OCC(CC(C(C=C)=O)O)=O)=O,,,5,1,3,0,3
18523_0,,,,2,2,1,3
C(OCC(CC(C=CC=O)O)=O)=O,,,5,1,3,0,3
18525_0,,,,2,2,1,3
C(OCC(CC(O)=O)=O)=O,,,5,1,3,0,3
18527_0,,,,2,2,1,3
C(OCC(CC(C(O)O)O)=O)=O,,,5,1,3,0,3
18529_0,,,,2,2,1,3
C(OCC(CC(C(C)O)O)=O)=O,,,5,1,3,0,3
18531_0,,,,2,2,1,3
C(OCC(CCO)=O)=O,,,5,1,3,0,3
18533_0,,,,2,2,1,3
C(OCC(CC(CO)O)=O)=O,,,5,1,3,0,3
18535_0,,,,2,2,1,3
C(OC(C(C)=O)C(C=C)(CO)O)=O,,,5,1,2,0,2
18535_1,,,,2,2,1,3
18537_0,,,,2,2,1,3
C(OC(C(C)=O)C(C=CCO)O)=O,,,5,1,2,0,2
18537_1,,,,2,2,1,3
18539_0,,,,2,2,1,3
C(C(CC)(C(C(C)=O)OC=O)O)=O,,,5,1,2,0,2
18539_1,,,,2,2,1,3
18541_0,,,,2,2,1,3
C(C(C(C(C)=O)OC=O)O)(CC)=O,,,5,1,2,0,2
18541_1,,,,2,2,1,3
18543_0,,,,2,2,1,3
C(CCC(C(C(C)=O)OC=O)O)=O,,,5,1,2,0,2
18543_1,,,,2,2,1,3
18545_0,,,,2,2,1,3
C(C)(C(C)(C(C(C)=O)OC=O)O)=O,,,5,1,2,0,2
18545_1,,,,2,2,1,3
18547_0,,,,2,2,1,3
C(OC(C(C)=O)C(C(C=O)=C)O)=O,,,5,1,2,0,2
18547_1,,,,2,2,1,3
18549_0,,,,2,2,1,3
C(OC(C(C)=O)C(C=CC)O)=O,,,5,1,2,0,2
18549_1,,,,2,2,1,3
18551_0,,,,2,2,1,3
C(OC(C(C)=O)C(CC=C)O)=O,,,5,1,2,0,2
18551_1,,,,2,2,1,3
18553_0,,,,2,2,1,3
C(OC(C(C)=O)C(C(C=C)O)O)=O,,,5,1,2,0,2
18553_1,,,,2,2,1,3
18555_0,,,,2,2,1,3
C(OC(C(C)=O)C(C=C)O)=O,,,5,1,2,0,2
18555_1,,,,2,2,1,3
18557_0,,,,2,2,1,3
C(OC(C(C)=O)C1(C=COC1)O)=O,,,5,1,2,0,2
18557_1,,,,2,2,1,3
18559_0,,,,2,2,1,3
C(OC(C(C)=O)C(C(CO)O)O)=O,,,5,1,3,0,3
18559_1,,,,2,2,1,3
18561_0,,,,2,2,1,3
C(OC(C(C)=O)C(C=O)O)=O,,,5,1,3,0,3
18561_1,,,,2,2,1,3
18563_0,,,,2,2,1,3
C(OC(C(C)=O)C(CO)(CO)O)=O,,,5,1,3,0,3
18563_1,,,,2,2,1,3
18565_0,,,,2,2,1,3
C(OC(C(C)=O)C(C(O)=O)O)=O,,,5,1,3,0,3
18565_1,,,,2,2,1,3
18567_0,,,,2,2,1,3
C(C(C)(C(C(C)=O)OC=O)O)=O,,,5,1,3,0,3
18567_1,,,,2,2,1,3
18569_0,,,,2,2,1,3
C(OC(C(C)=O)C(C(C)=O)O)=O,,,5,1,4,0,4
18569_1,,,,2,2,1,3
18571_0,,,,2,2,1,3
C(CC(C(C(C)=O)OC=O)O)=O,,,5,1,5,0,5
18571_1,,,,2,2,1,3
18573_0,,,,2,2,1,3
C(OC(C(C)=O)C(C)O)=O,,,5,1,3,0,3
18573_1,,,,2,2,1,3
18575_0,,,,2,2,1,3
C(C(CO)(C(C(C)=O)OC=O)O)=O,,,5,1,3,0,3
18575_1,,,,2,2,1,3
18577_0,,,,2,2,1,3
C(OC(C(C)=O)C(C(CO)=O)O)=O,,,5,1,3,0,3
18577_1,,,,2,2,1,3
18579_0,,,,2,2,1,3
C(OC(C(C)=O)C(CC(C)O)O)=O,,,5,1,3,0,3
18579_1,,,,2,2,1,3
18581_0,,,,2,2,1,3
C(OC(C(C)=O)C(CCO)O)=O,,,5,1,3,0,3
18581_1,,,,2,2,1,3
18583_0,,,,2,2,1,3
C(C(C(C(C(C)=O)OC=O)O)O)=O,,,5,1,3,0,3
18583_1,,,,2,2,1,3
18585_0,,,,2,2,1,3
C(OC(C(C)=O)C(C)(CO)O)=O,,,5,1,3,0,3
18585_1,,,,2,2,1,3
18587_0,,,,2,2,1,3
C(C(C)(C(C(C)=O)OC=O)O)(O)=O,,,5,1,3,0,3
18587_1,,,,2,2,1,3
18589_0,,,,2,2,1,3
C(CC(C(C(C)=O)OC=O)O)(O)=O,,,5,1,3,0,3
18589_1,,,,2,2,1,3
18591_0,,,,2,2,1,3
C(OC(C(C)=O)C(C=O)(C=C)O)=O,,,5,1,3,0,3
18591_1,,,,2,2,1,3
18593_0,,,,2,2,1,3
C(OC(C(C)=O)C(C(C=C)=O)O)=O,,,5,1,3,0,3
18593_1,,,,2,2,1,3
18595_0,,,,2,2,1,3
C(OC(C(C)=O)C(C=CC=O)O)=O,,,5,1,3,0,3
18595_1,,,,2,2,1,3
18597_0,,,,2,2,1,3
C(C(C(C)=O)OC=O)(O)=O,,,5,1,3,0,3
18597_1,,,,2,2,1,3
18599_0,,,,2,2,1,3
C(OC(C(C)=O)C(C(O)O)O)=O,,,5,1,3,0,3
18599_1,,,,2,2,1,3
18601_0,,,,2,2,1,3
C(OC(C(C)=O)C(C(C)O)O)=O,,,5,1,3,0,3
18601_1,,,,2,2,1,3
18603_0,,,,2,2,1,3
C(OC(C(C)=O)CO)=O,,,5,1,3,0,3
18603_1,,,,2,2,1,3
18605_0,,,,2,2,1,3
C(OC(C(C)=O)C(CO)O)=O,,,5,1,3,0,3
18605_1,,,,2,2,1,3
18607_0,,,,2,2,1,3
C(CC(C(O)OCC(C=O)O)O)=O,,,5,1,6,0,6
18609_0,,,,2,2,1,3
C(CC(C(COC(C=O)O)O)O)=O,,,5,1,3,0,3
18610_0,,,,2,2,1,3
18610_1,,,,2,2,1,3
18611_0,,,,2,2,1,3
18613_0,,,,2,2,1,3
C(CC(C(CO)O)(C(C)O)O)=O,,,5,1,2,0,2
18615_0,,,,2,2,1,3
C(C(C(C(CO)O)(C(C)O)O)O)=O,,,5,1,7,0,7
18615_1,,,,2,2,1,3
18617_0,,,,2,2,1,3
C(CC(C=O)(CC=O)O)(C(C)O)=O,,,5,1,2,0,2
18619_0,,,,2,2,1,3
C(CC(C(CC(C(C)O)=O)=O)O)=O,,,5,1,2,0,2
18621_0,,,,2,2,1,3
C(CC(C(C)O)(CC(C=O)=O)O)=O,,,5,1,2,0,2
18623_0,,,,2,2,1,3
C(C(C)O)(C(C(C=O)=O)C(C)O)=O,,,5,1,3,0,3
18623_1,,,,2,2,1,3
18625_0,,,,2,2,1,3
C(C(C(C(C)O)=O)C(C=O)=O)(O)=O,,,5,1,3,0,3
18625_1,,,,2,2,1,3
18626_0,,,,2,2,1,3
18626_1,,,,2,2,1,3
18628_0,,,,2,2,1,3
C(CC(C(C=O)C(C(C)O)=O)O)=O,,,5,1,4,0,4
18630_0,,,,2,2,1,3
C(C(C=O)C(C(C)O)(CC=O)O)=O,,,5,1,3,0,3
18632_0,,,,2,2,1,3
C(C(C=C)C(CC(C(C)O)=O)O)=O,,,5,1,1,0,1
18634_0,,,,2,2,1,3
C(C(C)O)(CC(CC(C=O)=O)O)=O,,,5,1,2,0,2
18636_0,,,,2,2,1,3
C(C(C=O)C(CC(C(C)O)=O)O)=O,,,5,1,3,0,3
18636_1,,,,2,2,1,3
18638_0,,,,2,2,1,3
C(CC(CC(C(C)O)=O)O)=O,,,5,1,2,0,2
18640_0,,,,2,2,1,3
C(C(C(CC(C(C)O)=O)O)CO)=O,,,5,1,3,0,3
18640_1,,,,2,2,1,3
18642_0,,,,2,2,1,3
C(C(C)O)(CC(C(C(C)=O)O)O)=O,,,5,1,3,0,3
18642_1,,,,2,2,1,3
18644_0,,,,2,2,1,3
C(C(C)O)(CC(CC(CO)=O)O)=O,,,5,1,2,0,2
18646_0,,,,2,2,1,3
C(C(C)O)(CC(C(C=O)O)O)=O,,,5,1,3,0,3
18646_1,,,,2,2,1,3
18648_0,,,,2,2,1,3
C(C(C=C)C(C(C)O)(CC=O)O)=O,,,5,1,1,0,1
18649_0,,,,2,2,1,3
18650_0,,,,2,2,1,3
18650_1,,,,2,2,1,3
18652_0,,,,2,2,1,3
C(CC(C(C)O)(CC=O)O)=O,,,5,1,1,0,1
18654_0,,,,2,2,1,3
C(C(CO)C(C(C)O)(CC=O)O)=O,,,5,1,2,0,2
18654_1,,,,2,2,1,3
18656_0,,,,2,2,1,3
C(CC(C(C)O)(C(C(C)=O)O)O)=O,,,5,1,2,0,2
18656_1,,,,2,2,1,3
18658_0,,,,2,2,1,3
C(CC(C(C)O)(CC(CO)=O)O)=O,,,5,1,1,0,1
18660_0,,,,2,2,1,3
C(CC(C(C)O)(C(C=O)O)O)=O,,,5,1,4,0,4
18660_1,,,,2,2,1,3
18662_0,,,,2,2,1,3
C(C(C)O)(C(C=O)C(C=CC)O)=O,,,5,1,2,0,2
18662_1,,,,2,2,1,3
18664_0,,,,2,2,1,3
C(C(C(C(C)O)=O)C(CC=C)O)=O,,,5,1,2,0,2
18664_1,,,,2,2,1,3
18666_0,,,,2,2,1,3
C(C(C)O)(C(C=O)C(C=C)O)=O,,,5,1,2,0,2
18666_1,,,,2,2,1,3
18667_0,,,,2,2,1,3
18667_1,,,,2,2,1,3
18669_0,,,,2,2,1,3
C(C(C)O)(C(C=O)C(C(O)=O)O)=O,,,5,1,5,0,5
18669_1,,,,2,2,1,3
18671_0,,,,2,2,1,3
C(C(C)O)(C(C=O)C(C=O)(C)O)=O,,,5,1,3,0,3
18671_1,,,,2,2,1,3
18673_0,,,,2,2,1,3
C(C(C)O)(C(C=O)C(C(C)=O)O)=O,,,5,1,3,0,3
18673_1,,,,2,2,1,3
18674_0,,,,2,2,1,3
18674_1,,,,2,2,1,3
18676_0,,,,2,2,1,3
C(C(C(C(C)O)=O)C(C)O)=O,,,5,1,4,0,4
18676_1,,,,2,2,1,3
18678_0,,,,2,2,1,3
C(C(C(C(C)O)=O)C(CCO)O)=O,,,5,1,3,0,3
18678_1,,,,2,2,1,3
18680_0,,,,2,2,1,3
C(C(C(C(C)O)=O)C(CO)(C)O)=O,,,5,1,3,0,3
18680_1,,,,2,2,1,3
18682_0,,,,2,2,1,3
C(C(C=O)C(C(C)O)=O)(O)=O,,,5,1,5,0,5
18682_1,,,,2,2,1,3
18684_0,,,,2,2,1,3
C(C(C(C(C)O)=O)C(C(O)O)O)=O,,,5,1,3,0,3
18684_1,,,,2,2,1,3
18686_0,,,,2,2,1,3
C(C(C(C(C)O)=O)C(C(C)O)O)=O,,,5,1,3,0,3
18686_1,,,,2,2,1,3
18688_0,,,,2,2,1,3
C(C(C(C(C)O)=O)CO)=O,,,5,1,5,0,5
18688_1,,,,2,2,1,3
18690_0,,,,2,2,1,3
C(C(C(C(C)O)=O)C(CO)O)=O,,,5,1,5,0,5
18690_1,,,,2,2,1,3
18691_0,,,,2,2,1,3
18692_0,,,,2,2,1,3
18693_0,,,,2,2,1,3
18693_1,,,,2,2,1,3
18694_0,,,,2,2,1,3
18696_0,,,,2,2,1,3
C(C(C(C(C)O)(C(C=O)O)O)O)=O,,,5,1,5,0,5
18696_1,,,,2,2,1,3
18697_0,,,,2,2,1,3
18697_1,,,,2,2,1,3
18699_0,,,,2,2,1,3
C(CC(CC(C(CCO)O)=O)O)=O,,,5,1,4,0,4
18701_0,,,,2,2,1,3
C(CC(C(CCO)O)(CC=O)O)=O,,,5,1,1,0,1
18703_0,,,,2,2,1,3
C(C(C(C(CCO)O)=O)C(C)O)=O,,,5,1,3,0,3
18703_1,,,,2,2,1,3
18705_0,,,,2,2,1,3
C(C(C=O)C(C(CCO)O)=O)(O)=O,,,5,1,4,0,4
18705_1,,,,2,2,1,3
18707_0,,,,2,2,1,3
C(C(C(C(CCO)O)=O)CO)=O,,,5,1,6,0,6
18707_1,,,,2,2,1,3
18708_0,,,,2,2,1,3
18708_1,,,,2,2,1,3
18710_0,,,,2,2,1,3
C(C(CO)CO)(C(C(CO)=O)O)=O,,,5,1,3,0,3
18710_1,,,,2,2,1,3
18711_0,,,,2,2,1,3
18711_1,,,,2,2,1,3
18712_0,,,,2,2,1,3
18712_1,,,,2,2,1,3
18713_0,,,,2,2,1,3
18713_1,,,,2,2,1,3
18714_0,,,,2,2,1,3
18714_1,,,,2,2,1,3
18715_0,,,,2,2,1,3
18715_1,,,,2,2,1,3
18716_0,,,,2,2,1,3
18716_1,,,,2,2,1,3
18718_0,,,,2,2,1,3
C(C(C(C(C(CO)=O)O)=O)CO)=O,,,5,1,3,0,3
18718_1,,,,2,2,1,3
18719_0,,,,2,2,1,3
18721_0,,,,2,2,1,3
C(CC(C(C(CC(C)O)O)=O)O)=O,,,5,1,3,0,3
18722_0,,,,2,2,1,3
18722_1,,,,2,2,1,3
18724_0,,,,2,2,1,3
C(C(C=O)O)(C(C(CO)=O)CO)=O,,,5,1,3,0,3
18724_1,,,,2,2,1,3
18725_0,,,,2,2,1,3
18726_0,,,,2,2,1,3
18726_1,,,,2,2,1,3
18728_0,,,,2,2,1,3
C(CC(C(C(CCO)O)=O)O)=O,,,5,1,4,0,4
18730_0,,,,2,2,1,3
C(C(C(C=O)O)O)(C(CCO)O)=O,,,5,1,10,0,10
18730_1,,,,2,2,1,3
18731_0,,,,2,2,1,3
18732_0,,,,2,2,1,3
18733_0,,,,2,2,1,3
18733_1,,,,2,2,1,3
18735_0,,,,2,2,1,3
C(C(C(C(CO)O)=O)(C(C)O)O)=O,,,5,1,6,0,6
18735_1,,,,2,2,1,3
18736_0,,,,2,2,1,3
18736_1,,,,2,2,1,3
18738_0,,,,2,2,1,3
C(CCO)(C(C=O)(C(CO)=O)O)=O,,,5,1,2,0,2
18740_0,,,,2,2,1,3
C(CC(C(C)O)(C(C(O)=O)O)O)=O,,,5,1,2,0,2
18741_0,,,,2,2,1,3
18741_1,,,,2,2,1,3
18742_0,,,,2,2,1,3
18742_1,,,,2,2,1,3
18743_0,,,,2,2,1,3
18744_0,,,,2,2,1,3
18744_1,,,,2,2,1,3
18746_0,,,,2,2,1,3
C(C(C(C=C)O)O)(CC(CO)=O)=O,,,5,1,2,0,2
18746_1,,,,2,2,1,3
18747_0,,,,2,2,1,3
18747_1,,,,2,2,1,3
18749_0,,,,2,2,1,3
C(C(C(C)O)O)(CC(CO)=O)=O,,,5,1,6,0,6
18749_1,,,,2,2,1,3
18751_0,,,,2,2,1,3
C(C(C(O)=O)O)(CC(CO)=O)=O,,,5,1,11,0,11
18751_1,,,,2,2,1,3
18752_0,,,,2,2,1,3
18752_1,,,,2,2,1,3
18754_0,,,,2,2,1,3
C(C(C(CO)O)O)(CC(CO)=O)=O,,,5,1,9,0,9
18754_1,,,,2,2,1,3
18756_0,,,,2,2,1,3
C(CO)(C(C(CO)=O)C(C=C)O)=O,,,5,1,2,0,2
18756_1,,,,2,2,1,3
18758_0,,,,2,2,1,3
C(C(C(C(CO)=O)C(CO)=O)O)=O,,,5,1,3,0,3
18758_1,,,,2,2,1,3
18760_0,,,,2,2,1,3
C(CO)(C(C(CO)=O)C(C)O)=O,,,5,1,4,0,4
18760_1,,,,2,2,1,3
18762_0,,,,2,2,1,3
C(C(C(CO)=O)C(CO)=O)(O)=O,,,5,1,6,0,6
18762_1,,,,2,2,1,3
18763_0,,,,2,2,1,3
18763_1,,,,2,2,1,3
18765_0,,,,2,2,1,3
C(CO)(C(C(CO)=O)C(CO)O)=O,,,5,1,3,0,3
18765_1,,,,2,2,1,3
18767_0,,,,2,2,1,3
C(C(CO)O)(CC(C(CO)O)=O)=O,,,5,1,6,0,6
18767_1,,,,2,2,1,3
18769_0,,,,2,2,1,3
C(C(CO)O)(C(C(CO)=O)CO)=O,,,5,1,10,0,10
18769_1,,,,2,2,1,3
18771_0,,,,2,2,1,3
C(CC(C(CO)(CC=O)O)O)(O)=O,,,5,1,3,0,3
18773_0,,,,2,2,1,3
C(CC(C(C(C(C)O)O)=O)O)(O)=O,,,5,1,4,0,4
18773_1,,,,2,2,1,3
18775_0,,,,2,2,1,3
C(C(C(C(CC(O)=O)O)=O)O)(O)=O,,,5,1,5,0,5
18775_1,,,,2,2,1,3
18776_0,,,,2,2,1,3
18776_1,,,,2,2,1,3
18777_0,,,,2,2,1,3
18779_0,,,,2,2,1,3
C(C(C=C)C1(COC(C1O)O)O)=O,,,5,1,1,0,1
18781_0,,,,2,2,1,3
C(C(CC1(COC(C1O)O)O)=O)=O,,,5,1,2,0,2
18783_0,,,,2,2,1,3
C(C(C=O)C1(COC(C1O)O)O)=O,,,5,1,3,0,3
18783_1,,,,2,2,1,3
18784_0,,,,2,2,1,3
18786_0,,,,2,2,1,3
C(C(CO)C1(COC(C1O)O)O)=O,,,5,1,5,0,5
18786_1,,,,2,2,1,3
18788_0,,,,2,2,1,3
C(C)(C(C1(COC(C1O)O)O)O)=O,,,5,1,4,0,4
18788_1,,,,2,2,1,3
18790_0,,,,2,2,1,3
C(CO)(CC1(COC(C1O)O)O)=O,,,5,1,2,0,2
18792_0,,,,2,2,1,3
C(C(C1(COC(C1O)O)O)O)=O,,,5,1,7,0,7
18792_1,,,,2,2,1,3
18794_0,,,,2,2,1,3
C1(C(C(C=CC)O)OC(C1O)O)=O,,,5,1,2,0,2
18794_1,,,,2,2,1,3
18796_0,,,,2,2,1,3
C1(C(C(CC=C)O)OC(C1O)O)=O,,,5,1,2,0,2
18796_1,,,,2,2,1,3
18798_0,,,,2,2,1,3
C1(C(C(C=C)O)OC(C1O)O)=O,,,5,1,2,0,2
18798_1,,,,2,2,1,3
18800_0,,,,2,2,1,3
C(C(C1C(C(C(O1)O)O)=O)O)=O,,,5,1,3,0,3
18800_1,,,,2,2,1,3
18802_0,,,,2,2,1,3
C(C(C1C(C(C(O1)O)O)=O)O)(O)=O,,,5,1,3,0,3
18802_1,,,,2,2,1,3
18804_0,,,,2,2,1,3
C(C(C)(C1C(C(C(O1)O)O)=O)O)=O,,,5,1,3,0,3
18804_1,,,,2,2,1,3
18806_0,,,,2,2,1,3
C(C(C1C(C(C(O1)O)O)=O)O)(C)=O,,,5,1,4,0,4
18806_1,,,,2,2,1,3
18808_0,,,,2,2,1,3
C(CC(C1C(C(C(O1)O)O)=O)O)=O,,,5,1,4,0,4
18808_1,,,,2,2,1,3
18810_0,,,,2,2,1,3
C1(C(C(C)O)OC(C1O)O)=O,,,5,1,3,0,3
18810_1,,,,2,2,1,3
18812_0,,,,2,2,1,3
C1(C(C(CCO)O)OC(C1O)O)=O,,,5,1,3,0,3
18812_1,,,,2,2,1,3
18814_0,,,,2,2,1,3
C1(C(C(CO)(C)O)OC(C1O)O)=O,,,5,1,3,0,3
18814_1,,,,2,2,1,3
18816_0,,,,2,2,1,3
C(C1C(C(C(O1)O)O)=O)(O)=O,,,5,1,4,0,4
18816_1,,,,2,2,1,3
18818_0,,,,2,2,1,3
C1(C(C(C(O)O)O)OC(C1O)O)=O,,,5,1,3,0,3
18818_1,,,,2,2,1,3
18820_0,,,,2,2,1,3
C1(C(C(C(C)O)O)OC(C1O)O)=O,,,5,1,3,0,3
18820_1,,,,2,2,1,3
18822_0,,,,2,2,1,3
C1(C(CO)OC(C1O)O)=O,,,5,1,4,0,4
18822_1,,,,2,2,1,3
18824_0,,,,2,2,1,3
C1(C(C(CO)O)OC(C1O)O)=O,,,5,1,4,0,4
18824_1,,,,2,2,1,3
18825_0,,,,2,2,1,3
18826_0,,,,2,2,1,3
18826_1,,,,2,2,1,3
18827_0,,,,2,2,1,3
18828_0,,,,2,2,1,3
18828_1,,,,2,2,1,3
18830_0,,,,2,2,1,3
C=CC(C(C(C(C(O)=O)=O)=O)O)O,,,5,1,2,0,2
18830_1,,,,2,2,1,3
18832_0,,,,2,2,1,3
C(C(C(C(C(C(O)=O)=O)=O)O)O)=O,,,5,1,2,0,2
18832_1,,,,2,2,1,3
18834_0,,,,2,2,1,3
C(C(C(C(C(C)O)O)=O)=O)(O)=O,,,5,1,2,0,2
18834_1,,,,2,2,1,3
18836_0,,,,2,2,1,3
C(C(C(C(C(O)=O)=O)=O)O)(O)=O,,,5,1,3,0,3
18836_1,,,,2,2,1,3
18838_0,,,,2,2,1,3
C(C(C(C(CO)O)=O)=O)(O)=O,,,5,1,5,0,5
18838_1,,,,2,2,1,3
18840_0,,,,2,2,1,3
C(C(C(C(C(CO)O)O)=O)=O)(O)=O,,,5,1,3,0,3
18840_1,,,,2,2,1,3
18842_0,,,,2,2,1,3
C(C(C=C)C(C(C)(CCO)O)O)=O,,,5,1,1,0,1
18844_0,,,,2,2,1,3
C(C(CC(C(C)(CCO)O)O)=O)=O,,,5,1,2,0,2
18846_0,,,,2,2,1,3
C(C(C=O)C(C(C)(CCO)O)O)=O,,,5,1,3,0,3
18846_1,,,,2,2,1,3
18848_0,,,,2,2,1,3
C(CC(C(C)(CCO)O)O)=O,,,5,1,2,0,2
18850_0,,,,2,2,1,3
C(C(CO)C(C(C)(CCO)O)O)=O,,,5,1,3,0,3
18850_1,,,,2,2,1,3
18852_0,,,,2,2,1,3
C(C)(C(C(C(C)(CCO)O)O)O)=O,,,5,1,3,0,3
18852_1,,,,2,2,1,3
18854_0,,,,2,2,1,3
C(CO)(CC(C(C)(CCO)O)O)=O,,,5,1,2,0,2
18856_0,,,,2,2,1,3
C(C(C(C(C)(CCO)O)O)O)=O,,,5,1,3,0,3
18856_1,,,,2,2,1,3
18858_0,,,,2,2,1,3
C(CC(C(C)(C(CO)O)O)O)=O,,,5,1,3,0,3
18860_0,,,,2,2,1,3
C(C(C(C(C)(C(CO)O)O)O)O)=O,,,5,1,7,0,7
18860_1,,,,2,2,1,3
18862_0,,,,2,2,1,3
C(C(C=C)C(C)(C(CCO)O)O)=O,,,5,1,1,0,1
18864_0,,,,2,2,1,3
C(C(CC(C)(C(CCO)O)O)=O)=O,,,5,1,2,0,2
18866_0,,,,2,2,1,3
C(C(C=O)C(C)(C(CCO)O)O)=O,,,5,1,3,0,3
18866_1,,,,2,2,1,3
18868_0,,,,2,2,1,3
C(CC(C)(C(CCO)O)O)=O,,,5,1,2,0,2
18870_0,,,,2,2,1,3
C(C(CO)C(C)(C(CCO)O)O)=O,,,5,1,3,0,3
18870_1,,,,2,2,1,3
18872_0,,,,2,2,1,3
C(C)(C(C(C)(C(CCO)O)O)O)=O,,,5,1,3,0,3
18872_1,,,,2,2,1,3
18874_0,,,,2,2,1,3
C(CO)(CC(C)(C(CCO)O)O)=O,,,5,1,2,0,2
18876_0,,,,2,2,1,3
C(C(C(C)(C(CCO)O)O)O)=O,,,5,1,4,0,4
18876_1,,,,2,2,1,3
18878_0,,,,2,2,1,3
C(CC(C=CC)O)(C(CCO)O)=O,,,5,1,1,0,1
18880_0,,,,2,2,1,3
C(C(CCO)O)(CC(CC=C)O)=O,,,5,1,1,0,1
18882_0,,,,2,2,1,3
C(CC(C=C)O)(C(CCO)O)=O,,,5,1,1,0,1
18884_0,,,,2,2,1,3
C(CC(C=O)O)(C(CCO)O)=O,,,5,1,4,0,4
18886_0,,,,2,2,1,3
C(CC(C(O)=O)O)(C(CCO)O)=O,,,5,1,5,0,5
18888_0,,,,2,2,1,3
C(C(C)(CC(C(CCO)O)=O)O)=O,,,5,1,2,0,2
18890_0,,,,2,2,1,3
C(CC(C(C)=O)O)(C(CCO)O)=O,,,5,1,2,0,2
18891_0,,,,2,2,1,3
18893_0,,,,2,2,1,3
C(C(CCO)O)(CC(C)O)=O,,,5,1,2,0,2
18895_0,,,,2,2,1,3
C(C(CCO)O)(CC(CCO)O)=O,,,5,1,2,0,2
18897_0,,,,2,2,1,3
C(C(CCO)O)(CC(CO)(C)O)=O,,,5,1,2,0,2
18899_0,,,,2,2,1,3
C(CC(C(CCO)O)=O)(O)=O,,,5,1,5,0,5
18901_0,,,,2,2,1,3
C(C(CCO)O)(CC(C(O)O)O)=O,,,5,1,2,0,2
18903_0,,,,2,2,1,3
C(C(CCO)O)(CC(C(C)O)O)=O,,,5,1,2,0,2
18904_0,,,,2,2,1,3
18906_0,,,,2,2,1,3
C(C(CCO)O)(CC(CO)O)=O,,,5,1,3,0,3
18908_0,,,,2,2,1,3
C(CC(C(CCO)(CCO)O)O)=O,,,5,1,2,0,2
18910_0,,,,2,2,1,3
C(CC(CCO)(C(CCO)O)O)=O,,,5,1,2,0,2
18912_0,,,,2,2,1,3
C(C(CCO)O)(C(CO)C(C)O)=O,,,5,1,3,0,3
18912_1,,,,2,2,1,3
18914_0,,,,2,2,1,3
C(C(C(C(CCO)O)=O)CO)(O)=O,,,5,1,3,0,3
18914_1,,,,2,2,1,3
18916_0,,,,2,2,1,3
C(C(CCO)O)(C(CO)CO)=O,,,5,1,3,0,3
18916_1,,,,2,2,1,3
18918_0,,,,2,2,1,3
C(CC(C(CC(CCO)O)O)O)=O,,,5,1,2,0,2
18920_0,,,,2,2,1,3
C(CC(C(C(CO)C(C)O)O)O)=O,,,5,1,2,0,2
18922_0,,,,2,2,1,3
C(CC(C(C(CO)CO)O)O)=O,,,5,1,2,0,2
18924_0,,,,2,2,1,3
C(C(C(C(C(CO)CO)O)O)O)=O,,,5,1,3,0,3
18924_1,,,,2,2,1,3
18926_0,,,,2,2,1,3
C(CC(C(C(C)(CCO)O)O)O)=O,,,5,1,2,0,2
18928_0,,,,2,2,1,3
C(CC(C(CO)(CCO)O)O)=O,,,5,1,3,0,3
18930_0,,,,2,2,1,3
C(C(C(C(CO)(CCO)O)O)O)=O,,,5,1,7,0,7
18930_1,,,,2,2,1,3
18932_0,,,,2,2,1,3
C(CC(CO)(C(CCO)O)O)=O,,,5,1,4,0,4
18933_0,,,,2,2,1,3
18933_1,,,,2,2,1,3
18935_0,,,,2,2,1,3
C(C(C(C=C)O)O)(C(CCO)O)=O,,,5,1,2,0,2
18935_1,,,,2,2,1,3
18936_0,,,,2,2,1,3
18936_1,,,,2,2,1,3
18938_0,,,,2,2,1,3
C(C(CCO)O)(C(C(C)O)O)=O,,,5,1,4,0,4
18938_1,,,,2,2,1,3
18939_0,,,,2,2,1,3
18939_1,,,,2,2,1,3
18940_0,,,,2,2,1,3
18940_1,,,,2,2,1,3
18942_0,,,,2,2,1,3
C(C(CCO)O)(C(C(CO)O)O)=O,,,5,1,5,0,5
18942_1,,,,2,2,1,3
18944_0,,,,2,2,1,3
C(CC(C)(C(CO)(C(C)O)O)O)=O,,,5,1,2,0,2
18946_0,,,,2,2,1,3
C(CC(C)O)(C(CO)(C(C)O)O)=O,,,5,1,4,0,4
18947_0,,,,2,2,1,3
18949_0,,,,2,2,1,3
C(CCO)(C(CO)(C(C)O)O)=O,,,5,1,8,0,8
18951_0,,,,2,2,1,3
C(CC(C)(C(CO)(CO)O)O)=O,,,5,1,2,0,2
18952_0,,,,2,2,1,3
18952_1,,,,2,2,1,3
18954_0,,,,2,2,1,3
C(CC(C=C)O)(C(CO)(CO)O)=O,,,5,1,1,0,1
18955_0,,,,2,2,1,3
18957_0,,,,2,2,1,3
C(CC(C)O)(C(CO)(CO)O)=O,,,5,1,4,0,4
18958_0,,,,2,2,1,3
18959_0,,,,2,2,1,3
18961_0,,,,2,2,1,3
C(CC(CO)O)(C(CO)(CO)O)=O,,,5,1,5,0,5
18963_0,,,,2,2,1,3
C(CCO)(C(CO)(C(CO)O)O)=O,,,5,1,9,0,9
18965_0,,,,2,2,1,3
C(CC(CC(CO)(C(C)O)O)O)=O,,,5,1,2,0,2
18966_0,,,,2,2,1,3
18966_1,,,,2,2,1,3
18967_0,,,,2,2,1,3
18967_1,,,,2,2,1,3
18968_0,,,,2,2,1,3
18968_1,,,,2,2,1,3
18970_0,,,,2,2,1,3
C(CC(C(CCO)(C(C)O)O)O)=O,,,5,1,2,0,2
18972_0,,,,2,2,1,3
C(C(CO)(CO)O)(C(CO)CO)=O,,,5,1,6,0,6
18972_1,,,,2,2,1,3
18974_0,,,,2,2,1,3
C(C(CO)(C(C(C=C)=O)O)O)=C,,,5,1,2,0,2
18974_1,,,,2,2,1,3
18976_0,,,,2,2,1,3
C=CC(CO)(C(C(C=O)=O)C)O,,,5,1,1,0,1
18978_0,,,,2,2,1,3
C(CC(C=O)C(C=C)(CO)O)=O,,,5,1,1,0,1
18980_0,,,,2,2,1,3
C(C(CO)(CC(C(C)=O)=O)O)=C,,,5,1,1,0,1
18982_0,,,,2,2,1,3
C=CC(CO)(C(C(C(O)=O)=O)C)O,,,5,1,1,0,1
18984_0,,,,2,2,1,3
C(C(C(C)=O)C(C=C)(CO)O)(O)=O,,,5,1,2,0,2
18984_1,,,,2,2,1,3
18986_0,,,,2,2,1,3
C(CC(CC(C=C)(CO)O)=O)(O)=O,,,5,1,1,0,1
18988_0,,,,2,2,1,3
C=CC(CO)(C1C(C(OC1)=O)=O)O,,,5,1,2,0,2
18988_1,,,,2,2,1,3
18990_0,,,,2,2,1,3
C1(C(C(CO1)=O)C(C=C)(CO)O)=O,,,5,1,2,0,2
18990_1,,,,2,2,1,3
18992_0,,,,2,2,1,3
C1(CC(C(C(C=C)(CO)O)O1)=O)=O,,,5,1,2,0,2
18992_1,,,,2,2,1,3
18994_0,,,,2,2,1,3
C(C(C(C=O)=C)C(C=C)(CO)O)=O,,,5,1,1,0,1
18996_0,,,,2,2,1,3
C(C(CO)(CC(C=CC=O)=O)O)=C,,,5,1,1,0,1
18998_0,,,,2,2,1,3
C=CC(C(C=O)=O)C(C=C)(CO)O,,,5,1,1,0,1
19000_0,,,,2,2,1,3
C(C(C=CC=O)C(C=C)(CO)O)=O,,,5,1,1,0,1
19002_0,,,,2,2,1,3
C(C(C=C)C(C=C)(CO)O)=O,,,5,1,1,0,1
19004_0,,,,2,2,1,3
C(C(CO)(C1C(C=CO1)=O)O)=C,,,5,1,2,0,2
19004_1,,,,2,2,1,3
19006_0,,,,2,2,1,3
C(C(C(C=C)(CO)O)O)(CO)=O,,,5,1,4,0,4
19006_1,,,,2,2,1,3
19008_0,,,,2,2,1,3
C(C(CO)(CC(C=O)=O)O)=C,,,5,1,3,0,3
19010_0,,,,2,2,1,3
C(C(C=O)C(C=C)(CO)O)=O,,,5,1,4,0,4
19010_1,,,,2,2,1,3
19012_0,,,,2,2,1,3
C=CC(CO)(C(C(C=O)=O)CO)O,,,5,1,3,0,3
19012_1,,,,2,2,1,3
19014_0,,,,2,2,1,3
C(C(C(C=O)C(C=C)(CO)O)O)=O,,,5,1,3,0,3
19014_1,,,,2,2,1,3
19016_0,,,,2,2,1,3
C(C(C(CO)=O)C(C=C)(CO)O)=O,,,5,1,3,0,3
19016_1,,,,2,2,1,3
19018_0,,,,2,2,1,3
C(CC(C(C(C=C)(CO)O)O)=O)=O,,,5,1,3,0,3
19018_1,,,,2,2,1,3
19020_0,,,,2,2,1,3
C(C(C(CC(C=C)(CO)O)=O)O)=O,,,5,1,2,0,2
19022_0,,,,2,2,1,3
C(CC(C=C)(CO)O)=O,,,5,1,4,0,4
19024_0,,,,2,2,1,3
C(C(CO)(C(C(C=O)=O)O)O)=C,,,5,1,4,0,4
19024_1,,,,2,2,1,3
19026_0,,,,2,2,1,3
C(C(C(C)O)C(C=C)(CO)O)=O,,,5,1,4,0,4
19026_1,,,,2,2,1,3
19028_0,,,,2,2,1,3
C(C(CO)C(C=C)(CO)O)=O,,,5,1,4,0,4
19028_1,,,,2,2,1,3
19030_0,,,,2,2,1,3
C(C(C(CO)O)C(C=C)(CO)O)=O,,,5,1,3,0,3
19030_1,,,,2,2,1,3
19032_0,,,,2,2,1,3
C(C(CO)(C(C(C(C)=O)=O)O)O)=C,,,5,1,3,0,3
19032_1,,,,2,2,1,3
19034_0,,,,2,2,1,3
C(C(CO)(CC(C(CO)=O)=O)O)=C,,,5,1,2,0,2
19036_0,,,,2,2,1,3
C(C(C(C=C)(CO)O)O)(C)=O,,,5,1,4,0,4
19036_1,,,,2,2,1,3
19038_0,,,,2,2,1,3
C(CC(C=C)(CO)O)(CO)=O,,,5,1,3,0,3
19040_0,,,,2,2,1,3
C(C(C(C=C)(CO)O)O)(CCO)=O,,,5,1,3,0,3
19040_1,,,,2,2,1,3
19042_0,,,,2,2,1,3
C(CO)(C(CO)C(C=C)(CO)O)=O,,,5,1,3,0,3
19042_1,,,,2,2,1,3
19044_0,,,,2,2,1,3
C(CC(C=C)(CO)O)(C(CO)O)=O,,,5,1,2,0,2
19046_0,,,,2,2,1,3
C(C(CO)(CC(C(O)=O)=O)O)=C,,,5,1,3,0,3
19048_0,,,,2,2,1,3
C(C(C=O)C(C=C)(CO)O)(O)=O,,,5,1,4,0,4
19048_1,,,,2,2,1,3
19050_0,,,,2,2,1,3
C(C(CO)(C(C(C(O)=O)=O)O)O)=C,,,5,1,3,0,3
19050_1,,,,2,2,1,3
19052_0,,,,2,2,1,3
C(C(C(C=O)=O)C(C=C)(CO)O)=O,,,5,1,3,0,3
19052_1,,,,2,2,1,3
19054_0,,,,2,2,1,3
C1(C(C(C=C)(CO)O)OCC1O)=O,,,5,1,3,0,3
19054_1,,,,2,2,1,3
19056_0,,,,2,2,1,3
C1(C(O)OCC1C(C=C)(CO)O)=O,,,5,1,3,0,3
19056_1,,,,2,2,1,3
19058_0,,,,2,2,1,3
C1(COC(C1C(C=C)(CO)O)O)=O,,,5,1,3,0,3
19058_1,,,,2,2,1,3
19060_0,,,,2,2,1,3
C1(C(C(C=C)(CO)O)OC(C1)O)=O,,,5,1,3,0,3
19060_1,,,,2,2,1,3
19062_0,,,,2,2,1,3
C(C(CO)(CC(C(C=O)=O)=O)O)=C,,,5,1,2,0,2
19064_0,,,,2,2,1,3
C(C(C(C=C)(CO)O)O)=O,,,5,1,9,0,9
19064_1,,,,2,2,1,3
19066_0,,,,2,2,1,3
C=CC(C(C(C=CCO)O)O)=O,,,5,1,2,0,2
19066_1,,,,2,2,1,3
19067_0,,,,2,2,1,3
19067_1,,,,2,2,1,3
19069_0,,,,2,2,1,3
C=CC(C(C(C=CC(O)=O)O)O)=O,,,5,1,2,0,2
19069_1,,,,2,2,1,3
19071_0,,,,2,2,1,3
C=CC(C(C(C(CO)(O)O)O)O)=O,,,5,1,2,0,2
19071_1,,,,2,2,1,3
19073_0,,,,2,2,1,3
C=CC(C(C(C(CO)(C)O)O)O)=O,,,5,1,2,0,2
19073_1,,,,2,2,1,3
19075_0,,,,2,2,1,3
C(C(CC)(C(C(C=C)=O)O)O)=O,,,5,1,2,0,2
19075_1,,,,2,2,1,3
19077_0,,,,2,2,1,3
C(C(C(C(C=C)=O)O)O)(CC)=O,,,5,1,2,0,2
19077_1,,,,2,2,1,3
19079_0,,,,2,2,1,3
C(CCC(C(C(C=C)=O)O)O)=O,,,5,1,2,0,2
19079_1,,,,2,2,1,3
19081_0,,,,2,2,1,3
C(C)(C(C)(C(C(C=C)=O)O)O)=O,,,5,1,2,0,2
19081_1,,,,2,2,1,3
19083_0,,,,2,2,1,3
C(C(CC)(C(C(C=C)=O)O)O)(O)=O,,,5,1,3,0,3
19083_1,,,,2,2,1,3
19085_0,,,,2,2,1,3
C(CC(C)(C(C(C=C)=O)O)O)(O)=O,,,5,1,2,0,2
19085_1,,,,2,2,1,3
19087_0,,,,2,2,1,3
C(C(C)C(C(C(C=C)=O)O)O)(O)=O,,,5,1,2,0,2
19087_1,,,,2,2,1,3
19088_0,,,,2,2,1,3
19088_1,,,,2,2,1,3
19090_0,,,,2,2,1,3
C1(CC(CO1)(C(C(C=C)=O)O)O)=O,,,5,1,2,0,2
19090_1,,,,2,2,1,3
19092_0,,,,2,2,1,3
C=CC(C(C(C=C(C=O)C)O)O)=O,,,5,1,2,0,2
19092_1,,,,2,2,1,3
19094_0,,,,2,2,1,3
C=CC(C(C(C(C)=CC=O)O)O)=O,,,5,1,2,0,2
19094_1,,,,2,2,1,3
19096_0,,,,2,2,1,3
C=CC(C(C(CC(C=O)=C)O)O)=O,,,5,1,2,0,2
19096_1,,,,2,2,1,3
19098_0,,,,2,2,1,3
C(CC(C(C(C(C=C)=O)O)O)=C)=O,,,5,1,2,0,2
19098_1,,,,2,2,1,3
19100_0,,,,2,2,1,3
C=CC(C(C(C=CC(C)=O)O)O)=O,,,5,1,2,0,2
19100_1,,,,2,2,1,3
19102_0,,,,2,2,1,3
C(C(C)(C(C(C=C)=O)O)O)=CC=O,,,5,1,2,0,2
19102_1,,,,2,2,1,3
19104_0,,,,2,2,1,3
C(C(CC=C)(C(C(C=C)=O)O)O)=O,,,5,1,2,0,2
19104_1,,,,2,2,1,3
19106_0,,,,2,2,1,3
C(C(C(C(C=C)=O)O)O)(CC=C)=O,,,5,1,2,0,2
19106_1,,,,2,2,1,3
19108_0,,,,2,2,1,3
C(C(C=CC)(C(C(C=C)=O)O)O)=O,,,5,1,2,0,2
19108_1,,,,2,2,1,3
19110_0,,,,2,2,1,3
C=CC(C(C(C(C=CC)=O)O)O)=O,,,5,1,2,0,2
19110_1,,,,2,2,1,3
19112_0,,,,2,2,1,3
C=CC(C(C(C=CC(C=O)=O)O)O)=O,,,5,1,2,0,2
19112_1,,,,2,2,1,3
19114_0,,,,2,2,1,3
C(C(C=CC=O)(C(C(C=C)=O)O)O)=O,,,5,1,3,0,3
19114_1,,,,2,2,1,3
19116_0,,,,2,2,1,3
C=CC(C(C(C(C=CC=O)=O)O)O)=O,,,5,1,4,0,4
19116_1,,,,2,2,1,3
19118_0,,,,2,2,1,3
C(CC=CC(C(C(C=C)=O)O)O)=O,,,5,1,2,0,2
19118_1,,,,2,2,1,3
19120_0,,,,2,2,1,3
C(CC(C(C(C=C)=O)O)O)=CC=O,,,5,1,2,0,2
19120_1,,,,2,2,1,3
19122_0,,,,2,2,1,3
C(C(C=C)C(C(C(C=C)=O)O)O)=O,,,5,1,3,0,3
19122_1,,,,2,2,1,3
19124_0,,,,2,2,1,3
C=CC(C(C(C(C=O)=CC)O)O)=O,,,5,1,2,0,2
19124_1,,,,2,2,1,3
19126_0,,,,2,2,1,3
C=CC(C(C(C=C(C=O)C=O)O)O)=O,,,5,1,2,0,2
19126_1,,,,2,2,1,3
19128_0,,,,2,2,1,3
C=CC(C(C(C(C=O)=CC=O)O)O)=O,,,5,1,2,0,2
19128_1,,,,2,2,1,3
19130_0,,,,2,2,1,3
C=C(C=O)C(C(C(C=C)=O)O)O,,,5,1,2,0,2
19130_1,,,,2,2,1,3
19132_0,,,,2,2,1,3
C=CC(C(C(C=CC)O)O)=O,,,5,1,2,0,2
19132_1,,,,2,2,1,3
19134_0,,,,2,2,1,3
C(CC(C(C(C=C)=O)O)O)=C,,,5,1,2,0,2
19134_1,,,,2,2,1,3
19136_0,,,,2,2,1,3
C=CC(C(C(C(C=C)=O)O)O)O,,,5,1,2,0,2
19136_1,,,,2,2,1,3
19138_0,,,,2,2,1,3
C=CC(C(C(C=C)=O)O)O,,,5,1,3,0,3
19138_1,,,,2,2,1,3
19140_0,,,,2,2,1,3
C(C(C(C=O)=C)(C(C(C=C)=O)O)O)=O,,,5,1,3,0,3
19140_1,,,,2,2,1,3
19142_0,,,,2,2,1,3
C=C(C=O)C(C(C(C(C=C)=O)O)O)=O,,,5,1,4,0,4
19142_1,,,,2,2,1,3
19144_0,,,,2,2,1,3
C=C(C(C=O)=O)C(C(C(C=C)=O)O)O,,,5,1,2,0,2
19144_1,,,,2,2,1,3
19146_0,,,,2,2,1,3
C1C(COC=1)(C(C(C=C)=O)O)O,,,5,1,2,0,2
19146_1,,,,2,2,1,3
19148_0,,,,2,2,1,3
C=CC(C(C(C(CO)O)O)O)=O,,,5,1,5,0,5
19148_1,,,,2,2,1,3
19149_0,,,,2,2,1,3
19149_1,,,,2,2,1,3
19151_0,,,,2,2,1,3
C=CC(C(C(CO)(CO)O)O)=O,,,5,1,5,0,5
19151_1,,,,2,2,1,3
19152_0,,,,2,2,1,3
19152_1,,,,2,2,1,3
19153_0,,,,2,2,1,3
19153_1,,,,2,2,1,3
19154_0,,,,2,2,1,3
19154_1,,,,2,2,1,3
19156_0,,,,2,2,1,3
C(CC(C(C(C=C)=O)O)O)=O,,,5,1,4,0,4
19156_1,,,,2,2,1,3
19157_0,,,,2,2,1,3
19157_1,,,,2,2,1,3
19158_0,,,,2,2,1,3
19158_1,,,,2,2,1,3
19159_0,,,,2,2,1,3
19159_1,,,,2,2,1,3
19161_0,,,,2,2,1,3
C(C(CC(C(C(C=C)=O)O)O)O)=O,,,5,1,2,0,2
19161_1,,,,2,2,1,3
19163_0,,,,2,2,1,3
C(CO)(CC(C(C(C=C)=O)O)O)=O,,,5,1,3,0,3
19163_1,,,,2,2,1,3
19165_0,,,,2,2,1,3
C(CC(CO)(C(C(C=C)=O)O)O)=O,,,5,1,3,0,3
19165_1,,,,2,2,1,3
19167_0,,,,2,2,1,3
C(C)(C(C(C(C(C=C)=O)O)O)O)=O,,,5,1,4,0,4
19167_1,,,,2,2,1,3
19169_0,,,,2,2,1,3
C(C(C(C)(C(C(C=C)=O)O)O)O)=O,,,5,1,3,0,3
19169_1,,,,2,2,1,3
19171_0,,,,2,2,1,3
C=CC(C(C(C)O)O)=O,,,5,1,3,0,3
19171_1,,,,2,2,1,3
19172_0,,,,2,2,1,3
19172_1,,,,2,2,1,3
19173_0,,,,2,2,1,3
19173_1,,,,2,2,1,3
19175_0,,,,2,2,1,3
C(C(CO)C(C(C(C=C)=O)O)O)=O,,,5,1,4,0,4
19175_1,,,,2,2,1,3
19177_0,,,,2,2,1,3
C=CC(C(C(CC(C)O)O)O)=O,,,5,1,3,0,3
19177_1,,,,2,2,1,3
19179_0,,,,2,2,1,3
C=CC(C(C(C(C(C)O)O)O)O)=O,,,5,1,2,0,2
19179_1,,,,2,2,1,3
19181_0,,,,2,2,1,3
C=CC(C(C(CCO)O)O)=O,,,5,1,3,0,3
19181_1,,,,2,2,1,3
19183_0,,,,2,2,1,3
C=CC(C(C(CC(CO)O)O)O)=O,,,5,1,2,0,2
19183_1,,,,2,2,1,3
19184_0,,,,2,2,1,3
19184_1,,,,2,2,1,3
19186_0,,,,2,2,1,3
C(CO)(C(C)(C(C(C=C)=O)O)O)=O,,,5,1,4,0,4
19186_1,,,,2,2,1,3
19187_0,,,,2,2,1,3
19187_1,,,,2,2,1,3
19188_0,,,,2,2,1,3
19188_1,,,,2,2,1,3
19190_0,,,,2,2,1,3
C(C(C(C(C(C=C)=O)O)O)O)=O,,,5,1,8,0,8
19190_1,,,,2,2,1,3
19192_0,,,,2,2,1,3
C=CC(C(C(CO)(C)O)O)=O,,,5,1,4,0,4
19192_1,,,,2,2,1,3
19194_0,,,,2,2,1,3
C=CC(C(C(CO)(CCO)O)O)=O,,,5,1,3,0,3
19194_1,,,,2,2,1,3
19196_0,,,,2,2,1,3
C=CC(C(C(C(CCO)O)O)O)=O,,,5,1,2,0,2
19196_1,,,,2,2,1,3
19198_0,,,,2,2,1,3
C=CC(C(C(C)(C(CO)O)O)O)=O,,,5,1,2,0,2
19198_1,,,,2,2,1,3
19199_0,,,,2,2,1,3
19199_1,,,,2,2,1,3
19201_0,,,,2,2,1,3
C(CC(C(C(C=C)=O)O)O)(O)=O,,,5,1,3,0,3
19201_1,,,,2,2,1,3
19202_0,,,,2,2,1,3
19202_1,,,,2,2,1,3
19203_0,,,,2,2,1,3
19203_1,,,,2,2,1,3
19204_0,,,,2,2,1,3
19204_1,,,,2,2,1,3
19206_0,,,,2,2,1,3
C=CC(C(C(CC(C=O)=O)O)O)=O,,,5,1,3,0,3
19206_1,,,,2,2,1,3
19208_0,,,,2,2,1,3
C=CC(C(C1(COCC1O)O)O)=O,,,5,1,2,0,2
19208_1,,,,2,2,1,3
19210_0,,,,2,2,1,3
C=CC(C(C1(C(O)OCC1)O)O)=O,,,5,1,3,0,3
19210_1,,,,2,2,1,3
19212_0,,,,2,2,1,3
C=CC(C(C1(COC(C1)O)O)O)=O,,,5,1,2,0,2
19212_1,,,,2,2,1,3
19213_0,,,,2,2,1,3
19213_1,,,,2,2,1,3
19214_0,,,,2,2,1,3
19214_1,,,,2,2,1,3
19215_0,,,,2,2,1,3
19215_1,,,,2,2,1,3
19217_0,,,,2,2,1,3
C(C(C=C)(C(C(C=C)=O)O)O)=O,,,5,1,6,0,6
19217_1,,,,2,2,1,3
19219_0,,,,2,2,1,3
C=CC(C(C(C(C=C)=O)O)O)=O,,,5,1,3,0,3
19219_1,,,,2,2,1,3
19221_0,,,,2,2,1,3
C=CC(C(C(C=CC=O)O)O)=O,,,5,1,3,0,3
19221_1,,,,2,2,1,3
19222_0,,,,2,2,1,3
19222_1,,,,2,2,1,3
19224_0,,,,2,2,1,3
C=CC(C(C(C(O)O)O)O)=O,,,5,1,3,0,3
19224_1,,,,2,2,1,3
19226_0,,,,2,2,1,3
C=CC(C(C(C(C)O)O)O)=O,,,5,1,3,0,3
19226_1,,,,2,2,1,3
19228_0,,,,2,2,1,3
C=CC(C(CO)O)=O,,,5,1,9,0,9
19228_1,,,,2,2,1,3
19230_0,,,,2,2,1,3
C=CC(C(C(CO)O)O)=O,,,5,1,7,0,7
19230_1,,,,2,2,1,3
19232_0,,,,2,2,1,3
C(CO)=CC(C(C(C=O)=O)C)O,,,5,1,1,0,1
19234_0,,,,2,2,1,3
C(CC(C=O)C(C=CCO)O)=O,,,5,1,1,0,1
19236_0,,,,2,2,1,3
C(C(CC(C(C)=O)=O)O)=CCO,,,5,1,1,0,1
19238_0,,,,2,2,1,3
C(CO)=CC(C(C(C(O)=O)=O)C)O,,,5,1,1,0,1
19240_0,,,,2,2,1,3
C(C(C(C)=O)C(C=CCO)O)(O)=O,,,5,1,2,0,2
19240_1,,,,2,2,1,3
19242_0,,,,2,2,1,3
C(CC(CC(C=CCO)O)=O)(O)=O,,,5,1,1,0,1
19244_0,,,,2,2,1,3
C(CO)=CC(C1C(C(OC1)=O)=O)O,,,5,1,2,0,2
19244_1,,,,2,2,1,3
19246_0,,,,2,2,1,3
C1(C(C(CO1)=O)C(C=CCO)O)=O,,,5,1,2,0,2
19246_1,,,,2,2,1,3
19248_0,,,,2,2,1,3
C1(CC(C(C(C=CCO)O)O1)=O)=O,,,5,1,2,0,2
19248_1,,,,2,2,1,3
19250_0,,,,2,2,1,3
C(C(C(C=O)=C)C(C=CCO)O)=O,,,5,1,1,0,1
19252_0,,,,2,2,1,3
C(C(CC(C=CC=O)=O)O)=CCO,,,5,1,1,0,1
19254_0,,,,2,2,1,3
C=CC(C(C=O)=O)C(C=CCO)O,,,5,1,1,0,1
19256_0,,,,2,2,1,3
C(C(C=CC=O)C(C=CCO)O)=O,,,5,1,1,0,1
19258_0,,,,2,2,1,3
C(C(C=C)C(C=CCO)O)=O,,,5,1,1,0,1
19260_0,,,,2,2,1,3
C1OC(C(C=1)=O)C(C=CCO)O,,,5,1,2,0,2
19260_1,,,,2,2,1,3
19262_0,,,,2,2,1,3
C(CO)(C(C(C=CCO)O)O)=O,,,5,1,5,0,5
19262_1,,,,2,2,1,3
19264_0,,,,2,2,1,3
C(C(CC(C=O)=O)O)=CCO,,,5,1,4,0,4
19266_0,,,,2,2,1,3
C(C(C=O)C(C=CCO)O)=O,,,5,1,5,0,5
19266_1,,,,2,2,1,3
19268_0,,,,2,2,1,3
C(CO)=CC(C(C(C=O)=O)CO)O,,,5,1,3,0,3
19268_1,,,,2,2,1,3
19270_0,,,,2,2,1,3
C(C(C(C=O)C(C=CCO)O)O)=O,,,5,1,3,0,3
19270_1,,,,2,2,1,3
19272_0,,,,2,2,1,3
C(C(C(CO)=O)C(C=CCO)O)=O,,,5,1,3,0,3
19272_1,,,,2,2,1,3
19274_0,,,,2,2,1,3
C(CC(C(C(C=CCO)O)O)=O)=O,,,5,1,3,0,3
19274_1,,,,2,2,1,3
19276_0,,,,2,2,1,3
C(C(C(CC(C=CCO)O)=O)O)=O,,,5,1,2,0,2
19278_0,,,,2,2,1,3
C(CC(C=CCO)O)=O,,,5,1,4,0,4
19280_0,,,,2,2,1,3
C(C(C(C(C=O)=O)O)O)=CCO,,,5,1,5,0,5
19280_1,,,,2,2,1,3
19282_0,,,,2,2,1,3
C(C(C(C)O)C(C=CCO)O)=O,,,5,1,5,0,5
19282_1,,,,2,2,1,3
19284_0,,,,2,2,1,3
C(C(CO)C(C=CCO)O)=O,,,5,1,5,0,5
19284_1,,,,2,2,1,3
19286_0,,,,2,2,1,3
C(C(C(CO)O)C(C=CCO)O)=O,,,5,1,3,0,3
19286_1,,,,2,2,1,3
19288_0,,,,2,2,1,3
C(CO)=CC(C(C(C(C)=O)=O)O)O,,,5,1,3,0,3
19288_1,,,,2,2,1,3
19290_0,,,,2,2,1,3
C(CO)=CC(CC(C(CO)=O)=O)O,,,5,1,2,0,2
19292_0,,,,2,2,1,3
C(C)(C(C(C=CCO)O)O)=O,,,5,1,5,0,5
19292_1,,,,2,2,1,3
19294_0,,,,2,2,1,3
C(CO)(CC(C=CCO)O)=O,,,5,1,4,0,4
19296_0,,,,2,2,1,3
C(C(C(C=CCO)O)O)(CCO)=O,,,5,1,3,0,3
19296_1,,,,2,2,1,3
19298_0,,,,2,2,1,3
C(CO)(C(CO)C(C=CCO)O)=O,,,5,1,3,0,3
19298_1,,,,2,2,1,3
19300_0,,,,2,2,1,3
C(CC(C=CCO)O)(C(CO)O)=O,,,5,1,2,0,2
19302_0,,,,2,2,1,3
C(C(CC(C(O)=O)=O)O)=CCO,,,5,1,4,0,4
19304_0,,,,2,2,1,3
C(C(C=O)C(C=CCO)O)(O)=O,,,5,1,5,0,5
19304_1,,,,2,2,1,3
19306_0,,,,2,2,1,3
C(C(C(C(C(O)=O)=O)O)O)=CCO,,,5,1,3,0,3
19306_1,,,,2,2,1,3
19308_0,,,,2,2,1,3
C(C(C(C=O)=O)C(C=CCO)O)=O,,,5,1,3,0,3
19308_1,,,,2,2,1,3
19310_0,,,,2,2,1,3
C1(C(C(C=CCO)O)OCC1O)=O,,,5,1,3,0,3
19310_1,,,,2,2,1,3
19312_0,,,,2,2,1,3
C1(C(O)OCC1C(C=CCO)O)=O,,,5,1,3,0,3
19312_1,,,,2,2,1,3
19314_0,,,,2,2,1,3
C1(COC(C1C(C=CCO)O)O)=O,,,5,1,3,0,3
19314_1,,,,2,2,1,3
19316_0,,,,2,2,1,3
C1(C(C(C=CCO)O)OC(C1)O)=O,,,5,1,3,0,3
19316_1,,,,2,2,1,3
19318_0,,,,2,2,1,3
C(C(CC(C(C=O)=O)=O)O)=CCO,,,5,1,2,0,2
19320_0,,,,2,2,1,3
C(C(C(C=CCO)O)O)=O,,,5,1,5,0,5
19320_1,,,,2,2,1,3
19322_0,,,,2,2,1,3
C(CC(C)(C(CC=O)O)O)(O)=O,,,5,1,2,0,2
19324_0,,,,2,2,1,3
C(CC(C)(C(C(C=O)O)O)O)(O)=O,,,5,1,3,0,3
19324_1,,,,2,2,1,3
19326_0,,,,2,2,1,3
C(CC(C(C)(CC=O)O)O)(O)=O,,,5,1,2,0,2
19328_0,,,,2,2,1,3
C(CC(C(C)(C(C=O)O)O)O)(O)=O,,,5,1,4,0,4
19328_1,,,,2,2,1,3
19330_0,,,,2,2,1,3
C(CC(C(CC(C=C)O)=O)O)(O)=O,,,5,1,1,0,1
19332_0,,,,2,2,1,3
C(CC(C(CC(C=O)O)=O)O)(O)=O,,,5,1,2,0,2
19334_0,,,,2,2,1,3
C(CC(C(CC(C)O)=O)O)(O)=O,,,5,1,2,0,2
19336_0,,,,2,2,1,3
C(CC(C(CC(O)=O)O)=O)(O)=O,,,5,1,4,0,4
19337_0,,,,2,2,1,3
19339_0,,,,2,2,1,3
C(CC(C(CC(CO)O)=O)O)(O)=O,,,5,1,2,0,2
19341_0,,,,2,2,1,3
C(CC(C(C(CO)CO)=O)O)(O)=O,,,5,1,3,0,3
19341_1,,,,2,2,1,3
19343_0,,,,2,2,1,3
C(C(CO)C(C(CC=O)O)O)(O)=O,,,5,1,6,0,6
19345_0,,,,2,2,1,3
C(CC(CO)(C(CC=O)O)O)(O)=O,,,5,1,3,0,3
19346_0,,,,2,2,1,3
19348_0,,,,2,2,1,3
C(C(CO)(C(C)(CC=O)O)O)(O)=O,,,5,1,7,0,7
19350_0,,,,2,2,1,3
C(C(C(CC(C)O)=O)(CO)O)(O)=O,,,5,1,7,0,7
19351_0,,,,2,2,1,3
19352_0,,,,2,2,1,3
19353_0,,,,2,2,1,3
19353_1,,,,2,2,1,3
19355_0,,,,2,2,1,3
C(C(C=C)C(C(O)=O)(C(C)=O)O)=O,,,5,1,1,0,1
19356_0,,,,2,2,1,3
19357_0,,,,2,2,1,3
19357_1,,,,2,2,1,3
19358_0,,,,2,2,1,3
19360_0,,,,2,2,1,3
C(C(CO)C(C(O)=O)(C(C)=O)O)=O,,,5,1,7,0,7
19360_1,,,,2,2,1,3
19361_0,,,,2,2,1,3
19361_1,,,,2,2,1,3
19363_0,,,,2,2,1,3
C(C(C(C)=O)(CC(CO)=O)O)(O)=O,,,5,1,4,0,4
19364_0,,,,2,2,1,3
19364_1,,,,2,2,1,3
19366_0,,,,2,2,1,3
C(C(C=C)C(C(C(O)=O)=O)(C)O)=O,,,5,1,1,0,1
19368_0,,,,2,2,1,3
C(C(O)=O)(C(C)(CC(C=O)=O)O)=O,,,5,1,3,0,3
19370_0,,,,2,2,1,3
C(C(C=O)C(C(C(O)=O)=O)(C)O)=O,,,5,1,4,0,4
19370_1,,,,2,2,1,3
19372_0,,,,2,2,1,3
C(CC(C(C(O)=O)=O)(C)O)=O,,,5,1,3,0,3
19374_0,,,,2,2,1,3
C(C(CO)C(C(C(O)=O)=O)(C)O)=O,,,5,1,4,0,4
19374_1,,,,2,2,1,3
19376_0,,,,2,2,1,3
C(C(C(C(C(O)=O)=O)(C)O)O)(C)=O,,,5,1,5,0,5
19376_1,,,,2,2,1,3
19378_0,,,,2,2,1,3
C(CC(C(C(O)=O)=O)(C)O)(CO)=O,,,5,1,3,0,3
19379_0,,,,2,2,1,3
19379_1,,,,2,2,1,3
19381_0,,,,2,2,1,3
C(C(CC(C(C(O)=O)=O)=O)O)=CC,,,5,1,1,0,1
19383_0,,,,2,2,1,3
C=CCC(CC(C(C(O)=O)=O)=O)O,,,5,1,1,0,1
19385_0,,,,2,2,1,3
C=CC(CC(C(C(O)=O)=O)=O)O,,,5,1,1,0,1
19387_0,,,,2,2,1,3
C(C(CC(C(C(O)=O)=O)=O)O)=O,,,5,1,3,0,3
19389_0,,,,2,2,1,3
C(C(CC(C(C(O)=O)=O)=O)O)(O)=O,,,5,1,2,0,2
19391_0,,,,2,2,1,3
C(C(C)(CC(C(C(O)=O)=O)=O)O)=O,,,5,1,2,0,2
19393_0,,,,2,2,1,3
C(C)(C(CC(C(C(O)=O)=O)=O)O)=O,,,5,1,2,0,2
19395_0,,,,2,2,1,3
C(CC(CC(C(C(O)=O)=O)=O)O)=O,,,5,1,2,0,2
19397_0,,,,2,2,1,3
C(C(C(CC(C)O)=O)=O)(O)=O,,,5,1,3,0,3
19399_0,,,,2,2,1,3
C(C(C(CC(CCO)O)=O)=O)(O)=O,,,5,1,2,0,2
19401_0,,,,2,2,1,3
C(C(C(CC(C)(CO)O)=O)=O)(O)=O,,,5,1,2,0,2
19403_0,,,,2,2,1,3
C(CC(C(C(O)=O)=O)=O)(O)=O,,,5,1,4,0,4
19405_0,,,,2,2,1,3
C(C(C(CC(C(O)O)O)=O)=O)(O)=O,,,5,1,2,0,2
19407_0,,,,2,2,1,3
C(C(C(CC(C(C)O)O)=O)=O)(O)=O,,,5,1,2,0,2
19408_0,,,,2,2,1,3
19409_0,,,,2,2,1,3
19411_0,,,,2,2,1,3
C(C(C=C)(C(C(C=O)=O)C)O)(O)=O,,,5,1,1,0,1
19412_0,,,,2,2,1,3
19414_0,,,,2,2,1,3
C(C(C=C)(CC(C(C)=O)=O)O)(O)=O,,,5,1,1,0,1
19416_0,,,,2,2,1,3
C(C(C(C=O)=C)C(C(O)=O)(C=C)O)=O,,,5,1,1,0,1
19418_0,,,,2,2,1,3
C(C(C=C)(CC(C=CC=O)=O)O)(O)=O,,,5,1,1,0,1
19420_0,,,,2,2,1,3
C(C(C=C)(C(C=C)C(C=O)=O)O)(O)=O,,,5,1,1,0,1
19422_0,,,,2,2,1,3
C(C(C=CC=O)C(C(O)=O)(C=C)O)=O,,,5,1,1,0,1
19424_0,,,,2,2,1,3
C(C(C=C)C(C(O)=O)(C=C)O)=O,,,5,1,1,0,1
19426_0,,,,2,2,1,3
C(C(C=C)(C1C(C=CO1)=O)O)(O)=O,,,5,1,2,0,2
19426_1,,,,2,2,1,3
19427_0,,,,2,2,1,3
19427_1,,,,2,2,1,3
19429_0,,,,2,2,1,3
C(C(C=C)(CC(C=O)=O)O)(O)=O,,,5,1,5,0,5
19431_0,,,,2,2,1,3
C(C(C=C)(C(C=O)C=O)O)(O)=O,,,5,1,6,0,6
19431_1,,,,2,2,1,3
19433_0,,,,2,2,1,3
C(C(C=C)(CC=O)O)(O)=O,,,5,1,5,0,5
19435_0,,,,2,2,1,3
C(C(C=C)(C(C(C=O)=O)O)O)(O)=O,,,5,1,5,0,5
19435_1,,,,2,2,1,3
19437_0,,,,2,2,1,3
C(C(C=C)(C(C=O)C(C)O)O)(O)=O,,,5,1,3,0,3
19437_1,,,,2,2,1,3
19439_0,,,,2,2,1,3
C(C(C=C)(C(C=O)CO)O)(O)=O,,,5,1,5,0,5
19439_1,,,,2,2,1,3
19440_0,,,,2,2,1,3
19440_1,,,,2,2,1,3
19442_0,,,,2,2,1,3
C(C(C=C)(CC(CO)=O)O)(O)=O,,,5,1,5,0,5
19444_0,,,,2,2,1,3
C(C(C=C)(CC(C(O)=O)=O)O)(O)=O,,,5,1,2,0,2
19446_0,,,,2,2,1,3
C(C(C=O)C(C(O)=O)(C=C)O)(O)=O,,,5,1,3,0,3
19446_1,,,,2,2,1,3
19447_0,,,,2,2,1,3
19447_1,,,,2,2,1,3
19449_0,,,,2,2,1,3
C(C(C(C(C=O)=O)C)O)=CC(O)=O,,,5,1,1,0,1
19450_0,,,,2,2,1,3
19452_0,,,,2,2,1,3
C(C(CC(C(C)=O)=O)O)=CC(O)=O,,,5,1,1,0,1
19454_0,,,,2,2,1,3
C(C(C(C=O)=C)C(C=CC(O)=O)O)=O,,,5,1,1,0,1
19456_0,,,,2,2,1,3
C(C(CC(C=CC=O)=O)O)=CC(O)=O,,,5,1,1,0,1
19458_0,,,,2,2,1,3
C=CC(C(C=O)=O)C(C=CC(O)=O)O,,,5,1,1,0,1
19460_0,,,,2,2,1,3
C(C(C=CC=O)C(C=CC(O)=O)O)=O,,,5,1,1,0,1
19462_0,,,,2,2,1,3
C(C(C=C)C(C=CC(O)=O)O)=O,,,5,1,1,0,1
19464_0,,,,2,2,1,3
C1OC(C(C=1)=O)C(C=CC(O)=O)O,,,5,1,2,0,2
19464_1,,,,2,2,1,3
19466_0,,,,2,2,1,3
C(CO)(C(C(C=CC(O)=O)O)O)=O,,,5,1,3,0,3
19466_1,,,,2,2,1,3
19468_0,,,,2,2,1,3
C(C(CC(C=O)=O)O)=CC(O)=O,,,5,1,4,0,4
19470_0,,,,2,2,1,3
C(C(C=O)C(C=CC(O)=O)O)=O,,,5,1,5,0,5
19470_1,,,,2,2,1,3
19472_0,,,,2,2,1,3
C(CC(C=CC(O)=O)O)=O,,,5,1,6,0,6
19474_0,,,,2,2,1,3
C(C(C(C(C=O)=O)O)O)=CC(O)=O,,,5,1,3,0,3
19474_1,,,,2,2,1,3
19476_0,,,,2,2,1,3
C(C(C(C)O)C(C=CC(O)=O)O)=O,,,5,1,3,0,3
19476_1,,,,2,2,1,3
19478_0,,,,2,2,1,3
C(C(CO)C(C=CC(O)=O)O)=O,,,5,1,5,0,5
19478_1,,,,2,2,1,3
19480_0,,,,2,2,1,3
C(C)(C(C(C=CC(O)=O)O)O)=O,,,5,1,5,0,5
19480_1,,,,2,2,1,3
19482_0,,,,2,2,1,3
C(CO)(CC(C=CC(O)=O)O)=O,,,5,1,4,0,4
19484_0,,,,2,2,1,3
C(C(CC(C(O)=O)=O)O)=CC(O)=O,,,5,1,2,0,2
19486_0,,,,2,2,1,3
C(C(C=O)C(C=CC(O)=O)O)(O)=O,,,5,1,3,0,3
19486_1,,,,2,2,1,3
19488_0,,,,2,2,1,3
C(C(C(C=CC(O)=O)O)O)=O,,,5,1,6,0,6
19488_1,,,,2,2,1,3
19489_0,,,,2,2,1,3
19489_1,,,,2,2,1,3
19490_0,,,,2,2,1,3
19490_1,,,,2,2,1,3
19492_0,,,,2,2,1,3
C(C(CO)(C(CC=O)O)C(C)O)=O,,,5,1,5,0,5
19494_0,,,,2,2,1,3
C(C(C=O)(CO)C(CC=O)O)(O)=O,,,5,1,6,0,6
19496_0,,,,2,2,1,3
C(C(CO)(CO)C(CC=O)O)=O,,,5,1,4,0,4
19498_0,,,,2,2,1,3
C(C(CO)(CO)C(C(C=O)O)O)=O,,,5,1,5,0,5
19498_1,,,,2,2,1,3
19499_0,,,,2,2,1,3
19499_1,,,,2,2,1,3
19500_0,,,,2,2,1,3
19500_1,,,,2,2,1,3
19501_0,,,,2,2,1,3
19503_0,,,,2,2,1,3
C(CC(C(C(C)O)(C(C)O)O)O)=O,,,5,1,1,0,1
19505_0,,,,2,2,1,3
C(C(C=O)(C(C(CO)O)=O)O)(O)=O,,,5,1,5,0,5
19505_1,,,,2,2,1,3
19506_0,,,,2,2,1,3
19508_0,,,,2,2,1,3
C(C(C=O)(C(C(C=O)O)O)O)(O)=O,,,5,1,10,0,10
19508_1,,,,2,2,1,3
19509_0,,,,2,2,1,3
19510_0,,,,2,2,1,3
19510_1,,,,2,2,1,3
19511_0,,,,2,2,1,3
19512_0,,,,2,2,1,3
19512_1,,,,2,2,1,3
19513_0,,,,2,2,1,3
19515_0,,,,2,2,1,3
C(C1(COCC1(CC=O)O)O)(O)=O,,,5,1,1,0,1
19517_0,,,,2,2,1,3
C(C1(C(C(C(C)O)OC1)=O)O)(O)=O,,,5,1,4,0,4
19517_1,,,,2,2,1,3
19519_0,,,,2,2,1,3
C(C1(C(C(C(O)=O)OC1)=O)O)(O)=O,,,5,1,4,0,4
19519_1,,,,2,2,1,3
19521_0,,,,2,2,1,3
C(C1(C(C(CO)OC1)=O)O)(O)=O,,,5,1,5,0,5
19521_1,,,,2,2,1,3
19523_0,,,,2,2,1,3
C1(C(COC1CO)(C(C=O)O)O)=O,,,5,1,4,0,4
19523_1,,,,2,2,1,3
19525_0,,,,2,2,1,3
C(CC1(COCC1(C(C)O)O)O)=O,,,5,1,1,0,1
19527_0,,,,2,2,1,3
C1(C(C(C)O)OCC1(C(C)O)O)=O,,,5,1,4,0,4
19527_1,,,,2,2,1,3
19529_0,,,,2,2,1,3
C(C1C(C(CO1)(C(C)O)O)=O)(O)=O,,,5,1,4,0,4
19529_1,,,,2,2,1,3
19531_0,,,,2,2,1,3
C1(C(CO)OCC1(C(C)O)O)=O,,,5,1,4,0,4
19531_1,,,,2,2,1,3
19533_0,,,,2,2,1,3
C(CC1(COCC1(CO)O)O)=O,,,5,1,1,0,1
19535_0,,,,2,2,1,3
C(C(C1(COCC1(CO)O)O)O)=O,,,5,1,2,0,2
19535_1,,,,2,2,1,3
19537_0,,,,2,2,1,3
C1(C(C(C=C)O)OCC1(CO)O)=O,,,5,1,2,0,2
19537_1,,,,2,2,1,3
19539_0,,,,2,2,1,3
C(C(C1C(C(CO)(CO1)O)=O)O)=O,,,5,1,4,0,4
19539_1,,,,2,2,1,3
19541_0,,,,2,2,1,3
C1(C(C(C)O)OCC1(CO)O)=O,,,5,1,4,0,4
19541_1,,,,2,2,1,3
19543_0,,,,2,2,1,3
C(C1C(C(CO)(CO1)O)=O)(O)=O,,,5,1,4,0,4
19543_1,,,,2,2,1,3
19545_0,,,,2,2,1,3
C1(C(CO)OCC1(CO)O)=O,,,5,1,5,0,5
19545_1,,,,2,2,1,3
19547_0,,,,2,2,1,3
C1(C(C(CO)O)OCC1(CO)O)=O,,,5,1,4,0,4
19547_1,,,,2,2,1,3
19549_0,,,,2,2,1,3
C1(C(CO)OCC1(C(CO)O)O)=O,,,5,1,4,0,4
19549_1,,,,2,2,1,3
19550_0,,,,2,2,1,3
19551_0,,,,2,2,1,3
19552_0,,,,2,2,1,3
19553_0,,,,2,2,1,3
19555_0,,,,2,2,1,3
C(C(C=O)(C(CC(O)=O)=O)O)(O)=O,,,5,1,3,0,3
19556_0,,,,2,2,1,3
19558_0,,,,2,2,1,3
C(CC(C1(CC(CC1O)O)O)O)=O,,,5,1,1,0,1
19560_0,,,,2,2,1,3
C(C(C(O)=O)(C(C=O)CO)O)(O)=O,,,5,1,5,0,5
19560_1,,,,2,2,1,3
19561_0,,,,2,2,1,3
19561_1,,,,2,2,1,3
19562_0,,,,2,2,1,3
19563_0,,,,2,2,1,3
19563_1,,,,2,2,1,3
19564_0,,,,2,2,1,3
19566_0,,,,2,2,1,3
C(CC(C(C(CCO)O)(O)O)O)=O,,,5,1,1,0,1
19568_0,,,,2,2,1,3
C(CC(C(C)(C(CCO)O)O)O)=O,,,5,1,1,0,1
19570_0,,,,2,2,1,3
C(C(C(C)(C(C)O)O)(CC=O)O)=O,,,5,1,1,0,1
19572_0,,,,2,2,1,3
C(CC(C(C(C)(C(C)O)O)=O)O)=O,,,5,1,2,0,2
19573_0,,,,2,2,1,3
19574_0,,,,2,2,1,3
19574_1,,,,2,2,1,3
19576_0,,,,2,2,1,3
C(CC(C(C(CO)(C)O)=O)O)=O,,,5,1,4,0,4
19578_0,,,,2,2,1,3
C(C(C(C=O)O)O)(C(CO)(C)O)=O,,,5,1,4,0,4
19578_1,,,,2,2,1,3
19580_0,,,,2,2,1,3
C(CC(C(C(C)(CO)O)(O)O)O)=O,,,5,1,1,0,1
19582_0,,,,2,2,1,3
C(CC(C(C)(C(C)(CO)O)O)O)=O,,,5,1,2,0,2
19584_0,,,,2,2,1,3
C(CC1(CCOC1(C(O)=O)O)O)=O,,,5,1,1,0,1
19586_0,,,,2,2,1,3
C(C1(C(C(CO1)C(C)O)=O)O)(O)=O,,,5,1,3,0,3
19586_1,,,,2,2,1,3
19588_0,,,,2,2,1,3
C(C1C(C(C(O)=O)(O)OC1)=O)(O)=O,,,5,1,3,0,3
19588_1,,,,2,2,1,3
19590_0,,,,2,2,1,3
C(C1(C(C(CO)CO1)=O)O)(O)=O,,,5,1,3,0,3
19590_1,,,,2,2,1,3
19592_0,,,,2,2,1,3
C(C(C1(C(C(CO)CO1)=O)O)O)=O,,,5,1,3,0,3
19592_1,,,,2,2,1,3
19594_0,,,,2,2,1,3
C(CC1(CCOC1(C(C)O)O)O)=O,,,5,1,1,0,1
19596_0,,,,2,2,1,3
C1(C(C(C)O)(O)OCC1C(C)O)=O,,,5,1,3,0,3
19596_1,,,,2,2,1,3
19598_0,,,,2,2,1,3
C(C1C(C(C(C)O)(O)OC1)=O)(O)=O,,,5,1,3,0,3
19598_1,,,,2,2,1,3
19600_0,,,,2,2,1,3
C1(C(C(C)O)(O)OCC1CO)=O,,,5,1,3,0,3
19600_1,,,,2,2,1,3
19602_0,,,,2,2,1,3
C(CC1(CCOC1(CO)O)O)=O,,,5,1,1,0,1
19604_0,,,,2,2,1,3
C(C(C1(C(CO)(O)OCC1)O)O)=O,,,5,1,2,0,2
19604_1,,,,2,2,1,3
19606_0,,,,2,2,1,3
C1(C(CO)(O)OCC1C(C=C)O)=O,,,5,1,2,0,2
19606_1,,,,2,2,1,3
19608_0,,,,2,2,1,3
C1(C(CO)(O)OCC1C(C=O)O)=O,,,5,1,3,0,3
19608_1,,,,2,2,1,3
19610_0,,,,2,2,1,3
C1(C(CO)(O)OCC1C(C)O)=O,,,5,1,3,0,3
19610_1,,,,2,2,1,3
19612_0,,,,2,2,1,3
C(C1C(C(CO)(O)OC1)=O)(O)=O,,,5,1,5,0,5
19612_1,,,,2,2,1,3
19614_0,,,,2,2,1,3
C1(C(CO)(O)OCC1CO)=O,,,5,1,5,0,5
19614_1,,,,2,2,1,3
19616_0,,,,2,2,1,3
C1(C(CO)(O)OCC1C(CO)O)=O,,,5,1,3,0,3
19616_1,,,,2,2,1,3
19618_0,,,,2,2,1,3
C1(C(C(CO)O)(O)OCC1CO)=O,,,5,1,3,0,3
19618_1,,,,2,2,1,3
19620_0,,,,2,2,1,3
C(CC1(C(CO)(O)OCC1O)O)=O,,,5,1,2,0,2
19622_0,,,,2,2,1,3
C(C(C=C)C(C(C(O)=O)(O)O)O)=O,,,5,1,2,0,2
19624_0,,,,2,2,1,3
C(C(C(CC(C=O)=O)O)(O)O)(O)=O,,,5,1,3,0,3
19626_0,,,,2,2,1,3
C(C(C=O)C(C(C(O)=O)(O)O)O)=O,,,5,1,3,0,3
19626_1,,,,2,2,1,3
19628_0,,,,2,2,1,3
C(CC(C(C(O)=O)(O)O)O)=O,,,5,1,3,0,3
19630_0,,,,2,2,1,3
C(C(CO)C(C(C(O)=O)(O)O)O)=O,,,5,1,4,0,4
19630_1,,,,2,2,1,3
19632_0,,,,2,2,1,3
C(C(C(C(C(C)=O)O)O)(O)O)(O)=O,,,5,1,4,0,4
19632_1,,,,2,2,1,3
19634_0,,,,2,2,1,3
C(C(C(CC(CO)=O)O)(O)O)(O)=O,,,5,1,3,0,3
19636_0,,,,2,2,1,3
C(C(C(C(C(O)=O)(O)O)O)O)=O,,,5,1,4,0,4
19636_1,,,,2,2,1,3
19637_0,,,,2,2,1,3
19638_0,,,,2,2,1,3
19639_0,,,,2,2,1,3
19639_1,,,,2,2,1,3
19641_0,,,,2,2,1,3
C(C(C=O)C(C(O)=O)(C=O)O)(O)=O,,,5,1,4,0,4
19641_1,,,,2,2,1,3
19642_0,,,,2,2,1,3
19642_1,,,,2,2,1,3
19644_0,,,,2,2,1,3
C(CC(C(C(C(O)O)O)(O)O)O)=O,,,5,1,1,0,1
19646_0,,,,2,2,1,3
C(CC(C(C(C(C)O)O)(O)O)O)=O,,,5,1,1,0,1
19647_0,,,,2,2,1,3
19648_0,,,,2,2,1,3
19648_1,,,,2,2,1,3
19650_0,,,,2,2,1,3
C(CC(C(C(C=O)O)(O)O)O)=O,,,5,1,1,0,1
19652_0,,,,2,2,1,3
C(C(C(C(C(C=O)O)O)(O)O)O)=O,,,5,1,2,0,2
19652_1,,,,2,2,1,3
19654_0,,,,2,2,1,3
C(CC(C(C(C(O)=O)O)(O)O)O)=O,,,5,1,1,0,1
19655_0,,,,2,2,1,3
19657_0,,,,2,2,1,3
C(C(C)(C(C(CC=O)O)(O)O)O)=O,,,5,1,1,0,1
19658_0,,,,2,2,1,3
19660_0,,,,2,2,1,3
C(CC(C(C(C(C)=O)O)(O)O)O)=O,,,5,1,1,0,1
19661_0,,,,2,2,1,3
19662_0,,,,2,2,1,3
19663_0,,,,2,2,1,3
19664_0,,,,2,2,1,3
19666_0,,,,2,2,1,3
C(CC(C(C(CC=O)O)(O)O)O)=O,,,5,1,1,0,1
19667_0,,,,2,2,1,3
19667_1,,,,2,2,1,3
19669_0,,,,2,2,1,3
C(C(C=O)C(C(C=O)(O)O)O)(O)=O,,,5,1,3,0,3
19669_1,,,,2,2,1,3
19670_0,,,,2,2,1,3
19670_1,,,,2,2,1,3
19672_0,,,,2,2,1,3
C(C(C=C)C(C(C(C)O)(O)O)O)=O,,,5,1,1,0,1
19674_0,,,,2,2,1,3
C(C(CC(C(C(C)O)(O)O)O)=O)=O,,,5,1,1,0,1
19676_0,,,,2,2,1,3
C(C(C=O)C(C(C(C)O)(O)O)O)=O,,,5,1,2,0,2
19676_1,,,,2,2,1,3
19678_0,,,,2,2,1,3
C(CC(C(C(C)O)(O)O)O)=O,,,5,1,1,0,1
19680_0,,,,2,2,1,3
C(C(CO)C(C(C(C)O)(O)O)O)=O,,,5,1,2,0,2
19680_1,,,,2,2,1,3
19682_0,,,,2,2,1,3
C(C)(C(C(C(C(C)O)(O)O)O)O)=O,,,5,1,2,0,2
19682_1,,,,2,2,1,3
19684_0,,,,2,2,1,3
C(CO)(CC(C(C(C)O)(O)O)O)=O,,,5,1,1,0,1
19686_0,,,,2,2,1,3
C(C(C(C(C(C)O)(O)O)O)O)=O,,,5,1,2,0,2
19686_1,,,,2,2,1,3
19687_0,,,,2,2,1,3
19687_1,,,,2,2,1,3
19689_0,,,,2,2,1,3
C(C(C(C)C(C(CO)(O)O)O)=O)=O,,,5,1,1,0,1
19691_0,,,,2,2,1,3
C(C(C(C(CO)(O)O)O)CC=O)=O,,,5,1,1,0,1
19693_0,,,,2,2,1,3
C(C(C)=O)(CC(C(CO)(O)O)O)=O,,,5,1,1,0,1
19695_0,,,,2,2,1,3
C(C(C=C)C(C(CO)(O)O)O)=O,,,5,1,1,0,1
19697_0,,,,2,2,1,3
C1OC(C(C=1)=O)C(C(CO)(O)O)O,,,5,1,2,0,2
19697_1,,,,2,2,1,3
19699_0,,,,2,2,1,3
C(CO)(C(C(C(CO)(O)O)O)O)=O,,,5,1,3,0,3
19699_1,,,,2,2,1,3
19701_0,,,,2,2,1,3
C(C(CC(C(CO)(O)O)O)=O)=O,,,5,1,2,0,2
19703_0,,,,2,2,1,3
C(C(C=O)C(C(CO)(O)O)O)=O,,,5,1,2,0,2
19703_1,,,,2,2,1,3
19705_0,,,,2,2,1,3
C(CC(C(CO)(O)O)O)=O,,,5,1,2,0,2
19707_0,,,,2,2,1,3
C(C(C(C(C(CO)(O)O)O)O)=O)=O,,,5,1,3,0,3
19707_1,,,,2,2,1,3
19709_0,,,,2,2,1,3
C(C(C(C)O)C(C(CO)(O)O)O)=O,,,5,1,3,0,3
19709_1,,,,2,2,1,3
19711_0,,,,2,2,1,3
C(C(CO)C(C(CO)(O)O)O)=O,,,5,1,3,0,3
19711_1,,,,2,2,1,3
19713_0,,,,2,2,1,3
C(C)(C(C(C(CO)(O)O)O)O)=O,,,5,1,3,0,3
19713_1,,,,2,2,1,3
19715_0,,,,2,2,1,3
C(CO)(CC(C(CO)(O)O)O)=O,,,5,1,2,0,2
19717_0,,,,2,2,1,3
C(C(CC(C(CO)(O)O)O)=O)(O)=O,,,5,1,2,0,2
19719_0,,,,2,2,1,3
C(C(C=O)C(C(CO)(O)O)O)(O)=O,,,5,1,2,0,2
19719_1,,,,2,2,1,3
19721_0,,,,2,2,1,3
C(C(C(C(CO)(O)O)O)O)=O,,,5,1,3,0,3
19721_1,,,,2,2,1,3
19723_0,,,,2,2,1,3
C(CC(C(C(CO)O)(O)O)O)=O,,,5,1,1,0,1
19725_0,,,,2,2,1,3
C(C(C(C(C(CO)O)(O)O)O)O)=O,,,5,1,2,0,2
19725_1,,,,2,2,1,3
19727_0,,,,2,2,1,3
C(CC(C(C)(C(C(O)O)O)O)O)=O,,,5,1,1,0,1
19729_0,,,,2,2,1,3
C(CC(C(C)(C(C(C)O)O)O)O)=O,,,5,1,1,0,1
19730_0,,,,2,2,1,3
19731_0,,,,2,2,1,3
19733_0,,,,2,2,1,3
C(CC(C(C)(C(CC=O)O)O)O)=O,,,5,1,1,0,1
19734_0,,,,2,2,1,3
19734_1,,,,2,2,1,3
19735_0,,,,2,2,1,3
19735_1,,,,2,2,1,3
19736_0,,,,2,2,1,3
19736_1,,,,2,2,1,3
19738_0,,,,2,2,1,3
C(C(C=C)C(C(C)(C(C)O)O)O)=O,,,5,1,1,0,1
19740_0,,,,2,2,1,3
C(C(CC(C(C)(C(C)O)O)O)=O)=O,,,5,1,1,0,1
19742_0,,,,2,2,1,3
C(C(C=O)C(C(C)(C(C)O)O)O)=O,,,5,1,2,0,2
19742_1,,,,2,2,1,3
19744_0,,,,2,2,1,3
C(CC(C(C)(C(C)O)O)O)=O,,,5,1,1,0,1
19746_0,,,,2,2,1,3
C(C(CO)C(C(C)(C(C)O)O)O)=O,,,5,1,2,0,2
19746_1,,,,2,2,1,3
19748_0,,,,2,2,1,3
C(C)(C(C(C(C)(C(C)O)O)O)O)=O,,,5,1,2,0,2
19748_1,,,,2,2,1,3
19750_0,,,,2,2,1,3
C(CO)(CC(C(C)(C(C)O)O)O)=O,,,5,1,1,0,1
19752_0,,,,2,2,1,3
C(C(C(C(C)(C(C)O)O)O)O)=O,,,5,1,2,0,2
19752_1,,,,2,2,1,3
19754_0,,,,2,2,1,3
C(C(C(C)C(C(C)(CO)O)O)=O)=O,,,5,1,1,0,1
19756_0,,,,2,2,1,3
C(C(C(C(C)(CO)O)O)CC=O)=O,,,5,1,1,0,1
19758_0,,,,2,2,1,3
C(C(C)=O)(CC(C(C)(CO)O)O)=O,,,5,1,1,0,1
19760_0,,,,2,2,1,3
C(C(C=C)C(C(C)(CO)O)O)=O,,,5,1,1,0,1
19762_0,,,,2,2,1,3
C1OC(C(C=1)=O)C(C(C)(CO)O)O,,,5,1,2,0,2
19762_1,,,,2,2,1,3
19764_0,,,,2,2,1,3
C(CO)(C(C(C(CO)(C)O)O)O)=O,,,5,1,5,0,5
19764_1,,,,2,2,1,3
19766_0,,,,2,2,1,3
C(C(CC(C(C)(CO)O)O)=O)=O,,,5,1,2,0,2
19768_0,,,,2,2,1,3
C(C(C=O)C(C(C)(CO)O)O)=O,,,5,1,2,0,2
19768_1,,,,2,2,1,3
19770_0,,,,2,2,1,3
C(CC(C(C)(CO)O)O)=O,,,5,1,2,0,2
19772_0,,,,2,2,1,3
C(C(C(C(C(CO)(C)O)O)O)=O)=O,,,5,1,5,0,5
19772_1,,,,2,2,1,3
19774_0,,,,2,2,1,3
C(C(C(C)O)C(C(C)(CO)O)O)=O,,,5,1,3,0,3
19774_1,,,,2,2,1,3
19776_0,,,,2,2,1,3
C(C(CO)C(C(C)(CO)O)O)=O,,,5,1,3,0,3
19776_1,,,,2,2,1,3
19778_0,,,,2,2,1,3
C(C)(C(C(C(CO)(C)O)O)O)=O,,,5,1,3,0,3
19778_1,,,,2,2,1,3
19780_0,,,,2,2,1,3
C(CO)(CC(C(CO)(C)O)O)=O,,,5,1,2,0,2
19782_0,,,,2,2,1,3
C(C(CC(C(C)(CO)O)O)=O)(O)=O,,,5,1,2,0,2
19784_0,,,,2,2,1,3
C(C(C=O)C(C(C)(CO)O)O)(O)=O,,,5,1,2,0,2
19784_1,,,,2,2,1,3
19786_0,,,,2,2,1,3
C(C(C(C(CO)(C)O)O)O)=O,,,5,1,6,0,6
19786_1,,,,2,2,1,3
19787_0,,,,2,2,1,3
19788_0,,,,2,2,1,3
19788_1,,,,2,2,1,3
19789_0,,,,2,2,1,3
19790_0,,,,2,2,1,3
19791_0,,,,2,2,1,3
19792_0,,,,2,2,1,3
19793_0,,,,2,2,1,3
19794_0,,,,2,2,1,3
19795_0,,,,2,2,1,3
19795_1,,,,2,2,1,3
19797_0,,,,2,2,1,3
C(C(C=O)C([C](C(O)=O)O)O)(O)=O,,,5,1,3,0,3
19797_1,,,,2,2,1,3
19798_0,,,,2,2,1,3
19798_1,,,,2,2,1,3
19799_0,,,,2,2,1,3
19799_1,,,,2,2,1,3
19801_0,,,,2,2,1,3
C(CC(C(O)OC(CO)=O)O)=O,,,5,1,2,0,2
19803_0,,,,2,2,1,3
C(C(C(C(O)OC(CO)=O)O)O)=O,,,5,1,3,0,3
19803_1,,,,2,2,1,3
19805_0,,,,2,2,1,3
C(C(C=C)C(COC(CO)=O)O)=O,,,5,1,1,0,1
19807_0,,,,2,2,1,3
C(CO)(OCC(CC(C=O)=O)O)=O,,,5,1,1,0,1
19809_0,,,,2,2,1,3
C(C(C=O)C(COC(CO)=O)O)=O,,,5,1,2,0,2
19809_1,,,,2,2,1,3
19811_0,,,,2,2,1,3
C(CC(COC(CO)=O)O)=O,,,5,1,3,0,3
19813_0,,,,2,2,1,3
C(C(CO)C(COC(CO)=O)O)=O,,,5,1,2,0,2
19813_1,,,,2,2,1,3
19815_0,,,,2,2,1,3
C(C)(C(C(COC(CO)=O)O)O)=O,,,5,1,2,0,2
19815_1,,,,2,2,1,3
19817_0,,,,2,2,1,3
C(CO)(CC(COC(CO)=O)O)=O,,,5,1,1,0,1
19818_0,,,,2,2,1,3
19818_1,,,,2,2,1,3
19820_0,,,,2,2,1,3
C(CO)(OC(C=O)C(C=CC)O)=O,,,5,1,2,0,2
19820_1,,,,2,2,1,3
19822_0,,,,2,2,1,3
C(C(C(CC=C)O)OC(CO)=O)=O,,,5,1,2,0,2
19822_1,,,,2,2,1,3
19824_0,,,,2,2,1,3
C(CO)(OC(C=O)C(C=C)O)=O,,,5,1,2,0,2
19824_1,,,,2,2,1,3
19826_0,,,,2,2,1,3
C(CO)(OC(C=O)C(C=O)O)=O,,,5,1,4,0,4
19826_1,,,,2,2,1,3
19828_0,,,,2,2,1,3
C(CO)(OC(C=O)C(C(O)=O)O)=O,,,5,1,2,0,2
19828_1,,,,2,2,1,3
19830_0,,,,2,2,1,3
C(CO)(OC(C=O)C(C=O)(C)O)=O,,,5,1,2,0,2
19830_1,,,,2,2,1,3
19832_0,,,,2,2,1,3
C(CO)(OC(C=O)C(C(C)=O)O)=O,,,5,1,2,0,2
19832_1,,,,2,2,1,3
19834_0,,,,2,2,1,3
C(CC(C(C=O)OC(CO)=O)O)=O,,,5,1,2,0,2
19834_1,,,,2,2,1,3
19836_0,,,,2,2,1,3
C(C(C(C)O)OC(CO)=O)=O,,,5,1,2,0,2
19836_1,,,,2,2,1,3
19838_0,,,,2,2,1,3
C(C(C(CCO)O)OC(CO)=O)=O,,,5,1,2,0,2
19838_1,,,,2,2,1,3
19840_0,,,,2,2,1,3
C(C(C(CO)(C)O)OC(CO)=O)=O,,,5,1,2,0,2
19840_1,,,,2,2,1,3
19842_0,,,,2,2,1,3
C(C(C=O)OC(CO)=O)(O)=O,,,5,1,2,0,2
19842_1,,,,2,2,1,3
19844_0,,,,2,2,1,3
C(C(C(C(O)O)O)OC(CO)=O)=O,,,5,1,2,0,2
19844_1,,,,2,2,1,3
19846_0,,,,2,2,1,3
C(C(C(C(C)O)O)OC(CO)=O)=O,,,5,1,2,0,2
19846_1,,,,2,2,1,3
19847_0,,,,2,2,1,3
19847_1,,,,2,2,1,3
19848_0,,,,2,2,1,3
19848_1,,,,2,2,1,3
19850_0,,,,2,2,1,3
C(CC(C(CO)OC(CO)=O)O)=O,,,5,1,3,0,3
19852_0,,,,2,2,1,3
C(CC(C(COC(CO)=O)O)O)=O,,,5,1,3,0,3
19854_0,,,,2,2,1,3
C(C(C(CCC(CC=O)O)=O)O)=O,,,5,1,2,0,2
19856_0,,,,2,2,1,3
C(CCC(C(C=O)O)(CC=O)O)=O,,,5,1,4,0,4
19858_0,,,,2,2,1,3
C(CC(C(C(CCC=O)=O)O)O)=O,,,5,1,3,0,3
19860_0,,,,2,2,1,3
C(C(C(C)O)CC(C(C=O)O)=O)=O,,,5,1,2,0,2
19862_0,,,,2,2,1,3
C(C(C=O)CC(C(C=O)O)=O)(O)=O,,,5,1,2,0,2
19863_0,,,,2,2,1,3
19865_0,,,,2,2,1,3
C(C(C(C)O)CC=O)(C(C=O)O)=O,,,5,1,2,0,2
19867_0,,,,2,2,1,3
C(C(C(C(C=O)O)=O)CC=O)(O)=O,,,5,1,1,0,1
19869_0,,,,2,2,1,3
C(C(CO)CC=O)(C(C=O)O)=O,,,5,1,5,0,5
19871_0,,,,2,2,1,3
C(CC(C=O)O)(CC(CC=O)O)=O,,,5,1,1,0,1
19873_0,,,,2,2,1,3
C(CC(CC(C=O)O)(CC=O)O)=O,,,5,1,1,0,1
19874_0,,,,2,2,1,3
19876_0,,,,2,2,1,3
C(CC(C=O)O)(C(C=O)C(C)O)=O,,,5,1,2,0,2
19876_1,,,,2,2,1,3
19878_0,,,,2,2,1,3
C(C(C=O)C(CC(C=O)O)=O)(O)=O,,,5,1,3,0,3
19878_1,,,,2,2,1,3
19879_0,,,,2,2,1,3
19879_1,,,,2,2,1,3
19881_0,,,,2,2,1,3
C(C(C(C)O)C(C=O)O)(CC=O)=O,,,5,1,2,0,2
19881_1,,,,2,2,1,3
19883_0,,,,2,2,1,3
C(C(C(CC=O)=O)C(C=O)O)(O)=O,,,5,1,5,0,5
19883_1,,,,2,2,1,3
19884_0,,,,2,2,1,3
19884_1,,,,2,2,1,3
19885_0,,,,2,2,1,3
19885_1,,,,2,2,1,3
19887_0,,,,2,2,1,3
C(C(CO)CC(C=O)(CC=O)O)=O,,,5,1,1,0,1
19889_0,,,,2,2,1,3
C(CC(C(CC(C=O)CO)=O)O)=O,,,5,1,1,0,1
19891_0,,,,2,2,1,3
C(CC(C(CO)CC(C=O)=O)O)=O,,,5,1,3,0,3
19893_0,,,,2,2,1,3
C(C(CO)C(C(C=O)=O)C(C)O)=O,,,5,1,2,0,2
19895_0,,,,2,2,1,3
C(C(C(C=O)=O)C(C=O)CO)(O)=O,,,5,1,1,0,1
19896_0,,,,2,2,1,3
19898_0,,,,2,2,1,3
C(CC(C(C=O)C(C=O)CO)O)=O,,,5,1,5,0,5
19900_0,,,,2,2,1,3
C(C(C=O)C(CO)C(CC=O)O)=O,,,5,1,3,0,3
19902_0,,,,2,2,1,3
C(C(C=C)C(CC(C=O)CO)O)=O,,,5,1,1,0,1
19904_0,,,,2,2,1,3
C(C(CO)CC(CC(C=O)=O)O)=O,,,5,1,1,0,1
19906_0,,,,2,2,1,3
C(C(C=O)C(CC(C=O)CO)O)=O,,,5,1,2,0,2
19906_1,,,,2,2,1,3
19908_0,,,,2,2,1,3
C(C(CO)CC(CC=O)O)=O,,,5,1,2,0,2
19910_0,,,,2,2,1,3
C(C(CO)C(CC(C=O)CO)O)=O,,,5,1,2,0,2
19910_1,,,,2,2,1,3
19912_0,,,,2,2,1,3
C(C(CO)CC(C(C(C)=O)O)O)=O,,,5,1,2,0,2
19912_1,,,,2,2,1,3
19914_0,,,,2,2,1,3
C(C(CO)CC(CC(CO)=O)O)=O,,,5,1,1,0,1
19916_0,,,,2,2,1,3
C(C(CO)CC(C(C=O)O)O)=O,,,5,1,4,0,4
19916_1,,,,2,2,1,3
19918_0,,,,2,2,1,3
C(C(C=C)C(C(CO)CC=O)O)=O,,,5,1,1,0,1
19920_0,,,,2,2,1,3
C(CC(CO)C(CC(C=O)=O)O)=O,,,5,1,4,0,4
19922_0,,,,2,2,1,3
C(C(C=O)C(C(CO)CC=O)O)=O,,,5,1,5,0,5
19922_1,,,,2,2,1,3
19924_0,,,,2,2,1,3
C(CC(C(CO)CC=O)O)=O,,,5,1,4,0,4
19926_0,,,,2,2,1,3
C(C(CO)C(C(CO)CC=O)O)=O,,,5,1,4,0,4
19926_1,,,,2,2,1,3
19928_0,,,,2,2,1,3
C(CC(CO)C(C(C(C)=O)O)O)=O,,,5,1,5,0,5
19928_1,,,,2,2,1,3
19930_0,,,,2,2,1,3
C(CC(CO)C(CC(CO)=O)O)=O,,,5,1,4,0,4
19932_0,,,,2,2,1,3
C(CC(CO)C(C(C=O)O)O)=O,,,5,1,5,0,5
19932_1,,,,2,2,1,3
19934_0,,,,2,2,1,3
C(C(CO)C(C=O)C(C=CC)O)=O,,,5,1,1,0,1
19936_0,,,,2,2,1,3
C(C(C(CC=C)O)C(C=O)CO)=O,,,5,1,1,0,1
19938_0,,,,2,2,1,3
C(C(CO)C(C=O)C(C=C)O)=O,,,5,1,2,0,2
19939_0,,,,2,2,1,3
19941_0,,,,2,2,1,3
C(C(C(C=O)C(C=O)CO)O)(O)=O,,,5,1,6,0,6
19943_0,,,,2,2,1,3
C(C(CO)C(C=O)C(C=O)(C)O)=O,,,5,1,4,0,4
19945_0,,,,2,2,1,3
C(C(C(C=O)C(C=O)CO)O)(C)=O,,,5,1,4,0,4
19946_0,,,,2,2,1,3
19948_0,,,,2,2,1,3
C(C(C(C)O)C(C=O)CO)=O,,,5,1,5,0,5
19950_0,,,,2,2,1,3
C(C(C(CCO)O)C(C=O)CO)=O,,,5,1,2,0,2
19952_0,,,,2,2,1,3
C(C(C(C)(CO)O)C(C=O)CO)=O,,,5,1,2,0,2
19954_0,,,,2,2,1,3
C(C(C=O)C(C=O)CO)(O)=O,,,5,1,4,0,4
19956_0,,,,2,2,1,3
C(C(C(C(O)O)O)C(C=O)CO)=O,,,5,1,2,0,2
19958_0,,,,2,2,1,3
C(C(C(C(C)O)O)C(C=O)CO)=O,,,5,1,2,0,2
19960_0,,,,2,2,1,3
C(C(CO)C(C=O)CO)=O,,,5,1,4,0,4
19962_0,,,,2,2,1,3
C(C(C(CO)O)C(C=O)CO)=O,,,5,1,9,0,9
19963_0,,,,2,2,1,3
19964_0,,,,2,2,1,3
19966_0,,,,2,2,1,3
C(CO)(C(C(C(O)=O)=O)C(C)O)=O,,,5,1,3,0,3
19966_1,,,,2,2,1,3
19968_0,,,,2,2,1,3
C(C(C(CO)=O)C(C(O)=O)=O)(O)=O,,,5,1,4,0,4
19968_1,,,,2,2,1,3
19969_0,,,,2,2,1,3
19969_1,,,,2,2,1,3
19971_0,,,,2,2,1,3
C(C(C(C)O)O)(CC(C(O)=O)=O)=O,,,5,1,4,0,4
19971_1,,,,2,2,1,3
19973_0,,,,2,2,1,3
C(C(C(CC(C(O)=O)=O)=O)O)(O)=O,,,5,1,5,0,5
19973_1,,,,2,2,1,3
19974_0,,,,2,2,1,3
19974_1,,,,2,2,1,3
19976_0,,,,2,2,1,3
C(CC(C(C(C(CO)=O)=O)C)O)=O,,,5,1,2,0,2
19978_0,,,,2,2,1,3
C(C(CO)(CC=O)O)(C(C=O)C)=O,,,5,1,1,0,1
19980_0,,,,2,2,1,3
C(CC(C(CO)=O)(C(C=O)C)O)=O,,,5,1,1,0,1
19982_0,,,,2,2,1,3
C(C(C(C(C(C(C)O)O)=O)=O)C)=O,,,5,1,2,0,2
19982_1,,,,2,2,1,3
19984_0,,,,2,2,1,3
C(C(C(C(C(C(O)=O)O)=O)=O)C)=O,,,5,1,2,0,2
19984_1,,,,2,2,1,3
19985_0,,,,2,2,1,3
19985_1,,,,2,2,1,3
19987_0,,,,2,2,1,3
C(CO)(CC(C(C)(CC=O)O)=O)=O,,,5,1,1,0,1
19989_0,,,,2,2,1,3
C(CC(C(C)=O)(CC(CO)=O)O)=O,,,5,1,2,0,2
19991_0,,,,2,2,1,3
C(CC(CO)(CC(C(C)=O)=O)O)=O,,,5,1,2,0,2
19993_0,,,,2,2,1,3
C(CO)(CC(C(CC(C)O)=O)=O)=O,,,5,1,1,0,1
19995_0,,,,2,2,1,3
C(CC(C(CC(CO)=O)=O)=O)(O)=O,,,5,1,2,0,2
19996_0,,,,2,2,1,3
19998_0,,,,2,2,1,3
C(CO)(C(C(C(C)=O)=O)C(C)O)=O,,,5,1,2,0,2
19998_1,,,,2,2,1,3
20000_0,,,,2,2,1,3
C(C(C(CO)=O)C(C(C)=O)=O)(O)=O,,,5,1,2,0,2
20000_1,,,,2,2,1,3
20001_0,,,,2,2,1,3
20001_1,,,,2,2,1,3
20003_0,,,,2,2,1,3
C(C(C(C)O)O)(CC(C(C)=O)=O)=O,,,5,1,2,0,2
20003_1,,,,2,2,1,3
20005_0,,,,2,2,1,3
C(C(C(O)=O)O)(CC(C(C)=O)=O)=O,,,5,1,2,0,2
20005_1,,,,2,2,1,3
20006_0,,,,2,2,1,3
20006_1,,,,2,2,1,3
20007_0,,,,2,2,1,3
20009_0,,,,2,2,1,3
C(C)(CC(C(CO)(CC=O)O)=O)=O,,,5,1,1,0,1
20011_0,,,,2,2,1,3
C(CC(C(CO)=O)(CC(C)=O)O)=O,,,5,1,1,0,1
20013_0,,,,2,2,1,3
C(C)(C(C(C(CO)=O)=O)C(C)O)=O,,,5,1,2,0,2
20013_1,,,,2,2,1,3
20015_0,,,,2,2,1,3
C(C(C(C)=O)C(C(CO)=O)=O)(O)=O,,,5,1,3,0,3
20015_1,,,,2,2,1,3
20017_0,,,,2,2,1,3
C(C)(C(C(C(CO)=O)=O)CO)=O,,,5,1,4,0,4
20017_1,,,,2,2,1,3
20019_0,,,,2,2,1,3
C(CC(C)O)(CC(C(CO)=O)=O)=O,,,5,1,1,0,1
20021_0,,,,2,2,1,3
C(CC(O)=O)(CC(C(CO)=O)=O)=O,,,5,1,2,0,2
20022_0,,,,2,2,1,3
20024_0,,,,2,2,1,3
C(C)(CC(C(C(C(C)O)O)=O)=O)=O,,,5,1,2,0,2
20024_1,,,,2,2,1,3
20026_0,,,,2,2,1,3
C(C(C(C(CC(C)=O)=O)=O)O)(O)=O,,,5,1,2,0,2
20026_1,,,,2,2,1,3
20027_0,,,,2,2,1,3
20027_1,,,,2,2,1,3
20029_0,,,,2,2,1,3
C(CC(CC=O)(CC(CO)=O)O)=O,,,5,1,2,0,2
20031_0,,,,2,2,1,3
C(CC(CC(CC(CO)=O)=O)O)=O,,,5,1,2,0,2
20032_0,,,,2,2,1,3
20034_0,,,,2,2,1,3
C(C(C(CC(CO)=O)=O)C(C)O)=O,,,5,1,2,0,2
20034_1,,,,2,2,1,3
20036_0,,,,2,2,1,3
C(C(C=O)C(CC(CO)=O)=O)(O)=O,,,5,1,2,0,2
20036_1,,,,2,2,1,3
20037_0,,,,2,2,1,3
20037_1,,,,2,2,1,3
20039_0,,,,2,2,1,3
C(CC=O)(C(C(CO)=O)C(C)O)=O,,,5,1,2,0,2
20039_1,,,,2,2,1,3
20041_0,,,,2,2,1,3
C(C(C(CC=O)=O)C(CO)=O)(O)=O,,,5,1,2,0,2
20041_1,,,,2,2,1,3
20042_0,,,,2,2,1,3
20042_1,,,,2,2,1,3
20044_0,,,,2,2,1,3
C(CC(CC(C(C(C)O)O)=O)=O)=O,,,5,1,2,0,2
20044_1,,,,2,2,1,3
20046_0,,,,2,2,1,3
C(C(C(CC(CC=O)=O)=O)O)(O)=O,,,5,1,2,0,2
20046_1,,,,2,2,1,3
20047_0,,,,2,2,1,3
20047_1,,,,2,2,1,3
20049_0,,,,2,2,1,3
C(CC(CCC(C(CO)=O)=O)O)=O,,,5,1,1,0,1
20051_0,,,,2,2,1,3
C(CCC=O)(C(CO)(CC=O)O)=O,,,5,1,1,0,1
20053_0,,,,2,2,1,3
C(CO)(C(CCC=O)(CC=O)O)=O,,,5,1,2,0,2
20055_0,,,,2,2,1,3
C(C(C(C)O)CC(C(CO)=O)=O)=O,,,5,1,1,0,1
20057_0,,,,2,2,1,3
C(C(C=O)CC(C(CO)=O)=O)(O)=O,,,5,1,1,0,1
20059_0,,,,2,2,1,3
C(C(CO)CC(C(CO)=O)=O)=O,,,5,1,4,0,4
20061_0,,,,2,2,1,3
C(CCC(C(C(C(C)O)O)=O)=O)=O,,,5,1,2,0,2
20061_1,,,,2,2,1,3
20063_0,,,,2,2,1,3
C(C(C(C(CCC=O)=O)=O)O)(O)=O,,,5,1,2,0,2
20063_1,,,,2,2,1,3
20064_0,,,,2,2,1,3
20064_1,,,,2,2,1,3
20066_0,,,,2,2,1,3
C(CC(C(C(CO)=O)=O)C(C)O)=O,,,5,1,1,0,1
20068_0,,,,2,2,1,3
C(C(C(C(CO)=O)=O)CC=O)(O)=O,,,5,1,2,0,2
20069_0,,,,2,2,1,3
20071_0,,,,2,2,1,3
C(C(C=C)C(C)(CC(CO)=O)O)=O,,,5,1,1,0,1
20072_0,,,,2,2,1,3
20073_0,,,,2,2,1,3
20073_1,,,,2,2,1,3
20074_0,,,,2,2,1,3
20076_0,,,,2,2,1,3
C(C(CO)C(C)(CC(CO)=O)O)=O,,,5,1,3,0,3
20076_1,,,,2,2,1,3
20078_0,,,,2,2,1,3
C(C)(C(C(C)(CC(CO)=O)O)O)=O,,,5,1,2,0,2
20078_1,,,,2,2,1,3
20080_0,,,,2,2,1,3
C(CO)(CC(C)(CC(CO)=O)O)=O,,,5,1,1,0,1
20081_0,,,,2,2,1,3
20081_1,,,,2,2,1,3
20083_0,,,,2,2,1,3
C(C(C=C)C(CO)(CC(C)=O)O)=O,,,5,1,1,0,1
20085_0,,,,2,2,1,3
C(C)(CC(CO)(CC(C=O)=O)O)=O,,,5,1,1,0,1
20087_0,,,,2,2,1,3
C(C(C=O)C(CO)(CC(C)=O)O)=O,,,5,1,2,0,2
20087_1,,,,2,2,1,3
20089_0,,,,2,2,1,3
C(CC(CO)(CC(C)=O)O)=O,,,5,1,2,0,2
20091_0,,,,2,2,1,3
C(C(CO)C(CO)(CC(C)=O)O)=O,,,5,1,2,0,2
20091_1,,,,2,2,1,3
20093_0,,,,2,2,1,3
C(C)(CC(CO)(C(C(C)=O)O)O)=O,,,5,1,2,0,2
20093_1,,,,2,2,1,3
20095_0,,,,2,2,1,3
C(C)(CC(CO)(CC(CO)=O)O)=O,,,5,1,1,0,1
20097_0,,,,2,2,1,3
C(C(C(CO)(CC(C)=O)O)O)=O,,,5,1,3,0,3
20097_1,,,,2,2,1,3
20099_0,,,,2,2,1,3
C(CO)(CC(CC(C=CC)O)=O)=O,,,5,1,1,0,1
20101_0,,,,2,2,1,3
C(CC(CC=C)O)(CC(CO)=O)=O,,,5,1,1,0,1
20103_0,,,,2,2,1,3
C(CC(C=C)O)(CC(CO)=O)=O,,,5,1,1,0,1
20104_0,,,,2,2,1,3
20106_0,,,,2,2,1,3
C(C(CC(CC(CO)=O)=O)O)(O)=O,,,5,1,5,0,5
20108_0,,,,2,2,1,3
C(C(C)(CC(CC(CO)=O)=O)O)=O,,,5,1,1,0,1
20110_0,,,,2,2,1,3
C(CO)(CC(CC(C(C)=O)O)=O)=O,,,5,1,1,0,1
20111_0,,,,2,2,1,3
20113_0,,,,2,2,1,3
C(CC(C)O)(CC(CO)=O)=O,,,5,1,3,0,3
20115_0,,,,2,2,1,3
C(CC(CCO)O)(CC(CO)=O)=O,,,5,1,1,0,1
20117_0,,,,2,2,1,3
C(CC(CO)(C)O)(CC(CO)=O)=O,,,5,1,1,0,1
20118_0,,,,2,2,1,3
20120_0,,,,2,2,1,3
C(CC(C(O)O)O)(CC(CO)=O)=O,,,5,1,1,0,1
20122_0,,,,2,2,1,3
C(CC(C(C)O)O)(CC(CO)=O)=O,,,5,1,1,0,1
20124_0,,,,2,2,1,3
C(CCO)(CC(CO)=O)=O,,,5,1,6,0,6
20126_0,,,,2,2,1,3
C(CC(CO)O)(CC(CO)=O)=O,,,5,1,5,0,5
20128_0,,,,2,2,1,3
C(C)(C(C(CO)=O)C(C=CC)O)=O,,,5,1,2,0,2
20128_1,,,,2,2,1,3
20130_0,,,,2,2,1,3
C(C)(C(C(CO)=O)C(CC=C)O)=O,,,5,1,2,0,2
20130_1,,,,2,2,1,3
20132_0,,,,2,2,1,3
C(CO)(C(C(C)=O)C(C=C)O)=O,,,5,1,2,0,2
20132_1,,,,2,2,1,3
20134_0,,,,2,2,1,3
C(C(C(C(CO)=O)C(C)=O)O)=O,,,5,1,5,0,5
20134_1,,,,2,2,1,3
20136_0,,,,2,2,1,3
C(C(C(C(CO)=O)C(C)=O)O)(O)=O,,,5,1,2,0,2
20136_1,,,,2,2,1,3
20138_0,,,,2,2,1,3
C(C(C)(C(C(C)=O)C(CO)=O)O)=O,,,5,1,2,0,2
20138_1,,,,2,2,1,3
20140_0,,,,2,2,1,3
C(C)(C(C(CO)=O)C(C(C)=O)O)=O,,,5,1,2,0,2
20140_1,,,,2,2,1,3
20142_0,,,,2,2,1,3
C(CC(C(C(C)=O)C(CO)=O)O)=O,,,5,1,3,0,3
20142_1,,,,2,2,1,3
20144_0,,,,2,2,1,3
C(C)(C(C(CO)=O)C(C)O)=O,,,5,1,3,0,3
20144_1,,,,2,2,1,3
20146_0,,,,2,2,1,3
C(C)(C(C(CO)=O)C(CCO)O)=O,,,5,1,2,0,2
20146_1,,,,2,2,1,3
20148_0,,,,2,2,1,3
C(C)(C(C(CO)=O)C(CO)(C)O)=O,,,5,1,2,0,2
20148_1,,,,2,2,1,3
20150_0,,,,2,2,1,3
C(C(C(C)=O)C(CO)=O)(O)=O,,,5,1,7,0,7
20150_1,,,,2,2,1,3
20152_0,,,,2,2,1,3
C(C)(C(C(CO)=O)C(C(O)O)O)=O,,,5,1,2,0,2
20152_1,,,,2,2,1,3
20154_0,,,,2,2,1,3
C(C)(C(C(CO)=O)C(C(C)O)O)=O,,,5,1,2,0,2
20154_1,,,,2,2,1,3
20155_0,,,,2,2,1,3
20155_1,,,,2,2,1,3
20157_0,,,,2,2,1,3
C(C)(C(C(CO)=O)C(CO)O)=O,,,5,1,3,0,3
20157_1,,,,2,2,1,3
20159_0,,,,2,2,1,3
C(C)(CC(C(C(C=CC)O)O)=O)=O,,,5,1,2,0,2
20159_1,,,,2,2,1,3
20161_0,,,,2,2,1,3
C(C(C(CC=C)O)O)(CC(C)=O)=O,,,5,1,2,0,2
20161_1,,,,2,2,1,3
20163_0,,,,2,2,1,3
C(C(C(C=C)O)O)(CC(C)=O)=O,,,5,1,2,0,2
20163_1,,,,2,2,1,3
20164_0,,,,2,2,1,3
20164_1,,,,2,2,1,3
20166_0,,,,2,2,1,3
C(C(C(C(CC(C)=O)=O)O)O)(O)=O,,,5,1,5,0,5
20166_1,,,,2,2,1,3
20168_0,,,,2,2,1,3
C(C(C)(C(C(CC(C)=O)=O)O)O)=O,,,5,1,3,0,3
20168_1,,,,2,2,1,3
20169_0,,,,2,2,1,3
20169_1,,,,2,2,1,3
20171_0,,,,2,2,1,3
C(CC(C(C(CC(C)=O)=O)O)O)=O,,,5,1,3,0,3
20171_1,,,,2,2,1,3
20173_0,,,,2,2,1,3
C(C(C(C)O)O)(CC(C)=O)=O,,,5,1,4,0,4
20173_1,,,,2,2,1,3
20175_0,,,,2,2,1,3
C(C(C(CCO)O)O)(CC(C)=O)=O,,,5,1,2,0,2
20175_1,,,,2,2,1,3
20177_0,,,,2,2,1,3
C(C(C(CO)(C)O)O)(CC(C)=O)=O,,,5,1,2,0,2
20177_1,,,,2,2,1,3
20178_0,,,,2,2,1,3
20178_1,,,,2,2,1,3
20180_0,,,,2,2,1,3
C(C(C(C(O)O)O)O)(CC(C)=O)=O,,,5,1,2,0,2
20180_1,,,,2,2,1,3
20182_0,,,,2,2,1,3
C(C(C(C(C)O)O)O)(CC(C)=O)=O,,,5,1,2,0,2
20182_1,,,,2,2,1,3
20183_0,,,,2,2,1,3
20183_1,,,,2,2,1,3
20185_0,,,,2,2,1,3
C(C(C(CO)O)O)(CC(C)=O)=O,,,5,1,4,0,4
20185_1,,,,2,2,1,3
20187_0,,,,2,2,1,3
C(C(C=C)C(C(CC)=O)(CO)O)=O,,,5,1,1,0,1
20189_0,,,,2,2,1,3
C(C(CO)(CC(C=O)=O)O)(CC)=O,,,5,1,1,0,1
20191_0,,,,2,2,1,3
C(C(C=O)C(C(CC)=O)(CO)O)=O,,,5,1,2,0,2
20191_1,,,,2,2,1,3
20193_0,,,,2,2,1,3
C(C(CO)(CC=O)O)(CC)=O,,,5,1,2,0,2
20195_0,,,,2,2,1,3
C(C(CO)C(C(CC)=O)(CO)O)=O,,,5,1,2,0,2
20195_1,,,,2,2,1,3
20197_0,,,,2,2,1,3
C(C(CO)(C(C(C)=O)O)O)(CC)=O,,,5,1,2,0,2
20197_1,,,,2,2,1,3
20199_0,,,,2,2,1,3
C(C(CO)(CC(CO)=O)O)(CC)=O,,,5,1,1,0,1
20201_0,,,,2,2,1,3
C(C(CO)(C(C=O)O)O)(CC)=O,,,5,1,3,0,3
20201_1,,,,2,2,1,3
20203_0,,,,2,2,1,3
C(C(C=C)C(C(CO)=O)(CC)O)=O,,,5,1,1,0,1
20205_0,,,,2,2,1,3
C(CO)(C(CC)(CC(C=O)=O)O)=O,,,5,1,1,0,1
20207_0,,,,2,2,1,3
C(C(C=O)C(C(CO)=O)(CC)O)=O,,,5,1,2,0,2
20207_1,,,,2,2,1,3
20209_0,,,,2,2,1,3
C(CO)(C(CC)(CC=O)O)=O,,,5,1,1,0,1
20211_0,,,,2,2,1,3
C(C(CO)C(C(CO)=O)(CC)O)=O,,,5,1,2,0,2
20211_1,,,,2,2,1,3
20213_0,,,,2,2,1,3
C(CO)(C(CC)(C(C(C)=O)O)O)=O,,,5,1,2,0,2
20213_1,,,,2,2,1,3
20215_0,,,,2,2,1,3
C(CO)(C(CC)(CC(CO)=O)O)=O,,,5,1,1,0,1
20217_0,,,,2,2,1,3
C(CO)(C(CC)(C(C=O)O)O)=O,,,5,1,2,0,2
20217_1,,,,2,2,1,3
20219_0,,,,2,2,1,3
C(C)=CC(C(C(C(CC)=O)=O)O)O,,,5,1,2,0,2
20219_1,,,,2,2,1,3
20221_0,,,,2,2,1,3
C(CC(C(C(C(CC)=O)=O)O)O)=C,,,5,1,2,0,2
20221_1,,,,2,2,1,3
20223_0,,,,2,2,1,3
C=CC(C(C(C(CC)=O)=O)O)O,,,5,1,2,0,2
20223_1,,,,2,2,1,3
20225_0,,,,2,2,1,3
C(C(C(C(C(CC)=O)=O)O)O)=O,,,5,1,5,0,5
20225_1,,,,2,2,1,3
20227_0,,,,2,2,1,3
C(C(C(C(C(CC)=O)=O)O)O)(O)=O,,,5,1,3,0,3
20227_1,,,,2,2,1,3
20229_0,,,,2,2,1,3
C(C(C)(C(C(C(CC)=O)=O)O)O)=O,,,5,1,3,0,3
20229_1,,,,2,2,1,3
20231_0,,,,2,2,1,3
C(C(C(C(C(CC)=O)=O)O)O)(C)=O,,,5,1,4,0,4
20231_1,,,,2,2,1,3
20233_0,,,,2,2,1,3
C(CC(C(C(C(CC)=O)=O)O)O)=O,,,5,1,2,0,2
20233_1,,,,2,2,1,3
20235_0,,,,2,2,1,3
C(C(C(C(C)O)O)=O)(CC)=O,,,5,1,3,0,3
20235_1,,,,2,2,1,3
20237_0,,,,2,2,1,3
C(C(C(C(CCO)O)O)=O)(CC)=O,,,5,1,2,0,2
20237_1,,,,2,2,1,3
20239_0,,,,2,2,1,3
C(C(C(C(CO)(C)O)O)=O)(CC)=O,,,5,1,2,0,2
20239_1,,,,2,2,1,3
20241_0,,,,2,2,1,3
C(C(C(C(CC)=O)=O)O)(O)=O,,,5,1,3,0,3
20241_1,,,,2,2,1,3
20243_0,,,,2,2,1,3
C(C(C(C(C(O)O)O)O)=O)(CC)=O,,,5,1,2,0,2
20243_1,,,,2,2,1,3
20245_0,,,,2,2,1,3
C(C(C(C(C(C)O)O)O)=O)(CC)=O,,,5,1,2,0,2
20245_1,,,,2,2,1,3
20246_0,,,,2,2,1,3
20246_1,,,,2,2,1,3
20248_0,,,,2,2,1,3
C(C(C(C(CO)O)O)=O)(CC)=O,,,5,1,3,0,3
20248_1,,,,2,2,1,3
20250_0,,,,2,2,1,3
C(C)=CC(C(C(C(CO)=O)=O)C)O,,,5,1,1,0,1
20252_0,,,,2,2,1,3
C(CC(C(C(C(CO)=O)=O)C)O)=C,,,5,1,1,0,1
20254_0,,,,2,2,1,3
C=CC(C(C(C(CO)=O)=O)C)O,,,5,1,1,0,1
20255_0,,,,2,2,1,3
20257_0,,,,2,2,1,3
C(C(C(C(C(CO)=O)=O)C)O)(O)=O,,,5,1,3,0,3
20259_0,,,,2,2,1,3
C(C(C)(C(C(C(CO)=O)=O)C)O)=O,,,5,1,1,0,1
20261_0,,,,2,2,1,3
C(C(C(C(C(CO)=O)=O)C)O)(C)=O,,,5,1,1,0,1
20262_0,,,,2,2,1,3
20264_0,,,,2,2,1,3
C(C(CO)=O)(C(C)C(C)O)=O,,,5,1,1,0,1
20266_0,,,,2,2,1,3
C(C(CO)=O)(C(C)C(CCO)O)=O,,,5,1,1,0,1
20268_0,,,,2,2,1,3
C(C(CO)=O)(C(C)C(CO)(C)O)=O,,,5,1,1,0,1
20269_0,,,,2,2,1,3
20271_0,,,,2,2,1,3
C(C(CO)=O)(C(C)C(C(O)O)O)=O,,,5,1,1,0,1
20273_0,,,,2,2,1,3
C(C(CO)=O)(C(C)C(C(C)O)O)=O,,,5,1,1,0,1
20275_0,,,,2,2,1,3
C(C(CO)=O)(C(CO)C)=O,,,5,1,3,0,3
20277_0,,,,2,2,1,3
C(C(CO)=O)(C(C)C(CO)O)=O,,,5,1,3,0,3
20279_0,,,,2,2,1,3
C(C(C(C(C(CO)O)=O)=O)CO)=O,,,5,1,5,0,5
20279_1,,,,2,2,1,3
20281_0,,,,2,2,1,3
C(CO)(CC(C(C(CO)O)=O)=O)=O,,,5,1,3,0,3
20281_1,,,,2,2,1,3
20283_0,,,,2,2,1,3
C(CO)(C(C(C(CO)=O)=O)CO)=O,,,5,1,2,0,2
20283_1,,,,2,2,1,3
20285_0,,,,2,2,1,3
C(C(CO)O)(CC(C(CO)=O)=O)=O,,,5,1,5,0,5
20285_1,,,,2,2,1,3
20286_0,,,,2,2,1,3
20287_0,,,,2,2,1,3
20287_1,,,,2,2,1,3
20289_0,,,,2,2,1,3
C(C(CO)(CC=O)O)(CC=O)=O,,,5,1,6,0,6
20290_0,,,,2,2,1,3
20290_1,,,,2,2,1,3
20292_0,,,,2,2,1,3
C(CC(C(CO)=O)(CC=O)O)=O,,,5,1,2,0,2
20293_0,,,,2,2,1,3
20293_1,,,,2,2,1,3
20295_0,,,,2,2,1,3
C(C(C(C(CO)=O)=O)C(C=C)O)=O,,,5,1,2,0,2
20295_1,,,,2,2,1,3
20297_0,,,,2,2,1,3
C(C(C(C(CO)=O)=O)C(C=O)O)=O,,,5,1,2,0,2
20297_1,,,,2,2,1,3
20299_0,,,,2,2,1,3
C(C(C(C(CO)=O)=O)C(C)O)=O,,,5,1,4,0,4
20299_1,,,,2,2,1,3
20301_0,,,,2,2,1,3
C(C(C=O)C(C(CO)=O)=O)(O)=O,,,5,1,4,0,4
20301_1,,,,2,2,1,3
20302_0,,,,2,2,1,3
20302_1,,,,2,2,1,3
20304_0,,,,2,2,1,3
C(C(C(C(CO)=O)=O)C(CO)O)=O,,,5,1,4,0,4
20304_1,,,,2,2,1,3
20306_0,,,,2,2,1,3
C(CC(C(C(C(C=C)O)O)=O)=O)=O,,,5,1,2,0,2
20306_1,,,,2,2,1,3
20308_0,,,,2,2,1,3
C(CC(C(C(C(C=O)O)O)=O)=O)=O,,,5,1,4,0,4
20308_1,,,,2,2,1,3
20310_0,,,,2,2,1,3
C(CC(C(C(C(C)O)O)=O)=O)=O,,,5,1,6,0,6
20310_1,,,,2,2,1,3
20312_0,,,,2,2,1,3
C(C(C(C(CC=O)=O)=O)O)(O)=O,,,5,1,5,0,5
20312_1,,,,2,2,1,3
20313_0,,,,2,2,1,3
20313_1,,,,2,2,1,3
20315_0,,,,2,2,1,3
C(CC(C(C(C(CO)O)O)=O)=O)=O,,,5,1,4,0,4
20315_1,,,,2,2,1,3
20317_0,,,,2,2,1,3
C(C(CC(CC=O)O)C(CO)O)=O,,,5,1,2,0,2
20319_0,,,,2,2,1,3
C(CC(C(C(CO)O)CC=O)O)=O,,,5,1,3,0,3
20321_0,,,,2,2,1,3
C(C(C(CO)O)C(C=O)C(C)O)=O,,,5,1,5,0,5
20323_0,,,,2,2,1,3
C(C(C=O)C(C=O)C(CO)O)(O)=O,,,5,1,3,0,3
20324_0,,,,2,2,1,3
20326_0,,,,2,2,1,3
C(CC(CC(C(CO)=O)CO)O)=O,,,5,1,1,0,1
20328_0,,,,2,2,1,3
C(CC(CO)(C(CO)CC=O)O)=O,,,5,1,3,0,3
20330_0,,,,2,2,1,3
C(C(C(C)O)C(C(CO)=O)CO)=O,,,5,1,1,0,1
20332_0,,,,2,2,1,3
C(C(C=O)C(C(CO)=O)CO)(O)=O,,,5,1,2,0,2
20334_0,,,,2,2,1,3
C(C(CO)C(C(CO)=O)CO)=O,,,5,1,7,0,7
20336_0,,,,2,2,1,3
C(C(CO)CC=O)(C(C(C)O)O)=O,,,5,1,2,0,2
20336_1,,,,2,2,1,3
20338_0,,,,2,2,1,3
C(C(CO)CC=O)(C(C(O)=O)O)=O,,,5,1,5,0,5
20338_1,,,,2,2,1,3
20340_0,,,,2,2,1,3
C(C(CO)CC=O)(C(CO)O)=O,,,5,1,6,0,6
20340_1,,,,2,2,1,3
20341_0,,,,2,2,1,3
20343_0,,,,2,2,1,3
C(CC(C(CO)O)(CC(C)=O)O)=O,,,5,1,1,0,1
20345_0,,,,2,2,1,3
C(CC(C)O)(CC(C(CO)O)=O)=O,,,5,1,1,0,1
20347_0,,,,2,2,1,3
C(CC(CC(C(CO)O)=O)=O)(O)=O,,,5,1,4,0,4
20349_0,,,,2,2,1,3
C(CCO)(CC(C(CO)O)=O)=O,,,5,1,6,0,6
20351_0,,,,2,2,1,3
C(C(CO)O)(C(C(C)=O)C(C)O)=O,,,5,1,2,0,2
20351_1,,,,2,2,1,3
20353_0,,,,2,2,1,3
C(C(CO)O)(C(C(O)=O)C(C)=O)=O,,,5,1,3,0,3
20353_1,,,,2,2,1,3
20355_0,,,,2,2,1,3
C(C(CO)O)(C(C(C)=O)CO)=O,,,5,1,7,0,7
20355_1,,,,2,2,1,3
20357_0,,,,2,2,1,3
C(C(C(CO)O)(CC=O)O)(CC)=O,,,5,1,1,0,1
20359_0,,,,2,2,1,3
C(C(CC)(CC=O)O)(C(CO)O)=O,,,5,1,1,0,1
20361_0,,,,2,2,1,3
C(C(C(CO)O)=O)(C(C)C(C)O)=O,,,5,1,1,0,1
20363_0,,,,2,2,1,3
C(C(C(C(C(CO)O)=O)=O)C)(O)=O,,,5,1,4,0,4
20365_0,,,,2,2,1,3
C(C(C(CO)O)=O)(C(CO)C)=O,,,5,1,3,0,3
20366_0,,,,2,2,1,3
20366_1,,,,2,2,1,3
20368_0,,,,2,2,1,3
C(C(C(C(CC(O)=O)=O)=O)CO)=O,,,5,1,4,0,4
20368_1,,,,2,2,1,3
20370_0,,,,2,2,1,3
C(C(C(C(CC=O)=O)=O)CO)(O)=O,,,5,1,5,0,5
20370_1,,,,2,2,1,3
20372_0,,,,2,2,1,3
C(C(C(CC(C(O)=O)=O)=O)CO)=O,,,5,1,2,0,2
20372_1,,,,2,2,1,3
20374_0,,,,2,2,1,3
C(CC=O)(C(C(C(O)=O)=O)CO)=O,,,5,1,3,0,3
20374_1,,,,2,2,1,3
20375_0,,,,2,2,1,3
20377_0,,,,2,2,1,3
C(CC(C(CC(C(O)=O)=O)=O)O)=O,,,5,1,4,0,4
20378_0,,,,2,2,1,3
20380_0,,,,2,2,1,3
C(C(C(C(C=O)=O)C(C)O)=O)(O)=O,,,5,1,3,0,3
20380_1,,,,2,2,1,3
20382_0,,,,2,2,1,3
C(C(C(C=O)=O)C(C(O)=O)=O)(O)=O,,,5,1,3,0,3
20382_1,,,,2,2,1,3
20383_0,,,,2,2,1,3
20383_1,,,,2,2,1,3
20385_0,,,,2,2,1,3
C(CC(CC=O)O)(C(CO)CO)=O,,,5,1,1,0,1
20387_0,,,,2,2,1,3
C(CC(C(CO)CO)(CC=O)O)=O,,,5,1,1,0,1
20389_0,,,,2,2,1,3
C(C(C(C(CO)CO)=O)C(C)O)=O,,,5,1,2,0,2
20389_1,,,,2,2,1,3
20391_0,,,,2,2,1,3
C(C(C=O)C(C(CO)CO)=O)(O)=O,,,5,1,3,0,3
20391_1,,,,2,2,1,3
20393_0,,,,2,2,1,3
C(C(C(C(CO)CO)=O)CO)=O,,,5,1,4,0,4
20393_1,,,,2,2,1,3
20395_0,,,,2,2,1,3
C(C(CO)CC(C(C(O)=O)O)=O)=O,,,5,1,3,0,3
20396_0,,,,2,2,1,3
20398_0,,,,2,2,1,3
C(CC(C(O)=O)O)(C(C=O)CO)=O,,,5,1,6,0,6
20398_1,,,,2,2,1,3
20400_0,,,,2,2,1,3
C(C(CO)C(C(O)=O)O)(CC=O)=O,,,5,1,8,0,8
20400_1,,,,2,2,1,3
20402_0,,,,2,2,1,3
C(C(C(C(C(C=O)CO)=O)=O)C)=O,,,5,1,2,0,2
20402_1,,,,2,2,1,3
20404_0,,,,2,2,1,3
C(C(C(C(C=O)(CC=O)O)=O)C)=O,,,5,1,1,0,1
20406_0,,,,2,2,1,3
C(CC(C(C(C(C=O)C)=O)=O)O)=O,,,5,1,1,0,1
20408_0,,,,2,2,1,3
C(CC(C(C=O)=O)(C(C=O)C)O)=O,,,5,1,1,0,1
20410_0,,,,2,2,1,3
C(CC(C(C(C(C=O)=O)=O)C)O)=O,,,5,1,2,0,2
20412_0,,,,2,2,1,3
C(C(C)C(C=O)(C(C=O)C=C)O)=O,,,5,1,1,0,1
20414_0,,,,2,2,1,3
C(C(C)C(C=O)(C1C(C=CO1)=O)O)=O,,,5,1,2,0,2
20414_1,,,,2,2,1,3
20416_0,,,,2,2,1,3
C(C(C)C(C=O)(CC(C=O)=O)O)=O,,,5,1,1,0,1
20418_0,,,,2,2,1,3
C(C(C)C(C=O)(C(C=O)C=O)O)=O,,,5,1,2,0,2
20418_1,,,,2,2,1,3
20420_0,,,,2,2,1,3
C(CC(C=O)(C(C=O)C)O)=O,,,5,1,2,0,2
20422_0,,,,2,2,1,3
C(C(CO)C(C=O)(C(C=O)C)O)=O,,,5,1,2,0,2
20422_1,,,,2,2,1,3
20424_0,,,,2,2,1,3
C(C(C(C=O)(C(C=O)C)O)O)(C)=O,,,5,1,2,0,2
20424_1,,,,2,2,1,3
20426_0,,,,2,2,1,3
C(CC(C=O)(C(C=O)C)O)(CO)=O,,,5,1,1,0,1
20428_0,,,,2,2,1,3
C(C(C(C=O)(C(C=O)C)O)O)=O,,,5,1,4,0,4
20428_1,,,,2,2,1,3
20430_0,,,,2,2,1,3
C(C(C(C(C(C=O)C=C)O)=O)C)=O,,,5,1,1,0,1
20432_0,,,,2,2,1,3
C(C(C1C(C=CO1)=O)O)(C(C=O)C)=O,,,5,1,2,0,2
20432_1,,,,2,2,1,3
20434_0,,,,2,2,1,3
C(C(C(C(CC(C=O)=O)O)=O)C)=O,,,5,1,1,0,1
20436_0,,,,2,2,1,3
C(C(C(C(C(C=O)C=O)O)=O)C)=O,,,5,1,2,0,2
20436_1,,,,2,2,1,3
20438_0,,,,2,2,1,3
C(CC(C(C(C=O)C)=O)O)=O,,,5,1,2,0,2
20440_0,,,,2,2,1,3
C(C(CO)C(C(C(C=O)C)=O)O)=O,,,5,1,2,0,2
20440_1,,,,2,2,1,3
20442_0,,,,2,2,1,3
C(C(C(C(C(C(C)=O)O)O)=O)C)=O,,,5,1,2,0,2
20442_1,,,,2,2,1,3
20444_0,,,,2,2,1,3
C(CC(C(C(C=O)C)=O)O)(CO)=O,,,5,1,1,0,1
20446_0,,,,2,2,1,3
C(C(C(C(C(C=O)O)O)=O)C)=O,,,5,1,4,0,4
20446_1,,,,2,2,1,3
20448_0,,,,2,2,1,3
C(C(C=C)C(C(C(C=O)=O)C)O)=O,,,5,1,2,0,2
20450_0,,,,2,2,1,3
C1OC(C(C=1)=O)C(C(C(C=O)=O)C)O,,,5,1,2,0,2
20450_1,,,,2,2,1,3
20452_0,,,,2,2,1,3
C(C=O)(C(C)C(CC(C=O)=O)O)=O,,,5,1,2,0,2
20453_0,,,,2,2,1,3
20453_1,,,,2,2,1,3
20455_0,,,,2,2,1,3
C(CC(C(C(C=O)=O)C)O)=O,,,5,1,3,0,3
20457_0,,,,2,2,1,3
C(C(CO)C(C(C(C=O)=O)C)O)=O,,,5,1,3,0,3
20457_1,,,,2,2,1,3
20459_0,,,,2,2,1,3
C(C)(C(C(C(C(C=O)=O)C)O)O)=O,,,5,1,3,0,3
20459_1,,,,2,2,1,3
20461_0,,,,2,2,1,3
C(CO)(CC(C(C(C=O)=O)C)O)=O,,,5,1,2,0,2
20463_0,,,,2,2,1,3
C(C(C(C(C(C=O)=O)C)O)O)=O,,,5,1,7,0,7
20463_1,,,,2,2,1,3
20465_0,,,,2,2,1,3
C(C(C(C(CC(C)=O)=O)=O)CO)=O,,,5,1,2,0,2
20465_1,,,,2,2,1,3
20467_0,,,,2,2,1,3
C(CC(C(C(C(C)=O)CO)=O)=O)=O,,,5,1,2,0,2
20467_1,,,,2,2,1,3
20469_0,,,,2,2,1,3
C(CC(C(CC(CCO)=O)=O)=O)=O,,,5,1,1,0,1
20471_0,,,,2,2,1,3
C(C(C(CC(C(C)=O)=O)=O)CO)=O,,,5,1,2,0,2
20471_1,,,,2,2,1,3
20473_0,,,,2,2,1,3
C(CC=O)(C(C(C(C)=O)=O)CO)=O,,,5,1,2,0,2
20473_1,,,,2,2,1,3
20475_0,,,,2,2,1,3
C(CC=O)(CC(C(CCO)=O)=O)=O,,,5,1,1,0,1
20477_0,,,,2,2,1,3
C(C(C(CC(C)=O)=O)(CC=O)O)=O,,,5,1,1,0,1
20479_0,,,,2,2,1,3
C(CC(C(C(CC(C)=O)=O)=O)O)=O,,,5,1,1,0,1
20481_0,,,,2,2,1,3
C(CC(C(C=O)=O)(CC(C)=O)O)=O,,,5,1,1,0,1
20482_0,,,,2,2,1,3
20484_0,,,,2,2,1,3
C(C)(C(C(C(C=O)=O)=O)C(C=C)O)=O,,,5,1,2,0,2
20484_1,,,,2,2,1,3
20486_0,,,,2,2,1,3
C(C)(C(C(C(C=O)=O)=O)C(C)O)=O,,,5,1,2,0,2
20486_1,,,,2,2,1,3
20488_0,,,,2,2,1,3
C(C(C(C)=O)C(C(C=O)=O)=O)(O)=O,,,5,1,2,0,2
20488_1,,,,2,2,1,3
20490_0,,,,2,2,1,3
C(C)(C(C(C(C=O)=O)=O)CO)=O,,,5,1,3,0,3
20490_1,,,,2,2,1,3
20492_0,,,,2,2,1,3
C(CC(C=C)O)(CC(C(C=O)=O)=O)=O,,,5,1,1,0,1
20494_0,,,,2,2,1,3
C(CC(C)O)(CC(C(C=O)=O)=O)=O,,,5,1,1,0,1
20496_0,,,,2,2,1,3
C(CC(CC(C(C=O)=O)=O)=O)(O)=O,,,5,1,1,0,1
20497_0,,,,2,2,1,3
20499_0,,,,2,2,1,3
C(CC(C=O)(CC(C(C)=O)=O)O)=O,,,5,1,2,0,2
20501_0,,,,2,2,1,3
C(CC(C(CC(C(C)=O)=O)=O)O)=O,,,5,1,1,0,1
20503_0,,,,2,2,1,3
C(C(C)(CC=O)O)(CC(C=O)=O)=O,,,5,1,1,0,1
20505_0,,,,2,2,1,3
C(CC(C(C)=O)(CC(C=O)=O)O)=O,,,5,1,2,0,2
20507_0,,,,2,2,1,3
C=CC(C(C(C=O)=O)C(C(C)=O)=O)O,,,5,1,2,0,2
20507_1,,,,2,2,1,3
20509_0,,,,2,2,1,3
C(C(C(C(C(C)=O)=O)C(C)O)=O)=O,,,5,1,2,0,2
20509_1,,,,2,2,1,3
20511_0,,,,2,2,1,3
C(C(C(C=O)=O)C(C(C)=O)=O)(O)=O,,,5,1,2,0,2
20511_1,,,,2,2,1,3
20512_0,,,,2,2,1,3
20512_1,,,,2,2,1,3
20514_0,,,,2,2,1,3
C=CC(CC(C(CC(C=O)=O)=O)=O)O,,,5,1,1,0,1
20516_0,,,,2,2,1,3
C(C(CC(C(CC(C)O)=O)=O)=O)=O,,,5,1,1,0,1
20518_0,,,,2,2,1,3
C(CC(C(CC(C=O)=O)=O)=O)(O)=O,,,5,1,1,0,1
20519_0,,,,2,2,1,3
20521_0,,,,2,2,1,3
C(C(C=C)C(CC(C(C)=O)=O)O)=O,,,5,1,2,0,2
20523_0,,,,2,2,1,3
C1OC(C(C=1)=O)C(CC(C(C)=O)=O)O,,,5,1,2,0,2
20523_1,,,,2,2,1,3
20525_0,,,,2,2,1,3
C(C=O)(CC(CC(C(C)=O)=O)O)=O,,,5,1,2,0,2
20526_0,,,,2,2,1,3
20526_1,,,,2,2,1,3
20528_0,,,,2,2,1,3
C(CC(CC(C(C)=O)=O)O)=O,,,5,1,4,0,4
20530_0,,,,2,2,1,3
C(C(CO)C(CC(C(C)=O)=O)O)=O,,,5,1,3,0,3
20530_1,,,,2,2,1,3
20532_0,,,,2,2,1,3
C(C)(C(C(CC(C(C)=O)=O)O)O)=O,,,5,1,3,0,3
20532_1,,,,2,2,1,3
20534_0,,,,2,2,1,3
C(CO)(CC(CC(C(C)=O)=O)O)=O,,,5,1,2,0,2
20536_0,,,,2,2,1,3
C(C(C(CC(C(C)=O)=O)O)O)=O,,,5,1,9,0,9
20536_1,,,,2,2,1,3
20538_0,,,,2,2,1,3
C(CC(C(C)(C(C=O)C=C)O)=O)=O,,,5,1,1,0,1
20540_0,,,,2,2,1,3
C(C(C)(C1C(C=CO1)=O)O)(CC=O)=O,,,5,1,2,0,2
20540_1,,,,2,2,1,3
20542_0,,,,2,2,1,3
C(C(C)(CC(C=O)=O)O)(CC=O)=O,,,5,1,1,0,1
20544_0,,,,2,2,1,3
C(CC(C(C)(C(C=O)C=O)O)=O)=O,,,5,1,2,0,2
20544_1,,,,2,2,1,3
20546_0,,,,2,2,1,3
C(C(C)(CC=O)O)(CC=O)=O,,,5,1,2,0,2
20548_0,,,,2,2,1,3
C(C(CO)C(C(CC=O)=O)(C)O)=O,,,5,1,2,0,2
20548_1,,,,2,2,1,3
20550_0,,,,2,2,1,3
C(C(C)(C(C(C)=O)O)O)(CC=O)=O,,,5,1,3,0,3
20550_1,,,,2,2,1,3
20552_0,,,,2,2,1,3
C(C(C)(CC(CO)=O)O)(CC=O)=O,,,5,1,1,0,1
20554_0,,,,2,2,1,3
C(C(C)(C(C=O)O)O)(CC=O)=O,,,5,1,5,0,5
20554_1,,,,2,2,1,3
20556_0,,,,2,2,1,3
C(C(C=C)C(C(C)=O)(CC=O)O)=O,,,5,1,1,0,1
20558_0,,,,2,2,1,3
C(CC(C(C)=O)(C1C(C=CO1)=O)O)=O,,,5,1,2,0,2
20558_1,,,,2,2,1,3
20559_0,,,,2,2,1,3
20561_0,,,,2,2,1,3
C(C(C=O)C(C(C)=O)(CC=O)O)=O,,,5,1,2,0,2
20561_1,,,,2,2,1,3
20563_0,,,,2,2,1,3
C(CC(C(C)=O)(CC=O)O)=O,,,5,1,3,0,3
20565_0,,,,2,2,1,3
C(CC(C(C)=O)(C(C=O)CO)O)=O,,,5,1,3,0,3
20565_1,,,,2,2,1,3
20566_0,,,,2,2,1,3
20566_1,,,,2,2,1,3
20567_0,,,,2,2,1,3
20568_0,,,,2,2,1,3
20568_1,,,,2,2,1,3
20570_0,,,,2,2,1,3
C(C(C(C(C)=O)=O)C(C(C=O)=C)O)=O,,,5,1,2,0,2
20570_1,,,,2,2,1,3
20572_0,,,,2,2,1,3
C(C(C(C(C)=O)=O)C(C=CC)O)=O,,,5,1,2,0,2
20572_1,,,,2,2,1,3
20574_0,,,,2,2,1,3
C(C(C(C(C)=O)=O)C(CC=C)O)=O,,,5,1,2,0,2
20574_1,,,,2,2,1,3
20576_0,,,,2,2,1,3
C(C(C(C(C)=O)=O)C(C=C)O)=O,,,5,1,2,0,2
20576_1,,,,2,2,1,3
20578_0,,,,2,2,1,3
C(C(C(C(C)=O)=O)C1(C=COC1)O)=O,,,5,1,2,0,2
20578_1,,,,2,2,1,3
20579_0,,,,2,2,1,3
20579_1,,,,2,2,1,3
20581_0,,,,2,2,1,3
C(C(C(C(C)=O)=O)C(C(O)=O)O)=O,,,5,1,4,0,4
20581_1,,,,2,2,1,3
20583_0,,,,2,2,1,3
C(C(C)(C(C=O)C(C(C)=O)=O)O)=O,,,5,1,2,0,2
20583_1,,,,2,2,1,3
20585_0,,,,2,2,1,3
C(C(C(C(C)=O)=O)C(C(C)=O)O)=O,,,5,1,2,0,2
20585_1,,,,2,2,1,3
20587_0,,,,2,2,1,3
C(CC(C(C=O)C(C(C)=O)=O)O)=O,,,5,1,2,0,2
20587_1,,,,2,2,1,3
20589_0,,,,2,2,1,3
C(C(C(C(C)=O)=O)C(C)O)=O,,,5,1,5,0,5
20589_1,,,,2,2,1,3
20591_0,,,,2,2,1,3
C(C(C(C(C)=O)=O)C(CCO)O)=O,,,5,1,2,0,2
20591_1,,,,2,2,1,3
20593_0,,,,2,2,1,3
C(C(C(C(C)=O)=O)C(C)(CO)O)=O,,,5,1,2,0,2
20593_1,,,,2,2,1,3
20595_0,,,,2,2,1,3
C(C(C(C(C)=O)=O)C(C=O)(C=C)O)=O,,,5,1,2,0,2
20595_1,,,,2,2,1,3
20597_0,,,,2,2,1,3
C(C(C(C(C)=O)=O)C(C(C=C)=O)O)=O,,,5,1,2,0,2
20597_1,,,,2,2,1,3
20599_0,,,,2,2,1,3
C(C(C(C(C)=O)=O)C(C=CC=O)O)=O,,,5,1,2,0,2
20599_1,,,,2,2,1,3
20601_0,,,,2,2,1,3
C(C(C(O)=O)C(C(C)=O)=O)=O,,,5,1,5,0,5
20601_1,,,,2,2,1,3
20603_0,,,,2,2,1,3
C(C(C(C(C)=O)=O)C(C(O)O)O)=O,,,5,1,2,0,2
20603_1,,,,2,2,1,3
20605_0,,,,2,2,1,3
C(C(C(C(C)=O)=O)C(C(C)O)O)=O,,,5,1,2,0,2
20605_1,,,,2,2,1,3
20606_0,,,,2,2,1,3
20606_1,,,,2,2,1,3
20607_0,,,,2,2,1,3
20607_1,,,,2,2,1,3
20609_0,,,,2,2,1,3
C(CC(C(CC(C(C=O)=C)O)=O)=O)=O,,,5,1,1,0,1
20611_0,,,,2,2,1,3
C(CC(C(CC(C=CC)O)=O)=O)=O,,,5,1,1,0,1
20613_0,,,,2,2,1,3
C(CC(C(CC(CC=C)O)=O)=O)=O,,,5,1,1,0,1
20615_0,,,,2,2,1,3
C(CC(C(CC(C=C)O)=O)=O)=O,,,5,1,1,0,1
20617_0,,,,2,2,1,3
C(CC(C(CC1(C=COC1)O)=O)=O)=O,,,5,1,1,0,1
20619_0,,,,2,2,1,3
C(CC(C(CC(C=O)O)=O)=O)=O,,,5,1,4,0,4
20621_0,,,,2,2,1,3
C(CC(C(CC(C(O)=O)O)=O)=O)=O,,,5,1,1,0,1
20623_0,,,,2,2,1,3
C(C(C)(CC(C(CC=O)=O)=O)O)=O,,,5,1,1,0,1
20625_0,,,,2,2,1,3
C(CC(C(CC(C(C)=O)O)=O)=O)=O,,,5,1,1,0,1
20627_0,,,,2,2,1,3
C(CC(C(CC(CC=O)O)=O)=O)=O,,,5,1,2,0,2
20629_0,,,,2,2,1,3
C(CC(C(CC(C)O)=O)=O)=O,,,5,1,3,0,3
20631_0,,,,2,2,1,3
C(CC(C(CC(CCO)O)=O)=O)=O,,,5,1,1,0,1
20633_0,,,,2,2,1,3
C(CC(C(CC(C)(CO)O)=O)=O)=O,,,5,1,1,0,1
20635_0,,,,2,2,1,3
C(C(C=C)(CC(C(CC=O)=O)=O)O)=O,,,5,1,1,0,1
20637_0,,,,2,2,1,3
C(CC(C(CC(C(C=C)=O)O)=O)=O)=O,,,5,1,1,0,1
20639_0,,,,2,2,1,3
C(CC(C(CC(C=CC=O)O)=O)=O)=O,,,5,1,1,0,1
20640_0,,,,2,2,1,3
20642_0,,,,2,2,1,3
C(CC(C(CC(C(O)O)O)=O)=O)=O,,,5,1,1,0,1
20644_0,,,,2,2,1,3
C(CC(C(CC(C(C)O)O)=O)=O)=O,,,5,1,1,0,1
20645_0,,,,2,2,1,3
20646_0,,,,2,2,1,3
20648_0,,,,2,2,1,3
C(C(CO)CC(C=O)=O)(CC=O)=O,,,5,1,1,0,1
20650_0,,,,2,2,1,3
C(C(C(CCC(C=O)=O)=O)CO)=O,,,5,1,2,0,2
20650_1,,,,2,2,1,3
20652_0,,,,2,2,1,3
C(CC(CC(C(C=O)=O)CO)=O)=O,,,5,1,1,0,1
20654_0,,,,2,2,1,3
C(C(CO)CC=O)(CC(C=O)=O)=O,,,5,1,1,0,1
20656_0,,,,2,2,1,3
C(CCC(C(C(C=O)=O)CO)=O)=O,,,5,1,2,0,2
20656_1,,,,2,2,1,3
20658_0,,,,2,2,1,3
C(C(CO)CC(CC(C=O)=O)=O)=O,,,5,1,1,0,1
20660_0,,,,2,2,1,3
C(C(CO)C(C=O)CC(C=O)=O)=O,,,5,1,3,0,3
20661_0,,,,2,2,1,3
20663_0,,,,2,2,1,3
C(C(C(CO)CC(C=O)=O)=O)(C)=O,,,5,1,1,0,1
20665_0,,,,2,2,1,3
C(C(CCC(C=O)=O)=O)(CCO)=O,,,5,1,2,0,2
20667_0,,,,2,2,1,3
C(C(CC(C(C=O)=O)CO)=O)(C)=O,,,5,1,1,0,1
20669_0,,,,2,2,1,3
C(CC(C=O)=O)(C(C(C)=O)CO)=O,,,5,1,2,0,2
20669_1,,,,2,2,1,3
20671_0,,,,2,2,1,3
C(CC(C)=O)(C(C(C=O)=O)CO)=O,,,5,1,2,0,2
20671_1,,,,2,2,1,3
20673_0,,,,2,2,1,3
C(CC(CCO)=O)(CC(C=O)=O)=O,,,5,1,1,0,1
20675_0,,,,2,2,1,3
C(C(C(C)C(C(C=O)=O)CO)=O)=O,,,5,1,1,0,1
20677_0,,,,2,2,1,3
C(CC(C(C=O)CC(C=O)=O)O)=O,,,5,1,3,0,3
20679_0,,,,2,2,1,3
C(C(CC(C=O)C=O)(CC=O)O)=O,,,5,1,2,0,2
20681_0,,,,2,2,1,3
C(C(C=O)CC(C(CC=O)O)=O)=O,,,5,1,1,0,1
20683_0,,,,2,2,1,3
C(C(C=O)C(C(C=O)=O)C(C=C)O)=O,,,5,1,1,0,1
20685_0,,,,2,2,1,3
C(C(C=O)C(C(C=O)=O)C(C)O)=O,,,5,1,1,0,1
20687_0,,,,2,2,1,3
C(C(C=O)C(C(O)=O)C(C=O)=O)=O,,,5,1,1,0,1
20688_0,,,,2,2,1,3
20689_0,,,,2,2,1,3
20691_0,,,,2,2,1,3
C(CO)(CCC(C=O)(CC=O)O)=O,,,5,1,3,0,3
20693_0,,,,2,2,1,3
C(CC(C(CCC(CO)=O)=O)O)=O,,,5,1,1,0,1
20695_0,,,,2,2,1,3
C(CO)(C(C(C)O)CC(C=O)=O)=O,,,5,1,2,0,2
20697_0,,,,2,2,1,3
C(C(C(CO)=O)CC(C=O)=O)(O)=O,,,5,1,2,0,2
20698_0,,,,2,2,1,3
20700_0,,,,2,2,1,3
C(CCC(C=O)=O)(C(C(C)O)O)=O,,,5,1,2,0,2
20700_1,,,,2,2,1,3
20702_0,,,,2,2,1,3
C(C(C(CCC(C=O)=O)=O)O)(O)=O,,,5,1,5,0,5
20702_1,,,,2,2,1,3
20703_0,,,,2,2,1,3
20703_1,,,,2,2,1,3
20705_0,,,,2,2,1,3
C(CC(C(C=O)=O)C(C)O)(CO)=O,,,5,1,2,0,2
20707_0,,,,2,2,1,3
C(C(C(C=O)=O)CC(CO)=O)(O)=O,,,5,1,1,0,1
20708_0,,,,2,2,1,3
20710_0,,,,2,2,1,3
C(CC(CCO)(CC(C=O)=O)O)=O,,,5,1,2,0,2
20712_0,,,,2,2,1,3
C(CC(C=O)(CC=O)O)(CCO)=O,,,5,1,1,0,1
20714_0,,,,2,2,1,3
C(CC(C(CC(CCO)=O)=O)O)=O,,,5,1,1,0,1
20716_0,,,,2,2,1,3
C(C(CO)C(C)O)(CC(C=O)=O)=O,,,5,1,2,0,2
20716_1,,,,2,2,1,3
20718_0,,,,2,2,1,3
C(C(C(CC(C=O)=O)=O)CO)(O)=O,,,5,1,2,0,2
20718_1,,,,2,2,1,3
20719_0,,,,2,2,1,3
20719_1,,,,2,2,1,3
20721_0,,,,2,2,1,3
C(CCO)(C(C(C=O)=O)C(C)O)=O,,,5,1,2,0,2
20721_1,,,,2,2,1,3
20723_0,,,,2,2,1,3
C(C(C(CCO)=O)C(C=O)=O)(O)=O,,,5,1,2,0,2
20723_1,,,,2,2,1,3
20724_0,,,,2,2,1,3
20724_1,,,,2,2,1,3
20726_0,,,,2,2,1,3
C(C(C=C)C(CCC(C=O)=O)O)=O,,,5,1,1,0,1
20728_0,,,,2,2,1,3
C1OC(C(C=1)=O)C(CCC(C=O)=O)O,,,5,1,2,0,2
20728_1,,,,2,2,1,3
20729_0,,,,2,2,1,3
20730_0,,,,2,2,1,3
20730_1,,,,2,2,1,3
20731_0,,,,2,2,1,3
20733_0,,,,2,2,1,3
C(C(CO)C(CCC(C=O)=O)O)=O,,,5,1,6,0,6
20733_1,,,,2,2,1,3
20734_0,,,,2,2,1,3
20734_1,,,,2,2,1,3
20735_0,,,,2,2,1,3
20736_0,,,,2,2,1,3
20736_1,,,,2,2,1,3
20738_0,,,,2,2,1,3
C(CCC(C=O)(C(C=O)C=C)O)=O,,,5,1,2,0,2
20740_0,,,,2,2,1,3
C(CCC(C=O)(C1C(C=CO1)=O)O)=O,,,5,1,2,0,2
20740_1,,,,2,2,1,3
20742_0,,,,2,2,1,3
C(CCC(C=O)(CC(C=O)=O)O)=O,,,5,1,2,0,2
20744_0,,,,2,2,1,3
C(CCC(C=O)(C(C=O)C=O)O)=O,,,5,1,3,0,3
20744_1,,,,2,2,1,3
20746_0,,,,2,2,1,3
C(CCC(C=O)(CC=O)O)=O,,,5,1,3,0,3
20748_0,,,,2,2,1,3
C(CCC(C=O)(C(C=O)CO)O)=O,,,5,1,3,0,3
20748_1,,,,2,2,1,3
20750_0,,,,2,2,1,3
C(CCC(C=O)(C(C(C)=O)O)O)=O,,,5,1,3,0,3
20750_1,,,,2,2,1,3
20752_0,,,,2,2,1,3
C(CCC(C=O)(CC(CO)=O)O)=O,,,5,1,2,0,2
20754_0,,,,2,2,1,3
C(CCC(C=O)(C(C=O)O)O)=O,,,5,1,5,0,5
20754_1,,,,2,2,1,3
20756_0,,,,2,2,1,3
C(C(C=C)C(C(CCC=O)=O)O)=O,,,5,1,1,0,1
20758_0,,,,2,2,1,3
C(CCC(C(C1C(C=CO1)=O)O)=O)=O,,,5,1,2,0,2
20758_1,,,,2,2,1,3
20760_0,,,,2,2,1,3
C(CCC(C(CC(C=O)=O)O)=O)=O,,,5,1,1,0,1
20762_0,,,,2,2,1,3
C(C(C=O)C(C(CCC=O)=O)O)=O,,,5,1,2,0,2
20762_1,,,,2,2,1,3
20764_0,,,,2,2,1,3
C(CCC(C(CC=O)O)=O)=O,,,5,1,4,0,4
20766_0,,,,2,2,1,3
C(CCC(C(C(C=O)CO)O)=O)=O,,,5,1,2,0,2
20766_1,,,,2,2,1,3
20768_0,,,,2,2,1,3
C(CCC(C(C(C(C)=O)O)O)=O)=O,,,5,1,4,0,4
20768_1,,,,2,2,1,3
20770_0,,,,2,2,1,3
C(CCC(C(CC(CO)=O)O)=O)=O,,,5,1,1,0,1
20772_0,,,,2,2,1,3
C(CCC(C(C(C=O)O)O)=O)=O,,,5,1,10,0,10
20772_1,,,,2,2,1,3
20774_0,,,,2,2,1,3
C(C(CC(C=O)=O)C(C(C=O)=C)O)=O,,,5,1,1,0,1
20776_0,,,,2,2,1,3
C(C(CC(C=O)=O)C(C=CC)O)=O,,,5,1,1,0,1
20778_0,,,,2,2,1,3
C(C(C(CC=C)O)CC(C=O)=O)=O,,,5,1,1,0,1
20780_0,,,,2,2,1,3
C(C(CC(C=O)=O)C(C=C)O)=O,,,5,1,2,0,2
20782_0,,,,2,2,1,3
C(C(CC(C=O)=O)C1(C=COC1)O)=O,,,5,1,1,0,1
20784_0,,,,2,2,1,3
C(C(C(C=O)CC(C=O)=O)O)=O,,,5,1,5,0,5
20786_0,,,,2,2,1,3
C(C(C(C=O)CC(C=O)=O)O)(O)=O,,,5,1,2,0,2
20788_0,,,,2,2,1,3
C(C(C)(C(C=O)CC(C=O)=O)O)=O,,,5,1,2,0,2
20790_0,,,,2,2,1,3
C(C(CC(C=O)=O)C(C(C)=O)O)=O,,,5,1,2,0,2
20791_0,,,,2,2,1,3
20793_0,,,,2,2,1,3
C(C(C(C)O)CC(C=O)=O)=O,,,5,1,3,0,3
20795_0,,,,2,2,1,3
C(C(C(CCO)O)CC(C=O)=O)=O,,,5,1,2,0,2
20797_0,,,,2,2,1,3
C(C(C(C)(CO)O)CC(C=O)=O)=O,,,5,1,2,0,2
20799_0,,,,2,2,1,3
C(C(C=C)(C(C=O)CC(C=O)=O)O)=O,,,5,1,2,0,2
20801_0,,,,2,2,1,3
C(C(CC(C=O)=O)C(C(C=C)=O)O)=O,,,5,1,2,0,2
20803_0,,,,2,2,1,3
C(C(CC(C=O)=O)C(C=CC=O)O)=O,,,5,1,2,0,2
20805_0,,,,2,2,1,3
C(C(C(O)=O)CC(C=O)=O)=O,,,5,1,4,0,4
20807_0,,,,2,2,1,3
C(C(C(C(O)O)O)CC(C=O)=O)=O,,,5,1,2,0,2
20809_0,,,,2,2,1,3
C(C(C(C(C)O)O)CC(C=O)=O)=O,,,5,1,2,0,2
20810_0,,,,2,2,1,3
20811_0,,,,2,2,1,3
20813_0,,,,2,2,1,3
C(CC(C(C=O)=O)C(C(C=O)=C)O)=O,,,5,1,1,0,1
20815_0,,,,2,2,1,3
C(CC(C(C=O)=O)C(C=CC)O)=O,,,5,1,1,0,1
20817_0,,,,2,2,1,3
C(CC(C(C=O)=O)C(CC=C)O)=O,,,5,1,1,0,1
20819_0,,,,2,2,1,3
C(CC(C(C=O)=O)C(C=C)O)=O,,,5,1,2,0,2
20821_0,,,,2,2,1,3
C(CC(C(C=O)=O)C1(C=COC1)O)=O,,,5,1,1,0,1
20823_0,,,,2,2,1,3
C(CC(C(C=O)=O)C(C=O)O)=O,,,5,1,3,0,3
20825_0,,,,2,2,1,3
C(C(C(C(C=O)=O)CC=O)O)(O)=O,,,5,1,2,0,2
20827_0,,,,2,2,1,3
C(CC(C(C=O)=O)C(C=O)(C)O)=O,,,5,1,2,0,2
20829_0,,,,2,2,1,3
C(CC(C(C=O)=O)C(C(C)=O)O)=O,,,5,1,2,0,2
20831_0,,,,2,2,1,3
C(CC(C(C(C=O)=O)CC=O)O)=O,,,5,1,3,0,3
20833_0,,,,2,2,1,3
C(CC(C(C=O)=O)C(C)O)=O,,,5,1,3,0,3
20835_0,,,,2,2,1,3
C(CC(C(C=O)=O)C(CCO)O)=O,,,5,1,2,0,2
20837_0,,,,2,2,1,3
C(CC(C(C=O)=O)C(C)(CO)O)=O,,,5,1,2,0,2
20839_0,,,,2,2,1,3
C(C(C=C)(C(C(C=O)=O)CC=O)O)=O,,,5,1,2,0,2
20841_0,,,,2,2,1,3
C(CC(C(C=O)=O)C(C(C=C)=O)O)=O,,,5,1,2,0,2
20843_0,,,,2,2,1,3
C(CC(C(C=O)=O)C(C=CC=O)O)=O,,,5,1,2,0,2
20845_0,,,,2,2,1,3
C(C(C(C=O)=O)CC=O)(O)=O,,,5,1,4,0,4
20847_0,,,,2,2,1,3
C(CC(C(C=O)=O)C(C(O)O)O)=O,,,5,1,2,0,2
20849_0,,,,2,2,1,3
C(CC(C(C=O)=O)C(C(C)O)O)=O,,,5,1,2,0,2
20850_0,,,,2,2,1,3
20852_0,,,,2,2,1,3
C(CC(C(C=O)=O)C(CO)O)=O,,,5,1,4,0,4
20854_0,,,,2,2,1,3
C(C(C(C(CCC=O)=O)=O)CO)=O,,,5,1,2,0,2
20854_1,,,,2,2,1,3
20856_0,,,,2,2,1,3
C(CC(C(C(CO)CC=O)=O)=O)=O,,,5,1,1,0,1
20858_0,,,,2,2,1,3
C(C(CO)CC(C(CC=O)=O)=O)=O,,,5,1,1,0,1
20860_0,,,,2,2,1,3
C(C(C(CC(CC=O)=O)=O)CO)=O,,,5,1,2,0,2
20860_1,,,,2,2,1,3
20862_0,,,,2,2,1,3
C(CC=O)(C(C(CC=O)=O)CO)=O,,,5,1,2,0,2
20862_1,,,,2,2,1,3
20864_0,,,,2,2,1,3
C(C(C(CCC=O)=O)(CC=O)O)=O,,,5,1,1,0,1
20866_0,,,,2,2,1,3
C(CCC(C(C(CC=O)O)=O)=O)=O,,,5,1,1,0,1
20868_0,,,,2,2,1,3
C(CCC(C(C=O)=O)(CC=O)O)=O,,,5,1,2,0,2
20870_0,,,,2,2,1,3
C(CC(CCC(C(C=O)=O)=O)O)=O,,,5,1,1,0,1
20872_0,,,,2,2,1,3
C(CC(C(C(C=O)=O)=O)C(C=C)O)=O,,,5,1,1,0,1
20874_0,,,,2,2,1,3
C(CC(C(C(C=O)=O)=O)C(C)O)=O,,,5,1,1,0,1
20876_0,,,,2,2,1,3
C(C(C(C(C=O)=O)=O)CC=O)(O)=O,,,5,1,1,0,1
20877_0,,,,2,2,1,3
20879_0,,,,2,2,1,3
C(C(CC(C(C=O)=O)=O)C(C=C)O)=O,,,5,1,1,0,1
20881_0,,,,2,2,1,3
C(C(C(C)O)CC(C(C=O)=O)=O)=O,,,5,1,1,0,1
20883_0,,,,2,2,1,3
C(C(C(O)=O)CC(C(C=O)=O)=O)=O,,,5,1,1,0,1
20885_0,,,,2,2,1,3
C(C(CO)CC(C(C=O)=O)=O)=O,,,5,1,3,0,3
20886_0,,,,2,2,1,3
20888_0,,,,2,2,1,3
C(CC(CC(C(CC=O)O)=O)=O)=O,,,5,1,1,0,1
20890_0,,,,2,2,1,3
C(CC(CC=O)(CC(C=O)=O)O)=O,,,5,1,2,0,2
20891_0,,,,2,2,1,3
20893_0,,,,2,2,1,3
C(CC=O)(C(C(C=O)=O)C(C=C)O)=O,,,5,1,2,0,2
20893_1,,,,2,2,1,3
20895_0,,,,2,2,1,3
C(CC=O)(C(C(C=O)=O)C(C)O)=O,,,5,1,2,0,2
20895_1,,,,2,2,1,3
20897_0,,,,2,2,1,3
C(C(C(CC=O)=O)C(C=O)=O)(O)=O,,,5,1,2,0,2
20897_1,,,,2,2,1,3
20898_0,,,,2,2,1,3
20898_1,,,,2,2,1,3
20900_0,,,,2,2,1,3
C(C(C(CC(C=O)=O)=O)C(C=C)O)=O,,,5,1,2,0,2
20900_1,,,,2,2,1,3
20902_0,,,,2,2,1,3
C(C(C(CC(C=O)=O)=O)C(C)O)=O,,,5,1,2,0,2
20902_1,,,,2,2,1,3
20904_0,,,,2,2,1,3
C(C(C(O)=O)C(CC(C=O)=O)=O)=O,,,5,1,2,0,2
20904_1,,,,2,2,1,3
20906_0,,,,2,2,1,3
C(C(C(CC(C=O)=O)=O)CO)=O,,,5,1,6,0,6
20906_1,,,,2,2,1,3
20907_0,,,,2,2,1,3
20909_0,,,,2,2,1,3
C(CC(C1C(C=CO1)=O)O)(CC=O)=O,,,5,1,2,0,2
20909_1,,,,2,2,1,3
20910_0,,,,2,2,1,3
20911_0,,,,2,2,1,3
20911_1,,,,2,2,1,3
20912_0,,,,2,2,1,3
20913_0,,,,2,2,1,3
20913_1,,,,2,2,1,3
20914_0,,,,2,2,1,3
20914_1,,,,2,2,1,3
20915_0,,,,2,2,1,3
20916_0,,,,2,2,1,3
20916_1,,,,2,2,1,3
20918_0,,,,2,2,1,3
C(C(C=C)C(CC=O)(CC=O)O)=O,,,5,1,1,0,1
20920_0,,,,2,2,1,3
C(CC(C1C(C=CO1)=O)(CC=O)O)=O,,,5,1,2,0,2
20920_1,,,,2,2,1,3
20921_0,,,,2,2,1,3
20923_0,,,,2,2,1,3
C(C(C=O)C(CC=O)(CC=O)O)=O,,,5,1,2,0,2
20923_1,,,,2,2,1,3
20925_0,,,,2,2,1,3
C(CC(CC=O)(CC=O)O)=O,,,5,1,2,0,2
20927_0,,,,2,2,1,3
C(C(CO)C(CC=O)(CC=O)O)=O,,,5,1,3,0,3
20927_1,,,,2,2,1,3
20929_0,,,,2,2,1,3
C(CC(C(C(C)=O)O)(CC=O)O)=O,,,5,1,3,0,3
20929_1,,,,2,2,1,3
20930_0,,,,2,2,1,3
20931_0,,,,2,2,1,3
20931_1,,,,2,2,1,3
20933_0,,,,2,2,1,3
C(C(C(CC=O)=O)C(C(C=O)=C)O)=O,,,5,1,2,0,2
20933_1,,,,2,2,1,3
20935_0,,,,2,2,1,3
C(C(C(CC=O)=O)C(C=CC)O)=O,,,5,1,2,0,2
20935_1,,,,2,2,1,3
20937_0,,,,2,2,1,3
C(C(C(CC=O)=O)C(CC=C)O)=O,,,5,1,2,0,2
20937_1,,,,2,2,1,3
20939_0,,,,2,2,1,3
C(C(C(CC=O)=O)C(C=C)O)=O,,,5,1,2,0,2
20939_1,,,,2,2,1,3
20941_0,,,,2,2,1,3
C(CC(C(C=O)C1(C=COC1)O)=O)=O,,,5,1,2,0,2
20941_1,,,,2,2,1,3
20942_0,,,,2,2,1,3
20942_1,,,,2,2,1,3
20944_0,,,,2,2,1,3
C(C(C(CC=O)=O)C(C(O)=O)O)=O,,,5,1,4,0,4
20944_1,,,,2,2,1,3
20946_0,,,,2,2,1,3
C(CC(C(C=O)C(C=O)(C)O)=O)=O,,,5,1,2,0,2
20946_1,,,,2,2,1,3
20948_0,,,,2,2,1,3
C(C(C(CC=O)=O)C(C(C)=O)O)=O,,,5,1,2,0,2
20948_1,,,,2,2,1,3
20950_0,,,,2,2,1,3
C(C(C(CC=O)=O)C(CC=O)O)=O,,,5,1,2,0,2
20950_1,,,,2,2,1,3
20952_0,,,,2,2,1,3
C(C(C(CC=O)=O)C(C)O)=O,,,5,1,6,0,6
20952_1,,,,2,2,1,3
20954_0,,,,2,2,1,3
C(C(C(CC=O)=O)C(CCO)O)=O,,,5,1,2,0,2
20954_1,,,,2,2,1,3
20956_0,,,,2,2,1,3
C(C(C(CC=O)=O)C(C)(CO)O)=O,,,5,1,2,0,2
20956_1,,,,2,2,1,3
20958_0,,,,2,2,1,3
C(C(C(CC=O)=O)C(C=O)(C=C)O)=O,,,5,1,2,0,2
20958_1,,,,2,2,1,3
20960_0,,,,2,2,1,3
C(C(C(CC=O)=O)C(C(C=C)=O)O)=O,,,5,1,2,0,2
20960_1,,,,2,2,1,3
20962_0,,,,2,2,1,3
C(C(C(CC=O)=O)C(C=CC=O)O)=O,,,5,1,2,0,2
20962_1,,,,2,2,1,3
20964_0,,,,2,2,1,3
C(C(C(O)=O)C(CC=O)=O)=O,,,5,1,6,0,6
20964_1,,,,2,2,1,3
20966_0,,,,2,2,1,3
C(C(C(CC=O)=O)C(C(O)O)O)=O,,,5,1,2,0,2
20966_1,,,,2,2,1,3
20968_0,,,,2,2,1,3
C(C(C(CC=O)=O)C(C(C)O)O)=O,,,5,1,2,0,2
20968_1,,,,2,2,1,3
20969_0,,,,2,2,1,3
20969_1,,,,2,2,1,3
20970_0,,,,2,2,1,3
20970_1,,,,2,2,1,3
20972_0,,,,2,2,1,3
C(CC(C(CO)C(C=O)C=O)=O)=O,,,5,1,1,0,1
20974_0,,,,2,2,1,3
C(C(C(CC(C=O)C=O)=O)CO)=O,,,5,1,2,0,2
20974_1,,,,2,2,1,3
20976_0,,,,2,2,1,3
C(C(CO)CC=O)(C(C=O)C=O)=O,,,5,1,1,0,1
20978_0,,,,2,2,1,3
C(C(CO)CC(C(C=O)C=O)=O)=O,,,5,1,1,0,1
20980_0,,,,2,2,1,3
C(C(CO)C(C=O)C(C=O)C=O)=O,,,5,1,3,0,3
20982_0,,,,2,2,1,3
C(C(C=O)C(C(C(C)=O)=O)CO)=O,,,5,1,1,0,1
20984_0,,,,2,2,1,3
C(C(C=O)CC(C(CCO)=O)=O)=O,,,5,1,1,0,1
20986_0,,,,2,2,1,3
C(C(C=O)C(C(C(C)=O)CO)=O)=O,,,5,1,2,0,2
20986_1,,,,2,2,1,3
20988_0,,,,2,2,1,3
C(C(C=O)C(CC(CCO)=O)=O)=O,,,5,1,1,0,1
20990_0,,,,2,2,1,3
C(CC(C(C=O)C(C=O)C=O)O)=O,,,5,1,3,0,3
20992_0,,,,2,2,1,3
C(C(C=O)CC(CO)(CC=O)O)=O,,,5,1,2,0,2
20994_0,,,,2,2,1,3
C(CC(C(C=O)CC(CO)=O)O)=O,,,5,1,3,0,3
20996_0,,,,2,2,1,3
C(C(C=O)C(C(CO)=O)C(C)O)=O,,,5,1,2,0,2
20998_0,,,,2,2,1,3
C(C(C(CO)=O)C(C=O)C=O)(O)=O,,,5,1,2,0,2
20999_0,,,,2,2,1,3
21001_0,,,,2,2,1,3
C(C(C=O)CC(C(C(C)O)O)=O)=O,,,5,1,2,0,2
21001_1,,,,2,2,1,3
21003_0,,,,2,2,1,3
C(C(C=O)CC(C(C(O)=O)O)=O)=O,,,5,1,4,0,4
21003_1,,,,2,2,1,3
21004_0,,,,2,2,1,3
21004_1,,,,2,2,1,3
21006_0,,,,2,2,1,3
C(C(C=O)C(CCO)(CC=O)O)=O,,,5,1,3,0,3
21008_0,,,,2,2,1,3
C(C(C(CCO)=O)C(CC=O)O)=O,,,5,1,3,0,3
21010_0,,,,2,2,1,3
C(C(C=O)C(C(CO)C(C)O)=O)=O,,,5,1,2,0,2
21010_1,,,,2,2,1,3
21012_0,,,,2,2,1,3
C(C(C=O)C(C(C(O)=O)CO)=O)=O,,,5,1,2,0,2
21012_1,,,,2,2,1,3
21013_0,,,,2,2,1,3
21013_1,,,,2,2,1,3
21015_0,,,,2,2,1,3
C(C(C=C)C(CC(C=O)C=O)O)=O,,,5,1,1,0,1
21017_0,,,,2,2,1,3
C(C(C=O)CC(C1C(C=CO1)=O)O)=O,,,5,1,2,0,2
21017_1,,,,2,2,1,3
21019_0,,,,2,2,1,3
C(C(C=O)CC(CC(C=O)=O)O)=O,,,5,1,2,0,2
21021_0,,,,2,2,1,3
C(C(C=O)CC(C(C=O)C=O)O)=O,,,5,1,3,0,3
21021_1,,,,2,2,1,3
21023_0,,,,2,2,1,3
C(C(C=O)CC(CC=O)O)=O,,,5,1,3,0,3
21025_0,,,,2,2,1,3
C(C(C=O)CC(C(C=O)CO)O)=O,,,5,1,3,0,3
21025_1,,,,2,2,1,3
21027_0,,,,2,2,1,3
C(C(C=O)CC(C(C(C)=O)O)O)=O,,,5,1,3,0,3
21027_1,,,,2,2,1,3
21029_0,,,,2,2,1,3
C(C(C=O)CC(CC(CO)=O)O)=O,,,5,1,2,0,2
21031_0,,,,2,2,1,3
C(C(C=O)CC(C(C=O)O)O)=O,,,5,1,7,0,7
21031_1,,,,2,2,1,3
21033_0,,,,2,2,1,3
C(C(C(C(C=O)C=C)O)CC=O)=O,,,5,1,2,0,2
21035_0,,,,2,2,1,3
C(C(C(C1C(C=CO1)=O)O)CC=O)=O,,,5,1,2,0,2
21035_1,,,,2,2,1,3
21036_0,,,,2,2,1,3
21037_0,,,,2,2,1,3
21037_1,,,,2,2,1,3
21038_0,,,,2,2,1,3
21040_0,,,,2,2,1,3
C(C(CO)C(C(C=O)CC=O)O)=O,,,5,1,7,0,7
21040_1,,,,2,2,1,3
21041_0,,,,2,2,1,3
21041_1,,,,2,2,1,3
21042_0,,,,2,2,1,3
21043_0,,,,2,2,1,3
21043_1,,,,2,2,1,3
21045_0,,,,2,2,1,3
C(C(C=O)C(C=O)C(C(C=O)=C)O)=O,,,5,1,1,0,1
21047_0,,,,2,2,1,3
C(C(C=O)C(C=O)C(C=CC)O)=O,,,5,1,1,0,1
21049_0,,,,2,2,1,3
C(C(C=O)C(C=O)C(CC=C)O)=O,,,5,1,1,0,1
21051_0,,,,2,2,1,3
C(C(C=O)C(C=O)C(C=C)O)=O,,,5,1,2,0,2
21053_0,,,,2,2,1,3
C(C(C=O)C(C=O)C1(C=COC1)O)=O,,,5,1,1,0,1
21054_0,,,,2,2,1,3
21056_0,,,,2,2,1,3
C(C(C=O)C(C=O)C(C(O)=O)O)=O,,,5,1,4,0,4
21058_0,,,,2,2,1,3
C(C(C)(C(C=O)C(C=O)C=O)O)=O,,,5,1,2,0,2
21060_0,,,,2,2,1,3
C(C(C=O)C(C=O)C(C(C)=O)O)=O,,,5,1,2,0,2
21061_0,,,,2,2,1,3
21063_0,,,,2,2,1,3
C(C(C=O)C(C=O)C(C)O)=O,,,5,1,3,0,3
21065_0,,,,2,2,1,3
C(C(C=O)C(C=O)C(CCO)O)=O,,,5,1,2,0,2
21067_0,,,,2,2,1,3
C(C(C=O)C(C=O)C(C)(CO)O)=O,,,5,1,2,0,2
21069_0,,,,2,2,1,3
C(C(C=O)C(C=O)C(C=O)(C=C)O)=O,,,5,1,2,0,2
21071_0,,,,2,2,1,3
C(C(C=O)C(C=O)C(C(C=C)=O)O)=O,,,5,1,2,0,2
21073_0,,,,2,2,1,3
C(C(C=O)C(C=O)C(C=CC=O)O)=O,,,5,1,2,0,2
21075_0,,,,2,2,1,3
C(C(C=O)C(C=O)C(O)=O)=O,,,5,1,4,0,4
21077_0,,,,2,2,1,3
C(C(C=O)C(C=O)C(C(O)O)O)=O,,,5,1,2,0,2
21079_0,,,,2,2,1,3
C(C(C=O)C(C=O)C(C(C)O)O)=O,,,5,1,2,0,2
21080_0,,,,2,2,1,3
21081_0,,,,2,2,1,3
21083_0,,,,2,2,1,3
C(CC(C=O)(C(C=O)CCO)O)=O,,,5,1,3,0,3
21085_0,,,,2,2,1,3
C(CC(C(C(C=O)CCO)=O)O)=O,,,5,1,1,0,1
21087_0,,,,2,2,1,3
C(CC(C(C(C=O)=O)CCO)O)=O,,,5,1,3,0,3
21089_0,,,,2,2,1,3
C(CC(CC(C(CCO)=O)=O)O)=O,,,5,1,1,0,1
21091_0,,,,2,2,1,3
C(C(CCO)(CC=O)O)(CC=O)=O,,,5,1,1,0,1
21093_0,,,,2,2,1,3
C(CC(C(CCO)=O)(CC=O)O)=O,,,5,1,1,0,1
21095_0,,,,2,2,1,3
C(C(C(C(CCO)=O)=O)C(C)O)=O,,,5,1,2,0,2
21095_1,,,,2,2,1,3
21097_0,,,,2,2,1,3
C(C(C=O)C(C(CCO)=O)=O)(O)=O,,,5,1,2,0,2
21097_1,,,,2,2,1,3
21098_0,,,,2,2,1,3
21098_1,,,,2,2,1,3
21100_0,,,,2,2,1,3
C(CC(C(C(CO)C(C)O)=O)=O)=O,,,5,1,2,0,2
21100_1,,,,2,2,1,3
21101_0,,,,2,2,1,3
21101_1,,,,2,2,1,3
21102_0,,,,2,2,1,3
21102_1,,,,2,2,1,3
21104_0,,,,2,2,1,3
C(CC(CC(C(C=O)=O)CO)O)=O,,,5,1,3,0,3
21106_0,,,,2,2,1,3
C(CC(CO)C(C=O)(CC=O)O)=O,,,5,1,4,0,4
21108_0,,,,2,2,1,3
C(CC(C(C(CO)CC=O)=O)O)=O,,,5,1,1,0,1
21110_0,,,,2,2,1,3
C(C(C(C)O)C(C(C=O)=O)CO)=O,,,5,1,2,0,2
21112_0,,,,2,2,1,3
C(C(C=O)C(C(C=O)=O)CO)(O)=O,,,5,1,2,0,2
21113_0,,,,2,2,1,3
21114_0,,,,2,2,1,3
21116_0,,,,2,2,1,3
C(C)(C(CO)C(C=O)(CC=O)O)=O,,,5,1,1,0,1
21118_0,,,,2,2,1,3
C(CC(C(C(C(C)=O)CO)=O)O)=O,,,5,1,1,0,1
21120_0,,,,2,2,1,3
C(CC(C)O)(C(C(C=O)=O)CO)=O,,,5,1,1,0,1
21122_0,,,,2,2,1,3
C(CC(O)=O)(C(C(C=O)=O)CO)=O,,,5,1,2,0,2
21123_0,,,,2,2,1,3
21125_0,,,,2,2,1,3
C(C(C=C)C(CCC(CC=O)=O)O)=O,,,5,1,1,0,1
21127_0,,,,2,2,1,3
C(CC(CCC(CC=O)O)=O)=O,,,5,1,2,0,2
21129_0,,,,2,2,1,3
C(CCC(C(C=O)O)O)(CC=O)=O,,,5,1,2,0,2
21129_1,,,,2,2,1,3
21131_0,,,,2,2,1,3
C(C(C=C)C(CCC=O)(CC=O)O)=O,,,5,1,1,0,1
21133_0,,,,2,2,1,3
C(CC(CCC=O)(CC=O)O)=O,,,5,1,2,0,2
21134_0,,,,2,2,1,3
21134_1,,,,2,2,1,3
21136_0,,,,2,2,1,3
C(C(C=C)C(CC(CCC=O)=O)O)=O,,,5,1,1,0,1
21138_0,,,,2,2,1,3
C(CC(CC(CCC=O)=O)O)=O,,,5,1,2,0,2
21140_0,,,,2,2,1,3
C(C(C(CC(CCC=O)=O)O)O)=O,,,5,1,2,0,2
21140_1,,,,2,2,1,3
21142_0,,,,2,2,1,3
C(CC(CC(C=O)C(C=CC)O)=O)=O,,,5,1,1,0,1
21144_0,,,,2,2,1,3
C(C(C(CC=C)O)CC(CC=O)=O)=O,,,5,1,1,0,1
21146_0,,,,2,2,1,3
C(CC(CC(C=O)C(C=C)O)=O)=O,,,5,1,1,0,1
21148_0,,,,2,2,1,3
C(CC(CC(C=O)C(C=O)O)=O)=O,,,5,1,1,0,1
21150_0,,,,2,2,1,3
C(C(C(C)O)CC(CC=O)=O)=O,,,5,1,2,0,2
21152_0,,,,2,2,1,3
C(C(C(O)=O)CC(CC=O)=O)=O,,,5,1,3,0,3
21154_0,,,,2,2,1,3
C(C(CO)CC(CC=O)=O)=O,,,5,1,3,0,3
21156_0,,,,2,2,1,3
C(C(C(CO)O)CC(CC=O)=O)=O,,,5,1,1,0,1
21158_0,,,,2,2,1,3
C(CC(C(CC=O)C(C=CC)O)=O)=O,,,5,1,1,0,1
21160_0,,,,2,2,1,3
C(C(C(CC=C)O)CC=O)(CC=O)=O,,,5,1,1,0,1
21162_0,,,,2,2,1,3
C(CC(C(CC=O)C(C=C)O)=O)=O,,,5,1,1,0,1
21164_0,,,,2,2,1,3
C(CC(C(CC=O)C(C=O)O)=O)=O,,,5,1,1,0,1
21166_0,,,,2,2,1,3
C(C(C(C)O)CC=O)(CC=O)=O,,,5,1,2,0,2
21168_0,,,,2,2,1,3
C(CC=O)(C(C(O)=O)CC=O)=O,,,5,1,3,0,3
21170_0,,,,2,2,1,3
C(C(CO)CC=O)(CC=O)=O,,,5,1,4,0,4
21172_0,,,,2,2,1,3
C(C(C(CO)O)CC=O)(CC=O)=O,,,5,1,1,0,1
21174_0,,,,2,2,1,3
C(C(C(CCC=O)=O)C(C=CC)O)=O,,,5,1,2,0,2
21174_1,,,,2,2,1,3
21176_0,,,,2,2,1,3
C(C(C(CCC=O)=O)C(CC=C)O)=O,,,5,1,2,0,2
21176_1,,,,2,2,1,3
21178_0,,,,2,2,1,3
C(C(C(CCC=O)=O)C(C=C)O)=O,,,5,1,2,0,2
21178_1,,,,2,2,1,3
21180_0,,,,2,2,1,3
C(C(C(CCC=O)=O)C(C=O)O)=O,,,5,1,2,0,2
21180_1,,,,2,2,1,3
21182_0,,,,2,2,1,3
C(C(C(CCC=O)=O)C(C)O)=O,,,5,1,3,0,3
21182_1,,,,2,2,1,3
21184_0,,,,2,2,1,3
C(C(C(O)=O)C(CCC=O)=O)=O,,,5,1,4,0,4
21184_1,,,,2,2,1,3
21186_0,,,,2,2,1,3
C(C(C(CCC=O)=O)CO)=O,,,5,1,4,0,4
21186_1,,,,2,2,1,3
21188_0,,,,2,2,1,3
C(C(C(CCC=O)=O)C(CO)O)=O,,,5,1,2,0,2
21188_1,,,,2,2,1,3
21190_0,,,,2,2,1,3
C(C(CCC(C=O)(CC=O)O)O)=O,,,5,1,2,0,2
21192_0,,,,2,2,1,3
C(CC(C(CCC(C=O)O)=O)O)=O,,,5,1,2,0,2
21193_0,,,,2,2,1,3
21195_0,,,,2,2,1,3
C(C(CC(C(C=O)=O)C(C)O)O)=O,,,5,1,2,0,2
21197_0,,,,2,2,1,3
C(C(C(C=O)=O)CC(C=O)O)(O)=O,,,5,1,1,0,1
21199_0,,,,2,2,1,3
C(C(CC(C(C=O)=O)CO)O)=O,,,5,1,5,0,5
21201_0,,,,2,2,1,3
C(CC(CC(C=O)C(C=O)O)O)=O,,,5,1,2,0,2
21202_0,,,,2,2,1,3
21204_0,,,,2,2,1,3
C(CC(C(C(C=O)O)CC=O)O)=O,,,5,1,3,0,3
21206_0,,,,2,2,1,3
C(C(C(C=O)C(C=O)C(C)O)O)=O,,,5,1,4,0,4
21208_0,,,,2,2,1,3
C(C(C=O)C(C=O)C(C=O)O)(O)=O,,,5,1,2,0,2
21209_0,,,,2,2,1,3
21210_0,,,,2,2,1,3
21211_0,,,,2,2,1,3
21213_0,,,,2,2,1,3
C(C)(C(C(CC=O)O)C(C=O)O)=O,,,5,1,1,0,1
21215_0,,,,2,2,1,3
C(CC(C)O)(C(C=O)C(C=O)O)=O,,,5,1,1,0,1
21217_0,,,,2,2,1,3
C(C(C(CC(O)=O)=O)C(C=O)O)=O,,,5,1,4,0,4
21218_0,,,,2,2,1,3
21220_0,,,,2,2,1,3
C(C(CC(C(C=O)C=C)O)CC=O)=O,,,5,1,1,0,1
21221_0,,,,2,2,1,3
21222_0,,,,2,2,1,3
21222_1,,,,2,2,1,3
21224_0,,,,2,2,1,3
C(C(C=C)C(C(CC=O)CC=O)O)=O,,,5,1,1,0,1
21226_0,,,,2,2,1,3
C(CC(C(CC=O)O)CC=O)=O,,,5,1,3,0,3
21228_0,,,,2,2,1,3
C(CC(C(C(C=O)O)O)CC=O)=O,,,5,1,4,0,4
21228_1,,,,2,2,1,3
21230_0,,,,2,2,1,3
C(CC(C=O)C(C=O)C(C=CC)O)=O,,,5,1,1,0,1
21232_0,,,,2,2,1,3
C(CC(C=O)C(C=O)C(CC=C)O)=O,,,5,1,1,0,1
21234_0,,,,2,2,1,3
C(CC(C=O)C(C=O)C(C=C)O)=O,,,5,1,1,0,1
21235_0,,,,2,2,1,3
21236_0,,,,2,2,1,3
21237_0,,,,2,2,1,3
21238_0,,,,2,2,1,3
21239_0,,,,2,2,1,3
21241_0,,,,2,2,1,3
C(CC(CC(C=O)C(CO)=O)O)=O,,,5,1,2,0,2
21243_0,,,,2,2,1,3
C(CO)(C(C(CC=O)O)CC=O)=O,,,5,1,3,0,3
21244_0,,,,2,2,1,3
21246_0,,,,2,2,1,3
C(C(C(C)O)C(C=O)C(CO)=O)=O,,,5,1,2,0,2
21248_0,,,,2,2,1,3
C(C(C=O)C(C=O)C(CO)=O)(O)=O,,,5,1,2,0,2
21249_0,,,,2,2,1,3
21251_0,,,,2,2,1,3
C(C(C(C)O)O)(C(C=O)CC=O)=O,,,5,1,2,0,2
21251_1,,,,2,2,1,3
21253_0,,,,2,2,1,3
C(C(C(C(C(O)=O)O)=O)CC=O)=O,,,5,1,3,0,3
21253_1,,,,2,2,1,3
21254_0,,,,2,2,1,3
21254_1,,,,2,2,1,3
21255_0,,,,2,2,1,3
21256_0,,,,2,2,1,3
21257_0,,,,2,2,1,3
21259_0,,,,2,2,1,3
C(CC(C)O)(C(C=O)C(CO)=O)=O,,,5,1,1,0,1
21261_0,,,,2,2,1,3
C(C(C(CC(O)=O)=O)C(CO)=O)=O,,,5,1,1,0,1
21262_0,,,,2,2,1,3
21264_0,,,,2,2,1,3
C(C(C(C)O)O)(C(C=O)C(C)=O)=O,,,5,1,2,0,2
21264_1,,,,2,2,1,3
21266_0,,,,2,2,1,3
C(C(C(C(C(O)=O)O)=O)C(C)=O)=O,,,5,1,2,0,2
21266_1,,,,2,2,1,3
21267_0,,,,2,2,1,3
21267_1,,,,2,2,1,3
21269_0,,,,2,2,1,3
C(C(C=C)C(C)(CC(CC=O)=O)O)=O,,,5,1,1,0,1
21270_0,,,,2,2,1,3
21271_0,,,,2,2,1,3
21271_1,,,,2,2,1,3
21273_0,,,,2,2,1,3
C(C(C=C)C(CC(CC(C)=O)=O)O)=O,,,5,1,1,0,1
21275_0,,,,2,2,1,3
C(CC(CC(CC(C)=O)=O)O)=O,,,5,1,3,0,3
21277_0,,,,2,2,1,3
C(C(C(CC(CC(C)=O)=O)O)O)=O,,,5,1,2,0,2
21277_1,,,,2,2,1,3
21279_0,,,,2,2,1,3
C(CC(CC(C)=O)(C(C=O)C=C)O)=O,,,5,1,1,0,1
21281_0,,,,2,2,1,3
C(CC(CC=O)(CC(C)=O)O)=O,,,5,1,2,0,2
21283_0,,,,2,2,1,3
C(CC(C(C=O)O)(CC(C)=O)O)=O,,,5,1,3,0,3
21283_1,,,,2,2,1,3
21285_0,,,,2,2,1,3
C(CC(CC(CC(C=CC)O)=O)=O)=O,,,5,1,1,0,1
21287_0,,,,2,2,1,3
C(CC(CC(CC(CC=C)O)=O)=O)=O,,,5,1,1,0,1
21289_0,,,,2,2,1,3
C(CC(CC(CC(C=C)O)=O)=O)=O,,,5,1,1,0,1
21291_0,,,,2,2,1,3
C(CC(CC(CC(C=O)O)=O)=O)=O,,,5,1,1,0,1
21293_0,,,,2,2,1,3
C(CC(CC(CC(C)O)=O)=O)=O,,,5,1,3,0,3
21295_0,,,,2,2,1,3
C(CC(CC(CC(O)=O)=O)=O)=O,,,5,1,4,0,4
21297_0,,,,2,2,1,3
C(CC(CC(CCO)=O)=O)=O,,,5,1,5,0,5
21299_0,,,,2,2,1,3
C(CC(CC(CC(CO)O)=O)=O)=O,,,5,1,1,0,1
21301_0,,,,2,2,1,3
C(CC=O)(C(C(C)=O)C(C=CC)O)=O,,,5,1,2,0,2
21301_1,,,,2,2,1,3
21303_0,,,,2,2,1,3
C(CC=O)(C(C(C)=O)C(CC=C)O)=O,,,5,1,2,0,2
21303_1,,,,2,2,1,3
21305_0,,,,2,2,1,3
C(CC=O)(C(C(C)=O)C(C=C)O)=O,,,5,1,2,0,2
21305_1,,,,2,2,1,3
21307_0,,,,2,2,1,3
C(CC=O)(C(C(C)=O)C(C=O)O)=O,,,5,1,2,0,2
21307_1,,,,2,2,1,3
21309_0,,,,2,2,1,3
C(CC=O)(C(C(C)=O)C(C)O)=O,,,5,1,4,0,4
21309_1,,,,2,2,1,3
21311_0,,,,2,2,1,3
C(CC(C(C(O)=O)C(C)=O)=O)=O,,,5,1,5,0,5
21311_1,,,,2,2,1,3
21313_0,,,,2,2,1,3
C(CC=O)(C(C(C)=O)CO)=O,,,5,1,6,0,6
21313_1,,,,2,2,1,3
21315_0,,,,2,2,1,3
C(CC=O)(C(C(C)=O)C(CO)O)=O,,,5,1,2,0,2
21315_1,,,,2,2,1,3
21317_0,,,,2,2,1,3
C(C(C(CC(C)=O)=O)C(C=CC)O)=O,,,5,1,2,0,2
21317_1,,,,2,2,1,3
21319_0,,,,2,2,1,3
C(C(C(CC(C)=O)=O)C(CC=C)O)=O,,,5,1,2,0,2
21319_1,,,,2,2,1,3
21321_0,,,,2,2,1,3
C(C(C(CC(C)=O)=O)C(C=C)O)=O,,,5,1,2,0,2
21321_1,,,,2,2,1,3
21323_0,,,,2,2,1,3
C(C(C(CC(C)=O)=O)C(C=O)O)=O,,,5,1,2,0,2
21323_1,,,,2,2,1,3
21325_0,,,,2,2,1,3
C(C(C(CC(C)=O)=O)C(C)O)=O,,,5,1,4,0,4
21325_1,,,,2,2,1,3
21327_0,,,,2,2,1,3
C(C(C(CC(C)=O)=O)C(O)=O)=O,,,5,1,5,0,5
21327_1,,,,2,2,1,3
21329_0,,,,2,2,1,3
C(C(C(CC(C)=O)=O)CO)=O,,,5,1,5,0,5
21329_1,,,,2,2,1,3
21331_0,,,,2,2,1,3
C(C(C(CC(C)=O)=O)C(CO)O)=O,,,5,1,2,0,2
21331_1,,,,2,2,1,3
21333_0,,,,2,2,1,3
C(C(C=C)C(CC(C(CC)=O)=O)O)=O,,,5,1,1,0,1
21335_0,,,,2,2,1,3
C(CC(CC(C(CC)=O)=O)O)=O,,,5,1,2,0,2
21337_0,,,,2,2,1,3
C(C(C(CC(C(CC)=O)=O)O)O)=O,,,5,1,2,0,2
21337_1,,,,2,2,1,3
21339_0,,,,2,2,1,3
C(CC(C(CC)(C(C=O)C=C)O)=O)=O,,,5,1,1,0,1
21341_0,,,,2,2,1,3
C(C(CC)(CC=O)O)(CC=O)=O,,,5,1,1,0,1
21343_0,,,,2,2,1,3
C(C(CC)(C(C=O)O)O)(CC=O)=O,,,5,1,2,0,2
21343_1,,,,2,2,1,3
21345_0,,,,2,2,1,3
C(CC(C(CC)=O)(C(C=O)C=C)O)=O,,,5,1,1,0,1
21347_0,,,,2,2,1,3
C(CC(C(CC)=O)(CC=O)O)=O,,,5,1,2,0,2
21349_0,,,,2,2,1,3
C(CC(C(CC)=O)(C(C=O)O)O)=O,,,5,1,2,0,2
21349_1,,,,2,2,1,3
21351_0,,,,2,2,1,3
C(C(C(C(CC)=O)=O)C(C=CC)O)=O,,,5,1,2,0,2
21351_1,,,,2,2,1,3
21353_0,,,,2,2,1,3
C(C(C(C(CC)=O)=O)C(CC=C)O)=O,,,5,1,2,0,2
21353_1,,,,2,2,1,3
21355_0,,,,2,2,1,3
C(C(C(C(CC)=O)=O)C(C=C)O)=O,,,5,1,2,0,2
21355_1,,,,2,2,1,3
21357_0,,,,2,2,1,3
C(C(C(C(CC)=O)=O)C(C=O)O)=O,,,5,1,2,0,2
21357_1,,,,2,2,1,3
21359_0,,,,2,2,1,3
C(C(C(C(CC)=O)=O)C(C)O)=O,,,5,1,3,0,3
21359_1,,,,2,2,1,3
21361_0,,,,2,2,1,3
C(C(C(O)=O)C(C(CC)=O)=O)=O,,,5,1,3,0,3
21361_1,,,,2,2,1,3
21363_0,,,,2,2,1,3
C(C(C(C(CC)=O)=O)CO)=O,,,5,1,3,0,3
21363_1,,,,2,2,1,3
21365_0,,,,2,2,1,3
C(C(C(C(CC)=O)=O)C(CO)O)=O,,,5,1,2,0,2
21365_1,,,,2,2,1,3
21367_0,,,,2,2,1,3
C(CC(C(C(C)C(C=CC)O)=O)=O)=O,,,5,1,1,0,1
21369_0,,,,2,2,1,3
C(CC(C(C(C)C(CC=C)O)=O)=O)=O,,,5,1,1,0,1
21371_0,,,,2,2,1,3
C(CC(C(C(C)C(C=C)O)=O)=O)=O,,,5,1,1,0,1
21373_0,,,,2,2,1,3
C(CC(C(C(C)C(C=O)O)=O)=O)=O,,,5,1,1,0,1
21375_0,,,,2,2,1,3
C(CC(C(C(C)C(C)O)=O)=O)=O,,,5,1,1,0,1
21377_0,,,,2,2,1,3
C(CC(C(C(C(O)=O)C)=O)=O)=O,,,5,1,3,0,3
21379_0,,,,2,2,1,3
C(CC(C(C(C)CO)=O)=O)=O,,,5,1,3,0,3
21381_0,,,,2,2,1,3
C(CC(C(C(C)C(CO)O)=O)=O)=O,,,5,1,1,0,1
21382_0,,,,2,2,1,3
21384_0,,,,2,2,1,3
C(CC(C(CC=O)(CC=O)O)=O)=O,,,5,1,1,0,1
21386_0,,,,2,2,1,3
C(C(C(C(CC=O)=O)=O)C(C=C)O)=O,,,5,1,2,0,2
21386_1,,,,2,2,1,3
21388_0,,,,2,2,1,3
C(C(C(C(CC=O)=O)=O)C(C)O)=O,,,5,1,2,0,2
21388_1,,,,2,2,1,3
21390_0,,,,2,2,1,3
C(C(C(O)=O)C(C(CC=O)=O)=O)=O,,,5,1,2,0,2
21390_1,,,,2,2,1,3
21391_0,,,,2,2,1,3
21391_1,,,,2,2,1,3
21392_0,,,,2,2,1,3
21394_0,,,,2,2,1,3
C(CC(CC(C(C(C)=O)O)=O)O)=O,,,5,1,1,0,1
21395_0,,,,2,2,1,3
21397_0,,,,2,2,1,3
C(CC(C(C(CC(C)O)=O)O)=O)=O,,,5,1,1,0,1
21399_0,,,,2,2,1,3
C(CC(C(C(CC=O)=O)O)=O)(O)=O,,,5,1,1,0,1
21400_0,,,,2,2,1,3
21402_0,,,,2,2,1,3
C(C(C(C(C(C)=O)O)=O)C(C)O)=O,,,5,1,3,0,3
21402_1,,,,2,2,1,3
21404_0,,,,2,2,1,3
C(C(C=O)C(C(C(C)=O)O)=O)(O)=O,,,5,1,3,0,3
21404_1,,,,2,2,1,3
21405_0,,,,2,2,1,3
21405_1,,,,2,2,1,3
21407_0,,,,2,2,1,3
C(C(C=C)C(CCC(C(C)=O)=O)O)=O,,,5,1,1,0,1
21409_0,,,,2,2,1,3
C(CC(CCC(C(C)=O)=O)O)=O,,,5,1,2,0,2
21411_0,,,,2,2,1,3
C(C(C(CCC(C(C)=O)=O)O)O)=O,,,5,1,2,0,2
21411_1,,,,2,2,1,3
21413_0,,,,2,2,1,3
C(CCC(C(C)=O)(C(C=O)C=C)O)=O,,,5,1,1,0,1
21415_0,,,,2,2,1,3
C(C)(C(CCC=O)(CC=O)O)=O,,,5,1,2,0,2
21417_0,,,,2,2,1,3
C(C)(C(CCC=O)(C(C=O)O)O)=O,,,5,1,3,0,3
21417_1,,,,2,2,1,3
21419_0,,,,2,2,1,3
C(C(C=C)C(C(CCC=O)=O)(C)O)=O,,,5,1,1,0,1
21421_0,,,,2,2,1,3
C(CCC=O)(C(C)(CC=O)O)=O,,,5,1,2,0,2
21423_0,,,,2,2,1,3
C(CCC=O)(C(C)(C(C=O)O)O)=O,,,5,1,2,0,2
21423_1,,,,2,2,1,3
21425_0,,,,2,2,1,3
C(C(CC(C(C)=O)=O)C(C=CC)O)=O,,,5,1,1,0,1
21427_0,,,,2,2,1,3
C(C(C(CC=C)O)CC(C(C)=O)=O)=O,,,5,1,1,0,1
21429_0,,,,2,2,1,3
C(C(CC(C(C)=O)=O)C(C=C)O)=O,,,5,1,1,0,1
21431_0,,,,2,2,1,3
C(C(C(C=O)CC(C(C)=O)=O)O)=O,,,5,1,1,0,1
21433_0,,,,2,2,1,3
C(C(C(C)O)CC(C(C)=O)=O)=O,,,5,1,2,0,2
21435_0,,,,2,2,1,3
C(C(C(O)=O)CC(C(C)=O)=O)=O,,,5,1,3,0,3
21437_0,,,,2,2,1,3
C(C(CO)CC(C(C)=O)=O)=O,,,5,1,3,0,3
21439_0,,,,2,2,1,3
C(C(C(CO)O)CC(C(C)=O)=O)=O,,,5,1,1,0,1
21441_0,,,,2,2,1,3
C(CC(C(C(C)=O)=O)C(C=CC)O)=O,,,5,1,1,0,1
21443_0,,,,2,2,1,3
C(CC(C(C(C)=O)=O)C(CC=C)O)=O,,,5,1,1,0,1
21445_0,,,,2,2,1,3
C(CC(C(C(C)=O)=O)C(C=C)O)=O,,,5,1,1,0,1
21447_0,,,,2,2,1,3
C(CC(C(C(C)=O)=O)C(C=O)O)=O,,,5,1,1,0,1
21449_0,,,,2,2,1,3
C(CC(C(C(C)=O)=O)C(C)O)=O,,,5,1,1,0,1
21451_0,,,,2,2,1,3
C(C(C(C(C)=O)=O)CC=O)(O)=O,,,5,1,3,0,3
21453_0,,,,2,2,1,3
C(CC(C(C(C)=O)=O)CO)=O,,,5,1,3,0,3
21455_0,,,,2,2,1,3
C(CC(C(C(C)=O)=O)C(CO)O)=O,,,5,1,1,0,1
21457_0,,,,2,2,1,3
C(CCC(C(CC(C=CC)O)=O)=O)=O,,,5,1,1,0,1
21459_0,,,,2,2,1,3
C(CCC(C(CC(CC=C)O)=O)=O)=O,,,5,1,1,0,1
21461_0,,,,2,2,1,3
C(CCC(C(CC(C=C)O)=O)=O)=O,,,5,1,1,0,1
21463_0,,,,2,2,1,3
C(CCC(C(CC(C=O)O)=O)=O)=O,,,5,1,1,0,1
21465_0,,,,2,2,1,3
C(CCC(C(CC(C)O)=O)=O)=O,,,5,1,2,0,2
21467_0,,,,2,2,1,3
C(CC(C(CCC=O)=O)=O)(O)=O,,,5,1,3,0,3
21469_0,,,,2,2,1,3
C(CCC(C(CCO)=O)=O)=O,,,5,1,4,0,4
21471_0,,,,2,2,1,3
C(CCC(C(CC(CO)O)=O)=O)=O,,,5,1,1,0,1
21473_0,,,,2,2,1,3
C(CC(C(CC(C(C)=O)=O)O)O)=O,,,5,1,2,0,2
21475_0,,,,2,2,1,3
C(C)(C(CC(C=O)O)(CC=O)O)=O,,,5,1,1,0,1
21477_0,,,,2,2,1,3
C(CC(C=O)O)(C(C)(CC=O)O)=O,,,5,1,1,0,1
21479_0,,,,2,2,1,3
C(C(C(C(C(C)=O)=O)C(C)O)O)=O,,,5,1,2,0,2
21479_1,,,,2,2,1,3
21481_0,,,,2,2,1,3
C(C(C(C(C)=O)=O)C(C=O)O)(O)=O,,,5,1,5,0,5
21481_1,,,,2,2,1,3
21483_0,,,,2,2,1,3
C(C(C(C(C(C)=O)=O)CO)O)=O,,,5,1,7,0,7
21483_1,,,,2,2,1,3
21485_0,,,,2,2,1,3
C(C(CC(C(CC(C)O)=O)=O)O)=O,,,5,1,1,0,1
21487_0,,,,2,2,1,3
C(CC(C(CC(C=O)O)=O)=O)(O)=O,,,5,1,2,0,2
21489_0,,,,2,2,1,3
C(C(CC(C(CCO)=O)=O)O)=O,,,5,1,5,0,5
21490_0,,,,2,2,1,3
21491_0,,,,2,2,1,3
21492_0,,,,2,2,1,3
21494_0,,,,2,2,1,3
C(C(C=O)O)(C(C(C)=O)C(C)O)=O,,,5,1,2,0,2
21494_1,,,,2,2,1,3
21496_0,,,,2,2,1,3
C(C(C(C(C=O)O)=O)C(C)=O)(O)=O,,,5,1,2,0,2
21496_1,,,,2,2,1,3
21498_0,,,,2,2,1,3
C(C(C=O)O)(C(C(C)=O)CO)=O,,,5,1,4,0,4
21498_1,,,,2,2,1,3
21500_0,,,,2,2,1,3
C(C(C=O)O)(CC(CC(C)O)=O)=O,,,5,1,1,0,1
21502_0,,,,2,2,1,3
C(CC(CC(C(C=O)O)=O)=O)(O)=O,,,5,1,1,0,1
21503_0,,,,2,2,1,3
21505_0,,,,2,2,1,3
C(C(C=C)C(CC(C(C=O)=O)C)O)=O,,,5,1,1,0,1
21507_0,,,,2,2,1,3
C(CC(CC(C(C=O)=O)C)O)=O,,,5,1,2,0,2
21509_0,,,,2,2,1,3
C(C(C(CC(C(C=O)=O)C)O)O)=O,,,5,1,2,0,2
21509_1,,,,2,2,1,3
21511_0,,,,2,2,1,3
C(CC(C)C(C=O)(C(C=O)C=C)O)=O,,,5,1,2,0,2
21513_0,,,,2,2,1,3
C(CC(C)C(C=O)(CC=O)O)=O,,,5,1,2,0,2
21515_0,,,,2,2,1,3
C(CC(C)C(C=O)(C(C=O)O)O)=O,,,5,1,3,0,3
21515_1,,,,2,2,1,3
21517_0,,,,2,2,1,3
C(CC(C(C(C(C=O)C=C)O)=O)C)=O,,,5,1,1,0,1
21519_0,,,,2,2,1,3
C(CC(C(C(C)CC=O)=O)O)=O,,,5,1,2,0,2
21521_0,,,,2,2,1,3
C(CC(C(C(C(C=O)O)O)=O)C)=O,,,5,1,2,0,2
21521_1,,,,2,2,1,3
21523_0,,,,2,2,1,3
C(C(C(C=CC)O)C(C(C=O)=O)C)=O,,,5,1,1,0,1
21525_0,,,,2,2,1,3
C(C(C(CC=C)O)C(C(C=O)=O)C)=O,,,5,1,1,0,1
21527_0,,,,2,2,1,3
C(C(C(C=C)O)C(C(C=O)=O)C)=O,,,5,1,1,0,1
21529_0,,,,2,2,1,3
C(C(C(C=O)C(C(C=O)=O)C)O)=O,,,5,1,1,0,1
21531_0,,,,2,2,1,3
C(C(C(C)O)C(C(C=O)=O)C)=O,,,5,1,2,0,2
21533_0,,,,2,2,1,3
C(C(C(O)=O)C(C(C=O)=O)C)=O,,,5,1,3,0,3
21535_0,,,,2,2,1,3
C(C(CO)C(C(C=O)=O)C)=O,,,5,1,3,0,3
21537_0,,,,2,2,1,3
C(C(C(CO)O)C(C(C=O)=O)C)=O,,,5,1,1,0,1
21539_0,,,,2,2,1,3
C(C(C(C)C(C=O)(CC=O)O)O)=O,,,5,1,1,0,1
21541_0,,,,2,2,1,3
C(CC(C(C(C)C(C=O)O)=O)O)=O,,,5,1,1,0,1
21543_0,,,,2,2,1,3
C(CC(C(C(C(C=O)=O)C)O)O)=O,,,5,1,2,0,2
21545_0,,,,2,2,1,3
C(C(C=C)C(C=O)(C(CC)=O)O)=O,,,5,1,1,0,1
21547_0,,,,2,2,1,3
C(CC)(C(C=O)(C1C(C=CO1)=O)O)=O,,,5,1,2,0,2
21547_1,,,,2,2,1,3
21549_0,,,,2,2,1,3
C(CC)(C(C=O)(CC(C=O)=O)O)=O,,,5,1,1,0,1
21551_0,,,,2,2,1,3
C(C(C=O)C(C=O)(C(CC)=O)O)=O,,,5,1,2,0,2
21551_1,,,,2,2,1,3
21553_0,,,,2,2,1,3
C(CC)(C(C=O)(CC=O)O)=O,,,5,1,2,0,2
21555_0,,,,2,2,1,3
C(CC)(C(C=O)(C(C=O)CO)O)=O,,,5,1,2,0,2
21555_1,,,,2,2,1,3
21557_0,,,,2,2,1,3
C(CC)(C(C=O)(C(C(C)=O)O)O)=O,,,5,1,2,0,2
21557_1,,,,2,2,1,3
21559_0,,,,2,2,1,3
C(CC)(C(C=O)(CC(CO)=O)O)=O,,,5,1,1,0,1
21561_0,,,,2,2,1,3
C(CC)(C(C=O)(C(C=O)O)O)=O,,,5,1,3,0,3
21561_1,,,,2,2,1,3
21563_0,,,,2,2,1,3
C(C(C=C)C(C(C(CC)=O)=O)O)=O,,,5,1,1,0,1
21565_0,,,,2,2,1,3
C1OC(C(C=1)=O)C(C(C(CC)=O)=O)O,,,5,1,2,0,2
21565_1,,,,2,2,1,3
21567_0,,,,2,2,1,3
C(C=O)(CC(C(C(CC)=O)=O)O)=O,,,5,1,1,0,1
21569_0,,,,2,2,1,3
C(C(C=O)C(C(C(CC)=O)=O)O)=O,,,5,1,2,0,2
21569_1,,,,2,2,1,3
21571_0,,,,2,2,1,3
C(CC(C(C(CC)=O)=O)O)=O,,,5,1,2,0,2
21573_0,,,,2,2,1,3
C(C(CO)C(C(C(CC)=O)=O)O)=O,,,5,1,2,0,2
21573_1,,,,2,2,1,3
21574_0,,,,2,2,1,3
21574_1,,,,2,2,1,3
21576_0,,,,2,2,1,3
C(CC(C(C(CC)=O)=O)O)(CO)=O,,,5,1,1,0,1
21577_0,,,,2,2,1,3
21577_1,,,,2,2,1,3
21579_0,,,,2,2,1,3
C(C(C=C)C(C(C=O)=O)(CC)O)=O,,,5,1,1,0,1
21581_0,,,,2,2,1,3
C1OC(C(C=1)=O)C(C(C=O)=O)(CC)O,,,5,1,2,0,2
21581_1,,,,2,2,1,3
21583_0,,,,2,2,1,3
C(C=O)(C(CC)(CC(C=O)=O)O)=O,,,5,1,1,0,1
21585_0,,,,2,2,1,3
C(C(C=O)C(C(C=O)=O)(CC)O)=O,,,5,1,2,0,2
21585_1,,,,2,2,1,3
21587_0,,,,2,2,1,3
C(CC(C(C=O)=O)(CC)O)=O,,,5,1,1,0,1
21589_0,,,,2,2,1,3
C(C(CO)C(C(C=O)=O)(CC)O)=O,,,5,1,2,0,2
21589_1,,,,2,2,1,3
21591_0,,,,2,2,1,3
C(C(C(C(C=O)=O)(CC)O)O)(C)=O,,,5,1,2,0,2
21591_1,,,,2,2,1,3
21593_0,,,,2,2,1,3
C(CC(C(C=O)=O)(CC)O)(CO)=O,,,5,1,1,0,1
21595_0,,,,2,2,1,3
C(C(C(C(C=O)=O)(CC)O)O)=O,,,5,1,2,0,2
21595_1,,,,2,2,1,3
21597_0,,,,2,2,1,3
C=C(C=O)C(C(C(C(C=O)=O)=O)C)O,,,5,1,1,0,1
21599_0,,,,2,2,1,3
C(C)=CC(C(C(C(C=O)=O)=O)C)O,,,5,1,1,0,1
21601_0,,,,2,2,1,3
C=CCC(C(C(C(C=O)=O)=O)C)O,,,5,1,1,0,1
21603_0,,,,2,2,1,3
C=CC(C(C(C(C=O)=O)=O)C)O,,,5,1,1,0,1
21605_0,,,,2,2,1,3
C1OCC(C=1)(C(C(C(C=O)=O)=O)C)O,,,5,1,1,0,1
21606_0,,,,2,2,1,3
21608_0,,,,2,2,1,3
C(C(C(C(C(C=O)=O)=O)C)O)(O)=O,,,5,1,3,0,3
21610_0,,,,2,2,1,3
C(C(C)(C(C(C(C=O)=O)=O)C)O)=O,,,5,1,1,0,1
21612_0,,,,2,2,1,3
C(C(C(C(C(C=O)=O)=O)C)O)(C)=O,,,5,1,1,0,1
21613_0,,,,2,2,1,3
21615_0,,,,2,2,1,3
C(C(C(C(C)C(C)O)=O)=O)=O,,,5,1,1,0,1
21617_0,,,,2,2,1,3
C(C(C(C(C)C(CCO)O)=O)=O)=O,,,5,1,1,0,1
21619_0,,,,2,2,1,3
C(C(C(C(C)C(C)(CO)O)=O)=O)=O,,,5,1,1,0,1
21621_0,,,,2,2,1,3
C(C(C=C)(C(C(C(C=O)=O)=O)C)O)=O,,,5,1,1,0,1
21623_0,,,,2,2,1,3
C=CC(C(C(C(C(C=O)=O)=O)C)O)=O,,,5,1,1,0,1
21625_0,,,,2,2,1,3
C(C(C(C(C(C=O)=O)=O)C)O)=CC=O,,,5,1,1,0,1
21627_0,,,,2,2,1,3
C(C(C(C(C=O)=O)=O)C)(O)=O,,,5,1,3,0,3
21629_0,,,,2,2,1,3
C(C(C(C(C)C(C(O)O)O)=O)=O)=O,,,5,1,1,0,1
21631_0,,,,2,2,1,3
C(C(C(C(C)C(C(C)O)O)=O)=O)=O,,,5,1,1,0,1
21633_0,,,,2,2,1,3
C(C(C(C(C)CO)=O)=O)=O,,,5,1,3,0,3
21635_0,,,,2,2,1,3
C(C(C(C(C)C(CO)O)=O)=O)=O,,,5,1,3,0,3
21637_0,,,,2,2,1,3
C(C(CC)(C(C(C=O)=O)C)O)=O,,,5,1,1,0,1
21639_0,,,,2,2,1,3
C(CC(C=O)C(C=O)(CC)O)=O,,,5,1,1,0,1
21641_0,,,,2,2,1,3
C(C(CC)(CC(C(C)=O)=O)O)=O,,,5,1,1,0,1
21643_0,,,,2,2,1,3
C(C(CC)(C(C(C(O)=O)=O)C)O)=O,,,5,1,1,0,1
21645_0,,,,2,2,1,3
C(C(CC)(C(C(O)=O)C(C)=O)O)=O,,,5,1,2,0,2
21645_1,,,,2,2,1,3
21647_0,,,,2,2,1,3
C(C(CC)(CC(CC(O)=O)=O)O)=O,,,5,1,1,0,1
21649_0,,,,2,2,1,3
C(C(CC)(C1C(C(OC1)=O)=O)O)=O,,,5,1,2,0,2
21649_1,,,,2,2,1,3
21651_0,,,,2,2,1,3
C(C(CC)(C1C(OCC1=O)=O)O)=O,,,5,1,2,0,2
21651_1,,,,2,2,1,3
21653_0,,,,2,2,1,3
C(C(CC)(C1C(CC(O1)=O)=O)O)=O,,,5,1,2,0,2
21653_1,,,,2,2,1,3
21655_0,,,,2,2,1,3
C(C(C(C=O)=C)C(C=O)(CC)O)=O,,,5,1,1,0,1
21657_0,,,,2,2,1,3
C(C(CC)(CC(C=CC=O)=O)O)=O,,,5,1,1,0,1
21659_0,,,,2,2,1,3
C(C(CC)(C(C=C)C(C=O)=O)O)=O,,,5,1,1,0,1
21661_0,,,,2,2,1,3
C(C(C=CC=O)C(C=O)(CC)O)=O,,,5,1,1,0,1
21663_0,,,,2,2,1,3
C(C(C=C)C(C=O)(CC)O)=O,,,5,1,1,0,1
21665_0,,,,2,2,1,3
C(C(CC)(C1C(C=CO1)=O)O)=O,,,5,1,2,0,2
21665_1,,,,2,2,1,3
21667_0,,,,2,2,1,3
C(C(CC)(C(C(CO)=O)O)O)=O,,,5,1,2,0,2
21667_1,,,,2,2,1,3
21669_0,,,,2,2,1,3
C(C(CC)(CC(C=O)=O)O)=O,,,5,1,1,0,1
21671_0,,,,2,2,1,3
C(C(C=O)C(C=O)(CC)O)=O,,,5,1,2,0,2
21671_1,,,,2,2,1,3
21673_0,,,,2,2,1,3
C(C(CC)(C(C(C=O)=O)CO)O)=O,,,5,1,2,0,2
21673_1,,,,2,2,1,3
21675_0,,,,2,2,1,3
C(C(C(C=O)C(C=O)(CC)O)O)=O,,,5,1,2,0,2
21675_1,,,,2,2,1,3
21677_0,,,,2,2,1,3
C(C(CC)(C(C=O)C(CO)=O)O)=O,,,5,1,2,0,2
21677_1,,,,2,2,1,3
21679_0,,,,2,2,1,3
C(C(CC)(C(C(CC=O)=O)O)O)=O,,,5,1,2,0,2
21679_1,,,,2,2,1,3
21681_0,,,,2,2,1,3
C(C(CC)(CC(C(C=O)O)=O)O)=O,,,5,1,1,0,1
21683_0,,,,2,2,1,3
C(C(CC)(CC=O)O)=O,,,5,1,1,0,1
21685_0,,,,2,2,1,3
C(C(CC)(C(C(C=O)=O)O)O)=O,,,5,1,2,0,2
21685_1,,,,2,2,1,3
21687_0,,,,2,2,1,3
C(C(C(C)O)C(C=O)(CC)O)=O,,,5,1,2,0,2
21687_1,,,,2,2,1,3
21689_0,,,,2,2,1,3
C(C(CO)C(C=O)(CC)O)=O,,,5,1,2,0,2
21689_1,,,,2,2,1,3
21691_0,,,,2,2,1,3
C(C(C(CO)O)C(C=O)(CC)O)=O,,,5,1,2,0,2
21691_1,,,,2,2,1,3
21693_0,,,,2,2,1,3
C(C(CC)(C(C(C(C)=O)=O)O)O)=O,,,5,1,2,0,2
21693_1,,,,2,2,1,3
21695_0,,,,2,2,1,3
C(C(CC)(CC(C(CO)=O)=O)O)=O,,,5,1,1,0,1
21697_0,,,,2,2,1,3
C(C(CC)(C(C(C)=O)O)O)=O,,,5,1,2,0,2
21697_1,,,,2,2,1,3
21699_0,,,,2,2,1,3
C(C(CC)(CC(CO)=O)O)=O,,,5,1,1,0,1
21701_0,,,,2,2,1,3
C(C(CC)(C(C(CCO)=O)O)O)=O,,,5,1,2,0,2
21701_1,,,,2,2,1,3
21703_0,,,,2,2,1,3
C(C(CC)(C(C(CO)=O)CO)O)=O,,,5,1,2,0,2
21703_1,,,,2,2,1,3
21705_0,,,,2,2,1,3
C(C(CC)(CC(C(CO)O)=O)O)=O,,,5,1,1,0,1
21707_0,,,,2,2,1,3
C(C(CC)(CC(C(O)=O)=O)O)=O,,,5,1,1,0,1
21709_0,,,,2,2,1,3
C(C(C=O)C(C=O)(CC)O)(O)=O,,,5,1,2,0,2
21709_1,,,,2,2,1,3
21711_0,,,,2,2,1,3
C(C(CC)(C(C(C(O)=O)=O)O)O)=O,,,5,1,2,0,2
21711_1,,,,2,2,1,3
21713_0,,,,2,2,1,3
C(C(C(C=O)=O)C(C=O)(CC)O)=O,,,5,1,2,0,2
21713_1,,,,2,2,1,3
21715_0,,,,2,2,1,3
C(C(CC)(C1C(C(CO1)O)=O)O)=O,,,5,1,2,0,2
21715_1,,,,2,2,1,3
21717_0,,,,2,2,1,3
C(C(CC)(C1C(C(O)OC1)=O)O)=O,,,5,1,2,0,2
21717_1,,,,2,2,1,3
21719_0,,,,2,2,1,3
C(C(CC)(C1C(COC1O)=O)O)=O,,,5,1,2,0,2
21719_1,,,,2,2,1,3
21721_0,,,,2,2,1,3
C(C(CC)(C1C(CC(O1)O)=O)O)=O,,,5,1,2,0,2
21721_1,,,,2,2,1,3
21723_0,,,,2,2,1,3
C(C(CC)(CC(C(C=O)=O)=O)O)=O,,,5,1,1,0,1
21725_0,,,,2,2,1,3
C(C(CC)(C(C=O)O)O)=O,,,5,1,3,0,3
21725_1,,,,2,2,1,3
21727_0,,,,2,2,1,3
C(C(C(C(C=O)=O)C)O)(CC)=O,,,5,1,1,0,1
21729_0,,,,2,2,1,3
C(C(C(C=O)CC=O)O)(CC)=O,,,5,1,1,0,1
21731_0,,,,2,2,1,3
C(C(CC(C(C)=O)=O)O)(CC)=O,,,5,1,1,0,1
21733_0,,,,2,2,1,3
C(C(C(C(C(O)=O)=O)C)O)(CC)=O,,,5,1,1,0,1
21735_0,,,,2,2,1,3
C(C)(C(C(O)=O)C(C(CC)=O)O)=O,,,5,1,2,0,2
21735_1,,,,2,2,1,3
21737_0,,,,2,2,1,3
C(CC(C(CC)=O)O)(CC(O)=O)=O,,,5,1,1,0,1
21739_0,,,,2,2,1,3
C(C(C1C(C(OC1)=O)=O)O)(CC)=O,,,5,1,2,0,2
21739_1,,,,2,2,1,3
21741_0,,,,2,2,1,3
C1(COC(C1C(C(CC)=O)O)=O)=O,,,5,1,2,0,2
21741_1,,,,2,2,1,3
21743_0,,,,2,2,1,3
C(C(C1C(CC(O1)=O)=O)O)(CC)=O,,,5,1,2,0,2
21743_1,,,,2,2,1,3
21745_0,,,,2,2,1,3
C(C(C(C=O)=C)C(C(CC)=O)O)=O,,,5,1,1,0,1
21747_0,,,,2,2,1,3
C(C(CC(C=CC=O)=O)O)(CC)=O,,,5,1,1,0,1
21749_0,,,,2,2,1,3
C(C(C(C=C)C(C=O)=O)O)(CC)=O,,,5,1,1,0,1
21751_0,,,,2,2,1,3
C(C(C=CC=O)C(C(CC)=O)O)=O,,,5,1,1,0,1
21753_0,,,,2,2,1,3
C(C(C=C)C(C(CC)=O)O)=O,,,5,1,1,0,1
21755_0,,,,2,2,1,3
C(C(C1C(C=CO1)=O)O)(CC)=O,,,5,1,2,0,2
21755_1,,,,2,2,1,3
21757_0,,,,2,2,1,3
C(C(C(C(CC)=O)O)O)(CO)=O,,,5,1,3,0,3
21757_1,,,,2,2,1,3
21759_0,,,,2,2,1,3
C(C(CC(C=O)=O)O)(CC)=O,,,5,1,2,0,2
21761_0,,,,2,2,1,3
C(C(C=O)C(C(CC)=O)O)=O,,,5,1,3,0,3
21761_1,,,,2,2,1,3
21763_0,,,,2,2,1,3
C(C(C(C(C=O)=O)CO)O)(CC)=O,,,5,1,2,0,2
21763_1,,,,2,2,1,3
21765_0,,,,2,2,1,3
C(C(C(C=O)C(C=O)O)O)(CC)=O,,,5,1,2,0,2
21765_1,,,,2,2,1,3
21767_0,,,,2,2,1,3
C(CO)(C(C=O)C(C(CC)=O)O)=O,,,5,1,2,0,2
21767_1,,,,2,2,1,3
21769_0,,,,2,2,1,3
C(CC(C(C(C(CC)=O)O)O)=O)=O,,,5,1,2,0,2
21769_1,,,,2,2,1,3
21771_0,,,,2,2,1,3
C(CC(C(CC)=O)O)(C(C=O)O)=O,,,5,1,1,0,1
21773_0,,,,2,2,1,3
C(CC(C(CC)=O)O)=O,,,5,1,4,0,4
21775_0,,,,2,2,1,3
C(C(C(C(C=O)=O)O)O)(CC)=O,,,5,1,3,0,3
21775_1,,,,2,2,1,3
21777_0,,,,2,2,1,3
C(C(C(C)O)C(C(CC)=O)O)=O,,,5,1,3,0,3
21777_1,,,,2,2,1,3
21779_0,,,,2,2,1,3
C(C(CO)C(C(CC)=O)O)=O,,,5,1,3,0,3
21779_1,,,,2,2,1,3
21781_0,,,,2,2,1,3
C(C(C(CO)O)C(C(CC)=O)O)=O,,,5,1,2,0,2
21781_1,,,,2,2,1,3
21783_0,,,,2,2,1,3
C(C(C(C(C(C)=O)=O)O)O)(CC)=O,,,5,1,2,0,2
21783_1,,,,2,2,1,3
21785_0,,,,2,2,1,3
C(C(CC(C(CO)=O)=O)O)(CC)=O,,,5,1,1,0,1
21787_0,,,,2,2,1,3
C(C(C(C(CC)=O)O)O)(C)=O,,,5,1,3,0,3
21787_1,,,,2,2,1,3
21789_0,,,,2,2,1,3
C(CC(C(CC)=O)O)(CO)=O,,,5,1,2,0,2
21791_0,,,,2,2,1,3
C(C(C(C(CC)=O)O)O)(CCO)=O,,,5,1,2,0,2
21791_1,,,,2,2,1,3
21793_0,,,,2,2,1,3
C(CO)(C(CO)C(C(CC)=O)O)=O,,,5,1,2,0,2
21793_1,,,,2,2,1,3
21795_0,,,,2,2,1,3
C(CC(C(CC)=O)O)(C(CO)O)=O,,,5,1,1,0,1
21797_0,,,,2,2,1,3
C(C(CC(C(O)=O)=O)O)(CC)=O,,,5,1,2,0,2
21799_0,,,,2,2,1,3
C(C(C=O)C(C(CC)=O)O)(O)=O,,,5,1,3,0,3
21799_1,,,,2,2,1,3
21801_0,,,,2,2,1,3
C(C(C(C(C(O)=O)=O)O)O)(CC)=O,,,5,1,2,0,2
21801_1,,,,2,2,1,3
21803_0,,,,2,2,1,3
C(C(C(C=O)=O)C(C(CC)=O)O)=O,,,5,1,2,0,2
21803_1,,,,2,2,1,3
21805_0,,,,2,2,1,3
C(C(C1C(C(CO1)O)=O)O)(CC)=O,,,5,1,2,0,2
21805_1,,,,2,2,1,3
21807_0,,,,2,2,1,3
C(C(C1C(C(O)OC1)=O)O)(CC)=O,,,5,1,2,0,2
21807_1,,,,2,2,1,3
21809_0,,,,2,2,1,3
C1(COC(C1C(C(CC)=O)O)O)=O,,,5,1,2,0,2
21809_1,,,,2,2,1,3
21811_0,,,,2,2,1,3
C(C(C1C(CC(O1)O)=O)O)(CC)=O,,,5,1,2,0,2
21811_1,,,,2,2,1,3
21813_0,,,,2,2,1,3
C(C(CC(C(C=O)=O)=O)O)(CC)=O,,,5,1,1,0,1
21815_0,,,,2,2,1,3
C(C(C(C=O)O)O)(CC)=O,,,5,1,4,0,4
21815_1,,,,2,2,1,3
21817_0,,,,2,2,1,3
C(CCC(C(C(C=O)=O)C)O)=O,,,5,1,1,0,1
21819_0,,,,2,2,1,3
C(C)(C(C)(C(C(C=O)=O)C)O)=O,,,5,1,1,0,1
21821_0,,,,2,2,1,3
C(C(CC)(C(C(C=O)=O)C)O)(O)=O,,,5,1,1,0,1
21823_0,,,,2,2,1,3
C(CC(C)(C(C(C=O)=O)C)O)(O)=O,,,5,1,1,0,1
21825_0,,,,2,2,1,3
C(C(C)C(C(C(C=O)=O)C)O)(O)=O,,,5,1,1,0,1
21827_0,,,,2,2,1,3
C1(C(CCO1)(C(C(C=O)=O)C)O)=O,,,5,1,1,0,1
21829_0,,,,2,2,1,3
C1(CC(CO1)(C(C(C=O)=O)C)O)=O,,,5,1,1,0,1
21831_0,,,,2,2,1,3
C(C(C(C(C=O)=O)C)O)=C(C=O)C,,,5,1,1,0,1
21833_0,,,,2,2,1,3
C(C(C(C(C=O)=O)C)O)(C)=CC=O,,,5,1,1,0,1
21835_0,,,,2,2,1,3
C=C(C=O)CC(C(C(C=O)=O)C)O,,,5,1,1,0,1
21837_0,,,,2,2,1,3
C(CC(C(C(C(C=O)=O)C)O)=C)=O,,,5,1,1,0,1
21839_0,,,,2,2,1,3
C(C(C(C(C=O)=O)C)O)=CC(C)=O,,,5,1,1,0,1
21841_0,,,,2,2,1,3
C(C(C)(C(C(C=O)=O)C)O)=CC=O,,,5,1,1,0,1
21843_0,,,,2,2,1,3
C(C(CC=C)(C(C(C=O)=O)C)O)=O,,,5,1,1,0,1
21845_0,,,,2,2,1,3
C(C(C(C(C=O)=O)C)O)(CC=C)=O,,,5,1,1,0,1
21847_0,,,,2,2,1,3
C(C(C=CC)(C(C(C=O)=O)C)O)=O,,,5,1,1,0,1
21849_0,,,,2,2,1,3
C(C)=CC(C(C(C(C=O)=O)C)O)=O,,,5,1,1,0,1
21851_0,,,,2,2,1,3
C(C(C(C(C=O)=O)C)O)=CC(C=O)=O,,,5,1,1,0,1
21853_0,,,,2,2,1,3
C(C(C=CC=O)(C(C(C=O)=O)C)O)=O,,,5,1,1,0,1
21855_0,,,,2,2,1,3
C(C=O)(C(C)C(C(C=CC=O)=O)O)=O,,,5,1,1,0,1
21857_0,,,,2,2,1,3
C(CC=CC(C(C(C=O)=O)C)O)=O,,,5,1,1,0,1
21859_0,,,,2,2,1,3
C(CC(C(C(C=O)=O)C)O)=CC=O,,,5,1,1,0,1
21860_0,,,,2,2,1,3
21862_0,,,,2,2,1,3
C(C)=C(C=O)C(C(C(C=O)=O)C)O,,,5,1,1,0,1
21864_0,,,,2,2,1,3
C(C(C(C(C=O)=O)C)O)=C(C=O)C=O,,,5,1,1,0,1
21866_0,,,,2,2,1,3
C(C=O)(C(C)C(C(C=O)=CC=O)O)=O,,,5,1,1,0,1
21868_0,,,,2,2,1,3
C=C(C=O)C(C(C(C=O)=O)C)O,,,5,1,1,0,1
21870_0,,,,2,2,1,3
C(C)=CC(C(C(C=O)=O)C)O,,,5,1,1,0,1
21872_0,,,,2,2,1,3
C=CCC(C(C(C=O)=O)C)O,,,5,1,1,0,1
21874_0,,,,2,2,1,3
C=CC(C(C(C(C=O)=O)C)O)O,,,5,1,1,0,1
21876_0,,,,2,2,1,3
C=CC(C(C(C=O)=O)C)O,,,5,1,1,0,1
21878_0,,,,2,2,1,3
C(C(C(C=O)=C)(C(C(C=O)=O)C)O)=O,,,5,1,1,0,1
21880_0,,,,2,2,1,3
C=C(C=O)C(C(C(C(C=O)=O)C)O)=O,,,5,1,1,0,1
21882_0,,,,2,2,1,3
C=C(C(C=O)=O)C(C(C(C=O)=O)C)O,,,5,1,1,0,1
21884_0,,,,2,2,1,3
C1OCC(C=1)(C(C(C=O)=O)C)O,,,5,1,1,0,1
21886_0,,,,2,2,1,3
C(C(C(C)C(C(CO)O)O)=O)=O,,,5,1,1,0,1
21887_0,,,,2,2,1,3
21889_0,,,,2,2,1,3
C(C(C(C)C(CO)(CO)O)=O)=O,,,5,1,3,0,3
21890_0,,,,2,2,1,3
21892_0,,,,2,2,1,3
C(C(C)(C(C(C=O)=O)C)O)=O,,,5,1,2,0,2
21894_0,,,,2,2,1,3
C(C(C(C(C=O)=O)C)O)(C)=O,,,5,1,2,0,2
21895_0,,,,2,2,1,3
21897_0,,,,2,2,1,3
C(C(CCO)(C(C(C=O)=O)C)O)=O,,,5,1,1,0,1
21899_0,,,,2,2,1,3
C(C(C(C(C=O)=O)C)O)(CCO)=O,,,5,1,1,0,1
21900_0,,,,2,2,1,3
21902_0,,,,2,2,1,3
C(C(CC(C(C(C=O)=O)C)O)O)=O,,,5,1,1,0,1
21903_0,,,,2,2,1,3
21905_0,,,,2,2,1,3
C(CC(CO)(C(C(C=O)=O)C)O)=O,,,5,1,1,0,1
21906_0,,,,2,2,1,3
21908_0,,,,2,2,1,3
C(C(C(C)(C(C(C=O)=O)C)O)O)=O,,,5,1,1,0,1
21910_0,,,,2,2,1,3
C(C(C(C)C(C)O)=O)=O,,,5,1,1,0,1
21911_0,,,,2,2,1,3
21912_0,,,,2,2,1,3
21913_0,,,,2,2,1,3
21915_0,,,,2,2,1,3
C(C(C(C)C(CC(C)O)O)=O)=O,,,5,1,1,0,1
21917_0,,,,2,2,1,3
C(C(C(C)C(C(C(C)O)O)O)=O)=O,,,5,1,1,0,1
21919_0,,,,2,2,1,3
C(C(C(C)C(CCO)O)=O)=O,,,5,1,1,0,1
21921_0,,,,2,2,1,3
C(C(C(C)C(CC(CO)O)O)=O)=O,,,5,1,1,0,1
21923_0,,,,2,2,1,3
C(C)(C(CO)(C(C(C=O)=O)C)O)=O,,,5,1,1,0,1
21925_0,,,,2,2,1,3
C(CO)(C(C)(C(C(C=O)=O)C)O)=O,,,5,1,1,0,1
21927_0,,,,2,2,1,3
C(C(C(C)O)(C(C(C=O)=O)C)O)=O,,,5,1,2,0,2
21929_0,,,,2,2,1,3
C(C(C(C(C=O)=O)C)O)(C(C)O)=O,,,5,1,1,0,1
21930_0,,,,2,2,1,3
21932_0,,,,2,2,1,3
C(C(C(C)C(C)(CO)O)=O)=O,,,5,1,1,0,1
21934_0,,,,2,2,1,3
C(C(C(C)C(CO)(CCO)O)=O)=O,,,5,1,1,0,1
21936_0,,,,2,2,1,3
C(C(C(C)C(C(CCO)O)O)=O)=O,,,5,1,1,0,1
21938_0,,,,2,2,1,3
C(C(C(C)C(C)(C(CO)O)O)=O)=O,,,5,1,1,0,1
21939_0,,,,2,2,1,3
21941_0,,,,2,2,1,3
C(CC(C(C(C=O)=O)C)O)(O)=O,,,5,1,1,0,1
21943_0,,,,2,2,1,3
C(C(CO)(C(C(C=O)=O)C)O)(O)=O,,,5,1,3,0,3
21945_0,,,,2,2,1,3
C(CC(C=O)(C(C(C=O)=O)C)O)=O,,,5,1,1,0,1
21947_0,,,,2,2,1,3
C(CC(C(C(C(C=O)=O)C)O)=O)=O,,,5,1,1,0,1
21948_0,,,,2,2,1,3
21950_0,,,,2,2,1,3
C(C(C(C)C1(COCC1O)O)=O)=O,,,5,1,1,0,1
21952_0,,,,2,2,1,3
C(C(C(C)C1(C(O)OCC1)O)=O)=O,,,5,1,1,0,1
21954_0,,,,2,2,1,3
C(C(C(C)C1(COC(C1)O)O)=O)=O,,,5,1,1,0,1
21956_0,,,,2,2,1,3
C(C(C(C)=O)(C(C(C=O)=O)C)O)=O,,,5,1,1,0,1
21958_0,,,,2,2,1,3
C(C(C(C(C(C=O)=O)C)O)=O)(C)=O,,,5,1,1,0,1
21960_0,,,,2,2,1,3
C(C=O)(C(C)C(C(C=O)=O)(C)O)=O,,,5,1,1,0,1
21962_0,,,,2,2,1,3
C(C(C=C)(C(C(C=O)=O)C)O)=O,,,5,1,1,0,1
21964_0,,,,2,2,1,3
C=CC(C(C(C(C=O)=O)C)O)=O,,,5,1,1,0,1
21966_0,,,,2,2,1,3
C(C(C(C(C=O)=O)C)O)=CC=O,,,5,1,1,0,1
21967_0,,,,2,2,1,3
21969_0,,,,2,2,1,3
C(C(C(C)C(C(O)O)O)=O)=O,,,5,1,1,0,1
21971_0,,,,2,2,1,3
C(C(C(C)C(C(C)O)O)=O)=O,,,5,1,1,0,1
21973_0,,,,2,2,1,3
C(C(C(C)CO)=O)=O,,,5,1,3,0,3
21975_0,,,,2,2,1,3
C(C(C(C)C(CO)O)=O)=O,,,5,1,4,0,4
21977_0,,,,2,2,1,3
C(C(C=C)C(CCC=O)(CO)O)=O,,,5,1,1,0,1
21979_0,,,,2,2,1,3
C(CCC(CO)(CC(C=O)=O)O)=O,,,5,1,2,0,2
21981_0,,,,2,2,1,3
C(C(C=O)C(CCC=O)(CO)O)=O,,,5,1,3,0,3
21981_1,,,,2,2,1,3
21983_0,,,,2,2,1,3
C(CCC(CO)(CC=O)O)=O,,,5,1,2,0,2
21985_0,,,,2,2,1,3
C(C(CO)C(CCC=O)(CO)O)=O,,,5,1,3,0,3
21985_1,,,,2,2,1,3
21987_0,,,,2,2,1,3
C(CCC(CO)(C(C(C)=O)O)O)=O,,,5,1,3,0,3
21987_1,,,,2,2,1,3
21989_0,,,,2,2,1,3
C(CCC(CO)(CC(CO)=O)O)=O,,,5,1,2,0,2
21991_0,,,,2,2,1,3
C(CCC(CO)(C(C=O)O)O)=O,,,5,1,3,0,3
21991_1,,,,2,2,1,3
21993_0,,,,2,2,1,3
C(C(C=C)C(CCC(CO)=O)O)=O,,,5,1,1,0,1
21995_0,,,,2,2,1,3
C(CO)(CCC(CC(C=O)=O)O)=O,,,5,1,3,0,3
21997_0,,,,2,2,1,3
C(C(C=O)C(CCC(CO)=O)O)=O,,,5,1,4,0,4
21997_1,,,,2,2,1,3
21999_0,,,,2,2,1,3
C(CC(CCC(CO)=O)O)=O,,,5,1,4,0,4
22001_0,,,,2,2,1,3
C(C(CO)C(CCC(CO)=O)O)=O,,,5,1,3,0,3
22001_1,,,,2,2,1,3
22003_0,,,,2,2,1,3
C(C)(C(C(CCC(CO)=O)O)O)=O,,,5,1,4,0,4
22003_1,,,,2,2,1,3
22005_0,,,,2,2,1,3
C(CO)(CC(CCC(CO)=O)O)=O,,,5,1,3,0,3
22007_0,,,,2,2,1,3
C(C(C(CCC(CO)=O)O)O)=O,,,5,1,6,0,6
22007_1,,,,2,2,1,3
22009_0,,,,2,2,1,3
C(CC(C(CO)=O)C(C=CC)O)=O,,,5,1,1,0,1
22011_0,,,,2,2,1,3
C(CO)(C(C(CC=C)O)CC=O)=O,,,5,1,1,0,1
22013_0,,,,2,2,1,3
C(CC(C(CO)=O)C(C=C)O)=O,,,5,1,2,0,2
22015_0,,,,2,2,1,3
C(CC(C(CO)=O)C(C=O)O)=O,,,5,1,4,0,4
22017_0,,,,2,2,1,3
C(C(C(C(CO)=O)CC=O)O)(O)=O,,,5,1,2,0,2
22019_0,,,,2,2,1,3
C(CC(C(CO)=O)C(C=O)(C)O)=O,,,5,1,2,0,2
22021_0,,,,2,2,1,3
C(CC(C(CO)=O)C(C(C)=O)O)=O,,,5,1,2,0,2
22022_0,,,,2,2,1,3
22024_0,,,,2,2,1,3
C(CO)(C(C(C)O)CC=O)=O,,,5,1,2,0,2
22026_0,,,,2,2,1,3
C(CO)(C(C(CCO)O)CC=O)=O,,,5,1,2,0,2
22028_0,,,,2,2,1,3
C(CO)(C(C(CO)(C)O)CC=O)=O,,,5,1,2,0,2
22030_0,,,,2,2,1,3
C(C(C(CO)=O)CC=O)(O)=O,,,5,1,4,0,4
22032_0,,,,2,2,1,3
C(CO)(C(C(C(O)O)O)CC=O)=O,,,5,1,2,0,2
22034_0,,,,2,2,1,3
C(CO)(C(C(C(C)O)O)CC=O)=O,,,5,1,2,0,2
22035_0,,,,2,2,1,3
22037_0,,,,2,2,1,3
C(CO)(C(C(CO)O)CC=O)=O,,,5,1,3,0,3
22039_0,,,,2,2,1,3
C(CCC(C(C(C=CC)O)O)=O)=O,,,5,1,2,0,2
22039_1,,,,2,2,1,3
22041_0,,,,2,2,1,3
C(CCC=O)(C(C(CC=C)O)O)=O,,,5,1,2,0,2
22041_1,,,,2,2,1,3
22043_0,,,,2,2,1,3
C(CCC(C(C(C=C)O)O)=O)=O,,,5,1,2,0,2
22043_1,,,,2,2,1,3
22044_0,,,,2,2,1,3
22044_1,,,,2,2,1,3
22046_0,,,,2,2,1,3
C(C(C(C(CCC=O)=O)O)O)(O)=O,,,5,1,5,0,5
22046_1,,,,2,2,1,3
22048_0,,,,2,2,1,3
C(CCC(C(C(C=O)(C)O)O)=O)=O,,,5,1,3,0,3
22048_1,,,,2,2,1,3
22049_0,,,,2,2,1,3
22049_1,,,,2,2,1,3
22050_0,,,,2,2,1,3
22050_1,,,,2,2,1,3
22052_0,,,,2,2,1,3
C(CCC=O)(C(C(C)O)O)=O,,,5,1,2,0,2
22052_1,,,,2,2,1,3
22054_0,,,,2,2,1,3
C(CCC=O)(C(C(CCO)O)O)=O,,,5,1,2,0,2
22054_1,,,,2,2,1,3
22056_0,,,,2,2,1,3
C(CCC=O)(C(C(CO)(C)O)O)=O,,,5,1,2,0,2
22056_1,,,,2,2,1,3
22057_0,,,,2,2,1,3
22057_1,,,,2,2,1,3
22059_0,,,,2,2,1,3
C(CCC=O)(C(C(C(O)O)O)O)=O,,,5,1,2,0,2
22059_1,,,,2,2,1,3
22061_0,,,,2,2,1,3
C(CCC=O)(C(C(C(C)O)O)O)=O,,,5,1,2,0,2
22061_1,,,,2,2,1,3
22062_0,,,,2,2,1,3
22062_1,,,,2,2,1,3
22063_0,,,,2,2,1,3
22063_1,,,,2,2,1,3
22065_0,,,,2,2,1,3
C(C(CC(CO)=O)C(C=CC)O)=O,,,5,1,1,0,1
22067_0,,,,2,2,1,3
C(C(C(CC=C)O)CC(CO)=O)=O,,,5,1,1,0,1
22069_0,,,,2,2,1,3
C(C(CC(CO)=O)C(C=C)O)=O,,,5,1,2,0,2
22070_0,,,,2,2,1,3
22072_0,,,,2,2,1,3
C(C(C(C=O)CC(CO)=O)O)(O)=O,,,5,1,4,0,4
22074_0,,,,2,2,1,3
C(CC(C=O)C(C=O)(C)O)(CO)=O,,,5,1,2,0,2
22076_0,,,,2,2,1,3
C(C(CC(CO)=O)C(C(C)=O)O)=O,,,5,1,2,0,2
22077_0,,,,2,2,1,3
22079_0,,,,2,2,1,3
C(C(C(C)O)CC(CO)=O)=O,,,5,1,3,0,3
22081_0,,,,2,2,1,3
C(C(C(CCO)O)CC(CO)=O)=O,,,5,1,2,0,2
22083_0,,,,2,2,1,3
C(C(C(CO)(C)O)CC(CO)=O)=O,,,5,1,2,0,2
22085_0,,,,2,2,1,3
C(C(C=O)CC(CO)=O)(O)=O,,,5,1,4,0,4
22087_0,,,,2,2,1,3
C(C(C(C(O)O)O)CC(CO)=O)=O,,,5,1,2,0,2
22089_0,,,,2,2,1,3
C(C(C(C(C)O)O)CC(CO)=O)=O,,,5,1,2,0,2
22091_0,,,,2,2,1,3
C(C(CO)CC(CO)=O)=O,,,5,1,6,0,6
22093_0,,,,2,2,1,3
C(C(C(CO)O)CC(CO)=O)=O,,,5,1,7,0,7
22095_0,,,,2,2,1,3
C(C(C=C)C(CCO)(CC=O)O)=O,,,5,1,1,0,1
22096_0,,,,2,2,1,3
22097_0,,,,2,2,1,3
22097_1,,,,2,2,1,3
22099_0,,,,2,2,1,3
C(CC(CCO)(CC=O)O)=O,,,5,1,1,0,1
22101_0,,,,2,2,1,3
C(C(CO)C(CCO)(CC=O)O)=O,,,5,1,2,0,2
22101_1,,,,2,2,1,3
22103_0,,,,2,2,1,3
C(CC(CCO)(C(C(C)=O)O)O)=O,,,5,1,2,0,2
22103_1,,,,2,2,1,3
22105_0,,,,2,2,1,3
C(CC(CCO)(CC(CO)=O)O)=O,,,5,1,1,0,1
22106_0,,,,2,2,1,3
22106_1,,,,2,2,1,3
22108_0,,,,2,2,1,3
C(C(C=C)C(CC(CCO)=O)O)=O,,,5,1,1,0,1
22110_0,,,,2,2,1,3
C(CCO)(CC(CC(C=O)=O)O)=O,,,5,1,1,0,1
22112_0,,,,2,2,1,3
C(C(C=O)C(CC(CCO)=O)O)=O,,,5,1,2,0,2
22112_1,,,,2,2,1,3
22114_0,,,,2,2,1,3
C(CC(CC(CCO)=O)O)=O,,,5,1,2,0,2
22116_0,,,,2,2,1,3
C(C(CO)C(CC(CCO)=O)O)=O,,,5,1,2,0,2
22116_1,,,,2,2,1,3
22118_0,,,,2,2,1,3
C(CCO)(CC(C(C(C)=O)O)O)=O,,,5,1,2,0,2
22118_1,,,,2,2,1,3
22120_0,,,,2,2,1,3
C(CCO)(CC(CC(CO)=O)O)=O,,,5,1,1,0,1
22122_0,,,,2,2,1,3
C(CCO)(CC(C(C=O)O)O)=O,,,5,1,3,0,3
22122_1,,,,2,2,1,3
22124_0,,,,2,2,1,3
C(C(CO)C(C=CC)O)(CC=O)=O,,,5,1,2,0,2
22124_1,,,,2,2,1,3
22126_0,,,,2,2,1,3
C(C(CO)C(CC=C)O)(CC=O)=O,,,5,1,2,0,2
22126_1,,,,2,2,1,3
22128_0,,,,2,2,1,3
C(C(CO)C(C=C)O)(CC=O)=O,,,5,1,2,0,2
22128_1,,,,2,2,1,3
22129_0,,,,2,2,1,3
22129_1,,,,2,2,1,3
22130_0,,,,2,2,1,3
22130_1,,,,2,2,1,3
22132_0,,,,2,2,1,3
C(C(CO)C(C=O)(C)O)(CC=O)=O,,,5,1,2,0,2
22132_1,,,,2,2,1,3
22134_0,,,,2,2,1,3
C(C(CO)C(C(C)=O)O)(CC=O)=O,,,5,1,2,0,2
22134_1,,,,2,2,1,3
22136_0,,,,2,2,1,3
C(C(CO)C(CC=O)O)(CC=O)=O,,,5,1,3,0,3
22136_1,,,,2,2,1,3
22138_0,,,,2,2,1,3
C(CC(C(CO)C(C)O)=O)=O,,,5,1,3,0,3
22138_1,,,,2,2,1,3
22140_0,,,,2,2,1,3
C(CC(C(CO)C(CCO)O)=O)=O,,,5,1,2,0,2
22140_1,,,,2,2,1,3
22142_0,,,,2,2,1,3
C(CC(C(CO)C(C)(CO)O)=O)=O,,,5,1,2,0,2
22142_1,,,,2,2,1,3
22143_0,,,,2,2,1,3
22143_1,,,,2,2,1,3
22145_0,,,,2,2,1,3
C(CC(C(CO)C(C(O)O)O)=O)=O,,,5,1,2,0,2
22145_1,,,,2,2,1,3
22147_0,,,,2,2,1,3
C(CC(C(CO)C(C(C)O)O)=O)=O,,,5,1,2,0,2
22147_1,,,,2,2,1,3
22148_0,,,,2,2,1,3
22148_1,,,,2,2,1,3
22149_0,,,,2,2,1,3
22149_1,,,,2,2,1,3
22151_0,,,,2,2,1,3
C(CCO)(C(C=O)C(C=CC)O)=O,,,5,1,2,0,2
22151_1,,,,2,2,1,3
22153_0,,,,2,2,1,3
C(C(C(CCO)=O)C(CC=C)O)=O,,,5,1,2,0,2
22153_1,,,,2,2,1,3
22155_0,,,,2,2,1,3
C(CCO)(C(C=O)C(C=C)O)=O,,,5,1,2,0,2
22155_1,,,,2,2,1,3
22156_0,,,,2,2,1,3
22156_1,,,,2,2,1,3
22158_0,,,,2,2,1,3
C(CCO)(C(C=O)C(C(O)=O)O)=O,,,5,1,5,0,5
22158_1,,,,2,2,1,3
22160_0,,,,2,2,1,3
C(CCO)(C(C=O)C(C=O)(C)O)=O,,,5,1,2,0,2
22160_1,,,,2,2,1,3
22162_0,,,,2,2,1,3
C(CCO)(C(C=O)C(C(C)=O)O)=O,,,5,1,2,0,2
22162_1,,,,2,2,1,3
22163_0,,,,2,2,1,3
22163_1,,,,2,2,1,3
22165_0,,,,2,2,1,3
C(C(C(CCO)=O)C(C)O)=O,,,5,1,4,0,4
22165_1,,,,2,2,1,3
22167_0,,,,2,2,1,3
C(C(C(CCO)=O)C(CCO)O)=O,,,5,1,2,0,2
22167_1,,,,2,2,1,3
22169_0,,,,2,2,1,3
C(C(C(CCO)=O)C(C)(CO)O)=O,,,5,1,2,0,2
22169_1,,,,2,2,1,3
22171_0,,,,2,2,1,3
C(C(C=O)C(CCO)=O)(O)=O,,,5,1,5,0,5
22171_1,,,,2,2,1,3
22173_0,,,,2,2,1,3
C(C(C(CCO)=O)C(C(O)O)O)=O,,,5,1,2,0,2
22173_1,,,,2,2,1,3
22175_0,,,,2,2,1,3
C(C(C(CCO)=O)C(C(C)O)O)=O,,,5,1,2,0,2
22175_1,,,,2,2,1,3
22177_0,,,,2,2,1,3
C(C(C(CCO)=O)CO)=O,,,5,1,8,0,8
22177_1,,,,2,2,1,3
22179_0,,,,2,2,1,3
C(C(C(CCO)=O)C(CO)O)=O,,,5,1,7,0,7
22179_1,,,,2,2,1,3
22181_0,,,,2,2,1,3
C(CCC(C(CO)O)(CC=O)O)=O,,,5,1,2,0,2
22183_0,,,,2,2,1,3
C(CC(CCC(C(CO)O)=O)O)=O,,,5,1,1,0,1
22185_0,,,,2,2,1,3
C(C(C(C)O)CC=O)(C(CO)O)=O,,,5,1,2,0,2
22187_0,,,,2,2,1,3
C(C(CO)O)(C(C(O)=O)CC=O)=O,,,5,1,2,0,2
22188_0,,,,2,2,1,3
22190_0,,,,2,2,1,3
C(C(C(C)O)CC(C(CO)O)=O)=O,,,5,1,2,0,2
22192_0,,,,2,2,1,3
C(C(C=O)CC(C(CO)O)=O)(O)=O,,,5,1,2,0,2
22194_0,,,,2,2,1,3
C(C(CO)CC(C(CO)O)=O)=O,,,5,1,6,0,6
22196_0,,,,2,2,1,3
C(CC(CC(CO)O)(CC=O)O)=O,,,5,1,1,0,1
22198_0,,,,2,2,1,3
C(CC(CC(CC(CO)O)=O)O)=O,,,5,1,1,0,1
22200_0,,,,2,2,1,3
C(CC(C(C(CO)O)C(C)O)=O)=O,,,5,1,2,0,2
22200_1,,,,2,2,1,3
22202_0,,,,2,2,1,3
C(C(C(CC=O)=O)C(CO)O)(O)=O,,,5,1,5,0,5
22202_1,,,,2,2,1,3
22203_0,,,,2,2,1,3
22203_1,,,,2,2,1,3
22205_0,,,,2,2,1,3
C(C(C(CC(CO)O)=O)C(C)O)=O,,,5,1,2,0,2
22205_1,,,,2,2,1,3
22207_0,,,,2,2,1,3
C(C(C=O)C(CC(CO)O)=O)(O)=O,,,5,1,3,0,3
22207_1,,,,2,2,1,3
22209_0,,,,2,2,1,3
C(C(C(CC(CO)O)=O)CO)=O,,,5,1,7,0,7
22209_1,,,,2,2,1,3
22211_0,,,,2,2,1,3
C(CCC(C(C=O)CC=O)O)=O,,,5,1,2,0,2
22213_0,,,,2,2,1,3
C(CCC(CC(C(C)=O)=O)O)=O,,,5,1,1,0,1
22215_0,,,,2,2,1,3
C(CCC(C(C(C(O)=O)=O)C)O)=O,,,5,1,1,0,1
22217_0,,,,2,2,1,3
C(CCC(C(C(O)=O)C(C)=O)O)=O,,,5,1,3,0,3
22217_1,,,,2,2,1,3
22219_0,,,,2,2,1,3
C(CC(CC(CCC=O)O)=O)(O)=O,,,5,1,1,0,1
22221_0,,,,2,2,1,3
C(CCC(C1C(C(OC1)=O)=O)O)=O,,,5,1,2,0,2
22221_1,,,,2,2,1,3
22223_0,,,,2,2,1,3
C(CCC(C1C(OCC1=O)=O)O)=O,,,5,1,2,0,2
22223_1,,,,2,2,1,3
22225_0,,,,2,2,1,3
C(CCC(C1C(CC(O1)=O)=O)O)=O,,,5,1,3,0,3
22225_1,,,,2,2,1,3
22227_0,,,,2,2,1,3
C(C(C(C=O)=C)C(CCC=O)O)=O,,,5,1,1,0,1
22229_0,,,,2,2,1,3
C(CCC(CC(C=CC=O)=O)O)=O,,,5,1,2,0,2
22231_0,,,,2,2,1,3
C(CCC(C(C=C)C(C=O)=O)O)=O,,,5,1,2,0,2
22233_0,,,,2,2,1,3
C(C(C=CC=O)C(CCC=O)O)=O,,,5,1,1,0,1
22235_0,,,,2,2,1,3
C(C(C=C)C(CCC=O)O)=O,,,5,1,1,0,1
22237_0,,,,2,2,1,3
C(CCC(C1C(C=CO1)=O)O)=O,,,5,1,2,0,2
22237_1,,,,2,2,1,3
22239_0,,,,2,2,1,3
C(CCC(C(C(CO)=O)O)O)=O,,,5,1,4,0,4
22239_1,,,,2,2,1,3
22241_0,,,,2,2,1,3
C(CCC(CC(C=O)=O)O)=O,,,5,1,3,0,3
22243_0,,,,2,2,1,3
C(C(C=O)C(CCC=O)O)=O,,,5,1,4,0,4
22243_1,,,,2,2,1,3
22245_0,,,,2,2,1,3
C(CCC(C(C(C=O)=O)CO)O)=O,,,5,1,3,0,3
22245_1,,,,2,2,1,3
22247_0,,,,2,2,1,3
C(CCC(C(C=O)C(C=O)O)O)=O,,,5,1,3,0,3
22247_1,,,,2,2,1,3
22249_0,,,,2,2,1,3
C(CCC(C(C=O)C(CO)=O)O)=O,,,5,1,3,0,3
22249_1,,,,2,2,1,3
22251_0,,,,2,2,1,3
C(CCC(C(C(CC=O)=O)O)O)=O,,,5,1,3,0,3
22251_1,,,,2,2,1,3
22253_0,,,,2,2,1,3
C(C(C(CC(CCC=O)O)=O)O)=O,,,5,1,2,0,2
22255_0,,,,2,2,1,3
C(CCC(CC=O)O)=O,,,5,1,3,0,3
22257_0,,,,2,2,1,3
C(CCC(C(C(C=O)=O)O)O)=O,,,5,1,5,0,5
22257_1,,,,2,2,1,3
22259_0,,,,2,2,1,3
C(C(C(C)O)C(CCC=O)O)=O,,,5,1,4,0,4
22259_1,,,,2,2,1,3
22261_0,,,,2,2,1,3
C(C(CO)C(CCC=O)O)=O,,,5,1,4,0,4
22261_1,,,,2,2,1,3
22263_0,,,,2,2,1,3
C(C(C(CO)O)C(CCC=O)O)=O,,,5,1,3,0,3
22263_1,,,,2,2,1,3
22265_0,,,,2,2,1,3
C(CCC(C(C(C(C)=O)=O)O)O)=O,,,5,1,3,0,3
22265_1,,,,2,2,1,3
22267_0,,,,2,2,1,3
C(CCC(CC(C(CO)=O)=O)O)=O,,,5,1,2,0,2
22269_0,,,,2,2,1,3
C(CCC(C(C(C)=O)O)O)=O,,,5,1,4,0,4
22269_1,,,,2,2,1,3
22271_0,,,,2,2,1,3
C(CCC(CC(CO)=O)O)=O,,,5,1,3,0,3
22273_0,,,,2,2,1,3
C(CCC(C(C(CCO)=O)O)O)=O,,,5,1,3,0,3
22273_1,,,,2,2,1,3
22275_0,,,,2,2,1,3
C(CCC(C(C(CO)=O)CO)O)=O,,,5,1,3,0,3
22275_1,,,,2,2,1,3
22277_0,,,,2,2,1,3
C(CCC(CC(C(CO)O)=O)O)=O,,,5,1,2,0,2
22279_0,,,,2,2,1,3
C(CCC(CC(C(O)=O)=O)O)=O,,,5,1,3,0,3
22281_0,,,,2,2,1,3
C(C(C=O)C(CCC=O)O)(O)=O,,,5,1,4,0,4
22281_1,,,,2,2,1,3
22283_0,,,,2,2,1,3
C(CCC(C(C(C(O)=O)=O)O)O)=O,,,5,1,3,0,3
22283_1,,,,2,2,1,3
22285_0,,,,2,2,1,3
C(C(C(C=O)=O)C(CCC=O)O)=O,,,5,1,3,0,3
22285_1,,,,2,2,1,3
22287_0,,,,2,2,1,3
C(CCC(C1C(C(CO1)O)=O)O)=O,,,5,1,3,0,3
22287_1,,,,2,2,1,3
22289_0,,,,2,2,1,3
C(CCC(C1C(C(O)OC1)=O)O)=O,,,5,1,3,0,3
22289_1,,,,2,2,1,3
22291_0,,,,2,2,1,3
C(CCC(C1C(COC1O)=O)O)=O,,,5,1,3,0,3
22291_1,,,,2,2,1,3
22293_0,,,,2,2,1,3
C(CCC(C1C(CC(O1)O)=O)O)=O,,,5,1,3,0,3
22293_1,,,,2,2,1,3
22295_0,,,,2,2,1,3
C(CCC(CC(C(C=O)=O)=O)O)=O,,,5,1,2,0,2
22297_0,,,,2,2,1,3
C(CCC(C(C=O)O)O)=O,,,5,1,7,0,7
22297_1,,,,2,2,1,3
22299_0,,,,2,2,1,3
C(C)(C(C)(C(C=O)CC=O)O)=O,,,5,1,1,0,1
22301_0,,,,2,2,1,3
C(C(CC)(C(C=O)CC=O)O)(O)=O,,,5,1,2,0,2
22303_0,,,,2,2,1,3
C(CC(C)(C(C=O)CC=O)O)(O)=O,,,5,1,3,0,3
22305_0,,,,2,2,1,3
C(C(C)C(C(C=O)CC=O)O)(O)=O,,,5,1,1,0,1
22306_0,,,,2,2,1,3
22307_0,,,,2,2,1,3
22309_0,,,,2,2,1,3
C(CC(C=O)C(C=C(C=O)C)O)=O,,,5,1,1,0,1
22311_0,,,,2,2,1,3
C(CC(C=O)C(C(C)=CC=O)O)=O,,,5,1,1,0,1
22313_0,,,,2,2,1,3
C(C(C(CC(C=O)=C)O)CC=O)=O,,,5,1,1,0,1
22315_0,,,,2,2,1,3
C(CC(C(C(C=O)CC=O)O)=C)=O,,,5,1,1,0,1
22317_0,,,,2,2,1,3
C(CC(C=O)C(C=CC(C)=O)O)=O,,,5,1,1,0,1
22319_0,,,,2,2,1,3
C(CC(C=O)C(C=CC=O)(C)O)=O,,,5,1,1,0,1
22321_0,,,,2,2,1,3
C(CC(C=O)C(C=O)(CC=C)O)=O,,,5,1,1,0,1
22323_0,,,,2,2,1,3
C(CC(C=O)C(C(CC=C)=O)O)=O,,,5,1,1,0,1
22325_0,,,,2,2,1,3
C(C(C=CC)(C(C=O)CC=O)O)=O,,,5,1,1,0,1
22327_0,,,,2,2,1,3
C(CC(C=O)C(C(C=CC)=O)O)=O,,,5,1,1,0,1
22329_0,,,,2,2,1,3
C(CC(C=O)C(C=CC(C=O)=O)O)=O,,,5,1,2,0,2
22331_0,,,,2,2,1,3
C(C(C=CC=O)(C(C=O)CC=O)O)=O,,,5,1,2,0,2
22333_0,,,,2,2,1,3
C(CC(C=O)C(C(C=CC=O)=O)O)=O,,,5,1,2,0,2
22335_0,,,,2,2,1,3
C(CC=CC(C(C=O)CC=O)O)=O,,,5,1,1,0,1
22337_0,,,,2,2,1,3
C(C(C(CC=CC=O)O)CC=O)=O,,,5,1,1,0,1
22338_0,,,,2,2,1,3
22340_0,,,,2,2,1,3
C(CC(C=O)C(C(C=O)=CC)O)=O,,,5,1,1,0,1
22342_0,,,,2,2,1,3
C(CC(C=O)C(C=C(C=O)C=O)O)=O,,,5,1,2,0,2
22344_0,,,,2,2,1,3
C(CC(C=O)C(C(C=O)=CC=O)O)=O,,,5,1,2,0,2
22346_0,,,,2,2,1,3
C(CC(C=O)C(C(C=O)=C)O)=O,,,5,1,1,0,1
22348_0,,,,2,2,1,3
C(CC(C=O)C(C=CC)O)=O,,,5,1,1,0,1
22350_0,,,,2,2,1,3
C(C(C(CC=C)O)CC=O)=O,,,5,1,1,0,1
22352_0,,,,2,2,1,3
C(C(C(C(C=C)O)O)CC=O)=O,,,5,1,1,0,1
22354_0,,,,2,2,1,3
C(CC(C=O)C(C=C)O)=O,,,5,1,4,0,4
22356_0,,,,2,2,1,3
C(C(C(C=O)=C)(C(C=O)CC=O)O)=O,,,5,1,2,0,2
22358_0,,,,2,2,1,3
C(CC(C=O)C(C(C(C=O)=C)=O)O)=O,,,5,1,2,0,2
22360_0,,,,2,2,1,3
C(CC(C=O)C(C(C(C=O)=O)=C)O)=O,,,5,1,2,0,2
22362_0,,,,2,2,1,3
C(CC(C=O)C1(C=COC1)O)=O,,,5,1,1,0,1
22363_0,,,,2,2,1,3
22364_0,,,,2,2,1,3
22365_0,,,,2,2,1,3
22366_0,,,,2,2,1,3
22367_0,,,,2,2,1,3
22368_0,,,,2,2,1,3
22369_0,,,,2,2,1,3
22370_0,,,,2,2,1,3
22371_0,,,,2,2,1,3
22372_0,,,,2,2,1,3
22373_0,,,,2,2,1,3
22374_0,,,,2,2,1,3
22375_0,,,,2,2,1,3
22376_0,,,,2,2,1,3
22377_0,,,,2,2,1,3
22378_0,,,,2,2,1,3
22379_0,,,,2,2,1,3
22380_0,,,,2,2,1,3
22381_0,,,,2,2,1,3
22383_0,,,,2,2,1,3
C(C(C(CC(C)O)O)CC=O)=O,,,5,1,3,0,3
22385_0,,,,2,2,1,3
C(C(C(C(C(C)O)O)O)CC=O)=O,,,5,1,2,0,2
22387_0,,,,2,2,1,3
C(C(C(CCO)O)CC=O)=O,,,5,1,4,0,4
22389_0,,,,2,2,1,3
C(C(C(CC(CO)O)O)CC=O)=O,,,5,1,3,0,3
22390_0,,,,2,2,1,3
22392_0,,,,2,2,1,3
C(CO)(C(C)(C(C=O)CC=O)O)=O,,,5,1,4,0,4
22393_0,,,,2,2,1,3
22395_0,,,,2,2,1,3
C(C(C(C=O)CC=O)O)(C(C)O)=O,,,5,1,3,0,3
22396_0,,,,2,2,1,3
22398_0,,,,2,2,1,3
C(C(C(C)(CO)O)CC=O)=O,,,5,1,4,0,4
22400_0,,,,2,2,1,3
C(C(C(CO)(CCO)O)CC=O)=O,,,5,1,4,0,4
22402_0,,,,2,2,1,3
C(C(C(C(CCO)O)O)CC=O)=O,,,5,1,3,0,3
22404_0,,,,2,2,1,3
C(C(C(C)(C(CO)O)O)CC=O)=O,,,5,1,4,0,4
22405_0,,,,2,2,1,3
22407_0,,,,2,2,1,3
C(CC(C(C=O)CC=O)O)(O)=O,,,5,1,4,0,4
22408_0,,,,2,2,1,3
22409_0,,,,2,2,1,3
22410_0,,,,2,2,1,3
22411_0,,,,2,2,1,3
22413_0,,,,2,2,1,3
C(C(C1(COCC1O)O)CC=O)=O,,,5,1,1,0,1
22415_0,,,,2,2,1,3
C(C(C1(C(O)OCC1)O)CC=O)=O,,,5,1,3,0,3
22417_0,,,,2,2,1,3
C(C(C1(COC(C1)O)O)CC=O)=O,,,5,1,3,0,3
22418_0,,,,2,2,1,3
22419_0,,,,2,2,1,3
22420_0,,,,2,2,1,3
22422_0,,,,2,2,1,3
C(C(C=C)(C(C=O)CC=O)O)=O,,,5,1,5,0,5
22424_0,,,,2,2,1,3
C(CC(C=O)C(C(C=C)=O)O)=O,,,5,1,4,0,4
22426_0,,,,2,2,1,3
C(CC(C=O)C(C=CC=O)O)=O,,,5,1,5,0,5
22428_0,,,,2,2,1,3
C(C(C(O)=O)CC=O)=O,,,5,1,4,0,4
22430_0,,,,2,2,1,3
C(C(C(C(O)O)O)CC=O)=O,,,5,1,3,0,3
22432_0,,,,2,2,1,3
C(C(C(C(C)O)O)CC=O)=O,,,5,1,4,0,4
22433_0,,,,2,2,1,3
22434_0,,,,2,2,1,3
22436_0,,,,2,2,1,3
C(CO)(C(C(C(C=O)=O)=O)CO)=O,,,5,1,2,0,2
22436_1,,,,2,2,1,3
22438_0,,,,2,2,1,3
C(C(CO)O)(CC(C(C=O)=O)=O)=O,,,5,1,3,0,3
22438_1,,,,2,2,1,3
22440_0,,,,2,2,1,3
C(C(C(C(C(CO)=O)=O)CO)=O)=O,,,5,1,2,0,2
22440_1,,,,2,2,1,3
22442_0,,,,2,2,1,3
C(C(CC(C(C(CO)O)=O)=O)=O)=O,,,5,1,2,0,2
22442_1,,,,2,2,1,3
22444_0,,,,2,2,1,3
C(C(C=C)C(CC(C(C=O)=O)=O)O)=O,,,5,1,2,0,2
22445_0,,,,2,2,1,3
22446_0,,,,2,2,1,3
22446_1,,,,2,2,1,3
22448_0,,,,2,2,1,3
C(C(C=C)C(C=O)(C(CC=O)=O)O)=O,,,5,1,1,0,1
22450_0,,,,2,2,1,3
C(C(C(CC=O)=O)(CC=O)O)=O,,,5,1,3,0,3
22452_0,,,,2,2,1,3
C(C(C(CC=O)=O)(C(C=O)O)O)=O,,,5,1,4,0,4
22452_1,,,,2,2,1,3
22454_0,,,,2,2,1,3
C(C(C=C)C(C(C(CC=O)=O)=O)O)=O,,,5,1,1,0,1
22456_0,,,,2,2,1,3
C(CC(C(C(CC=O)O)=O)=O)=O,,,5,1,3,0,3
22457_0,,,,2,2,1,3
22457_1,,,,2,2,1,3
22459_0,,,,2,2,1,3
C(C(C=C)C(C(C=O)=O)(CC=O)O)=O,,,5,1,1,0,1
22461_0,,,,2,2,1,3
C(CC(C(C=O)=O)(CC=O)O)=O,,,5,1,1,0,1
22463_0,,,,2,2,1,3
C(CC(C(C=O)=O)(C(C=O)O)O)=O,,,5,1,3,0,3
22463_1,,,,2,2,1,3
22465_0,,,,2,2,1,3
C(C(C(C(C=O)=O)=O)C(C=CC)O)=O,,,5,1,2,0,2
22465_1,,,,2,2,1,3
22467_0,,,,2,2,1,3
C(C(C(C(C=O)=O)=O)C(CC=C)O)=O,,,5,1,2,0,2
22467_1,,,,2,2,1,3
22469_0,,,,2,2,1,3
C(C(C(C(C=O)=O)=O)C(C=C)O)=O,,,5,1,2,0,2
22469_1,,,,2,2,1,3
22471_0,,,,2,2,1,3
C(C(C(C(C=O)=O)=O)C(C=O)O)=O,,,5,1,2,0,2
22471_1,,,,2,2,1,3
22473_0,,,,2,2,1,3
C(C(C(C(C=O)=O)=O)C(C)O)=O,,,5,1,5,0,5
22473_1,,,,2,2,1,3
22475_0,,,,2,2,1,3
C(C(C(O)=O)C(C(C=O)=O)=O)=O,,,5,1,3,0,3
22475_1,,,,2,2,1,3
22476_0,,,,2,2,1,3
22476_1,,,,2,2,1,3
22478_0,,,,2,2,1,3
C(C(C(C(C=O)=O)=O)C(CO)O)=O,,,5,1,2,0,2
22478_1,,,,2,2,1,3
22480_0,,,,2,2,1,3
C(C)(C(C)(CC(C(C)=O)=O)O)=O,,,5,1,1,0,1
22482_0,,,,2,2,1,3
C(C)(C(C)(C(C(C(O)=O)=O)C)O)=O,,,5,1,1,0,1
22484_0,,,,2,2,1,3
C(C(C(C)=O)C(C(C)=O)(C)O)(O)=O,,,5,1,2,0,2
22484_1,,,,2,2,1,3
22486_0,,,,2,2,1,3
C(C)(C(C)(CC(CC(O)=O)=O)O)=O,,,5,1,1,0,1
22488_0,,,,2,2,1,3
C(C)(C(C)(C1C(C(OC1)=O)=O)O)=O,,,5,1,2,0,2
22488_1,,,,2,2,1,3
22490_0,,,,2,2,1,3
C(C)(C(C)(C1C(OCC1=O)=O)O)=O,,,5,1,2,0,2
22490_1,,,,2,2,1,3
22492_0,,,,2,2,1,3
C(C)(C(C)(C1C(CC(O1)=O)=O)O)=O,,,5,1,2,0,2
22492_1,,,,2,2,1,3
22494_0,,,,2,2,1,3
C(C(C(C=O)=C)C(C(C)=O)(C)O)=O,,,5,1,1,0,1
22496_0,,,,2,2,1,3
C(C)(C(C)(CC(C=CC=O)=O)O)=O,,,5,1,1,0,1
22498_0,,,,2,2,1,3
C(C)(C(C)(C(C=C)C(C=O)=O)O)=O,,,5,1,1,0,1
22500_0,,,,2,2,1,3
C(C(C=CC=O)C(C(C)=O)(C)O)=O,,,5,1,1,0,1
22502_0,,,,2,2,1,3
C(C(C=C)C(C(C)=O)(C)O)=O,,,5,1,1,0,1
22504_0,,,,2,2,1,3
C(C)(C(C)(C1C(C=CO1)=O)O)=O,,,5,1,2,0,2
22504_1,,,,2,2,1,3
22506_0,,,,2,2,1,3
C(C)(C(C)(C(C(CO)=O)O)O)=O,,,5,1,3,0,3
22506_1,,,,2,2,1,3
22508_0,,,,2,2,1,3
C(C)(C(C)(CC(C=O)=O)O)=O,,,5,1,2,0,2
22510_0,,,,2,2,1,3
C(C(C=O)C(C(C)=O)(C)O)=O,,,5,1,3,0,3
22510_1,,,,2,2,1,3
22512_0,,,,2,2,1,3
C(C)(C(C)(C(C(C=O)=O)CO)O)=O,,,5,1,2,0,2
22512_1,,,,2,2,1,3
22514_0,,,,2,2,1,3
C(C)(C(C)(C(C=O)C(C=O)O)O)=O,,,5,1,2,0,2
22514_1,,,,2,2,1,3
22516_0,,,,2,2,1,3
C(C)(C(C)(C(C=O)C(CO)=O)O)=O,,,5,1,2,0,2
22516_1,,,,2,2,1,3
22518_0,,,,2,2,1,3
C(C)(C(C)(C(C(CC=O)=O)O)O)=O,,,5,1,2,0,2
22518_1,,,,2,2,1,3
22520_0,,,,2,2,1,3
C(C)(C(C)(CC(C(C=O)O)=O)O)=O,,,5,1,1,0,1
22522_0,,,,2,2,1,3
C(C)(C(C)(CC=O)O)=O,,,5,1,2,0,2
22524_0,,,,2,2,1,3
C(C)(C(C)(C(C(C=O)=O)O)O)=O,,,5,1,3,0,3
22524_1,,,,2,2,1,3
22526_0,,,,2,2,1,3
C(C(C(C)O)C(C(C)=O)(C)O)=O,,,5,1,3,0,3
22526_1,,,,2,2,1,3
22528_0,,,,2,2,1,3
C(C(CO)C(C(C)=O)(C)O)=O,,,5,1,3,0,3
22528_1,,,,2,2,1,3
22530_0,,,,2,2,1,3
C(C(C(CO)O)C(C(C)=O)(C)O)=O,,,5,1,2,0,2
22530_1,,,,2,2,1,3
22532_0,,,,2,2,1,3
C(C)(C(C)(C(C(C(C)=O)=O)O)O)=O,,,5,1,2,0,2
22532_1,,,,2,2,1,3
22534_0,,,,2,2,1,3
C(C)(C(C)(CC(C(CO)=O)=O)O)=O,,,5,1,1,0,1
22536_0,,,,2,2,1,3
C(C)(C(C)(C(C(C)=O)O)O)=O,,,5,1,3,0,3
22536_1,,,,2,2,1,3
22538_0,,,,2,2,1,3
C(C)(C(C)(CC(CO)=O)O)=O,,,5,1,2,0,2
22540_0,,,,2,2,1,3
C(C)(C(C)(C(C(CCO)=O)O)O)=O,,,5,1,2,0,2
22540_1,,,,2,2,1,3
22542_0,,,,2,2,1,3
C(C)(C(C)(C(C(CO)=O)CO)O)=O,,,5,1,2,0,2
22542_1,,,,2,2,1,3
22544_0,,,,2,2,1,3
C(C)(C(C)(CC(C(CO)O)=O)O)=O,,,5,1,1,0,1
22546_0,,,,2,2,1,3
C(C)(C(C)(CC(C(O)=O)=O)O)=O,,,5,1,2,0,2
22548_0,,,,2,2,1,3
C(C(C=O)C(C(C)=O)(C)O)(O)=O,,,5,1,3,0,3
22548_1,,,,2,2,1,3
22550_0,,,,2,2,1,3
C(C)(C(C)(C(C(C(O)=O)=O)O)O)=O,,,5,1,2,0,2
22550_1,,,,2,2,1,3
22552_0,,,,2,2,1,3
C(C(C(C=O)=O)C(C(C)=O)(C)O)=O,,,5,1,2,0,2
22552_1,,,,2,2,1,3
22554_0,,,,2,2,1,3
C(C)(C(C)(C1C(C(CO1)O)=O)O)=O,,,5,1,2,0,2
22554_1,,,,2,2,1,3
22556_0,,,,2,2,1,3
C(C)(C(C)(C1C(C(O)OC1)=O)O)=O,,,5,1,2,0,2
22556_1,,,,2,2,1,3
22558_0,,,,2,2,1,3
C(C)(C(C)(C1C(COC1O)=O)O)=O,,,5,1,2,0,2
22558_1,,,,2,2,1,3
22560_0,,,,2,2,1,3
C(C)(C(C)(C1C(CC(O1)O)=O)O)=O,,,5,1,2,0,2
22560_1,,,,2,2,1,3
22562_0,,,,2,2,1,3
C(C)(C(C)(CC(C(C=O)=O)=O)O)=O,,,5,1,1,0,1
22564_0,,,,2,2,1,3
C(C)(C(C)(C(C=O)O)O)=O,,,5,1,3,0,3
22564_1,,,,2,2,1,3
22566_0,,,,2,2,1,3
C(C(CC)(CC(C(C)=O)=O)O)(O)=O,,,5,1,1,0,1
22568_0,,,,2,2,1,3
C(CC(C)(CC(C(C)=O)=O)O)(O)=O,,,5,1,1,0,1
22570_0,,,,2,2,1,3
C(C(C)C(CC(C(C)=O)=O)O)(O)=O,,,5,1,1,0,1
22572_0,,,,2,2,1,3
C1(C(CCO1)(CC(C(C)=O)=O)O)=O,,,5,1,1,0,1
22574_0,,,,2,2,1,3
C1(CC(CO1)(CC(C(C)=O)=O)O)=O,,,5,1,1,0,1
22576_0,,,,2,2,1,3
C(C(CC(C(C)=O)=O)O)=C(C=O)C,,,5,1,1,0,1
22578_0,,,,2,2,1,3
C(C)(C(CC(C(C)=O)=O)O)=CC=O,,,5,1,1,0,1
22580_0,,,,2,2,1,3
C=C(C=O)CC(CC(C(C)=O)=O)O,,,5,1,1,0,1
22582_0,,,,2,2,1,3
C(CC(C(CC(C(C)=O)=O)O)=C)=O,,,5,1,1,0,1
22584_0,,,,2,2,1,3
C(C(CC(C(C)=O)=O)O)=CC(C)=O,,,5,1,1,0,1
22586_0,,,,2,2,1,3
C(C(C)(CC(C(C)=O)=O)O)=CC=O,,,5,1,1,0,1
22588_0,,,,2,2,1,3
C(C(CC=C)(CC(C(C)=O)=O)O)=O,,,5,1,1,0,1
22590_0,,,,2,2,1,3
C(C(CC(C(C)=O)=O)O)(CC=C)=O,,,5,1,1,0,1
22592_0,,,,2,2,1,3
C(C(C=CC)(CC(C(C)=O)=O)O)=O,,,5,1,1,0,1
22594_0,,,,2,2,1,3
C(C)=CC(C(CC(C(C)=O)=O)O)=O,,,5,1,1,0,1
22596_0,,,,2,2,1,3
C(C(CC(C(C)=O)=O)O)=CC(C=O)=O,,,5,1,1,0,1
22598_0,,,,2,2,1,3
C(C(C=CC=O)(CC(C(C)=O)=O)O)=O,,,5,1,1,0,1
22600_0,,,,2,2,1,3
C(C=CC(C(CC(C(C)=O)=O)O)=O)=O,,,5,1,1,0,1
22602_0,,,,2,2,1,3
C(CC=CC(CC(C(C)=O)=O)O)=O,,,5,1,1,0,1
22604_0,,,,2,2,1,3
C(CC(CC(C(C)=O)=O)O)=CC=O,,,5,1,1,0,1
22605_0,,,,2,2,1,3
22607_0,,,,2,2,1,3
C(C)=C(C=O)C(CC(C(C)=O)=O)O,,,5,1,1,0,1
22609_0,,,,2,2,1,3
C(C(CC(C(C)=O)=O)O)=C(C=O)C=O,,,5,1,1,0,1
22611_0,,,,2,2,1,3
C(C(C(CC(C(C)=O)=O)O)=CC=O)=O,,,5,1,1,0,1
22613_0,,,,2,2,1,3
C=C(C=O)C(CC(C(C)=O)=O)O,,,5,1,1,0,1
22615_0,,,,2,2,1,3
C(C)=CC(CC(C(C)=O)=O)O,,,5,1,1,0,1
22617_0,,,,2,2,1,3
C(CC(CC(C(C)=O)=O)O)=C,,,5,1,1,0,1
22619_0,,,,2,2,1,3
C(C(C(CC(C(C)=O)=O)O)O)=C,,,5,1,1,0,1
22621_0,,,,2,2,1,3
C=CC(CC(C(C)=O)=O)O,,,5,1,1,0,1
22623_0,,,,2,2,1,3
C(C(C(C=O)=C)(CC(C(C)=O)=O)O)=O,,,5,1,1,0,1
22625_0,,,,2,2,1,3
C=C(C=O)C(C(CC(C(C)=O)=O)O)=O,,,5,1,1,0,1
22627_0,,,,2,2,1,3
C=C(C(C=O)=O)C(CC(C(C)=O)=O)O,,,5,1,1,0,1
22629_0,,,,2,2,1,3
C1C(COC=1)(CC(C(C)=O)=O)O,,,5,1,1,0,1
22631_0,,,,2,2,1,3
C(C(C)=O)(CC(C(CO)O)O)=O,,,5,1,3,0,3
22632_0,,,,2,2,1,3
22634_0,,,,2,2,1,3
C(C(C)=O)(CC(CO)(CO)O)=O,,,5,1,4,0,4
22635_0,,,,2,2,1,3
22637_0,,,,2,2,1,3
C(C(C)(CC(C(C)=O)=O)O)=O,,,5,1,3,0,3
22639_0,,,,2,2,1,3
C(C)(C(CC(C(C)=O)=O)O)=O,,,5,1,3,0,3
22640_0,,,,2,2,1,3
22642_0,,,,2,2,1,3
C(C(CCO)(CC(C(C)=O)=O)O)=O,,,5,1,1,0,1
22644_0,,,,2,2,1,3
C(C(CC(C(C)=O)=O)O)(CCO)=O,,,5,1,1,0,1
22645_0,,,,2,2,1,3
22647_0,,,,2,2,1,3
C(C(CC(CC(C(C)=O)=O)O)O)=O,,,5,1,1,0,1
22648_0,,,,2,2,1,3
22649_0,,,,2,2,1,3
22650_0,,,,2,2,1,3
22652_0,,,,2,2,1,3
C(C(C(C)(CC(C(C)=O)=O)O)O)=O,,,5,1,1,0,1
22654_0,,,,2,2,1,3
C(C(C)=O)(CC(C)O)=O,,,5,1,3,0,3
22655_0,,,,2,2,1,3
22656_0,,,,2,2,1,3
22657_0,,,,2,2,1,3
22659_0,,,,2,2,1,3
C(C(C)=O)(CC(CC(C)O)O)=O,,,5,1,2,0,2
22661_0,,,,2,2,1,3
C(C(C)=O)(CC(C(C(C)O)O)O)=O,,,5,1,1,0,1
22663_0,,,,2,2,1,3
C(C(C)=O)(CC(CCO)O)=O,,,5,1,3,0,3
22665_0,,,,2,2,1,3
C(C(C)=O)(CC(CC(CO)O)O)=O,,,5,1,1,0,1
22667_0,,,,2,2,1,3
C(C)(C(CO)(CC(C(C)=O)=O)O)=O,,,5,1,1,0,1
22669_0,,,,2,2,1,3
C(CO)(C(C)(CC(C(C)=O)=O)O)=O,,,5,1,1,0,1
22671_0,,,,2,2,1,3
C(C(C(C)O)(CC(C(C)=O)=O)O)=O,,,5,1,2,0,2
22673_0,,,,2,2,1,3
C(C(CC(C(C)=O)=O)O)(C(C)O)=O,,,5,1,1,0,1
22674_0,,,,2,2,1,3
22676_0,,,,2,2,1,3
C(C(C)=O)(CC(C)(CO)O)=O,,,5,1,2,0,2
22678_0,,,,2,2,1,3
C(C(C)=O)(CC(CO)(CCO)O)=O,,,5,1,1,0,1
22680_0,,,,2,2,1,3
C(C(C)=O)(CC(C(CCO)O)O)=O,,,5,1,1,0,1
22682_0,,,,2,2,1,3
C(C(C)=O)(CC(C)(C(CO)O)O)=O,,,5,1,1,0,1
22683_0,,,,2,2,1,3
22685_0,,,,2,2,1,3
C(CC(CC(C(C)=O)=O)O)(O)=O,,,5,1,3,0,3
22687_0,,,,2,2,1,3
C(C(CO)(CC(C(C)=O)=O)O)(O)=O,,,5,1,3,0,3
22688_0,,,,2,2,1,3
22690_0,,,,2,2,1,3
C(CC(C(CC(C(C)=O)=O)O)=O)=O,,,5,1,1,0,1
22691_0,,,,2,2,1,3
22693_0,,,,2,2,1,3
C(C(C)=O)(CC1(COCC1O)O)=O,,,5,1,1,0,1
22695_0,,,,2,2,1,3
C(C(C)=O)(CC1(C(O)OCC1)O)=O,,,5,1,1,0,1
22697_0,,,,2,2,1,3
C(C(C)=O)(CC1(COC(C1)O)O)=O,,,5,1,1,0,1
22699_0,,,,2,2,1,3
C(C(C(C)=O)(CC(C(C)=O)=O)O)=O,,,5,1,1,0,1
22701_0,,,,2,2,1,3
C(C(C(CC(C(C)=O)=O)O)=O)(C)=O,,,5,1,1,0,1
22703_0,,,,2,2,1,3
C(C(CC(C(C=O)=O)(C)O)=O)(C)=O,,,5,1,1,0,1
22705_0,,,,2,2,1,3
C(C(C=C)(CC(C(C)=O)=O)O)=O,,,5,1,2,0,2
22707_0,,,,2,2,1,3
C=CC(C(CC(C(C)=O)=O)O)=O,,,5,1,2,0,2
22709_0,,,,2,2,1,3
C(C(CC(C(C)=O)=O)O)=CC=O,,,5,1,2,0,2
22710_0,,,,2,2,1,3
22712_0,,,,2,2,1,3
C(C(C)=O)(CC(C(O)O)O)=O,,,5,1,2,0,2
22714_0,,,,2,2,1,3
C(C(C)=O)(CC(C(C)O)O)=O,,,5,1,3,0,3
22716_0,,,,2,2,1,3
C(C(C)=O)(CCO)=O,,,5,1,8,0,8
22718_0,,,,2,2,1,3
C(C(C)=O)(CC(CO)O)=O,,,5,1,5,0,5
22719_0,,,,2,2,1,3
22721_0,,,,2,2,1,3
C(CC(CO)(C(C(C)=O)CO)O)=O,,,5,1,1,0,1
22723_0,,,,2,2,1,3
C(CC(C)O)(C(C(CO)=O)CO)=O,,,5,1,1,0,1
22725_0,,,,2,2,1,3
C(CC(O)=O)(C(C(CO)=O)CO)=O,,,5,1,4,0,4
22727_0,,,,2,2,1,3
C(CCO)(C(C(CO)=O)CO)=O,,,5,1,6,0,6
22729_0,,,,2,2,1,3
C(C(C(C)O)O)(C(C(C)=O)CO)=O,,,5,1,2,0,2
22729_1,,,,2,2,1,3
22731_0,,,,2,2,1,3
C(C(C(O)=O)O)(C(C(C)=O)CO)=O,,,5,1,4,0,4
22731_1,,,,2,2,1,3
22732_0,,,,2,2,1,3
22732_1,,,,2,2,1,3
22734_0,,,,2,2,1,3
C(CCO)(C(C(CO)=O)(CO)O)=O,,,5,1,5,0,5
22736_0,,,,2,2,1,3
C(C(CO)O)(C(C(C)=O)(CO)O)=O,,,5,1,7,0,7
22736_1,,,,2,2,1,3
22737_0,,,,2,2,1,3
22737_1,,,,2,2,1,3
22739_0,,,,2,2,1,3
C(C(C(C(CCO)=O)=O)CO)(O)=O,,,5,1,4,0,4
22741_0,,,,2,2,1,3
C(C(C(C(C=O)CO)=O)CO)(O)=O,,,5,1,2,0,2
22741_1,,,,2,2,1,3
22743_0,,,,2,2,1,3
C(C(CO)C(C)(CC=O)O)(O)=O,,,5,1,2,0,2
22745_0,,,,2,2,1,3
C(C(CO)C(C)(C(C=O)O)O)(O)=O,,,5,1,7,0,7
22745_1,,,,2,2,1,3
22747_0,,,,2,2,1,3
C(CC(C=C)O)(C(C(O)=O)CO)=O,,,5,1,1,0,1
22749_0,,,,2,2,1,3
C(CC(C=O)O)(C(C(O)=O)CO)=O,,,5,1,4,0,4
22751_0,,,,2,2,1,3
C(C(C(CC(C)O)=O)CO)(O)=O,,,5,1,2,0,2
22753_0,,,,2,2,1,3
C(C(C(CC(O)=O)=O)CO)(O)=O,,,5,1,3,0,3
22755_0,,,,2,2,1,3
C(C(C(CCO)=O)CO)(O)=O,,,5,1,3,0,3
22757_0,,,,2,2,1,3
C(C(C(CC(CO)O)=O)CO)(O)=O,,,5,1,1,0,1
22759_0,,,,2,2,1,3
C(C(C(CCO)=O)C(CO)O)(O)=O,,,5,1,1,0,1
22761_0,,,,2,2,1,3
C(C(C(CCO)=O)C(C(O)=O)=O)=O,,,5,1,1,0,1
22762_0,,,,2,2,1,3
22764_0,,,,2,2,1,3
C(CCO)(C(C(O)=O)C(C=O)O)=O,,,5,1,2,0,2
22766_0,,,,2,2,1,3
C(CCO)(C(C=O)C(C(C)=O)=O)=O,,,5,1,1,0,1
22768_0,,,,2,2,1,3
C(C(C(C)=O)C(C(CCO)=O)=O)=O,,,5,1,1,0,1
22770_0,,,,2,2,1,3
C(CC(C(C(C(C)=O)=O)CO)O)=O,,,5,1,1,0,1
22772_0,,,,2,2,1,3
C(C(C)(CC=O)O)(C(C=O)CO)=O,,,5,1,1,0,1
22773_0,,,,2,2,1,3
22775_0,,,,2,2,1,3
C(C(C(C(CC(C)O)=O)=O)CO)=O,,,5,1,1,0,1
22776_0,,,,2,2,1,3
22777_0,,,,2,2,1,3
22779_0,,,,2,2,1,3
C(C(C(CC=O)=O)C(CCO)=O)=O,,,5,1,1,0,1
22781_0,,,,2,2,1,3
C(C(C(C(C=O)CO)=O)C(C)=O)=O,,,5,1,2,0,2
22781_1,,,,2,2,1,3
22782_0,,,,2,2,1,3
22783_0,,,,2,2,1,3
22785_0,,,,2,2,1,3
C(C(C(CC(CC=O)O)=O)CO)=O,,,5,1,2,0,2
22787_0,,,,2,2,1,3
C(C(C(C(C=O)CO)=O)C(C)O)=O,,,5,1,2,0,2
22787_1,,,,2,2,1,3
22789_0,,,,2,2,1,3
C(C(C=O)C(C(C=O)CO)=O)(O)=O,,,5,1,2,0,2
22789_1,,,,2,2,1,3
22791_0,,,,2,2,1,3
C(C(C(C(C=O)CO)=O)CO)=O,,,5,1,4,0,4
22791_1,,,,2,2,1,3
22793_0,,,,2,2,1,3
C(C(C=C)C(C)(C(C=O)C(C)=O)O)=O,,,5,1,1,0,1
22794_0,,,,2,2,1,3
22795_0,,,,2,2,1,3
22795_1,,,,2,2,1,3
22797_0,,,,2,2,1,3
C(C(C=C)C(C(C(C)=O)C(C)=O)O)=O,,,5,1,1,0,1
22799_0,,,,2,2,1,3
C(CC(C(C(C)=O)C(C)=O)O)=O,,,5,1,2,0,2
22801_0,,,,2,2,1,3
C(C(C(C(C(C)=O)C(C)=O)O)O)=O,,,5,1,2,0,2
22801_1,,,,2,2,1,3
22803_0,,,,2,2,1,3
C(C(C(C)=O)C(CC(C=CC)O)=O)=O,,,5,1,1,0,1
22805_0,,,,2,2,1,3
C(CC(CC=C)O)(C(C=O)C(C)=O)=O,,,5,1,1,0,1
22807_0,,,,2,2,1,3
C(C(C(CC(C=C)O)=O)C(C)=O)=O,,,5,1,1,0,1
22809_0,,,,2,2,1,3
C(C(C(CC(C=O)O)=O)C(C)=O)=O,,,5,1,1,0,1
22811_0,,,,2,2,1,3
C(CC(C)O)(C(C=O)C(C)=O)=O,,,5,1,3,0,3
22813_0,,,,2,2,1,3
C(C(C(CC(O)=O)=O)C(C)=O)=O,,,5,1,4,0,4
22815_0,,,,2,2,1,3
C(CCO)(C(C=O)C(C)=O)=O,,,5,1,5,0,5
22817_0,,,,2,2,1,3
C(CC(CO)O)(C(C=O)C(C)=O)=O,,,5,1,1,0,1
22818_0,,,,2,2,1,3
22820_0,,,,2,2,1,3
C(C(C(C(CC=O)O)=O)C(C)=O)=O,,,5,1,1,0,1
22821_0,,,,2,2,1,3
22822_0,,,,2,2,1,3
22824_0,,,,2,2,1,3
C(C(C(CC(C=C)O)=O)C(C=O)=O)=O,,,5,1,1,0,1
22826_0,,,,2,2,1,3
C(C(C(CC(C)O)=O)C(C=O)=O)=O,,,5,1,1,0,1
22828_0,,,,2,2,1,3
C(C(C(CC(O)=O)=O)C(C=O)=O)=O,,,5,1,1,0,1
22830_0,,,,2,2,1,3
C(C(C(CCO)=O)C(C=O)=O)=O,,,5,1,5,0,5
22832_0,,,,2,2,1,3
C(CC(C)(C(C=O)(C(C)=O)O)O)=O,,,5,1,3,0,3
22834_0,,,,2,2,1,3
C(CC(C(C(C)=O)(C(C)=O)O)O)=O,,,5,1,1,0,1
22836_0,,,,2,2,1,3
C(CC(C)O)(C(C=O)(C(C)=O)O)=O,,,5,1,1,0,1
22838_0,,,,2,2,1,3
C(C(C(CC(O)=O)=O)(C(C)=O)O)=O,,,5,1,1,0,1
22839_0,,,,2,2,1,3
22841_0,,,,2,2,1,3
C(C(C=C)C(C(C(C)=O)CO)O)=O,,,5,1,1,0,1
22843_0,,,,2,2,1,3
C(C)(C(CO)C(CC(C=O)=O)O)=O,,,5,1,1,0,1
22845_0,,,,2,2,1,3
C(C(C=O)C(C(C(C)=O)CO)O)=O,,,5,1,2,0,2
22845_1,,,,2,2,1,3
22847_0,,,,2,2,1,3
C(CC(C(C(C)=O)CO)O)=O,,,5,1,2,0,2
22849_0,,,,2,2,1,3
C(C(CO)C(C(C(C)=O)CO)O)=O,,,5,1,2,0,2
22849_1,,,,2,2,1,3
22851_0,,,,2,2,1,3
C(C)(C(CO)C(C(C(C)=O)O)O)=O,,,5,1,2,0,2
22851_1,,,,2,2,1,3
22853_0,,,,2,2,1,3
C(C)(C(CO)C(CC(CO)=O)O)=O,,,5,1,1,0,1
22855_0,,,,2,2,1,3
C(C(C(C(C(C)=O)CO)O)O)=O,,,5,1,3,0,3
22855_1,,,,2,2,1,3
22857_0,,,,2,2,1,3
C(C(C=C)C(C)(C(C=O)CO)O)=O,,,5,1,1,0,1
22858_0,,,,2,2,1,3
22859_0,,,,2,2,1,3
22859_1,,,,2,2,1,3
22860_0,,,,2,2,1,3
22862_0,,,,2,2,1,3
C(C(CO)C(C)(C(C=O)CO)O)=O,,,5,1,2,0,2
22862_1,,,,2,2,1,3
22864_0,,,,2,2,1,3
C(C(CO)C(C)(C(C(C)=O)O)O)=O,,,5,1,2,0,2
22864_1,,,,2,2,1,3
22865_0,,,,2,2,1,3
22866_0,,,,2,2,1,3
22866_1,,,,2,2,1,3
22868_0,,,,2,2,1,3
C(CC(C=CC)O)(C(C=O)CO)=O,,,5,1,1,0,1
22870_0,,,,2,2,1,3
C(C(C(CC(CC=C)O)=O)CO)=O,,,5,1,1,0,1
22872_0,,,,2,2,1,3
C(CC(C=C)O)(C(C=O)CO)=O,,,5,1,1,0,1
22873_0,,,,2,2,1,3
22874_0,,,,2,2,1,3
22876_0,,,,2,2,1,3
C(C(C)(CC(C(C=O)CO)=O)O)=O,,,5,1,1,0,1
22878_0,,,,2,2,1,3
C(CC(C(C)=O)O)(C(C=O)CO)=O,,,5,1,1,0,1
22879_0,,,,2,2,1,3
22881_0,,,,2,2,1,3
C(C(C(CC(C)O)=O)CO)=O,,,5,1,3,0,3
22883_0,,,,2,2,1,3
C(C(C(CC(CCO)O)=O)CO)=O,,,5,1,1,0,1
22885_0,,,,2,2,1,3
C(C(C(CC(C)(CO)O)=O)CO)=O,,,5,1,1,0,1
22887_0,,,,2,2,1,3
C(C(C(CC(O)=O)=O)CO)=O,,,5,1,7,0,7
22889_0,,,,2,2,1,3
C(C(C(CC(C(O)O)O)=O)CO)=O,,,5,1,1,0,1
22891_0,,,,2,2,1,3
C(C(C(CC(C(C)O)O)=O)CO)=O,,,5,1,1,0,1
22892_0,,,,2,2,1,3
22893_0,,,,2,2,1,3
22895_0,,,,2,2,1,3
C(CC(C(C(C)=O)C(CO)O)O)=O,,,5,1,1,0,1
22896_0,,,,2,2,1,3
22898_0,,,,2,2,1,3
C(C(C(CC(C)O)=O)C(CO)O)=O,,,5,1,1,0,1
22900_0,,,,2,2,1,3
C(C(C(CC(O)=O)=O)C(CO)O)=O,,,5,1,4,0,4
22901_0,,,,2,2,1,3
22903_0,,,,2,2,1,3
C(CCO)(C(C(C=O)=O)(CO)O)=O,,,5,1,4,0,4
22905_0,,,,2,2,1,3
C(C(C(C(O)=O)=O)C(C=O)CO)=O,,,5,1,1,0,1
22907_0,,,,2,2,1,3
C(C(C)C(C(O)=O)(CC=O)O)(O)=O,,,5,1,1,0,1
22909_0,,,,2,2,1,3
C(CC(C(O)=O)(C(C=O)C)O)=O,,,5,1,3,0,3
22911_0,,,,2,2,1,3
C(C(C(C(O)=O)(C(C=O)C)O)O)=O,,,5,1,2,0,2
22911_1,,,,2,2,1,3
22913_0,,,,2,2,1,3
C(CC(C(C(C(O)=O)=O)C)O)=O,,,5,1,3,0,3
22915_0,,,,2,2,1,3
C(C(C(C(C(C(O)=O)=O)C)O)O)=O,,,5,1,3,0,3
22915_1,,,,2,2,1,3
22917_0,,,,2,2,1,3
C(C(CO)C(C=O)C(C(C)=O)=O)=O,,,5,1,1,0,1
22919_0,,,,2,2,1,3
C(C(C(C(CCO)=O)=O)CC=O)=O,,,5,1,2,0,2
22921_0,,,,2,2,1,3
C(C(C)(CC=O)O)(C(C(O)=O)C)=O,,,5,1,1,0,1
22923_0,,,,2,2,1,3
C(C(C)C(C(C)=O)(CC=O)O)(O)=O,,,5,1,1,0,1
22925_0,,,,2,2,1,3
C(C(C(C(CC(C)O)=O)=O)C)(O)=O,,,5,1,1,0,1
22927_0,,,,2,2,1,3
C(C(C(C(CC(O)=O)=O)=O)C)(O)=O,,,5,1,1,0,1
22928_0,,,,2,2,1,3
22930_0,,,,2,2,1,3
C(C(CC=O)(CC(C)=O)O)(O)=O,,,5,1,4,0,4
22932_0,,,,2,2,1,3
C(C(CC(C)=O)(C(C=O)O)O)(O)=O,,,5,1,3,0,3
22932_1,,,,2,2,1,3
22933_0,,,,2,2,1,3
22934_0,,,,2,2,1,3
22934_1,,,,2,2,1,3
22936_0,,,,2,2,1,3
C(C)(C(C(C(O)=O)=O)C(C=C)O)=O,,,5,1,2,0,2
22936_1,,,,2,2,1,3
22938_0,,,,2,2,1,3
C(C(C(C(C)=O)C(C(O)=O)=O)O)=O,,,5,1,2,0,2
22938_1,,,,2,2,1,3
22940_0,,,,2,2,1,3
C(C)(C(C(C(O)=O)=O)C(C)O)=O,,,5,1,4,0,4
22940_1,,,,2,2,1,3
22942_0,,,,2,2,1,3
C(C(C(C)=O)C(C(O)=O)=O)(O)=O,,,5,1,5,0,5
22942_1,,,,2,2,1,3
22944_0,,,,2,2,1,3
C(C)(C(C(C(O)=O)=O)CO)=O,,,5,1,7,0,7
22944_1,,,,2,2,1,3
22946_0,,,,2,2,1,3
C(C)(C(C(C(O)=O)=O)C(CO)O)=O,,,5,1,2,0,2
22946_1,,,,2,2,1,3
22948_0,,,,2,2,1,3
C(CC(C=C)O)(CC(C(O)=O)=O)=O,,,5,1,1,0,1
22950_0,,,,2,2,1,3
C(C(CC(CC(C(O)=O)=O)=O)O)=O,,,5,1,2,0,2
22952_0,,,,2,2,1,3
C(CC(C)O)(CC(C(O)=O)=O)=O,,,5,1,4,0,4
22954_0,,,,2,2,1,3
C(CC(CC(C(O)=O)=O)=O)(O)=O,,,5,1,5,0,5
22955_0,,,,2,2,1,3
22957_0,,,,2,2,1,3
C(CC(CO)O)(CC(C(O)=O)=O)=O,,,5,1,2,0,2
22959_0,,,,2,2,1,3
C(C(C)(CC=O)O)(CC(O)=O)=O,,,5,1,2,0,2
22961_0,,,,2,2,1,3
C(C(C)(C(C=O)O)O)(CC(O)=O)=O,,,5,1,2,0,2
22961_1,,,,2,2,1,3
22963_0,,,,2,2,1,3
C(CC(C(C)=O)(CC=O)O)(O)=O,,,5,1,3,0,3
22965_0,,,,2,2,1,3
C(CC(C(C)=O)(C(C=O)O)O)(O)=O,,,5,1,4,0,4
22965_1,,,,2,2,1,3
22967_0,,,,2,2,1,3
C(CC(C(CC(C=C)O)=O)=O)(O)=O,,,5,1,1,0,1
22968_0,,,,2,2,1,3
22970_0,,,,2,2,1,3
C(CC(C(CC(C)O)=O)=O)(O)=O,,,5,1,3,0,3
22972_0,,,,2,2,1,3
C(CC(C(CC(O)=O)=O)=O)(O)=O,,,5,1,3,0,3
22973_0,,,,2,2,1,3
22975_0,,,,2,2,1,3
C(CC(C(CC(CO)O)=O)=O)(O)=O,,,5,1,2,0,2
22977_0,,,,2,2,1,3
C(C(C(C(C)=O)=O)C(C=C)O)(O)=O,,,5,1,2,0,2
22977_1,,,,2,2,1,3
22978_0,,,,2,2,1,3
22978_1,,,,2,2,1,3
22980_0,,,,2,2,1,3
C(C(C(C(C)=O)=O)C(C)O)(O)=O,,,5,1,4,0,4
22980_1,,,,2,2,1,3
22982_0,,,,2,2,1,3
C(C(C(O)=O)C(C(C)=O)=O)(O)=O,,,5,1,4,0,4
22982_1,,,,2,2,1,3
22983_0,,,,2,2,1,3
22983_1,,,,2,2,1,3
22985_0,,,,2,2,1,3
C(C(C(C(C)=O)=O)C(CO)O)(O)=O,,,5,1,3,0,3
22985_1,,,,2,2,1,3
22987_0,,,,2,2,1,3
C(CC(C(C=O)C(C=O)CO)=O)=O,,,5,1,1,0,1
22989_0,,,,2,2,1,3
C(C(C(C(C=O)CC=O)=O)CO)=O,,,5,1,2,0,2
22989_1,,,,2,2,1,3
22991_0,,,,2,2,1,3
C(C(C)C(CC=O)(CC=O)O)(O)=O,,,5,1,1,0,1
22993_0,,,,2,2,1,3
C(C(C(CC(CC=O)O)=O)C)(O)=O,,,5,1,2,0,2
22995_0,,,,2,2,1,3
C(C(C(C(C=O)C(C)O)=O)C)(O)=O,,,5,1,2,0,2
22995_1,,,,2,2,1,3
22997_0,,,,2,2,1,3
C(C(C(C(C(O)=O)C)=O)C(O)=O)=O,,,5,1,2,0,2
22997_1,,,,2,2,1,3
22999_0,,,,2,2,1,3
C(C(C(C(C=O)CO)=O)C)(O)=O,,,5,1,3,0,3
22999_1,,,,2,2,1,3
23001_0,,,,2,2,1,3
C(C(CCC=O)(CC=O)O)(O)=O,,,5,1,4,0,4
23003_0,,,,2,2,1,3
C(C(CCC=O)(C(C=O)O)O)(O)=O,,,5,1,4,0,4
23003_1,,,,2,2,1,3
23005_0,,,,2,2,1,3
C(CC(CCC(C(O)=O)=O)O)=O,,,5,1,4,0,4
23007_0,,,,2,2,1,3
C(C(C(CCC(C(O)=O)=O)O)O)=O,,,5,1,5,0,5
23007_1,,,,2,2,1,3
23009_0,,,,2,2,1,3
C(CC(C(C(O)=O)=O)C(C=C)O)=O,,,5,1,1,0,1
23011_0,,,,2,2,1,3
C(CC(C(C(O)=O)=O)C(C=O)O)=O,,,5,1,1,0,1
23013_0,,,,2,2,1,3
C(CC(C(C(O)=O)=O)C(C)O)=O,,,5,1,2,0,2
23015_0,,,,2,2,1,3
C(C(C(C(O)=O)=O)CC=O)(O)=O,,,5,1,4,0,4
23016_0,,,,2,2,1,3
23018_0,,,,2,2,1,3
C(CC(C(C(O)=O)=O)C(CO)O)=O,,,5,1,1,0,1
23020_0,,,,2,2,1,3
C(C(CC(C(O)=O)=O)C(C=C)O)=O,,,5,1,1,0,1
23022_0,,,,2,2,1,3
C(C(C(C=O)CC(C(O)=O)=O)O)=O,,,5,1,1,0,1
23024_0,,,,2,2,1,3
C(C(C(C)O)CC(C(O)=O)=O)=O,,,5,1,2,0,2
23026_0,,,,2,2,1,3
C(C(C(O)=O)CC(C(O)=O)=O)=O,,,5,1,3,0,3
23028_0,,,,2,2,1,3
C(C(CO)CC(C(O)=O)=O)=O,,,5,1,4,0,4
23030_0,,,,2,2,1,3
C(C(C(CO)O)CC(C(O)=O)=O)=O,,,5,1,3,0,3
23032_0,,,,2,2,1,3
C(CC(CC=O)(CC=O)O)(O)=O,,,5,1,2,0,2
23033_0,,,,2,2,1,3
23033_1,,,,2,2,1,3
23035_0,,,,2,2,1,3
C(CC(CC(CC=O)O)=O)(O)=O,,,5,1,3,0,3
23037_0,,,,2,2,1,3
C(CC(C(C=O)O)O)(CC(O)=O)=O,,,5,1,3,0,3
23037_1,,,,2,2,1,3
23039_0,,,,2,2,1,3
C(C(C(CC=O)=O)C(C=C)O)(O)=O,,,5,1,2,0,2
23039_1,,,,2,2,1,3
23040_0,,,,2,2,1,3
23040_1,,,,2,2,1,3
23042_0,,,,2,2,1,3
C(C(C(CC=O)=O)C(C)O)(O)=O,,,5,1,4,0,4
23042_1,,,,2,2,1,3
23044_0,,,,2,2,1,3
C(C(C(O)=O)C(CC=O)=O)(O)=O,,,5,1,4,0,4
23044_1,,,,2,2,1,3
23045_0,,,,2,2,1,3
23045_1,,,,2,2,1,3
23046_0,,,,2,2,1,3
23046_1,,,,2,2,1,3
23048_0,,,,2,2,1,3
C(C(C(CC(O)=O)=O)C(C=C)O)=O,,,5,1,2,0,2
23048_1,,,,2,2,1,3
23049_0,,,,2,2,1,3
23049_1,,,,2,2,1,3
23051_0,,,,2,2,1,3
C(C(C(CC(O)=O)=O)C(C)O)=O,,,5,1,5,0,5
23051_1,,,,2,2,1,3
23053_0,,,,2,2,1,3
C(C(C(O)=O)C(CC(O)=O)=O)=O,,,5,1,4,0,4
23053_1,,,,2,2,1,3
23054_0,,,,2,2,1,3
23054_1,,,,2,2,1,3
23055_0,,,,2,2,1,3
23055_1,,,,2,2,1,3
23057_0,,,,2,2,1,3
C(CCO)(C(C(C(O)=O)=O)CO)=O,,,5,1,3,0,3
23057_1,,,,2,2,1,3
23059_0,,,,2,2,1,3
C(C(CO)CO)(CC(C(O)=O)=O)=O,,,5,1,3,0,3
23059_1,,,,2,2,1,3
23061_0,,,,2,2,1,3
C(CC(C(C(CO)CO)=O)=O)(O)=O,,,5,1,3,0,3
23061_1,,,,2,2,1,3
23062_0,,,,2,2,1,3
23062_1,,,,2,2,1,3
23064_0,,,,2,2,1,3
C(C(C(C)(C(C=O)C=C)O)CC=O)=O,,,5,1,1,0,1
23065_0,,,,2,2,1,3
23066_0,,,,2,2,1,3
23066_1,,,,2,2,1,3
23068_0,,,,2,2,1,3
C(C)(C(C(C(C=O)C=C)O)CC=O)=O,,,5,1,1,0,1
23070_0,,,,2,2,1,3
C(C)(C(C(CC=O)O)CC=O)=O,,,5,1,3,0,3
23072_0,,,,2,2,1,3
C(C)(C(C(C(C=O)O)O)CC=O)=O,,,5,1,3,0,3
23072_1,,,,2,2,1,3
23074_0,,,,2,2,1,3
C(C(C=C)C(CC(C=O)C(C)=O)O)=O,,,5,1,1,0,1
23076_0,,,,2,2,1,3
C(CC(CC(C=O)C(C)=O)O)=O,,,5,1,2,0,2
23078_0,,,,2,2,1,3
C(C(C(CC(C=O)C(C)=O)O)O)=O,,,5,1,2,0,2
23078_1,,,,2,2,1,3
23080_0,,,,2,2,1,3
C(C(C(CC(C=CC)O)=O)CC=O)=O,,,5,1,1,0,1
23082_0,,,,2,2,1,3
C(CC(CC=C)O)(C(C=O)CC=O)=O,,,5,1,1,0,1
23084_0,,,,2,2,1,3
C(C(C(CC(C=C)O)=O)CC=O)=O,,,5,1,1,0,1
23086_0,,,,2,2,1,3
C(C(C(CC(C=O)O)=O)CC=O)=O,,,5,1,1,0,1
23088_0,,,,2,2,1,3
C(CC(C)O)(C(C=O)CC=O)=O,,,5,1,2,0,2
23090_0,,,,2,2,1,3
C(C(C(CC(O)=O)=O)CC=O)=O,,,5,1,4,0,4
23092_0,,,,2,2,1,3
C(CCO)(C(C=O)CC=O)=O,,,5,1,5,0,5
23094_0,,,,2,2,1,3
C(CC(CO)O)(C(C=O)CC=O)=O,,,5,1,1,0,1
23096_0,,,,2,2,1,3
C(C(C(C)=O)C(C=O)C(C=CC)O)=O,,,5,1,1,0,1
23098_0,,,,2,2,1,3
C(C(C(CC=C)O)C(C=O)C(C)=O)=O,,,5,1,1,0,1
23100_0,,,,2,2,1,3
C(C(C(C)=O)C(C=O)C(C=C)O)=O,,,5,1,1,0,1
23102_0,,,,2,2,1,3
C(C(C(C)=O)C(C=O)C(C=O)O)=O,,,5,1,1,0,1
23104_0,,,,2,2,1,3
C(C(C(C)O)C(C=O)C(C)=O)=O,,,5,1,3,0,3
23106_0,,,,2,2,1,3
C(C(C(O)=O)C(C=O)C(C)=O)=O,,,5,1,3,0,3
23108_0,,,,2,2,1,3
C(C(CO)C(C=O)C(C)=O)=O,,,5,1,3,0,3
23110_0,,,,2,2,1,3
C(C(C(CO)O)C(C=O)C(C)=O)=O,,,5,1,1,0,1
23111_0,,,,2,2,1,3
23113_0,,,,2,2,1,3
C(C(C(C(CC=O)O)=O)CC=O)=O,,,5,1,2,0,2
23114_0,,,,2,2,1,3
23116_0,,,,2,2,1,3
C(C(C(C=O)=O)CC(CC=O)O)=O,,,5,1,2,0,2
23118_0,,,,2,2,1,3
C(C(C(C=O)=O)C(C=O)C(C=C)O)=O,,,5,1,1,0,1
23120_0,,,,2,2,1,3
C(C(C(C=O)=O)C(C=O)C(C)O)=O,,,5,1,1,0,1
23122_0,,,,2,2,1,3
C(C(C(O)=O)C(C=O)C(C=O)=O)=O,,,5,1,1,0,1
23124_0,,,,2,2,1,3
C(C(C(C=O)=O)C(C=O)CO)=O,,,5,1,4,0,4
23126_0,,,,2,2,1,3
C(C(CC(C(C(O)=O)=O)CO)O)=O,,,5,1,1,0,1
23127_0,,,,2,2,1,3
23127_1,,,,2,2,1,3
23129_0,,,,2,2,1,3
C(C(CO)C(C=O)O)(CC(O)=O)=O,,,5,1,3,0,3
23129_1,,,,2,2,1,3
23131_0,,,,2,2,1,3
C(CC(C(C(O)=O)=O)CO)(CO)=O,,,5,1,2,0,2
23133_0,,,,2,2,1,3
C(CO)(C(CO)CC(C(O)=O)=O)=O,,,5,1,2,0,2
23135_0,,,,2,2,1,3
C(CCC(C(O)=O)=O)(C(CO)O)=O,,,5,1,3,0,3
23135_1,,,,2,2,1,3
23137_0,,,,2,2,1,3
C(C(C(CC(CO)=O)=O)CO)(O)=O,,,5,1,3,0,3
23137_1,,,,2,2,1,3
23138_0,,,,2,2,1,3
23138_1,,,,2,2,1,3
23139_0,,,,2,2,1,3
23139_1,,,,2,2,1,3
23141_0,,,,2,2,1,3
C(C(CO)C(C(C(O)=O)=O)CO)=O,,,5,1,2,0,2
23142_0,,,,2,2,1,3
23144_0,,,,2,2,1,3
C(C(C(C(C(C)=O)=O)CO)O)(O)=O,,,5,1,4,0,4
23144_1,,,,2,2,1,3
23146_0,,,,2,2,1,3
C(C(CC(C(CCO)=O)=O)O)(O)=O,,,5,1,3,0,3
23148_0,,,,2,2,1,3
C(C(C(C(C(C)=O)O)=O)CO)(O)=O,,,5,1,3,0,3
23148_1,,,,2,2,1,3
23150_0,,,,2,2,1,3
C(CC(C(C(CCO)=O)O)=O)(O)=O,,,5,1,2,0,2
23151_0,,,,2,2,1,3
23151_1,,,,2,2,1,3
23153_0,,,,2,2,1,3
C(C(C(O)=O)O)(CC(CCO)=O)=O,,,5,1,5,0,5
23155_0,,,,2,2,1,3
C(C(C=C)C(C)(C(C(O)=O)C)O)=O,,,5,1,1,0,1
23157_0,,,,2,2,1,3
C(C(C)C(C)(CC(C=O)=O)O)(O)=O,,,5,1,1,0,1
23159_0,,,,2,2,1,3
C(C(C=O)C(C)(C(C(O)=O)C)O)=O,,,5,1,2,0,2
23159_1,,,,2,2,1,3
23161_0,,,,2,2,1,3
C(C(C)C(C)(CC=O)O)(O)=O,,,5,1,1,0,1
23163_0,,,,2,2,1,3
C(C(C)C(C)(C(C=O)CO)O)(O)=O,,,5,1,2,0,2
23163_1,,,,2,2,1,3
23165_0,,,,2,2,1,3
C(C(C)C(C)(C(C(C)=O)O)O)(O)=O,,,5,1,2,0,2
23165_1,,,,2,2,1,3
23167_0,,,,2,2,1,3
C(C(C)C(C)(CC(CO)=O)O)(O)=O,,,5,1,1,0,1
23169_0,,,,2,2,1,3
C(C(C)C(C)(C(C=O)O)O)(O)=O,,,5,1,2,0,2
23169_1,,,,2,2,1,3
23171_0,,,,2,2,1,3
C(CC(C=CC)O)(C(C(O)=O)C)=O,,,5,1,1,0,1
23173_0,,,,2,2,1,3
C(C(C(CC(CC=C)O)=O)C)(O)=O,,,5,1,1,0,1
23175_0,,,,2,2,1,3
C(CC(C=C)O)(C(C(O)=O)C)=O,,,5,1,1,0,1
23176_0,,,,2,2,1,3
23178_0,,,,2,2,1,3
C(CC(C(O)=O)O)(C(C(O)=O)C)=O,,,5,1,3,0,3
23180_0,,,,2,2,1,3
C(C(C)(CC(C(C(O)=O)C)=O)O)=O,,,5,1,1,0,1
23182_0,,,,2,2,1,3
C(CC(C(C)=O)O)(C(C(O)=O)C)=O,,,5,1,1,0,1
23183_0,,,,2,2,1,3
23185_0,,,,2,2,1,3
C(C(C(CC(C)O)=O)C)(O)=O,,,5,1,2,0,2
23187_0,,,,2,2,1,3
C(C(C(CC(CCO)O)=O)C)(O)=O,,,5,1,1,0,1
23189_0,,,,2,2,1,3
C(C(C(CC(C)(CO)O)=O)C)(O)=O,,,5,1,1,0,1
23191_0,,,,2,2,1,3
C(CC(O)=O)(C(C(O)=O)C)=O,,,5,1,3,0,3
23193_0,,,,2,2,1,3
C(C(C(CC(C(O)O)O)=O)C)(O)=O,,,5,1,1,0,1
23195_0,,,,2,2,1,3
C(C(C(CC(C(C)O)O)=O)C)(O)=O,,,5,1,1,0,1
23197_0,,,,2,2,1,3
C(C(C(CCO)=O)C)(O)=O,,,5,1,3,0,3
23199_0,,,,2,2,1,3
C(C(C(CC(CO)O)=O)C)(O)=O,,,5,1,3,0,3
23201_0,,,,2,2,1,3
C(C(CCO)C(C)(CC=O)O)(O)=O,,,5,1,1,0,1
23203_0,,,,2,2,1,3
C(C(C(CC(C)O)=O)CCO)(O)=O,,,5,1,1,0,1
23205_0,,,,2,2,1,3
C(C(C(CC(O)=O)=O)CCO)(O)=O,,,5,1,2,0,2
23207_0,,,,2,2,1,3
C(C(C(CCO)=O)CCO)(O)=O,,,5,1,3,0,3
23209_0,,,,2,2,1,3
C(C(C=C)C(C(O)=O)(CC)O)=O,,,5,1,1,0,1
23211_0,,,,2,2,1,3
C(C(CC)(C1C(C=CO1)=O)O)(O)=O,,,5,1,2,0,2
23211_1,,,,2,2,1,3
23213_0,,,,2,2,1,3
C(C(CC)(C(C(CO)=O)O)O)(O)=O,,,5,1,3,0,3
23213_1,,,,2,2,1,3
23215_0,,,,2,2,1,3
C(C(CC)(CC(C=O)=O)O)(O)=O,,,5,1,1,0,1
23217_0,,,,2,2,1,3
C(C(C=O)C(C(O)=O)(CC)O)=O,,,5,1,2,0,2
23217_1,,,,2,2,1,3
23219_0,,,,2,2,1,3
C(C(CC)(CC=O)O)(O)=O,,,5,1,2,0,2
23221_0,,,,2,2,1,3
C(C(CC)(C(C(C=O)=O)O)O)(O)=O,,,5,1,3,0,3
23221_1,,,,2,2,1,3
23223_0,,,,2,2,1,3
C(C(C(C)O)C(C(O)=O)(CC)O)=O,,,5,1,2,0,2
23223_1,,,,2,2,1,3
23225_0,,,,2,2,1,3
C(C(CO)C(C(O)=O)(CC)O)=O,,,5,1,2,0,2
23225_1,,,,2,2,1,3
23227_0,,,,2,2,1,3
C(C(CC)(C(C(C)=O)O)O)(O)=O,,,5,1,3,0,3
23227_1,,,,2,2,1,3
23229_0,,,,2,2,1,3
C(C(CC)(CC(CO)=O)O)(O)=O,,,5,1,1,0,1
23231_0,,,,2,2,1,3
C(C(CC)(CC(C(O)=O)=O)O)(O)=O,,,5,1,1,0,1
23233_0,,,,2,2,1,3
C(C(C=O)C(C(O)=O)(CC)O)(O)=O,,,5,1,2,0,2
23233_1,,,,2,2,1,3
23235_0,,,,2,2,1,3
C(C(CC)(C(C=O)O)O)(O)=O,,,5,1,3,0,3
23235_1,,,,2,2,1,3
23237_0,,,,2,2,1,3
C=C(C=O)C(C(C(C(O)=O)=O)C)O,,,5,1,1,0,1
23239_0,,,,2,2,1,3
C(C)=CC(C(C(C(O)=O)=O)C)O,,,5,1,1,0,1
23241_0,,,,2,2,1,3
C=CCC(C(C(C(O)=O)=O)C)O,,,5,1,1,0,1
23243_0,,,,2,2,1,3
C=CC(C(C(C(C(O)=O)=O)C)O)O,,,5,1,1,0,1
23245_0,,,,2,2,1,3
C=CC(C(C(C(O)=O)=O)C)O,,,5,1,1,0,1
23247_0,,,,2,2,1,3
C1OCC(C=1)(C(C(C(O)=O)=O)C)O,,,5,1,1,0,1
23249_0,,,,2,2,1,3
C(C(C(C)C(C(CO)O)O)=O)(O)=O,,,5,1,1,0,1
23250_0,,,,2,2,1,3
23252_0,,,,2,2,1,3
C(C(C(C)C(CO)(CO)O)=O)(O)=O,,,5,1,1,0,1
23254_0,,,,2,2,1,3
C(C(C(C(C(O)=O)=O)C)O)(O)=O,,,5,1,5,0,5
23256_0,,,,2,2,1,3
C(C(C)(C(C(C(O)=O)=O)C)O)=O,,,5,1,2,0,2
23258_0,,,,2,2,1,3
C(C(C(C(C(O)=O)=O)C)O)(C)=O,,,5,1,2,0,2
23259_0,,,,2,2,1,3
23261_0,,,,2,2,1,3
C(C(C(C)C(C)O)=O)(O)=O,,,5,1,1,0,1
23263_0,,,,2,2,1,3
C(C(CO)(C(C(C(O)=O)=O)C)O)=O,,,5,1,3,0,3
23265_0,,,,2,2,1,3
C(C(C(C(C(O)=O)=O)C)O)(CO)=O,,,5,1,2,0,2
23267_0,,,,2,2,1,3
C(C(C(C)C(CC(C)O)O)=O)(O)=O,,,5,1,1,0,1
23269_0,,,,2,2,1,3
C(C(C(C)C(CCO)O)=O)(O)=O,,,5,1,1,0,1
23270_0,,,,2,2,1,3
23272_0,,,,2,2,1,3
C(C(C(C)C(C)(CO)O)=O)(O)=O,,,5,1,1,0,1
23274_0,,,,2,2,1,3
C(C(C)(C(C(C(O)=O)=O)C)O)(O)=O,,,5,1,2,0,2
23276_0,,,,2,2,1,3
C(CC(C(C(C(O)=O)=O)C)O)(O)=O,,,5,1,1,0,1
23278_0,,,,2,2,1,3
C(C(C=C)(C(C(C(O)=O)=O)C)O)=O,,,5,1,1,0,1
23280_0,,,,2,2,1,3
C=CC(C(C(C(C(O)=O)=O)C)O)=O,,,5,1,1,0,1
23282_0,,,,2,2,1,3
C(C(C(C(C(O)=O)=O)C)O)=CC=O,,,5,1,1,0,1
23283_0,,,,2,2,1,3
23285_0,,,,2,2,1,3
C(C(C(C)C(C(O)O)O)=O)(O)=O,,,5,1,1,0,1
23287_0,,,,2,2,1,3
C(C(C(C)C(C(C)O)O)=O)(O)=O,,,5,1,1,0,1
23289_0,,,,2,2,1,3
C(C(C(C)CO)=O)(O)=O,,,5,1,3,0,3
23291_0,,,,2,2,1,3
C(C(C(C)C(CO)O)=O)(O)=O,,,5,1,3,0,3
23293_0,,,,2,2,1,3
C(C(C=C)C(C)(CC(O)=O)O)=O,,,5,1,1,0,1
23295_0,,,,2,2,1,3
C(CC(C)(C1C(C=CO1)=O)O)(O)=O,,,5,1,2,0,2
23295_1,,,,2,2,1,3
23297_0,,,,2,2,1,3
C(CC(C)(C(C(CO)=O)O)O)(O)=O,,,5,1,2,0,2
23297_1,,,,2,2,1,3
23299_0,,,,2,2,1,3
C(CC(C)(CC(C=O)=O)O)(O)=O,,,5,1,1,0,1
23301_0,,,,2,2,1,3
C(C(C=O)C(C)(CC(O)=O)O)=O,,,5,1,2,0,2
23301_1,,,,2,2,1,3
23303_0,,,,2,2,1,3
C(CC(C)(CC=O)O)(O)=O,,,5,1,1,0,1
23305_0,,,,2,2,1,3
C(CC(C)(C(C(C=O)=O)O)O)(O)=O,,,5,1,2,0,2
23305_1,,,,2,2,1,3
23307_0,,,,2,2,1,3
C(C(C(C)O)C(C)(CC(O)=O)O)=O,,,5,1,2,0,2
23307_1,,,,2,2,1,3
23309_0,,,,2,2,1,3
C(C(CO)C(C)(CC(O)=O)O)=O,,,5,1,2,0,2
23309_1,,,,2,2,1,3
23311_0,,,,2,2,1,3
C(CC(C)(C(C(C)=O)O)O)(O)=O,,,5,1,2,0,2
23311_1,,,,2,2,1,3
23313_0,,,,2,2,1,3
C(CC(C)(CC(CO)=O)O)(O)=O,,,5,1,1,0,1
23315_0,,,,2,2,1,3
C(CC(C)(CC(C(O)=O)=O)O)(O)=O,,,5,1,1,0,1
23317_0,,,,2,2,1,3
C(C(C=O)C(C)(CC(O)=O)O)(O)=O,,,5,1,2,0,2
23317_1,,,,2,2,1,3
23318_0,,,,2,2,1,3
23318_1,,,,2,2,1,3
23320_0,,,,2,2,1,3
C(C(C(C)=O)C(C(C=O)=C)O)(O)=O,,,5,1,2,0,2
23320_1,,,,2,2,1,3
23322_0,,,,2,2,1,3
C(C(C(C)=O)C(C=CC)O)(O)=O,,,5,1,2,0,2
23322_1,,,,2,2,1,3
23324_0,,,,2,2,1,3
C(C(C(C)=O)C(CC=C)O)(O)=O,,,5,1,2,0,2
23324_1,,,,2,2,1,3
23326_0,,,,2,2,1,3
C(C(C(C)=O)C(C(C=C)O)O)(O)=O,,,5,1,2,0,2
23326_1,,,,2,2,1,3
23328_0,,,,2,2,1,3
C(C(C(C)=O)C(C=C)O)(O)=O,,,5,1,2,0,2
23328_1,,,,2,2,1,3
23330_0,,,,2,2,1,3
C(C(C(C)=O)C1(C=COC1)O)(O)=O,,,5,1,2,0,2
23330_1,,,,2,2,1,3
23332_0,,,,2,2,1,3
C(C(C(C)=O)C(C(CO)O)O)(O)=O,,,5,1,3,0,3
23332_1,,,,2,2,1,3
23333_0,,,,2,2,1,3
23333_1,,,,2,2,1,3
23335_0,,,,2,2,1,3
C(C(C(C)=O)C(CO)(CO)O)(O)=O,,,5,1,2,0,2
23335_1,,,,2,2,1,3
23337_0,,,,2,2,1,3
C(C(C(C)=O)C(C(O)=O)O)(O)=O,,,5,1,9,0,9
23337_1,,,,2,2,1,3
23339_0,,,,2,2,1,3
C(C(C)(C(C(O)=O)C(C)=O)O)=O,,,5,1,3,0,3
23339_1,,,,2,2,1,3
23341_0,,,,2,2,1,3
C(C(C(C)=O)C(C(C)=O)O)(O)=O,,,5,1,3,0,3
23341_1,,,,2,2,1,3
23343_0,,,,2,2,1,3
C(CC(C(C(O)=O)C(C)=O)O)=O,,,5,1,3,0,3
23343_1,,,,2,2,1,3
23345_0,,,,2,2,1,3
C(C(C(C)=O)C(C)O)(O)=O,,,5,1,3,0,3
23345_1,,,,2,2,1,3
23347_0,,,,2,2,1,3
C(C(CO)(C(C(O)=O)C(C)=O)O)=O,,,5,1,4,0,4
23347_1,,,,2,2,1,3
23349_0,,,,2,2,1,3
C(C(C(C)=O)C(C(CO)=O)O)(O)=O,,,5,1,2,0,2
23349_1,,,,2,2,1,3
23351_0,,,,2,2,1,3
C(C(C(C)=O)C(CC(C)O)O)(O)=O,,,5,1,2,0,2
23351_1,,,,2,2,1,3
23353_0,,,,2,2,1,3
C(C(C(C)=O)C(CCO)O)(O)=O,,,5,1,3,0,3
23353_1,,,,2,2,1,3
23355_0,,,,2,2,1,3
C(C(C(C(C(O)=O)C(C)=O)O)O)=O,,,5,1,2,0,2
23355_1,,,,2,2,1,3
23357_0,,,,2,2,1,3
C(C(C(C)=O)C(C)(CO)O)(O)=O,,,5,1,3,0,3
23357_1,,,,2,2,1,3
23359_0,,,,2,2,1,3
C(C(C)(C(C(O)=O)C(C)=O)O)(O)=O,,,5,1,2,0,2
23359_1,,,,2,2,1,3
23361_0,,,,2,2,1,3
C(CC(C(C(O)=O)C(C)=O)O)(O)=O,,,5,1,2,0,2
23361_1,,,,2,2,1,3
23363_0,,,,2,2,1,3
C(C(C(C)=O)C(C=O)(C=C)O)(O)=O,,,5,1,2,0,2
23363_1,,,,2,2,1,3
23365_0,,,,2,2,1,3
C(C(C(C)=O)C(C(C=C)=O)O)(O)=O,,,5,1,2,0,2
23365_1,,,,2,2,1,3
23367_0,,,,2,2,1,3
C(C(C(C)=O)C(C=CC=O)O)(O)=O,,,5,1,2,0,2
23367_1,,,,2,2,1,3
23369_0,,,,2,2,1,3
C(C(C(O)=O)C(C)=O)(O)=O,,,5,1,3,0,3
23369_1,,,,2,2,1,3
23371_0,,,,2,2,1,3
C(C(C(C)=O)C(C(O)O)O)(O)=O,,,5,1,3,0,3
23371_1,,,,2,2,1,3
23373_0,,,,2,2,1,3
C(C(C(C)=O)C(C(C)O)O)(O)=O,,,5,1,3,0,3
23373_1,,,,2,2,1,3
23374_0,,,,2,2,1,3
23374_1,,,,2,2,1,3
23375_0,,,,2,2,1,3
23375_1,,,,2,2,1,3
23377_0,,,,2,2,1,3
C(CC(CC(C(C=O)=C)O)=O)(O)=O,,,5,1,1,0,1
23379_0,,,,2,2,1,3
C(CC(CC(C=CC)O)=O)(O)=O,,,5,1,1,0,1
23381_0,,,,2,2,1,3
C(CC(CC(CC=C)O)=O)(O)=O,,,5,1,1,0,1
23383_0,,,,2,2,1,3
C(CC(C(C=C)O)O)(CC(O)=O)=O,,,5,1,1,0,1
23385_0,,,,2,2,1,3
C(CC(CC(C=C)O)=O)(O)=O,,,5,1,1,0,1
23387_0,,,,2,2,1,3
C(CC(CC1(C=COC1)O)=O)(O)=O,,,5,1,1,0,1
23389_0,,,,2,2,1,3
C(CC(CC(C(CO)O)O)=O)(O)=O,,,5,1,2,0,2
23390_0,,,,2,2,1,3
23392_0,,,,2,2,1,3
C(CC(CC(CO)(CO)O)=O)(O)=O,,,5,1,1,0,1
23394_0,,,,2,2,1,3
C(CC(CC(C(O)=O)O)=O)(O)=O,,,5,1,8,0,8
23396_0,,,,2,2,1,3
C(C(C)(CC(CC(O)=O)=O)O)=O,,,5,1,3,0,3
23398_0,,,,2,2,1,3
C(CC(CC(C(C)=O)O)=O)(O)=O,,,5,1,3,0,3
23399_0,,,,2,2,1,3
23401_0,,,,2,2,1,3
C(CC(CC(C)O)=O)(O)=O,,,5,1,2,0,2
23403_0,,,,2,2,1,3
C(C(CO)(CC(CC(O)=O)=O)O)=O,,,5,1,3,0,3
23405_0,,,,2,2,1,3
C(CC(CC(C(CO)=O)O)=O)(O)=O,,,5,1,2,0,2
23407_0,,,,2,2,1,3
C(CC(CC(CC(C)O)O)=O)(O)=O,,,5,1,1,0,1
23409_0,,,,2,2,1,3
C(CC(CC(CCO)O)=O)(O)=O,,,5,1,1,0,1
23410_0,,,,2,2,1,3
23412_0,,,,2,2,1,3
C(CC(CC(C)(CO)O)=O)(O)=O,,,5,1,1,0,1
23414_0,,,,2,2,1,3
C(C(C)(CC(CC(O)=O)=O)O)(O)=O,,,5,1,2,0,2
23416_0,,,,2,2,1,3
C(CC(CC(CC(O)=O)O)=O)(O)=O,,,5,1,1,0,1
23418_0,,,,2,2,1,3
C(C(C=C)(CC(CC(O)=O)=O)O)=O,,,5,1,1,0,1
23420_0,,,,2,2,1,3
C(CC(CC(C(C=C)=O)O)=O)(O)=O,,,5,1,1,0,1
23422_0,,,,2,2,1,3
C(CC(CC(C=CC=O)O)=O)(O)=O,,,5,1,1,0,1
23424_0,,,,2,2,1,3
C(CC(CC(O)=O)=O)(O)=O,,,5,1,3,0,3
23426_0,,,,2,2,1,3
C(CC(CC(C(O)O)O)=O)(O)=O,,,5,1,1,0,1
23428_0,,,,2,2,1,3
C(CC(CC(C(C)O)O)=O)(O)=O,,,5,1,1,0,1
23430_0,,,,2,2,1,3
C(CC(CCO)=O)(O)=O,,,5,1,5,0,5
23432_0,,,,2,2,1,3
C(CC(CC(CO)O)=O)(O)=O,,,5,1,5,0,5
23433_0,,,,2,2,1,3
23433_1,,,,2,2,1,3
23435_0,,,,2,2,1,3
C(C(C(C(CO)CO)=O)(C)O)(O)=O,,,5,1,2,0,2
23435_1,,,,2,2,1,3
23437_0,,,,2,2,1,3
C(C(C)C(C=O)(CC=O)O)(O)=O,,,5,1,1,0,1
23439_0,,,,2,2,1,3
C(C(C)C(C=O)(C(C=O)O)O)(O)=O,,,5,1,2,0,2
23439_1,,,,2,2,1,3
23440_0,,,,2,2,1,3
23442_0,,,,2,2,1,3
C(C(C(C(C(C=O)O)O)=O)C)(O)=O,,,5,1,4,0,4
23442_1,,,,2,2,1,3
23444_0,,,,2,2,1,3
C(C(C=C)C(C(C(O)=O)C)O)=O,,,5,1,1,0,1
23446_0,,,,2,2,1,3
C(C(C)C(C1C(C=CO1)=O)O)(O)=O,,,5,1,2,0,2
23446_1,,,,2,2,1,3
23448_0,,,,2,2,1,3
C(C(C)C(C(C(CO)=O)O)O)(O)=O,,,5,1,3,0,3
23448_1,,,,2,2,1,3
23450_0,,,,2,2,1,3
C(C(C)C(CC(C=O)=O)O)(O)=O,,,5,1,1,0,1
23452_0,,,,2,2,1,3
C(C(C=O)C(C(C(O)=O)C)O)=O,,,5,1,2,0,2
23452_1,,,,2,2,1,3
23454_0,,,,2,2,1,3
C(C(C)C(CC=O)O)(O)=O,,,5,1,1,0,1
23456_0,,,,2,2,1,3
C(C(C)C(C(C(C=O)=O)O)O)(O)=O,,,5,1,2,0,2
23456_1,,,,2,2,1,3
23458_0,,,,2,2,1,3
C(C(C)C(C(C=O)C(C)O)O)(O)=O,,,5,1,2,0,2
23458_1,,,,2,2,1,3
23460_0,,,,2,2,1,3
C(C(C)C(C(C=O)CO)O)(O)=O,,,5,1,2,0,2
23460_1,,,,2,2,1,3
23462_0,,,,2,2,1,3
C(C(C)C(C(C(C)=O)O)O)(O)=O,,,5,1,2,0,2
23462_1,,,,2,2,1,3
23464_0,,,,2,2,1,3
C(C(C)C(CC(CO)=O)O)(O)=O,,,5,1,1,0,1
23466_0,,,,2,2,1,3
C(C(C)C(CC(C(O)=O)=O)O)(O)=O,,,5,1,1,0,1
23468_0,,,,2,2,1,3
C(C(C=O)C(C(C(O)=O)C)O)(O)=O,,,5,1,2,0,2
23468_1,,,,2,2,1,3
23470_0,,,,2,2,1,3
C(C(C)C(C(C=O)O)O)(O)=O,,,5,1,3,0,3
23470_1,,,,2,2,1,3
23472_0,,,,2,2,1,3
C(C(C)C(CO)(CC=O)O)(O)=O,,,5,1,1,0,1
23474_0,,,,2,2,1,3
C(C(C)C(CO)(C(C=O)O)O)(O)=O,,,5,1,2,0,2
23474_1,,,,2,2,1,3
23476_0,,,,2,2,1,3
C(C(C(C(C(C=C)O)O)=O)C)(O)=O,,,5,1,2,0,2
23476_1,,,,2,2,1,3
23477_0,,,,2,2,1,3
23477_1,,,,2,2,1,3
23479_0,,,,2,2,1,3
C(C(C(C(C(C)O)O)=O)C)(O)=O,,,5,1,3,0,3
23479_1,,,,2,2,1,3
23481_0,,,,2,2,1,3
C(C(C(C(C(O)=O)O)=O)C)(O)=O,,,5,1,2,0,2
23481_1,,,,2,2,1,3
23482_0,,,,2,2,1,3
23482_1,,,,2,2,1,3
23484_0,,,,2,2,1,3
C(C(C(C(C(CO)O)O)=O)C)(O)=O,,,5,1,6,0,6
23484_1,,,,2,2,1,3
23486_0,,,,2,2,1,3
C(C(C(CC=O)O)CCO)(O)=O,,,5,1,2,0,2
23488_0,,,,2,2,1,3
C(C(C(C(C=O)O)O)CCO)(O)=O,,,5,1,3,0,3
23488_1,,,,2,2,1,3
23490_0,,,,2,2,1,3
C(C(C(CCO)=O)(CCO)O)(O)=O,,,5,1,3,0,3
23492_0,,,,2,2,1,3
C(C(C(C(CO)O)=O)CCO)(O)=O,,,5,1,4,0,4
23492_1,,,,2,2,1,3
23494_0,,,,2,2,1,3
C(CC1(COC(CO)C1O)O)=O,,,5,1,1,0,1
23496_0,,,,2,2,1,3
C(C(C1(COC(CO)C1O)O)O)=O,,,5,1,2,0,2
23496_1,,,,2,2,1,3
23498_0,,,,2,2,1,3
C1(C(C(C=C)O)OC(CO)C1O)=O,,,5,1,2,0,2
23498_1,,,,2,2,1,3
23500_0,,,,2,2,1,3
C(C(C1C(C(C(CO)O1)O)=O)O)=O,,,5,1,2,0,2
23500_1,,,,2,2,1,3
23502_0,,,,2,2,1,3
C1(C(C(C)O)OC(CO)C1O)=O,,,5,1,2,0,2
23502_1,,,,2,2,1,3
23504_0,,,,2,2,1,3
C(C1C(C(C(CO)O1)O)=O)(O)=O,,,5,1,3,0,3
23504_1,,,,2,2,1,3
23506_0,,,,2,2,1,3
C1(C(CO)OC(CO)C1O)=O,,,5,1,3,0,3
23506_1,,,,2,2,1,3
23508_0,,,,2,2,1,3
C1(C(C(CO)O)OC(CO)C1O)=O,,,5,1,2,0,2
23508_1,,,,2,2,1,3
23510_0,,,,2,2,1,3
C(CC1(C(O)OC(CO)C1)O)=O,,,5,1,2,0,2
23512_0,,,,2,2,1,3
C(C(C1(C(O)OC(CO)C1)O)O)=O,,,5,1,3,0,3
23512_1,,,,2,2,1,3
23514_0,,,,2,2,1,3
C1(C(O)OC(CO)C1C(C=C)O)=O,,,5,1,2,0,2
23514_1,,,,2,2,1,3
23516_0,,,,2,2,1,3
C1(C(O)OC(CO)C1C(C=O)O)=O,,,5,1,3,0,3
23516_1,,,,2,2,1,3
23518_0,,,,2,2,1,3
C1(C(O)OC(CO)C1C(C)O)=O,,,5,1,3,0,3
23518_1,,,,2,2,1,3
23520_0,,,,2,2,1,3
C(C1C(C(O)OC1CO)=O)(O)=O,,,5,1,5,0,5
23520_1,,,,2,2,1,3
23521_0,,,,2,2,1,3
23521_1,,,,2,2,1,3
23523_0,,,,2,2,1,3
C1(C(O)OC(CO)C1C(CO)O)=O,,,5,1,3,0,3
23523_1,,,,2,2,1,3
23525_0,,,,2,2,1,3
C1(C(CO)OC(C(CO)O)C1O)=O,,,5,1,2,0,2
23525_1,,,,2,2,1,3
23526_0,,,,2,2,1,3
23526_1,,,,2,2,1,3
23528_0,,,,2,2,1,3
C(C(CO)C1C(C(C(O)O1)O)O)=O,,,5,1,4,0,4
23528_1,,,,2,2,1,3
23530_0,,,,2,2,1,3
C(C1C(C(C(O1)O)O)O)(CCO)=O,,,5,1,3,0,3
23532_0,,,,2,2,1,3
C(C1(COCC1(CC=O)O)O)=O,,,5,1,1,0,1
23534_0,,,,2,2,1,3
C(C1(COCC1(C(C=O)O)O)O)=O,,,5,1,2,0,2
23534_1,,,,2,2,1,3
23535_0,,,,2,2,1,3
23536_0,,,,2,2,1,3
23536_1,,,,2,2,1,3
23538_0,,,,2,2,1,3
C(C1(C(C(C(C=C)O)OC1)=O)O)=O,,,5,1,2,0,2
23538_1,,,,2,2,1,3
23540_0,,,,2,2,1,3
C(C(C1C(C(C=O)(CO1)O)=O)O)=O,,,5,1,2,0,2
23540_1,,,,2,2,1,3
23542_0,,,,2,2,1,3
C(C1(C(C(C(C)O)OC1)=O)O)=O,,,5,1,2,0,2
23542_1,,,,2,2,1,3
23544_0,,,,2,2,1,3
C(C1(C(C(C(O)=O)OC1)=O)O)=O,,,5,1,2,0,2
23544_1,,,,2,2,1,3
23546_0,,,,2,2,1,3
C(C1(C(C(CO)OC1)=O)O)=O,,,5,1,3,0,3
23546_1,,,,2,2,1,3
23548_0,,,,2,2,1,3
C(C1(C(C(C(CO)O)OC1)=O)O)=O,,,5,1,2,0,2
23548_1,,,,2,2,1,3
23550_0,,,,2,2,1,3
C(C1COC(C1(CC=O)O)O)=O,,,5,1,3,0,3
23552_0,,,,2,2,1,3
C(C1COC(C1(C(C=O)O)O)O)=O,,,5,1,3,0,3
23552_1,,,,2,2,1,3
23553_0,,,,2,2,1,3
23554_0,,,,2,2,1,3
23554_1,,,,2,2,1,3
23556_0,,,,2,2,1,3
C1(CC(CO1)(C(CC=O)O)O)=O,,,5,1,2,0,2
23558_0,,,,2,2,1,3
C1(CC(CO1)(C(C(C=O)O)O)O)=O,,,5,1,2,0,2
23558_1,,,,2,2,1,3
23560_0,,,,2,2,1,3
C(CC(C1C(O)OCC1O)O)=O,,,5,1,2,0,2
23562_0,,,,2,2,1,3
C(C(C(C1C(O)OCC1O)O)O)=O,,,5,1,3,0,3
23562_1,,,,2,2,1,3
23564_0,,,,2,2,1,3
C(C1(C(C(CO)OC1CO)=O)O)=O,,,5,1,2,0,2
23564_1,,,,2,2,1,3
23566_0,,,,2,2,1,3
C(C(CO)O)(C1C(O)OCC1O)=O,,,5,1,3,0,3
23566_1,,,,2,2,1,3
23568_0,,,,2,2,1,3
C(CCO)(C1(C(O)OCC1O)O)=O,,,5,1,2,0,2
23570_0,,,,2,2,1,3
C(C(C=C)C1(COC(C1O)=O)O)=O,,,5,1,1,0,1
23572_0,,,,2,2,1,3
C1(C(C(CO1)(CC(C=O)=O)O)O)=O,,,5,1,1,0,1
23574_0,,,,2,2,1,3
C(C(C=O)C1(COC(C1O)=O)O)=O,,,5,1,2,0,2
23574_1,,,,2,2,1,3
23575_0,,,,2,2,1,3
23577_0,,,,2,2,1,3
C(C(CO)C1(COC(C1O)=O)O)=O,,,5,1,4,0,4
23577_1,,,,2,2,1,3
23579_0,,,,2,2,1,3
C1(C(C(CO1)(C(C(C)=O)O)O)O)=O,,,5,1,3,0,3
23579_1,,,,2,2,1,3
23581_0,,,,2,2,1,3
C1(C(C(CO1)(CC(CO)=O)O)O)=O,,,5,1,1,0,1
23583_0,,,,2,2,1,3
C1(C(C(CO1)(C(C=O)O)O)O)=O,,,5,1,7,0,7
23583_1,,,,2,2,1,3
23585_0,,,,2,2,1,3
C1(C(C(C(C(C=CC)O)O1)=O)O)=O,,,5,1,2,0,2
23585_1,,,,2,2,1,3
23587_0,,,,2,2,1,3
C1(C(C(C(C(CC=C)O)O1)=O)O)=O,,,5,1,2,0,2
23587_1,,,,2,2,1,3
23589_0,,,,2,2,1,3
C1(C(C(C(C(C=C)O)O1)=O)O)=O,,,5,1,2,0,2
23589_1,,,,2,2,1,3
23591_0,,,,2,2,1,3
C1(C(C(C(C(C=O)O)O1)=O)O)=O,,,5,1,3,0,3
23591_1,,,,2,2,1,3
23593_0,,,,2,2,1,3
C1(C(C(C(C(C(O)=O)O)O1)=O)O)=O,,,5,1,2,0,2
23593_1,,,,2,2,1,3
23595_0,,,,2,2,1,3
C(C(C)(C1C(C(C(O1)=O)O)=O)O)=O,,,5,1,2,0,2
23595_1,,,,2,2,1,3
23597_0,,,,2,2,1,3
C1(C(C(C(C(C(C)=O)O)O1)=O)O)=O,,,5,1,2,0,2
23597_1,,,,2,2,1,3
23599_0,,,,2,2,1,3
C(CC(C1C(C(C(O1)=O)O)=O)O)=O,,,5,1,2,0,2
23599_1,,,,2,2,1,3
23601_0,,,,2,2,1,3
C1(C(C(C(C(C)O)O1)=O)O)=O,,,5,1,3,0,3
23601_1,,,,2,2,1,3
23603_0,,,,2,2,1,3
C1(C(C(C(C(CCO)O)O1)=O)O)=O,,,5,1,2,0,2
23603_1,,,,2,2,1,3
23605_0,,,,2,2,1,3
C1(C(C(C(C(CO)(C)O)O1)=O)O)=O,,,5,1,2,0,2
23605_1,,,,2,2,1,3
23607_0,,,,2,2,1,3
C1(C(C(C(C(O)=O)O1)=O)O)=O,,,5,1,3,0,3
23607_1,,,,2,2,1,3
23609_0,,,,2,2,1,3
C1(C(C(C(C(C(O)O)O)O1)=O)O)=O,,,5,1,2,0,2
23609_1,,,,2,2,1,3
23611_0,,,,2,2,1,3
C1(C(C(C(C(C(C)O)O)O1)=O)O)=O,,,5,1,2,0,2
23611_1,,,,2,2,1,3
23613_0,,,,2,2,1,3
C1(C(C(C(CO)O1)=O)O)=O,,,5,1,5,0,5
23613_1,,,,2,2,1,3
23615_0,,,,2,2,1,3
C1(C(C(C(C(CO)O)O1)=O)O)=O,,,5,1,5,0,5
23615_1,,,,2,2,1,3
23617_0,,,,2,2,1,3
C(C(C=C)C1(C(O)OC(C1)=O)O)=O,,,5,1,1,0,1
23619_0,,,,2,2,1,3
C1(CC(C(O)O1)(CC(C=O)=O)O)=O,,,5,1,2,0,2
23621_0,,,,2,2,1,3
C(C(C=O)C1(C(O)OC(C1)=O)O)=O,,,5,1,3,0,3
23621_1,,,,2,2,1,3
23623_0,,,,2,2,1,3
C1(CC(C(O)O1)(CC=O)O)=O,,,5,1,2,0,2
23625_0,,,,2,2,1,3
C(C(CO)C1(C(O)OC(C1)=O)O)=O,,,5,1,3,0,3
23625_1,,,,2,2,1,3
23627_0,,,,2,2,1,3
C1(CC(C(O)O1)(C(C(C)=O)O)O)=O,,,5,1,3,0,3
23627_1,,,,2,2,1,3
23629_0,,,,2,2,1,3
C1(CC(C(O)O1)(CC(CO)=O)O)=O,,,5,1,2,0,2
23631_0,,,,2,2,1,3
C1(CC(C(O)O1)(C(C=O)O)O)=O,,,5,1,3,0,3
23631_1,,,,2,2,1,3
23633_0,,,,2,2,1,3
C1(C(C(C(O)O1)=O)C(C=CC)O)=O,,,5,1,2,0,2
23633_1,,,,2,2,1,3
23635_0,,,,2,2,1,3
C1(C(C(C(O)O1)=O)C(CC=C)O)=O,,,5,1,2,0,2
23635_1,,,,2,2,1,3
23637_0,,,,2,2,1,3
C1(C(C(C(O)O1)=O)C(C=C)O)=O,,,5,1,2,0,2
23637_1,,,,2,2,1,3
23639_0,,,,2,2,1,3
C1(C(C(C(O)O1)=O)C(C=O)O)=O,,,5,1,4,0,4
23639_1,,,,2,2,1,3
23641_0,,,,2,2,1,3
C1(C(C(C(O)O1)=O)C(C(O)=O)O)=O,,,5,1,3,0,3
23641_1,,,,2,2,1,3
23643_0,,,,2,2,1,3
C(C(C)(C1C(OC(C1=O)O)=O)O)=O,,,5,1,3,0,3
23643_1,,,,2,2,1,3
23645_0,,,,2,2,1,3
C1(C(C(C(O)O1)=O)C(C(C)=O)O)=O,,,5,1,3,0,3
23645_1,,,,2,2,1,3
23647_0,,,,2,2,1,3
C(CC(C1C(OC(C1=O)O)=O)O)=O,,,5,1,3,0,3
23647_1,,,,2,2,1,3
23649_0,,,,2,2,1,3
C1(C(C(C(O)O1)=O)C(C)O)=O,,,5,1,4,0,4
23649_1,,,,2,2,1,3
23651_0,,,,2,2,1,3
C1(C(C(C(O)O1)=O)C(CCO)O)=O,,,5,1,3,0,3
23651_1,,,,2,2,1,3
23653_0,,,,2,2,1,3
C1(C(C(C(O)O1)=O)C(CO)(C)O)=O,,,5,1,3,0,3
23653_1,,,,2,2,1,3
23655_0,,,,2,2,1,3
C1(C(C(O)=O)C(C(O)O1)=O)=O,,,5,1,4,0,4
23655_1,,,,2,2,1,3
23657_0,,,,2,2,1,3
C1(C(C(C(O)O1)=O)C(C(O)O)O)=O,,,5,1,3,0,3
23657_1,,,,2,2,1,3
23659_0,,,,2,2,1,3
C1(C(C(C(O)O1)=O)C(C(C)O)O)=O,,,5,1,3,0,3
23659_1,,,,2,2,1,3
23661_0,,,,2,2,1,3
C1(C(C(C(O)O1)=O)CO)=O,,,5,1,4,0,4
23661_1,,,,2,2,1,3
23663_0,,,,2,2,1,3
C1(C(C(C(O)O1)=O)C(CO)O)=O,,,5,1,4,0,4
23663_1,,,,2,2,1,3
23665_0,,,,2,2,1,3
C(C(C=C)C1(C(OC(C1)O)=O)O)=O,,,5,1,1,0,1
23667_0,,,,2,2,1,3
C1(C(CC(O)O1)(CC(C=O)=O)O)=O,,,5,1,2,0,2
23669_0,,,,2,2,1,3
C(C(C=O)C1(C(OC(C1)O)=O)O)=O,,,5,1,3,0,3
23669_1,,,,2,2,1,3
23671_0,,,,2,2,1,3
C1(C(CC(O)O1)(CC=O)O)=O,,,5,1,2,0,2
23673_0,,,,2,2,1,3
C(C(CO)C1(C(OC(C1)O)=O)O)=O,,,5,1,3,0,3
23673_1,,,,2,2,1,3
23675_0,,,,2,2,1,3
C1(C(CC(O)O1)(C(C(C)=O)O)O)=O,,,5,1,4,0,4
23675_1,,,,2,2,1,3
23677_0,,,,2,2,1,3
C1(C(CC(O)O1)(CC(CO)=O)O)=O,,,5,1,2,0,2
23679_0,,,,2,2,1,3
C1(C(CC(O)O1)(C(C=O)O)O)=O,,,5,1,4,0,4
23679_1,,,,2,2,1,3
23681_0,,,,2,2,1,3
C(C)=CC(C1C(C(OC1O)=O)=O)O,,,5,1,2,0,2
23681_1,,,,2,2,1,3
23683_0,,,,2,2,1,3
C=CCC(C1C(C(OC1O)=O)=O)O,,,5,1,2,0,2
23683_1,,,,2,2,1,3
23685_0,,,,2,2,1,3
C=CC(C1C(C(OC1O)=O)=O)O,,,5,1,2,0,2
23685_1,,,,2,2,1,3
23687_0,,,,2,2,1,3
C(C(C1C(C(OC1O)=O)=O)O)=O,,,5,1,4,0,4
23687_1,,,,2,2,1,3
23689_0,,,,2,2,1,3
C(C(C1C(C(OC1O)=O)=O)O)(O)=O,,,5,1,3,0,3
23689_1,,,,2,2,1,3
23691_0,,,,2,2,1,3
C(C(C)(C1C(C(OC1O)=O)=O)O)=O,,,5,1,3,0,3
23691_1,,,,2,2,1,3
23693_0,,,,2,2,1,3
C(C(C1C(C(OC1O)=O)=O)O)(C)=O,,,5,1,3,0,3
23693_1,,,,2,2,1,3
23695_0,,,,2,2,1,3
C(CC(C1C(C(OC1O)=O)=O)O)=O,,,5,1,3,0,3
23695_1,,,,2,2,1,3
23697_0,,,,2,2,1,3
C1(C(C(C(O)O1)C(C)O)=O)=O,,,5,1,4,0,4
23697_1,,,,2,2,1,3
23699_0,,,,2,2,1,3
C1(C(C(C(O)O1)C(CCO)O)=O)=O,,,5,1,3,0,3
23699_1,,,,2,2,1,3
23701_0,,,,2,2,1,3
C1(C(C(C(O)O1)C(C)(CO)O)=O)=O,,,5,1,3,0,3
23701_1,,,,2,2,1,3
23703_0,,,,2,2,1,3
C(C1C(C(OC1O)=O)=O)(O)=O,,,5,1,3,0,3
23703_1,,,,2,2,1,3
23705_0,,,,2,2,1,3
C1(C(C(C(O)O1)C(C(O)O)O)=O)=O,,,5,1,3,0,3
23705_1,,,,2,2,1,3
23707_0,,,,2,2,1,3
C1(C(C(C(O)O1)C(C(C)O)O)=O)=O,,,5,1,3,0,3
23707_1,,,,2,2,1,3
23709_0,,,,2,2,1,3
C1(C(C(CO)C(O)O1)=O)=O,,,5,1,4,0,4
23709_1,,,,2,2,1,3
23711_0,,,,2,2,1,3
C1(C(C(C(O)O1)C(CO)O)=O)=O,,,5,1,4,0,4
23711_1,,,,2,2,1,3
23713_0,,,,2,2,1,3
C(CC1(COCC(C1O)O)O)=O,,,5,1,1,0,1
23715_0,,,,2,2,1,3
C(C(C1(COCC(C1O)O)O)O)=O,,,5,1,2,0,2
23715_1,,,,2,2,1,3
23717_0,,,,2,2,1,3
C1(C(C(C=C)O)OCC(C1O)O)=O,,,5,1,2,0,2
23717_1,,,,2,2,1,3
23719_0,,,,2,2,1,3
C(C(C1C(C(C(CO1)O)O)=O)O)=O,,,5,1,2,0,2
23719_1,,,,2,2,1,3
23721_0,,,,2,2,1,3
C1(C(C(C)O)OCC(C1O)O)=O,,,5,1,2,0,2
23721_1,,,,2,2,1,3
23723_0,,,,2,2,1,3
C(C1C(C(C(CO1)O)O)=O)(O)=O,,,5,1,3,0,3
23723_1,,,,2,2,1,3
23725_0,,,,2,2,1,3
C1(C(CO)OCC(C1O)O)=O,,,5,1,3,0,3
23725_1,,,,2,2,1,3
23727_0,,,,2,2,1,3
C1(C(C(CO)O)OCC(C1O)O)=O,,,5,1,2,0,2
23727_1,,,,2,2,1,3
23729_0,,,,2,2,1,3
C(CC1(C(O)OCC(C1)O)O)=O,,,5,1,2,0,2
23731_0,,,,2,2,1,3
C(C(C1(C(O)OCC(C1)O)O)O)=O,,,5,1,3,0,3
23731_1,,,,2,2,1,3
23733_0,,,,2,2,1,3
C1(C(O)OCC(C1C(C=C)O)O)=O,,,5,1,2,0,2
23733_1,,,,2,2,1,3
23735_0,,,,2,2,1,3
C1(C(O)OCC(C1C(C=O)O)O)=O,,,5,1,3,0,3
23735_1,,,,2,2,1,3
23737_0,,,,2,2,1,3
C1(C(O)OCC(C1C(C)O)O)=O,,,5,1,3,0,3
23737_1,,,,2,2,1,3
23739_0,,,,2,2,1,3
C(C1C(C(O)OCC1O)=O)(O)=O,,,5,1,5,0,5
23739_1,,,,2,2,1,3
23740_0,,,,2,2,1,3
23740_1,,,,2,2,1,3
23742_0,,,,2,2,1,3
C1(C(O)OCC(C1C(CO)O)O)=O,,,5,1,3,0,3
23742_1,,,,2,2,1,3
23744_0,,,,2,2,1,3
C(CC1(COC(C(C1)O)O)O)=O,,,5,1,2,0,2
23746_0,,,,2,2,1,3
C(C(C1(COC(C(C1)O)O)O)O)=O,,,5,1,3,0,3
23746_1,,,,2,2,1,3
23748_0,,,,2,2,1,3
C1(COC(C(C1C(C=C)O)O)O)=O,,,5,1,2,0,2
23748_1,,,,2,2,1,3
23750_0,,,,2,2,1,3
C1(COC(C(C1C(C=O)O)O)O)=O,,,5,1,3,0,3
23750_1,,,,2,2,1,3
23752_0,,,,2,2,1,3
C1(COC(C(C1C(C)O)O)O)=O,,,5,1,3,0,3
23752_1,,,,2,2,1,3
23754_0,,,,2,2,1,3
C(C1C(COC(C1O)O)=O)(O)=O,,,5,1,5,0,5
23754_1,,,,2,2,1,3
23756_0,,,,2,2,1,3
C1(COC(C(C1CO)O)O)=O,,,5,1,5,0,5
23756_1,,,,2,2,1,3
23758_0,,,,2,2,1,3
C1(COC(C(C1C(CO)O)O)O)=O,,,5,1,3,0,3
23758_1,,,,2,2,1,3
23760_0,,,,2,2,1,3
C1(C(C(C=C)O)OC(C(C1)O)O)=O,,,5,1,2,0,2
23760_1,,,,2,2,1,3
23762_0,,,,2,2,1,3
C(C(C1C(CC(C(O1)O)O)=O)O)=O,,,5,1,3,0,3
23762_1,,,,2,2,1,3
23764_0,,,,2,2,1,3
C1(C(C(C)O)OC(C(C1)O)O)=O,,,5,1,3,0,3
23764_1,,,,2,2,1,3
23766_0,,,,2,2,1,3
C(C1C(CC(C(O1)O)O)=O)(O)=O,,,5,1,5,0,5
23766_1,,,,2,2,1,3
23767_0,,,,2,2,1,3
23767_1,,,,2,2,1,3
23769_0,,,,2,2,1,3
C1(C(C(CO)O)OC(C(C1)O)O)=O,,,5,1,3,0,3
23769_1,,,,2,2,1,3
23771_0,,,,2,2,1,3
C(CC1(CC(O)OCC1O)O)=O,,,5,1,2,0,2
23773_0,,,,2,2,1,3
C(C(C1(C(COC(C1)O)O)O)O)=O,,,5,1,3,0,3
23773_1,,,,2,2,1,3
23775_0,,,,2,2,1,3
C1(C(C(O)OCC1O)C(C=C)O)=O,,,5,1,2,0,2
23775_1,,,,2,2,1,3
23777_0,,,,2,2,1,3
C1(C(C(O)OCC1O)C(C=O)O)=O,,,5,1,4,0,4
23777_1,,,,2,2,1,3
23779_0,,,,2,2,1,3
C1(C(COC(C1C(C)O)O)O)=O,,,5,1,4,0,4
23779_1,,,,2,2,1,3
23781_0,,,,2,2,1,3
C(C1C(C(COC1O)O)=O)(O)=O,,,5,1,3,0,3
23781_1,,,,2,2,1,3
23782_0,,,,2,2,1,3
23782_1,,,,2,2,1,3
23784_0,,,,2,2,1,3
C1(C(COC(C1C(CO)O)O)O)=O,,,5,1,3,0,3
23784_1,,,,2,2,1,3
23786_0,,,,2,2,1,3
C(CC1(CCOC(C1O)O)O)=O,,,5,1,2,0,2
23788_0,,,,2,2,1,3
C(C(C1(C(C(O)OCC1)O)O)O)=O,,,5,1,3,0,3
23788_1,,,,2,2,1,3
23790_0,,,,2,2,1,3
C1(C(COC(C1O)O)C(C=C)O)=O,,,5,1,2,0,2
23790_1,,,,2,2,1,3
23792_0,,,,2,2,1,3
C1(C(COC(C1O)O)C(C=O)O)=O,,,5,1,3,0,3
23792_1,,,,2,2,1,3
23794_0,,,,2,2,1,3
C1(C(C(O)OCC1C(C)O)O)=O,,,5,1,3,0,3
23794_1,,,,2,2,1,3
23796_0,,,,2,2,1,3
C(C1C(C(C(O)OC1)O)=O)(O)=O,,,5,1,3,0,3
23796_1,,,,2,2,1,3
23798_0,,,,2,2,1,3
C1(C(C(O)OCC1CO)O)=O,,,5,1,4,0,4
23798_1,,,,2,2,1,3
23800_0,,,,2,2,1,3
C1(C(C(O)OCC1C(CO)O)O)=O,,,5,1,3,0,3
23800_1,,,,2,2,1,3
23802_0,,,,2,2,1,3
C1(C(CO)OC(C(C1O)O)CO)=O,,,5,1,2,0,2
23802_1,,,,2,2,1,3
23803_0,,,,2,2,1,3
23803_1,,,,2,2,1,3
23805_0,,,,2,2,1,3
C1(C(CO)OC(C(C1CO)O)O)=O,,,5,1,3,0,3
23805_1,,,,2,2,1,3
23807_0,,,,2,2,1,3
C1(C(C(CO)OC(C1CO)O)O)=O,,,5,1,3,0,3
23807_1,,,,2,2,1,3
23809_0,,,,2,2,1,3
C1(C(C(O)OC(CO)C1CO)O)=O,,,5,1,3,0,3
23809_1,,,,2,2,1,3
23811_0,,,,2,2,1,3
C1(COC(C(CO)(C1CO)O)O)=O,,,5,1,4,0,4
23811_1,,,,2,2,1,3
23813_0,,,,2,2,1,3
C1(C(CO)OC(C(CO)(C1)O)O)=O,,,5,1,4,0,4
23813_1,,,,2,2,1,3
23815_0,,,,2,2,1,3
C1(C(C(O)OCC1CO)(CO)O)=O,,,5,1,3,0,3
23815_1,,,,2,2,1,3
23817_0,,,,2,2,1,3
C(C1(C(C(CO)OCC1O)=O)O)=O,,,5,1,2,0,2
23817_1,,,,2,2,1,3
23819_0,,,,2,2,1,3
C(C1C(C(CO)OC(C1O)O)=O)=O,,,5,1,3,0,3
23819_1,,,,2,2,1,3
23821_0,,,,2,2,1,3
C1(C(CO)OCC(C(C1O)O)O)=O,,,5,1,2,0,2
23821_1,,,,2,2,1,3
23822_0,,,,2,2,1,3
23822_1,,,,2,2,1,3
23824_0,,,,2,2,1,3
C1(C(COC(C(C1CO)O)O)O)=O,,,5,1,3,0,3
23824_1,,,,2,2,1,3
23826_0,,,,2,2,1,3
C1(C(C(C(O)OCC1CO)O)O)=O,,,5,1,3,0,3
23826_1,,,,2,2,1,3
23828_0,,,,2,2,1,3
C1(C(C(COC(C1CO)O)O)O)=O,,,5,1,3,0,3
23828_1,,,,2,2,1,3
23830_0,,,,2,2,1,3
C1(C(C(O)OCC(C1CO)O)O)=O,,,5,1,3,0,3
23830_1,,,,2,2,1,3
23832_0,,,,2,2,1,3
C1(COC(C(C(C1CO)O)O)O)=O,,,5,1,3,0,3
23832_1,,,,2,2,1,3
23834_0,,,,2,2,1,3
C1(C(CO)OC(C(C(C1)O)O)O)=O,,,5,1,3,0,3
23834_1,,,,2,2,1,3
23836_0,,,,2,2,1,3
C(C(C(C=O)=C)C1(C(OCC1)=O)O)=O,,,5,1,1,0,1
23838_0,,,,2,2,1,3
C1(C(CCO1)(CC(C=CC=O)=O)O)=O,,,5,1,1,0,1
23840_0,,,,2,2,1,3
C1(C(CCO1)(C(C=C)C(C=O)=O)O)=O,,,5,1,1,0,1
23842_0,,,,2,2,1,3
C(C(C=CC=O)C1(C(OCC1)=O)O)=O,,,5,1,1,0,1
23844_0,,,,2,2,1,3
C(C(C=C)C1(C(OCC1)=O)O)=O,,,5,1,1,0,1
23846_0,,,,2,2,1,3
C1(C(CCO1)(C2C(C=CO2)=O)O)=O,,,5,1,2,0,2
23846_1,,,,2,2,1,3
23847_0,,,,2,2,1,3
23847_1,,,,2,2,1,3
23849_0,,,,2,2,1,3
C1(C(CCO1)(CC(C=O)=O)O)=O,,,5,1,3,0,3
23851_0,,,,2,2,1,3
C(C(C=O)C1(C(OCC1)=O)O)=O,,,5,1,4,0,4
23851_1,,,,2,2,1,3
23853_0,,,,2,2,1,3
C1(C(CCO1)(CC=O)O)=O,,,5,1,3,0,3
23855_0,,,,2,2,1,3
C1(C(CCO1)(C(C(C=O)=O)O)O)=O,,,5,1,4,0,4
23855_1,,,,2,2,1,3
23857_0,,,,2,2,1,3
C(C(C(C)O)C1(C(OCC1)=O)O)=O,,,5,1,2,0,2
23857_1,,,,2,2,1,3
23859_0,,,,2,2,1,3
C(C(CO)C1(C(OCC1)=O)O)=O,,,5,1,4,0,4
23859_1,,,,2,2,1,3
23860_0,,,,2,2,1,3
23860_1,,,,2,2,1,3
23862_0,,,,2,2,1,3
C1(C(CCO1)(CC(CO)=O)O)=O,,,5,1,3,0,3
23864_0,,,,2,2,1,3
C1(C(CCO1)(CC(C(O)=O)=O)O)=O,,,5,1,1,0,1
23866_0,,,,2,2,1,3
C(C(C=O)C1(C(OCC1)=O)O)(O)=O,,,5,1,2,0,2
23866_1,,,,2,2,1,3
23867_0,,,,2,2,1,3
23867_1,,,,2,2,1,3
23869_0,,,,2,2,1,3
C(C(C1C(C(OC1)=O)=O)O)=C(C=O)C,,,5,1,2,0,2
23869_1,,,,2,2,1,3
23871_0,,,,2,2,1,3
C(C(C1C(C(OC1)=O)=O)O)(C)=CC=O,,,5,1,2,0,2
23871_1,,,,2,2,1,3
23873_0,,,,2,2,1,3
C=C(C=O)CC(C1C(C(OC1)=O)=O)O,,,5,1,2,0,2
23873_1,,,,2,2,1,3
23875_0,,,,2,2,1,3
C(CC(C(C1C(C(OC1)=O)=O)O)=C)=O,,,5,1,2,0,2
23875_1,,,,2,2,1,3
23877_0,,,,2,2,1,3
C(C(C1C(C(OC1)=O)=O)O)=CC(C)=O,,,5,1,2,0,2
23877_1,,,,2,2,1,3
23879_0,,,,2,2,1,3
C(C(C)(C1C(C(OC1)=O)=O)O)=CC=O,,,5,1,2,0,2
23879_1,,,,2,2,1,3
23881_0,,,,2,2,1,3
C(C(CC=C)(C1C(C(OC1)=O)=O)O)=O,,,5,1,2,0,2
23881_1,,,,2,2,1,3
23883_0,,,,2,2,1,3
C(C(C1C(C(OC1)=O)=O)O)(CC=C)=O,,,5,1,2,0,2
23883_1,,,,2,2,1,3
23885_0,,,,2,2,1,3
C(C(C=CC)(C1C(C(OC1)=O)=O)O)=O,,,5,1,2,0,2
23885_1,,,,2,2,1,3
23887_0,,,,2,2,1,3
C(C)=CC(C(C1C(C(OC1)=O)=O)O)=O,,,5,1,2,0,2
23887_1,,,,2,2,1,3
23889_0,,,,2,2,1,3
C(CC=CC(C1C(C(OC1)=O)=O)O)=O,,,5,1,2,0,2
23889_1,,,,2,2,1,3
23891_0,,,,2,2,1,3
C(CC(C1C(C(OC1)=O)=O)O)=CC=O,,,5,1,2,0,2
23891_1,,,,2,2,1,3
23893_0,,,,2,2,1,3
C(C(C=C)C(C1C(C(OC1)=O)=O)O)=O,,,5,1,2,0,2
23893_1,,,,2,2,1,3
23895_0,,,,2,2,1,3
C(C)=C(C=O)C(C1C(C(OC1)=O)=O)O,,,5,1,2,0,2
23895_1,,,,2,2,1,3
23897_0,,,,2,2,1,3
C=C(C=O)C(C1C(C(OC1)=O)=O)O,,,5,1,2,0,2
23897_1,,,,2,2,1,3
23899_0,,,,2,2,1,3
C(C)=CC(C1C(C(OC1)=O)=O)O,,,5,1,2,0,2
23899_1,,,,2,2,1,3
23901_0,,,,2,2,1,3
C=CCC(C1C(C(OC1)=O)=O)O,,,5,1,2,0,2
23901_1,,,,2,2,1,3
23903_0,,,,2,2,1,3
C=CC(C(C1C(C(OC1)=O)=O)O)O,,,5,1,2,0,2
23903_1,,,,2,2,1,3
23905_0,,,,2,2,1,3
C=CC(C1C(C(OC1)=O)=O)O,,,5,1,2,0,2
23905_1,,,,2,2,1,3
23907_0,,,,2,2,1,3
C1OCC(C=1)(C2C(C(OC2)=O)=O)O,,,5,1,2,0,2
23907_1,,,,2,2,1,3
23909_0,,,,2,2,1,3
C1(C(C(CO1)C(C(CO)O)O)=O)=O,,,5,1,2,0,2
23909_1,,,,2,2,1,3
23911_0,,,,2,2,1,3
C(C(C1C(C(OC1)=O)=O)O)=O,,,5,1,3,0,3
23911_1,,,,2,2,1,3
23913_0,,,,2,2,1,3
C1(C(C(CO1)C(CO)(CO)O)=O)=O,,,5,1,2,0,2
23913_1,,,,2,2,1,3
23915_0,,,,2,2,1,3
C(C(C1C(C(OC1)=O)=O)O)(O)=O,,,5,1,3,0,3
23915_1,,,,2,2,1,3
23917_0,,,,2,2,1,3
C(C(C)(C1C(C(OC1)=O)=O)O)=O,,,5,1,3,0,3
23917_1,,,,2,2,1,3
23919_0,,,,2,2,1,3
C(C(C1C(C(OC1)=O)=O)O)(C)=O,,,5,1,3,0,3
23919_1,,,,2,2,1,3
23921_0,,,,2,2,1,3
C(CC(C1C(C(OC1)=O)=O)O)=O,,,5,1,3,0,3
23921_1,,,,2,2,1,3
23923_0,,,,2,2,1,3
C1(C(C(CO1)C(C)O)=O)=O,,,5,1,3,0,3
23923_1,,,,2,2,1,3
23925_0,,,,2,2,1,3
C(C(CO)(C1C(C(OC1)=O)=O)O)=O,,,5,1,2,0,2
23925_1,,,,2,2,1,3
23927_0,,,,2,2,1,3
C(C(C1C(C(OC1)=O)=O)O)(CO)=O,,,5,1,2,0,2
23927_1,,,,2,2,1,3
23929_0,,,,2,2,1,3
C1(C(C(CO1)C(CC(C)O)O)=O)=O,,,5,1,2,0,2
23929_1,,,,2,2,1,3
23931_0,,,,2,2,1,3
C1(C(C(CO1)C(CCO)O)=O)=O,,,5,1,3,0,3
23931_1,,,,2,2,1,3
23933_0,,,,2,2,1,3
C(C(C(C1C(C(OC1)=O)=O)O)O)=O,,,5,1,2,0,2
23933_1,,,,2,2,1,3
23935_0,,,,2,2,1,3
C1(C(C(CO1)C(C)(CO)O)=O)=O,,,5,1,3,0,3
23935_1,,,,2,2,1,3
23937_0,,,,2,2,1,3
C(C(C)(C1C(C(OC1)=O)=O)O)(O)=O,,,5,1,2,0,2
23937_1,,,,2,2,1,3
23939_0,,,,2,2,1,3
C(CC(C1C(C(OC1)=O)=O)O)(O)=O,,,5,1,2,0,2
23939_1,,,,2,2,1,3
23941_0,,,,2,2,1,3
C(C(C=C)(C1C(C(OC1)=O)=O)O)=O,,,5,1,2,0,2
23941_1,,,,2,2,1,3
23943_0,,,,2,2,1,3
C=CC(C(C1C(C(OC1)=O)=O)O)=O,,,5,1,2,0,2
23943_1,,,,2,2,1,3
23945_0,,,,2,2,1,3
C(C(C1C(C(OC1)=O)=O)O)=CC=O,,,5,1,2,0,2
23945_1,,,,2,2,1,3
23947_0,,,,2,2,1,3
C(C1C(C(OC1)=O)=O)(O)=O,,,5,1,4,0,4
23947_1,,,,2,2,1,3
23949_0,,,,2,2,1,3
C1(C(C(CO1)C(C(O)O)O)=O)=O,,,5,1,3,0,3
23949_1,,,,2,2,1,3
23951_0,,,,2,2,1,3
C1(C(C(CO1)C(C(C)O)O)=O)=O,,,5,1,3,0,3
23951_1,,,,2,2,1,3
23953_0,,,,2,2,1,3
C1(C(C(CO1)CO)=O)=O,,,5,1,4,0,4
23953_1,,,,2,2,1,3
23955_0,,,,2,2,1,3
C1(C(C(CO1)C(CO)O)=O)=O,,,5,1,4,0,4
23955_1,,,,2,2,1,3
23957_0,,,,2,2,1,3
C(C(C(C=O)=C)C1(COC(C1)=O)O)=O,,,5,1,1,0,1
23959_0,,,,2,2,1,3
C1(CC(CO1)(CC(C=CC=O)=O)O)=O,,,5,1,1,0,1
23961_0,,,,2,2,1,3
C1(CC(CO1)(C(C=C)C(C=O)=O)O)=O,,,5,1,1,0,1
23963_0,,,,2,2,1,3
C(C(C=CC=O)C1(COC(C1)=O)O)=O,,,5,1,1,0,1
23965_0,,,,2,2,1,3
C(C(C=C)C1(COC(C1)=O)O)=O,,,5,1,1,0,1
23967_0,,,,2,2,1,3
C1(CC(CO1)(C2C(C=CO2)=O)O)=O,,,5,1,2,0,2
23967_1,,,,2,2,1,3
23969_0,,,,2,2,1,3
C1(CC(CO1)(C(C(CO)=O)O)O)=O,,,5,1,2,0,2
23969_1,,,,2,2,1,3
23971_0,,,,2,2,1,3
C1(CC(CO1)(CC(C=O)=O)O)=O,,,5,1,2,0,2
23973_0,,,,2,2,1,3
C(C(C=O)C1(COC(C1)=O)O)=O,,,5,1,3,0,3
23973_1,,,,2,2,1,3
23975_0,,,,2,2,1,3
C1(CC(CO1)(CC=O)O)=O,,,5,1,3,0,3
23977_0,,,,2,2,1,3
C1(CC(CO1)(C(C(C=O)=O)O)O)=O,,,5,1,2,0,2
23977_1,,,,2,2,1,3
23979_0,,,,2,2,1,3
C(C(C(C)O)C1(COC(C1)=O)O)=O,,,5,1,2,0,2
23979_1,,,,2,2,1,3
23981_0,,,,2,2,1,3
C(C(CO)C1(COC(C1)=O)O)=O,,,5,1,3,0,3
23981_1,,,,2,2,1,3
23983_0,,,,2,2,1,3
C1(CC(CO1)(C(C(C)=O)O)O)=O,,,5,1,3,0,3
23983_1,,,,2,2,1,3
23985_0,,,,2,2,1,3
C1(CC(CO1)(CC(CO)=O)O)=O,,,5,1,2,0,2
23987_0,,,,2,2,1,3
C1(CC(CO1)(CC(C(O)=O)=O)O)=O,,,5,1,1,0,1
23989_0,,,,2,2,1,3
C(C(C=O)C1(COC(C1)=O)O)(O)=O,,,5,1,2,0,2
23989_1,,,,2,2,1,3
23991_0,,,,2,2,1,3
C1(CC(CO1)(C(C=O)O)O)=O,,,5,1,3,0,3
23991_1,,,,2,2,1,3
23993_0,,,,2,2,1,3
C1(C(C(CO1)=O)C(C=C(C=O)C)O)=O,,,5,1,2,0,2
23993_1,,,,2,2,1,3
23995_0,,,,2,2,1,3
C1(C(C(CO1)=O)C(C(C)=CC=O)O)=O,,,5,1,2,0,2
23995_1,,,,2,2,1,3
23997_0,,,,2,2,1,3
C1(C(C(CO1)=O)C(CC(C=O)=C)O)=O,,,5,1,2,0,2
23997_1,,,,2,2,1,3
23999_0,,,,2,2,1,3
C1(C(C(CO1)=O)C(C(CC=O)=C)O)=O,,,5,1,2,0,2
23999_1,,,,2,2,1,3
24001_0,,,,2,2,1,3
C1(C(C(CO1)=O)C(C=CC(C)=O)O)=O,,,5,1,2,0,2
24001_1,,,,2,2,1,3
24003_0,,,,2,2,1,3
C1(C(C(CO1)=O)C(C=CC=O)(C)O)=O,,,5,1,2,0,2
24003_1,,,,2,2,1,3
24005_0,,,,2,2,1,3
C1(C(C(CO1)=O)C(C=O)(CC=C)O)=O,,,5,1,2,0,2
24005_1,,,,2,2,1,3
24007_0,,,,2,2,1,3
C1(C(C(CO1)=O)C(C(CC=C)=O)O)=O,,,5,1,2,0,2
24007_1,,,,2,2,1,3
24009_0,,,,2,2,1,3
C1(C(C(CO1)=O)C(C=O)(C=CC)O)=O,,,5,1,2,0,2
24009_1,,,,2,2,1,3
24011_0,,,,2,2,1,3
C1(C(C(CO1)=O)C(C(C=CC)=O)O)=O,,,5,1,2,0,2
24011_1,,,,2,2,1,3
24013_0,,,,2,2,1,3
C1(C(C(CO1)=O)C(C=CCC=O)O)=O,,,5,1,2,0,2
24013_1,,,,2,2,1,3
24015_0,,,,2,2,1,3
C1(C(C(CO1)=O)C(CC=CC=O)O)=O,,,5,1,2,0,2
24015_1,,,,2,2,1,3
24017_0,,,,2,2,1,3
C(C(C=C)C(C1C(OCC1=O)=O)O)=O,,,5,1,2,0,2
24017_1,,,,2,2,1,3
24019_0,,,,2,2,1,3
C1(C(C(CO1)=O)C(C(C=O)=CC)O)=O,,,5,1,2,0,2
24019_1,,,,2,2,1,3
24021_0,,,,2,2,1,3
C1(C(C(CO1)=O)C(C(C=O)=C)O)=O,,,5,1,2,0,2
24021_1,,,,2,2,1,3
24023_0,,,,2,2,1,3
C1(C(C(CO1)=O)C(C=CC)O)=O,,,5,1,2,0,2
24023_1,,,,2,2,1,3
24025_0,,,,2,2,1,3
C1(C(C(CO1)=O)C(CC=C)O)=O,,,5,1,2,0,2
24025_1,,,,2,2,1,3
24027_0,,,,2,2,1,3
C1(C(C(CO1)=O)C(C(C=C)O)O)=O,,,5,1,2,0,2
24027_1,,,,2,2,1,3
24029_0,,,,2,2,1,3
C1(C(C(CO1)=O)C(C=C)O)=O,,,5,1,2,0,2
24029_1,,,,2,2,1,3
24031_0,,,,2,2,1,3
C1(C(C(CO1)=O)C2(C=COC2)O)=O,,,5,1,2,0,2
24031_1,,,,2,2,1,3
24033_0,,,,2,2,1,3
C1(C(C(CO1)=O)C(C(CO)O)O)=O,,,5,1,2,0,2
24033_1,,,,2,2,1,3
24035_0,,,,2,2,1,3
C1(C(C(CO1)=O)C(C=O)O)=O,,,5,1,4,0,4
24035_1,,,,2,2,1,3
24037_0,,,,2,2,1,3
C1(C(C(CO1)=O)C(CO)(CO)O)=O,,,5,1,2,0,2
24037_1,,,,2,2,1,3
24039_0,,,,2,2,1,3
C1(C(C(CO1)=O)C(C(O)=O)O)=O,,,5,1,4,0,4
24039_1,,,,2,2,1,3
24041_0,,,,2,2,1,3
C(C(C)(C1C(OCC1=O)=O)O)=O,,,5,1,4,0,4
24041_1,,,,2,2,1,3
24043_0,,,,2,2,1,3
C1(C(C(CO1)=O)C(C(C)=O)O)=O,,,5,1,4,0,4
24043_1,,,,2,2,1,3
24045_0,,,,2,2,1,3
C(CC(C1C(OCC1=O)=O)O)=O,,,5,1,4,0,4
24045_1,,,,2,2,1,3
24047_0,,,,2,2,1,3
C1(C(C(CO1)=O)C(C)O)=O,,,5,1,4,0,4
24047_1,,,,2,2,1,3
24049_0,,,,2,2,1,3
C(C(CO)(C1C(OCC1=O)=O)O)=O,,,5,1,2,0,2
24049_1,,,,2,2,1,3
24051_0,,,,2,2,1,3
C1(C(C(CO1)=O)C(C(CO)=O)O)=O,,,5,1,2,0,2
24051_1,,,,2,2,1,3
24053_0,,,,2,2,1,3
C1(C(C(CO1)=O)C(CC(C)O)O)=O,,,5,1,2,0,2
24053_1,,,,2,2,1,3
24055_0,,,,2,2,1,3
C1(C(C(CO1)=O)C(CCO)O)=O,,,5,1,4,0,4
24055_1,,,,2,2,1,3
24057_0,,,,2,2,1,3
C(C(C(C1C(OCC1=O)=O)O)O)=O,,,5,1,2,0,2
24057_1,,,,2,2,1,3
24059_0,,,,2,2,1,3
C1(C(C(CO1)=O)C(C)(CO)O)=O,,,5,1,4,0,4
24059_1,,,,2,2,1,3
24061_0,,,,2,2,1,3
C(C(C)(C1C(OCC1=O)=O)O)(O)=O,,,5,1,2,0,2
24061_1,,,,2,2,1,3
24063_0,,,,2,2,1,3
C(CC(C1C(OCC1=O)=O)O)(O)=O,,,5,1,2,0,2
24063_1,,,,2,2,1,3
24065_0,,,,2,2,1,3
C1(C(C(CO1)=O)C(C=O)(C=C)O)=O,,,5,1,2,0,2
24065_1,,,,2,2,1,3
24067_0,,,,2,2,1,3
C1(C(C(CO1)=O)C(C(C=C)=O)O)=O,,,5,1,2,0,2
24067_1,,,,2,2,1,3
24069_0,,,,2,2,1,3
C1(C(C(CO1)=O)C(C=CC=O)O)=O,,,5,1,2,0,2
24069_1,,,,2,2,1,3
24071_0,,,,2,2,1,3
C1(C(C(O)=O)C(CO1)=O)=O,,,5,1,4,0,4
24071_1,,,,2,2,1,3
24073_0,,,,2,2,1,3
C1(C(C(CO1)=O)C(C(O)O)O)=O,,,5,1,4,0,4
24073_1,,,,2,2,1,3
24075_0,,,,2,2,1,3
C1(C(C(CO1)=O)C(C(C)O)O)=O,,,5,1,4,0,4
24075_1,,,,2,2,1,3
24077_0,,,,2,2,1,3
C1(C(C(CO1)=O)CO)=O,,,5,1,5,0,5
24077_1,,,,2,2,1,3
24079_0,,,,2,2,1,3
C1(C(C(CO1)=O)C(CO)O)=O,,,5,1,5,0,5
24079_1,,,,2,2,1,3
24081_0,,,,2,2,1,3
C1(CC(C(C(C=C(C=O)C)O)O1)=O)=O,,,5,1,2,0,2
24081_1,,,,2,2,1,3
24083_0,,,,2,2,1,3
C1(CC(C(C(C(C)=CC=O)O)O1)=O)=O,,,5,1,2,0,2
24083_1,,,,2,2,1,3
24085_0,,,,2,2,1,3
C1(CC(C(C(CC(C=O)=C)O)O1)=O)=O,,,5,1,2,0,2
24085_1,,,,2,2,1,3
24087_0,,,,2,2,1,3
C1(CC(C(C(C(CC=O)=C)O)O1)=O)=O,,,5,1,2,0,2
24087_1,,,,2,2,1,3
24089_0,,,,2,2,1,3
C1(CC(C(C(C=CC(C)=O)O)O1)=O)=O,,,5,1,2,0,2
24089_1,,,,2,2,1,3
24091_0,,,,2,2,1,3
C1(CC(C(C(C=CC=O)(C)O)O1)=O)=O,,,5,1,2,0,2
24091_1,,,,2,2,1,3
24093_0,,,,2,2,1,3
C1(CC(C(C(C=O)(CC=C)O)O1)=O)=O,,,5,1,2,0,2
24093_1,,,,2,2,1,3
24095_0,,,,2,2,1,3
C1(CC(C(C(C(CC=C)=O)O)O1)=O)=O,,,5,1,2,0,2
24095_1,,,,2,2,1,3
24097_0,,,,2,2,1,3
C(C(C=CC)(C1C(CC(O1)=O)=O)O)=O,,,5,1,2,0,2
24097_1,,,,2,2,1,3
24099_0,,,,2,2,1,3
C1(CC(C(C(C(C=CC)=O)O)O1)=O)=O,,,5,1,2,0,2
24099_1,,,,2,2,1,3
24101_0,,,,2,2,1,3
C(CC=CC(C1C(CC(O1)=O)=O)O)=O,,,5,1,2,0,2
24101_1,,,,2,2,1,3
24103_0,,,,2,2,1,3
C1(CC(C(C(CC=CC=O)O)O1)=O)=O,,,5,1,2,0,2
24103_1,,,,2,2,1,3
24105_0,,,,2,2,1,3
C(C(C=C)C(C1C(CC(O1)=O)=O)O)=O,,,5,1,2,0,2
24105_1,,,,2,2,1,3
24107_0,,,,2,2,1,3
C1(CC(C(C(C(C=O)=CC)O)O1)=O)=O,,,5,1,2,0,2
24107_1,,,,2,2,1,3
24109_0,,,,2,2,1,3
C1(CC(C(C(C(C=O)=C)O)O1)=O)=O,,,5,1,2,0,2
24109_1,,,,2,2,1,3
24111_0,,,,2,2,1,3
C1(CC(C(C(C=CC)O)O1)=O)=O,,,5,1,2,0,2
24111_1,,,,2,2,1,3
24113_0,,,,2,2,1,3
C1(CC(C(C(CC=C)O)O1)=O)=O,,,5,1,2,0,2
24113_1,,,,2,2,1,3
24115_0,,,,2,2,1,3
C1(CC(C(C(C(C=C)O)O)O1)=O)=O,,,5,1,2,0,2
24115_1,,,,2,2,1,3
24117_0,,,,2,2,1,3
C1(CC(C(C(C=C)O)O1)=O)=O,,,5,1,2,0,2
24117_1,,,,2,2,1,3
24119_0,,,,2,2,1,3
C1(CC(C(C2(C=COC2)O)O1)=O)=O,,,5,1,2,0,2
24119_1,,,,2,2,1,3
24121_0,,,,2,2,1,3
C1(CC(C(C(C(CO)O)O)O1)=O)=O,,,5,1,2,0,2
24121_1,,,,2,2,1,3
24123_0,,,,2,2,1,3
C1(CC(C(C(C=O)O)O1)=O)=O,,,5,1,4,0,4
24123_1,,,,2,2,1,3
24125_0,,,,2,2,1,3
C1(CC(C(C(CO)(CO)O)O1)=O)=O,,,5,1,2,0,2
24125_1,,,,2,2,1,3
24127_0,,,,2,2,1,3
C1(CC(C(C(C(O)=O)O)O1)=O)=O,,,5,1,3,0,3
24127_1,,,,2,2,1,3
24129_0,,,,2,2,1,3
C(C(C)(C1C(CC(O1)=O)=O)O)=O,,,5,1,3,0,3
24129_1,,,,2,2,1,3
24131_0,,,,2,2,1,3
C1(CC(C(C(C(C)=O)O)O1)=O)=O,,,5,1,3,0,3
24131_1,,,,2,2,1,3
24133_0,,,,2,2,1,3
C(CC(C1C(CC(O1)=O)=O)O)=O,,,5,1,3,0,3
24133_1,,,,2,2,1,3
24135_0,,,,2,2,1,3
C1(CC(C(C(C)O)O1)=O)=O,,,5,1,3,0,3
24135_1,,,,2,2,1,3
24137_0,,,,2,2,1,3
C(C(CO)(C1C(CC(O1)=O)=O)O)=O,,,5,1,2,0,2
24137_1,,,,2,2,1,3
24139_0,,,,2,2,1,3
C1(CC(C(C(C(CO)=O)O)O1)=O)=O,,,5,1,2,0,2
24139_1,,,,2,2,1,3
24141_0,,,,2,2,1,3
C1(CC(C(C(CC(C)O)O)O1)=O)=O,,,5,1,2,0,2
24141_1,,,,2,2,1,3
24143_0,,,,2,2,1,3
C1(CC(C(C(CCO)O)O1)=O)=O,,,5,1,3,0,3
24143_1,,,,2,2,1,3
24145_0,,,,2,2,1,3
C(C(C(C1C(CC(O1)=O)=O)O)O)=O,,,5,1,2,0,2
24145_1,,,,2,2,1,3
24147_0,,,,2,2,1,3
C1(CC(C(C(C)(CO)O)O1)=O)=O,,,5,1,3,0,3
24147_1,,,,2,2,1,3
24149_0,,,,2,2,1,3
C(C(C)(C1C(CC(O1)=O)=O)O)(O)=O,,,5,1,2,0,2
24149_1,,,,2,2,1,3
24151_0,,,,2,2,1,3
C(CC(C1C(CC(O1)=O)=O)O)(O)=O,,,5,1,2,0,2
24151_1,,,,2,2,1,3
24153_0,,,,2,2,1,3
C(C(C=C)(C1C(CC(O1)=O)=O)O)=O,,,5,1,2,0,2
24153_1,,,,2,2,1,3
24155_0,,,,2,2,1,3
C1(CC(C(C(C(C=C)=O)O)O1)=O)=O,,,5,1,2,0,2
24155_1,,,,2,2,1,3
24157_0,,,,2,2,1,3
C1(CC(C(C(C=CC=O)O)O1)=O)=O,,,5,1,2,0,2
24157_1,,,,2,2,1,3
24159_0,,,,2,2,1,3
C1(CC(C(C(O)=O)O1)=O)=O,,,5,1,3,0,3
24159_1,,,,2,2,1,3
24161_0,,,,2,2,1,3
C1(CC(C(C(C(O)O)O)O1)=O)=O,,,5,1,3,0,3
24161_1,,,,2,2,1,3
24163_0,,,,2,2,1,3
C1(CC(C(C(C(C)O)O)O1)=O)=O,,,5,1,3,0,3
24163_1,,,,2,2,1,3
24164_0,,,,2,2,1,3
24164_1,,,,2,2,1,3
24165_0,,,,2,2,1,3
24165_1,,,,2,2,1,3
24167_0,,,,2,2,1,3
C1(C(CC(CO)O1)(CC=O)O)=O,,,5,1,2,0,2
24169_0,,,,2,2,1,3
C1(C(CC(CO)O1)(C(C=O)O)O)=O,,,5,1,3,0,3
24169_1,,,,2,2,1,3
24171_0,,,,2,2,1,3
C=CC(C1C(C(OC1CO)=O)=O)O,,,5,1,2,0,2
24171_1,,,,2,2,1,3
24173_0,,,,2,2,1,3
C(C(C1C(C(OC1CO)=O)=O)O)=O,,,5,1,2,0,2
24173_1,,,,2,2,1,3
24175_0,,,,2,2,1,3
C1(C(C(C(CO)O1)C(C)O)=O)=O,,,5,1,3,0,3
24175_1,,,,2,2,1,3
24177_0,,,,2,2,1,3
C(C1C(C(OC1CO)=O)=O)(O)=O,,,5,1,3,0,3
24177_1,,,,2,2,1,3
24179_0,,,,2,2,1,3
C1(C(C(CO)C(CO)O1)=O)=O,,,5,1,4,0,4
24179_1,,,,2,2,1,3
24181_0,,,,2,2,1,3
C1(C(C(C(CO)O1)C(CO)O)=O)=O,,,5,1,2,0,2
24181_1,,,,2,2,1,3
24183_0,,,,2,2,1,3
C1(CC(C(CO)O1)(CC=O)O)=O,,,5,1,2,0,2
24185_0,,,,2,2,1,3
C1(CC(C(CO)O1)(C(C=O)O)O)=O,,,5,1,2,0,2
24185_1,,,,2,2,1,3
24187_0,,,,2,2,1,3
C1(C(CO)OC(C1C(C=C)O)=O)=O,,,5,1,2,0,2
24187_1,,,,2,2,1,3
24189_0,,,,2,2,1,3
C1(C(CO)OC(C1C(C=O)O)=O)=O,,,5,1,2,0,2
24189_1,,,,2,2,1,3
24191_0,,,,2,2,1,3
C1(C(C(C(CO)O1)=O)C(C)O)=O,,,5,1,4,0,4
24191_1,,,,2,2,1,3
24193_0,,,,2,2,1,3
C(C1C(OC(C1=O)CO)=O)(O)=O,,,5,1,4,0,4
24193_1,,,,2,2,1,3
24195_0,,,,2,2,1,3
C1(C(C(C(CO)O1)=O)CO)=O,,,5,1,4,0,4
24195_1,,,,2,2,1,3
24197_0,,,,2,2,1,3
C1(C(C(C(CO)O1)=O)C(CO)O)=O,,,5,1,2,0,2
24197_1,,,,2,2,1,3
24199_0,,,,2,2,1,3
C1(C(C(CO)C(C(CO)O)O1)=O)=O,,,5,1,2,0,2
24199_1,,,,2,2,1,3
24201_0,,,,2,2,1,3
C1(C(C(C(C(CO)O)O1)=O)CO)=O,,,5,1,2,0,2
24201_1,,,,2,2,1,3
24203_0,,,,2,2,1,3
C(C(CO)C1C(C(C(O1)=O)O)O)=O,,,5,1,2,0,2
24203_1,,,,2,2,1,3
24205_0,,,,2,2,1,3
C1(C(C(C(C(CCO)=O)O1)O)O)=O,,,5,1,2,0,2
24207_0,,,,2,2,1,3
C1(C(CC(CO1)O)(CC=O)O)=O,,,5,1,2,0,2
24209_0,,,,2,2,1,3
C1(C(CC(CO1)O)(C(C=O)O)O)=O,,,5,1,3,0,3
24209_1,,,,2,2,1,3
24211_0,,,,2,2,1,3
C=CC(C1C(C(OCC1O)=O)=O)O,,,5,1,2,0,2
24211_1,,,,2,2,1,3
24213_0,,,,2,2,1,3
C(C(C1C(C(OCC1O)=O)=O)O)=O,,,5,1,2,0,2
24213_1,,,,2,2,1,3
24215_0,,,,2,2,1,3
C1(C(C(C(C)O)C(CO1)O)=O)=O,,,5,1,3,0,3
24215_1,,,,2,2,1,3
24217_0,,,,2,2,1,3
C(C1C(C(OCC1O)=O)=O)(O)=O,,,5,1,3,0,3
24217_1,,,,2,2,1,3
24219_0,,,,2,2,1,3
C1(C(C(CO)C(CO1)O)=O)=O,,,5,1,4,0,4
24219_1,,,,2,2,1,3
24221_0,,,,2,2,1,3
C1(C(C(C(CO)O)C(CO1)O)=O)=O,,,5,1,2,0,2
24221_1,,,,2,2,1,3
24223_0,,,,2,2,1,3
C(CC1(COC(C(C1)O)=O)O)=O,,,5,1,3,0,3
24225_0,,,,2,2,1,3
C1(C(CC(CO1)(C(C=O)O)O)O)=O,,,5,1,2,0,2
24225_1,,,,2,2,1,3
24227_0,,,,2,2,1,3
C1(C(C(C(CO1)=O)C(C=C)O)O)=O,,,5,1,2,0,2
24227_1,,,,2,2,1,3
24229_0,,,,2,2,1,3
C1(C(C(C(CO1)=O)C(C=O)O)O)=O,,,5,1,2,0,2
24229_1,,,,2,2,1,3
24231_0,,,,2,2,1,3
C1(COC(C(C1C(C)O)O)=O)=O,,,5,1,3,0,3
24231_1,,,,2,2,1,3
24233_0,,,,2,2,1,3
C(C1C(COC(C1O)=O)=O)(O)=O,,,5,1,4,0,4
24233_1,,,,2,2,1,3
24235_0,,,,2,2,1,3
C1(COC(C(C1CO)O)=O)=O,,,5,1,5,0,5
24235_1,,,,2,2,1,3
24237_0,,,,2,2,1,3
C1(COC(C(C1C(CO)O)O)=O)=O,,,5,1,2,0,2
24237_1,,,,2,2,1,3
24239_0,,,,2,2,1,3
C1(C(CC(C(C(C=C)O)O1)=O)O)=O,,,5,1,2,0,2
24239_1,,,,2,2,1,3
24241_0,,,,2,2,1,3
C1(C(CC(C(C(C=O)O)O1)=O)O)=O,,,5,1,2,0,2
24241_1,,,,2,2,1,3
24243_0,,,,2,2,1,3
C1(CC(C(OC1C(C)O)=O)O)=O,,,5,1,3,0,3
24243_1,,,,2,2,1,3
24245_0,,,,2,2,1,3
C(C1C(CC(C(O1)=O)O)=O)(O)=O,,,5,1,4,0,4
24245_1,,,,2,2,1,3
24246_0,,,,2,2,1,3
24246_1,,,,2,2,1,3
24248_0,,,,2,2,1,3
C1(CC(C(OC1C(CO)O)=O)O)=O,,,5,1,2,0,2
24248_1,,,,2,2,1,3
24250_0,,,,2,2,1,3
C1(CC(C(CO1)O)(CC=O)O)=O,,,5,1,2,0,2
24252_0,,,,2,2,1,3
C1(CC(C(CO1)O)(C(C=O)O)O)=O,,,5,1,2,0,2
24252_1,,,,2,2,1,3
24254_0,,,,2,2,1,3
C1(C(COC(C1C(C=C)O)=O)O)=O,,,5,1,2,0,2
24254_1,,,,2,2,1,3
24256_0,,,,2,2,1,3
C1(C(COC(C1C(C=O)O)=O)O)=O,,,5,1,2,0,2
24256_1,,,,2,2,1,3
24258_0,,,,2,2,1,3
C1(C(C(C(CO1)O)=O)C(C)O)=O,,,5,1,4,0,4
24258_1,,,,2,2,1,3
24260_0,,,,2,2,1,3
C1(C(C(O)=O)C(C(CO1)O)=O)=O,,,5,1,4,0,4
24260_1,,,,2,2,1,3
24262_0,,,,2,2,1,3
C1(C(C(C(CO1)O)=O)CO)=O,,,5,1,4,0,4
24262_1,,,,2,2,1,3
24264_0,,,,2,2,1,3
C1(C(C(C(CO1)O)=O)C(CO)O)=O,,,5,1,2,0,2
24264_1,,,,2,2,1,3
24266_0,,,,2,2,1,3
C(CC1(CCOC(C1O)=O)O)=O,,,5,1,2,0,2
24268_0,,,,2,2,1,3
C1(C(C(CCO1)(C(C=O)O)O)O)=O,,,5,1,2,0,2
24268_1,,,,2,2,1,3
24270_0,,,,2,2,1,3
C1(C(COC(C1O)=O)C(C=C)O)=O,,,5,1,2,0,2
24270_1,,,,2,2,1,3
24272_0,,,,2,2,1,3
C1(C(COC(C1O)=O)C(C=O)O)=O,,,5,1,2,0,2
24272_1,,,,2,2,1,3
24274_0,,,,2,2,1,3
C1(C(C(C(CO1)C(C)O)=O)O)=O,,,5,1,3,0,3
24274_1,,,,2,2,1,3
24276_0,,,,2,2,1,3
C(C1C(C(C(OC1)=O)O)=O)(O)=O,,,5,1,3,0,3
24276_1,,,,2,2,1,3
24278_0,,,,2,2,1,3
C1(C(C(C(CO)CO1)=O)O)=O,,,5,1,4,0,4
24278_1,,,,2,2,1,3
24280_0,,,,2,2,1,3
C1(C(C(C(CO1)C(CO)O)=O)O)=O,,,5,1,2,0,2
24280_1,,,,2,2,1,3
24282_0,,,,2,2,1,3
C1(C(C(CO)C(C(CO)O1)O)=O)=O,,,5,1,2,0,2
24282_1,,,,2,2,1,3
24284_0,,,,2,2,1,3
C1(C(CO)OC(C(C1CO)O)=O)=O,,,5,1,2,0,2
24284_1,,,,2,2,1,3
24286_0,,,,2,2,1,3
C1(C(C(C(C(CO)O1)O)=O)CO)=O,,,5,1,2,0,2
24286_1,,,,2,2,1,3
24288_0,,,,2,2,1,3
C1(C(C(C(CO)C(CO)O1)=O)O)=O,,,5,1,2,0,2
24288_1,,,,2,2,1,3
24290_0,,,,2,2,1,3
C1(C(C(CO)C(C(CO1)O)O)=O)=O,,,5,1,2,0,2
24290_1,,,,2,2,1,3
24292_0,,,,2,2,1,3
C1(C(CO)C(C(OCC1O)=O)O)=O,,,5,1,2,0,2
24292_1,,,,2,2,1,3
24294_0,,,,2,2,1,3
C1(C(C(C(OCC1CO)=O)O)O)=O,,,5,1,2,0,2
24294_1,,,,2,2,1,3
24296_0,,,,2,2,1,3
C1(C(C(C(C(CO1)O)O)=O)CO)=O,,,5,1,2,0,2
24296_1,,,,2,2,1,3
24298_0,,,,2,2,1,3
C1(C(C(C(CO)C(CO1)O)=O)O)=O,,,5,1,2,0,2
24298_1,,,,2,2,1,3
24300_0,,,,2,2,1,3
C1(C(C(C(C(CO1)=O)CO)O)O)=O,,,5,1,2,0,2
24300_1,,,,2,2,1,3
24302_0,,,,2,2,1,3
C1(C(C(CC(C(CO)O1)=O)O)O)=O,,,5,1,2,0,2
24302_1,,,,2,2,1,3
24303_0,,,,2,2,1,3
24304_0,,,,2,2,1,3
24306_0,,,,2,2,1,3
C(CC(C)O)(C(C(C(O)=O)=O)O)=O,,,5,1,2,0,2
24308_0,,,,2,2,1,3
C(CC(C(C(C(O)=O)=O)O)=O)(O)=O,,,5,1,3,0,3
24309_0,,,,2,2,1,3
24310_0,,,,2,2,1,3
24312_0,,,,2,2,1,3
C(CC(C(C(O)=O)=O)(CCO)O)=O,,,5,1,2,0,2
24314_0,,,,2,2,1,3
C(C(C(C(CO)C(C)O)=O)=O)(O)=O,,,5,1,2,0,2
24314_1,,,,2,2,1,3
24316_0,,,,2,2,1,3
C(C(C(C(C(O)=O)=O)=O)CO)(O)=O,,,5,1,2,0,2
24316_1,,,,2,2,1,3
24318_0,,,,2,2,1,3
C(C(C(C(CO)CO)=O)=O)(O)=O,,,5,1,4,0,4
24318_1,,,,2,2,1,3
24319_0,,,,2,2,1,3
24321_0,,,,2,2,1,3
C(CC(CC(C(C(O)=O)=O)O)O)=O,,,5,1,4,0,4
24323_0,,,,2,2,1,3
C(C(C(C)O)C(C(C(O)=O)=O)O)=O,,,5,1,4,0,4
24323_1,,,,2,2,1,3
24325_0,,,,2,2,1,3
C(C(C=O)C(C(C(O)=O)=O)O)(O)=O,,,5,1,3,0,3
24325_1,,,,2,2,1,3
24327_0,,,,2,2,1,3
C(C(CO)C(C(C(O)=O)=O)O)=O,,,5,1,6,0,6
24327_1,,,,2,2,1,3
24329_0,,,,2,2,1,3
C(CC(C)(CC(C(O)=O)O)O)=O,,,5,1,2,0,2
24330_0,,,,2,2,1,3
24330_1,,,,2,2,1,3
24332_0,,,,2,2,1,3
C(C(C(C(C)=O)C(C=C)O)O)(O)=O,,,5,1,2,0,2
24332_1,,,,2,2,1,3
24334_0,,,,2,2,1,3
C(C(C(C(C)=O)C(C=O)O)O)(O)=O,,,5,1,2,0,2
24334_1,,,,2,2,1,3
24336_0,,,,2,2,1,3
C(C)(C(C(C)O)C(C(O)=O)O)=O,,,5,1,2,0,2
24336_1,,,,2,2,1,3
24337_0,,,,2,2,1,3
24337_1,,,,2,2,1,3
24339_0,,,,2,2,1,3
C(C)(C(CO)C(C(O)=O)O)=O,,,5,1,7,0,7
24339_1,,,,2,2,1,3
24341_0,,,,2,2,1,3
C(C)(C(C(CO)O)C(C(O)=O)O)=O,,,5,1,2,0,2
24341_1,,,,2,2,1,3
24343_0,,,,2,2,1,3
C(C(CC(CC(C=C)O)=O)O)(O)=O,,,5,1,1,0,1
24345_0,,,,2,2,1,3
C(C(CC(CC(C=O)O)=O)O)(O)=O,,,5,1,4,0,4
24347_0,,,,2,2,1,3
C(CC(C(O)=O)O)(CC(C)O)=O,,,5,1,2,0,2
24348_0,,,,2,2,1,3
24349_0,,,,2,2,1,3
24351_0,,,,2,2,1,3
C(CC(C(O)=O)O)(CC(CO)O)=O,,,5,1,4,0,4
24353_0,,,,2,2,1,3
C(CC(CCC(C(O)=O)O)O)=O,,,5,1,4,0,4
24355_0,,,,2,2,1,3
C(C(CCC(C(C=O)O)O)O)(O)=O,,,5,1,6,0,6
24355_1,,,,2,2,1,3
24357_0,,,,2,2,1,3
C(C(CC(C=O)C(C=C)O)O)(O)=O,,,5,1,1,0,1
24359_0,,,,2,2,1,3
C(C(CC(C=O)C(C=O)O)O)(O)=O,,,5,1,3,0,3
24361_0,,,,2,2,1,3
C(C(CC(C(O)=O)O)C(C)O)=O,,,5,1,2,0,2
24363_0,,,,2,2,1,3
C(C(C=O)CC(C(O)=O)O)(O)=O,,,5,1,2,0,2
24365_0,,,,2,2,1,3
C(C(CO)CC(C(O)=O)O)=O,,,5,1,5,0,5
24367_0,,,,2,2,1,3
C(C(CC(C(O)=O)O)C(CO)O)=O,,,5,1,5,0,5
24369_0,,,,2,2,1,3
C(C(CO)C(C(O)=O)O)(CCO)=O,,,5,1,4,0,4
24369_1,,,,2,2,1,3
24371_0,,,,2,2,1,3
C(CC(C(O)=O)O)(C(CO)CO)=O,,,5,1,5,0,5
24371_1,,,,2,2,1,3
24373_0,,,,2,2,1,3
C(C(CC(C(CO)=O)CO)O)(O)=O,,,5,1,4,0,4
24375_0,,,,2,2,1,3
C(C(CO)O)(CCC(C(O)=O)O)=O,,,5,1,5,0,5
24375_1,,,,2,2,1,3
24377_0,,,,2,2,1,3
C(C(C=C(CO)CO)(CC=O)O)=O,,,5,1,1,0,1
24379_0,,,,2,2,1,3
C(CC(C(C=C(CO)CO)=O)O)=O,,,5,1,1,0,1
24381_0,,,,2,2,1,3
C(CC(C(C=O)=C(CO)CO)O)=O,,,5,1,1,0,1
24383_0,,,,2,2,1,3
C(C(C=C)C(C=C(CO)CO)O)=O,,,5,1,1,0,1
24385_0,,,,2,2,1,3
C(C(CC(C=O)=O)O)=C(CO)CO,,,5,1,1,0,1
24387_0,,,,2,2,1,3
C(C(C=O)C(C=C(CO)CO)O)=O,,,5,1,2,0,2
24387_1,,,,2,2,1,3
24389_0,,,,2,2,1,3
C(CC(C=C(CO)CO)O)=O,,,5,1,2,0,2
24391_0,,,,2,2,1,3
C(C(CO)C(C=C(CO)CO)O)=O,,,5,1,2,0,2
24391_1,,,,2,2,1,3
24393_0,,,,2,2,1,3
C(C)(C(C(C=C(CO)CO)O)O)=O,,,5,1,2,0,2
24393_1,,,,2,2,1,3
24395_0,,,,2,2,1,3
C(CO)(CC(C=C(CO)CO)O)=O,,,5,1,1,0,1
24397_0,,,,2,2,1,3
C(C(C(C=C(CO)CO)O)O)=O,,,5,1,3,0,3
24397_1,,,,2,2,1,3
24399_0,,,,2,2,1,3
C(CC(C(C(C(CO)=O)O)=C)O)=O,,,5,1,1,0,1
24401_0,,,,2,2,1,3
C(CC(CO)(C(C(C=O)=C)O)O)=O,,,5,1,1,0,1
24403_0,,,,2,2,1,3
C(C(C(C)O)O)(C(C(C=O)=C)O)=O,,,5,1,2,0,2
24403_1,,,,2,2,1,3
24405_0,,,,2,2,1,3
C(C(C(C(C(C=O)=C)O)=O)O)(O)=O,,,5,1,2,0,2
24405_1,,,,2,2,1,3
24406_0,,,,2,2,1,3
24406_1,,,,2,2,1,3
24408_0,,,,2,2,1,3
C(CC(C=CC(C(CO)=O)O)O)=O,,,5,1,1,0,1
24410_0,,,,2,2,1,3
C(CC(CO)(C(C=CC=O)O)O)=O,,,5,1,2,0,2
24412_0,,,,2,2,1,3
C(C(C(C)O)O)(C(C=CC=O)O)=O,,,5,1,2,0,2
24412_1,,,,2,2,1,3
24414_0,,,,2,2,1,3
C(C(C(C(C=CC=O)O)=O)O)(O)=O,,,5,1,3,0,3
24414_1,,,,2,2,1,3
24415_0,,,,2,2,1,3
24415_1,,,,2,2,1,3
24417_0,,,,2,2,1,3
C(C(C=C)C(CO)(C(C=C)O)O)=O,,,5,1,1,0,1
24419_0,,,,2,2,1,3
C=CC(C(CO)(CC(C=O)=O)O)O,,,5,1,1,0,1
24421_0,,,,2,2,1,3
C(C(C=O)C(CO)(C(C=C)O)O)=O,,,5,1,2,0,2
24421_1,,,,2,2,1,3
24423_0,,,,2,2,1,3
C(CC(CO)(C(C=C)O)O)=O,,,5,1,2,0,2
24425_0,,,,2,2,1,3
C(C(CO)C(CO)(C(C=C)O)O)=O,,,5,1,2,0,2
24425_1,,,,2,2,1,3
24427_0,,,,2,2,1,3
C(C)(C(C(CO)(C(C=C)O)O)O)=O,,,5,1,2,0,2
24427_1,,,,2,2,1,3
24429_0,,,,2,2,1,3
C(CO)(CC(CO)(C(C=C)O)O)=O,,,5,1,1,0,1
24431_0,,,,2,2,1,3
C(C(C(CO)(C(C=C)O)O)O)=O,,,5,1,4,0,4
24431_1,,,,2,2,1,3
24433_0,,,,2,2,1,3
C(C(C(C=CC)O)O)(C(C=C)O)=O,,,5,1,2,0,2
24433_1,,,,2,2,1,3
24435_0,,,,2,2,1,3
C(C(C(CC=C)O)O)(C(C=C)O)=O,,,5,1,2,0,2
24435_1,,,,2,2,1,3
24437_0,,,,2,2,1,3
C(C(C(C=C)O)O)(C(C=C)O)=O,,,5,1,2,0,2
24437_1,,,,2,2,1,3
24439_0,,,,2,2,1,3
C(C(C(C(C(C=C)O)=O)O)O)=O,,,5,1,5,0,5
24439_1,,,,2,2,1,3
24441_0,,,,2,2,1,3
C(C(C(C(C(C=C)O)=O)O)O)(O)=O,,,5,1,3,0,3
24441_1,,,,2,2,1,3
24443_0,,,,2,2,1,3
C(C(C)(C(C(C(C=C)O)=O)O)O)=O,,,5,1,3,0,3
24443_1,,,,2,2,1,3
24445_0,,,,2,2,1,3
C(C(C(C(C)=O)O)O)(C(C=C)O)=O,,,5,1,4,0,4
24445_1,,,,2,2,1,3
24447_0,,,,2,2,1,3
C(CC(C(C(C(C=C)O)=O)O)O)=O,,,5,1,2,0,2
24447_1,,,,2,2,1,3
24449_0,,,,2,2,1,3
C(C(C(C)O)O)(C(C=C)O)=O,,,5,1,3,0,3
24449_1,,,,2,2,1,3
24451_0,,,,2,2,1,3
C(C(C(CCO)O)O)(C(C=C)O)=O,,,5,1,2,0,2
24451_1,,,,2,2,1,3
24453_0,,,,2,2,1,3
C(C(C(CO)(C)O)O)(C(C=C)O)=O,,,5,1,2,0,2
24453_1,,,,2,2,1,3
24455_0,,,,2,2,1,3
C(C(C(C(C=C)O)=O)O)(O)=O,,,5,1,5,0,5
24455_1,,,,2,2,1,3
24457_0,,,,2,2,1,3
C(C(C(C(O)O)O)O)(C(C=C)O)=O,,,5,1,2,0,2
24457_1,,,,2,2,1,3
24459_0,,,,2,2,1,3
C(C(C(C(C)O)O)O)(C(C=C)O)=O,,,5,1,2,0,2
24459_1,,,,2,2,1,3
24460_0,,,,2,2,1,3
24460_1,,,,2,2,1,3
24462_0,,,,2,2,1,3
C(C(C(CO)O)O)(C(C=C)O)=O,,,5,1,3,0,3
24462_1,,,,2,2,1,3
24464_0,,,,2,2,1,3
C(CC(C=C(CO)C(CO)O)O)=O,,,5,1,1,0,1
24466_0,,,,2,2,1,3
C(CC(C(CO)O)(C(C=C)O)O)=O,,,5,1,1,0,1
24468_0,,,,2,2,1,3
C(C(C=C)C(C=O)(C=CC(O)=O)O)=O,,,5,1,1,0,1
24470_0,,,,2,2,1,3
C(C(C=CC(O)=O)(CC=O)O)=O,,,5,1,4,0,4
24472_0,,,,2,2,1,3
C(C(C=CC(O)=O)(C(C=O)O)O)=O,,,5,1,3,0,3
24472_1,,,,2,2,1,3
24474_0,,,,2,2,1,3
C(C(C=C)C(C(C=CC(O)=O)=O)O)=O,,,5,1,1,0,1
24476_0,,,,2,2,1,3
C(CC(C(C=CC(O)=O)=O)O)=O,,,5,1,2,0,2
24478_0,,,,2,2,1,3
C(C(C(C(C=CC(O)=O)=O)O)O)=O,,,5,1,4,0,4
24478_1,,,,2,2,1,3
24480_0,,,,2,2,1,3
C(C(C=C)C(C(C=O)=CC(O)=O)O)=O,,,5,1,1,0,1
24482_0,,,,2,2,1,3
C(CC(C(C=O)=CC(O)=O)O)=O,,,5,1,4,0,4
24484_0,,,,2,2,1,3
C(C(C(C(C=O)=CC(O)=O)O)O)=O,,,5,1,2,0,2
24484_1,,,,2,2,1,3
24486_0,,,,2,2,1,3
C(C(C(C(CO)O)=O)=CC(O)=O)=O,,,5,1,2,0,2
24486_1,,,,2,2,1,3
24488_0,,,,2,2,1,3
C(CC(C=CC(CO)(CO)O)O)=O,,,5,1,1,0,1
24490_0,,,,2,2,1,3
C(C(C=C)C(C=O)(C=C(C=O)C)O)=O,,,5,1,1,0,1
24492_0,,,,2,2,1,3
C(C(C=C(C=O)C)(CC(C=O)=O)O)=O,,,5,1,1,0,1
24494_0,,,,2,2,1,3
C(C(C=O)C(C=O)(C=C(C=O)C)O)=O,,,5,1,2,0,2
24494_1,,,,2,2,1,3
24496_0,,,,2,2,1,3
C(C(C=C(C=O)C)(CC=O)O)=O,,,5,1,2,0,2
24498_0,,,,2,2,1,3
C(C(C=C(C=O)C)(C(C=O)O)O)=O,,,5,1,2,0,2
24498_1,,,,2,2,1,3
24500_0,,,,2,2,1,3
C(C(C=C)C(C(C=C(C=O)C)=O)O)=O,,,5,1,1,0,1
24502_0,,,,2,2,1,3
C(C(C)=CC(C(CC(C=O)=O)O)=O)=O,,,5,1,1,0,1
24504_0,,,,2,2,1,3
C(C(C=O)C(C(C=C(C=O)C)=O)O)=O,,,5,1,2,0,2
24504_1,,,,2,2,1,3
24506_0,,,,2,2,1,3
C(CC(C(C=C(C=O)C)=O)O)=O,,,5,1,2,0,2
24508_0,,,,2,2,1,3
C(C(C(C(C=C(C=O)C)=O)O)O)=O,,,5,1,2,0,2
24508_1,,,,2,2,1,3
24510_0,,,,2,2,1,3
C(C(C=C)C(C(C)=CC(C=O)=O)O)=O,,,5,1,1,0,1
24512_0,,,,2,2,1,3
C(C)(C(CC(C=O)=O)O)=CC(C=O)=O,,,5,1,1,0,1
24514_0,,,,2,2,1,3
C(C(C=O)C(C(C)=CC(C=O)=O)O)=O,,,5,1,2,0,2
24514_1,,,,2,2,1,3
24516_0,,,,2,2,1,3
C(CC(C(C)=CC(C=O)=O)O)=O,,,5,1,2,0,2
24518_0,,,,2,2,1,3
C(C(C(C(C)=CC(C=O)=O)O)O)=O,,,5,1,2,0,2
24518_1,,,,2,2,1,3
24520_0,,,,2,2,1,3
C(C(C=C)C(C=O)(CC(C=O)=C)O)=O,,,5,1,1,0,1
24522_0,,,,2,2,1,3
C(C(CC(C=O)=O)(CC(C=O)=C)O)=O,,,5,1,1,0,1
24524_0,,,,2,2,1,3
C(C(C=O)C(C=O)(CC(C=O)=C)O)=O,,,5,1,2,0,2
24524_1,,,,2,2,1,3
24526_0,,,,2,2,1,3
C(CC(C=O)(CC(C=O)=C)O)=O,,,5,1,2,0,2
24528_0,,,,2,2,1,3
C(C(C(C=O)(CC(C=O)=C)O)O)=O,,,5,1,2,0,2
24528_1,,,,2,2,1,3
24530_0,,,,2,2,1,3
C(C(C=C)C(C(CC(C=O)=C)=O)O)=O,,,5,1,1,0,1
24532_0,,,,2,2,1,3
C(C(CC(C=O)=O)O)(CC(C=O)=C)=O,,,5,1,1,0,1
24534_0,,,,2,2,1,3
C(C(C=O)C(C(CC(C=O)=C)=O)O)=O,,,5,1,2,0,2
24534_1,,,,2,2,1,3
24536_0,,,,2,2,1,3
C(CC(C(CC(C=O)=C)=O)O)=O,,,5,1,2,0,2
24538_0,,,,2,2,1,3
C(C(C(C(CC(C=O)=C)=O)O)O)=O,,,5,1,2,0,2
24538_1,,,,2,2,1,3
24540_0,,,,2,2,1,3
C(C(C=C)C(C(CC(C=O)=O)=C)O)=O,,,5,1,1,0,1
24542_0,,,,2,2,1,3
C=C(C(CC(C=O)=O)O)CC(C=O)=O,,,5,1,1,0,1
24544_0,,,,2,2,1,3
C(C(C=O)C(C(CC(C=O)=O)=C)O)=O,,,5,1,2,0,2
24544_1,,,,2,2,1,3
24546_0,,,,2,2,1,3
C(CC(C(CC(C=O)=O)=C)O)=O,,,5,1,2,0,2
24548_0,,,,2,2,1,3
C(C(C(C(CC(C=O)=O)=C)O)O)=O,,,5,1,2,0,2
24548_1,,,,2,2,1,3
24550_0,,,,2,2,1,3
C=C(C=O)C(C(C=O)=O)C(C=CC)O,,,5,1,1,0,1
24552_0,,,,2,2,1,3
C=CCC(C(C(C=O)=O)C(C=O)=C)O,,,5,1,1,0,1
24554_0,,,,2,2,1,3
C=CC(C(C(C=O)=O)C(C=O)=C)O,,,5,1,1,0,1
24556_0,,,,2,2,1,3
C(C(C(C(C=O)=O)C(C=O)=C)O)=O,,,5,1,1,0,1
24558_0,,,,2,2,1,3
C(C(C)(C(C(C=O)=O)C(C=O)=C)O)=O,,,5,1,1,0,1
24560_0,,,,2,2,1,3
C(C)(C(C(C(C=O)=O)C(C=O)=C)O)=O,,,5,1,1,0,1
24562_0,,,,2,2,1,3
C(CC(C(C(C=O)=O)C(C=O)=C)O)=O,,,5,1,1,0,1
24564_0,,,,2,2,1,3
C=C(C=O)C(C(C=O)=O)C(C)O,,,5,1,2,0,2
24566_0,,,,2,2,1,3
C(C(C(C=O)=O)C(C=O)=C)(O)=O,,,5,1,2,0,2
24567_0,,,,2,2,1,3
24569_0,,,,2,2,1,3
C=C(C=O)C(C(C=O)=O)C(CO)O,,,5,1,1,0,1
24571_0,,,,2,2,1,3
C(C(C=C)C(C(C=O)=C(C=O)C)O)=O,,,5,1,1,0,1
24573_0,,,,2,2,1,3
C(C(CC(C(C=O)=C(C=O)C)O)=O)=O,,,5,1,1,0,1
24575_0,,,,2,2,1,3
C(C(C=O)C(C(C=O)=C(C=O)C)O)=O,,,5,1,2,0,2
24575_1,,,,2,2,1,3
24577_0,,,,2,2,1,3
C(CC(C(C=O)=C(C=O)C)O)=O,,,5,1,2,0,2
24579_0,,,,2,2,1,3
C(C(C(C(C=O)=C(C=O)C)O)O)=O,,,5,1,2,0,2
24579_1,,,,2,2,1,3
24581_0,,,,2,2,1,3
C(C(C=C)C(C(C)=C(C=O)C=O)O)=O,,,5,1,1,0,1
24583_0,,,,2,2,1,3
C(C)(C(CC(C=O)=O)O)=C(C=O)C=O,,,5,1,1,0,1
24585_0,,,,2,2,1,3
C(C(C=O)C(C(C)=C(C=O)C=O)O)=O,,,5,1,2,0,2
24585_1,,,,2,2,1,3
24587_0,,,,2,2,1,3
C(CC(C(C)=C(C=O)C=O)O)=O,,,5,1,2,0,2
24589_0,,,,2,2,1,3
C(C(C(C(C)=C(C=O)C=O)O)O)=O,,,5,1,2,0,2
24589_1,,,,2,2,1,3
24591_0,,,,2,2,1,3
C(C(C(C=O)=C)C(C(C=O)C=C)O)=O,,,5,1,2,0,2
24593_0,,,,2,2,1,3
C(C(C(C=O)=C)C(CC(C=O)=O)O)=O,,,5,1,2,0,2
24594_0,,,,2,2,1,3
24594_1,,,,2,2,1,3
24596_0,,,,2,2,1,3
C(C(C(C=O)=C)C(CC=O)O)=O,,,5,1,3,0,3
24598_0,,,,2,2,1,3
C(C(C(C=O)=C)C(C(C=O)O)O)=O,,,5,1,3,0,3
24598_1,,,,2,2,1,3
24600_0,,,,2,2,1,3
C(C(C=O)C(C(C(C=O)C=C)O)=C)=O,,,5,1,1,0,1
24602_0,,,,2,2,1,3
C(C(C=O)C(C(CC(C=O)=O)O)=C)=O,,,5,1,1,0,1
24604_0,,,,2,2,1,3
C(C(C=O)C(C(C(C=O)C=O)O)=C)=O,,,5,1,2,0,2
24604_1,,,,2,2,1,3
24606_0,,,,2,2,1,3
C(C(C=O)C(C(CC=O)O)=C)=O,,,5,1,2,0,2
24608_0,,,,2,2,1,3
C(C(C=O)C(C(C(C=O)O)O)=C)=O,,,5,1,2,0,2
24608_1,,,,2,2,1,3
24610_0,,,,2,2,1,3
C(C(C=O)=C(C=O)C)(C(CO)O)=O,,,5,1,2,0,2
24610_1,,,,2,2,1,3
24612_0,,,,2,2,1,3
C(C(C(C(CO)O)=O)C(C=O)=C)=O,,,5,1,2,0,2
24612_1,,,,2,2,1,3
24614_0,,,,2,2,1,3
C(C(C(C(C(C=O)=C)O)=O)CO)=O,,,5,1,2,0,2
24614_1,,,,2,2,1,3
24616_0,,,,2,2,1,3
C(C(C=O)O)(C(C(C=O)=C)CO)=O,,,5,1,1,0,1
24618_0,,,,2,2,1,3
C(C(C(C=O)=C)C(C=C(C=O)C)O)=O,,,5,1,1,0,1
24620_0,,,,2,2,1,3
C(C(CC(C=CC=O)=O)O)=C(C=O)C,,,5,1,1,0,1
24622_0,,,,2,2,1,3
C=CC(C(C=O)=O)C(C=C(C=O)C)O,,,5,1,1,0,1
24624_0,,,,2,2,1,3
C(C(C=CC=O)C(C=C(C=O)C)O)=O,,,5,1,1,0,1
24626_0,,,,2,2,1,3
C(C(C=C)C(C=C(C=O)C)O)=O,,,5,1,1,0,1
24628_0,,,,2,2,1,3
C1OC(C(C=1)=O)C(C=C(C=O)C)O,,,5,1,2,0,2
24628_1,,,,2,2,1,3
24630_0,,,,2,2,1,3
C(CO)(C(C(C=C(C=O)C)O)O)=O,,,5,1,2,0,2
24630_1,,,,2,2,1,3
24632_0,,,,2,2,1,3
C(C(CC(C=O)=O)O)=C(C=O)C,,,5,1,2,0,2
24634_0,,,,2,2,1,3
C(C(C=O)C(C=C(C=O)C)O)=O,,,5,1,3,0,3
24634_1,,,,2,2,1,3
24636_0,,,,2,2,1,3
C(CC(C=C(C=O)C)O)=O,,,5,1,2,0,2
24638_0,,,,2,2,1,3
C(C(C(C(C=O)=O)O)O)=C(C=O)C,,,5,1,2,0,2
24638_1,,,,2,2,1,3
24640_0,,,,2,2,1,3
C(C(C(C)O)C(C=C(C=O)C)O)=O,,,5,1,2,0,2
24640_1,,,,2,2,1,3
24642_0,,,,2,2,1,3
C(C(CO)C(C=C(C=O)C)O)=O,,,5,1,3,0,3
24642_1,,,,2,2,1,3
24644_0,,,,2,2,1,3
C(C)(C(C(C=C(C=O)C)O)O)=O,,,5,1,3,0,3
24644_1,,,,2,2,1,3
24646_0,,,,2,2,1,3
C(CO)(CC(C=C(C=O)C)O)=O,,,5,1,2,0,2
24648_0,,,,2,2,1,3
C(C(CC(C(O)=O)=O)O)=C(C=O)C,,,5,1,1,0,1
24650_0,,,,2,2,1,3
C(C(C=O)C(C=C(C=O)C)O)(O)=O,,,5,1,2,0,2
24650_1,,,,2,2,1,3
24652_0,,,,2,2,1,3
C(C(C(C=O)=O)C(C=C(C=O)C)O)=O,,,5,1,2,0,2
24652_1,,,,2,2,1,3
24654_0,,,,2,2,1,3
C(C(CC(C(C=O)=O)=O)O)=C(C=O)C,,,5,1,1,0,1
24656_0,,,,2,2,1,3
C(C(C(C=C(C=O)C)O)O)=O,,,5,1,3,0,3
24656_1,,,,2,2,1,3
24658_0,,,,2,2,1,3
C(C(C(C=O)=C)C(C(C)=CC=O)O)=O,,,5,1,1,0,1
24660_0,,,,2,2,1,3
C(C)(C(CC(C=CC=O)=O)O)=CC=O,,,5,1,1,0,1
24662_0,,,,2,2,1,3
C=CC(C(C=O)=O)C(C(C)=CC=O)O,,,5,1,1,0,1
24664_0,,,,2,2,1,3
C(C(C=CC=O)C(C(C)=CC=O)O)=O,,,5,1,1,0,1
24666_0,,,,2,2,1,3
C(C(C=C)C(C(C)=CC=O)O)=O,,,5,1,1,0,1
24668_0,,,,2,2,1,3
C1OC(C(C=1)=O)C(C(C)=CC=O)O,,,5,1,2,0,2
24668_1,,,,2,2,1,3
24670_0,,,,2,2,1,3
C(CO)(C(C(C(C)=CC=O)O)O)=O,,,5,1,2,0,2
24670_1,,,,2,2,1,3
24672_0,,,,2,2,1,3
C(C)(C(CC(C=O)=O)O)=CC=O,,,5,1,2,0,2
24674_0,,,,2,2,1,3
C(C(C=O)C(C(C)=CC=O)O)=O,,,5,1,3,0,3
24674_1,,,,2,2,1,3
24676_0,,,,2,2,1,3
C(CC(C(C)=CC=O)O)=O,,,5,1,2,0,2
24678_0,,,,2,2,1,3
C(C)(C(C(C(C=O)=O)O)O)=CC=O,,,5,1,2,0,2
24678_1,,,,2,2,1,3
24680_0,,,,2,2,1,3
C(C(C(C)O)C(C(C)=CC=O)O)=O,,,5,1,2,0,2
24680_1,,,,2,2,1,3
24682_0,,,,2,2,1,3
C(C(CO)C(C(C)=CC=O)O)=O,,,5,1,3,0,3
24682_1,,,,2,2,1,3
24684_0,,,,2,2,1,3
C(C)(C(C(C(C)=CC=O)O)O)=O,,,5,1,3,0,3
24684_1,,,,2,2,1,3
24686_0,,,,2,2,1,3
C(CO)(CC(C(C)=CC=O)O)=O,,,5,1,2,0,2
24688_0,,,,2,2,1,3
C(C)(C(CC(C(O)=O)=O)O)=CC=O,,,5,1,1,0,1
24690_0,,,,2,2,1,3
C(C(C=O)C(C(C)=CC=O)O)(O)=O,,,5,1,2,0,2
24690_1,,,,2,2,1,3
24692_0,,,,2,2,1,3
C(C(C(C=O)=O)C(C(C)=CC=O)O)=O,,,5,1,2,0,2
24692_1,,,,2,2,1,3
24694_0,,,,2,2,1,3
C(C)(C(CC(C(C=O)=O)=O)O)=CC=O,,,5,1,1,0,1
24696_0,,,,2,2,1,3
C(C(C(C(C)=CC=O)O)O)=O,,,5,1,3,0,3
24696_1,,,,2,2,1,3
24698_0,,,,2,2,1,3
C(C(C(C=O)=C)C(CC(C=O)=C)O)=O,,,5,1,1,0,1
24700_0,,,,2,2,1,3
C=C(C=O)CC(CC(C=CC=O)=O)O,,,5,1,1,0,1
24702_0,,,,2,2,1,3
C=CC(C(C=O)=O)C(CC(C=O)=C)O,,,5,1,1,0,1
24704_0,,,,2,2,1,3
C(C(C=CC=O)C(CC(C=O)=C)O)=O,,,5,1,1,0,1
24706_0,,,,2,2,1,3
C(C(C=C)C(CC(C=O)=C)O)=O,,,5,1,1,0,1
24708_0,,,,2,2,1,3
C1OC(C(C=1)=O)C(CC(C=O)=C)O,,,5,1,2,0,2
24708_1,,,,2,2,1,3
24710_0,,,,2,2,1,3
C(CO)(C(C(CC(C=O)=C)O)O)=O,,,5,1,2,0,2
24710_1,,,,2,2,1,3
24712_0,,,,2,2,1,3
C=C(C=O)CC(CC(C=O)=O)O,,,5,1,2,0,2
24714_0,,,,2,2,1,3
C(C(C=O)C(CC(C=O)=C)O)=O,,,5,1,3,0,3
24714_1,,,,2,2,1,3
24716_0,,,,2,2,1,3
C(CC(CC(C=O)=C)O)=O,,,5,1,2,0,2
24718_0,,,,2,2,1,3
C=C(C=O)CC(C(C(C=O)=O)O)O,,,5,1,2,0,2
24718_1,,,,2,2,1,3
24720_0,,,,2,2,1,3
C(C(C(CC(C=O)=C)O)C(C)O)=O,,,5,1,2,0,2
24720_1,,,,2,2,1,3
24722_0,,,,2,2,1,3
C(C(CO)C(CC(C=O)=C)O)=O,,,5,1,3,0,3
24722_1,,,,2,2,1,3
24724_0,,,,2,2,1,3
C(C)(C(C(CC(C=O)=C)O)O)=O,,,5,1,3,0,3
24724_1,,,,2,2,1,3
24726_0,,,,2,2,1,3
C(CO)(CC(CC(C=O)=C)O)=O,,,5,1,2,0,2
24728_0,,,,2,2,1,3
C=C(C=O)CC(CC(C(O)=O)=O)O,,,5,1,1,0,1
24730_0,,,,2,2,1,3
C(C(C=O)C(CC(C=O)=C)O)(O)=O,,,5,1,2,0,2
24730_1,,,,2,2,1,3
24732_0,,,,2,2,1,3
C(C(C(C=O)=O)C(CC(C=O)=C)O)=O,,,5,1,2,0,2
24732_1,,,,2,2,1,3
24734_0,,,,2,2,1,3
C=C(C=O)CC(CC(C(C=O)=O)=O)O,,,5,1,1,0,1
24736_0,,,,2,2,1,3
C(C(C(CC(C=O)=C)O)O)=O,,,5,1,3,0,3
24736_1,,,,2,2,1,3
24738_0,,,,2,2,1,3
C(C(C(C=O)=C)C(C(CC=O)=C)O)=O,,,5,1,1,0,1
24740_0,,,,2,2,1,3
C(CC(C(CC(C=CC=O)=O)O)=C)=O,,,5,1,1,0,1
24742_0,,,,2,2,1,3
C(CC(C(C(C=C)C(C=O)=O)O)=C)=O,,,5,1,1,0,1
24744_0,,,,2,2,1,3
C(C(C=CC=O)C(C(CC=O)=C)O)=O,,,5,1,1,0,1
24746_0,,,,2,2,1,3
C(C(C=C)C(C(CC=O)=C)O)=O,,,5,1,1,0,1
24748_0,,,,2,2,1,3
C(CC(C(C1C(C=CO1)=O)O)=C)=O,,,5,1,2,0,2
24748_1,,,,2,2,1,3
24750_0,,,,2,2,1,3
C(CC(C(C(C(CO)=O)O)O)=C)=O,,,5,1,2,0,2
24750_1,,,,2,2,1,3
24752_0,,,,2,2,1,3
C(CC(C(CC(C=O)=O)O)=C)=O,,,5,1,2,0,2
24754_0,,,,2,2,1,3
C(C(C=O)C(C(CC=O)=C)O)=O,,,5,1,3,0,3
24754_1,,,,2,2,1,3
24756_0,,,,2,2,1,3
C(CC(C(CC=O)O)=C)=O,,,5,1,2,0,2
24758_0,,,,2,2,1,3
C(CC(C(C(C(C=O)=O)O)O)=C)=O,,,5,1,2,0,2
24758_1,,,,2,2,1,3
24760_0,,,,2,2,1,3
C(C(C(C)O)C(C(CC=O)=C)O)=O,,,5,1,2,0,2
24760_1,,,,2,2,1,3
24762_0,,,,2,2,1,3
C(C(CO)C(C(CC=O)=C)O)=O,,,5,1,3,0,3
24762_1,,,,2,2,1,3
24764_0,,,,2,2,1,3
C(CC(C(C(C(C)=O)O)O)=C)=O,,,5,1,3,0,3
24764_1,,,,2,2,1,3
24766_0,,,,2,2,1,3
C(CC(C(CC(CO)=O)O)=C)=O,,,5,1,2,0,2
24768_0,,,,2,2,1,3
C(CC(C(CC(C(O)=O)=O)O)=C)=O,,,5,1,1,0,1
24770_0,,,,2,2,1,3
C(C(C=O)C(C(CC=O)=C)O)(O)=O,,,5,1,2,0,2
24770_1,,,,2,2,1,3
24772_0,,,,2,2,1,3
C(C(C(C=O)=O)C(C(CC=O)=C)O)=O,,,5,1,2,0,2
24772_1,,,,2,2,1,3
24774_0,,,,2,2,1,3
C(CC(C(CC(C(C=O)=O)=O)O)=C)=O,,,5,1,1,0,1
24776_0,,,,2,2,1,3
C(CC(C(C(C=O)O)O)=C)=O,,,5,1,3,0,3
24776_1,,,,2,2,1,3
24778_0,,,,2,2,1,3
C(C(C(C=O)=C)C(C=CC(C)=O)O)=O,,,5,1,1,0,1
24780_0,,,,2,2,1,3
C(C(C(C=O)=C)C(C=CC=O)(C)O)=O,,,5,1,1,0,1
24782_0,,,,2,2,1,3
C(C(C(C=O)=C)C(C=O)(CC=C)O)=O,,,5,1,1,0,1
24784_0,,,,2,2,1,3
C(C(C(C=O)=C)C(C(CC=C)=O)O)=O,,,5,1,1,0,1
24786_0,,,,2,2,1,3
C(C(C(C=O)=C)C(C=O)(C=CC)O)=O,,,5,1,1,0,1
24788_0,,,,2,2,1,3
C(C(C(C=O)=C)C(C(C=CC)=O)O)=O,,,5,1,1,0,1
24790_0,,,,2,2,1,3
C(C(C(C=O)=C)C(C=CCC=O)O)=O,,,5,1,1,0,1
24792_0,,,,2,2,1,3
C(C(C(C=O)=C)C(CC=CC=O)O)=O,,,5,1,1,0,1
24793_0,,,,2,2,1,3
24795_0,,,,2,2,1,3
C(C(C(C=O)=C)C(C(C=O)=CC)O)=O,,,5,1,1,0,1
24797_0,,,,2,2,1,3
C(C(C(C=O)=C)C(C(C=O)=C)O)=O,,,5,1,1,0,1
24799_0,,,,2,2,1,3
C(C(C(C=O)=C)C(C=CC)O)=O,,,5,1,1,0,1
24801_0,,,,2,2,1,3
C(C(C(C=O)=C)C(CC=C)O)=O,,,5,1,1,0,1
24803_0,,,,2,2,1,3
C(C(C(C=O)=C)C(C(C=C)O)O)=O,,,5,1,1,0,1
24805_0,,,,2,2,1,3
C(C(C(C=O)=C)C(C=C)O)=O,,,5,1,1,0,1
24807_0,,,,2,2,1,3
C(C(C(C=O)=C)C1(C=COC1)O)=O,,,5,1,1,0,1
24809_0,,,,2,2,1,3
C(C(C(C=O)=C)C(C(CO)O)O)=O,,,5,1,1,0,1
24810_0,,,,2,2,1,3
24812_0,,,,2,2,1,3
C(C(C(C=O)=C)C(CO)(CO)O)=O,,,5,1,1,0,1
24814_0,,,,2,2,1,3
C(C(C(C=O)=C)C(C(O)=O)O)=O,,,5,1,4,0,4
24816_0,,,,2,2,1,3
C(C(C(C=O)=C)C(C=O)(C)O)=O,,,5,1,2,0,2
24818_0,,,,2,2,1,3
C(C(C(C=O)=C)C(C(C)=O)O)=O,,,5,1,2,0,2
24819_0,,,,2,2,1,3
24821_0,,,,2,2,1,3
C(C(C(C=O)=C)C(C)O)=O,,,5,1,2,0,2
24823_0,,,,2,2,1,3
C(C(C(C=O)=C)C(C=O)(CO)O)=O,,,5,1,2,0,2
24825_0,,,,2,2,1,3
C(C(C(C=O)=C)C(C(CO)=O)O)=O,,,5,1,1,0,1
24827_0,,,,2,2,1,3
C(C(C(C=O)=C)C(CC(C)O)O)=O,,,5,1,1,0,1
24829_0,,,,2,2,1,3
C(C(C(C=O)=C)C(CCO)O)=O,,,5,1,2,0,2
24830_0,,,,2,2,1,3
24832_0,,,,2,2,1,3
C(C(C(C=O)=C)C(C)(CO)O)=O,,,5,1,2,0,2
24834_0,,,,2,2,1,3
C(C(C(C=O)=C)C(C(O)=O)(C)O)=O,,,5,1,1,0,1
24836_0,,,,2,2,1,3
C(C(C(C=O)=C)C(CC(O)=O)O)=O,,,5,1,1,0,1
24838_0,,,,2,2,1,3
C(C(C(C=O)=C)C(C=O)(CC=O)O)=O,,,5,1,1,0,1
24840_0,,,,2,2,1,3
C(C(C(C=O)=C)C(C(CC=O)=O)O)=O,,,5,1,1,0,1
24841_0,,,,2,2,1,3
24843_0,,,,2,2,1,3
C(C(C(C=O)=C)C(C=O)(C(C)=O)O)=O,,,5,1,1,0,1
24845_0,,,,2,2,1,3
C(C(C(C=O)=C)C(C(C(C)=O)=O)O)=O,,,5,1,1,0,1
24847_0,,,,2,2,1,3
C(C(C(C=O)=C)C(C(C=O)=O)(C)O)=O,,,5,1,1,0,1
24849_0,,,,2,2,1,3
C(C(C(C=O)=C)C(C=O)(C=C)O)=O,,,5,1,1,0,1
24851_0,,,,2,2,1,3
C(C(C(C=O)=C)C(C(C=C)=O)O)=O,,,5,1,1,0,1
24853_0,,,,2,2,1,3
C(C(C(C=O)=C)C(C=CC=O)O)=O,,,5,1,1,0,1
24855_0,,,,2,2,1,3
C(C(C(O)=O)C(C=O)=C)=O,,,5,1,4,0,4
24857_0,,,,2,2,1,3
C(C(C(C=O)=C)C(C(O)O)O)=O,,,5,1,2,0,2
24859_0,,,,2,2,1,3
C(C(C(C=O)=C)C(C(C)O)O)=O,,,5,1,2,0,2
24861_0,,,,2,2,1,3
C(C(C(C=O)=C)CO)=O,,,5,1,3,0,3
24863_0,,,,2,2,1,3
C(C(C(C=O)=C)C(CO)O)=O,,,5,1,3,0,3
24865_0,,,,2,2,1,3
C(CC(C=O)(C(C(C=O)=C)O)O)=O,,,5,1,2,0,2
24867_0,,,,2,2,1,3
C(CC(C(C(C(C=O)=C)O)=O)O)=O,,,5,1,1,0,1
24869_0,,,,2,2,1,3
C(CC(C(C(C(C=O)=O)O)=C)O)=O,,,5,1,1,0,1
24871_0,,,,2,2,1,3
C(C(C=C)C(C(C(C=O)=C)O)O)=O,,,5,1,1,0,1
24873_0,,,,2,2,1,3
C1OC(C(C=1)=O)C(C(C(C=O)=C)O)O,,,5,1,2,0,2
24873_1,,,,2,2,1,3
24875_0,,,,2,2,1,3
C=C(C=O)C(C(CC(C=O)=O)O)O,,,5,1,1,0,1
24877_0,,,,2,2,1,3
C(C(C=O)C(C(C(C=O)=C)O)O)=O,,,5,1,2,0,2
24877_1,,,,2,2,1,3
24879_0,,,,2,2,1,3
C(CC(C(C(C=O)=C)O)O)=O,,,5,1,3,0,3
24881_0,,,,2,2,1,3
C(C(CO)C(C(C(C=O)=C)O)O)=O,,,5,1,2,0,2
24881_1,,,,2,2,1,3
24883_0,,,,2,2,1,3
C(C)(C(C(C(C(C=O)=C)O)O)O)=O,,,5,1,2,0,2
24883_1,,,,2,2,1,3
24885_0,,,,2,2,1,3
C(CO)(CC(C(C(C=O)=C)O)O)=O,,,5,1,1,0,1
24887_0,,,,2,2,1,3
C(C(C(C(C(C=O)=C)O)O)O)=O,,,5,1,6,0,6
24887_1,,,,2,2,1,3
24889_0,,,,2,2,1,3
C(C(C=C)C(C(C(C=O)O)=C)O)=O,,,5,1,1,0,1
24891_0,,,,2,2,1,3
C(C(C(C(C1C(C=CO1)=O)O)=C)O)=O,,,5,1,2,0,2
24891_1,,,,2,2,1,3
24893_0,,,,2,2,1,3
C(C(C(C(CC(C=O)=O)O)=C)O)=O,,,5,1,1,0,1
24895_0,,,,2,2,1,3
C(C(C=O)C(C(C(C=O)O)=C)O)=O,,,5,1,2,0,2
24895_1,,,,2,2,1,3
24897_0,,,,2,2,1,3
C(C(C(C(CC=O)O)=C)O)=O,,,5,1,4,0,4
24899_0,,,,2,2,1,3
C(C(CO)C(C(C(C=O)O)=C)O)=O,,,5,1,2,0,2
24899_1,,,,2,2,1,3
24901_0,,,,2,2,1,3
C(C(C(C(C(C(C)=O)O)O)=C)O)=O,,,5,1,2,0,2
24901_1,,,,2,2,1,3
24903_0,,,,2,2,1,3
C(C(C(C(CC(CO)=O)O)=C)O)=O,,,5,1,1,0,1
24905_0,,,,2,2,1,3
C(C(C(C(C(C=O)O)O)=C)O)=O,,,5,1,7,0,7
24905_1,,,,2,2,1,3
24907_0,,,,2,2,1,3
C(C(C=C)C(C=O)(C=CC(C)=O)O)=O,,,5,1,1,0,1
24909_0,,,,2,2,1,3
C(C(C=CC(C)=O)(CC(C=O)=O)O)=O,,,5,1,1,0,1
24911_0,,,,2,2,1,3
C(C(C=O)C(C=O)(C=CC(C)=O)O)=O,,,5,1,2,0,2
24911_1,,,,2,2,1,3
24913_0,,,,2,2,1,3
C(C(C=CC(C)=O)(CC=O)O)=O,,,5,1,2,0,2
24915_0,,,,2,2,1,3
C(C(C=CC(C)=O)(C(C=O)O)O)=O,,,5,1,2,0,2
24915_1,,,,2,2,1,3
24917_0,,,,2,2,1,3
C(C(C=C)C(C(C=CC(C)=O)=O)O)=O,,,5,1,1,0,1
24919_0,,,,2,2,1,3
C(C(CC(C(C=CC(C)=O)=O)O)=O)=O,,,5,1,1,0,1
24921_0,,,,2,2,1,3
C(C(C=O)C(C(C=CC(C)=O)=O)O)=O,,,5,1,2,0,2
24921_1,,,,2,2,1,3
24923_0,,,,2,2,1,3
C(CC(C(C=CC(C)=O)=O)O)=O,,,5,1,2,0,2
24925_0,,,,2,2,1,3
C(C(C(C(C=CC(C)=O)=O)O)O)=O,,,5,1,2,0,2
24925_1,,,,2,2,1,3
24927_0,,,,2,2,1,3
C(C(C=C)C(C=CC(C=O)=O)(C)O)=O,,,5,1,1,0,1
24929_0,,,,2,2,1,3
C(C(C)(CC(C=O)=O)O)=CC(C=O)=O,,,5,1,1,0,1
24931_0,,,,2,2,1,3
C(C(C=O)C(C=CC(C=O)=O)(C)O)=O,,,5,1,2,0,2
24931_1,,,,2,2,1,3
24933_0,,,,2,2,1,3
C(CC(C=CC(C=O)=O)(C)O)=O,,,5,1,2,0,2
24935_0,,,,2,2,1,3
C(C(C(C=CC(C=O)=O)(C)O)O)=O,,,5,1,2,0,2
24935_1,,,,2,2,1,3
24937_0,,,,2,2,1,3
C(C(CC(C=CC(C=O)=O)=O)O)=CC,,,5,1,1,0,1
24939_0,,,,2,2,1,3
C=CCC(CC(C=CC(C=O)=O)=O)O,,,5,1,1,0,1
24941_0,,,,2,2,1,3
C=CC(CC(C=CC(C=O)=O)=O)O,,,5,1,1,0,1
24943_0,,,,2,2,1,3
C(C(CC(C=CC(C=O)=O)=O)O)=O,,,5,1,1,0,1
24945_0,,,,2,2,1,3
C(C(C)(CC(C=CC(C=O)=O)=O)O)=O,,,5,1,1,0,1
24947_0,,,,2,2,1,3
C(C)(C(CC(C=CC(C=O)=O)=O)O)=O,,,5,1,1,0,1
24949_0,,,,2,2,1,3
C(CC(CC(C=CC(C=O)=O)=O)O)=O,,,5,1,1,0,1
24951_0,,,,2,2,1,3
C(C(C=CC(CC(C)O)=O)=O)=O,,,5,1,2,0,2
24953_0,,,,2,2,1,3
C(CC(C=CC(C=O)=O)=O)(O)=O,,,5,1,2,0,2
24954_0,,,,2,2,1,3
24956_0,,,,2,2,1,3
C(C(C=CC(CC(CO)O)=O)=O)=O,,,5,1,1,0,1
24958_0,,,,2,2,1,3
C(C(C=C)C(C(C=O)=CC(C)=O)O)=O,,,5,1,1,0,1
24960_0,,,,2,2,1,3
C(C(C(CC(C=O)=O)O)=CC(C)=O)=O,,,5,1,1,0,1
24962_0,,,,2,2,1,3
C(C(C=O)C(C(C=O)=CC(C)=O)O)=O,,,5,1,2,0,2
24962_1,,,,2,2,1,3
24964_0,,,,2,2,1,3
C(CC(C(C=O)=CC(C)=O)O)=O,,,5,1,2,0,2
24966_0,,,,2,2,1,3
C(C(C(C(C=O)=CC(C)=O)O)O)=O,,,5,1,2,0,2
24966_1,,,,2,2,1,3
24968_0,,,,2,2,1,3
C(C(C=C)C(C=C(C=O)C=O)(C)O)=O,,,5,1,1,0,1
24970_0,,,,2,2,1,3
C(C(C)(CC(C=O)=O)O)=C(C=O)C=O,,,5,1,1,0,1
24972_0,,,,2,2,1,3
C(C(C=O)C(C=C(C=O)C=O)(C)O)=O,,,5,1,2,0,2
24972_1,,,,2,2,1,3
24974_0,,,,2,2,1,3
C(CC(C=C(C=O)C=O)(C)O)=O,,,5,1,2,0,2
24976_0,,,,2,2,1,3
C(C(C(C=C(C=O)C=O)(C)O)O)=O,,,5,1,2,0,2
24976_1,,,,2,2,1,3
24978_0,,,,2,2,1,3
C(C(CC(C=C(C=O)C=O)=O)O)=CC,,,5,1,1,0,1
24980_0,,,,2,2,1,3
C=CCC(CC(C=C(C=O)C=O)=O)O,,,5,1,1,0,1
24982_0,,,,2,2,1,3
C=CC(CC(C=C(C=O)C=O)=O)O,,,5,1,1,0,1
24984_0,,,,2,2,1,3
C(C(CC(C=C(C=O)C=O)=O)O)=O,,,5,1,1,0,1
24986_0,,,,2,2,1,3
C(C(C)(CC(C=C(C=O)C=O)=O)O)=O,,,5,1,1,0,1
24988_0,,,,2,2,1,3
C(C)(C(CC(C=C(C=O)C=O)=O)O)=O,,,5,1,1,0,1
24990_0,,,,2,2,1,3
C(CC(CC(C=C(C=O)C=O)=O)O)=O,,,5,1,1,0,1
24992_0,,,,2,2,1,3
C(C(C=O)=CC(CC(C)O)=O)=O,,,5,1,2,0,2
24994_0,,,,2,2,1,3
C(CC(C=C(C=O)C=O)=O)(O)=O,,,5,1,2,0,2
24995_0,,,,2,2,1,3
24997_0,,,,2,2,1,3
C(C(C=O)=CC(CC(CO)O)=O)=O,,,5,1,1,0,1
24999_0,,,,2,2,1,3
C(CCO)(C(C(C(C=O)=O)=C)O)=O,,,5,1,1,0,1
25001_0,,,,2,2,1,3
C(C(C(CO)=CC(CCO)=O)=O)=O,,,5,1,1,0,1
25003_0,,,,2,2,1,3
C(CCO)(C(C(C=O)=CC=O)O)=O,,,5,1,1,0,1
25005_0,,,,2,2,1,3
C(C(C(C=O)=CC(CCO)=O)O)=O,,,5,1,1,0,1
25007_0,,,,2,2,1,3
C(C(C=O)=CC(C)=O)(C(CO)O)=O,,,5,1,2,0,2
25007_1,,,,2,2,1,3
25009_0,,,,2,2,1,3
C(C(C(CO)=O)=CC(CCO)=O)=O,,,5,1,1,0,1
25011_0,,,,2,2,1,3
C(C(C(C=CC(CCO)=O)=O)O)=O,,,5,1,1,0,1
25013_0,,,,2,2,1,3
C(C(CC(C=CC=O)=O)O)=CC(C)=O,,,5,1,1,0,1
25015_0,,,,2,2,1,3
C=CC(C(C=O)=O)C(C=CC(C)=O)O,,,5,1,1,0,1
25017_0,,,,2,2,1,3
C(C(C=CC=O)C(C=CC(C)=O)O)=O,,,5,1,1,0,1
25019_0,,,,2,2,1,3
C(C(C=C)C(C=CC(C)=O)O)=O,,,5,1,1,0,1
25021_0,,,,2,2,1,3
C1OC(C(C=1)=O)C(C=CC(C)=O)O,,,5,1,2,0,2
25021_1,,,,2,2,1,3
25023_0,,,,2,2,1,3
C(CO)(C(C(C=CC(C)=O)O)O)=O,,,5,1,2,0,2
25023_1,,,,2,2,1,3
25025_0,,,,2,2,1,3
C(C(CC(C=O)=O)O)=CC(C)=O,,,5,1,2,0,2
25027_0,,,,2,2,1,3
C(C(C=O)C(C=CC(C)=O)O)=O,,,5,1,3,0,3
25027_1,,,,2,2,1,3
25029_0,,,,2,2,1,3
C(CC(C=CC(C)=O)O)=O,,,5,1,2,0,2
25031_0,,,,2,2,1,3
C(C(C(C(C=O)=O)O)O)=CC(C)=O,,,5,1,2,0,2
25031_1,,,,2,2,1,3
25033_0,,,,2,2,1,3
C(C(C(C)O)C(C=CC(C)=O)O)=O,,,5,1,2,0,2
25033_1,,,,2,2,1,3
25035_0,,,,2,2,1,3
C(C(CO)C(C=CC(C)=O)O)=O,,,5,1,3,0,3
25035_1,,,,2,2,1,3
25037_0,,,,2,2,1,3
C(C)(C(C(C=CC(C)=O)O)O)=O,,,5,1,3,0,3
25037_1,,,,2,2,1,3
25039_0,,,,2,2,1,3
C(CO)(CC(C=CC(C)=O)O)=O,,,5,1,2,0,2
25041_0,,,,2,2,1,3
C(C(CC(C(O)=O)=O)O)=CC(C)=O,,,5,1,1,0,1
25043_0,,,,2,2,1,3
C(C(C=O)C(C=CC(C)=O)O)(O)=O,,,5,1,2,0,2
25043_1,,,,2,2,1,3
25045_0,,,,2,2,1,3
C(C(C(C=O)=O)C(C=CC(C)=O)O)=O,,,5,1,2,0,2
25045_1,,,,2,2,1,3
25047_0,,,,2,2,1,3
C(C(CC(C(C=O)=O)=O)O)=CC(C)=O,,,5,1,1,0,1
25049_0,,,,2,2,1,3
C(C(C(C=CC(C)=O)O)O)=O,,,5,1,3,0,3
25049_1,,,,2,2,1,3
25051_0,,,,2,2,1,3
C(C(C)(CC(C=CC=O)=O)O)=CC=O,,,5,1,1,0,1
25053_0,,,,2,2,1,3
C=CC(C(C=O)=O)C(C=CC=O)(C)O,,,5,1,1,0,1
25055_0,,,,2,2,1,3
C(C(C=CC=O)C(C=CC=O)(C)O)=O,,,5,1,1,0,1
25057_0,,,,2,2,1,3
C(C(C=C)C(C=CC=O)(C)O)=O,,,5,1,1,0,1
25059_0,,,,2,2,1,3
C(C(C)(C1C(C=CO1)=O)O)=CC=O,,,5,1,2,0,2
25059_1,,,,2,2,1,3
25061_0,,,,2,2,1,3
C(C(C(C=CC=O)(C)O)O)(CO)=O,,,5,1,2,0,2
25061_1,,,,2,2,1,3
25063_0,,,,2,2,1,3
C(C(C)(CC(C=O)=O)O)=CC=O,,,5,1,2,0,2
25065_0,,,,2,2,1,3
C(C(C=O)C(C=CC=O)(C)O)=O,,,5,1,3,0,3
25065_1,,,,2,2,1,3
25067_0,,,,2,2,1,3
C(CC(C=CC=O)(C)O)=O,,,5,1,2,0,2
25069_0,,,,2,2,1,3
C(C(C)(C(C(C=O)=O)O)O)=CC=O,,,5,1,2,0,2
25069_1,,,,2,2,1,3
25071_0,,,,2,2,1,3
C(C(C(C)O)C(C=CC=O)(C)O)=O,,,5,1,2,0,2
25071_1,,,,2,2,1,3
25073_0,,,,2,2,1,3
C(C(CO)C(C=CC=O)(C)O)=O,,,5,1,3,0,3
25073_1,,,,2,2,1,3
25075_0,,,,2,2,1,3
C(C(C(C=CC=O)(C)O)O)(C)=O,,,5,1,3,0,3
25075_1,,,,2,2,1,3
25077_0,,,,2,2,1,3
C(CC(C=CC=O)(C)O)(CO)=O,,,5,1,2,0,2
25079_0,,,,2,2,1,3
C(C(C)(CC(C(O)=O)=O)O)=CC=O,,,5,1,1,0,1
25081_0,,,,2,2,1,3
C(C(C=O)C(C=CC=O)(C)O)(O)=O,,,5,1,2,0,2
25081_1,,,,2,2,1,3
25083_0,,,,2,2,1,3
C(C(C(C=O)=O)C(C=CC=O)(C)O)=O,,,5,1,2,0,2
25083_1,,,,2,2,1,3
25085_0,,,,2,2,1,3
C(C(C)(CC(C(C=O)=O)=O)O)=CC=O,,,5,1,1,0,1
25087_0,,,,2,2,1,3
C(C(C(C=CC=O)(C)O)O)=O,,,5,1,4,0,4
25087_1,,,,2,2,1,3
25089_0,,,,2,2,1,3
C(C(CC(C=CC=O)=O)(CC=C)O)=O,,,5,1,1,0,1
25091_0,,,,2,2,1,3
C(C(CC(C=CC=O)=O)O)(CC=C)=O,,,5,1,1,0,1
25093_0,,,,2,2,1,3
C(C(C=CC)(CC(C=CC=O)=O)O)=O,,,5,1,1,0,1
25095_0,,,,2,2,1,3
C(C)=CC(C(CC(C=CC=O)=O)O)=O,,,5,1,1,0,1
25097_0,,,,2,2,1,3
C(CC=CC(CC(C=CC=O)=O)O)=O,,,5,1,1,0,1
25099_0,,,,2,2,1,3
C(CC(CC(C=CC=O)=O)O)=CC=O,,,5,1,1,0,1
25101_0,,,,2,2,1,3
C(C(C=C)C(CC(C=CC=O)=O)O)=O,,,5,1,1,0,1
25103_0,,,,2,2,1,3
C(C)=C(C=O)C(CC(C=CC=O)=O)O,,,5,1,1,0,1
25105_0,,,,2,2,1,3
C=C(C=O)C(CC(C=CC=O)=O)O,,,5,1,1,0,1
25107_0,,,,2,2,1,3
C(C(CC(C=CC=O)=O)O)=CC,,,5,1,1,0,1
25109_0,,,,2,2,1,3
C=CCC(CC(C=CC=O)=O)O,,,5,1,1,0,1
25111_0,,,,2,2,1,3
C=CC(C(CC(C=CC=O)=O)O)O,,,5,1,1,0,1
25113_0,,,,2,2,1,3
C=CC(CC(C=CC=O)=O)O,,,5,1,1,0,1
25115_0,,,,2,2,1,3
C1C(COC=1)(CC(C=CC=O)=O)O,,,5,1,1,0,1
25117_0,,,,2,2,1,3
C(C=CC(CC(C(CO)O)O)=O)=O,,,5,1,1,0,1
25119_0,,,,2,2,1,3
C(C(CC(C=CC=O)=O)O)=O,,,5,1,2,0,2
25121_0,,,,2,2,1,3
C(C=CC(CC(CO)(CO)O)=O)=O,,,5,1,1,0,1
25123_0,,,,2,2,1,3
C(C(CC(C=CC=O)=O)O)(O)=O,,,5,1,2,0,2
25125_0,,,,2,2,1,3
C(C(C)(CC(C=CC=O)=O)O)=O,,,5,1,2,0,2
25127_0,,,,2,2,1,3
C(C)(C(CC(C=CC=O)=O)O)=O,,,5,1,2,0,2
25129_0,,,,2,2,1,3
C(CC(CC(C=CC=O)=O)O)=O,,,5,1,2,0,2
25131_0,,,,2,2,1,3
C(C=CC(CC(C)O)=O)=O,,,5,1,2,0,2
25133_0,,,,2,2,1,3
C(C(CO)(CC(C=CC=O)=O)O)=O,,,5,1,1,0,1
25135_0,,,,2,2,1,3
C(CO)(C(CC(C=CC=O)=O)O)=O,,,5,1,1,0,1
25137_0,,,,2,2,1,3
C(C=CC(CC(CC(C)O)O)=O)=O,,,5,1,1,0,1
25139_0,,,,2,2,1,3
C(C=CC(CC(CCO)O)=O)=O,,,5,1,2,0,2
25141_0,,,,2,2,1,3
C(C(C(CC(C=CC=O)=O)O)O)=O,,,5,1,1,0,1
25143_0,,,,2,2,1,3
C(C=CC(CC(C)(CO)O)=O)=O,,,5,1,2,0,2
25145_0,,,,2,2,1,3
C(C(C)(CC(C=CC=O)=O)O)(O)=O,,,5,1,1,0,1
25147_0,,,,2,2,1,3
C(CC(CC(C=CC=O)=O)O)(O)=O,,,5,1,1,0,1
25149_0,,,,2,2,1,3
C(CC(C=O)(CC(C=CC=O)=O)O)=O,,,5,1,1,0,1
25151_0,,,,2,2,1,3
C(CC(C(CC(C=CC=O)=O)O)=O)=O,,,5,1,1,0,1
25153_0,,,,2,2,1,3
C(C(CC(CC(C=CC=O)=O)O)=O)=O,,,5,1,1,0,1
25155_0,,,,2,2,1,3
C(C(C(C)=O)(CC(C=CC=O)=O)O)=O,,,5,1,1,0,1
25157_0,,,,2,2,1,3
C(C=CC(CC(C(C(C)=O)=O)O)=O)=O,,,5,1,1,0,1
25159_0,,,,2,2,1,3
C(C=O)(C(C)(CC(C=CC=O)=O)O)=O,,,5,1,1,0,1
25161_0,,,,2,2,1,3
C(C(C=C)(CC(C=CC=O)=O)O)=O,,,5,1,1,0,1
25163_0,,,,2,2,1,3
C=CC(C(CC(C=CC=O)=O)O)=O,,,5,1,1,0,1
25165_0,,,,2,2,1,3
C(C(CC(C=CC=O)=O)O)=CC=O,,,5,1,1,0,1
25167_0,,,,2,2,1,3
C(CC(C=CC=O)=O)(O)=O,,,5,1,4,0,4
25169_0,,,,2,2,1,3
C(C=CC(CC(C(O)O)O)=O)=O,,,5,1,2,0,2
25171_0,,,,2,2,1,3
C(C=CC(CC(C(C)O)O)=O)=O,,,5,1,2,0,2
25172_0,,,,2,2,1,3
25174_0,,,,2,2,1,3
C(C=CC(CC(CO)O)=O)=O,,,5,1,3,0,3
25176_0,,,,2,2,1,3
C(C(C=C)C(C=CCC(C=O)=O)O)=O,,,5,1,1,0,1
25178_0,,,,2,2,1,3
C(CC(C=O)=O)=CC(CC(C=O)=O)O,,,5,1,1,0,1
25180_0,,,,2,2,1,3
C(C(C=O)C(C=CCC(C=O)=O)O)=O,,,5,1,2,0,2
25180_1,,,,2,2,1,3
25182_0,,,,2,2,1,3
C(CC(C=CCC(C=O)=O)O)=O,,,5,1,3,0,3
25184_0,,,,2,2,1,3
C(C(C(C=CCC(C=O)=O)O)O)=O,,,5,1,2,0,2
25184_1,,,,2,2,1,3
25186_0,,,,2,2,1,3
C(C(C=C)C(C=O)(CC=CC=O)O)=O,,,5,1,1,0,1
25188_0,,,,2,2,1,3
C(C(CC(C=O)=O)(CC=CC=O)O)=O,,,5,1,1,0,1
25190_0,,,,2,2,1,3
C(C(C=O)C(C=O)(CC=CC=O)O)=O,,,5,1,2,0,2
25190_1,,,,2,2,1,3
25192_0,,,,2,2,1,3
C(CC(C=O)(CC=CC=O)O)=O,,,5,1,2,0,2
25194_0,,,,2,2,1,3
C(C(C(C=O)(CC=CC=O)O)O)=O,,,5,1,3,0,3
25194_1,,,,2,2,1,3
25196_0,,,,2,2,1,3
C(C(C=C)C(C(CC=CC=O)=O)O)=O,,,5,1,1,0,1
25198_0,,,,2,2,1,3
C(C(CC(C=O)=O)O)(CC=CC=O)=O,,,5,1,1,0,1
25200_0,,,,2,2,1,3
C(C(C=O)C(C(CC=CC=O)=O)O)=O,,,5,1,2,0,2
25200_1,,,,2,2,1,3
25202_0,,,,2,2,1,3
C(CC(C(CC=CC=O)=O)O)=O,,,5,1,2,0,2
25204_0,,,,2,2,1,3
C(C(C(C(CC=CC=O)=O)O)O)=O,,,5,1,4,0,4
25204_1,,,,2,2,1,3
25206_0,,,,2,2,1,3
C(C(C(C=O)=O)C(C=CC)O)=CC=O,,,5,1,1,0,1
25208_0,,,,2,2,1,3
C=CCC(C(C=CC=O)C(C=O)=O)O,,,5,1,1,0,1
25210_0,,,,2,2,1,3
C=CC(C(C=CC=O)C(C=O)=O)O,,,5,1,1,0,1
25212_0,,,,2,2,1,3
C(C(C(C=CC=O)C(C=O)=O)O)=O,,,5,1,1,0,1
25214_0,,,,2,2,1,3
C(C(C)(C(C=CC=O)C(C=O)=O)O)=O,,,5,1,1,0,1
25216_0,,,,2,2,1,3
C(C)(C(C(C=CC=O)C(C=O)=O)O)=O,,,5,1,1,0,1
25218_0,,,,2,2,1,3
C(CC(C(C=CC=O)C(C=O)=O)O)=O,,,5,1,1,0,1
25220_0,,,,2,2,1,3
C(C(C(C=O)=O)C(C)O)=CC=O,,,5,1,2,0,2
25222_0,,,,2,2,1,3
C(C(C=CC=O)C(C=O)=O)(O)=O,,,5,1,2,0,2
25223_0,,,,2,2,1,3
25225_0,,,,2,2,1,3
C(C(C(C=O)=O)C(CO)O)=CC=O,,,5,1,1,0,1
25227_0,,,,2,2,1,3
C(C(C=C)C(CC=CC(C=O)=O)O)=O,,,5,1,1,0,1
25229_0,,,,2,2,1,3
C(CC(CC(C=O)=O)O)=CC(C=O)=O,,,5,1,1,0,1
25231_0,,,,2,2,1,3
C(C(C=O)C(CC=CC(C=O)=O)O)=O,,,5,1,2,0,2
25231_1,,,,2,2,1,3
25233_0,,,,2,2,1,3
C(CC(CC=CC(C=O)=O)O)=O,,,5,1,2,0,2
25235_0,,,,2,2,1,3
C(C(C(CC=CC(C=O)=O)O)O)=O,,,5,1,2,0,2
25235_1,,,,2,2,1,3
25237_0,,,,2,2,1,3
C(C(C=C)C(C=O)(C=CCC=O)O)=O,,,5,1,1,0,1
25239_0,,,,2,2,1,3
C(C(C=CCC=O)(CC(C=O)=O)O)=O,,,5,1,1,0,1
25241_0,,,,2,2,1,3
C(C(C=O)C(C=O)(C=CCC=O)O)=O,,,5,1,2,0,2
25241_1,,,,2,2,1,3
25243_0,,,,2,2,1,3
C(C(C=CCC=O)(CC=O)O)=O,,,5,1,2,0,2
25245_0,,,,2,2,1,3
C(C(C=CCC=O)(C(C=O)O)O)=O,,,5,1,3,0,3
25245_1,,,,2,2,1,3
25247_0,,,,2,2,1,3
C(C(C=C)C(C(C=CCC=O)=O)O)=O,,,5,1,1,0,1
25249_0,,,,2,2,1,3
C(CC=CC(C(CC(C=O)=O)O)=O)=O,,,5,1,1,0,1
25251_0,,,,2,2,1,3
C(C(C=O)C(C(C=CCC=O)=O)O)=O,,,5,1,2,0,2
25251_1,,,,2,2,1,3
25253_0,,,,2,2,1,3
C(CC=CC(C(CC=O)O)=O)=O,,,5,1,2,0,2
25255_0,,,,2,2,1,3
C(CC=CC(C(C(C=O)O)O)=O)=O,,,5,1,4,0,4
25255_1,,,,2,2,1,3
25257_0,,,,2,2,1,3
C(C(C=CC(C=O)=O)C(C=CC)O)=O,,,5,1,1,0,1
25259_0,,,,2,2,1,3
C(C(C=CC(C=O)=O)C(CC=C)O)=O,,,5,1,1,0,1
25261_0,,,,2,2,1,3
C(C(C=CC(C=O)=O)C(C=C)O)=O,,,5,1,1,0,1
25263_0,,,,2,2,1,3
C(C(C=CC(C=O)=O)C(C=O)O)=O,,,5,1,1,0,1
25265_0,,,,2,2,1,3
C(C(C=CC(C=O)=O)C(C=O)(C)O)=O,,,5,1,1,0,1
25267_0,,,,2,2,1,3
C(C(C=CC(C=O)=O)C(C(C)=O)O)=O,,,5,1,1,0,1
25269_0,,,,2,2,1,3
C(C(C=CC(C=O)=O)C(CC=O)O)=O,,,5,1,1,0,1
25271_0,,,,2,2,1,3
C(C(C=CC(C=O)=O)C(C)O)=O,,,5,1,2,0,2
25273_0,,,,2,2,1,3
C(C(C(O)=O)C=CC(C=O)=O)=O,,,5,1,2,0,2
25275_0,,,,2,2,1,3
C(C(C=CC(C=O)=O)CO)=O,,,5,1,3,0,3
25277_0,,,,2,2,1,3
C(C(C=CC(C=O)=O)C(CO)O)=O,,,5,1,1,0,1
25279_0,,,,2,2,1,3
C(CO)=C(C=O)C(C(C=O)=O)CO,,,5,1,1,0,1
25281_0,,,,2,2,1,3
C(C(C=CC(C(CO)CO)=O)=O)=O,,,5,1,2,0,2
25281_1,,,,2,2,1,3
25283_0,,,,2,2,1,3
C(C(CO)C(C=CC(C=O)=O)O)=O,,,5,1,4,0,4
25283_1,,,,2,2,1,3
25285_0,,,,2,2,1,3
C(C(C=CC(C(C=O)=O)CO)O)=O,,,5,1,1,0,1
25287_0,,,,2,2,1,3
C(CC(C=O)=O)=CC(C(CO)O)=O,,,5,1,2,0,2
25287_1,,,,2,2,1,3
25289_0,,,,2,2,1,3
C(C(C(C=O)=O)CO)=CC(CO)=O,,,5,1,1,0,1
25291_0,,,,2,2,1,3
C(CO)(C(C=CC(C=O)=O)CO)=O,,,5,1,1,0,1
25293_0,,,,2,2,1,3
C(C(CO)O)(CC=CC(C=O)=O)=O,,,5,1,2,0,2
25293_1,,,,2,2,1,3
25295_0,,,,2,2,1,3
C(CO)(C(C(C=O)=O)CO)=CC=O,,,5,1,1,0,1
25297_0,,,,2,2,1,3
C(C(C(CO)=CC(C=O)=O)CO)=O,,,5,1,1,0,1
25299_0,,,,2,2,1,3
C(CCO)(C(C=CC(C=O)=O)O)=O,,,5,1,1,0,1
25301_0,,,,2,2,1,3
C(C(C(C(C(C=O)=O)CO)=C)O)=O,,,5,1,1,0,1
25303_0,,,,2,2,1,3
C(C(CC=C)(C(C=C)C(C=O)=O)O)=O,,,5,1,1,0,1
25305_0,,,,2,2,1,3
C(C(C=CC=O)C(C=O)(CC=C)O)=O,,,5,1,1,0,1
25307_0,,,,2,2,1,3
C(C(C=C)C(C=O)(CC=C)O)=O,,,5,1,1,0,1
25309_0,,,,2,2,1,3
C(C(CC=C)(C1C(C=CO1)=O)O)=O,,,5,1,2,0,2
25309_1,,,,2,2,1,3
25311_0,,,,2,2,1,3
C(C(CC=C)(C(C(CO)=O)O)O)=O,,,5,1,2,0,2
25311_1,,,,2,2,1,3
25313_0,,,,2,2,1,3
C(C(CC(C=O)=O)(CC=C)O)=O,,,5,1,2,0,2
25315_0,,,,2,2,1,3
C(C(C=O)C(C=O)(CC=C)O)=O,,,5,1,3,0,3
25315_1,,,,2,2,1,3
25317_0,,,,2,2,1,3
C(CC(C=O)(CC=C)O)=O,,,5,1,2,0,2
25319_0,,,,2,2,1,3
C(C(CC=C)(C(C(C=O)=O)O)O)=O,,,5,1,2,0,2
25319_1,,,,2,2,1,3
25321_0,,,,2,2,1,3
C(C(C(C)O)C(C=O)(CC=C)O)=O,,,5,1,2,0,2
25321_1,,,,2,2,1,3
25323_0,,,,2,2,1,3
C(C(CO)C(C=O)(CC=C)O)=O,,,5,1,3,0,3
25323_1,,,,2,2,1,3
25325_0,,,,2,2,1,3
C(C(CC=C)(C(C(C)=O)O)O)=O,,,5,1,3,0,3
25325_1,,,,2,2,1,3
25327_0,,,,2,2,1,3
C(C(CC=C)(CC(CO)=O)O)=O,,,5,1,2,0,2
25329_0,,,,2,2,1,3
C(C(CC(C(O)=O)=O)(CC=C)O)=O,,,5,1,1,0,1
25331_0,,,,2,2,1,3
C(C(C=O)C(C=O)(CC=C)O)(O)=O,,,5,1,2,0,2
25331_1,,,,2,2,1,3
25333_0,,,,2,2,1,3
C(C(C(C=O)=O)C(C=O)(CC=C)O)=O,,,5,1,2,0,2
25333_1,,,,2,2,1,3
25335_0,,,,2,2,1,3
C(C(CC(C(C=O)=O)=O)(CC=C)O)=O,,,5,1,1,0,1
25337_0,,,,2,2,1,3
C(C(C(C=O)(CC=C)O)O)=O,,,5,1,3,0,3
25337_1,,,,2,2,1,3
25339_0,,,,2,2,1,3
C(C(C(C=C)C(C=O)=O)O)(CC=C)=O,,,5,1,1,0,1
25341_0,,,,2,2,1,3
C(C(C=CC=O)C(C(CC=C)=O)O)=O,,,5,1,1,0,1
25343_0,,,,2,2,1,3
C(C(C=C)C(C(CC=C)=O)O)=O,,,5,1,1,0,1
25345_0,,,,2,2,1,3
C(C(C1C(C=CO1)=O)O)(CC=C)=O,,,5,1,2,0,2
25345_1,,,,2,2,1,3
25347_0,,,,2,2,1,3
C(C(C(C(CO)=O)O)O)(CC=C)=O,,,5,1,2,0,2
25347_1,,,,2,2,1,3
25349_0,,,,2,2,1,3
C(C(CC(C=O)=O)O)(CC=C)=O,,,5,1,2,0,2
25351_0,,,,2,2,1,3
C(C(C=O)C(C(CC=C)=O)O)=O,,,5,1,3,0,3
25351_1,,,,2,2,1,3
25353_0,,,,2,2,1,3
C(CC(C(CC=C)=O)O)=O,,,5,1,2,0,2
25355_0,,,,2,2,1,3
C(C(C(C(C=O)=O)O)O)(CC=C)=O,,,5,1,2,0,2
25355_1,,,,2,2,1,3
25357_0,,,,2,2,1,3
C(C(C(C)O)C(C(CC=C)=O)O)=O,,,5,1,2,0,2
25357_1,,,,2,2,1,3
25359_0,,,,2,2,1,3
C(C(CO)C(C(CC=C)=O)O)=O,,,5,1,3,0,3
25359_1,,,,2,2,1,3
25361_0,,,,2,2,1,3
C(C(C(C(C)=O)O)O)(CC=C)=O,,,5,1,3,0,3
25361_1,,,,2,2,1,3
25363_0,,,,2,2,1,3
C(C(CC(CO)=O)O)(CC=C)=O,,,5,1,2,0,2
25365_0,,,,2,2,1,3
C(C(CC(C(O)=O)=O)O)(CC=C)=O,,,5,1,1,0,1
25367_0,,,,2,2,1,3
C(C(C=O)C(C(CC=C)=O)O)(O)=O,,,5,1,2,0,2
25367_1,,,,2,2,1,3
25369_0,,,,2,2,1,3
C(C(C(C=O)=O)C(C(CC=C)=O)O)=O,,,5,1,2,0,2
25369_1,,,,2,2,1,3
25371_0,,,,2,2,1,3
C(C(CC(C(C=O)=O)=O)O)(CC=C)=O,,,5,1,1,0,1
25373_0,,,,2,2,1,3
C(C(C(C(CC=C)=O)O)O)=O,,,5,1,3,0,3
25373_1,,,,2,2,1,3
25375_0,,,,2,2,1,3
C(C(C=CC)(C(C=C)C(C=O)=O)O)=O,,,5,1,1,0,1
25377_0,,,,2,2,1,3
C=CC(C(C=O)=O)C(C(C=CC)=O)O,,,5,1,1,0,1
25379_0,,,,2,2,1,3
C(CC=CC(C(C=C)C(C=O)=O)O)=O,,,5,1,1,0,1
25381_0,,,,2,2,1,3
C=CC(C(C=O)=O)C(CC=CC=O)O,,,5,1,1,0,1
25383_0,,,,2,2,1,3
C(C(C=C)C(C(C=C)C(C=O)=O)O)=O,,,5,1,1,0,1
25385_0,,,,2,2,1,3
C=CC(C(C=O)=O)C(C(C=O)=CC)O,,,5,1,1,0,1
25387_0,,,,2,2,1,3
C=CC(C(C=O)=O)C(C(C=O)=C)O,,,5,1,1,0,1
25389_0,,,,2,2,1,3
C=CC(C(C=O)=O)C(C=CC)O,,,5,1,1,0,1
25391_0,,,,2,2,1,3
C=CC(C(C=O)=O)C(CC=C)O,,,5,1,1,0,1
25393_0,,,,2,2,1,3
C=CC(C(C=O)=O)C(C(C=C)O)O,,,5,1,1,0,1
25395_0,,,,2,2,1,3
C=CC(C(C=O)=O)C(C=C)O,,,5,1,1,0,1
25397_0,,,,2,2,1,3
C1OCC(C=1)(C(C=C)C(C=O)=O)O,,,5,1,1,0,1
25399_0,,,,2,2,1,3
C=CC(C(C=O)=O)C(C(CO)O)O,,,5,1,1,0,1
25401_0,,,,2,2,1,3
C(C(C(C=C)C(C=O)=O)O)=O,,,5,1,2,0,2
25403_0,,,,2,2,1,3
C=CC(C(C=O)=O)C(CO)(CO)O,,,5,1,1,0,1
25405_0,,,,2,2,1,3
C(C(C(C=C)C(C=O)=O)O)(O)=O,,,5,1,2,0,2
25407_0,,,,2,2,1,3
C(C(C)(C(C=C)C(C=O)=O)O)=O,,,5,1,2,0,2
25409_0,,,,2,2,1,3
C(C)(C(C(C=C)C(C=O)=O)O)=O,,,5,1,2,0,2
25411_0,,,,2,2,1,3
C(CC(C(C=C)C(C=O)=O)O)=O,,,5,1,2,0,2
25413_0,,,,2,2,1,3
C=CC(C(C=O)=O)C(C)O,,,5,1,2,0,2
25415_0,,,,2,2,1,3
C(C(CO)(C(C=C)C(C=O)=O)O)=O,,,5,1,1,0,1
25417_0,,,,2,2,1,3
C(CO)(C(C(C=C)C(C=O)=O)O)=O,,,5,1,1,0,1
25419_0,,,,2,2,1,3
C=CC(C(C=O)=O)C(CC(C)O)O,,,5,1,1,0,1
25421_0,,,,2,2,1,3
C=CC(C(C=O)=O)C(CCO)O,,,5,1,2,0,2
25423_0,,,,2,2,1,3
C(C(C(C(C=C)C(C=O)=O)O)O)=O,,,5,1,1,0,1
25425_0,,,,2,2,1,3
C=CC(C(C=O)=O)C(C)(CO)O,,,5,1,2,0,2
25427_0,,,,2,2,1,3
C(C(C)(C(C=C)C(C=O)=O)O)(O)=O,,,5,1,1,0,1
25429_0,,,,2,2,1,3
C(CC(C(C=C)C(C=O)=O)O)(O)=O,,,5,1,1,0,1
25431_0,,,,2,2,1,3
C(CC(C=O)(C(C=C)C(C=O)=O)O)=O,,,5,1,1,0,1
25433_0,,,,2,2,1,3
C(CC(C(C(C=C)C(C=O)=O)O)=O)=O,,,5,1,1,0,1
25435_0,,,,2,2,1,3
C=CC(C(C=O)=O)C(CC(C=O)=O)O,,,5,1,1,0,1
25437_0,,,,2,2,1,3
C(C(C(C)=O)(C(C=C)C(C=O)=O)O)=O,,,5,1,1,0,1
25439_0,,,,2,2,1,3
C=CC(C(C=O)=O)C(C(C(C)=O)=O)O,,,5,1,1,0,1
25441_0,,,,2,2,1,3
C=CC(C(C=O)=O)C(C(C=O)=O)(C)O,,,5,1,1,0,1
25443_0,,,,2,2,1,3
C(C(C=C)(C(C=C)C(C=O)=O)O)=O,,,5,1,1,0,1
25445_0,,,,2,2,1,3
C=CC(C(C=O)=O)C(C(C=C)=O)O,,,5,1,1,0,1
25447_0,,,,2,2,1,3
C=CC(C(C=O)=O)C(C=CC=O)O,,,5,1,1,0,1
25449_0,,,,2,2,1,3
C(C(C=C)C(C=O)=O)(O)=O,,,5,1,4,0,4
25451_0,,,,2,2,1,3
C=CC(C(C=O)=O)C(C(O)O)O,,,5,1,2,0,2
25453_0,,,,2,2,1,3
C=CC(C(C=O)=O)C(C(C)O)O,,,5,1,2,0,2
25454_0,,,,2,2,1,3
25456_0,,,,2,2,1,3
C=CC(C(C=O)=O)C(CO)O,,,5,1,2,0,2
25458_0,,,,2,2,1,3
C(C(C=CC=O)C(C=O)(C=CC)O)=O,,,5,1,1,0,1
25460_0,,,,2,2,1,3
C(C(C=C)C(C=O)(C=CC)O)=O,,,5,1,1,0,1
25462_0,,,,2,2,1,3
C(C(C=CC)(C1C(C=CO1)=O)O)=O,,,5,1,2,0,2
25462_1,,,,2,2,1,3
25464_0,,,,2,2,1,3
C(C(C=CC)(C(C(CO)=O)O)O)=O,,,5,1,2,0,2
25464_1,,,,2,2,1,3
25466_0,,,,2,2,1,3
C(C(C=CC)(CC(C=O)=O)O)=O,,,5,1,2,0,2
25468_0,,,,2,2,1,3
C(C(C=O)C(C=O)(C=CC)O)=O,,,5,1,3,0,3
25468_1,,,,2,2,1,3
25470_0,,,,2,2,1,3
C(C(C=CC)(CC=O)O)=O,,,5,1,2,0,2
25472_0,,,,2,2,1,3
C(C(C=CC)(C(C(C=O)=O)O)O)=O,,,5,1,2,0,2
25472_1,,,,2,2,1,3
25474_0,,,,2,2,1,3
C(C(C(C)O)C(C=O)(C=CC)O)=O,,,5,1,2,0,2
25474_1,,,,2,2,1,3
25476_0,,,,2,2,1,3
C(C(CO)C(C=O)(C=CC)O)=O,,,5,1,3,0,3
25476_1,,,,2,2,1,3
25478_0,,,,2,2,1,3
C(C(C=CC)(C(C(C)=O)O)O)=O,,,5,1,3,0,3
25478_1,,,,2,2,1,3
25480_0,,,,2,2,1,3
C(C(C=CC)(CC(CO)=O)O)=O,,,5,1,2,0,2
25482_0,,,,2,2,1,3
C(C(C=CC)(CC(C(O)=O)=O)O)=O,,,5,1,1,0,1
25484_0,,,,2,2,1,3
C(C(C=O)C(C=O)(C=CC)O)(O)=O,,,5,1,2,0,2
25484_1,,,,2,2,1,3
25486_0,,,,2,2,1,3
C(C(C(C=O)=O)C(C=O)(C=CC)O)=O,,,5,1,2,0,2
25486_1,,,,2,2,1,3
25488_0,,,,2,2,1,3
C(C(C=CC)(CC(C(C=O)=O)=O)O)=O,,,5,1,1,0,1
25490_0,,,,2,2,1,3
C(C(C=CC)(C(C=O)O)O)=O,,,5,1,3,0,3
25490_1,,,,2,2,1,3
25492_0,,,,2,2,1,3
C(C(C=CC=O)C(C(C=CC)=O)O)=O,,,5,1,1,0,1
25494_0,,,,2,2,1,3
C(C(C=C)C(C(C=CC)=O)O)=O,,,5,1,1,0,1
25496_0,,,,2,2,1,3
C1OC(C(C=1)=O)C(C(C=CC)=O)O,,,5,1,2,0,2
25496_1,,,,2,2,1,3
25498_0,,,,2,2,1,3
C(CO)(C(C(C(C=CC)=O)O)O)=O,,,5,1,2,0,2
25498_1,,,,2,2,1,3
25500_0,,,,2,2,1,3
C(C)=CC(C(CC(C=O)=O)O)=O,,,5,1,2,0,2
25502_0,,,,2,2,1,3
C(C(C=O)C(C(C=CC)=O)O)=O,,,5,1,3,0,3
25502_1,,,,2,2,1,3
25504_0,,,,2,2,1,3
C(CC(C(C=CC)=O)O)=O,,,5,1,2,0,2
25506_0,,,,2,2,1,3
C(C)=CC(C(C(C(C=O)=O)O)O)=O,,,5,1,2,0,2
25506_1,,,,2,2,1,3
25508_0,,,,2,2,1,3
C(C(C(C)O)C(C(C=CC)=O)O)=O,,,5,1,2,0,2
25508_1,,,,2,2,1,3
25510_0,,,,2,2,1,3
C(C(CO)C(C(C=CC)=O)O)=O,,,5,1,3,0,3
25510_1,,,,2,2,1,3
25512_0,,,,2,2,1,3
C(C)(C(C(C(C=CC)=O)O)O)=O,,,5,1,3,0,3
25512_1,,,,2,2,1,3
25514_0,,,,2,2,1,3
C(CO)(CC(C(C=CC)=O)O)=O,,,5,1,2,0,2
25516_0,,,,2,2,1,3
C(C)=CC(C(CC(C(O)=O)=O)O)=O,,,5,1,1,0,1
25518_0,,,,2,2,1,3
C(C(C=O)C(C(C=CC)=O)O)(O)=O,,,5,1,2,0,2
25518_1,,,,2,2,1,3
25520_0,,,,2,2,1,3
C(C(C(C=O)=O)C(C(C=CC)=O)O)=O,,,5,1,2,0,2
25520_1,,,,2,2,1,3
25522_0,,,,2,2,1,3
C(C)=CC(C(CC(C(C=O)=O)=O)O)=O,,,5,1,1,0,1
25524_0,,,,2,2,1,3
C(C(C(C(C=CC)=O)O)O)=O,,,5,1,3,0,3
25524_1,,,,2,2,1,3
25526_0,,,,2,2,1,3
C(CC(C(CO)=CC(C=O)=O)O)=O,,,5,1,1,0,1
25528_0,,,,2,2,1,3
C(C(C=C(C=O)CO)(CC=O)O)=O,,,5,1,1,0,1
25530_0,,,,2,2,1,3
C(CC(C(C=C(C=O)CO)=O)O)=O,,,5,1,1,0,1
25532_0,,,,2,2,1,3
C(CC(C=CC(C=O)=O)(CO)O)=O,,,5,1,1,0,1
25534_0,,,,2,2,1,3
C(C(C=CC(CO)=O)(CC=O)O)=O,,,5,1,1,0,1
25536_0,,,,2,2,1,3
C(CC(C(C=CC(CO)=O)=O)O)=O,,,5,1,1,0,1
25538_0,,,,2,2,1,3
C=CC(C(C(C=CC(C=O)=O)=O)O)O,,,5,1,2,0,2
25538_1,,,,2,2,1,3
25540_0,,,,2,2,1,3
C(C(C=CC(C(C(C)O)O)=O)=O)=O,,,5,1,2,0,2
25540_1,,,,2,2,1,3
25542_0,,,,2,2,1,3
C(C(C(C=CC(C=O)=O)=O)O)(O)=O,,,5,1,2,0,2
25542_1,,,,2,2,1,3
25543_0,,,,2,2,1,3
25543_1,,,,2,2,1,3
25545_0,,,,2,2,1,3
C(C(C=CC(CO)O)(CC=O)O)=O,,,5,1,1,0,1
25547_0,,,,2,2,1,3
C(CC(C(C=CC(CO)O)=O)O)=O,,,5,1,1,0,1
25549_0,,,,2,2,1,3
C(C(C=C)C(C=CC(C=O)=O)O)=O,,,5,1,1,0,1
25551_0,,,,2,2,1,3
C1OC(C(C=1)=O)C(C=CC(C=O)=O)O,,,5,1,2,0,2
25551_1,,,,2,2,1,3
25553_0,,,,2,2,1,3
C(C(CC(C=O)=O)O)=CC(C=O)=O,,,5,1,1,0,1
25555_0,,,,2,2,1,3
C(C(C=O)C(C=CC(C=O)=O)O)=O,,,5,1,2,0,2
25555_1,,,,2,2,1,3
25556_0,,,,2,2,1,3
25557_0,,,,2,2,1,3
25557_1,,,,2,2,1,3
25559_0,,,,2,2,1,3
C(C)(C(C(C=CC(C=O)=O)O)O)=O,,,5,1,2,0,2
25559_1,,,,2,2,1,3
25561_0,,,,2,2,1,3
C(CO)(CC(C=CC(C=O)=O)O)=O,,,5,1,1,0,1
25562_0,,,,2,2,1,3
25562_1,,,,2,2,1,3
25564_0,,,,2,2,1,3
C(C(C=C)C(C=O)(C=CC=O)O)=O,,,5,1,1,0,1
25566_0,,,,2,2,1,3
C(C(C=CC=O)(C1C(C=CO1)=O)O)=O,,,5,1,2,0,2
25566_1,,,,2,2,1,3
25568_0,,,,2,2,1,3
C(C(C=CC=O)(CC(C=O)=O)O)=O,,,5,1,1,0,1
25570_0,,,,2,2,1,3
C(C(C=O)C(C=O)(C=CC=O)O)=O,,,5,1,2,0,2
25570_1,,,,2,2,1,3
25571_0,,,,2,2,1,3
25573_0,,,,2,2,1,3
C(C(C=CC=O)(C(C=O)CO)O)=O,,,5,1,4,0,4
25573_1,,,,2,2,1,3
25575_0,,,,2,2,1,3
C(C(C=CC=O)(C(C(C)=O)O)O)=O,,,5,1,3,0,3
25575_1,,,,2,2,1,3
25577_0,,,,2,2,1,3
C(C(C=CC=O)(CC(CO)=O)O)=O,,,5,1,1,0,1
25578_0,,,,2,2,1,3
25578_1,,,,2,2,1,3
25580_0,,,,2,2,1,3
C(C(C=C)C(C(C=CC=O)=O)O)=O,,,5,1,1,0,1
25582_0,,,,2,2,1,3
C1OC(C(C=1)=O)C(C(C=CC=O)=O)O,,,5,1,2,0,2
25582_1,,,,2,2,1,3
25584_0,,,,2,2,1,3
C(C(CC(C(C=CC=O)=O)O)=O)=O,,,5,1,1,0,1
25586_0,,,,2,2,1,3
C(C(C=O)C(C(C=CC=O)=O)O)=O,,,5,1,2,0,2
25586_1,,,,2,2,1,3
25588_0,,,,2,2,1,3
C(CC(C(C=CC=O)=O)O)=O,,,5,1,4,0,4
25590_0,,,,2,2,1,3
C(C(CO)C(C(C=CC=O)=O)O)=O,,,5,1,2,0,2
25590_1,,,,2,2,1,3
25592_0,,,,2,2,1,3
C(C)(C(C(C(C=CC=O)=O)O)O)=O,,,5,1,4,0,4
25592_1,,,,2,2,1,3
25594_0,,,,2,2,1,3
C(CO)(CC(C(C=CC=O)=O)O)=O,,,5,1,1,0,1
25596_0,,,,2,2,1,3
C(C(C(C(C=CC=O)=O)O)O)=O,,,5,1,6,0,6
25596_1,,,,2,2,1,3
25598_0,,,,2,2,1,3
C(C(C=C)C(C=O)(C=CCO)O)=O,,,5,1,1,0,1
25600_0,,,,2,2,1,3
C(C(C=CCO)(C1C(C=CO1)=O)O)=O,,,5,1,2,0,2
25600_1,,,,2,2,1,3
25602_0,,,,2,2,1,3
C(C(C=CCO)(CC(C=O)=O)O)=O,,,5,1,1,0,1
25604_0,,,,2,2,1,3
C(C(C=O)C(C=O)(C=CCO)O)=O,,,5,1,2,0,2
25604_1,,,,2,2,1,3
25606_0,,,,2,2,1,3
C(C(C=CCO)(CC=O)O)=O,,,5,1,4,0,4
25608_0,,,,2,2,1,3
C(C(CO)C(C=O)(C=CCO)O)=O,,,5,1,2,0,2
25608_1,,,,2,2,1,3
25610_0,,,,2,2,1,3
C(C(C=CCO)(C(C(C)=O)O)O)=O,,,5,1,2,0,2
25610_1,,,,2,2,1,3
25612_0,,,,2,2,1,3
C(C(C=CCO)(CC(CO)=O)O)=O,,,5,1,1,0,1
25614_0,,,,2,2,1,3
C(C(C=CCO)(C(C=O)O)O)=O,,,5,1,5,0,5
25614_1,,,,2,2,1,3
25616_0,,,,2,2,1,3
C(C(C=C)C(C(C=CCO)=O)O)=O,,,5,1,1,0,1
25618_0,,,,2,2,1,3
C1OC(C(C=1)=O)C(C(C=CCO)=O)O,,,5,1,2,0,2
25618_1,,,,2,2,1,3
25620_0,,,,2,2,1,3
C(CO)=CC(C(CC(C=O)=O)O)=O,,,5,1,1,0,1
25622_0,,,,2,2,1,3
C(C(C=O)C(C(C=CCO)=O)O)=O,,,5,1,2,0,2
25622_1,,,,2,2,1,3
25624_0,,,,2,2,1,3
C(CC(C(C=CCO)=O)O)=O,,,5,1,2,0,2
25626_0,,,,2,2,1,3
C(C(CO)C(C(C=CCO)=O)O)=O,,,5,1,2,0,2
25626_1,,,,2,2,1,3
25628_0,,,,2,2,1,3
C(C)(C(C(C(C=CCO)=O)O)O)=O,,,5,1,2,0,2
25628_1,,,,2,2,1,3
25630_0,,,,2,2,1,3
C(CO)(CC(C(C=CCO)=O)O)=O,,,5,1,1,0,1
25632_0,,,,2,2,1,3
C(C(C(C(C=CCO)=O)O)O)=O,,,5,1,3,0,3
25632_1,,,,2,2,1,3
25634_0,,,,2,2,1,3
C(C(C=C)C(C(C=O)=CCC=O)O)=O,,,5,1,1,0,1
25636_0,,,,2,2,1,3
C(CC=C(C=O)C(CC(C=O)=O)O)=O,,,5,1,1,0,1
25638_0,,,,2,2,1,3
C(C(C=O)C(C(C=O)=CCC=O)O)=O,,,5,1,2,0,2
25638_1,,,,2,2,1,3
25640_0,,,,2,2,1,3
C(CC=C(C=O)C(CC=O)O)=O,,,5,1,2,0,2
25642_0,,,,2,2,1,3
C(CC=C(C=O)C(C(C=O)O)O)=O,,,5,1,2,0,2
25642_1,,,,2,2,1,3
25644_0,,,,2,2,1,3
C(C(C=C)C(CC=C(C=O)C=O)O)=O,,,5,1,1,0,1
25646_0,,,,2,2,1,3
C(CC(CC(C=O)=O)O)=C(C=O)C=O,,,5,1,1,0,1
25648_0,,,,2,2,1,3
C(C(C=O)C(CC=C(C=O)C=O)O)=O,,,5,1,2,0,2
25648_1,,,,2,2,1,3
25650_0,,,,2,2,1,3
C(CC(CC=C(C=O)C=O)O)=O,,,5,1,2,0,2
25652_0,,,,2,2,1,3
C(C(C(CC=C(C=O)C=O)O)O)=O,,,5,1,2,0,2
25652_1,,,,2,2,1,3
25654_0,,,,2,2,1,3
C(C(C=C(C=O)C=O)C(C=CC)O)=O,,,5,1,1,0,1
25656_0,,,,2,2,1,3
C(C(C=C(C=O)C=O)C(CC=C)O)=O,,,5,1,1,0,1
25658_0,,,,2,2,1,3
C(C(C=C(C=O)C=O)C(C=C)O)=O,,,5,1,1,0,1
25660_0,,,,2,2,1,3
C(C(C=C(C=O)C=O)C(C=O)O)=O,,,5,1,1,0,1
25662_0,,,,2,2,1,3
C(C(C=C(C=O)C=O)C(C=O)(C)O)=O,,,5,1,1,0,1
25664_0,,,,2,2,1,3
C(C(C=C(C=O)C=O)C(C(C)=O)O)=O,,,5,1,1,0,1
25666_0,,,,2,2,1,3
C(C(C=C(C=O)C=O)C(CC=O)O)=O,,,5,1,1,0,1
25668_0,,,,2,2,1,3
C(C(C=C(C=O)C=O)C(C)O)=O,,,5,1,2,0,2
25670_0,,,,2,2,1,3
C(C(C(O)=O)C=C(C=O)C=O)=O,,,5,1,2,0,2
25672_0,,,,2,2,1,3
C(C(C=C(C=O)C=O)CO)=O,,,5,1,3,0,3
25674_0,,,,2,2,1,3
C(C(C=C(C=O)C=O)C(CO)O)=O,,,5,1,1,0,1
25676_0,,,,2,2,1,3
C(C(C=C)C(C(C=O)C=CC=O)O)=O,,,5,1,2,0,2
25678_0,,,,2,2,1,3
C(C(C=CC=O)C(CC(C=O)=O)O)=O,,,5,1,2,0,2
25679_0,,,,2,2,1,3
25679_1,,,,2,2,1,3
25681_0,,,,2,2,1,3
C(C(C=CC=O)C(CC=O)O)=O,,,5,1,3,0,3
25683_0,,,,2,2,1,3
C(C(C=CC=O)C(C(C=O)O)O)=O,,,5,1,3,0,3
25683_1,,,,2,2,1,3
25685_0,,,,2,2,1,3
C(C(C=O)C=CC(C(C=O)C=C)O)=O,,,5,1,1,0,1
25687_0,,,,2,2,1,3
C(C(C=O)C=CC(CC(C=O)=O)O)=O,,,5,1,1,0,1
25689_0,,,,2,2,1,3
C(C(C=O)C=CC(C(C=O)C=O)O)=O,,,5,1,2,0,2
25689_1,,,,2,2,1,3
25691_0,,,,2,2,1,3
C(C(C=O)C=CC(CC=O)O)=O,,,5,1,2,0,2
25693_0,,,,2,2,1,3
C(C(C=O)C=CC(C(C=O)O)O)=O,,,5,1,2,0,2
25693_1,,,,2,2,1,3
25695_0,,,,2,2,1,3
C(C(CO)C(C(C(C=O)=O)=C)O)=O,,,5,1,4,0,4
25695_1,,,,2,2,1,3
25697_0,,,,2,2,1,3
C(C(C=C(C(C=O)=O)CO)CO)=O,,,5,1,1,0,1
25699_0,,,,2,2,1,3
C(C(CO)C(C(C=O)=CC=O)O)=O,,,5,1,4,0,4
25699_1,,,,2,2,1,3
25701_0,,,,2,2,1,3
C(C(C=C(C=O)C(C=O)O)CO)=O,,,5,1,1,0,1
25703_0,,,,2,2,1,3
C(CC=C(C=O)C(C(CO)O)=O)=O,,,5,1,2,0,2
25703_1,,,,2,2,1,3
25705_0,,,,2,2,1,3
C(C(C=C(C=O)C(CO)=O)CO)=O,,,5,1,1,0,1
25707_0,,,,2,2,1,3
C(C(C(C(CO)O)=O)C=CC=O)=O,,,5,1,2,0,2
25707_1,,,,2,2,1,3
25709_0,,,,2,2,1,3
C(C(C(C(C=CC=O)O)=O)CO)=O,,,5,1,2,0,2
25709_1,,,,2,2,1,3
25711_0,,,,2,2,1,3
C(C(C=CC(C(C=O)O)=O)CO)=O,,,5,1,1,0,1
25713_0,,,,2,2,1,3
C(C(C=O)O)(C(C=CC=O)CO)=O,,,5,1,1,0,1
25715_0,,,,2,2,1,3
C(C(C=CC=O)C(C=CCC=O)O)=O,,,5,1,1,0,1
25717_0,,,,2,2,1,3
C(C(C=C)C(C=CCC=O)O)=O,,,5,1,1,0,1
25719_0,,,,2,2,1,3
C(CC=CC(C1C(C=CO1)=O)O)=O,,,5,1,2,0,2
25719_1,,,,2,2,1,3
25721_0,,,,2,2,1,3
C(CC=CC(C(C(CO)=O)O)O)=O,,,5,1,2,0,2
25721_1,,,,2,2,1,3
25723_0,,,,2,2,1,3
C(CC=CC(CC(C=O)=O)O)=O,,,5,1,2,0,2
25725_0,,,,2,2,1,3
C(C(C=O)C(C=CCC=O)O)=O,,,5,1,3,0,3
25725_1,,,,2,2,1,3
25727_0,,,,2,2,1,3
C(CC=CC(CC=O)O)=O,,,5,1,2,0,2
25729_0,,,,2,2,1,3
C(CC=CC(C(C(C=O)=O)O)O)=O,,,5,1,2,0,2
25729_1,,,,2,2,1,3
25731_0,,,,2,2,1,3
C(C(C(C)O)C(C=CCC=O)O)=O,,,5,1,2,0,2
25731_1,,,,2,2,1,3
25733_0,,,,2,2,1,3
C(C(CO)C(C=CCC=O)O)=O,,,5,1,3,0,3
25733_1,,,,2,2,1,3
25735_0,,,,2,2,1,3
C(CC=CC(C(C(C)=O)O)O)=O,,,5,1,3,0,3
25735_1,,,,2,2,1,3
25737_0,,,,2,2,1,3
C(CC=CC(CC(CO)=O)O)=O,,,5,1,2,0,2
25739_0,,,,2,2,1,3
C(CC=CC(CC(C(O)=O)=O)O)=O,,,5,1,1,0,1
25741_0,,,,2,2,1,3
C(C(C=O)C(C=CCC=O)O)(O)=O,,,5,1,2,0,2
25741_1,,,,2,2,1,3
25743_0,,,,2,2,1,3
C(C(C(C=O)=O)C(C=CCC=O)O)=O,,,5,1,2,0,2
25743_1,,,,2,2,1,3
25745_0,,,,2,2,1,3
C(CC=CC(CC(C(C=O)=O)=O)O)=O,,,5,1,1,0,1
25747_0,,,,2,2,1,3
C(CC=CC(C(C=O)O)O)=O,,,5,1,3,0,3
25747_1,,,,2,2,1,3
25749_0,,,,2,2,1,3
C(C(C=CC=O)C(CC=CC=O)O)=O,,,5,1,1,0,1
25751_0,,,,2,2,1,3
C(C(C=C)C(CC=CC=O)O)=O,,,5,1,1,0,1
25753_0,,,,2,2,1,3
C(CC(C1C(C=CO1)=O)O)=CC=O,,,5,1,2,0,2
25753_1,,,,2,2,1,3
25755_0,,,,2,2,1,3
C(CO)(C(C(CC=CC=O)O)O)=O,,,5,1,2,0,2
25755_1,,,,2,2,1,3
25757_0,,,,2,2,1,3
C(CC(CC(C=O)=O)O)=CC=O,,,5,1,2,0,2
25759_0,,,,2,2,1,3
C(C(C=O)C(CC=CC=O)O)=O,,,5,1,3,0,3
25759_1,,,,2,2,1,3
25761_0,,,,2,2,1,3
C(CC(CC=CC=O)O)=O,,,5,1,2,0,2
25763_0,,,,2,2,1,3
C(CC(C(C(C=O)=O)O)O)=CC=O,,,5,1,2,0,2
25763_1,,,,2,2,1,3
25765_0,,,,2,2,1,3
C(C(C(CC=CC=O)O)C(C)O)=O,,,5,1,2,0,2
25765_1,,,,2,2,1,3
25767_0,,,,2,2,1,3
C(C(CO)C(CC=CC=O)O)=O,,,5,1,3,0,3
25767_1,,,,2,2,1,3
25769_0,,,,2,2,1,3
C(C)(C(C(CC=CC=O)O)O)=O,,,5,1,3,0,3
25769_1,,,,2,2,1,3
25771_0,,,,2,2,1,3
C(CO)(CC(CC=CC=O)O)=O,,,5,1,2,0,2
25773_0,,,,2,2,1,3
C(CC(CC(C(O)=O)=O)O)=CC=O,,,5,1,1,0,1
25775_0,,,,2,2,1,3
C(C(C=O)C(CC=CC=O)O)(O)=O,,,5,1,2,0,2
25775_1,,,,2,2,1,3
25777_0,,,,2,2,1,3
C(C(C(C=O)=O)C(CC=CC=O)O)=O,,,5,1,2,0,2
25777_1,,,,2,2,1,3
25779_0,,,,2,2,1,3
C(CC(CC(C(C=O)=O)=O)O)=CC=O,,,5,1,1,0,1
25781_0,,,,2,2,1,3
C(C(C(CC=CC=O)O)O)=O,,,5,1,3,0,3
25781_1,,,,2,2,1,3
25782_0,,,,2,2,1,3
25784_0,,,,2,2,1,3
C(C(C=CC=O)C(C(C=O)=CC)O)=O,,,5,1,1,0,1
25786_0,,,,2,2,1,3
C(C(C=CC=O)C(C(C=O)=C)O)=O,,,5,1,1,0,1
25788_0,,,,2,2,1,3
C(C(C=CC=O)C(C=CC)O)=O,,,5,1,1,0,1
25790_0,,,,2,2,1,3
C(C(C=CC=O)C(CC=C)O)=O,,,5,1,1,0,1
25792_0,,,,2,2,1,3
C(C(C=CC=O)C(C(C=C)O)O)=O,,,5,1,1,0,1
25794_0,,,,2,2,1,3
C(C(C=CC=O)C(C=C)O)=O,,,5,1,1,0,1
25796_0,,,,2,2,1,3
C(C(C=CC=O)C1(C=COC1)O)=O,,,5,1,1,0,1
25798_0,,,,2,2,1,3
C(C(C=CC=O)C(C(CO)O)O)=O,,,5,1,1,0,1
25799_0,,,,2,2,1,3
25801_0,,,,2,2,1,3
C(C(C=CC=O)C(CO)(CO)O)=O,,,5,1,1,0,1
25803_0,,,,2,2,1,3
C(C(C=CC=O)C(C(O)=O)O)=O,,,5,1,4,0,4
25805_0,,,,2,2,1,3
C(C(C=CC=O)C(C=O)(C)O)=O,,,5,1,2,0,2
25807_0,,,,2,2,1,3
C(C(C=CC=O)C(C(C)=O)O)=O,,,5,1,2,0,2
25808_0,,,,2,2,1,3
25810_0,,,,2,2,1,3
C(C(C=CC=O)C(C)O)=O,,,5,1,2,0,2
25812_0,,,,2,2,1,3
C(C(C=CC=O)C(C=O)(CO)O)=O,,,5,1,2,0,2
25814_0,,,,2,2,1,3
C(C(C=CC=O)C(C(CO)=O)O)=O,,,5,1,1,0,1
25816_0,,,,2,2,1,3
C(C(C=CC=O)C(CC(C)O)O)=O,,,5,1,1,0,1
25818_0,,,,2,2,1,3
C(C(C=CC=O)C(CCO)O)=O,,,5,1,2,0,2
25819_0,,,,2,2,1,3
25821_0,,,,2,2,1,3
C(C(C=CC=O)C(C)(CO)O)=O,,,5,1,2,0,2
25823_0,,,,2,2,1,3
C(C(C=CC=O)C(C(O)=O)(C)O)=O,,,5,1,1,0,1
25825_0,,,,2,2,1,3
C(C(C=CC=O)C(CC(O)=O)O)=O,,,5,1,1,0,1
25827_0,,,,2,2,1,3
C(C(C=CC=O)C(C=O)(CC=O)O)=O,,,5,1,1,0,1
25829_0,,,,2,2,1,3
C(C(C=CC=O)C(C(CC=O)=O)O)=O,,,5,1,1,0,1
25830_0,,,,2,2,1,3
25832_0,,,,2,2,1,3
C(C(C=CC=O)C(C=O)(C(C)=O)O)=O,,,5,1,1,0,1
25834_0,,,,2,2,1,3
C(C(C=CC=O)C(C(C(C)=O)=O)O)=O,,,5,1,1,0,1
25836_0,,,,2,2,1,3
C(C(C=CC=O)C(C(C=O)=O)(C)O)=O,,,5,1,1,0,1
25838_0,,,,2,2,1,3
C(C(C=CC=O)C(C=O)(C=C)O)=O,,,5,1,1,0,1
25840_0,,,,2,2,1,3
C(C(C=CC=O)C(C(C=C)=O)O)=O,,,5,1,1,0,1
25842_0,,,,2,2,1,3
C(C(C=CC=O)C(C=CC=O)O)=O,,,5,1,1,0,1
25844_0,,,,2,2,1,3
C(C(C(O)=O)C=CC=O)=O,,,5,1,4,0,4
25846_0,,,,2,2,1,3
C(C(C=CC=O)C(C(O)O)O)=O,,,5,1,2,0,2
25848_0,,,,2,2,1,3
C(C(C=CC=O)C(C(C)O)O)=O,,,5,1,2,0,2
25850_0,,,,2,2,1,3
C(C(C=CC=O)CO)=O,,,5,1,4,0,4
25852_0,,,,2,2,1,3
C(C(C=CC=O)C(CO)O)=O,,,5,1,4,0,4
25853_0,,,,2,2,1,3
25855_0,,,,2,2,1,3
C(CC(C(C(C=CC=O)O)=O)O)=O,,,5,1,2,0,2
25857_0,,,,2,2,1,3
C(CC(C=CC(C(C=O)=O)O)O)=O,,,5,1,1,0,1
25859_0,,,,2,2,1,3
C(C(C=C)C(C(C=CC=O)O)O)=O,,,5,1,1,0,1
25861_0,,,,2,2,1,3
C(C(C(C1C(C=CO1)=O)O)O)=CC=O,,,5,1,2,0,2
25861_1,,,,2,2,1,3
25863_0,,,,2,2,1,3
C(C(C(CC(C=O)=O)O)O)=CC=O,,,5,1,1,0,1
25865_0,,,,2,2,1,3
C(C(C=O)C(C(C=CC=O)O)O)=O,,,5,1,2,0,2
25865_1,,,,2,2,1,3
25867_0,,,,2,2,1,3
C(CC(C(C=CC=O)O)O)=O,,,5,1,4,0,4
25869_0,,,,2,2,1,3
C(C(CO)C(C(C=CC=O)O)O)=O,,,5,1,2,0,2
25869_1,,,,2,2,1,3
25871_0,,,,2,2,1,3
C(C)(C(C(C(C=CC=O)O)O)O)=O,,,5,1,2,0,2
25871_1,,,,2,2,1,3
25873_0,,,,2,2,1,3
C(CO)(CC(C(C=CC=O)O)O)=O,,,5,1,1,0,1
25875_0,,,,2,2,1,3
C(C(C(C(C=CC=O)O)O)O)=O,,,5,1,9,0,9
25875_1,,,,2,2,1,3
25877_0,,,,2,2,1,3
C(C(C=C)C(C=CC(C=O)O)O)=O,,,5,1,1,0,1
25879_0,,,,2,2,1,3
C(C(C=CC(C1C(C=CO1)=O)O)O)=O,,,5,1,2,0,2
25879_1,,,,2,2,1,3
25881_0,,,,2,2,1,3
C(C(C=CC(CC(C=O)=O)O)O)=O,,,5,1,1,0,1
25883_0,,,,2,2,1,3
C(C(C=O)C(C=CC(C=O)O)O)=O,,,5,1,2,0,2
25883_1,,,,2,2,1,3
25885_0,,,,2,2,1,3
C(C(C=CC(CC=O)O)O)=O,,,5,1,4,0,4
25887_0,,,,2,2,1,3
C(C(CO)C(C=CC(C=O)O)O)=O,,,5,1,2,0,2
25887_1,,,,2,2,1,3
25889_0,,,,2,2,1,3
C(C(C=CC(C(C(C)=O)O)O)O)=O,,,5,1,2,0,2
25889_1,,,,2,2,1,3
25891_0,,,,2,2,1,3
C(C(C=CC(CC(CO)=O)O)O)=O,,,5,1,1,0,1
25893_0,,,,2,2,1,3
C(C(C=CC(C(C=O)O)O)O)=O,,,5,1,8,0,8
25893_1,,,,2,2,1,3
25895_0,,,,2,2,1,3
C(C(C=O)=CC(C(CO)CO)=O)=O,,,5,1,2,0,2
25895_1,,,,2,2,1,3
25897_0,,,,2,2,1,3
C(C(CO)C(C=C(C=O)C=O)O)=O,,,5,1,4,0,4
25897_1,,,,2,2,1,3
25899_0,,,,2,2,1,3
C(C(C=O)C=CC(C(CO)O)=O)=O,,,5,1,2,0,2
25899_1,,,,2,2,1,3
25901_0,,,,2,2,1,3
C(CO)(C(C=C(C=O)C=O)CO)=O,,,5,1,1,0,1
25903_0,,,,2,2,1,3
C(C(CO)O)(CC=C(C=O)C=O)=O,,,5,1,2,0,2
25903_1,,,,2,2,1,3
25905_0,,,,2,2,1,3
C(C(C(CO)=C(C=O)C=O)CO)=O,,,5,1,1,0,1
25907_0,,,,2,2,1,3
C(CCO)(C(C=C(C=O)C=O)O)=O,,,5,1,1,0,1
25909_0,,,,2,2,1,3
C(C(C=C)C(C(C=O)C=C)O)=O,,,5,1,1,0,1
25911_0,,,,2,2,1,3
C(C(C=C)C(C1C(C=CO1)=O)O)=O,,,5,1,2,0,2
25911_1,,,,2,2,1,3
25913_0,,,,2,2,1,3
C(C(C=C)C(C(C(CO)=O)O)O)=O,,,5,1,3,0,3
25913_1,,,,2,2,1,3
25915_0,,,,2,2,1,3
C(C(C=C)C(CC(C=O)=O)O)=O,,,5,1,3,0,3
25916_0,,,,2,2,1,3
25916_1,,,,2,2,1,3
25918_0,,,,2,2,1,3
C(C(C=C)C(CC=O)O)=O,,,5,1,3,0,3
25920_0,,,,2,2,1,3
C(C(C=C)C(C(C(C=O)=O)O)O)=O,,,5,1,3,0,3
25920_1,,,,2,2,1,3
25922_0,,,,2,2,1,3
C(C(C=C)C(C(C=O)C(C)O)O)=O,,,5,1,3,0,3
25922_1,,,,2,2,1,3
25924_0,,,,2,2,1,3
C(C(C=C)C(C(C=O)CO)O)=O,,,5,1,4,0,4
25924_1,,,,2,2,1,3
25926_0,,,,2,2,1,3
C(C(C=C)C(C(C(C)=O)O)O)=O,,,5,1,4,0,4
25926_1,,,,2,2,1,3
25928_0,,,,2,2,1,3
C(C(C=C)C(CC(CO)=O)O)=O,,,5,1,3,0,3
25930_0,,,,2,2,1,3
C(C(C=C)C(CC(C(O)=O)=O)O)=O,,,5,1,2,0,2
25931_0,,,,2,2,1,3
25931_1,,,,2,2,1,3
25932_0,,,,2,2,1,3
25932_1,,,,2,2,1,3
25933_0,,,,2,2,1,3
25935_0,,,,2,2,1,3
C(C(C=C)C(C(C=O)O)O)=O,,,5,1,4,0,4
25935_1,,,,2,2,1,3
25937_0,,,,2,2,1,3
C(C(C=C)C(C(C=O)=CC)O)=O,,,5,1,1,0,1
25939_0,,,,2,2,1,3
C1OC(C(C=1)=O)C(C(C=O)=CC)O,,,5,1,2,0,2
25939_1,,,,2,2,1,3
25941_0,,,,2,2,1,3
C(CO)(C(C(C(C=O)=CC)O)O)=O,,,5,1,2,0,2
25941_1,,,,2,2,1,3
25943_0,,,,2,2,1,3
C(C)=C(C=O)C(CC(C=O)=O)O,,,5,1,2,0,2
25945_0,,,,2,2,1,3
C(C(C=O)C(C(C=O)=CC)O)=O,,,5,1,3,0,3
25945_1,,,,2,2,1,3
25947_0,,,,2,2,1,3
C(CC(C(C=O)=CC)O)=O,,,5,1,2,0,2
25949_0,,,,2,2,1,3
C(C)=C(C=O)C(C(C(C=O)=O)O)O,,,5,1,2,0,2
25949_1,,,,2,2,1,3
25951_0,,,,2,2,1,3
C(C(C(C)O)C(C(C=O)=CC)O)=O,,,5,1,2,0,2
25951_1,,,,2,2,1,3
25953_0,,,,2,2,1,3
C(C(CO)C(C(C=O)=CC)O)=O,,,5,1,3,0,3
25953_1,,,,2,2,1,3
25955_0,,,,2,2,1,3
C(C)(C(C(C(C=O)=CC)O)O)=O,,,5,1,3,0,3
25955_1,,,,2,2,1,3
25957_0,,,,2,2,1,3
C(CO)(CC(C(C=O)=CC)O)=O,,,5,1,2,0,2
25959_0,,,,2,2,1,3
C(C)=C(C=O)C(CC(C(O)=O)=O)O,,,5,1,1,0,1
25961_0,,,,2,2,1,3
C(C(C=O)C(C(C=O)=CC)O)(O)=O,,,5,1,2,0,2
25961_1,,,,2,2,1,3
25963_0,,,,2,2,1,3
C(C(C(C=O)=O)C(C(C=O)=CC)O)=O,,,5,1,2,0,2
25963_1,,,,2,2,1,3
25965_0,,,,2,2,1,3
C(C)=C(C=O)C(CC(C(C=O)=O)=O)O,,,5,1,1,0,1
25967_0,,,,2,2,1,3
C(C(C(C(C=O)=CC)O)O)=O,,,5,1,3,0,3
25967_1,,,,2,2,1,3
25969_0,,,,2,2,1,3
C(CC(C(CO)=C(C=O)C=O)O)=O,,,5,1,1,0,1
25971_0,,,,2,2,1,3
C(CC(C(C=O)=C(C=O)CO)O)=O,,,5,1,1,0,1
25973_0,,,,2,2,1,3
C(CC(C=C(C=O)C=O)(CO)O)=O,,,5,1,1,0,1
25975_0,,,,2,2,1,3
C(CC(C(C=O)=CC(CO)=O)O)=O,,,5,1,1,0,1
25977_0,,,,2,2,1,3
C=CC(C(C(C=C(C=O)C=O)=O)O)O,,,5,1,2,0,2
25977_1,,,,2,2,1,3
25979_0,,,,2,2,1,3
C(C(C=O)=CC(C(C(C)O)O)=O)=O,,,5,1,2,0,2
25979_1,,,,2,2,1,3
25981_0,,,,2,2,1,3
C(C(C(C=C(C=O)C=O)=O)O)(O)=O,,,5,1,2,0,2
25981_1,,,,2,2,1,3
25982_0,,,,2,2,1,3
25982_1,,,,2,2,1,3
25984_0,,,,2,2,1,3
C(CC(C(C=O)=CC(CO)O)O)=O,,,5,1,1,0,1
25986_0,,,,2,2,1,3
C(C(C=C)C(C=C(C=O)C=O)O)=O,,,5,1,1,0,1
25988_0,,,,2,2,1,3
C1OC(C(C=1)=O)C(C=C(C=O)C=O)O,,,5,1,2,0,2
25988_1,,,,2,2,1,3
25990_0,,,,2,2,1,3
C(C(CC(C=O)=O)O)=C(C=O)C=O,,,5,1,1,0,1
25992_0,,,,2,2,1,3
C(C(C=O)C(C=C(C=O)C=O)O)=O,,,5,1,2,0,2
25992_1,,,,2,2,1,3
25993_0,,,,2,2,1,3
25994_0,,,,2,2,1,3
25994_1,,,,2,2,1,3
25996_0,,,,2,2,1,3
C(C)(C(C(C=C(C=O)C=O)O)O)=O,,,5,1,2,0,2
25996_1,,,,2,2,1,3
25998_0,,,,2,2,1,3
C(CO)(CC(C=C(C=O)C=O)O)=O,,,5,1,1,0,1
25999_0,,,,2,2,1,3
25999_1,,,,2,2,1,3
26001_0,,,,2,2,1,3
C(C(C=C)C(C(C=O)=CC=O)O)=O,,,5,1,1,0,1
26003_0,,,,2,2,1,3
C1OC(C(C=1)=O)C(C(C=O)=CC=O)O,,,5,1,2,0,2
26003_1,,,,2,2,1,3
26005_0,,,,2,2,1,3
C(C(C(CC(C=O)=O)O)=CC=O)=O,,,5,1,1,0,1
26007_0,,,,2,2,1,3
C(C(C=O)C(C(C=O)=CC=O)O)=O,,,5,1,2,0,2
26007_1,,,,2,2,1,3
26008_0,,,,2,2,1,3
26009_0,,,,2,2,1,3
26009_1,,,,2,2,1,3
26011_0,,,,2,2,1,3
C(C)(C(C(C(C=O)=CC=O)O)O)=O,,,5,1,2,0,2
26011_1,,,,2,2,1,3
26013_0,,,,2,2,1,3
C(CO)(CC(C(C=O)=CC=O)O)=O,,,5,1,1,0,1
26015_0,,,,2,2,1,3
C(C(C(C(C=O)=CC=O)O)O)=O,,,5,1,5,0,5
26015_1,,,,2,2,1,3
26017_0,,,,2,2,1,3
C=C(C=O)C(C(C(C(C=O)=C)O)O)=O,,,5,1,2,0,2
26017_1,,,,2,2,1,3
26019_0,,,,2,2,1,3
C(C(C=C)C(C(C=O)=C)O)=O,,,5,1,1,0,1
26021_0,,,,2,2,1,3
C=C(C=O)C(C(C(C=CC=O)=O)O)O,,,5,1,2,0,2
26021_1,,,,2,2,1,3
26023_0,,,,2,2,1,3
C=C(C=O)C(C1C(C=CO1)=O)O,,,5,1,2,0,2
26023_1,,,,2,2,1,3
26025_0,,,,2,2,1,3
C(CO)(C(C(C(C=O)=C)O)O)=O,,,5,1,5,0,5
26025_1,,,,2,2,1,3
26027_0,,,,2,2,1,3
C=C(C=O)C(CC(C=O)=O)O,,,5,1,3,0,3
26029_0,,,,2,2,1,3
C(C(C=O)C(C(C=O)=C)O)=O,,,5,1,3,0,3
26029_1,,,,2,2,1,3
26031_0,,,,2,2,1,3
C=C(C=O)C(C(C(C=O)=O)CO)O,,,5,1,2,0,2
26031_1,,,,2,2,1,3
26033_0,,,,2,2,1,3
C(C(C(C=O)C(C(C=O)=C)O)O)=O,,,5,1,2,0,2
26033_1,,,,2,2,1,3
26035_0,,,,2,2,1,3
C(C(C(CO)=O)C(C(C=O)=C)O)=O,,,5,1,2,0,2
26035_1,,,,2,2,1,3
26037_0,,,,2,2,1,3
C(CC(C(C(C(C=O)=C)O)O)=O)=O,,,5,1,2,0,2
26037_1,,,,2,2,1,3
26039_0,,,,2,2,1,3
C(C(C(CC(C(C=O)=C)O)=O)O)=O,,,5,1,1,0,1
26041_0,,,,2,2,1,3
C(CC(C(C=O)=C)O)=O,,,5,1,4,0,4
26043_0,,,,2,2,1,3
C=C(C=O)C(C(C(C=O)=O)O)O,,,5,1,4,0,4
26043_1,,,,2,2,1,3
26045_0,,,,2,2,1,3
C(C(C(C)O)C(C(C=O)=C)O)=O,,,5,1,4,0,4
26045_1,,,,2,2,1,3
26047_0,,,,2,2,1,3
C(C(CO)C(C(C=O)=C)O)=O,,,5,1,4,0,4
26047_1,,,,2,2,1,3
26049_0,,,,2,2,1,3
C(C(C(CO)O)C(C(C=O)=C)O)=O,,,5,1,2,0,2
26049_1,,,,2,2,1,3
26051_0,,,,2,2,1,3
C=C(C=O)C(C(C(C(C)=O)=O)O)O,,,5,1,2,0,2
26051_1,,,,2,2,1,3
26053_0,,,,2,2,1,3
C=C(C=O)C(CC(C(CO)=O)=O)O,,,5,1,1,0,1
26055_0,,,,2,2,1,3
C(C)(C(C(C(C=O)=C)O)O)=O,,,5,1,4,0,4
26055_1,,,,2,2,1,3
26057_0,,,,2,2,1,3
C(CO)(CC(C(C=O)=C)O)=O,,,5,1,3,0,3
26059_0,,,,2,2,1,3
C(C(C(C(C=O)=C)O)O)(CCO)=O,,,5,1,2,0,2
26059_1,,,,2,2,1,3
26061_0,,,,2,2,1,3
C(CO)(C(CO)C(C(C=O)=C)O)=O,,,5,1,2,0,2
26061_1,,,,2,2,1,3
26063_0,,,,2,2,1,3
C(CC(C(C=O)=C)O)(C(CO)O)=O,,,5,1,1,0,1
26065_0,,,,2,2,1,3
C=C(C=O)C(CC(C(O)=O)=O)O,,,5,1,3,0,3
26067_0,,,,2,2,1,3
C(C(C=O)C(C(C=O)=C)O)(O)=O,,,5,1,3,0,3
26067_1,,,,2,2,1,3
26069_0,,,,2,2,1,3
C=C(C=O)C(C(C(C(O)=O)=O)O)O,,,5,1,2,0,2
26069_1,,,,2,2,1,3
26071_0,,,,2,2,1,3
C(C(C(C=O)=O)C(C(C=O)=C)O)=O,,,5,1,2,0,2
26071_1,,,,2,2,1,3
26073_0,,,,2,2,1,3
C1(C(C(C(C=O)=C)O)OCC1O)=O,,,5,1,2,0,2
26073_1,,,,2,2,1,3
26075_0,,,,2,2,1,3
C1(C(O)OCC1C(C(C=O)=C)O)=O,,,5,1,2,0,2
26075_1,,,,2,2,1,3
26077_0,,,,2,2,1,3
C1(COC(C1C(C(C=O)=C)O)O)=O,,,5,1,2,0,2
26077_1,,,,2,2,1,3
26079_0,,,,2,2,1,3
C1(C(C(C(C=O)=C)O)OC(C1)O)=O,,,5,1,2,0,2
26079_1,,,,2,2,1,3
26081_0,,,,2,2,1,3
C=C(C=O)C(CC(C(C=O)=O)=O)O,,,5,1,1,0,1
26083_0,,,,2,2,1,3
C(C(C(C(C=O)=C)O)O)=O,,,5,1,7,0,7
26083_1,,,,2,2,1,3
26085_0,,,,2,2,1,3
C(C(C=C)C(C(C=O)=CCO)O)=O,,,5,1,1,0,1
26087_0,,,,2,2,1,3
C1OC(C(C=1)=O)C(C(C=O)=CCO)O,,,5,1,2,0,2
26087_1,,,,2,2,1,3
26089_0,,,,2,2,1,3
C(CO)=C(C=O)C(CC(C=O)=O)O,,,5,1,1,0,1
26091_0,,,,2,2,1,3
C(C(C=O)C(C(C=O)=CCO)O)=O,,,5,1,2,0,2
26091_1,,,,2,2,1,3
26093_0,,,,2,2,1,3
C(CC(C(C=O)=CCO)O)=O,,,5,1,4,0,4
26095_0,,,,2,2,1,3
C(C(CO)C(C(C=O)=CCO)O)=O,,,5,1,2,0,2
26095_1,,,,2,2,1,3
26097_0,,,,2,2,1,3
C(C)(C(C(C(C=O)=CCO)O)O)=O,,,5,1,2,0,2
26097_1,,,,2,2,1,3
26099_0,,,,2,2,1,3
C(CO)(CC(C(C=O)=CCO)O)=O,,,5,1,1,0,1
26101_0,,,,2,2,1,3
C(C(C(C(C=O)=CCO)O)O)=O,,,5,1,7,0,7
26101_1,,,,2,2,1,3
26103_0,,,,2,2,1,3
C(C(C=C)C(C=C(C=O)CCO)O)=O,,,5,1,1,0,1
26105_0,,,,2,2,1,3
C(CC(C=C(C=O)CCO)O)=O,,,5,1,2,0,2
26107_0,,,,2,2,1,3
C(C(C(C=C(C=O)CCO)O)O)=O,,,5,1,2,0,2
26107_1,,,,2,2,1,3
26109_0,,,,2,2,1,3
C(C(C=C)C(C(CCO)=CC=O)O)=O,,,5,1,1,0,1
26111_0,,,,2,2,1,3
C(CC(C(CCO)=CC=O)O)=O,,,5,1,2,0,2
26113_0,,,,2,2,1,3
C(C(C(C(CCO)=CC=O)O)O)=O,,,5,1,2,0,2
26113_1,,,,2,2,1,3
26115_0,,,,2,2,1,3
C(C(C=C)C(CC(C=O)=CCO)O)=O,,,5,1,1,0,1
26117_0,,,,2,2,1,3
C(CC(CC(C=O)=CCO)O)=O,,,5,1,2,0,2
26119_0,,,,2,2,1,3
C(C(C(CC(C=O)=CCO)O)O)=O,,,5,1,2,0,2
26119_1,,,,2,2,1,3
26121_0,,,,2,2,1,3
C(C(C=C)C(C(CC=O)=CCO)O)=O,,,5,1,1,0,1
26123_0,,,,2,2,1,3
C(CC(C(CC=O)O)=CCO)=O,,,5,1,2,0,2
26125_0,,,,2,2,1,3
C(CC(C(C(C=O)O)O)=CCO)=O,,,5,1,2,0,2
26125_1,,,,2,2,1,3
26127_0,,,,2,2,1,3
C(C(C(C=O)=CCO)C(C=CC)O)=O,,,5,1,1,0,1
26129_0,,,,2,2,1,3
C(C(C(C=O)=CCO)C(CC=C)O)=O,,,5,1,1,0,1
26131_0,,,,2,2,1,3
C(C(C(C=O)=CCO)C(C=C)O)=O,,,5,1,1,0,1
26133_0,,,,2,2,1,3
C(C(C(C=O)=CCO)C(C=O)O)=O,,,5,1,1,0,1
26135_0,,,,2,2,1,3
C(C(C(C=O)=CCO)C(C)O)=O,,,5,1,2,0,2
26137_0,,,,2,2,1,3
C(C(C=O)C(C=O)=CCO)(O)=O,,,5,1,3,0,3
26139_0,,,,2,2,1,3
C(C(C(C=O)=CCO)CO)=O,,,5,1,3,0,3
26141_0,,,,2,2,1,3
C(C(C(C=O)=CCO)C(CO)O)=O,,,5,1,1,0,1
26143_0,,,,2,2,1,3
C(CC(C(C(C=O)=CCO)O)O)=O,,,5,1,1,0,1
26145_0,,,,2,2,1,3
C(C(C(C(CC=O)O)=CCO)O)=O,,,5,1,1,0,1
26147_0,,,,2,2,1,3
C(C(C=C)C(C=CC(CCO)=O)O)=O,,,5,1,1,0,1
26149_0,,,,2,2,1,3
C(CC(C=CC(CCO)=O)O)=O,,,5,1,2,0,2
26151_0,,,,2,2,1,3
C(C(C(C=CC(CCO)=O)O)O)=O,,,5,1,2,0,2
26151_1,,,,2,2,1,3
26153_0,,,,2,2,1,3
C(C(C=C)C(C=CC=O)(CCO)O)=O,,,5,1,1,0,1
26155_0,,,,2,2,1,3
C(CC(C=CC=O)(CCO)O)=O,,,5,1,2,0,2
26157_0,,,,2,2,1,3
C(C(C(C=CC=O)(CCO)O)O)=O,,,5,1,2,0,2
26157_1,,,,2,2,1,3
26159_0,,,,2,2,1,3
C(C)=CC(C(C(C=CC=O)=O)CO)O,,,5,1,2,0,2
26159_1,,,,2,2,1,3
26161_0,,,,2,2,1,3
C=CCC(C(C(C=CC=O)=O)CO)O,,,5,1,2,0,2
26161_1,,,,2,2,1,3
26163_0,,,,2,2,1,3
C=CC(C(C(C=CC=O)=O)CO)O,,,5,1,2,0,2
26163_1,,,,2,2,1,3
26165_0,,,,2,2,1,3
C(C(C(C(C=CC=O)=O)CO)O)=O,,,5,1,2,0,2
26165_1,,,,2,2,1,3
26167_0,,,,2,2,1,3
C(C=CC(C(CO)C(C)O)=O)=O,,,5,1,3,0,3
26167_1,,,,2,2,1,3
26169_0,,,,2,2,1,3
C(C(C(C=CC=O)=O)CO)(O)=O,,,5,1,4,0,4
26169_1,,,,2,2,1,3
26171_0,,,,2,2,1,3
C(C=CC(C(CO)CO)=O)=O,,,5,1,3,0,3
26171_1,,,,2,2,1,3
26173_0,,,,2,2,1,3
C(C=CC(C(CO)C(CO)O)=O)=O,,,5,1,2,0,2
26173_1,,,,2,2,1,3
26175_0,,,,2,2,1,3
C(C(C=C)C(C=O)(C(C=C)CO)O)=O,,,5,1,1,0,1
26177_0,,,,2,2,1,3
C(CC(C=O)(C(C=C)CO)O)=O,,,5,1,2,0,2
26179_0,,,,2,2,1,3
C(C(C(C=O)(C(C=C)CO)O)O)=O,,,5,1,2,0,2
26179_1,,,,2,2,1,3
26181_0,,,,2,2,1,3
C(C(C=C)C(C(C(C=C)CO)=O)O)=O,,,5,1,1,0,1
26183_0,,,,2,2,1,3
C(CC(C(C(C=C)CO)=O)O)=O,,,5,1,2,0,2
26185_0,,,,2,2,1,3
C(C(C(C(C(C=C)CO)=O)O)O)=O,,,5,1,2,0,2
26185_1,,,,2,2,1,3
26187_0,,,,2,2,1,3
C(C(C=C)C(C=O)(C(CO)=CC)O)=O,,,5,1,1,0,1
26189_0,,,,2,2,1,3
C(C(C(CO)=CC)(CC=O)O)=O,,,5,1,2,0,2
26191_0,,,,2,2,1,3
C(C(C(CO)=CC)(C(C=O)O)O)=O,,,5,1,2,0,2
26191_1,,,,2,2,1,3
26193_0,,,,2,2,1,3
C(C(C=C)C(C(C(CO)=CC)=O)O)=O,,,5,1,1,0,1
26195_0,,,,2,2,1,3
C(CC(C(C(CO)=CC)=O)O)=O,,,5,1,2,0,2
26197_0,,,,2,2,1,3
C(C(C(C(C(CO)=CC)=O)O)O)=O,,,5,1,2,0,2
26197_1,,,,2,2,1,3
26199_0,,,,2,2,1,3
C(C(C=C)C(C=O)(C(C(C)O)=C)O)=O,,,5,1,1,0,1
26201_0,,,,2,2,1,3
C(C(C(C(C)O)=C)(CC=O)O)=O,,,5,1,2,0,2
26203_0,,,,2,2,1,3
C(C(C(C(C)O)=C)(C(C=O)O)O)=O,,,5,1,2,0,2
26203_1,,,,2,2,1,3
26205_0,,,,2,2,1,3
C(C(C=C)C(C(C(C(C)O)=C)=O)O)=O,,,5,1,1,0,1
26207_0,,,,2,2,1,3
C(CC(C(C(C(C)O)=C)=O)O)=O,,,5,1,2,0,2
26209_0,,,,2,2,1,3
C(C(C(C(C(C(C)O)=C)=O)O)O)=O,,,5,1,2,0,2
26209_1,,,,2,2,1,3
26211_0,,,,2,2,1,3
C(CC(C=C(C(C=O)=O)CO)O)=O,,,5,1,1,0,1
26213_0,,,,2,2,1,3
C(C(C(CO)=CC=O)(CC=O)O)=O,,,5,1,1,0,1
26215_0,,,,2,2,1,3
C(CC(C(C(CO)=CC=O)=O)O)=O,,,5,1,1,0,1
26217_0,,,,2,2,1,3
C(CC(C(C(C(C=O)=O)=C)O)O)=O,,,5,1,1,0,1
26219_0,,,,2,2,1,3
C(C(C(C(C=O)O)=C)(CC=O)O)=O,,,5,1,1,0,1
26221_0,,,,2,2,1,3
C(C(C(C(C(CC=O)O)=O)=C)O)=O,,,5,1,1,0,1
26223_0,,,,2,2,1,3
C(C(C=C)C(C=O)(C(CO)=C)O)=O,,,5,1,1,0,1
26225_0,,,,2,2,1,3
C(C(C(CO)=C)(C1C(C=CO1)=O)O)=O,,,5,1,2,0,2
26225_1,,,,2,2,1,3
26227_0,,,,2,2,1,3
C(C(C(CO)=C)(CC(C=O)=O)O)=O,,,5,1,1,0,1
26229_0,,,,2,2,1,3
C(C(C=O)C(C=O)(C(CO)=C)O)=O,,,5,1,2,0,2
26229_1,,,,2,2,1,3
26231_0,,,,2,2,1,3
C(C(C(CO)=C)(CC=O)O)=O,,,5,1,4,0,4
26233_0,,,,2,2,1,3
C(C(CO)C(C=O)(C(CO)=C)O)=O,,,5,1,2,0,2
26233_1,,,,2,2,1,3
26235_0,,,,2,2,1,3
C(C(C(CO)=C)(C(C(C)=O)O)O)=O,,,5,1,2,0,2
26235_1,,,,2,2,1,3
26237_0,,,,2,2,1,3
C(C(C(CO)=C)(CC(CO)=O)O)=O,,,5,1,1,0,1
26239_0,,,,2,2,1,3
C(C(C(CO)=C)(C(C=O)O)O)=O,,,5,1,5,0,5
26239_1,,,,2,2,1,3
26241_0,,,,2,2,1,3
C(C(C=C)C(C(C(CO)=C)=O)O)=O,,,5,1,1,0,1
26243_0,,,,2,2,1,3
C=C(C(C(C1C(C=CO1)=O)O)=O)CO,,,5,1,2,0,2
26243_1,,,,2,2,1,3
26245_0,,,,2,2,1,3
C=C(C(C(CC(C=O)=O)O)=O)CO,,,5,1,1,0,1
26247_0,,,,2,2,1,3
C(C(C=O)C(C(C(CO)=C)=O)O)=O,,,5,1,2,0,2
26247_1,,,,2,2,1,3
26249_0,,,,2,2,1,3
C(CC(C(C(CO)=C)=O)O)=O,,,5,1,2,0,2
26251_0,,,,2,2,1,3
C(C(CO)C(C(C(CO)=C)=O)O)=O,,,5,1,2,0,2
26251_1,,,,2,2,1,3
26253_0,,,,2,2,1,3
C(C)(C(C(C(C(CO)=C)=O)O)O)=O,,,5,1,2,0,2
26253_1,,,,2,2,1,3
26255_0,,,,2,2,1,3
C(CO)(CC(C(C(CO)=C)=O)O)=O,,,5,1,1,0,1
26257_0,,,,2,2,1,3
C(C(C(C(C(CO)=C)=O)O)O)=O,,,5,1,3,0,3
26257_1,,,,2,2,1,3
26259_0,,,,2,2,1,3
C(C(C(CO)=CCO)(CC=O)O)=O,,,5,1,1,0,1
26261_0,,,,2,2,1,3
C(CC(C(C(CO)=CCO)=O)O)=O,,,5,1,1,0,1
26263_0,,,,2,2,1,3
C(C(C(C(CO)O)=C)(CC=O)O)=O,,,5,1,1,0,1
26265_0,,,,2,2,1,3
C(CC(C(C(C(CO)O)=C)=O)O)=O,,,5,1,1,0,1
26267_0,,,,2,2,1,3
C(C(C=C)C(C=CCC(C=O)O)O)=O,,,5,1,1,0,1
26269_0,,,,2,2,1,3
C(CC(C=CCC(C=O)O)O)=O,,,5,1,2,0,2
26271_0,,,,2,2,1,3
C(C(C(C=CCC(C=O)O)O)O)=O,,,5,1,2,0,2
26271_1,,,,2,2,1,3
26273_0,,,,2,2,1,3
C(C(C=C)C(C(CC=CC=O)O)O)=O,,,5,1,1,0,1
26275_0,,,,2,2,1,3
C(CC(C(CC=CC=O)O)O)=O,,,5,1,2,0,2
26277_0,,,,2,2,1,3
C(C(C(C(CC=CC=O)O)O)O)=O,,,5,1,2,0,2
26277_1,,,,2,2,1,3
26279_0,,,,2,2,1,3
C(C(C=C)C(CC=CC(C=O)O)O)=O,,,5,1,1,0,1
26281_0,,,,2,2,1,3
C(C(C=CCC(CC=O)O)O)=O,,,5,1,2,0,2
26283_0,,,,2,2,1,3
C(C(C=CCC(C(C=O)O)O)O)=O,,,5,1,2,0,2
26283_1,,,,2,2,1,3
26285_0,,,,2,2,1,3
C(C(C=C)C(C(C=CCC=O)O)O)=O,,,5,1,1,0,1
26287_0,,,,2,2,1,3
C(CC(C(C=CCC=O)O)O)=O,,,5,1,2,0,2
26289_0,,,,2,2,1,3
C(CC=CC(C(C(C=O)O)O)O)=O,,,5,1,2,0,2
26289_1,,,,2,2,1,3
26291_0,,,,2,2,1,3
C(C(C=CC(C=O)O)C(C=CC)O)=O,,,5,1,1,0,1
26293_0,,,,2,2,1,3
C(C(C=CC(C=O)O)C(CC=C)O)=O,,,5,1,1,0,1
26295_0,,,,2,2,1,3
C(C(C=CC(C=O)O)C(C=C)O)=O,,,5,1,1,0,1
26297_0,,,,2,2,1,3
C(C(C=CC(C=O)O)C(C=O)O)=O,,,5,1,1,0,1
26299_0,,,,2,2,1,3
C(C(C=CC(C=O)O)C(C)O)=O,,,5,1,2,0,2
26301_0,,,,2,2,1,3
C(C(C=O)C=CC(C=O)O)(O)=O,,,5,1,3,0,3
26303_0,,,,2,2,1,3
C(C(C=CC(C=O)O)CO)=O,,,5,1,3,0,3
26305_0,,,,2,2,1,3
C(C(C=CC(C=O)O)C(CO)O)=O,,,5,1,1,0,1
26307_0,,,,2,2,1,3
C(CC(C(C=CC(C=O)O)O)O)=O,,,5,1,1,0,1
26309_0,,,,2,2,1,3
C(C(C=C)C(C(C(C=O)C=C)O)O)=O,,,5,1,1,0,1
26311_0,,,,2,2,1,3
C(C(C=C)C(C(CC=O)O)O)=O,,,5,1,3,0,3
26313_0,,,,2,2,1,3
C(C(C=C)C(C(C(C=O)O)O)O)=O,,,5,1,3,0,3
26313_1,,,,2,2,1,3
26315_0,,,,2,2,1,3
C(C(C=C)C(C(C=C)C(C=O)O)O)=O,,,5,1,1,0,1
26317_0,,,,2,2,1,3
C(CC(C(C=C)C(C=O)O)O)=O,,,5,1,2,0,2
26319_0,,,,2,2,1,3
C(C(C(C(C=C)C(C=O)O)O)O)=O,,,5,1,2,0,2
26319_1,,,,2,2,1,3
26321_0,,,,2,2,1,3
C(C(C=C)C(C(C(C=O)=CC)O)O)=O,,,5,1,1,0,1
26323_0,,,,2,2,1,3
C(CC(C(C(C=O)=CC)O)O)=O,,,5,1,2,0,2
26325_0,,,,2,2,1,3
C(C(C(C(C(C=O)=CC)O)O)O)=O,,,5,1,2,0,2
26325_1,,,,2,2,1,3
26327_0,,,,2,2,1,3
C(C(C=C)C(C(C(C=O)O)=CC)O)=O,,,5,1,1,0,1
26329_0,,,,2,2,1,3
C(C(C(C(CC=O)O)=CC)O)=O,,,5,1,2,0,2
26331_0,,,,2,2,1,3
C(C(C(C(C(C=O)O)O)=CC)O)=O,,,5,1,2,0,2
26331_1,,,,2,2,1,3
26333_0,,,,2,2,1,3
C(C(C=C)C(C=C(C=O)C(C)O)O)=O,,,5,1,1,0,1
26335_0,,,,2,2,1,3
C(CC(C=C(C=O)C(C)O)O)=O,,,5,1,3,0,3
26337_0,,,,2,2,1,3
C(C(C(C=C(C=O)C(C)O)O)O)=O,,,5,1,2,0,2
26337_1,,,,2,2,1,3
26339_0,,,,2,2,1,3
C(C(C=C)C(C(C(C)O)=CC=O)O)=O,,,5,1,1,0,1
26341_0,,,,2,2,1,3
C(CC(C(C(C)O)=CC=O)O)=O,,,5,1,3,0,3
26343_0,,,,2,2,1,3
C(C(C(C(C(C)O)=CC=O)O)O)=O,,,5,1,2,0,2
26343_1,,,,2,2,1,3
26345_0,,,,2,2,1,3
C(C(C(C=O)=CC(CC=O)O)O)=O,,,5,1,1,0,1
26347_0,,,,2,2,1,3
C(CC(C(C(C=O)=CC=O)O)O)=O,,,5,1,1,0,1
26349_0,,,,2,2,1,3
C(C(C(C(CC=O)O)=CC=O)O)=O,,,5,1,1,0,1
26351_0,,,,2,2,1,3
C(C(C=C)C(C=C(C=O)CO)O)=O,,,5,1,1,0,1
26353_0,,,,2,2,1,3
C1OC(C(C=1)=O)C(C=C(C=O)CO)O,,,5,1,2,0,2
26353_1,,,,2,2,1,3
26355_0,,,,2,2,1,3
C(C(CC(C=O)=O)O)=C(C=O)CO,,,5,1,1,0,1
26357_0,,,,2,2,1,3
C(C(C=O)C(C=C(C=O)CO)O)=O,,,5,1,2,0,2
26357_1,,,,2,2,1,3
26359_0,,,,2,2,1,3
C(CC(C=C(C=O)CO)O)=O,,,5,1,4,0,4
26361_0,,,,2,2,1,3
C(C(CO)C(C=C(C=O)CO)O)=O,,,5,1,2,0,2
26361_1,,,,2,2,1,3
26363_0,,,,2,2,1,3
C(C)(C(C(C=C(C=O)CO)O)O)=O,,,5,1,2,0,2
26363_1,,,,2,2,1,3
26365_0,,,,2,2,1,3
C(CO)(CC(C=C(C=O)CO)O)=O,,,5,1,1,0,1
26367_0,,,,2,2,1,3
C(C(C(C=C(C=O)CO)O)O)=O,,,5,1,5,0,5
26367_1,,,,2,2,1,3
26369_0,,,,2,2,1,3
C(C(C=C)C(C(CO)=CC=O)O)=O,,,5,1,1,0,1
26371_0,,,,2,2,1,3
C1OC(C(C=1)=O)C(C(CO)=CC=O)O,,,5,1,2,0,2
26371_1,,,,2,2,1,3
26373_0,,,,2,2,1,3
C(CO)(C(CC(C=O)=O)O)=CC=O,,,5,1,1,0,1
26375_0,,,,2,2,1,3
C(C(C=O)C(C(CO)=CC=O)O)=O,,,5,1,2,0,2
26375_1,,,,2,2,1,3
26377_0,,,,2,2,1,3
C(CC(C(CO)=CC=O)O)=O,,,5,1,4,0,4
26379_0,,,,2,2,1,3
C(C(CO)C(C(CO)=CC=O)O)=O,,,5,1,2,0,2
26379_1,,,,2,2,1,3
26381_0,,,,2,2,1,3
C(C)(C(C(C(CO)=CC=O)O)O)=O,,,5,1,2,0,2
26381_1,,,,2,2,1,3
26383_0,,,,2,2,1,3
C(CO)(CC(C(CO)=CC=O)O)=O,,,5,1,1,0,1
26385_0,,,,2,2,1,3
C(C(C(C(CO)=CC=O)O)O)=O,,,5,1,7,0,7
26385_1,,,,2,2,1,3
26387_0,,,,2,2,1,3
C(CC(C=C(C=O)C(CO)O)O)=O,,,5,1,1,0,1
26389_0,,,,2,2,1,3
C(CC(C(C(CO)O)=CC=O)O)=O,,,5,1,1,0,1
26391_0,,,,2,2,1,3
C(C(C=C)C(C=CCC(CO)=O)O)=O,,,5,1,1,0,1
26393_0,,,,2,2,1,3
C(CC(C=CCC(CO)=O)O)=O,,,5,1,2,0,2
26395_0,,,,2,2,1,3
C(C(C(C=CCC(CO)=O)O)O)=O,,,5,1,2,0,2
26395_1,,,,2,2,1,3
26397_0,,,,2,2,1,3
C(C(C=C)C(CO)(CC=CC=O)O)=O,,,5,1,1,0,1
26399_0,,,,2,2,1,3
C(CC(CO)(CC=CC=O)O)=O,,,5,1,2,0,2
26401_0,,,,2,2,1,3
C(C(C(CO)(CC=CC=O)O)O)=O,,,5,1,2,0,2
26401_1,,,,2,2,1,3
26403_0,,,,2,2,1,3
C(CO)(C(C=CC=O)C(C=CC)O)=O,,,5,1,1,0,1
26405_0,,,,2,2,1,3
C(CO)(C(C=CC=O)C(CC=C)O)=O,,,5,1,1,0,1
26407_0,,,,2,2,1,3
C(CO)(C(C=CC=O)C(C=C)O)=O,,,5,1,1,0,1
26409_0,,,,2,2,1,3
C(C(C(C(CO)=O)C=CC=O)O)=O,,,5,1,1,0,1
26411_0,,,,2,2,1,3
C(CO)(C(C=CC=O)C(C)O)=O,,,5,1,2,0,2
26413_0,,,,2,2,1,3
C(C(C(CO)=O)C=CC=O)(O)=O,,,5,1,3,0,3
26415_0,,,,2,2,1,3
C(CO)(C(C=CC=O)CO)=O,,,5,1,5,0,5
26417_0,,,,2,2,1,3
C(CO)(C(C=CC=O)C(CO)O)=O,,,5,1,1,0,1
26419_0,,,,2,2,1,3
C(C(C(C=CC)O)O)(CC=CC=O)=O,,,5,1,2,0,2
26419_1,,,,2,2,1,3
26421_0,,,,2,2,1,3
C(C(C(CC=C)O)O)(CC=CC=O)=O,,,5,1,2,0,2
26421_1,,,,2,2,1,3
26423_0,,,,2,2,1,3
C(C(C(C=C)O)O)(CC=CC=O)=O,,,5,1,2,0,2
26423_1,,,,2,2,1,3
26424_0,,,,2,2,1,3
26424_1,,,,2,2,1,3
26426_0,,,,2,2,1,3
C(C(C(C)O)O)(CC=CC=O)=O,,,5,1,3,0,3
26426_1,,,,2,2,1,3
26428_0,,,,2,2,1,3
C(C(C(CC=CC=O)=O)O)(O)=O,,,5,1,5,0,5
26428_1,,,,2,2,1,3
26430_0,,,,2,2,1,3
C(C(CO)O)(CC=CC=O)=O,,,5,1,5,0,5
26430_1,,,,2,2,1,3
26432_0,,,,2,2,1,3
C(C(C(CO)O)O)(CC=CC=O)=O,,,5,1,2,0,2
26432_1,,,,2,2,1,3
26434_0,,,,2,2,1,3
C(C(C=C)C(CC=CC(CO)=O)O)=O,,,5,1,1,0,1
26436_0,,,,2,2,1,3
C(CC(CC=CC(CO)=O)O)=O,,,5,1,2,0,2
26438_0,,,,2,2,1,3
C(C(C(CC=CC(CO)=O)O)O)=O,,,5,1,2,0,2
26438_1,,,,2,2,1,3
26440_0,,,,2,2,1,3
C(CC=CC(CO)(C(C=O)C=C)O)=O,,,5,1,1,0,1
26442_0,,,,2,2,1,3
C(CC=CC(CO)(CC=O)O)=O,,,5,1,2,0,2
26444_0,,,,2,2,1,3
C(CC=CC(CO)(C(C=O)O)O)=O,,,5,1,2,0,2
26444_1,,,,2,2,1,3
26446_0,,,,2,2,1,3
C(C(C=CC(CO)=O)C(C=CC)O)=O,,,5,1,1,0,1
26448_0,,,,2,2,1,3
C(C(C=CC(CO)=O)C(CC=C)O)=O,,,5,1,1,0,1
26450_0,,,,2,2,1,3
C(C(C=CC(CO)=O)C(C=C)O)=O,,,5,1,1,0,1
26452_0,,,,2,2,1,3
C(C(C=CC(CO)=O)C(C=O)O)=O,,,5,1,1,0,1
26454_0,,,,2,2,1,3
C(C(C=CC(CO)=O)C(C)O)=O,,,5,1,2,0,2
26456_0,,,,2,2,1,3
C(C(C=O)C=CC(CO)=O)(O)=O,,,5,1,3,0,3
26458_0,,,,2,2,1,3
C(C(C=CC(CO)=O)CO)=O,,,5,1,3,0,3
26460_0,,,,2,2,1,3
C(C(C=CC(CO)=O)C(CO)O)=O,,,5,1,1,0,1
26462_0,,,,2,2,1,3
C(CC=CC(C(C(C=CC)O)O)=O)=O,,,5,1,2,0,2
26462_1,,,,2,2,1,3
26464_0,,,,2,2,1,3
C(CC=CC(C(C(CC=C)O)O)=O)=O,,,5,1,2,0,2
26464_1,,,,2,2,1,3
26466_0,,,,2,2,1,3
C(CC=CC(C(C(C=C)O)O)=O)=O,,,5,1,2,0,2
26466_1,,,,2,2,1,3
26467_0,,,,2,2,1,3
26467_1,,,,2,2,1,3
26469_0,,,,2,2,1,3
C(CC=CC(C(C(C)O)O)=O)=O,,,5,1,3,0,3
26469_1,,,,2,2,1,3
26471_0,,,,2,2,1,3
C(C(C(C=CCC=O)=O)O)(O)=O,,,5,1,5,0,5
26471_1,,,,2,2,1,3
26473_0,,,,2,2,1,3
C(CC=CC(C(CO)O)=O)=O,,,5,1,4,0,4
26473_1,,,,2,2,1,3
26475_0,,,,2,2,1,3
C(CC=CC(C(C(CO)O)O)=O)=O,,,5,1,2,0,2
26475_1,,,,2,2,1,3
26477_0,,,,2,2,1,3
C(CC(C(C=CC(CO)=O)O)O)=O,,,5,1,1,0,1
26479_0,,,,2,2,1,3
C(C(C=CC(CO)(CC=O)O)O)=O,,,5,1,1,0,1
26481_0,,,,2,2,1,3
C(C(C=CC(C(C(C)O)O)=O)O)=O,,,5,1,2,0,2
26481_1,,,,2,2,1,3
26483_0,,,,2,2,1,3
C(C(C(C=CC(C=O)O)=O)O)(O)=O,,,5,1,2,0,2
26483_1,,,,2,2,1,3
26485_0,,,,2,2,1,3
C(C(C=CC(C(CO)O)=O)O)=O,,,5,1,6,0,6
26485_1,,,,2,2,1,3
26487_0,,,,2,2,1,3
C(C(C=C)C(C=C(CO)CC=O)O)=O,,,5,1,1,0,1
26489_0,,,,2,2,1,3
C(CC(CO)=CC(CC=O)O)=O,,,5,1,2,0,2
26491_0,,,,2,2,1,3
C(CC(CO)=CC(C(C=O)O)O)=O,,,5,1,2,0,2
26491_1,,,,2,2,1,3
26493_0,,,,2,2,1,3
C(C(C=C)C(CC(CO)=CC=O)O)=O,,,5,1,1,0,1
26495_0,,,,2,2,1,3
C(CC(CC(CO)=CC=O)O)=O,,,5,1,2,0,2
26497_0,,,,2,2,1,3
C(C(C(CC(CO)=CC=O)O)O)=O,,,5,1,2,0,2
26497_1,,,,2,2,1,3
26499_0,,,,2,2,1,3
C(C(C(CO)=CC=O)C(C=CC)O)=O,,,5,1,1,0,1
26501_0,,,,2,2,1,3
C(C(C(CO)=CC=O)C(CC=C)O)=O,,,5,1,1,0,1
26503_0,,,,2,2,1,3
C(C(C(CO)=CC=O)C(C=C)O)=O,,,5,1,1,0,1
26505_0,,,,2,2,1,3
C(C(C(CO)=CC=O)C(C=O)O)=O,,,5,1,1,0,1
26507_0,,,,2,2,1,3
C(C(C(CO)=CC=O)C(C)O)=O,,,5,1,2,0,2
26509_0,,,,2,2,1,3
C(C(C=O)C(CO)=CC=O)(O)=O,,,5,1,3,0,3
26511_0,,,,2,2,1,3
C(C(C(CO)=CC=O)CO)=O,,,5,1,3,0,3
26513_0,,,,2,2,1,3
C(C(C(CO)=CC=O)C(CO)O)=O,,,5,1,1,0,1
26515_0,,,,2,2,1,3
C(CC(C(C(CO)=CC=O)O)O)=O,,,5,1,1,0,1
26517_0,,,,2,2,1,3
C(C(C(CO)=CC(CC=O)O)O)=O,,,5,1,1,0,1
26519_0,,,,2,2,1,3
C(C(C=C)C(C(C(CO)=O)C=C)O)=O,,,5,1,1,0,1
26521_0,,,,2,2,1,3
C(CC(C(C(CO)=O)C=C)O)=O,,,5,1,2,0,2
26523_0,,,,2,2,1,3
C(C(C(C(C(CO)=O)C=C)O)O)=O,,,5,1,2,0,2
26523_1,,,,2,2,1,3
26525_0,,,,2,2,1,3
C(C(C=C)C(CO)(C(C=O)C=C)O)=O,,,5,1,1,0,1
26527_0,,,,2,2,1,3
C(C(C=C)C(CO)(CC=O)O)=O,,,5,1,3,0,3
26529_0,,,,2,2,1,3
C(C(C=C)C(CO)(C(C=O)O)O)=O,,,5,1,3,0,3
26529_1,,,,2,2,1,3
26531_0,,,,2,2,1,3
C(C(C(C(C(C=CC)O)O)=O)C=C)=O,,,5,1,2,0,2
26531_1,,,,2,2,1,3
26533_0,,,,2,2,1,3
C(C(C(C(C(CC=C)O)O)=O)C=C)=O,,,5,1,2,0,2
26533_1,,,,2,2,1,3
26535_0,,,,2,2,1,3
C(C(C(C(C(C=C)O)O)=O)C=C)=O,,,5,1,2,0,2
26535_1,,,,2,2,1,3
26537_0,,,,2,2,1,3
C(C(C(C(C(C=O)O)O)=O)C=C)=O,,,5,1,2,0,2
26537_1,,,,2,2,1,3
26539_0,,,,2,2,1,3
C(C(C(C(C(C)O)O)=O)C=C)=O,,,5,1,3,0,3
26539_1,,,,2,2,1,3
26541_0,,,,2,2,1,3
C(C(C(C(C(O)=O)O)=O)C=C)=O,,,5,1,3,0,3
26541_1,,,,2,2,1,3
26543_0,,,,2,2,1,3
C(C(C(C(CO)O)=O)C=C)=O,,,5,1,4,0,4
26543_1,,,,2,2,1,3
26545_0,,,,2,2,1,3
C(C(C(C(C(CO)O)O)=O)C=C)=O,,,5,1,2,0,2
26545_1,,,,2,2,1,3
26547_0,,,,2,2,1,3
C(C(C=C)C(C(C(CO)=O)=CC)O)=O,,,5,1,1,0,1
26549_0,,,,2,2,1,3
C(CC(C(C(CO)=O)=CC)O)=O,,,5,1,2,0,2
26551_0,,,,2,2,1,3
C(C(C(C(C(CO)=O)=CC)O)O)=O,,,5,1,2,0,2
26551_1,,,,2,2,1,3
26553_0,,,,2,2,1,3
C(C(C=C)C(C(C=O)=CC)(CO)O)=O,,,5,1,1,0,1
26555_0,,,,2,2,1,3
C(CC(C(C=O)=CC)(CO)O)=O,,,5,1,2,0,2
26557_0,,,,2,2,1,3
C(C(C(C(C=O)=CC)(CO)O)O)=O,,,5,1,2,0,2
26557_1,,,,2,2,1,3
26559_0,,,,2,2,1,3
C(C)=CC(C(C(C(C=O)=CC)=O)O)O,,,5,1,2,0,2
26559_1,,,,2,2,1,3
26561_0,,,,2,2,1,3
C(CC(C(C(C(C=O)=CC)=O)O)O)=C,,,5,1,2,0,2
26561_1,,,,2,2,1,3
26563_0,,,,2,2,1,3
C=CC(C(C(C(C=O)=CC)=O)O)O,,,5,1,2,0,2
26563_1,,,,2,2,1,3
26565_0,,,,2,2,1,3
C(C(C(C(C(C=O)=CC)=O)O)O)=O,,,5,1,2,0,2
26565_1,,,,2,2,1,3
26567_0,,,,2,2,1,3
C(C)=C(C(C(C(C)O)O)=O)C=O,,,5,1,3,0,3
26567_1,,,,2,2,1,3
26569_0,,,,2,2,1,3
C(C(C(C(C=O)=CC)=O)O)(O)=O,,,5,1,3,0,3
26569_1,,,,2,2,1,3
26571_0,,,,2,2,1,3
C(C)=C(C(C(CO)O)=O)C=O,,,5,1,3,0,3
26571_1,,,,2,2,1,3
26573_0,,,,2,2,1,3
C(C)=C(C(C(C(CO)O)O)=O)C=O,,,5,1,2,0,2
26573_1,,,,2,2,1,3
26575_0,,,,2,2,1,3
C(CC(C=C(C=O)C(CO)=O)O)=O,,,5,1,1,0,1
26577_0,,,,2,2,1,3
C(CC(C(C(CO)=O)=CC=O)O)=O,,,5,1,1,0,1
26579_0,,,,2,2,1,3
C(CC(C(C=O)=CC=O)(CO)O)=O,,,5,1,1,0,1
26581_0,,,,2,2,1,3
C=CC(C(C(C(C=O)=CC=O)=O)O)O,,,5,1,2,0,2
26581_1,,,,2,2,1,3
26583_0,,,,2,2,1,3
C(C(C(C(C(C)O)O)=O)=CC=O)=O,,,5,1,2,0,2
26583_1,,,,2,2,1,3
26585_0,,,,2,2,1,3
C(C(C(C(C=O)=CC=O)=O)O)(O)=O,,,5,1,2,0,2
26585_1,,,,2,2,1,3
26587_0,,,,2,2,1,3
C(C(C(C(CO)O)=O)=CC=O)=O,,,5,1,5,0,5
26587_1,,,,2,2,1,3
26589_0,,,,2,2,1,3
C(C(C=C)C(C(C(CO)=O)=C)O)=O,,,5,1,1,0,1
26591_0,,,,2,2,1,3
C=C(C(CO)=O)C(C1C(C=CO1)=O)O,,,5,1,2,0,2
26591_1,,,,2,2,1,3
26593_0,,,,2,2,1,3
C=C(C(CO)=O)C(CC(C=O)=O)O,,,5,1,1,0,1
26595_0,,,,2,2,1,3
C(C(C=O)C(C(C(CO)=O)=C)O)=O,,,5,1,2,0,2
26595_1,,,,2,2,1,3
26597_0,,,,2,2,1,3
C(CC(C(C(CO)=O)=C)O)=O,,,5,1,3,0,3
26599_0,,,,2,2,1,3
C(C(CO)C(C(C(CO)=O)=C)O)=O,,,5,1,2,0,2
26599_1,,,,2,2,1,3
26601_0,,,,2,2,1,3
C(C)(C(C(C(C(CO)=O)=C)O)O)=O,,,5,1,2,0,2
26601_1,,,,2,2,1,3
26603_0,,,,2,2,1,3
C(CO)(CC(C(C(CO)=O)=C)O)=O,,,5,1,1,0,1
26605_0,,,,2,2,1,3
C(C(C(C(C(CO)=O)=C)O)O)=O,,,5,1,3,0,3
26605_1,,,,2,2,1,3
26607_0,,,,2,2,1,3
C(C(C=C)C(C(C=O)=C)(CO)O)=O,,,5,1,1,0,1
26609_0,,,,2,2,1,3
C1OC(C(C=1)=O)C(C(C=O)=C)(CO)O,,,5,1,2,0,2
26609_1,,,,2,2,1,3
26611_0,,,,2,2,1,3
C=C(C=O)C(CO)(CC(C=O)=O)O,,,5,1,1,0,1
26613_0,,,,2,2,1,3
C(C(C=O)C(C(C=O)=C)(CO)O)=O,,,5,1,2,0,2
26613_1,,,,2,2,1,3
26615_0,,,,2,2,1,3
C(CC(C(C=O)=C)(CO)O)=O,,,5,1,4,0,4
26617_0,,,,2,2,1,3
C(C(CO)C(C(C=O)=C)(CO)O)=O,,,5,1,2,0,2
26617_1,,,,2,2,1,3
26619_0,,,,2,2,1,3
C(C(C(C(C=O)=C)(CO)O)O)(C)=O,,,5,1,2,0,2
26619_1,,,,2,2,1,3
26621_0,,,,2,2,1,3
C(CC(C(C=O)=C)(CO)O)(CO)=O,,,5,1,1,0,1
26623_0,,,,2,2,1,3
C(C(C(C(C=O)=C)(CO)O)O)=O,,,5,1,9,0,9
26623_1,,,,2,2,1,3
26625_0,,,,2,2,1,3
C=C(C=O)C(C(C(C=CC)O)O)=O,,,5,1,2,0,2
26625_1,,,,2,2,1,3
26627_0,,,,2,2,1,3
C(CC(C(C(C(C=O)=C)=O)O)O)=C,,,5,1,2,0,2
26627_1,,,,2,2,1,3
26629_0,,,,2,2,1,3
C=CC(C(C(C(C=O)=C)=O)O)O,,,5,1,2,0,2
26629_1,,,,2,2,1,3
26631_0,,,,2,2,1,3
C1C(COC=1)(C(C(C(C=O)=C)=O)O)O,,,5,1,2,0,2
26631_1,,,,2,2,1,3
26633_0,,,,2,2,1,3
C(C(C(C(C(C=O)=C)=O)O)O)=O,,,5,1,5,0,5
26633_1,,,,2,2,1,3
26635_0,,,,2,2,1,3
C(C(C(C(C(C=O)=C)=O)O)O)(O)=O,,,5,1,3,0,3
26635_1,,,,2,2,1,3
26637_0,,,,2,2,1,3
C(C(C)(C(C(C(C=O)=C)=O)O)O)=O,,,5,1,3,0,3
26637_1,,,,2,2,1,3
26639_0,,,,2,2,1,3
C(C)(C(C(C(C(C=O)=C)=O)O)O)=O,,,5,1,4,0,4
26639_1,,,,2,2,1,3
26641_0,,,,2,2,1,3
C(CC(C(C(C(C=O)=C)=O)O)O)=O,,,5,1,2,0,2
26641_1,,,,2,2,1,3
26643_0,,,,2,2,1,3
C=C(C=O)C(C(C(C)O)O)=O,,,5,1,3,0,3
26643_1,,,,2,2,1,3
26645_0,,,,2,2,1,3
C=C(C=O)C(C(C(CCO)O)O)=O,,,5,1,2,0,2
26645_1,,,,2,2,1,3
26647_0,,,,2,2,1,3
C=C(C=O)C(C(C(CO)(C)O)O)=O,,,5,1,2,0,2
26647_1,,,,2,2,1,3
26649_0,,,,2,2,1,3
C(C(C=C)(C(C(C(C=O)=C)=O)O)O)=O,,,5,1,3,0,3
26649_1,,,,2,2,1,3
26650_0,,,,2,2,1,3
26650_1,,,,2,2,1,3
26652_0,,,,2,2,1,3
C=C(C=O)C(C(C(C=CC=O)O)O)=O,,,5,1,2,0,2
26652_1,,,,2,2,1,3
26654_0,,,,2,2,1,3
C(C(C(C(C=O)=C)=O)O)(O)=O,,,5,1,3,0,3
26654_1,,,,2,2,1,3
26656_0,,,,2,2,1,3
C=C(C=O)C(C(C(C(O)O)O)O)=O,,,5,1,2,0,2
26656_1,,,,2,2,1,3
26658_0,,,,2,2,1,3
C=C(C=O)C(C(C(C(C)O)O)O)=O,,,5,1,2,0,2
26658_1,,,,2,2,1,3
26659_0,,,,2,2,1,3
26659_1,,,,2,2,1,3
26661_0,,,,2,2,1,3
C=C(C=O)C(C(C(CO)O)O)=O,,,5,1,5,0,5
26661_1,,,,2,2,1,3
26663_0,,,,2,2,1,3
C(CC(C(C(CO)=O)=CCO)O)=O,,,5,1,1,0,1
26665_0,,,,2,2,1,3
C(CC(C(C=O)=CCO)(CO)O)=O,,,5,1,1,0,1
26667_0,,,,2,2,1,3
C(CO)=C(C(C(C(C)O)O)=O)C=O,,,5,1,2,0,2
26667_1,,,,2,2,1,3
26669_0,,,,2,2,1,3
C(C(C(C(C=O)=CCO)=O)O)(O)=O,,,5,1,2,0,2
26669_1,,,,2,2,1,3
26671_0,,,,2,2,1,3
C(CO)=C(C(C(CO)O)=O)C=O,,,5,1,5,0,5
26671_1,,,,2,2,1,3
26673_0,,,,2,2,1,3
C(C(C=C)C(CC(C(C=C)O)=O)O)=O,,,5,1,1,0,1
26675_0,,,,2,2,1,3
C(CC(CC(C(C=C)O)=O)O)=O,,,5,1,2,0,2
26677_0,,,,2,2,1,3
C(CC(C(C=O)O)O)(C(C=C)O)=O,,,5,1,2,0,2
26677_1,,,,2,2,1,3
26679_0,,,,2,2,1,3
C(CC(C(C=C)O)(C(C=O)C=C)O)=O,,,5,1,1,0,1
26681_0,,,,2,2,1,3
C(CC(C(C=C)O)(CC=O)O)=O,,,5,1,2,0,2
26683_0,,,,2,2,1,3
C(CC(C(C=O)O)(C(C=C)O)O)=O,,,5,1,2,0,2
26683_1,,,,2,2,1,3
26685_0,,,,2,2,1,3
C(C(C(C(C=C)O)=O)C(C=CC)O)=O,,,5,1,2,0,2
26685_1,,,,2,2,1,3
26687_0,,,,2,2,1,3
C(C(C(C(C=C)O)=O)C(CC=C)O)=O,,,5,1,2,0,2
26687_1,,,,2,2,1,3
26689_0,,,,2,2,1,3
C(C(C(C(C=C)O)=O)C(C=C)O)=O,,,5,1,2,0,2
26689_1,,,,2,2,1,3
26691_0,,,,2,2,1,3
C(C(C(C(C=C)O)=O)C(C=O)O)=O,,,5,1,3,0,3
26691_1,,,,2,2,1,3
26693_0,,,,2,2,1,3
C(C(C(C(C=C)O)=O)C(C)O)=O,,,5,1,4,0,4
26693_1,,,,2,2,1,3
26695_0,,,,2,2,1,3
C(C(C=O)C(C(C=C)O)=O)(O)=O,,,5,1,4,0,4
26695_1,,,,2,2,1,3
26697_0,,,,2,2,1,3
C(C(C(C(C=C)O)=O)CO)=O,,,5,1,4,0,4
26697_1,,,,2,2,1,3
26699_0,,,,2,2,1,3
C(C(C(C(C=C)O)=O)C(CO)O)=O,,,5,1,3,0,3
26699_1,,,,2,2,1,3
26701_0,,,,2,2,1,3
C(C(C=C)C(C=CC(C(C)=O)O)O)=O,,,5,1,1,0,1
26703_0,,,,2,2,1,3
C(CC(C=CC(C(C)=O)O)O)=O,,,5,1,2,0,2
26705_0,,,,2,2,1,3
C(C(C(C=CC(C(C)=O)O)O)O)=O,,,5,1,2,0,2
26705_1,,,,2,2,1,3
26707_0,,,,2,2,1,3
C(C(C=C)C(C)(C(C=CC=O)O)O)=O,,,5,1,1,0,1
26709_0,,,,2,2,1,3
C(CC(C)(C(C=CC=O)O)O)=O,,,5,1,2,0,2
26711_0,,,,2,2,1,3
C(C(C(C)(C(C=CC=O)O)O)O)=O,,,5,1,3,0,3
26711_1,,,,2,2,1,3
26713_0,,,,2,2,1,3
C(CC(C=CC)O)(C(C=CC=O)O)=O,,,5,1,1,0,1
26715_0,,,,2,2,1,3
C(CC(CC=C)O)(C(C=CC=O)O)=O,,,5,1,1,0,1
26717_0,,,,2,2,1,3
C(CC(C=C)O)(C(C=CC=O)O)=O,,,5,1,1,0,1
26719_0,,,,2,2,1,3
C(C(CC(C(C=CC=O)O)=O)O)=O,,,5,1,1,0,1
26721_0,,,,2,2,1,3
C(CC(C)O)(C(C=CC=O)O)=O,,,5,1,2,0,2
26723_0,,,,2,2,1,3
C(CC(C(C=CC=O)O)=O)(O)=O,,,5,1,3,0,3
26725_0,,,,2,2,1,3
C(CCO)(C(C=CC=O)O)=O,,,5,1,5,0,5
26727_0,,,,2,2,1,3
C(CC(CO)O)(C(C=CC=O)O)=O,,,5,1,1,0,1
26729_0,,,,2,2,1,3
C(C(C=C)C(C=C(C)C(C=O)O)O)=O,,,5,1,1,0,1
26731_0,,,,2,2,1,3
C(C(C(C)=CC(CC=O)O)O)=O,,,5,1,2,0,2
26733_0,,,,2,2,1,3
C(C(C(C)=CC(C(C=O)O)O)O)=O,,,5,1,2,0,2
26733_1,,,,2,2,1,3
26735_0,,,,2,2,1,3
C(C(C=C)C(C(C(C)=CC=O)O)O)=O,,,5,1,1,0,1
26737_0,,,,2,2,1,3
C(CC(C(C(C)=CC=O)O)O)=O,,,5,1,2,0,2
26739_0,,,,2,2,1,3
C(C(C(C(C(C)=CC=O)O)O)O)=O,,,5,1,2,0,2
26739_1,,,,2,2,1,3
26741_0,,,,2,2,1,3
C(C(C=C)C(CC(C(C=O)O)=C)O)=O,,,5,1,1,0,1
26743_0,,,,2,2,1,3
C(C(C(CC(CC=O)O)=C)O)=O,,,5,1,2,0,2
26745_0,,,,2,2,1,3
C(C(C(CC(C(C=O)O)O)=C)O)=O,,,5,1,2,0,2
26745_1,,,,2,2,1,3
26747_0,,,,2,2,1,3
C(C(C=C)C(C(C(CC=O)=C)O)O)=O,,,5,1,1,0,1
26749_0,,,,2,2,1,3
C(CC(C(C(CC=O)=C)O)O)=O,,,5,1,2,0,2
26751_0,,,,2,2,1,3
C(CC(C(C(C(C=O)O)O)O)=C)=O,,,5,1,2,0,2
26751_1,,,,2,2,1,3
26753_0,,,,2,2,1,3
C(C(C(C(C=O)O)=C)C(C=CC)O)=O,,,5,1,1,0,1
26755_0,,,,2,2,1,3
C(C(C(C(C=O)O)=C)C(CC=C)O)=O,,,5,1,1,0,1
26757_0,,,,2,2,1,3
C(C(C(C(C=O)O)=C)C(C=C)O)=O,,,5,1,1,0,1
26759_0,,,,2,2,1,3
C(C(C(C(C=O)O)=C)C(C=O)O)=O,,,5,1,1,0,1
26761_0,,,,2,2,1,3
C(C(C(C(C=O)O)=C)C(C)O)=O,,,5,1,2,0,2
26763_0,,,,2,2,1,3
C(C(C=O)C(C(C=O)O)=C)(O)=O,,,5,1,3,0,3
26765_0,,,,2,2,1,3
C(C(C(C(C=O)O)=C)CO)=O,,,5,1,3,0,3
26767_0,,,,2,2,1,3
C(C(C(C(C=O)O)=C)C(CO)O)=O,,,5,1,1,0,1
26769_0,,,,2,2,1,3
C(CC(C(C(C(C=O)O)=C)O)O)=O,,,5,1,1,0,1
26771_0,,,,2,2,1,3
C(C(C=C)C(C(C(CC=C)=O)O)O)=O,,,5,1,1,0,1
26773_0,,,,2,2,1,3
C(CC(C(C(CC=C)=O)O)O)=O,,,5,1,2,0,2
26775_0,,,,2,2,1,3
C(C(C(C(C(CC=C)=O)O)O)O)=O,,,5,1,2,0,2
26775_1,,,,2,2,1,3
26777_0,,,,2,2,1,3
C(C(C=C)C(C(C=O)O)(CC=C)O)=O,,,5,1,1,0,1
26779_0,,,,2,2,1,3
C(CC(C(C=O)O)(CC=C)O)=O,,,5,1,2,0,2
26781_0,,,,2,2,1,3
C(C(C(C(C=O)O)(CC=C)O)O)=O,,,5,1,2,0,2
26781_1,,,,2,2,1,3
26783_0,,,,2,2,1,3
C(C(C(C(C=C)C(C=CC)O)=O)O)=O,,,5,1,1,0,1
26785_0,,,,2,2,1,3
C(C(C(C(C=C)C(CC=C)O)=O)O)=O,,,5,1,1,0,1
26787_0,,,,2,2,1,3
C(C(C(C(C=C)C(C=C)O)=O)O)=O,,,5,1,1,0,1
26789_0,,,,2,2,1,3
C(C(C=O)O)(C(C=C)C(C=O)O)=O,,,5,1,1,0,1
26791_0,,,,2,2,1,3
C(C(C=O)O)(C(C=C)C(C)O)=O,,,5,1,2,0,2
26793_0,,,,2,2,1,3
C(C(C(C(C=O)O)=O)C=C)(O)=O,,,5,1,3,0,3
26795_0,,,,2,2,1,3
C(C(C=O)O)(C(C=C)CO)=O,,,5,1,2,0,2
26797_0,,,,2,2,1,3
C(C(C=O)O)(C(C=C)C(CO)O)=O,,,5,1,1,0,1
26799_0,,,,2,2,1,3
C(C(C=C)C(C(C(C=CC)=O)O)O)=O,,,5,1,1,0,1
26801_0,,,,2,2,1,3
C(CC(C(C(C=CC)=O)O)O)=O,,,5,1,2,0,2
26803_0,,,,2,2,1,3
C(C(C(C(C(C=CC)=O)O)O)O)=O,,,5,1,2,0,2
26803_1,,,,2,2,1,3
26805_0,,,,2,2,1,3
C(C(C=C)C(C=CC)(C(C=O)O)O)=O,,,5,1,1,0,1
26807_0,,,,2,2,1,3
C(CC(C=CC)(C(C=O)O)O)=O,,,5,1,2,0,2
26809_0,,,,2,2,1,3
C(C(C(C=CC)(C(C=O)O)O)O)=O,,,5,1,2,0,2
26809_1,,,,2,2,1,3
26811_0,,,,2,2,1,3
C(C(C(C=CC(CC=O)O)=O)O)=O,,,5,1,1,0,1
26813_0,,,,2,2,1,3
C(CC(C(C(C=CC=O)=O)O)O)=O,,,5,1,3,0,3
26815_0,,,,2,2,1,3
C(CC(C=CC=O)(C(C=O)O)O)=O,,,5,1,1,0,1
26816_0,,,,2,2,1,3
26818_0,,,,2,2,1,3
C1OC(C(C=1)=O)C(C(C(C=C)=O)O)O,,,5,1,2,0,2
26818_1,,,,2,2,1,3
26819_0,,,,2,2,1,3
26820_0,,,,2,2,1,3
26820_1,,,,2,2,1,3
26821_0,,,,2,2,1,3
26822_0,,,,2,2,1,3
26822_1,,,,2,2,1,3
26823_0,,,,2,2,1,3
26823_1,,,,2,2,1,3
26824_0,,,,2,2,1,3
26825_0,,,,2,2,1,3
26825_1,,,,2,2,1,3
26827_0,,,,2,2,1,3
C(C(C=C)C(C=C)(C(C=O)O)O)=O,,,5,1,1,0,1
26829_0,,,,2,2,1,3
C(C(C(C=C)(C1C(C=CO1)=O)O)O)=O,,,5,1,2,0,2
26829_1,,,,2,2,1,3
26831_0,,,,2,2,1,3
C(C(C(C=C)(CC(C=O)=O)O)O)=O,,,5,1,1,0,1
26833_0,,,,2,2,1,3
C(C(C=O)C(C=C)(C(C=O)O)O)=O,,,5,1,2,0,2
26833_1,,,,2,2,1,3
26835_0,,,,2,2,1,3
C(CC(C=C)(C(C=O)O)O)=O,,,5,1,2,0,2
26837_0,,,,2,2,1,3
C(C(C(C=C)(C(C=O)CO)O)O)=O,,,5,1,2,0,2
26837_1,,,,2,2,1,3
26839_0,,,,2,2,1,3
C(C(C(C=C)(C(C(C)=O)O)O)O)=O,,,5,1,2,0,2
26839_1,,,,2,2,1,3
26841_0,,,,2,2,1,3
C(C(C(C=C)(CC(CO)=O)O)O)=O,,,5,1,1,0,1
26843_0,,,,2,2,1,3
C(C(C(C=C)(C(C=O)O)O)O)=O,,,5,1,3,0,3
26843_1,,,,2,2,1,3
26845_0,,,,2,2,1,3
C(CC(C(C(C=CCO)=O)O)O)=O,,,5,1,1,0,1
26847_0,,,,2,2,1,3
C(CC(C=CCO)(C(C=O)O)O)=O,,,5,1,1,0,1
26849_0,,,,2,2,1,3
C(C(C=C)C(C=CC)O)=O,,,5,1,1,0,1
26851_0,,,,2,2,1,3
C(C(C(C(C=CC=O)=O)O)O)=CC,,,5,1,2,0,2
26851_1,,,,2,2,1,3
26853_0,,,,2,2,1,3
C(C(C(CC(C=CC)O)=O)(C=C)O)=O,,,5,1,1,0,1
26855_0,,,,2,2,1,3
C1OC(C(C=1)=O)C(C=CC)O,,,5,1,2,0,2
26855_1,,,,2,2,1,3
26857_0,,,,2,2,1,3
C1(C(O)OC(C)C1C(C=CC)O)=O,,,5,1,2,0,2
26857_1,,,,2,2,1,3
26859_0,,,,2,2,1,3
C(C)=CC(C(C(C=O)=O)CCO)O,,,5,1,1,0,1
26861_0,,,,2,2,1,3
C(C(CCC(C=O)=O)C(C=CC)O)=O,,,5,1,1,0,1
26863_0,,,,2,2,1,3
C(CCC(C(C=O)=O)C(C=CC)O)=O,,,5,1,1,0,1
26865_0,,,,2,2,1,3
C(CCC(C=O)C(C=CC)O)(O)=O,,,5,1,1,0,1
26867_0,,,,2,2,1,3
C(C([C](C(O)=O)O)C(C=CC)O)=O,,,5,1,2,0,2
26867_1,,,,2,2,1,3
26869_0,,,,2,2,1,3
C(CO)(C(C(C=CC)O)O)=O,,,5,1,3,0,3
26869_1,,,,2,2,1,3
26871_0,,,,2,2,1,3
C(C(C(C=CC)O)O)(C(CO)O)=O,,,5,1,2,0,2
26871_1,,,,2,2,1,3
26873_0,,,,2,2,1,3
C(C(CC(C=O)=O)O)=CC,,,5,1,2,0,2
26875_0,,,,2,2,1,3
C(C(C=O)C(C=CC)O)=O,,,5,1,3,0,3
26875_1,,,,2,2,1,3
26877_0,,,,2,2,1,3
C(C)=CC(C(C(C=O)=O)CO)O,,,5,1,3,0,3
26877_1,,,,2,2,1,3
26879_0,,,,2,2,1,3
C(C(C(C=O)C(C=CC)O)O)=O,,,5,1,3,0,3
26879_1,,,,2,2,1,3
26881_0,,,,2,2,1,3
C(C(C(CO)=O)C(C=CC)O)=O,,,5,1,3,0,3
26881_1,,,,2,2,1,3
26883_0,,,,2,2,1,3
C(CC(C(C(C=CC)O)O)=O)=O,,,5,1,3,0,3
26883_1,,,,2,2,1,3
26885_0,,,,2,2,1,3
C(C(C(CC(C=CC)O)=O)O)=O,,,5,1,2,0,2
26887_0,,,,2,2,1,3
C(CC(C=CC)O)=O,,,5,1,2,0,2
26889_0,,,,2,2,1,3
C(C(C(C(C=O)=O)O)O)=CC,,,5,1,3,0,3
26889_1,,,,2,2,1,3
26891_0,,,,2,2,1,3
C(C(C(C=O)C(C=CC)O)O)(O)=O,,,5,1,2,0,2
26891_1,,,,2,2,1,3
26893_0,,,,2,2,1,3
C(C(C)(C(C=O)C(C=CC)O)O)=O,,,5,1,2,0,2
26893_1,,,,2,2,1,3
26895_0,,,,2,2,1,3
C(C(C(C(C)=O)O)C(C=CC)O)=O,,,5,1,2,0,2
26895_1,,,,2,2,1,3
26897_0,,,,2,2,1,3
C(CC(C(CC(C=CC)O)=O)O)=O,,,5,1,1,0,1
26899_0,,,,2,2,1,3
C(C)=CC(C(C(C=O)=O)C(C)O)O,,,5,1,2,0,2
26899_1,,,,2,2,1,3
26901_0,,,,2,2,1,3
C(CC(C(C=O)C(C=CC)O)O)=O,,,5,1,2,0,2
26901_1,,,,2,2,1,3
26903_0,,,,2,2,1,3
C(C(C(C)O)C(C=CC)O)=O,,,5,1,3,0,3
26903_1,,,,2,2,1,3
26905_0,,,,2,2,1,3
C(C(CO)C(C=CC)O)=O,,,5,1,3,0,3
26905_1,,,,2,2,1,3
26907_0,,,,2,2,1,3
C(C(C(CO)O)C(C=CC)O)=O,,,5,1,3,0,3
26907_1,,,,2,2,1,3
26909_0,,,,2,2,1,3
C(C(C(C(C(C=CC)O)O)=O)O)=O,,,5,1,2,0,2
26909_1,,,,2,2,1,3
26911_0,,,,2,2,1,3
C(C)=CC(C(C(C(C)=O)=O)O)O,,,5,1,3,0,3
26911_1,,,,2,2,1,3
26913_0,,,,2,2,1,3
C(C)=CC(CC(C(CO)=O)=O)O,,,5,1,2,0,2
26915_0,,,,2,2,1,3
C(C)(C(C(C=CC)O)O)=O,,,5,1,3,0,3
26915_1,,,,2,2,1,3
26917_0,,,,2,2,1,3
C(CO)(CC(C=CC)O)=O,,,5,1,2,0,2
26919_0,,,,2,2,1,3
C(C(C(C=CC)O)O)(CCO)=O,,,5,1,3,0,3
26919_1,,,,2,2,1,3
26921_0,,,,2,2,1,3
C(CO)(C(CO)C(C=CC)O)=O,,,5,1,3,0,3
26921_1,,,,2,2,1,3
26923_0,,,,2,2,1,3
C(CC(C=CC)O)(C(CO)O)=O,,,5,1,2,0,2
26925_0,,,,2,2,1,3
C(C(CC(C(O)=O)=O)O)=CC,,,5,1,2,0,2
26927_0,,,,2,2,1,3
C(C(C=O)C(C=CC)O)(O)=O,,,5,1,3,0,3
26927_1,,,,2,2,1,3
26929_0,,,,2,2,1,3
C(C)=CC(C(C(C(O)=O)=O)CO)O,,,5,1,2,0,2
26929_1,,,,2,2,1,3
26931_0,,,,2,2,1,3
C(C(C(CO)=O)C(C=CC)O)(O)=O,,,5,1,2,0,2
26931_1,,,,2,2,1,3
26933_0,,,,2,2,1,3
C(CC(C(C(C=CC)O)O)=O)(O)=O,,,5,1,2,0,2
26933_1,,,,2,2,1,3
26935_0,,,,2,2,1,3
C(C(C(CC(C=CC)O)=O)O)(O)=O,,,5,1,1,0,1
26937_0,,,,2,2,1,3
C(C(C(C(C(O)=O)=O)O)O)=CC,,,5,1,3,0,3
26937_1,,,,2,2,1,3
26939_0,,,,2,2,1,3
C(C(C(C=O)=O)C(C=CC)O)=O,,,5,1,3,0,3
26939_1,,,,2,2,1,3
26941_0,,,,2,2,1,3
C(C(C(C=O)=O)C(C=CC)O)(O)=O,,,5,1,2,0,2
26941_1,,,,2,2,1,3
26943_0,,,,2,2,1,3
C(C(C(C(O)=O)=O)C(C=CC)O)=O,,,5,1,2,0,2
26943_1,,,,2,2,1,3
26945_0,,,,2,2,1,3
C1(C(C(C=CC)O)OCC1O)=O,,,5,1,3,0,3
26945_1,,,,2,2,1,3
26947_0,,,,2,2,1,3
C1(C(O)OCC1C(C=CC)O)=O,,,5,1,3,0,3
26947_1,,,,2,2,1,3
26949_0,,,,2,2,1,3
C1(COC(C1C(C=CC)O)O)=O,,,5,1,3,0,3
26949_1,,,,2,2,1,3
26951_0,,,,2,2,1,3
C1(C(C(C=CC)O)OC(C1)O)=O,,,5,1,3,0,3
26951_1,,,,2,2,1,3
26953_0,,,,2,2,1,3
C(C(CC(C(C=O)=O)=O)O)=CC,,,5,1,2,0,2
26955_0,,,,2,2,1,3
C(C(C(C=CC)O)O)=O,,,5,1,3,0,3
26955_1,,,,2,2,1,3
26957_0,,,,2,2,1,3
C(C(C=C)C(CC=C)O)=O,,,5,1,1,0,1
26959_0,,,,2,2,1,3
C(CC(C(C(C=CC=O)=O)O)O)=C,,,5,1,2,0,2
26959_1,,,,2,2,1,3
26961_0,,,,2,2,1,3
C(C(C(CC(CC=C)O)=O)(C=C)O)=O,,,5,1,1,0,1
26963_0,,,,2,2,1,3
C(CC(C1C(C=CO1)=O)O)=C,,,5,1,2,0,2
26963_1,,,,2,2,1,3
26965_0,,,,2,2,1,3
C1(C(O)OC(C)C1C(CC=C)O)=O,,,5,1,2,0,2
26965_1,,,,2,2,1,3
26967_0,,,,2,2,1,3
C=CCC(C(C(C=O)=O)CCO)O,,,5,1,1,0,1
26969_0,,,,2,2,1,3
C(C(CCC(C=O)=O)C(CC=C)O)=O,,,5,1,1,0,1
26971_0,,,,2,2,1,3
C(CCC(C(C=O)=O)C(CC=C)O)=O,,,5,1,1,0,1
26973_0,,,,2,2,1,3
C(C(CCC(O)=O)C(CC=C)O)=O,,,5,1,1,0,1
26975_0,,,,2,2,1,3
C(C([C](C(O)=O)O)C(CC=C)O)=O,,,5,1,2,0,2
26975_1,,,,2,2,1,3
26977_0,,,,2,2,1,3
C(CO)(C(C(CC=C)O)O)=O,,,5,1,3,0,3
26977_1,,,,2,2,1,3
26979_0,,,,2,2,1,3
C(C(C(CC=C)O)O)(C(CO)O)=O,,,5,1,2,0,2
26979_1,,,,2,2,1,3
26981_0,,,,2,2,1,3
C=CCC(CC(C=O)=O)O,,,5,1,2,0,2
26983_0,,,,2,2,1,3
C(C(C=O)C(CC=C)O)=O,,,5,1,3,0,3
26983_1,,,,2,2,1,3
26985_0,,,,2,2,1,3
C=CCC(C(C(C=O)=O)CO)O,,,5,1,3,0,3
26985_1,,,,2,2,1,3
26987_0,,,,2,2,1,3
C(C(C(CC=C)O)C(C=O)O)=O,,,5,1,3,0,3
26987_1,,,,2,2,1,3
26989_0,,,,2,2,1,3
C(C(C(CO)=O)C(CC=C)O)=O,,,5,1,3,0,3
26989_1,,,,2,2,1,3
26991_0,,,,2,2,1,3
C(CC(C(C(CC=C)O)O)=O)=O,,,5,1,3,0,3
26991_1,,,,2,2,1,3
26993_0,,,,2,2,1,3
C(C(C(CC(CC=C)O)=O)O)=O,,,5,1,2,0,2
26995_0,,,,2,2,1,3
C(CC(CC=C)O)=O,,,5,1,2,0,2
26997_0,,,,2,2,1,3
C(CC(C(C(C=O)=O)O)O)=C,,,5,1,3,0,3
26997_1,,,,2,2,1,3
26999_0,,,,2,2,1,3
C(C(C(CC=C)O)C(C(O)=O)O)=O,,,5,1,2,0,2
26999_1,,,,2,2,1,3
27001_0,,,,2,2,1,3
C(C(C(CC=C)O)C(C=O)(C)O)=O,,,5,1,2,0,2
27001_1,,,,2,2,1,3
27003_0,,,,2,2,1,3
C(C(C(CC=C)O)C(C(C)=O)O)=O,,,5,1,2,0,2
27003_1,,,,2,2,1,3
27005_0,,,,2,2,1,3
C(CC(C(CC(CC=C)O)=O)O)=O,,,5,1,1,0,1
27007_0,,,,2,2,1,3
C=CCC(C(C(C=O)=O)C(C)O)O,,,5,1,2,0,2
27007_1,,,,2,2,1,3
27009_0,,,,2,2,1,3
C(C(C(CC=C)O)C(CC=O)O)=O,,,5,1,2,0,2
27009_1,,,,2,2,1,3
27011_0,,,,2,2,1,3
C(C(C(CC=C)O)C(C)O)=O,,,5,1,3,0,3
27011_1,,,,2,2,1,3
27013_0,,,,2,2,1,3
C(C(CO)C(CC=C)O)=O,,,5,1,3,0,3
27013_1,,,,2,2,1,3
27015_0,,,,2,2,1,3
C(C(C(CC=C)O)C(CO)O)=O,,,5,1,3,0,3
27015_1,,,,2,2,1,3
27017_0,,,,2,2,1,3
C(C(C(C(C(CC=C)O)O)=O)O)=O,,,5,1,2,0,2
27017_1,,,,2,2,1,3
27019_0,,,,2,2,1,3
C(CC(C(C(C(C)=O)=O)O)O)=C,,,5,1,3,0,3
27019_1,,,,2,2,1,3
27021_0,,,,2,2,1,3
C(CC(CC(C(CO)=O)=O)O)=C,,,5,1,2,0,2
27023_0,,,,2,2,1,3
C(C)(C(C(CC=C)O)O)=O,,,5,1,3,0,3
27023_1,,,,2,2,1,3
27025_0,,,,2,2,1,3
C(CO)(CC(CC=C)O)=O,,,5,1,2,0,2
27027_0,,,,2,2,1,3
C(C(C(CC=C)O)O)(CCO)=O,,,5,1,3,0,3
27027_1,,,,2,2,1,3
27029_0,,,,2,2,1,3
C(CO)(C(CO)C(CC=C)O)=O,,,5,1,3,0,3
27029_1,,,,2,2,1,3
27031_0,,,,2,2,1,3
C(C(CO)O)(CC(CC=C)O)=O,,,5,1,2,0,2
27033_0,,,,2,2,1,3
C=CCC(CC(C(O)=O)=O)O,,,5,1,2,0,2
27035_0,,,,2,2,1,3
C(C(C=O)C(CC=C)O)(O)=O,,,5,1,3,0,3
27035_1,,,,2,2,1,3
27037_0,,,,2,2,1,3
C=CCC(C(C(C(O)=O)=O)CO)O,,,5,1,2,0,2
27037_1,,,,2,2,1,3
27039_0,,,,2,2,1,3
C(C(C(CO)=O)C(CC=C)O)(O)=O,,,5,1,2,0,2
27039_1,,,,2,2,1,3
27041_0,,,,2,2,1,3
C(CC(C(C(CC=C)O)O)=O)(O)=O,,,5,1,2,0,2
27041_1,,,,2,2,1,3
27043_0,,,,2,2,1,3
C(C(C(CC(CC=C)O)=O)O)(O)=O,,,5,1,1,0,1
27045_0,,,,2,2,1,3
C(CC(C(C(C(O)=O)=O)O)O)=C,,,5,1,3,0,3
27045_1,,,,2,2,1,3
27047_0,,,,2,2,1,3
C(C(C(C=O)=O)C(CC=C)O)=O,,,5,1,3,0,3
27047_1,,,,2,2,1,3
27049_0,,,,2,2,1,3
C(C(C(C=O)=O)C(CC=C)O)(O)=O,,,5,1,2,0,2
27049_1,,,,2,2,1,3
27051_0,,,,2,2,1,3
C(C(C(C(O)=O)=O)C(CC=C)O)=O,,,5,1,2,0,2
27051_1,,,,2,2,1,3
27053_0,,,,2,2,1,3
C1(C(C(CC=C)O)OCC1O)=O,,,5,1,3,0,3
27053_1,,,,2,2,1,3
27055_0,,,,2,2,1,3
C1(C(O)OCC1C(CC=C)O)=O,,,5,1,3,0,3
27055_1,,,,2,2,1,3
27057_0,,,,2,2,1,3
C1(COC(C1C(CC=C)O)O)=O,,,5,1,3,0,3
27057_1,,,,2,2,1,3
27059_0,,,,2,2,1,3
C1(C(C(CC=C)O)OC(C1)O)=O,,,5,1,3,0,3
27059_1,,,,2,2,1,3
27061_0,,,,2,2,1,3
C=CCC(CC(C(C=O)=O)=O)O,,,5,1,2,0,2
27063_0,,,,2,2,1,3
C(C(C(CC=C)O)O)=O,,,5,1,3,0,3
27063_1,,,,2,2,1,3
27065_0,,,,2,2,1,3
C(C(C=C)C(C=O)(C(C=C)O)O)=O,,,5,1,2,0,2
27067_0,,,,2,2,1,3
C(C(C=C)C(C(C(C=C)O)=O)O)=O,,,5,1,1,0,1
27069_0,,,,2,2,1,3
C(C(C=C)C(C(C=C)O)O)=O,,,5,1,1,0,1
27071_0,,,,2,2,1,3
C(C(C=C)C(C=CC=O)(CO)O)=O,,,5,1,1,0,1
27073_0,,,,2,2,1,3
C(C(C=C)C(C=CC(CO)=O)O)=O,,,5,1,1,0,1
27075_0,,,,2,2,1,3
C(C(C=C)C(C=CC(CO)O)O)=O,,,5,1,1,0,1
27077_0,,,,2,2,1,3
C(C(C=C)C(C=C)O)=O,,,5,1,1,0,1
27079_0,,,,2,2,1,3
C(C(C=C)C(C(C(C)=O)(C=C)O)O)=O,,,5,1,1,0,1
27081_0,,,,2,2,1,3
C(C(C=C)C(C)(C(C=O)(C=C)O)O)=O,,,5,1,1,0,1
27083_0,,,,2,2,1,3
C(C(C=C)C(C(C=C)(CO)O)O)=O,,,5,1,1,0,1
27085_0,,,,2,2,1,3
C(C(C=C)C(C=O)(C(C=O)=C)O)=O,,,5,1,1,0,1
27087_0,,,,2,2,1,3
C(C(C=C)C(C(C(C=O)=C)=O)O)=O,,,5,1,1,0,1
27089_0,,,,2,2,1,3
C(C(C=C)C(C(C(C=O)=O)=C)O)=O,,,5,1,1,0,1
27091_0,,,,2,2,1,3
C(C(C=C)C1(C=COC1)O)=O,,,5,1,1,0,1
27093_0,,,,2,2,1,3
C(C(C=C)C1(C(O)OC(C)C1)O)=O,,,5,1,1,0,1
27095_0,,,,2,2,1,3
C(C(C=C)C1(C(OCC1O)=O)O)=O,,,5,1,1,0,1
27097_0,,,,2,2,1,3
C(C(C=C)C(C=O)(CCCO)O)=O,,,5,1,1,0,1
27099_0,,,,2,2,1,3
C(C(C=C)C(C(CCCO)=O)O)=O,,,5,1,1,0,1
27101_0,,,,2,2,1,3
C(C(C=C)C(CCCC(C=O)=O)O)=O,,,5,1,1,0,1
27103_0,,,,2,2,1,3
C(CCCC(C=O)(C(C=O)C=C)O)=O,,,5,1,1,0,1
27105_0,,,,2,2,1,3
C(CCCC(C(C(C=O)C=C)O)=O)=O,,,5,1,1,0,1
27107_0,,,,2,2,1,3
C(C(C=C)C(CCCC(O)=O)O)=O,,,5,1,1,0,1
27109_0,,,,2,2,1,3
C(C(C=C)C(C(CC(C)O)O)O)=O,,,5,1,1,0,1
27111_0,,,,2,2,1,3
C(C(C=C)C(C[C](C(O)=O)O)O)=O,,,5,1,1,0,1
27113_0,,,,2,2,1,3
C(C(C=C)C(C(CO)O)O)=O,,,5,1,2,0,2
27115_0,,,,2,2,1,3
C(C(C=C)C(C(C(CO)O)O)O)=O,,,5,1,1,0,1
27116_0,,,,2,2,1,3
27117_0,,,,2,2,1,3
27119_0,,,,2,2,1,3
C(C(C=C)C(CO)(CO)O)=O,,,5,1,2,0,2
27121_0,,,,2,2,1,3
C(C(C=C)C(CO)(C(CO)O)O)=O,,,5,1,1,0,1
27123_0,,,,2,2,1,3
C(C(C=C)C(C(O)=O)O)=O,,,5,1,4,0,4
27125_0,,,,2,2,1,3
C(C(C=C)C(C(CO)(CO)O)O)=O,,,5,1,1,0,1
27127_0,,,,2,2,1,3
C(C(C=C)C(C=O)(C)O)=O,,,5,1,2,0,2
27129_0,,,,2,2,1,3
C(C(C=C)C(C(C)=O)O)=O,,,5,1,2,0,2
27130_0,,,,2,2,1,3
27132_0,,,,2,2,1,3
C(C(C=C)C(C=O)(CCO)O)=O,,,5,1,2,0,2
27134_0,,,,2,2,1,3
C(C(C=C)C(C(CCO)=O)O)=O,,,5,1,2,0,2
27135_0,,,,2,2,1,3
27137_0,,,,2,2,1,3
C(C(C=C)C(CC(C=O)O)O)=O,,,5,1,2,0,2
27138_0,,,,2,2,1,3
27139_0,,,,2,2,1,3
27140_0,,,,2,2,1,3
27142_0,,,,2,2,1,3
C(C(C=C)C(C)(C(C=O)O)O)=O,,,5,1,2,0,2
27144_0,,,,2,2,1,3
C(C(C=C)C(C)O)=O,,,5,1,2,0,2
27146_0,,,,2,2,1,3
C(C(C=C)C(C=O)(CO)O)=O,,,5,1,3,0,3
27148_0,,,,2,2,1,3
C(C(C=C)C(C(CO)=O)O)=O,,,5,1,2,0,2
27150_0,,,,2,2,1,3
C(C(C=C)C(C=O)(C(CO)O)O)=O,,,5,1,2,0,2
27152_0,,,,2,2,1,3
C(C(C=C)C(C(C(CO)O)=O)O)=O,,,5,1,1,0,1
27154_0,,,,2,2,1,3
C(C(C=C)C(CC(C(O)=O)O)O)=O,,,5,1,1,0,1
27156_0,,,,2,2,1,3
C(C(C=C)C(CC(C=O)(C)O)O)=O,,,5,1,1,0,1
27158_0,,,,2,2,1,3
C(C(C=C)C(C(C)(CC=O)O)O)=O,,,5,1,1,0,1
27160_0,,,,2,2,1,3
C(C(C=C)C(CC(C(C)=O)O)O)=O,,,5,1,1,0,1
27162_0,,,,2,2,1,3
C(C(C=C)C(C)(C(CC=O)O)O)=O,,,5,1,1,0,1
27164_0,,,,2,2,1,3
C(C(C=C)C(C=O)(CC(C)O)O)=O,,,5,1,1,0,1
27166_0,,,,2,2,1,3
C(C(C=C)C(C(CC(C)O)=O)O)=O,,,5,1,1,0,1
27168_0,,,,2,2,1,3
C(C(C=C)C(CC(CC=O)O)O)=O,,,5,1,1,0,1
27169_0,,,,2,2,1,3
27170_0,,,,2,2,1,3
27172_0,,,,2,2,1,3
C(C(C=C)C(CC(C)O)O)=O,,,5,1,2,0,2
27174_0,,,,2,2,1,3
C(C(C=C)C(C(C(C)O)O)O)=O,,,5,1,2,0,2
27176_0,,,,2,2,1,3
C(C(C=C)C(CCO)O)=O,,,5,1,2,0,2
27178_0,,,,2,2,1,3
C(C(C=C)C(CC(CO)O)O)=O,,,5,1,2,0,2
27179_0,,,,2,2,1,3
27181_0,,,,2,2,1,3
C(C(C=C)C(C(C(C=O)O)=O)O)=O,,,5,1,1,0,1
27183_0,,,,2,2,1,3
C(C(C=C)C(C=O)(C(C=O)O)O)=O,,,5,1,2,0,2
27184_0,,,,2,2,1,3
27185_0,,,,2,2,1,3
27187_0,,,,2,2,1,3
C(C(C=C)C(C(C)=O)(CO)O)=O,,,5,1,2,0,2
27189_0,,,,2,2,1,3
C(C(C=C)C(C(CO)=O)(C)O)=O,,,5,1,2,0,2
27191_0,,,,2,2,1,3
C(C(C=C)C(C=O)(C(C)O)O)=O,,,5,1,3,0,3
27193_0,,,,2,2,1,3
C(C(C=C)C(C(C(C)O)=O)O)=O,,,5,1,2,0,2
27194_0,,,,2,2,1,3
27196_0,,,,2,2,1,3
C(C(C=C)C(C)(CO)O)=O,,,5,1,2,0,2
27198_0,,,,2,2,1,3
C(C(C=C)C(CO)(CCO)O)=O,,,5,1,2,0,2
27200_0,,,,2,2,1,3
C(C(C=C)C(C(CCO)O)O)=O,,,5,1,2,0,2
27202_0,,,,2,2,1,3
C(C(C=C)C(C)(C(CO)O)O)=O,,,5,1,2,0,2
27204_0,,,,2,2,1,3
C(C(C=C)C(C(O)=O)(C)O)=O,,,5,1,2,0,2
27206_0,,,,2,2,1,3
C(C(C=C)C(CC(O)=O)O)=O,,,5,1,2,0,2
27208_0,,,,2,2,1,3
C(C(C=C)C(C(O)=O)(CCO)O)=O,,,5,1,1,0,1
27210_0,,,,2,2,1,3
C(C(C=C)C(C(CC(O)=O)O)O)=O,,,5,1,1,0,1
27212_0,,,,2,2,1,3
C(C(C=C)C(CO)(CC(O)=O)O)=O,,,5,1,1,0,1
27214_0,,,,2,2,1,3
C(C(C=C)C(C)(C(C(O)=O)O)O)=O,,,5,1,1,0,1
27216_0,,,,2,2,1,3
C(C(C=C)C(C(O)=O)(CO)O)=O,,,5,1,2,0,2
27218_0,,,,2,2,1,3
C(C(C=C)C(C=O)(CC=O)O)=O,,,5,1,2,0,2
27220_0,,,,2,2,1,3
C(C(C=C)C(C(CC=O)=O)O)=O,,,5,1,2,0,2
27221_0,,,,2,2,1,3
27223_0,,,,2,2,1,3
C(C(C=C)C(C=O)(CC(O)=O)O)=O,,,5,1,1,0,1
27225_0,,,,2,2,1,3
C(C(C=C)C(C(CC(O)=O)=O)O)=O,,,5,1,1,0,1
27226_0,,,,2,2,1,3
27228_0,,,,2,2,1,3
C(C(C=C)C(C(O)=O)(CC=O)O)=O,,,5,1,1,0,1
27230_0,,,,2,2,1,3
C(C(C=C)C1(COCC1O)O)=O,,,5,1,2,0,2
27232_0,,,,2,2,1,3
C(C(C=C)C1(C(O)OCC1)O)=O,,,5,1,2,0,2
27234_0,,,,2,2,1,3
C(C(C=C)C1(COC(C1)O)O)=O,,,5,1,2,0,2
27236_0,,,,2,2,1,3
C(C(C=C)C(C=O)(C(C)=O)O)=O,,,5,1,2,0,2
27238_0,,,,2,2,1,3
C(C(C=C)C(C(C(C)=O)=O)O)=O,,,5,1,2,0,2
27240_0,,,,2,2,1,3
C(C(C=C)C(C(C=O)=O)(C)O)=O,,,5,1,2,0,2
27242_0,,,,2,2,1,3
C(C(C=C)C(C=O)(C=C)O)=O,,,5,1,2,0,2
27244_0,,,,2,2,1,3
C(C(C=C)C(C(C=C)=O)O)=O,,,5,1,2,0,2
27246_0,,,,2,2,1,3
C(C(C=C)C(C=CC=O)O)=O,,,5,1,2,0,2
27248_0,,,,2,2,1,3
C(C(C=C)C1(C(O)OCC1O)O)=O,,,5,1,1,0,1
27250_0,,,,2,2,1,3
C(C(C(O)=O)C=C)=O,,,5,1,5,0,5
27252_0,,,,2,2,1,3
C(C(C=C)C(C(O)O)O)=O,,,5,1,2,0,2
27254_0,,,,2,2,1,3
C(C(C=C)C(C(C)O)O)=O,,,5,1,2,0,2
27256_0,,,,2,2,1,3
C(C(C=C)CO)=O,,,5,1,3,0,3
27258_0,,,,2,2,1,3
C(C(C=C)C(CO)O)=O,,,5,1,3,0,3
27260_0,,,,2,2,1,3
C(C(C1C(C=CO1)=O)(C(C=C)O)O)=O,,,5,1,2,0,2
27260_1,,,,2,2,1,3
27262_0,,,,2,2,1,3
C(C(CC(C=O)=O)(C(C=C)O)O)=O,,,5,1,2,0,2
27264_0,,,,2,2,1,3
C(C(C=O)C(C=O)(C(C=C)O)O)=O,,,5,1,3,0,3
27264_1,,,,2,2,1,3
27266_0,,,,2,2,1,3
C(CC(C=O)(C(C=C)O)O)=O,,,5,1,4,0,4
27268_0,,,,2,2,1,3
C(C(CO)C(C=O)(C(C=C)O)O)=O,,,5,1,3,0,3
27268_1,,,,2,2,1,3
27270_0,,,,2,2,1,3
C(C(C(C=C)O)(C(C(C)=O)O)O)=O,,,5,1,4,0,4
27270_1,,,,2,2,1,3
27272_0,,,,2,2,1,3
C(C(CC(CO)=O)(C(C=C)O)O)=O,,,5,1,2,0,2
27274_0,,,,2,2,1,3
C(C(C(C=O)(C(C=C)O)O)O)=O,,,5,1,6,0,6
27274_1,,,,2,2,1,3
27276_0,,,,2,2,1,3
C(C(C1C(C=CO1)=O)O)(C(C=C)O)=O,,,5,1,2,0,2
27276_1,,,,2,2,1,3
27278_0,,,,2,2,1,3
C(C(CC(C=O)=O)O)(C(C=C)O)=O,,,5,1,1,0,1
27280_0,,,,2,2,1,3
C(C(C=O)C(C(C(C=C)O)=O)O)=O,,,5,1,2,0,2
27280_1,,,,2,2,1,3
27282_0,,,,2,2,1,3
C(CC(C(C(C=C)O)=O)O)=O,,,5,1,2,0,2
27284_0,,,,2,2,1,3
C(C(CO)C(C(C(C=C)O)=O)O)=O,,,5,1,2,0,2
27284_1,,,,2,2,1,3
27285_0,,,,2,2,1,3
27285_1,,,,2,2,1,3
27287_0,,,,2,2,1,3
C(C(CC(CO)=O)O)(C(C=C)O)=O,,,5,1,1,0,1
27288_0,,,,2,2,1,3
27288_1,,,,2,2,1,3
27290_0,,,,2,2,1,3
C(C(C(C1C(C=CO1)=O)O)O)=C,,,5,1,2,0,2
27290_1,,,,2,2,1,3
27292_0,,,,2,2,1,3
C(CO)(C(C(C(C=C)O)O)O)=O,,,5,1,4,0,4
27292_1,,,,2,2,1,3
27294_0,,,,2,2,1,3
C=CC(C(CC(C=O)=O)O)O,,,5,1,3,0,3
27296_0,,,,2,2,1,3
C(C(C=O)C(C(C=C)O)O)=O,,,5,1,4,0,4
27296_1,,,,2,2,1,3
27298_0,,,,2,2,1,3
C=CC(C(C(C(C=O)=O)CO)O)O,,,5,1,2,0,2
27298_1,,,,2,2,1,3
27300_0,,,,2,2,1,3
C(C(C(C(C=C)O)O)C(C=O)O)=O,,,5,1,2,0,2
27300_1,,,,2,2,1,3
27302_0,,,,2,2,1,3
C(C(C(CO)=O)C(C(C=C)O)O)=O,,,5,1,2,0,2
27302_1,,,,2,2,1,3
27304_0,,,,2,2,1,3
C(CC(C(C(C(C=C)O)O)O)=O)=O,,,5,1,2,0,2
27304_1,,,,2,2,1,3
27306_0,,,,2,2,1,3
C(CC(C(C=C)O)O)(C(C=O)O)=O,,,5,1,1,0,1
27308_0,,,,2,2,1,3
C(CC(C(C=C)O)O)=O,,,5,1,4,0,4
27310_0,,,,2,2,1,3
C=CC(C(C(C(C=O)=O)O)O)O,,,5,1,4,0,4
27310_1,,,,2,2,1,3
27312_0,,,,2,2,1,3
C(C(C(C(C=C)O)O)C(C)O)=O,,,5,1,4,0,4
27312_1,,,,2,2,1,3
27314_0,,,,2,2,1,3
C(C(CO)C(C(C=C)O)O)=O,,,5,1,4,0,4
27314_1,,,,2,2,1,3
27316_0,,,,2,2,1,3
C(C(C(C(C=C)O)O)C(CO)O)=O,,,5,1,2,0,2
27316_1,,,,2,2,1,3
27318_0,,,,2,2,1,3
C(C(C(C(C(C(C)=O)=O)O)O)O)=C,,,5,1,2,0,2
27318_1,,,,2,2,1,3
27320_0,,,,2,2,1,3
C(C(C(CC(C(CO)=O)=O)O)O)=C,,,5,1,1,0,1
27322_0,,,,2,2,1,3
C(C)(C(C(C(C=C)O)O)O)=O,,,5,1,4,0,4
27322_1,,,,2,2,1,3
27324_0,,,,2,2,1,3
C(CO)(CC(C(C=C)O)O)=O,,,5,1,3,0,3
27326_0,,,,2,2,1,3
C(C(C(C(C=C)O)O)O)(CCO)=O,,,5,1,2,0,2
27326_1,,,,2,2,1,3
27328_0,,,,2,2,1,3
C(CO)(C(CO)C(C(C=C)O)O)=O,,,5,1,2,0,2
27328_1,,,,2,2,1,3
27330_0,,,,2,2,1,3
C(C(CO)O)(CC(C(C=C)O)O)=O,,,5,1,1,0,1
27332_0,,,,2,2,1,3
C=CC(C(CC(C(O)=O)=O)O)O,,,5,1,3,0,3
27334_0,,,,2,2,1,3
C(C(C=O)C(C(C=C)O)O)(O)=O,,,5,1,4,0,4
27334_1,,,,2,2,1,3
27336_0,,,,2,2,1,3
C=CC(C(C(C(C(O)=O)=O)O)O)O,,,5,1,2,0,2
27336_1,,,,2,2,1,3
27338_0,,,,2,2,1,3
C(C(C(C=O)=O)C(C(C=C)O)O)=O,,,5,1,2,0,2
27338_1,,,,2,2,1,3
27340_0,,,,2,2,1,3
C1(C(C(C(C=C)O)O)OCC1O)=O,,,5,1,2,0,2
27340_1,,,,2,2,1,3
27342_0,,,,2,2,1,3
C1(C(O)OCC1C(C(C=C)O)O)=O,,,5,1,2,0,2
27342_1,,,,2,2,1,3
27344_0,,,,2,2,1,3
C1(COC(C1C(C(C=C)O)O)O)=O,,,5,1,2,0,2
27344_1,,,,2,2,1,3
27346_0,,,,2,2,1,3
C1(C(C(C(C=C)O)O)OC(C1)O)=O,,,5,1,2,0,2
27346_1,,,,2,2,1,3
27348_0,,,,2,2,1,3
C=CC(C(CC(C(C=O)=O)=O)O)O,,,5,1,1,0,1
27350_0,,,,2,2,1,3
C(C(C(C(C=C)O)O)O)=O,,,5,1,7,0,7
27350_1,,,,2,2,1,3
27352_0,,,,2,2,1,3
C(C(CO)(C1C(C=CO1)=O)O)=CC=O,,,5,1,2,0,2
27352_1,,,,2,2,1,3
27354_0,,,,2,2,1,3
C(C(CO)(CC(C=O)=O)O)=CC=O,,,5,1,1,0,1
27356_0,,,,2,2,1,3
C(C(C=O)C(C=CC=O)(CO)O)=O,,,5,1,2,0,2
27356_1,,,,2,2,1,3
27358_0,,,,2,2,1,3
C(CC(C=CC=O)(CO)O)=O,,,5,1,5,0,5
27360_0,,,,2,2,1,3
C(C(CO)C(C=CC=O)(CO)O)=O,,,5,1,2,0,2
27360_1,,,,2,2,1,3
27362_0,,,,2,2,1,3
C(C(C(C=CC=O)(CO)O)O)(C)=O,,,5,1,2,0,2
27362_1,,,,2,2,1,3
27364_0,,,,2,2,1,3
C(CC(C=CC=O)(CO)O)(CO)=O,,,5,1,1,0,1
27365_0,,,,2,2,1,3
27365_1,,,,2,2,1,3
27367_0,,,,2,2,1,3
C1OC(C(C=1)=O)C(C=CC(CO)=O)O,,,5,1,2,0,2
27367_1,,,,2,2,1,3
27369_0,,,,2,2,1,3
C(C(CC(C=O)=O)O)=CC(CO)=O,,,5,1,1,0,1
27371_0,,,,2,2,1,3
C(C(C=O)C(C=CC(CO)=O)O)=O,,,5,1,2,0,2
27371_1,,,,2,2,1,3
27373_0,,,,2,2,1,3
C(CC(C=CC(CO)=O)O)=O,,,5,1,4,0,4
27375_0,,,,2,2,1,3
C(C(CO)C(C=CC(CO)=O)O)=O,,,5,1,2,0,2
27375_1,,,,2,2,1,3
27377_0,,,,2,2,1,3
C(C)(C(C(C=CC(CO)=O)O)O)=O,,,5,1,2,0,2
27377_1,,,,2,2,1,3
27379_0,,,,2,2,1,3
C(CO)(CC(C=CC(CO)=O)O)=O,,,5,1,1,0,1
27381_0,,,,2,2,1,3
C(C(C(C=CC(CO)=O)O)O)=O,,,5,1,8,0,8
27381_1,,,,2,2,1,3
27383_0,,,,2,2,1,3
C=CC(C(C(C=CC=O)=O)O)O,,,5,1,2,0,2
27383_1,,,,2,2,1,3
27385_0,,,,2,2,1,3
C1C(COC=1)(C(C(C=CC=O)=O)O)O,,,5,1,2,0,2
27385_1,,,,2,2,1,3
27386_0,,,,2,2,1,3
27386_1,,,,2,2,1,3
27388_0,,,,2,2,1,3
C(C(C(C(C=CC=O)=O)O)O)(O)=O,,,5,1,3,0,3
27388_1,,,,2,2,1,3
27390_0,,,,2,2,1,3
C(C(C)(C(C(C=CC=O)=O)O)O)=O,,,5,1,3,0,3
27390_1,,,,2,2,1,3
27391_0,,,,2,2,1,3
27391_1,,,,2,2,1,3
27392_0,,,,2,2,1,3
27392_1,,,,2,2,1,3
27394_0,,,,2,2,1,3
C(C=CC(C(C(C)O)O)=O)=O,,,5,1,4,0,4
27394_1,,,,2,2,1,3
27396_0,,,,2,2,1,3
C(C=CC(C(C(CCO)O)O)=O)=O,,,5,1,2,0,2
27396_1,,,,2,2,1,3
27398_0,,,,2,2,1,3
C(C=CC(C(C(CO)(C)O)O)=O)=O,,,5,1,2,0,2
27398_1,,,,2,2,1,3
27400_0,,,,2,2,1,3
C(C(C=C)(C(C(C=CC=O)=O)O)O)=O,,,5,1,3,0,3
27400_1,,,,2,2,1,3
27401_0,,,,2,2,1,3
27401_1,,,,2,2,1,3
27403_0,,,,2,2,1,3
C(C(C(C(C=CC=O)=O)O)O)=CC=O,,,5,1,2,0,2
27403_1,,,,2,2,1,3
27405_0,,,,2,2,1,3
C(C(C(C=CC=O)=O)O)(O)=O,,,5,1,6,0,6
27405_1,,,,2,2,1,3
27407_0,,,,2,2,1,3
C(C=CC(C(C(C(O)O)O)O)=O)=O,,,5,1,2,0,2
27407_1,,,,2,2,1,3
27409_0,,,,2,2,1,3
C(C=CC(C(C(C(C)O)O)O)=O)=O,,,5,1,2,0,2
27409_1,,,,2,2,1,3
27410_0,,,,2,2,1,3
27410_1,,,,2,2,1,3
27412_0,,,,2,2,1,3
C(C=CC(C(C(CO)O)O)=O)=O,,,5,1,5,0,5
27412_1,,,,2,2,1,3
27414_0,,,,2,2,1,3
C(CC(C=CC=O)(C(CO)O)O)=O,,,5,1,1,0,1
27416_0,,,,2,2,1,3
C(CC(C=CC(C(CO)O)=O)O)=O,,,5,1,1,0,1
27418_0,,,,2,2,1,3
C(C(CO)O)=CC(CC(C=O)=O)O,,,5,1,1,0,1
27420_0,,,,2,2,1,3
C(C(C=O)C(C=CC(CO)O)O)=O,,,5,1,2,0,2
27420_1,,,,2,2,1,3
27422_0,,,,2,2,1,3
C(CC(C=CC(CO)O)O)=O,,,5,1,2,0,2
27424_0,,,,2,2,1,3
C(C(CO)C(C=CC(CO)O)O)=O,,,5,1,2,0,2
27424_1,,,,2,2,1,3
27426_0,,,,2,2,1,3
C(C(C(C=CC(CO)O)O)O)(C)=O,,,5,1,2,0,2
27426_1,,,,2,2,1,3
27428_0,,,,2,2,1,3
C(CC(C=CC(CO)O)O)(CO)=O,,,5,1,1,0,1
27430_0,,,,2,2,1,3
C(C(C(C=CC(CO)O)O)O)=O,,,5,1,3,0,3
27430_1,,,,2,2,1,3
27432_0,,,,2,2,1,3
C(CC(C=CC(C(CO)O)O)O)=O,,,5,1,1,0,1
27434_0,,,,2,2,1,3
C(C(C(CC(C=C)O)=O)(C=C)O)=O,,,5,1,1,0,1
27436_0,,,,2,2,1,3
C=CC(C(C(C=CC(O)=O)=O)O)O,,,5,1,2,0,2
27436_1,,,,2,2,1,3
27438_0,,,,2,2,1,3
C=CC(C1C(C=CO1)=O)O,,,5,1,2,0,2
27438_1,,,,2,2,1,3
27440_0,,,,2,2,1,3
C1(C(O)OC(C)C1C(C=C)O)=O,,,5,1,2,0,2
27440_1,,,,2,2,1,3
27442_0,,,,2,2,1,3
C(C1C(C(C(O)O1)=O)C(C=C)O)=O,,,5,1,2,0,2
27442_1,,,,2,2,1,3
27444_0,,,,2,2,1,3
C1(C(C(C=C)O)OC(CC1O)O)=O,,,5,1,2,0,2
27444_1,,,,2,2,1,3
27446_0,,,,2,2,1,3
C=CC(C(C(C=O)=O)CC(C)O)O,,,5,1,1,0,1
27448_0,,,,2,2,1,3
C(C(C(C)O)C(C=O)C(C=C)O)=O,,,5,1,2,0,2
27450_0,,,,2,2,1,3
C=CC(C(C(C=O)=O)CCCO)O,,,5,1,1,0,1
27452_0,,,,2,2,1,3
C(C(CCO)C(C=O)C(C=C)O)=O,,,5,1,2,0,2
27454_0,,,,2,2,1,3
C=CC(C(C(C=O)=O)CCO)O,,,5,1,1,0,1
27456_0,,,,2,2,1,3
C(C(CCC(C=O)=O)C(C=C)O)=O,,,5,1,1,0,1
27458_0,,,,2,2,1,3
C(CCC(C(C=O)=O)C(C=C)O)=O,,,5,1,1,0,1
27460_0,,,,2,2,1,3
C(CCC(C=O)C(C=C)O)(O)=O,,,5,1,1,0,1
27462_0,,,,2,2,1,3
C(C([C](C(O)=O)O)C(C=C)O)=O,,,5,1,2,0,2
27462_1,,,,2,2,1,3
27464_0,,,,2,2,1,3
C(CO)(C(C(C=C)O)O)=O,,,5,1,6,0,6
27464_1,,,,2,2,1,3
27466_0,,,,2,2,1,3
C(C(C(C=C)O)O)(C(CO)O)=O,,,5,1,4,0,4
27466_1,,,,2,2,1,3
27468_0,,,,2,2,1,3
C=CC(CC(C=O)=O)O,,,5,1,3,0,3
27470_0,,,,2,2,1,3
C(C(C=O)C(C=C)O)=O,,,5,1,4,0,4
27470_1,,,,2,2,1,3
27472_0,,,,2,2,1,3
C=CC(C(C(C=O)=O)CO)O,,,5,1,4,0,4
27472_1,,,,2,2,1,3
27474_0,,,,2,2,1,3
C(C(C(C=O)C(C=C)O)O)=O,,,5,1,4,0,4
27474_1,,,,2,2,1,3
27476_0,,,,2,2,1,3
C(C(C(CO)=O)C(C=C)O)=O,,,5,1,4,0,4
27476_1,,,,2,2,1,3
27478_0,,,,2,2,1,3
C(CC(C(C(C=C)O)O)=O)=O,,,5,1,4,0,4
27478_1,,,,2,2,1,3
27480_0,,,,2,2,1,3
C(C(C(CC(C=C)O)=O)O)=O,,,5,1,3,0,3
27482_0,,,,2,2,1,3
C(CC(C=C)O)=O,,,5,1,3,0,3
27484_0,,,,2,2,1,3
C=CC(C(C(C=O)=O)O)O,,,5,1,4,0,4
27484_1,,,,2,2,1,3
27486_0,,,,2,2,1,3
C(C(C(CO)(CO)O)C(C=C)O)=O,,,5,1,2,0,2
27486_1,,,,2,2,1,3
27488_0,,,,2,2,1,3
C(C(C(C=C)O)O)(C(C(C)O)O)=O,,,5,1,2,0,2
27488_1,,,,2,2,1,3
27490_0,,,,2,2,1,3
C(C(C(C=O)C(C=C)O)O)(O)=O,,,5,1,4,0,4
27490_1,,,,2,2,1,3
27492_0,,,,2,2,1,3
C(C(C)(C(C=O)C(C=C)O)O)=O,,,5,1,4,0,4
27492_1,,,,2,2,1,3
27494_0,,,,2,2,1,3
C(C(C(C=C)O)C(C(C)=O)O)=O,,,5,1,4,0,4
27494_1,,,,2,2,1,3
27496_0,,,,2,2,1,3
C(CC(C(CC(C=C)O)=O)O)=O,,,5,1,3,0,3
27498_0,,,,2,2,1,3
C(C(C(C(CC(C=C)O)=O)O)O)=O,,,5,1,1,0,1
27500_0,,,,2,2,1,3
C=CC(C(C(C=O)=O)C(C)O)O,,,5,1,4,0,4
27500_1,,,,2,2,1,3
27502_0,,,,2,2,1,3
C(C(C(C(C=O)=O)C(C=C)O)O)=O,,,5,1,2,0,2
27502_1,,,,2,2,1,3
27504_0,,,,2,2,1,3
C=CC(C(C(C=O)=O)C(CO)O)O,,,5,1,2,0,2
27504_1,,,,2,2,1,3
27506_0,,,,2,2,1,3
C(CC(C(C=O)C(C=C)O)O)=O,,,5,1,4,0,4
27506_1,,,,2,2,1,3
27508_0,,,,2,2,1,3
C(C(C(C(C=O)C(C=C)O)O)O)=O,,,5,1,2,0,2
27508_1,,,,2,2,1,3
27510_0,,,,2,2,1,3
C(C(C(C(C(C=C)O)O)=O)CO)=O,,,5,1,2,0,2
27510_1,,,,2,2,1,3
27512_0,,,,2,2,1,3
C(C(CO)O)(C(C=O)C(C=C)O)=O,,,5,1,2,0,2
27512_1,,,,2,2,1,3
27514_0,,,,2,2,1,3
C(C(CO)C(C=C)O)(C(C=O)O)=O,,,5,1,2,0,2
27514_1,,,,2,2,1,3
27516_0,,,,2,2,1,3
C(C(C(C)O)C(C=C)O)=O,,,5,1,4,0,4
27516_1,,,,2,2,1,3
27518_0,,,,2,2,1,3
C(C(CO)(C(C=O)C(C=C)O)O)=O,,,5,1,2,0,2
27518_1,,,,2,2,1,3
27520_0,,,,2,2,1,3
C(CC(C(C(C(C=C)O)O)=O)O)=O,,,5,1,2,0,2
27520_1,,,,2,2,1,3
27522_0,,,,2,2,1,3
C(C(C(C=C)O)C(C(CO)=O)O)=O,,,5,1,2,0,2
27522_1,,,,2,2,1,3
27524_0,,,,2,2,1,3
C(C(C(C(CO)O)O)C(C=C)O)=O,,,5,1,2,0,2
27524_1,,,,2,2,1,3
27526_0,,,,2,2,1,3
C(C(CO)C(C=C)O)=O,,,5,1,4,0,4
27526_1,,,,2,2,1,3
27528_0,,,,2,2,1,3
C(C(C(CO)O)C(C=C)O)=O,,,5,1,4,0,4
27528_1,,,,2,2,1,3
27530_0,,,,2,2,1,3
C(C(C(C(C(C=C)O)O)=O)O)=O,,,5,1,4,0,4
27530_1,,,,2,2,1,3
27532_0,,,,2,2,1,3
C(C(C(C(C(C=C)O)O)=O)O)(O)=O,,,5,1,2,0,2
27532_1,,,,2,2,1,3
27534_0,,,,2,2,1,3
C=CC(C(C(C(C)=O)=O)O)O,,,5,1,4,0,4
27534_1,,,,2,2,1,3
27536_0,,,,2,2,1,3
C=CC(CC(C(CO)=O)=O)O,,,5,1,3,0,3
27538_0,,,,2,2,1,3
C(C)(C(C(C=C)O)O)=O,,,5,1,5,0,5
27538_1,,,,2,2,1,3
27540_0,,,,2,2,1,3
C(CO)(CC(C=C)O)=O,,,5,1,3,0,3
27542_0,,,,2,2,1,3
C(C(C(C=C)O)O)(CCO)=O,,,5,1,4,0,4
27542_1,,,,2,2,1,3
27544_0,,,,2,2,1,3
C(CO)(C(CO)C(C=C)O)=O,,,5,1,4,0,4
27544_1,,,,2,2,1,3
27546_0,,,,2,2,1,3
C(CC(C=C)O)(C(CO)O)=O,,,5,1,3,0,3
27548_0,,,,2,2,1,3
C=CC(CC(C(O)=O)=O)O,,,5,1,3,0,3
27550_0,,,,2,2,1,3
C(C(C=O)C(C=C)O)(O)=O,,,5,1,4,0,4
27550_1,,,,2,2,1,3
27552_0,,,,2,2,1,3
C=CC(C(C(C(O)=O)=O)CO)O,,,5,1,4,0,4
27552_1,,,,2,2,1,3
27554_0,,,,2,2,1,3
C(C(C(CO)=O)C(C=C)O)(O)=O,,,5,1,4,0,4
27554_1,,,,2,2,1,3
27556_0,,,,2,2,1,3
C(CC(C(C(C=C)O)O)=O)(O)=O,,,5,1,4,0,4
27556_1,,,,2,2,1,3
27558_0,,,,2,2,1,3
C(C(C(CC(C=C)O)=O)O)(O)=O,,,5,1,3,0,3
27560_0,,,,2,2,1,3
C=CC(C(C(C(O)=O)=O)O)O,,,5,1,4,0,4
27560_1,,,,2,2,1,3
27562_0,,,,2,2,1,3
C(CC(C=C)O)(C(C=O)(CO)O)=O,,,5,1,1,0,1
27564_0,,,,2,2,1,3
C(C(C(C(CO)=O)C(C=C)O)O)=O,,,5,1,2,0,2
27564_1,,,,2,2,1,3
27566_0,,,,2,2,1,3
C(C(CC(C(C(C=C)O)O)=O)O)=O,,,5,1,2,0,2
27566_1,,,,2,2,1,3
27568_0,,,,2,2,1,3
C(C(C(C=O)=O)C(C=C)O)=O,,,5,1,4,0,4
27568_1,,,,2,2,1,3
27570_0,,,,2,2,1,3
C(C(C(C=O)=O)C(C=C)O)(O)=O,,,5,1,4,0,4
27570_1,,,,2,2,1,3
27572_0,,,,2,2,1,3
C(C(C(C(O)=O)=O)C(C=C)O)=O,,,5,1,4,0,4
27572_1,,,,2,2,1,3
27574_0,,,,2,2,1,3
C1(C(C(C=C)O)OCC1O)=O,,,5,1,4,0,4
27574_1,,,,2,2,1,3
27576_0,,,,2,2,1,3
C1(C(O)OCC1C(C=C)O)=O,,,5,1,4,0,4
27576_1,,,,2,2,1,3
27578_0,,,,2,2,1,3
C1(COC(C1C(C=C)O)O)=O,,,5,1,4,0,4
27578_1,,,,2,2,1,3
27580_0,,,,2,2,1,3
C1(C(C(C=C)O)OC(C1)O)=O,,,5,1,4,0,4
27580_1,,,,2,2,1,3
27582_0,,,,2,2,1,3
C=CC(CC(C(C=O)=O)=O)O,,,5,1,3,0,3
27584_0,,,,2,2,1,3
C(C(C(C=C)O)O)=O,,,5,1,8,0,8
27584_1,,,,2,2,1,3
27586_0,,,,2,2,1,3
C(CC(CO)(C(C=C)(CO)O)O)=O,,,5,1,1,0,1
27588_0,,,,2,2,1,3
C(C(C(C)O)O)(C(C=C)(CO)O)=O,,,5,1,2,0,2
27588_1,,,,2,2,1,3
27590_0,,,,2,2,1,3
C(C(C(O)=O)O)(C(C=C)(CO)O)=O,,,5,1,2,0,2
27590_1,,,,2,2,1,3
27592_0,,,,2,2,1,3
C(C(CO)O)(C(C=C)(CO)O)=O,,,5,1,4,0,4
27592_1,,,,2,2,1,3
27594_0,,,,2,2,1,3
C(C(C(CCO)=O)(C(C=O)=C)O)=O,,,5,1,1,0,1
27596_0,,,,2,2,1,3
C(CC(C(C(C=O)=C)(CO)O)O)=O,,,5,1,1,0,1
27598_0,,,,2,2,1,3
C(CC(C(C(C=O)(CO)O)=C)O)=O,,,5,1,1,0,1
27600_0,,,,2,2,1,3
C(C(C(CCO)=O)(C=CC=O)O)=O,,,5,1,1,0,1
27602_0,,,,2,2,1,3
C(CC(C(C=CC=O)(CO)O)O)=O,,,5,1,1,0,1
27604_0,,,,2,2,1,3
C(CC(C=CC(C=O)(CO)O)O)=O,,,5,1,1,0,1
27606_0,,,,2,2,1,3
C(CC(C(C(C)=O)(C=C)O)O)=O,,,5,1,2,0,2
27608_0,,,,2,2,1,3
C(C(C(C(C(C)=O)(C=C)O)O)O)=O,,,5,1,2,0,2
27608_1,,,,2,2,1,3
27610_0,,,,2,2,1,3
C(C(C=C)(C(C)(CC=O)O)O)=O,,,5,1,3,0,3
27612_0,,,,2,2,1,3
C(C(C=C)(C(C)(C(C=O)O)O)O)=O,,,5,1,4,0,4
27612_1,,,,2,2,1,3
27614_0,,,,2,2,1,3
C(C(C(CC(C=O)O)=O)(C=C)O)=O,,,5,1,1,0,1
27616_0,,,,2,2,1,3
C(C(C(CC(C)O)=O)(C=C)O)=O,,,5,1,2,0,2
27618_0,,,,2,2,1,3
C(C(C(CC(O)=O)=O)(C=C)O)=O,,,5,1,2,0,2
27620_0,,,,2,2,1,3
C(C(C(CCO)=O)(C=C)O)=O,,,5,1,3,0,3
27622_0,,,,2,2,1,3
C(C(C(CC(CO)O)=O)(C=C)O)=O,,,5,1,1,0,1
27624_0,,,,2,2,1,3
C(CC(C=O)(C(C=C)(CO)O)O)=O,,,5,1,3,0,3
27626_0,,,,2,2,1,3
C(CC(C(C(C=C)(CO)O)=O)O)=O,,,5,1,1,0,1
27628_0,,,,2,2,1,3
C(C(CO)(C(CC(C=O)=O)O)O)=C,,,5,1,1,0,1
27630_0,,,,2,2,1,3
C(C(C=O)C(C(C=C)(CO)O)O)=O,,,5,1,2,0,2
27630_1,,,,2,2,1,3
27632_0,,,,2,2,1,3
C(CC(C(C=C)(CO)O)O)=O,,,5,1,2,0,2
27634_0,,,,2,2,1,3
C(C(CO)C(C(C=C)(CO)O)O)=O,,,5,1,2,0,2
27634_1,,,,2,2,1,3
27636_0,,,,2,2,1,3
C(C)(C(C(C(C=C)(CO)O)O)O)=O,,,5,1,2,0,2
27636_1,,,,2,2,1,3
27638_0,,,,2,2,1,3
C(CO)(CC(C(C=C)(CO)O)O)=O,,,5,1,1,0,1
27640_0,,,,2,2,1,3
C(C(C(C(C=C)(CO)O)O)O)=O,,,5,1,3,0,3
27640_1,,,,2,2,1,3
27642_0,,,,2,2,1,3
C(CC(C(C=C)(C(CO)O)O)O)=O,,,5,1,1,0,1
27644_0,,,,2,2,1,3
C(C(C(C=O)=C)(C(C=O)CO)O)=O,,,5,1,4,0,4
27644_1,,,,2,2,1,3
27646_0,,,,2,2,1,3
C(CC(C(C(C(O)=O)=C)(C)O)O)=O,,,5,1,1,0,1
27648_0,,,,2,2,1,3
C(CC(C(C(C(O)=O)(C)O)=C)O)=O,,,5,1,1,0,1
27650_0,,,,2,2,1,3
C(C(C(C(CC=O)O)=C)O)(O)=O,,,5,1,5,0,5
27652_0,,,,2,2,1,3
C(C(C(C(C(C=O)O)O)=C)O)(O)=O,,,5,1,2,0,2
27652_1,,,,2,2,1,3
27654_0,,,,2,2,1,3
C(CC(C)(C(C(C(O)=O)=C)O)O)=O,,,5,1,1,0,1
27656_0,,,,2,2,1,3
C(CC(C)O)(C(C(C(O)=O)=C)O)=O,,,5,1,1,0,1
27658_0,,,,2,2,1,3
C(CC(C(C(C(O)=O)=C)O)=O)(O)=O,,,5,1,1,0,1
27659_0,,,,2,2,1,3
27660_0,,,,2,2,1,3
27660_1,,,,2,2,1,3
27662_0,,,,2,2,1,3
C(CC(CC(C(C(O)=O)=C)O)O)=O,,,5,1,1,0,1
27664_0,,,,2,2,1,3
C(C(C(C)O)C(C(C(O)=O)=C)O)=O,,,5,1,2,0,2
27664_1,,,,2,2,1,3
27666_0,,,,2,2,1,3
C(C(C=O)C(C(C(O)=O)=C)O)(O)=O,,,5,1,2,0,2
27666_1,,,,2,2,1,3
27668_0,,,,2,2,1,3
C(C(CO)C(C(C(O)=O)=C)O)=O,,,5,1,3,0,3
27668_1,,,,2,2,1,3
27670_0,,,,2,2,1,3
C(CC(C=CC(C(O)=O)(C)O)O)=O,,,5,1,1,0,1
27672_0,,,,2,2,1,3
C(C(C=CC(CC=O)O)O)(O)=O,,,5,1,5,0,5
27674_0,,,,2,2,1,3
C(C(C=CC(C(C=O)O)O)O)(O)=O,,,5,1,4,0,4
27674_1,,,,2,2,1,3
27676_0,,,,2,2,1,3
C(C(C=CC(C(CO)O)=O)O)(O)=O,,,5,1,4,0,4
27676_1,,,,2,2,1,3
27678_0,,,,2,2,1,3
C(C(CO)O)(C(C(C(O)=O)=C)O)=O,,,5,1,3,0,3
27678_1,,,,2,2,1,3
27679_0,,,,2,2,1,3
27681_0,,,,2,2,1,3
C(C(C(C(C(C(O)=O)=C)O)O)O)=O,,,5,1,2,0,2
27681_1,,,,2,2,1,3
27683_0,,,,2,2,1,3
C(CC(C=C(C=O)CO)(CO)O)=O,,,5,1,1,0,1
27685_0,,,,2,2,1,3
C(CC(C(CO)=CC(CO)=O)O)=O,,,5,1,1,0,1
27687_0,,,,2,2,1,3
C(C=C(C=O)CO)(C(C(C)O)O)=O,,,5,1,2,0,2
27687_1,,,,2,2,1,3
27689_0,,,,2,2,1,3
C(C(C(C=C(C=O)CO)=O)O)(O)=O,,,5,1,4,0,4
27689_1,,,,2,2,1,3
27691_0,,,,2,2,1,3
C(C=C(C=O)CO)(C(CO)O)=O,,,5,1,6,0,6
27691_1,,,,2,2,1,3
27693_0,,,,2,2,1,3
C(CC(C=C)(C(C=O)(CO)O)O)=O,,,5,1,1,0,1
27695_0,,,,2,2,1,3
C(CC(C(C(C=C)=O)(CO)O)O)=O,,,5,1,1,0,1
27697_0,,,,2,2,1,3
C(CC(C(C=O)=C)(C(CO)O)O)=O,,,5,1,1,0,1
27699_0,,,,2,2,1,3
C(CC(C(C(C(CO)O)=O)=C)O)=O,,,5,1,1,0,1
27701_0,,,,2,2,1,3
C(C(C(C=O)=C)(C1C(C=CO1)=O)O)=O,,,5,1,2,0,2
27701_1,,,,2,2,1,3
27703_0,,,,2,2,1,3
C(C(C(C=O)=C)(CC(C=O)=O)O)=O,,,5,1,1,0,1
27705_0,,,,2,2,1,3
C(C(C=O)C(C=O)(C(C=O)=C)O)=O,,,5,1,2,0,2
27705_1,,,,2,2,1,3
27706_0,,,,2,2,1,3
27707_0,,,,2,2,1,3
27707_1,,,,2,2,1,3
27709_0,,,,2,2,1,3
C(C(C(C=O)=C)(C(C(C)=O)O)O)=O,,,5,1,3,0,3
27709_1,,,,2,2,1,3
27711_0,,,,2,2,1,3
C(C(C(C=O)=C)(CC(CO)=O)O)=O,,,5,1,1,0,1
27712_0,,,,2,2,1,3
27712_1,,,,2,2,1,3
27714_0,,,,2,2,1,3
C=C(C=O)C(C(C1C(C=CO1)=O)O)=O,,,5,1,2,0,2
27714_1,,,,2,2,1,3
27716_0,,,,2,2,1,3
C=C(C=O)C(C(CC(C=O)=O)O)=O,,,5,1,1,0,1
27718_0,,,,2,2,1,3
C(C(C=O)C(C(C(C=O)=C)=O)O)=O,,,5,1,2,0,2
27718_1,,,,2,2,1,3
27720_0,,,,2,2,1,3
C(CC(C(C(C=O)=C)=O)O)=O,,,5,1,4,0,4
27722_0,,,,2,2,1,3
C(C(CO)C(C(C(C=O)=C)=O)O)=O,,,5,1,2,0,2
27722_1,,,,2,2,1,3
27723_0,,,,2,2,1,3
27723_1,,,,2,2,1,3
27725_0,,,,2,2,1,3
C(CO)(CC(C(C(C=O)=C)=O)O)=O,,,5,1,1,0,1
27726_0,,,,2,2,1,3
27726_1,,,,2,2,1,3
27728_0,,,,2,2,1,3
C=C(C(C=O)=O)C(C1C(C=CO1)=O)O,,,5,1,2,0,2
27728_1,,,,2,2,1,3
27730_0,,,,2,2,1,3
C=C(C(C=O)=O)C(CC(C=O)=O)O,,,5,1,1,0,1
27732_0,,,,2,2,1,3
C(C(C=O)C(C(C(C=O)=O)=C)O)=O,,,5,1,2,0,2
27732_1,,,,2,2,1,3
27733_0,,,,2,2,1,3
27734_0,,,,2,2,1,3
27734_1,,,,2,2,1,3
27736_0,,,,2,2,1,3
C(C)(C(C(C(C(C=O)=O)=C)O)O)=O,,,5,1,2,0,2
27736_1,,,,2,2,1,3
27738_0,,,,2,2,1,3
C(CO)(CC(C(C(C=O)=O)=C)O)=O,,,5,1,1,0,1
27740_0,,,,2,2,1,3
C(C(C(C(C(C=O)=O)=C)O)O)=O,,,5,1,5,0,5
27740_1,,,,2,2,1,3
27742_0,,,,2,2,1,3
C(C(C(C=O)=CCO)(CC=O)O)=O,,,5,1,1,0,1
27744_0,,,,2,2,1,3
C(CC(C(C(C=O)=CCO)=O)O)=O,,,5,1,1,0,1
27746_0,,,,2,2,1,3
C(CC(C(C(C=O)=O)=CCO)O)=O,,,5,1,1,0,1
27748_0,,,,2,2,1,3
C(C(C=CCO)(CC=O)O)(O)=O,,,5,1,3,0,3
27750_0,,,,2,2,1,3
C(C(C=CCO)(C(C=O)O)O)(O)=O,,,5,1,3,0,3
27750_1,,,,2,2,1,3
27752_0,,,,2,2,1,3
C(CC(C=CC(O)=O)(CO)O)=O,,,5,1,2,0,2
27754_0,,,,2,2,1,3
C(C(C(C=CC(O)=O)(CO)O)O)=O,,,5,1,3,0,3
27754_1,,,,2,2,1,3
27755_0,,,,2,2,1,3
27755_1,,,,2,2,1,3
27757_0,,,,2,2,1,3
C(C=CC(C(C(C)O)O)=O)(O)=O,,,5,1,3,0,3
27757_1,,,,2,2,1,3
27759_0,,,,2,2,1,3
C(C(C(C=CC(O)=O)=O)O)(O)=O,,,5,1,5,0,5
27759_1,,,,2,2,1,3
27760_0,,,,2,2,1,3
27760_1,,,,2,2,1,3
27762_0,,,,2,2,1,3
C(C=CC(C(C(CO)O)O)=O)(O)=O,,,5,1,2,0,2
27762_1,,,,2,2,1,3
27764_0,,,,2,2,1,3
C(C(C(C=C)(CC=O)O)O)(O)=O,,,5,1,2,0,2
27766_0,,,,2,2,1,3
C(C(C(C=C)(C(C=O)O)O)O)(O)=O,,,5,1,3,0,3
27766_1,,,,2,2,1,3
27768_0,,,,2,2,1,3
C1OCC(C=1)(C2C(C=CO2)=O)O,,,5,1,2,0,2
27768_1,,,,2,2,1,3
27770_0,,,,2,2,1,3
C(C(C1(C=COC1)O)O)(CO)=O,,,5,1,3,0,3
27770_1,,,,2,2,1,3
27772_0,,,,2,2,1,3
C1C(COC=1)(CC(C=O)=O)O,,,5,1,2,0,2
27774_0,,,,2,2,1,3
C(C(C=O)C1(C=COC1)O)=O,,,5,1,3,0,3
27774_1,,,,2,2,1,3
27776_0,,,,2,2,1,3
C1OCC(C=1)(C(C(C=O)=O)CO)O,,,5,1,2,0,2
27776_1,,,,2,2,1,3
27778_0,,,,2,2,1,3
C(C(C(C=O)C1(C=COC1)O)O)=O,,,5,1,2,0,2
27778_1,,,,2,2,1,3
27780_0,,,,2,2,1,3
C(C(C(CO)=O)C1(C=COC1)O)=O,,,5,1,2,0,2
27780_1,,,,2,2,1,3
27782_0,,,,2,2,1,3
C(CC(C(C1(C=COC1)O)O)=O)=O,,,5,1,2,0,2
27782_1,,,,2,2,1,3
27784_0,,,,2,2,1,3
C(C(C(CC1(C=COC1)O)=O)O)=O,,,5,1,1,0,1
27786_0,,,,2,2,1,3
C(CC1(C=COC1)O)=O,,,5,1,2,0,2
27788_0,,,,2,2,1,3
C1C(COC=1)(C(C(C=O)=O)O)O,,,5,1,3,0,3
27788_1,,,,2,2,1,3
27790_0,,,,2,2,1,3
C(C(C(C)O)C1(C=COC1)O)=O,,,5,1,3,0,3
27790_1,,,,2,2,1,3
27792_0,,,,2,2,1,3
C(C(CO)C1(C=COC1)O)=O,,,5,1,3,0,3
27792_1,,,,2,2,1,3
27794_0,,,,2,2,1,3
C(C(C(CO)O)C1(C=COC1)O)=O,,,5,1,2,0,2
27794_1,,,,2,2,1,3
27796_0,,,,2,2,1,3
C1C(COC=1)(C(C(C(C)=O)=O)O)O,,,5,1,2,0,2
27796_1,,,,2,2,1,3
27798_0,,,,2,2,1,3
C1C(COC=1)(CC(C(CO)=O)=O)O,,,5,1,1,0,1
27800_0,,,,2,2,1,3
C(C(C1(C=COC1)O)O)(C)=O,,,5,1,3,0,3
27800_1,,,,2,2,1,3
27802_0,,,,2,2,1,3
C(CC1(C=COC1)O)(CO)=O,,,5,1,2,0,2
27804_0,,,,2,2,1,3
C(C(C1(C=COC1)O)O)(CCO)=O,,,5,1,2,0,2
27804_1,,,,2,2,1,3
27806_0,,,,2,2,1,3
C(CO)(C(CO)C1(C=COC1)O)=O,,,5,1,2,0,2
27806_1,,,,2,2,1,3
27808_0,,,,2,2,1,3
C(CC1(C=COC1)O)(C(CO)O)=O,,,5,1,1,0,1
27810_0,,,,2,2,1,3
C1OCC(C=1)(CC(C(O)=O)=O)O,,,5,1,2,0,2
27812_0,,,,2,2,1,3
C(C(C=O)C1(C=COC1)O)(O)=O,,,5,1,3,0,3
27812_1,,,,2,2,1,3
27814_0,,,,2,2,1,3
C1OCC(C=1)(C(C(C(O)=O)=O)O)O,,,5,1,2,0,2
27814_1,,,,2,2,1,3
27816_0,,,,2,2,1,3
C(C(C(C=O)=O)C1(C=COC1)O)=O,,,5,1,2,0,2
27816_1,,,,2,2,1,3
27818_0,,,,2,2,1,3
C1(C(C2(C=COC2)O)OCC1O)=O,,,5,1,2,0,2
27818_1,,,,2,2,1,3
27820_0,,,,2,2,1,3
C1(C(O)OCC1C2(C=COC2)O)=O,,,5,1,2,0,2
27820_1,,,,2,2,1,3
27822_0,,,,2,2,1,3
C1(COC(C1C2(C=COC2)O)O)=O,,,5,1,2,0,2
27822_1,,,,2,2,1,3
27824_0,,,,2,2,1,3
C1(C(C2(C=COC2)O)OC(C1)O)=O,,,5,1,2,0,2
27824_1,,,,2,2,1,3
27826_0,,,,2,2,1,3
C1C(COC=1)(CC(C(C=O)=O)=O)O,,,5,1,1,0,1
27828_0,,,,2,2,1,3
C(C(C1(C=COC1)O)O)=O,,,5,1,3,0,3
27828_1,,,,2,2,1,3
27830_0,,,,2,2,1,3
C1OC(C(C=1)=O)C(C(CO)O)O,,,5,1,3,0,3
27830_1,,,,2,2,1,3
27832_0,,,,2,2,1,3
C(C(C1C(C=CO1)=O)O)=O,,,5,1,3,0,3
27832_1,,,,2,2,1,3
27834_0,,,,2,2,1,3
C1OC(C(C=1)=O)C(CO)(CO)O,,,5,1,3,0,3
27834_1,,,,2,2,1,3
27836_0,,,,2,2,1,3
C(C(C1C(C=CO1)=O)O)(O)=O,,,5,1,3,0,3
27836_1,,,,2,2,1,3
27838_0,,,,2,2,1,3
C(C(C)(C1C(C=CO1)=O)O)=O,,,5,1,3,0,3
27838_1,,,,2,2,1,3
27840_0,,,,2,2,1,3
C(C)(C(C1C(C=CO1)=O)O)=O,,,5,1,3,0,3
27840_1,,,,2,2,1,3
27842_0,,,,2,2,1,3
C(CC(C1C(C=CO1)=O)O)=O,,,5,1,3,0,3
27842_1,,,,2,2,1,3
27844_0,,,,2,2,1,3
C(C(CCO)(C1C(C=CO1)=O)O)=O,,,5,1,2,0,2
27844_1,,,,2,2,1,3
27846_0,,,,2,2,1,3
C(C(C1C(C=CO1)=O)O)(CCO)=O,,,5,1,2,0,2
27846_1,,,,2,2,1,3
27848_0,,,,2,2,1,3
C(CC(C(C1C(C=CO1)=O)O)O)=O,,,5,1,2,0,2
27848_1,,,,2,2,1,3
27850_0,,,,2,2,1,3
C(C(CC(C1C(C=CO1)=O)O)O)=O,,,5,1,2,0,2
27850_1,,,,2,2,1,3
27852_0,,,,2,2,1,3
C(CO)(CC(C1C(C=CO1)=O)O)=O,,,5,1,2,0,2
27852_1,,,,2,2,1,3
27854_0,,,,2,2,1,3
C(CC(CO)(C1C(C=CO1)=O)O)=O,,,5,1,2,0,2
27854_1,,,,2,2,1,3
27856_0,,,,2,2,1,3
C(C)(C(C(C1C(C=CO1)=O)O)O)=O,,,5,1,2,0,2
27856_1,,,,2,2,1,3
27858_0,,,,2,2,1,3
C(C(C(C)(C1C(C=CO1)=O)O)O)=O,,,5,1,2,0,2
27858_1,,,,2,2,1,3
27860_0,,,,2,2,1,3
C1OC(C(C=1)=O)C(C)O,,,5,1,3,0,3
27860_1,,,,2,2,1,3
27862_0,,,,2,2,1,3
C(C(CO)(C1C(C=CO1)=O)O)=O,,,5,1,3,0,3
27862_1,,,,2,2,1,3
27864_0,,,,2,2,1,3
C(CO)(C(C1C(C=CO1)=O)O)=O,,,5,1,3,0,3
27864_1,,,,2,2,1,3
27866_0,,,,2,2,1,3
C(C(CO)C(C1C(C=CO1)=O)O)=O,,,5,1,2,0,2
27866_1,,,,2,2,1,3
27868_0,,,,2,2,1,3
C1OC(C(C=1)=O)C(CC(C)O)O,,,5,1,3,0,3
27868_1,,,,2,2,1,3
27870_0,,,,2,2,1,3
C1OC(C(C=1)=O)C(C(C(C)O)O)O,,,5,1,2,0,2
27870_1,,,,2,2,1,3
27872_0,,,,2,2,1,3
C1OC(C(C=1)=O)C(CCO)O,,,5,1,3,0,3
27872_1,,,,2,2,1,3
27874_0,,,,2,2,1,3
C1OC(C(C=1)=O)C(CC(CO)O)O,,,5,1,2,0,2
27874_1,,,,2,2,1,3
27876_0,,,,2,2,1,3
C(C)(C(CO)(C1C(C=CO1)=O)O)=O,,,5,1,2,0,2
27876_1,,,,2,2,1,3
27878_0,,,,2,2,1,3
C(CO)(C(C)(C1C(C=CO1)=O)O)=O,,,5,1,2,0,2
27878_1,,,,2,2,1,3
27880_0,,,,2,2,1,3
C(C(C(C)O)(C1C(C=CO1)=O)O)=O,,,5,1,2,0,2
27880_1,,,,2,2,1,3
27882_0,,,,2,2,1,3
C(C(C1C(C=CO1)=O)O)(C(C)O)=O,,,5,1,2,0,2
27882_1,,,,2,2,1,3
27884_0,,,,2,2,1,3
C(C(C(C1C(C=CO1)=O)O)O)=O,,,5,1,3,0,3
27884_1,,,,2,2,1,3
27886_0,,,,2,2,1,3
C1OC(C(C=1)=O)C(C)(CO)O,,,5,1,3,0,3
27886_1,,,,2,2,1,3
27888_0,,,,2,2,1,3
C1OC(C(C=1)=O)C(CO)(CCO)O,,,5,1,2,0,2
27888_1,,,,2,2,1,3
27890_0,,,,2,2,1,3
C1OC(C(C=1)=O)C(C(CCO)O)O,,,5,1,2,0,2
27890_1,,,,2,2,1,3
27892_0,,,,2,2,1,3
C1OC(C(C=1)=O)C(C)(C(CO)O)O,,,5,1,2,0,2
27892_1,,,,2,2,1,3
27894_0,,,,2,2,1,3
C(C(C)(C1C(C=CO1)=O)O)(O)=O,,,5,1,3,0,3
27894_1,,,,2,2,1,3
27896_0,,,,2,2,1,3
C(CC(C1C(C=CO1)=O)O)(O)=O,,,5,1,3,0,3
27896_1,,,,2,2,1,3
27898_0,,,,2,2,1,3
C(C(CO)(C1C(C=CO1)=O)O)(O)=O,,,5,1,2,0,2
27898_1,,,,2,2,1,3
27900_0,,,,2,2,1,3
C(CC(C=O)(C1C(C=CO1)=O)O)=O,,,5,1,2,0,2
27900_1,,,,2,2,1,3
27902_0,,,,2,2,1,3
C(CC(C(C1C(C=CO1)=O)O)=O)=O,,,5,1,2,0,2
27902_1,,,,2,2,1,3
27904_0,,,,2,2,1,3
C1OC(C(C=1)=O)C(CC(C=O)=O)O,,,5,1,2,0,2
27904_1,,,,2,2,1,3
27906_0,,,,2,2,1,3
C1OC(C(C=1)=O)C2(COCC2O)O,,,5,1,2,0,2
27906_1,,,,2,2,1,3
27908_0,,,,2,2,1,3
C1OC(C(C=1)=O)C2(C(O)OCC2)O,,,5,1,2,0,2
27908_1,,,,2,2,1,3
27910_0,,,,2,2,1,3
C1OC(C(C=1)=O)C2(COC(C2)O)O,,,5,1,2,0,2
27910_1,,,,2,2,1,3
27912_0,,,,2,2,1,3
C(C(C(C)=O)(C1C(C=CO1)=O)O)=O,,,5,1,2,0,2
27912_1,,,,2,2,1,3
27914_0,,,,2,2,1,3
C1OC(C(C=1)=O)C(C(C(C)=O)=O)O,,,5,1,2,0,2
27914_1,,,,2,2,1,3
27916_0,,,,2,2,1,3
C1OC(C(C=1)=O)C(C(C=O)=O)(C)O,,,5,1,2,0,2
27916_1,,,,2,2,1,3
27918_0,,,,2,2,1,3
C(C(C=C)(C1C(C=CO1)=O)O)=O,,,5,1,3,0,3
27918_1,,,,2,2,1,3
27920_0,,,,2,2,1,3
C1OC(C(C=1)=O)C(C(C=C)=O)O,,,5,1,3,0,3
27920_1,,,,2,2,1,3
27922_0,,,,2,2,1,3
C1OC(C(C=1)=O)C(C=CC=O)O,,,5,1,3,0,3
27922_1,,,,2,2,1,3
27924_0,,,,2,2,1,3
C(C1C(C=CO1)=O)(O)=O,,,5,1,3,0,3
27924_1,,,,2,2,1,3
27926_0,,,,2,2,1,3
C1OC(C(C=1)=O)C(C(O)O)O,,,5,1,3,0,3
27926_1,,,,2,2,1,3
27928_0,,,,2,2,1,3
C1OC(C(C=1)=O)C(C(C)O)O,,,5,1,3,0,3
27928_1,,,,2,2,1,3
27930_0,,,,2,2,1,3
C1OC(C(C=1)=O)CO,,,5,1,3,0,3
27930_1,,,,2,2,1,3
27932_0,,,,2,2,1,3
C1OC(C(C=1)=O)C(CO)O,,,5,1,3,0,3
27932_1,,,,2,2,1,3
27933_0,,,,2,2,1,3
27933_1,,,,2,2,1,3
27934_0,,,,2,2,1,3
27934_1,,,,2,2,1,3
27936_0,,,,2,2,1,3
C(CC1(CC(C(O)=O)OC1O)O)=O,,,5,1,2,0,2
27938_0,,,,2,2,1,3
C1(C(OC(C(O)=O)C1C(C)O)O)=O,,,5,1,3,0,3
27938_1,,,,2,2,1,3
27940_0,,,,2,2,1,3
C(C1C(C(O)OC1C(O)=O)=O)(O)=O,,,5,1,3,0,3
27940_1,,,,2,2,1,3
27941_0,,,,2,2,1,3
27941_1,,,,2,2,1,3
27943_0,,,,2,2,1,3
C(CC(C1(CC(C(O1)=O)O)O)O)=O,,,5,1,2,0,2
27945_0,,,,2,2,1,3
C(CC(C1C(O)OC(C1O)=O)O)=O,,,5,1,2,0,2
27947_0,,,,2,2,1,3
C(C1(C)CC(C(O1)O)(CC=O)O)=O,,,5,1,2,0,2
27949_0,,,,2,2,1,3
C(CC(C1(C)CC(C(O)O1)=O)O)=O,,,5,1,2,0,2
27951_0,,,,2,2,1,3
C(C1(C)C(C(C(O1)O)=O)C(C)O)=O,,,5,1,3,0,3
27951_1,,,,2,2,1,3
27953_0,,,,2,2,1,3
C(C1(C)C(C(O)=O)C(C(O1)O)=O)=O,,,5,1,3,0,3
27953_1,,,,2,2,1,3
27954_0,,,,2,2,1,3
27954_1,,,,2,2,1,3
27956_0,,,,2,2,1,3
C(CC1(CC(C(C)=O)OC1O)O)=O,,,5,1,2,0,2
27958_0,,,,2,2,1,3
C(CC(C)(C1CC(C(O)O1)=O)O)=O,,,5,1,2,0,2
27960_0,,,,2,2,1,3
C(C1C(C(C(O1)O)=O)C(C)O)(C)=O,,,5,1,3,0,3
27960_1,,,,2,2,1,3
27962_0,,,,2,2,1,3
C(C1C(C(O)OC1C(C)=O)=O)(O)=O,,,5,1,3,0,3
27962_1,,,,2,2,1,3
27963_0,,,,2,2,1,3
27963_1,,,,2,2,1,3
27965_0,,,,2,2,1,3
C1(C(OC(C(CC(C)O)=O)C1)O)=O,,,5,1,2,0,2
27967_0,,,,2,2,1,3
C(CC(C1CC(C(O)O1)=O)=O)(O)=O,,,5,1,2,0,2
27968_0,,,,2,2,1,3
27969_0,,,,2,2,1,3
27971_0,,,,2,2,1,3
C(CC(CC1CC(C(O)O1)=O)O)=O,,,5,1,2,0,2
27973_0,,,,2,2,1,3
C(CC1CC(C(O)O1)(CC=O)O)=O,,,5,1,2,0,2
27975_0,,,,2,2,1,3
C(C(C1CC(C(O)O1)=O)C(C)O)=O,,,5,1,3,0,3
27975_1,,,,2,2,1,3
27977_0,,,,2,2,1,3
C(C(C=O)C1CC(C(O)O1)=O)(O)=O,,,5,1,3,0,3
27977_1,,,,2,2,1,3
27979_0,,,,2,2,1,3
C(C(CO)C1CC(C(O)O1)=O)=O,,,5,1,4,0,4
27979_1,,,,2,2,1,3
27981_0,,,,2,2,1,3
C(CC1C(C(C(O)O1)=O)C(C)O)=O,,,5,1,3,0,3
27981_1,,,,2,2,1,3
27983_0,,,,2,2,1,3
C(CC1C(C(O)=O)C(C(O)O1)=O)=O,,,5,1,3,0,3
27983_1,,,,2,2,1,3
27984_0,,,,2,2,1,3
27984_1,,,,2,2,1,3
27986_0,,,,2,2,1,3
C(C(CC1(C(O)OC(C)C1)O)=O)=O,,,5,1,2,0,2
27988_0,,,,2,2,1,3
C(C(C=O)C1(C(O)OC(C)C1)O)=O,,,5,1,3,0,3
27988_1,,,,2,2,1,3
27990_0,,,,2,2,1,3
C(CC1(C(O)OC(C)C1)O)=O,,,5,1,2,0,2
27992_0,,,,2,2,1,3
C(C(CO)C1(C(O)OC(C)C1)O)=O,,,5,1,3,0,3
27992_1,,,,2,2,1,3
27994_0,,,,2,2,1,3
C(C)(C(C1(C(O)OC(C)C1)O)O)=O,,,5,1,3,0,3
27994_1,,,,2,2,1,3
27996_0,,,,2,2,1,3
C(CO)(CC1(C(O)OC(C)C1)O)=O,,,5,1,2,0,2
27998_0,,,,2,2,1,3
C(C(C1(C(O)OC(C)C1)O)O)=O,,,5,1,3,0,3
27998_1,,,,2,2,1,3
28000_0,,,,2,2,1,3
C1(C(O)OC(C)C1C(C=O)O)=O,,,5,1,3,0,3
28000_1,,,,2,2,1,3
28002_0,,,,2,2,1,3
C1(C(O)OC(C)C1C(C(O)=O)O)=O,,,5,1,3,0,3
28002_1,,,,2,2,1,3
28004_0,,,,2,2,1,3
C(C(C)(C1C(C(O)OC1C)=O)O)=O,,,5,1,3,0,3
28004_1,,,,2,2,1,3
28006_0,,,,2,2,1,3
C(C(C1C(C(O)OC1C)=O)O)(C)=O,,,5,1,3,0,3
28006_1,,,,2,2,1,3
28008_0,,,,2,2,1,3
C(CC(C1C(C(O)OC1C)=O)O)=O,,,5,1,3,0,3
28008_1,,,,2,2,1,3
28010_0,,,,2,2,1,3
C1(C(O)OC(C)C1C(C)O)=O,,,5,1,3,0,3
28010_1,,,,2,2,1,3
28012_0,,,,2,2,1,3
C1(C(O)OC(C)C1C(CCO)O)=O,,,5,1,3,0,3
28012_1,,,,2,2,1,3
28014_0,,,,2,2,1,3
C1(C(O)OC(C)C1C(CO)(C)O)=O,,,5,1,3,0,3
28014_1,,,,2,2,1,3
28016_0,,,,2,2,1,3
C(C1C(C(O)OC1C)=O)(O)=O,,,5,1,4,0,4
28016_1,,,,2,2,1,3
28018_0,,,,2,2,1,3
C1(C(O)OC(C)C1C(C(O)O)O)=O,,,5,1,3,0,3
28018_1,,,,2,2,1,3
28020_0,,,,2,2,1,3
C1(C(O)OC(C)C1C(C(C)O)O)=O,,,5,1,3,0,3
28020_1,,,,2,2,1,3
28021_0,,,,2,2,1,3
28021_1,,,,2,2,1,3
28023_0,,,,2,2,1,3
C1(C(O)OC(C)C1C(CO)O)=O,,,5,1,3,0,3
28023_1,,,,2,2,1,3
28024_0,,,,2,2,1,3
28024_1,,,,2,2,1,3
28025_0,,,,2,2,1,3
28025_1,,,,2,2,1,3
28026_0,,,,2,2,1,3
28026_1,,,,2,2,1,3
28027_0,,,,2,2,1,3
28028_0,,,,2,2,1,3
28028_1,,,,2,2,1,3
28030_0,,,,2,2,1,3
C(CC1(CC(C=O)OC1O)O)=O,,,5,1,2,0,2
28032_0,,,,2,2,1,3
C(C(C1(C(OC(C=O)C1)O)O)O)=O,,,5,1,3,0,3
28032_1,,,,2,2,1,3
28034_0,,,,2,2,1,3
C(C1C(C(C(O)O1)=O)C(C=O)O)=O,,,5,1,3,0,3
28034_1,,,,2,2,1,3
28036_0,,,,2,2,1,3
C1(C(OC(C=O)C1C(C)O)O)=O,,,5,1,3,0,3
28036_1,,,,2,2,1,3
28038_0,,,,2,2,1,3
C(C1C(C(O)OC1C=O)=O)(O)=O,,,5,1,4,0,4
28038_1,,,,2,2,1,3
28039_0,,,,2,2,1,3
28039_1,,,,2,2,1,3
28041_0,,,,2,2,1,3
C1(C(OC(C=O)C1C(CO)O)O)=O,,,5,1,3,0,3
28041_1,,,,2,2,1,3
28043_0,,,,2,2,1,3
C(CC(C1(CC(CO1)O)O)O)=O,,,5,1,2,0,2
28045_0,,,,2,2,1,3
C(C(C(C1(CC(CO1)O)O)O)O)=O,,,5,1,3,0,3
28045_1,,,,2,2,1,3
28047_0,,,,2,2,1,3
C(C(CO)C1C(C(C(O)O1)=O)O)=O,,,5,1,3,0,3
28047_1,,,,2,2,1,3
28049_0,,,,2,2,1,3
C(CC(C1C(CC(O)O1)O)O)=O,,,5,1,3,0,3
28051_0,,,,2,2,1,3
C(C(C(C1C(CC(O)O1)O)O)O)=O,,,5,1,7,0,7
28051_1,,,,2,2,1,3
28053_0,,,,2,2,1,3
C(CC1(C(O)OC(C)C1CO)O)=O,,,5,1,2,0,2
28055_0,,,,2,2,1,3
C(CC(CC1C(CC(O)O1)O)O)=O,,,5,1,2,0,2
28057_0,,,,2,2,1,3
C(C(C1C(CC(O)O1)O)C(C)O)=O,,,5,1,3,0,3
28057_1,,,,2,2,1,3
28059_0,,,,2,2,1,3
C(C(C=O)C1C(CC(O)O1)O)(O)=O,,,5,1,4,0,4
28059_1,,,,2,2,1,3
28061_0,,,,2,2,1,3
C(C(CO)C1C(CC(O)O1)O)=O,,,5,1,4,0,4
28061_1,,,,2,2,1,3
28063_0,,,,2,2,1,3
C(CC(CC1CC(C(O)O1)O)O)=O,,,5,1,2,0,2
28065_0,,,,2,2,1,3
C(C(C1CC(C(O)O1)O)C(C)O)=O,,,5,1,3,0,3
28065_1,,,,2,2,1,3
28067_0,,,,2,2,1,3
C(C(C=O)C1CC(C(O)O1)O)(O)=O,,,5,1,4,0,4
28067_1,,,,2,2,1,3
28069_0,,,,2,2,1,3
C(C(CO)C1CC(C(O)O1)O)=O,,,5,1,4,0,4
28069_1,,,,2,2,1,3
28071_0,,,,2,2,1,3
C(CC(C1C(C)OC(C1O)O)O)=O,,,5,1,2,0,2
28073_0,,,,2,2,1,3
C(CC(C1COC(C1O)O)O)=O,,,5,1,2,0,2
28075_0,,,,2,2,1,3
C(C(C(C1COC(C1O)O)O)O)=O,,,5,1,3,0,3
28075_1,,,,2,2,1,3
28076_0,,,,2,2,1,3
28076_1,,,,2,2,1,3
28078_0,,,,2,2,1,3
C(C(CO)C1(C(C(CO1)O)O)O)=O,,,5,1,3,0,3
28078_1,,,,2,2,1,3
28080_0,,,,2,2,1,3
C(CC(C)(C1C(CC(O)O1)O)O)=O,,,5,1,2,0,2
28082_0,,,,2,2,1,3
C(C1C(CC(O1)O)O)(CC(C)O)=O,,,5,1,2,0,2
28084_0,,,,2,2,1,3
C(CC(C1C(CC(O1)O)O)=O)(O)=O,,,5,1,3,0,3
28086_0,,,,2,2,1,3
C(C1C(CC(O1)O)O)(CCO)=O,,,5,1,4,0,4
28088_0,,,,2,2,1,3
C(CC(C1C(C)(CC(O)O1)O)O)=O,,,5,1,2,0,2
28090_0,,,,2,2,1,3
C(CC1(C(O)OC(C)C1O)O)=O,,,5,1,2,0,2
28092_0,,,,2,2,1,3
C(C(C1(C(O)OC(C)C1O)O)O)=O,,,5,1,3,0,3
28092_1,,,,2,2,1,3
28094_0,,,,2,2,1,3
C(CC(C1(COC(C1)O)O)O)=O,,,5,1,2,0,2
28096_0,,,,2,2,1,3
C(C(C(C1(COC(C1)O)O)O)O)=O,,,5,1,6,0,6
28096_1,,,,2,2,1,3
28097_0,,,,2,2,1,3
28099_0,,,,2,2,1,3
C(CC1(C(C(C=O)OC1O)O)O)=O,,,5,1,2,0,2
28101_0,,,,2,2,1,3
C(CC(C1(C(C(CO1)O)O)O)O)=O,,,5,1,3,0,3
28102_0,,,,2,2,1,3
28103_0,,,,2,2,1,3
28105_0,,,,2,2,1,3
C1(C(C(C)O)OC(C1(CO)O)O)=O,,,5,1,3,0,3
28105_1,,,,2,2,1,3
28107_0,,,,2,2,1,3
C(C1C(C(C(O1)O)(CO)O)=O)(O)=O,,,5,1,3,0,3
28107_1,,,,2,2,1,3
28109_0,,,,2,2,1,3
C1(C(CO)OC(C1(CO)O)O)=O,,,5,1,3,0,3
28109_1,,,,2,2,1,3
28111_0,,,,2,2,1,3
C(CC(C1(CC(O)OC1C)O)O)=O,,,5,1,2,0,2
28113_0,,,,2,2,1,3
C1(C(C(C(O)O1)O)(CC=O)O)=O,,,5,1,4,0,4
28114_0,,,,2,2,1,3
28114_1,,,,2,2,1,3
28115_0,,,,2,2,1,3
28116_0,,,,2,2,1,3
28117_0,,,,2,2,1,3
28118_0,,,,2,2,1,3
28118_1,,,,2,2,1,3
28119_0,,,,2,2,1,3
28119_1,,,,2,2,1,3
28120_0,,,,2,2,1,3
28120_1,,,,2,2,1,3
28121_0,,,,2,2,1,3
28121_1,,,,2,2,1,3
28123_0,,,,2,2,1,3
C(CC1(COC(C(C1O)O)O)O)=O,,,5,1,3,0,3
28125_0,,,,2,2,1,3
C1(C(C(C)O)OC(C(C1O)O)O)=O,,,5,1,3,0,3
28125_1,,,,2,2,1,3
28127_0,,,,2,2,1,3
C(C1C(C(C(C(O1)O)O)O)=O)(O)=O,,,5,1,3,0,3
28127_1,,,,2,2,1,3
28128_0,,,,2,2,1,3
28128_1,,,,2,2,1,3
28130_0,,,,2,2,1,3
C(CC1(C(O)OC(C(C1)O)=O)O)=O,,,5,1,2,0,2
28132_0,,,,2,2,1,3
C1(C(O)OC(C(C1C(C)O)O)=O)=O,,,5,1,3,0,3
28132_1,,,,2,2,1,3
28134_0,,,,2,2,1,3
C(C1C(C(O)OC(C1O)=O)=O)(O)=O,,,5,1,3,0,3
28134_1,,,,2,2,1,3
28135_0,,,,2,2,1,3
28135_1,,,,2,2,1,3
28136_0,,,,2,2,1,3
28136_1,,,,2,2,1,3
28137_0,,,,2,2,1,3
28137_1,,,,2,2,1,3
28138_0,,,,2,2,1,3
28138_1,,,,2,2,1,3
28140_0,,,,2,2,1,3
C(CC(C1(CC(O)OCC1)O)O)=O,,,5,1,2,0,2
28142_0,,,,2,2,1,3
C(CC(C1CC(CC(O)O1)O)O)=O,,,5,1,2,0,2
28144_0,,,,2,2,1,3
C(CC1(CC(O)OC(C)C1O)O)=O,,,5,1,2,0,2
28146_0,,,,2,2,1,3
C1(C(C(C)OC(C1C(C)O)O)O)=O,,,5,1,3,0,3
28146_1,,,,2,2,1,3
28148_0,,,,2,2,1,3
C(C1C(C(C(C)OC1O)O)=O)(O)=O,,,5,1,3,0,3
28148_1,,,,2,2,1,3
28150_0,,,,2,2,1,3
C1(C(C(C)OC(C1CO)O)O)=O,,,5,1,3,0,3
28150_1,,,,2,2,1,3
28152_0,,,,2,2,1,3
C1(C(C(C=O)OC(C1CO)O)O)=O,,,5,1,3,0,3
28152_1,,,,2,2,1,3
28154_0,,,,2,2,1,3
C(CC1(CC(C)OC(C1O)O)O)=O,,,5,1,2,0,2
28156_0,,,,2,2,1,3
C1(C(C(O)OC(C)C1C(C)O)O)=O,,,5,1,3,0,3
28156_1,,,,2,2,1,3
28158_0,,,,2,2,1,3
C(C1C(C(C(O)OC1C)O)=O)(O)=O,,,5,1,3,0,3
28158_1,,,,2,2,1,3
28160_0,,,,2,2,1,3
C1(C(C(O)OC(C)C1CO)O)=O,,,5,1,3,0,3
28160_1,,,,2,2,1,3
28162_0,,,,2,2,1,3
C(C1C(C(CO)C(C(O1)O)O)=O)=O,,,5,1,3,0,3
28162_1,,,,2,2,1,3
28164_0,,,,2,2,1,3
C1(C(CO)C(C=O)OC(C1O)O)=O,,,5,1,3,0,3
28164_1,,,,2,2,1,3
28166_0,,,,2,2,1,3
C(CC1(COC(CC1O)O)O)=O,,,5,1,3,0,3
28167_0,,,,2,2,1,3
28167_1,,,,2,2,1,3
28169_0,,,,2,2,1,3
C(C(C1C(C(CC(O1)O)O)=O)O)=O,,,5,1,3,0,3
28169_1,,,,2,2,1,3
28171_0,,,,2,2,1,3
C1(C(C(C)O)OC(CC1O)O)=O,,,5,1,3,0,3
28171_1,,,,2,2,1,3
28173_0,,,,2,2,1,3
C(C1C(C(CC(O1)O)O)=O)(O)=O,,,5,1,4,0,4
28173_1,,,,2,2,1,3
28174_0,,,,2,2,1,3
28174_1,,,,2,2,1,3
28176_0,,,,2,2,1,3
C1(C(C(CO)O)OC(CC1O)O)=O,,,5,1,4,0,4
28176_1,,,,2,2,1,3
28177_0,,,,2,2,1,3
28178_0,,,,2,2,1,3
28178_1,,,,2,2,1,3
28179_0,,,,2,2,1,3
28179_1,,,,2,2,1,3
28180_0,,,,2,2,1,3
28180_1,,,,2,2,1,3
28182_0,,,,2,2,1,3
C(CC1(CCOC(CC1O)O)O)=O,,,5,1,2,0,2
28184_0,,,,2,2,1,3
C1(C(CC(O)OCC1C(C)O)O)=O,,,5,1,3,0,3
28184_1,,,,2,2,1,3
28186_0,,,,2,2,1,3
C(C1C(C(CC(O)OC1)O)=O)(O)=O,,,5,1,3,0,3
28186_1,,,,2,2,1,3
28188_0,,,,2,2,1,3
C1(C(CC(O)OCC1CO)O)=O,,,5,1,3,0,3
28188_1,,,,2,2,1,3
28190_0,,,,2,2,1,3
C(CC1(COC(CC(C1)O)O)O)=O,,,5,1,2,0,2
28192_0,,,,2,2,1,3
C1(COC(CC(C1C(C)O)O)O)=O,,,5,1,3,0,3
28192_1,,,,2,2,1,3
28194_0,,,,2,2,1,3
C(C1C(COC(CC1O)O)=O)(O)=O,,,5,1,4,0,4
28194_1,,,,2,2,1,3
28196_0,,,,2,2,1,3
C1(COC(CC(C1CO)O)O)=O,,,5,1,5,0,5
28196_1,,,,2,2,1,3
28198_0,,,,2,2,1,3
C1(C(C(C)O)OC(CC(C1)O)O)=O,,,5,1,3,0,3
28198_1,,,,2,2,1,3
28200_0,,,,2,2,1,3
C(C1C(CC(CC(O1)O)O)=O)(O)=O,,,5,1,4,0,4
28200_1,,,,2,2,1,3
28202_0,,,,2,2,1,3
C1(C(CO)OC(CC(C1)O)O)=O,,,5,1,5,0,5
28202_1,,,,2,2,1,3
28204_0,,,,2,2,1,3
C(CC(C1(COC(C1O)=O)O)O)=O,,,5,1,2,0,2
28206_0,,,,2,2,1,3
C1(C(C(CO1)O)(CC(C=O)=O)O)=O,,,5,1,1,0,1
28208_0,,,,2,2,1,3
C(C(C=O)C1(C(OCC1O)=O)O)=O,,,5,1,2,0,2
28208_1,,,,2,2,1,3
28210_0,,,,2,2,1,3
C1(C(C(CO1)O)(CC=O)O)=O,,,5,1,3,0,3
28212_0,,,,2,2,1,3
C(C(CO)C1(C(OCC1O)=O)O)=O,,,5,1,2,0,2
28212_1,,,,2,2,1,3
28213_0,,,,2,2,1,3
28213_1,,,,2,2,1,3
28215_0,,,,2,2,1,3
C1(C(C(CO1)O)(CC(CO)=O)O)=O,,,5,1,1,0,1
28216_0,,,,2,2,1,3
28216_1,,,,2,2,1,3
28217_0,,,,2,2,1,3
28217_1,,,,2,2,1,3
28219_0,,,,2,2,1,3
C1(C(C(C(CO)O1)O)(CC=O)O)=O,,,5,1,1,0,1
28221_0,,,,2,2,1,3
C(CC1(COC(C(C1O)O)=O)O)=O,,,5,1,2,0,2
28223_0,,,,2,2,1,3
C1(C(C(C(OC1C(C)O)=O)O)O)=O,,,5,1,2,0,2
28223_1,,,,2,2,1,3
28225_0,,,,2,2,1,3
C(C1C(C(C(C(O1)=O)O)O)=O)(O)=O,,,5,1,2,0,2
28225_1,,,,2,2,1,3
28226_0,,,,2,2,1,3
28226_1,,,,2,2,1,3
28228_0,,,,2,2,1,3
C1(C(CO)OC(C(C1C=O)O)=O)=O,,,5,1,2,0,2
28228_1,,,,2,2,1,3
28230_0,,,,2,2,1,3
C1(C(CO)C(C(OC1C=O)=O)O)=O,,,5,1,2,0,2
28230_1,,,,2,2,1,3
28232_0,,,,2,2,1,3
C1(C(C)(C(C(C(CO)O1)=O)O)O)=O,,,5,1,2,0,2
28232_1,,,,2,2,1,3
28234_0,,,,2,2,1,3
C1(C(C(C(CO1)O)O)(CC=O)O)=O,,,5,1,1,0,1
28236_0,,,,2,2,1,3
C(C(CO)C(C)(CCC(O)=O)O)=O,,,5,1,4,0,4
28236_1,,,,2,2,1,3
28238_0,,,,2,2,1,3
C(C(CO)C(CCCC(O)=O)O)=O,,,5,1,6,0,6
28238_1,,,,2,2,1,3
28239_0,,,,2,2,1,3
28240_0,,,,2,2,1,3
28240_1,,,,2,2,1,3
28241_0,,,,2,2,1,3
28242_0,,,,2,2,1,3
28242_1,,,,2,2,1,3
28244_0,,,,2,2,1,3
C(CCC(CC(CC=O)O)O)(O)=O,,,5,1,2,0,2
28246_0,,,,2,2,1,3
C(C(C(C)O)C(CCC(O)=O)O)=O,,,5,1,3,0,3
28246_1,,,,2,2,1,3
28248_0,,,,2,2,1,3
C(C(C=O)C(CCC(O)=O)O)(O)=O,,,5,1,4,0,4
28248_1,,,,2,2,1,3
28250_0,,,,2,2,1,3
C(C(CO)C(CCC(O)=O)O)=O,,,5,1,5,0,5
28250_1,,,,2,2,1,3
28252_0,,,,2,2,1,3
C(C(CC(C(C=O)=O)CO)CO)=O,,,5,1,2,0,2
28254_0,,,,2,2,1,3
C(C(CO)C(C=O)C(C=O)CO)=O,,,5,1,2,0,2
28256_0,,,,2,2,1,3
C(CCC(CO)C(CC=O)O)(O)=O,,,5,1,3,0,3
28258_0,,,,2,2,1,3
C(C)(C(CC(C(C=O)=O)CO)O)=O,,,5,1,2,0,2
28259_0,,,,2,2,1,3
28260_0,,,,2,2,1,3
28261_0,,,,2,2,1,3
28263_0,,,,2,2,1,3
C(CCC(C(C)(CC=O)O)O)(O)=O,,,5,1,2,0,2
28265_0,,,,2,2,1,3
C(CCC(C(CC(C)O)=O)O)(O)=O,,,5,1,2,0,2
28266_0,,,,2,2,1,3
28267_0,,,,2,2,1,3
28269_0,,,,2,2,1,3
C(CO)(CCC(C(C=O)=O)CO)=O,,,5,1,4,0,4
28270_0,,,,2,2,1,3
28270_1,,,,2,2,1,3
28271_0,,,,2,2,1,3
28273_0,,,,2,2,1,3
C(CC(C=O)C(C=O)CO)(CO)=O,,,5,1,3,0,3
28274_0,,,,2,2,1,3
28274_1,,,,2,2,1,3
28275_0,,,,2,2,1,3
28277_0,,,,2,2,1,3
C(CCCC(CO)(CC=O)O)(O)=O,,,5,1,3,0,3
28279_0,,,,2,2,1,3
C(CCCC(C(C(C)O)O)=O)(O)=O,,,5,1,3,0,3
28279_1,,,,2,2,1,3
28280_0,,,,2,2,1,3
28280_1,,,,2,2,1,3
28281_0,,,,2,2,1,3
28281_1,,,,2,2,1,3
28283_0,,,,2,2,1,3
C(CCC(C(CO)=O)C(C)O)(O)=O,,,5,1,3,0,3
28284_0,,,,2,2,1,3
28285_0,,,,2,2,1,3
28287_0,,,,2,2,1,3
C(C(CCC(C)O)(CC=O)O)=O,,,5,1,1,0,1
28289_0,,,,2,2,1,3
C(C(CCC(C)O)(C(C=O)O)O)=O,,,5,1,2,0,2
28289_1,,,,2,2,1,3
28291_0,,,,2,2,1,3
C(CC(C(CCC(C)O)=O)O)=O,,,5,1,2,0,2
28293_0,,,,2,2,1,3
C(C(C(C=O)O)O)(CCC(C)O)=O,,,5,1,3,0,3
28293_1,,,,2,2,1,3
28295_0,,,,2,2,1,3
C(C(C(C(C=O)=O)CC(C)O)O)=O,,,5,1,2,0,2
28297_0,,,,2,2,1,3
C(C(C(CC(C)O)C(C)O)=O)=O,,,5,1,2,0,2
28299_0,,,,2,2,1,3
C(C(C(C=O)=O)CC(C)O)(O)=O,,,5,1,1,0,1
28301_0,,,,2,2,1,3
C(C(C(CO)CC(C)O)=O)=O,,,5,1,2,0,2
28303_0,,,,2,2,1,3
C(C(C(CC(C)O)C(CO)O)=O)=O,,,5,1,2,0,2
28305_0,,,,2,2,1,3
C(CC(C(C(C)O)CC=O)O)=O,,,5,1,2,0,2
28307_0,,,,2,2,1,3
C(CC(C(C(C=O)O)O)C(C)O)=O,,,5,1,3,0,3
28307_1,,,,2,2,1,3
28309_0,,,,2,2,1,3
C(C(CC(CC=O)O)C(C)O)=O,,,5,1,1,0,1
28311_0,,,,2,2,1,3
C(C(C(C)O)CC(C(C=O)O)O)=O,,,5,1,3,0,3
28311_1,,,,2,2,1,3
28312_0,,,,2,2,1,3
28314_0,,,,2,2,1,3
C(C(C(C)O)C(C=O)C(C)O)=O,,,5,1,2,0,2
28316_0,,,,2,2,1,3
C(C(C=O)C(C=O)C(C)O)(O)=O,,,5,1,2,0,2
28317_0,,,,2,2,1,3
28318_0,,,,2,2,1,3
28320_0,,,,2,2,1,3
C(C(CCCCO)(CC=O)O)=O,,,5,1,1,0,1
28322_0,,,,2,2,1,3
C(C(CCCCO)(C(C=O)O)O)=O,,,5,1,2,0,2
28322_1,,,,2,2,1,3
28324_0,,,,2,2,1,3
C(CC(C(CCCCO)=O)O)=O,,,5,1,2,0,2
28326_0,,,,2,2,1,3
C(C(C(C=O)O)O)(CCCCO)=O,,,5,1,3,0,3
28326_1,,,,2,2,1,3
28328_0,,,,2,2,1,3
C(C(C(C(C=O)=O)CCCO)O)=O,,,5,1,2,0,2
28330_0,,,,2,2,1,3
C(C(C(CCCO)C(C)O)=O)=O,,,5,1,2,0,2
28332_0,,,,2,2,1,3
C(C(C(C=O)=O)CCCO)(O)=O,,,5,1,1,0,1
28334_0,,,,2,2,1,3
C(C(C(CO)CCCO)=O)=O,,,5,1,2,0,2
28336_0,,,,2,2,1,3
C(C(C(CCCO)C(CO)O)=O)=O,,,5,1,2,0,2
28338_0,,,,2,2,1,3
C(CC(C(CC=O)O)CCO)=O,,,5,1,2,0,2
28340_0,,,,2,2,1,3
C(CC(C(C(C=O)O)O)CCO)=O,,,5,1,3,0,3
28340_1,,,,2,2,1,3
28342_0,,,,2,2,1,3
C(C(CC(CC=O)O)CCO)=O,,,5,1,2,0,2
28344_0,,,,2,2,1,3
C(C(CCO)CC(C(C=O)O)O)=O,,,5,1,3,0,3
28344_1,,,,2,2,1,3
28346_0,,,,2,2,1,3
C(C(C(C=O)C(C=O)CCO)O)=O,,,5,1,5,0,5
28348_0,,,,2,2,1,3
C(C(C(C)O)C(C=O)CCO)=O,,,5,1,5,0,5
28350_0,,,,2,2,1,3
C(C(C=O)C(C=O)CCO)(O)=O,,,5,1,3,0,3
28352_0,,,,2,2,1,3
C(C(CCO)C(C=O)CO)=O,,,5,1,5,0,5
28354_0,,,,2,2,1,3
C(C(C(CO)O)C(C=O)CCO)=O,,,5,1,4,0,4
28355_0,,,,2,2,1,3
28356_0,,,,2,2,1,3
28357_0,,,,2,2,1,3
28358_0,,,,2,2,1,3
28359_0,,,,2,2,1,3
28360_0,,,,2,2,1,3
28362_0,,,,2,2,1,3
C(CC(C(CC=O)O)CC=O)(O)=O,,,5,1,2,0,2
28364_0,,,,2,2,1,3
C(CC(CC(C=O)CC(O)=O)O)=O,,,5,1,3,0,3
28366_0,,,,2,2,1,3
C(CC(C=O)C(C=O)C(C)O)(O)=O,,,5,1,4,0,4
28368_0,,,,2,2,1,3
C(C(C(O)=O)C(C=O)CC(O)=O)=O,,,5,1,3,0,3
28370_0,,,,2,2,1,3
C(CC(C=O)C(C=O)CO)(O)=O,,,5,1,5,0,5
28372_0,,,,2,2,1,3
C(C(CC(C(C=O)=O)CO)(O)O)=O,,,5,1,2,0,2
28374_0,,,,2,2,1,3
C(C(CC(C(C=O)=O)CO)(C)O)=O,,,5,1,2,0,2
28376_0,,,,2,2,1,3
C(C(CCC(C(C=O)=O)CO)O)=O,,,5,1,3,0,3
28378_0,,,,2,2,1,3
[C](C(O)=O)(CC(C(C=O)=O)CO)O,,,5,1,2,0,2
28380_0,,,,2,2,1,3
C(C(CCCO)(CC(C=O)=O)O)=O,,,5,1,1,0,1
28382_0,,,,2,2,1,3
C(C(C=O)C(C=O)(CCCO)O)=O,,,5,1,2,0,2
28382_1,,,,2,2,1,3
28384_0,,,,2,2,1,3
C(C(CCCO)(CC=O)O)=O,,,5,1,1,0,1
28386_0,,,,2,2,1,3
C(C(CO)C(C=O)(CCCO)O)=O,,,5,1,2,0,2
28386_1,,,,2,2,1,3
28388_0,,,,2,2,1,3
C(C(CCCO)(C(C(C)=O)O)O)=O,,,5,1,2,0,2
28388_1,,,,2,2,1,3
28390_0,,,,2,2,1,3
C(C(CCCO)(CC(CO)=O)O)=O,,,5,1,1,0,1
28392_0,,,,2,2,1,3
C(C(CCCO)(C(C=O)O)O)=O,,,5,1,2,0,2
28392_1,,,,2,2,1,3
28394_0,,,,2,2,1,3
C(C(CC(C=O)=O)O)(CCCO)=O,,,5,1,2,0,2
28396_0,,,,2,2,1,3
C(C(C=O)C(C(CCCO)=O)O)=O,,,5,1,3,0,3
28396_1,,,,2,2,1,3
28398_0,,,,2,2,1,3
C(CC(C(CCCO)=O)O)=O,,,5,1,2,0,2
28400_0,,,,2,2,1,3
C(C(CO)C(C(CCCO)=O)O)=O,,,5,1,3,0,3
28400_1,,,,2,2,1,3
28402_0,,,,2,2,1,3
C(C(C(C(CCCO)=O)O)O)(C)=O,,,5,1,3,0,3
28402_1,,,,2,2,1,3
28404_0,,,,2,2,1,3
C(CC(C(CCCO)=O)O)(CO)=O,,,5,1,2,0,2
28406_0,,,,2,2,1,3
C(C(C(C=O)O)O)(CCCO)=O,,,5,1,3,0,3
28406_1,,,,2,2,1,3
28408_0,,,,2,2,1,3
C(C(C(C(C=O)=O)CCO)O)=O,,,5,1,3,0,3
28410_0,,,,2,2,1,3
C(C(C(C(C=O)=O)CCO)O)(O)=O,,,5,1,2,0,2
28412_0,,,,2,2,1,3
C(C(C)(C(C(C=O)=O)CCO)O)=O,,,5,1,2,0,2
28414_0,,,,2,2,1,3
C(C(C(C(C=O)=O)CCO)O)(C)=O,,,5,1,2,0,2
28415_0,,,,2,2,1,3
28417_0,,,,2,2,1,3
C(C(C(CCO)C(C)O)=O)=O,,,5,1,2,0,2
28419_0,,,,2,2,1,3
C(C(C(CCO)C(CCO)O)=O)=O,,,5,1,1,0,1
28421_0,,,,2,2,1,3
C(C(C(CCO)C(C)(CO)O)=O)=O,,,5,1,1,0,1
28422_0,,,,2,2,1,3
28424_0,,,,2,2,1,3
C(C(C(CCO)C(C(O)O)O)=O)=O,,,5,1,1,0,1
28426_0,,,,2,2,1,3
C(C(C(CCO)C(C(C)O)O)=O)=O,,,5,1,1,0,1
28428_0,,,,2,2,1,3
C(C(C(CO)CCO)=O)=O,,,5,1,6,0,6
28430_0,,,,2,2,1,3
C(C(C(CCO)C(CO)O)=O)=O,,,5,1,2,0,2
28432_0,,,,2,2,1,3
C(C(CCC(CO)O)(CC=O)O)=O,,,5,1,1,0,1
28434_0,,,,2,2,1,3
C(CC(C(CCC(CO)O)=O)O)=O,,,5,1,2,0,2
28436_0,,,,2,2,1,3
C(C(C(CC(CO)O)C(C)O)=O)=O,,,5,1,2,0,2
28438_0,,,,2,2,1,3
C(C(C(C=O)=O)CC(CO)O)(O)=O,,,5,1,1,0,1
28440_0,,,,2,2,1,3
C(C(C(CO)CC(CO)O)=O)=O,,,5,1,2,0,2
28442_0,,,,2,2,1,3
C(C(CC(C(C=O)=O)CO)O)(O)=O,,,5,1,3,0,3
28443_0,,,,2,2,1,3
28445_0,,,,2,2,1,3
C(C(C=O)CC(C(C=O)=O)CO)=O,,,5,1,3,0,3
28446_0,,,,2,2,1,3
28447_0,,,,2,2,1,3
28447_1,,,,2,2,1,3
28449_0,,,,2,2,1,3
C(CCCC(C=O)(CC=O)O)=O,,,5,1,2,0,2
28451_0,,,,2,2,1,3
C(CCCC(C=O)(C(C=O)O)O)=O,,,5,1,3,0,3
28451_1,,,,2,2,1,3
28453_0,,,,2,2,1,3
C(CC(C(CCCC=O)=O)O)=O,,,5,1,3,0,3
28455_0,,,,2,2,1,3
C(CCCC(C(C(C=O)O)O)=O)=O,,,5,1,4,0,4
28455_1,,,,2,2,1,3
28456_0,,,,2,2,1,3
28457_0,,,,2,2,1,3
28458_0,,,,2,2,1,3
28459_0,,,,2,2,1,3
28460_0,,,,2,2,1,3
28462_0,,,,2,2,1,3
C(CCC(C(C=O)=O)C(C=O)O)=O,,,5,1,3,0,3
28464_0,,,,2,2,1,3
C(CCC(C(C=O)=O)C(C)O)=O,,,5,1,3,0,3
28466_0,,,,2,2,1,3
C(CCC(C(O)=O)C(C=O)=O)=O,,,5,1,2,0,2
28468_0,,,,2,2,1,3
C(CCC(C(C=O)=O)CO)=O,,,5,1,3,0,3
28470_0,,,,2,2,1,3
C(CCC(C(C=O)=O)C(CO)O)=O,,,5,1,3,0,3
28472_0,,,,2,2,1,3
C(C(C(C=O)(O)O)C(C=O)CO)=O,,,5,1,2,0,2
28473_0,,,,2,2,1,3
28475_0,,,,2,2,1,3
C(C(CC(C=O)C(C=O)CO)O)=O,,,5,1,2,0,2
28477_0,,,,2,2,1,3
C(C([C](C(O)=O)O)C(C=O)CO)=O,,,5,1,2,0,2
28479_0,,,,2,2,1,3
C(CCC(C(CC=O)O)(O)O)(O)=O,,,5,1,2,0,2
28481_0,,,,2,2,1,3
C(CCC(C)(C(CC=O)O)O)(O)=O,,,5,1,2,0,2
28483_0,,,,2,2,1,3
C(CCCC(C(CC=O)O)O)(O)=O,,,5,1,2,0,2
28484_0,,,,2,2,1,3
28484_1,,,,2,2,1,3
28485_0,,,,2,2,1,3
28486_0,,,,2,2,1,3
28487_0,,,,2,2,1,3
28487_1,,,,2,2,1,3
28488_0,,,,2,2,1,3
28489_0,,,,2,2,1,3
28489_1,,,,2,2,1,3
28491_0,,,,2,2,1,3
C(CCCC(C(C(C)=O)O)O)(O)=O,,,5,1,3,0,3
28491_1,,,,2,2,1,3
28493_0,,,,2,2,1,3
C(CCCC(CC(CO)=O)O)(O)=O,,,5,1,3,0,3
28494_0,,,,2,2,1,3
28494_1,,,,2,2,1,3
28495_0,,,,2,2,1,3
28496_0,,,,2,2,1,3
28497_0,,,,2,2,1,3
28498_0,,,,2,2,1,3
28499_0,,,,2,2,1,3
28500_0,,,,2,2,1,3
28502_0,,,,2,2,1,3
C(C(CCC(O)=O)C(CCO)O)=O,,,5,1,3,0,3
28504_0,,,,2,2,1,3
C(C(CCC(O)=O)C(C)(CO)O)=O,,,5,1,3,0,3
28505_0,,,,2,2,1,3
28507_0,,,,2,2,1,3
C(C(CCC(O)=O)C(C(O)O)O)=O,,,5,1,2,0,2
28509_0,,,,2,2,1,3
C(C(CCC(O)=O)C(C(C)O)O)=O,,,5,1,2,0,2
28510_0,,,,2,2,1,3
28511_0,,,,2,2,1,3
28512_0,,,,2,2,1,3
28513_0,,,,2,2,1,3
28513_1,,,,2,2,1,3
28514_0,,,,2,2,1,3
28515_0,,,,2,2,1,3
28516_0,,,,2,2,1,3
28517_0,,,,2,2,1,3
28518_0,,,,2,2,1,3
28518_1,,,,2,2,1,3
28519_0,,,,2,2,1,3
28520_0,,,,2,2,1,3
28521_0,,,,2,2,1,3
28523_0,,,,2,2,1,3
C(CC(C(C(C(O)=O)=O)(C)O)O)=O,,,5,1,4,0,4
28525_0,,,,2,2,1,3
C(C(C)(CC(C(CC=O)O)O)O)=O,,,5,1,1,0,1
28527_0,,,,2,2,1,3
C(CC(C(C)(CC(C=O)O)O)O)=O,,,5,1,3,0,3
28529_0,,,,2,2,1,3
C(CC(C(CC(C(C)=O)O)O)O)=O,,,5,1,1,0,1
28531_0,,,,2,2,1,3
C(CC(C)(C(CC(C=O)O)O)O)=O,,,5,1,3,0,3
28533_0,,,,2,2,1,3
C(C(CC(C=O)O)O)(CC(C)O)=O,,,5,1,3,0,3
28535_0,,,,2,2,1,3
C(CC(C(CC(C=O)O)O)=O)(O)=O,,,5,1,3,0,3
28536_0,,,,2,2,1,3
28538_0,,,,2,2,1,3
C(C(CC(C(CC(C)O)O)O)=O)=O,,,5,1,1,0,1
28540_0,,,,2,2,1,3
C(C(C=O)C(C(CC(C)O)O)O)=O,,,5,1,2,0,2
28540_1,,,,2,2,1,3
28542_0,,,,2,2,1,3
C(CC(C(CC(C)O)O)O)=O,,,5,1,1,0,1
28544_0,,,,2,2,1,3
C(C(CO)C(C(CC(C)O)O)O)=O,,,5,1,2,0,2
28544_1,,,,2,2,1,3
28546_0,,,,2,2,1,3
C(C)(C(C(C(CC(C)O)O)O)O)=O,,,5,1,2,0,2
28546_1,,,,2,2,1,3
28548_0,,,,2,2,1,3
C(CO)(CC(C(CC(C)O)O)O)=O,,,5,1,1,0,1
28550_0,,,,2,2,1,3
C(C(C(C(CC(C)O)O)O)O)=O,,,5,1,5,0,5
28550_1,,,,2,2,1,3
28552_0,,,,2,2,1,3
C(CC(C(CC(CO)O)O)O)=O,,,5,1,2,0,2
28554_0,,,,2,2,1,3
C(C(C(C(CC(CO)O)O)O)O)=O,,,5,1,6,0,6
28554_1,,,,2,2,1,3
28556_0,,,,2,2,1,3
[C](C(O)=O)(CC(CC(C=O)=O)O)O,,,5,1,2,0,2
28558_0,,,,2,2,1,3
C(C(C=O)C(C[C](C(O)=O)O)O)=O,,,5,1,3,0,3
28558_1,,,,2,2,1,3
28560_0,,,,2,2,1,3
C(CC(C[C](C(O)=O)O)O)=O,,,5,1,3,0,3
28562_0,,,,2,2,1,3
C(C(CO)C(C[C](C(O)=O)O)O)=O,,,5,1,3,0,3
28562_1,,,,2,2,1,3
28564_0,,,,2,2,1,3
C(C)(C(C(C[C](C(O)=O)O)O)O)=O,,,5,1,3,0,3
28564_1,,,,2,2,1,3
28566_0,,,,2,2,1,3
C(CO)(CC(C[C](C(O)=O)O)O)=O,,,5,1,2,0,2
28568_0,,,,2,2,1,3
C(C(C(C[C](C(O)=O)O)O)O)=O,,,5,1,4,0,4
28568_1,,,,2,2,1,3
28570_0,,,,2,2,1,3
C(C([C](C(O)=O)O)C(C=O)O)=O,,,5,1,4,0,4
28570_1,,,,2,2,1,3
28572_0,,,,2,2,1,3
C(C([C](C(O)=O)O)C(C(O)=O)O)=O,,,5,1,3,0,3
28572_1,,,,2,2,1,3
28574_0,,,,2,2,1,3
C(C([C](C(O)=O)O)C(C=O)(C)O)=O,,,5,1,3,0,3
28574_1,,,,2,2,1,3
28576_0,,,,2,2,1,3
C(C([C](C(O)=O)O)C(C(C)=O)O)=O,,,5,1,3,0,3
28576_1,,,,2,2,1,3
28578_0,,,,2,2,1,3
C(C([C](C(O)=O)O)C(CC=O)O)=O,,,5,1,3,0,3
28578_1,,,,2,2,1,3
28580_0,,,,2,2,1,3
C(C([C](C(O)=O)O)C(C)O)=O,,,5,1,3,0,3
28580_1,,,,2,2,1,3
28582_0,,,,2,2,1,3
C(C([C](C(O)=O)O)C(CCO)O)=O,,,5,1,3,0,3
28582_1,,,,2,2,1,3
28584_0,,,,2,2,1,3
C(C([C](C(O)=O)O)C(C)(CO)O)=O,,,5,1,3,0,3
28584_1,,,,2,2,1,3
28586_0,,,,2,2,1,3
C(C(C(O)=O)[C](C(O)=O)O)=O,,,5,1,4,0,4
28586_1,,,,2,2,1,3
28588_0,,,,2,2,1,3
C(C([C](C(O)=O)O)C(C(O)O)O)=O,,,5,1,3,0,3
28588_1,,,,2,2,1,3
28590_0,,,,2,2,1,3
C(C([C](C(O)=O)O)C(C(C)O)O)=O,,,5,1,3,0,3
28590_1,,,,2,2,1,3
28592_0,,,,2,2,1,3
C(C([C](C(O)=O)O)CO)=O,,,5,1,4,0,4
28592_1,,,,2,2,1,3
28594_0,,,,2,2,1,3
C(C([C](C(O)=O)O)C(CO)O)=O,,,5,1,5,0,5
28594_1,,,,2,2,1,3
28596_0,,,,2,2,1,3
C(C(C1C(C(CC1O)O)O)O)(O)=O,,,5,1,2,0,2
28596_1,,,,2,2,1,3
28597_0,,,,2,2,1,3
28597_1,,,,2,2,1,3
28598_0,,,,2,2,1,3
28598_1,,,,2,2,1,3
28600_0,,,,2,2,1,3
C(C(C(C(C)O)C(C=O)O)O)(O)=O,,,5,1,4,0,4
28600_1,,,,2,2,1,3
28602_0,,,,2,2,1,3
C(C(C(C(C)O)C(C)O)O)(O)=O,,,5,1,2,0,2
28602_1,,,,2,2,1,3
28604_0,,,,2,2,1,3
C(C(C(C(CO)O)C(C)O)O)(O)=O,,,5,1,3,0,3
28604_1,,,,2,2,1,3
28605_0,,,,2,2,1,3
28605_1,,,,2,2,1,3
28606_0,,,,2,2,1,3
28606_1,,,,2,2,1,3
28608_0,,,,2,2,1,3
C(C(CC(CC(C)O)O)O)(O)=O,,,5,1,3,0,3
28608_1,,,,2,2,1,3
28610_0,,,,2,2,1,3
C(C(C(C(CC(C)O)O)O)O)(O)=O,,,5,1,5,0,5
28610_1,,,,2,2,1,3
28612_0,,,,2,2,1,3
C(C(CC(C(C(C)O)O)O)O)(O)=O,,,5,1,3,0,3
28612_1,,,,2,2,1,3
28613_0,,,,2,2,1,3
28615_0,,,,2,2,1,3
C(C(CO)(CC(CCO)O)O)(O)=O,,,5,1,1,0,1
28616_0,,,,2,2,1,3
28616_1,,,,2,2,1,3
28617_0,,,,2,2,1,3
28617_1,,,,2,2,1,3
28619_0,,,,2,2,1,3
C(C(C=O)(CC(CCO)O)O)(O)=O,,,5,1,3,0,3
28621_0,,,,2,2,1,3
C(C(CC(CCO)O)O)(O)=O,,,5,1,7,0,7
28621_1,,,,2,2,1,3
28623_0,,,,2,2,1,3
C(C(C(CO)C(CCO)O)O)(O)=O,,,5,1,5,0,5
28623_1,,,,2,2,1,3
28624_0,,,,2,2,1,3
28624_1,,,,2,2,1,3
28625_0,,,,2,2,1,3
28626_0,,,,2,2,1,3
28626_1,,,,2,2,1,3
28628_0,,,,2,2,1,3
C(C(CC(CC(CO)O)O)O)(O)=O,,,5,1,4,0,4
28628_1,,,,2,2,1,3
28629_0,,,,2,2,1,3
28629_1,,,,2,2,1,3
28631_0,,,,2,2,1,3
C(C(CC(C(C)=O)(CO)O)O)(O)=O,,,5,1,5,0,5
28631_1,,,,2,2,1,3
28633_0,,,,2,2,1,3
C(C(CC(C(CO)=O)(C)O)O)(O)=O,,,5,1,4,0,4
28633_1,,,,2,2,1,3
28635_0,,,,2,2,1,3
C(C(C)(C(C(CO)(C)O)O)O)(O)=O,,,5,1,2,0,2
28636_0,,,,2,2,1,3
28638_0,,,,2,2,1,3
C(C(C)(C(C(C(O)O)O)O)O)(O)=O,,,5,1,1,0,1
28639_0,,,,2,2,1,3
28640_0,,,,2,2,1,3
28642_0,,,,2,2,1,3
C(C(C)(C(C(C(O)=O)O)O)O)(O)=O,,,5,1,10,0,10
28644_0,,,,2,2,1,3
C(C(C)(C(C(C=O)(C)O)O)O)(O)=O,,,5,1,3,0,3
28645_0,,,,2,2,1,3
28646_0,,,,2,2,1,3
28647_0,,,,2,2,1,3
28648_0,,,,2,2,1,3
28649_0,,,,2,2,1,3
28651_0,,,,2,2,1,3
C(C(CO)(CC(CO)(C)O)O)(O)=O,,,5,1,1,0,1
28652_0,,,,2,2,1,3
28654_0,,,,2,2,1,3
C(C(CO)(CC(C(O)O)O)O)(O)=O,,,5,1,1,0,1
28656_0,,,,2,2,1,3
C(C(CO)(CC(C(C)O)O)O)(O)=O,,,5,1,1,0,1
28658_0,,,,2,2,1,3
C(C(CO)(CC(C=O)O)O)(O)=O,,,5,1,6,0,6
28660_0,,,,2,2,1,3
C(C(CO)(CC(C(O)=O)O)O)(O)=O,,,5,1,7,0,7
28662_0,,,,2,2,1,3
C(C(CO)(CC(C=O)(C)O)O)(O)=O,,,5,1,2,0,2
28664_0,,,,2,2,1,3
C(C(CO)(CC(C(C)=O)O)O)(O)=O,,,5,1,2,0,2
28665_0,,,,2,2,1,3
28667_0,,,,2,2,1,3
C(C(CO)(CC(C)O)O)(O)=O,,,5,1,2,0,2
28668_0,,,,2,2,1,3
28669_0,,,,2,2,1,3
28671_0,,,,2,2,1,3
C(C(CC(C(O)=O)O)(C(C)O)O)=O,,,5,1,5,0,5
28671_1,,,,2,2,1,3
28673_0,,,,2,2,1,3
C(C(CC(C(C(C)O)=O)O)O)(O)=O,,,5,1,5,0,5
28673_1,,,,2,2,1,3
28674_0,,,,2,2,1,3
28674_1,,,,2,2,1,3
28675_0,,,,2,2,1,3
28675_1,,,,2,2,1,3
28676_0,,,,2,2,1,3
28676_1,,,,2,2,1,3
28678_0,,,,2,2,1,3
C(C(C=O)(CC(CO)(C)O)O)(O)=O,,,5,1,1,0,1
28680_0,,,,2,2,1,3
C(C(CC(CO)(C)O)O)(O)=O,,,5,1,4,0,4
28680_1,,,,2,2,1,3
28682_0,,,,2,2,1,3
C(C(C(CO)C(CO)(C)O)O)(O)=O,,,5,1,5,0,5
28682_1,,,,2,2,1,3
28684_0,,,,2,2,1,3
C(C(C(C(CO)(C)O)O)O)(O)=O,,,5,1,6,0,6
28684_1,,,,2,2,1,3
28685_0,,,,2,2,1,3
28685_1,,,,2,2,1,3
28686_0,,,,2,2,1,3
28687_0,,,,2,2,1,3
28687_1,,,,2,2,1,3
28689_0,,,,2,2,1,3
C(C(CC(CO)(CCO)O)O)(O)=O,,,5,1,5,0,5
28689_1,,,,2,2,1,3
28691_0,,,,2,2,1,3
C(C(CC(C(CCO)O)O)O)(O)=O,,,5,1,4,0,4
28691_1,,,,2,2,1,3
28693_0,,,,2,2,1,3
C(C(CC(C)(C(CO)O)O)O)(O)=O,,,5,1,4,0,4
28693_1,,,,2,2,1,3
28695_0,,,,2,2,1,3
C(C(C)(CC(C(O)=O)O)O)(O)=O,,,5,1,6,0,6
28695_1,,,,2,2,1,3
28696_0,,,,2,2,1,3
28696_1,,,,2,2,1,3
28698_0,,,,2,2,1,3
C(CC(CC(C(O)=O)O)O)(O)=O,,,5,1,7,0,7
28698_1,,,,2,2,1,3
28699_0,,,,2,2,1,3
28699_1,,,,2,2,1,3
28700_0,,,,2,2,1,3
28700_1,,,,2,2,1,3
28701_0,,,,2,2,1,3
28701_1,,,,2,2,1,3
28703_0,,,,2,2,1,3
C(CC(C(CC(C(O)=O)O)O)=O)=O,,,5,1,5,0,5
28703_1,,,,2,2,1,3
28704_0,,,,2,2,1,3
28704_1,,,,2,2,1,3
28705_0,,,,2,2,1,3
28705_1,,,,2,2,1,3
28706_0,,,,2,2,1,3
28706_1,,,,2,2,1,3
28707_0,,,,2,2,1,3
28707_1,,,,2,2,1,3
28708_0,,,,2,2,1,3
28708_1,,,,2,2,1,3
28709_0,,,,2,2,1,3
28709_1,,,,2,2,1,3
28710_0,,,,2,2,1,3
28710_1,,,,2,2,1,3
28711_0,,,,2,2,1,3
28711_1,,,,2,2,1,3
28712_0,,,,2,2,1,3
28712_1,,,,2,2,1,3
28713_0,,,,2,2,1,3
28713_1,,,,2,2,1,3
28714_0,,,,2,2,1,3
28714_1,,,,2,2,1,3
28715_0,,,,2,2,1,3
28715_1,,,,2,2,1,3
28716_0,,,,2,2,1,3
28716_1,,,,2,2,1,3
28718_0,,,,2,2,1,3
C(C(CC1(COCC1O)O)O)(O)=O,,,5,1,3,0,3
28718_1,,,,2,2,1,3
28720_0,,,,2,2,1,3
C(C(CC1(C(O)OCC1)O)O)(O)=O,,,5,1,4,0,4
28720_1,,,,2,2,1,3
28722_0,,,,2,2,1,3
C(C(CC1(COC(C1)O)O)O)(O)=O,,,5,1,4,0,4
28722_1,,,,2,2,1,3
28724_0,,,,2,2,1,3
C(C(CC(C=O)(C(C)=O)O)O)(O)=O,,,5,1,4,0,4
28724_1,,,,2,2,1,3
28726_0,,,,2,2,1,3
C(C(CC(C(C(C)=O)=O)O)O)(O)=O,,,5,1,6,0,6
28726_1,,,,2,2,1,3
28727_0,,,,2,2,1,3
28728_0,,,,2,2,1,3
28729_0,,,,2,2,1,3
28731_0,,,,2,2,1,3
C(C(CC(C(C=O)=O)(C)O)O)(O)=O,,,5,1,5,0,5
28731_1,,,,2,2,1,3
28732_0,,,,2,2,1,3
28732_1,,,,2,2,1,3
28733_0,,,,2,2,1,3
28733_1,,,,2,2,1,3
28734_0,,,,2,2,1,3
28734_1,,,,2,2,1,3
28735_0,,,,2,2,1,3
28735_1,,,,2,2,1,3
28736_0,,,,2,2,1,3
28736_1,,,,2,2,1,3
28737_0,,,,2,2,1,3
28738_0,,,,2,2,1,3
28738_1,,,,2,2,1,3
28740_0,,,,2,2,1,3
C(C(C=O)(CC(C(O)O)O)O)(O)=O,,,5,1,1,0,1
28741_0,,,,2,2,1,3
28741_1,,,,2,2,1,3
28743_0,,,,2,2,1,3
C(C(C=O)(CC(C(C)O)O)O)(O)=O,,,5,1,1,0,1
28744_0,,,,2,2,1,3
28744_1,,,,2,2,1,3
28746_0,,,,2,2,1,3
C(C(C=O)(CC(C=O)O)O)(O)=O,,,5,1,4,0,4
28747_0,,,,2,2,1,3
28747_1,,,,2,2,1,3
28749_0,,,,2,2,1,3
C(C(C=O)(CC(C(O)=O)O)O)(O)=O,,,5,1,4,0,4
28750_0,,,,2,2,1,3
28750_1,,,,2,2,1,3
28752_0,,,,2,2,1,3
C(C(C=O)(CC(C=O)(C)O)O)(O)=O,,,5,1,2,0,2
28753_0,,,,2,2,1,3
28753_1,,,,2,2,1,3
28755_0,,,,2,2,1,3
C(C(C=O)(CC(C(C)=O)O)O)(O)=O,,,5,1,2,0,2
28756_0,,,,2,2,1,3
28756_1,,,,2,2,1,3
28757_0,,,,2,2,1,3
28758_0,,,,2,2,1,3
28758_1,,,,2,2,1,3
28760_0,,,,2,2,1,3
C(C(C=O)(CC(C)O)O)(O)=O,,,5,1,2,0,2
28761_0,,,,2,2,1,3
28761_1,,,,2,2,1,3
28762_0,,,,2,2,1,3
28763_0,,,,2,2,1,3
28763_1,,,,2,2,1,3
28765_0,,,,2,2,1,3
C(C(C=O)(CC(CO)O)O)(O)=O,,,5,1,2,0,2
28767_0,,,,2,2,1,3
C(C(C=C)(CC(C(O)=O)O)O)=O,,,5,1,4,0,4
28767_1,,,,2,2,1,3
28769_0,,,,2,2,1,3
C(C(C=C)(C(C(C(O)=O)O)O)O)=O,,,5,1,5,0,5
28769_1,,,,2,2,1,3
28771_0,,,,2,2,1,3
C(C(CC(C(C=C)=O)O)O)(O)=O,,,5,1,4,0,4
28771_1,,,,2,2,1,3
28772_0,,,,2,2,1,3
28772_1,,,,2,2,1,3
28774_0,,,,2,2,1,3
C(C(CC(C=CC=O)O)O)(O)=O,,,5,1,5,0,5
28774_1,,,,2,2,1,3
28776_0,,,,2,2,1,3
C(C(C(C(C=CC=O)O)O)O)(O)=O,,,5,1,5,0,5
28776_1,,,,2,2,1,3
28778_0,,,,2,2,1,3
C(C(CC(C(O)O)O)O)(O)=O,,,5,1,3,0,3
28778_1,,,,2,2,1,3
28780_0,,,,2,2,1,3
C(C(C(CO)C(C(O)O)O)O)(O)=O,,,5,1,4,0,4
28780_1,,,,2,2,1,3
28782_0,,,,2,2,1,3
C(C(C(C(C(O)O)O)O)O)(O)=O,,,5,1,4,0,4
28782_1,,,,2,2,1,3
28784_0,,,,2,2,1,3
C(C(CC(C(C)O)O)O)(O)=O,,,5,1,4,0,4
28784_1,,,,2,2,1,3
28786_0,,,,2,2,1,3
C(C(C(CO)C(C(C)O)O)O)(O)=O,,,5,1,4,0,4
28786_1,,,,2,2,1,3
28787_0,,,,2,2,1,3
28787_1,,,,2,2,1,3
28788_0,,,,2,2,1,3
28788_1,,,,2,2,1,3
28789_0,,,,2,2,1,3
28789_1,,,,2,2,1,3
28790_0,,,,2,2,1,3
28790_1,,,,2,2,1,3
28791_0,,,,2,2,1,3
28791_1,,,,2,2,1,3
28792_0,,,,2,2,1,3
28792_1,,,,2,2,1,3
28793_0,,,,2,2,1,3
28793_1,,,,2,2,1,3
28794_0,,,,2,2,1,3
28794_1,,,,2,2,1,3
28795_0,,,,2,2,1,3
28795_1,,,,2,2,1,3
28796_0,,,,2,2,1,3
28796_1,,,,2,2,1,3
28797_0,,,,2,2,1,3
28798_0,,,,2,2,1,3
28798_1,,,,2,2,1,3
28799_0,,,,2,2,1,3
28800_0,,,,2,2,1,3
28801_0,,,,2,2,1,3
28802_0,,,,2,2,1,3
28803_0,,,,2,2,1,3
28804_0,,,,2,2,1,3
28805_0,,,,2,2,1,3
28805_1,,,,2,2,1,3
28806_0,,,,2,2,1,3
28807_0,,,,2,2,1,3
28807_1,,,,2,2,1,3
28808_0,,,,2,2,1,3
28808_1,,,,2,2,1,3
28809_0,,,,2,2,1,3
28810_0,,,,2,2,1,3
28811_0,,,,2,2,1,3
28812_0,,,,2,2,1,3
28813_0,,,,2,2,1,3
28814_0,,,,2,2,1,3
28815_0,,,,2,2,1,3
28816_0,,,,2,2,1,3
28817_0,,,,2,2,1,3
28817_1,,,,2,2,1,3
28818_0,,,,2,2,1,3
28818_1,,,,2,2,1,3
28819_0,,,,2,2,1,3
28819_1,,,,2,2,1,3
28820_0,,,,2,2,1,3
28821_0,,,,2,2,1,3
28822_0,,,,2,2,1,3
28823_0,,,,2,2,1,3
28823_1,,,,2,2,1,3
28824_0,,,,2,2,1,3
28824_1,,,,2,2,1,3
28825_0,,,,2,2,1,3
28826_0,,,,2,2,1,3
28826_1,,,,2,2,1,3
28827_0,,,,2,2,1,3
28828_0,,,,2,2,1,3
28829_0,,,,2,2,1,3
28829_1,,,,2,2,1,3
28830_0,,,,2,2,1,3
28831_0,,,,2,2,1,3
28832_0,,,,2,2,1,3
28832_1,,,,2,2,1,3
28833_0,,,,2,2,1,3
28834_0,,,,2,2,1,3
28834_1,,,,2,2,1,3
28835_0,,,,2,2,1,3
28836_0,,,,2,2,1,3
28836_1,,,,2,2,1,3
28837_0,,,,2,2,1,3
28838_0,,,,2,2,1,3
28838_1,,,,2,2,1,3
28839_0,,,,2,2,1,3
28840_0,,,,2,2,1,3
28840_1,,,,2,2,1,3
28841_0,,,,2,2,1,3
28841_1,,,,2,2,1,3
28842_0,,,,2,2,1,3
28843_0,,,,2,2,1,3
28843_1,,,,2,2,1,3
28844_0,,,,2,2,1,3
28845_0,,,,2,2,1,3
28846_0,,,,2,2,1,3
28847_0,,,,2,2,1,3
28848_0,,,,2,2,1,3
28849_0,,,,2,2,1,3
28850_0,,,,2,2,1,3
28851_0,,,,2,2,1,3
28852_0,,,,2,2,1,3
28852_1,,,,2,2,1,3
28853_0,,,,2,2,1,3
28853_1,,,,2,2,1,3
28854_0,,,,2,2,1,3
28854_1,,,,2,2,1,3
28855_0,,,,2,2,1,3
28856_0,,,,2,2,1,3
28856_1,,,,2,2,1,3
28857_0,,,,2,2,1,3
28857_1,,,,2,2,1,3
28858_0,,,,2,2,1,3
28858_1,,,,2,2,1,3
28859_0,,,,2,2,1,3
28859_1,,,,2,2,1,3
28861_0,,,,2,2,1,3
C(CC(C(O)=O)O)(C(C)O)=O,,,5,1,5,0,5
28861_1,,,,2,2,1,3
28863_0,,,,2,2,1,3
C(C(CO)C(C(O)=O)O)(C(C)O)=O,,,5,1,3,0,3
28863_1,,,,2,2,1,3
28864_0,,,,2,2,1,3
28864_1,,,,2,2,1,3
28865_0,,,,2,2,1,3
28865_1,,,,2,2,1,3
28866_0,,,,2,2,1,3
28866_1,,,,2,2,1,3
28867_0,,,,2,2,1,3
28867_1,,,,2,2,1,3
28868_0,,,,2,2,1,3
28868_1,,,,2,2,1,3
28869_0,,,,2,2,1,3
28869_1,,,,2,2,1,3
28870_0,,,,2,2,1,3
28870_1,,,,2,2,1,3
28871_0,,,,2,2,1,3
28871_1,,,,2,2,1,3
28872_0,,,,2,2,1,3
28873_0,,,,2,2,1,3
28875_0,,,,2,2,1,3
C(C(C(CO)(CO)C(C)O)O)(O)=O,,,5,1,2,0,2
28875_1,,,,2,2,1,3
28877_0,,,,2,2,1,3
C(C(CO)(CO)C(C(O)=O)O)(O)=O,,,5,1,3,0,3
28877_1,,,,2,2,1,3
28879_0,,,,2,2,1,3
C(C(C(CO)(CO)CO)O)(O)=O,,,5,1,2,0,2
28879_1,,,,2,2,1,3
28880_0,,,,2,2,1,3
28880_1,,,,2,2,1,3
28882_0,,,,2,2,1,3
C(C(C(C(C)O)(C(C)O)O)O)(O)=O,,,5,1,2,0,2
28882_1,,,,2,2,1,3
28883_0,,,,2,2,1,3
28883_1,,,,2,2,1,3
28885_0,,,,2,2,1,3
C(C(C=O)(CO)C(C(O)=O)O)(O)=O,,,5,1,9,0,9
28885_1,,,,2,2,1,3
28887_0,,,,2,2,1,3
C(C(CO)(C(C)O)C(C(O)=O)O)=O,,,5,1,8,0,8
28887_1,,,,2,2,1,3
28889_0,,,,2,2,1,3
C(C(CO)(CO)C(C(O)=O)O)=O,,,5,1,7,0,7
28889_1,,,,2,2,1,3
28890_0,,,,2,2,1,3
28890_1,,,,2,2,1,3
28891_0,,,,2,2,1,3
28891_1,,,,2,2,1,3
28893_0,,,,2,2,1,3
C(C(C(C)(C(CCO)O)O)O)(O)=O,,,5,1,4,0,4
28893_1,,,,2,2,1,3
28895_0,,,,2,2,1,3
C(C(C(C)(C(CO)(C)O)O)O)(O)=O,,,5,1,3,0,3
28895_1,,,,2,2,1,3
28897_0,,,,2,2,1,3
C(C(C(C)(C(C(O)O)O)O)O)(O)=O,,,5,1,2,0,2
28897_1,,,,2,2,1,3
28899_0,,,,2,2,1,3
C(C(C(C)(C(C(C)O)O)O)O)(O)=O,,,5,1,3,0,3
28899_1,,,,2,2,1,3
28900_0,,,,2,2,1,3
28900_1,,,,2,2,1,3
28901_0,,,,2,2,1,3
28901_1,,,,2,2,1,3
28902_0,,,,2,2,1,3
28902_1,,,,2,2,1,3
28904_0,,,,2,2,1,3
C(C(C(C)(C(C)O)O)O)(O)=O,,,5,1,2,0,2
28904_1,,,,2,2,1,3
28905_0,,,,2,2,1,3
28905_1,,,,2,2,1,3
28906_0,,,,2,2,1,3
28906_1,,,,2,2,1,3
28907_0,,,,2,2,1,3
28907_1,,,,2,2,1,3
28908_0,,,,2,2,1,3
28908_1,,,,2,2,1,3
28909_0,,,,2,2,1,3
28909_1,,,,2,2,1,3
28910_0,,,,2,2,1,3
28910_1,,,,2,2,1,3
28912_0,,,,2,2,1,3
C(C(C)(C(C(C=O)(O)O)O)O)(O)=O,,,5,1,2,0,2
28914_0,,,,2,2,1,3
C(C(C)(C([C](C(O)=O)O)O)O)(O)=O,,,5,1,3,0,3
28915_0,,,,2,2,1,3
28915_1,,,,2,2,1,3
28916_0,,,,2,2,1,3
28916_1,,,,2,2,1,3
28918_0,,,,2,2,1,3
C(CCC(C(O)=O)O)(C(C=O)O)=O,,,5,1,4,0,4
28918_1,,,,2,2,1,3
28919_0,,,,2,2,1,3
28919_1,,,,2,2,1,3
28921_0,,,,2,2,1,3
C(C(CO)(C(CO)CO)O)(O)=O,,,5,1,3,0,3
28922_0,,,,2,2,1,3
28922_1,,,,2,2,1,3
28924_0,,,,2,2,1,3
C(C(CO)C(CO)C(C(O)=O)O)=O,,,5,1,2,0,2
28924_1,,,,2,2,1,3
28925_0,,,,2,2,1,3
28926_0,,,,2,2,1,3
28926_1,,,,2,2,1,3
28928_0,,,,2,2,1,3
C(C(C=O)(C(CO)CO)O)(O)=O,,,5,1,3,0,3
28929_0,,,,2,2,1,3
28929_1,,,,2,2,1,3
28931_0,,,,2,2,1,3
C(C(C)C(C(O)=O)(CO)O)=O,,,5,1,2,0,2
28932_0,,,,2,2,1,3
28934_0,,,,2,2,1,3
C(C(CO)(CC(C)=O)O)(O)=O,,,5,1,4,0,4
28936_0,,,,2,2,1,3
C(C(CO)(CCC=O)O)(O)=O,,,5,1,4,0,4
28938_0,,,,2,2,1,3
C(C(CCO)C(C(O)=O)(CO)O)=O,,,5,1,3,0,3
28939_0,,,,2,2,1,3
28941_0,,,,2,2,1,3
C(C(CO)(CC(CCO)=O)O)(O)=O,,,5,1,2,0,2
28943_0,,,,2,2,1,3
C(C(CO)(CCC(C=O)O)O)(O)=O,,,5,1,3,0,3
28945_0,,,,2,2,1,3
C(C(CO)(CCC(CO)=O)O)(O)=O,,,5,1,4,0,4
28947_0,,,,2,2,1,3
C(C(CO)(C(CO)CC=O)O)(O)=O,,,5,1,4,0,4
28949_0,,,,2,2,1,3
C(C(C)(CC(C(CO)=O)O)O)(O)=O,,,5,1,3,0,3
28951_0,,,,2,2,1,3
C(C(C(C)C(C(CO)=O)O)O)(O)=O,,,5,1,2,0,2
28951_1,,,,2,2,1,3
28953_0,,,,2,2,1,3
C(C(CO)(C(C)C(C=O)O)O)(O)=O,,,5,1,1,0,1
28955_0,,,,2,2,1,3
C(C(CO)(CC)O)(O)=O,,,5,1,2,0,2
28956_0,,,,2,2,1,3
28957_0,,,,2,2,1,3
28958_0,,,,2,2,1,3
28959_0,,,,2,2,1,3
28959_1,,,,2,2,1,3
28960_0,,,,2,2,1,3
28960_1,,,,2,2,1,3
28961_0,,,,2,2,1,3
28963_0,,,,2,2,1,3
C(C(C)C(C(O)=O)(C(CO)O)O)=O,,,5,1,1,0,1
28964_0,,,,2,2,1,3
28966_0,,,,2,2,1,3
C(C(C(CO)O)(CC(C)=O)O)(O)=O,,,5,1,2,0,2
28968_0,,,,2,2,1,3
C(C(CCC=O)(C(CO)O)O)(O)=O,,,5,1,3,0,3
28970_0,,,,2,2,1,3
C(C(C(CO)O)(CC)O)(O)=O,,,5,1,2,0,2
28971_0,,,,2,2,1,3
28972_0,,,,2,2,1,3
28973_0,,,,2,2,1,3
28973_1,,,,2,2,1,3
28974_0,,,,2,2,1,3
28974_1,,,,2,2,1,3
28975_0,,,,2,2,1,3
28977_0,,,,2,2,1,3
C(C(C(C(C(O)=O)O)=O)C)=O,,,5,1,3,0,3
28977_1,,,,2,2,1,3
28979_0,,,,2,2,1,3
C(C(C=O)(C(C=O)C)O)(O)=O,,,5,1,1,0,1
28981_0,,,,2,2,1,3
C(C(C)C(C(O)=O)O)=O,,,5,1,4,0,4
28981_1,,,,2,2,1,3
28982_0,,,,2,2,1,3
28983_0,,,,2,2,1,3
28984_0,,,,2,2,1,3
28984_1,,,,2,2,1,3
28986_0,,,,2,2,1,3
C(C(C=O)(CC(C)=O)O)(O)=O,,,5,1,1,0,1
28987_0,,,,2,2,1,3
28987_1,,,,2,2,1,3
28988_0,,,,2,2,1,3
28989_0,,,,2,2,1,3
28991_0,,,,2,2,1,3
C(CCC(C(O)=O)O)(CC=O)=O,,,5,1,3,0,3
28991_1,,,,2,2,1,3
28993_0,,,,2,2,1,3
C(C(CC(CCC=O)=O)O)(O)=O,,,5,1,3,0,3
28993_1,,,,2,2,1,3
28994_0,,,,2,2,1,3
28994_1,,,,2,2,1,3
28995_0,,,,2,2,1,3
28997_0,,,,2,2,1,3
C(C(CCC(C(C)=O)=O)O)(O)=O,,,5,1,3,0,3
28997_1,,,,2,2,1,3
28999_0,,,,2,2,1,3
C(C(CC(CC(C)=O)=O)O)(O)=O,,,5,1,4,0,4
28999_1,,,,2,2,1,3
29001_0,,,,2,2,1,3
C(C(C(C)CC(C=O)=O)O)(O)=O,,,5,1,3,0,3
29001_1,,,,2,2,1,3
29003_0,,,,2,2,1,3
C(C(CC(C(C=O)=O)C)O)(O)=O,,,5,1,3,0,3
29003_1,,,,2,2,1,3
29005_0,,,,2,2,1,3
C(C(C=O)CC(C(O)=O)O)=O,,,5,1,5,0,5
29005_1,,,,2,2,1,3
29007_0,,,,2,2,1,3
C(C(CC(C=O)C(CO)=O)O)(O)=O,,,5,1,4,0,4
29007_1,,,,2,2,1,3
29008_0,,,,2,2,1,3
29008_1,,,,2,2,1,3
29009_0,,,,2,2,1,3
29009_1,,,,2,2,1,3
29010_0,,,,2,2,1,3
29010_1,,,,2,2,1,3
29011_0,,,,2,2,1,3
29011_1,,,,2,2,1,3
29012_0,,,,2,2,1,3
29012_1,,,,2,2,1,3
29013_0,,,,2,2,1,3
29014_0,,,,2,2,1,3
29014_1,,,,2,2,1,3
29016_0,,,,2,2,1,3
C(C(C=O)(CCC=O)O)(O)=O,,,5,1,2,0,2
29017_0,,,,2,2,1,3
29017_1,,,,2,2,1,3
29019_0,,,,2,2,1,3
C(C(C=O)CC(C(O)=O)(C)O)=O,,,5,1,2,0,2
29021_0,,,,2,2,1,3
C(C(C=O)C(C)C(C(O)=O)O)=O,,,5,1,3,0,3
29021_1,,,,2,2,1,3
29023_0,,,,2,2,1,3
C(C(C(C(C(O)=O)O)=O)CCO)=O,,,5,1,2,0,2
29023_1,,,,2,2,1,3
29025_0,,,,2,2,1,3
C(C(C=O)(C(C=O)CCO)O)(O)=O,,,5,1,1,0,1
29027_0,,,,2,2,1,3
C(C(CCO)C(C(O)=O)O)=O,,,5,1,6,0,6
29027_1,,,,2,2,1,3
29028_0,,,,2,2,1,3
29028_1,,,,2,2,1,3
29030_0,,,,2,2,1,3
C(C(C=O)(CC(CCO)=O)O)(O)=O,,,5,1,1,0,1
29031_0,,,,2,2,1,3
29031_1,,,,2,2,1,3
29032_0,,,,2,2,1,3
29033_0,,,,2,2,1,3
29035_0,,,,2,2,1,3
C(C(C=O)C(CO)C(C(O)=O)O)=O,,,5,1,3,0,3
29035_1,,,,2,2,1,3
29037_0,,,,2,2,1,3
C(C(C(CO)CC(CO)=O)O)(O)=O,,,5,1,3,0,3
29037_1,,,,2,2,1,3
29038_0,,,,2,2,1,3
29038_1,,,,2,2,1,3
29040_0,,,,2,2,1,3
C(CC(CO)C(C(O)=O)O)=O,,,5,1,7,0,7
29040_1,,,,2,2,1,3
29041_0,,,,2,2,1,3
29041_1,,,,2,2,1,3
29042_0,,,,2,2,1,3
29042_1,,,,2,2,1,3
29043_0,,,,2,2,1,3
29043_1,,,,2,2,1,3
29044_0,,,,2,2,1,3
29044_1,,,,2,2,1,3
29046_0,,,,2,2,1,3
C(CCC(C=O)O)(C(C(O)=O)O)=O,,,5,1,3,0,3
29046_1,,,,2,2,1,3
29048_0,,,,2,2,1,3
C(C(C=O)(CCC(C=O)O)O)(O)=O,,,5,1,1,0,1
29049_0,,,,2,2,1,3
29049_1,,,,2,2,1,3
29051_0,,,,2,2,1,3
C(C(C(CCC(CO)=O)=O)O)(O)=O,,,5,1,4,0,4
29051_1,,,,2,2,1,3
29053_0,,,,2,2,1,3
C(C(C=O)(CCC(CO)=O)O)(O)=O,,,5,1,2,0,2
29054_0,,,,2,2,1,3
29054_1,,,,2,2,1,3
29055_0,,,,2,2,1,3
29055_1,,,,2,2,1,3
29057_0,,,,2,2,1,3
C(C(C=O)(C(CO)CC=O)O)(O)=O,,,5,1,2,0,2
29058_0,,,,2,2,1,3
29058_1,,,,2,2,1,3
29059_0,,,,2,2,1,3
29060_0,,,,2,2,1,3
29061_0,,,,2,2,1,3
29062_0,,,,2,2,1,3
29063_0,,,,2,2,1,3
29064_0,,,,2,2,1,3
29066_0,,,,2,2,1,3
C(C(C)(CCC=O)O)(O)=O,,,5,1,2,0,2
29067_0,,,,2,2,1,3
29067_1,,,,2,2,1,3
29069_0,,,,2,2,1,3
C(C(C)(CC(C(C=O)=O)O)O)(O)=O,,,5,1,3,0,3
29071_0,,,,2,2,1,3
C(C(CC(C(C(C)=O)O)=O)O)(O)=O,,,5,1,2,0,2
29071_1,,,,2,2,1,3
29072_0,,,,2,2,1,3
29072_1,,,,2,2,1,3
29074_0,,,,2,2,1,3
C(C(C)(CC(C=O)O)O)(O)=O,,,5,1,5,0,5
29076_0,,,,2,2,1,3
C(CC(C)C(C(O)=O)O)=O,,,5,1,3,0,3
29076_1,,,,2,2,1,3
29078_0,,,,2,2,1,3
C(C(C)C(C=O)O)(C(C(O)=O)O)=O,,,5,1,2,0,2
29078_1,,,,2,2,1,3
29080_0,,,,2,2,1,3
C(C(C=O)(C(C)C(C=O)O)O)(O)=O,,,5,1,1,0,1
29081_0,,,,2,2,1,3
29081_1,,,,2,2,1,3
29083_0,,,,2,2,1,3
C(C(C(C)C(C(C=O)=O)O)O)(O)=O,,,5,1,2,0,2
29083_1,,,,2,2,1,3
29085_0,,,,2,2,1,3
C(C(C(C)C(C=O)O)O)(O)=O,,,5,1,4,0,4
29085_1,,,,2,2,1,3
29087_0,,,,2,2,1,3
C(C(C(CC)=O)O)(O)=O,,,5,1,3,0,3
29087_1,,,,2,2,1,3
29089_0,,,,2,2,1,3
C(C(C=O)(CC)O)(O)=O,,,5,1,1,0,1
29090_0,,,,2,2,1,3
29090_1,,,,2,2,1,3
29091_0,,,,2,2,1,3
29091_1,,,,2,2,1,3
29092_0,,,,2,2,1,3
29093_0,,,,2,2,1,3
29093_1,,,,2,2,1,3
29094_0,,,,2,2,1,3
29094_1,,,,2,2,1,3
29095_0,,,,2,2,1,3
29096_0,,,,2,2,1,3
29096_1,,,,2,2,1,3
29097_0,,,,2,2,1,3
29098_0,,,,2,2,1,3
29098_1,,,,2,2,1,3
29099_0,,,,2,2,1,3
29101_0,,,,2,2,1,3
C(C(C)(C)O)(O)=O,,,5,1,1,0,1
29102_0,,,,2,2,1,3
29103_0,,,,2,2,1,3
29105_0,,,,2,2,1,3
C(C(CO)C(C(O)=O)(C)O)(O)=O,,,5,1,4,0,4
29107_0,,,,2,2,1,3
C(C(CO)C(C(O)=O)(CO)O)(O)=O,,,5,1,6,0,6
29108_0,,,,2,2,1,3
29108_1,,,,2,2,1,3
29109_0,,,,2,2,1,3
29110_0,,,,2,2,1,3
29110_1,,,,2,2,1,3
29111_0,,,,2,2,1,3
29112_0,,,,2,2,1,3
29113_0,,,,2,2,1,3
29114_0,,,,2,2,1,3
29114_1,,,,2,2,1,3
29115_0,,,,2,2,1,3
29116_0,,,,2,2,1,3
29117_0,,,,2,2,1,3
29117_1,,,,2,2,1,3
29119_0,,,,2,2,1,3
C(C(C)(CC(C=O)(CO)O)O)(O)=O,,,5,1,1,0,1
29121_0,,,,2,2,1,3
C(C(CO)(C(C)C(C(O)=O)O)O)=O,,,5,1,2,0,2
29121_1,,,,2,2,1,3
29122_0,,,,2,2,1,3
29122_1,,,,2,2,1,3
29123_0,,,,2,2,1,3
29125_0,,,,2,2,1,3
C(C(C)C(C(O)=O)(C)O)(O)=O,,,5,1,1,0,1
29127_0,,,,2,2,1,3
C(C(CCO)C(C(O)=O)(C)O)(O)=O,,,5,1,1,0,1
29129_0,,,,2,2,1,3
C(C(C)(CC(O)=O)O)(O)=O,,,5,1,4,0,4
29131_0,,,,2,2,1,3
C(C(C)C(C(O)=O)(CCO)O)(O)=O,,,5,1,1,0,1
29133_0,,,,2,2,1,3
C(C(CCO)(CC(O)=O)O)(O)=O,,,5,1,4,0,4
29134_0,,,,2,2,1,3
29135_0,,,,2,2,1,3
29135_1,,,,2,2,1,3
29137_0,,,,2,2,1,3
C(C(C)(CC(C(O)=O)(C)O)O)(O)=O,,,5,1,1,0,1
29138_0,,,,2,2,1,3
29140_0,,,,2,2,1,3
C(C(C)(C(C)C(C(O)=O)O)O)(O)=O,,,5,1,2,0,2
29140_1,,,,2,2,1,3
29142_0,,,,2,2,1,3
C(C(C(C)C(C(O)=O)O)O)(O)=O,,,5,1,2,0,2
29142_1,,,,2,2,1,3
29144_0,,,,2,2,1,3
C(C(C)C(C(O)=O)(CO)O)(O)=O,,,5,1,1,0,1
29146_0,,,,2,2,1,3
C(C(C)C(C(O)=O)O)(O)=O,,,5,1,3,0,3
29146_1,,,,2,2,1,3
29148_0,,,,2,2,1,3
C(C(CCO)C(C(O)=O)O)(O)=O,,,5,1,4,0,4
29148_1,,,,2,2,1,3
29150_0,,,,2,2,1,3
C(C(C1C(O)OCC1O)O)(O)=O,,,5,1,5,0,5
29150_1,,,,2,2,1,3
29151_0,,,,2,2,1,3
29152_0,,,,2,2,1,3
29153_0,,,,2,2,1,3
29153_1,,,,2,2,1,3
29155_0,,,,2,2,1,3
C(C(C=C(CO)CO)O)(O)=O,,,5,1,3,0,3
29155_1,,,,2,2,1,3
29157_0,,,,2,2,1,3
C(C(C(C(CO)(CO)O)=C)O)(O)=O,,,5,1,2,0,2
29157_1,,,,2,2,1,3
29159_0,,,,2,2,1,3
C(C(C(CO)=C(CO)CO)O)(O)=O,,,5,1,2,0,2
29159_1,,,,2,2,1,3
29161_0,,,,2,2,1,3
C(C(C=C(CO)C(CO)O)O)(O)=O,,,5,1,2,0,2
29161_1,,,,2,2,1,3
29163_0,,,,2,2,1,3
C(C(C=CC(O)=O)O)(O)=O,,,5,1,6,0,6
29163_1,,,,2,2,1,3
29165_0,,,,2,2,1,3
C(C(C(C(C(O)=O)O)=C)O)(O)=O,,,5,1,6,0,6
29165_1,,,,2,2,1,3
29167_0,,,,2,2,1,3
C(C(C(CO)=CC(O)=O)O)(O)=O,,,5,1,5,0,5
29167_1,,,,2,2,1,3
29169_0,,,,2,2,1,3
C(C(C=CC(CO)(CO)O)O)(O)=O,,,5,1,2,0,2
29169_1,,,,2,2,1,3
29171_0,,,,2,2,1,3
C(C(C=C(C=O)C)O)(O)=O,,,5,1,3,0,3
29171_1,,,,2,2,1,3
29173_0,,,,2,2,1,3
C(C(CC(C=O)=C)O)(O)=O,,,5,1,3,0,3
29173_1,,,,2,2,1,3
29175_0,,,,2,2,1,3
C(C(C(C(C(O)=O)O)=C)(C)O)=O,,,5,1,4,0,4
29175_1,,,,2,2,1,3
29177_0,,,,2,2,1,3
C(C(C(CO)=C(C=O)C)O)(O)=O,,,5,1,3,0,3
29177_1,,,,2,2,1,3
29179_0,,,,2,2,1,3
C(C(C(C(C=O)=C)CO)O)(O)=O,,,5,1,3,0,3
29179_1,,,,2,2,1,3
29181_0,,,,2,2,1,3
C(C(C(C(C=O)=C)O)O)(O)=O,,,5,1,5,0,5
29181_1,,,,2,2,1,3
29183_0,,,,2,2,1,3
C(C(C=CC(C)=O)O)(O)=O,,,5,1,4,0,4
29183_1,,,,2,2,1,3
29185_0,,,,2,2,1,3
C(C(C(C(C(C)=O)O)=C)O)(O)=O,,,5,1,4,0,4
29185_1,,,,2,2,1,3
29187_0,,,,2,2,1,3
C(C(C(CO)=CC(C)=O)O)(O)=O,,,5,1,3,0,3
29187_1,,,,2,2,1,3
29189_0,,,,2,2,1,3
C(C(CC=CC=O)O)(O)=O,,,5,1,7,0,7
29189_1,,,,2,2,1,3
29191_0,,,,2,2,1,3
C(C(C=CCC=O)O)(O)=O,,,5,1,6,0,6
29191_1,,,,2,2,1,3
29193_0,,,,2,2,1,3
C(C(CC(C=O)=CCO)O)(O)=O,,,5,1,3,0,3
29193_1,,,,2,2,1,3
29195_0,,,,2,2,1,3
C(C(C=C(C=O)CCO)O)(O)=O,,,5,1,3,0,3
29195_1,,,,2,2,1,3
29197_0,,,,2,2,1,3
C(C(C=CC(CCO)=O)O)(O)=O,,,5,1,3,0,3
29197_1,,,,2,2,1,3
29198_0,,,,2,2,1,3
29198_1,,,,2,2,1,3
29200_0,,,,2,2,1,3
C(C(C=CCC(C(O)=O)O)O)=O,,,5,1,3,0,3
29200_1,,,,2,2,1,3
29202_0,,,,2,2,1,3
C(C(C=CCC(C=O)O)O)(O)=O,,,5,1,3,0,3
29202_1,,,,2,2,1,3
29204_0,,,,2,2,1,3
C(C(CC=CC(CO)=O)O)(O)=O,,,5,1,3,0,3
29204_1,,,,2,2,1,3
29206_0,,,,2,2,1,3
C(C(C=CCC(CO)=O)O)(O)=O,,,5,1,3,0,3
29206_1,,,,2,2,1,3
29208_0,,,,2,2,1,3
C(C(CC(CO)=CC=O)O)(O)=O,,,5,1,3,0,3
29208_1,,,,2,2,1,3
29210_0,,,,2,2,1,3
C(CC(CO)=CC(C(O)=O)O)=O,,,5,1,3,0,3
29210_1,,,,2,2,1,3
29212_0,,,,2,2,1,3
C(C(C=CC(C(C)=O)O)O)(O)=O,,,5,1,4,0,4
29212_1,,,,2,2,1,3
29214_0,,,,2,2,1,3
C(C(C(CC(C(O)=O)O)=C)O)=O,,,5,1,3,0,3
29214_1,,,,2,2,1,3
29216_0,,,,2,2,1,3
C(C(C=C(C)C(C=O)O)O)(O)=O,,,5,1,3,0,3
29216_1,,,,2,2,1,3
29218_0,,,,2,2,1,3
C(C(CC=C)O)(O)=O,,,5,1,3,0,3
29218_1,,,,2,2,1,3
29220_0,,,,2,2,1,3
C(C(C=CC)O)(O)=O,,,5,1,3,0,3
29220_1,,,,2,2,1,3
29222_0,,,,2,2,1,3
C(C(C=C(C=O)CO)O)(O)=O,,,5,1,4,0,4
29222_1,,,,2,2,1,3
29223_0,,,,2,2,1,3
29223_1,,,,2,2,1,3
29225_0,,,,2,2,1,3
C(C(C=C(C=O)C(CO)O)O)(O)=O,,,5,1,2,0,2
29225_1,,,,2,2,1,3
29226_0,,,,2,2,1,3
29226_1,,,,2,2,1,3
29227_0,,,,2,2,1,3
29227_1,,,,2,2,1,3
29229_0,,,,2,2,1,3
C(C(C=CC(C(CO)O)O)O)(O)=O,,,5,1,2,0,2
29229_1,,,,2,2,1,3
29230_0,,,,2,2,1,3
29230_1,,,,2,2,1,3
29231_0,,,,2,2,1,3
29231_1,,,,2,2,1,3
29232_0,,,,2,2,1,3
29232_1,,,,2,2,1,3
29234_0,,,,2,2,1,3
C(CC=C(CO)C(C(O)=O)O)=O,,,5,1,3,0,3
29234_1,,,,2,2,1,3
29236_0,,,,2,2,1,3
C(C(C(C=CC=O)CO)O)(O)=O,,,5,1,3,0,3
29236_1,,,,2,2,1,3
29237_0,,,,2,2,1,3
29237_1,,,,2,2,1,3
29239_0,,,,2,2,1,3
C(C(C(C(C=O)=CCO)O)O)(O)=O,,,5,1,3,0,3
29239_1,,,,2,2,1,3
29241_0,,,,2,2,1,3
C(C(C(C=C)CO)O)(O)=O,,,5,1,3,0,3
29241_1,,,,2,2,1,3
29243_0,,,,2,2,1,3
C(C(C(CO)=CC)O)(O)=O,,,5,1,3,0,3
29243_1,,,,2,2,1,3
29245_0,,,,2,2,1,3
C(C(C(C(C)O)=C)O)(O)=O,,,5,1,3,0,3
29245_1,,,,2,2,1,3
29247_0,,,,2,2,1,3
C(C(C(CO)=C(C=O)CO)O)(O)=O,,,5,1,2,0,2
29247_1,,,,2,2,1,3
29249_0,,,,2,2,1,3
C(C(C(C(C(O)=O)O)=C)(CO)O)=O,,,5,1,5,0,5
29249_1,,,,2,2,1,3
29251_0,,,,2,2,1,3
C(C(C(CO)=CC(CO)=O)O)(O)=O,,,5,1,2,0,2
29251_1,,,,2,2,1,3
29253_0,,,,2,2,1,3
C(C(C(C(C(CO)=O)O)=C)O)(O)=O,,,5,1,4,0,4
29253_1,,,,2,2,1,3
29255_0,,,,2,2,1,3
C(C(C(CO)=CC(CO)O)O)(O)=O,,,5,1,2,0,2
29255_1,,,,2,2,1,3
29257_0,,,,2,2,1,3
C(C(C(C(C(CO)O)O)=C)O)(O)=O,,,5,1,2,0,2
29257_1,,,,2,2,1,3
29258_0,,,,2,2,1,3
29258_1,,,,2,2,1,3
29259_0,,,,2,2,1,3
29259_1,,,,2,2,1,3
29261_0,,,,2,2,1,3
C(C(C(CO)=C)O)(O)=O,,,5,1,5,0,5
29261_1,,,,2,2,1,3
29263_0,,,,2,2,1,3
C(C(C(CO)=CCO)O)(O)=O,,,5,1,6,0,6
29263_1,,,,2,2,1,3
29265_0,,,,2,2,1,3
C(C(C(C(CO)O)=C)O)(O)=O,,,5,1,5,0,5
29265_1,,,,2,2,1,3
29267_0,,,,2,2,1,3
C(C(C=CC(C(C(O)=O)O)O)O)=O,,,5,1,3,0,3
29267_1,,,,2,2,1,3
29269_0,,,,2,2,1,3
C(C(C(C=CC(CO)=O)O)O)(O)=O,,,5,1,3,0,3
29269_1,,,,2,2,1,3
29271_0,,,,2,2,1,3
C(C(C(C(CO)=CC=O)O)O)(O)=O,,,5,1,3,0,3
29271_1,,,,2,2,1,3
29273_0,,,,2,2,1,3
C(C(C(C(C(C(O)=O)O)O)=C)O)=O,,,5,1,3,0,3
29273_1,,,,2,2,1,3
29275_0,,,,2,2,1,3
C(C(C(C=C)O)O)(O)=O,,,5,1,6,0,6
29275_1,,,,2,2,1,3
29277_0,,,,2,2,1,3
C(C(C(C(C=O)=C)(CO)O)O)(O)=O,,,5,1,3,0,3
29277_1,,,,2,2,1,3
29279_0,,,,2,2,1,3
C(C(C(C=CC=O)(CO)O)O)(O)=O,,,5,1,5,0,5
29279_1,,,,2,2,1,3
29281_0,,,,2,2,1,3
C(C(C(C=C)(CO)O)O)(O)=O,,,5,1,6,0,6
29281_1,,,,2,2,1,3
29282_0,,,,2,2,1,3
29282_1,,,,2,2,1,3
29283_0,,,,2,2,1,3
29283_1,,,,2,2,1,3
29285_0,,,,2,2,1,3
C(C(C1COC(C1(C)O)O)O)(O)=O,,,5,1,3,0,3
29285_1,,,,2,2,1,3
29287_0,,,,2,2,1,3
C(C(C1COC(C)(C1O)O)O)(O)=O,,,5,1,3,0,3
29287_1,,,,2,2,1,3
29289_0,,,,2,2,1,3
C(C(CC1C(CC(O)O1)O)O)(O)=O,,,5,1,3,0,3
29289_1,,,,2,2,1,3
29291_0,,,,2,2,1,3
C(C(CC1CC(C(O)O1)O)O)(O)=O,,,5,1,3,0,3
29291_1,,,,2,2,1,3
29292_0,,,,2,2,1,3
29292_1,,,,2,2,1,3
29294_0,,,,2,2,1,3
C(C(C1COC(C1O)O)O)(O)=O,,,5,1,3,0,3
29294_1,,,,2,2,1,3
29296_0,,,,2,2,1,3
C(C(C1(COC(C1O)O)O)O)(O)=O,,,5,1,5,0,5
29296_1,,,,2,2,1,3
29297_0,,,,2,2,1,3
29297_1,,,,2,2,1,3
29299_0,,,,2,2,1,3
C(C(C1COC(CC1O)O)O)(O)=O,,,5,1,3,0,3
29299_1,,,,2,2,1,3
29301_0,,,,2,2,1,3
C1(C(C(CO1)C(C(O)=O)O)O)=O,,,5,1,4,0,4
29301_1,,,,2,2,1,3
29303_0,,,,2,2,1,3
C1(C(C(CO1)(C(C(O)=O)O)O)O)=O,,,5,1,4,0,4
29303_1,,,,2,2,1,3
29305_0,,,,2,2,1,3
C(C(C(C)O)CCC(C(O)=O)O)=O,,,5,1,2,0,2
29305_1,,,,2,2,1,3
29307_0,,,,2,2,1,3
C(CC(C)(CCC(C(O)=O)O)O)=O,,,5,1,2,0,2
29307_1,,,,2,2,1,3
29309_0,,,,2,2,1,3
C(CC(CCCC(C(O)=O)O)O)=O,,,5,1,2,0,2
29309_1,,,,2,2,1,3
29310_0,,,,2,2,1,3
29310_1,,,,2,2,1,3
29312_0,,,,2,2,1,3
C(C(CO)CCC(C(O)=O)O)=O,,,5,1,2,0,2
29312_1,,,,2,2,1,3
29313_0,,,,2,2,1,3
29314_0,,,,2,2,1,3
29315_0,,,,2,2,1,3
29315_1,,,,2,2,1,3
29316_0,,,,2,2,1,3
29316_1,,,,2,2,1,3
29318_0,,,,2,2,1,3
C(C(C=O)(CCC(C(O)=O)O)O)=O,,,5,1,2,0,2
29318_1,,,,2,2,1,3
29320_0,,,,2,2,1,3
C(C(CCC(C(C)=O)O)O)(O)=O,,,5,1,3,0,3
29320_1,,,,2,2,1,3
29322_0,,,,2,2,1,3
C(C(CCCC(CO)=O)O)(O)=O,,,5,1,4,0,4
29322_1,,,,2,2,1,3
29324_0,,,,2,2,1,3
C(C(CCC(C)O)O)(O)=O,,,5,1,3,0,3
29324_1,,,,2,2,1,3
29326_0,,,,2,2,1,3
C(C(CCCCO)O)(O)=O,,,5,1,2,0,2
29326_1,,,,2,2,1,3
29328_0,,,,2,2,1,3
C(C(CCCC(C(O)=O)=O)O)(O)=O,,,5,1,4,0,4
29328_1,,,,2,2,1,3
29330_0,,,,2,2,1,3
C(C(C=O)CCC(C(O)=O)O)(O)=O,,,5,1,2,0,2
29330_1,,,,2,2,1,3
29331_0,,,,2,2,1,3
29331_1,,,,2,2,1,3
29332_0,,,,2,2,1,3
29332_1,,,,2,2,1,3
29333_0,,,,2,2,1,3
29333_1,,,,2,2,1,3
29335_0,,,,2,2,1,3
C(C(C=O)(CCCC(O)=O)O)(O)=O,,,5,1,3,0,3
29337_0,,,,2,2,1,3
C(C(CCC(C=O)(O)O)O)(O)=O,,,5,1,2,0,2
29337_1,,,,2,2,1,3
29339_0,,,,2,2,1,3
C(C(C)(CCC(C(O)=O)O)O)=O,,,5,1,3,0,3
29339_1,,,,2,2,1,3
29341_0,,,,2,2,1,3
C(C(CCCC(C=O)O)O)(O)=O,,,5,1,3,0,3
29341_1,,,,2,2,1,3
29343_0,,,,2,2,1,3
C(C(CC[C](C(O)=O)O)O)(O)=O,,,5,1,2,0,2
29343_1,,,,2,2,1,3
29345_0,,,,2,2,1,3
C(C(CO)(CCC(C(O)=O)O)O)=O,,,5,1,4,0,4
29345_1,,,,2,2,1,3
29346_0,,,,2,2,1,3
29346_1,,,,2,2,1,3
29348_0,,,,2,2,1,3
C(C(CCCO)O)(O)=O,,,5,1,4,0,4
29348_1,,,,2,2,1,3
29350_0,,,,2,2,1,3
C(C(CCC(CO)O)O)(O)=O,,,5,1,4,0,4
29350_1,,,,2,2,1,3
29352_0,,,,2,2,1,3
C(C(CCC(C(O)=O)O)O)(O)=O,,,5,1,5,0,5
29352_1,,,,2,2,1,3
29354_0,,,,2,2,1,3
C(C(CCC(C(CO)=O)O)O)(O)=O,,,5,1,3,0,3
29354_1,,,,2,2,1,3
29356_0,,,,2,2,1,3
C(C(CCC(CO)(CO)O)O)(O)=O,,,5,1,3,0,3
29356_1,,,,2,2,1,3
29358_0,,,,2,2,1,3
C(C(CCC(C(CO)O)O)O)(O)=O,,,5,1,3,0,3
29358_1,,,,2,2,1,3
29359_0,,,,2,2,1,3
29359_1,,,,2,2,1,3
29361_0,,,,2,2,1,3
C(C(C=O)CCC(C(O)=O)O)=O,,,5,1,3,0,3
29361_1,,,,2,2,1,3
29363_0,,,,2,2,1,3
C(CCCC(C(O)=O)O)=O,,,5,1,3,0,3
29363_1,,,,2,2,1,3
29365_0,,,,2,2,1,3
C(C(C)(CCC(C(O)=O)O)O)(O)=O,,,5,1,2,0,2
29365_1,,,,2,2,1,3
29367_0,,,,2,2,1,3
C(C(CCCC(C(O)=O)O)O)(O)=O,,,5,1,2,0,2
29367_1,,,,2,2,1,3
29368_0,,,,2,2,1,3
29368_1,,,,2,2,1,3
29370_0,,,,2,2,1,3
C(C(CCC(C(C=O)=O)O)O)(O)=O,,,5,1,2,0,2
29370_1,,,,2,2,1,3
29371_0,,,,2,2,1,3
29371_1,,,,2,2,1,3
29372_0,,,,2,2,1,3
29372_1,,,,2,2,1,3
29373_0,,,,2,2,1,3
29373_1,,,,2,2,1,3
29374_0,,,,2,2,1,3
29374_1,,,,2,2,1,3
29375_0,,,,2,2,1,3
29375_1,,,,2,2,1,3
29376_0,,,,2,1,2,3
29377_0,,,,2,1,2,3
29378_0,,,,2,1,2,3
29379_0,,,,2,1,2,3
29380_0,,,,2,1,2,3
29381_0,,,,2,1,2,3
29382_0,,,,2,1,2,3
29383_0,,,,2,1,2,3
29384_0,,,,2,1,2,3
29385_0,,,,2,1,2,3
29386_0,,,,2,1,2,3
29387_0,,,,2,1,2,3
29388_0,,,,2,1,2,3
29389_0,,,,2,1,2,3
29390_0,,,,2,1,2,3
29391_0,,,,2,1,2,3
29392_0,,,,2,1,2,3
29393_0,,,,2,1,2,3
29394_0,,,,2,1,2,3
29395_0,,,,2,1,2,3
29396_0,,,,2,1,2,3
29397_0,,,,2,1,2,3
29398_0,,,,2,1,2,3
29399_0,,,,2,1,2,3
29400_0,,,,2,1,2,3
29401_0,,,,2,1,2,3
29402_0,,,,2,1,2,3
29403_0,,,,2,1,2,3
29404_0,,,,2,1,2,3
29405_0,,,,2,1,2,3
29406_0,,,,2,1,2,3
29407_0,,,,2,1,2,3
29408_0,,,,2,1,2,3
29409_0,,,,2,1,2,3
29410_0,,,,2,1,2,3
29411_0,,,,2,1,2,3
29412_0,,,,2,1,2,3
29413_0,,,,2,1,2,3
29414_0,,,,2,1,2,3
29416_0,,,,2,1,2,3
C(C(C(C(C=O)=O)=O)O)=O,,,5,1,3,0,3
29418_0,,,,2,1,2,3
C(C(C(C(C(C=O)=O)O)=O)O)=O,,,5,1,4,0,4
29420_0,,,,2,1,2,3
C(C(C(C(C=O)=O)=O)(CO)O)=O,,,5,1,2,0,2
29421_0,,,,2,1,2,3
29422_0,,,,2,1,2,3
29423_0,,,,2,1,2,3
29425_0,,,,2,1,2,3
C(C(C)=O)(C(C(C(C)=O)=O)O)=O,,,5,1,1,0,1
29427_0,,,,2,1,2,3
C(C(C(C(C)=O)=O)=O)=O,,,5,1,3,0,3
29429_0,,,,2,1,2,3
C(C(C(C(C(C)=O)=O)O)=O)=O,,,5,1,4,0,4
29431_0,,,,2,1,2,3
C(C(C)=O)(CC(C(CO)=O)=O)=O,,,5,1,2,0,2
29432_0,,,,2,1,2,3
29433_0,,,,2,1,2,3
29434_0,,,,2,1,2,3
29436_0,,,,2,1,2,3
C(CC(C(C(C(C)=O)O)=O)=O)=O,,,5,1,1,0,1
29437_0,,,,2,1,2,3
29438_0,,,,2,1,2,3
29439_0,,,,2,1,2,3
29440_0,,,,2,1,2,3
29441_0,,,,2,1,2,3
29442_0,,,,2,1,2,3
29443_0,,,,2,1,2,3
29444_0,,,,2,1,2,3
29446_0,,,,2,1,2,3
C(C(O)=O)(CC(C(C)=O)=O)=O,,,5,1,6,0,6
29447_0,,,,2,1,2,3
29449_0,,,,2,1,2,3
C(C(C(C(C(C)=O)=O)O)=O)(O)=O,,,5,1,3,0,3
29451_0,,,,2,1,2,3
C(C(C(C=O)=O)C(C(C)=O)=O)=O,,,5,1,3,0,3
29453_0,,,,2,1,2,3
C1(C(COC1C(C(C)=O)=O)O)=O,,,5,1,2,0,2
29455_0,,,,2,1,2,3
C1(C(O)OCC1C(C(C)=O)=O)=O,,,5,1,3,0,3
29457_0,,,,2,1,2,3
C1(COC(C1C(C(C)=O)=O)O)=O,,,5,1,1,0,1
29459_0,,,,2,1,2,3
C1(CC(OC1C(C(C)=O)=O)O)=O,,,5,1,1,0,1
29461_0,,,,2,1,2,3
C(C(C)=O)(CC(C(C=O)=O)=O)=O,,,5,1,2,0,2
29462_0,,,,2,1,2,3
29464_0,,,,2,1,2,3
C(C(C=O)C(C(C)=O)=O)=O,,,5,1,4,0,4
29465_0,,,,2,1,2,3
29466_0,,,,2,1,2,3
29468_0,,,,2,1,2,3
C(C(C(CO)=O)C(C(C)=O)=O)=O,,,5,1,4,0,4
29470_0,,,,2,1,2,3
C(CC(C(C(C(C)=O)=O)O)=O)=O,,,5,1,3,0,3
29472_0,,,,2,1,2,3
C(C(C=O)O)(CC(C(C)=O)=O)=O,,,5,1,5,0,5
29473_0,,,,2,1,2,3
29474_0,,,,2,1,2,3
29476_0,,,,2,1,2,3
C(C(CC(C(CO)=O)=O)=O)(O)=O,,,5,1,5,0,5
29477_0,,,,2,1,2,3
29478_0,,,,2,1,2,3
29479_0,,,,2,1,2,3
29481_0,,,,2,1,2,3
C(C(C=O)C(C(CCO)=O)=O)=O,,,5,1,3,0,3
29482_0,,,,2,1,2,3
29483_0,,,,2,1,2,3
29484_0,,,,2,1,2,3
29485_0,,,,2,1,2,3
29486_0,,,,2,1,2,3
29487_0,,,,2,1,2,3
29488_0,,,,2,1,2,3
29489_0,,,,2,1,2,3
29490_0,,,,2,1,2,3
29491_0,,,,2,1,2,3
29492_0,,,,2,1,2,3
29493_0,,,,2,1,2,3
29494_0,,,,2,1,2,3
29495_0,,,,2,1,2,3
29496_0,,,,2,1,2,3
29497_0,,,,2,1,2,3
29498_0,,,,2,1,2,3
29500_0,,,,2,1,2,3
C(C(C=O)C(C(CO)=O)=O)=O,,,5,1,3,0,3
29501_0,,,,2,1,2,3
29503_0,,,,2,1,2,3
C(C(C(C(C(CO)=O)=O)O)=O)=O,,,5,1,1,0,1
29505_0,,,,2,1,2,3
C(C(C(C(O)=O)=O)=O)=O,,,5,1,7,0,7
29506_0,,,,2,1,2,3
29507_0,,,,2,1,2,3
29509_0,,,,2,1,2,3
C(C(C(C(CO)(CO)O)=O)=O)=O,,,5,1,3,0,3
29510_0,,,,2,1,2,3
29511_0,,,,2,1,2,3
29512_0,,,,2,1,2,3
29513_0,,,,2,1,2,3
29514_0,,,,2,1,2,3
29515_0,,,,2,1,2,3
29516_0,,,,2,1,2,3
29517_0,,,,2,1,2,3
29519_0,,,,2,1,2,3
C(C(C(C=O)=O)C(C=O)=O)=O,,,5,1,4,0,4
29520_0,,,,2,1,2,3
29521_0,,,,2,1,2,3
29522_0,,,,2,1,2,3
29523_0,,,,2,1,2,3
29524_0,,,,2,1,2,3
29525_0,,,,2,1,2,3
29526_0,,,,2,1,2,3
29527_0,,,,2,1,2,3
29529_0,,,,2,1,2,3
C(CC(C(CC(C=O)=O)=O)=O)=O,,,5,1,2,0,2
29531_0,,,,2,1,2,3
C(C(C=O)C(C(CC=O)=O)=O)=O,,,5,1,2,0,2
29532_0,,,,2,1,2,3
29534_0,,,,2,1,2,3
C(CC(C(C(C=O)O)=O)=O)=O,,,5,1,5,0,5
29536_0,,,,2,1,2,3
C(C(C(C=O)=O)C(C(O)=O)=O)=O,,,5,1,6,0,6
29538_0,,,,2,1,2,3
C1(C(COC1C(C=O)=O)O)=O,,,5,1,3,0,3
29540_0,,,,2,1,2,3
C1(C(O)OCC1C(C=O)=O)=O,,,5,1,5,0,5
29542_0,,,,2,1,2,3
C1(COC(C1C(C=O)=O)O)=O,,,5,1,4,0,4
29544_0,,,,2,1,2,3
C1(CC(OC1C(C=O)=O)O)=O,,,5,1,3,0,3
29546_0,,,,2,1,2,3
C(C(CC(C(C=O)=O)=O)=O)=O,,,5,1,3,0,3
29547_0,,,,2,1,2,3
29548_0,,,,2,1,2,3
29549_0,,,,2,1,2,3
29550_0,,,,2,1,2,3
29551_0,,,,2,1,2,3
29552_0,,,,2,1,2,3
29553_0,,,,2,1,2,3
29554_0,,,,2,1,2,3
29555_0,,,,2,1,2,3
29556_0,,,,2,1,2,3
29557_0,,,,2,1,2,3
29558_0,,,,2,1,2,3
29559_0,,,,2,1,2,3
29560_0,,,,2,1,2,3
29561_0,,,,2,1,2,3
29562_0,,,,2,1,2,3
29563_0,,,,2,1,2,3
29564_0,,,,2,1,2,3
29565_0,,,,2,1,2,3
29566_0,,,,2,1,2,3
29567_0,,,,2,1,2,3
29568_0,,,,2,1,2,3
29569_0,,,,2,1,2,3
29570_0,,,,2,1,2,3
29571_0,,,,2,1,2,3
29572_0,,,,2,1,2,3
29573_0,,,,2,1,2,3
29574_0,,,,2,1,2,3
29575_0,,,,2,1,2,3
29576_0,,,,2,1,2,3
29577_0,,,,2,1,2,3
29579_0,,,,2,1,2,3
C(C(C(C(CO)=O)=O)=O)=O,,,5,1,3,0,3
29580_0,,,,2,1,2,3
29581_0,,,,2,1,2,3
29583_0,,,,2,1,2,3
C(C(C(C(CCO)=O)=O)=O)=O,,,5,1,3,0,3
29584_0,,,,2,1,2,3
29585_0,,,,2,1,2,3
29586_0,,,,2,1,2,3
29588_0,,,,2,1,2,3
C(C(C(CO)=O)=O)(C)=O,,,5,1,5,0,5
29590_0,,,,2,1,2,3
C(C(C(C)=O)=O)(C)=O,,,5,1,4,0,4
29591_0,,,,2,1,2,3
29593_0,,,,2,1,2,3
C(C(C(CO)=O)=O)(CO)=O,,,5,1,2,0,2
29595_0,,,,2,1,2,3
C(C(C(CO)=O)=O)(C(CO)O)=O,,,5,1,4,0,4
29597_0,,,,2,1,2,3
C(C(C(CO)=O)(C(C=O)=O)O)=O,,,5,1,4,0,4
29599_0,,,,2,1,2,3
C(C(C(CO)=O)=O)(C(C)O)=O,,,5,1,4,0,4
29600_0,,,,2,1,2,3
29601_0,,,,2,1,2,3
29602_0,,,,2,1,2,3
29604_0,,,,2,1,2,3
C(C(C(C(C(CO)=O)=O)=O)O)=O,,,5,1,2,0,2
29606_0,,,,2,1,2,3
C(C(C(C)=O)=O)(C(C)O)=O,,,5,1,4,0,4
29608_0,,,,2,1,2,3
C(C(C(C(C)O)=O)=O)(CCO)=O,,,5,1,3,0,3
29610_0,,,,2,1,2,3
C(C(C(C(C)O)=O)=O)=O,,,5,1,8,0,8
29612_0,,,,2,1,2,3
C(C(C(C)=O)=O)(C(CCO)O)=O,,,5,1,3,0,3
29614_0,,,,2,1,2,3
C(C(C(C(CCO)O)=O)=O)=O,,,5,1,2,0,2
29616_0,,,,2,1,2,3
C(C(C)O)(C(C(C(C)=O)=O)O)=O,,,5,1,3,0,3
29617_0,,,,2,1,2,3
29619_0,,,,2,1,2,3
C(CO)(C(C(C(C)=O)=O)(C)O)=O,,,5,1,2,0,2
29621_0,,,,2,1,2,3
C(CO)(C(C(C=O)=O)(C)O)=O,,,5,1,4,0,4
29623_0,,,,2,1,2,3
C(C(C(C)=O)=O)(C(CO)O)=O,,,5,1,4,0,4
29624_0,,,,2,1,2,3
29626_0,,,,2,1,2,3
C(C(C(CO)=O)=O)(CCO)=O,,,5,1,4,0,4
29627_0,,,,2,1,2,3
29629_0,,,,2,1,2,3
C(C(CO)=O)(C(CO)(C)O)=O,,,5,1,4,0,4
29631_0,,,,2,1,2,3
C(C(CO)=O)(C(CCO)O)=O,,,5,1,4,0,4
29632_0,,,,2,1,2,3
29634_0,,,,2,1,2,3
C(C(C)=O)(C(CO)(C)O)=O,,,5,1,4,0,4
29636_0,,,,2,1,2,3
C(C(CCO)=O)(C(CO)(C)O)=O,,,5,1,4,0,4
29637_0,,,,2,1,2,3
29639_0,,,,2,1,2,3
C(C(C)=O)(C(CCO)O)=O,,,5,1,4,0,4
29641_0,,,,2,1,2,3
C(C(C(CCO)O)=O)(CCO)=O,,,5,1,3,0,3
29642_0,,,,2,1,2,3
29644_0,,,,2,1,2,3
C(C(C)=O)(C(CO)(CCO)O)=O,,,5,1,3,0,3
29646_0,,,,2,1,2,3
C(C(C(CO)(CCO)O)=O)=O,,,5,1,8,0,8
29647_0,,,,2,1,2,3
29649_0,,,,2,1,2,3
C(C(C)=O)(C(CC(CO)O)O)=O,,,5,1,2,0,2
29650_0,,,,2,1,2,3
29652_0,,,,2,1,2,3
C(C(C)=O)(C(C)(C(CO)O)O)=O,,,5,1,3,0,3
29653_0,,,,2,1,2,3
29654_0,,,,2,1,2,3
29655_0,,,,2,1,2,3
29657_0,,,,2,1,2,3
C(C(C(C(C)=O)=O)(CO)O)(O)=O,,,5,1,7,0,7
29659_0,,,,2,1,2,3
C(C(C(C(CO)=O)=O)(C)O)(O)=O,,,5,1,3,0,3
29661_0,,,,2,1,2,3
C(CC(C(C(CO)=O)=O)O)(O)=O,,,5,1,2,0,2
29663_0,,,,2,1,2,3
C(C(C(C(C(C)=O)=O)=O)O)(O)=O,,,5,1,1,0,1
29665_0,,,,2,1,2,3
C(C(C(C)=O)(C(C=O)=O)O)(O)=O,,,5,1,6,0,6
29666_0,,,,2,1,2,3
29667_0,,,,2,1,2,3
29669_0,,,,2,1,2,3
C(C(C(C(C(C)=O)=O)=O)(C)O)=O,,,5,1,1,0,1
29671_0,,,,2,1,2,3
C(C(C(C)=O)(C(C(C)=O)=O)O)=O,,,5,1,2,0,2
29673_0,,,,2,1,2,3
C(C)(C(C(C(C(C)=O)=O)=O)O)=O,,,5,1,1,0,1
29675_0,,,,2,1,2,3
C(CC(C(C(C(C)=O)=O)=O)O)=O,,,5,1,1,0,1
29676_0,,,,2,1,2,3
29678_0,,,,2,1,2,3
C(C(C(C(C(C)=O)=O)=O)O)=O,,,5,1,3,0,3
29679_0,,,,2,1,2,3
29680_0,,,,2,1,2,3
29681_0,,,,2,1,2,3
29683_0,,,,2,1,2,3
C(C(C(C=O)=O)(CC=O)O)(O)=O,,,5,1,5,0,5
29685_0,,,,2,1,2,3
C(C(C(C=O)=O)(CC(O)=O)O)=O,,,5,1,4,0,4
29687_0,,,,2,1,2,3
C(C(C(C(CC=O)=O)=O)(C)O)=O,,,5,1,1,0,1
29689_0,,,,2,1,2,3
C(C(C(C(C)=O)=O)(CC=O)O)=O,,,5,1,2,0,2
29691_0,,,,2,1,2,3
C(C(C(C(C)=O)=O)(C)O)(O)=O,,,5,1,4,0,4
29692_0,,,,2,1,2,3
29694_0,,,,2,1,2,3
C(CC(C(C(C)=O)=O)O)(O)=O,,,5,1,5,0,5
29696_0,,,,2,1,2,3
C(CC(C(C=O)=O)O)(O)=O,,,5,1,7,0,7
29698_0,,,,2,1,2,3
C(CC(C(C(C)O)=O)=O)=O,,,5,1,4,0,4
29699_0,,,,2,1,2,3
29700_0,,,,2,1,2,3
29702_0,,,,2,1,2,3
C(CC(C(C=O)=O)(CO)O)(O)=O,,,5,1,5,0,5
29703_0,,,,2,1,2,3
29704_0,,,,2,1,2,3
29706_0,,,,2,1,2,3
C1(C(COC(C1O)O)=O)=O,,,5,1,2,0,2
29708_0,,,,2,1,2,3
C1(C(C(CO)OC(C1O)O)=O)=O,,,5,1,2,0,2
29709_0,,,,2,1,2,3
29711_0,,,,2,1,2,3
C1(C(C(COC(C1O)O)O)=O)=O,,,5,1,2,0,2
29713_0,,,,2,1,2,3
C(C(C(C(C(CO)O)=O)=O)=O)=O,,,5,1,1,0,1
29714_0,,,,2,1,2,3
29716_0,,,,2,1,2,3
C1(CC(C(C(C1O)=O)=O)O)=O,,,5,1,1,0,1
29717_0,,,,2,1,2,3
29719_0,,,,2,1,2,3
C1(C(C(C(C(C1O)O)O)O)=O)=O,,,5,1,1,0,1
29720_0,,,,2,1,2,3
29722_0,,,,2,1,2,3
C(CO)(C(C(C(C=O)=O)=O)O)=O,,,5,1,1,0,1
29724_0,,,,2,1,2,3
C(C(C=O)(C(O)=O)C(C=O)=O)=O,,,5,1,3,0,3
29726_0,,,,2,1,2,3
C(C(C=O)(C(C=O)=O)C(C)O)=O,,,5,1,3,0,3
29728_0,,,,2,1,2,3
C(C(C=O)(C(C=O)=O)CO)=O,,,5,1,3,0,3
29730_0,,,,2,1,2,3
C(C(C(C(C=O)=O)=O)(C)O)=O,,,5,1,1,0,1
29732_0,,,,2,1,2,3
C(C)(C(C(C(C=O)=O)=O)O)=O,,,5,1,1,0,1
29733_0,,,,2,1,2,3
29735_0,,,,2,1,2,3
C(C(C=O)(C(C(C)=O)=O)CO)=O,,,5,1,1,0,1
29737_0,,,,2,1,2,3
C(CC(C(C(C(C)O)=O)=O)=O)=O,,,5,1,1,0,1
29739_0,,,,2,1,2,3
C(CC(C(C(CO)=O)=O)=O)=O,,,5,1,2,0,2
29741_0,,,,2,1,2,3
C(CC(C(C(C=O)=O)=O)(C)O)=O,,,5,1,1,0,1
29743_0,,,,2,1,2,3
C(C(C(C(CC(C)O)=O)=O)=O)=O,,,5,1,1,0,1
29744_0,,,,2,1,2,3
29746_0,,,,2,1,2,3
C(C(CO)=O)(C(CC(C)O)O)=O,,,5,1,1,0,1
29748_0,,,,2,1,2,3
C(C(C(C(C(C)O)=O)=O)=O)=O,,,5,1,1,0,1
29750_0,,,,2,1,2,3
C(C(C(C(C)=O)=O)(C(C)O)O)=O,,,5,1,4,0,4
29751_0,,,,2,1,2,3
29752_0,,,,2,1,2,3
29754_0,,,,2,1,2,3
C(C(C(C)O)=O)(C(CCO)O)=O,,,5,1,1,0,1
29756_0,,,,2,1,2,3
C(C(C(C(C(C=O)=O)=O)O)=O)=O,,,5,1,1,0,1
29758_0,,,,2,1,2,3
C(C(C(C(C(C=O)=O)=O)=O)O)=O,,,5,1,1,0,1
29760_0,,,,2,1,2,3
C(C(C(C(C=O)=O)=O)=O)=O,,,5,1,1,0,1
29762_0,,,,2,1,2,3
C(C(C(C=O)=O)(C(C=O)=O)O)=O,,,5,1,2,0,2
29763_0,,,,2,1,2,3
29765_0,,,,2,1,2,3
C(C(C(C(CO)=O)=O)=O)(O)=O,,,5,1,2,0,2
29767_0,,,,2,1,2,3
C(C(C=O)(C(C(C)=O)=O)O)=O,,,5,1,1,0,1
29769_0,,,,2,1,2,3
C(C(C=O)(C(C(CO)=O)=O)O)=O,,,5,1,1,0,1
29770_0,,,,2,1,2,3
29772_0,,,,2,1,2,3
C(C(C=O)(C(C=O)=O)O)=O,,,5,1,4,0,4
29774_0,,,,2,1,2,3
C(C(C(C)=O)=O)(C(CO)(C)O)=O,,,5,1,1,0,1
29776_0,,,,2,1,2,3
C(C(C(C)O)=O)(C(CO)(C)O)=O,,,5,1,1,0,1
29778_0,,,,2,1,2,3
C(C)(C(C(C(C)=O)=O)(CO)O)=O,,,5,1,4,0,4
29779_0,,,,2,1,2,3
29780_0,,,,2,1,2,3
29782_0,,,,2,1,2,3
C1(COCC1(C(C(C)=O)=O)O)=O,,,5,1,1,0,1
29784_0,,,,2,1,2,3
C1(C(C(C(C)=O)=O)C(CO1)O)=O,,,5,1,2,0,2
29786_0,,,,2,1,2,3
C(C(C(C(C)=O)=O)=O)(O)=O,,,5,1,2,0,2
29788_0,,,,2,1,2,3
C(C(C(C)=O)=O)(C(C(O)O)O)=O,,,5,1,1,0,1
29790_0,,,,2,1,2,3
C(C(C(C)=O)=O)(C(C(C)O)O)=O,,,5,1,1,0,1
29791_0,,,,2,1,2,3
29793_0,,,,2,1,2,3
C(C(C(C(C(O)=O)=O)=O)(C)O)=O,,,5,1,1,0,1
29795_0,,,,2,1,2,3
C(C(C(C(C(C)O)=O)=O)(C)O)=O,,,5,1,1,0,1
29797_0,,,,2,1,2,3
C(C)(C(C(C(C(O)=O)=O)=O)O)=O,,,5,1,1,0,1
29799_0,,,,2,1,2,3
C(C)(C(C(C(C(C)O)=O)=O)O)=O,,,5,1,1,0,1
29801_0,,,,2,1,2,3
C(C)(C(C(C=O)=O)(C(C)O)O)=O,,,5,1,5,0,5
29803_0,,,,2,1,2,3
C(CC(C(C(C(O)=O)=O)=O)O)=O,,,5,1,2,0,2
29805_0,,,,2,1,2,3
C(CC(C(C(C(C)O)=O)=O)O)=O,,,5,1,3,0,3
29807_0,,,,2,1,2,3
C(C(C(C(C)O)=O)=O)(O)=O,,,5,1,2,0,2
29809_0,,,,2,1,2,3
C(C(C(C)O)=O)(C(C(O)O)O)=O,,,5,1,1,0,1
29810_0,,,,2,1,2,3
29812_0,,,,2,1,2,3
C(C(C(C)O)=O)(C(C)O)=O,,,5,1,1,0,1
29814_0,,,,2,1,2,3
C(C(C(C(C=O)=O)=O)(C)O)(O)=O,,,5,1,1,0,1
29816_0,,,,2,1,2,3
C(C(C=O)(C(C(C)=O)=O)O)(O)=O,,,5,1,3,0,3
29818_0,,,,2,1,2,3
C(CC(C(C(CO)=O)=O)=O)(O)=O,,,5,1,1,0,1
29820_0,,,,2,1,2,3
C(C(C(C(CCO)=O)=O)=O)(O)=O,,,5,1,2,0,2
29821_0,,,,2,1,2,3
29823_0,,,,2,1,2,3
C1(C(C(COC1)=O)=O)=O,,,5,1,1,0,1
29825_0,,,,2,1,2,3
C1(COCC1(C(C=O)=O)O)=O,,,5,1,3,0,3
29827_0,,,,2,1,2,3
C1(C(C(C=O)=O)C(CO1)O)=O,,,5,1,5,0,5
29829_0,,,,2,1,2,3
C(C(C=C)(C(C(CO)=O)=O)O)=O,,,5,1,1,0,1
29831_0,,,,2,1,2,3
C=CC(C(C(C(CO)=O)=O)O)=O,,,5,1,1,0,1
29833_0,,,,2,1,2,3
C(C(C(C(CO)=O)=O)O)=CC=O,,,5,1,1,0,1
29835_0,,,,2,1,2,3
C1(C(C(C(C(O)O1)O)=O)=O)=O,,,5,1,1,0,1
29837_0,,,,2,1,2,3
C1(C(C(C(O)OC1)=O)=O)=O,,,5,1,1,0,1
29839_0,,,,2,1,2,3
C1(C(O)OCC1(C(C=O)=O)O)=O,,,5,1,3,0,3
29841_0,,,,2,1,2,3
C1(C(C(C(CO1)O)=O)=O)=O,,,5,1,2,0,2
29843_0,,,,2,1,2,3
C1(C(C(C(C(CO)O1)O)=O)=O)=O,,,5,1,1,0,1
29845_0,,,,2,1,2,3
C1(C(C(C(C(CO1)O)O)=O)=O)=O,,,5,1,1,0,1
29847_0,,,,2,1,2,3
C(C(C(C(C(O)=O)=O)=O)=O)=O,,,5,1,2,0,2
29848_0,,,,2,1,2,3
29849_0,,,,2,1,2,3
29850_0,,,,2,1,2,3
29851_0,,,,2,1,2,3
29852_0,,,,2,1,2,3
29853_0,,,,2,1,2,3
29854_0,,,,2,1,2,3
29855_0,,,,2,1,2,3
29856_0,,,,2,1,2,3
29857_0,,,,2,1,2,3
29859_0,,,,2,1,2,3
C(C(C(C(C(O)=O)=O)=O)O)=O,,,5,1,2,0,2
29860_0,,,,2,1,2,3
29862_0,,,,2,1,2,3
C1(C(C(C=O)=O)(C(CO1)O)O)=O,,,5,1,3,0,3
29863_0,,,,2,1,2,3
29864_0,,,,2,1,2,3
29865_0,,,,2,1,2,3
29867_0,,,,2,1,2,3
C(C(CO)=O)(C(C(O)O)O)=O,,,5,1,1,0,1
29868_0,,,,2,1,2,3
29869_0,,,,2,1,2,3
29871_0,,,,2,1,2,3
C(C(CC(C(C(O)=O)=O)=O)=O)=O,,,5,1,1,0,1
29873_0,,,,2,1,2,3
C(C(CC(C(C(C)O)=O)=O)=O)=O,,,5,1,3,0,3
29875_0,,,,2,1,2,3
C(C(C=O)C(C(C(O)=O)=O)=O)=O,,,5,1,1,0,1
29877_0,,,,2,1,2,3
C(C(C=O)C(C(C(C)O)=O)=O)=O,,,5,1,2,0,2
29879_0,,,,2,1,2,3
C(CC(C(C(CCO)O)=O)=O)=O,,,5,1,2,0,2
29881_0,,,,2,1,2,3
C(CC(C(C(CO)(C)O)=O)=O)=O,,,5,1,2,0,2
29883_0,,,,2,1,2,3
C(CC(C(C(O)=O)=O)=O)=O,,,5,1,3,0,3
29885_0,,,,2,1,2,3
C(CC(C(C(C(O)O)O)=O)=O)=O,,,5,1,1,0,1
29886_0,,,,2,1,2,3
29887_0,,,,2,1,2,3
29888_0,,,,2,1,2,3
29889_0,,,,2,1,2,3
29890_0,,,,2,1,2,3
29892_0,,,,2,1,2,3
C(C(CC(C(C(C)=O)=O)=O)=O)=O,,,5,1,2,0,2
29894_0,,,,2,1,2,3
C(C(C=O)C(C(C(C)=O)=O)=O)=O,,,5,1,2,0,2
29896_0,,,,2,1,2,3
C(CC(C(C(C)=O)=O)=O)=O,,,5,1,3,0,3
29898_0,,,,2,1,2,3
C(CC(C(C)=O)(C(C=O)=O)O)=O,,,5,1,2,0,2
29899_0,,,,2,1,2,3
29901_0,,,,2,1,2,3
C(C(C(C=O)=O)(CC(C)O)O)=O,,,5,1,2,0,2
29902_0,,,,2,1,2,3
29904_0,,,,2,1,2,3
C(C(C=O)C(C(C=O)=O)=O)=O,,,5,1,1,0,1
29906_0,,,,2,1,2,3
C(CC(C(C(CCO)=O)=O)=O)=O,,,5,1,1,0,1
29907_0,,,,2,1,2,3
29908_0,,,,2,1,2,3
29909_0,,,,2,1,2,3
29911_0,,,,2,1,2,3
C=CC(C(C(CC(C)O)O)=O)=O,,,5,1,1,0,1
29912_0,,,,2,1,2,3
29914_0,,,,2,1,2,3
C(C(C)=O)(C(CC(C)O)O)=O,,,5,1,1,0,1
29915_0,,,,2,1,2,3
29916_0,,,,2,1,2,3
29917_0,,,,2,1,2,3
29919_0,,,,2,1,2,3
C=CC(C(C(CCO)O)=O)=O,,,5,1,1,0,1
29920_0,,,,2,1,2,3
29922_0,,,,2,1,2,3
C(C(C(C(C(C)=O)=O)(C)O)=O)=O,,,5,1,2,0,2
29924_0,,,,2,1,2,3
C(C(C(C(C=O)=O)(C)O)=O)=O,,,5,1,2,0,2
29926_0,,,,2,1,2,3
C(C(C(C(C(C=C)=O)=O)O)O)=O,,,5,1,1,0,1
29928_0,,,,2,1,2,3
C=CC(C(C(CO)(C)O)=O)=O,,,5,1,1,0,1
29930_0,,,,2,1,2,3
C1(CCOC1(C(C(C)=O)=O)O)=O,,,5,1,1,0,1
29932_0,,,,2,1,2,3
C(C(C(C(C=C)=O)=O)(C)O)(O)=O,,,5,1,1,0,1
29934_0,,,,2,1,2,3
C(C(C=C)(C(C(C)=O)=O)O)(O)=O,,,5,1,1,0,1
29936_0,,,,2,1,2,3
C1(C(C(C(C)=O)=O)(CCO1)O)=O,,,5,1,1,0,1
29938_0,,,,2,1,2,3
C(C(C(C(C)=O)=O)(O)O)=O,,,5,1,1,0,1
29940_0,,,,2,1,2,3
C([C](C(C(C)=O)=O)O)(O)=O,,,5,1,1,0,1
29942_0,,,,2,1,2,3
C(CC(C(C(C=C)=O)=O)O)(O)=O,,,5,1,1,0,1
29944_0,,,,2,1,2,3
C(C(C(C(CCO)=O)=O)(O)O)=O,,,5,1,1,0,1
29946_0,,,,2,1,2,3
C(C([C](C(O)=O)O)=O)(CCO)=O,,,5,1,1,0,1
29947_0,,,,2,1,2,3
29948_0,,,,2,1,2,3
29949_0,,,,2,1,2,3
29950_0,,,,2,1,2,3
29952_0,,,,2,1,2,3
C(C(C(C(CO)=O)=O)(O)O)=O,,,5,1,1,0,1
29954_0,,,,2,1,2,3
C([C](C(C(CO)=O)=O)O)(O)=O,,,5,1,1,0,1
29955_0,,,,2,1,2,3
29956_0,,,,2,1,2,3
29957_0,,,,2,1,2,3
29959_0,,,,2,1,2,3
C(CO)(CC(C(C(O)=O)=O)=O)=O,,,5,1,3,0,3
29961_0,,,,2,1,2,3
C(CO)(CC(C(C(C)O)=O)=O)=O,,,5,1,3,0,3
29962_0,,,,2,1,2,3
29964_0,,,,2,1,2,3
C(CC(C(C(C=O)(O)O)=O)=O)=O,,,5,1,1,0,1
29966_0,,,,2,1,2,3
C(CC(C([C](C(O)=O)O)=O)=O)=O,,,5,1,1,0,1
29968_0,,,,2,1,2,3
C(C(C1(COCC1O)O)=O)=O,,,5,1,2,0,2
29970_0,,,,2,1,2,3
C(C(C)=O)(C1(COCC1O)O)=O,,,5,1,1,0,1
29972_0,,,,2,1,2,3
C1(C(C(OCC1)=O)=O)=O,,,5,1,4,0,4
29974_0,,,,2,1,2,3
C1(CCOC1(C(C=O)=O)O)=O,,,5,1,2,0,2
29976_0,,,,2,1,2,3
C(C(C1(C(O)OCC1)O)=O)=O,,,5,1,3,0,3
29978_0,,,,2,1,2,3
C(C(C)=O)(C1(C(O)OCC1)O)=O,,,5,1,2,0,2
29980_0,,,,2,1,2,3
C(C(C1(COC(C1)O)O)=O)=O,,,5,1,3,0,3
29982_0,,,,2,1,2,3
C(C(C)=O)(C1(COC(C1)O)O)=O,,,5,1,2,0,2
29984_0,,,,2,1,2,3
C(C(C=C)(C(C(C=C)=O)=O)O)=O,,,5,1,1,0,1
29986_0,,,,2,1,2,3
C(C(C=C)(C(C=O)=O)O)=O,,,5,1,5,0,5
29988_0,,,,2,1,2,3
C(C(C=C)(C(C(C)=O)=O)O)=O,,,5,1,2,0,2
29990_0,,,,2,1,2,3
C=CC(C(C(C(C=C)=O)=O)O)=O,,,5,1,1,0,1
29992_0,,,,2,1,2,3
C=CC(C(C(C=O)=O)O)=O,,,5,1,5,0,5
29994_0,,,,2,1,2,3
C=CC(C(C(C(C)=O)=O)O)=O,,,5,1,2,0,2
29996_0,,,,2,1,2,3
C=CC(C(C(C=CC=O)O)=O)=O,,,5,1,1,0,1
29997_0,,,,2,1,2,3
29999_0,,,,2,1,2,3
C(C(C(C(C)=O)=O)O)=CC=O,,,5,1,4,0,4
30001_0,,,,2,1,2,3
C=CC(C(C(O)=O)=O)=O,,,5,1,2,0,2
30003_0,,,,2,1,2,3
C=CC(C(C(C(O)O)O)=O)=O,,,5,1,1,0,1
30005_0,,,,2,1,2,3
C=CC(C(C(C(C)O)O)=O)=O,,,5,1,1,0,1
30007_0,,,,2,1,2,3
C=CC(C(C(C(CO)O)O)=O)=O,,,5,1,1,0,1
30009_0,,,,2,1,2,3
C(C(C(C(C=C)=O)=O)O)=O,,,5,1,4,0,4
30011_0,,,,2,1,2,3
C=CC(C(C(CO)(CO)O)=O)=O,,,5,1,1,0,1
30013_0,,,,2,1,2,3
C(C(C=C)(C(C=O)=O)O)(O)=O,,,5,1,5,0,5
30015_0,,,,2,1,2,3
C(C(C(C(C=C)=O)=O)O)(O)=O,,,5,1,2,0,2
30017_0,,,,2,1,2,3
C(C(C(C(C=C)=O)=O)(C)O)=O,,,5,1,2,0,2
30019_0,,,,2,1,2,3
C(C)(C(C(C(C=C)=O)=O)O)=O,,,5,1,2,0,2
30021_0,,,,2,1,2,3
C(CC(C(C(C=C)=O)=O)O)=O,,,5,1,2,0,2
30023_0,,,,2,1,2,3
C=CC(C(C(C)O)=O)=O,,,5,1,2,0,2
30025_0,,,,2,1,2,3
C(C(C(C(C=C)=O)=O)(CO)O)=O,,,5,1,1,0,1
30027_0,,,,2,1,2,3
C(CO)(C(C(C(C=C)=O)=O)O)=O,,,5,1,1,0,1
30029_0,,,,2,1,2,3
C=CC(C(CO)=O)=O,,,5,1,7,0,7
30031_0,,,,2,1,2,3
C=CC(C(C(CO)O)=O)=O,,,5,1,3,0,3
30032_0,,,,2,1,2,3
30034_0,,,,2,1,2,3
C1(C(COC1(C(C=O)=O)O)O)=O,,,5,1,2,0,2
30035_0,,,,2,1,2,3
30036_0,,,,2,1,2,3
30037_0,,,,2,1,2,3
30039_0,,,,2,1,2,3
C(C(C(O)=O)=O)=O,,,5,1,50,0,50
30040_0,,,,2,1,2,3
30041_0,,,,2,1,2,3
30042_0,,,,2,1,2,3
30043_0,,,,2,1,2,3
30045_0,,,,2,1,2,3
C1(C(C(C=O)=O)(CCO1)O)=O,,,5,1,3,0,3
30046_0,,,,2,1,2,3
30047_0,,,,2,1,2,3
30048_0,,,,2,1,2,3
30049_0,,,,2,1,2,3
30050_0,,,,2,1,2,3
30051_0,,,,2,1,2,3
30053_0,,,,2,1,2,3
C(C(C(C=O)=O)(O)O)=O,,,5,1,5,0,5
30055_0,,,,2,1,2,3
C(C(C(C(O)O)O)=O)=O,,,5,1,6,0,6
30057_0,,,,2,1,2,3
C(C(C)=O)(C(C(O)O)O)=O,,,5,1,2,0,2
30059_0,,,,2,1,2,3
C(C(C(C(O)O)O)=O)(CCO)=O,,,5,1,2,0,2
30060_0,,,,2,1,2,3
30061_0,,,,2,1,2,3
30063_0,,,,2,1,2,3
C(C([C](C(O)=O)O)=O)=O,,,5,1,5,0,5
30064_0,,,,2,1,2,3
30065_0,,,,2,1,2,3
30066_0,,,,2,1,2,3
30067_0,,,,2,1,2,3
30069_0,,,,2,1,2,3
C(CCC(C(C(C)=O)=O)=O)=O,,,5,1,3,0,3
30070_0,,,,2,1,2,3
30071_0,,,,2,1,2,3
30073_0,,,,2,1,2,3
C(C(C)=O)(CC(C(C)=O)=O)=O,,,5,1,3,0,3
30075_0,,,,2,1,2,3
C(C)(CC(C(C(C)=O)=O)=O)=O,,,5,1,3,0,3
30076_0,,,,2,1,2,3
30077_0,,,,2,1,2,3
30079_0,,,,2,1,2,3
C(C(C(C(C(C)=O)=O)C)=O)=O,,,5,1,3,0,3
30081_0,,,,2,1,2,3
C(C(C(C(C=O)=O)C)=O)=O,,,5,1,3,0,3
30083_0,,,,2,1,2,3
C(C(C(C)=O)=O)(CCO)=O,,,5,1,4,0,4
30084_0,,,,2,1,2,3
30085_0,,,,2,1,2,3
30086_0,,,,2,1,2,3
30087_0,,,,2,1,2,3
30088_0,,,,2,1,2,3
30090_0,,,,2,1,2,3
C=C(C(C=O)=O)C(C=O)=O,,,5,1,3,0,3
30092_0,,,,2,1,2,3
C(C(C(C=O)=O)=CC=O)=O,,,5,1,5,0,5
30094_0,,,,2,1,2,3
C=C(C=O)C(C(CO)=O)=O,,,5,1,4,0,4
30096_0,,,,2,1,2,3
C(C=CC(C(CO)=O)=O)=O,,,5,1,6,0,6
30098_0,,,,2,1,2,3
C=C(C(O)=O)C(C=O)=O,,,5,1,7,0,7
30100_0,,,,2,1,2,3
C(CO)=C(C(O)=O)C(C=O)=O,,,5,1,5,0,5
30102_0,,,,2,1,2,3
C=C(C=O)C(C(C)=O)=O,,,5,1,4,0,4
30104_0,,,,2,1,2,3
C=C(C=O)C(C(CCO)=O)=O,,,5,1,3,0,3
30105_0,,,,2,1,2,3
30107_0,,,,2,1,2,3
C(C=CC(C(C)=O)=O)=O,,,5,1,4,0,4
30109_0,,,,2,1,2,3
C(C(C=CC=O)=O)(CCO)=O,,,5,1,2,0,2
30110_0,,,,2,1,2,3
30112_0,,,,2,1,2,3
C(CO)=C(C=O)C(C(C)=O)=O,,,5,1,3,0,3
30113_0,,,,2,1,2,3
30115_0,,,,2,1,2,3
C(C(C=CC(C(C)=O)=O)O)=O,,,5,1,2,0,2
30117_0,,,,2,1,2,3
C(C(C=CC(C=O)=O)O)=O,,,5,1,5,0,5
30119_0,,,,2,1,2,3
C(C(C=CC(CO)=O)=O)(C)=O,,,5,1,3,0,3
30120_0,,,,2,1,2,3
30122_0,,,,2,1,2,3
C(C=C(C(C(C)=O)=O)CO)=O,,,5,1,2,0,2
30123_0,,,,2,1,2,3
30125_0,,,,2,1,2,3
C(C(C(C(C(C)=O)=O)=C)O)=O,,,5,1,2,0,2
30126_0,,,,2,1,2,3
30128_0,,,,2,1,2,3
C=CC(C(C)=O)=O,,,5,1,2,0,2
30130_0,,,,2,1,2,3
C=CC(C(CCO)=O)=O,,,5,1,2,0,2
30132_0,,,,2,1,2,3
C=CC(C(C=O)=O)=O,,,5,1,5,0,5
30134_0,,,,2,1,2,3
C(CO)=CC(C(C=O)=O)=O,,,5,1,2,0,2
30135_0,,,,2,1,2,3
30136_0,,,,2,1,2,3
30137_0,,,,2,1,2,3
30139_0,,,,2,1,2,3
C(C(C1C(C(C(O1)O)O)O)=O)=O,,,5,1,3,0,3
30141_0,,,,2,1,2,3
C1(C(COC(C1(C)O)O)=O)=O,,,5,1,2,0,2
30143_0,,,,2,1,2,3
C1(C(COC(C)(C1O)O)=O)=O,,,5,1,2,0,2
30145_0,,,,2,1,2,3
C1(C(COC(C1(CO)O)O)=O)=O,,,5,1,2,0,2
30147_0,,,,2,1,2,3
C1(C(COC(CO)(C1O)O)=O)=O,,,5,1,2,0,2
30149_0,,,,2,1,2,3
C1(C(C(C)OC(C1O)O)=O)=O,,,5,1,2,0,2
30151_0,,,,2,1,2,3
C(C1C(C(C(C(O1)O)O)=O)=O)=O,,,5,1,2,0,2
30153_0,,,,2,1,2,3
C(C(C)=O)(C1C(CC(O1)O)O)=O,,,5,1,3,0,3
30155_0,,,,2,1,2,3
C(C(C)=O)(C1CC(C(O1)O)O)=O,,,5,1,2,0,2
30157_0,,,,2,1,2,3
C(C(C1CC(C(O1)O)O)=O)=O,,,5,1,3,0,3
30158_0,,,,2,1,2,3
30159_0,,,,2,1,2,3
30161_0,,,,2,1,2,3
C(C(C1(CC(CO1)O)O)=O)=O,,,5,1,3,0,3
30162_0,,,,2,1,2,3
30163_0,,,,2,1,2,3
30165_0,,,,2,1,2,3
C1(C(COC(CC1O)O)=O)=O,,,5,1,2,0,2
30167_0,,,,2,1,2,3
C1(C(CCOC(C1(C)O)O)=O)=O,,,5,1,2,0,2
30169_0,,,,2,1,2,3
C1(C(C(C(C)(O)OCC1)O)=O)=O,,,5,1,2,0,2
30171_0,,,,2,1,2,3
C1(C(C(C(O)OCC1)O)=O)=O,,,5,1,2,0,2
30172_0,,,,2,1,2,3
30173_0,,,,2,1,2,3
30175_0,,,,2,1,2,3
C1(C(C(CC(O)OCC1)O)=O)=O,,,5,1,1,0,1
30177_0,,,,2,1,2,3
C1(C(C(C(CO1)=O)=O)O)=O,,,5,1,2,0,2
30179_0,,,,2,1,2,3
C1(C(C(C(CCO1)=O)=O)O)=O,,,5,1,2,0,2
30180_0,,,,2,1,2,3
30182_0,,,,2,1,2,3
C(CC(C(CCC(O)=O)=O)=O)=O,,,5,1,3,0,3
30184_0,,,,2,1,2,3
C(CCC(C(C(C)=O)=O)=O)(O)=O,,,5,1,2,0,2
30185_0,,,,2,1,2,3
30187_0,,,,2,1,2,3
C(CCC(C(C(C)O)=O)=O)(O)=O,,,5,1,1,0,1
30188_0,,,,2,1,2,3
30189_0,,,,2,1,2,3
30190_0,,,,2,1,2,3
30191_0,,,,2,1,2,3
30193_0,,,,2,1,2,3
C=CC(C(CCC(C=O)=O)=O)=O,,,5,1,1,0,1
30195_0,,,,2,1,2,3
C(C(CCC(C=O)=O)=O)=O,,,5,1,4,0,4
30197_0,,,,2,1,2,3
C(C(CCC(C(CO)=O)=O)=O)=O,,,5,1,5,0,5
30198_0,,,,2,1,2,3
30199_0,,,,2,1,2,3
30200_0,,,,2,1,2,3
30202_0,,,,2,1,2,3
C(C(C(C(C=C)=O)=O)CC=O)=O,,,5,1,2,0,2
30203_0,,,,2,1,2,3
30204_0,,,,2,1,2,3
30205_0,,,,2,1,2,3
30207_0,,,,2,1,2,3
C(CCC(C(C=C)=O)=O)(O)=O,,,5,1,1,0,1
30209_0,,,,2,1,2,3
C(CCC(C=O)=O)(O)=O,,,5,1,9,0,9
30211_0,,,,2,1,2,3
C(CCC(C(CO)=O)=O)(O)=O,,,5,1,4,0,4
30212_0,,,,2,1,2,3
30214_0,,,,2,1,2,3
C(CCC(C(C)=O)=O)(O)=O,,,5,1,4,0,4
30215_0,,,,2,1,2,3
30217_0,,,,2,1,2,3
C(CCC(C(CCO)=O)=O)(O)=O,,,5,1,3,0,3
30218_0,,,,2,1,2,3
30219_0,,,,2,1,2,3
30221_0,,,,2,1,2,3
C(CC(C(C=O)=O)CO)(O)=O,,,5,1,6,0,6
30223_0,,,,2,1,2,3
C(CC(C(C(C)=O)=O)CO)(O)=O,,,5,1,2,0,2
30224_0,,,,2,1,2,3
30225_0,,,,2,1,2,3
30226_0,,,,2,1,2,3
30227_0,,,,2,1,2,3
30228_0,,,,2,1,2,3
30229_0,,,,2,1,1,2
30229_1,,,,2,1,1,2
30230_0,,,,2,1,1,2
30230_1,,,,2,1,1,2
30231_0,,,,2,1,1,2
30231_1,,,,2,1,1,2
30232_0,,,,2,1,1,2
30232_1,,,,2,1,1,2
30233_0,,,,2,1,1,2
30233_1,,,,2,1,1,2
30234_0,,,,2,1,1,2
30235_0,,,,2,1,1,2
30235_1,,,,2,1,1,2
30236_0,,,,2,1,1,2
30236_1,,,,2,1,1,2
30237_0,,,,2,1,1,2
30237_1,,,,2,1,1,2
30238_0,,,,2,1,1,2
30238_1,,,,2,1,1,2
30239_0,,,,2,1,2,3
30239_1,,,,2,1,2,3
30240_0,,,,2,1,1,2
30240_1,,,,2,1,1,2
30241_0,,,,2,1,1,2
30241_1,,,,2,1,1,2
30242_0,,,,2,1,1,2
30242_1,,,,2,1,1,2
30243_0,,,,2,1,1,2
30243_1,,,,2,1,1,2
30244_0,,,,2,1,1,2
30244_1,,,,2,1,1,2
30245_0,,,,2,1,1,2
30245_1,,,,2,1,1,2
30246_0,,,,2,1,1,2
30246_1,,,,2,1,1,2
30247_0,,,,2,1,1,2
30248_0,,,,2,1,1,2
30248_1,,,,2,1,1,2
30249_0,,,,2,1,1,2
30249_1,,,,2,1,1,2
30250_0,,,,2,1,1,2
30250_1,,,,2,1,1,2
30251_0,,,,2,1,1,2
30251_1,,,,2,1,1,2
30252_0,,,,2,1,1,2
30253_0,,,,2,1,1,2
30253_1,,,,2,1,1,2
30254_0,,,,2,1,1,2
30254_1,,,,2,1,1,2
30255_0,,,,2,1,1,2
30255_1,,,,2,1,1,2
30256_0,,,,2,1,1,2
30256_1,,,,2,1,1,2
30257_0,,,,2,1,1,2
30258_0,,,,2,1,1,2
30258_1,,,,2,1,1,2
30259_0,,,,2,1,1,2
30259_1,,,,2,1,1,2
30260_0,,,,2,1,1,2
30260_1,,,,2,1,1,2
30261_0,,,,2,1,1,2
30261_1,,,,2,1,1,2
30262_0,,,,2,1,1,2
30262_1,,,,2,1,1,2
30263_0,,,,2,1,1,2
30263_1,,,,2,1,1,2
30264_0,,,,2,1,1,2
30265_0,,,,2,1,1,2
30266_0,,,,2,1,1,2
30266_1,,,,2,1,1,2
30267_0,,,,2,1,1,2
30267_1,,,,2,1,1,2
30268_0,,,,2,1,1,2
30269_0,,,,2,1,1,2
30270_0,,,,2,1,2,3
30270_1,,,,2,1,2,3
30271_0,,,,2,1,1,2
30271_1,,,,2,1,1,2
30272_0,,,,2,1,1,2
30273_0,,,,2,1,1,2
30273_1,,,,2,1,1,2
30274_0,,,,2,1,1,2
30274_1,,,,2,1,1,2
30275_0,,,,2,1,1,2
30276_0,,,,2,1,1,2
30277_0,,,,2,1,1,2
30277_1,,,,2,1,1,2
30278_0,,,,2,1,1,2
30278_1,,,,2,1,1,2
30279_0,,,,2,1,1,2
30280_0,,,,2,1,1,2
30280_1,,,,2,1,1,2
30281_0,,,,2,1,1,2
30281_1,,,,2,1,1,2
30282_0,,,,2,1,1,2
30283_0,,,,2,1,1,2
30284_0,,,,2,1,1,2
30284_1,,,,2,1,1,2
30285_0,,,,2,1,2,3
30286_0,,,,2,1,1,2
30286_1,,,,2,1,1,2
30287_0,,,,2,1,1,2
30288_0,,,,2,1,1,2
30288_1,,,,2,1,1,2
30289_0,,,,2,1,1,2
30290_0,,,,2,1,1,2
30291_0,,,,2,1,2,3
30291_1,,,,2,1,2,3
30292_0,,,,2,1,1,2
30293_0,,,,2,1,1,2
30294_0,,,,2,1,1,2
30294_1,,,,2,1,1,2
30295_0,,,,2,1,1,2
30295_1,,,,2,1,1,2
30296_0,,,,2,1,1,2
30297_0,,,,2,1,1,2
30297_1,,,,2,1,1,2
30298_0,,,,2,1,1,2
30298_1,,,,2,1,1,2
30299_0,,,,2,1,1,2
30300_0,,,,2,1,1,2
30300_1,,,,2,1,1,2
30301_0,,,,2,1,1,2
30302_0,,,,2,1,2,3
30302_1,,,,2,1,2,3
30303_0,,,,2,1,1,2
30303_1,,,,2,1,1,2
30304_0,,,,2,1,1,2
30304_1,,,,2,1,1,2
30305_0,,,,2,1,1,2
30305_1,,,,2,1,1,2
30306_0,,,,2,1,1,2
30306_1,,,,2,1,1,2
30307_0,,,,2,1,1,2
30307_1,,,,2,1,1,2
30308_0,,,,2,1,1,2
30309_0,,,,2,1,1,2
30309_1,,,,2,1,1,2
30310_0,,,,2,1,1,2
30310_1,,,,2,1,1,2
30311_0,,,,2,1,1,2
30311_1,,,,2,1,1,2
30312_0,,,,2,1,1,2
30313_0,,,,2,1,1,2
30313_1,,,,2,1,1,2
30314_0,,,,2,1,1,2
30314_1,,,,2,1,1,2
30315_0,,,,2,1,2,3
30315_1,,,,2,1,2,3
30316_0,,,,2,1,1,2
30316_1,,,,2,1,1,2
30317_0,,,,2,1,1,2
30317_1,,,,2,1,1,2
30318_0,,,,2,1,1,2
30318_1,,,,2,1,1,2
30319_0,,,,2,1,1,2
30319_1,,,,2,1,1,2
30320_0,,,,2,1,1,2
30320_1,,,,2,1,1,2
30321_0,,,,2,1,1,2
30321_1,,,,2,1,1,2
30322_0,,,,2,1,1,2
30322_1,,,,2,1,1,2
30323_0,,,,2,1,1,2
30324_0,,,,2,1,1,2
30324_1,,,,2,1,1,2
30325_0,,,,2,1,1,2
30325_1,,,,2,1,1,2
30326_0,,,,2,1,1,2
30326_1,,,,2,1,1,2
30327_0,,,,2,1,1,2
30327_1,,,,2,1,1,2
30328_0,,,,2,1,1,2
30328_1,,,,2,1,1,2
30329_0,,,,2,1,1,2
30329_1,,,,2,1,1,2
30330_0,,,,2,1,1,2
30330_1,,,,2,1,1,2
30331_0,,,,2,1,2,3
30331_1,,,,2,1,2,3
30332_0,,,,2,1,1,2
30332_1,,,,2,1,1,2
30333_0,,,,2,1,1,2
30333_1,,,,2,1,1,2
30334_0,,,,2,1,1,2
30334_1,,,,2,1,1,2
30335_0,,,,2,1,2,3
30335_1,,,,2,1,2,3
30336_0,,,,2,1,1,2
30336_1,,,,2,1,1,2
30337_0,,,,2,1,1,2
30337_1,,,,2,1,1,2
30338_0,,,,2,1,1,2
30338_1,,,,2,1,1,2
30339_0,,,,2,1,2,3
30339_1,,,,2,1,2,3
30340_0,,,,2,1,1,2
30340_1,,,,2,1,1,2
30341_0,,,,2,1,1,2
30341_1,,,,2,1,1,2
30342_0,,,,2,1,2,3
30342_1,,,,2,1,2,3
30343_0,,,,2,1,1,2
30343_1,,,,2,1,1,2
30345_0,,,,2,1,1,2
C(C(C(CO)C(C(C=O)=O)O)O)=O,,,5,1,6,0,6
30345_1,,,,2,1,1,2
30346_0,,,,2,1,1,2
30346_1,,,,2,1,1,2
30347_0,,,,2,1,1,2
30347_1,,,,2,1,1,2
30348_0,,,,2,1,1,2
30348_1,,,,2,1,1,2
30349_0,,,,2,1,1,2
30349_1,,,,2,1,1,2
30350_0,,,,2,1,1,2
30350_1,,,,2,1,1,2
30351_0,,,,2,1,1,2
30351_1,,,,2,1,1,2
30352_0,,,,2,1,1,2
30352_1,,,,2,1,1,2
30353_0,,,,2,1,1,2
30353_1,,,,2,1,1,2
30354_0,,,,2,1,1,2
30354_1,,,,2,1,1,2
30355_0,,,,2,1,1,2
30356_0,,,,2,1,1,2
30356_1,,,,2,1,1,2
30357_0,,,,2,1,1,2
30357_1,,,,2,1,1,2
30357_2,,,,2,1,1,2
30358_0,,,,2,1,1,2
30358_1,,,,2,1,1,2
30358_2,,,,2,1,1,2
30359_0,,,,2,1,1,2
30360_0,,,,2,1,1,2
30360_1,,,,2,1,1,2
30361_0,,,,2,1,1,2
30361_1,,,,2,1,1,2
30362_0,,,,2,1,1,2
30362_1,,,,2,1,1,2
30363_0,,,,2,1,1,2
30363_1,,,,2,1,1,2
30364_0,,,,2,1,1,2
30364_1,,,,2,1,1,2
30365_0,,,,2,1,1,2
30365_1,,,,2,1,1,2
30366_0,,,,2,1,1,2
30367_0,,,,2,1,1,2
30367_1,,,,2,1,1,2
30368_0,,,,2,1,1,2
30369_0,,,,2,1,1,2
30369_1,,,,2,1,1,2
30370_0,,,,2,1,1,2
30370_1,,,,2,1,1,2
30371_0,,,,2,1,1,2
30371_1,,,,2,1,1,2
30372_0,,,,2,1,1,2
30372_1,,,,2,1,1,2
30373_0,,,,2,1,1,2
30373_1,,,,2,1,1,2
30374_0,,,,2,1,1,2
30374_1,,,,2,1,1,2
30375_0,,,,2,1,1,2
30375_1,,,,2,1,1,2
30376_0,,,,2,1,1,2
30376_1,,,,2,1,1,2
30377_0,,,,2,1,1,2
30377_1,,,,2,1,1,2
30378_0,,,,2,1,1,2
30378_1,,,,2,1,1,2
30379_0,,,,2,1,1,2
30379_1,,,,2,1,1,2
30380_0,,,,2,1,1,2
30380_1,,,,2,1,1,2
30381_0,,,,2,1,2,3
30382_0,,,,2,1,1,2
30382_1,,,,2,1,1,2
30383_0,,,,2,1,1,2
30383_1,,,,2,1,1,2
30384_0,,,,2,1,1,2
30385_0,,,,2,1,1,2
30385_1,,,,2,1,1,2
30386_0,,,,2,1,1,2
30386_1,,,,2,1,1,2
30387_0,,,,2,1,1,2
30388_0,,,,2,1,1,2
30388_1,,,,2,1,1,2
30389_0,,,,2,1,2,3
30389_1,,,,2,1,2,3
30390_0,,,,2,1,1,2
30390_1,,,,2,1,1,2
30391_0,,,,2,1,1,2
30391_1,,,,2,1,1,2
30391_2,,,,2,1,1,2
30392_0,,,,2,1,1,2
30392_1,,,,2,1,1,2
30392_2,,,,2,1,1,2
30393_0,,,,2,1,1,2
30393_1,,,,2,1,1,2
30394_0,,,,2,1,1,2
30394_1,,,,2,1,1,2
30395_0,,,,2,1,1,2
30395_1,,,,2,1,1,2
30396_0,,,,2,1,1,2
30396_1,,,,2,1,1,2
30397_0,,,,2,1,1,2
30398_0,,,,2,1,2,3
30398_1,,,,2,1,2,3
30399_0,,,,2,1,1,2
30399_1,,,,2,1,1,2
30400_0,,,,2,1,1,2
30400_1,,,,2,1,1,2
30401_0,,,,2,1,1,2
30401_1,,,,2,1,1,2
30401_2,,,,2,1,1,2
30402_0,,,,2,1,1,2
30402_1,,,,2,1,1,2
30402_2,,,,2,1,1,2
30403_0,,,,2,1,1,2
30403_1,,,,2,1,1,2
30404_0,,,,2,1,1,2
30404_1,,,,2,1,1,2
30404_2,,,,2,1,1,2
30405_0,,,,2,1,2,3
30405_1,,,,2,1,2,3
30405_2,,,,2,1,2,3
30406_0,,,,2,1,1,2
30406_1,,,,2,1,1,2
30407_0,,,,2,1,1,2
30407_1,,,,2,1,1,2
30407_2,,,,2,1,1,2
30408_0,,,,2,1,2,3
30408_1,,,,2,1,2,3
30408_2,,,,2,1,2,3
30409_0,,,,2,1,1,2
30409_1,,,,2,1,1,2
30410_0,,,,2,1,1,2
30411_0,,,,2,1,1,2
30411_1,,,,2,1,1,2
30412_0,,,,2,1,1,2
30412_1,,,,2,1,1,2
30412_2,,,,2,1,1,2
30413_0,,,,2,1,2,3
30413_1,,,,2,1,2,3
30413_2,,,,2,1,2,3
30414_0,,,,2,1,1,2
30414_1,,,,2,1,1,2
30415_0,,,,2,1,1,2
30415_1,,,,2,1,1,2
30415_2,,,,2,1,1,2
30416_0,,,,2,1,2,3
30416_1,,,,2,1,2,3
30416_2,,,,2,1,2,3
30417_0,,,,2,1,1,2
30417_1,,,,2,1,1,2
30417_2,,,,2,1,1,2
30418_0,,,,2,1,1,2
30419_0,,,,2,1,1,2
30419_1,,,,2,1,1,2
30419_2,,,,2,1,1,2
30420_0,,,,2,1,1,2
30420_1,,,,2,1,1,2
30420_2,,,,2,1,1,2
30421_0,,,,2,1,1,2
30421_1,,,,2,1,1,2
30422_0,,,,2,1,1,2
30423_0,,,,2,1,1,2
30423_1,,,,2,1,1,2
30423_2,,,,2,1,1,2
30424_0,,,,2,1,1,2
30424_1,,,,2,1,1,2
30424_2,,,,2,1,1,2
30425_0,,,,2,1,1,2
30425_1,,,,2,1,1,2
30426_0,,,,2,1,1,2
30427_0,,,,2,1,1,2
30427_1,,,,2,1,1,2
30427_2,,,,2,1,1,2
30428_0,,,,2,1,1,2
30429_0,,,,2,1,1,2
30429_1,,,,2,1,1,2
30430_0,,,,2,1,1,2
30430_1,,,,2,1,1,2
30431_0,,,,2,1,1,2
30432_0,,,,2,1,2,3
30432_1,,,,2,1,2,3
30432_2,,,,2,1,2,3
30433_0,,,,2,1,1,2
30433_1,,,,2,1,1,2
30433_2,,,,2,1,1,2
30434_0,,,,2,1,1,2
30434_1,,,,2,1,1,2
30435_0,,,,2,1,1,2
30436_0,,,,2,1,1,2
30436_1,,,,2,1,1,2
30437_0,,,,2,1,1,2
30438_0,,,,2,1,1,2
30438_1,,,,2,1,1,2
30439_0,,,,2,1,1,2
30440_0,,,,2,1,1,2
30440_1,,,,2,1,1,2
30440_2,,,,2,1,1,2
30441_0,,,,2,1,1,2
30442_0,,,,2,1,2,3
30442_1,,,,2,1,2,3
30442_2,,,,2,1,2,3
30443_0,,,,2,1,1,2
30443_1,,,,2,1,1,2
30443_2,,,,2,1,1,2
30444_0,,,,2,1,1,2
30444_1,,,,2,1,1,2
30445_0,,,,2,1,1,2
30445_1,,,,2,1,1,2
30446_0,,,,2,1,1,2
30446_1,,,,2,1,1,2
30447_0,,,,2,1,1,2
30447_1,,,,2,1,1,2
30448_0,,,,2,1,2,3
30448_1,,,,2,1,2,3
30449_0,,,,2,1,1,2
30450_0,,,,2,1,1,2
30450_1,,,,2,1,1,2
30451_0,,,,2,1,1,2
30451_1,,,,2,1,1,2
30451_2,,,,2,1,1,2
30452_0,,,,2,1,1,2
30453_0,,,,2,1,1,2
30453_1,,,,2,1,1,2
30453_2,,,,2,1,1,2
30454_0,,,,2,1,1,2
30455_0,,,,2,1,1,2
30455_1,,,,2,1,1,2
30456_0,,,,2,1,1,2
30456_1,,,,2,1,1,2
30457_0,,,,2,1,1,2
30457_1,,,,2,1,1,2
30457_2,,,,2,1,1,2
30458_0,,,,2,1,1,2
30458_1,,,,2,1,1,2
30458_2,,,,2,1,1,2
30459_0,,,,2,1,1,2
30459_1,,,,2,1,1,2
30460_0,,,,2,1,1,2
30460_1,,,,2,1,1,2
30461_0,,,,2,1,1,2
30461_1,,,,2,1,1,2
30461_2,,,,2,1,1,2
30462_0,,,,2,1,1,2
30462_1,,,,2,1,1,2
30462_2,,,,2,1,1,2
30463_0,,,,2,1,1,2
30463_1,,,,2,1,1,2
30463_2,,,,2,1,1,2
30464_0,,,,2,1,1,2
30465_0,,,,2,1,2,3
30466_0,,,,2,1,1,2
30466_1,,,,2,1,1,2
30467_0,,,,2,1,1,2
30468_0,,,,2,1,1,2
30468_1,,,,2,1,1,2
30469_0,,,,2,1,1,2
30469_1,,,,2,1,1,2
30470_0,,,,2,1,1,2
30470_1,,,,2,1,1,2
30471_0,,,,2,1,1,2
30471_1,,,,2,1,1,2
30472_0,,,,2,1,1,2
30472_1,,,,2,1,1,2
30473_0,,,,2,1,1,2
30473_1,,,,2,1,1,2
30474_0,,,,2,1,1,2
30474_1,,,,2,1,1,2
30475_0,,,,2,1,1,2
30475_1,,,,2,1,1,2
30476_0,,,,2,1,1,2
30476_1,,,,2,1,1,2
30477_0,,,,2,1,2,3
30477_1,,,,2,1,2,3
30478_0,,,,2,1,2,3
30478_1,,,,2,1,2,3
30479_0,,,,2,1,2,3
30479_1,,,,2,1,2,3
30480_0,,,,2,1,2,3
30481_0,,,,2,1,2,3
30481_1,,,,2,1,2,3
30482_0,,,,2,1,2,3
30482_1,,,,2,1,2,3
30483_0,,,,2,1,2,3
30483_1,,,,2,1,2,3
30484_0,,,,2,1,2,3
30484_1,,,,2,1,2,3
30485_0,,,,2,1,2,3
30485_1,,,,2,1,2,3
30486_0,,,,2,1,2,3
30486_1,,,,2,1,2,3
30487_0,,,,2,1,2,3
30487_1,,,,2,1,2,3
30488_0,,,,2,1,2,3
30488_1,,,,2,1,2,3
30489_0,,,,2,1,2,3
30489_1,,,,2,1,2,3
30490_0,,,,2,1,2,3
30491_0,,,,2,1,2,3
30491_1,,,,2,1,2,3
30492_0,,,,2,1,2,3
30492_1,,,,2,1,2,3
30493_0,,,,2,1,2,3
30493_1,,,,2,1,2,3
30494_0,,,,2,1,2,3
30495_0,,,,2,1,2,3
30495_1,,,,2,1,2,3
30496_0,,,,2,1,2,3
30496_1,,,,2,1,2,3
30497_0,,,,2,1,2,3
30497_1,,,,2,1,2,3
30498_0,,,,2,1,2,3
30498_1,,,,2,1,2,3
30499_0,,,,2,1,2,3
30499_1,,,,2,1,2,3
30500_0,,,,2,1,2,3
30500_1,,,,2,1,2,3
30501_0,,,,2,1,2,3
30501_1,,,,2,1,2,3
30502_0,,,,2,1,2,3
30502_1,,,,2,1,2,3
30503_0,,,,2,1,2,3
30503_1,,,,2,1,2,3
30504_0,,,,2,1,2,3
30505_0,,,,2,1,2,3
30505_1,,,,2,1,2,3
30506_0,,,,2,1,2,3
30506_1,,,,2,1,2,3
30507_0,,,,2,1,2,3
30507_1,,,,2,1,2,3
30508_0,,,,2,1,2,3
30508_1,,,,2,1,2,3
30509_0,,,,2,1,2,3
30510_0,,,,2,1,2,3
30510_1,,,,2,1,2,3
30511_0,,,,2,1,2,3
30511_1,,,,2,1,2,3
30512_0,,,,2,1,2,3
30512_1,,,,2,1,2,3
30513_0,,,,2,1,2,3
30513_1,,,,2,1,2,3
30514_0,,,,2,1,2,3
30515_0,,,,2,1,2,3
30516_0,,,,2,1,2,3
30517_0,,,,2,1,2,3
30518_0,,,,2,1,2,3
30518_1,,,,2,1,2,3
30519_0,,,,2,1,2,3
30519_1,,,,2,1,2,3
30520_0,,,,2,1,2,3
30520_1,,,,2,1,2,3
30521_0,,,,2,1,2,3
30521_1,,,,2,1,2,3
30522_0,,,,2,1,2,3
30523_0,,,,2,1,2,3
30523_1,,,,2,1,2,3
30524_0,,,,2,1,2,3
30524_1,,,,2,1,2,3
30525_0,,,,2,1,2,3
30525_1,,,,2,1,2,3
30526_0,,,,2,1,2,3
30526_1,,,,2,1,2,3
30527_0,,,,2,1,2,3
30527_1,,,,2,1,2,3
30528_0,,,,2,1,2,3
30529_0,,,,2,1,2,3
30530_0,,,,2,1,2,3
30530_1,,,,2,1,2,3
30531_0,,,,2,1,2,3
30532_0,,,,2,1,2,3
30532_1,,,,2,1,2,3
30533_0,,,,2,1,2,3
30533_1,,,,2,1,2,3
30534_0,,,,2,1,2,3
30534_1,,,,2,1,2,3
30535_0,,,,2,1,2,3
30535_1,,,,2,1,2,3
30536_0,,,,2,1,2,3
30536_1,,,,2,1,2,3
30537_0,,,,2,1,2,3
30537_1,,,,2,1,2,3
30538_0,,,,2,1,2,3
30538_1,,,,2,1,2,3
30539_0,,,,2,1,2,3
30539_1,,,,2,1,2,3
30540_0,,,,2,1,2,3
30540_1,,,,2,1,2,3
30541_0,,,,2,1,2,3
30541_1,,,,2,1,2,3
30542_0,,,,2,1,2,3
30542_1,,,,2,1,2,3
30543_0,,,,2,1,2,3
30543_1,,,,2,1,2,3
30544_0,,,,2,1,2,3
30544_1,,,,2,1,2,3
30545_0,,,,2,1,2,3
30545_1,,,,2,1,2,3
30546_0,,,,2,1,2,3
30546_1,,,,2,1,2,3
30547_0,,,,2,1,2,3
30547_1,,,,2,1,2,3
30548_0,,,,2,1,2,3
30548_1,,,,2,1,2,3
30549_0,,,,2,1,2,3
30549_1,,,,2,1,2,3
30550_0,,,,2,1,2,3
30550_1,,,,2,1,2,3
30551_0,,,,2,1,2,3
30551_1,,,,2,1,2,3
30552_0,,,,2,1,2,3
30552_1,,,,2,1,2,3
30553_0,,,,2,1,2,3
30553_1,,,,2,1,2,3
30554_0,,,,2,1,2,3
30554_1,,,,2,1,2,3
30555_0,,,,2,1,2,3
30555_1,,,,2,1,2,3
30556_0,,,,2,1,2,3
30557_0,,,,2,1,2,3
30558_0,,,,2,1,2,3
30559_0,,,,2,1,2,3
30560_0,,,,2,1,2,3
30561_0,,,,2,1,2,3
30561_1,,,,2,1,2,3
30562_0,,,,2,1,2,3
30562_1,,,,2,1,2,3
30563_0,,,,2,1,2,3
30563_1,,,,2,1,2,3
30564_0,,,,2,1,2,3
30564_1,,,,2,1,2,3
30565_0,,,,2,1,2,3
30566_0,,,,2,1,2,3
30566_1,,,,2,1,2,3
30567_0,,,,2,1,2,3
30567_1,,,,2,1,2,3
30568_0,,,,2,1,2,3
30569_0,,,,2,1,2,3
30569_1,,,,2,1,2,3
30570_0,,,,2,1,2,3
30570_1,,,,2,1,2,3
30571_0,,,,2,1,2,3
30571_1,,,,2,1,2,3
30572_0,,,,2,1,2,3
30572_1,,,,2,1,2,3
30573_0,,,,2,1,2,3
30574_0,,,,2,1,2,3
30575_0,,,,2,1,2,3
30575_1,,,,2,1,2,3
30576_0,,,,2,1,2,3
30577_0,,,,2,1,2,3
30577_1,,,,2,1,2,3
30578_0,,,,2,1,2,3
30578_1,,,,2,1,2,3
30579_0,,,,2,1,2,3
30579_1,,,,2,1,2,3
30580_0,,,,2,1,2,3
30581_0,,,,2,1,2,3
30581_1,,,,2,1,2,3
30582_0,,,,2,1,2,3
30583_0,,,,2,1,2,3
30584_0,,,,2,1,2,3
30585_0,,,,2,1,2,3
30586_0,,,,2,1,2,3
30587_0,,,,2,1,2,3
30587_1,,,,2,1,2,3
30588_0,,,,2,1,2,3
30589_0,,,,2,1,2,3
30590_0,,,,2,1,2,3
30591_0,,,,2,1,2,3
30591_1,,,,2,1,2,3
30592_0,,,,2,1,2,3
30593_0,,,,2,1,2,3
30593_1,,,,2,1,2,3
30594_0,,,,2,1,2,3
30594_1,,,,2,1,2,3
30595_0,,,,2,1,2,3
30595_1,,,,2,1,2,3
30596_0,,,,2,1,2,3
30596_1,,,,2,1,2,3
30597_0,,,,2,1,2,3
30597_1,,,,2,1,2,3
30598_0,,,,2,1,2,3
30598_1,,,,2,1,2,3
30599_0,,,,2,1,2,3
30599_1,,,,2,1,2,3
30600_0,,,,2,1,2,3
30600_1,,,,2,1,2,3
30601_0,,,,2,1,2,3
30601_1,,,,2,1,2,3
30602_0,,,,2,1,2,3
30602_1,,,,2,1,2,3
30603_0,,,,2,1,2,3
30603_1,,,,2,1,2,3
30604_0,,,,2,1,2,3
30604_1,,,,2,1,2,3
30605_0,,,,2,1,2,3
30605_1,,,,2,1,2,3
30606_0,,,,2,1,2,3
30606_1,,,,2,1,2,3
30607_0,,,,2,1,2,3
30607_1,,,,2,1,2,3
30608_0,,,,2,1,2,3
30608_1,,,,2,1,2,3
30609_0,,,,2,1,2,3
30609_1,,,,2,1,2,3
30610_0,,,,2,1,2,3
30610_1,,,,2,1,2,3
30611_0,,,,2,1,2,3
30611_1,,,,2,1,2,3
30612_0,,,,2,1,2,3
30613_0,,,,2,1,2,3
30613_1,,,,2,1,2,3
30614_0,,,,2,1,2,3
30614_1,,,,2,1,2,3
30615_0,,,,2,1,2,3
30615_1,,,,2,1,2,3
30616_0,,,,2,1,2,3
30617_0,,,,2,1,2,3
30617_1,,,,2,1,2,3
30618_0,,,,2,1,2,3
30618_1,,,,2,1,2,3
30619_0,,,,2,1,2,3
30619_1,,,,2,1,2,3
30620_0,,,,2,1,2,3
30621_0,,,,2,1,2,3
30622_0,,,,2,1,2,3
30623_0,,,,2,1,2,3
30623_1,,,,2,1,2,3
30624_0,,,,2,1,2,3
30624_1,,,,2,1,2,3
30625_0,,,,2,1,2,3
30625_1,,,,2,1,2,3
30626_0,,,,2,1,2,3
30626_1,,,,2,1,2,3
30627_0,,,,2,1,2,3
30628_0,,,,2,1,2,3
30628_1,,,,2,1,2,3
30629_0,,,,2,1,2,3
30630_0,,,,2,1,2,3
30631_0,,,,2,1,2,3
30632_0,,,,2,1,2,3
30632_1,,,,2,1,2,3
30633_0,,,,2,1,2,3
30633_1,,,,2,1,2,3
30634_0,,,,2,1,2,3
30634_1,,,,2,1,2,3
30635_0,,,,2,1,2,3
30635_1,,,,2,1,2,3
30636_0,,,,2,1,2,3
30636_1,,,,2,1,2,3
30637_0,,,,2,1,2,3
30638_0,,,,2,1,2,3
30638_1,,,,2,1,2,3
30639_0,,,,2,1,2,3
30639_1,,,,2,1,2,3
30640_0,,,,2,1,2,3
30640_1,,,,2,1,2,3
30641_0,,,,2,1,2,3
30642_0,,,,2,1,2,3
30643_0,,,,2,1,2,3
30643_1,,,,2,1,2,3
30644_0,,,,2,1,2,3
30645_0,,,,2,1,2,3
30645_1,,,,2,1,2,3
30646_0,,,,2,1,2,3
30646_1,,,,2,1,2,3
30647_0,,,,2,1,2,3
30647_1,,,,2,1,2,3
30648_0,,,,2,1,2,3
30649_0,,,,2,1,2,3
30649_1,,,,2,1,2,3
30650_0,,,,2,1,2,3
30651_0,,,,2,1,2,3
30652_0,,,,2,1,2,3
30653_0,,,,2,1,2,3
30653_1,,,,2,1,2,3
30654_0,,,,2,1,2,3
30654_1,,,,2,1,2,3
30655_0,,,,2,1,2,3
30655_1,,,,2,1,2,3
30656_0,,,,2,1,2,3
30656_1,,,,2,1,2,3
30657_0,,,,2,1,2,3
30657_1,,,,2,1,2,3
30658_0,,,,2,1,2,3
30658_1,,,,2,1,2,3
30659_0,,,,2,1,2,3
30659_1,,,,2,1,2,3
30660_0,,,,2,1,2,3
30660_1,,,,2,1,2,3
30661_0,,,,2,1,2,3
30661_1,,,,2,1,2,3
30662_0,,,,2,1,2,3
30662_1,,,,2,1,2,3
30663_0,,,,2,1,2,3
30663_1,,,,2,1,2,3
30664_0,,,,2,1,2,3
30664_1,,,,2,1,2,3
30665_0,,,,2,1,2,3
30665_1,,,,2,1,2,3
30666_0,,,,2,1,2,3
30666_1,,,,2,1,2,3
30667_0,,,,2,1,2,3
30667_1,,,,2,1,2,3
30668_0,,,,2,1,2,3
30668_1,,,,2,1,2,3
30669_0,,,,2,1,2,3
30669_1,,,,2,1,2,3
30670_0,,,,2,1,2,3
30671_0,,,,2,1,2,3
30672_0,,,,2,1,2,3
30673_0,,,,2,1,2,3
30674_0,,,,2,1,2,3
30675_0,,,,2,1,2,3
30675_1,,,,2,1,2,3
30676_0,,,,2,1,2,3
30677_0,,,,2,1,2,3
30678_0,,,,2,1,2,3
30679_0,,,,2,1,2,3
30680_0,,,,2,1,2,3
30681_0,,,,2,1,2,3
30682_0,,,,2,1,2,3
30683_0,,,,2,1,2,3
30684_0,,,,2,1,2,3
30685_0,,,,2,1,2,3
30686_0,,,,2,1,2,3
30687_0,,,,2,1,2,3
30688_0,,,,2,1,2,3
30689_0,,,,2,1,2,3
30690_0,,,,2,1,2,3
30690_1,,,,2,1,2,3
30691_0,,,,2,1,2,3
30691_1,,,,2,1,2,3
30692_0,,,,2,1,2,3
30692_1,,,,2,1,2,3
30693_0,,,,2,1,2,3
30693_1,,,,2,1,2,3
30694_0,,,,2,1,2,3
30694_1,,,,2,1,2,3
30695_0,,,,2,1,2,3
30695_1,,,,2,1,2,3
30696_0,,,,2,1,2,3
30696_1,,,,2,1,2,3
30697_0,,,,2,1,2,3
30697_1,,,,2,1,2,3
30698_0,,,,2,1,2,3
30699_0,,,,2,1,2,3
30699_1,,,,2,1,2,3
30700_0,,,,2,1,2,3
30700_1,,,,2,1,2,3
30701_0,,,,2,1,2,3
30702_0,,,,2,1,2,3
30702_1,,,,2,1,2,3
30703_0,,,,2,1,2,3
30703_1,,,,2,1,2,3
30704_0,,,,2,1,2,3
30705_0,,,,2,1,2,3
30706_0,,,,2,1,2,3
30707_0,,,,2,1,2,3
30708_0,,,,2,1,2,3
30709_0,,,,2,1,2,3
30709_1,,,,2,1,2,3
30710_0,,,,2,1,2,3
30710_1,,,,2,1,2,3
30711_0,,,,2,1,2,3
30712_0,,,,2,1,2,3
30712_1,,,,2,1,2,3
30713_0,,,,2,1,2,3
30713_1,,,,2,1,2,3
30714_0,,,,2,1,2,3
30715_0,,,,2,1,2,3
30715_1,,,,2,1,2,3
30716_0,,,,2,1,2,3
30716_1,,,,2,1,2,3
30717_0,,,,2,1,2,3
30718_0,,,,2,1,2,3
30719_0,,,,2,1,2,3
30719_1,,,,2,1,2,3
30720_0,,,,2,1,2,3
30720_1,,,,2,1,2,3
30721_0,,,,2,1,2,3
30722_0,,,,2,1,2,3
30722_1,,,,2,1,2,3
30723_0,,,,2,1,2,3
30723_1,,,,2,1,2,3
30724_0,,,,2,1,2,3
30724_1,,,,2,1,2,3
30725_0,,,,2,1,2,3
30725_1,,,,2,1,2,3
30726_0,,,,2,1,2,3
30726_1,,,,2,1,2,3
30727_0,,,,2,1,2,3
30727_1,,,,2,1,2,3
30728_0,,,,2,1,2,3
30729_0,,,,2,1,2,3
30730_0,,,,2,1,2,3
30730_1,,,,2,1,2,3
30731_0,,,,2,1,2,3
30732_0,,,,2,1,2,3
30732_1,,,,2,1,2,3
30733_0,,,,2,1,2,3
30733_1,,,,2,1,2,3
30734_0,,,,2,1,2,3
30734_1,,,,2,1,2,3
30735_0,,,,2,1,2,3
30735_1,,,,2,1,2,3
30736_0,,,,2,1,2,3
30737_0,,,,2,1,2,3
30737_1,,,,2,1,2,3
30738_0,,,,2,1,2,3
30738_1,,,,2,1,2,3
30739_0,,,,2,1,2,3
30740_0,,,,2,1,2,3
30741_0,,,,2,1,2,3
30742_0,,,,2,1,2,3
30742_1,,,,2,1,2,3
30743_0,,,,2,1,2,3
30743_1,,,,2,1,2,3
30744_0,,,,2,1,2,3
30744_1,,,,2,1,2,3
30745_0,,,,2,1,2,3
30745_1,,,,2,1,2,3
30746_0,,,,2,1,2,3
30746_1,,,,2,1,2,3
30747_0,,,,2,1,2,3
30747_1,,,,2,1,2,3
30748_0,,,,2,1,2,3
30748_1,,,,2,1,2,3
30749_0,,,,2,1,2,3
30749_1,,,,2,1,2,3
30750_0,,,,2,1,2,3
30750_1,,,,2,1,2,3
30751_0,,,,2,1,2,3
30751_1,,,,2,1,2,3
30752_0,,,,2,1,2,3
30752_1,,,,2,1,2,3
30753_0,,,,2,1,2,3
30753_1,,,,2,1,2,3
30754_0,,,,2,1,2,3
30754_1,,,,2,1,2,3
30755_0,,,,2,1,2,3
30755_1,,,,2,1,2,3
30756_0,,,,2,1,2,3
30756_1,,,,2,1,2,3
30757_0,,,,2,1,2,3
30758_0,,,,2,1,2,3
30758_1,,,,2,1,2,3
30759_0,,,,2,1,2,3
30759_1,,,,2,1,2,3
30760_0,,,,2,1,2,3
30760_1,,,,2,1,2,3
30761_0,,,,2,1,2,3
30761_1,,,,2,1,2,3
30762_0,,,,2,1,2,3
30762_1,,,,2,1,2,3
30763_0,,,,2,1,2,3
30763_1,,,,2,1,2,3
30764_0,,,,2,1,2,3
30764_1,,,,2,1,2,3
30765_0,,,,2,1,2,3
30766_0,,,,2,1,2,3
30766_1,,,,2,1,2,3
30767_0,,,,2,1,2,3
30767_1,,,,2,1,2,3
30768_0,,,,2,1,2,3
30768_1,,,,2,1,2,3
30769_0,,,,2,1,2,3
30769_1,,,,2,1,2,3
30770_0,,,,2,1,2,3
30770_1,,,,2,1,2,3
30771_0,,,,2,1,2,3
30772_0,,,,2,1,2,3
30772_1,,,,2,1,2,3
30773_0,,,,2,1,2,3
30774_0,,,,2,1,2,3
30774_1,,,,2,1,2,3
30775_0,,,,2,1,2,3
30775_1,,,,2,1,2,3
30776_0,,,,2,1,2,3
30776_1,,,,2,1,2,3
30777_0,,,,2,1,2,3
30777_1,,,,2,1,2,3
30778_0,,,,2,1,2,3
30778_1,,,,2,1,2,3
30779_0,,,,2,1,2,3
30779_1,,,,2,1,2,3
30780_0,,,,2,1,2,3
30780_1,,,,2,1,2,3
30781_0,,,,2,1,2,3
30781_1,,,,2,1,2,3
30782_0,,,,2,1,2,3
30782_1,,,,2,1,2,3
30783_0,,,,2,1,2,3
30783_1,,,,2,1,2,3
30784_0,,,,2,1,2,3
30784_1,,,,2,1,2,3
30785_0,,,,2,1,2,3
30785_1,,,,2,1,2,3
30786_0,,,,2,1,2,3
30787_0,,,,2,1,2,3
30787_1,,,,2,1,2,3
30788_0,,,,2,1,2,3
30789_0,,,,2,1,2,3
30790_0,,,,2,1,2,3
30791_0,,,,2,1,2,3
30792_0,,,,2,1,2,3
30792_1,,,,2,1,2,3
30793_0,,,,2,1,2,3
30794_0,,,,2,1,2,3
30794_1,,,,2,1,2,3
30795_0,,,,2,1,2,3
30795_1,,,,2,1,2,3
30796_0,,,,2,1,2,3
30797_0,,,,2,1,2,3
30797_1,,,,2,1,2,3
30798_0,,,,2,1,2,3
30798_1,,,,2,1,2,3
30799_0,,,,2,1,2,3
30800_0,,,,2,1,2,3
30800_1,,,,2,1,2,3
30801_0,,,,2,1,2,3
30801_1,,,,2,1,2,3
30802_0,,,,2,1,2,3
30803_0,,,,2,1,2,3
30803_1,,,,2,1,2,3
30804_0,,,,2,1,2,3
30804_1,,,,2,1,2,3
30805_0,,,,2,1,2,3
30806_0,,,,2,1,2,3
30806_1,,,,2,1,2,3
30807_0,,,,2,1,2,3
30807_1,,,,2,1,2,3
30808_0,,,,2,1,2,3
30809_0,,,,2,1,2,3
30809_1,,,,2,1,2,3
30810_0,,,,2,1,2,3
30810_1,,,,2,1,2,3
30811_0,,,,2,1,2,3
30812_0,,,,2,1,2,3
30812_1,,,,2,1,2,3
30813_0,,,,2,1,2,3
30813_1,,,,2,1,2,3
30814_0,,,,2,1,2,3
30815_0,,,,2,1,2,3
30815_1,,,,2,1,2,3
30816_0,,,,2,1,2,3
30816_1,,,,2,1,2,3
30817_0,,,,2,1,2,3
30818_0,,,,2,1,2,3
30818_1,,,,2,1,2,3
30819_0,,,,2,1,2,3
30820_0,,,,2,1,2,3
30820_1,,,,2,1,2,3
30821_0,,,,2,1,2,3
30821_1,,,,2,1,2,3
30822_0,,,,2,1,2,3
30823_0,,,,2,1,2,3
30823_1,,,,2,1,2,3
30824_0,,,,2,1,2,3
30825_0,,,,2,1,2,3
30825_1,,,,2,1,2,3
30826_0,,,,2,1,2,3
30826_1,,,,2,1,2,3
30827_0,,,,2,1,2,3
30827_1,,,,2,1,2,3
30828_0,,,,2,1,2,3
30828_1,,,,2,1,2,3
30829_0,,,,2,1,2,3
30829_1,,,,2,1,2,3
30830_0,,,,2,1,2,3
30830_1,,,,2,1,2,3
30831_0,,,,2,1,2,3
30831_1,,,,2,1,2,3
30832_0,,,,2,1,2,3
30832_1,,,,2,1,2,3
30833_0,,,,2,1,2,3
30833_1,,,,2,1,2,3
30834_0,,,,2,1,2,3
30834_1,,,,2,1,2,3
30835_0,,,,2,1,2,3
30835_1,,,,2,1,2,3
30836_0,,,,2,1,2,3
30836_1,,,,2,1,2,3
30837_0,,,,2,1,2,3
30837_1,,,,2,1,2,3
30838_0,,,,2,1,2,3
30838_1,,,,2,1,2,3
30839_0,,,,2,1,2,3
30839_1,,,,2,1,2,3
30840_0,,,,2,1,2,3
30840_1,,,,2,1,2,3
30841_0,,,,2,1,2,3
30841_1,,,,2,1,2,3
30842_0,,,,2,1,2,3
30842_1,,,,2,1,2,3
30843_0,,,,2,1,2,3
30843_1,,,,2,1,2,3
30844_0,,,,2,1,2,3
30844_1,,,,2,1,2,3
30845_0,,,,2,1,2,3
30845_1,,,,2,1,2,3
30846_0,,,,2,1,2,3
30846_1,,,,2,1,2,3
30847_0,,,,2,1,2,3
30847_1,,,,2,1,2,3
30848_0,,,,2,1,2,3
30849_0,,,,2,1,2,3
30849_1,,,,2,1,2,3
30850_0,,,,2,1,2,3
30850_1,,,,2,1,2,3
30851_0,,,,2,1,2,3
30851_1,,,,2,1,2,3
30852_0,,,,2,1,2,3
30852_1,,,,2,1,2,3
30853_0,,,,2,1,2,3
30853_1,,,,2,1,2,3
30854_0,,,,2,1,2,3
30854_1,,,,2,1,2,3
30855_0,,,,2,1,2,3
30855_1,,,,2,1,2,3
30856_0,,,,2,1,2,3
30857_0,,,,2,1,2,3
30857_1,,,,2,1,2,3
30858_0,,,,2,1,2,3
30858_1,,,,2,1,2,3
30859_0,,,,2,1,2,3
30860_0,,,,2,1,2,3
30860_1,,,,2,1,2,3
30861_0,,,,2,1,2,3
30861_1,,,,2,1,2,3
30862_0,,,,2,1,2,3
30862_1,,,,2,1,2,3
30863_0,,,,2,1,2,3
30863_1,,,,2,1,2,3
30864_0,,,,2,1,2,3
30864_1,,,,2,1,2,3
30865_0,,,,2,1,2,3
30865_1,,,,2,1,2,3
30866_0,,,,2,1,2,3
30867_0,,,,2,1,2,3
30868_0,,,,2,1,2,3
30869_0,,,,2,1,2,3
30869_1,,,,2,1,2,3
30870_0,,,,2,1,2,3
30870_1,,,,2,1,2,3
30871_0,,,,2,1,2,3
30871_1,,,,2,1,2,3
30872_0,,,,2,1,2,3
30872_1,,,,2,1,2,3
30873_0,,,,2,1,2,3
30873_1,,,,2,1,2,3
30874_0,,,,2,1,2,3
30874_1,,,,2,1,2,3
30875_0,,,,2,1,2,3
30876_0,,,,2,1,2,3
30877_0,,,,2,1,2,3
30877_1,,,,2,1,2,3
30878_0,,,,2,1,2,3
30878_1,,,,2,1,2,3
30879_0,,,,2,1,2,3
30880_0,,,,2,1,2,3
30880_1,,,,2,1,2,3
30881_0,,,,2,1,2,3
30881_1,,,,2,1,2,3
30882_0,,,,2,1,2,3
30883_0,,,,2,1,2,3
30883_1,,,,2,1,2,3
30884_0,,,,2,1,2,3
30884_1,,,,2,1,2,3
30885_0,,,,2,1,2,3
30886_0,,,,2,1,2,3
30887_0,,,,2,1,2,3
30887_1,,,,2,1,2,3
30888_0,,,,2,1,2,3
30888_1,,,,2,1,2,3
30889_0,,,,2,1,2,3
30890_0,,,,2,1,2,3
30890_1,,,,2,1,2,3
30891_0,,,,2,1,2,3
30891_1,,,,2,1,2,3
30892_0,,,,2,1,2,3
30893_0,,,,2,1,2,3
30893_1,,,,2,1,2,3
30894_0,,,,2,1,2,3
30894_1,,,,2,1,2,3
30895_0,,,,2,1,2,3
30895_1,,,,2,1,2,3
30896_0,,,,2,1,2,3
30896_1,,,,2,1,2,3
30897_0,,,,2,1,2,3
30898_0,,,,2,1,2,3
30899_0,,,,2,1,2,3
30899_1,,,,2,1,2,3
30900_0,,,,2,1,2,3
30900_1,,,,2,1,2,3
30901_0,,,,2,1,2,3
30902_0,,,,2,1,2,3
30903_0,,,,2,1,2,3
30903_1,,,,2,1,2,3
30904_0,,,,2,1,2,3
30904_1,,,,2,1,2,3
30905_0,,,,2,1,2,3
30906_0,,,,2,1,2,3
30906_1,,,,2,1,2,3
30907_0,,,,2,1,2,3
30907_1,,,,2,1,2,3
30908_0,,,,2,1,2,3
30909_0,,,,2,1,2,3
30909_1,,,,2,1,2,3
30910_0,,,,2,1,2,3
30910_1,,,,2,1,2,3
30911_0,,,,2,1,2,3
30912_0,,,,2,1,2,3
30913_0,,,,2,1,2,3
30913_1,,,,2,1,2,3
30914_0,,,,2,1,2,3
30914_1,,,,2,1,2,3
30915_0,,,,2,1,2,3
30915_1,,,,2,1,2,3
30916_0,,,,2,1,2,3
30916_1,,,,2,1,2,3
30917_0,,,,2,1,2,3
30917_1,,,,2,1,2,3
30918_0,,,,2,1,2,3
30918_1,,,,2,1,2,3
30919_0,,,,2,1,2,3
30920_0,,,,2,1,2,3
30921_0,,,,2,1,2,3
30921_1,,,,2,1,2,3
30922_0,,,,2,1,2,3
30923_0,,,,2,1,2,3
30924_0,,,,2,1,2,3
30924_1,,,,2,1,2,3
30925_0,,,,2,1,2,3
30925_1,,,,2,1,2,3
30926_0,,,,2,1,2,3
30927_0,,,,2,1,2,3
30928_0,,,,2,1,2,3
30928_1,,,,2,1,2,3
30929_0,,,,2,1,2,3
30929_1,,,,2,1,2,3
30930_0,,,,2,1,2,3
30931_0,,,,2,1,2,3
30931_1,,,,2,1,2,3
30932_0,,,,2,1,2,3
30932_1,,,,2,1,2,3
30933_0,,,,2,1,2,3
30934_0,,,,2,1,2,3
30934_1,,,,2,1,2,3
30935_0,,,,2,1,2,3
30935_1,,,,2,1,2,3
30936_0,,,,2,1,2,3
30937_0,,,,2,1,2,3
30938_0,,,,2,1,2,3
30938_1,,,,2,1,2,3
30939_0,,,,2,1,2,3
30940_0,,,,2,1,2,3
30941_0,,,,2,1,2,3
30941_1,,,,2,1,2,3
30942_0,,,,2,1,2,3
30943_0,,,,2,1,2,3
30944_0,,,,2,1,2,3
30944_1,,,,2,1,2,3
30945_0,,,,2,1,2,3
30945_1,,,,2,1,2,3
30946_0,,,,2,1,2,3
30946_1,,,,2,1,2,3
30947_0,,,,2,1,2,3
30947_1,,,,2,1,2,3
30948_0,,,,2,1,2,3
30948_1,,,,2,1,2,3
30949_0,,,,2,1,2,3
30950_0,,,,2,1,2,3
30950_1,,,,2,1,2,3
30951_0,,,,2,1,2,3
30951_1,,,,2,1,2,3
30952_0,,,,2,1,2,3
30952_1,,,,2,1,2,3
30953_0,,,,2,1,2,3
30954_0,,,,2,1,2,3
30954_1,,,,2,1,2,3
30955_0,,,,2,1,2,3
30955_1,,,,2,1,2,3
30956_0,,,,2,1,2,3
30957_0,,,,2,1,2,3
30957_1,,,,2,1,2,3
30958_0,,,,2,1,2,3
30958_1,,,,2,1,2,3
30959_0,,,,2,1,2,3
30960_0,,,,2,1,2,3
30960_1,,,,2,1,2,3
30961_0,,,,2,1,2,3
30961_1,,,,2,1,2,3
30962_0,,,,2,1,2,3
30962_1,,,,2,1,2,3
30963_0,,,,2,1,2,3
30963_1,,,,2,1,2,3
30964_0,,,,2,1,2,3
30964_1,,,,2,1,2,3
30965_0,,,,2,1,2,3
30965_1,,,,2,1,2,3
30966_0,,,,2,1,2,3
30966_1,,,,2,1,2,3
30967_0,,,,2,1,2,3
30967_1,,,,2,1,2,3
30968_0,,,,2,1,2,3
30968_1,,,,2,1,2,3
30969_0,,,,2,1,2,3
30969_1,,,,2,1,2,3
30970_0,,,,2,1,2,3
30970_1,,,,2,1,2,3
30971_0,,,,2,1,2,3
30971_1,,,,2,1,2,3
30972_0,,,,2,1,2,3
30972_1,,,,2,1,2,3
30973_0,,,,2,1,2,3
30973_1,,,,2,1,2,3
30974_0,,,,2,1,2,3
30974_1,,,,2,1,2,3
30975_0,,,,2,1,2,3
30975_1,,,,2,1,2,3
30976_0,,,,2,1,2,3
30976_1,,,,2,1,2,3
30977_0,,,,2,1,2,3
30977_1,,,,2,1,2,3
30978_0,,,,2,1,2,3
30978_1,,,,2,1,2,3
30979_0,,,,2,1,2,3
30979_1,,,,2,1,2,3
30980_0,,,,2,1,2,3
30980_1,,,,2,1,2,3
30981_0,,,,2,1,2,3
30981_1,,,,2,1,2,3
30982_0,,,,2,1,2,3
30983_0,,,,2,1,2,3
30983_1,,,,2,1,2,3
30984_0,,,,2,1,2,3
30984_1,,,,2,1,2,3
30985_0,,,,2,1,2,3
30986_0,,,,2,1,2,3
30986_1,,,,2,1,2,3
30987_0,,,,2,1,2,3
30988_0,,,,2,1,2,3
30988_1,,,,2,1,2,3
30989_0,,,,2,1,2,3
30989_1,,,,2,1,2,3
30990_0,,,,2,1,2,3
30991_0,,,,2,1,2,3
30992_0,,,,2,1,2,3
30992_1,,,,2,1,2,3
30993_0,,,,2,1,2,3
30993_1,,,,2,1,2,3
30994_0,,,,2,1,2,3
30994_1,,,,2,1,2,3
30995_0,,,,2,1,2,3
30996_0,,,,2,1,2,3
30996_1,,,,2,1,2,3
30997_0,,,,2,1,2,3
30997_1,,,,2,1,2,3
30998_0,,,,2,1,2,3
30999_0,,,,2,1,2,3
30999_1,,,,2,1,2,3
31000_0,,,,2,1,2,3
31001_0,,,,2,1,2,3
31002_0,,,,2,1,2,3
31002_1,,,,2,1,2,3
31003_0,,,,2,1,2,3
31004_0,,,,2,1,2,3
31004_1,,,,2,1,2,3
31005_0,,,,2,1,2,3
31005_1,,,,2,1,2,3
31006_0,,,,2,1,2,3
31007_0,,,,2,1,2,3
31008_0,,,,2,1,2,3
31008_1,,,,2,1,2,3
31009_0,,,,2,1,2,3
31009_1,,,,2,1,2,3
31010_0,,,,2,1,2,3
31010_1,,,,2,1,2,3
31011_0,,,,2,1,2,3
31011_1,,,,2,1,2,3
31012_0,,,,2,1,2,3
31012_1,,,,2,1,2,3
31013_0,,,,2,1,2,3
31013_1,,,,2,1,2,3
31014_0,,,,2,1,2,3
31014_1,,,,2,1,2,3
31015_0,,,,2,1,2,3
31015_1,,,,2,1,2,3
31016_0,,,,2,1,2,3
31016_1,,,,2,1,2,3
31017_0,,,,2,1,2,3
31017_1,,,,2,1,2,3
31018_0,,,,2,1,2,3
31019_0,,,,2,1,2,3
31019_1,,,,2,1,2,3
31020_0,,,,2,1,2,3
31020_1,,,,2,1,2,3
31021_0,,,,2,1,2,3
31021_1,,,,2,1,2,3
31022_0,,,,2,1,2,3
31022_1,,,,2,1,2,3
31023_0,,,,2,1,2,3
31023_1,,,,2,1,2,3
31024_0,,,,2,1,2,3
31024_1,,,,2,1,2,3
31025_0,,,,2,1,2,3
31025_1,,,,2,1,2,3
31026_0,,,,2,1,2,3
31026_1,,,,2,1,2,3
31027_0,,,,2,1,2,3
31028_0,,,,2,1,2,3
31028_1,,,,2,1,2,3
31029_0,,,,2,1,2,3
31029_1,,,,2,1,2,3
31030_0,,,,2,1,2,3
31030_1,,,,2,1,2,3
31031_0,,,,2,1,2,3
31031_1,,,,2,1,2,3
31032_0,,,,2,1,2,3
31032_1,,,,2,1,2,3
31033_0,,,,2,1,2,3
31033_1,,,,2,1,2,3
31034_0,,,,2,1,2,3
31034_1,,,,2,1,2,3
31035_0,,,,2,1,2,3
31035_1,,,,2,1,2,3
31036_0,,,,2,1,2,3
31036_1,,,,2,1,2,3
31037_0,,,,2,1,2,3
31037_1,,,,2,1,2,3
31038_0,,,,2,1,2,3
31038_1,,,,2,1,2,3
31039_0,,,,2,1,2,3
31039_1,,,,2,1,2,3
31040_0,,,,2,1,2,3
31040_1,,,,2,1,2,3
31041_0,,,,2,1,2,3
31041_1,,,,2,1,2,3
31042_0,,,,2,1,2,3
31043_0,,,,2,1,2,3
31044_0,,,,2,1,2,3
31045_0,,,,2,1,2,3
31045_1,,,,2,1,2,3
31046_0,,,,2,1,2,3
31047_0,,,,2,1,2,3
31047_1,,,,2,1,2,3
31048_0,,,,2,1,2,3
31049_0,,,,2,1,2,3
31049_1,,,,2,1,2,3
31050_0,,,,2,1,2,3
31050_1,,,,2,1,2,3
31051_0,,,,2,1,2,3
31051_1,,,,2,1,2,3
31052_0,,,,2,1,2,3
31053_0,,,,2,1,2,3
31054_0,,,,2,1,2,3
31054_1,,,,2,1,2,3
31055_0,,,,2,1,2,3
31055_1,,,,2,1,2,3
31056_0,,,,2,1,2,3
31056_1,,,,2,1,2,3
31057_0,,,,2,1,2,3
31057_1,,,,2,1,2,3
31058_0,,,,2,1,2,3
31058_1,,,,2,1,2,3
31059_0,,,,2,1,2,3
31059_1,,,,2,1,2,3
31060_0,,,,2,1,1,2
31060_1,,,,2,1,1,2
31061_0,,,,2,1,2,3
31061_1,,,,2,1,2,3
31062_0,,,,2,1,1,2
31063_0,,,,2,1,2,3
31063_1,,,,2,1,2,3
31064_0,,,,2,1,2,3
31065_0,,,,2,1,2,3
31065_1,,,,2,1,2,3
31066_0,,,,2,1,2,3
31067_0,,,,2,1,2,3
31067_1,,,,2,1,2,3
31068_0,,,,2,1,2,3
31068_1,,,,2,1,2,3
31069_0,,,,2,1,2,3
31069_1,,,,2,1,2,3
31070_0,,,,2,1,2,3
31070_1,,,,2,1,2,3
31071_0,,,,2,1,2,3
31071_1,,,,2,1,2,3
31072_0,,,,2,1,2,3
31072_1,,,,2,1,2,3
31073_0,,,,2,1,2,3
31073_1,,,,2,1,2,3
31074_0,,,,2,1,2,3
31075_0,,,,2,1,2,3
31076_0,,,,2,1,2,3
31076_1,,,,2,1,2,3
31077_0,,,,2,1,2,3
31078_0,,,,2,1,2,3
31078_1,,,,2,1,2,3
31079_0,,,,2,1,2,3
31079_1,,,,2,1,2,3
31080_0,,,,2,1,2,3
31080_1,,,,2,1,2,3
31081_0,,,,2,1,2,3
31081_1,,,,2,1,2,3
31082_0,,,,2,1,2,3
31082_1,,,,2,1,2,3
31083_0,,,,2,1,2,3
31083_1,,,,2,1,2,3
31084_0,,,,2,1,2,3
31084_1,,,,2,1,2,3
31085_0,,,,2,1,2,3
31085_1,,,,2,1,2,3
31086_0,,,,2,1,2,3
31086_1,,,,2,1,2,3
31087_0,,,,2,1,2,3
31087_1,,,,2,1,2,3
31088_0,,,,2,1,2,3
31088_1,,,,2,1,2,3
31089_0,,,,2,1,2,3
31089_1,,,,2,1,2,3
31090_0,,,,2,1,2,3
31090_1,,,,2,1,2,3
31091_0,,,,2,1,2,3
31091_1,,,,2,1,2,3
31092_0,,,,2,1,2,3
31092_1,,,,2,1,2,3
31093_0,,,,2,1,2,3
31093_1,,,,2,1,2,3
31094_0,,,,2,1,2,3
31094_1,,,,2,1,2,3
31095_0,,,,2,1,2,3
31095_1,,,,2,1,2,3
31096_0,,,,2,1,2,3
31096_1,,,,2,1,2,3
31097_0,,,,2,1,2,3
31097_1,,,,2,1,2,3
31098_0,,,,2,1,2,3
31098_1,,,,2,1,2,3
31099_0,,,,2,1,2,3
31099_1,,,,2,1,2,3
31100_0,,,,2,1,2,3
31100_1,,,,2,1,2,3
31101_0,,,,2,1,2,3
31101_1,,,,2,1,2,3
31102_0,,,,2,1,2,3
31102_1,,,,2,1,2,3
31103_0,,,,2,1,2,3
31103_1,,,,2,1,2,3
31104_0,,,,2,1,2,3
31104_1,,,,2,1,2,3
31105_0,,,,2,1,2,3
31105_1,,,,2,1,2,3
31106_0,,,,2,1,2,3
31106_1,,,,2,1,2,3
31107_0,,,,2,1,2,3
31107_1,,,,2,1,2,3
31108_0,,,,2,1,2,3
31108_1,,,,2,1,2,3
31109_0,,,,2,1,2,3
31110_0,,,,2,1,2,3
31110_1,,,,2,1,2,3
31111_0,,,,2,1,2,3
31111_1,,,,2,1,2,3
31112_0,,,,2,1,2,3
31112_1,,,,2,1,2,3
31113_0,,,,2,1,2,3
31113_1,,,,2,1,2,3
31114_0,,,,2,1,2,3
31114_1,,,,2,1,2,3
31115_0,,,,2,1,2,3
31115_1,,,,2,1,2,3
31116_0,,,,2,1,2,3
31116_1,,,,2,1,2,3
31117_0,,,,2,1,2,3
31117_1,,,,2,1,2,3
31118_0,,,,2,1,2,3
31118_1,,,,2,1,2,3
31119_0,,,,2,1,2,3
31119_1,,,,2,1,2,3
31120_0,,,,2,1,2,3
31120_1,,,,2,1,2,3
31121_0,,,,2,1,2,3
31121_1,,,,2,1,2,3
31122_0,,,,2,1,2,3
31123_0,,,,2,1,2,3
31123_1,,,,2,1,2,3
31124_0,,,,2,1,2,3
31124_1,,,,2,1,2,3
31125_0,,,,2,1,2,3
31126_0,,,,2,1,2,3
31126_1,,,,2,1,2,3
31127_0,,,,2,1,2,3
31127_1,,,,2,1,2,3
31128_0,,,,2,1,2,3
31128_1,,,,2,1,2,3
31129_0,,,,2,1,2,3
31129_1,,,,2,1,2,3
31130_0,,,,2,1,2,3
31130_1,,,,2,1,2,3
31131_0,,,,2,1,2,3
31131_1,,,,2,1,2,3
31132_0,,,,2,1,2,3
31132_1,,,,2,1,2,3
31133_0,,,,2,1,2,3
31133_1,,,,2,1,2,3
31134_0,,,,2,1,2,3
31134_1,,,,2,1,2,3
31135_0,,,,2,1,2,3
31135_1,,,,2,1,2,3
31136_0,,,,2,1,2,3
31136_1,,,,2,1,2,3
31137_0,,,,2,1,2,3
31137_1,,,,2,1,2,3
31138_0,,,,2,1,2,3
31138_1,,,,2,1,2,3
31139_0,,,,2,1,2,3
31139_1,,,,2,1,2,3
31140_0,,,,2,1,2,3
31140_1,,,,2,1,2,3
31141_0,,,,2,1,2,3
31141_1,,,,2,1,2,3
31142_0,,,,2,1,2,3
31142_1,,,,2,1,2,3
31143_0,,,,2,1,2,3
31143_1,,,,2,1,2,3
31144_0,,,,2,1,2,3
31144_1,,,,2,1,2,3
31145_0,,,,2,1,2,3
31145_1,,,,2,1,2,3
31146_0,,,,2,1,2,3
31146_1,,,,2,1,2,3
31147_0,,,,2,1,2,3
31147_1,,,,2,1,2,3
31148_0,,,,2,1,2,3
31148_1,,,,2,1,2,3
31149_0,,,,2,1,2,3
31149_1,,,,2,1,2,3
31150_0,,,,2,1,2,3
31150_1,,,,2,1,2,3
31151_0,,,,2,1,2,3
31151_1,,,,2,1,2,3
31152_0,,,,2,1,2,3
31153_0,,,,2,1,2,3
31153_1,,,,2,1,2,3
31154_0,,,,2,1,2,3
31154_1,,,,2,1,2,3
31155_0,,,,2,1,2,3
31155_1,,,,2,1,2,3
31155_2,,,,2,1,2,3
31156_0,,,,2,1,2,3
31156_1,,,,2,1,2,3
31156_2,,,,2,1,2,3
31157_0,,,,2,1,2,3
31158_0,,,,2,1,2,3
31158_1,,,,2,1,2,3
31159_0,,,,2,1,2,3
31159_1,,,,2,1,2,3
31160_0,,,,2,1,2,3
31160_1,,,,2,1,2,3
31161_0,,,,2,1,2,3
31161_1,,,,2,1,2,3
31162_0,,,,2,1,2,3
31163_0,,,,2,1,2,3
31164_0,,,,2,1,2,3
31164_1,,,,2,1,2,3
31165_0,,,,2,1,2,3
31165_1,,,,2,1,2,3
31166_0,,,,2,1,2,3
31166_1,,,,2,1,2,3
31167_0,,,,2,1,2,3
31168_0,,,,2,1,2,3
31168_1,,,,2,1,2,3
31169_0,,,,2,1,2,3
31170_0,,,,2,1,2,3
31170_1,,,,2,1,2,3
31171_0,,,,2,1,2,3
31172_0,,,,2,1,2,3
31172_1,,,,2,1,2,3
31173_0,,,,2,1,2,3
31174_0,,,,2,1,2,3
31175_0,,,,2,1,2,3
31176_0,,,,2,1,2,3
31176_1,,,,2,1,2,3
31177_0,,,,2,1,2,3
31177_1,,,,2,1,2,3
31178_0,,,,2,1,2,3
31178_1,,,,2,1,2,3
31179_0,,,,2,1,2,3
31179_1,,,,2,1,2,3
31180_0,,,,2,1,2,3
31180_1,,,,2,1,2,3
31181_0,,,,2,1,2,3
31181_1,,,,2,1,2,3
31182_0,,,,2,1,2,3
31182_1,,,,2,1,2,3
31183_0,,,,2,1,2,3
31183_1,,,,2,1,2,3
31184_0,,,,2,1,2,3
31184_1,,,,2,1,2,3
31185_0,,,,2,1,2,3
31185_1,,,,2,1,2,3
31186_0,,,,2,1,2,3
31186_1,,,,2,1,2,3
31187_0,,,,2,1,2,3
31187_1,,,,2,1,2,3
31188_0,,,,2,1,2,3
31189_0,,,,2,1,2,3
31189_1,,,,2,1,2,3
31190_0,,,,2,1,2,3
31190_1,,,,2,1,2,3
31191_0,,,,2,1,2,3
31192_0,,,,2,1,2,3
31192_1,,,,2,1,2,3
31193_0,,,,2,1,2,3
31193_1,,,,2,1,2,3
31194_0,,,,2,1,2,3
31195_0,,,,2,1,2,3
31195_1,,,,2,1,2,3
31196_0,,,,2,1,2,3
31197_0,,,,2,1,2,3
31197_1,,,,2,1,2,3
31198_0,,,,2,1,2,3
31198_1,,,,2,1,2,3
31199_0,,,,2,1,2,3
31199_1,,,,2,1,2,3
31200_0,,,,2,1,2,3
31200_1,,,,2,1,2,3
31201_0,,,,2,1,2,3
31201_1,,,,2,1,2,3
31202_0,,,,2,1,2,3
31202_1,,,,2,1,2,3
31203_0,,,,2,1,2,3
31203_1,,,,2,1,2,3
31204_0,,,,2,1,2,3
31204_1,,,,2,1,2,3
31205_0,,,,2,1,2,3
31205_1,,,,2,1,2,3
31206_0,,,,2,1,2,3
31206_1,,,,2,1,2,3
31207_0,,,,2,1,2,3
31207_1,,,,2,1,2,3
31208_0,,,,2,1,2,3
31208_1,,,,2,1,2,3
31209_0,,,,2,1,2,3
31210_0,,,,2,1,2,3
31210_1,,,,2,1,2,3
31211_0,,,,2,1,2,3
31211_1,,,,2,1,2,3
31212_0,,,,2,1,2,3
31212_1,,,,2,1,2,3
31213_0,,,,2,1,2,3
31213_1,,,,2,1,2,3
31214_0,,,,2,1,2,3
31214_1,,,,2,1,2,3
31215_0,,,,2,1,2,3
31215_1,,,,2,1,2,3
31216_0,,,,2,1,2,3
31216_1,,,,2,1,2,3
31217_0,,,,2,1,2,3
31217_1,,,,2,1,2,3
31218_0,,,,2,1,2,3
31218_1,,,,2,1,2,3
31219_0,,,,2,1,2,3
31219_1,,,,2,1,2,3
31220_0,,,,2,1,2,3
31220_1,,,,2,1,2,3
31221_0,,,,2,1,2,3
31221_1,,,,2,1,2,3
31222_0,,,,2,1,2,3
31222_1,,,,2,1,2,3
31223_0,,,,2,1,2,3
31223_1,,,,2,1,2,3
31224_0,,,,2,1,2,3
31224_1,,,,2,1,2,3
31225_0,,,,2,1,2,3
31226_0,,,,2,1,2,3
31227_0,,,,2,1,2,3
31228_0,,,,2,1,2,3
31228_1,,,,2,1,2,3
31229_0,,,,2,1,2,3
31230_0,,,,2,1,2,3
31230_1,,,,2,1,2,3
31231_0,,,,2,1,2,3
31232_0,,,,2,1,2,3
31232_1,,,,2,1,2,3
31233_0,,,,2,1,2,3
31233_1,,,,2,1,2,3
31234_0,,,,2,1,2,3
31234_1,,,,2,1,2,3
31235_0,,,,2,1,2,3
31236_0,,,,2,1,2,3
31237_0,,,,2,1,2,3
31237_1,,,,2,1,2,3
31238_0,,,,2,1,2,3
31238_1,,,,2,1,2,3
31239_0,,,,2,1,2,3
31239_1,,,,2,1,2,3
31240_0,,,,2,1,2,3
31240_1,,,,2,1,2,3
31241_0,,,,2,1,2,3
31241_1,,,,2,1,2,3
31242_0,,,,2,1,2,3
31242_1,,,,2,1,2,3
31243_0,,,,2,1,2,3
31243_1,,,,2,1,2,3
31244_0,,,,2,1,2,3
31244_1,,,,2,1,2,3
31245_0,,,,2,1,2,3
31245_1,,,,2,1,2,3
31246_0,,,,2,1,2,3
31247_0,,,,2,1,2,3
31247_1,,,,2,1,2,3
31248_0,,,,2,1,2,3
31248_1,,,,2,1,2,3
31249_0,,,,2,1,2,3
31249_1,,,,2,1,2,3
31250_0,,,,2,1,2,3
31250_1,,,,2,1,2,3
31251_0,,,,2,1,2,3
31251_1,,,,2,1,2,3
31252_0,,,,2,1,2,3
31252_1,,,,2,1,2,3
31253_0,,,,2,1,2,3
31253_1,,,,2,1,2,3
31254_0,,,,2,1,1,2
31254_1,,,,2,1,1,2
31255_0,,,,2,1,2,3
31255_1,,,,2,1,2,3
31256_0,,,,2,1,1,2
31257_0,,,,2,1,2,3
31257_1,,,,2,1,2,3
31258_0,,,,2,1,2,3
31259_0,,,,2,1,2,3
31259_1,,,,2,1,2,3
31260_0,,,,2,1,2,3
31260_1,,,,2,1,2,3
31261_0,,,,2,1,2,3
31261_1,,,,2,1,2,3
31262_0,,,,2,1,2,3
31263_0,,,,2,1,2,3
31263_1,,,,2,1,2,3
31264_0,,,,2,1,2,3
31264_1,,,,2,1,2,3
31265_0,,,,2,1,2,3
31265_1,,,,2,1,2,3
31266_0,,,,2,1,2,3
31266_1,,,,2,1,2,3
31267_0,,,,2,1,2,3
31267_1,,,,2,1,2,3
31268_0,,,,2,1,2,3
31268_1,,,,2,1,2,3
31269_0,,,,2,1,2,3
31269_1,,,,2,1,2,3
31270_0,,,,2,1,2,3
31271_0,,,,2,1,2,3
31272_0,,,,2,1,2,3
31272_1,,,,2,1,2,3
31273_0,,,,2,1,2,3
31274_0,,,,2,1,2,3
31274_1,,,,2,1,2,3
31275_0,,,,2,1,2,3
31275_1,,,,2,1,2,3
31276_0,,,,2,1,2,3
31276_1,,,,2,1,2,3
31277_0,,,,2,1,2,3
31277_1,,,,2,1,2,3
31278_0,,,,2,1,2,3
31278_1,,,,2,1,2,3
31279_0,,,,2,1,2,3
31279_1,,,,2,1,2,3
31280_0,,,,2,1,2,3
31280_1,,,,2,1,2,3
31281_0,,,,2,1,2,3
31281_1,,,,2,1,2,3
31282_0,,,,2,1,2,3
31282_1,,,,2,1,2,3
31283_0,,,,2,1,2,3
31283_1,,,,2,1,2,3
31284_0,,,,2,1,2,3
31284_1,,,,2,1,2,3
31285_0,,,,2,1,2,3
31285_1,,,,2,1,2,3
31286_0,,,,2,1,2,3
31286_1,,,,2,1,2,3
31287_0,,,,2,1,2,3
31287_1,,,,2,1,2,3
31288_0,,,,2,1,2,3
31288_1,,,,2,1,2,3
31289_0,,,,2,1,2,3
31289_1,,,,2,1,2,3
31290_0,,,,2,1,2,3
31290_1,,,,2,1,2,3
31291_0,,,,2,1,2,3
31291_1,,,,2,1,2,3
31292_0,,,,2,1,2,3
31292_1,,,,2,1,2,3
31293_0,,,,2,1,2,3
31293_1,,,,2,1,2,3
31294_0,,,,2,1,2,3
31294_1,,,,2,1,2,3
31295_0,,,,2,1,2,3
31295_1,,,,2,1,2,3
31296_0,,,,2,1,2,3
31296_1,,,,2,1,2,3
31297_0,,,,2,1,2,3
31297_1,,,,2,1,2,3
31298_0,,,,2,1,2,3
31298_1,,,,2,1,2,3
31299_0,,,,2,1,2,3
31299_1,,,,2,1,2,3
31300_0,,,,2,1,2,3
31300_1,,,,2,1,2,3
31301_0,,,,2,1,2,3
31301_1,,,,2,1,2,3
31302_0,,,,2,1,2,3
31302_1,,,,2,1,2,3
31303_0,,,,2,1,2,3
31303_1,,,,2,1,2,3
31304_0,,,,2,1,2,3
31304_1,,,,2,1,2,3
31305_0,,,,2,1,2,3
31305_1,,,,2,1,2,3
31306_0,,,,2,1,2,3
31306_1,,,,2,1,2,3
31307_0,,,,2,1,2,3
31307_1,,,,2,1,2,3
31308_0,,,,2,1,2,3
31308_1,,,,2,1,2,3
31309_0,,,,2,1,2,3
31309_1,,,,2,1,2,3
31310_0,,,,2,1,2,3
31310_1,,,,2,1,2,3
31311_0,,,,2,1,2,3
31311_1,,,,2,1,2,3
31312_0,,,,2,1,2,3
31312_1,,,,2,1,2,3
31313_0,,,,2,1,2,3
31313_1,,,,2,1,2,3
31314_0,,,,2,1,2,3
31314_1,,,,2,1,2,3
31315_0,,,,2,1,2,3
31316_0,,,,2,1,2,3
31316_1,,,,2,1,2,3
31317_0,,,,2,1,2,3
31317_1,,,,2,1,2,3
31318_0,,,,2,1,2,3
31318_1,,,,2,1,2,3
31319_0,,,,2,1,2,3
31319_1,,,,2,1,2,3
31320_0,,,,2,1,2,3
31320_1,,,,2,1,2,3
31321_0,,,,2,1,2,3
31321_1,,,,2,1,2,3
31322_0,,,,2,1,2,3
31322_1,,,,2,1,2,3
31323_0,,,,2,1,2,3
31323_1,,,,2,1,2,3
31324_0,,,,2,1,2,3
31324_1,,,,2,1,2,3
31325_0,,,,2,1,2,3
31326_0,,,,2,1,2,3
31326_1,,,,2,1,2,3
31327_0,,,,2,1,2,3
31327_1,,,,2,1,2,3
31328_0,,,,2,1,2,3
31328_1,,,,2,1,2,3
31329_0,,,,2,1,2,3
31329_1,,,,2,1,2,3
31330_0,,,,2,1,2,3
31330_1,,,,2,1,2,3
31331_0,,,,2,1,2,3
31331_1,,,,2,1,2,3
31332_0,,,,2,1,2,3
31332_1,,,,2,1,2,3
31333_0,,,,2,1,2,3
31333_1,,,,2,1,2,3
31334_0,,,,2,1,2,3
31334_1,,,,2,1,2,3
31335_0,,,,2,1,2,3
31335_1,,,,2,1,2,3
31336_0,,,,2,1,2,3
31337_0,,,,2,1,2,3
31337_1,,,,2,1,2,3
31338_0,,,,2,1,2,3
31338_1,,,,2,1,2,3
31339_0,,,,2,1,2,3
31340_0,,,,2,1,2,3
31340_1,,,,2,1,2,3
31341_0,,,,2,1,2,3
31341_1,,,,2,1,2,3
31342_0,,,,2,1,2,3
31342_1,,,,2,1,2,3
31343_0,,,,2,1,2,3
31343_1,,,,2,1,2,3
31344_0,,,,2,1,2,3
31344_1,,,,2,1,2,3
31345_0,,,,2,1,2,3
31345_1,,,,2,1,2,3
31346_0,,,,2,1,2,3
31346_1,,,,2,1,2,3
31347_0,,,,2,1,2,3
31347_1,,,,2,1,2,3
31348_0,,,,2,1,2,3
31348_1,,,,2,1,2,3
31349_0,,,,2,1,2,3
31349_1,,,,2,1,2,3
31350_0,,,,2,1,2,3
31350_1,,,,2,1,2,3
31351_0,,,,2,1,2,3
31351_1,,,,2,1,2,3
31352_0,,,,2,1,2,3
31352_1,,,,2,1,2,3
31353_0,,,,2,1,2,3
31353_1,,,,2,1,2,3
31354_0,,,,2,1,2,3
31354_1,,,,2,1,2,3
31355_0,,,,2,1,2,3
31355_1,,,,2,1,2,3
31356_0,,,,2,1,2,3
31356_1,,,,2,1,2,3
31357_0,,,,2,1,2,3
31357_1,,,,2,1,2,3
31358_0,,,,2,1,2,3
31358_1,,,,2,1,2,3
31359_0,,,,2,1,2,3
31359_1,,,,2,1,2,3
31360_0,,,,2,1,2,3
31361_0,,,,2,1,2,3
31362_0,,,,2,1,2,3
31362_1,,,,2,1,2,3
31363_0,,,,2,1,2,3
31363_1,,,,2,1,2,3
31364_0,,,,2,1,2,3
31364_1,,,,2,1,2,3
31365_0,,,,2,1,2,3
31366_0,,,,2,1,2,3
31366_1,,,,2,1,2,3
31367_0,,,,2,1,2,3
31368_0,,,,2,1,2,3
31368_1,,,,2,1,2,3
31369_0,,,,2,1,2,3
31370_0,,,,2,1,2,3
31370_1,,,,2,1,2,3
31371_0,,,,2,1,2,3
31371_1,,,,2,1,2,3
31372_0,,,,2,1,2,3
31372_1,,,,2,1,2,3
31373_0,,,,2,1,2,3
31373_1,,,,2,1,2,3
31374_0,,,,2,1,2,3
31374_1,,,,2,1,2,3
31375_0,,,,2,1,2,3
31375_1,,,,2,1,2,3
31376_0,,,,2,1,2,3
31376_1,,,,2,1,2,3
31377_0,,,,2,1,2,3
31377_1,,,,2,1,2,3
31378_0,,,,2,1,2,3
31378_1,,,,2,1,2,3
31379_0,,,,2,1,2,3
31379_1,,,,2,1,2,3
31380_0,,,,2,1,2,3
31380_1,,,,2,1,2,3
31381_0,,,,2,1,2,3
31381_1,,,,2,1,2,3
31382_0,,,,2,1,2,3
31382_1,,,,2,1,2,3
31383_0,,,,2,1,2,3
31383_1,,,,2,1,2,3
31384_0,,,,2,1,2,3
31384_1,,,,2,1,2,3
31385_0,,,,2,1,2,3
31385_1,,,,2,1,2,3
31386_0,,,,2,1,2,3
31386_1,,,,2,1,2,3
31387_0,,,,2,1,2,3
31387_1,,,,2,1,2,3
31388_0,,,,2,1,2,3
31388_1,,,,2,1,2,3
31389_0,,,,2,1,2,3
31389_1,,,,2,1,2,3
31390_0,,,,2,1,2,3
31391_0,,,,2,1,2,3
31391_1,,,,2,1,2,3
31392_0,,,,2,1,2,3
31392_1,,,,2,1,2,3
31393_0,,,,2,1,2,3
31394_0,,,,2,1,2,3
31395_0,,,,2,1,2,3
31395_1,,,,2,1,2,3
31396_0,,,,2,1,2,3
31396_1,,,,2,1,2,3
31397_0,,,,2,1,2,3
31398_0,,,,2,1,2,3
31398_1,,,,2,1,2,3
31399_0,,,,2,1,2,3
31399_1,,,,2,1,2,3
31400_0,,,,2,1,2,3
31401_0,,,,2,1,2,3
31401_1,,,,2,1,2,3
31402_0,,,,2,1,2,3
31402_1,,,,2,1,2,3
31403_0,,,,2,1,2,3
31403_1,,,,2,1,2,3
31404_0,,,,2,1,2,3
31405_0,,,,2,1,2,3
31406_0,,,,2,1,2,3
31406_1,,,,2,1,2,3
31407_0,,,,2,1,2,3
31408_0,,,,2,1,2,3
31408_1,,,,2,1,2,3
31409_0,,,,2,1,2,3
31409_1,,,,2,1,2,3
31410_0,,,,2,1,2,3
31411_0,,,,2,1,2,3
31411_1,,,,2,1,2,3
31412_0,,,,2,1,2,3
31412_1,,,,2,1,2,3
31413_0,,,,2,1,2,3
31414_0,,,,2,1,2,3
31414_1,,,,2,1,2,3
31415_0,,,,2,1,2,3
31415_1,,,,2,1,2,3
31416_0,,,,2,1,2,3
31416_1,,,,2,1,2,3
31417_0,,,,2,1,2,3
31417_1,,,,2,1,2,3
31418_0,,,,2,1,2,3
31418_1,,,,2,1,2,3
31419_0,,,,2,1,2,3
31419_1,,,,2,1,2,3
31420_0,,,,2,1,2,3
31420_1,,,,2,1,2,3
31421_0,,,,2,1,2,3
31422_0,,,,2,1,2,3
31422_1,,,,2,1,2,3
31423_0,,,,2,1,2,3
31424_0,,,,2,1,2,3
31424_1,,,,2,1,2,3
31425_0,,,,2,1,2,3
31425_1,,,,2,1,2,3
31426_0,,,,2,1,2,3
31426_1,,,,2,1,2,3
31427_0,,,,2,1,2,3
31427_1,,,,2,1,2,3
31428_0,,,,2,1,2,3
31429_0,,,,2,1,2,3
31429_1,,,,2,1,2,3
31430_0,,,,2,1,2,3
31430_1,,,,2,1,2,3
31431_0,,,,2,1,2,3
31431_1,,,,2,1,2,3
31432_0,,,,2,1,2,3
31432_1,,,,2,1,2,3
31433_0,,,,2,1,2,3
31433_1,,,,2,1,2,3
31434_0,,,,2,1,2,3
31434_1,,,,2,1,2,3
31435_0,,,,2,1,2,3
31435_1,,,,2,1,2,3
31436_0,,,,2,1,2,3
31436_1,,,,2,1,2,3
31437_0,,,,2,1,2,3
31437_1,,,,2,1,2,3
31438_0,,,,2,1,2,3
31438_1,,,,2,1,2,3
31439_0,,,,2,1,2,3
31439_1,,,,2,1,2,3
31440_0,,,,2,1,2,3
31440_1,,,,2,1,2,3
31441_0,,,,2,1,2,3
31442_0,,,,2,1,2,3
31442_1,,,,2,1,2,3
31443_0,,,,2,1,2,3
31443_1,,,,2,1,2,3
31444_0,,,,2,1,2,3
31444_1,,,,2,1,2,3
31445_0,,,,2,1,2,3
31445_1,,,,2,1,2,3
31446_0,,,,2,1,2,3
31446_1,,,,2,1,2,3
31447_0,,,,2,1,2,3
31447_1,,,,2,1,2,3
31447_2,,,,2,1,2,3
31448_0,,,,2,1,2,3
31448_1,,,,2,1,2,3
31449_0,,,,2,1,2,3
31449_1,,,,2,1,2,3
31449_2,,,,2,1,2,3
31450_0,,,,2,1,2,3
31450_1,,,,2,1,2,3
31451_0,,,,2,1,2,3
31451_1,,,,2,1,2,3
31451_2,,,,2,1,2,3
31452_0,,,,2,1,2,3
31452_1,,,,2,1,2,3
31453_0,,,,2,1,2,3
31453_1,,,,2,1,2,3
31454_0,,,,2,1,2,3
31454_1,,,,2,1,2,3
31455_0,,,,2,1,2,3
31455_1,,,,2,1,2,3
31456_0,,,,2,1,2,3
31456_1,,,,2,1,2,3
31457_0,,,,2,1,2,3
31457_1,,,,2,1,2,3
31457_2,,,,2,1,2,3
31458_0,,,,2,1,2,3
31458_1,,,,2,1,2,3
31458_2,,,,2,1,2,3
31459_0,,,,2,1,2,3
31460_0,,,,2,1,2,3
31460_1,,,,2,1,2,3
31461_0,,,,2,1,2,3
31462_0,,,,2,1,2,3
31462_1,,,,2,1,2,3
31463_0,,,,2,1,2,3
31463_1,,,,2,1,2,3
31464_0,,,,2,1,2,3
31464_1,,,,2,1,2,3
31465_0,,,,2,1,2,3
31465_1,,,,2,1,2,3
31466_0,,,,2,1,2,3
31466_1,,,,2,1,2,3
31467_0,,,,2,1,2,3
31467_1,,,,2,1,2,3
31467_2,,,,2,1,2,3
31468_0,,,,2,1,2,3
31468_1,,,,2,1,2,3
31468_2,,,,2,1,2,3
31469_0,,,,2,1,2,3
31470_0,,,,2,1,2,3
31470_1,,,,2,1,2,3
31471_0,,,,2,1,2,3
31471_1,,,,2,1,2,3
31472_0,,,,2,1,2,3
31472_1,,,,2,1,2,3
31473_0,,,,2,1,2,3
31474_0,,,,2,1,2,3
31474_1,,,,2,1,2,3
31475_0,,,,2,1,2,3
31475_1,,,,2,1,2,3
31476_0,,,,2,1,2,3
31477_0,,,,2,1,2,3
31477_1,,,,2,1,2,3
31477_2,,,,2,1,2,3
31478_0,,,,2,1,2,3
31478_1,,,,2,1,2,3
31478_2,,,,2,1,2,3
31479_0,,,,2,1,2,3
31479_1,,,,2,1,2,3
31480_0,,,,2,1,2,3
31480_1,,,,2,1,2,3
31480_2,,,,2,1,2,3
31481_0,,,,2,1,2,3
31481_1,,,,2,1,2,3
31481_2,,,,2,1,2,3
31482_0,,,,2,1,2,3
31482_1,,,,2,1,2,3
31483_0,,,,2,1,2,3
31483_1,,,,2,1,2,3
31484_0,,,,2,1,2,3
31485_0,,,,2,1,2,3
31486_0,,,,2,1,2,3
31486_1,,,,2,1,2,3
31487_0,,,,2,1,2,3
31487_1,,,,2,1,2,3
31488_0,,,,2,1,2,3
31488_1,,,,2,1,2,3
31489_0,,,,2,1,2,3
31489_1,,,,2,1,2,3
31490_0,,,,2,1,2,3
31491_0,,,,2,1,2,3
31491_1,,,,2,1,2,3
31492_0,,,,2,1,2,3
31493_0,,,,2,1,2,3
31493_1,,,,2,1,2,3
31494_0,,,,2,1,2,3
31495_0,,,,2,1,2,3
31495_1,,,,2,1,2,3
31496_0,,,,2,1,2,3
31496_1,,,,2,1,2,3
31497_0,,,,2,1,2,3
31497_1,,,,2,1,2,3
31498_0,,,,2,1,2,3
31498_1,,,,2,1,2,3
31499_0,,,,2,1,2,3
31499_1,,,,2,1,2,3
31500_0,,,,2,1,2,3
31501_0,,,,2,1,2,3
31501_1,,,,2,1,2,3
31502_0,,,,2,1,2,3
31503_0,,,,2,1,2,3
31503_1,,,,2,1,2,3
31504_0,,,,2,1,2,3
31505_0,,,,2,1,2,3
31505_1,,,,2,1,2,3
31506_0,,,,2,1,2,3
31507_0,,,,2,1,2,3
31507_1,,,,2,1,2,3
31508_0,,,,2,1,2,3
31508_1,,,,2,1,2,3
31510_0,,,,2,1,2,3
C(C(C=O)(C=C)O)=O,,,5,1,4,0,4
31511_0,,,,2,1,2,3
31511_1,,,,2,1,2,3
31512_0,,,,2,1,2,3
31512_1,,,,2,1,2,3
31513_0,,,,2,1,2,3
31514_0,,,,2,1,2,3
31514_1,,,,2,1,2,3
31515_0,,,,2,1,2,3
31516_0,,,,2,1,2,3
31516_1,,,,2,1,2,3
31517_0,,,,2,1,2,3
31518_0,,,,2,1,2,3
31518_1,,,,2,1,2,3
31520_0,,,,2,1,2,3
C(C(C(O)O)O)=O,,,5,1,2,0,2
31521_0,,,,2,1,2,3
31521_1,,,,2,1,2,3
31522_0,,,,2,1,2,3
31523_0,,,,2,1,2,3
31523_1,,,,2,1,2,3
31524_0,,,,2,1,2,3
31525_0,,,,2,1,2,3
31525_1,,,,2,1,2,3
31526_0,,,,2,1,2,3
31526_1,,,,2,1,2,3
31527_0,,,,2,1,2,3
31528_0,,,,2,1,2,3
31528_1,,,,2,1,2,3
31529_0,,,,2,1,2,3
31530_0,,,,2,1,2,3
31530_1,,,,2,1,2,3
31531_0,,,,2,1,2,3
31532_0,,,,2,1,2,3
31532_1,,,,2,1,2,3
31533_0,,,,2,1,2,3
31533_1,,,,2,1,2,3
31534_0,,,,2,1,2,3
31535_0,,,,2,1,2,3
31535_1,,,,2,1,2,3
31536_0,,,,2,1,2,3
31536_1,,,,2,1,2,3
31537_0,,,,2,1,2,3
31538_0,,,,2,1,2,3
31539_0,,,,2,1,2,3
31539_1,,,,2,1,2,3
31540_0,,,,2,1,2,3
31541_0,,,,2,1,2,3
31541_1,,,,2,1,2,3
31542_0,,,,2,1,2,3
31543_0,,,,2,1,2,3
31543_1,,,,2,1,2,3
31543_2,,,,2,1,2,3
31544_0,,,,2,1,2,3
31544_1,,,,2,1,2,3
31544_2,,,,2,1,2,3
31545_0,,,,2,1,2,3
31545_1,,,,2,1,2,3
31546_0,,,,2,1,2,3
31547_0,,,,2,1,2,3
31547_1,,,,2,1,2,3
31548_0,,,,2,1,2,3
31548_1,,,,2,1,2,3
31549_0,,,,2,1,2,3
31550_0,,,,2,1,2,3
31550_1,,,,2,1,2,3
31551_0,,,,2,1,2,3
31552_0,,,,2,1,2,3
31552_1,,,,2,1,2,3
31553_0,,,,2,1,2,3
31554_0,,,,2,1,2,3
31554_1,,,,2,1,2,3
31555_0,,,,2,1,2,3
31556_0,,,,2,1,2,3
31557_0,,,,2,1,2,3
31558_0,,,,2,1,2,3
31559_0,,,,2,1,2,3
31560_0,,,,2,1,2,3
31561_0,,,,2,1,2,3
31562_0,,,,2,1,2,3
31563_0,,,,2,1,2,3
31564_0,,,,2,1,2,3
31565_0,,,,2,1,2,3
31566_0,,,,2,1,2,3
31567_0,,,,2,1,2,3
31568_0,,,,2,1,2,3
31569_0,,,,2,1,2,3
31570_0,,,,2,1,2,3
31570_1,,,,2,1,2,3
31571_0,,,,2,1,2,3
31572_0,,,,2,1,2,3
31573_0,,,,2,1,2,3
31574_0,,,,2,1,2,3
31575_0,,,,2,1,2,3
31576_0,,,,2,1,2,3
31577_0,,,,2,1,2,3
31578_0,,,,2,1,2,3
31579_0,,,,2,1,2,3
31580_0,,,,2,1,2,3
31581_0,,,,2,1,2,3
31582_0,,,,2,1,2,3
31583_0,,,,2,1,2,3
31584_0,,,,2,1,2,3
31585_0,,,,2,1,2,3
31586_0,,,,2,1,2,3
31587_0,,,,2,1,2,3
31588_0,,,,2,1,2,3
31589_0,,,,2,1,2,3
31590_0,,,,2,1,2,3
31591_0,,,,2,1,2,3
31592_0,,,,2,1,2,3
31592_1,,,,2,1,2,3
31593_0,,,,2,1,2,3
31594_0,,,,2,1,2,3
31595_0,,,,2,1,2,3
31596_0,,,,2,1,2,3
31597_0,,,,2,1,2,3
31598_0,,,,2,1,2,3
31599_0,,,,2,1,2,3
31600_0,,,,2,1,2,3
31601_0,,,,2,1,2,3
31601_1,,,,2,1,2,3
31602_0,,,,2,1,2,3
31602_1,,,,2,1,2,3
31602_2,,,,2,1,2,3
31603_0,,,,2,1,2,3
31603_1,,,,2,1,2,3
31603_2,,,,2,1,2,3
31604_0,,,,2,1,2,3
31605_0,,,,2,1,2,3
31605_1,,,,2,1,2,3
31606_0,,,,2,1,2,3
31607_0,,,,2,1,2,3
31607_1,,,,2,1,2,3
31608_0,,,,2,1,2,3
31608_1,,,,2,1,2,3
31609_0,,,,2,1,2,3
31609_1,,,,2,1,2,3
31610_0,,,,2,1,2,3
31610_1,,,,2,1,2,3
31611_0,,,,2,1,2,3
31611_1,,,,2,1,2,3
31612_0,,,,2,1,2,3
31612_1,,,,2,1,2,3
31612_2,,,,2,1,2,3
31613_0,,,,2,1,2,3
31613_1,,,,2,1,2,3
31613_2,,,,2,1,2,3
31614_0,,,,2,1,2,3
31615_0,,,,2,1,2,3
31615_1,,,,2,1,2,3
31616_0,,,,2,1,2,3
31616_1,,,,2,1,2,3
31617_0,,,,2,1,2,3
31617_1,,,,2,1,2,3
31618_0,,,,2,1,2,3
31618_1,,,,2,1,2,3
31619_0,,,,2,1,2,3
31620_0,,,,2,1,2,3
31620_1,,,,2,1,2,3
31620_2,,,,2,1,2,3
31621_0,,,,2,1,2,3
31621_1,,,,2,1,2,3
31621_2,,,,2,1,2,3
31622_0,,,,2,1,2,3
31622_1,,,,2,1,2,3
31623_0,,,,2,1,2,3
31623_1,,,,2,1,2,3
31624_0,,,,2,1,2,3
31625_0,,,,2,1,2,3
31626_0,,,,2,1,2,3
31626_1,,,,2,1,2,3
31627_0,,,,2,1,2,3
31627_1,,,,2,1,2,3
31628_0,,,,2,1,2,3
31628_1,,,,2,1,2,3
31629_0,,,,2,1,2,3
31629_1,,,,2,1,2,3
31630_0,,,,2,1,2,3
31631_0,,,,2,1,2,3
31631_1,,,,2,1,2,3
31632_0,,,,2,1,2,3
31633_0,,,,2,1,2,3
31633_1,,,,2,1,2,3
31634_0,,,,2,1,2,3
31635_0,,,,2,1,2,3
31635_1,,,,2,1,2,3
31636_0,,,,2,1,2,3
31636_1,,,,2,1,2,3
31637_0,,,,2,1,2,3
31637_1,,,,2,1,2,3
31638_0,,,,2,1,2,3
31639_0,,,,2,1,2,3
31639_1,,,,2,1,2,3
31640_0,,,,2,1,2,3
31640_1,,,,2,1,2,3
31641_0,,,,2,1,2,3
31641_1,,,,2,1,2,3
31642_0,,,,2,1,2,3
31642_1,,,,2,1,2,3
31643_0,,,,2,1,2,3
31643_1,,,,2,1,2,3
31644_0,,,,2,1,2,3
31644_1,,,,2,1,2,3
31646_0,,,,2,1,2,3
C(C1C(C(CO1)O)=O)=O,,,5,1,5,0,5
31646_1,,,,2,1,2,3
31647_0,,,,2,1,2,3
31647_1,,,,2,1,2,3
31648_0,,,,2,1,2,3
31648_1,,,,2,1,2,3
31649_0,,,,2,1,1,2
31649_1,,,,2,1,1,2
31650_0,,,,2,1,2,3
31650_1,,,,2,1,2,3
31652_0,,,,2,1,2,3
C(C1C(COC1O)=O)=O,,,5,1,6,0,6
31652_1,,,,2,1,2,3
31653_0,,,,2,1,1,2
31654_0,,,,2,1,2,3
31654_1,,,,2,1,2,3
31656_0,,,,2,1,2,3
C(C1C(CC(O1)O)=O)=O,,,5,1,4,0,4
31656_1,,,,2,1,2,3
31657_0,,,,2,1,2,3
31658_0,,,,2,1,2,3
31658_1,,,,2,1,2,3
31659_0,,,,2,1,2,3
31660_0,,,,2,1,2,3
31660_1,,,,2,1,2,3
31661_0,,,,2,1,2,3
31661_1,,,,2,1,2,3
31662_0,,,,2,1,2,3
31662_1,,,,2,1,2,3
31663_0,,,,2,1,2,3
31663_1,,,,2,1,2,3
31664_0,,,,2,1,2,3
31664_1,,,,2,1,2,3
31665_0,,,,2,1,2,3
31665_1,,,,2,1,2,3
31666_0,,,,2,1,2,3
31666_1,,,,2,1,2,3
31667_0,,,,2,1,2,3
31667_1,,,,2,1,2,3
31668_0,,,,2,1,2,3
31668_1,,,,2,1,2,3
31669_0,,,,2,1,2,3
31669_1,,,,2,1,2,3
31670_0,,,,2,1,2,3
31671_0,,,,2,1,2,3
31671_1,,,,2,1,2,3
31672_0,,,,2,1,2,3
31672_1,,,,2,1,2,3
31673_0,,,,2,1,2,3
31673_1,,,,2,1,2,3
31674_0,,,,2,1,2,3
31675_0,,,,2,1,2,3
31675_1,,,,2,1,2,3
31676_0,,,,2,1,2,3
31677_0,,,,2,1,2,3
31677_1,,,,2,1,2,3
31678_0,,,,2,1,2,3
31678_1,,,,2,1,2,3
31679_0,,,,2,1,2,3
31679_1,,,,2,1,2,3
31680_0,,,,2,1,2,3
31681_0,,,,2,1,2,3
31682_0,,,,2,1,2,3
31682_1,,,,2,1,2,3
31683_0,,,,2,1,2,3
31683_1,,,,2,1,2,3
31684_0,,,,2,1,2,3
31684_1,,,,2,1,2,3
31685_0,,,,2,1,2,3
31685_1,,,,2,1,2,3
31686_0,,,,2,1,2,3
31686_1,,,,2,1,2,3
31687_0,,,,2,1,2,3
31687_1,,,,2,1,2,3
31688_0,,,,2,1,2,3
31688_1,,,,2,1,2,3
31689_0,,,,2,1,2,3
31689_1,,,,2,1,2,3
31690_0,,,,2,1,2,3
31690_1,,,,2,1,2,3
31691_0,,,,2,1,2,3
31692_0,,,,2,1,2,3
31692_1,,,,2,1,2,3
31693_0,,,,2,1,2,3
31693_1,,,,2,1,2,3
31694_0,,,,2,1,2,3
31694_1,,,,2,1,2,3
31695_0,,,,2,1,2,3
31695_1,,,,2,1,2,3
31696_0,,,,2,1,2,3
31696_1,,,,2,1,2,3
31697_0,,,,2,1,2,3
31697_1,,,,2,1,2,3
31698_0,,,,2,1,2,3
31698_1,,,,2,1,2,3
31699_0,,,,2,1,1,2
31699_1,,,,2,1,1,2
31700_0,,,,2,1,2,3
31700_1,,,,2,1,2,3
31701_0,,,,2,1,1,2
31702_0,,,,2,1,2,3
31702_1,,,,2,1,2,3
31703_0,,,,2,1,2,3
31704_0,,,,2,1,2,3
31704_1,,,,2,1,2,3
31705_0,,,,2,1,2,3
31705_1,,,,2,1,2,3
31706_0,,,,2,1,2,3
31706_1,,,,2,1,2,3
31707_0,,,,2,1,2,3
31708_0,,,,2,1,2,3
31708_1,,,,2,1,2,3
31709_0,,,,2,1,2,3
31709_1,,,,2,1,2,3
31710_0,,,,2,1,2,3
31710_1,,,,2,1,2,3
31711_0,,,,2,1,2,3
31711_1,,,,2,1,2,3
31712_0,,,,2,1,2,3
31712_1,,,,2,1,2,3
31713_0,,,,2,1,2,3
31713_1,,,,2,1,2,3
31714_0,,,,2,1,2,3
31714_1,,,,2,1,2,3
31715_0,,,,2,1,2,3
31716_0,,,,2,1,2,3
31717_0,,,,2,1,2,3
31717_1,,,,2,1,2,3
31718_0,,,,2,1,2,3
31719_0,,,,2,1,2,3
31719_1,,,,2,1,2,3
31720_0,,,,2,1,2,3
31720_1,,,,2,1,2,3
31721_0,,,,2,1,2,3
31721_1,,,,2,1,2,3
31722_0,,,,2,1,2,3
31722_1,,,,2,1,2,3
31723_0,,,,2,1,2,3
31723_1,,,,2,1,2,3
31724_0,,,,2,1,2,3
31724_1,,,,2,1,2,3
31725_0,,,,2,1,2,3
31725_1,,,,2,1,2,3
31726_0,,,,2,1,2,3
31726_1,,,,2,1,2,3
31727_0,,,,2,1,2,3
31727_1,,,,2,1,2,3
31728_0,,,,2,1,2,3
31728_1,,,,2,1,2,3
31729_0,,,,2,1,2,3
31729_1,,,,2,1,2,3
31730_0,,,,2,1,2,3
31730_1,,,,2,1,2,3
31731_0,,,,2,1,2,3
31731_1,,,,2,1,2,3
31732_0,,,,2,1,2,3
31733_0,,,,2,1,2,3
31733_1,,,,2,1,2,3
31734_0,,,,2,1,2,3
31735_0,,,,2,1,2,3
31735_1,,,,2,1,2,3
31736_0,,,,2,1,2,3
31736_1,,,,2,1,2,3
31737_0,,,,2,1,2,3
31737_1,,,,2,1,2,3
31738_0,,,,2,1,2,3
31738_1,,,,2,1,2,3
31739_0,,,,2,1,2,3
31739_1,,,,2,1,2,3
31741_0,,,,2,1,2,3
C(C)(C(C(C)=O)O)=O,,,5,1,8,0,8
31742_0,,,,2,1,2,3
31742_1,,,,2,1,2,3
31743_0,,,,2,1,2,3
31743_1,,,,2,1,2,3
31744_0,,,,2,1,2,3
31744_1,,,,2,1,2,3
31745_0,,,,2,1,2,3
31745_1,,,,2,1,2,3
31746_0,,,,2,1,2,3
31746_1,,,,2,1,2,3
31747_0,,,,2,1,2,3
31747_1,,,,2,1,2,3
31748_0,,,,2,1,2,3
31748_1,,,,2,1,2,3
31749_0,,,,2,1,2,3
31749_1,,,,2,1,2,3
31750_0,,,,2,1,2,3
31750_1,,,,2,1,2,3
31751_0,,,,2,1,2,3
31751_1,,,,2,1,2,3
31752_0,,,,2,1,2,3
31752_1,,,,2,1,2,3
31753_0,,,,2,1,2,3
31753_1,,,,2,1,2,3
31754_0,,,,2,1,2,3
31754_1,,,,2,1,2,3
31755_0,,,,2,1,2,3
31755_1,,,,2,1,2,3
31756_0,,,,2,1,2,3
31756_1,,,,2,1,2,3
31757_0,,,,2,1,2,3
31757_1,,,,2,1,2,3
31758_0,,,,2,1,2,3
31758_1,,,,2,1,2,3
31759_0,,,,2,1,2,3
31759_1,,,,2,1,2,3
31760_0,,,,2,1,2,3
31760_1,,,,2,1,2,3
31761_0,,,,2,1,2,3
31761_1,,,,2,1,2,3
31762_0,,,,2,1,2,3
31763_0,,,,2,1,2,3
31763_1,,,,2,1,2,3
31764_0,,,,2,1,2,3
31764_1,,,,2,1,2,3
31765_0,,,,2,1,2,3
31766_0,,,,2,1,2,3
31766_1,,,,2,1,2,3
31767_0,,,,2,1,2,3
31768_0,,,,2,1,2,3
31768_1,,,,2,1,2,3
31769_0,,,,2,1,2,3
31769_1,,,,2,1,2,3
31770_0,,,,2,1,2,3
31770_1,,,,2,1,2,3
31771_0,,,,2,1,2,3
31771_1,,,,2,1,2,3
31772_0,,,,2,1,2,3
31772_1,,,,2,1,2,3
31773_0,,,,2,1,2,3
31773_1,,,,2,1,2,3
31774_0,,,,2,1,2,3
31775_0,,,,2,1,2,3
31776_0,,,,2,1,2,3
31777_0,,,,2,1,2,3
31778_0,,,,2,1,2,3
31779_0,,,,2,1,2,3
31780_0,,,,2,1,2,3
31781_0,,,,2,1,2,3
31782_0,,,,2,1,2,3
31783_0,,,,2,1,2,3
31784_0,,,,2,1,2,3
31785_0,,,,2,1,2,3
31786_0,,,,2,1,2,3
31787_0,,,,2,1,2,3
31788_0,,,,2,1,2,3
31788_1,,,,2,1,2,3
31789_0,,,,2,1,2,3
31790_0,,,,2,1,2,3
31791_0,,,,2,1,2,3
31792_0,,,,2,1,2,3
31793_0,,,,2,1,2,3
31794_0,,,,2,1,2,3
31795_0,,,,2,1,2,3
31796_0,,,,2,1,2,3
31797_0,,,,2,1,2,3
31798_0,,,,2,1,2,3
31799_0,,,,2,1,2,3
31800_0,,,,2,1,2,3
31801_0,,,,2,1,2,3
31802_0,,,,2,1,2,3
31803_0,,,,2,1,2,3
31804_0,,,,2,1,2,3
31805_0,,,,2,1,2,3
31806_0,,,,2,1,2,3
31807_0,,,,2,1,2,3
31808_0,,,,2,1,2,3
31809_0,,,,2,1,2,3
31810_0,,,,2,1,2,3
31810_1,,,,2,1,2,3
31811_0,,,,2,1,2,3
31812_0,,,,2,1,2,3
31813_0,,,,2,1,2,3
31814_0,,,,2,1,2,3
31815_0,,,,2,1,2,3
31816_0,,,,2,1,2,3
31817_0,,,,2,1,2,3
31818_0,,,,2,1,2,3
31819_0,,,,2,1,2,3
31820_0,,,,2,1,2,3
31821_0,,,,2,1,2,3
31822_0,,,,2,1,2,3
31823_0,,,,2,1,2,3
31824_0,,,,2,1,2,3
31825_0,,,,2,1,2,3
31826_0,,,,2,1,2,3
31826_1,,,,2,1,2,3
31827_0,,,,2,1,2,3
31828_0,,,,2,1,2,3
31829_0,,,,2,1,2,3
31830_0,,,,2,1,2,3
31830_1,,,,2,1,2,3
31831_0,,,,2,1,2,3
31832_0,,,,2,1,2,3
31832_1,,,,2,1,2,3
31833_0,,,,2,1,2,3
31834_0,,,,2,1,2,3
31835_0,,,,2,1,2,3
31836_0,,,,2,1,2,3
31836_1,,,,2,1,2,3
31837_0,,,,2,1,2,3
31837_1,,,,2,1,2,3
31838_0,,,,2,1,2,3
31838_1,,,,2,1,2,3
31839_0,,,,2,1,2,3
31840_0,,,,2,1,2,3
31840_1,,,,2,1,2,3
31841_0,,,,2,1,2,3
31842_0,,,,2,1,2,3
31842_1,,,,2,1,2,3
31843_0,,,,2,1,2,3
31844_0,,,,2,1,2,3
31844_1,,,,2,1,2,3
31845_0,,,,2,1,2,3
31845_1,,,,2,1,2,3
31846_0,,,,2,1,2,3
31847_0,,,,2,1,2,3
31847_1,,,,2,1,2,3
31848_0,,,,2,1,2,3
31848_1,,,,2,1,2,3
31849_0,,,,2,1,2,3
31850_0,,,,2,1,2,3
31850_1,,,,2,1,2,3
31851_0,,,,2,1,2,3
31851_1,,,,2,1,2,3
31852_0,,,,2,1,2,3
31853_0,,,,2,1,2,3
31853_1,,,,2,1,2,3
31854_0,,,,2,1,2,3
31855_0,,,,2,1,2,3
31855_1,,,,2,1,2,3
31856_0,,,,2,1,2,3
31857_0,,,,2,1,2,3
31857_1,,,,2,1,2,3
31858_0,,,,2,1,2,3
31859_0,,,,2,1,2,3
31859_1,,,,2,1,2,3
31860_0,,,,2,1,2,3
31861_0,,,,2,1,2,3
31861_1,,,,2,1,2,3
31862_0,,,,2,1,2,3
31863_0,,,,2,1,2,3
31863_1,,,,2,1,2,3
31864_0,,,,2,1,2,3
31864_1,,,,2,1,2,3
31865_0,,,,2,1,2,3
31866_0,,,,2,1,2,3
31866_1,,,,2,1,2,3
31867_0,,,,2,1,2,3
31868_0,,,,2,1,2,3
31868_1,,,,2,1,2,3
31869_0,,,,2,1,2,3
31870_0,,,,2,1,2,3
31870_1,,,,2,1,2,3
31871_0,,,,2,1,2,3
31872_0,,,,2,1,2,3
31872_1,,,,2,1,2,3
31873_0,,,,2,1,2,3
31873_1,,,,2,1,2,3
31874_0,,,,2,1,2,3
31874_1,,,,2,1,2,3
31875_0,,,,2,1,2,3
31875_1,,,,2,1,2,3
31876_0,,,,2,1,2,3
31876_1,,,,2,1,2,3
31877_0,,,,2,1,2,3
31877_1,,,,2,1,2,3
31878_0,,,,2,1,2,3
31878_1,,,,2,1,2,3
31879_0,,,,2,1,2,3
31879_1,,,,2,1,2,3
31880_0,,,,2,1,2,3
31880_1,,,,2,1,2,3
31881_0,,,,2,1,2,3
31881_1,,,,2,1,2,3
31882_0,,,,2,1,2,3
31882_1,,,,2,1,2,3
31883_0,,,,2,1,2,3
31883_1,,,,2,1,2,3
31884_0,,,,2,1,2,3
31884_1,,,,2,1,2,3
31885_0,,,,2,1,2,3
31885_1,,,,2,1,2,3
31886_0,,,,2,1,2,3
31886_1,,,,2,1,2,3
31887_0,,,,2,1,2,3
31887_1,,,,2,1,2,3
31888_0,,,,2,1,2,3
31888_1,,,,2,1,2,3
31889_0,,,,2,1,2,3
31889_1,,,,2,1,2,3
31890_0,,,,2,1,2,3
31890_1,,,,2,1,2,3
31891_0,,,,2,1,2,3
31891_1,,,,2,1,2,3
31892_0,,,,2,1,2,3
31892_1,,,,2,1,2,3
31893_0,,,,2,1,2,3
31893_1,,,,2,1,2,3
31894_0,,,,2,1,2,3
31894_1,,,,2,1,2,3
31895_0,,,,2,1,2,3
31895_1,,,,2,1,2,3
31896_0,,,,2,1,2,3
31896_1,,,,2,1,2,3
31897_0,,,,2,1,2,3
31897_1,,,,2,1,2,3
31898_0,,,,2,1,2,3
31898_1,,,,2,1,2,3
31899_0,,,,2,1,2,3
31899_1,,,,2,1,2,3
31900_0,,,,2,1,2,3
31900_1,,,,2,1,2,3
31901_0,,,,2,1,2,3
31901_1,,,,2,1,2,3
31902_0,,,,2,1,2,3
31902_1,,,,2,1,2,3
31903_0,,,,2,1,2,3
31903_1,,,,2,1,2,3
31904_0,,,,2,1,2,3
31904_1,,,,2,1,2,3
31905_0,,,,2,1,2,3
31905_1,,,,2,1,2,3
31906_0,,,,2,1,2,3
31906_1,,,,2,1,2,3
31907_0,,,,2,1,2,3
31907_1,,,,2,1,2,3
31908_0,,,,2,1,2,3
31908_1,,,,2,1,2,3
31909_0,,,,2,1,2,3
31909_1,,,,2,1,2,3
31910_0,,,,2,1,2,3
31911_0,,,,2,1,2,3
31911_1,,,,2,1,2,3
31912_0,,,,2,1,2,3
31912_1,,,,2,1,2,3
31913_0,,,,2,1,2,3
31913_1,,,,2,1,2,3
31914_0,,,,2,1,2,3
31915_0,,,,2,1,2,3
31915_1,,,,2,1,2,3
31916_0,,,,2,1,2,3
31917_0,,,,2,1,2,3
31917_1,,,,2,1,2,3
31918_0,,,,2,1,2,3
31919_0,,,,2,1,2,3
31919_1,,,,2,1,2,3
31920_0,,,,2,1,2,3
31921_0,,,,2,1,2,3
31921_1,,,,2,1,2,3
31922_0,,,,2,1,2,3
31922_1,,,,2,1,2,3
31923_0,,,,2,1,2,3
31923_1,,,,2,1,2,3
31924_0,,,,2,1,2,3
31925_0,,,,2,1,2,3
31925_1,,,,2,1,2,3
31926_0,,,,2,1,2,3
31927_0,,,,2,1,2,3
31927_1,,,,2,1,2,3
31928_0,,,,2,1,2,3
31929_0,,,,2,1,2,3
31929_1,,,,2,1,2,3
31930_0,,,,2,1,2,3
31930_1,,,,2,1,2,3
31931_0,,,,2,1,2,3
31932_0,,,,2,1,2,3
31932_1,,,,2,1,2,3
31933_0,,,,2,1,2,3
31934_0,,,,2,1,2,3
31934_1,,,,2,1,2,3
31935_0,,,,2,1,2,3
31936_0,,,,2,1,2,3
31936_1,,,,2,1,2,3
31937_0,,,,2,1,2,3
31938_0,,,,2,1,2,3
31938_1,,,,2,1,2,3
31939_0,,,,2,1,2,3
31940_0,,,,2,1,2,3
31940_1,,,,2,1,2,3
31941_0,,,,2,1,2,3
31942_0,,,,2,1,2,3
31942_1,,,,2,1,2,3
31943_0,,,,2,1,2,3
31944_0,,,,2,1,2,3
31944_1,,,,2,1,2,3
31945_0,,,,2,1,2,3
31946_0,,,,2,1,2,3
31946_1,,,,2,1,2,3
31947_0,,,,2,1,2,3
31948_0,,,,2,1,2,3
31948_1,,,,2,1,2,3
31949_0,,,,2,1,2,3
31950_0,,,,2,1,2,3
31950_1,,,,2,1,2,3
31951_0,,,,2,1,2,3
31952_0,,,,2,1,2,3
31952_1,,,,2,1,2,3
31953_0,,,,2,1,2,3
31954_0,,,,2,1,2,3
31954_1,,,,2,1,2,3
31955_0,,,,2,1,2,3
31955_1,,,,2,1,2,3
31956_0,,,,2,1,2,3
31957_0,,,,2,1,2,3
31957_1,,,,2,1,2,3
31958_0,,,,2,1,2,3
31959_0,,,,2,1,2,3
31959_1,,,,2,1,2,3
31960_0,,,,2,1,2,3
31961_0,,,,2,1,2,3
31962_0,,,,2,1,2,3
31962_1,,,,2,1,2,3
31963_0,,,,2,1,2,3
31963_1,,,,2,1,2,3
31964_0,,,,2,1,2,3
31964_1,,,,2,1,2,3
31965_0,,,,2,1,2,3
31965_1,,,,2,1,2,3
31966_0,,,,2,1,2,3
31966_1,,,,2,1,2,3
31967_0,,,,2,1,2,3
31967_1,,,,2,1,2,3
31968_0,,,,2,1,1,2
31968_1,,,,2,1,1,2
31969_0,,,,2,1,2,3
31969_1,,,,2,1,2,3
31970_0,,,,2,1,1,2
31971_0,,,,2,1,2,3
31971_1,,,,2,1,2,3
31972_0,,,,2,1,2,3
31973_0,,,,2,1,2,3
31974_0,,,,2,1,2,3
31974_1,,,,2,1,2,3
31975_0,,,,2,1,2,3
31975_1,,,,2,1,2,3
31976_0,,,,2,1,2,3
31976_1,,,,2,1,2,3
31977_0,,,,2,1,2,3
31977_1,,,,2,1,2,3
31978_0,,,,2,1,2,3
31978_1,,,,2,1,2,3
31979_0,,,,2,1,2,3
31979_1,,,,2,1,2,3
31980_0,,,,2,1,2,3
31980_1,,,,2,1,2,3
31981_0,,,,2,1,2,3
31982_0,,,,2,1,2,3
31983_0,,,,2,1,2,3
31983_1,,,,2,1,2,3
31984_0,,,,2,1,2,3
31985_0,,,,2,1,2,3
31986_0,,,,2,1,2,3
31987_0,,,,2,1,2,3
31988_0,,,,2,1,2,3
31989_0,,,,2,1,2,3
31990_0,,,,2,1,2,3
31991_0,,,,2,1,2,3
31992_0,,,,2,1,2,3
31993_0,,,,2,1,2,3
31994_0,,,,2,1,2,3
31995_0,,,,2,1,2,3
31996_0,,,,2,1,2,3
31997_0,,,,2,1,2,3
31998_0,,,,2,1,2,3
31999_0,,,,2,1,2,3
32000_0,,,,2,1,2,3
32001_0,,,,2,1,2,3
32002_0,,,,2,1,2,3
32003_0,,,,2,1,2,3
32003_1,,,,2,1,2,3
32004_0,,,,2,1,2,3
32005_0,,,,2,1,2,3
32006_0,,,,2,1,2,3
32007_0,,,,2,1,2,3
32008_0,,,,2,1,2,3
32009_0,,,,2,1,2,3
32010_0,,,,2,1,2,3
32011_0,,,,2,1,2,3
32012_0,,,,2,1,2,3
32013_0,,,,2,1,2,3
32014_0,,,,2,1,2,3
32015_0,,,,2,1,2,3
32016_0,,,,2,1,2,3
32017_0,,,,2,1,2,3
32018_0,,,,2,1,2,3
32019_0,,,,2,1,2,3
32020_0,,,,2,1,2,3
32021_0,,,,2,1,2,3
32021_1,,,,2,1,2,3
32022_0,,,,2,1,2,3
32023_0,,,,2,1,2,3
32024_0,,,,2,1,2,3
32024_1,,,,2,1,2,3
32025_0,,,,2,1,2,3
32026_0,,,,2,1,2,3
32027_0,,,,2,1,2,3
32027_1,,,,2,1,2,3
32028_0,,,,2,1,2,3
32028_1,,,,2,1,2,3
32029_0,,,,2,1,2,3
32029_1,,,,2,1,2,3
32030_0,,,,2,1,2,3
32030_1,,,,2,1,2,3
32031_0,,,,2,1,2,3
32031_1,,,,2,1,2,3
32032_0,,,,2,1,2,3
32032_1,,,,2,1,2,3
32033_0,,,,2,1,1,2
32033_1,,,,2,1,1,2
32034_0,,,,2,1,2,3
32034_1,,,,2,1,2,3
32035_0,,,,2,1,1,2
32036_0,,,,2,1,2,3
32036_1,,,,2,1,2,3
32037_0,,,,2,1,2,3
32038_0,,,,2,1,2,3
32038_1,,,,2,1,2,3
32039_0,,,,2,1,2,3
32040_0,,,,2,1,2,3
32040_1,,,,2,1,2,3
32041_0,,,,2,1,2,3
32041_1,,,,2,1,2,3
32042_0,,,,2,1,2,3
32042_1,,,,2,1,2,3
32043_0,,,,2,1,2,3
32043_1,,,,2,1,2,3
32044_0,,,,2,1,2,3
32044_1,,,,2,1,2,3
32045_0,,,,2,1,2,3
32045_1,,,,2,1,2,3
32046_0,,,,2,1,2,3
32046_1,,,,2,1,2,3
32047_0,,,,2,1,2,3
32048_0,,,,2,1,2,3
32049_0,,,,2,1,2,3
32049_1,,,,2,1,2,3
32050_0,,,,2,1,2,3
32051_0,,,,2,1,2,3
32051_1,,,,2,1,2,3
32052_0,,,,2,1,2,3
32052_1,,,,2,1,2,3
32053_0,,,,2,1,2,3
32053_1,,,,2,1,2,3
32054_0,,,,2,1,2,3
32055_0,,,,2,1,2,3
32055_1,,,,2,1,2,3
32056_0,,,,2,1,2,3
32056_1,,,,2,1,2,3
32057_0,,,,2,1,2,3
32057_1,,,,2,1,2,3
32058_0,,,,2,1,2,3
32058_1,,,,2,1,2,3
32059_0,,,,2,1,2,3
32059_1,,,,2,1,2,3
32060_0,,,,2,1,2,3
32060_1,,,,2,1,2,3
32061_0,,,,2,1,2,3
32061_1,,,,2,1,2,3
32062_0,,,,2,1,2,3
32062_1,,,,2,1,2,3
32063_0,,,,2,1,2,3
32063_1,,,,2,1,2,3
32064_0,,,,2,1,2,3
32064_1,,,,2,1,2,3
32065_0,,,,2,1,2,3
32065_1,,,,2,1,2,3
32066_0,,,,2,1,2,3
32066_1,,,,2,1,2,3
32067_0,,,,2,1,2,3
32068_0,,,,2,1,2,3
32068_1,,,,2,1,2,3
32069_0,,,,2,1,2,3
32069_1,,,,2,1,2,3
32070_0,,,,2,1,2,3
32071_0,,,,2,1,2,3
32071_1,,,,2,1,2,3
32072_0,,,,2,1,2,3
32072_1,,,,2,1,2,3
32073_0,,,,2,1,2,3
32073_1,,,,2,1,2,3
32074_0,,,,2,1,2,3
32074_1,,,,2,1,2,3
32075_0,,,,2,1,2,3
32075_1,,,,2,1,2,3
32076_0,,,,2,1,2,3
32076_1,,,,2,1,2,3
32077_0,,,,2,1,2,3
32077_1,,,,2,1,2,3
32078_0,,,,2,1,2,3
32078_1,,,,2,1,2,3
32079_0,,,,2,1,2,3
32079_1,,,,2,1,2,3
32080_0,,,,2,1,2,3
32080_1,,,,2,1,2,3
32081_0,,,,2,1,2,3
32081_1,,,,2,1,2,3
32082_0,,,,2,1,2,3
32082_1,,,,2,1,2,3
32083_0,,,,2,1,2,3
32083_1,,,,2,1,2,3
32084_0,,,,2,1,2,3
32084_1,,,,2,1,2,3
32085_0,,,,2,1,2,3
32085_1,,,,2,1,2,3
32086_0,,,,2,1,2,3
32087_0,,,,2,1,2,3
32087_1,,,,2,1,2,3
32088_0,,,,2,1,2,3
32089_0,,,,2,1,2,3
32089_1,,,,2,1,2,3
32090_0,,,,2,1,2,3
32090_1,,,,2,1,2,3
32091_0,,,,2,1,2,3
32091_1,,,,2,1,2,3
32092_0,,,,2,1,2,3
32092_1,,,,2,1,2,3
32093_0,,,,2,1,2,3
32093_1,,,,2,1,2,3
32094_0,,,,2,1,2,3
32094_1,,,,2,1,2,3
32095_0,,,,2,1,2,3
32095_1,,,,2,1,2,3
32096_0,,,,2,1,2,3
32096_1,,,,2,1,2,3
32097_0,,,,2,1,2,3
32097_1,,,,2,1,2,3
32098_0,,,,2,1,2,3
32098_1,,,,2,1,2,3
32099_0,,,,2,1,2,3
32099_1,,,,2,1,2,3
32100_0,,,,2,1,2,3
32100_1,,,,2,1,2,3
32101_0,,,,2,1,2,3
32101_1,,,,2,1,2,3
32102_0,,,,2,1,2,3
32102_1,,,,2,1,2,3
32103_0,,,,2,1,2,3
32104_0,,,,2,1,2,3
32104_1,,,,2,1,2,3
32105_0,,,,2,1,2,3
32105_1,,,,2,1,2,3
32106_0,,,,2,1,2,3
32106_1,,,,2,1,2,3
32107_0,,,,2,1,2,3
32107_1,,,,2,1,2,3
32108_0,,,,2,1,2,3
32108_1,,,,2,1,2,3
32109_0,,,,2,1,2,3
32109_1,,,,2,1,2,3
32110_0,,,,2,1,2,3
32110_1,,,,2,1,2,3
32111_0,,,,2,1,2,3
32112_0,,,,2,1,2,3
32112_1,,,,2,1,2,3
32113_0,,,,2,1,2,3
32114_0,,,,2,1,2,3
32114_1,,,,2,1,2,3
32115_0,,,,2,1,2,3
32116_0,,,,2,1,2,3
32116_1,,,,2,1,2,3
32117_0,,,,2,1,2,3
32118_0,,,,2,1,2,3
32118_1,,,,2,1,2,3
32119_0,,,,2,1,2,3
32119_1,,,,2,1,2,3
32120_0,,,,2,1,2,3
32120_1,,,,2,1,2,3
32121_0,,,,2,1,2,3
32121_1,,,,2,1,2,3
32122_0,,,,2,1,2,3
32122_1,,,,2,1,2,3
32123_0,,,,2,1,2,3
32123_1,,,,2,1,2,3
32124_0,,,,2,1,2,3
32124_1,,,,2,1,2,3
32125_0,,,,2,1,2,3
32125_1,,,,2,1,2,3
32126_0,,,,2,1,2,3
32126_1,,,,2,1,2,3
32127_0,,,,2,1,2,3
32127_1,,,,2,1,2,3
32128_0,,,,2,1,2,3
32128_1,,,,2,1,2,3
32129_0,,,,2,1,2,3
32129_1,,,,2,1,2,3
32130_0,,,,2,1,2,3
32130_1,,,,2,1,2,3
32131_0,,,,2,1,2,3
32131_1,,,,2,1,2,3
32132_0,,,,2,1,2,3
32132_1,,,,2,1,2,3
32133_0,,,,2,1,2,3
32133_1,,,,2,1,2,3
32134_0,,,,2,1,2,3
32134_1,,,,2,1,2,3
32135_0,,,,2,1,2,3
32135_1,,,,2,1,2,3
32136_0,,,,2,1,2,3
32136_1,,,,2,1,2,3
32137_0,,,,2,1,2,3
32137_1,,,,2,1,2,3
32138_0,,,,2,1,2,3
32138_1,,,,2,1,2,3
32139_0,,,,2,1,2,3
32139_1,,,,2,1,2,3
32140_0,,,,2,1,2,3
32140_1,,,,2,1,2,3
32141_0,,,,2,1,2,3
32141_1,,,,2,1,2,3
32142_0,,,,2,1,2,3
32142_1,,,,2,1,2,3
32143_0,,,,2,1,2,3
32143_1,,,,2,1,2,3
32144_0,,,,2,1,2,3
32144_1,,,,2,1,2,3
32145_0,,,,2,1,2,3
32145_1,,,,2,1,2,3
32146_0,,,,2,1,2,3
32146_1,,,,2,1,2,3
32147_0,,,,2,1,2,3
32147_1,,,,2,1,2,3
32148_0,,,,2,1,2,3
32148_1,,,,2,1,2,3
32149_0,,,,2,1,2,3
32150_0,,,,2,1,2,3
32150_1,,,,2,1,2,3
32151_0,,,,2,1,2,3
32152_0,,,,2,1,2,3
32152_1,,,,2,1,2,3
32153_0,,,,2,1,2,3
32154_0,,,,2,1,2,3
32154_1,,,,2,1,2,3
32155_0,,,,2,1,2,3
32156_0,,,,2,1,2,3
32156_1,,,,2,1,2,3
32157_0,,,,2,1,2,3
32158_0,,,,2,1,2,3
32158_1,,,,2,1,2,3
32159_0,,,,2,1,2,3
32160_0,,,,2,1,2,3
32160_1,,,,2,1,2,3
32161_0,,,,2,1,2,3
32162_0,,,,2,1,2,3
32162_1,,,,2,1,2,3
32163_0,,,,2,1,2,3
32164_0,,,,2,1,2,3
32164_1,,,,2,1,2,3
32165_0,,,,2,1,2,3
32166_0,,,,2,1,2,3
32167_0,,,,2,1,2,3
32167_1,,,,2,1,2,3
32168_0,,,,2,1,2,3
32169_0,,,,2,1,2,3
32169_1,,,,2,1,2,3
32170_0,,,,2,1,2,3
32171_0,,,,2,1,2,3
32171_1,,,,2,1,2,3
32172_0,,,,2,1,2,3
32172_1,,,,2,1,2,3
32173_0,,,,2,1,2,3
32173_1,,,,2,1,2,3
32174_0,,,,2,1,2,3
32174_1,,,,2,1,2,3
32175_0,,,,2,1,2,3
32175_1,,,,2,1,2,3
32176_0,,,,2,1,2,3
32176_1,,,,2,1,2,3
32177_0,,,,2,1,2,3
32177_1,,,,2,1,2,3
32178_0,,,,2,1,2,3
32178_1,,,,2,1,2,3
32179_0,,,,2,1,2,3
32179_1,,,,2,1,2,3
32180_0,,,,2,1,2,3
32180_1,,,,2,1,2,3
32181_0,,,,2,1,2,3
32181_1,,,,2,1,2,3
32182_0,,,,2,1,2,3
32182_1,,,,2,1,2,3
32183_0,,,,2,1,2,3
32183_1,,,,2,1,2,3
32184_0,,,,2,1,2,3
32184_1,,,,2,1,2,3
32185_0,,,,2,1,2,3
32185_1,,,,2,1,2,3
32186_0,,,,2,1,2,3
32186_1,,,,2,1,2,3
32187_0,,,,2,1,2,3
32188_0,,,,2,1,2,3
32188_1,,,,2,1,2,3
32189_0,,,,2,1,2,3
32189_1,,,,2,1,2,3
32190_0,,,,2,1,2,3
32190_1,,,,2,1,2,3
32190_2,,,,2,1,2,3
32191_0,,,,2,1,2,3
32191_1,,,,2,1,2,3
32191_2,,,,2,1,2,3
32192_0,,,,2,1,2,3
32192_1,,,,2,1,2,3
32193_0,,,,2,1,2,3
32193_1,,,,2,1,2,3
32194_0,,,,2,1,2,3
32194_1,,,,2,1,2,3
32195_0,,,,2,1,2,3
32196_0,,,,2,1,2,3
32196_1,,,,2,1,2,3
32197_0,,,,2,1,2,3
32197_1,,,,2,1,2,3
32197_2,,,,2,1,2,3
32198_0,,,,2,1,2,3
32198_1,,,,2,1,2,3
32198_2,,,,2,1,2,3
32199_0,,,,2,1,2,3
32200_0,,,,2,1,2,3
32200_1,,,,2,1,2,3
32201_0,,,,2,1,2,3
32201_1,,,,2,1,2,3
32201_2,,,,2,1,2,3
32202_0,,,,2,1,2,3
32202_1,,,,2,1,2,3
32203_0,,,,2,1,2,3
32203_1,,,,2,1,2,3
32203_2,,,,2,1,2,3
32204_0,,,,2,1,2,3
32204_1,,,,2,1,2,3
32205_0,,,,2,1,2,3
32205_1,,,,2,1,2,3
32205_2,,,,2,1,2,3
32206_0,,,,2,1,2,3
32206_1,,,,2,1,2,3
32206_2,,,,2,1,2,3
32207_0,,,,2,1,2,3
32207_1,,,,2,1,2,3
32207_2,,,,2,1,2,3
32208_0,,,,2,1,2,3
32208_1,,,,2,1,2,3
32209_0,,,,2,1,2,3
32209_1,,,,2,1,2,3
32210_0,,,,2,1,2,3
32211_0,,,,2,1,2,3
32211_1,,,,2,1,2,3
32211_2,,,,2,1,2,3
32212_0,,,,2,1,2,3
32212_1,,,,2,1,2,3
32212_2,,,,2,1,2,3
32213_0,,,,2,1,2,3
32214_0,,,,2,1,2,3
32214_1,,,,2,1,2,3
32214_2,,,,2,1,2,3
32215_0,,,,2,1,2,3
32215_1,,,,2,1,2,3
32215_2,,,,2,1,2,3
32216_0,,,,2,1,2,3
32216_1,,,,2,1,2,3
32216_2,,,,2,1,2,3
32217_0,,,,2,1,2,3
32217_1,,,,2,1,2,3
32218_0,,,,2,1,2,3
32218_1,,,,2,1,2,3
32218_2,,,,2,1,2,3
32219_0,,,,2,1,2,3
32220_0,,,,2,1,2,3
32220_1,,,,2,1,2,3
32220_2,,,,2,1,2,3
32221_0,,,,2,1,2,3
32222_0,,,,2,1,2,3
32222_1,,,,2,1,2,3
32223_0,,,,2,1,2,3
32223_1,,,,2,1,2,3
32223_2,,,,2,1,2,3
32224_0,,,,2,1,2,3
32225_0,,,,2,1,2,3
32226_0,,,,2,1,2,3
32226_1,,,,2,1,2,3
32226_2,,,,2,1,2,3
32227_0,,,,2,1,2,3
32227_1,,,,2,1,2,3
32227_2,,,,2,1,2,3
32228_0,,,,2,1,2,3
32228_1,,,,2,1,2,3
32229_0,,,,2,1,2,3
32229_1,,,,2,1,2,3
32229_2,,,,2,1,2,3
32230_0,,,,2,1,2,3
32230_1,,,,2,1,2,3
32230_2,,,,2,1,2,3
32231_0,,,,2,1,2,3
32232_0,,,,2,1,2,3
32232_1,,,,2,1,2,3
32232_2,,,,2,1,2,3
32233_0,,,,2,1,2,3
32233_1,,,,2,1,2,3
32233_2,,,,2,1,2,3
32234_0,,,,2,1,2,3
32234_1,,,,2,1,2,3
32234_2,,,,2,1,2,3
32235_0,,,,2,1,2,3
32235_1,,,,2,1,2,3
32236_0,,,,2,1,2,3
32236_1,,,,2,1,2,3
32236_2,,,,2,1,2,3
32237_0,,,,2,1,2,3
32238_0,,,,2,1,2,3
32238_1,,,,2,1,2,3
32238_2,,,,2,1,2,3
32239_0,,,,2,1,2,3
32240_0,,,,2,1,2,3
32240_1,,,,2,1,2,3
32240_2,,,,2,1,2,3
32241_0,,,,2,1,2,3
32242_0,,,,2,1,2,3
32242_1,,,,2,1,2,3
32242_2,,,,2,1,2,3
32243_0,,,,2,1,2,3
32244_0,,,,2,1,2,3
32245_0,,,,2,1,2,3
32245_1,,,,2,1,2,3
32246_0,,,,2,1,2,3
32247_0,,,,2,1,2,3
32247_1,,,,2,1,2,3
32247_2,,,,2,1,2,3
32248_0,,,,2,1,2,3
32249_0,,,,2,1,2,3
32250_0,,,,2,1,2,3
32250_1,,,,2,1,2,3
32251_0,,,,2,1,2,3
32252_0,,,,2,1,2,3
32252_1,,,,2,1,2,3
32253_0,,,,2,1,2,3
32253_1,,,,2,1,2,3
32254_0,,,,2,1,2,3
32255_0,,,,2,1,2,3
32255_1,,,,2,1,2,3
32256_0,,,,2,1,2,3
32256_1,,,,2,1,2,3
32257_0,,,,2,1,2,3
32257_1,,,,2,1,2,3
32258_0,,,,2,1,2,3
32258_1,,,,2,1,2,3
32259_0,,,,2,1,2,3
32259_1,,,,2,1,2,3
32260_0,,,,2,1,2,3
32260_1,,,,2,1,2,3
32261_0,,,,2,1,2,3
32262_0,,,,2,1,2,3
32263_0,,,,2,1,2,3
32264_0,,,,2,1,2,3
32264_1,,,,2,1,2,3
32265_0,,,,2,1,2,3
32266_0,,,,2,1,2,3
32266_1,,,,2,1,2,3
32267_0,,,,2,1,2,3
32267_1,,,,2,1,2,3
32268_0,,,,2,1,2,3
32268_1,,,,2,1,2,3
32269_0,,,,2,1,2,3
32269_1,,,,2,1,2,3
32270_0,,,,2,1,2,3
32270_1,,,,2,1,2,3
32271_0,,,,2,1,2,3
32271_1,,,,2,1,2,3
32272_0,,,,2,1,2,3
32273_0,,,,2,1,2,3
32273_1,,,,2,1,2,3
32274_0,,,,2,1,2,3
32275_0,,,,2,1,2,3
32275_1,,,,2,1,2,3
32276_0,,,,2,1,2,3
32276_1,,,,2,1,2,3
32277_0,,,,2,1,2,3
32277_1,,,,2,1,2,3
32278_0,,,,2,1,2,3
32278_1,,,,2,1,2,3
32279_0,,,,2,1,2,3
32280_0,,,,2,1,2,3
32281_0,,,,2,1,2,3
32281_1,,,,2,1,2,3
32282_0,,,,2,1,2,3
32283_0,,,,2,1,2,3
32284_0,,,,2,1,2,3
32284_1,,,,2,1,2,3
32285_0,,,,2,1,2,3
32286_0,,,,2,1,2,3
32286_1,,,,2,1,2,3
32287_0,,,,2,1,2,3
32288_0,,,,2,1,2,3
32289_0,,,,2,1,2,3
32289_1,,,,2,1,2,3
32290_0,,,,2,1,2,3
32291_0,,,,2,1,2,3
32291_1,,,,2,1,2,3
32292_0,,,,2,1,2,3
32293_0,,,,2,1,2,3
32293_1,,,,2,1,2,3
32294_0,,,,2,1,2,3
32295_0,,,,2,1,2,3
32295_1,,,,2,1,2,3
32296_0,,,,2,1,2,3
32297_0,,,,2,1,2,3
32297_1,,,,2,1,2,3
32298_0,,,,2,1,2,3
32298_1,,,,2,1,2,3
32299_0,,,,2,1,2,3
32299_1,,,,2,1,2,3
32300_0,,,,2,1,2,3
32300_1,,,,2,1,2,3
32301_0,,,,2,1,2,3
32301_1,,,,2,1,2,3
32302_0,,,,2,1,2,3
32302_1,,,,2,1,2,3
32303_0,,,,2,1,2,3
32303_1,,,,2,1,2,3
32304_0,,,,2,1,2,3
32304_1,,,,2,1,2,3
32305_0,,,,2,1,2,3
32305_1,,,,2,1,2,3
32306_0,,,,2,1,2,3
32306_1,,,,2,1,2,3
32307_0,,,,2,1,2,3
32307_1,,,,2,1,2,3
32308_0,,,,2,1,2,3
32308_1,,,,2,1,2,3
32309_0,,,,2,1,2,3
32310_0,,,,2,1,2,3
32310_1,,,,2,1,2,3
32311_0,,,,2,1,2,3
32311_1,,,,2,1,2,3
32312_0,,,,2,1,2,3
32312_1,,,,2,1,2,3
32313_0,,,,2,1,2,3
32313_1,,,,2,1,2,3
32314_0,,,,2,1,2,3
32314_1,,,,2,1,2,3
32315_0,,,,2,1,2,3
32315_1,,,,2,1,2,3
32316_0,,,,2,1,2,3
32316_1,,,,2,1,2,3
32316_2,,,,2,1,2,3
32317_0,,,,2,1,2,3
32318_0,,,,2,1,2,3
32318_1,,,,2,1,2,3
32319_0,,,,2,1,2,3
32320_0,,,,2,1,2,3
32320_1,,,,2,1,2,3
32321_0,,,,2,1,2,3
32321_1,,,,2,1,2,3
32322_0,,,,2,1,2,3
32322_1,,,,2,1,2,3
32323_0,,,,2,1,2,3
32323_1,,,,2,1,2,3
32324_0,,,,2,1,2,3
32325_0,,,,2,1,2,3
32325_1,,,,2,1,2,3
32326_0,,,,2,1,2,3
32326_1,,,,2,1,2,3
32327_0,,,,2,1,2,3
32328_0,,,,2,1,2,3
32328_1,,,,2,1,2,3
32329_0,,,,2,1,2,3
32330_0,,,,2,1,2,3
32330_1,,,,2,1,2,3
32331_0,,,,2,1,2,3
32331_1,,,,2,1,2,3
32332_0,,,,2,1,2,3
32332_1,,,,2,1,2,3
32333_0,,,,2,1,2,3
32333_1,,,,2,1,2,3
32334_0,,,,2,1,2,3
32334_1,,,,2,1,2,3
32335_0,,,,2,1,2,3
32335_1,,,,2,1,2,3
32336_0,,,,2,1,2,3
32336_1,,,,2,1,2,3
32337_0,,,,2,1,2,3
32337_1,,,,2,1,2,3
32338_0,,,,2,1,2,3
32339_0,,,,2,1,2,3
32339_1,,,,2,1,2,3
32340_0,,,,2,1,2,3
32340_1,,,,2,1,2,3
32341_0,,,,2,1,2,3
32341_1,,,,2,1,2,3
32342_0,,,,2,1,2,3
32342_1,,,,2,1,2,3
32343_0,,,,2,1,2,3
32343_1,,,,2,1,2,3
32344_0,,,,2,1,2,3
32344_1,,,,2,1,2,3
32345_0,,,,2,1,2,3
32345_1,,,,2,1,2,3
32346_0,,,,2,1,2,3
32346_1,,,,2,1,2,3
32347_0,,,,2,1,2,3
32348_0,,,,2,1,2,3
32348_1,,,,2,1,2,3
32349_0,,,,2,1,2,3
32350_0,,,,2,1,2,3
32350_1,,,,2,1,2,3
32351_0,,,,2,1,2,3
32351_1,,,,2,1,2,3
32352_0,,,,2,1,2,3
32352_1,,,,2,1,2,3
32353_0,,,,2,1,2,3
32353_1,,,,2,1,2,3
32354_0,,,,2,1,2,3
32354_1,,,,2,1,2,3
32355_0,,,,2,1,2,3
32355_1,,,,2,1,2,3
32356_0,,,,2,1,2,3
32356_1,,,,2,1,2,3
32357_0,,,,2,1,2,3
32357_1,,,,2,1,2,3
32358_0,,,,2,1,2,3
32358_1,,,,2,1,2,3
32359_0,,,,2,1,2,3
32359_1,,,,2,1,2,3
32360_0,,,,2,1,2,3
32361_0,,,,2,1,2,3
32362_0,,,,2,1,2,3
32363_0,,,,2,1,2,3
32363_1,,,,2,1,2,3
32364_0,,,,2,1,2,3
32365_0,,,,2,1,2,3
32366_0,,,,2,1,2,3
32366_1,,,,2,1,2,3
32367_0,,,,2,1,2,3
32368_0,,,,2,1,2,3
32368_1,,,,2,1,2,3
32369_0,,,,2,1,2,3
32369_1,,,,2,1,2,3
32370_0,,,,2,1,2,3
32370_1,,,,2,1,2,3
32371_0,,,,2,1,2,3
32371_1,,,,2,1,2,3
32372_0,,,,2,1,2,3
32372_1,,,,2,1,2,3
32373_0,,,,2,1,2,3
32373_1,,,,2,1,2,3
32374_0,,,,2,1,2,3
32374_1,,,,2,1,2,3
32375_0,,,,2,1,2,3
32376_0,,,,2,1,2,3
32376_1,,,,2,1,2,3
32377_0,,,,2,1,2,3
32377_1,,,,2,1,2,3
32378_0,,,,2,1,2,3
32378_1,,,,2,1,2,3
32379_0,,,,2,1,2,3
32379_1,,,,2,1,2,3
32380_0,,,,2,1,2,3
32380_1,,,,2,1,2,3
32381_0,,,,2,1,2,3
32382_0,,,,2,1,2,3
32382_1,,,,2,1,2,3
32383_0,,,,2,1,2,3
32384_0,,,,2,1,2,3
32384_1,,,,2,1,2,3
32386_0,,,,2,1,2,3
C(C1(COCC1O)O)=O,,,5,1,1,0,1
32387_0,,,,2,1,2,3
32387_1,,,,2,1,2,3
32388_0,,,,2,1,2,3
32388_1,,,,2,1,2,3
32389_0,,,,2,1,2,3
32389_1,,,,2,1,2,3
32390_0,,,,2,1,2,3
32390_1,,,,2,1,2,3
32391_0,,,,2,1,2,3
32391_1,,,,2,1,2,3
32392_0,,,,2,1,2,3
32392_1,,,,2,1,2,3
32393_0,,,,2,1,2,3
32393_1,,,,2,1,2,3
32394_0,,,,2,1,2,3
32394_1,,,,2,1,2,3
32395_0,,,,2,1,2,3
32395_1,,,,2,1,2,3
32396_0,,,,2,1,2,3
32396_1,,,,2,1,2,3
32397_0,,,,2,1,2,3
32397_1,,,,2,1,2,3
32398_0,,,,2,1,2,3
32398_1,,,,2,1,2,3
32399_0,,,,2,1,2,3
32399_1,,,,2,1,2,3
32400_0,,,,2,1,2,3
32401_0,,,,2,1,2,3
32401_1,,,,2,1,2,3
32402_0,,,,2,1,2,3
32402_1,,,,2,1,2,3
32403_0,,,,2,1,2,3
32403_1,,,,2,1,2,3
32403_2,,,,2,1,2,3
32404_0,,,,2,1,2,3
32404_1,,,,2,1,2,3
32405_0,,,,2,1,2,3
32405_1,,,,2,1,2,3
32406_0,,,,2,1,2,3
32406_1,,,,2,1,2,3
32407_0,,,,2,1,2,3
32407_1,,,,2,1,2,3
32408_0,,,,2,1,2,3
32408_1,,,,2,1,2,3
32409_0,,,,2,1,2,3
32410_0,,,,2,1,2,3
32410_1,,,,2,1,2,3
32411_0,,,,2,1,2,3
32412_0,,,,2,1,2,3
32412_1,,,,2,1,2,3
32414_0,,,,2,1,2,3
C(C1(C(O)OCC1)O)=O,,,5,1,2,0,2
32415_0,,,,2,1,2,3
32415_1,,,,2,1,2,3
32416_0,,,,2,1,2,3
32416_1,,,,2,1,2,3
32417_0,,,,2,1,2,3
32417_1,,,,2,1,2,3
32418_0,,,,2,1,2,3
32418_1,,,,2,1,2,3
32419_0,,,,2,1,2,3
32419_1,,,,2,1,2,3
32420_0,,,,2,1,2,3
32420_1,,,,2,1,2,3
32421_0,,,,2,1,2,3
32421_1,,,,2,1,2,3
32422_0,,,,2,1,2,3
32422_1,,,,2,1,2,3
32423_0,,,,2,1,2,3
32423_1,,,,2,1,2,3
32424_0,,,,2,1,2,3
32424_1,,,,2,1,2,3
32425_0,,,,2,1,2,3
32425_1,,,,2,1,2,3
32426_0,,,,2,1,2,3
32426_1,,,,2,1,2,3
32427_0,,,,2,1,2,3
32427_1,,,,2,1,2,3
32428_0,,,,2,1,2,3
32429_0,,,,2,1,2,3
32429_1,,,,2,1,2,3
32430_0,,,,2,1,2,3
32430_1,,,,2,1,2,3
32431_0,,,,2,1,2,3
32431_1,,,,2,1,2,3
32432_0,,,,2,1,2,3
32432_1,,,,2,1,2,3
32433_0,,,,2,1,2,3
32433_1,,,,2,1,2,3
32434_0,,,,2,1,2,3
32434_1,,,,2,1,2,3
32435_0,,,,2,1,2,3
32435_1,,,,2,1,2,3
32436_0,,,,2,1,2,3
32436_1,,,,2,1,2,3
32437_0,,,,2,1,2,3
32438_0,,,,2,1,2,3
32438_1,,,,2,1,2,3
32439_0,,,,2,1,2,3
32440_0,,,,2,1,2,3
32440_1,,,,2,1,2,3
32441_0,,,,2,1,2,3
32442_0,,,,2,1,2,3
32442_1,,,,2,1,2,3
32443_0,,,,2,1,2,3
32443_1,,,,2,1,2,3
32444_0,,,,2,1,1,2
32444_1,,,,2,1,1,2
32445_0,,,,2,1,2,3
32445_1,,,,2,1,2,3
32446_0,,,,2,1,1,2
32446_1,,,,2,1,1,2
32447_0,,,,2,1,2,3
32447_1,,,,2,1,2,3
32448_0,,,,2,1,1,2
32448_1,,,,2,1,1,2
32449_0,,,,2,1,2,3
32449_1,,,,2,1,2,3
32450_0,,,,2,1,1,2
32450_1,,,,2,1,1,2
32451_0,,,,2,1,2,3
32451_1,,,,2,1,2,3
32452_0,,,,2,1,1,2
32452_1,,,,2,1,1,2
32453_0,,,,2,1,2,3
32453_1,,,,2,1,2,3
32454_0,,,,2,1,1,2
32454_1,,,,2,1,1,2
32455_0,,,,2,1,2,3
32455_1,,,,2,1,2,3
32456_0,,,,2,1,1,2
32456_1,,,,2,1,1,2
32457_0,,,,2,1,2,3
32457_1,,,,2,1,2,3
32458_0,,,,2,1,1,2
32458_1,,,,2,1,1,2
32459_0,,,,2,1,2,3
32459_1,,,,2,1,2,3
32460_0,,,,2,1,1,2
32460_1,,,,2,1,1,2
32461_0,,,,2,1,2,3
32461_1,,,,2,1,2,3
32462_0,,,,2,1,1,2
32462_1,,,,2,1,1,2
32463_0,,,,2,1,2,3
32463_1,,,,2,1,2,3
32464_0,,,,2,1,1,2
32464_1,,,,2,1,1,2
32465_0,,,,2,1,2,3
32465_1,,,,2,1,2,3
32466_0,,,,2,1,1,2
32466_1,,,,2,1,1,2
32467_0,,,,2,1,2,3
32468_0,,,,2,1,2,3
32468_1,,,,2,1,2,3
32469_0,,,,2,1,1,2
32469_1,,,,2,1,1,2
32470_0,,,,2,1,2,3
32470_1,,,,2,1,2,3
32471_0,,,,2,1,1,2
32471_1,,,,2,1,1,2
32472_0,,,,2,1,2,3
32472_1,,,,2,1,2,3
32473_0,,,,2,1,2,3
32473_1,,,,2,1,2,3
32474_0,,,,2,1,1,2
32474_1,,,,2,1,1,2
32475_0,,,,2,1,2,3
32475_1,,,,2,1,2,3
32476_0,,,,2,1,1,2
32476_1,,,,2,1,1,2
32477_0,,,,2,1,2,3
32477_1,,,,2,1,2,3
32478_0,,,,2,1,1,2
32478_1,,,,2,1,1,2
32479_0,,,,2,1,2,3
32479_1,,,,2,1,2,3
32480_0,,,,2,1,1,2
32480_1,,,,2,1,1,2
32481_0,,,,2,1,1,2
32482_0,,,,2,1,2,3
32482_1,,,,2,1,2,3
32483_0,,,,2,1,1,2
32484_0,,,,2,1,2,3
32484_1,,,,2,1,2,3
32485_0,,,,2,1,1,2
32486_0,,,,2,1,2,3
32486_1,,,,2,1,2,3
32487_0,,,,2,1,1,2
32488_0,,,,2,1,2,3
32488_1,,,,2,1,2,3
32489_0,,,,2,1,1,2
32490_0,,,,2,1,2,3
32490_1,,,,2,1,2,3
32491_0,,,,2,1,1,2
32492_0,,,,2,1,2,3
32492_1,,,,2,1,2,3
32493_0,,,,2,1,1,2
32494_0,,,,2,1,2,3
32494_1,,,,2,1,2,3
32495_0,,,,2,1,1,2
32496_0,,,,2,1,2,3
32496_1,,,,2,1,2,3
32497_0,,,,2,1,1,2
32498_0,,,,2,1,2,3
32498_1,,,,2,1,2,3
32499_0,,,,2,1,1,2
32500_0,,,,2,1,2,3
32500_1,,,,2,1,2,3
32501_0,,,,2,1,1,2
32502_0,,,,2,1,2,3
32502_1,,,,2,1,2,3
32503_0,,,,2,1,1,2
32504_0,,,,2,1,2,3
32504_1,,,,2,1,2,3
32505_0,,,,2,1,2,3
32506_0,,,,2,1,1,2
32507_0,,,,2,1,2,3
32507_1,,,,2,1,2,3
32508_0,,,,2,1,1,2
32509_0,,,,2,1,2,3
32509_1,,,,2,1,2,3
32510_0,,,,2,1,2,3
32510_1,,,,2,1,2,3
32510_2,,,,2,1,2,3
32511_0,,,,2,1,1,2
32512_0,,,,2,1,2,3
32512_1,,,,2,1,2,3
32513_0,,,,2,1,1,2
32514_0,,,,2,1,2,3
32514_1,,,,2,1,2,3
32515_0,,,,2,1,1,2
32516_0,,,,2,1,2,3
32516_1,,,,2,1,2,3
32517_0,,,,2,1,1,2
32518_0,,,,2,1,2,3
32518_1,,,,2,1,2,3
32519_0,,,,2,1,2,3
32520_0,,,,2,1,2,3
32520_1,,,,2,1,2,3
32521_0,,,,2,1,2,3
32522_0,,,,2,1,2,3
32522_1,,,,2,1,2,3
32523_0,,,,2,1,2,3
32524_0,,,,2,1,2,3
32524_1,,,,2,1,2,3
32524_2,,,,2,1,2,3
32525_0,,,,2,1,2,3
32526_0,,,,2,1,2,3
32527_0,,,,2,1,2,3
32527_1,,,,2,1,2,3
32528_0,,,,2,1,2,3
32529_0,,,,2,1,2,3
32530_0,,,,2,1,2,3
32531_0,,,,2,1,2,3
32531_1,,,,2,1,2,3
32532_0,,,,2,1,2,3
32533_0,,,,2,1,2,3
32533_1,,,,2,1,2,3
32534_0,,,,2,1,2,3
32535_0,,,,2,1,2,3
32535_1,,,,2,1,2,3
32536_0,,,,2,1,2,3
32536_1,,,,2,1,2,3
32537_0,,,,2,1,2,3
32538_0,,,,2,1,2,3
32539_0,,,,2,1,2,3
32540_0,,,,2,1,2,3
32540_1,,,,2,1,2,3
32541_0,,,,2,1,2,3
32542_0,,,,2,1,2,3
32543_0,,,,2,1,2,3
32544_0,,,,2,1,2,3
32544_1,,,,2,1,2,3
32545_0,,,,2,1,2,3
32546_0,,,,2,1,2,3
32546_1,,,,2,1,2,3
32547_0,,,,2,1,2,3
32548_0,,,,2,1,2,3
32548_1,,,,2,1,2,3
32549_0,,,,2,1,2,3
32549_1,,,,2,1,2,3
32550_0,,,,2,1,2,3
32551_0,,,,2,1,2,3
32552_0,,,,2,1,2,3
32553_0,,,,2,1,2,3
32554_0,,,,2,1,2,3
32554_1,,,,2,1,2,3
32555_0,,,,2,1,2,3
32556_0,,,,2,1,2,3
32557_0,,,,2,1,2,3
32558_0,,,,2,1,2,3
32559_0,,,,2,1,2,3
32560_0,,,,2,1,2,3
32561_0,,,,2,1,2,3
32562_0,,,,2,1,2,3
32563_0,,,,2,1,2,3
32564_0,,,,2,1,2,3
32565_0,,,,2,1,2,3
32566_0,,,,2,1,2,3
32566_1,,,,2,1,2,3
32567_0,,,,2,1,2,3
32568_0,,,,2,1,2,3
32569_0,,,,2,1,2,3
32570_0,,,,2,1,2,3
32571_0,,,,2,1,2,3
32571_1,,,,2,1,2,3
32572_0,,,,2,1,2,3
32572_1,,,,2,1,2,3
32573_0,,,,2,1,2,3
32574_0,,,,2,1,2,3
32574_1,,,,2,1,2,3
32575_0,,,,2,1,2,3
32575_1,,,,2,1,2,3
32576_0,,,,2,1,2,3
32576_1,,,,2,1,2,3
32577_0,,,,2,1,2,3
32577_1,,,,2,1,2,3
32578_0,,,,2,1,2,3
32578_1,,,,2,1,2,3
32579_0,,,,2,1,2,3
32579_1,,,,2,1,2,3
32580_0,,,,2,1,2,3
32580_1,,,,2,1,2,3
32581_0,,,,2,1,2,3
32581_1,,,,2,1,2,3
32582_0,,,,2,1,2,3
32583_0,,,,2,1,2,3
32584_0,,,,2,1,2,3
32584_1,,,,2,1,2,3
32585_0,,,,2,1,2,3
32586_0,,,,2,1,2,3
32586_1,,,,2,1,2,3
32587_0,,,,2,1,2,3
32587_1,,,,2,1,2,3
32588_0,,,,2,1,2,3
32588_1,,,,2,1,2,3
32589_0,,,,2,1,2,3
32589_1,,,,2,1,2,3
32590_0,,,,2,1,2,3
32590_1,,,,2,1,2,3
32591_0,,,,2,1,2,3
32592_0,,,,2,1,2,3
32592_1,,,,2,1,2,3
32593_0,,,,2,1,2,3
32593_1,,,,2,1,2,3
32594_0,,,,2,1,2,3
32594_1,,,,2,1,2,3
32595_0,,,,2,1,2,3
32595_1,,,,2,1,2,3
32596_0,,,,2,1,2,3
32596_1,,,,2,1,2,3
32597_0,,,,2,1,2,3
32597_1,,,,2,1,2,3
32598_0,,,,2,1,2,3
32598_1,,,,2,1,2,3
32599_0,,,,2,1,2,3
32599_1,,,,2,1,2,3
32600_0,,,,2,1,2,3
32601_0,,,,2,1,2,3
32602_0,,,,2,1,2,3
32602_1,,,,2,1,2,3
32603_0,,,,2,1,2,3
32604_0,,,,2,1,2,3
32604_1,,,,2,1,2,3
32605_0,,,,2,1,2,3
32605_1,,,,2,1,2,3
32606_0,,,,2,1,2,3
32606_1,,,,2,1,2,3
32607_0,,,,2,1,2,3
32607_1,,,,2,1,2,3
32608_0,,,,2,1,2,3
32609_0,,,,2,1,2,3
32609_1,,,,2,1,2,3
32610_0,,,,2,1,2,3
32610_1,,,,2,1,2,3
32611_0,,,,2,1,2,3
32611_1,,,,2,1,2,3
32612_0,,,,2,1,2,3
32612_1,,,,2,1,2,3
32613_0,,,,2,1,2,3
32613_1,,,,2,1,2,3
32614_0,,,,2,1,2,3
32614_1,,,,2,1,2,3
32615_0,,,,2,1,2,3
32615_1,,,,2,1,2,3
32616_0,,,,2,1,2,3
32617_0,,,,2,1,2,3
32618_0,,,,2,1,2,3
32618_1,,,,2,1,2,3
32619_0,,,,2,1,2,3
32620_0,,,,2,1,2,3
32620_1,,,,2,1,2,3
32621_0,,,,2,1,2,3
32622_0,,,,2,1,2,3
32623_0,,,,2,1,2,3
32623_1,,,,2,1,2,3
32624_0,,,,2,1,2,3
32625_0,,,,2,1,2,3
32625_1,,,,2,1,2,3
32626_0,,,,2,1,2,3
32626_1,,,,2,1,2,3
32627_0,,,,2,1,2,3
32627_1,,,,2,1,2,3
32628_0,,,,2,1,2,3
32628_1,,,,2,1,2,3
32629_0,,,,2,1,2,3
32629_1,,,,2,1,2,3
32630_0,,,,2,1,2,3
32631_0,,,,2,1,2,3
32631_1,,,,2,1,2,3
32631_2,,,,2,1,2,3
32632_0,,,,2,1,2,3
32632_1,,,,2,1,2,3
32633_0,,,,2,1,2,3
32633_1,,,,2,1,2,3
32634_0,,,,2,1,2,3
32634_1,,,,2,1,2,3
32635_0,,,,2,1,2,3
32636_0,,,,2,1,2,3
32636_1,,,,2,1,2,3
32637_0,,,,2,1,2,3
32637_1,,,,2,1,2,3
32638_0,,,,2,1,2,3
32638_1,,,,2,1,2,3
32639_0,,,,2,1,2,3
32639_1,,,,2,1,2,3
32640_0,,,,2,1,2,3
32640_1,,,,2,1,2,3
32641_0,,,,2,1,2,3
32641_1,,,,2,1,2,3
32642_0,,,,2,1,2,3
32642_1,,,,2,1,2,3
32643_0,,,,2,1,2,3
32644_0,,,,2,1,2,3
32645_0,,,,2,1,2,3
32645_1,,,,2,1,2,3
32646_0,,,,2,1,2,3
32647_0,,,,2,1,2,3
32647_1,,,,2,1,2,3
32648_0,,,,2,1,2,3
32648_1,,,,2,1,2,3
32649_0,,,,2,1,2,3
32649_1,,,,2,1,2,3
32650_0,,,,2,1,2,3
32650_1,,,,2,1,2,3
32651_0,,,,2,1,2,3
32652_0,,,,2,1,2,3
32652_1,,,,2,1,2,3
32653_0,,,,2,1,2,3
32653_1,,,,2,1,2,3
32654_0,,,,2,1,2,3
32654_1,,,,2,1,2,3
32655_0,,,,2,1,2,3
32655_1,,,,2,1,2,3
32656_0,,,,2,1,2,3
32656_1,,,,2,1,2,3
32657_0,,,,2,1,2,3
32657_1,,,,2,1,2,3
32658_0,,,,2,1,2,3
32658_1,,,,2,1,2,3
32659_0,,,,2,1,2,3
32660_0,,,,2,1,2,3
32661_0,,,,2,1,2,3
32661_1,,,,2,1,2,3
32662_0,,,,2,1,2,3
32663_0,,,,2,1,2,3
32663_1,,,,2,1,2,3
32664_0,,,,2,1,2,3
32664_1,,,,2,1,2,3
32665_0,,,,2,1,2,3
32666_0,,,,2,1,2,3
32667_0,,,,2,1,2,3
32667_1,,,,2,1,2,3
32668_0,,,,2,1,2,3
32668_1,,,,2,1,2,3
32669_0,,,,2,1,2,3
32670_0,,,,2,1,2,3
32670_1,,,,2,1,2,3
32670_2,,,,2,1,2,3
32671_0,,,,2,1,2,3
32671_1,,,,2,1,2,3
32671_2,,,,2,1,2,3
32672_0,,,,2,1,2,3
32672_1,,,,2,1,2,3
32673_0,,,,2,1,2,3
32673_1,,,,2,1,2,3
32674_0,,,,2,1,2,3
32675_0,,,,2,1,2,3
32676_0,,,,2,1,2,3
32677_0,,,,2,1,2,3
32677_1,,,,2,1,2,3
32678_0,,,,2,1,2,3
32678_1,,,,2,1,2,3
32679_0,,,,2,1,2,3
32680_0,,,,2,1,2,3
32681_0,,,,2,1,2,3
32682_0,,,,2,1,2,3
32683_0,,,,2,1,2,3
32683_1,,,,2,1,2,3
32684_0,,,,2,1,2,3
32685_0,,,,2,1,2,3
32686_0,,,,2,1,2,3
32687_0,,,,2,1,2,3
32688_0,,,,2,1,2,3
32689_0,,,,2,1,2,3
32689_1,,,,2,1,2,3
32690_0,,,,2,1,2,3
32691_0,,,,2,1,2,3
32692_0,,,,2,1,2,3
32692_1,,,,2,1,2,3
32693_0,,,,2,1,2,3
32694_0,,,,2,1,2,3
32695_0,,,,2,1,2,3
32695_1,,,,2,1,2,3
32696_0,,,,2,1,2,3
32696_1,,,,2,1,2,3
32696_2,,,,2,1,2,3
32697_0,,,,2,1,2,3
32697_1,,,,2,1,2,3
32698_0,,,,2,1,2,3
32699_0,,,,2,1,2,3
32699_1,,,,2,1,2,3
32699_2,,,,2,1,2,3
32700_0,,,,2,1,2,3
32701_0,,,,2,1,2,3
32702_0,,,,2,1,2,3
32702_1,,,,2,1,2,3
32702_2,,,,2,1,2,3
32703_0,,,,2,1,2,3
32704_0,,,,2,1,2,3
32705_0,,,,2,1,2,3
32705_1,,,,2,1,2,3
32705_2,,,,2,1,2,3
32706_0,,,,2,1,2,3
32707_0,,,,2,1,2,3
32707_1,,,,2,1,2,3
32708_0,,,,2,1,2,3
32709_0,,,,2,1,2,3
32710_0,,,,2,1,2,3
32711_0,,,,2,1,2,3
32712_0,,,,2,1,2,3
32713_0,,,,2,1,2,3
32714_0,,,,2,1,2,3
32715_0,,,,2,1,2,3
32716_0,,,,2,1,2,3
32717_0,,,,2,1,2,3
32718_0,,,,2,1,2,3
32718_1,,,,2,1,2,3
32718_2,,,,2,1,2,3
32719_0,,,,2,1,2,3
32720_0,,,,2,1,2,3
32721_0,,,,2,1,2,3
32722_0,,,,2,1,2,3
32723_0,,,,2,1,2,3
32724_0,,,,2,1,2,3
32724_1,,,,2,1,2,3
32725_0,,,,2,1,2,3
32726_0,,,,2,1,2,3
32727_0,,,,2,1,2,3
32727_1,,,,2,1,2,3
32727_2,,,,2,1,2,3
32728_0,,,,2,1,2,3
32729_0,,,,2,1,2,3
32729_1,,,,2,1,2,3
32729_2,,,,2,1,2,3
32730_0,,,,2,1,2,3
32731_0,,,,2,1,2,3
32732_0,,,,2,1,2,3
32733_0,,,,2,1,2,3
32734_0,,,,2,1,2,3
32734_1,,,,2,1,2,3
32734_2,,,,2,1,2,3
32735_0,,,,2,1,2,3
32736_0,,,,2,1,2,3
32737_0,,,,2,1,2,3
32738_0,,,,2,1,2,3
32739_0,,,,2,1,2,3
32740_0,,,,2,1,2,3
32740_1,,,,2,1,2,3
32741_0,,,,2,1,2,3
32742_0,,,,2,1,2,3
32743_0,,,,2,1,2,3
32744_0,,,,2,1,2,3
32745_0,,,,2,1,2,3
32746_0,,,,2,1,2,3
32747_0,,,,2,1,2,3
32748_0,,,,2,1,2,3
32749_0,,,,2,1,2,3
32750_0,,,,2,1,2,3
32751_0,,,,2,1,2,3
32752_0,,,,2,1,2,3
32753_0,,,,2,1,2,3
32754_0,,,,2,1,2,3
32755_0,,,,2,1,2,3
32756_0,,,,2,1,2,3
32757_0,,,,2,1,2,3
32758_0,,,,2,1,2,3
32759_0,,,,2,1,2,3
32760_0,,,,2,1,2,3
32761_0,,,,2,1,2,3
32762_0,,,,2,1,2,3
32763_0,,,,2,1,2,3
32764_0,,,,2,1,2,3
32765_0,,,,2,1,2,3
32766_0,,,,2,1,2,3
32767_0,,,,2,1,2,3
32768_0,,,,2,1,2,3
32768_1,,,,2,1,2,3
32769_0,,,,2,1,2,3
32770_0,,,,2,1,2,3
32771_0,,,,2,1,2,3
32771_1,,,,2,1,2,3
32772_0,,,,2,1,2,3
32773_0,,,,2,1,2,3
32774_0,,,,2,1,2,3
32774_1,,,,2,1,2,3
32775_0,,,,2,1,2,3
32776_0,,,,2,1,2,3
32776_1,,,,2,1,2,3
32777_0,,,,2,1,2,3
32778_0,,,,2,1,2,3
32779_0,,,,2,1,2,3
32780_0,,,,2,1,2,3
32780_1,,,,2,1,2,3
32780_2,,,,2,1,2,3
32781_0,,,,2,1,2,3
32782_0,,,,2,1,2,3
32783_0,,,,2,1,2,3
32784_0,,,,2,1,2,3
32785_0,,,,2,1,2,3
32786_0,,,,2,1,2,3
32787_0,,,,2,1,2,3
32788_0,,,,2,1,2,3
32788_1,,,,2,1,2,3
32789_0,,,,2,1,2,3
32789_1,,,,2,1,2,3
32790_0,,,,2,1,2,3
32790_1,,,,2,1,2,3
32790_2,,,,2,1,2,3
32791_0,,,,2,1,2,3
32791_1,,,,2,1,2,3
32791_2,,,,2,1,2,3
32792_0,,,,2,1,2,3
32792_1,,,,2,1,2,3
32793_0,,,,2,1,2,3
32794_0,,,,2,1,2,3
32794_1,,,,2,1,2,3
32794_2,,,,2,1,2,3
32795_0,,,,2,1,2,3
32795_1,,,,2,1,2,3
32795_2,,,,2,1,2,3
32796_0,,,,2,1,2,3
32797_0,,,,2,1,2,3
32798_0,,,,2,1,2,3
32800_0,,,,2,1,2,3
C(C)(C(C)O)=O,,,5,1,3,0,3
32802_0,,,,2,1,2,3
C(COC(C=O)O)=O,,,5,1,4,0,4
32802_1,,,,2,1,2,3
32803_0,,,,2,1,2,3
32803_1,,,,2,1,2,3
32804_0,,,,2,1,2,3
32805_0,,,,2,1,2,3
32805_1,,,,2,1,2,3
32805_2,,,,2,1,2,3
32806_0,,,,2,1,2,3
32806_1,,,,2,1,2,3
32807_0,,,,2,1,2,3
32807_1,,,,2,1,2,3
32808_0,,,,2,1,2,3
32808_1,,,,2,1,2,3
32809_0,,,,2,1,2,3
32809_1,,,,2,1,2,3
32810_0,,,,2,1,2,3
32810_1,,,,2,1,2,3
32811_0,,,,2,1,2,3
32811_1,,,,2,1,2,3
32812_0,,,,2,1,2,3
32812_1,,,,2,1,2,3
32813_0,,,,2,1,2,3
32814_0,,,,2,1,2,3
32814_1,,,,2,1,2,3
32815_0,,,,2,1,2,3
32815_1,,,,2,1,2,3
32816_0,,,,2,1,2,3
32816_1,,,,2,1,2,3
32817_0,,,,2,1,2,3
32818_0,,,,2,1,2,3
32818_1,,,,2,1,2,3
32819_0,,,,2,1,2,3
32819_1,,,,2,1,2,3
32820_0,,,,2,1,2,3
32820_1,,,,2,1,2,3
32821_0,,,,2,1,2,3
32821_1,,,,2,1,2,3
32822_0,,,,2,1,2,3
32822_1,,,,2,1,2,3
32823_0,,,,2,1,2,3
32823_1,,,,2,1,2,3
32824_0,,,,2,1,2,3
32824_1,,,,2,1,2,3
32824_2,,,,2,1,2,3
32825_0,,,,2,1,2,3
32825_1,,,,2,1,2,3
32825_2,,,,2,1,2,3
32826_0,,,,2,1,2,3
32826_1,,,,2,1,2,3
32827_0,,,,2,1,2,3
32827_1,,,,2,1,2,3
32828_0,,,,2,1,2,3
32828_1,,,,2,1,2,3
32829_0,,,,2,1,2,3
32829_1,,,,2,1,2,3
32830_0,,,,2,1,2,3
32830_1,,,,2,1,2,3
32831_0,,,,2,1,2,3
32831_1,,,,2,1,2,3
32832_0,,,,2,1,2,3
32832_1,,,,2,1,2,3
32833_0,,,,2,1,2,3
32833_1,,,,2,1,2,3
32834_0,,,,2,1,2,3
32835_0,,,,2,1,2,3
32836_0,,,,2,1,2,3
32837_0,,,,2,1,2,3
32837_1,,,,2,1,2,3
32838_0,,,,2,1,2,3
32838_1,,,,2,1,2,3
32839_0,,,,2,1,2,3
32840_0,,,,2,1,2,3
32841_0,,,,2,1,2,3
32842_0,,,,2,1,2,3
32842_1,,,,2,1,2,3
32843_0,,,,2,1,2,3
32844_0,,,,2,1,2,3
32845_0,,,,2,1,2,3
32846_0,,,,2,1,2,3
32846_1,,,,2,1,2,3
32847_0,,,,2,1,2,3
32847_1,,,,2,1,2,3
32848_0,,,,2,1,2,3
32849_0,,,,2,1,2,3
32850_0,,,,2,1,2,3
32851_0,,,,2,1,2,3
32851_1,,,,2,1,2,3
32852_0,,,,2,1,2,3
32852_1,,,,2,1,2,3
32853_0,,,,2,1,2,3
32853_1,,,,2,1,2,3
32854_0,,,,2,1,2,3
32854_1,,,,2,1,2,3
32855_0,,,,2,1,2,3
32856_0,,,,2,1,2,3
32856_1,,,,2,1,2,3
32857_0,,,,2,1,2,3
32858_0,,,,2,1,2,3
32858_1,,,,2,1,2,3
32859_0,,,,2,1,2,3
32859_1,,,,2,1,2,3
32860_0,,,,2,1,2,3
32861_0,,,,2,1,2,3
32861_1,,,,2,1,2,3
32862_0,,,,2,1,2,3
32862_1,,,,2,1,2,3
32863_0,,,,2,1,2,3
32864_0,,,,2,1,2,3
32864_1,,,,2,1,2,3
32865_0,,,,2,1,2,3
32866_0,,,,2,1,2,3
32866_1,,,,2,1,2,3
32867_0,,,,2,1,2,3
32868_0,,,,2,1,2,3
32869_0,,,,2,1,2,3
32870_0,,,,2,1,2,3
32871_0,,,,2,1,2,3
32871_1,,,,2,1,2,3
32871_2,,,,2,1,2,3
32872_0,,,,2,1,2,3
32873_0,,,,2,1,2,3
32873_1,,,,2,1,2,3
32873_2,,,,2,1,2,3
32874_0,,,,2,1,2,3
32875_0,,,,2,1,2,3
32875_1,,,,2,1,2,3
32875_2,,,,2,1,2,3
32876_0,,,,2,1,2,3
32876_1,,,,2,1,2,3
32876_2,,,,2,1,2,3
32877_0,,,,2,1,2,3
32877_1,,,,2,1,2,3
32878_0,,,,2,1,2,3
32878_1,,,,2,1,2,3
32878_2,,,,2,1,2,3
32879_0,,,,2,1,2,3
32879_1,,,,2,1,2,3
32879_2,,,,2,1,2,3
32880_0,,,,2,1,2,3
32880_1,,,,2,1,2,3
32881_0,,,,2,1,2,3
32881_1,,,,2,1,2,3
32882_0,,,,2,1,2,3
32882_1,,,,2,1,2,3
32882_2,,,,2,1,2,3
32884_0,,,,2,1,2,3
C(C(C=O)(C(CO)=O)O)=O,,,5,1,4,0,4
32885_0,,,,2,1,2,3
32885_1,,,,2,1,2,3
32885_2,,,,2,1,2,3
32886_0,,,,2,1,2,3
32886_1,,,,2,1,2,3
32886_2,,,,2,1,2,3
32887_0,,,,2,1,2,3
32887_1,,,,2,1,2,3
32887_2,,,,2,1,2,3
32888_0,,,,2,1,2,3
32888_1,,,,2,1,2,3
32889_0,,,,2,1,2,3
32889_1,,,,2,1,2,3
32890_0,,,,2,1,2,3
32890_1,,,,2,1,2,3
32891_0,,,,2,1,2,3
32891_1,,,,2,1,2,3
32891_2,,,,2,1,2,3
32892_0,,,,2,1,2,3
32892_1,,,,2,1,2,3
32893_0,,,,2,1,2,3
32893_1,,,,2,1,2,3
32893_2,,,,2,1,2,3
32894_0,,,,2,1,2,3
32895_0,,,,2,1,2,3
32895_1,,,,2,1,2,3
32895_2,,,,2,1,2,3
32896_0,,,,2,1,2,3
32896_1,,,,2,1,2,3
32897_0,,,,2,1,2,3
32898_0,,,,2,1,2,3
32898_1,,,,2,1,2,3
32898_2,,,,2,1,2,3
32899_0,,,,2,1,2,3
32899_1,,,,2,1,2,3
32900_0,,,,2,1,2,3
32900_1,,,,2,1,2,3
32900_2,,,,2,1,2,3
32901_0,,,,2,1,2,3
32902_0,,,,2,1,2,3
32902_1,,,,2,1,2,3
32902_2,,,,2,1,2,3
32903_0,,,,2,1,2,3
32904_0,,,,2,1,2,3
32904_1,,,,2,1,2,3
32905_0,,,,2,1,2,3
32905_1,,,,2,1,2,3
32905_2,,,,2,1,2,3
32906_0,,,,2,1,2,3
32907_0,,,,2,1,2,3
32907_1,,,,2,1,2,3
32907_2,,,,2,1,2,3
32908_0,,,,2,1,2,3
32908_1,,,,2,1,2,3
32908_2,,,,2,1,2,3
32909_0,,,,2,1,2,3
32909_1,,,,2,1,2,3
32909_2,,,,2,1,2,3
32910_0,,,,2,1,2,3
32910_1,,,,2,1,2,3
32911_0,,,,2,1,2,3
32911_1,,,,2,1,2,3
32912_0,,,,2,1,2,3
32912_1,,,,2,1,2,3
32912_2,,,,2,1,2,3
32913_0,,,,2,1,2,3
32913_1,,,,2,1,2,3
32913_2,,,,2,1,2,3
32914_0,,,,2,1,2,3
32914_1,,,,2,1,2,3
32914_2,,,,2,1,2,3
32915_0,,,,2,1,2,3
32915_1,,,,2,1,2,3
32916_0,,,,2,1,2,3
32916_1,,,,2,1,2,3
32916_2,,,,2,1,2,3
32917_0,,,,2,1,2,3
32917_1,,,,2,1,2,3
32917_2,,,,2,1,2,3
32918_0,,,,2,1,2,3
32918_1,,,,2,1,2,3
32919_0,,,,2,1,2,3
32921_0,,,,2,1,2,3
C(C(C)O)(C(C)O)=O,,,5,1,3,0,3
32923_0,,,,2,1,2,3
C(C(CCO)O)(C(C)O)=O,,,5,1,5,0,5
32924_0,,,,2,1,2,3
32924_1,,,,2,1,2,3
32925_0,,,,2,1,2,3
32926_0,,,,2,1,2,3
32926_1,,,,2,1,2,3
32927_0,,,,2,1,2,3
32927_1,,,,2,1,2,3
32928_0,,,,2,1,2,3
32929_0,,,,2,1,2,3
32930_0,,,,2,1,2,3
32930_1,,,,2,1,2,3
32931_0,,,,2,1,2,3
32931_1,,,,2,1,2,3
32932_0,,,,2,1,2,3
32932_1,,,,2,1,2,3
32933_0,,,,2,1,2,3
32933_1,,,,2,1,2,3
32934_0,,,,2,1,2,3
32934_1,,,,2,1,2,3
32935_0,,,,2,1,2,3
32936_0,,,,2,1,2,3
32936_1,,,,2,1,2,3
32937_0,,,,2,1,2,3
32938_0,,,,2,1,2,3
32938_1,,,,2,1,2,3
32939_0,,,,2,1,2,3
32939_1,,,,2,1,2,3
32940_0,,,,2,1,2,3
32940_1,,,,2,1,2,3
32942_0,,,,2,1,1,2
C(OCC(C(C(CO)=O)O)O)=O,,,5,1,3,0,3
32942_1,,,,2,1,1,2
32942_2,,,,2,1,1,2
32944_0,,,,2,1,1,2
C(CO)(C(C(OCC=O)O)O)=O,,,5,1,4,0,4
32944_1,,,,2,1,1,2
32944_2,,,,2,1,1,2
32946_0,,,,2,1,1,2
C(OCC(CO)=O)=O,,,5,1,2,0,2
32946_1,,,,2,1,1,2
32947_0,,,,2,1,2,3
32947_1,,,,2,1,2,3
32948_0,,,,2,1,2,3
32949_0,,,,2,1,2,3
32949_1,,,,2,1,2,3
32949_2,,,,2,1,2,3
32950_0,,,,2,1,2,3
32950_1,,,,2,1,2,3
32950_2,,,,2,1,2,3
32951_0,,,,2,1,2,3
32951_1,,,,2,1,2,3
32952_0,,,,2,1,2,3
32952_1,,,,2,1,2,3
32953_0,,,,2,1,2,3
32953_1,,,,2,1,2,3
32954_0,,,,2,1,2,3
32955_0,,,,2,1,2,3
32955_1,,,,2,1,2,3
32957_0,,,,2,1,2,3
C(C)(CCO)=O,,,5,1,8,0,8
32957_1,,,,2,1,2,3
32958_0,,,,2,1,2,3
32958_1,,,,2,1,2,3
32959_0,,,,2,1,2,3
32959_1,,,,2,1,2,3
32960_0,,,,2,1,2,3
32960_1,,,,2,1,2,3
32960_2,,,,2,1,2,3
32961_0,,,,2,1,2,3
32961_1,,,,2,1,2,3
32961_2,,,,2,1,2,3
32962_0,,,,2,1,2,3
32962_1,,,,2,1,2,3
32963_0,,,,2,1,2,3
32963_1,,,,2,1,2,3
32963_2,,,,2,1,2,3
32964_0,,,,2,1,2,3
32964_1,,,,2,1,2,3
32964_2,,,,2,1,2,3
32965_0,,,,2,1,2,3
32965_1,,,,2,1,2,3
32966_0,,,,2,1,2,3
32966_1,,,,2,1,2,3
32966_2,,,,2,1,2,3
32967_0,,,,2,1,2,3
32967_1,,,,2,1,2,3
32967_2,,,,2,1,2,3
32968_0,,,,2,1,2,3
32968_1,,,,2,1,2,3
32968_2,,,,2,1,2,3
32969_0,,,,2,1,2,3
32969_1,,,,2,1,2,3
32969_2,,,,2,1,2,3
32970_0,,,,2,1,2,3
32970_1,,,,2,1,2,3
32970_2,,,,2,1,2,3
32971_0,,,,2,1,2,3
32971_1,,,,2,1,2,3
32971_2,,,,2,1,2,3
32972_0,,,,2,1,2,3
32972_1,,,,2,1,2,3
32972_2,,,,2,1,2,3
32973_0,,,,2,1,2,3
32973_1,,,,2,1,2,3
32973_2,,,,2,1,2,3
32974_0,,,,2,1,2,3
32974_1,,,,2,1,2,3
32974_2,,,,2,1,2,3
32975_0,,,,2,1,2,3
32975_1,,,,2,1,2,3
32975_2,,,,2,1,2,3
32976_0,,,,2,1,2,3
32976_1,,,,2,1,2,3
32976_2,,,,2,1,2,3
32977_0,,,,2,1,2,3
32977_1,,,,2,1,2,3
32977_2,,,,2,1,2,3
32978_0,,,,2,1,2,3
32978_1,,,,2,1,2,3
32978_2,,,,2,1,2,3
32979_0,,,,2,1,2,3
32979_1,,,,2,1,2,3
32979_2,,,,2,1,2,3
32980_0,,,,2,1,2,3
32980_1,,,,2,1,2,3
32981_0,,,,2,1,2,3
32981_1,,,,2,1,2,3
32981_2,,,,2,1,2,3
32982_0,,,,2,1,2,3
32982_1,,,,2,1,2,3
32982_2,,,,2,1,2,3
32983_0,,,,2,1,2,3
32983_1,,,,2,1,2,3
32983_2,,,,2,1,2,3
32985_0,,,,2,1,2,3
C(CO)(C(CO)(C)O)=O,,,5,1,5,0,5
32986_0,,,,2,1,2,3
32986_1,,,,2,1,2,3
32987_0,,,,2,1,2,3
32987_1,,,,2,1,2,3
32987_2,,,,2,1,2,3
32988_0,,,,2,1,2,3
32988_1,,,,2,1,2,3
32988_2,,,,2,1,2,3
32989_0,,,,2,1,2,3
32989_1,,,,2,1,2,3
32990_0,,,,2,1,2,3
32990_1,,,,2,1,2,3
32990_2,,,,2,1,2,3
32991_0,,,,2,1,2,3
32991_1,,,,2,1,2,3
32991_2,,,,2,1,2,3
32992_0,,,,2,1,2,3
32992_1,,,,2,1,2,3
32992_2,,,,2,1,2,3
32993_0,,,,2,1,2,3
32993_1,,,,2,1,2,3
32993_2,,,,2,1,2,3
32994_0,,,,2,1,2,3
32994_1,,,,2,1,2,3
32994_2,,,,2,1,2,3
32995_0,,,,2,1,2,3
32996_0,,,,2,1,2,3
32996_1,,,,2,1,2,3
32996_2,,,,2,1,2,3
32997_0,,,,2,1,2,3
32997_1,,,,2,1,2,3
32997_2,,,,2,1,2,3
32998_0,,,,2,1,2,3
32998_1,,,,2,1,2,3
32998_2,,,,2,1,2,3
32999_0,,,,2,1,2,3
32999_1,,,,2,1,2,3
32999_2,,,,2,1,2,3
33000_0,,,,2,1,2,3
33000_1,,,,2,1,2,3
33001_0,,,,2,1,2,3
33001_1,,,,2,1,2,3
33001_2,,,,2,1,2,3
33002_0,,,,2,1,2,3
33002_1,,,,2,1,2,3
33002_2,,,,2,1,2,3
33003_0,,,,2,1,2,3
33003_1,,,,2,1,2,3
33003_2,,,,2,1,2,3
33004_0,,,,2,1,2,3
33004_1,,,,2,1,2,3
33004_2,,,,2,1,2,3
33005_0,,,,2,1,2,3
33005_1,,,,2,1,2,3
33005_2,,,,2,1,2,3
33006_0,,,,2,1,2,3
33006_1,,,,2,1,2,3
33006_2,,,,2,1,2,3
33007_0,,,,2,1,2,3
33007_1,,,,2,1,2,3
33007_2,,,,2,1,2,3
33008_0,,,,2,1,2,3
33008_1,,,,2,1,2,3
33008_2,,,,2,1,2,3
33009_0,,,,2,1,2,3
33009_1,,,,2,1,2,3
33009_2,,,,2,1,2,3
33010_0,,,,2,1,2,3
33010_1,,,,2,1,2,3
33010_2,,,,2,1,2,3
33011_0,,,,2,1,2,3
33011_1,,,,2,1,2,3
33011_2,,,,2,1,2,3
33012_0,,,,2,1,2,3
33012_1,,,,2,1,2,3
33012_2,,,,2,1,2,3
33013_0,,,,2,1,2,3
33013_1,,,,2,1,2,3
33013_2,,,,2,1,2,3
33014_0,,,,2,1,2,3
33014_1,,,,2,1,2,3
33014_2,,,,2,1,2,3
33015_0,,,,2,1,2,3
33015_1,,,,2,1,2,3
33015_2,,,,2,1,2,3
33016_0,,,,2,1,2,3
33016_1,,,,2,1,2,3
33017_0,,,,2,1,2,3
33017_1,,,,2,1,2,3
33017_2,,,,2,1,2,3
33018_0,,,,2,1,2,3
33018_1,,,,2,1,2,3
33018_2,,,,2,1,2,3
33019_0,,,,2,1,2,3
33020_0,,,,2,1,2,3
33020_1,,,,2,1,2,3
33021_0,,,,2,1,2,3
33021_1,,,,2,1,2,3
33022_0,,,,2,1,2,3
33022_1,,,,2,1,2,3
33023_0,,,,2,1,2,3
33023_1,,,,2,1,2,3
33024_0,,,,2,1,2,3
33025_0,,,,2,1,2,3
33025_1,,,,2,1,2,3
33026_0,,,,2,1,2,3
33027_0,,,,2,1,2,3
33027_1,,,,2,1,2,3
33028_0,,,,2,1,2,3
33029_0,,,,2,1,2,3
33030_0,,,,2,1,2,3
33030_1,,,,2,1,2,3
33031_0,,,,2,1,2,3
33031_1,,,,2,1,2,3
33032_0,,,,2,1,2,3
33033_0,,,,2,1,2,3
33033_1,,,,2,1,2,3
33033_2,,,,2,1,2,3
33034_0,,,,2,1,2,3
33034_1,,,,2,1,2,3
33035_0,,,,2,1,2,3
33035_1,,,,2,1,2,3
33036_0,,,,2,1,2,3
33037_0,,,,2,1,2,3
33038_0,,,,2,1,2,3
33038_1,,,,2,1,2,3
33039_0,,,,2,1,2,3
33039_1,,,,2,1,2,3
33040_0,,,,2,1,2,3
33040_1,,,,2,1,2,3
33041_0,,,,2,1,2,3
33042_0,,,,2,1,2,3
33042_1,,,,2,1,2,3
33042_2,,,,2,1,2,3
33043_0,,,,2,1,2,3
33044_0,,,,2,1,2,3
33044_1,,,,2,1,2,3
33044_2,,,,2,1,2,3
33045_0,,,,2,1,2,3
33045_1,,,,2,1,2,3
33046_0,,,,2,1,2,3
33046_1,,,,2,1,2,3
33046_2,,,,2,1,2,3
33047_0,,,,2,1,2,3
33048_0,,,,2,1,2,3
33048_1,,,,2,1,2,3
33048_2,,,,2,1,2,3
33049_0,,,,2,1,2,3
33049_1,,,,2,1,2,3
33050_0,,,,2,1,2,3
33051_0,,,,2,1,2,3
33051_1,,,,2,1,2,3
33051_2,,,,2,1,2,3
33052_0,,,,2,1,2,3
33053_0,,,,2,1,2,3
33053_1,,,,2,1,2,3
33053_2,,,,2,1,2,3
33054_0,,,,2,1,2,3
33054_1,,,,2,1,2,3
33054_2,,,,2,1,2,3
33055_0,,,,2,1,2,3
33055_1,,,,2,1,2,3
33055_2,,,,2,1,2,3
33056_0,,,,2,1,2,3
33056_1,,,,2,1,2,3
33056_2,,,,2,1,2,3
33057_0,,,,2,1,2,3
33058_0,,,,2,1,2,3
33058_1,,,,2,1,2,3
33059_0,,,,2,1,2,3
33059_1,,,,2,1,2,3
33059_2,,,,2,1,2,3
33060_0,,,,2,1,2,3
33061_0,,,,2,1,2,3
33061_1,,,,2,1,2,3
33061_2,,,,2,1,2,3
33062_0,,,,2,1,2,3
33063_0,,,,2,1,2,3
33063_1,,,,2,1,2,3
33063_2,,,,2,1,2,3
33064_0,,,,2,1,2,3
33065_0,,,,2,1,2,3
33065_1,,,,2,1,2,3
33065_2,,,,2,1,2,3
33066_0,,,,2,1,2,3
33066_1,,,,2,1,2,3
33066_2,,,,2,1,2,3
33067_0,,,,2,1,2,3
33067_1,,,,2,1,2,3
33068_0,,,,2,1,2,3
33068_1,,,,2,1,2,3
33068_2,,,,2,1,2,3
33069_0,,,,2,1,2,3
33069_1,,,,2,1,2,3
33069_2,,,,2,1,2,3
33070_0,,,,2,1,2,3
33070_1,,,,2,1,2,3
33070_2,,,,2,1,2,3
33071_0,,,,2,1,2,3
33071_1,,,,2,1,2,3
33071_2,,,,2,1,2,3
33072_0,,,,2,1,2,3
33072_1,,,,2,1,2,3
33072_2,,,,2,1,2,3
33073_0,,,,2,1,2,3
33074_0,,,,2,1,2,3
33074_1,,,,2,1,2,3
33075_0,,,,2,1,2,3
33076_0,,,,2,1,2,3
33076_1,,,,2,1,2,3
33077_0,,,,2,1,2,3
33077_1,,,,2,1,2,3
33078_0,,,,2,1,2,3
33078_1,,,,2,1,2,3
33079_0,,,,2,1,2,3
33079_1,,,,2,1,2,3
33080_0,,,,2,1,2,3
33081_0,,,,2,1,2,3
33082_0,,,,2,1,2,3
33083_0,,,,2,1,2,3
33083_1,,,,2,1,2,3
33085_0,,,,2,1,2,3
C(C(C=O)(CC(O)=O)O)=O,,,5,1,4,0,4
33086_0,,,,2,1,2,3
33086_1,,,,2,1,2,3
33087_0,,,,2,1,2,3
33088_0,,,,2,1,2,3
33089_0,,,,2,1,2,3
33089_1,,,,2,1,2,3
33090_0,,,,2,1,2,3
33091_0,,,,2,1,2,3
33092_0,,,,2,1,2,3
33092_1,,,,2,1,2,3
33092_2,,,,2,1,2,3
33093_0,,,,2,1,2,3
33093_1,,,,2,1,2,3
33094_0,,,,2,1,2,3
33094_1,,,,2,1,2,3
33094_2,,,,2,1,2,3
33095_0,,,,2,1,2,3
33095_1,,,,2,1,2,3
33095_2,,,,2,1,2,3
33096_0,,,,2,1,2,3
33097_0,,,,2,1,2,3
33097_1,,,,2,1,2,3
33097_2,,,,2,1,2,3
33098_0,,,,2,1,2,3
33099_0,,,,2,1,1,2
33099_1,,,,2,1,1,2
33100_0,,,,2,1,1,2
33100_1,,,,2,1,1,2
33100_2,,,,2,1,1,2
33101_0,,,,2,1,1,2
33101_1,,,,2,1,1,2
33101_2,,,,2,1,1,2
33102_0,,,,2,1,1,2
33102_1,,,,2,1,1,2
33103_0,,,,2,1,1,2
33103_1,,,,2,1,1,2
33103_2,,,,2,1,1,2
33104_0,,,,2,1,1,2
33104_1,,,,2,1,1,2
33104_2,,,,2,1,1,2
33105_0,,,,2,1,1,2
33105_1,,,,2,1,1,2
33105_2,,,,2,1,1,2
33106_0,,,,2,1,1,2
33106_1,,,,2,1,1,2
33106_2,,,,2,1,1,2
33107_0,,,,2,1,1,2
33107_1,,,,2,1,1,2
33107_2,,,,2,1,1,2
33108_0,,,,2,1,1,2
33109_0,,,,2,1,1,2
33109_1,,,,2,1,1,2
33110_0,,,,2,1,1,2
33110_1,,,,2,1,1,2
33110_2,,,,2,1,1,2
33111_0,,,,2,1,1,2
33111_1,,,,2,1,1,2
33111_2,,,,2,1,1,2
33112_0,,,,2,1,2,3
33112_1,,,,2,1,2,3
33112_2,,,,2,1,2,3
33113_0,,,,2,1,1,2
33113_1,,,,2,1,1,2
33113_2,,,,2,1,1,2
33115_0,,,,2,1,1,2
C(C(CC(C(C(CO)=O)=O)O)O)=O,,,5,1,3,0,3
33115_1,,,,2,1,1,2
33116_0,,,,2,1,1,2
33116_1,,,,2,1,1,2
33117_0,,,,2,1,1,2
33117_1,,,,2,1,1,2
33118_0,,,,2,1,1,2
33118_1,,,,2,1,1,2
33118_2,,,,2,1,1,2
33119_0,,,,2,1,1,2
33119_1,,,,2,1,1,2
33119_2,,,,2,1,1,2
33120_0,,,,2,1,2,3
33121_0,,,,2,1,1,2
33121_1,,,,2,1,1,2
33121_2,,,,2,1,1,2
33122_0,,,,2,1,1,2
33122_1,,,,2,1,1,2
33122_2,,,,2,1,1,2
33123_0,,,,2,1,1,2
33124_0,,,,2,1,1,2
33124_1,,,,2,1,1,2
33125_0,,,,2,1,1,2
33125_1,,,,2,1,1,2
33125_2,,,,2,1,1,2
33126_0,,,,2,1,1,2
33126_1,,,,2,1,1,2
33126_2,,,,2,1,1,2
33127_0,,,,2,1,1,2
33128_0,,,,2,1,1,2
33128_1,,,,2,1,1,2
33129_0,,,,2,1,2,3
33129_1,,,,2,1,2,3
33129_2,,,,2,1,2,3
33130_0,,,,2,1,1,2
33130_1,,,,2,1,1,2
33130_2,,,,2,1,1,2
33131_0,,,,2,1,1,2
33131_1,,,,2,1,1,2
33131_2,,,,2,1,1,2
33132_0,,,,2,1,1,2
33132_1,,,,2,1,1,2
33132_2,,,,2,1,1,2
33133_0,,,,2,1,1,2
33134_0,,,,2,1,1,2
33134_1,,,,2,1,1,2
33134_2,,,,2,1,1,2
33135_0,,,,2,1,2,3
33135_1,,,,2,1,2,3
33135_2,,,,2,1,2,3
33136_0,,,,2,1,2,3
33136_1,,,,2,1,2,3
33137_0,,,,2,1,2,3
33137_1,,,,2,1,2,3
33138_0,,,,2,1,2,3
33139_0,,,,2,1,2,3
33139_1,,,,2,1,2,3
33139_2,,,,2,1,2,3
33140_0,,,,2,1,2,3
33140_1,,,,2,1,2,3
33141_0,,,,2,1,2,3
33141_1,,,,2,1,2,3
33141_2,,,,2,1,2,3
33142_0,,,,2,1,2,3
33142_1,,,,2,1,2,3
33142_2,,,,2,1,2,3
33143_0,,,,2,1,2,3
33143_1,,,,2,1,2,3
33143_2,,,,2,1,2,3
33144_0,,,,2,1,2,3
33144_1,,,,2,1,2,3
33144_2,,,,2,1,2,3
33145_0,,,,2,1,2,3
33145_1,,,,2,1,2,3
33145_2,,,,2,1,2,3
33146_0,,,,2,1,2,3
33147_0,,,,2,1,2,3
33147_1,,,,2,1,2,3
33147_2,,,,2,1,2,3
33148_0,,,,2,1,2,3
33148_1,,,,2,1,2,3
33149_0,,,,2,1,2,3
33150_0,,,,2,1,2,3
33150_1,,,,2,1,2,3
33151_0,,,,2,1,2,3
33151_1,,,,2,1,2,3
33152_0,,,,2,1,2,3
33152_1,,,,2,1,2,3
33153_0,,,,2,1,2,3
33153_1,,,,2,1,2,3
33154_0,,,,2,1,2,3
33154_1,,,,2,1,2,3
33155_0,,,,2,1,2,3
33156_0,,,,2,1,2,3
33156_1,,,,2,1,2,3
33157_0,,,,2,1,2,3
33157_1,,,,2,1,2,3
33158_0,,,,2,1,2,3
33158_1,,,,2,1,2,3
33159_0,,,,2,1,2,3
33159_1,,,,2,1,2,3
33160_0,,,,2,1,2,3
33160_1,,,,2,1,2,3
33161_0,,,,2,1,2,3
33162_0,,,,2,1,2,3
33162_1,,,,2,1,2,3
33162_2,,,,2,1,2,3
33163_0,,,,2,1,2,3
33163_1,,,,2,1,2,3
33164_0,,,,2,1,2,3
33164_1,,,,2,1,2,3
33164_2,,,,2,1,2,3
33165_0,,,,2,1,2,3
33165_1,,,,2,1,2,3
33165_2,,,,2,1,2,3
33166_0,,,,2,1,2,3
33166_1,,,,2,1,2,3
33167_0,,,,2,1,2,3
33168_0,,,,2,1,2,3
33168_1,,,,2,1,2,3
33169_0,,,,2,1,2,3
33169_1,,,,2,1,2,3
33170_0,,,,2,1,2,3
33170_1,,,,2,1,2,3
33171_0,,,,2,1,2,3
33171_1,,,,2,1,2,3
33172_0,,,,2,1,2,3
33172_1,,,,2,1,2,3
33173_0,,,,2,1,2,3
33174_0,,,,2,1,2,3
33174_1,,,,2,1,2,3
33174_2,,,,2,1,2,3
33175_0,,,,2,1,2,3
33175_1,,,,2,1,2,3
33176_0,,,,2,1,2,3
33176_1,,,,2,1,2,3
33177_0,,,,2,1,2,3
33177_1,,,,2,1,2,3
33177_2,,,,2,1,2,3
33178_0,,,,2,1,2,3
33178_1,,,,2,1,2,3
33179_0,,,,2,1,2,3
33179_1,,,,2,1,2,3
33179_2,,,,2,1,2,3
33180_0,,,,2,1,2,3
33180_1,,,,2,1,2,3
33180_2,,,,2,1,2,3
33181_0,,,,2,1,2,3
33181_1,,,,2,1,2,3
33182_0,,,,2,1,2,3
33182_1,,,,2,1,2,3
33182_2,,,,2,1,2,3
33183_0,,,,2,1,2,3
33183_1,,,,2,1,2,3
33183_2,,,,2,1,2,3
33184_0,,,,2,1,2,3
33185_0,,,,2,1,2,3
33185_1,,,,2,1,2,3
33187_0,,,,2,1,2,3
C(C(C=O)(C=O)C(O)=O)=O,,,5,1,2,0,2
33188_0,,,,2,1,2,3
33188_1,,,,2,1,2,3
33189_0,,,,2,1,2,3
33189_1,,,,2,1,2,3
33191_0,,,,2,1,2,3
C(C(C=O)(C=O)C(C)O)=O,,,5,1,2,0,2
33192_0,,,,2,1,2,3
33192_1,,,,2,1,2,3
33193_0,,,,2,1,2,3
33193_1,,,,2,1,2,3
33195_0,,,,2,1,2,3
C(C(C=O)(C=O)CO)=O,,,5,1,4,0,4
33196_0,,,,2,1,2,3
33197_0,,,,2,1,2,3
33197_1,,,,2,1,2,3
33197_2,,,,2,1,2,3
33198_0,,,,2,1,2,3
33199_0,,,,2,1,2,3
33199_1,,,,2,1,2,3
33199_2,,,,2,1,2,3
33200_0,,,,2,1,2,3
33200_1,,,,2,1,2,3
33200_2,,,,2,1,2,3
33201_0,,,,2,1,2,3
33202_0,,,,2,1,2,3
33202_1,,,,2,1,2,3
33203_0,,,,2,1,2,3
33203_1,,,,2,1,2,3
33204_0,,,,2,1,2,3
33204_1,,,,2,1,2,3
33205_0,,,,2,1,2,3
33205_1,,,,2,1,2,3
33206_0,,,,2,1,2,3
33207_0,,,,2,1,2,3
33207_1,,,,2,1,2,3
33208_0,,,,2,1,2,3
33208_1,,,,2,1,2,3
33209_0,,,,2,1,2,3
33209_1,,,,2,1,2,3
33210_0,,,,2,1,2,3
33210_1,,,,2,1,2,3
33211_0,,,,2,1,2,3
33211_1,,,,2,1,2,3
33212_0,,,,2,1,2,3
33212_1,,,,2,1,2,3
33213_0,,,,2,1,2,3
33213_1,,,,2,1,2,3
33214_0,,,,2,1,2,3
33214_1,,,,2,1,2,3
33215_0,,,,2,1,2,3
33215_1,,,,2,1,2,3
33216_0,,,,2,1,2,3
33216_1,,,,2,1,2,3
33217_0,,,,2,1,2,3
33217_1,,,,2,1,2,3
33218_0,,,,2,1,2,3
33218_1,,,,2,1,2,3
33219_0,,,,2,1,2,3
33219_1,,,,2,1,2,3
33220_0,,,,2,1,2,3
33220_1,,,,2,1,2,3
33221_0,,,,2,1,2,3
33221_1,,,,2,1,2,3
33222_0,,,,2,1,2,3
33222_1,,,,2,1,2,3
33223_0,,,,2,1,2,3
33223_1,,,,2,1,2,3
33224_0,,,,2,1,2,3
33224_1,,,,2,1,2,3
33225_0,,,,2,1,2,3
33225_1,,,,2,1,2,3
33226_0,,,,2,1,2,3
33227_0,,,,2,1,2,3
33227_1,,,,2,1,2,3
33228_0,,,,2,1,2,3
33228_1,,,,2,1,2,3
33229_0,,,,2,1,2,3
33229_1,,,,2,1,2,3
33230_0,,,,2,1,2,3
33230_1,,,,2,1,2,3
33231_0,,,,2,1,2,3
33231_1,,,,2,1,2,3
33232_0,,,,2,1,2,3
33232_1,,,,2,1,2,3
33233_0,,,,2,1,2,3
33233_1,,,,2,1,2,3
33234_0,,,,2,1,2,3
33234_1,,,,2,1,2,3
33235_0,,,,2,1,2,3
33235_1,,,,2,1,2,3
33236_0,,,,2,1,2,3
33236_1,,,,2,1,2,3
33237_0,,,,2,1,2,3
33237_1,,,,2,1,2,3
33238_0,,,,2,1,2,3
33238_1,,,,2,1,2,3
33239_0,,,,2,1,2,3
33239_1,,,,2,1,2,3
33240_0,,,,2,1,2,3
33240_1,,,,2,1,2,3
33241_0,,,,2,1,2,3
33241_1,,,,2,1,2,3
33242_0,,,,2,1,2,3
33242_1,,,,2,1,2,3
33243_0,,,,2,1,2,3
33243_1,,,,2,1,2,3
33244_0,,,,2,1,2,3
33244_1,,,,2,1,2,3
33245_0,,,,2,1,2,3
33245_1,,,,2,1,2,3
33246_0,,,,2,1,2,3
33246_1,,,,2,1,2,3
33247_0,,,,2,1,2,3
33247_1,,,,2,1,2,3
33248_0,,,,2,1,2,3
33248_1,,,,2,1,2,3
33249_0,,,,2,1,2,3
33249_1,,,,2,1,2,3
33250_0,,,,2,1,2,3
33250_1,,,,2,1,2,3
33251_0,,,,2,1,2,3
33251_1,,,,2,1,2,3
33252_0,,,,2,1,2,3
33253_0,,,,2,1,2,3
33253_1,,,,2,1,2,3
33254_0,,,,2,1,2,3
33254_1,,,,2,1,2,3
33255_0,,,,2,1,2,3
33255_1,,,,2,1,2,3
33256_0,,,,2,1,2,3
33256_1,,,,2,1,2,3
33257_0,,,,2,1,2,3
33257_1,,,,2,1,2,3
33258_0,,,,2,1,2,3
33258_1,,,,2,1,2,3
33259_0,,,,2,1,2,3
33259_1,,,,2,1,2,3
33260_0,,,,2,1,2,3
33260_1,,,,2,1,2,3
33261_0,,,,2,1,2,3
33261_1,,,,2,1,2,3
33261_2,,,,2,1,2,3
33262_0,,,,2,1,2,3
33262_1,,,,2,1,2,3
33264_0,,,,2,1,2,3
C(C(C=O)(C=O)O)=O,,,5,1,10,0,10
33264_1,,,,2,1,2,3
33265_0,,,,2,1,2,3
33266_0,,,,2,1,2,3
33266_1,,,,2,1,2,3
33267_0,,,,2,1,2,3
33267_1,,,,2,1,2,3
33268_0,,,,2,1,2,3
33268_1,,,,2,1,2,3
33269_0,,,,2,1,2,3
33269_1,,,,2,1,2,3
33269_2,,,,2,1,2,3
33270_0,,,,2,1,2,3
33270_1,,,,2,1,2,3
33270_2,,,,2,1,2,3
33271_0,,,,2,1,2,3
33272_0,,,,2,1,2,3
33273_0,,,,2,1,2,3
33273_1,,,,2,1,2,3
33274_0,,,,2,1,2,3
33274_1,,,,2,1,2,3
33275_0,,,,2,1,2,3
33275_1,,,,2,1,2,3
33276_0,,,,2,1,2,3
33276_1,,,,2,1,2,3
33277_0,,,,2,1,2,3
33277_1,,,,2,1,2,3
33278_0,,,,2,1,2,3
33278_1,,,,2,1,2,3
33279_0,,,,2,1,2,3
33279_1,,,,2,1,2,3
33280_0,,,,2,1,2,3
33280_1,,,,2,1,2,3
33281_0,,,,2,1,2,3
33282_0,,,,2,1,2,3
33282_1,,,,2,1,2,3
33283_0,,,,2,1,2,3
33283_1,,,,2,1,2,3
33284_0,,,,2,1,2,3
33284_1,,,,2,1,2,3
33285_0,,,,2,1,2,3
33285_1,,,,2,1,2,3
33286_0,,,,2,1,2,3
33287_0,,,,2,1,2,3
33287_1,,,,2,1,2,3
33288_0,,,,2,1,2,3
33288_1,,,,2,1,2,3
33289_0,,,,2,1,2,3
33289_1,,,,2,1,2,3
33290_0,,,,2,1,2,3
33290_1,,,,2,1,2,3
33291_0,,,,2,1,2,3
33291_1,,,,2,1,2,3
33292_0,,,,2,1,2,3
33292_1,,,,2,1,2,3
33293_0,,,,2,1,2,3
33293_1,,,,2,1,2,3
33294_0,,,,2,1,2,3
33294_1,,,,2,1,2,3
33295_0,,,,2,1,2,3
33295_1,,,,2,1,2,3
33296_0,,,,2,1,2,3
33297_0,,,,2,1,2,3
33297_1,,,,2,1,2,3
33298_0,,,,2,1,2,3
33298_1,,,,2,1,2,3
33299_0,,,,2,1,2,3
33299_1,,,,2,1,2,3
33300_0,,,,2,1,2,3
33300_1,,,,2,1,2,3
33301_0,,,,2,1,2,3
33301_1,,,,2,1,2,3
33302_0,,,,2,1,2,3
33302_1,,,,2,1,2,3
33303_0,,,,2,1,2,3
33303_1,,,,2,1,2,3
33304_0,,,,2,1,2,3
33305_0,,,,2,1,2,3
33305_1,,,,2,1,2,3
33306_0,,,,2,1,2,3
33306_1,,,,2,1,2,3
33307_0,,,,2,1,2,3
33307_1,,,,2,1,2,3
33308_0,,,,2,1,2,3
33308_1,,,,2,1,2,3
33309_0,,,,2,1,2,3
33309_1,,,,2,1,2,3
33310_0,,,,2,1,2,3
33310_1,,,,2,1,2,3
33311_0,,,,2,1,2,3
33312_0,,,,2,1,2,3
33312_1,,,,2,1,2,3
33313_0,,,,2,1,2,3
33313_1,,,,2,1,2,3
33314_0,,,,2,1,2,3
33314_1,,,,2,1,2,3
33315_0,,,,2,1,2,3
33315_1,,,,2,1,2,3
33316_0,,,,2,1,2,3
33317_0,,,,2,1,2,3
33317_1,,,,2,1,2,3
33317_2,,,,2,1,2,3
33318_0,,,,2,1,2,3
33318_1,,,,2,1,2,3
33318_2,,,,2,1,2,3
33319_0,,,,2,1,2,3
33319_1,,,,2,1,2,3
33319_2,,,,2,1,2,3
33320_0,,,,2,1,2,3
33320_1,,,,2,1,2,3
33320_2,,,,2,1,2,3
33321_0,,,,2,1,2,3
33321_1,,,,2,1,2,3
33322_0,,,,2,1,2,3
33322_1,,,,2,1,2,3
33322_2,,,,2,1,2,3
33323_0,,,,2,1,2,3
33323_1,,,,2,1,2,3
33323_2,,,,2,1,2,3
33324_0,,,,2,1,2,3
33325_0,,,,2,1,2,3
33325_1,,,,2,1,2,3
33325_2,,,,2,1,2,3
33326_0,,,,2,1,2,3
33326_1,,,,2,1,2,3
33326_2,,,,2,1,2,3
33327_0,,,,2,1,2,3
33327_1,,,,2,1,2,3
33327_2,,,,2,1,2,3
33328_0,,,,2,1,2,3
33328_1,,,,2,1,2,3
33328_2,,,,2,1,2,3
33329_0,,,,2,1,2,3
33330_0,,,,2,1,2,3
33331_0,,,,2,1,2,3
33331_1,,,,2,1,2,3
33331_2,,,,2,1,2,3
33332_0,,,,2,1,2,3
33333_0,,,,2,1,2,3
33334_0,,,,2,1,2,3
33335_0,,,,2,1,2,3
33336_0,,,,2,1,2,3
33336_1,,,,2,1,2,3
33336_2,,,,2,1,2,3
33337_0,,,,2,1,2,3
33337_1,,,,2,1,2,3
33337_2,,,,2,1,2,3
33338_0,,,,2,1,2,3
33338_1,,,,2,1,2,3
33338_2,,,,2,1,2,3
33339_0,,,,2,1,2,3
33339_1,,,,2,1,2,3
33339_2,,,,2,1,2,3
33340_0,,,,2,1,2,3
33340_1,,,,2,1,2,3
33340_2,,,,2,1,2,3
33341_0,,,,2,1,2,3
33341_1,,,,2,1,2,3
33341_2,,,,2,1,2,3
33342_0,,,,2,1,2,3
33342_1,,,,2,1,2,3
33342_2,,,,2,1,2,3
33343_0,,,,2,1,2,3
33343_1,,,,2,1,2,3
33343_2,,,,2,1,2,3
33344_0,,,,2,1,2,3
33344_1,,,,2,1,2,3
33344_2,,,,2,1,2,3
33345_0,,,,2,1,2,3
33346_0,,,,2,1,2,3
33346_1,,,,2,1,2,3
33346_2,,,,2,1,2,3
33347_0,,,,2,1,2,3
33348_0,,,,2,1,2,3
33348_1,,,,2,1,2,3
33349_0,,,,2,1,2,3
33349_1,,,,2,1,2,3
33349_2,,,,2,1,2,3
33350_0,,,,2,1,2,3
33350_1,,,,2,1,2,3
33350_2,,,,2,1,2,3
33351_0,,,,2,1,2,3
33352_0,,,,2,1,2,3
33352_1,,,,2,1,2,3
33352_2,,,,2,1,2,3
33353_0,,,,2,1,2,3
33354_0,,,,2,1,2,3
33354_1,,,,2,1,2,3
33354_2,,,,2,1,2,3
33355_0,,,,2,1,2,3
33355_1,,,,2,1,2,3
33355_2,,,,2,1,2,3
33356_0,,,,2,1,2,3
33357_0,,,,2,1,2,3
33357_1,,,,2,1,2,3
33357_2,,,,2,1,2,3
33358_0,,,,2,1,2,3
33358_1,,,,2,1,2,3
33358_2,,,,2,1,2,3
33359_0,,,,2,1,2,3
33359_1,,,,2,1,2,3
33360_0,,,,2,1,2,3
33360_1,,,,2,1,2,3
33360_2,,,,2,1,2,3
33361_0,,,,2,1,2,3
33361_1,,,,2,1,2,3
33361_2,,,,2,1,2,3
33362_0,,,,2,1,2,3
33362_1,,,,2,1,2,3
33362_2,,,,2,1,2,3
33363_0,,,,2,1,2,3
33363_1,,,,2,1,2,3
33363_2,,,,2,1,2,3
33364_0,,,,2,1,2,3
33364_1,,,,2,1,2,3
33364_2,,,,2,1,2,3
33365_0,,,,2,1,2,3
33365_1,,,,2,1,2,3
33365_2,,,,2,1,2,3
33366_0,,,,2,1,2,3
33366_1,,,,2,1,2,3
33366_2,,,,2,1,2,3
33367_0,,,,2,1,2,3
33367_1,,,,2,1,2,3
33367_2,,,,2,1,2,3
33368_0,,,,2,1,2,3
33368_1,,,,2,1,2,3
33369_0,,,,2,1,2,3
33369_1,,,,2,1,2,3
33369_2,,,,2,1,2,3
33370_0,,,,2,1,2,3
33370_1,,,,2,1,2,3
33370_2,,,,2,1,2,3
33371_0,,,,2,1,2,3
33371_1,,,,2,1,2,3
33372_0,,,,2,1,2,3
33372_1,,,,2,1,2,3
33372_2,,,,2,1,2,3
33373_0,,,,2,1,2,3
33373_1,,,,2,1,2,3
33373_2,,,,2,1,2,3
33374_0,,,,2,1,2,3
33374_1,,,,2,1,2,3
33374_2,,,,2,1,2,3
33375_0,,,,2,1,2,3
33375_1,,,,2,1,2,3
33375_2,,,,2,1,2,3
33376_0,,,,2,1,2,3
33377_0,,,,2,1,2,3
33377_1,,,,2,1,2,3
33377_2,,,,2,1,2,3
33378_0,,,,2,1,2,3
33378_1,,,,2,1,2,3
33378_2,,,,2,1,2,3
33379_0,,,,2,1,2,3
33379_1,,,,2,1,2,3
33379_2,,,,2,1,2,3
33380_0,,,,2,1,2,3
33380_1,,,,2,1,2,3
33380_2,,,,2,1,2,3
33381_0,,,,2,1,2,3
33381_1,,,,2,1,2,3
33381_2,,,,2,1,2,3
33382_0,,,,2,1,2,3
33382_1,,,,2,1,2,3
33382_2,,,,2,1,2,3
33383_0,,,,2,1,2,3
33383_1,,,,2,1,2,3
33383_2,,,,2,1,2,3
33384_0,,,,2,1,2,3
33384_1,,,,2,1,2,3
33384_2,,,,2,1,2,3
33385_0,,,,2,1,2,3
33385_1,,,,2,1,2,3
33385_2,,,,2,1,2,3
33386_0,,,,2,1,2,3
33386_1,,,,2,1,2,3
33386_2,,,,2,1,2,3
33387_0,,,,2,1,2,3
33388_0,,,,2,1,2,3
33388_1,,,,2,1,2,3
33388_2,,,,2,1,2,3
33389_0,,,,2,1,2,3
33389_1,,,,2,1,2,3
33389_2,,,,2,1,2,3
33390_0,,,,2,1,2,3
33390_1,,,,2,1,2,3
33390_2,,,,2,1,2,3
33391_0,,,,2,1,2,3
33391_1,,,,2,1,2,3
33391_2,,,,2,1,2,3
33392_0,,,,2,1,2,3
33393_0,,,,2,1,2,3
33393_1,,,,2,1,2,3
33393_2,,,,2,1,2,3
33394_0,,,,2,1,2,3
33394_1,,,,2,1,2,3
33394_2,,,,2,1,2,3
33395_0,,,,2,1,2,3
33395_1,,,,2,1,2,3
33395_2,,,,2,1,2,3
33396_0,,,,2,1,2,3
33396_1,,,,2,1,2,3
33396_2,,,,2,1,2,3
33397_0,,,,2,1,2,3
33398_0,,,,2,1,2,3
33398_1,,,,2,1,2,3
33398_2,,,,2,1,2,3
33399_0,,,,2,1,2,3
33399_1,,,,2,1,2,3
33400_0,,,,2,1,2,3
33401_0,,,,2,1,2,3
33401_1,,,,2,1,2,3
33402_0,,,,2,1,2,3
33403_0,,,,2,1,2,3
33403_1,,,,2,1,2,3
33403_2,,,,2,1,2,3
33404_0,,,,2,1,2,3
33405_0,,,,2,1,2,3
33405_1,,,,2,1,2,3
33405_2,,,,2,1,2,3
33406_0,,,,2,1,2,3
33407_0,,,,2,1,2,3
33408_0,,,,2,1,2,3
33409_0,,,,2,1,2,3
33409_1,,,,2,1,2,3
33409_2,,,,2,1,2,3
33410_0,,,,2,1,2,3
33411_0,,,,2,1,2,3
33411_1,,,,2,1,2,3
33411_2,,,,2,1,2,3
33412_0,,,,2,1,2,3
33413_0,,,,2,1,2,3
33413_1,,,,2,1,2,3
33413_2,,,,2,1,2,3
33414_0,,,,2,1,2,3
33415_0,,,,2,1,2,3
33415_1,,,,2,1,2,3
33416_0,,,,2,1,2,3
33416_1,,,,2,1,2,3
33416_2,,,,2,1,2,3
33417_0,,,,2,1,2,3
33418_0,,,,2,1,2,3
33418_1,,,,2,1,2,3
33419_0,,,,2,1,2,3
33419_1,,,,2,1,2,3
33419_2,,,,2,1,2,3
33420_0,,,,2,1,2,3
33421_0,,,,2,1,2,3
33422_0,,,,2,1,2,3
33422_1,,,,2,1,2,3
33422_2,,,,2,1,2,3
33423_0,,,,2,1,2,3
33424_0,,,,2,1,2,3
33424_1,,,,2,1,2,3
33424_2,,,,2,1,2,3
33425_0,,,,2,1,2,3
33426_0,,,,2,1,2,3
33426_1,,,,2,1,2,3
33426_2,,,,2,1,2,3
33427_0,,,,2,1,2,3
33427_1,,,,2,1,2,3
33427_2,,,,2,1,2,3
33428_0,,,,2,1,2,3
33429_0,,,,2,1,2,3
33429_1,,,,2,1,2,3
33429_2,,,,2,1,2,3
33430_0,,,,2,1,2,3
33430_1,,,,2,1,2,3
33430_2,,,,2,1,2,3
33431_0,,,,2,1,2,3
33431_1,,,,2,1,2,3
33431_2,,,,2,1,2,3
33432_0,,,,2,1,2,3
33432_1,,,,2,1,2,3
33432_2,,,,2,1,2,3
33433_0,,,,2,1,2,3
33433_1,,,,2,1,2,3
33434_0,,,,2,1,2,3
33434_1,,,,2,1,2,3
33434_2,,,,2,1,2,3
33435_0,,,,2,1,2,3
33435_1,,,,2,1,2,3
33435_2,,,,2,1,2,3
33436_0,,,,2,1,2,3
33436_1,,,,2,1,2,3
33436_2,,,,2,1,2,3
33437_0,,,,2,1,2,3
33437_1,,,,2,1,2,3
33437_2,,,,2,1,2,3
33438_0,,,,2,1,2,3
33438_1,,,,2,1,2,3
33439_0,,,,2,1,2,3
33439_1,,,,2,1,2,3
33440_0,,,,2,1,2,3
33440_1,,,,2,1,2,3
33440_2,,,,2,1,2,3
33441_0,,,,2,1,2,3
33441_1,,,,2,1,2,3
33441_2,,,,2,1,2,3
33442_0,,,,2,1,2,3
33442_1,,,,2,1,2,3
33442_2,,,,2,1,2,3
33443_0,,,,2,1,2,3
33443_1,,,,2,1,2,3
33443_2,,,,2,1,2,3
33444_0,,,,2,1,2,3
33444_1,,,,2,1,2,3
33444_2,,,,2,1,2,3
33445_0,,,,2,1,2,3
33445_1,,,,2,1,2,3
33445_2,,,,2,1,2,3
33446_0,,,,2,1,2,3
33446_1,,,,2,1,2,3
33446_2,,,,2,1,2,3
33447_0,,,,2,1,2,3
33447_1,,,,2,1,2,3
33447_2,,,,2,1,2,3
33448_0,,,,2,1,2,3
33448_1,,,,2,1,2,3
33449_0,,,,2,1,2,3
33450_0,,,,2,1,2,3
33450_1,,,,2,1,2,3
33450_2,,,,2,1,2,3
33451_0,,,,2,1,2,3
33451_1,,,,2,1,2,3
33452_0,,,,2,1,2,3
33452_1,,,,2,1,2,3
33452_2,,,,2,1,2,3
33453_0,,,,2,1,2,3
33454_0,,,,2,1,2,3
33454_1,,,,2,1,2,3
33454_2,,,,2,1,2,3
33455_0,,,,2,1,2,3
33455_1,,,,2,1,2,3
33455_2,,,,2,1,2,3
33456_0,,,,2,1,2,3
33456_1,,,,2,1,2,3
33456_2,,,,2,1,2,3
33457_0,,,,2,1,2,3
33457_1,,,,2,1,2,3
33457_2,,,,2,1,2,3
33458_0,,,,2,1,2,3
33458_1,,,,2,1,2,3
33458_2,,,,2,1,2,3
33459_0,,,,2,1,2,3
33459_1,,,,2,1,2,3
33459_2,,,,2,1,2,3
33460_0,,,,2,1,2,3
33460_1,,,,2,1,2,3
33461_0,,,,2,1,2,3
33462_0,,,,2,1,2,3
33462_1,,,,2,1,2,3
33462_2,,,,2,1,2,3
33463_0,,,,2,1,2,3
33463_1,,,,2,1,2,3
33464_0,,,,2,1,2,3
33465_0,,,,2,1,2,3
33465_1,,,,2,1,2,3
33465_2,,,,2,1,2,3
33466_0,,,,2,1,2,3
33466_1,,,,2,1,2,3
33467_0,,,,2,1,2,3
33467_1,,,,2,1,2,3
33467_2,,,,2,1,2,3
33468_0,,,,2,1,2,3
33468_1,,,,2,1,2,3
33469_0,,,,2,1,2,3
33469_1,,,,2,1,2,3
33469_2,,,,2,1,2,3
33470_0,,,,2,1,2,3
33470_1,,,,2,1,2,3
33470_2,,,,2,1,2,3
33471_0,,,,2,1,2,3
33472_0,,,,2,1,2,3
33472_1,,,,2,1,2,3
33472_2,,,,2,1,2,3
33473_0,,,,2,1,2,3
33473_1,,,,2,1,2,3
33473_2,,,,2,1,2,3
33474_0,,,,2,1,2,3
33474_1,,,,2,1,2,3
33474_2,,,,2,1,2,3
33475_0,,,,2,1,2,3
33475_1,,,,2,1,2,3
33475_2,,,,2,1,2,3
33476_0,,,,2,1,2,3
33476_1,,,,2,1,2,3
33476_2,,,,2,1,2,3
33477_0,,,,2,1,2,3
33477_1,,,,2,1,2,3
33478_0,,,,2,1,2,3
33478_1,,,,2,1,2,3
33478_2,,,,2,1,2,3
33479_0,,,,2,1,2,3
33479_1,,,,2,1,2,3
33480_0,,,,2,1,2,3
33480_1,,,,2,1,2,3
33480_2,,,,2,1,2,3
33481_0,,,,2,1,2,3
33482_0,,,,2,1,2,3
33482_1,,,,2,1,2,3
33482_2,,,,2,1,2,3
33483_0,,,,2,1,2,3
33483_1,,,,2,1,2,3
33484_0,,,,2,1,2,3
33484_1,,,,2,1,2,3
33484_2,,,,2,1,2,3
33485_0,,,,2,1,2,3
33485_1,,,,2,1,2,3
33486_0,,,,2,1,2,3
33487_0,,,,2,1,2,3
33487_1,,,,2,1,2,3
33487_2,,,,2,1,2,3
33488_0,,,,2,1,2,3
33489_0,,,,2,1,2,3
33489_1,,,,2,1,2,3
33489_2,,,,2,1,2,3
33490_0,,,,2,1,2,3
33490_1,,,,2,1,2,3
33490_2,,,,2,1,2,3
33491_0,,,,2,1,2,3
33492_0,,,,2,1,2,3
33492_1,,,,2,1,2,3
33492_2,,,,2,1,2,3
33493_0,,,,2,1,2,3
33494_0,,,,2,1,2,3
33494_1,,,,2,1,2,3
33494_2,,,,2,1,2,3
33495_0,,,,2,1,2,3
33495_1,,,,2,1,2,3
33496_0,,,,2,1,2,3
33496_1,,,,2,1,2,3
33496_2,,,,2,1,2,3
33497_0,,,,2,1,2,3
33497_1,,,,2,1,2,3
33498_0,,,,2,1,2,3
33498_1,,,,2,1,2,3
33498_2,,,,2,1,2,3
33499_0,,,,2,1,2,3
33499_1,,,,2,1,2,3
33499_2,,,,2,1,2,3
33500_0,,,,2,1,2,3
33500_1,,,,2,1,2,3
33500_2,,,,2,1,2,3
33501_0,,,,2,1,2,3
33501_1,,,,2,1,2,3
33501_2,,,,2,1,2,3
33502_0,,,,2,1,2,3
33502_1,,,,2,1,2,3
33502_2,,,,2,1,2,3
33503_0,,,,2,1,2,3
33503_1,,,,2,1,2,3
33504_0,,,,2,1,2,3
33504_1,,,,2,1,2,3
33504_2,,,,2,1,2,3
33505_0,,,,2,1,2,3
33505_1,,,,2,1,2,3
33505_2,,,,2,1,2,3
33506_0,,,,2,1,2,3
33506_1,,,,2,1,2,3
33508_0,,,,2,1,2,3
C1(C(C=O)C(CO1)O)=O,,,5,1,5,0,5
33508_1,,,,2,1,2,3
33509_0,,,,2,1,2,3
33509_1,,,,2,1,2,3
33509_2,,,,2,1,2,3
33510_0,,,,2,1,2,3
33510_1,,,,2,1,2,3
33510_2,,,,2,1,2,3
33511_0,,,,2,1,2,3
33512_0,,,,2,1,2,3
33512_1,,,,2,1,2,3
33512_2,,,,2,1,2,3
33513_0,,,,2,1,2,3
33513_1,,,,2,1,2,3
33513_2,,,,2,1,2,3
33514_0,,,,2,1,2,3
33514_1,,,,2,1,2,3
33514_2,,,,2,1,2,3
33515_0,,,,2,1,2,3
33515_1,,,,2,1,2,3
33515_2,,,,2,1,2,3
33516_0,,,,2,1,2,3
33516_1,,,,2,1,2,3
33516_2,,,,2,1,2,3
33517_0,,,,2,1,2,3
33517_1,,,,2,1,2,3
33517_2,,,,2,1,2,3
33518_0,,,,2,1,2,3
33518_1,,,,2,1,2,3
33518_2,,,,2,1,2,3
33519_0,,,,2,1,2,3
33519_1,,,,2,1,2,3
33520_0,,,,2,1,2,3
33520_1,,,,2,1,2,3
33520_2,,,,2,1,2,3
33521_0,,,,2,1,2,3
33521_1,,,,2,1,2,3
33521_2,,,,2,1,2,3
33522_0,,,,2,1,2,3
33522_1,,,,2,1,2,3
33523_0,,,,2,1,2,3
33523_1,,,,2,1,2,3
33523_2,,,,2,1,2,3
33524_0,,,,2,1,2,3
33524_1,,,,2,1,2,3
33524_2,,,,2,1,2,3
33525_0,,,,2,1,2,3
33525_1,,,,2,1,2,3
33525_2,,,,2,1,2,3
33526_0,,,,2,1,2,3
33526_1,,,,2,1,2,3
33526_2,,,,2,1,2,3
33527_0,,,,2,1,2,3
33527_1,,,,2,1,2,3
33527_2,,,,2,1,2,3
33528_0,,,,2,1,2,3
33528_1,,,,2,1,2,3
33528_2,,,,2,1,2,3
33529_0,,,,2,1,2,3
33529_1,,,,2,1,2,3
33529_2,,,,2,1,2,3
33530_0,,,,2,1,2,3
33530_1,,,,2,1,2,3
33530_2,,,,2,1,2,3
33531_0,,,,2,1,2,3
33531_1,,,,2,1,2,3
33531_2,,,,2,1,2,3
33532_0,,,,2,1,2,3
33532_1,,,,2,1,2,3
33532_2,,,,2,1,2,3
33533_0,,,,2,1,2,3
33534_0,,,,2,1,2,3
33534_1,,,,2,1,2,3
33534_2,,,,2,1,2,3
33535_0,,,,2,1,2,3
33536_0,,,,2,1,2,3
33536_1,,,,2,1,2,3
33536_2,,,,2,1,2,3
33537_0,,,,2,1,2,3
33538_0,,,,2,1,2,3
33539_0,,,,2,1,2,3
33539_1,,,,2,1,2,3
33539_2,,,,2,1,2,3
33541_0,,,,2,1,2,3
C(C(C(O)=O)=O)(O)=O,,,5,1,13,0,13
33541_1,,,,2,1,2,3
33542_0,,,,2,1,2,3
33542_1,,,,2,1,2,3
33543_0,,,,2,1,2,3
33543_1,,,,2,1,2,3
33544_0,,,,2,1,2,3
33544_1,,,,2,1,2,3
33545_0,,,,2,1,2,3
33545_1,,,,2,1,2,3
33545_2,,,,2,1,2,3
33546_0,,,,2,1,2,3
33546_1,,,,2,1,2,3
33546_2,,,,2,1,2,3
33548_0,,,,2,1,2,3
C(C(C(O)=O)(C=O)O)(O)=O,,,5,1,4,0,4
33549_0,,,,2,1,2,3
33550_0,,,,2,1,2,3
33551_0,,,,2,1,2,3
33551_1,,,,2,1,2,3
33551_2,,,,2,1,2,3
33552_0,,,,2,1,2,3
33553_0,,,,2,1,2,3
33553_1,,,,2,1,2,3
33553_2,,,,2,1,2,3
33554_0,,,,2,1,2,3
33554_1,,,,2,1,2,3
33554_2,,,,2,1,2,3
33555_0,,,,2,1,2,3
33555_1,,,,2,1,2,3
33555_2,,,,2,1,2,3
33556_0,,,,2,1,2,3
33557_0,,,,2,1,2,3
33557_1,,,,2,1,2,3
33557_2,,,,2,1,2,3
33558_0,,,,2,1,2,3
33558_1,,,,2,1,2,3
33559_0,,,,2,1,2,3
33559_1,,,,2,1,2,3
33560_0,,,,2,1,2,3
33560_1,,,,2,1,2,3
33561_0,,,,2,1,2,3
33562_0,,,,2,1,2,3
33562_1,,,,2,1,2,3
33563_0,,,,2,1,2,3
33563_1,,,,2,1,2,3
33564_0,,,,2,1,2,3
33564_1,,,,2,1,2,3
33565_0,,,,2,1,2,3
33565_1,,,,2,1,2,3
33566_0,,,,2,1,2,3
33566_1,,,,2,1,2,3
33567_0,,,,2,1,2,3
33567_1,,,,2,1,2,3
33568_0,,,,2,1,2,3
33568_1,,,,2,1,2,3
33569_0,,,,2,1,2,3
33569_1,,,,2,1,2,3
33570_0,,,,2,1,2,3
33570_1,,,,2,1,2,3
33571_0,,,,2,1,2,3
33572_0,,,,2,1,2,3
33572_1,,,,2,1,2,3
33572_2,,,,2,1,2,3
33573_0,,,,2,1,2,3
33573_1,,,,2,1,2,3
33574_0,,,,2,1,2,3
33574_1,,,,2,1,2,3
33574_2,,,,2,1,2,3
33575_0,,,,2,1,2,3
33575_1,,,,2,1,2,3
33575_2,,,,2,1,2,3
33576_0,,,,2,1,2,3
33576_1,,,,2,1,2,3
33577_0,,,,2,1,2,3
33577_1,,,,2,1,2,3
33577_2,,,,2,1,2,3
33578_0,,,,2,1,2,3
33579_0,,,,2,1,2,3
33580_0,,,,2,1,2,3
33580_1,,,,2,1,2,3
33580_2,,,,2,1,2,3
33581_0,,,,2,1,2,3
33582_0,,,,2,1,2,3
33584_0,,,,2,1,2,3
C1(C(COC1)=O)=O,,,5,1,19,0,19
33584_1,,,,2,1,2,3
33585_0,,,,2,1,2,3
33585_1,,,,2,1,2,3
33585_2,,,,2,1,2,3
33586_0,,,,2,1,2,3
33586_1,,,,2,1,2,3
33587_0,,,,2,1,2,3
33587_1,,,,2,1,2,3
33587_2,,,,2,1,2,3
33588_0,,,,2,1,2,3
33588_1,,,,2,1,2,3
33588_2,,,,2,1,2,3
33589_0,,,,2,1,2,3
33590_0,,,,2,1,2,3
33590_1,,,,2,1,2,3
33590_2,,,,2,1,2,3
33591_0,,,,2,1,2,3
33591_1,,,,2,1,2,3
33591_2,,,,2,1,2,3
33592_0,,,,2,1,2,3
33592_1,,,,2,1,2,3
33592_2,,,,2,1,2,3
33593_0,,,,2,1,2,3
33593_1,,,,2,1,2,3
33594_0,,,,2,1,2,3
33594_1,,,,2,1,2,3
33594_2,,,,2,1,2,3
33595_0,,,,2,1,2,3
33595_1,,,,2,1,2,3
33595_2,,,,2,1,2,3
33596_0,,,,2,1,2,3
33596_1,,,,2,1,2,3
33596_2,,,,2,1,2,3
33597_0,,,,2,1,2,3
33597_1,,,,2,1,2,3
33598_0,,,,2,1,2,3
33598_1,,,,2,1,2,3
33598_2,,,,2,1,2,3
33599_0,,,,2,1,2,3
33599_1,,,,2,1,2,3
33600_0,,,,2,1,2,3
33600_1,,,,2,1,2,3
33600_2,,,,2,1,2,3
33601_0,,,,2,1,2,3
33602_0,,,,2,1,2,3
33602_1,,,,2,1,2,3
33602_2,,,,2,1,2,3
33603_0,,,,2,1,2,3
33603_1,,,,2,1,2,3
33603_2,,,,2,1,2,3
33604_0,,,,2,1,2,3
33604_1,,,,2,1,2,3
33604_2,,,,2,1,2,3
33605_0,,,,2,1,2,3
33605_1,,,,2,1,2,3
33605_2,,,,2,1,2,3
33606_0,,,,2,1,2,3
33606_1,,,,2,1,2,3
33606_2,,,,2,1,2,3
33607_0,,,,2,1,2,3
33607_1,,,,2,1,2,3
33608_0,,,,2,1,2,3
33608_1,,,,2,1,2,3
33608_2,,,,2,1,2,3
33609_0,,,,2,1,2,3
33609_1,,,,2,1,2,3
33609_2,,,,2,1,2,3
33610_0,,,,2,1,2,3
33610_1,,,,2,1,2,3
33610_2,,,,2,1,2,3
33611_0,,,,2,1,2,3
33611_1,,,,2,1,2,3
33611_2,,,,2,1,2,3
33612_0,,,,2,1,2,3
33612_1,,,,2,1,2,3
33612_2,,,,2,1,2,3
33613_0,,,,2,1,2,3
33613_1,,,,2,1,2,3
33613_2,,,,2,1,2,3
33614_0,,,,2,1,2,3
33614_1,,,,2,1,2,3
33614_2,,,,2,1,2,3
33615_0,,,,2,1,2,3
33616_0,,,,2,1,2,3
33616_1,,,,2,1,2,3
33617_0,,,,2,1,2,3
33617_1,,,,2,1,2,3
33617_2,,,,2,1,2,3
33618_0,,,,2,1,2,3
33618_1,,,,2,1,2,3
33618_2,,,,2,1,2,3
33619_0,,,,2,1,2,3
33619_1,,,,2,1,2,3
33619_2,,,,2,1,2,3
33620_0,,,,2,1,2,3
33620_1,,,,2,1,2,3
33620_2,,,,2,1,2,3
33621_0,,,,2,1,2,3
33621_1,,,,2,1,2,3
33622_0,,,,2,1,2,3
33623_0,,,,2,1,2,3
33623_1,,,,2,1,2,3
33623_2,,,,2,1,2,3
33624_0,,,,2,1,2,3
33624_1,,,,2,1,2,3
33624_2,,,,2,1,2,3
33625_0,,,,2,1,2,3
33625_1,,,,2,1,2,3
33626_0,,,,2,1,2,3
33626_1,,,,2,1,2,3
33627_0,,,,2,1,2,3
33627_1,,,,2,1,2,3
33627_2,,,,2,1,2,3
33628_0,,,,2,1,2,3
33628_1,,,,2,1,2,3
33629_0,,,,2,1,2,3
33629_1,,,,2,1,2,3
33629_2,,,,2,1,2,3
33630_0,,,,2,1,2,3
33630_1,,,,2,1,2,3
33630_2,,,,2,1,2,3
33631_0,,,,2,1,2,3
33631_1,,,,2,1,2,3
33632_0,,,,2,1,2,3
33632_1,,,,2,1,2,3
33633_0,,,,2,1,2,3
33633_1,,,,2,1,2,3
33633_2,,,,2,1,2,3
33634_0,,,,2,1,2,3
33634_1,,,,2,1,2,3
33635_0,,,,2,1,2,3
33635_1,,,,2,1,2,3
33635_2,,,,2,1,2,3
33636_0,,,,2,1,2,3
33636_1,,,,2,1,2,3
33636_2,,,,2,1,2,3
33637_0,,,,2,1,2,3
33637_1,,,,2,1,2,3
33637_2,,,,2,1,2,3
33638_0,,,,2,1,2,3
33638_1,,,,2,1,2,3
33639_0,,,,2,1,2,3
33640_0,,,,2,1,2,3
33640_1,,,,2,1,2,3
33640_2,,,,2,1,2,3
33641_0,,,,2,1,2,3
33641_1,,,,2,1,2,3
33641_2,,,,2,1,2,3
33643_0,,,,2,1,2,3
C1(C(C(O)OC1)=O)=O,,,5,1,8,0,8
33643_1,,,,2,1,2,3
33644_0,,,,2,1,2,3
33644_1,,,,2,1,2,3
33644_2,,,,2,1,2,3
33645_0,,,,2,1,2,3
33645_1,,,,2,1,2,3
33645_2,,,,2,1,2,3
33646_0,,,,2,1,2,3
33646_1,,,,2,1,2,3
33647_0,,,,2,1,2,3
33647_1,,,,2,1,2,3
33647_2,,,,2,1,2,3
33648_0,,,,2,1,2,3
33648_1,,,,2,1,2,3
33649_0,,,,2,1,2,3
33649_1,,,,2,1,2,3
33649_2,,,,2,1,2,3
33650_0,,,,2,1,2,3
33651_0,,,,2,1,2,3
33651_1,,,,2,1,2,3
33651_2,,,,2,1,2,3
33652_0,,,,2,1,2,3
33652_1,,,,2,1,2,3
33652_2,,,,2,1,2,3
33653_0,,,,2,1,2,3
33653_1,,,,2,1,2,3
33653_2,,,,2,1,2,3
33654_0,,,,2,1,2,3
33654_1,,,,2,1,2,3
33654_2,,,,2,1,2,3
33655_0,,,,2,1,2,3
33656_0,,,,2,1,2,3
33657_0,,,,2,1,2,3
33658_0,,,,2,1,2,3
33658_1,,,,2,1,2,3
33658_2,,,,2,1,2,3
33659_0,,,,2,1,2,3
33660_0,,,,2,1,2,3
33660_1,,,,2,1,2,3
33660_2,,,,2,1,2,3
33661_0,,,,2,1,2,3
33662_0,,,,2,1,2,3
33662_1,,,,2,1,2,3
33662_2,,,,2,1,2,3
33663_0,,,,2,1,2,3
33664_0,,,,2,1,2,3
33664_1,,,,2,1,2,3
33665_0,,,,2,1,2,3
33665_1,,,,2,1,2,3
33665_2,,,,2,1,2,3
33666_0,,,,2,1,2,3
33667_0,,,,2,1,2,3
33667_1,,,,2,1,2,3
33667_2,,,,2,1,2,3
33668_0,,,,2,1,2,3
33668_1,,,,2,1,2,3
33668_2,,,,2,1,2,3
33669_0,,,,2,1,2,3
33669_1,,,,2,1,2,3
33669_2,,,,2,1,2,3
33670_0,,,,2,1,2,3
33671_0,,,,2,1,2,3
33671_1,,,,2,1,2,3
33672_0,,,,2,1,2,3
33673_0,,,,2,1,2,3
33673_1,,,,2,1,2,3
33674_0,,,,2,1,2,3
33674_1,,,,2,1,2,3
33675_0,,,,2,1,2,3
33675_1,,,,2,1,2,3
33677_0,,,,2,1,2,3
C1(C(C=O)(C(CO1)O)O)=O,,,5,1,2,0,2
33678_0,,,,2,1,2,3
33678_1,,,,2,1,2,3
33679_0,,,,2,1,2,3
33679_1,,,,2,1,2,3
33679_2,,,,2,1,2,3
33680_0,,,,2,1,2,3
33680_1,,,,2,1,2,3
33680_2,,,,2,1,2,3
33681_0,,,,2,1,2,3
33681_1,,,,2,1,2,3
33681_2,,,,2,1,2,3
33682_0,,,,2,1,2,3
33682_1,,,,2,1,2,3
33682_2,,,,2,1,2,3
33683_0,,,,2,1,2,3
33683_1,,,,2,1,2,3
33683_2,,,,2,1,2,3
33684_0,,,,2,1,2,3
33684_1,,,,2,1,2,3
33684_2,,,,2,1,2,3
33685_0,,,,2,1,2,3
33685_1,,,,2,1,2,3
33685_2,,,,2,1,2,3
33686_0,,,,2,1,2,3
33686_1,,,,2,1,2,3
33686_2,,,,2,1,2,3
33687_0,,,,2,1,2,3
33687_1,,,,2,1,2,3
33688_0,,,,2,1,2,3
33688_1,,,,2,1,2,3
33688_2,,,,2,1,2,3
33689_0,,,,2,1,2,3
33689_1,,,,2,1,2,3
33689_2,,,,2,1,2,3
33690_0,,,,2,1,2,3
33690_1,,,,2,1,2,3
33690_2,,,,2,1,2,3
33691_0,,,,2,1,2,3
33691_1,,,,2,1,2,3
33691_2,,,,2,1,2,3
33692_0,,,,2,1,2,3
33692_1,,,,2,1,2,3
33692_2,,,,2,1,2,3
33694_0,,,,2,1,2,3
C(CO)(C(C(O)O)O)=O,,,5,1,2,0,2
33695_0,,,,2,1,2,3
33695_1,,,,2,1,2,3
33695_2,,,,2,1,2,3
33696_0,,,,2,1,2,3
33696_1,,,,2,1,2,3
33696_2,,,,2,1,2,3
33697_0,,,,2,1,2,3
33697_1,,,,2,1,2,3
33697_2,,,,2,1,2,3
33698_0,,,,2,1,2,3
33698_1,,,,2,1,2,3
33698_2,,,,2,1,2,3
33699_0,,,,2,1,2,3
33699_1,,,,2,1,2,3
33699_2,,,,2,1,2,3
33700_0,,,,2,1,2,3
33700_1,,,,2,1,2,3
33700_2,,,,2,1,2,3
33701_0,,,,2,1,2,3
33701_1,,,,2,1,2,3
33701_2,,,,2,1,2,3
33702_0,,,,2,1,2,3
33702_1,,,,2,1,2,3
33702_2,,,,2,1,2,3
33703_0,,,,2,1,2,3
33703_1,,,,2,1,2,3
33703_2,,,,2,1,2,3
33704_0,,,,2,1,2,3
33705_0,,,,2,1,1,2
33705_1,,,,2,1,1,2
33706_0,,,,2,1,1,2
33706_1,,,,2,1,1,2
33707_0,,,,2,1,1,2
33708_0,,,,2,1,1,2
33708_1,,,,2,1,1,2
33709_0,,,,2,1,1,2
33710_0,,,,2,1,1,2
33710_1,,,,2,1,1,2
33711_0,,,,2,1,1,2
33711_1,,,,2,1,1,2
33712_0,,,,2,1,1,2
33712_1,,,,2,1,1,2
33713_0,,,,2,1,1,2
33713_1,,,,2,1,1,2
33714_0,,,,2,1,1,2
33714_1,,,,2,1,1,2
33715_0,,,,2,1,1,2
33715_1,,,,2,1,1,2
33716_0,,,,2,1,1,2
33717_0,,,,2,1,1,2
33717_1,,,,2,1,1,2
33718_0,,,,2,1,2,3
33719_0,,,,2,1,2,3
33720_0,,,,2,1,2,3
33720_1,,,,2,1,2,3
33721_0,,,,2,1,2,3
33721_1,,,,2,1,2,3
33722_0,,,,2,1,2,3
33724_0,,,,2,1,2,3
C(C(C(CO)(C)O)=O)(O)=O,,,5,1,6,0,6
33725_0,,,,2,1,2,3
33727_0,,,,2,1,2,3
C(C(C(C(O)O)O)=O)(O)=O,,,5,1,2,0,2
33728_0,,,,2,1,2,3
33729_0,,,,2,1,2,3
33729_1,,,,2,1,2,3
33730_0,,,,2,1,2,3
33730_1,,,,2,1,2,3
33731_0,,,,2,1,2,3
33731_1,,,,2,1,2,3
33732_0,,,,2,1,2,3
33732_1,,,,2,1,2,3
33733_0,,,,2,1,2,3
33733_1,,,,2,1,2,3
33734_0,,,,2,1,2,3
33735_0,,,,2,1,2,3
33735_1,,,,2,1,2,3
33736_0,,,,2,1,2,3
33737_0,,,,2,1,2,3
33738_0,,,,2,1,2,3
33739_0,,,,2,1,2,3
33740_0,,,,2,1,2,3
33741_0,,,,2,1,2,3
33741_1,,,,2,1,2,3
33742_0,,,,2,1,2,3
33742_1,,,,2,1,2,3
33743_0,,,,2,1,2,3
33744_0,,,,2,1,2,3
33744_1,,,,2,1,2,3
33745_0,,,,2,1,2,3
33745_1,,,,2,1,2,3
33746_0,,,,2,1,2,3
33747_0,,,,2,1,2,3
33747_1,,,,2,1,2,3
33748_0,,,,2,1,2,3
33749_0,,,,2,1,2,3
33749_1,,,,2,1,2,3
33750_0,,,,2,1,2,3
33751_0,,,,2,1,2,3
33752_0,,,,2,1,2,3
33753_0,,,,2,1,2,3
33753_1,,,,2,1,2,3
33754_0,,,,2,1,2,3
33755_0,,,,2,1,2,3
33755_1,,,,2,1,2,3
33756_0,,,,2,1,2,3
33756_1,,,,2,1,2,3
33757_0,,,,2,1,2,3
33758_0,,,,2,1,2,3
33758_1,,,,2,1,2,3
33759_0,,,,2,1,2,3
33760_0,,,,2,1,2,3
33760_1,,,,2,1,2,3
33761_0,,,,2,1,2,3
33761_1,,,,2,1,2,3
33762_0,,,,2,1,2,3
33763_0,,,,2,1,2,3
33763_1,,,,2,1,2,3
33764_0,,,,2,1,2,3
33764_1,,,,2,1,2,3
33765_0,,,,2,1,2,3
33766_0,,,,2,1,2,3
33766_1,,,,2,1,2,3
33767_0,,,,2,1,2,3
33768_0,,,,2,1,2,3
33769_0,,,,2,1,2,3
33769_1,,,,2,1,2,3
33770_0,,,,2,1,2,3
33771_0,,,,2,1,2,3
33771_1,,,,2,1,2,3
33772_0,,,,2,1,2,3
33773_0,,,,2,1,2,3
33773_1,,,,2,1,2,3
33774_0,,,,2,1,2,3
33774_1,,,,2,1,2,3
33775_0,,,,2,1,2,3
33775_1,,,,2,1,2,3
33776_0,,,,2,1,2,3
33776_1,,,,2,1,2,3
33777_0,,,,2,1,2,3
33778_0,,,,2,1,2,3
33778_1,,,,2,1,2,3
33779_0,,,,2,1,2,3
33780_0,,,,2,1,2,3
33781_0,,,,2,1,2,3
33781_1,,,,2,1,2,3
33782_0,,,,2,1,2,3
33782_1,,,,2,1,2,3
33783_0,,,,2,1,2,3
33783_1,,,,2,1,2,3
33784_0,,,,2,1,2,3
33784_1,,,,2,1,2,3
33786_0,,,,2,1,2,3
[C](C(O)=O)=O,,,5,1,66,0,66
33786_1,,,,2,1,2,3
33787_0,,,,2,1,2,3
33787_1,,,,2,1,2,3
33788_0,,,,2,1,2,3
33788_1,,,,2,1,2,3
33789_0,,,,2,1,2,3
33789_1,,,,2,1,2,3
33790_0,,,,2,1,2,3
33791_0,,,,2,1,2,3
33791_1,,,,2,1,2,3
33792_0,,,,2,1,2,3
33792_1,,,,2,1,2,3
33793_0,,,,2,1,2,3
33794_0,,,,2,1,2,3
33794_1,,,,2,1,2,3
33795_0,,,,2,1,2,3
33796_0,,,,2,1,2,3
33796_1,,,,2,1,2,3
33797_0,,,,2,1,2,3
33798_0,,,,2,1,2,3
33799_0,,,,2,1,2,3
33800_0,,,,2,1,2,3
33800_1,,,,2,1,2,3
33801_0,,,,2,1,2,3
33802_0,,,,2,1,2,3
33802_1,,,,2,1,2,3
33803_0,,,,2,1,2,3
33804_0,,,,2,1,2,3
33805_0,,,,2,1,2,3
33805_1,,,,2,1,2,3
33806_0,,,,2,1,2,3
33806_1,,,,2,1,2,3
33808_0,,,,2,1,2,3
C(C(C=O)(O)O)=O,,,5,1,17,0,17
33808_1,,,,2,1,2,3
33809_0,,,,2,1,2,3
33809_1,,,,2,1,2,3
33810_0,,,,2,1,2,3
33810_1,,,,2,1,2,3
33811_0,,,,2,1,2,3
33811_1,,,,2,1,2,3
33812_0,,,,2,1,2,3
33812_1,,,,2,1,2,3
33814_0,,,,2,1,2,3
C([C](C(O)=O)O)=O,,,5,1,17,0,17
33814_1,,,,2,1,2,3
33815_0,,,,2,1,2,3
33815_1,,,,2,1,2,3
33816_0,,,,2,1,2,3
33816_1,,,,2,1,2,3
33817_0,,,,2,1,2,3
33818_0,,,,2,1,2,3
33818_1,,,,2,1,2,3
33819_0,,,,2,1,2,3
33819_1,,,,2,1,2,3
33820_0,,,,2,1,2,3
33820_1,,,,2,1,2,3
33821_0,,,,2,1,2,3
33821_1,,,,2,1,2,3
33822_0,,,,2,1,2,3
33822_1,,,,2,1,2,3
33823_0,,,,2,1,2,3
33823_1,,,,2,1,2,3
33824_0,,,,2,1,2,3
33824_1,,,,2,1,2,3
33825_0,,,,2,1,2,3
33825_1,,,,2,1,2,3
33826_0,,,,2,1,2,3
33826_1,,,,2,1,2,3
33827_0,,,,2,1,2,3
33828_0,,,,2,1,2,3
33829_0,,,,2,1,2,3
33830_0,,,,2,1,2,3
33831_0,,,,2,1,2,3
33831_1,,,,2,1,2,3
33832_0,,,,2,1,2,3
33833_0,,,,2,1,2,3
33834_0,,,,2,1,2,3
33834_1,,,,2,1,2,3
33835_0,,,,2,1,2,3
33836_0,,,,2,1,2,3
33837_0,,,,2,1,2,3
33838_0,,,,2,1,2,3
33839_0,,,,2,1,2,3
33839_1,,,,2,1,2,3
33840_0,,,,2,1,2,3
33840_1,,,,2,1,2,3
33841_0,,,,2,1,2,3
33842_0,,,,2,1,2,3
33842_1,,,,2,1,2,3
33843_0,,,,2,1,2,3
33843_1,,,,2,1,2,3
33845_0,,,,2,1,2,3
C(C)(C(CC(C)O)O)=O,,,5,1,1,0,1
33846_0,,,,2,1,2,3
33846_1,,,,2,1,2,3
33847_0,,,,2,1,2,3
33847_1,,,,2,1,2,3
33848_0,,,,2,1,2,3
33848_1,,,,2,1,2,3
33849_0,,,,2,1,2,3
33849_1,,,,2,1,2,3
33850_0,,,,2,1,2,3
33850_1,,,,2,1,2,3
33851_0,,,,2,1,2,3
33851_1,,,,2,1,2,3
33852_0,,,,2,1,2,3
33853_0,,,,2,1,2,3
33853_1,,,,2,1,2,3
33854_0,,,,2,1,2,3
33854_1,,,,2,1,2,3
33855_0,,,,2,1,2,3
33856_0,,,,2,1,2,3
33857_0,,,,2,1,2,3
33857_1,,,,2,1,2,3
33858_0,,,,2,1,2,3
33858_1,,,,2,1,2,3
33859_0,,,,2,1,2,3
33860_0,,,,2,1,2,3
33860_1,,,,2,1,2,3
33861_0,,,,2,1,2,3
33862_0,,,,2,1,2,3
33862_1,,,,2,1,2,3
33863_0,,,,2,1,2,3
33864_0,,,,2,1,2,3
33865_0,,,,2,1,2,3
33865_1,,,,2,1,2,3
33866_0,,,,2,1,2,3
33866_1,,,,2,1,2,3
33867_0,,,,2,1,2,3
33867_1,,,,2,1,2,3
33868_0,,,,2,1,2,3
33868_1,,,,2,1,2,3
33869_0,,,,2,1,2,3
33869_1,,,,2,1,2,3
33870_0,,,,2,1,2,3
33870_1,,,,2,1,2,3
33871_0,,,,2,1,2,3
33871_1,,,,2,1,2,3
33872_0,,,,2,1,2,3
33872_1,,,,2,1,2,3
33873_0,,,,2,1,2,3
33873_1,,,,2,1,2,3
33874_0,,,,2,1,2,3
33874_1,,,,2,1,2,3
33875_0,,,,2,1,2,3
33876_0,,,,2,1,2,3
33876_1,,,,2,1,2,3
33877_0,,,,2,1,2,3
33877_1,,,,2,1,2,3
33878_0,,,,2,1,2,3
33879_0,,,,2,1,2,3
33879_1,,,,2,1,2,3
33880_0,,,,2,1,2,3
33881_0,,,,2,1,2,3
33881_1,,,,2,1,2,3
33882_0,,,,2,1,2,3
33883_0,,,,2,1,2,3
33883_1,,,,2,1,2,3
33884_0,,,,2,1,2,3
33884_1,,,,2,1,2,3
33885_0,,,,2,1,2,3
33885_1,,,,2,1,2,3
33886_0,,,,2,1,2,3
33886_1,,,,2,1,2,3
33887_0,,,,2,1,2,3
33887_1,,,,2,1,2,3
33888_0,,,,2,1,2,3
33888_1,,,,2,1,2,3
33889_0,,,,2,1,2,3
33889_1,,,,2,1,2,3
33889_2,,,,2,1,2,3
33890_0,,,,2,1,2,3
33890_1,,,,2,1,2,3
33890_2,,,,2,1,2,3
33891_0,,,,2,1,2,3
33891_1,,,,2,1,2,3
33892_0,,,,2,1,2,3
33892_1,,,,2,1,2,3
33892_2,,,,2,1,2,3
33893_0,,,,2,1,2,3
33893_1,,,,2,1,2,3
33893_2,,,,2,1,2,3
33894_0,,,,2,1,2,3
33894_1,,,,2,1,2,3
33896_0,,,,2,1,2,3
C(C(C(CO)=O)(O)O)=O,,,5,1,5,0,5
33896_1,,,,2,1,2,3
33898_0,,,,2,1,2,3
C([C](C(CO)=O)O)(O)=O,,,5,1,6,0,6
33898_1,,,,2,1,2,3
33899_0,,,,2,1,2,3
33899_1,,,,2,1,2,3
33900_0,,,,2,1,2,3
33900_1,,,,2,1,2,3
33901_0,,,,2,1,2,3
33901_1,,,,2,1,2,3
33902_0,,,,2,1,2,3
33902_1,,,,2,1,2,3
33903_0,,,,2,1,2,3
33903_1,,,,2,1,2,3
33903_2,,,,2,1,2,3
33904_0,,,,2,1,2,3
33904_1,,,,2,1,2,3
33904_2,,,,2,1,2,3
33905_0,,,,2,1,2,3
33905_1,,,,2,1,2,3
33905_2,,,,2,1,2,3
33906_0,,,,2,1,2,3
33906_1,,,,2,1,2,3
33906_2,,,,2,1,2,3
33907_0,,,,2,1,2,3
33907_1,,,,2,1,2,3
33908_0,,,,2,1,2,3
33908_1,,,,2,1,2,3
33909_0,,,,2,1,2,3
33909_1,,,,2,1,2,3
33910_0,,,,2,1,2,3
33910_1,,,,2,1,2,3
33911_0,,,,2,1,2,3
33911_1,,,,2,1,2,3
33912_0,,,,2,1,2,3
33912_1,,,,2,1,2,3
33913_0,,,,2,1,2,3
33914_0,,,,2,1,2,3
33914_1,,,,2,1,2,3
33916_0,,,,2,1,2,3
C(C)(C(CO)(C)O)=O,,,5,1,1,0,1
33917_0,,,,2,1,2,3
33917_1,,,,2,1,2,3
33918_0,,,,2,1,2,3
33919_0,,,,2,1,2,3
33919_1,,,,2,1,2,3
33920_0,,,,2,1,2,3
33921_0,,,,2,1,2,3
33921_1,,,,2,1,2,3
33922_0,,,,2,1,2,3
33922_1,,,,2,1,2,3
33923_0,,,,2,1,2,3
33924_0,,,,2,1,2,3
33924_1,,,,2,1,2,3
33925_0,,,,2,1,2,3
33925_1,,,,2,1,2,3
33927_0,,,,2,1,2,3
C(C)(C(C(C=C)=O)O)=O,,,5,1,1,0,1
33928_0,,,,2,1,2,3
33928_1,,,,2,1,2,3
33929_0,,,,2,1,2,3
33930_0,,,,2,1,2,3
33930_1,,,,2,1,2,3
33932_0,,,,2,1,2,3
C(C)(C(C(O)O)O)=O,,,5,1,1,0,1
33933_0,,,,2,1,2,3
33933_1,,,,2,1,2,3
33934_0,,,,2,1,2,3
33935_0,,,,2,1,2,3
33935_1,,,,2,1,2,3
33936_0,,,,2,1,2,3
33937_0,,,,2,1,2,3
33937_1,,,,2,1,2,3
33938_0,,,,2,1,2,3
33939_0,,,,2,1,2,3
33939_1,,,,2,1,2,3
33940_0,,,,2,1,2,3
33941_0,,,,2,1,2,3
33941_1,,,,2,1,2,3
33942_0,,,,2,1,2,3
33942_1,,,,2,1,2,3
33944_0,,,,2,1,2,3
C(C(C(C)=O)(C)O)=O,,,5,1,5,0,5
33945_0,,,,2,1,2,3
33945_1,,,,2,1,2,3
33946_0,,,,2,1,2,3
33947_0,,,,2,1,2,3
33948_0,,,,2,1,2,3
33948_1,,,,2,1,2,3
33949_0,,,,2,1,2,3
33950_0,,,,2,1,2,3
33950_1,,,,2,1,2,3
33951_0,,,,2,1,2,3
33952_0,,,,2,1,2,3
33952_1,,,,2,1,2,3
33953_0,,,,2,1,2,3
33954_0,,,,2,1,2,3
33954_1,,,,2,1,2,3
33955_0,,,,2,1,2,3
33955_1,,,,2,1,2,3
33956_0,,,,2,1,2,3
33956_1,,,,2,1,2,3
33956_2,,,,2,1,2,3
33957_0,,,,2,1,2,3
33957_1,,,,2,1,2,3
33957_2,,,,2,1,2,3
33958_0,,,,2,1,2,3
33958_1,,,,2,1,2,3
33958_2,,,,2,1,2,3
33959_0,,,,2,1,2,3
33959_1,,,,2,1,2,3
33959_2,,,,2,1,2,3
33960_0,,,,2,1,2,3
33960_1,,,,2,1,2,3
33961_0,,,,2,1,2,3
33961_1,,,,2,1,2,3
33962_0,,,,2,1,2,3
33962_1,,,,2,1,2,3
33963_0,,,,2,1,2,3
33963_1,,,,2,1,2,3
33964_0,,,,2,1,2,3
33964_1,,,,2,1,2,3
33965_0,,,,2,1,2,3
33965_1,,,,2,1,2,3
33967_0,,,,2,1,2,3
C(C1(C(CCO1)=O)O)=O,,,5,1,5,0,5
33967_1,,,,2,1,2,3
33969_0,,,,2,1,2,3
C(C(C=O)(C=C)O)(O)=O,,,5,1,6,0,6
33969_1,,,,2,1,2,3
33971_0,,,,2,1,2,3
C1(C(C=O)(CCO1)O)=O,,,5,1,4,0,4
33971_1,,,,2,1,2,3
33972_0,,,,2,1,2,3
33972_1,,,,2,1,2,3
33973_0,,,,2,1,2,3
33973_1,,,,2,1,2,3
33974_0,,,,2,1,2,3
33974_1,,,,2,1,2,3
33975_0,,,,2,1,2,3
33975_1,,,,2,1,2,3
33976_0,,,,2,1,2,3
33976_1,,,,2,1,2,3
33977_0,,,,2,1,2,3
33977_1,,,,2,1,2,3
33978_0,,,,2,1,2,3
33978_1,,,,2,1,2,3
33979_0,,,,2,1,2,3
33979_1,,,,2,1,2,3
33980_0,,,,2,1,2,3
33980_1,,,,2,1,2,3
33981_0,,,,2,1,2,3
33981_1,,,,2,1,2,3
33982_0,,,,2,1,2,3
33982_1,,,,2,1,2,3
33983_0,,,,2,1,2,3
33983_1,,,,2,1,2,3
33984_0,,,,2,1,2,3
33984_1,,,,2,1,2,3
33985_0,,,,2,1,2,3
33985_1,,,,2,1,2,3
33986_0,,,,2,1,2,3
33986_1,,,,2,1,2,3
33987_0,,,,2,1,2,3
33987_1,,,,2,1,2,3
33988_0,,,,2,1,2,3
33988_1,,,,2,1,2,3
33989_0,,,,2,1,2,3
33989_1,,,,2,1,2,3
33990_0,,,,2,1,2,3
33990_1,,,,2,1,2,3
33991_0,,,,2,1,2,3
33991_1,,,,2,1,2,3
33992_0,,,,2,1,2,3
33992_1,,,,2,1,2,3
33993_0,,,,2,1,2,3
33993_1,,,,2,1,2,3
33994_0,,,,2,1,2,3
33994_1,,,,2,1,2,3
33995_0,,,,2,1,2,3
33995_1,,,,2,1,2,3
33996_0,,,,2,1,2,3
33996_1,,,,2,1,2,3
33997_0,,,,2,1,2,3
33997_1,,,,2,1,2,3
33998_0,,,,2,1,2,3
33998_1,,,,2,1,2,3
33999_0,,,,2,1,2,3
33999_1,,,,2,1,2,3
34000_0,,,,2,1,2,3
34000_1,,,,2,1,2,3
34001_0,,,,2,1,2,3
34002_0,,,,2,1,2,3
34002_1,,,,2,1,2,3
34003_0,,,,2,1,2,3
34003_1,,,,2,1,2,3
34004_0,,,,2,1,2,3
34004_1,,,,2,1,2,3
34005_0,,,,2,1,2,3
34005_1,,,,2,1,2,3
34006_0,,,,2,1,2,3
34006_1,,,,2,1,2,3
34007_0,,,,2,1,2,3
34007_1,,,,2,1,2,3
34008_0,,,,2,1,2,3
34008_1,,,,2,1,2,3
34009_0,,,,2,1,2,3
34009_1,,,,2,1,2,3
34010_0,,,,2,1,2,3
34010_1,,,,2,1,2,3
34011_0,,,,2,1,2,3
34012_0,,,,2,1,2,3
34013_0,,,,2,1,2,3
34013_1,,,,2,1,2,3
34014_0,,,,2,1,2,3
34014_1,,,,2,1,2,3
34015_0,,,,2,1,2,3
34016_0,,,,2,1,2,3
34016_1,,,,2,1,2,3
34017_0,,,,2,1,2,3
34018_0,,,,2,1,2,3
34018_1,,,,2,1,2,3
34019_0,,,,2,1,2,3
34019_1,,,,2,1,2,3
34020_0,,,,2,1,2,3
34020_1,,,,2,1,2,3
34021_0,,,,2,1,2,3
34021_1,,,,2,1,2,3
34022_0,,,,2,1,2,3
34023_0,,,,2,1,2,3
34023_1,,,,2,1,2,3
34024_0,,,,2,1,2,3
34025_0,,,,2,1,2,3
34026_0,,,,2,1,2,3
34027_0,,,,2,1,2,3
34028_0,,,,2,1,2,3
34029_0,,,,2,1,2,3
34030_0,,,,2,1,2,3
34030_1,,,,2,1,2,3
34031_0,,,,2,1,2,3
34031_1,,,,2,1,2,3
34032_0,,,,2,1,2,3
34032_1,,,,2,1,2,3
34033_0,,,,2,1,2,3
34033_1,,,,2,1,2,3
34034_0,,,,2,1,2,3
34034_1,,,,2,1,2,3
34035_0,,,,2,1,2,3
34035_1,,,,2,1,2,3
34036_0,,,,2,1,2,3
34036_1,,,,2,1,2,3
34037_0,,,,2,1,2,3
34037_1,,,,2,1,2,3
34038_0,,,,2,1,2,3
34038_1,,,,2,1,2,3
34039_0,,,,2,1,2,3
34040_0,,,,2,1,2,3
34040_1,,,,2,1,2,3
34041_0,,,,2,1,2,3
34042_0,,,,2,1,2,3
34043_0,,,,2,1,2,3
34044_0,,,,2,1,2,3
34044_1,,,,2,1,2,3
34046_0,,,,2,1,2,3
C(C(C(C(O)=O)=O)(O)O)=O,,,5,1,2,0,2
34048_0,,,,2,1,2,3
C(C([C](C(O)=O)O)=O)(O)=O,,,5,1,2,0,2
34049_0,,,,2,1,2,3
34049_1,,,,2,1,2,3
34050_0,,,,2,1,2,3
34050_1,,,,2,1,2,3
34051_0,,,,2,1,2,3
34051_1,,,,2,1,2,3
34052_0,,,,2,1,2,3
34052_1,,,,2,1,2,3
34053_0,,,,2,1,2,3
34053_1,,,,2,1,2,3
34054_0,,,,2,1,2,3
34054_1,,,,2,1,2,3
34055_0,,,,2,1,2,3
34055_1,,,,2,1,2,3
34056_0,,,,2,1,2,3
34057_0,,,,2,1,2,3
34057_1,,,,2,1,2,3
34058_0,,,,2,1,2,3
34058_1,,,,2,1,2,3
34059_0,,,,2,1,2,3
34059_1,,,,2,1,2,3
34060_0,,,,2,1,2,3
34060_1,,,,2,1,2,3
34061_0,,,,2,1,2,3
34061_1,,,,2,1,2,3
34062_0,,,,2,1,2,3
34062_1,,,,2,1,2,3
34063_0,,,,2,1,2,3
34063_1,,,,2,1,2,3
34064_0,,,,2,1,2,3
34064_1,,,,2,1,2,3
34065_0,,,,2,1,2,3
34065_1,,,,2,1,2,3
34066_0,,,,2,1,2,3
34066_1,,,,2,1,2,3
34067_0,,,,2,1,2,3
34067_1,,,,2,1,2,3
34068_0,,,,2,1,2,3
34069_0,,,,2,1,2,3
34069_1,,,,2,1,2,3
34070_0,,,,2,1,2,3
34070_1,,,,2,1,2,3
34071_0,,,,2,1,2,3
34071_1,,,,2,1,2,3
34071_2,,,,2,1,2,3
34072_0,,,,2,1,2,3
34072_1,,,,2,1,2,3
34072_2,,,,2,1,2,3
34073_0,,,,2,1,2,3
34073_1,,,,2,1,2,3
34074_0,,,,2,1,2,3
34074_1,,,,2,1,2,3
34075_0,,,,2,1,2,3
34075_1,,,,2,1,2,3
34076_0,,,,2,1,2,3
34076_1,,,,2,1,2,3
34077_0,,,,2,1,2,3
34077_1,,,,2,1,2,3
34078_0,,,,2,1,2,3
34078_1,,,,2,1,2,3
34079_0,,,,2,1,2,3
34079_1,,,,2,1,2,3
34080_0,,,,2,1,2,3
34080_1,,,,2,1,2,3
34081_0,,,,2,1,2,3
34081_1,,,,2,1,2,3
34082_0,,,,2,1,2,3
34082_1,,,,2,1,2,3
34083_0,,,,2,1,2,3
34083_1,,,,2,1,2,3
34083_2,,,,2,1,2,3
34084_0,,,,2,1,2,3
34084_1,,,,2,1,2,3
34084_2,,,,2,1,2,3
34085_0,,,,2,1,2,3
34085_1,,,,2,1,2,3
34086_0,,,,2,1,2,3
34086_1,,,,2,1,2,3
34087_0,,,,2,1,2,3
34088_0,,,,2,1,2,3
34088_1,,,,2,1,2,3
34089_0,,,,2,1,2,3
34090_0,,,,2,1,2,3
34090_1,,,,2,1,2,3
34091_0,,,,2,1,2,3
34091_1,,,,2,1,2,3
34093_0,,,,2,1,2,3
C(C(C(C)=O)(O)O)=O,,,5,1,5,0,5
34094_0,,,,2,1,2,3
34094_1,,,,2,1,2,3
34096_0,,,,2,1,2,3
C([C](C(C)=O)O)(O)=O,,,5,1,6,0,6
34097_0,,,,2,1,2,3
34097_1,,,,2,1,2,3
34098_0,,,,2,1,2,3
34098_1,,,,2,1,2,3
34099_0,,,,2,1,2,3
34099_1,,,,2,1,2,3
34100_0,,,,2,1,2,3
34100_1,,,,2,1,2,3
34101_0,,,,2,1,2,3
34101_1,,,,2,1,2,3
34102_0,,,,2,1,2,3
34102_1,,,,2,1,2,3
34103_0,,,,2,1,2,3
34103_1,,,,2,1,2,3
34104_0,,,,2,1,2,3
34104_1,,,,2,1,2,3
34105_0,,,,2,1,2,3
34105_1,,,,2,1,2,3
34106_0,,,,2,1,2,3
34107_0,,,,2,1,2,3
34107_1,,,,2,1,2,3
34108_0,,,,2,1,2,3
34108_1,,,,2,1,2,3
34109_0,,,,2,1,2,3
34109_1,,,,2,1,2,3
34110_0,,,,2,1,2,3
34110_1,,,,2,1,2,3
34111_0,,,,2,1,2,3
34111_1,,,,2,1,2,3
34112_0,,,,2,1,2,3
34112_1,,,,2,1,2,3
34113_0,,,,2,1,2,3
34113_1,,,,2,1,2,3
34114_0,,,,2,1,2,3
34114_1,,,,2,1,2,3
34115_0,,,,2,1,2,3
34115_1,,,,2,1,2,3
34116_0,,,,2,1,2,3
34116_1,,,,2,1,2,3
34117_0,,,,2,1,2,3
34117_1,,,,2,1,2,3
34118_0,,,,2,1,2,3
34119_0,,,,2,1,2,3
34119_1,,,,2,1,2,3
34120_0,,,,2,1,2,3
34120_1,,,,2,1,2,3
34121_0,,,,2,1,2,3
34121_1,,,,2,1,2,3
34122_0,,,,2,1,2,3
34122_1,,,,2,1,2,3
34123_0,,,,2,1,2,3
34123_1,,,,2,1,2,3
34124_0,,,,2,1,2,3
34125_0,,,,2,1,2,3
34125_1,,,,2,1,2,3
34126_0,,,,2,1,2,3
34126_1,,,,2,1,2,3
34127_0,,,,2,1,2,3
34127_1,,,,2,1,2,3
34128_0,,,,2,1,2,3
34129_0,,,,2,1,2,3
34129_1,,,,2,1,2,3
34129_2,,,,2,1,2,3
34130_0,,,,2,1,2,3
34130_1,,,,2,1,2,3
34130_2,,,,2,1,2,3
34131_0,,,,2,1,2,3
34131_1,,,,2,1,2,3
34132_0,,,,2,1,2,3
34133_0,,,,2,1,2,3
34133_1,,,,2,1,2,3
34134_0,,,,2,1,2,3
34134_1,,,,2,1,2,3
34135_0,,,,2,1,2,3
34135_1,,,,2,1,2,3
34136_0,,,,2,1,2,3
34136_1,,,,2,1,2,3
34137_0,,,,2,1,2,3
34137_1,,,,2,1,2,3
34138_0,,,,2,1,2,3
34138_1,,,,2,1,2,3
34139_0,,,,2,1,2,3
34139_1,,,,2,1,2,3
34140_0,,,,2,1,2,3
34140_1,,,,2,1,2,3
34141_0,,,,2,1,2,3
34141_1,,,,2,1,2,3
34143_0,,,,2,1,2,3
C(C1(C(C(CO1)O)=O)O)=O,,,5,1,1,0,1
34144_0,,,,2,1,2,3
34144_1,,,,2,1,2,3
34145_0,,,,2,1,2,3
34145_1,,,,2,1,2,3
34146_0,,,,2,1,2,3
34146_1,,,,2,1,2,3
34147_0,,,,2,1,2,3
34147_1,,,,2,1,2,3
34148_0,,,,2,1,2,3
34148_1,,,,2,1,2,3
34149_0,,,,2,1,2,3
34149_1,,,,2,1,2,3
34150_0,,,,2,1,2,3
34151_0,,,,2,1,2,3
34152_0,,,,2,1,2,3
34153_0,,,,2,1,2,3
34153_1,,,,2,1,2,3
34154_0,,,,2,1,2,3
34154_1,,,,2,1,2,3
34155_0,,,,2,1,2,3
34155_1,,,,2,1,2,3
34156_0,,,,2,1,2,3
34157_0,,,,2,1,2,3
34157_1,,,,2,1,2,3
34157_2,,,,2,1,2,3
34158_0,,,,2,1,2,3
34158_1,,,,2,1,2,3
34158_2,,,,2,1,2,3
34159_0,,,,2,1,2,3
34159_1,,,,2,1,2,3
34160_0,,,,2,1,2,3
34160_1,,,,2,1,2,3
34161_0,,,,2,1,2,3
34161_1,,,,2,1,2,3
34162_0,,,,2,1,2,3
34162_1,,,,2,1,2,3
34163_0,,,,2,1,2,3
34163_1,,,,2,1,2,3
34164_0,,,,2,1,2,3
34164_1,,,,2,1,2,3
34165_0,,,,2,1,2,3
34165_1,,,,2,1,2,3
34166_0,,,,2,1,2,3
34166_1,,,,2,1,2,3
34167_0,,,,2,1,2,3
34167_1,,,,2,1,2,3
34168_0,,,,2,1,2,3
34168_1,,,,2,1,2,3
34169_0,,,,2,1,2,3
34169_1,,,,2,1,2,3
34170_0,,,,2,1,2,3
34170_1,,,,2,1,2,3
34171_0,,,,2,1,2,3
34171_1,,,,2,1,2,3
34172_0,,,,2,1,2,3
34172_1,,,,2,1,2,3
34173_0,,,,2,1,2,3
34173_1,,,,2,1,2,3
34174_0,,,,2,1,2,3
34174_1,,,,2,1,2,3
34175_0,,,,2,1,2,3
34175_1,,,,2,1,2,3
34176_0,,,,2,1,2,3
34176_1,,,,2,1,2,3
34177_0,,,,2,1,2,3
34178_0,,,,2,1,2,3
34178_1,,,,2,1,2,3
34179_0,,,,2,1,2,3
34179_1,,,,2,1,2,3
34180_0,,,,2,1,2,3
34180_1,,,,2,1,2,3
34181_0,,,,2,1,2,3
34181_1,,,,2,1,2,3
34182_0,,,,2,1,2,3
34183_0,,,,2,1,2,3
34183_1,,,,2,1,2,3
34184_0,,,,2,1,2,3
34185_0,,,,2,1,2,3
34185_1,,,,2,1,2,3
34186_0,,,,2,1,2,3
34186_1,,,,2,1,2,3
34187_0,,,,2,1,2,3
34188_0,,,,2,1,2,3
34188_1,,,,2,1,2,3
34189_0,,,,2,1,2,3
34190_0,,,,2,1,2,3
34190_1,,,,2,1,2,3
34191_0,,,,2,1,2,3
34191_1,,,,2,1,2,3
34192_0,,,,2,1,2,3
34192_1,,,,2,1,2,3
34193_0,,,,2,1,2,3
34193_1,,,,2,1,2,3
34194_0,,,,2,1,2,3
34194_1,,,,2,1,2,3
34195_0,,,,2,1,2,3
34195_1,,,,2,1,2,3
34196_0,,,,2,1,2,3
34196_1,,,,2,1,2,3
34196_2,,,,2,1,2,3
34197_0,,,,2,1,2,3
34197_1,,,,2,1,2,3
34197_2,,,,2,1,2,3
34198_0,,,,2,1,2,3
34198_1,,,,2,1,2,3
34199_0,,,,2,1,2,3
34199_1,,,,2,1,2,3
34200_0,,,,2,1,2,3
34200_1,,,,2,1,2,3
34201_0,,,,2,1,2,3
34201_1,,,,2,1,2,3
34201_2,,,,2,1,2,3
34202_0,,,,2,1,2,3
34202_1,,,,2,1,2,3
34202_2,,,,2,1,2,3
34203_0,,,,2,1,2,3
34203_1,,,,2,1,2,3
34204_0,,,,2,1,2,3
34204_1,,,,2,1,2,3
34205_0,,,,2,1,2,3
34205_1,,,,2,1,2,3
34206_0,,,,2,1,2,3
34206_1,,,,2,1,2,3
34207_0,,,,2,1,2,3
34207_1,,,,2,1,2,3
34208_0,,,,2,1,2,3
34208_1,,,,2,1,2,3
34209_0,,,,2,1,2,3
34209_1,,,,2,1,2,3
34210_0,,,,2,1,2,3
34210_1,,,,2,1,2,3
34211_0,,,,2,1,2,3
34212_0,,,,2,1,2,3
34212_1,,,,2,1,2,3
34213_0,,,,2,1,2,3
34213_1,,,,2,1,2,3
34214_0,,,,2,1,2,3
34214_1,,,,2,1,2,3
34215_0,,,,2,1,2,3
34215_1,,,,2,1,2,3
34216_0,,,,2,1,2,3
34216_1,,,,2,1,2,3
34217_0,,,,2,1,2,3
34218_0,,,,2,1,2,3
34218_1,,,,2,1,2,3
34219_0,,,,2,1,2,3
34219_1,,,,2,1,2,3
34220_0,,,,2,1,2,3
34221_0,,,,2,1,2,3
34221_1,,,,2,1,2,3
34222_0,,,,2,1,2,3
34222_1,,,,2,1,2,3
34223_0,,,,2,1,2,3
34223_1,,,,2,1,2,3
34224_0,,,,2,1,2,3
34224_1,,,,2,1,2,3
34225_0,,,,2,1,2,3
34225_1,,,,2,1,2,3
34226_0,,,,2,1,2,3
34226_1,,,,2,1,2,3
34227_0,,,,2,1,2,3
34227_1,,,,2,1,2,3
34228_0,,,,2,1,2,3
34228_1,,,,2,1,2,3
34229_0,,,,2,1,2,3
34229_1,,,,2,1,2,3
34230_0,,,,2,1,2,3
34230_1,,,,2,1,2,3
34231_0,,,,2,1,2,3
34231_1,,,,2,1,2,3
34232_0,,,,2,1,2,3
34233_0,,,,2,1,2,3
34233_1,,,,2,1,2,3
34234_0,,,,2,1,2,3
34234_1,,,,2,1,2,3
34235_0,,,,2,1,2,3
34236_0,,,,2,1,2,3
34237_0,,,,2,1,2,3
34238_0,,,,2,1,2,3
34239_0,,,,2,1,2,3
34239_1,,,,2,1,2,3
34240_0,,,,2,1,2,3
34240_1,,,,2,1,2,3
34241_0,,,,2,1,2,3
34241_1,,,,2,1,2,3
34241_2,,,,2,1,2,3
34242_0,,,,2,1,2,3
34242_1,,,,2,1,2,3
34242_2,,,,2,1,2,3
34243_0,,,,2,1,2,3
34243_1,,,,2,1,2,3
34244_0,,,,2,1,2,3
34244_1,,,,2,1,2,3
34244_2,,,,2,1,2,3
34245_0,,,,2,1,2,3
34245_1,,,,2,1,2,3
34245_2,,,,2,1,2,3
34246_0,,,,2,1,2,3
34246_1,,,,2,1,2,3
34247_0,,,,2,1,2,3
34247_1,,,,2,1,2,3
34248_0,,,,2,1,2,3
34248_1,,,,2,1,2,3
34249_0,,,,2,1,2,3
34249_1,,,,2,1,2,3
34250_0,,,,2,1,2,3
34250_1,,,,2,1,2,3
34251_0,,,,2,1,2,3
34251_1,,,,2,1,2,3
34252_0,,,,2,1,2,3
34253_0,,,,2,1,2,3
34254_0,,,,2,1,2,3
34255_0,,,,2,1,2,3
34256_0,,,,2,1,2,3
34257_0,,,,2,1,2,3
34257_1,,,,2,1,2,3
34258_0,,,,2,1,2,3
34259_0,,,,2,1,2,3
34260_0,,,,2,1,2,3
34261_0,,,,2,1,2,3
34262_0,,,,2,1,2,3
34263_0,,,,2,1,2,3
34264_0,,,,2,1,2,3
34265_0,,,,2,1,2,3
34265_1,,,,2,1,2,3
34266_0,,,,2,1,2,3
34267_0,,,,2,1,2,3
34268_0,,,,2,1,2,3
34268_1,,,,2,1,2,3
34269_0,,,,2,1,2,3
34270_0,,,,2,1,2,3
34270_1,,,,2,1,2,3
34271_0,,,,2,1,2,3
34271_1,,,,2,1,2,3
34272_0,,,,2,1,2,3
34273_0,,,,2,1,2,3
34274_0,,,,2,1,2,3
34275_0,,,,2,1,2,3
34276_0,,,,2,1,2,3
34277_0,,,,2,1,2,3
34278_0,,,,2,1,2,3
34279_0,,,,2,1,2,3
34280_0,,,,2,1,2,3
34281_0,,,,2,1,2,3
34282_0,,,,2,1,2,3
34283_0,,,,2,1,2,3
34284_0,,,,2,1,2,3
34285_0,,,,2,1,2,3
34286_0,,,,2,1,2,3
34287_0,,,,2,1,2,3
34288_0,,,,2,1,2,3
34289_0,,,,2,1,2,3
34290_0,,,,2,1,2,3
34291_0,,,,2,1,2,3
34292_0,,,,2,1,2,3
34292_1,,,,2,1,2,3
34293_0,,,,2,1,2,3
34294_0,,,,2,1,2,3
34295_0,,,,2,1,2,3
34296_0,,,,2,1,2,3
34297_0,,,,2,1,2,3
34298_0,,,,2,1,2,3
34299_0,,,,2,1,2,3
34300_0,,,,2,1,2,3
34301_0,,,,2,1,2,3
34302_0,,,,2,1,2,3
34302_1,,,,2,1,2,3
34303_0,,,,2,1,2,3
34303_1,,,,2,1,2,3
34304_0,,,,2,1,2,3
34305_0,,,,2,1,2,3
34305_1,,,,2,1,2,3
34306_0,,,,2,1,2,3
34307_0,,,,2,1,2,3
34307_1,,,,2,1,2,3
34308_0,,,,2,1,2,3
34308_1,,,,2,1,2,3
34309_0,,,,2,1,2,3
34310_0,,,,2,1,2,3
34310_1,,,,2,1,2,3
34311_0,,,,2,1,2,3
34311_1,,,,2,1,2,3
34312_0,,,,2,1,2,3
34313_0,,,,2,1,2,3
34313_1,,,,2,1,2,3
34314_0,,,,2,1,2,3
34314_1,,,,2,1,2,3
34315_0,,,,2,1,2,3
34316_0,,,,2,1,2,3
34316_1,,,,2,1,2,3
34317_0,,,,2,1,2,3
34318_0,,,,2,1,2,3
34318_1,,,,2,1,2,3
34319_0,,,,2,1,2,3
34319_1,,,,2,1,2,3
34320_0,,,,2,1,2,3
34320_1,,,,2,1,2,3
34320_2,,,,2,1,2,3
34321_0,,,,2,1,2,3
34322_0,,,,2,1,2,3
34322_1,,,,2,1,2,3
34323_0,,,,2,1,2,3
34323_1,,,,2,1,2,3
34324_0,,,,2,1,2,3
34324_1,,,,2,1,2,3
34325_0,,,,2,1,2,3
34325_1,,,,2,1,2,3
34326_0,,,,2,1,2,3
34326_1,,,,2,1,2,3
34327_0,,,,2,1,2,3
34327_1,,,,2,1,2,3
34328_0,,,,2,1,2,3
34328_1,,,,2,1,2,3
34329_0,,,,2,1,2,3
34329_1,,,,2,1,2,3
34330_0,,,,2,1,2,3
34330_1,,,,2,1,2,3
34331_0,,,,2,1,2,3
34332_0,,,,2,1,2,3
34333_0,,,,2,1,2,3
34333_1,,,,2,1,2,3
34334_0,,,,2,1,2,3
34335_0,,,,2,1,2,3
34336_0,,,,2,1,2,3
34336_1,,,,2,1,2,3
34337_0,,,,2,1,2,3
34338_0,,,,2,1,2,3
34339_0,,,,2,1,2,3
34340_0,,,,2,1,2,3
34341_0,,,,2,1,2,3
34342_0,,,,2,1,2,3
34343_0,,,,2,1,2,3
34344_0,,,,2,1,2,3
34344_1,,,,2,1,2,3
34345_0,,,,2,1,2,3
34346_0,,,,2,1,2,3
34346_1,,,,2,1,2,3
34347_0,,,,2,1,2,3
34348_0,,,,2,1,2,3
34349_0,,,,2,1,2,3
34350_0,,,,2,1,2,3
34351_0,,,,2,1,2,3
34352_0,,,,2,1,2,3
34353_0,,,,2,1,2,3
34354_0,,,,2,1,2,3
34354_1,,,,2,1,2,3
34355_0,,,,2,1,2,3
34356_0,,,,2,1,2,3
34356_1,,,,2,1,2,3
34357_0,,,,2,1,2,3
34358_0,,,,2,1,2,3
34359_0,,,,2,1,2,3
34360_0,,,,2,1,2,3
34361_0,,,,2,1,2,3
34361_1,,,,2,1,2,3
34362_0,,,,2,1,2,3
34363_0,,,,2,1,2,3
34364_0,,,,2,1,2,3
34365_0,,,,2,1,2,3
34366_0,,,,2,1,2,3
34367_0,,,,2,1,2,3
34368_0,,,,2,1,2,3
34369_0,,,,2,1,2,3
34370_0,,,,2,1,2,3
34371_0,,,,2,1,2,3
34372_0,,,,2,1,2,3
34373_0,,,,2,1,2,3
34374_0,,,,2,1,2,3
34375_0,,,,2,1,2,3
34375_1,,,,2,1,2,3
34376_0,,,,2,1,2,3
34377_0,,,,2,1,2,3
34377_1,,,,2,1,2,3
34378_0,,,,2,1,2,3
34379_0,,,,2,1,2,3
34379_1,,,,2,1,2,3
34380_0,,,,2,1,2,3
34381_0,,,,2,1,2,3
34381_1,,,,2,1,2,3
34382_0,,,,2,1,2,3
34382_1,,,,2,1,2,3
34383_0,,,,2,1,2,3
34383_1,,,,2,1,2,3
34384_0,,,,2,1,2,3
34384_1,,,,2,1,2,3
34385_0,,,,2,1,2,3
34385_1,,,,2,1,2,3
34386_0,,,,2,1,2,3
34386_1,,,,2,1,2,3
34387_0,,,,2,1,2,3
34387_1,,,,2,1,2,3
34388_0,,,,2,1,2,3
34388_1,,,,2,1,2,3
34388_2,,,,2,1,2,3
34389_0,,,,2,1,2,3
34389_1,,,,2,1,2,3
34390_0,,,,2,1,2,3
34390_1,,,,2,1,2,3
34391_0,,,,2,1,2,3
34391_1,,,,2,1,2,3
34392_0,,,,2,1,2,3
34392_1,,,,2,1,2,3
34393_0,,,,2,1,2,3
34393_1,,,,2,1,2,3
34394_0,,,,2,1,2,3
34394_1,,,,2,1,2,3
34395_0,,,,2,1,2,3
34395_1,,,,2,1,2,3
34396_0,,,,2,1,2,3
34397_0,,,,2,1,2,3
34397_1,,,,2,1,2,3
34398_0,,,,2,1,2,3
34398_1,,,,2,1,2,3
34400_0,,,,2,1,2,3
C(C)(CC(CO)O)=O,,,5,1,2,0,2
34400_1,,,,2,1,2,3
34401_0,,,,2,1,2,3
34401_1,,,,2,1,2,3
34402_0,,,,2,1,2,3
34402_1,,,,2,1,2,3
34403_0,,,,2,1,2,3
34403_1,,,,2,1,2,3
34404_0,,,,2,1,2,3
34404_1,,,,2,1,2,3
34405_0,,,,2,1,2,3
34405_1,,,,2,1,2,3
34406_0,,,,2,1,2,3
34406_1,,,,2,1,2,3
34408_0,,,,2,1,2,3
C(C(CC(C)=O)O)=O,,,5,1,11,0,11
34408_1,,,,2,1,2,3
34409_0,,,,2,1,2,3
34409_1,,,,2,1,2,3
34410_0,,,,2,1,2,3
34410_1,,,,2,1,2,3
34411_0,,,,2,1,2,3
34411_1,,,,2,1,2,3
34412_0,,,,2,1,2,3
34412_1,,,,2,1,2,3
34413_0,,,,2,1,2,3
34413_1,,,,2,1,2,3
34414_0,,,,2,1,2,3
34414_1,,,,2,1,2,3
34415_0,,,,2,1,2,3
34415_1,,,,2,1,2,3
34416_0,,,,2,1,2,3
34417_0,,,,2,1,2,3
34417_1,,,,2,1,2,3
34418_0,,,,2,1,2,3
34419_0,,,,2,1,2,3
34419_1,,,,2,1,2,3
34420_0,,,,2,1,2,3
34420_1,,,,2,1,2,3
34421_0,,,,2,1,2,3
34422_0,,,,2,1,2,3
34423_0,,,,2,1,2,3
34424_0,,,,2,1,2,3
34424_1,,,,2,1,2,3
34425_0,,,,2,1,2,3
34425_1,,,,2,1,2,3
34426_0,,,,2,1,2,3
34427_0,,,,2,1,2,3
34427_1,,,,2,1,2,3
34428_0,,,,2,1,2,3
34428_1,,,,2,1,2,3
34428_2,,,,2,1,2,3
34429_0,,,,2,1,2,3
34429_1,,,,2,1,2,3
34430_0,,,,2,1,2,3
34431_0,,,,2,1,2,3
34431_1,,,,2,1,2,3
34432_0,,,,2,1,2,3
34432_1,,,,2,1,2,3
34433_0,,,,2,1,2,3
34433_1,,,,2,1,2,3
34433_2,,,,2,1,2,3
34434_0,,,,2,1,2,3
34435_0,,,,2,1,2,3
34435_1,,,,2,1,2,3
34437_0,,,,2,1,2,3
C(C(CCCO)=O)(O)=O,,,5,1,6,0,6
34437_1,,,,2,1,2,3
34439_0,,,,2,1,2,3
C(C(C)=O)(CC)=O,,,5,1,3,0,3
34439_1,,,,2,1,2,3
34441_0,,,,2,1,2,3
C(C(C)=O)(CCCO)=O,,,5,1,4,0,4
34441_1,,,,2,1,2,3
34442_0,,,,2,1,2,3
34442_1,,,,2,1,2,3
34444_0,,,,2,1,2,3
C(CC(CC)=O)=O,,,5,1,3,0,3
34444_1,,,,2,1,2,3
34446_0,,,,2,1,2,3
C(CC(CCCO)=O)=O,,,5,1,4,0,4
34446_1,,,,2,1,2,3
34447_0,,,,2,1,2,3
34447_1,,,,2,1,2,3
34448_0,,,,2,1,2,3
34450_0,,,,2,1,2,3
C(C(CCO)=O)(CC)=O,,,5,1,4,0,4
34450_1,,,,2,1,2,3
34451_0,,,,2,1,2,3
34452_0,,,,2,1,2,3
34453_0,,,,2,1,2,3
34453_1,,,,2,1,2,3
34454_0,,,,2,1,2,3
34455_0,,,,2,1,2,3
34456_0,,,,2,1,2,3
34457_0,,,,2,1,2,3
34457_1,,,,2,1,2,3
34458_0,,,,2,1,2,3
34459_0,,,,2,1,2,3
34459_1,,,,2,1,2,3
34460_0,,,,2,1,2,3
34462_0,,,,2,1,2,3
C(CCC=O)(C(C)O)=O,,,5,1,2,0,2
34464_0,,,,2,1,2,3
C(CC(C=O)O)(CC)=O,,,5,1,2,0,2
34464_1,,,,2,1,2,3
34465_0,,,,2,1,2,3
34466_0,,,,2,1,2,3
34466_1,,,,2,1,2,3
34467_0,,,,2,1,2,3
34469_0,,,,2,1,2,3
C(CC)(CC(CO)=O)=O,,,5,1,3,0,3
34469_1,,,,2,1,2,3
34470_0,,,,2,1,2,3
34470_1,,,,2,1,2,3
34471_0,,,,2,1,2,3
34472_0,,,,2,1,2,3
34473_0,,,,2,1,2,3
34474_0,,,,2,1,2,3
34476_0,,,,2,1,2,3
C(CC)(C(C(C)=O)O)=O,,,5,1,3,0,3
34476_1,,,,2,1,2,3
34478_0,,,,2,1,2,3
C(C(C)O)(CC(C)=O)=O,,,5,1,2,0,2
34479_0,,,,2,1,2,3
34480_0,,,,2,1,2,3
34480_1,,,,2,1,2,3
34481_0,,,,2,1,2,3
34481_1,,,,2,1,2,3
34482_0,,,,2,1,2,3
34483_0,,,,2,1,2,3
34484_0,,,,2,1,2,3
34486_0,,,,2,1,2,3
C(C)(CC)=O,,,5,1,2,0,2
34486_1,,,,2,1,2,3
34488_0,,,,2,1,2,3
C(C)(CCCO)=O,,,5,1,2,0,2
34488_1,,,,2,1,2,3
34490_0,,,,2,1,2,3
C(C)(C)=O,,,5,1,4,0,4
34490_1,,,,2,1,2,3
34491_0,,,,2,1,2,3
34492_0,,,,2,1,2,3
34492_1,,,,2,1,2,3
34493_0,,,,2,1,2,3
34495_0,,,,2,1,2,3
C(C(C)O)(CCO)=O,,,5,1,3,0,3
34496_0,,,,2,1,2,3
34496_1,,,,2,1,2,3
34498_0,,,,2,1,2,3
C(C(CO)O)(CC)=O,,,5,1,2,0,2
34498_1,,,,2,1,2,3
34499_0,,,,2,1,2,3
34499_1,,,,2,1,2,3
34501_0,,,,2,1,2,3
C(CC)=O,,,5,1,4,0,4
34501_1,,,,2,1,2,3
34503_0,,,,2,1,2,3
C(CO)(CC)=O,,,5,1,4,0,4
34503_1,,,,2,1,2,3
34504_0,,,,2,1,2,3
34504_1,,,,2,1,2,3
34506_0,,,,2,1,2,3
C(CCCO)=O,,,5,1,6,0,6
34506_1,,,,2,1,2,3
34507_0,,,,2,1,2,3
34509_0,,,,2,1,2,3
C(CO)(CCCO)=O,,,5,1,6,0,6
34509_1,,,,2,1,2,3
34511_0,,,,2,1,1,2
C(C(C(OCC(C)=O)O)O)=O,,,5,1,3,0,3
34511_1,,,,2,1,1,2
34512_0,,,,2,1,2,3
34512_1,,,,2,1,2,3
34514_0,,,,2,1,1,2
C(OC(C(CCO)=O)CO)=O,,,5,1,2,0,2
34514_1,,,,2,1,1,2
34515_0,,,,2,1,2,3
34515_1,,,,2,1,2,3
34517_0,,,,2,1,1,2
C(CC(OC(C=O)CO)O)=O,,,5,1,5,0,5
34517_1,,,,2,1,1,2
34519_0,,,,2,1,1,2
C(OC(CO)C(CC=O)O)=O,,,5,1,2,0,2
34519_1,,,,2,1,1,2
34521_0,,,,2,1,1,2
C(CC(OCC=O)O)=O,,,5,1,4,0,4
34521_1,,,,2,1,1,2
34523_0,,,,2,1,1,2
C(OCC(CC=O)O)=O,,,5,1,2,0,2
34523_1,,,,2,1,1,2
34525_0,,,,2,1,1,2
C(OCC(CC(C=O)=O)O)=O,,,5,1,2,0,2
34525_1,,,,2,1,1,2
34527_0,,,,2,1,1,2
C(COC(CC(C=O)=O)O)=O,,,5,1,7,0,7
34527_1,,,,2,1,1,2
34529_0,,,,2,1,1,2
C(CO)(CC(OCC=O)O)=O,,,5,1,6,0,6
34529_1,,,,2,1,1,2
34531_0,,,,2,1,1,2
C(OCC(CC(CO)=O)O)=O,,,5,1,4,0,4
34531_1,,,,2,1,1,2
34533_0,,,,2,1,1,2
C(C)(C(C(OCC=O)O)O)=O,,,5,1,6,0,6
34533_1,,,,2,1,1,2
34533_2,,,,2,1,1,2
34535_0,,,,2,1,1,2
C(OCC(C(C(C)=O)O)O)=O,,,5,1,4,0,4
34535_1,,,,2,1,1,2
34535_2,,,,2,1,1,2
34537_0,,,,2,1,1,2
C(OC(C(C)=O)=O)=O,,,5,1,1,0,1
34539_0,,,,2,1,1,2
C(COCC(CO)=O)=O,,,5,1,2,0,2
34539_1,,,,2,1,1,2
34541_0,,,,2,1,1,2
C(COC(C(C)=O)O)=O,,,5,1,1,0,1
34543_0,,,,2,1,1,2
C(C(O)OCC(C)=O)=O,,,5,1,1,0,1
34545_0,,,,2,1,1,2
C(OCC(C(C)=O)O)=O,,,5,1,1,0,1
34547_0,,,,2,1,1,2
C(OCCC(CO)=O)=O,,,5,1,2,0,2
34547_1,,,,2,1,1,2
34549_0,,,,2,1,1,2
C(C(CO)OCC(CO)=O)=O,,,5,1,2,0,2
34549_1,,,,2,1,1,2
34551_0,,,,2,1,1,2
C(C(CO)OC(C(C)=O)O)=O,,,5,1,1,0,1
34553_0,,,,2,1,1,2
C(C)(C(CO)OC(C=O)O)=O,,,5,1,1,0,1
34554_0,,,,2,1,2,3
34554_1,,,,2,1,2,3
34556_0,,,,2,1,1,2
C(OC(CO)C(C(C)=O)O)=O,,,5,1,1,0,1
34558_0,,,,2,1,1,2
C(OC(CO)CC(CO)=O)=O,,,5,1,2,0,2
34558_1,,,,2,1,1,2
34560_0,,,,2,1,1,2
C(COC(C(CO)=O)O)(C)=O,,,5,1,1,0,1
34562_0,,,,2,1,1,2
C(OCCC(C(CO)O)=O)=O,,,5,1,3,0,3
34562_1,,,,2,1,1,2
34562_2,,,,2,1,1,2
34563_0,,,,2,1,2,3
34563_1,,,,2,1,2,3
34563_2,,,,2,1,2,3
34565_0,,,,2,1,1,2
C(OCC(C(CCO)=O)O)=O,,,5,1,2,0,2
34565_1,,,,2,1,1,2
34566_0,,,,2,1,2,3
34566_1,,,,2,1,2,3
34568_0,,,,2,1,1,2
C(CC(O)OCC(C=O)O)=O,,,5,1,5,0,5
34568_1,,,,2,1,1,2
34570_0,,,,2,1,1,2
C(OCC(C(CC=O)O)O)=O,,,5,1,2,0,2
34570_1,,,,2,1,1,2
34572_0,,,,2,1,1,2
C(C(C(COCC=O)=O)O)=O,,,5,1,4,0,4
34572_1,,,,2,1,1,2
34572_2,,,,2,1,1,2
34574_0,,,,2,1,1,2
C(CC(C(O)OCC=O)=O)=O,,,5,1,3,0,3
34574_1,,,,2,1,1,2
34576_0,,,,2,1,1,2
C(CC(C=O)O)(OCC=O)=O,,,5,1,4,0,4
34576_1,,,,2,1,1,2
34578_0,,,,2,1,1,2
C(CC(COC(C=O)O)=O)=O,,,5,1,3,0,3
34578_1,,,,2,1,1,2
34580_0,,,,2,1,1,2
C(C(COCC(CO)=O)O)=O,,,5,1,2,0,2
34580_1,,,,2,1,1,2
34582_0,,,,2,1,1,2
C(C(COC(C(C)=O)O)O)=O,,,5,1,4,0,4
34584_0,,,,2,1,1,2
C(C)(C(COC(C=O)O)O)=O,,,5,1,1,0,1
34586_0,,,,2,1,1,2
C(CO)(CCOC(C=O)O)=O,,,5,1,2,0,2
34586_1,,,,2,1,1,2
34587_0,,,,2,1,1,2
34588_0,,,,2,1,1,2
34588_1,,,,2,1,1,2
34589_0,,,,2,1,1,2
34589_1,,,,2,1,1,2
34590_0,,,,2,1,1,2
34591_0,,,,2,1,1,2
34592_0,,,,2,1,2,3
34592_1,,,,2,1,2,3
34593_0,,,,2,1,2,3
34593_1,,,,2,1,2,3
34595_0,,,,2,1,1,2
C(C(C=O)O)(OCC(C)=O)=O,,,5,1,3,0,3
34595_1,,,,2,1,1,2
34597_0,,,,2,1,1,2
C(COC(C(C)=O)=O)=O,,,5,1,1,0,1
34599_0,,,,2,1,1,2
C(COC(C=O)=O)(C)=O,,,5,1,1,0,1
34601_0,,,,2,1,1,2
C(C(CO)OC(C(C)=O)=O)=O,,,5,1,1,0,1
34603_0,,,,2,1,1,2
C(C)(C(CO)OC(C=O)=O)=O,,,5,1,1,0,1
34604_0,,,,2,1,2,3
34604_1,,,,2,1,2,3
34606_0,,,,2,1,1,2
C(C(COC(C(C)=O)=O)O)=O,,,5,1,4,0,4
34608_0,,,,2,1,1,2
C(C)(C(COC(C=O)=O)O)=O,,,5,1,1,0,1
34610_0,,,,2,1,1,2
C(CO)(CCOC(C=O)=O)=O,,,5,1,2,0,2
34610_1,,,,2,1,1,2
34612_0,,,,2,1,1,2
C(CC(CO)=O)(OCC=O)=O,,,5,1,2,0,2
34612_1,,,,2,1,1,2
34614_0,,,,2,1,1,2
C(C(C(C)=O)O)(OCC=O)=O,,,5,1,3,0,3
34615_0,,,,2,1,1,2
34616_0,,,,2,1,2,3
34616_1,,,,2,1,2,3
34617_0,,,,2,1,2,3
34618_0,,,,2,1,2,3
34619_0,,,,2,1,2,3
34620_0,,,,2,1,2,3
34620_1,,,,2,1,2,3
34621_0,,,,2,1,2,3
34622_0,,,,2,1,2,3
34623_0,,,,2,1,2,3
34624_0,,,,2,1,2,3
34625_0,,,,2,1,2,3
34626_0,,,,2,1,2,3
34626_1,,,,2,1,2,3
34627_0,,,,2,1,2,3
34627_1,,,,2,1,2,3
34628_0,,,,2,1,2,3
34629_0,,,,2,1,2,3
34630_0,,,,2,1,2,3
34631_0,,,,2,1,2,3
34632_0,,,,2,1,2,3
34633_0,,,,2,1,2,3
34634_0,,,,2,1,2,3
34635_0,,,,2,1,2,3
34635_1,,,,2,1,2,3
34636_0,,,,2,1,2,3
34636_1,,,,2,1,2,3
34637_0,,,,2,1,2,3
34637_1,,,,2,1,2,3
34638_0,,,,2,1,2,3
34639_0,,,,2,1,2,3
34640_0,,,,2,1,2,3
34641_0,,,,2,1,2,3
34642_0,,,,2,1,2,3
34642_1,,,,2,1,2,3
34643_0,,,,2,1,2,3
34644_0,,,,2,1,2,3
34645_0,,,,2,1,2,3
34646_0,,,,2,1,2,3
34647_0,,,,2,1,2,3
34648_0,,,,2,1,2,3
34649_0,,,,2,1,2,3
34650_0,,,,2,1,2,3
34651_0,,,,2,1,2,3
34652_0,,,,2,1,2,3
34653_0,,,,2,1,2,3
34654_0,,,,2,1,2,3
34655_0,,,,2,1,2,3
34656_0,,,,2,1,2,3
34657_0,,,,2,1,2,3
34658_0,,,,2,1,2,3
34659_0,,,,2,1,2,3
34660_0,,,,2,1,2,3
34661_0,,,,2,1,2,3
34661_1,,,,2,1,2,3
34662_0,,,,2,1,2,3
34663_0,,,,2,1,2,3
34664_0,,,,2,1,2,3
34665_0,,,,2,1,2,3
34666_0,,,,2,1,2,3
34667_0,,,,2,1,2,3
34668_0,,,,2,1,2,3
34669_0,,,,2,1,2,3
34670_0,,,,2,1,2,3
34671_0,,,,2,1,2,3
34672_0,,,,2,1,2,3
34673_0,,,,2,1,2,3
34674_0,,,,2,1,2,3
34675_0,,,,2,1,2,3
34675_1,,,,2,1,2,3
34676_0,,,,2,1,2,3
34677_0,,,,2,1,2,3
34678_0,,,,2,1,2,3
34679_0,,,,2,1,2,3
34680_0,,,,2,1,2,3
34681_0,,,,2,1,2,3
34682_0,,,,2,1,2,3
34683_0,,,,2,1,2,3
34684_0,,,,2,1,2,3
34685_0,,,,2,1,2,3
34685_1,,,,2,1,2,3
34686_0,,,,2,1,2,3
34687_0,,,,2,1,2,3
34688_0,,,,2,1,2,3
34689_0,,,,2,1,2,3
34690_0,,,,2,1,2,3
34691_0,,,,2,1,2,3
34692_0,,,,2,1,2,3
34693_0,,,,2,1,2,3
34694_0,,,,2,1,2,3
34695_0,,,,2,1,2,3
34696_0,,,,2,1,2,3
34697_0,,,,2,1,2,3
34698_0,,,,2,1,2,3
34699_0,,,,2,1,2,3
34700_0,,,,2,1,2,3
34701_0,,,,2,1,2,3
34702_0,,,,2,1,2,3
34702_1,,,,2,1,2,3
34703_0,,,,2,1,2,3
34704_0,,,,2,1,2,3
34705_0,,,,2,1,2,3
34706_0,,,,2,1,2,3
34707_0,,,,2,1,2,3
34708_0,,,,2,1,2,3
34709_0,,,,2,1,2,3
34710_0,,,,2,1,2,3
34711_0,,,,2,1,2,3
34712_0,,,,2,1,2,3
34713_0,,,,2,1,2,3
34714_0,,,,2,1,2,3
34715_0,,,,2,1,2,3
34716_0,,,,2,1,2,3
34717_0,,,,2,1,2,3
34717_1,,,,2,1,2,3
34718_0,,,,2,1,2,3
34718_1,,,,2,1,2,3
34719_0,,,,2,1,2,3
34720_0,,,,2,1,2,3
34720_1,,,,2,1,2,3
34721_0,,,,2,1,2,3
34721_1,,,,2,1,2,3
34722_0,,,,2,1,2,3
34722_1,,,,2,1,2,3
34723_0,,,,2,1,2,3
34723_1,,,,2,1,2,3
34724_0,,,,2,1,2,3
34725_0,,,,2,1,2,3
34725_1,,,,2,1,2,3
34726_0,,,,2,1,2,3
34726_1,,,,2,1,2,3
34727_0,,,,2,1,2,3
34727_1,,,,2,1,2,3
34728_0,,,,2,1,2,3
34729_0,,,,2,1,2,3
34730_0,,,,2,1,2,3
34730_1,,,,2,1,2,3
34731_0,,,,2,1,2,3
34732_0,,,,2,1,2,3
34733_0,,,,2,1,2,3
34733_1,,,,2,1,2,3
34734_0,,,,2,1,2,3
34735_0,,,,2,1,2,3
34735_1,,,,2,1,2,3
34736_0,,,,2,1,2,3
34737_0,,,,2,1,2,3
34737_1,,,,2,1,2,3
34738_0,,,,2,1,2,3
34739_0,,,,2,1,2,3
34739_1,,,,2,1,2,3
34740_0,,,,2,1,2,3
34740_1,,,,2,1,2,3
34741_0,,,,2,1,2,3
34741_1,,,,2,1,2,3
34742_0,,,,2,1,2,3
34743_0,,,,2,1,2,3
34743_1,,,,2,1,2,3
34744_0,,,,2,1,2,3
34744_1,,,,2,1,2,3
34745_0,,,,2,1,2,3
34745_1,,,,2,1,2,3
34746_0,,,,2,1,2,3
34746_1,,,,2,1,2,3
34747_0,,,,2,1,2,3
34747_1,,,,2,1,2,3
34748_0,,,,2,1,2,3
34749_0,,,,2,1,2,3
34749_1,,,,2,1,2,3
34750_0,,,,2,1,2,3
34750_1,,,,2,1,2,3
34751_0,,,,2,1,2,3
34752_0,,,,2,1,2,3
34753_0,,,,2,1,2,3
34754_0,,,,2,1,2,3
34755_0,,,,2,1,2,3
34756_0,,,,2,1,2,3
34758_0,,,,2,1,2,3
C=C(C=O)C(O)=O,,,5,1,10,0,10
34760_0,,,,2,1,2,3
C(CO)=C(C(O)=O)C=O,,,5,1,5,0,5
34761_0,,,,2,1,2,3
34762_0,,,,2,1,2,3
34763_0,,,,2,1,2,3
34764_0,,,,2,1,2,3
34765_0,,,,2,1,2,3
34767_0,,,,2,1,2,3
C=C(C(O)=O)C(CO)=O,,,5,1,7,0,7
34768_0,,,,2,1,2,3
34768_1,,,,2,1,2,3
34770_0,,,,2,1,2,3
C=C(C(O)=O)C(C)=O,,,5,1,6,0,6
34770_1,,,,2,1,2,3
34771_0,,,,2,1,2,3
34771_1,,,,2,1,2,3
34772_0,,,,2,1,2,3
34773_0,,,,2,1,2,3
34773_1,,,,2,1,2,3
34773_2,,,,2,1,2,3
34774_0,,,,2,1,2,3
34774_1,,,,2,1,2,3
34775_0,,,,2,1,2,3
34775_1,,,,2,1,2,3
34776_0,,,,2,1,2,3
34776_1,,,,2,1,2,3
34778_0,,,,2,1,2,3
C(CO)=CC(CO)=O,,,5,1,8,0,8
34778_1,,,,2,1,2,3
34779_0,,,,2,1,2,3
34779_1,,,,2,1,2,3
34781_0,,,,2,1,1,2
C(CC(C(C(C=O)O)OC=O)O)=O,,,5,1,2,0,2
34781_1,,,,2,1,1,2
34783_0,,,,2,1,1,2
C(C(C(C=O)OC(CC=O)O)O)=O,,,5,1,10,0,10
34783_1,,,,2,1,1,2
34785_0,,,,2,1,1,2
C(OCC(CO)(CC=O)O)=O,,,5,1,2,0,2
34785_1,,,,2,1,1,2
34787_0,,,,2,1,1,2
C(CC(OCC(CO)=O)O)=O,,,5,1,6,0,6
34787_1,,,,2,1,1,2
34788_0,,,,2,1,2,3
34788_1,,,,2,1,2,3
34790_0,,,,2,1,1,2
C(CC(CO)(CO)OC(C=O)O)=O,,,5,1,2,0,2
34790_1,,,,2,1,1,2
34792_0,,,,2,1,1,2
C(OCC(CO)(CC(CO)=O)O)=O,,,5,1,4,0,4
34792_1,,,,2,1,1,2
34794_0,,,,2,1,1,2
C(CO)(CC(OCC(CO)=O)O)=O,,,5,1,8,0,8
34794_1,,,,2,1,1,2
34796_0,,,,2,1,1,2
C(CC(CO)(COC(CO)=O)O)=O,,,5,1,2,0,2
34796_1,,,,2,1,1,2
34798_0,,,,2,1,1,2
C(CC(CO)(OCC(CO)=O)O)=O,,,5,1,6,0,6
34798_1,,,,2,1,1,2
34799_0,,,,2,1,2,3
34801_0,,,,2,1,2,3
C1(CC(CO1)(CO)O)=O,,,5,1,5,0,5
34801_1,,,,2,1,2,3
34803_0,,,,2,1,1,2
C(C(CO)(COC(C=O)O)O)=O,,,5,1,4,0,4
34803_1,,,,2,1,1,2
34804_0,,,,2,1,1,2
34804_1,,,,2,1,1,2
34805_0,,,,2,1,1,2
34805_1,,,,2,1,1,2
34807_0,,,,2,1,2,3
C1(COC(CO)(C1O)O)=O,,,5,1,3,0,3
34808_0,,,,2,1,1,2
34808_1,,,,2,1,1,2
34810_0,,,,2,1,1,2
C(C(C(CO)(OCC(C)=O)O)O)=O,,,5,1,3,0,3
34810_1,,,,2,1,1,2
34812_0,,,,2,1,1,2
C(C(C(C)(OCC(CO)=O)O)O)=O,,,5,1,7,0,7
34812_1,,,,2,1,1,2
34814_0,,,,2,1,1,2
C(C)(C(C(CO)(OCC=O)O)O)=O,,,5,1,2,0,2
34814_1,,,,2,1,1,2
34816_0,,,,2,1,1,2
C(C)(C(C(OCC(CO)=O)O)O)=O,,,5,1,8,0,8
34816_1,,,,2,1,1,2
34818_0,,,,2,1,1,2
C(C(COC(C=O)(CO)O)O)=O,,,5,1,4,0,4
34818_1,,,,2,1,1,2
34818_2,,,,2,1,1,2
34820_0,,,,2,1,1,2
C(OCC(C(CO)O)(CC=O)O)=O,,,5,1,2,0,2
34820_1,,,,2,1,1,2
34822_0,,,,2,1,1,2
C(CC(OCC(C(CO)O)=O)O)=O,,,5,1,7,0,7
34822_1,,,,2,1,1,2
34824_0,,,,2,1,1,2
C(OC(CO)C(CO)(CC=O)O)=O,,,5,1,2,0,2
34824_1,,,,2,1,1,2
34826_0,,,,2,1,1,2
C(CC(OC(C(CO)=O)CO)O)=O,,,5,1,7,0,7
34826_1,,,,2,1,1,2
34827_0,,,,2,1,1,2
34827_1,,,,2,1,1,2
34828_0,,,,2,1,2,3
34828_1,,,,2,1,2,3
34830_0,,,,2,1,1,2
C(OC(C(CC=O)O)=O)=O,,,5,1,2,0,2
34830_1,,,,2,1,1,2
34832_0,,,,2,1,1,2
C(CC(O)OC(C=O)=O)=O,,,5,1,2,0,2
34832_1,,,,2,1,1,2
34833_0,,,,2,1,2,3
34833_1,,,,2,1,2,3
34835_0,,,,2,1,1,2
C(C(CC=O)OC(C=O)O)(O)=O,,,5,1,2,0,2
34835_1,,,,2,1,1,2
34837_0,,,,2,1,1,2
C(OC(C(CC(CO)=O)O)=O)=O,,,5,1,4,0,4
34837_1,,,,2,1,1,2
34839_0,,,,2,1,1,2
C(CO)(CC(O)OC(C=O)=O)=O,,,5,1,4,0,4
34839_1,,,,2,1,1,2
34841_0,,,,2,1,1,2
C(C(CC=O)O)(OC(CO)=O)=O,,,5,1,2,0,2
34841_1,,,,2,1,1,2
34843_0,,,,2,1,1,2
C(CC(CO)(O)OC(C=O)=O)=O,,,5,1,2,0,2
34843_1,,,,2,1,1,2
34844_0,,,,2,1,2,3
34845_0,,,,2,1,2,3
34845_1,,,,2,1,2,3
34847_0,,,,2,1,1,2
C(C(C=O)O)(OC(C=O)O)=O,,,5,1,2,0,2
34847_1,,,,2,1,1,2
34848_0,,,,2,1,2,3
34848_1,,,,2,1,2,3
34848_2,,,,2,1,2,3
34850_0,,,,2,1,1,2
C(OC(CO)(CO)C(CC=O)O)=O,,,5,1,2,0,2
34850_1,,,,2,1,1,2
34852_0,,,,2,1,1,2
C(C(CO)(CO)OC(CC=O)O)=O,,,5,1,2,0,2
34852_1,,,,2,1,1,2
34853_0,,,,2,1,2,3
34853_1,,,,2,1,2,3
34855_0,,,,2,1,1,2
C(C(O)OCCC(C=O)=O)(C)=O,,,5,1,3,0,3
34855_1,,,,2,1,1,2
34857_0,,,,2,1,1,2
C(CC(C=O)OC(C(C)=O)O)=O,,,5,1,4,0,4
34857_1,,,,2,1,1,2
34859_0,,,,2,1,1,2
C(CC(C=O)(C)OC(C=O)O)=O,,,5,1,2,0,2
34859_1,,,,2,1,1,2
34861_0,,,,2,1,1,2
C(C(C)OC(C(C=O)=O)O)=O,,,5,1,2,0,2
34861_1,,,,2,1,1,2
34862_0,,,,2,1,2,3
34862_1,,,,2,1,2,3
34864_0,,,,2,1,1,2
C(C(C)(O)OCCC(C=O)=O)=O,,,5,1,2,0,2
34864_1,,,,2,1,1,2
34866_0,,,,2,1,1,2
C(CC(C=O)OC(C=O)(C)O)=O,,,5,1,2,0,2
34866_1,,,,2,1,1,2
34868_0,,,,2,1,1,2
C(C(O)OC(C(C)=O)CC=O)=O,,,5,1,2,0,2
34868_1,,,,2,1,1,2
34870_0,,,,2,1,1,2
C(COC(C(C=O)=O)O)(C)=O,,,5,1,2,0,2
34870_1,,,,2,1,1,2
34871_0,,,,2,1,2,3
34872_0,,,,2,1,2,3
34874_0,,,,2,1,2,3
C(C1(CC(CO1)=O)O)=O,,,5,1,3,0,3
34876_0,,,,2,1,1,2
C(C(CC=O)(O)OCC(C)=O)=O,,,5,1,3,0,3
34876_1,,,,2,1,1,2
34878_0,,,,2,1,1,2
C(COC(C=O)(CC(C)=O)O)=O,,,5,1,2,0,2
34878_1,,,,2,1,1,2
34879_0,,,,2,1,2,3
34879_1,,,,2,1,2,3
34880_0,,,,2,1,2,3
34880_1,,,,2,1,2,3
34881_0,,,,2,1,2,3
34881_1,,,,2,1,2,3
34882_0,,,,2,1,2,3
34882_1,,,,2,1,2,3
34884_0,,,,2,1,1,2
C(CC(CC=O)OC(C=O)O)=O,,,5,1,2,0,2
34884_1,,,,2,1,1,2
34886_0,,,,2,1,1,2
C(CC(OCC(CC=O)=O)O)=O,,,5,1,8,0,8
34886_1,,,,2,1,1,2
34888_0,,,,2,1,1,2
C(CC(OCC(C=O)=O)O)=O,,,5,1,6,0,6
34888_1,,,,2,1,1,2
34889_0,,,,2,1,1,2
34889_1,,,,2,1,1,2
34891_0,,,,2,1,1,2
C(CC(C=O)OC(CC=O)O)=O,,,5,1,8,0,8
34891_1,,,,2,1,1,2
34893_0,,,,2,1,1,2
C(OC(C(CC=O)O)CC=O)=O,,,5,1,2,0,2
34893_1,,,,2,1,1,2
34894_0,,,,2,1,2,3
34895_0,,,,2,1,1,2
34895_1,,,,2,1,1,2
34897_0,,,,2,1,1,2
C(OCC(CC=O)(CC=O)O)=O,,,5,1,2,0,2
34897_1,,,,2,1,1,2
34899_0,,,,2,1,1,2
C(C(C=O)C(OCC(C)=O)O)=O,,,5,1,3,0,3
34899_1,,,,2,1,1,2
34901_0,,,,2,1,1,2
C(CC(OC(C=O)C(C)=O)O)=O,,,5,1,8,0,8
34901_1,,,,2,1,1,2
34902_0,,,,2,1,1,2
34902_1,,,,2,1,1,2
34904_0,,,,2,1,1,2
C(C)(C(C=O)C(OCC=O)O)=O,,,5,1,2,0,2
34904_1,,,,2,1,1,2
34905_0,,,,2,1,1,2
34905_1,,,,2,1,1,2
34907_0,,,,2,1,1,2
C(CC(C)(C(C=O)OC=O)O)=O,,,5,1,2,0,2
34907_1,,,,2,1,1,2
34908_0,,,,2,1,1,2
34908_1,,,,2,1,1,2
34910_0,,,,2,1,1,2
C(C(COC=O)(CC=O)O)=O,,,5,1,2,0,2
34910_1,,,,2,1,1,2
34912_0,,,,2,1,1,2
C(CC(OC(C(C=O)=O)CO)O)=O,,,5,1,7,0,7
34912_1,,,,2,1,1,2
34914_0,,,,2,1,1,2
C(C(C(CO)OC=O)(CC=O)O)=O,,,5,1,2,0,2
34914_1,,,,2,1,1,2
34916_0,,,,2,1,1,2
C(CC(OC(C=O)C(CO)O)O)=O,,,5,1,5,0,5
34916_1,,,,2,1,1,2
34918_0,,,,2,1,1,2
C(OC(C(CC=O)O)C(CO)O)=O,,,5,1,2,0,2
34918_1,,,,2,1,1,2
34920_0,,,,2,1,1,2
C(C(CCO)OC(C(C=O)=O)O)=O,,,5,1,2,0,2
34920_1,,,,2,1,1,2
34922_0,,,,2,1,1,2
C(COC(C(C=O)=O)O)(CCO)=O,,,5,1,2,0,2
34922_1,,,,2,1,1,2
34923_0,,,,2,1,2,3
34924_0,,,,2,1,2,3
34924_1,,,,2,1,2,3
34925_0,,,,2,1,2,3
34925_1,,,,2,1,2,3
34926_0,,,,2,1,2,3
34926_1,,,,2,1,2,3
34928_0,,,,2,1,1,2
C(C(O)OCCC(C=O)=O)(CO)=O,,,5,1,4,0,4
34928_1,,,,2,1,1,2
34929_0,,,,2,1,2,3
34929_1,,,,2,1,2,3
34931_0,,,,2,1,1,2
C(C(CO)(O)OCCC(C=O)=O)=O,,,5,1,2,0,2
34931_1,,,,2,1,1,2
34932_0,,,,2,1,2,3
34932_1,,,,2,1,2,3
34933_0,,,,2,1,2,3
34933_1,,,,2,1,2,3
34935_0,,,,2,1,1,2
C(C(O)OCCC(C=O)=O)=O,,,5,1,3,0,3
34935_1,,,,2,1,1,2
34936_0,,,,2,1,2,3
34936_1,,,,2,1,2,3
34937_0,,,,2,1,2,3
34938_0,,,,2,1,2,3
34940_0,,,,2,1,1,2
C(CC(C(C=O)O)OC(C=O)O)=O,,,5,1,5,0,5
34940_1,,,,2,1,1,2
34942_0,,,,2,1,2,3
C(C1CC(C(O1)O)O)=O,,,5,1,2,0,2
34944_0,,,,2,1,1,2
C(CC(C)OC(C=O)O)=O,,,5,1,2,0,2
34944_1,,,,2,1,1,2
34946_0,,,,2,1,1,2
C(CC(C=O)OC(C(CO)=O)O)=O,,,5,1,6,0,6
34946_1,,,,2,1,1,2
34947_0,,,,2,1,2,3
34947_1,,,,2,1,2,3
34949_0,,,,2,1,1,2
C(CC(C=O)(CO)OC(C=O)O)=O,,,5,1,2,0,2
34949_1,,,,2,1,1,2
34951_0,,,,2,1,1,2
C(CC(C=O)OC(C=O)(CO)O)=O,,,5,1,2,0,2
34951_1,,,,2,1,1,2
34953_0,,,,2,1,1,2
C(C(O)OC(C(CO)=O)CC=O)=O,,,5,1,2,0,2
34953_1,,,,2,1,1,2
34955_0,,,,2,1,1,2
C(CC(C(CO)O)OC(C=O)O)=O,,,5,1,2,0,2
34955_1,,,,2,1,1,2
34957_0,,,,2,1,1,2
C(C(CC=O)OC(C=O)O)=O,,,5,1,2,0,2
34957_1,,,,2,1,1,2
34959_0,,,,2,1,1,2
C(CCOC(C=O)O)=O,,,5,1,2,0,2
34959_1,,,,2,1,1,2
34961_0,,,,2,1,1,2
C(CC(CO)OC(C=O)O)=O,,,5,1,2,0,2
34961_1,,,,2,1,1,2
34963_0,,,,2,1,1,2
C(CC(CO)(OCC(C=O)=O)O)=O,,,5,1,6,0,6
34963_1,,,,2,1,1,2
34965_0,,,,2,1,1,2
C(CC(CO)(OCC=O)O)=O,,,5,1,4,0,4
34965_1,,,,2,1,1,2
34967_0,,,,2,1,1,2
C(CO)(CC(OCC(C=O)=O)O)=O,,,5,1,8,0,8
34967_1,,,,2,1,1,2
34969_0,,,,2,1,1,2
C(CC(C=O)(COC(C=O)O)O)=O,,,5,1,4,0,4
34969_1,,,,2,1,1,2
34971_0,,,,2,1,2,3
C(C1(C(C(CO1)=O)O)O)=O,,,5,1,2,0,2
34972_0,,,,2,1,1,2
34972_1,,,,2,1,1,2
34973_0,,,,2,1,2,3
34974_0,,,,2,1,1,2
34974_1,,,,2,1,1,2
34976_0,,,,2,1,1,2
C(C(COC=O)(CC(CO)=O)O)=O,,,5,1,4,0,4
34976_1,,,,2,1,1,2
34977_0,,,,2,1,1,2
34977_1,,,,2,1,1,2
34979_0,,,,2,1,1,2
C(CO)(OCC(C=O)(CC=O)O)=O,,,5,1,2,0,2
34979_1,,,,2,1,1,2
34981_0,,,,2,1,1,2
C(C(CO)OC(CC(CO)=O)O)=O,,,5,1,7,0,7
34981_1,,,,2,1,1,2
34983_0,,,,2,1,1,2
C(OC(CO)C(CC(CO)=O)O)=O,,,5,1,4,0,4
34983_1,,,,2,1,1,2
34985_0,,,,2,1,1,2
C(CC(CO)(OC(C=O)CO)O)=O,,,5,1,5,0,5
34985_1,,,,2,1,1,2
34986_0,,,,2,1,1,2
34986_1,,,,2,1,1,2
34987_0,,,,2,1,1,2
34987_1,,,,2,1,1,2
34988_0,,,,2,1,1,2
34988_1,,,,2,1,1,2
34990_0,,,,2,1,1,2
C(CC(C=O)(O)OCC(C=O)O)=O,,,5,1,3,0,3
34990_1,,,,2,1,1,2
34990_2,,,,2,1,1,2
34991_0,,,,2,1,2,3
34992_0,,,,2,1,2,3
34993_0,,,,2,1,2,3
34995_0,,,,2,1,1,2
C(CC(OCC(C)=O)O)=O,,,5,1,3,0,3
34995_1,,,,2,1,1,2
34997_0,,,,2,1,1,2
C(C(C(C)(OCC(C=O)=O)O)O)=O,,,5,1,8,0,8
34997_1,,,,2,1,1,2
34999_0,,,,2,1,1,2
C(C(C(C(C)=O)OC(C=O)O)O)=O,,,5,1,5,0,5
34999_1,,,,2,1,1,2
35001_0,,,,2,1,1,2
C(C(C(C=O)(O)OCC(C)=O)O)=O,,,5,1,3,0,3
35001_1,,,,2,1,1,2
35003_0,,,,2,1,1,2
C(C(C(C)(OCC=O)O)O)=O,,,5,1,5,0,5
35003_1,,,,2,1,1,2
35005_0,,,,2,1,1,2
C(C)(CC(OCC=O)O)=O,,,5,1,2,0,2
35005_1,,,,2,1,1,2
35007_0,,,,2,1,1,2
C(C)(C(C(OCC(C=O)=O)O)O)=O,,,5,1,9,0,9
35007_1,,,,2,1,1,2
35009_0,,,,2,1,1,2
C(C(C)(C(C=O)OC(C=O)O)O)=O,,,5,1,2,0,2
35009_1,,,,2,1,1,2
35011_0,,,,2,1,1,2
C(COC(C=O)(C(C(C)=O)O)O)=O,,,5,1,2,0,2
35011_1,,,,2,1,1,2
35012_0,,,,2,1,1,2
35012_1,,,,2,1,1,2
35013_0,,,,2,1,2,3
35013_1,,,,2,1,2,3
35014_0,,,,2,1,2,3
35014_1,,,,2,1,2,3
35015_0,,,,2,1,2,3
35015_1,,,,2,1,2,3
35017_0,,,,2,1,1,2
C(C(CO)OC(C(C=O)=O)O)=O,,,5,1,3,0,3
35017_1,,,,2,1,1,2
35017_2,,,,2,1,1,2
35018_0,,,,2,1,2,3
35018_1,,,,2,1,2,3
35018_2,,,,2,1,2,3
35020_0,,,,2,1,1,2
C(C(C=O)(COC(C=O)O)O)=O,,,5,1,2,0,2
35020_1,,,,2,1,1,2
35022_0,,,,2,1,1,2
C(C(C=O)(O)OCC(C=O)O)=O,,,5,1,3,0,3
35022_1,,,,2,1,1,2
35022_2,,,,2,1,1,2
35024_0,,,,2,1,1,2
C(COC(C(C=O)=O)O)(CO)=O,,,5,1,4,0,4
35024_1,,,,2,1,1,2
35025_0,,,,2,1,1,2
35025_1,,,,2,1,1,2
35027_0,,,,2,1,1,2
C(COC(C(C=O)=O)O)=O,,,5,1,2,0,2
35027_1,,,,2,1,1,2
35028_0,,,,2,1,1,2
35028_1,,,,2,1,1,2
35030_0,,,,2,1,1,2
C(OCC(C(CO)O)=O)=O,,,5,1,3,0,3
35030_1,,,,2,1,1,2
35030_2,,,,2,1,1,2
35031_0,,,,2,1,2,3
35031_1,,,,2,1,2,3
35031_2,,,,2,1,2,3
35033_0,,,,2,1,1,2
C(OCC(C(C(CO)O)O)=O)=O,,,5,1,3,0,3
35033_1,,,,2,1,1,2
35033_2,,,,2,1,1,2
35034_0,,,,2,1,2,3
35034_1,,,,2,1,2,3
35034_2,,,,2,1,2,3
35035_0,,,,2,1,1,2
35035_1,,,,2,1,1,2
35035_2,,,,2,1,1,2
35037_0,,,,2,1,1,2
C(C(C(CO)(OCC=O)O)O)=O,,,5,1,3,0,3
35037_1,,,,2,1,1,2
35037_2,,,,2,1,1,2
35038_0,,,,2,1,2,3
35038_1,,,,2,1,2,3
35040_0,,,,2,1,1,2
C(C(C(C=O)O)OC(C=O)O)(O)=O,,,5,1,3,0,3
35040_1,,,,2,1,1,2
35040_2,,,,2,1,1,2
35042_0,,,,2,1,1,2
C(C(C(C=O)OC(C(C)=O)O)O)=O,,,5,1,5,0,5
35042_1,,,,2,1,1,2
35042_2,,,,2,1,1,2
35044_0,,,,2,1,1,2
C(COC(C(C(C=O)=O)(C)O)O)=O,,,5,1,2,0,2
35044_1,,,,2,1,1,2
35046_0,,,,2,1,1,2
C(C(C)OC(C(C(C=O)=O)O)O)=O,,,5,1,2,0,2
35046_1,,,,2,1,1,2
35048_0,,,,2,1,1,2
C(C(OC(C=O)(C)C(C=O)O)O)=O,,,5,1,3,0,3
35048_1,,,,2,1,1,2
35048_2,,,,2,1,1,2
35050_0,,,,2,1,1,2
C(C(C(C=O)O)OC(C=O)(C)O)=O,,,5,1,3,0,3
35050_1,,,,2,1,1,2
35050_2,,,,2,1,1,2
35052_0,,,,2,1,1,2
C(COC(C)(C(C(C=O)=O)O)O)=O,,,5,1,2,0,2
35052_1,,,,2,1,1,2
35054_0,,,,2,1,1,2
C(COC(C(C(C=O)=O)O)O)(C)=O,,,5,1,2,0,2
35054_1,,,,2,1,1,2
35055_0,,,,2,1,1,2
35055_1,,,,2,1,1,2
35055_2,,,,2,1,1,2
35056_0,,,,2,1,1,2
35056_1,,,,2,1,1,2
35056_2,,,,2,1,1,2
35057_0,,,,2,1,2,3
35057_1,,,,2,1,2,3
35057_2,,,,2,1,2,3
35058_0,,,,2,1,1,2
35058_1,,,,2,1,1,2
35058_2,,,,2,1,1,2
35060_0,,,,2,1,1,2
C(C(C(C)OC(C=O)O)O)=O,,,5,1,3,0,3
35060_1,,,,2,1,1,2
35060_2,,,,2,1,1,2
35062_0,,,,2,1,1,2
C(C(C(C=O)O)OC(C=O)O)=O,,,5,1,3,0,3
35062_1,,,,2,1,1,2
35062_2,,,,2,1,1,2
35064_0,,,,2,1,1,2
C(COC(C(C(C=O)=O)O)O)=O,,,5,1,6,0,6
35064_1,,,,2,1,1,2
35066_0,,,,2,1,1,2
C(OCC(CO)(C(C(C)=O)O)O)=O,,,5,1,4,0,4
35066_1,,,,2,1,1,2
35066_2,,,,2,1,1,2
35067_0,,,,2,1,1,2
35067_1,,,,2,1,1,2
35067_2,,,,2,1,1,2
35069_0,,,,2,1,1,2
C(C(C(CO)(COC(C)=O)O)O)=O,,,5,1,3,0,3
35069_1,,,,2,1,1,2
35069_2,,,,2,1,1,2
35070_0,,,,2,1,1,2
35070_1,,,,2,1,1,2
35070_2,,,,2,1,1,2
35072_0,,,,2,1,1,2
C(CO)(C(COC(C(C)=O)O)O)=O,,,5,1,6,0,6
35072_1,,,,2,1,1,2
35072_2,,,,2,1,1,2
35074_0,,,,2,1,1,2
C(C(C)(O)OCC(C(CO)=O)O)=O,,,5,1,5,0,5
35074_1,,,,2,1,1,2
35074_2,,,,2,1,1,2
35075_0,,,,2,1,1,2
35075_1,,,,2,1,1,2
35075_2,,,,2,1,1,2
35076_0,,,,2,1,2,3
35076_1,,,,2,1,2,3
35076_2,,,,2,1,2,3
35078_0,,,,2,1,1,2
C(CO)(C(COC(C=O)O)O)=O,,,5,1,8,0,8
35078_1,,,,2,1,1,2
35078_2,,,,2,1,1,2
35080_0,,,,2,1,1,2
C(OC(C(C(C(C)=O)O)O)=O)=O,,,5,1,4,0,4
35080_1,,,,2,1,1,2
35080_2,,,,2,1,1,2
35082_0,,,,2,1,1,2
C(C)(C(C(O)OC(C=O)=O)O)=O,,,5,1,4,0,4
35082_1,,,,2,1,1,2
35082_2,,,,2,1,1,2
35084_0,,,,2,1,1,2
C(C(C(C=O)O)O)(OC(C)=O)=O,,,5,1,3,0,3
35084_1,,,,2,1,1,2
35084_2,,,,2,1,1,2
35086_0,,,,2,1,1,2
C(C(C(C)(O)OC(C=O)=O)O)=O,,,5,1,3,0,3
35086_1,,,,2,1,1,2
35086_2,,,,2,1,1,2
35087_0,,,,2,1,2,3
35087_1,,,,2,1,2,3
35087_2,,,,2,1,2,3
35089_0,,,,2,1,1,2
C(C(C(CO)=O)O)(OC(C=O)O)=O,,,5,1,2,0,2
35089_1,,,,2,1,1,2
35091_0,,,,2,1,1,2
C(C(C(C)OC(C(CO)=O)O)O)=O,,,5,1,3,0,3
35091_1,,,,2,1,1,2
35091_2,,,,2,1,1,2
35093_0,,,,2,1,1,2
C(C(COC(C(C(C)O)=O)O)O)=O,,,5,1,3,0,3
35093_1,,,,2,1,1,2
35093_2,,,,2,1,1,2
35095_0,,,,2,1,1,2
C(C(COC(C(CO)=O)O)O)=O,,,5,1,5,0,5
35095_1,,,,2,1,1,2
35095_2,,,,2,1,1,2
35097_0,,,,2,1,1,2
C(COC(C(C(C(O)=O)=O)O)O)=O,,,5,1,2,0,2
35097_1,,,,2,1,1,2
35099_0,,,,2,1,1,2
C(C(O)OCC(C(C=O)=O)O)(C)=O,,,5,1,4,0,4
35099_1,,,,2,1,1,2
35099_2,,,,2,1,1,2
35101_0,,,,2,1,2,3
C1(COC(C1(C)O)O)=O,,,5,1,2,0,2
35102_0,,,,2,1,2,3
35102_1,,,,2,1,2,3
35102_2,,,,2,1,2,3
35104_0,,,,2,1,1,2
C(C(C)OC(C(C(CO)=O)=O)O)=O,,,5,1,2,0,2
35104_1,,,,2,1,1,2
35105_0,,,,2,1,1,2
35105_1,,,,2,1,1,2
35105_2,,,,2,1,1,2
35107_0,,,,2,1,1,2
C(C(C(CO)OC(C(C)=O)O)O)=O,,,5,1,4,0,4
35107_1,,,,2,1,1,2
35107_2,,,,2,1,1,2
35109_0,,,,2,1,1,2
C(C(C)(O)OCC(C(C=O)=O)O)=O,,,5,1,3,0,3
35109_1,,,,2,1,1,2
35109_2,,,,2,1,1,2
35111_0,,,,2,1,2,3
C1(COC(C)(C1O)O)=O,,,5,1,2,0,2
35112_0,,,,2,1,2,3
35112_1,,,,2,1,2,3
35112_2,,,,2,1,2,3
35114_0,,,,2,1,1,2
C(COC(C(C(CO)=O)=O)O)(C)=O,,,5,1,2,0,2
35114_1,,,,2,1,1,2
35116_0,,,,2,1,1,2
C(C(COC(C=O)(C)O)O)=O,,,5,1,3,0,3
35116_1,,,,2,1,1,2
35116_2,,,,2,1,1,2
35118_0,,,,2,1,1,2
C(C(C(CO)OC(C=O)(C)O)O)=O,,,5,1,3,0,3
35118_1,,,,2,1,1,2
35118_2,,,,2,1,1,2
35119_0,,,,2,1,1,2
35119_1,,,,2,1,1,2
35119_2,,,,2,1,1,2
35120_0,,,,2,1,2,3
35120_1,,,,2,1,2,3
35120_2,,,,2,1,2,3
35121_0,,,,2,1,1,2
35121_1,,,,2,1,1,2
35121_2,,,,2,1,1,2
35122_0,,,,2,1,2,3
35122_1,,,,2,1,2,3
35122_2,,,,2,1,2,3
35123_0,,,,2,1,2,3
35123_1,,,,2,1,2,3
35123_2,,,,2,1,2,3
35124_0,,,,2,1,1,2
35124_1,,,,2,1,1,2
35124_2,,,,2,1,1,2
35125_0,,,,2,1,2,3
35125_1,,,,2,1,2,3
35125_2,,,,2,1,2,3
35126_0,,,,2,1,1,2
35126_1,,,,2,1,1,2
35126_2,,,,2,1,1,2
35128_0,,,,2,1,2,3
C(C1(C(O)OCC1O)O)=O,,,5,1,2,0,2
35130_0,,,,2,1,1,2
C(C(COC(C(CCO)=O)O)O)=O,,,5,1,5,0,5
35130_1,,,,2,1,1,2
35130_2,,,,2,1,1,2
35132_0,,,,2,1,1,2
C(C(COC(C=O)(CCO)O)O)=O,,,5,1,3,0,3
35132_1,,,,2,1,1,2
35132_2,,,,2,1,1,2
35133_0,,,,2,1,2,3
35133_1,,,,2,1,2,3
35133_2,,,,2,1,2,3
35134_0,,,,2,1,2,3
35134_1,,,,2,1,2,3
35134_2,,,,2,1,2,3
35135_0,,,,2,1,1,2
35135_1,,,,2,1,1,2
35135_2,,,,2,1,1,2
35136_0,,,,2,1,2,3
35136_1,,,,2,1,2,3
35136_2,,,,2,1,2,3
35137_0,,,,2,1,1,2
35137_1,,,,2,1,1,2
35137_2,,,,2,1,1,2
35138_0,,,,2,1,2,3
35140_0,,,,2,1,1,2
C(C(COC(C(C(C)=O)=O)O)O)=O,,,5,1,3,0,3
35140_1,,,,2,1,1,2
35140_2,,,,2,1,1,2
35141_0,,,,2,1,1,2
35141_1,,,,2,1,1,2
35141_2,,,,2,1,1,2
35143_0,,,,2,1,1,2
C(C(COC=O)(C(C(C)=O)O)O)=O,,,5,1,4,0,4
35143_1,,,,2,1,1,2
35143_2,,,,2,1,1,2
35145_0,,,,2,1,1,2
C(C(COC(C(C=O)=O)(C)O)O)=O,,,5,1,3,0,3
35145_1,,,,2,1,1,2
35145_2,,,,2,1,1,2
35146_0,,,,2,1,1,2
35146_1,,,,2,1,1,2
35146_2,,,,2,1,1,2
35148_0,,,,2,1,1,2
C(C)(OCC(C=O)(C(C=O)O)O)=O,,,5,1,3,0,3
35148_1,,,,2,1,1,2
35148_2,,,,2,1,1,2
35150_0,,,,2,1,1,2
C(C(CO)OC(C(C(C)=O)O)O)=O,,,5,1,7,0,7
35150_1,,,,2,1,1,2
35150_2,,,,2,1,1,2
35152_0,,,,2,1,1,2
C(OC(CO)C(C(C(C)=O)O)O)=O,,,5,1,4,0,4
35152_1,,,,2,1,1,2
35152_2,,,,2,1,1,2
35154_0,,,,2,1,1,2
C(C(C(C)(OC(C=O)CO)O)O)=O,,,5,1,6,0,6
35154_1,,,,2,1,1,2
35154_2,,,,2,1,1,2
35156_0,,,,2,1,1,2
C(C(C(C(CO)OC(C)=O)O)O)=O,,,5,1,3,0,3
35156_1,,,,2,1,1,2
35156_2,,,,2,1,1,2
35157_0,,,,2,1,1,2
35157_1,,,,2,1,1,2
35157_2,,,,2,1,1,2
35159_0,,,,2,1,1,2
C(C(C(COC(C)=O)O)O)=O,,,5,1,3,0,3
35159_1,,,,2,1,1,2
35159_2,,,,2,1,1,2
35160_0,,,,2,1,2,3
35160_1,,,,2,1,2,3
35160_2,,,,2,1,2,3
35161_0,,,,2,1,1,2
35161_1,,,,2,1,1,2
35161_2,,,,2,1,1,2
35163_0,,,,2,1,1,2
C(C(C(OCC(C)=O)O)(CO)O)=O,,,5,1,3,0,3
35163_1,,,,2,1,1,2
35164_0,,,,2,1,2,3
35164_1,,,,2,1,2,3
35164_2,,,,2,1,2,3
35165_0,,,,2,1,1,2
35165_1,,,,2,1,1,2
35165_2,,,,2,1,1,2
35167_0,,,,2,1,1,2
C(C)(C(C(OCC=O)O)(CO)O)=O,,,5,1,2,0,2
35167_1,,,,2,1,1,2
35168_0,,,,2,1,2,3
35168_1,,,,2,1,2,3
35168_2,,,,2,1,2,3
35170_0,,,,2,1,1,2
C(C(O)OCC(C(C=O)=O)O)=O,,,5,1,6,0,6
35170_1,,,,2,1,1,2
35170_2,,,,2,1,1,2
35171_0,,,,2,1,2,3
35173_0,,,,2,1,1,2
C(COC(C(C(CO)=O)=O)O)=O,,,5,1,2,0,2
35173_1,,,,2,1,1,2
35174_0,,,,2,1,2,3
35174_1,,,,2,1,2,3
35174_2,,,,2,1,2,3
35175_0,,,,2,1,1,2
35175_1,,,,2,1,1,2
35176_0,,,,2,1,2,3
35176_1,,,,2,1,2,3
35176_2,,,,2,1,2,3
35177_0,,,,2,1,2,3
35178_0,,,,2,1,2,3
35180_0,,,,2,1,1,2
C(C(C)OC(CC(C=O)=O)O)=O,,,5,1,4,0,4
35180_1,,,,2,1,1,2
35182_0,,,,2,1,1,2
C(COC(CC(C=O)=O)O)(C)=O,,,5,1,4,0,4
35182_1,,,,2,1,1,2
35183_0,,,,2,1,1,2
35183_1,,,,2,1,1,2
35185_0,,,,2,1,1,2
C(C(COC(C(CC=O)=O)O)O)=O,,,5,1,3,0,3
35185_1,,,,2,1,1,2
35185_2,,,,2,1,1,2
35186_0,,,,2,1,2,3
35187_0,,,,2,1,2,3
35187_1,,,,2,1,2,3
35187_2,,,,2,1,2,3
35189_0,,,,2,1,1,2
C(C(CO)OC(CC(C=O)=O)O)=O,,,5,1,6,0,6
35189_1,,,,2,1,1,2
35189_2,,,,2,1,1,2
35191_0,,,,2,1,1,2
C(COC(CC(C=O)=O)O)(CO)=O,,,5,1,6,0,6
35191_1,,,,2,1,1,2
35192_0,,,,2,1,2,3
35193_0,,,,2,1,1,2
35193_1,,,,2,1,1,2
35195_0,,,,2,1,1,2
C(CC(COC(C=O)=O)O)=O,,,5,1,2,0,2
35195_1,,,,2,1,1,2
35197_0,,,,2,1,1,2
C(CC(C=O)(O)OCC=O)=O,,,5,1,2,0,2
35197_1,,,,2,1,1,2
35199_0,,,,2,1,1,2
C(OC(C(CO)=O)=O)=O,,,5,1,2,0,2
35199_1,,,,2,1,1,2
35200_0,,,,2,1,1,2
35200_1,,,,2,1,1,2
35202_0,,,,2,1,1,2
C(C(C(COC(C=O)=O)O)O)=O,,,5,1,7,0,7
35202_1,,,,2,1,1,2
35202_2,,,,2,1,1,2
35204_0,,,,2,1,1,2
C(C(C(C=O)O)(O)OCC=O)=O,,,5,1,3,0,3
35204_1,,,,2,1,1,2
35204_2,,,,2,1,1,2
35206_0,,,,2,1,1,2
C(OCC(C(C(C=O)=O)O)O)=O,,,5,1,3,0,3
35206_1,,,,2,1,1,2
35206_2,,,,2,1,1,2
35207_0,,,,2,1,1,2
35207_1,,,,2,1,1,2
35207_2,,,,2,1,1,2
35208_0,,,,2,1,2,3
35209_0,,,,2,1,1,2
35211_0,,,,2,1,1,2
C(C(CC(C=O)(OCC=O)O)O)=O,,,5,1,4,0,4
35211_1,,,,2,1,1,2
35213_0,,,,2,1,1,2
C(CC(C(C(C=O)OC=O)O)O)=O,,,5,1,2,0,2
35213_1,,,,2,1,1,2
35214_0,,,,2,1,1,2
35214_1,,,,2,1,1,2
35216_0,,,,2,1,1,2
C(COC(C(C=O)C(C=O)O)O)=O,,,5,1,4,0,4
35216_1,,,,2,1,1,2
35218_0,,,,2,1,1,2
C(C(CC(OCC=O)O)O)=O,,,5,1,4,0,4
35218_1,,,,2,1,1,2
35219_0,,,,2,1,1,2
35219_1,,,,2,1,1,2
35221_0,,,,2,1,1,2
C(COC(C(C)=O)O)(CO)=O,,,5,1,3,0,3
35222_0,,,,2,1,2,3
35222_1,,,,2,1,2,3
35224_0,,,,2,1,1,2
C(CO)(COC(C(CCO)=O)O)=O,,,5,1,4,0,4
35224_1,,,,2,1,1,2
35226_0,,,,2,1,1,2
C(CC(CO)(COC(C=O)O)O)=O,,,5,1,2,0,2
35226_1,,,,2,1,1,2
35228_0,,,,2,1,1,2
C(CC(C(OCC(CO)=O)O)O)=O,,,5,1,4,0,4
35228_1,,,,2,1,1,2
35230_0,,,,2,1,1,2
C(OC(CO)(CO)C(C(C)=O)O)=O,,,5,1,1,0,1
35232_0,,,,2,1,1,2
C(OC(CO)(CO)CC(CO)=O)=O,,,5,1,2,0,2
35232_1,,,,2,1,1,2
35234_0,,,,2,1,1,2
C(C(O)OCC(CO)=O)(CO)=O,,,5,1,4,0,4
35234_1,,,,2,1,1,2
35235_0,,,,2,1,1,2
35235_1,,,,2,1,1,2
35237_0,,,,2,1,1,2
C(C(C)(OCC(CO)=O)O)=O,,,5,1,2,0,2
35237_1,,,,2,1,1,2
35239_0,,,,2,1,1,2
C(C(CCOC(C=O)(CO)O)O)=O,,,5,1,2,0,2
35239_1,,,,2,1,1,2
35240_0,,,,2,1,1,2
35240_1,,,,2,1,1,2
35242_0,,,,2,1,1,2
C(C(CCO)(OCC(CO)=O)O)=O,,,5,1,2,0,2
35242_1,,,,2,1,1,2
35244_0,,,,2,1,1,2
C(C(CC(OCC(CO)=O)O)O)=O,,,5,1,4,0,4
35244_1,,,,2,1,1,2
35245_0,,,,2,1,1,2
35245_1,,,,2,1,1,2
35246_0,,,,2,1,1,2
35246_1,,,,2,1,1,2
35248_0,,,,2,1,1,2
C(C(CO)(OCC(CO)=O)O)=O,,,5,1,2,0,2
35248_1,,,,2,1,1,2
35250_0,,,,2,1,1,2
C(C(O)OCC(CO)=O)=O,,,5,1,3,0,3
35250_1,,,,2,1,1,2
35252_0,,,,2,1,1,2
C(COC(C(C)=O)O)(C(CO)O)=O,,,5,1,4,0,4
35254_0,,,,2,1,1,2
C(CO)(C(CO)OC(C(C)=O)O)=O,,,5,1,3,0,3
35256_0,,,,2,1,1,2
C(OCC(C(CO)(CC=O)O)O)=O,,,5,1,2,0,2
35256_1,,,,2,1,1,2
35258_0,,,,2,1,1,2
C(CC(O)OCC(C(CO)=O)O)=O,,,5,1,5,0,5
35258_1,,,,2,1,1,2
35259_0,,,,2,1,1,2
35259_1,,,,2,1,1,2
35260_0,,,,2,1,2,3
35260_1,,,,2,1,2,3
35262_0,,,,2,1,1,2
C(C(C)(OC(C(CO)=O)CO)O)=O,,,5,1,2,0,2
35262_1,,,,2,1,1,2
35263_0,,,,2,1,2,3
35263_1,,,,2,1,2,3
35265_0,,,,2,1,1,2
C(CO)(C(CO)OC(C=O)O)=O,,,5,1,3,0,3
35265_1,,,,2,1,1,2
35266_0,,,,2,1,2,3
35266_1,,,,2,1,2,3
35268_0,,,,2,1,1,2
C(C)(C(O)OC(C=O)=O)=O,,,5,1,1,0,1
35269_0,,,,2,1,2,3
35269_1,,,,2,1,2,3
35271_0,,,,2,1,1,2
C(C(O)OC(C=O)=O)(CCO)=O,,,5,1,2,0,2
35271_1,,,,2,1,1,2
35273_0,,,,2,1,1,2
C(C(CC=O)O)(OC(C=O)O)=O,,,5,1,2,0,2
35273_1,,,,2,1,1,2
35275_0,,,,2,1,1,2
C(CC(C(O)OC(C=O)=O)O)=O,,,5,1,2,0,2
35275_1,,,,2,1,1,2
35277_0,,,,2,1,1,2
C(OC(C(O)=O)C(C(C)=O)O)=O,,,5,1,1,0,1
35279_0,,,,2,1,1,2
C(OC(C(O)=O)CC(CO)=O)=O,,,5,1,2,0,2
35279_1,,,,2,1,1,2
35281_0,,,,2,1,1,2
C(CO)(C(O)OC(C=O)=O)=O,,,5,1,2,0,2
35281_1,,,,2,1,1,2
35283_0,,,,2,1,1,2
C(C(CC(OC(C=O)CO)O)O)=O,,,5,1,5,0,5
35283_1,,,,2,1,1,2
35283_2,,,,2,1,1,2
35284_0,,,,2,1,2,3
35284_1,,,,2,1,2,3
35284_2,,,,2,1,2,3
35285_0,,,,2,1,2,3
35285_1,,,,2,1,2,3
35287_0,,,,2,1,1,2
C(CO)(C(CC(OCC=O)O)O)=O,,,5,1,2,0,2
35287_1,,,,2,1,1,2
35289_0,,,,2,1,1,2
C(C(CO)(CO)OC(C(C)=O)O)=O,,,5,1,1,0,1
35291_0,,,,2,1,1,2
C(OCC(CO)(C(CC=O)O)O)=O,,,5,1,2,0,2
35291_1,,,,2,1,1,2
35293_0,,,,2,1,1,2
C(C(COC(CC=O)O)(CO)O)=O,,,5,1,2,0,2
35293_1,,,,2,1,1,2
35295_0,,,,2,1,1,2
C(CC(COC(C(C)=O)O)=O)=O,,,5,1,3,0,3
35295_1,,,,2,1,1,2
35297_0,,,,2,1,1,2
C(C(C)(C(C(C)=O)O)OC=O)=O,,,5,1,1,0,1
35298_0,,,,2,1,1,2
35298_1,,,,2,1,1,2
35300_0,,,,2,1,1,2
C(C(C(C)=O)OC(C(C)=O)O)=O,,,5,1,3,0,3
35302_0,,,,2,1,1,2
C(C(C)(CC(CO)=O)OC=O)=O,,,5,1,2,0,2
35302_1,,,,2,1,1,2
35304_0,,,,2,1,1,2
C(C(C)(OCC(CC=O)=O)O)=O,,,5,1,2,0,2
35304_1,,,,2,1,1,2
35305_0,,,,2,1,1,2
35306_0,,,,2,1,1,2
35306_1,,,,2,1,1,2
35308_0,,,,2,1,1,2
C(C(C)(OC(C=O)C(C)=O)O)=O,,,5,1,1,0,1
35310_0,,,,2,1,1,2
C(OC(C(C)=O)CC(CO)=O)=O,,,5,1,2,0,2
35310_1,,,,2,1,1,2
35311_0,,,,2,1,1,2
35313_0,,,,2,1,2,3
C1(COC(C(C1)=O)O)=O,,,5,1,4,0,4
35314_0,,,,2,1,1,2
35316_0,,,,2,1,1,2
C(CC(C(O)OCC(C)=O)=O)=O,,,5,1,2,0,2
35316_1,,,,2,1,1,2
35317_0,,,,2,1,1,2
35319_0,,,,2,1,1,2
C(COC(C(CC(C)=O)=O)O)=O,,,5,1,2,0,2
35319_1,,,,2,1,1,2
35320_0,,,,2,1,1,2
35322_0,,,,2,1,1,2
C(C)(C(O)OCC(C=O)=O)=O,,,5,1,2,0,2
35324_0,,,,2,1,1,2
C(C(OC(C(C=O)=O)CO)O)(C)=O,,,5,1,2,0,2
35325_0,,,,2,1,1,2
35325_1,,,,2,1,1,2
35326_0,,,,2,1,2,3
35326_1,,,,2,1,2,3
35328_0,,,,2,1,1,2
C(C(C(CO)O)OC(C(C)=O)O)=O,,,5,1,1,0,1
35330_0,,,,2,1,1,2
C(CC(O)OCCC(C=O)=O)=O,,,5,1,6,0,6
35330_1,,,,2,1,1,2
35331_0,,,,2,1,1,2
35331_1,,,,2,1,1,2
35333_0,,,,2,1,1,2
C(CC(C(C(C)=O)O)OC=O)=O,,,5,1,1,0,1
35335_0,,,,2,1,1,2
C(CC(CC(CO)=O)OC=O)=O,,,5,1,2,0,2
35335_1,,,,2,1,1,2
35336_0,,,,2,1,1,2
35336_1,,,,2,1,1,2
35338_0,,,,2,1,1,2
C(C(CCOC=O)(CC=O)O)=O,,,5,1,2,0,2
35338_1,,,,2,1,1,2
35339_0,,,,2,1,1,2
35339_1,,,,2,1,1,2
35341_0,,,,2,1,1,2
C(CC(CC(C=O)OC=O)O)=O,,,5,1,2,0,2
35341_1,,,,2,1,1,2
35342_0,,,,2,1,1,2
35342_1,,,,2,1,1,2
35344_0,,,,2,1,1,2
C(OCC(C(CC=O)O)=O)=O,,,5,1,2,0,2
35344_1,,,,2,1,1,2
35345_0,,,,2,1,1,2
35345_1,,,,2,1,1,2
35347_0,,,,2,1,1,2
C(CC(O)OCC(C(C=O)=O)O)=O,,,5,1,7,0,7
35347_1,,,,2,1,1,2
35349_0,,,,2,1,1,2
C(C(C(COC=O)O)(CC=O)O)=O,,,5,1,2,0,2
35349_1,,,,2,1,1,2
35350_0,,,,2,1,2,3
35350_1,,,,2,1,2,3
35351_0,,,,2,1,1,2
35351_1,,,,2,1,1,2
35353_0,,,,2,1,1,2
C(CC(C(C(CO)OC=O)=O)O)=O,,,5,1,2,0,2
35353_1,,,,2,1,1,2
35355_0,,,,2,1,1,2
C(CC(O)OC(CO)C(C=O)O)=O,,,5,1,5,0,5
35355_1,,,,2,1,1,2
35357_0,,,,2,1,1,2
C(OC(CO)C(C(CC=O)O)O)=O,,,5,1,2,0,2
35357_1,,,,2,1,1,2
35359_0,,,,2,1,1,2
C(C(C=O)(CCOC(C=O)O)O)=O,,,5,1,2,0,2
35359_1,,,,2,1,1,2
35361_0,,,,2,1,1,2
C(C(C=O)(O)OCCC(C=O)O)=O,,,5,1,2,0,2
35361_1,,,,2,1,1,2
35363_0,,,,2,1,1,2
C(C(CCOC(C=O)O)O)=O,,,5,1,2,0,2
35363_1,,,,2,1,1,2
35365_0,,,,2,1,1,2
C(C(OCC(C=O)=O)O)(CCO)=O,,,5,1,4,0,4
35365_1,,,,2,1,1,2
35366_0,,,,2,1,2,3
35366_1,,,,2,1,2,3
35368_0,,,,2,1,1,2
C(C(CO)OC(C(CCO)=O)O)=O,,,5,1,2,0,2
35368_1,,,,2,1,1,2
35369_0,,,,2,1,2,3
35369_1,,,,2,1,2,3
35371_0,,,,2,1,1,2
C(COC(C(CCO)=O)O)=O,,,5,1,2,0,2
35371_1,,,,2,1,1,2
35372_0,,,,2,1,2,3
35372_1,,,,2,1,2,3
35374_0,,,,2,1,1,2
C(C(CC(OCC(C=O)=O)O)O)=O,,,5,1,6,0,6
35374_1,,,,2,1,1,2
35375_0,,,,2,1,1,2
35375_1,,,,2,1,1,2
35377_0,,,,2,1,1,2
C(CC(C(OCC(C=O)=O)O)O)=O,,,5,1,6,0,6
35377_1,,,,2,1,1,2
35379_0,,,,2,1,1,2
C(C(CC(C=O)O)OC(C=O)O)=O,,,5,1,2,0,2
35379_1,,,,2,1,1,2
35381_0,,,,2,1,1,2
C(CC(C(OCC=O)O)O)=O,,,5,1,4,0,4
35381_1,,,,2,1,1,2
35382_0,,,,2,1,1,2
35382_1,,,,2,1,1,2
35383_0,,,,2,1,1,2
35383_1,,,,2,1,1,2
35385_0,,,,2,1,1,2
C(CC(C(OC(C=O)CO)O)O)=O,,,5,1,5,0,5
35385_1,,,,2,1,1,2
35387_0,,,,2,1,1,2
C(CC(C(CO)OC(C=O)O)O)=O,,,5,1,2,0,2
35387_1,,,,2,1,1,2
35388_0,,,,2,1,1,2
35388_1,,,,2,1,1,2
35390_0,,,,2,1,1,2
C(CC(COC(C=O)O)O)=O,,,5,1,2,0,2
35390_1,,,,2,1,1,2
35392_0,,,,2,1,1,2
C(CC(COC(C(CO)=O)O)=O)=O,,,5,1,4,0,4
35392_1,,,,2,1,1,2
35394_0,,,,2,1,2,3
C1(C(O)OCC(C1O)=O)=O,,,5,1,3,0,3
35395_0,,,,2,1,1,2
35395_1,,,,2,1,1,2
35396_0,,,,2,1,1,2
35396_1,,,,2,1,1,2
35398_0,,,,2,1,1,2
C(OCC(C(CC(CO)=O)O)=O)=O,,,5,1,2,0,2
35398_1,,,,2,1,1,2
35399_0,,,,2,1,1,2
35399_1,,,,2,1,1,2
35401_0,,,,2,1,1,2
C(CO)(OCC(C(CC=O)O)=O)=O,,,5,1,2,0,2
35401_1,,,,2,1,1,2
35403_0,,,,2,1,1,2
C(C(CO)(OCC(CC=O)=O)O)=O,,,5,1,2,0,2
35403_1,,,,2,1,1,2
35405_0,,,,2,1,1,2
C(C(COC(CC(CO)=O)O)O)=O,,,5,1,5,0,5
35405_1,,,,2,1,1,2
35407_0,,,,2,1,1,2
C(OCC(C(CC(CO)=O)O)O)=O,,,5,1,2,0,2
35407_1,,,,2,1,1,2
35409_0,,,,2,1,1,2
C(CC(CO)(O)OCC(C=O)O)=O,,,5,1,5,0,5
35409_1,,,,2,1,1,2
35410_0,,,,2,1,1,2
35410_1,,,,2,1,1,2
35412_0,,,,2,1,1,2
C(OC(C)C(C(C)=O)O)=O,,,5,1,1,0,1
35413_0,,,,2,1,2,3
35413_1,,,,2,1,2,3
35413_2,,,,2,1,2,3
35414_0,,,,2,1,1,2
35414_1,,,,2,1,1,2
35414_2,,,,2,1,1,2
35416_0,,,,2,1,1,2
C(C(CO)(C(C(C)=O)O)OC=O)=O,,,5,1,1,0,1
35418_0,,,,2,1,1,2
C(C(CC=O)(O)OCC(CO)=O)=O,,,5,1,2,0,2
35418_1,,,,2,1,1,2
35419_0,,,,2,1,2,3
35420_0,,,,2,1,1,2
35420_1,,,,2,1,1,2
35422_0,,,,2,1,1,2
C(OC(C(CO)=O)C(C(C)=O)O)=O,,,5,1,1,0,1
35423_0,,,,2,1,2,3
35425_0,,,,2,1,1,2
C(OC(C(CO)O)C(C(C)=O)O)=O,,,5,1,1,0,1
35426_0,,,,2,1,1,2
35426_1,,,,2,1,1,2
35428_0,,,,2,1,1,2
C(OC(C=O)C(C(C)=O)O)=O,,,5,1,1,0,1
35430_0,,,,2,1,1,2
C(C(C(C)=O)OC(C(CO)=O)O)=O,,,5,1,5,0,5
35430_1,,,,2,1,1,2
35432_0,,,,2,1,1,2
C(C(C(C(O)OCC(C)=O)=O)O)=O,,,5,1,2,0,2
35432_1,,,,2,1,1,2
35433_0,,,,2,1,1,2
35433_1,,,,2,1,1,2
35435_0,,,,2,1,1,2
C(COC(C(C(C(C)=O)O)=O)O)=O,,,5,1,2,0,2
35435_1,,,,2,1,1,2
35437_0,,,,2,1,1,2
C(OC(C)CC(CO)=O)=O,,,5,1,2,0,2
35437_1,,,,2,1,1,2
35438_0,,,,2,1,1,2
35439_0,,,,2,1,2,3
35439_1,,,,2,1,2,3
35441_0,,,,2,1,1,2
C(C(CO)(CC(CO)=O)OC=O)=O,,,5,1,2,0,2
35441_1,,,,2,1,1,2
35443_0,,,,2,1,2,3
C1(CC(C(CO1)=O)O)=O,,,5,1,5,0,5
35443_1,,,,2,1,2,3
35445_0,,,,2,1,1,2
C(C(CO)(OC(C=O)C(C)=O)O)=O,,,5,1,1,0,1
35447_0,,,,2,1,1,2
C(OC(C(CO)=O)CC(CO)=O)=O,,,5,1,2,0,2
35447_1,,,,2,1,1,2
35448_0,,,,2,1,2,3
35448_1,,,,2,1,2,3
35450_0,,,,2,1,1,2
C(OC(C(CO)O)CC(CO)=O)=O,,,5,1,2,0,2
35450_1,,,,2,1,1,2
35452_0,,,,2,1,1,2
C(C(C(C)=O)OC(C=O)O)=O,,,5,1,1,0,1
35454_0,,,,2,1,1,2
C(OC(C=O)CC(CO)=O)=O,,,5,1,2,0,2
35454_1,,,,2,1,1,2
35455_0,,,,2,1,1,2
35455_1,,,,2,1,1,2
35456_0,,,,2,1,2,3
35456_1,,,,2,1,2,3
35458_0,,,,2,1,1,2
C(C(O)OCC(C=O)=O)(CO)=O,,,5,1,4,0,4
35458_1,,,,2,1,1,2
35460_0,,,,2,1,1,2
C(C(COC(C(C=O)=O)O)O)=O,,,5,1,3,0,3
35460_1,,,,2,1,1,2
35460_2,,,,2,1,1,2
35462_0,,,,2,1,1,2
C(C(C(COC(C=O)O)=O)O)=O,,,5,1,2,0,2
35462_1,,,,2,1,1,2
35464_0,,,,2,1,1,2
C(C(C=O)(O)OCC(CO)=O)=O,,,5,1,2,0,2
35464_1,,,,2,1,1,2
35466_0,,,,2,1,1,2
C(C(CO)OC(C(CO)=O)O)=O,,,5,1,2,0,2
35466_1,,,,2,1,1,2
35467_0,,,,2,1,1,2
35467_1,,,,2,1,1,2
35469_0,,,,2,1,1,2
C(COC(C(CO)=O)O)=O,,,5,1,2,0,2
35469_1,,,,2,1,1,2
35471_0,,,,2,1,1,2
C(C(C(C(O)OC(C=O)=O)O)O)=O,,,5,1,3,0,3
35471_1,,,,2,1,1,2
35471_2,,,,2,1,1,2
35473_0,,,,2,1,1,2
C(C(C(C=O)O)O)(OC(C=O)O)=O,,,5,1,6,0,6
35473_1,,,,2,1,1,2
35473_2,,,,2,1,1,2
35474_0,,,,2,1,1,2
35474_1,,,,2,1,1,2
35474_2,,,,2,1,1,2
35476_0,,,,2,1,1,2
C(COC(CC(C(C=O)=O)O)O)=O,,,5,1,2,0,2
35476_1,,,,2,1,1,2
35477_0,,,,2,1,1,2
35477_1,,,,2,1,1,2
35477_2,,,,2,1,1,2
35478_0,,,,2,1,2,3
35478_1,,,,2,1,2,3
35478_2,,,,2,1,2,3
35480_0,,,,2,1,1,2
C(C(C)(OCC(C(CO)O)=O)O)=O,,,5,1,3,0,3
35480_1,,,,2,1,1,2
35480_2,,,,2,1,1,2
35481_0,,,,2,1,2,3
35481_1,,,,2,1,2,3
35481_2,,,,2,1,2,3
35482_0,,,,2,1,1,2
35482_1,,,,2,1,1,2
35482_2,,,,2,1,1,2
35484_0,,,,2,1,1,2
C(COC(C=O)O)(C(CO)O)=O,,,5,1,3,0,3
35484_1,,,,2,1,1,2
35484_2,,,,2,1,1,2
35485_0,,,,2,1,2,3
35485_1,,,,2,1,2,3
35485_2,,,,2,1,2,3
35486_0,,,,2,1,2,3
35486_1,,,,2,1,2,3
35486_2,,,,2,1,2,3
35488_0,,,,2,1,1,2
C(C(O)OC(C=O)=O)(C(CO)O)=O,,,5,1,3,0,3
35488_1,,,,2,1,1,2
35488_2,,,,2,1,1,2
35490_0,,,,2,1,1,2
C(C(C(C(OCC=O)O)(C)O)O)=O,,,5,1,3,0,3
35490_1,,,,2,1,1,2
35490_2,,,,2,1,1,2
35492_0,,,,2,1,1,2
C(C(C(COC(C(C)=O)O)O)O)=O,,,5,1,3,0,3
35492_1,,,,2,1,1,2
35492_2,,,,2,1,1,2
35494_0,,,,2,1,1,2
C(C(C(C(C)(OCC=O)O)O)O)=O,,,5,1,3,0,3
35494_1,,,,2,1,1,2
35494_2,,,,2,1,1,2
35496_0,,,,2,1,1,2
C(C(C(COC(C=O)(C)O)O)O)=O,,,5,1,3,0,3
35496_1,,,,2,1,1,2
35496_2,,,,2,1,1,2
35497_0,,,,2,1,1,2
35497_1,,,,2,1,1,2
35497_2,,,,2,1,1,2
35498_0,,,,2,1,2,3
35499_0,,,,2,1,1,2
35499_1,,,,2,1,1,2
35499_2,,,,2,1,1,2
35500_0,,,,2,1,1,2
35500_1,,,,2,1,1,2
35500_2,,,,2,1,1,2
35502_0,,,,2,1,1,2
C(C(CCOC(C(CO)=O)O)O)=O,,,5,1,2,0,2
35502_1,,,,2,1,1,2
35503_0,,,,2,1,2,3
35503_1,,,,2,1,2,3
35503_2,,,,2,1,2,3
35504_0,,,,2,1,1,2
35504_1,,,,2,1,1,2
35504_2,,,,2,1,1,2
35505_0,,,,2,1,1,2
35505_1,,,,2,1,1,2
35505_2,,,,2,1,1,2
35506_0,,,,2,1,1,2
35506_1,,,,2,1,1,2
35506_2,,,,2,1,1,2
35508_0,,,,2,1,1,2
C(COC(C(C(C)=O)=O)O)(CO)=O,,,5,1,2,0,2
35508_1,,,,2,1,1,2
35509_0,,,,2,1,1,2
35509_1,,,,2,1,1,2
35509_2,,,,2,1,1,2
35511_0,,,,2,1,1,2
C(OCC(C(C(C(C)=O)O)O)=O)=O,,,5,1,3,0,3
35511_1,,,,2,1,1,2
35511_2,,,,2,1,1,2
35513_0,,,,2,1,1,2
C(CO)(COC(C(C=O)=O)(C)O)=O,,,5,1,2,0,2
35513_1,,,,2,1,1,2
35514_0,,,,2,1,1,2
35514_1,,,,2,1,1,2
35514_2,,,,2,1,1,2
35516_0,,,,2,1,1,2
C(C)(OCC(C(C(C=O)O)O)=O)=O,,,5,1,3,0,3
35516_1,,,,2,1,1,2
35516_2,,,,2,1,1,2
35518_0,,,,2,1,1,2
C(C(COC(C(C(C)=O)O)O)O)=O,,,5,1,6,0,6
35518_1,,,,2,1,1,2
35518_2,,,,2,1,1,2
35520_0,,,,2,1,1,2
C(OCC(C(C(C(C)=O)O)O)O)=O,,,5,1,3,0,3
35520_1,,,,2,1,1,2
35520_2,,,,2,1,1,2
35522_0,,,,2,1,1,2
C(C(C(C)(O)OCC(C=O)O)O)=O,,,5,1,6,0,6
35522_1,,,,2,1,1,2
35522_2,,,,2,1,1,2
35524_0,,,,2,1,1,2
C(C(C(C(COC(C)=O)O)O)O)=O,,,5,1,3,0,3
35524_1,,,,2,1,1,2
35524_2,,,,2,1,1,2
35525_0,,,,2,1,1,2
35525_1,,,,2,1,1,2
35525_2,,,,2,1,1,2
35526_0,,,,2,1,1,2
35526_1,,,,2,1,1,2
35526_2,,,,2,1,1,2
35528_0,,,,2,1,1,2
C(COC(C(C(CO)O)=O)O)=O,,,5,1,3,0,3
35528_1,,,,2,1,1,2
35528_2,,,,2,1,1,2
35529_0,,,,2,1,2,3
35529_1,,,,2,1,2,3
35529_2,,,,2,1,2,3
35530_0,,,,2,1,1,2
35530_1,,,,2,1,1,2
35532_0,,,,2,1,1,2
C(C(CC(O)OC(C=O)=O)O)=O,,,5,1,2,0,2
35532_1,,,,2,1,1,2
35534_0,,,,2,1,1,2
C(C(COC(CC(C=O)=O)O)O)=O,,,5,1,6,0,6
35534_1,,,,2,1,1,2
35534_2,,,,2,1,1,2
35535_0,,,,2,1,1,2
35535_1,,,,2,1,1,2
35537_0,,,,2,1,1,2
C(CC(C(O)OCC(CO)=O)=O)=O,,,5,1,2,0,2
35537_1,,,,2,1,1,2
35538_0,,,,2,1,2,3
35539_0,,,,2,1,1,2
35539_1,,,,2,1,1,2
35540_0,,,,2,1,2,3
35542_0,,,,2,1,1,2
C(C(C(C(O)OCC=O)=O)O)=O,,,5,1,3,0,3
35542_1,,,,2,1,1,2
35542_2,,,,2,1,1,2
35543_0,,,,2,1,1,2
35545_0,,,,2,1,1,2
C(COC(C(CC(C=O)O)=O)O)=O,,,5,1,4,0,4
35545_1,,,,2,1,1,2
35546_0,,,,2,1,1,2
35547_0,,,,2,1,1,2
35547_1,,,,2,1,1,2
35548_0,,,,2,1,1,2
35548_1,,,,2,1,1,2
35549_0,,,,2,1,1,2
35550_0,,,,2,1,1,2
35550_1,,,,2,1,1,2
35552_0,,,,2,1,1,2
C(C(CO)(O)OCCC(CO)=O)=O,,,5,1,2,0,2
35552_1,,,,2,1,1,2
35553_0,,,,2,1,1,2
35554_0,,,,2,1,1,2
35554_1,,,,2,1,1,2
35555_0,,,,2,1,1,2
35555_1,,,,2,1,1,2
35556_0,,,,2,1,1,2
35556_1,,,,2,1,1,2
35557_0,,,,2,1,1,2
35557_1,,,,2,1,1,2
35558_0,,,,2,1,1,2
35559_0,,,,2,1,1,2
35559_1,,,,2,1,1,2
35560_0,,,,2,1,1,2
35560_1,,,,2,1,1,2
35561_0,,,,2,1,1,2
35561_1,,,,2,1,1,2
35562_0,,,,2,1,2,3
35562_1,,,,2,1,2,3
35563_0,,,,2,1,1,2
35563_1,,,,2,1,1,2
35564_0,,,,2,1,1,2
35565_0,,,,2,1,1,2
35565_1,,,,2,1,1,2
35566_0,,,,2,1,1,2
35566_1,,,,2,1,1,2
35567_0,,,,2,1,1,2
35569_0,,,,2,1,1,2
C(C(CC(O)OCC(C=O)O)O)=O,,,5,1,5,0,5
35569_1,,,,2,1,1,2
35569_2,,,,2,1,1,2
35571_0,,,,2,1,1,2
C(C(CO)(COC(C(C)=O)O)O)=O,,,5,1,1,0,1
35572_0,,,,2,1,1,2
35573_0,,,,2,1,1,2
35574_0,,,,2,1,1,2
35575_0,,,,2,1,1,2
35576_0,,,,2,1,1,2
35576_1,,,,2,1,1,2
35577_0,,,,2,1,1,2
35578_0,,,,2,1,2,3
35578_1,,,,2,1,2,3
35579_0,,,,2,1,1,2
35580_0,,,,2,1,1,2
35581_0,,,,2,1,1,2
35581_1,,,,2,1,1,2
35582_0,,,,2,1,1,2
35583_0,,,,2,1,1,2
35583_1,,,,2,1,1,2
35585_0,,,,2,1,1,2
C(CC(C(CCOC=O)=O)O)=O,,,5,1,2,0,2
35585_1,,,,2,1,1,2
35586_0,,,,2,1,1,2
35587_0,,,,2,1,1,2
35587_1,,,,2,1,1,2
35588_0,,,,2,1,1,2
35588_1,,,,2,1,1,2
35589_0,,,,2,1,1,2
35589_1,,,,2,1,1,2
35591_0,,,,2,1,1,2
C(CC(C(C(COC=O)O)=O)O)=O,,,5,1,2,0,2
35591_1,,,,2,1,1,2
35593_0,,,,2,1,1,2
C(CC(O)OCC(C(C=O)O)O)=O,,,5,1,5,0,5
35593_1,,,,2,1,1,2
35595_0,,,,2,1,1,2
C(OCC(C(C(CC=O)O)O)O)=O,,,5,1,2,0,2
35595_1,,,,2,1,1,2
35596_0,,,,2,1,1,2
35596_1,,,,2,1,1,2
35598_0,,,,2,1,1,2
C(C(CCOC(C(C=O)=O)O)O)=O,,,5,1,2,0,2
35598_1,,,,2,1,1,2
35600_0,,,,2,1,1,2
C(CCOC(C=O)O)(C(C=O)O)=O,,,5,1,2,0,2
35600_1,,,,2,1,1,2
35602_0,,,,2,1,1,2
C(C(C=O)(O)OCCC(CO)=O)=O,,,5,1,2,0,2
35602_1,,,,2,1,1,2
35603_0,,,,2,1,1,2
35603_1,,,,2,1,1,2
35604_0,,,,2,1,2,3
35604_1,,,,2,1,2,3
35605_0,,,,2,1,1,2
35605_1,,,,2,1,1,2
35606_0,,,,2,1,2,3
35606_1,,,,2,1,2,3
35607_0,,,,2,1,1,2
35607_1,,,,2,1,1,2
35608_0,,,,2,1,1,2
35608_1,,,,2,1,1,2
35610_0,,,,2,1,1,2
C(C(O)OCC(C(CC=O)O)=O)=O,,,5,1,2,0,2
35610_1,,,,2,1,1,2
35611_0,,,,2,1,1,2
35611_1,,,,2,1,1,2
35612_0,,,,2,1,1,2
35612_1,,,,2,1,1,2
35613_0,,,,2,1,1,2
35615_0,,,,2,1,1,2
C(C(CC(COC(C=O)O)=O)O)=O,,,5,1,2,0,2
35615_1,,,,2,1,1,2
35616_0,,,,2,1,1,2
35617_0,,,,2,1,1,2
35617_1,,,,2,1,1,2
35617_2,,,,2,1,1,2
35618_0,,,,2,1,1,2
35619_0,,,,2,1,1,2
35619_1,,,,2,1,1,2
35620_0,,,,2,1,1,2
35621_0,,,,2,1,1,2
35621_1,,,,2,1,1,2
35622_0,,,,2,1,1,2
35622_1,,,,2,1,1,2
35623_0,,,,2,1,1,2
35624_0,,,,2,1,1,2
35624_1,,,,2,1,1,2
35625_0,,,,2,1,1,2
35626_0,,,,2,1,1,2
35626_1,,,,2,1,1,2
35627_0,,,,2,1,1,2
35627_1,,,,2,1,1,2
35628_0,,,,2,1,1,2
35628_1,,,,2,1,1,2
35629_0,,,,2,1,1,2
35629_1,,,,2,1,1,2
35629_2,,,,2,1,1,2
35630_0,,,,2,1,2,3
35630_1,,,,2,1,2,3
35630_2,,,,2,1,2,3
35632_0,,,,2,1,1,2
C(C(C(CC(OCC=O)O)O)O)=O,,,5,1,3,0,3
35632_1,,,,2,1,1,2
35632_2,,,,2,1,1,2
35633_0,,,,2,1,1,2
35633_1,,,,2,1,1,2
35633_2,,,,2,1,1,2
35635_0,,,,2,1,1,2
C(CO)(CCOC(C(CO)=O)O)=O,,,5,1,2,0,2
35635_1,,,,2,1,1,2
35636_0,,,,2,1,1,2
35636_1,,,,2,1,1,2
35636_2,,,,2,1,1,2
35637_0,,,,2,1,1,2
35638_0,,,,2,1,1,2
35638_1,,,,2,1,1,2
35639_0,,,,2,1,1,2
35639_1,,,,2,1,1,2
35640_0,,,,2,1,1,2
35640_1,,,,2,1,1,2
35642_0,,,,2,1,1,2
C(C(CCOC(C=O)=O)=O)=O,,,5,1,2,0,2
35642_1,,,,2,1,1,2
35644_0,,,,2,1,1,2
C(C(CC=O)OC(C=O)=O)=O,,,5,1,2,0,2
35644_1,,,,2,1,1,2
35646_0,,,,2,1,1,2
C(C(COC(C=O)=O)O)=O,,,5,1,4,0,4
35646_1,,,,2,1,1,2
35646_2,,,,2,1,1,2
35648_0,,,,2,1,1,2
C(C(C(CO)OC(C=O)=O)O)=O,,,5,1,4,0,4
35648_1,,,,2,1,1,2
35648_2,,,,2,1,1,2
35650_0,,,,2,1,1,2
C(C(C(C=O)O)OC(C=O)=O)=O,,,5,1,3,0,3
35650_1,,,,2,1,1,2
35650_2,,,,2,1,1,2
35652_0,,,,2,1,1,2
C(C(C(C=O)=O)O)(OCC=O)=O,,,5,1,2,0,2
35652_1,,,,2,1,1,2
35654_0,,,,2,1,1,2
C(CO)(C(COC(C=O)=O)O)=O,,,5,1,5,0,5
35654_1,,,,2,1,1,2
35654_2,,,,2,1,1,2
35656_0,,,,2,1,1,2
C(C(COC(C(CO)=O)=O)O)=O,,,5,1,5,0,5
35656_1,,,,2,1,1,2
35656_2,,,,2,1,1,2
35658_0,,,,2,1,1,2
C(C=O)(OCC(C(C=O)=O)O)=O,,,5,1,3,0,3
35658_1,,,,2,1,1,2
35658_2,,,,2,1,1,2
35659_0,,,,2,1,2,3
35661_0,,,,2,1,1,2
C(C(C(C)OC(C=O)=O)O)=O,,,5,1,3,0,3
35661_1,,,,2,1,1,2
35661_2,,,,2,1,1,2
35663_0,,,,2,1,2,3
C1(C(C(CO1)=O)(C)O)=O,,,5,1,3,0,3
35664_0,,,,2,1,2,3
35666_0,,,,2,1,1,2
C(C(C=O)(C)O)(OCC(C)=O)=O,,,5,1,3,0,3
35666_1,,,,2,1,1,2
35668_0,,,,2,1,1,2
C(C)(C(C(OCC=O)=O)(C)O)=O,,,5,1,2,0,2
35668_1,,,,2,1,1,2
35669_0,,,,2,1,1,2
35669_1,,,,2,1,1,2
35670_0,,,,2,1,1,2
35670_1,,,,2,1,1,2
35670_2,,,,2,1,1,2
35672_0,,,,2,1,1,2
C(COC(C=O)=O)(CO)=O,,,5,1,2,0,2
35672_1,,,,2,1,1,2
35674_0,,,,2,1,1,2
C(CO)(C(CO)OC(C=O)=O)=O,,,5,1,2,0,2
35674_1,,,,2,1,1,2
35675_0,,,,2,1,2,3
35675_1,,,,2,1,2,3
35677_0,,,,2,1,1,2
C(CC(COC(C=O)=O)=O)=O,,,5,1,2,0,2
35677_1,,,,2,1,1,2
35679_0,,,,2,1,1,2
C(C(C(C)=O)OC(C=O)=O)=O,,,5,1,1,0,1
35681_0,,,,2,1,1,2
C(C(C(C=O)O)O)(OCC=O)=O,,,5,1,8,0,8
35681_1,,,,2,1,1,2
35682_0,,,,2,1,1,2
35682_1,,,,2,1,1,2
35682_2,,,,2,1,1,2
35683_0,,,,2,1,1,2
35683_1,,,,2,1,1,2
35683_2,,,,2,1,1,2
35685_0,,,,2,1,1,2
C(COC(C=O)=O)(C(CO)O)=O,,,5,1,3,0,3
35685_1,,,,2,1,1,2
35685_2,,,,2,1,1,2
35686_0,,,,2,1,2,3
35686_1,,,,2,1,2,3
35686_2,,,,2,1,2,3
35688_0,,,,2,1,1,2
C(COC(C(CO)=O)=O)(CO)=O,,,5,1,2,0,2
35688_1,,,,2,1,1,2
35690_0,,,,2,1,1,2
C(C(CCOC(C(C)=O)=O)O)=O,,,5,1,2,0,2
35690_1,,,,2,1,1,2
35692_0,,,,2,1,1,2
C(C(CCOC(C=O)=O)O)=O,,,5,1,2,0,2
35692_1,,,,2,1,1,2
35694_0,,,,2,1,1,2
C(COC(C(C)=O)=O)(CO)=O,,,5,1,2,0,2
35694_1,,,,2,1,1,2
35696_0,,,,2,1,1,2
C(COC(C(CO)=O)=O)=O,,,5,1,2,0,2
35696_1,,,,2,1,1,2
35698_0,,,,2,1,1,2
C(C(CO)OC(C(CO)=O)=O)=O,,,5,1,2,0,2
35698_1,,,,2,1,1,2
35699_0,,,,2,1,1,2
35699_1,,,,2,1,1,2
35701_0,,,,2,1,1,2
C(CO)(CCOC(C(C)=O)=O)=O,,,5,1,2,0,2
35701_1,,,,2,1,1,2
35702_0,,,,2,1,1,2
35703_0,,,,2,1,1,2
35703_1,,,,2,1,1,2
35704_0,,,,2,1,2,3
35706_0,,,,2,1,2,3
C(CCC(C(O)=O)=O)(O)=O,,,5,1,5,0,5
35707_0,,,,2,1,2,3
35708_0,,,,2,1,2,3
35709_0,,,,2,1,2,3
35710_0,,,,2,1,2,3
35711_0,,,,2,1,2,3
35713_0,,,,2,1,2,3
C(CCC(C)=O)(O)=O,,,5,1,9,0,9
35714_0,,,,2,1,2,3
35715_0,,,,2,1,2,3
35716_0,,,,2,1,2,3
35717_0,,,,2,1,2,3
35719_0,,,,2,1,2,3
C(CC(CCC(O)=O)=O)=O,,,5,1,4,0,4
35720_0,,,,2,1,2,3
35720_1,,,,2,1,2,3
35721_0,,,,2,1,2,3
35721_1,,,,2,1,2,3
35722_0,,,,2,1,2,3
35722_1,,,,2,1,2,3
35723_0,,,,2,1,2,3
35723_1,,,,2,1,2,3
35724_0,,,,2,1,2,3
35725_0,,,,2,1,2,3
35725_1,,,,2,1,2,3
35727_0,,,,2,1,2,3
C(CCC(O)=O)=O,,,5,1,24,0,24
35727_1,,,,2,1,2,3
35728_0,,,,2,1,2,3
35728_1,,,,2,1,2,3
35729_0,,,,2,1,2,3
35729_1,,,,2,1,2,3
35730_0,,,,2,1,2,3
35730_1,,,,2,1,2,3
35731_0,,,,2,1,2,3
35732_0,,,,2,1,2,3
35733_0,,,,2,1,2,3
35734_0,,,,2,1,2,3
35736_0,,,,2,1,2,3
C(C)(CCC(C=O)=O)=O,,,5,1,6,0,6
35737_0,,,,2,1,2,3
35738_0,,,,2,1,2,3
35739_0,,,,2,1,2,3
35741_0,,,,2,1,2,3
C(C)(C(CO)CC(O)=O)=O,,,5,1,2,0,2
35742_0,,,,2,1,2,3
35743_0,,,,2,1,2,3
35744_0,,,,2,1,2,3
35745_0,,,,2,1,2,3
35746_0,,,,2,1,2,3
35746_1,,,,2,1,2,3
35747_0,,,,2,1,2,3
35748_0,,,,2,1,2,3
35748_1,,,,2,1,2,3
35749_0,,,,2,1,2,3
35749_1,,,,2,1,2,3
35750_0,,,,2,1,2,3
35750_1,,,,2,1,2,3
35751_0,,,,2,1,2,3
35752_0,,,,2,1,2,3
35752_1,,,,2,1,2,3
35753_0,,,,2,1,2,3
35753_1,,,,2,1,2,3
35754_0,,,,2,1,2,3
35754_1,,,,2,1,2,3
35755_0,,,,2,1,2,3
35755_1,,,,2,1,2,3
35756_0,,,,2,1,2,3
35756_1,,,,2,1,2,3
35757_0,,,,2,1,2,3
35758_0,,,,2,1,2,3
35759_0,,,,2,1,2,3
35760_0,,,,2,1,2,3
35762_0,,,,2,1,2,3
C(C(CO)CC(O)=O)=O,,,5,1,8,0,8
35763_0,,,,2,1,2,3
35764_0,,,,2,1,2,3
35765_0,,,,2,1,2,3
35766_0,,,,2,1,2,3
35767_0,,,,2,1,2,3
35768_0,,,,2,1,2,3
35769_0,,,,2,1,2,3
35770_0,,,,2,1,2,3
35771_0,,,,2,1,2,3
35772_0,,,,2,1,2,3
35773_0,,,,2,1,2,3
35775_0,,,,2,1,2,3
C(CCC(CO)=O)(O)=O,,,5,1,8,0,8
35776_0,,,,2,1,2,3
35777_0,,,,2,1,2,3
35778_0,,,,2,1,2,3
35779_0,,,,2,1,2,3
35780_0,,,,2,1,2,3
35781_0,,,,2,1,2,3
35782_0,,,,2,1,2,3
35783_0,,,,2,1,2,3
35784_0,,,,2,1,2,3
35785_0,,,,2,1,2,3
35786_0,,,,2,1,2,3
35787_0,,,,2,1,2,3
35788_0,,,,2,1,2,3
35789_0,,,,2,1,2,3
35790_0,,,,2,1,2,3
35791_0,,,,2,1,2,3
35792_0,,,,2,1,2,3
35793_0,,,,2,1,2,3
35794_0,,,,2,1,2,3
35795_0,,,,2,1,2,3
35796_0,,,,2,1,2,3
35797_0,,,,2,1,2,3
35798_0,,,,2,1,2,3
35799_0,,,,2,1,2,3
35800_0,,,,2,1,2,3
35801_0,,,,2,1,2,3
35802_0,,,,2,1,2,3
35803_0,,,,2,1,2,3
35804_0,,,,2,1,2,3
35805_0,,,,2,1,2,3
35806_0,,,,2,1,2,3
35807_0,,,,2,1,2,3
35808_0,,,,2,1,2,3
35809_0,,,,2,1,2,3
35809_1,,,,2,1,2,3
35810_0,,,,2,1,2,3
35811_0,,,,2,1,2,3
35811_1,,,,2,1,2,3
35812_0,,,,2,1,2,3
35812_1,,,,2,1,2,3
35813_0,,,,2,1,2,3
35813_1,,,,2,1,2,3
35814_0,,,,2,1,2,3
35815_0,,,,2,1,2,3
35815_1,,,,2,1,2,3
35816_0,,,,2,1,2,3
35816_1,,,,2,1,2,3
35817_0,,,,2,1,2,3
35817_1,,,,2,1,2,3
35818_0,,,,2,1,2,3
35818_1,,,,2,1,2,3
35819_0,,,,2,1,2,3
35819_1,,,,2,1,2,3
35820_0,,,,2,1,2,3
35821_0,,,,2,1,2,3
35821_1,,,,2,1,2,3
35822_0,,,,2,1,2,3
35822_1,,,,2,1,2,3
35823_0,,,,2,1,2,3
35823_1,,,,2,1,2,3
35824_0,,,,2,1,2,3
35824_1,,,,2,1,2,3
35825_0,,,,2,1,2,3
35826_0,,,,2,1,2,3
35827_0,,,,2,1,2,3
35827_1,,,,2,1,2,3
35828_0,,,,2,1,2,3
35828_1,,,,2,1,2,3
35829_0,,,,2,1,2,3
35830_0,,,,2,1,2,3
35830_1,,,,2,1,2,3
35831_0,,,,2,1,2,3
35832_0,,,,2,1,2,3
35832_1,,,,2,1,2,3
35833_0,,,,2,1,2,3
35834_0,,,,2,1,2,3
35835_0,,,,2,1,2,3
35837_0,,,,2,1,1,2
C(COC=O)(CCCC(C=O)=O)=O,,,5,1,2,0,2
35839_0,,,,2,1,1,2
C(OCC(CC(C=O)CC=O)=O)=O,,,5,1,2,0,2
35841_0,,,,2,1,1,2
C(CCCC(COC=O)=O)(O)=O,,,5,1,2,0,2
35843_0,,,,2,1,1,2
C(CCC(C=O)=O)(OCC(C)=O)=O,,,5,1,1,0,1
35844_0,,,,2,1,2,3
35846_0,,,,2,1,1,2
C(C(C(OCC(C)=O)=O)CC=O)=O,,,5,1,1,0,1
35848_0,,,,2,1,1,2
C(CCC(O)=O)(OCC(C)=O)=O,,,5,1,1,0,1
35850_0,,,,2,1,1,2
C(C)(C(CCC(C=O)=O)OC=O)=O,,,5,1,2,0,2
35852_0,,,,2,1,1,2
C(OC(C(C)=O)C(C=O)CC=O)=O,,,5,1,2,0,2
35854_0,,,,2,1,1,2
C(CCC(C(C)=O)OC=O)(O)=O,,,5,1,2,0,2
35855_0,,,,2,1,2,3
35855_1,,,,2,1,2,3
35856_0,,,,2,1,2,3
35856_1,,,,2,1,2,3
35857_0,,,,2,1,2,3
35858_0,,,,2,1,2,3
35859_0,,,,2,1,2,3
35860_0,,,,2,1,2,3
35861_0,,,,2,1,2,3
35862_0,,,,2,1,2,3
35863_0,,,,2,1,2,3
35864_0,,,,2,1,2,3
35865_0,,,,2,1,2,3
35866_0,,,,2,1,2,3
35867_0,,,,2,1,2,3
35868_0,,,,2,1,2,3
35868_1,,,,2,1,2,3
35869_0,,,,2,1,2,3
35870_0,,,,2,1,2,3
35871_0,,,,2,1,2,3
35872_0,,,,2,1,2,3
35873_0,,,,2,1,2,3
35874_0,,,,2,1,2,3
35875_0,,,,2,1,2,3
35876_0,,,,2,1,2,3
35877_0,,,,2,1,2,3
35878_0,,,,2,1,2,3
35879_0,,,,2,1,2,3
35880_0,,,,2,1,2,3
35881_0,,,,2,1,2,3
35882_0,,,,2,1,2,3
35882_1,,,,2,1,2,3
35883_0,,,,2,1,2,3
35883_1,,,,2,1,2,3
35884_0,,,,2,1,2,3
35884_1,,,,2,1,2,3
35885_0,,,,2,1,2,3
35885_1,,,,2,1,2,3
35886_0,,,,2,1,2,3
35886_1,,,,2,1,2,3
35887_0,,,,2,1,2,3
35887_1,,,,2,1,2,3
35888_0,,,,2,1,2,3
35888_1,,,,2,1,2,3
35889_0,,,,2,1,2,3
35889_1,,,,2,1,2,3
35890_0,,,,2,1,2,3
35890_1,,,,2,1,2,3
35891_0,,,,2,1,2,3
35891_1,,,,2,1,2,3
35892_0,,,,2,1,2,3
35892_1,,,,2,1,2,3
35892_2,,,,2,1,2,3
35893_0,,,,2,1,2,3
35893_1,,,,2,1,2,3
35893_2,,,,2,1,2,3
35894_0,,,,2,1,2,3
35895_0,,,,2,1,2,3
35896_0,,,,2,1,2,3
35897_0,,,,2,1,2,3
35898_0,,,,2,1,2,3
35899_0,,,,2,1,2,3
35899_1,,,,2,1,2,3
35900_0,,,,2,1,2,3
35901_0,,,,2,1,2,3
35901_1,,,,2,1,2,3
35902_0,,,,2,1,2,3
35903_0,,,,2,1,2,3
35903_1,,,,2,1,2,3
35904_0,,,,2,1,2,3
35904_1,,,,2,1,2,3
35905_0,,,,2,1,2,3
35906_0,,,,2,1,2,3
35906_1,,,,2,1,2,3
35907_0,,,,2,1,2,3
35908_0,,,,2,1,2,3
35908_1,,,,2,1,2,3
35908_2,,,,2,1,2,3
35909_0,,,,2,1,2,3
35909_1,,,,2,1,2,3
35909_2,,,,2,1,2,3
35910_0,,,,2,1,2,3
35911_0,,,,2,1,2,3
35912_0,,,,2,1,2,3
35913_0,,,,2,1,2,3
35914_0,,,,2,1,2,3
35914_1,,,,2,1,2,3
35915_0,,,,2,1,2,3
35916_0,,,,2,1,2,3
35916_1,,,,2,1,2,3
35917_0,,,,2,1,2,3
35917_1,,,,2,1,2,3
35918_0,,,,2,1,2,3
35919_0,,,,2,1,2,3
35920_0,,,,2,1,2,3
35920_1,,,,2,1,2,3
35921_0,,,,2,1,2,3
35921_1,,,,2,1,2,3
35922_0,,,,2,1,2,3
35923_0,,,,2,1,1,2
35924_0,,,,2,1,1,2
35925_0,,,,2,1,1,2
35926_0,,,,2,1,1,2
35928_0,,,,2,1,1,2
C1(C(C(C(C1(CCO)O)O)O)O)=O,,,5,1,1,0,1
35929_0,,,,2,1,1,2
35930_0,,,,2,1,1,2
35931_0,,,,2,1,1,2
35932_0,,,,2,1,1,2
35934_0,,,,2,1,1,2
C1(C(C(C(CO)(CC1O)O)O)O)=O,,,5,1,2,0,2
35936_0,,,,2,1,1,2
C1(C(C(C(CC1(CO)O)O)O)O)=O,,,5,1,1,0,1
35938_0,,,,2,1,1,2
C1(C(CC(C(C1(CO)O)O)O)O)=O,,,5,1,3,0,3
35939_0,,,,2,1,1,2
35941_0,,,,2,1,1,2
C1(C(C(C(C(C1(C)O)O)O)O)O)=O,,,5,1,1,0,1
35942_0,,,,2,1,1,2
35943_0,,,,2,1,1,2
35944_0,,,,2,1,1,2
35945_0,,,,2,1,1,2
35946_0,,,,2,1,1,2
35947_0,,,,2,1,1,2
35948_0,,,,2,1,1,2
35949_0,,,,2,1,1,2
35951_0,,,,2,1,1,2
C1(C(CC(C(C1)=O)O)O)=O,,,5,1,1,0,1
35952_0,,,,2,1,1,2
35953_0,,,,2,1,1,2
35955_0,,,,2,1,1,2
C1(C(C(CO)C(C(C1)=O)O)O)=O,,,5,1,1,0,1
35957_0,,,,2,1,1,2
C1(C(CC(C(C1CO)=O)O)O)=O,,,5,1,1,0,1
35959_0,,,,2,1,1,2
C(C1C(C(CC(C1O)O)O)=O)=O,,,5,1,1,0,1
35960_0,,,,2,1,1,2
35961_0,,,,2,1,1,2
35962_0,,,,2,1,1,2
35963_0,,,,2,1,1,2
35964_0,,,,2,1,1,2
35965_0,,,,2,1,1,2
35966_0,,,,2,1,1,2
35967_0,,,,2,1,1,2
35968_0,,,,2,1,1,2
35969_0,,,,2,1,1,2
35970_0,,,,2,1,1,2
35971_0,,,,2,1,1,2
35972_0,,,,2,1,1,2
35973_0,,,,2,1,1,2
35974_0,,,,2,1,1,2
35976_0,,,,2,1,1,2
C1(C(CC(C(C1O)=O)O)O)=O,,,5,1,1,0,1
35977_0,,,,2,1,1,2
35978_0,,,,2,1,1,2
35980_0,,,,2,1,1,2
C(C1(C(C(CC(C1)O)O)=O)O)=O,,,5,1,1,0,1
35982_0,,,,2,1,1,2
C(C1(CC(C(C(C1)O)=O)O)O)=O,,,5,1,1,0,1
35983_0,,,,2,1,1,2
35984_0,,,,2,1,1,2
35985_0,,,,2,1,1,2
35986_0,,,,2,1,1,2
35987_0,,,,2,1,1,2
35988_0,,,,2,1,1,2
35989_0,,,,2,1,1,2
35990_0,,,,2,1,1,2
35991_0,,,,2,1,1,2
35993_0,,,,2,1,1,2
C1(C(C(C(C(C1CO)=O)O)O)O)=O,,,5,1,1,0,1
35994_0,,,,2,1,1,2
35996_0,,,,2,1,1,2
C1(C(C(CO)C(C(C1O)=O)O)O)=O,,,5,1,1,0,1
35997_0,,,,2,1,1,2
35998_0,,,,2,1,1,2
36000_0,,,,2,1,1,2
C(C1(C(C(C(C1CO)O)O)=O)O)=O,,,5,1,1,0,1
36001_0,,,,2,1,1,2
36002_0,,,,2,1,1,2
36003_0,,,,2,1,1,2
36004_0,,,,2,1,1,2
36005_0,,,,2,1,1,2
36007_0,,,,2,1,1,2
C1(C(CC(CC1O)O)O)=O,,,5,1,1,0,1
36009_0,,,,2,1,1,2
C(C1(C(C(CC(C1O)O)O)=O)O)=O,,,5,1,3,0,3
36011_0,,,,2,1,1,2
C1(C(C(C(C1C(CO)=O)O)O)O)=O,,,5,1,1,0,1
36012_0,,,,2,1,1,2
36013_0,,,,2,1,1,2
36015_0,,,,2,1,1,2
C1(CC(C(C(C(C1O)=O)O)O)O)=O,,,5,1,1,0,1
36016_0,,,,2,1,1,2
36017_0,,,,2,1,1,2
36018_0,,,,2,1,1,2
36019_0,,,,2,1,1,2
36020_0,,,,2,1,1,2
36021_0,,,,2,1,1,2
36022_0,,,,2,1,1,2
36023_0,,,,2,1,1,2
36024_0,,,,2,1,1,2
36025_0,,,,2,1,1,2
36027_0,,,,2,1,1,2
C(C1(C(C(C(C(C1)O)=O)O)O)O)=O,,,5,1,3,0,3
36029_0,,,,2,1,1,2
C1(C(C(C(C(C(C1)=O)O)O)O)O)=O,,,5,1,1,0,1
36030_0,,,,2,1,1,2
36031_0,,,,2,1,1,2
36032_0,,,,2,1,1,2
36033_0,,,,2,1,1,2
36034_0,,,,2,1,1,2
36035_0,,,,2,1,1,2
36036_0,,,,2,1,1,2
36037_0,,,,2,1,1,2
36038_0,,,,2,1,1,2
36039_0,,,,2,1,1,2
36041_0,,,,2,1,1,2
C1(C(C(CC1O)O)(C(C=O)O)O)=O,,,5,1,5,0,5
36042_0,,,,2,1,1,2
36043_0,,,,2,1,1,2
36044_0,,,,2,1,1,2
36046_0,,,,2,1,1,2
C1(C(CC(CO)(C1(CO)O)O)O)=O,,,5,1,4,0,4
36048_0,,,,2,1,1,2
C1(C(C(CO)(C(CC1O)O)O)O)=O,,,5,1,2,0,2
36049_0,,,,2,1,1,2
36051_0,,,,2,1,1,2
C1(C(CC(C1(C(C)=O)O)O)O)=O,,,5,1,3,0,3
36053_0,,,,2,1,1,2
C(C1(C(C(CC1(C)O)O)=O)O)=O,,,5,1,1,0,1
36054_0,,,,2,1,1,2
36056_0,,,,2,1,1,2
C1(C(C(CO)(C(C(C1)=O)O)O)O)=O,,,5,1,1,0,1
36058_0,,,,2,1,1,2
C1(C(CC(C(C1(CO)O)=O)O)O)=O,,,5,1,1,0,1
36059_0,,,,2,1,1,2
36061_0,,,,2,1,1,2
C1(C(CC(C1(C(CO)O)O)O)O)=O,,,5,1,5,0,5
36062_0,,,,2,1,1,2
36064_0,,,,2,1,1,2
C1(C(C(CO)C(C1(CO)O)O)O)=O,,,5,1,4,0,4
36065_0,,,,2,1,1,2
36067_0,,,,2,1,1,2
C1(C(C(C(C1(C(C)=O)O)O)O)O)=O,,,5,1,1,0,1
36068_0,,,,2,1,1,2
36069_0,,,,2,1,1,2
36070_0,,,,2,1,1,2
36072_0,,,,2,1,1,2
C1(C(C(CC1O)O)(CC=O)O)=O,,,5,1,2,0,2
36074_0,,,,2,1,1,2
C(C1(C(C(C(C(C1)O)O)O)=O)O)=O,,,5,1,1,0,1
36075_0,,,,2,1,1,2
36076_0,,,,2,1,1,2
36078_0,,,,2,1,1,2
C(CO)(C(CC(CO)(CO)O)O)=O,,,5,1,3,0,3
36079_0,,,,2,1,1,2
36080_0,,,,2,1,1,2
36081_0,,,,2,1,1,2
36082_0,,,,2,1,1,2
36083_0,,,,2,1,1,2
36084_0,,,,2,1,1,2
36085_0,,,,2,1,1,2
36086_0,,,,2,1,1,2
36087_0,,,,2,1,1,2
36088_0,,,,2,1,1,2
36089_0,,,,2,1,1,2
36090_0,,,,2,1,1,2
36091_0,,,,2,1,1,2
36092_0,,,,2,1,1,2
36093_0,,,,2,1,1,2
36094_0,,,,2,1,1,2
36095_0,,,,2,1,1,2
36096_0,,,,2,1,1,2
36097_0,,,,2,1,1,2
36098_0,,,,2,1,1,2
36099_0,,,,2,1,1,2
36100_0,,,,2,1,1,2
36102_0,,,,2,1,1,2
C(C(C)(CC(C(CC=O)=O)O)O)=O,,,5,1,1,0,1
36104_0,,,,2,1,1,2
C(C(C)(CC(C(C(C)O)=O)O)O)=O,,,5,1,1,0,1
36106_0,,,,2,1,1,2
C(C(C)(CC(CC(C=O)O)O)O)=O,,,5,1,2,0,2
36108_0,,,,2,1,1,2
C(C(C)(CC(C(CO)=O)O)O)=O,,,5,1,3,0,3
36109_0,,,,2,1,1,2
36110_0,,,,2,1,1,2
36111_0,,,,2,1,1,2
36112_0,,,,2,1,1,2
36113_0,,,,2,1,1,2
36114_0,,,,2,1,1,2
36115_0,,,,2,1,1,2
36116_0,,,,2,1,1,2
36117_0,,,,2,1,1,2
36119_0,,,,2,1,1,2
C(C(CC(C(C)=O)O)O)(CC=O)=O,,,5,1,1,0,1
36120_0,,,,2,1,1,2
36121_0,,,,2,1,1,2
36122_0,,,,2,1,1,2
36124_0,,,,2,1,1,2
C(CC(C(CC(C=O)=O)=O)O)(O)=O,,,5,1,2,0,2
36126_0,,,,2,1,1,2
C(C(CC(C)O)O)(CC(C=O)=O)=O,,,5,1,1,0,1
36127_0,,,,2,1,1,2
36129_0,,,,2,1,1,2
C(C(C=O)C(C(CC(O)=O)O)=O)=O,,,5,1,1,0,1
36131_0,,,,2,1,1,2
C(C(C=O)C(C(CC(C)O)O)=O)=O,,,5,1,1,0,1
36132_0,,,,2,1,1,2
36134_0,,,,2,1,1,2
C(C(C)O)(C(CC(C(C)=O)O)O)=O,,,5,1,1,0,1
36135_0,,,,2,1,1,2
36137_0,,,,2,1,1,2
C(C(CC(CC(C(C)=O)O)O)O)=O,,,5,1,2,0,2
36138_0,,,,2,1,1,2
36139_0,,,,2,1,1,2
36140_0,,,,2,1,1,2
36141_0,,,,2,1,1,2
36143_0,,,,2,1,1,2
C(C)(C(CC(C(CO)=O)O)O)=O,,,5,1,3,0,3
36144_0,,,,2,1,1,2
36146_0,,,,2,1,1,2
C(CC(C(C(C(C)O)=O)(C)O)O)=O,,,5,1,1,0,1
36147_0,,,,2,1,1,2
36148_0,,,,2,1,1,2
36149_0,,,,2,1,1,2
36150_0,,,,2,1,1,2
36151_0,,,,2,1,1,2
36152_0,,,,2,1,1,2
36153_0,,,,2,1,1,2
36154_0,,,,2,1,1,2
36155_0,,,,2,1,1,2
36156_0,,,,2,1,1,2
36158_0,,,,2,1,1,2
C(CC(C(CC(CCO)O)O)=O)=O,,,5,1,1,0,1
36160_0,,,,2,1,1,2
C(CC(C(CC(CO)(C)O)O)=O)=O,,,5,1,1,0,1
36162_0,,,,2,1,1,2
C(CC(C(CC(O)=O)O)=O)=O,,,5,1,5,0,5
36164_0,,,,2,1,1,2
C(CC(C(CC(C(O)O)O)O)=O)=O,,,5,1,1,0,1
36166_0,,,,2,1,1,2
C(CC(C(CC(C(C)O)O)O)=O)=O,,,5,1,1,0,1
36167_0,,,,2,1,1,2
36169_0,,,,2,1,1,2
C(CC(C(CC(C=O)O)O)=O)=O,,,5,1,6,0,6
36170_0,,,,2,1,1,2
36172_0,,,,2,1,1,2
C(CC(C(CC(C)O)O)=O)=O,,,5,1,1,0,1
36174_0,,,,2,1,1,2
C(CC(C(CC(CO)O)O)=O)=O,,,5,1,1,0,1
36175_0,,,,2,1,1,2
36176_0,,,,2,1,1,2
36177_0,,,,2,1,1,2
36178_0,,,,2,1,1,2
36180_0,,,,2,1,1,2
C(C(C(C(CC(O)=O)O)=O)O)=O,,,5,1,6,0,6
36181_0,,,,2,1,1,2
36182_0,,,,2,1,1,2
36183_0,,,,2,1,1,2
36184_0,,,,2,1,1,2
36186_0,,,,2,1,1,2
C(C(C(C(CC(C)O)O)=O)O)=O,,,5,1,2,0,2
36187_0,,,,2,1,1,2
36189_0,,,,2,1,1,2
C(C(C(C(CC(CO)O)O)=O)O)=O,,,5,1,4,0,4
36191_0,,,,2,1,1,2
C(C(C(C(C)O)=O)(CC(C)O)O)=O,,,5,1,1,0,1
36193_0,,,,2,1,1,2
C(C(CC(C=O)O)(CC(C)O)O)=O,,,5,1,2,0,2
36195_0,,,,2,1,1,2
C(C(C(CO)=O)(CC(C)O)O)=O,,,5,1,1,0,1
36197_0,,,,2,1,1,2
C(C(C(C(CC(C)O)O)=O)CO)=O,,,5,1,1,0,1
36199_0,,,,2,1,1,2
C(CC(C)O)(C(C(C(C)O)=O)O)=O,,,5,1,1,0,1
36201_0,,,,2,1,1,2
C(C(CC(C)O)O)(C(C(C)=O)O)=O,,,5,1,2,0,2
36202_0,,,,2,1,1,2
36204_0,,,,2,1,1,2
C(C(CC(C)O)O)(CC(CO)=O)=O,,,5,1,1,0,1
36205_0,,,,2,1,1,2
36206_0,,,,2,1,1,2
36208_0,,,,2,1,1,2
C(C(CC(C=O)(C(CO)=O)O)O)=O,,,5,1,1,0,1
36209_0,,,,2,1,1,2
36210_0,,,,2,1,1,2
36211_0,,,,2,1,1,2
36212_0,,,,2,1,1,2
36214_0,,,,2,1,1,2
C(C(C(CO)=O)(CC(CO)O)O)=O,,,5,1,2,0,2
36215_0,,,,2,1,1,2
36216_0,,,,2,1,1,2
36217_0,,,,2,1,1,2
36218_0,,,,2,1,1,2
36219_0,,,,2,1,1,2
36220_0,,,,2,1,1,2
36221_0,,,,2,1,1,2
36222_0,,,,2,1,1,2
36223_0,,,,2,1,1,2
36224_0,,,,2,1,1,2
36225_0,,,,2,1,1,2
36226_0,,,,2,1,1,2
36227_0,,,,2,1,1,2
36228_0,,,,2,1,1,2
36229_0,,,,2,1,1,2
36230_0,,,,2,1,1,2
36231_0,,,,2,1,1,2
36232_0,,,,2,1,1,2
36233_0,,,,2,1,1,2
36234_0,,,,2,1,1,2
36236_0,,,,2,1,1,2
C(C(CO)C(C(CC=O)=O)O)(O)=O,,,5,1,4,0,4
36238_0,,,,2,1,1,2
C(CC(C(C(CO)C(C)O)O)=O)=O,,,5,1,2,0,2
36240_0,,,,2,1,1,2
C(CC(C(C(CO)CO)O)=O)=O,,,5,1,2,0,2
36241_0,,,,2,1,1,2
36243_0,,,,2,1,1,2
C(C(C(C(C(CO)CO)O)=O)O)=O,,,5,1,3,0,3
36245_0,,,,2,1,1,2
C(C(C(CO)=O)(C(CO)CO)O)=O,,,5,1,2,0,2
36246_0,,,,2,1,1,2
36247_0,,,,2,1,1,2
36248_0,,,,2,1,1,2
36249_0,,,,2,1,1,2
36250_0,,,,2,1,1,2
36251_0,,,,2,1,1,2
36252_0,,,,2,1,1,2
36253_0,,,,2,1,1,2
36254_0,,,,2,1,1,2
36255_0,,,,2,1,1,2
36256_0,,,,2,1,1,2
36257_0,,,,2,1,1,2
36258_0,,,,2,1,1,2
36259_0,,,,2,1,1,2
36260_0,,,,2,1,1,2
36261_0,,,,2,1,1,2
36262_0,,,,2,1,1,2
36263_0,,,,2,1,1,2
36264_0,,,,2,1,1,2
36265_0,,,,2,1,1,2
36266_0,,,,2,1,1,2
36267_0,,,,2,1,1,2
36268_0,,,,2,1,1,2
36269_0,,,,2,1,1,2
36270_0,,,,2,1,1,2
36271_0,,,,2,1,1,2
36272_0,,,,2,1,1,2
36273_0,,,,2,1,1,2
36274_0,,,,2,1,1,2
36275_0,,,,2,1,1,2
36276_0,,,,2,1,1,2
36277_0,,,,2,1,1,2
36278_0,,,,2,1,1,2
36279_0,,,,2,1,1,2
36280_0,,,,2,1,1,2
36282_0,,,,2,1,1,2
C(CC(C(C(CC=O)O)=O)O)(O)=O,,,5,1,3,0,3
36283_0,,,,2,1,1,2
36284_0,,,,2,1,1,2
36285_0,,,,2,1,1,2
36286_0,,,,2,1,1,2
36287_0,,,,2,1,1,2
36288_0,,,,2,1,1,2
36289_0,,,,2,1,1,2
36290_0,,,,2,1,1,2
36291_0,,,,2,1,1,2
36292_0,,,,2,1,1,2
36294_0,,,,2,1,1,2
C(C(C(C)O)C(C(C=O)=O)O)(O)=O,,,5,1,2,0,2
36295_0,,,,2,1,1,2
36297_0,,,,2,1,1,2
C(C(C(C(C(C)O)C(C)O)O)=O)=O,,,5,1,1,0,1
36298_0,,,,2,1,1,2
36300_0,,,,2,1,1,2
C(C(C(C(CO)C(C)O)O)=O)=O,,,5,1,1,0,1
36301_0,,,,2,1,1,2
36302_0,,,,2,1,1,2
36303_0,,,,2,1,1,2
36304_0,,,,2,1,1,2
36305_0,,,,2,1,1,2
36306_0,,,,2,1,1,2
36308_0,,,,2,1,1,2
C(C(CO)C(C(C=O)=O)O)(O)=O,,,5,1,3,0,3
36309_0,,,,2,1,1,2
36311_0,,,,2,1,1,2
C(C(C(C(CO)CO)O)=O)=O,,,5,1,3,0,3
36312_0,,,,2,1,1,2
36314_0,,,,2,1,1,2
C(C(C(C(CO)C(CO)O)O)=O)=O,,,5,1,2,0,2
36315_0,,,,2,1,1,2
36316_0,,,,2,1,1,2
36318_0,,,,2,1,1,2
C(C(CC(C)O)O)(C(C)O)=O,,,5,1,1,0,1
36320_0,,,,2,1,1,2
C(C(CC(CC(C)O)O)O)=O,,,5,1,2,0,2
36322_0,,,,2,1,1,2
C(C(CC(C)O)O)(C(CCO)O)=O,,,5,1,1,0,1
36324_0,,,,2,1,1,2
C(C(C(CO)C(CC(C)O)O)O)=O,,,5,1,3,0,3
36326_0,,,,2,1,1,2
C(CO)(C(CC(CC(C)O)O)O)=O,,,5,1,1,0,1
36328_0,,,,2,1,1,2
C(C(C(C(CC(C)O)O)=O)O)(O)=O,,,5,1,2,0,2
36330_0,,,,2,1,1,2
C1(COC(C(CC(C)O)O)C1O)=O,,,5,1,1,0,1
36332_0,,,,2,1,1,2
C1(C(C(CO1)C(CC(C)O)O)O)=O,,,5,1,1,0,1
36334_0,,,,2,1,1,2
C(C(CC(C)O)O)(C(CO)O)=O,,,5,1,1,0,1
36335_0,,,,2,1,1,2
36336_0,,,,2,1,1,2
36337_0,,,,2,1,1,2
36338_0,,,,2,1,1,2
36339_0,,,,2,1,1,2
36341_0,,,,2,1,1,2
C(C(C(CC(CC(C)O)O)O)=O)=O,,,5,1,1,0,1
36342_0,,,,2,1,1,2
36344_0,,,,2,1,1,2
C(CO)(C(CC(C)O)O)=O,,,5,1,3,0,3
36345_0,,,,2,1,1,2
36346_0,,,,2,1,1,2
36347_0,,,,2,1,1,2
36348_0,,,,2,1,1,2
36349_0,,,,2,1,1,2
36350_0,,,,2,1,1,2
36351_0,,,,2,1,1,2
36352_0,,,,2,1,1,2
36353_0,,,,2,1,1,2
36354_0,,,,2,1,1,2
36355_0,,,,2,1,1,2
36356_0,,,,2,1,1,2
36358_0,,,,2,1,1,2
C(C(CC(C(C(C)O)O)O)O)=O,,,5,1,2,0,2
36359_0,,,,2,1,1,2
36360_0,,,,2,1,1,2
36361_0,,,,2,1,1,2
36362_0,,,,2,1,1,2
36364_0,,,,2,1,1,2
C(C(CO)(CC(C(CO)=O)O)O)=O,,,5,1,5,0,5
36365_0,,,,2,1,1,2
36366_0,,,,2,1,1,2
36368_0,,,,2,1,1,2
C(CO)(C(CC(C(CO)=O)O)O)=O,,,5,1,4,0,4
36369_0,,,,2,1,1,2
36370_0,,,,2,1,1,2
36371_0,,,,2,1,1,2
36372_0,,,,2,1,1,2
36373_0,,,,2,1,1,2
36374_0,,,,2,1,1,2
36375_0,,,,2,1,1,2
36376_0,,,,2,1,1,2
36377_0,,,,2,1,1,2
36378_0,,,,2,1,1,2
36379_0,,,,2,1,1,2
36380_0,,,,2,1,1,2
36381_0,,,,2,1,1,2
36382_0,,,,2,1,1,2
36383_0,,,,2,1,1,2
36384_0,,,,2,1,1,2
36385_0,,,,2,1,1,2
36387_0,,,,2,1,1,2
C(CO)(C(CC(C(CO)O)O)O)=O,,,5,1,5,0,5
36388_0,,,,2,1,1,2
36389_0,,,,2,1,1,2
36390_0,,,,2,1,1,2
36392_0,,,,2,1,1,2
C(C(CCO)O)(C(C(C)=O)O)=O,,,5,1,3,0,3
36393_0,,,,2,1,1,2
36394_0,,,,2,1,1,2
36395_0,,,,2,1,1,2
36397_0,,,,2,1,1,2
C(C(CCO)O)(C(CCO)O)=O,,,5,1,1,0,1
36399_0,,,,2,1,1,2
C(C(C(CO)C(CCO)O)O)=O,,,5,1,4,0,4
36401_0,,,,2,1,1,2
C(CO)(C(CC(CCO)O)O)=O,,,5,1,2,0,2
36402_0,,,,2,1,1,2
36404_0,,,,2,1,1,2
C(CC(C(C(CCO)O)=O)O)(O)=O,,,5,1,2,0,2
36406_0,,,,2,1,1,2
C(C(C(CC(CCO)O)O)=O)(O)=O,,,5,1,1,0,1
36407_0,,,,2,1,1,2
36409_0,,,,2,1,1,2
C1(COC(C(CCO)O)C1O)=O,,,5,1,1,0,1
36411_0,,,,2,1,1,2
C1(C(C(CO1)C(CCO)O)O)=O,,,5,1,1,0,1
36412_0,,,,2,1,1,2
36413_0,,,,2,1,1,2
36414_0,,,,2,1,1,2
36415_0,,,,2,1,1,2
36416_0,,,,2,1,1,2
36417_0,,,,2,1,1,2
36418_0,,,,2,1,1,2
36419_0,,,,2,1,1,2
36421_0,,,,2,1,1,2
C(C(C(CC(CCO)O)O)=O)=O,,,5,1,2,0,2
36422_0,,,,2,1,1,2
36423_0,,,,2,1,1,2
36424_0,,,,2,1,1,2
36425_0,,,,2,1,1,2
36426_0,,,,2,1,1,2
36427_0,,,,2,1,1,2
36428_0,,,,2,1,1,2
36429_0,,,,2,1,1,2
36430_0,,,,2,1,1,2
36431_0,,,,2,1,1,2
36433_0,,,,2,1,1,2
C(CC(C(C(C=O)CO)=O)O)(O)=O,,,5,1,2,0,2
36434_0,,,,2,1,1,2
36435_0,,,,2,1,1,2
36437_0,,,,2,1,1,2
C(C(CC(CO)O)O)(C(C)O)=O,,,5,1,1,0,1
36439_0,,,,2,1,1,2
C(C(CC(CC(CO)O)O)O)=O,,,5,1,3,0,3
36441_0,,,,2,1,1,2
C(C(CC(CO)O)O)(C(CO)O)=O,,,5,1,2,0,2
36442_0,,,,2,1,1,2
36443_0,,,,2,1,1,2
36445_0,,,,2,1,1,2
C(CO)(C(CC(CO)O)O)=O,,,5,1,4,0,4
36446_0,,,,2,1,1,2
36447_0,,,,2,1,1,2
36448_0,,,,2,1,1,2
36449_0,,,,2,1,1,2
36450_0,,,,2,1,1,2
36451_0,,,,2,1,1,2
36453_0,,,,2,1,1,2
C(C(C(C(C(C(C)O)=O)O)=O)O)=O,,,5,1,2,0,2
36454_0,,,,2,1,1,2
36455_0,,,,2,1,1,2
36456_0,,,,2,1,1,2
36457_0,,,,2,1,1,2
36458_0,,,,2,1,1,2
36459_0,,,,2,1,1,2
36460_0,,,,2,1,1,2
36461_0,,,,2,1,1,2
36462_0,,,,2,1,1,2
36463_0,,,,2,1,1,2
36464_0,,,,2,1,1,2
36465_0,,,,2,1,1,2
36466_0,,,,2,1,1,2
36467_0,,,,2,1,1,2
36468_0,,,,2,1,1,2
36469_0,,,,2,1,1,2
36470_0,,,,2,1,1,2
36471_0,,,,2,1,1,2
36472_0,,,,2,1,1,2
36473_0,,,,2,1,1,2
36474_0,,,,2,1,1,2
36475_0,,,,2,1,1,2
36476_0,,,,2,1,1,2
36477_0,,,,2,1,1,2
36478_0,,,,2,1,1,2
36479_0,,,,2,1,1,2
36480_0,,,,2,1,1,2
36481_0,,,,2,1,1,2
36482_0,,,,2,1,1,2
36483_0,,,,2,1,1,2
36484_0,,,,2,1,1,2
36485_0,,,,2,1,1,2
36486_0,,,,2,1,1,2
36487_0,,,,2,1,1,2
36488_0,,,,2,1,1,2
36489_0,,,,2,1,1,2
36490_0,,,,2,1,1,2
36491_0,,,,2,1,1,2
36492_0,,,,2,1,1,2
36493_0,,,,2,1,1,2
36494_0,,,,2,1,1,2
36495_0,,,,2,1,1,2
36496_0,,,,2,1,1,2
36497_0,,,,2,1,1,2
36499_0,,,,2,1,1,2
C(C(C(C=O)O)O)(C(C(O)O)O)=O,,,5,1,1,0,1
36501_0,,,,2,1,1,2
C(C(C(C(C(C(O)O)O)O)O)=O)=O,,,5,1,2,0,2
36502_0,,,,2,1,1,2
36503_0,,,,2,1,1,2
36504_0,,,,2,1,1,2
36505_0,,,,2,1,1,2
36506_0,,,,2,1,1,2
36507_0,,,,2,1,1,2
36508_0,,,,2,1,1,2
36509_0,,,,2,1,1,2
36510_0,,,,2,1,1,2
36511_0,,,,2,1,1,2
36512_0,,,,2,1,1,2
36513_0,,,,2,1,1,2
36514_0,,,,2,1,1,2
36515_0,,,,2,1,1,2
36516_0,,,,2,1,1,2
36517_0,,,,2,1,1,2
36518_0,,,,2,1,1,2
36519_0,,,,2,1,1,2
36520_0,,,,2,1,1,2
36521_0,,,,2,1,1,2
36522_0,,,,2,1,1,2
36523_0,,,,2,1,1,2
36524_0,,,,2,1,1,2
36525_0,,,,2,1,1,2
36526_0,,,,2,1,1,2
36527_0,,,,2,1,1,2
36528_0,,,,2,1,1,2
36529_0,,,,2,1,1,2
36530_0,,,,2,1,1,2
36532_0,,,,2,1,1,2
C(C(C)O)(C(C(C)=O)(CO)O)=O,,,5,1,2,0,2
36534_0,,,,2,1,1,2
C(C(CC(C(C)=O)(CO)O)O)=O,,,5,1,4,0,4
36535_0,,,,2,1,1,2
36536_0,,,,2,1,1,2
36538_0,,,,2,1,1,2
C(C(C=O)O)(C(C(C)=O)(CO)O)=O,,,5,1,3,0,3
36539_0,,,,2,1,1,2
36541_0,,,,2,1,1,2
C(C(C)O)(C(C(CO)=O)(C)O)=O,,,5,1,1,0,1
36542_0,,,,2,1,1,2
36544_0,,,,2,1,1,2
C(C(CC(C(CO)=O)(C)O)O)=O,,,5,1,3,0,3
36545_0,,,,2,1,1,2
36546_0,,,,2,1,1,2
36547_0,,,,2,1,1,2
36549_0,,,,2,1,1,2
C(C(CO)O)(C(C(CO)=O)(C)O)=O,,,5,1,2,0,2
36550_0,,,,2,1,1,2
36551_0,,,,2,1,1,2
36552_0,,,,2,1,1,2
36553_0,,,,2,1,1,2
36554_0,,,,2,1,1,2
36556_0,,,,2,1,1,2
C(C(C=O)O)(C(C(CO)=O)(C)O)=O,,,5,1,2,0,2
36557_0,,,,2,1,1,2
36559_0,,,,2,1,1,2
C(CO)(C(C(CO)=O)(C)O)=O,,,5,1,1,0,1
36560_0,,,,2,1,1,2
36561_0,,,,2,1,1,2
36562_0,,,,2,1,1,2
36564_0,,,,2,1,1,2
C(C(CO)(C)O)(C(C(C)=O)O)=O,,,5,1,1,0,1
36566_0,,,,2,1,1,2
C(C(C(C(C(C)=O)O)=O)(C)O)(O)=O,,,5,1,1,0,1
36568_0,,,,2,1,1,2
C(CC(C(C(C(C)=O)O)=O)O)(O)=O,,,5,1,3,0,3
36570_0,,,,2,1,1,2
C(C(C(C(C(C)=O)O)=O)(C=C)O)=O,,,5,1,1,0,1
36572_0,,,,2,1,1,2
C(C(C=C)O)(C(C(C(C)=O)=O)O)=O,,,5,1,1,0,1
36574_0,,,,2,1,1,2
C(C(C(C)=O)O)(C(C(C=C)=O)O)=O,,,5,1,1,0,1
36576_0,,,,2,1,1,2
C(C(C(C)=O)O)(C(C=CC=O)O)=O,,,5,1,1,0,1
36577_0,,,,2,1,1,2
36579_0,,,,2,1,1,2
C(C(C(O)O)O)(C(C(C)=O)O)=O,,,5,1,1,0,1
36580_0,,,,2,1,1,2
36581_0,,,,2,1,1,2
36582_0,,,,2,1,1,2
36583_0,,,,2,1,1,2
36585_0,,,,2,1,1,2
C(C(CO)(CO)O)(C(C(C)=O)O)=O,,,5,1,4,0,4
36586_0,,,,2,1,1,2
36588_0,,,,2,1,1,2
C(C(C(C(C(C)=O)O)=O)(C)O)=O,,,5,1,2,0,2
36589_0,,,,2,1,1,2
36591_0,,,,2,1,1,2
C(C(C(C)=O)O)(C(C(C)=O)O)=O,,,5,1,2,0,2
36592_0,,,,2,1,1,2
36594_0,,,,2,1,1,2
C(C(C)O)(C(C(C)=O)O)=O,,,5,1,3,0,3
36596_0,,,,2,1,1,2
C(C(C(C(C(C)=O)O)=O)(CO)O)=O,,,5,1,3,0,3
36597_0,,,,2,1,1,2
36598_0,,,,2,1,1,2
36600_0,,,,2,1,1,2
C(C(C(CO)=O)O)(C(C(C)=O)O)=O,,,5,1,1,0,1
36601_0,,,,2,1,1,2
36602_0,,,,2,1,1,2
36603_0,,,,2,1,1,2
36604_0,,,,2,1,1,2
36605_0,,,,2,1,1,2
36606_0,,,,2,1,1,2
36607_0,,,,2,1,1,2
36608_0,,,,2,1,1,2
36610_0,,,,2,1,1,2
C(C(C=C)O)(CC(C(CO)=O)=O)=O,,,5,1,1,0,1
36611_0,,,,2,1,1,2
36612_0,,,,2,1,1,2
36613_0,,,,2,1,1,2
36614_0,,,,2,1,1,2
36615_0,,,,2,1,1,2
36616_0,,,,2,1,1,2
36617_0,,,,2,1,1,2
36618_0,,,,2,1,1,2
36619_0,,,,2,1,1,2
36620_0,,,,2,1,1,2
36621_0,,,,2,1,1,2
36623_0,,,,2,1,1,2
C(C(C)O)(CC(C(CO)=O)=O)=O,,,5,1,3,0,3
36624_0,,,,2,1,1,2
36625_0,,,,2,1,1,2
36626_0,,,,2,1,1,2
36627_0,,,,2,1,1,2
36628_0,,,,2,1,1,2
36629_0,,,,2,1,1,2
36630_0,,,,2,1,1,2
36631_0,,,,2,1,1,2
36632_0,,,,2,1,1,2
36634_0,,,,2,1,1,2
C(C(C(C(C)O)=O)(C(C)O)O)=O,,,5,1,3,0,3
36636_0,,,,2,1,1,2
C(C(CC(C=O)O)(C(C)O)O)=O,,,5,1,3,0,3
36637_0,,,,2,1,1,2
36638_0,,,,2,1,1,2
36640_0,,,,2,1,1,2
C(C(C(C(C=O)O)=O)(C(C)O)O)=O,,,5,1,3,0,3
36642_0,,,,2,1,1,2
C(C(C)O)(C(C(C(C)O)=O)O)=O,,,5,1,1,0,1
36643_0,,,,2,1,1,2
36644_0,,,,2,1,1,2
36646_0,,,,2,1,1,2
C(C(CC(C(C(C)O)=O)O)O)=O,,,5,1,4,0,4
36647_0,,,,2,1,1,2
36648_0,,,,2,1,1,2
36649_0,,,,2,1,1,2
36650_0,,,,2,1,1,2
36651_0,,,,2,1,1,2
36652_0,,,,2,1,1,2
36653_0,,,,2,1,1,2
36654_0,,,,2,1,1,2
36655_0,,,,2,1,1,2
36656_0,,,,2,1,1,2
36657_0,,,,2,1,1,2
36658_0,,,,2,1,1,2
36659_0,,,,2,1,1,2
36660_0,,,,2,1,1,2
36661_0,,,,2,1,1,2
36662_0,,,,2,1,1,2
36663_0,,,,2,1,1,2
36664_0,,,,2,1,1,2
36665_0,,,,2,1,1,2
36666_0,,,,2,1,1,2
36667_0,,,,2,1,1,2
36668_0,,,,2,1,1,2
36669_0,,,,2,1,1,2
36670_0,,,,2,1,1,2
36671_0,,,,2,1,1,2
36672_0,,,,2,1,1,2
36674_0,,,,2,1,1,2
C(C(C(C1C(C(CO1)=O)O)O)O)=O,,,5,1,1,0,1
36675_0,,,,2,1,1,2
36677_0,,,,2,1,1,2
C1(C(C(CO1)C(C(C=O)O)O)O)=O,,,5,1,1,0,1
36678_0,,,,2,1,1,2
36679_0,,,,2,1,1,2
36680_0,,,,2,1,1,2
36681_0,,,,2,1,1,2
36682_0,,,,2,1,1,2
36683_0,,,,2,1,1,2
36684_0,,,,2,1,1,2
36685_0,,,,2,1,1,2
36686_0,,,,2,1,1,2
36687_0,,,,2,1,1,2
36688_0,,,,2,1,1,2
36689_0,,,,2,1,1,2
36690_0,,,,2,1,1,2
36691_0,,,,2,1,1,2
36692_0,,,,2,1,1,2
36694_0,,,,2,1,1,2
C(C(C)O)(C(CO)(C)O)=O,,,5,1,1,0,1
36696_0,,,,2,1,1,2
C(C(CC(CO)(C)O)O)=O,,,5,1,3,0,3
36698_0,,,,2,1,1,2
C(C(CCO)O)(C(CO)(C)O)=O,,,5,1,1,0,1
36700_0,,,,2,1,1,2
C(C(C(CO)C(CO)(C)O)O)=O,,,5,1,4,0,4
36702_0,,,,2,1,1,2
C(CO)(C(CC(CO)(C)O)O)=O,,,5,1,1,0,1
36703_0,,,,2,1,1,2
36705_0,,,,2,1,1,2
C(CC(C(C(CO)(C)O)=O)O)(O)=O,,,5,1,1,0,1
36707_0,,,,2,1,1,2
C(C(C(CC(CO)(C)O)O)=O)(O)=O,,,5,1,1,0,1
36709_0,,,,2,1,1,2
C(C(C(C(CO)(C)O)=O)O)(O)=O,,,5,1,2,0,2
36711_0,,,,2,1,1,2
C1(COC(C(CO)(C)O)C1O)=O,,,5,1,1,0,1
36713_0,,,,2,1,1,2
C1(C(C(CO1)C(CO)(C)O)O)=O,,,5,1,1,0,1
36715_0,,,,2,1,1,2
C(C(CO)O)(C(CO)(C)O)=O,,,5,1,3,0,3
36716_0,,,,2,1,1,2
36718_0,,,,2,1,1,2
C(C(C(CO)O)O)(C(CO)(C)O)=O,,,5,1,3,0,3
36719_0,,,,2,1,1,2
36720_0,,,,2,1,1,2
36721_0,,,,2,1,1,2
36722_0,,,,2,1,1,2
36723_0,,,,2,1,1,2
36725_0,,,,2,1,1,2
C(C(C(CC(CO)(C)O)O)=O)=O,,,5,1,2,0,2
36727_0,,,,2,1,1,2
C(C(C(C(CO)(C)O)=O)O)=O,,,5,1,3,0,3
36728_0,,,,2,1,1,2
36730_0,,,,2,1,1,2
C(C(C)O)(C(CO)(CCO)O)=O,,,5,1,1,0,1
36731_0,,,,2,1,1,2
36733_0,,,,2,1,1,2
C(C(C)O)(C(C)(C(CO)O)O)=O,,,5,1,1,0,1
36735_0,,,,2,1,1,2
C(CC(C(C(C)O)=O)O)(O)=O,,,5,1,3,0,3
36736_0,,,,2,1,1,2
36738_0,,,,2,1,1,2
C(C(CO)(CC(O)=O)O)(C(C)O)=O,,,5,1,1,0,1
36740_0,,,,2,1,1,2
C(C(C)(C(C(O)=O)O)O)(C(C)O)=O,,,5,1,2,0,2
36742_0,,,,2,1,1,2
C(C(C)O)(C(C=O)(CC(O)=O)O)=O,,,5,1,2,0,2
36743_0,,,,2,1,1,2
36745_0,,,,2,1,1,2
C(CC(C(C(C(C)O)=O)O)=O)(O)=O,,,5,1,2,0,2
36746_0,,,,2,1,1,2
36748_0,,,,2,1,1,2
C(C(C)O)(C(C(O)=O)(CC=O)O)=O,,,5,1,3,0,3
36750_0,,,,2,1,1,2
C(C(C)O)(C1(COCC1O)O)=O,,,5,1,1,0,1
36752_0,,,,2,1,1,2
C(C(C)O)(C1(C(O)OCC1)O)=O,,,5,1,1,0,1
36754_0,,,,2,1,1,2
C(C(C)O)(C1(COC(C1)O)O)=O,,,5,1,1,0,1
36756_0,,,,2,1,1,2
C(C(C)O)(C(C(C=O)=O)(C)O)=O,,,5,1,1,0,1
36758_0,,,,2,1,1,2
C(C(C(C(C)O)=O)(C=C)O)=O,,,5,1,1,0,1
36760_0,,,,2,1,1,2
C(C(C(C)=O)O)(C(C=C)O)=O,,,5,1,1,0,1
36762_0,,,,2,1,1,2
C(C(C)O)(C(C(C=C)=O)O)=O,,,5,1,1,0,1
36764_0,,,,2,1,1,2
C(C(C)O)(C(C=CC=O)O)=O,,,5,1,1,0,1
36766_0,,,,2,1,1,2
C(C(C)O)(C1(C(O)OCC1O)O)=O,,,5,1,2,0,2
36768_0,,,,2,1,1,2
C(C(C(O)O)O)(C(C)O)=O,,,5,1,1,0,1
36769_0,,,,2,1,1,2
36770_0,,,,2,1,1,2
36771_0,,,,2,1,1,2
36773_0,,,,2,1,1,2
C(C(C)O)(C(CO)(CO)O)=O,,,5,1,4,0,4
36775_0,,,,2,1,1,2
C(C(C)O)(C(CO)(C(CO)O)O)=O,,,5,1,6,0,6
36776_0,,,,2,1,1,2
36778_0,,,,2,1,1,2
C(C(C(C(C)O)=O)(C)O)=O,,,5,1,1,0,1
36779_0,,,,2,1,1,2
36781_0,,,,2,1,1,2
C(C(C(C(C)O)=O)(CCO)O)=O,,,5,1,2,0,2
36782_0,,,,2,1,1,2
36784_0,,,,2,1,1,2
C(CCO)(C(C(C(C)O)=O)O)=O,,,5,1,2,0,2
36785_0,,,,2,1,1,2
36786_0,,,,2,1,1,2
36787_0,,,,2,1,1,2
36788_0,,,,2,1,1,2
36789_0,,,,2,1,1,2
36790_0,,,,2,1,1,2
36791_0,,,,2,1,1,2
36792_0,,,,2,1,1,2
36793_0,,,,2,1,1,2
36794_0,,,,2,1,1,2
36796_0,,,,2,1,1,2
C(C(CC(CO)(CCO)O)O)=O,,,5,1,4,0,4
36798_0,,,,2,1,1,2
C(C(CC(C(CCO)O)O)O)=O,,,5,1,3,0,3
36800_0,,,,2,1,1,2
C(C(CC(C)(C(CO)O)O)O)=O,,,5,1,3,0,3
36801_0,,,,2,1,1,2
36802_0,,,,2,1,1,2
36804_0,,,,2,1,1,2
C(C(CC(C=O)O)(CCO)O)(O)=O,,,5,1,4,0,4
36806_0,,,,2,1,1,2
C(CC(C(CC(C=O)O)O)O)(O)=O,,,5,1,3,0,3
36808_0,,,,2,1,1,2
C(CC(CO)(CC(C=O)O)O)(O)=O,,,5,1,3,0,3
36810_0,,,,2,1,1,2
C(C(C(C)(CC(C=O)O)O)O)(O)=O,,,5,1,4,0,4
36811_0,,,,2,1,1,2
36812_0,,,,2,1,1,2
36813_0,,,,2,1,1,2
36814_0,,,,2,1,1,2
36816_0,,,,2,1,1,2
C(C(CC(C=O)(CC(O)=O)O)O)=O,,,5,1,3,0,3
36818_0,,,,2,1,1,2
C(CC(C(CC(CO)=O)=O)O)(O)=O,,,5,1,2,0,2
36819_0,,,,2,1,1,2
36820_0,,,,2,1,1,2
36821_0,,,,2,1,1,2
36823_0,,,,2,1,1,2
C(C(CC1(COCC1O)O)O)=O,,,5,1,2,0,2
36825_0,,,,2,1,1,2
C(C(CC1(C(O)OCC1)O)O)=O,,,5,1,3,0,3
36827_0,,,,2,1,1,2
C(C(CC1(COC(C1)O)O)O)=O,,,5,1,3,0,3
36829_0,,,,2,1,1,2
C(C(CC(C=O)(C(C)=O)O)O)=O,,,5,1,4,0,4
36830_0,,,,2,1,1,2
36831_0,,,,2,1,1,2
36833_0,,,,2,1,1,2
C(C(CC(C(C=O)=O)(C)O)O)=O,,,5,1,3,0,3
36835_0,,,,2,1,1,2
C(C(C=C)(CC(C=O)O)O)=O,,,5,1,3,0,3
36837_0,,,,2,1,1,2
C(C(C=C)O)(CC(CO)=O)=O,,,5,1,1,0,1
36839_0,,,,2,1,1,2
C(C(CC(C(C=C)=O)O)O)=O,,,5,1,3,0,3
36841_0,,,,2,1,1,2
C(C(CC(C=CC=O)O)O)=O,,,5,1,4,0,4
36843_0,,,,2,1,1,2
C(C(CC1(C(O)OCC1O)O)O)=O,,,5,1,3,0,3
36845_0,,,,2,1,1,2
C(C(CC(C(O)O)O)O)=O,,,5,1,2,0,2
36847_0,,,,2,1,1,2
C(C(CC(C(C)O)O)O)=O,,,5,1,2,0,2
36848_0,,,,2,1,1,2
36849_0,,,,2,1,1,2
36850_0,,,,2,1,1,2
36851_0,,,,2,1,1,2
36852_0,,,,2,1,1,2
36853_0,,,,2,1,1,2
36854_0,,,,2,1,1,2
36855_0,,,,2,1,1,2
36857_0,,,,2,1,1,2
C(C(C)O)(CC(CO)=O)=O,,,5,1,4,0,4
36858_0,,,,2,1,1,2
36859_0,,,,2,1,1,2
36861_0,,,,2,1,1,2
C(C(CCO)O)(CC(CO)=O)=O,,,5,1,4,0,4
36862_0,,,,2,1,1,2
36863_0,,,,2,1,1,2
36864_0,,,,2,1,1,2
36865_0,,,,2,1,1,2
36866_0,,,,2,1,1,2
36867_0,,,,2,1,1,2
36868_0,,,,2,1,1,2
36869_0,,,,2,1,1,2
36870_0,,,,2,1,1,2
36871_0,,,,2,1,1,2
36872_0,,,,2,1,1,2
36873_0,,,,2,1,1,2
36874_0,,,,2,1,1,2
36875_0,,,,2,1,1,2
36876_0,,,,2,1,1,2
36877_0,,,,2,1,1,2
36878_0,,,,2,1,1,2
36880_0,,,,2,1,1,2
C(C(CO)O)(C(CO)(CCO)O)=O,,,5,1,4,0,4
36881_0,,,,2,1,1,2
36883_0,,,,2,1,1,2
C(C(C(C(CO)(CCO)O)=O)O)=O,,,5,1,4,0,4
36885_0,,,,2,1,1,2
C(CO)(C(CO)(CCO)O)=O,,,5,1,5,0,5
36886_0,,,,2,1,1,2
36888_0,,,,2,1,1,2
C(C(C(C(CCO)O)=O)(C=C)O)=O,,,5,1,1,0,1
36890_0,,,,2,1,1,2
C(C(C(CCO)=O)O)(C(C=C)O)=O,,,5,1,1,0,1
36892_0,,,,2,1,1,2
C(C(CCO)O)(C(C(C=C)=O)O)=O,,,5,1,1,0,1
36894_0,,,,2,1,1,2
C(C(CCO)O)(C(C=CC=O)O)=O,,,5,1,1,0,1
36896_0,,,,2,1,1,2
C(C(CCO)O)(C(C(O)O)O)=O,,,5,1,1,0,1
36897_0,,,,2,1,1,2
36898_0,,,,2,1,1,2
36900_0,,,,2,1,1,2
C(C(CCO)O)(C(CO)(CO)O)=O,,,5,1,5,0,5
36902_0,,,,2,1,1,2
C(C(C(C(CCO)O)=O)(C)O)=O,,,5,1,2,0,2
36903_0,,,,2,1,1,2
36904_0,,,,2,1,1,2
36905_0,,,,2,1,1,2
36907_0,,,,2,1,1,2
C(C(C)(C(CO)C(C=O)O)O)(O)=O,,,5,1,6,0,6
36909_0,,,,2,1,1,2
C(CC(C(CO)C(C=O)O)O)(O)=O,,,5,1,4,0,4
36911_0,,,,2,1,1,2
C(C(C=C)(C(CO)C(C=O)O)O)=O,,,5,1,3,0,3
36913_0,,,,2,1,1,2
C(C(C=C)O)(C(C(CO)=O)CO)=O,,,5,1,1,0,1
36915_0,,,,2,1,1,2
C(C(C(CO)C(C(C=C)=O)O)O)=O,,,5,1,3,0,3
36917_0,,,,2,1,1,2
C(C(C(CO)C(C=CC=O)O)O)=O,,,5,1,3,0,3
36918_0,,,,2,1,1,2
36920_0,,,,2,1,1,2
C(C(C(CO)C(C(O)O)O)O)=O,,,5,1,3,0,3
36922_0,,,,2,1,1,2
C(C(C(CO)C(C(C)O)O)O)=O,,,5,1,3,0,3
36923_0,,,,2,1,1,2
36924_0,,,,2,1,1,2
36925_0,,,,2,1,1,2
36926_0,,,,2,1,1,2
36927_0,,,,2,1,1,2
36928_0,,,,2,1,1,2
36930_0,,,,2,1,1,2
C(C(C)O)(C(C(CO)=O)CO)=O,,,5,1,4,0,4
36931_0,,,,2,1,1,2
36932_0,,,,2,1,1,2
36933_0,,,,2,1,1,2
36934_0,,,,2,1,1,2
36935_0,,,,2,1,1,2
36936_0,,,,2,1,1,2
36937_0,,,,2,1,1,2
36938_0,,,,2,1,1,2
36939_0,,,,2,1,1,2
36940_0,,,,2,1,1,2
36941_0,,,,2,1,1,2
36942_0,,,,2,1,1,2
36944_0,,,,2,1,1,2
C(C(CO)O)(C(C)(C(CO)O)O)=O,,,5,1,3,0,3
36945_0,,,,2,1,1,2
36947_0,,,,2,1,1,2
C(C(C(C(C)(C(CO)O)O)=O)O)=O,,,5,1,3,0,3
36949_0,,,,2,1,1,2
C(CO)(C(C)(C(CO)O)O)=O,,,5,1,5,0,5
36950_0,,,,2,1,1,2
36952_0,,,,2,1,1,2
C(CC(CC(C(CO)=O)O)O)(O)=O,,,5,1,2,0,2
36954_0,,,,2,1,1,2
C(C(C=C)(CC(C(CO)=O)O)O)=O,,,5,1,1,0,1
36956_0,,,,2,1,1,2
C(C(C=C)O)(CC(C(CO)O)=O)=O,,,5,1,1,0,1
36958_0,,,,2,1,1,2
C(CO)(C(CC(C(C=C)=O)O)O)=O,,,5,1,1,0,1
36960_0,,,,2,1,1,2
C(CO)(C(CC(C=CC=O)O)O)=O,,,5,1,1,0,1
36962_0,,,,2,1,1,2
C(CO)(C(CC(C(O)O)O)O)=O,,,5,1,1,0,1
36964_0,,,,2,1,1,2
C(CO)(C(CC(C(C)O)O)O)=O,,,5,1,1,0,1
36965_0,,,,2,1,1,2
36966_0,,,,2,1,1,2
36967_0,,,,2,1,1,2
36969_0,,,,2,1,1,2
C(C(CO)O)(CC(C(C)O)=O)=O,,,5,1,3,0,3
36970_0,,,,2,1,1,2
36971_0,,,,2,1,1,2
36972_0,,,,2,1,1,2
36973_0,,,,2,1,1,2
36974_0,,,,2,1,1,2
36975_0,,,,2,1,1,2
36976_0,,,,2,1,1,2
36977_0,,,,2,1,1,2
36979_0,,,,2,1,1,2
C(C(C)(C1C(C(CO1)=O)O)O)(O)=O,,,5,1,1,0,1
36981_0,,,,2,1,1,2
C(C(C)(C1COC(C1O)=O)O)(O)=O,,,5,1,1,0,1
36982_0,,,,2,1,1,2
36983_0,,,,2,1,1,2
36984_0,,,,2,1,1,2
36985_0,,,,2,1,1,2
36986_0,,,,2,1,1,2
36988_0,,,,2,1,1,2
C(C(C(C(C=O)O)=O)(C)O)(O)=O,,,5,1,3,0,3
36989_0,,,,2,1,1,2
36991_0,,,,2,1,1,2
C(C(C(C)=O)O)(CC(C(O)=O)=O)=O,,,5,1,2,0,2
36993_0,,,,2,1,1,2
C(CC(C(O)=O)=O)(C(C=C)O)=O,,,5,1,1,0,1
36994_0,,,,2,1,1,2
36996_0,,,,2,1,1,2
C(C(C)O)(CC(C(O)=O)=O)=O,,,5,1,4,0,4
36998_0,,,,2,1,1,2
C(C(CCO)O)(CC(C(O)=O)=O)=O,,,5,1,2,0,2
36999_0,,,,2,1,1,2
37000_0,,,,2,1,1,2
37001_0,,,,2,1,1,2
37002_0,,,,2,1,1,2
37003_0,,,,2,1,1,2
37005_0,,,,2,1,1,2
C(CC(C1C(C(CO1)=O)O)O)(O)=O,,,5,1,1,0,1
37007_0,,,,2,1,1,2
C(CC(C1COC(C1O)=O)O)(O)=O,,,5,1,1,0,1
37008_0,,,,2,1,1,2
37009_0,,,,2,1,1,2
37010_0,,,,2,1,1,2
37011_0,,,,2,1,1,2
37012_0,,,,2,1,1,2
37013_0,,,,2,1,1,2
37015_0,,,,2,1,1,2
C(CC(CC(C(C=O)=O)O)O)(O)=O,,,5,1,2,0,2
37016_0,,,,2,1,1,2
37017_0,,,,2,1,1,2
37018_0,,,,2,1,1,2
37019_0,,,,2,1,1,2
37020_0,,,,2,1,1,2
37021_0,,,,2,1,1,2
37022_0,,,,2,1,1,2
37024_0,,,,2,1,1,2
C(C(C)O)(C(C(C(O)=O)=O)CO)=O,,,5,1,2,0,2
37025_0,,,,2,1,1,2
37027_0,,,,2,1,1,2
C(CO)(C(CO)(CC(O)=O)O)=O,,,5,1,4,0,4
37028_0,,,,2,1,1,2
37029_0,,,,2,1,1,2
37030_0,,,,2,1,1,2
37031_0,,,,2,1,1,2
37032_0,,,,2,1,1,2
37033_0,,,,2,1,1,2
37034_0,,,,2,1,1,2
37036_0,,,,2,1,1,2
C(C(C)O)(C(C(O)=O)C(CO)=O)=O,,,5,1,2,0,2
37037_0,,,,2,1,1,2
37038_0,,,,2,1,1,2
37039_0,,,,2,1,1,2
37041_0,,,,2,1,1,2
C(CC(C(C(O)=O)=O)O)(O)=O,,,5,1,4,0,4
37043_0,,,,2,1,1,2
C(CC(C(C(C(O)O)O)=O)O)(O)=O,,,5,1,1,0,1
37044_0,,,,2,1,1,2
37045_0,,,,2,1,1,2
37047_0,,,,2,1,1,2
C(CC(C(C(C=O)(C)O)=O)O)(O)=O,,,5,1,2,0,2
37048_0,,,,2,1,1,2
37050_0,,,,2,1,1,2
C(C(C(CC(C(O)O)O)O)=O)(O)=O,,,5,1,1,0,1
37052_0,,,,2,1,1,2
C(C(C(CC(C(C)O)O)O)=O)(O)=O,,,5,1,1,0,1
37053_0,,,,2,1,1,2
37054_0,,,,2,1,1,2
37056_0,,,,2,1,1,2
C(C(CC(C(C(O)=O)=O)O)O)(O)=O,,,5,1,6,0,6
37058_0,,,,2,1,1,2
C(C(C)(CC(C(C(O)=O)=O)O)O)=O,,,5,1,3,0,3
37060_0,,,,2,1,1,2
C(C(C(O)=O)O)(CC(C(C)O)=O)=O,,,5,1,3,0,3
37062_0,,,,2,1,1,2
C(C)(C(CC(C(C(O)=O)=O)O)O)=O,,,5,1,3,0,3
37064_0,,,,2,1,1,2
C(C(C(CC(C)O)O)=O)(O)=O,,,5,1,3,0,3
37066_0,,,,2,1,1,2
C(C(C(C(C=O)O)=O)(CO)O)(O)=O,,,5,1,6,0,6
37068_0,,,,2,1,1,2
C(C(C(C(C(O)=O)O)=O)(C=C)O)=O,,,5,1,1,0,1
37070_0,,,,2,1,1,2
C(C(C(C(O)=O)=O)O)(C(C=C)O)=O,,,5,1,1,0,1
37072_0,,,,2,1,1,2
C(C(C(C(C(C=C)=O)O)=O)O)(O)=O,,,5,1,1,0,1
37073_0,,,,2,1,1,2
37074_0,,,,2,1,1,2
37076_0,,,,2,1,1,2
C(C(C(C(C(O)O)O)=O)O)(O)=O,,,5,1,1,0,1
37077_0,,,,2,1,1,2
37078_0,,,,2,1,1,2
37079_0,,,,2,1,1,2
37080_0,,,,2,1,1,2
37081_0,,,,2,1,1,2
37082_0,,,,2,1,1,2
37084_0,,,,2,1,1,2
C(C(C)O)(C(C(C(O)=O)=O)O)=O,,,5,1,3,0,3
37085_0,,,,2,1,1,2
37086_0,,,,2,1,1,2
37087_0,,,,2,1,1,2
37088_0,,,,2,1,1,2
37089_0,,,,2,1,1,2
37090_0,,,,2,1,1,2
37091_0,,,,2,1,1,2
37092_0,,,,2,1,1,2
37093_0,,,,2,1,1,2
37094_0,,,,2,1,1,2
37095_0,,,,2,1,1,2
37096_0,,,,2,1,1,2
37097_0,,,,2,1,1,2
37099_0,,,,2,1,1,2
C(C(C(CC(CO)=O)=O)(CO)O)=O,,,5,1,3,0,3
37100_0,,,,2,1,1,2
37101_0,,,,2,1,1,2
37102_0,,,,2,1,1,2
37103_0,,,,2,1,1,2
37105_0,,,,2,1,1,2
C(C(CC(C(CO)=O)(CO)O)O)=O,,,5,1,4,0,4
37106_0,,,,2,1,1,2
37107_0,,,,2,1,1,2
37109_0,,,,2,1,1,2
C(C(C(C(C=O)O)C(C=O)O)O)=O,,,5,1,2,0,2
37110_0,,,,2,1,1,2
37112_0,,,,2,1,1,2
C(C(C(C(C)O)C(C=O)O)O)=O,,,5,1,2,0,2
37113_0,,,,2,1,1,2
37115_0,,,,2,1,1,2
C(C(C(C(CO)O)C(C=O)O)O)=O,,,5,1,2,0,2
37116_0,,,,2,1,1,2
37117_0,,,,2,1,1,2
37118_0,,,,2,1,1,2
37119_0,,,,2,1,1,2
37120_0,,,,2,1,1,2
37121_0,,,,2,1,1,2
37123_0,,,,2,1,1,2
C(C(C(C(C=O)O)=O)(CC=O)O)=O,,,5,1,1,0,1
37124_0,,,,2,1,1,2
37125_0,,,,2,1,1,2
37126_0,,,,2,1,1,2
37128_0,,,,2,1,1,2
C(C(C(C(C(CC=O)=O)O)=O)O)=O,,,5,1,1,0,1
37129_0,,,,2,1,1,2
37131_0,,,,2,1,1,2
C(C(C(C(C=C)O)=O)C(C=O)=O)=O,,,5,1,1,0,1
37132_0,,,,2,1,1,2
37134_0,,,,2,1,1,2
C(C(C(C(C)O)=O)C(C=O)=O)=O,,,5,1,5,0,5
37135_0,,,,2,1,1,2
37136_0,,,,2,1,1,2
37137_0,,,,2,1,1,2
37138_0,,,,2,1,1,2
37139_0,,,,2,1,1,2
37141_0,,,,2,1,1,2
C(C(C(O)=O)C(C(CO)=O)O)(O)=O,,,5,1,4,0,4
37143_0,,,,2,1,1,2
C(C(C(C)O)C(C(CO)=O)O)(O)=O,,,5,1,4,0,4
37145_0,,,,2,1,1,2
C(C(CO)C(C(CO)=O)O)(O)=O,,,5,1,6,0,6
37147_0,,,,2,1,1,2
C(C(CO)C(C(C(O)=O)=O)O)(O)=O,,,5,1,1,0,1
37149_0,,,,2,1,1,2
C(C(C(C(CO)C(C)O)O)=O)(O)=O,,,5,1,1,0,1
37151_0,,,,2,1,1,2
C(C(C(C(CO)CO)O)=O)(O)=O,,,5,1,1,0,1
37153_0,,,,2,1,1,2
C(C(C(CO)=O)(CC(O)=O)O)=O,,,5,1,5,0,5
37154_0,,,,2,1,1,2
37155_0,,,,2,1,1,2
37157_0,,,,2,1,1,2
C(C(C(C(C)O)=O)C(C(O)=O)=O)=O,,,5,1,1,0,1
37159_0,,,,2,1,1,2
C(C(CO)O)(C1(COCC1O)O)=O,,,5,1,1,0,1
37161_0,,,,2,1,1,2
C(C(C(C1(COCC1O)O)O)O)=O,,,5,1,3,0,3
37163_0,,,,2,1,1,2
C(C(C(C1(COCC1O)O)=O)O)=O,,,5,1,1,0,1
37165_0,,,,2,1,1,2
C(CO)(C1(COCC1O)O)=O,,,5,1,1,0,1
37167_0,,,,2,1,1,2
C(C(C=C)(C1C(C(CO1)=O)O)O)=O,,,5,1,1,0,1
37169_0,,,,2,1,1,2
C(C1C(C(CO1)O)=O)(C(C=C)O)=O,,,5,1,1,0,1
37171_0,,,,2,1,1,2
C1(COC(C1O)C(C(C=C)=O)O)=O,,,5,1,1,0,1
37173_0,,,,2,1,1,2
C1(COC(C1O)C(C=CC=O)O)=O,,,5,1,1,0,1
37175_0,,,,2,1,1,2
C(C1C(C(CO1)=O)O)(O)=O,,,5,1,1,0,1
37177_0,,,,2,1,1,2
C1(COC(C(C(O)O)O)C1O)=O,,,5,1,1,0,1
37179_0,,,,2,1,1,2
C1(COC(C(C(C)O)O)C1O)=O,,,5,1,1,0,1
37181_0,,,,2,1,1,2
C1(COC(C(C(CO)O)O)C1O)=O,,,5,1,1,0,1
37183_0,,,,2,1,1,2
C1(C(COC1C(CO)=O)O)=O,,,5,1,3,0,3
37185_0,,,,2,1,1,2
C(C(C1C(C(CO1)=O)O)O)=O,,,5,1,2,0,2
37187_0,,,,2,1,1,2
C1(COC(C(CO)(CO)O)C1O)=O,,,5,1,1,0,1
37189_0,,,,2,1,1,2
C(C(C1C(C(CO1)=O)O)O)(O)=O,,,5,1,2,0,2
37191_0,,,,2,1,1,2
C(C(C)(C1C(C(CO1)=O)O)O)=O,,,5,1,1,0,1
37193_0,,,,2,1,1,2
C1(C(COC1C(C(C)O)=O)O)=O,,,5,1,2,0,2
37195_0,,,,2,1,1,2
C(C)(C(C1C(C(CO1)=O)O)O)=O,,,5,1,1,0,1
37197_0,,,,2,1,1,2
C(CC(C1C(C(CO1)=O)O)O)=O,,,5,1,1,0,1
37199_0,,,,2,1,1,2
C1(COC(C(C)O)C1O)=O,,,5,1,1,0,1
37201_0,,,,2,1,1,2
C(C(CO)(C1C(C(CO1)=O)O)O)=O,,,5,1,1,0,1
37203_0,,,,2,1,1,2
C(C(CO)O)(C1C(C(CO1)O)=O)=O,,,5,1,1,0,1
37204_0,,,,2,1,1,2
37206_0,,,,2,1,1,2
C(CO)(C(C1C(C(CO1)=O)O)O)=O,,,5,1,1,0,1
37207_0,,,,2,1,1,2
37208_0,,,,2,1,1,2
37210_0,,,,2,1,1,2
C(C(CO)O)(C1(C(O)OCC1)O)=O,,,5,1,2,0,2
37212_0,,,,2,1,1,2
C(C(C(C1(C(O)OCC1)O)O)O)=O,,,5,1,4,0,4
37214_0,,,,2,1,1,2
C(C(C(C1(C(O)OCC1)O)=O)O)=O,,,5,1,2,0,2
37216_0,,,,2,1,1,2
C(CO)(C1(C(O)OCC1)O)=O,,,5,1,2,0,2
37218_0,,,,2,1,1,2
C(C(C=C)(C1COC(C1O)=O)O)=O,,,5,1,1,0,1
37220_0,,,,2,1,1,2
C(C(C=C)O)(C1C(C(O)OC1)=O)=O,,,5,1,1,0,1
37222_0,,,,2,1,1,2
C1(C(C(CO1)C(C(C=C)=O)O)O)=O,,,5,1,1,0,1
37224_0,,,,2,1,1,2
C1(C(C(CO1)C(C=CC=O)O)O)=O,,,5,1,1,0,1
37226_0,,,,2,1,1,2
C(C1COC(C1O)=O)(O)=O,,,5,1,2,0,2
37228_0,,,,2,1,1,2
C1(C(C(CO1)C(C(O)O)O)O)=O,,,5,1,1,0,1
37230_0,,,,2,1,1,2
C1(C(C(CO1)C(C(C)O)O)O)=O,,,5,1,1,0,1
37232_0,,,,2,1,1,2
C1(C(C(CO1)C(C(CO)O)O)O)=O,,,5,1,1,0,1
37234_0,,,,2,1,1,2
C(CO)(C1C(C(O)OC1)=O)=O,,,5,1,5,0,5
37236_0,,,,2,1,1,2
C1(C(C(CO1)C(C=O)O)O)=O,,,5,1,3,0,3
37238_0,,,,2,1,1,2
C1(C(C(CO1)C(CO)(CO)O)O)=O,,,5,1,1,0,1
37239_0,,,,2,1,1,2
37241_0,,,,2,1,1,2
C(C(C)(C1COC(C1O)=O)O)=O,,,5,1,2,0,2
37243_0,,,,2,1,1,2
C(C(C)O)(C1C(C(O)OC1)=O)=O,,,5,1,3,0,3
37245_0,,,,2,1,1,2
C1(C(C(CO1)C(C(C)=O)O)O)=O,,,5,1,2,0,2
37247_0,,,,2,1,1,2
C(CC(C1COC(C1O)=O)O)=O,,,5,1,2,0,2
37249_0,,,,2,1,1,2
C1(C(C(CO1)C(C)O)O)=O,,,5,1,2,0,2
37251_0,,,,2,1,1,2
C(C(CO)(C1COC(C1O)=O)O)=O,,,5,1,1,0,1
37253_0,,,,2,1,1,2
C(C(CO)O)(C1C(C(O)OC1)=O)=O,,,5,1,2,0,2
37254_0,,,,2,1,1,2
37256_0,,,,2,1,1,2
C1(C(C(CO1)C(C(CO)=O)O)O)=O,,,5,1,1,0,1
37258_0,,,,2,1,1,2
C1(C(C(CO)CO1)O)=O,,,5,1,2,0,2
37260_0,,,,2,1,1,2
C1(C(C(CO1)C(CO)O)O)=O,,,5,1,2,0,2
37262_0,,,,2,1,1,2
C(C(CO)O)(C1(COC(C1)O)O)=O,,,5,1,2,0,2
37263_0,,,,2,1,1,2
37265_0,,,,2,1,1,2
C(C(C(C1(COC(C1)O)O)=O)O)=O,,,5,1,2,0,2
37267_0,,,,2,1,1,2
C(CO)(C1(COC(C1)O)O)=O,,,5,1,2,0,2
37269_0,,,,2,1,1,2
C(C(C=C)O)(C1C(COC1O)=O)=O,,,5,1,1,0,1
37271_0,,,,2,1,1,2
C(CO)(C1C(COC1O)=O)=O,,,5,1,5,0,5
37273_0,,,,2,1,1,2
C(C(C)O)(C1C(COC1O)=O)=O,,,5,1,2,0,2
37275_0,,,,2,1,1,2
C(C(CO)O)(C1C(COC1O)=O)=O,,,5,1,2,0,2
37276_0,,,,2,1,1,2
37278_0,,,,2,1,1,2
C(C1C(CC(O1)O)=O)(C(C=C)O)=O,,,5,1,1,0,1
37280_0,,,,2,1,1,2
C1(CC(OC1C(CO)=O)O)=O,,,5,1,3,0,3
37282_0,,,,2,1,1,2
C1(CC(OC1C(C(C)O)=O)O)=O,,,5,1,2,0,2
37284_0,,,,2,1,1,2
C1(CC(OC1C(C(CO)O)=O)O)=O,,,5,1,2,0,2
37285_0,,,,2,1,1,2
37287_0,,,,2,1,1,2
C(C(C(C(C=O)O)=O)(C(C)=O)O)=O,,,5,1,1,0,1
37288_0,,,,2,1,1,2
37290_0,,,,2,1,1,2
C(C(C=O)C(C(C(C)=O)O)=O)=O,,,5,1,3,0,3
37291_0,,,,2,1,1,2
37293_0,,,,2,1,1,2
C(C(C=O)O)(C(C(C(C)=O)=O)O)=O,,,5,1,1,0,1
37295_0,,,,2,1,1,2
C(C(C(C)=O)O)(C(C(C=O)=O)O)=O,,,5,1,1,0,1
37297_0,,,,2,1,1,2
C(C(CO)O)(C(C(C=O)=O)(C)O)=O,,,5,1,2,0,2
37298_0,,,,2,1,1,2
37300_0,,,,2,1,1,2
C(C(C=O)O)(C(C(C=O)=O)(C)O)=O,,,5,1,2,0,2
37301_0,,,,2,1,1,2
37303_0,,,,2,1,1,2
C(CC(C(C=O)=O)=O)(C(C=C)O)=O,,,5,1,1,0,1
37304_0,,,,2,1,1,2
37306_0,,,,2,1,1,2
C(C(C)O)(CC(C(C=O)=O)=O)=O,,,5,1,2,0,2
37307_0,,,,2,1,1,2
37308_0,,,,2,1,1,2
37310_0,,,,2,1,1,2
C(C(C(C(CO)O)=O)(C=C)O)=O,,,5,1,2,0,2
37312_0,,,,2,1,1,2
C(C(C=C)(C(C(C=O)O)O)O)=O,,,5,1,6,0,6
37313_0,,,,2,1,1,2
37314_0,,,,2,1,1,2
37316_0,,,,2,1,1,2
C(C(C(C(CC=O)O)=O)(C=C)O)=O,,,5,1,1,0,1
37317_0,,,,2,1,1,2
37319_0,,,,2,1,1,2
C(C(C=C)(CC(C(C=O)=O)O)O)=O,,,5,1,1,0,1
37321_0,,,,2,1,1,2
C(C(C(C(C=O)O)=O)(C=C)O)=O,,,5,1,2,0,2
37323_0,,,,2,1,1,2
C(C(C(CO)=O)(C=C)O)=O,,,5,1,3,0,3
37325_0,,,,2,1,1,2
C(C(CO)O)(C(C(C=C)=O)O)=O,,,5,1,3,0,3
37326_0,,,,2,1,1,2
37328_0,,,,2,1,1,2
C(C(C(CO)=O)O)(C(C=C)O)=O,,,5,1,2,0,2
37330_0,,,,2,1,1,2
C(CC(C=O)=O)(C(C=C)O)=O,,,5,1,2,0,2
37332_0,,,,2,1,1,2
C(C(C=O)C(C(C=C)O)=O)=O,,,5,1,2,0,2
37334_0,,,,2,1,1,2
C(C(C=C)O)(C(C(C=O)=O)CO)=O,,,5,1,1,0,1
37335_0,,,,2,1,1,2
37336_0,,,,2,1,1,2
37337_0,,,,2,1,1,2
37339_0,,,,2,1,1,2
C(C(C(C(C=C)O)=O)C(CO)=O)=O,,,5,1,1,0,1
37341_0,,,,2,1,1,2
C(CC(C(C(C(C=C)=O)O)=O)O)=O,,,5,1,1,0,1
37343_0,,,,2,1,1,2
C(CC(C(C(C(C=C)O)=O)O)=O)=O,,,5,1,1,0,1
37344_0,,,,2,1,1,2
37346_0,,,,2,1,1,2
C=CC(C(CC(C(C=O)=O)O)O)=O,,,5,1,1,0,1
37348_0,,,,2,1,1,2
C(C(C(CC(C(C=C)O)=O)=O)O)=O,,,5,1,1,0,1
37349_0,,,,2,1,1,2
37351_0,,,,2,1,1,2
C(C(C(C(C(C=C)=O)O)=O)O)=O,,,5,1,2,0,2
37353_0,,,,2,1,1,2
C(C(C(C=O)=O)O)(C(C=C)O)=O,,,5,1,2,0,2
37355_0,,,,2,1,1,2
C(CO)(C(C(C=C)=O)O)=O,,,5,1,3,0,3
37357_0,,,,2,1,1,2
C(C(C(C(C=C)O)=O)O)=O,,,5,1,3,0,3
37358_0,,,,2,1,1,2
37359_0,,,,2,1,1,2
37360_0,,,,2,1,1,2
37361_0,,,,2,1,1,2
37362_0,,,,2,1,1,2
37363_0,,,,2,1,1,2
37365_0,,,,2,1,1,2
C(C(CC(C(C=O)=O)O)O)=CC=O,,,5,1,1,0,1
37367_0,,,,2,1,1,2
C(C(C(C(C=CC=O)O)=O)O)=O,,,5,1,3,0,3
37368_0,,,,2,1,1,2
37369_0,,,,2,1,1,2
37370_0,,,,2,1,1,2
37371_0,,,,2,1,1,2
37372_0,,,,2,1,1,2
37373_0,,,,2,1,1,2
37374_0,,,,2,1,1,2
37376_0,,,,2,1,1,2
C(C(C(O)O)O)(C(CO)O)=O,,,5,1,1,0,1
37378_0,,,,2,1,1,2
C(C(C(C(C(O)O)O)O)O)=O,,,5,1,3,0,3
37380_0,,,,2,1,1,2
C(C(C(CO)O)O)(C(C(O)O)O)=O,,,5,1,1,0,1
37382_0,,,,2,1,1,2
C(CO)(C(C(C(C(O)O)O)O)O)=O,,,5,1,2,0,2
37383_0,,,,2,1,1,2
37384_0,,,,2,1,1,2
37386_0,,,,2,1,1,2
C(CC(C(C(C(O)O)O)=O)O)=O,,,5,1,1,0,1
37387_0,,,,2,1,1,2
37389_0,,,,2,1,1,2
C(C(C(CC(C(O)O)O)O)=O)=O,,,5,1,1,0,1
37391_0,,,,2,1,1,2
C(C(C(C(C(O)O)O)=O)O)=O,,,5,1,1,0,1
37392_0,,,,2,1,1,2
37393_0,,,,2,1,1,2
37394_0,,,,2,1,1,2
37395_0,,,,2,1,1,2
37396_0,,,,2,1,1,2
37397_0,,,,2,1,1,2
37398_0,,,,2,1,1,2
37399_0,,,,2,1,1,2
37400_0,,,,2,1,1,2
37402_0,,,,2,1,1,2
C(C(C(CC(C(C)O)O)O)=O)=O,,,5,1,1,0,1
37403_0,,,,2,1,1,2
37404_0,,,,2,1,1,2
37405_0,,,,2,1,1,2
37406_0,,,,2,1,1,2
37407_0,,,,2,1,1,2
37408_0,,,,2,1,1,2
37409_0,,,,2,1,1,2
37410_0,,,,2,1,1,2
37411_0,,,,2,1,1,2
37412_0,,,,2,1,1,2
37413_0,,,,2,1,1,2
37414_0,,,,2,1,1,2
37415_0,,,,2,1,1,2
37416_0,,,,2,1,1,2
37417_0,,,,2,1,1,2
37418_0,,,,2,1,1,2
37419_0,,,,2,1,1,2
37420_0,,,,2,1,1,2
37421_0,,,,2,1,1,2
37422_0,,,,2,1,1,2
37423_0,,,,2,1,1,2
37424_0,,,,2,1,1,2
37425_0,,,,2,1,1,2
37426_0,,,,2,1,1,2
37427_0,,,,2,1,1,2
37428_0,,,,2,1,1,2
37429_0,,,,2,1,1,2
37430_0,,,,2,1,1,2
37431_0,,,,2,1,1,2
37432_0,,,,2,1,1,2
37433_0,,,,2,1,1,2
37434_0,,,,2,1,1,2
37435_0,,,,2,1,1,2
37436_0,,,,2,1,1,2
37437_0,,,,2,1,1,2
37438_0,,,,2,1,1,2
37439_0,,,,2,1,1,2
37440_0,,,,2,1,1,2
37441_0,,,,2,1,1,2
37442_0,,,,2,1,1,2
37443_0,,,,2,1,1,2
37444_0,,,,2,1,1,2
37445_0,,,,2,1,1,2
37446_0,,,,2,1,1,2
37447_0,,,,2,1,1,2
37448_0,,,,2,1,1,2
37449_0,,,,2,1,1,2
37450_0,,,,2,1,1,2
37451_0,,,,2,1,1,2
37452_0,,,,2,1,1,2
37453_0,,,,2,1,1,2
37454_0,,,,2,1,1,2
37455_0,,,,2,1,1,2
37456_0,,,,2,1,1,2
37457_0,,,,2,1,1,2
37458_0,,,,2,1,1,2
37459_0,,,,2,1,1,2
37460_0,,,,2,1,1,2
37461_0,,,,2,1,1,2
37462_0,,,,2,1,1,2
37463_0,,,,2,1,1,2
37464_0,,,,2,1,1,2
37465_0,,,,2,1,1,2
37466_0,,,,2,1,1,2
37467_0,,,,2,1,1,2
37468_0,,,,2,1,1,2
37469_0,,,,2,1,1,2
37470_0,,,,2,1,1,2
37471_0,,,,2,1,1,2
37472_0,,,,2,1,1,2
37473_0,,,,2,1,1,2
37474_0,,,,2,1,1,2
37475_0,,,,2,1,1,2
37476_0,,,,2,1,1,2
37477_0,,,,2,1,1,2
37478_0,,,,2,1,1,2
37479_0,,,,2,1,1,2
37480_0,,,,2,1,1,2
37482_0,,,,2,1,1,2
C(C(CC(C(C(C)=O)O)=O)O)=O,,,5,1,5,0,5
37483_0,,,,2,1,1,2
37484_0,,,,2,1,1,2
37485_0,,,,2,1,1,2
37486_0,,,,2,1,1,2
37487_0,,,,2,1,1,2
37488_0,,,,2,1,1,2
37490_0,,,,2,1,1,2
C(CCO)(C(C(C)=O)O)=O,,,5,1,4,0,4
37491_0,,,,2,1,1,2
37492_0,,,,2,1,1,2
37493_0,,,,2,1,1,2
37494_0,,,,2,1,1,2
37495_0,,,,2,1,1,2
37496_0,,,,2,1,1,2
37497_0,,,,2,1,1,2
37498_0,,,,2,1,1,2
37499_0,,,,2,1,1,2
37500_0,,,,2,1,1,2
37501_0,,,,2,1,1,2
37502_0,,,,2,1,1,2
37503_0,,,,2,1,1,2
37504_0,,,,2,1,1,2
37505_0,,,,2,1,1,2
37506_0,,,,2,1,1,2
37507_0,,,,2,1,1,2
37508_0,,,,2,1,1,2
37509_0,,,,2,1,1,2
37510_0,,,,2,1,1,2
37511_0,,,,2,1,1,2
37512_0,,,,2,1,1,2
37513_0,,,,2,1,1,2
37514_0,,,,2,1,1,2
37515_0,,,,2,1,1,2
37516_0,,,,2,1,1,2
37517_0,,,,2,1,1,2
37518_0,,,,2,1,1,2
37519_0,,,,2,1,1,2
37520_0,,,,2,1,1,2
37521_0,,,,2,1,1,2
37522_0,,,,2,1,1,2
37523_0,,,,2,1,1,2
37524_0,,,,2,1,1,2
37525_0,,,,2,1,1,2
37526_0,,,,2,1,1,2
37527_0,,,,2,1,1,2
37528_0,,,,2,1,1,2
37529_0,,,,2,1,1,2
37530_0,,,,2,1,1,2
37531_0,,,,2,1,1,2
37532_0,,,,2,1,1,2
37533_0,,,,2,1,1,2
37534_0,,,,2,1,1,2
37535_0,,,,2,1,1,2
37536_0,,,,2,1,1,2
37537_0,,,,2,1,1,2
37538_0,,,,2,1,1,2
37540_0,,,,2,1,1,2
C(C(C(CO)O)=O)(C(CCO)O)=O,,,5,1,3,0,3
37541_0,,,,2,1,1,2
37542_0,,,,2,1,1,2
37543_0,,,,2,1,1,2
37544_0,,,,2,1,1,2
37545_0,,,,2,1,1,2
37546_0,,,,2,1,1,2
37547_0,,,,2,1,1,2
37548_0,,,,2,1,1,2
37549_0,,,,2,1,1,2
37550_0,,,,2,1,1,2
37551_0,,,,2,1,1,2
37552_0,,,,2,1,1,2
37553_0,,,,2,1,1,2
37554_0,,,,2,1,1,2
37555_0,,,,2,1,1,2
37556_0,,,,2,1,1,2
37557_0,,,,2,1,1,2
37558_0,,,,2,1,1,2
37559_0,,,,2,1,1,2
37560_0,,,,2,1,1,2
37561_0,,,,2,1,1,2
37562_0,,,,2,1,1,2
37563_0,,,,2,1,1,2
37564_0,,,,2,1,1,2
37565_0,,,,2,1,1,2
37566_0,,,,2,1,1,2
37567_0,,,,2,1,1,2
37568_0,,,,2,1,1,2
37569_0,,,,2,1,1,2
37570_0,,,,2,1,1,2
37571_0,,,,2,1,1,2
37572_0,,,,2,1,1,2
37573_0,,,,2,1,1,2
37574_0,,,,2,1,1,2
37575_0,,,,2,1,1,2
37576_0,,,,2,1,1,2
37577_0,,,,2,1,1,2
37578_0,,,,2,1,1,2
37579_0,,,,2,1,1,2
37580_0,,,,2,1,1,2
37581_0,,,,2,1,1,2
37582_0,,,,2,1,1,2
37583_0,,,,2,1,1,2
37584_0,,,,2,1,1,2
37585_0,,,,2,1,1,2
37586_0,,,,2,1,1,2
37587_0,,,,2,1,1,2
37588_0,,,,2,1,1,2
37589_0,,,,2,1,1,2
37590_0,,,,2,1,1,2
37592_0,,,,2,1,1,2
C(CC(C(C=O)=O)O)(C(C)O)=O,,,5,1,3,0,3
37593_0,,,,2,1,1,2
37594_0,,,,2,1,1,2
37595_0,,,,2,1,1,2
37596_0,,,,2,1,1,2
37597_0,,,,2,1,1,2
37598_0,,,,2,1,1,2
37599_0,,,,2,1,1,2
37600_0,,,,2,1,1,2
37601_0,,,,2,1,1,2
37602_0,,,,2,1,1,2
37603_0,,,,2,1,1,2
37604_0,,,,2,1,1,2
37605_0,,,,2,1,1,2
37606_0,,,,2,1,1,2
37607_0,,,,2,1,1,2
37608_0,,,,2,1,1,2
37609_0,,,,2,1,1,2
37610_0,,,,2,1,1,2
37611_0,,,,2,1,1,2
37612_0,,,,2,1,1,2
37613_0,,,,2,1,1,2
37615_0,,,,2,1,1,2
C(C(C(C(CO)=O)=O)(CCO)O)=O,,,5,1,1,0,1
37616_0,,,,2,1,1,2
37617_0,,,,2,1,1,2
37618_0,,,,2,1,1,2
37619_0,,,,2,1,1,2
37620_0,,,,2,1,1,2
37621_0,,,,2,1,1,2
37623_0,,,,2,1,1,2
C(C(C(C(C(CCO)O)=O)=O)O)=O,,,5,1,2,0,2
37624_0,,,,2,1,1,2
37625_0,,,,2,1,1,2
37626_0,,,,2,1,1,2
37627_0,,,,2,1,1,2
37628_0,,,,2,1,1,2
37629_0,,,,2,1,1,2
37630_0,,,,2,1,1,2
37631_0,,,,2,1,1,2
37632_0,,,,2,1,1,2
37633_0,,,,2,1,1,2
37634_0,,,,2,1,1,2
37635_0,,,,2,1,1,2
37636_0,,,,2,1,1,2
37637_0,,,,2,1,1,2
37638_0,,,,2,1,1,2
37639_0,,,,2,1,1,2
37640_0,,,,2,1,1,2
37641_0,,,,2,1,1,2
37643_0,,,,2,1,1,2
C(CC(C(C(CO)=O)=O)(CO)O)=O,,,5,1,3,0,3
37644_0,,,,2,1,1,2
37645_0,,,,2,1,1,2
37646_0,,,,2,1,1,2
37647_0,,,,2,1,1,2
37648_0,,,,2,1,1,2
37649_0,,,,2,1,1,2
37650_0,,,,2,1,1,2
37651_0,,,,2,1,1,2
37652_0,,,,2,1,1,2
37653_0,,,,2,1,1,2
37654_0,,,,2,1,1,2
37655_0,,,,2,1,1,2
37656_0,,,,2,1,1,2
37657_0,,,,2,1,1,2
37658_0,,,,2,1,1,2
37660_0,,,,2,1,1,2
C(C(C(C(C(CO)=O)=O)(C)O)O)=O,,,5,1,2,0,2
37661_0,,,,2,1,1,2
37662_0,,,,2,1,1,2
37663_0,,,,2,1,1,2
37664_0,,,,2,1,1,2
37665_0,,,,2,1,1,2
37666_0,,,,2,1,1,2
37667_0,,,,2,1,1,2
37668_0,,,,2,1,1,2
37669_0,,,,2,1,1,2
37670_0,,,,2,1,1,2
37671_0,,,,2,1,1,2
37672_0,,,,2,1,1,2
37673_0,,,,2,1,1,2
37674_0,,,,2,1,1,2
37675_0,,,,2,1,1,2
37676_0,,,,2,1,1,2
37677_0,,,,2,1,1,2
37678_0,,,,2,1,1,2
37679_0,,,,2,1,1,2
37680_0,,,,2,1,1,2
37681_0,,,,2,1,1,2
37682_0,,,,2,1,1,2
37683_0,,,,2,1,1,2
37684_0,,,,2,1,1,2
37685_0,,,,2,1,1,2
37686_0,,,,2,1,1,2
37687_0,,,,2,1,1,2
37688_0,,,,2,1,1,2
37689_0,,,,2,1,1,2
37690_0,,,,2,1,1,2
37692_0,,,,2,1,1,2
C(C(C)O)(C(C=O)(C(CO)=O)O)=O,,,5,1,2,0,2
37693_0,,,,2,1,1,2
37694_0,,,,2,1,1,2
37695_0,,,,2,1,1,2
37696_0,,,,2,1,1,2
37697_0,,,,2,1,1,2
37699_0,,,,2,1,1,2
C(C(C(CO)=O)(C(CO)=O)O)=O,,,5,1,2,0,2
37700_0,,,,2,1,1,2
37701_0,,,,2,1,1,2
37702_0,,,,2,1,1,2
37703_0,,,,2,1,1,2
37704_0,,,,2,1,1,2
37705_0,,,,2,1,1,2
37706_0,,,,2,1,1,2
37707_0,,,,2,1,1,2
37708_0,,,,2,1,1,2
37709_0,,,,2,1,1,2
37711_0,,,,2,1,1,2
C(C(C(CO)=O)(C(CO)=O)O)(O)=O,,,5,1,3,0,3
37712_0,,,,2,1,1,2
37713_0,,,,2,1,1,2
37714_0,,,,2,1,1,2
37715_0,,,,2,1,1,2
37716_0,,,,2,1,1,2
37717_0,,,,2,1,1,2
37718_0,,,,2,1,1,2
37719_0,,,,2,1,1,2
37720_0,,,,2,1,1,2
37721_0,,,,2,1,1,2
37722_0,,,,2,1,1,2
37723_0,,,,2,1,1,2
37724_0,,,,2,1,1,2
37725_0,,,,2,1,1,2
37726_0,,,,2,1,1,2
37727_0,,,,2,1,1,2
37728_0,,,,2,1,1,2
37729_0,,,,2,1,1,2
37730_0,,,,2,1,1,2
37731_0,,,,2,1,1,2
37732_0,,,,2,1,1,2
37733_0,,,,2,1,1,2
37734_0,,,,2,1,1,2
37735_0,,,,2,1,1,2
37736_0,,,,2,1,1,2
37737_0,,,,2,1,1,2
37738_0,,,,2,1,1,2
37739_0,,,,2,1,1,2
37740_0,,,,2,1,1,2
37741_0,,,,2,1,1,2
37742_0,,,,2,1,1,2
37743_0,,,,2,1,1,2
37744_0,,,,2,1,1,2
37745_0,,,,2,1,1,2
37746_0,,,,2,1,1,2
37747_0,,,,2,1,1,2
37748_0,,,,2,1,1,2
37749_0,,,,2,1,1,2
37750_0,,,,2,1,1,2
37751_0,,,,2,1,1,2
37752_0,,,,2,1,1,2
37753_0,,,,2,1,1,2
37754_0,,,,2,1,1,2
37755_0,,,,2,1,1,2
37756_0,,,,2,1,1,2
37757_0,,,,2,1,1,2
37758_0,,,,2,1,1,2
37760_0,,,,2,1,1,2
C(C(CO)C(C=O)O)(C(C)O)=O,,,5,1,4,0,4
37761_0,,,,2,1,1,2
37762_0,,,,2,1,1,2
37763_0,,,,2,1,1,2
37764_0,,,,2,1,1,2
37765_0,,,,2,1,1,2
37766_0,,,,2,1,1,2
37767_0,,,,2,1,1,2
37768_0,,,,2,1,1,2
37769_0,,,,2,1,1,2
37770_0,,,,2,1,1,2
37771_0,,,,2,1,1,2
37772_0,,,,2,1,1,2
37773_0,,,,2,1,1,2
37775_0,,,,2,1,1,2
C(CO)(C(C)(CCO)O)=O,,,5,1,2,0,2
37776_0,,,,2,1,1,2
37777_0,,,,2,1,1,2
37778_0,,,,2,1,1,2
37779_0,,,,2,1,1,2
37780_0,,,,2,1,1,2
37781_0,,,,2,1,1,2
37783_0,,,,2,1,1,2
C(C(C(CO)(C(CO)(C)O)O)O)=O,,,5,1,6,0,6
37784_0,,,,2,1,1,2
37785_0,,,,2,1,1,2
37787_0,,,,2,1,1,2
C(CO)(C(C)(C(CO)(CO)O)O)=O,,,5,1,5,0,5
37789_0,,,,2,1,1,2
C(CO)(C(C(CO)CO)O)=O,,,5,1,2,0,2
37790_0,,,,2,1,1,2
37791_0,,,,2,1,1,2
37792_0,,,,2,1,1,2
37793_0,,,,2,1,1,2
37795_0,,,,2,1,1,2
C(C(C)O)(C(C(O)=O)C(C=O)O)=O,,,5,1,2,0,2
37797_0,,,,2,1,1,2
C(CC(C(C)O)=O)(O)=O,,,5,1,3,0,3
37798_0,,,,2,1,1,2
37799_0,,,,2,1,1,2
37800_0,,,,2,1,1,2
37801_0,,,,2,1,1,2
37802_0,,,,2,1,1,2
37803_0,,,,2,1,1,2
37804_0,,,,2,1,1,2
37806_0,,,,2,1,1,2
C(CO)(C(C)(CC(O)=O)O)=O,,,5,1,2,0,2
37808_0,,,,2,1,1,2
C(C(C)O)(C(C(O)=O)(C(C)=O)O)=O,,,5,1,2,0,2
37810_0,,,,2,1,1,2
C(C(C(CO)=O)(C(C)=O)O)(O)=O,,,5,1,6,0,6
37811_0,,,,2,1,1,2
37812_0,,,,2,1,1,2
37814_0,,,,2,1,1,2
C(C1(C(C(CC1O)O)=O)O)(O)=O,,,5,1,5,0,5
37815_0,,,,2,1,1,2
37816_0,,,,2,1,1,2
37818_0,,,,2,1,1,2
C1(C(CC(C1(C(CO)=O)O)O)O)=O,,,5,1,3,0,3
37820_0,,,,2,1,1,2
C(C1(C(C(CC1O)O)=O)O)=O,,,5,1,3,0,3
37821_0,,,,2,1,1,2
37823_0,,,,2,1,1,2
C(CO)(C(C(CO)=O)(C(C)O)O)=O,,,5,1,3,0,3
37824_0,,,,2,1,1,2
37826_0,,,,2,1,1,2
C(C(C(C(C)O)(C(C)O)O)O)=O,,,5,1,3,0,3
37827_0,,,,2,1,1,2
37828_0,,,,2,1,1,2
37829_0,,,,2,1,1,2
37831_0,,,,2,1,1,2
C(C(C=O)(C=O)C(C(C)O)=O)(O)=O,,,5,1,2,0,2
37833_0,,,,2,1,1,2
C(C(C=O)(C(C(C)O)=O)C(C)O)=O,,,5,1,2,0,2
37835_0,,,,2,1,1,2
C(C(C=O)(C(C(C)O)=O)CO)=O,,,5,1,2,0,2
37837_0,,,,2,1,1,2
C(C(C=O)(C(C(C)O)=O)O)(O)=O,,,5,1,3,0,3
37839_0,,,,2,1,1,2
C(C(C(C(CO)=O)(C(C)=O)O)O)=O,,,5,1,3,0,3
37841_0,,,,2,1,1,2
C(C)(C(C(CO)=O)(C(C)O)O)=O,,,5,1,4,0,4
37843_0,,,,2,1,1,2
C(C)(C(C(CO)=O)(C(CO)O)O)=O,,,5,1,3,0,3
37845_0,,,,2,1,1,2
C(C(C=O)(C(CO)=O)C(C)O)=O,,,5,1,3,0,3
37847_0,,,,2,1,1,2
C(C(C=O)(C(C(CO)O)=O)CO)=O,,,5,1,2,0,2
37848_0,,,,2,1,1,2
37850_0,,,,2,1,1,2
C(C(C=O)(C=O)C(CO)=O)(O)=O,,,5,1,2,0,2
37852_0,,,,2,1,1,2
C(C(C=O)(C(CO)=O)C(C=O)O)=O,,,5,1,2,0,2
37854_0,,,,2,1,1,2
C(C(C=O)(C(CO)=O)CO)=O,,,5,1,3,0,3
37856_0,,,,2,1,1,2
C(C(C=O)(C(CO)=O)C(CO)O)=O,,,5,1,2,0,2
37857_0,,,,2,1,1,2
37859_0,,,,2,1,1,2
C(C(C=O)(C(C(C=C)O)=O)CO)=O,,,5,1,1,0,1
37860_0,,,,2,1,1,2
37862_0,,,,2,1,1,2
C(CO)(C(C(C=O)=O)(CO)CO)=O,,,5,1,2,0,2
37863_0,,,,2,1,1,2
37864_0,,,,2,1,1,2
37865_0,,,,2,1,1,2
37866_0,,,,2,1,1,2
37867_0,,,,2,1,1,2
37868_0,,,,2,1,1,2
37869_0,,,,2,1,1,2
37870_0,,,,2,1,1,2
37871_0,,,,2,1,1,2
37872_0,,,,2,1,1,2
37874_0,,,,2,1,1,2
C(C(C(CO)=O)(C(CO)=O)CO)=O,,,5,1,2,0,2
37875_0,,,,2,1,1,2
37876_0,,,,2,1,1,2
37877_0,,,,2,1,1,2
37878_0,,,,2,1,1,2
37880_0,,,,2,1,1,2
C(CC=O)(C(C(CO)=O)(CO)O)=O,,,5,1,3,0,3
37882_0,,,,2,1,1,2
C(CO)(C(C(C=O)=O)(C(C)O)O)=O,,,5,1,4,0,4
37883_0,,,,2,1,1,2
37885_0,,,,2,1,1,2
C(C(C(C(C=C)O)=O)(C(C)O)O)=O,,,5,1,1,0,1
37886_0,,,,2,1,1,2
37887_0,,,,2,1,1,2
37889_0,,,,2,1,1,2
C1(C(C(CO1)(C(CCO)O)O)O)=O,,,5,1,1,0,1
37891_0,,,,2,1,1,2
C(C(C=O)(C(C(C=O)O)=O)O)(O)=O,,,5,1,3,0,3
37893_0,,,,2,1,1,2
C(C(C(CO)=O)(C(C=O)=O)O)(O)=O,,,5,1,4,0,4
37895_0,,,,2,1,1,2
C(C(C(C(C)O)=O)(C(C=O)=O)O)=O,,,5,1,2,0,2
37896_0,,,,2,1,1,2
37897_0,,,,2,1,1,2
37898_0,,,,2,1,1,2
37899_0,,,,2,1,1,2
37900_0,,,,2,1,1,2
37901_0,,,,2,1,1,2
37903_0,,,,2,1,1,2
C(C(C=O)(C(C(C(C)O)O)=O)O)=O,,,5,1,1,0,1
37904_0,,,,2,1,1,2
37905_0,,,,2,1,1,2
37907_0,,,,2,1,1,2
C(C(C=O)(C(C(CC=O)O)=O)O)=O,,,5,1,1,0,1
37909_0,,,,2,1,1,2
C(C(C=O)(C(C(C(C)=O)O)=O)O)=O,,,5,1,1,0,1
37911_0,,,,2,1,1,2
C(C(C=O)(C(C(C=C)O)=O)O)=O,,,5,1,1,0,1
37913_0,,,,2,1,1,2
C(C(C=O)(C(C(C)O)=O)O)=O,,,5,1,1,0,1
37915_0,,,,2,1,1,2
C(C(C=O)(C(C(CCO)O)=O)O)=O,,,5,1,1,0,1
37916_0,,,,2,1,1,2
37917_0,,,,2,1,1,2
37918_0,,,,2,1,1,2
37919_0,,,,2,1,1,2
37921_0,,,,2,1,1,2
C(C(C=O)(C(C(CO)O)=O)O)=O,,,5,1,1,0,1
37922_0,,,,2,1,1,2
37923_0,,,,2,1,1,2
37924_0,,,,2,1,1,2
37925_0,,,,2,1,1,2
37927_0,,,,2,1,1,2
C1(C(C(CO1)(C(CO)(C)O)O)O)=O,,,5,1,1,0,1
37929_0,,,,2,1,1,2
C(C(C=C)O)(C(C(C)=O)(CO)O)=O,,,5,1,1,0,1
37930_0,,,,2,1,1,2
37931_0,,,,2,1,1,2
37932_0,,,,2,1,1,2
37934_0,,,,2,1,1,2
C(C(C(O)=O)(C(C(C)O)=O)O)(O)=O,,,5,1,3,0,3
37936_0,,,,2,1,1,2
C(C(C(C(C)O)=O)(C(C)O)O)(O)=O,,,5,1,3,0,3
37938_0,,,,2,1,1,2
C(C(CO)(CO)O)(CC(CO)=O)=O,,,5,1,4,0,4
37940_0,,,,2,1,1,2
C(C(CO)(CO)C(C(CO)=O)O)=O,,,5,1,4,0,4
37942_0,,,,2,1,1,2
C(C(C(CO)=O)(C(C=O)=O)CO)=O,,,5,1,3,0,3
37944_0,,,,2,1,1,2
C(C(C=C)O)(C1(C(COC1)=O)O)=O,,,5,1,1,0,1
37946_0,,,,2,1,1,2
C(CO)(C1(C(COC1)=O)O)=O,,,5,1,3,0,3
37948_0,,,,2,1,1,2
C(C(C)O)(C1(C(COC1)=O)O)=O,,,5,1,1,0,1
37950_0,,,,2,1,1,2
C(C(CO)O)(C1(C(COC1)=O)O)=O,,,5,1,1,0,1
37951_0,,,,2,1,1,2
37953_0,,,,2,1,1,2
C1(C(C(C(C=C)O)=O)C(CO1)O)=O,,,5,1,1,0,1
37955_0,,,,2,1,1,2
C1(C(C(CO)=O)C(CO1)O)=O,,,5,1,5,0,5
37957_0,,,,2,1,1,2
C1(C(C(C(C)O)=O)C(CO1)O)=O,,,5,1,2,0,2
37959_0,,,,2,1,1,2
C1(C(C(C(CO)O)=O)C(CO1)O)=O,,,5,1,1,0,1
37960_0,,,,2,1,1,2
37962_0,,,,2,1,1,2
C(C(C(C(C=C)O)=O)(CO)O)=O,,,5,1,3,0,3
37964_0,,,,2,1,1,2
C(C(C(C(C=C)O)=O)(CO)O)(O)=O,,,5,1,3,0,3
37966_0,,,,2,1,1,2
C(C(C(C(C=C)O)=O)(C(C)=O)O)=O,,,5,1,1,0,1
37968_0,,,,2,1,1,2
C1(C(C(CO)=O)(C(C(O)O1)O)O)=O,,,5,1,2,0,2
37969_0,,,,2,1,1,2
37971_0,,,,2,1,1,2
C1(C(C(CO1)(C(C(O)O)O)O)O)=O,,,5,1,1,0,1
37973_0,,,,2,1,1,2
C1(C(C(CO1)(C(C(C)O)O)O)O)=O,,,5,1,1,0,1
37975_0,,,,2,1,1,2
C(CO)(C1(C(C(O)OC1)=O)O)=O,,,5,1,3,0,3
37976_0,,,,2,1,1,2
37977_0,,,,2,1,1,2
37979_0,,,,2,1,1,2
C(C(C)(C1(COC(C1O)=O)O)O)=O,,,5,1,2,0,2
37981_0,,,,2,1,1,2
C(C(C)O)(C1(C(C(O)OC1)=O)O)=O,,,5,1,2,0,2
37982_0,,,,2,1,1,2
37983_0,,,,2,1,1,2
37985_0,,,,2,1,1,2
C1(C(C(CO1)(C(C)O)O)O)=O,,,5,1,2,0,2
37986_0,,,,2,1,1,2
37987_0,,,,2,1,1,2
37988_0,,,,2,1,1,2
37989_0,,,,2,1,1,2
37991_0,,,,2,1,1,2
C1(C(C(CO)=O)(C(CO1)O)O)=O,,,5,1,3,0,3
37993_0,,,,2,1,1,2
C1(C(C(C(C)O)=O)(C(CO1)O)O)=O,,,5,1,1,0,1
37995_0,,,,2,1,1,2
C(C(C(CO)=O)(C(C(O)=O)=O)O)=O,,,5,1,2,0,2
37996_0,,,,2,1,1,2
37998_0,,,,2,1,1,2
C(C(C(CO)(C(C(O)O)O)O)O)=O,,,5,1,5,0,5
37999_0,,,,2,1,1,2
38000_0,,,,2,1,1,2
38001_0,,,,2,1,1,2
38002_0,,,,2,1,1,2
38003_0,,,,2,1,1,2
38005_0,,,,2,1,1,2
C(CC(C(CO)=O)(C(C)=O)O)=O,,,5,1,3,0,3
38007_0,,,,2,1,1,2
C(C)(C(C(C(C)O)=O)(CC=O)O)=O,,,5,1,1,0,1
38009_0,,,,2,1,1,2
C(C(C)O)(CC(C(C=O)(O)O)O)=O,,,5,1,2,0,2
38011_0,,,,2,1,1,2
C(C(C(CC(C(C)O)=O)O)(C)O)=O,,,5,1,2,0,2
38013_0,,,,2,1,1,2
C(CC([C](C(O)=O)O)O)(C(C)O)=O,,,5,1,2,0,2
38015_0,,,,2,1,1,2
C(C(C)O)(CC(C(C(O)=O)O)O)=O,,,5,1,2,0,2
38017_0,,,,2,1,1,2
C(C(C(C(CC(C)O)O)=O)(O)O)=O,,,5,1,1,0,1
38019_0,,,,2,1,1,2
C(C(C(C(CC(C)O)O)=O)(C)O)=O,,,5,1,1,0,1
38021_0,,,,2,1,1,2
C([C](C(C(CC(C)O)O)=O)O)(O)=O,,,5,1,1,0,1
38022_0,,,,2,1,1,2
38023_0,,,,2,1,1,2
38024_0,,,,2,1,1,2
38026_0,,,,2,1,1,2
C(CC(C(CO)=O)(C(CO)=O)O)=O,,,5,1,1,0,1
38027_0,,,,2,1,1,2
38028_0,,,,2,1,1,2
38029_0,,,,2,1,1,2
38031_0,,,,2,1,1,2
C1(COC(C(CCO)O)(C1O)O)=O,,,5,1,2,0,2
38032_0,,,,2,1,1,2
38033_0,,,,2,1,1,2
38034_0,,,,2,1,1,2
38035_0,,,,2,1,1,2
38037_0,,,,2,1,1,2
C(C(C(C(C(CO)=O)=O)O)(O)O)=O,,,5,1,2,0,2
38038_0,,,,2,1,1,2
38040_0,,,,2,1,1,2
C(C(C(C(C(C=O)O)O)=O)(O)O)=O,,,5,1,1,0,1
38042_0,,,,2,1,1,2
[C](C(O)=O)(C(C(C(CO)=O)=O)O)O,,,5,1,2,0,2
38043_0,,,,2,1,1,2
38045_0,,,,2,1,1,2
C(C(C(C([C](C(O)=O)O)=O)O)O)=O,,,5,1,1,0,1
38047_0,,,,2,1,1,2
C(C(C(CO)=O)(C(C=O)(O)O)O)=O,,,5,1,2,0,2
38049_0,,,,2,1,1,2
C(C(C(CO)=O)([C](C(O)=O)O)O)=O,,,5,1,2,0,2
38051_0,,,,2,1,1,2
C(CO)(C(CO)(C(C=O)(O)O)O)=O,,,5,1,4,0,4
38053_0,,,,2,1,1,2
C(CO)(C([C](C(O)=O)O)(CO)O)=O,,,5,1,5,0,5
38054_0,,,,2,1,1,2
38055_0,,,,2,1,1,2
38056_0,,,,2,1,1,2
38057_0,,,,2,1,1,2
38058_0,,,,2,1,1,2
38059_0,,,,2,1,1,2
38060_0,,,,2,1,1,2
38061_0,,,,2,1,1,2
38063_0,,,,2,1,1,2
C(C(C=C)O)(C(C(C=O)=O)(C)O)=O,,,5,1,1,0,1
38065_0,,,,2,1,1,2
C(C(C(C(C(C)O)O)=O)(O)O)=O,,,5,1,1,0,1
38066_0,,,,2,1,1,2
38067_0,,,,2,1,1,2
38068_0,,,,2,1,1,2
38070_0,,,,2,1,1,2
C([C](C(C(C(C)O)O)=O)O)(O)=O,,,5,1,1,0,1
38071_0,,,,2,1,1,2
38072_0,,,,2,1,1,2
38073_0,,,,2,1,1,2
38074_0,,,,2,1,1,2
38075_0,,,,2,1,1,2
38076_0,,,,2,1,1,2
38078_0,,,,2,1,1,2
C1(COC(C(CO)(C)O)(C1O)O)=O,,,5,1,1,0,1
38080_0,,,,2,1,1,2
C(C(C(C(C=C)O)=O)(CCO)O)=O,,,5,1,1,0,1
38081_0,,,,2,1,1,2
38083_0,,,,2,1,1,2
C(C(C(C(CC=O)O)=O)(O)O)=O,,,5,1,1,0,1
38085_0,,,,2,1,1,2
C(CC(C([C](C(O)=O)O)=O)O)=O,,,5,1,1,0,1
38087_0,,,,2,1,1,2
C(C(C(O)=O)(CC(C=O)O)O)(O)=O,,,5,1,3,0,3
38089_0,,,,2,1,1,2
C(C(CC(C=O)O)(C(C)O)O)(O)=O,,,5,1,3,0,3
38091_0,,,,2,1,1,2
C(C(C(C(CC(O)=O)O)=O)(O)O)=O,,,5,1,1,0,1
38093_0,,,,2,1,1,2
C(CC(C([C](C(O)=O)O)=O)O)(O)=O,,,5,1,1,0,1
38095_0,,,,2,1,1,2
C(C1(C(CCO1)=O)O)(C(C=C)O)=O,,,5,1,1,0,1
38097_0,,,,2,1,1,2
C1(CCOC1(C(CO)=O)O)=O,,,5,1,2,0,2
38099_0,,,,2,1,1,2
C1(CCOC1(C(C(C)O)=O)O)=O,,,5,1,1,0,1
38101_0,,,,2,1,1,2
C1(CCOC1(C(C(CO)O)=O)O)=O,,,5,1,1,0,1
38102_0,,,,2,1,1,2
38104_0,,,,2,1,1,2
C(C(C=O)(O)O)(C(C(C)=O)O)=O,,,5,1,1,0,1
38106_0,,,,2,1,1,2
C(C)(C(C([C](C(O)=O)O)=O)O)=O,,,5,1,1,0,1
38108_0,,,,2,1,1,2
C(C(C(C(C=C)O)=O)(C=C)O)(O)=O,,,5,1,1,0,1
38110_0,,,,2,1,1,2
C1(C(C(C(C=C)O)=O)(CCO1)O)=O,,,5,1,1,0,1
38112_0,,,,2,1,1,2
C(C(C(C(C=C)O)=O)(O)O)=O,,,5,1,1,0,1
38114_0,,,,2,1,1,2
C(C(C(C(C=C)O)=O)(C)O)=O,,,5,1,1,0,1
38116_0,,,,2,1,1,2
C=CC(C([C](C(O)=O)O)=O)O,,,5,1,1,0,1
38117_0,,,,2,1,1,2
38119_0,,,,2,1,1,2
C(C(C(C(C=C)O)=O)(CC=O)O)=O,,,5,1,1,0,1
38121_0,,,,2,1,1,2
C(C(C(C(C=C)O)=O)(C)O)(O)=O,,,5,1,2,0,2
38123_0,,,,2,1,1,2
C(C(C(CO)=O)(C=C)O)(O)=O,,,5,1,5,0,5
38125_0,,,,2,1,1,2
C(C(C(C(C)O)=O)(C=C)O)(O)=O,,,5,1,2,0,2
38127_0,,,,2,1,1,2
C(C(C(C(CO)O)=O)(C=C)O)(O)=O,,,5,1,2,0,2
38128_0,,,,2,1,1,2
38130_0,,,,2,1,1,2
C(C1(C(C(CO1)=O)O)O)(O)=O,,,5,1,2,0,2
38132_0,,,,2,1,1,2
C1(COC(C(C(O)O)O)(C1O)O)=O,,,5,1,1,0,1
38134_0,,,,2,1,1,2
C1(COC(C(C(C)O)O)(C1O)O)=O,,,5,1,1,0,1
38136_0,,,,2,1,1,2
C1(C(COC1(C(CO)=O)O)O)=O,,,5,1,2,0,2
38138_0,,,,2,1,1,2
C(C(C1(C(C(CO1)=O)O)O)O)=O,,,5,1,2,0,2
38140_0,,,,2,1,1,2
C(C(C1(C(C(CO1)=O)O)O)O)(O)=O,,,5,1,1,0,1
38142_0,,,,2,1,1,2
C(C(C)(C1(C(C(CO1)=O)O)O)O)=O,,,5,1,1,0,1
38144_0,,,,2,1,1,2
C1(C(COC1(C(C(C)O)=O)O)O)=O,,,5,1,1,0,1
38146_0,,,,2,1,1,2
C(C)(C(C1(C(C(CO1)=O)O)O)O)=O,,,5,1,1,0,1
38148_0,,,,2,1,1,2
C(CC(C1(C(C(CO1)=O)O)O)O)=O,,,5,1,2,0,2
38150_0,,,,2,1,1,2
C1(COC(C(C)O)(C1O)O)=O,,,5,1,2,0,2
38151_0,,,,2,1,1,2
38153_0,,,,2,1,1,2
C1(COC(C(CO)O)(C1O)O)=O,,,5,1,2,0,2
38155_0,,,,2,1,1,2
C1(C(C(CO)=O)(CCO1)O)=O,,,5,1,3,0,3
38157_0,,,,2,1,1,2
C1(C(C(C(C)O)=O)(CCO1)O)=O,,,5,1,2,0,2
38159_0,,,,2,1,1,2
C1(C(C(C(CO)O)=O)(CCO1)O)=O,,,5,1,1,0,1
38160_0,,,,2,1,1,2
38162_0,,,,2,1,1,2
C(C(C(CO)=O)(CC(O)=O)O)(O)=O,,,5,1,3,0,3
38163_0,,,,2,1,1,2
38164_0,,,,2,1,1,2
38166_0,,,,2,1,1,2
C(C(C(C(C)O)=O)(O)O)=O,,,5,1,1,0,1
38168_0,,,,2,1,1,2
C(C(C(C(CCO)O)=O)(O)O)=O,,,5,1,1,0,1
38169_0,,,,2,1,1,2
38170_0,,,,2,1,1,2
38171_0,,,,2,1,1,2
38172_0,,,,2,1,1,2
38174_0,,,,2,1,1,2
C(C(C(C(CO)O)=O)(O)O)=O,,,5,1,1,0,1
38175_0,,,,2,1,1,2
38177_0,,,,2,1,1,2
C(C(C(C(C(CO)O)O)=O)(O)O)=O,,,5,1,1,0,1
38178_0,,,,2,1,1,2
38179_0,,,,2,1,1,2
38180_0,,,,2,1,1,2
38181_0,,,,2,1,1,2
38182_0,,,,2,1,1,2
38183_0,,,,2,1,1,2
38184_0,,,,2,1,1,2
38186_0,,,,2,1,1,2
C([C](C(C(C)O)=O)O)(O)=O,,,5,1,1,0,1
38188_0,,,,2,1,1,2
C([C](C(C(CCO)O)=O)O)(O)=O,,,5,1,1,0,1
38189_0,,,,2,1,1,2
38190_0,,,,2,1,1,2
38191_0,,,,2,1,1,2
38192_0,,,,2,1,1,2
38194_0,,,,2,1,1,2
C([C](C(C(CO)O)=O)O)(O)=O,,,5,1,1,0,1
38195_0,,,,2,1,1,2
38197_0,,,,2,1,1,2
C([C](C(C(C(CO)O)O)=O)O)(O)=O,,,5,1,1,0,1
38198_0,,,,2,1,1,2
38200_0,,,,2,1,1,2
C(CO)(OC(CO)=O)=O,,,5,1,1,0,1
38202_0,,,,2,1,1,2
C(CO)(OCC(CO)=O)=O,,,5,1,2,0,2
38204_0,,,,2,1,1,2
C(CO)(C(CO)OC(CO)=O)=O,,,5,1,2,0,2
38206_0,,,,2,1,1,2
C(CO)(C(COC(CO)=O)O)=O,,,5,1,2,0,2
38208_0,,,,2,1,1,2
C(CCC(C(C(CO)O)=O)O)=O,,,5,1,2,0,2
38209_0,,,,2,1,1,2
38210_0,,,,2,1,1,2
38211_0,,,,2,1,1,2
38213_0,,,,2,1,1,2
C(C(C=O)CC(C(C=O)=O)O)=O,,,5,1,3,0,3
38215_0,,,,2,1,1,2
C(C(C=O)CC(C(CO)=O)=O)=O,,,5,1,3,0,3
38217_0,,,,2,1,1,2
C(C(C=O)C(CC(CO)=O)=O)=O,,,5,1,4,0,4
38219_0,,,,2,1,1,2
C(CCC(C(C=O)=O)O)=O,,,5,1,4,0,4
38220_0,,,,2,1,1,2
38221_0,,,,2,1,1,2
38222_0,,,,2,1,1,2
38223_0,,,,2,1,1,2
38224_0,,,,2,1,1,2
38225_0,,,,2,1,1,2
38227_0,,,,2,1,1,2
C(C(CO)CC(C(C=O)=O)O)=O,,,5,1,2,0,2
38228_0,,,,2,1,1,2
38229_0,,,,2,1,1,2
38231_0,,,,2,1,1,2
C(C(C(C(C=O)O)=O)C)=O,,,5,1,2,0,2
38232_0,,,,2,1,1,2
38233_0,,,,2,1,1,2
38234_0,,,,2,1,1,2
38235_0,,,,2,1,1,2
38237_0,,,,2,1,1,2
C(C(C(C(C=O)O)=O)CCO)=O,,,5,1,2,0,2
38238_0,,,,2,1,1,2
38239_0,,,,2,1,1,2
38240_0,,,,2,1,1,2
38241_0,,,,2,1,1,2
38243_0,,,,2,1,1,2
C(CCC(C(C(CO)=O)=O)O)=O,,,5,1,2,0,2
38244_0,,,,2,1,1,2
38245_0,,,,2,1,1,2
38246_0,,,,2,1,1,2
38247_0,,,,2,1,1,2
38248_0,,,,2,1,1,2
38250_0,,,,2,1,1,2
C(C(CC(CC(C=O)O)=O)O)=O,,,5,1,3,0,3
38251_0,,,,2,1,1,2
38253_0,,,,2,1,1,2
C(CCC(C=O)O)(C(C=O)O)=O,,,5,1,6,0,6
38254_0,,,,2,1,1,2
38255_0,,,,2,1,1,2
38256_0,,,,2,1,1,2
38257_0,,,,2,1,1,2
38258_0,,,,2,1,1,2
38259_0,,,,2,1,1,2
38260_0,,,,2,1,1,2
38261_0,,,,2,1,1,2
38263_0,,,,2,1,1,2
C(C)(CC(C(C(CO)=O)=O)O)=O,,,5,1,1,0,1
38264_0,,,,2,1,1,2
38265_0,,,,2,1,1,2
38266_0,,,,2,1,1,2
38267_0,,,,2,1,1,2
38268_0,,,,2,1,1,2
38270_0,,,,2,1,1,2
C(C(CO)O)(C(C(C=O)=O)C)=O,,,5,1,3,0,3
38271_0,,,,2,1,1,2
38273_0,,,,2,1,1,2
C(CO)(C(C(C(CO)=O)=O)C)=O,,,5,1,2,0,2
38275_0,,,,2,1,1,2
C(C(C)C(C=O)O)(C(C=O)O)=O,,,5,1,2,0,2
38276_0,,,,2,1,1,2
38278_0,,,,2,1,1,2
C(C(C(CC)=O)O)=O,,,5,1,2,0,2
38279_0,,,,2,1,1,2
38280_0,,,,2,1,1,2
38281_0,,,,2,1,1,2
38282_0,,,,2,1,1,2
38284_0,,,,2,1,1,2
C(C(C(CO)CC(C=O)=O)O)=O,,,5,1,5,0,5
38286_0,,,,2,1,1,2
C(C(C=O)C(CO)C(C=O)O)=O,,,5,1,7,0,7
38288_0,,,,2,1,1,2
C(CC(CO)C(C=O)O)=O,,,5,1,8,0,8
38289_0,,,,2,1,1,2
38290_0,,,,2,1,1,2
38292_0,,,,2,1,1,2
C(C(C(C(C(CO)=O)O)=O)C)=O,,,5,1,2,0,2
38293_0,,,,2,1,1,2
38294_0,,,,2,1,1,2
38295_0,,,,2,1,1,2
38296_0,,,,2,1,1,2
38298_0,,,,2,1,1,2
C(CO)(C(CC(C)=O)O)=O,,,5,1,2,0,2
38300_0,,,,2,1,1,2
C(CC)(C(C(CO)=O)O)=O,,,5,1,2,0,2
38301_0,,,,2,1,1,2
38302_0,,,,2,1,1,2
38304_0,,,,2,1,1,2
C(CCC(C(C(O)=O)=O)O)=O,,,5,1,3,0,3
38305_0,,,,2,1,1,2
38306_0,,,,2,1,1,2
38307_0,,,,2,1,1,2
38308_0,,,,2,1,1,2
38310_0,,,,2,1,1,2
C(C(C=O)CC(C=O)O)=O,,,5,1,5,0,5
38312_0,,,,2,1,1,2
C(C(C=O)CC(C(CO)=O)O)=O,,,5,1,3,0,3
38313_0,,,,2,1,1,2
38315_0,,,,2,1,1,2
C(CC(CC(C(C=O)O)=O)=O)=O,,,5,1,6,0,6
38316_0,,,,2,1,1,2
38318_0,,,,2,1,1,2
C(C(C(C(CCC=O)=O)=O)O)=O,,,5,1,2,0,2
38320_0,,,,2,1,1,2
C(CCC(C(C(C=O)=O)=O)O)=O,,,5,1,2,0,2
38321_0,,,,2,1,1,2
38322_0,,,,2,1,1,2
38323_0,,,,2,1,1,2
38325_0,,,,2,1,1,2
C(C(CC(C=O)C(C=O)O)O)=O,,,5,1,4,0,4
38326_0,,,,2,1,1,2
38327_0,,,,2,1,1,2
38328_0,,,,2,1,1,2
38329_0,,,,2,1,1,2
38330_0,,,,2,1,1,2
38331_0,,,,2,1,1,2
38333_0,,,,2,1,1,2
C(C(C(C(C=O)O)=O)CC=O)=O,,,5,1,4,0,4
38335_0,,,,2,1,1,2
C(C(CC(C=O)C(CO)=O)O)=O,,,5,1,5,0,5
38336_0,,,,2,1,1,2
38337_0,,,,2,1,1,2
38338_0,,,,2,1,1,2
38339_0,,,,2,1,1,2
38340_0,,,,2,1,1,2
38341_0,,,,2,1,1,2
38342_0,,,,2,1,1,2
38343_0,,,,2,1,1,2
38344_0,,,,2,1,1,2
38345_0,,,,2,1,1,2
38346_0,,,,2,1,1,2
38347_0,,,,2,1,1,2
38348_0,,,,2,1,1,2
38350_0,,,,2,1,1,2
C(C(C(C(CC(C)=O)=O)=O)O)=O,,,5,1,2,0,2
38352_0,,,,2,1,1,2
C(C)(CC(C(C(C=O)=O)=O)O)=O,,,5,1,1,0,1
38353_0,,,,2,1,1,2
38354_0,,,,2,1,1,2
38356_0,,,,2,1,1,2
C(C)(CC(C(C=O)=O)O)=O,,,5,1,4,0,4
38358_0,,,,2,1,1,2
C(CO)(C(C(C(C=O)=O)=O)C)=O,,,5,1,2,0,2
38360_0,,,,2,1,1,2
C(C(C=O)O)(C(C(C=O)=O)C)=O,,,5,1,3,0,3
38362_0,,,,2,1,1,2
C(CO)(C(C(C=O)=O)C)=O,,,5,1,3,0,3
38363_0,,,,2,1,1,2
38364_0,,,,2,1,1,2
38366_0,,,,2,1,1,2
C(CO)(CCC(C(C=O)=O)O)=O,,,5,1,5,0,5
38367_0,,,,2,1,1,2
38369_0,,,,2,1,1,2
C(CC(C(C=O)=O)O)(CCO)=O,,,5,1,5,0,5
38371_0,,,,2,1,1,2
C(CCC(C=O)O)=O,,,5,1,6,0,6
38373_0,,,,2,1,1,2
C(CCC(C(CO)=O)O)=O,,,5,1,3,0,3
38375_0,,,,2,1,1,2
C(C(C=O)C(C(C=O)O)=O)=O,,,5,1,3,0,3
38376_0,,,,2,1,1,2
38377_0,,,,2,1,1,2
38378_0,,,,2,1,1,2
38380_0,,,,2,1,1,2
C(C(C(CC=O)=O)C(CO)=O)=O,,,5,1,4,0,4
38381_0,,,,2,1,1,2
38382_0,,,,2,1,1,2
38383_0,,,,2,1,1,2
38385_0,,,,2,1,1,2
C(C)(C(CO)C(C=O)O)=O,,,5,1,5,0,5
38386_0,,,,2,1,1,2
38387_0,,,,2,1,1,2
38388_0,,,,2,1,1,2
38389_0,,,,2,1,1,2
38390_0,,,,2,1,1,2
38391_0,,,,2,1,1,2
38393_0,,,,2,1,1,2
C(C(C(C(C=O)O)=O)C(C)=O)=O,,,5,1,2,0,2
38394_0,,,,2,1,1,2
38395_0,,,,2,1,1,2
38397_0,,,,2,1,1,2
C(C(C(C(C(C)O)=O)=O)CO)=O,,,5,1,2,0,2
38398_0,,,,2,1,1,2
38399_0,,,,2,1,1,2
38401_0,,,,2,1,1,2
C(C(C)C(C(CC=O)=O)O)(O)=O,,,5,1,1,0,1
38402_0,,,,2,1,1,2
38403_0,,,,2,1,1,2
38404_0,,,,2,1,1,2
38405_0,,,,2,1,1,2
38406_0,,,,2,1,1,2
38407_0,,,,2,1,1,2
38409_0,,,,2,1,1,2
C(C(C)C(C(C(C)=O)=O)O)(O)=O,,,5,1,1,0,1
38411_0,,,,2,1,1,2
C(C(C(C(C(C)O)=O)=O)C)(O)=O,,,5,1,2,0,2
38412_0,,,,2,1,1,2
38413_0,,,,2,1,1,2
38415_0,,,,2,1,1,2
C(C)(CC(C(C(O)=O)=O)O)=O,,,5,1,3,0,3
38417_0,,,,2,1,1,2
C(CO)(C(C(C(O)=O)=O)C)=O,,,5,1,2,0,2
38419_0,,,,2,1,1,2
C(C(C(C(C=O)O)=O)C)(O)=O,,,5,1,2,0,2
38421_0,,,,2,1,1,2
C(C(C)C(C(CO)=O)O)(O)=O,,,5,1,1,0,1
38423_0,,,,2,1,1,2
C(C(C)C(C=O)O)(O)=O,,,5,1,2,0,2
38425_0,,,,2,1,1,2
C(C(CCO)C(C=O)O)(O)=O,,,5,1,3,0,3
38426_0,,,,2,1,1,2
38427_0,,,,2,1,1,2
38428_0,,,,2,1,1,2
38429_0,,,,2,1,1,2
38431_0,,,,2,1,1,2
C(C1COC(C1O)=O)=O,,,5,1,3,0,3
38433_0,,,,2,1,1,2
C(C1C(CO)OC(C1O)=O)=O,,,5,1,4,0,4
38434_0,,,,2,1,1,2
38435_0,,,,2,1,1,2
38436_0,,,,2,1,1,2
38438_0,,,,2,1,1,2
C1(C(COCC1O)O)=O,,,5,1,1,0,1
38439_0,,,,2,1,1,2
38440_0,,,,2,1,1,2
38442_0,,,,2,1,1,2
C1(C(O)OCCC1O)=O,,,5,1,2,0,2
38444_0,,,,2,1,1,2
C1(C(C(CO)OCC1O)O)=O,,,5,1,1,0,1
38445_0,,,,2,1,1,2
38446_0,,,,2,1,1,2
38448_0,,,,2,1,1,2
C1(C(O)OC(CO)CC1O)=O,,,5,1,2,0,2
38450_0,,,,2,1,1,2
C1(COC(C(CO)C1O)O)=O,,,5,1,3,0,3
38452_0,,,,2,1,1,2
C(C1C(COC(C1O)=O)O)=O,,,5,1,3,0,3
38454_0,,,,2,1,1,2
C1(C(C(COCC1O)O)O)=O,,,5,1,1,0,1
38455_0,,,,2,1,1,2
38457_0,,,,2,1,1,2
C1(COC(C(CC1O)O)O)=O,,,5,1,2,0,2
38459_0,,,,2,1,1,2
C1(C(CCOC(C1O)O)O)=O,,,5,1,2,0,2
38460_0,,,,2,1,1,2
38462_0,,,,2,1,1,2
C1(C(O)OCC(CC1O)O)=O,,,5,1,2,0,2
38463_0,,,,2,1,1,2
38465_0,,,,2,1,1,2
C1(C(C(CCO1)O)=O)=O,,,5,1,2,0,2
38467_0,,,,2,1,1,2
C1(CC(C(C(CO)O1)=O)O)=O,,,5,1,3,0,3
38469_0,,,,2,1,1,2
C1(C(C(CC(CO)O1)O)=O)=O,,,5,1,2,0,2
38471_0,,,,2,1,1,2
C1(C(CC(C(CO1)=O)O)O)=O,,,5,1,3,0,3
38473_0,,,,2,1,1,2
C1(C(C(C(CCO1)O)=O)O)=O,,,5,1,2,0,2
38475_0,,,,2,1,1,2
C1(CC(C(C(CO1)O)=O)O)=O,,,5,1,3,0,3
38477_0,,,,2,1,1,2
C1(C(C(CC(CO1)O)O)=O)=O,,,5,1,2,0,2
38478_0,,,,2,1,1,2
38479_0,,,,2,1,1,2
38480_0,,,,2,1,1,2
38481_0,,,,2,1,1,2
38483_0,,,,2,1,1,2
C(C(C(C(CCO)O)=O)=O)(O)=O,,,5,1,1,0,1
38484_0,,,,2,1,1,2
38485_0,,,,2,1,1,2
38486_0,,,,2,1,1,2
38488_0,,,,2,1,1,2
C(CO)(C(C=CC(C=O)=O)O)=O,,,5,1,5,0,5
38490_0,,,,2,1,1,2
C(CO)(C(C=C(C=O)C=O)O)=O,,,5,1,3,0,3
38491_0,,,,2,1,1,2
38492_0,,,,2,1,1,2
38494_0,,,,2,1,1,2
C(CO)(CO)=CC(C(CO)=O)=O,,,5,1,2,0,2
38496_0,,,,2,1,1,2
C(C(C(C=O)=O)O)=C(CO)CO,,,5,1,2,0,2
38497_0,,,,2,1,1,2
38498_0,,,,2,1,1,2
38499_0,,,,2,1,1,2
38500_0,,,,2,1,1,2
38501_0,,,,2,1,1,2
38502_0,,,,2,1,1,2
38503_0,,,,2,1,1,2
38504_0,,,,2,1,1,2
38505_0,,,,2,1,1,2
38506_0,,,,2,1,1,2
38508_0,,,,2,1,1,2
C(C=CC(CO)=O)(C(CO)O)=O,,,5,1,5,0,5
38509_0,,,,2,1,1,2
38511_0,,,,2,1,1,2
C(C(CO)=CC=O)(C(CO)O)=O,,,5,1,3,0,3
38512_0,,,,2,1,1,2
38514_0,,,,2,1,1,2
C(CO)(C(C(C(CO)=O)=C)O)=O,,,5,1,4,0,4
38516_0,,,,2,1,1,2
C(C(C(C(C(CO)O)=O)=C)O)=O,,,5,1,3,0,3
38517_0,,,,2,1,1,2
38518_0,,,,2,1,1,2
38519_0,,,,2,1,1,2
38520_0,,,,2,1,1,2
38521_0,,,,2,1,1,2
38522_0,,,,2,1,1,2
38523_0,,,,2,1,1,2
38524_0,,,,2,1,1,2
38525_0,,,,2,1,1,2
38526_0,,,,2,1,1,2
38527_0,,,,2,1,1,2
38529_0,,,,2,1,1,2
C(C=CC(C(CO)=O)=O)(O)=O,,,5,1,2,0,2
38531_0,,,,2,1,1,2
C(C(C(C=O)=O)O)=CC(O)=O,,,5,1,5,0,5
38532_0,,,,2,1,1,2
38533_0,,,,2,1,1,2
38534_0,,,,2,1,1,2
38535_0,,,,2,1,1,2
38536_0,,,,2,1,1,2
38537_0,,,,2,1,1,2
38539_0,,,,2,1,1,2
C(C(C)=CC(C(CO)=O)=O)=O,,,5,1,2,0,2
38541_0,,,,2,1,1,2
C(C(C(C=O)=O)O)=C(C=O)C,,,5,1,2,0,2
38543_0,,,,2,1,1,2
C=C(C=O)CC(C(CO)=O)=O,,,5,1,2,0,2
38545_0,,,,2,1,1,2
C=C(C=O)CC(C(C=O)=O)O,,,5,1,2,0,2
38547_0,,,,2,1,1,2
C(C(C(C(C=O)=C)=O)O)=O,,,5,1,2,0,2
38548_0,,,,2,1,1,2
38550_0,,,,2,1,1,2
C=C(C(C(C)O)=O)C(C=O)=O,,,5,1,2,0,2
38552_0,,,,2,1,1,2
C(C(C(C(C)O)=O)=CC=O)=O,,,5,1,3,0,3
38553_0,,,,2,1,1,2
38554_0,,,,2,1,1,2
38556_0,,,,2,1,1,2
C(C(C=CC(C)=O)=O)(CO)=O,,,5,1,2,0,2
38558_0,,,,2,1,1,2
C(C(C(C=O)=O)O)=CC(C)=O,,,5,1,2,0,2
38559_0,,,,2,1,1,2
38560_0,,,,2,1,1,2
38561_0,,,,2,1,1,2
38562_0,,,,2,1,1,2
38564_0,,,,2,1,1,2
C(C(C=CC(C(C)O)=O)=O)=O,,,5,1,2,0,2
38566_0,,,,2,1,1,2
C=C(C(CO)=O)CC(C=O)=O,,,5,1,3,0,3
38568_0,,,,2,1,1,2
C(C(C=C(C(CO)=O)C)=O)=O,,,5,1,2,0,2
38569_0,,,,2,1,1,2
38570_0,,,,2,1,1,2
38571_0,,,,2,1,1,2
38572_0,,,,2,1,1,2
38573_0,,,,2,1,1,2
38574_0,,,,2,1,1,2
38575_0,,,,2,1,1,2
38577_0,,,,2,1,1,2
C(CC=CC(C(CO)=O)=O)=O,,,5,1,2,0,2
38579_0,,,,2,1,1,2
C(CC=CC(C(C=O)=O)O)=O,,,5,1,2,0,2
38581_0,,,,2,1,1,2
C(CC(C(CO)=O)=O)=CC=O,,,5,1,4,0,4
38583_0,,,,2,1,1,2
C(CC(C(C=O)=O)O)=CC=O,,,5,1,2,0,2
38584_0,,,,2,1,1,2
38585_0,,,,2,1,1,2
38586_0,,,,2,1,1,2
38587_0,,,,2,1,1,2
38588_0,,,,2,1,1,2
38589_0,,,,2,1,1,2
38591_0,,,,2,1,1,2
C(C(C=O)=CC(C(C)O)=O)=O,,,5,1,2,0,2
38593_0,,,,2,1,1,2
C(C(C=O)C(C(CO)=O)=C)=O,,,5,1,3,0,3
38595_0,,,,2,1,1,2
C(C(C=O)=C(C(CO)=O)C)=O,,,5,1,2,0,2
38597_0,,,,2,1,1,2
C(C(C=C(C=O)C=O)O)=O,,,5,1,2,0,2
38598_0,,,,2,1,1,2
38600_0,,,,2,1,1,2
C(C(C(C(C=O)=CCO)=O)O)=O,,,5,1,2,0,2
38601_0,,,,2,1,1,2
38603_0,,,,2,1,1,2
C(C(C=C(C(C=O)=O)CO)O)=O,,,5,1,2,0,2
38605_0,,,,2,1,1,2
C=C(C(C(CO)O)=O)C(C=O)=O,,,5,1,2,0,2
38606_0,,,,2,1,1,2
38608_0,,,,2,1,1,2
C=C(C(CO)=O)C(C=O)=O,,,5,1,2,0,2
38609_0,,,,2,1,1,2
38610_0,,,,2,1,1,2
38612_0,,,,2,1,1,2
C(C(C(C=CC(C=O)O)=O)O)=O,,,5,1,4,0,4
38613_0,,,,2,1,1,2
38614_0,,,,2,1,1,2
38615_0,,,,2,1,1,2
38616_0,,,,2,1,1,2
38617_0,,,,2,1,1,2
38619_0,,,,2,1,1,2
C(C(C(C=O)=CC(C=O)O)O)=O,,,5,1,3,0,3
38620_0,,,,2,1,1,2
38621_0,,,,2,1,1,2
38622_0,,,,2,1,1,2
38623_0,,,,2,1,1,2
38624_0,,,,2,1,1,2
38625_0,,,,2,1,1,2
38626_0,,,,2,1,1,2
38627_0,,,,2,1,1,2
38628_0,,,,2,1,1,2
38630_0,,,,2,1,1,2
C(C=CC(CO)=O)(CO)=O,,,5,1,3,0,3
38631_0,,,,2,1,1,2
38633_0,,,,2,1,1,2
C(C(C(C(CO)=CC=O)=O)O)=O,,,5,1,3,0,3
38635_0,,,,2,1,1,2
C(C=C(C(CO)=O)CO)=O,,,5,1,6,0,6
38636_0,,,,2,1,1,2
38637_0,,,,2,1,1,2
38638_0,,,,2,1,1,2
38640_0,,,,2,1,1,2
C(C(C=C(C=O)C(CO)=O)O)=O,,,5,1,2,0,2
38641_0,,,,2,1,1,2
38642_0,,,,2,1,1,2
38643_0,,,,2,1,1,2
38644_0,,,,2,1,1,2
38645_0,,,,2,1,1,2
38646_0,,,,2,1,1,2
38648_0,,,,2,1,1,2
C(C=CC(C(C)O)=O)=O,,,5,1,2,0,2
38650_0,,,,2,1,1,2
C(C=C(C(CO)=O)C)=O,,,5,1,2,0,2
38652_0,,,,2,1,1,2
C(CC(C(CO)=O)=C)=O,,,5,1,3,0,3
38654_0,,,,2,1,1,2
C(C(C(C(C(C=O)O)=O)=C)O)=O,,,5,1,3,0,3
38656_0,,,,2,1,1,2
C=C(C(CO)=O)C(C(C=O)=O)O,,,5,1,2,0,2
38658_0,,,,2,1,1,2
C(C(C(C(CO)=O)=C)O)=O,,,5,1,4,0,4
38660_0,,,,2,1,1,2
C=CCC(C(CO)=O)=O,,,5,1,2,0,2
38662_0,,,,2,1,1,2
C=CCC(C(C=O)=O)O,,,5,1,2,0,2
38664_0,,,,2,1,1,2
C(C)=CC(C(CO)=O)=O,,,5,1,2,0,2
38666_0,,,,2,1,1,2
C(C(C(C=O)=O)O)=CC,,,5,1,2,0,2
38668_0,,,,2,1,1,2
C(C(CO)=CC(C(CO)=O)=O)=O,,,5,1,2,0,2
38670_0,,,,2,1,1,2
C(C(C(C=O)=O)O)=C(C=O)CO,,,5,1,3,0,3
38671_0,,,,2,1,1,2
38673_0,,,,2,1,1,2
C(C(C=CC(CO)=O)=O)(CO)=O,,,5,1,2,0,2
38674_0,,,,2,1,1,2
38676_0,,,,2,1,1,2
C(C(CO)O)=CC(C(CO)=O)=O,,,5,1,2,0,2
38678_0,,,,2,1,1,2
C(C(C(C=O)=O)O)=CC(CO)O,,,5,1,4,0,4
38679_0,,,,2,1,1,2
38680_0,,,,2,1,1,2
38681_0,,,,2,1,1,2
38682_0,,,,2,1,1,2
38684_0,,,,2,1,1,2
C(CO)=CC(C(CO)=O)=O,,,5,1,2,0,2
38686_0,,,,2,1,1,2
C(C(C(C=O)=O)O)=CCO,,,5,1,4,0,4
38687_0,,,,2,1,1,2
38688_0,,,,2,1,1,2
38689_0,,,,2,1,1,2
38690_0,,,,2,1,1,2
38692_0,,,,2,1,1,2
C(C(C(CO)=O)(C(C=O)=C)O)=O,,,5,1,2,0,2
38694_0,,,,2,1,1,2
C(C(C(CO)=O)(C=CC=O)O)=O,,,5,1,2,0,2
38695_0,,,,2,1,1,2
38696_0,,,,2,1,1,2
38697_0,,,,2,1,1,2
38698_0,,,,2,1,1,2
38699_0,,,,2,1,1,2
38701_0,,,,2,1,1,2
C(C(C(C(CO)=O)=C)(CO)O)=O,,,5,1,4,0,4
38703_0,,,,2,1,1,2
C=C(C(O)=O)C(C(C)O)=O,,,5,1,2,0,2
38705_0,,,,2,1,1,2
C(CO)=C(C(C(C)O)=O)C(O)=O,,,5,1,2,0,2
38707_0,,,,2,1,1,2
C=C(C(O)=O)C(C(CCO)O)=O,,,5,1,2,0,2
38708_0,,,,2,1,1,2
38709_0,,,,2,1,1,2
38710_0,,,,2,1,1,2
38711_0,,,,2,1,1,2
38712_0,,,,2,1,1,2
38713_0,,,,2,1,1,2
38715_0,,,,2,1,1,2
C(C(C)O)(C(C(C(O)=O)=C)O)=O,,,5,1,2,0,2
38717_0,,,,2,1,1,2
C(CO)(C(C(C(O)=O)=C)(C)O)=O,,,5,1,2,0,2
38719_0,,,,2,1,1,2
C(C(C(C(CO)=O)=C)(C)O)(O)=O,,,5,1,3,0,3
38721_0,,,,2,1,1,2
C(C(C(C(CO)=O)=C)O)(O)=O,,,5,1,4,0,4
38723_0,,,,2,1,1,2
C=C(C(O)=O)C(C(CO)O)=O,,,5,1,4,0,4
38725_0,,,,2,1,1,2
C(C(C(C(C(O)=O)=C)O)O)=O,,,5,1,2,0,2
38726_0,,,,2,1,1,2
38728_0,,,,2,1,1,2
C(CO)=C(C(O)=O)C(CO)=O,,,5,1,4,0,4
38730_0,,,,2,1,1,2
C(C(C=C(C=O)CO)O)=O,,,5,1,4,0,4
38731_0,,,,2,1,1,2
38733_0,,,,2,1,1,2
C(C(C=CC(O)=O)O)=O,,,5,1,6,0,6
38735_0,,,,2,1,1,2
C=CC(C(C(O)=O)=O)O,,,5,1,4,0,4
38737_0,,,,2,1,1,2
C(CO)(C(C=CC(O)=O)O)=O,,,5,1,5,0,5
38739_0,,,,2,1,1,2
C(C(C(C(O)=O)=O)O)=CCO,,,5,1,3,0,3
38741_0,,,,2,1,1,2
C1(C(CC(C(C(C=O)O)O)O1)O)=O,,,5,1,1,0,1
38743_0,,,,2,1,1,2
C(CO)(C(C1CC(C(O)O1)=O)O)=O,,,5,1,3,0,3
38745_0,,,,2,1,1,2
C(C1(CC(C(C(CO)=O)O1)O)O)=O,,,5,1,2,0,2
38747_0,,,,2,1,1,2
C(C1C(OC(C(CO)=O)C1O)O)=O,,,5,1,2,0,2
38748_0,,,,2,1,1,2
38750_0,,,,2,1,1,2
C(CO)(C1C(C(C(O1)O)O)O)=O,,,5,1,3,0,3
38752_0,,,,2,1,1,2
C1(C(CC(CO)(CO)O1)O)=O,,,5,1,2,0,2
38754_0,,,,2,1,1,2
C1(C(C(CO)C(CO)(CO)O1)O)=O,,,5,1,1,0,1
38755_0,,,,2,1,1,2
38756_0,,,,2,1,1,2
38758_0,,,,2,1,1,2
C(CO)(C1(CC(CO)(CO1)O)O)=O,,,5,1,2,0,2
38759_0,,,,2,1,1,2
38761_0,,,,2,1,1,2
C1(C(C(OC1(CO)CO)O)O)=O,,,5,1,2,0,2
38762_0,,,,2,1,1,2
38763_0,,,,2,1,1,2
38764_0,,,,2,1,1,2
38766_0,,,,2,1,1,2
C(C1CC(C(O1)O)O)(C(CO)O)=O,,,5,1,2,0,2
38768_0,,,,2,1,1,2
C(C(C(C1CC(C(O)O1)O)O)O)=O,,,5,1,4,0,4
38770_0,,,,2,1,1,2
C(C(C1C(CC(CO)(O)O1)O)O)=O,,,5,1,4,0,4
38772_0,,,,2,1,1,2
C(C(C1C(CO)(CC(O)O1)O)O)=O,,,5,1,3,0,3
38774_0,,,,2,1,1,2
C(C(C1C(C(C(C)(O)O1)O)O)O)=O,,,5,1,3,0,3
38776_0,,,,2,1,1,2
C(C(C1C(C)(C(C(O)O1)O)O)O)=O,,,5,1,3,0,3
38778_0,,,,2,1,1,2
C1(C(CC(CO)(C(CO)O)O1)O)=O,,,5,1,1,0,1
38779_0,,,,2,1,1,2
38781_0,,,,2,1,1,2
C1(C(CC(C(O)=O)O1)O)=O,,,5,1,2,0,2
38783_0,,,,2,1,1,2
C1(C(C(CO)C(C(O)=O)O1)O)=O,,,5,1,2,0,2
38784_0,,,,2,1,1,2
38785_0,,,,2,1,1,2
38787_0,,,,2,1,1,2
C1(C(CC(C(CO)=O)(O)O1)O)=O,,,5,1,2,0,2
38789_0,,,,2,1,1,2
C1(C(C(C(C(O)=O)O1)O)O)=O,,,5,1,2,0,2
38790_0,,,,2,1,1,2
38791_0,,,,2,1,1,2
38793_0,,,,2,1,1,2
C1(C(CC(C(CO)(CO)O)O1)O)=O,,,5,1,1,0,1
38795_0,,,,2,1,1,2
C(C1(C)CC(C(O1)=O)O)=O,,,5,1,2,0,2
38797_0,,,,2,1,1,2
C(C1(C)C(CO)C(C(O1)=O)O)=O,,,5,1,2,0,2
38799_0,,,,2,1,1,2
C(C1(C)C(C(C(O1)=O)O)O)=O,,,5,1,2,0,2
38801_0,,,,2,1,1,2
C(C1(C(C(C(O1)O)O)=O)C)=O,,,5,1,2,0,2
38803_0,,,,2,1,1,2
C1(C(CC(C(C)=O)O1)O)=O,,,5,1,3,0,3
38805_0,,,,2,1,1,2
C1(C(C(CO)C(C(C)=O)O1)O)=O,,,5,1,2,0,2
38806_0,,,,2,1,1,2
38808_0,,,,2,1,1,2
C1(C(C(OC1C(C)=O)O)O)=O,,,5,1,2,0,2
38810_0,,,,2,1,1,2
C(CC1CC(C(O1)=O)O)=O,,,5,1,3,0,3
38812_0,,,,2,1,1,2
C(C1(CC(C(O1)=O)O)CCO)=O,,,5,1,2,0,2
38814_0,,,,2,1,1,2
C1(C(CC(C(CCO)=O)O1)O)=O,,,5,1,2,0,2
38816_0,,,,2,1,1,2
C(CC(C1CC(C(O1)=O)O)O)=O,,,5,1,2,0,2
38817_0,,,,2,1,1,2
38819_0,,,,2,1,1,2
C1(C(CC(CC(C=O)O)O1)O)=O,,,5,1,2,0,2
38820_0,,,,2,1,1,2
38822_0,,,,2,1,1,2
C1(C(CC(CC(CO)=O)O1)O)=O,,,5,1,2,0,2
38824_0,,,,2,1,1,2
C(CC1(CO)CC(C(O1)=O)O)=O,,,5,1,2,0,2
38826_0,,,,2,1,1,2
C1(C(OC(C(C(C)O)=O)C1)O)=O,,,5,1,2,0,2
38828_0,,,,2,1,1,2
C1(C(CC(C(C(C)=O)O)O1)O)=O,,,5,1,2,0,2
38830_0,,,,2,1,1,2
C(CO)(C1(C)CC(C(O1)O)=O)=O,,,5,1,2,0,2
38832_0,,,,2,1,1,2
C1(C(CC(C)(C(C=O)O)O1)O)=O,,,5,1,2,0,2
38834_0,,,,2,1,1,2
C1(C(CC(C)O1)O)=O,,,5,1,2,0,2
38836_0,,,,2,1,1,2
C(C1(CO)CC(C(O1)=O)O)=O,,,5,1,2,0,2
38838_0,,,,2,1,1,2
C(C(C1CC(C(O)O1)=O)O)=O,,,5,1,3,0,3
38840_0,,,,2,1,1,2
C1(C(CC(C(CO)=O)O1)O)=O,,,5,1,3,0,3
38842_0,,,,2,1,1,2
C(C1(CC(C(O1)=O)O)C(CO)O)=O,,,5,1,1,0,1
38843_0,,,,2,1,1,2
38845_0,,,,2,1,1,2
C1(C(CC(C(C(CO)O)=O)O1)O)=O,,,5,1,1,0,1
38847_0,,,,2,1,1,2
C1(C(CC(C(C(CO)O)O)O1)O)=O,,,5,1,1,0,1
38849_0,,,,2,1,1,2
C1(C(CC(C=O)O1)O)=O,,,5,1,3,0,3
38851_0,,,,2,1,1,2
C(CC1C(CO)C(C(O1)=O)O)=O,,,5,1,2,0,2
38852_0,,,,2,1,1,2
38854_0,,,,2,1,1,2
C(CC1C(C(C(O1)O)O)=O)=O,,,5,1,2,0,2
38856_0,,,,2,1,1,2
C(C1(C(C(C(O1)=O)O)O)CCO)=O,,,5,1,1,0,1
38858_0,,,,2,1,1,2
C(C1(C(C(C(O1)O)O)=O)CCO)=O,,,5,1,2,0,2
38859_0,,,,2,1,1,2
38861_0,,,,2,1,1,2
C(CCO)(C1C(C(C(O1)O)O)=O)=O,,,5,1,2,0,2
38863_0,,,,2,1,1,2
C1(C(C(CO)C(C)O1)O)=O,,,5,1,2,0,2
38865_0,,,,2,1,1,2
C(C1(CO)C(CO)C(C(O1)=O)O)=O,,,5,1,1,0,1
38867_0,,,,2,1,1,2
C(C(C1C(C(C(O)O1)=O)CO)O)=O,,,5,1,2,0,2
38869_0,,,,2,1,1,2
C1(C(C(CO)C(C(CO)=O)O1)O)=O,,,5,1,1,0,1
38871_0,,,,2,1,1,2
C1(C(C(CO)C(C(CO)O)O1)O)=O,,,5,1,1,0,1
38873_0,,,,2,1,1,2
C1(C(C(CO)C(C=O)O1)O)=O,,,5,1,3,0,3
38875_0,,,,2,1,1,2
C1(C(C(CO)C(CO)O1)O)=O,,,5,1,2,0,2
38877_0,,,,2,1,1,2
C(CC(C1C(C(C(O1)=O)O)O)O)=O,,,5,1,1,0,1
38878_0,,,,2,1,1,2
38880_0,,,,2,1,1,2
C(C(C(C1C(CC(O1)O)O)=O)O)=O,,,5,1,2,0,2
38882_0,,,,2,1,1,2
C1(C(C(C(CC(C=O)O)O1)O)O)=O,,,5,1,1,0,1
38884_0,,,,2,1,1,2
C(C(CC1C(C(C(O1)O)O)=O)O)=O,,,5,1,2,0,2
38885_0,,,,2,1,1,2
38887_0,,,,2,1,1,2
C(C(C(C1CC(C(O1)O)O)=O)O)=O,,,5,1,2,0,2
38889_0,,,,2,1,1,2
C(CO)(C1CC(C(O1)O)O)=O,,,5,1,2,0,2
38890_0,,,,2,1,1,2
38892_0,,,,2,1,1,2
C(C1C(C(C=O)O)OC(C1O)O)=O,,,5,1,2,0,2
38893_0,,,,2,1,1,2
38894_0,,,,2,1,1,2
38896_0,,,,2,1,1,2
C1(C(C(C(CC(CO)=O)O1)O)O)=O,,,5,1,1,0,1
38898_0,,,,2,1,1,2
C(CC1C(C(C(O1)O)O)=O)(CO)=O,,,5,1,2,0,2
38899_0,,,,2,1,1,2
38901_0,,,,2,1,1,2
C(CC1(CO)C(C(C(O1)=O)O)O)=O,,,5,1,1,0,1
38903_0,,,,2,1,1,2
C1(C(CO)(CC=O)OC(C1O)O)=O,,,5,1,2,0,2
38904_0,,,,2,1,1,2
38905_0,,,,2,1,1,2
38907_0,,,,2,1,1,2
C1(C(C(C(C(C(C)=O)O)O1)O)O)=O,,,5,1,1,0,1
38908_0,,,,2,1,1,2
38910_0,,,,2,1,1,2
C(C1C(C(C(O1)O)=O)O)(C(C)O)=O,,,5,1,2,0,2
38912_0,,,,2,1,1,2
C1(C(C(C(C)(C(C=O)O)O1)O)O)=O,,,5,1,1,0,1
38914_0,,,,2,1,1,2
C1(C(C)(C(C=O)O)OC(C1O)O)=O,,,5,1,2,0,2
38916_0,,,,2,1,1,2
C(CO)(C1(C)C(C(C(O1)O)=O)O)=O,,,5,1,2,0,2
38918_0,,,,2,1,1,2
C(C1(COC(C(CO)=O)(C1)O)O)=O,,,5,1,2,0,2
38920_0,,,,2,1,1,2
C(CO)(C1(CC(C(CO)O1)O)O)=O,,,5,1,2,0,2
38922_0,,,,2,1,1,2
C(CO)(C1(CC(CO1)O)O)=O,,,5,1,2,0,2
38924_0,,,,2,1,1,2
C1(C(C(C(C)O1)O)O)=O,,,5,1,2,0,2
38926_0,,,,2,1,1,2
C1(C(C)OC(C1O)O)=O,,,5,1,2,0,2
38928_0,,,,2,1,1,2
C(C1(CO)C(C(C(O1)=O)O)O)=O,,,5,1,2,0,2
38930_0,,,,2,1,1,2
C(C1(C(C(C(O1)O)O)=O)CO)=O,,,5,1,2,0,2
38932_0,,,,2,1,1,2
C1(C(C(C(C(CO)=O)O1)O)O)=O,,,5,1,4,0,4
38934_0,,,,2,1,1,2
C1(C(C(OC1C(CO)=O)O)O)=O,,,5,1,2,0,2
38936_0,,,,2,1,1,2
C(C(C1C(C(C(O)O1)=O)O)O)=O,,,5,1,2,0,2
38937_0,,,,2,1,1,2
38938_0,,,,2,1,1,2
38940_0,,,,2,1,1,2
C1(C(C(C(C=O)O1)O)O)=O,,,5,1,3,0,3
38942_0,,,,2,1,1,2
C(C1C(C(C(O1)O)O)=O)=O,,,5,1,2,0,2
38943_0,,,,2,1,1,2
38944_0,,,,2,1,1,2
38946_0,,,,2,1,1,2
C(CO)(C1(C(O)OC(C1O)=O)O)=O,,,5,1,2,0,2
38948_0,,,,2,1,1,2
C(C1(C(CO)=O)C(CC(O1)O)O)=O,,,5,1,2,0,2
38950_0,,,,2,1,1,2
C(C(C1(COC(C1(C)O)O)O)O)=O,,,5,1,4,0,4
38952_0,,,,2,1,1,2
C(C(C1(COC(C)(C1O)O)O)O)=O,,,5,1,4,0,4
38953_0,,,,2,1,1,2
38954_0,,,,2,1,1,2
38956_0,,,,2,1,1,2
C1(C(C(CO)(C(C(O)=O)O1)O)O)=O,,,5,1,1,0,1
38958_0,,,,2,1,1,2
C(C1(C)C(CO)(C(C(O1)=O)O)O)=O,,,5,1,1,0,1
38960_0,,,,2,1,1,2
C1(C(C(CO)(C(C(C)=O)O1)O)O)=O,,,5,1,1,0,1
38962_0,,,,2,1,1,2
C(CC1C(CO)(C(C(O1)=O)O)O)=O,,,5,1,1,0,1
38964_0,,,,2,1,1,2
C1(C(C(CO)(C(C)O1)O)O)=O,,,5,1,3,0,3
38966_0,,,,2,1,1,2
C1(C(C(CO)(C(C=O)O1)O)O)=O,,,5,1,5,0,5
38967_0,,,,2,1,1,2
38969_0,,,,2,1,1,2
C(C1(C(C(C=O)O)OC(C1)O)O)=O,,,5,1,2,0,2
38970_0,,,,2,1,1,2
38971_0,,,,2,1,1,2
38972_0,,,,2,1,1,2
38973_0,,,,2,1,1,2
38974_0,,,,2,1,1,2
38976_0,,,,2,1,1,2
C1(C(CC(C(C(C=O)O)O1)O)O)=O,,,5,1,1,0,1
38978_0,,,,2,1,1,2
C(CO)(C1C(CC(C(O1)O)=O)O)=O,,,5,1,2,0,2
38980_0,,,,2,1,1,2
C1(C(CC(CO)(CO1)O)O)=O,,,5,1,2,0,2
38982_0,,,,2,1,1,2
C1(C(C(CO)C(CO)(CO1)O)O)=O,,,5,1,1,0,1
38984_0,,,,2,1,1,2
C1(C(CC(OC1(CO)CO)O)O)=O,,,5,1,4,0,4
38986_0,,,,2,1,1,2
C1(C(O)OC(CO)(CO)CC1O)=O,,,5,1,2,0,2
38987_0,,,,2,1,1,2
38989_0,,,,2,1,1,2
C1(C(C(O)OCC1(CO)O)O)=O,,,5,1,2,0,2
38991_0,,,,2,1,1,2
C1(C(COC(C1(C)O)O)O)=O,,,5,1,2,0,2
38993_0,,,,2,1,1,2
C1(C(C(C)(O)OCC1O)O)=O,,,5,1,2,0,2
38995_0,,,,2,1,1,2
C1(C(COC(C1(CCO)O)O)O)=O,,,5,1,2,0,2
38997_0,,,,2,1,1,2
C1(C(C(CCO)(O)OCC1O)O)=O,,,5,1,2,0,2
38999_0,,,,2,1,1,2
C(C(C1C(C(CC(O)O1)O)O)O)=O,,,5,1,3,0,3
39001_0,,,,2,1,1,2
C(C(C1C(CC(C(O)O1)O)O)O)=O,,,5,1,3,0,3
39003_0,,,,2,1,1,2
C1(C(COC(C1(CO)O)O)O)=O,,,5,1,2,0,2
39005_0,,,,2,1,1,2
C1(C(C(CO)(O)OCC1O)O)=O,,,5,1,2,0,2
39007_0,,,,2,1,1,2
C1(C(C(O)OCC1O)O)=O,,,5,1,3,0,3
39009_0,,,,2,1,1,2
C1(C(CC(CO1)(C(CO)O)O)O)=O,,,5,1,1,0,1
39011_0,,,,2,1,1,2
C1(C(CC(CO)(C(CO)O1)O)O)=O,,,5,1,1,0,1
39013_0,,,,2,1,1,2
C1(C(C(CO)OC(C1(C)O)O)O)=O,,,5,1,2,0,2
39015_0,,,,2,1,1,2
C1(C(C(CO)OC(C)(C1O)O)O)=O,,,5,1,2,0,2
39017_0,,,,2,1,1,2
C1(C(C(CO)OC(C1O)O)O)=O,,,5,1,3,0,3
39019_0,,,,2,1,1,2
C1(C(CC(C(O1)=O)O)O)=O,,,5,1,2,0,2
39021_0,,,,2,1,1,2
C1(C(C(CO)C(C(O1)=O)O)O)=O,,,5,1,2,0,2
39022_0,,,,2,1,1,2
39024_0,,,,2,1,1,2
C(C1CC(C(C(O1)O)=O)O)(O)=O,,,5,1,2,0,2
39026_0,,,,2,1,1,2
C1(C(C(C(C(O1)=O)O)O)O)=O,,,5,1,2,0,2
39028_0,,,,2,1,1,2
C1(C(C(C(C(O)O1)O)=O)O)=O,,,5,1,2,0,2
39029_0,,,,2,1,1,2
39031_0,,,,2,1,1,2
C1(C(CC(C(CO)(CO)O1)O)O)=O,,,5,1,1,0,1
39033_0,,,,2,1,1,2
C(C1(C(C(CC(O1)O)O)=O)C)=O,,,5,1,2,0,2
39035_0,,,,2,1,1,2
C(C1(C)CC(C(C(O1)O)=O)O)=O,,,5,1,2,0,2
39037_0,,,,2,1,1,2
C1(C(CC(OC1C(C)=O)O)O)=O,,,5,1,2,0,2
39039_0,,,,2,1,1,2
C(C)(C1CC(C(C(O1)O)=O)O)=O,,,5,1,2,0,2
39041_0,,,,2,1,1,2
C(CC1C(CC(C(O1)=O)O)O)=O,,,5,1,2,0,2
39042_0,,,,2,1,1,2
39044_0,,,,2,1,1,2
C1(C(CC(C(C(C)=O)O1)O)O)=O,,,5,1,2,0,2
39046_0,,,,2,1,1,2
C1(C(CC(C)(C(C=O)O1)O)O)=O,,,5,1,2,0,2
39048_0,,,,2,1,1,2
C(C1(COC(C(C1)O)=O)O)=O,,,5,1,2,0,2
39050_0,,,,2,1,1,2
C1(CC(C=O)(O)OCC1O)=O,,,5,1,3,0,3
39052_0,,,,2,1,1,2
C(C1(CC(C(OC1CO)=O)O)O)=O,,,5,1,1,0,1
39054_0,,,,2,1,1,2
C1(CC(C=O)(O)OC(CO)C1O)=O,,,5,1,2,0,2
39056_0,,,,2,1,1,2
C1(C(CC(C(C(CO)O)O1)O)O)=O,,,5,1,1,0,1
39058_0,,,,2,1,1,2
C(CC1C(C(CC(O1)O)O)=O)=O,,,5,1,2,0,2
39060_0,,,,2,1,1,2
C(CC1CC(C(C(O)O1)=O)O)=O,,,5,1,2,0,2
39062_0,,,,2,1,1,2
C(C1C(C(COC1O)O)=O)=O,,,5,1,2,0,2
39064_0,,,,2,1,1,2
C(C1C(C(C(CO)OC1O)O)=O)=O,,,5,1,2,0,2
39066_0,,,,2,1,1,2
C(C1(COC(C(C1CO)O)=O)O)=O,,,5,1,1,0,1
39068_0,,,,2,1,1,2
C1(C(CO)C(C=O)(O)OCC1O)=O,,,5,1,2,0,2
39070_0,,,,2,1,1,2
C1(C(C(CO)C(C(CO)O1)O)O)=O,,,5,1,1,0,1
39072_0,,,,2,1,1,2
C1(C(C(CO)C(CO1)O)O)=O,,,5,1,2,0,2
39074_0,,,,2,1,1,2
C(CC1C(C(C(C(O1)=O)O)O)O)=O,,,5,1,1,0,1
39076_0,,,,2,1,1,2
C(CC1C(C(C(C(O)O1)O)=O)O)=O,,,5,1,2,0,2
39077_0,,,,2,1,1,2
39078_0,,,,2,1,1,2
39079_0,,,,2,1,1,2
39080_0,,,,2,1,1,2
39082_0,,,,2,1,1,2
C1(C(COC(C1O)O)(CC=O)O)=O,,,5,1,2,0,2
39084_0,,,,2,1,1,2
C1(C(COC(C1C(CO)=O)O)O)=O,,,5,1,2,0,2
39085_0,,,,2,1,1,2
39087_0,,,,2,1,1,2
C(C1C(C(COC1(CO)O)O)=O)=O,,,5,1,2,0,2
39088_0,,,,2,1,1,2
39090_0,,,,2,1,1,2
C1(C(C)OC(CC1O)O)=O,,,5,1,2,0,2
39092_0,,,,2,1,1,2
C(C1(C(C(CC(O1)O)O)=O)CO)=O,,,5,1,2,0,2
39094_0,,,,2,1,1,2
C(CC1(C(C(C(CO1)O)=O)O)O)=O,,,5,1,2,0,2
39096_0,,,,2,1,1,2
C1(C(C(C(C=O)O)OC(C1)O)O)=O,,,5,1,2,0,2
39098_0,,,,2,1,1,2
C1(C(CC(OC1C(CO)=O)O)O)=O,,,5,1,2,0,2
39099_0,,,,2,1,1,2
39101_0,,,,2,1,1,2
C(C1C(C(CC(O1)O)O)=O)=O,,,5,1,2,0,2
39103_0,,,,2,1,1,2
C1(C(C(C(C(C(C)=O)O1)O)O)O)=O,,,5,1,1,0,1
39105_0,,,,2,1,1,2
C1(C(C(C(C)=O)OC(C1O)O)O)=O,,,5,1,2,0,2
39107_0,,,,2,1,1,2
C1(C(C(C(C)(C(C=O)O1)O)O)O)=O,,,5,1,1,0,1
39109_0,,,,2,1,1,2
C1(C(C)(C(C=O)OC(C1O)O)O)=O,,,5,1,2,0,2
39111_0,,,,2,1,1,2
C1(C(O)OC(C)CC1O)=O,,,5,1,2,0,2
39113_0,,,,2,1,1,2
C(C1(CO)CC(C(C(O1)O)=O)O)=O,,,5,1,2,0,2
39115_0,,,,2,1,1,2
C1(C(COC(C(C=O)O)(C1)O)O)=O,,,5,1,2,0,2
39117_0,,,,2,1,1,2
C1(COC(C(CO)=O)(CC1O)O)=O,,,5,1,2,0,2
39119_0,,,,2,1,1,2
C1(C(C(O)OC(C(C=O)O)C1)O)=O,,,5,1,2,0,2
39121_0,,,,2,1,1,2
C(CO)(C1CC(C(C(O1)O)=O)O)=O,,,5,1,2,0,2
39123_0,,,,2,1,1,2
C(CO)(C1(CC(C(CO1)O)O)O)=O,,,5,1,2,0,2
39125_0,,,,2,1,1,2
C1(C(O)OC(CC1O)C(CO)O)=O,,,5,1,2,0,2
39127_0,,,,2,1,1,2
C(C1CC(C(C(O1)O)=O)O)=O,,,5,1,2,0,2
39128_0,,,,2,1,1,2
39129_0,,,,2,1,1,2
39131_0,,,,2,1,1,2
C(C1(COC(C(C1O)O)=O)O)=O,,,5,1,2,0,2
39133_0,,,,2,1,1,2
C(C1(C(C(C(O)OC1)O)=O)O)=O,,,5,1,2,0,2
39135_0,,,,2,1,1,2
C1(C(C(C=O)(O)OCC1O)O)=O,,,5,1,2,0,2
39136_0,,,,2,1,1,2
39137_0,,,,2,1,1,2
39138_0,,,,2,1,1,2
39139_0,,,,2,1,1,2
39140_0,,,,2,1,1,2
39142_0,,,,2,1,1,2
C1(C(C(CO)(C(C(O1)=O)O)O)O)=O,,,5,1,1,0,1
39144_0,,,,2,1,1,2
C1(C(COC(C1(C(C)=O)O)O)O)=O,,,5,1,2,0,2
39146_0,,,,2,1,1,2
C(C1(C(C(COC1(C)O)O)=O)O)=O,,,5,1,2,0,2
39147_0,,,,2,1,1,2
39149_0,,,,2,1,1,2
C1(C(C(O)OCC1O)(CC=O)O)=O,,,5,1,2,0,2
39150_0,,,,2,1,1,2
39152_0,,,,2,1,1,2
C1(C(CC(C(C(C=O)O1)O)O)O)=O,,,5,1,1,0,1
39154_0,,,,2,1,1,2
C1(C(CC(O)OCC1(CO)O)O)=O,,,5,1,4,0,4
39156_0,,,,2,1,1,2
C1(C(O)OCC(CO)(CC1O)O)=O,,,5,1,2,0,2
39157_0,,,,2,1,1,2
39159_0,,,,2,1,1,2
C1(C(CCOC(CO)(C1O)O)O)=O,,,5,1,2,0,2
39161_0,,,,2,1,1,2
C1(C(CC(CO)(O)OCC1O)O)=O,,,5,1,3,0,3
39163_0,,,,2,1,1,2
C1(C(COC(CC1(CO)O)O)O)=O,,,5,1,3,0,3
39164_0,,,,2,1,1,2
39166_0,,,,2,1,1,2
C1(C(COC(C(C1(C)O)O)O)O)=O,,,5,1,2,0,2
39168_0,,,,2,1,1,2
C1(C(CC(CO)(C(CO1)O)O)O)=O,,,5,1,1,0,1
39170_0,,,,2,1,1,2
C1(C(C(COC(C1(C)O)O)O)O)=O,,,5,1,2,0,2
39172_0,,,,2,1,1,2
C1(COC(C(C)(C(C1O)O)O)O)=O,,,5,1,2,0,2
39174_0,,,,2,1,1,2
C1(C(C(COC(C)(C1O)O)O)O)=O,,,5,1,2,0,2
39175_0,,,,2,1,1,2
39177_0,,,,2,1,1,2
C1(C(CC(O)OC(CO)C1O)O)=O,,,5,1,3,0,3
39179_0,,,,2,1,1,2
C1(C(C(COC(C1O)O)O)O)=O,,,5,1,3,0,3
39181_0,,,,2,1,1,2
C1(COC(C(C(C1O)O)O)O)=O,,,5,1,3,0,3
39183_0,,,,2,1,1,2
C1(C(C(C(CC(O)O1)O)=O)O)=O,,,5,1,2,0,2
39185_0,,,,2,1,1,2
C1(C(CC(C(C(O)O1)=O)O)O)=O,,,5,1,2,0,2
39187_0,,,,2,1,1,2
C1(C(CC(C(CO)(CO1)O)O)O)=O,,,5,1,1,0,1
39189_0,,,,2,1,1,2
C(C1(CC(C(OCC1)=O)O)O)=O,,,5,1,2,0,2
39191_0,,,,2,1,1,2
C1(CC(C=O)(O)OCCC1O)=O,,,5,1,2,0,2
39193_0,,,,2,1,1,2
C1(C(CC(CC(C=O)O1)O)O)=O,,,5,1,2,0,2
39195_0,,,,2,1,1,2
C1(C(COC(C(C1)=O)O)O)=O,,,5,1,4,0,4
39196_0,,,,2,1,1,2
39198_0,,,,2,1,1,2
C(C1(CC(C(OCC1O)=O)O)O)=O,,,5,1,1,0,1
39200_0,,,,2,1,1,2
C1(C(C(CO)OC(C(C1)=O)O)O)=O,,,5,1,2,0,2
39202_0,,,,2,1,1,2
C1(C(CC(C(C(CO)O1)=O)O)O)=O,,,5,1,1,0,1
39204_0,,,,2,1,1,2
C1(CC(C=O)(O)OCC(C1O)O)=O,,,5,1,2,0,2
39206_0,,,,2,1,1,2
C(C1(CC(C(C(CO1)=O)O)O)O)=O,,,5,1,2,0,2
39208_0,,,,2,1,1,2
C1(C(CC(C(C(CO)O1)O)O)O)=O,,,5,1,1,0,1
39210_0,,,,2,1,1,2
C(C1C(C(CCOC1O)O)=O)=O,,,5,1,2,0,2
39212_0,,,,2,1,1,2
C(C1C(C(C(COC1O)O)O)=O)=O,,,5,1,2,0,2
39214_0,,,,2,1,1,2
C(C1C(OCC(C(C1O)O)=O)O)=O,,,5,1,2,0,2
39216_0,,,,2,1,1,2
C(C1(C(C(C(OCC1)=O)O)O)O)=O,,,5,1,1,0,1
39218_0,,,,2,1,1,2
C(C1(C(C(C(O)OCC1)O)=O)O)=O,,,5,1,2,0,2
39220_0,,,,2,1,1,2
C1(C(CCOC(C1)O)O)=O,,,5,1,2,0,2
39222_0,,,,2,1,1,2
C1(C(C(C=O)(O)OCCC1O)O)=O,,,5,1,2,0,2
39224_0,,,,2,1,1,2
C1(C(COC(C(C1CO)=O)O)O)=O,,,5,1,2,0,2
39226_0,,,,2,1,1,2
C1(C(C(CO)C(C(CO1)=O)O)O)=O,,,5,1,1,0,1
39228_0,,,,2,1,1,2
C1(C(C(CO)C(C(CO1)O)O)O)=O,,,5,1,1,0,1
39230_0,,,,2,1,1,2
C1(C(C(C(CC(C=O)O1)O)O)O)=O,,,5,1,1,0,1
39232_0,,,,2,1,1,2
C1(C(C(OC(C=O)CC1O)O)O)=O,,,5,1,2,0,2
39234_0,,,,2,1,1,2
C(C1C(C(COC(C1O)O)O)=O)=O,,,5,1,2,0,2
39236_0,,,,2,1,1,2
C(C1(C(C(CC(O)OC1)O)=O)O)=O,,,5,1,2,0,2
39237_0,,,,2,1,1,2
39239_0,,,,2,1,1,2
C(C1(COC(C(C(C1)O)=O)O)O)=O,,,5,1,2,0,2
39241_0,,,,2,1,1,2
C1(C(O)OC(CO)C(CC1O)O)=O,,,5,1,2,0,2
39242_0,,,,2,1,1,2
39243_0,,,,2,1,1,2
39245_0,,,,2,1,1,2
C1(C(C(C(C(CO1)=O)O)O)O)=O,,,5,1,4,0,4
39247_0,,,,2,1,1,2
C1(C(C(OCC(C1O)=O)O)O)=O,,,5,1,2,0,2
39249_0,,,,2,1,1,2
C1(C(COC(C(C1O)=O)O)O)=O,,,5,1,2,0,2
39250_0,,,,2,1,1,2
39251_0,,,,2,1,1,2
39253_0,,,,2,1,1,2
C1(C(CCOC(C1(CO)O)O)O)=O,,,5,1,2,0,2
39255_0,,,,2,1,1,2
C(C1(C(C(COC(C1)O)O)=O)O)=O,,,5,1,2,0,2
39256_0,,,,2,1,1,2
39257_0,,,,2,1,1,2
39258_0,,,,2,1,1,2
39259_0,,,,2,1,1,2
39260_0,,,,2,1,1,2
39262_0,,,,2,1,1,2
C1(C(C(C(CO1)O)=O)O)=O,,,5,1,3,0,3
39264_0,,,,2,1,1,2
C1(C(C(C(C(CO)O1)O)=O)O)=O,,,5,1,3,0,3
39266_0,,,,2,1,1,2
C1(C(C(C(CO1)O)=O)(CO)O)=O,,,5,1,2,0,2
39268_0,,,,2,1,1,2
C1(C(C(C(CO1)O)=O)(C)O)=O,,,5,1,2,0,2
39269_0,,,,2,1,1,2
39270_0,,,,2,1,1,2
39272_0,,,,2,1,1,2
C1(C(C(C(C(CO1)O)O)=O)O)=O,,,5,1,3,0,3
39273_0,,,,2,1,1,2
39275_0,,,,2,1,1,2
C1(C(C(C(CCO1)O)=O)(C)O)=O,,,5,1,2,0,2
39276_0,,,,2,1,1,2
39278_0,,,,2,1,1,2
C(CCC(C=O)C(C(C)O)=O)(O)=O,,,5,1,2,0,2
39280_0,,,,2,1,1,2
C(CCCC(C(CC=O)=O)O)(O)=O,,,5,1,2,0,2
39282_0,,,,2,1,1,2
C(CO)(C(C)(CCC(C=O)=O)O)=O,,,5,1,3,0,3
39283_0,,,,2,1,1,2
39285_0,,,,2,1,1,2
C(CCC(C(CO)=O)(C)O)(O)=O,,,5,1,3,0,3
39287_0,,,,2,1,1,2
C(CO)(C(CCCC(C=O)=O)O)=O,,,5,1,4,0,4
39289_0,,,,2,1,1,2
C(CO)(C(CC(C=O)CC=O)O)=O,,,5,1,5,0,5
39291_0,,,,2,1,1,2
C(CCCC(C(CO)=O)O)(O)=O,,,5,1,4,0,4
39293_0,,,,2,1,1,2
C(CCC(C(C(C=O)O)O)=O)(O)=O,,,5,1,1,0,1
39294_0,,,,2,1,1,2
39296_0,,,,2,1,1,2
C(CCC(C(C(CO)=O)=O)O)(O)=O,,,5,1,2,0,2
39297_0,,,,2,1,1,2
39299_0,,,,2,1,1,2
C(CCC(C=O)=O)(C(C(C)=O)O)=O,,,5,1,1,0,1
39301_0,,,,2,1,1,2
C(C(C(C(C(C)=O)O)=O)CC=O)=O,,,5,1,1,0,1
39303_0,,,,2,1,1,2
C(CCC(C(C(C)=O)O)=O)(O)=O,,,5,1,2,0,2
39304_0,,,,2,1,1,2
39305_0,,,,2,1,1,2
39306_0,,,,2,1,1,2
39307_0,,,,2,1,1,2
39308_0,,,,2,1,1,2
39309_0,,,,2,1,1,2
39311_0,,,,2,1,1,2
C(CCC(C=O)=O)(C(C)O)=O,,,5,1,2,0,2
39313_0,,,,2,1,1,2
C(C(C)O)(C(C=O)CC=O)=O,,,5,1,2,0,2
39315_0,,,,2,1,1,2
C(CCC(O)=O)(C(C)O)=O,,,5,1,1,0,1
39317_0,,,,2,1,1,2
C(C(CO)CC(O)=O)(C(C)O)=O,,,5,1,1,0,1
39318_0,,,,2,1,1,2
39319_0,,,,2,1,1,2
39320_0,,,,2,1,1,2
39321_0,,,,2,1,1,2
39323_0,,,,2,1,1,2
C(CCC(C=O)=O)(C(CCO)O)=O,,,5,1,1,0,1
39325_0,,,,2,1,1,2
C(C(CCO)O)(C(C=O)CC=O)=O,,,5,1,1,0,1
39327_0,,,,2,1,1,2
C(CCC(O)=O)(C(CCO)O)=O,,,5,1,1,0,1
39328_0,,,,2,1,1,2
39329_0,,,,2,1,1,2
39330_0,,,,2,1,1,2
39331_0,,,,2,1,1,2
39332_0,,,,2,1,1,2
39333_0,,,,2,1,1,2
39334_0,,,,2,1,1,2
39335_0,,,,2,1,1,2
39336_0,,,,2,1,1,2
39337_0,,,,2,1,1,2
39338_0,,,,2,1,1,2
39339_0,,,,2,1,1,2
39341_0,,,,2,1,1,2
C(C(CCC(C=O)=O)O)(C(C)O)=O,,,5,1,2,0,2
39342_0,,,,2,1,1,2
39344_0,,,,2,1,1,2
C(CCC(C(C(C)O)=O)O)(O)=O,,,5,1,2,0,2
39345_0,,,,2,1,1,2
39346_0,,,,2,1,1,2
39347_0,,,,2,1,1,2
39348_0,,,,2,1,1,2
39349_0,,,,2,1,1,2
39351_0,,,,2,1,1,2
C(CCC(C(CC(O)=O)O)=O)(O)=O,,,5,1,1,0,1
39353_0,,,,2,1,1,2
C(CCCC(C(C(O)=O)=O)O)(O)=O,,,5,1,4,0,4
39354_0,,,,2,1,1,2
39355_0,,,,2,1,1,2
39357_0,,,,2,1,1,2
C(C(C(CCC(O)=O)=O)O)(O)=O,,,5,1,4,0,4
39358_0,,,,2,1,1,2
39359_0,,,,2,1,1,2
39360_0,,,,2,1,1,2
39361_0,,,,2,1,1,2
39362_0,,,,2,1,1,2
39363_0,,,,2,1,1,2
39364_0,,,,2,1,1,2
39365_0,,,,2,1,1,2
39366_0,,,,2,1,1,2
39367_0,,,,2,1,1,2
39368_0,,,,2,1,1,2
39369_0,,,,2,1,1,2
39370_0,,,,2,1,1,2
39371_0,,,,2,1,1,2
39372_0,,,,2,1,1,2
39373_0,,,,2,1,1,2
39374_0,,,,2,1,1,2
39375_0,,,,2,1,1,2
39377_0,,,,2,1,1,2
C(CC(C(CCC(C=O)=O)=O)O)=O,,,5,1,1,0,1
39378_0,,,,2,1,1,2
39379_0,,,,2,1,1,2
39380_0,,,,2,1,1,2
39381_0,,,,2,1,1,2
39382_0,,,,2,1,1,2
39383_0,,,,2,1,1,2
39384_0,,,,2,1,1,2
39385_0,,,,2,1,1,2
39386_0,,,,2,1,1,2
39387_0,,,,2,1,1,2
39389_0,,,,2,1,1,2
C(CCC1(C(C(CO1)=O)O)O)(O)=O,,,5,1,2,0,2
39390_0,,,,2,1,1,2
39392_0,,,,2,1,1,2
C(CCC1C(C(C(O1)O)O)=O)(O)=O,,,5,1,3,0,3
39393_0,,,,2,1,1,2
39394_0,,,,2,1,1,2
39395_0,,,,2,1,1,2
39396_0,,,,2,1,1,2
39397_0,,,,2,1,1,2
39398_0,,,,2,1,1,2
39400_0,,,,2,1,1,2
C(CCC(O)=O)(C(CO)O)=O,,,5,1,4,0,4
39401_0,,,,2,1,1,2
39403_0,,,,2,1,1,2
C(CCC(O)=O)(C(C(CO)O)O)=O,,,5,1,3,0,3
39404_0,,,,2,1,1,2
39405_0,,,,2,1,1,2
39406_0,,,,2,1,1,2
39407_0,,,,2,1,1,2
39408_0,,,,2,1,1,2
39409_0,,,,2,1,1,2
39411_0,,,,2,1,1,2
C(CCC(C(CC=O)O)=O)(O)=O,,,5,1,2,0,2
39412_0,,,,2,1,1,2
39413_0,,,,2,1,1,2
39415_0,,,,2,1,1,2
C(C(C(CCC(O)=O)=O)O)=O,,,5,1,4,0,4
39416_0,,,,2,1,1,2
39417_0,,,,2,1,1,2
39418_0,,,,2,1,1,2
39419_0,,,,2,1,1,2
39421_0,,,,2,1,1,2
C(C(CO)CC(O)=O)(C(CO)O)=O,,,5,1,2,0,2
39422_0,,,,2,1,1,2
39424_0,,,,2,1,1,2
C(C(CO)CC(O)=O)(C(C=O)O)=O,,,5,1,2,0,2
39426_0,,,,2,1,1,2
C(CO)(C(CO)CC(O)=O)=O,,,5,1,5,0,5
39427_0,,,,2,1,1,2
39428_0,,,,2,1,1,2
39429_0,,,,2,1,1,2
39430_0,,,,2,1,1,2
39431_0,,,,2,1,1,2
39432_0,,,,2,1,1,2
39433_0,,,,2,1,1,2
39434_0,,,,2,1,1,2
39435_0,,,,2,1,1,2
39436_0,,,,2,1,1,2
39437_0,,,,2,1,1,2
39438_0,,,,2,1,1,2
39439_0,,,,2,1,1,2
39440_0,,,,2,1,1,2
39441_0,,,,2,1,1,2
39442_0,,,,2,1,1,2
39444_0,,,,2,1,1,2
C(CO)(C(C(C(O)=O)=O)(C)O)=O,,,5,1,2,0,2
39445_0,,,,2,1,1,2
39446_0,,,,2,1,1,2
39447_0,,,,2,1,1,2
39448_0,,,,2,1,1,2
39449_0,,,,2,1,1,2
39451_0,,,,2,1,1,2
C(CC(C=O)O)(C(C)O)=O,,,5,1,3,0,3
39452_0,,,,2,1,1,2
39453_0,,,,2,1,1,2
39454_0,,,,2,1,1,2
39455_0,,,,2,1,1,2
39456_0,,,,2,1,1,2
39457_0,,,,2,1,1,2
39458_0,,,,2,1,1,2
39459_0,,,,2,1,1,2
39460_0,,,,2,1,1,2
39461_0,,,,2,1,1,2
39462_0,,,,2,1,1,2
39463_0,,,,2,3,2,5
39465_0,,,,2,3,2,5
C(C1C(C(C(C1O)O)O)O)O,,,5,1,1,0,1
39467_0,,,,2,3,2,5
C(C1(C(C(C(C1CO)O)O)O)O)O,,,5,1,1,0,1
39469_0,,,,2,3,2,5
C(C1(C(C(C(CO)C1O)O)O)O)O,,,5,1,1,0,1
39470_0,,,,2,3,2,5
39471_0,,,,2,3,2,5
39472_0,,,,2,3,2,5
39473_0,,,,2,3,2,5
39474_0,,,,2,3,2,5
39475_0,,,,2,3,2,5
39476_0,,,,2,3,2,5
39477_0,,,,2,3,2,5
39478_0,,,,2,3,2,5
39479_0,,,,2,3,2,5
39480_0,,,,2,3,2,5
39481_0,,,,2,3,2,5
39482_0,,,,2,3,2,5
39484_0,,,,2,3,2,5
C(C1(CC(C(C1CO)O)O)O)=O,,,5,1,1,0,1
39485_0,,,,2,3,2,5
39486_0,,,,2,3,2,5
39487_0,,,,2,3,2,5
39488_0,,,,2,3,2,5
39489_0,,,,2,3,2,5
39490_0,,,,2,3,2,5
39491_0,,,,2,3,2,5
39492_0,,,,2,3,2,5
39493_0,,,,2,3,2,5
39494_0,,,,2,3,2,5
39495_0,,,,2,3,2,5
39497_0,,,,2,3,2,5
C(C1C(C(CC1O)O)O)O,,,5,1,1,0,1
39498_0,,,,2,3,2,5
39500_0,,,,2,3,2,5
C(C1(C(C(C(C1CO)O)O)O)O)=O,,,5,1,3,0,3
39501_0,,,,2,3,2,5
39502_0,,,,2,3,2,5
39503_0,,,,2,3,2,5
39504_0,,,,2,3,2,5
39505_0,,,,2,3,2,5
39506_0,,,,2,3,2,5
39507_0,,,,2,3,2,5
39508_0,,,,2,3,2,5
39509_0,,,,2,3,2,5
39510_0,,,,2,3,2,5
39511_0,,,,2,3,2,5
39512_0,,,,2,3,2,5
39514_0,,,,2,3,2,5
C(C1(C(C(CO)C(C1O)O)O)O)=O,,,5,1,5,0,5
39515_0,,,,2,3,2,5
39516_0,,,,2,3,2,5
39517_0,,,,2,3,2,5
39518_0,,,,2,3,2,5
39519_0,,,,2,3,2,5
39520_0,,,,2,3,2,5
39521_0,,,,2,3,2,5
39522_0,,,,2,3,2,5
39523_0,,,,2,3,2,5
39524_0,,,,2,3,2,5
39525_0,,,,2,3,2,5
39526_0,,,,2,3,2,5
39527_0,,,,2,3,2,5
39529_0,,,,2,3,2,5
C(C1(C(C(CO)C(C1)O)O)O)=O,,,5,1,2,0,2
39530_0,,,,2,3,2,5
39532_0,,,,2,3,2,5
C(C1(C(CC(C1CO)O)O)O)=O,,,5,1,2,0,2
39533_0,,,,2,3,2,5
39534_0,,,,2,3,2,5
39535_0,,,,2,3,2,5
39537_0,,,,2,3,2,5
C(C(CO)(CC(CCO)O)O)O,,,5,1,1,0,1
39539_0,,,,2,3,2,5
C(C(C(CC(CO)(CO)O)O)O)O,,,5,1,2,0,2
39541_0,,,,2,3,2,5
C(C(CO)C(CO)(CO)O)(O)=O,,,5,1,5,0,5
39543_0,,,,2,3,2,5
CC(C(CO)C(CO)(CO)O)O,,,5,1,1,0,1
39545_0,,,,2,3,2,5
C(C(CO)(C(CO)CO)O)O,,,5,1,1,0,1
39547_0,,,,2,3,2,5
C(C(CO)(C(CO)C(CO)O)O)O,,,5,1,2,0,2
39549_0,,,,2,3,2,5
C(C(CO)(C(C(CCO)O)O)O)O,,,5,1,3,0,3
39550_0,,,,2,3,2,5
39552_0,,,,2,3,2,5
CC(C(C(CO)(CCO)O)O)O,,,5,1,2,0,2
39554_0,,,,2,3,2,5
CC(C(C(CO)(C(CO)O)O)O)O,,,5,1,6,0,6
39555_0,,,,2,3,2,5
39556_0,,,,2,3,2,5
39557_0,,,,2,3,2,5
39558_0,,,,2,3,2,5
39560_0,,,,2,3,2,5
C(C(C(C(CO)(CCO)O)O)O)O,,,5,1,4,0,4
39562_0,,,,2,3,2,5
C(C(C(CO)O)(C(CO)CO)O)O,,,5,1,1,0,1
39564_0,,,,2,3,2,5
C(C(C(CCO)(C(CO)O)O)O)O,,,5,1,1,0,1
39565_0,,,,2,3,2,5
39566_0,,,,2,3,2,5
39567_0,,,,2,3,2,5
39568_0,,,,2,3,2,5
39569_0,,,,2,3,2,5
39570_0,,,,2,3,2,5
39571_0,,,,2,3,2,5
39573_0,,,,2,3,2,5
C(C(CC(C(CO)CO)O)O)(O)=O,,,5,1,1,0,1
39574_0,,,,2,3,2,5
39575_0,,,,2,3,2,5
39576_0,,,,2,3,2,5
39577_0,,,,2,3,2,5
39578_0,,,,2,3,2,5
39579_0,,,,2,3,2,5
39580_0,,,,2,3,2,5
39581_0,,,,2,3,2,5
39582_0,,,,2,3,2,5
39583_0,,,,2,3,2,5
39584_0,,,,2,3,2,5
39585_0,,,,2,3,2,5
39586_0,,,,2,3,2,5
39587_0,,,,2,3,2,5
39588_0,,,,2,3,2,5
39589_0,,,,2,3,2,5
39591_0,,,,2,3,2,5
C(C(CO)(C(C(CO)CO)O)O)O,,,5,1,1,0,1
39593_0,,,,2,3,2,5
C(C(C)(CC(C=O)(CCO)O)O)=O,,,5,1,1,0,1
39594_0,,,,2,3,2,5
39595_0,,,,2,3,2,5
39596_0,,,,2,3,2,5
39597_0,,,,2,3,2,5
39598_0,,,,2,3,2,5
39599_0,,,,2,3,2,5
39600_0,,,,2,3,2,5
39601_0,,,,2,3,2,5
39602_0,,,,2,3,2,5
39603_0,,,,2,3,2,5
39604_0,,,,2,3,2,5
39605_0,,,,2,3,2,5
39606_0,,,,2,3,2,5
39607_0,,,,2,3,2,5
39608_0,,,,2,3,2,5
39610_0,,,,2,3,2,5
C(C(C)(CC(C(CO)CO)O)O)=O,,,5,1,1,0,1
39611_0,,,,2,3,2,5
39612_0,,,,2,3,2,5
39613_0,,,,2,3,2,5
39614_0,,,,2,3,2,5
39615_0,,,,2,3,2,5
39616_0,,,,2,3,2,5
39617_0,,,,2,3,2,5
39619_0,,,,2,3,2,5
C(C(C)(CC(CCO)O)O)=O,,,5,1,1,0,1
39620_0,,,,2,3,2,5
39622_0,,,,2,3,2,5
C(C(C)(CC(C(CO)O)O)O)=O,,,5,1,2,0,2
39623_0,,,,2,3,2,5
39625_0,,,,2,3,2,5
C(CC(C)(C(C(CO)CO)O)O)=O,,,5,1,1,0,1
39626_0,,,,2,3,2,5
39627_0,,,,2,3,2,5
39628_0,,,,2,3,2,5
39629_0,,,,2,3,2,5
39630_0,,,,2,3,2,5
39631_0,,,,2,3,2,5
39632_0,,,,2,3,2,5
39633_0,,,,2,3,2,5
39634_0,,,,2,3,2,5
39635_0,,,,2,3,2,5
39636_0,,,,2,3,2,5
39638_0,,,,2,3,2,5
C(C(C)(C(CO)C(CCO)O)O)=O,,,5,1,1,0,1
39639_0,,,,2,3,2,5
39641_0,,,,2,3,2,5
C(C(C)(C(CO)C(CO)(C)O)O)=O,,,5,1,1,0,1
39642_0,,,,2,3,2,5
39644_0,,,,2,3,2,5
C(C(CO)C(C=O)(C)O)(O)=O,,,5,1,5,0,5
39645_0,,,,2,3,2,5
39647_0,,,,2,3,2,5
C(C(C)(C(CO)C(C(O)O)O)O)=O,,,5,1,1,0,1
39648_0,,,,2,3,2,5
39650_0,,,,2,3,2,5
C(C(C)(C(CO)C(C(C)O)O)O)=O,,,5,1,1,0,1
39651_0,,,,2,3,2,5
39652_0,,,,2,3,2,5
39654_0,,,,2,3,2,5
C(C(C)(C(CO)C(C=O)(C)O)O)=O,,,5,1,1,0,1
39656_0,,,,2,3,2,5
C(C(C)(C(CO)C(C(C)=O)O)O)=O,,,5,1,1,0,1
39657_0,,,,2,3,2,5
39659_0,,,,2,3,2,5
C(C(C)(C(CO)C(C)O)O)=O,,,5,1,1,0,1
39660_0,,,,2,3,2,5
39662_0,,,,2,3,2,5
C(C(C)(C(CO)CO)O)=O,,,5,1,1,0,1
39663_0,,,,2,3,2,5
39665_0,,,,2,3,2,5
C(C(C)(C(CO)C(CO)O)O)=O,,,5,1,2,0,2
39666_0,,,,2,3,2,5
39667_0,,,,2,3,2,5
39668_0,,,,2,3,2,5
39669_0,,,,2,3,2,5
39670_0,,,,2,3,2,5
39671_0,,,,2,3,2,5
39672_0,,,,2,3,2,5
39673_0,,,,2,3,2,5
39674_0,,,,2,3,2,5
39676_0,,,,2,3,2,5
C(C(CC(C(C)=O)O)(CCO)O)=O,,,5,1,1,0,1
39677_0,,,,2,3,2,5
39678_0,,,,2,3,2,5
39679_0,,,,2,3,2,5
39680_0,,,,2,3,2,5
39681_0,,,,2,3,2,5
39682_0,,,,2,3,2,5
39683_0,,,,2,3,2,5
39684_0,,,,2,3,2,5
39685_0,,,,2,3,2,5
39686_0,,,,2,3,2,5
39688_0,,,,2,3,2,5
C(C)(C(CC(C(CO)CO)O)O)=O,,,5,1,1,0,1
39689_0,,,,2,3,2,5
39690_0,,,,2,3,2,5
39692_0,,,,2,3,2,5
C(C)(C(CC(CCO)O)O)=O,,,5,1,1,0,1
39694_0,,,,2,3,2,5
C(C)(C(CC(C(CO)O)O)O)=O,,,5,1,2,0,2
39696_0,,,,2,3,2,5
C(CC(C(C)(C(CO)CO)O)O)=O,,,5,1,1,0,1
39697_0,,,,2,3,2,5
39698_0,,,,2,3,2,5
39699_0,,,,2,3,2,5
39701_0,,,,2,3,2,5
C(C)(C(C(CO)C(CCO)O)O)=O,,,5,1,1,0,1
39703_0,,,,2,3,2,5
C(C)(C(C(CO)C(CO)(C)O)O)=O,,,5,1,1,0,1
39705_0,,,,2,3,2,5
C(C(CO)C(C(C)=O)O)(O)=O,,,5,1,5,0,5
39707_0,,,,2,3,2,5
C(C)(C(C(CO)C(C(O)O)O)O)=O,,,5,1,1,0,1
39709_0,,,,2,3,2,5
C(C)(C(C(CO)C(C(C)O)O)O)=O,,,5,1,1,0,1
39711_0,,,,2,3,2,5
C(C)(C(C(CO)C(C(C)=O)O)O)=O,,,5,1,1,0,1
39713_0,,,,2,3,2,5
C(C)(C(C(CO)C(C)O)O)=O,,,5,1,1,0,1
39715_0,,,,2,3,2,5
C(C)(C(C(CO)CO)O)=O,,,5,1,1,0,1
39717_0,,,,2,3,2,5
C(C)(C(C(CO)C(CO)O)O)=O,,,5,1,2,0,2
39718_0,,,,2,3,2,5
39719_0,,,,2,3,2,5
39720_0,,,,2,3,2,5
39721_0,,,,2,3,2,5
39722_0,,,,2,3,2,5
39723_0,,,,2,3,2,5
39724_0,,,,2,3,2,5
39725_0,,,,2,3,2,5
39726_0,,,,2,3,2,5
39727_0,,,,2,3,2,5
39728_0,,,,2,3,2,5
39729_0,,,,2,3,2,5
39730_0,,,,2,3,2,5
39731_0,,,,2,3,2,5
39732_0,,,,2,3,2,5
39733_0,,,,2,3,2,5
39734_0,,,,2,3,2,5
39735_0,,,,2,3,2,5
39736_0,,,,2,3,2,5
39737_0,,,,2,3,2,5
39738_0,,,,2,3,2,5
39739_0,,,,2,3,2,5
39740_0,,,,2,3,2,5
39741_0,,,,2,3,2,5
39742_0,,,,2,3,2,5
39743_0,,,,2,3,2,5
39744_0,,,,2,3,2,5
39745_0,,,,2,3,2,5
39746_0,,,,2,3,2,5
39747_0,,,,2,3,2,5
39748_0,,,,2,3,2,5
39749_0,,,,2,3,2,5
39750_0,,,,2,3,2,5
39752_0,,,,2,3,2,5
C(C(CC(C)O)(C(CO)CO)O)=O,,,5,1,1,0,1
39753_0,,,,2,3,2,5
39754_0,,,,2,3,2,5
39755_0,,,,2,3,2,5
39756_0,,,,2,3,2,5
39757_0,,,,2,3,2,5
39758_0,,,,2,3,2,5
39759_0,,,,2,3,2,5
39761_0,,,,2,3,2,5
C(C(CCO)(CC(C)O)O)=O,,,5,1,1,0,1
39762_0,,,,2,3,2,5
39764_0,,,,2,3,2,5
C(C(C(CO)O)(CC(C)O)O)=O,,,5,1,3,0,3
39765_0,,,,2,3,2,5
39767_0,,,,2,3,2,5
C(C(C(CO)CO)O)(CC(C)O)=O,,,5,1,1,0,1
39768_0,,,,2,3,2,5
39769_0,,,,2,3,2,5
39770_0,,,,2,3,2,5
39771_0,,,,2,3,2,5
39772_0,,,,2,3,2,5
39773_0,,,,2,3,2,5
39774_0,,,,2,3,2,5
39775_0,,,,2,3,2,5
39776_0,,,,2,3,2,5
39777_0,,,,2,3,2,5
39778_0,,,,2,3,2,5
39779_0,,,,2,3,2,5
39780_0,,,,2,3,2,5
39781_0,,,,2,3,2,5
39782_0,,,,2,3,2,5
39783_0,,,,2,3,2,5
39784_0,,,,2,3,2,5
39785_0,,,,2,3,2,5
39786_0,,,,2,3,2,5
39787_0,,,,2,3,2,5
39788_0,,,,2,3,2,5
39790_0,,,,2,3,2,5
C(C(CCO)(CC(CO)O)O)=O,,,5,1,2,0,2
39791_0,,,,2,3,2,5
39793_0,,,,2,3,2,5
C(C(C(CO)O)(CC(CO)O)O)=O,,,5,1,4,0,4
39794_0,,,,2,3,2,5
39795_0,,,,2,3,2,5
39796_0,,,,2,3,2,5
39797_0,,,,2,3,2,5
39798_0,,,,2,3,2,5
39799_0,,,,2,3,2,5
39800_0,,,,2,3,2,5
39801_0,,,,2,3,2,5
39802_0,,,,2,3,2,5
39803_0,,,,2,3,2,5
39804_0,,,,2,3,2,5
39805_0,,,,2,3,2,5
39806_0,,,,2,3,2,5
39808_0,,,,2,3,2,5
C(CC(CC(C(CO)CO)O)O)=O,,,5,1,1,0,1
39809_0,,,,2,3,2,5
39810_0,,,,2,3,2,5
39811_0,,,,2,3,2,5
39812_0,,,,2,3,2,5
39813_0,,,,2,3,2,5
39814_0,,,,2,3,2,5
39815_0,,,,2,3,2,5
39816_0,,,,2,3,2,5
39817_0,,,,2,3,2,5
39818_0,,,,2,3,2,5
39819_0,,,,2,3,2,5
39820_0,,,,2,3,2,5
39821_0,,,,2,3,2,5
39822_0,,,,2,3,2,5
39823_0,,,,2,3,2,5
39824_0,,,,2,3,2,5
39825_0,,,,2,3,2,5
39826_0,,,,2,3,2,5
39827_0,,,,2,3,2,5
39828_0,,,,2,3,2,5
39829_0,,,,2,3,2,5
39830_0,,,,2,3,2,5
39831_0,,,,2,3,2,5
39832_0,,,,2,3,2,5
39833_0,,,,2,3,2,5
39834_0,,,,2,3,2,5
39835_0,,,,2,3,2,5
39836_0,,,,2,3,2,5
39837_0,,,,2,3,2,5
39838_0,,,,2,3,2,5
39839_0,,,,2,3,2,5
39840_0,,,,2,3,2,5
39841_0,,,,2,3,2,5
39842_0,,,,2,3,2,5
39843_0,,,,2,3,2,5
39844_0,,,,2,3,2,5
39845_0,,,,2,3,2,5
39846_0,,,,2,3,2,5
39847_0,,,,2,3,2,5
39848_0,,,,2,3,2,5
39849_0,,,,2,3,2,5
39850_0,,,,2,3,2,5
39851_0,,,,2,3,2,5
39852_0,,,,2,3,2,5
39853_0,,,,2,3,2,5
39854_0,,,,2,3,2,5
39855_0,,,,2,3,2,5
39856_0,,,,2,3,2,5
39857_0,,,,2,3,2,5
39859_0,,,,2,3,2,5
C(C(CCO)(CC(CCO)O)O)=O,,,5,1,1,0,1
39860_0,,,,2,3,2,5
39861_0,,,,2,3,2,5
39862_0,,,,2,3,2,5
39864_0,,,,2,3,2,5
C(C(CO)C(C=O)(CCO)O)(O)=O,,,5,1,5,0,5
39865_0,,,,2,3,2,5
39867_0,,,,2,3,2,5
C(C(CCO)(C(CO)C(C)O)O)=O,,,5,1,2,0,2
39868_0,,,,2,3,2,5
39870_0,,,,2,3,2,5
C(C(CCO)(C(CO)CO)O)=O,,,5,1,2,0,2
39871_0,,,,2,3,2,5
39873_0,,,,2,3,2,5
C(C(CC(CCO)O)O)(CCO)=O,,,5,1,1,0,1
39875_0,,,,2,3,2,5
C(C(CO)C(C(CCO)=O)O)(O)=O,,,5,1,5,0,5
39877_0,,,,2,3,2,5
C(C(C(CO)C(C)O)O)(CCO)=O,,,5,1,1,0,1
39879_0,,,,2,3,2,5
C(C(C(CO)CO)O)(CCO)=O,,,5,1,1,0,1
39880_0,,,,2,3,2,5
39881_0,,,,2,3,2,5
39882_0,,,,2,3,2,5
39883_0,,,,2,3,2,5
39884_0,,,,2,3,2,5
39885_0,,,,2,3,2,5
39886_0,,,,2,3,2,5
39887_0,,,,2,3,2,5
39889_0,,,,2,3,2,5
C(C(C(CO)O)(C(CO)CO)O)=O,,,5,1,4,0,4
39890_0,,,,2,3,2,5
39891_0,,,,2,3,2,5
39892_0,,,,2,3,2,5
39893_0,,,,2,3,2,5
39894_0,,,,2,3,2,5
39895_0,,,,2,3,2,5
39896_0,,,,2,3,2,5
39897_0,,,,2,3,2,5
39898_0,,,,2,3,2,5
39900_0,,,,2,3,2,5
C(C(CC(CC(CCO)O)O)O)=O,,,5,1,1,0,1
39901_0,,,,2,3,2,5
39903_0,,,,2,3,2,5
C(C(CO)C(CC(C=O)O)O)(O)=O,,,5,1,5,0,5
39904_0,,,,2,3,2,5
39906_0,,,,2,3,2,5
C(C(CC(C(CO)C(C)O)O)O)=O,,,5,1,1,0,1
39907_0,,,,2,3,2,5
39909_0,,,,2,3,2,5
C(C(CC(C(CO)CO)O)O)=O,,,5,1,1,0,1
39910_0,,,,2,3,2,5
39912_0,,,,2,3,2,5
C(C(C(C(CCO)O)C(C)O)O)=O,,,5,1,2,0,2
39913_0,,,,2,3,2,5
39914_0,,,,2,3,2,5
39915_0,,,,2,3,2,5
39916_0,,,,2,3,2,5
39917_0,,,,2,3,2,5
39918_0,,,,2,3,2,5
39919_0,,,,2,3,2,5
39920_0,,,,2,3,2,5
39921_0,,,,2,3,2,5
39922_0,,,,2,3,2,5
39923_0,,,,2,3,2,5
39924_0,,,,2,3,2,5
39925_0,,,,2,3,2,5
39926_0,,,,2,3,2,5
39927_0,,,,2,3,2,5
39928_0,,,,2,3,2,5
39929_0,,,,2,3,2,5
39930_0,,,,2,3,2,5
39931_0,,,,2,3,2,5
39932_0,,,,2,3,2,5
39933_0,,,,2,3,2,5
39934_0,,,,2,3,2,5
39935_0,,,,2,3,2,5
39936_0,,,,2,3,2,5
39937_0,,,,2,3,2,5
39938_0,,,,2,3,2,5
39939_0,,,,2,3,2,5
39940_0,,,,2,3,2,5
39941_0,,,,2,3,2,5
39942_0,,,,2,3,2,5
39943_0,,,,2,3,2,5
39944_0,,,,2,3,2,5
39945_0,,,,2,3,2,5
39946_0,,,,2,3,2,5
39947_0,,,,2,3,2,5
39948_0,,,,2,3,2,5
39949_0,,,,2,3,2,5
39950_0,,,,2,3,2,5
39951_0,,,,2,3,2,5
39952_0,,,,2,3,2,5
39953_0,,,,2,3,2,5
39954_0,,,,2,3,2,5
39955_0,,,,2,3,2,5
39956_0,,,,2,3,2,5
39957_0,,,,2,3,2,5
39958_0,,,,2,3,2,5
39959_0,,,,2,3,2,5
39960_0,,,,2,3,2,5
39962_0,,,,2,3,2,5
C(C(C(C)(CC(CCO)O)O)O)=O,,,5,1,1,0,1
39963_0,,,,2,3,2,5
39964_0,,,,2,3,2,5
39965_0,,,,2,3,2,5
39967_0,,,,2,3,2,5
C(C(C(C)(C(CO)C(C)O)O)O)=O,,,5,1,1,0,1
39968_0,,,,2,3,2,5
39970_0,,,,2,3,2,5
C(C(C(C)(C(CO)CO)O)O)=O,,,5,1,1,0,1
39971_0,,,,2,3,2,5
39973_0,,,,2,3,2,5
C(C(C(CC(C)O)(CCO)O)O)=O,,,5,1,1,0,1
39974_0,,,,2,3,2,5
39975_0,,,,2,3,2,5
39976_0,,,,2,3,2,5
39977_0,,,,2,3,2,5
39978_0,,,,2,3,2,5
39979_0,,,,2,3,2,5
39981_0,,,,2,3,2,5
C(C(C(CCO)(CCO)O)O)=O,,,5,1,1,0,1
39982_0,,,,2,3,2,5
39983_0,,,,2,3,2,5
39984_0,,,,2,3,2,5
39985_0,,,,2,3,2,5
39986_0,,,,2,3,2,5
39988_0,,,,2,3,2,5
CC(CC(C(CO)C(C)O)O)O,,,5,1,1,0,1
39990_0,,,,2,3,2,5
CC(CC(C(CO)CO)O)O,,,5,1,1,0,1
39992_0,,,,2,3,2,5
CC(CC(C(CO)C(CO)O)O)O,,,5,1,1,0,1
39994_0,,,,2,3,2,5
C(C(CO)C(CC(C)O)O)(O)=O,,,5,1,3,0,3
39995_0,,,,2,3,2,5
39996_0,,,,2,3,2,5
39997_0,,,,2,3,2,5
39998_0,,,,2,3,2,5
39999_0,,,,2,3,2,5
40000_0,,,,2,3,2,5
40001_0,,,,2,3,2,5
40002_0,,,,2,3,2,5
40003_0,,,,2,3,2,5
40004_0,,,,2,3,2,5
40005_0,,,,2,3,2,5
40007_0,,,,2,3,2,5
CC(CC(CCO)O)O,,,5,1,1,0,1
40008_0,,,,2,3,2,5
40010_0,,,,2,3,2,5
CC(CC(C(CO)O)O)O,,,5,1,2,0,2
40012_0,,,,2,3,2,5
CC(C(CO)C(C(C(C)O)O)O)O,,,5,1,1,0,1
40014_0,,,,2,3,2,5
CC(C(CO)C(CCO)O)O,,,5,1,1,0,1
40016_0,,,,2,3,2,5
CC(C(CO)C(CC(CO)O)O)O,,,5,1,1,0,1
40018_0,,,,2,3,2,5
C(C)(C(CO)(C(CO)C(C)O)O)=O,,,5,1,1,0,1
40020_0,,,,2,3,2,5
C(CO)(C(C)(C(CO)C(C)O)O)=O,,,5,1,1,0,1
40021_0,,,,2,3,2,5
40023_0,,,,2,3,2,5
C(C(C(C)O)(C(CO)C(C)O)O)=O,,,5,1,2,0,2
40025_0,,,,2,3,2,5
C(C(C(CO)C(C)O)O)(C(C)O)=O,,,5,1,1,0,1
40027_0,,,,2,3,2,5
CC(CO)(C(CO)C(C)O)O,,,5,1,1,0,1
40029_0,,,,2,3,2,5
CC(C(CO)C(CO)(CCO)O)O,,,5,1,1,0,1
40031_0,,,,2,3,2,5
CC(C(CO)C(C(CCO)O)O)O,,,5,1,1,0,1
40033_0,,,,2,3,2,5
CC(C(CO)O)(C(CO)C(C)O)O,,,5,1,1,0,1
40035_0,,,,2,3,2,5
C(C(C)(C(CO)C(C)O)O)(O)=O,,,5,1,1,0,1
40037_0,,,,2,3,2,5
C(CC(C(CO)C(C)O)O)(O)=O,,,5,1,1,0,1
40039_0,,,,2,3,2,5
C(C(CO)(C(CO)C(C)O)O)(O)=O,,,5,1,2,0,2
40040_0,,,,2,3,2,5
40041_0,,,,2,3,2,5
40042_0,,,,2,3,2,5
40043_0,,,,2,3,2,5
40044_0,,,,2,3,2,5
40046_0,,,,2,3,2,5
C1C(C(CO1)O)(C(CO)C(C)O)O,,,5,1,1,0,1
40048_0,,,,2,3,2,5
CC(C(CO)C1(C(O)OCC1)O)O,,,5,1,1,0,1
40050_0,,,,2,3,2,5
C1C(CC(O)O1)(C(CO)C(C)O)O,,,5,1,1,0,1
40051_0,,,,2,3,2,5
40053_0,,,,2,3,2,5
C(C(C(C)=O)(C(CO)C(C)O)O)=O,,,5,1,1,0,1
40055_0,,,,2,3,2,5
C(C(C)=O)(C(C(CO)C(C)O)O)=O,,,5,1,1,0,1
40056_0,,,,2,3,2,5
40058_0,,,,2,3,2,5
C(C(C(C)(C(CO)C(C)O)O)=O)=O,,,5,1,1,0,1
40059_0,,,,2,3,2,5
40061_0,,,,2,3,2,5
C(C(C=C)(C(CO)C(C)O)O)=O,,,5,1,1,0,1
40063_0,,,,2,3,2,5
C=CC(C(C(CO)C(C)O)O)=O,,,5,1,1,0,1
40064_0,,,,2,3,2,5
40066_0,,,,2,3,2,5
C(C(C(CO)C(C)O)O)=CC=O,,,5,1,1,0,1
40068_0,,,,2,3,2,5
C(C(CO)C(C)O)(O)=O,,,5,1,5,0,5
40070_0,,,,2,3,2,5
CC(C(CO)C(C(O)O)O)O,,,5,1,1,0,1
40072_0,,,,2,3,2,5
CC(C(C(CO)C(C)O)O)O,,,5,1,1,0,1
40074_0,,,,2,3,2,5
CC(C(CO)C(C(CO)O)O)O,,,5,1,1,0,1
40076_0,,,,2,3,2,5
CC(C(CO)C(C)O)O,,,5,1,1,0,1
40077_0,,,,2,3,2,5
40079_0,,,,2,3,2,5
C(C(CO)(C(CO)C(C)O)O)=O,,,5,1,2,0,2
40081_0,,,,2,3,2,5
C(CO)(C(C(CO)C(C)O)O)=O,,,5,1,1,0,1
40083_0,,,,2,3,2,5
CC(C(CO)CO)O,,,5,1,1,0,1
40085_0,,,,2,3,2,5
CC(C(CO)C(CO)O)O,,,5,1,2,0,2
40086_0,,,,2,3,2,5
40087_0,,,,2,3,2,5
40088_0,,,,2,3,2,5
40089_0,,,,2,3,2,5
40090_0,,,,2,3,2,5
40092_0,,,,2,3,2,5
CC(C(C(C(CO)CO)O)O)O,,,5,1,1,0,1
40094_0,,,,2,3,2,5
C(C(CO)C(C(C(C)O)O)O)(O)=O,,,5,1,3,0,3
40095_0,,,,2,3,2,5
40096_0,,,,2,3,2,5
40098_0,,,,2,3,2,5
CC(C(C(CCO)O)O)O,,,5,1,1,0,1
40099_0,,,,2,3,2,5
40101_0,,,,2,3,2,5
CC(C(C(C(CO)O)O)O)O,,,5,1,6,0,6
40102_0,,,,2,3,2,5
40103_0,,,,2,3,2,5
40105_0,,,,2,3,2,5
C(C(CO)(CC(CCO)O)O)=O,,,5,1,2,0,2
40106_0,,,,2,3,2,5
40108_0,,,,2,3,2,5
C(C(CO)(CC(C(CO)O)O)O)=O,,,5,1,3,0,3
40109_0,,,,2,3,2,5
40110_0,,,,2,3,2,5
40112_0,,,,2,3,2,5
C(C(CO)C(C=O)(CO)O)(O)=O,,,5,1,6,0,6
40113_0,,,,2,3,2,5
40115_0,,,,2,3,2,5
C(C(CO)(C(CO)CO)O)=O,,,5,1,2,0,2
40116_0,,,,2,3,2,5
40118_0,,,,2,3,2,5
C(C(CO)(C(CO)C(CO)O)O)=O,,,5,1,3,0,3
40119_0,,,,2,3,2,5
40120_0,,,,2,3,2,5
40121_0,,,,2,3,2,5
40122_0,,,,2,3,2,5
40123_0,,,,2,3,2,5
40124_0,,,,2,3,2,5
40125_0,,,,2,3,2,5
40126_0,,,,2,3,2,5
40128_0,,,,2,3,2,5
C(CO)(C(C(CO)C(CO)O)O)=O,,,5,1,2,0,2
40129_0,,,,2,3,2,5
40130_0,,,,2,3,2,5
40132_0,,,,2,3,2,5
C(C(C(CO)CO)O)(C(CO)O)=O,,,5,1,1,0,1
40134_0,,,,2,3,2,5
C(C(C(CC(CCO)O)O)O)O,,,5,1,1,0,1
40136_0,,,,2,3,2,5
C(C(C(CC(C(CO)O)O)O)O)O,,,5,1,2,0,2
40138_0,,,,2,3,2,5
C(C(CO)C(C(CO)O)O)(O)=O,,,5,1,5,0,5
40140_0,,,,2,3,2,5
C(C(CO)C(C(CO)O)O)O,,,5,1,1,0,1
40142_0,,,,2,3,2,5
C(C(C(CO)O)C(C(CO)O)O)O,,,5,1,2,0,2
40144_0,,,,2,3,2,5
C(C(CO)C(C(C(CO)O)O)O)O,,,5,1,1,0,1
40146_0,,,,2,3,2,5
C(C(CO)C(CCO)O)O,,,5,1,1,0,1
40148_0,,,,2,3,2,5
C(C(C(CO)C(CCO)O)O)O,,,5,1,1,0,1
40149_0,,,,2,3,2,5
40151_0,,,,2,3,2,5
C(C(CO)C(CCO)O)(O)=O,,,5,1,3,0,3
40152_0,,,,2,3,2,5
40153_0,,,,2,3,2,5
40154_0,,,,2,3,2,5
40155_0,,,,2,3,2,5
40156_0,,,,2,3,2,5
40157_0,,,,2,3,2,5
40158_0,,,,2,3,2,5
40159_0,,,,2,3,2,5
40160_0,,,,2,3,2,5
40161_0,,,,2,3,2,5
40162_0,,,,2,3,2,5
40163_0,,,,2,3,2,5
40164_0,,,,2,3,2,5
40166_0,,,,2,3,2,5
C(CC(CCO)O)O,,,5,1,1,0,1
40167_0,,,,2,3,2,5
40168_0,,,,2,3,2,5
40170_0,,,,2,3,2,5
C(C(CC(C(CO)CO)O)O)O,,,5,1,1,0,1
40171_0,,,,2,3,2,5
40172_0,,,,2,3,2,5
40173_0,,,,2,3,2,5
40174_0,,,,2,3,2,5
40175_0,,,,2,3,2,5
40177_0,,,,2,3,2,5
C(C)(C(CO)(C(CO)CO)O)=O,,,5,1,1,0,1
40179_0,,,,2,3,2,5
C(CO)(C(C)(C(CO)CO)O)=O,,,5,1,1,0,1
40180_0,,,,2,3,2,5
40182_0,,,,2,3,2,5
C(C(C(C)O)(C(CO)CO)O)=O,,,5,1,2,0,2
40184_0,,,,2,3,2,5
C(C(C(CO)CO)O)(C(C)O)=O,,,5,1,1,0,1
40186_0,,,,2,3,2,5
CC(CO)(C(CO)CO)O,,,5,1,1,0,1
40188_0,,,,2,3,2,5
C(C(CCO)(C(CO)CO)O)O,,,5,1,1,0,1
40190_0,,,,2,3,2,5
C(C(CO)C(C(CCO)O)O)O,,,5,1,1,0,1
40192_0,,,,2,3,2,5
CC(C(CO)O)(C(CO)CO)O,,,5,1,1,0,1
40194_0,,,,2,3,2,5
C(C(C)(C(CO)CO)O)(O)=O,,,5,1,1,0,1
40196_0,,,,2,3,2,5
C(CC(C(CO)CO)O)(O)=O,,,5,1,1,0,1
40198_0,,,,2,3,2,5
C(C(CCO)(C(CO)CO)O)(O)=O,,,5,1,1,0,1
40200_0,,,,2,3,2,5
C(CC(C(C(CO)CO)O)O)(O)=O,,,5,1,1,0,1
40202_0,,,,2,3,2,5
C(CC(CO)(C(CO)CO)O)(O)=O,,,5,1,1,0,1
40204_0,,,,2,3,2,5
C(C(C(C)(C(CO)CO)O)O)(O)=O,,,5,1,1,0,1
40205_0,,,,2,3,2,5
40206_0,,,,2,3,2,5
40207_0,,,,2,3,2,5
40208_0,,,,2,3,2,5
40209_0,,,,2,3,2,5
40210_0,,,,2,3,2,5
40211_0,,,,2,3,2,5
40213_0,,,,2,3,2,5
C(C(C(CO)CO)(CC(O)=O)O)=O,,,5,1,2,0,2
40215_0,,,,2,3,2,5
C(CC(C(C(CO)CO)O)=O)(O)=O,,,5,1,1,0,1
40216_0,,,,2,3,2,5
40217_0,,,,2,3,2,5
40219_0,,,,2,3,2,5
C1C(C(CO1)O)(C(CO)CO)O,,,5,1,1,0,1
40221_0,,,,2,3,2,5
C1CC(C(O)O1)(C(CO)CO)O,,,5,1,1,0,1
40223_0,,,,2,3,2,5
C1C(CC(O)O1)(C(CO)CO)O,,,5,1,1,0,1
40224_0,,,,2,3,2,5
40226_0,,,,2,3,2,5
C(C(C(C)=O)(C(CO)CO)O)=O,,,5,1,1,0,1
40228_0,,,,2,3,2,5
C(C(C)=O)(C(C(CO)CO)O)=O,,,5,1,1,0,1
40229_0,,,,2,3,2,5
40231_0,,,,2,3,2,5
C(C(C(C)(C(CO)CO)O)=O)=O,,,5,1,1,0,1
40232_0,,,,2,3,2,5
40234_0,,,,2,3,2,5
C(C(C=C)(C(CO)CO)O)=O,,,5,1,1,0,1
40236_0,,,,2,3,2,5
C=CC(C(C(CO)CO)O)=O,,,5,1,1,0,1
40237_0,,,,2,3,2,5
40239_0,,,,2,3,2,5
C(C(C(CO)CO)O)=CC=O,,,5,1,1,0,1
40241_0,,,,2,3,2,5
C1C(C(C(O)O1)(C(CO)CO)O)O,,,5,1,1,0,1
40243_0,,,,2,3,2,5
C(C(CO)CO)(O)=O,,,5,1,4,0,4
40245_0,,,,2,3,2,5
C(C(CO)C(C(O)O)O)O,,,5,1,1,0,1
40247_0,,,,2,3,2,5
CC(C(C(CO)CO)O)O,,,5,1,1,0,1
40249_0,,,,2,3,2,5
C(C(CO)CO)O,,,5,1,1,0,1
40251_0,,,,2,3,2,5
C(C(CO)C(CO)O)O,,,5,1,2,0,2
40253_0,,,,2,3,2,5
C(C(CO)C(CC(CO)O)O)(O)=O,,,5,1,3,0,3
40254_0,,,,2,3,2,5
40255_0,,,,2,3,2,5
40257_0,,,,2,3,2,5
C(C(CC(CCO)O)O)O,,,5,1,2,0,2
40258_0,,,,2,3,2,5
40260_0,,,,2,3,2,5
C(C(C(CC(CO)O)O)O)O,,,5,1,3,0,3
40262_0,,,,2,3,2,5
CC(CO)(C(CO)C(CO)O)O,,,5,1,1,0,1
40264_0,,,,2,3,2,5
C(C(C)(C(CO)C(CO)O)O)(O)=O,,,5,1,1,0,1
40266_0,,,,2,3,2,5
C(CC(C(CO)C(CO)O)O)(O)=O,,,5,1,1,0,1
40267_0,,,,2,3,2,5
40269_0,,,,2,3,2,5
C(C(C=C)(C(CO)C(CO)O)O)=O,,,5,1,1,0,1
40271_0,,,,2,3,2,5
C=CC(C(C(CO)C(CO)O)O)=O,,,5,1,1,0,1
40272_0,,,,2,3,2,5
40274_0,,,,2,3,2,5
C(C(C(CO)C(CO)O)O)=CC=O,,,5,1,1,0,1
40276_0,,,,2,3,2,5
C(C(CO)C(CO)O)(O)=O,,,5,1,8,0,8
40278_0,,,,2,3,2,5
C(C(C(CO)O)C(C(O)O)O)O,,,5,1,1,0,1
40280_0,,,,2,3,2,5
CC(C(C(CO)C(CO)O)O)O,,,5,1,1,0,1
40282_0,,,,2,3,2,5
C(C(C(CO)O)C(CO)O)O,,,5,1,2,0,2
40283_0,,,,2,3,2,5
40284_0,,,,2,3,2,5
40285_0,,,,2,3,2,5
40286_0,,,,2,3,2,5
40287_0,,,,2,3,2,5
40288_0,,,,2,3,2,5
40289_0,,,,2,3,2,5
40290_0,,,,2,3,2,5
40291_0,,,,2,3,2,5
40292_0,,,,2,3,2,5
40293_0,,,,2,3,2,5
40294_0,,,,2,3,2,5
40295_0,,,,2,3,2,5
40296_0,,,,2,3,2,5
40297_0,,,,2,3,2,5
40298_0,,,,2,3,2,5
40299_0,,,,2,3,2,5
40300_0,,,,2,3,2,5
40301_0,,,,2,3,2,5
40302_0,,,,2,3,2,5
40303_0,,,,2,3,2,5
40304_0,,,,2,3,2,5
40305_0,,,,2,3,2,5
40306_0,,,,2,3,2,5
40307_0,,,,2,3,2,5
40308_0,,,,2,3,2,5
40309_0,,,,2,3,2,5
40310_0,,,,2,3,2,5
40311_0,,,,2,3,2,5
40312_0,,,,2,3,2,5
40313_0,,,,2,3,2,5
40314_0,,,,2,3,2,5
40315_0,,,,2,3,2,5
40316_0,,,,2,3,2,5
40317_0,,,,2,3,2,5
40318_0,,,,2,3,2,5
40319_0,,,,2,3,2,5
40320_0,,,,2,3,2,5
40321_0,,,,2,3,2,5
40322_0,,,,2,3,2,5
40323_0,,,,2,3,2,5
40324_0,,,,2,3,2,5
40325_0,,,,2,3,2,5
40326_0,,,,2,3,2,5
40327_0,,,,2,3,2,5
40328_0,,,,2,3,2,5
40329_0,,,,2,3,2,5
40330_0,,,,2,3,2,5
40331_0,,,,2,3,2,5
40332_0,,,,2,3,2,5
40333_0,,,,2,3,2,5
40334_0,,,,2,3,2,5
40335_0,,,,2,3,2,5
40337_0,,,,2,3,2,5
C(C(CO)C(C(C)=O)(CO)O)(O)=O,,,5,1,3,0,3
40338_0,,,,2,3,2,5
40339_0,,,,2,3,2,5
40341_0,,,,2,3,2,5
C(C)(C(CO)(CCO)O)=O,,,5,1,3,0,3
40342_0,,,,2,3,2,5
40343_0,,,,2,3,2,5
40345_0,,,,2,3,2,5
C(C(CO)C(C(CO)=O)(C)O)(O)=O,,,5,1,3,0,3
40346_0,,,,2,3,2,5
40347_0,,,,2,3,2,5
40348_0,,,,2,3,2,5
40349_0,,,,2,3,2,5
40350_0,,,,2,3,2,5
40351_0,,,,2,3,2,5
40352_0,,,,2,3,2,5
40353_0,,,,2,3,2,5
40354_0,,,,2,3,2,5
40355_0,,,,2,3,2,5
40356_0,,,,2,3,2,5
40357_0,,,,2,3,2,5
40358_0,,,,2,3,2,5
40359_0,,,,2,3,2,5
40360_0,,,,2,3,2,5
40361_0,,,,2,3,2,5
40362_0,,,,2,3,2,5
40363_0,,,,2,3,2,5
40364_0,,,,2,3,2,5
40365_0,,,,2,3,2,5
40366_0,,,,2,3,2,5
40367_0,,,,2,3,2,5
40369_0,,,,2,3,2,5
C(C(CO)C(C=O)(C(C)O)O)(O)=O,,,5,1,5,0,5
40370_0,,,,2,3,2,5
40371_0,,,,2,3,2,5
40372_0,,,,2,3,2,5
40373_0,,,,2,3,2,5
40374_0,,,,2,3,2,5
40375_0,,,,2,3,2,5
40376_0,,,,2,3,2,5
40377_0,,,,2,3,2,5
40379_0,,,,2,3,2,5
C(C(CO)C(C(C(C)O)=O)O)(O)=O,,,5,1,3,0,3
40380_0,,,,2,3,2,5
40381_0,,,,2,3,2,5
40382_0,,,,2,3,2,5
40383_0,,,,2,3,2,5
40384_0,,,,2,3,2,5
40385_0,,,,2,3,2,5
40386_0,,,,2,3,2,5
40387_0,,,,2,3,2,5
40388_0,,,,2,3,2,5
40389_0,,,,2,3,2,5
40390_0,,,,2,3,2,5
40391_0,,,,2,3,2,5
40392_0,,,,2,3,2,5
40393_0,,,,2,3,2,5
40394_0,,,,2,3,2,5
40395_0,,,,2,3,2,5
40396_0,,,,2,3,2,5
40397_0,,,,2,3,2,5
40398_0,,,,2,3,2,5
40399_0,,,,2,3,2,5
40400_0,,,,2,3,2,5
40401_0,,,,2,3,2,5
40402_0,,,,2,3,2,5
40403_0,,,,2,3,2,5
40404_0,,,,2,3,2,5
40405_0,,,,2,3,2,5
40406_0,,,,2,3,2,5
40407_0,,,,2,3,2,5
40408_0,,,,2,3,2,5
40410_0,,,,2,3,2,5
C(C(CO)C(C)(CO)O)(O)=O,,,5,1,3,0,3
40411_0,,,,2,3,2,5
40412_0,,,,2,3,2,5
40413_0,,,,2,3,2,5
40414_0,,,,2,3,2,5
40415_0,,,,2,3,2,5
40416_0,,,,2,3,2,5
40417_0,,,,2,3,2,5
40418_0,,,,2,3,2,5
40419_0,,,,2,3,2,5
40420_0,,,,2,3,2,5
40421_0,,,,2,3,2,5
40422_0,,,,2,3,2,5
40423_0,,,,2,3,2,5
40425_0,,,,2,3,2,5
CC(CO)(CCO)O,,,5,1,2,0,2
40426_0,,,,2,3,2,5
40428_0,,,,2,3,2,5
CC(CO)(C(CO)O)O,,,5,1,3,0,3
40429_0,,,,2,3,2,5
40430_0,,,,2,3,2,5
40431_0,,,,2,3,2,5
40432_0,,,,2,3,2,5
40433_0,,,,2,3,2,5
40434_0,,,,2,3,2,5
40435_0,,,,2,3,2,5
40436_0,,,,2,3,2,5
40437_0,,,,2,3,2,5
40438_0,,,,2,3,2,5
40439_0,,,,2,3,2,5
40440_0,,,,2,3,2,5
40441_0,,,,2,3,2,5
40442_0,,,,2,3,2,5
40443_0,,,,2,3,2,5
40444_0,,,,2,3,2,5
40445_0,,,,2,3,2,5
40446_0,,,,2,3,2,5
40447_0,,,,2,3,2,5
40448_0,,,,2,3,2,5
40449_0,,,,2,3,2,5
40450_0,,,,2,3,2,5
40451_0,,,,2,3,2,5
40452_0,,,,2,3,2,5
40453_0,,,,2,3,2,5
40454_0,,,,2,3,2,5
40455_0,,,,2,3,2,5
40457_0,,,,2,3,2,5
C(C(CO)C(CO)(CCO)O)(O)=O,,,5,1,3,0,3
40458_0,,,,2,3,2,5
40459_0,,,,2,3,2,5
40461_0,,,,2,3,2,5
C(C(CCO)(CCO)O)O,,,5,1,2,0,2
40462_0,,,,2,3,2,5
40463_0,,,,2,3,2,5
40464_0,,,,2,3,2,5
40465_0,,,,2,3,2,5
40466_0,,,,2,3,2,5
40467_0,,,,2,3,2,5
40468_0,,,,2,3,2,5
40469_0,,,,2,3,2,5
40470_0,,,,2,3,2,5
40471_0,,,,2,3,2,5
40473_0,,,,2,3,2,5
C(C(CO)C(C(CCO)O)O)(O)=O,,,5,1,3,0,3
40474_0,,,,2,3,2,5
40475_0,,,,2,3,2,5
40477_0,,,,2,3,2,5
C(CC(C(CCO)O)O)O,,,5,1,1,0,1
40478_0,,,,2,3,2,5
40479_0,,,,2,3,2,5
40481_0,,,,2,3,2,5
C(C(CO)C(C)(C(CO)O)O)(O)=O,,,5,1,3,0,3
40482_0,,,,2,3,2,5
40483_0,,,,2,3,2,5
40485_0,,,,2,3,2,5
CC(CCO)(C(CO)O)O,,,5,1,2,0,2
40486_0,,,,2,3,2,5
40488_0,,,,2,3,2,5
CC(C(CO)O)(C(CO)O)O,,,5,1,2,0,2
40489_0,,,,2,3,2,5
40490_0,,,,2,3,2,5
40491_0,,,,2,3,2,5
40492_0,,,,2,3,2,5
40493_0,,,,2,3,2,5
40494_0,,,,2,3,2,5
40495_0,,,,2,3,2,5
40496_0,,,,2,3,2,5
40497_0,,,,2,3,2,5
40498_0,,,,2,3,2,5
40499_0,,,,2,3,2,5
40500_0,,,,2,3,2,5
40501_0,,,,2,3,2,5
40502_0,,,,2,3,2,5
40503_0,,,,2,3,2,5
40504_0,,,,2,3,2,5
40506_0,,,,2,3,2,5
C(C(C)(CCO)O)(O)=O,,,5,1,3,0,3
40507_0,,,,2,3,2,5
40508_0,,,,2,3,2,5
40509_0,,,,2,3,2,5
40510_0,,,,2,3,2,5
40511_0,,,,2,3,2,5
40512_0,,,,2,3,2,5
40513_0,,,,2,3,2,5
40514_0,,,,2,3,2,5
40515_0,,,,2,3,2,5
40516_0,,,,2,3,2,5
40517_0,,,,2,3,2,5
40518_0,,,,2,3,2,5
40519_0,,,,2,3,2,5
40520_0,,,,2,3,2,5
40521_0,,,,2,3,2,5
40522_0,,,,2,3,2,5
40523_0,,,,2,3,2,5
40524_0,,,,2,3,2,5
40526_0,,,,2,3,2,5
C(C(CO)C(CC(O)=O)O)(O)=O,,,5,1,3,0,3
40527_0,,,,2,3,2,5
40528_0,,,,2,3,2,5
40529_0,,,,2,3,2,5
40530_0,,,,2,3,2,5
40531_0,,,,2,3,2,5
40532_0,,,,2,3,2,5
40533_0,,,,2,3,2,5
40534_0,,,,2,3,2,5
40535_0,,,,2,3,2,5
40536_0,,,,2,3,2,5
40537_0,,,,2,3,2,5
40539_0,,,,2,3,2,5
C(CC(CCO)O)(O)=O,,,5,1,3,0,3
40540_0,,,,2,3,2,5
40541_0,,,,2,3,2,5
40542_0,,,,2,3,2,5
40543_0,,,,2,3,2,5
40544_0,,,,2,3,2,5
40545_0,,,,2,3,2,5
40546_0,,,,2,3,2,5
40547_0,,,,2,3,2,5
40549_0,,,,2,3,2,5
C(C(CO)C1(COCC1O)O)(O)=O,,,5,1,3,0,3
40551_0,,,,2,3,2,5
C(C(CO)C1(C(O)OCC1)O)(O)=O,,,5,1,3,0,3
40553_0,,,,2,3,2,5
C(C(CO)C1(COC(C1)O)O)(O)=O,,,5,1,3,0,3
40554_0,,,,2,3,2,5
40556_0,,,,2,3,2,5
C(C(CO)C(C=O)(C(C)=O)O)(O)=O,,,5,1,3,0,3
40558_0,,,,2,3,2,5
C(C(CO)C(C(C(C)=O)=O)O)(O)=O,,,5,1,3,0,3
40559_0,,,,2,3,2,5
40561_0,,,,2,3,2,5
C(C(CO)C(C(C=O)=O)(C)O)(O)=O,,,5,1,3,0,3
40562_0,,,,2,3,2,5
40564_0,,,,2,3,2,5
C(C(C=C)(C(C(O)=O)CO)O)=O,,,5,1,3,0,3
40566_0,,,,2,3,2,5
C(C(CO)C(C(C=C)=O)O)(O)=O,,,5,1,3,0,3
40567_0,,,,2,3,2,5
40569_0,,,,2,3,2,5
C(C(CO)C(C=CC=O)O)(O)=O,,,5,1,3,0,3
40571_0,,,,2,3,2,5
C(C(C(O)=O)CO)(O)=O,,,5,1,4,0,4
40573_0,,,,2,3,2,5
C(C(CO)C(C(O)O)O)(O)=O,,,5,1,3,0,3
40575_0,,,,2,3,2,5
C(C(CO)C(C(C)O)O)(O)=O,,,5,1,3,0,3
40576_0,,,,2,3,2,5
40577_0,,,,2,3,2,5
40578_0,,,,2,3,2,5
40579_0,,,,2,3,2,5
40581_0,,,,2,3,2,5
C(C(CCO)(CCO)O)(O)=O,,,5,1,3,0,3
40582_0,,,,2,3,2,5
40583_0,,,,2,3,2,5
40584_0,,,,2,3,2,5
40585_0,,,,2,3,2,5
40586_0,,,,2,3,2,5
40588_0,,,,2,3,2,5
C(CC(C(CCO)O)O)(O)=O,,,5,1,2,0,2
40589_0,,,,2,3,2,5
40590_0,,,,2,3,2,5
40591_0,,,,2,3,2,5
40593_0,,,,2,3,2,5
C(CC(CO)(CCO)O)(O)=O,,,5,1,3,0,3
40594_0,,,,2,3,2,5
40595_0,,,,2,3,2,5
40596_0,,,,2,3,2,5
40597_0,,,,2,3,2,5
40598_0,,,,2,3,2,5
40599_0,,,,2,3,2,5
40601_0,,,,2,3,2,5
C(C(C(C)(CCO)O)O)(O)=O,,,5,1,3,0,3
40602_0,,,,2,3,2,5
40603_0,,,,2,3,2,5
40604_0,,,,2,3,2,5
40605_0,,,,2,3,2,5
40606_0,,,,2,3,2,5
40607_0,,,,2,3,2,5
40608_0,,,,2,3,2,5
40609_0,,,,2,3,2,5
40610_0,,,,2,3,2,5
40611_0,,,,2,3,2,5
40612_0,,,,2,3,2,5
40613_0,,,,2,3,2,5
40614_0,,,,2,3,2,5
40616_0,,,,2,3,2,5
C(C(CCO)(C(CO)(CO)O)O)O,,,5,1,4,0,4
40617_0,,,,2,3,2,5
40619_0,,,,2,3,2,5
C(C(CO)(C(C(CO)CO)O)O)=O,,,5,1,3,0,3
40621_0,,,,2,3,2,5
C(C)(C(C(C)O)(C(CCO)O)O)=O,,,5,1,5,0,5
40623_0,,,,2,3,2,5
C(C(C(C)O)(C(C)(CCO)O)O)=O,,,5,1,3,0,3
40624_0,,,,2,3,2,5
40625_0,,,,2,3,2,5
40626_0,,,,2,3,2,5
40627_0,,,,2,3,2,5
40628_0,,,,2,3,2,5
40629_0,,,,2,3,2,5
40630_0,,,,2,3,2,5
40631_0,,,,2,3,2,5
40633_0,,,,2,3,2,5
C(C(CO)(C(C)(CCO)O)O)=O,,,5,1,3,0,3
40634_0,,,,2,3,2,5
40635_0,,,,2,3,2,5
40636_0,,,,2,3,2,5
40637_0,,,,2,3,2,5
40638_0,,,,2,3,2,5
40639_0,,,,2,3,2,5
40640_0,,,,2,3,2,5
40642_0,,,,2,3,2,5
CC(C(CO)(C(CCO)O)O)O,,,5,1,3,0,3
40643_0,,,,2,3,2,5
40644_0,,,,2,3,2,5
40645_0,,,,2,3,2,5
40647_0,,,,2,3,2,5
C(C(C(C(C)(CCO)O)O)O)(O)=O,,,5,1,2,0,2
40649_0,,,,2,3,2,5
C(C(C)(C(C(CO)CO)O)O)(O)=O,,,5,1,2,0,2
40651_0,,,,2,3,2,5
C(C(C(CC(CCO)O)O)O)(O)=O,,,5,1,2,0,2
40653_0,,,,2,3,2,5
C(C(CO)C(C(C(O)=O)O)O)(O)=O,,,5,1,5,0,5
40655_0,,,,2,3,2,5
C(C(C(C(CO)C(C)O)O)O)(O)=O,,,5,1,2,0,2
40657_0,,,,2,3,2,5
C(C(C(C(CO)CO)O)O)(O)=O,,,5,1,2,0,2
40659_0,,,,2,3,2,5
C(CC(C(CCO)O)(C(C)O)O)=O,,,5,1,1,0,1
40660_0,,,,2,3,2,5
40662_0,,,,2,3,2,5
C(C(C(C)O)(CC(CCO)O)O)=O,,,5,1,2,0,2
40663_0,,,,2,3,2,5
40664_0,,,,2,3,2,5
40665_0,,,,2,3,2,5
40666_0,,,,2,3,2,5
40667_0,,,,2,3,2,5
40668_0,,,,2,3,2,5
40669_0,,,,2,3,2,5
40670_0,,,,2,3,2,5
40671_0,,,,2,3,2,5
40672_0,,,,2,3,2,5
40673_0,,,,2,3,2,5
40674_0,,,,2,3,2,5
40675_0,,,,2,3,2,5
40676_0,,,,2,3,2,5
40677_0,,,,2,3,2,5
40678_0,,,,2,3,2,5
40679_0,,,,2,3,2,5
40680_0,,,,2,3,2,5
40681_0,,,,2,3,2,5
40682_0,,,,2,3,2,5
40683_0,,,,2,3,2,5
40684_0,,,,2,3,2,5
40685_0,,,,2,3,2,5
40686_0,,,,2,3,2,5
40687_0,,,,2,3,2,5
40688_0,,,,2,3,2,5
40689_0,,,,2,3,2,5
40690_0,,,,2,3,2,5
40691_0,,,,2,3,2,5
40692_0,,,,2,3,2,5
40693_0,,,,2,3,2,5
40694_0,,,,2,3,2,5
40695_0,,,,2,3,2,5
40696_0,,,,2,3,2,5
40697_0,,,,2,3,2,5
40698_0,,,,2,3,2,5
40699_0,,,,2,3,2,5
40700_0,,,,2,3,2,5
40701_0,,,,2,3,2,5
40702_0,,,,2,3,2,5
40703_0,,,,2,3,2,5
40704_0,,,,2,3,2,5
40705_0,,,,2,3,2,5
40706_0,,,,2,3,2,5
40707_0,,,,2,3,2,5
40708_0,,,,2,3,2,5
40709_0,,,,2,3,2,5
40710_0,,,,2,3,2,5
40711_0,,,,2,3,2,5
40712_0,,,,2,3,2,5
40713_0,,,,2,3,2,5
40714_0,,,,2,3,2,5
40715_0,,,,2,3,2,5
40716_0,,,,2,3,2,5
40717_0,,,,2,3,2,5
40718_0,,,,2,3,2,5
40719_0,,,,2,3,2,5
40720_0,,,,2,3,2,5
40721_0,,,,2,3,2,5
40722_0,,,,2,3,2,5
40723_0,,,,2,3,2,5
40724_0,,,,2,3,2,5
40725_0,,,,2,3,2,5
40726_0,,,,2,3,2,5
40727_0,,,,2,3,2,5
40728_0,,,,2,3,2,5
40729_0,,,,2,3,2,5
40730_0,,,,2,3,2,5
40731_0,,,,2,3,2,5
40732_0,,,,2,3,2,5
40733_0,,,,2,3,2,5
40734_0,,,,2,3,2,5
40735_0,,,,2,3,2,5
40736_0,,,,2,3,2,5
40738_0,,,,2,3,2,5
C(C(CCO)(CC(CO)O)O)(O)=O,,,5,1,1,0,1
40739_0,,,,2,3,2,5
40741_0,,,,2,3,2,5
C(CC(CCO)(C(CO)O)O)(O)=O,,,5,1,1,0,1
40743_0,,,,2,3,2,5
C(C(C(CCO)(CCO)O)O)(O)=O,,,5,1,1,0,1
40744_0,,,,2,3,2,5
40745_0,,,,2,3,2,5
40746_0,,,,2,3,2,5
40747_0,,,,2,3,2,5
40748_0,,,,2,3,2,5
40749_0,,,,2,3,2,5
40750_0,,,,2,3,2,5
40751_0,,,,2,3,2,5
40752_0,,,,2,3,2,5
40753_0,,,,2,3,2,5
40754_0,,,,2,3,2,5
40755_0,,,,2,3,2,5
40756_0,,,,2,3,2,5
40757_0,,,,2,3,2,5
40758_0,,,,2,3,2,5
40759_0,,,,2,3,2,5
40760_0,,,,2,3,2,5
40761_0,,,,2,3,2,5
40762_0,,,,2,3,2,5
40763_0,,,,2,3,2,5
40764_0,,,,2,3,2,5
40765_0,,,,2,3,2,5
40766_0,,,,2,3,2,5
40767_0,,,,2,3,2,5
40768_0,,,,2,3,2,5
40769_0,,,,2,3,2,5
40770_0,,,,2,3,2,5
40771_0,,,,2,3,2,5
40772_0,,,,2,3,2,5
40773_0,,,,2,3,2,5
40774_0,,,,2,3,2,5
40775_0,,,,2,3,2,5
40776_0,,,,2,3,2,5
40777_0,,,,2,3,2,5
40778_0,,,,2,3,2,5
40779_0,,,,2,3,2,5
40781_0,,,,2,3,2,5
C1C(C(CO1)(CCO)O)O,,,5,1,1,0,1
40782_0,,,,2,3,2,5
40784_0,,,,2,3,2,5
C1C(C(CO1)O)(C(CO)O)O,,,5,1,2,0,2
40785_0,,,,2,3,2,5
40786_0,,,,2,3,2,5
40787_0,,,,2,3,2,5
40788_0,,,,2,3,2,5
40789_0,,,,2,3,2,5
40790_0,,,,2,3,2,5
40791_0,,,,2,3,2,5
40792_0,,,,2,3,2,5
40794_0,,,,2,3,2,5
C1CC(C(O)O1)(CCO)O,,,5,1,2,0,2
40795_0,,,,2,3,2,5
40797_0,,,,2,3,2,5
C1CC(C(O)O1)(C(CO)O)O,,,5,1,3,0,3
40798_0,,,,2,3,2,5
40799_0,,,,2,3,2,5
40800_0,,,,2,3,2,5
40801_0,,,,2,3,2,5
40802_0,,,,2,3,2,5
40803_0,,,,2,3,2,5
40804_0,,,,2,3,2,5
40805_0,,,,2,3,2,5
40807_0,,,,2,3,2,5
C1C(CC(O)O1)(CCO)O,,,5,1,2,0,2
40808_0,,,,2,3,2,5
40809_0,,,,2,3,2,5
40810_0,,,,2,3,2,5
40811_0,,,,2,3,2,5
40812_0,,,,2,3,2,5
40813_0,,,,2,3,2,5
40814_0,,,,2,3,2,5
40815_0,,,,2,3,2,5
40816_0,,,,2,3,2,5
40817_0,,,,2,3,2,5
40818_0,,,,2,3,2,5
40819_0,,,,2,3,2,5
40820_0,,,,2,3,2,5
40821_0,,,,2,3,2,5
40822_0,,,,2,3,2,5
40823_0,,,,2,3,2,5
40824_0,,,,2,3,2,5
40825_0,,,,2,3,2,5
40827_0,,,,2,3,2,5
C(C(C(C)=O)(CCO)O)=O,,,5,1,3,0,3
40828_0,,,,2,3,2,5
40829_0,,,,2,3,2,5
40830_0,,,,2,3,2,5
40831_0,,,,2,3,2,5
40832_0,,,,2,3,2,5
40833_0,,,,2,3,2,5
40834_0,,,,2,3,2,5
40835_0,,,,2,3,2,5
40836_0,,,,2,3,2,5
40837_0,,,,2,3,2,5
40838_0,,,,2,3,2,5
40839_0,,,,2,3,2,5
40841_0,,,,2,3,2,5
C(C(C(C)(CCO)O)=O)=O,,,5,1,2,0,2
40842_0,,,,2,3,2,5
40843_0,,,,2,3,2,5
40844_0,,,,2,3,2,5
40845_0,,,,2,3,2,5
40846_0,,,,2,3,2,5
40847_0,,,,2,3,2,5
40848_0,,,,2,3,2,5
40849_0,,,,2,3,2,5
40850_0,,,,2,3,2,5
40851_0,,,,2,3,2,5
40852_0,,,,2,3,2,5
40853_0,,,,2,3,2,5
40854_0,,,,2,3,2,5
40855_0,,,,2,3,2,5
40856_0,,,,2,3,2,5
40857_0,,,,2,3,2,5
40858_0,,,,2,3,2,5
40859_0,,,,2,3,2,5
40860_0,,,,2,3,2,5
40861_0,,,,2,3,2,5
40862_0,,,,2,3,2,5
40863_0,,,,2,3,2,5
40864_0,,,,2,3,2,5
40865_0,,,,2,3,2,5
40866_0,,,,2,3,2,5
40867_0,,,,2,3,2,5
40868_0,,,,2,3,2,5
40869_0,,,,2,3,2,5
40870_0,,,,2,3,2,5
40871_0,,,,2,3,2,5
40872_0,,,,2,3,2,5
40873_0,,,,2,3,2,5
40874_0,,,,2,3,2,5
40875_0,,,,2,3,2,5
40876_0,,,,2,3,2,5
40877_0,,,,2,3,2,5
40878_0,,,,2,3,2,5
40879_0,,,,2,3,2,5
40880_0,,,,2,3,2,5
40881_0,,,,2,3,2,5
40882_0,,,,2,3,2,5
40883_0,,,,2,3,2,5
40884_0,,,,2,3,2,5
40885_0,,,,2,3,2,5
40886_0,,,,2,3,2,5
40888_0,,,,2,3,2,5
C(C(C=C)(CCO)O)=O,,,5,1,3,0,3
40889_0,,,,2,3,2,5
40890_0,,,,2,3,2,5
40891_0,,,,2,3,2,5
40892_0,,,,2,3,2,5
40893_0,,,,2,3,2,5
40894_0,,,,2,3,2,5
40895_0,,,,2,3,2,5
40896_0,,,,2,3,2,5
40897_0,,,,2,3,2,5
40898_0,,,,2,3,2,5
40899_0,,,,2,3,2,5
40900_0,,,,2,3,2,5
40901_0,,,,2,3,2,5
40903_0,,,,2,3,2,5
C=CC(C(CCO)O)=O,,,5,1,2,0,2
40904_0,,,,2,3,2,5
40905_0,,,,2,3,2,5
40906_0,,,,2,3,2,5
40907_0,,,,2,3,2,5
40908_0,,,,2,3,2,5
40909_0,,,,2,3,2,5
40910_0,,,,2,3,2,5
40911_0,,,,2,3,2,5
40912_0,,,,2,3,2,5
40913_0,,,,2,3,2,5
40914_0,,,,2,3,2,5
40915_0,,,,2,3,2,5
40916_0,,,,2,3,2,5
40917_0,,,,2,3,2,5
40918_0,,,,2,3,2,5
40919_0,,,,2,3,2,5
40920_0,,,,2,3,2,5
40921_0,,,,2,3,2,5
40923_0,,,,2,3,2,5
C(C(CCO)O)=CC=O,,,5,1,4,0,4
40924_0,,,,2,3,2,5
40925_0,,,,2,3,2,5
40926_0,,,,2,3,2,5
40927_0,,,,2,3,2,5
40928_0,,,,2,3,2,5
40930_0,,,,2,3,2,5
C1C(C(C(O)O1)O)(C(CCO)O)O,,,5,1,3,0,3
40931_0,,,,2,3,2,5
40932_0,,,,2,3,2,5
40934_0,,,,2,3,2,5
C1C(C(C(O)O1)(CCO)O)O,,,5,1,2,0,2
40935_0,,,,2,3,2,5
40936_0,,,,2,3,2,5
40937_0,,,,2,3,2,5
40938_0,,,,2,3,2,5
40939_0,,,,2,3,2,5
40940_0,,,,2,3,2,5
40941_0,,,,2,3,2,5
40942_0,,,,2,3,2,5
40943_0,,,,2,3,2,5
40944_0,,,,2,3,2,5
40945_0,,,,2,3,2,5
40946_0,,,,2,3,2,5
40947_0,,,,2,3,2,5
40948_0,,,,2,3,2,5
40949_0,,,,2,3,2,5
40951_0,,,,2,3,2,5
C(CC(C(O)O)O)O,,,5,1,1,0,1
40952_0,,,,2,3,2,5
40954_0,,,,2,3,2,5
C(C(C(C(O)O)O)O)O,,,5,1,2,0,2
40955_0,,,,2,3,2,5
40956_0,,,,2,3,2,5
40957_0,,,,2,3,2,5
40958_0,,,,2,3,2,5
40959_0,,,,2,3,2,5
40960_0,,,,2,3,2,5
40961_0,,,,2,3,2,5
40962_0,,,,2,3,2,5
40964_0,,,,2,3,2,5
CC(C(CCO)O)O,,,5,1,1,0,1
40965_0,,,,2,3,2,5
40967_0,,,,2,3,2,5
CC(C(C(CO)O)O)O,,,5,1,4,0,4
40968_0,,,,2,3,2,5
40969_0,,,,2,3,2,5
40970_0,,,,2,3,2,5
40971_0,,,,2,3,2,5
40972_0,,,,2,3,2,5
40973_0,,,,2,3,2,5
40974_0,,,,2,3,2,5
40975_0,,,,2,3,2,5
40976_0,,,,2,3,2,5
40977_0,,,,2,3,2,5
40978_0,,,,2,3,2,5
40979_0,,,,2,3,2,5
40980_0,,,,2,3,2,5
40981_0,,,,2,3,2,5
40982_0,,,,2,3,2,5
40983_0,,,,2,3,2,5
40984_0,,,,2,3,2,5
40985_0,,,,2,3,2,5
40986_0,,,,2,3,2,5
40987_0,,,,2,3,2,5
40988_0,,,,2,3,2,5
40989_0,,,,2,3,2,5
40990_0,,,,2,3,2,5
40991_0,,,,2,3,2,5
40992_0,,,,2,3,2,5
40993_0,,,,2,3,2,5
40994_0,,,,2,3,2,5
40995_0,,,,2,3,2,5
40996_0,,,,2,3,2,5
40997_0,,,,2,3,2,5
40998_0,,,,2,3,2,5
40999_0,,,,2,3,2,5
41000_0,,,,2,3,2,5
41001_0,,,,2,3,2,5
41002_0,,,,2,3,2,5
41003_0,,,,2,3,2,5
41004_0,,,,2,3,2,5
41005_0,,,,2,3,2,5
41006_0,,,,2,3,2,5
41007_0,,,,2,3,2,5
41008_0,,,,2,3,2,5
41009_0,,,,2,3,2,5
41010_0,,,,2,3,2,5
41011_0,,,,2,3,2,5
41012_0,,,,2,3,2,5
41013_0,,,,2,3,2,5
41014_0,,,,2,3,2,5
41015_0,,,,2,3,2,5
41016_0,,,,2,3,2,5
41017_0,,,,2,3,2,5
41018_0,,,,2,3,2,5
41019_0,,,,2,3,2,5
41020_0,,,,2,3,2,5
41021_0,,,,2,3,2,5
41022_0,,,,2,3,2,5
41023_0,,,,2,3,2,5
41024_0,,,,2,3,2,5
41025_0,,,,2,3,2,5
41026_0,,,,2,3,2,5
41027_0,,,,2,3,2,5
41028_0,,,,2,3,2,5
41029_0,,,,2,3,2,5
41030_0,,,,2,3,2,5
41031_0,,,,2,3,2,5
41032_0,,,,2,3,2,5
41033_0,,,,2,3,2,5
41034_0,,,,2,3,2,5
41035_0,,,,2,3,2,5
41036_0,,,,2,3,2,5
41037_0,,,,2,3,2,5
41038_0,,,,2,3,2,5
41039_0,,,,2,3,2,5
41040_0,,,,2,3,2,5
41041_0,,,,2,3,2,5
41042_0,,,,2,3,2,5
41043_0,,,,2,3,2,5
41044_0,,,,2,3,2,5
41045_0,,,,2,3,2,5
41046_0,,,,2,3,2,5
41047_0,,,,2,3,2,5
41048_0,,,,2,3,2,5
41049_0,,,,2,3,2,5
41050_0,,,,2,3,2,5
41051_0,,,,2,3,2,5
41052_0,,,,2,3,2,5
41053_0,,,,2,3,2,5
41054_0,,,,2,3,2,5
41055_0,,,,2,3,2,5
41056_0,,,,2,3,2,5
41057_0,,,,2,3,2,5
41058_0,,,,2,3,2,5
41059_0,,,,2,3,2,5
41060_0,,,,2,3,2,5
41061_0,,,,2,3,2,5
41062_0,,,,2,3,2,5
41063_0,,,,2,3,2,5
41064_0,,,,2,3,2,5
41066_0,,,,2,3,2,5
C(C(COC(CO)O)O)=O,,,5,1,1,0,1
41068_0,,,,2,3,2,5
C(C(O)OCC(CO)O)=O,,,5,1,1,0,1
41070_0,,,,2,3,2,5
C(C(C(CO)OC(CO)O)O)=O,,,5,1,1,0,1
41072_0,,,,2,3,2,5
C(C(O)OC(CO)C(CO)O)=O,,,5,1,1,0,1
41074_0,,,,2,3,2,5
C(C(C(COC(CO)O)O)O)=O,,,5,1,1,0,1
41076_0,,,,2,3,2,5
C(C(O)OCC(C(CO)O)O)=O,,,5,1,1,0,1
41078_0,,,,2,3,2,5
C(COC(C(C(CO)O)O)O)=O,,,5,1,1,0,1
41080_0,,,,2,3,2,5
C(C(C(C(O)OCCO)O)O)=O,,,5,1,1,0,1
41081_0,,,,2,3,2,5
41082_0,,,,2,3,2,5
41083_0,,,,2,3,2,5
41084_0,,,,2,3,2,5
41085_0,,,,2,3,2,5
41086_0,,,,2,3,2,5
41087_0,,,,2,3,2,5
41088_0,,,,2,3,2,5
41089_0,,,,2,3,2,5
41090_0,,,,2,3,2,5
41091_0,,,,2,3,2,5
41092_0,,,,2,3,2,5
41093_0,,,,2,3,2,5
41094_0,,,,2,3,2,5
41095_0,,,,2,3,2,5
41096_0,,,,2,3,2,5
41097_0,,,,2,3,2,5
41098_0,,,,2,3,2,5
41099_0,,,,2,3,2,5
41100_0,,,,2,3,2,5
41101_0,,,,2,3,2,5
41102_0,,,,2,3,2,5
41103_0,,,,2,3,2,5
41104_0,,,,2,3,2,5
41105_0,,,,2,3,2,5
41106_0,,,,2,3,2,5
41107_0,,,,2,3,2,5
41108_0,,,,2,3,2,5
41109_0,,,,2,3,2,5
41110_0,,,,2,3,2,5
41111_0,,,,2,3,2,5
41112_0,,,,2,3,2,5
41113_0,,,,2,3,2,5
41114_0,,,,2,3,2,5
41115_0,,,,2,3,2,5
41116_0,,,,2,3,2,5
41117_0,,,,2,3,2,5
41118_0,,,,2,3,2,5
41119_0,,,,2,3,2,5
41120_0,,,,2,3,2,5
41121_0,,,,2,3,2,5
41122_0,,,,2,3,2,5
41123_0,,,,2,3,2,5
41124_0,,,,2,3,2,5
41125_0,,,,2,3,2,5
41126_0,,,,2,3,2,5
41127_0,,,,2,3,2,5
41128_0,,,,2,3,2,5
41129_0,,,,2,3,2,5
41130_0,,,,2,3,2,5
41131_0,,,,2,3,2,5
41132_0,,,,2,3,2,5
41133_0,,,,2,3,2,5
41134_0,,,,2,3,2,5
41135_0,,,,2,3,2,5
41136_0,,,,2,3,2,5
41137_0,,,,2,3,2,5
41138_0,,,,2,3,2,5
41139_0,,,,2,3,2,5
41140_0,,,,2,3,2,5
41141_0,,,,2,3,2,5
41142_0,,,,2,3,2,5
41143_0,,,,2,3,2,5
41144_0,,,,2,3,2,5
41145_0,,,,2,3,2,5
41146_0,,,,2,3,2,5
41147_0,,,,2,3,2,5
41148_0,,,,2,3,2,5
41149_0,,,,2,3,2,5
41150_0,,,,2,3,2,5
41151_0,,,,2,3,2,5
41152_0,,,,2,3,2,5
41153_0,,,,2,3,2,5
41154_0,,,,2,3,2,5
41155_0,,,,2,3,2,5
41156_0,,,,2,3,2,5
41157_0,,,,2,3,2,5
41158_0,,,,2,3,2,5
41159_0,,,,2,3,2,5
41160_0,,,,2,3,2,5
41161_0,,,,2,3,2,5
41162_0,,,,2,3,2,5
41163_0,,,,2,3,2,5
41164_0,,,,2,3,2,5
41165_0,,,,2,3,2,5
41166_0,,,,2,3,2,5
41167_0,,,,2,3,2,5
41168_0,,,,2,3,2,5
41169_0,,,,2,3,2,5
41170_0,,,,2,3,2,5
41171_0,,,,2,3,2,5
41172_0,,,,2,3,2,5
41173_0,,,,2,3,2,5
41174_0,,,,2,3,2,5
41175_0,,,,2,3,2,5
41176_0,,,,2,3,2,5
41177_0,,,,2,3,2,5
41178_0,,,,2,3,2,5
41179_0,,,,2,3,2,5
41180_0,,,,2,3,2,5
41181_0,,,,2,3,2,5
41182_0,,,,2,3,2,5
41183_0,,,,2,3,2,5
41184_0,,,,2,3,2,5
41185_0,,,,2,3,2,5
41186_0,,,,2,3,2,5
41187_0,,,,2,3,2,5
41188_0,,,,2,3,2,5
41189_0,,,,2,3,2,5
41190_0,,,,2,3,2,5
41191_0,,,,2,3,2,5
41192_0,,,,2,3,2,5
41193_0,,,,2,3,2,5
41194_0,,,,2,3,2,5
41195_0,,,,2,3,2,5
41197_0,,,,2,3,2,5
C(C(CO)(CC(CO)O)O)=O,,,5,1,2,0,2
41198_0,,,,2,3,2,5
41199_0,,,,2,3,2,5
41200_0,,,,2,3,2,5
41201_0,,,,2,3,2,5
41202_0,,,,2,3,2,5
41203_0,,,,2,3,2,5
41204_0,,,,2,3,2,5
41205_0,,,,2,3,2,5
41206_0,,,,2,3,2,5
41207_0,,,,2,3,2,5
41208_0,,,,2,3,2,5
41209_0,,,,2,3,2,5
41210_0,,,,2,3,2,5
41211_0,,,,2,3,2,5
41212_0,,,,2,3,2,5
41213_0,,,,2,3,2,5
41214_0,,,,2,3,2,5
41215_0,,,,2,3,2,5
41216_0,,,,2,3,2,5
41217_0,,,,2,3,2,5
41218_0,,,,2,3,2,5
41219_0,,,,2,3,2,5
41220_0,,,,2,3,2,5
41221_0,,,,2,3,2,5
41222_0,,,,2,3,2,5
41223_0,,,,2,3,2,5
41224_0,,,,2,3,2,5
41226_0,,,,2,3,2,5
CC(C(CO)(C(CO)(CO)O)O)O,,,5,1,3,0,3
41227_0,,,,2,3,2,5
41228_0,,,,2,3,2,5
41229_0,,,,2,3,2,5
41230_0,,,,2,3,2,5
41232_0,,,,2,3,2,5
CC(CO)(C(CO)(CO)O)O,,,5,1,3,0,3
41233_0,,,,2,3,2,5
41235_0,,,,2,3,2,5
CC(CO)(C(CO)(C(CO)O)O)O,,,5,1,5,0,5
41236_0,,,,2,3,2,5
41237_0,,,,2,3,2,5
41238_0,,,,2,3,2,5
41239_0,,,,2,3,2,5
41240_0,,,,2,3,2,5
41241_0,,,,2,3,2,5
41242_0,,,,2,3,2,5
41244_0,,,,2,3,2,5
C(C(CC(C(CO)(CO)O)O)O)O,,,5,1,3,0,3
41245_0,,,,2,3,2,5
41246_0,,,,2,3,2,5
41248_0,,,,2,3,2,5
CC(C(CO)O)(C(CO)(CO)O)O,,,5,1,3,0,3
41249_0,,,,2,3,2,5
41250_0,,,,2,3,2,5
41252_0,,,,2,3,2,5
C(CC(CO)(C(C)(CO)O)O)=O,,,5,1,2,0,2
41253_0,,,,2,3,2,5
41254_0,,,,2,3,2,5
41255_0,,,,2,3,2,5
41256_0,,,,2,3,2,5
41257_0,,,,2,3,2,5
41258_0,,,,2,3,2,5
41259_0,,,,2,3,2,5
41260_0,,,,2,3,2,5
41262_0,,,,2,3,2,5
CC(C(CO)(CCO)O)O,,,5,1,2,0,2
41263_0,,,,2,3,2,5
41264_0,,,,2,3,2,5
41266_0,,,,2,3,2,5
C(CO)=CCO,,,5,1,3,0,3
41267_0,,,,2,3,2,5
41269_0,,,,2,3,2,5
C(C(C(CO)O)C(C=O)(C)O)(O)=O,,,5,1,5,0,5
41270_0,,,,2,3,2,5
41272_0,,,,2,3,2,5
C(CC(C)(CO)O)(O)=O,,,5,1,3,0,3
41274_0,,,,2,3,2,5
C(C(C(CO)O)C(C(C)=O)O)(O)=O,,,5,1,5,0,5
41275_0,,,,2,3,2,5
41276_0,,,,2,3,2,5
41277_0,,,,2,3,2,5
41279_0,,,,2,3,2,5
C(CC(CC(CO)O)O)(O)=O,,,5,1,2,0,2
41281_0,,,,2,3,2,5
C(C(C(CO)O)C(C)O)(O)=O,,,5,1,5,0,5
41282_0,,,,2,3,2,5
41283_0,,,,2,3,2,5
41285_0,,,,2,3,2,5
C(C(C(CO)O)C(CO)O)(O)=O,,,5,1,5,0,5
41287_0,,,,2,3,2,5
C(CC(C)(C(CO)O)O)(O)=O,,,5,1,2,0,2
41288_0,,,,2,3,2,5
41289_0,,,,2,3,2,5
41290_0,,,,2,3,2,5
41291_0,,,,2,3,2,5
41292_0,,,,2,3,2,5
41293_0,,,,2,3,2,5
41294_0,,,,2,3,2,5
41295_0,,,,2,3,2,5
41296_0,,,,2,3,2,5
41297_0,,,,2,3,2,5
41298_0,,,,2,3,2,5
41299_0,,,,2,3,2,5
41300_0,,,,2,3,2,5
41301_0,,,,2,3,2,5
41302_0,,,,2,3,2,5
41303_0,,,,2,3,2,5
41304_0,,,,2,3,2,5
41305_0,,,,2,3,2,5
41306_0,,,,2,3,2,5
41307_0,,,,2,3,2,5
41308_0,,,,2,3,2,5
41309_0,,,,2,3,2,5
41310_0,,,,2,3,2,5
41311_0,,,,2,3,2,5
41313_0,,,,2,3,2,5
C(CC(CO)(C(C)O)O)(O)=O,,,5,1,2,0,2
41314_0,,,,2,3,2,5
41315_0,,,,2,3,2,5
41316_0,,,,2,3,2,5
41317_0,,,,2,3,2,5
41319_0,,,,2,3,2,5
C(C1(C(C(CC1(CO)O)O)O)O)=O,,,5,1,5,0,5
41320_0,,,,2,3,2,5
41322_0,,,,2,3,2,5
C(C1(CO)C(C(C(C1O)O)O)O)=O,,,5,1,3,0,3
41324_0,,,,2,3,2,5
C(C1(C(C(CC1O)O)O)O)O,,,5,1,3,0,3
41326_0,,,,2,3,2,5
C(C1(C(C(C(C1O)O)O)O)O)O,,,5,1,6,0,6
41328_0,,,,2,3,2,5
C(C1(C(CC(C1(CO)O)O)O)O)O,,,5,1,1,0,1
41329_0,,,,2,3,2,5
41331_0,,,,2,3,2,5
C(C1(CO)C(C(CC1O)O)O)=O,,,5,1,4,0,4
41332_0,,,,2,3,2,5
41333_0,,,,2,3,2,5
41334_0,,,,2,3,2,5
41336_0,,,,2,3,2,5
C(C(CO)(CO)C(CO)(CO)O)=O,,,5,1,3,0,3
41337_0,,,,2,3,2,5
41338_0,,,,2,3,2,5
41339_0,,,,2,3,2,5
41340_0,,,,2,3,2,5
41341_0,,,,2,3,2,5
41342_0,,,,2,3,2,5
41344_0,,,,2,3,2,5
C(C(C=O)(CO)C(C=O)(C)O)(O)=O,,,5,1,5,0,5
41346_0,,,,2,3,2,5
C(C(C=O)(C=O)C(C)(CO)O)(O)=O,,,5,1,3,0,3
41348_0,,,,2,3,2,5
C(C(CO)(C(C)O)C(C=O)(C)O)=O,,,5,1,4,0,4
41349_0,,,,2,3,2,5
41351_0,,,,2,3,2,5
C(C(CO)(CO)C(C=O)(C)O)=O,,,5,1,3,0,3
41352_0,,,,2,3,2,5
41353_0,,,,2,3,2,5
41355_0,,,,2,3,2,5
C(C(C=O)(C(CO)(C)O)O)(O)=O,,,5,1,6,0,6
41357_0,,,,2,3,2,5
C(C(C)(C(CO)(C(C)O)O)O)=O,,,5,1,3,0,3
41358_0,,,,2,3,2,5
41360_0,,,,2,3,2,5
C(C(C=O)(CO)C(C(C)=O)O)(O)=O,,,5,1,5,0,5
41362_0,,,,2,3,2,5
C(C(CO)(C(C)O)C(C(C)=O)O)=O,,,5,1,4,0,4
41364_0,,,,2,3,2,5
C(C(CO)(CO)C(C(C)=O)O)=O,,,5,1,3,0,3
41365_0,,,,2,3,2,5
41366_0,,,,2,3,2,5
41368_0,,,,2,3,2,5
C(C)(C(C(CO)O)(C(C)O)O)=O,,,5,1,6,0,6
41370_0,,,,2,3,2,5
C(C)(C(C(CO)O)(C(CO)O)O)=O,,,5,1,4,0,4
41371_0,,,,2,3,2,5
41373_0,,,,2,3,2,5
C(C(C=O)(C=O)C(CCO)O)(O)=O,,,5,1,3,0,3
41374_0,,,,2,3,2,5
41375_0,,,,2,3,2,5
41376_0,,,,2,3,2,5
41377_0,,,,2,3,2,5
41378_0,,,,2,3,2,5
41380_0,,,,2,3,2,5
C(C(C=O)(C(CCO)O)O)(O)=O,,,5,1,6,0,6
41381_0,,,,2,3,2,5
41382_0,,,,2,3,2,5
41384_0,,,,2,3,2,5
C(C(CO)(C(C)O)C(CCO)O)=O,,,5,1,4,0,4
41386_0,,,,2,3,2,5
C(C(CO)(C(C)O)C(C)(CO)O)=O,,,5,1,4,0,4
41388_0,,,,2,3,2,5
C(C(C=O)(CO)C(C)O)(O)=O,,,5,1,5,0,5
41390_0,,,,2,3,2,5
C(C(CO)(C(C(O)O)O)C(C)O)=O,,,5,1,4,0,4
41392_0,,,,2,3,2,5
C(C(CO)(C(C)O)C(C(C)O)O)=O,,,5,1,4,0,4
41393_0,,,,2,3,2,5
41394_0,,,,2,3,2,5
41396_0,,,,2,3,2,5
C(C(CO)(C(C)O)C(C)O)=O,,,5,1,3,0,3
41398_0,,,,2,3,2,5
C(C(CO)(CO)C(C)O)=O,,,5,1,3,0,3
41400_0,,,,2,3,2,5
C(C(CO)(C(CO)O)C(C)O)=O,,,5,1,5,0,5
41401_0,,,,2,3,2,5
41403_0,,,,2,3,2,5
C(C(CO)(CO)C(C=O)(CO)O)=O,,,5,1,4,0,4
41404_0,,,,2,3,2,5
41406_0,,,,2,3,2,5
C(C(CO)(CO)C(C(CO)O)O)=O,,,5,1,3,0,3
41407_0,,,,2,3,2,5
41408_0,,,,2,3,2,5
41409_0,,,,2,3,2,5
41410_0,,,,2,3,2,5
41411_0,,,,2,3,2,5
41412_0,,,,2,3,2,5
41413_0,,,,2,3,2,5
41414_0,,,,2,3,2,5
41416_0,,,,2,3,2,5
C(C(CO)(CO)C(CC(C)O)O)=O,,,5,1,3,0,3
41418_0,,,,2,3,2,5
C(C(CO)(CO)C(CCO)O)=O,,,5,1,3,0,3
41419_0,,,,2,3,2,5
41420_0,,,,2,3,2,5
41422_0,,,,2,3,2,5
C(C(CO)(CO)C(C)(CO)O)=O,,,5,1,3,0,3
41424_0,,,,2,3,2,5
C(C(CO)(CO)C(C(O)=O)(C)O)=O,,,5,1,3,0,3
41426_0,,,,2,3,2,5
C(C(CO)(CO)C(CC(O)=O)O)=O,,,5,1,3,0,3
41428_0,,,,2,3,2,5
C(C(C=O)(CO)C(C=C)(CO)O)=O,,,5,1,2,0,2
41430_0,,,,2,3,2,5
C(C(C=C)(C(C=O)(CO)CO)O)=O,,,5,1,3,0,3
41432_0,,,,2,3,2,5
C(C(CO)(CO)C(C(C=C)=O)O)=O,,,5,1,3,0,3
41434_0,,,,2,3,2,5
C(C(C=O)(CO)C(C=CCO)O)=O,,,5,1,2,0,2
41436_0,,,,2,3,2,5
C(C(CO)(CO)C(C=CC=O)O)=O,,,5,1,3,0,3
41438_0,,,,2,3,2,5
C(C(C=O)(CO)CO)(O)=O,,,5,1,4,0,4
41440_0,,,,2,3,2,5
C(C(CO)(CO)C(C(O)O)O)=O,,,5,1,3,0,3
41442_0,,,,2,3,2,5
C(C(CO)(CO)C(C(C)O)O)=O,,,5,1,3,0,3
41444_0,,,,2,3,2,5
C(C(CO)(CO)CO)=O,,,5,1,2,0,2
41446_0,,,,2,3,2,5
C(C(CO)(CO)C(CO)O)=O,,,5,1,4,0,4
41447_0,,,,2,3,2,5
41449_0,,,,2,3,2,5
C(C(C=O)(C(C(CO)CO)O)O)=O,,,5,1,4,0,4
41451_0,,,,2,3,2,5
C(C(C=O)(CO)C(CO)O)(O)=O,,,5,1,6,0,6
41453_0,,,,2,3,2,5
C(C(CO)(C(CO)O)C(CO)O)=O,,,5,1,4,0,4
41454_0,,,,2,3,2,5
41456_0,,,,2,3,2,5
C(C(C(CO)=O)(CO)C(C)O)(O)=O,,,5,1,6,0,6
41458_0,,,,2,3,2,5
C(CO)(C(CO)(C(C)O)C(C)O)=O,,,5,1,3,0,3
41460_0,,,,2,3,2,5
C(CO)(C(CO)(CO)C(C)O)=O,,,5,1,4,0,4
41461_0,,,,2,3,2,5
41463_0,,,,2,3,2,5
C(CO)(C(CO)(CO)C(C=O)O)=O,,,5,1,4,0,4
41465_0,,,,2,3,2,5
C(C(C(CO)=O)(CO)CO)(O)=O,,,5,1,5,0,5
41467_0,,,,2,3,2,5
C(CO)(C(CO)(CO)CO)=O,,,5,1,3,0,3
41469_0,,,,2,3,2,5
C(CO)(C(CO)(CO)C(CO)O)=O,,,5,1,4,0,4
41471_0,,,,2,3,2,5
C(C(C=O)(C(CO)O)C(C)O)(O)=O,,,5,1,5,0,5
41473_0,,,,2,3,2,5
C(C(CO)(C(C)O)C(C=O)O)(O)=O,,,5,1,5,0,5
41475_0,,,,2,3,2,5
C(C(C(CO)O)(C(C)O)C(C)O)=O,,,5,1,3,0,3
41477_0,,,,2,3,2,5
C(C(C(CO)(C(C)O)C(C)O)O)=O,,,5,1,2,0,2
41478_0,,,,2,3,2,5
41480_0,,,,2,3,2,5
C(C(C(CO)(CO)C(C)O)O)=O,,,5,1,2,0,2
41481_0,,,,2,3,2,5
41483_0,,,,2,3,2,5
C(C(C(CO)(CO)C(C=O)O)O)=O,,,5,1,2,0,2
41484_0,,,,2,3,2,5
41486_0,,,,2,3,2,5
C(C(CO)(CO)C(C=O)O)(O)=O,,,5,1,4,0,4
41487_0,,,,2,3,2,5
41489_0,,,,2,3,2,5
C(C(C(CO)(CO)CO)O)=O,,,5,1,2,0,2
41490_0,,,,2,3,2,5
41492_0,,,,2,3,2,5
C(C(C(CO)(CO)C(CO)O)O)=O,,,5,1,2,0,2
41493_0,,,,2,3,2,5
41494_0,,,,2,3,2,5
41495_0,,,,2,3,2,5
41496_0,,,,2,3,2,5
41497_0,,,,2,3,2,5
41498_0,,,,2,3,2,5
41499_0,,,,2,3,2,5
41500_0,,,,2,3,2,5
41501_0,,,,2,3,2,5
41503_0,,,,2,3,2,5
C(CCO)(C(C(C)O)(C(C)O)O)=O,,,5,1,3,0,3
41504_0,,,,2,3,2,5
41505_0,,,,2,3,2,5
41506_0,,,,2,3,2,5
41507_0,,,,2,3,2,5
41508_0,,,,2,3,2,5
41509_0,,,,2,3,2,5
41511_0,,,,2,3,2,5
C(C(C=O)(C(C)(CCO)O)O)(O)=O,,,5,1,3,0,3
41512_0,,,,2,3,2,5
41513_0,,,,2,3,2,5
41514_0,,,,2,3,2,5
41516_0,,,,2,3,2,5
CC(CC(C(CO)(C(C)O)O)O)O,,,5,1,2,0,2
41517_0,,,,2,3,2,5
41519_0,,,,2,3,2,5
CC(CC(C(CO)(CO)O)O)O,,,5,1,2,0,2
41520_0,,,,2,3,2,5
41521_0,,,,2,3,2,5
41522_0,,,,2,3,2,5
41523_0,,,,2,3,2,5
41524_0,,,,2,3,2,5
41525_0,,,,2,3,2,5
41526_0,,,,2,3,2,5
41527_0,,,,2,3,2,5
41528_0,,,,2,3,2,5
41530_0,,,,2,3,2,5
CC(CO)(C(CO)(C(C)O)O)O,,,5,1,2,0,2
41532_0,,,,2,3,2,5
C(C(C)(C(CO)(C(C)O)O)O)(O)=O,,,5,1,3,0,3
41534_0,,,,2,3,2,5
C(CC(C(CO)(C(C)O)O)O)(O)=O,,,5,1,3,0,3
41536_0,,,,2,3,2,5
C(C(C(C)O)(C(C=C)(CO)O)O)=O,,,5,1,3,0,3
41538_0,,,,2,3,2,5
C(C(C=C)(C(CO)(C(C)O)O)O)=O,,,5,1,3,0,3
41539_0,,,,2,3,2,5
41541_0,,,,2,3,2,5
C(C(C(C)O)(C(C=CCO)O)O)=O,,,5,1,3,0,3
41543_0,,,,2,3,2,5
C(C(C(CO)(C(C)O)O)O)=CC=O,,,5,1,2,0,2
41544_0,,,,2,3,2,5
41546_0,,,,2,3,2,5
CC(C(CO)(C(C(O)O)O)O)O,,,5,1,2,0,2
41548_0,,,,2,3,2,5
CC(C(C(CO)(C(C)O)O)O)O,,,5,1,2,0,2
41550_0,,,,2,3,2,5
CC(C(CO)(C(C)O)O)O,,,5,1,2,0,2
41551_0,,,,2,3,2,5
41553_0,,,,2,3,2,5
CC(C(C(C(CO)(CO)O)O)O)O,,,5,1,2,0,2
41554_0,,,,2,3,2,5
41555_0,,,,2,3,2,5
41556_0,,,,2,3,2,5
41557_0,,,,2,3,2,5
41559_0,,,,2,3,2,5
C(C(C(CO)O)C(CCO)O)(O)=O,,,5,1,3,0,3
41560_0,,,,2,3,2,5
41561_0,,,,2,3,2,5
41562_0,,,,2,3,2,5
41563_0,,,,2,3,2,5
41564_0,,,,2,3,2,5
41565_0,,,,2,3,2,5
41566_0,,,,2,3,2,5
41567_0,,,,2,3,2,5
41568_0,,,,2,3,2,5
41569_0,,,,2,3,2,5
41570_0,,,,2,3,2,5
41571_0,,,,2,3,2,5
41572_0,,,,2,3,2,5
41573_0,,,,2,3,2,5
41574_0,,,,2,3,2,5
41575_0,,,,2,3,2,5
41576_0,,,,2,3,2,5
41577_0,,,,2,3,2,5
41578_0,,,,2,3,2,5
41579_0,,,,2,3,2,5
41580_0,,,,2,3,2,5
41581_0,,,,2,3,2,5
41582_0,,,,2,3,2,5
41583_0,,,,2,3,2,5
41584_0,,,,2,3,2,5
41585_0,,,,2,3,2,5
41586_0,,,,2,3,2,5
41587_0,,,,2,3,2,5
41588_0,,,,2,3,2,5
41589_0,,,,2,3,2,5
41591_0,,,,2,3,2,5
C(C(C=O)(C(CO)(C(C)O)O)O)=O,,,5,1,3,0,3
41592_0,,,,2,3,2,5
41593_0,,,,2,3,2,5
41594_0,,,,2,3,2,5
41595_0,,,,2,3,2,5
41596_0,,,,2,3,2,5
41597_0,,,,2,3,2,5
41598_0,,,,2,3,2,5
41599_0,,,,2,3,2,5
41600_0,,,,2,3,2,5
41601_0,,,,2,3,2,5
41602_0,,,,2,3,2,5
41603_0,,,,2,3,2,5
41604_0,,,,2,3,2,5
41605_0,,,,2,3,2,5
41606_0,,,,2,3,2,5
41607_0,,,,2,3,2,5
41608_0,,,,2,3,2,5
41609_0,,,,2,3,2,5
41610_0,,,,2,3,2,5
41611_0,,,,2,3,2,5
41612_0,,,,2,3,2,5
41613_0,,,,2,3,2,5
41614_0,,,,2,3,2,5
41615_0,,,,2,3,2,5
41616_0,,,,2,3,2,5
41618_0,,,,2,3,2,5
C(C(C=O)(C(C=C)(CO)O)O)=O,,,5,1,4,0,4
41619_0,,,,2,3,2,5
41620_0,,,,2,3,2,5
41622_0,,,,2,3,2,5
C(C(C=O)(C(C=CCO)O)O)=O,,,5,1,5,0,5
41623_0,,,,2,3,2,5
41624_0,,,,2,3,2,5
41625_0,,,,2,3,2,5
41626_0,,,,2,3,2,5
41627_0,,,,2,3,2,5
41628_0,,,,2,3,2,5
41629_0,,,,2,3,2,5
41630_0,,,,2,3,2,5
41631_0,,,,2,3,2,5
41632_0,,,,2,3,2,5
41633_0,,,,2,3,2,5
41634_0,,,,2,3,2,5
41635_0,,,,2,3,2,5
41636_0,,,,2,3,2,5
41637_0,,,,2,3,2,5
41638_0,,,,2,3,2,5
41639_0,,,,2,3,2,5
41640_0,,,,2,3,2,5
41641_0,,,,2,3,2,5
41642_0,,,,2,3,2,5
41643_0,,,,2,3,2,5
41644_0,,,,2,3,2,5
41645_0,,,,2,3,2,5
41646_0,,,,2,3,2,5
41647_0,,,,2,3,2,5
41648_0,,,,2,3,2,5
41649_0,,,,2,3,2,5
41650_0,,,,2,3,2,5
41651_0,,,,2,3,2,5
41652_0,,,,2,3,2,5
41653_0,,,,2,3,2,5
41655_0,,,,2,3,2,5
C(C(C(CO)O)C(C)(CO)O)(O)=O,,,5,1,3,0,3
41657_0,,,,2,3,2,5
C(C)(C(CO)(C(C=C)(CO)O)O)=O,,,5,1,3,0,3
41659_0,,,,2,3,2,5
C(C)(C(CO)(C(C=CCO)O)O)=O,,,5,1,3,0,3
41661_0,,,,2,3,2,5
C(C(C(O)=O)C(CO)O)(O)=O,,,5,1,4,0,4
41663_0,,,,2,3,2,5
C(C(C(CO)O)C(C(O)O)O)(O)=O,,,5,1,3,0,3
41665_0,,,,2,3,2,5
C(C(C(CO)O)C(C(C)O)O)(O)=O,,,5,1,3,0,3
41667_0,,,,2,3,2,5
C(C(C(O)=O)(C(CO)(C)O)O)(O)=O,,,5,1,5,0,5
41668_0,,,,2,3,2,5
41670_0,,,,2,3,2,5
C(C(C(O)=O)(C(CCO)O)O)(O)=O,,,5,1,5,0,5
41671_0,,,,2,3,2,5
41672_0,,,,2,3,2,5
41673_0,,,,2,3,2,5
41674_0,,,,2,3,2,5
41675_0,,,,2,3,2,5
41676_0,,,,2,3,2,5
41678_0,,,,2,3,2,5
C(C(CO)O)(C(CO)(CO)CO)=O,,,5,1,2,0,2
41679_0,,,,2,3,2,5
41680_0,,,,2,3,2,5
41681_0,,,,2,3,2,5
41682_0,,,,2,3,2,5
41683_0,,,,2,3,2,5
41684_0,,,,2,3,2,5
41685_0,,,,2,3,2,5
41686_0,,,,2,3,2,5
41687_0,,,,2,3,2,5
41688_0,,,,2,3,2,5
41689_0,,,,2,3,2,5
41691_0,,,,2,3,2,5
C1(COCC1(C(C=C)(CO)O)O)=O,,,5,1,3,0,3
41693_0,,,,2,3,2,5
C1(COCC1(C(C=CCO)O)O)=O,,,5,1,3,0,3
41694_0,,,,2,3,2,5
41695_0,,,,2,3,2,5
41696_0,,,,2,3,2,5
41697_0,,,,2,3,2,5
41699_0,,,,2,3,2,5
C1C(C(CO1)O)(C(CO)(CO)O)O,,,5,1,2,0,2
41701_0,,,,2,3,2,5
C1CC(C(O)O1)(C(CO)(CO)O)O,,,5,1,3,0,3
41703_0,,,,2,3,2,5
C1(C(C(CO1)O)C(C=C)(CO)O)=O,,,5,1,2,0,2
41705_0,,,,2,3,2,5
C1(C(C(CO1)O)C(C=CCO)O)=O,,,5,1,2,0,2
41706_0,,,,2,3,2,5
41707_0,,,,2,3,2,5
41708_0,,,,2,3,2,5
41709_0,,,,2,3,2,5
41711_0,,,,2,3,2,5
C1C(CC(O)O1)(C(CO)(CO)O)O,,,5,1,3,0,3
41712_0,,,,2,3,2,5
41713_0,,,,2,3,2,5
41715_0,,,,2,3,2,5
C(C(C=C)(C(CO)(CO)O)O)=O,,,5,1,5,0,5
41717_0,,,,2,3,2,5
C(C(CO)(C(C=C)(CO)O)O)=O,,,5,1,5,0,5
41719_0,,,,2,3,2,5
C(C(CO)(C(C=C)(CO)O)O)(O)=O,,,5,1,3,0,3
41720_0,,,,2,3,2,5
41722_0,,,,2,3,2,5
C(C(C(C)=O)(C(C=C)(CO)O)O)=O,,,5,1,3,0,3
41723_0,,,,2,3,2,5
41724_0,,,,2,3,2,5
41726_0,,,,2,3,2,5
C(C(C(CO)(CO)O)O)=CC=O,,,5,1,4,0,4
41728_0,,,,2,3,2,5
C(C(CO)(C(C=CCO)O)O)=O,,,5,1,5,0,5
41730_0,,,,2,3,2,5
C(C(CO)(C(C=CCO)O)O)(O)=O,,,5,1,3,0,3
41731_0,,,,2,3,2,5
41733_0,,,,2,3,2,5
C(C(C(C)=O)(C(C=CCO)O)O)=O,,,5,1,3,0,3
41734_0,,,,2,3,2,5
41735_0,,,,2,3,2,5
41736_0,,,,2,3,2,5
41737_0,,,,2,3,2,5
41738_0,,,,2,3,2,5
41739_0,,,,2,3,2,5
41740_0,,,,2,3,2,5
41741_0,,,,2,3,2,5
41742_0,,,,2,3,2,5
41743_0,,,,2,3,2,5
41744_0,,,,2,3,2,5
41745_0,,,,2,3,2,5
41746_0,,,,2,3,2,5
41747_0,,,,2,3,2,5
41748_0,,,,2,3,2,5
41749_0,,,,2,3,2,5
41750_0,,,,2,3,2,5
41751_0,,,,2,3,2,5
41752_0,,,,2,3,2,5
41753_0,,,,2,3,2,5
41754_0,,,,2,3,2,5
41756_0,,,,2,3,2,5
C(C(CO)(C(C(O)O)O)O)O,,,5,1,2,0,2
41758_0,,,,2,3,2,5
C(C(C(CO)O)(C(C(O)O)O)O)O,,,5,1,4,0,4
41759_0,,,,2,3,2,5
41760_0,,,,2,3,2,5
41761_0,,,,2,3,2,5
41762_0,,,,2,3,2,5
41764_0,,,,2,3,2,5
CC(C(C(CO)(CO)O)O)O,,,5,1,2,0,2
41765_0,,,,2,3,2,5
41766_0,,,,2,3,2,5
41767_0,,,,2,3,2,5
41769_0,,,,2,3,2,5
C(C1(C(C(CC1(CO)O)O)O)O)O,,,5,1,1,0,1
41771_0,,,,2,3,2,5
C(C1(CC(CC1(CO)O)O)O)=O,,,5,1,2,0,2
41773_0,,,,2,3,2,5
C(C1(CC(CC1O)O)O)O,,,5,1,1,0,1
41775_0,,,,2,3,2,5
C(C1(CC(C(C1O)O)O)O)O,,,5,1,1,0,1
41777_0,,,,2,3,2,5
C(C1(C(CC(CO)(C1O)O)O)O)O,,,5,1,1,0,1
41778_0,,,,2,3,2,5
41779_0,,,,2,3,2,5
41780_0,,,,2,3,2,5
41781_0,,,,2,3,2,5
41782_0,,,,2,3,2,5
41783_0,,,,2,3,2,5
41784_0,,,,2,3,2,5
41785_0,,,,2,3,2,5
41786_0,,,,2,3,2,5
41788_0,,,,2,3,2,5
C(C(CC(C(CO)(O)O)O)O)(O)=O,,,5,1,1,0,1
41790_0,,,,2,3,2,5
C(C(CC(C(CO)(C)O)O)O)(O)=O,,,5,1,1,0,1
41792_0,,,,2,3,2,5
C(C(C)(CC(C(CO)(O)O)O)O)=O,,,5,1,1,0,1
41794_0,,,,2,3,2,5
C(C(C(CC(CO)(C)O)O)(O)O)=O,,,5,1,2,0,2
41796_0,,,,2,3,2,5
C(C(C)(CC(C(CO)(C)O)O)O)=O,,,5,1,1,0,1
41798_0,,,,2,3,2,5
C(C(C)(C(CC(CO)(C)O)O)O)=O,,,5,1,2,0,2
41800_0,,,,2,3,2,5
[C](C(O)=O)(C(CC(CO)(C)O)O)O,,,5,1,2,0,2
41802_0,,,,2,3,2,5
C(C(C(CC(CO)(C)O)O)O)(O)=O,,,5,1,2,0,2
41804_0,,,,2,3,2,5
C(CC(C)(C(C(CO)(O)O)O)O)=O,,,5,1,1,0,1
41806_0,,,,2,3,2,5
C(C(C(C(C)(CCO)O)O)(O)O)=O,,,5,1,2,0,2
41807_0,,,,2,3,2,5
41809_0,,,,2,3,2,5
C(C(C)(C(C(C)(CCO)O)O)O)=O,,,5,1,2,0,2
41811_0,,,,2,3,2,5
[C](C(O)=O)(C(C(C)(CCO)O)O)O,,,5,1,2,0,2
41812_0,,,,2,3,2,5
41813_0,,,,2,3,2,5
41814_0,,,,2,3,2,5
41815_0,,,,2,3,2,5
41817_0,,,,2,3,2,5
C(C)(C(CCO)(C(CCO)O)O)=O,,,5,1,2,0,2
41819_0,,,,2,3,2,5
C(C)(C(CCO)(C(CO)(C)O)O)=O,,,5,1,2,0,2
41820_0,,,,2,3,2,5
41822_0,,,,2,3,2,5
C(C)(C(C(C(O)O)O)(CCO)O)=O,,,5,1,2,0,2
41824_0,,,,2,3,2,5
C(C)(C(CCO)(C(C(C)O)O)O)=O,,,5,1,2,0,2
41825_0,,,,2,3,2,5
41827_0,,,,2,3,2,5
C(C)(C(CCO)(C(C=O)O)O)=O,,,5,1,2,0,2
41829_0,,,,2,3,2,5
C(C)(C(CCO)(C(C(O)=O)O)O)=O,,,5,1,2,0,2
41830_0,,,,2,3,2,5
41832_0,,,,2,3,2,5
C(C(C)(C(C(C)=O)(CCO)O)O)=O,,,5,1,2,0,2
41834_0,,,,2,3,2,5
C(C)(C(CCO)(C(C(C)=O)O)O)=O,,,5,1,2,0,2
41835_0,,,,2,3,2,5
41837_0,,,,2,3,2,5
C(CC(C(C(C)=O)(CCO)O)O)=O,,,5,1,2,0,2
41839_0,,,,2,3,2,5
C(C)(C(C(C)O)(CCO)O)=O,,,5,1,2,0,2
41841_0,,,,2,3,2,5
C(C)(C(C(CO)O)(CCO)O)=O,,,5,1,2,0,2
41843_0,,,,2,3,2,5
C(C)(C(CC(C(CO)(O)O)O)O)=O,,,5,1,1,0,1
41845_0,,,,2,3,2,5
C(C)(C(CC(C(CO)(C)O)O)O)=O,,,5,1,1,0,1
41847_0,,,,2,3,2,5
C(CC(C(C)(C(CO)(O)O)O)O)=O,,,5,1,1,0,1
41849_0,,,,2,3,2,5
C(C(C(C)(C(CCO)O)O)(O)O)=O,,,5,1,2,0,2
41850_0,,,,2,3,2,5
41852_0,,,,2,3,2,5
C(C(C)(C(C)(C(CCO)O)O)O)=O,,,5,1,2,0,2
41854_0,,,,2,3,2,5
[C](C(O)=O)(C(C)(C(CCO)O)O)O,,,5,1,2,0,2
41856_0,,,,2,3,2,5
C(C(C(CO)(O)O)(CC(C)O)O)=O,,,5,1,1,0,1
41858_0,,,,2,3,2,5
C(C(C(CO)(CC(C)O)O)(O)O)=O,,,5,1,2,0,2
41860_0,,,,2,3,2,5
C(C(CC(C)O)(C(CO)(C)O)O)=O,,,5,1,2,0,2
41862_0,,,,2,3,2,5
C(C(C)(C(CO)(CC(C)O)O)O)=O,,,5,1,2,0,2
41864_0,,,,2,3,2,5
[C](C(O)=O)(C(CO)(CC(C)O)O)O,,,5,1,2,0,2
41866_0,,,,2,3,2,5
C(C(C(CO)(CC(C)O)O)O)(O)=O,,,5,1,2,0,2
41868_0,,,,2,3,2,5
C(C(C(CO)(O)O)O)(CC(C)O)=O,,,5,1,1,0,1
41869_0,,,,2,3,2,5
41870_0,,,,2,3,2,5
41871_0,,,,2,3,2,5
41872_0,,,,2,3,2,5
41874_0,,,,2,3,2,5
C(CC(CC(C(CO)(O)O)O)O)=O,,,5,1,1,0,1
41876_0,,,,2,3,2,5
C(C(C(CC(CCO)O)O)(O)O)=O,,,5,1,2,0,2
41878_0,,,,2,3,2,5
C(CC(CC(C(C)(CO)O)O)O)=O,,,5,1,1,0,1
41880_0,,,,2,3,2,5
C(C(C)(C(CC(CCO)O)O)O)=O,,,5,1,2,0,2
41882_0,,,,2,3,2,5
[C](C(O)=O)(C(CC(CCO)O)O)O,,,5,1,2,0,2
41883_0,,,,2,3,2,5
41885_0,,,,2,3,2,5
C(C(C(C(CO)C(C)O)O)(O)O)=O,,,5,1,2,0,2
41886_0,,,,2,3,2,5
41888_0,,,,2,3,2,5
C(C(C)(C(C(CO)C(C)O)O)O)=O,,,5,1,2,0,2
41890_0,,,,2,3,2,5
[C](C(O)=O)(C(C(CO)C(C)O)O)O,,,5,1,2,0,2
41891_0,,,,2,3,2,5
41892_0,,,,2,3,2,5
41893_0,,,,2,3,2,5
41894_0,,,,2,3,2,5
41896_0,,,,2,3,2,5
C(C(C(C(CO)CO)O)(O)O)=O,,,5,1,2,0,2
41897_0,,,,2,3,2,5
41899_0,,,,2,3,2,5
C(C(C)(C(C(CO)CO)O)O)=O,,,5,1,2,0,2
41901_0,,,,2,3,2,5
[C](C(O)=O)(C(C(CO)CO)O)O,,,5,1,2,0,2
41902_0,,,,2,3,2,5
41904_0,,,,2,3,2,5
C(CCO)(C(C(C)O)(CCO)O)=O,,,5,1,2,0,2
41906_0,,,,2,3,2,5
C(CCO)(C(CO)(CCO)O)=O,,,5,1,2,0,2
41907_0,,,,2,3,2,5
41908_0,,,,2,3,2,5
41909_0,,,,2,3,2,5
41911_0,,,,2,3,2,5
C(C(C=O)(C(CO)C(C)O)O)(O)=O,,,5,1,2,0,2
41912_0,,,,2,3,2,5
41913_0,,,,2,3,2,5
41915_0,,,,2,3,2,5
C(CO)(C(C)(C(CC(C)O)O)O)=O,,,5,1,2,0,2
41917_0,,,,2,3,2,5
CC(CC(C(CO)(CCO)O)O)O,,,5,1,1,0,1
41919_0,,,,2,3,2,5
CC(CC(C(CO)(O)O)O)O,,,5,1,1,0,1
41921_0,,,,2,3,2,5
CC(CC(C(C)(CO)O)O)O,,,5,1,1,0,1
41923_0,,,,2,3,2,5
C(CC(CO)(C(CC(C)O)O)O)=O,,,5,1,1,0,1
41924_0,,,,2,3,2,5
41926_0,,,,2,3,2,5
CC(C(C(C(CO)(O)O)O)O)O,,,5,1,1,0,1
41928_0,,,,2,3,2,5
CC(CO)(C(C(C(C)O)O)O)O,,,5,1,1,0,1
41929_0,,,,2,3,2,5
41930_0,,,,2,3,2,5
41931_0,,,,2,3,2,5
41933_0,,,,2,3,2,5
C(CO)(C(C(C)O)(CCO)O)=O,,,5,1,2,0,2
41935_0,,,,2,3,2,5
C(CO)(C(C(CO)O)(CCO)O)=O,,,5,1,2,0,2
41937_0,,,,2,3,2,5
C(CO)(C(C)(C(CCO)O)O)=O,,,5,1,2,0,2
41939_0,,,,2,3,2,5
C(C(CCO)(C(CCO)O)O)O,,,5,1,1,0,1
41941_0,,,,2,3,2,5
C(CC(CO)(C(CCO)O)O)(O)=O,,,5,1,1,0,1
41943_0,,,,2,3,2,5
C(CC(C(CO)(O)O)O)O,,,5,1,1,0,1
41945_0,,,,2,3,2,5
CC(CO)(C(CCO)O)O,,,5,1,1,0,1
41947_0,,,,2,3,2,5
C(C(CC(C(CO)(O)O)O)O)O,,,5,1,1,0,1
41949_0,,,,2,3,2,5
CC(CO)(C(CC(CO)O)O)O,,,5,1,1,0,1
41950_0,,,,2,3,2,5
41951_0,,,,2,3,2,5
41952_0,,,,2,3,2,5
41953_0,,,,2,3,2,5
41954_0,,,,2,3,2,5
41955_0,,,,2,3,2,5
41957_0,,,,2,3,2,5
C(C(C(C(C(CO)(O)O)O)=O)O)=O,,,5,1,1,0,1
41958_0,,,,2,3,2,5
41959_0,,,,2,3,2,5
41961_0,,,,2,3,2,5
C(C(C(CO)(O)O)(C(C=O)O)O)=O,,,5,1,1,0,1
41962_0,,,,2,3,2,5
41963_0,,,,2,3,2,5
41964_0,,,,2,3,2,5
41965_0,,,,2,3,2,5
41967_0,,,,2,3,2,5
C(C(C(CO)(C(CO)(O)O)O)O)=O,,,5,1,1,0,1
41968_0,,,,2,3,2,5
41969_0,,,,2,3,2,5
41970_0,,,,2,3,2,5
41972_0,,,,2,3,2,5
C(C)(C(CO)(C(CO)(O)O)O)=O,,,5,1,1,0,1
41974_0,,,,2,3,2,5
C(CO)(C(C)(C(CO)(O)O)O)=O,,,5,1,1,0,1
41976_0,,,,2,3,2,5
C(CO)(C(C)(C(CO)(C)O)O)=O,,,5,1,3,0,3
41977_0,,,,2,3,2,5
41978_0,,,,2,3,2,5
41979_0,,,,2,3,2,5
41980_0,,,,2,3,2,5
41982_0,,,,2,3,2,5
C(CC(C(C(CO)=O)(C)O)O)(O)=O,,,5,1,2,0,2
41984_0,,,,2,3,2,5
C=CC(CO)(C(C(C=O)=O)(C)O)O,,,5,1,2,0,2
41986_0,,,,2,3,2,5
C(C(C=C)(C(C(CO)=O)(C)O)O)=O,,,5,1,3,0,3
41987_0,,,,2,3,2,5
41989_0,,,,2,3,2,5
C(CO)=CC(C(C(C=O)=O)(C)O)O,,,5,1,2,0,2
41991_0,,,,2,3,2,5
C(CO)(C(C)(C(C=CC=O)O)O)=O,,,5,1,2,0,2
41993_0,,,,2,3,2,5
C(CO)(C(C)(C(C(O)O)O)O)=O,,,5,1,2,0,2
41995_0,,,,2,3,2,5
C(CO)(C(C)(C(C(C)O)O)O)=O,,,5,1,2,0,2
41997_0,,,,2,3,2,5
C(CO)(C(C)(C(C(CO)O)O)O)=O,,,5,1,4,0,4
41998_0,,,,2,3,2,5
41999_0,,,,2,3,2,5
42000_0,,,,2,3,2,5
42001_0,,,,2,3,2,5
42002_0,,,,2,3,2,5
42003_0,,,,2,3,2,5
42005_0,,,,2,3,2,5
C(CO)(C(C)(C(C)O)O)=O,,,5,1,2,0,2
42006_0,,,,2,3,2,5
42007_0,,,,2,3,2,5
42009_0,,,,2,3,2,5
C(C(C(CO)(O)O)(C(C)O)O)=O,,,5,1,1,0,1
42011_0,,,,2,3,2,5
C(C(C(CO)(C(C)O)O)(O)O)=O,,,5,1,2,0,2
42013_0,,,,2,3,2,5
[C](C(O)=O)(C(CO)(C(C)O)O)O,,,5,1,3,0,3
42015_0,,,,2,3,2,5
C(C(C(CO)(O)O)O)(C(C)O)=O,,,5,1,1,0,1
42016_0,,,,2,3,2,5
42017_0,,,,2,3,2,5
42018_0,,,,2,3,2,5
42019_0,,,,2,3,2,5
42020_0,,,,2,3,2,5
42021_0,,,,2,3,2,5
42022_0,,,,2,3,2,5
42024_0,,,,2,3,2,5
CC(CO)(C(CO)(CCO)O)O,,,5,1,2,0,2
42026_0,,,,2,3,2,5
C(CC(CO)(C(C)(CO)O)O)(O)=O,,,5,1,2,0,2
42028_0,,,,2,3,2,5
CC(CO)(C(CO)(O)O)O,,,5,1,1,0,1
42030_0,,,,2,3,2,5
CC(CO)(C(C)(CO)O)O,,,5,1,1,0,1
42032_0,,,,2,3,2,5
C(C(C(CO)(CCO)O)(O)O)O,,,5,1,1,0,1
42033_0,,,,2,3,2,5
42035_0,,,,2,3,2,5
C(CC(C(CO)(CCO)O)O)(O)=O,,,5,1,1,0,1
42037_0,,,,2,3,2,5
C(C(CCO)(C(C=C)(CO)O)O)=O,,,5,1,2,0,2
42039_0,,,,2,3,2,5
C(C(C=C)(C(CO)(CCO)O)O)=O,,,5,1,2,0,2
42040_0,,,,2,3,2,5
42042_0,,,,2,3,2,5
C(C(CCO)(C(C=CCO)O)O)=O,,,5,1,2,0,2
42044_0,,,,2,3,2,5
C(C(C(CO)(CCO)O)O)=CC=O,,,5,1,1,0,1
42046_0,,,,2,3,2,5
C(C(CCO)(C(C(O)O)O)O)O,,,5,1,1,0,1
42047_0,,,,2,3,2,5
42049_0,,,,2,3,2,5
C(C(C(C(CCO)O)O)(O)O)O,,,5,1,1,0,1
42051_0,,,,2,3,2,5
CC(CO)(C(C(CCO)O)O)O,,,5,1,1,0,1
42053_0,,,,2,3,2,5
CC(C(CO)O)(C(CO)(O)O)O,,,5,1,1,0,1
42055_0,,,,2,3,2,5
CC(C(CO)O)(C(C)(CO)O)O,,,5,1,1,0,1
42057_0,,,,2,3,2,5
C(C(C)(C(CO)(O)O)O)(O)=O,,,5,1,1,0,1
42059_0,,,,2,3,2,5
C(CC(C(CO)(O)O)O)(O)=O,,,5,1,1,0,1
42061_0,,,,2,3,2,5
C(CC(C(C)(CO)O)O)(O)=O,,,5,1,1,0,1
42063_0,,,,2,3,2,5
C(C(C(CO)(O)O)(CCO)O)(O)=O,,,5,1,1,0,1
42064_0,,,,2,3,2,5
42066_0,,,,2,3,2,5
C(CC(CO)(C(C(O)O)O)O)(O)=O,,,5,1,1,0,1
42068_0,,,,2,3,2,5
C(CC(CO)(C(C(C)O)O)O)(O)=O,,,5,1,2,0,2
42070_0,,,,2,3,2,5
C(CC(C(C(CO)(O)O)O)O)(O)=O,,,5,1,1,0,1
42072_0,,,,2,3,2,5
C(CC(C(C(C)(CO)O)O)O)(O)=O,,,5,1,1,0,1
42074_0,,,,2,3,2,5
C(CC(CO)(C(CO)(O)O)O)(O)=O,,,5,1,1,0,1
42075_0,,,,2,3,2,5
42077_0,,,,2,3,2,5
C(C(C(C)(C(CO)(O)O)O)O)(O)=O,,,5,1,1,0,1
42078_0,,,,2,3,2,5
42080_0,,,,2,3,2,5
C(C(CO)(C(CO)(O)O)O)(O)=O,,,5,1,1,0,1
42081_0,,,,2,3,2,5
42083_0,,,,2,3,2,5
C(C(C(CO)(O)O)(CC=O)O)=O,,,5,1,1,0,1
42084_0,,,,2,3,2,5
42085_0,,,,2,3,2,5
42086_0,,,,2,3,2,5
42087_0,,,,2,3,2,5
42089_0,,,,2,3,2,5
C(CC(C(C(CO)(O)O)O)=O)=O,,,5,1,1,0,1
42090_0,,,,2,3,2,5
42091_0,,,,2,3,2,5
42092_0,,,,2,3,2,5
42093_0,,,,2,3,2,5
42094_0,,,,2,3,2,5
42095_0,,,,2,3,2,5
42096_0,,,,2,3,2,5
42097_0,,,,2,3,2,5
42098_0,,,,2,3,2,5
42100_0,,,,2,3,2,5
C(C(C(CO)(O)O)(CC(O)=O)O)=O,,,5,1,1,0,1
42101_0,,,,2,3,2,5
42102_0,,,,2,3,2,5
42104_0,,,,2,3,2,5
C(CC(C(C(CO)(O)O)O)=O)(O)=O,,,5,1,1,0,1
42105_0,,,,2,3,2,5
42106_0,,,,2,3,2,5
42108_0,,,,2,3,2,5
C(C(C(CO)(O)O)(CC=O)O)(O)=O,,,5,1,1,0,1
42109_0,,,,2,3,2,5
42110_0,,,,2,3,2,5
42112_0,,,,2,3,2,5
C1C(C(CO1)O)(C(CO)(O)O)O,,,5,1,1,0,1
42114_0,,,,2,3,2,5
C1C(C(CO1)O)(C(C)(CO)O)O,,,5,1,1,0,1
42116_0,,,,2,3,2,5
C1(C(C(C=C)(CO)O)(O)OCC1)=O,,,5,1,2,0,2
42118_0,,,,2,3,2,5
C1(C(C(C=CCO)O)(O)OCC1)=O,,,5,1,2,0,2
42119_0,,,,2,3,2,5
42120_0,,,,2,3,2,5
42121_0,,,,2,3,2,5
42122_0,,,,2,3,2,5
42124_0,,,,2,3,2,5
C1CC(C(O)O1)(C(CO)(O)O)O,,,5,1,1,0,1
42126_0,,,,2,3,2,5
CC(CO)(C1(C(O)OCC1)O)O,,,5,1,2,0,2
42128_0,,,,2,3,2,5
C1C(CC(O)O1)(C(CO)(O)O)O,,,5,1,1,0,1
42130_0,,,,2,3,2,5
C1C(CC(O)O1)(C(C)(CO)O)O,,,5,1,1,0,1
42132_0,,,,2,3,2,5
C(C(C(C)=O)(C(CO)(O)O)O)=O,,,5,1,1,0,1
42133_0,,,,2,3,2,5
42134_0,,,,2,3,2,5
42136_0,,,,2,3,2,5
C(C(C)=O)(C(C(CO)(O)O)O)=O,,,5,1,1,0,1
42138_0,,,,2,3,2,5
C(C(C(C)(C(CO)(O)O)O)=O)=O,,,5,1,1,0,1
42139_0,,,,2,3,2,5
42140_0,,,,2,3,2,5
42142_0,,,,2,3,2,5
C(C(C=C)(C(C=C)(CO)O)O)(O)=O,,,5,1,2,0,2
42144_0,,,,2,3,2,5
C1(C(CCO1)(C(C=C)(CO)O)O)=O,,,5,1,2,0,2
42146_0,,,,2,3,2,5
C(C(C=C)(C(CO)(O)O)O)=O,,,5,1,1,0,1
42148_0,,,,2,3,2,5
C(C(C(C=C)(CO)O)(O)O)=O,,,5,1,3,0,3
42150_0,,,,2,3,2,5
C(C(C=C)(C(CO)(C)O)O)=O,,,5,1,4,0,4
42152_0,,,,2,3,2,5
C(C(C)(C(C=C)(CO)O)O)=O,,,5,1,3,0,3
42154_0,,,,2,3,2,5
C=CC([C](C(O)=O)O)(CO)O,,,5,1,3,0,3
42155_0,,,,2,3,2,5
42157_0,,,,2,3,2,5
C(C(C=C)(C(CO)(CC=O)O)O)=O,,,5,1,2,0,2
42158_0,,,,2,3,2,5
42159_0,,,,2,3,2,5
42161_0,,,,2,3,2,5
C(C(C)(C(C=C)(CO)O)O)(O)=O,,,5,1,3,0,3
42163_0,,,,2,3,2,5
C=CC(C(C(CO)(O)O)O)=O,,,5,1,1,0,1
42164_0,,,,2,3,2,5
42165_0,,,,2,3,2,5
42166_0,,,,2,3,2,5
42168_0,,,,2,3,2,5
C(C(C=C)(C(C=CCO)O)O)(O)=O,,,5,1,2,0,2
42170_0,,,,2,3,2,5
C1(C(CCO1)(C(C=CCO)O)O)=O,,,5,1,2,0,2
42172_0,,,,2,3,2,5
C(C(C(CO)(O)O)O)=CC=O,,,5,1,1,0,1
42174_0,,,,2,3,2,5
C(C(C(C=CCO)O)(O)O)=O,,,5,1,4,0,4
42176_0,,,,2,3,2,5
C(C(C(CO)(C)O)O)=CC=O,,,5,1,1,0,1
42178_0,,,,2,3,2,5
C(C(C)(C(C=CCO)O)O)=O,,,5,1,4,0,4
42180_0,,,,2,3,2,5
C(C([C](C(O)=O)O)O)=CCO,,,5,1,4,0,4
42182_0,,,,2,3,2,5
C(C(C(C=CCO)O)O)(O)=O,,,5,1,4,0,4
42183_0,,,,2,3,2,5
42184_0,,,,2,3,2,5
42186_0,,,,2,3,2,5
C(CC(C=O)(C(C=CCO)O)O)=O,,,5,1,2,0,2
42188_0,,,,2,3,2,5
C(C(C)(C(C=CCO)O)O)(O)=O,,,5,1,4,0,4
42189_0,,,,2,3,2,5
42190_0,,,,2,3,2,5
42191_0,,,,2,3,2,5
42192_0,,,,2,3,2,5
42193_0,,,,2,3,2,5
42194_0,,,,2,3,2,5
42195_0,,,,2,3,2,5
42197_0,,,,2,3,2,5
C1C(C(C(O)O1)(C(CO)(O)O)O)O,,,5,1,1,0,1
42199_0,,,,2,3,2,5
CC(CO)(C1(C(O)OCC1O)O)O,,,5,1,3,0,3
42201_0,,,,2,3,2,5
C(C(CO)(O)O)(O)=O,,,5,1,3,0,3
42202_0,,,,2,3,2,5
42203_0,,,,2,3,2,5
42204_0,,,,2,3,2,5
42205_0,,,,2,3,2,5
42206_0,,,,2,3,2,5
42207_0,,,,2,3,2,5
42208_0,,,,2,3,2,5
42210_0,,,,2,3,2,5
C(C(C(C(O)O)O)(O)O)O,,,5,1,1,0,1
42212_0,,,,2,3,2,5
CC(C(C(CO)(O)O)O)O,,,5,1,1,0,1
42214_0,,,,2,3,2,5
C(C(C(C(CO)(O)O)O)O)O,,,5,1,1,0,1
42216_0,,,,2,3,2,5
C(C(C(C(C(CO)(O)O)O)O)O)O,,,5,1,1,0,1
42217_0,,,,2,3,2,5
42219_0,,,,2,3,2,5
C(C(C(CO)(O)O)O)=O,,,5,1,1,0,1
42220_0,,,,2,3,2,5
42222_0,,,,2,3,2,5
C(C(C(C(C(CO)(O)O)O)O)O)=O,,,5,1,1,0,1
42224_0,,,,2,3,2,5
C(C(CO)(C(CO)(O)O)O)O,,,5,1,1,0,1
42226_0,,,,2,3,2,5
C(C(C(CO)(C(CO)O)O)(O)O)O,,,5,1,1,0,1
42228_0,,,,2,3,2,5
C(C(C(CO)(O)O)O)(O)=O,,,5,1,1,0,1
42230_0,,,,2,3,2,5
C(C(C(C(CO)(CO)O)O)(O)O)O,,,5,1,1,0,1
42231_0,,,,2,3,2,5
42233_0,,,,2,3,2,5
C(C(C)(C(CO)(O)O)O)=O,,,5,1,1,0,1
42235_0,,,,2,3,2,5
C(C)(C(C(CO)(O)O)O)=O,,,5,1,1,0,1
42236_0,,,,2,3,2,5
42237_0,,,,2,3,2,5
42238_0,,,,2,3,2,5
42240_0,,,,2,3,2,5
C(C(C(CO)(O)O)(CCO)O)=O,,,5,1,1,0,1
42242_0,,,,2,3,2,5
C(C(C(CO)(O)O)O)(CCO)=O,,,5,1,1,0,1
42243_0,,,,2,3,2,5
42245_0,,,,2,3,2,5
C(CC(C(C(CO)(O)O)O)O)=O,,,5,1,1,0,1
42246_0,,,,2,3,2,5
42248_0,,,,2,3,2,5
C(C(CC(C(CO)(O)O)O)O)=O,,,5,1,1,0,1
42249_0,,,,2,3,2,5
42250_0,,,,2,3,2,5
42252_0,,,,2,3,2,5
C(CC(CO)(C(CO)(O)O)O)=O,,,5,1,1,0,1
42253_0,,,,2,3,2,5
42254_0,,,,2,3,2,5
42256_0,,,,2,3,2,5
C(C(C(C)(C(CO)(O)O)O)O)=O,,,5,1,1,0,1
42258_0,,,,2,3,2,5
CC(C(CO)(O)O)O,,,5,1,1,0,1
42259_0,,,,2,3,2,5
42261_0,,,,2,3,2,5
C(C(CO)(C(CO)(O)O)O)=O,,,5,1,1,0,1
42263_0,,,,2,3,2,5
C(CO)(C(C(CO)(O)O)O)=O,,,5,1,1,0,1
42264_0,,,,2,3,2,5
42266_0,,,,2,3,2,5
C(C(C(CO)(O)O)(C(CO)O)O)=O,,,5,1,1,0,1
42268_0,,,,2,3,2,5
C(C(C(CO)(O)O)O)(C(CO)O)=O,,,5,1,1,0,1
42270_0,,,,2,3,2,5
C(C(CO)(O)O)O,,,5,1,1,0,1
42272_0,,,,2,3,2,5
C(C(C(CO)O)(O)O)O,,,5,1,1,0,1
42274_0,,,,2,3,2,5
CC(CO)(C(C(O)O)O)O,,,5,1,1,0,1
42276_0,,,,2,3,2,5
C(CC(CO)(C(C(O)O)O)O)=O,,,5,1,1,0,1
42277_0,,,,2,3,2,5
42279_0,,,,2,3,2,5
CC(CO)(C(C(C)O)O)O,,,5,1,1,0,1
42281_0,,,,2,3,2,5
CC(CO)(C(C(CO)O)O)O,,,5,1,3,0,3
42283_0,,,,2,3,2,5
CC(CO)(C(C(C(CO)O)O)O)O,,,5,1,3,0,3
42285_0,,,,2,3,2,5
CC(CO)(C(C(CO)(CO)O)O)O,,,5,1,1,0,1
42286_0,,,,2,3,2,5
42287_0,,,,2,3,2,5
42288_0,,,,2,3,2,5
42289_0,,,,2,3,2,5
42291_0,,,,2,3,2,5
C(C(CC(C(CO)(C)O)O)O)=O,,,5,1,1,0,1
42292_0,,,,2,3,2,5
42293_0,,,,2,3,2,5
42294_0,,,,2,3,2,5
42296_0,,,,2,3,2,5
C(C(C(C)(C(CO)(C)O)O)O)=O,,,5,1,2,0,2
42298_0,,,,2,3,2,5
CC(CO)(C(C)O)O,,,5,1,1,0,1
42300_0,,,,2,3,2,5
CC(CO)(CO)O,,,5,1,1,0,1
42301_0,,,,2,3,2,5
42302_0,,,,2,3,2,5
42303_0,,,,2,3,2,5
42304_0,,,,2,3,2,5
42305_0,,,,2,3,2,5
42306_0,,,,2,3,2,5
42307_0,,,,2,3,2,5
42308_0,,,,2,3,2,5
42309_0,,,,2,3,2,5
42310_0,,,,2,3,2,5
42311_0,,,,2,3,2,5
42313_0,,,,2,3,2,5
C(CO)(OC(CO)O)=O,,,5,1,1,0,1
42315_0,,,,2,3,2,5
C(CO)(OCCO)=O,,,5,1,1,0,1
42317_0,,,,2,3,2,5
C(CO)(OC(CO)CO)=O,,,5,1,1,0,1
42319_0,,,,2,3,2,5
C(CO)(OC(CO)C(CO)O)=O,,,5,1,2,0,2
42321_0,,,,2,3,2,5
C(CO)(OCC(CO)O)=O,,,5,1,1,0,1
42322_0,,,,2,3,2,5
42324_0,,,,2,3,2,5
C(CO)(OCC(C(CO)O)O)=O,,,5,1,1,0,1
42326_0,,,,2,3,2,5
C(C(C(CO)O)O)(CCCO)=O,,,5,1,2,0,2
42328_0,,,,2,3,2,5
C(CC(C(CO)O)O)(CCO)=O,,,5,1,2,0,2
42329_0,,,,2,3,2,5
42330_0,,,,2,3,2,5
42331_0,,,,2,3,2,5
42332_0,,,,2,3,2,5
42333_0,,,,2,3,2,5
42334_0,,,,2,3,2,5
42335_0,,,,2,3,2,5
42336_0,,,,2,3,2,5
42338_0,,,,2,3,2,5
C(C(C(CCCO)=O)O)=O,,,5,1,4,0,4
42339_0,,,,2,3,2,5
42341_0,,,,2,3,2,5
C(CC(C=O)O)(CCO)=O,,,5,1,5,0,5
42342_0,,,,2,3,2,5
42343_0,,,,2,3,2,5
42345_0,,,,2,3,2,5
C(C(CC(CO)CO)=O)=O,,,5,1,2,0,2
42346_0,,,,2,3,2,5
42348_0,,,,2,3,2,5
C(C(C=O)C(CO)CO)=O,,,5,1,2,0,2
42349_0,,,,2,3,2,5
42351_0,,,,2,3,2,5
C(C(C(CO)C(CO)CO)=O)=O,,,5,1,2,0,2
42352_0,,,,2,3,2,5
42354_0,,,,2,3,2,5
C(C(CO)C(CO)C(C=O)O)=O,,,5,1,3,0,3
42356_0,,,,2,3,2,5
C(C(C(CO)CO)C(C=O)O)=O,,,5,1,2,0,2
42357_0,,,,2,3,2,5
42359_0,,,,2,3,2,5
C(C(C(CO)=O)C(CO)CO)=O,,,5,1,2,0,2
42361_0,,,,2,3,2,5
C(C(CCO)=O)(C(CO)CO)=O,,,5,1,3,0,3
42362_0,,,,2,3,2,5
42364_0,,,,2,3,2,5
C(C(C(CC(CO)CO)=O)O)=O,,,5,1,2,0,2
42366_0,,,,2,3,2,5
C(C(CO)CCO)=O,,,5,1,2,0,2
42368_0,,,,2,3,2,5
C(CC(CO)CO)=O,,,5,1,2,0,2
42369_0,,,,2,3,2,5
42370_0,,,,2,3,2,5
42371_0,,,,2,3,2,5
42372_0,,,,2,3,2,5
42373_0,,,,2,3,2,5
42375_0,,,,2,3,2,5
C(C(CO)=O)(CCCO)=O,,,5,1,2,0,2
42377_0,,,,2,3,2,5
C(C(CO)=O)(C(CO)CCO)=O,,,5,1,3,0,3
42379_0,,,,2,3,2,5
C(CC(C(CO)=O)O)(CCO)=O,,,5,1,2,0,2
42381_0,,,,2,3,2,5
C(CCCO)(C(C(CO)=O)O)=O,,,5,1,2,0,2
42382_0,,,,2,3,2,5
42383_0,,,,2,3,2,5
42385_0,,,,2,3,2,5
C(C(CO)=O)(CCC(CO)O)=O,,,5,1,2,0,2
42387_0,,,,2,3,2,5
C(C(CCO)C(C(CO)=O)O)=O,,,5,1,3,0,3
42389_0,,,,2,3,2,5
C(CC(CO)C(C(CO)=O)O)=O,,,5,1,3,0,3
42390_0,,,,2,3,2,5
42392_0,,,,2,3,2,5
C(CO)(C(C)C(C(CO)=O)O)=O,,,5,1,2,0,2
42393_0,,,,2,3,2,5
42394_0,,,,2,3,2,5
42395_0,,,,2,3,2,5
42396_0,,,,2,3,2,5
42398_0,,,,2,3,2,5
C(C(CC(CO)C(CO)O)=O)=O,,,5,1,3,0,3
42400_0,,,,2,3,2,5
C(CO)(C(CO)CC(CO)=O)=O,,,5,1,5,0,5
42401_0,,,,2,3,2,5
42403_0,,,,2,3,2,5
C(C(C=O)C(CO)C(CO)O)=O,,,5,1,3,0,3
42404_0,,,,2,3,2,5
42406_0,,,,2,3,2,5
C(C(CCO)C(CO)O)=O,,,5,1,3,0,3
42408_0,,,,2,3,2,5
C(CC(CO)C(CO)O)=O,,,5,1,3,0,3
42410_0,,,,2,3,2,5
C(CO)(C(CO)CCO)=O,,,5,1,2,0,2
42411_0,,,,2,3,2,5
42412_0,,,,2,3,2,5
42414_0,,,,2,3,2,5
C(C(C(CO)O)=O)(CCCO)=O,,,5,1,2,0,2
42415_0,,,,2,3,2,5
42416_0,,,,2,3,2,5
42417_0,,,,2,3,2,5
42418_0,,,,2,3,2,5
42420_0,,,,2,3,2,5
C(C(C(CCCO)=O)(CO)O)=O,,,5,1,3,0,3
42422_0,,,,2,3,2,5
C(CCC=O)(C(CO)(CO)O)=O,,,5,1,4,0,4
42424_0,,,,2,3,2,5
C(C(CO)(CC(CCO)=O)O)=O,,,5,1,2,0,2
42425_0,,,,2,3,2,5
42427_0,,,,2,3,2,5
C(C(CO)C(C=O)O)(CCO)=O,,,5,1,5,0,5
42428_0,,,,2,3,2,5
42430_0,,,,2,3,2,5
C(C(CO)CO)(CC(CO)=O)=O,,,5,1,3,0,3
42431_0,,,,2,3,2,5
42433_0,,,,2,3,2,5
C(CCO)(C(CO)CO)=O,,,5,1,2,0,2
42435_0,,,,2,3,2,5
C(CCO)(C(CO)C(CO)O)=O,,,5,1,2,0,2
42437_0,,,,2,3,2,5
C(C(C(CCCO)=O)O)(O)=O,,,5,1,3,0,3
42438_0,,,,2,3,2,5
42440_0,,,,2,3,2,5
C(C(C(C(CCO)=O)=O)C)=O,,,5,1,2,0,2
42441_0,,,,2,3,2,5
42442_0,,,,2,3,2,5
42443_0,,,,2,3,2,5
42445_0,,,,2,3,2,5
C(C(C(CO)=O)C)=O,,,5,1,2,0,2
42446_0,,,,2,3,2,5
42448_0,,,,2,3,2,5
C(C)(CC(C(CCO)=O)=O)=O,,,5,1,2,0,2
42450_0,,,,2,3,2,5
C(CCO)(CC(C(C)=O)=O)=O,,,5,1,3,0,3
42451_0,,,,2,3,2,5
42452_0,,,,2,3,2,5
42453_0,,,,2,3,2,5
42455_0,,,,2,3,2,5
C(CCC(C=O)=O)(CCO)=O,,,5,1,3,0,3
42457_0,,,,2,3,2,5
C(CC(CCC(CO)=O)=O)=O,,,5,1,3,0,3
42459_0,,,,2,3,2,5
C(CCCO)(CC(C=O)=O)=O,,,5,1,2,0,2
42461_0,,,,2,3,2,5
C(CCC(CC(CO)=O)=O)=O,,,5,1,3,0,3
42463_0,,,,2,3,2,5
C(C(CCO)CC(C=O)=O)=O,,,5,1,4,0,4
42465_0,,,,2,3,2,5
C(CC(CO)CC(C=O)=O)=O,,,5,1,5,0,5
42466_0,,,,2,3,2,5
42468_0,,,,2,3,2,5
C(CO)(CCC(C(C)=O)=O)=O,,,5,1,2,0,2
42470_0,,,,2,3,2,5
C(CC(C)=O)(CC(CO)=O)=O,,,5,1,2,0,2
42472_0,,,,2,3,2,5
C(CO)(C(C)CC(C=O)=O)=O,,,5,1,2,0,2
42474_0,,,,2,3,2,5
C(CC(C(C=O)=O)C)(CO)=O,,,5,1,2,0,2
42475_0,,,,2,3,2,5
42476_0,,,,2,3,2,5
42477_0,,,,2,3,2,5
42478_0,,,,2,3,2,5
42480_0,,,,2,3,2,5
C(CO)(CCC(CO)=O)=O,,,5,1,2,0,2
42481_0,,,,2,3,2,5
42483_0,,,,2,3,2,5
C(CCC(C(CO)O)=O)(CO)=O,,,5,1,4,0,4
42484_0,,,,2,3,2,5
42485_0,,,,2,3,2,5
42486_0,,,,2,3,2,5
42487_0,,,,2,3,2,5
42489_0,,,,2,3,2,5
C(CC(C(CCCO)=O)=O)=O,,,5,1,2,0,2
42490_0,,,,2,3,2,5
42491_0,,,,2,3,2,5
42493_0,,,,2,3,2,5
C(C(C(CCCO)=O)=O)=O,,,5,1,2,0,2
42494_0,,,,2,3,2,5
42495_0,,,,2,3,2,5
42496_0,,,,2,3,2,5
42498_0,,,,2,3,2,5
C(C(C=O)CC(CCO)=O)=O,,,5,1,2,0,2
42499_0,,,,2,3,2,5
42501_0,,,,2,3,2,5
C(C(C=O)C(CCCO)=O)=O,,,5,1,2,0,2
42502_0,,,,2,3,2,5
42504_0,,,,2,3,2,5
C(C(C=O)C(C=O)CCO)=O,,,5,1,4,0,4
42506_0,,,,2,3,2,5
C(C(C=O)C(CO)CC=O)=O,,,5,1,5,0,5
42507_0,,,,2,3,2,5
42508_0,,,,2,3,2,5
42509_0,,,,2,3,2,5
42511_0,,,,2,3,2,5
C(C(C=O)C(C(CO)=O)C)=O,,,5,1,2,0,2
42512_0,,,,2,3,2,5
42513_0,,,,2,3,2,5
42514_0,,,,2,3,2,5
42515_0,,,,2,3,2,5
42516_0,,,,2,3,2,5
42517_0,,,,2,3,2,5
42518_0,,,,2,3,2,5
42519_0,,,,2,3,2,5
42521_0,,,,2,3,2,5
C(C(C=O)CCO)=O,,,5,1,5,0,5
42522_0,,,,2,3,2,5
42523_0,,,,2,3,2,5
42525_0,,,,2,3,2,5
C(C(C(C(CO)CCO)=O)=O)=O,,,5,1,3,0,3
42527_0,,,,2,3,2,5
C(C(C(CO)=O)CCO)=O,,,5,1,5,0,5
42528_0,,,,2,3,2,5
42529_0,,,,2,3,2,5
42530_0,,,,2,3,2,5
42532_0,,,,2,3,2,5
C(C(CCO)=O)(CCO)=O,,,5,1,2,0,2
42533_0,,,,2,3,2,5
42534_0,,,,2,3,2,5
42535_0,,,,2,3,2,5
42536_0,,,,2,3,2,5
42537_0,,,,2,3,2,5
42538_0,,,,2,3,2,5
42539_0,,,,2,3,2,5
42540_0,,,,2,3,2,5
42542_0,,,,2,3,2,5
C(CCC=O)(CCO)=O,,,5,1,2,0,2
42543_0,,,,2,3,2,5
42544_0,,,,2,3,2,5
42545_0,,,,2,3,2,5
42546_0,,,,2,3,2,5
42547_0,,,,2,3,2,5
42549_0,,,,2,3,2,5
C(CCCO)(C(C(C=O)=O)O)=O,,,5,1,2,0,2
42550_0,,,,2,3,2,5
42552_0,,,,2,3,2,5
C(C(C(CCC(CO)O)=O)=O)=O,,,5,1,2,0,2
42554_0,,,,2,3,2,5
C(C(CCC(CO)=O)O)=O,,,5,1,5,0,5
42555_0,,,,2,3,2,5
42556_0,,,,2,3,2,5
42557_0,,,,2,3,2,5
42558_0,,,,2,3,2,5
42559_0,,,,2,3,2,5
42561_0,,,,2,3,2,5
C(C(C(CO)CC(CO)=O)O)=O,,,5,1,4,0,4
42562_0,,,,2,3,2,5
42563_0,,,,2,3,2,5
42565_0,,,,2,3,2,5
C(C(CCO)C(C=O)O)=O,,,5,1,6,0,6
42566_0,,,,2,3,2,5
42567_0,,,,2,3,2,5
42568_0,,,,2,3,2,5
42569_0,,,,2,3,2,5
42570_0,,,,2,3,2,5
42571_0,,,,2,3,2,5
42572_0,,,,2,3,2,5
42574_0,,,,2,3,2,5
C(CC(CO)CC=O)=O,,,5,1,3,0,3
42575_0,,,,2,3,2,5
42576_0,,,,2,3,2,5
42577_0,,,,2,3,2,5
42579_0,,,,2,3,2,5
C(C(CCO)C(C(C=O)=O)O)=O,,,5,1,4,0,4
42581_0,,,,2,3,2,5
C(CC(CO)C(C(C=O)=O)O)=O,,,5,1,4,0,4
42582_0,,,,2,3,2,5
42583_0,,,,2,3,2,5
42584_0,,,,2,3,2,5
42585_0,,,,2,3,2,5
42586_0,,,,2,3,2,5
42588_0,,,,2,3,2,5
C(CCO)(CC(C)=O)=O,,,5,1,3,0,3
42589_0,,,,2,3,2,5
42590_0,,,,2,3,2,5
42591_0,,,,2,3,2,5
42592_0,,,,2,3,2,5
42593_0,,,,2,3,2,5
42595_0,,,,2,3,2,5
C(CCO)(C(C(CCO)=O)O)=O,,,5,1,2,0,2
42597_0,,,,2,3,2,5
C(C(CCO)=O)(CC(CO)O)=O,,,5,1,2,0,2
42598_0,,,,2,3,2,5
42599_0,,,,2,3,2,5
42600_0,,,,2,3,2,5
42601_0,,,,2,3,2,5
42602_0,,,,2,3,2,5
42603_0,,,,2,3,2,5
42604_0,,,,2,3,2,5
42605_0,,,,2,3,2,5
42607_0,,,,2,3,2,5
C(C(C(C)CCO)=O)=O,,,5,1,2,0,2
42609_0,,,,2,3,2,5
C(CO)(C(C)CC=O)=O,,,5,1,2,0,2
42610_0,,,,2,3,2,5
42611_0,,,,2,3,2,5
42612_0,,,,2,3,2,5
42614_0,,,,2,3,2,5
C(CO)(C(C)C(C(C=O)=O)O)=O,,,5,1,2,0,2
42616_0,,,,2,3,2,5
C(CO)(C(C)C(C=O)O)=O,,,5,1,2,0,2
42617_0,,,,2,3,2,5
42618_0,,,,2,3,2,5
42619_0,,,,2,3,2,5
42620_0,,,,2,3,2,5
42621_0,,,,2,3,2,5
42622_0,,,,2,3,2,5
42624_0,,,,2,3,2,5
C(CCO)(CCO)=O,,,5,1,2,0,2
42626_0,,,,2,3,2,5
C(C(CO)O)(CCCO)=O,,,5,1,2,0,2
42628_0,,,,2,3,2,5
C(CC(CO)O)(CCO)=O,,,5,1,2,0,2
42629_0,,,,2,3,2,5
42630_0,,,,2,3,2,5
42631_0,,,,2,3,2,5
42632_0,,,,2,3,2,5
42633_0,,,,2,3,2,5
42634_0,,,,2,3,2,5
42635_0,,,,2,3,2,5
42636_0,,,,2,3,2,5
42637_0,,,,2,3,2,5
42639_0,,,,2,3,2,5
C(C)(C(CO)C(C(CO)O)O)=O,,,5,1,2,0,2
42640_0,,,,2,3,2,5
42641_0,,,,2,3,2,5
42642_0,,,,2,3,2,5
42643_0,,,,2,3,2,5
42644_0,,,,2,3,2,5
42645_0,,,,2,3,2,5
42646_0,,,,2,3,2,5
42647_0,,,,2,3,2,5
42648_0,,,,2,3,2,5
42650_0,,,,2,3,2,5
C(C(CO)(C(C(C)=O)CO)O)=O,,,5,1,2,0,2
42651_0,,,,2,3,2,5
42652_0,,,,2,3,2,5
42653_0,,,,2,3,2,5
42655_0,,,,2,3,2,5
C(C)(C(C(C(C)=O)=O)CO)=O,,,5,1,2,0,2
42656_0,,,,2,3,2,5
42658_0,,,,2,3,2,5
C(C(C)=O)(C(CO)CO)=O,,,5,1,3,0,3
42660_0,,,,2,3,2,5
C(C(C)=O)(C(CO)C(CO)O)=O,,,5,1,2,0,2
42661_0,,,,2,3,2,5
42662_0,,,,2,3,2,5
42663_0,,,,2,3,2,5
42664_0,,,,2,3,2,5
42665_0,,,,2,3,2,5
42666_0,,,,2,3,2,5
42667_0,,,,2,3,2,5
42668_0,,,,2,3,2,5
42669_0,,,,2,3,2,5
42671_0,,,,2,3,2,5
C(CC(C=O)O)(C(CO)CO)=O,,,5,1,3,0,3
42672_0,,,,2,3,2,5
42673_0,,,,2,3,2,5
42674_0,,,,2,3,2,5
42676_0,,,,2,3,2,5
C(C(CCO)C(C=O)(CO)O)=O,,,5,1,3,0,3
42678_0,,,,2,3,2,5
C(C(CO)(C(CO)CC=O)O)=O,,,5,1,3,0,3
42680_0,,,,2,3,2,5
C(C)(C(C(C)=O)CO)=O,,,5,1,2,0,2
42681_0,,,,2,3,2,5
42683_0,,,,2,3,2,5
C(CCO)(C(C(C)=O)(CO)O)=O,,,5,1,2,0,2
42684_0,,,,2,3,2,5
42685_0,,,,2,3,2,5
42686_0,,,,2,3,2,5
42688_0,,,,2,3,2,5
C(C)(C(C(C)=O)(CO)O)=O,,,5,1,3,0,3
42689_0,,,,2,3,2,5
42691_0,,,,2,3,2,5
C(C(CO)CO)(C(C(C)=O)O)=O,,,5,1,2,0,2
42693_0,,,,2,3,2,5
C(C(CO)(CO)O)(CC(C)=O)=O,,,5,1,5,0,5
42694_0,,,,2,3,2,5
42696_0,,,,2,3,2,5
C(C(CO)(C(C(CO)=O)C)O)=O,,,5,1,2,0,2
42698_0,,,,2,3,2,5
C(C)(C(CO)CO)=O,,,5,1,2,0,2
42700_0,,,,2,3,2,5
C(C)(C(CO)C(CO)O)=O,,,5,1,2,0,2
42701_0,,,,2,3,2,5
42702_0,,,,2,3,2,5
42703_0,,,,2,3,2,5
42704_0,,,,2,3,2,5
42705_0,,,,2,3,2,5
42707_0,,,,2,3,2,5
C(C(C(C(C)=O)=O)CCO)=O,,,5,1,2,0,2
42708_0,,,,2,3,2,5
42710_0,,,,2,3,2,5
C(C(C(CC=O)=O)CCO)=O,,,5,1,2,0,2
42711_0,,,,2,3,2,5
42712_0,,,,2,3,2,5
42713_0,,,,2,3,2,5
42714_0,,,,2,3,2,5
42715_0,,,,2,3,2,5
42717_0,,,,2,3,2,5
C(C(C(CO)CCO)=O)(O)=O,,,5,1,3,0,3
42719_0,,,,2,3,2,5
C(C)(C(CO)CC=O)=O,,,5,1,3,0,3
42721_0,,,,2,3,2,5
C(C(C(C)=O)CCO)=O,,,5,1,2,0,2
42722_0,,,,2,3,2,5
42723_0,,,,2,3,2,5
42724_0,,,,2,3,2,5
42726_0,,,,2,3,2,5
C(C(C(CCO)=O)(CCO)O)=O,,,5,1,2,0,2
42727_0,,,,2,3,2,5
42729_0,,,,2,3,2,5
C(C(C(C(CO)O)=O)CCO)=O,,,5,1,3,0,3
42730_0,,,,2,3,2,5
42731_0,,,,2,3,2,5
42732_0,,,,2,3,2,5
42734_0,,,,2,3,2,5
C(C(C)(CC(CCO)=O)O)(O)=O,,,5,1,2,0,2
42736_0,,,,2,3,2,5
C(C(C(C(CCO)O)=O)C)(O)=O,,,5,1,2,0,2
42738_0,,,,2,3,2,5
C(C(C(CCCO)=O)(C)O)(O)=O,,,5,1,2,0,2
42739_0,,,,2,3,2,5
42741_0,,,,2,3,2,5
C(C(CCC(CO)O)=O)(O)=O,,,5,1,4,0,4
42742_0,,,,2,3,2,5
42744_0,,,,2,3,2,5
C(C(CCO)C(C(O)=O)(C)O)=O,,,5,1,3,0,3
42746_0,,,,2,3,2,5
C(C(C)(C(CO)CC=O)O)(O)=O,,,5,1,3,0,3
42747_0,,,,2,3,2,5
42748_0,,,,2,3,2,5
42749_0,,,,2,3,2,5
42751_0,,,,2,3,2,5
C(C(C)(C(C(CO)=O)C)O)(O)=O,,,5,1,2,0,2
42752_0,,,,2,3,2,5
42754_0,,,,2,3,2,5
C(CO)(C(C)C(C(O)=O)O)=O,,,5,1,2,0,2
42755_0,,,,2,3,2,5
42757_0,,,,2,3,2,5
C(C(C)CO)(O)=O,,,5,1,1,0,1
42758_0,,,,2,3,2,5
42760_0,,,,2,3,2,5
C(C(CO)CCO)(O)=O,,,5,1,2,0,2
42762_0,,,,2,3,2,5
C(CC1C(C(C(O)O1)O)O)O,,,5,1,2,0,2
42764_0,,,,2,3,2,5
C1(C(CO)C(C(CO)O1)O)O,,,5,1,2,0,2
42765_0,,,,2,3,2,5
42766_0,,,,2,3,2,5
42767_0,,,,2,3,2,5
42769_0,,,,2,3,2,5
C1C(C(C(O)O1)CO)O,,,5,1,2,0,2
42771_0,,,,2,3,2,5
C1(COC(CO)C1(CO)O)=O,,,5,1,4,0,4
42772_0,,,,2,3,2,5
42774_0,,,,2,3,2,5
C1(CC(CO)(C(CO)O1)O)=O,,,5,1,3,0,3
42775_0,,,,2,3,2,5
42777_0,,,,2,3,2,5
C1C(C(C(C(O)O1)CO)O)O,,,5,1,2,0,2
42779_0,,,,2,3,2,5
C1(COCC(C1(CO)O)O)=O,,,5,1,4,0,4
42780_0,,,,2,3,2,5
42782_0,,,,2,3,2,5
C1(CC(CO)(C(CO1)O)O)=O,,,5,1,3,0,3
42783_0,,,,2,3,2,5
42785_0,,,,2,3,2,5
C1(C(C(C(CCO)O1)O)O)=O,,,5,1,2,0,2
42786_0,,,,2,3,2,5
42787_0,,,,2,3,2,5
42789_0,,,,2,3,2,5
C(C(C(C(CO)O)O)O)=CCO,,,5,1,2,0,2
42790_0,,,,2,3,2,5
42791_0,,,,2,3,2,5
42792_0,,,,2,3,2,5
42793_0,,,,2,3,2,5
42795_0,,,,2,3,2,5
C(CO)(CO)=CC(CO)=O,,,5,1,3,0,3
42797_0,,,,2,3,2,5
C(CO)(CO)=C(C=O)CO,,,5,1,2,0,2
42799_0,,,,2,3,2,5
C=C(C(CO)=O)C(CO)(CO)O,,,5,1,2,0,2
42801_0,,,,2,3,2,5
C(CO)(CO)=C(C(CO)=O)CO,,,5,1,3,0,3
42803_0,,,,2,3,2,5
C(CO)=C(C=O)C(CO)(CO)O,,,5,1,4,0,4
42805_0,,,,2,3,2,5
C(CO)(C(CO)(CO)O)=CC=O,,,5,1,4,0,4
42807_0,,,,2,3,2,5
C(CO)(CO)=C(C=O)C(CO)O,,,5,1,2,0,2
42809_0,,,,2,3,2,5
C(C(C(CO)=C(CO)CO)O)=O,,,5,1,3,0,3
42810_0,,,,2,3,2,5
42812_0,,,,2,3,2,5
C(CO)(CO)=CC(C(CO)O)=O,,,5,1,2,0,2
42814_0,,,,2,3,2,5
C(CO)=C(CO)CO,,,5,1,2,0,2
42816_0,,,,2,3,2,5
C(CO)(C(C(CO)=C)O)=O,,,5,1,2,0,2
42818_0,,,,2,3,2,5
C(CO)(C(C=CCO)O)=O,,,5,1,2,0,2
42820_0,,,,2,3,2,5
C(CO)(C(C(CO)=CCO)O)=O,,,5,1,3,0,3
42822_0,,,,2,3,2,5
C(CO)(C(C=CC(CO)O)O)=O,,,5,1,2,0,2
42823_0,,,,2,3,2,5
42825_0,,,,2,3,2,5
C(CO)(C(C(C(CO)O)=C)O)=O,,,5,1,2,0,2
42827_0,,,,2,3,2,5
C(CO)(C(CO)O)=CC(CO)=O,,,5,1,2,0,2
42829_0,,,,2,3,2,5
C(CO)(C(CO)O)=C(C=O)CO,,,5,1,2,0,2
42831_0,,,,2,3,2,5
C(CO)(C(CO)O)=CCO,,,5,1,2,0,2
42833_0,,,,2,3,2,5
C(C(CO)O)(C(C(CO)=C)O)=O,,,5,1,2,0,2
42835_0,,,,2,3,2,5
C(C(CO)O)(C(C=CCO)O)=O,,,5,1,2,0,2
42836_0,,,,2,3,2,5
42838_0,,,,2,3,2,5
C(C(CO)=CC(O)=O)=O,,,5,1,4,0,4
42839_0,,,,2,3,2,5
42841_0,,,,2,3,2,5
C(C=C(C(CO)=O)CO)(O)=O,,,5,1,3,0,3
42842_0,,,,2,3,2,5
42843_0,,,,2,3,2,5
42845_0,,,,2,3,2,5
C(C=C(C=O)C(CO)O)(O)=O,,,5,1,4,0,4
42847_0,,,,2,3,2,5
C(C(C(CO)=CC(O)=O)O)=O,,,5,1,5,0,5
42848_0,,,,2,3,2,5
42849_0,,,,2,3,2,5
42851_0,,,,2,3,2,5
C(C(C(C=CCO)(CO)O)O)=O,,,5,1,2,0,2
42852_0,,,,2,3,2,5
42854_0,,,,2,3,2,5
C(C(CO)(CO)O)=CC(CO)=O,,,5,1,3,0,3
42856_0,,,,2,3,2,5
C(C(CO)(CO)O)=C(C=O)CO,,,5,1,2,0,2
42858_0,,,,2,3,2,5
C(C(CO)(CO)O)=CCO,,,5,1,2,0,2
42860_0,,,,2,3,2,5
C(C(CO)(C(CO)O)O)=CCO,,,5,1,2,0,2
42862_0,,,,2,3,2,5
C(C(C)=CC(CO)=O)=O,,,5,1,2,0,2
42864_0,,,,2,3,2,5
C(C)(CO)=CC(C=O)=O,,,5,1,2,0,2
42866_0,,,,2,3,2,5
C(CO)(CC(C=O)=C)=O,,,5,1,2,0,2
42868_0,,,,2,3,2,5
C=C(CO)CC(C=O)=O,,,5,1,2,0,2
42870_0,,,,2,3,2,5
C(C(C)=C(C=O)CO)=O,,,5,1,2,0,2
42872_0,,,,2,3,2,5
C(C)(CO)=C(C=O)C=O,,,5,1,2,0,2
42873_0,,,,2,3,2,5
42875_0,,,,2,3,2,5
C(C(C=O)C(CO)=C)=O,,,5,1,2,0,2
42877_0,,,,2,3,2,5
C(C(C(C(CO)=O)=C)(C)O)=O,,,5,1,3,0,3
42879_0,,,,2,3,2,5
C=C(C(C=O)=O)C(CO)(C)O,,,5,1,3,0,3
42881_0,,,,2,3,2,5
C(C(C)=C(C(CO)=O)CO)=O,,,5,1,3,0,3
42883_0,,,,2,3,2,5
C(C)(CO)=C(C(C=O)=O)CO,,,5,1,2,0,2
42885_0,,,,2,3,2,5
C(CO)(C(C(C=O)=C)CO)=O,,,5,1,3,0,3
42887_0,,,,2,3,2,5
C=C(CO)C(C(C=O)=O)CO,,,5,1,2,0,2
42889_0,,,,2,3,2,5
C(C(C(C=O)=CCO)(C)O)=O,,,5,1,3,0,3
42891_0,,,,2,3,2,5
C(C(C(CO)=CC=O)(C)O)=O,,,5,1,3,0,3
42893_0,,,,2,3,2,5
C(C=C(C=O)C(CO)(C)O)=O,,,5,1,3,0,3
42895_0,,,,2,3,2,5
C(C(C(CO)O)=C(C=O)C)=O,,,5,1,2,0,2
42897_0,,,,2,3,2,5
C(C(C(CO)=C(C=O)C)O)=O,,,5,1,3,0,3
42899_0,,,,2,3,2,5
C(C(C(C=O)=C(CO)C)O)=O,,,5,1,2,0,2
42900_0,,,,2,3,2,5
42902_0,,,,2,3,2,5
C(C(C(C(C=O)=C)CO)O)=O,,,5,1,3,0,3
42904_0,,,,2,3,2,5
C(C(C(CO)=C)C(C=O)O)=O,,,5,1,2,0,2
42905_0,,,,2,3,2,5
42907_0,,,,2,3,2,5
C(C)(CO)=C(C=O)C(CO)=O,,,5,1,2,0,2
42908_0,,,,2,3,2,5
42910_0,,,,2,3,2,5
C(C(C(CO)=O)C(CO)=C)=O,,,5,1,2,0,2
42912_0,,,,2,3,2,5
C(CCO)(C(C(C=O)=C)O)=O,,,5,1,3,0,3
42914_0,,,,2,3,2,5
C(CC(C(C(CO)=C)O)=O)=O,,,5,1,2,0,2
42916_0,,,,2,3,2,5
C(C=C(C=O)C)(C(CO)O)=O,,,5,1,2,0,2
42918_0,,,,2,3,2,5
C(C(C(C=C(CO)C)=O)O)=O,,,5,1,2,0,2
42920_0,,,,2,3,2,5
C(C(CO)O)(CC(C=O)=C)=O,,,5,1,2,0,2
42922_0,,,,2,3,2,5
C(C(C=O)O)(CC(CO)=C)=O,,,5,1,2,0,2
42924_0,,,,2,3,2,5
C(CO)=C(C=O)C,,,5,1,2,0,2
42926_0,,,,2,3,2,5
C(C)(CO)=CC=O,,,5,1,2,0,2
42928_0,,,,2,3,2,5
C=C(C=O)CCO,,,5,1,2,0,2
42930_0,,,,2,3,2,5
C(CC(CO)=C)=O,,,5,1,2,0,2
42931_0,,,,2,3,2,5
42933_0,,,,2,3,2,5
C=C(CO)C(C(C=O)=O)O,,,5,1,2,0,2
42935_0,,,,2,3,2,5
C=C(C=O)C(CO)O,,,5,1,7,0,7
42937_0,,,,2,3,2,5
C(C(C(CO)=C)O)=O,,,5,1,5,0,5
42939_0,,,,2,3,2,5
C(C=CC(CO)=O)(C)=O,,,5,1,2,0,2
42941_0,,,,2,3,2,5
C(C(CO)=CC(C)=O)=O,,,5,1,2,0,2
42943_0,,,,2,3,2,5
C(C)(C(C(C(CO)=O)=C)O)=O,,,5,1,3,0,3
42945_0,,,,2,3,2,5
C(C(CO)=CC(C)=O)(CO)=O,,,5,1,3,0,3
42947_0,,,,2,3,2,5
C(C)(C(C(C=O)=CCO)O)=O,,,5,1,3,0,3
42949_0,,,,2,3,2,5
C(C)(C(C(CO)=CC=O)O)=O,,,5,1,3,0,3
42951_0,,,,2,3,2,5
C(C(C(CO)O)=CC(C)=O)=O,,,5,1,2,0,2
42953_0,,,,2,3,2,5
C(C(C(CO)=CC(C)=O)O)=O,,,5,1,3,0,3
42954_0,,,,2,3,2,5
42956_0,,,,2,3,2,5
C(C=CC(C)=O)(C(CO)O)=O,,,5,1,2,0,2
42958_0,,,,2,3,2,5
C(CO)=CC(C)=O,,,5,1,2,0,2
42960_0,,,,2,3,2,5
C(CC(C=O)=O)=CCO,,,5,1,3,0,3
42961_0,,,,2,3,2,5
42963_0,,,,2,3,2,5
C(CCO)=CC(C=O)=O,,,5,1,2,0,2
42964_0,,,,2,3,2,5
42966_0,,,,2,3,2,5
C(CO)=C(CO)CC(C=O)=O,,,5,1,3,0,3
42968_0,,,,2,3,2,5
C(CO)(CC(C=O)=CCO)=O,,,5,1,2,0,2
42970_0,,,,2,3,2,5
C(CO)(CCO)=CC(C=O)=O,,,5,1,3,0,3
42972_0,,,,2,3,2,5
C(C(CCO)=CC(CO)=O)=O,,,5,1,2,0,2
42974_0,,,,2,3,2,5
C(C=CC(CO)=O)(CCO)=O,,,5,1,2,0,2
42976_0,,,,2,3,2,5
C(C(CCO)O)=CC(C=O)=O,,,5,1,2,0,2
42977_0,,,,2,3,2,5
42979_0,,,,2,3,2,5
C(CC(C=O)=O)=CC(CO)O,,,5,1,3,0,3
42981_0,,,,2,3,2,5
C(C(C=CCC(CO)=O)O)=O,,,5,1,3,0,3
42983_0,,,,2,3,2,5
C(CC(CO)O)=CC(C=O)=O,,,5,1,2,0,2
42985_0,,,,2,3,2,5
C(C(CC=CC(CO)=O)O)=O,,,5,1,3,0,3
42987_0,,,,2,3,2,5
C(CO)(CC=CC(CO)=O)=O,,,5,1,3,0,3
42988_0,,,,2,3,2,5
42989_0,,,,2,3,2,5
42991_0,,,,2,3,2,5
C(CO)(CC(CO)=CC=O)=O,,,5,1,2,0,2
42992_0,,,,2,3,2,5
42994_0,,,,2,3,2,5
C(CC(CO)=CC(CO)=O)=O,,,5,1,2,0,2
42996_0,,,,2,3,2,5
C(C)(C(C=CC(CO)=O)O)=O,,,5,1,2,0,2
42998_0,,,,2,3,2,5
C=C(C(CO)O)CC(C=O)=O,,,5,1,2,0,2
43000_0,,,,2,3,2,5
C(C(C(CC(CO)=O)=C)O)=O,,,5,1,2,0,2
43002_0,,,,2,3,2,5
C(C)(C(CO)O)=CC(C=O)=O,,,5,1,2,0,2
43004_0,,,,2,3,2,5
C(C(C(C)=CC(CO)=O)O)=O,,,5,1,2,0,2
43006_0,,,,2,3,2,5
C(CO)(CC=C)=O,,,5,1,2,0,2
43008_0,,,,2,3,2,5
C(C)=CC(CO)=O,,,5,1,2,0,2
43009_0,,,,2,3,2,5
43010_0,,,,2,3,2,5
43011_0,,,,2,3,2,5
43012_0,,,,2,3,2,5
43014_0,,,,2,3,2,5
C(C(C(CO)O)=CC(CO)=O)=O,,,5,1,4,0,4
43015_0,,,,2,3,2,5
43017_0,,,,2,3,2,5
C(C(CO)O)=CC(CO)=O,,,5,1,4,0,4
43019_0,,,,2,3,2,5
C(C(C(CO)O)O)=CC(CO)=O,,,5,1,2,0,2
43020_0,,,,2,3,2,5
43021_0,,,,2,3,2,5
43022_0,,,,2,3,2,5
43024_0,,,,2,3,2,5
C(CC=C(C=O)CO)=O,,,5,1,2,0,2
43026_0,,,,2,3,2,5
C(CCO)=C(C=O)C=O,,,5,1,2,0,2
43027_0,,,,2,3,2,5
43029_0,,,,2,3,2,5
C(C(C=O)C=CCO)=O,,,5,1,2,0,2
43030_0,,,,2,3,2,5
43032_0,,,,2,3,2,5
C=C(C(C=O)=O)C(CCO)O,,,5,1,3,0,3
43034_0,,,,2,3,2,5
C(CC=C(C(CO)=O)CO)=O,,,5,1,3,0,3
43036_0,,,,2,3,2,5
C(CCO)=C(C(C=O)=O)CO,,,5,1,2,0,2
43037_0,,,,2,3,2,5
43039_0,,,,2,3,2,5
C(C(C(C=O)=O)CO)=CCO,,,5,1,2,0,2
43040_0,,,,2,3,2,5
43041_0,,,,2,3,2,5
43043_0,,,,2,3,2,5
C(C=C(C=O)C(CCO)O)=O,,,5,1,3,0,3
43045_0,,,,2,3,2,5
C(CC=C(C=O)C(CO)O)=O,,,5,1,2,0,2
43047_0,,,,2,3,2,5
C(CC=C(CO)C(C=O)O)=O,,,5,1,3,0,3
43049_0,,,,2,3,2,5
C(C(C(C=O)=CCCO)O)=O,,,5,1,2,0,2
43050_0,,,,2,3,2,5
43052_0,,,,2,3,2,5
C(C(C(C=CC=O)CO)O)=O,,,5,1,3,0,3
43054_0,,,,2,3,2,5
C(C(C=CCO)C(C=O)O)=O,,,5,1,2,0,2
43055_0,,,,2,3,2,5
43057_0,,,,2,3,2,5
C(CCO)=C(C=O)C(CO)=O,,,5,1,2,0,2
43058_0,,,,2,3,2,5
43060_0,,,,2,3,2,5
C(C(C(CO)=O)C=CCO)=O,,,5,1,2,0,2
43061_0,,,,2,3,2,5
43063_0,,,,2,3,2,5
C(CC(C(C=CCO)O)=O)=O,,,5,1,2,0,2
43064_0,,,,2,3,2,5
43066_0,,,,2,3,2,5
C(C(C(C=CCCO)=O)O)=O,,,5,1,2,0,2
43067_0,,,,2,3,2,5
43069_0,,,,2,3,2,5
C(C(C=O)O)(CC=CCO)=O,,,5,1,2,0,2
43071_0,,,,2,3,2,5
C(CC=CCO)=O,,,5,1,2,0,2
43073_0,,,,2,3,2,5
C(CCO)=CC=O,,,5,1,2,0,2
43074_0,,,,2,3,2,5
43075_0,,,,2,3,2,5
43076_0,,,,2,3,2,5
43078_0,,,,2,3,2,5
C(C(C=CCO)O)=O,,,5,1,5,0,5
43080_0,,,,2,3,2,5
C(C(C=O)C(CO)=CCO)=O,,,5,1,3,0,3
43081_0,,,,2,3,2,5
43083_0,,,,2,3,2,5
C(CO)(CCO)=C(C=O)C=O,,,5,1,3,0,3
43085_0,,,,2,3,2,5
C(C(CCO)=C(C=O)CO)=O,,,5,1,2,0,2
43087_0,,,,2,3,2,5
C(C=C(C=O)CO)(CCO)=O,,,5,1,2,0,2
43089_0,,,,2,3,2,5
C(C(CCO)O)=C(C=O)C=O,,,5,1,2,0,2
43090_0,,,,2,3,2,5
43092_0,,,,2,3,2,5
C(C(C=O)C=CC(CO)O)=O,,,5,1,2,0,2
43093_0,,,,2,3,2,5
43095_0,,,,2,3,2,5
C(CC(CO)O)=C(C=O)C=O,,,5,1,2,0,2
43097_0,,,,2,3,2,5
C(C(CC=C(C=O)CO)O)=O,,,5,1,2,0,2
43098_0,,,,2,3,2,5
43100_0,,,,2,3,2,5
C(CO)(CC=C(C=O)CO)=O,,,5,1,2,0,2
43101_0,,,,2,3,2,5
43102_0,,,,2,3,2,5
43103_0,,,,2,3,2,5
43105_0,,,,2,3,2,5
C(CC(CO)=C(C=O)CO)=O,,,5,1,2,0,2
43107_0,,,,2,3,2,5
C(C)(C(C=C(C=O)CO)O)=O,,,5,1,2,0,2
43109_0,,,,2,3,2,5
C(C(C=O)C(C(CO)O)=C)=O,,,5,1,2,0,2
43110_0,,,,2,3,2,5
43112_0,,,,2,3,2,5
C(C)(C(CO)O)=C(C=O)C=O,,,5,1,2,0,2
43114_0,,,,2,3,2,5
C(C(C(C)=C(C=O)CO)O)=O,,,5,1,2,0,2
43115_0,,,,2,3,2,5
43117_0,,,,2,3,2,5
C(C)=C(C=O)CO,,,5,1,2,0,2
43118_0,,,,2,3,2,5
43120_0,,,,2,3,2,5
C(C(CO)=C(C=O)CO)=O,,,5,1,2,0,2
43121_0,,,,2,3,2,5
43122_0,,,,2,3,2,5
43124_0,,,,2,3,2,5
C(C(C(CO)O)=C(C=O)CO)=O,,,5,1,4,0,4
43125_0,,,,2,3,2,5
43127_0,,,,2,3,2,5
C(C(CO)O)=C(C=O)CO,,,5,1,2,0,2
43129_0,,,,2,3,2,5
C(C(C(CO)O)O)=C(C=O)CO,,,5,1,2,0,2
43130_0,,,,2,3,2,5
43131_0,,,,2,3,2,5
43133_0,,,,2,3,2,5
C=C(C=O)CO,,,5,1,6,0,6
43135_0,,,,2,3,2,5
C(CO)=C(C=O)CO,,,5,1,6,0,6
43137_0,,,,2,3,2,5
C(CO)=C(C=O)CCO,,,5,1,3,0,3
43139_0,,,,2,3,2,5
C(CO)(CCO)=CC=O,,,5,1,3,0,3
43140_0,,,,2,3,2,5
43142_0,,,,2,3,2,5
C(CC(CO)=CCO)=O,,,5,1,3,0,3
43143_0,,,,2,3,2,5
43145_0,,,,2,3,2,5
C(CO)=C(CO)C(C(C=O)=O)O,,,5,1,3,0,3
43147_0,,,,2,3,2,5
C(CO)=C(C=O)C(CO)O,,,5,1,5,0,5
43149_0,,,,2,3,2,5
C(C(C(CO)=CCO)O)=O,,,5,1,5,0,5
43151_0,,,,2,3,2,5
C(CO)=CC(CCO)=O,,,5,1,2,0,2
43153_0,,,,2,3,2,5
C(CO)(C(C=C)CO)=O,,,5,1,3,0,3
43155_0,,,,2,3,2,5
C(C)=C(C(CO)=O)CO,,,5,1,3,0,3
43157_0,,,,2,3,2,5
C=C(C(CO)=O)C(C)O,,,5,1,2,0,2
43158_0,,,,2,3,2,5
43160_0,,,,2,3,2,5
C(C(CO)=C(C(CO)=O)CO)=O,,,5,1,3,0,3
43161_0,,,,2,3,2,5
43162_0,,,,2,3,2,5
43164_0,,,,2,3,2,5
C(C(CO)=CC(CO)=O)(CO)=O,,,5,1,3,0,3
43165_0,,,,2,3,2,5
43167_0,,,,2,3,2,5
C(C(CO)O)=C(C(CO)=O)CO,,,5,1,3,0,3
43169_0,,,,2,3,2,5
C=C(C(CO)=O)C(C(CO)O)O,,,5,1,2,0,2
43170_0,,,,2,3,2,5
43171_0,,,,2,3,2,5
43172_0,,,,2,3,2,5
43173_0,,,,2,3,2,5
43175_0,,,,2,3,2,5
C=C(C(CO)=O)CO,,,5,1,5,0,5
43177_0,,,,2,3,2,5
C(CO)=C(C(CO)=O)CO,,,5,1,3,0,3
43179_0,,,,2,3,2,5
C=C(C(CO)=O)C(CO)O,,,5,1,2,0,2
43181_0,,,,2,3,2,5
C(C(CC=CCO)O)=O,,,5,1,2,0,2
43183_0,,,,2,3,2,5
C(CC(CO)O)=CC=O,,,5,1,2,0,2
43185_0,,,,2,3,2,5
C(C(C=CCCO)O)=O,,,5,1,2,0,2
43187_0,,,,2,3,2,5
C(CC=CC(CO)O)=O,,,5,1,2,0,2
43188_0,,,,2,3,2,5
43189_0,,,,2,3,2,5
43191_0,,,,2,3,2,5
C(C(C=CC(CO)O)O)=O,,,5,1,5,0,5
43192_0,,,,2,3,2,5
43194_0,,,,2,3,2,5
C(C(C(C=C)CO)O)=O,,,5,1,3,0,3
43196_0,,,,2,3,2,5
C(C)=C(C=O)C(CO)O,,,5,1,2,0,2
43198_0,,,,2,3,2,5
C(C(C(CO)=CC)O)=O,,,5,1,3,0,3
43200_0,,,,2,3,2,5
C(CO)=C(C=O)C(C)O,,,5,1,5,0,5
43202_0,,,,2,3,2,5
C(CO)(C(C)O)=CC=O,,,5,1,4,0,4
43203_0,,,,2,3,2,5
43204_0,,,,2,3,2,5
43206_0,,,,2,3,2,5
C(C(C(CO)=C(C=O)CO)O)=O,,,5,1,4,0,4
43207_0,,,,2,3,2,5
43208_0,,,,2,3,2,5
43209_0,,,,2,3,2,5
43210_0,,,,2,3,2,5
43212_0,,,,2,3,2,5
C(C(C(CO)=CC(CO)=O)O)=O,,,5,1,4,0,4
43213_0,,,,2,3,2,5
43214_0,,,,2,3,2,5
43216_0,,,,2,3,2,5
C(C(CO)O)=C(C=O)C(CO)O,,,5,1,2,0,2
43218_0,,,,2,3,2,5
C(C(C(CO)=CC(CO)O)O)=O,,,5,1,3,0,3
43220_0,,,,2,3,2,5
C(CO)=C(C=O)C(C(CO)O)O,,,5,1,3,0,3
43222_0,,,,2,3,2,5
C(CO)(C(C(CO)O)O)=CC=O,,,5,1,3,0,3
43223_0,,,,2,3,2,5
43224_0,,,,2,3,2,5
43225_0,,,,2,3,2,5
43226_0,,,,2,3,2,5
43227_0,,,,2,3,2,5
43228_0,,,,2,3,2,5
43229_0,,,,2,3,2,5
43231_0,,,,2,3,2,5
C(CO)(CC=CCO)=O,,,5,1,2,0,2
43233_0,,,,2,3,2,5
C(CCO)=CC(CO)=O,,,5,1,2,0,2
43234_0,,,,2,3,2,5
43235_0,,,,2,3,2,5
43236_0,,,,2,3,2,5
43237_0,,,,2,3,2,5
43238_0,,,,2,3,2,5
43239_0,,,,2,3,2,5
43240_0,,,,2,3,2,5
43241_0,,,,2,3,2,5
43242_0,,,,2,3,2,5
43243_0,,,,2,3,2,5
43244_0,,,,2,3,2,5
43245_0,,,,2,3,2,5
43246_0,,,,2,3,2,5
43247_0,,,,2,3,2,5
43248_0,,,,2,3,2,5
43249_0,,,,2,3,2,5
43250_0,,,,2,3,2,5
43251_0,,,,2,3,2,5
43253_0,,,,2,3,2,5
C(CCO)(C(C=C)O)=O,,,5,1,3,0,3
43255_0,,,,2,3,2,5
C(C)(C(C=CCO)O)=O,,,5,1,2,0,2
43257_0,,,,2,3,2,5
C(C(C(C)=CCO)O)=O,,,5,1,2,0,2
43259_0,,,,2,3,2,5
C(C)(C(CO)O)=CC=O,,,5,1,2,0,2
43261_0,,,,2,3,2,5
C(C(C(CCO)=C)O)=O,,,5,1,2,0,2
43263_0,,,,2,3,2,5
C(CC(C(CO)O)=C)=O,,,5,1,2,0,2
43264_0,,,,2,3,2,5
43266_0,,,,2,3,2,5
C=C(C(CO)O)C(C(C=O)=O)O,,,5,1,2,0,2
43268_0,,,,2,3,2,5
C(C(C(C(CO)O)=C)O)=O,,,5,1,5,0,5
43270_0,,,,2,3,2,5
C(C(CO)O)(CC=C)=O,,,5,1,2,0,2
43272_0,,,,2,3,2,5
C(C)=CC(C(CO)O)=O,,,5,1,2,0,2
43273_0,,,,2,3,2,5
43274_0,,,,2,3,2,5
43275_0,,,,2,3,2,5
43277_0,,,,2,3,2,5
C(C(CO)O)=CC(C(CO)O)=O,,,5,1,2,0,2
43278_0,,,,2,3,2,5
43279_0,,,,2,3,2,5
43280_0,,,,2,3,2,5
43282_0,,,,2,3,2,5
C(CO)=CC(C(CO)O)=O,,,5,1,4,0,4
43284_0,,,,2,3,2,5
C(C)=CCO,,,5,1,2,0,2
43286_0,,,,2,3,2,5
C=CCCO,,,5,1,2,0,2
43287_0,,,,2,3,2,5
43289_0,,,,2,3,2,5
C=CC(CO)O,,,5,1,6,0,6
43290_0,,,,2,3,2,5
43291_0,,,,2,3,2,5
43293_0,,,,2,3,2,5
C(C(CO)O)=CCO,,,5,1,3,0,3
43295_0,,,,2,3,2,5
C(C(C(CO)O)O)=CCO,,,5,1,2,0,2
43296_0,,,,2,3,2,5
43298_0,,,,2,3,2,5
C=CC(CO)(C(C(CO)O)O)O,,,5,1,2,0,2
43299_0,,,,2,3,2,5
43300_0,,,,2,3,2,5
43301_0,,,,2,3,2,5
43302_0,,,,2,3,2,5
43303_0,,,,2,3,2,5
43304_0,,,,2,3,2,5
43306_0,,,,2,3,2,5
C(CO)(C(C(CO)=C)(CO)O)=O,,,5,1,2,0,2
43308_0,,,,2,3,2,5
C(CO)(C(C=CCO)(CO)O)=O,,,5,1,2,0,2
43310_0,,,,2,3,2,5
C(C(C(CO)=C)(CO)O)(O)=O,,,5,1,2,0,2
43312_0,,,,2,3,2,5
C(C(C=CCO)(CO)O)(O)=O,,,5,1,4,0,4
43314_0,,,,2,3,2,5
C(C)(C(C(C=O)=C)(CO)O)=O,,,5,1,3,0,3
43316_0,,,,2,3,2,5
C(C(C(C)=O)(C(CO)=C)O)=O,,,5,1,2,0,2
43317_0,,,,2,3,2,5
43319_0,,,,2,3,2,5
C=C(CO)C(C(C=O)=O)(CO)O,,,5,1,2,0,2
43321_0,,,,2,3,2,5
C=C(C=O)C(CO)(CO)O,,,5,1,3,0,3
43323_0,,,,2,3,2,5
C(C(C(CO)=C)(CO)O)=O,,,5,1,2,0,2
43325_0,,,,2,3,2,5
C=C(C=O)C(CO)(C(CO)O)O,,,5,1,3,0,3
43327_0,,,,2,3,2,5
C(C(C(CO)=C)(C(CO)O)O)=O,,,5,1,2,0,2
43329_0,,,,2,3,2,5
C(C)(C(C=CC=O)(CO)O)=O,,,5,1,4,0,4
43331_0,,,,2,3,2,5
C(C(C(C)=O)(C=CCO)O)=O,,,5,1,2,0,2
43332_0,,,,2,3,2,5
43334_0,,,,2,3,2,5
C(C(C(C=O)=O)(CO)O)=CCO,,,5,1,2,0,2
43335_0,,,,2,3,2,5
43337_0,,,,2,3,2,5
C(C(C=CCO)(CO)O)=O,,,5,1,2,0,2
43338_0,,,,2,3,2,5
43340_0,,,,2,3,2,5
C(C(C=CCO)(C(CO)O)O)=O,,,5,1,2,0,2
43341_0,,,,2,3,2,5
43343_0,,,,2,3,2,5
C(C(C(CO)=CCO)(CO)O)=O,,,5,1,3,0,3
43345_0,,,,2,3,2,5
C(C(C=CC(CO)(CO)O)O)=O,,,5,1,4,0,4
43347_0,,,,2,3,2,5
C(C(C=CC(CO)O)(CO)O)=O,,,5,1,2,0,2
43348_0,,,,2,3,2,5
43349_0,,,,2,3,2,5
43350_0,,,,2,3,2,5
43352_0,,,,2,3,2,5
C(C)(C(C=C)(CO)O)=O,,,5,1,2,0,2
43354_0,,,,2,3,2,5
C(C(C(C(CO)(CO)O)=C)O)=O,,,5,1,4,0,4
43356_0,,,,2,3,2,5
C(C(C(C(CO)O)=C)(CO)O)=O,,,5,1,2,0,2
43357_0,,,,2,3,2,5
43359_0,,,,2,3,2,5
C=CC(CO)(CO)O,,,5,1,3,0,3
43361_0,,,,2,3,2,5
C=CC(CO)(C(CO)O)O,,,5,1,3,0,3
43362_0,,,,2,3,2,5
43364_0,,,,2,3,2,5
C(C(C(C=O)=C)(CCO)O)=O,,,5,1,3,0,3
43365_0,,,,2,3,2,5
43367_0,,,,2,3,2,5
C=C(C(O)=O)C(CO)(C)O,,,5,1,2,0,2
43369_0,,,,2,3,2,5
C(C(C(CO)=C)(C)O)(O)=O,,,5,1,2,0,2
43371_0,,,,2,3,2,5
C(CO)=C(C(O)=O)C(CO)(C)O,,,5,1,2,0,2
43373_0,,,,2,3,2,5
C(C(C(CO)=C)(CCO)O)(O)=O,,,5,1,2,0,2
43374_0,,,,2,3,2,5
43375_0,,,,2,3,2,5
43377_0,,,,2,3,2,5
C(C(C=CC=O)(CCO)O)=O,,,5,1,3,0,3
43378_0,,,,2,3,2,5
43380_0,,,,2,3,2,5
C=C(C(O)=O)C(CCO)O,,,5,1,2,0,2
43382_0,,,,2,3,2,5
C(C(C=CCO)(C)O)(O)=O,,,5,1,2,0,2
43384_0,,,,2,3,2,5
C(CO)=C(C(O)=O)C(CCO)O,,,5,1,2,0,2
43386_0,,,,2,3,2,5
C(C(C=CCO)(CCO)O)(O)=O,,,5,1,2,0,2
43387_0,,,,2,3,2,5
43389_0,,,,2,3,2,5
C=C(C(O)=O)C(CO)(CCO)O,,,5,1,3,0,3
43391_0,,,,2,3,2,5
C(C(C(CO)=CCO)(C)O)(O)=O,,,5,1,3,0,3
43392_0,,,,2,3,2,5
43394_0,,,,2,3,2,5
C=C(C(O)=O)C(C(CCO)O)O,,,5,1,2,0,2
43396_0,,,,2,3,2,5
C=C(C(O)=O)C(CC(CO)O)O,,,5,1,2,0,2
43398_0,,,,2,3,2,5
C(C(C=CC(CO)O)(C)O)(O)=O,,,5,1,2,0,2
43399_0,,,,2,3,2,5
43400_0,,,,2,3,2,5
43401_0,,,,2,3,2,5
43402_0,,,,2,3,2,5
43404_0,,,,2,3,2,5
C=C(C(O)=O)C(C)(C(CO)O)O,,,5,1,2,0,2
43406_0,,,,2,3,2,5
C(C(C(C(CO)O)=C)(C)O)(O)=O,,,5,1,2,0,2
43407_0,,,,2,3,2,5
43408_0,,,,2,3,2,5
43409_0,,,,2,3,2,5
43410_0,,,,2,3,2,5
43411_0,,,,2,3,2,5
43413_0,,,,2,3,2,5
C=CC(C(CO)(CO)O)=O,,,5,1,2,0,2
43415_0,,,,2,3,2,5
C=C(C(C(CO)O)=O)CO,,,5,1,2,0,2
43416_0,,,,2,3,2,5
43417_0,,,,2,3,2,5
43418_0,,,,2,3,2,5
43419_0,,,,2,3,2,5
43420_0,,,,2,3,2,5
43422_0,,,,2,3,2,5
C(CO)(CC1C(C(C(O)O1)O)O)=O,,,5,1,3,0,3
43423_0,,,,2,3,2,5
43424_0,,,,2,3,2,5
43425_0,,,,2,3,2,5
43427_0,,,,2,3,2,5
C(C(C1C(C(C(O)O1)CO)O)O)=O,,,5,1,2,0,2
43428_0,,,,2,3,2,5
43429_0,,,,2,3,2,5
43430_0,,,,2,3,2,5
43432_0,,,,2,3,2,5
C1C(CO)(CC(CO)(O)O1)O,,,5,1,3,0,3
43434_0,,,,2,3,2,5
C1C(CO)(C(C(O)O1)CO)O,,,5,1,2,0,2
43436_0,,,,2,3,2,5
C1C(CO)(C(CO)C(CO)(O)O1)O,,,5,1,3,0,3
43438_0,,,,2,3,2,5
C(C1C(C(O)OC1(CO)CO)O)O,,,5,1,2,0,2
43440_0,,,,2,3,2,5
C1C(CO)(C(C(O)O1)C(CO)O)O,,,5,1,2,0,2
43441_0,,,,2,3,2,5
43443_0,,,,2,3,2,5
C1C(CO)(C(C(CCO)(O)O1)O)O,,,5,1,3,0,3
43445_0,,,,2,3,2,5
C1C(CO)(CC(C(CO)O)(O)O1)O,,,5,1,2,0,2
43446_0,,,,2,3,2,5
43448_0,,,,2,3,2,5
C(C1(C(C(C(CCO)O1)O)O)O)O,,,5,1,2,0,2
43450_0,,,,2,3,2,5
C1C(CCO)(C(C(CO)(O)O1)O)O,,,5,1,2,0,2
43452_0,,,,2,3,2,5
CC1(C(CO)OC(CO)(C1O)O)O,,,5,1,2,0,2
43453_0,,,,2,3,2,5
43455_0,,,,2,3,2,5
C1C(CC(CO)(O)O1)(C(CO)O)O,,,5,1,2,0,2
43457_0,,,,2,3,2,5
C(C1(CC(CO)(C(CO)O1)O)O)O,,,5,1,2,0,2
43459_0,,,,2,3,2,5
C1C(C(CO)O)(C(C(O)O1)CO)O,,,5,1,2,0,2
43461_0,,,,2,3,2,5
C(C1(C(CO)OC(C1CO)O)O)O,,,5,1,2,0,2
43462_0,,,,2,3,2,5
43464_0,,,,2,3,2,5
C1(C(C(CO)C(O)O1)O)=O,,,5,1,2,0,2
43466_0,,,,2,3,2,5
C1(C(C(CO)C(CO)(O)O1)O)=O,,,5,1,3,0,3
43468_0,,,,2,3,2,5
C(C1C(CO)C(C(O1)O)O)(O)=O,,,5,1,2,0,2
43470_0,,,,2,3,2,5
C1(C(C(C(O)O1)C(CO)O)O)=O,,,5,1,2,0,2
43471_0,,,,2,3,2,5
43472_0,,,,2,3,2,5
43473_0,,,,2,3,2,5
43474_0,,,,2,3,2,5
43476_0,,,,2,3,2,5
C1(C(CO)(C(C(CCO)O1)O)O)O,,,5,1,2,0,2
43478_0,,,,2,3,2,5
C(C(CO)(C1C(CC(O)O1)O)O)O,,,5,1,2,0,2
43480_0,,,,2,3,2,5
C1(C(C(CO)(C(CCO)O1)O)O)O,,,5,1,2,0,2
43481_0,,,,2,3,2,5
43483_0,,,,2,3,2,5
C(C1(CC(C(CO)(CO)O1)O)O)O,,,5,1,3,0,3
43485_0,,,,2,3,2,5
C1(C(CO)C(C(CO)(CO)O1)O)O,,,5,1,2,0,2
43487_0,,,,2,3,2,5
C1(C(O)OC(CO)(C)C1)=O,,,5,1,2,0,2
43489_0,,,,2,3,2,5
C1(C(O)OC(CO)(C)C1CO)=O,,,5,1,2,0,2
43491_0,,,,2,3,2,5
C(CO)(C1COC(C1(C)O)O)=O,,,5,1,2,0,2
43493_0,,,,2,3,2,5
C(C1C(CO)OC(C1(C)O)O)=O,,,5,1,2,0,2
43495_0,,,,2,3,2,5
C(C1C(CO)C(C)(C(O1)O)O)=O,,,5,1,2,0,2
43497_0,,,,2,3,2,5
C(C1(C)C(CO)C(C(O1)O)O)=O,,,5,1,2,0,2
43499_0,,,,2,3,2,5
C(C1C(C(O)OC1(C)CO)O)=O,,,5,1,2,0,2
43501_0,,,,2,3,2,5
C1(C(O)OC(CO)(C)C1O)=O,,,5,1,2,0,2
43503_0,,,,2,3,2,5
C(CO)(C1COC(C)(C1O)O)=O,,,5,1,2,0,2
43505_0,,,,2,3,2,5
C(C1C(CO)OC(C)(C1O)O)=O,,,5,1,2,0,2
43507_0,,,,2,3,2,5
C(C1C(CO)C(C(C)(O1)O)O)=O,,,5,1,2,0,2
43509_0,,,,2,3,2,5
C(C)(C1C(CO)C(C(O1)O)O)=O,,,5,1,2,0,2
43511_0,,,,2,3,2,5
C1(C(O)OC(CCO)C1)=O,,,5,1,2,0,2
43513_0,,,,2,3,2,5
C1(C(O)OC(CO)(CCO)C1)=O,,,5,1,3,0,3
43515_0,,,,2,3,2,5
C(C1(CC(C(CCO)O1)O)O)=O,,,5,1,2,0,2
43517_0,,,,2,3,2,5
C(CC1C(CC(CO)(O)O1)O)=O,,,5,1,2,0,2
43519_0,,,,2,3,2,5
C(CO)(CC1C(CC(O)O1)O)=O,,,5,1,3,0,3
43521_0,,,,2,3,2,5
C1(C(O)OC(C(CCO)O)C1)=O,,,5,1,2,0,2
43523_0,,,,2,3,2,5
C(CO)(CC1CC(C(O)O1)O)=O,,,5,1,2,0,2
43525_0,,,,2,3,2,5
C1(C(O)OC(CC(CO)O)C1)=O,,,5,1,2,0,2
43527_0,,,,2,3,2,5
C(C1(CC(CO1)(CCO)O)O)=O,,,5,1,2,0,2
43529_0,,,,2,3,2,5
C(CC1(COC(CO)(C1)O)O)=O,,,5,1,2,0,2
43530_0,,,,2,3,2,5
43532_0,,,,2,3,2,5
C(C)(C1C(CC(CO)(O1)O)O)=O,,,5,1,2,0,2
43534_0,,,,2,3,2,5
C(C1(CC(C)(C(CO)O1)O)O)=O,,,5,1,2,0,2
43536_0,,,,2,3,2,5
C(C1C(C)(CC(CO)(O1)O)O)=O,,,5,1,2,0,2
43538_0,,,,2,3,2,5
C1(C(O)OC(C)(C(CO)O)C1)=O,,,5,1,2,0,2
43539_0,,,,2,3,2,5
43540_0,,,,2,3,2,5
43541_0,,,,2,3,2,5
43542_0,,,,2,3,2,5
43544_0,,,,2,3,2,5
C(C1(C(CO)OC(CO)(C1)O)O)=O,,,5,1,2,0,2
43545_0,,,,2,3,2,5
43547_0,,,,2,3,2,5
C(C1(CC(C(CO)O1)O)O)O,,,5,1,3,0,3
43549_0,,,,2,3,2,5
C(C1(CC(C(C(CO)O)O1)O)O)O,,,5,1,2,0,2
43550_0,,,,2,3,2,5
43552_0,,,,2,3,2,5
C1C(CC(CO)(O)O1)O,,,5,1,2,0,2
43554_0,,,,2,3,2,5
C1(C(O)OC(CCO)C1CO)=O,,,5,1,2,0,2
43556_0,,,,2,3,2,5
C(CC1C(CO)C(C(O)O1)O)=O,,,5,1,2,0,2
43558_0,,,,2,3,2,5
C(C1C(CCO)OC(C1O)O)=O,,,5,1,2,0,2
43559_0,,,,2,3,2,5
43560_0,,,,2,3,2,5
43562_0,,,,2,3,2,5
C1(C(O)OC(CCO)C1O)=O,,,5,1,2,0,2
43563_0,,,,2,3,2,5
43565_0,,,,2,3,2,5
C(C1C(O)OC(C1O)CCO)=O,,,5,1,2,0,2
43567_0,,,,2,3,2,5
C(CC1C(C(C(O)O1)CO)O)=O,,,5,1,2,0,2
43568_0,,,,2,3,2,5
43569_0,,,,2,3,2,5
43571_0,,,,2,3,2,5
C(C1C(O)OCC1(CCO)O)=O,,,5,1,2,0,2
43572_0,,,,2,3,2,5
43574_0,,,,2,3,2,5
C(C)(C1C(C(CO)C(O1)O)O)=O,,,5,1,2,0,2
43576_0,,,,2,3,2,5
C(C1C(O)OC(CO)C1(C)O)=O,,,5,1,2,0,2
43578_0,,,,2,3,2,5
C(C1C(C)(C(CO)C(O1)O)O)=O,,,5,1,2,0,2
43579_0,,,,2,3,2,5
43581_0,,,,2,3,2,5
C(C1(COC(C1CO)O)O)=O,,,5,1,2,0,2
43582_0,,,,2,3,2,5
43584_0,,,,2,3,2,5
C(C1(C(CO)OC(C1CO)O)O)=O,,,5,1,2,0,2
43586_0,,,,2,3,2,5
C(C(C1C(C(C(O)O1)CO)O)O)O,,,5,1,2,0,2
43588_0,,,,2,3,2,5
C1(C(O)OC(CO)(CCO)C1O)=O,,,5,1,3,0,3
43589_0,,,,2,3,2,5
43591_0,,,,2,3,2,5
C(C1(COC(CO)(C1CO)O)O)=O,,,5,1,3,0,3
43592_0,,,,2,3,2,5
43594_0,,,,2,3,2,5
C(CO)(C1COC(C1(CO)O)O)=O,,,5,1,2,0,2
43596_0,,,,2,3,2,5
C(CO)(C1COC(CO)(C1O)O)=O,,,5,1,2,0,2
43598_0,,,,2,3,2,5
C(C1(C(CO)C(C(CO)O1)O)O)O,,,5,1,3,0,3
43599_0,,,,2,3,2,5
43601_0,,,,2,3,2,5
C(CO)(C1COC(C1O)O)=O,,,5,1,3,0,3
43603_0,,,,2,3,2,5
C1C(C(CO)C(CO)(O)O1)O,,,5,1,3,0,3
43605_0,,,,2,3,2,5
C(CC1C(CC(O)O1)O)O,,,5,1,2,0,2
43607_0,,,,2,3,2,5
C1(C(O)OC(C(CCO)O)C1O)=O,,,5,1,2,0,2
43608_0,,,,2,3,2,5
43609_0,,,,2,3,2,5
43611_0,,,,2,3,2,5
C(C1(C(C(C(CCO)O1)O)O)O)=O,,,5,1,2,0,2
43613_0,,,,2,3,2,5
C(CC1CC(C(O)O1)O)O,,,5,1,2,0,2
43615_0,,,,2,3,2,5
C1(C(O)OC(CC(CO)O)C1O)=O,,,5,1,2,0,2
43616_0,,,,2,3,2,5
43618_0,,,,2,3,2,5
C(C(C1CC(C(O)O1)O)O)O,,,5,1,3,0,3
43620_0,,,,2,3,2,5
CC1C(CO)C(C(O)O1)O,,,5,1,2,0,2
43621_0,,,,2,3,2,5
43623_0,,,,2,3,2,5
C(C1(COC(C1C(CO)O)O)O)=O,,,5,1,2,0,2
43625_0,,,,2,3,2,5
C(C1C(CO)OC(C1(CO)O)O)=O,,,5,1,2,0,2
43627_0,,,,2,3,2,5
C(C1C(CO)C(CO)(C(O1)O)O)=O,,,5,1,2,0,2
43628_0,,,,2,3,2,5
43630_0,,,,2,3,2,5
C(C1(CO)C(CO)C(C(O1)O)O)=O,,,5,1,2,0,2
43632_0,,,,2,3,2,5
C(C1C(CO)OC(CO)(C1O)O)=O,,,5,1,2,0,2
43634_0,,,,2,3,2,5
C(C1C(CO)C(C(CO)(O1)O)O)=O,,,5,1,2,0,2
43636_0,,,,2,3,2,5
C(CO)(C1C(CO)C(C(O1)O)O)=O,,,5,1,2,0,2
43638_0,,,,2,3,2,5
C(C(C1C(O)OC(CO)C1O)O)O,,,5,1,2,0,2
43640_0,,,,2,3,2,5
C1(C(C(CO)C(C(CO)O)O1)O)O,,,5,1,2,0,2
43641_0,,,,2,3,2,5
43643_0,,,,2,3,2,5
C(C1C(CO)C(C(O1)O)O)=O,,,5,1,2,0,2
43645_0,,,,2,3,2,5
C1C(CO)C(C(O)O1)O,,,5,1,2,0,2
43647_0,,,,2,3,2,5
C1C(C(C(O)O1)C(CO)O)O,,,5,1,2,0,2
43649_0,,,,2,3,2,5
C1(C(C(CO)C(CO)O1)O)O,,,5,1,2,0,2
43650_0,,,,2,3,2,5
43651_0,,,,2,3,2,5
43652_0,,,,2,3,2,5
43653_0,,,,2,3,2,5
43654_0,,,,2,3,2,5
43656_0,,,,2,3,2,5
C(C1(C(C(CO1)(CCO)O)O)O)=O,,,5,1,2,0,2
43657_0,,,,2,3,2,5
43659_0,,,,2,3,2,5
C1C(CCO)(C(C(O)O1)O)O,,,5,1,2,0,2
43660_0,,,,2,3,2,5
43661_0,,,,2,3,2,5
43662_0,,,,2,3,2,5
43663_0,,,,2,3,2,5
43664_0,,,,2,3,2,5
43665_0,,,,2,3,2,5
43666_0,,,,2,3,2,5
43668_0,,,,2,3,2,5
C(CC1(C(C(C(CO)O1)O)O)O)O,,,5,1,2,0,2
43670_0,,,,2,3,2,5
C1C(C(C(CCO)(O)O1)O)O,,,5,1,2,0,2
43671_0,,,,2,3,2,5
43672_0,,,,2,3,2,5
43674_0,,,,2,3,2,5
CC1(C(C(C(CO)O1)O)O)O,,,5,1,2,0,2
43676_0,,,,2,3,2,5
CC1(CC(O)OC1CO)O,,,5,1,2,0,2
43677_0,,,,2,3,2,5
43679_0,,,,2,3,2,5
C1(C(O)OC(C)(C(CO)O)C1O)=O,,,5,1,2,0,2
43680_0,,,,2,3,2,5
43682_0,,,,2,3,2,5
C(C1(C(C(C)(C(CO)O1)O)O)O)=O,,,5,1,2,0,2
43684_0,,,,2,3,2,5
CC1(C(CO)OC(C1O)O)O,,,5,1,2,0,2
43685_0,,,,2,3,2,5
43687_0,,,,2,3,2,5
C(C1(COC(C1)(C(CO)O)O)O)=O,,,5,1,2,0,2
43689_0,,,,2,3,2,5
C(C(C1(CC(C(CO)O1)O)O)O)O,,,5,1,2,0,2
43691_0,,,,2,3,2,5
C1C(CC(C(CO)O)(O)O1)O,,,5,1,2,0,2
43692_0,,,,2,3,2,5
43693_0,,,,2,3,2,5
43694_0,,,,2,3,2,5
43695_0,,,,2,3,2,5
43696_0,,,,2,3,2,5
43697_0,,,,2,3,2,5
43698_0,,,,2,3,2,5
43699_0,,,,2,3,2,5
43700_0,,,,2,3,2,5
43701_0,,,,2,3,2,5
43703_0,,,,2,3,2,5
C(C1C(CO)(C(C(O1)O)O)O)(O)=O,,,5,1,4,0,4
43705_0,,,,2,3,2,5
C(C1C(CO)(C(C)(C(O1)O)O)O)=O,,,5,1,3,0,3
43706_0,,,,2,3,2,5
43708_0,,,,2,3,2,5
C(C1(C(C(O)OC1(CO)C)O)O)=O,,,5,1,2,0,2
43710_0,,,,2,3,2,5
C(C1(C)C(CO)(C(C(O1)O)O)O)=O,,,5,1,4,0,4
43712_0,,,,2,3,2,5
C(C1C(CO)(C(C(C)(O1)O)O)O)=O,,,5,1,3,0,3
43713_0,,,,2,3,2,5
43715_0,,,,2,3,2,5
C(C)(C1C(CO)(C(C(O1)O)O)O)=O,,,5,1,4,0,4
43716_0,,,,2,3,2,5
43717_0,,,,2,3,2,5
43719_0,,,,2,3,2,5
C(C1(C(C(O)OC1CCO)O)O)=O,,,5,1,2,0,2
43720_0,,,,2,3,2,5
43722_0,,,,2,3,2,5
CC1C(CO)(C(C(O)O1)O)O,,,5,1,4,0,4
43724_0,,,,2,3,2,5
C(C1C(CO)(C(C(O1)O)O)O)=O,,,5,1,4,0,4
43725_0,,,,2,3,2,5
43727_0,,,,2,3,2,5
C1C(CO)(C(CO)(C(C)(O)O1)O)O,,,5,1,2,0,2
43729_0,,,,2,3,2,5
C1(C(C(CO)(C(C)(O)O1)O)O)=O,,,5,1,2,0,2
43730_0,,,,2,3,2,5
43732_0,,,,2,3,2,5
CC1C(CO)(C(C(O)O1)(CO)O)O,,,5,1,2,0,2
43734_0,,,,2,3,2,5
C1C(CO)(C(C(O)O1)(C(C)O)O)O,,,5,1,2,0,2
43735_0,,,,2,3,2,5
43736_0,,,,2,3,2,5
43737_0,,,,2,3,2,5
43739_0,,,,2,3,2,5
C1(C(O)OC(CO)(C)C1(CO)O)=O,,,5,1,2,0,2
43741_0,,,,2,3,2,5
C1C(CO)(C(C)(C(O)O1)O)O,,,5,1,2,0,2
43743_0,,,,2,3,2,5
CC1(C(O)OC(CO)C1(CO)O)O,,,5,1,2,0,2
43744_0,,,,2,3,2,5
43746_0,,,,2,3,2,5
C1C(CO)(C(C(C)(O)O1)O)O,,,5,1,2,0,2
43748_0,,,,2,3,2,5
CC1(C(C(CO)(C(CO)O1)O)O)O,,,5,1,2,0,2
43750_0,,,,2,3,2,5
C(C)(C1(CO)C(CC(O1)O)O)=O,,,5,1,5,0,5
43751_0,,,,2,3,2,5
43753_0,,,,2,3,2,5
C1(C(O)OC(CCO)C1(CO)O)=O,,,5,1,2,0,2
43754_0,,,,2,3,2,5
43755_0,,,,2,3,2,5
43757_0,,,,2,3,2,5
C1C(C(C(O)O1)(C(CCO)O)O)O,,,5,1,3,0,3
43759_0,,,,2,3,2,5
C1C(CO)(C(C(O)O1)(CCO)O)O,,,5,1,3,0,3
43760_0,,,,2,3,2,5
43762_0,,,,2,3,2,5
C1(C(CC(C(CO)(CO)O)O1)O)O,,,5,1,2,0,2
43763_0,,,,2,3,2,5
43765_0,,,,2,3,2,5
C(C1(CC(O)OC1(CO)CO)O)O,,,5,1,3,0,3
43767_0,,,,2,3,2,5
C1C(CCO)(C(C(O)O1)(CO)O)O,,,5,1,2,0,2
43768_0,,,,2,3,2,5
43769_0,,,,2,3,2,5
43771_0,,,,2,3,2,5
C(C1(COC(C)(C1(CO)O)O)O)=O,,,5,1,2,0,2
43773_0,,,,2,3,2,5
CC1(C(CO)(C(C(CO)O1)O)O)O,,,5,1,2,0,2
43775_0,,,,2,3,2,5
C1C(C(CO)(C(C)(O)O1)O)O,,,5,1,2,0,2
43777_0,,,,2,3,2,5
CC1(C(C(C(CO)(CO)O1)O)O)O,,,5,1,2,0,2
43779_0,,,,2,3,2,5
CC1(C(C(O)OC1(CO)CO)O)O,,,5,1,2,0,2
43781_0,,,,2,3,2,5
CC1(C(CO)OC(C1(CO)O)O)O,,,5,1,2,0,2
43782_0,,,,2,3,2,5
43783_0,,,,2,3,2,5
43784_0,,,,2,3,2,5
43785_0,,,,2,3,2,5
43786_0,,,,2,3,2,5
43787_0,,,,2,3,2,5
43788_0,,,,2,3,2,5
43790_0,,,,2,3,2,5
C(C1(C)C(CO)(CC(O1)O)O)=O,,,5,1,2,0,2
43792_0,,,,2,3,2,5
C(C1(CC(O)OC1(CO)C)O)=O,,,5,1,2,0,2
43794_0,,,,2,3,2,5
C(C)(C1C(CO)(CC(O1)O)O)=O,,,5,1,2,0,2
43796_0,,,,2,3,2,5
C(CC1(CO)C(CC(O)O1)O)=O,,,5,1,3,0,3
43798_0,,,,2,3,2,5
C(C1(CCO)C(CC(O1)O)O)=O,,,5,1,2,0,2
43800_0,,,,2,3,2,5
C(CC1C(CO)(CC(O)O1)O)=O,,,5,1,2,0,2
43802_0,,,,2,3,2,5
C(C1(CC(O)OC1CCO)O)=O,,,5,1,2,0,2
43804_0,,,,2,3,2,5
CC1C(CO)(CC(O)O1)O,,,5,1,2,0,2
43805_0,,,,2,3,2,5
43806_0,,,,2,3,2,5
43807_0,,,,2,3,2,5
43808_0,,,,2,3,2,5
43809_0,,,,2,3,2,5
43811_0,,,,2,3,2,5
C1(C(CCO)(C(C(CO)O1)O)O)O,,,5,1,2,0,2
43813_0,,,,2,3,2,5
C(C(C1C(CO)(CC(O)O1)O)O)O,,,5,1,2,0,2
43814_0,,,,2,3,2,5
43815_0,,,,2,3,2,5
43816_0,,,,2,3,2,5
43817_0,,,,2,3,2,5
43818_0,,,,2,3,2,5
43819_0,,,,2,3,2,5
43820_0,,,,2,3,2,5
43821_0,,,,2,3,2,5
43822_0,,,,2,3,2,5
43823_0,,,,2,3,2,5
43824_0,,,,2,3,2,5
43826_0,,,,2,3,2,5
C(C1C(C(CC(CO)(O1)O)O)O)=O,,,5,1,2,0,2
43827_0,,,,2,3,2,5
43829_0,,,,2,3,2,5
C(C1C(C(C(CO)C(O1)O)O)O)=O,,,5,1,2,0,2
43830_0,,,,2,3,2,5
43831_0,,,,2,3,2,5
43832_0,,,,2,3,2,5
43834_0,,,,2,3,2,5
C1C(CO)(C(CO)C(C(O)O1)O)O,,,5,1,2,0,2
43836_0,,,,2,3,2,5
C1CC(CO)(C(C(CO)(O)O1)O)O,,,5,1,2,0,2
43838_0,,,,2,3,2,5
C(C1(C(C(CC(CO)O1)O)O)O)O,,,5,1,2,0,2
43840_0,,,,2,3,2,5
C1C(C(CO)(CC(CO)(O)O1)O)O,,,5,1,2,0,2
43842_0,,,,2,3,2,5
C1C(C(CO)(C(C(O)O1)CO)O)O,,,5,1,2,0,2
43844_0,,,,2,3,2,5
C1(C(C(CO)C(C(O)O1)O)O)=O,,,5,1,2,0,2
43846_0,,,,2,3,2,5
C(C1(CO)C(C(CC(O)O1)O)O)O,,,5,1,2,0,2
43847_0,,,,2,3,2,5
43848_0,,,,2,3,2,5
43850_0,,,,2,3,2,5
C1C(CO)(C(CC(CO)(O)O1)O)O,,,5,1,3,0,3
43852_0,,,,2,3,2,5
C1C(CO)(C(C(C(O)O1)CO)O)O,,,5,1,2,0,2
43854_0,,,,2,3,2,5
C1(COC(C(C)(C1CO)O)O)=O,,,5,1,2,0,2
43856_0,,,,2,3,2,5
C1(C(C(CO)(C)OC(C1)O)O)=O,,,5,1,2,0,2
43858_0,,,,2,3,2,5
C1(C(CO)OC(C(C)(C1)O)O)=O,,,5,1,2,0,2
43860_0,,,,2,3,2,5
C1(C(C(O)OC(CO)(C)C1)O)=O,,,5,1,2,0,2
43862_0,,,,2,3,2,5
C1(COC(C)(C(C1CO)O)O)=O,,,5,1,2,0,2
43864_0,,,,2,3,2,5
C1(C(CO)OC(C(C1)O)(C)O)=O,,,5,1,2,0,2
43866_0,,,,2,3,2,5
C(C1(CC(CO)(CCO1)O)O)=O,,,5,1,2,0,2
43868_0,,,,2,3,2,5
C(C1(CCOC(CO)(C1)O)O)=O,,,5,1,2,0,2
43870_0,,,,2,3,2,5
C1(C(O)OC(C(C1)O)CCO)=O,,,5,1,2,0,2
43872_0,,,,2,3,2,5
C(C1(CC(CC(CO)O1)O)O)=O,,,5,1,2,0,2
43874_0,,,,2,3,2,5
C(C1CC(CC(CO)(O1)O)O)=O,,,5,1,2,0,2
43876_0,,,,2,3,2,5
C1(C(O)OCC(CCO)(C1)O)=O,,,5,1,2,0,2
43878_0,,,,2,3,2,5
C1(C(O)OC(CO)C(C)(C1)O)=O,,,5,1,2,0,2
43879_0,,,,2,3,2,5
43881_0,,,,2,3,2,5
C1(COC(CO)(CC1O)O)=O,,,5,1,2,0,2
43882_0,,,,2,3,2,5
43883_0,,,,2,3,2,5
43885_0,,,,2,3,2,5
C(C1(C(COC(CO)(C1)O)O)O)=O,,,5,1,2,0,2
43887_0,,,,2,3,2,5
C1(C(CO)OC(CC1O)(CO)O)=O,,,5,1,2,0,2
43889_0,,,,2,3,2,5
C1C(C(CC(CO)(O)O1)O)O,,,5,1,2,0,2
43891_0,,,,2,3,2,5
C(C1(CC(C(C(CO)O1)O)O)O)O,,,5,1,2,0,2
43893_0,,,,2,3,2,5
C(CO)(C1COC(CC1O)O)=O,,,5,1,3,0,3
43895_0,,,,2,3,2,5
C(C1C(CO)OC(CC1O)O)=O,,,5,1,3,0,3
43897_0,,,,2,3,2,5
C(C1C(CO)C(CC(O1)O)O)=O,,,5,1,2,0,2
43899_0,,,,2,3,2,5
C1(C(C(CCO)OC(C1)O)O)=O,,,5,1,2,0,2
43901_0,,,,2,3,2,5
C1(C(C(O)OC(CCO)C1)O)=O,,,5,1,2,0,2
43903_0,,,,2,3,2,5
C(C1C(O)OCCC1(CO)O)=O,,,5,1,2,0,2
43905_0,,,,2,3,2,5
C(C1(CCOC(C1CO)O)O)=O,,,5,1,2,0,2
43907_0,,,,2,3,2,5
C(C1C(O)OC(CO)CC1O)=O,,,5,1,2,0,2
43909_0,,,,2,3,2,5
C(C1CC(C(CO)C(O1)O)O)=O,,,5,1,2,0,2
43910_0,,,,2,3,2,5
43911_0,,,,2,3,2,5
43913_0,,,,2,3,2,5
C(C1(C(COC(C1CO)O)O)O)=O,,,5,1,2,0,2
43915_0,,,,2,3,2,5
C1(C(CO)OC(C(CO)C1O)O)=O,,,5,1,2,0,2
43917_0,,,,2,3,2,5
C1(C(CO)C(C(C(CO)O1)O)O)O,,,5,1,2,0,2
43919_0,,,,2,3,2,5
C1CC(CO)(CC(O)O1)O,,,5,1,2,0,2
43920_0,,,,2,3,2,5
43922_0,,,,2,3,2,5
C(C1(C(C(CO)(CCO1)O)O)O)=O,,,5,1,2,0,2
43924_0,,,,2,3,2,5
C1CC(CO)(C(C(O)O1)O)O,,,5,1,2,0,2
43925_0,,,,2,3,2,5
43927_0,,,,2,3,2,5
C1(COC(CO)(C(CO)C1O)O)=O,,,5,1,3,0,3
43929_0,,,,2,3,2,5
C1C(C(C(CO)C(CO)(O)O1)O)O,,,5,1,3,0,3
43930_0,,,,2,3,2,5
43932_0,,,,2,3,2,5
C1(C(O)OC(C(C1O)O)CCO)=O,,,5,1,2,0,2
43934_0,,,,2,3,2,5
C(C1CC(CC(O)O1)O)O,,,5,1,2,0,2
43935_0,,,,2,3,2,5
43936_0,,,,2,3,2,5
43938_0,,,,2,3,2,5
C(C1(C(C(CC(CO)O1)O)O)O)=O,,,5,1,2,0,2
43940_0,,,,2,3,2,5
C(C1C(CC(C(O)O1)O)O)O,,,5,1,2,0,2
43942_0,,,,2,3,2,5
C(C1CC(C(C(O)O1)O)O)O,,,5,1,2,0,2
43943_0,,,,2,3,2,5
43945_0,,,,2,3,2,5
C(C1(COC(C(C1CO)O)O)O)=O,,,5,1,2,0,2
43947_0,,,,2,3,2,5
C1(COC(C(C(CO)O)C1O)O)=O,,,5,1,2,0,2
43949_0,,,,2,3,2,5
C1(C(C(CO)C(C(CO)O1)O)O)O,,,5,1,2,0,2
43951_0,,,,2,3,2,5
C1C(C(C(C(O)O1)C(CO)O)O)O,,,5,1,2,0,2
43953_0,,,,2,3,2,5
C1C(C(CO)C(C(O)O1)O)O,,,5,1,2,0,2
43955_0,,,,2,3,2,5
C1(C(O)OCC(CCO)(C1O)O)=O,,,5,1,2,0,2
43956_0,,,,2,3,2,5
43957_0,,,,2,3,2,5
43959_0,,,,2,3,2,5
C1(COC(CO)(C(C1CO)O)O)=O,,,5,1,2,0,2
43960_0,,,,2,3,2,5
43961_0,,,,2,3,2,5
43962_0,,,,2,3,2,5
43964_0,,,,2,3,2,5
C1C(C(C(C(CCO)(O)O1)O)O)O,,,5,1,2,0,2
43965_0,,,,2,3,2,5
43967_0,,,,2,3,2,5
C1(C(O)OC(CO)C(C)(C1O)O)=O,,,5,1,2,0,2
43968_0,,,,2,3,2,5
43969_0,,,,2,3,2,5
43971_0,,,,2,3,2,5
C1(COC(CC1O)(C(CO)O)O)=O,,,5,1,2,0,2
43973_0,,,,2,3,2,5
C1(C(CO)OC(C(C1)O)(CO)O)=O,,,5,1,2,0,2
43975_0,,,,2,3,2,5
C1C(C(CC(C(CO)O)(O)O1)O)O,,,5,1,2,0,2
43976_0,,,,2,3,2,5
43977_0,,,,2,3,2,5
43978_0,,,,2,3,2,5
43979_0,,,,2,3,2,5
43980_0,,,,2,3,2,5
43981_0,,,,2,3,2,5
43983_0,,,,2,3,2,5
C1(C(C(CO)(C(C(O)O1)O)O)O)=O,,,5,1,4,0,4
43984_0,,,,2,3,2,5
43985_0,,,,2,3,2,5
43987_0,,,,2,3,2,5
CC1(C(O)OCC(C1(CO)O)O)O,,,5,1,2,0,2
43989_0,,,,2,3,2,5
C1C(C(CO)(C(C(C)(O)O1)O)O)O,,,5,1,2,0,2
43990_0,,,,2,3,2,5
43991_0,,,,2,3,2,5
43992_0,,,,2,3,2,5
43994_0,,,,2,3,2,5
C1CC(CO)(C(C(O)O1)(CO)O)O,,,5,1,2,0,2
43996_0,,,,2,3,2,5
C1(C(CC(C(CO)(CO)O1)O)O)O,,,5,1,2,0,2
43998_0,,,,2,3,2,5
C1(C(CO)(C(CC(CO)O1)O)O)O,,,5,1,2,0,2
43999_0,,,,2,3,2,5
44001_0,,,,2,3,2,5
C1C(CO)(C(CO)(CC(O)O1)O)O,,,5,1,3,0,3
44003_0,,,,2,3,2,5
C1(COC(C)(C(CO)(C1O)O)O)=O,,,5,1,2,0,2
44005_0,,,,2,3,2,5
C1C(C(C(CO)(C(C)(O)O1)O)O)O,,,5,1,2,0,2
44007_0,,,,2,3,2,5
C1C(CO)(C(C(C(C)(O)O1)O)O)O,,,5,1,2,0,2
44009_0,,,,2,3,2,5
CC1(C(C(O)OCC1(CO)O)O)O,,,5,1,2,0,2
44010_0,,,,2,3,2,5
44011_0,,,,2,3,2,5
44012_0,,,,2,3,2,5
44013_0,,,,2,3,2,5
44014_0,,,,2,3,2,5
44016_0,,,,2,3,2,5
C(C1(CC(O)OC(CO)C1O)O)O,,,5,1,2,0,2
44018_0,,,,2,3,2,5
C1C(C(C(C(O)O1)(CCO)O)O)O,,,5,1,2,0,2
44019_0,,,,2,3,2,5
44020_0,,,,2,3,2,5
44022_0,,,,2,3,2,5
C1C(CO)(C(C(CC(O)O1)O)O)O,,,5,1,2,0,2
44024_0,,,,2,3,2,5
C1(C(O)OCCC(CO)(C1)O)=O,,,5,1,2,0,2
44026_0,,,,2,3,2,5
C1(C(CC(CO)(O)OCC1)O)=O,,,5,1,2,0,2
44028_0,,,,2,3,2,5
C1(C(O)OC(CO)CC(C1)O)=O,,,5,1,2,0,2
44030_0,,,,2,3,2,5
C1(COC(CO)(CC(C1)O)O)=O,,,5,1,2,0,2
44031_0,,,,2,3,2,5
44032_0,,,,2,3,2,5
44034_0,,,,2,3,2,5
C1C(C(C(CC(CO)(O)O1)O)O)O,,,5,1,2,0,2
44035_0,,,,2,3,2,5
44036_0,,,,2,3,2,5
44038_0,,,,2,3,2,5
C1(C(C(C(O)OCC1)CO)O)=O,,,5,1,2,0,2
44040_0,,,,2,3,2,5
C1(COC(C(CO)C(C1)O)O)=O,,,5,1,2,0,2
44042_0,,,,2,3,2,5
C1(C(C(C(O)OCC1O)CO)O)=O,,,5,1,2,0,2
44044_0,,,,2,3,2,5
C1C(C(C(C(C(O)O1)CO)O)O)O,,,5,1,2,0,2
44046_0,,,,2,3,2,5
C1(C(O)OCCC(CO)(C1O)O)=O,,,5,1,2,0,2
44047_0,,,,2,3,2,5
44049_0,,,,2,3,2,5
C1(C(O)OC(CO)CC(C1O)O)=O,,,5,1,2,0,2
44051_0,,,,2,3,2,5
C1(COC(C(C(CO)C1O)O)O)=O,,,5,1,2,0,2
44053_0,,,,2,3,2,5
C1C(C(C(CO)C(C(O)O1)O)O)O,,,5,1,2,0,2
44054_0,,,,2,3,2,5
44055_0,,,,2,3,2,5
44056_0,,,,2,3,2,5
44057_0,,,,2,3,2,5
44059_0,,,,2,3,2,5
C1C(CO)(C(CC(C(O)O1)O)O)O,,,5,1,2,0,2
44060_0,,,,2,3,2,5
44062_0,,,,2,3,2,5
C1C(C(C(CO)(CC(O)O1)O)O)O,,,5,1,2,0,2
44064_0,,,,2,3,2,5
C(CO)(C1COC(C1O)=O)=O,,,5,1,3,0,3
44065_0,,,,2,3,2,5
44066_0,,,,2,3,2,5
44067_0,,,,2,3,2,5
44068_0,,,,2,3,2,5
44069_0,,,,2,3,2,5
44070_0,,,,2,3,2,5
44071_0,,,,2,3,2,5
44072_0,,,,2,3,2,5
44073_0,,,,2,3,2,5
44074_0,,,,2,3,2,5
44076_0,,,,2,3,2,5
C1(C(C)(C(C(CCO)O1)O)O)=O,,,5,1,2,0,2
44078_0,,,,2,3,2,5
C1(C(C)(C(CO1)(CCO)O)O)=O,,,5,1,2,0,2
44080_0,,,,2,3,2,5
C1(C(C(CO1)(CCO)O)O)=O,,,5,1,2,0,2
44082_0,,,,2,3,2,5
C1(C(C)(C(C)(C(CO)O1)O)O)=O,,,5,1,2,0,2
44084_0,,,,2,3,2,5
C1(C(C(C)(C(CO)O1)O)O)=O,,,5,1,2,0,2
44085_0,,,,2,3,2,5
44086_0,,,,2,3,2,5
44087_0,,,,2,3,2,5
44088_0,,,,2,3,2,5
44089_0,,,,2,3,2,5
44091_0,,,,2,3,2,5
C1(C(C)(C(CO)(CCO1)O)O)=O,,,5,1,2,0,2
44093_0,,,,2,3,2,5
C1(C(C(CO)(CCO1)O)O)=O,,,5,1,2,0,2
44095_0,,,,2,3,2,5
C1(C(C)(C(CC(CO)O1)O)O)=O,,,5,1,2,0,2
44097_0,,,,2,3,2,5
C1(C(C(CC(CO)O1)O)O)=O,,,5,1,2,0,2
44098_0,,,,2,3,2,5
44099_0,,,,2,3,2,5
44101_0,,,,2,3,2,5
C(C(C)(C(CO)CCC(O)=O)O)=O,,,5,1,2,0,2
44102_0,,,,2,3,2,5
44104_0,,,,2,3,2,5
C(C(CCO)(CCCC(O)=O)O)=O,,,5,1,2,0,2
44105_0,,,,2,3,2,5
44107_0,,,,2,3,2,5
C(CCC(CO)C(C(C)=O)O)(O)=O,,,5,1,2,0,2
44109_0,,,,2,3,2,5
C(CCC(C(C)=O)(CCO)O)(O)=O,,,5,1,2,0,2
44111_0,,,,2,3,2,5
C(CCCC(C(CCO)O)=O)(O)=O,,,5,1,2,0,2
44113_0,,,,2,3,2,5
C(CCC(C)(CC(CO)=O)O)(O)=O,,,5,1,2,0,2
44114_0,,,,2,3,2,5
44115_0,,,,2,3,2,5
44116_0,,,,2,3,2,5
44117_0,,,,2,3,2,5
44119_0,,,,2,3,2,5
C(CCC(CCO)(CC=O)O)(O)=O,,,5,1,2,0,2
44120_0,,,,2,3,2,5
44121_0,,,,2,3,2,5
44123_0,,,,2,3,2,5
C(C(CCC(O)=O)(CO)C(C)O)=O,,,5,1,4,0,4
44124_0,,,,2,3,2,5
44125_0,,,,2,3,2,5
44126_0,,,,2,3,2,5
44128_0,,,,2,3,2,5
C(C(C=O)C(C(C=O)CCO)O)=O,,,5,1,1,0,1
44129_0,,,,2,3,2,5
44130_0,,,,2,3,2,5
44132_0,,,,2,3,2,5
C(C(C=O)(CO)CCC(CO)=O)=O,,,5,1,2,0,2
44134_0,,,,2,3,2,5
C(C(CCC(C=O)=O)(CO)CO)=O,,,5,1,3,0,3
44136_0,,,,2,3,2,5
C(C(C=O)(CO)C(CO)CC=O)=O,,,5,1,2,0,2
44138_0,,,,2,3,2,5
C(C(C=O)(CO)C(C=O)CCO)=O,,,5,1,2,0,2
44140_0,,,,2,3,2,5
C(CC(C=O)C(C=O)(CO)CO)=O,,,5,1,3,0,3
44142_0,,,,2,3,2,5
C(C(CCC(O)=O)(CO)CO)=O,,,5,1,3,0,3
44144_0,,,,2,3,2,5
C(C(CCC(CO)=O)C(C)O)=O,,,5,1,2,0,2
44146_0,,,,2,3,2,5
C(C(CCC(CO)C(C)O)=O)=O,,,5,1,2,0,2
44148_0,,,,2,3,2,5
C(C(C(CO)CC=O)C(C)O)=O,,,5,1,2,0,2
44149_0,,,,2,3,2,5
44151_0,,,,2,3,2,5
C(C(C(CO)C(C)O)CC=O)=O,,,5,1,3,0,3
44153_0,,,,2,3,2,5
C(CCC(CO)C(C)O)(O)=O,,,5,1,2,0,2
44155_0,,,,2,3,2,5
C(CC(CO)C(CO)C(C)O)(O)=O,,,5,1,2,0,2
44157_0,,,,2,3,2,5
C(CC(C)(CCC(CO)=O)O)=O,,,5,1,2,0,2
44159_0,,,,2,3,2,5
C(C(CCC(C)(CCO)O)=O)=O,,,5,1,2,0,2
44161_0,,,,2,3,2,5
C(CC(C)(C(CO)CC=O)O)=O,,,5,1,2,0,2
44163_0,,,,2,3,2,5
C(C(CCO)C(C)(CC=O)O)=O,,,5,1,1,0,1
44165_0,,,,2,3,2,5
C(C(C(C)(CCO)O)CC=O)=O,,,5,1,2,0,2
44167_0,,,,2,3,2,5
C(CCC(C)(CCO)O)(O)=O,,,5,1,2,0,2
44169_0,,,,2,3,2,5
C(CC(CO)C(C)(CCO)O)(O)=O,,,5,1,2,0,2
44171_0,,,,2,3,2,5
C(CC(CCCC(CO)=O)O)=O,,,5,1,2,0,2
44173_0,,,,2,3,2,5
C(C(CCCC(CCO)O)=O)=O,,,5,1,2,0,2
44175_0,,,,2,3,2,5
C(CC(CO)CC(CC=O)O)=O,,,5,1,2,0,2
44176_0,,,,2,3,2,5
44178_0,,,,2,3,2,5
C(C(CC(CCO)O)CC=O)=O,,,5,1,3,0,3
44180_0,,,,2,3,2,5
C(CCCC(CCO)O)(O)=O,,,5,1,2,0,2
44182_0,,,,2,3,2,5
C(CC(CO)CC(CCO)O)(O)=O,,,5,1,2,0,2
44184_0,,,,2,3,2,5
C(C(CCC(CO)=O)(C(C)O)O)=O,,,5,1,2,0,2
44186_0,,,,2,3,2,5
C(C(CCC(CO)(C(C)O)O)=O)=O,,,5,1,3,0,3
44188_0,,,,2,3,2,5
C(C(C(C)O)(C(CO)CC=O)O)=O,,,5,1,2,0,2
44190_0,,,,2,3,2,5
C(C(CCO)C(C=O)(C(C)O)O)=O,,,5,1,1,0,1
44191_0,,,,2,3,2,5
44193_0,,,,2,3,2,5
C(CCC(CO)(C(C)O)O)(O)=O,,,5,1,3,0,3
44195_0,,,,2,3,2,5
C(C(C(CCC(CO)=O)(C)O)O)=O,,,5,1,2,0,2
44197_0,,,,2,3,2,5
C(C(CCC(C)(C(CO)O)O)=O)=O,,,5,1,3,0,3
44199_0,,,,2,3,2,5
C(CC(CO)C(C)(C(C=O)O)O)=O,,,5,1,2,0,2
44201_0,,,,2,3,2,5
C(C(CCO)C(C)(C(C=O)O)O)=O,,,5,1,1,0,1
44202_0,,,,2,3,2,5
44204_0,,,,2,3,2,5
C(CCC(C)(C(CO)O)O)(O)=O,,,5,1,3,0,3
44206_0,,,,2,3,2,5
C(C(C(CCCC(CO)=O)O)O)=O,,,5,1,2,0,2
44208_0,,,,2,3,2,5
C(C(CCCC(C(CO)O)O)=O)=O,,,5,1,3,0,3
44210_0,,,,2,3,2,5
C(CC(CO)CC(C(C=O)O)O)=O,,,5,1,2,0,2
44211_0,,,,2,3,2,5
44213_0,,,,2,3,2,5
C(C(CC(C(CO)O)O)CC=O)=O,,,5,1,4,0,4
44215_0,,,,2,3,2,5
C(CCCC(C(CO)O)O)(O)=O,,,5,1,3,0,3
44216_0,,,,2,3,2,5
44218_0,,,,2,3,2,5
C(C(CCC(CCO)O)=O)=O,,,5,1,2,0,2
44219_0,,,,2,3,2,5
44221_0,,,,2,3,2,5
C(C(C(CC=O)O)CCO)=O,,,5,1,1,0,1
44222_0,,,,2,3,2,5
44224_0,,,,2,3,2,5
C(CCC(CCO)O)(O)=O,,,5,1,2,0,2
44226_0,,,,2,3,2,5
C(CC(CO)C(CCO)O)(O)=O,,,5,1,2,0,2
44228_0,,,,2,3,2,5
C(C(CO)CCC(CO)=O)=O,,,5,1,2,0,2
44230_0,,,,2,3,2,5
C(C(CCC(CO)CO)=O)=O,,,5,1,2,0,2
44232_0,,,,2,3,2,5
C(C(CO)C(CO)CC=O)=O,,,5,1,2,0,2
44233_0,,,,2,3,2,5
44235_0,,,,2,3,2,5
C(C(C(CO)CO)CC=O)=O,,,5,1,3,0,3
44237_0,,,,2,3,2,5
C(CCC(CO)CO)(O)=O,,,5,1,2,0,2
44239_0,,,,2,3,2,5
C(CC(CO)C(CO)CO)(O)=O,,,5,1,2,0,2
44241_0,,,,2,3,2,5
C(CC(C(CCC(CO)=O)O)O)=O,,,5,1,2,0,2
44243_0,,,,2,3,2,5
C(C(CCC(C(CCO)O)O)=O)=O,,,5,1,2,0,2
44245_0,,,,2,3,2,5
C(CC(C(C(CO)CC=O)O)O)=O,,,5,1,2,0,2
44247_0,,,,2,3,2,5
C(C(CCO)C(C(CC=O)O)O)=O,,,5,1,1,0,1
44248_0,,,,2,3,2,5
44250_0,,,,2,3,2,5
C(CCC(C(CCO)O)O)(O)=O,,,5,1,2,0,2
44252_0,,,,2,3,2,5
C(CC(CO)(CCC(CO)=O)O)=O,,,5,1,2,0,2
44254_0,,,,2,3,2,5
C(C(CCC(CO)(CCO)O)=O)=O,,,5,1,3,0,3
44255_0,,,,2,3,2,5
44257_0,,,,2,3,2,5
C(C(CCO)C(CO)(CC=O)O)=O,,,5,1,1,0,1
44258_0,,,,2,3,2,5
44260_0,,,,2,3,2,5
C(CCC(CO)(CCO)O)(O)=O,,,5,1,3,0,3
44262_0,,,,2,3,2,5
C(C(CCC(CO)=O)C(CO)O)=O,,,5,1,2,0,2
44264_0,,,,2,3,2,5
C(C(CCC(CO)C(CO)O)=O)=O,,,5,1,3,0,3
44266_0,,,,2,3,2,5
C(C(C(CO)CC=O)C(CO)O)=O,,,5,1,2,0,2
44267_0,,,,2,3,2,5
44269_0,,,,2,3,2,5
C(C(C(CO)C(CO)O)CC=O)=O,,,5,1,4,0,4
44271_0,,,,2,3,2,5
C(CCC(CO)C(CO)O)(O)=O,,,5,1,3,0,3
44272_0,,,,2,3,2,5
44273_0,,,,2,3,2,5
44274_0,,,,2,3,2,5
44275_0,,,,2,3,2,5
44277_0,,,,2,3,2,5
C(CO)(CCC(C(C(C)=O)=O)O)=O,,,5,1,2,0,2
44279_0,,,,2,3,2,5
C(CC(CO)C(C(C(C)=O)=O)O)=O,,,5,1,2,0,2
44281_0,,,,2,3,2,5
C(C(CCO)C(C(C(C)=O)=O)O)=O,,,5,1,1,0,1
44283_0,,,,2,3,2,5
C(CO)(CCCC(C(CO)=O)=O)=O,,,5,1,2,0,2
44285_0,,,,2,3,2,5
C(CC(CO)CC(C(CO)=O)=O)=O,,,5,1,2,0,2
44287_0,,,,2,3,2,5
C(C(CCO)CC(C(CO)=O)=O)=O,,,5,1,1,0,1
44289_0,,,,2,3,2,5
C(CO)(CCCC(C(C=O)=O)O)=O,,,5,1,2,0,2
44290_0,,,,2,3,2,5
44292_0,,,,2,3,2,5
C(CC(CO)CC(C(C=O)=O)O)=O,,,5,1,2,0,2
44294_0,,,,2,3,2,5
C(C(CC(C(C=O)=O)O)CCO)=O,,,5,1,1,0,1
44295_0,,,,2,3,2,5
44296_0,,,,2,3,2,5
44298_0,,,,2,3,2,5
C(CO)(CCC(C(C=O)=O)(C)O)=O,,,5,1,2,0,2
44299_0,,,,2,3,2,5
44301_0,,,,2,3,2,5
C(CC(CO)C(C(C=O)=O)(C)O)=O,,,5,1,2,0,2
44303_0,,,,2,3,2,5
C(C(CCO)C(C(C=O)=O)(C)O)=O,,,5,1,1,0,1
44304_0,,,,2,3,2,5
44305_0,,,,2,3,2,5
44307_0,,,,2,3,2,5
C(C(C=O)(CCC(CO)=O)O)=O,,,5,1,3,0,3
44308_0,,,,2,3,2,5
44310_0,,,,2,3,2,5
C(C(C=O)(C(CO)CC=O)O)=O,,,5,1,3,0,3
44312_0,,,,2,3,2,5
C(C(C=O)(C(C=O)CCO)O)=O,,,5,1,3,0,3
44313_0,,,,2,3,2,5
44314_0,,,,2,3,2,5
44315_0,,,,2,3,2,5
44317_0,,,,2,3,2,5
C(C)(C(CCC(CO)=O)O)=O,,,5,1,2,0,2
44319_0,,,,2,3,2,5
C(CC(CO)C(C(C)=O)O)=O,,,5,1,3,0,3
44321_0,,,,2,3,2,5
C(C(CCO)C(C(C)=O)O)=O,,,5,1,2,0,2
44323_0,,,,2,3,2,5
C(CO)(CCCC(CO)=O)=O,,,5,1,2,0,2
44325_0,,,,2,3,2,5
C(CC(CO)CC(CO)=O)=O,,,5,1,4,0,4
44327_0,,,,2,3,2,5
C(C(CCO)CC(CO)=O)=O,,,5,1,3,0,3
44329_0,,,,2,3,2,5
C(C(CCC(CO)=O)O)(CCO)=O,,,5,1,2,0,2
44331_0,,,,2,3,2,5
C(CC(CO)C(C(CCO)=O)O)=O,,,5,1,2,0,2
44333_0,,,,2,3,2,5
C(C(CCO)C(C(CCO)=O)O)=O,,,5,1,1,0,1
44334_0,,,,2,3,2,5
44335_0,,,,2,3,2,5
44337_0,,,,2,3,2,5
C(C(C(CC(CO)=O)O)CCO)=O,,,5,1,1,0,1
44339_0,,,,2,3,2,5
C(CO)(C(CO)CCC(CO)=O)=O,,,5,1,2,0,2
44341_0,,,,2,3,2,5
C(CC(CO)C(C(CO)=O)CO)=O,,,5,1,2,0,2
44343_0,,,,2,3,2,5
C(C(CCO)C(C(CO)=O)CO)=O,,,5,1,1,0,1
44345_0,,,,2,3,2,5
C(C(CCC(CO)=O)(CCO)O)=O,,,5,1,2,0,2
44346_0,,,,2,3,2,5
44348_0,,,,2,3,2,5
C(C(CCO)(C(CO)CC=O)O)=O,,,5,1,2,0,2
44350_0,,,,2,3,2,5
C(C(CCO)C(C=O)(CCO)O)=O,,,5,1,1,0,1
44351_0,,,,2,3,2,5
44352_0,,,,2,3,2,5
44354_0,,,,2,3,2,5
C(C(CC(CCC(CO)=O)O)O)=O,,,5,1,2,0,2
44356_0,,,,2,3,2,5
C(C(CCC(CC(CO)O)O)=O)=O,,,5,1,2,0,2
44358_0,,,,2,3,2,5
C(CC(CO)C(CC(C=O)O)O)=O,,,5,1,2,0,2
44360_0,,,,2,3,2,5
C(C(C(CC(C=O)O)O)CCO)=O,,,5,1,1,0,1
44361_0,,,,2,3,2,5
44363_0,,,,2,3,2,5
C(CCC(CC(CO)O)O)(O)=O,,,5,1,2,0,2
44365_0,,,,2,3,2,5
C(C(C(CCC(CO)=O)CO)O)=O,,,5,1,2,0,2
44366_0,,,,2,3,2,5
44368_0,,,,2,3,2,5
C(CC(CO)C(CO)C(C=O)O)=O,,,5,1,2,0,2
44370_0,,,,2,3,2,5
C(C(CCO)C(CO)C(C=O)O)=O,,,5,1,1,0,1
44371_0,,,,2,3,2,5
44372_0,,,,2,3,2,5
44374_0,,,,2,3,2,5
C(C)(C(CO)(CCC(CO)=O)O)=O,,,5,1,2,0,2
44376_0,,,,2,3,2,5
C(CC(CO)C(C(C)=O)(CO)O)=O,,,5,1,2,0,2
44378_0,,,,2,3,2,5
C(C(CCO)C(C(C)=O)(CO)O)=O,,,5,1,1,0,1
44379_0,,,,2,3,2,5
44380_0,,,,2,3,2,5
44382_0,,,,2,3,2,5
C(C(C(C(C(C)=O)O)O)CCO)=O,,,5,1,1,0,1
44384_0,,,,2,3,2,5
C(C(CO)O)(CCCC(CO)=O)=O,,,5,1,2,0,2
44386_0,,,,2,3,2,5
C(CC(CO)CC(C(CO)O)=O)=O,,,5,1,2,0,2
44388_0,,,,2,3,2,5
C(C(CCO)CC(C(CO)O)=O)=O,,,5,1,2,0,2
44390_0,,,,2,3,2,5
C(CO)(CCC(C)O)=O,,,5,1,2,0,2
44392_0,,,,2,3,2,5
C(CC(CO)C(C)O)=O,,,5,1,2,0,2
44394_0,,,,2,3,2,5
C(C(CCO)C(C)O)=O,,,5,1,1,0,1
44396_0,,,,2,3,2,5
C(CO)(CCCCO)=O,,,5,1,2,0,2
44398_0,,,,2,3,2,5
C(CC(CO)CCO)=O,,,5,1,2,0,2
44400_0,,,,2,3,2,5
C(C(CCO)CCO)=O,,,5,1,1,0,1
44402_0,,,,2,3,2,5
C(CO)(CCCC(C(O)=O)=O)=O,,,5,1,4,0,4
44404_0,,,,2,3,2,5
C(CC(CO)CC(C(O)=O)=O)=O,,,5,1,3,0,3
44406_0,,,,2,3,2,5
C(C(CCO)CC(C(O)=O)=O)=O,,,5,1,2,0,2
44408_0,,,,2,3,2,5
C(C(C=O)CCC(CO)=O)(O)=O,,,5,1,2,0,2
44410_0,,,,2,3,2,5
C(C(CCC(C=O)=O)CO)(O)=O,,,5,1,4,0,4
44412_0,,,,2,3,2,5
C(C(C=O)C(CO)CC=O)(O)=O,,,5,1,2,0,2
44413_0,,,,2,3,2,5
44415_0,,,,2,3,2,5
C(C(CO)C(C=O)CC=O)(O)=O,,,5,1,3,0,3
44417_0,,,,2,3,2,5
C(C(CCC(O)=O)CO)(O)=O,,,5,1,4,0,4
44419_0,,,,2,3,2,5
C(C(CO)C(CO)CC(O)=O)(O)=O,,,5,1,4,0,4
44421_0,,,,2,3,2,5
C(CCC(CO)(CC(O)=O)O)(O)=O,,,5,1,3,0,3
44423_0,,,,2,3,2,5
C(C(CCC(O)=O)C(CO)O)(O)=O,,,5,1,4,0,4
44424_0,,,,2,3,2,5
44425_0,,,,2,3,2,5
44427_0,,,,2,3,2,5
C(C(CCO)CC(O)=O)=O,,,5,1,3,0,3
44429_0,,,,2,3,2,5
C(CO)(CCC(C(C(O)=O)=O)O)=O,,,5,1,2,0,2
44431_0,,,,2,3,2,5
C(CC(CO)C(C(C(O)=O)=O)O)=O,,,5,1,2,0,2
44433_0,,,,2,3,2,5
C(C(CCO)C(C(C(O)=O)=O)O)=O,,,5,1,1,0,1
44435_0,,,,2,3,2,5
C(C(C(C=O)=O)CCC(CO)=O)=O,,,5,1,3,0,3
44436_0,,,,2,3,2,5
44437_0,,,,2,3,2,5
44439_0,,,,2,3,2,5
C(C(C(C=O)=O)C(CO)CC=O)=O,,,5,1,3,0,3
44441_0,,,,2,3,2,5
C(C(C(C=O)=O)C(C=O)CCO)=O,,,5,1,1,0,1
44442_0,,,,2,3,2,5
44443_0,,,,2,3,2,5
44444_0,,,,2,3,2,5
44445_0,,,,2,3,2,5
44446_0,,,,2,3,2,5
44447_0,,,,2,3,2,5
44449_0,,,,2,3,2,5
C1(C(CCC(CO)=O)OCC1O)=O,,,5,1,2,0,2
44451_0,,,,2,3,2,5
C(CC(CO)C1C(C(CO1)O)=O)=O,,,5,1,2,0,2
44453_0,,,,2,3,2,5
C(C(CCO)C1C(C(CO1)O)=O)=O,,,5,1,1,0,1
44455_0,,,,2,3,2,5
C(CO)(CCC1C(C(CO1)=O)O)=O,,,5,1,2,0,2
44457_0,,,,2,3,2,5
C(CC(CO)C1C(C(CO1)=O)O)=O,,,5,1,2,0,2
44459_0,,,,2,3,2,5
C(C(C1C(C(CO1)=O)O)CCO)=O,,,5,1,1,0,1
44461_0,,,,2,3,2,5
C(CO)(CCC1(C(COC1)=O)O)=O,,,5,1,2,0,2
44463_0,,,,2,3,2,5
C(CC(CO)C1(C(COC1)=O)O)=O,,,5,1,2,0,2
44465_0,,,,2,3,2,5
C(C(CCO)C1(C(COC1)=O)O)=O,,,5,1,1,0,1
44467_0,,,,2,3,2,5
C1(C(CCC(CO)=O)(O)OCC1)=O,,,5,1,2,0,2
44469_0,,,,2,3,2,5
C(CC(CO)C1(C(CCO1)=O)O)=O,,,5,1,2,0,2
44471_0,,,,2,3,2,5
C(C(CCO)C1(C(CCO1)=O)O)=O,,,5,1,1,0,1
44473_0,,,,2,3,2,5
C(CO)(CCC1CC(C(O)O1)=O)=O,,,5,1,2,0,2
44475_0,,,,2,3,2,5
C(CC(CO)C1CC(C(O)O1)=O)=O,,,5,1,2,0,2
44477_0,,,,2,3,2,5
C(C(C1CC(C(O)O1)=O)CCO)=O,,,5,1,1,0,1
44479_0,,,,2,3,2,5
C(CO)(CCC1C(C(O)OC1)=O)=O,,,5,1,2,0,2
44481_0,,,,2,3,2,5
C(CC(CO)C1C(C(O)OC1)=O)=O,,,5,1,2,0,2
44483_0,,,,2,3,2,5
C(C(CCO)C1C(C(O)OC1)=O)=O,,,5,1,1,0,1
44485_0,,,,2,3,2,5
C1(C(CCC(CO)=O)C(CO1)O)=O,,,5,1,2,0,2
44487_0,,,,2,3,2,5
C1(C(C(CO)CC=O)C(CO1)O)=O,,,5,1,2,0,2
44489_0,,,,2,3,2,5
C1(C(C(CO1)O)C(C=O)CCO)=O,,,5,1,1,0,1
44491_0,,,,2,3,2,5
C1(CC(C(CCC(CO)=O)O1)O)=O,,,5,1,2,0,2
44493_0,,,,2,3,2,5
C1(CC(C(C(CO)CC=O)O1)O)=O,,,5,1,2,0,2
44495_0,,,,2,3,2,5
C(C(CCO)C1C(CC(O1)=O)O)=O,,,5,1,1,0,1
44497_0,,,,2,3,2,5
C1(CC(CCC(CO)=O)(CO1)O)=O,,,5,1,2,0,2
44499_0,,,,2,3,2,5
C1(CC(CO1)(C(CO)CC=O)O)=O,,,5,1,2,0,2
44501_0,,,,2,3,2,5
C(C(CCO)C1(COC(C1)=O)O)=O,,,5,1,1,0,1
44503_0,,,,2,3,2,5
C(CO)(CCC1C(COC1O)=O)=O,,,5,1,2,0,2
44505_0,,,,2,3,2,5
C(CC(CO)C1C(COC1O)=O)=O,,,5,1,2,0,2
44507_0,,,,2,3,2,5
C(C(CCO)C1C(COC1O)=O)=O,,,5,1,1,0,1
44509_0,,,,2,3,2,5
C(CO)(CCC1(CC(CO1)=O)O)=O,,,5,1,2,0,2
44511_0,,,,2,3,2,5
C(CC(CO)C1(CC(CO1)=O)O)=O,,,5,1,2,0,2
44513_0,,,,2,3,2,5
C(C(C1(CC(CO1)=O)O)CCO)=O,,,5,1,1,0,1
44515_0,,,,2,3,2,5
C1(C(CCC(CO)=O)OC(C1)O)=O,,,5,1,2,0,2
44517_0,,,,2,3,2,5
C(CC(CO)C1C(CC(O1)O)=O)=O,,,5,1,2,0,2
44519_0,,,,2,3,2,5
C(C(CCO)C1C(CC(O1)O)=O)=O,,,5,1,1,0,1
44521_0,,,,2,3,2,5
C(CO)(CCCC(C(C=O)=O)=O)=O,,,5,1,2,0,2
44522_0,,,,2,3,2,5
44524_0,,,,2,3,2,5
C(CC(CO)CC(C(C=O)=O)=O)=O,,,5,1,2,0,2
44526_0,,,,2,3,2,5
C(C(CCO)CC(C(C=O)=O)=O)=O,,,5,1,1,0,1
44527_0,,,,2,3,2,5
44528_0,,,,2,3,2,5
44530_0,,,,2,3,2,5
C(CO)(CCC(C=CC(O)=O)O)=O,,,5,1,2,0,2
44532_0,,,,2,3,2,5
C(C(C=C)(CCC(CO)=O)O)(O)=O,,,5,1,2,0,2
44534_0,,,,2,3,2,5
C1(C(CCC(CO)=O)(CCO1)O)=O,,,5,1,2,0,2
44536_0,,,,2,3,2,5
C1(C(CC(CCC(CO)=O)O1)O)=O,,,5,1,2,0,2
44538_0,,,,2,3,2,5
C1(C(C(CCC(CO)=O)CO1)O)=O,,,5,1,2,0,2
44540_0,,,,2,3,2,5
C(C(CCC(CO)(O)O)=O)=O,,,5,1,2,0,2
44542_0,,,,2,3,2,5
C(C(CCC(CO)=O)(O)O)=O,,,5,1,2,0,2
44544_0,,,,2,3,2,5
C(C(CCC(C)(CO)O)=O)=O,,,5,1,2,0,2
44546_0,,,,2,3,2,5
C(C(C)(CCC(CO)=O)O)=O,,,5,1,2,0,2
44548_0,,,,2,3,2,5
C(C(CCCC(CO)O)=O)=O,,,5,1,2,0,2
44550_0,,,,2,3,2,5
C(C(CCCC(CO)=O)O)=O,,,5,1,3,0,3
44552_0,,,,2,3,2,5
C(CO)(CC[C](C(O)=O)O)=O,,,5,1,4,0,4
44553_0,,,,2,3,2,5
44555_0,,,,2,3,2,5
C(C(CO)(CCC(CO)=O)O)=O,,,5,1,2,0,2
44556_0,,,,2,3,2,5
44557_0,,,,2,3,2,5
44558_0,,,,2,3,2,5
44560_0,,,,2,3,2,5
C(CO)(CCC(CO)O)=O,,,5,1,2,0,2
44561_0,,,,2,3,2,5
44563_0,,,,2,3,2,5
C(CO)(CCC(C(CO)=O)O)=O,,,5,1,2,0,2
44565_0,,,,2,3,2,5
C(CO)(CCC(CO)(CO)O)=O,,,5,1,2,0,2
44567_0,,,,2,3,2,5
C(CO)(CCC(C(CO)O)O)=O,,,5,1,2,0,2
44568_0,,,,2,3,2,5
44570_0,,,,2,3,2,5
C(C(C(CCC(CO)=O)O)O)(O)=O,,,5,1,3,0,3
44571_0,,,,2,3,2,5
44572_0,,,,2,3,2,5
44574_0,,,,2,3,2,5
C(C(C=O)CCC(CO)=O)=O,,,5,1,3,0,3
44575_0,,,,2,3,2,5
44576_0,,,,2,3,2,5
44577_0,,,,2,3,2,5
44578_0,,,,2,3,2,5
44579_0,,,,2,3,2,5
44580_0,,,,2,3,2,5
44581_0,,,,2,3,2,5
44582_0,,,,2,3,2,5
44583_0,,,,2,3,2,5
44585_0,,,,2,3,2,5
C(CO)(CCC(C=O)C(C=O)O)=O,,,5,1,3,0,3
44586_0,,,,2,3,2,5
44588_0,,,,2,3,2,5
C(C(C(CO)=O)CCC(CO)=O)=O,,,5,1,3,0,3
44589_0,,,,2,3,2,5
44591_0,,,,2,3,2,5
C(C(CCC(CO)=O)O)(CC=O)=O,,,5,1,2,0,2
44592_0,,,,2,3,2,5
44594_0,,,,2,3,2,5
C(C)(C(C=O)(CCC(CO)=O)O)=O,,,5,1,2,0,2
44595_0,,,,2,3,2,5
44597_0,,,,2,3,2,5
C(CCCC(CO)=O)(C(C=O)O)=O,,,5,1,3,0,3
44598_0,,,,2,3,2,5
44600_0,,,,2,3,2,5
C(CCCC(CO)=O)=O,,,5,1,3,0,3
44602_0,,,,2,3,2,5
C(C(C)(CCC(CO)=O)O)(O)=O,,,5,1,2,0,2
44603_0,,,,2,3,2,5
44604_0,,,,2,3,2,5
44605_0,,,,2,3,2,5
44607_0,,,,2,3,2,5
C(CC(CO)C(C=CC(O)=O)O)=O,,,5,1,2,0,2
44609_0,,,,2,3,2,5
C(C(CCO)C(C=CC(O)=O)O)=O,,,5,1,1,0,1
44611_0,,,,2,3,2,5
C(C(C=C)(C(CO)CC=O)O)(O)=O,,,5,1,2,0,2
44613_0,,,,2,3,2,5
C(C(C=C)(C(C=O)CCO)O)(O)=O,,,5,1,1,0,1
44615_0,,,,2,3,2,5
C1(C(CCO1)(C(CO)CC=O)O)=O,,,5,1,2,0,2
44617_0,,,,2,3,2,5
C(C(CCO)C1(C(OCC1)=O)O)=O,,,5,1,1,0,1
44619_0,,,,2,3,2,5
C(CC(CO)C1CC(C(O1)=O)O)=O,,,5,1,2,0,2
44621_0,,,,2,3,2,5
C(C(CCO)C1CC(C(O1)=O)O)=O,,,5,1,1,0,1
44623_0,,,,2,3,2,5
C(CC(CO)C1COC(C1O)=O)=O,,,5,1,2,0,2
44625_0,,,,2,3,2,5
C(C(CCO)C1COC(C1O)=O)=O,,,5,1,1,0,1
44627_0,,,,2,3,2,5
C(C(C(CO)(O)O)CC=O)=O,,,5,1,2,0,2
44629_0,,,,2,3,2,5
C(CC(CO)C(C=O)(O)O)=O,,,5,1,2,0,2
44631_0,,,,2,3,2,5
C(C(CCO)C(C=O)(O)O)=O,,,5,1,2,0,2
44632_0,,,,2,3,2,5
44634_0,,,,2,3,2,5
C(C(C)(C(CO)CC=O)O)=O,,,5,1,2,0,2
44636_0,,,,2,3,2,5
C(C(CCO)C(C=O)(C)O)=O,,,5,1,2,0,2
44638_0,,,,2,3,2,5
C(C(CC(CO)O)CC=O)=O,,,5,1,3,0,3
44640_0,,,,2,3,2,5
C(CC(CO)CC(C=O)O)=O,,,5,1,3,0,3
44642_0,,,,2,3,2,5
C(C(CC(C=O)O)CCO)=O,,,5,1,1,0,1
44644_0,,,,2,3,2,5
C(CC([C](C(O)=O)O)CO)=O,,,5,1,3,0,3
44646_0,,,,2,3,2,5
C(C([C](C(O)=O)O)CCO)=O,,,5,1,3,0,3
44647_0,,,,2,3,2,5
44648_0,,,,2,3,2,5
44650_0,,,,2,3,2,5
C(C(C(C(C=O)O)O)CCO)=O,,,5,1,1,0,1
44652_0,,,,2,3,2,5
C(CC(CO)C(CO)(CO)O)=O,,,5,1,3,0,3
44654_0,,,,2,3,2,5
C(C(CCO)C(CO)(CO)O)=O,,,5,1,1,0,1
44656_0,,,,2,3,2,5
C(CC(CO)C(C(CO)O)O)=O,,,5,1,3,0,3
44658_0,,,,2,3,2,5
C(C(CCO)C(C(CO)O)O)=O,,,5,1,1,0,1
44659_0,,,,2,3,2,5
44660_0,,,,2,3,2,5
44662_0,,,,2,3,2,5
C(CC(CO)C(C(C(O)=O)O)O)=O,,,5,1,4,0,4
44664_0,,,,2,3,2,5
C(C(C(C(C(O)=O)O)O)CCO)=O,,,5,1,1,0,1
44665_0,,,,2,3,2,5
44666_0,,,,2,3,2,5
44668_0,,,,2,3,2,5
C(C(C(CC(C=O)=O)O)CCO)=O,,,5,1,1,0,1
44669_0,,,,2,3,2,5
44671_0,,,,2,3,2,5
C(CC(CO)C(C(C=O)=O)CO)=O,,,5,1,5,0,5
44673_0,,,,2,3,2,5
C(C(CCO)C(C(C=O)=O)CO)=O,,,5,1,4,0,4
44674_0,,,,2,3,2,5
44675_0,,,,2,3,2,5
44676_0,,,,2,3,2,5
44677_0,,,,2,3,2,5
44678_0,,,,2,3,2,5
44679_0,,,,2,3,2,5
44681_0,,,,2,3,2,5
C(CC(CO)C(C=O)C(C=O)O)=O,,,5,1,5,0,5
44682_0,,,,2,3,2,5
44683_0,,,,2,3,2,5
44685_0,,,,2,3,2,5
C(CC(CO)C(C=O)C(CO)=O)=O,,,5,1,5,0,5
44687_0,,,,2,3,2,5
C(C(CCO)C(C=O)C(CO)=O)=O,,,5,1,3,0,3
44688_0,,,,2,3,2,5
44690_0,,,,2,3,2,5
C(CC(CO)C(C(CC=O)=O)O)=O,,,5,1,3,0,3
44692_0,,,,2,3,2,5
C(C(CCO)C(C(CC=O)=O)O)=O,,,5,1,2,0,2
44693_0,,,,2,3,2,5
44695_0,,,,2,3,2,5
C(CC(CO)C(C=O)(C(C)=O)O)=O,,,5,1,3,0,3
44697_0,,,,2,3,2,5
C(C(CCO)C(C=O)(C(C)=O)O)=O,,,5,1,2,0,2
44698_0,,,,2,3,2,5
44700_0,,,,2,3,2,5
C(C(C(CC(CO)CC=O)=O)O)=O,,,5,1,5,0,5
44702_0,,,,2,3,2,5
C(C(CCO)CC(C(C=O)O)=O)=O,,,5,1,3,0,3
44704_0,,,,2,3,2,5
C(CC(CO)CC(C(O)=O)O)=O,,,5,1,2,0,2
44706_0,,,,2,3,2,5
C(C(CC(C(O)=O)O)CCO)=O,,,5,1,1,0,1
44708_0,,,,2,3,2,5
C(CCC(CO)(O)O)(O)=O,,,5,1,2,0,2
44710_0,,,,2,3,2,5
C(CCC(C)(CO)O)(O)=O,,,5,1,2,0,2
44712_0,,,,2,3,2,5
C(CCCC(CO)O)(O)=O,,,5,1,2,0,2
44713_0,,,,2,3,2,5
44714_0,,,,2,3,2,5
44715_0,,,,2,3,2,5
44716_0,,,,2,3,2,5
44717_0,,,,2,3,2,5
44718_0,,,,2,3,2,5
44719_0,,,,2,3,2,5
44720_0,,,,2,3,2,5
44721_0,,,,2,3,2,5
44722_0,,,,2,3,2,5
44723_0,,,,2,3,2,5
44724_0,,,,2,3,2,5
44725_0,,,,2,3,2,5
44726_0,,,,2,3,2,5
44727_0,,,,2,3,2,5
44728_0,,,,2,3,2,5
44729_0,,,,2,3,2,5
44730_0,,,,2,3,2,5
44731_0,,,,2,3,2,5
44732_0,,,,2,3,2,5
44733_0,,,,2,3,2,5
44734_0,,,,2,3,2,5
44735_0,,,,2,3,2,5
44736_0,,,,2,3,2,5
44738_0,,,,2,3,2,5
C(CC(CO)C(CO)(O)O)(O)=O,,,5,1,2,0,2
44740_0,,,,2,3,2,5
C(CC(CO)C(C)(CO)O)(O)=O,,,5,1,2,0,2
44742_0,,,,2,3,2,5
C(CC(CO)CC(CO)O)(O)=O,,,5,1,2,0,2
44743_0,,,,2,3,2,5
44744_0,,,,2,3,2,5
44745_0,,,,2,3,2,5
44746_0,,,,2,3,2,5
44747_0,,,,2,3,2,5
44748_0,,,,2,3,2,5
44749_0,,,,2,3,2,5
44750_0,,,,2,3,2,5
44751_0,,,,2,3,2,5
44752_0,,,,2,3,2,5
44753_0,,,,2,3,2,5
44754_0,,,,2,3,2,5
44756_0,,,,2,3,2,5
C(C)(C(C(C(O)=O)=O)(CO)O)=O,,,5,1,7,0,7
44757_0,,,,2,3,2,5
44758_0,,,,2,3,2,5
44759_0,,,,2,3,2,5
44760_0,,,,2,3,2,5
44762_0,,,,2,3,2,5
C(C(C(CO)(CCO)O)=O)(O)=O,,,5,1,5,0,5
44763_0,,,,2,3,2,5
44764_0,,,,2,3,2,5
44766_0,,,,2,3,2,5
C(C(C(C)(C(CO)O)O)=O)(O)=O,,,5,1,4,0,4
44767_0,,,,2,3,2,5
44769_0,,,,2,3,2,5
C(C(CC(CO)(CO)O)O)O,,,5,1,1,0,1
44771_0,,,,2,3,2,5
C(C(CC(CO)(C(CO)O)O)O)O,,,5,1,1,0,1
44773_0,,,,2,3,2,5
C(C(C)(CC(CO)O)O)=O,,,5,1,1,0,1
44774_0,,,,2,3,2,5
44776_0,,,,2,3,2,5
C(C)(C(CC(CO)O)O)=O,,,5,1,1,0,1
44777_0,,,,2,3,2,5
44778_0,,,,2,3,2,5
44780_0,,,,2,3,2,5
C(C(CC(CO)O)O)(CCO)=O,,,5,1,1,0,1
44781_0,,,,2,3,2,5
44782_0,,,,2,3,2,5
44783_0,,,,2,3,2,5
44784_0,,,,2,3,2,5
44786_0,,,,2,3,2,5
C(C(C(C)(CC(CO)O)O)O)=O,,,5,1,1,0,1
44788_0,,,,2,3,2,5
CC(CC(CO)O)O,,,5,1,1,0,1
44789_0,,,,2,3,2,5
44790_0,,,,2,3,2,5
44792_0,,,,2,3,2,5
C(C(CC(C(C(CO)O)O)O)O)O,,,5,1,3,0,3
44794_0,,,,2,3,2,5
C(C(CC(CO)O)O)O,,,5,1,1,0,1
44795_0,,,,2,3,2,5
44797_0,,,,2,3,2,5
C(C1C(C(C(C1O)O)O)O)(O)=O,,,5,1,2,0,2
44798_0,,,,2,3,2,5
44799_0,,,,2,3,2,5
44800_0,,,,2,3,2,5
44801_0,,,,2,3,2,5
44802_0,,,,2,3,2,5
44803_0,,,,2,3,2,5
44804_0,,,,2,3,2,5
44805_0,,,,2,3,2,5
44806_0,,,,2,3,2,5
44807_0,,,,2,3,2,5
44808_0,,,,2,3,2,5
44809_0,,,,2,3,2,5
44810_0,,,,2,3,2,5
44812_0,,,,2,3,2,5
C(C1C(C(CC1(C=O)O)O)O)(O)=O,,,5,1,2,0,2
44813_0,,,,2,3,2,5
44814_0,,,,2,3,2,5
44815_0,,,,2,3,2,5
44816_0,,,,2,3,2,5
44817_0,,,,2,3,2,5
44818_0,,,,2,3,2,5
44819_0,,,,2,3,2,5
44820_0,,,,2,3,2,5
44821_0,,,,2,3,2,5
44823_0,,,,2,3,2,5
C(C1C(C(CC1O)O)O)(O)=O,,,5,1,3,0,3
44824_0,,,,2,3,2,5
44825_0,,,,2,3,2,5
44826_0,,,,2,3,2,5
44827_0,,,,2,3,2,5
44828_0,,,,2,3,2,5
44829_0,,,,2,3,2,5
44830_0,,,,2,3,2,5
44831_0,,,,2,3,2,5
44832_0,,,,2,3,2,5
44834_0,,,,2,3,2,5
C(C1C(C(C=O)(CC1O)O)O)(O)=O,,,5,1,3,0,3
44835_0,,,,2,3,2,5
44837_0,,,,2,3,2,5
C(C1C(CC(C1(C=O)O)O)O)(O)=O,,,5,1,3,0,3
44839_0,,,,2,3,2,5
C(CC(CC(CO)(CO)O)O)(O)=O,,,5,1,1,0,1
44841_0,,,,2,3,2,5
C(C(C(O)=O)C(CO)(CO)O)(O)=O,,,5,1,3,0,3
44843_0,,,,2,3,2,5
C(C(C(C)O)C(CO)(CO)O)(O)=O,,,5,1,3,0,3
44844_0,,,,2,3,2,5
44845_0,,,,2,3,2,5
44846_0,,,,2,3,2,5
44847_0,,,,2,3,2,5
44848_0,,,,2,3,2,5
44849_0,,,,2,3,2,5
44850_0,,,,2,3,2,5
44851_0,,,,2,3,2,5
44853_0,,,,2,3,2,5
C(C(C)(CC(CC(O)=O)O)O)=O,,,5,1,1,0,1
44854_0,,,,2,3,2,5
44855_0,,,,2,3,2,5
44856_0,,,,2,3,2,5
44857_0,,,,2,3,2,5
44858_0,,,,2,3,2,5
44859_0,,,,2,3,2,5
44860_0,,,,2,3,2,5
44862_0,,,,2,3,2,5
C(C(C(O)=O)C(C=O)(C)O)(O)=O,,,5,1,3,0,3
44863_0,,,,2,3,2,5
44865_0,,,,2,3,2,5
C(C(C(C)O)C(C=O)(C)O)(O)=O,,,5,1,3,0,3
44866_0,,,,2,3,2,5
44867_0,,,,2,3,2,5
44868_0,,,,2,3,2,5
44869_0,,,,2,3,2,5
44870_0,,,,2,3,2,5
44871_0,,,,2,3,2,5
44872_0,,,,2,3,2,5
44873_0,,,,2,3,2,5
44874_0,,,,2,3,2,5
44876_0,,,,2,3,2,5
C(CC(CC(C(C)=O)O)O)(O)=O,,,5,1,1,0,1
44877_0,,,,2,3,2,5
44879_0,,,,2,3,2,5
C(C(C(O)=O)C(C(C)=O)O)(O)=O,,,5,1,3,0,3
44881_0,,,,2,3,2,5
C(C(C(C)O)C(C(C)=O)O)(O)=O,,,5,1,3,0,3
44882_0,,,,2,3,2,5
44883_0,,,,2,3,2,5
44884_0,,,,2,3,2,5
44885_0,,,,2,3,2,5
44886_0,,,,2,3,2,5
44887_0,,,,2,3,2,5
44888_0,,,,2,3,2,5
44889_0,,,,2,3,2,5
44890_0,,,,2,3,2,5
44891_0,,,,2,3,2,5
44892_0,,,,2,3,2,5
44893_0,,,,2,3,2,5
44895_0,,,,2,3,2,5
C(C(CC(C)O)(CC(O)=O)O)=O,,,5,1,1,0,1
44896_0,,,,2,3,2,5
44897_0,,,,2,3,2,5
44898_0,,,,2,3,2,5
44899_0,,,,2,3,2,5
44900_0,,,,2,3,2,5
44901_0,,,,2,3,2,5
44902_0,,,,2,3,2,5
44903_0,,,,2,3,2,5
44904_0,,,,2,3,2,5
44905_0,,,,2,3,2,5
44906_0,,,,2,3,2,5
44907_0,,,,2,3,2,5
44908_0,,,,2,3,2,5
44910_0,,,,2,3,2,5
C(C(CC(CO)O)(CC(O)=O)O)=O,,,5,1,1,0,1
44911_0,,,,2,3,2,5
44912_0,,,,2,3,2,5
44913_0,,,,2,3,2,5
44914_0,,,,2,3,2,5
44915_0,,,,2,3,2,5
44916_0,,,,2,3,2,5
44917_0,,,,2,3,2,5
44918_0,,,,2,3,2,5
44919_0,,,,2,3,2,5
44920_0,,,,2,3,2,5
44921_0,,,,2,3,2,5
44922_0,,,,2,3,2,5
44923_0,,,,2,3,2,5
44924_0,,,,2,3,2,5
44925_0,,,,2,3,2,5
44926_0,,,,2,3,2,5
44927_0,,,,2,3,2,5
44928_0,,,,2,3,2,5
44929_0,,,,2,3,2,5
44930_0,,,,2,3,2,5
44931_0,,,,2,3,2,5
44932_0,,,,2,3,2,5
44933_0,,,,2,3,2,5
44934_0,,,,2,3,2,5
44935_0,,,,2,3,2,5
44936_0,,,,2,3,2,5
44937_0,,,,2,3,2,5
44938_0,,,,2,3,2,5
44939_0,,,,2,3,2,5
44940_0,,,,2,3,2,5
44941_0,,,,2,3,2,5
44942_0,,,,2,3,2,5
44943_0,,,,2,3,2,5
44944_0,,,,2,3,2,5
44945_0,,,,2,3,2,5
44946_0,,,,2,3,2,5
44947_0,,,,2,3,2,5
44948_0,,,,2,3,2,5
44949_0,,,,2,3,2,5
44950_0,,,,2,3,2,5
44951_0,,,,2,3,2,5
44952_0,,,,2,3,2,5
44953_0,,,,2,3,2,5
44954_0,,,,2,3,2,5
44955_0,,,,2,3,2,5
44956_0,,,,2,3,2,5
44957_0,,,,2,3,2,5
44958_0,,,,2,3,2,5
44959_0,,,,2,3,2,5
44960_0,,,,2,3,2,5
44962_0,,,,2,3,2,5
C(CC(CCO)(C(C=O)O)O)(O)=O,,,5,1,1,0,1
44963_0,,,,2,3,2,5
44964_0,,,,2,3,2,5
44965_0,,,,2,3,2,5
44967_0,,,,2,3,2,5
C(C(C(C)O)C(CC(C)O)O)(O)=O,,,5,1,2,0,2
44968_0,,,,2,3,2,5
44970_0,,,,2,3,2,5
C(C(C(O)=O)C(CC(C)O)O)(O)=O,,,5,1,2,0,2
44971_0,,,,2,3,2,5
44972_0,,,,2,3,2,5
44974_0,,,,2,3,2,5
C(CC(CC(C)O)O)(O)=O,,,5,1,1,0,1
44975_0,,,,2,3,2,5
44976_0,,,,2,3,2,5
44978_0,,,,2,3,2,5
C(C(C(C)O)C(CCO)O)(O)=O,,,5,1,2,0,2
44980_0,,,,2,3,2,5
C(C(C(C)O)C(C)(CO)O)(O)=O,,,5,1,2,0,2
44982_0,,,,2,3,2,5
C(C(C(C)O)C(C(O)=O)(C)O)(O)=O,,,5,1,2,0,2
44984_0,,,,2,3,2,5
C(C(C(CC(O)=O)O)C(C)O)(O)=O,,,5,1,2,0,2
44985_0,,,,2,3,2,5
44987_0,,,,2,3,2,5
C(C(C=C)(C(C(O)=O)C(C)O)O)=O,,,5,1,2,0,2
44989_0,,,,2,3,2,5
C(C(C(C)O)C(C(C=C)=O)O)(O)=O,,,5,1,2,0,2
44990_0,,,,2,3,2,5
44992_0,,,,2,3,2,5
C(C(C(C)O)C(C=CC=O)O)(O)=O,,,5,1,2,0,2
44994_0,,,,2,3,2,5
C(C(C(O)=O)C(C)O)(O)=O,,,5,1,3,0,3
44996_0,,,,2,3,2,5
C(C(C(C(O)O)O)C(C)O)(O)=O,,,5,1,2,0,2
44998_0,,,,2,3,2,5
C(C(C(C)O)C(C(C)O)O)(O)=O,,,5,1,2,0,2
45000_0,,,,2,3,2,5
C(C(C(C)O)C(C(CO)O)O)(O)=O,,,5,1,3,0,3
45002_0,,,,2,3,2,5
C(C(C(C)O)C(C)O)(O)=O,,,5,1,2,0,2
45003_0,,,,2,3,2,5
45005_0,,,,2,3,2,5
C(C(C(C)O)C(C=O)(CO)O)(O)=O,,,5,1,4,0,4
45006_0,,,,2,3,2,5
45007_0,,,,2,3,2,5
45008_0,,,,2,3,2,5
45009_0,,,,2,3,2,5
45010_0,,,,2,3,2,5
45011_0,,,,2,3,2,5
45012_0,,,,2,3,2,5
45013_0,,,,2,3,2,5
45014_0,,,,2,3,2,5
45016_0,,,,2,3,2,5
C(CC(C(C(C)O)O)O)(O)=O,,,5,1,1,0,1
45017_0,,,,2,3,2,5
45018_0,,,,2,3,2,5
45019_0,,,,2,3,2,5
45021_0,,,,2,3,2,5
C(C(CO)(CC(CC(O)=O)O)O)=O,,,5,1,2,0,2
45022_0,,,,2,3,2,5
45023_0,,,,2,3,2,5
45025_0,,,,2,3,2,5
C(C(C(O)=O)C(C=O)(CO)O)(O)=O,,,5,1,4,0,4
45026_0,,,,2,3,2,5
45027_0,,,,2,3,2,5
45028_0,,,,2,3,2,5
45029_0,,,,2,3,2,5
45030_0,,,,2,3,2,5
45031_0,,,,2,3,2,5
45033_0,,,,2,3,2,5
C(CC(CC(C(CO)O)O)O)(O)=O,,,5,1,1,0,1
45035_0,,,,2,3,2,5
C(C(C(O)=O)C(C(CO)O)O)(O)=O,,,5,1,3,0,3
45036_0,,,,2,3,2,5
45037_0,,,,2,3,2,5
45038_0,,,,2,3,2,5
45040_0,,,,2,3,2,5
C(C(C(O)=O)C(CCO)O)(O)=O,,,5,1,2,0,2
45041_0,,,,2,3,2,5
45042_0,,,,2,3,2,5
45043_0,,,,2,3,2,5
45044_0,,,,2,3,2,5
45045_0,,,,2,3,2,5
45046_0,,,,2,3,2,5
45047_0,,,,2,3,2,5
45048_0,,,,2,3,2,5
45049_0,,,,2,3,2,5
45050_0,,,,2,3,2,5
45051_0,,,,2,3,2,5
45052_0,,,,2,3,2,5
45053_0,,,,2,3,2,5
45054_0,,,,2,3,2,5
45055_0,,,,2,3,2,5
45056_0,,,,2,3,2,5
45057_0,,,,2,3,2,5
45058_0,,,,2,3,2,5
45059_0,,,,2,3,2,5
45060_0,,,,2,3,2,5
45061_0,,,,2,3,2,5
45062_0,,,,2,3,2,5
45063_0,,,,2,3,2,5
45064_0,,,,2,3,2,5
45065_0,,,,2,3,2,5
45066_0,,,,2,3,2,5
45067_0,,,,2,3,2,5
45068_0,,,,2,3,2,5
45069_0,,,,2,3,2,5
45070_0,,,,2,3,2,5
45071_0,,,,2,3,2,5
45072_0,,,,2,3,2,5
45073_0,,,,2,3,2,5
45074_0,,,,2,3,2,5
45075_0,,,,2,3,2,5
45076_0,,,,2,3,2,5
45077_0,,,,2,3,2,5
45078_0,,,,2,3,2,5
45079_0,,,,2,3,2,5
45080_0,,,,2,3,2,5
45081_0,,,,2,3,2,5
45082_0,,,,2,3,2,5
45083_0,,,,2,3,2,5
45084_0,,,,2,3,2,5
45085_0,,,,2,3,2,5
45086_0,,,,2,3,2,5
45087_0,,,,2,3,2,5
45088_0,,,,2,3,2,5
45089_0,,,,2,3,2,5
45090_0,,,,2,3,2,5
45091_0,,,,2,3,2,5
45092_0,,,,2,3,2,5
45093_0,,,,2,3,2,5
45094_0,,,,2,3,2,5
45095_0,,,,2,3,2,5
45096_0,,,,2,3,2,5
45097_0,,,,2,3,2,5
45098_0,,,,2,3,2,5
45099_0,,,,2,3,2,5
45100_0,,,,2,3,2,5
45101_0,,,,2,3,2,5
45102_0,,,,2,3,2,5
45103_0,,,,2,3,2,5
45104_0,,,,2,3,2,5
45105_0,,,,2,3,2,5
45106_0,,,,2,3,2,5
45107_0,,,,2,3,2,5
45108_0,,,,2,3,2,5
45109_0,,,,2,3,2,5
45110_0,,,,2,3,2,5
45111_0,,,,2,3,2,5
45112_0,,,,2,3,2,5
45113_0,,,,2,3,2,5
45114_0,,,,2,3,2,5
45116_0,,,,2,3,2,5
C(C)(C(CO)(CC(O)=O)O)=O,,,5,1,4,0,4
45117_0,,,,2,3,2,5
45118_0,,,,2,3,2,5
45119_0,,,,2,3,2,5
45120_0,,,,2,3,2,5
45121_0,,,,2,3,2,5
45122_0,,,,2,3,2,5
45123_0,,,,2,3,2,5
45124_0,,,,2,3,2,5
45125_0,,,,2,3,2,5
45126_0,,,,2,3,2,5
45127_0,,,,2,3,2,5
45128_0,,,,2,3,2,5
45129_0,,,,2,3,2,5
45130_0,,,,2,3,2,5
45131_0,,,,2,3,2,5
45132_0,,,,2,3,2,5
45133_0,,,,2,3,2,5
45134_0,,,,2,3,2,5
45135_0,,,,2,3,2,5
45136_0,,,,2,3,2,5
45137_0,,,,2,3,2,5
45138_0,,,,2,3,2,5
45139_0,,,,2,3,2,5
45140_0,,,,2,3,2,5
45141_0,,,,2,3,2,5
45142_0,,,,2,3,2,5
45143_0,,,,2,3,2,5
45145_0,,,,2,3,2,5
C(C(C(O)=O)C(C)(CO)O)(O)=O,,,5,1,2,0,2
45146_0,,,,2,3,2,5
45147_0,,,,2,3,2,5
45148_0,,,,2,3,2,5
45149_0,,,,2,3,2,5
45150_0,,,,2,3,2,5
45151_0,,,,2,3,2,5
45152_0,,,,2,3,2,5
45153_0,,,,2,3,2,5
45154_0,,,,2,3,2,5
45155_0,,,,2,3,2,5
45156_0,,,,2,3,2,5
45157_0,,,,2,3,2,5
45158_0,,,,2,3,2,5
45159_0,,,,2,3,2,5
45160_0,,,,2,3,2,5
45161_0,,,,2,3,2,5
45162_0,,,,2,3,2,5
45163_0,,,,2,3,2,5
45164_0,,,,2,3,2,5
45165_0,,,,2,3,2,5
45166_0,,,,2,3,2,5
45167_0,,,,2,3,2,5
45168_0,,,,2,3,2,5
45169_0,,,,2,3,2,5
45170_0,,,,2,3,2,5
45171_0,,,,2,3,2,5
45172_0,,,,2,3,2,5
45173_0,,,,2,3,2,5
45174_0,,,,2,3,2,5
45175_0,,,,2,3,2,5
45176_0,,,,2,3,2,5
45177_0,,,,2,3,2,5
45178_0,,,,2,3,2,5
45179_0,,,,2,3,2,5
45180_0,,,,2,3,2,5
45181_0,,,,2,3,2,5
45182_0,,,,2,3,2,5
45183_0,,,,2,3,2,5
45184_0,,,,2,3,2,5
45185_0,,,,2,3,2,5
45186_0,,,,2,3,2,5
45187_0,,,,2,3,2,5
45188_0,,,,2,3,2,5
45189_0,,,,2,3,2,5
45190_0,,,,2,3,2,5
45191_0,,,,2,3,2,5
45192_0,,,,2,3,2,5
45193_0,,,,2,3,2,5
45194_0,,,,2,3,2,5
45195_0,,,,2,3,2,5
45196_0,,,,2,3,2,5
45198_0,,,,2,3,2,5
C(C(C(O)=O)C(C(O)=O)(C)O)(O)=O,,,5,1,2,0,2
45199_0,,,,2,3,2,5
45200_0,,,,2,3,2,5
45201_0,,,,2,3,2,5
45202_0,,,,2,3,2,5
45203_0,,,,2,3,2,5
45204_0,,,,2,3,2,5
45205_0,,,,2,3,2,5
45206_0,,,,2,3,2,5
45207_0,,,,2,3,2,5
45208_0,,,,2,3,2,5
45210_0,,,,2,3,2,5
C(C(C(O)=O)C(CC(O)=O)O)(O)=O,,,5,1,2,0,2
45211_0,,,,2,3,2,5
45212_0,,,,2,3,2,5
45214_0,,,,2,3,2,5
C(CC(CC(O)=O)O)(O)=O,,,5,1,1,0,1
45215_0,,,,2,3,2,5
45216_0,,,,2,3,2,5
45217_0,,,,2,3,2,5
45219_0,,,,2,3,2,5
C(C(C(O)=O)C(C=O)(C=C)O)(O)=O,,,5,1,2,0,2
45221_0,,,,2,3,2,5
C(C(C(O)=O)C(C(C=C)=O)O)(O)=O,,,5,1,2,0,2
45222_0,,,,2,3,2,5
45224_0,,,,2,3,2,5
C(C(C(O)=O)C(C=CC=O)O)(O)=O,,,5,1,2,0,2
45226_0,,,,2,3,2,5
C(C(C(O)=O)C(O)=O)(O)=O,,,5,1,2,0,2
45228_0,,,,2,3,2,5
C(C(C(O)=O)C(C(O)O)O)(O)=O,,,5,1,2,0,2
45230_0,,,,2,3,2,5
C(C(C(O)=O)C(C(C)O)O)(O)=O,,,5,1,2,0,2
45231_0,,,,2,3,2,5
45232_0,,,,2,3,2,5
45233_0,,,,2,3,2,5
45234_0,,,,2,3,2,5
45236_0,,,,2,3,2,5
C(CC(C(CC(O)=O)O)O)(O)=O,,,5,1,1,0,1
45237_0,,,,2,3,2,5
45239_0,,,,2,3,2,5
C(CC(CO)(CC(O)=O)O)(O)=O,,,5,1,1,0,1
45240_0,,,,2,3,2,5
45241_0,,,,2,3,2,5
45243_0,,,,2,3,2,5
C(CC(C)(C(C(O)=O)O)O)(O)=O,,,5,1,4,0,4
45244_0,,,,2,3,2,5
45245_0,,,,2,3,2,5
45246_0,,,,2,3,2,5
45247_0,,,,2,3,2,5
45248_0,,,,2,3,2,5
45249_0,,,,2,3,2,5
45250_0,,,,2,3,2,5
45251_0,,,,2,3,2,5
45252_0,,,,2,3,2,5
45253_0,,,,2,3,2,5
45255_0,,,,2,3,2,5
C(C(CO)(C(C)(CC(O)=O)O)O)=O,,,5,1,5,0,5
45256_0,,,,2,3,2,5
45257_0,,,,2,3,2,5
45258_0,,,,2,3,2,5
45259_0,,,,2,3,2,5
45260_0,,,,2,3,2,5
45261_0,,,,2,3,2,5
45262_0,,,,2,3,2,5
45263_0,,,,2,3,2,5
45264_0,,,,2,3,2,5
45265_0,,,,2,3,2,5
45266_0,,,,2,3,2,5
45267_0,,,,2,3,2,5
45268_0,,,,2,3,2,5
45269_0,,,,2,3,2,5
45270_0,,,,2,3,2,5
45271_0,,,,2,3,2,5
45272_0,,,,2,3,2,5
45273_0,,,,2,3,2,5
45274_0,,,,2,3,2,5
45275_0,,,,2,3,2,5
45276_0,,,,2,3,2,5
45277_0,,,,2,3,2,5
45278_0,,,,2,3,2,5
45279_0,,,,2,3,2,5
45280_0,,,,2,3,2,5
45281_0,,,,2,3,2,5
45282_0,,,,2,3,2,5
45283_0,,,,2,3,2,5
45284_0,,,,2,3,2,5
45285_0,,,,2,3,2,5
45286_0,,,,2,3,2,5
45287_0,,,,2,3,2,5
45288_0,,,,2,3,2,5
45289_0,,,,2,3,2,5
45290_0,,,,2,3,2,5
45291_0,,,,2,3,2,5
45292_0,,,,2,3,2,5
45293_0,,,,2,3,2,5
45294_0,,,,2,3,2,5
45295_0,,,,2,3,2,5
45296_0,,,,2,3,2,5
45297_0,,,,2,3,2,5
45298_0,,,,2,3,2,5
45299_0,,,,2,3,2,5
45300_0,,,,2,3,2,5
45301_0,,,,2,3,2,5
45302_0,,,,2,3,2,5
45303_0,,,,2,3,2,5
45304_0,,,,2,3,2,5
45306_0,,,,2,3,2,5
C(CC(C=O)(CC(O)=O)O)(O)=O,,,5,1,2,0,2
45307_0,,,,2,3,2,5
45308_0,,,,2,3,2,5
45309_0,,,,2,3,2,5
45310_0,,,,2,3,2,5
45311_0,,,,2,3,2,5
45312_0,,,,2,3,2,5
45313_0,,,,2,3,2,5
45314_0,,,,2,3,2,5
45315_0,,,,2,3,2,5
45316_0,,,,2,3,2,5
45317_0,,,,2,3,2,5
45318_0,,,,2,3,2,5
45319_0,,,,2,3,2,5
45320_0,,,,2,3,2,5
45321_0,,,,2,3,2,5
45322_0,,,,2,3,2,5
45324_0,,,,2,3,2,5
C(CC1(COCC1O)O)(O)=O,,,5,1,1,0,1
45325_0,,,,2,3,2,5
45326_0,,,,2,3,2,5
45327_0,,,,2,3,2,5
45328_0,,,,2,3,2,5
45329_0,,,,2,3,2,5
45330_0,,,,2,3,2,5
45332_0,,,,2,3,2,5
C(CC1(C(O)OCC1)O)(O)=O,,,5,1,2,0,2
45333_0,,,,2,3,2,5
45334_0,,,,2,3,2,5
45335_0,,,,2,3,2,5
45336_0,,,,2,3,2,5
45337_0,,,,2,3,2,5
45338_0,,,,2,3,2,5
45340_0,,,,2,3,2,5
C(CC1(COC(C1)O)O)(O)=O,,,5,1,2,0,2
45341_0,,,,2,3,2,5
45342_0,,,,2,3,2,5
45343_0,,,,2,3,2,5
45344_0,,,,2,3,2,5
45345_0,,,,2,3,2,5
45346_0,,,,2,3,2,5
45347_0,,,,2,3,2,5
45348_0,,,,2,3,2,5
45349_0,,,,2,3,2,5
45350_0,,,,2,3,2,5
45351_0,,,,2,3,2,5
45353_0,,,,2,3,2,5
C(C(C(C)=O)(CC(O)=O)O)=O,,,5,1,3,0,3
45354_0,,,,2,3,2,5
45355_0,,,,2,3,2,5
45356_0,,,,2,3,2,5
45357_0,,,,2,3,2,5
45358_0,,,,2,3,2,5
45359_0,,,,2,3,2,5
45360_0,,,,2,3,2,5
45361_0,,,,2,3,2,5
45363_0,,,,2,3,2,5
C(CC(C(C=O)=O)(C)O)(O)=O,,,5,1,3,0,3
45364_0,,,,2,3,2,5
45365_0,,,,2,3,2,5
45366_0,,,,2,3,2,5
45367_0,,,,2,3,2,5
45368_0,,,,2,3,2,5
45369_0,,,,2,3,2,5
45370_0,,,,2,3,2,5
45371_0,,,,2,3,2,5
45372_0,,,,2,3,2,5
45373_0,,,,2,3,2,5
45374_0,,,,2,3,2,5
45375_0,,,,2,3,2,5
45376_0,,,,2,3,2,5
45377_0,,,,2,3,2,5
45378_0,,,,2,3,2,5
45379_0,,,,2,3,2,5
45380_0,,,,2,3,2,5
45381_0,,,,2,3,2,5
45382_0,,,,2,3,2,5
45383_0,,,,2,3,2,5
45384_0,,,,2,3,2,5
45385_0,,,,2,3,2,5
45387_0,,,,2,3,2,5
C(C(C=C)(CC(O)=O)O)=O,,,5,1,3,0,3
45388_0,,,,2,3,2,5
45389_0,,,,2,3,2,5
45390_0,,,,2,3,2,5
45391_0,,,,2,3,2,5
45392_0,,,,2,3,2,5
45393_0,,,,2,3,2,5
45394_0,,,,2,3,2,5
45396_0,,,,2,3,2,5
C(CC(C(C=C)=O)O)(O)=O,,,5,1,2,0,2
45397_0,,,,2,3,2,5
45398_0,,,,2,3,2,5
45399_0,,,,2,3,2,5
45400_0,,,,2,3,2,5
45401_0,,,,2,3,2,5
45402_0,,,,2,3,2,5
45403_0,,,,2,3,2,5
45405_0,,,,2,3,2,5
C(CC(C=CC=O)O)(O)=O,,,5,1,3,0,3
45406_0,,,,2,3,2,5
45407_0,,,,2,3,2,5
45408_0,,,,2,3,2,5
45409_0,,,,2,3,2,5
45410_0,,,,2,3,2,5
45412_0,,,,2,3,2,5
C(CC1(C(O)OCC1O)O)(O)=O,,,5,1,2,0,2
45413_0,,,,2,3,2,5
45414_0,,,,2,3,2,5
45415_0,,,,2,3,2,5
45416_0,,,,2,3,2,5
45417_0,,,,2,3,2,5
45418_0,,,,2,3,2,5
45419_0,,,,2,3,2,5
45420_0,,,,2,3,2,5
45421_0,,,,2,3,2,5
45422_0,,,,2,3,2,5
45423_0,,,,2,3,2,5
45424_0,,,,2,3,2,5
45425_0,,,,2,3,2,5
45427_0,,,,2,3,2,5
C(CC(C(O)O)O)(O)=O,,,5,1,2,0,2
45428_0,,,,2,3,2,5
45429_0,,,,2,3,2,5
45430_0,,,,2,3,2,5
45431_0,,,,2,3,2,5
45432_0,,,,2,3,2,5
45433_0,,,,2,3,2,5
45434_0,,,,2,3,2,5
45435_0,,,,2,3,2,5
45436_0,,,,2,3,2,5
45437_0,,,,2,3,2,5
45439_0,,,,2,3,2,5
C(CC(C(C)O)O)(O)=O,,,5,1,2,0,2
45440_0,,,,2,3,2,5
45441_0,,,,2,3,2,5
45442_0,,,,2,3,2,5
45443_0,,,,2,3,2,5
45444_0,,,,2,3,2,5
45445_0,,,,2,3,2,5
45446_0,,,,2,3,2,5
45447_0,,,,2,3,2,5
45448_0,,,,2,3,2,5
45449_0,,,,2,3,2,5
45450_0,,,,2,3,2,5
45451_0,,,,2,3,2,5
45452_0,,,,2,3,2,5
45453_0,,,,2,3,2,5
45454_0,,,,2,3,2,5
45455_0,,,,2,3,2,5
45456_0,,,,2,3,2,5
45457_0,,,,2,3,2,5
45458_0,,,,2,3,2,5
45459_0,,,,2,3,2,5
45460_0,,,,2,3,2,5
45461_0,,,,2,3,2,5
45462_0,,,,2,3,2,5
45463_0,,,,2,3,2,5
45464_0,,,,2,3,2,5
45465_0,,,,2,3,2,5
45466_0,,,,2,3,2,5
45467_0,,,,2,3,2,5
45468_0,,,,2,3,2,5
45469_0,,,,2,3,2,5
45470_0,,,,2,3,2,5
45471_0,,,,2,3,2,5
45473_0,,,,2,3,2,5
C(C(C(C(CO)=O)=O)(CO)O)(O)=O,,,5,1,5,0,5
45474_0,,,,2,3,2,5
45475_0,,,,2,3,2,5
45476_0,,,,2,3,2,5
45477_0,,,,2,3,2,5
45478_0,,,,2,3,2,5
45479_0,,,,2,3,2,5
45480_0,,,,2,3,2,5
45481_0,,,,2,3,2,5
45482_0,,,,2,3,2,5
45483_0,,,,2,3,2,5
45484_0,,,,2,3,2,5
45485_0,,,,2,3,2,5
45486_0,,,,2,3,2,5
45488_0,,,,2,3,2,5
C(C(C(C(CCO)=O)=O)(C)O)(O)=O,,,5,1,3,0,3
45489_0,,,,2,3,2,5
45490_0,,,,2,3,2,5
45491_0,,,,2,3,2,5
45493_0,,,,2,3,2,5
C(CC(C(C(CCO)=O)=O)O)(O)=O,,,5,1,2,0,2
45494_0,,,,2,3,2,5
45495_0,,,,2,3,2,5
45497_0,,,,2,3,2,5
C(C(C(C(C)=O)=O)(CCO)O)(O)=O,,,5,1,1,0,1
45498_0,,,,2,3,2,5
45499_0,,,,2,3,2,5
45500_0,,,,2,3,2,5
45501_0,,,,2,3,2,5
45502_0,,,,2,3,2,5
45503_0,,,,2,3,2,5
45504_0,,,,2,3,2,5
45506_0,,,,2,3,2,5
C(CC(C(C(C)=O)=O)(CO)O)(O)=O,,,5,1,1,0,1
45507_0,,,,2,3,2,5
45508_0,,,,2,3,2,5
45510_0,,,,2,3,2,5
C(C(C(C(C(C)=O)=O)(C)O)O)(O)=O,,,5,1,3,0,3
45511_0,,,,2,3,2,5
45512_0,,,,2,3,2,5
45513_0,,,,2,3,2,5
45514_0,,,,2,3,2,5
45515_0,,,,2,3,2,5
45516_0,,,,2,3,2,5
45517_0,,,,2,3,2,5
45518_0,,,,2,3,2,5
45519_0,,,,2,3,2,5
45520_0,,,,2,3,2,5
45521_0,,,,2,3,2,5
45522_0,,,,2,3,2,5
45523_0,,,,2,3,2,5
45524_0,,,,2,3,2,5
45525_0,,,,2,3,2,5
45526_0,,,,2,3,2,5
45527_0,,,,2,3,2,5
45528_0,,,,2,3,2,5
45529_0,,,,2,3,2,5
45530_0,,,,2,3,2,5
45531_0,,,,2,3,2,5
45532_0,,,,2,3,2,5
45533_0,,,,2,3,2,5
45534_0,,,,2,3,2,5
45535_0,,,,2,3,2,5
45536_0,,,,2,3,2,5
45537_0,,,,2,3,2,5
45539_0,,,,2,3,2,5
C(C(COC(C(O)=O)O)O)=O,,,5,1,3,0,3
45541_0,,,,2,3,2,5
C(C(COC(C=O)O)O)(O)=O,,,5,1,4,0,4
45543_0,,,,2,3,2,5
C(C(C(CO)OC(C(O)=O)O)O)=O,,,5,1,3,0,3
45545_0,,,,2,3,2,5
C(C(C(CO)OC(C=O)O)O)(O)=O,,,5,1,4,0,4
45547_0,,,,2,3,2,5
C(C(C(COC(C(O)=O)O)O)O)=O,,,5,1,3,0,3
45549_0,,,,2,3,2,5
C(C(C(COC(C=O)O)O)O)(O)=O,,,5,1,4,0,4
45551_0,,,,2,3,2,5
C(C(C(C(OCC=O)O)O)O)(O)=O,,,5,1,4,0,4
45553_0,,,,2,3,2,5
C(C(C(C(OCC(O)=O)O)O)O)=O,,,5,1,2,0,2
45554_0,,,,2,3,2,5
45555_0,,,,2,3,2,5
45556_0,,,,2,3,2,5
45557_0,,,,2,3,2,5
45558_0,,,,2,3,2,5
45559_0,,,,2,3,2,5
45560_0,,,,2,3,2,5
45561_0,,,,2,3,2,5
45562_0,,,,2,3,2,5
45563_0,,,,2,3,2,5
45564_0,,,,2,3,2,5
45565_0,,,,2,3,2,5
45566_0,,,,2,3,2,5
45567_0,,,,2,3,2,5
45568_0,,,,2,3,2,5
45569_0,,,,2,3,2,5
45570_0,,,,2,3,2,5
45571_0,,,,2,3,2,5
45572_0,,,,2,3,2,5
45573_0,,,,2,3,2,5
45574_0,,,,2,3,2,5
45575_0,,,,2,3,2,5
45576_0,,,,2,3,2,5
45577_0,,,,2,3,2,5
45578_0,,,,2,3,2,5
45579_0,,,,2,3,2,5
45580_0,,,,2,3,2,5
45581_0,,,,2,3,2,5
45582_0,,,,2,3,2,5
45583_0,,,,2,3,2,5
45584_0,,,,2,3,2,5
45585_0,,,,2,3,2,5
45586_0,,,,2,3,2,5
45587_0,,,,2,3,2,5
45588_0,,,,2,3,2,5
45589_0,,,,2,3,2,5
45590_0,,,,2,3,2,5
45591_0,,,,2,3,2,5
45592_0,,,,2,3,2,5
45593_0,,,,2,3,2,5
45594_0,,,,2,3,2,5
45595_0,,,,2,3,2,5
45596_0,,,,2,3,2,5
45597_0,,,,2,3,2,5
45598_0,,,,2,3,2,5
45599_0,,,,2,3,2,5
45600_0,,,,2,3,2,5
45601_0,,,,2,3,2,5
45602_0,,,,2,3,2,5
45603_0,,,,2,3,2,5
45604_0,,,,2,3,2,5
45605_0,,,,2,3,2,5
45606_0,,,,2,3,2,5
45607_0,,,,2,3,2,5
45608_0,,,,2,3,2,5
45609_0,,,,2,3,2,5
45610_0,,,,2,3,2,5
45611_0,,,,2,3,2,5
45612_0,,,,2,3,2,5
45613_0,,,,2,3,2,5
45614_0,,,,2,3,2,5
45615_0,,,,2,3,2,5
45616_0,,,,2,3,2,5
45617_0,,,,2,3,2,5
45618_0,,,,2,3,2,5
45619_0,,,,2,3,2,5
45620_0,,,,2,3,2,5
45621_0,,,,2,3,2,5
45622_0,,,,2,3,2,5
45623_0,,,,2,3,2,5
45624_0,,,,2,3,2,5
45625_0,,,,2,3,2,5
45626_0,,,,2,3,2,5
45627_0,,,,2,3,2,5
45628_0,,,,2,3,2,5
45629_0,,,,2,3,2,5
45630_0,,,,2,3,2,5
45631_0,,,,2,3,2,5
45632_0,,,,2,3,2,5
45633_0,,,,2,3,2,5
45634_0,,,,2,3,2,5
45635_0,,,,2,3,2,5
45636_0,,,,2,3,2,5
45637_0,,,,2,3,2,5
45638_0,,,,2,3,2,5
45639_0,,,,2,3,2,5
45640_0,,,,2,3,2,5
45641_0,,,,2,3,2,5
45642_0,,,,2,3,2,5
45643_0,,,,2,3,2,5
45644_0,,,,2,3,2,5
45645_0,,,,2,3,2,5
45646_0,,,,2,3,2,5
45647_0,,,,2,3,2,5
45648_0,,,,2,3,2,5
45649_0,,,,2,3,2,5
45650_0,,,,2,3,2,5
45651_0,,,,2,3,2,5
45652_0,,,,2,3,2,5
45653_0,,,,2,3,2,5
45654_0,,,,2,3,2,5
45655_0,,,,2,3,2,5
45656_0,,,,2,3,2,5
45657_0,,,,2,3,2,5
45658_0,,,,2,3,2,5
45659_0,,,,2,3,2,5
45660_0,,,,2,3,2,5
45661_0,,,,2,3,2,5
45662_0,,,,2,3,2,5
45663_0,,,,2,3,2,5
45664_0,,,,2,3,2,5
45665_0,,,,2,3,2,5
45666_0,,,,2,3,2,5
45667_0,,,,2,3,2,5
45668_0,,,,2,3,2,5
45670_0,,,,2,3,2,5
C(C1(C=O)C(C(CC1O)O)O)(O)=O,,,5,1,4,0,4
45671_0,,,,2,3,2,5
45672_0,,,,2,3,2,5
45673_0,,,,2,3,2,5
45674_0,,,,2,3,2,5
45675_0,,,,2,3,2,5
45676_0,,,,2,3,2,5
45677_0,,,,2,3,2,5
45678_0,,,,2,3,2,5
45679_0,,,,2,3,2,5
45680_0,,,,2,3,2,5
45681_0,,,,2,3,2,5
45682_0,,,,2,3,2,5
45683_0,,,,2,3,2,5
45684_0,,,,2,3,2,5
45686_0,,,,2,3,2,5
C(C(C=O)(C(CC(O)=O)O)O)(O)=O,,,5,1,6,0,6
45687_0,,,,2,3,2,5
45688_0,,,,2,3,2,5
45690_0,,,,2,3,2,5
C(C(C(O)=O)(C=O)C(C)O)(O)=O,,,5,1,3,0,3
45691_0,,,,2,3,2,5
45692_0,,,,2,3,2,5
45694_0,,,,2,3,2,5
C(C(C=O)(C(C)O)C(C)O)(O)=O,,,5,1,3,0,3
45695_0,,,,2,3,2,5
45696_0,,,,2,3,2,5
45697_0,,,,2,3,2,5
45699_0,,,,2,3,2,5
C(C(C(O)=O)(C=O)C(C=O)O)(O)=O,,,5,1,3,0,3
45700_0,,,,2,3,2,5
45701_0,,,,2,3,2,5
45703_0,,,,2,3,2,5
C(C(C=O)(CO)C(CCO)O)(O)=O,,,5,1,4,0,4
45705_0,,,,2,3,2,5
C(C(C=O)(CO)C(C)(CO)O)(O)=O,,,5,1,4,0,4
45707_0,,,,2,3,2,5
C(C(C(O)=O)(C=O)CO)(O)=O,,,5,1,3,0,3
45709_0,,,,2,3,2,5
C(C(C=O)(CO)C(C(O)O)O)(O)=O,,,5,1,4,0,4
45711_0,,,,2,3,2,5
C(C(C=O)(CO)C(C(C)O)O)(O)=O,,,5,1,4,0,4
45712_0,,,,2,3,2,5
45713_0,,,,2,3,2,5
45715_0,,,,2,3,2,5
C(C(C(O)=O)(C=O)C(CO)O)(O)=O,,,5,1,3,0,3
45717_0,,,,2,3,2,5
C(C(C(CO)(CO)C(C)O)=O)(O)=O,,,5,1,3,0,3
45719_0,,,,2,3,2,5
C(C(C(C(O)=O)=O)(CO)CO)(O)=O,,,5,1,3,0,3
45721_0,,,,2,3,2,5
C(C(C(CO)(CO)CO)=O)(O)=O,,,5,1,2,0,2
45722_0,,,,2,3,2,5
45723_0,,,,2,3,2,5
45724_0,,,,2,3,2,5
45726_0,,,,2,3,2,5
C(C(C(O)=O)(CO)C(C=O)O)(O)=O,,,5,1,3,0,3
45727_0,,,,2,3,2,5
45728_0,,,,2,3,2,5
45729_0,,,,2,3,2,5
45731_0,,,,2,3,2,5
C(C(C(O)=O)(C(CO)=O)CO)(O)=O,,,5,1,3,0,3
45732_0,,,,2,3,2,5
45733_0,,,,2,3,2,5
45734_0,,,,2,3,2,5
45735_0,,,,2,3,2,5
45736_0,,,,2,3,2,5
45738_0,,,,2,3,2,5
C(C(C=O)(C(CC(C)O)O)O)(O)=O,,,5,1,5,0,5
45739_0,,,,2,3,2,5
45741_0,,,,2,3,2,5
C(C(C(C(O)=O)=O)(C(C)O)O)(O)=O,,,5,1,7,0,7
45743_0,,,,2,3,2,5
C(C(C(C(C)O)(C(C)O)O)=O)(O)=O,,,5,1,3,0,3
45744_0,,,,2,3,2,5
45745_0,,,,2,3,2,5
45746_0,,,,2,3,2,5
45747_0,,,,2,3,2,5
45748_0,,,,2,3,2,5
45749_0,,,,2,3,2,5
45750_0,,,,2,3,2,5
45751_0,,,,2,3,2,5
45752_0,,,,2,3,2,5
45753_0,,,,2,3,2,5
45755_0,,,,2,3,2,5
C(C(C=O)(C(C(C(O)=O)O)O)O)=O,,,5,1,4,0,4
45756_0,,,,2,3,2,5
45757_0,,,,2,3,2,5
45758_0,,,,2,3,2,5
45759_0,,,,2,3,2,5
45761_0,,,,2,3,2,5
C(C(C=C)(C(C=O)(C=O)O)O)(O)=O,,,5,1,4,0,4
45763_0,,,,2,3,2,5
C(C(C=O)(C(C=O)(C=C)O)O)(O)=O,,,5,1,5,0,5
45765_0,,,,2,3,2,5
C(C(C=O)(C(C(C=C)=O)O)O)(O)=O,,,5,1,5,0,5
45767_0,,,,2,3,2,5
C(C(C=O)(C(C=CC(O)=O)O)O)=O,,,5,1,3,0,3
45769_0,,,,2,3,2,5
C(C(C=O)(C(C=CC=O)O)O)(O)=O,,,5,1,5,0,5
45770_0,,,,2,3,2,5
45772_0,,,,2,3,2,5
C(C(C=O)(C(C(O)O)O)O)(O)=O,,,5,1,5,0,5
45774_0,,,,2,3,2,5
C(C(C=O)(C(C(C)O)O)O)(O)=O,,,5,1,5,0,5
45775_0,,,,2,3,2,5
45776_0,,,,2,3,2,5
45777_0,,,,2,3,2,5
45778_0,,,,2,3,2,5
45779_0,,,,2,3,2,5
45780_0,,,,2,3,2,5
45781_0,,,,2,3,2,5
45782_0,,,,2,3,2,5
45783_0,,,,2,3,2,5
45784_0,,,,2,3,2,5
45785_0,,,,2,3,2,5
45786_0,,,,2,3,2,5
45787_0,,,,2,3,2,5
45789_0,,,,2,3,2,5
C(C(C=O)(C(C(O)=O)=O)CO)(O)=O,,,5,1,3,0,3
45791_0,,,,2,3,2,5
C(C(C(O)=O)(C(C=O)=O)CO)(O)=O,,,5,1,3,0,3
45793_0,,,,2,3,2,5
C(C(C(C(O)=O)=O)(CO)C(C)O)=O,,,5,1,3,0,3
45794_0,,,,2,3,2,5
45796_0,,,,2,3,2,5
C(C(C(C(O)=O)=O)(CO)CO)=O,,,5,1,2,0,2
45797_0,,,,2,3,2,5
45798_0,,,,2,3,2,5
45799_0,,,,2,3,2,5
45800_0,,,,2,3,2,5
45801_0,,,,2,3,2,5
45802_0,,,,2,3,2,5
45803_0,,,,2,3,2,5
45804_0,,,,2,3,2,5
45805_0,,,,2,3,2,5
45806_0,,,,2,3,2,5
45807_0,,,,2,3,2,5
45809_0,,,,2,3,2,5
C(C(CO)(C(C=CC(O)=O)O)O)=O,,,5,1,3,0,3
45810_0,,,,2,3,2,5
45812_0,,,,2,3,2,5
C(C(C(O)=O)(C(C(O)=O)=O)O)(O)=O,,,5,1,5,0,5
45813_0,,,,2,3,2,5
45814_0,,,,2,3,2,5
45815_0,,,,2,3,2,5
45816_0,,,,2,3,2,5
45817_0,,,,2,3,2,5
45818_0,,,,2,3,2,5
45819_0,,,,2,3,2,5
45820_0,,,,2,3,2,5
45821_0,,,,2,3,2,5
45822_0,,,,2,3,2,5
45823_0,,,,2,3,2,5
45824_0,,,,2,3,2,5
45825_0,,,,2,3,2,5
45827_0,,,,2,3,2,5
C(C1(CC(CC1(C=O)O)O)O)(O)=O,,,5,1,3,0,3
45829_0,,,,2,3,2,5
C(C1(C(CC(C1)O)O)O)(O)=O,,,5,1,2,0,2
45831_0,,,,2,3,2,5
C(C1(C(C(C(C1)O)O)O)O)(O)=O,,,5,1,2,0,2
45832_0,,,,2,3,2,5
45834_0,,,,2,3,2,5
C(C(C(C)=O)(CC(O)=O)O)(O)=O,,,5,1,4,0,4
45835_0,,,,2,3,2,5
45836_0,,,,2,3,2,5
45838_0,,,,2,3,2,5
C(C)(C(C(C)O)(CC(O)=O)O)=O,,,5,1,2,0,2
45840_0,,,,2,3,2,5
C(C)(C(C(CO)O)(CC(O)=O)O)=O,,,5,1,2,0,2
45841_0,,,,2,3,2,5
45843_0,,,,2,3,2,5
C(C(C=O)(CC(C(O)=O)=O)O)(O)=O,,,5,1,2,0,2
45844_0,,,,2,3,2,5
45845_0,,,,2,3,2,5
45846_0,,,,2,3,2,5
45848_0,,,,2,3,2,5
C(C(CO)C(C(C=O)(O)O)O)(O)=O,,,5,1,3,0,3
45849_0,,,,2,3,2,5
45851_0,,,,2,3,2,5
C(C(CO)C(C(C=O)(C)O)O)(O)=O,,,5,1,4,0,4
45853_0,,,,2,3,2,5
C(C(CO)C([C](C(O)=O)O)O)(O)=O,,,5,1,3,0,3
45855_0,,,,2,3,2,5
C(C(CO)(CC(O)=O)O)(CCO)=O,,,5,1,2,0,2
45856_0,,,,2,3,2,5
45858_0,,,,2,3,2,5
C(C(C=O)(C(C(O)=O)CO)O)(O)=O,,,5,1,3,0,3
45860_0,,,,2,3,2,5
C(C(C(CC(C)O)O)(O)O)(O)=O,,,5,1,2,0,2
45861_0,,,,2,3,2,5
45863_0,,,,2,3,2,5
C(C(C(C(C(C)O)O)O)(O)O)(O)=O,,,5,1,2,0,2
45864_0,,,,2,3,2,5
45865_0,,,,2,3,2,5
45867_0,,,,2,3,2,5
C(CO)(C(C(C)O)(CC(O)=O)O)=O,,,5,1,2,0,2
45869_0,,,,2,3,2,5
C(C(C(C)(C(CCO)O)O)=O)(O)=O,,,5,1,2,0,2
45870_0,,,,2,3,2,5
45872_0,,,,2,3,2,5
C(C(C(CCO)O)(O)O)(O)=O,,,5,1,2,0,2
45873_0,,,,2,3,2,5
45875_0,,,,2,3,2,5
C(C(C(CC(CO)O)O)(O)O)(O)=O,,,5,1,2,0,2
45876_0,,,,2,3,2,5
45878_0,,,,2,3,2,5
C(C)(C(CO)(C(C(O)=O)(O)O)O)=O,,,5,1,2,0,2
45880_0,,,,2,3,2,5
C(CO)(C(C)(C(C(O)=O)(O)O)O)=O,,,5,1,2,0,2
45881_0,,,,2,3,2,5
45883_0,,,,2,3,2,5
C(C(C(C)(C(CO)(C)O)O)=O)(O)=O,,,5,1,2,0,2
45885_0,,,,2,3,2,5
C(C(C(C)(C(C(O)O)O)O)=O)(O)=O,,,5,1,2,0,2
45887_0,,,,2,3,2,5
C(C(C(C)(C(C(C)O)O)O)=O)(O)=O,,,5,1,2,0,2
45889_0,,,,2,3,2,5
C(C(C(C(C(O)=O)=O)(C)O)O)(O)=O,,,5,1,6,0,6
45890_0,,,,2,3,2,5
45892_0,,,,2,3,2,5
C(C(C)(C(C(C(O)=O)=O)(C)O)O)=O,,,5,1,4,0,4
45893_0,,,,2,3,2,5
45894_0,,,,2,3,2,5
45896_0,,,,2,3,2,5
C(C(C(C)(C(C)O)O)=O)(O)=O,,,5,1,2,0,2
45897_0,,,,2,3,2,5
45898_0,,,,2,3,2,5
45900_0,,,,2,3,2,5
C(C(C(C)O)(C(C(O)=O)(O)O)O)=O,,,5,1,2,0,2
45902_0,,,,2,3,2,5
C(C(C(C)O)(C(C=O)(O)O)O)(O)=O,,,5,1,4,0,4
45904_0,,,,2,3,2,5
C(C([C](C(O)=O)O)(C(C)O)O)(O)=O,,,5,1,4,0,4
45906_0,,,,2,3,2,5
C(C(C(C(O)=O)(O)O)O)(C(C)O)=O,,,5,1,2,0,2
45907_0,,,,2,3,2,5
45908_0,,,,2,3,2,5
45910_0,,,,2,3,2,5
C(C(C(C(C=O)(O)O)O)O)(O)=O,,,5,1,3,0,3
45912_0,,,,2,3,2,5
C(C(C([C](C(O)=O)O)O)O)(O)=O,,,5,1,4,0,4
45913_0,,,,2,3,2,5
45915_0,,,,2,3,2,5
C(C(C(CO)(C)O)(O)O)(O)=O,,,5,1,2,0,2
45916_0,,,,2,3,2,5
45918_0,,,,2,3,2,5
C(C(C(CO)(CCO)O)(O)O)(O)=O,,,5,1,2,0,2
45919_0,,,,2,3,2,5
45920_0,,,,2,3,2,5
45921_0,,,,2,3,2,5
45923_0,,,,2,3,2,5
C(C(C(C(CCO)O)O)(O)O)(O)=O,,,5,1,2,0,2
45924_0,,,,2,3,2,5
45926_0,,,,2,3,2,5
C(C(C(C)(C(CO)O)O)(O)O)(O)=O,,,5,1,2,0,2
45927_0,,,,2,3,2,5
45929_0,,,,2,3,2,5
C(C(C)(C(C(O)=O)(O)O)O)(O)=O,,,5,1,2,0,2
45931_0,,,,2,3,2,5
C(CC(C(C(O)=O)(O)O)O)(O)=O,,,5,1,2,0,2
45932_0,,,,2,3,2,5
45933_0,,,,2,3,2,5
45935_0,,,,2,3,2,5
C(C(CO)(C(C(O)=O)(O)O)O)(O)=O,,,5,1,2,0,2
45936_0,,,,2,3,2,5
45938_0,,,,2,3,2,5
C(C(C(C=O)(CC=O)O)(O)O)(O)=O,,,5,1,2,0,2
45939_0,,,,2,3,2,5
45940_0,,,,2,3,2,5
45941_0,,,,2,3,2,5
45942_0,,,,2,3,2,5
45944_0,,,,2,3,2,5
C(CC(C(C(C(O)=O)(O)O)O)=O)=O,,,5,1,2,0,2
45945_0,,,,2,3,2,5
45946_0,,,,2,3,2,5
45947_0,,,,2,3,2,5
45948_0,,,,2,3,2,5
45949_0,,,,2,3,2,5
45950_0,,,,2,3,2,5
45951_0,,,,2,3,2,5
45952_0,,,,2,3,2,5
45954_0,,,,2,3,2,5
C(C(C1(COCC1O)O)(O)O)(O)=O,,,5,1,2,0,2
45955_0,,,,2,3,2,5
45956_0,,,,2,3,2,5
45957_0,,,,2,3,2,5
45958_0,,,,2,3,2,5
45960_0,,,,2,3,2,5
C(C(C1(C(O)OCC1)O)(O)O)(O)=O,,,5,1,2,0,2
45961_0,,,,2,3,2,5
45963_0,,,,2,3,2,5
C(C(C1(COC(C1)O)O)(O)O)(O)=O,,,5,1,2,0,2
45964_0,,,,2,3,2,5
45966_0,,,,2,3,2,5
C(C(C(C)=O)(C(C(O)=O)(O)O)O)=O,,,5,1,2,0,2
45968_0,,,,2,3,2,5
C(C(C(C)=O)(C(C=O)(O)O)O)(O)=O,,,5,1,4,0,4
45970_0,,,,2,3,2,5
C(C(C(C)=O)([C](C(O)=O)O)O)(O)=O,,,5,1,4,0,4
45972_0,,,,2,3,2,5
C(C(C(C(C(C)=O)=O)O)(O)O)(O)=O,,,5,1,2,0,2
45974_0,,,,2,3,2,5
C(C(C(C(C=O)=O)(C)O)(O)O)(O)=O,,,5,1,2,0,2
45976_0,,,,2,3,2,5
C(C(C(C(C(O)=O)=O)(C)O)(O)O)=O,,,5,1,3,0,3
45978_0,,,,2,3,2,5
[C](C(O)=O)(C(C(C(O)=O)=O)(C)O)O,,,5,1,3,0,3
45980_0,,,,2,3,2,5
C(C(C=C)(C(C(O)=O)(O)O)O)=O,,,5,1,2,0,2
45982_0,,,,2,3,2,5
C(C(C=C)(C(C=O)(O)O)O)(O)=O,,,5,1,3,0,3
45983_0,,,,2,3,2,5
45984_0,,,,2,3,2,5
45986_0,,,,2,3,2,5
C(C(C=C)([C](C(O)=O)O)O)(O)=O,,,5,1,3,0,3
45987_0,,,,2,3,2,5
45988_0,,,,2,3,2,5
45990_0,,,,2,3,2,5
C(C(C(C(C=C)=O)O)(O)O)(O)=O,,,5,1,2,0,2
45991_0,,,,2,3,2,5
45993_0,,,,2,3,2,5
C(C(C(C=CC=O)O)(O)O)(O)=O,,,5,1,2,0,2
45995_0,,,,2,3,2,5
C(C(C(C=CC(O)=O)O)(O)O)=O,,,5,1,4,0,4
45996_0,,,,2,3,2,5
45998_0,,,,2,3,2,5
C(C(C)(C(C=CC(O)=O)O)O)=O,,,5,1,4,0,4
46000_0,,,,2,3,2,5
C(C([C](C(O)=O)O)O)=CC(O)=O,,,5,1,4,0,4
46002_0,,,,2,3,2,5
C(C(C(C=CC(O)=O)O)O)(O)=O,,,5,1,4,0,4
46004_0,,,,2,3,2,5
C(C(C)(C(C=CC(O)=O)O)O)(O)=O,,,5,1,2,0,2
46005_0,,,,2,3,2,5
46006_0,,,,2,3,2,5
46007_0,,,,2,3,2,5
46008_0,,,,2,3,2,5
46010_0,,,,2,3,2,5
C(C(C(O)=O)(O)O)(O)=O,,,5,1,2,0,2
46011_0,,,,2,3,2,5
46012_0,,,,2,3,2,5
46013_0,,,,2,3,2,5
46014_0,,,,2,3,2,5
46015_0,,,,2,3,2,5
46017_0,,,,2,3,2,5
C(C(C(C(O)O)O)(O)O)(O)=O,,,5,1,2,0,2
46019_0,,,,2,3,2,5
C(C(C(C(C)O)O)(O)O)(O)=O,,,5,1,2,0,2
46021_0,,,,2,3,2,5
C(C(C(C(CO)O)O)(O)O)(O)=O,,,5,1,2,0,2
46022_0,,,,2,3,2,5
46024_0,,,,2,3,2,5
C(C(C(C=O)O)(O)O)(O)=O,,,5,1,2,0,2
46026_0,,,,2,3,2,5
C(C(C(CO)(CO)O)(O)O)(O)=O,,,5,1,2,0,2
46028_0,,,,2,3,2,5
C(C(C(C(O)=O)(O)O)O)(O)=O,,,5,1,2,0,2
46029_0,,,,2,3,2,5
46031_0,,,,2,3,2,5
C(C(C)(C(C(O)=O)(O)O)O)=O,,,5,1,2,0,2
46033_0,,,,2,3,2,5
C(C(C(C(C)=O)O)(O)O)(O)=O,,,5,1,2,0,2
46034_0,,,,2,3,2,5
46035_0,,,,2,3,2,5
46036_0,,,,2,3,2,5
46038_0,,,,2,3,2,5
C(C(CCO)(C(C(O)=O)(O)O)O)=O,,,5,1,2,0,2
46040_0,,,,2,3,2,5
C(C(C(C(O)=O)(O)O)O)(CCO)=O,,,5,1,2,0,2
46041_0,,,,2,3,2,5
46043_0,,,,2,3,2,5
C(CC(C(C(C(O)=O)(O)O)O)O)=O,,,5,1,2,0,2
46044_0,,,,2,3,2,5
46046_0,,,,2,3,2,5
C(C(CC(C(C(O)=O)(O)O)O)O)=O,,,5,1,2,0,2
46047_0,,,,2,3,2,5
46048_0,,,,2,3,2,5
46050_0,,,,2,3,2,5
C(CC(CO)(C(C(O)=O)(O)O)O)=O,,,5,1,2,0,2
46051_0,,,,2,3,2,5
46052_0,,,,2,3,2,5
46054_0,,,,2,3,2,5
C(C(C(C)(C(C(O)=O)(O)O)O)O)=O,,,5,1,2,0,2
46056_0,,,,2,3,2,5
C(C(C(C)O)(O)O)(O)=O,,,5,1,2,0,2
46057_0,,,,2,3,2,5
46059_0,,,,2,3,2,5
C(C(CO)(C(C(O)=O)(O)O)O)=O,,,5,1,2,0,2
46061_0,,,,2,3,2,5
C(C(C(C(CO)=O)O)(O)O)(O)=O,,,5,1,2,0,2
46062_0,,,,2,3,2,5
46064_0,,,,2,3,2,5
C(C(C(CO)O)(O)O)(O)=O,,,5,1,2,0,2
46065_0,,,,2,3,2,5
46066_0,,,,2,3,2,5
46067_0,,,,2,3,2,5
46068_0,,,,2,3,2,5
46069_0,,,,2,3,2,5
46070_0,,,,2,3,2,5
46071_0,,,,2,3,2,5
46072_0,,,,2,3,2,5
46073_0,,,,2,3,2,5
46074_0,,,,2,3,2,5
46075_0,,,,2,3,2,5
46076_0,,,,2,3,2,5
46077_0,,,,2,3,2,5
46078_0,,,,2,3,2,5
46079_0,,,,2,3,2,5
46080_0,,,,2,3,2,5
46081_0,,,,2,3,2,5
46082_0,,,,2,3,2,5
46083_0,,,,2,3,2,5
46084_0,,,,2,3,2,5
46085_0,,,,2,3,2,5
46086_0,,,,2,3,2,5
46087_0,,,,2,3,2,5
46088_0,,,,2,3,2,5
46089_0,,,,2,3,2,5
46091_0,,,,2,3,2,5
C(CO)(OC(C(O)=O)O)=O,,,5,1,2,0,2
46093_0,,,,2,3,2,5
C(CO)(OCC(O)=O)=O,,,5,1,1,0,1
46095_0,,,,2,3,2,5
C(C(CO)OC(CO)=O)(O)=O,,,5,1,1,0,1
46097_0,,,,2,3,2,5
C(C(C(CO)O)OC(CO)=O)(O)=O,,,5,1,1,0,1
46099_0,,,,2,3,2,5
C(C(COC(CO)=O)O)(O)=O,,,5,1,2,0,2
46101_0,,,,2,3,2,5
C(C(C(CO)OC(CO)=O)O)(O)=O,,,5,1,2,0,2
46103_0,,,,2,3,2,5
C(C(C(COC(CO)=O)O)O)(O)=O,,,5,1,3,0,3
46104_0,,,,2,3,2,5
46105_0,,,,2,3,2,5
46107_0,,,,2,3,2,5
C(C(C(CCC(C(O)=O)=O)=O)O)=O,,,5,1,1,0,1
46108_0,,,,2,3,2,5
46109_0,,,,2,3,2,5
46110_0,,,,2,3,2,5
46111_0,,,,2,3,2,5
46112_0,,,,2,3,2,5
46113_0,,,,2,3,2,5
46114_0,,,,2,3,2,5
46115_0,,,,2,3,2,5
46116_0,,,,2,3,2,5
46117_0,,,,2,3,2,5
46118_0,,,,2,3,2,5
46119_0,,,,2,3,2,5
46121_0,,,,2,3,2,5
C(C(CO)CC(C=O)=O)(O)=O,,,5,1,2,0,2
46122_0,,,,2,3,2,5
46124_0,,,,2,3,2,5
C(C(C=O)C(C(O)=O)CO)=O,,,5,1,2,0,2
46125_0,,,,2,3,2,5
46127_0,,,,2,3,2,5
C(C(CO)C(C(C=O)=O)CO)(O)=O,,,5,1,2,0,2
46128_0,,,,2,3,2,5
46130_0,,,,2,3,2,5
C(C(C(C(O)=O)C(C=O)CO)O)=O,,,5,1,1,0,1
46132_0,,,,2,3,2,5
C(C(CO)C(C=O)C(C=O)O)(O)=O,,,5,1,2,0,2
46134_0,,,,2,3,2,5
C(C(CO)C(C(O)=O)C(CO)=O)=O,,,5,1,1,0,1
46136_0,,,,2,3,2,5
C(C(CO)C(C=O)C(CO)=O)(O)=O,,,5,1,2,0,2
46137_0,,,,2,3,2,5
46138_0,,,,2,3,2,5
46140_0,,,,2,3,2,5
C(C(CO)CC(C(C=O)O)=O)(O)=O,,,5,1,2,0,2
46141_0,,,,2,3,2,5
46143_0,,,,2,3,2,5
C(C(CO)CC=O)(O)=O,,,5,1,2,0,2
46144_0,,,,2,3,2,5
46145_0,,,,2,3,2,5
46146_0,,,,2,3,2,5
46147_0,,,,2,3,2,5
46148_0,,,,2,3,2,5
46149_0,,,,2,3,2,5
46151_0,,,,2,3,2,5
C(C(C(C(CO)=O)=O)CCO)(O)=O,,,5,1,1,0,1
46152_0,,,,2,3,2,5
46154_0,,,,2,3,2,5
C(CCC(C(C(CO)=O)O)=O)(O)=O,,,5,1,1,0,1
46155_0,,,,2,3,2,5
46156_0,,,,2,3,2,5
46158_0,,,,2,3,2,5
C(C(CCC(C(CO)=O)=O)O)(O)=O,,,5,1,3,0,3
46160_0,,,,2,3,2,5
C(CC(C=O)C(C(CO)=O)O)(O)=O,,,5,1,2,0,2
46162_0,,,,2,3,2,5
C(C(CC=O)C(C(CO)=O)O)(O)=O,,,5,1,2,0,2
46164_0,,,,2,3,2,5
C(CC(C(C(CO)=O)=O)CO)(O)=O,,,5,1,1,0,1
46165_0,,,,2,3,2,5
46166_0,,,,2,3,2,5
46167_0,,,,2,3,2,5
46168_0,,,,2,3,2,5
46169_0,,,,2,3,2,5
46171_0,,,,2,3,2,5
C(C(C(CO)O)CC(C=O)=O)(O)=O,,,5,1,2,0,2
46172_0,,,,2,3,2,5
46173_0,,,,2,3,2,5
46175_0,,,,2,3,2,5
C(C(C=O)C(C(O)=O)C(CO)O)=O,,,5,1,2,0,2
46176_0,,,,2,3,2,5
46178_0,,,,2,3,2,5
C(C(C(CO)O)CC(O)=O)=O,,,5,1,5,0,5
46180_0,,,,2,3,2,5
C(C(C(CO)O)CC=O)(O)=O,,,5,1,2,0,2
46181_0,,,,2,3,2,5
46182_0,,,,2,3,2,5
46183_0,,,,2,3,2,5
46185_0,,,,2,3,2,5
C(CCC(C(C(CO)O)=O)=O)(O)=O,,,5,1,2,0,2
46186_0,,,,2,3,2,5
46187_0,,,,2,3,2,5
46188_0,,,,2,3,2,5
46190_0,,,,2,3,2,5
C(C(CC(C(O)=O)=O)=O)(O)=O,,,5,1,3,0,3
46192_0,,,,2,3,2,5
C(C(C(CCC(O)=O)=O)(CO)O)=O,,,5,1,1,0,1
46194_0,,,,2,3,2,5
C(C(C(CCC=O)=O)(CO)O)(O)=O,,,5,1,5,0,5
46195_0,,,,2,3,2,5
46196_0,,,,2,3,2,5
46197_0,,,,2,3,2,5
46198_0,,,,2,3,2,5
46199_0,,,,2,3,2,5
46200_0,,,,2,3,2,5
46202_0,,,,2,3,2,5
C(CC(C(CO)CO)=O)(O)=O,,,5,1,2,0,2
46204_0,,,,2,3,2,5
C(CC(C(CO)C(CO)O)=O)(O)=O,,,5,1,1,0,1
46205_0,,,,2,3,2,5
46206_0,,,,2,3,2,5
46208_0,,,,2,3,2,5
C(C(C(C(CC(O)=O)=O)=O)C)=O,,,5,1,2,0,2
46209_0,,,,2,3,2,5
46211_0,,,,2,3,2,5
C(C(C(C(C(O)=O)=O)=O)C)=O,,,5,1,2,0,2
46212_0,,,,2,3,2,5
46213_0,,,,2,3,2,5
46214_0,,,,2,3,2,5
46216_0,,,,2,3,2,5
C(CC(C(CC(C)=O)=O)=O)(O)=O,,,5,1,2,0,2
46218_0,,,,2,3,2,5
C(CC(O)=O)(CC(C(C)=O)=O)=O,,,5,1,3,0,3
46220_0,,,,2,3,2,5
C(C)(CC(C(C(O)=O)=O)=O)=O,,,5,1,3,0,3
46221_0,,,,2,3,2,5
46222_0,,,,2,3,2,5
46224_0,,,,2,3,2,5
C(CC(CCC(C=O)=O)=O)(O)=O,,,5,1,3,0,3
46226_0,,,,2,3,2,5
C(CC(CCC(C(O)=O)=O)=O)=O,,,5,1,2,0,2
46228_0,,,,2,3,2,5
C(CCC(O)=O)(CC(C=O)=O)=O,,,5,1,3,0,3
46230_0,,,,2,3,2,5
C(CCC(CC(C(O)=O)=O)=O)=O,,,5,1,2,0,2
46232_0,,,,2,3,2,5
C(C(CC(O)=O)CC(C=O)=O)=O,,,5,1,4,0,4
46234_0,,,,2,3,2,5
C(CC(C(O)=O)CC(C=O)=O)=O,,,5,1,3,0,3
46235_0,,,,2,3,2,5
46237_0,,,,2,3,2,5
C(C(CCC(C(C)=O)=O)=O)(O)=O,,,5,1,2,0,2
46239_0,,,,2,3,2,5
C(CC(C)=O)(CC(C(O)=O)=O)=O,,,5,1,2,0,2
46241_0,,,,2,3,2,5
C(C(O)=O)(C(C)CC(C=O)=O)=O,,,5,1,2,0,2
46243_0,,,,2,3,2,5
C(C=O)(C(C)CC(C(O)=O)=O)=O,,,5,1,2,0,2
46244_0,,,,2,3,2,5
46246_0,,,,2,3,2,5
C(C(C=O)CC(C(O)=O)=O)=O,,,5,1,2,0,2
46247_0,,,,2,3,2,5
46249_0,,,,2,3,2,5
C(C(C(CO)=O)CC(C(O)=O)=O)=O,,,5,1,1,0,1
46250_0,,,,2,3,2,5
46251_0,,,,2,3,2,5
46252_0,,,,2,3,2,5
46253_0,,,,2,3,2,5
46254_0,,,,2,3,2,5
46255_0,,,,2,3,2,5
46256_0,,,,2,3,2,5
46257_0,,,,2,3,2,5
46258_0,,,,2,3,2,5
46260_0,,,,2,3,2,5
C(CCC(C(C(O)=O)=O)=O)=O,,,5,1,3,0,3
46262_0,,,,2,3,2,5
C(CCC(C(C=O)=O)=O)(O)=O,,,5,1,3,0,3
46263_0,,,,2,3,2,5
46264_0,,,,2,3,2,5
46265_0,,,,2,3,2,5
46267_0,,,,2,3,2,5
C(C(C=O)CC(CC(O)=O)=O)=O,,,5,1,2,0,2
46268_0,,,,2,3,2,5
46270_0,,,,2,3,2,5
C(C(C=O)C(CCC(O)=O)=O)=O,,,5,1,2,0,2
46271_0,,,,2,3,2,5
46273_0,,,,2,3,2,5
C(C(C=O)C(C=O)CC(O)=O)=O,,,5,1,4,0,4
46275_0,,,,2,3,2,5
C(C(C=O)C(C(O)=O)CC=O)=O,,,5,1,3,0,3
46276_0,,,,2,3,2,5
46277_0,,,,2,3,2,5
46278_0,,,,2,3,2,5
46280_0,,,,2,3,2,5
C(C(C=O)C(C(C(O)=O)=O)C)=O,,,5,1,2,0,2
46281_0,,,,2,3,2,5
46282_0,,,,2,3,2,5
46283_0,,,,2,3,2,5
46284_0,,,,2,3,2,5
46285_0,,,,2,3,2,5
46286_0,,,,2,3,2,5
46287_0,,,,2,3,2,5
46288_0,,,,2,3,2,5
46290_0,,,,2,3,2,5
C(C(C=O)CC(O)=O)=O,,,5,1,3,0,3
46291_0,,,,2,3,2,5
46293_0,,,,2,3,2,5
C(C(C(C(C(O)=O)=O)=O)CCO)=O,,,5,1,1,0,1
46295_0,,,,2,3,2,5
C(C(C(C(C=O)=O)=O)CCO)(O)=O,,,5,1,1,0,1
46296_0,,,,2,3,2,5
46297_0,,,,2,3,2,5
46299_0,,,,2,3,2,5
C(CCO)(CC(C(C(O)=O)=O)=O)=O,,,5,1,1,0,1
46301_0,,,,2,3,2,5
C(C(CC(C(CCO)=O)=O)=O)(O)=O,,,5,1,1,0,1
46302_0,,,,2,3,2,5
46303_0,,,,2,3,2,5
46305_0,,,,2,3,2,5
C(C(C=O)C(C(C(O)=O)=O)CO)=O,,,5,1,1,0,1
46306_0,,,,2,3,2,5
46307_0,,,,2,3,2,5
46308_0,,,,2,3,2,5
46309_0,,,,2,3,2,5
46310_0,,,,2,3,2,5
46311_0,,,,2,3,2,5
46313_0,,,,2,3,2,5
C(CC(CCC=O)=O)(O)=O,,,5,1,2,0,2
46315_0,,,,2,3,2,5
C(CC(CC(C(C(O)=O)=O)O)=O)=O,,,5,1,1,0,1
46316_0,,,,2,3,2,5
46317_0,,,,2,3,2,5
46318_0,,,,2,3,2,5
46320_0,,,,2,3,2,5
C(CCC(C(C(C(O)=O)=O)O)=O)=O,,,5,1,1,0,1
46322_0,,,,2,3,2,5
C(CCC(C(C(C=O)=O)O)=O)(O)=O,,,5,1,1,0,1
46324_0,,,,2,3,2,5
C(C(CCC(C(C(O)=O)=O)=O)O)=O,,,5,1,1,0,1
46326_0,,,,2,3,2,5
C(C(CCC(C(C=O)=O)=O)O)(O)=O,,,5,1,3,0,3
46327_0,,,,2,3,2,5
46328_0,,,,2,3,2,5
46329_0,,,,2,3,2,5
46330_0,,,,2,3,2,5
46332_0,,,,2,3,2,5
C(C(C=O)C(C(O)=O)C(C=O)O)=O,,,5,1,2,0,2
46333_0,,,,2,3,2,5
46335_0,,,,2,3,2,5
C(C(CC(CO)=O)C(C=O)O)(O)=O,,,5,1,2,0,2
46336_0,,,,2,3,2,5
46337_0,,,,2,3,2,5
46339_0,,,,2,3,2,5
C(CC(C=O)C(C=O)O)(O)=O,,,5,1,4,0,4
46340_0,,,,2,3,2,5
46342_0,,,,2,3,2,5
C(C(CC=O)C(C=O)O)(O)=O,,,5,1,3,0,3
46343_0,,,,2,3,2,5
46344_0,,,,2,3,2,5
46346_0,,,,2,3,2,5
C(CO)(CCC(C(C(O)=O)=O)=O)=O,,,5,1,1,0,1
46348_0,,,,2,3,2,5
C(CC(CO)=O)(CC(C(O)=O)=O)=O,,,5,1,1,0,1
46349_0,,,,2,3,2,5
46351_0,,,,2,3,2,5
C(CC(C(O)=O)CC=O)=O,,,5,1,2,0,2
46353_0,,,,2,3,2,5
C(CC(C(C(C(O)=O)=O)=O)CO)=O,,,5,1,1,0,1
46355_0,,,,2,3,2,5
C(CC(C(C(C=O)=O)=O)CO)(O)=O,,,5,1,1,0,1
46356_0,,,,2,3,2,5
46358_0,,,,2,3,2,5
C(CC(C=O)C(C(C=O)=O)O)(O)=O,,,5,1,2,0,2
46360_0,,,,2,3,2,5
C(C(CC=O)C(C(C=O)=O)O)(O)=O,,,5,1,2,0,2
46362_0,,,,2,3,2,5
C(C(C(CO)=O)CC(CO)=O)(O)=O,,,5,1,1,0,1
46364_0,,,,2,3,2,5
C(CCO)(C(C(O)=O)C(CO)=O)=O,,,5,1,1,0,1
46366_0,,,,2,3,2,5
C(C(C(CO)=O)CC(O)=O)=O,,,5,1,3,0,3
46367_0,,,,2,3,2,5
46368_0,,,,2,3,2,5
46370_0,,,,2,3,2,5
C(CC(O)=O)(CC(C)=O)=O,,,5,1,3,0,3
46372_0,,,,2,3,2,5
C(CC(C(CC)=O)=O)(O)=O,,,5,1,2,0,2
46373_0,,,,2,3,2,5
46374_0,,,,2,3,2,5
46375_0,,,,2,3,2,5
46376_0,,,,2,3,2,5
46377_0,,,,2,3,2,5
46378_0,,,,2,3,2,5
46379_0,,,,2,3,2,5
46380_0,,,,2,3,2,5
46381_0,,,,2,3,2,5
46383_0,,,,2,3,2,5
C(C(C(CC(C(C)=O)=O)O)=O)(O)=O,,,5,1,1,0,1
46384_0,,,,2,3,2,5
46386_0,,,,2,3,2,5
C(C(C(C(O)=O)=O)O)(CC(C)=O)=O,,,5,1,1,0,1
46387_0,,,,2,3,2,5
46388_0,,,,2,3,2,5
46390_0,,,,2,3,2,5
C(CC(C(C=O)=O)C)(O)=O,,,5,1,2,0,2
46392_0,,,,2,3,2,5
C(CC(C(C(O)=O)=O)C)=O,,,5,1,2,0,2
46394_0,,,,2,3,2,5
C(C(C(C(C(C(O)=O)=O)=O)C)O)=O,,,5,1,1,0,1
46395_0,,,,2,3,2,5
46397_0,,,,2,3,2,5
C(C=O)(C(C)C(C(C(O)=O)=O)O)=O,,,5,1,1,0,1
46398_0,,,,2,3,2,5
46399_0,,,,2,3,2,5
46400_0,,,,2,3,2,5
46401_0,,,,2,3,2,5
46402_0,,,,2,3,2,5
46404_0,,,,2,3,2,5
C(C(C(O)=O)=O)(CC)=O,,,5,1,2,0,2
46405_0,,,,2,3,2,5
46406_0,,,,2,3,2,5
46407_0,,,,2,3,2,5
46408_0,,,,2,3,2,5
46409_0,,,,2,3,2,5
46410_0,,,,2,3,2,5
46412_0,,,,2,3,2,5
C(C(C(C(C(O)=O)=O)=O)CO)=O,,,5,1,2,0,2
46413_0,,,,2,3,2,5
46415_0,,,,2,3,2,5
C(C(C=O)C(C(C(O)=O)=O)O)=O,,,5,1,2,0,2
46416_0,,,,2,3,2,5
46417_0,,,,2,3,2,5
46418_0,,,,2,3,2,5
46419_0,,,,2,3,2,5
46420_0,,,,2,3,2,5
46421_0,,,,2,3,2,5
46422_0,,,,2,3,2,5
46423_0,,,,2,3,2,5
46424_0,,,,2,3,2,5
46425_0,,,,2,3,2,5
46426_0,,,,2,3,2,5
46427_0,,,,2,3,2,5
46428_0,,,,2,3,2,5
46429_0,,,,2,3,2,5
46431_0,,,,2,3,2,5
C(C(C(C(C(O)=O)=O)CO)=O)(O)=O,,,5,1,2,0,2
46432_0,,,,2,3,2,5
46433_0,,,,2,3,2,5
46434_0,,,,2,3,2,5
46435_0,,,,2,3,2,5
46437_0,,,,2,3,2,5
C(C(C(C)=O)C(C(C)=O)=O)(O)=O,,,5,1,2,0,2
46439_0,,,,2,3,2,5
C(C(C(C(C(C)=O)=O)CO)=O)(O)=O,,,5,1,1,0,1
46440_0,,,,2,3,2,5
46441_0,,,,2,3,2,5
46442_0,,,,2,3,2,5
46443_0,,,,2,3,2,5
46444_0,,,,2,3,2,5
46445_0,,,,2,3,2,5
46446_0,,,,2,3,2,5
46447_0,,,,2,3,2,5
46448_0,,,,2,3,2,5
46449_0,,,,2,3,2,5
46450_0,,,,2,3,2,5
46451_0,,,,2,3,2,5
46452_0,,,,2,3,2,5
46453_0,,,,2,3,2,5
46454_0,,,,2,3,2,5
46456_0,,,,2,3,2,5
C(CC(C=O)C(C=O)(CO)O)(O)=O,,,5,1,2,0,2
46458_0,,,,2,3,2,5
C(CC(C(O)=O)C(C=O)(CO)O)=O,,,5,1,2,0,2
46460_0,,,,2,3,2,5
C(C(C(C)=O)C(C)=O)(O)=O,,,5,1,3,0,3
46461_0,,,,2,3,2,5
46463_0,,,,2,3,2,5
C(CCO)(C(C(O)=O)(C(C)=O)O)=O,,,5,1,1,0,1
46464_0,,,,2,3,2,5
46465_0,,,,2,3,2,5
46466_0,,,,2,3,2,5
46468_0,,,,2,3,2,5
C(C(C(C)=O)(C(C)=O)O)(O)=O,,,5,1,2,0,2
46469_0,,,,2,3,2,5
46470_0,,,,2,3,2,5
46472_0,,,,2,3,2,5
C(C(C(CC(C)=O)=O)(CO)O)(O)=O,,,5,1,5,0,5
46473_0,,,,2,3,2,5
46474_0,,,,2,3,2,5
46475_0,,,,2,3,2,5
46476_0,,,,2,3,2,5
46477_0,,,,2,3,2,5
46478_0,,,,2,3,2,5
46480_0,,,,2,3,2,5
C(C(C(C(O)=O)=O)CC(O)=O)=O,,,5,1,3,0,3
46481_0,,,,2,3,2,5
46482_0,,,,2,3,2,5
46484_0,,,,2,3,2,5
C(C(C(C(C)=O)=O)CC(O)=O)=O,,,5,1,2,0,2
46485_0,,,,2,3,2,5
46487_0,,,,2,3,2,5
C(C(C(CC=O)=O)CC(O)=O)=O,,,5,1,2,0,2
46488_0,,,,2,3,2,5
46489_0,,,,2,3,2,5
46490_0,,,,2,3,2,5
46491_0,,,,2,3,2,5
46492_0,,,,2,3,2,5
46493_0,,,,2,3,2,5
46495_0,,,,2,3,2,5
C(C(C(C)=O)CC=O)(O)=O,,,5,1,3,0,3
46497_0,,,,2,3,2,5
C(C(C(C)=O)CC(O)=O)=O,,,5,1,2,0,2
46498_0,,,,2,3,2,5
46500_0,,,,2,3,2,5
C(C(C(C(CO)=O)=O)CC(O)=O)=O,,,5,1,1,0,1
46501_0,,,,2,3,2,5
46503_0,,,,2,3,2,5
C(CCO)(C(C=O)(CC(O)=O)O)=O,,,5,1,1,0,1
46504_0,,,,2,3,2,5
46506_0,,,,2,3,2,5
C(C(CO)O)(C(C=O)CC(O)=O)=O,,,5,1,1,0,1
46507_0,,,,2,3,2,5
46508_0,,,,2,3,2,5
46510_0,,,,2,3,2,5
C(C(C(C=O)=O)CC(O)=O)=O,,,5,1,3,0,3
46511_0,,,,2,3,2,5
46513_0,,,,2,3,2,5
C(CC(C(C(C(O)=O)C)=O)O)(O)=O,,,5,1,1,0,1
46515_0,,,,2,3,2,5
C(C(C(CCC(O)=O)=O)(C)O)(O)=O,,,5,1,1,0,1
46516_0,,,,2,3,2,5
46518_0,,,,2,3,2,5
C(C(CCC(C(O)=O)=O)O)(O)=O,,,5,1,6,0,6
46519_0,,,,2,3,2,5
46521_0,,,,2,3,2,5
C(CC(C=O)C(C(O)=O)(C)O)(O)=O,,,5,1,2,0,2
46523_0,,,,2,3,2,5
C(C(C)(C(C(O)=O)CC=O)O)(O)=O,,,5,1,2,0,2
46525_0,,,,2,3,2,5
C(CC(C(C(O)=O)=O)CO)(O)=O,,,5,1,4,0,4
46527_0,,,,2,3,2,5
C(CC(C=O)C(C(O)=O)O)(O)=O,,,5,1,4,0,4
46529_0,,,,2,3,2,5
C(C(C(C(O)=O)CC=O)O)(O)=O,,,5,1,3,0,3
46530_0,,,,2,3,2,5
46531_0,,,,2,3,2,5
46532_0,,,,2,3,2,5
46533_0,,,,2,3,2,5
46535_0,,,,2,3,2,5
C(C(C(O)=O)C)(O)=O,,,5,1,1,0,1
46536_0,,,,2,3,2,5
46538_0,,,,2,3,2,5
C(C(C(O)=O)CCO)(O)=O,,,5,1,1,0,1
46540_0,,,,2,3,2,5
C(CC1C(C(C(O)O1)O)O)(O)=O,,,5,1,2,0,2
46542_0,,,,2,3,2,5
C(C1C(O)OC(CO)C1O)(O)=O,,,5,1,2,0,2
46543_0,,,,2,3,2,5
46544_0,,,,2,3,2,5
46546_0,,,,2,3,2,5
C(C1(COC(C1)=O)O)(O)=O,,,5,1,3,0,3
46548_0,,,,2,3,2,5
C(C1C(O)OCC1O)(O)=O,,,5,1,2,0,2
46550_0,,,,2,3,2,5
C(C1(C(COC1CO)=O)O)(O)=O,,,5,1,4,0,4
46551_0,,,,2,3,2,5
46553_0,,,,2,3,2,5
C(C1(C(CO)OC(C1)=O)O)(O)=O,,,5,1,3,0,3
46555_0,,,,2,3,2,5
C(C(C1C(O)OCC1O)=O)(O)=O,,,5,1,3,0,3
46557_0,,,,2,3,2,5
C(C1C(O)OCC(C1O)O)(O)=O,,,5,1,2,0,2
46559_0,,,,2,3,2,5
C(C1(C(COCC1O)=O)O)(O)=O,,,5,1,4,0,4
46560_0,,,,2,3,2,5
46562_0,,,,2,3,2,5
C(C1(C(COC(C1)=O)O)O)(O)=O,,,5,1,3,0,3
46563_0,,,,2,3,2,5
46565_0,,,,2,3,2,5
C(CC1C(C(C(O1)=O)O)O)(O)=O,,,5,1,2,0,2
46566_0,,,,2,3,2,5
46567_0,,,,2,3,2,5
46569_0,,,,2,3,2,5
C(C(C(C(CO)O)O)O)=CC(O)=O,,,5,1,1,0,1
46571_0,,,,2,3,2,5
C(C(C(C=CC(C(O)=O)=O)O)O)=O,,,5,1,1,0,1
46573_0,,,,2,3,2,5
C(C(C(C=CC(C=O)=O)O)O)(O)=O,,,5,1,3,0,3
46575_0,,,,2,3,2,5
C(C(C(C=C(C(O)=O)C=O)O)O)=O,,,5,1,1,0,1
46577_0,,,,2,3,2,5
C(C(C(C=C(C=O)C=O)O)O)(O)=O,,,5,1,3,0,3
46579_0,,,,2,3,2,5
C(CO)(CO)=CC(C(O)=O)=O,,,5,1,2,0,2
46581_0,,,,2,3,2,5
C(CO)(CO)=C(C(O)=O)C=O,,,5,1,2,0,2
46583_0,,,,2,3,2,5
C=C(C(C(O)=O)=O)C(CO)(CO)O,,,5,1,1,0,1
46585_0,,,,2,3,2,5
C(CO)(CO)=C(C(C(O)=O)=O)CO,,,5,1,1,0,1
46587_0,,,,2,3,2,5
C(C=C(C=O)C(CO)(CO)O)(O)=O,,,5,1,1,0,1
46589_0,,,,2,3,2,5
C(C(C(CO)(CO)O)=CC=O)(O)=O,,,5,1,1,0,1
46591_0,,,,2,3,2,5
C(C(C(C=O)=C(CO)CO)O)(O)=O,,,5,1,2,0,2
46593_0,,,,2,3,2,5
C(C(C(C(O)=O)=C(CO)CO)O)=O,,,5,1,1,0,1
46595_0,,,,2,3,2,5
C(CO)(CO)=C(C(O)=O)C(CO)=O,,,5,1,1,0,1
46597_0,,,,2,3,2,5
C(C(C(C=C(CO)CO)=O)O)(O)=O,,,5,1,2,0,2
46599_0,,,,2,3,2,5
C(CO)(CO)=CC(O)=O,,,5,1,3,0,3
46600_0,,,,2,3,2,5
46601_0,,,,2,3,2,5
46603_0,,,,2,3,2,5
C(CO)(C(C(C(O)=O)=CCO)O)=O,,,5,1,1,0,1
46605_0,,,,2,3,2,5
C(C(C=CC(C(CO)=O)O)O)(O)=O,,,5,1,2,0,2
46607_0,,,,2,3,2,5
C(CO)(C(C(CO)=CC(O)=O)O)=O,,,5,1,1,0,1
46608_0,,,,2,3,2,5
46610_0,,,,2,3,2,5
C(CO)(C(CO)O)=CC(C(O)=O)=O,,,5,1,1,0,1
46612_0,,,,2,3,2,5
C(CO)(C(CO)O)=C(C(O)=O)C=O,,,5,1,1,0,1
46614_0,,,,2,3,2,5
C(CO)(C(CO)O)=CC(O)=O,,,5,1,3,0,3
46615_0,,,,2,3,2,5
46617_0,,,,2,3,2,5
C(C(CO)O)(C(C=CC(O)=O)O)=O,,,5,1,1,0,1
46619_0,,,,2,3,2,5
C(C(C=CC(O)=O)=O)(O)=O,,,5,1,2,0,2
46621_0,,,,2,3,2,5
C(C(C(O)=O)=CC(O)=O)=O,,,5,1,3,0,3
46623_0,,,,2,3,2,5
C(C(C(C(C(O)=O)=O)=C)O)(O)=O,,,5,1,2,0,2
46625_0,,,,2,3,2,5
C(C(C(CO)=CC(O)=O)=O)(O)=O,,,5,1,2,0,2
46627_0,,,,2,3,2,5
C(C(C(C=O)=CC(O)=O)O)(O)=O,,,5,1,5,0,5
46629_0,,,,2,3,2,5
C(C(C(C(O)=O)=CC=O)O)(O)=O,,,5,1,3,0,3
46630_0,,,,2,3,2,5
46632_0,,,,2,3,2,5
C(C(C(C(O)=O)=CC(O)=O)O)=O,,,5,1,3,0,3
46634_0,,,,2,3,2,5
C(C(C(CO)=O)=CC(O)=O)(O)=O,,,5,1,2,0,2
46635_0,,,,2,3,2,5
46636_0,,,,2,3,2,5
46637_0,,,,2,3,2,5
46639_0,,,,2,3,2,5
C(C(CO)(CO)O)=CC(C(O)=O)=O,,,5,1,1,0,1
46641_0,,,,2,3,2,5
C(C(CO)(CO)O)=C(C(O)=O)C=O,,,5,1,1,0,1
46643_0,,,,2,3,2,5
C(C(CO)(CO)O)=CC(O)=O,,,5,1,4,0,4
46645_0,,,,2,3,2,5
C(C(CO)(C(CO)O)O)=CC(O)=O,,,5,1,1,0,1
46647_0,,,,2,3,2,5
C(C(C)=CC(C(O)=O)=O)=O,,,5,1,2,0,2
46649_0,,,,2,3,2,5
C(C(C=C(C(O)=O)C)=O)=O,,,5,1,2,0,2
46651_0,,,,2,3,2,5
C=C(C=O)CC(C(O)=O)=O,,,5,1,2,0,2
46653_0,,,,2,3,2,5
C=C(C(O)=O)CC(C=O)=O,,,5,1,2,0,2
46655_0,,,,2,3,2,5
C(C(C(O)=O)=C(C=O)C)=O,,,5,1,2,0,2
46657_0,,,,2,3,2,5
C(C(C=O)=C(C(O)=O)C)=O,,,5,1,2,0,2
46658_0,,,,2,3,2,5
46660_0,,,,2,3,2,5
C(C(C=O)C(C(O)=O)=C)=O,,,5,1,3,0,3
46662_0,,,,2,3,2,5
C(C(C(C(C(O)=O)=O)=C)(C)O)=O,,,5,1,2,0,2
46664_0,,,,2,3,2,5
C(C(C(C(C=O)=O)=C)(C)O)(O)=O,,,5,1,4,0,4
46666_0,,,,2,3,2,5
C(C(C(CO)=C(C=O)C)=O)(O)=O,,,5,1,2,0,2
46668_0,,,,2,3,2,5
C(C(C(CO)=C(C(O)=O)C)=O)=O,,,5,1,2,0,2
46670_0,,,,2,3,2,5
C=C(C=O)C(C(C(O)=O)=O)CO,,,5,1,2,0,2
46672_0,,,,2,3,2,5
C=C(C(O)=O)C(C(C=O)=O)CO,,,5,1,2,0,2
46674_0,,,,2,3,2,5
C(C(C(C=O)=CC(O)=O)(C)O)=O,,,5,1,3,0,3
46676_0,,,,2,3,2,5
C(C(C(C(O)=O)=CC=O)(C)O)=O,,,5,1,3,0,3
46678_0,,,,2,3,2,5
C(C(C(C=O)=CC=O)(C)O)(O)=O,,,5,1,3,0,3
46680_0,,,,2,3,2,5
C(C(C(C=O)=C(C=O)C)O)(O)=O,,,5,1,3,0,3
46682_0,,,,2,3,2,5
C(C(C(C(O)=O)=C(C=O)C)O)=O,,,5,1,2,0,2
46684_0,,,,2,3,2,5
C(C(C(C=O)=C(C(O)=O)C)O)=O,,,5,1,2,0,2
46685_0,,,,2,3,2,5
46687_0,,,,2,3,2,5
C(C(C(C=O)=C)C(C=O)O)(O)=O,,,5,1,2,0,2
46689_0,,,,2,3,2,5
C(C(C(C(O)=O)=C)C(C=O)O)=O,,,5,1,2,0,2
46691_0,,,,2,3,2,5
C(C(C(CO)=O)=C(C=O)C)(O)=O,,,5,1,2,0,2
46693_0,,,,2,3,2,5
C(C(C(CO)=O)=C(C(O)=O)C)=O,,,5,1,2,0,2
46695_0,,,,2,3,2,5
C(C(C(CO)=O)C(C=O)=C)(O)=O,,,5,1,2,0,2
46697_0,,,,2,3,2,5
C(C(C(CO)=O)C(C(O)=O)=C)=O,,,5,1,2,0,2
46699_0,,,,2,3,2,5
C(CC(C(C(C=O)=C)O)=O)(O)=O,,,5,1,3,0,3
46701_0,,,,2,3,2,5
C(CC(C(C(C(O)=O)=C)O)=O)=O,,,5,1,2,0,2
46703_0,,,,2,3,2,5
C(C(C(C=C(C=O)C)=O)O)(O)=O,,,5,1,3,0,3
46705_0,,,,2,3,2,5
C(C(C(C=C(C(O)=O)C)=O)O)=O,,,5,1,2,0,2
46707_0,,,,2,3,2,5
C(C(C(CC(C=O)=C)=O)O)(O)=O,,,5,1,3,0,3
46709_0,,,,2,3,2,5
C(C(C(CC(C(O)=O)=C)=O)O)=O,,,5,1,2,0,2
46711_0,,,,2,3,2,5
C(C(C)=CC(O)=O)=O,,,5,1,2,0,2
46713_0,,,,2,3,2,5
C(C=C(C(O)=O)C)=O,,,5,1,2,0,2
46715_0,,,,2,3,2,5
C(CC(C=O)=C)(O)=O,,,5,1,2,0,2
46717_0,,,,2,3,2,5
C(CC(C(O)=O)=C)=O,,,5,1,3,0,3
46719_0,,,,2,3,2,5
C=C(C=O)C(C(C(O)=O)=O)O,,,5,1,2,0,2
46721_0,,,,2,3,2,5
C=C(C(O)=O)C(C(C=O)=O)O,,,5,1,2,0,2
46722_0,,,,2,3,2,5
46723_0,,,,2,3,2,5
46725_0,,,,2,3,2,5
C(C(C=CC(C)=O)=O)(O)=O,,,5,1,3,0,3
46727_0,,,,2,3,2,5
C(C(C(O)=O)=CC(C)=O)=O,,,5,1,2,0,2
46729_0,,,,2,3,2,5
C(C)(C(C(C(C(O)=O)=O)=C)O)=O,,,5,1,2,0,2
46731_0,,,,2,3,2,5
C(C(C(CO)=CC(C)=O)=O)(O)=O,,,5,1,2,0,2
46733_0,,,,2,3,2,5
C(C)(C(C(C=O)=CC(O)=O)O)=O,,,5,1,3,0,3
46735_0,,,,2,3,2,5
C(C)(C(C(C(O)=O)=CC=O)O)=O,,,5,1,3,0,3
46737_0,,,,2,3,2,5
C(C(C(C=O)=CC(C)=O)O)(O)=O,,,5,1,3,0,3
46739_0,,,,2,3,2,5
C(C(C(C(O)=O)=CC(C)=O)O)=O,,,5,1,2,0,2
46741_0,,,,2,3,2,5
C(C(C(CO)=O)=CC(C)=O)(O)=O,,,5,1,2,0,2
46743_0,,,,2,3,2,5
C(C(C(C=CC(C)=O)=O)O)(O)=O,,,5,1,3,0,3
46745_0,,,,2,3,2,5
C(C=CC(C)=O)(O)=O,,,5,1,4,0,4
46747_0,,,,2,3,2,5
C(CC(C=O)=O)=CC(O)=O,,,5,1,4,0,4
46749_0,,,,2,3,2,5
C(CC(C(O)=O)=O)=CC=O,,,5,1,4,0,4
46751_0,,,,2,3,2,5
C(CC=CC(C=O)=O)(O)=O,,,5,1,4,0,4
46753_0,,,,2,3,2,5
C(CC=CC(C(O)=O)=O)=O,,,5,1,3,0,3
46755_0,,,,2,3,2,5
C(CO)=C(C(O)=O)CC(C=O)=O,,,5,1,2,0,2
46757_0,,,,2,3,2,5
C(CO)=C(C=O)CC(C(O)=O)=O,,,5,1,2,0,2
46759_0,,,,2,3,2,5
C(C(C=C(C(O)=O)CCO)=O)=O,,,5,1,2,0,2
46761_0,,,,2,3,2,5
C(C(C=C(C=O)CCO)=O)(O)=O,,,5,1,2,0,2
46763_0,,,,2,3,2,5
C(C(C=CC(CCO)=O)=O)(O)=O,,,5,1,2,0,2
46765_0,,,,2,3,2,5
C(CC(C=CC(C=O)=O)O)(O)=O,,,5,1,2,0,2
46767_0,,,,2,3,2,5
C(CC(C=CC(C(O)=O)=O)O)=O,,,5,1,2,0,2
46769_0,,,,2,3,2,5
C(C(C=CCC(C=O)=O)O)(O)=O,,,5,1,4,0,4
46771_0,,,,2,3,2,5
C(C(C=CCC(C(O)=O)=O)O)=O,,,5,1,2,0,2
46773_0,,,,2,3,2,5
C(C(CC=CC(C=O)=O)O)(O)=O,,,5,1,4,0,4
46775_0,,,,2,3,2,5
C(C(CC=CC(C(O)=O)=O)O)=O,,,5,1,2,0,2
46777_0,,,,2,3,2,5
C(CC(C(O)=O)=O)=CC(CO)=O,,,5,1,2,0,2
46779_0,,,,2,3,2,5
C(CO)(CC=CC(C(O)=O)=O)=O,,,5,1,2,0,2
46781_0,,,,2,3,2,5
C(CO)(CC(C=O)=O)=CC(O)=O,,,5,1,2,0,2
46783_0,,,,2,3,2,5
C(CO)(CC(C(O)=O)=O)=CC=O,,,5,1,2,0,2
46785_0,,,,2,3,2,5
C(CC(CO)=CC(C=O)=O)(O)=O,,,5,1,3,0,3
46787_0,,,,2,3,2,5
C(CC(CO)=CC(C(O)=O)=O)=O,,,5,1,2,0,2
46789_0,,,,2,3,2,5
C(C)(C(C=CC(C(O)=O)=O)O)=O,,,5,1,2,0,2
46791_0,,,,2,3,2,5
C(C(C(CC(C=O)=O)=C)O)(O)=O,,,5,1,3,0,3
46793_0,,,,2,3,2,5
C(C(C(CC(C(O)=O)=O)=C)O)=O,,,5,1,2,0,2
46795_0,,,,2,3,2,5
C(C(C(C)=CC(C=O)=O)O)(O)=O,,,5,1,3,0,3
46797_0,,,,2,3,2,5
C(C(C(C)=CC(C(O)=O)=O)O)=O,,,5,1,2,0,2
46799_0,,,,2,3,2,5
C=CCC(C(O)=O)=O,,,5,1,2,0,2
46801_0,,,,2,3,2,5
C(C)=CC(C(O)=O)=O,,,5,1,2,0,2
46803_0,,,,2,3,2,5
C(C(CO)=CC(C=O)=O)(O)=O,,,5,1,2,0,2
46805_0,,,,2,3,2,5
C(C(CO)=CC(C(O)=O)=O)=O,,,5,1,2,0,2
46807_0,,,,2,3,2,5
C(C(C=CC(CO)=O)=O)(O)=O,,,5,1,4,0,4
46809_0,,,,2,3,2,5
C(C(C=C(C(O)=O)C(CO)O)=O)=O,,,5,1,1,0,1
46811_0,,,,2,3,2,5
C(C(C=C(C=O)C(CO)O)=O)(O)=O,,,5,1,1,0,1
46813_0,,,,2,3,2,5
C(C(C=CC(C(CO)O)=O)=O)(O)=O,,,5,1,1,0,1
46814_0,,,,2,3,2,5
46816_0,,,,2,3,2,5
C(C(C(CO)O)O)=CC(C(O)=O)=O,,,5,1,1,0,1
46817_0,,,,2,3,2,5
46819_0,,,,2,3,2,5
C(C=CC(C(O)=O)=O)=O,,,5,1,6,0,6
46820_0,,,,2,3,2,5
46822_0,,,,2,3,2,5
C(CC=C(C=O)C(O)=O)=O,,,5,1,2,0,2
46824_0,,,,2,3,2,5
C(CC=C(C=O)C=O)(O)=O,,,5,1,4,0,4
46825_0,,,,2,3,2,5
46827_0,,,,2,3,2,5
C(C(C=O)C=CC(O)=O)=O,,,5,1,3,0,3
46829_0,,,,2,3,2,5
C(CC(C(C(C(O)=O)=O)=C)O)=O,,,5,1,2,0,2
46831_0,,,,2,3,2,5
C(CC(C(C(C=O)=O)=C)O)(O)=O,,,5,1,3,0,3
46833_0,,,,2,3,2,5
C(CC=C(C(C(O)=O)=O)CO)=O,,,5,1,2,0,2
46835_0,,,,2,3,2,5
C(CC=C(C(C=O)=O)CO)(O)=O,,,5,1,3,0,3
46837_0,,,,2,3,2,5
C(C(C(C(O)=O)=O)CO)=CC=O,,,5,1,2,0,2
46839_0,,,,2,3,2,5
C(C(C(C=O)=O)CO)=CC(O)=O,,,5,1,2,0,2
46840_0,,,,2,3,2,5
46842_0,,,,2,3,2,5
C(CC(C(C(O)=O)=CC=O)O)=O,,,5,1,3,0,3
46844_0,,,,2,3,2,5
C(CC(C(C=O)=CC=O)O)(O)=O,,,5,1,3,0,3
46846_0,,,,2,3,2,5
C(C(C(C=O)=CCC=O)O)(O)=O,,,5,1,3,0,3
46848_0,,,,2,3,2,5
C(CC=C(C(O)=O)C(C=O)O)=O,,,5,1,2,0,2
46850_0,,,,2,3,2,5
C(CC=C(C=O)C(C=O)O)(O)=O,,,5,1,3,0,3
46851_0,,,,2,3,2,5
46853_0,,,,2,3,2,5
C(C(C=CC=O)C(C=O)O)(O)=O,,,5,1,2,0,2
46855_0,,,,2,3,2,5
C(C(C=CC(O)=O)C(C=O)O)=O,,,5,1,2,0,2
46857_0,,,,2,3,2,5
C(CC=C(C(O)=O)C(CO)=O)=O,,,5,1,2,0,2
46859_0,,,,2,3,2,5
C(CC=C(C=O)C(CO)=O)(O)=O,,,5,1,3,0,3
46860_0,,,,2,3,2,5
46862_0,,,,2,3,2,5
C(C(C(CO)=O)C=CC(O)=O)=O,,,5,1,2,0,2
46863_0,,,,2,3,2,5
46865_0,,,,2,3,2,5
C(CC(C(C=CC(O)=O)O)=O)=O,,,5,1,2,0,2
46866_0,,,,2,3,2,5
46868_0,,,,2,3,2,5
C(CC=CC(C(C=O)O)=O)(O)=O,,,5,1,3,0,3
46869_0,,,,2,3,2,5
46871_0,,,,2,3,2,5
C(C(C(CC=CC(O)=O)=O)O)=O,,,5,1,2,0,2
46873_0,,,,2,3,2,5
C(CC=CC(O)=O)=O,,,5,1,5,0,5
46875_0,,,,2,3,2,5
C(CC=CC=O)(O)=O,,,5,1,4,0,4
46877_0,,,,2,3,2,5
C(C(C(C(O)=O)=O)O)=CC=O,,,5,1,4,0,4
46878_0,,,,2,3,2,5
46879_0,,,,2,3,2,5
46880_0,,,,2,3,2,5
46882_0,,,,2,3,2,5
C(C(C=O)C(C(O)=O)=CCO)=O,,,5,1,2,0,2
46883_0,,,,2,3,2,5
46885_0,,,,2,3,2,5
C(C(C=O)=C(C(O)=O)CCO)=O,,,5,1,2,0,2
46887_0,,,,2,3,2,5
C(C(C=O)=C(C=O)CCO)(O)=O,,,5,1,2,0,2
46889_0,,,,2,3,2,5
C(C(C=O)=CC(CCO)=O)(O)=O,,,5,1,2,0,2
46891_0,,,,2,3,2,5
C(CC(C=C(C=O)C=O)O)(O)=O,,,5,1,2,0,2
46893_0,,,,2,3,2,5
C(CC(C=C(C(O)=O)C=O)O)=O,,,5,1,3,0,3
46895_0,,,,2,3,2,5
C(C(C=O)C=CC(C(O)=O)O)=O,,,5,1,3,0,3
46896_0,,,,2,3,2,5
46898_0,,,,2,3,2,5
C(C(CC=C(C=O)C=O)O)(O)=O,,,5,1,4,0,4
46900_0,,,,2,3,2,5
C(C(CC=C(C(O)=O)C=O)O)=O,,,5,1,2,0,2
46901_0,,,,2,3,2,5
46903_0,,,,2,3,2,5
C(CO)(CC=C(C(O)=O)C=O)=O,,,5,1,2,0,2
46905_0,,,,2,3,2,5
C(C(C=O)C(CO)=CC(O)=O)=O,,,5,1,2,0,2
46906_0,,,,2,3,2,5
46908_0,,,,2,3,2,5
C(CC(CO)=C(C=O)C=O)(O)=O,,,5,1,3,0,3
46910_0,,,,2,3,2,5
C(CC(CO)=C(C(O)=O)C=O)=O,,,5,1,2,0,2
46912_0,,,,2,3,2,5
C(C)(C(C=C(C(O)=O)C=O)O)=O,,,5,1,2,0,2
46914_0,,,,2,3,2,5
C(C(C=O)C(C(C(O)=O)O)=C)=O,,,5,1,3,0,3
46915_0,,,,2,3,2,5
46917_0,,,,2,3,2,5
C(C(C(C)=C(C=O)C=O)O)(O)=O,,,5,1,3,0,3
46919_0,,,,2,3,2,5
C(C(C(C)=C(C(O)=O)C=O)O)=O,,,5,1,2,0,2
46920_0,,,,2,3,2,5
46922_0,,,,2,3,2,5
C(C)=C(C=O)C(O)=O,,,5,1,2,0,2
46924_0,,,,2,3,2,5
C(C(C=O)=C(C(O)=O)CO)=O,,,5,1,2,0,2
46926_0,,,,2,3,2,5
C(C(C=O)=C(C=O)CO)(O)=O,,,5,1,3,0,3
46928_0,,,,2,3,2,5
C(C(C=O)=CC(CO)=O)(O)=O,,,5,1,3,0,3
46930_0,,,,2,3,2,5
C(C(C=O)=C(C(O)=O)C(CO)O)=O,,,5,1,1,0,1
46932_0,,,,2,3,2,5
C(C(C=O)=C(C=O)C(CO)O)(O)=O,,,5,1,1,0,1
46934_0,,,,2,3,2,5
C(C(C=O)=CC(C(CO)O)=O)(O)=O,,,5,1,1,0,1
46936_0,,,,2,3,2,5
C(C(CO)O)=C(C(O)=O)C=O,,,5,1,2,0,2
46938_0,,,,2,3,2,5
C(C(C(CO)O)O)=C(C(O)=O)C=O,,,5,1,1,0,1
46939_0,,,,2,3,2,5
46941_0,,,,2,3,2,5
C(C(C(O)=O)=CC=O)=O,,,5,1,4,0,4
46942_0,,,,2,3,2,5
46943_0,,,,2,3,2,5
46945_0,,,,2,3,2,5
C(C=C(C=O)CCO)(O)=O,,,5,1,2,0,2
46947_0,,,,2,3,2,5
C(C(CCO)=CC=O)(O)=O,,,5,1,2,0,2
46949_0,,,,2,3,2,5
C(CC(C=O)=CCO)(O)=O,,,5,1,2,0,2
46951_0,,,,2,3,2,5
C(CC(C(O)=O)=CCO)=O,,,5,1,3,0,3
46953_0,,,,2,3,2,5
C(CO)=C(C=O)C(C(C(O)=O)=O)O,,,5,1,1,0,1
46955_0,,,,2,3,2,5
C(CO)=C(C(O)=O)C(C(C=O)=O)O,,,5,1,1,0,1
46956_0,,,,2,3,2,5
46957_0,,,,2,3,2,5
46959_0,,,,2,3,2,5
C(C=CC(CCO)=O)(O)=O,,,5,1,4,0,4
46961_0,,,,2,3,2,5
C=CC(C(C(O)=O)=O)CO,,,5,1,2,0,2
46963_0,,,,2,3,2,5
C(C)=C(C(C(O)=O)=O)CO,,,5,1,2,0,2
46965_0,,,,2,3,2,5
C=C(C(C(O)=O)=O)C(C)O,,,5,1,2,0,2
46967_0,,,,2,3,2,5
C(C(C(CO)=C(C(O)=O)CO)=O)=O,,,5,1,1,0,1
46969_0,,,,2,3,2,5
C(C(C(CO)=C(C=O)CO)=O)(O)=O,,,5,1,1,0,1
46971_0,,,,2,3,2,5
C(C(C(C(C=O)=O)=C)(CO)O)(O)=O,,,5,1,2,0,2
46973_0,,,,2,3,2,5
C(C(C(C(C(O)=O)=O)=C)(CO)O)=O,,,5,1,1,0,1
46975_0,,,,2,3,2,5
C(C(C(CO)=CC(CO)=O)=O)(O)=O,,,5,1,1,0,1
46977_0,,,,2,3,2,5
C(CO)(C(C(C(C(O)=O)=O)=C)O)=O,,,5,1,1,0,1
46979_0,,,,2,3,2,5
C(C(CO)O)=C(C(C(O)=O)=O)CO,,,5,1,1,0,1
46981_0,,,,2,3,2,5
C=C(C(C(O)=O)=O)C(C(CO)O)O,,,5,1,1,0,1
46982_0,,,,2,3,2,5
46984_0,,,,2,3,2,5
C(C(C(CO)=CC=O)=O)(O)=O,,,5,1,4,0,4
46985_0,,,,2,3,2,5
46987_0,,,,2,3,2,5
C(C(C(C(C(O)=O)=O)=C)O)=O,,,5,1,4,0,4
46989_0,,,,2,3,2,5
C=C(C(C(O)=O)=O)CO,,,5,1,3,0,3
46991_0,,,,2,3,2,5
C(CO)=C(C(C(O)=O)=O)CO,,,5,1,2,0,2
46993_0,,,,2,3,2,5
C=C(C(C(O)=O)=O)C(CO)O,,,5,1,2,0,2
46995_0,,,,2,3,2,5
C(C(CC=CC(O)=O)O)=O,,,5,1,4,0,4
46996_0,,,,2,3,2,5
46998_0,,,,2,3,2,5
C(CC=CC(C=O)O)(O)=O,,,5,1,3,0,3
46999_0,,,,2,3,2,5
47001_0,,,,2,3,2,5
C(C(C=CC(C(C(O)=O)=O)O)O)=O,,,5,1,1,0,1
47003_0,,,,2,3,2,5
C(C(C=CC(C(C=O)=O)O)O)(O)=O,,,5,1,2,0,2
47004_0,,,,2,3,2,5
47005_0,,,,2,3,2,5
47007_0,,,,2,3,2,5
C(C(C=C)C(C=O)O)(O)=O,,,5,1,2,0,2
47009_0,,,,2,3,2,5
C(C(C(C=O)=CC)O)(O)=O,,,5,1,3,0,3
47011_0,,,,2,3,2,5
C(C(C(C(O)=O)=CC)O)=O,,,5,1,2,0,2
47013_0,,,,2,3,2,5
C(C=C(C=O)C(C)O)(O)=O,,,5,1,3,0,3
47015_0,,,,2,3,2,5
C(C(C(C)O)=CC=O)(O)=O,,,5,1,3,0,3
47017_0,,,,2,3,2,5
C(C(C(C=O)=C(C(O)=O)CO)O)=O,,,5,1,1,0,1
47019_0,,,,2,3,2,5
C(C(C(C=O)=C(C=O)CO)O)(O)=O,,,5,1,2,0,2
47021_0,,,,2,3,2,5
C(C(C(C(O)=O)=C(C=O)CO)O)=O,,,5,1,1,0,1
47023_0,,,,2,3,2,5
C(C(C(C=O)=CC=O)(CO)O)(O)=O,,,5,1,2,0,2
47025_0,,,,2,3,2,5
C(C(C(C=O)=CC(O)=O)(CO)O)=O,,,5,1,2,0,2
47027_0,,,,2,3,2,5
C(C(C(C(O)=O)=CC=O)(CO)O)=O,,,5,1,1,0,1
47029_0,,,,2,3,2,5
C(C(C(C=O)=CC(CO)=O)O)(O)=O,,,5,1,2,0,2
47031_0,,,,2,3,2,5
C(C(C(C(O)=O)=CC(CO)=O)O)=O,,,5,1,1,0,1
47033_0,,,,2,3,2,5
C(CO)(C(C(C=O)=CC(O)=O)O)=O,,,5,1,1,0,1
47035_0,,,,2,3,2,5
C(CO)(C(C(C(O)=O)=CC=O)O)=O,,,5,1,1,0,1
47037_0,,,,2,3,2,5
C(C(C(C=O)=CC(CO)O)O)(O)=O,,,5,1,2,0,2
47039_0,,,,2,3,2,5
C(C(C(C(O)=O)=CC(CO)O)O)=O,,,5,1,1,0,1
47041_0,,,,2,3,2,5
C(C=C(C=O)C(C(CO)O)O)(O)=O,,,5,1,1,0,1
47043_0,,,,2,3,2,5
C(C(C(C(CO)O)O)=CC=O)(O)=O,,,5,1,1,0,1
47044_0,,,,2,3,2,5
47045_0,,,,2,3,2,5
47047_0,,,,2,3,2,5
C(C(C(C(O)=O)=CC=O)O)=O,,,5,1,3,0,3
47048_0,,,,2,3,2,5
47050_0,,,,2,3,2,5
C(C(CO)=CC=O)(O)=O,,,5,1,3,0,3
47051_0,,,,2,3,2,5
47053_0,,,,2,3,2,5
C(C(C(CO)O)=CC=O)(O)=O,,,5,1,3,0,3
47055_0,,,,2,3,2,5
C(CO)(CC=CC(O)=O)=O,,,5,1,5,0,5
47057_0,,,,2,3,2,5
C(CC=CC(CO)=O)(O)=O,,,5,1,4,0,4
47059_0,,,,2,3,2,5
C(C(C(C(O)=O)=O)O)=CC(CO)=O,,,5,1,1,0,1
47060_0,,,,2,3,2,5
47062_0,,,,2,3,2,5
C(CC(CO)=CC(O)=O)=O,,,5,1,2,0,2
47064_0,,,,2,3,2,5
C(CC(CO)=CC=O)(O)=O,,,5,1,3,0,3
47066_0,,,,2,3,2,5
C(CO)(C(C(C(O)=O)=O)O)=CC=O,,,5,1,1,0,1
47068_0,,,,2,3,2,5
C(CO)(C(C(C=O)=O)O)=CC(O)=O,,,5,1,1,0,1
47069_0,,,,2,3,2,5
47070_0,,,,2,3,2,5
47072_0,,,,2,3,2,5
C(C(C(CO)=O)C=C)(O)=O,,,5,1,4,0,4
47074_0,,,,2,3,2,5
C(C)=C(C(O)=O)C(CO)=O,,,5,1,2,0,2
47076_0,,,,2,3,2,5
C(C(C(CO)=O)=C(C(O)=O)CO)=O,,,5,1,1,0,1
47078_0,,,,2,3,2,5
C(C(C(CO)=O)=C(C=O)CO)(O)=O,,,5,1,1,0,1
47080_0,,,,2,3,2,5
C(C(C(CO)=O)=CC(CO)=O)(O)=O,,,5,1,1,0,1
47082_0,,,,2,3,2,5
C(C(CO)O)=C(C(O)=O)C(CO)=O,,,5,1,1,0,1
47083_0,,,,2,3,2,5
47085_0,,,,2,3,2,5
C(C(C(CO)=O)=CC=O)(O)=O,,,5,1,3,0,3
47086_0,,,,2,3,2,5
47087_0,,,,2,3,2,5
47089_0,,,,2,3,2,5
C(CC(C(C=C)O)=O)(O)=O,,,5,1,2,0,2
47091_0,,,,2,3,2,5
C(C)(C(C=CC(O)=O)O)=O,,,5,1,5,0,5
47093_0,,,,2,3,2,5
C(C(C(C)=CC(O)=O)O)=O,,,5,1,2,0,2
47095_0,,,,2,3,2,5
C(C(C(C)=CC=O)O)(O)=O,,,5,1,3,0,3
47097_0,,,,2,3,2,5
C(CC(C(C=O)O)=C)(O)=O,,,5,1,3,0,3
47099_0,,,,2,3,2,5
C(C(C(CC=O)=C)O)(O)=O,,,5,1,3,0,3
47101_0,,,,2,3,2,5
C(C(C(C(C(C(O)=O)=O)O)=C)O)=O,,,5,1,1,0,1
47103_0,,,,2,3,2,5
C(C(C(C(C(C=O)=O)O)=C)O)(O)=O,,,5,1,2,0,2
47104_0,,,,2,3,2,5
47106_0,,,,2,3,2,5
C(C(C(CC=C)=O)O)(O)=O,,,5,1,3,0,3
47108_0,,,,2,3,2,5
C(C(C(C=CC)=O)O)(O)=O,,,5,1,3,0,3
47110_0,,,,2,3,2,5
C(C(C(C=C(C(O)=O)CO)=O)O)=O,,,5,1,1,0,1
47111_0,,,,2,3,2,5
47113_0,,,,2,3,2,5
C(C(C(C=CC(CO)=O)=O)O)(O)=O,,,5,1,2,0,2
47115_0,,,,2,3,2,5
C(C(C(C=CC(CO)O)=O)O)(O)=O,,,5,1,2,0,2
47116_0,,,,2,3,2,5
47117_0,,,,2,3,2,5
47118_0,,,,2,3,2,5
47119_0,,,,2,3,2,5
47121_0,,,,2,3,2,5
C(C)=CC(O)=O,,,5,1,3,0,3
47123_0,,,,2,3,2,5
C(CC=C)(O)=O,,,5,1,3,0,3
47124_0,,,,2,3,2,5
47125_0,,,,2,3,2,5
47126_0,,,,2,3,2,5
47127_0,,,,2,3,2,5
47128_0,,,,2,3,2,5
47129_0,,,,2,3,2,5
47130_0,,,,2,3,2,5
47131_0,,,,2,3,2,5
47133_0,,,,2,3,2,5
C(C(C(C(O)=O)=C)(C(C=O)O)O)=O,,,5,1,2,0,2
47135_0,,,,2,3,2,5
C(C(C(C=O)=C)(C(C=O)O)O)(O)=O,,,5,1,2,0,2
47137_0,,,,2,3,2,5
C(C(C(C=O)=C)(C(C(O)=O)O)O)=O,,,5,1,4,0,4
47138_0,,,,2,3,2,5
47140_0,,,,2,3,2,5
C(C(C=CC=O)(C(C=O)O)O)(O)=O,,,5,1,2,0,2
47142_0,,,,2,3,2,5
C(C(C=CC=O)(C(C(O)=O)O)O)=O,,,5,1,4,0,4
47144_0,,,,2,3,2,5
C(CO)(C(C(C(O)=O)=C)(CO)O)=O,,,5,1,2,0,2
47146_0,,,,2,3,2,5
C(CO)(C(C=CC(O)=O)(CO)O)=O,,,5,1,1,0,1
47148_0,,,,2,3,2,5
C(C(C(C(O)=O)=C)(CO)O)(O)=O,,,5,1,4,0,4
47150_0,,,,2,3,2,5
C(C(C=CC(O)=O)(CO)O)(O)=O,,,5,1,2,0,2
47152_0,,,,2,3,2,5
C(C(C(C)=O)(C(C=O)=C)O)(O)=O,,,5,1,2,0,2
47154_0,,,,2,3,2,5
C(C(C(C)=O)(C(C(O)=O)=C)O)=O,,,5,1,2,0,2
47156_0,,,,2,3,2,5
C=C(C=O)C(C(C(O)=O)=O)(CO)O,,,5,1,1,0,1
47158_0,,,,2,3,2,5
C=C(C(O)=O)C(C(C=O)=O)(CO)O,,,5,1,1,0,1
47159_0,,,,2,3,2,5
47160_0,,,,2,3,2,5
47162_0,,,,2,3,2,5
C(C(C(C=O)=C)(C(CO)O)O)(O)=O,,,5,1,2,0,2
47164_0,,,,2,3,2,5
C(C(C(C(O)=O)=C)(C(CO)O)O)=O,,,5,1,2,0,2
47166_0,,,,2,3,2,5
C(C(C(C)=O)(C=CC=O)O)(O)=O,,,5,1,3,0,3
47168_0,,,,2,3,2,5
C(C(C(C)=O)(C=CC(O)=O)O)=O,,,5,1,2,0,2
47170_0,,,,2,3,2,5
C(C(C(C(O)=O)=O)(CO)O)=CC=O,,,5,1,1,0,1
47172_0,,,,2,3,2,5
C(C(C(C=O)=O)(CO)O)=CC(O)=O,,,5,1,1,0,1
47173_0,,,,2,3,2,5
47175_0,,,,2,3,2,5
C(C(C=CC(O)=O)(CO)O)=O,,,5,1,4,0,4
47177_0,,,,2,3,2,5
C(C(C=CC=O)(C(CO)O)O)(O)=O,,,5,1,2,0,2
47179_0,,,,2,3,2,5
C(C(C=CC(O)=O)(C(CO)O)O)=O,,,5,1,1,0,1
47181_0,,,,2,3,2,5
C(C(C(C=O)=CCO)(CO)O)(O)=O,,,5,1,2,0,2
47183_0,,,,2,3,2,5
C(C(C(C(O)=O)=CCO)(CO)O)=O,,,5,1,2,0,2
47185_0,,,,2,3,2,5
C(C(C=CC(C=O)O)(CO)O)(O)=O,,,5,1,2,0,2
47187_0,,,,2,3,2,5
C(C(C=CC(C(O)=O)O)(CO)O)=O,,,5,1,3,0,3
47189_0,,,,2,3,2,5
C(C(C=CC(CO)=O)(CO)O)(O)=O,,,5,1,2,0,2
47191_0,,,,2,3,2,5
C(C(C(CO)=CC=O)(CO)O)(O)=O,,,5,1,2,0,2
47193_0,,,,2,3,2,5
C(C(C(CO)=CC(O)=O)(CO)O)=O,,,5,1,1,0,1
47195_0,,,,2,3,2,5
C(C(C(C)=O)(C=C)O)(O)=O,,,5,1,4,0,4
47197_0,,,,2,3,2,5
C(C(C(C(C=O)O)=C)(CO)O)(O)=O,,,5,1,2,0,2
47198_0,,,,2,3,2,5
47200_0,,,,2,3,2,5
C=CC(C(C(O)=O)=O)(CO)O,,,5,1,2,0,2
47201_0,,,,2,3,2,5
47202_0,,,,2,3,2,5
47204_0,,,,2,3,2,5
C(C(C(C=O)=C)(CC=O)O)(O)=O,,,5,1,3,0,3
47206_0,,,,2,3,2,5
C(C(C(C=O)=C)(CC(O)=O)O)=O,,,5,1,3,0,3
47208_0,,,,2,3,2,5
C(C(C(C(O)=O)=C)(CC=O)O)=O,,,5,1,2,0,2
47210_0,,,,2,3,2,5
C(C(C(C(O)=O)=C)(C)O)(O)=O,,,5,1,3,0,3
47211_0,,,,2,3,2,5
47213_0,,,,2,3,2,5
C(C(C(C(O)=O)=CCO)(C)O)(O)=O,,,5,1,2,0,2
47215_0,,,,2,3,2,5
C(C(C(C(O)=O)=C)(CCO)O)(O)=O,,,5,1,2,0,2
47216_0,,,,2,3,2,5
47218_0,,,,2,3,2,5
C(C(C=CC=O)(CC=O)O)(O)=O,,,5,1,2,0,2
47220_0,,,,2,3,2,5
C(C(C=CC=O)(CC(O)=O)O)=O,,,5,1,2,0,2
47221_0,,,,2,3,2,5
47223_0,,,,2,3,2,5
C(CC(C(C(O)=O)=C)O)(O)=O,,,5,1,2,0,2
47225_0,,,,2,3,2,5
C(C(C=CC(O)=O)(C)O)(O)=O,,,5,1,3,0,3
47227_0,,,,2,3,2,5
C(CC(C(C(O)=O)=CCO)O)(O)=O,,,5,1,1,0,1
47229_0,,,,2,3,2,5
C(C(C=CC(O)=O)(CCO)O)(O)=O,,,5,1,1,0,1
47230_0,,,,2,3,2,5
47231_0,,,,2,3,2,5
47232_0,,,,2,3,2,5
47233_0,,,,2,3,2,5
47235_0,,,,2,3,2,5
C(CC(C(C(C(O)=O)=C)O)O)(O)=O,,,5,1,1,0,1
47237_0,,,,2,3,2,5
C(C(CC(C(C(O)=O)=C)O)O)(O)=O,,,5,1,2,0,2
47239_0,,,,2,3,2,5
C(C(C=CC(C(O)=O)O)(C)O)(O)=O,,,5,1,2,0,2
47241_0,,,,2,3,2,5
C(C(C=CC(C(O)=O)O)O)(O)=O,,,5,1,3,0,3
47243_0,,,,2,3,2,5
C(CC(C(C(O)=O)=C)(CO)O)(O)=O,,,5,1,1,0,1
47245_0,,,,2,3,2,5
C(C(C(CO)=CC(O)=O)(C)O)(O)=O,,,5,1,1,0,1
47246_0,,,,2,3,2,5
47248_0,,,,2,3,2,5
C(C(C(C(C(O)=O)=C)(C)O)O)(O)=O,,,5,1,2,0,2
47250_0,,,,2,3,2,5
C(C(C(C(C(O)=O)O)=C)(C)O)(O)=O,,,5,1,2,0,2
47251_0,,,,2,3,2,5
47252_0,,,,2,3,2,5
47253_0,,,,2,3,2,5
47254_0,,,,2,3,2,5
47256_0,,,,2,3,2,5
C(C(CO)=CC(CO)=O)(O)=O,,,5,1,2,0,2
47258_0,,,,2,3,2,5
C(C(C(C=C)=O)(CO)O)(O)=O,,,5,1,5,0,5
47259_0,,,,2,3,2,5
47261_0,,,,2,3,2,5
C=C(C=O)C(C(O)=O)=O,,,5,1,6,0,6
47262_0,,,,2,3,2,5
47264_0,,,,2,3,2,5
C(CO)=C(C=O)C(C(O)=O)=O,,,5,1,4,0,4
47265_0,,,,2,3,2,5
47266_0,,,,2,3,2,5
47267_0,,,,2,3,2,5
47269_0,,,,2,3,2,5
C(C1(CC(CO)(CO1)O)O)(O)=O,,,5,1,2,0,2
47271_0,,,,2,3,2,5
C(C1C(O)OCC1(CO)O)(O)=O,,,5,1,2,0,2
47273_0,,,,2,3,2,5
C(C1(C(C(CO)(CO1)O)O)O)(O)=O,,,5,1,2,0,2
47274_0,,,,2,3,2,5
47276_0,,,,2,3,2,5
C1(C(CC(C(O)=O)(O)O1)O)=O,,,5,1,2,0,2
47278_0,,,,2,3,2,5
C(C1C(O)OC(C1O)=O)(O)=O,,,5,1,2,0,2
47280_0,,,,2,3,2,5
C1(C(C(CO)C(C(O)=O)(O)O1)O)=O,,,5,1,2,0,2
47282_0,,,,2,3,2,5
C(C1C(C(OC1C(O)=O)O)O)(O)=O,,,5,1,2,0,2
47284_0,,,,2,3,2,5
C1(C(C(C(O)O1)C(C(O)=O)O)O)=O,,,5,1,3,0,3
47286_0,,,,2,3,2,5
C(C1C(CO)(O)OC(C1O)=O)(O)=O,,,5,1,2,0,2
47288_0,,,,2,3,2,5
C(CC1(C(C(C(O1)=O)O)O)O)(O)=O,,,5,1,2,0,2
47290_0,,,,2,3,2,5
C1(C(CC(C(C(O)=O)O)(O)O1)O)=O,,,5,1,3,0,3
47292_0,,,,2,3,2,5
C1(C(C(C(C(O)=O)(O)O1)O)O)=O,,,5,1,2,0,2
47294_0,,,,2,3,2,5
C(C1(C)CC(C(O1)O)=O)(O)=O,,,5,1,2,0,2
47296_0,,,,2,3,2,5
C(C1(C)C(C(C(O1)O)=O)CO)(O)=O,,,5,1,2,0,2
47298_0,,,,2,3,2,5
C(C(C1COC(C1(C)O)O)=O)(O)=O,,,5,1,2,0,2
47300_0,,,,2,3,2,5
C(C1C(C)(C(OC1C(O)=O)O)O)=O,,,5,1,2,0,2
47302_0,,,,2,3,2,5
C(C1C(C)(C(OC1C=O)O)O)(O)=O,,,5,1,2,0,2
47304_0,,,,2,3,2,5
C(C1C(C(OC1(C=O)C)O)O)(O)=O,,,5,1,2,0,2
47306_0,,,,2,3,2,5
C(C1C(C(OC1(C(O)=O)C)O)O)=O,,,5,1,2,0,2
47308_0,,,,2,3,2,5
C(C1(C)C(C(C(O1)O)=O)O)(O)=O,,,5,1,2,0,2
47310_0,,,,2,3,2,5
C(C(C1COC(C)(C1O)O)=O)(O)=O,,,5,1,2,0,2
47312_0,,,,2,3,2,5
C(C1C(C(C)(OC1C(O)=O)O)O)=O,,,5,1,2,0,2
47314_0,,,,2,3,2,5
C(C1C(C(C)(OC1C=O)O)O)(O)=O,,,5,1,2,0,2
47316_0,,,,2,3,2,5
C(C1C(C(OC1C(C)=O)O)O)(O)=O,,,5,1,2,0,2
47318_0,,,,2,3,2,5
C(CC1CC(C(O)O1)=O)(O)=O,,,5,1,2,0,2
47320_0,,,,2,3,2,5
C(C1(CCO)CC(C(O1)O)=O)(O)=O,,,5,1,2,0,2
47322_0,,,,2,3,2,5
C(CC1C(CC(C=O)(O)O1)O)(O)=O,,,5,1,2,0,2
47324_0,,,,2,3,2,5
C(CC1C(CC(C(O)=O)(O)O1)O)=O,,,5,1,2,0,2
47326_0,,,,2,3,2,5
C(C(CC1C(CC(O)O1)O)=O)(O)=O,,,5,1,2,0,2
47328_0,,,,2,3,2,5
C(CC(C1CC(C(O)O1)=O)O)(O)=O,,,5,1,2,0,2
47330_0,,,,2,3,2,5
C(C(CC1CC(C(O)O1)O)=O)(O)=O,,,5,1,2,0,2
47332_0,,,,2,3,2,5
C(C(CC1CC(C(O)O1)=O)O)(O)=O,,,5,1,4,0,4
47334_0,,,,2,3,2,5
C(CC1(COC(C=O)(C1)O)O)(O)=O,,,5,1,2,0,2
47336_0,,,,2,3,2,5
C(CC1(COC(C(O)=O)(C1)O)O)=O,,,5,1,2,0,2
47338_0,,,,2,3,2,5
C(CC1(CO)CC(C(O)O1)=O)(O)=O,,,5,1,2,0,2
47340_0,,,,2,3,2,5
C(C1(CC(C(C(C)=O)O1)O)O)(O)=O,,,5,1,2,0,2
47342_0,,,,2,3,2,5
C(C1C(C)(CC(C=O)(O1)O)O)(O)=O,,,5,1,2,0,2
47344_0,,,,2,3,2,5
C(C1C(C)(CC(C(O)=O)(O1)O)O)=O,,,5,1,2,0,2
47346_0,,,,2,3,2,5
C(C(C1(C)CC(C(O)O1)=O)O)(O)=O,,,5,1,3,0,3
47348_0,,,,2,3,2,5
C(C1(COC(C=O)(C1)O)O)(O)=O,,,5,1,2,0,2
47350_0,,,,2,3,2,5
C(C1(COC(C(O)=O)(C1)O)O)=O,,,5,1,2,0,2
47352_0,,,,2,3,2,5
C(C1(CO)CC(C(O1)O)=O)(O)=O,,,5,1,3,0,3
47353_0,,,,2,3,2,5
47354_0,,,,2,3,2,5
47355_0,,,,2,3,2,5
47357_0,,,,2,3,2,5
C(CC1C(C(C(O)O1)=O)CO)(O)=O,,,5,1,2,0,2
47359_0,,,,2,3,2,5
C(C1C(CC=O)OC(C1O)O)(O)=O,,,5,1,2,0,2
47361_0,,,,2,3,2,5
C(C1C(CC(O)=O)OC(C1O)O)=O,,,5,1,2,0,2
47362_0,,,,2,3,2,5
47364_0,,,,2,3,2,5
C(C(C1C(CC(O1)O)O)=O)(O)=O,,,5,1,3,0,3
47366_0,,,,2,3,2,5
C(CC1C(C(C(O)O1)=O)O)(O)=O,,,5,1,2,0,2
47367_0,,,,2,3,2,5
47369_0,,,,2,3,2,5
C(C1C(O)OC(C1O)CC(O)=O)=O,,,5,1,2,0,2
47371_0,,,,2,3,2,5
C(C1C(O)OC(C1O)CC=O)(O)=O,,,5,1,2,0,2
47372_0,,,,2,3,2,5
47373_0,,,,2,3,2,5
47375_0,,,,2,3,2,5
C(C1C(O)OCC1(CC(O)=O)O)=O,,,5,1,2,0,2
47376_0,,,,2,3,2,5
47378_0,,,,2,3,2,5
C(C1C(C(C(C)=O)OC1O)O)(O)=O,,,5,1,2,0,2
47380_0,,,,2,3,2,5
C(C1C(OC(C(O)=O)C1(C)O)O)=O,,,5,1,2,0,2
47382_0,,,,2,3,2,5
C(C1C(OC(C=O)C1(C)O)O)(O)=O,,,5,1,2,0,2
47384_0,,,,2,3,2,5
C(C1C(O)OCC1(C(O)=O)O)=O,,,5,1,3,0,3
47386_0,,,,2,3,2,5
C(C1C(O)OCC1(C=O)O)(O)=O,,,5,1,2,0,2
47387_0,,,,2,3,2,5
47389_0,,,,2,3,2,5
C(C(C1COC(C1O)O)=O)(O)=O,,,5,1,2,0,2
47391_0,,,,2,3,2,5
C(C1(C(CO)C(CO1)O)O)(O)=O,,,5,1,2,0,2
47393_0,,,,2,3,2,5
C(CC1C(CC(O)O1)O)(O)=O,,,5,1,2,0,2
47395_0,,,,2,3,2,5
C(CC1CC(C(O)O1)O)(O)=O,,,5,1,2,0,2
47396_0,,,,2,3,2,5
47398_0,,,,2,3,2,5
C(C1C(C)OC(C1O)O)(O)=O,,,5,1,2,0,2
47399_0,,,,2,3,2,5
47401_0,,,,2,3,2,5
C(C1C(C(OC1C=O)O)O)(O)=O,,,5,1,2,0,2
47403_0,,,,2,3,2,5
C(C1COC(C1O)O)(O)=O,,,5,1,2,0,2
47404_0,,,,2,3,2,5
47406_0,,,,2,3,2,5
C(C1C(CO)OC(C1O)O)(O)=O,,,5,1,2,0,2
47407_0,,,,2,3,2,5
47408_0,,,,2,3,2,5
47410_0,,,,2,3,2,5
C(CC1(COC(C1O)O)O)(O)=O,,,5,1,2,0,2
47412_0,,,,2,3,2,5
C(C1C(CO)(O)OCC1O)(O)=O,,,5,1,2,0,2
47413_0,,,,2,3,2,5
47414_0,,,,2,3,2,5
47416_0,,,,2,3,2,5
C(C1C(C)(CC(O1)O)O)(O)=O,,,5,1,2,0,2
47417_0,,,,2,3,2,5
47418_0,,,,2,3,2,5
47420_0,,,,2,3,2,5
C(C1(COC(C1)O)O)(O)=O,,,5,1,2,0,2
47422_0,,,,2,3,2,5
C(C1(C(CO)OC(C1)O)O)(O)=O,,,5,1,2,0,2
47424_0,,,,2,3,2,5
C(C1(CO)C(C(C(O1)O)=O)O)(O)=O,,,5,1,4,0,4
47426_0,,,,2,3,2,5
C(C1(COC(C(O)=O)(C1O)O)O)=O,,,5,1,2,0,2
47428_0,,,,2,3,2,5
C(C1(COC(C=O)(C1O)O)O)(O)=O,,,5,1,2,0,2
47429_0,,,,2,3,2,5
47430_0,,,,2,3,2,5
47431_0,,,,2,3,2,5
47433_0,,,,2,3,2,5
C(C1(C(CO)(O)OCC1O)O)(O)=O,,,5,1,2,0,2
47434_0,,,,2,3,2,5
47435_0,,,,2,3,2,5
47436_0,,,,2,3,2,5
47438_0,,,,2,3,2,5
C(C1(C(C)(O)OC(C1O)=O)O)(O)=O,,,5,1,2,0,2
47439_0,,,,2,3,2,5
47440_0,,,,2,3,2,5
47441_0,,,,2,3,2,5
47443_0,,,,2,3,2,5
C(C1(C(C)=O)C(CC(O1)O)O)(O)=O,,,5,1,4,0,4
47444_0,,,,2,3,2,5
47446_0,,,,2,3,2,5
C(C1(C(C)(O)OCC1O)O)(O)=O,,,5,1,2,0,2
47448_0,,,,2,3,2,5
C(C(C1(COC(C1O)O)O)=O)(O)=O,,,5,1,2,0,2
47449_0,,,,2,3,2,5
47451_0,,,,2,3,2,5
C(C1(C(CO)(C(CO1)O)O)O)(O)=O,,,5,1,2,0,2
47453_0,,,,2,3,2,5
C(C1(CC(OC1C(O)=O)O)O)(O)=O,,,5,1,2,0,2
47455_0,,,,2,3,2,5
C(CC1(C(O)OC(C1O)=O)O)(O)=O,,,5,1,2,0,2
47457_0,,,,2,3,2,5
C(C1(CC(OC1(C=O)C)O)O)(O)=O,,,5,1,2,0,2
47459_0,,,,2,3,2,5
C(C1(CC(OC1(C(O)=O)C)O)O)=O,,,5,1,2,0,2
47461_0,,,,2,3,2,5
C(C1(CC(OC1C(C)=O)O)O)(O)=O,,,5,1,2,0,2
47463_0,,,,2,3,2,5
C(C1(C(CC(O1)O)O)CC=O)(O)=O,,,5,1,2,0,2
47465_0,,,,2,3,2,5
C(C1(C(CC(O1)O)O)CC(O)=O)=O,,,5,1,2,0,2
47467_0,,,,2,3,2,5
C(C1(C(CC=O)OC(C1)O)O)(O)=O,,,5,1,2,0,2
47469_0,,,,2,3,2,5
C(C1(C(CC(O)=O)OC(C1)O)O)=O,,,5,1,2,0,2
47471_0,,,,2,3,2,5
C(C1(C(C)OC(C1)O)O)(O)=O,,,5,1,2,0,2
47472_0,,,,2,3,2,5
47474_0,,,,2,3,2,5
C(C1(CC(OC1C=O)O)O)(O)=O,,,5,1,2,0,2
47476_0,,,,2,3,2,5
C(C1(COC(CO)(C1)O)O)(O)=O,,,5,1,2,0,2
47478_0,,,,2,3,2,5
C(C1C(COC1(C(O)=O)O)O)=O,,,5,1,2,0,2
47480_0,,,,2,3,2,5
C(C1C(COC1(C=O)O)O)(O)=O,,,5,1,2,0,2
47481_0,,,,2,3,2,5
47483_0,,,,2,3,2,5
C(C1(C(C(O)OC1CO)=O)O)(O)=O,,,5,1,4,0,4
47485_0,,,,2,3,2,5
C(C1(C(COC1(C(O)=O)O)O)O)=O,,,5,1,2,0,2
47487_0,,,,2,3,2,5
C(C1(C(COC1(C=O)O)O)O)(O)=O,,,5,1,2,0,2
47489_0,,,,2,3,2,5
C(C(C1(C(O)OCC1O)O)=O)(O)=O,,,5,1,3,0,3
47490_0,,,,2,3,2,5
47491_0,,,,2,3,2,5
47493_0,,,,2,3,2,5
C(C1C(C(O)OC(C1O)=O)O)(O)=O,,,5,1,2,0,2
47495_0,,,,2,3,2,5
C(C1C(COC(C1(C)O)O)=O)(O)=O,,,5,1,2,0,2
47497_0,,,,2,3,2,5
C(C1(C)C(C(CC(O1)O)=O)O)(O)=O,,,5,1,2,0,2
47499_0,,,,2,3,2,5
C(C1C(CC(C)(C(O1)O)O)=O)(O)=O,,,5,1,2,0,2
47501_0,,,,2,3,2,5
C(C1(C)CC(C(C(O1)O)O)=O)(O)=O,,,5,1,2,0,2
47503_0,,,,2,3,2,5
C(C1C(COC(C)(C1O)O)=O)(O)=O,,,5,1,2,0,2
47505_0,,,,2,3,2,5
C(C1C(CC(C(C)(O1)O)O)=O)(O)=O,,,5,1,2,0,2
47507_0,,,,2,3,2,5
C(C1(CC(C=O)(O)OCC1)O)(O)=O,,,5,1,2,0,2
47509_0,,,,2,3,2,5
C(C1(CC(C(O)=O)(O)OCC1)O)=O,,,5,1,2,0,2
47511_0,,,,2,3,2,5
C(CC1C(CC(C(O)O1)=O)O)(O)=O,,,5,1,2,0,2
47513_0,,,,2,3,2,5
C(C1CC(CC(C=O)(O1)O)O)(O)=O,,,5,1,2,0,2
47515_0,,,,2,3,2,5
C(C1CC(CC(C(O)=O)(O1)O)O)=O,,,5,1,2,0,2
47517_0,,,,2,3,2,5
C(CC1(COC(C(C1)=O)O)O)(O)=O,,,5,1,2,0,2
47519_0,,,,2,3,2,5
C(C1C(C)(CC(C(O1)O)=O)O)(O)=O,,,5,1,2,0,2
47521_0,,,,2,3,2,5
C(C1(COC(C(C1)=O)O)O)(O)=O,,,5,1,2,0,2
47523_0,,,,2,3,2,5
C(C1(CC(C(CO1)=O)O)O)(O)=O,,,5,1,2,0,2
47524_0,,,,2,3,2,5
47526_0,,,,2,3,2,5
C(C(C1COC(CC1O)O)=O)(O)=O,,,5,1,2,0,2
47528_0,,,,2,3,2,5
C(C1C(CC(OC1C(O)=O)O)O)=O,,,5,1,2,0,2
47530_0,,,,2,3,2,5
C(C1C(CC(OC1C=O)O)O)(O)=O,,,5,1,2,0,2
47532_0,,,,2,3,2,5
C(CC1C(C(CC(O)O1)=O)O)(O)=O,,,5,1,2,0,2
47534_0,,,,2,3,2,5
C(CC1CC(C(C(O)O1)O)=O)(O)=O,,,5,1,2,0,2
47536_0,,,,2,3,2,5
C(C1C(O)OCCC1(C(O)=O)O)=O,,,5,1,2,0,2
47538_0,,,,2,3,2,5
C(C1C(O)OCCC1(C=O)O)(O)=O,,,5,1,2,0,2
47540_0,,,,2,3,2,5
C(C1C(OC(C(O)=O)CC1O)O)=O,,,5,1,2,0,2
47542_0,,,,2,3,2,5
C(C1C(OC(C=O)CC1O)O)(O)=O,,,5,1,2,0,2
47544_0,,,,2,3,2,5
C(C1C(OCC(C1O)=O)O)(O)=O,,,5,1,2,0,2
47546_0,,,,2,3,2,5
C(C1(CC(O)OCC1)O)(O)=O,,,5,1,2,0,2
47547_0,,,,2,3,2,5
47549_0,,,,2,3,2,5
C(C1CC(CC(O1)O)O)(O)=O,,,5,1,2,0,2
47550_0,,,,2,3,2,5
47552_0,,,,2,3,2,5
C(C1CC(C(C(O1)O)O)O)(O)=O,,,5,1,2,0,2
47554_0,,,,2,3,2,5
C(C1C(C(O)OCC1O)O)(O)=O,,,5,1,2,0,2
47555_0,,,,2,3,2,5
47556_0,,,,2,3,2,5
47557_0,,,,2,3,2,5
47559_0,,,,2,3,2,5
C(C1(C(COC(C1)O)O)O)(O)=O,,,5,1,2,0,2
47561_0,,,,2,3,2,5
C(C1(COC(C(C1O)=O)O)O)(O)=O,,,5,1,2,0,2
47563_0,,,,2,3,2,5
C(C1(C(C(C(CO1)=O)O)O)O)(O)=O,,,5,1,2,0,2
47564_0,,,,2,3,2,5
47565_0,,,,2,3,2,5
47567_0,,,,2,3,2,5
C(C1(CC(O)OC(C1O)=O)O)(O)=O,,,5,1,2,0,2
47569_0,,,,2,3,2,5
C(C1(C(C(O)OCC1O)=O)O)(O)=O,,,5,1,4,0,4
47571_0,,,,2,3,2,5
C(C1(CCOC(C(C1)=O)O)O)(O)=O,,,5,1,2,0,2
47573_0,,,,2,3,2,5
C1(C(CC(C(O)=O)(O)OCC1)O)=O,,,5,1,2,0,2
47575_0,,,,2,3,2,5
C(C1CC(CC(C(O1)O)=O)O)(O)=O,,,5,1,2,0,2
47577_0,,,,2,3,2,5
C(C1(CC(CC(CO1)=O)O)O)(O)=O,,,5,1,2,0,2
47578_0,,,,2,3,2,5
47579_0,,,,2,3,2,5
47581_0,,,,2,3,2,5
C(C1C(O)OCCC(C1O)=O)(O)=O,,,5,1,2,0,2
47583_0,,,,2,3,2,5
C(C1C(CC(COC1O)=O)O)(O)=O,,,5,1,2,0,2
47585_0,,,,2,3,2,5
C1(C(C(C(C(O)=O)=O)CO1)O)=O,,,5,1,2,0,2
47587_0,,,,2,3,2,5
C1(C(C(C=O)C(C(O)=O)O1)O)=O,,,5,1,2,0,2
47589_0,,,,2,3,2,5
C1(C(C(C(O)=O)C(C=O)O1)O)=O,,,5,1,2,0,2
47591_0,,,,2,3,2,5
C1(C(C(C(C(C(O)=O)O)O1)O)O)=O,,,5,1,2,0,2
47592_0,,,,2,3,2,5
47594_0,,,,2,3,2,5
C(C1(C(CO)OC(C1O)=O)O)(O)=O,,,5,1,1,0,1
47596_0,,,,2,3,2,5
C1(C(C(C(O)=O)(C(C=O)O1)O)O)=O,,,5,1,1,0,1
47598_0,,,,2,3,2,5
C1(C(C(C=O)(C(C(O)=O)O1)O)O)=O,,,5,1,1,0,1
47600_0,,,,2,3,2,5
C1(C(CO)(C(C(O)=O)(CO1)O)O)=O,,,5,1,3,0,3
47602_0,,,,2,3,2,5
C1(C(C(C(C(O)=O)=O)(CO1)O)O)=O,,,5,1,1,0,1
47604_0,,,,2,3,2,5
C(C1(C(C)OC(C1O)=O)O)(O)=O,,,5,1,2,0,2
47606_0,,,,2,3,2,5
C1(C(C)(C(C(CC(O)=O)O1)O)O)=O,,,5,1,1,0,1
47608_0,,,,2,3,2,5
C1(C(C)(C(CO1)(CC(O)=O)O)O)=O,,,5,1,1,0,1
47610_0,,,,2,3,2,5
C(CC1(COC(C1O)=O)O)(O)=O,,,5,1,2,0,2
47612_0,,,,2,3,2,5
C1(C(C)(C(C)(C(C(O)=O)O1)O)O)=O,,,5,1,1,0,1
47614_0,,,,2,3,2,5
C1(C(C(C)(C(C(O)=O)O1)O)O)=O,,,5,1,2,0,2
47616_0,,,,2,3,2,5
C1(C(C)(C(C(O)=O)(CO1)O)O)=O,,,5,1,2,0,2
47617_0,,,,2,3,2,5
47618_0,,,,2,3,2,5
47620_0,,,,2,3,2,5
C1(C(C(C(C(C(O)=O)O1)O)O)O)=O,,,5,1,1,0,1
47622_0,,,,2,3,2,5
C(C1(C(COC(C1O)=O)O)O)(O)=O,,,5,1,1,0,1
47624_0,,,,2,3,2,5
C1(C(C)(C(C(O)=O)(CCO1)O)O)=O,,,5,1,1,0,1
47625_0,,,,2,3,2,5
47627_0,,,,2,3,2,5
C1(C(C)(C(CC(C(O)=O)O1)O)O)=O,,,5,1,1,0,1
47629_0,,,,2,3,2,5
C1(C(C(CC(C(O)=O)O1)O)O)=O,,,5,1,2,0,2
47630_0,,,,2,3,2,5
47632_0,,,,2,3,2,5
C(C(C=O)(CCC(O)=O)CO)(O)=O,,,5,1,4,0,4
47634_0,,,,2,3,2,5
C(C(CCC(C(O)=O)=O)C(C)O)=O,,,5,1,2,0,2
47636_0,,,,2,3,2,5
C(C(CCC(C=O)=O)C(C)O)(O)=O,,,5,1,3,0,3
47638_0,,,,2,3,2,5
C(CC(C(O)=O)C(C=O)C(C)O)=O,,,5,1,2,0,2
47639_0,,,,2,3,2,5
47641_0,,,,2,3,2,5
C(C(C(C)O)C(C=O)CC=O)(O)=O,,,5,1,2,0,2
47643_0,,,,2,3,2,5
C(C(CCC(O)=O)C(C)O)(O)=O,,,5,1,3,0,3
47645_0,,,,2,3,2,5
C(CC(C)(CCC(C(O)=O)=O)O)=O,,,5,1,2,0,2
47647_0,,,,2,3,2,5
C(CC(C)(CCC(C=O)=O)O)(O)=O,,,5,1,2,0,2
47649_0,,,,2,3,2,5
C(C(C(C)(CC=O)O)CC=O)(O)=O,,,5,1,2,0,2
47651_0,,,,2,3,2,5
C(CC(C)(C(C=O)CC(O)=O)O)=O,,,5,1,2,0,2
47652_0,,,,2,3,2,5
47654_0,,,,2,3,2,5
C(CCC(C)(CC(O)=O)O)(O)=O,,,5,1,2,0,2
47656_0,,,,2,3,2,5
C(CC(CCCC(C(O)=O)=O)O)=O,,,5,1,2,0,2
47658_0,,,,2,3,2,5
C(CC(CCCC(C=O)=O)O)(O)=O,,,5,1,2,0,2
47660_0,,,,2,3,2,5
C(C(CC(CC=O)O)CC=O)(O)=O,,,5,1,2,0,2
47661_0,,,,2,3,2,5
47663_0,,,,2,3,2,5
C(CC(CC(C=O)CC=O)O)(O)=O,,,5,1,3,0,3
47665_0,,,,2,3,2,5
C(CCCC(CC(O)=O)O)(O)=O,,,5,1,2,0,2
47666_0,,,,2,3,2,5
47667_0,,,,2,3,2,5
47668_0,,,,2,3,2,5
47669_0,,,,2,3,2,5
47671_0,,,,2,3,2,5
C(CC(CCC(C=O)=O)O)(O)=O,,,5,1,2,0,2
47673_0,,,,2,3,2,5
C(C(C(CC=O)O)CC=O)(O)=O,,,5,1,2,0,2
47675_0,,,,2,3,2,5
C(CC(C(C=O)CC(O)=O)O)=O,,,5,1,3,0,3
47676_0,,,,2,3,2,5
47678_0,,,,2,3,2,5
C(CCC(CC(O)=O)O)(O)=O,,,5,1,2,0,2
47680_0,,,,2,3,2,5
C(CC(C(CO)CC(O)=O)O)(O)=O,,,5,1,2,0,2
47682_0,,,,2,3,2,5
C(C(CCC(C(O)=O)=O)CO)=O,,,5,1,2,0,2
47683_0,,,,2,3,2,5
47685_0,,,,2,3,2,5
C(CC(C(O)=O)C(C=O)CO)=O,,,5,1,2,0,2
47686_0,,,,2,3,2,5
47687_0,,,,2,3,2,5
47688_0,,,,2,3,2,5
47689_0,,,,2,3,2,5
47691_0,,,,2,3,2,5
C(CCC(C(CC(O)=O)O)O)(O)=O,,,5,1,3,0,3
47692_0,,,,2,3,2,5
47693_0,,,,2,3,2,5
47694_0,,,,2,3,2,5
47696_0,,,,2,3,2,5
C(CCC(C(C(O)=O)=O)(C)O)(O)=O,,,5,1,3,0,3
47698_0,,,,2,3,2,5
C(C(C=O)(CCC(C(O)=O)=O)O)=O,,,5,1,2,0,2
47700_0,,,,2,3,2,5
C(C(C=O)(CCC(C=O)=O)O)(O)=O,,,5,1,3,0,3
47702_0,,,,2,3,2,5
C(C(C=O)(C(C(O)=O)CC=O)O)=O,,,5,1,2,0,2
47704_0,,,,2,3,2,5
C(C(C=O)(C(C=O)CC(O)=O)O)=O,,,5,1,2,0,2
47706_0,,,,2,3,2,5
C(C(C=O)(C(C=O)CC=O)O)(O)=O,,,5,1,3,0,3
47708_0,,,,2,3,2,5
C(C(C=O)(CCC(O)=O)O)(O)=O,,,5,1,3,0,3
47710_0,,,,2,3,2,5
C(C)(C(CCC(C(O)=O)=O)O)=O,,,5,1,3,0,3
47712_0,,,,2,3,2,5
C(C(CC=O)C(C(C)=O)O)(O)=O,,,5,1,2,0,2
47714_0,,,,2,3,2,5
C(CC(C=O)C(C(C)=O)O)(O)=O,,,5,1,4,0,4
47715_0,,,,2,3,2,5
47717_0,,,,2,3,2,5
C(C(CC=O)CC(CO)=O)(O)=O,,,5,1,3,0,3
47719_0,,,,2,3,2,5
C(CC(C=O)CC(CO)=O)(O)=O,,,5,1,4,0,4
47720_0,,,,2,3,2,5
47721_0,,,,2,3,2,5
47722_0,,,,2,3,2,5
47724_0,,,,2,3,2,5
C(C(CCC(C)O)=O)(O)=O,,,5,1,3,0,3
47726_0,,,,2,3,2,5
C(C(C(C)O)CC=O)(O)=O,,,5,1,2,0,2
47728_0,,,,2,3,2,5
C(C(C(C)O)CC(O)=O)=O,,,5,1,3,0,3
47730_0,,,,2,3,2,5
C(C(CCCCO)=O)(O)=O,,,5,1,2,0,2
47732_0,,,,2,3,2,5
C(C(CCO)CC=O)(O)=O,,,5,1,2,0,2
47733_0,,,,2,3,2,5
47735_0,,,,2,3,2,5
C(C(O)=O)(CCCC(C(O)=O)=O)=O,,,5,1,2,0,2
47737_0,,,,2,3,2,5
C(CC(C(O)=O)CC(C(O)=O)=O)=O,,,5,1,2,0,2
47739_0,,,,2,3,2,5
C(C(CC(O)=O)CC(C(O)=O)=O)=O,,,5,1,2,0,2
47741_0,,,,2,3,2,5
C(C(C(O)=O)CCC(C(O)=O)=O)=O,,,5,1,2,0,2
47743_0,,,,2,3,2,5
C(C(C(O)=O)CCC(C=O)=O)(O)=O,,,5,1,2,0,2
47745_0,,,,2,3,2,5
C(C(C(O)=O)C(C(O)=O)CC=O)=O,,,5,1,2,0,2
47746_0,,,,2,3,2,5
47748_0,,,,2,3,2,5
C(C(C(O)=O)C(C=O)CC=O)(O)=O,,,5,1,2,0,2
47750_0,,,,2,3,2,5
C(C(C(O)=O)CCC(O)=O)(O)=O,,,5,1,2,0,2
47751_0,,,,2,3,2,5
47753_0,,,,2,3,2,5
C(CC(C(O)=O)CC(O)=O)=O,,,5,1,3,0,3
47755_0,,,,2,3,2,5
C(C(CC(O)=O)CC(O)=O)=O,,,5,1,2,0,2
47756_0,,,,2,3,2,5
47757_0,,,,2,3,2,5
47759_0,,,,2,3,2,5
C(CCCC(C(C(O)=O)=O)=O)(O)=O,,,5,1,2,0,2
47761_0,,,,2,3,2,5
C(C(CCC(C=O)=O)(O)O)(O)=O,,,5,1,2,0,2
47763_0,,,,2,3,2,5
C(C(CCC(C(O)=O)=O)(O)O)=O,,,5,1,2,0,2
47764_0,,,,2,3,2,5
47766_0,,,,2,3,2,5
C(C(C)(CCC(C(O)=O)=O)O)=O,,,5,1,3,0,3
47767_0,,,,2,3,2,5
47769_0,,,,2,3,2,5
C(C(CCCC(C(O)=O)=O)O)=O,,,5,1,3,0,3
47771_0,,,,2,3,2,5
C(C(CC[C](C(O)=O)O)=O)(O)=O,,,5,1,2,0,2
47772_0,,,,2,3,2,5
47774_0,,,,2,3,2,5
C(C(CO)(CCC(C(O)=O)=O)O)=O,,,5,1,3,0,3
47775_0,,,,2,3,2,5
47776_0,,,,2,3,2,5
47777_0,,,,2,3,2,5
47778_0,,,,2,3,2,5
47779_0,,,,2,3,2,5
47781_0,,,,2,3,2,5
C(CO)(C(CCC(C(O)=O)=O)O)=O,,,5,1,2,0,2
47783_0,,,,2,3,2,5
C(C(CCC(CO)(CO)O)=O)(O)=O,,,5,1,2,0,2
47785_0,,,,2,3,2,5
C(C(CCC(C(CO)O)O)=O)(O)=O,,,5,1,2,0,2
47786_0,,,,2,3,2,5
47787_0,,,,2,3,2,5
47789_0,,,,2,3,2,5
C(C(C=O)CCC(C(O)=O)=O)=O,,,5,1,3,0,3
47790_0,,,,2,3,2,5
47792_0,,,,2,3,2,5
C(CCCC(C(O)=O)=O)=O,,,5,1,3,0,3
47794_0,,,,2,3,2,5
C(C(C)(CCC(C(O)=O)=O)O)(O)=O,,,5,1,2,0,2
47795_0,,,,2,3,2,5
47796_0,,,,2,3,2,5
47798_0,,,,2,3,2,5
C(C(O)=O)(CCC(C(C=O)=O)O)=O,,,5,1,2,0,2
47800_0,,,,2,3,2,5
C(C(C(C=O)CC=O)(O)O)(O)=O,,,5,1,2,0,2
47802_0,,,,2,3,2,5
C(C(CC=O)C(C=O)(O)O)(O)=O,,,5,1,2,0,2
47804_0,,,,2,3,2,5
C(CC(C=O)C(C=O)(O)O)(O)=O,,,5,1,3,0,3
47805_0,,,,2,3,2,5
47807_0,,,,2,3,2,5
C(CC(C(O)=O)C(C=O)(C)O)=O,,,5,1,2,0,2
47809_0,,,,2,3,2,5
C(CC(C=O)C(C=O)(C)O)(O)=O,,,5,1,4,0,4
47810_0,,,,2,3,2,5
47812_0,,,,2,3,2,5
C(C(CC(C=O)O)CC=O)(O)=O,,,5,1,2,0,2
47814_0,,,,2,3,2,5
C(C(CC(C=O)CC(O)=O)O)=O,,,5,1,2,0,2
47816_0,,,,2,3,2,5
C(C([C](C(O)=O)O)CC=O)(O)=O,,,5,1,2,0,2
47818_0,,,,2,3,2,5
C(C([C](C(O)=O)O)CC(O)=O)=O,,,5,1,3,0,3
47819_0,,,,2,3,2,5
47821_0,,,,2,3,2,5
C(C(C(C(C=O)O)O)CC=O)(O)=O,,,5,1,2,0,2
47823_0,,,,2,3,2,5
C(C(C(C(C=O)CC(O)=O)O)O)=O,,,5,1,2,0,2
47825_0,,,,2,3,2,5
C(C(C(CO)(CO)O)CC=O)(O)=O,,,5,1,2,0,2
47827_0,,,,2,3,2,5
C(C(C(CO)(CO)O)CC(O)=O)=O,,,5,1,2,0,2
47829_0,,,,2,3,2,5
C(C(C(C(CO)O)O)CC=O)(O)=O,,,5,1,2,0,2
47831_0,,,,2,3,2,5
C(C(C(C(CO)O)O)CC(O)=O)=O,,,5,1,2,0,2
47833_0,,,,2,3,2,5
C(C(CC(C(O)=O)CC=O)O)(O)=O,,,5,1,2,0,2
47835_0,,,,2,3,2,5
C(C(CC(C=O)CC(O)=O)O)(O)=O,,,5,1,2,0,2
47837_0,,,,2,3,2,5
C(CCC(C(O)=O)(O)O)(O)=O,,,5,1,2,0,2
47838_0,,,,2,3,2,5
47839_0,,,,2,3,2,5
47840_0,,,,2,3,2,5
47841_0,,,,2,3,2,5
47842_0,,,,2,3,2,5
47843_0,,,,2,3,2,5
47844_0,,,,2,3,2,5
47845_0,,,,2,3,2,5
47846_0,,,,2,3,2,5
47847_0,,,,2,3,2,5
47848_0,,,,2,3,2,5
47849_0,,,,2,3,2,5
47850_0,,,,2,3,2,5
47851_0,,,,2,3,2,5
47852_0,,,,2,3,2,5
47853_0,,,,2,3,2,5
47854_0,,,,2,3,2,5
47855_0,,,,2,3,2,5
47857_0,,,,2,3,2,5
C(CC(CO)C(C(O)=O)(O)O)(O)=O,,,5,1,2,0,2
47858_0,,,,2,3,2,5
47859_0,,,,2,3,2,5
47860_0,,,,2,3,2,5
47861_0,,,,2,3,2,5
47862_0,,,,2,3,2,5
47863_0,,,,2,3,2,5
47864_0,,,,2,3,2,5
47865_0,,,,2,3,2,5
47866_0,,,,2,3,2,5
47867_0,,,,2,3,2,5
47869_0,,,,2,3,2,5
C(C(C(C(C(O)=O)=O)O)=O)(O)=O,,,5,1,2,0,2
47871_0,,,,2,3,2,5
C(C(C(C)=O)(C(C(O)=O)=O)O)(O)=O,,,5,1,4,0,4
47873_0,,,,2,3,2,5
C(C(C(C(O)=O)=O)(CC=O)O)(O)=O,,,5,1,3,0,3
47875_0,,,,2,3,2,5
C(C(C(C(O)=O)=O)(CC(O)=O)O)=O,,,5,1,2,0,2
47876_0,,,,2,3,2,5
47877_0,,,,2,3,2,5
47878_0,,,,2,3,2,5
47880_0,,,,2,3,2,5
C(CC(C(C(O)=O)=O)(CO)O)(O)=O,,,5,1,2,0,2
47881_0,,,,2,3,2,5
47882_0,,,,2,3,2,5
47883_0,,,,2,3,2,5
47884_0,,,,2,3,2,5
47885_0,,,,2,3,2,5
47886_0,,,,2,3,2,5
47887_0,,,,2,3,2,5
47888_0,,,,2,3,2,5
47889_0,,,,2,3,2,5
47890_0,,,,2,3,2,5
47891_0,,,,2,3,2,5
47892_0,,,,2,3,2,5
47893_0,,,,2,3,2,5
47894_0,,,,2,3,2,5
47895_0,,,,2,3,2,5
47896_0,,,,2,3,2,5
47898_0,,,,2,3,2,5
C(C[C](C(O)=O)O)(O)=O,,,5,1,3,0,3
47899_0,,,,2,1,1,2
47899_1,,,,2,1,1,2
47900_0,,,,2,1,1,2
47900_1,,,,2,1,1,2
47902_0,,,,2,1,1,2
C1(C(C2C(C1(C(C2O)O)O)O)O)=O,,,5,1,4,0,4
47902_1,,,,2,1,1,2
47903_0,,,,2,1,1,2
47903_1,,,,2,1,1,2
47904_0,,,,2,1,1,2
47904_1,,,,2,1,1,2
47905_0,,,,2,1,1,2
47905_1,,,,2,1,1,2
47906_0,,,,2,1,1,2
47906_1,,,,2,1,1,2
47907_0,,,,2,1,1,2
47908_0,,,,2,1,1,2
47908_1,,,,2,1,1,2
47909_0,,,,2,1,1,2
47909_1,,,,2,1,1,2
47911_0,,,,2,1,1,2
C(C1(C(C(CO)(CC1O)O)O)O)=O,,,5,1,4,0,4
47911_1,,,,2,1,1,2
47912_0,,,,2,1,1,2
47912_1,,,,2,1,1,2
47914_0,,,,2,1,1,2
C(C1(C=O)C(CC(C1(C)O)O)O)=O,,,5,1,2,0,2
47916_0,,,,2,1,1,2
C(C1(CO)C(C(C)(CC1O)O)O)=O,,,5,1,2,0,2
47918_0,,,,2,1,1,2
C(C)(C1(C(C(C)(CC1O)O)O)O)=O,,,5,1,4,0,4
47918_1,,,,2,1,1,2
47920_0,,,,2,1,1,2
C(C1(C=O)C(C(C)(CC1O)O)O)=O,,,5,1,2,0,2
47922_0,,,,2,1,1,2
C(C1(C(C(C)(CC1O)O)O)O)=O,,,5,1,4,0,4
47922_1,,,,2,1,1,2
47923_0,,,,2,1,1,2
47924_0,,,,2,1,1,2
47924_1,,,,2,1,1,2
47925_0,,,,2,1,1,2
47926_0,,,,2,1,1,2
47926_1,,,,2,1,1,2
47928_0,,,,2,1,1,2
C(C1(C(C(C)(C(C1O)O)O)O)O)=O,,,5,1,6,0,6
47928_1,,,,2,1,1,2
47930_0,,,,2,1,1,2
C(C1(C(CC(C1(C)O)O)O)O)=O,,,5,1,4,0,4
47930_1,,,,2,1,1,2
47931_0,,,,2,1,1,2
47931_1,,,,2,1,1,2
47933_0,,,,2,1,1,2
C(C1(C(C(C(C1(C)O)O)O)O)O)=O,,,5,1,7,0,7
47933_1,,,,2,1,1,2
47935_0,,,,2,1,1,2
C(C1(CO)C(CC(C1(C)O)O)O)=O,,,5,1,2,0,2
47937_0,,,,2,1,1,2
C(C)(C1(C(CC(C1(C)O)O)O)O)=O,,,5,1,4,0,4
47937_1,,,,2,1,1,2
47938_0,,,,2,1,1,2
47939_0,,,,2,1,1,2
47939_1,,,,2,1,1,2
47940_0,,,,2,1,1,2
47941_0,,,,2,1,1,2
47941_1,,,,2,1,1,2
47943_0,,,,2,1,1,2
C(C)(C1(C(C(CC1O)O)O)O)=O,,,5,1,4,0,4
47943_1,,,,2,1,1,2
47944_0,,,,2,1,1,2
47944_1,,,,2,1,1,2
47946_0,,,,2,1,1,2
C(C)(C1(C(C(C(C1O)O)O)O)O)=O,,,5,1,4,0,4
47946_1,,,,2,1,1,2
47947_0,,,,2,1,1,2
47947_1,,,,2,1,1,2
47948_0,,,,2,1,1,2
47948_1,,,,2,1,1,2
47949_0,,,,2,1,1,2
47950_0,,,,2,1,1,2
47951_0,,,,2,1,1,2
47952_0,,,,2,1,1,2
47952_1,,,,2,1,1,2
47954_0,,,,2,1,1,2
C(C1(C=O)C(CC(CC1O)O)O)=O,,,5,1,1,0,1
47956_0,,,,2,1,1,2
C(C1(CO)C(CC(CC1O)O)O)=O,,,5,1,1,0,1
47958_0,,,,2,1,1,2
C(C)(C1(C(CC(CC1O)O)O)O)=O,,,5,1,2,0,2
47958_1,,,,2,1,1,2
47960_0,,,,2,1,1,2
C(C1(C(CC(CC1O)O)O)O)=O,,,5,1,2,0,2
47960_1,,,,2,1,1,2
47961_0,,,,2,1,1,2
47963_0,,,,2,1,1,2
C(C1(C(C(C(CC1O)O)O)O)O)=O,,,5,1,6,0,6
47963_1,,,,2,1,1,2
47964_0,,,,2,1,1,2
47964_1,,,,2,1,1,2
47965_0,,,,2,1,1,2
47965_1,,,,2,1,1,2
47967_0,,,,2,1,1,2
C(C1(C(C(CC1O)O)=O)CO)(O)=O,,,5,1,2,0,2
47969_0,,,,2,1,1,2
C1(C(CC(C1(CO)C(C)O)O)O)=O,,,5,1,2,0,2
47971_0,,,,2,1,1,2
C1(C(CC(C1(CO)CO)O)O)=O,,,5,1,2,0,2
47973_0,,,,2,1,1,2
C1(C(C(C(C1(CO)CO)O)O)O)=O,,,5,1,2,0,2
47974_0,,,,2,1,1,2
47976_0,,,,2,1,1,2
C(C1(C(C(CC1O)O)O)C(C)O)=O,,,5,1,3,0,3
47977_0,,,,2,1,1,2
47978_0,,,,2,1,1,2
47979_0,,,,2,1,1,2
47980_0,,,,2,1,1,2
47981_0,,,,2,1,1,2
47981_1,,,,2,1,1,2
47982_0,,,,2,1,1,2
47982_1,,,,2,1,1,2
47983_0,,,,2,1,1,2
47983_1,,,,2,1,1,2
47984_0,,,,2,1,1,2
47984_1,,,,2,1,1,2
47985_0,,,,2,1,1,2
47985_1,,,,2,1,1,2
47986_0,,,,2,1,1,2
47986_1,,,,2,1,1,2
47987_0,,,,2,1,1,2
47987_1,,,,2,1,1,2
47988_0,,,,2,1,1,2
47990_0,,,,2,1,1,2
C(C1(C(CC(CC1(C)O)O)O)O)=O,,,5,1,2,0,2
47990_1,,,,2,1,1,2
47991_0,,,,2,1,1,2
47991_1,,,,2,1,1,2
47992_0,,,,2,1,1,2
47994_0,,,,2,1,1,2
C(C1(C(C)O)C(C=CC1O)O)=O,,,5,1,1,0,1
47996_0,,,,2,1,1,2
C1(C(CC(C1(C(C)O)O)O)O)=O,,,5,1,4,0,4
47996_1,,,,2,1,1,2
47997_0,,,,2,1,1,2
47997_1,,,,2,1,1,2
47998_0,,,,2,1,1,2
47998_1,,,,2,1,1,2
47999_0,,,,2,1,1,2
47999_1,,,,2,1,1,2
48000_0,,,,2,1,1,2
48000_1,,,,2,1,1,2
48001_0,,,,2,1,1,2
48001_1,,,,2,1,1,2
48002_0,,,,2,1,1,2
48002_1,,,,2,1,1,2
48003_0,,,,2,1,1,2
48003_1,,,,2,1,1,2
48005_0,,,,2,1,1,2
C(C1(C(C(C(CO)C1O)O)=O)O)=O,,,5,1,2,0,2
48005_1,,,,2,1,1,2
48006_0,,,,2,1,1,2
48008_0,,,,2,1,1,2
C(C1C(C(CO)C(C1O)O)O)(O)=O,,,5,1,1,0,1
48009_0,,,,2,1,1,2
48011_0,,,,2,1,1,2
C(C1(CO)C(C=CC1O)O)=O,,,5,1,1,0,1
48013_0,,,,2,1,1,2
C(C1(C(CO)O)C(C=CC1O)O)=O,,,5,1,1,0,1
48015_0,,,,2,1,1,2
C(C1(C(C(C=O)(CC1O)O)O)O)=O,,,5,1,3,0,3
48015_1,,,,2,1,1,2
48016_0,,,,2,1,1,2
48016_1,,,,2,1,1,2
48018_0,,,,2,1,1,2
C(C1(C=O)C(C(C(C1O)=O)O)O)=O,,,5,1,2,0,2
48019_0,,,,2,1,1,2
48019_1,,,,2,1,1,2
48020_0,,,,2,1,1,2
48020_1,,,,2,1,1,2
48021_0,,,,2,1,1,2
48021_1,,,,2,1,1,2
48023_0,,,,2,1,1,2
C(C1(C(C(CC1(CO)O)O)=O)O)=O,,,5,1,2,0,2
48023_1,,,,2,1,1,2
48025_0,,,,2,1,1,2
C1(C(CC(C=O)(C1(C=O)O)O)O)=O,,,5,1,2,0,2
48025_1,,,,2,1,1,2
48026_0,,,,2,1,1,2
48026_1,,,,2,1,1,2
48027_0,,,,2,1,1,2
48028_0,,,,2,1,1,2
48028_1,,,,2,1,1,2
48029_0,,,,2,1,1,2
48029_1,,,,2,1,1,2
48030_0,,,,2,1,1,2
48030_1,,,,2,1,1,2
48031_0,,,,2,1,1,2
48031_1,,,,2,1,1,2
48032_0,,,,2,1,1,2
48032_1,,,,2,1,1,2
48033_0,,,,2,1,1,2
48033_1,,,,2,1,1,2
48034_0,,,,2,1,1,2
48034_1,,,,2,1,1,2
48035_0,,,,2,1,1,2
48035_1,,,,2,1,1,2
48036_0,,,,2,1,1,2
48036_1,,,,2,1,1,2
48037_0,,,,2,1,1,2
48037_1,,,,2,1,1,2
48038_0,,,,2,1,1,2
48038_1,,,,2,1,1,2
48039_0,,,,2,1,1,2
48041_0,,,,2,1,1,2
C1C(C(C(C(C)=O)=O)(C(C=1)O)O)O,,,5,1,2,0,2
48041_1,,,,2,1,1,2
48042_0,,,,2,1,1,2
48042_1,,,,2,1,1,2
48043_0,,,,2,1,1,2
48044_0,,,,2,1,1,2
48044_1,,,,2,1,1,2
48045_0,,,,2,1,1,2
48045_1,,,,2,1,1,2
48046_0,,,,2,1,1,2
48046_1,,,,2,1,1,2
48047_0,,,,2,1,1,2
48047_1,,,,2,1,1,2
48048_0,,,,2,1,1,2
48048_1,,,,2,1,1,2
48049_0,,,,2,1,1,2
48049_1,,,,2,1,1,2
48050_0,,,,2,1,1,2
48050_1,,,,2,1,1,2
48051_0,,,,2,1,1,2
48051_1,,,,2,1,1,2
48052_0,,,,2,1,1,2
48052_1,,,,2,1,1,2
48054_0,,,,2,1,1,2
C(C1C(C(C(C1(C)O)O)O)O)(O)=O,,,5,1,1,0,1
48056_0,,,,2,1,1,2
C(C)(C1(C(C=CC1O)O)O)=O,,,5,1,2,0,2
48056_1,,,,2,1,1,2
48057_0,,,,2,1,1,2
48057_1,,,,2,1,1,2
48059_0,,,,2,1,1,2
C(C1C(C(CC1(CO)O)O)O)(O)=O,,,5,1,1,0,1
48060_0,,,,2,1,1,2
48060_1,,,,2,1,1,2
48061_0,,,,2,1,1,2
48061_1,,,,2,1,1,2
48063_0,,,,2,1,1,2
C(C1(C(C=CC1O)O)O)(CCO)=O,,,5,1,2,0,2
48063_1,,,,2,1,1,2
48065_0,,,,2,1,1,2
C(CO)(C1(CO)C(C=CC1O)O)=O,,,5,1,1,0,1
48066_0,,,,2,1,1,2
48066_1,,,,2,1,1,2
48067_0,,,,2,1,1,2
48067_1,,,,2,1,1,2
48068_0,,,,2,1,1,2
48068_1,,,,2,1,1,2
48069_0,,,,2,1,1,2
48069_1,,,,2,1,1,2
48070_0,,,,2,1,1,2
48070_1,,,,2,1,1,2
48071_0,,,,2,1,1,2
48071_1,,,,2,1,1,2
48072_0,,,,2,1,1,2
48072_1,,,,2,1,1,2
48073_0,,,,2,1,1,2
48074_0,,,,2,1,1,2
48075_0,,,,2,1,1,2
48076_0,,,,2,1,1,2
48077_0,,,,2,1,1,2
48078_0,,,,2,1,1,2
48079_0,,,,2,1,1,2
48080_0,,,,2,1,1,2
48081_0,,,,2,1,1,2
48082_0,,,,2,1,1,2
48084_0,,,,2,1,1,2
C(C1(C=O)C(C=CC1O)O)(O)=O,,,5,1,1,0,1
48085_0,,,,2,1,1,2
48086_0,,,,2,1,1,2
48087_0,,,,2,1,1,2
48088_0,,,,2,1,1,2
48089_0,,,,2,1,1,2
48090_0,,,,2,1,1,2
48091_0,,,,2,1,1,2
48091_1,,,,2,1,1,2
48092_0,,,,2,1,1,2
48092_1,,,,2,1,1,2
48093_0,,,,2,1,1,2
48093_1,,,,2,1,1,2
48094_0,,,,2,1,1,2
48094_1,,,,2,1,1,2
48096_0,,,,2,1,1,2
C1C(C(C(C(O)=O)=O)(C(C=1)O)O)O,,,5,1,2,0,2
48096_1,,,,2,1,1,2
48098_0,,,,2,1,1,2
C(C1(C(CC(C1(C)O)O)O)O)(O)=O,,,5,1,4,0,4
48098_1,,,,2,1,1,2
48100_0,,,,2,1,1,2
C(C1(C(C(C)(CC1O)O)O)O)(O)=O,,,5,1,4,0,4
48100_1,,,,2,1,1,2
48102_0,,,,2,1,1,2
C(C1(C(CC(CC1O)O)O)O)(O)=O,,,5,1,2,0,2
48102_1,,,,2,1,1,2
48103_0,,,,2,1,1,2
48103_1,,,,2,1,1,2
48104_0,,,,2,1,1,2
48104_1,,,,2,1,1,2
48105_0,,,,2,1,1,2
48105_1,,,,2,1,1,2
48106_0,,,,2,1,1,2
48106_1,,,,2,1,1,2
48108_0,,,,2,1,1,2
C(C1(C=O)C(CC(C1O)=O)O)=O,,,5,1,3,0,3
48109_0,,,,2,1,1,2
48109_1,,,,2,1,1,2
48110_0,,,,2,1,1,2
48112_0,,,,2,1,1,2
C(C1(C(C=O)=O)C(C=CC1O)O)=O,,,5,1,1,0,1
48114_0,,,,2,1,1,2
C(C1(C(C(CC1O)O)=O)CO)=O,,,5,1,1,0,1
48115_0,,,,2,1,1,2
48116_0,,,,2,1,1,2
48116_1,,,,2,1,1,2
48117_0,,,,2,1,1,2
48117_1,,,,2,1,1,2
48119_0,,,,2,1,1,2
C1(C2(C(C=CC2O)O)OCC1O)=O,,,5,1,2,0,2
48119_1,,,,2,1,1,2
48120_0,,,,2,1,1,2
48120_1,,,,2,1,1,2
48121_0,,,,2,1,1,2
48121_1,,,,2,1,1,2
48122_0,,,,2,1,1,2
48122_1,,,,2,1,1,2
48123_0,,,,2,1,1,2
48123_1,,,,2,1,1,2
48124_0,,,,2,1,1,2
48124_1,,,,2,1,1,2
48125_0,,,,2,1,1,2
48125_1,,,,2,1,1,2
48126_0,,,,2,1,1,2
48126_1,,,,2,1,1,2
48128_0,,,,2,1,1,2
C1(C(O)OCC21C(C=CC2O)O)=O,,,5,1,1,0,1
48130_0,,,,2,1,1,2
C1(COC(C21C(C=CC2O)O)O)=O,,,5,1,1,0,1
48132_0,,,,2,1,1,2
C1(C2(C(C=CC2O)O)OC(C1)O)=O,,,5,1,2,0,2
48132_1,,,,2,1,1,2
48133_0,,,,2,1,1,2
48133_1,,,,2,1,1,2
48135_0,,,,2,1,1,2
C1(C(C(C(C=C)=O)(C(C1)O)O)O)=O,,,5,1,2,0,2
48135_1,,,,2,1,1,2
48136_0,,,,2,1,1,2
48136_1,,,,2,1,1,2
48138_0,,,,2,1,1,2
C(CO)(C1(C(C=CC1O)O)O)=O,,,5,1,3,0,3
48138_1,,,,2,1,1,2
48140_0,,,,2,1,1,2
C(C1(C=O)C(C=CC1O)O)=O,,,5,1,2,0,2
48142_0,,,,2,1,1,2
C1C(C(C(C=O)=O)(CO)C(C=1)O)O,,,5,1,1,0,1
48144_0,,,,2,1,1,2
C(C(C1(C=O)C(C=CC1O)O)O)=O,,,5,1,1,0,1
48146_0,,,,2,1,1,2
C(C1(C(CO)=O)C(C=CC1O)O)=O,,,5,1,1,0,1
48148_0,,,,2,1,1,2
C(CC(C1(C(C=CC1O)O)O)=O)=O,,,5,1,2,0,2
48148_1,,,,2,1,1,2
48149_0,,,,2,1,1,2
48149_1,,,,2,1,1,2
48151_0,,,,2,1,1,2
C1C(C(C(C=O)=O)(C(C=1)O)O)O,,,5,1,3,0,3
48151_1,,,,2,1,1,2
48153_0,,,,2,1,1,2
C(C1(C(C=CC1O)O)O)=O,,,5,1,3,0,3
48153_1,,,,2,1,1,2
48154_0,,,,2,1,1,2
48154_1,,,,2,1,1,2
48155_0,,,,2,1,1,2
48155_1,,,,2,1,1,2
48156_0,,,,2,1,1,2
48156_1,,,,2,1,1,2
48158_0,,,,2,1,1,2
C(C1(C(C(C(C1O)O)=O)=O)O)=O,,,5,1,2,0,2
48158_1,,,,2,1,1,2
48159_0,,,,2,1,1,2
48159_1,,,,2,1,1,2
48160_0,,,,2,1,1,2
48160_1,,,,2,1,1,2
48161_0,,,,2,1,1,2
48161_1,,,,2,1,1,2
48162_0,,,,2,1,1,2
48162_1,,,,2,1,1,2
48163_0,,,,2,1,1,2
48163_1,,,,2,1,1,2
48164_0,,,,2,1,1,2
48164_1,,,,2,1,1,2
48166_0,,,,2,1,1,2
C(C1(C(C(CC(C1O)O)O)O)O)=O,,,5,1,2,0,2
48166_1,,,,2,1,1,2
48168_0,,,,2,1,1,2
C1(C(CO)(C(CC1(CO)O)O)O)=O,,,5,1,3,0,3
48168_1,,,,2,1,1,2
48170_0,,,,2,1,1,2
C1(C(CO)(C(C(C1(C)O)O)O)O)=O,,,5,1,2,0,2
48170_1,,,,2,1,1,2
48171_0,,,,2,1,1,2
48171_1,,,,2,1,1,2
48173_0,,,,2,1,1,2
C1(C(C(CO)O)(C(C(C1)=O)O)O)=O,,,5,1,2,0,2
48173_1,,,,2,1,1,2
48175_0,,,,2,1,1,2
C1(C(CO)(C(C(C1CO)=O)O)O)=O,,,5,1,2,0,2
48175_1,,,,2,1,1,2
48176_0,,,,2,1,1,2
48176_1,,,,2,1,1,2
48178_0,,,,2,1,1,2
C(C1(C(C(CO)(CC1O)O)=O)O)=O,,,5,1,2,0,2
48178_1,,,,2,1,1,2
48180_0,,,,2,1,1,2
C1(C(CO)(C(CC(C1O)=O)O)O)=O,,,5,1,2,0,2
48180_1,,,,2,1,1,2
48181_0,,,,2,1,1,2
48181_1,,,,2,1,1,2
48183_0,,,,2,1,1,2
C(C1(C(C(C)(C(C1O)O)O)=O)O)=O,,,5,1,3,0,3
48183_1,,,,2,1,1,2
48184_0,,,,2,1,1,2
48184_1,,,,2,1,1,2
48186_0,,,,2,1,1,2
C1(C(CO)(C(C(C(C1)=O)O)O)O)=O,,,5,1,2,0,2
48186_1,,,,2,1,1,2
48188_0,,,,2,1,1,2
C(C1(C(C(CO)(C(C1)O)O)=O)O)=O,,,5,1,2,0,2
48188_1,,,,2,1,1,2
48189_0,,,,2,1,1,2
48190_0,,,,2,1,1,2
48191_0,,,,2,1,1,2
48192_0,,,,2,1,1,2
48192_1,,,,2,1,1,2
48194_0,,,,2,1,1,2
C1(C2(C(CO1)O)C(C=CC2O)O)=O,,,5,1,1,0,1
48195_0,,,,2,1,1,2
48195_1,,,,2,1,1,2
48196_0,,,,2,1,1,2
48196_1,,,,2,1,1,2
48197_0,,,,2,1,1,2
48197_1,,,,2,1,1,2
48199_0,,,,2,1,1,2
C(C1(C(C(C(C1O)(O)O)O)=O)O)=O,,,5,1,2,0,2
48199_1,,,,2,1,1,2
48200_0,,,,2,1,1,2
48200_1,,,,2,1,1,2
48202_0,,,,2,1,1,2
C(C1C(C(C(C1O)=O)(C)O)O)(O)=O,,,5,1,2,0,2
48204_0,,,,2,1,1,2
C(C1C(C(C(C1O)O)(O)O)O)(O)=O,,,5,1,1,0,1
48206_0,,,,2,1,1,2
C(C1C(C(C)(C(C1O)O)O)O)(O)=O,,,5,1,1,0,1
48207_0,,,,2,1,1,2
48207_1,,,,2,1,1,2
48209_0,,,,2,1,1,2
C(C1(C(C=CC1O)O)O)(O)=O,,,5,1,3,0,3
48209_1,,,,2,1,1,2
48211_0,,,,2,1,1,2
C1(C2(C(C(C1(CO2)O)O)O)O)=O,,,5,1,3,0,3
48211_1,,,,2,1,1,2
48213_0,,,,2,1,1,2
C1(C2(C(C)(C(C1(CO2)O)O)O)O)=O,,,5,1,3,0,3
48213_1,,,,2,1,1,2
48215_0,,,,2,1,1,2
C1(C2(C(C(C)(C1(CO2)O)O)O)O)=O,,,5,1,3,0,3
48215_1,,,,2,1,1,2
48217_0,,,,2,1,1,2
C1(C2(C(CC(C1(CO2)O)O)O)O)=O,,,5,1,3,0,3
48217_1,,,,2,1,1,2
48219_0,,,,2,1,1,2
C(C1(C(C(C(C1O)O)(O)O)O)O)=O,,,5,1,2,0,2
48219_1,,,,2,1,1,2
48221_0,,,,2,1,1,2
C1(C(C(C(C1(CO)O)O)(O)O)O)=O,,,5,1,2,0,2
48221_1,,,,2,1,1,2
48223_0,,,,2,1,1,2
C1(CCC(C1(C(CO)O)O)O)=O,,,5,1,2,0,2
48223_1,,,,2,1,1,2
48225_0,,,,2,1,1,2
C1(CCC(C=O)(C1(C=O)O)O)=O,,,5,1,4,0,4
48225_1,,,,2,1,1,2
48226_0,,,,2,1,1,2
48226_1,,,,2,1,1,2
48228_0,,,,2,1,1,2
C(C1(C=O)C(C(C(C1)=O)O)O)=O,,,5,1,3,0,3
48230_0,,,,2,1,1,2
C(C1C(C(C=O)(C(C1)=O)O)O)=O,,,5,1,4,0,4
48230_1,,,,2,1,1,2
48232_0,,,,2,1,1,2
C(C1(C=O)C(CC(C1O)O)=O)=O,,,5,1,2,0,2
48234_0,,,,2,1,1,2
C(C1(C(CCC1O)=O)O)=O,,,5,1,4,0,4
48234_1,,,,2,1,1,2
48236_0,,,,2,1,1,2
C1(C(CC(C1(CO)CO)O)=O)=O,,,5,1,1,0,1
48238_0,,,,2,1,1,2
C(C1(C(CC(CO)C1O)=O)O)=O,,,5,1,2,0,2
48238_1,,,,2,1,1,2
48240_0,,,,2,1,1,2
C(C1(CO)C(C(C(C1)=O)O)O)=O,,,5,1,1,0,1
48242_0,,,,2,1,1,2
C1(CCC(C1(C(CO)=O)O)O)=O,,,5,1,3,0,3
48242_1,,,,2,1,1,2
48244_0,,,,2,1,1,2
C1(C(C(C(C1C)O)(CO)O)=O)=O,,,5,1,3,0,3
48244_1,,,,2,1,1,2
48246_0,,,,2,1,1,2
C1(C(CO)(C(C(C1)=O)(C)O)O)=O,,,5,1,3,0,3
48246_1,,,,2,1,1,2
48248_0,,,,2,1,1,2
C1(C(CC(C)(C1(CO)O)O)=O)=O,,,5,1,3,0,3
48248_1,,,,2,1,1,2
48249_0,,,,2,1,1,2
48249_1,,,,2,1,1,2
48251_0,,,,2,1,1,2
C1(C(CCC(C1(CO)O)O)=O)=O,,,5,1,3,0,3
48251_1,,,,2,1,1,2
48252_0,,,,2,1,1,2
48252_1,,,,2,1,1,2
48254_0,,,,2,1,1,2
C1(C(CO)(CO)C(C(C1)=O)O)=O,,,5,1,1,0,1
48256_0,,,,2,1,1,2
C(C1(C(CCC1O)=O)O)(O)=O,,,5,1,3,0,3
48256_1,,,,2,1,1,2
48258_0,,,,2,1,1,2
C(C1(C(C(CC1O)=O)=O)C)=O,,,5,1,1,0,1
48260_0,,,,2,1,1,2
C1(C(CO)(C(C=O)(CC1)O)O)=O,,,5,1,4,0,4
48260_1,,,,2,1,1,2
48261_0,,,,2,1,1,2
48261_1,,,,2,1,1,2
48263_0,,,,2,1,1,2
C(C1(C=O)C(CC(C1)=O)O)=O,,,5,1,3,0,3
48265_0,,,,2,1,1,2
C(C1(C=O)C(CCC1O)=O)=O,,,5,1,2,0,2
48266_0,,,,2,1,1,2
48266_1,,,,2,1,1,2
48268_0,,,,2,1,1,2
C1(CCC(C1(C(C=O)=O)O)O)=O,,,5,1,3,0,3
48268_1,,,,2,1,1,2
48270_0,,,,2,1,1,2
C(C1(C(C(CC1O)=O)=O)CO)=O,,,5,1,1,0,1
48272_0,,,,2,1,1,2
C1(CC(C(C1(C(C)=O)O)O)=O)=O,,,5,1,3,0,3
48272_1,,,,2,1,1,2
48274_0,,,,2,1,1,2
C(C1(C(CCC1(CO)O)=O)O)=O,,,5,1,2,0,2
48274_1,,,,2,1,1,2
48276_0,,,,2,1,1,2
C1(CCC(C1(CO)O)O)=O,,,5,1,2,0,2
48276_1,,,,2,1,1,2
48278_0,,,,2,1,1,2
C(C1(C(CC(C1O)O)=O)CO)=O,,,5,1,1,0,1
48280_0,,,,2,1,1,2
C(C1C(C(CO)(C(C1)O)O)=O)=O,,,5,1,3,0,3
48280_1,,,,2,1,1,2
48282_0,,,,2,1,1,2
C(C1(C(C(CC1O)O)=O)C)(O)=O,,,5,1,1,0,1
48284_0,,,,2,1,1,2
C(C1(C(CC(C1O)O)=O)C)(O)=O,,,5,1,1,0,1
48286_0,,,,2,1,1,2
C1(C2(C(C(CC2O)O1)O)O)=O,,,5,1,6,0,6
48286_1,,,,2,1,1,2
48288_0,,,,2,1,1,2
C(C1(C=CC(C1(C=O)O)O)O)=O,,,5,1,7,0,7
48288_1,,,,2,1,1,2
48289_0,,,,2,1,1,2
48289_1,,,,2,1,1,2
48291_0,,,,2,1,1,2
C(C1(C(C(C=O)=CC1O)O)O)=O,,,5,1,3,0,3
48291_1,,,,2,1,1,2
48293_0,,,,2,1,1,2
C1(C(CO)(C(C(C1O)=C)O)O)=O,,,5,1,3,0,3
48293_1,,,,2,1,1,2
48295_0,,,,2,1,1,2
C1(C(CO)(C(C=CC1O)O)O)=O,,,5,1,3,0,3
48295_1,,,,2,1,1,2
48297_0,,,,2,1,1,2
C(C1(C(C=CC1(CO)O)O)O)=O,,,5,1,3,0,3
48297_1,,,,2,1,1,2
48299_0,,,,2,1,1,2
C(C1(C(C=C(C)C1O)=O)O)=O,,,5,1,3,0,3
48299_1,,,,2,1,1,2
48301_0,,,,2,1,1,2
C(C1(C(CC(C1O)=C)=O)O)=O,,,5,1,3,0,3
48301_1,,,,2,1,1,2
48303_0,,,,2,1,1,2
C(C1(C(C=CC1(C)O)=O)O)=O,,,5,1,3,0,3
48303_1,,,,2,1,1,2
48305_0,,,,2,1,1,2
C(C1(C=CC(C1(CO)O)=O)O)=O,,,5,1,3,0,3
48305_1,,,,2,1,1,2
48307_0,,,,2,1,1,2
C1(C=CC(C(C1(CO)O)O)=O)=O,,,5,1,3,0,3
48307_1,,,,2,1,1,2
48309_0,,,,2,1,1,2
C(C1(C(C=CCC1O)=O)O)=O,,,5,1,3,0,3
48309_1,,,,2,1,1,2
48311_0,,,,2,1,1,2
C(C1(C(CC=CC1O)=O)O)=O,,,5,1,3,0,3
48311_1,,,,2,1,1,2
48313_0,,,,2,1,1,2
C(C1(C=O)C=CC(C1O)O)=O,,,5,1,2,0,2
48315_0,,,,2,1,1,2
C1(C=C(C=O)C(C1(CO)O)O)=O,,,5,1,3,0,3
48315_1,,,,2,1,1,2
48317_0,,,,2,1,1,2
C(C1(C(C=C(CO)C1O)=O)O)=O,,,5,1,3,0,3
48317_1,,,,2,1,1,2
48319_0,,,,2,1,1,2
C(C1(C(C=CC1(CO)O)=O)O)=O,,,5,1,3,0,3
48319_1,,,,2,1,1,2
48321_0,,,,2,1,1,2
C(C1(C(C=CC1O)=O)O)=O,,,5,1,3,0,3
48321_1,,,,2,1,1,2
48323_0,,,,2,1,1,2
C1C(C(C(C=1)=O)(CO)O)O,,,5,1,4,0,4
48323_1,,,,2,1,1,2
48324_0,,,,2,1,1,2
48324_1,,,,2,1,1,2
48326_0,,,,2,1,1,2
C(C1(C(C2CC1(C(O)O2)O)O)O)=O,,,5,1,4,0,4
48326_1,,,,2,1,1,2
48328_0,,,,2,1,1,2
C(C1(C(C2(CC(C1O2)O)O)O)O)=O,,,5,1,3,0,3
48328_1,,,,2,1,1,2
48330_0,,,,2,1,1,2
C(C12C(O)OC(C1O)C(C2O)O)=O,,,5,1,4,0,4
48332_0,,,,2,1,1,2
C(C1(C(C2C(O)OC1C2O)O)O)=O,,,5,1,4,0,4
48332_1,,,,2,1,1,2
48334_0,,,,2,1,1,2
C1(C2(C(C(CC2O)(O)O1)O)O)=O,,,5,1,4,0,4
48334_1,,,,2,1,1,2
48336_0,,,,2,1,1,2
C1(C2CC(C(O2)O)(C1(CO)O)O)=O,,,5,1,4,0,4
48336_1,,,,2,1,1,2
48338_0,,,,2,1,1,2
C(C12C(O)OC(C1O)CC2O)=O,,,5,1,4,0,4
48340_0,,,,2,1,1,2
C1(C(O)OC2C(CC(C12O)O)O)=O,,,5,1,3,0,3
48340_1,,,,2,1,1,2
48342_0,,,,2,1,1,2
C1(C(O)OC2CC(C(C12O)O)O)=O,,,5,1,3,0,3
48342_1,,,,2,1,1,2
48344_0,,,,2,1,1,2
C(C1(C(C2(COC1(C2)O)O)O)O)=O,,,5,1,4,0,4
48344_1,,,,2,1,1,2
48346_0,,,,2,1,1,2
C(C1(C2C(CC1(C(O)O2)O)O)O)=O,,,5,1,4,0,4
48346_1,,,,2,1,1,2
48347_0,,,,2,1,1,2
48349_0,,,,2,1,1,2
C(C12C(C(C(O1)O)C(C2O)O)O)=O,,,5,1,4,0,4
48349_1,,,,2,1,1,2
48351_0,,,,2,1,1,2
C1(CC2(C)C(C1(C(O)O2)O)O)=O,,,5,1,4,0,4
48351_1,,,,2,1,1,2
48353_0,,,,2,1,1,2
C1(CC2C(C)(C1(C(O)O2)O)O)=O,,,5,1,4,0,4
48353_1,,,,2,1,1,2
48355_0,,,,2,1,1,2
C1(CC2CC(C1(C(O)O2)O)O)=O,,,5,1,3,0,3
48355_1,,,,2,1,1,2
48356_0,,,,2,1,1,2
48358_0,,,,2,1,1,2
C1(C(C2C(OC1(CO)C2O)O)O)=O,,,5,1,4,0,4
48358_1,,,,2,1,1,2
48360_0,,,,2,1,1,2
C1(C(O)OC2C(C1(C(C2)O)O)O)=O,,,5,1,6,0,6
48360_1,,,,2,1,1,2
48362_0,,,,2,1,1,2
C1(COC2(C(C1(C(C2)O)O)O)O)=O,,,5,1,4,0,4
48362_1,,,,2,1,1,2
48364_0,,,,2,1,1,2
C1(CC2(CO)C(C1(C(O)O2)O)O)=O,,,5,1,4,0,4
48364_1,,,,2,1,1,2
48366_0,,,,2,1,1,2
C(C1(C2(CC(C1(CO2)O)O)O)O)=O,,,5,1,4,0,4
48366_1,,,,2,1,1,2
48368_0,,,,2,1,1,2
C1(CC2C(CO)(C1(C(O)O2)O)O)=O,,,5,1,4,0,4
48368_1,,,,2,1,1,2
48370_0,,,,2,1,1,2
C1(CC2C(C1(C(O)O2)O)O)=O,,,5,1,4,0,4
48370_1,,,,2,1,1,2
48372_0,,,,2,1,1,2
C1(C(CC2(C(C1(CO2)O)O)O)O)=O,,,5,1,4,0,4
48372_1,,,,2,1,1,2
48374_0,,,,2,1,1,2
C1(C(C2C(O)OCC1(C2O)O)O)=O,,,5,1,4,0,4
48374_1,,,,2,1,1,2
48375_0,,,,2,1,1,2
48375_1,,,,2,1,1,2
48376_0,,,,2,1,1,2
48376_1,,,,2,1,1,2
48378_0,,,,2,1,1,2
C1(C2(C(C(C(C2O)O)O1)O)O)=O,,,5,1,6,0,6
48378_1,,,,2,1,1,2
48379_0,,,,2,1,1,2
48379_1,,,,2,1,1,2
48380_0,,,,2,1,1,2
48380_1,,,,2,1,1,2
48382_0,,,,2,1,1,2
C(C1(C=O)C(CCC1(C=O)O)O)=O,,,5,1,1,0,1
48384_0,,,,2,1,1,2
C(C1(C=O)C(CCC(C1O)=O)O)=O,,,5,1,2,0,2
48386_0,,,,2,1,1,2
C(C1(C=O)C(C(C=O)CC1O)O)=O,,,5,1,1,0,1
48388_0,,,,2,1,1,2
C(C1(CCC(C1O)=O)C(C)O)=O,,,5,1,2,0,2
48390_0,,,,2,1,1,2
C(C1(C(C)(CCC1(C=O)O)O)O)=O,,,5,1,2,0,2
48390_1,,,,2,1,1,2
48392_0,,,,2,1,1,2
C(C1(C(CCC(C1O)=O)(C)O)O)=O,,,5,1,3,0,3
48392_1,,,,2,1,1,2
48394_0,,,,2,1,1,2
C(C1CC(C(C=O)(C1(C)O)O)O)=O,,,5,1,2,0,2
48394_1,,,,2,1,1,2
48396_0,,,,2,1,1,2
C(C1(C(CCCC1(C=O)O)O)O)=O,,,5,1,2,0,2
48396_1,,,,2,1,1,2
48398_0,,,,2,1,1,2
C(C1(C(CCCC(C1O)=O)O)O)=O,,,5,1,3,0,3
48398_1,,,,2,1,1,2
48400_0,,,,2,1,1,2
C(C1(C(C(CC1O)CC=O)O)O)=O,,,5,1,3,0,3
48400_1,,,,2,1,1,2
48402_0,,,,2,1,1,2
C(C1CC(C(C=O)(C(C1)O)O)O)=O,,,5,1,2,0,2
48402_1,,,,2,1,1,2
48404_0,,,,2,1,1,2
C(C1(CO)CCC(C1O)=O)=O,,,5,1,2,0,2
48406_0,,,,2,1,1,2
C(C1(C(C(CC1O)O)O)CC=O)=O,,,5,1,2,0,2
48408_0,,,,2,1,1,2
C(C1(CCC(C1O)=O)C(CO)O)=O,,,5,1,2,0,2
48410_0,,,,2,1,1,2
C(CO)(C1(CO)CCC(C1O)=O)=O,,,5,1,2,0,2
48411_0,,,,2,1,1,2
48413_0,,,,2,1,1,2
C(C1(CCC(C1(C(C)=O)O)O)O)=O,,,5,1,2,0,2
48413_1,,,,2,1,1,2
48415_0,,,,2,1,1,2
C(C)(C1(C(CCC(C1O)=O)O)O)=O,,,5,1,3,0,3
48415_1,,,,2,1,1,2
48417_0,,,,2,1,1,2
C(C1C(C(C(C)=O)(C(C1)O)O)O)=O,,,5,1,2,0,2
48417_1,,,,2,1,1,2
48419_0,,,,2,1,1,2
C1(C(CO)(C(C=O)(CCC1)O)O)=O,,,5,1,2,0,2
48419_1,,,,2,1,1,2
48421_0,,,,2,1,1,2
C1(C(CO)(C(C(CCC1)=O)O)O)=O,,,5,1,3,0,3
48421_1,,,,2,1,1,2
48423_0,,,,2,1,1,2
C1(CC(C(C1(CO)O)O)CC=O)=O,,,5,1,3,0,3
48423_1,,,,2,1,1,2
48425_0,,,,2,1,1,2
C(C1CC(C(C(C1)=O)(CO)O)O)=O,,,5,1,2,0,2
48425_1,,,,2,1,1,2
48427_0,,,,2,1,1,2
C(C1(C=O)CCC(C1O)=O)(O)=O,,,5,1,2,0,2
48429_0,,,,2,1,1,2
C(C1(C(C=O)=O)CCC(C1O)=O)=O,,,5,1,2,0,2
48431_0,,,,2,1,1,2
C1(C2(COC1CCC2(C=O)O)O)=O,,,5,1,2,0,2
48431_1,,,,2,1,1,2
48433_0,,,,2,1,1,2
C1(C2(COC1CCC(C2O)=O)O)=O,,,5,1,3,0,3
48433_1,,,,2,1,1,2
48435_0,,,,2,1,1,2
C(CC1C(C2(C(C1OC2)=O)O)O)=O,,,5,1,3,0,3
48435_1,,,,2,1,1,2
48437_0,,,,2,1,1,2
C(C1CC(C2(C(C1OC2)=O)O)O)=O,,,5,1,2,0,2
48437_1,,,,2,1,1,2
48439_0,,,,2,1,1,2
C(C1(CCC2C1(C(CO2)=O)O)O)=O,,,5,1,2,0,2
48439_1,,,,2,1,1,2
48441_0,,,,2,1,1,2
C1(COC2CCC(C(C12O)O)=O)=O,,,5,1,3,0,3
48441_1,,,,2,1,1,2
48443_0,,,,2,1,1,2
C(C1C2C(C(CO2)=O)(C(C1)O)O)=O,,,5,1,2,0,2
48443_1,,,,2,1,1,2
48445_0,,,,2,1,1,2
C1(C(O)OCC21CCC(C2O)=O)=O,,,5,1,2,0,2
48447_0,,,,2,1,1,2
C1(C2(CCC(C2O)=O)C(CO1)O)=O,,,5,1,2,0,2
48449_0,,,,2,1,1,2
C1(C2C(C(CCC2(C=O)O)O1)O)=O,,,5,1,1,0,1
48451_0,,,,2,1,1,2
C1(C2C(C(CCC(C2O)=O)O1)O)=O,,,5,1,2,0,2
48453_0,,,,2,1,1,2
C1(C2C(C(C(C2O)O1)CC=O)O)=O,,,5,1,2,0,2
48455_0,,,,2,1,1,2
C1(C2C(CC(C=O)C(C2O)O1)O)=O,,,5,1,1,0,1
48457_0,,,,2,1,1,2
C1(C2C(CO1)(CCC2(C=O)O)O)=O,,,5,1,1,0,1
48459_0,,,,2,1,1,2
C1(C2C(CCC(C2O)=O)(CO1)O)=O,,,5,1,2,0,2
48461_0,,,,2,1,1,2
C1(C2C(CC(C=O)C2(CO1)O)O)=O,,,5,1,1,0,1
48463_0,,,,2,1,1,2
C1(COC(C21CCC(C2O)=O)O)=O,,,5,1,2,0,2
48465_0,,,,2,1,1,2
C(C1(C(CCC1(C=O)O)O)O)=O,,,5,1,2,0,2
48465_1,,,,2,1,1,2
48467_0,,,,2,1,1,2
C(C1(C(CCC(C1O)=O)O)O)=O,,,5,1,3,0,3
48467_1,,,,2,1,1,2
48469_0,,,,2,1,1,2
C(C1(C(CCC1(C=O)O)O)O)(O)=O,,,5,1,2,0,2
48469_1,,,,2,1,1,2
48471_0,,,,2,1,1,2
C(C1(C(CCC(C1O)=O)O)O)(O)=O,,,5,1,3,0,3
48471_1,,,,2,1,1,2
48473_0,,,,2,1,1,2
C(C1(C=O)CCC(C1O)=O)=O,,,5,1,2,0,2
48475_0,,,,2,1,1,2
C1(C(C(C(C=O)=O)(CO)CC1)O)=O,,,5,1,2,0,2
48477_0,,,,2,1,1,2
C(C1(CCC(C1O)=O)C(C=O)O)=O,,,5,1,2,0,2
48479_0,,,,2,1,1,2
C(CO)(C1(C=O)CCC(C1O)=O)=O,,,5,1,2,0,2
48481_0,,,,2,1,1,2
C1(CCCC(C=O)(C1(C=O)O)O)=O,,,5,1,2,0,2
48481_1,,,,2,1,1,2
48483_0,,,,2,1,1,2
C1(CCCC(C(C1(C=O)O)O)=O)=O,,,5,1,3,0,3
48483_1,,,,2,1,1,2
48485_0,,,,2,1,1,2
C(C1C(C(C=O)(C(C1)O)O)O)=O,,,5,1,2,0,2
48485_1,,,,2,1,1,2
48487_0,,,,2,1,1,2
C(C1C(C(C(O)=O)(C(C1)O)O)O)=O,,,5,1,2,0,2
48487_1,,,,2,1,1,2
48489_0,,,,2,1,1,2
C(CC1(C=O)C(CC(C1O)=O)O)=O,,,5,1,2,0,2
48490_0,,,,2,1,1,2
48492_0,,,,2,1,1,2
C(C1(C(CC(C1O)CC=O)=O)O)=O,,,5,1,3,0,3
48492_1,,,,2,1,1,2
48494_0,,,,2,1,1,2
C(C1CC(C(C=O)(C(C1)=O)O)O)=O,,,5,1,2,0,2
48494_1,,,,2,1,1,2
48496_0,,,,2,1,1,2
C(C1(C(C(CC1(C)O)O)O)O)=O,,,5,1,2,0,2
48496_1,,,,2,1,1,2
48497_0,,,,2,2,1,3
48498_0,,,,2,2,1,3
48498_1,,,,2,2,1,3
48499_0,,,,2,2,1,3
48499_1,,,,2,2,1,3
48500_0,,,,2,2,1,3
48500_1,,,,2,2,1,3
48501_0,,,,2,2,1,3
48501_1,,,,2,2,1,3
48502_0,,,,2,2,1,3
48502_1,,,,2,2,1,3
48503_0,,,,2,2,1,3
48503_1,,,,2,2,1,3
48504_0,,,,2,2,1,3
48504_1,,,,2,2,1,3
48505_0,,,,2,2,1,3
48506_0,,,,2,2,1,3
48507_0,,,,2,2,1,3
48508_0,,,,2,2,1,3
48508_1,,,,2,2,1,3
48509_0,,,,2,2,1,3
48509_1,,,,2,2,1,3
48510_0,,,,2,2,1,3
48510_1,,,,2,2,1,3
48512_0,,,,2,2,1,3
C1(C(C(C(C1)O)O)(C(C=C)O)O)=O,,,5,1,2,0,2
48512_1,,,,2,2,1,3
48513_0,,,,2,2,1,3
48513_1,,,,2,2,1,3
48514_0,,,,2,2,1,3
48514_1,,,,2,2,1,3
48515_0,,,,2,2,1,3
48515_1,,,,2,2,1,3
48516_0,,,,2,2,1,3
48516_1,,,,2,2,1,3
48517_0,,,,2,2,1,3
48517_1,,,,2,2,1,3
48518_0,,,,2,2,1,3
48518_1,,,,2,2,1,3
48519_0,,,,2,2,1,3
48519_1,,,,2,2,1,3
48520_0,,,,2,2,1,3
48521_0,,,,2,2,1,3
48522_0,,,,2,2,1,3
48523_0,,,,2,2,1,3
48524_0,,,,2,2,1,3
48524_1,,,,2,2,1,3
48525_0,,,,2,2,1,3
48526_0,,,,2,2,1,3
48527_0,,,,2,2,1,3
48528_0,,,,2,2,1,3
48529_0,,,,2,2,1,3
48529_1,,,,2,2,1,3
48530_0,,,,2,2,1,3
48530_1,,,,2,2,1,3
48531_0,,,,2,2,1,3
48531_1,,,,2,2,1,3
48532_0,,,,2,2,1,3
48532_1,,,,2,2,1,3
48533_0,,,,2,2,1,3
48534_0,,,,2,2,1,3
48534_1,,,,2,2,1,3
48536_0,,,,2,2,1,3
C1(C(C(CC1O)O)(C(C=C)O)O)=O,,,5,1,2,0,2
48536_1,,,,2,2,1,3
48537_0,,,,2,2,1,3
48537_1,,,,2,2,1,3
48538_0,,,,2,2,1,3
48538_1,,,,2,2,1,3
48539_0,,,,2,2,1,3
48539_1,,,,2,2,1,3
48540_0,,,,2,2,1,3
48540_1,,,,2,2,1,3
48541_0,,,,2,2,1,3
48541_1,,,,2,2,1,3
48542_0,,,,2,2,1,3
48542_1,,,,2,2,1,3
48543_0,,,,2,2,1,3
48544_0,,,,2,2,1,3
48545_0,,,,2,2,1,3
48546_0,,,,2,2,1,3
48547_0,,,,2,2,1,3
48548_0,,,,2,2,1,3
48549_0,,,,2,2,1,3
48550_0,,,,2,2,1,3
48551_0,,,,2,2,1,3
48552_0,,,,2,2,1,3
48553_0,,,,2,2,1,3
48554_0,,,,2,2,1,3
48555_0,,,,2,2,1,3
48556_0,,,,2,2,1,3
48557_0,,,,2,2,1,3
48558_0,,,,2,2,1,3
48559_0,,,,2,2,1,3
48560_0,,,,2,2,1,3
48561_0,,,,2,2,1,3
48562_0,,,,2,2,1,3
48563_0,,,,2,2,1,3
48564_0,,,,2,2,1,3
48565_0,,,,2,2,1,3
48566_0,,,,2,2,1,3
48566_1,,,,2,2,1,3
48567_0,,,,2,2,1,3
48568_0,,,,2,2,1,3
48568_1,,,,2,2,1,3
48570_0,,,,2,2,1,3
C(C(C(C(CO)(CO)CO)=O)O)=O,,,5,1,1,0,1
48571_0,,,,2,2,1,3
48572_0,,,,2,2,1,3
48572_1,,,,2,2,1,3
48573_0,,,,2,2,1,3
48574_0,,,,2,2,1,3
48574_1,,,,2,2,1,3
48575_0,,,,2,2,1,3
48575_1,,,,2,2,1,3
48576_0,,,,2,2,1,3
48576_1,,,,2,2,1,3
48577_0,,,,2,2,1,3
48578_0,,,,2,2,1,3
48580_0,,,,2,2,1,3
C(C(C=O)(C(C)O)C(C=C)O)(O)=O,,,5,1,1,0,1
48581_0,,,,2,2,1,3
48582_0,,,,2,2,1,3
48583_0,,,,2,2,1,3
48584_0,,,,2,2,1,3
48585_0,,,,2,2,1,3
48586_0,,,,2,2,1,3
48587_0,,,,2,2,1,3
48589_0,,,,2,2,1,3
C(C(C(C)O)(C(C)O)C(C=C)O)=O,,,5,1,1,0,1
48590_0,,,,2,2,1,3
48592_0,,,,2,2,1,3
C(C(C(C)O)(C(C)O)C(C)O)=O,,,5,1,1,0,1
48593_0,,,,2,2,1,3
48594_0,,,,2,2,1,3
48595_0,,,,2,2,1,3
48597_0,,,,2,2,1,3
C(C(CO)(C(C)O)C(C=CC)O)=O,,,5,1,1,0,1
48599_0,,,,2,2,1,3
C(C(CO)(C(CC=C)O)C(C)O)=O,,,5,1,1,0,1
48601_0,,,,2,2,1,3
C(C(CO)(C(C)O)C(C=C)O)=O,,,5,1,1,0,1
48602_0,,,,2,2,1,3
48603_0,,,,2,2,1,3
48604_0,,,,2,2,1,3
48605_0,,,,2,2,1,3
48606_0,,,,2,2,1,3
48607_0,,,,2,2,1,3
48608_0,,,,2,2,1,3
48609_0,,,,2,2,1,3
48610_0,,,,2,2,1,3
48611_0,,,,2,2,1,3
48612_0,,,,2,2,1,3
48613_0,,,,2,2,1,3
48614_0,,,,2,2,1,3
48615_0,,,,2,2,1,3
48616_0,,,,2,2,1,3
48617_0,,,,2,2,1,3
48618_0,,,,2,2,1,3
48618_1,,,,2,2,1,3
48619_0,,,,2,2,1,3
48620_0,,,,2,2,1,3
48621_0,,,,2,2,1,3
48622_0,,,,2,2,1,3
48623_0,,,,2,2,1,3
48624_0,,,,2,2,1,3
48625_0,,,,2,2,1,3
48625_1,,,,2,2,1,3
48626_0,,,,2,2,1,3
48626_1,,,,2,2,1,3
48627_0,,,,2,2,1,3
48627_1,,,,2,2,1,3
48628_0,,,,2,2,1,3
48629_0,,,,2,2,1,3
48629_1,,,,2,2,1,3
48630_0,,,,2,2,1,3
48631_0,,,,2,2,1,3
48632_0,,,,2,2,1,3
48633_0,,,,2,2,1,3
48633_1,,,,2,2,1,3
48635_0,,,,2,2,1,3
C(C(C(CCO)O)(C(C=C)O)O)=O,,,5,1,2,0,2
48635_1,,,,2,2,1,3
48636_0,,,,2,2,1,3
48636_1,,,,2,2,1,3
48637_0,,,,2,2,1,3
48637_1,,,,2,2,1,3
48638_0,,,,2,2,1,3
48638_1,,,,2,2,1,3
48639_0,,,,2,2,1,3
48639_1,,,,2,2,1,3
48640_0,,,,2,2,1,3
48640_1,,,,2,2,1,3
48641_0,,,,2,2,1,3
48642_0,,,,2,2,1,3
48643_0,,,,2,2,1,3
48644_0,,,,2,2,1,3
48645_0,,,,2,2,1,3
48646_0,,,,2,2,1,3
48647_0,,,,2,2,1,3
48648_0,,,,2,2,1,3
48649_0,,,,2,2,1,3
48651_0,,,,2,2,1,3
C(C(C=O)(CO)C(C=CC)O)(O)=O,,,5,1,1,0,1
48653_0,,,,2,2,1,3
C(C(C=O)(CO)C(CC=C)O)(O)=O,,,5,1,1,0,1
48655_0,,,,2,2,1,3
C(C(C=O)(CO)C(C=C)O)(O)=O,,,5,1,1,0,1
48656_0,,,,2,2,1,3
48657_0,,,,2,2,1,3
48658_0,,,,2,2,1,3
48659_0,,,,2,2,1,3
48660_0,,,,2,2,1,3
48661_0,,,,2,2,1,3
48662_0,,,,2,2,1,3
48663_0,,,,2,2,1,3
48664_0,,,,2,2,1,3
48665_0,,,,2,2,1,3
48666_0,,,,2,2,1,3
48667_0,,,,2,2,1,3
48668_0,,,,2,2,1,3
48669_0,,,,2,2,1,3
48670_0,,,,2,2,1,3
48671_0,,,,2,2,1,3
48672_0,,,,2,2,1,3
48673_0,,,,2,2,1,3
48674_0,,,,2,2,1,3
48676_0,,,,2,2,1,3
C(C(C=O)(C(C=O)(CO)CO)O)=O,,,5,1,1,0,1
48678_0,,,,2,2,1,3
C(C(CO)(CO)C(C(C=O)=O)O)=O,,,5,1,2,0,2
48680_0,,,,2,2,1,3
C(C(CO)(CO)C(CC(C)=O)O)=O,,,5,1,1,0,1
48682_0,,,,2,2,1,3
C(C(CO)(CO)C(C)(CC=O)O)=O,,,5,1,1,0,1
48684_0,,,,2,2,1,3
C(C(CO)(CO)C(C=C)(CO)O)=O,,,5,1,1,0,1
48686_0,,,,2,2,1,3
C(C(CO)(CO)C(C=CCO)O)=O,,,5,1,1,0,1
48688_0,,,,2,2,1,3
C(C(CO)(CO)C(C=O)(CC)O)=O,,,5,1,1,0,1
48690_0,,,,2,2,1,3
C(C(CO)(CO)C(C(CC)=O)O)=O,,,5,1,1,0,1
48692_0,,,,2,2,1,3
C(C(CO)(CO)C(CCC=O)O)=O,,,5,1,1,0,1
48694_0,,,,2,2,1,3
C(C(CO)(CO)C(C(C)=O)(C)O)=O,,,5,1,1,0,1
48696_0,,,,2,2,1,3
C(C(CO)(CO)C(C(C=O)=C)O)=O,,,5,1,1,0,1
48698_0,,,,2,2,1,3
C(C(CO)(CO)C(C=CC)O)=O,,,5,1,1,0,1
48700_0,,,,2,2,1,3
C(C(CO)(CO)C(CC=C)O)=O,,,5,1,1,0,1
48702_0,,,,2,2,1,3
C(C(CO)(CO)C(C(C=C)O)O)=O,,,5,1,1,0,1
48704_0,,,,2,2,1,3
C(C(CO)(CO)C(C=C)O)=O,,,5,1,1,0,1
48706_0,,,,2,2,1,3
C(C(CO)(CO)C1(C=COC1)O)=O,,,5,1,1,0,1
48707_0,,,,2,2,1,3
48708_0,,,,2,2,1,3
48709_0,,,,2,2,1,3
48710_0,,,,2,2,1,3
48711_0,,,,2,2,1,3
48712_0,,,,2,2,1,3
48713_0,,,,2,2,1,3
48714_0,,,,2,2,1,3
48715_0,,,,2,2,1,3
48716_0,,,,2,2,1,3
48717_0,,,,2,2,1,3
48718_0,,,,2,2,1,3
48719_0,,,,2,2,1,3
48720_0,,,,2,2,1,3
48721_0,,,,2,2,1,3
48722_0,,,,2,2,1,3
48723_0,,,,2,2,1,3
48724_0,,,,2,2,1,3
48725_0,,,,2,2,1,3
48726_0,,,,2,2,1,3
48727_0,,,,2,2,1,3
48728_0,,,,2,2,1,3
48729_0,,,,2,2,1,3
48730_0,,,,2,2,1,3
48732_0,,,,2,2,1,3
C(C(CO)C(C(CO)CO)O)(O)=O,,,5,1,1,0,1
48733_0,,,,2,2,1,3
48733_1,,,,2,2,1,3
48734_0,,,,2,2,1,3
48734_1,,,,2,2,1,3
48736_0,,,,2,2,1,3
C(C(CO)(C(CO)O)C(C=C)O)=O,,,5,1,1,0,1
48737_0,,,,2,2,1,3
48738_0,,,,2,2,1,3
48739_0,,,,2,2,1,3
48740_0,,,,2,2,1,3
48741_0,,,,2,2,1,3
48742_0,,,,2,2,1,3
48742_1,,,,2,2,1,3
48743_0,,,,2,2,1,3
48744_0,,,,2,2,1,3
48745_0,,,,2,2,1,3
48746_0,,,,2,2,1,3
48747_0,,,,2,2,1,3
48747_1,,,,2,2,1,3
48748_0,,,,2,2,1,3
48748_1,,,,2,2,1,3
48749_0,,,,2,2,1,3
48749_1,,,,2,2,1,3
48751_0,,,,2,2,1,3
C(C(C(C(CO)(C(C)O)O)=O)O)=O,,,5,1,4,0,4
48751_1,,,,2,2,1,3
48752_0,,,,2,2,1,3
48752_1,,,,2,2,1,3
48753_0,,,,2,2,1,3
48753_1,,,,2,2,1,3
48754_0,,,,2,2,1,3
48754_1,,,,2,2,1,3
48755_0,,,,2,2,1,3
48755_1,,,,2,2,1,3
48756_0,,,,2,2,1,3
48756_1,,,,2,2,1,3
48757_0,,,,2,2,1,3
48757_1,,,,2,2,1,3
48758_0,,,,2,2,1,3
48758_1,,,,2,2,1,3
48759_0,,,,2,2,1,3
48759_1,,,,2,2,1,3
48760_0,,,,2,2,1,3
48760_1,,,,2,2,1,3
48761_0,,,,2,2,1,3
48761_1,,,,2,2,1,3
48762_0,,,,2,2,1,3
48762_1,,,,2,2,1,3
48764_0,,,,2,2,1,3
C(C(C(C(C)=O)=O)(C(C)O)O)(O)=O,,,5,1,4,0,4
48764_1,,,,2,2,1,3
48766_0,,,,2,2,1,3
C(C(C(O)=O)(C(C(C)=O)=O)O)(O)=O,,,5,1,2,0,2
48766_1,,,,2,2,1,3
48767_0,,,,2,2,1,3
48767_1,,,,2,2,1,3
48768_0,,,,2,2,1,3
48768_1,,,,2,2,1,3
48770_0,,,,2,2,1,3
C(C(C(C(C(C)=O)=O)(CO)O)O)=O,,,5,1,6,0,6
48770_1,,,,2,2,1,3
48772_0,,,,2,2,1,3
C(C(C)=O)(C(C(C)O)(C(C)O)O)=O,,,5,1,2,0,2
48772_1,,,,2,2,1,3
48773_0,,,,2,2,1,3
48773_1,,,,2,2,1,3
48775_0,,,,2,2,1,3
C(C(C)=O)(C(CO)(C(C)O)O)=O,,,5,1,5,0,5
48775_1,,,,2,2,1,3
48777_0,,,,2,2,1,3
C=CC(C(C(C(C)=O)=O)(CO)O)O,,,5,1,2,0,2
48777_1,,,,2,2,1,3
48778_0,,,,2,2,1,3
48778_1,,,,2,2,1,3
48779_0,,,,2,2,1,3
48779_1,,,,2,2,1,3
48780_0,,,,2,2,1,3
48780_1,,,,2,2,1,3
48781_0,,,,2,2,1,3
48781_1,,,,2,2,1,3
48783_0,,,,2,2,1,3
C(C(C)=O)(C(CO)(C(CO)O)O)=O,,,5,1,7,0,7
48783_1,,,,2,2,1,3
48784_0,,,,2,2,1,3
48784_1,,,,2,2,1,3
48785_0,,,,2,2,1,3
48785_1,,,,2,2,1,3
48786_0,,,,2,2,1,3
48786_1,,,,2,2,1,3
48787_0,,,,2,2,1,3
48787_1,,,,2,2,1,3
48788_0,,,,2,2,1,3
48789_0,,,,2,2,1,3
48789_1,,,,2,2,1,3
48790_0,,,,2,2,1,3
48790_1,,,,2,2,1,3
48791_0,,,,2,2,1,3
48791_1,,,,2,2,1,3
48792_0,,,,2,2,1,3
48792_1,,,,2,2,1,3
48794_0,,,,2,2,1,3
C(C)(C(C(C)O)(C(CO)(C)O)O)=O,,,5,1,4,0,4
48794_1,,,,2,2,1,3
48795_0,,,,2,2,1,3
48795_1,,,,2,2,1,3
48796_0,,,,2,2,1,3
48796_1,,,,2,2,1,3
48797_0,,,,2,2,1,3
48798_0,,,,2,2,1,3
48798_1,,,,2,2,1,3
48799_0,,,,2,2,1,3
48800_0,,,,2,2,1,3
48801_0,,,,2,2,1,3
48802_0,,,,2,2,1,3
48802_1,,,,2,2,1,3
48804_0,,,,2,2,1,3
C(C(C(CO)(C)O)(C(C=C)O)O)=O,,,5,1,2,0,2
48804_1,,,,2,2,1,3
48805_0,,,,2,2,1,3
48805_1,,,,2,2,1,3
48806_0,,,,2,2,1,3
48806_1,,,,2,2,1,3
48807_0,,,,2,2,1,3
48807_1,,,,2,2,1,3
48808_0,,,,2,2,1,3
48808_1,,,,2,2,1,3
48809_0,,,,2,2,1,3
48809_1,,,,2,2,1,3
48810_0,,,,2,2,1,3
48811_0,,,,2,2,1,3
48811_1,,,,2,2,1,3
48812_0,,,,2,2,1,3
48812_1,,,,2,2,1,3
48814_0,,,,2,2,1,3
C(C(C(C(C=C)=O)(CO)O)O)(C)=O,,,5,1,2,0,2
48814_1,,,,2,2,1,3
48815_0,,,,2,2,1,3
48815_1,,,,2,2,1,3
48816_0,,,,2,2,1,3
48816_1,,,,2,2,1,3
48818_0,,,,2,2,1,3
C(C)(C(C(C(O)O)O)(C(C)O)O)=O,,,5,1,4,0,4
48818_1,,,,2,2,1,3
48819_0,,,,2,2,1,3
48819_1,,,,2,2,1,3
48820_0,,,,2,2,1,3
48820_1,,,,2,2,1,3
48822_0,,,,2,2,1,3
C(C)(C(C(C)O)(C(C(C)O)O)O)=O,,,5,1,4,0,4
48822_1,,,,2,2,1,3
48823_0,,,,2,2,1,3
48823_1,,,,2,2,1,3
48824_0,,,,2,2,1,3
48824_1,,,,2,2,1,3
48825_0,,,,2,2,1,3
48825_1,,,,2,2,1,3
48826_0,,,,2,2,1,3
48826_1,,,,2,2,1,3
48828_0,,,,2,2,1,3
C(C(C)(C(C(C)=O)(C(C)O)O)O)=O,,,5,1,5,0,5
48828_1,,,,2,2,1,3
48829_0,,,,2,2,1,3
48829_1,,,,2,2,1,3
48830_0,,,,2,2,1,3
48830_1,,,,2,2,1,3
48831_0,,,,2,2,1,3
48831_1,,,,2,2,1,3
48832_0,,,,2,2,1,3
48832_1,,,,2,2,1,3
48833_0,,,,2,2,1,3
48833_1,,,,2,2,1,3
48835_0,,,,2,2,1,3
C(C)(C(C(C)O)(C(C=CC)O)O)=O,,,5,1,2,0,2
48835_1,,,,2,2,1,3
48837_0,,,,2,2,1,3
C(C)(C(C(CC=C)O)(C(C)O)O)=O,,,5,1,2,0,2
48837_1,,,,2,2,1,3
48839_0,,,,2,2,1,3
C(C)(C(C(C)O)(C(C=C)O)O)=O,,,5,1,2,0,2
48839_1,,,,2,2,1,3
48840_0,,,,2,2,1,3
48840_1,,,,2,2,1,3
48841_0,,,,2,2,1,3
48841_1,,,,2,2,1,3
48842_0,,,,2,2,1,3
48842_1,,,,2,2,1,3
48843_0,,,,2,2,1,3
48843_1,,,,2,2,1,3
48844_0,,,,2,2,1,3
48844_1,,,,2,2,1,3
48846_0,,,,2,2,1,3
C(C)(C(C(C)O)(C(C)O)O)=O,,,5,1,2,0,2
48846_1,,,,2,2,1,3
48847_0,,,,2,2,1,3
48847_1,,,,2,2,1,3
48848_0,,,,2,2,1,3
48848_1,,,,2,2,1,3
48849_0,,,,2,2,1,3
48849_1,,,,2,2,1,3
48850_0,,,,2,2,1,3
48850_1,,,,2,2,1,3
48851_0,,,,2,2,1,3
48851_1,,,,2,2,1,3
48852_0,,,,2,2,1,3
48852_1,,,,2,2,1,3
48853_0,,,,2,2,1,3
48853_1,,,,2,2,1,3
48855_0,,,,2,2,1,3
C(C)(C(C(CO)O)(C(C=C)O)O)=O,,,5,1,2,0,2
48855_1,,,,2,2,1,3
48856_0,,,,2,2,1,3
48856_1,,,,2,2,1,3
48857_0,,,,2,2,1,3
48857_1,,,,2,2,1,3
48858_0,,,,2,2,1,3
48858_1,,,,2,2,1,3
48859_0,,,,2,2,1,3
48859_1,,,,2,2,1,3
48860_0,,,,2,2,1,3
48860_1,,,,2,2,1,3
48861_0,,,,2,2,1,3
48862_0,,,,2,2,1,3
48862_1,,,,2,2,1,3
48863_0,,,,2,2,1,3
48863_1,,,,2,2,1,3
48864_0,,,,2,2,1,3
48864_1,,,,2,2,1,3
48865_0,,,,2,2,1,3
48865_1,,,,2,2,1,3
48867_0,,,,2,2,1,3
C(C(CO)(C(C=C)O)O)(CCO)=O,,,5,1,2,0,2
48867_1,,,,2,2,1,3
48868_0,,,,2,2,1,3
48868_1,,,,2,2,1,3
48869_0,,,,2,2,1,3
48869_1,,,,2,2,1,3
48870_0,,,,2,2,1,3
48870_1,,,,2,2,1,3
48871_0,,,,2,2,1,3
48871_1,,,,2,2,1,3
48872_0,,,,2,2,1,3
48872_1,,,,2,2,1,3
48873_0,,,,2,2,1,3
48873_1,,,,2,2,1,3
48874_0,,,,2,2,1,3
48875_0,,,,2,2,1,3
48876_0,,,,2,2,1,3
48877_0,,,,2,2,1,3
48878_0,,,,2,2,1,3
48879_0,,,,2,2,1,3
48880_0,,,,2,2,1,3
48882_0,,,,2,2,1,3
C(CO)(C(CO)(CO)C(C=C)O)=O,,,5,1,1,0,1
48883_0,,,,2,2,1,3
48884_0,,,,2,2,1,3
48885_0,,,,2,2,1,3
48886_0,,,,2,2,1,3
48887_0,,,,2,2,1,3
48888_0,,,,2,2,1,3
48889_0,,,,2,2,1,3
48889_1,,,,2,2,1,3
48890_0,,,,2,2,1,3
48890_1,,,,2,2,1,3
48891_0,,,,2,2,1,3
48891_1,,,,2,2,1,3
48892_0,,,,2,2,1,3
48892_1,,,,2,2,1,3
48893_0,,,,2,2,1,3
48893_1,,,,2,2,1,3
48894_0,,,,2,2,1,3
48894_1,,,,2,2,1,3
48895_0,,,,2,2,1,3
48896_0,,,,2,2,1,3
48897_0,,,,2,2,1,3
48898_0,,,,2,2,1,3
48900_0,,,,2,2,1,3
C(C(C(CC=O)O)C(C=C)O)(O)=O,,,5,1,1,0,1
48901_0,,,,2,2,1,3
48902_0,,,,2,2,1,3
48903_0,,,,2,2,1,3
48904_0,,,,2,2,1,3
48905_0,,,,2,2,1,3
48906_0,,,,2,2,1,3
48906_1,,,,2,2,1,3
48907_0,,,,2,2,1,3
48907_1,,,,2,2,1,3
48908_0,,,,2,2,1,3
48908_1,,,,2,2,1,3
48909_0,,,,2,2,1,3
48910_0,,,,2,2,1,3
48911_0,,,,2,2,1,3
48913_0,,,,2,2,1,3
C(C(C(O)=O)(C=O)C(C=C)O)(O)=O,,,5,1,1,0,1
48914_0,,,,2,2,1,3
48915_0,,,,2,2,1,3
48917_0,,,,2,2,1,3
C(C(C(O)=O)(C(O)=O)C(O)=O)=O,,,5,1,1,0,1
48918_0,,,,2,2,1,3
48919_0,,,,2,2,1,3
48920_0,,,,2,2,1,3
48921_0,,,,2,2,1,3
48922_0,,,,2,2,1,3
48923_0,,,,2,2,1,3
48924_0,,,,2,2,1,3
48925_0,,,,2,2,1,3
48926_0,,,,2,2,1,3
48927_0,,,,2,2,1,3
48928_0,,,,2,2,1,3
48929_0,,,,2,2,1,3
48930_0,,,,2,2,1,3
48931_0,,,,2,2,1,3
48932_0,,,,2,2,1,3
48933_0,,,,2,2,1,3
48934_0,,,,2,2,1,3
48934_1,,,,2,2,1,3
48935_0,,,,2,2,1,3
48935_1,,,,2,2,1,3
48936_0,,,,2,2,1,3
48936_1,,,,2,2,1,3
48937_0,,,,2,2,1,3
48937_1,,,,2,2,1,3
48938_0,,,,2,2,1,3
48938_1,,,,2,2,1,3
48939_0,,,,2,2,1,3
48939_1,,,,2,2,1,3
48940_0,,,,2,2,1,3
48940_1,,,,2,2,1,3
48941_0,,,,2,2,1,3
48941_1,,,,2,2,1,3
48942_0,,,,2,2,1,3
48942_1,,,,2,2,1,3
48943_0,,,,2,2,1,3
48943_1,,,,2,2,1,3
48944_0,,,,2,2,1,3
48944_1,,,,2,2,1,3
48945_0,,,,2,2,1,3
48945_1,,,,2,2,1,3
48947_0,,,,2,2,1,3
C(C(C=O)(C(C=O)=O)C(C)O)(O)=O,,,5,1,3,0,3
48949_0,,,,2,2,1,3
C(C(C(O)=O)(C(O)=O)C(C=O)=O)=O,,,5,1,1,0,1
48950_0,,,,2,2,1,3
48951_0,,,,2,2,1,3
48953_0,,,,2,2,1,3
C(C(C(C=O)=O)(C(C)O)C(C)O)=O,,,5,1,2,0,2
48954_0,,,,2,2,1,3
48955_0,,,,2,2,1,3
48956_0,,,,2,2,1,3
48957_0,,,,2,2,1,3
48958_0,,,,2,2,1,3
48959_0,,,,2,2,1,3
48960_0,,,,2,2,1,3
48961_0,,,,2,2,1,3
48962_0,,,,2,2,1,3
48963_0,,,,2,2,1,3
48964_0,,,,2,2,1,3
48965_0,,,,2,2,1,3
48966_0,,,,2,2,1,3
48966_1,,,,2,2,1,3
48968_0,,,,2,2,1,3
C(C1(C(C(CO1)O)=O)C(C)O)(O)=O,,,5,1,4,0,4
48968_1,,,,2,2,1,3
48970_0,,,,2,2,1,3
C(C1(C(O)=O)C(C(CO1)O)=O)(O)=O,,,5,1,2,0,2
48970_1,,,,2,2,1,3
48972_0,,,,2,2,1,3
C(C1(C(C(CO1)O)=O)CO)(O)=O,,,5,1,4,0,4
48972_1,,,,2,2,1,3
48973_0,,,,2,2,1,3
48973_1,,,,2,2,1,3
48974_0,,,,2,2,1,3
48974_1,,,,2,2,1,3
48975_0,,,,2,2,1,3
48975_1,,,,2,2,1,3
48976_0,,,,2,2,1,3
48976_1,,,,2,2,1,3
48978_0,,,,2,2,1,3
C1(C(CO)(C(C=O)O)OCC1O)=O,,,5,1,4,0,4
48978_1,,,,2,2,1,3
48979_0,,,,2,2,1,3
48979_1,,,,2,2,1,3
48981_0,,,,2,2,1,3
C1(C(COC1(C(C)O)C(C)O)O)=O,,,5,1,2,0,2
48981_1,,,,2,2,1,3
48982_0,,,,2,2,1,3
48982_1,,,,2,2,1,3
48984_0,,,,2,2,1,3
C1(C(COC1(CO)C(C)O)O)=O,,,5,1,4,0,4
48984_1,,,,2,2,1,3
48985_0,,,,2,2,1,3
48985_1,,,,2,2,1,3
48986_0,,,,2,2,1,3
48986_1,,,,2,2,1,3
48987_0,,,,2,2,1,3
48987_1,,,,2,2,1,3
48989_0,,,,2,2,1,3
C1(C(CO)(C(C=C)O)OCC1O)=O,,,5,1,2,0,2
48989_1,,,,2,2,1,3
48990_0,,,,2,2,1,3
48990_1,,,,2,2,1,3
48991_0,,,,2,2,1,3
48991_1,,,,2,2,1,3
48992_0,,,,2,2,1,3
48992_1,,,,2,2,1,3
48994_0,,,,2,2,1,3
C1(C(COC1(CO)CO)O)=O,,,5,1,2,0,2
48994_1,,,,2,2,1,3
48996_0,,,,2,2,1,3
C1(C(COC1(CO)C(CO)O)O)=O,,,5,1,4,0,4
48996_1,,,,2,2,1,3
48998_0,,,,2,2,1,3
C1(C(COC1CO)(C(C=C)O)O)=O,,,5,1,2,0,2
48998_1,,,,2,2,1,3
48999_0,,,,2,2,1,3
48999_1,,,,2,2,1,3
49000_0,,,,2,2,1,3
49000_1,,,,2,2,1,3
49001_0,,,,2,2,1,3
49001_1,,,,2,2,1,3
49002_0,,,,2,2,1,3
49002_1,,,,2,2,1,3
49003_0,,,,2,2,1,3
49003_1,,,,2,2,1,3
49004_0,,,,2,2,1,3
49004_1,,,,2,2,1,3
49005_0,,,,2,2,1,3
49005_1,,,,2,2,1,3
49006_0,,,,2,2,1,3
49006_1,,,,2,2,1,3
49008_0,,,,2,2,1,3
C(C1(C(C(O)OC1)=O)C(C)O)(O)=O,,,5,1,3,0,3
49010_0,,,,2,2,1,3
C(C1(C(O)=O)C(C(O)OC1)=O)(O)=O,,,5,1,1,0,1
49012_0,,,,2,2,1,3
C(C1(C(C(O)OC1)=O)CO)(O)=O,,,5,1,3,0,3
49014_0,,,,2,2,1,3
C1(C(O)OCC1(CO)C(C=O)O)=O,,,5,1,3,0,3
49016_0,,,,2,2,1,3
C1(C(O)OCC1(C(C)O)C(C)O)=O,,,5,1,2,0,2
49017_0,,,,2,2,1,3
49019_0,,,,2,2,1,3
C1(C(O)OCC1(CO)C(C)O)=O,,,5,1,3,0,3
49021_0,,,,2,2,1,3
C1(C(O)OCC1(CO)C(C=C)O)=O,,,5,1,1,0,1
49022_0,,,,2,2,1,3
49023_0,,,,2,2,1,3
49024_0,,,,2,2,1,3
49026_0,,,,2,2,1,3
C1(C(O)OCC1(CO)CO)=O,,,5,1,2,0,2
49028_0,,,,2,2,1,3
C1(C(O)OCC1(CO)C(CO)O)=O,,,5,1,3,0,3
49029_0,,,,2,2,1,3
49030_0,,,,2,2,1,3
49030_1,,,,2,2,1,3
49032_0,,,,2,2,1,3
C(C1(C(COC1O)=O)C(C)O)(O)=O,,,5,1,3,0,3
49034_0,,,,2,2,1,3
C(C1(C(O)=O)C(COC1O)=O)(O)=O,,,5,1,1,0,1
49036_0,,,,2,2,1,3
C(C1(C(COC1O)=O)CO)(O)=O,,,5,1,3,0,3
49038_0,,,,2,2,1,3
C1(COC(C1(CO)C(C=O)O)O)=O,,,5,1,3,0,3
49040_0,,,,2,2,1,3
C1(COC(C1(C(C)O)C(C)O)O)=O,,,5,1,2,0,2
49041_0,,,,2,2,1,3
49043_0,,,,2,2,1,3
C1(COC(C1(CO)C(C)O)O)=O,,,5,1,3,0,3
49045_0,,,,2,2,1,3
C1(COC(C1(CO)C(C=C)O)O)=O,,,5,1,1,0,1
49046_0,,,,2,2,1,3
49047_0,,,,2,2,1,3
49048_0,,,,2,2,1,3
49050_0,,,,2,2,1,3
C1(COC(C1(CO)CO)O)=O,,,5,1,2,0,2
49052_0,,,,2,2,1,3
C1(COC(C1(CO)C(CO)O)O)=O,,,5,1,3,0,3
49053_0,,,,2,2,1,3
49055_0,,,,2,2,1,3
C(C1(C(CC(O1)O)=O)C(C)O)(O)=O,,,5,1,5,0,5
49055_1,,,,2,2,1,3
49057_0,,,,2,2,1,3
C(C1(C(O)=O)C(CC(O1)O)=O)(O)=O,,,5,1,2,0,2
49057_1,,,,2,2,1,3
49059_0,,,,2,2,1,3
C(C1(C(CC(O1)O)=O)CO)(O)=O,,,5,1,5,0,5
49059_1,,,,2,2,1,3
49060_0,,,,2,2,1,3
49060_1,,,,2,2,1,3
49062_0,,,,2,2,1,3
C1(C(CO)(C(C=O)O)OC(C1)O)=O,,,5,1,5,0,5
49062_1,,,,2,2,1,3
49064_0,,,,2,2,1,3
C1(CC(OC1(C(C)O)C(C)O)O)=O,,,5,1,3,0,3
49064_1,,,,2,2,1,3
49065_0,,,,2,2,1,3
49065_1,,,,2,2,1,3
49067_0,,,,2,2,1,3
C1(CC(OC1(CO)C(C)O)O)=O,,,5,1,5,0,5
49067_1,,,,2,2,1,3
49069_0,,,,2,2,1,3
C1(C(CO)(C(C=C)O)OC(C1)O)=O,,,5,1,2,0,2
49069_1,,,,2,2,1,3
49070_0,,,,2,2,1,3
49070_1,,,,2,2,1,3
49071_0,,,,2,2,1,3
49071_1,,,,2,2,1,3
49072_0,,,,2,2,1,3
49072_1,,,,2,2,1,3
49074_0,,,,2,2,1,3
C1(CC(OC1(CO)CO)O)=O,,,5,1,4,0,4
49074_1,,,,2,2,1,3
49076_0,,,,2,2,1,3
C1(CC(OC1(CO)C(CO)O)O)=O,,,5,1,5,0,5
49076_1,,,,2,2,1,3
49077_0,,,,2,2,1,3
49077_1,,,,2,2,1,3
49078_0,,,,2,2,1,3
49078_1,,,,2,2,1,3
49079_0,,,,2,2,1,3
49080_0,,,,2,2,1,3
49080_1,,,,2,2,1,3
49081_0,,,,2,2,1,3
49081_1,,,,2,2,1,3
49082_0,,,,2,2,1,3
49082_1,,,,2,2,1,3
49083_0,,,,2,2,1,3
49084_0,,,,2,2,1,3
49084_1,,,,2,2,1,3
49085_0,,,,2,2,1,3
49085_1,,,,2,2,1,3
49086_0,,,,2,2,1,3
49086_1,,,,2,2,1,3
49088_0,,,,2,2,1,3
C(C(C(C(C=C)=O)(C(C)O)O)O)=O,,,5,1,2,0,2
49088_1,,,,2,2,1,3
49090_0,,,,2,2,1,3
C(C(C(C=C)=O)(C(C=O)O)O)(O)=O,,,5,1,4,0,4
49090_1,,,,2,2,1,3
49092_0,,,,2,2,1,3
C(C(C(C(C=C)=O)(CO)O)O)=O,,,5,1,3,0,3
49092_1,,,,2,2,1,3
49093_0,,,,2,2,1,3
49094_0,,,,2,2,1,3
49094_1,,,,2,2,1,3
49095_0,,,,2,2,1,3
49095_1,,,,2,2,1,3
49096_0,,,,2,2,1,3
49096_1,,,,2,2,1,3
49098_0,,,,2,2,1,3
C(C(C=O)(C=O)C(C=CC)O)(O)=O,,,5,1,1,0,1
49100_0,,,,2,2,1,3
C(C(C=O)(C=O)C(CC=C)O)(O)=O,,,5,1,1,0,1
49102_0,,,,2,2,1,3
C(C(C=O)(C=O)C(C=C)O)(O)=O,,,5,1,1,0,1
49103_0,,,,2,2,1,3
49104_0,,,,2,2,1,3
49105_0,,,,2,2,1,3
49106_0,,,,2,2,1,3
49107_0,,,,2,2,1,3
49108_0,,,,2,2,1,3
49109_0,,,,2,2,1,3
49110_0,,,,2,2,1,3
49112_0,,,,2,2,1,3
C(C(C=O)(C(O)=O)C(O)=O)=O,,,5,1,1,0,1
49114_0,,,,2,2,1,3
C(C(C=O)(C=O)C(C(O)O)O)(O)=O,,,5,1,2,0,2
49116_0,,,,2,2,1,3
C(C(C=O)(C=O)C(C(C)O)O)(O)=O,,,5,1,2,0,2
49117_0,,,,2,2,1,3
49118_0,,,,2,2,1,3
49119_0,,,,2,2,1,3
49121_0,,,,2,2,1,3
C(C(C(O)=O)(C=O)C(CO)=O)(O)=O,,,5,1,1,0,1
49122_0,,,,2,2,1,3
49123_0,,,,2,2,1,3
49123_1,,,,2,2,1,3
49125_0,,,,2,2,1,3
C(C(C(O)=O)(C(CC=O)=O)O)(O)=O,,,5,1,2,0,2
49125_1,,,,2,2,1,3
49126_0,,,,2,2,1,3
49126_1,,,,2,2,1,3
49127_0,,,,2,2,1,3
49127_1,,,,2,2,1,3
49128_0,,,,2,2,1,3
49128_1,,,,2,2,1,3
49129_0,,,,2,2,1,3
49129_1,,,,2,2,1,3
49131_0,,,,2,2,1,3
C(C(C=O)(C(C=O)(C=O)O)O)(O)=O,,,5,1,4,0,4
49131_1,,,,2,2,1,3
49132_0,,,,2,2,1,3
49132_1,,,,2,2,1,3
49134_0,,,,2,2,1,3
C(C(C=O)(C(CC(C)=O)O)O)(O)=O,,,5,1,2,0,2
49134_1,,,,2,2,1,3
49135_0,,,,2,2,1,3
49135_1,,,,2,2,1,3
49137_0,,,,2,2,1,3
C(C(C=O)(C(C=C)(CO)O)O)(O)=O,,,5,1,2,0,2
49137_1,,,,2,2,1,3
49139_0,,,,2,2,1,3
C(C(C=O)(C(C=CCO)O)O)(O)=O,,,5,1,2,0,2
49139_1,,,,2,2,1,3
49141_0,,,,2,2,1,3
C(C(C=O)(C(C=O)(CC)O)O)(O)=O,,,5,1,2,0,2
49141_1,,,,2,2,1,3
49143_0,,,,2,2,1,3
C(C(C=O)(C(C(CC)=O)O)O)(O)=O,,,5,1,2,0,2
49143_1,,,,2,2,1,3
49145_0,,,,2,2,1,3
C(C(C=O)(C(CCC=O)O)O)(O)=O,,,5,1,3,0,3
49145_1,,,,2,2,1,3
49147_0,,,,2,2,1,3
C(C(C=O)(C(C(C)=O)(C)O)O)(O)=O,,,5,1,2,0,2
49147_1,,,,2,2,1,3
49149_0,,,,2,2,1,3
C(C(C=O)(C(C(C=O)=C)O)O)(O)=O,,,5,1,2,0,2
49149_1,,,,2,2,1,3
49151_0,,,,2,2,1,3
C(C(C=O)(C(C=CC)O)O)(O)=O,,,5,1,2,0,2
49151_1,,,,2,2,1,3
49153_0,,,,2,2,1,3
C(C(C=O)(C(CC=C)O)O)(O)=O,,,5,1,2,0,2
49153_1,,,,2,2,1,3
49155_0,,,,2,2,1,3
C(C(C=O)(C(C(C=C)O)O)O)(O)=O,,,5,1,2,0,2
49155_1,,,,2,2,1,3
49157_0,,,,2,2,1,3
C(C(C=O)(C(C=C)O)O)(O)=O,,,5,1,2,0,2
49157_1,,,,2,2,1,3
49159_0,,,,2,2,1,3
C(C(C=O)(C1(C=COC1)O)O)(O)=O,,,5,1,2,0,2
49159_1,,,,2,2,1,3
49160_0,,,,2,2,1,3
49160_1,,,,2,2,1,3
49161_0,,,,2,2,1,3
49161_1,,,,2,2,1,3
49162_0,,,,2,2,1,3
49162_1,,,,2,2,1,3
49163_0,,,,2,2,1,3
49163_1,,,,2,2,1,3
49164_0,,,,2,2,1,3
49164_1,,,,2,2,1,3
49165_0,,,,2,2,1,3
49165_1,,,,2,2,1,3
49166_0,,,,2,2,1,3
49166_1,,,,2,2,1,3
49167_0,,,,2,2,1,3
49167_1,,,,2,2,1,3
49168_0,,,,2,2,1,3
49168_1,,,,2,2,1,3
49169_0,,,,2,2,1,3
49169_1,,,,2,2,1,3
49170_0,,,,2,2,1,3
49170_1,,,,2,2,1,3
49171_0,,,,2,2,1,3
49171_1,,,,2,2,1,3
49172_0,,,,2,2,1,3
49172_1,,,,2,2,1,3
49173_0,,,,2,2,1,3
49173_1,,,,2,2,1,3
49174_0,,,,2,2,1,3
49174_1,,,,2,2,1,3
49175_0,,,,2,2,1,3
49175_1,,,,2,2,1,3
49176_0,,,,2,2,1,3
49176_1,,,,2,2,1,3
49177_0,,,,2,2,1,3
49177_1,,,,2,2,1,3
49178_0,,,,2,2,1,3
49178_1,,,,2,2,1,3
49179_0,,,,2,2,1,3
49179_1,,,,2,2,1,3
49180_0,,,,2,2,1,3
49180_1,,,,2,2,1,3
49181_0,,,,2,2,1,3
49181_1,,,,2,2,1,3
49182_0,,,,2,2,1,3
49182_1,,,,2,2,1,3
49183_0,,,,2,2,1,3
49183_1,,,,2,2,1,3
49184_0,,,,2,2,1,3
49185_0,,,,2,2,1,3
49185_1,,,,2,2,1,3
49186_0,,,,2,2,1,3
49186_1,,,,2,2,1,3
49187_0,,,,2,2,1,3
49187_1,,,,2,2,1,3
49188_0,,,,2,2,1,3
49189_0,,,,2,2,1,3
49190_0,,,,2,2,1,3
49191_0,,,,2,2,1,3
49191_1,,,,2,2,1,3
49193_0,,,,2,2,1,3
C(C(C(C(O)O)O)(C(C=C)O)O)=O,,,5,1,2,0,2
49193_1,,,,2,2,1,3
49194_0,,,,2,2,1,3
49194_1,,,,2,2,1,3
49195_0,,,,2,2,1,3
49195_1,,,,2,2,1,3
49196_0,,,,2,2,1,3
49196_1,,,,2,2,1,3
49197_0,,,,2,2,1,3
49197_1,,,,2,2,1,3
49198_0,,,,2,2,1,3
49198_1,,,,2,2,1,3
49199_0,,,,2,2,1,3
49199_1,,,,2,2,1,3
49200_0,,,,2,2,1,3
49201_0,,,,2,2,1,3
49202_0,,,,2,2,1,3
49203_0,,,,2,2,1,3
49203_1,,,,2,2,1,3
49205_0,,,,2,2,1,3
C(C(C(C(C)O)O)(C(C=C)O)O)=O,,,5,1,2,0,2
49205_1,,,,2,2,1,3
49206_0,,,,2,2,1,3
49206_1,,,,2,2,1,3
49207_0,,,,2,2,1,3
49207_1,,,,2,2,1,3
49208_0,,,,2,2,1,3
49208_1,,,,2,2,1,3
49209_0,,,,2,2,1,3
49209_1,,,,2,2,1,3
49210_0,,,,2,2,1,3
49210_1,,,,2,2,1,3
49211_0,,,,2,2,1,3
49211_1,,,,2,2,1,3
49213_0,,,,2,2,1,3
C(C(C(O)=O)(C(C(C)O)O)O)(O)=O,,,5,1,4,0,4
49213_1,,,,2,2,1,3
49214_0,,,,2,2,1,3
49214_1,,,,2,2,1,3
49215_0,,,,2,2,1,3
49215_1,,,,2,2,1,3
49216_0,,,,2,2,1,3
49216_1,,,,2,2,1,3
49217_0,,,,2,2,1,3
49217_1,,,,2,2,1,3
49218_0,,,,2,2,1,3
49218_1,,,,2,2,1,3
49219_0,,,,2,2,1,3
49219_1,,,,2,2,1,3
49221_0,,,,2,2,1,3
C(C(C=O)(C(C=O)=O)C(C=CC)O)=O,,,5,1,1,0,1
49223_0,,,,2,2,1,3
C(C(C=O)(C(C=O)=O)C(CC=C)O)=O,,,5,1,1,0,1
49225_0,,,,2,2,1,3
C(C(C=O)(C(C=O)=O)C(C=C)O)=O,,,5,1,1,0,1
49227_0,,,,2,2,1,3
C(C(C=O)(C(C=O)=O)C(C=O)O)=O,,,5,1,2,0,2
49228_0,,,,2,2,1,3
49229_0,,,,2,2,1,3
49230_0,,,,2,2,1,3
49232_0,,,,2,2,1,3
C(C(C=O)(C(C=O)=O)C(CO)O)=O,,,5,1,2,0,2
49234_0,,,,2,2,1,3
C(C(C(C(C=O)=O)(CO)CO)=O)=O,,,5,1,2,0,2
49235_0,,,,2,2,1,3
49237_0,,,,2,2,1,3
C(CC=O)(C(C(C=O)=O)(CO)O)=O,,,5,1,3,0,3
49237_1,,,,2,2,1,3
49239_0,,,,2,2,1,3
C(C(C(CC(C=O)=O)=O)(CO)O)=O,,,5,1,3,0,3
49239_1,,,,2,2,1,3
49241_0,,,,2,2,1,3
C(C(C(C(C=O)=O)(C(C)O)O)=O)=O,,,5,1,3,0,3
49241_1,,,,2,2,1,3
49243_0,,,,2,2,1,3
C(C(C(C=O)=O)(C(C=O)=O)O)(O)=O,,,5,1,3,0,3
49243_1,,,,2,2,1,3
49244_0,,,,2,2,1,3
49244_1,,,,2,2,1,3
49246_0,,,,2,2,1,3
C(C(C(C(CO)=O)=O)(C(C)O)O)=O,,,5,1,3,0,3
49246_1,,,,2,2,1,3
49248_0,,,,2,2,1,3
C(C(C=O)(C(C(CO)=O)=O)O)(O)=O,,,5,1,2,0,2
49248_1,,,,2,2,1,3
49249_0,,,,2,2,1,3
49249_1,,,,2,2,1,3
49251_0,,,,2,2,1,3
C(C(CO)=O)(C(CO)(C(C)O)O)=O,,,5,1,2,0,2
49251_1,,,,2,2,1,3
49252_0,,,,2,2,1,3
49252_1,,,,2,2,1,3
49253_0,,,,2,2,1,3
49253_1,,,,2,2,1,3
49254_0,,,,2,2,1,3
49254_1,,,,2,2,1,3
49256_0,,,,2,2,1,3
C(C)(C(C(C(CO)=O)=O)(CO)O)=O,,,5,1,3,0,3
49256_1,,,,2,2,1,3
49258_0,,,,2,2,1,3
C(C(C(C)O)=O)(C(CO)(CO)O)=O,,,5,1,2,0,2
49258_1,,,,2,2,1,3
49260_0,,,,2,2,1,3
C(C(C(C(C(C)O)=O)=O)(CO)O)=O,,,5,1,2,0,2
49260_1,,,,2,2,1,3
49262_0,,,,2,2,1,3
C(C)(C(C(C(C)=O)=O)(C(C)O)O)=O,,,5,1,2,0,2
49262_1,,,,2,2,1,3
49264_0,,,,2,2,1,3
C(C(C(C)=O)(C(C(C)=O)=O)O)(O)=O,,,5,1,2,0,2
49264_1,,,,2,2,1,3
49265_0,,,,2,2,1,3
49265_1,,,,2,2,1,3
49267_0,,,,2,2,1,3
C(C)(C(C(C=O)=O)(C(C=C)O)O)=O,,,5,1,2,0,2
49267_1,,,,2,2,1,3
49269_0,,,,2,2,1,3
C(C(C(C(C)=O)(C(C=O)=O)O)O)=O,,,5,1,3,0,3
49269_1,,,,2,2,1,3
49270_0,,,,2,2,1,3
49270_1,,,,2,2,1,3
49271_0,,,,2,2,1,3
49271_1,,,,2,2,1,3
49272_0,,,,2,2,1,3
49272_1,,,,2,2,1,3
49274_0,,,,2,2,1,3
C(C)(C(C(C=O)=O)(C(CO)O)O)=O,,,5,1,3,0,3
49274_1,,,,2,2,1,3
49275_0,,,,2,2,1,3
49275_1,,,,2,2,1,3
49277_0,,,,2,2,1,3
C(CO)(C(C(C(C)=O)=O)(CO)O)=O,,,5,1,2,0,2
49277_1,,,,2,2,1,3
49279_0,,,,2,2,1,3
C(C(C(C(C)=O)=O)(C(C=C)O)O)=O,,,5,1,2,0,2
49279_1,,,,2,2,1,3
49281_0,,,,2,2,1,3
C(C(C(C(C)=O)=O)(C(C=O)O)O)=O,,,5,1,2,0,2
49281_1,,,,2,2,1,3
49282_0,,,,2,2,1,3
49282_1,,,,2,2,1,3
49283_0,,,,2,2,1,3
49283_1,,,,2,2,1,3
49284_0,,,,2,2,1,3
49284_1,,,,2,2,1,3
49286_0,,,,2,2,1,3
C(C(C(C(C)=O)=O)(C(CO)O)O)=O,,,5,1,2,0,2
49286_1,,,,2,2,1,3
49287_0,,,,2,2,1,3
49287_1,,,,2,2,1,3
49288_0,,,,2,2,1,3
49288_1,,,,2,2,1,3
49290_0,,,,2,2,1,3
C(C(CO)(CO)O)(CC(C=O)=O)=O,,,5,1,3,0,3
49290_1,,,,2,2,1,3
49291_0,,,,2,2,1,3
49291_1,,,,2,2,1,3
49292_0,,,,2,2,1,3
49292_1,,,,2,2,1,3
49293_0,,,,2,2,1,3
49293_1,,,,2,2,1,3
49295_0,,,,2,2,1,3
C(CO)(C(C(C)=O)(C(C=C)O)O)=O,,,5,1,2,0,2
49295_1,,,,2,2,1,3
49296_0,,,,2,2,1,3
49296_1,,,,2,2,1,3
49297_0,,,,2,2,1,3
49297_1,,,,2,2,1,3
49298_0,,,,2,2,1,3
49298_1,,,,2,2,1,3
49299_0,,,,2,2,1,3
49299_1,,,,2,2,1,3
49300_0,,,,2,2,1,3
49300_1,,,,2,2,1,3
49301_0,,,,2,2,1,3
49303_0,,,,2,2,1,3
C(C(CO)(C(C(C=O)(C)O)O)O)=O,,,5,1,5,0,5
49303_1,,,,2,2,1,3
49305_0,,,,2,2,1,3
C(C(C=O)(C(C(C=O)(C)O)O)O)=O,,,5,1,2,0,2
49305_1,,,,2,2,1,3
49307_0,,,,2,2,1,3
C(C(C=O)(C=O)C(C=O)(C=O)O)=O,,,5,1,1,0,1
49309_0,,,,2,2,1,3
C(C(C=O)(C(C(O)=O)CO)O)=O,,,5,1,1,0,1
49311_0,,,,2,2,1,3
C(C(C=O)(C(C(O)=O)C(C)O)O)=O,,,5,1,1,0,1
49313_0,,,,2,2,1,3
C(C(C(O)=O)C(C=O)(C=O)O)(O)=O,,,5,1,1,0,1
49315_0,,,,2,2,1,3
C(C(C=O)(C)C(C=O)(C=O)O)(O)=O,,,5,1,1,0,1
49317_0,,,,2,2,1,3
C(C(C=O)(C=C)C(C=O)(C=O)O)=O,,,5,1,1,0,1
49318_0,,,,2,2,1,3
49318_1,,,,2,2,1,3
49319_0,,,,2,2,1,3
49319_1,,,,2,2,1,3
49320_0,,,,2,2,1,3
49320_1,,,,2,2,1,3
49322_0,,,,2,2,1,3
C(C(C=O)(CO)C(C=O)(C=O)O)=O,,,5,1,1,0,1
49323_0,,,,2,2,1,3
49323_1,,,,2,2,1,3
49325_0,,,,2,2,1,3
C(C(C=O)(C(C=O)(C=O)O)O)=O,,,5,1,2,0,2
49325_1,,,,2,2,1,3
49326_0,,,,2,2,1,3
49326_1,,,,2,2,1,3
49328_0,,,,2,2,1,3
C(C(C=O)(C1(C(COC1)=O)O)O)=O,,,5,1,2,0,2
49328_1,,,,2,2,1,3
49330_0,,,,2,2,1,3
C(C(C=O)(C1C(OCC1O)=O)O)=O,,,5,1,1,0,1
49332_0,,,,2,2,1,3
C(C(C=O)(C=O)C(C(C=O)=O)O)=O,,,5,1,1,0,1
49333_0,,,,2,2,1,3
49334_0,,,,2,2,1,3
49336_0,,,,2,2,1,3
C(C(C(O)=O)C(C(C=O)=O)O)(O)=O,,,5,1,1,0,1
49338_0,,,,2,2,1,3
C(C(C=O)(C)C(C(C=O)=O)O)(O)=O,,,5,1,1,0,1
49340_0,,,,2,2,1,3
C(C(C=O)(C=C)C(C(C=O)=O)O)=O,,,5,1,1,0,1
49341_0,,,,2,2,1,3
49341_1,,,,2,2,1,3
49342_0,,,,2,2,1,3
49342_1,,,,2,2,1,3
49343_0,,,,2,2,1,3
49343_1,,,,2,2,1,3
49345_0,,,,2,2,1,3
C(C(C=O)(CO)C(C(C=O)=O)O)=O,,,5,1,3,0,3
49346_0,,,,2,2,1,3
49346_1,,,,2,2,1,3
49347_0,,,,2,2,1,3
49347_1,,,,2,2,1,3
49348_0,,,,2,2,1,3
49348_1,,,,2,2,1,3
49350_0,,,,2,2,1,3
C1(COCC1(C(C(C=O)=O)O)O)=O,,,5,1,3,0,3
49350_1,,,,2,2,1,3
49352_0,,,,2,2,1,3
C1(C(C(CO1)O)C(C(C=O)=O)O)=O,,,5,1,2,0,2
49354_0,,,,2,2,1,3
C(C(C=O)(C=O)C(CC(C)=O)O)=O,,,5,1,1,0,1
49356_0,,,,2,2,1,3
C(C(C=O)(C=O)C(C)(CC=O)O)=O,,,5,1,1,0,1
49358_0,,,,2,2,1,3
C(C(C=O)(C=O)C(C=C)(CO)O)=O,,,5,1,1,0,1
49360_0,,,,2,2,1,3
C(C(C=O)(C=O)C(C=CCO)O)=O,,,5,1,1,0,1
49362_0,,,,2,2,1,3
C(C(C=O)(C=O)C(C=O)(CC)O)=O,,,5,1,1,0,1
49364_0,,,,2,2,1,3
C(C(C=O)(C=O)C(C(CC)=O)O)=O,,,5,1,1,0,1
49366_0,,,,2,2,1,3
C(C(C=O)(C=O)C(CCC=O)O)=O,,,5,1,1,0,1
49368_0,,,,2,2,1,3
C(C(C=O)(C=O)C(C(C)=O)(C)O)=O,,,5,1,1,0,1
49370_0,,,,2,2,1,3
C(C(C=O)(C=O)C(C=C(C=O)C)O)=O,,,5,1,1,0,1
49372_0,,,,2,2,1,3
C(C(C=O)(C=O)C(C(C)=CC=O)O)=O,,,5,1,1,0,1
49374_0,,,,2,2,1,3
C(C(C=O)(C=O)C(CC(C=O)=C)O)=O,,,5,1,1,0,1
49376_0,,,,2,2,1,3
C(C(C=O)(C=O)C(C(CC=O)=C)O)=O,,,5,1,1,0,1
49378_0,,,,2,2,1,3
C(C(C=O)(C=O)C(C=CC(C)=O)O)=O,,,5,1,1,0,1
49380_0,,,,2,2,1,3
C(C(C=O)(C=O)C(C=CC=O)(C)O)=O,,,5,1,1,0,1
49382_0,,,,2,2,1,3
C(C(C=O)(C=O)C(C=O)(CC=C)O)=O,,,5,1,1,0,1
49384_0,,,,2,2,1,3
C(C(C=O)(C=O)C(C(CC=C)=O)O)=O,,,5,1,1,0,1
49386_0,,,,2,2,1,3
C(C(C=O)(C=O)C(C=O)(C=CC)O)=O,,,5,1,1,0,1
49388_0,,,,2,2,1,3
C(C(C=O)(C=O)C(C(C=CC)=O)O)=O,,,5,1,1,0,1
49390_0,,,,2,2,1,3
C(C(C=O)(C=O)C(C=CCC=O)O)=O,,,5,1,1,0,1
49392_0,,,,2,2,1,3
C(C(C=O)(C=O)C(CC=CC=O)O)=O,,,5,1,1,0,1
49394_0,,,,2,2,1,3
C(C(C=O)(C=O)C(C(C=O)C=C)O)=O,,,5,1,1,0,1
49396_0,,,,2,2,1,3
C(C(C=O)(C=O)C(C(C=O)=CC)O)=O,,,5,1,1,0,1
49398_0,,,,2,2,1,3
C(C(C=O)(C=O)C(C(C=O)=C)O)=O,,,5,1,1,0,1
49400_0,,,,2,2,1,3
C(C(C=O)(C=O)C(C=CC)O)=O,,,5,1,1,0,1
49402_0,,,,2,2,1,3
C(C(C=O)(C=O)C(CC=C)O)=O,,,5,1,1,0,1
49404_0,,,,2,2,1,3
C(C(C=O)(C=O)C(C(C=C)O)O)=O,,,5,1,1,0,1
49406_0,,,,2,2,1,3
C(C(C=O)(C=O)C(C=C)O)=O,,,5,1,1,0,1
49408_0,,,,2,2,1,3
C(C(C=O)(C=O)C1(C=COC1)O)=O,,,5,1,1,0,1
49410_0,,,,2,2,1,3
C(C(C=O)(C=O)C(C(CO)O)O)=O,,,5,1,1,0,1
49412_0,,,,2,2,1,3
C(C(C=O)(C=O)C(C=O)O)=O,,,5,1,1,0,1
49414_0,,,,2,2,1,3
C(C(C=O)(C=O)C(CO)(CO)O)=O,,,5,1,1,0,1
49416_0,,,,2,2,1,3
C(C(C=O)(C=O)C(C(O)=O)O)=O,,,5,1,1,0,1
49418_0,,,,2,2,1,3
C(C(C=O)(C=O)C(C=O)(C)O)=O,,,5,1,1,0,1
49420_0,,,,2,2,1,3
C(C(C=O)(C=O)C(C(C)=O)O)=O,,,5,1,1,0,1
49422_0,,,,2,2,1,3
C(C(C=O)(C=O)C(CC=O)O)=O,,,5,1,1,0,1
49423_0,,,,2,2,1,3
49425_0,,,,2,2,1,3
C(C(C=O)(C=O)C(C=O)(CO)O)=O,,,5,1,1,0,1
49427_0,,,,2,2,1,3
C(C(C=O)(C=O)C(C(CO)=O)O)=O,,,5,1,1,0,1
49429_0,,,,2,2,1,3
C(C(C=O)(C=O)C(CC(C)O)O)=O,,,5,1,1,0,1
49431_0,,,,2,2,1,3
C(C(C=O)(C=O)C(CCO)O)=O,,,5,1,1,0,1
49433_0,,,,2,2,1,3
C(C(C=O)(C=O)C(C(C=O)O)O)=O,,,5,1,1,0,1
49435_0,,,,2,2,1,3
C(C(C=O)(C=O)C(C)(CO)O)=O,,,5,1,1,0,1
49437_0,,,,2,2,1,3
C(C(C=O)(C=O)C(C(O)=O)(C)O)=O,,,5,1,1,0,1
49439_0,,,,2,2,1,3
C(C(C=O)(C=O)C(CC(O)=O)O)=O,,,5,1,1,0,1
49441_0,,,,2,2,1,3
C(C(C=O)(C=O)C(C=O)(C=C)O)=O,,,5,1,1,0,1
49443_0,,,,2,2,1,3
C(C(C=O)(C=O)C(C(C=C)=O)O)=O,,,5,1,1,0,1
49445_0,,,,2,2,1,3
C(C(C=O)(C=O)C(C=CC=O)O)=O,,,5,1,1,0,1
49446_0,,,,2,2,1,3
49448_0,,,,2,2,1,3
C(C(C=O)(C=O)C(C(O)O)O)=O,,,5,1,1,0,1
49450_0,,,,2,2,1,3
C(C(C=O)(C=O)C(C(C)O)O)=O,,,5,1,1,0,1
49451_0,,,,2,2,1,3
49453_0,,,,2,2,1,3
C(C(C=O)(C=O)C(CO)O)=O,,,5,1,1,0,1
49454_0,,,,2,2,1,3
49456_0,,,,2,2,1,3
C(C(C=O)(C=C)C(C(C=O)C=O)O)=O,,,5,1,1,0,1
49457_0,,,,2,2,1,3
49457_1,,,,2,2,1,3
49459_0,,,,2,2,1,3
C(C(C=O)C(C(C=O)(C=O)O)O)=O,,,5,1,2,0,2
49459_1,,,,2,2,1,3
49461_0,,,,2,2,1,3
C(C(C=O)(C(CO)=O)C(C=C)O)=O,,,5,1,1,0,1
49462_0,,,,2,2,1,3
49463_0,,,,2,2,1,3
49464_0,,,,2,2,1,3
49465_0,,,,2,2,1,3
49466_0,,,,2,2,1,3
49468_0,,,,2,2,1,3
C(C(C(CC=O)=O)(C(C=C)O)O)=O,,,5,1,2,0,2
49468_1,,,,2,2,1,3
49469_0,,,,2,2,1,3
49469_1,,,,2,2,1,3
49471_0,,,,2,2,1,3
C(C(C(CC=O)=O)(C(C)O)O)=O,,,5,1,4,0,4
49471_1,,,,2,2,1,3
49473_0,,,,2,2,1,3
C(C(C=O)(C(CC=O)=O)O)(O)=O,,,5,1,2,0,2
49473_1,,,,2,2,1,3
49475_0,,,,2,2,1,3
C(C(C(CC=O)=O)(CO)O)=O,,,5,1,4,0,4
49475_1,,,,2,2,1,3
49477_0,,,,2,2,1,3
C(C(C(CC=O)=O)(C(CO)O)O)=O,,,5,1,2,0,2
49477_1,,,,2,2,1,3
49479_0,,,,2,2,1,3
C(C(C=O)(C(C)=O)C(C(C=O)=C)O)=O,,,5,1,1,0,1
49481_0,,,,2,2,1,3
C(C(C=O)(C(C)=O)C(C=CC)O)=O,,,5,1,1,0,1
49483_0,,,,2,2,1,3
C(C(C=O)(C(C)=O)C(CC=C)O)=O,,,5,1,1,0,1
49485_0,,,,2,2,1,3
C(C(C=O)(C(C)=O)C(C=C)O)=O,,,5,1,1,0,1
49487_0,,,,2,2,1,3
C(C(C=O)(C(C)=O)C1(C=COC1)O)=O,,,5,1,1,0,1
49489_0,,,,2,2,1,3
C(C(C=O)(C(C)=O)C(C=O)O)=O,,,5,1,2,0,2
49491_0,,,,2,2,1,3
C(C(C=O)(C(C)=O)C(C(O)=O)O)=O,,,5,1,1,0,1
49493_0,,,,2,2,1,3
C(C(C)(C(C=O)(C=O)C(C)=O)O)=O,,,5,1,1,0,1
49495_0,,,,2,2,1,3
C(C(C=O)(C(C)=O)C(C(C)=O)O)=O,,,5,1,1,0,1
49497_0,,,,2,2,1,3
C(CC(C(C=O)(C=O)C(C)=O)O)=O,,,5,1,1,0,1
49499_0,,,,2,2,1,3
C(C(C=O)(C(C)=O)C(C)O)=O,,,5,1,2,0,2
49501_0,,,,2,2,1,3
C(C(C=O)(C(C)=O)C(CCO)O)=O,,,5,1,1,0,1
49503_0,,,,2,2,1,3
C(C(C=O)(C(C)=O)C(C)(CO)O)=O,,,5,1,1,0,1
49505_0,,,,2,2,1,3
C(C(C=O)(C(C)=O)C(C=O)(C=C)O)=O,,,5,1,1,0,1
49507_0,,,,2,2,1,3
C(C(C=O)(C(C)=O)C(C(C=C)=O)O)=O,,,5,1,1,0,1
49509_0,,,,2,2,1,3
C(C(C=O)(C(C)=O)C(C=CC=O)O)=O,,,5,1,1,0,1
49511_0,,,,2,2,1,3
C(C(C=O)(C(O)=O)C(C)=O)=O,,,5,1,2,0,2
49513_0,,,,2,2,1,3
C(C(C=O)(C(C)=O)C(C(O)O)O)=O,,,5,1,1,0,1
49515_0,,,,2,2,1,3
C(C(C=O)(C(C)=O)C(C(C)O)O)=O,,,5,1,1,0,1
49517_0,,,,2,2,1,3
C(C(C=O)(C(C)=O)CO)=O,,,5,1,2,0,2
49519_0,,,,2,2,1,3
C(C(C=O)(C(C)=O)C(CO)O)=O,,,5,1,2,0,2
49521_0,,,,2,2,1,3
C(C(CO)C(CC(C)=O)O)(O)=O,,,5,1,1,0,1
49523_0,,,,2,2,1,3
C(C(C(CC(C)=O)O)C(C)O)(O)=O,,,5,1,1,0,1
49525_0,,,,2,2,1,3
C(C(C(O)=O)C(CC(C)=O)O)(O)=O,,,5,1,1,0,1
49527_0,,,,2,2,1,3
C(C(C=O)(C)C(CC(C)=O)O)(O)=O,,,5,1,1,0,1
49529_0,,,,2,2,1,3
C(C(C=O)(C=C)C(CC(C)=O)O)=O,,,5,1,1,0,1
49531_0,,,,2,2,1,3
C(C(CO)(C(CC(C)=O)O)O)=O,,,5,1,4,0,4
49531_1,,,,2,2,1,3
49533_0,,,,2,2,1,3
C(C(CO)(C(CC(C)=O)O)O)(O)=O,,,5,1,2,0,2
49533_1,,,,2,2,1,3
49535_0,,,,2,2,1,3
C(C(C(C)=O)(C(CC(C)=O)O)O)=O,,,5,1,2,0,2
49535_1,,,,2,2,1,3
49537_0,,,,2,2,1,3
C(C(C=O)(CO)C(CC(C)=O)O)=O,,,5,1,1,0,1
49539_0,,,,2,2,1,3
C(C(C(CC(C)=O)O)(C(C)O)O)=O,,,5,1,2,0,2
49539_1,,,,2,2,1,3
49541_0,,,,2,2,1,3
C(C(C=O)(C(CC(C)=O)O)O)=O,,,5,1,5,0,5
49541_1,,,,2,2,1,3
49543_0,,,,2,2,1,3
C(C)(C(CO)(C(CC(C)=O)O)O)=O,,,5,1,2,0,2
49543_1,,,,2,2,1,3
49545_0,,,,2,2,1,3
C(C)(CC(C1(C(COC1)=O)O)O)=O,,,5,1,2,0,2
49545_1,,,,2,2,1,3
49547_0,,,,2,2,1,3
C1(C(C(CC(C)=O)O)C(CO1)O)=O,,,5,1,1,0,1
49548_0,,,,2,2,1,3
49550_0,,,,2,2,1,3
C(C(C(C)O)C(C)(CC=O)O)(O)=O,,,5,1,1,0,1
49552_0,,,,2,2,1,3
C(C(C(O)=O)C(C)(CC=O)O)(O)=O,,,5,1,1,0,1
49554_0,,,,2,2,1,3
C(C(C=O)(C)C(C)(CC=O)O)(O)=O,,,5,1,1,0,1
49556_0,,,,2,2,1,3
C(C(C=O)(C=C)C(C)(CC=O)O)=O,,,5,1,1,0,1
49557_0,,,,2,2,1,3
49557_1,,,,2,2,1,3
49558_0,,,,2,2,1,3
49558_1,,,,2,2,1,3
49559_0,,,,2,2,1,3
49559_1,,,,2,2,1,3
49561_0,,,,2,2,1,3
C(C(C=O)(CO)C(C)(CC=O)O)=O,,,5,1,1,0,1
49562_0,,,,2,2,1,3
49562_1,,,,2,2,1,3
49563_0,,,,2,2,1,3
49563_1,,,,2,2,1,3
49565_0,,,,2,2,1,3
C(CC(C)(C(C(C)=O)(CO)O)O)=O,,,5,1,2,0,2
49565_1,,,,2,2,1,3
49567_0,,,,2,2,1,3
C(CC(C)(C1(C(COC1)=O)O)O)=O,,,5,1,2,0,2
49567_1,,,,2,2,1,3
49569_0,,,,2,2,1,3
C1(C(C(CO1)O)C(C)(CC=O)O)=O,,,5,1,1,0,1
49570_0,,,,2,2,1,3
49570_1,,,,2,2,1,3
49571_0,,,,2,2,1,3
49571_1,,,,2,2,1,3
49572_0,,,,2,2,1,3
49572_1,,,,2,2,1,3
49574_0,,,,2,2,1,3
C(C(CO)C(CO)(C(C)O)O)(O)=O,,,5,1,1,0,1
49575_0,,,,2,2,1,3
49575_1,,,,2,2,1,3
49576_0,,,,2,2,1,3
49576_1,,,,2,2,1,3
49578_0,,,,2,2,1,3
C(OCC(C)(C(C(O)=O)CO)O)=O,,,5,1,1,0,1
49580_0,,,,2,2,1,3
C(OCC(C)(C(C=O)(CO)O)O)=O,,,5,1,2,0,2
49580_1,,,,2,2,1,3
49582_0,,,,2,2,1,3
C(OCC(C)(C(C=O)(C=O)O)O)=O,,,5,1,2,0,2
49582_1,,,,2,2,1,3
49584_0,,,,2,2,1,3
C(C(COC(C=O)O)(C(C)O)O)=O,,,5,1,2,0,2
49584_1,,,,2,2,1,3
49586_0,,,,2,2,1,3
C(C(C=O)(COC(C=O)O)O)(O)=O,,,5,1,2,0,2
49586_1,,,,2,2,1,3
49587_0,,,,2,2,1,3
49587_1,,,,2,2,1,3
49589_0,,,,2,2,1,3
C(C(C(C(CO)(CO)O)=O)(C)O)=O,,,5,1,2,0,2
49589_1,,,,2,2,1,3
49590_0,,,,2,2,1,3
49590_1,,,,2,2,1,3
49591_0,,,,2,2,1,3
49591_1,,,,2,2,1,3
49592_0,,,,2,2,1,3
49592_1,,,,2,2,1,3
49593_0,,,,2,2,1,3
49593_1,,,,2,2,1,3
49595_0,,,,2,2,1,3
C(C(CO)(C(C=C)O)O)(C(C)O)=O,,,5,1,2,0,2
49595_1,,,,2,2,1,3
49596_0,,,,2,2,1,3
49596_1,,,,2,2,1,3
49598_0,,,,2,2,1,3
C(C(C)O)(C(CO)(C(C)O)O)=O,,,5,1,2,0,2
49598_1,,,,2,2,1,3
49599_0,,,,2,2,1,3
49599_1,,,,2,2,1,3
49600_0,,,,2,2,1,3
49600_1,,,,2,2,1,3
49601_0,,,,2,2,1,3
49601_1,,,,2,2,1,3
49602_0,,,,2,2,1,3
49602_1,,,,2,2,1,3
49604_0,,,,2,2,1,3
C(C(C(C(C=O)(C)O)=O)(CO)O)=O,,,5,1,2,0,2
49604_1,,,,2,2,1,3
49605_0,,,,2,2,1,3
49606_0,,,,2,2,1,3
49607_0,,,,2,2,1,3
49608_0,,,,2,2,1,3
49608_1,,,,2,2,1,3
49609_0,,,,2,2,1,3
49609_1,,,,2,2,1,3
49610_0,,,,2,2,1,3
49610_1,,,,2,2,1,3
49612_0,,,,2,2,1,3
C(C(C)O)(C(C=O)(C(C=C)O)O)=O,,,5,1,2,0,2
49612_1,,,,2,2,1,3
49613_0,,,,2,2,1,3
49613_1,,,,2,2,1,3
49614_0,,,,2,2,1,3
49614_1,,,,2,2,1,3
49615_0,,,,2,2,1,3
49615_1,,,,2,2,1,3
49616_0,,,,2,2,1,3
49616_1,,,,2,2,1,3
49617_0,,,,2,2,1,3
49617_1,,,,2,2,1,3
49619_0,,,,2,2,1,3
C(C(C=O)C(C(CO)(CO)O)=O)=O,,,5,1,2,0,2
49619_1,,,,2,2,1,3
49620_0,,,,2,2,1,3
49621_0,,,,2,2,1,3
49621_1,,,,2,2,1,3
49622_0,,,,2,2,1,3
49622_1,,,,2,2,1,3
49623_0,,,,2,2,1,3
49624_0,,,,2,2,1,3
49625_0,,,,2,2,1,3
49625_1,,,,2,2,1,3
49626_0,,,,2,2,1,3
49626_1,,,,2,2,1,3
49627_0,,,,2,2,1,3
49627_1,,,,2,2,1,3
49628_0,,,,2,2,1,3
49628_1,,,,2,2,1,3
49629_0,,,,2,2,1,3
49629_1,,,,2,2,1,3
49630_0,,,,2,2,1,3
49630_1,,,,2,2,1,3
49631_0,,,,2,2,1,3
49631_1,,,,2,2,1,3
49632_0,,,,2,2,1,3
49632_1,,,,2,2,1,3
49633_0,,,,2,2,1,3
49633_1,,,,2,2,1,3
49634_0,,,,2,2,1,3
49634_1,,,,2,2,1,3
49635_0,,,,2,2,1,3
49636_0,,,,2,2,1,3
49637_0,,,,2,2,1,3
49639_0,,,,2,2,1,3
C1(COC(C1(C(C=CC)O)O)O)=O,,,5,1,2,0,2
49639_1,,,,2,2,1,3
49641_0,,,,2,2,1,3
C1(COC(C1(C(CC=C)O)O)O)=O,,,5,1,2,0,2
49641_1,,,,2,2,1,3
49643_0,,,,2,2,1,3
C1(COC(C1(C(C=C)O)O)O)=O,,,5,1,2,0,2
49643_1,,,,2,2,1,3
49645_0,,,,2,2,1,3
C1(COC(C1(C(C=O)O)O)O)=O,,,5,1,3,0,3
49645_1,,,,2,2,1,3
49647_0,,,,2,2,1,3
C1(COC(C1(C(C(O)=O)O)O)O)=O,,,5,1,3,0,3
49647_1,,,,2,2,1,3
49649_0,,,,2,2,1,3
C(C(C)(C1(C(COC1O)=O)O)O)=O,,,5,1,3,0,3
49649_1,,,,2,2,1,3
49651_0,,,,2,2,1,3
C1(COC(C1(C(C(C)=O)O)O)O)=O,,,5,1,3,0,3
49651_1,,,,2,2,1,3
49653_0,,,,2,2,1,3
C(CC(C1(C(COC1O)=O)O)O)=O,,,5,1,3,0,3
49653_1,,,,2,2,1,3
49655_0,,,,2,2,1,3
C1(COC(C1(C(C)O)O)O)=O,,,5,1,3,0,3
49655_1,,,,2,2,1,3
49657_0,,,,2,2,1,3
C1(COC(C1(C(CCO)O)O)O)=O,,,5,1,3,0,3
49657_1,,,,2,2,1,3
49659_0,,,,2,2,1,3
C1(COC(C1(C(CO)(C)O)O)O)=O,,,5,1,3,0,3
49659_1,,,,2,2,1,3
49661_0,,,,2,2,1,3
C(C1(C(COC1O)=O)O)(O)=O,,,5,1,3,0,3
49661_1,,,,2,2,1,3
49663_0,,,,2,2,1,3
C1(COC(C1(C(C(O)O)O)O)O)=O,,,5,1,3,0,3
49663_1,,,,2,2,1,3
49665_0,,,,2,2,1,3
C1(COC(C1(C(C(C)O)O)O)O)=O,,,5,1,3,0,3
49665_1,,,,2,2,1,3
49666_0,,,,2,2,1,3
49666_1,,,,2,2,1,3
49667_0,,,,2,2,1,3
49667_1,,,,2,2,1,3
49668_0,,,,2,2,1,3
49668_1,,,,2,2,1,3
49669_0,,,,2,2,1,3
49669_1,,,,2,2,1,3
49670_0,,,,2,2,1,3
49670_1,,,,2,2,1,3
49671_0,,,,2,2,1,3
49671_1,,,,2,2,1,3
49673_0,,,,2,2,1,3
C(C(CO)C(C=C)(CO)O)(O)=O,,,5,1,1,0,1
49675_0,,,,2,2,1,3
C(C(CO)C(C=CCO)O)(O)=O,,,5,1,1,0,1
49677_0,,,,2,2,1,3
C(C(C=C)(C(C(O)=O)CO)O)(O)=O,,,5,1,1,0,1
49679_0,,,,2,2,1,3
C(C(CO)C(C=CC(O)=O)O)(O)=O,,,5,1,1,0,1
49681_0,,,,2,2,1,3
C(C(CO)C(C(CO)(O)O)O)(O)=O,,,5,1,1,0,1
49683_0,,,,2,2,1,3
C(C(CO)C(C(C)(CO)O)O)(O)=O,,,5,1,1,0,1
49685_0,,,,2,2,1,3
C(C(CO)C(C=O)(CC)O)(O)=O,,,5,1,1,0,1
49687_0,,,,2,2,1,3
C(C(CO)C(C(CC)=O)O)(O)=O,,,5,1,1,0,1
49689_0,,,,2,2,1,3
C(C(CO)C(CCC=O)O)(O)=O,,,5,1,1,0,1
49691_0,,,,2,2,1,3
C(C(CO)C(C(C)=O)(C)O)(O)=O,,,5,1,1,0,1
49693_0,,,,2,2,1,3
C(C(CO)C(C(O)=O)(CC)O)(O)=O,,,5,1,1,0,1
49695_0,,,,2,2,1,3
C(C(CO)C(C)(CC(O)=O)O)(O)=O,,,5,1,1,0,1
49697_0,,,,2,2,1,3
C(C(CO)C(C(C(O)=O)C)O)(O)=O,,,5,1,1,0,1
49699_0,,,,2,2,1,3
C(C(CO)C1(C(OCC1)=O)O)(O)=O,,,5,1,1,0,1
49701_0,,,,2,2,1,3
C(C(CO)C1(COC(C1)=O)O)(O)=O,,,5,1,1,0,1
49703_0,,,,2,2,1,3
C(C(CO)C(C=C(C=O)C)O)(O)=O,,,5,1,1,0,1
49705_0,,,,2,2,1,3
C(C(CO)C(C(C)=CC=O)O)(O)=O,,,5,1,1,0,1
49707_0,,,,2,2,1,3
C(C(CO)C(CC(C=O)=C)O)(O)=O,,,5,1,1,0,1
49709_0,,,,2,2,1,3
C(C(CO)C(C(CC=O)=C)O)(O)=O,,,5,1,1,0,1
49711_0,,,,2,2,1,3
C(C(CO)C(C=CC(C)=O)O)(O)=O,,,5,1,1,0,1
49713_0,,,,2,2,1,3
C(C(CO)C(C=CC=O)(C)O)(O)=O,,,5,1,1,0,1
49715_0,,,,2,2,1,3
C(C(CO)C(C=O)(CC=C)O)(O)=O,,,5,1,1,0,1
49717_0,,,,2,2,1,3
C(C(CO)C(C(CC=C)=O)O)(O)=O,,,5,1,1,0,1
49719_0,,,,2,2,1,3
C(C(CO)C(C=O)(C=CC)O)(O)=O,,,5,1,1,0,1
49721_0,,,,2,2,1,3
C(C(CO)C(C(C=CC)=O)O)(O)=O,,,5,1,1,0,1
49723_0,,,,2,2,1,3
C(C(CO)C(C=CCC=O)O)(O)=O,,,5,1,1,0,1
49725_0,,,,2,2,1,3
C(C(CO)C(CC=CC=O)O)(O)=O,,,5,1,1,0,1
49726_0,,,,2,2,1,3
49728_0,,,,2,2,1,3
C(C(CO)C(C(C=O)=CC)O)(O)=O,,,5,1,1,0,1
49730_0,,,,2,2,1,3
C(C(CO)C(C(C=O)=C)O)(O)=O,,,5,1,1,0,1
49732_0,,,,2,2,1,3
C(C(CO)C(C=CC)O)(O)=O,,,5,1,1,0,1
49734_0,,,,2,2,1,3
C(C(CO)C(CC=C)O)(O)=O,,,5,1,1,0,1
49736_0,,,,2,2,1,3
C(C(CO)C(C(C=C)O)O)(O)=O,,,5,1,1,0,1
49738_0,,,,2,2,1,3
C(C(CO)C(C=C)O)(O)=O,,,5,1,1,0,1
49740_0,,,,2,2,1,3
C(C(CO)C1(C=COC1)O)(O)=O,,,5,1,1,0,1
49741_0,,,,2,2,1,3
49742_0,,,,2,2,1,3
49743_0,,,,2,2,1,3
49744_0,,,,2,2,1,3
49745_0,,,,2,2,1,3
49746_0,,,,2,2,1,3
49747_0,,,,2,2,1,3
49748_0,,,,2,2,1,3
49749_0,,,,2,2,1,3
49750_0,,,,2,2,1,3
49751_0,,,,2,2,1,3
49752_0,,,,2,2,1,3
49753_0,,,,2,2,1,3
49754_0,,,,2,2,1,3
49755_0,,,,2,2,1,3
49756_0,,,,2,2,1,3
49757_0,,,,2,2,1,3
49758_0,,,,2,2,1,3
49759_0,,,,2,2,1,3
49760_0,,,,2,2,1,3
49761_0,,,,2,2,1,3
49762_0,,,,2,2,1,3
49763_0,,,,2,2,1,3
49764_0,,,,2,2,1,3
49765_0,,,,2,2,1,3
49766_0,,,,2,2,1,3
49767_0,,,,2,2,1,3
49768_0,,,,2,2,1,3
49769_0,,,,2,2,1,3
49770_0,,,,2,2,1,3
49771_0,,,,2,2,1,3
49772_0,,,,2,2,1,3
49773_0,,,,2,2,1,3
49774_0,,,,2,2,1,3
49775_0,,,,2,2,1,3
49776_0,,,,2,2,1,3
49777_0,,,,2,2,1,3
49778_0,,,,2,2,1,3
49779_0,,,,2,2,1,3
49780_0,,,,2,2,1,3
49781_0,,,,2,2,1,3
49782_0,,,,2,2,1,3
49783_0,,,,2,2,1,3
49784_0,,,,2,2,1,3
49785_0,,,,2,2,1,3
49786_0,,,,2,2,1,3
49787_0,,,,2,2,1,3
49788_0,,,,2,2,1,3
49789_0,,,,2,2,1,3
49790_0,,,,2,2,1,3
49791_0,,,,2,2,1,3
49792_0,,,,2,2,1,3
49794_0,,,,2,2,1,3
C(C(C(CO)O)C(C=CC)O)(O)=O,,,5,1,1,0,1
49796_0,,,,2,2,1,3
C(C(C(CC=C)O)C(CO)O)(O)=O,,,5,1,1,0,1
49798_0,,,,2,2,1,3
C(C(C(CO)O)C(C=C)O)(O)=O,,,5,1,1,0,1
49799_0,,,,2,2,1,3
49800_0,,,,2,2,1,3
49801_0,,,,2,2,1,3
49802_0,,,,2,2,1,3
49803_0,,,,2,2,1,3
49804_0,,,,2,2,1,3
49805_0,,,,2,2,1,3
49806_0,,,,2,2,1,3
49807_0,,,,2,2,1,3
49808_0,,,,2,2,1,3
49809_0,,,,2,2,1,3
49810_0,,,,2,2,1,3
49811_0,,,,2,2,1,3
49812_0,,,,2,2,1,3
49812_1,,,,2,2,1,3
49813_0,,,,2,2,1,3
49813_1,,,,2,2,1,3
49814_0,,,,2,2,1,3
49814_1,,,,2,2,1,3
49815_0,,,,2,2,1,3
49815_1,,,,2,2,1,3
49816_0,,,,2,2,1,3
49816_1,,,,2,2,1,3
49817_0,,,,2,2,1,3
49817_1,,,,2,2,1,3
49818_0,,,,2,2,1,3
49818_1,,,,2,2,1,3
49819_0,,,,2,2,1,3
49821_0,,,,2,2,1,3
C(C(C(C)O)C(C=C)(CO)O)(O)=O,,,5,1,1,0,1
49823_0,,,,2,2,1,3
C(C(C(O)=O)C(C=C)(CO)O)(O)=O,,,5,1,1,0,1
49825_0,,,,2,2,1,3
C(C(C=O)(C)C(C=C)(CO)O)(O)=O,,,5,1,1,0,1
49827_0,,,,2,2,1,3
C(C(C=O)(C=C)C(C=C)(CO)O)=O,,,5,1,1,0,1
49828_0,,,,2,2,1,3
49828_1,,,,2,2,1,3
49829_0,,,,2,2,1,3
49829_1,,,,2,2,1,3
49830_0,,,,2,2,1,3
49830_1,,,,2,2,1,3
49831_0,,,,2,2,1,3
49832_0,,,,2,2,1,3
49832_1,,,,2,2,1,3
49833_0,,,,2,2,1,3
49833_1,,,,2,2,1,3
49834_0,,,,2,2,1,3
49834_1,,,,2,2,1,3
49835_0,,,,2,2,1,3
49835_1,,,,2,2,1,3
49836_0,,,,2,2,1,3
49838_0,,,,2,2,1,3
C(C(C(C)O)C(C=CCO)O)(O)=O,,,5,1,1,0,1
49840_0,,,,2,2,1,3
C(C(C(O)=O)C(C=CCO)O)(O)=O,,,5,1,1,0,1
49842_0,,,,2,2,1,3
C(C(C=O)(C)C(C=CCO)O)(O)=O,,,5,1,1,0,1
49844_0,,,,2,2,1,3
C(C(C=O)(C=C)C(C=CCO)O)=O,,,5,1,1,0,1
49845_0,,,,2,2,1,3
49845_1,,,,2,2,1,3
49846_0,,,,2,2,1,3
49846_1,,,,2,2,1,3
49847_0,,,,2,2,1,3
49847_1,,,,2,2,1,3
49848_0,,,,2,2,1,3
49849_0,,,,2,2,1,3
49849_1,,,,2,2,1,3
49850_0,,,,2,2,1,3
49850_1,,,,2,2,1,3
49851_0,,,,2,2,1,3
49851_1,,,,2,2,1,3
49852_0,,,,2,2,1,3
49852_1,,,,2,2,1,3
49853_0,,,,2,2,1,3
49854_0,,,,2,2,1,3
49855_0,,,,2,2,1,3
49856_0,,,,2,2,1,3
49858_0,,,,2,2,1,3
C(C(C)(C(C(O)=O)C(C=C)O)O)=O,,,5,1,1,0,1
49859_0,,,,2,2,1,3
49860_0,,,,2,2,1,3
49861_0,,,,2,2,1,3
49862_0,,,,2,2,1,3
49863_0,,,,2,2,1,3
49865_0,,,,2,2,1,3
C(C(C(C=C)O)C(C(C)=O)O)(O)=O,,,5,1,1,0,1
49866_0,,,,2,2,1,3
49867_0,,,,2,2,1,3
49868_0,,,,2,2,1,3
49869_0,,,,2,2,1,3
49870_0,,,,2,2,1,3
49871_0,,,,2,2,1,3
49872_0,,,,2,2,1,3
49873_0,,,,2,2,1,3
49874_0,,,,2,2,1,3
49875_0,,,,2,2,1,3
49876_0,,,,2,2,1,3
49877_0,,,,2,2,1,3
49878_0,,,,2,2,1,3
49879_0,,,,2,2,1,3
49879_1,,,,2,2,1,3
49881_0,,,,2,2,1,3
C(C(C(C)O)C(C=O)(CC)O)(O)=O,,,5,1,1,0,1
49883_0,,,,2,2,1,3
C(C(C(C)O)C(C(CC)=O)O)(O)=O,,,5,1,1,0,1
49885_0,,,,2,2,1,3
C(C(C(C)O)C(CCC=O)O)(O)=O,,,5,1,1,0,1
49887_0,,,,2,2,1,3
C(C(C(C)O)C(C(C)=O)(C)O)(O)=O,,,5,1,1,0,1
49889_0,,,,2,2,1,3
C(C(C(C)O)C(C(C=O)=C)O)(O)=O,,,5,1,1,0,1
49891_0,,,,2,2,1,3
C(C(C(C)O)C(C=CC)O)(O)=O,,,5,1,1,0,1
49893_0,,,,2,2,1,3
C(C(C(CC=C)O)C(C)O)(O)=O,,,5,1,1,0,1
49895_0,,,,2,2,1,3
C(C(C(C(C=C)O)O)C(C)O)(O)=O,,,5,1,1,0,1
49897_0,,,,2,2,1,3
C(C(C(C)O)C(C=C)O)(O)=O,,,5,1,1,0,1
49899_0,,,,2,2,1,3
C(C(C(C)O)C1(C=COC1)O)(O)=O,,,5,1,1,0,1
49900_0,,,,2,2,1,3
49901_0,,,,2,2,1,3
49902_0,,,,2,2,1,3
49903_0,,,,2,2,1,3
49904_0,,,,2,2,1,3
49905_0,,,,2,2,1,3
49906_0,,,,2,2,1,3
49907_0,,,,2,2,1,3
49908_0,,,,2,2,1,3
49909_0,,,,2,2,1,3
49910_0,,,,2,2,1,3
49911_0,,,,2,2,1,3
49912_0,,,,2,2,1,3
49913_0,,,,2,2,1,3
49914_0,,,,2,2,1,3
49915_0,,,,2,2,1,3
49916_0,,,,2,2,1,3
49917_0,,,,2,2,1,3
49918_0,,,,2,2,1,3
49919_0,,,,2,2,1,3
49920_0,,,,2,2,1,3
49921_0,,,,2,2,1,3
49922_0,,,,2,2,1,3
49923_0,,,,2,2,1,3
49924_0,,,,2,2,1,3
49925_0,,,,2,2,1,3
49926_0,,,,2,2,1,3
49927_0,,,,2,2,1,3
49928_0,,,,2,2,1,3
49929_0,,,,2,2,1,3
49931_0,,,,2,2,1,3
C(C(C(O)=O)C(C=O)(CC)O)(O)=O,,,5,1,1,0,1
49933_0,,,,2,2,1,3
C(C(C(O)=O)C(C(CC)=O)O)(O)=O,,,5,1,1,0,1
49935_0,,,,2,2,1,3
C(C(C(O)=O)C(CCC=O)O)(O)=O,,,5,1,1,0,1
49937_0,,,,2,2,1,3
C(C(C(O)=O)C(C(C)=O)(C)O)(O)=O,,,5,1,1,0,1
49939_0,,,,2,2,1,3
C(C(C(O)=O)C(C(C=O)=C)O)(O)=O,,,5,1,1,0,1
49941_0,,,,2,2,1,3
C(C(C(O)=O)C(C=CC)O)(O)=O,,,5,1,1,0,1
49943_0,,,,2,2,1,3
C(C(C(O)=O)C(CC=C)O)(O)=O,,,5,1,1,0,1
49945_0,,,,2,2,1,3
C(C(C(O)=O)C(C(C=C)O)O)(O)=O,,,5,1,1,0,1
49947_0,,,,2,2,1,3
C(C(C(O)=O)C(C=C)O)(O)=O,,,5,1,1,0,1
49949_0,,,,2,2,1,3
C(C(C(O)=O)C1(C=COC1)O)(O)=O,,,5,1,1,0,1
49950_0,,,,2,2,1,3
49951_0,,,,2,2,1,3
49952_0,,,,2,2,1,3
49953_0,,,,2,2,1,3
49954_0,,,,2,2,1,3
49955_0,,,,2,2,1,3
49956_0,,,,2,2,1,3
49957_0,,,,2,2,1,3
49958_0,,,,2,2,1,3
49959_0,,,,2,2,1,3
49960_0,,,,2,2,1,3
49961_0,,,,2,2,1,3
49962_0,,,,2,2,1,3
49963_0,,,,2,2,1,3
49964_0,,,,2,2,1,3
49965_0,,,,2,2,1,3
49966_0,,,,2,2,1,3
49967_0,,,,2,2,1,3
49968_0,,,,2,2,1,3
49969_0,,,,2,2,1,3
49970_0,,,,2,2,1,3
49971_0,,,,2,2,1,3
49972_0,,,,2,2,1,3
49973_0,,,,2,2,1,3
49974_0,,,,2,2,1,3
49974_1,,,,2,2,1,3
49975_0,,,,2,2,1,3
49976_0,,,,2,2,1,3
49978_0,,,,2,2,1,3
C(C(C=O)(C=C)C(C(O)=O)(C=C)O)=O,,,5,1,1,0,1
49979_0,,,,2,2,1,3
49979_1,,,,2,2,1,3
49980_0,,,,2,2,1,3
49980_1,,,,2,2,1,3
49982_0,,,,2,2,1,3
C(C(C=O)(C=C)C(C=CC(O)=O)O)=O,,,5,1,1,0,1
49983_0,,,,2,2,1,3
49983_1,,,,2,2,1,3
49984_0,,,,2,2,1,3
49984_1,,,,2,2,1,3
49985_0,,,,2,2,1,3
49985_1,,,,2,2,1,3
49986_0,,,,2,2,1,3
49986_1,,,,2,2,1,3
49987_0,,,,2,2,1,3
49987_1,,,,2,2,1,3
49988_0,,,,2,2,1,3
49989_0,,,,2,2,1,3
49989_1,,,,2,2,1,3
49991_0,,,,2,2,1,3
C1(C(C(O)=O)(C(CO1)O)C(C)O)=O,,,5,1,2,0,2
49993_0,,,,2,2,1,3
C1(C(C(O)=O)(C(O)=O)C(CO1)O)=O,,,5,1,1,0,1
49995_0,,,,2,2,1,3
C1(C(C(O)=O)(CO)C(CO1)O)=O,,,5,1,2,0,2
49997_0,,,,2,2,1,3
C1(C(CO)(C(CO1)O)C(C=O)O)=O,,,5,1,2,0,2
49999_0,,,,2,2,1,3
C1(C(C(C)O)(C(C)O)C(CO1)O)=O,,,5,1,1,0,1
50000_0,,,,2,2,1,3
50002_0,,,,2,2,1,3
C1(C(CO)(C(C)O)C(CO1)O)=O,,,5,1,2,0,2
50004_0,,,,2,2,1,3
C1(C(CO)(C(CO1)O)C(C=C)O)=O,,,5,1,1,0,1
50005_0,,,,2,2,1,3
50006_0,,,,2,2,1,3
50007_0,,,,2,2,1,3
50009_0,,,,2,2,1,3
C1(C(CO)(CO)C(CO1)O)=O,,,5,1,1,0,1
50011_0,,,,2,2,1,3
C1(C(CO)(C(CO)O)C(CO1)O)=O,,,5,1,2,0,2
50012_0,,,,2,2,1,3
50013_0,,,,2,2,1,3
50013_1,,,,2,2,1,3
50014_0,,,,2,2,1,3
50015_0,,,,2,2,1,3
50015_1,,,,2,2,1,3
50017_0,,,,2,2,1,3
C(C(CO)(C(C(C=O)(O)O)O)O)=O,,,5,1,3,0,3
50017_1,,,,2,2,1,3
50019_0,,,,2,2,1,3
C(C(CO)(C([C](C(O)=O)O)O)O)=O,,,5,1,4,0,4
50019_1,,,,2,2,1,3
50020_0,,,,2,2,1,3
50021_0,,,,2,2,1,3
50022_0,,,,2,2,1,3
50023_0,,,,2,2,1,3
50024_0,,,,2,2,1,3
50024_1,,,,2,2,1,3
50025_0,,,,2,2,1,3
50025_1,,,,2,2,1,3
50027_0,,,,2,2,1,3
C(C(C(C(C=C)=O)(CO)O)(O)O)=O,,,5,1,2,0,2
50027_1,,,,2,2,1,3
50029_0,,,,2,2,1,3
C(C(C)(C(C(C=C)=O)(CO)O)O)=O,,,5,1,2,0,2
50029_1,,,,2,2,1,3
50031_0,,,,2,2,1,3
C=CC(C([C](C(O)=O)O)(CO)O)=O,,,5,1,2,0,2
50031_1,,,,2,2,1,3
50032_0,,,,2,2,1,3
50032_1,,,,2,2,1,3
50034_0,,,,2,2,1,3
C(C(C(C(C=C)=O)(CO)O)O)(O)=O,,,5,1,2,0,2
50034_1,,,,2,2,1,3
50035_0,,,,2,2,1,3
50035_1,,,,2,2,1,3
50036_0,,,,2,2,1,3
50036_1,,,,2,2,1,3
50038_0,,,,2,2,1,3
C(C1(C(C(CO)(CO1)O)=O)O)(O)=O,,,5,1,3,0,3
50038_1,,,,2,2,1,3
50040_0,,,,2,2,1,3
C1(C(C(C)O)(O)OCC1(CO)O)=O,,,5,1,3,0,3
50040_1,,,,2,2,1,3
50042_0,,,,2,2,1,3
C1(C(CO)(O)OCC1(C(C)O)O)=O,,,5,1,3,0,3
50042_1,,,,2,2,1,3
50044_0,,,,2,2,1,3
C(C1(C(C(CO)(O)OC1)=O)O)(O)=O,,,5,1,3,0,3
50044_1,,,,2,2,1,3
50046_0,,,,2,2,1,3
C1(C(CO)(O)OCC1(CO)O)=O,,,5,1,4,0,4
50046_1,,,,2,2,1,3
50048_0,,,,2,2,1,3
C(C(C(O)=O)(C(C=CC)O)O)(O)=O,,,5,1,2,0,2
50048_1,,,,2,2,1,3
50050_0,,,,2,2,1,3
C(C(C(O)=O)(C(CC=C)O)O)(O)=O,,,5,1,2,0,2
50050_1,,,,2,2,1,3
50052_0,,,,2,2,1,3
C(C(C(O)=O)(C(C=C)O)O)(O)=O,,,5,1,2,0,2
50052_1,,,,2,2,1,3
50053_0,,,,2,2,1,3
50053_1,,,,2,2,1,3
50054_0,,,,2,2,1,3
50054_1,,,,2,2,1,3
50055_0,,,,2,2,1,3
50055_1,,,,2,2,1,3
50056_0,,,,2,2,1,3
50056_1,,,,2,2,1,3
50057_0,,,,2,2,1,3
50057_1,,,,2,2,1,3
50058_0,,,,2,2,1,3
50058_1,,,,2,2,1,3
50059_0,,,,2,2,1,3
50059_1,,,,2,2,1,3
50060_0,,,,2,2,1,3
50060_1,,,,2,2,1,3
50062_0,,,,2,2,1,3
C(C(C(O)=O)(C(O)=O)O)(O)=O,,,5,1,2,0,2
50062_1,,,,2,2,1,3
50064_0,,,,2,2,1,3
C(C(C(O)=O)(C(C(O)O)O)O)(O)=O,,,5,1,4,0,4
50064_1,,,,2,2,1,3
50065_0,,,,2,2,1,3
50065_1,,,,2,2,1,3
50066_0,,,,2,2,1,3
50066_1,,,,2,2,1,3
50067_0,,,,2,2,1,3
50067_1,,,,2,2,1,3
50068_0,,,,2,2,1,3
50068_1,,,,2,2,1,3
50069_0,,,,2,2,1,3
50071_0,,,,2,2,1,3
C(C(C(C=O)(C(C=C)O)O)(O)O)=O,,,5,1,3,0,3
50071_1,,,,2,2,1,3
50072_0,,,,2,2,1,3
50072_1,,,,2,2,1,3
50073_0,,,,2,2,1,3
50073_1,,,,2,2,1,3
50075_0,,,,2,2,1,3
C(C(C=O)(C(C=O)(O)O)O)(O)=O,,,5,1,2,0,2
50075_1,,,,2,2,1,3
50076_0,,,,2,2,1,3
50076_1,,,,2,2,1,3
50077_0,,,,2,2,1,3
50077_1,,,,2,2,1,3
50078_0,,,,2,2,1,3
50078_1,,,,2,2,1,3
50080_0,,,,2,2,1,3
C(C(C(O)=O)(C(C=O)(O)O)O)(O)=O,,,5,1,2,0,2
50080_1,,,,2,2,1,3
50081_0,,,,2,2,1,3
50081_1,,,,2,2,1,3
50083_0,,,,2,2,1,3
C(C)(C(C(C)O)(C(C=O)(O)O)O)=O,,,5,1,3,0,3
50083_1,,,,2,2,1,3
50084_0,,,,2,2,1,3
50084_1,,,,2,2,1,3
50085_0,,,,2,2,1,3
50085_1,,,,2,2,1,3
50086_0,,,,2,2,1,3
50086_1,,,,2,2,1,3
50088_0,,,,2,2,1,3
C(C(CO)(C(C(CO)(O)O)O)O)=O,,,5,1,2,0,2
50088_1,,,,2,2,1,3
50090_0,,,,2,2,1,3
C(C(C=O)(C(C(CO)(O)O)O)O)=O,,,5,1,2,0,2
50090_1,,,,2,2,1,3
50091_0,,,,2,2,1,3
50091_1,,,,2,2,1,3
50092_0,,,,2,2,1,3
50092_1,,,,2,2,1,3
50093_0,,,,2,2,1,3
50093_1,,,,2,2,1,3
50095_0,,,,2,2,1,3
C(C(CO)(C(C(CO)(C)O)O)O)=O,,,5,1,2,0,2
50095_1,,,,2,2,1,3
50097_0,,,,2,2,1,3
C(C(C=O)(C(C(CO)(C)O)O)O)=O,,,5,1,2,0,2
50097_1,,,,2,2,1,3
50099_0,,,,2,2,1,3
C(C([C](C(O)=O)O)(C(C=C)O)O)=O,,,5,1,3,0,3
50099_1,,,,2,2,1,3
50100_0,,,,2,2,1,3
50100_1,,,,2,2,1,3
50101_0,,,,2,2,1,3
50101_1,,,,2,2,1,3
50103_0,,,,2,2,1,3
C(C(C=O)([C](C(O)=O)O)O)(O)=O,,,5,1,3,0,3
50103_1,,,,2,2,1,3
50104_0,,,,2,2,1,3
50104_1,,,,2,2,1,3
50105_0,,,,2,2,1,3
50105_1,,,,2,2,1,3
50106_0,,,,2,2,1,3
50106_1,,,,2,2,1,3
50108_0,,,,2,2,1,3
C(C(C(O)=O)([C](C(O)=O)O)O)(O)=O,,,5,1,2,0,2
50108_1,,,,2,2,1,3
50109_0,,,,2,2,1,3
50109_1,,,,2,2,1,3
50111_0,,,,2,2,1,3
C(C)(C([C](C(O)=O)O)(C(C)O)O)=O,,,5,1,3,0,3
50111_1,,,,2,2,1,3
50112_0,,,,2,2,1,3
50112_1,,,,2,2,1,3
50113_0,,,,2,2,1,3
50113_1,,,,2,2,1,3
50114_0,,,,2,2,1,3
50114_1,,,,2,2,1,3
50116_0,,,,2,2,1,3
C(C(CO)(C(C)O)OC(CO)=O)=O,,,5,1,2,0,2
50116_1,,,,2,2,1,3
50118_0,,,,2,2,1,3
C(C(C=O)(CO)OC(CO)=O)(O)=O,,,5,1,2,0,2
50118_1,,,,2,2,1,3
50120_0,,,,2,2,1,3
C(C(CO)(CO)OC(CO)=O)=O,,,5,1,3,0,3
50120_1,,,,2,2,1,3
50122_0,,,,2,2,1,3
C(C(COC(CO)=O)(C(C)O)O)=O,,,5,1,2,0,2
50122_1,,,,2,2,1,3
50124_0,,,,2,2,1,3
C(C(C=O)(COC(CO)=O)O)(O)=O,,,5,1,2,0,2
50124_1,,,,2,2,1,3
50126_0,,,,2,2,1,3
C(C(CO)(COC(CO)=O)O)=O,,,5,1,3,0,3
50126_1,,,,2,2,1,3
50128_0,,,,2,2,1,3
C(C(C(CCC=O)=O)(C(C)O)O)=O,,,5,1,2,0,2
50128_1,,,,2,2,1,3
50130_0,,,,2,2,1,3
C(C(C=O)(C(CCC=O)=O)O)(O)=O,,,5,1,2,0,2
50130_1,,,,2,2,1,3
50131_0,,,,2,2,1,3
50131_1,,,,2,2,1,3
50133_0,,,,2,2,1,3
C(C(CO)=O)(C(CO)(CO)CO)=O,,,5,1,1,0,1
50135_0,,,,2,2,1,3
C(C(CO)(C(C)O)CC(C=O)=O)=O,,,5,1,2,0,2
50137_0,,,,2,2,1,3
C(C(C=O)(CO)CC(C=O)=O)(O)=O,,,5,1,1,0,1
50139_0,,,,2,2,1,3
C(C(CO)(CO)CC(C=O)=O)=O,,,5,1,2,0,2
50141_0,,,,2,2,1,3
C(C(C=O)(C(C)O)C(C=O)CO)=O,,,5,1,2,0,2
50143_0,,,,2,2,1,3
C(C(C=O)(C=O)C(C=O)CO)(O)=O,,,5,1,1,0,1
50145_0,,,,2,2,1,3
C(C(C=O)(CO)C(C=O)CO)=O,,,5,1,3,0,3
50147_0,,,,2,2,1,3
C(C(C=O)C(C=O)(CO)C(C)O)=O,,,5,1,2,0,2
50149_0,,,,2,2,1,3
C(C(C=O)(CO)C(C=O)C=O)(O)=O,,,5,1,1,0,1
50151_0,,,,2,2,1,3
C(C(C=O)C(C=O)(CO)CO)=O,,,5,1,2,0,2
50153_0,,,,2,2,1,3
C(CC(C=O)(CO)C(C=CC)O)=O,,,5,1,1,0,1
50155_0,,,,2,2,1,3
C(C(CO)(C(CC=C)O)CC=O)=O,,,5,1,1,0,1
50157_0,,,,2,2,1,3
C(CC(C=O)(CO)C(C=C)O)=O,,,5,1,2,0,2
50159_0,,,,2,2,1,3
C(CC(C=O)(CO)C(C=O)O)=O,,,5,1,5,0,5
50161_0,,,,2,2,1,3
C(CC(C=O)(CO)C(C(O)=O)O)=O,,,5,1,4,0,4
50163_0,,,,2,2,1,3
C(C(C)(C(C=O)(CO)CC=O)O)=O,,,5,1,4,0,4
50165_0,,,,2,2,1,3
C(CC(C=O)(CO)C(C(C)=O)O)=O,,,5,1,4,0,4
50167_0,,,,2,2,1,3
C(C(CO)(C(CC=O)O)CC=O)=O,,,5,1,4,0,4
50169_0,,,,2,2,1,3
C(C(CO)(C(C)O)CC=O)=O,,,5,1,4,0,4
50171_0,,,,2,2,1,3
C(C(CO)(C(CCO)O)CC=O)=O,,,5,1,2,0,2
50173_0,,,,2,2,1,3
C(C(CO)(C(C)(CO)O)CC=O)=O,,,5,1,2,0,2
50175_0,,,,2,2,1,3
C(C(C=O)(CO)CC=O)(O)=O,,,5,1,1,0,1
50177_0,,,,2,2,1,3
C(C(CO)(C(C(O)O)O)CC=O)=O,,,5,1,2,0,2
50179_0,,,,2,2,1,3
C(C(CO)(C(C(C)O)O)CC=O)=O,,,5,1,2,0,2
50181_0,,,,2,2,1,3
C(C(CO)(CO)CC=O)=O,,,5,1,2,0,2
50183_0,,,,2,2,1,3
C(C(CO)(C(CO)O)CC=O)=O,,,5,1,4,0,4
50185_0,,,,2,2,1,3
C(C(C(C(CO)(CO)CO)=O)=O)=O,,,5,1,1,0,1
50186_0,,,,2,2,1,3
50188_0,,,,2,2,1,3
C(C(C(C(CO)=O)=O)(C)C(C)O)=O,,,5,1,1,0,1
50190_0,,,,2,2,1,3
C(C(C=O)(C(C(CO)=O)=O)C)(O)=O,,,5,1,1,0,1
50192_0,,,,2,2,1,3
C(C(C(C(CO)=O)=O)(CO)C)=O,,,5,1,1,0,1
50194_0,,,,2,2,1,3
C(C(C(C(CO)=O)=O)(CO)CO)=O,,,5,1,1,0,1
50196_0,,,,2,2,1,3
C(C(C(CO)O)(C(C)O)CC=O)=O,,,5,1,4,0,4
50198_0,,,,2,2,1,3
C(C(C=O)(C(CO)O)CC=O)(O)=O,,,5,1,1,0,1
50199_0,,,,2,2,1,3
50201_0,,,,2,2,1,3
C(CO)(C(CO)(C(C)O)CC=O)=O,,,5,1,1,0,1
50203_0,,,,2,2,1,3
C(CO)(C(C(O)=O)(CO)CC=O)=O,,,5,1,1,0,1
50205_0,,,,2,2,1,3
C(CO)(C(CO)(CO)CC=O)=O,,,5,1,1,0,1
50207_0,,,,2,2,1,3
C(C(CO)(C(C)O)O)(CC(C)=O)=O,,,5,1,2,0,2
50207_1,,,,2,2,1,3
50208_0,,,,2,2,1,3
50208_1,,,,2,2,1,3
50209_0,,,,2,2,1,3
50209_1,,,,2,2,1,3
50211_0,,,,2,2,1,3
C(C(CC)=O)(C(CO)(C(C)O)O)=O,,,5,1,2,0,2
50211_1,,,,2,2,1,3
50213_0,,,,2,2,1,3
C(C(C(C(CC)=O)=O)(CO)O)(O)=O,,,5,1,2,0,2
50213_1,,,,2,2,1,3
50215_0,,,,2,2,1,3
C(C(CC)=O)(C(CO)(CO)O)=O,,,5,1,3,0,3
50215_1,,,,2,2,1,3
50217_0,,,,2,2,1,3
C(CC(C(C(CO)(CO)O)=O)=O)=O,,,5,1,3,0,3
50217_1,,,,2,2,1,3
50219_0,,,,2,2,1,3
C(CC(C(CO)(CO)C(C)O)=O)=O,,,5,1,1,0,1
50221_0,,,,2,2,1,3
C(C(C(CC=O)=O)(CO)CO)(O)=O,,,5,1,2,0,2
50223_0,,,,2,2,1,3
C(CC(C(CO)(CO)CO)=O)=O,,,5,1,1,0,1
50224_0,,,,2,2,1,3
50224_1,,,,2,2,1,3
50226_0,,,,2,2,1,3
C(C(C(C(CC=O)=O)=O)(C)CO)=O,,,5,1,1,0,1
50228_0,,,,2,2,1,3
C(C(C(C(C=O)=O)=O)(C)C(C=C)O)=O,,,5,1,1,0,1
50230_0,,,,2,2,1,3
C(C(C(C(C=O)=O)=O)(C)C(C)O)=O,,,5,1,1,0,1
50232_0,,,,2,2,1,3
C(C(C(O)=O)(C(C(C=O)=O)=O)C)=O,,,5,1,1,0,1
50234_0,,,,2,2,1,3
C(C(C(C(C=O)=O)=O)(C)CO)=O,,,5,1,1,0,1
50236_0,,,,2,2,1,3
C(C(C(C=O)=O)(C)C(C(C=O)=C)O)=O,,,5,1,1,0,1
50238_0,,,,2,2,1,3
C(C(C(C=O)=O)(C)C(C=CC)O)=O,,,5,1,1,0,1
50240_0,,,,2,2,1,3
C(C(C(C=O)=O)(C)C(CC=C)O)=O,,,5,1,1,0,1
50242_0,,,,2,2,1,3
C(C(C(C=O)=O)(C)C(C=C)O)=O,,,5,1,1,0,1
50244_0,,,,2,2,1,3
C(C(C(C=O)=O)(C)C1(C=COC1)O)=O,,,5,1,1,0,1
50246_0,,,,2,2,1,3
C(C(C(C=O)=O)(C)C(C=O)O)=O,,,5,1,1,0,1
50248_0,,,,2,2,1,3
C(C(C(C=O)=O)(C)C(C(O)=O)O)=O,,,5,1,1,0,1
50250_0,,,,2,2,1,3
C(C(C(C=O)=O)(C)C(C=O)(C)O)=O,,,5,1,1,0,1
50252_0,,,,2,2,1,3
C(C(C(C=O)=O)(C)C(C(C)=O)O)=O,,,5,1,1,0,1
50254_0,,,,2,2,1,3
C(C(C(C=O)=O)(C)C(CC=O)O)=O,,,5,1,1,0,1
50256_0,,,,2,2,1,3
C(C(C(C=O)=O)(C)C(C)O)=O,,,5,1,1,0,1
50258_0,,,,2,2,1,3
C(C(C(C=O)=O)(C)C(CCO)O)=O,,,5,1,1,0,1
50260_0,,,,2,2,1,3
C(C(C(C=O)=O)(C)C(C)(CO)O)=O,,,5,1,1,0,1
50262_0,,,,2,2,1,3
C(C(C(C=O)=O)(C)C(C=O)(C=C)O)=O,,,5,1,1,0,1
50264_0,,,,2,2,1,3
C(C(C(C=O)=O)(C)C(C(C=C)=O)O)=O,,,5,1,1,0,1
50266_0,,,,2,2,1,3
C(C(C(C=O)=O)(C)C(C=CC=O)O)=O,,,5,1,1,0,1
50268_0,,,,2,2,1,3
C(C(C(O)=O)(C(C=O)=O)C)=O,,,5,1,1,0,1
50270_0,,,,2,2,1,3
C(C(C(C=O)=O)(C)C(C(O)O)O)=O,,,5,1,1,0,1
50272_0,,,,2,2,1,3
C(C(C(C=O)=O)(C)C(C(C)O)O)=O,,,5,1,1,0,1
50274_0,,,,2,2,1,3
C(C(C(C=O)=O)(C)CO)=O,,,5,1,1,0,1
50276_0,,,,2,2,1,3
C(C(C(C=O)=O)(C)C(CO)O)=O,,,5,1,1,0,1
50278_0,,,,2,2,1,3
C(C(C=O)(CC(C=O)=O)C(C=C)O)=O,,,5,1,1,0,1
50280_0,,,,2,2,1,3
C(C(C=O)(C(C)O)CC(C=O)=O)=O,,,5,1,1,0,1
50282_0,,,,2,2,1,3
C(C(C=O)(C(O)=O)CC(C=O)=O)=O,,,5,1,1,0,1
50284_0,,,,2,2,1,3
C(C(C=O)(CO)CC(C=O)=O)=O,,,5,1,2,0,2
50286_0,,,,2,2,1,3
C(C(C=O)(CO)CC(CC=O)=O)=O,,,5,1,1,0,1
50288_0,,,,2,2,1,3
C(C(C=O)(C(CCC=O)=O)CO)=O,,,5,1,1,0,1
50289_0,,,,2,2,1,3
50291_0,,,,2,2,1,3
C(C(C=O)(CO)CC(C(C)=O)=O)=O,,,5,1,1,0,1
50293_0,,,,2,2,1,3
C(C(C=O)(C(CC(C)=O)=O)CO)=O,,,5,1,1,0,1
50295_0,,,,2,2,1,3
C(C(C=O)(CO)C(C(C=O)=O)C)=O,,,5,1,1,0,1
50297_0,,,,2,2,1,3
C(C(C=O)(C(C=C)O)C(C=O)C=O)=O,,,5,1,1,0,1
50299_0,,,,2,2,1,3
C(C(C=O)(C(C)O)C(C=O)C=O)=O,,,5,1,1,0,1
50301_0,,,,2,2,1,3
C(C(C=O)(C(O)=O)C(C=O)C=O)=O,,,5,1,1,0,1
50303_0,,,,2,2,1,3
C(C(C=O)(CO)C(C=O)C=O)=O,,,5,1,2,0,2
50305_0,,,,2,2,1,3
C(C(C=O)(C(C)O)CC(CO)=O)=O,,,5,1,2,0,2
50307_0,,,,2,2,1,3
C(C(C=O)(C=O)CC(CO)=O)(O)=O,,,5,1,1,0,1
50309_0,,,,2,2,1,3
C(C(C=O)(CO)CC(CO)=O)=O,,,5,1,3,0,3
50311_0,,,,2,2,1,3
C(C(C=O)(C(CCO)=O)C(C)O)=O,,,5,1,1,0,1
50313_0,,,,2,2,1,3
C(C(C=O)(C=O)C(CCO)=O)(O)=O,,,5,1,1,0,1
50315_0,,,,2,2,1,3
C(C(C=O)(C(CCO)=O)CO)=O,,,5,1,2,0,2
50317_0,,,,2,2,1,3
C(C(C=O)(CC=O)C(C(C=O)=C)O)=O,,,5,1,1,0,1
50319_0,,,,2,2,1,3
C(C(C=O)(CC=O)C(C=CC)O)=O,,,5,1,1,0,1
50321_0,,,,2,2,1,3
C(C(C=O)(C(CC=C)O)CC=O)=O,,,5,1,1,0,1
50323_0,,,,2,2,1,3
C(C(C=O)(CC=O)C(C=C)O)=O,,,5,1,2,0,2
50325_0,,,,2,2,1,3
C(C(C=O)(CC=O)C1(C=COC1)O)=O,,,5,1,1,0,1
50327_0,,,,2,2,1,3
C(C(C=O)(CC=O)C(C=O)O)=O,,,5,1,3,0,3
50329_0,,,,2,2,1,3
C(C(C=O)(CC=O)C(C(O)=O)O)=O,,,5,1,2,0,2
50331_0,,,,2,2,1,3
C(C(C)(C(C=O)(C=O)CC=O)O)=O,,,5,1,2,0,2
50333_0,,,,2,2,1,3
C(C(C=O)(CC=O)C(C(C)=O)O)=O,,,5,1,2,0,2
50335_0,,,,2,2,1,3
C(CC(C(C=O)(C=O)CC=O)O)=O,,,5,1,2,0,2
50337_0,,,,2,2,1,3
C(C(C=O)(C(C)O)CC=O)=O,,,5,1,3,0,3
50339_0,,,,2,2,1,3
C(C(C=O)(C(CCO)O)CC=O)=O,,,5,1,2,0,2
50341_0,,,,2,2,1,3
C(C(C=O)(C(C)(CO)O)CC=O)=O,,,5,1,2,0,2
50343_0,,,,2,2,1,3
C(C(C=O)(CC=O)C(C=O)(C=C)O)=O,,,5,1,2,0,2
50345_0,,,,2,2,1,3
C(C(C=O)(CC=O)C(C(C=C)=O)O)=O,,,5,1,2,0,2
50347_0,,,,2,2,1,3
C(C(C=O)(CC=O)C(C=CC=O)O)=O,,,5,1,2,0,2
50349_0,,,,2,2,1,3
C(C(C=O)(C(O)=O)CC=O)=O,,,5,1,2,0,2
50351_0,,,,2,2,1,3
C(C(C=O)(C(C(O)O)O)CC=O)=O,,,5,1,2,0,2
50353_0,,,,2,2,1,3
C(C(C=O)(C(C(C)O)O)CC=O)=O,,,5,1,2,0,2
50355_0,,,,2,2,1,3
C(C(C=O)(CO)CC=O)=O,,,5,1,3,0,3
50357_0,,,,2,2,1,3
C(C(C=O)(C(CO)O)CC=O)=O,,,5,1,3,0,3
50359_0,,,,2,2,1,3
C(C(C(C=O)=O)(CCO)C(C)O)=O,,,5,1,1,0,1
50361_0,,,,2,2,1,3
C(C(C=O)(C(C=O)=O)CCO)(O)=O,,,5,1,1,0,1
50363_0,,,,2,2,1,3
C(C(C(C=O)=O)(CO)CCO)=O,,,5,1,1,0,1
50365_0,,,,2,2,1,3
C(CC(C(C=O)=O)(CO)C(C)O)=O,,,5,1,2,0,2
50367_0,,,,2,2,1,3
C(C(C(C=O)=O)(CO)CC=O)(O)=O,,,5,1,1,0,1
50369_0,,,,2,2,1,3
C(CC(C(C=O)=O)(CO)CO)=O,,,5,1,3,0,3
50371_0,,,,2,2,1,3
C(C)(C(C(C=O)=O)(CO)C(C)O)=O,,,5,1,1,0,1
50373_0,,,,2,2,1,3
C(C(C(C)=O)(C(C=O)=O)CO)(O)=O,,,5,1,1,0,1
50375_0,,,,2,2,1,3
C(C)(C(C(C=O)=O)(CO)CO)=O,,,5,1,2,0,2
50377_0,,,,2,2,1,3
C(CC(C=O)(C(C)O)C(C=O)O)=O,,,5,1,4,0,4
50379_0,,,,2,2,1,3
C(C(C=O)(CC=O)C(C=O)O)(O)=O,,,5,1,1,0,1
50380_0,,,,2,2,1,3
50382_0,,,,2,2,1,3
C(C)(C(C=O)(C(C)O)C(C=O)O)=O,,,5,1,1,0,1
50384_0,,,,2,2,1,3
C(C(C=O)(C(C)=O)C(C=O)O)(O)=O,,,5,1,1,0,1
50386_0,,,,2,2,1,3
C(C)(C(C=O)(CO)C(C=O)O)=O,,,5,1,3,0,3
50388_0,,,,2,2,1,3
C(CO)(C(C=O)(C(C)O)CC=O)=O,,,5,1,2,0,2
50390_0,,,,2,2,1,3
C(C(C=O)(C(CO)=O)CC=O)(O)=O,,,5,1,1,0,1
50392_0,,,,2,2,1,3
C(CO)(C(C=O)(CO)CC=O)=O,,,5,1,3,0,3
50394_0,,,,2,2,1,3
C(C)(C(C=O)(C(CO)=O)C(C)O)=O,,,5,1,1,0,1
50396_0,,,,2,2,1,3
C(C(C=O)(C(C)=O)C(CO)=O)(O)=O,,,5,1,1,0,1
50398_0,,,,2,2,1,3
C(C)(C(C=O)(C(CO)=O)CO)=O,,,5,1,2,0,2
50400_0,,,,2,2,1,3
C(CC=O)(C(C(C)=O)(C(C)O)O)=O,,,5,1,2,0,2
50400_1,,,,2,2,1,3
50402_0,,,,2,2,1,3
C(C(C(CC=O)=O)(C(C)=O)O)(O)=O,,,5,1,2,0,2
50402_1,,,,2,2,1,3
50404_0,,,,2,2,1,3
C(CC=O)(C(C(C)=O)(CO)O)=O,,,5,1,5,0,5
50404_1,,,,2,2,1,3
50406_0,,,,2,2,1,3
C(C(C(CC(C)=O)=O)(C(C)O)O)=O,,,5,1,2,0,2
50406_1,,,,2,2,1,3
50408_0,,,,2,2,1,3
C(C(C=O)(C(CC(C)=O)=O)O)(O)=O,,,5,1,2,0,2
50408_1,,,,2,2,1,3
50409_0,,,,2,2,1,3
50409_1,,,,2,2,1,3
50411_0,,,,2,2,1,3
C(C(C(C(C=O)=O)(C)C(C)O)O)=O,,,5,1,1,0,1
50413_0,,,,2,2,1,3
C(C(C(C=O)=O)(C)C(C=O)O)(O)=O,,,5,1,2,0,2
50415_0,,,,2,2,1,3
C(C(C(C(C=O)=O)(CO)C)O)=O,,,5,1,1,0,1
50417_0,,,,2,2,1,3
C(C(C=O)(C)C(C=O)(CC)O)(O)=O,,,5,1,1,0,1
50419_0,,,,2,2,1,3
C(C(C=O)(C=C)C(C=O)(CC)O)=O,,,5,1,1,0,1
50421_0,,,,2,2,1,3
C(C(CC)(C(C=O)(CO)O)O)=O,,,5,1,2,0,2
50421_1,,,,2,2,1,3
50423_0,,,,2,2,1,3
C(C(CO)(C(C=O)(CC)O)O)(O)=O,,,5,1,2,0,2
50423_1,,,,2,2,1,3
50425_0,,,,2,2,1,3
C(C(CC)(C(C=O)(C(C)=O)O)O)=O,,,5,1,2,0,2
50425_1,,,,2,2,1,3
50427_0,,,,2,2,1,3
C(C(C=O)(CO)C(C=O)(CC)O)=O,,,5,1,1,0,1
50429_0,,,,2,2,1,3
C(C(CC)(C(C=O)(C(C)O)O)O)=O,,,5,1,2,0,2
50429_1,,,,2,2,1,3
50431_0,,,,2,2,1,3
C(C(C=O)(C(C=O)(CC)O)O)=O,,,5,1,2,0,2
50431_1,,,,2,2,1,3
50433_0,,,,2,2,1,3
C(C(CC)(C(C(C)=O)(CO)O)O)=O,,,5,1,2,0,2
50433_1,,,,2,2,1,3
50435_0,,,,2,2,1,3
C(C(CC)(C1(C(COC1)=O)O)O)=O,,,5,1,2,0,2
50435_1,,,,2,2,1,3
50437_0,,,,2,2,1,3
C1(C(C(CO1)O)C(C=O)(CC)O)=O,,,5,1,1,0,1
50439_0,,,,2,2,1,3
C(C(C=O)(C)C(C(CC)=O)O)(O)=O,,,5,1,1,0,1
50441_0,,,,2,2,1,3
C(C(C=O)(C=C)C(C(CC)=O)O)=O,,,5,1,1,0,1
50443_0,,,,2,2,1,3
C(C(CO)(C(C(CC)=O)O)O)=O,,,5,1,3,0,3
50443_1,,,,2,2,1,3
50445_0,,,,2,2,1,3
C(C(CO)(C(C(CC)=O)O)O)(O)=O,,,5,1,2,0,2
50445_1,,,,2,2,1,3
50447_0,,,,2,2,1,3
C(C)(C(C=O)(C(C(CC)=O)O)O)=O,,,5,1,2,0,2
50447_1,,,,2,2,1,3
50449_0,,,,2,2,1,3
C(C(C=O)(CO)C(C(CC)=O)O)=O,,,5,1,1,0,1
50451_0,,,,2,2,1,3
C(C(C(C)O)(C(C(CC)=O)O)O)=O,,,5,1,2,0,2
50451_1,,,,2,2,1,3
50453_0,,,,2,2,1,3
C(C(C=O)(C(C(CC)=O)O)O)=O,,,5,1,3,0,3
50453_1,,,,2,2,1,3
50455_0,,,,2,2,1,3
C(C)(C(CO)(C(C(CC)=O)O)O)=O,,,5,1,2,0,2
50455_1,,,,2,2,1,3
50457_0,,,,2,2,1,3
C1(COCC1(C(C(CC)=O)O)O)=O,,,5,1,2,0,2
50457_1,,,,2,2,1,3
50459_0,,,,2,2,1,3
C1(C(C(CO1)O)C(C(CC)=O)O)=O,,,5,1,1,0,1
50461_0,,,,2,2,1,3
C(CCC=O)(C(CO)(C(C)O)O)=O,,,5,1,2,0,2
50461_1,,,,2,2,1,3
50462_0,,,,2,2,1,3
50462_1,,,,2,2,1,3
50463_0,,,,2,2,1,3
50463_1,,,,2,2,1,3
50465_0,,,,2,2,1,3
C(C(C=O)(C)C(CCC=O)O)(O)=O,,,5,1,1,0,1
50467_0,,,,2,2,1,3
C(C(C=O)(C=C)C(CCC=O)O)=O,,,5,1,1,0,1
50469_0,,,,2,2,1,3
C(C(CO)(C(CCC=O)O)O)=O,,,5,1,4,0,4
50469_1,,,,2,2,1,3
50471_0,,,,2,2,1,3
C(C(CO)(C(CCC=O)O)O)(O)=O,,,5,1,3,0,3
50471_1,,,,2,2,1,3
50473_0,,,,2,2,1,3
C(CCC(C(C=O)(C(C)=O)O)O)=O,,,5,1,3,0,3
50473_1,,,,2,2,1,3
50475_0,,,,2,2,1,3
C(C(C=O)(CO)C(CCC=O)O)=O,,,5,1,2,0,2
50477_0,,,,2,2,1,3
C(C(C(C)O)(C(CCC=O)O)O)=O,,,5,1,3,0,3
50477_1,,,,2,2,1,3
50479_0,,,,2,2,1,3
C(C(C=O)(C(CCC=O)O)O)=O,,,5,1,5,0,5
50479_1,,,,2,2,1,3
50481_0,,,,2,2,1,3
C(CCC(C(C(C)=O)(CO)O)O)=O,,,5,1,3,0,3
50481_1,,,,2,2,1,3
50483_0,,,,2,2,1,3
C(CCC(C1(C(COC1)=O)O)O)=O,,,5,1,3,0,3
50483_1,,,,2,2,1,3
50485_0,,,,2,2,1,3
C1(C(C(CO1)O)C(CCC=O)O)=O,,,5,1,2,0,2
50487_0,,,,2,2,1,3
C(C(C(C(C=O)=O)=O)(CO)CO)=O,,,5,1,1,0,1
50488_0,,,,2,2,1,3
50490_0,,,,2,2,1,3
C(C(C=O)(C)C(C(C)=O)(C)O)(O)=O,,,5,1,1,0,1
50492_0,,,,2,2,1,3
C(C(C=O)(C=C)C(C(C)=O)(C)O)=O,,,5,1,1,0,1
50494_0,,,,2,2,1,3
C(C(CO)(C(C(C)=O)(C)O)O)=O,,,5,1,3,0,3
50494_1,,,,2,2,1,3
50496_0,,,,2,2,1,3
C(C(CO)(C(C(C)=O)(C)O)O)(O)=O,,,5,1,2,0,2
50496_1,,,,2,2,1,3
50498_0,,,,2,2,1,3
C(C(C(C)=O)(C(C(C)=O)(C)O)O)=O,,,5,1,2,0,2
50498_1,,,,2,2,1,3
50500_0,,,,2,2,1,3
C(C(C=O)(CO)C(C(C)=O)(C)O)=O,,,5,1,1,0,1
50502_0,,,,2,2,1,3
C(C(C(C)O)(C(C(C)=O)(C)O)O)=O,,,5,1,2,0,2
50502_1,,,,2,2,1,3
50504_0,,,,2,2,1,3
C(C(C=O)(C(C(C)=O)(C)O)O)=O,,,5,1,3,0,3
50504_1,,,,2,2,1,3
50506_0,,,,2,2,1,3
C(C)(C(CO)(C(C(C)=O)(C)O)O)=O,,,5,1,2,0,2
50506_1,,,,2,2,1,3
50508_0,,,,2,2,1,3
C(C)(C(C)(C1(C(COC1)=O)O)O)=O,,,5,1,2,0,2
50508_1,,,,2,2,1,3
50510_0,,,,2,2,1,3
C1(C(C(CO1)O)C(C(C)=O)(C)O)=O,,,5,1,1,0,1
50512_0,,,,2,2,1,3
C(C)(C(C(CO)=O)(CO)C(C)O)=O,,,5,1,1,0,1
50514_0,,,,2,2,1,3
C(C)(C(C(O)=O)(C(CO)=O)CO)=O,,,5,1,1,0,1
50516_0,,,,2,2,1,3
C(C)(C(C(CO)=O)(CO)CO)=O,,,5,1,1,0,1
50518_0,,,,2,2,1,3
C(CO)(C(C(CO)=O)(CO)CO)=O,,,5,1,1,0,1
50520_0,,,,2,2,1,3
C(C(C(C(C)=O)=O)(CO)CO)(O)=O,,,5,1,1,0,1
50521_0,,,,2,2,1,3
50523_0,,,,2,2,1,3
C(C)(C(C(O)=O)(CO)C(C=C)O)=O,,,5,1,1,0,1
50525_0,,,,2,2,1,3
C(C)(C(C(O)=O)(CO)C(C=O)O)=O,,,5,1,2,0,2
50527_0,,,,2,2,1,3
C(C(C(C)=O)(CO)C(C)O)(O)=O,,,5,1,1,0,1
50529_0,,,,2,2,1,3
C(C(C(O)=O)(C(C)=O)CO)(O)=O,,,5,1,1,0,1
50531_0,,,,2,2,1,3
C(C(C(C)=O)(CO)CO)(O)=O,,,5,1,1,0,1
50533_0,,,,2,2,1,3
C(C(C(C)=O)(CO)C(CO)O)(O)=O,,,5,1,2,0,2
50534_0,,,,2,2,1,3
50536_0,,,,2,2,1,3
C(C(C(C)=O)(C(C(O)=O)=O)CO)=O,,,5,1,1,0,1
50538_0,,,,2,2,1,3
C(C)(C(C=O)(CO)C(C(O)=O)O)=O,,,5,1,2,0,2
50539_0,,,,2,2,1,3
50541_0,,,,2,2,1,3
C(C(C(C)=O)(C(C(C)=O)=O)CO)=O,,,5,1,1,0,1
50543_0,,,,2,2,1,3
C(C(C(C(C)=O)=O)(CO)C(C)O)=O,,,5,1,1,0,1
50545_0,,,,2,2,1,3
C(C(C=O)(C(C(C)=O)=O)CO)(O)=O,,,5,1,1,0,1
50547_0,,,,2,2,1,3
C(C(C(C(C)=O)=O)(CO)CO)=O,,,5,1,2,0,2
50549_0,,,,2,2,1,3
C(C(C(CC=O)=O)(C(C)=O)CO)=O,,,5,1,1,0,1
50551_0,,,,2,2,1,3
C(C(C(CC=O)=O)(CO)C(C)O)=O,,,5,1,1,0,1
50553_0,,,,2,2,1,3
C(C(C=O)(C(CC=O)=O)CO)(O)=O,,,5,1,1,0,1
50555_0,,,,2,2,1,3
C(C(C(CC=O)=O)(CO)CO)=O,,,5,1,2,0,2
50557_0,,,,2,2,1,3
C(C(C(C)=O)(C(C)=O)C(C=CC)O)=O,,,5,1,1,0,1
50559_0,,,,2,2,1,3
C(C(C(C)=O)(C(C)=O)C(CC=C)O)=O,,,5,1,1,0,1
50561_0,,,,2,2,1,3
C(C(C(C)=O)(C(C)=O)C(C=C)O)=O,,,5,1,1,0,1
50563_0,,,,2,2,1,3
C(C(C(C)=O)(C(C)=O)C(C=O)O)=O,,,5,1,1,0,1
50565_0,,,,2,2,1,3
C(C(C(C)=O)(C(C)=O)C(C)O)=O,,,5,1,1,0,1
50567_0,,,,2,2,1,3
C(C(C(O)=O)(C(C)=O)C(C)=O)=O,,,5,1,1,0,1
50569_0,,,,2,2,1,3
C(C(C(C)=O)(C(C)=O)CO)=O,,,5,1,1,0,1
50571_0,,,,2,2,1,3
C(C(C(C)=O)(C(C)=O)C(CO)O)=O,,,5,1,1,0,1
50573_0,,,,2,2,1,3
C(C(C(C)=O)(C(C=O)=O)C(C=C)O)=O,,,5,1,1,0,1
50575_0,,,,2,2,1,3
C(C(C(C)=O)(C(C=O)=O)C(C)O)=O,,,5,1,1,0,1
50577_0,,,,2,2,1,3
C(C(C(O)=O)(C(C)=O)C(C=O)=O)=O,,,5,1,1,0,1
50579_0,,,,2,2,1,3
C(C(C(C)=O)(C(C=O)=O)CO)=O,,,5,1,2,0,2
50581_0,,,,2,2,1,3
C(C)(C(C=O)(CO)C(C=CC)O)=O,,,5,1,1,0,1
50583_0,,,,2,2,1,3
C(C(C(C)=O)(CO)C(CC=C)O)=O,,,5,1,1,0,1
50585_0,,,,2,2,1,3
C(C)(C(C=O)(CO)C(C=C)O)=O,,,5,1,1,0,1
50586_0,,,,2,2,1,3
50587_0,,,,2,2,1,3
50589_0,,,,2,2,1,3
C(C(C)(C(C=O)(C(C)=O)CO)O)=O,,,5,1,1,0,1
50591_0,,,,2,2,1,3
C(C)(C(C=O)(CO)C(C(C)=O)O)=O,,,5,1,1,0,1
50593_0,,,,2,2,1,3
C(CC(C(C=O)(C(C)=O)CO)O)=O,,,5,1,1,0,1
50595_0,,,,2,2,1,3
C(C(C(C)=O)(CO)C(C)O)=O,,,5,1,1,0,1
50597_0,,,,2,2,1,3
C(C(C(C)=O)(CO)C(CCO)O)=O,,,5,1,1,0,1
50599_0,,,,2,2,1,3
C(C(C(C)=O)(CO)C(C)(CO)O)=O,,,5,1,1,0,1
50601_0,,,,2,2,1,3
C(C(C=O)(C(C)=O)CO)(O)=O,,,5,1,1,0,1
50603_0,,,,2,2,1,3
C(C(C(C)=O)(CO)C(C(O)O)O)=O,,,5,1,1,0,1
50605_0,,,,2,2,1,3
C(C(C(C)=O)(CO)C(C(C)O)O)=O,,,5,1,1,0,1
50607_0,,,,2,2,1,3
C(C(C(C)=O)(CO)CO)=O,,,5,1,1,0,1
50609_0,,,,2,2,1,3
C(C(C(C)=O)(CO)C(CO)O)=O,,,5,1,2,0,2
50611_0,,,,2,2,1,3
C(C(C(C)=O)(C(CO)O)C(C)O)=O,,,5,1,1,0,1
50613_0,,,,2,2,1,3
C(C(C=O)(C(C)=O)C(CO)O)(O)=O,,,5,1,1,0,1
50614_0,,,,2,2,1,3
50616_0,,,,2,2,1,3
C(C(C(C(O)=O)=O)(CO)CC=O)=O,,,5,1,1,0,1
50618_0,,,,2,2,1,3
C(C(C(C(O)=O)=O)(C)C(C)O)(O)=O,,,5,1,1,0,1
50620_0,,,,2,2,1,3
C(C(C(O)=O)(C(C(O)=O)=O)C)(O)=O,,,5,1,1,0,1
50622_0,,,,2,2,1,3
C(C(C(C(O)=O)=O)(C)CO)(O)=O,,,5,1,1,0,1
50624_0,,,,2,2,1,3
C(C(C(C(O)=O)=O)(C)C(C=C)O)=O,,,5,1,1,0,1
50626_0,,,,2,2,1,3
C(C(C(C(O)=O)=O)(C)C(C=O)O)=O,,,5,1,1,0,1
50628_0,,,,2,2,1,3
C(C(C(C(O)=O)=O)(C)C(C)O)=O,,,5,1,1,0,1
50630_0,,,,2,2,1,3
C(C(C(O)=O)(C(C(O)=O)=O)C)=O,,,5,1,1,0,1
50632_0,,,,2,2,1,3
C(C(C(C(O)=O)=O)(C)CO)=O,,,5,1,1,0,1
50634_0,,,,2,2,1,3
C(C(C(C(O)=O)=O)(C)C(CO)O)=O,,,5,1,1,0,1
50636_0,,,,2,2,1,3
C(C(C(C(C)=O)=O)(CO)CC=O)=O,,,5,1,1,0,1
50638_0,,,,2,2,1,3
C(C(C(C(C)=O)=O)(C)C(C)O)(O)=O,,,5,1,1,0,1
50640_0,,,,2,2,1,3
C(C(C(O)=O)(C(C(C)=O)=O)C)(O)=O,,,5,1,1,0,1
50642_0,,,,2,2,1,3
C(C(C(C(C)=O)=O)(C)CO)(O)=O,,,5,1,1,0,1
50644_0,,,,2,2,1,3
C(C(C(CC=O)=O)(CO)CC=O)=O,,,5,1,1,0,1
50646_0,,,,2,2,1,3
C(C(C(CC=O)=O)(C)C(C)O)(O)=O,,,5,1,1,0,1
50648_0,,,,2,2,1,3
C(CC(C(C(O)=O)(C(O)=O)C)=O)=O,,,5,1,1,0,1
50650_0,,,,2,2,1,3
C(C(C(CC=O)=O)(C)CO)(O)=O,,,5,1,1,0,1
50652_0,,,,2,2,1,3
C(C(C(C(O)=O)=O)(CO)CCO)=O,,,5,1,1,0,1
50654_0,,,,2,2,1,3
C(C(C(C)=O)(CC=O)C(C=CC)O)=O,,,5,1,1,0,1
50656_0,,,,2,2,1,3
C(C)(C(C=O)(C(CC=C)O)CC=O)=O,,,5,1,1,0,1
50658_0,,,,2,2,1,3
C(C(C(C)=O)(CC=O)C(C=C)O)=O,,,5,1,1,0,1
50660_0,,,,2,2,1,3
C(C(C(C)=O)(CC=O)C(C=O)O)=O,,,5,1,1,0,1
50662_0,,,,2,2,1,3
C(C)(C(C=O)(C(C)O)CC=O)=O,,,5,1,1,0,1
50664_0,,,,2,2,1,3
C(C(C(O)=O)(C(C)=O)CC=O)=O,,,5,1,1,0,1
50666_0,,,,2,2,1,3
C(C)(C(C=O)(CO)CC=O)=O,,,5,1,1,0,1
50668_0,,,,2,2,1,3
C(C)(C(C=O)(C(CO)O)CC=O)=O,,,5,1,1,0,1
50670_0,,,,2,2,1,3
C(C(C(C=O)=O)(CC=O)C(C=C)O)=O,,,5,1,1,0,1
50672_0,,,,2,2,1,3
C(C(C(C=O)=O)(C(C)O)CC=O)=O,,,5,1,1,0,1
50674_0,,,,2,2,1,3
C(C(C(O)=O)(C(C=O)=O)CC=O)=O,,,5,1,1,0,1
50676_0,,,,2,2,1,3
C(C(C(C=O)=O)(CO)CC=O)=O,,,5,1,2,0,2
50678_0,,,,2,2,1,3
C(CC(C(C(O)=O)=O)(CO)CO)=O,,,5,1,1,0,1
50679_0,,,,2,2,1,3
50681_0,,,,2,2,1,3
C(CC(O)=O)(C(C(C)=O)(CO)O)=O,,,5,1,2,0,2
50681_1,,,,2,2,1,3
50682_0,,,,2,2,1,3
50682_1,,,,2,2,1,3
50684_0,,,,2,2,1,3
C(C(C(C(C(O)=O)=O)(CO)C)O)=O,,,5,1,1,0,1
50686_0,,,,2,2,1,3
C(C(C(C(C=O)=O)(CO)C)O)(O)=O,,,5,1,1,0,1
50688_0,,,,2,2,1,3
C(C)(C(C(O)=O)(C)C(C=CC)O)=O,,,5,1,1,0,1
50690_0,,,,2,2,1,3
C(C(C(C)=O)(C)C(CC=C)O)(O)=O,,,5,1,1,0,1
50692_0,,,,2,2,1,3
C(C)(C(C(O)=O)(C)C(C=C)O)=O,,,5,1,1,0,1
50694_0,,,,2,2,1,3
C(C)(C(C(O)=O)(C)C(C=O)O)=O,,,5,1,1,0,1
50696_0,,,,2,2,1,3
C(C)(C(C(O)=O)(C)C(C(O)=O)O)=O,,,5,1,1,0,1
50698_0,,,,2,2,1,3
C(C(C)(C(C(O)=O)(C(C)=O)C)O)=O,,,5,1,1,0,1
50700_0,,,,2,2,1,3
C(C)(C(C(O)=O)(C)C(C(C)=O)O)=O,,,5,1,1,0,1
50702_0,,,,2,2,1,3
C(CC(C(C(O)=O)(C(C)=O)C)O)=O,,,5,1,1,0,1
50704_0,,,,2,2,1,3
C(C(C(C)=O)(C)C(C)O)(O)=O,,,5,1,1,0,1
50706_0,,,,2,2,1,3
C(C(C(C)=O)(C)C(CCO)O)(O)=O,,,5,1,1,0,1
50708_0,,,,2,2,1,3
C(C(C(C)=O)(C)C(C)(CO)O)(O)=O,,,5,1,1,0,1
50710_0,,,,2,2,1,3
C(C)(C(C(O)=O)(C(O)=O)C)=O,,,5,1,1,0,1
50712_0,,,,2,2,1,3
C(C(C(C)=O)(C)C(C(O)O)O)(O)=O,,,5,1,1,0,1
50714_0,,,,2,2,1,3
C(C(C(C)=O)(C)C(C(C)O)O)(O)=O,,,5,1,1,0,1
50716_0,,,,2,2,1,3
C(C(C(C)=O)(C)CO)(O)=O,,,5,1,1,0,1
50718_0,,,,2,2,1,3
C(C(C(C)=O)(C)C(CO)O)(O)=O,,,5,1,1,0,1
50720_0,,,,2,2,1,3
C(C(C(C)=O)(CCO)C(C)O)(O)=O,,,5,1,1,0,1
50722_0,,,,2,2,1,3
C(C(C(O)=O)(C(C)=O)CCO)(O)=O,,,5,1,1,0,1
50724_0,,,,2,2,1,3
C(C(C(C)=O)(CO)CCO)(O)=O,,,5,1,1,0,1
50726_0,,,,2,2,1,3
C(C(CC)(C(C=O)(CO)O)O)(O)=O,,,5,1,3,0,3
50726_1,,,,2,2,1,3
50728_0,,,,2,2,1,3
C(C(C=O)(C(C(O)=O)(CC)O)O)=O,,,5,1,3,0,3
50728_1,,,,2,2,1,3
50729_0,,,,2,2,1,3
50729_1,,,,2,2,1,3
50731_0,,,,2,2,1,3
C(C(C=O)(C(C)(CC(O)=O)O)O)=O,,,5,1,2,0,2
50731_1,,,,2,2,1,3
50733_0,,,,2,2,1,3
C(C(C(C(CO)=O)=O)(CO)C)(O)=O,,,5,1,1,0,1
50735_0,,,,2,2,1,3
C(C(C(C(CO)(CO)O)=O)C)(O)=O,,,5,1,2,0,2
50735_1,,,,2,2,1,3
50737_0,,,,2,2,1,3
C(C(C(C(CO)O)=O)(CO)C)(O)=O,,,5,1,1,0,1
50739_0,,,,2,2,1,3
C(C(C(C=O)=O)(C)C(C=C)O)(O)=O,,,5,1,1,0,1
50740_0,,,,2,2,1,3
50742_0,,,,2,2,1,3
C(C(C(C=O)=O)(C)C(C)O)(O)=O,,,5,1,1,0,1
50744_0,,,,2,2,1,3
C(C(C(O)=O)(C(C=O)=O)C)(O)=O,,,5,1,1,0,1
50746_0,,,,2,2,1,3
C(C(C(C=O)=O)(C)CO)(O)=O,,,5,1,1,0,1
50748_0,,,,2,2,1,3
C(C(C(C=O)=O)(C)C(CO)O)(O)=O,,,5,1,1,0,1
50750_0,,,,2,2,1,3
C(C(C=O)(C)C(C(C=O)=C)O)(O)=O,,,5,1,1,0,1
50752_0,,,,2,2,1,3
C(C(C=O)(C)C(C=CC)O)(O)=O,,,5,1,1,0,1
50754_0,,,,2,2,1,3
C(C(C=O)(C)C(CC=C)O)(O)=O,,,5,1,1,0,1
50756_0,,,,2,2,1,3
C(C(C=O)(C)C(C(C=C)O)O)(O)=O,,,5,1,1,0,1
50758_0,,,,2,2,1,3
C(C(C=O)(C)C(C=C)O)(O)=O,,,5,1,1,0,1
50760_0,,,,2,2,1,3
C(C(C=O)(C)C1(C=COC1)O)(O)=O,,,5,1,1,0,1
50762_0,,,,2,2,1,3
C(C(C=O)(C)C(C(CO)O)O)(O)=O,,,5,1,1,0,1
50764_0,,,,2,2,1,3
C(C(C=O)(C)C(C=O)O)(O)=O,,,5,1,1,0,1
50766_0,,,,2,2,1,3
C(C(C=O)(C)C(CO)(CO)O)(O)=O,,,5,1,1,0,1
50768_0,,,,2,2,1,3
C(C(C=O)(C)C(C(O)=O)O)(O)=O,,,5,1,1,0,1
50770_0,,,,2,2,1,3
C(C(C=O)(C)C(C=O)(C)O)(O)=O,,,5,1,1,0,1
50772_0,,,,2,2,1,3
C(C(C=O)(C)C(C(C)=O)O)(O)=O,,,5,1,1,0,1
50774_0,,,,2,2,1,3
C(C(C=O)(C)C(CC=O)O)(O)=O,,,5,1,1,0,1
50776_0,,,,2,2,1,3
C(C(C=O)(C)C(C)O)(O)=O,,,5,1,1,0,1
50778_0,,,,2,2,1,3
C(C(C=O)(C)C(C=O)(CO)O)(O)=O,,,5,1,1,0,1
50780_0,,,,2,2,1,3
C(C(C=O)(C)C(C(CO)=O)O)(O)=O,,,5,1,1,0,1
50782_0,,,,2,2,1,3
C(C(C=O)(C)C(CC(C)O)O)(O)=O,,,5,1,1,0,1
50784_0,,,,2,2,1,3
C(C(C=O)(C)C(CCO)O)(O)=O,,,5,1,1,0,1
50786_0,,,,2,2,1,3
C(C(C=O)(C)C(C(C=O)O)O)(O)=O,,,5,1,1,0,1
50788_0,,,,2,2,1,3
C(C(C=O)(C)C(C)(CO)O)(O)=O,,,5,1,1,0,1
50790_0,,,,2,2,1,3
C(C(C=O)(C)C(C(O)=O)(C)O)(O)=O,,,5,1,1,0,1
50792_0,,,,2,2,1,3
C(C(C=O)(C)C(CC(O)=O)O)(O)=O,,,5,1,1,0,1
50794_0,,,,2,2,1,3
C(C(C=O)(C)C(C=O)(C=C)O)(O)=O,,,5,1,1,0,1
50796_0,,,,2,2,1,3
C(C(C=O)(C)C(C(C=C)=O)O)(O)=O,,,5,1,1,0,1
50798_0,,,,2,2,1,3
C(C(C=O)(C)C(C=CC=O)O)(O)=O,,,5,1,1,0,1
50800_0,,,,2,2,1,3
C(C(C(O)=O)(C(O)=O)C)=O,,,5,1,1,0,1
50802_0,,,,2,2,1,3
C(C(C=O)(C)C(C(O)O)O)(O)=O,,,5,1,1,0,1
50804_0,,,,2,2,1,3
C(C(C=O)(C)C(C(C)O)O)(O)=O,,,5,1,1,0,1
50806_0,,,,2,2,1,3
C(C(C=O)(C)CO)(O)=O,,,5,1,1,0,1
50808_0,,,,2,2,1,3
C(C(C=O)(C)C(CO)O)(O)=O,,,5,1,1,0,1
50810_0,,,,2,2,1,3
C(C(C)C(C(C=O)(CO)O)O)(O)=O,,,5,1,2,0,2
50810_1,,,,2,2,1,3
50812_0,,,,2,2,1,3
C(C(C=O)(C(C(C(O)=O)C)O)O)=O,,,5,1,2,0,2
50812_1,,,,2,2,1,3
50814_0,,,,2,2,1,3
C(CO)(C(C(O)=O)(C)C(C=C)O)=O,,,5,1,1,0,1
50816_0,,,,2,2,1,3
C(CO)(C(C(O)=O)(C)C(C=O)O)=O,,,5,1,1,0,1
50818_0,,,,2,2,1,3
C(C(C(CO)=O)(C)C(C)O)(O)=O,,,5,1,1,0,1
50820_0,,,,2,2,1,3
C(C(C(O)=O)(C(CO)=O)C)(O)=O,,,5,1,1,0,1
50822_0,,,,2,2,1,3
C(C(C(CO)=O)(CO)C)(O)=O,,,5,1,1,0,1
50824_0,,,,2,2,1,3
C(C(C(CO)=O)(C)C(CO)O)(O)=O,,,5,1,1,0,1
50826_0,,,,2,2,1,3
C(C(C(C=O)=O)(CO)CCO)(O)=O,,,5,1,1,0,1
50828_0,,,,2,2,1,3
C(C(C=O)(CCO)C(C=C)O)(O)=O,,,5,1,1,0,1
50830_0,,,,2,2,1,3
C(C(C=O)(CCO)C(C=O)O)(O)=O,,,5,1,1,0,1
50832_0,,,,2,2,1,3
C(C(C=O)(CCO)C(C)O)(O)=O,,,5,1,1,0,1
50834_0,,,,2,2,1,3
C(C(C(O)=O)(C=O)CCO)(O)=O,,,5,1,1,0,1
50836_0,,,,2,2,1,3
C(C(C=O)(CO)CCO)(O)=O,,,5,1,1,0,1
50838_0,,,,2,2,1,3
C(C(C=O)(CCO)C(CO)O)(O)=O,,,5,1,1,0,1
50840_0,,,,2,2,1,3
C(C(C(CO)=O)(CO)CCO)(O)=O,,,5,1,1,0,1
50842_0,,,,2,2,1,3
C1(COC(CO)C1(C(C=C)O)O)=O,,,5,1,2,0,2
50842_1,,,,2,2,1,3
50844_0,,,,2,2,1,3
C1(COC(CO)C1(C(C=O)O)O)=O,,,5,1,2,0,2
50844_1,,,,2,2,1,3
50846_0,,,,2,2,1,3
C1(COC(CO)C1(C(C)O)O)=O,,,5,1,2,0,2
50846_1,,,,2,2,1,3
50847_0,,,,2,2,1,3
50847_1,,,,2,2,1,3
50848_0,,,,2,2,1,3
50848_1,,,,2,2,1,3
50850_0,,,,2,2,1,3
C1(COC(CO)C1(C(CO)O)O)=O,,,5,1,2,0,2
50850_1,,,,2,2,1,3
50852_0,,,,2,2,1,3
C1(C(C(C(CO)O1)O)C(C=C)O)=O,,,5,1,1,0,1
50854_0,,,,2,2,1,3
C1(C(C(C(CO)O1)O)C(C=O)O)=O,,,5,1,1,0,1
50856_0,,,,2,2,1,3
C1(C(C(C)O)C(C(CO)O1)O)=O,,,5,1,2,0,2
50858_0,,,,2,2,1,3
C1(C(C(O)=O)C(C(CO)O1)O)=O,,,5,1,1,0,1
50859_0,,,,2,2,1,3
50861_0,,,,2,2,1,3
C1(C(C(CO)O)C(C(CO)O1)O)=O,,,5,1,2,0,2
50863_0,,,,2,2,1,3
C1(COC(C(CO)O)C1(CO)O)=O,,,5,1,2,0,2
50863_1,,,,2,2,1,3
50865_0,,,,2,2,1,3
C1(C(CO)C(C(C(CO)O)O1)O)=O,,,5,1,1,0,1
50867_0,,,,2,2,1,3
C(C)(C1(CO)C(C(C(O1)O)O)O)=O,,,5,1,3,0,3
50867_1,,,,2,2,1,3
50869_0,,,,2,2,1,3
C1(C(CO)(CO)OC(C1CO)O)=O,,,5,1,3,0,3
50869_1,,,,2,2,1,3
50871_0,,,,2,2,1,3
C1(C(CO)OC(C1(CO)CO)O)=O,,,5,1,2,0,2
50873_0,,,,2,2,1,3
C1(C(CO)(CO)C(C(CO)O1)O)=O,,,5,1,1,0,1
50875_0,,,,2,2,1,3
C(C1(C(O)OC(CO)C1O)CO)=O,,,5,1,2,0,2
50877_0,,,,2,2,1,3
C(C1(C(C(O)OC1)=O)C(C=C)O)=O,,,5,1,1,0,1
50879_0,,,,2,2,1,3
C(C1(C(C(O)OC1)=O)C(C=O)O)=O,,,5,1,2,0,2
50881_0,,,,2,2,1,3
C(C1(C(C(O)OC1)=O)C(C)O)=O,,,5,1,2,0,2
50883_0,,,,2,2,1,3
C(C1(C=O)C(C(O)OC1)=O)(O)=O,,,5,1,2,0,2
50885_0,,,,2,2,1,3
C(C1(C(C(O)OC1)=O)CO)=O,,,5,1,2,0,2
50887_0,,,,2,2,1,3
C(C1(C(C(O)OC1)=O)C(CO)O)=O,,,5,1,2,0,2
50889_0,,,,2,2,1,3
C(C1(COC(C1C(C=C)O)=O)O)=O,,,5,1,1,0,1
50891_0,,,,2,2,1,3
C(C(C1C(OCC1(C=O)O)=O)O)=O,,,5,1,1,0,1
50893_0,,,,2,2,1,3
C1(C(C(C)O)C(C=O)(CO1)O)=O,,,5,1,2,0,2
50895_0,,,,2,2,1,3
C1(C(C(O)=O)C(C=O)(CO1)O)=O,,,5,1,1,0,1
50897_0,,,,2,2,1,3
C1(C(CO)C(C=O)(CO1)O)=O,,,5,1,2,0,2
50899_0,,,,2,2,1,3
C1(C(C(CO)O)C(C=O)(CO1)O)=O,,,5,1,2,0,2
50901_0,,,,2,2,1,3
C(C1(C(O)OCC1O)C(C=C)O)=O,,,5,1,1,0,1
50903_0,,,,2,2,1,3
C(C1(C(O)OCC1O)C(C=O)O)=O,,,5,1,2,0,2
50905_0,,,,2,2,1,3
C(C1(C(O)OCC1O)C(C)O)=O,,,5,1,2,0,2
50907_0,,,,2,2,1,3
C(C1(C=O)C(O)OCC1O)(O)=O,,,5,1,2,0,2
50909_0,,,,2,2,1,3
C(C1(C(O)OCC1O)CO)=O,,,5,1,2,0,2
50911_0,,,,2,2,1,3
C(C1(C(O)OCC1O)C(CO)O)=O,,,5,1,2,0,2
50913_0,,,,2,2,1,3
C(C1(C(C(O)OC1CO)=O)CO)=O,,,5,1,2,0,2
50915_0,,,,2,2,1,3
C1(C(CO)C(C=O)(C(CO)O1)O)=O,,,5,1,1,0,1
50917_0,,,,2,2,1,3
C(C(C1(C(O)OCC1O)CO)=O)=O,,,5,1,2,0,2
50919_0,,,,2,2,1,3
C(CO)(C1(C(O)OCC1O)CO)=O,,,5,1,2,0,2
50921_0,,,,2,2,1,3
C1(C(C(CO1)=O)(C(C=CC)O)O)=O,,,5,1,2,0,2
50921_1,,,,2,2,1,3
50923_0,,,,2,2,1,3
C1(C(C(CO1)=O)(C(CC=C)O)O)=O,,,5,1,2,0,2
50923_1,,,,2,2,1,3
50925_0,,,,2,2,1,3
C1(C(C(CO1)=O)(C(C=C)O)O)=O,,,5,1,2,0,2
50925_1,,,,2,2,1,3
50927_0,,,,2,2,1,3
C1(C(C(CO1)=O)(C(C=O)O)O)=O,,,5,1,4,0,4
50927_1,,,,2,2,1,3
50929_0,,,,2,2,1,3
C1(C(C(CO1)=O)(C(C(O)=O)O)O)=O,,,5,1,2,0,2
50929_1,,,,2,2,1,3
50931_0,,,,2,2,1,3
C(C(C)(C1(C(OCC1=O)=O)O)O)=O,,,5,1,2,0,2
50931_1,,,,2,2,1,3
50933_0,,,,2,2,1,3
C1(C(C(CO1)=O)(C(C(C)=O)O)O)=O,,,5,1,2,0,2
50933_1,,,,2,2,1,3
50935_0,,,,2,2,1,3
C(CC(C1(C(OCC1=O)=O)O)O)=O,,,5,1,2,0,2
50935_1,,,,2,2,1,3
50937_0,,,,2,2,1,3
C1(C(C(CO1)=O)(C(C)O)O)=O,,,5,1,4,0,4
50937_1,,,,2,2,1,3
50939_0,,,,2,2,1,3
C1(C(C(CO1)=O)(C(CCO)O)O)=O,,,5,1,2,0,2
50939_1,,,,2,2,1,3
50941_0,,,,2,2,1,3
C1(C(C(CO1)=O)(C(CO)(C)O)O)=O,,,5,1,2,0,2
50941_1,,,,2,2,1,3
50943_0,,,,2,2,1,3
C1(C(C(O)=O)(C(CO1)=O)O)=O,,,5,1,4,0,4
50943_1,,,,2,2,1,3
50945_0,,,,2,2,1,3
C1(C(C(CO1)=O)(C(C(O)O)O)O)=O,,,5,1,2,0,2
50945_1,,,,2,2,1,3
50947_0,,,,2,2,1,3
C1(C(C(CO1)=O)(C(C(C)O)O)O)=O,,,5,1,2,0,2
50947_1,,,,2,2,1,3
50949_0,,,,2,2,1,3
C1(C(C(CO1)=O)(CO)O)=O,,,5,1,4,0,4
50949_1,,,,2,2,1,3
50951_0,,,,2,2,1,3
C1(C(C(CO1)=O)(C(CO)O)O)=O,,,5,1,4,0,4
50951_1,,,,2,2,1,3
50953_0,,,,2,2,1,3
C1(C(C(C(O1)=O)C(C=CC)O)O)=O,,,5,1,1,0,1
50955_0,,,,2,2,1,3
C1(C(C(CC=C)O)C(C(O1)=O)O)=O,,,5,1,1,0,1
50957_0,,,,2,2,1,3
C1(C(C(C(O1)=O)C(C=C)O)O)=O,,,5,1,1,0,1
50959_0,,,,2,2,1,3
C1(C(C(C(O1)=O)C(C=O)O)O)=O,,,5,1,3,0,3
50961_0,,,,2,2,1,3
C1(C(C(C(O1)=O)C(C(O)=O)O)O)=O,,,5,1,1,0,1
50963_0,,,,2,2,1,3
C1(C(C(C(O1)=O)C(C=O)(C)O)O)=O,,,5,1,1,0,1
50965_0,,,,2,2,1,3
C1(C(C(C(O1)=O)C(C(C)=O)O)O)=O,,,5,1,1,0,1
50967_0,,,,2,2,1,3
C1(C(C(CC=O)O)C(C(O1)=O)O)=O,,,5,1,1,0,1
50969_0,,,,2,2,1,3
C1(C(C(C)O)C(C(O1)=O)O)=O,,,5,1,3,0,3
50971_0,,,,2,2,1,3
C1(C(C(CCO)O)C(C(O1)=O)O)=O,,,5,1,1,0,1
50973_0,,,,2,2,1,3
C1(C(C(CO)(C)O)C(C(O1)=O)O)=O,,,5,1,1,0,1
50975_0,,,,2,2,1,3
C1(C(C(O)=O)C(C(O1)=O)O)=O,,,5,1,2,0,2
50977_0,,,,2,2,1,3
C1(C(C(C(O)O)O)C(C(O1)=O)O)=O,,,5,1,1,0,1
50979_0,,,,2,2,1,3
C1(C(C(C(C)O)O)C(C(O1)=O)O)=O,,,5,1,1,0,1
50981_0,,,,2,2,1,3
C1(C(CO)C(C(O1)=O)O)=O,,,5,1,3,0,3
50983_0,,,,2,2,1,3
C1(C(C(CO)O)C(C(O1)=O)O)=O,,,5,1,4,0,4
50985_0,,,,2,2,1,3
C1(COCC(C1(C(C=C)O)O)O)=O,,,5,1,2,0,2
50985_1,,,,2,2,1,3
50987_0,,,,2,2,1,3
C1(COCC(C1(C(C=O)O)O)O)=O,,,5,1,2,0,2
50987_1,,,,2,2,1,3
50989_0,,,,2,2,1,3
C1(COCC(C1(C(C)O)O)O)=O,,,5,1,2,0,2
50989_1,,,,2,2,1,3
50990_0,,,,2,2,1,3
50990_1,,,,2,2,1,3
50991_0,,,,2,2,1,3
50991_1,,,,2,2,1,3
50993_0,,,,2,2,1,3
C1(COCC(C1(C(CO)O)O)O)=O,,,5,1,2,0,2
50993_1,,,,2,2,1,3
50995_0,,,,2,2,1,3
C1(C(C(C(CO1)O)O)C(C=C)O)=O,,,5,1,1,0,1
50997_0,,,,2,2,1,3
C1(C(C(C(CO1)O)O)C(C=O)O)=O,,,5,1,1,0,1
50999_0,,,,2,2,1,3
C1(C(C(C)O)C(C(CO1)O)O)=O,,,5,1,2,0,2
51001_0,,,,2,2,1,3
C1(C(C(O)=O)C(C(CO1)O)O)=O,,,5,1,1,0,1
51002_0,,,,2,2,1,3
51004_0,,,,2,2,1,3
C1(C(C(CO)O)C(C(CO1)O)O)=O,,,5,1,2,0,2
51006_0,,,,2,2,1,3
C1(C(COC(C1)O)(C(C=C)O)O)=O,,,5,1,2,0,2
51006_1,,,,2,2,1,3
51008_0,,,,2,2,1,3
C1(C(COC(C1)O)(C(C=O)O)O)=O,,,5,1,3,0,3
51008_1,,,,2,2,1,3
51010_0,,,,2,2,1,3
C1(CC(O)OCC1(C(C)O)O)=O,,,5,1,3,0,3
51010_1,,,,2,2,1,3
51012_0,,,,2,2,1,3
C(C1(C(CC(O)OC1)=O)O)(O)=O,,,5,1,3,0,3
51012_1,,,,2,2,1,3
51014_0,,,,2,2,1,3
C1(CC(O)OCC1(CO)O)=O,,,5,1,4,0,4
51014_1,,,,2,2,1,3
51016_0,,,,2,2,1,3
C1(CC(O)OCC1(C(CO)O)O)=O,,,5,1,3,0,3
51016_1,,,,2,2,1,3
51018_0,,,,2,2,1,3
C1(C(C(O)OCC1)(C(C=C)O)O)=O,,,5,1,2,0,2
51018_1,,,,2,2,1,3
51020_0,,,,2,2,1,3
C1(C(C(O)OCC1)(C(C=O)O)O)=O,,,5,1,3,0,3
51020_1,,,,2,2,1,3
51022_0,,,,2,2,1,3
C1(CCOC(C1(C(C)O)O)O)=O,,,5,1,4,0,4
51022_1,,,,2,2,1,3
51024_0,,,,2,2,1,3
C(C1(C(CCOC1O)=O)O)(O)=O,,,5,1,3,0,3
51024_1,,,,2,2,1,3
51025_0,,,,2,2,1,3
51025_1,,,,2,2,1,3
51027_0,,,,2,2,1,3
C1(CCOC(C1(C(CO)O)O)O)=O,,,5,1,3,0,3
51027_1,,,,2,2,1,3
51029_0,,,,2,2,1,3
C1(COC(CO)C(C1(CO)O)O)=O,,,5,1,2,0,2
51029_1,,,,2,2,1,3
51031_0,,,,2,2,1,3
C1(C(CO)C(C(C(CO)O1)O)O)=O,,,5,1,1,0,1
51033_0,,,,2,2,1,3
C1(CC(C(OC1(CO)CO)O)O)=O,,,5,1,3,0,3
51033_1,,,,2,2,1,3
51035_0,,,,2,2,1,3
C1(CC(O)OC(CO)C1(CO)O)=O,,,5,1,3,0,3
51035_1,,,,2,2,1,3
51037_0,,,,2,2,1,3
C1(CC(CO)OC(C1(CO)O)O)=O,,,5,1,3,0,3
51037_1,,,,2,2,1,3
51039_0,,,,2,2,1,3
C1(C(COC(C1CO)O)(CO)O)=O,,,5,1,3,0,3
51039_1,,,,2,2,1,3
51041_0,,,,2,2,1,3
C1(C(COC(C1(CO)CO)O)O)=O,,,5,1,2,0,2
51043_0,,,,2,2,1,3
C1(C(CO)(CO)C(C(CO1)O)O)=O,,,5,1,1,0,1
51045_0,,,,2,2,1,3
C(C1(C(O)OCC(C1O)O)CO)=O,,,5,1,2,0,2
51047_0,,,,2,2,1,3
C(C1(C(C(O)OCC1O)=O)CO)=O,,,5,1,2,0,2
51049_0,,,,2,2,1,3
C1(C(CO)C(C=O)(C(CO1)O)O)=O,,,5,1,1,0,1
51051_0,,,,2,2,1,3
C(C1(C(COC(C1O)O)=O)CO)=O,,,5,1,2,0,2
51053_0,,,,2,2,1,3
C1(COCC(C(C1(CO)O)O)O)=O,,,5,1,2,0,2
51053_1,,,,2,2,1,3
51055_0,,,,2,2,1,3
C1(C(CO)C(C(C(CO1)O)O)O)=O,,,5,1,1,0,1
51057_0,,,,2,2,1,3
C1(CC(C(O)OCC1(CO)O)O)=O,,,5,1,3,0,3
51057_1,,,,2,2,1,3
51059_0,,,,2,2,1,3
C1(CCOC(C(C1(CO)O)O)O)=O,,,5,1,3,0,3
51059_1,,,,2,2,1,3
51061_0,,,,2,2,1,3
C1(CC(O)OCC(C1(CO)O)O)=O,,,5,1,3,0,3
51061_1,,,,2,2,1,3
51063_0,,,,2,2,1,3
C1(CC(COC(C1(CO)O)O)O)=O,,,5,1,3,0,3
51063_1,,,,2,2,1,3
51065_0,,,,2,2,1,3
C(C(C=O)(C=C)C1(C(OCC1)=O)O)=O,,,5,1,1,0,1
51066_0,,,,2,2,1,3
51066_1,,,,2,2,1,3
51068_0,,,,2,2,1,3
C(C(C=O)(C1(C(OCC1)=O)O)O)=O,,,5,1,3,0,3
51068_1,,,,2,2,1,3
51070_0,,,,2,2,1,3
C(C(C=O)(C=C)C1(COC(C1)=O)O)=O,,,5,1,1,0,1
51072_0,,,,2,2,1,3
C(C(CO)(C1(COC(C1)=O)O)O)=O,,,5,1,2,0,2
51072_1,,,,2,2,1,3
51074_0,,,,2,2,1,3
C(C(C=O)(C1(COC(C1)=O)O)O)=O,,,5,1,2,0,2
51074_1,,,,2,2,1,3
51076_0,,,,2,2,1,3
C1(C(CO)(C(C=C)O)OC(C1)=O)=O,,,5,1,2,0,2
51076_1,,,,2,2,1,3
51078_0,,,,2,2,1,3
C1(C(CO)(C(C=O)O)OC(C1)=O)=O,,,5,1,2,0,2
51078_1,,,,2,2,1,3
51080_0,,,,2,2,1,3
C1(CC(C(CO)(C(C)O)O1)=O)=O,,,5,1,3,0,3
51080_1,,,,2,2,1,3
51082_0,,,,2,2,1,3
C(C1(C(CC(O1)=O)=O)CO)(O)=O,,,5,1,3,0,3
51082_1,,,,2,2,1,3
51084_0,,,,2,2,1,3
C1(CC(C(CO)(CO)O1)=O)=O,,,5,1,4,0,4
51084_1,,,,2,2,1,3
51086_0,,,,2,2,1,3
C1(CC(C(CO)(C(CO)O)O1)=O)=O,,,5,1,4,0,4
51086_1,,,,2,2,1,3
51087_0,,,,2,2,1,3
51087_1,,,,2,2,1,3
51089_0,,,,2,2,1,3
C1(C(CO)(C(C(CC=O)O1)O)O)=O,,,5,1,2,0,2
51089_1,,,,2,2,1,3
51091_0,,,,2,2,1,3
C1(C(CO)(C(C(C(C)=O)O1)O)O)=O,,,5,1,2,0,2
51091_1,,,,2,2,1,3
51093_0,,,,2,2,1,3
C1(C(C(C(C(C)=O)(CO)O1)O)O)=O,,,5,1,2,0,2
51093_1,,,,2,2,1,3
51095_0,,,,2,2,1,3
C1(C(COC(C1)=O)(C(C=C)O)O)=O,,,5,1,2,0,2
51095_1,,,,2,2,1,3
51097_0,,,,2,2,1,3
C1(C(COC(C1)=O)(C(C=O)O)O)=O,,,5,1,2,0,2
51097_1,,,,2,2,1,3
51099_0,,,,2,2,1,3
C1(CC(C(CO1)(C(C)O)O)=O)=O,,,5,1,3,0,3
51099_1,,,,2,2,1,3
51101_0,,,,2,2,1,3
C(C1(C(CC(OC1)=O)=O)O)(O)=O,,,5,1,3,0,3
51101_1,,,,2,2,1,3
51103_0,,,,2,2,1,3
C1(CC(C(CO)(CO1)O)=O)=O,,,5,1,4,0,4
51103_1,,,,2,2,1,3
51105_0,,,,2,2,1,3
C1(CC(C(CO1)(C(CO)O)O)=O)=O,,,5,1,2,0,2
51105_1,,,,2,2,1,3
51107_0,,,,2,2,1,3
C1(CCOC(C1(C(C=C)O)O)=O)=O,,,5,1,2,0,2
51107_1,,,,2,2,1,3
51109_0,,,,2,2,1,3
C1(CCOC(C1(C(C=O)O)O)=O)=O,,,5,1,2,0,2
51109_1,,,,2,2,1,3
51111_0,,,,2,2,1,3
C1(C(C(CCO1)=O)(C(C)O)O)=O,,,5,1,4,0,4
51111_1,,,,2,2,1,3
51113_0,,,,2,2,1,3
C1(C(C(O)=O)(C(CCO1)=O)O)=O,,,5,1,4,0,4
51113_1,,,,2,2,1,3
51115_0,,,,2,2,1,3
C1(C(C(CCO1)=O)(CO)O)=O,,,5,1,4,0,4
51115_1,,,,2,2,1,3
51117_0,,,,2,2,1,3
C1(C(C(CCO1)=O)(C(CO)O)O)=O,,,5,1,2,0,2
51117_1,,,,2,2,1,3
51119_0,,,,2,2,1,3
C1(CC(C(OC1(CO)CO)=O)O)=O,,,5,1,2,0,2
51119_1,,,,2,2,1,3
51121_0,,,,2,2,1,3
C1(CC(C(CO)(C(CO)O1)O)=O)=O,,,5,1,2,0,2
51121_1,,,,2,2,1,3
51123_0,,,,2,2,1,3
C1(C(C(CC(CO)O1)=O)(CO)O)=O,,,5,1,2,0,2
51123_1,,,,2,2,1,3
51125_0,,,,2,2,1,3
C1(CC(C(OCC1(CO)O)=O)O)=O,,,5,1,2,0,2
51125_1,,,,2,2,1,3
51127_0,,,,2,2,1,3
C1(C(CO)(C(C(CCO1)=O)O)O)=O,,,5,1,2,0,2
51127_1,,,,2,2,1,3
51129_0,,,,2,2,1,3
C1(C(CO)(C(C(OCC1)=O)O)O)=O,,,5,1,2,0,2
51129_1,,,,2,2,1,3
51131_0,,,,2,2,1,3
C1(CC(C(CO)(C(CO1)O)O)=O)=O,,,5,1,2,0,2
51131_1,,,,2,2,1,3
51133_0,,,,2,2,1,3
C1(C(C(CC(CO1)O)=O)(CO)O)=O,,,5,1,2,0,2
51133_1,,,,2,2,1,3
51135_0,,,,2,2,1,3
C1(C(CO)(C(CC(CO1)=O)O)O)=O,,,5,1,2,0,2
51135_1,,,,2,2,1,3
51137_0,,,,2,2,1,3
C(C)(C(C(C(O)=O)=O)(C(C)O)O)=O,,,5,1,3,0,3
51137_1,,,,2,2,1,3
51138_0,,,,2,2,1,3
51138_1,,,,2,2,1,3
51139_0,,,,2,2,1,3
51139_1,,,,2,2,1,3
51141_0,,,,2,2,1,3
C(C(CO)(C(C)O)O)(C(C=C)O)=O,,,5,1,2,0,2
51141_1,,,,2,2,1,3
51142_0,,,,2,2,1,3
51142_1,,,,2,2,1,3
51144_0,,,,2,2,1,3
C(C(CO)(CO)O)(C(C=C)O)=O,,,5,1,3,0,3
51144_1,,,,2,2,1,3
51146_0,,,,2,2,1,3
C(C(C(C=CC(O)=O)=O)(CO)O)=O,,,5,1,2,0,2
51146_1,,,,2,2,1,3
51148_0,,,,2,2,1,3
C(C(C=O)(C(C=O)=C)C(C=CC)O)=O,,,5,1,1,0,1
51150_0,,,,2,2,1,3
C(C(C=O)(C(C=O)=C)C(CC=C)O)=O,,,5,1,1,0,1
51152_0,,,,2,2,1,3
C(C(C=O)(C(C=O)=C)C(C=C)O)=O,,,5,1,1,0,1
51154_0,,,,2,2,1,3
C(C(C=O)(C(C=O)=C)C(C=O)O)=O,,,5,1,1,0,1
51156_0,,,,2,2,1,3
C(C(C=O)(C(C=O)=C)C(C=O)(C)O)=O,,,5,1,1,0,1
51158_0,,,,2,2,1,3
C(C(C=O)(C(C=O)=C)C(C(C)=O)O)=O,,,5,1,1,0,1
51160_0,,,,2,2,1,3
C(C(C=O)(C(C=O)=C)C(CC=O)O)=O,,,5,1,1,0,1
51162_0,,,,2,2,1,3
C(C(C=O)(C(C=O)=C)C(C)O)=O,,,5,1,2,0,2
51164_0,,,,2,2,1,3
C(C(C=O)(C(O)=O)C(C=O)=C)=O,,,5,1,2,0,2
51166_0,,,,2,2,1,3
C(C(C=O)(C(C=O)=C)CO)=O,,,5,1,2,0,2
51168_0,,,,2,2,1,3
C(C(C=O)(C(C=O)=C)C(CO)O)=O,,,5,1,1,0,1
51170_0,,,,2,2,1,3
C=C(C=O)C(C(C=O)=O)(CO)CO,,,5,1,1,0,1
51172_0,,,,2,2,1,3
C(C(C(C=O)=C)(CO)C(C=O)O)=O,,,5,1,1,0,1
51174_0,,,,2,2,1,3
C(C(C(CO)=O)(C(C=O)=C)CO)=O,,,5,1,1,0,1
51176_0,,,,2,2,1,3
C(C(C(C=C(C=O)C)=O)(CO)O)=O,,,5,1,2,0,2
51176_1,,,,2,2,1,3
51178_0,,,,2,2,1,3
C(C(C(CC(C=O)=C)=O)(CO)O)=O,,,5,1,2,0,2
51178_1,,,,2,2,1,3
51180_0,,,,2,2,1,3
C(C(C=O)(C=C)C(C=C(C=O)C)O)=O,,,5,1,1,0,1
51182_0,,,,2,2,1,3
C(C(CO)(C(C=C(C=O)C)O)O)=O,,,5,1,2,0,2
51182_1,,,,2,2,1,3
51184_0,,,,2,2,1,3
C(C(C=O)(C(C=C(C=O)C)O)O)=O,,,5,1,2,0,2
51184_1,,,,2,2,1,3
51186_0,,,,2,2,1,3
C(C(C=O)(C=C)C(C(C)=CC=O)O)=O,,,5,1,1,0,1
51188_0,,,,2,2,1,3
C(C(CO)(C(C(C)=CC=O)O)O)=O,,,5,1,2,0,2
51188_1,,,,2,2,1,3
51190_0,,,,2,2,1,3
C(C(C=O)(C(C(C)=CC=O)O)O)=O,,,5,1,2,0,2
51190_1,,,,2,2,1,3
51192_0,,,,2,2,1,3
C(C(C=O)(C=C)C(CC(C=O)=C)O)=O,,,5,1,1,0,1
51194_0,,,,2,2,1,3
C(C(CO)(C(CC(C=O)=C)O)O)=O,,,5,1,2,0,2
51194_1,,,,2,2,1,3
51196_0,,,,2,2,1,3
C(C(C=O)(C(CC(C=O)=C)O)O)=O,,,5,1,2,0,2
51196_1,,,,2,2,1,3
51198_0,,,,2,2,1,3
C(C(C=O)(C=C)C(C(CC=O)=C)O)=O,,,5,1,1,0,1
51200_0,,,,2,2,1,3
C(C(CO)(C(C(CC=O)=C)O)O)=O,,,5,1,2,0,2
51200_1,,,,2,2,1,3
51202_0,,,,2,2,1,3
C(C(C=O)(C(C(CC=O)=C)O)O)=O,,,5,1,2,0,2
51202_1,,,,2,2,1,3
51204_0,,,,2,2,1,3
C(C(C(C=CC(C)=O)=O)(CO)O)=O,,,5,1,2,0,2
51204_1,,,,2,2,1,3
51206_0,,,,2,2,1,3
C(C(C=O)(C=C)C(C=CC(C)=O)O)=O,,,5,1,1,0,1
51208_0,,,,2,2,1,3
C(C(CO)(C(C=CC(C)=O)O)O)=O,,,5,1,2,0,2
51208_1,,,,2,2,1,3
51210_0,,,,2,2,1,3
C(C(C=O)(C(C=CC(C)=O)O)O)=O,,,5,1,2,0,2
51210_1,,,,2,2,1,3
51212_0,,,,2,2,1,3
C(C(C=O)(C=C)C(C=CC=O)(C)O)=O,,,5,1,1,0,1
51214_0,,,,2,2,1,3
C(C(CO)(C(C=CC=O)(C)O)O)=O,,,5,1,2,0,2
51214_1,,,,2,2,1,3
51216_0,,,,2,2,1,3
C(C(C=O)(C(C=CC=O)(C)O)O)=O,,,5,1,2,0,2
51216_1,,,,2,2,1,3
51218_0,,,,2,2,1,3
C(C(C=O)(C=C)C(C=O)(CC=C)O)=O,,,5,1,1,0,1
51220_0,,,,2,2,1,3
C(C(CO)(C(C=O)(CC=C)O)O)=O,,,5,1,2,0,2
51220_1,,,,2,2,1,3
51222_0,,,,2,2,1,3
C(C(C=O)(C(C=O)(CC=C)O)O)=O,,,5,1,2,0,2
51222_1,,,,2,2,1,3
51224_0,,,,2,2,1,3
C(C(C=O)(C=C)C(C(CC=C)=O)O)=O,,,5,1,1,0,1
51226_0,,,,2,2,1,3
C(C(CO)(C(C(CC=C)=O)O)O)=O,,,5,1,2,0,2
51226_1,,,,2,2,1,3
51228_0,,,,2,2,1,3
C(C(C=O)(C(C(CC=C)=O)O)O)=O,,,5,1,2,0,2
51228_1,,,,2,2,1,3
51230_0,,,,2,2,1,3
C(C(C=O)(C=C)C(C=O)(C=CC)O)=O,,,5,1,1,0,1
51232_0,,,,2,2,1,3
C(C(CO)(C(C=O)(C=CC)O)O)=O,,,5,1,2,0,2
51232_1,,,,2,2,1,3
51234_0,,,,2,2,1,3
C(C(C=CC)(C(C=O)(C=O)O)O)=O,,,5,1,2,0,2
51234_1,,,,2,2,1,3
51236_0,,,,2,2,1,3
C(C(C=O)(C=C)C(C(C=CC)=O)O)=O,,,5,1,1,0,1
51238_0,,,,2,2,1,3
C(C(CO)(C(C(C=CC)=O)O)O)=O,,,5,1,2,0,2
51238_1,,,,2,2,1,3
51240_0,,,,2,2,1,3
C(C(C=O)(C(C(C=CC)=O)O)O)=O,,,5,1,2,0,2
51240_1,,,,2,2,1,3
51242_0,,,,2,2,1,3
C(C(C=O)(C=CC=O)C(C=CC)O)=O,,,5,1,1,0,1
51244_0,,,,2,2,1,3
C(C(C=O)(C=CC=O)C(CC=C)O)=O,,,5,1,1,0,1
51246_0,,,,2,2,1,3
C(C(C=O)(C=CC=O)C(C=C)O)=O,,,5,1,1,0,1
51248_0,,,,2,2,1,3
C(C(C=O)(C=CC=O)C(C=O)O)=O,,,5,1,1,0,1
51250_0,,,,2,2,1,3
C(C(C=O)(C=CC=O)C(C=O)(C)O)=O,,,5,1,1,0,1
51252_0,,,,2,2,1,3
C(C(C=O)(C=CC=O)C(C(C)=O)O)=O,,,5,1,1,0,1
51254_0,,,,2,2,1,3
C(C(C=O)(C=CC=O)C(CC=O)O)=O,,,5,1,1,0,1
51256_0,,,,2,2,1,3
C(C(C=O)(C=CC=O)C(C)O)=O,,,5,1,2,0,2
51258_0,,,,2,2,1,3
C(C(C=O)(C(O)=O)C=CC=O)=O,,,5,1,2,0,2
51260_0,,,,2,2,1,3
C(C(C=O)(C=CC=O)CO)=O,,,5,1,2,0,2
51262_0,,,,2,2,1,3
C(C(C=O)(C=CC=O)C(CO)O)=O,,,5,1,1,0,1
51264_0,,,,2,2,1,3
C(C(C(C=O)=O)(CO)CO)=CC=O,,,5,1,1,0,1
51266_0,,,,2,2,1,3
C(C(C=CC=O)(CO)C(C=O)O)=O,,,5,1,1,0,1
51268_0,,,,2,2,1,3
C(C(C(CO)=O)(C=CC=O)CO)=O,,,5,1,1,0,1
51270_0,,,,2,2,1,3
C(C(C(C=CCC=O)=O)(CO)O)=O,,,5,1,2,0,2
51270_1,,,,2,2,1,3
51272_0,,,,2,2,1,3
C(C(C(CC=CC=O)=O)(CO)O)=O,,,5,1,2,0,2
51272_1,,,,2,2,1,3
51274_0,,,,2,2,1,3
C(C(C=O)(C=C)C(C=CCC=O)O)=O,,,5,1,1,0,1
51276_0,,,,2,2,1,3
C(C(CO)(C(C=CCC=O)O)O)=O,,,5,1,2,0,2
51276_1,,,,2,2,1,3
51278_0,,,,2,2,1,3
C(C(C=O)(C(C=CCC=O)O)O)=O,,,5,1,2,0,2
51278_1,,,,2,2,1,3
51280_0,,,,2,2,1,3
C(C(C=O)(C=C)C(CC=CC=O)O)=O,,,5,1,1,0,1
51282_0,,,,2,2,1,3
C(C(CO)(C(CC=CC=O)O)O)=O,,,5,1,2,0,2
51282_1,,,,2,2,1,3
51284_0,,,,2,2,1,3
C(C(C=O)(C(CC=CC=O)O)O)=O,,,5,1,2,0,2
51284_1,,,,2,2,1,3
51286_0,,,,2,2,1,3
C(C(C=O)(C(C=O)=CCO)CO)=O,,,5,1,1,0,1
51288_0,,,,2,2,1,3
C(C(C=O)(C=CC(C=O)O)CO)=O,,,5,1,1,0,1
51290_0,,,,2,2,1,3
C(C(C=O)(C=CC(CO)=O)CO)=O,,,5,1,1,0,1
51292_0,,,,2,2,1,3
C(C(C=O)(C(CO)=CC=O)CO)=O,,,5,1,1,0,1
51294_0,,,,2,2,1,3
C(C(C=O)(C(C(C=O)O)=C)CO)=O,,,5,1,1,0,1
51296_0,,,,2,2,1,3
C(C(C=O)(C=C)C(C(C=O)C=C)O)=O,,,5,1,1,0,1
51298_0,,,,2,2,1,3
C(C(C=O)(C=C)C(C(C=O)=CC)O)=O,,,5,1,1,0,1
51300_0,,,,2,2,1,3
C(C(C=O)(C=C)C(C(C=O)=C)O)=O,,,5,1,1,0,1
51302_0,,,,2,2,1,3
C(C(C=O)(C=C)C(C=CC)O)=O,,,5,1,1,0,1
51304_0,,,,2,2,1,3
C(C(C=O)(C=C)C(CC=C)O)=O,,,5,1,1,0,1
51306_0,,,,2,2,1,3
C(C(C=O)(C=C)C(C(C=C)O)O)=O,,,5,1,1,0,1
51308_0,,,,2,2,1,3
C(C(C=O)(C=C)C(C=C)O)=O,,,5,1,1,0,1
51310_0,,,,2,2,1,3
C(C(C=O)(C=C)C1(C=COC1)O)=O,,,5,1,1,0,1
51312_0,,,,2,2,1,3
C(C(C=O)(C=C)C(C(CO)O)O)=O,,,5,1,1,0,1
51314_0,,,,2,2,1,3
C(C(C=O)(C=C)C(C=O)O)=O,,,5,1,2,0,2
51316_0,,,,2,2,1,3
C(C(C=O)(C=C)C(CO)(CO)O)=O,,,5,1,1,0,1
51318_0,,,,2,2,1,3
C(C(C=O)(C=C)C(C(O)=O)O)=O,,,5,1,2,0,2
51320_0,,,,2,2,1,3
C(C(C=O)(C=C)C(C=O)(C)O)=O,,,5,1,2,0,2
51322_0,,,,2,2,1,3
C(C(C=O)(C=C)C(C(C)=O)O)=O,,,5,1,2,0,2
51324_0,,,,2,2,1,3
C(C(C=O)(C=C)C(CC=O)O)=O,,,5,1,2,0,2
51326_0,,,,2,2,1,3
C(C(C=O)(C=C)C(C)O)=O,,,5,1,2,0,2
51328_0,,,,2,2,1,3
C(C(C=O)(C=C)C(C=O)(CO)O)=O,,,5,1,1,0,1
51330_0,,,,2,2,1,3
C(C(C=O)(C=C)C(C(CO)=O)O)=O,,,5,1,1,0,1
51332_0,,,,2,2,1,3
C(C(C=O)(C=C)C(CC(C)O)O)=O,,,5,1,1,0,1
51334_0,,,,2,2,1,3
C(C(C=O)(C=C)C(CCO)O)=O,,,5,1,2,0,2
51336_0,,,,2,2,1,3
C(C(C=O)(C=C)C(C(C=O)O)O)=O,,,5,1,1,0,1
51338_0,,,,2,2,1,3
C(C(C=O)(C=C)C(C)(CO)O)=O,,,5,1,2,0,2
51340_0,,,,2,2,1,3
C(C(C=O)(C=C)C(C(O)=O)(C)O)=O,,,5,1,1,0,1
51342_0,,,,2,2,1,3
C(C(C=O)(C=C)C(CC(O)=O)O)=O,,,5,1,1,0,1
51344_0,,,,2,2,1,3
C(C(C=O)(C=C)C(C=O)(CC=O)O)=O,,,5,1,1,0,1
51346_0,,,,2,2,1,3
C(C(C=O)(C=C)C(C(CC=O)=O)O)=O,,,5,1,1,0,1
51348_0,,,,2,2,1,3
C(C(C=O)(C=C)C(CC(C=O)=O)O)=O,,,5,1,1,0,1
51350_0,,,,2,2,1,3
C(C(C=O)(C=C)C(C=O)(C(C)=O)O)=O,,,5,1,1,0,1
51352_0,,,,2,2,1,3
C(C(C=O)(C=C)C(C(C(C)=O)=O)O)=O,,,5,1,1,0,1
51354_0,,,,2,2,1,3
C(C(C=O)(C=C)C(C(C=O)=O)(C)O)=O,,,5,1,1,0,1
51356_0,,,,2,2,1,3
C(C(C=O)(C=C)C(C=O)(C=C)O)=O,,,5,1,1,0,1
51358_0,,,,2,2,1,3
C(C(C=O)(C=C)C(C(C=C)=O)O)=O,,,5,1,1,0,1
51360_0,,,,2,2,1,3
C(C(C=O)(C=C)C(C=CC=O)O)=O,,,5,1,1,0,1
51362_0,,,,2,2,1,3
C(C(C=O)(C(O)=O)C=C)=O,,,5,1,2,0,2
51364_0,,,,2,2,1,3
C(C(C=O)(C=C)C(C(O)O)O)=O,,,5,1,2,0,2
51366_0,,,,2,2,1,3
C(C(C=O)(C=C)C(C(C)O)O)=O,,,5,1,2,0,2
51368_0,,,,2,2,1,3
C(C(C=O)(C=C)CO)=O,,,5,1,2,0,2
51370_0,,,,2,2,1,3
C(C(C=O)(C=C)C(CO)O)=O,,,5,1,2,0,2
51371_0,,,,2,2,1,3
51371_1,,,,2,2,1,3
51373_0,,,,2,2,1,3
C(C(C=C)C(C(C=O)(C=O)O)O)=O,,,5,1,2,0,2
51373_1,,,,2,2,1,3
51375_0,,,,2,2,1,3
C(C(CO)(C(C(C=O)=CC)O)O)=O,,,5,1,2,0,2
51375_1,,,,2,2,1,3
51377_0,,,,2,2,1,3
C(C(C=O)(C(C(C=O)=CC)O)O)=O,,,5,1,2,0,2
51377_1,,,,2,2,1,3
51379_0,,,,2,2,1,3
C(C(C(C=C)=O)(C(C(C=O)=C)O)O)=O,,,5,1,2,0,2
51379_1,,,,2,2,1,3
51381_0,,,,2,2,1,3
C(C(CO)(C(C(C=O)=C)O)O)=O,,,5,1,3,0,3
51381_1,,,,2,2,1,3
51383_0,,,,2,2,1,3
C(C(CO)(C(C(C=O)=C)O)O)(O)=O,,,5,1,2,0,2
51383_1,,,,2,2,1,3
51385_0,,,,2,2,1,3
C(C(C(C)=O)(C(C(C=O)=C)O)O)=O,,,5,1,2,0,2
51385_1,,,,2,2,1,3
51387_0,,,,2,2,1,3
C(C(C=O)(CO)C(C(C=O)=C)O)=O,,,5,1,1,0,1
51389_0,,,,2,2,1,3
C(C(C(C)O)(C(C(C=O)=C)O)O)=O,,,5,1,2,0,2
51389_1,,,,2,2,1,3
51391_0,,,,2,2,1,3
C(C(C=O)(C(C(C=O)=C)O)O)=O,,,5,1,3,0,3
51391_1,,,,2,2,1,3
51393_0,,,,2,2,1,3
C(C)(C(CO)(C(C(C=O)=C)O)O)=O,,,5,1,2,0,2
51393_1,,,,2,2,1,3
51395_0,,,,2,2,1,3
C1(COCC1(C(C(C=O)=C)O)O)=O,,,5,1,2,0,2
51395_1,,,,2,2,1,3
51397_0,,,,2,2,1,3
C1(C(C(CO1)O)C(C(C=O)=C)O)=O,,,5,1,1,0,1
51399_0,,,,2,2,1,3
C(C)=CC(C(C=C)(C(C=O)=O)CO)O,,,5,1,1,0,1
51401_0,,,,2,2,1,3
C=CC(C(C=O)=O)(CO)C(CC=C)O,,,5,1,1,0,1
51403_0,,,,2,2,1,3
C=CC(C(C=O)=O)(CO)C(C=C)O,,,5,1,1,0,1
51405_0,,,,2,2,1,3
C(C(C(C=C)(C(C=O)=O)CO)O)=O,,,5,1,1,0,1
51407_0,,,,2,2,1,3
C=CC(C(C=O)=O)(CO)C(C)O,,,5,1,2,0,2
51409_0,,,,2,2,1,3
C(C(C=C)(C(C=O)=O)CO)(O)=O,,,5,1,2,0,2
51411_0,,,,2,2,1,3
C=CC(C(C=O)=O)(CO)CO,,,5,1,2,0,2
51413_0,,,,2,2,1,3
C=CC(C(C=O)=O)(CO)C(CO)O,,,5,1,1,0,1
51415_0,,,,2,2,1,3
C(C(C=C)(C(C=CC)O)C(C=O)O)=O,,,5,1,1,0,1
51417_0,,,,2,2,1,3
C(C(C=C)(C(CC=C)O)C(C=O)O)=O,,,5,1,1,0,1
51419_0,,,,2,2,1,3
C(C(C=C)(C(C=C)O)C(C=O)O)=O,,,5,1,1,0,1
51421_0,,,,2,2,1,3
C(C(C=C)(C(C=O)O)C(C=O)O)=O,,,5,1,1,0,1
51423_0,,,,2,2,1,3
C(C(C=C)(C(C)O)C(C=O)O)=O,,,5,1,2,0,2
51425_0,,,,2,2,1,3
C(C(C=O)(C=C)C(C=O)O)(O)=O,,,5,1,2,0,2
51427_0,,,,2,2,1,3
C(C(C=C)(CO)C(C=O)O)=O,,,5,1,2,0,2
51429_0,,,,2,2,1,3
C(C(C=C)(C(CO)O)C(C=O)O)=O,,,5,1,1,0,1
51431_0,,,,2,2,1,3
C(C(C(CO)=O)(C=C)C(C=CC)O)=O,,,5,1,1,0,1
51433_0,,,,2,2,1,3
C(C(C(CO)=O)(C=C)C(CC=C)O)=O,,,5,1,1,0,1
51435_0,,,,2,2,1,3
C(C(C(CO)=O)(C=C)C(C=C)O)=O,,,5,1,1,0,1
51437_0,,,,2,2,1,3
C(C(C(CO)=O)(C=C)C(C=O)O)=O,,,5,1,1,0,1
51439_0,,,,2,2,1,3
C(C(C(CO)=O)(C=C)C(C)O)=O,,,5,1,2,0,2
51441_0,,,,2,2,1,3
C(C(C=O)(C(CO)=O)C=C)(O)=O,,,5,1,2,0,2
51443_0,,,,2,2,1,3
C(C(C(CO)=O)(C=C)CO)=O,,,5,1,2,0,2
51445_0,,,,2,2,1,3
C(C(C(CO)=O)(C=C)C(CO)O)=O,,,5,1,1,0,1
51447_0,,,,2,2,1,3
C(C(C(CC=C)=O)(C(C=CC)O)O)=O,,,5,1,2,0,2
51447_1,,,,2,2,1,3
51449_0,,,,2,2,1,3
C(C(C(CC=C)=O)(C(CC=C)O)O)=O,,,5,1,2,0,2
51449_1,,,,2,2,1,3
51451_0,,,,2,2,1,3
C(C(C(CC=C)=O)(C(C=C)O)O)=O,,,5,1,2,0,2
51451_1,,,,2,2,1,3
51453_0,,,,2,2,1,3
C(C(C(CC=C)=O)(C(C=O)O)O)=O,,,5,1,2,0,2
51453_1,,,,2,2,1,3
51455_0,,,,2,2,1,3
C(C(C(CC=C)=O)(C(C)O)O)=O,,,5,1,3,0,3
51455_1,,,,2,2,1,3
51457_0,,,,2,2,1,3
C(C(C=O)(C(CC=C)=O)O)(O)=O,,,5,1,3,0,3
51457_1,,,,2,2,1,3
51459_0,,,,2,2,1,3
C(C(C(CC=C)=O)(CO)O)=O,,,5,1,3,0,3
51459_1,,,,2,2,1,3
51461_0,,,,2,2,1,3
C(C(C(CC=C)=O)(C(CO)O)O)=O,,,5,1,2,0,2
51461_1,,,,2,2,1,3
51463_0,,,,2,2,1,3
C(C(C(C=CC)=O)(C(C=CC)O)O)=O,,,5,1,2,0,2
51463_1,,,,2,2,1,3
51465_0,,,,2,2,1,3
C(C(C(C=CC)=O)(C(CC=C)O)O)=O,,,5,1,2,0,2
51465_1,,,,2,2,1,3
51467_0,,,,2,2,1,3
C(C(C(C=CC)=O)(C(C=C)O)O)=O,,,5,1,2,0,2
51467_1,,,,2,2,1,3
51469_0,,,,2,2,1,3
C(C(C(C=CC)=O)(C(C=O)O)O)=O,,,5,1,2,0,2
51469_1,,,,2,2,1,3
51471_0,,,,2,2,1,3
C(C(C(C=CC)=O)(C(C)O)O)=O,,,5,1,3,0,3
51471_1,,,,2,2,1,3
51473_0,,,,2,2,1,3
C(C(C=O)(C(C=CC)=O)O)(O)=O,,,5,1,3,0,3
51473_1,,,,2,2,1,3
51475_0,,,,2,2,1,3
C(C(C(C=CC)=O)(CO)O)=O,,,5,1,3,0,3
51475_1,,,,2,2,1,3
51477_0,,,,2,2,1,3
C(C(C(C=CC)=O)(C(CO)O)O)=O,,,5,1,2,0,2
51477_1,,,,2,2,1,3
51479_0,,,,2,2,1,3
C(C(C(C=CC=O)=O)(C(C=C)O)O)=O,,,5,1,2,0,2
51479_1,,,,2,2,1,3
51481_0,,,,2,2,1,3
C(C(C(C=CC=O)=O)(C(C)O)O)=O,,,5,1,2,0,2
51481_1,,,,2,2,1,3
51483_0,,,,2,2,1,3
C(C(C=O)(C(C=CC=O)=O)O)(O)=O,,,5,1,2,0,2
51483_1,,,,2,2,1,3
51485_0,,,,2,2,1,3
C(C(C(C=CC=O)=O)(CO)O)=O,,,5,1,4,0,4
51485_1,,,,2,2,1,3
51487_0,,,,2,2,1,3
C(C(C(C=C)=O)(C(C=CC)O)O)=O,,,5,1,2,0,2
51487_1,,,,2,2,1,3
51489_0,,,,2,2,1,3
C(C(C(C=C)=O)(C(CC=C)O)O)=O,,,5,1,2,0,2
51489_1,,,,2,2,1,3
51491_0,,,,2,2,1,3
C(C(C(C=C)=O)(C(C=C)O)O)=O,,,5,1,2,0,2
51491_1,,,,2,2,1,3
51493_0,,,,2,2,1,3
C(C(C(C=C)=O)(C1(C=COC1)O)O)=O,,,5,1,2,0,2
51493_1,,,,2,2,1,3
51495_0,,,,2,2,1,3
C(C(C(C=C)=O)(C(C=O)O)O)=O,,,5,1,4,0,4
51495_1,,,,2,2,1,3
51497_0,,,,2,2,1,3
C(C(C(C=C)=O)(C(C(O)=O)O)O)=O,,,5,1,2,0,2
51497_1,,,,2,2,1,3
51499_0,,,,2,2,1,3
C(C(C(C=C)=O)(C(C=O)(C)O)O)=O,,,5,1,2,0,2
51499_1,,,,2,2,1,3
51501_0,,,,2,2,1,3
C(C(C(C=C)=O)(C(C(C)=O)O)O)=O,,,5,1,2,0,2
51501_1,,,,2,2,1,3
51503_0,,,,2,2,1,3
C(C(C(C=C)=O)(C(CC=O)O)O)=O,,,5,1,2,0,2
51503_1,,,,2,2,1,3
51505_0,,,,2,2,1,3
C(C(C(C=C)=O)(C(C)O)O)=O,,,5,1,3,0,3
51505_1,,,,2,2,1,3
51507_0,,,,2,2,1,3
C(C(C(C=C)=O)(C(CCO)O)O)=O,,,5,1,2,0,2
51507_1,,,,2,2,1,3
51509_0,,,,2,2,1,3
C(C(C(C=C)=O)(C(CO)(C)O)O)=O,,,5,1,2,0,2
51509_1,,,,2,2,1,3
51511_0,,,,2,2,1,3
C(C(C=C)(C(C=O)(C(C=C)=O)O)O)=O,,,5,1,2,0,2
51511_1,,,,2,2,1,3
51513_0,,,,2,2,1,3
C(C(C(C=C)=O)(C(C(C=C)=O)O)O)=O,,,5,1,2,0,2
51513_1,,,,2,2,1,3
51515_0,,,,2,2,1,3
C(C(C(C=C)=O)(C(C=CC=O)O)O)=O,,,5,1,2,0,2
51515_1,,,,2,2,1,3
51517_0,,,,2,2,1,3
C(C(C=O)(C(C=C)=O)O)(O)=O,,,5,1,3,0,3
51517_1,,,,2,2,1,3
51519_0,,,,2,2,1,3
C(C(C(C=C)=O)(C(C(O)O)O)O)=O,,,5,1,2,0,2
51519_1,,,,2,2,1,3
51521_0,,,,2,2,1,3
C(C(C(C=C)=O)(C(C(C)O)O)O)=O,,,5,1,2,0,2
51521_1,,,,2,2,1,3
51522_0,,,,2,2,1,3
51522_1,,,,2,2,1,3
51524_0,,,,2,2,1,3
C(C(C(C=C)=O)(C(CO)O)O)=O,,,5,1,4,0,4
51524_1,,,,2,2,1,3
51526_0,,,,2,2,1,3
C(C(C(C=CCO)=O)(C(C)O)O)=O,,,5,1,2,0,2
51526_1,,,,2,2,1,3
51528_0,,,,2,2,1,3
C(C(C=O)(C(C=CCO)=O)O)(O)=O,,,5,1,2,0,2
51528_1,,,,2,2,1,3
51530_0,,,,2,2,1,3
C(C(C(C=CCO)=O)(CO)O)=O,,,5,1,4,0,4
51530_1,,,,2,2,1,3
51532_0,,,,2,2,1,3
C1(C(C(C(O)O1)O)C(C=CC)O)=O,,,5,1,1,0,1
51534_0,,,,2,2,1,3
C(C)=CC(C1(C(C(OC1)=O)=O)O)O,,,5,1,2,0,2
51534_1,,,,2,2,1,3
51536_0,,,,2,2,1,3
C(C(CO)(C(C=CC)O)O)=O,,,5,1,3,0,3
51536_1,,,,2,2,1,3
51538_0,,,,2,2,1,3
C(C(C(CO)O)(C(C=CC)O)O)=O,,,5,1,2,0,2
51538_1,,,,2,2,1,3
51540_0,,,,2,2,1,3
C(C(C(C=O)(C(C=CC)O)O)O)=O,,,5,1,2,0,2
51540_1,,,,2,2,1,3
51542_0,,,,2,2,1,3
C(CO)(C(CO)(C(C=CC)O)O)=O,,,5,1,2,0,2
51542_1,,,,2,2,1,3
51544_0,,,,2,2,1,3
C(C(CO)(C(C=CC)O)O)(O)=O,,,5,1,3,0,3
51544_1,,,,2,2,1,3
51546_0,,,,2,2,1,3
C(C(C(C)=O)(C(C=CC)O)O)=O,,,5,1,3,0,3
51546_1,,,,2,2,1,3
51548_0,,,,2,2,1,3
C(C)=CC(C(C(C=O)=O)(CO)O)O,,,5,1,2,0,2
51548_1,,,,2,2,1,3
51550_0,,,,2,2,1,3
C(C(C=O)(C(C)O)C(C=CC)O)=O,,,5,1,1,0,1
51552_0,,,,2,2,1,3
C(C(C=O)(CO)C(C=CC)O)=O,,,5,1,2,0,2
51554_0,,,,2,2,1,3
C(C(C(C)O)(C(C=CC)O)O)=O,,,5,1,3,0,3
51554_1,,,,2,2,1,3
51556_0,,,,2,2,1,3
C(C(C(C=O)=O)(C(C=CC)O)O)=O,,,5,1,2,0,2
51556_1,,,,2,2,1,3
51558_0,,,,2,2,1,3
C(C(C(CO)=O)(C(C=CC)O)O)=O,,,5,1,2,0,2
51558_1,,,,2,2,1,3
51560_0,,,,2,2,1,3
C(C(C=O)(C(C=CC)O)O)=O,,,5,1,3,0,3
51560_1,,,,2,2,1,3
51562_0,,,,2,2,1,3
C(C)(C(CO)(C(C=CC)O)O)=O,,,5,1,3,0,3
51562_1,,,,2,2,1,3
51564_0,,,,2,2,1,3
C(C(C(C=O)O)C(C=CC)O)(O)=O,,,5,1,1,0,1
51566_0,,,,2,2,1,3
C(C(C(C)=O)(C(C=CC)O)O)(O)=O,,,5,1,2,0,2
51566_1,,,,2,2,1,3
51568_0,,,,2,2,1,3
C(C(C(C)O)(C(C=CC)O)O)(O)=O,,,5,1,2,0,2
51568_1,,,,2,2,1,3
51570_0,,,,2,2,1,3
C1(COCC1(C(C=CC)O)O)=O,,,5,1,3,0,3
51570_1,,,,2,2,1,3
51572_0,,,,2,2,1,3
C1(C(C(CO1)O)C(C=CC)O)=O,,,5,1,2,0,2
51574_0,,,,2,2,1,3
C1(C(O)OCC1(C(C=CC)O)O)=O,,,5,1,2,0,2
51574_1,,,,2,2,1,3
51576_0,,,,2,2,1,3
C1(C(C(CO1)O)(C(C=CC)O)O)=O,,,5,1,2,0,2
51576_1,,,,2,2,1,3
51578_0,,,,2,2,1,3
C1(C(C(CC=C)O)C(C(O)O1)O)=O,,,5,1,1,0,1
51580_0,,,,2,2,1,3
C=CCC(C1(C(C(OC1)=O)=O)O)O,,,5,1,2,0,2
51580_1,,,,2,2,1,3
51582_0,,,,2,2,1,3
C(C(CO)(C(CC=C)O)O)=O,,,5,1,3,0,3
51582_1,,,,2,2,1,3
51584_0,,,,2,2,1,3
C(C(C(CC=C)O)(C(CO)O)O)=O,,,5,1,2,0,2
51584_1,,,,2,2,1,3
51586_0,,,,2,2,1,3
C(C(C(CC=C)O)(C(C=O)O)O)=O,,,5,1,2,0,2
51586_1,,,,2,2,1,3
51588_0,,,,2,2,1,3
C(CO)(C(CO)(C(CC=C)O)O)=O,,,5,1,2,0,2
51588_1,,,,2,2,1,3
51590_0,,,,2,2,1,3
C(C(CO)(C(CC=C)O)O)(O)=O,,,5,1,3,0,3
51590_1,,,,2,2,1,3
51592_0,,,,2,2,1,3
C(C(C(C)=O)(C(CC=C)O)O)=O,,,5,1,3,0,3
51592_1,,,,2,2,1,3
51594_0,,,,2,2,1,3
C=CCC(C(C(C=O)=O)(CO)O)O,,,5,1,2,0,2
51594_1,,,,2,2,1,3
51596_0,,,,2,2,1,3
C(C(C=O)(C(CC=C)O)C(C)O)=O,,,5,1,1,0,1
51598_0,,,,2,2,1,3
C(C(C=O)(CO)C(CC=C)O)=O,,,5,1,2,0,2
51600_0,,,,2,2,1,3
C(C(C(CC=C)O)(C(C)O)O)=O,,,5,1,3,0,3
51600_1,,,,2,2,1,3
51602_0,,,,2,2,1,3
C(C(C(C=O)=O)(C(CC=C)O)O)=O,,,5,1,2,0,2
51602_1,,,,2,2,1,3
51604_0,,,,2,2,1,3
C(C(C(CO)=O)(C(CC=C)O)O)=O,,,5,1,2,0,2
51604_1,,,,2,2,1,3
51606_0,,,,2,2,1,3
C(C(C=O)(C(CC=C)O)O)=O,,,5,1,3,0,3
51606_1,,,,2,2,1,3
51608_0,,,,2,2,1,3
C(C)(C(CO)(C(CC=C)O)O)=O,,,5,1,3,0,3
51608_1,,,,2,2,1,3
51610_0,,,,2,2,1,3
C(C(C(CC=C)O)C(C=O)O)(O)=O,,,5,1,1,0,1
51612_0,,,,2,2,1,3
C(C(C(C)=O)(C(CC=C)O)O)(O)=O,,,5,1,2,0,2
51612_1,,,,2,2,1,3
51614_0,,,,2,2,1,3
C(C(C(CC=C)O)(C(C)O)O)(O)=O,,,5,1,2,0,2
51614_1,,,,2,2,1,3
51616_0,,,,2,2,1,3
C1(COCC1(C(CC=C)O)O)=O,,,5,1,3,0,3
51616_1,,,,2,2,1,3
51618_0,,,,2,2,1,3
C1(C(C(CC=C)O)C(CO1)O)=O,,,5,1,2,0,2
51620_0,,,,2,2,1,3
C1(C(O)OCC1(C(CC=C)O)O)=O,,,5,1,2,0,2
51620_1,,,,2,2,1,3
51622_0,,,,2,2,1,3
C1(C(C(CC=C)O)(C(CO1)O)O)=O,,,5,1,2,0,2
51622_1,,,,2,2,1,3
51624_0,,,,2,2,1,3
C(C(CO)(C(C(C=C)O)O)O)=O,,,5,1,4,0,4
51624_1,,,,2,2,1,3
51626_0,,,,2,2,1,3
C(C(CO)(C(C(C=C)O)O)O)(O)=O,,,5,1,2,0,2
51626_1,,,,2,2,1,3
51628_0,,,,2,2,1,3
C(C(C(C)=O)(C(C(C=C)O)O)O)=O,,,5,1,2,0,2
51628_1,,,,2,2,1,3
51630_0,,,,2,2,1,3
C(C(C=O)(CO)C(C(C=C)O)O)=O,,,5,1,1,0,1
51632_0,,,,2,2,1,3
C(C(C(C(C=C)O)O)(C(C)O)O)=O,,,5,1,2,0,2
51632_1,,,,2,2,1,3
51634_0,,,,2,2,1,3
C(C(C=O)(C(C(C=C)O)O)O)=O,,,5,1,4,0,4
51634_1,,,,2,2,1,3
51636_0,,,,2,2,1,3
C(C)(C(CO)(C(C(C=C)O)O)O)=O,,,5,1,2,0,2
51636_1,,,,2,2,1,3
51638_0,,,,2,2,1,3
C1(COCC1(C(C(C=C)O)O)O)=O,,,5,1,2,0,2
51638_1,,,,2,2,1,3
51640_0,,,,2,2,1,3
C1(C(C(C(C=C)O)O)C(CO1)O)=O,,,5,1,1,0,1
51642_0,,,,2,2,1,3
C(C=CC(C(CO)(C(C)O)O)=O)=O,,,5,1,2,0,2
51642_1,,,,2,2,1,3
51644_0,,,,2,2,1,3
C(C(C(C=CC=O)=O)(CO)O)(O)=O,,,5,1,2,0,2
51644_1,,,,2,2,1,3
51646_0,,,,2,2,1,3
C(C=CC(C(CO)(CO)O)=O)=O,,,5,1,4,0,4
51646_1,,,,2,2,1,3
51648_0,,,,2,2,1,3
C(C(C(C=C)=O)(C(C=C)O)O)(O)=O,,,5,1,2,0,2
51648_1,,,,2,2,1,3
51650_0,,,,2,2,1,3
C(C1(C(CC(O1)O)O)C(C=C)O)=O,,,5,1,2,0,2
51650_1,,,,2,2,1,3
51652_0,,,,2,2,1,3
C(C1(COC(C1O)O)C(C=C)O)=O,,,5,1,1,0,1
51654_0,,,,2,2,1,3
C1(C(O)OC(C)C1(C(C=C)O)O)=O,,,5,1,2,0,2
51654_1,,,,2,2,1,3
51656_0,,,,2,2,1,3
C1(C(C(C(O)O1)O)C(C=C)O)=O,,,5,1,1,0,1
51658_0,,,,2,2,1,3
C=CC(C1(C(C(OC1O)=O)=O)O)O,,,5,1,2,0,2
51658_1,,,,2,2,1,3
51660_0,,,,2,2,1,3
C1(C(C(C(O)O1)=O)(C(C=C)O)O)=O,,,5,1,2,0,2
51660_1,,,,2,2,1,3
51662_0,,,,2,2,1,3
C1(C(C(C(O1)=O)(C(C=C)O)O)O)=O,,,5,1,2,0,2
51662_1,,,,2,2,1,3
51664_0,,,,2,2,1,3
C=CC(C1(C(C(OC1)=O)=O)O)O,,,5,1,2,0,2
51664_1,,,,2,2,1,3
51666_0,,,,2,2,1,3
C(CC(C=O)(C(C)O)C(C=C)O)=O,,,5,1,2,0,2
51668_0,,,,2,2,1,3
C(C(CO)(C(C=C)O)O)=O,,,5,1,5,0,5
51668_1,,,,2,2,1,3
51670_0,,,,2,2,1,3
C(C(C(CO)O)(C(C=C)O)O)=O,,,5,1,4,0,4
51670_1,,,,2,2,1,3
51671_0,,,,2,2,1,3
51671_1,,,,2,2,1,3
51673_0,,,,2,2,1,3
C(CO)(C(CO)(C(C=C)O)O)=O,,,5,1,4,0,4
51673_1,,,,2,2,1,3
51675_0,,,,2,2,1,3
C(C(CO)(C(C=C)O)O)(O)=O,,,5,1,4,0,4
51675_1,,,,2,2,1,3
51677_0,,,,2,2,1,3
C(C(C(CO)O)(C(C=C)O)O)(O)=O,,,5,1,2,0,2
51677_1,,,,2,2,1,3
51679_0,,,,2,2,1,3
C(C(C(C=O)(C(C=C)O)O)O)(O)=O,,,5,1,3,0,3
51679_1,,,,2,2,1,3
51681_0,,,,2,2,1,3
C(C(C(C=O)O)(C(C=C)O)O)(O)=O,,,5,1,2,0,2
51681_1,,,,2,2,1,3
51683_0,,,,2,2,1,3
C(C(C(C)=O)(C(C=C)O)O)=O,,,5,1,4,0,4
51683_1,,,,2,2,1,3
51685_0,,,,2,2,1,3
C=CC(C(C(C=O)=O)(CO)O)O,,,5,1,4,0,4
51685_1,,,,2,2,1,3
51687_0,,,,2,2,1,3
C(CO)(C(C(C)O)(C(C=C)O)O)=O,,,5,1,2,0,2
51687_1,,,,2,2,1,3
51689_0,,,,2,2,1,3
C(C(C)(C(C=O)(C(C=C)O)O)O)=O,,,5,1,3,0,3
51689_1,,,,2,2,1,3
51690_0,,,,2,2,1,3
51690_1,,,,2,2,1,3
51692_0,,,,2,2,1,3
C(C(C(C(C)=O)(C(C=C)O)O)O)=O,,,5,1,2,0,2
51692_1,,,,2,2,1,3
51694_0,,,,2,2,1,3
C(CC(C(C=O)(C(C=C)O)O)O)=O,,,5,1,2,0,2
51694_1,,,,2,2,1,3
51696_0,,,,2,2,1,3
C(C(C=O)(C(C)O)C(C=C)O)=O,,,5,1,3,0,3
51698_0,,,,2,2,1,3
C(C(C=O)(C(C=C)O)C(C=O)O)=O,,,5,1,1,0,1
51700_0,,,,2,2,1,3
C(C(C=O)(CO)C(C=C)O)=O,,,5,1,3,0,3
51702_0,,,,2,2,1,3
C(C(C=O)(C(CO)O)C(C=C)O)=O,,,5,1,1,0,1
51704_0,,,,2,2,1,3
C=CC(C(C(C=O)=O)(CO)CO)O,,,5,1,1,0,1
51706_0,,,,2,2,1,3
C(C(CO)(C(C=O)O)C(C=C)O)=O,,,5,1,1,0,1
51708_0,,,,2,2,1,3
C(CO)(C(C=O)(CO)C(C=C)O)=O,,,5,1,1,0,1
51710_0,,,,2,2,1,3
C(C(CO)(C(C=C)O)O)(CC=O)=O,,,5,1,2,0,2
51710_1,,,,2,2,1,3
51712_0,,,,2,2,1,3
C(CCO)(C(C=O)(C(C=C)O)O)=O,,,5,1,2,0,2
51712_1,,,,2,2,1,3
51714_0,,,,2,2,1,3
C=CC(C(C(C=O)=O)(C(C)O)O)O,,,5,1,2,0,2
51714_1,,,,2,2,1,3
51716_0,,,,2,2,1,3
C(C(C(C)O)(C(C=C)O)O)=O,,,5,1,4,0,4
51716_1,,,,2,2,1,3
51718_0,,,,2,2,1,3
C(C(C(C=O)=O)(C(C=C)O)O)=O,,,5,1,4,0,4
51718_1,,,,2,2,1,3
51720_0,,,,2,2,1,3
C(C(C(CO)=O)(C(C=C)O)O)=O,,,5,1,4,0,4
51720_1,,,,2,2,1,3
51722_0,,,,2,2,1,3
C(C(C(CO)=O)(C(C=C)O)O)(O)=O,,,5,1,2,0,2
51722_1,,,,2,2,1,3
51724_0,,,,2,2,1,3
C(C(C=O)(C(C=C)O)O)=O,,,5,1,4,0,4
51724_1,,,,2,2,1,3
51726_0,,,,2,2,1,3
C(C)(C(CO)(C(C=C)O)O)=O,,,5,1,4,0,4
51726_1,,,,2,2,1,3
51728_0,,,,2,2,1,3
C(C(C(C=O)O)C(C=C)O)(O)=O,,,5,1,3,0,3
51730_0,,,,2,2,1,3
C(C(C(C)=O)(C(C=C)O)O)(O)=O,,,5,1,4,0,4
51730_1,,,,2,2,1,3
51732_0,,,,2,2,1,3
C=CC(C(C(C(O)=O)=O)(CO)O)O,,,5,1,2,0,2
51732_1,,,,2,2,1,3
51734_0,,,,2,2,1,3
C(C(C(C)O)(C(C=C)O)O)(O)=O,,,5,1,4,0,4
51734_1,,,,2,2,1,3
51736_0,,,,2,2,1,3
C(C(C(C=O)=O)(CO)C(C=C)O)=O,,,5,1,1,0,1
51738_0,,,,2,2,1,3
C1(COCC1(C(C=C)O)O)=O,,,5,1,4,0,4
51738_1,,,,2,2,1,3
51740_0,,,,2,2,1,3
C1(C(C(CO1)O)C(C=C)O)=O,,,5,1,3,0,3
51742_0,,,,2,2,1,3
C1(C(C(C(O)O1)O)(C(C=C)O)O)=O,,,5,1,2,0,2
51742_1,,,,2,2,1,3
51744_0,,,,2,2,1,3
C1(C(O)OCC1(C(C=C)O)O)=O,,,5,1,4,0,4
51744_1,,,,2,2,1,3
51746_0,,,,2,2,1,3
C1(C(C(CO1)O)(C(C=C)O)O)=O,,,5,1,4,0,4
51746_1,,,,2,2,1,3
51748_0,,,,2,2,1,3
C(C(C(C(O)=O)=O)(C(C=C)O)O)=O,,,5,1,2,0,2
51748_1,,,,2,2,1,3
51750_0,,,,2,2,1,3
C(C(C(C(O)=O)C(C=C)O)O)(O)=O,,,5,1,1,0,1
51752_0,,,,2,2,1,3
C(C(C(C=O)=O)(C(C=C)O)O)(O)=O,,,5,1,2,0,2
51752_1,,,,2,2,1,3
51754_0,,,,2,2,1,3
C=C(C=O)C(C(CO)(C(C)O)O)=O,,,5,1,2,0,2
51754_1,,,,2,2,1,3
51756_0,,,,2,2,1,3
C(C(C(C(C=O)=C)=O)(CO)O)(O)=O,,,5,1,2,0,2
51756_1,,,,2,2,1,3
51758_0,,,,2,2,1,3
C=C(C=O)C(C(CO)(CO)O)=O,,,5,1,3,0,3
51758_1,,,,2,2,1,3
51759_0,,,,2,2,1,3
51759_1,,,,2,2,1,3
51761_0,,,,2,2,1,3
C(C(C(C=C)=O)(C(C)O)O)(O)=O,,,5,1,3,0,3
51761_1,,,,2,2,1,3
51763_0,,,,2,2,1,3
C(C(C(O)=O)(C(C=C)=O)O)(O)=O,,,5,1,3,0,3
51763_1,,,,2,2,1,3
51764_0,,,,2,2,1,3
51764_1,,,,2,2,1,3
51766_0,,,,2,2,1,3
C(C(C(C=C)=O)(C(CO)O)O)(O)=O,,,5,1,2,0,2
51766_1,,,,2,2,1,3
51768_0,,,,2,2,1,3
C(C=CC(C(CO)(CO)O)=O)(O)=O,,,5,1,2,0,2
51768_1,,,,2,2,1,3
51770_0,,,,2,2,1,3
C(C(C(C=CCO)=O)(CO)O)(O)=O,,,5,1,2,0,2
51770_1,,,,2,2,1,3
51772_0,,,,2,2,1,3
C(C(CO)(C1(C=COC1)O)O)=O,,,5,1,3,0,3
51772_1,,,,2,2,1,3
51774_0,,,,2,2,1,3
C(C(CO)(C1(C=COC1)O)O)(O)=O,,,5,1,2,0,2
51774_1,,,,2,2,1,3
51776_0,,,,2,2,1,3
C(C(C(C)=O)(C1(C=COC1)O)O)=O,,,5,1,2,0,2
51776_1,,,,2,2,1,3
51778_0,,,,2,2,1,3
C(C(C=O)(CO)C1(C=COC1)O)=O,,,5,1,1,0,1
51780_0,,,,2,2,1,3
C(C(C(C)O)(C1(C=COC1)O)O)=O,,,5,1,2,0,2
51780_1,,,,2,2,1,3
51782_0,,,,2,2,1,3
C(C(C=O)(C1(C=COC1)O)O)=O,,,5,1,3,0,3
51782_1,,,,2,2,1,3
51784_0,,,,2,2,1,3
C(C)(C(CO)(C1(C=COC1)O)O)=O,,,5,1,2,0,2
51784_1,,,,2,2,1,3
51786_0,,,,2,2,1,3
C1(COCC1(C2(C=COC2)O)O)=O,,,5,1,2,0,2
51786_1,,,,2,2,1,3
51788_0,,,,2,2,1,3
C1(C(C(CO1)O)C2(C=COC2)O)=O,,,5,1,1,0,1
51789_0,,,,2,2,1,3
51789_1,,,,2,2,1,3
51791_0,,,,2,2,1,3
C(C1(C(O)OCC1(CO)O)CO)=O,,,5,1,2,0,2
51792_0,,,,2,2,1,3
51792_1,,,,2,2,1,3
51793_0,,,,2,2,1,3
51793_1,,,,2,2,1,3
51795_0,,,,2,2,1,3
C(C1(C(O)OC(C1O)=O)C(C)O)=O,,,5,1,2,0,2
51797_0,,,,2,2,1,3
C(C1(C=O)C(O)OC(C1O)=O)(O)=O,,,5,1,2,0,2
51799_0,,,,2,2,1,3
C(C1(CO)C(O)OC(C1O)=O)=O,,,5,1,2,0,2
51800_0,,,,2,2,1,3
51800_1,,,,2,2,1,3
51801_0,,,,2,2,1,3
51801_1,,,,2,2,1,3
51803_0,,,,2,2,1,3
C1(C(CO)(C(C(C=O)(O)O1)O)O)=O,,,5,1,3,0,3
51803_1,,,,2,2,1,3
51804_0,,,,2,2,1,3
51804_1,,,,2,2,1,3
51805_0,,,,2,2,1,3
51805_1,,,,2,2,1,3
51807_0,,,,2,2,1,3
C(C)(C1(CO)C(C(C(O1)O)=O)O)=O,,,5,1,3,0,3
51807_1,,,,2,2,1,3
51808_0,,,,2,2,1,3
51808_1,,,,2,2,1,3
51809_0,,,,2,2,1,3
51809_1,,,,2,2,1,3
51810_0,,,,2,2,1,3
51810_1,,,,2,2,1,3
51812_0,,,,2,2,1,3
C(C1(C(C)O)C(CC(O1)O)O)=O,,,5,1,3,0,3
51812_1,,,,2,2,1,3
51814_0,,,,2,2,1,3
C(C1(C=O)C(CC(O1)O)O)(O)=O,,,5,1,3,0,3
51814_1,,,,2,2,1,3
51815_0,,,,2,2,1,3
51815_1,,,,2,2,1,3
51816_0,,,,2,2,1,3
51816_1,,,,2,2,1,3
51818_0,,,,2,2,1,3
C(C1(C(O)OCC1(C=O)O)CO)=O,,,5,1,2,0,2
51820_0,,,,2,2,1,3
C1(C(O)OC(C)C1(CO)C(C)O)=O,,,5,1,2,0,2
51822_0,,,,2,2,1,3
C(C1(C(C(O)OC1C)=O)CO)(O)=O,,,5,1,2,0,2
51824_0,,,,2,2,1,3
C1(C(O)OC(C)C1(CO)CO)=O,,,5,1,2,0,2
51826_0,,,,2,2,1,3
C1(C(OC(C=O)C1(CO)CO)O)=O,,,5,1,2,0,2
51828_0,,,,2,2,1,3
C(C(C1(COC(C1O)O)CO)=O)=O,,,5,1,2,0,2
51830_0,,,,2,2,1,3
C1(C(O)OC(CO)C1(CO)CO)=O,,,5,1,2,0,2
51831_0,,,,2,2,1,3
51831_1,,,,2,2,1,3
51833_0,,,,2,2,1,3
C(C1(C(C)OC(C1O)O)C(C)O)=O,,,5,1,2,0,2
51835_0,,,,2,2,1,3
C(C1(C=O)C(C)OC(C1O)O)(O)=O,,,5,1,2,0,2
51837_0,,,,2,2,1,3
C(C1(CO)C(C)OC(C1O)O)=O,,,5,1,2,0,2
51839_0,,,,2,2,1,3
C(C1(CO)C(C(OC1C=O)O)O)=O,,,5,1,2,0,2
51841_0,,,,2,2,1,3
C(C1(COC(C1O)O)C(C=O)O)=O,,,5,1,2,0,2
51843_0,,,,2,2,1,3
C(C1(COC(C1O)O)C(C)O)=O,,,5,1,2,0,2
51845_0,,,,2,2,1,3
C(C1(C=O)COC(C1O)O)(O)=O,,,5,1,2,0,2
51847_0,,,,2,2,1,3
C(C1(COC(C1O)O)CO)=O,,,5,1,2,0,2
51849_0,,,,2,2,1,3
C(C1(COC(C1O)O)C(CO)O)=O,,,5,1,2,0,2
51851_0,,,,2,2,1,3
C(C1(CO)C(CO)OC(C1O)O)=O,,,5,1,2,0,2
51852_0,,,,2,2,1,3
51852_1,,,,2,2,1,3
51853_0,,,,2,2,1,3
51853_1,,,,2,2,1,3
51855_0,,,,2,2,1,3
C(C1(CO)C(CO)(O)OCC1O)=O,,,5,1,2,0,2
51857_0,,,,2,2,1,3
C(C)(C1(C(C)O)C(CC(O1)O)O)=O,,,5,1,3,0,3
51857_1,,,,2,2,1,3
51858_0,,,,2,2,1,3
51858_1,,,,2,2,1,3
51859_0,,,,2,2,1,3
51859_1,,,,2,2,1,3
51860_0,,,,2,2,1,3
51860_1,,,,2,2,1,3
51862_0,,,,2,2,1,3
C(C1(C(C)O)C(C)(CC(O1)O)O)=O,,,5,1,3,0,3
51862_1,,,,2,2,1,3
51864_0,,,,2,2,1,3
C(C1(C=O)C(C)(CC(O1)O)O)(O)=O,,,5,1,3,0,3
51864_1,,,,2,2,1,3
51866_0,,,,2,2,1,3
C(C1(CO)C(C)(CC(O1)O)O)=O,,,5,1,3,0,3
51866_1,,,,2,2,1,3
51867_0,,,,2,2,1,3
51867_1,,,,2,2,1,3
51869_0,,,,2,2,1,3
C(C(CO)(C1(CC(CO1)O)O)O)=O,,,5,1,3,0,3
51869_1,,,,2,2,1,3
51871_0,,,,2,2,1,3
C1(C(O)OC(C)C1(C(C=O)O)O)=O,,,5,1,3,0,3
51871_1,,,,2,2,1,3
51873_0,,,,2,2,1,3
C1(C(O)OC(C)C1(C(C)O)O)=O,,,5,1,3,0,3
51873_1,,,,2,2,1,3
51875_0,,,,2,2,1,3
C(C1(C(C(O)OC1C)=O)O)(O)=O,,,5,1,3,0,3
51875_1,,,,2,2,1,3
51876_0,,,,2,2,1,3
51876_1,,,,2,2,1,3
51878_0,,,,2,2,1,3
C1(C(O)OC(C)C1(C(CO)O)O)=O,,,5,1,3,0,3
51878_1,,,,2,2,1,3
51880_0,,,,2,2,1,3
C(C1(C(C)O)C(C(C(O1)O)=O)O)=O,,,5,1,3,0,3
51880_1,,,,2,2,1,3
51882_0,,,,2,2,1,3
C(C1(C=O)C(C(C(O1)O)=O)O)(O)=O,,,5,1,3,0,3
51882_1,,,,2,2,1,3
51883_0,,,,2,2,1,3
51883_1,,,,2,2,1,3
51885_0,,,,2,2,1,3
C1(C(OC(C=O)C1(C(C)O)O)O)=O,,,5,1,3,0,3
51885_1,,,,2,2,1,3
51887_0,,,,2,2,1,3
C(C1(C(C(O)OC1C=O)=O)O)(O)=O,,,5,1,3,0,3
51887_1,,,,2,2,1,3
51888_0,,,,2,2,1,3
51888_1,,,,2,2,1,3
51890_0,,,,2,2,1,3
C1(C(O)OC(CO)C1(C(C)O)O)=O,,,5,1,3,0,3
51890_1,,,,2,2,1,3
51891_0,,,,2,2,1,3
51891_1,,,,2,2,1,3
51892_0,,,,2,2,1,3
51892_1,,,,2,2,1,3
51893_0,,,,2,2,1,3
51893_1,,,,2,2,1,3
51895_0,,,,2,2,1,3
C1(C(C(C(O)O1)O)C(C=O)O)=O,,,5,1,3,0,3
51897_0,,,,2,2,1,3
C1(C(C(C(O)O1)O)C(C(O)=O)O)=O,,,5,1,2,0,2
51899_0,,,,2,2,1,3
C1(C(C(C(O)O1)O)C(C=O)(C)O)=O,,,5,1,2,0,2
51901_0,,,,2,2,1,3
C1(C(C(C(O)O1)O)C(C(C)=O)O)=O,,,5,1,2,0,2
51903_0,,,,2,2,1,3
C1(C(C(CC=O)O)C(C(O)O1)O)=O,,,5,1,2,0,2
51905_0,,,,2,2,1,3
C1(C(C(C(O)O1)O)C(C)O)=O,,,5,1,2,0,2
51907_0,,,,2,2,1,3
C1(C(C(C(O)O1)O)C(CCO)O)=O,,,5,1,2,0,2
51909_0,,,,2,2,1,3
C1(C(C(C(O)O1)O)C(C)(CO)O)=O,,,5,1,2,0,2
51911_0,,,,2,2,1,3
C1(C(C(O)=O)C(C(O)O1)O)=O,,,5,1,2,0,2
51913_0,,,,2,2,1,3
C1(C(C(C(O)O1)O)C(C(O)O)O)=O,,,5,1,2,0,2
51915_0,,,,2,2,1,3
C1(C(C(C(O)O1)O)C(C(C)O)O)=O,,,5,1,2,0,2
51917_0,,,,2,2,1,3
C1(C(CO)C(C(O)O1)O)=O,,,5,1,2,0,2
51919_0,,,,2,2,1,3
C1(C(C(CO)O)C(C(O)O1)O)=O,,,5,1,3,0,3
51921_0,,,,2,2,1,3
C1(C(C(C)O)(C(C)(C(O)O1)O)O)=O,,,5,1,3,0,3
51921_1,,,,2,2,1,3
51923_0,,,,2,2,1,3
C1(C(C(O)=O)(C(C(O)O1)(C)O)O)=O,,,5,1,3,0,3
51923_1,,,,2,2,1,3
51924_0,,,,2,2,1,3
51924_1,,,,2,2,1,3
51926_0,,,,2,2,1,3
C1(C(C(C)O)(C(C(C)(O)O1)O)O)=O,,,5,1,3,0,3
51926_1,,,,2,2,1,3
51928_0,,,,2,2,1,3
C1(C(C(O)=O)(C(C(C)(O)O1)O)O)=O,,,5,1,3,0,3
51928_1,,,,2,2,1,3
51929_0,,,,2,2,1,3
51929_1,,,,2,2,1,3
51931_0,,,,2,2,1,3
C(C1(C(C)O)C(CC(O1)O)O)(O)=O,,,5,1,3,0,3
51931_1,,,,2,2,1,3
51933_0,,,,2,2,1,3
C(C1(C(O)=O)C(CC(O1)O)O)(O)=O,,,5,1,3,0,3
51933_1,,,,2,2,1,3
51934_0,,,,2,2,1,3
51934_1,,,,2,2,1,3
51935_0,,,,2,2,1,3
51935_1,,,,2,2,1,3
51937_0,,,,2,2,1,3
C(C1(CO)C(COC1(C=O)O)O)=O,,,5,1,2,0,2
51939_0,,,,2,2,1,3
C(C(C1(C(C(OC1O)=O)=O)O)O)=O,,,5,1,3,0,3
51939_1,,,,2,2,1,3
51941_0,,,,2,2,1,3
C1(C(C(C(O)O1)(C(C)O)O)=O)=O,,,5,1,3,0,3
51941_1,,,,2,2,1,3
51943_0,,,,2,2,1,3
C(C1(C(C(OC1O)=O)=O)O)(O)=O,,,5,1,3,0,3
51943_1,,,,2,2,1,3
51945_0,,,,2,2,1,3
C1(C(C(CO)(C(O)O1)O)=O)=O,,,5,1,3,0,3
51945_1,,,,2,2,1,3
51947_0,,,,2,2,1,3
C1(C(C(C(O)O1)(C(CO)O)O)=O)=O,,,5,1,3,0,3
51947_1,,,,2,2,1,3
51949_0,,,,2,2,1,3
C1(C(C(C(O)O1)=O)(C(C=O)O)O)=O,,,5,1,3,0,3
51949_1,,,,2,2,1,3
51951_0,,,,2,2,1,3
C1(C(C(C(O)O1)=O)(C(C)O)O)=O,,,5,1,3,0,3
51951_1,,,,2,2,1,3
51953_0,,,,2,2,1,3
C1(C(C(O)=O)(C(C(O)O1)=O)O)=O,,,5,1,3,0,3
51953_1,,,,2,2,1,3
51955_0,,,,2,2,1,3
C1(C(C(C(O)O1)=O)(CO)O)=O,,,5,1,3,0,3
51955_1,,,,2,2,1,3
51957_0,,,,2,2,1,3
C1(C(C(C(O)O1)=O)(C(CO)O)O)=O,,,5,1,3,0,3
51957_1,,,,2,2,1,3
51958_0,,,,2,2,1,3
51958_1,,,,2,2,1,3
51959_0,,,,2,2,1,3
51959_1,,,,2,2,1,3
51960_0,,,,2,2,1,3
51960_1,,,,2,2,1,3
51962_0,,,,2,2,1,3
C1(COC(C(C1(C(C)O)O)O)O)=O,,,5,1,3,0,3
51962_1,,,,2,2,1,3
51964_0,,,,2,2,1,3
C(C1(C(COC(C1O)O)=O)O)(O)=O,,,5,1,3,0,3
51964_1,,,,2,2,1,3
51965_0,,,,2,2,1,3
51965_1,,,,2,2,1,3
51966_0,,,,2,2,1,3
51966_1,,,,2,2,1,3
51968_0,,,,2,2,1,3
C1(C(CO)(C(C(C(O)O1)=O)O)O)=O,,,5,1,3,0,3
51968_1,,,,2,2,1,3
51970_0,,,,2,2,1,3
C(C1(C(OCC(C1O)=O)O)CO)=O,,,5,1,2,0,2
51972_0,,,,2,2,1,3
C1(C(O)OCC(C1(CO)CO)O)=O,,,5,1,2,0,2
51973_0,,,,2,2,1,3
51973_1,,,,2,2,1,3
51975_0,,,,2,2,1,3
C(C1(CO)C(C(O)OCC1O)O)=O,,,5,1,2,0,2
51977_0,,,,2,2,1,3
C1(CC(O)OC(C)C1(C(C)O)O)=O,,,5,1,3,0,3
51977_1,,,,2,2,1,3
51979_0,,,,2,2,1,3
C(C1(C(CC(O)OC1C)=O)O)(O)=O,,,5,1,3,0,3
51979_1,,,,2,2,1,3
51981_0,,,,2,2,1,3
C1(CC(O)OC(C)C1(CO)O)=O,,,5,1,3,0,3
51981_1,,,,2,2,1,3
51982_0,,,,2,2,1,3
51982_1,,,,2,2,1,3
51984_0,,,,2,2,1,3
C1(C(CO)(C(C=O)OC(C1)O)O)=O,,,5,1,3,0,3
51984_1,,,,2,2,1,3
51986_0,,,,2,2,1,3
C1(CC(C)OC(C1(C(C)O)O)O)=O,,,5,1,3,0,3
51986_1,,,,2,2,1,3
51988_0,,,,2,2,1,3
C(C1(C(CC(C)OC1O)=O)O)(O)=O,,,5,1,3,0,3
51988_1,,,,2,2,1,3
51990_0,,,,2,2,1,3
C1(CC(C)OC(C1(CO)O)O)=O,,,5,1,3,0,3
51990_1,,,,2,2,1,3
51992_0,,,,2,2,1,3
C(C1(C(CC(C(O1)O)O)=O)CO)=O,,,5,1,3,0,3
51992_1,,,,2,2,1,3
51994_0,,,,2,2,1,3
C1(CC(C=O)OC(C1(CO)O)O)=O,,,5,1,3,0,3
51994_1,,,,2,2,1,3
51995_0,,,,2,2,1,3
51995_1,,,,2,2,1,3
51997_0,,,,2,2,1,3
C1(C(O)OCC(C1(C(C)O)O)O)=O,,,5,1,3,0,3
51997_1,,,,2,2,1,3
51998_0,,,,2,2,1,3
51998_1,,,,2,2,1,3
51999_0,,,,2,2,1,3
51999_1,,,,2,2,1,3
52001_0,,,,2,2,1,3
C1(C(C(C)O)(C(CC(O)O1)O)O)=O,,,5,1,3,0,3
52001_1,,,,2,2,1,3
52003_0,,,,2,2,1,3
C1(C(C(O)=O)(C(CC(O)O1)O)O)=O,,,5,1,3,0,3
52003_1,,,,2,2,1,3
52004_0,,,,2,2,1,3
52004_1,,,,2,2,1,3
52005_0,,,,2,2,1,3
52005_1,,,,2,2,1,3
52006_0,,,,2,2,1,3
52006_1,,,,2,2,1,3
52008_0,,,,2,2,1,3
C1(C(C(C(C=O)=O)(CO)CO1)O)=O,,,5,1,1,0,1
52010_0,,,,2,2,1,3
C1(C(C(C=O)(CO)C(C=O)O1)O)=O,,,5,1,1,0,1
52012_0,,,,2,2,1,3
C1(C(C(C)O)(C(C=O)(CO1)O)O)=O,,,5,1,2,0,2
52012_1,,,,2,2,1,3
52014_0,,,,2,2,1,3
C1(C(C(O)=O)(C(C=O)(CO1)O)O)=O,,,5,1,2,0,2
52014_1,,,,2,2,1,3
52015_0,,,,2,2,1,3
52015_1,,,,2,2,1,3
52017_0,,,,2,2,1,3
C1(C(C(C(O1)=O)(C(C=O)O)O)O)=O,,,5,1,2,0,2
52017_1,,,,2,2,1,3
52019_0,,,,2,2,1,3
C1(C(C(C)O)(C(C(O1)=O)O)O)=O,,,5,1,3,0,3
52019_1,,,,2,2,1,3
52021_0,,,,2,2,1,3
C1(C(C(O)=O)(C(C(O1)=O)O)O)=O,,,5,1,3,0,3
52021_1,,,,2,2,1,3
52022_0,,,,2,2,1,3
52022_1,,,,2,2,1,3
52024_0,,,,2,2,1,3
C1(C(C(CO)O)(C(C(O1)=O)O)O)=O,,,5,1,3,0,3
52024_1,,,,2,2,1,3
52026_0,,,,2,2,1,3
C(C(C1(C(C(OC1)=O)=O)O)O)=O,,,5,1,3,0,3
52026_1,,,,2,2,1,3
52028_0,,,,2,2,1,3
C(C(C1(C(C(OC1)=O)=O)O)O)(O)=O,,,5,1,2,0,2
52028_1,,,,2,2,1,3
52030_0,,,,2,2,1,3
C(C(C)(C1(C(C(OC1)=O)=O)O)O)=O,,,5,1,2,0,2
52030_1,,,,2,2,1,3
52032_0,,,,2,2,1,3
C(C(C1(C(C(OC1)=O)=O)O)O)(C)=O,,,5,1,2,0,2
52032_1,,,,2,2,1,3
52034_0,,,,2,2,1,3
C(CC(C1(C(C(OC1)=O)=O)O)O)=O,,,5,1,2,0,2
52034_1,,,,2,2,1,3
52036_0,,,,2,2,1,3
C1(C(C(CO1)(C(C)O)O)=O)=O,,,5,1,3,0,3
52036_1,,,,2,2,1,3
52038_0,,,,2,2,1,3
C1(C(C(CO1)(C(CCO)O)O)=O)=O,,,5,1,2,0,2
52038_1,,,,2,2,1,3
52040_0,,,,2,2,1,3
C1(C(C(CO1)(C(CO)(C)O)O)=O)=O,,,5,1,2,0,2
52040_1,,,,2,2,1,3
52042_0,,,,2,2,1,3
C(C1(C(C(OC1)=O)=O)O)(O)=O,,,5,1,3,0,3
52042_1,,,,2,2,1,3
52044_0,,,,2,2,1,3
C1(C(C(CO1)(C(C(O)O)O)O)=O)=O,,,5,1,2,0,2
52044_1,,,,2,2,1,3
52046_0,,,,2,2,1,3
C1(C(C(CO1)(C(C(C)O)O)O)=O)=O,,,5,1,2,0,2
52046_1,,,,2,2,1,3
52048_0,,,,2,2,1,3
C1(C(C(CO)(CO1)O)=O)=O,,,5,1,3,0,3
52048_1,,,,2,2,1,3
52050_0,,,,2,2,1,3
C1(C(C(CO1)(C(CO)O)O)=O)=O,,,5,1,3,0,3
52050_1,,,,2,2,1,3
52052_0,,,,2,2,1,3
C1(C(CO)(C(C(O1)=O)(CO)O)O)=O,,,5,1,2,0,2
52052_1,,,,2,2,1,3
52053_0,,,,2,2,1,3
52053_1,,,,2,2,1,3
52055_0,,,,2,2,1,3
C1(C(CO)(C(C=O)(C(C)O1)O)O)=O,,,5,1,2,0,2
52055_1,,,,2,2,1,3
52057_0,,,,2,2,1,3
C1(C(C(C)O)(C(CO)(CO1)O)O)=O,,,5,1,2,0,2
52057_1,,,,2,2,1,3
52059_0,,,,2,2,1,3
C1(C(C(O)=O)(C(CO1)(CO)O)O)=O,,,5,1,2,0,2
52059_1,,,,2,2,1,3
52060_0,,,,2,2,1,3
52060_1,,,,2,2,1,3
52062_0,,,,2,2,1,3
C1(C(C(C)O)(C(C(O1)=O)(C)O)O)=O,,,5,1,2,0,2
52062_1,,,,2,2,1,3
52064_0,,,,2,2,1,3
C1(C(C(O)=O)(C(C(O1)=O)(C)O)O)=O,,,5,1,2,0,2
52064_1,,,,2,2,1,3
52066_0,,,,2,2,1,3
C1(C(CO)(C(C(O1)=O)(C)O)O)=O,,,5,1,3,0,3
52066_1,,,,2,2,1,3
52068_0,,,,2,2,1,3
C1(C(CO)(C(CO1)(CC=O)O)O)=O,,,5,1,2,0,2
52068_1,,,,2,2,1,3
52070_0,,,,2,2,1,3
C1(C(CO)(C(C)(C(C=O)O1)O)O)=O,,,5,1,2,0,2
52070_1,,,,2,2,1,3
52072_0,,,,2,2,1,3
C(C1(CO)C(C)(C(C(O1)=O)O)O)=O,,,5,1,2,0,2
52072_1,,,,2,2,1,3
52074_0,,,,2,2,1,3
C1(C(C(C(C)O)(C(CO)O1)O)=O)=O,,,5,1,2,0,2
52074_1,,,,2,2,1,3
52076_0,,,,2,2,1,3
C(C1(C(C(OC1CO)=O)=O)O)(O)=O,,,5,1,2,0,2
52076_1,,,,2,2,1,3
52078_0,,,,2,2,1,3
C1(C(C(CO)(C(CO)O1)O)=O)=O,,,5,1,3,0,3
52078_1,,,,2,2,1,3
52080_0,,,,2,2,1,3
C1(C(C(C)O)(C(C(CO1)=O)O)O)=O,,,5,1,2,0,2
52080_1,,,,2,2,1,3
52082_0,,,,2,2,1,3
C1(C(C(O)=O)(C(C(CO1)=O)O)O)=O,,,5,1,2,0,2
52082_1,,,,2,2,1,3
52083_0,,,,2,2,1,3
52083_1,,,,2,2,1,3
52085_0,,,,2,2,1,3
C1(COC(C(C1(C(C)O)O)O)=O)=O,,,5,1,2,0,2
52085_1,,,,2,2,1,3
52087_0,,,,2,2,1,3
C(C1(C(COC(C1O)=O)=O)O)(O)=O,,,5,1,2,0,2
52087_1,,,,2,2,1,3
52088_0,,,,2,2,1,3
52088_1,,,,2,2,1,3
52090_0,,,,2,2,1,3
C1(COC(C(C1(C=O)CO)O)=O)=O,,,5,1,1,0,1
52092_0,,,,2,2,1,3
C1(CC(C(OC1(C=O)CO)=O)O)=O,,,5,1,2,0,2
52092_1,,,,2,2,1,3
52094_0,,,,2,2,1,3
C1(C(CO)(C(C=O)(CCO1)O)O)=O,,,5,1,2,0,2
52094_1,,,,2,2,1,3
52096_0,,,,2,2,1,3
C1(C(CO)(C(CC(C=O)O1)O)O)=O,,,5,1,2,0,2
52096_1,,,,2,2,1,3
52098_0,,,,2,2,1,3
C1(C(C)(C(C(CO1)=O)(CO)O)O)=O,,,5,1,2,0,2
52098_1,,,,2,2,1,3
52100_0,,,,2,2,1,3
C1(C(C(C(C)O)(C(CO1)O)O)=O)=O,,,5,1,2,0,2
52100_1,,,,2,2,1,3
52102_0,,,,2,2,1,3
C(C1(C(C(OCC1O)=O)=O)O)(O)=O,,,5,1,2,0,2
52102_1,,,,2,2,1,3
52104_0,,,,2,2,1,3
C1(C(C(CO)(C(CO1)O)O)=O)=O,,,5,1,3,0,3
52104_1,,,,2,2,1,3
52105_0,,,,2,2,1,3
52106_0,,,,2,2,1,3
52107_0,,,,2,2,1,3
52108_0,,,,2,2,1,3
52109_0,,,,2,2,1,3
52110_0,,,,2,2,1,3
52111_0,,,,2,2,1,3
52112_0,,,,2,2,1,3
52113_0,,,,2,2,1,3
52115_0,,,,2,2,1,3
C(C(C(C)O)(C(C)O)CC=O)=O,,,5,1,2,0,2
52117_0,,,,2,2,1,3
C(C(C=O)(C(C)O)CC=O)(O)=O,,,5,1,1,0,1
52118_0,,,,2,2,1,3
52119_0,,,,2,2,1,3
52120_0,,,,2,2,1,3
52121_0,,,,2,2,1,3
52123_0,,,,2,2,1,3
C(CC(C=O)(CO)C(C=O)(O)O)=O,,,5,1,2,0,2
52124_0,,,,2,2,1,3
52126_0,,,,2,2,1,3
C(C([C](C(O)=O)O)(CO)CC=O)=O,,,5,1,2,0,2
52127_0,,,,2,2,1,3
52127_1,,,,2,2,1,3
52128_0,,,,2,2,1,3
52130_0,,,,2,2,1,3
C(C(C=O)(C(O)=O)CCC(O)=O)=O,,,5,1,1,0,1
52131_0,,,,2,2,1,3
52132_0,,,,2,2,1,3
52132_1,,,,2,2,1,3
52134_0,,,,2,2,1,3
C(C(C=O)(C(C(O)=O)=O)C(C)O)=O,,,5,1,2,0,2
52136_0,,,,2,2,1,3
C(C(C=O)(C(O)=O)C(C(O)=O)=O)=O,,,5,1,2,0,2
52138_0,,,,2,2,1,3
C(C(C=O)(C(C(O)=O)=O)CO)=O,,,5,1,2,0,2
52139_0,,,,2,2,1,3
52139_1,,,,2,2,1,3
52140_0,,,,2,1,1,2
52141_0,,,,2,1,1,2
52143_0,,,,2,1,1,2
C(C1(CC(C=O)(CC1O)O)O)(O)=O,,,5,1,1,0,1
52145_0,,,,2,1,1,2
C(C1(C(CC(C(C1)=O)O)O)O)(O)=O,,,5,1,1,0,1
52146_0,,,,2,1,1,2
52148_0,,,,2,1,1,2
C(C1(C(C(CO)C(C1)O)O)O)(O)=O,,,5,1,1,0,1
52150_0,,,,2,1,1,2
C(C1(CC(C(C1(C)O)O)O)O)(O)=O,,,5,1,1,0,1
52152_0,,,,2,1,1,2
C(C1(CC(CC1(CO)O)O)O)(O)=O,,,5,1,1,0,1
52153_0,,,,2,1,1,2
52154_0,,,,2,1,1,2
52155_0,,,,2,1,1,2
52156_0,,,,2,1,1,2
52157_0,,,,2,1,1,2
52158_0,,,,2,1,1,2
52160_0,,,,2,1,1,2
C(C1(CC(C(C)=O)(C(C1)O)O)O)=O,,,5,1,1,0,1
52161_0,,,,2,1,1,2
52163_0,,,,2,1,1,2
C(C)(C1(C(CC(C(C1)=O)O)O)O)=O,,,5,1,1,0,1
52164_0,,,,2,1,1,2
52166_0,,,,2,1,1,2
C(C)(C1(C(C(CO)C(C1)O)O)O)=O,,,5,1,1,0,1
52168_0,,,,2,1,1,2
C(C)(C1(CC(C(C1(C)O)O)O)O)=O,,,5,1,1,0,1
52170_0,,,,2,1,1,2
C(C)(C1(CC(CC1(CO)O)O)O)=O,,,5,1,1,0,1
52172_0,,,,2,1,1,2
C(C1(CC(CC1(C(C)=O)O)O)O)=O,,,5,1,1,0,1
52173_0,,,,2,1,1,2
52174_0,,,,2,1,1,2
52176_0,,,,2,1,1,2
C(C)(C1(C(CC(C1)O)O)O)=O,,,5,1,1,0,1
52178_0,,,,2,1,1,2
C(C)(C1(C(C(C(C1)O)O)O)O)=O,,,5,1,1,0,1
52179_0,,,,2,1,1,2
52180_0,,,,2,1,1,2
52181_0,,,,2,1,1,2
52182_0,,,,2,1,1,2
52184_0,,,,2,1,1,2
C(C1(CC(C=O)(CC1O)O)O)=O,,,5,1,1,0,1
52186_0,,,,2,1,1,2
C(C1(CC(C=O)(C(C1O)O)O)O)=O,,,5,1,1,0,1
52187_0,,,,2,1,1,2
52189_0,,,,2,1,1,2
C(CCO)(C1(C(CC(C1)O)O)O)=O,,,5,1,1,0,1
52191_0,,,,2,1,1,2
C(C1(C(CC(CC(C1)O)O)O)O)=O,,,5,1,1,0,1
52192_0,,,,2,1,1,2
52194_0,,,,2,1,1,2
C(C1(C(C(C(C1)O)C(C)O)O)O)=O,,,5,1,1,0,1
52195_0,,,,2,1,1,2
52197_0,,,,2,1,1,2
C(C1(C(CC(C1C(C)O)O)O)O)=O,,,5,1,1,0,1
52198_0,,,,2,1,1,2
52199_0,,,,2,1,1,2
52200_0,,,,2,1,1,2
52202_0,,,,2,1,1,2
C1(C(C(C(C1(C)O)O)C(C)O)O)=O,,,5,1,1,0,1
52204_0,,,,2,1,1,2
C(CO)(C1(C(CC(C1)O)O)O)=O,,,5,1,1,0,1
52206_0,,,,2,1,1,2
C(CO)(C1(C(C(C(C1)O)O)O)O)=O,,,5,1,1,0,1
52207_0,,,,2,1,1,2
52209_0,,,,2,1,1,2
C1(C(C(CO)C(C1(C)O)O)O)=O,,,5,1,1,0,1
52210_0,,,,2,1,1,2
52212_0,,,,2,1,1,2
C1(C(CC(CO)(C1(C)O)O)O)=O,,,5,1,1,0,1
52214_0,,,,2,1,1,2
C1(C(C)(C(C(O)=O)(CC1O)O)O)=O,,,5,1,1,0,1
52215_0,,,,2,1,1,2
52216_0,,,,2,1,1,2
52218_0,,,,2,1,1,2
C1(C(C)(C(C=O)(CC1O)O)O)=O,,,5,1,2,0,2
52219_0,,,,2,1,1,2
52220_0,,,,2,1,1,2
52222_0,,,,2,1,1,2
C1(C(CC(C1(C)O)O)O)=O,,,5,1,1,0,1
52223_0,,,,2,1,1,2
52224_0,,,,2,1,1,2
52225_0,,,,2,1,1,2
52226_0,,,,2,1,1,2
52228_0,,,,2,1,1,2
C(C1(CC(C(C1(C)O)O)O)O)=O,,,5,1,1,0,1
52229_0,,,,2,1,1,2
52230_0,,,,2,1,1,2
52231_0,,,,2,1,1,2
52233_0,,,,2,1,1,2
C(C1(CC(CO)(CC1O)O)O)=O,,,5,1,1,0,1
52235_0,,,,2,1,1,2
C(C1(CC(CO)(C(C1O)O)O)O)=O,,,5,1,1,0,1
52237_0,,,,2,1,1,2
C(C1(CC(CO)(CC1O)O)O)(O)=O,,,5,1,1,0,1
52238_0,,,,2,1,1,2
52239_0,,,,2,1,1,2
52240_0,,,,2,1,1,2
52241_0,,,,2,1,1,2
52242_0,,,,2,1,1,2
52243_0,,,,2,1,1,2
52244_0,,,,2,1,1,2
52245_0,,,,2,1,1,2
52246_0,,,,2,1,1,2
52248_0,,,,2,1,1,2
C=CC(C1(CC(C(C1O)=O)=O)O)=O,,,5,1,1,0,1
52249_0,,,,2,1,1,2
52251_0,,,,2,1,1,2
C(C1(CC(C(C1O)=O)=O)O)(O)=O,,,5,1,1,0,1
52253_0,,,,2,1,1,2
C(C)(C1(CC(C(C1O)=O)=O)O)=O,,,5,1,2,0,2
52255_0,,,,2,1,1,2
C(CO)(C1(CC(C(C1O)=O)=O)O)=O,,,5,1,1,0,1
52257_0,,,,2,1,1,2
C1(CC(C(C=C)=O)(C(C1O)O)O)=O,,,5,1,1,0,1
52258_0,,,,2,1,1,2
52260_0,,,,2,1,1,2
C(C1(C(CC(C(C1)O)O)O)O)(O)=O,,,5,1,1,0,1
52262_0,,,,2,1,1,2
C(C1(C(C(CC(C1)O)O)O)O)(O)=O,,,5,1,1,0,1
52264_0,,,,2,1,1,2
C(C1(CC(C)(C(C1O)O)O)O)(O)=O,,,5,1,1,0,1
52266_0,,,,2,1,1,2
C(C1(C(CC(C1CO)O)O)O)(O)=O,,,5,1,1,0,1
52267_0,,,,2,1,1,2
52268_0,,,,2,1,1,2
52269_0,,,,2,1,1,2
52270_0,,,,2,1,1,2
52271_0,,,,2,1,1,2
52272_0,,,,2,1,1,2
52274_0,,,,2,1,1,2
C(C1(C(C(C(C(C1)O)O)O)O)O)=O,,,5,1,3,0,3
52275_0,,,,2,1,1,2
52276_0,,,,2,1,1,2
52277_0,,,,2,1,1,2
52279_0,,,,2,1,1,2
C(C1C(C(C)(C(C1O)O)O)=O)=O,,,5,1,1,0,1
52281_0,,,,2,1,1,2
C1(C(C)(C(CC(C1O)=O)O)O)=O,,,5,1,1,0,1
52282_0,,,,2,1,1,2
52284_0,,,,2,1,1,2
C1(C(C)(C(C(C(C1)=O)O)O)O)=O,,,5,1,1,0,1
52285_0,,,,2,1,1,2
52286_0,,,,2,1,1,2
52287_0,,,,2,1,1,2
52289_0,,,,2,1,1,2
C(C(C1(C(CC(C1)O)O)O)=O)=O,,,5,1,1,0,1
52291_0,,,,2,1,1,2
C1(C(CCO)(C(C(C1O)=O)O)O)=O,,,5,1,1,0,1
52292_0,,,,2,1,1,2
52293_0,,,,2,1,1,2
52294_0,,,,2,1,1,2
52296_0,,,,2,1,1,2
C1(C(C)(C(C(C1(CO)O)=O)O)O)=O,,,5,1,1,0,1
52297_0,,,,2,1,1,2
52299_0,,,,2,1,1,2
C(C1(C(C(C)(C(C1)O)O)=O)O)=O,,,5,1,1,0,1
52300_0,,,,2,1,1,2
52301_0,,,,2,1,1,2
52302_0,,,,2,1,1,2
52303_0,,,,2,1,1,2
52304_0,,,,2,1,1,2
52305_0,,,,2,1,1,2
52306_0,,,,2,1,1,2
52308_0,,,,2,1,1,2
C(C1(C(C(C(C1)O)(O)O)O)O)(O)=O,,,5,1,1,0,1
52310_0,,,,2,1,1,2
C(C1(C(C(C)(C(C1)O)O)O)O)(O)=O,,,5,1,1,0,1
52312_0,,,,2,1,1,2
C(C)(C1(C(C(C(C1)O)(O)O)O)O)=O,,,5,1,1,0,1
52314_0,,,,2,1,1,2
C(C)(C1(C(C(C)(C(C1)O)O)O)O)=O,,,5,1,1,0,1
52316_0,,,,2,1,1,2
C1(C(C(C(C1(C)O)O)(O)O)O)=O,,,5,1,1,0,1
52317_0,,,,2,1,1,2
52319_0,,,,2,1,1,2
C(C1(C(C(C(C1)O)(O)O)O)O)=O,,,5,1,1,0,1
52321_0,,,,2,1,1,2
C(C1(C(C(C)(C(C1)O)O)O)O)=O,,,5,1,1,0,1
52322_0,,,,2,1,1,2
52323_0,,,,2,1,1,2
52324_0,,,,2,1,1,2
52325_0,,,,2,1,1,2
52326_0,,,,2,1,1,2
52327_0,,,,2,1,1,2
52328_0,,,,2,1,1,2
52330_0,,,,2,1,1,2
C(C1(CC(CC1(C=O)O)=O)O)=O,,,5,1,2,0,2
52331_0,,,,2,1,1,2
52333_0,,,,2,1,1,2
C(C1(C(C(C=O)C(C1)=O)O)O)=O,,,5,1,2,0,2
52335_0,,,,2,1,1,2
C(C1(C(CC(C1)=O)O)O)=O,,,5,1,3,0,3
52337_0,,,,2,1,1,2
C(CO)(C1(C(CC(C1)=O)O)O)=O,,,5,1,2,0,2
52339_0,,,,2,1,1,2
C(C1(C(CO)(CC(C1)=O)O)O)=O,,,5,1,2,0,2
52340_0,,,,2,1,1,2
52342_0,,,,2,1,1,2
C1(C(CO)C(C=O)(C(C1)O)O)=O,,,5,1,2,0,2
52344_0,,,,2,1,1,2
C(C1(C(CC(C1)=O)O)O)(O)=O,,,5,1,2,0,2
52346_0,,,,2,1,1,2
C1(CC(C(C=O)=O)(C(C1)O)O)=O,,,5,1,2,0,2
52347_0,,,,2,1,1,2
52348_0,,,,2,1,1,2
52350_0,,,,2,1,1,2
C(C1(CCC(C(C1O)=O)=O)O)=O,,,5,1,2,0,2
52351_0,,,,2,1,1,2
52353_0,,,,2,1,1,2
C(C1(C(C(C(C1C)=O)=O)O)O)=O,,,5,1,2,0,2
52354_0,,,,2,1,1,2
52356_0,,,,2,1,1,2
C(C1(C(C(C(C1)=O)CO)O)O)=O,,,5,1,2,0,2
52358_0,,,,2,1,1,2
C(C1(C=CC(C1(CO)O)O)O)=O,,,5,1,3,0,3
52360_0,,,,2,1,1,2
C(CO)(C1(C=CC(C1O)O)O)=O,,,5,1,2,0,2
52362_0,,,,2,1,1,2
C(C1(C=CCC1(C=O)O)O)=O,,,5,1,3,0,3
52363_0,,,,2,1,1,2
52364_0,,,,2,1,1,2
52365_0,,,,2,1,1,2
52367_0,,,,2,1,1,2
C(C)(C1(C=CC(C1O)=O)O)=O,,,5,1,2,0,2
52369_0,,,,2,1,1,2
C(C1(C(CC(C1O)=O)=C)O)=O,,,5,1,2,0,2
52371_0,,,,2,1,1,2
C(C1(C(C)=CC(C1O)=O)O)=O,,,5,1,2,0,2
52373_0,,,,2,1,1,2
C(C1(C(C=O)=CCC1O)O)=O,,,5,1,2,0,2
52375_0,,,,2,1,1,2
C(C1C=CC(C1(C=O)O)O)=O,,,5,1,2,0,2
52377_0,,,,2,1,1,2
C(C1C=CC(C=O)(C1O)O)=O,,,5,1,2,0,2
52379_0,,,,2,1,1,2
C(C1(CC=C(C=O)C1O)O)=O,,,5,1,2,0,2
52381_0,,,,2,1,1,2
C(C1(CC=CC1O)O)=O,,,5,1,2,0,2
52383_0,,,,2,1,1,2
C(C1(C=CCC1O)O)=O,,,5,1,2,0,2
52385_0,,,,2,1,1,2
C1C(C(C=O)=O)(C(C(C=1)O)O)O,,,5,1,2,0,2
52386_0,,,,2,1,1,2
52388_0,,,,2,1,1,2
C(C1(C=CC(C(C1O)=O)O)O)=O,,,5,1,2,0,2
52390_0,,,,2,1,1,2
C(C1(C=CC(C1O)O)O)=O,,,5,1,3,0,3
52391_0,,,,2,1,1,2
52393_0,,,,2,1,1,2
C(C1(C=CC(CO)(C1O)O)O)=O,,,5,1,2,0,2
52395_0,,,,2,1,1,2
C(C1(C=CC(C1O)O)O)(O)=O,,,5,1,2,0,2
52397_0,,,,2,1,1,2
C1(C2(C(C(C(C(C1)O2)O)O)O)O)=O,,,5,1,1,0,1
52399_0,,,,2,1,1,2
C1(C2(CC(C(C2O)O)(O)O1)O)=O,,,5,1,3,0,3
52401_0,,,,2,1,1,2
C1(C2(C(CC(C1)O2)O)O)=O,,,5,1,1,0,1
52403_0,,,,2,1,1,2
C1(C2(C(CC(C(C1)O2)O)O)O)=O,,,5,1,1,0,1
52405_0,,,,2,1,1,2
C(C1(CC2CC1(C(O)O2)O)O)=O,,,5,1,3,0,3
52407_0,,,,2,1,1,2
C1(C2(C(C(CC(C1)O2)O)O)O)=O,,,5,1,1,0,1
52409_0,,,,2,1,1,2
C1(C2(C(CO)(CC(C1)O2)O)O)=O,,,5,1,1,0,1
52411_0,,,,2,1,1,2
C1(C2(C(CC(CO)(C1)O2)O)O)=O,,,5,1,1,0,1
52413_0,,,,2,1,1,2
C1(C2(C(C)(C(C(C1)O2)O)O)O)=O,,,5,1,1,0,1
52415_0,,,,2,1,1,2
C1(C2(C(C(C(C)(C1)O2)O)O)O)=O,,,5,1,1,0,1
52417_0,,,,2,1,1,2
C1(C2(C(CC(C1CO)O2)O)O)=O,,,5,1,1,0,1
52419_0,,,,2,1,1,2
C1(C2(C(CC(C1O)O2)O)O)=O,,,5,1,1,0,1
52421_0,,,,2,1,1,2
C1(C2(C(CC(C(C1O)O2)O)O)O)=O,,,5,1,1,0,1
52423_0,,,,2,1,1,2
C1(C2(C(C(CC(C1O)O2)O)O)O)=O,,,5,1,1,0,1
52425_0,,,,2,1,1,2
C(C1(CC2C(C1(C(O)O2)O)O)O)=O,,,5,1,3,0,3
52427_0,,,,2,1,1,2
C1(C2(C(CO)(CC(C1O)O2)O)O)=O,,,5,1,1,0,1
52429_0,,,,2,1,1,2
C1(C2(C(CC(CO)(C1O)O2)O)O)=O,,,5,1,1,0,1
52431_0,,,,2,1,1,2
C1(C2(C(C)(C(C(C1O)O2)O)O)O)=O,,,5,1,1,0,1
52433_0,,,,2,1,1,2
C1(C2(C(C(C(C)(C1O)O2)O)O)O)=O,,,5,1,1,0,1
52435_0,,,,2,1,1,2
C1(C2(C(CC(C1(CO)O)O2)O)O)=O,,,5,1,1,0,1
52437_0,,,,2,1,1,2
C1(C2(C(C(C(C(C1)O)O2)O)O)O)=O,,,5,1,1,0,1
52439_0,,,,2,1,1,2
C1(C2(C(CC(C(C1)O)O2)O)O)=O,,,5,1,1,0,1
52441_0,,,,2,1,1,2
C1(C2(C(CC(CO2)(C1)O)O)O)=O,,,5,1,1,0,1
52443_0,,,,2,1,1,2
C1(C2(C(C(CO2)(C1)O)O)O)=O,,,5,1,1,0,1
52445_0,,,,2,1,1,2
C1(C2(C(C(C(CO)O2)(C1)O)O)O)=O,,,5,1,1,0,1
52447_0,,,,2,1,1,2
C(C12C(C(C(O1)O)C(C2)O)O)=O,,,5,1,3,0,3
52449_0,,,,2,1,1,2
C1(C2(C(C(CO2)(C1CO)O)O)O)=O,,,5,1,1,0,1
52451_0,,,,2,1,1,2
C1(C2(C(CC(C(C1O)O)O2)O)O)=O,,,5,1,1,0,1
52453_0,,,,2,1,1,2
C1(C2(C(CC(CO2)(C1O)O)O)O)=O,,,5,1,1,0,1
52455_0,,,,2,1,1,2
C1(COC2(CC1(C(C2O)O)O)O)=O,,,5,1,3,0,3
52457_0,,,,2,1,1,2
C1(C2(C(C(CO2)(C1O)O)O)O)=O,,,5,1,1,0,1
52459_0,,,,2,1,1,2
C1(C2(C(C(CCO2)(C1)O)O)O)=O,,,5,1,1,0,1
52461_0,,,,2,1,1,2
C1(C2(C(C(C(CO2)O)(C1)O)O)O)=O,,,5,1,1,0,1
52463_0,,,,2,1,1,2
C1(C2(C(C(CCO2)(C1O)O)O)O)=O,,,5,1,1,0,1
52465_0,,,,2,1,1,2
C1(C2(C(C(C(C2)=O)O1)O)O)=O,,,5,1,3,0,3
52467_0,,,,2,1,1,2
C1(C(C(C(C(C)=O)=O)(CC1)O)O)=O,,,5,1,2,0,2
52469_0,,,,2,1,1,2
C(C1(CCCC1(C(C=O)=O)O)O)=O,,,5,1,1,0,1
52471_0,,,,2,1,1,2
C1(C(C(C(C=O)=O)(CCC1)O)O)=O,,,5,1,2,0,2
52473_0,,,,2,1,1,2
C(C1CC(C(C=O)=O)(C(C1)O)O)=O,,,5,1,1,0,1
52475_0,,,,2,1,1,2
C(C)(C1(CCC(C1O)=O)O)=O,,,5,1,2,0,2
52477_0,,,,2,1,1,2
C(C1(CCC(C1O)=O)O)(CCO)=O,,,5,1,2,0,2
52479_0,,,,2,1,1,2
C(C1(CCC(CC1(C=O)O)O)O)=O,,,5,1,1,0,1
52481_0,,,,2,1,1,2
C(C1(CC(CCC(C1O)=O)O)O)=O,,,5,1,2,0,2
52483_0,,,,2,1,1,2
C(C1(C(C(C(C1)O)CC=O)O)O)=O,,,5,1,2,0,2
52485_0,,,,2,1,1,2
C(C1C(CC(C=O)(C(C1)O)O)O)=O,,,5,1,1,0,1
52487_0,,,,2,1,1,2
C(C1(C(CO)CCC1(C=O)O)O)=O,,,5,1,1,0,1
52489_0,,,,2,1,1,2
C(C1(C(CCC(C1O)=O)CO)O)=O,,,5,1,2,0,2
52491_0,,,,2,1,1,2
C(C1CC(C(C=O)(C1CO)O)O)=O,,,5,1,1,0,1
52493_0,,,,2,1,1,2
C1(C(C(C(C(O)=O)=O)(CC1)O)O)=O,,,5,1,2,0,2
52495_0,,,,2,1,1,2
C1(C2(CCC(C2O)=O)OCC1O)=O,,,5,1,2,0,2
52497_0,,,,2,1,1,2
C(C1(CCC2CC(C1(O)O2)=O)O)=O,,,5,1,1,0,1
52499_0,,,,2,1,1,2
C1(C(C2(C(CC(CC1)O2)=O)O)O)=O,,,5,1,2,0,2
52501_0,,,,2,1,1,2
C(CC1C2CC(C(C1O)(O)O2)=O)=O,,,5,1,2,0,2
52503_0,,,,2,1,1,2
C(C1C2CC(C(C(C1)O)(O)O2)=O)=O,,,5,1,1,0,1
52505_0,,,,2,1,1,2
C(C1(CCC2C(C1(O)OC2)=O)O)=O,,,5,1,1,0,1
52507_0,,,,2,1,1,2
C1(C(C2(C(C(CO2)CC1)=O)O)O)=O,,,5,1,2,0,2
52509_0,,,,2,1,1,2
C(CC1C(C2(C(C1CO2)=O)O)O)=O,,,5,1,2,0,2
52511_0,,,,2,1,1,2
C(C1CC(C2(C(C1CO2)=O)O)O)=O,,,5,1,1,0,1
52513_0,,,,2,1,1,2
C1(C2(CCC(C2O)=O)OC(C1)O)=O,,,5,1,2,0,2
52515_0,,,,2,1,1,2
C1(C2(CC(CCC2(C=O)O)O1)O)=O,,,5,1,1,0,1
52517_0,,,,2,1,1,2
C1(C2(CC(CCC(C2O)=O)O1)O)=O,,,5,1,2,0,2
52519_0,,,,2,1,1,2
C1(C2(C(CO1)CCC2(C=O)O)O)=O,,,5,1,1,0,1
52521_0,,,,2,1,1,2
C1(C2(C(CCC(C2O)=O)CO1)O)=O,,,5,1,2,0,2
52523_0,,,,2,1,1,2
C(C1(CCCC1(C=O)O)O)=O,,,5,1,1,0,1
52524_0,,,,2,1,1,2
52525_0,,,,2,1,1,2
52526_0,,,,2,1,1,2
52528_0,,,,2,1,1,2
C(C1CCC(C=O)(C1(C=O)O)O)=O,,,5,1,1,0,1
52530_0,,,,2,1,1,2
C1(C(C(C=O)(C(C=O)CC1)O)O)=O,,,5,1,2,0,2
52532_0,,,,2,1,1,2
C(C1(CCC(C1O)=O)O)(CC=O)=O,,,5,1,2,0,2
52534_0,,,,2,1,1,2
C(C1(CCCC1(C=O)O)O)(O)=O,,,5,1,1,0,1
52536_0,,,,2,1,1,2
C(C1(CCCC(C1O)=O)O)(O)=O,,,5,1,2,0,2
52537_0,,,,2,1,1,2
52539_0,,,,2,1,1,2
C1(C2(C(C(C(C2)O1)CC=O)O)O)=O,,,5,1,2,0,2
52541_0,,,,2,1,1,2
C(C1CC(C2(C(OC1C2)=O)O)O)=O,,,5,1,1,0,1
52543_0,,,,2,1,1,2
C(C1CC(C2(C(OCC21)=O)O)O)=O,,,5,1,1,0,1
52545_0,,,,2,1,1,2
C(C1CC(C=O)(C(C1)O)O)=O,,,5,1,1,0,1
52546_0,,,,2,1,1,2
52548_0,,,,2,1,1,2
C(C1CC(C(O)=O)(C(C1)O)O)=O,,,5,1,1,0,1
52550_0,,,,2,1,1,2
C(C1(C(C(CC1)O)O)O)(O)=O,,,5,1,1,0,1
52552_0,,,,2,1,1,2
C(C1(C(CC(C(C1)O)O)O)O)=O,,,5,1,1,0,1
52554_0,,,,2,1,1,2
C(C1(C(C(CC(C1)O)O)O)O)=O,,,5,1,1,0,1
52556_0,,,,2,1,1,2
C(C1(CC(C)(C(C1O)O)O)O)=O,,,5,1,1,0,1
52557_0,,,,2,2,1,3
52558_0,,,,2,2,1,3
52559_0,,,,2,2,1,3
52560_0,,,,2,2,1,3
52561_0,,,,2,2,1,3
52562_0,,,,2,2,1,3
52563_0,,,,2,2,1,3
52564_0,,,,2,2,1,3
52565_0,,,,2,2,1,3
52567_0,,,,2,2,1,3
C1(C(CC(C1)O)(C(C=CC)O)O)=O,,,5,1,1,0,1
52569_0,,,,2,2,1,3
C1(CC(CC1(C(CC=C)O)O)O)=O,,,5,1,1,0,1
52571_0,,,,2,2,1,3
C1(C(CC(C1)O)(C(C=C)O)O)=O,,,5,1,1,0,1
52572_0,,,,2,2,1,3
52573_0,,,,2,2,1,3
52574_0,,,,2,2,1,3
52575_0,,,,2,2,1,3
52576_0,,,,2,2,1,3
52577_0,,,,2,2,1,3
52578_0,,,,2,2,1,3
52579_0,,,,2,2,1,3
52580_0,,,,2,2,1,3
52581_0,,,,2,2,1,3
52582_0,,,,2,2,1,3
52583_0,,,,2,2,1,3
52584_0,,,,2,2,1,3
52586_0,,,,2,2,1,3
C(C(C1(C(CC(C1)O)O)O)O)(O)=O,,,5,1,1,0,1
52588_0,,,,2,2,1,3
C(C(C1(C(CC(C1)O)O)O)(O)O)=O,,,5,1,1,0,1
52590_0,,,,2,2,1,3
C(C(C)(C1(C(CC(C1)O)O)O)O)=O,,,5,1,1,0,1
52592_0,,,,2,2,1,3
[C](C(O)=O)(C1(C(CC(C1)O)O)O)O,,,5,1,1,0,1
52593_0,,,,2,2,1,3
52594_0,,,,2,2,1,3
52595_0,,,,2,2,1,3
52596_0,,,,2,2,1,3
52597_0,,,,2,2,1,3
52598_0,,,,2,2,1,3
52600_0,,,,2,2,1,3
C1(C(CC(C1O)O)(C(C=C)O)O)=O,,,5,1,1,0,1
52601_0,,,,2,2,1,3
52602_0,,,,2,2,1,3
52603_0,,,,2,2,1,3
52604_0,,,,2,2,1,3
52605_0,,,,2,2,1,3
52606_0,,,,2,2,1,3
52607_0,,,,2,2,1,3
52608_0,,,,2,2,1,3
52609_0,,,,2,2,1,3
52610_0,,,,2,2,1,3
52611_0,,,,2,2,1,3
52612_0,,,,2,2,1,3
52613_0,,,,2,2,1,3
52614_0,,,,2,2,1,3
52615_0,,,,2,2,1,3
52616_0,,,,2,2,1,3
52617_0,,,,2,2,1,3
52618_0,,,,2,2,1,3
52619_0,,,,2,2,1,3
52620_0,,,,2,2,1,3
52621_0,,,,2,2,1,3
52622_0,,,,2,2,1,3
52623_0,,,,2,2,1,3
52624_0,,,,2,2,1,3
52625_0,,,,2,2,1,3
52626_0,,,,2,2,1,3
52627_0,,,,2,2,1,3
52628_0,,,,2,2,1,3
52630_0,,,,2,2,1,3
C(C(CO)C(C(C=C)=O)(CO)O)=O,,,5,1,1,0,1
52631_0,,,,2,2,1,3
52632_0,,,,2,2,1,3
52633_0,,,,2,2,1,3
52634_0,,,,2,2,1,3
52636_0,,,,2,2,1,3
C(C(C(C(CO)CO)O)(O)O)(O)=O,,,5,1,1,0,1
52638_0,,,,2,2,1,3
C(C(C=C)(C(C(CO)CO)O)O)=O,,,5,1,1,0,1
52639_0,,,,2,2,1,3
52640_0,,,,2,2,1,3
52641_0,,,,2,2,1,3
52642_0,,,,2,2,1,3
52643_0,,,,2,2,1,3
52644_0,,,,2,2,1,3
52645_0,,,,2,2,1,3
52647_0,,,,2,2,1,3
C(C(C(C)O)(CC=O)O)(C(C)O)=O,,,5,1,1,0,1
52648_0,,,,2,2,1,3
52649_0,,,,2,2,1,3
52650_0,,,,2,2,1,3
52651_0,,,,2,2,1,3
52652_0,,,,2,2,1,3
52653_0,,,,2,2,1,3
52654_0,,,,2,2,1,3
52655_0,,,,2,2,1,3
52656_0,,,,2,2,1,3
52657_0,,,,2,2,1,3
52658_0,,,,2,2,1,3
52660_0,,,,2,2,1,3
C(C(C(C)(C(C(C)O)O)O)(O)O)=O,,,5,1,1,0,1
52662_0,,,,2,2,1,3
C(C(C)(C(C)(C(C(C)O)O)O)O)=O,,,5,1,1,0,1
52664_0,,,,2,2,1,3
[C](C(O)=O)(C(C)(C(C(C)O)O)O)O,,,5,1,1,0,1
52666_0,,,,2,2,1,3
C(CC(C(C=C)=O)(CO)O)(CO)=O,,,5,1,1,0,1
52667_0,,,,2,2,1,3
52668_0,,,,2,2,1,3
52669_0,,,,2,2,1,3
52670_0,,,,2,2,1,3
52671_0,,,,2,2,1,3
52672_0,,,,2,2,1,3
52673_0,,,,2,2,1,3
52674_0,,,,2,2,1,3
52675_0,,,,2,2,1,3
52676_0,,,,2,2,1,3
52677_0,,,,2,2,1,3
52678_0,,,,2,2,1,3
52679_0,,,,2,2,1,3
52680_0,,,,2,2,1,3
52681_0,,,,2,2,1,3
52682_0,,,,2,2,1,3
52683_0,,,,2,2,1,3
52685_0,,,,2,2,1,3
C(C(C(C)O)(CC=O)O)(CC=O)=O,,,5,1,1,0,1
52687_0,,,,2,2,1,3
C(C(C(CC=O)=O)(CC=O)O)(O)=O,,,5,1,1,0,1
52688_0,,,,2,2,1,3
52689_0,,,,2,2,1,3
52690_0,,,,2,2,1,3
52691_0,,,,2,2,1,3
52692_0,,,,2,2,1,3
52693_0,,,,2,2,1,3
52694_0,,,,2,2,1,3
52695_0,,,,2,2,1,3
52696_0,,,,2,2,1,3
52697_0,,,,2,2,1,3
52699_0,,,,2,2,1,3
C1(C(C(C=C)O)(O)OCC1CO)=O,,,5,1,1,0,1
52700_0,,,,2,2,1,3
52701_0,,,,2,2,1,3
52702_0,,,,2,2,1,3
52703_0,,,,2,2,1,3
52704_0,,,,2,2,1,3
52705_0,,,,2,2,1,3
52706_0,,,,2,2,1,3
52708_0,,,,2,2,1,3
C(CC(C(C(C)=O)=O)(C(C)O)O)=O,,,5,1,1,0,1
52710_0,,,,2,2,1,3
C(C(C(C(C)=O)=O)(CC=O)O)(O)=O,,,5,1,1,0,1
52711_0,,,,2,2,1,3
52712_0,,,,2,2,1,3
52714_0,,,,2,2,1,3
C=CC(C(CO)(CC(C=O)=O)O)=O,,,5,1,1,0,1
52716_0,,,,2,2,1,3
C(C(C=O)C(C(C=C)=O)(CO)O)=O,,,5,1,1,0,1
52718_0,,,,2,2,1,3
C(CC(C(C=C)=O)(C(C=CC)O)O)=O,,,5,1,1,0,1
52720_0,,,,2,2,1,3
C(CC(C(C=C)=O)(C(CC=C)O)O)=O,,,5,1,1,0,1
52722_0,,,,2,2,1,3
C(CC(C(C=C)=O)(C(C=C)O)O)=O,,,5,1,1,0,1
52724_0,,,,2,2,1,3
C(CC(C(C=C)=O)(C(C=O)O)O)=O,,,5,1,1,0,1
52726_0,,,,2,2,1,3
C(CC(C(C=C)=O)(C(C)O)O)=O,,,5,1,2,0,2
52728_0,,,,2,2,1,3
C(C(C(C=C)=O)(CC=O)O)(O)=O,,,5,1,2,0,2
52730_0,,,,2,2,1,3
C(CC(C(C=C)=O)(CO)O)=O,,,5,1,2,0,2
52732_0,,,,2,2,1,3
C(CC(C(C=C)=O)(C(CO)O)O)=O,,,5,1,1,0,1
52733_0,,,,2,2,1,3
52734_0,,,,2,2,1,3
52735_0,,,,2,2,1,3
52736_0,,,,2,2,1,3
52738_0,,,,2,2,1,3
C(C(C(C(C(O)=O)(O)O)O)O)(O)=O,,,5,1,2,0,2
52739_0,,,,2,2,1,3
52740_0,,,,2,2,1,3
52741_0,,,,2,2,1,3
52742_0,,,,2,2,1,3
52743_0,,,,2,2,1,3
52744_0,,,,2,2,1,3
52746_0,,,,2,2,1,3
C(C(C(CC(C(O)O)O)O)O)(O)=O,,,5,1,1,0,1
52748_0,,,,2,2,1,3
C(C(C(CC(C(O)O)O)O)(O)O)=O,,,5,1,1,0,1
52750_0,,,,2,2,1,3
C(C(C)(C(CC(C(O)O)O)O)O)=O,,,5,1,1,0,1
52752_0,,,,2,2,1,3
[C](C(O)=O)(C(CC(C(O)O)O)O)O,,,5,1,1,0,1
52754_0,,,,2,2,1,3
C(C(C(CC(C(C)O)O)O)O)(O)=O,,,5,1,1,0,1
52756_0,,,,2,2,1,3
C(C(C(CC(C(C)O)O)O)(O)O)=O,,,5,1,1,0,1
52758_0,,,,2,2,1,3
C(C(C)(C(CC(C(C)O)O)O)O)=O,,,5,1,1,0,1
52760_0,,,,2,2,1,3
[C](C(O)=O)(C(CC(C(C)O)O)O)O,,,5,1,1,0,1
52761_0,,,,2,2,1,3
52762_0,,,,2,2,1,3
52763_0,,,,2,2,1,3
52764_0,,,,2,2,1,3
52766_0,,,,2,2,1,3
C(C(CC(C)O)(C(C=C)O)O)(O)=O,,,5,1,1,0,1
52767_0,,,,2,2,1,3
52769_0,,,,2,2,1,3
C(C(C(C)O)(CC(C)O)O)(O)=O,,,5,1,1,0,1
52771_0,,,,2,2,1,3
C(C(C(O)=O)(CC(C)O)O)(O)=O,,,5,1,1,0,1
52772_0,,,,2,2,1,3
52774_0,,,,2,2,1,3
C(C(C(CO)O)(CC(C)O)O)(O)=O,,,5,1,1,0,1
52775_0,,,,2,2,1,3
52776_0,,,,2,2,1,3
52777_0,,,,2,2,1,3
52778_0,,,,2,2,1,3
52779_0,,,,2,2,1,3
52780_0,,,,2,2,1,3
52781_0,,,,2,2,1,3
52783_0,,,,2,2,1,3
C(C(C(C)O)(C(CO)CO)O)(O)=O,,,5,1,1,0,1
52785_0,,,,2,2,1,3
C(C(C(O)=O)(C(CO)CO)O)(O)=O,,,5,1,1,0,1
52786_0,,,,2,2,1,3
52787_0,,,,2,2,1,3
52788_0,,,,2,2,1,3
52789_0,,,,2,2,1,3
52790_0,,,,2,2,1,3
52791_0,,,,2,2,1,3
52793_0,,,,2,2,1,3
C(C(C(C(C=O)=O)(CO)O)(O)O)=O,,,5,1,2,0,2
52794_0,,,,2,2,1,3
52796_0,,,,2,2,1,3
[C](C(O)=O)(C(C(C=O)=O)(CO)O)O,,,5,1,3,0,3
52797_0,,,,2,2,1,3
52798_0,,,,2,2,1,3
52799_0,,,,2,2,1,3
52800_0,,,,2,2,1,3
52801_0,,,,2,2,1,3
52802_0,,,,2,2,1,3
52803_0,,,,2,2,1,3
52804_0,,,,2,2,1,3
52805_0,,,,2,2,1,3
52806_0,,,,2,2,1,3
52807_0,,,,2,2,1,3
52808_0,,,,2,2,1,3
52809_0,,,,2,2,1,3
52811_0,,,,2,2,1,3
C=CC(C(C(C(CO)=O)=O)(C)O)O,,,5,1,1,0,1
52812_0,,,,2,2,1,3
52814_0,,,,2,2,1,3
C(C(CO)=O)(C(C)(C(C)O)O)=O,,,5,1,1,0,1
52815_0,,,,2,2,1,3
52816_0,,,,2,2,1,3
52818_0,,,,2,2,1,3
C(C(CO)=O)(C(C)(C(CO)O)O)=O,,,5,1,1,0,1
52820_0,,,,2,2,1,3
C(C(C(CO)O)=O)(C(CO)(C)O)=O,,,5,1,3,0,3
52822_0,,,,2,2,1,3
C(C(C(C(C(CO)(C)O)=O)=O)O)=O,,,5,1,1,0,1
52824_0,,,,2,2,1,3
C(CC(C(C=O)=O)(C(C=C)O)O)=O,,,5,1,1,0,1
52825_0,,,,2,2,1,3
52827_0,,,,2,2,1,3
C(CC(C(C=O)=O)(C(C)O)O)=O,,,5,1,2,0,2
52828_0,,,,2,2,1,3
52829_0,,,,2,2,1,3
52831_0,,,,2,2,1,3
C(CC(C(C=O)=O)(C(CO)O)O)=O,,,5,1,2,0,2
52832_0,,,,2,2,1,3
52834_0,,,,2,2,1,3
C(C(CC(C(C=O)=O)(CO)O)O)=O,,,5,1,3,0,3
52835_0,,,,2,2,1,3
52837_0,,,,2,2,1,3
C(C)=CC(C(C(C(C)=O)=O)(C)O)O,,,5,1,1,0,1
52839_0,,,,2,2,1,3
C(CC(C(C(C(C)=O)=O)(C)O)O)=C,,,5,1,1,0,1
52841_0,,,,2,2,1,3
C=CC(C(C(C(C)=O)=O)(C)O)O,,,5,1,1,0,1
52842_0,,,,2,2,1,3
52843_0,,,,2,2,1,3
52845_0,,,,2,2,1,3
C(C(C)(C(C(C(C)=O)=O)(C)O)O)=O,,,5,1,1,0,1
52847_0,,,,2,2,1,3
C(C(C(C(C(C)=O)=O)(C)O)O)(C)=O,,,5,1,1,0,1
52848_0,,,,2,2,1,3
52850_0,,,,2,2,1,3
C(C(C)=O)(C(C)(C(C)O)O)=O,,,5,1,1,0,1
52852_0,,,,2,2,1,3
C(C(C)=O)(C(C)(C(CCO)O)O)=O,,,5,1,1,0,1
52854_0,,,,2,2,1,3
C(C(C)=O)(C(C)(C(CO)(C)O)O)=O,,,5,1,1,0,1
52855_0,,,,2,2,1,3
52857_0,,,,2,2,1,3
C(C(C)=O)(C(C)(C(C(O)O)O)O)=O,,,5,1,1,0,1
52859_0,,,,2,2,1,3
C(C(C)=O)(C(C)(C(C(C)O)O)O)=O,,,5,1,1,0,1
52860_0,,,,2,2,1,3
52861_0,,,,2,2,1,3
52862_0,,,,2,2,1,3
52863_0,,,,2,2,1,3
52864_0,,,,2,2,1,3
52865_0,,,,2,2,1,3
52866_0,,,,2,2,1,3
52868_0,,,,2,2,1,3
C(C(C)(C(C=O)(O)O)O)(C(C)O)=O,,,5,1,1,0,1
52870_0,,,,2,2,1,3
C(C(C)(C(C=O)(C)O)O)(C(C)O)=O,,,5,1,1,0,1
52872_0,,,,2,2,1,3
C(C(C)O)(C([C](C(O)=O)O)(C)O)=O,,,5,1,1,0,1
52874_0,,,,2,2,1,3
C(C(CCO)=O)(C(C)(C(C)O)O)=O,,,5,1,1,0,1
52875_0,,,,2,2,1,3
52876_0,,,,2,2,1,3
52877_0,,,,2,2,1,3
52879_0,,,,2,2,1,3
C(C(C(C=O)=O)(C(C=O)(O)O)O)=O,,,5,1,2,0,2
52880_0,,,,2,2,1,3
52882_0,,,,2,2,1,3
C(C([C](C(O)=O)O)(C(C=O)=O)O)=O,,,5,1,2,0,2
52883_0,,,,2,2,1,3
52885_0,,,,2,2,1,3
C(C(C(C(C(C=O)=O)=O)O)(O)O)=O,,,5,1,1,0,1
52886_0,,,,2,2,1,3
52888_0,,,,2,2,1,3
C([C](C(C(C(C=O)=O)=O)O)O)(O)=O,,,5,1,1,0,1
52890_0,,,,2,2,1,3
C(C(C)(C(C(C(O)=O)(O)O)O)O)=O,,,5,1,2,0,2
52892_0,,,,2,2,1,3
C(C(C=C)(C(C(C=O)(C)O)O)O)=O,,,5,1,1,0,1
52893_0,,,,2,2,1,3
52894_0,,,,2,2,1,3
52896_0,,,,2,2,1,3
C(C(C)(C(C(C=O)(O)O)O)O)=O,,,5,1,1,0,1
52898_0,,,,2,2,1,3
C(C(C)(C(C(C=O)(C)O)O)O)=O,,,5,1,1,0,1
52900_0,,,,2,2,1,3
C(C(C)(C([C](C(O)=O)O)O)O)=O,,,5,1,2,0,2
52901_0,,,,2,2,1,3
52903_0,,,,2,2,1,3
C(C(C=O)(C(C(O)=O)(O)O)O)=O,,,5,1,1,0,1
52904_0,,,,2,2,1,3
52905_0,,,,2,2,1,3
52906_0,,,,2,2,1,3
52907_0,,,,2,2,1,3
52908_0,,,,2,2,1,3
52909_0,,,,2,2,1,3
52910_0,,,,2,2,1,3
52912_0,,,,2,2,1,3
C(C(C=O)(C1(C(CCO1)=O)O)O)=O,,,5,1,1,0,1
52913_0,,,,2,2,1,3
52914_0,,,,2,2,1,3
52916_0,,,,2,2,1,3
C(C(C=O)(C(C=O)(O)O)O)=O,,,5,1,1,0,1
52917_0,,,,2,2,1,3
52919_0,,,,2,2,1,3
C(C(C=O)([C](C(O)=O)O)O)=O,,,5,1,1,0,1
52920_0,,,,2,2,1,3
52922_0,,,,2,2,1,3
C(C(C(C(C=O)=O)O)(O)O)(O)=O,,,5,1,1,0,1
52923_0,,,,2,2,1,3
52924_0,,,,2,2,1,3
52925_0,,,,2,2,1,3
52926_0,,,,2,2,1,3
52927_0,,,,2,2,1,3
52928_0,,,,2,2,1,3
52929_0,,,,2,2,1,3
52931_0,,,,2,2,1,3
C1(C(C(C(C=O)=O)O)(O)OCC1)=O,,,5,1,2,0,2
52932_0,,,,2,2,1,3
52933_0,,,,2,2,1,3
52935_0,,,,2,2,1,3
C(C(C(C(C=O)=O)O)(O)O)=O,,,5,1,2,0,2
52936_0,,,,2,2,1,3
52938_0,,,,2,2,1,3
C([C](C(C(C=O)=O)O)O)(O)=O,,,5,1,3,0,3
52939_0,,,,2,2,1,3
52941_0,,,,2,2,1,3
C(C(C(C)(CC(C=O)=O)O)(O)O)=O,,,5,1,1,0,1
52943_0,,,,2,2,1,3
C(C(C)(C(C)(CC(C=O)=O)O)O)=O,,,5,1,1,0,1
52945_0,,,,2,2,1,3
[C](C(O)=O)(C(C)(CC(C=O)=O)O)O,,,5,1,1,0,1
52947_0,,,,2,2,1,3
C(C(C(C=O)(CC(C)=O)O)O)(O)=O,,,5,1,1,0,1
52949_0,,,,2,2,1,3
C(C(C(C=O)(CC(C)=O)O)(O)O)=O,,,5,1,1,0,1
52951_0,,,,2,2,1,3
C(CC(C=O)(C(C=O)(C)O)O)(C)=O,,,5,1,1,0,1
52953_0,,,,2,2,1,3
C(C([C](C(O)=O)O)(CC(C)=O)O)=O,,,5,1,1,0,1
52954_0,,,,2,2,1,3
52956_0,,,,2,2,1,3
C(C(C(C(CC(C)=O)=O)O)(O)O)=O,,,5,1,1,0,1
52957_0,,,,2,2,1,3
52959_0,,,,2,2,1,3
C(C([C](C(O)=O)O)O)(CC(C)=O)=O,,,5,1,1,0,1
52960_0,,,,2,2,1,3
52962_0,,,,2,2,1,3
C(C(C=O)C(C(C=O)(C=C)O)O)=O,,,5,1,1,0,1
52963_0,,,,2,2,1,3
52964_0,,,,2,2,1,3
52966_0,,,,2,2,1,3
C(C(C=O)C(C(C=O)(O)O)O)=O,,,5,1,1,0,1
52967_0,,,,2,2,1,3
52969_0,,,,2,2,1,3
C(C(C=O)C([C](C(O)=O)O)O)=O,,,5,1,1,0,1
52970_0,,,,2,2,1,3
52972_0,,,,2,2,1,3
C(C(C=O)C(C)(C(C=O)(O)O)O)=O,,,5,1,1,0,1
52974_0,,,,2,2,1,3
C(C(C=O)C(C)(C(C=O)(C)O)O)=O,,,5,1,1,0,1
52976_0,,,,2,2,1,3
C(C(C=O)C([C](C(O)=O)O)(C)O)=O,,,5,1,1,0,1
52977_0,,,,2,2,1,3
52979_0,,,,2,2,1,3
C(C(C(C(C=O)C(C)=O)O)(O)O)=O,,,5,1,1,0,1
52980_0,,,,2,2,1,3
52982_0,,,,2,2,1,3
C(C(C(C)=O)C([C](C(O)=O)O)O)=O,,,5,1,1,0,1
52984_0,,,,2,2,1,3
C(C(CC(C=O)(C(C=C)O)O)O)=O,,,5,1,1,0,1
52985_0,,,,2,2,1,3
52986_0,,,,2,2,1,3
52987_0,,,,2,2,1,3
52988_0,,,,2,2,1,3
52989_0,,,,2,2,1,3
52991_0,,,,2,2,1,3
C(C)(CC(C(C(CO)=O)(C)O)O)=O,,,5,1,1,0,1
52993_0,,,,2,2,1,3
C(C(C(CC(C)=O)O)(O)O)(O)=O,,,5,1,1,0,1
52995_0,,,,2,2,1,3
C(C(C=C)(C(CC(C)=O)O)O)=O,,,5,1,1,0,1
52997_0,,,,2,2,1,3
C(C(C(CC(C)=O)O)(CC)O)(O)=O,,,5,1,1,0,1
52999_0,,,,2,2,1,3
C(C(C(CC(C)=O)O)O)(O)=O,,,5,1,3,0,3
53001_0,,,,2,2,1,3
C(C)(CC(C(C=O)(CC=O)O)O)=O,,,5,1,1,0,1
53003_0,,,,2,2,1,3
C(C(C)(C(CC(C)=O)O)O)(O)=O,,,5,1,3,0,3
53005_0,,,,2,2,1,3
C(C)(CC(C(C(C=O)=O)(C)O)O)=O,,,5,1,1,0,1
53007_0,,,,2,2,1,3
C(C(C(CC(C)=O)O)(CCO)O)=O,,,5,1,1,0,1
53009_0,,,,2,2,1,3
C1(C(C(CC(C)=O)O)(O)OCC1)=O,,,5,1,1,0,1
53011_0,,,,2,2,1,3
C(C(C=C)(C(CC(C)=O)O)O)(O)=O,,,5,1,1,0,1
53013_0,,,,2,2,1,3
C1(C(C(CC(C)=O)O)(CCO1)O)=O,,,5,1,1,0,1
53015_0,,,,2,2,1,3
C(C(C(CC(C)=O)O)(O)O)=O,,,5,1,3,0,3
53017_0,,,,2,2,1,3
C(C(C)(C(CC(C)=O)O)O)=O,,,5,1,3,0,3
53019_0,,,,2,2,1,3
C(C)(CC([C](C(O)=O)O)O)=O,,,5,1,3,0,3
53021_0,,,,2,2,1,3
C(CC(C)(C(C(CO)=O)(C)O)O)=O,,,5,1,1,0,1
53023_0,,,,2,2,1,3
C(CC(C)(C(C(O)=O)(O)O)O)=O,,,5,1,1,0,1
53024_0,,,,2,2,1,3
53026_0,,,,2,2,1,3
C(C(CC)(C(C)(CC=O)O)O)(O)=O,,,5,1,1,0,1
53027_0,,,,2,2,1,3
53028_0,,,,2,2,1,3
53029_0,,,,2,2,1,3
53031_0,,,,2,2,1,3
C(CC(C)(C(C(C=O)=O)(C)O)O)=O,,,5,1,1,0,1
53033_0,,,,2,2,1,3
C(C(CCO)(C(C)(CC=O)O)O)=O,,,5,1,1,0,1
53035_0,,,,2,2,1,3
C(CC(C)(C1(C(CCO1)=O)O)O)=O,,,5,1,1,0,1
53037_0,,,,2,2,1,3
C(C(C=C)(C(C)(CC=O)O)O)(O)=O,,,5,1,1,0,1
53039_0,,,,2,2,1,3
C1(C(CCO1)(C(C)(CC=O)O)O)=O,,,5,1,1,0,1
53041_0,,,,2,2,1,3
C(CC(C)(C(C=O)(O)O)O)=O,,,5,1,2,0,2
53043_0,,,,2,2,1,3
C(C(C)(C(C)(CC=O)O)O)=O,,,5,1,2,0,2
53045_0,,,,2,2,1,3
C(CC([C](C(O)=O)O)(C)O)=O,,,5,1,2,0,2
53046_0,,,,2,2,1,3
53047_0,,,,2,2,1,3
53048_0,,,,2,2,1,3
53049_0,,,,2,2,1,3
53051_0,,,,2,2,1,3
C(C)=CC(C(C(C(O)=O)=O)(C)O)O,,,5,1,1,0,1
53053_0,,,,2,2,1,3
C=CCC(C(C(C(O)=O)=O)(C)O)O,,,5,1,1,0,1
53055_0,,,,2,2,1,3
C=CC(C(C(C(O)=O)=O)(C)O)O,,,5,1,1,0,1
53056_0,,,,2,2,1,3
53057_0,,,,2,2,1,3
53058_0,,,,2,2,1,3
53059_0,,,,2,2,1,3
53060_0,,,,2,2,1,3
53061_0,,,,2,2,1,3
53062_0,,,,2,2,1,3
53063_0,,,,2,2,1,3
53064_0,,,,2,2,1,3
53065_0,,,,2,2,1,3
53066_0,,,,2,2,1,3
53067_0,,,,2,2,1,3
53068_0,,,,2,2,1,3
53069_0,,,,2,2,1,3
53070_0,,,,2,2,1,3
53071_0,,,,2,2,1,3
53072_0,,,,2,2,1,3
53074_0,,,,2,2,1,3
C(CO)(C(C)(C(C=C)(CO)O)O)=O,,,5,1,1,0,1
53076_0,,,,2,2,1,3
C(CO)(C(C)(C(C=CCO)O)O)=O,,,5,1,1,0,1
53078_0,,,,2,2,1,3
C(C(CC)(C(C(CO)=O)(C)O)O)=O,,,5,1,1,0,1
53080_0,,,,2,2,1,3
C(CO)(C(C)(C(C(CC)=O)O)O)=O,,,5,1,1,0,1
53082_0,,,,2,2,1,3
C(CCC(C(C(CO)=O)(C)O)O)=O,,,5,1,1,0,1
53084_0,,,,2,2,1,3
C(C)(C(C)(C(C(CO)=O)(C)O)O)=O,,,5,1,1,0,1
53086_0,,,,2,2,1,3
C(CO)(C(C)(C(C(C=O)=C)O)O)=O,,,5,1,1,0,1
53088_0,,,,2,2,1,3
C(CO)(C(C)(C(C=CC)O)O)=O,,,5,1,1,0,1
53090_0,,,,2,2,1,3
C(CO)(C(C)(C(CC=C)O)O)=O,,,5,1,1,0,1
53092_0,,,,2,2,1,3
C(CO)(C(C)(C(C(C=C)O)O)O)=O,,,5,1,1,0,1
53094_0,,,,2,2,1,3
C(CO)(C(C)(C(C=C)O)O)=O,,,5,1,1,0,1
53096_0,,,,2,2,1,3
C(CO)(C(C)(C1(C=COC1)O)O)=O,,,5,1,1,0,1
53097_0,,,,2,2,1,3
53098_0,,,,2,2,1,3
53099_0,,,,2,2,1,3
53100_0,,,,2,2,1,3
53101_0,,,,2,2,1,3
53102_0,,,,2,2,1,3
53103_0,,,,2,2,1,3
53104_0,,,,2,2,1,3
53105_0,,,,2,2,1,3
53106_0,,,,2,2,1,3
53107_0,,,,2,2,1,3
53108_0,,,,2,2,1,3
53109_0,,,,2,2,1,3
53110_0,,,,2,2,1,3
53111_0,,,,2,2,1,3
53112_0,,,,2,2,1,3
53113_0,,,,2,2,1,3
53114_0,,,,2,2,1,3
53115_0,,,,2,2,1,3
53116_0,,,,2,2,1,3
53117_0,,,,2,2,1,3
53118_0,,,,2,2,1,3
53119_0,,,,2,2,1,3
53120_0,,,,2,2,1,3
53122_0,,,,2,2,1,3
C(C(C(CO)(C(C)O)O)(O)O)(O)=O,,,5,1,1,0,1
53123_0,,,,2,2,1,3
53124_0,,,,2,2,1,3
53125_0,,,,2,2,1,3
53126_0,,,,2,2,1,3
53127_0,,,,2,2,1,3
53128_0,,,,2,2,1,3
53130_0,,,,2,2,1,3
C(OCC(C)(C(C(O)=O)(O)O)O)=O,,,5,1,1,0,1
53132_0,,,,2,2,1,3
C(OCC(C)(C(C=O)(C=C)O)O)=O,,,5,1,1,0,1
53134_0,,,,2,2,1,3
C(OCC(C)(C(C(O)=O)O)O)=O,,,5,1,1,0,1
53136_0,,,,2,2,1,3
C(OCC(C)(C(C(O)=O)(C)O)O)=O,,,5,1,1,0,1
53138_0,,,,2,2,1,3
C(OCC(C)(C(C=O)(O)O)O)=O,,,5,1,1,0,1
53140_0,,,,2,2,1,3
C(OCC(C)(C(C=O)(C)O)O)=O,,,5,1,1,0,1
53142_0,,,,2,2,1,3
C(OCC([C](C(O)=O)O)(C)O)=O,,,5,1,1,0,1
53144_0,,,,2,2,1,3
C(C(COC(C=O)(C(C)O)O)O)=O,,,5,1,1,0,1
53146_0,,,,2,2,1,3
C(C(C=O)(O)OCC(C=O)O)(O)=O,,,5,1,1,0,1
53147_0,,,,2,2,1,3
53149_0,,,,2,2,1,3
C(C(CO)(C)O)(C(C(CO)=O)O)=O,,,5,1,1,0,1
53151_0,,,,2,2,1,3
C(C(C)(C(C=C)O)O)(C(CO)O)=O,,,5,1,1,0,1
53152_0,,,,2,2,1,3
53154_0,,,,2,2,1,3
C(C(CO)O)(C(C)(C(C)O)O)=O,,,5,1,1,0,1
53155_0,,,,2,2,1,3
53156_0,,,,2,2,1,3
53157_0,,,,2,2,1,3
53158_0,,,,2,2,1,3
53160_0,,,,2,2,1,3
C(C(C)(C(C)O)O)(CC(C=O)=O)=O,,,5,1,1,0,1
53162_0,,,,2,2,1,3
C(C(C(CC(C=O)=O)=O)(C)O)(O)=O,,,5,1,1,0,1
53164_0,,,,2,2,1,3
C(C(CO)(C)O)(CC(C=O)=O)=O,,,5,1,1,0,1
53166_0,,,,2,2,1,3
C(C(C=O)C(C(C)(C(C)O)O)=O)=O,,,5,1,1,0,1
53168_0,,,,2,2,1,3
C(C(C=O)C(C(C(O)=O)(C)O)=O)=O,,,5,1,1,0,1
53170_0,,,,2,2,1,3
C(C(C=O)C(C(CO)(C)O)=O)=O,,,5,1,1,0,1
53172_0,,,,2,2,1,3
C(C(C)(C(C=CC)O)O)(CC=O)=O,,,5,1,1,0,1
53174_0,,,,2,2,1,3
C(C(C)(C(CC=C)O)O)(CC=O)=O,,,5,1,1,0,1
53176_0,,,,2,2,1,3
C(C(C)(C(C=C)O)O)(CC=O)=O,,,5,1,1,0,1
53177_0,,,,2,2,1,3
53179_0,,,,2,2,1,3
C(C(C)(C(C(O)=O)O)O)(CC=O)=O,,,5,1,2,0,2
53181_0,,,,2,2,1,3
C(CC(C(C)(C(C=O)(C)O)O)=O)=O,,,5,1,2,0,2
53182_0,,,,2,2,1,3
53184_0,,,,2,2,1,3
C(C(C)(C(CC=O)O)O)(CC=O)=O,,,5,1,1,0,1
53186_0,,,,2,2,1,3
C(CC(C(C)(C(C)O)O)=O)=O,,,5,1,1,0,1
53188_0,,,,2,2,1,3
C(CC(C(C)(C(CCO)O)O)=O)=O,,,5,1,1,0,1
53190_0,,,,2,2,1,3
C(CC(C(C)(C(CO)(C)O)O)=O)=O,,,5,1,1,0,1
53192_0,,,,2,2,1,3
C(C(C(CC=O)=O)(C)O)(O)=O,,,5,1,3,0,3
53194_0,,,,2,2,1,3
C(CC(C(C)(C(C(O)O)O)O)=O)=O,,,5,1,1,0,1
53196_0,,,,2,2,1,3
C(CC(C(C)(C(C(C)O)O)O)=O)=O,,,5,1,1,0,1
53198_0,,,,2,2,1,3
C(CC(C(CO)(C)O)=O)=O,,,5,1,1,0,1
53200_0,,,,2,2,1,3
C(CC(C(C)(C(CO)O)O)=O)=O,,,5,1,1,0,1
53201_0,,,,2,2,1,3
53202_0,,,,2,2,1,3
53203_0,,,,2,2,1,3
53204_0,,,,2,2,1,3
53205_0,,,,2,2,1,3
53207_0,,,,2,2,1,3
C(CC(C(C)O)(C(C=O)(O)O)O)=O,,,5,1,1,0,1
53209_0,,,,2,2,1,3
C(C(C)(C(C(C)O)(CC=O)O)O)=O,,,5,1,1,0,1
53211_0,,,,2,2,1,3
C(CC([C](C(O)=O)O)(C(C)O)O)=O,,,5,1,1,0,1
53213_0,,,,2,2,1,3
C(C(CO)(C)O)(C(C(C=O)=O)O)=O,,,5,1,1,0,1
53215_0,,,,2,2,1,3
C(C(C)(C(C=C)O)O)(C(C=O)O)=O,,,5,1,1,0,1
53216_0,,,,2,2,1,3
53218_0,,,,2,2,1,3
C(C(C(C(C)(C(C)O)O)=O)O)=O,,,5,1,1,0,1
53219_0,,,,2,2,1,3
53220_0,,,,2,2,1,3
53221_0,,,,2,2,1,3
53223_0,,,,2,2,1,3
C(CC(C(C(C)O)(CCO)O)=O)=O,,,5,1,1,0,1
53225_0,,,,2,2,1,3
C(C(C(CC=O)=O)(CCO)O)(O)=O,,,5,1,1,0,1
53227_0,,,,2,2,1,3
C(CC(C(CO)(CCO)O)=O)=O,,,5,1,1,0,1
53228_0,,,,2,2,1,3
53229_0,,,,2,2,1,3
53230_0,,,,2,2,1,3
53232_0,,,,2,2,1,3
C(C(C(C(C)O)(CC(C)O)O)=O)=O,,,5,1,1,0,1
53234_0,,,,2,2,1,3
C(C(C(C=O)=O)(CC(C)O)O)(O)=O,,,5,1,1,0,1
53236_0,,,,2,2,1,3
C(C(C(CO)(CC(C)O)O)=O)=O,,,5,1,1,0,1
53238_0,,,,2,2,1,3
C=CC(C(C(C=O)=O)(CCO)O)O,,,5,1,1,0,1
53239_0,,,,2,2,1,3
53241_0,,,,2,2,1,3
C(C(C(C(C)O)(CCO)O)=O)=O,,,5,1,1,0,1
53242_0,,,,2,2,1,3
53243_0,,,,2,2,1,3
53245_0,,,,2,2,1,3
C(C(C(C(CO)O)(CCO)O)=O)=O,,,5,1,1,0,1
53247_0,,,,2,2,1,3
C(C(C(CO)(CC(CO)O)O)=O)=O,,,5,1,2,0,2
53249_0,,,,2,2,1,3
C(C(C(C(CO)(C)O)=O)(CO)O)=O,,,5,1,1,0,1
53251_0,,,,2,2,1,3
C(C(C(C(CO)(C)O)=O)(C)O)(O)=O,,,5,1,1,0,1
53253_0,,,,2,2,1,3
C(C(C(C(C)(C(C)O)O)=O)O)(O)=O,,,5,1,1,0,1
53254_0,,,,2,2,1,3
53255_0,,,,2,2,1,3
53257_0,,,,2,2,1,3
C(C(CO)(CC(C=O)(CO)O)O)=O,,,5,1,1,0,1
53258_0,,,,2,2,1,3
53259_0,,,,2,2,1,3
53260_0,,,,2,2,1,3
53262_0,,,,2,2,1,3
C(C(C(C(C)O)(CCO)O)=O)(O)=O,,,5,1,1,0,1
53263_0,,,,2,2,1,3
53264_0,,,,2,2,1,3
53265_0,,,,2,2,1,3
53267_0,,,,2,2,1,3
C(C(C1(COC(C1O)O)O)(O)O)=O,,,5,1,2,0,2
53269_0,,,,2,2,1,3
C(C(C)(C1(COC(C1O)O)O)O)=O,,,5,1,3,0,3
53271_0,,,,2,2,1,3
[C](C(O)=O)(C1(COC(C1O)O)O)O,,,5,1,2,0,2
53272_0,,,,2,2,1,3
53273_0,,,,2,2,1,3
53274_0,,,,2,2,1,3
53275_0,,,,2,2,1,3
53277_0,,,,2,2,1,3
C(C)(C(CCO)(C(C=CC)O)O)=O,,,5,1,1,0,1
53279_0,,,,2,2,1,3
C(C)(C(C(CC=C)O)(CCO)O)=O,,,5,1,1,0,1
53281_0,,,,2,2,1,3
C(C)(C(CCO)(C(C=C)O)O)=O,,,5,1,1,0,1
53282_0,,,,2,2,1,3
53283_0,,,,2,2,1,3
53284_0,,,,2,2,1,3
53285_0,,,,2,2,1,3
53286_0,,,,2,2,1,3
53287_0,,,,2,2,1,3
53288_0,,,,2,2,1,3
53289_0,,,,2,2,1,3
53290_0,,,,2,2,1,3
53291_0,,,,2,2,1,3
53292_0,,,,2,2,1,3
53293_0,,,,2,2,1,3
53294_0,,,,2,2,1,3
53295_0,,,,2,2,1,3
53296_0,,,,2,2,1,3
53297_0,,,,2,2,1,3
53298_0,,,,2,2,1,3
53299_0,,,,2,2,1,3
53300_0,,,,2,2,1,3
53301_0,,,,2,2,1,3
53302_0,,,,2,2,1,3
53303_0,,,,2,2,1,3
53304_0,,,,2,2,1,3
53305_0,,,,2,2,1,3
53306_0,,,,2,2,1,3
53307_0,,,,2,2,1,3
53308_0,,,,2,2,1,3
53309_0,,,,2,2,1,3
53311_0,,,,2,2,1,3
C(C(C(CO)CO)(C(C=C)O)O)=O,,,5,1,1,0,1
53312_0,,,,2,2,1,3
53313_0,,,,2,2,1,3
53314_0,,,,2,2,1,3
53315_0,,,,2,2,1,3
53316_0,,,,2,2,1,3
53317_0,,,,2,2,1,3
53319_0,,,,2,2,1,3
C(CO)(C(CCO)(C(C=C)O)O)=O,,,5,1,1,0,1
53320_0,,,,2,2,1,3
53321_0,,,,2,2,1,3
53322_0,,,,2,2,1,3
53323_0,,,,2,2,1,3
53324_0,,,,2,2,1,3
53325_0,,,,2,2,1,3
53327_0,,,,2,2,1,3
C(C(C(C=C)(CO)O)(O)O)(O)=O,,,5,1,1,0,1
53329_0,,,,2,2,1,3
C(C(C=C)(C(C=C)(CO)O)O)=O,,,5,1,1,0,1
53331_0,,,,2,2,1,3
C(C(CC)(C(C=C)(CO)O)O)(O)=O,,,5,1,1,0,1
53332_0,,,,2,2,1,3
53333_0,,,,2,2,1,3
53334_0,,,,2,2,1,3
53335_0,,,,2,2,1,3
53336_0,,,,2,2,1,3
53337_0,,,,2,2,1,3
53338_0,,,,2,2,1,3
53339_0,,,,2,2,1,3
53340_0,,,,2,2,1,3
53341_0,,,,2,2,1,3
53342_0,,,,2,2,1,3
53344_0,,,,2,2,1,3
C(C(C(C=CCO)O)(O)O)(O)=O,,,5,1,1,0,1
53346_0,,,,2,2,1,3
C(C(C=C)(C(C=CCO)O)O)=O,,,5,1,1,0,1
53348_0,,,,2,2,1,3
C(C(CC)(C(C=CCO)O)O)(O)=O,,,5,1,1,0,1
53349_0,,,,2,2,1,3
53350_0,,,,2,2,1,3
53351_0,,,,2,2,1,3
53352_0,,,,2,2,1,3
53353_0,,,,2,2,1,3
53354_0,,,,2,2,1,3
53355_0,,,,2,2,1,3
53356_0,,,,2,2,1,3
53357_0,,,,2,2,1,3
53358_0,,,,2,2,1,3
53359_0,,,,2,2,1,3
53361_0,,,,2,2,1,3
C(CC(C(C)=O)(C(C=C)O)O)(O)=O,,,5,1,1,0,1
53362_0,,,,2,2,1,3
53363_0,,,,2,2,1,3
53364_0,,,,2,2,1,3
53365_0,,,,2,2,1,3
53366_0,,,,2,2,1,3
53367_0,,,,2,2,1,3
53368_0,,,,2,2,1,3
53369_0,,,,2,2,1,3
53370_0,,,,2,2,1,3
53371_0,,,,2,2,1,3
53372_0,,,,2,2,1,3
53373_0,,,,2,2,1,3
53374_0,,,,2,2,1,3
53375_0,,,,2,2,1,3
53376_0,,,,2,2,1,3
53377_0,,,,2,2,1,3
53378_0,,,,2,2,1,3
53379_0,,,,2,2,1,3
53380_0,,,,2,2,1,3
53382_0,,,,2,2,1,3
C(C(C=C)(C(C(O)=O)(O)O)O)(O)=O,,,5,1,1,0,1
53383_0,,,,2,2,1,3
53384_0,,,,2,2,1,3
53385_0,,,,2,2,1,3
53386_0,,,,2,2,1,3
53387_0,,,,2,2,1,3
53388_0,,,,2,2,1,3
53390_0,,,,2,2,1,3
C(C(C(C=CC(O)=O)O)(O)O)(O)=O,,,5,1,1,0,1
53392_0,,,,2,2,1,3
C(C(C=C)(C(C=CC(O)=O)O)O)=O,,,5,1,1,0,1
53393_0,,,,2,2,1,3
53394_0,,,,2,2,1,3
53395_0,,,,2,2,1,3
53396_0,,,,2,2,1,3
53397_0,,,,2,2,1,3
53399_0,,,,2,2,1,3
C(C(C(C(CO)(O)O)O)(O)O)(O)=O,,,5,1,1,0,1
53401_0,,,,2,2,1,3
C(C(C(C(CO)(C)O)O)(O)O)(O)=O,,,5,1,1,0,1
53403_0,,,,2,2,1,3
C(C(CC)(C(C(O)=O)(O)O)O)=O,,,5,1,1,0,1
53405_0,,,,2,2,1,3
C(C(C(C(O)=O)(O)O)O)(CC)=O,,,5,1,1,0,1
53407_0,,,,2,2,1,3
C(CCC(C(C(O)=O)(O)O)O)=O,,,5,1,1,0,1
53409_0,,,,2,2,1,3
C(C)(C(C)(C(C(O)=O)(O)O)O)=O,,,5,1,1,0,1
53411_0,,,,2,2,1,3
C(C(CC)(C(C(O)=O)(O)O)O)(O)=O,,,5,1,1,0,1
53413_0,,,,2,2,1,3
C(CC(C)(C(C(O)=O)(O)O)O)(O)=O,,,5,1,1,0,1
53415_0,,,,2,2,1,3
C(C(C)C(C(C(O)=O)(O)O)O)(O)=O,,,5,1,1,0,1
53417_0,,,,2,2,1,3
C1(C(CCO1)(C(C(O)=O)(O)O)O)=O,,,5,1,1,0,1
53419_0,,,,2,2,1,3
C1(CC(CO1)(C(C(O)=O)(O)O)O)=O,,,5,1,1,0,1
53421_0,,,,2,2,1,3
C(C(C(C=C(C=O)C)O)(O)O)(O)=O,,,5,1,1,0,1
53423_0,,,,2,2,1,3
C(C(C(C(C)=CC=O)O)(O)O)(O)=O,,,5,1,1,0,1
53425_0,,,,2,2,1,3
C(C(C(CC(C=O)=C)O)(O)O)(O)=O,,,5,1,1,0,1
53427_0,,,,2,2,1,3
C(CC(C(C(C(O)=O)(O)O)O)=C)=O,,,5,1,1,0,1
53429_0,,,,2,2,1,3
C(C(C(C=CC(C)=O)O)(O)O)(O)=O,,,5,1,1,0,1
53431_0,,,,2,2,1,3
C(C(C(C=CC=O)(C)O)(O)O)(O)=O,,,5,1,1,0,1
53433_0,,,,2,2,1,3
C(C(C(C=O)(CC=C)O)(O)O)(O)=O,,,5,1,1,0,1
53435_0,,,,2,2,1,3
C(C(C(C(CC=C)=O)O)(O)O)(O)=O,,,5,1,1,0,1
53437_0,,,,2,2,1,3
C(C(C=CC)(C(C(O)=O)(O)O)O)=O,,,5,1,1,0,1
53439_0,,,,2,2,1,3
C(C(C(C(C=CC)=O)O)(O)O)(O)=O,,,5,1,1,0,1
53441_0,,,,2,2,1,3
C(CC=CC(C(C(O)=O)(O)O)O)=O,,,5,1,1,0,1
53443_0,,,,2,2,1,3
C(C(C(CC=CC=O)O)(O)O)(O)=O,,,5,1,1,0,1
53444_0,,,,2,2,1,3
53446_0,,,,2,2,1,3
C(C(C(C(C=O)=CC)O)(O)O)(O)=O,,,5,1,1,0,1
53448_0,,,,2,2,1,3
C(C(C(C(C=O)=C)O)(O)O)(O)=O,,,5,1,1,0,1
53450_0,,,,2,2,1,3
C(C(C(C=CC)O)(O)O)(O)=O,,,5,1,1,0,1
53452_0,,,,2,2,1,3
C(C(C(CC=C)O)(O)O)(O)=O,,,5,1,1,0,1
53454_0,,,,2,2,1,3
C(C(C(C(C=C)O)O)(O)O)(O)=O,,,5,1,1,0,1
53456_0,,,,2,2,1,3
C(C(C(C=C)O)(O)O)(O)=O,,,5,1,1,0,1
53458_0,,,,2,2,1,3
C(C(C1(C=COC1)O)(O)O)(O)=O,,,5,1,1,0,1
53459_0,,,,2,2,1,3
53460_0,,,,2,2,1,3
53461_0,,,,2,2,1,3
53462_0,,,,2,2,1,3
53463_0,,,,2,2,1,3
53464_0,,,,2,2,1,3
53465_0,,,,2,2,1,3
53466_0,,,,2,2,1,3
53467_0,,,,2,2,1,3
53468_0,,,,2,2,1,3
53469_0,,,,2,2,1,3
53470_0,,,,2,2,1,3
53471_0,,,,2,2,1,3
53472_0,,,,2,2,1,3
53473_0,,,,2,2,1,3
53474_0,,,,2,2,1,3
53475_0,,,,2,2,1,3
53476_0,,,,2,2,1,3
53477_0,,,,2,2,1,3
53478_0,,,,2,2,1,3
53479_0,,,,2,2,1,3
53480_0,,,,2,2,1,3
53481_0,,,,2,2,1,3
53482_0,,,,2,2,1,3
53483_0,,,,2,2,1,3
53484_0,,,,2,2,1,3
53485_0,,,,2,2,1,3
53486_0,,,,2,2,1,3
53487_0,,,,2,2,1,3
53488_0,,,,2,2,1,3
53489_0,,,,2,2,1,3
53490_0,,,,2,2,1,3
53491_0,,,,2,2,1,3
53492_0,,,,2,2,1,3
53493_0,,,,2,2,1,3
53494_0,,,,2,2,1,3
53495_0,,,,2,2,1,3
53496_0,,,,2,2,1,3
53497_0,,,,2,2,1,3
53498_0,,,,2,2,1,3
53499_0,,,,2,2,1,3
53500_0,,,,2,2,1,3
53501_0,,,,2,2,1,3
53502_0,,,,2,2,1,3
53503_0,,,,2,2,1,3
53504_0,,,,2,2,1,3
53505_0,,,,2,2,1,3
53506_0,,,,2,2,1,3
53507_0,,,,2,2,1,3
53508_0,,,,2,2,1,3
53509_0,,,,2,2,1,3
53510_0,,,,2,2,1,3
53511_0,,,,2,2,1,3
53512_0,,,,2,2,1,3
53513_0,,,,2,2,1,3
53514_0,,,,2,2,1,3
53515_0,,,,2,2,1,3
53516_0,,,,2,2,1,3
53517_0,,,,2,2,1,3
53518_0,,,,2,2,1,3
53519_0,,,,2,2,1,3
53520_0,,,,2,2,1,3
53521_0,,,,2,2,1,3
53522_0,,,,2,2,1,3
53524_0,,,,2,2,1,3
C(C(C(C(C=O)(O)O)O)(O)O)(O)=O,,,5,1,1,0,1
53525_0,,,,2,2,1,3
53527_0,,,,2,2,1,3
C(C(C([C](C(O)=O)O)O)(O)O)(O)=O,,,5,1,1,0,1
53529_0,,,,2,2,1,3
C(C(C(C(C(C)O)(O)O)O)O)(O)=O,,,5,1,1,0,1
53531_0,,,,2,2,1,3
C(C(C(C(C(C)O)(O)O)O)(O)O)=O,,,5,1,1,0,1
53533_0,,,,2,2,1,3
C(C(C)(C(C(C(C)O)(O)O)O)O)=O,,,5,1,1,0,1
53535_0,,,,2,2,1,3
[C](C(O)=O)(C(C(C(C)O)(O)O)O)O,,,5,1,1,0,1
53537_0,,,,2,2,1,3
C(C(C=C)(C(C(CO)(O)O)O)O)=O,,,5,1,1,0,1
53539_0,,,,2,2,1,3
C(C(C(C(CO)(O)O)O)O)(O)=O,,,5,1,1,0,1
53541_0,,,,2,2,1,3
C(C(C)(C(C(CO)(O)O)O)O)(O)=O,,,5,1,1,0,1
53543_0,,,,2,2,1,3
C(C(C(C(CO)(O)O)O)(O)O)=O,,,5,1,1,0,1
53545_0,,,,2,2,1,3
C(C(C)(C(C(CO)(O)O)O)O)=O,,,5,1,1,0,1
53547_0,,,,2,2,1,3
[C](C(O)=O)(C(C(CO)(O)O)O)O,,,5,1,1,0,1
53549_0,,,,2,2,1,3
C(C(C(C(C)(C(C)O)O)O)O)(O)=O,,,5,1,1,0,1
53551_0,,,,2,2,1,3
C(C(C(C(C)(C(C)O)O)O)(O)O)=O,,,5,1,1,0,1
53553_0,,,,2,2,1,3
C(C(C)(C(C(C)(C(C)O)O)O)O)=O,,,5,1,1,0,1
53555_0,,,,2,2,1,3
[C](C(O)=O)(C(C(C)(C(C)O)O)O)O,,,5,1,1,0,1
53557_0,,,,2,2,1,3
C(C(C=C)(C(C(CO)(C)O)O)O)=O,,,5,1,1,0,1
53558_0,,,,2,2,1,3
53559_0,,,,2,2,1,3
53561_0,,,,2,2,1,3
C(C(C(C(CO)(C)O)O)(O)O)=O,,,5,1,1,0,1
53563_0,,,,2,2,1,3
C(C(C)(C(C(CO)(C)O)O)O)=O,,,5,1,1,0,1
53565_0,,,,2,2,1,3
[C](C(O)=O)(C(C(CO)(C)O)O)O,,,5,1,2,0,2
53567_0,,,,2,2,1,3
C(CO)(OC(C=O)(C(C=C)O)O)=O,,,5,1,1,0,1
53569_0,,,,2,2,1,3
C(CO)(OC(C=O)(C(C=O)O)O)=O,,,5,1,1,0,1
53571_0,,,,2,2,1,3
C(C(C(C)O)(O)OC(CO)=O)=O,,,5,1,1,0,1
53573_0,,,,2,2,1,3
C(C(C=O)(O)OC(CO)=O)(O)=O,,,5,1,1,0,1
53575_0,,,,2,2,1,3
C(C(CO)(O)OC(CO)=O)=O,,,5,1,2,0,2
53577_0,,,,2,2,1,3
C(C(C(CO)O)(O)OC(CO)=O)=O,,,5,1,2,0,2
53579_0,,,,2,2,1,3
C(C(C(C=C)O)O)(OC(C=O)O)=O,,,5,1,1,0,1
53580_0,,,,2,2,1,3
53582_0,,,,2,2,1,3
C(C(C(C)O)O)(OC(C=O)O)=O,,,5,1,3,0,3
53584_0,,,,2,2,1,3
C(C(C(O)=O)O)(OC(C=O)O)=O,,,5,1,3,0,3
53586_0,,,,2,2,1,3
C(C(CO)O)(OC(C=O)O)=O,,,5,1,3,0,3
53588_0,,,,2,2,1,3
C(C(C(CO)O)O)(OC(C=O)O)=O,,,5,1,3,0,3
53590_0,,,,2,2,1,3
C(C(C(C=CC)O)O)(OCC=O)=O,,,5,1,1,0,1
53592_0,,,,2,2,1,3
C(C(C(CC=C)O)O)(OCC=O)=O,,,5,1,1,0,1
53594_0,,,,2,2,1,3
C(C(C(C=C)O)O)(OCC=O)=O,,,5,1,1,0,1
53595_0,,,,2,2,1,3
53597_0,,,,2,2,1,3
C(C(C(C(O)=O)O)O)(OCC=O)=O,,,5,1,3,0,3
53599_0,,,,2,2,1,3
C(COC(C(C(C=O)(C)O)O)=O)=O,,,5,1,3,0,3
53601_0,,,,2,2,1,3
C(C(C(C(C)=O)O)O)(OCC=O)=O,,,5,1,3,0,3
53603_0,,,,2,2,1,3
C(C(C(CC=O)O)O)(OCC=O)=O,,,5,1,3,0,3
53605_0,,,,2,2,1,3
C(C(C(C)O)O)(OCC=O)=O,,,5,1,3,0,3
53607_0,,,,2,2,1,3
C(C(C(CCO)O)O)(OCC=O)=O,,,5,1,3,0,3
53609_0,,,,2,2,1,3
C(C(C(CO)(C)O)O)(OCC=O)=O,,,5,1,3,0,3
53611_0,,,,2,2,1,3
C(C(C(O)=O)O)(OCC=O)=O,,,5,1,3,0,3
53613_0,,,,2,2,1,3
C(C(C(C(O)O)O)O)(OCC=O)=O,,,5,1,3,0,3
53615_0,,,,2,2,1,3
C(C(C(C(C)O)O)O)(OCC=O)=O,,,5,1,3,0,3
53617_0,,,,2,2,1,3
C(C(CO)O)(OCC=O)=O,,,5,1,3,0,3
53619_0,,,,2,2,1,3
C(C(C(CO)O)O)(OCC=O)=O,,,5,1,3,0,3
53620_0,,,,2,2,1,3
53622_0,,,,2,2,1,3
C(C(C(COC(CO)=O)O)(O)O)=O,,,5,1,1,0,1
53624_0,,,,2,2,1,3
C(C(C)(C(COC(CO)=O)O)O)=O,,,5,1,1,0,1
53626_0,,,,2,2,1,3
C(CO)(OCC([C](C(O)=O)O)O)=O,,,5,1,1,0,1
53628_0,,,,2,2,1,3
C(C(C(C)O)O)(OC(C=O)CO)=O,,,5,1,3,0,3
53630_0,,,,2,2,1,3
C(C(C(OC(C=O)CO)=O)O)(O)=O,,,5,1,3,0,3
53632_0,,,,2,2,1,3
C(C(CO)O)(OC(C=O)CO)=O,,,5,1,3,0,3
53634_0,,,,2,2,1,3
C(C(C(C)O)O)(OCC(C=O)O)=O,,,5,1,3,0,3
53636_0,,,,2,2,1,3
C(C(C(O)=O)O)(OCC(C=O)O)=O,,,5,1,3,0,3
53638_0,,,,2,2,1,3
C(C(CO)O)(OCC(C=O)O)=O,,,5,1,3,0,3
53639_0,,,,2,2,1,3
53641_0,,,,2,2,1,3
C(C(C=O)(CC(CC=O)=O)O)(O)=O,,,5,1,1,0,1
53642_0,,,,2,2,1,3
53644_0,,,,2,2,1,3
C(C(CO)CC(C(C(O)=O)O)O)=O,,,5,1,1,0,1
53646_0,,,,2,2,1,3
C(C(CO)CC(C(C=O)(O)O)O)=O,,,5,1,1,0,1
53648_0,,,,2,2,1,3
C(C(CO)CC(C(C=O)(C)O)O)=O,,,5,1,1,0,1
53650_0,,,,2,2,1,3
C(C(CO)CC([C](C(O)=O)O)O)=O,,,5,1,1,0,1
53651_0,,,,2,2,1,3
53653_0,,,,2,2,1,3
C(CC(CO)C(C(C=O)(O)O)O)=O,,,5,1,3,0,3
53655_0,,,,2,2,1,3
C(C(C)(C(C(CO)CC=O)O)O)=O,,,5,1,3,0,3
53657_0,,,,2,2,1,3
C(CC(CO)C([C](C(O)=O)O)O)=O,,,5,1,3,0,3
53658_0,,,,2,2,1,3
53659_0,,,,2,2,1,3
53661_0,,,,2,2,1,3
C(C(C(C)(CC(CO)=O)O)(O)O)=O,,,5,1,1,0,1
53663_0,,,,2,2,1,3
C(C(C)(C(C)(CC(CO)=O)O)O)=O,,,5,1,1,0,1
53665_0,,,,2,2,1,3
C(CC([C](C(O)=O)O)(C)O)(CO)=O,,,5,1,1,0,1
53667_0,,,,2,2,1,3
C(C(C(CO)(CC(C)=O)O)O)(O)=O,,,5,1,1,0,1
53669_0,,,,2,2,1,3
C(C(C(CO)(CC(C)=O)O)(O)O)=O,,,5,1,1,0,1
53671_0,,,,2,2,1,3
C(C(C)(C(CO)(CC(C)=O)O)O)=O,,,5,1,1,0,1
53673_0,,,,2,2,1,3
C(CC([C](C(O)=O)O)(CO)O)(C)=O,,,5,1,1,0,1
53675_0,,,,2,2,1,3
C(C(CO)(C(C(O)=O)O)O)(CC)=O,,,5,1,1,0,1
53677_0,,,,2,2,1,3
C(C(CO)(C(C=O)(O)O)O)(CC)=O,,,5,1,1,0,1
53679_0,,,,2,2,1,3
C(C(CO)(C(C=O)(C)O)O)(CC)=O,,,5,1,1,0,1
53681_0,,,,2,2,1,3
C(CC)(C([C](C(O)=O)O)(CO)O)=O,,,5,1,1,0,1
53683_0,,,,2,2,1,3
C(CO)(C(CC)(C(C(O)=O)O)O)=O,,,5,1,1,0,1
53685_0,,,,2,2,1,3
C(CO)(C(CC)(C(C=O)(O)O)O)=O,,,5,1,1,0,1
53687_0,,,,2,2,1,3
C(C(C)(C(C(CO)=O)(CC)O)O)=O,,,5,1,1,0,1
53689_0,,,,2,2,1,3
C(CO)(C([C](C(O)=O)O)(CC)O)=O,,,5,1,1,0,1
53690_0,,,,2,2,1,3
53692_0,,,,2,2,1,3
C(C(C(C=O)(C(C=O)C)O)O)(O)=O,,,5,1,1,0,1
53694_0,,,,2,2,1,3
C(C(C(C=O)(C(C=O)C)O)(O)O)=O,,,5,1,1,0,1
53696_0,,,,2,2,1,3
C(C(C)C(C=O)(C(C=O)(C)O)O)=O,,,5,1,1,0,1
53698_0,,,,2,2,1,3
C(C([C](C(O)=O)O)(C(C=O)C)O)=O,,,5,1,1,0,1
53700_0,,,,2,2,1,3
C(C(C(C(C(C(O)=O)O)O)=O)C)=O,,,5,1,1,0,1
53702_0,,,,2,2,1,3
C(C(C(C=O)(O)O)O)(C(C=O)C)=O,,,5,1,1,0,1
53704_0,,,,2,2,1,3
C(C(C)(C(C(C(C=O)C)=O)O)O)=O,,,5,1,1,0,1
53706_0,,,,2,2,1,3
C(C(C(C([C](C(O)=O)O)O)=O)C)=O,,,5,1,1,0,1
53707_0,,,,2,2,1,3
53709_0,,,,2,2,1,3
C(C(C(C(C(C=O)=O)C)O)(O)O)=O,,,5,1,1,0,1
53710_0,,,,2,2,1,3
53712_0,,,,2,2,1,3
[C](C(O)=O)(C(C(C(C=O)=O)C)O)O,,,5,1,1,0,1
53713_0,,,,2,2,1,3
53715_0,,,,2,2,1,3
C(C(C(CC(C(C)=O)=O)O)(O)O)=O,,,5,1,1,0,1
53716_0,,,,2,2,1,3
53718_0,,,,2,2,1,3
C([C](C(CC(C(C)=O)=O)O)O)(O)=O,,,5,1,1,0,1
53719_0,,,,2,2,1,3
53721_0,,,,2,2,1,3
C(C(C)(C(C=O)(O)O)O)(CC=O)=O,,,5,1,1,0,1
53722_0,,,,2,2,1,3
53724_0,,,,2,2,1,3
C(CC=O)(C([C](C(O)=O)O)(C)O)=O,,,5,1,1,0,1
53725_0,,,,2,2,1,3
53727_0,,,,2,2,1,3
C(CC(C(C)=O)(C(C=O)(O)O)O)=O,,,5,1,1,0,1
53728_0,,,,2,2,1,3
53730_0,,,,2,2,1,3
C(CC(C(C)=O)([C](C(O)=O)O)O)=O,,,5,1,1,0,1
53731_0,,,,2,2,1,3
53733_0,,,,2,2,1,3
C(C(C(CCC(C=O)=O)O)(O)O)=O,,,5,1,2,0,2
53735_0,,,,2,2,1,3
C(C(C)(C(CCC(C=O)=O)O)O)=O,,,5,1,2,0,2
53737_0,,,,2,2,1,3
[C](C(O)=O)(C(CCC(C=O)=O)O)O,,,5,1,3,0,3
53739_0,,,,2,2,1,3
C(CCC(C=O)(C(C(O)=O)O)O)=O,,,5,1,2,0,2
53741_0,,,,2,2,1,3
C(CCC(C=O)(C(C=O)(O)O)O)=O,,,5,1,2,0,2
53743_0,,,,2,2,1,3
C(CCC(C=O)(C(C=O)(C)O)O)=O,,,5,1,2,0,2
53745_0,,,,2,2,1,3
C(C([C](C(O)=O)O)(CCC=O)O)=O,,,5,1,2,0,2
53746_0,,,,2,2,1,3
53748_0,,,,2,2,1,3
C(CCC(C(C(C=O)(O)O)O)=O)=O,,,5,1,1,0,1
53749_0,,,,2,2,1,3
53751_0,,,,2,2,1,3
C(CCC(C([C](C(O)=O)O)O)=O)=O,,,5,1,1,0,1
53752_0,,,,2,2,1,3
53754_0,,,,2,2,1,3
C(CC(C(C=O)(O)O)O)(CC=O)=O,,,5,1,1,0,1
53755_0,,,,2,2,1,3
53757_0,,,,2,2,1,3
C(CC(CC([C](C(O)=O)O)O)=O)=O,,,5,1,1,0,1
53758_0,,,,2,2,1,3
53760_0,,,,2,2,1,3
C(CC(C(C=O)(O)O)(CC=O)O)=O,,,5,1,1,0,1
53762_0,,,,2,2,1,3
C(C(C)(C(CC=O)(CC=O)O)O)=O,,,5,1,1,0,1
53764_0,,,,2,2,1,3
C(CC([C](C(O)=O)O)(CC=O)O)=O,,,5,1,1,0,1
53766_0,,,,2,2,1,3
C(C(C=O)CC(C(C(O)=O)O)O)=O,,,5,1,2,0,2
53768_0,,,,2,2,1,3
C(C(C=O)CC(C(C=O)(O)O)O)=O,,,5,1,2,0,2
53770_0,,,,2,2,1,3
C(C(C=O)CC(C(C=O)(C)O)O)=O,,,5,1,2,0,2
53772_0,,,,2,2,1,3
C(C(C=O)CC([C](C(O)=O)O)O)=O,,,5,1,2,0,2
53773_0,,,,2,2,1,3
53775_0,,,,2,2,1,3
C(C(C(C(C=O)(O)O)O)CC=O)=O,,,5,1,2,0,2
53776_0,,,,2,2,1,3
53778_0,,,,2,2,1,3
C(CC(C=O)C([C](C(O)=O)O)O)=O,,,5,1,3,0,3
53779_0,,,,2,2,1,3
53780_0,,,,2,2,1,3
53781_0,,,,2,2,1,3
53782_0,,,,2,2,1,3
53783_0,,,,2,2,1,3
53784_0,,,,2,2,1,3
53785_0,,,,2,2,1,3
53787_0,,,,2,2,1,3
C(C(C(C)=O)C(C(O)=O)(C=O)O)=O,,,5,1,1,0,1
53788_0,,,,2,2,1,3
53789_0,,,,2,2,1,3
53791_0,,,,2,2,1,3
C(C(C=O)(CC(C(C)=O)=O)O)(O)=O,,,5,1,1,0,1
53792_0,,,,2,2,1,3
53793_0,,,,2,2,1,3
53795_0,,,,2,2,1,3
C(C(C=O)(C(C(C=O)=O)C)O)(O)=O,,,5,1,1,0,1
53796_0,,,,2,2,1,3
53798_0,,,,2,2,1,3
C(CC)(C(C=O)(C(C(O)=O)O)O)=O,,,5,1,1,0,1
53800_0,,,,2,2,1,3
C(CC)(C(C=O)(C(C=O)(O)O)O)=O,,,5,1,1,0,1
53802_0,,,,2,2,1,3
C(CC)(C(C=O)(C(C=O)(C)O)O)=O,,,5,1,1,0,1
53804_0,,,,2,2,1,3
C(C(C(CC)=O)([C](C(O)=O)O)O)=O,,,5,1,1,0,1
53805_0,,,,2,2,1,3
53807_0,,,,2,2,1,3
C(C(C(C(C(CC)=O)=O)O)(O)O)=O,,,5,1,1,0,1
53808_0,,,,2,2,1,3
53810_0,,,,2,2,1,3
[C](C(O)=O)(C(C(C(CC)=O)=O)O)O,,,5,1,1,0,1
53812_0,,,,2,2,1,3
C(C(C(C(C=O)=O)(CC)O)O)(O)=O,,,5,1,1,0,1
53814_0,,,,2,2,1,3
C(C(C(C(C=O)=O)(CC)O)(O)O)=O,,,5,1,1,0,1
53816_0,,,,2,2,1,3
C(C(C)(C(C(C=O)=O)(CC)O)O)=O,,,5,1,1,0,1
53818_0,,,,2,2,1,3
[C](C(O)=O)(C(C(C=O)=O)(CC)O)O,,,5,1,1,0,1
53820_0,,,,2,2,1,3
C(C(C=C)(C(C=O)(CC)O)O)=O,,,5,1,1,0,1
53822_0,,,,2,2,1,3
C(C(CC)(C(C=O)(CC)O)O)(O)=O,,,5,1,1,0,1
53824_0,,,,2,2,1,3
C(C(CC)(C(C(O)=O)O)O)=O,,,5,1,1,0,1
53826_0,,,,2,2,1,3
C(CC(C=O)(C(C=O)(CC)O)O)=O,,,5,1,1,0,1
53828_0,,,,2,2,1,3
C(C(C)(C(C=O)(CC)O)O)(O)=O,,,5,1,1,0,1
53830_0,,,,2,2,1,3
C(C(CC)(C(C(C=O)=O)(C)O)O)=O,,,5,1,1,0,1
53832_0,,,,2,2,1,3
C(C(CCO)(C(C=O)(CC)O)O)=O,,,5,1,1,0,1
53834_0,,,,2,2,1,3
C(C(CC)(C1(C(CCO1)=O)O)O)=O,,,5,1,1,0,1
53836_0,,,,2,2,1,3
C(C(C=C)(C(C=O)(CC)O)O)(O)=O,,,5,1,1,0,1
53838_0,,,,2,2,1,3
C1(C(CCO1)(C(C=O)(CC)O)O)=O,,,5,1,1,0,1
53840_0,,,,2,2,1,3
C(C(CC)(C(C=O)(O)O)O)=O,,,5,1,1,0,1
53842_0,,,,2,2,1,3
C(C(CC)(C(C=O)(C)O)O)=O,,,5,1,1,0,1
53844_0,,,,2,2,1,3
C(C([C](C(O)=O)O)(CC)O)=O,,,5,1,1,0,1
53846_0,,,,2,2,1,3
C(C(C=C)(C(C(CC)=O)O)O)=O,,,5,1,1,0,1
53848_0,,,,2,2,1,3
C(C(CC)(C(C(CC)=O)O)O)(O)=O,,,5,1,1,0,1
53850_0,,,,2,2,1,3
C(C(C(C(O)=O)O)O)(CC)=O,,,5,1,2,0,2
53852_0,,,,2,2,1,3
C(C(C(C=O)(CC=O)O)O)(CC)=O,,,5,1,1,0,1
53854_0,,,,2,2,1,3
C(C(C)(C(C(CC)=O)O)O)(O)=O,,,5,1,2,0,2
53856_0,,,,2,2,1,3
C(C(C(C(C=O)=O)(C)O)O)(CC)=O,,,5,1,1,0,1
53858_0,,,,2,2,1,3
C(C(CCO)(C(C(CC)=O)O)O)=O,,,5,1,1,0,1
53860_0,,,,2,2,1,3
C(C(C1(C(CCO1)=O)O)O)(CC)=O,,,5,1,1,0,1
53862_0,,,,2,2,1,3
C(C(C=C)(C(C(CC)=O)O)O)(O)=O,,,5,1,1,0,1
53864_0,,,,2,2,1,3
C1(C(CCO1)(C(C(CC)=O)O)O)=O,,,5,1,1,0,1
53866_0,,,,2,2,1,3
C(C(C(C=O)(O)O)O)(CC)=O,,,5,1,2,0,2
53868_0,,,,2,2,1,3
C(C(C)(C(C(CC)=O)O)O)=O,,,5,1,2,0,2
53870_0,,,,2,2,1,3
C(CC)(C([C](C(O)=O)O)O)=O,,,5,1,2,0,2
53872_0,,,,2,2,1,3
C(CCC(CO)(C(C(O)=O)O)O)=O,,,5,1,2,0,2
53874_0,,,,2,2,1,3
C(CCC(CO)(C(C=O)(O)O)O)=O,,,5,1,2,0,2
53876_0,,,,2,2,1,3
C(C(C)(C(CO)(CCC=O)O)O)=O,,,5,1,2,0,2
53878_0,,,,2,2,1,3
C(CCC([C](C(O)=O)O)(CO)O)=O,,,5,1,2,0,2
53879_0,,,,2,2,1,3
53881_0,,,,2,2,1,3
C(C(C(CCC(CO)=O)O)(O)O)=O,,,5,1,2,0,2
53883_0,,,,2,2,1,3
C(C(C)(C(CCC(CO)=O)O)O)=O,,,5,1,2,0,2
53885_0,,,,2,2,1,3
C(CO)(CCC([C](C(O)=O)O)O)=O,,,5,1,2,0,2
53886_0,,,,2,2,1,3
53888_0,,,,2,2,1,3
C(CC(CCO)(C(C=O)(O)O)O)=O,,,5,1,1,0,1
53890_0,,,,2,2,1,3
C(C(C)(C(CCO)(CC=O)O)O)=O,,,5,1,1,0,1
53892_0,,,,2,2,1,3
C(CC([C](C(O)=O)O)(CCO)O)=O,,,5,1,1,0,1
53894_0,,,,2,2,1,3
C(CCO)(CC(C(C(O)=O)O)O)=O,,,5,1,1,0,1
53896_0,,,,2,2,1,3
C(CCO)(CC(C(C=O)(O)O)O)=O,,,5,1,1,0,1
53898_0,,,,2,2,1,3
C(C(C)(C(CC(CCO)=O)O)O)=O,,,5,1,1,0,1
53900_0,,,,2,2,1,3
C(CC([C](C(O)=O)O)O)(CCO)=O,,,5,1,1,0,1
53902_0,,,,2,2,1,3
C(C(C=C)(C(CCC=O)O)O)=O,,,5,1,2,0,2
53904_0,,,,2,2,1,3
C(C(C(CCC=O)O)(CC)O)(O)=O,,,5,1,1,0,1
53906_0,,,,2,2,1,3
C(CCC(C(C(O)=O)O)O)=O,,,5,1,3,0,3
53908_0,,,,2,2,1,3
C(CCC(C(C=O)(CC=O)O)O)=O,,,5,1,2,0,2
53910_0,,,,2,2,1,3
C(C(C)(C(CCC=O)O)O)(O)=O,,,5,1,3,0,3
53912_0,,,,2,2,1,3
C(CCC(C(C(C=O)=O)(C)O)O)=O,,,5,1,2,0,2
53914_0,,,,2,2,1,3
C(C(C(CCC=O)O)(CCO)O)=O,,,5,1,2,0,2
53916_0,,,,2,2,1,3
C(CCC(C1(C(CCO1)=O)O)O)=O,,,5,1,2,0,2
53918_0,,,,2,2,1,3
C(C(C=C)(C(CCC=O)O)O)(O)=O,,,5,1,2,0,2
53920_0,,,,2,2,1,3
C1(C(C(CCC=O)O)(CCO1)O)=O,,,5,1,2,0,2
53922_0,,,,2,2,1,3
C(CCC(C(C=O)(O)O)O)=O,,,5,1,3,0,3
53924_0,,,,2,2,1,3
C(C(C)(C(CCC=O)O)O)=O,,,5,1,3,0,3
53926_0,,,,2,2,1,3
C(CCC([C](C(O)=O)O)O)=O,,,5,1,3,0,3
53927_0,,,,2,2,1,3
53929_0,,,,2,2,1,3
C(C(C=C)(C(C(C)=O)(C)O)O)=O,,,5,1,1,0,1
53931_0,,,,2,2,1,3
C(C(CC)(C(C(C)=O)(C)O)O)(O)=O,,,5,1,1,0,1
53933_0,,,,2,2,1,3
C(C)(C(C)(C(C(O)=O)O)O)=O,,,5,1,2,0,2
53935_0,,,,2,2,1,3
C(C)(C(C)(C(C=O)(CC=O)O)O)=O,,,5,1,1,0,1
53937_0,,,,2,2,1,3
C(C(C)(C(C(C)=O)(C)O)O)(O)=O,,,5,1,2,0,2
53939_0,,,,2,2,1,3
C(C)(C(C)(C(C(C=O)=O)(C)O)O)=O,,,5,1,1,0,1
53941_0,,,,2,2,1,3
C(C(CCO)(C(C(C)=O)(C)O)O)=O,,,5,1,1,0,1
53943_0,,,,2,2,1,3
C(C)(C(C)(C1(C(CCO1)=O)O)O)=O,,,5,1,1,0,1
53945_0,,,,2,2,1,3
C(C(C=C)(C(C(C)=O)(C)O)O)(O)=O,,,5,1,1,0,1
53947_0,,,,2,2,1,3
C1(C(CCO1)(C(C(C)=O)(C)O)O)=O,,,5,1,1,0,1
53949_0,,,,2,2,1,3
C(C)(C(C)(C(C=O)(O)O)O)=O,,,5,1,2,0,2
53951_0,,,,2,2,1,3
C(C(C)(C(C(C)=O)(C)O)O)=O,,,5,1,2,0,2
53953_0,,,,2,2,1,3
C(C)(C([C](C(O)=O)O)(C)O)=O,,,5,1,2,0,2
53954_0,,,,2,2,1,3
53955_0,,,,2,2,1,3
53957_0,,,,2,2,1,3
C(C(C(C(C(C)=O)CO)O)O)(O)=O,,,5,1,1,0,1
53959_0,,,,2,2,1,3
C(C(C(C(C(C)=O)CO)O)(O)O)=O,,,5,1,1,0,1
53961_0,,,,2,2,1,3
C(C(C(C(C(C)=O)CO)O)(C)O)=O,,,5,1,1,0,1
53963_0,,,,2,2,1,3
C(C)(C(CO)C([C](C(O)=O)O)O)=O,,,5,1,1,0,1
53964_0,,,,2,2,1,3
53966_0,,,,2,2,1,3
C(C(CO)C(C)(C(C=O)(O)O)O)=O,,,5,1,1,0,1
53968_0,,,,2,2,1,3
C(C(CO)C(C)(C(C=O)(C)O)O)=O,,,5,1,1,0,1
53970_0,,,,2,2,1,3
C(C(CO)C([C](C(O)=O)O)(C)O)=O,,,5,1,1,0,1
53971_0,,,,2,2,1,3
53972_0,,,,2,2,1,3
53973_0,,,,2,2,1,3
53974_0,,,,2,2,1,3
53975_0,,,,2,2,1,3
53976_0,,,,2,2,1,3
53978_0,,,,2,2,1,3
C(C(C)C(C)(C(C(O)=O)O)O)(O)=O,,,5,1,1,0,1
53980_0,,,,2,2,1,3
C(C(C)C(C)(C(C=O)(O)O)O)(O)=O,,,5,1,1,0,1
53982_0,,,,2,2,1,3
C(C(C)C(C)(C(C=O)(C)O)O)(O)=O,,,5,1,1,0,1
53984_0,,,,2,2,1,3
C(C(C)C([C](C(O)=O)O)(C)O)(O)=O,,,5,1,1,0,1
53986_0,,,,2,2,1,3
C(C(C=C)(C(C(O)=O)(CC)O)O)=O,,,5,1,2,0,2
53988_0,,,,2,2,1,3
C(C(CC)(C(C(O)=O)O)O)(O)=O,,,5,1,2,0,2
53990_0,,,,2,2,1,3
C(C(CC)(C(C(O)=O)(C)O)O)(O)=O,,,5,1,2,0,2
53992_0,,,,2,2,1,3
C(C(CC)(C(C=O)(O)O)O)(O)=O,,,5,1,1,0,1
53994_0,,,,2,2,1,3
C(C(CC)(C(C=O)(C)O)O)(O)=O,,,5,1,2,0,2
53996_0,,,,2,2,1,3
C(C([C](C(O)=O)O)(CC)O)(O)=O,,,5,1,1,0,1
53998_0,,,,2,2,1,3
C(C(C=C)(C(C)(CC(O)=O)O)O)=O,,,5,1,1,0,1
53999_0,,,,2,2,1,3
54001_0,,,,2,2,1,3
C(C(C)(C(C)(CC(O)=O)O)O)(O)=O,,,5,1,1,0,1
54003_0,,,,2,2,1,3
C(CC(C)(C(C=O)(O)O)O)(O)=O,,,5,1,1,0,1
54005_0,,,,2,2,1,3
C(C(C)(C(C)(CC(O)=O)O)O)=O,,,5,1,1,0,1
54007_0,,,,2,2,1,3
C(CC([C](C(O)=O)O)(C)O)(O)=O,,,5,1,1,0,1
54009_0,,,,2,2,1,3
C(C(C=C)(C(C(C(O)=O)C)O)O)=O,,,5,1,1,0,1
54011_0,,,,2,2,1,3
C(C(C)C(C(C(O)=O)O)O)(O)=O,,,5,1,1,0,1
54013_0,,,,2,2,1,3
C(C(C)C(C(C(O)=O)(C)O)O)(O)=O,,,5,1,1,0,1
54015_0,,,,2,2,1,3
C(C(C)C(C(C=O)(O)O)O)(O)=O,,,5,1,1,0,1
54017_0,,,,2,2,1,3
C(C(C)C(C(C=O)(C)O)O)(O)=O,,,5,1,1,0,1
54019_0,,,,2,2,1,3
C(C(C)C([C](C(O)=O)O)O)(O)=O,,,5,1,1,0,1
54021_0,,,,2,2,1,3
C1(C(C(C=C)O)(O)OC(CO)C1)=O,,,5,1,1,0,1
54023_0,,,,2,2,1,3
C(C(C1(C(CC(CO)O1)=O)O)O)=O,,,5,1,1,0,1
54025_0,,,,2,2,1,3
C1(C(C(C)O)(O)OC(CO)C1)=O,,,5,1,1,0,1
54027_0,,,,2,2,1,3
C(C1(C(CC(CO)O1)=O)O)(O)=O,,,5,1,3,0,3
54029_0,,,,2,2,1,3
C1(C(CO)(O)OC(CO)C1)=O,,,5,1,3,0,3
54031_0,,,,2,2,1,3
C1(C(C(CO)O)(O)OC(CO)C1)=O,,,5,1,1,0,1
54033_0,,,,2,2,1,3
C1(C(CO)(O)OC(C(CO)O)C1)=O,,,5,1,2,0,2
54035_0,,,,2,2,1,3
C(C1C(C(C(C=C)O)(O)OC1)=O)=O,,,5,1,1,0,1
54037_0,,,,2,2,1,3
C(C(C1(C(C(C=O)CO1)=O)O)O)=O,,,5,1,1,0,1
54039_0,,,,2,2,1,3
C(C1C(C(C(C)O)(O)OC1)=O)=O,,,5,1,1,0,1
54041_0,,,,2,2,1,3
C(C1C(C(C(O)=O)(O)OC1)=O)=O,,,5,1,1,0,1
54043_0,,,,2,2,1,3
C(C1C(C(CO)(O)OC1)=O)=O,,,5,1,3,0,3
54045_0,,,,2,2,1,3
C(C1C(C(C(CO)O)(O)OC1)=O)=O,,,5,1,1,0,1
54047_0,,,,2,2,1,3
C(C1C(C(CO)(O)OC1CO)=O)=O,,,5,1,1,0,1
54048_0,,,,2,2,1,3
54050_0,,,,2,2,1,3
C1(C(C(CO1)(C(C=O)(O)O)O)O)=O,,,5,1,1,0,1
54051_0,,,,2,2,1,3
54053_0,,,,2,2,1,3
C1(C(C([C](C(O)=O)O)(CO1)O)O)=O,,,5,1,1,0,1
54055_0,,,,2,2,1,3
C1(CC(C(C(C=CC)O)(O)O1)=O)=O,,,5,1,1,0,1
54057_0,,,,2,2,1,3
C1(CC(C(C(CC=C)O)(O)O1)=O)=O,,,5,1,1,0,1
54059_0,,,,2,2,1,3
C1(CC(C(C(C=C)O)(O)O1)=O)=O,,,5,1,1,0,1
54061_0,,,,2,2,1,3
C1(CC(C(C(C=O)O)(O)O1)=O)=O,,,5,1,1,0,1
54063_0,,,,2,2,1,3
C1(CC(C(C(C(O)=O)O)(O)O1)=O)=O,,,5,1,1,0,1
54065_0,,,,2,2,1,3
C(C(C)(C1(C(CC(O1)=O)=O)O)O)=O,,,5,1,1,0,1
54067_0,,,,2,2,1,3
C1(CC(C(C(C(C)=O)O)(O)O1)=O)=O,,,5,1,1,0,1
54069_0,,,,2,2,1,3
C(CC(C1(C(CC(O1)=O)=O)O)O)=O,,,5,1,1,0,1
54071_0,,,,2,2,1,3
C1(CC(C(C(C)O)(O)O1)=O)=O,,,5,1,1,0,1
54073_0,,,,2,2,1,3
C1(CC(C(C(CCO)O)(O)O1)=O)=O,,,5,1,1,0,1
54075_0,,,,2,2,1,3
C1(CC(C(C(CO)(C)O)(O)O1)=O)=O,,,5,1,1,0,1
54077_0,,,,2,2,1,3
C1(CC(C(C(O)=O)(O)O1)=O)=O,,,5,1,1,0,1
54079_0,,,,2,2,1,3
C1(CC(C(C(C(O)O)O)(O)O1)=O)=O,,,5,1,1,0,1
54081_0,,,,2,2,1,3
C1(CC(C(C(C(C)O)O)(O)O1)=O)=O,,,5,1,1,0,1
54083_0,,,,2,2,1,3
C1(CC(C(CO)(O)O1)=O)=O,,,5,1,3,0,3
54085_0,,,,2,2,1,3
C1(CC(C(C(CO)O)(O)O1)=O)=O,,,5,1,3,0,3
54087_0,,,,2,2,1,3
C1(CC(C(O)O1)(C(C(O)=O)O)O)=O,,,5,1,2,0,2
54089_0,,,,2,2,1,3
C1(CC(C(O)O1)(C(C=O)(O)O)O)=O,,,5,1,2,0,2
54091_0,,,,2,2,1,3
C(C(C)(C1(C(O)OC(C1)=O)O)O)=O,,,5,1,2,0,2
54093_0,,,,2,2,1,3
C1(CC([C](C(O)=O)O)(C(O)O1)O)=O,,,5,1,2,0,2
54095_0,,,,2,2,1,3
C1(CC(C(O1)=O)(C(C=CC)O)O)=O,,,5,1,1,0,1
54097_0,,,,2,2,1,3
C1(C(C(CC=C)O)(CC(O1)=O)O)=O,,,5,1,1,0,1
54099_0,,,,2,2,1,3
C1(CC(C(O1)=O)(C(C=C)O)O)=O,,,5,1,1,0,1
54101_0,,,,2,2,1,3
C1(CC(C(O1)=O)(C(C=O)O)O)=O,,,5,1,3,0,3
54103_0,,,,2,2,1,3
C1(CC(C(O1)=O)(C(C(O)=O)O)O)=O,,,5,1,1,0,1
54105_0,,,,2,2,1,3
C1(CC(C(O1)=O)(C(C=O)(C)O)O)=O,,,5,1,1,0,1
54107_0,,,,2,2,1,3
C1(CC(C(O1)=O)(C(C(C)=O)O)O)=O,,,5,1,1,0,1
54109_0,,,,2,2,1,3
C1(C(C(CC=O)O)(CC(O1)=O)O)=O,,,5,1,1,0,1
54111_0,,,,2,2,1,3
C1(C(C(C)O)(CC(O1)=O)O)=O,,,5,1,3,0,3
54113_0,,,,2,2,1,3
C1(C(C(CCO)O)(CC(O1)=O)O)=O,,,5,1,1,0,1
54115_0,,,,2,2,1,3
C1(C(C(CO)(C)O)(CC(O1)=O)O)=O,,,5,1,1,0,1
54117_0,,,,2,2,1,3
C1(C(C(O)=O)(CC(O1)=O)O)=O,,,5,1,3,0,3
54119_0,,,,2,2,1,3
C1(C(C(C(O)O)O)(CC(O1)=O)O)=O,,,5,1,1,0,1
54121_0,,,,2,2,1,3
C1(C(C(C(C)O)O)(CC(O1)=O)O)=O,,,5,1,1,0,1
54123_0,,,,2,2,1,3
C1(C(CO)(CC(O1)=O)O)=O,,,5,1,3,0,3
54125_0,,,,2,2,1,3
C1(C(C(CO)O)(CC(O1)=O)O)=O,,,5,1,3,0,3
54127_0,,,,2,2,1,3
C1(C(CC(O)O1)(C(C(O)=O)O)O)=O,,,5,1,3,0,3
54129_0,,,,2,2,1,3
C1(C(CC(O)O1)(C(C=O)(O)O)O)=O,,,5,1,2,0,2
54131_0,,,,2,2,1,3
C1(C(CC(O)O1)(C(C=O)(C)O)O)=O,,,5,1,3,0,3
54133_0,,,,2,2,1,3
C1(C([C](C(O)=O)O)(CC(O)O1)O)=O,,,5,1,2,0,2
54135_0,,,,2,2,1,3
C1(C(C(C=C)O)(O)OCC(C1)O)=O,,,5,1,1,0,1
54137_0,,,,2,2,1,3
C(C(C1(C(CC(CO1)O)=O)O)O)=O,,,5,1,1,0,1
54139_0,,,,2,2,1,3
C1(C(C(C)O)(O)OCC(C1)O)=O,,,5,1,1,0,1
54141_0,,,,2,2,1,3
C(C1(C(CC(CO1)O)=O)O)(O)=O,,,5,1,3,0,3
54143_0,,,,2,2,1,3
C1(C(CO)(O)OCC(C1)O)=O,,,5,1,3,0,3
54145_0,,,,2,2,1,3
C1(C(C(CO)O)(O)OCC(C1)O)=O,,,5,1,1,0,1
54147_0,,,,2,2,1,3
C1(C(CO)(O)OC(C(C1)O)CO)=O,,,5,1,2,0,2
54149_0,,,,2,2,1,3
C(C1C(C(CO)(O)OCC1O)=O)=O,,,5,1,1,0,1
54151_0,,,,2,2,1,3
C1(C(CO)(O)OCC(C(C1)O)O)=O,,,5,1,2,0,2
54152_0,,,,2,2,1,3
54153_0,,,,2,2,1,3
54154_0,,,,2,2,1,3
54156_0,,,,2,2,1,3
C1(C(CCO1)(C(C=O)(O)O)O)=O,,,5,1,2,0,2
54157_0,,,,2,2,1,3
54159_0,,,,2,2,1,3
C1(C([C](C(O)=O)O)(CCO1)O)=O,,,5,1,2,0,2
54161_0,,,,2,2,1,3
C(C(C=C)(C1(COC(C1)=O)O)O)=O,,,5,1,1,0,1
54163_0,,,,2,2,1,3
C1(CC(CO1)(C(C(O)=O)O)O)=O,,,5,1,2,0,2
54165_0,,,,2,2,1,3
C(C(C)(C1(COC(C1)=O)O)O)(O)=O,,,5,1,1,0,1
54167_0,,,,2,2,1,3
C1(CC(CO1)(C(C=O)(O)O)O)=O,,,5,1,2,0,2
54169_0,,,,2,2,1,3
C(C(C)(C1(COC(C1)=O)O)O)=O,,,5,1,2,0,2
54171_0,,,,2,2,1,3
C1(CC([C](C(O)=O)O)(CO1)O)=O,,,5,1,2,0,2
54173_0,,,,2,2,1,3
C1(C(CC(CO1)=O)(C(C=C)O)O)=O,,,5,1,1,0,1
54175_0,,,,2,2,1,3
C1(C(CC(CO1)=O)(C(C=O)O)O)=O,,,5,1,1,0,1
54177_0,,,,2,2,1,3
C1(C(C(C)O)(CC(CO1)=O)O)=O,,,5,1,3,0,3
54179_0,,,,2,2,1,3
C1(C(C(O)=O)(CC(CO1)=O)O)=O,,,5,1,3,0,3
54181_0,,,,2,2,1,3
C1(C(CO)(CC(CO1)=O)O)=O,,,5,1,3,0,3
54183_0,,,,2,2,1,3
C1(C(C(CO)O)(CC(CO1)=O)O)=O,,,5,1,1,0,1
54185_0,,,,2,2,1,3
C1(C(CO)(CC(C(CO)O1)=O)O)=O,,,5,1,1,0,1
54187_0,,,,2,2,1,3
C1(C(CO)(CC(C(CO1)O)=O)O)=O,,,5,1,1,0,1
54189_0,,,,2,2,1,3
C(CC(C(C(O)=O)=O)(C(C)O)O)=O,,,5,1,1,0,1
54190_0,,,,2,2,1,3
54191_0,,,,2,2,1,3
54193_0,,,,2,2,1,3
C(C(CC(C)=O)(C(C=C)O)O)(O)=O,,,5,1,1,0,1
54194_0,,,,2,2,1,3
54196_0,,,,2,2,1,3
C(C(C(C)O)(CC(C)=O)O)(O)=O,,,5,1,3,0,3
54198_0,,,,2,2,1,3
C(C(C(O)=O)(CC(C)=O)O)(O)=O,,,5,1,2,0,2
54199_0,,,,2,2,1,3
54200_0,,,,2,2,1,3
54202_0,,,,2,2,1,3
C(C(CCC=O)(C(C=C)O)O)(O)=O,,,5,1,1,0,1
54203_0,,,,2,2,1,3
54205_0,,,,2,2,1,3
C(C(CCC=O)(C(C)O)O)(O)=O,,,5,1,3,0,3
54207_0,,,,2,2,1,3
C(C(C(O)=O)(CCC=O)O)(O)=O,,,5,1,3,0,3
54208_0,,,,2,2,1,3
54209_0,,,,2,2,1,3
54210_0,,,,2,2,1,3
54211_0,,,,2,2,1,3
54213_0,,,,2,2,1,3
C(C(C(C=C(CO)CO)O)O)(O)=O,,,5,1,1,0,1
54215_0,,,,2,2,1,3
C(C(C(C=C(CO)CO)O)(O)O)=O,,,5,1,1,0,1
54217_0,,,,2,2,1,3
C(C(C)(C(C=C(CO)CO)O)O)=O,,,5,1,1,0,1
54219_0,,,,2,2,1,3
C(C([C](C(O)=O)O)O)=C(CO)CO,,,5,1,1,0,1
54221_0,,,,2,2,1,3
C(CO)(C(C(C=O)=C)(C(C)O)O)=O,,,5,1,1,0,1
54223_0,,,,2,2,1,3
C(C(C(CO)=O)(C(C=O)=C)O)(O)=O,,,5,1,1,0,1
54224_0,,,,2,2,1,3
54226_0,,,,2,2,1,3
C(CO)(C(C=CC=O)(C(C)O)O)=O,,,5,1,1,0,1
54228_0,,,,2,2,1,3
C(C(C(CO)=O)(C=CC=O)O)(O)=O,,,5,1,1,0,1
54229_0,,,,2,2,1,3
54231_0,,,,2,2,1,3
C(CO)(C(C=C)(C(C=CC)O)O)=O,,,5,1,1,0,1
54233_0,,,,2,2,1,3
C(CO)(C(C=C)(C(CC=C)O)O)=O,,,5,1,1,0,1
54235_0,,,,2,2,1,3
C(CO)(C(C=C)(C(C=C)O)O)=O,,,5,1,1,0,1
54237_0,,,,2,2,1,3
C(C(C(C(CO)=O)(C=C)O)O)=O,,,5,1,2,0,2
54239_0,,,,2,2,1,3
C(C(C(C(CO)=O)(C=C)O)O)(O)=O,,,5,1,1,0,1
54241_0,,,,2,2,1,3
C(C(C)(C(C(CO)=O)(C=C)O)O)=O,,,5,1,1,0,1
54243_0,,,,2,2,1,3
C(CO)(C(C=C)(C(C(C)=O)O)O)=O,,,5,1,1,0,1
54245_0,,,,2,2,1,3
C(CC(C(C(CO)=O)(C=C)O)O)=O,,,5,1,1,0,1
54247_0,,,,2,2,1,3
C(CO)(C(C=C)(C(C)O)O)=O,,,5,1,2,0,2
54249_0,,,,2,2,1,3
C(CO)(C(C=C)(C(CCO)O)O)=O,,,5,1,1,0,1
54251_0,,,,2,2,1,3
C(CO)(C(C=C)(C(CO)(C)O)O)=O,,,5,1,1,0,1
54252_0,,,,2,2,1,3
54254_0,,,,2,2,1,3
C(CO)(C(C=C)(C(C(O)O)O)O)=O,,,5,1,1,0,1
54256_0,,,,2,2,1,3
C(CO)(C(C=C)(C(C(C)O)O)O)=O,,,5,1,1,0,1
54257_0,,,,2,2,1,3
54259_0,,,,2,2,1,3
C(CO)(C(C=C)(C(CO)O)O)=O,,,5,1,2,0,2
54261_0,,,,2,2,1,3
C(C(C(CO)(C(C=C)O)O)O)(O)=O,,,5,1,1,0,1
54263_0,,,,2,2,1,3
C(C(C(CO)(C(C=C)O)O)(O)O)=O,,,5,1,1,0,1
54265_0,,,,2,2,1,3
C(C(C)(C(CO)(C(C=C)O)O)O)=O,,,5,1,1,0,1
54267_0,,,,2,2,1,3
C=CC(C([C](C(O)=O)O)(CO)O)O,,,5,1,1,0,1
54269_0,,,,2,2,1,3
C(C(CO)O)(C(C=C)(C(C)O)O)=O,,,5,1,1,0,1
54270_0,,,,2,2,1,3
54271_0,,,,2,2,1,3
54272_0,,,,2,2,1,3
54273_0,,,,2,2,1,3
54274_0,,,,2,2,1,3
54276_0,,,,2,2,1,3
C(C(C(C=O)=C(C=O)C)(CO)O)=O,,,5,1,1,0,1
54277_0,,,,2,2,1,3
54279_0,,,,2,2,1,3
C(CC=O)(C(C(C=O)=C)(CO)O)=O,,,5,1,1,0,1
54281_0,,,,2,2,1,3
C(C(C=C)(C(C=C(C=O)C)O)O)=O,,,5,1,1,0,1
54283_0,,,,2,2,1,3
C(C(C(C=C(C=O)C)O)O)(O)=O,,,5,1,2,0,2
54285_0,,,,2,2,1,3
C(C(C)(C(C=C(C=O)C)O)O)(O)=O,,,5,1,1,0,1
54287_0,,,,2,2,1,3
C(C(C(C=C(C=O)C)O)(O)O)=O,,,5,1,2,0,2
54289_0,,,,2,2,1,3
C(C(C)(C(C=C(C=O)C)O)O)=O,,,5,1,2,0,2
54291_0,,,,2,2,1,3
C(C([C](C(O)=O)O)O)=C(C=O)C,,,5,1,2,0,2
54293_0,,,,2,2,1,3
C(C(C=C)(C(C(C)=CC=O)O)O)=O,,,5,1,1,0,1
54295_0,,,,2,2,1,3
C(C(C(C(C)=CC=O)O)O)(O)=O,,,5,1,2,0,2
54297_0,,,,2,2,1,3
C(C(C)(C(C(C)=CC=O)O)O)(O)=O,,,5,1,1,0,1
54299_0,,,,2,2,1,3
C(C(C(C(C)=CC=O)O)(O)O)=O,,,5,1,2,0,2
54301_0,,,,2,2,1,3
C(C(C)(C(C(C)=CC=O)O)O)=O,,,5,1,2,0,2
54303_0,,,,2,2,1,3
C(C)(C([C](C(O)=O)O)O)=CC=O,,,5,1,2,0,2
54305_0,,,,2,2,1,3
C(C(C=C)(C(CC(C=O)=C)O)O)=O,,,5,1,1,0,1
54307_0,,,,2,2,1,3
C(C(C(CC(C=O)=C)O)O)(O)=O,,,5,1,2,0,2
54309_0,,,,2,2,1,3
C(C(C)(C(CC(C=O)=C)O)O)(O)=O,,,5,1,1,0,1
54311_0,,,,2,2,1,3
C(C(C(CC(C=O)=C)O)(O)O)=O,,,5,1,2,0,2
54313_0,,,,2,2,1,3
C(C(C)(C(CC(C=O)=C)O)O)=O,,,5,1,2,0,2
54315_0,,,,2,2,1,3
C=C(C=O)CC([C](C(O)=O)O)O,,,5,1,2,0,2
54317_0,,,,2,2,1,3
C(C(C=C)(C(C(CC=O)=C)O)O)=O,,,5,1,1,0,1
54319_0,,,,2,2,1,3
C(CC(C(C(C(O)=O)O)O)=C)=O,,,5,1,2,0,2
54321_0,,,,2,2,1,3
C(C(C)(C(C(CC=O)=C)O)O)(O)=O,,,5,1,1,0,1
54323_0,,,,2,2,1,3
C(CC(C(C(C=O)(O)O)O)=C)=O,,,5,1,2,0,2
54325_0,,,,2,2,1,3
C(C(C)(C(C(CC=O)=C)O)O)=O,,,5,1,2,0,2
54327_0,,,,2,2,1,3
C(CC(C([C](C(O)=O)O)O)=C)=O,,,5,1,2,0,2
54329_0,,,,2,2,1,3
C=CC(C(C(C=O)=O)(C(C=O)=C)O)O,,,5,1,1,0,1
54331_0,,,,2,2,1,3
C=C(C=O)C(C(C=O)=O)(C(C)O)O,,,5,1,1,0,1
54333_0,,,,2,2,1,3
C(C(C(C=O)=O)(C(C=O)=C)O)(O)=O,,,5,1,1,0,1
54334_0,,,,2,2,1,3
54336_0,,,,2,2,1,3
C(C(C(C=O)=C)(C(C(C=O)=C)O)O)=O,,,5,1,1,0,1
54338_0,,,,2,2,1,3
C(C(C(C=O)=C)(C(C=CC)O)O)=O,,,5,1,1,0,1
54340_0,,,,2,2,1,3
C(C(C(C=O)=C)(C(CC=C)O)O)=O,,,5,1,1,0,1
54342_0,,,,2,2,1,3
C(C(C(C=O)=C)(C(C=C)O)O)=O,,,5,1,1,0,1
54344_0,,,,2,2,1,3
C(C(C(C=O)=C)(C1(C=COC1)O)O)=O,,,5,1,1,0,1
54345_0,,,,2,2,1,3
54346_0,,,,2,2,1,3
54348_0,,,,2,2,1,3
C(C(C(C=O)=C)(C(C=O)(C)O)O)=O,,,5,1,2,0,2
54349_0,,,,2,2,1,3
54351_0,,,,2,2,1,3
C(C(C(C=O)=C)(C(CC=O)O)O)=O,,,5,1,1,0,1
54353_0,,,,2,2,1,3
C(C(C(C=O)=C)(C(C)O)O)=O,,,5,1,3,0,3
54355_0,,,,2,2,1,3
C(C(C(C=O)=C)(C(CCO)O)O)=O,,,5,1,1,0,1
54357_0,,,,2,2,1,3
C(C(C(C=O)=C)(C(CO)(C)O)O)=O,,,5,1,1,0,1
54359_0,,,,2,2,1,3
C(C(C=C)(C(C=O)(C(C=O)=C)O)O)=O,,,5,1,2,0,2
54360_0,,,,2,2,1,3
54362_0,,,,2,2,1,3
C(C(C(C=O)=C)(C(C=CC=O)O)O)=O,,,5,1,1,0,1
54364_0,,,,2,2,1,3
C(C(C=O)(C(C=O)=C)O)(O)=O,,,5,1,3,0,3
54366_0,,,,2,2,1,3
C(C(C(C=O)=C)(C(C(O)O)O)O)=O,,,5,1,1,0,1
54368_0,,,,2,2,1,3
C(C(C(C=O)=C)(C(C(C)O)O)O)=O,,,5,1,1,0,1
54369_0,,,,2,2,1,3
54370_0,,,,2,2,1,3
54372_0,,,,2,2,1,3
C(C(C(C(C(C=O)=C)O)O)O)(O)=O,,,5,1,1,0,1
54374_0,,,,2,2,1,3
C(C(C(C(C(C=O)=C)O)O)(O)O)=O,,,5,1,1,0,1
54376_0,,,,2,2,1,3
C(C(C)(C(C(C(C=O)=C)O)O)O)=O,,,5,1,1,0,1
54378_0,,,,2,2,1,3
C=C(C=O)C(C([C](C(O)=O)O)O)O,,,5,1,1,0,1
54379_0,,,,2,2,1,3
54381_0,,,,2,2,1,3
C(C(C(C(C(C=O)(O)O)O)=C)O)=O,,,5,1,1,0,1
54383_0,,,,2,2,1,3
C(C(C)(C(C(C(C=O)O)=C)O)O)=O,,,5,1,1,0,1
54385_0,,,,2,2,1,3
C(C(C(C([C](C(O)=O)O)O)=C)O)=O,,,5,1,1,0,1
54387_0,,,,2,2,1,3
C(C)(C(C(C(C=O)=O)=C)(CO)O)=O,,,5,1,1,0,1
54389_0,,,,2,2,1,3
C(C)(C(C(C=O)=CC=O)(CO)O)=O,,,5,1,1,0,1
54391_0,,,,2,2,1,3
C(C(C(C=O)=CC(C)=O)(CO)O)=O,,,5,1,1,0,1
54393_0,,,,2,2,1,3
C(C(C=C)(C(C=CC(C)=O)O)O)=O,,,5,1,1,0,1
54395_0,,,,2,2,1,3
C(C(C(C=CC(C)=O)O)O)(O)=O,,,5,1,2,0,2
54397_0,,,,2,2,1,3
C(C(C)(C(C=CC(C)=O)O)O)(O)=O,,,5,1,1,0,1
54399_0,,,,2,2,1,3
C(C(C(C=CC(C)=O)O)(O)O)=O,,,5,1,2,0,2
54401_0,,,,2,2,1,3
C(C(C)(C(C=CC(C)=O)O)O)=O,,,5,1,2,0,2
54403_0,,,,2,2,1,3
C(C([C](C(O)=O)O)O)=CC(C)=O,,,5,1,2,0,2
54405_0,,,,2,2,1,3
C(C(C=C)(C(C=CC=O)(C)O)O)=O,,,5,1,1,0,1
54407_0,,,,2,2,1,3
C(C(C(C=CC=O)(C)O)O)(O)=O,,,5,1,2,0,2
54409_0,,,,2,2,1,3
C(C(C)(C(C=CC=O)(C)O)O)(O)=O,,,5,1,1,0,1
54411_0,,,,2,2,1,3
C(C(C(C=CC=O)(C)O)(O)O)=O,,,5,1,2,0,2
54413_0,,,,2,2,1,3
C(C(C)(C(C=CC=O)(C)O)O)=O,,,5,1,2,0,2
54415_0,,,,2,2,1,3
C(C([C](C(O)=O)O)(C)O)=CC=O,,,5,1,2,0,2
54417_0,,,,2,2,1,3
C(C(C=CCC(C=O)=O)(CO)O)=O,,,5,1,1,0,1
54419_0,,,,2,2,1,3
C(C(CO)(CC=CC(C=O)=O)O)=O,,,5,1,1,0,1
54421_0,,,,2,2,1,3
C(C)(C(C=CC(C=O)=O)(CO)O)=O,,,5,1,1,0,1
54423_0,,,,2,2,1,3
C(C(C(CC(C=O)=O)=C)(CO)O)=O,,,5,1,1,0,1
54425_0,,,,2,2,1,3
C(C(C(C)=CC(C=O)=O)(CO)O)=O,,,5,1,1,0,1
54427_0,,,,2,2,1,3
C(C(C=C)(C(C=O)(CC=C)O)O)=O,,,5,1,1,0,1
54429_0,,,,2,2,1,3
C(C(C(C=O)(CC=C)O)O)(O)=O,,,5,1,2,0,2
54431_0,,,,2,2,1,3
C(C(C)(C(C=O)(CC=C)O)O)(O)=O,,,5,1,1,0,1
54433_0,,,,2,2,1,3
C(C(C(C=O)(CC=C)O)(O)O)=O,,,5,1,2,0,2
54435_0,,,,2,2,1,3
C(C(C)(C(C=O)(CC=C)O)O)=O,,,5,1,2,0,2
54437_0,,,,2,2,1,3
C(C([C](C(O)=O)O)(CC=C)O)=O,,,5,1,2,0,2
54439_0,,,,2,2,1,3
C(C(C=C)(C(C(CC=C)=O)O)O)=O,,,5,1,1,0,1
54441_0,,,,2,2,1,3
C(C(C(C(CC=C)=O)O)O)(O)=O,,,5,1,2,0,2
54443_0,,,,2,2,1,3
C(C(C)(C(C(CC=C)=O)O)O)(O)=O,,,5,1,1,0,1
54445_0,,,,2,2,1,3
C(C(C(C(CC=C)=O)O)(O)O)=O,,,5,1,2,0,2
54447_0,,,,2,2,1,3
C(C(C)(C(C(CC=C)=O)O)O)=O,,,5,1,2,0,2
54449_0,,,,2,2,1,3
C(CC=C)(C([C](C(O)=O)O)O)=O,,,5,1,2,0,2
54451_0,,,,2,2,1,3
C(C(C=C)(C(C=O)(C=CC)O)O)=O,,,5,1,1,0,1
54453_0,,,,2,2,1,3
C(C(C=CC)(C(C(O)=O)O)O)=O,,,5,1,2,0,2
54455_0,,,,2,2,1,3
C(C(C)(C(C=O)(C=CC)O)O)(O)=O,,,5,1,1,0,1
54457_0,,,,2,2,1,3
C(C(C=CC)(C(C=O)(O)O)O)=O,,,5,1,2,0,2
54459_0,,,,2,2,1,3
C(C(C)(C(C=O)(C=CC)O)O)=O,,,5,1,2,0,2
54461_0,,,,2,2,1,3
C(C(C=CC)([C](C(O)=O)O)O)=O,,,5,1,2,0,2
54463_0,,,,2,2,1,3
C(C(C=C)(C(C(C=CC)=O)O)O)=O,,,5,1,1,0,1
54465_0,,,,2,2,1,3
C(C(C(C(C=CC)=O)O)O)(O)=O,,,5,1,2,0,2
54467_0,,,,2,2,1,3
C(C(C)(C(C(C=CC)=O)O)O)(O)=O,,,5,1,1,0,1
54469_0,,,,2,2,1,3
C(C(C(C(C=CC)=O)O)(O)O)=O,,,5,1,2,0,2
54471_0,,,,2,2,1,3
C(C(C)(C(C(C=CC)=O)O)O)=O,,,5,1,2,0,2
54473_0,,,,2,2,1,3
C(C)=CC(C([C](C(O)=O)O)O)=O,,,5,1,2,0,2
54475_0,,,,2,2,1,3
C(C(C=C)(C(C=CC(C=O)=O)O)O)=O,,,5,1,1,0,1
54476_0,,,,2,2,1,3
54478_0,,,,2,2,1,3
C(C(C(C=CC(C=O)=O)O)(O)O)=O,,,5,1,1,0,1
54480_0,,,,2,2,1,3
C(C(C)(C(C=CC(C=O)=O)O)O)=O,,,5,1,1,0,1
54482_0,,,,2,2,1,3
C(C([C](C(O)=O)O)O)=CC(C=O)=O,,,5,1,1,0,1
54484_0,,,,2,2,1,3
C(C(C=C)(C(C=O)(C=CC=O)O)O)=O,,,5,1,2,0,2
54485_0,,,,2,2,1,3
54487_0,,,,2,2,1,3
C(C(C=CC=O)(C(C=O)(O)O)O)=O,,,5,1,1,0,1
54489_0,,,,2,2,1,3
C(C(C=CC=O)(C(C=O)(C)O)O)=O,,,5,1,2,0,2
54491_0,,,,2,2,1,3
C(C(C=CC=O)([C](C(O)=O)O)O)=O,,,5,1,1,0,1
54492_0,,,,2,2,1,3
54493_0,,,,2,2,1,3
54495_0,,,,2,2,1,3
C(C(C(C(C=CC=O)=O)O)(O)O)=O,,,5,1,1,0,1
54496_0,,,,2,2,1,3
54498_0,,,,2,2,1,3
C([C](C(C(C=CC=O)=O)O)O)(O)=O,,,5,1,1,0,1
54500_0,,,,2,2,1,3
C(C(C=CCO)(C(C(O)=O)O)O)=O,,,5,1,1,0,1
54502_0,,,,2,2,1,3
C(C(C=CCO)(C(C=O)(O)O)O)=O,,,5,1,1,0,1
54504_0,,,,2,2,1,3
C(C(C)(C(C=O)(C=CCO)O)O)=O,,,5,1,1,0,1
54506_0,,,,2,2,1,3
C(C(C=CCO)([C](C(O)=O)O)O)=O,,,5,1,1,0,1
54508_0,,,,2,2,1,3
C(C(C(C(C=CCO)=O)O)O)(O)=O,,,5,1,1,0,1
54510_0,,,,2,2,1,3
C(C(C(C(C=CCO)=O)O)(O)O)=O,,,5,1,1,0,1
54512_0,,,,2,2,1,3
C(C(C)(C(C(C=CCO)=O)O)O)=O,,,5,1,1,0,1
54514_0,,,,2,2,1,3
C(CO)=CC(C([C](C(O)=O)O)O)=O,,,5,1,1,0,1
54516_0,,,,2,2,1,3
C(C(C(C=O)=CCC=O)(CO)O)=O,,,5,1,1,0,1
54517_0,,,,2,2,1,3
54519_0,,,,2,2,1,3
C(CC=O)(C(C=CC=O)(CO)O)=O,,,5,1,1,0,1
54521_0,,,,2,2,1,3
C(C(C=C)(C(C=CCC=O)O)O)=O,,,5,1,1,0,1
54523_0,,,,2,2,1,3
C(CC=CC(C(C(O)=O)O)O)=O,,,5,1,2,0,2
54525_0,,,,2,2,1,3
C(C(C)(C(C=CCC=O)O)O)(O)=O,,,5,1,1,0,1
54527_0,,,,2,2,1,3
C(CC=CC(C(C=O)(O)O)O)=O,,,5,1,2,0,2
54529_0,,,,2,2,1,3
C(C(C)(C(C=CCC=O)O)O)=O,,,5,1,2,0,2
54531_0,,,,2,2,1,3
C(CC=CC([C](C(O)=O)O)O)=O,,,5,1,2,0,2
54533_0,,,,2,2,1,3
C(C(C=C)(C(CC=CC=O)O)O)=O,,,5,1,1,0,1
54535_0,,,,2,2,1,3
C(C(C(CC=CC=O)O)O)(O)=O,,,5,1,2,0,2
54537_0,,,,2,2,1,3
C(C(C)(C(CC=CC=O)O)O)(O)=O,,,5,1,1,0,1
54539_0,,,,2,2,1,3
C(C(C(CC=CC=O)O)(O)O)=O,,,5,1,2,0,2
54541_0,,,,2,2,1,3
C(C(C)(C(CC=CC=O)O)O)=O,,,5,1,2,0,2
54543_0,,,,2,2,1,3
C(CC([C](C(O)=O)O)O)=CC=O,,,5,1,2,0,2
54545_0,,,,2,2,1,3
C=CC(C(C=CC=O)(C(C=O)=O)O)O,,,5,1,1,0,1
54547_0,,,,2,2,1,3
C(C(C(C=O)=O)(C(C)O)O)=CC=O,,,5,1,1,0,1
54549_0,,,,2,2,1,3
C(C(C=CC=O)(C(C=O)=O)O)(O)=O,,,5,1,1,0,1
54550_0,,,,2,2,1,3
54552_0,,,,2,2,1,3
C(C(C=CC=O)(C(C(C=O)=C)O)O)=O,,,5,1,1,0,1
54554_0,,,,2,2,1,3
C(C(C=CC=O)(C(C=CC)O)O)=O,,,5,1,1,0,1
54556_0,,,,2,2,1,3
C(C(C=CC=O)(C(CC=C)O)O)=O,,,5,1,1,0,1
54558_0,,,,2,2,1,3
C(C(C=CC=O)(C(C=C)O)O)=O,,,5,1,1,0,1
54560_0,,,,2,2,1,3
C(C(C=CC=O)(C1(C=COC1)O)O)=O,,,5,1,1,0,1
54561_0,,,,2,2,1,3
54562_0,,,,2,2,1,3
54563_0,,,,2,2,1,3
54564_0,,,,2,2,1,3
54566_0,,,,2,2,1,3
C(C(C=CC=O)(C(CC=O)O)O)=O,,,5,1,1,0,1
54568_0,,,,2,2,1,3
C(C(C=CC=O)(C(C)O)O)=O,,,5,1,2,0,2
54570_0,,,,2,2,1,3
C(C(C=CC=O)(C(CCO)O)O)=O,,,5,1,1,0,1
54572_0,,,,2,2,1,3
C(C(C=CC=O)(C(CO)(C)O)O)=O,,,5,1,1,0,1
54573_0,,,,2,2,1,3
54574_0,,,,2,2,1,3
54576_0,,,,2,2,1,3
C(C(C=CC=O)(C(C=CC=O)O)O)=O,,,5,1,1,0,1
54578_0,,,,2,2,1,3
C(C(C=O)(C=CC=O)O)(O)=O,,,5,1,2,0,2
54580_0,,,,2,2,1,3
C(C(C=CC=O)(C(C(O)O)O)O)=O,,,5,1,1,0,1
54582_0,,,,2,2,1,3
C(C(C=CC=O)(C(C(C)O)O)O)=O,,,5,1,1,0,1
54583_0,,,,2,2,1,3
54584_0,,,,2,2,1,3
54585_0,,,,2,2,1,3
54587_0,,,,2,2,1,3
C(C(C(C(C=CC=O)O)O)(O)O)=O,,,5,1,1,0,1
54589_0,,,,2,2,1,3
C(C(C)(C(C(C=CC=O)O)O)O)=O,,,5,1,1,0,1
54591_0,,,,2,2,1,3
C(C(C([C](C(O)=O)O)O)O)=CC=O,,,5,1,2,0,2
54592_0,,,,2,2,1,3
54594_0,,,,2,2,1,3
C(C(C=CC(C(C=O)(O)O)O)O)=O,,,5,1,1,0,1
54596_0,,,,2,2,1,3
C(C(C)(C(C=CC(C=O)O)O)O)=O,,,5,1,1,0,1
54598_0,,,,2,2,1,3
C(C(C=CC([C](C(O)=O)O)O)O)=O,,,5,1,1,0,1
54600_0,,,,2,2,1,3
C(C(C=O)C=CC(C=O)(CO)O)=O,,,5,1,1,0,1
54602_0,,,,2,2,1,3
C(C(CO)(CC=C(C=O)C=O)O)=O,,,5,1,1,0,1
54604_0,,,,2,2,1,3
C(C)(C(C=C(C=O)C=O)(CO)O)=O,,,5,1,1,0,1
54606_0,,,,2,2,1,3
C(C(C=O)C(C(C=O)(CO)O)=C)=O,,,5,1,1,0,1
54608_0,,,,2,2,1,3
C(C(C(C)=C(C=O)C=O)(CO)O)=O,,,5,1,1,0,1
54610_0,,,,2,2,1,3
C(C(C=C)C(C(C=O)(C=C)O)O)=O,,,5,1,1,0,1
54611_0,,,,2,2,1,3
54612_0,,,,2,2,1,3
54614_0,,,,2,2,1,3
C(C(C=C)C(C(C=O)(O)O)O)=O,,,5,1,2,0,2
54615_0,,,,2,2,1,3
54617_0,,,,2,2,1,3
C(C(C=C)C([C](C(O)=O)O)O)=O,,,5,1,2,0,2
54619_0,,,,2,2,1,3
C(C(C=C)(C(C(C=O)=CC)O)O)=O,,,5,1,1,0,1
54621_0,,,,2,2,1,3
C(C(C(C(C=O)=CC)O)O)(O)=O,,,5,1,2,0,2
54623_0,,,,2,2,1,3
C(C(C)(C(C(C=O)=CC)O)O)(O)=O,,,5,1,1,0,1
54625_0,,,,2,2,1,3
C(C(C(C(C=O)=CC)O)(O)O)=O,,,5,1,2,0,2
54627_0,,,,2,2,1,3
C(C(C)(C(C(C=O)=CC)O)O)=O,,,5,1,2,0,2
54629_0,,,,2,2,1,3
C(C)=C(C=O)C([C](C(O)=O)O)O,,,5,1,2,0,2
54631_0,,,,2,2,1,3
C(C(C=C)(C(C=C(C=O)C=O)O)O)=O,,,5,1,1,0,1
54632_0,,,,2,2,1,3
54634_0,,,,2,2,1,3
C(C(C(C=C(C=O)C=O)O)(O)O)=O,,,5,1,1,0,1
54636_0,,,,2,2,1,3
C(C(C)(C(C=C(C=O)C=O)O)O)=O,,,5,1,1,0,1
54638_0,,,,2,2,1,3
C(C([C](C(O)=O)O)O)=C(C=O)C=O,,,5,1,1,0,1
54640_0,,,,2,2,1,3
C(C(C=C)(C(C(C=O)=CC=O)O)O)=O,,,5,1,1,0,1
54642_0,,,,2,2,1,3
C(C(C(C(C=O)=CC=O)O)O)(O)=O,,,5,1,1,0,1
54644_0,,,,2,2,1,3
C(C(C(C(C=O)=CC=O)O)(O)O)=O,,,5,1,1,0,1
54646_0,,,,2,2,1,3
C(C(C)(C(C(C=O)=CC=O)O)O)=O,,,5,1,1,0,1
54648_0,,,,2,2,1,3
C([C](C(C(C=O)=CC=O)O)O)(O)=O,,,5,1,1,0,1
54650_0,,,,2,2,1,3
C=CC(C(C=O)=O)(C(C(C=O)=C)O)O,,,5,1,1,0,1
54652_0,,,,2,2,1,3
C(C(C=C)(C(C(C=O)=C)O)O)=O,,,5,1,1,0,1
54654_0,,,,2,2,1,3
C(C(CC)(C(C(C=O)=C)O)O)(O)=O,,,5,1,1,0,1
54655_0,,,,2,2,1,3
54656_0,,,,2,2,1,3
54658_0,,,,2,2,1,3
C(C(C)(C(C(C=O)=C)O)O)(O)=O,,,5,1,2,0,2
54660_0,,,,2,2,1,3
C=C(C=O)C(C(C(C=O)=O)(C)O)O,,,5,1,1,0,1
54662_0,,,,2,2,1,3
C(C(CCO)(C(C(C=O)=C)O)O)=O,,,5,1,1,0,1
54664_0,,,,2,2,1,3
C1(C(C(C(C=O)=C)O)(O)OCC1)=O,,,5,1,1,0,1
54666_0,,,,2,2,1,3
C(C(C=C)(C(C(C=O)=C)O)O)(O)=O,,,5,1,1,0,1
54668_0,,,,2,2,1,3
C1(C(CCO1)(C(C(C=O)=C)O)O)=O,,,5,1,1,0,1
54670_0,,,,2,2,1,3
C(C(C(C(C=O)=C)O)(O)O)=O,,,5,1,2,0,2
54672_0,,,,2,2,1,3
C(C(C)(C(C(C=O)=C)O)O)=O,,,5,1,2,0,2
54674_0,,,,2,2,1,3
C=C(C=O)C([C](C(O)=O)O)O,,,5,1,2,0,2
54675_0,,,,2,2,1,3
54677_0,,,,2,2,1,3
C(C(C(C(C=O)=CCO)O)(O)O)=O,,,5,1,1,0,1
54679_0,,,,2,2,1,3
C(C(C)(C(C(C=O)=CCO)O)O)=O,,,5,1,1,0,1
54681_0,,,,2,2,1,3
C(CO)=C(C=O)C([C](C(O)=O)O)O,,,5,1,1,0,1
54683_0,,,,2,2,1,3
C(C(C(C=O)=CCO)(C(C)O)O)=O,,,5,1,1,0,1
54685_0,,,,2,2,1,3
C(C(C=O)(C(C=O)=CCO)O)(O)=O,,,5,1,1,0,1
54686_0,,,,2,2,1,3
54688_0,,,,2,2,1,3
C(C(C(C(C=O)=O)=C)(C(C=C)O)O)=O,,,5,1,1,0,1
54690_0,,,,2,2,1,3
C(C(C(C(C=O)=O)=C)(C(C)O)O)=O,,,5,1,1,0,1
54692_0,,,,2,2,1,3
C(C(C=O)(C(C(C=O)=O)=C)O)(O)=O,,,5,1,1,0,1
54693_0,,,,2,2,1,3
54695_0,,,,2,2,1,3
C(C(C(CO)=C)(C(C(O)=O)O)O)=O,,,5,1,1,0,1
54697_0,,,,2,2,1,3
C(C(C(CO)=C)(C(C=O)(O)O)O)=O,,,5,1,1,0,1
54699_0,,,,2,2,1,3
C(C(C)(C(C=O)(C(CO)=C)O)O)=O,,,5,1,1,0,1
54701_0,,,,2,2,1,3
C(C(C(CO)=C)([C](C(O)=O)O)O)=O,,,5,1,1,0,1
54703_0,,,,2,2,1,3
C(C(C(C(C(CO)=C)=O)O)O)(O)=O,,,5,1,1,0,1
54705_0,,,,2,2,1,3
C(C(C(C(C(CO)=C)=O)O)(O)O)=O,,,5,1,1,0,1
54707_0,,,,2,2,1,3
C(C(C)(C(C(C(CO)=C)=O)O)O)=O,,,5,1,1,0,1
54709_0,,,,2,2,1,3
C=C(C(C([C](C(O)=O)O)O)=O)CO,,,5,1,1,0,1
54711_0,,,,2,2,1,3
C(C(CC=CC=O)(C(C=CC)O)O)=O,,,5,1,1,0,1
54713_0,,,,2,2,1,3
C(C(C(CC=C)O)(CC=CC=O)O)=O,,,5,1,1,0,1
54715_0,,,,2,2,1,3
C(C(CC=CC=O)(C(C=C)O)O)=O,,,5,1,1,0,1
54716_0,,,,2,2,1,3
54718_0,,,,2,2,1,3
C(C(C(C)O)(CC=CC=O)O)=O,,,5,1,2,0,2
54720_0,,,,2,2,1,3
C(C(C=O)(CC=CC=O)O)(O)=O,,,5,1,2,0,2
54722_0,,,,2,2,1,3
C(C(CO)(CC=CC=O)O)=O,,,5,1,2,0,2
54724_0,,,,2,2,1,3
C(C(C(CO)O)(CC=CC=O)O)=O,,,5,1,1,0,1
54726_0,,,,2,2,1,3
C(C(C=CCC=O)(C(C=CC)O)O)=O,,,5,1,1,0,1
54728_0,,,,2,2,1,3
C(C(C=CCC=O)(C(CC=C)O)O)=O,,,5,1,1,0,1
54730_0,,,,2,2,1,3
C(C(C=CCC=O)(C(C=C)O)O)=O,,,5,1,1,0,1
54731_0,,,,2,2,1,3
54733_0,,,,2,2,1,3
C(C(C=CCC=O)(C(C)O)O)=O,,,5,1,2,0,2
54735_0,,,,2,2,1,3
C(C(C=O)(C=CCC=O)O)(O)=O,,,5,1,2,0,2
54737_0,,,,2,2,1,3
C(C(C=CCC=O)(CO)O)=O,,,5,1,2,0,2
54739_0,,,,2,2,1,3
C(C(C=CCC=O)(C(CO)O)O)=O,,,5,1,1,0,1
54741_0,,,,2,2,1,3
C(C(C=CC(C=O)O)(C(C)O)O)=O,,,5,1,1,0,1
54743_0,,,,2,2,1,3
C(C(C=O)(C=CC(C=O)O)O)(O)=O,,,5,1,1,0,1
54744_0,,,,2,2,1,3
54746_0,,,,2,2,1,3
C(C(C=C)C(C=O)(C(C=CC)O)O)=O,,,5,1,1,0,1
54748_0,,,,2,2,1,3
C(C(C=C)C(C=O)(C(CC=C)O)O)=O,,,5,1,1,0,1
54749_0,,,,2,2,1,3
54750_0,,,,2,2,1,3
54751_0,,,,2,2,1,3
54753_0,,,,2,2,1,3
C(C(C=O)(C(C=O)C=C)O)(O)=O,,,5,1,2,0,2
54754_0,,,,2,2,1,3
54755_0,,,,2,2,1,3
54757_0,,,,2,2,1,3
C(C(C(C=O)=CC)(C(C=CC)O)O)=O,,,5,1,1,0,1
54759_0,,,,2,2,1,3
C(C(C(C=O)=CC)(C(CC=C)O)O)=O,,,5,1,1,0,1
54761_0,,,,2,2,1,3
C(C(C(C=O)=CC)(C(C=C)O)O)=O,,,5,1,1,0,1
54763_0,,,,2,2,1,3
C(C(C(C=O)=CC)(C(C=O)O)O)=O,,,5,1,1,0,1
54765_0,,,,2,2,1,3
C(C(C(C=O)=CC)(C(C)O)O)=O,,,5,1,2,0,2
54767_0,,,,2,2,1,3
C(C(C=O)(C(C=O)=CC)O)(O)=O,,,5,1,2,0,2
54769_0,,,,2,2,1,3
C(C(C(C=O)=CC)(CO)O)=O,,,5,1,2,0,2
54771_0,,,,2,2,1,3
C(C(C(C=O)=CC)(C(CO)O)O)=O,,,5,1,1,0,1
54773_0,,,,2,2,1,3
C(C(C(C=O)=CC=O)(C(C=C)O)O)=O,,,5,1,1,0,1
54775_0,,,,2,2,1,3
C(C(C(C=O)=CC=O)(C(C)O)O)=O,,,5,1,1,0,1
54777_0,,,,2,2,1,3
C(C(C=O)(C(C=O)=CC=O)O)(O)=O,,,5,1,1,0,1
54778_0,,,,2,2,1,3
54780_0,,,,2,2,1,3
C(C(C(C=C(C=O)CO)O)O)(O)=O,,,5,1,1,0,1
54782_0,,,,2,2,1,3
C(C(C(C=C(C=O)CO)O)(O)O)=O,,,5,1,1,0,1
54784_0,,,,2,2,1,3
C(C(C)(C(C=C(C=O)CO)O)O)=O,,,5,1,1,0,1
54786_0,,,,2,2,1,3
C(C([C](C(O)=O)O)O)=C(C=O)CO,,,5,1,1,0,1
54787_0,,,,2,2,1,3
54789_0,,,,2,2,1,3
C(C(C(C(CO)=CC=O)O)(O)O)=O,,,5,1,1,0,1
54791_0,,,,2,2,1,3
C(C(C)(C(C(CO)=CC=O)O)O)=O,,,5,1,1,0,1
54793_0,,,,2,2,1,3
C(CO)(C([C](C(O)=O)O)O)=CC=O,,,5,1,1,0,1
54795_0,,,,2,2,1,3
C(C(C=CC(CO)=O)(C(C)O)O)=O,,,5,1,1,0,1
54797_0,,,,2,2,1,3
C(C(C=O)(C=CC(CO)=O)O)(O)=O,,,5,1,1,0,1
54798_0,,,,2,2,1,3
54800_0,,,,2,2,1,3
C(C(C(CO)=CC=O)(C(C)O)O)=O,,,5,1,1,0,1
54802_0,,,,2,2,1,3
C(C(C=O)(C(CO)=CC=O)O)(O)=O,,,5,1,1,0,1
54803_0,,,,2,2,1,3
54805_0,,,,2,2,1,3
C(C(C(C(C(CO)=O)=C)O)O)(O)=O,,,5,1,1,0,1
54807_0,,,,2,2,1,3
C(C(C(C(C(CO)=O)=C)O)(O)O)=O,,,5,1,1,0,1
54809_0,,,,2,2,1,3
C(C(C)(C(C(C(CO)=O)=C)O)O)=O,,,5,1,1,0,1
54811_0,,,,2,2,1,3
C=C(C(CO)=O)C([C](C(O)=O)O)O,,,5,1,1,0,1
54812_0,,,,2,2,1,3
54814_0,,,,2,2,1,3
C(C(C(C(C=O)=C)(CO)O)(O)O)=O,,,5,1,1,0,1
54816_0,,,,2,2,1,3
C(C(C)(C(C(C=O)=C)(CO)O)O)=O,,,5,1,1,0,1
54818_0,,,,2,2,1,3
C=C(C=O)C([C](C(O)=O)O)(CO)O,,,5,1,1,0,1
54820_0,,,,2,2,1,3
C(CC(C(C=C)(C(C=CC)O)O)=O)=O,,,5,1,1,0,1
54822_0,,,,2,2,1,3
C(CC(C(C=C)(C(CC=C)O)O)=O)=O,,,5,1,1,0,1
54824_0,,,,2,2,1,3
C(CC(C(C=C)(C(C=C)O)O)=O)=O,,,5,1,1,0,1
54826_0,,,,2,2,1,3
C(CC=O)(C(C=C)(C(C=O)O)O)=O,,,5,1,1,0,1
54828_0,,,,2,2,1,3
C(CC=O)(C(C=C)(C(C)O)O)=O,,,5,1,2,0,2
54830_0,,,,2,2,1,3
C(C(C(CC=O)=O)(C=C)O)(O)=O,,,5,1,3,0,3
54832_0,,,,2,2,1,3
C(CC=O)(C(C=C)(CO)O)=O,,,5,1,2,0,2
54834_0,,,,2,2,1,3
C(CC=O)(C(C=C)(C(CO)O)O)=O,,,5,1,1,0,1
54836_0,,,,2,2,1,3
C(C)(C(C=CC=O)(C(C=CC)O)O)=O,,,5,1,1,0,1
54838_0,,,,2,2,1,3
C(C)(C(C=CC=O)(C(CC=C)O)O)=O,,,5,1,1,0,1
54840_0,,,,2,2,1,3
C(C)(C(C=CC=O)(C(C=C)O)O)=O,,,5,1,1,0,1
54842_0,,,,2,2,1,3
C(C(C(C(C)=O)(C=CC=O)O)O)=O,,,5,1,1,0,1
54844_0,,,,2,2,1,3
C(C)(C(C=CC=O)(C(C)O)O)=O,,,5,1,2,0,2
54845_0,,,,2,2,1,3
54846_0,,,,2,2,1,3
54848_0,,,,2,2,1,3
C(C)(C(C=CC=O)(C(CO)O)O)=O,,,5,1,1,0,1
54850_0,,,,2,2,1,3
C(C(C(C)=CC=O)(C(C=CC)O)O)=O,,,5,1,1,0,1
54852_0,,,,2,2,1,3
C(C(C(C)=CC=O)(C(CC=C)O)O)=O,,,5,1,1,0,1
54854_0,,,,2,2,1,3
C(C(C(C)=CC=O)(C(C=C)O)O)=O,,,5,1,1,0,1
54856_0,,,,2,2,1,3
C(C(C(C)=CC=O)(C(C=O)O)O)=O,,,5,1,1,0,1
54858_0,,,,2,2,1,3
C(C(C(C)=CC=O)(C(C)O)O)=O,,,5,1,2,0,2
54860_0,,,,2,2,1,3
C(C(C=O)(C(C)=CC=O)O)(O)=O,,,5,1,2,0,2
54862_0,,,,2,2,1,3
C(C(C(C)=CC=O)(CO)O)=O,,,5,1,2,0,2
54864_0,,,,2,2,1,3
C(C(C(C)=CC=O)(C(CO)O)O)=O,,,5,1,1,0,1
54866_0,,,,2,2,1,3
C(C(C(CC=O)=C)(C(C=CC)O)O)=O,,,5,1,1,0,1
54868_0,,,,2,2,1,3
C(C(C(CC=O)=C)(C(CC=C)O)O)=O,,,5,1,1,0,1
54870_0,,,,2,2,1,3
C(C(C(CC=O)=C)(C(C=C)O)O)=O,,,5,1,1,0,1
54872_0,,,,2,2,1,3
C(C(C(CC=O)=C)(C(C=O)O)O)=O,,,5,1,1,0,1
54874_0,,,,2,2,1,3
C(C(C(CC=O)=C)(C(C)O)O)=O,,,5,1,2,0,2
54876_0,,,,2,2,1,3
C(C(C=O)(C(CC=O)=C)O)(O)=O,,,5,1,2,0,2
54878_0,,,,2,2,1,3
C(C(C(CC=O)=C)(CO)O)=O,,,5,1,2,0,2
54880_0,,,,2,2,1,3
C(C(C(CC=O)=C)(C(CO)O)O)=O,,,5,1,1,0,1
54882_0,,,,2,2,1,3
C(C(C(C(C=O)O)=C)(C(C)O)O)=O,,,5,1,1,0,1
54884_0,,,,2,2,1,3
C(C(C=O)(C(C(C=O)O)=C)O)(O)=O,,,5,1,1,0,1
54885_0,,,,2,2,1,3
54886_0,,,,2,2,1,3
54888_0,,,,2,2,1,3
C(C(C(C(C(C=C)=O)O)O)(O)O)=O,,,5,1,1,0,1
54889_0,,,,2,2,1,3
54891_0,,,,2,2,1,3
C=CC(C(C([C](C(O)=O)O)O)O)=O,,,5,1,2,0,2
54892_0,,,,2,2,1,3
54894_0,,,,2,2,1,3
C(C(C(C=C)(C(C=O)(O)O)O)O)=O,,,5,1,1,0,1
54896_0,,,,2,2,1,3
C(C(C(C=C)(C(C=O)(C)O)O)O)=O,,,5,1,1,0,1
54898_0,,,,2,2,1,3
C(C(C(C=C)([C](C(O)=O)O)O)O)=O,,,5,1,1,0,1
54900_0,,,,2,2,1,3
C=CC(C(C=O)=O)(C(C=CC)O)O,,,5,1,1,0,1
54902_0,,,,2,2,1,3
C(C(C=C)(C(C=CC)O)O)=O,,,5,1,1,0,1
54904_0,,,,2,2,1,3
C1(C(CC(O)O1)(C(C=CC)O)O)=O,,,5,1,1,0,1
54906_0,,,,2,2,1,3
C1(C(C(C=CC)O)(O)OC(C)C1)=O,,,5,1,1,0,1
54908_0,,,,2,2,1,3
C(C(CC)(C(C=CC)O)O)(O)=O,,,5,1,1,0,1
54910_0,,,,2,2,1,3
C(C(CC(C)O)(C(C=CC)O)O)=O,,,5,1,1,0,1
54912_0,,,,2,2,1,3
C(C(C(C=CC)O)O)(O)=O,,,5,1,2,0,2
54914_0,,,,2,2,1,3
C(CC(C=O)(C(C=CC)O)O)=O,,,5,1,2,0,2
54916_0,,,,2,2,1,3
C(C(C)(C(C=CC)O)O)(O)=O,,,5,1,2,0,2
54918_0,,,,2,2,1,3
C(C(CCO)(C(C=CC)O)O)(O)=O,,,5,1,1,0,1
54920_0,,,,2,2,1,3
C(C(CC=O)(C(C=CC)O)O)(O)=O,,,5,1,1,0,1
54922_0,,,,2,2,1,3
C(CC(C(C)=O)(C(C=CC)O)O)=O,,,5,1,1,0,1
54924_0,,,,2,2,1,3
C(C)=CC(C(C(C=O)=O)(C)O)O,,,5,1,2,0,2
54926_0,,,,2,2,1,3
C(C(CCO)(C(C=CC)O)O)=O,,,5,1,2,0,2
54928_0,,,,2,2,1,3
C(CC(C=O)(C(C=CC)O)O)(O)=O,,,5,1,1,0,1
54930_0,,,,2,2,1,3
C1(C(C(C=CC)O)(O)OCC1)=O,,,5,1,2,0,2
54932_0,,,,2,2,1,3
C(C(C=C)(C(C=CC)O)O)(O)=O,,,5,1,2,0,2
54934_0,,,,2,2,1,3
C1(C(C(C=CC)O)(O)OCC1O)=O,,,5,1,1,0,1
54936_0,,,,2,2,1,3
C1(C(CCO1)(C(C=CC)O)O)=O,,,5,1,2,0,2
54938_0,,,,2,2,1,3
C(C(C(C=CC)O)(O)O)=O,,,5,1,2,0,2
54940_0,,,,2,2,1,3
C(C(C)(C(C=CC)O)O)=O,,,5,1,2,0,2
54942_0,,,,2,2,1,3
C(C([C](C(O)=O)O)O)=CC,,,5,1,2,0,2
54944_0,,,,2,2,1,3
C=CC(C(C=O)=O)(C(CC=C)O)O,,,5,1,1,0,1
54946_0,,,,2,2,1,3
C(C(C=C)(C(CC=C)O)O)=O,,,5,1,1,0,1
54948_0,,,,2,2,1,3
C1(C(C(CC=C)O)(CC(O)O1)O)=O,,,5,1,1,0,1
54950_0,,,,2,2,1,3
C1(C(C(CC=C)O)(O)OC(C)C1)=O,,,5,1,1,0,1
54952_0,,,,2,2,1,3
C(C(C(CC=C)O)(CC)O)(O)=O,,,5,1,1,0,1
54954_0,,,,2,2,1,3
C(C(C(CC=C)O)(CC(C)O)O)=O,,,5,1,1,0,1
54956_0,,,,2,2,1,3
C(C(C(CC=C)O)O)(O)=O,,,5,1,2,0,2
54958_0,,,,2,2,1,3
C(C(C(CC=C)O)(CC=O)O)=O,,,5,1,2,0,2
54960_0,,,,2,2,1,3
C(C(C)(C(CC=C)O)O)(O)=O,,,5,1,2,0,2
54962_0,,,,2,2,1,3
C(C(C(CC=C)O)(CCO)O)(O)=O,,,5,1,1,0,1
54964_0,,,,2,2,1,3
C(C(C(CC=C)O)(CC=O)O)(O)=O,,,5,1,1,0,1
54966_0,,,,2,2,1,3
C(C)(C(C(CC=C)O)(CC=O)O)=O,,,5,1,1,0,1
54968_0,,,,2,2,1,3
C=CCC(C(C(C=O)=O)(C)O)O,,,5,1,2,0,2
54970_0,,,,2,2,1,3
C(C(C(CC=C)O)(CCO)O)=O,,,5,1,2,0,2
54972_0,,,,2,2,1,3
C(C(C(CC=C)O)(CC(O)=O)O)=O,,,5,1,1,0,1
54974_0,,,,2,2,1,3
C1(C(C(CC=C)O)(O)OCC1)=O,,,5,1,2,0,2
54976_0,,,,2,2,1,3
C(C(C=C)(C(CC=C)O)O)(O)=O,,,5,1,2,0,2
54978_0,,,,2,2,1,3
C1(C(C(CC=C)O)(O)OCC1O)=O,,,5,1,1,0,1
54980_0,,,,2,2,1,3
C1(C(C(CC=C)O)(CCO1)O)=O,,,5,1,2,0,2
54982_0,,,,2,2,1,3
C(C(C(CC=C)O)(O)O)=O,,,5,1,2,0,2
54984_0,,,,2,2,1,3
C(C(C)(C(CC=C)O)O)=O,,,5,1,2,0,2
54986_0,,,,2,2,1,3
C=CCC([C](C(O)=O)O)O,,,5,1,2,0,2
54988_0,,,,2,2,1,3
C=CC(C(C=O)=O)(C(C=C)O)O,,,5,1,1,0,1
54990_0,,,,2,2,1,3
C1OCC(C=1)(C(C=C)(C(C=O)=O)O)O,,,5,1,1,0,1
54992_0,,,,2,2,1,3
C(C(C(C=C)(C(C=O)=O)O)O)=O,,,5,1,2,0,2
54994_0,,,,2,2,1,3
C(C(C(C=C)(C(C=O)=O)O)O)(O)=O,,,5,1,1,0,1
54996_0,,,,2,2,1,3
C(C(C)(C(C=C)(C(C=O)=O)O)O)=O,,,5,1,1,0,1
54998_0,,,,2,2,1,3
C(C)(C(C(C=C)(C(C=O)=O)O)O)=O,,,5,1,1,0,1
55000_0,,,,2,2,1,3
C(CC(C(C=C)(C(C=O)=O)O)O)=O,,,5,1,1,0,1
55002_0,,,,2,2,1,3
C=CC(C(C=O)=O)(C(C)O)O,,,5,1,2,0,2
55004_0,,,,2,2,1,3
C=CC(C(C=O)=O)(C(CCO)O)O,,,5,1,1,0,1
55006_0,,,,2,2,1,3
C=CC(C(C=O)=O)(C(CO)(C)O)O,,,5,1,1,0,1
55008_0,,,,2,2,1,3
C(C(C=C)(C(C=C)(C(C=O)=O)O)O)=O,,,5,1,1,0,1
55010_0,,,,2,2,1,3
C=CC(C(C=O)=O)(C(C(C=C)=O)O)O,,,5,1,1,0,1
55012_0,,,,2,2,1,3
C=CC(C(C=O)=O)(C(C=CC=O)O)O,,,5,1,1,0,1
55013_0,,,,2,2,1,3
55015_0,,,,2,2,1,3
C=CC(C(C=O)=O)(C(C(O)O)O)O,,,5,1,1,0,1
55017_0,,,,2,2,1,3
C=CC(C(C=O)=O)(C(C(C)O)O)O,,,5,1,1,0,1
55018_0,,,,2,2,1,3
55020_0,,,,2,2,1,3
C=CC(C(C=O)=O)(C(CO)O)O,,,5,1,2,0,2
55021_0,,,,2,2,1,3
55022_0,,,,2,2,1,3
55023_0,,,,2,2,1,3
55024_0,,,,2,2,1,3
55025_0,,,,2,2,1,3
55027_0,,,,2,2,1,3
C(C(C(C(C(C=C)O)=O)O)(O)O)=O,,,5,1,1,0,1
55028_0,,,,2,2,1,3
55030_0,,,,2,2,1,3
C(C([C](C(O)=O)O)O)(C(C=C)O)=O,,,5,1,1,0,1
55032_0,,,,2,2,1,3
C(C(C=C)(C(C(C=C)O)O)O)=O,,,5,1,1,0,1
55034_0,,,,2,2,1,3
C(C(C=C)(C(C=C)O)O)=O,,,5,1,2,0,2
55035_0,,,,2,2,1,3
55036_0,,,,2,2,1,3
55038_0,,,,2,2,1,3
C(C(C=C)(C(C(C(C=O)=O)=C)O)O)=O,,,5,1,1,0,1
55040_0,,,,2,2,1,3
C(C(C=C)(C1(C=COC1)O)O)=O,,,5,1,1,0,1
55041_0,,,,2,2,1,3
55042_0,,,,2,2,1,3
55043_0,,,,2,2,1,3
55044_0,,,,2,2,1,3
55045_0,,,,2,2,1,3
55046_0,,,,2,2,1,3
55048_0,,,,2,2,1,3
C(C(C=C)(C(CC=O)O)O)=O,,,5,1,4,0,4
55049_0,,,,2,2,1,3
55050_0,,,,2,2,1,3
55051_0,,,,2,2,1,3
55053_0,,,,2,2,1,3
C(C(C=C)(C(CC(C=O)O)O)O)=O,,,5,1,1,0,1
55055_0,,,,2,2,1,3
C(C(C=C)(C(CC(CO)=O)O)O)=O,,,5,1,1,0,1
55056_0,,,,2,2,1,3
55058_0,,,,2,2,1,3
C(C(C=C)(C(C(C(C)=O)O)O)O)=O,,,5,1,1,0,1
55059_0,,,,2,2,1,3
55061_0,,,,2,2,1,3
C(C(C=C)(C(C)O)O)=O,,,5,1,3,0,3
55062_0,,,,2,2,1,3
55063_0,,,,2,2,1,3
55065_0,,,,2,2,1,3
C(C(C=C)(C(C(C=O)CO)O)O)=O,,,5,1,1,0,1
55067_0,,,,2,2,1,3
C(C(C=C)(C(CC(C)O)O)O)=O,,,5,1,3,0,3
55069_0,,,,2,2,1,3
C(C(C=C)(C(C(C(C)O)O)O)O)=O,,,5,1,1,0,1
55071_0,,,,2,2,1,3
C(C(C=C)(C(CCO)O)O)=O,,,5,1,3,0,3
55073_0,,,,2,2,1,3
C(C(C=C)(C(CC(CO)O)O)O)=O,,,5,1,1,0,1
55074_0,,,,2,2,1,3
55075_0,,,,2,2,1,3
55076_0,,,,2,2,1,3
55077_0,,,,2,2,1,3
55078_0,,,,2,2,1,3
55079_0,,,,2,2,1,3
55080_0,,,,2,2,1,3
55082_0,,,,2,2,1,3
C(C(C=C)(C(C(CCO)O)O)O)=O,,,5,1,1,0,1
55084_0,,,,2,2,1,3
C(C(C=C)(C(C)(C(CO)O)O)O)=O,,,5,1,1,0,1
55085_0,,,,2,2,1,3
55087_0,,,,2,2,1,3
C(C(C=C)(C(CC(O)=O)O)O)=O,,,5,1,3,0,3
55088_0,,,,2,2,1,3
55089_0,,,,2,2,1,3
55090_0,,,,2,2,1,3
55092_0,,,,2,2,1,3
C(C(C=C)(C(CC(C=O)=O)O)O)=O,,,5,1,1,0,1
55094_0,,,,2,2,1,3
C(C(C=C)(C1(COCC1O)O)O)=O,,,5,1,1,0,1
55096_0,,,,2,2,1,3
C(C(C=C)(C1(C(O)OCC1)O)O)=O,,,5,1,2,0,2
55098_0,,,,2,2,1,3
C(C(C=C)(C1(COC(C1)O)O)O)=O,,,5,1,1,0,1
55099_0,,,,2,2,1,3
55100_0,,,,2,2,1,3
55101_0,,,,2,2,1,3
55103_0,,,,2,2,1,3
C(C(C=C)(C(C=O)(C=C)O)O)=O,,,5,1,3,0,3
55104_0,,,,2,2,1,3
55106_0,,,,2,2,1,3
C(C(C=C)(C(C=CC=O)O)O)=O,,,5,1,3,0,3
55107_0,,,,2,2,1,3
55109_0,,,,2,2,1,3
C(C(C=C)(C(C(O)O)O)O)=O,,,5,1,3,0,3
55111_0,,,,2,2,1,3
C(C(C=C)(C(C(C)O)O)O)=O,,,5,1,3,0,3
55112_0,,,,2,2,1,3
55113_0,,,,2,2,1,3
55115_0,,,,2,2,1,3
C(C(C(C(C=C)O)O)(CC)O)(O)=O,,,5,1,1,0,1
55117_0,,,,2,2,1,3
C(C(C(C(C=C)O)O)O)(O)=O,,,5,1,3,0,3
55119_0,,,,2,2,1,3
C(C(C(C(C=C)O)O)(CC=O)O)=O,,,5,1,1,0,1
55121_0,,,,2,2,1,3
C(C(C)(C(C(C=C)O)O)O)(O)=O,,,5,1,3,0,3
55123_0,,,,2,2,1,3
C=CC(C(C(C(C=O)=O)(C)O)O)O,,,5,1,1,0,1
55125_0,,,,2,2,1,3
C(C(C(C(C=C)O)O)(CCO)O)=O,,,5,1,1,0,1
55127_0,,,,2,2,1,3
C1(C(C(C(C=C)O)O)(O)OCC1)=O,,,5,1,1,0,1
55129_0,,,,2,2,1,3
C(C(C=C)(C(C(C=C)O)O)O)(O)=O,,,5,1,1,0,1
55131_0,,,,2,2,1,3
C1(C(C(C(C=C)O)O)(CCO1)O)=O,,,5,1,1,0,1
55133_0,,,,2,2,1,3
C(C(C(C(C=C)O)O)(O)O)=O,,,5,1,3,0,3
55135_0,,,,2,2,1,3
C(C(C)(C(C(C=C)O)O)O)=O,,,5,1,3,0,3
55137_0,,,,2,2,1,3
C=CC(C([C](C(O)=O)O)O)O,,,5,1,3,0,3
55138_0,,,,2,2,1,3
55140_0,,,,2,2,1,3
C(C(C(C=CC=O)(CO)O)(O)O)=O,,,5,1,1,0,1
55142_0,,,,2,2,1,3
C(C(C)(C(C=CC=O)(CO)O)O)=O,,,5,1,1,0,1
55144_0,,,,2,2,1,3
C(C([C](C(O)=O)O)(CO)O)=CC=O,,,5,1,1,0,1
55145_0,,,,2,2,1,3
55147_0,,,,2,2,1,3
C(C(C(C=CC(CO)=O)O)(O)O)=O,,,5,1,1,0,1
55149_0,,,,2,2,1,3
C(C(C)(C(C=CC(CO)=O)O)O)=O,,,5,1,1,0,1
55151_0,,,,2,2,1,3
C(C([C](C(O)=O)O)O)=CC(CO)=O,,,5,1,1,0,1
55153_0,,,,2,2,1,3
C(C(C(C=CC(CO)O)O)O)(O)=O,,,5,1,1,0,1
55155_0,,,,2,2,1,3
C(C(C(C=CC(CO)O)O)(O)O)=O,,,5,1,1,0,1
55157_0,,,,2,2,1,3
C(C(C)(C(C=CC(CO)O)O)O)=O,,,5,1,1,0,1
55159_0,,,,2,2,1,3
C(C([C](C(O)=O)O)O)=CC(CO)O,,,5,1,1,0,1
55161_0,,,,2,2,1,3
C(C(C(C=O)=C)(C(C=C)O)O)(O)=O,,,5,1,1,0,1
55163_0,,,,2,2,1,3
C(C(C=CC=O)(C(C=C)O)O)(O)=O,,,5,1,1,0,1
55165_0,,,,2,2,1,3
C(C(C(C(O)=O)=C)(C(C=C)O)O)=O,,,5,1,1,0,1
55167_0,,,,2,2,1,3
C(C(C=CCO)(C(C=C)O)O)(O)=O,,,5,1,1,0,1
55169_0,,,,2,2,1,3
C1(C(CC(O)O1)(C(C=C)O)O)=O,,,5,1,1,0,1
55171_0,,,,2,2,1,3
C1(C(C(C=C)O)(O)OC(C)C1)=O,,,5,1,1,0,1
55173_0,,,,2,2,1,3
C(C1(CC(C(O)O1)=O)C(C=C)O)=O,,,5,1,1,0,1
55175_0,,,,2,2,1,3
C(C1CC(C(C(C=C)O)(O)O1)=O)=O,,,5,1,1,0,1
55177_0,,,,2,2,1,3
C1(C(C(C=C)O)(O)OC(C)C1O)=O,,,5,1,1,0,1
55179_0,,,,2,2,1,3
C1(C(C(C(C(C=C)O)(O)O1)=O)O)=O,,,5,1,1,0,1
55181_0,,,,2,2,1,3
C1(COC(CC1(C(C=C)O)O)O)=O,,,5,1,1,0,1
55183_0,,,,2,2,1,3
C1(C(CC(CO)O1)(C(C=C)O)O)=O,,,5,1,1,0,1
55185_0,,,,2,2,1,3
C1(C(CC(CO1)O)(C(C=C)O)O)=O,,,5,1,1,0,1
55187_0,,,,2,2,1,3
C(CCC(C=O)(C(C=C)O)O)(O)=O,,,5,1,1,0,1
55189_0,,,,2,2,1,3
C(C(CC)(C(C=C)O)O)(O)=O,,,5,1,1,0,1
55191_0,,,,2,2,1,3
C(C(CC(C)O)(C(C=C)O)O)=O,,,5,1,1,0,1
55193_0,,,,2,2,1,3
C(C(CC(CO)O)(C(C=C)O)O)=O,,,5,1,1,0,1
55194_0,,,,2,2,1,3
55195_0,,,,2,2,1,3
55197_0,,,,2,2,1,3
C(C(C)(C(C=C)O)O)(O)=O,,,5,1,4,0,4
55199_0,,,,2,2,1,3
C(C(CCO)(C(C=C)O)O)(O)=O,,,5,1,3,0,3
55201_0,,,,2,2,1,3
C(C(CC=O)(C(C=C)O)O)(O)=O,,,5,1,3,0,3
55203_0,,,,2,2,1,3
C(CC(C(C)=O)(C(C=C)O)O)=O,,,5,1,3,0,3
55204_0,,,,2,2,1,3
55205_0,,,,2,2,1,3
55206_0,,,,2,2,1,3
55208_0,,,,2,2,1,3
C(CC(C(CO)=O)(C(C=C)O)O)=O,,,5,1,1,0,1
55210_0,,,,2,2,1,3
C=CC(C(C(C=O)=O)(C)O)O,,,5,1,3,0,3
55212_0,,,,2,2,1,3
C(C(CCO)(C(C=C)O)O)=O,,,5,1,3,0,3
55214_0,,,,2,2,1,3
C(CC(C=O)(C(C=C)O)O)(O)=O,,,5,1,3,0,3
55215_0,,,,2,2,1,3
55217_0,,,,2,2,1,3
C1(C(C(C=C)O)(O)OCC1)=O,,,5,1,3,0,3
55219_0,,,,2,2,1,3
C(C(C=C)(C(C=C)O)O)(O)=O,,,5,1,3,0,3
55221_0,,,,2,2,1,3
C1(C(C(C=C)O)(O)OCC1O)=O,,,5,1,3,0,3
55223_0,,,,2,2,1,3
C1(C(CCO1)(C(C=C)O)O)=O,,,5,1,3,0,3
55225_0,,,,2,2,1,3
C(CC(C(O)=O)(C(C=C)O)O)(O)=O,,,5,1,1,0,1
55227_0,,,,2,2,1,3
C(C(C(C=C)O)(O)O)=O,,,5,1,3,0,3
55229_0,,,,2,2,1,3
C(C(C)(C(C=C)O)O)=O,,,5,1,4,0,4
55231_0,,,,2,2,1,3
C=CC([C](C(O)=O)O)O,,,5,1,3,0,3
55233_0,,,,2,2,1,3
C(C(C(C(C=C)(CO)O)O)O)(O)=O,,,5,1,1,0,1
55235_0,,,,2,2,1,3
C(C(C(C(C=C)(CO)O)O)(O)O)=O,,,5,1,1,0,1
55237_0,,,,2,2,1,3
C(C(C)(C(C(C=C)(CO)O)O)O)=O,,,5,1,1,0,1
55239_0,,,,2,2,1,3
C(C(CO)(C([C](C(O)=O)O)O)O)=C,,,5,1,1,0,1
55241_0,,,,2,2,1,3
C(C(C(C(O)=O)=C)(C(C)O)O)(O)=O,,,5,1,1,0,1
55243_0,,,,2,2,1,3
C(C(C(O)=O)(C(C(O)=O)=C)O)(O)=O,,,5,1,1,0,1
55244_0,,,,2,2,1,3
55245_0,,,,2,2,1,3
55247_0,,,,2,2,1,3
C(C(C(C=O)=C)(C(C)O)O)(O)=O,,,5,1,2,0,2
55249_0,,,,2,2,1,3
C(C(C(O)=O)(C(C=O)=C)O)(O)=O,,,5,1,2,0,2
55250_0,,,,2,2,1,3
55251_0,,,,2,2,1,3
55253_0,,,,2,2,1,3
C(C)(C(C(C(O)=O)=C)(C(C)O)O)=O,,,5,1,1,0,1
55255_0,,,,2,2,1,3
C(C(C(C)=O)(C(C(O)=O)=C)O)(O)=O,,,5,1,1,0,1
55257_0,,,,2,2,1,3
C(C)(C(C(C(O)=O)=C)(CO)O)=O,,,5,1,2,0,2
55258_0,,,,2,2,1,3
55260_0,,,,2,2,1,3
C(C(C=CC=O)(C(C)O)O)(O)=O,,,5,1,2,0,2
55262_0,,,,2,2,1,3
C(C(C(O)=O)(C=CC=O)O)(O)=O,,,5,1,2,0,2
55263_0,,,,2,2,1,3
55264_0,,,,2,2,1,3
55265_0,,,,2,2,1,3
55266_0,,,,2,2,1,3
55267_0,,,,2,2,1,3
55268_0,,,,2,2,1,3
55269_0,,,,2,2,1,3
55270_0,,,,2,2,1,3
55271_0,,,,2,2,1,3
55272_0,,,,2,2,1,3
55273_0,,,,2,2,1,3
55275_0,,,,2,2,1,3
C(C(C(C(O)=O)=C)(C(C)O)O)=O,,,5,1,2,0,2
55277_0,,,,2,2,1,3
C(C(C=O)(C(C(O)=O)=C)O)(O)=O,,,5,1,2,0,2
55278_0,,,,2,2,1,3
55279_0,,,,2,2,1,3
55280_0,,,,2,2,1,3
55281_0,,,,2,2,1,3
55283_0,,,,2,2,1,3
C(C(C(C=O)=C)(C(C=O)(O)O)O)=O,,,5,1,1,0,1
55284_0,,,,2,2,1,3
55286_0,,,,2,2,1,3
C(C([C](C(O)=O)O)(C(C=O)=C)O)=O,,,5,1,1,0,1
55287_0,,,,2,2,1,3
55289_0,,,,2,2,1,3
C(C(C(C(C(C=O)=C)=O)O)(O)O)=O,,,5,1,1,0,1
55290_0,,,,2,2,1,3
55292_0,,,,2,2,1,3
C=C(C=O)C(C([C](C(O)=O)O)O)=O,,,5,1,1,0,1
55294_0,,,,2,2,1,3
C(C(C(C(C(C=O)=O)=C)O)O)(O)=O,,,5,1,1,0,1
55296_0,,,,2,2,1,3
C(C(C(C(C(C=O)=O)=C)O)(O)O)=O,,,5,1,1,0,1
55298_0,,,,2,2,1,3
C(C(C)(C(C(C(C=O)=O)=C)O)O)=O,,,5,1,1,0,1
55300_0,,,,2,2,1,3
C=C(C(C=O)=O)C([C](C(O)=O)O)O,,,5,1,1,0,1
55302_0,,,,2,2,1,3
C(C(CC)(C1(C=COC1)O)O)(O)=O,,,5,1,1,0,1
55304_0,,,,2,2,1,3
C(C(C1(C=COC1)O)O)(O)=O,,,5,1,2,0,2
55306_0,,,,2,2,1,3
C(CC(C=O)(C1(C=COC1)O)O)=O,,,5,1,1,0,1
55308_0,,,,2,2,1,3
C(C(C)(C1(C=COC1)O)O)(O)=O,,,5,1,2,0,2
55310_0,,,,2,2,1,3
C1OCC(C=1)(C(C(C=O)=O)(C)O)O,,,5,1,1,0,1
55312_0,,,,2,2,1,3
C(C(CCO)(C1(C=COC1)O)O)=O,,,5,1,1,0,1
55314_0,,,,2,2,1,3
C1(C(C2(C=COC2)O)(O)OCC1)=O,,,5,1,1,0,1
55316_0,,,,2,2,1,3
C(C(C=C)(C1(C=COC1)O)O)(O)=O,,,5,1,1,0,1
55318_0,,,,2,2,1,3
C1(C(CCO1)(C2(C=COC2)O)O)=O,,,5,1,1,0,1
55320_0,,,,2,2,1,3
C(C(C1(C=COC1)O)(O)O)=O,,,5,1,2,0,2
55322_0,,,,2,2,1,3
C(C(C)(C1(C=COC1)O)O)=O,,,5,1,2,0,2
55324_0,,,,2,2,1,3
C1OCC(C=1)([C](C(O)=O)O)O,,,5,1,2,0,2
55325_0,,,,2,2,1,3
55327_0,,,,2,2,1,3
C(C(C=CCO)(C(C)O)O)(O)=O,,,5,1,3,0,3
55329_0,,,,2,2,1,3
C(C(C(O)=O)(C=CCO)O)(O)=O,,,5,1,2,0,2
55330_0,,,,2,2,1,3
55332_0,,,,2,2,1,3
C(C(C=CCO)(C(CO)O)O)(O)=O,,,5,1,1,0,1
55334_0,,,,2,2,1,3
C(C(C=CC(CO)O)(CO)O)(O)=O,,,5,1,1,0,1
55336_0,,,,2,2,1,3
C1(C(CO)(O)OC(CO)(CO)C1)=O,,,5,1,2,0,2
55338_0,,,,2,2,1,3
C1(CC(C(O)=O)OC1(C(C)O)O)=O,,,5,1,1,0,1
55340_0,,,,2,2,1,3
C(C1(C(CC(C(O)=O)O1)=O)O)(O)=O,,,5,1,1,0,1
55342_0,,,,2,2,1,3
C1(CC(C(O)=O)OC1(CO)O)=O,,,5,1,2,0,2
55344_0,,,,2,2,1,3
C(C1(C(C)O)CC(C(O1)O)=O)(O)=O,,,5,1,2,0,2
55346_0,,,,2,2,1,3
C(C1(C(O)=O)CC(C(O1)O)=O)(O)=O,,,5,1,2,0,2
55347_0,,,,2,2,1,3
55349_0,,,,2,2,1,3
C1(C(CC(C=O)(O)O1)(C(C)O)O)=O,,,5,1,2,0,2
55351_0,,,,2,2,1,3
C(C1(C(OC(C=O)(C1)O)=O)O)(O)=O,,,5,1,2,0,2
55353_0,,,,2,2,1,3
C1(C(CO)(CC(C=O)(O)O1)O)=O,,,5,1,2,0,2
55355_0,,,,2,2,1,3
C(C1C(O)OC(C1(C(C)O)O)=O)=O,,,5,1,2,0,2
55357_0,,,,2,2,1,3
C1(C(C(O)=O)(C(C=O)C(O)O1)O)=O,,,5,1,2,0,2
55359_0,,,,2,2,1,3
C(C1C(O)OC(C1(CO)O)=O)=O,,,5,1,3,0,3
55360_0,,,,2,2,1,3
55361_0,,,,2,2,1,3
55362_0,,,,2,2,1,3
55363_0,,,,2,2,1,3
55365_0,,,,2,2,1,3
C1(C(C(CC=O)O)(CC(O)O1)O)=O,,,5,1,2,0,2
55367_0,,,,2,2,1,3
C1(C(C(C)O)(CC(O)O1)O)=O,,,5,1,2,0,2
55369_0,,,,2,2,1,3
C1(C(CC(O)O1)(C(CCO)O)O)=O,,,5,1,2,0,2
55371_0,,,,2,2,1,3
C1(C(CC(O)O1)(C(CO)(C)O)O)=O,,,5,1,2,0,2
55373_0,,,,2,2,1,3
C1(C(C(O)=O)(CC(O)O1)O)=O,,,5,1,2,0,2
55375_0,,,,2,2,1,3
C1(C(C(C(O)O)O)(CC(O)O1)O)=O,,,5,1,2,0,2
55377_0,,,,2,2,1,3
C1(C(CC(O)O1)(C(C(C)O)O)O)=O,,,5,1,2,0,2
55379_0,,,,2,2,1,3
C1(C(CO)(CC(O)O1)O)=O,,,5,1,2,0,2
55381_0,,,,2,2,1,3
C1(C(C(CO)O)(CC(O)O1)O)=O,,,5,1,2,0,2
55383_0,,,,2,2,1,3
C(C1C(C(C(CO)(O1)O)=O)O)(O)=O,,,5,1,1,0,1
55385_0,,,,2,2,1,3
C(C1(C)CC(C(C(C)O)(O1)O)=O)=O,,,5,1,1,0,1
55387_0,,,,2,2,1,3
C(C1(C)CC(C(C(O)=O)(O1)O)=O)=O,,,5,1,1,0,1
55389_0,,,,2,2,1,3
C(C1(C)CC(C(CO)(O1)O)=O)=O,,,5,1,2,0,2
55391_0,,,,2,2,1,3
C(C1(C)C(C(C(CO)(O1)O)=O)O)=O,,,5,1,1,0,1
55393_0,,,,2,2,1,3
C1(CC(C(C)=O)OC1(C(C)O)O)=O,,,5,1,1,0,1
55395_0,,,,2,2,1,3
C(C1(C(CC(C(C)=O)O1)=O)O)(O)=O,,,5,1,1,0,1
55397_0,,,,2,2,1,3
C1(CC(C(C)=O)OC1(CO)O)=O,,,5,1,3,0,3
55399_0,,,,2,2,1,3
C(C)(C1(C(C)O)CC(C(O1)O)=O)=O,,,5,1,2,0,2
55401_0,,,,2,2,1,3
C(C1(C(C)=O)CC(C(O1)O)=O)(O)=O,,,5,1,2,0,2
55403_0,,,,2,2,1,3
C(C)(C1(CO)CC(C(O1)O)=O)=O,,,5,1,3,0,3
55405_0,,,,2,2,1,3
C(C1C(C(C(CO)(O1)O)=O)O)(C)=O,,,5,1,1,0,1
55407_0,,,,2,2,1,3
C(CC1CC(C(C(C)O)(O)O1)=O)=O,,,5,1,1,0,1
55409_0,,,,2,2,1,3
C(C1(C(CC(CC=O)O1)=O)O)(O)=O,,,5,1,1,0,1
55411_0,,,,2,2,1,3
C(CC1CC(C(CO)(O)O1)=O)=O,,,5,1,3,0,3
55413_0,,,,2,2,1,3
C(C(C1(C(CC(C)O1)=O)O)O)=O,,,5,1,1,0,1
55415_0,,,,2,2,1,3
C(C(C1(C(CC(C)O1)=O)O)O)(O)=O,,,5,1,1,0,1
55417_0,,,,2,2,1,3
C(C(C)(C1(C(CC(C)O1)=O)O)O)=O,,,5,1,1,0,1
55419_0,,,,2,2,1,3
C(C(C1(C(CC(C)O1)=O)O)O)(C)=O,,,5,1,1,0,1
55421_0,,,,2,2,1,3
C(CC(C1(C(CC(C)O1)=O)O)O)=O,,,5,1,1,0,1
55423_0,,,,2,2,1,3
C1(C(C(C)O)(O)OC(C)C1)=O,,,5,1,1,0,1
55425_0,,,,2,2,1,3
C1(C(C(CCO)O)(O)OC(C)C1)=O,,,5,1,1,0,1
55427_0,,,,2,2,1,3
C1(C(C(CO)(C)O)(O)OC(C)C1)=O,,,5,1,1,0,1
55429_0,,,,2,2,1,3
C(C1(C(CC(C)O1)=O)O)(O)=O,,,5,1,1,0,1
55431_0,,,,2,2,1,3
C1(C(C(C(O)O)O)(O)OC(C)C1)=O,,,5,1,1,0,1
55433_0,,,,2,2,1,3
C1(C(C(C(C)O)O)(O)OC(C)C1)=O,,,5,1,1,0,1
55435_0,,,,2,2,1,3
C1(C(CO)(O)OC(C)C1)=O,,,5,1,2,0,2
55437_0,,,,2,2,1,3
C1(C(C(CO)O)(O)OC(C)C1)=O,,,5,1,1,0,1
55439_0,,,,2,2,1,3
C(C(C1(C(O)OC(C)C1)O)O)(O)=O,,,5,1,2,0,2
55441_0,,,,2,2,1,3
C(C(C1(C(O)OC(C)C1)O)(O)O)=O,,,5,1,2,0,2
55443_0,,,,2,2,1,3
C(C(C)(C1(C(O)OC(C)C1)O)O)=O,,,5,1,2,0,2
55445_0,,,,2,2,1,3
[C](C(O)=O)(C1(C(O)OC(C)C1)O)O,,,5,1,2,0,2
55447_0,,,,2,2,1,3
C(C1(CO)CC(C(CO)(O1)O)=O)=O,,,5,1,2,0,2
55449_0,,,,2,2,1,3
C(CO)(C1(CO)CC(C(O1)O)=O)=O,,,5,1,2,0,2
55451_0,,,,2,2,1,3
C1(CC(C(CO)=O)OC1(CO)O)=O,,,5,1,2,0,2
55453_0,,,,2,2,1,3
C(C(C1(C=O)CC(C(O)O1)=O)O)=O,,,5,1,2,0,2
55455_0,,,,2,2,1,3
C(C1(C(C)O)CC(C(O1)O)=O)=O,,,5,1,2,0,2
55457_0,,,,2,2,1,3
C(C1(C=O)CC(C(O1)O)=O)(O)=O,,,5,1,2,0,2
55458_0,,,,2,2,1,3
55459_0,,,,2,2,1,3
55461_0,,,,2,2,1,3
C(C1CC(C(C(C=O)O)(O)O1)=O)=O,,,5,1,1,0,1
55463_0,,,,2,2,1,3
C1(CC(C=O)OC1(C(C)O)O)=O,,,5,1,1,0,1
55465_0,,,,2,2,1,3
C(C1(C(CC(C=O)O1)=O)O)(O)=O,,,5,1,1,0,1
55467_0,,,,2,2,1,3
C1(CC(C=O)OC1(CO)O)=O,,,5,1,2,0,2
55469_0,,,,2,2,1,3
C1(CC(C=O)OC1(C(CO)O)O)=O,,,5,1,1,0,1
55471_0,,,,2,2,1,3
C(CC1C(C(C(CO)(O)O1)=O)O)=O,,,5,1,1,0,1
55473_0,,,,2,2,1,3
C1(C(C(C)O)(O)OC(C)C1CO)=O,,,5,1,1,0,1
55475_0,,,,2,2,1,3
C(C1(C(C(CO)C(C)O1)=O)O)(O)=O,,,5,1,1,0,1
55477_0,,,,2,2,1,3
C1(C(CO)(O)OC(C)C1CO)=O,,,5,1,1,0,1
55478_0,,,,2,2,1,3
55480_0,,,,2,2,1,3
C1(C(CO)(OC(C=O)C1CO)O)=O,,,5,1,1,0,1
55482_0,,,,2,2,1,3
C1(C(CO)(O)OC(CO)C1CO)=O,,,5,1,1,0,1
55483_0,,,,2,2,1,3
55485_0,,,,2,2,1,3
C(C(CO)(C1C(O)OCC1O)O)=O,,,5,1,2,0,2
55487_0,,,,2,2,1,3
C(C(C1(C(C(C(C)O1)O)=O)O)O)=O,,,5,1,1,0,1
55489_0,,,,2,2,1,3
C1(C(C(C)O)(O)OC(C)C1O)=O,,,5,1,1,0,1
55491_0,,,,2,2,1,3
C(C1(C(C(C(C)O1)O)=O)O)(O)=O,,,5,1,1,0,1
55493_0,,,,2,2,1,3
C1(C(CO)(O)OC(C)C1O)=O,,,5,1,1,0,1
55495_0,,,,2,2,1,3
C1(C(C(CO)O)(O)OC(C)C1O)=O,,,5,1,1,0,1
55497_0,,,,2,2,1,3
C(C1C(C(C(C(C)O)(O1)O)=O)O)=O,,,5,1,1,0,1
55499_0,,,,2,2,1,3
C(C1(C(C(C(C=O)O1)O)=O)O)(O)=O,,,5,1,1,0,1
55501_0,,,,2,2,1,3
C(C1C(C(C(CO)(O1)O)=O)O)=O,,,5,1,1,0,1
55503_0,,,,2,2,1,3
C1(C(C(C)O)(O)OC(CO)C1O)=O,,,5,1,1,0,1
55505_0,,,,2,2,1,3
C(C1(C(C(C(CO)O1)O)=O)O)(O)=O,,,5,1,1,0,1
55507_0,,,,2,2,1,3
C1(C(CO)(O)OC(CO)C1O)=O,,,5,1,2,0,2
55509_0,,,,2,2,1,3
C1(C(CO)(O)OC(C)C1(CO)O)=O,,,5,1,1,0,1
55511_0,,,,2,2,1,3
C1(C(C(C)O)(CC(CO)(O)O1)O)=O,,,5,1,2,0,2
55513_0,,,,2,2,1,3
C1(C(C(O)=O)(CC(CO)(O)O1)O)=O,,,5,1,2,0,2
55515_0,,,,2,2,1,3
C1(C(CO)(CC(CO)(O)O1)O)=O,,,5,1,2,0,2
55517_0,,,,2,2,1,3
C(C1(C(C(C(C)O)(O)OC1)=O)O)=O,,,5,1,1,0,1
55519_0,,,,2,2,1,3
C(C1(C(C(C(O)=O)(O)OC1)=O)O)=O,,,5,1,1,0,1
55521_0,,,,2,2,1,3
C(C1(C(C(CO)(O)OC1)=O)O)=O,,,5,1,2,0,2
55523_0,,,,2,2,1,3
C1(C(C(C(C(C=O)O)(O)O1)=O)O)=O,,,5,1,1,0,1
55525_0,,,,2,2,1,3
C1(C(C(C(C(C)O)(O)O1)=O)O)=O,,,5,1,1,0,1
55527_0,,,,2,2,1,3
C1(C(C(C(C(O)=O)(O)O1)=O)O)=O,,,5,1,1,0,1
55529_0,,,,2,2,1,3
C1(C(C(C(CO)(O)O1)=O)O)=O,,,5,1,2,0,2
55531_0,,,,2,2,1,3
C1(C(C(C(C(CO)O)(O)O1)=O)O)=O,,,5,1,1,0,1
55533_0,,,,2,2,1,3
C1(C(CO)(O)OCC(CO)(C1)O)=O,,,5,1,2,0,2
55535_0,,,,2,2,1,3
C1(CC(C(OC1(C(C)O)O)=O)O)=O,,,5,1,1,0,1
55537_0,,,,2,2,1,3
C(C1(C(CC(C(O1)=O)O)=O)O)(O)=O,,,5,1,1,0,1
55539_0,,,,2,2,1,3
C1(CC(C(OC1(CO)O)=O)O)=O,,,5,1,2,0,2
55541_0,,,,2,2,1,3
C1(C(C(C)O)(CC(C(O)O1)=O)O)=O,,,5,1,2,0,2
55543_0,,,,2,2,1,3
C1(C(C(O)=O)(CC(C(O)O1)=O)O)=O,,,5,1,2,0,2
55545_0,,,,2,2,1,3
C1(C(CO)(CC(C(O)O1)=O)O)=O,,,5,1,2,0,2
55547_0,,,,2,2,1,3
C1(C(C(C(OC1(CO)O)=O)O)O)=O,,,5,1,1,0,1
55549_0,,,,2,2,1,3
C(C1(COC(C(C1)=O)(CO)O)O)=O,,,5,1,2,0,2
55551_0,,,,2,2,1,3
C(C1(CC(C(CO1)=O)(CO)O)O)=O,,,5,1,2,0,2
55553_0,,,,2,2,1,3
C(C1C(OCC(C1(CO)O)=O)O)=O,,,5,1,2,0,2
55555_0,,,,2,2,1,3
C1(C(CO)(O)OCC(C1CO)O)=O,,,5,1,1,0,1
55557_0,,,,2,2,1,3
C(C1(C(C)O)CC(CC(O1)O)O)=O,,,5,1,2,0,2
55559_0,,,,2,2,1,3
C(C1(C=O)CC(CC(O1)O)O)(O)=O,,,5,1,2,0,2
55561_0,,,,2,2,1,3
C(C1(CO)CC(CC(O1)O)O)=O,,,5,1,2,0,2
55563_0,,,,2,2,1,3
C(C1(CO)CC(C(C(O1)O)O)O)=O,,,5,1,2,0,2
55564_0,,,,2,2,1,3
55566_0,,,,2,2,1,3
C1(COC(CC1(C(C=O)O)O)O)=O,,,5,1,2,0,2
55568_0,,,,2,2,1,3
C1(COC(CC1(C(C)O)O)O)=O,,,5,1,2,0,2
55570_0,,,,2,2,1,3
C(C1(C(COC(C1)O)=O)O)(O)=O,,,5,1,2,0,2
55572_0,,,,2,2,1,3
C1(COC(CC1(CO)O)O)=O,,,5,1,2,0,2
55574_0,,,,2,2,1,3
C1(COC(CC1(C(CO)O)O)O)=O,,,5,1,2,0,2
55576_0,,,,2,2,1,3
C1(C(CO)OC(CC1(CO)O)O)=O,,,5,1,2,0,2
55578_0,,,,2,2,1,3
C1(C(C(C)O)(O)OCC(C1O)O)=O,,,5,1,1,0,1
55580_0,,,,2,2,1,3
C(C1(C(C(C(CO1)O)O)=O)O)(O)=O,,,5,1,1,0,1
55582_0,,,,2,2,1,3
C1(C(CO)(O)OCC(C1O)O)=O,,,5,1,2,0,2
55584_0,,,,2,2,1,3
C1(COC(C(CC1(CO)O)=O)O)=O,,,5,1,2,0,2
55586_0,,,,2,2,1,3
C1(CC(C(COC1(CO)O)=O)O)=O,,,5,1,2,0,2
55588_0,,,,2,2,1,3
C1(CCOC(CC1(C(C)O)O)O)=O,,,5,1,2,0,2
55590_0,,,,2,2,1,3
C(C1(C(CCOC(C1)O)=O)O)(O)=O,,,5,1,2,0,2
55592_0,,,,2,2,1,3
C1(CCOC(CC1(CO)O)O)=O,,,5,1,2,0,2
55593_0,,,,2,2,1,3
55595_0,,,,2,2,1,3
C1(C(CO)(C(C(C=O)=O)CO1)O)=O,,,5,1,1,0,1
55597_0,,,,2,2,1,3
C1(C(C(C=O)C(C=O)(CO)O1)O)=O,,,5,1,1,0,1
55599_0,,,,2,2,1,3
C1(C(CO)(C(C=O)C(C=O)O1)O)=O,,,5,1,1,0,1
55600_0,,,,2,2,1,3
55602_0,,,,2,2,1,3
C1(C(C(CO1)O)(C(C=O)(O)O)O)=O,,,5,1,1,0,1
55603_0,,,,2,2,1,3
55605_0,,,,2,2,1,3
C1(C([C](C(O)=O)O)(C(CO1)O)O)=O,,,5,1,1,0,1
55606_0,,,,2,2,1,3
55608_0,,,,2,2,1,3
C1(C(C(C)O)(CC(CO)O1)O)=O,,,5,1,2,0,2
55610_0,,,,2,2,1,3
C1(C(C(O)=O)(CC(CO)O1)O)=O,,,5,1,2,0,2
55612_0,,,,2,2,1,3
C1(C(CO)(CC(CO)O1)O)=O,,,5,1,2,0,2
55614_0,,,,2,2,1,3
C1(C(C(CO)O)(CC(CO)O1)O)=O,,,5,1,1,0,1
55616_0,,,,2,2,1,3
C1(C(CO)(CC(C(CO)O)O1)O)=O,,,5,1,1,0,1
55618_0,,,,2,2,1,3
C1(C(CO)(C(C=O)C(CO1)=O)O)=O,,,5,1,1,0,1
55620_0,,,,2,2,1,3
C1(C(CO)(CC(C(C=O)O1)=O)O)=O,,,5,1,1,0,1
55622_0,,,,2,2,1,3
C(C1(CO)CC(C(C(O1)=O)O)O)=O,,,5,1,1,0,1
55623_0,,,,2,2,1,3
55625_0,,,,2,2,1,3
C1(C(C(C)O)(CC(CO1)O)O)=O,,,5,1,2,0,2
55627_0,,,,2,2,1,3
C1(C(C(O)=O)(CC(CO1)O)O)=O,,,5,1,2,0,2
55629_0,,,,2,2,1,3
C1(C(CO)(CC(CO1)O)O)=O,,,5,1,2,0,2
55631_0,,,,2,2,1,3
C1(C(C(CO)O)(CC(CO1)O)O)=O,,,5,1,1,0,1
55633_0,,,,2,2,1,3
C1(C(CO)(CC(C(CO)O1)O)O)=O,,,5,1,1,0,1
55635_0,,,,2,2,1,3
C1(C(CO)(CC(C(CO1)O)O)O)=O,,,5,1,1,0,1
55636_0,,,,2,2,1,3
55637_0,,,,2,2,1,3
55639_0,,,,2,2,1,3
C(CCC(C(C)=O)(C(C)O)O)(O)=O,,,5,1,2,0,2
55640_0,,,,2,2,1,3
55641_0,,,,2,2,1,3
55643_0,,,,2,2,1,3
C(C(CO)(CCCC(C=O)=O)O)=O,,,5,1,2,0,2
55645_0,,,,2,2,1,3
C(C(CCCO)(C(C(O)=O)O)O)=O,,,5,1,1,0,1
55647_0,,,,2,2,1,3
C(C(CCCO)(C(C=O)(O)O)O)=O,,,5,1,1,0,1
55649_0,,,,2,2,1,3
C(C(CCCO)(C(C=O)(C)O)O)=O,,,5,1,1,0,1
55651_0,,,,2,2,1,3
C(C([C](C(O)=O)O)(CCCO)O)=O,,,5,1,1,0,1
55653_0,,,,2,2,1,3
C(C(C(C(O)=O)O)O)(CCCO)=O,,,5,1,2,0,2
55655_0,,,,2,2,1,3
C(C(C(C=O)(O)O)O)(CCCO)=O,,,5,1,2,0,2
55657_0,,,,2,2,1,3
C(C(C)(C(C(CCCO)=O)O)O)=O,,,5,1,2,0,2
55659_0,,,,2,2,1,3
C(CCCO)(C([C](C(O)=O)O)O)=O,,,5,1,2,0,2
55660_0,,,,2,2,1,3
55662_0,,,,2,2,1,3
C(C(CO)(CC(C=O)CC=O)O)=O,,,5,1,3,0,3
55664_0,,,,2,2,1,3
C(C(C(C)O)(CCCC(O)=O)O)=O,,,5,1,2,0,2
55665_0,,,,2,2,1,3
55667_0,,,,2,2,1,3
C(C(CO)(CCCC(O)=O)O)=O,,,5,1,2,0,2
55668_0,,,,2,2,1,3
55670_0,,,,2,2,1,3
C(C(C(O)=O)(CCC(O)=O)O)(O)=O,,,5,1,2,0,2
55671_0,,,,2,2,1,3
55672_0,,,,2,2,1,3
55673_0,,,,2,2,1,3
55675_0,,,,2,2,1,3
C(CCCC(C(C=O)(O)O)O)(O)=O,,,5,1,2,0,2
55677_0,,,,2,2,1,3
C(C(C)(C(CCCC(O)=O)O)O)=O,,,5,1,2,0,2
55679_0,,,,2,2,1,3
C(CCCC([C](C(O)=O)O)O)(O)=O,,,5,1,2,0,2
55680_0,,,,2,2,1,3
55681_0,,,,2,2,1,3
55682_0,,,,2,2,1,3
55683_0,,,,2,2,1,3
55684_0,,,,2,2,1,3
55685_0,,,,2,2,1,3
55686_0,,,,2,2,1,3
55687_0,,,,2,2,1,3
55688_0,,,,2,2,1,3
55689_0,,,,2,2,1,3
55691_0,,,,2,2,1,3
C(C(CC)(C(C(CO)O)O)O)(O)=O,,,5,1,1,0,1
55692_0,,,,2,2,1,3
55694_0,,,,2,2,1,3
C(C(CC)(C(CO)(CO)O)O)(O)=O,,,5,1,1,0,1
55695_0,,,,2,2,1,3
55696_0,,,,2,2,1,3
55697_0,,,,2,2,1,3
55699_0,,,,2,2,1,3
C(C(C(CC=O)O)(CC)O)(O)=O,,,5,1,1,0,1
55701_0,,,,2,2,1,3
C(C(C(C)O)(CC)O)(O)=O,,,5,1,1,0,1
55702_0,,,,2,2,1,3
55703_0,,,,2,2,1,3
55705_0,,,,2,2,1,3
C(C(CC)(C(CC(C)O)O)O)(O)=O,,,5,1,1,0,1
55707_0,,,,2,2,1,3
C(C(CC)(C(CCO)O)O)(O)=O,,,5,1,1,0,1
55709_0,,,,2,2,1,3
C(C(C(C(C=O)O)O)(CC)O)(O)=O,,,5,1,1,0,1
55711_0,,,,2,2,1,3
C(C(CC)(C(CO)(C)O)O)(O)=O,,,5,1,1,0,1
55712_0,,,,2,2,1,3
55714_0,,,,2,2,1,3
C(C(C(CC(O)=O)O)(CC)O)(O)=O,,,5,1,1,0,1
55715_0,,,,2,2,1,3
55716_0,,,,2,2,1,3
55718_0,,,,2,2,1,3
C(C(CC)(C(C=CC=O)O)O)(O)=O,,,5,1,1,0,1
55720_0,,,,2,2,1,3
C(C(C(O)=O)(CC)O)(O)=O,,,5,1,1,0,1
55722_0,,,,2,2,1,3
C(C(C(C(O)O)O)(CC)O)(O)=O,,,5,1,1,0,1
55724_0,,,,2,2,1,3
C(C(CC)(C(C(C)O)O)O)(O)=O,,,5,1,1,0,1
55725_0,,,,2,2,1,3
55726_0,,,,2,2,1,3
55728_0,,,,2,2,1,3
C(C(CO)(CC(CO)(CO)O)O)=O,,,5,1,1,0,1
55730_0,,,,2,2,1,3
C(C(C)(CC(C=O)(C(C)O)O)O)=O,,,5,1,1,0,1
55731_0,,,,2,2,1,3
55733_0,,,,2,2,1,3
C(C(CO)(CC(C=O)(C)O)O)=O,,,5,1,1,0,1
55735_0,,,,2,2,1,3
C(C(CC(C(C)=O)O)(C(C)O)O)=O,,,5,1,1,0,1
55736_0,,,,2,2,1,3
55738_0,,,,2,2,1,3
C(C(CO)(CC(C(C)=O)O)O)=O,,,5,1,1,0,1
55740_0,,,,2,2,1,3
C(C(CC(C(C)=O)(C(C)O)O)O)=O,,,5,1,2,0,2
55742_0,,,,2,2,1,3
C(C(CC(C(O)=O)(C(C)=O)O)O)=O,,,5,1,2,0,2
55743_0,,,,2,2,1,3
55744_0,,,,2,2,1,3
55745_0,,,,2,2,1,3
55746_0,,,,2,2,1,3
55747_0,,,,2,2,1,3
55749_0,,,,2,2,1,3
C(C(C(CC=O)O)(CC(C)O)O)=O,,,5,1,1,0,1
55751_0,,,,2,2,1,3
C(C(C(C)O)(CC(C)O)O)=O,,,5,1,1,0,1
55753_0,,,,2,2,1,3
C(C(C(CCO)O)(CC(C)O)O)=O,,,5,1,1,0,1
55754_0,,,,2,2,1,3
55755_0,,,,2,2,1,3
55757_0,,,,2,2,1,3
C(C(C(C(O)O)O)(CC(C)O)O)=O,,,5,1,1,0,1
55759_0,,,,2,2,1,3
C(C(C(C(C)O)O)(CC(C)O)O)=O,,,5,1,1,0,1
55761_0,,,,2,2,1,3
C(C(CO)(CC(C)O)O)=O,,,5,1,1,0,1
55762_0,,,,2,2,1,3
55763_0,,,,2,2,1,3
55765_0,,,,2,2,1,3
C(C(C(C(CC(C)O)O)O)(O)O)=O,,,5,1,1,0,1
55767_0,,,,2,2,1,3
C(C(C)(C(C(CC(C)O)O)O)O)=O,,,5,1,1,0,1
55769_0,,,,2,2,1,3
[C](C(O)=O)(C(C(CC(C)O)O)O)O,,,5,1,2,0,2
55770_0,,,,2,2,1,3
55772_0,,,,2,2,1,3
C(C(C(C)O)(CC(CO)O)O)=O,,,5,1,1,0,1
55773_0,,,,2,2,1,3
55774_0,,,,2,2,1,3
55775_0,,,,2,2,1,3
55777_0,,,,2,2,1,3
C(C(C(C[C](C(O)=O)O)O)O)(O)=O,,,5,1,2,0,2
55779_0,,,,2,2,1,3
C(C(C(C[C](C(O)=O)O)O)(O)O)=O,,,5,1,2,0,2
55781_0,,,,2,2,1,3
C(C(C)(C(C[C](C(O)=O)O)O)O)=O,,,5,1,2,0,2
55783_0,,,,2,2,1,3
C([C](CC([C](C(O)=O)O)O)O)(O)=O,,,5,1,2,0,2
55784_0,,,,2,1,2,3
55784_1,,,,2,1,2,3
55785_0,,,,2,1,2,3
55785_1,,,,2,1,2,3
55786_0,,,,2,1,2,3
55786_1,,,,2,1,2,3
55787_0,,,,2,1,2,3
55787_1,,,,2,1,2,3
55788_0,,,,2,1,2,3
55788_1,,,,2,1,2,3
55789_0,,,,2,1,2,3
55789_1,,,,2,1,2,3
55790_0,,,,2,1,2,3
55790_1,,,,2,1,2,3
55791_0,,,,2,1,2,3
55791_1,,,,2,1,2,3
55792_0,,,,2,1,2,3
55793_0,,,,2,1,2,3
55794_0,,,,2,1,2,3
55795_0,,,,2,1,2,3
55796_0,,,,2,1,2,3
55797_0,,,,2,1,2,3
55798_0,,,,2,1,2,3
55799_0,,,,2,1,2,3
55800_0,,,,2,1,2,3
55801_0,,,,2,1,2,3
55802_0,,,,2,1,2,3
55803_0,,,,2,1,2,3
55804_0,,,,2,1,2,3
55805_0,,,,2,1,2,3
55806_0,,,,2,1,2,3
55807_0,,,,2,1,2,3
55807_1,,,,2,1,2,3
55808_0,,,,2,1,2,3
55808_1,,,,2,1,2,3
55809_0,,,,2,1,2,3
55809_1,,,,2,1,2,3
55810_0,,,,2,1,2,3
55810_1,,,,2,1,2,3
55811_0,,,,2,1,2,3
55811_1,,,,2,1,2,3
55812_0,,,,2,1,2,3
55812_1,,,,2,1,2,3
55813_0,,,,2,1,1,2
55813_1,,,,2,1,1,2
55814_0,,,,2,1,1,2
55814_1,,,,2,1,1,2
55815_0,,,,2,1,1,2
55815_1,,,,2,1,1,2
55816_0,,,,2,1,1,2
55816_1,,,,2,1,1,2
55817_0,,,,2,1,1,2
55817_1,,,,2,1,1,2
55818_0,,,,2,1,1,2
55818_1,,,,2,1,1,2
55819_0,,,,2,1,1,2
55819_1,,,,2,1,1,2
55820_0,,,,2,1,1,2
55820_1,,,,2,1,1,2
55821_0,,,,2,1,1,2
55821_1,,,,2,1,1,2
55823_0,,,,2,1,1,2
C(CC(CC(C)O)O)(OCC=O)=O,,,5,1,1,0,1
55824_0,,,,2,1,2,3
55825_0,,,,2,1,2,3
55825_1,,,,2,1,2,3
55826_0,,,,2,1,2,3
55826_1,,,,2,1,2,3
55827_0,,,,2,1,2,3
55828_0,,,,2,1,2,3
55829_0,,,,2,1,2,3
55829_1,,,,2,1,2,3
55830_0,,,,2,1,2,3
55830_1,,,,2,1,2,3
55832_0,,,,2,1,1,2
C(CC(CCO)O)(OCC=O)=O,,,5,1,1,0,1
55833_0,,,,2,1,2,3
55834_0,,,,2,1,1,2
55834_1,,,,2,1,1,2
55835_0,,,,2,1,2,3
55835_1,,,,2,1,2,3
55836_0,,,,2,1,2,3
55836_1,,,,2,1,2,3
55837_0,,,,2,1,2,3
55837_1,,,,2,1,2,3
55839_0,,,,2,1,1,2
C(CC(C(C=O)O)O)(OCC=O)=O,,,5,1,1,0,1
55840_0,,,,2,1,2,3
55841_0,,,,2,1,2,3
55842_0,,,,2,1,2,3
55843_0,,,,2,1,2,3
55843_1,,,,2,1,2,3
55844_0,,,,2,1,2,3
55844_1,,,,2,1,2,3
55846_0,,,,2,1,1,2
C(CC(C)(CO)O)(OCC=O)=O,,,5,1,1,0,1
55847_0,,,,2,1,2,3
55848_0,,,,2,1,1,2
55848_1,,,,2,1,1,2
55849_0,,,,2,1,2,3
55849_1,,,,2,1,2,3
55850_0,,,,2,1,2,3
55850_1,,,,2,1,2,3
55852_0,,,,2,1,1,2
C(C(C)(CC(OCC=O)=O)O)(O)=O,,,5,1,1,0,1
55853_0,,,,2,1,2,3
55855_0,,,,2,1,1,2
C(CC(CC(OCC=O)=O)O)(O)=O,,,5,1,1,0,1
55856_0,,,,2,1,2,3
55857_0,,,,2,1,2,3
55858_0,,,,2,1,2,3
55859_0,,,,2,1,2,3
55860_0,,,,2,1,2,3
55861_0,,,,2,1,2,3
55862_0,,,,2,1,2,3
55862_1,,,,2,1,2,3
55863_0,,,,2,1,2,3
55863_1,,,,2,1,2,3
55864_0,,,,2,1,2,3
55864_1,,,,2,1,2,3
55865_0,,,,2,1,2,3
55865_1,,,,2,1,2,3
55866_0,,,,2,1,2,3
55866_1,,,,2,1,2,3
55867_0,,,,2,1,2,3
55867_1,,,,2,1,2,3
55868_0,,,,2,1,2,3
55868_1,,,,2,1,2,3
55869_0,,,,2,1,2,3
55869_1,,,,2,1,2,3
55870_0,,,,2,1,2,3
55870_1,,,,2,1,2,3
55871_0,,,,2,1,2,3
55871_1,,,,2,1,2,3
55872_0,,,,2,1,2,3
55872_1,,,,2,1,2,3
55873_0,,,,2,1,2,3
55873_1,,,,2,1,2,3
55874_0,,,,2,1,2,3
55874_1,,,,2,1,2,3
55875_0,,,,2,1,2,3
55875_1,,,,2,1,2,3
55876_0,,,,2,1,2,3
55876_1,,,,2,1,2,3
55877_0,,,,2,1,2,3
55879_0,,,,2,1,1,2
C(C(C=C)(CC(OCC=O)=O)O)=O,,,5,1,1,0,1
55880_0,,,,2,1,2,3
55882_0,,,,2,1,1,2
C(CC(C(C=C)=O)O)(OCC=O)=O,,,5,1,1,0,1
55883_0,,,,2,1,2,3
55885_0,,,,2,1,1,2
C(CC(C=CC=O)O)(OCC=O)=O,,,5,1,1,0,1
55887_0,,,,2,1,1,2
C(CC(O)=O)(OCC=O)=O,,,5,1,1,0,1
55888_0,,,,2,1,2,3
55890_0,,,,2,1,1,2
C(CC(C(O)O)O)(OCC=O)=O,,,5,1,1,0,1
55891_0,,,,2,1,2,3
55893_0,,,,2,1,1,2
C(CC(C(C)O)O)(OCC=O)=O,,,5,1,1,0,1
55894_0,,,,2,1,2,3
55896_0,,,,2,1,1,2
C(CC(C(CO)O)O)(OCC=O)=O,,,5,1,1,0,1
55897_0,,,,2,1,2,3
55898_0,,,,2,1,1,2
55899_0,,,,2,1,2,3
55901_0,,,,2,1,1,2
C(CC(CO)(CO)O)(OCC=O)=O,,,5,1,1,0,1
55902_0,,,,2,1,2,3
55904_0,,,,2,1,1,2
C(CC(C(O)=O)O)(OCC=O)=O,,,5,1,1,0,1
55905_0,,,,2,1,2,3
55907_0,,,,2,1,1,2
C(C(C)(CC(OCC=O)=O)O)=O,,,5,1,1,0,1
55908_0,,,,2,1,2,3
55910_0,,,,2,1,1,2
C(CC(C(C)=O)O)(OCC=O)=O,,,5,1,1,0,1
55911_0,,,,2,1,2,3
55913_0,,,,2,1,1,2
C(CC(CC=O)O)(OCC=O)=O,,,5,1,1,0,1
55914_0,,,,2,1,2,3
55916_0,,,,2,1,1,2
C(CC(C)O)(OCC=O)=O,,,5,1,1,0,1
55917_0,,,,2,1,2,3
55919_0,,,,2,1,1,2
C(C(CO)(CC(OCC=O)=O)O)=O,,,5,1,1,0,1
55920_0,,,,2,1,2,3
55922_0,,,,2,1,1,2
C(CC(C(CO)=O)O)(OCC=O)=O,,,5,1,1,0,1
55923_0,,,,2,1,2,3
55925_0,,,,2,1,1,2
C(CCO)(OCC=O)=O,,,5,1,1,0,1
55926_0,,,,2,1,2,3
55928_0,,,,2,1,1,2
C(CC(CO)O)(OCC=O)=O,,,5,1,1,0,1
55929_0,,,,2,1,2,3
55929_1,,,,2,1,2,3
55930_0,,,,2,1,2,3
55930_1,,,,2,1,2,3
55931_0,,,,2,1,2,3
55931_1,,,,2,1,2,3
55932_0,,,,2,1,2,3
55932_1,,,,2,1,2,3
55933_0,,,,2,1,2,3
55933_1,,,,2,1,2,3
55934_0,,,,2,1,2,3
55934_1,,,,2,1,2,3
55935_0,,,,2,1,1,2
55935_1,,,,2,1,1,2
55936_0,,,,2,1,2,3
55936_1,,,,2,1,2,3
55937_0,,,,2,1,1,2
55937_1,,,,2,1,1,2
55938_0,,,,2,1,2,3
55938_1,,,,2,1,2,3
55939_0,,,,2,1,1,2
55939_1,,,,2,1,1,2
55940_0,,,,2,1,2,3
55940_1,,,,2,1,2,3
55941_0,,,,2,1,1,2
55941_1,,,,2,1,1,2
55942_0,,,,2,1,2,3
55942_1,,,,2,1,2,3
55943_0,,,,2,1,1,2
55943_1,,,,2,1,1,2
55944_0,,,,2,1,1,2
55944_1,,,,2,1,1,2
55945_0,,,,2,1,1,2
55945_1,,,,2,1,1,2
55946_0,,,,2,1,1,2
55946_1,,,,2,1,1,2
55947_0,,,,2,1,2,3
55948_0,,,,2,1,2,3
55948_1,,,,2,1,2,3
55949_0,,,,2,1,2,3
55949_1,,,,2,1,2,3
55950_0,,,,2,1,2,3
55950_1,,,,2,1,2,3
55951_0,,,,2,1,2,3
55951_1,,,,2,1,2,3
55952_0,,,,2,1,1,2
55952_1,,,,2,1,1,2
55953_0,,,,2,1,2,3
55953_1,,,,2,1,2,3
55954_0,,,,2,1,1,2
55954_1,,,,2,1,1,2
55955_0,,,,2,1,2,3
55955_1,,,,2,1,2,3
55956_0,,,,2,1,1,2
55956_1,,,,2,1,1,2
55957_0,,,,2,1,2,3
55957_1,,,,2,1,2,3
55958_0,,,,2,1,1,2
55958_1,,,,2,1,1,2
55959_0,,,,2,1,2,3
55959_1,,,,2,1,2,3
55960_0,,,,2,1,1,2
55960_1,,,,2,1,1,2
55961_0,,,,2,1,2,3
55961_1,,,,2,1,2,3
55962_0,,,,2,1,1,2
55962_1,,,,2,1,1,2
55963_0,,,,2,1,2,3
55963_1,,,,2,1,2,3
55964_0,,,,2,1,1,2
55964_1,,,,2,1,1,2
55965_0,,,,2,1,2,3
55965_1,,,,2,1,2,3
55966_0,,,,2,1,1,2
55966_1,,,,2,1,1,2
55967_0,,,,2,1,2,3
55967_1,,,,2,1,2,3
55968_0,,,,2,1,1,2
55968_1,,,,2,1,1,2
55969_0,,,,2,1,2,3
55969_1,,,,2,1,2,3
55970_0,,,,2,1,1,2
55970_1,,,,2,1,1,2
55971_0,,,,2,1,2,3
55971_1,,,,2,1,2,3
55972_0,,,,2,1,1,2
55972_1,,,,2,1,1,2
55973_0,,,,2,1,2,3
55973_1,,,,2,1,2,3
55974_0,,,,2,1,1,2
55974_1,,,,2,1,1,2
55975_0,,,,2,1,2,3
55975_1,,,,2,1,2,3
55976_0,,,,2,1,1,2
55976_1,,,,2,1,1,2
55977_0,,,,2,1,2,3
55977_1,,,,2,1,2,3
55978_0,,,,2,1,1,2
55978_1,,,,2,1,1,2
55979_0,,,,2,1,2,3
55980_0,,,,2,1,2,3
55981_0,,,,2,1,2,3
55982_0,,,,2,1,2,3
55983_0,,,,2,1,2,3
55984_0,,,,2,1,2,3
55985_0,,,,2,1,2,3
55985_1,,,,2,1,2,3
55986_0,,,,2,1,2,3
55986_1,,,,2,1,2,3
55987_0,,,,2,1,2,3
55987_1,,,,2,1,2,3
55988_0,,,,2,1,2,3
55988_1,,,,2,1,2,3
55989_0,,,,2,1,2,3
55989_1,,,,2,1,2,3
55990_0,,,,2,1,2,3
55990_1,,,,2,1,2,3
55991_0,,,,2,1,2,3
55991_1,,,,2,1,2,3
55992_0,,,,2,1,2,3
55992_1,,,,2,1,2,3
55994_0,,,,2,1,1,2
C(CCO)(OC(C=O)CO)=O,,,5,1,1,0,1
55995_0,,,,2,1,2,3
55997_0,,,,2,1,1,2
C(CCO)(OCC(C=O)O)=O,,,5,1,1,0,1
55998_0,,,,2,1,2,3
56000_0,,,,2,1,1,2
C(C(CO)O)(OC(C(C)=O)O)=O,,,5,1,2,0,2
56000_1,,,,2,1,1,2
56001_0,,,,2,1,2,3
56001_1,,,,2,1,2,3
56003_0,,,,2,1,1,2
C(C(COC(C(C)=O)O)O)(O)=O,,,5,1,2,0,2
56003_1,,,,2,1,1,2
56005_0,,,,2,1,1,2
C(C(CO)O)(OC(C=O)(C)O)=O,,,5,1,2,0,2
56005_1,,,,2,1,1,2
56006_0,,,,2,1,2,3
56006_1,,,,2,1,2,3
56008_0,,,,2,1,1,2
C(C(COC(C=O)(C)O)O)(O)=O,,,5,1,2,0,2
56008_1,,,,2,1,1,2
56010_0,,,,2,1,1,2
C(CC(OC(C(O)=O)CO)O)=O,,,5,1,2,0,2
56010_1,,,,2,1,1,2
56011_0,,,,2,1,2,3
56011_1,,,,2,1,2,3
56013_0,,,,2,1,1,2
C(C(CO)O)(OC(C(CO)=O)O)=O,,,5,1,2,0,2
56013_1,,,,2,1,1,2
56014_0,,,,2,1,2,3
56014_1,,,,2,1,2,3
56016_0,,,,2,1,1,2
C(C(COC(C(CO)=O)O)O)(O)=O,,,5,1,2,0,2
56016_1,,,,2,1,1,2
56018_0,,,,2,1,1,2
C(C(CO)O)(OC(C=O)(CO)O)=O,,,5,1,2,0,2
56018_1,,,,2,1,1,2
56019_0,,,,2,1,2,3
56019_1,,,,2,1,2,3
56021_0,,,,2,1,1,2
C(C(COC(C=O)(CO)O)O)(O)=O,,,5,1,2,0,2
56021_1,,,,2,1,1,2
56023_0,,,,2,1,1,2
C(C(C(C)OC(C=O)O)O)(O)=O,,,5,1,2,0,2
56023_1,,,,2,1,1,2
56025_0,,,,2,1,1,2
C(C(C(C=O)OC(C=O)O)O)(O)=O,,,5,1,2,0,2
56025_1,,,,2,1,1,2
56027_0,,,,2,1,1,2
C(CC(O)OC(C(CO)O)=O)=O,,,5,1,2,0,2
56027_1,,,,2,1,1,2
56028_0,,,,2,1,2,3
56028_1,,,,2,1,2,3
56030_0,,,,2,1,1,2
C(CC(O)OCC(C(O)=O)O)=O,,,5,1,2,0,2
56030_1,,,,2,1,1,2
56031_0,,,,2,1,2,3
56031_1,,,,2,1,2,3
56033_0,,,,2,1,1,2
C(C(CO)O)(OCC(CO)=O)=O,,,5,1,2,0,2
56033_1,,,,2,1,1,2
56035_0,,,,2,1,1,2
C(C(CO)O)(OC(C=O)=O)=O,,,5,1,2,0,2
56035_1,,,,2,1,1,2
56036_0,,,,2,1,2,3
56036_1,,,,2,1,2,3
56038_0,,,,2,1,1,2
C(C(COC(C=O)=O)O)(O)=O,,,5,1,2,0,2
56038_1,,,,2,1,1,2
56040_0,,,,2,1,1,2
C(C(CO)O)(OCC(C=O)=O)=O,,,5,1,4,0,4
56040_1,,,,2,1,1,2
56041_0,,,,2,1,2,3
56041_1,,,,2,1,2,3
56042_0,,,,2,1,1,2
56042_1,,,,2,1,1,2
56043_0,,,,2,1,2,3
56043_1,,,,2,1,2,3
56044_0,,,,2,1,2,3
56045_0,,,,2,1,2,3
56046_0,,,,2,1,2,3
56047_0,,,,2,1,2,3
56048_0,,,,2,1,2,3
56049_0,,,,2,1,2,3
56050_0,,,,2,1,2,3
56051_0,,,,2,1,2,3
56052_0,,,,2,1,2,3
56053_0,,,,2,1,2,3
56054_0,,,,2,1,2,3
56055_0,,,,2,1,2,3
56056_0,,,,2,1,2,3
56057_0,,,,2,1,2,3
56058_0,,,,2,1,2,3
56059_0,,,,2,1,2,3
56060_0,,,,2,1,2,3
56061_0,,,,2,1,2,3
56062_0,,,,2,1,2,3
56063_0,,,,2,1,2,3
56064_0,,,,2,1,2,3
56065_0,,,,2,1,2,3
56066_0,,,,2,1,2,3
56067_0,,,,2,1,2,3
56068_0,,,,2,1,2,3
56069_0,,,,2,1,2,3
56070_0,,,,2,1,2,3
56071_0,,,,2,1,2,3
56072_0,,,,2,1,2,3
56073_0,,,,2,1,2,3
56074_0,,,,2,1,2,3
56075_0,,,,2,1,2,3
56076_0,,,,2,1,2,3
56077_0,,,,2,1,2,3
56078_0,,,,2,1,2,3
56079_0,,,,2,1,2,3
56080_0,,,,2,1,2,3
56081_0,,,,2,1,2,3
56082_0,,,,2,1,2,3
56083_0,,,,2,1,2,3
56084_0,,,,2,1,2,3
56085_0,,,,2,1,2,3
56086_0,,,,2,1,2,3
56087_0,,,,2,1,2,3
56088_0,,,,2,1,2,3
56089_0,,,,2,1,2,3
56090_0,,,,2,1,2,3
56091_0,,,,2,1,2,3
56092_0,,,,2,1,2,3
56093_0,,,,2,1,2,3
56094_0,,,,2,1,2,3
56095_0,,,,2,1,2,3
56096_0,,,,2,1,2,3
56097_0,,,,2,1,2,3
56098_0,,,,2,1,2,3
56099_0,,,,2,1,2,3
56100_0,,,,2,1,2,3
56101_0,,,,2,1,2,3
56102_0,,,,2,1,2,3
56103_0,,,,2,1,2,3
56104_0,,,,2,1,2,3
56105_0,,,,2,1,2,3
56106_0,,,,2,1,2,3
56107_0,,,,2,1,2,3
56108_0,,,,2,1,2,3
56109_0,,,,2,1,2,3
56110_0,,,,2,1,2,3
56111_0,,,,2,1,2,3
56112_0,,,,2,1,2,3
56113_0,,,,2,1,2,3
56114_0,,,,2,1,2,3
56115_0,,,,2,1,2,3
56116_0,,,,2,1,2,3
56117_0,,,,2,1,2,3
56118_0,,,,2,1,2,3
56119_0,,,,2,1,2,3
56120_0,,,,2,1,2,3
56121_0,,,,2,1,2,3
56122_0,,,,2,1,2,3
56123_0,,,,2,1,2,3
56124_0,,,,2,1,2,3
56125_0,,,,2,1,2,3
56126_0,,,,2,1,2,3
56127_0,,,,2,1,2,3
56128_0,,,,2,1,2,3
56129_0,,,,2,1,2,3
56130_0,,,,2,1,2,3
56131_0,,,,2,1,2,3
56132_0,,,,2,1,2,3
56133_0,,,,2,1,2,3
56134_0,,,,2,1,2,3
56135_0,,,,2,1,2,3
56136_0,,,,2,1,2,3
56137_0,,,,2,1,2,3
56138_0,,,,2,1,2,3
56139_0,,,,2,1,1,2
56140_0,,,,2,1,2,3
56141_0,,,,2,1,2,3
56142_0,,,,2,1,2,3
56143_0,,,,2,1,2,3
56144_0,,,,2,1,2,3
56145_0,,,,2,1,2,3
56146_0,,,,2,1,2,3
56147_0,,,,2,1,2,3
56148_0,,,,2,1,2,3
56149_0,,,,2,1,2,3
56150_0,,,,2,1,2,3
56151_0,,,,2,1,2,3
56152_0,,,,2,1,2,3
56153_0,,,,2,1,2,3
56154_0,,,,2,1,2,3
56155_0,,,,2,1,2,3
56156_0,,,,2,1,2,3
56157_0,,,,2,1,2,3
56158_0,,,,2,1,2,3
56159_0,,,,2,1,2,3
56160_0,,,,2,1,2,3
56161_0,,,,2,1,2,3
56162_0,,,,2,1,2,3
56163_0,,,,2,1,2,3
56164_0,,,,2,1,2,3
56165_0,,,,2,1,2,3
56166_0,,,,2,1,2,3
56167_0,,,,2,1,2,3
56168_0,,,,2,1,2,3
56169_0,,,,2,1,2,3
56170_0,,,,2,1,2,3
56171_0,,,,2,1,2,3
56172_0,,,,2,1,2,3
56173_0,,,,2,1,2,3
56174_0,,,,2,1,2,3
56175_0,,,,2,1,2,3
56176_0,,,,2,1,2,3
56177_0,,,,2,1,2,3
56178_0,,,,2,1,2,3
56179_0,,,,2,1,2,3
56180_0,,,,2,1,2,3
56181_0,,,,2,1,2,3
56182_0,,,,2,1,2,3
56183_0,,,,2,1,2,3
56184_0,,,,2,1,2,3
56185_0,,,,2,1,2,3
56186_0,,,,2,1,2,3
56187_0,,,,2,1,2,3
56188_0,,,,2,1,2,3
56189_0,,,,2,1,2,3
56190_0,,,,2,1,2,3
56191_0,,,,2,1,2,3
56192_0,,,,2,1,2,3
56193_0,,,,2,1,2,3
56194_0,,,,2,1,2,3
56195_0,,,,2,1,2,3
56196_0,,,,2,1,2,3
56197_0,,,,2,1,2,3
56198_0,,,,2,1,2,3
56199_0,,,,2,1,2,3
56200_0,,,,2,1,2,3
56201_0,,,,2,1,2,3
56202_0,,,,2,1,2,3
56203_0,,,,2,1,2,3
56204_0,,,,2,1,2,3
56205_0,,,,2,1,2,3
56206_0,,,,2,1,2,3
56207_0,,,,2,1,2,3
56208_0,,,,2,1,2,3
56209_0,,,,2,1,2,3
56210_0,,,,2,1,2,3
56211_0,,,,2,1,2,3
56212_0,,,,2,1,2,3
56213_0,,,,2,1,2,3
56214_0,,,,2,1,2,3
56215_0,,,,2,1,2,3
56216_0,,,,2,1,2,3
56217_0,,,,2,1,2,3
56218_0,,,,2,1,2,3
56219_0,,,,2,1,2,3
56220_0,,,,2,1,2,3
56221_0,,,,2,1,2,3
56222_0,,,,2,1,2,3
56223_0,,,,2,1,2,3
56224_0,,,,2,1,2,3
56225_0,,,,2,1,2,3
56226_0,,,,2,1,2,3
56227_0,,,,2,1,2,3
56228_0,,,,2,1,2,3
56229_0,,,,2,1,2,3
56230_0,,,,2,1,2,3
56231_0,,,,2,1,2,3
56232_0,,,,2,1,2,3
56233_0,,,,2,1,2,3
56234_0,,,,2,1,2,3
56235_0,,,,2,1,2,3
56236_0,,,,2,1,2,3
56237_0,,,,2,1,2,3
56238_0,,,,2,1,2,3
56239_0,,,,2,1,2,3
56240_0,,,,2,1,2,3
56241_0,,,,2,1,2,3
56242_0,,,,2,1,2,3
56243_0,,,,2,1,2,3
56244_0,,,,2,1,2,3
56245_0,,,,2,1,2,3
56246_0,,,,2,1,2,3
56247_0,,,,2,1,2,3
56248_0,,,,2,1,2,3
56249_0,,,,2,1,2,3
56250_0,,,,2,1,2,3
56251_0,,,,2,1,2,3
56252_0,,,,2,1,2,3
56253_0,,,,2,1,2,3
56254_0,,,,2,1,2,3
56255_0,,,,2,1,2,3
56256_0,,,,2,1,2,3
56257_0,,,,2,1,2,3
56258_0,,,,2,1,2,3
56259_0,,,,2,1,2,3
56260_0,,,,2,1,2,3
56261_0,,,,2,1,2,3
56262_0,,,,2,1,2,3
56263_0,,,,2,1,2,3
56264_0,,,,2,1,2,3
56265_0,,,,2,1,2,3
56266_0,,,,2,1,2,3
56267_0,,,,2,1,2,3
56268_0,,,,2,1,2,3
56269_0,,,,2,1,2,3
56270_0,,,,2,1,2,3
56271_0,,,,2,1,2,3
56272_0,,,,2,1,2,3
56273_0,,,,2,1,2,3
56274_0,,,,2,1,2,3
56275_0,,,,2,1,2,3
56276_0,,,,2,1,2,3
56277_0,,,,2,1,2,3
56278_0,,,,2,1,2,3
56279_0,,,,2,1,2,3
56280_0,,,,2,1,2,3
56281_0,,,,2,1,2,3
56282_0,,,,2,1,2,3
56283_0,,,,2,1,2,3
56284_0,,,,2,1,2,3
56285_0,,,,2,1,2,3
56286_0,,,,2,1,2,3
56287_0,,,,2,1,2,3
56288_0,,,,2,1,2,3
56289_0,,,,2,1,2,3
56290_0,,,,2,1,2,3
56291_0,,,,2,1,2,3
56292_0,,,,2,1,2,3
56293_0,,,,2,1,2,3
56294_0,,,,2,1,2,3
56295_0,,,,2,1,2,3
56296_0,,,,2,1,2,3
56297_0,,,,2,1,2,3
56298_0,,,,2,1,2,3
56299_0,,,,2,1,2,3
56300_0,,,,2,1,2,3
56301_0,,,,2,1,2,3
56302_0,,,,2,1,2,3
56303_0,,,,2,1,2,3
56304_0,,,,2,1,2,3
56305_0,,,,2,1,2,3
56306_0,,,,2,1,2,3
56307_0,,,,2,1,2,3
56308_0,,,,2,1,2,3
56309_0,,,,2,1,2,3
56310_0,,,,2,1,2,3
56311_0,,,,2,1,2,3
56312_0,,,,2,1,2,3
56313_0,,,,2,1,2,3
56314_0,,,,2,1,2,3
56315_0,,,,2,1,2,3
56316_0,,,,2,1,2,3
56317_0,,,,2,1,2,3
56318_0,,,,2,1,2,3
56319_0,,,,2,1,2,3
56320_0,,,,2,1,2,3
56321_0,,,,2,1,2,3
56322_0,,,,2,1,2,3
56323_0,,,,2,1,2,3
56324_0,,,,2,1,2,3
56325_0,,,,2,1,2,3
56326_0,,,,2,1,2,3
56327_0,,,,2,1,2,3
56329_0,,,,2,1,1,2
C(CO)(OC(C=O)CC=O)=O,,,5,1,3,0,3
56331_0,,,,2,1,1,2
C(C(C(C)=O)OC(CO)=O)=O,,,5,1,3,0,3
56333_0,,,,2,1,1,2
C(CO)(OCCC(C=O)=O)=O,,,5,1,3,0,3
56335_0,,,,2,1,1,2
C(CC(COC(CO)=O)=O)=O,,,5,1,3,0,3
56336_0,,,,2,1,2,3
56337_0,,,,2,1,2,3
56338_0,,,,2,1,1,2
56339_0,,,,2,1,1,2
56341_0,,,,2,1,1,2
C(CO)(OC(C=O)(CC=O)O)=O,,,5,1,1,0,1
56343_0,,,,2,1,1,2
C(COC(C(C=O)=O)O)(O)=O,,,5,1,1,0,1
56345_0,,,,2,1,1,2
C(C(C=O)(O)OC(CO)=O)=O,,,5,1,1,0,1
56347_0,,,,2,1,1,2
C(CO)(OC(C(CO)=O)O)=O,,,5,1,1,0,1
56349_0,,,,2,1,1,2
C(CO)(OC(C(C(CO)O)=O)O)=O,,,5,1,1,0,1
56351_0,,,,2,1,1,2
C(C(C(C(O)OC(CO)=O)=O)O)=O,,,5,1,1,0,1
56353_0,,,,2,1,1,2
C(COC(C(C(C=O)=O)O)O)(O)=O,,,5,1,1,0,1
56355_0,,,,2,1,1,2
C(CO)(C(CO)(O)OC(CO)=O)=O,,,5,1,1,0,1
56357_0,,,,2,1,1,2
C(CO)(OC(C(C(C)=O)=O)O)=O,,,5,1,1,0,1
56359_0,,,,2,1,1,2
C(CO)(OC(C(C=O)=O)(C)O)=O,,,5,1,1,0,1
56361_0,,,,2,1,1,2
C(COC(C(C(CO)=O)=O)O)(O)=O,,,5,1,1,0,1
56363_0,,,,2,1,1,2
C(C(C(CO)=O)(O)OC(CO)=O)=O,,,5,1,1,0,1
56365_0,,,,2,1,1,2
C(CO)(OC(C(C(C)O)=O)O)=O,,,5,1,1,0,1
56367_0,,,,2,1,1,2
C(COC(CC(C=O)=O)O)(O)=O,,,5,1,2,0,2
56369_0,,,,2,1,1,2
C(CC(C(O)OC(CO)=O)=O)=O,,,5,1,1,0,1
56371_0,,,,2,1,1,2
C(C(C)O)(OC(C(C)=O)O)=O,,,5,1,1,0,1
56373_0,,,,2,1,1,2
C(C(CCO)O)(OC(C(C)=O)O)=O,,,5,1,1,0,1
56375_0,,,,2,1,1,2
C(CO)(OC(C(C)=O)O)=O,,,5,1,1,0,1
56377_0,,,,2,1,1,2
C(C(C)O)(OC(C=O)(C)O)=O,,,5,1,1,0,1
56379_0,,,,2,1,1,2
C(C(CCO)O)(OC(C=O)(C)O)=O,,,5,1,1,0,1
56381_0,,,,2,1,1,2
C(C(C)(O)OC(CO)=O)=O,,,5,1,1,0,1
56383_0,,,,2,1,1,2
C(CC(OC(C(O)=O)C)O)=O,,,5,1,1,0,1
56385_0,,,,2,1,1,2
C(CC(OC(C(O)=O)CCO)O)=O,,,5,1,1,0,1
56387_0,,,,2,1,1,2
C(CC(OCC(O)=O)O)=O,,,5,1,1,0,1
56389_0,,,,2,1,1,2
C(C(C)O)(OC(C(CCO)=O)O)=O,,,5,1,1,0,1
56391_0,,,,2,1,1,2
C(CO)(OC(C(CCO)=O)O)=O,,,5,1,1,0,1
56393_0,,,,2,1,1,2
C(C(C)O)(OC(C=O)(CCO)O)=O,,,5,1,1,0,1
56395_0,,,,2,1,1,2
C(C(CCO)(O)OC(CO)=O)=O,,,5,1,1,0,1
56397_0,,,,2,1,1,2
C(CC(CO)(OC(C(O)=O)C)O)=O,,,5,1,1,0,1
56399_0,,,,2,1,1,2
C(CC(CO)(OCC(O)=O)O)=O,,,5,1,1,0,1
56401_0,,,,2,1,1,2
C(C(C)OC(CC(CO)=O)O)(O)=O,,,5,1,1,0,1
56403_0,,,,2,1,1,2
C(CO)(CC(OCC(O)=O)O)=O,,,5,1,1,0,1
56405_0,,,,2,1,1,2
C(C(C(C)(OC(C(O)=O)C)O)O)=O,,,5,1,1,0,1
56407_0,,,,2,1,1,2
C(C(C(C)(OCC(O)=O)O)O)=O,,,5,1,1,0,1
56409_0,,,,2,1,1,2
C(C(C)OC(C(C(C)=O)O)O)(O)=O,,,5,1,1,0,1
56411_0,,,,2,1,1,2
C(C)(C(C(OCC(O)=O)O)O)=O,,,5,1,1,0,1
56413_0,,,,2,1,1,2
C(C(C)O)(OC(C(CO)=O)O)=O,,,5,1,1,0,1
56415_0,,,,2,1,1,2
C(C(C)O)(OC(C=O)(CO)O)=O,,,5,1,1,0,1
56417_0,,,,2,1,1,2
C(C(C)O)(OC(C=O)O)=O,,,5,1,1,0,1
56419_0,,,,2,1,1,2
C(C(CCO)O)(OC(C=O)O)=O,,,5,1,1,0,1
56420_0,,,,2,1,2,3
56421_0,,,,2,1,1,2
56422_0,,,,2,1,1,2
56423_0,,,,2,1,1,2
56425_0,,,,2,1,1,2
C(CO)(OC(C(C=O)=O)O)=O,,,5,1,1,0,1
56427_0,,,,2,1,1,2
C(C(CC(OCC(O)=O)O)O)=O,,,5,1,1,0,1
56428_0,,,,2,1,1,2
56430_0,,,,2,1,1,2
C(CO)(OC(C(C(C=O)=O)O)O)=O,,,5,1,1,0,1
56432_0,,,,2,1,1,2
C(CO)(OC(C(C(CO)=O)=O)O)=O,,,5,1,1,0,1
56434_0,,,,2,1,1,2
C(CO)(OC(CC(C=O)=O)O)=O,,,5,1,2,0,2
56436_0,,,,2,1,1,2
C(C(CCOC(C(C)=O)O)O)(O)=O,,,5,1,1,0,1
56438_0,,,,2,1,1,2
C(C(CCOC(C=O)(C)O)O)(O)=O,,,5,1,1,0,1
56440_0,,,,2,1,1,2
C(CC(O)OC(C(C)O)=O)=O,,,5,1,1,0,1
56442_0,,,,2,1,1,2
C(CC(O)OC(C(CCO)O)=O)=O,,,5,1,1,0,1
56444_0,,,,2,1,1,2
C(CC(O)OC(CO)=O)=O,,,5,1,1,0,1
56446_0,,,,2,1,1,2
C(C(CC(OC(C(O)=O)C)O)O)=O,,,5,1,1,0,1
56448_0,,,,2,1,1,2
C(CC(C(OC(C(O)=O)C)O)O)=O,,,5,1,1,0,1
56450_0,,,,2,1,1,2
C(CC(C(OCC(O)=O)O)O)=O,,,5,1,1,0,1
56452_0,,,,2,1,1,2
C(CC(CO)(O)OC(C(C)O)=O)=O,,,5,1,1,0,1
56454_0,,,,2,1,1,2
C(CC(CO)(O)OC(CO)=O)=O,,,5,1,1,0,1
56456_0,,,,2,1,1,2
C(C(C)O)(OC(CC(CO)=O)O)=O,,,5,1,1,0,1
56458_0,,,,2,1,1,2
C(CO)(CC(O)OC(CO)=O)=O,,,5,1,1,0,1
56460_0,,,,2,1,1,2
C(C(C)O)(OC(C)(C(C=O)O)O)=O,,,5,1,1,0,1
56462_0,,,,2,1,1,2
C(C(C(C)(O)OC(CO)=O)O)=O,,,5,1,1,0,1
56464_0,,,,2,1,1,2
C(C(C)O)(OC(C(C(C)=O)O)O)=O,,,5,1,1,0,1
56466_0,,,,2,1,1,2
C(C)(C(C(O)OC(CO)=O)O)=O,,,5,1,1,0,1
56468_0,,,,2,1,1,2
C(C(CCOC(C=O)O)O)(O)=O,,,5,1,2,0,2
56469_0,,,,2,1,1,2
56470_0,,,,2,1,1,2
56472_0,,,,2,1,1,2
C(C(CC(O)OC(CO)=O)O)=O,,,5,1,1,0,1
56473_0,,,,2,1,1,2
56475_0,,,,2,1,1,2
C(CC(O)OCCC(C(O)=O)O)=O,,,5,1,1,0,1
56477_0,,,,2,1,1,2
C(C(C)O)(OC(CC(C=O)O)O)=O,,,5,1,1,0,1
56479_0,,,,2,1,1,2
C(CC(C(O)OC(C(C)O)=O)O)=O,,,5,1,1,0,1
56480_0,,,,2,1,1,2
56481_0,,,,2,1,1,2
56483_0,,,,2,1,1,2
C(CO)(OCC(C=O)=O)=O,,,5,1,3,0,3
56485_0,,,,2,1,1,2
C(CO)(OC(C(C=O)=O)CO)=O,,,5,1,3,0,3
56487_0,,,,2,1,1,2
C(CO)(OC(C=O)=O)=O,,,5,1,2,0,2
56489_0,,,,2,1,1,2
C(C(C(C=O)=O)OC(CO)=O)=O,,,5,1,1,0,1
56491_0,,,,2,1,1,2
C(CO)(OCC(C(CO)=O)=O)=O,,,5,1,2,0,2
56493_0,,,,2,1,1,2
C(CO)(OC(C(CO)=O)=O)=O,,,5,1,1,0,1
56495_0,,,,2,1,1,2
C(CO)(OCC(C(O)=O)=O)=O,,,5,1,1,0,1
56497_0,,,,2,1,1,2
C(CO)(OCC(C(C=O)=O)=O)=O,,,5,1,1,0,1
56499_0,,,,2,1,1,2
C(CO)(OC(C(C=O)=O)C)=O,,,5,1,1,0,1
56501_0,,,,2,1,1,2
C(C(C)O)(OCC(CO)=O)=O,,,5,1,1,0,1
56502_0,,,,2,1,1,2
56504_0,,,,2,1,1,2
C(CO)(OCC(C(CO)O)=O)=O,,,5,1,1,0,1
56505_0,,,,2,1,1,2
56507_0,,,,2,1,1,2
C(C(C)O)(OC(C=O)=O)=O,,,5,1,1,0,1
56509_0,,,,2,1,1,2
C(CO)(OC(C(C)=O)=O)=O,,,5,1,1,0,1
56511_0,,,,2,1,1,2
C(C(CCO)O)(OC(C=O)=O)=O,,,5,1,1,0,1
56513_0,,,,2,1,1,2
C(CO)(OC(C(CCO)=O)=O)=O,,,5,1,1,0,1
56514_0,,,,2,1,1,2
56516_0,,,,2,1,1,2
C(C(C)O)(OC(C=O)CC=O)=O,,,5,1,2,0,2
56518_0,,,,2,1,1,2
C(C(C)O)(OCC(CC=O)=O)=O,,,5,1,2,0,2
56519_0,,,,2,1,1,2
56521_0,,,,2,1,1,2
C(C(C)O)(OC(C=O)C(C)=O)=O,,,5,1,2,0,2
56522_0,,,,2,1,1,2
56523_0,,,,2,1,1,2
56525_0,,,,2,1,1,2
C(C(C)O)(OCC(C=O)=O)=O,,,5,1,2,0,2
56527_0,,,,2,1,1,2
C(C(C)O)(OC(C=O)CO)=O,,,5,1,1,0,1
56529_0,,,,2,1,1,2
C(C(C)O)(OCC=O)=O,,,5,1,1,0,1
56531_0,,,,2,1,1,2
C(C(CCO)O)(OCC=O)=O,,,5,1,1,0,1
56532_0,,,,2,1,1,2
56533_0,,,,2,1,1,2
56534_0,,,,2,1,1,2
56536_0,,,,2,1,1,2
C(CO)(OCC(C(C=O)=O)O)=O,,,5,1,3,0,3
56537_0,,,,2,1,1,2
56538_0,,,,2,1,1,2
56540_0,,,,2,1,1,2
C(C(CCOC(C=O)=O)O)(O)=O,,,5,1,1,0,1
56542_0,,,,2,1,1,2
C(CO)(OCCC(C(O)=O)=O)=O,,,5,1,1,0,1
56543_0,,,,2,1,1,2
56545_0,,,,2,1,1,2
C(C(C)O)(OCCC(C=O)=O)=O,,,5,1,2,0,2
56546_0,,,,2,1,1,2
56547_0,,,,2,1,1,2
56548_0,,,,2,1,1,2
56549_0,,,,2,1,1,2
56551_0,,,,2,1,1,2
C(C(C)O)(OCC(C=O)O)=O,,,5,1,1,0,1
56552_0,,,,2,1,1,2
56553_0,,,,2,1,1,2
56554_0,,,,2,1,1,2
56555_0,,,,2,1,2,3
56556_0,,,,2,1,2,3
56557_0,,,,2,1,2,3
56558_0,,,,2,1,2,3
56559_0,,,,2,1,2,3
56560_0,,,,2,1,2,3
56561_0,,,,2,1,2,3
56562_0,,,,2,1,2,3
56563_0,,,,2,1,2,3
56565_0,,,,2,1,1,2
C(CCC(C(OCC=O)=O)O)(O)=O,,,5,1,2,0,2
56567_0,,,,2,1,1,2
C(CCC(C=O)OC(CO)=O)(O)=O,,,5,1,2,0,2
56569_0,,,,2,1,1,2
C(CO)(OCC(CCC(O)=O)=O)=O,,,5,1,1,0,1
56570_0,,,,2,1,2,3
56571_0,,,,2,1,2,3
56572_0,,,,2,1,2,3
56573_0,,,,2,1,2,3
56574_0,,,,2,1,2,3
56575_0,,,,2,1,2,3
56576_0,,,,2,1,2,3
56577_0,,,,2,1,2,3
56579_0,,,,2,1,2,3
C1(C(C)C(C(C1O)=O)O)=O,,,5,1,1,0,1
56580_0,,,,2,1,2,3
56581_0,,,,2,1,2,3
56582_0,,,,2,1,2,3
56583_0,,,,2,1,2,3
56584_0,,,,2,1,2,3
56586_0,,,,2,1,2,3
C1(C(CO)CC(C1O)=O)=O,,,5,1,2,0,2
56587_0,,,,2,1,2,3
56588_0,,,,2,1,2,3
56589_0,,,,2,1,2,3
56591_0,,,,2,1,2,3
C1(C(CCO)C(C(C1O)=O)O)=O,,,5,1,1,0,1
56592_0,,,,2,1,2,3
56593_0,,,,2,1,2,3
56594_0,,,,2,1,2,3
56595_0,,,,2,1,2,3
56596_0,,,,2,1,2,3
56598_0,,,,2,1,2,3
C1(C(CO)C(C(C1O)=O)CO)=O,,,5,1,1,0,1
56599_0,,,,2,1,2,3
56600_0,,,,2,1,2,3
56601_0,,,,2,1,2,3
56602_0,,,,2,1,2,3
56603_0,,,,2,1,2,3
56604_0,,,,2,1,2,3
56605_0,,,,2,1,2,3
56606_0,,,,2,1,2,3
56607_0,,,,2,1,2,3
56608_0,,,,2,1,2,3
56609_0,,,,2,1,2,3
56610_0,,,,2,1,2,3
56611_0,,,,2,1,2,3
56612_0,,,,2,1,2,3
56613_0,,,,2,1,2,3
56614_0,,,,2,1,2,3
56615_0,,,,2,1,2,3
56616_0,,,,2,1,2,3
56618_0,,,,2,1,2,3
C1(C(CC(C(C1CO)O)O)=O)=O,,,5,1,1,0,1
56619_0,,,,2,1,2,3
56620_0,,,,2,1,2,3
56621_0,,,,2,1,2,3
56622_0,,,,2,1,2,3
56623_0,,,,2,1,2,3
56624_0,,,,2,1,2,3
56625_0,,,,2,1,2,3
56626_0,,,,2,1,2,3
56627_0,,,,2,1,2,3
56628_0,,,,2,1,2,3
56629_0,,,,2,1,2,3
56630_0,,,,2,1,2,3
56631_0,,,,2,1,2,3
56632_0,,,,2,1,2,3
56633_0,,,,2,1,2,3
56634_0,,,,2,1,2,3
56635_0,,,,2,1,2,3
56636_0,,,,2,1,2,3
56637_0,,,,2,1,2,3
56638_0,,,,2,1,2,3
56639_0,,,,2,1,2,3
56640_0,,,,2,1,2,3
56641_0,,,,2,1,2,3
56642_0,,,,2,1,2,3
56643_0,,,,2,1,2,3
56645_0,,,,2,1,2,3
C1(C(C(CO)O)CC(C1O)=O)=O,,,5,1,1,0,1
56646_0,,,,2,1,2,3
56647_0,,,,2,1,2,3
56648_0,,,,2,1,2,3
56649_0,,,,2,1,2,3
56650_0,,,,2,1,2,3
56651_0,,,,2,1,2,3
56652_0,,,,2,1,2,3
56653_0,,,,2,1,2,3
56654_0,,,,2,1,2,3
56655_0,,,,2,1,2,3
56657_0,,,,2,1,2,3
C1(C(C=O)C(C(C1O)=O)C)=O,,,5,1,1,0,1
56658_0,,,,2,1,2,3
56660_0,,,,2,1,2,3
C1(C(C)C(C(C1C=O)=O)O)=O,,,5,1,1,0,1
56661_0,,,,2,1,2,3
56662_0,,,,2,1,2,3
56663_0,,,,2,1,2,3
56664_0,,,,2,1,2,3
56666_0,,,,2,1,2,3
C(CC1C(C(C(C1)=O)O)=O)=O,,,5,1,1,0,1
56667_0,,,,2,1,2,3
56668_0,,,,2,1,2,3
56669_0,,,,2,1,2,3
56670_0,,,,2,1,2,3
56672_0,,,,2,1,2,3
C1(CC(C(C=O)=O)CC1O)=O,,,5,1,1,0,1
56674_0,,,,2,1,2,3
C(C1C(C(C(C1)=O)O)=O)=O,,,5,1,2,0,2
56675_0,,,,2,1,2,3
56676_0,,,,2,1,2,3
56677_0,,,,2,1,2,3
56678_0,,,,2,1,2,3
56680_0,,,,2,1,2,3
C1(CCC(C1O)=O)=O,,,5,1,1,0,1
56681_0,,,,2,1,2,3
56682_0,,,,2,1,2,3
56683_0,,,,2,1,2,3
56684_0,,,,2,1,2,3
56685_0,,,,2,1,2,3
56686_0,,,,2,1,2,3
56687_0,,,,2,1,2,3
56688_0,,,,2,1,2,3
56689_0,,,,2,1,2,3
56691_0,,,,2,1,2,3
C(C1C(C(C(C1)O)=O)=O)=O,,,5,1,1,0,1
56692_0,,,,2,1,2,3
56693_0,,,,2,1,2,3
56694_0,,,,2,1,2,3
56695_0,,,,2,1,2,3
56696_0,,,,2,1,2,3
56697_0,,,,2,1,2,3
56698_0,,,,2,1,2,3
56700_0,,,,2,1,2,3
C1(C(C=O)C(C(C1O)=O)CO)=O,,,5,1,2,0,2
56701_0,,,,2,1,2,3
56702_0,,,,2,1,2,3
56703_0,,,,2,1,2,3
56704_0,,,,2,1,2,3
56705_0,,,,2,1,2,3
56706_0,,,,2,1,2,3
56707_0,,,,2,1,2,3
56708_0,,,,2,1,2,3
56710_0,,,,2,1,2,3
C(C1C(C(C(C1CO)O)=O)=O)=O,,,5,1,1,0,1
56711_0,,,,2,1,2,3
56712_0,,,,2,1,2,3
56713_0,,,,2,1,2,3
56714_0,,,,2,1,2,3
56715_0,,,,2,1,2,3
56716_0,,,,2,1,2,3
56717_0,,,,2,1,2,3
56718_0,,,,2,1,2,3
56719_0,,,,2,1,2,3
56720_0,,,,2,1,2,3
56721_0,,,,2,1,2,3
56723_0,,,,2,1,2,3
C(C(C1C(C(C(C1)=O)=O)O)O)=O,,,5,1,1,0,1
56724_0,,,,2,1,2,3
56725_0,,,,2,1,2,3
56726_0,,,,2,1,2,3
56727_0,,,,2,1,2,3
56728_0,,,,2,1,2,3
56729_0,,,,2,1,2,3
56730_0,,,,2,1,2,3
56731_0,,,,2,1,2,3
56732_0,,,,2,1,2,3
56733_0,,,,2,1,2,3
56734_0,,,,2,1,2,3
56735_0,,,,2,1,2,3
56736_0,,,,2,1,2,3
56737_0,,,,2,1,2,3
56738_0,,,,2,1,2,3
56739_0,,,,2,1,2,3
56740_0,,,,2,1,2,3
56741_0,,,,2,1,2,3
56742_0,,,,2,1,2,3
56743_0,,,,2,1,2,3
56744_0,,,,2,1,2,3
56745_0,,,,2,1,2,3
56746_0,,,,2,1,2,3
56747_0,,,,2,1,2,3
56749_0,,,,2,1,2,3
C1(C(CO)C(C(C1C=O)=O)O)=O,,,5,1,1,0,1
56750_0,,,,2,1,2,3
56751_0,,,,2,1,2,3
56752_0,,,,2,1,2,3
56753_0,,,,2,1,2,3
56754_0,,,,2,1,2,3
56755_0,,,,2,1,2,3
56756_0,,,,2,1,2,3
56757_0,,,,2,1,2,3
56758_0,,,,2,1,2,3
56759_0,,,,2,1,2,3
56760_0,,,,2,1,2,3
56761_0,,,,2,1,2,3
56762_0,,,,2,1,2,3
56763_0,,,,2,1,2,3
56764_0,,,,2,1,2,3
56765_0,,,,2,1,2,3
56766_0,,,,2,1,2,3
56767_0,,,,2,1,2,3
56768_0,,,,2,1,2,3
56770_0,,,,2,1,2,3
C(C(C1C(C(C(C1)O)=O)=O)O)=O,,,5,1,1,0,1
56771_0,,,,2,1,2,3
56773_0,,,,2,1,2,3
C1(C(C(CC1)O)=O)=O,,,5,1,1,0,1
56774_0,,,,2,1,2,3
56775_0,,,,2,1,2,3
56776_0,,,,2,1,2,3
56777_0,,,,2,1,2,3
56779_0,,,,2,1,2,3
C(C1C(C(C(C1O)O)=O)=O)=O,,,5,1,1,0,1
56780_0,,,,2,1,2,3
56781_0,,,,2,1,2,3
56782_0,,,,2,1,2,3
56783_0,,,,2,1,2,3
56784_0,,,,2,1,2,3
56785_0,,,,2,1,2,3
56786_0,,,,2,1,2,3
56787_0,,,,2,1,2,3
56789_0,,,,2,1,2,3
C1(C(C)C(C(C1O)=O)(CO)O)=O,,,5,1,1,0,1
56790_0,,,,2,1,2,3
56791_0,,,,2,1,2,3
56792_0,,,,2,1,2,3
56794_0,,,,2,1,2,3
C1(C(C)C(C(C1(CO)O)=O)O)=O,,,5,1,1,0,1
56795_0,,,,2,1,2,3
56796_0,,,,2,1,2,3
56797_0,,,,2,1,2,3
56798_0,,,,2,1,2,3
56799_0,,,,2,1,2,3
56800_0,,,,2,1,2,3
56801_0,,,,2,1,2,3
56802_0,,,,2,1,2,3
56803_0,,,,2,1,2,3
56804_0,,,,2,1,2,3
56805_0,,,,2,1,2,3
56806_0,,,,2,1,2,3
56807_0,,,,2,1,2,3
56808_0,,,,2,1,2,3
56809_0,,,,2,1,2,3
56810_0,,,,2,1,2,3
56812_0,,,,2,1,2,3
C1(C(C=O)(C(C(C1)=O)C)O)=O,,,5,1,1,0,1
56813_0,,,,2,1,2,3
56814_0,,,,2,1,2,3
56815_0,,,,2,1,2,3
56816_0,,,,2,1,2,3
56818_0,,,,2,1,2,3
C1(C(C)CC(C1(C=O)O)=O)=O,,,5,1,1,0,1
56819_0,,,,2,1,2,3
56820_0,,,,2,1,2,3
56821_0,,,,2,1,2,3
56822_0,,,,2,1,2,3
56823_0,,,,2,1,2,3
56824_0,,,,2,1,2,3
56825_0,,,,2,1,2,3
56826_0,,,,2,1,2,3
56827_0,,,,2,1,2,3
56828_0,,,,2,1,2,3
56829_0,,,,2,1,2,3
56830_0,,,,2,1,2,3
56831_0,,,,2,1,2,3
56832_0,,,,2,1,2,3
56833_0,,,,2,1,2,3
56834_0,,,,2,1,2,3
56835_0,,,,2,1,2,3
56836_0,,,,2,1,2,3
56837_0,,,,2,1,2,3
56838_0,,,,2,1,2,3
56839_0,,,,2,1,2,3
56840_0,,,,2,1,2,3
56841_0,,,,2,1,2,3
56842_0,,,,2,1,2,3
56843_0,,,,2,1,2,3
56845_0,,,,2,1,2,3
C1(C(CO)CC(C1(C=O)O)=O)=O,,,5,1,1,0,1
56846_0,,,,2,1,2,3
56847_0,,,,2,1,2,3
56848_0,,,,2,1,2,3
56849_0,,,,2,1,2,3
56850_0,,,,2,1,2,3
56851_0,,,,2,1,2,3
56852_0,,,,2,1,2,3
56853_0,,,,2,1,2,3
56855_0,,,,2,1,2,3
C(C1(C(CCC1=O)=O)O)=O,,,5,1,1,0,1
56856_0,,,,2,1,2,3
56857_0,,,,2,1,2,3
56858_0,,,,2,1,2,3
56859_0,,,,2,1,2,3
56860_0,,,,2,1,2,3
56861_0,,,,2,1,2,3
56862_0,,,,2,1,2,3
56863_0,,,,2,1,2,3
56864_0,,,,2,1,2,3
56865_0,,,,2,1,2,3
56866_0,,,,2,1,2,3
56867_0,,,,2,1,2,3
56868_0,,,,2,1,2,3
56869_0,,,,2,1,2,3
56870_0,,,,2,1,2,3
56871_0,,,,2,1,2,3
56872_0,,,,2,1,2,3
56873_0,,,,2,1,2,3
56874_0,,,,2,1,2,3
56875_0,,,,2,1,2,3
56876_0,,,,2,1,2,3
56877_0,,,,2,1,2,3
56878_0,,,,2,1,2,3
56879_0,,,,2,1,2,3
56880_0,,,,2,1,2,3
56881_0,,,,2,1,2,3
56882_0,,,,2,1,2,3
56883_0,,,,2,1,2,3
56884_0,,,,2,1,2,3
56885_0,,,,2,1,2,3
56886_0,,,,2,1,2,3
56888_0,,,,2,1,2,3
C(C(CO)CC=O)(C(C)O)=O,,,5,1,1,0,1
56889_0,,,,2,1,2,3
56890_0,,,,2,1,2,3
56891_0,,,,2,1,2,3
56892_0,,,,2,1,2,3
56893_0,,,,2,1,2,3
56894_0,,,,2,1,2,3
56895_0,,,,2,1,2,3
56896_0,,,,2,1,2,3
56897_0,,,,2,1,2,3
56898_0,,,,2,1,2,3
56899_0,,,,2,1,2,3
56900_0,,,,2,1,2,3
56901_0,,,,2,1,2,3
56902_0,,,,2,1,2,3
56903_0,,,,2,1,2,3
56904_0,,,,2,1,2,3
56905_0,,,,2,1,2,3
56906_0,,,,2,1,2,3
56907_0,,,,2,1,2,3
56908_0,,,,2,1,2,3
56909_0,,,,2,1,2,3
56910_0,,,,2,1,2,3
56911_0,,,,2,1,2,3
56912_0,,,,2,1,2,3
56913_0,,,,2,1,2,3
56914_0,,,,2,1,2,3
56915_0,,,,2,1,2,3
56916_0,,,,2,1,2,3
56917_0,,,,2,1,2,3
56918_0,,,,2,1,2,3
56919_0,,,,2,1,2,3
56920_0,,,,2,1,2,3
56921_0,,,,2,1,2,3
56922_0,,,,2,1,2,3
56923_0,,,,2,1,2,3
56924_0,,,,2,1,2,3
56925_0,,,,2,1,2,3
56926_0,,,,2,1,2,3
56927_0,,,,2,1,2,3
56928_0,,,,2,1,2,3
56929_0,,,,2,1,2,3
56930_0,,,,2,1,2,3
56931_0,,,,2,1,2,3
56932_0,,,,2,1,2,3
56933_0,,,,2,1,2,3
56934_0,,,,2,1,2,3
56935_0,,,,2,1,2,3
56937_0,,,,2,1,2,3
C(C(C(C=O)C(C=O)C)O)(O)=O,,,5,1,2,0,2
56938_0,,,,2,1,2,3
56939_0,,,,2,1,2,3
56941_0,,,,2,1,2,3
C(C(C(C=O)CC(C)=O)O)(O)=O,,,5,1,2,0,2
56943_0,,,,2,1,2,3
C(CC)(C(C=O)C(C(O)=O)O)=O,,,5,1,1,0,1
56944_0,,,,2,1,2,3
56945_0,,,,2,1,2,3
56946_0,,,,2,1,2,3
56947_0,,,,2,1,2,3
56949_0,,,,2,1,2,3
C(C(C)CC(C=O)=O)(CC=O)=O,,,5,1,1,0,1
56951_0,,,,2,1,2,3
C(CC(C(C)C(C=O)C=O)=O)=O,,,5,1,1,0,1
56953_0,,,,2,1,2,3
C(C(C)(CCC(C(C)=O)=O)O)=O,,,5,1,1,0,1
56955_0,,,,2,1,2,3
C(C(C)(CC(CC(C)=O)=O)O)=O,,,5,1,1,0,1
56956_0,,,,2,1,2,3
56957_0,,,,2,1,2,3
56959_0,,,,2,1,2,3
C(C(C)CC=O)(C(C=O)CO)=O,,,5,1,1,0,1
56960_0,,,,2,1,2,3
56962_0,,,,2,1,2,3
C(C)(CC(C(C)(CC=O)O)=O)=O,,,5,1,1,0,1
56964_0,,,,2,1,2,3
C(C)(C(C(C(C)CC=O)=O)O)=O,,,5,1,1,0,1
56966_0,,,,2,1,2,3
C(CO)(CC(C(C)CC=O)=O)=O,,,5,1,1,0,1
56968_0,,,,2,1,2,3
C(C(C)CC=O)(CC(C=O)=O)=O,,,5,1,1,0,1
56970_0,,,,2,1,2,3
C(C(C)CC=O)(C(C=O)C=O)=O,,,5,1,1,0,1
56972_0,,,,2,1,2,3
C(C(C)CC=O)(CC=O)=O,,,5,1,1,0,1
56973_0,,,,2,1,2,3
56974_0,,,,2,1,2,3
56976_0,,,,2,1,2,3
C(C(C)CC=O)(C(C=O)O)=O,,,5,1,1,0,1
56978_0,,,,2,1,2,3
C(C(C)C(C=O)C(C=O)(C)O)=O,,,5,1,2,0,2
56979_0,,,,2,1,2,3
56980_0,,,,2,1,2,3
56982_0,,,,2,1,2,3
C(CC(C=O)C(C=O)(C)O)(C)=O,,,5,1,2,0,2
56984_0,,,,2,1,2,3
C(CC)(C(C=O)C(C=O)(C)O)=O,,,5,1,1,0,1
56985_0,,,,2,1,2,3
56986_0,,,,2,1,2,3
56988_0,,,,2,1,2,3
C(C(C(CCC=O)=O)(C)O)=O,,,5,1,1,0,1
56989_0,,,,2,1,2,3
56990_0,,,,2,1,2,3
56991_0,,,,2,1,2,3
56993_0,,,,2,1,2,3
C(CC(C=O)O)(C(C=O)(C)O)=O,,,5,1,1,0,1
56994_0,,,,2,1,2,3
56995_0,,,,2,1,2,3
56996_0,,,,2,1,2,3
56997_0,,,,2,1,2,3
56999_0,,,,2,1,2,3
C(C(C)C(C=O)O)(CC=O)=O,,,5,1,1,0,1
57000_0,,,,2,1,2,3
57001_0,,,,2,1,2,3
57002_0,,,,2,1,2,3
57003_0,,,,2,1,2,3
57005_0,,,,2,1,2,3
C(C)(C(CCC(C(C)=O)=O)O)=O,,,5,1,1,0,1
57007_0,,,,2,1,2,3
C(C)(CC(CC(C(C)=O)O)=O)=O,,,5,1,1,0,1
57008_0,,,,2,1,2,3
57009_0,,,,2,1,2,3
57011_0,,,,2,1,2,3
C(CC(C(C)C(C=O)CO)=O)=O,,,5,1,1,0,1
57013_0,,,,2,1,2,3
C(CC(C(C(C(C)=O)=O)C)O)=O,,,5,1,1,0,1
57015_0,,,,2,1,2,3
C(C(C)C(C(C)=O)O)(CC=O)=O,,,5,1,1,0,1
57017_0,,,,2,1,2,3
C(C(C)CC(CO)=O)(CC=O)=O,,,5,1,1,0,1
57019_0,,,,2,1,2,3
C(C(C(C=O)C(C=O)C)O)(C)=O,,,5,1,2,0,2
57020_0,,,,2,1,2,3
57021_0,,,,2,1,2,3
57023_0,,,,2,1,2,3
C(C(CC(C)=O)C(C(C)=O)O)=O,,,5,1,2,0,2
57025_0,,,,2,1,2,3
C(CC)(C(C=O)C(C(C)=O)O)=O,,,5,1,1,0,1
57026_0,,,,2,1,2,3
57027_0,,,,2,1,2,3
57029_0,,,,2,1,2,3
C(CC(C(CC(C=O)C)=O)O)=O,,,5,1,1,0,1
57030_0,,,,2,1,2,3
57031_0,,,,2,1,2,3
57033_0,,,,2,1,2,3
C(CC(C(CCC(C)=O)=O)O)=O,,,5,1,1,0,1
57035_0,,,,2,1,2,3
C(CC(C(CC(CC)=O)=O)O)=O,,,5,1,1,0,1
57036_0,,,,2,1,2,3
57037_0,,,,2,1,2,3
57039_0,,,,2,1,2,3
C(CCC(C(C(C)=O)O)=O)=O,,,5,1,2,0,2
57040_0,,,,2,1,2,3
57041_0,,,,2,1,2,3
57042_0,,,,2,1,2,3
57043_0,,,,2,1,2,3
57044_0,,,,2,1,2,3
57045_0,,,,2,1,2,3
57046_0,,,,2,1,2,3
57047_0,,,,2,1,2,3
57048_0,,,,2,1,2,3
57049_0,,,,2,1,2,3
57050_0,,,,2,1,2,3
57051_0,,,,2,1,2,3
57052_0,,,,2,1,2,3
57053_0,,,,2,1,2,3
57054_0,,,,2,1,2,3
57055_0,,,,2,1,2,3
57056_0,,,,2,1,2,3
57057_0,,,,2,1,2,3
57058_0,,,,2,1,2,3
57060_0,,,,2,1,2,3
C(C(C(C(C)=O)=O)CC(C)O)=O,,,5,1,1,0,1
57062_0,,,,2,1,2,3
C(C(C(C=O)=O)CC(C)O)=O,,,5,1,2,0,2
57064_0,,,,2,1,2,3
C(CC(C)O)(CC(C(C)=O)=O)=O,,,5,1,2,0,2
57066_0,,,,2,1,2,3
C(C)(CC(C(CC(C)O)=O)=O)=O,,,5,1,1,0,1
57068_0,,,,2,1,2,3
C(C(C)C(C(C=O)=O)C(C)O)=O,,,5,1,2,0,2
57070_0,,,,2,1,2,3
C(CC(C(C=O)=O)C(C)O)(O)=O,,,5,1,2,0,2
57071_0,,,,2,1,2,3
57073_0,,,,2,1,2,3
C(CC(C(C=O)=O)C(C)O)(C)=O,,,5,1,2,0,2
57075_0,,,,2,1,2,3
C(CC)(C(C(C=O)=O)C(C)O)=O,,,5,1,1,0,1
57076_0,,,,2,1,2,3
57077_0,,,,2,1,2,3
57079_0,,,,2,1,2,3
C(C(C(C=O)=O)CC(C=O)O)=O,,,5,1,2,0,2
57080_0,,,,2,1,2,3
57081_0,,,,2,1,2,3
57082_0,,,,2,1,2,3
57083_0,,,,2,1,2,3
57085_0,,,,2,1,2,3
C(C(C(C=O)=O)CC(CO)O)=O,,,5,1,2,0,2
57086_0,,,,2,1,2,3
57087_0,,,,2,1,2,3
57088_0,,,,2,1,2,3
57089_0,,,,2,1,2,3
57090_0,,,,2,1,2,3
57091_0,,,,2,1,2,3
57092_0,,,,2,1,2,3
57093_0,,,,2,1,2,3
57094_0,,,,2,1,2,3
57095_0,,,,2,1,2,3
57097_0,,,,2,1,2,3
C(CC(C(C=O)C(C=O)C)O)=O,,,5,1,2,0,2
57098_0,,,,2,1,2,3
57099_0,,,,2,1,2,3
57101_0,,,,2,1,2,3
C(CC(C(C=O)CC(C)=O)O)=O,,,5,1,2,0,2
57103_0,,,,2,1,2,3
C(C(C(CC)=O)C(CC=O)O)=O,,,5,1,1,0,1
57104_0,,,,2,1,2,3
57105_0,,,,2,1,2,3
57106_0,,,,2,1,2,3
57107_0,,,,2,1,2,3
57108_0,,,,2,1,2,3
57109_0,,,,2,1,2,3
57110_0,,,,2,1,2,3
57111_0,,,,2,1,2,3
57112_0,,,,2,1,2,3
57113_0,,,,2,1,2,3
57114_0,,,,2,1,2,3
57115_0,,,,2,1,2,3
57116_0,,,,2,1,2,3
57117_0,,,,2,1,2,3
57118_0,,,,2,1,2,3
57119_0,,,,2,1,2,3
57120_0,,,,2,1,2,3
57121_0,,,,2,1,2,3
57122_0,,,,2,1,2,3
57123_0,,,,2,1,2,3
57124_0,,,,2,1,2,3
57125_0,,,,2,1,2,3
57126_0,,,,2,1,2,3
57127_0,,,,2,1,2,3
57128_0,,,,2,1,2,3
57129_0,,,,2,1,2,3
57130_0,,,,2,1,2,3
57131_0,,,,2,1,2,3
57132_0,,,,2,1,2,3
57133_0,,,,2,1,2,3
57135_0,,,,2,1,2,3
C(C(CCO)CC=O)(CC=O)=O,,,5,1,1,0,1
57136_0,,,,2,1,2,3
57137_0,,,,2,1,2,3
57139_0,,,,2,1,2,3
C(C(C(C=O)=O)C(CO)CO)=O,,,5,1,2,0,2
57140_0,,,,2,1,2,3
57141_0,,,,2,1,2,3
57142_0,,,,2,1,2,3
57143_0,,,,2,1,2,3
57144_0,,,,2,1,2,3
57145_0,,,,2,1,2,3
57146_0,,,,2,1,2,3
57147_0,,,,2,1,2,3
57148_0,,,,2,1,2,3
57149_0,,,,2,1,2,3
57150_0,,,,2,1,2,3
57151_0,,,,2,1,2,3
57152_0,,,,2,1,2,3
57153_0,,,,2,1,2,3
57154_0,,,,2,1,2,3
57155_0,,,,2,1,2,3
57156_0,,,,2,1,2,3
57157_0,,,,2,1,2,3
57158_0,,,,2,1,2,3
57159_0,,,,2,1,2,3
57160_0,,,,2,1,2,3
57161_0,,,,2,1,2,3
57162_0,,,,2,1,2,3
57163_0,,,,2,1,2,3
57164_0,,,,2,1,2,3
57165_0,,,,2,1,2,3
57166_0,,,,2,1,2,3
57167_0,,,,2,1,2,3
57168_0,,,,2,1,2,3
57169_0,,,,2,1,2,3
57170_0,,,,2,1,2,3
57171_0,,,,2,1,2,3
57172_0,,,,2,1,2,3
57173_0,,,,2,1,2,3
57174_0,,,,2,1,2,3
57175_0,,,,2,1,2,3
57176_0,,,,2,1,2,3
57177_0,,,,2,1,2,3
57178_0,,,,2,1,2,3
57179_0,,,,2,1,2,3
57180_0,,,,2,1,2,3
57181_0,,,,2,1,2,3
57182_0,,,,2,1,2,3
57183_0,,,,2,1,2,3
57184_0,,,,2,1,2,3
57185_0,,,,2,1,2,3
57187_0,,,,2,1,2,3
C(CC(C(C(C)O)=O)CC=O)=O,,,5,1,1,0,1
57188_0,,,,2,1,2,3
57189_0,,,,2,1,2,3
57190_0,,,,2,1,2,3
57191_0,,,,2,1,2,3
57193_0,,,,2,1,2,3
C(CC(C(CO)=O)CC=O)=O,,,5,1,2,0,2
57194_0,,,,2,1,2,3
57195_0,,,,2,1,2,3
57196_0,,,,2,1,2,3
57197_0,,,,2,1,2,3
57198_0,,,,2,1,2,3
57199_0,,,,2,1,2,3
57200_0,,,,2,1,2,3
57201_0,,,,2,1,2,3
57202_0,,,,2,1,2,3
57203_0,,,,2,1,2,3
57204_0,,,,2,1,2,3
57205_0,,,,2,1,2,3
57206_0,,,,2,1,2,3
57207_0,,,,2,1,2,3
57208_0,,,,2,1,2,3
57209_0,,,,2,1,2,3
57210_0,,,,2,1,2,3
57211_0,,,,2,1,2,3
57212_0,,,,2,1,2,3
57213_0,,,,2,1,2,3
57214_0,,,,2,1,2,3
57215_0,,,,2,1,2,3
57216_0,,,,2,1,2,3
57217_0,,,,2,1,2,3
57218_0,,,,2,1,2,3
57220_0,,,,2,1,2,3
C(CC(C(C=O)=O)CC(C)O)=O,,,5,1,1,0,1
57222_0,,,,2,1,2,3
C(CC(C(C=O)=O)CCO)=O,,,5,1,2,0,2
57223_0,,,,2,1,2,3
57224_0,,,,2,1,2,3
57225_0,,,,2,1,2,3
57226_0,,,,2,1,2,3
57227_0,,,,2,1,2,3
57229_0,,,,2,1,2,3
C(C(C(C)=O)=O)(CCC(C)O)=O,,,5,1,1,0,1
57230_0,,,,2,1,2,3
57232_0,,,,2,1,2,3
C(C(C)=O)(CCC(C)O)=O,,,5,1,1,0,1
57234_0,,,,2,1,2,3
C(CC(C)O)(CC(C)=O)=O,,,5,1,1,0,1
57236_0,,,,2,1,2,3
C(C(CCO)=O)(CCC(C)O)=O,,,5,1,1,0,1
57238_0,,,,2,1,2,3
C(CC(C)O)(CC(CCO)=O)=O,,,5,1,1,0,1
57239_0,,,,2,1,2,3
57240_0,,,,2,1,2,3
57242_0,,,,2,1,2,3
C(C(C(CCC(C)O)=O)=O)(O)=O,,,5,1,1,0,1
57243_0,,,,2,1,2,3
57245_0,,,,2,1,2,3
C(C(CO)=O)(CCC(C)O)=O,,,5,1,1,0,1
57246_0,,,,2,1,2,3
57248_0,,,,2,1,2,3
C(CC(C(CCC(C)O)=O)=O)=O,,,5,1,1,0,1
57249_0,,,,2,1,2,3
57251_0,,,,2,1,2,3
C(C(C(CCC(C)O)=O)=O)=O,,,5,1,1,0,1
57252_0,,,,2,1,2,3
57253_0,,,,2,1,2,3
57254_0,,,,2,1,2,3
57256_0,,,,2,1,2,3
C(C(C(C)O)CC(C(C)O)=O)=O,,,5,1,1,0,1
57257_0,,,,2,1,2,3
57259_0,,,,2,1,2,3
C(C(C(CC(C)O)=O)C(C)O)=O,,,5,1,2,0,2
57260_0,,,,2,1,2,3
57261_0,,,,2,1,2,3
57262_0,,,,2,1,2,3
57263_0,,,,2,1,2,3
57264_0,,,,2,1,2,3
57266_0,,,,2,1,2,3
C(C(C(C)O)C(C=O)C)=O,,,5,1,2,0,2
57267_0,,,,2,1,2,3
57269_0,,,,2,1,2,3
C(C(C(C)O)CC(CCO)=O)=O,,,5,1,2,0,2
57271_0,,,,2,1,2,3
C(C(C(CCCO)=O)C(C)O)=O,,,5,1,1,0,1
57272_0,,,,2,1,2,3
57274_0,,,,2,1,2,3
C(C(C(C)O)C(C(CO)=O)C)=O,,,5,1,1,0,1
57275_0,,,,2,1,2,3
57276_0,,,,2,1,2,3
57278_0,,,,2,1,2,3
C(C(C(C)O)C1C(COC1)=O)=O,,,5,1,1,0,1
57280_0,,,,2,1,2,3
C1(C(CCO1)C(C=O)C(C)O)=O,,,5,1,1,0,1
57281_0,,,,2,1,2,3
57282_0,,,,2,1,2,3
57284_0,,,,2,1,2,3
C(C(C(C)O)CC(C)=O)=O,,,5,1,2,0,2
57286_0,,,,2,1,2,3
C(C(C(CC)=O)C(C)O)=O,,,5,1,1,0,1
57287_0,,,,2,1,2,3
57288_0,,,,2,1,2,3
57289_0,,,,2,1,2,3
57290_0,,,,2,1,2,3
57291_0,,,,2,1,2,3
57292_0,,,,2,1,2,3
57293_0,,,,2,1,2,3
57294_0,,,,2,1,2,3
57295_0,,,,2,1,2,3
57296_0,,,,2,1,2,3
57297_0,,,,2,1,2,3
57298_0,,,,2,1,2,3
57299_0,,,,2,1,2,3
57300_0,,,,2,1,2,3
57301_0,,,,2,1,2,3
57302_0,,,,2,1,2,3
57304_0,,,,2,1,2,3
C(C(CO)CC(C(C)O)=O)=O,,,5,1,1,0,1
57305_0,,,,2,1,2,3
57306_0,,,,2,1,2,3
57307_0,,,,2,1,2,3
57308_0,,,,2,1,2,3
57310_0,,,,2,1,2,3
C(CC(C(C)=O)O)(C(C)O)=O,,,5,1,1,0,1
57311_0,,,,2,1,2,3
57312_0,,,,2,1,2,3
57314_0,,,,2,1,2,3
C(CC(C)O)(C(C(C)=O)O)=O,,,5,1,1,0,1
57315_0,,,,2,1,2,3
57317_0,,,,2,1,2,3
C(CCC(C(C)O)=O)(CO)=O,,,5,1,1,0,1
57318_0,,,,2,1,2,3
57319_0,,,,2,1,2,3
57320_0,,,,2,1,2,3
57322_0,,,,2,1,2,3
C(CCC(C(O)=O)=O)(C(C)O)=O,,,5,1,1,0,1
57323_0,,,,2,1,2,3
57324_0,,,,2,1,2,3
57325_0,,,,2,1,2,3
57327_0,,,,2,1,2,3
C(C(C=O)CC(C(C)O)=O)(O)=O,,,5,1,1,0,1
57328_0,,,,2,1,2,3
57330_0,,,,2,1,2,3
C(C(C=O)C(CC(C)O)=O)(O)=O,,,5,1,1,0,1
57331_0,,,,2,1,2,3
57332_0,,,,2,1,2,3
57334_0,,,,2,1,2,3
C(CC(C(CO)=O)O)(C(C)O)=O,,,5,1,1,0,1
57335_0,,,,2,1,2,3
57336_0,,,,2,1,2,3
57337_0,,,,2,1,2,3
57338_0,,,,2,1,2,3
57339_0,,,,2,1,2,3
57340_0,,,,2,1,2,3
57341_0,,,,2,1,2,3
57342_0,,,,2,1,2,3
57344_0,,,,2,1,2,3
C(C(C=O)CC(C(C)O)=O)=O,,,5,1,1,0,1
57345_0,,,,2,1,2,3
57346_0,,,,2,1,2,3
57347_0,,,,2,1,2,3
57348_0,,,,2,1,2,3
57349_0,,,,2,1,2,3
57350_0,,,,2,1,2,3
57351_0,,,,2,1,2,3
57352_0,,,,2,1,2,3
57353_0,,,,2,1,2,3
57354_0,,,,2,1,2,3
57355_0,,,,2,1,2,3
57356_0,,,,2,1,2,3
57357_0,,,,2,1,2,3
57358_0,,,,2,1,2,3
57359_0,,,,2,1,2,3
57360_0,,,,2,1,2,3
57361_0,,,,2,1,2,3
57362_0,,,,2,1,2,3
57363_0,,,,2,1,2,3
57364_0,,,,2,1,2,3
57365_0,,,,2,1,2,3
57366_0,,,,2,1,2,3
57367_0,,,,2,1,2,3
57368_0,,,,2,1,2,3
57369_0,,,,2,1,2,3
57370_0,,,,2,1,2,3
57371_0,,,,2,1,2,3
57372_0,,,,2,1,2,3
57373_0,,,,2,1,2,3
57374_0,,,,2,1,2,3
57375_0,,,,2,1,2,3
57376_0,,,,2,1,2,3
57377_0,,,,2,1,2,3
57378_0,,,,2,1,2,3
57379_0,,,,2,1,2,3
57380_0,,,,2,1,2,3
57381_0,,,,2,1,2,3
57382_0,,,,2,1,2,3
57383_0,,,,2,1,2,3
57384_0,,,,2,1,2,3
57385_0,,,,2,1,2,3
57386_0,,,,2,1,2,3
57387_0,,,,2,1,2,3
57388_0,,,,2,1,2,3
57389_0,,,,2,1,2,3
57390_0,,,,2,1,2,3
57391_0,,,,2,1,2,3
57392_0,,,,2,1,2,3
57393_0,,,,2,1,2,3
57394_0,,,,2,1,2,3
57395_0,,,,2,1,2,3
57396_0,,,,2,1,2,3
57397_0,,,,2,1,2,3
57398_0,,,,2,1,2,3
57399_0,,,,2,1,2,3
57400_0,,,,2,1,2,3
57401_0,,,,2,1,2,3
57402_0,,,,2,1,2,3
57403_0,,,,2,1,2,3
57404_0,,,,2,1,2,3
57405_0,,,,2,1,2,3
57406_0,,,,2,1,2,3
57407_0,,,,2,1,2,3
57408_0,,,,2,1,2,3
57409_0,,,,2,1,2,3
57410_0,,,,2,1,2,3
57411_0,,,,2,1,2,3
57412_0,,,,2,1,2,3
57413_0,,,,2,1,2,3
57414_0,,,,2,1,2,3
57415_0,,,,2,1,2,3
57416_0,,,,2,1,2,3
57417_0,,,,2,1,2,3
57418_0,,,,2,1,2,3
57419_0,,,,2,1,2,3
57420_0,,,,2,1,2,3
57421_0,,,,2,1,2,3
57423_0,,,,2,1,2,3
C(C(C(C(CCCO)=O)=O)O)=O,,,5,1,1,0,1
57424_0,,,,2,1,2,3
57426_0,,,,2,1,2,3
C(C(C(C)=O)=O)(CCCO)=O,,,5,1,1,0,1
57427_0,,,,2,1,2,3
57428_0,,,,2,1,2,3
57429_0,,,,2,1,2,3
57431_0,,,,2,1,2,3
C(C(CCO)=O)(CCCO)=O,,,5,1,1,0,1
57433_0,,,,2,1,2,3
C(CCO)(CC(CCO)=O)=O,,,5,1,1,0,1
57434_0,,,,2,1,2,3
57435_0,,,,2,1,2,3
57437_0,,,,2,1,2,3
C(CC(C(CCCO)=O)=O)(O)=O,,,5,1,1,0,1
57439_0,,,,2,1,2,3
C(CC(CC(CCO)=O)=O)(O)=O,,,5,1,2,0,2
57441_0,,,,2,1,2,3
C(C(C(CCCO)=O)=O)(O)=O,,,5,1,1,0,1
57442_0,,,,2,1,2,3
57443_0,,,,2,1,2,3
57444_0,,,,2,1,2,3
57445_0,,,,2,1,2,3
57446_0,,,,2,1,2,3
57447_0,,,,2,1,2,3
57448_0,,,,2,1,2,3
57449_0,,,,2,1,2,3
57450_0,,,,2,1,2,3
57451_0,,,,2,1,2,3
57452_0,,,,2,1,2,3
57453_0,,,,2,1,2,3
57454_0,,,,2,1,2,3
57455_0,,,,2,1,2,3
57456_0,,,,2,1,2,3
57457_0,,,,2,1,2,3
57458_0,,,,2,1,2,3
57459_0,,,,2,1,2,3
57461_0,,,,2,1,2,3
C(C(C)C(C=O)CO)=O,,,5,1,2,0,2
57462_0,,,,2,1,2,3
57464_0,,,,2,1,2,3
C(C(CO)CC(CCO)=O)=O,,,5,1,2,0,2
57466_0,,,,2,1,2,3
C(C(C(CCCO)=O)CO)=O,,,5,1,1,0,1
57467_0,,,,2,1,2,3
57469_0,,,,2,1,2,3
C(C(CO)C(C(CO)=O)C)=O,,,5,1,1,0,1
57470_0,,,,2,1,2,3
57472_0,,,,2,1,2,3
C(C(CO)CC(CC(O)=O)=O)=O,,,5,1,1,0,1
57474_0,,,,2,1,2,3
C(C(C(CCC(O)=O)=O)CO)=O,,,5,1,2,0,2
57475_0,,,,2,1,2,3
57477_0,,,,2,1,2,3
C(C(CO)C(C(C(O)=O)=O)C)=O,,,5,1,1,0,1
57478_0,,,,2,1,2,3
57480_0,,,,2,1,2,3
C(C(CO)C1C(COC1)=O)=O,,,5,1,1,0,1
57482_0,,,,2,1,2,3
C1(C(CCO1)C(C=O)CO)=O,,,5,1,1,0,1
57484_0,,,,2,1,2,3
C1(C(C(CO1)O)C(C=O)CO)=O,,,5,1,2,0,2
57486_0,,,,2,1,2,3
C(C(CO)C1C(COC1O)=O)=O,,,5,1,3,0,3
57487_0,,,,2,1,2,3
57488_0,,,,2,1,2,3
57490_0,,,,2,1,2,3
C(C(CO)CC(C)=O)=O,,,5,1,2,0,2
57492_0,,,,2,1,2,3
C(C(C(CC)=O)CO)=O,,,5,1,1,0,1
57493_0,,,,2,1,2,3
57494_0,,,,2,1,2,3
57496_0,,,,2,1,2,3
C(C(C)=O)(CCC(CO)O)=O,,,5,1,1,0,1
57497_0,,,,2,1,2,3
57498_0,,,,2,1,2,3
57500_0,,,,2,1,2,3
C(CC(CO)O)(CC(C)=O)=O,,,5,1,1,0,1
57501_0,,,,2,1,2,3
57502_0,,,,2,1,2,3
57503_0,,,,2,1,2,3
57504_0,,,,2,1,2,3
57505_0,,,,2,1,2,3
57506_0,,,,2,1,2,3
57507_0,,,,2,1,2,3
57508_0,,,,2,1,2,3
57509_0,,,,2,1,2,3
57510_0,,,,2,1,2,3
57511_0,,,,2,1,2,3
57512_0,,,,2,1,2,3
57513_0,,,,2,1,2,3
57514_0,,,,2,1,2,3
57515_0,,,,2,1,2,3
57516_0,,,,2,1,2,3
57517_0,,,,2,1,2,3
57518_0,,,,2,1,2,3
57519_0,,,,2,1,2,3
57520_0,,,,2,1,2,3
57521_0,,,,2,1,2,3
57522_0,,,,2,1,2,3
57523_0,,,,2,1,2,3
57524_0,,,,2,1,2,3
57526_0,,,,2,1,2,3
C(C(C(CO)O)C(C=O)C)=O,,,5,1,2,0,2
57527_0,,,,2,1,2,3
57528_0,,,,2,1,2,3
57529_0,,,,2,1,2,3
57530_0,,,,2,1,2,3
57531_0,,,,2,1,2,3
57532_0,,,,2,1,2,3
57533_0,,,,2,1,2,3
57534_0,,,,2,1,2,3
57535_0,,,,2,1,2,3
57536_0,,,,2,1,2,3
57537_0,,,,2,1,2,3
57538_0,,,,2,1,2,3
57539_0,,,,2,1,2,3
57540_0,,,,2,1,2,3
57541_0,,,,2,1,2,3
57542_0,,,,2,1,2,3
57543_0,,,,2,1,2,3
57544_0,,,,2,1,2,3
57546_0,,,,2,1,2,3
C(C(C(CO)O)CC(C)=O)=O,,,5,1,2,0,2
57548_0,,,,2,1,2,3
C(C(C(CC)=O)C(CO)O)=O,,,5,1,1,0,1
57549_0,,,,2,1,2,3
57550_0,,,,2,1,2,3
57551_0,,,,2,1,2,3
57552_0,,,,2,1,2,3
57553_0,,,,2,1,2,3
57554_0,,,,2,1,2,3
57555_0,,,,2,1,2,3
57557_0,,,,2,1,2,3
C(C(CCC(C(C=O)=O)=O)=O)=O,,,5,1,3,0,3
57559_0,,,,2,1,2,3
C(CC(C=O)=O)(CC(C=O)=O)=O,,,5,1,2,0,2
57561_0,,,,2,1,2,3
C(C(C=O)CC(C(C=O)=O)=O)=O,,,5,1,2,0,2
57563_0,,,,2,1,2,3
C(C(C=O)C(CC(C=O)=O)=O)=O,,,5,1,3,0,3
57564_0,,,,2,1,2,3
57565_0,,,,2,1,2,3
57566_0,,,,2,1,2,3
57567_0,,,,2,1,2,3
57568_0,,,,2,1,2,3
57569_0,,,,2,1,2,3
57570_0,,,,2,1,2,3
57571_0,,,,2,1,2,3
57573_0,,,,2,1,2,3
C(C(C(C=O)=O)CC(CO)=O)=O,,,5,1,3,0,3
57575_0,,,,2,1,2,3
C(C(C(C=O)=O)CC(C=O)=O)=O,,,5,1,2,0,2
57577_0,,,,2,1,2,3
C(C(C=O)C(C=O)C(C=O)=O)=O,,,5,1,3,0,3
57578_0,,,,2,1,2,3
57579_0,,,,2,1,2,3
57580_0,,,,2,1,2,3
57581_0,,,,2,1,2,3
57582_0,,,,2,1,2,3
57583_0,,,,2,1,2,3
57585_0,,,,2,1,2,3
C(C=O)(C(CO)CC(C=O)=O)=O,,,5,1,2,0,2
57586_0,,,,2,1,2,3
57587_0,,,,2,1,2,3
57588_0,,,,2,1,2,3
57589_0,,,,2,1,2,3
57590_0,,,,2,1,2,3
57591_0,,,,2,1,2,3
57592_0,,,,2,1,2,3
57593_0,,,,2,1,2,3
57594_0,,,,2,1,2,3
57595_0,,,,2,1,2,3
57596_0,,,,2,1,2,3
57597_0,,,,2,1,2,3
57599_0,,,,2,1,2,3
C(C(C)C(C(C(C=O)O)=O)O)=O,,,5,1,2,0,2
57601_0,,,,2,1,2,3
C(C(C(C(C(CO)C)=O)=O)O)=O,,,5,1,1,0,1
57602_0,,,,2,1,2,3
57603_0,,,,2,1,2,3
57605_0,,,,2,1,2,3
C(C(C=O)O)(CC(C(O)O)=O)=O,,,5,1,1,0,1
57607_0,,,,2,1,2,3
C(C(C(C(CC(O)O)=O)=O)O)=O,,,5,1,1,0,1
57609_0,,,,2,1,2,3
C(C(C(C(CC(C)=O)O)=O)O)=O,,,5,1,2,0,2
57611_0,,,,2,1,2,3
C(C(C(C(C(CC)=O)O)=O)O)=O,,,5,1,1,0,1
57612_0,,,,2,1,2,3
57613_0,,,,2,1,2,3
57614_0,,,,2,1,2,3
57615_0,,,,2,1,2,3
57617_0,,,,2,1,2,3
C(C(C(C(C(C=O)O)=O)=O)C)=O,,,5,1,1,0,1
57618_0,,,,2,1,2,3
57619_0,,,,2,1,2,3
57620_0,,,,2,1,2,3
57622_0,,,,2,1,2,3
C(C(C(C(CC)=O)=O)O)=O,,,5,1,1,0,1
57623_0,,,,2,1,2,3
57624_0,,,,2,1,2,3
57625_0,,,,2,1,2,3
57626_0,,,,2,1,2,3
57627_0,,,,2,1,2,3
57628_0,,,,2,1,2,3
57629_0,,,,2,1,2,3
57630_0,,,,2,1,2,3
57632_0,,,,2,1,2,3
C(C(C(C(CC)=O)=O)(CO)O)=O,,,5,1,1,0,1
57633_0,,,,2,1,2,3
57634_0,,,,2,1,2,3
57635_0,,,,2,1,2,3
57636_0,,,,2,1,2,3
57637_0,,,,2,1,2,3
57638_0,,,,2,1,2,3
57639_0,,,,2,1,2,3
57640_0,,,,2,1,2,3
57641_0,,,,2,1,2,3
57642_0,,,,2,1,2,3
57643_0,,,,2,1,2,3
57645_0,,,,2,1,2,3
C(C(C(C)=O)CC(CO)=O)=O,,,5,1,3,0,3
57647_0,,,,2,1,2,3
C(C(C(C)=O)CC(C(O)=O)=O)=O,,,5,1,2,0,2
57648_0,,,,2,1,2,3
57649_0,,,,2,1,2,3
57650_0,,,,2,1,2,3
57652_0,,,,2,1,2,3
C(C(C(C)=O)CC(C=O)=O)=O,,,5,1,3,0,3
57654_0,,,,2,1,2,3
C(C(C=O)C(C=O)C(C)=O)=O,,,5,1,4,0,4
57655_0,,,,2,1,2,3
57656_0,,,,2,1,2,3
57657_0,,,,2,1,2,3
57658_0,,,,2,1,2,3
57659_0,,,,2,1,2,3
57661_0,,,,2,1,2,3
C(CO)(C(C(C(C)=O)=O)C)=O,,,5,1,1,0,1
57662_0,,,,2,1,2,3
57663_0,,,,2,1,2,3
57664_0,,,,2,1,2,3
57665_0,,,,2,1,2,3
57666_0,,,,2,1,2,3
57667_0,,,,2,1,2,3
57669_0,,,,2,1,2,3
C(C(CC(C(C(C)=O)=O)=O)O)=O,,,5,1,1,0,1
57671_0,,,,2,1,2,3
C(C(C)C(C(C(C)=O)=O)O)=O,,,5,1,1,0,1
57673_0,,,,2,1,2,3
C(C(C(C)=O)=O)(C(C)CO)=O,,,5,1,1,0,1
57675_0,,,,2,1,2,3
C(C(C(C(C(C)=O)=O)=O)C)(O)=O,,,5,1,1,0,1
57676_0,,,,2,1,2,3
57677_0,,,,2,1,2,3
57679_0,,,,2,1,2,3
C(C(C=C)C(C(C(C)=O)=O)=O)=O,,,5,1,1,0,1
57681_0,,,,2,1,2,3
C=CC(C(CC(C(C)=O)=O)=O)=O,,,5,1,1,0,1
57683_0,,,,2,1,2,3
C=CC(CC(C(C(C)=O)=O)=O)=O,,,5,1,1,0,1
57685_0,,,,2,1,2,3
C(C(C)=O)(CC(C=CC=O)=O)=O,,,5,1,1,0,1
57687_0,,,,2,1,2,3
C(CC(C(C(C)=O)=O)=O)=CC=O,,,5,1,1,0,1
57688_0,,,,2,1,2,3
57689_0,,,,2,1,2,3
57691_0,,,,2,1,2,3
C(C(O)O)(CC(C(C)=O)=O)=O,,,5,1,1,0,1
57693_0,,,,2,1,2,3
C(C(C(C)=O)=O)(CC(O)O)=O,,,5,1,1,0,1
57695_0,,,,2,1,2,3
C(C)(CC(C(C(C)=O)=O)O)=O,,,5,1,1,0,1
57697_0,,,,2,1,2,3
C(CC)(C(C(C(C)=O)=O)O)=O,,,5,1,1,0,1
57699_0,,,,2,1,2,3
C(C(C)O)(CC(C(C)=O)=O)=O,,,5,1,2,0,2
57701_0,,,,2,1,2,3
C(C(C(C)=O)=O)(CC(C)O)=O,,,5,1,1,0,1
57702_0,,,,2,1,2,3
57703_0,,,,2,1,2,3
57704_0,,,,2,1,2,3
57705_0,,,,2,1,2,3
57706_0,,,,2,1,2,3
57708_0,,,,2,1,2,3
C(C(C(C)=O)=O)(CC(CO)O)=O,,,5,1,1,0,1
57709_0,,,,2,1,2,3
57710_0,,,,2,1,2,3
57711_0,,,,2,1,2,3
57713_0,,,,2,1,2,3
C(C(C(C)=O)=O)(C(CO)CO)=O,,,5,1,1,0,1
57714_0,,,,2,1,2,3
57716_0,,,,2,1,2,3
C(CC(C(C(C)=O)=O)=O)(O)=O,,,5,1,2,0,2
57718_0,,,,2,1,2,3
C(C(C(C(C(C)=O)=O)=O)C)=O,,,5,1,2,0,2
57719_0,,,,2,1,2,3
57720_0,,,,2,1,2,3
57721_0,,,,2,1,2,3
57722_0,,,,2,1,2,3
57724_0,,,,2,1,2,3
C(C)(CC(C(C)=O)=O)=O,,,5,1,3,0,3
57726_0,,,,2,1,2,3
C(C(C(C)=O)=O)(CC)=O,,,5,1,2,0,2
57727_0,,,,2,1,2,3
57729_0,,,,2,1,2,3
C(C(C(C(C(C)=O)=O)=O)CO)=O,,,5,1,1,0,1
57730_0,,,,2,1,2,3
57732_0,,,,2,1,2,3
C(CO)(CC(C(C(C)=O)=O)=O)=O,,,5,1,1,0,1
57733_0,,,,2,1,2,3
57734_0,,,,2,1,2,3
57735_0,,,,2,1,2,3
57736_0,,,,2,1,2,3
57737_0,,,,2,1,2,3
57738_0,,,,2,1,2,3
57739_0,,,,2,1,2,3
57740_0,,,,2,1,2,3
57742_0,,,,2,1,2,3
C(C(C)CC(C(CO)=O)=O)=O,,,5,1,1,0,1
57743_0,,,,2,1,2,3
57744_0,,,,2,1,2,3
57746_0,,,,2,1,2,3
C(C)(CCC(C(CO)=O)=O)=O,,,5,1,1,0,1
57748_0,,,,2,1,2,3
C(CC)(CC(C(CO)=O)=O)=O,,,5,1,1,0,1
57749_0,,,,2,1,2,3
57750_0,,,,2,1,2,3
57751_0,,,,2,1,2,3
57752_0,,,,2,1,2,3
57753_0,,,,2,1,2,3
57754_0,,,,2,1,2,3
57755_0,,,,2,1,2,3
57756_0,,,,2,1,2,3
57757_0,,,,2,1,2,3
57758_0,,,,2,1,2,3
57759_0,,,,2,1,2,3
57760_0,,,,2,1,2,3
57761_0,,,,2,1,2,3
57762_0,,,,2,1,2,3
57763_0,,,,2,1,2,3
57764_0,,,,2,1,2,3
57765_0,,,,2,1,2,3
57766_0,,,,2,1,2,3
57767_0,,,,2,1,2,3
57768_0,,,,2,1,2,3
57770_0,,,,2,1,2,3
C(C)(CC(C(C(C)O)=O)=O)=O,,,5,1,1,0,1
57771_0,,,,2,1,2,3
57772_0,,,,2,1,2,3
57773_0,,,,2,1,2,3
57774_0,,,,2,1,2,3
57775_0,,,,2,1,2,3
57776_0,,,,2,1,2,3
57778_0,,,,2,1,2,3
C(C(CCC(C(O)=O)=O)=O)=O,,,5,1,4,0,4
57779_0,,,,2,1,2,3
57780_0,,,,2,1,2,3
57782_0,,,,2,1,2,3
C(C(C(CC(C=O)=O)O)=O)(O)=O,,,5,1,3,0,3
57783_0,,,,2,1,2,3
57784_0,,,,2,1,2,3
57785_0,,,,2,1,2,3
57787_0,,,,2,1,2,3
C(C(C(CC=O)=O)C(C=O)=O)=O,,,5,1,3,0,3
57789_0,,,,2,1,2,3
C1(C(CC(C=O)=O)OCC1O)=O,,,5,1,1,0,1
57791_0,,,,2,1,2,3
C(CC(C1C(C(CO1)O)=O)=O)=O,,,5,1,2,0,2
57793_0,,,,2,1,2,3
C1(C(O)OCC1CC(C=O)=O)=O,,,5,1,1,0,1
57795_0,,,,2,1,2,3
C(CC=O)(C1C(C(O)OC1)=O)=O,,,5,1,3,0,3
57797_0,,,,2,1,2,3
C1(COC(C1CC(C=O)=O)O)=O,,,5,1,3,0,3
57799_0,,,,2,1,2,3
C(CC=O)(C1C(COC1O)=O)=O,,,5,1,1,0,1
57801_0,,,,2,1,2,3
C1(C(CC(C=O)=O)OC(C1)O)=O,,,5,1,3,0,3
57803_0,,,,2,1,2,3
C(CC(C1C(CC(O1)O)=O)=O)=O,,,5,1,1,0,1
57804_0,,,,2,1,2,3
57806_0,,,,2,1,2,3
C(CC(CC(C(C=O)=O)=O)=O)=O,,,5,1,2,0,2
57807_0,,,,2,1,2,3
57808_0,,,,2,1,2,3
57809_0,,,,2,1,2,3
57811_0,,,,2,1,2,3
C(C(C=O)C(CC=O)=O)=O,,,5,1,3,0,3
57812_0,,,,2,1,2,3
57813_0,,,,2,1,2,3
57814_0,,,,2,1,2,3
57815_0,,,,2,1,2,3
57816_0,,,,2,1,2,3
57817_0,,,,2,1,2,3
57818_0,,,,2,1,2,3
57820_0,,,,2,1,2,3
C(CC(C(C(CC=O)=O)O)=O)=O,,,5,1,2,0,2
57821_0,,,,2,1,2,3
57822_0,,,,2,1,2,3
57823_0,,,,2,1,2,3
57824_0,,,,2,1,2,3
57826_0,,,,2,1,2,3
C(C(C)=O)(C(C)CO)=O,,,5,1,1,0,1
57828_0,,,,2,1,2,3
C(C(C)C(C(C)=O)O)=O,,,5,1,1,0,1
57830_0,,,,2,1,2,3
C(C(C)CC(CO)=O)=O,,,5,1,1,0,1
57832_0,,,,2,1,2,3
C(C(CCO)=O)(C(C)CO)=O,,,5,1,1,0,1
57834_0,,,,2,1,2,3
C(C(C)C(C(CCO)=O)O)=O,,,5,1,1,0,1
57836_0,,,,2,1,2,3
C(C(C)C(C(CO)=O)CO)=O,,,5,1,1,0,1
57837_0,,,,2,1,2,3
57838_0,,,,2,1,2,3
57840_0,,,,2,1,2,3
C(C(C)CC(C(CO)O)=O)=O,,,5,1,1,0,1
57842_0,,,,2,1,2,3
C(C(C)CC(C(O)=O)=O)=O,,,5,1,1,0,1
57844_0,,,,2,1,2,3
C(C(C(O)=O)C(C=O)C)=O,,,5,1,1,0,1
57846_0,,,,2,1,2,3
C(C(C)C(C(C(O)=O)=O)CO)=O,,,5,1,1,0,1
57848_0,,,,2,1,2,3
C(C(C)C(C(O)=O)C(CO)=O)=O,,,5,1,1,0,1
57850_0,,,,2,1,2,3
C(CC(C(C(C)CO)=O)=O)(O)=O,,,5,1,1,0,1
57852_0,,,,2,1,2,3
C(C(C)C(C(CC(O)=O)=O)O)=O,,,5,1,1,0,1
57854_0,,,,2,1,2,3
C(C(C)CC(C(C(O)=O)O)=O)=O,,,5,1,1,0,1
57856_0,,,,2,1,2,3
C(C(C(C(C)CO)=O)=O)(O)=O,,,5,1,1,0,1
57858_0,,,,2,1,2,3
C(C(C)C(C(C(O)=O)=O)O)=O,,,5,1,1,0,1
57860_0,,,,2,1,2,3
C(C(C(C=O)=O)C(C=O)C)=O,,,5,1,1,0,1
57862_0,,,,2,1,2,3
C(C(C)C(C(O)=O)C(C=O)=O)=O,,,5,1,1,0,1
57864_0,,,,2,1,2,3
C(C(C(C(O)=O)=O)C(C=O)C)=O,,,5,1,1,0,1
57866_0,,,,2,1,2,3
C(C(C)C1C(C(CO1)O)=O)=O,,,5,1,1,0,1
57868_0,,,,2,1,2,3
C(C(C)C1C(C(O)OC1)=O)=O,,,5,1,1,0,1
57870_0,,,,2,1,2,3
C(C(C)C1C(COC1O)=O)=O,,,5,1,1,0,1
57872_0,,,,2,1,2,3
C(C(C)C1C(CC(O1)O)=O)=O,,,5,1,1,0,1
57874_0,,,,2,1,2,3
C(C(C)CC(C(C=O)=O)=O)=O,,,5,1,1,0,1
57875_0,,,,2,1,2,3
57877_0,,,,2,1,2,3
C(C(C)C(C(CO)=O)O)=O,,,5,1,1,0,1
57878_0,,,,2,1,2,3
57879_0,,,,2,1,2,3
57880_0,,,,2,1,2,3
57882_0,,,,2,1,2,3
C(C(C)C(C(C(CO)O)=O)O)=O,,,5,1,1,0,1
57884_0,,,,2,1,2,3
C(C(C)CC(C=O)=O)=O,,,5,1,1,0,1
57886_0,,,,2,1,2,3
C(C(C=O)C(C=O)C)=O,,,5,1,1,0,1
57888_0,,,,2,1,2,3
C(C(C)C(C(C=O)=O)CO)=O,,,5,1,2,0,2
57890_0,,,,2,1,2,3
C(C(C(C=O)C(C=O)C)O)=O,,,5,1,2,0,2
57892_0,,,,2,1,2,3
C(C(C)C(C=O)C(CO)=O)=O,,,5,1,1,0,1
57893_0,,,,2,1,2,3
57895_0,,,,2,1,2,3
C(C(C)C(C(CC=O)=O)O)=O,,,5,1,1,0,1
57897_0,,,,2,1,2,3
C(C(C)CC(C(C=O)O)=O)=O,,,5,1,1,0,1
57899_0,,,,2,1,2,3
C(C(C)CC=O)=O,,,5,1,1,0,1
57900_0,,,,2,1,2,3
57902_0,,,,2,1,2,3
C(C(C)C(C(C=O)=O)O)=O,,,5,1,2,0,2
57903_0,,,,2,1,2,3
57905_0,,,,2,1,2,3
C(C(C)C(C=O)O)=O,,,5,1,4,0,4
57906_0,,,,2,1,2,3
57908_0,,,,2,1,2,3
C(C(C)=O)(C(CO)CCO)=O,,,5,1,1,0,1
57910_0,,,,2,1,2,3
C(CC(C(C)=O)O)(CCO)=O,,,5,1,1,0,1
57912_0,,,,2,1,2,3
C(CCCO)(C(C(C)=O)O)=O,,,5,1,1,0,1
57914_0,,,,2,1,2,3
C(C(CCO)O)(CC(C)=O)=O,,,5,1,1,0,1
57915_0,,,,2,1,2,3
57916_0,,,,2,1,2,3
57918_0,,,,2,1,2,3
C(CO)(C(C)C(C(C)=O)O)=O,,,5,1,1,0,1
57919_0,,,,2,1,2,3
57921_0,,,,2,1,2,3
C(C(C)=O)(C(C)C(CO)O)=O,,,5,1,1,0,1
57922_0,,,,2,1,2,3
57923_0,,,,2,1,2,3
57924_0,,,,2,1,2,3
57925_0,,,,2,1,2,3
57927_0,,,,2,1,2,3
C(CC(C(CC(C)=O)=O)O)(O)=O,,,5,1,1,0,1
57928_0,,,,2,1,2,3
57929_0,,,,2,1,2,3
57930_0,,,,2,1,2,3
57931_0,,,,2,1,2,3
57933_0,,,,2,1,2,3
C(C(C(C(C(C)=O)=O)C)O)(O)=O,,,5,1,1,0,1
57934_0,,,,2,1,2,3
57935_0,,,,2,1,2,3
57936_0,,,,2,1,2,3
57937_0,,,,2,1,2,3
57938_0,,,,2,1,2,3
57939_0,,,,2,1,2,3
57941_0,,,,2,1,2,3
C1(COCC1C(C(C)=O)O)=O,,,5,1,1,0,1
57943_0,,,,2,1,2,3
C(C(C)=O)(C1COCC1O)=O,,,5,1,1,0,1
57945_0,,,,2,1,2,3
C1(C(CCO1)C(C(C)=O)O)=O,,,5,1,1,0,1
57947_0,,,,2,1,2,3
C(C(C)=O)(C1C(O)OCC1)=O,,,5,1,1,0,1
57949_0,,,,2,1,2,3
C(C(C)=O)(C1COC(C1)O)=O,,,5,1,1,0,1
57950_0,,,,2,1,2,3
57952_0,,,,2,1,2,3
C(C(C=C)C(C(C)=O)=O)=O,,,5,1,1,0,1
57954_0,,,,2,1,2,3
C(C)(CC(C(C=C)=O)=O)=O,,,5,1,1,0,1
57956_0,,,,2,1,2,3
C=CC(CC(C(C)=O)=O)=O,,,5,1,1,0,1
57958_0,,,,2,1,2,3
C(C)(CC(C=CC=O)=O)=O,,,5,1,1,0,1
57960_0,,,,2,1,2,3
C(CC(C(C)=O)=O)=CC=O,,,5,1,1,0,1
57961_0,,,,2,1,2,3
57962_0,,,,2,1,2,3
57964_0,,,,2,1,2,3
C(C(C)=O)(C1C(O)OCC1O)=O,,,5,1,2,0,2
57965_0,,,,2,1,2,3
57966_0,,,,2,1,2,3
57968_0,,,,2,1,2,3
C(C)(CC(C(O)O)=O)=O,,,5,1,1,0,1
57970_0,,,,2,1,2,3
C(C(C)=O)(CC(O)O)=O,,,5,1,1,0,1
57972_0,,,,2,1,2,3
C(C)(C(CC(C)=O)O)=O,,,5,1,1,0,1
57973_0,,,,2,1,2,3
57974_0,,,,2,1,2,3
57975_0,,,,2,1,2,3
57976_0,,,,2,1,2,3
57977_0,,,,2,1,2,3
57978_0,,,,2,1,2,3
57979_0,,,,2,1,2,3
57980_0,,,,2,1,2,3
57981_0,,,,2,1,2,3
57982_0,,,,2,1,2,3
57983_0,,,,2,1,2,3
57985_0,,,,2,1,2,3
C(CC(CO)O)(C(C(C)=O)O)=O,,,5,1,1,0,1
57986_0,,,,2,1,2,3
57987_0,,,,2,1,2,3
57988_0,,,,2,1,2,3
57989_0,,,,2,1,2,3
57990_0,,,,2,1,2,3
57991_0,,,,2,1,2,3
57992_0,,,,2,1,2,3
57993_0,,,,2,1,2,3
57994_0,,,,2,1,2,3
57995_0,,,,2,1,2,3
57996_0,,,,2,1,2,3
57997_0,,,,2,1,2,3
57998_0,,,,2,1,2,3
57999_0,,,,2,1,2,3
58000_0,,,,2,1,2,3
58001_0,,,,2,1,2,3
58003_0,,,,2,1,2,3
C(C(C(C(C)=O)=O)C)=O,,,5,1,1,0,1
58004_0,,,,2,1,2,3
58005_0,,,,2,1,2,3
58006_0,,,,2,1,2,3
58007_0,,,,2,1,2,3
58009_0,,,,2,1,2,3
C(C(CC(CC(C)=O)=O)O)=O,,,5,1,3,0,3
58011_0,,,,2,1,2,3
C(C(CCC(C(C)=O)=O)O)=O,,,5,1,2,0,2
58012_0,,,,2,1,2,3
58013_0,,,,2,1,2,3
58014_0,,,,2,1,2,3
58015_0,,,,2,1,2,3
58016_0,,,,2,1,2,3
58018_0,,,,2,1,2,3
C(C(C(C)=O)O)(CC(C)=O)=O,,,5,1,1,0,1
58019_0,,,,2,1,2,3
58021_0,,,,2,1,2,3
C(C(C(C(C(C)=O)=O)C)O)=O,,,5,1,1,0,1
58023_0,,,,2,1,2,3
C(C)(CC(C)=O)=O,,,5,1,1,0,1
58024_0,,,,2,1,2,3
58025_0,,,,2,1,2,3
58026_0,,,,2,1,2,3
58027_0,,,,2,1,2,3
58028_0,,,,2,1,2,3
58029_0,,,,2,1,2,3
58031_0,,,,2,1,2,3
C(CCC(CCO)=O)(CO)=O,,,5,1,1,0,1
58033_0,,,,2,1,2,3
C(CCCO)(CC(CO)=O)=O,,,5,1,1,0,1
58034_0,,,,2,1,2,3
58036_0,,,,2,1,2,3
C(CO)(C(C)CC(CO)=O)=O,,,5,1,1,0,1
58037_0,,,,2,1,2,3
58039_0,,,,2,1,2,3
C(CC(CCC(CO)=O)=O)(O)=O,,,5,1,1,0,1
58041_0,,,,2,1,2,3
C(CCC(CC(CO)=O)=O)(O)=O,,,5,1,3,0,3
58042_0,,,,2,1,2,3
58044_0,,,,2,1,2,3
C(CC(C(C(O)=O)=O)C)(CO)=O,,,5,1,1,0,1
58045_0,,,,2,1,2,3
58047_0,,,,2,1,2,3
C(CC1C(COC1)=O)(CO)=O,,,5,1,1,0,1
58049_0,,,,2,1,2,3
C1(C(CCO1)CC(CO)=O)=O,,,5,1,1,0,1
58051_0,,,,2,1,2,3
C1(C(C(CO1)O)CC(CO)=O)=O,,,5,1,2,0,2
58053_0,,,,2,1,2,3
C(CC1C(COC1O)=O)(CO)=O,,,5,1,3,0,3
58054_0,,,,2,1,2,3
58055_0,,,,2,1,2,3
58057_0,,,,2,1,2,3
C(C)(CCC(CO)=O)=O,,,5,1,1,0,1
58058_0,,,,2,1,2,3
58059_0,,,,2,1,2,3
58060_0,,,,2,1,2,3
58061_0,,,,2,1,2,3
58062_0,,,,2,1,2,3
58063_0,,,,2,1,2,3
58064_0,,,,2,1,2,3
58065_0,,,,2,1,2,3
58066_0,,,,2,1,2,3
58067_0,,,,2,1,2,3
58068_0,,,,2,1,2,3
58069_0,,,,2,1,2,3
58070_0,,,,2,1,2,3
58071_0,,,,2,1,2,3
58072_0,,,,2,1,2,3
58073_0,,,,2,1,2,3
58074_0,,,,2,1,2,3
58075_0,,,,2,1,2,3
58076_0,,,,2,1,2,3
58077_0,,,,2,1,2,3
58078_0,,,,2,1,2,3
58079_0,,,,2,1,2,3
58080_0,,,,2,1,2,3
58081_0,,,,2,1,2,3
58082_0,,,,2,1,2,3
58083_0,,,,2,1,2,3
58084_0,,,,2,1,2,3
58085_0,,,,2,1,2,3
58086_0,,,,2,1,2,3
58087_0,,,,2,1,2,3
58088_0,,,,2,1,2,3
58089_0,,,,2,1,2,3
58090_0,,,,2,1,2,3
58091_0,,,,2,1,2,3
58092_0,,,,2,1,2,3
58093_0,,,,2,1,2,3
58094_0,,,,2,1,2,3
58095_0,,,,2,1,2,3
58096_0,,,,2,1,2,3
58097_0,,,,2,1,2,3
58098_0,,,,2,1,2,3
58099_0,,,,2,1,2,3
58100_0,,,,2,1,2,3
58101_0,,,,2,1,2,3
58102_0,,,,2,1,2,3
58103_0,,,,2,1,2,3
58105_0,,,,2,1,2,3
C(C(C=C)C(C(CCO)=O)=O)=O,,,5,1,1,0,1
58107_0,,,,2,1,2,3
C(CCO)(CC(C(C=C)=O)=O)=O,,,5,1,1,0,1
58109_0,,,,2,1,2,3
C=CC(CC(C(CCO)=O)=O)=O,,,5,1,1,0,1
58111_0,,,,2,1,2,3
C(CCO)(CC(C=CC=O)=O)=O,,,5,1,1,0,1
58113_0,,,,2,1,2,3
C(CC(C(CCO)=O)=O)=CC=O,,,5,1,1,0,1
58114_0,,,,2,1,2,3
58115_0,,,,2,1,2,3
58117_0,,,,2,1,2,3
C(CCO)(CC(C(O)O)=O)=O,,,5,1,1,0,1
58119_0,,,,2,1,2,3
C(C(CC(O)O)=O)(CCO)=O,,,5,1,1,0,1
58121_0,,,,2,1,2,3
C(CC(C(CCO)=O)O)(C)=O,,,5,1,1,0,1
58123_0,,,,2,1,2,3
C(CCO)(C(C(CC)=O)O)=O,,,5,1,1,0,1
58125_0,,,,2,1,2,3
C(CCO)(CC(C(C)O)=O)=O,,,5,1,1,0,1
58127_0,,,,2,1,2,3
C(C(CCO)=O)(CC(C)O)=O,,,5,1,1,0,1
58128_0,,,,2,1,2,3
58129_0,,,,2,1,2,3
58130_0,,,,2,1,2,3
58131_0,,,,2,1,2,3
58132_0,,,,2,1,2,3
58133_0,,,,2,1,2,3
58134_0,,,,2,1,2,3
58135_0,,,,2,1,2,3
58136_0,,,,2,1,2,3
58137_0,,,,2,1,2,3
58138_0,,,,2,1,2,3
58139_0,,,,2,1,2,3
58140_0,,,,2,1,2,3
58141_0,,,,2,1,2,3
58142_0,,,,2,1,2,3
58143_0,,,,2,1,2,3
58144_0,,,,2,1,2,3
58145_0,,,,2,1,2,3
58146_0,,,,2,1,2,3
58148_0,,,,2,1,2,3
C(CO)(C(CO)CC(C)=O)=O,,,5,1,1,0,1
58150_0,,,,2,1,2,3
C(CC)(C(C(CO)=O)CO)=O,,,5,1,1,0,1
58151_0,,,,2,1,2,3
58152_0,,,,2,1,2,3
58153_0,,,,2,1,2,3
58154_0,,,,2,1,2,3
58155_0,,,,2,1,2,3
58156_0,,,,2,1,2,3
58157_0,,,,2,1,2,3
58158_0,,,,2,1,2,3
58160_0,,,,2,1,2,3
C(CCC(C(O)=O)=O)(CCO)=O,,,5,1,1,0,1
58162_0,,,,2,1,2,3
C(CCCO)(CC(C(O)=O)=O)=O,,,5,1,1,0,1
58164_0,,,,2,1,2,3
C(C(C=O)CC(CCO)=O)(O)=O,,,5,1,1,0,1
58166_0,,,,2,1,2,3
C(C(C=O)C(CCCO)=O)(O)=O,,,5,1,1,0,1
58167_0,,,,2,1,2,3
58168_0,,,,2,1,2,3
58169_0,,,,2,1,2,3
58170_0,,,,2,1,2,3
58171_0,,,,2,1,2,3
58172_0,,,,2,1,2,3
58173_0,,,,2,1,2,3
58174_0,,,,2,1,2,3
58175_0,,,,2,1,2,3
58176_0,,,,2,1,2,3
58177_0,,,,2,1,2,3
58178_0,,,,2,1,2,3
58179_0,,,,2,1,2,3
58180_0,,,,2,1,2,3
58181_0,,,,2,1,2,3
58182_0,,,,2,1,2,3
58183_0,,,,2,1,2,3
58184_0,,,,2,1,2,3
58185_0,,,,2,1,2,3
58187_0,,,,2,1,2,3
C(CO)(C(C)CC(C(O)=O)=O)=O,,,5,1,1,0,1
58188_0,,,,2,1,2,3
58189_0,,,,2,1,2,3
58191_0,,,,2,1,2,3
C(C(C=O)C(C(CO)=O)C)(O)=O,,,5,1,1,0,1
58192_0,,,,2,1,2,3
58193_0,,,,2,1,2,3
58194_0,,,,2,1,2,3
58195_0,,,,2,1,2,3
58196_0,,,,2,1,2,3
58197_0,,,,2,1,2,3
58198_0,,,,2,1,2,3
58199_0,,,,2,1,2,3
58200_0,,,,2,1,2,3
58201_0,,,,2,1,2,3
58202_0,,,,2,1,2,3
58203_0,,,,2,1,2,3
58204_0,,,,2,1,2,3
58205_0,,,,2,1,2,3
58206_0,,,,2,1,2,3
58207_0,,,,2,1,2,3
58208_0,,,,2,1,2,3
58209_0,,,,2,1,2,3
58210_0,,,,2,1,2,3
58211_0,,,,2,1,2,3
58212_0,,,,2,1,2,3
58213_0,,,,2,1,2,3
58214_0,,,,2,1,2,3
58215_0,,,,2,1,2,3
58216_0,,,,2,1,2,3
58217_0,,,,2,1,2,3
58218_0,,,,2,1,2,3
58219_0,,,,2,1,2,3
58220_0,,,,2,1,2,3
58221_0,,,,2,1,2,3
58222_0,,,,2,1,2,3
58223_0,,,,2,1,2,3
58224_0,,,,2,1,2,3
58225_0,,,,2,1,2,3
58226_0,,,,2,1,2,3
58227_0,,,,2,1,2,3
58229_0,,,,2,1,2,3
C(CCC(C(CO)O)=O)(C)=O,,,5,1,1,0,1
58231_0,,,,2,1,2,3
C(CC)(CC(C(CO)O)=O)=O,,,5,1,1,0,1
58232_0,,,,2,1,2,3
58233_0,,,,2,1,2,3
58234_0,,,,2,1,2,3
58235_0,,,,2,1,2,3
58236_0,,,,2,1,2,3
58237_0,,,,2,1,2,3
58238_0,,,,2,1,2,3
58239_0,,,,2,1,2,3
58240_0,,,,2,1,2,3
58241_0,,,,2,1,2,3
58242_0,,,,2,1,2,3
58243_0,,,,2,1,2,3
58244_0,,,,2,1,2,3
58245_0,,,,2,1,2,3
58246_0,,,,2,1,2,3
58247_0,,,,2,1,2,3
58248_0,,,,2,1,2,3
58249_0,,,,2,1,2,3
58250_0,,,,2,1,2,3
58251_0,,,,2,1,2,3
58252_0,,,,2,1,2,3
58253_0,,,,2,1,2,3
58254_0,,,,2,1,2,3
58255_0,,,,2,1,2,3
58256_0,,,,2,1,2,3
58257_0,,,,2,1,2,3
58259_0,,,,2,1,2,3
C(C(C(C(C(O)=O)=O)=O)C)(O)=O,,,5,1,1,0,1
58260_0,,,,2,1,2,3
58261_0,,,,2,1,2,3
58262_0,,,,2,1,2,3
58264_0,,,,2,1,2,3
C1(COCC1CC(C(O)=O)=O)=O,,,5,1,1,0,1
58266_0,,,,2,1,2,3
C1(C(CCO1)CC(C(O)=O)=O)=O,,,5,1,1,0,1
58267_0,,,,2,1,2,3
58268_0,,,,2,1,2,3
58270_0,,,,2,1,2,3
C(C)(CCC(C(O)=O)=O)=O,,,5,1,1,0,1
58272_0,,,,2,1,2,3
C(CC)(CC(C(O)=O)=O)=O,,,5,1,1,0,1
58273_0,,,,2,1,2,3
58274_0,,,,2,1,2,3
58275_0,,,,2,1,2,3
58276_0,,,,2,1,2,3
58277_0,,,,2,1,2,3
58278_0,,,,2,1,2,3
58280_0,,,,2,1,2,3
C(CCC(C(C(O)=O)=O)=O)(O)=O,,,5,1,1,0,1
58281_0,,,,2,1,2,3
58282_0,,,,2,1,2,3
58283_0,,,,2,1,2,3
58284_0,,,,2,1,2,3
58285_0,,,,2,1,2,3
58286_0,,,,2,1,2,3
58287_0,,,,2,1,2,3
58288_0,,,,2,1,2,3
58289_0,,,,2,1,2,3
58291_0,,,,2,1,2,3
C(C(C(O)=O)C(C=O)C(O)=O)=O,,,5,1,1,0,1
58293_0,,,,2,1,2,3
C(C(C=O)C1C(COC1)=O)(O)=O,,,5,1,1,0,1
58295_0,,,,2,1,2,3
C(C(C(O)=O)C1C(OCC1)=O)=O,,,5,1,1,0,1
58297_0,,,,2,1,2,3
C(C(C(O)=O)CC(O)=O)=O,,,5,1,2,0,2
58298_0,,,,2,1,2,3
58300_0,,,,2,1,2,3
C(C(C(O)=O)CC(C)=O)=O,,,5,1,1,0,1
58302_0,,,,2,1,2,3
C(C(C(CC)=O)C(O)=O)=O,,,5,1,1,0,1
58303_0,,,,2,1,2,3
58304_0,,,,2,1,2,3
58306_0,,,,2,1,2,3
C(CC(C(C(O)=O)=O)CO)(C)=O,,,5,1,1,0,1
58308_0,,,,2,1,2,3
C(CC)(C(C(C(O)=O)=O)CO)=O,,,5,1,1,0,1
58309_0,,,,2,1,2,3
58310_0,,,,2,1,2,3
58311_0,,,,2,1,2,3
58312_0,,,,2,1,2,3
58313_0,,,,2,1,2,3
58314_0,,,,2,1,2,3
58315_0,,,,2,1,2,3
58316_0,,,,2,1,2,3
58317_0,,,,2,1,2,3
58318_0,,,,2,1,2,3
58319_0,,,,2,1,2,3
58320_0,,,,2,1,2,3
58321_0,,,,2,1,2,3
58322_0,,,,2,1,2,3
58323_0,,,,2,1,2,3
58324_0,,,,2,1,2,3
58325_0,,,,2,1,2,3
58327_0,,,,2,1,2,3
C(C(C(CO)=O)CC(O)=O)(O)=O,,,5,1,2,0,2
58328_0,,,,2,1,2,3
58330_0,,,,2,1,2,3
C(C(C(CO)=O)CC(C)=O)(O)=O,,,5,1,1,0,1
58332_0,,,,2,1,2,3
C(CC)(C(C(O)=O)C(CO)=O)=O,,,5,1,1,0,1
58333_0,,,,2,1,2,3
58334_0,,,,2,1,2,3
58335_0,,,,2,1,2,3
58336_0,,,,2,1,2,3
58338_0,,,,2,1,2,3
C(CC(CC(C(O)O)=O)=O)(O)=O,,,5,1,1,0,1
58340_0,,,,2,1,2,3
C(CC(C(CC(O)O)=O)=O)(O)=O,,,5,1,1,0,1
58342_0,,,,2,1,2,3
C(CC(C(CC(C)=O)O)=O)(O)=O,,,5,1,1,0,1
58344_0,,,,2,1,2,3
C(CC(C(C(CC)=O)O)=O)(O)=O,,,5,1,1,0,1
58346_0,,,,2,1,2,3
C(CC(CC(C(C)O)=O)=O)(O)=O,,,5,1,1,0,1
58347_0,,,,2,1,2,3
58348_0,,,,2,1,2,3
58349_0,,,,2,1,2,3
58350_0,,,,2,1,2,3
58351_0,,,,2,1,2,3
58352_0,,,,2,1,2,3
58353_0,,,,2,1,2,3
58354_0,,,,2,1,2,3
58355_0,,,,2,1,2,3
58356_0,,,,2,1,2,3
58357_0,,,,2,1,2,3
58359_0,,,,2,1,2,3
C(C(C(CCC(C)=O)=O)O)(O)=O,,,5,1,1,0,1
58361_0,,,,2,1,2,3
C(C(C(O)=O)O)(CC(CC)=O)=O,,,5,1,1,0,1
58362_0,,,,2,1,2,3
58363_0,,,,2,1,2,3
58364_0,,,,2,1,2,3
58365_0,,,,2,1,2,3
58366_0,,,,2,1,2,3
58368_0,,,,2,1,2,3
C(C(C=C)C(C(C(O)=O)=O)=O)=O,,,5,1,1,0,1
58370_0,,,,2,1,2,3
C=CC(C(CC(C(O)=O)=O)=O)=O,,,5,1,1,0,1
58372_0,,,,2,1,2,3
C=CC(CC(C(C(O)=O)=O)=O)=O,,,5,1,1,0,1
58374_0,,,,2,1,2,3
C(C=CC(CC(C(O)=O)=O)=O)=O,,,5,1,1,0,1
58376_0,,,,2,1,2,3
C(CC(C(C(O)=O)=O)=O)=CC=O,,,5,1,1,0,1
58377_0,,,,2,1,2,3
58378_0,,,,2,1,2,3
58380_0,,,,2,1,2,3
C(C(O)O)(CC(C(O)=O)=O)=O,,,5,1,1,0,1
58382_0,,,,2,1,2,3
C(C(C(CC(O)O)=O)=O)(O)=O,,,5,1,1,0,1
58383_0,,,,2,1,2,3
58385_0,,,,2,1,2,3
C(CC)(C(C(C(O)=O)=O)O)=O,,,5,1,1,0,1
58386_0,,,,2,1,2,3
58387_0,,,,2,1,2,3
58388_0,,,,2,1,2,3
58389_0,,,,2,1,2,3
58390_0,,,,2,1,2,3
58391_0,,,,2,1,2,3
58392_0,,,,2,1,2,3
58393_0,,,,2,1,2,3
58394_0,,,,2,1,2,3
58395_0,,,,2,1,2,3
58396_0,,,,2,1,2,3
58397_0,,,,2,1,2,3
58398_0,,,,2,1,2,3
58399_0,,,,2,1,2,3
58400_0,,,,2,1,2,3
58401_0,,,,2,1,2,3
58402_0,,,,2,1,2,3
58403_0,,,,2,1,2,3
58404_0,,,,2,1,2,3
58405_0,,,,2,1,2,3
58406_0,,,,2,1,2,3
58407_0,,,,2,1,2,3
58408_0,,,,2,1,2,3
58409_0,,,,2,1,2,3
58410_0,,,,2,1,2,3
58411_0,,,,2,1,2,3
58412_0,,,,2,1,2,3
58413_0,,,,2,1,2,3
58414_0,,,,2,1,2,3
58415_0,,,,2,1,2,3
58416_0,,,,2,1,2,3
58417_0,,,,2,1,2,3
58418_0,,,,2,1,2,3
58419_0,,,,2,1,2,3
58420_0,,,,2,1,2,3
58421_0,,,,2,1,2,3
58422_0,,,,2,1,2,3
58423_0,,,,2,1,2,3
58424_0,,,,2,1,2,3
58425_0,,,,2,1,2,3
58426_0,,,,2,1,2,3
58427_0,,,,2,1,2,3
58428_0,,,,2,1,2,3
58429_0,,,,2,1,2,3
58430_0,,,,2,1,2,3
58431_0,,,,2,1,2,3
58432_0,,,,2,1,2,3
58433_0,,,,2,1,2,3
58434_0,,,,2,1,2,3
58435_0,,,,2,1,2,3
58436_0,,,,2,1,2,3
58437_0,,,,2,1,2,3
58438_0,,,,2,1,2,3
58439_0,,,,2,1,2,3
58440_0,,,,2,1,2,3
58441_0,,,,2,1,2,3
58442_0,,,,2,1,2,3
58443_0,,,,2,1,2,3
58444_0,,,,2,1,2,3
58445_0,,,,2,1,2,3
58446_0,,,,2,1,2,3
58447_0,,,,2,1,2,3
58448_0,,,,2,1,2,3
58449_0,,,,2,1,2,3
58450_0,,,,2,1,2,3
58451_0,,,,2,1,2,3
58452_0,,,,2,1,2,3
58453_0,,,,2,1,2,3
58454_0,,,,2,1,2,3
58455_0,,,,2,1,2,3
58457_0,,,,2,1,2,3
C(C(C)C(C(O)=O)O)(CC=O)=O,,,5,1,1,0,1
58458_0,,,,2,1,2,3
58459_0,,,,2,1,2,3
58461_0,,,,2,1,2,3
C(C(C)CC=O)(C(C(O)=O)O)=O,,,5,1,1,0,1
58462_0,,,,2,1,2,3
58463_0,,,,2,1,2,3
58464_0,,,,2,1,2,3
58465_0,,,,2,1,2,3
58466_0,,,,2,1,2,3
58467_0,,,,2,1,2,3
58468_0,,,,2,1,2,3
58469_0,,,,2,1,2,3
58470_0,,,,2,1,2,3
58471_0,,,,2,1,2,3
58472_0,,,,2,1,2,3
58473_0,,,,2,1,2,3
58474_0,,,,2,1,2,3
58475_0,,,,2,1,2,3
58476_0,,,,2,1,2,3
58477_0,,,,2,1,2,3
58478_0,,,,2,1,2,3
58479_0,,,,2,1,2,3
58480_0,,,,2,1,2,3
58481_0,,,,2,1,2,3
58483_0,,,,2,1,2,3
C(C(CC(C(CC)=O)=O)O)=O,,,5,1,1,0,1
58484_0,,,,2,1,2,3
58485_0,,,,2,1,2,3
58486_0,,,,2,1,2,3
58487_0,,,,2,1,2,3
58488_0,,,,2,1,2,3
58489_0,,,,2,1,2,3
58491_0,,,,2,1,2,3
C(C(C(C(C=O)=O)=O)CC=O)=O,,,5,1,1,0,1
58492_0,,,,2,1,2,3
58493_0,,,,2,1,2,3
58494_0,,,,2,1,2,3
58495_0,,,,2,1,2,3
58497_0,,,,2,1,2,3
C(C(C(C=O)=O)CC(C)=O)=O,,,5,1,1,0,1
58499_0,,,,2,1,2,3
C(C(C(CC)=O)C(C=O)=O)=O,,,5,1,1,0,1
58500_0,,,,2,1,2,3
58501_0,,,,2,1,2,3
58502_0,,,,2,1,2,3
58503_0,,,,2,1,2,3
58504_0,,,,2,1,2,3
58505_0,,,,2,1,2,3
58506_0,,,,2,1,2,3
58507_0,,,,2,1,2,3
58508_0,,,,2,1,2,3
58509_0,,,,2,1,2,3
58510_0,,,,2,1,2,3
58511_0,,,,2,1,2,3
58512_0,,,,2,1,2,3
58513_0,,,,2,1,2,3
58514_0,,,,2,1,2,3
58516_0,,,,2,1,2,3
C(C(CC(C(CC)=O)=O)O)(O)=O,,,5,1,1,0,1
58518_0,,,,2,1,2,3
C(CC(C(CO)=O)CC=O)(O)=O,,,5,1,3,0,3
58519_0,,,,2,1,2,3
58520_0,,,,2,1,2,3
58521_0,,,,2,1,2,3
58522_0,,,,2,1,2,3
58523_0,,,,2,1,2,3
58524_0,,,,2,1,2,3
58525_0,,,,2,1,2,3
58526_0,,,,2,1,2,3
58528_0,,,,2,1,2,3
C(CC(C(C(O)=O)=O)CCO)=O,,,5,1,1,0,1
58529_0,,,,2,1,2,3
58531_0,,,,2,1,2,3
C(C(C(C=O)=O)CC(O)=O)(O)=O,,,5,1,2,0,2
58532_0,,,,2,1,2,3
58534_0,,,,2,1,2,3
C(C(C(C=O)=O)CC(C)=O)(O)=O,,,5,1,1,0,1
58536_0,,,,2,1,2,3
C(CC)(C(C(O)=O)C(C=O)=O)=O,,,5,1,1,0,1
58537_0,,,,2,1,2,3
58538_0,,,,2,1,2,3
58539_0,,,,2,1,2,3
58541_0,,,,2,1,2,3
C(C(C(C(O)=O)=O)CC(C)=O)=O,,,5,1,1,0,1
58543_0,,,,2,1,2,3
C(C(C(CC)=O)C(C(O)=O)=O)=O,,,5,1,1,0,1
58544_0,,,,2,1,2,3
58545_0,,,,2,1,2,3
58547_0,,,,2,1,2,3
C(C(CO)=O)(C1COCC1O)=O,,,5,1,1,0,1
58549_0,,,,2,1,2,3
C1(COCC1C(C(CO)=O)O)=O,,,5,1,1,0,1
58551_0,,,,2,1,2,3
C1(COCC1CC(C=O)=O)=O,,,5,1,1,0,1
58553_0,,,,2,1,2,3
C(C(C=O)C1C(COC1)=O)=O,,,5,1,1,0,1
58555_0,,,,2,1,2,3
C1(COCC1CC=O)=O,,,5,1,1,0,1
58557_0,,,,2,1,2,3
C(C(C(C1COCC1O)=O)=O)=O,,,5,1,1,0,1
58559_0,,,,2,1,2,3
C1(COCC1C(C(C=O)=O)O)=O,,,5,1,1,0,1
58561_0,,,,2,1,2,3
C(C(C1COCC1O)=O)=O,,,5,1,1,0,1
58563_0,,,,2,1,2,3
C1(COCC1C(C=O)O)=O,,,5,1,1,0,1
58565_0,,,,2,1,2,3
C(CC1C(C(CO1)O)=O)(O)=O,,,5,1,2,0,2
58566_0,,,,2,1,2,3
58568_0,,,,2,1,2,3
C(CC1C(C(CO1)O)=O)(C)=O,,,5,1,1,0,1
58570_0,,,,2,1,2,3
C(CC)(C1C(C(CO1)O)=O)=O,,,5,1,1,0,1
58572_0,,,,2,1,2,3
C(CC1C(C(CO1)O)=O)(CO)=O,,,5,1,1,0,1
58573_0,,,,2,1,2,3
58575_0,,,,2,1,2,3
C(CCO)(C1C(C(CO1)O)=O)=O,,,5,1,2,0,2
58576_0,,,,2,1,2,3
58578_0,,,,2,1,2,3
C(C(CO)C1C(C(CO1)O)=O)=O,,,5,1,1,0,1
58580_0,,,,2,1,2,3
C(C(C=O)C1C(C(CO1)O)=O)=O,,,5,1,1,0,1
58582_0,,,,2,1,2,3
C(CC1C(C(CO1)O)=O)=O,,,5,1,2,0,2
58584_0,,,,2,1,2,3
C1(C(COC1C(C)=O)O)=O,,,5,1,2,0,2
58586_0,,,,2,1,2,3
C(C(CO)=O)(C1C(O)OCC1)=O,,,5,1,2,0,2
58588_0,,,,2,1,2,3
C1(C(CCO1)C(C(CO)=O)O)=O,,,5,1,1,0,1
58590_0,,,,2,1,2,3
C1(C(CCO1)CC(C=O)=O)=O,,,5,1,1,0,1
58592_0,,,,2,1,2,3
C(C(C=O)C1C(OCC1)=O)=O,,,5,1,1,0,1
58594_0,,,,2,1,2,3
C(CC1C(OCC1)=O)=O,,,5,1,1,0,1
58596_0,,,,2,1,2,3
C(C(C(C1C(O)OCC1)=O)=O)=O,,,5,1,2,0,2
58598_0,,,,2,1,2,3
C1(C(CCO1)C(C(C=O)=O)O)=O,,,5,1,1,0,1
58600_0,,,,2,1,2,3
C(C(C1C(O)OCC1)=O)=O,,,5,1,2,0,2
58602_0,,,,2,1,2,3
C1(C(CCO1)C(C=O)O)=O,,,5,1,1,0,1
58604_0,,,,2,1,2,3
C(CC1C(C(O)OC1)=O)(O)=O,,,5,1,1,0,1
58605_0,,,,2,1,2,3
58607_0,,,,2,1,2,3
C(CC1C(C(O)OC1)=O)(C)=O,,,5,1,1,0,1
58609_0,,,,2,1,2,3
C(CC)(C1C(C(O)OC1)=O)=O,,,5,1,1,0,1
58611_0,,,,2,1,2,3
C(CC1C(C(O)OC1)=O)(CO)=O,,,5,1,2,0,2
58612_0,,,,2,1,2,3
58614_0,,,,2,1,2,3
C(CCO)(C1C(C(O)OC1)=O)=O,,,5,1,3,0,3
58615_0,,,,2,1,2,3
58617_0,,,,2,1,2,3
C(C(CO)C1C(C(O)OC1)=O)=O,,,5,1,2,0,2
58619_0,,,,2,1,2,3
C(C(C=O)C1C(C(O)OC1)=O)=O,,,5,1,2,0,2
58621_0,,,,2,1,2,3
C(CC1C(C(O)OC1)=O)=O,,,5,1,3,0,3
58623_0,,,,2,1,2,3
C(C)(C1C(C(O)OC1)=O)=O,,,5,1,3,0,3
58625_0,,,,2,1,2,3
C(C(CO)=O)(C1COC(C1)O)=O,,,5,1,2,0,2
58627_0,,,,2,1,2,3
C(C(C(C1COC(C1)O)=O)=O)=O,,,5,1,2,0,2
58629_0,,,,2,1,2,3
C(C(C1COC(C1)O)=O)=O,,,5,1,2,0,2
58631_0,,,,2,1,2,3
C1(COC(C1CC(O)=O)O)=O,,,5,1,1,0,1
58632_0,,,,2,1,2,3
58634_0,,,,2,1,2,3
C1(COC(C1CC(C)=O)O)=O,,,5,1,1,0,1
58636_0,,,,2,1,2,3
C(CC)(C1C(COC1O)=O)=O,,,5,1,1,0,1
58637_0,,,,2,1,2,3
58638_0,,,,2,1,2,3
58640_0,,,,2,1,2,3
C(CCO)(C1C(COC1O)=O)=O,,,5,1,2,0,2
58641_0,,,,2,1,2,3
58642_0,,,,2,1,2,3
58644_0,,,,2,1,2,3
C(C(C=O)C1C(COC1O)=O)=O,,,5,1,3,0,3
58646_0,,,,2,1,2,3
C1(COC(C1CC=O)O)=O,,,5,1,3,0,3
58648_0,,,,2,1,2,3
C(C)(C1C(COC1O)=O)=O,,,5,1,3,0,3
58650_0,,,,2,1,2,3
C(CC1C(CC(O1)O)=O)(O)=O,,,5,1,1,0,1
58651_0,,,,2,1,2,3
58653_0,,,,2,1,2,3
C(CC1C(CC(O1)O)=O)(C)=O,,,5,1,1,0,1
58655_0,,,,2,1,2,3
C(CC)(C1C(CC(O1)O)=O)=O,,,5,1,1,0,1
58657_0,,,,2,1,2,3
C(CC1C(CC(O1)O)=O)(CO)=O,,,5,1,2,0,2
58658_0,,,,2,1,2,3
58660_0,,,,2,1,2,3
C(CCO)(C1C(CC(O1)O)=O)=O,,,5,1,2,0,2
58661_0,,,,2,1,2,3
58663_0,,,,2,1,2,3
C(C(CO)C1C(CC(O1)O)=O)=O,,,5,1,2,0,2
58665_0,,,,2,1,2,3
C(C(C=O)C1C(CC(O1)O)=O)=O,,,5,1,3,0,3
58667_0,,,,2,1,2,3
C(CC1C(CC(O1)O)=O)=O,,,5,1,3,0,3
58669_0,,,,2,1,2,3
C1(CC(OC1C(C)=O)O)=O,,,5,1,3,0,3
58671_0,,,,2,1,2,3
C(C(C(C)=O)C(C(C=O)=O)=O)=O,,,5,1,1,0,1
58672_0,,,,2,1,2,3
58673_0,,,,2,1,2,3
58675_0,,,,2,1,2,3
C(C(C(C(C(CO)=O)=O)C)=O)=O,,,5,1,2,0,2
58677_0,,,,2,1,2,3
C(C(C(C(C(C=O)=O)=O)C)=O)=O,,,5,1,2,0,2
58678_0,,,,2,1,2,3
58679_0,,,,2,1,2,3
58680_0,,,,2,1,2,3
58682_0,,,,2,1,2,3
C(C)(CCC(C(C=O)=O)=O)=O,,,5,1,1,0,1
58684_0,,,,2,1,2,3
C(CC)(CC(C(C=O)=O)=O)=O,,,5,1,1,0,1
58685_0,,,,2,1,2,3
58686_0,,,,2,1,2,3
58687_0,,,,2,1,2,3
58688_0,,,,2,1,2,3
58689_0,,,,2,1,2,3
58690_0,,,,2,1,2,3
58691_0,,,,2,1,2,3
58692_0,,,,2,1,2,3
58694_0,,,,2,1,2,3
C(C(C=C)C(C(CO)=O)=O)=O,,,5,1,2,0,2
58696_0,,,,2,1,2,3
C(C(C=C)C(C(CC=O)=O)=O)=O,,,5,1,1,0,1
58698_0,,,,2,1,2,3
C(C(C=C)C(C(C=O)=O)=O)=O,,,5,1,2,0,2
58700_0,,,,2,1,2,3
C(C(C=C)C(C=O)=O)=O,,,5,1,5,0,5
58702_0,,,,2,1,2,3
C=CC(CC(C(CO)=O)=O)=O,,,5,1,2,0,2
58704_0,,,,2,1,2,3
C(CO)(CC(C(C=C)=O)=O)=O,,,5,1,2,0,2
58706_0,,,,2,1,2,3
C(CC(C(CC(C=C)=O)=O)=O)=O,,,5,1,1,0,1
58708_0,,,,2,1,2,3
C(CC(CC(C(C=C)=O)=O)=O)=O,,,5,1,1,0,1
58710_0,,,,2,1,2,3
C=CC(CC(C(C=O)=O)=O)=O,,,5,1,2,0,2
58712_0,,,,2,1,2,3
C=CC(C(CC(C=O)=O)=O)=O,,,5,1,2,0,2
58714_0,,,,2,1,2,3
C=CC(CC(C=O)=O)=O,,,5,1,3,0,3
58716_0,,,,2,1,2,3
C(CC(C(C=C)=O)=O)=O,,,5,1,2,0,2
58717_0,,,,2,1,2,3
58719_0,,,,2,1,2,3
C(CO)(CC(C=CC=O)=O)=O,,,5,1,3,0,3
58721_0,,,,2,1,2,3
C(CC(C(CC=CC=O)=O)=O)=O,,,5,1,1,0,1
58723_0,,,,2,1,2,3
C(CC(CC(C=CC=O)=O)=O)=O,,,5,1,1,0,1
58725_0,,,,2,1,2,3
C(CC(C(C=O)=O)=O)=CC=O,,,5,1,3,0,3
58727_0,,,,2,1,2,3
C(C(CC(C=CC=O)=O)=O)=O,,,5,1,3,0,3
58728_0,,,,2,1,2,3
58730_0,,,,2,1,2,3
C(CC(C=CC=O)=O)=O,,,5,1,4,0,4
58731_0,,,,2,1,2,3
58732_0,,,,2,1,2,3
58733_0,,,,2,1,2,3
58735_0,,,,2,1,2,3
C(CC(C1COC(C1O)O)=O)=O,,,5,1,2,0,2
58737_0,,,,2,1,2,3
C1(C(C(CO1)O)CC(C=O)=O)=O,,,5,1,2,0,2
58738_0,,,,2,1,2,3
58740_0,,,,2,1,2,3
C(C(C=O)C1C(OCC1O)=O)=O,,,5,1,2,0,2
58741_0,,,,2,1,2,3
58743_0,,,,2,1,2,3
C1(C(C(CO1)O)CC=O)=O,,,5,1,2,0,2
58744_0,,,,2,1,2,3
58745_0,,,,2,1,2,3
58747_0,,,,2,1,2,3
C(C(CO)=O)(CC(O)O)=O,,,5,1,1,0,1
58748_0,,,,2,1,2,3
58750_0,,,,2,1,2,3
C(CO)(CC(C(O)O)=O)=O,,,5,1,1,0,1
58751_0,,,,2,1,2,3
58753_0,,,,2,1,2,3
C(C(C(CO)O)=O)(CC(O)O)=O,,,5,1,1,0,1
58754_0,,,,2,1,2,3
58755_0,,,,2,1,2,3
58756_0,,,,2,1,2,3
58758_0,,,,2,1,2,3
C(C(CO)O)(CC(C(O)O)=O)=O,,,5,1,1,0,1
58759_0,,,,2,1,2,3
58760_0,,,,2,1,2,3
58761_0,,,,2,1,2,3
58762_0,,,,2,1,2,3
58763_0,,,,2,1,2,3
58764_0,,,,2,1,2,3
58765_0,,,,2,1,2,3
58766_0,,,,2,1,2,3
58767_0,,,,2,1,2,3
58768_0,,,,2,1,2,3
58769_0,,,,2,1,2,3
58771_0,,,,2,1,2,3
C(CC(C(CC(O)O)=O)=O)=O,,,5,1,1,0,1
58772_0,,,,2,1,2,3
58774_0,,,,2,1,2,3
C(CC(CC(C(O)O)=O)=O)=O,,,5,1,1,0,1
58775_0,,,,2,1,2,3
58776_0,,,,2,1,2,3
58777_0,,,,2,1,2,3
58778_0,,,,2,1,2,3
58779_0,,,,2,1,2,3
58781_0,,,,2,1,2,3
C(C(C(CC(O)O)=O)=O)=O,,,5,1,1,0,1
58782_0,,,,2,1,2,3
58784_0,,,,2,1,2,3
C(C(O)O)(CC(C=O)=O)=O,,,5,1,1,0,1
58785_0,,,,2,1,2,3
58787_0,,,,2,1,2,3
C(C(CC(O)O)=O)=O,,,5,1,1,0,1
58788_0,,,,2,1,2,3
58790_0,,,,2,1,2,3
C(CC(C(O)O)=O)=O,,,5,1,1,0,1
58791_0,,,,2,1,2,3
58792_0,,,,2,1,2,3
58793_0,,,,2,1,2,3
58794_0,,,,2,1,2,3
58795_0,,,,2,1,2,3
58796_0,,,,2,1,2,3
58797_0,,,,2,1,2,3
58798_0,,,,2,1,2,3
58800_0,,,,2,1,2,3
C(CC(C(C(CO)O)=O)O)(C)=O,,,5,1,1,0,1
58801_0,,,,2,1,2,3
58803_0,,,,2,1,2,3
C(CC)(C(C(C(CO)O)=O)O)=O,,,5,1,1,0,1
58804_0,,,,2,1,2,3
58806_0,,,,2,1,2,3
C(CC)(CC(C=O)=O)=O,,,5,1,1,0,1
58808_0,,,,2,1,2,3
C(C(C=O)CC(C)=O)=O,,,5,1,1,0,1
58810_0,,,,2,1,2,3
C(C(C=O)C(CC)=O)=O,,,5,1,1,0,1
58812_0,,,,2,1,2,3
C(CC(C(C=O)=O)CO)(C)=O,,,5,1,2,0,2
58814_0,,,,2,1,2,3
C(CC)(C(C(C=O)=O)CO)=O,,,5,1,1,0,1
58816_0,,,,2,1,2,3
C(C(C(C=O)CC(C)=O)O)=O,,,5,1,2,0,2
58818_0,,,,2,1,2,3
C(CC)(C(C=O)C(C=O)O)=O,,,5,1,1,0,1
58820_0,,,,2,1,2,3
C(C(C(CO)=O)CC(C)=O)=O,,,5,1,1,0,1
58822_0,,,,2,1,2,3
C(CC)(C(C=O)C(CO)=O)=O,,,5,1,1,0,1
58823_0,,,,2,1,2,3
58825_0,,,,2,1,2,3
C(CC(C(CC(C)=O)O)=O)=O,,,5,1,1,0,1
58827_0,,,,2,1,2,3
C(CC(CC(C(C)O)=O)=O)=O,,,5,1,1,0,1
58829_0,,,,2,1,2,3
C(CC(C(C(CC)=O)O)=O)=O,,,5,1,1,0,1
58831_0,,,,2,1,2,3
C(C(C(CCC(C)=O)=O)O)=O,,,5,1,1,0,1
58833_0,,,,2,1,2,3
C(C(C=O)O)(CC(CC)=O)=O,,,5,1,1,0,1
58835_0,,,,2,1,2,3
C(CCC(C)=O)=O,,,5,1,1,0,1
58836_0,,,,2,1,2,3
58837_0,,,,2,1,2,3
58838_0,,,,2,1,2,3
58839_0,,,,2,1,2,3
58841_0,,,,2,1,2,3
C(CC)(C(C(C=O)=O)O)=O,,,5,1,1,0,1
58842_0,,,,2,1,2,3
58843_0,,,,2,1,2,3
58844_0,,,,2,1,2,3
58845_0,,,,2,1,2,3
58846_0,,,,2,1,2,3
58847_0,,,,2,1,2,3
58848_0,,,,2,1,2,3
58849_0,,,,2,1,2,3
58851_0,,,,2,1,2,3
C(C(C(CC(O)=O)=O)(C)O)=O,,,5,1,1,0,1
58852_0,,,,2,1,2,3
58853_0,,,,2,1,2,3
58854_0,,,,2,1,2,3
58855_0,,,,2,1,2,3
58856_0,,,,2,1,2,3
58857_0,,,,2,1,2,3
58858_0,,,,2,1,2,3
58859_0,,,,2,1,2,3
58860_0,,,,2,1,2,3
58861_0,,,,2,1,2,3
58862_0,,,,2,1,2,3
58863_0,,,,2,1,2,3
58864_0,,,,2,1,2,3
58865_0,,,,2,1,2,3
58866_0,,,,2,1,2,3
58867_0,,,,2,1,2,3
58868_0,,,,2,1,2,3
58869_0,,,,2,1,2,3
58870_0,,,,2,1,2,3
58871_0,,,,2,1,2,3
58872_0,,,,2,1,2,3
58873_0,,,,2,1,2,3
58874_0,,,,2,1,2,3
58875_0,,,,2,1,2,3
58876_0,,,,2,1,2,3
58877_0,,,,2,1,2,3
58878_0,,,,2,1,2,3
58879_0,,,,2,1,2,3
58880_0,,,,2,1,2,3
58881_0,,,,2,1,2,3
58882_0,,,,2,1,2,3
58883_0,,,,2,1,2,3
58884_0,,,,2,1,2,3
58885_0,,,,2,1,2,3
58886_0,,,,2,1,2,3
58887_0,,,,2,1,2,3
58888_0,,,,2,1,2,3
58889_0,,,,2,1,2,3
58890_0,,,,2,1,2,3
58891_0,,,,2,1,2,3
58892_0,,,,2,1,2,3
58893_0,,,,2,1,2,3
58894_0,,,,2,1,2,3
58895_0,,,,2,1,2,3
58896_0,,,,2,1,2,3
58897_0,,,,2,1,2,3
58898_0,,,,2,1,2,3
58899_0,,,,2,1,2,3
58900_0,,,,2,1,2,3
58901_0,,,,2,1,2,3
58902_0,,,,2,1,2,3
58903_0,,,,2,1,2,3
58904_0,,,,2,1,2,3
58905_0,,,,2,1,2,3
58906_0,,,,2,1,2,3
58907_0,,,,2,1,2,3
58908_0,,,,2,1,2,3
58909_0,,,,2,1,2,3
58910_0,,,,2,1,2,3
58911_0,,,,2,1,2,3
58912_0,,,,2,1,2,3
58913_0,,,,2,1,2,3
58914_0,,,,2,1,2,3
58915_0,,,,2,1,2,3
58916_0,,,,2,1,2,3
58917_0,,,,2,1,2,3
58918_0,,,,2,1,2,3
58919_0,,,,2,1,2,3
58920_0,,,,2,1,2,3
58921_0,,,,2,1,2,3
58922_0,,,,2,1,2,3
58924_0,,,,2,1,2,3
C(C(C(CC=O)=O)(C)O)=O,,,5,1,2,0,2
58925_0,,,,2,1,2,3
58926_0,,,,2,1,2,3
58927_0,,,,2,1,2,3
58928_0,,,,2,1,2,3
58929_0,,,,2,1,2,3
58930_0,,,,2,1,2,3
58932_0,,,,2,1,2,3
C(C(C(CC=O)=O)(CCO)O)=O,,,5,1,2,0,2
58933_0,,,,2,1,2,3
58934_0,,,,2,1,2,3
58935_0,,,,2,1,2,3
58936_0,,,,2,1,2,3
58937_0,,,,2,1,2,3
58938_0,,,,2,1,2,3
58939_0,,,,2,1,2,3
58940_0,,,,2,1,2,3
58941_0,,,,2,1,2,3
58942_0,,,,2,1,2,3
58943_0,,,,2,1,2,3
58944_0,,,,2,1,2,3
58945_0,,,,2,1,2,3
58946_0,,,,2,1,2,3
58947_0,,,,2,1,2,3
58948_0,,,,2,1,2,3
58949_0,,,,2,1,2,3
58950_0,,,,2,1,2,3
58951_0,,,,2,1,2,3
58952_0,,,,2,1,2,3
58953_0,,,,2,1,2,3
58954_0,,,,2,1,2,3
58955_0,,,,2,1,2,3
58956_0,,,,2,1,2,3
58957_0,,,,2,1,2,3
58958_0,,,,2,1,2,3
58959_0,,,,2,1,2,3
58961_0,,,,2,1,2,3
C(C(C(CC(CO)=O)=O)(C)O)=O,,,5,1,2,0,2
58962_0,,,,2,1,2,3
58963_0,,,,2,1,2,3
58964_0,,,,2,1,2,3
58965_0,,,,2,1,2,3
58966_0,,,,2,1,2,3
58967_0,,,,2,1,2,3
58968_0,,,,2,1,2,3
58969_0,,,,2,1,2,3
58970_0,,,,2,1,2,3
58971_0,,,,2,1,2,3
58972_0,,,,2,1,2,3
58973_0,,,,2,1,2,3
58974_0,,,,2,1,2,3
58975_0,,,,2,1,2,3
58976_0,,,,2,1,2,3
58977_0,,,,2,1,2,3
58978_0,,,,2,1,2,3
58979_0,,,,2,1,2,3
58980_0,,,,2,1,2,3
58981_0,,,,2,1,2,3
58982_0,,,,2,1,2,3
58983_0,,,,2,1,2,3
58984_0,,,,2,1,2,3
58985_0,,,,2,1,2,3
58986_0,,,,2,1,2,3
58987_0,,,,2,1,2,3
58988_0,,,,2,1,2,3
58989_0,,,,2,1,2,3
58990_0,,,,2,1,2,3
58991_0,,,,2,1,2,3
58992_0,,,,2,1,2,3
58993_0,,,,2,1,2,3
58994_0,,,,2,1,2,3
58995_0,,,,2,1,2,3
58996_0,,,,2,1,2,3
58997_0,,,,2,1,2,3
58998_0,,,,2,1,2,3
58999_0,,,,2,1,2,3
59000_0,,,,2,1,2,3
59001_0,,,,2,1,2,3
59002_0,,,,2,1,2,3
59003_0,,,,2,1,2,3
59004_0,,,,2,1,2,3
59005_0,,,,2,1,2,3
59006_0,,,,2,1,2,3
59007_0,,,,2,1,2,3
59008_0,,,,2,1,2,3
59009_0,,,,2,1,2,3
59010_0,,,,2,1,2,3
59011_0,,,,2,1,2,3
59012_0,,,,2,1,2,3
59013_0,,,,2,1,2,3
59014_0,,,,2,1,2,3
59015_0,,,,2,1,2,3
59016_0,,,,2,1,2,3
59017_0,,,,2,1,2,3
59018_0,,,,2,1,2,3
59019_0,,,,2,1,2,3
59020_0,,,,2,1,2,3
59021_0,,,,2,1,2,3
59022_0,,,,2,1,2,3
59023_0,,,,2,1,2,3
59024_0,,,,2,1,2,3
59025_0,,,,2,1,2,3
59026_0,,,,2,1,2,3
59027_0,,,,2,1,2,3
59028_0,,,,2,1,2,3
59029_0,,,,2,1,2,3
59030_0,,,,2,1,2,3
59031_0,,,,2,1,2,3
59032_0,,,,2,1,2,3
59033_0,,,,2,1,2,3
59034_0,,,,2,1,2,3
59035_0,,,,2,1,2,3
59036_0,,,,2,1,2,3
59037_0,,,,2,1,2,3
59038_0,,,,2,1,2,3
59040_0,,,,2,1,2,3
C(C(C(CC=O)=O)(C(C)=O)O)=O,,,5,1,2,0,2
59041_0,,,,2,1,2,3
59042_0,,,,2,1,2,3
59043_0,,,,2,1,2,3
59044_0,,,,2,1,2,3
59045_0,,,,2,1,2,3
59046_0,,,,2,1,2,3
59047_0,,,,2,1,2,3
59048_0,,,,2,1,2,3
59049_0,,,,2,1,2,3
59050_0,,,,2,1,2,3
59051_0,,,,2,1,2,3
59052_0,,,,2,1,2,3
59053_0,,,,2,1,2,3
59054_0,,,,2,1,2,3
59055_0,,,,2,1,2,3
59056_0,,,,2,1,2,3
59057_0,,,,2,1,2,3
59058_0,,,,2,1,2,3
59059_0,,,,2,1,2,3
59060_0,,,,2,1,2,3
59061_0,,,,2,1,2,3
59062_0,,,,2,1,2,3
59063_0,,,,2,1,2,3
59064_0,,,,2,1,2,3
59065_0,,,,2,1,2,3
59066_0,,,,2,1,2,3
59067_0,,,,2,1,2,3
59068_0,,,,2,1,2,3
59069_0,,,,2,1,2,3
59070_0,,,,2,1,2,3
59071_0,,,,2,1,2,3
59072_0,,,,2,1,2,3
59073_0,,,,2,1,2,3
59074_0,,,,2,1,2,3
59075_0,,,,2,1,2,3
59076_0,,,,2,1,2,3
59077_0,,,,2,1,2,3
59078_0,,,,2,1,2,3
59079_0,,,,2,1,2,3
59080_0,,,,2,1,2,3
59081_0,,,,2,1,2,3
59082_0,,,,2,1,2,3
59083_0,,,,2,1,2,3
59084_0,,,,2,1,2,3
59085_0,,,,2,1,2,3
59086_0,,,,2,1,2,3
59087_0,,,,2,1,2,3
59088_0,,,,2,1,2,3
59089_0,,,,2,1,2,3
59090_0,,,,2,1,2,3
59091_0,,,,2,1,2,3
59092_0,,,,2,1,2,3
59093_0,,,,2,1,2,3
59094_0,,,,2,1,2,3
59095_0,,,,2,1,2,3
59096_0,,,,2,1,2,3
59097_0,,,,2,1,2,3
59098_0,,,,2,1,2,3
59099_0,,,,2,1,2,3
59100_0,,,,2,1,2,3
59101_0,,,,2,1,2,3
59102_0,,,,2,1,2,3
59103_0,,,,2,1,2,3
59104_0,,,,2,1,2,3
59105_0,,,,2,1,2,3
59106_0,,,,2,1,2,3
59107_0,,,,2,1,2,3
59108_0,,,,2,1,2,3
59109_0,,,,2,1,2,3
59110_0,,,,2,1,2,3
59111_0,,,,2,1,2,3
59112_0,,,,2,1,2,3
59113_0,,,,2,1,2,3
59114_0,,,,2,1,2,3
59115_0,,,,2,1,2,3
59116_0,,,,2,1,2,3
59117_0,,,,2,1,2,3
59118_0,,,,2,1,2,3
59119_0,,,,2,1,2,3
59120_0,,,,2,1,2,3
59121_0,,,,2,1,2,3
59122_0,,,,2,1,2,3
59123_0,,,,2,1,2,3
59124_0,,,,2,1,2,3
59125_0,,,,2,1,2,3
59126_0,,,,2,1,2,3
59127_0,,,,2,1,2,3
59128_0,,,,2,1,2,3
59129_0,,,,2,1,2,3
59130_0,,,,2,1,2,3
59131_0,,,,2,1,2,3
59132_0,,,,2,1,2,3
59133_0,,,,2,1,2,3
59134_0,,,,2,1,2,3
59135_0,,,,2,1,2,3
59136_0,,,,2,1,2,3
59137_0,,,,2,1,2,3
59138_0,,,,2,1,2,3
59139_0,,,,2,1,2,3
59140_0,,,,2,1,2,3
59141_0,,,,2,1,2,3
59142_0,,,,2,1,2,3
59143_0,,,,2,1,2,3
59144_0,,,,2,1,2,3
59145_0,,,,2,1,2,3
59146_0,,,,2,1,2,3
59147_0,,,,2,1,2,3
59148_0,,,,2,1,2,3
59149_0,,,,2,1,2,3
59150_0,,,,2,1,2,3
59151_0,,,,2,1,2,3
59152_0,,,,2,1,2,3
59153_0,,,,2,1,2,3
59155_0,,,,2,1,2,3
C(C(C)C(C(CO)=O)(CO)O)=O,,,5,1,1,0,1
59156_0,,,,2,1,2,3
59157_0,,,,2,1,2,3
59158_0,,,,2,1,2,3
59159_0,,,,2,1,2,3
59160_0,,,,2,1,2,3
59161_0,,,,2,1,2,3
59162_0,,,,2,1,2,3
59163_0,,,,2,1,2,3
59164_0,,,,2,1,2,3
59165_0,,,,2,1,2,3
59166_0,,,,2,1,2,3
59167_0,,,,2,1,2,3
59168_0,,,,2,1,2,3
59169_0,,,,2,1,2,3
59170_0,,,,2,1,2,3
59172_0,,,,2,1,2,3
C(C(C)C(C=O)(C(C)=O)O)=O,,,5,1,1,0,1
59173_0,,,,2,1,2,3
59175_0,,,,2,1,2,3
C(C(C)C(C(C=O)=O)(CO)O)=O,,,5,1,2,0,2
59176_0,,,,2,1,2,3
59177_0,,,,2,1,2,3
59179_0,,,,2,1,2,3
C(C(C)C(C=O)(CO)O)=O,,,5,1,1,0,1
59180_0,,,,2,1,2,3
59181_0,,,,2,1,2,3
59182_0,,,,2,1,2,3
59183_0,,,,2,1,2,3
59184_0,,,,2,1,2,3
59185_0,,,,2,1,2,3
59186_0,,,,2,1,2,3
59188_0,,,,2,1,2,3
C(C(C)C(C=O)(C(CO)O)O)=O,,,5,1,1,0,1
59189_0,,,,2,1,2,3
59190_0,,,,2,1,2,3
59191_0,,,,2,1,2,3
59192_0,,,,2,1,2,3
59193_0,,,,2,1,2,3
59194_0,,,,2,1,2,3
59195_0,,,,2,1,2,3
59196_0,,,,2,1,2,3
59197_0,,,,2,1,2,3
59198_0,,,,2,1,2,3
59199_0,,,,2,1,2,3
59200_0,,,,2,1,2,3
59201_0,,,,2,1,2,3
59202_0,,,,2,1,2,3
59203_0,,,,2,1,2,3
59204_0,,,,2,1,2,3
59205_0,,,,2,1,2,3
59206_0,,,,2,1,2,3
59207_0,,,,2,1,2,3
59208_0,,,,2,1,2,3
59209_0,,,,2,1,2,3
59210_0,,,,2,1,2,3
59211_0,,,,2,1,2,3
59212_0,,,,2,1,2,3
59213_0,,,,2,1,2,3
59214_0,,,,2,1,2,3
59215_0,,,,2,1,2,3
59216_0,,,,2,1,2,3
59217_0,,,,2,1,2,3
59218_0,,,,2,1,2,3
59219_0,,,,2,1,2,3
59220_0,,,,2,1,2,3
59221_0,,,,2,1,2,3
59222_0,,,,2,1,2,3
59223_0,,,,2,1,2,3
59224_0,,,,2,1,2,3
59225_0,,,,2,1,2,3
59226_0,,,,2,1,2,3
59227_0,,,,2,1,2,3
59228_0,,,,2,1,2,3
59229_0,,,,2,1,2,3
59230_0,,,,2,1,2,3
59231_0,,,,2,1,2,3
59232_0,,,,2,1,2,3
59233_0,,,,2,1,2,3
59234_0,,,,2,1,2,3
59235_0,,,,2,1,2,3
59236_0,,,,2,1,2,3
59238_0,,,,2,1,2,3
C(C(C)C(C(O)=O)(C)O)=O,,,5,1,1,0,1
59240_0,,,,2,1,2,3
C(C(C)C(C(O)=O)(CCO)O)=O,,,5,1,1,0,1
59241_0,,,,2,1,2,3
59242_0,,,,2,1,2,3
59243_0,,,,2,1,2,3
59244_0,,,,2,1,2,3
59245_0,,,,2,1,2,3
59246_0,,,,2,1,2,3
59247_0,,,,2,1,2,3
59248_0,,,,2,1,2,3
59249_0,,,,2,1,2,3
59250_0,,,,2,1,2,3
59251_0,,,,2,1,2,3
59252_0,,,,2,1,2,3
59253_0,,,,2,1,2,3
59254_0,,,,2,1,2,3
59255_0,,,,2,1,2,3
59256_0,,,,2,1,2,3
59257_0,,,,2,1,2,3
59258_0,,,,2,1,2,3
59259_0,,,,2,1,2,3
59260_0,,,,2,1,2,3
59261_0,,,,2,1,2,3
59262_0,,,,2,1,2,3
59263_0,,,,2,1,2,3
59264_0,,,,2,1,2,3
59265_0,,,,2,1,2,3
59266_0,,,,2,1,2,3
59267_0,,,,2,1,2,3
59268_0,,,,2,1,2,3
59269_0,,,,2,1,2,3
59270_0,,,,2,1,2,3
59271_0,,,,2,1,2,3
59272_0,,,,2,1,2,3
59273_0,,,,2,1,2,3
59274_0,,,,2,1,2,3
59275_0,,,,2,1,2,3
59276_0,,,,2,1,2,3
59277_0,,,,2,1,2,3
59278_0,,,,2,1,2,3
59279_0,,,,2,1,2,3
59280_0,,,,2,1,2,3
59281_0,,,,2,1,2,3
59282_0,,,,2,1,2,3
59283_0,,,,2,1,2,3
59284_0,,,,2,1,2,3
59285_0,,,,2,1,2,3
59286_0,,,,2,1,2,3
59287_0,,,,2,1,2,3
59288_0,,,,2,1,2,3
59289_0,,,,2,1,2,3
59290_0,,,,2,1,2,3
59291_0,,,,2,1,2,3
59292_0,,,,2,1,2,3
59293_0,,,,2,1,2,3
59294_0,,,,2,1,2,3
59295_0,,,,2,1,2,3
59296_0,,,,2,1,2,3
59297_0,,,,2,1,2,3
59298_0,,,,2,1,2,3
59299_0,,,,2,1,2,3
59300_0,,,,2,1,2,3
59301_0,,,,2,1,2,3
59302_0,,,,2,1,2,3
59303_0,,,,2,1,2,3
59304_0,,,,2,1,2,3
59305_0,,,,2,1,2,3
59306_0,,,,2,1,2,3
59307_0,,,,2,1,2,3
59308_0,,,,2,1,2,3
59309_0,,,,2,1,2,3
59310_0,,,,2,1,2,3
59311_0,,,,2,1,2,3
59312_0,,,,2,1,2,3
59313_0,,,,2,1,2,3
59314_0,,,,2,1,2,3
59315_0,,,,2,1,2,3
59316_0,,,,2,1,2,3
59317_0,,,,2,1,2,3
59318_0,,,,2,1,2,3
59319_0,,,,2,1,2,3
59320_0,,,,2,1,2,3
59321_0,,,,2,1,2,3
59322_0,,,,2,1,2,3
59323_0,,,,2,1,2,3
59324_0,,,,2,1,2,3
59325_0,,,,2,1,2,3
59326_0,,,,2,1,2,3
59327_0,,,,2,1,2,3
59328_0,,,,2,1,2,3
59329_0,,,,2,1,2,3
59330_0,,,,2,1,2,3
59331_0,,,,2,1,2,3
59332_0,,,,2,1,2,3
59333_0,,,,2,1,2,3
59334_0,,,,2,1,2,3
59335_0,,,,2,1,2,3
59336_0,,,,2,1,2,3
59337_0,,,,2,1,2,3
59338_0,,,,2,1,2,3
59339_0,,,,2,1,2,3
59340_0,,,,2,1,2,3
59341_0,,,,2,1,2,3
59342_0,,,,2,1,2,3
59343_0,,,,2,1,2,3
59344_0,,,,2,1,2,3
59345_0,,,,2,1,2,3
59346_0,,,,2,1,2,3
59347_0,,,,2,1,2,3
59348_0,,,,2,1,2,3
59349_0,,,,2,1,2,3
59350_0,,,,2,1,2,3
59351_0,,,,2,1,2,3
59352_0,,,,2,1,2,3
59353_0,,,,2,1,2,3
59354_0,,,,2,1,2,3
59355_0,,,,2,1,2,3
59356_0,,,,2,1,2,3
59357_0,,,,2,1,2,3
59358_0,,,,2,1,2,3
59359_0,,,,2,1,2,3
59360_0,,,,2,1,2,3
59361_0,,,,2,1,2,3
59362_0,,,,2,1,2,3
59363_0,,,,2,1,2,3
59364_0,,,,2,1,2,3
59365_0,,,,2,1,2,3
59366_0,,,,2,1,2,3
59367_0,,,,2,1,2,3
59368_0,,,,2,1,2,3
59369_0,,,,2,1,2,3
59370_0,,,,2,1,2,3
59371_0,,,,2,1,2,3
59372_0,,,,2,1,2,3
59373_0,,,,2,1,2,3
59374_0,,,,2,1,2,3
59375_0,,,,2,1,2,3
59376_0,,,,2,1,2,3
59377_0,,,,2,1,2,3
59378_0,,,,2,1,2,3
59379_0,,,,2,1,2,3
59380_0,,,,2,1,2,3
59381_0,,,,2,1,2,3
59382_0,,,,2,1,2,3
59383_0,,,,2,1,2,3
59384_0,,,,2,1,2,3
59385_0,,,,2,1,2,3
59386_0,,,,2,1,2,3
59387_0,,,,2,1,2,3
59388_0,,,,2,1,2,3
59389_0,,,,2,1,2,3
59390_0,,,,2,1,2,3
59391_0,,,,2,1,2,3
59392_0,,,,2,1,2,3
59393_0,,,,2,1,2,3
59394_0,,,,2,1,2,3
59395_0,,,,2,1,2,3
59396_0,,,,2,1,2,3
59397_0,,,,2,1,2,3
59398_0,,,,2,1,2,3
59399_0,,,,2,1,2,3
59400_0,,,,2,1,2,3
59401_0,,,,2,1,2,3
59402_0,,,,2,1,2,3
59403_0,,,,2,1,2,3
59404_0,,,,2,1,2,3
59406_0,,,,2,1,2,3
C(C1C(CC(C1O)=O)=O)(O)=O,,,5,1,1,0,1
59407_0,,,,2,1,2,3
59408_0,,,,2,1,2,3
59409_0,,,,2,1,2,3
59410_0,,,,2,1,2,3
59411_0,,,,2,1,2,3
59412_0,,,,2,1,2,3
59413_0,,,,2,1,2,3
59414_0,,,,2,1,2,3
59415_0,,,,2,1,2,3
59416_0,,,,2,1,2,3
59417_0,,,,2,1,2,3
59418_0,,,,2,1,2,3
59419_0,,,,2,1,2,3
59420_0,,,,2,1,2,3
59421_0,,,,2,1,2,3
59422_0,,,,2,1,2,3
59423_0,,,,2,1,2,3
59424_0,,,,2,1,2,3
59425_0,,,,2,1,2,3
59426_0,,,,2,1,2,3
59427_0,,,,2,1,2,3
59428_0,,,,2,1,2,3
59429_0,,,,2,1,2,3
59430_0,,,,2,1,2,3
59431_0,,,,2,1,2,3
59432_0,,,,2,1,2,3
59433_0,,,,2,1,2,3
59435_0,,,,2,1,2,3
C1(CCC(C1(CO)O)=O)=O,,,5,1,1,0,1
59436_0,,,,2,1,2,3
59437_0,,,,2,1,2,3
59438_0,,,,2,1,2,3
59439_0,,,,2,1,2,3
59440_0,,,,2,1,2,3
59441_0,,,,2,1,2,3
59442_0,,,,2,1,2,3
59443_0,,,,2,1,2,3
59444_0,,,,2,1,2,3
59445_0,,,,2,1,2,3
59446_0,,,,2,1,2,3
59447_0,,,,2,1,2,3
59448_0,,,,2,1,2,3
59449_0,,,,2,1,2,3
59450_0,,,,2,1,2,3
59452_0,,,,2,1,2,3
C(C(C(C(C)=O)C(C)=O)O)=O,,,5,1,1,0,1
59453_0,,,,2,1,2,3
59454_0,,,,2,1,2,3
59456_0,,,,2,1,2,3
C(C(C(C(C)=O)(C(C)=O)O)O)=O,,,5,1,1,0,1
59457_0,,,,2,1,2,3
59458_0,,,,2,1,2,3
59459_0,,,,2,1,2,3
59460_0,,,,2,1,2,3
59461_0,,,,2,1,2,3
59463_0,,,,2,1,2,3
C(C(C=O)(C(C)O)C(C=O)C)=O,,,5,1,2,0,2
59465_0,,,,2,1,2,3
C(C(C=O)(C(C)O)CC(O)=O)=O,,,5,1,2,0,2
59466_0,,,,2,1,2,3
59468_0,,,,2,1,2,3
C(C(C=O)(C(C)O)CC(C)=O)=O,,,5,1,2,0,2
59470_0,,,,2,1,2,3
C(C(C=O)(C(CC)=O)C(C)O)=O,,,5,1,1,0,1
59471_0,,,,2,1,2,3
59472_0,,,,2,1,2,3
59473_0,,,,2,1,2,3
59474_0,,,,2,1,2,3
59475_0,,,,2,1,2,3
59476_0,,,,2,1,2,3
59477_0,,,,2,1,2,3
59478_0,,,,2,1,2,3
59479_0,,,,2,1,2,3
59480_0,,,,2,1,2,3
59482_0,,,,2,1,2,3
C(C(C=O)(C(CC=O)=O)CO)=O,,,5,1,1,0,1
59484_0,,,,2,1,2,3
C(C(C=O)(CO)C(C=O)C)=O,,,5,1,2,0,2
59486_0,,,,2,1,2,3
C(C(C=O)(CO)CC(O)=O)=O,,,5,1,2,0,2
59487_0,,,,2,1,2,3
59489_0,,,,2,1,2,3
C(C(C=O)(CO)CC(C)=O)=O,,,5,1,2,0,2
59491_0,,,,2,1,2,3
C(C(C=O)(C(CC)=O)CO)=O,,,5,1,1,0,1
59492_0,,,,2,1,2,3
59493_0,,,,2,1,2,3
59495_0,,,,2,1,2,3
C(C(C=O)C(C(C=O)CO)=O)=O,,,5,1,1,0,1
59496_0,,,,2,1,2,3
59497_0,,,,2,1,2,3
59498_0,,,,2,1,2,3
59499_0,,,,2,1,2,3
59500_0,,,,2,1,2,3
59501_0,,,,2,1,2,3
59502_0,,,,2,1,2,3
59503_0,,,,2,1,2,3
59504_0,,,,2,1,2,3
59505_0,,,,2,1,2,3
59506_0,,,,2,1,2,3
59507_0,,,,2,1,2,3
59508_0,,,,2,1,2,3
59509_0,,,,2,1,2,3
59510_0,,,,2,1,2,3
59511_0,,,,2,1,2,3
59512_0,,,,2,1,2,3
59513_0,,,,2,1,2,3
59514_0,,,,2,1,2,3
59515_0,,,,2,1,2,3
59516_0,,,,2,1,2,3
59517_0,,,,2,1,2,3
59518_0,,,,2,1,2,3
59519_0,,,,2,1,2,3
59520_0,,,,2,1,2,3
59521_0,,,,2,1,2,3
59522_0,,,,2,1,2,3
59523_0,,,,2,1,2,3
59525_0,,,,2,1,2,3
C(CC(C)O)(C(C(C)=O)CO)=O,,,5,1,1,0,1
59527_0,,,,2,1,2,3
C(CC(C)O)(C1C(COC1)=O)=O,,,5,1,1,0,1
59528_0,,,,2,1,2,3
59529_0,,,,2,1,2,3
59530_0,,,,2,1,2,3
59531_0,,,,2,1,2,3
59532_0,,,,2,1,2,3
59533_0,,,,2,1,2,3
59534_0,,,,2,1,2,3
59535_0,,,,2,1,2,3
59536_0,,,,2,1,2,3
59537_0,,,,2,1,2,3
59538_0,,,,2,1,2,3
59539_0,,,,2,1,2,3
59540_0,,,,2,1,2,3
59541_0,,,,2,1,2,3
59542_0,,,,2,1,2,3
59543_0,,,,2,1,2,3
59544_0,,,,2,1,2,3
59545_0,,,,2,1,2,3
59546_0,,,,2,1,2,3
59548_0,,,,2,1,2,3
C(C(C)C(C=O)(C(C)O)O)=O,,,5,1,1,0,1
59549_0,,,,2,1,2,3
59550_0,,,,2,1,2,3
59551_0,,,,2,1,2,3
59552_0,,,,2,1,2,3
59553_0,,,,2,1,2,3
59555_0,,,,2,1,2,3
C(C(C(C(C=C)=O)=O)C(C)O)=O,,,5,1,1,0,1
59556_0,,,,2,1,2,3
59558_0,,,,2,1,2,3
C(C(C(C=CC=O)=O)C(C)O)=O,,,5,1,1,0,1
59559_0,,,,2,1,2,3
59560_0,,,,2,1,2,3
59561_0,,,,2,1,2,3
59562_0,,,,2,1,2,3
59564_0,,,,2,1,2,3
C(C(C(C(O)O)=O)C(C)O)=O,,,5,1,1,0,1
59565_0,,,,2,1,2,3
59567_0,,,,2,1,2,3
C(C(C(C)O)(CC(C)=O)O)=O,,,5,1,1,0,1
59569_0,,,,2,1,2,3
C(C(C(CC)=O)(C(C)O)O)=O,,,5,1,1,0,1
59570_0,,,,2,1,2,3
59571_0,,,,2,1,2,3
59572_0,,,,2,1,2,3
59574_0,,,,2,1,2,3
C(C(C=O)(CC(C(C)O)=O)O)=O,,,5,1,1,0,1
59575_0,,,,2,1,2,3
59576_0,,,,2,1,2,3
59577_0,,,,2,1,2,3
59578_0,,,,2,1,2,3
59579_0,,,,2,1,2,3
59581_0,,,,2,1,2,3
C(C(CO)(CC(C(C)O)=O)O)=O,,,5,1,1,0,1
59582_0,,,,2,1,2,3
59583_0,,,,2,1,2,3
59584_0,,,,2,1,2,3
59585_0,,,,2,1,2,3
59586_0,,,,2,1,2,3
59587_0,,,,2,1,2,3
59588_0,,,,2,1,2,3
59589_0,,,,2,1,2,3
59591_0,,,,2,1,2,3
C(CCO)(C(C(C)=O)CO)=O,,,5,1,1,0,1
59593_0,,,,2,1,2,3
C(CCO)(C(C(O)=O)C(C)=O)=O,,,5,1,2,0,2
59594_0,,,,2,1,2,3
59596_0,,,,2,1,2,3
C(C(C(CCO)=O)C(C)O)(O)=O,,,5,1,1,0,1
59598_0,,,,2,1,2,3
C(CCO)(C1C(COC1)=O)=O,,,5,1,1,0,1
59599_0,,,,2,1,2,3
59600_0,,,,2,1,2,3
59602_0,,,,2,1,2,3
C1(C(C(CCO)=O)C(CO1)O)=O,,,5,1,2,0,2
59603_0,,,,2,1,2,3
59604_0,,,,2,1,2,3
59605_0,,,,2,1,2,3
59606_0,,,,2,1,2,3
59607_0,,,,2,1,2,3
59609_0,,,,2,1,2,3
C(C(C(C=O)=O)(C(C=O)C)O)=O,,,5,1,1,0,1
59610_0,,,,2,1,2,3
59611_0,,,,2,1,2,3
59613_0,,,,2,1,2,3
C(C(C(C(O)O)=O)C(C=O)=O)=O,,,5,1,1,0,1
59615_0,,,,2,1,2,3
C(C(C(C=O)=O)(CC(C)=O)O)=O,,,5,1,1,0,1
59617_0,,,,2,1,2,3
C(C(C(CC)=O)(C(C=O)=O)O)=O,,,5,1,1,0,1
59618_0,,,,2,1,2,3
59619_0,,,,2,1,2,3
59620_0,,,,2,1,2,3
59621_0,,,,2,1,2,3
59623_0,,,,2,1,2,3
C(C(C)C(C=O)(C(CO)=O)O)=O,,,5,1,2,0,2
59624_0,,,,2,1,2,3
59625_0,,,,2,1,2,3
59627_0,,,,2,1,2,3
C(C(C(CO)=O)C(C(O)O)=O)=O,,,5,1,1,0,1
59629_0,,,,2,1,2,3
C(C(C(CO)=O)(CC(C)=O)O)=O,,,5,1,2,0,2
59631_0,,,,2,1,2,3
C(CC)(C(C=O)(C(CO)=O)O)=O,,,5,1,1,0,1
59632_0,,,,2,1,2,3
59633_0,,,,2,1,2,3
59634_0,,,,2,1,2,3
59635_0,,,,2,1,2,3
59636_0,,,,2,1,2,3
59638_0,,,,2,1,2,3
C(C(C=O)(C(CC=O)=O)O)=O,,,5,1,1,0,1
59639_0,,,,2,1,2,3
59641_0,,,,2,1,2,3
C(C(C=O)(C(C=O)C)O)=O,,,5,1,2,0,2
59642_0,,,,2,1,2,3
59644_0,,,,2,1,2,3
C(C(C=O)(CC(CCO)=O)O)=O,,,5,1,2,0,2
59646_0,,,,2,1,2,3
C(C(C=O)(C(CCCO)=O)O)=O,,,5,1,1,0,1
59647_0,,,,2,1,2,3
59648_0,,,,2,1,2,3
59650_0,,,,2,1,2,3
C(C(C=O)(C(C(CO)=O)C)O)=O,,,5,1,1,0,1
59651_0,,,,2,1,2,3
59652_0,,,,2,1,2,3
59653_0,,,,2,1,2,3
59654_0,,,,2,1,2,3
59655_0,,,,2,1,2,3
59657_0,,,,2,1,2,3
C(C(C=O)(C1C(COC1)=O)O)=O,,,5,1,1,0,1
59659_0,,,,2,1,2,3
C(C(C=O)(C1C(OCC1)=O)O)=O,,,5,1,1,0,1
59660_0,,,,2,1,2,3
59662_0,,,,2,1,2,3
C(C(C=O)C(C(C=C)=O)=O)=O,,,5,1,1,0,1
59664_0,,,,2,1,2,3
C(C(C=O)C(C=CC=O)=O)=O,,,5,1,2,0,2
59665_0,,,,2,1,2,3
59666_0,,,,2,1,2,3
59668_0,,,,2,1,2,3
C(C(C=O)C(C(O)O)=O)=O,,,5,1,1,0,1
59670_0,,,,2,1,2,3
C(C(C=O)(CC(C)=O)O)=O,,,5,1,2,0,2
59672_0,,,,2,1,2,3
C(C(C=O)(C(CC)=O)O)=O,,,5,1,1,0,1
59673_0,,,,2,1,2,3
59674_0,,,,2,1,2,3
59675_0,,,,2,1,2,3
59676_0,,,,2,1,2,3
59677_0,,,,2,1,2,3
59678_0,,,,2,1,2,3
59679_0,,,,2,1,2,3
59680_0,,,,2,1,2,3
59681_0,,,,2,1,2,3
59682_0,,,,2,1,2,3
59683_0,,,,2,1,2,3
59684_0,,,,2,1,2,3
59686_0,,,,2,1,2,3
C(C(C=O)(C(CCC=O)=O)O)=O,,,5,1,1,0,1
59687_0,,,,2,1,2,3
59688_0,,,,2,1,2,3
59689_0,,,,2,1,2,3
59690_0,,,,2,1,2,3
59691_0,,,,2,1,2,3
59693_0,,,,2,1,2,3
C(C(C=O)(C(CC(C)=O)=O)O)=O,,,5,1,1,0,1
59694_0,,,,2,1,2,3
59695_0,,,,2,1,2,3
59696_0,,,,2,1,2,3
59697_0,,,,2,1,2,3
59698_0,,,,2,1,2,3
59700_0,,,,2,1,2,3
C1(COCC1(CC(C=O)=O)O)=O,,,5,1,1,0,1
59702_0,,,,2,1,2,3
C(C(C=O)O)(C1C(COC1)=O)=O,,,5,1,1,0,1
59704_0,,,,2,1,2,3
C(CC=O)(C1(C(COC1)=O)O)=O,,,5,1,1,0,1
59705_0,,,,2,1,2,3
59707_0,,,,2,1,2,3
C1(C(C(CC=O)=O)C(CO1)O)=O,,,5,1,2,0,2
59708_0,,,,2,1,2,3
59710_0,,,,2,1,2,3
C(C(C)C(C(C)=O)(CO)O)=O,,,5,1,1,0,1
59712_0,,,,2,1,2,3
C(C(C(C(O)=O)C(C=O)C)O)=O,,,5,1,1,0,1
59714_0,,,,2,1,2,3
C(C(C)C(C(O)=O)(C(C)=O)O)=O,,,5,1,1,0,1
59715_0,,,,2,1,2,3
59717_0,,,,2,1,2,3
C(C(C)C(C(O)=O)(C(C)O)O)=O,,,5,1,1,0,1
59719_0,,,,2,1,2,3
C(C(C)C1(C(COC1)=O)O)=O,,,5,1,1,0,1
59721_0,,,,2,1,2,3
C1(C(C(CO1)O)C(C=O)C)=O,,,5,1,1,0,1
59723_0,,,,2,1,2,3
C(C(C)C1(C(C(O)OC1)=O)O)=O,,,5,1,1,0,1
59724_0,,,,2,1,2,3
59726_0,,,,2,1,2,3
C(C(C)C1(C(OCC1O)=O)O)=O,,,5,1,1,0,1
59727_0,,,,2,1,2,3
59729_0,,,,2,1,2,3
C(CC(O)=O)(C(C(C)=O)CO)=O,,,5,1,2,0,2
59730_0,,,,2,1,2,3
59731_0,,,,2,1,2,3
59733_0,,,,2,1,2,3
C(C)(C(C(C(C=C)=O)=O)CO)=O,,,5,1,1,0,1
59734_0,,,,2,1,2,3
59736_0,,,,2,1,2,3
C(C)(C(C(C=CC=O)=O)CO)=O,,,5,1,1,0,1
59737_0,,,,2,1,2,3
59738_0,,,,2,1,2,3
59739_0,,,,2,1,2,3
59741_0,,,,2,1,2,3
C(C)(C(C(C(O)O)=O)CO)=O,,,5,1,1,0,1
59742_0,,,,2,1,2,3
59744_0,,,,2,1,2,3
C(C)(C(CO)(CC(C)=O)O)=O,,,5,1,1,0,1
59746_0,,,,2,1,2,3
C(CC)(C(C(C)=O)(CO)O)=O,,,5,1,1,0,1
59748_0,,,,2,1,2,3
C(C(C)O)(C(C(C)=O)CO)=O,,,5,1,1,0,1
59749_0,,,,2,1,2,3
59750_0,,,,2,1,2,3
59752_0,,,,2,1,2,3
C(CC(O)=O)(C1C(COC1)=O)=O,,,5,1,1,0,1
59754_0,,,,2,1,2,3
C(CC(C(O)=O)C(C=O)O)(O)=O,,,5,1,2,0,2
59755_0,,,,2,1,2,3
59757_0,,,,2,1,2,3
C(C(CC(C)=O)C(C=O)O)(O)=O,,,5,1,1,0,1
59759_0,,,,2,1,2,3
C(CC)(C(C(O)=O)C(C=O)O)=O,,,5,1,1,0,1
59760_0,,,,2,1,2,3
59761_0,,,,2,1,2,3
59763_0,,,,2,1,2,3
C(C(C(C)=O)C(C(O)O)=O)(O)=O,,,5,1,1,0,1
59765_0,,,,2,1,2,3
C(C(C(C)=O)(CC(C)=O)O)(O)=O,,,5,1,1,0,1
59767_0,,,,2,1,2,3
C(CC)(C(C(O)=O)(C(C)=O)O)=O,,,5,1,1,0,1
59769_0,,,,2,1,2,3
C(C(C)O)(C(C(O)=O)C(C)=O)=O,,,5,1,1,0,1
59770_0,,,,2,1,2,3
59771_0,,,,2,1,2,3
59772_0,,,,2,1,2,3
59773_0,,,,2,1,2,3
59774_0,,,,2,1,2,3
59776_0,,,,2,1,2,3
C(C(C(C(C)=O)C(C)=O)O)(O)=O,,,5,1,1,0,1
59777_0,,,,2,1,2,3
59778_0,,,,2,1,2,3
59779_0,,,,2,1,2,3
59780_0,,,,2,1,2,3
59781_0,,,,2,1,2,3
59782_0,,,,2,1,2,3
59783_0,,,,2,1,2,3
59785_0,,,,2,1,2,3
C(C(C(C(O)O)=O)C(C)O)(O)=O,,,5,1,1,0,1
59786_0,,,,2,1,2,3
59787_0,,,,2,1,2,3
59789_0,,,,2,1,2,3
C(C(C(CC)=O)(C(C)O)O)(O)=O,,,5,1,1,0,1
59791_0,,,,2,1,2,3
C(C(C(C(C)O)=O)C(C)O)(O)=O,,,5,1,1,0,1
59792_0,,,,2,1,2,3
59793_0,,,,2,1,2,3
59794_0,,,,2,1,2,3
59795_0,,,,2,1,2,3
59796_0,,,,2,1,2,3
59797_0,,,,2,1,2,3
59798_0,,,,2,1,2,3
59799_0,,,,2,1,2,3
59800_0,,,,2,1,2,3
59801_0,,,,2,1,2,3
59802_0,,,,2,1,2,3
59803_0,,,,2,1,2,3
59804_0,,,,2,1,2,3
59805_0,,,,2,1,2,3
59806_0,,,,2,1,2,3
59808_0,,,,2,1,2,3
C1(COCC1C(C(C=C)=O)=O)=O,,,5,1,1,0,1
59810_0,,,,2,1,2,3
C1(COCC1C(C=CC=O)=O)=O,,,5,1,1,0,1
59812_0,,,,2,1,2,3
C1(COCC1(CC(O)=O)O)=O,,,5,1,1,0,1
59813_0,,,,2,1,2,3
59815_0,,,,2,1,2,3
C1(COCC1C(C(O)O)=O)=O,,,5,1,1,0,1
59817_0,,,,2,1,2,3
C(CC1(C(COC1)=O)O)(C)=O,,,5,1,1,0,1
59819_0,,,,2,1,2,3
C(CC)(C1(C(COC1)=O)O)=O,,,5,1,1,0,1
59821_0,,,,2,1,2,3
C(C(C)O)(C1C(COC1)=O)=O,,,5,1,1,0,1
59823_0,,,,2,1,2,3
C(CC1(C(COC1)=O)O)(CO)=O,,,5,1,1,0,1
59824_0,,,,2,1,2,3
59826_0,,,,2,1,2,3
C(CCO)(C1(C(COC1)=O)O)=O,,,5,1,1,0,1
59828_0,,,,2,1,2,3
C(C(CO)O)(C1C(COC1)=O)=O,,,5,1,1,0,1
59829_0,,,,2,1,2,3
59831_0,,,,2,1,2,3
C1(COCC1C(C=O)=O)=O,,,5,1,2,0,2
59833_0,,,,2,1,2,3
C(C(CO)C1(C(COC1)=O)O)=O,,,5,1,1,0,1
59835_0,,,,2,1,2,3
C1(COCC1C(C(O)=O)=O)=O,,,5,1,1,0,1
59837_0,,,,2,1,2,3
C1(COCC1C(C(C)=O)=O)=O,,,5,1,1,0,1
59839_0,,,,2,1,2,3
C(CC=O)(C1C(COC1)=O)=O,,,5,1,1,0,1
59841_0,,,,2,1,2,3
C(C)(C1C(COC1)=O)=O,,,5,1,1,0,1
59843_0,,,,2,1,2,3
C(C(C=O)C1(C(COC1)=O)O)=O,,,5,1,1,0,1
59845_0,,,,2,1,2,3
C1(COCC1C(C(CO)=O)=O)=O,,,5,1,1,0,1
59847_0,,,,2,1,2,3
C(C1C(COC1)=O)=O,,,5,1,2,0,2
59849_0,,,,2,1,2,3
C1(COCC1(CC=O)O)=O,,,5,1,2,0,2
59851_0,,,,2,1,2,3
C(C)(C1(C(COC1)=O)O)=O,,,5,1,1,0,1
59853_0,,,,2,1,2,3
C(CO)(C1C(COC1)=O)=O,,,5,1,1,0,1
59854_0,,,,2,1,2,3
59856_0,,,,2,1,2,3
C(C(CO)(C1C(COC1)=O)O)=O,,,5,1,1,0,1
59857_0,,,,2,1,2,3
59859_0,,,,2,1,2,3
C1(C(CCO1)C(C=O)(CO)O)=O,,,5,1,1,0,1
59861_0,,,,2,1,2,3
C1(C(C(CO1)O)CC(O)=O)=O,,,5,1,1,0,1
59862_0,,,,2,1,2,3
59864_0,,,,2,1,2,3
C1(C(C(CO1)O)CC(C)=O)=O,,,5,1,1,0,1
59866_0,,,,2,1,2,3
C1(C(C(CC)=O)C(CO1)O)=O,,,5,1,1,0,1
59867_0,,,,2,1,2,3
59868_0,,,,2,1,2,3
59869_0,,,,2,1,2,3
59870_0,,,,2,1,2,3
59871_0,,,,2,1,2,3
59872_0,,,,2,1,2,3
59873_0,,,,2,1,2,3
59875_0,,,,2,1,2,3
C1(C(C(C)=O)C(CO1)O)=O,,,5,1,4,0,4
59876_0,,,,2,1,2,3
59877_0,,,,2,1,2,3
59878_0,,,,2,1,2,3
59879_0,,,,2,1,2,3
59880_0,,,,2,1,2,3
59882_0,,,,2,1,2,3
C(C(C(C(C=C)=O)=O)CO)=O,,,5,1,2,0,2
59883_0,,,,2,1,2,3
59885_0,,,,2,1,2,3
C(C(C(C(C=C)=O)=O)CO)(O)=O,,,5,1,1,0,1
59887_0,,,,2,1,2,3
C(C(C(C)=O)C(C(C=C)=O)=O)=O,,,5,1,1,0,1
59888_0,,,,2,1,2,3
59890_0,,,,2,1,2,3
C(C(C(C=CC=O)=O)CO)=O,,,5,1,3,0,3
59891_0,,,,2,1,2,3
59892_0,,,,2,1,2,3
59894_0,,,,2,1,2,3
C(C(C(C)=O)C(C=CC=O)=O)=O,,,5,1,1,0,1
59895_0,,,,2,1,2,3
59896_0,,,,2,1,2,3
59897_0,,,,2,1,2,3
59899_0,,,,2,1,2,3
C1(C(C(C=O)=O)C(C(O)O1)O)=O,,,5,1,3,0,3
59900_0,,,,2,1,2,3
59901_0,,,,2,1,2,3
59902_0,,,,2,1,2,3
59904_0,,,,2,1,2,3
C1(C(C(C)=O)C(C(O)O1)O)=O,,,5,1,2,0,2
59905_0,,,,2,1,2,3
59906_0,,,,2,1,2,3
59907_0,,,,2,1,2,3
59909_0,,,,2,1,2,3
C1(C(C=O)C(C(O)O1)O)=O,,,5,1,3,0,3
59910_0,,,,2,1,2,3
59911_0,,,,2,1,2,3
59912_0,,,,2,1,2,3
59913_0,,,,2,1,2,3
59915_0,,,,2,1,2,3
C1(C(C(C)=O)(C(C(O)O1)O)O)=O,,,5,1,3,0,3
59917_0,,,,2,1,2,3
C1(C(C(CO)=O)C(C(O)O1)O)=O,,,5,1,3,0,3
59918_0,,,,2,1,2,3
59919_0,,,,2,1,2,3
59920_0,,,,2,1,2,3
59922_0,,,,2,1,2,3
C(CC1(C(C(O)OC1)=O)O)(O)=O,,,5,1,1,0,1
59923_0,,,,2,1,2,3
59925_0,,,,2,1,2,3
C(C(O)O)(C1C(C(O)OC1)=O)=O,,,5,1,1,0,1
59927_0,,,,2,1,2,3
C(CC1(C(C(O)OC1)=O)O)(C)=O,,,5,1,1,0,1
59929_0,,,,2,1,2,3
C(CC)(C1(C(C(O)OC1)=O)O)=O,,,5,1,1,0,1
59930_0,,,,2,1,2,3
59931_0,,,,2,1,2,3
59933_0,,,,2,1,2,3
C1(C(O)OCC1C(C(O)=O)=O)=O,,,5,1,3,0,3
59934_0,,,,2,1,2,3
59935_0,,,,2,1,2,3
59936_0,,,,2,1,2,3
59937_0,,,,2,1,2,3
59939_0,,,,2,1,2,3
C(CC1(C(C(O)OC1)=O)O)=O,,,5,1,2,0,2
59941_0,,,,2,1,2,3
C(C)(C1(C(C(O)OC1)=O)O)=O,,,5,1,2,0,2
59942_0,,,,2,1,2,3
59943_0,,,,2,1,2,3
59944_0,,,,2,1,2,3
59945_0,,,,2,1,2,3
59946_0,,,,2,1,2,3
59947_0,,,,2,1,2,3
59948_0,,,,2,1,2,3
59949_0,,,,2,1,2,3
59950_0,,,,2,1,2,3
59951_0,,,,2,1,2,3
59952_0,,,,2,1,2,3
59953_0,,,,2,1,2,3
59954_0,,,,2,1,2,3
59955_0,,,,2,1,2,3
59956_0,,,,2,1,2,3
59957_0,,,,2,1,2,3
59958_0,,,,2,1,2,3
59959_0,,,,2,1,2,3
59960_0,,,,2,1,2,3
59961_0,,,,2,1,2,3
59962_0,,,,2,1,2,3
59963_0,,,,2,1,2,3
59965_0,,,,2,1,2,3
C1(C(C(CO1)O)(CC(O)=O)O)=O,,,5,1,2,0,2
59966_0,,,,2,1,2,3
59968_0,,,,2,1,2,3
C1(C(C(C(O)O)=O)C(CO1)O)=O,,,5,1,1,0,1
59969_0,,,,2,1,2,3
59971_0,,,,2,1,2,3
C1(C(C(CO1)O)(CC(C)=O)O)=O,,,5,1,1,0,1
59973_0,,,,2,1,2,3
C1(C(C(CC)=O)(C(CO1)O)O)=O,,,5,1,1,0,1
59974_0,,,,2,1,2,3
59975_0,,,,2,1,2,3
59976_0,,,,2,1,2,3
59977_0,,,,2,1,2,3
59979_0,,,,2,1,2,3
C1(C(C(C(O)=O)=O)C(CO1)O)=O,,,5,1,3,0,3
59980_0,,,,2,1,2,3
59981_0,,,,2,1,2,3
59982_0,,,,2,1,2,3
59983_0,,,,2,1,2,3
59984_0,,,,2,1,2,3
59985_0,,,,2,1,2,3
59986_0,,,,2,1,2,3
59987_0,,,,2,1,2,3
59988_0,,,,2,1,2,3
59989_0,,,,2,1,2,3
59990_0,,,,2,1,2,3
59992_0,,,,2,1,2,3
C1(C(C(C)=O)(C(CO1)O)O)=O,,,5,1,2,0,2
59993_0,,,,2,1,2,3
59994_0,,,,2,1,2,3
59996_0,,,,2,1,2,3
C1(C(C(C)=O)C(C(CO)O1)O)=O,,,5,1,2,0,2
59997_0,,,,2,1,2,3
59999_0,,,,2,1,2,3
C1(C(C=O)C(C(CO)O1)O)=O,,,5,1,2,0,2
60000_0,,,,2,1,2,3
60002_0,,,,2,1,2,3
C1(C(C(C)=O)C(C(CO1)O)O)=O,,,5,1,2,0,2
60003_0,,,,2,1,2,3
60004_0,,,,2,1,2,3
60005_0,,,,2,1,2,3
60007_0,,,,2,1,2,3
C1(C(C=O)C(C(CO1)O)O)=O,,,5,1,2,0,2
60008_0,,,,2,1,2,3
60009_0,,,,2,1,2,3
60010_0,,,,2,1,2,3
60011_0,,,,2,1,2,3
60012_0,,,,2,1,2,3
60013_0,,,,2,1,2,3
60014_0,,,,2,1,2,3
60015_0,,,,2,1,2,3
60016_0,,,,2,1,2,3
60018_0,,,,2,1,2,3
C(C(C(C(O)O)=O)CO)=O,,,5,1,1,0,1
60019_0,,,,2,1,2,3
60020_0,,,,2,1,2,3
60021_0,,,,2,1,2,3
60022_0,,,,2,1,2,3
60023_0,,,,2,1,2,3
60025_0,,,,2,1,2,3
C(C(C(C(O)O)=O)C(CO)O)=O,,,5,1,1,0,1
60026_0,,,,2,1,2,3
60027_0,,,,2,1,2,3
60028_0,,,,2,1,2,3
60030_0,,,,2,1,2,3
C(C(C(C(O)O)=O)C(C=O)O)=O,,,5,1,1,0,1
60031_0,,,,2,1,2,3
60032_0,,,,2,1,2,3
60033_0,,,,2,1,2,3
60035_0,,,,2,1,2,3
C(CO)(C(C(C(O)O)=O)CO)=O,,,5,1,1,0,1
60036_0,,,,2,1,2,3
60037_0,,,,2,1,2,3
60038_0,,,,2,1,2,3
60040_0,,,,2,1,2,3
C(C(C(C(O)O)=O)CO)(O)=O,,,5,1,1,0,1
60041_0,,,,2,1,2,3
60042_0,,,,2,1,2,3
60044_0,,,,2,1,2,3
C(C(C(C)=O)C(C(O)O)=O)=O,,,5,1,1,0,1
60045_0,,,,2,1,2,3
60046_0,,,,2,1,2,3
60047_0,,,,2,1,2,3
60049_0,,,,2,1,2,3
C(C(O)O)(C(C(C=O)=O)CO)=O,,,5,1,1,0,1
60050_0,,,,2,1,2,3
60051_0,,,,2,1,2,3
60053_0,,,,2,1,2,3
C(C(CO)(CC(C)=O)O)=O,,,5,1,1,0,1
60054_0,,,,2,1,2,3
60056_0,,,,2,1,2,3
C(C(C(CC)=O)(CO)O)=O,,,5,1,1,0,1
60057_0,,,,2,1,2,3
60058_0,,,,2,1,2,3
60059_0,,,,2,1,2,3
60061_0,,,,2,1,2,3
C(C(C(CO)O)(CC(C)=O)O)=O,,,5,1,1,0,1
60062_0,,,,2,1,2,3
60064_0,,,,2,1,2,3
C(C(C(CC)=O)(C(CO)O)O)=O,,,5,1,1,0,1
60065_0,,,,2,1,2,3
60067_0,,,,2,1,2,3
C(CO)(C(CO)(CC(C)=O)O)=O,,,5,1,1,0,1
60068_0,,,,2,1,2,3
60070_0,,,,2,1,2,3
C(CC)(C(C(CO)=O)(CO)O)=O,,,5,1,1,0,1
60071_0,,,,2,1,2,3
60072_0,,,,2,1,2,3
60074_0,,,,2,1,2,3
C(C(C(C(C)O)=O)CO)(O)=O,,,5,1,1,0,1
60076_0,,,,2,1,2,3
C(C(C(CC)=O)(CO)O)(O)=O,,,5,1,1,0,1
60078_0,,,,2,1,2,3
C(C(C(C)=O)(CC(C)=O)O)=O,,,5,1,1,0,1
60080_0,,,,2,1,2,3
C(C(C)O)(C(C=O)C(C)=O)=O,,,5,1,1,0,1
60082_0,,,,2,1,2,3
C(CC)(C(C=O)(C(C)=O)O)=O,,,5,1,1,0,1
60083_0,,,,2,1,2,3
60085_0,,,,2,1,2,3
C(CC(C(C=O)=O)(CO)O)(C)=O,,,5,1,2,0,2
60086_0,,,,2,1,2,3
60088_0,,,,2,1,2,3
C(CC)(C(C(C=O)=O)(CO)O)=O,,,5,1,1,0,1
60089_0,,,,2,1,2,3
60090_0,,,,2,1,2,3
60091_0,,,,2,1,2,3
60092_0,,,,2,1,2,3
60094_0,,,,2,1,2,3
C(C1(CC(C(C1)=O)=O)O)(O)=O,,,5,1,1,0,1
60096_0,,,,2,1,2,3
C(C1(C(CC(C1)=O)=O)O)(O)=O,,,5,1,1,0,1
60098_0,,,,2,1,2,3
C(C1C(C(C(C1)=O)O)=O)(O)=O,,,5,1,1,0,1
60100_0,,,,2,1,2,3
C(C)(C1(CC(C(C1)=O)=O)O)=O,,,5,1,1,0,1
60102_0,,,,2,1,2,3
C1(CC(CC1(C(C)=O)O)=O)=O,,,5,1,1,0,1
60104_0,,,,2,1,2,3
C1(C(C(CC1C(C)=O)=O)O)=O,,,5,1,1,0,1
60105_0,,,,2,1,2,3
60106_0,,,,2,1,2,3
60107_0,,,,2,1,2,3
60108_0,,,,2,1,2,3
60109_0,,,,2,1,2,3
60110_0,,,,2,1,2,3
60112_0,,,,2,1,2,3
C(CO)(C1(CC(C(C1)=O)=O)O)=O,,,5,1,1,0,1
60114_0,,,,2,1,2,3
C1(C(C(CC1C(CO)=O)=O)O)=O,,,5,1,1,0,1
60116_0,,,,2,1,2,3
C1(CC(CC1(C(CO)=O)O)=O)=O,,,5,1,1,0,1
60117_0,,,,2,1,2,3
60118_0,,,,2,1,2,3
60119_0,,,,2,1,2,3
60120_0,,,,2,1,2,3
60122_0,,,,2,1,2,3
C(C(C(C)=O)CC(C=O)=O)(O)=O,,,5,1,1,0,1
60124_0,,,,2,1,2,3
C(C(C=O)C(C(O)=O)C(C)=O)=O,,,5,1,1,0,1
60126_0,,,,2,1,2,3
C(CCO)(C(C(O)=O)CC=O)=O,,,5,1,1,0,1
60127_0,,,,2,1,2,3
60128_0,,,,2,1,2,3
60129_0,,,,2,1,2,3
60131_0,,,,2,1,2,3
C(C(C(C(O)O)=O)CC=O)(O)=O,,,5,1,1,0,1
60132_0,,,,2,1,2,3
60134_0,,,,2,1,2,3
C(CC)(C(C(O)=O)(CC=O)O)=O,,,5,1,1,0,1
60136_0,,,,2,1,2,3
C(C(C)O)(C(C(O)=O)CC=O)=O,,,5,1,1,0,1
60137_0,,,,2,1,2,3
60139_0,,,,2,1,2,3
C(CC(C(O)=O)O)(C(C=O)C)=O,,,5,1,1,0,1
60141_0,,,,2,1,2,3
C(C(CC([CH]C(O)=O)=O)O)(O)=O,,,5,1,1,0,1
60142_0,,,,2,1,2,3
60144_0,,,,2,1,2,3
C(C(C)(CC(C(C=O)C)=O)O)=O,,,5,1,1,0,1
60146_0,,,,2,1,2,3
C(C(C)(CC([CH]C(O)=O)=O)O)=O,,,5,1,1,0,1
60147_0,,,,2,1,2,3
60148_0,,,,2,1,2,3
60149_0,,,,2,1,2,3
60151_0,,,,2,1,2,3
C(C(C)CC=O)(C(C=O)(O)O)=O,,,5,1,1,0,1
60153_0,,,,2,1,2,3
C(C(C)(CC=O)O)(C(C=O)C)=O,,,5,1,1,0,1
60155_0,,,,2,1,2,3
C(C(C)CC=O)(C(C=O)(C)O)=O,,,5,1,1,0,1
60157_0,,,,2,1,2,3
C(CC(C([CH]C(O)=O)=O)(C)O)=O,,,5,1,1,0,1
60159_0,,,,2,1,2,3
C(CC(C([C](C(O)=O)O)=O)C)=O,,,5,1,1,0,1
60161_0,,,,2,1,2,3
C(C)(C(C(C)=O)CC(C=O)=O)=O,,,5,1,1,0,1
60163_0,,,,2,1,2,3
C(C(C=O)C(C(C)=O)C(C)=O)=O,,,5,1,1,0,1
60165_0,,,,2,1,2,3
C(C)(C(C(CCO)=O)CC=O)=O,,,5,1,2,0,2
60167_0,,,,2,1,2,3
C(CC(C(C)=O)(C(C=O)C)O)=O,,,5,1,1,0,1
60168_0,,,,2,1,2,3
60169_0,,,,2,1,2,3
60171_0,,,,2,1,2,3
C(CC(C(C)=O)C(C(O)O)=O)=O,,,5,1,1,0,1
60173_0,,,,2,1,2,3
C(CC(C(C)=O)(CC(C)=O)O)=O,,,5,1,1,0,1
60175_0,,,,2,1,2,3
C(C)(C(C(CC)=O)(CC=O)O)=O,,,5,1,1,0,1
60177_0,,,,2,1,2,3
C(C)(C(C(C(C)O)=O)CC=O)=O,,,5,1,1,0,1
60179_0,,,,2,1,2,3
C(CC(C(C)=O)C(C=O)=O)=O,,,5,1,1,0,1
60181_0,,,,2,1,2,3
C(CC(C(C)=O)C(C(O)=O)=O)=O,,,5,1,1,0,1
60183_0,,,,2,1,2,3
C(CC(C(C)=O)C(C(C)=O)=O)=O,,,5,1,1,0,1
60185_0,,,,2,1,2,3
C(CC=O)(C(C(C)=O)CC=O)=O,,,5,1,1,0,1
60187_0,,,,2,1,2,3
C(CC(C(C)=O)C(C)=O)=O,,,5,1,1,0,1
60188_0,,,,2,1,2,3
60190_0,,,,2,1,2,3
C(CC(C(C)=O)(C(C)=O)O)=O,,,5,1,1,0,1
60192_0,,,,2,1,2,3
C(CC(C(C)=O)C(CO)=O)=O,,,5,1,2,0,2
60193_0,,,,2,1,2,3
60195_0,,,,2,1,2,3
C(CC(C(C)=O)O)(C(C=O)C)=O,,,5,1,1,0,1
60197_0,,,,2,1,2,3
C(C)(C(CC([CH]C(O)=O)=O)O)=O,,,5,1,1,0,1
60198_0,,,,2,1,2,3
60199_0,,,,2,1,2,3
60201_0,,,,2,1,2,3
C(C(C)C(C=O)(O)O)(CC=O)=O,,,5,1,1,0,1
60203_0,,,,2,1,2,3
C(C(C)C(C=O)(C)O)(CC=O)=O,,,5,1,1,0,1
60205_0,,,,2,1,2,3
C(CC=O)(C([C](C(O)=O)O)C)=O,,,5,1,1,0,1
60207_0,,,,2,1,2,3
C(C(C(C(O)=O)=O)CC(C)O)=O,,,5,1,1,0,1
60208_0,,,,2,1,2,3
60210_0,,,,2,1,2,3
C(C(C(C(CC(C)O)=O)=O)C)=O,,,5,1,1,0,1
60212_0,,,,2,1,2,3
C(C([CH]C(O)=O)=O)(CC(C)O)=O,,,5,1,1,0,1
60213_0,,,,2,1,2,3
60214_0,,,,2,1,2,3
60216_0,,,,2,1,2,3
C(C(C(CC(CC=O)O)=O)C)=O,,,5,1,1,0,1
60218_0,,,,2,1,2,3
C(CC(CC([CH]C(O)=O)=O)O)=O,,,5,1,1,0,1
60219_0,,,,2,1,2,3
60221_0,,,,2,1,2,3
C(C(C(C(C=O)C)=O)C(C)O)=O,,,5,1,1,0,1
60223_0,,,,2,1,2,3
C(C(C([CH]C(O)=O)=O)C(C)O)=O,,,5,1,1,0,1
60224_0,,,,2,1,2,3
60225_0,,,,2,1,2,3
60227_0,,,,2,1,2,3
C(C(C(C(C=O)CO)=O)C)=O,,,5,1,1,0,1
60229_0,,,,2,1,2,3
C(C(C([CH]C(O)=O)=O)CO)=O,,,5,1,1,0,1
60230_0,,,,2,1,2,3
60231_0,,,,2,1,2,3
60233_0,,,,2,1,2,3
C(CC(C)O)(C(C(C=O)=O)C)=O,,,5,1,1,0,1
60235_0,,,,2,1,2,3
C(C(C(CC(C)O)=O)CCO)=O,,,5,1,1,0,1
60237_0,,,,2,1,2,3
C(CC(C)O)(C1C(CCO1)=O)=O,,,5,1,1,0,1
60239_0,,,,2,1,2,3
C(C(C(CC(C)O)=O)C=C)(O)=O,,,5,1,1,0,1
60241_0,,,,2,1,2,3
C1(C(C(CC(C)O)=O)CCO1)=O,,,5,1,1,0,1
60242_0,,,,2,1,2,3
60244_0,,,,2,1,2,3
C(C(C(CC(C)O)=O)C)=O,,,5,1,1,0,1
60246_0,,,,2,1,2,3
C([CH]C(CC(C)O)=O)(O)=O,,,5,1,1,0,1
60247_0,,,,2,1,2,3
60248_0,,,,2,1,2,3
60249_0,,,,2,1,2,3
60250_0,,,,2,1,2,3
60252_0,,,,2,1,2,3
C(CC(C=O)(O)O)(C(C)O)=O,,,5,1,1,0,1
60253_0,,,,2,1,2,3
60254_0,,,,2,1,2,3
60256_0,,,,2,1,2,3
C(C(C(CC(C)O)=O)(O)O)=O,,,5,1,1,0,1
60257_0,,,,2,1,2,3
60259_0,,,,2,1,2,3
C(C(C)(CC(C(C)O)=O)O)=O,,,5,1,1,0,1
60260_0,,,,2,1,2,3
60262_0,,,,2,1,2,3
C(C(C(C(C(C)O)O)=O)C)=O,,,5,1,1,0,1
60264_0,,,,2,1,2,3
C(C(C(CC(C)O)=O)(C)O)=O,,,5,1,1,0,1
60265_0,,,,2,1,2,3
60267_0,,,,2,1,2,3
C(C(C)O)(C[C](C(O)=O)O)=O,,,5,1,1,0,1
60268_0,,,,2,1,2,3
60270_0,,,,2,1,2,3
C([CH]C(C(C(C)O)O)=O)(O)=O,,,5,1,1,0,1
60272_0,,,,2,1,2,3
C([C](C(CC(C)O)=O)O)(O)=O,,,5,1,1,0,1
60273_0,,,,2,1,2,3
60274_0,,,,2,1,2,3
60275_0,,,,2,1,2,3
60276_0,,,,2,1,2,3
60277_0,,,,2,1,2,3
60278_0,,,,2,1,2,3
60279_0,,,,2,1,2,3
60281_0,,,,2,1,2,3
C(C(C)(CC(C(C)O)=O)O)(O)=O,,,5,1,1,0,1
60282_0,,,,2,1,2,3
60283_0,,,,2,1,2,3
60284_0,,,,2,1,2,3
60285_0,,,,2,1,2,3
60287_0,,,,2,1,2,3
C(CC(C(CO)=O)C(C=O)=O)=O,,,5,1,1,0,1
60288_0,,,,2,1,2,3
60289_0,,,,2,1,2,3
60290_0,,,,2,1,2,3
60292_0,,,,2,1,2,3
C(CC(C(CO)=O)C(CO)=O)=O,,,5,1,1,0,1
60294_0,,,,2,1,2,3
C(CCO)(C(C(C=O)=O)C)=O,,,5,1,1,0,1
60296_0,,,,2,1,2,3
C(C(C(CCO)=O)CCO)=O,,,5,1,1,0,1
60298_0,,,,2,1,2,3
C(CCO)(C(C=O)CC(O)=O)=O,,,5,1,1,0,1
60300_0,,,,2,1,2,3
C(CCO)(C1C(CCO1)=O)=O,,,5,1,1,0,1
60302_0,,,,2,1,2,3
C(C(C(CCO)=O)C=C)(O)=O,,,5,1,1,0,1
60303_0,,,,2,1,2,3
60305_0,,,,2,1,2,3
C1(C(C(CCO)=O)CCO1)=O,,,5,1,1,0,1
60306_0,,,,2,1,2,3
60308_0,,,,2,1,2,3
C(C(C(CCO)=O)C)=O,,,5,1,1,0,1
60310_0,,,,2,1,2,3
C([CH]C(CCO)=O)(O)=O,,,5,1,1,0,1
60311_0,,,,2,1,2,3
60312_0,,,,2,1,2,3
60313_0,,,,2,1,2,3
60314_0,,,,2,1,2,3
60315_0,,,,2,1,2,3
60317_0,,,,2,1,2,3
C(C(C(CC(CO)O)=O)C)=O,,,5,1,1,0,1
60318_0,,,,2,1,2,3
60319_0,,,,2,1,2,3
60321_0,,,,2,1,2,3
C([CH]C(CC(CO)O)=O)(O)=O,,,5,1,1,0,1
60323_0,,,,2,1,2,3
C(C(CC(C(C=O)=O)=O)(O)O)=O,,,5,1,1,0,1
60324_0,,,,2,1,2,3
60326_0,,,,2,1,2,3
C(C(C(CC(C=O)=O)=O)(O)O)=O,,,5,1,1,0,1
60327_0,,,,2,1,2,3
60329_0,,,,2,1,2,3
C(C(C(C(C(C=O)=O)O)=O)C)=O,,,5,1,1,0,1
60331_0,,,,2,1,2,3
C(C(C(CC(C=O)=O)=O)(C)O)=O,,,5,1,1,0,1
60333_0,,,,2,1,2,3
C(C(C(C[C](C(O)=O)O)=O)=O)=O,,,5,1,1,0,1
60335_0,,,,2,1,2,3
C(C(C(C([CH]C(O)=O)=O)O)=O)=O,,,5,1,1,0,1
60337_0,,,,2,1,2,3
C(C(CC([C](C(O)=O)O)=O)=O)=O,,,5,1,1,0,1
60338_0,,,,2,1,2,3
60339_0,,,,2,1,2,3
60340_0,,,,2,1,2,3
60341_0,,,,2,1,2,3
60342_0,,,,2,1,2,3
60344_0,,,,2,1,2,3
C(C(C(C([CH]C(O)=O)=O)=O)O)=O,,,5,1,1,0,1
60346_0,,,,2,1,2,3
C(C(C(C=O)=O)C(C=O)(O)O)=O,,,5,1,1,0,1
60348_0,,,,2,1,2,3
C(C([C](C(O)=O)O)C(C=O)=O)=O,,,5,1,1,0,1
60350_0,,,,2,1,2,3
C(C(C(C=O)C(C=O)(O)O)O)=O,,,5,1,1,0,1
60352_0,,,,2,1,2,3
C(C(C(C(C=O)=O)CO)(O)O)=O,,,5,1,1,0,1
60353_0,,,,2,1,2,3
60355_0,,,,2,1,2,3
[C](C(O)=O)(C(C(C=O)=O)CO)O,,,5,1,2,0,2
60357_0,,,,2,1,2,3
C(C(CC(C(CO)=O)=O)(O)O)=O,,,5,1,1,0,1
60358_0,,,,2,1,2,3
60360_0,,,,2,1,2,3
C(C(C=O)(O)O)(CC(CO)=O)=O,,,5,1,1,0,1
60362_0,,,,2,1,2,3
[C](C(O)=O)(CC(C(CO)=O)=O)O,,,5,1,1,0,1
60364_0,,,,2,1,2,3
C(CO)(C(C([CH]C(O)=O)=O)O)=O,,,5,1,1,0,1
60366_0,,,,2,1,2,3
C(CO)(CC([C](C(O)=O)O)=O)=O,,,5,1,1,0,1
60368_0,,,,2,1,2,3
C(C(C(C)=O)C(C=O)(O)O)=O,,,5,1,2,0,2
60370_0,,,,2,1,2,3
C(C(C(C)=O)[C](C(O)=O)O)=O,,,5,1,3,0,3
60371_0,,,,2,1,2,3
60373_0,,,,2,1,2,3
C(CC=O)(C(C(C=O)=O)(C)O)=O,,,5,1,1,0,1
60374_0,,,,2,1,2,3
60376_0,,,,2,1,2,3
C(C(C)C(C(C=O)=O)(C)O)=O,,,5,1,1,0,1
60378_0,,,,2,1,2,3
C(CC(O)=O)(C(C(C=O)=O)C)=O,,,5,1,1,0,1
60380_0,,,,2,1,2,3
C=CC(C(C(C(C=O)=O)C)=O)=O,,,5,1,1,0,1
60382_0,,,,2,1,2,3
C(C(C(C(C=CC=O)=O)C)=O)=O,,,5,1,1,0,1
60383_0,,,,2,1,2,3
60384_0,,,,2,1,2,3
60386_0,,,,2,1,2,3
C(C(O)O)(C(C(C=O)=O)C)=O,,,5,1,1,0,1
60388_0,,,,2,1,2,3
C(CC(C(C=O)=O)(C)O)(C)=O,,,5,1,1,0,1
60390_0,,,,2,1,2,3
C(CC)(C(C(C=O)=O)(C)O)=O,,,5,1,1,0,1
60392_0,,,,2,1,2,3
C(C(C)O)(C(C(C=O)=O)C)=O,,,5,1,1,0,1
60393_0,,,,2,1,2,3
60394_0,,,,2,1,2,3
60396_0,,,,2,1,2,3
C(CCO)(C(C(C=O)=O)(C)O)=O,,,5,1,1,0,1
60397_0,,,,2,1,2,3
60398_0,,,,2,1,2,3
60399_0,,,,2,1,2,3
60401_0,,,,2,1,2,3
C(C(C(C(C(O)=O)=O)C)=O)=O,,,5,1,4,0,4
60403_0,,,,2,1,2,3
C(CC=O)(C(C(C=O)=O)C)=O,,,5,1,1,0,1
60405_0,,,,2,1,2,3
C(C)(C(C(C=O)=O)C)=O,,,5,1,1,0,1
60406_0,,,,2,1,2,3
60407_0,,,,2,1,2,3
60409_0,,,,2,1,2,3
C(C)(C(C(C=O)=O)(C)O)=O,,,5,1,1,0,1
60410_0,,,,2,1,2,3
60411_0,,,,2,1,2,3
60412_0,,,,2,1,2,3
60413_0,,,,2,1,2,3
60415_0,,,,2,1,2,3
C(C(C(C(C(C)O)=O)=O)C)=O,,,5,1,1,0,1
60417_0,,,,2,1,2,3
C(C([CH]C(O)=O)=O)(C(C)O)=O,,,5,1,1,0,1
60419_0,,,,2,1,2,3
C1(C(CC(C=O)=O)(O)OCC1)=O,,,5,1,2,0,2
60421_0,,,,2,1,2,3
C(C(C(C1C(CCO1)=O)=O)O)=O,,,5,1,1,0,1
60423_0,,,,2,1,2,3
C(CC(C1(C(CCO1)=O)O)=O)=O,,,5,1,1,0,1
60424_0,,,,2,1,2,3
60425_0,,,,2,1,2,3
60426_0,,,,2,1,2,3
60427_0,,,,2,1,2,3
60429_0,,,,2,1,2,3
C1(C(C(C(C=O)O)=O)CCO1)=O,,,5,1,1,0,1
60431_0,,,,2,1,2,3
C1(C(C(CC=O)=O)(CCO1)O)=O,,,5,1,1,0,1
60433_0,,,,2,1,2,3
C(C(CC(C=O)=O)(O)O)=O,,,5,1,1,0,1
60434_0,,,,2,1,2,3
60436_0,,,,2,1,2,3
C(CC(C(C=O)(O)O)=O)=O,,,5,1,1,0,1
60438_0,,,,2,1,2,3
C(C(C[C](C(O)=O)O)=O)=O,,,5,1,2,0,2
60440_0,,,,2,1,2,3
C(C(C([CH]C(O)=O)=O)O)=O,,,5,1,1,0,1
60442_0,,,,2,1,2,3
C(CC([C](C(O)=O)O)=O)=O,,,5,1,1,0,1
60444_0,,,,2,1,2,3
C(C(C)C(C=O)(CCO)O)=O,,,5,1,1,0,1
60446_0,,,,2,1,2,3
C(CC(C=O)(C(C=O)C)O)(O)=O,,,5,1,1,0,1
60448_0,,,,2,1,2,3
C(C(C)C1(C(CCO1)=O)O)=O,,,5,1,1,0,1
60450_0,,,,2,1,2,3
C(C(C=C)(C(C=O)C)O)(O)=O,,,5,1,1,0,1
60452_0,,,,2,1,2,3
C(C(C)C1(C(C(CO1)O)=O)O)=O,,,5,1,2,0,2
60454_0,,,,2,1,2,3
C(C(C)C1(C(OCC1)=O)O)=O,,,5,1,1,0,1
60456_0,,,,2,1,2,3
C(C(C)C(C=O)(O)O)=O,,,5,1,1,0,1
60458_0,,,,2,1,2,3
C(C(C)C(C=O)(C)O)=O,,,5,1,1,0,1
60460_0,,,,2,1,2,3
C(C([C](C(O)=O)O)C)=O,,,5,1,2,0,2
60461_0,,,,2,1,2,3
60462_0,,,,2,1,2,3
60463_0,,,,2,1,2,3
60465_0,,,,2,1,2,3
C(C(C(CC(O)=O)=O)CCO)=O,,,5,1,1,0,1
60467_0,,,,2,1,2,3
C(C(C(C(C=C)=O)=O)CCO)=O,,,5,1,1,0,1
60469_0,,,,2,1,2,3
C(C(C(C=CC=O)=O)CCO)=O,,,5,1,1,0,1
60470_0,,,,2,1,2,3
60471_0,,,,2,1,2,3
60473_0,,,,2,1,2,3
C(C(C(C(O)O)=O)CCO)=O,,,5,1,1,0,1
60475_0,,,,2,1,2,3
C(C(CCO)(CC(C)=O)O)=O,,,5,1,1,0,1
60477_0,,,,2,1,2,3
C(C(C(CC)=O)(CCO)O)=O,,,5,1,1,0,1
60479_0,,,,2,1,2,3
C(C(C(C(C)O)=O)CCO)=O,,,5,1,1,0,1
60481_0,,,,2,1,2,3
C(CC(C=O)(O)O)(CCO)=O,,,5,1,1,0,1
60482_0,,,,2,1,2,3
60484_0,,,,2,1,2,3
C(C(C(CCCO)=O)(O)O)=O,,,5,1,1,0,1
60486_0,,,,2,1,2,3
C(C(C)(CC(CCO)=O)O)=O,,,5,1,1,0,1
60488_0,,,,2,1,2,3
C(C(C(C(CCO)O)=O)C)=O,,,5,1,1,0,1
60490_0,,,,2,1,2,3
C(C(C(CCCO)=O)(C)O)=O,,,5,1,1,0,1
60492_0,,,,2,1,2,3
C(CCO)(C[C](C(O)=O)O)=O,,,5,1,3,0,3
60494_0,,,,2,1,2,3
C([CH]C(C(CCO)O)=O)(O)=O,,,5,1,1,0,1
60496_0,,,,2,1,2,3
C([C](C(CCCO)=O)O)(O)=O,,,5,1,1,0,1
60497_0,,,,2,1,2,3
60499_0,,,,2,1,2,3
C(CO)(C(C)C(C=O)(O)O)=O,,,5,1,1,0,1
60500_0,,,,2,1,2,3
60501_0,,,,2,1,2,3
60503_0,,,,2,1,2,3
C(C(C)(C(C(CO)=O)C)O)=O,,,5,1,1,0,1
60504_0,,,,2,1,2,3
60505_0,,,,2,1,2,3
60507_0,,,,2,1,2,3
C(CO)(C([C](C(O)=O)O)C)=O,,,5,1,1,0,1
60508_0,,,,2,1,2,3
60510_0,,,,2,1,2,3
C(CC(C1C(CCO1)=O)=O)(O)=O,,,5,1,1,0,1
60512_0,,,,2,1,2,3
C(C(C(CC(O)=O)=O)C=C)(O)=O,,,5,1,1,0,1
60514_0,,,,2,1,2,3
C1(C(C(CC(O)=O)=O)CCO1)=O,,,5,1,1,0,1
60515_0,,,,2,1,2,3
60517_0,,,,2,1,2,3
C(C(C(CC(O)=O)=O)C)=O,,,5,1,1,0,1
60519_0,,,,2,1,2,3
C(CC([CH]C(O)=O)=O)(O)=O,,,5,1,1,0,1
60520_0,,,,2,1,2,3
60521_0,,,,2,1,2,3
60523_0,,,,2,1,2,3
C(C(C(C(O)O)=O)CC(O)=O)=O,,,5,1,1,0,1
60525_0,,,,2,1,2,3
C(CC(C=O)(CC(C)=O)O)(O)=O,,,5,1,1,0,1
60527_0,,,,2,1,2,3
C(CC)(C(C=O)(CC(O)=O)O)=O,,,5,1,1,0,1
60529_0,,,,2,1,2,3
C(C(C)O)(C(C=O)CC(O)=O)=O,,,5,1,1,0,1
60531_0,,,,2,1,2,3
C(CC(CC(C=O)(O)O)=O)(O)=O,,,5,1,1,0,1
60532_0,,,,2,1,2,3
60534_0,,,,2,1,2,3
C(C(C(CCC(O)=O)=O)(O)O)=O,,,5,1,1,0,1
60535_0,,,,2,1,2,3
60537_0,,,,2,1,2,3
C(CC(C(C(C=O)C)=O)O)(O)=O,,,5,1,1,0,1
60539_0,,,,2,1,2,3
C(C(C(CCC(O)=O)=O)(C)O)=O,,,5,1,1,0,1
60541_0,,,,2,1,2,3
C(CC(C[C](C(O)=O)O)=O)(O)=O,,,5,1,1,0,1
60543_0,,,,2,1,2,3
C(CC(C([CH]C(O)=O)=O)O)(O)=O,,,5,1,1,0,1
60545_0,,,,2,1,2,3
C(CCC([C](C(O)=O)O)=O)(O)=O,,,5,1,1,0,1
60546_0,,,,2,1,2,3
60547_0,,,,2,1,2,3
60548_0,,,,2,1,2,3
60550_0,,,,2,1,2,3
C(C(C(C(C(O)=O)=O)C)(O)O)=O,,,5,1,1,0,1
60551_0,,,,2,1,2,3
60553_0,,,,2,1,2,3
[C](C(O)=O)(C(C(C(O)=O)=O)C)O,,,5,1,1,0,1
60555_0,,,,2,1,2,3
C(C(C=O)C(C=O)(O)O)(O)=O,,,5,1,1,0,1
60556_0,,,,2,1,2,3
60557_0,,,,2,1,2,3
60559_0,,,,2,1,2,3
C(CC(C([CH]C(O)=O)=O)=O)=O,,,5,1,1,0,1
60560_0,,,,2,1,2,3
60562_0,,,,2,1,2,3
C(C(C(CC(C=O)=O)=O)C)=O,,,5,1,1,0,1
60564_0,,,,2,1,2,3
C(C(CC([CH]C(O)=O)=O)=O)=O,,,5,1,1,0,1
60565_0,,,,2,1,2,3
60566_0,,,,2,1,2,3
60568_0,,,,2,1,2,3
C(CC(C=O)=O)(C(C(O)=O)C)=O,,,5,1,2,0,2
60570_0,,,,2,1,2,3
C(C(C(C)=O)CC(CO)=O)(O)=O,,,5,1,1,0,1
60571_0,,,,2,1,2,3
60573_0,,,,2,1,2,3
C(CC(C([CH]C(O)=O)=O)=O)(O)=O,,,5,1,1,0,1
60574_0,,,,2,1,2,3
60576_0,,,,2,1,2,3
C(C(C(CC(C(O)=O)=O)=O)C)=O,,,5,1,1,0,1
60578_0,,,,2,1,2,3
C(C(CC([CH]C(O)=O)=O)=O)(O)=O,,,5,1,1,0,1
60580_0,,,,2,1,2,3
C(C(CCC(C(O)=O)=O)=O)(O)=O,,,5,1,1,0,1
60581_0,,,,2,1,2,3
60583_0,,,,2,1,2,3
C1(COCC1C(C=O)(O)O)=O,,,5,1,1,0,1
60585_0,,,,2,1,2,3
C(C(C)(C1C(COC1)=O)O)=O,,,5,1,1,0,1
60587_0,,,,2,1,2,3
C1(COCC1[C](C(O)=O)O)=O,,,5,1,1,0,1
60589_0,,,,2,1,2,3
C(C(C1COCC1O)=O)(O)=O,,,5,1,1,0,1
60591_0,,,,2,1,2,3
C1(COCC1C(C(O)=O)O)=O,,,5,1,1,0,1
60593_0,,,,2,1,2,3
C(C(C)(C1C(COC1)=O)O)(O)=O,,,5,1,1,0,1
60595_0,,,,2,1,2,3
C1(CCOC1C(C(C=C)=O)=O)=O,,,5,1,1,0,1
60597_0,,,,2,1,2,3
C1(CCOC1C(C=CC=O)=O)=O,,,5,1,1,0,1
60599_0,,,,2,1,2,3
C(CC1(C(CCO1)=O)O)(O)=O,,,5,1,3,0,3
60600_0,,,,2,1,2,3
60602_0,,,,2,1,2,3
C1(CCOC1C(C(O)O)=O)=O,,,5,1,1,0,1
60604_0,,,,2,1,2,3
C(CC1(C(CCO1)=O)O)(C)=O,,,5,1,1,0,1
60606_0,,,,2,1,2,3
C1(CCOC1(C(CC)=O)O)=O,,,5,1,1,0,1
60608_0,,,,2,1,2,3
C1(CCOC1C(C(C)O)=O)=O,,,5,1,1,0,1
60610_0,,,,2,1,2,3
C(CC1(C(CCO1)=O)O)(CO)=O,,,5,1,2,0,2
60611_0,,,,2,1,2,3
60613_0,,,,2,1,2,3
C(CCO)(C1(C(CCO1)=O)O)=O,,,5,1,1,0,1
60615_0,,,,2,1,2,3
C1(CCOC1C(C(CO)O)=O)=O,,,5,1,1,0,1
60616_0,,,,2,1,2,3
60618_0,,,,2,1,2,3
C1(CCOC1C(C=O)=O)=O,,,5,1,1,0,1
60620_0,,,,2,1,2,3
C(C(CO)C1(C(CCO1)=O)O)=O,,,5,1,2,0,2
60622_0,,,,2,1,2,3
C1(CCOC1C(C(O)=O)=O)=O,,,5,1,1,0,1
60624_0,,,,2,1,2,3
C1(CCOC1C(C(C)=O)=O)=O,,,5,1,1,0,1
60626_0,,,,2,1,2,3
C(CC(C1C(CCO1)=O)=O)=O,,,5,1,1,0,1
60628_0,,,,2,1,2,3
C1(CCOC1C(C)=O)=O,,,5,1,1,0,1
60630_0,,,,2,1,2,3
C(C(C=O)C1(C(CCO1)=O)O)=O,,,5,1,1,0,1
60632_0,,,,2,1,2,3
C1(CCOC1C(C(CO)=O)=O)=O,,,5,1,1,0,1
60634_0,,,,2,1,2,3
C(C1C(CCO1)=O)=O,,,5,1,1,0,1
60636_0,,,,2,1,2,3
C(CC1(C(CCO1)=O)O)=O,,,5,1,3,0,3
60638_0,,,,2,1,2,3
C1(CCOC1(C(C)=O)O)=O,,,5,1,1,0,1
60640_0,,,,2,1,2,3
C1(CCOC1C(CO)=O)=O,,,5,1,1,0,1
60642_0,,,,2,1,2,3
C1(C(CCO1)C(C=O)(O)O)=O,,,5,1,1,0,1
60644_0,,,,2,1,2,3
C1(C(CCO1)C(C=O)(C)O)=O,,,5,1,1,0,1
60646_0,,,,2,1,2,3
C1(C([C](C(O)=O)O)CCO1)=O,,,5,1,1,0,1
60648_0,,,,2,1,2,3
C(C(C1C(O)OCC1)=O)(O)=O,,,5,1,2,0,2
60650_0,,,,2,1,2,3
C1(C(CCO1)C(C(O)=O)O)=O,,,5,1,1,0,1
60652_0,,,,2,1,2,3
C1(C(CCO1)C(C(O)=O)(C)O)=O,,,5,1,1,0,1
60654_0,,,,2,1,2,3
C(C(C1COC(C1)O)=O)(O)=O,,,5,1,2,0,2
60655_0,,,,2,1,2,3
60657_0,,,,2,1,2,3
C([CH]C(C(C(C)=O)=O)=O)(O)=O,,,5,1,1,0,1
60659_0,,,,2,1,2,3
C(C(C=C)C(C(O)=O)=O)=O,,,5,1,3,0,3
60661_0,,,,2,1,2,3
C(C(C=C)C(C(C=C)=O)=O)(O)=O,,,5,1,1,0,1
60663_0,,,,2,1,2,3
C1(C(C(C(C=C)=O)=O)CCO1)=O,,,5,1,1,0,1
60664_0,,,,2,1,2,3
60666_0,,,,2,1,2,3
C(C(C(C(C=C)=O)=O)C)=O,,,5,1,1,0,1
60668_0,,,,2,1,2,3
C=CC(C([CH]C(O)=O)=O)=O,,,5,1,1,0,1
60670_0,,,,2,1,2,3
C=CC(CC(C(O)=O)=O)=O,,,5,1,2,0,2
60672_0,,,,2,1,2,3
C(CC(C(C=C)=O)=O)(O)=O,,,5,1,2,0,2
60673_0,,,,2,1,2,3
60675_0,,,,2,1,2,3
C(C(C(C(C=C)=O)=O)C)(O)=O,,,5,1,2,0,2
60677_0,,,,2,1,2,3
C(C(C=C)C(C=CC=O)=O)(O)=O,,,5,1,1,0,1
60679_0,,,,2,1,2,3
C1(C(C(C=CC=O)=O)CCO1)=O,,,5,1,1,0,1
60680_0,,,,2,1,2,3
60682_0,,,,2,1,2,3
C(C(C(C=CC=O)=O)C)=O,,,5,1,1,0,1
60684_0,,,,2,1,2,3
C(C=CC([CH]C(O)=O)=O)=O,,,5,1,1,0,1
60685_0,,,,2,1,2,3
60686_0,,,,2,1,2,3
60688_0,,,,2,1,2,3
C(C(C(C=CC=O)=O)CC=O)=O,,,5,1,1,0,1
60690_0,,,,2,1,2,3
C(C(C(C=CC=O)=O)C)(O)=O,,,5,1,3,0,3
60692_0,,,,2,1,2,3
C(C(C=C)(CC(O)=O)O)(O)=O,,,5,1,2,0,2
60693_0,,,,2,1,2,3
60695_0,,,,2,1,2,3
C(C(C(C(O)O)=O)C=C)(O)=O,,,5,1,1,0,1
60697_0,,,,2,1,2,3
C(C(C=C)(CC(C)=O)O)(O)=O,,,5,1,1,0,1
60699_0,,,,2,1,2,3
C(C(C(CC)=O)(C=C)O)(O)=O,,,5,1,1,0,1
60701_0,,,,2,1,2,3
C(C(C(C(C)O)=O)C=C)(O)=O,,,5,1,1,0,1
60702_0,,,,2,1,2,3
60703_0,,,,2,1,2,3
60705_0,,,,2,1,2,3
C(C(C(CCO)=O)(C=C)O)(O)=O,,,5,1,2,0,2
60707_0,,,,2,1,2,3
C(C(C(C(CO)O)=O)C=C)(O)=O,,,5,1,2,0,2
60708_0,,,,2,1,2,3
60709_0,,,,2,1,2,3
60710_0,,,,2,1,2,3
60712_0,,,,2,1,2,3
C(C(C=C)C(C(O)=O)=O)(O)=O,,,5,1,2,0,2
60714_0,,,,2,1,2,3
C(C(C=C)C(C(C)=O)=O)(O)=O,,,5,1,2,0,2
60716_0,,,,2,1,2,3
C(C(C(CC=O)=O)C=C)(O)=O,,,5,1,2,0,2
60718_0,,,,2,1,2,3
C(C(C(C)=O)C=C)(O)=O,,,5,1,2,0,2
60719_0,,,,2,1,2,3
60721_0,,,,2,1,2,3
C(C(C=C)C(C(CO)=O)=O)(O)=O,,,5,1,1,0,1
60722_0,,,,2,1,2,3
60723_0,,,,2,1,2,3
60724_0,,,,2,1,2,3
60725_0,,,,2,1,2,3
60727_0,,,,2,1,2,3
C(CC1(C(C(CO1)O)=O)O)(O)=O,,,5,1,2,0,2
60728_0,,,,2,1,2,3
60730_0,,,,2,1,2,3
C1(C(COC1C(C(O)O)=O)O)=O,,,5,1,1,0,1
60732_0,,,,2,1,2,3
C(CC1(C(C(CO1)O)=O)O)(C)=O,,,5,1,2,0,2
60734_0,,,,2,1,2,3
C(CC)(C1(C(C(CO1)O)=O)O)=O,,,5,1,1,0,1
60735_0,,,,2,1,2,3
60736_0,,,,2,1,2,3
60738_0,,,,2,1,2,3
C1(C(COC1C(C(O)=O)=O)O)=O,,,5,1,2,0,2
60739_0,,,,2,1,2,3
60740_0,,,,2,1,2,3
60741_0,,,,2,1,2,3
60742_0,,,,2,1,2,3
60744_0,,,,2,1,2,3
C(CC1(C(C(CO1)O)=O)O)=O,,,5,1,2,0,2
60746_0,,,,2,1,2,3
C1(C(COC1(C(C)=O)O)O)=O,,,5,1,1,0,1
60747_0,,,,2,1,2,3
60749_0,,,,2,1,2,3
C1(C(C(CO1)O)C(C=O)(O)O)=O,,,5,1,1,0,1
60751_0,,,,2,1,2,3
C1(COC(C1C(C=O)(O)O)O)=O,,,5,1,1,0,1
60752_0,,,,2,1,2,3
60753_0,,,,2,1,2,3
60755_0,,,,2,1,2,3
C1(C([C](C(O)=O)O)C(CO1)O)=O,,,5,1,1,0,1
60757_0,,,,2,1,2,3
C1(COC(C1[C](C(O)=O)O)O)=O,,,5,1,1,0,1
60758_0,,,,2,1,2,3
60759_0,,,,2,1,2,3
60761_0,,,,2,1,2,3
C1(C(CCO1)(CC(O)=O)O)=O,,,5,1,1,0,1
60762_0,,,,2,1,2,3
60764_0,,,,2,1,2,3
C1(C(C(C(O)O)=O)CCO1)=O,,,5,1,1,0,1
60766_0,,,,2,1,2,3
C1(C(CCO1)(CC(C)=O)O)=O,,,5,1,1,0,1
60768_0,,,,2,1,2,3
C1(C(C(CC)=O)(CCO1)O)=O,,,5,1,1,0,1
60770_0,,,,2,1,2,3
C1(C(C(C(C)O)=O)CCO1)=O,,,5,1,1,0,1
60771_0,,,,2,1,2,3
60772_0,,,,2,1,2,3
60774_0,,,,2,1,2,3
C1(C(C(CCO)=O)(CCO1)O)=O,,,5,1,1,0,1
60776_0,,,,2,1,2,3
C1(C(C(C(CO)O)=O)CCO1)=O,,,5,1,1,0,1
60777_0,,,,2,1,2,3
60779_0,,,,2,1,2,3
C1(C(C(C=O)=O)CCO1)=O,,,5,1,2,0,2
60780_0,,,,2,1,2,3
60782_0,,,,2,1,2,3
C1(C(C(C(O)=O)=O)CCO1)=O,,,5,1,2,0,2
60784_0,,,,2,1,2,3
C1(C(C(C(C)=O)=O)CCO1)=O,,,5,1,2,0,2
60786_0,,,,2,1,2,3
C(CC=O)(C1C(OCC1)=O)=O,,,5,1,2,0,2
60788_0,,,,2,1,2,3
C(C)(C1C(OCC1)=O)=O,,,5,1,2,0,2
60789_0,,,,2,1,2,3
60791_0,,,,2,1,2,3
C1(C(C(C(CO)=O)=O)CCO1)=O,,,5,1,1,0,1
60793_0,,,,2,1,2,3
C(C1C(OCC1)=O)=O,,,5,1,2,0,2
60794_0,,,,2,1,2,3
60796_0,,,,2,1,2,3
C1(C(C(C)=O)(CCO1)O)=O,,,5,1,2,0,2
60798_0,,,,2,1,2,3
C1(C(C(CO)=O)CCO1)=O,,,5,1,2,0,2
60800_0,,,,2,1,2,3
C(C(C(C)=O)CC(CO)O)(O)=O,,,5,1,1,0,1
60801_0,,,,2,1,2,3
60802_0,,,,2,1,2,3
60804_0,,,,2,1,2,3
C(C(C=O)CC(CO)O)(O)=O,,,5,1,1,0,1
60805_0,,,,2,1,2,3
60806_0,,,,2,1,2,3
60807_0,,,,2,1,2,3
60809_0,,,,2,1,2,3
C(C(C(C)=O)CC(O)=O)(O)=O,,,5,1,1,0,1
60810_0,,,,2,1,2,3
60811_0,,,,2,1,2,3
60812_0,,,,2,1,2,3
60813_0,,,,2,1,2,3
60815_0,,,,2,1,2,3
C(CC(C=O)(O)O)(O)=O,,,5,1,1,0,1
60816_0,,,,2,1,2,3
60818_0,,,,2,1,2,3
C(C(C(C(O)O)=O)O)=O,,,5,1,1,0,1
60820_0,,,,2,1,2,3
C(C(CC(C)=O)(O)O)=O,,,5,1,1,0,1
60822_0,,,,2,1,2,3
C(C(C(CC)=O)(O)O)=O,,,5,1,1,0,1
60823_0,,,,2,1,2,3
60825_0,,,,2,1,2,3
C(C(CC(CO)=O)(O)O)=O,,,5,1,1,0,1
60826_0,,,,2,1,2,3
60828_0,,,,2,1,2,3
C(C(C(CCO)=O)(O)O)=O,,,5,1,1,0,1
60829_0,,,,2,1,2,3
60830_0,,,,2,1,2,3
60832_0,,,,2,1,2,3
C(CC(C=O)(O)O)(C(CO)O)=O,,,5,1,1,0,1
60833_0,,,,2,1,2,3
60835_0,,,,2,1,2,3
C(C(C(CC(CO)O)=O)(O)O)=O,,,5,1,1,0,1
60836_0,,,,2,1,2,3
60837_0,,,,2,1,2,3
60838_0,,,,2,1,2,3
60839_0,,,,2,1,2,3
60840_0,,,,2,1,2,3
60842_0,,,,2,1,2,3
C(C(C(CC(C=O)(O)O)=O)O)=O,,,5,1,1,0,1
60843_0,,,,2,1,2,3
60845_0,,,,2,1,2,3
C(C(C(CC(C=O)O)=O)(O)O)=O,,,5,1,1,0,1
60846_0,,,,2,1,2,3
60847_0,,,,2,1,2,3
60849_0,,,,2,1,2,3
C(C(CO)C(C=O)(O)O)=O,,,5,1,1,0,1
60851_0,,,,2,1,2,3
C(C(C(CO)O)C(C=O)(O)O)=O,,,5,1,2,0,2
60852_0,,,,2,1,2,3
60854_0,,,,2,1,2,3
C(CO)(C(CO)C(C=O)(O)O)=O,,,5,1,1,0,1
60855_0,,,,2,1,2,3
60856_0,,,,2,1,2,3
60857_0,,,,2,1,2,3
60859_0,,,,2,1,2,3
C(C(C(C(CO)CO)=O)(O)O)=O,,,5,1,1,0,1
60860_0,,,,2,1,2,3
60861_0,,,,2,1,2,3
60862_0,,,,2,1,2,3
60863_0,,,,2,1,2,3
60865_0,,,,2,1,2,3
C(CC(CC(C=O)(O)O)=O)=O,,,5,1,1,0,1
60867_0,,,,2,1,2,3
C(C(C(CCC=O)=O)(O)O)=O,,,5,1,1,0,1
60868_0,,,,2,1,2,3
60869_0,,,,2,1,2,3
60870_0,,,,2,1,2,3
60871_0,,,,2,1,2,3
60873_0,,,,2,1,2,3
C(C(CC(C(C)=O)=O)(O)O)=O,,,5,1,1,0,1
60875_0,,,,2,1,2,3
C(C(C=O)(O)O)(CC(C)=O)=O,,,5,1,1,0,1
60876_0,,,,2,1,2,3
60878_0,,,,2,1,2,3
C(C(C(C(C=O)=O)C)(O)O)=O,,,5,1,1,0,1
60879_0,,,,2,1,2,3
60881_0,,,,2,1,2,3
C(C(C=O)C(C=O)(O)O)=O,,,5,1,1,0,1
60882_0,,,,2,1,2,3
60883_0,,,,2,1,2,3
60885_0,,,,2,1,2,3
C(C(C(CO)=O)C(C=O)(O)O)=O,,,5,1,1,0,1
60886_0,,,,2,1,2,3
60887_0,,,,2,1,2,3
60888_0,,,,2,1,2,3
60889_0,,,,2,1,2,3
60890_0,,,,2,1,2,3
60892_0,,,,2,1,2,3
C(CC(C=O)(O)O)=O,,,5,1,1,0,1
60893_0,,,,2,1,2,3
60894_0,,,,2,1,2,3
60895_0,,,,2,1,2,3
60897_0,,,,2,1,2,3
C(C(C(C(O)O)=O)C)=O,,,5,1,1,0,1
60898_0,,,,2,1,2,3
60899_0,,,,2,1,2,3
60901_0,,,,2,1,2,3
C([CH]C(C(O)O)=O)(O)=O,,,5,1,1,0,1
60902_0,,,,2,1,2,3
60904_0,,,,2,1,2,3
C(C(CC(O)O)=O)(O)=O,,,5,1,1,0,1
60905_0,,,,2,1,2,3
60907_0,,,,2,1,2,3
C(CC(C(O)O)=O)(O)=O,,,5,1,1,0,1
60908_0,,,,2,1,2,3
60909_0,,,,2,1,2,3
60911_0,,,,2,1,2,3
C(C(C(C(O)O)=O)CC=O)=O,,,5,1,1,0,1
60912_0,,,,2,1,2,3
60913_0,,,,2,1,2,3
60915_0,,,,2,1,2,3
C(C(C(C(O)O)=O)C)(O)=O,,,5,1,1,0,1
60916_0,,,,2,1,2,3
60917_0,,,,2,1,2,3
60919_0,,,,2,1,2,3
C(C(C(C(O)O)=O)CCO)(O)=O,,,5,1,1,0,1
60920_0,,,,2,1,2,3
60922_0,,,,2,1,2,3
C(C(C)(CC(C)=O)O)=O,,,5,1,1,0,1
60924_0,,,,2,1,2,3
C(C(C(CC)=O)(C)O)=O,,,5,1,1,0,1
60926_0,,,,2,1,2,3
C(C(C(C(C)O)=O)C)=O,,,5,1,1,0,1
60927_0,,,,2,1,2,3
60928_0,,,,2,1,2,3
60930_0,,,,2,1,2,3
C(C(C(CCO)=O)(C)O)=O,,,5,1,1,0,1
60932_0,,,,2,1,2,3
C(C(C(C(CO)O)=O)C)=O,,,5,1,1,0,1
60933_0,,,,2,1,2,3
60934_0,,,,2,1,2,3
60935_0,,,,2,1,2,3
60937_0,,,,2,1,2,3
C(C(C(CC(CO)O)=O)(C)O)=O,,,5,1,1,0,1
60939_0,,,,2,1,2,3
C(C(C(C(C(CO)O)O)=O)C)=O,,,5,1,1,0,1
60940_0,,,,2,1,2,3
60941_0,,,,2,1,2,3
60942_0,,,,2,1,2,3
60943_0,,,,2,1,2,3
60945_0,,,,2,1,2,3
C(C(C(C(CO)CO)=O)(C)O)=O,,,5,1,1,0,1
60947_0,,,,2,1,2,3
C(C(C(C(CO)(CO)O)=O)C)=O,,,5,1,1,0,1
60949_0,,,,2,1,2,3
C(C(C(CC=O)=O)C)=O,,,5,1,1,0,1
60951_0,,,,2,1,2,3
C(CC(C=O)O)(C(C=O)C)=O,,,5,1,1,0,1
60953_0,,,,2,1,2,3
C(C(C(CC(CO)=O)=O)C)=O,,,5,1,1,0,1
60954_0,,,,2,1,2,3
60956_0,,,,2,1,2,3
C(C(C(CC(C)=O)=O)(C)O)=O,,,5,1,1,0,1
60958_0,,,,2,1,2,3
C(C(C(C(C(C)=O)O)=O)C)=O,,,5,1,1,0,1
60959_0,,,,2,1,2,3
60961_0,,,,2,1,2,3
C(C(C(C)=O)C)=O,,,5,1,1,0,1
60963_0,,,,2,1,2,3
C(C(C=O)C)=O,,,5,1,2,0,2
60965_0,,,,2,1,2,3
C(C)(C[C](C(O)=O)O)=O,,,5,1,3,0,3
60967_0,,,,2,1,2,3
C([CH]C(C(C)O)=O)(O)=O,,,5,1,1,0,1
60969_0,,,,2,1,2,3
C([C](C(O)=O)O)(CC)=O,,,5,1,1,0,1
60971_0,,,,2,1,2,3
C(C(C)(CC(C)=O)O)(O)=O,,,5,1,1,0,1
60973_0,,,,2,1,2,3
C(C(C(C(C)O)=O)C)(O)=O,,,5,1,1,0,1
60975_0,,,,2,1,2,3
C(C(C(CC)=O)(C)O)(O)=O,,,5,1,1,0,1
60977_0,,,,2,1,2,3
C(C(CCO)(CC(C)=O)O)(O)=O,,,5,1,1,0,1
60979_0,,,,2,1,2,3
C(C(C(C(C)O)=O)CCO)(O)=O,,,5,1,1,0,1
60981_0,,,,2,1,2,3
C(C(C(CC)=O)(CCO)O)(O)=O,,,5,1,1,0,1
60983_0,,,,2,1,2,3
C(CO)(C[C](C(O)=O)O)=O,,,5,1,2,0,2
60984_0,,,,2,1,2,3
60986_0,,,,2,1,2,3
C([C](C(CCO)=O)O)(O)=O,,,5,1,2,0,2
60988_0,,,,2,1,2,3
C([CH]C(C(CO)O)=O)(O)=O,,,5,1,1,0,1
60989_0,,,,2,1,2,3
60991_0,,,,2,1,2,3
C(C(CO)O)(C[C](C(O)=O)O)=O,,,5,1,2,0,2
60992_0,,,,2,1,2,3
60994_0,,,,2,1,2,3
C([C](C(CC(CO)O)=O)O)(O)=O,,,5,1,2,0,2
60996_0,,,,2,1,2,3
C([CH]C(C(C(CO)O)O)=O)(O)=O,,,5,1,1,0,1
60997_0,,,,2,1,2,3
60998_0,,,,2,1,2,3
60999_0,,,,2,1,2,3
61001_0,,,,2,1,2,3
C(C([CH]C(O)=O)=O)=O,,,5,1,1,0,1
61003_0,,,,2,1,2,3
C(C(C(C[C](C(O)=O)O)=O)O)=O,,,5,1,2,0,2
61004_0,,,,2,1,2,3
61006_0,,,,2,1,2,3
C(C(CC([C](C(O)=O)O)=O)O)=O,,,5,1,1,0,1
61008_0,,,,2,1,2,3
C(C(C(C([CH]C(O)=O)=O)O)O)=O,,,5,1,1,0,1
61009_0,,,,2,1,2,3
61010_0,,,,2,1,2,3
61011_0,,,,2,1,2,3
61012_0,,,,2,1,2,3
61014_0,,,,2,1,2,3
C(CO)(C([C](C(O)=O)O)CO)=O,,,5,1,2,0,2
61015_0,,,,2,1,2,3
61017_0,,,,2,1,2,3
C(C([CH]C(O)=O)=O)(O)=O,,,5,1,1,0,1
61018_0,,,,2,1,2,3
61020_0,,,,2,1,2,3
C([C](C(C(CO)CO)=O)O)(O)=O,,,5,1,1,0,1
61022_0,,,,2,1,2,3
C([CH]C(C(CO)(CO)O)=O)(O)=O,,,5,1,1,0,1
61024_0,,,,2,1,2,3
C([CH]C(C(C)=O)=O)(O)=O,,,5,1,1,0,1
61026_0,,,,2,1,2,3
C(CC([CH]C(O)=O)=O)=O,,,5,1,1,0,1
61028_0,,,,2,1,2,3
C(C([CH]C(O)=O)=O)(CCO)=O,,,5,1,1,0,1
61030_0,,,,2,1,2,3
C(CC(C[C](C(O)=O)O)=O)=O,,,5,1,2,0,2
61032_0,,,,2,1,2,3
C(CCC([C](C(O)=O)O)=O)=O,,,5,1,1,0,1
61034_0,,,,2,1,2,3
C(CC(C([CH]C(O)=O)=O)O)=O,,,5,1,1,0,1
61036_0,,,,2,1,2,3
C(C(CC([CH]C(O)=O)=O)O)=O,,,5,1,1,0,1
61038_0,,,,2,1,2,3
C(CO)(CC([CH]C(O)=O)=O)=O,,,5,1,1,0,1
61039_0,,,,2,1,2,3
61041_0,,,,2,1,2,3
[C](C(O)=O)(CC(C(C)=O)=O)O,,,5,1,1,0,1
61043_0,,,,2,1,2,3
C(C)(CC([C](C(O)=O)O)=O)=O,,,5,1,1,0,1
61045_0,,,,2,1,2,3
C(C)(C(C([CH]C(O)=O)=O)O)=O,,,5,1,1,0,1
61047_0,,,,2,1,2,3
[C](C(O)=O)(C(C(C=O)=O)C)O,,,5,1,1,0,1
61049_0,,,,2,1,2,3
C([CH]C(C)=O)(O)=O,,,5,1,1,0,1
61051_0,,,,2,1,2,3
C(C(C=O)[C](C(O)=O)O)=O,,,5,1,2,0,2
61053_0,,,,2,1,2,3
C([CH]C(C(CO)=O)=O)(O)=O,,,5,1,1,0,1
61054_0,,,,2,1,2,3
61056_0,,,,2,1,2,3
C(C(C(CO)=O)[C](C(O)=O)O)=O,,,5,1,2,0,2
61057_0,,,,2,1,2,3
61059_0,,,,2,1,2,3
C(C([CH]C(O)=O)=O)(C(CO)O)=O,,,5,1,1,0,1
61060_0,,,,2,1,2,3
61061_0,,,,2,1,2,3
61063_0,,,,2,1,2,3
C([CH]C(O)=O)=O,,,5,1,1,0,1
61064_0,,,,2,1,2,3
61065_0,,,,2,1,2,3
61067_0,,,,2,1,2,3
C([CH]C(CO)=O)(O)=O,,,5,1,1,0,1
61068_0,,,,2,1,2,3
61069_0,,,,2,1,2,3
61070_0,,,,2,1,2,3
61071_0,,,,2,1,2,3
61072_0,,,,2,1,2,3
61073_0,,,,2,1,2,3
61074_0,,,,2,1,2,3
61075_0,,,,2,1,2,3
61076_0,,,,2,1,2,3
61077_0,,,,2,1,2,3
61078_0,,,,2,1,2,3
61079_0,,,,2,1,2,3
61080_0,,,,2,1,2,3
61081_0,,,,2,1,2,3
61082_0,,,,2,1,2,3
61083_0,,,,2,1,2,3
61084_0,,,,2,1,2,3
61085_0,,,,2,1,2,3
61086_0,,,,2,1,2,3
61087_0,,,,2,1,2,3
61088_0,,,,2,1,2,3
61089_0,,,,2,1,2,3
61090_0,,,,2,1,2,3
61091_0,,,,2,1,2,3
61092_0,,,,2,1,2,3
61093_0,,,,2,1,2,3
61094_0,,,,2,1,2,3
61095_0,,,,2,1,2,3
61096_0,,,,2,1,2,3
61097_0,,,,2,1,2,3
61098_0,,,,2,1,2,3
61099_0,,,,2,1,2,3
61100_0,,,,2,1,2,3
61101_0,,,,2,1,2,3
61102_0,,,,2,1,2,3
61103_0,,,,2,1,2,3
61104_0,,,,2,1,2,3
61105_0,,,,2,1,2,3
61106_0,,,,2,1,2,3
61107_0,,,,2,1,2,3
61108_0,,,,2,1,2,3
61109_0,,,,2,1,2,3
61110_0,,,,2,1,2,3
61111_0,,,,2,1,2,3
61112_0,,,,2,1,2,3
61113_0,,,,2,1,2,3
61114_0,,,,2,1,2,3
61115_0,,,,2,1,2,3
61116_0,,,,2,1,2,3
61117_0,,,,2,1,2,3
61118_0,,,,2,1,2,3
61119_0,,,,2,1,2,3
61120_0,,,,2,1,2,3
61121_0,,,,2,1,2,3
61122_0,,,,2,1,2,3
61123_0,,,,2,1,2,3
61124_0,,,,2,1,2,3
61125_0,,,,2,1,2,3
61126_0,,,,2,1,2,3
61127_0,,,,2,1,2,3
61128_0,,,,2,1,2,3
61129_0,,,,2,1,2,3
61130_0,,,,2,1,2,3
61131_0,,,,2,1,2,3
61132_0,,,,2,1,2,3
61133_0,,,,2,1,2,3
61134_0,,,,2,1,2,3
61135_0,,,,2,1,2,3
61136_0,,,,2,1,2,3
61137_0,,,,2,1,2,3
61138_0,,,,2,1,2,3
61139_0,,,,2,1,2,3
61140_0,,,,2,1,2,3
61141_0,,,,2,1,2,3
61142_0,,,,2,1,2,3
61143_0,,,,2,1,2,3
61144_0,,,,2,1,2,3
61145_0,,,,2,1,2,3
61146_0,,,,2,1,2,3
61147_0,,,,2,1,2,3
61148_0,,,,2,1,2,3
61150_0,,,,2,1,2,3
C(CC1C(C(CO1)=O)O)=O,,,5,1,2,0,2
61152_0,,,,2,1,2,3
C1(COC(C(C)=O)C1O)=O,,,5,1,2,0,2
61153_0,,,,2,1,2,3
61154_0,,,,2,1,2,3
61156_0,,,,2,1,2,3
C1(CC(C(CC=O)O1)O)=O,,,5,1,3,0,3
61158_0,,,,2,1,2,3
C1(CC(C(C(C)=O)O1)O)=O,,,5,1,3,0,3
61159_0,,,,2,1,2,3
61160_0,,,,2,1,2,3
61161_0,,,,2,1,2,3
61162_0,,,,2,1,2,3
61163_0,,,,2,1,2,3
61164_0,,,,2,1,2,3
61165_0,,,,2,1,2,3
61166_0,,,,2,1,2,3
61167_0,,,,2,1,2,3
61168_0,,,,2,1,2,3
61170_0,,,,2,1,2,3
C1(COCC(C1)=O)=O,,,5,1,2,0,2
61172_0,,,,2,1,2,3
C1(C(COCC1)=O)=O,,,5,1,2,0,2
61174_0,,,,2,1,2,3
C1(CCC(CO1)=O)=O,,,5,1,2,0,2
61176_0,,,,2,1,2,3
C1(CCOC(C1)=O)=O,,,5,1,2,0,2
61177_0,,,,2,1,2,3
61178_0,,,,2,1,2,3
61179_0,,,,2,1,2,3
61180_0,,,,2,1,2,3
61182_0,,,,2,1,2,3
C1(C(CO)OCC(C1)=O)=O,,,5,1,2,0,2
61184_0,,,,2,1,2,3
C1(C(COC(CO)C1)=O)=O,,,5,1,2,0,2
61186_0,,,,2,1,2,3
C1(CCC(OC1CO)=O)=O,,,5,1,2,0,2
61188_0,,,,2,1,2,3
C1(CC(CC(CO)O1)=O)=O,,,5,1,2,0,2
61189_0,,,,2,1,2,3
61190_0,,,,2,1,2,3
61191_0,,,,2,1,2,3
61192_0,,,,2,1,2,3
61194_0,,,,2,1,2,3
C1(C(CO)CC(CO1)=O)=O,,,5,1,2,0,2
61196_0,,,,2,1,2,3
C(C1C(OCC(C1)=O)O)=O,,,5,1,3,0,3
61198_0,,,,2,1,2,3
C1(C(C(CCO1)=O)CO)=O,,,5,1,2,0,2
61200_0,,,,2,1,2,3
C(C1C(CCOC1O)=O)=O,,,5,1,3,0,3
61201_0,,,,2,1,2,3
61202_0,,,,2,1,2,3
61203_0,,,,2,1,2,3
61204_0,,,,2,1,2,3
61206_0,,,,2,1,2,3
C(C1C(COCC1=O)=O)=O,,,5,1,2,0,2
61208_0,,,,2,1,2,3
C(C1C(COC(C1)=O)=O)=O,,,5,1,2,0,2
61209_0,,,,2,1,2,3
61210_0,,,,2,1,2,3
61212_0,,,,2,1,2,3
C1(C(COCC(C1)=O)O)=O,,,5,1,2,0,2
61214_0,,,,2,1,2,3
C1(CCOCC(C1O)=O)=O,,,5,1,2,0,2
61216_0,,,,2,1,2,3
C1(C(COCC(C1)O)=O)=O,,,5,1,2,0,2
61218_0,,,,2,1,2,3
C1(COCC(CC1O)=O)=O,,,5,1,2,0,2
61220_0,,,,2,1,2,3
C1(CCOC(C(C1)=O)O)=O,,,5,1,3,0,3
61222_0,,,,2,1,2,3
C1(COC(C(CC1)=O)O)=O,,,5,1,3,0,3
61224_0,,,,2,1,2,3
C1(CCC(OCC1O)=O)=O,,,5,1,2,0,2
61226_0,,,,2,1,2,3
C1(CC(C(CCO1)=O)O)=O,,,5,1,3,0,3
61228_0,,,,2,1,2,3
C1(CC(CC(CO1)O)=O)=O,,,5,1,2,0,2
61230_0,,,,2,1,2,3
C1(CC(CC(CO1)=O)O)=O,,,5,1,3,0,3
61231_0,,,,2,1,2,3
61232_0,,,,2,1,2,3
61233_0,,,,2,1,2,3
61234_0,,,,2,1,2,3
61235_0,,,,2,1,2,3
61237_0,,,,2,1,2,3
C1(C(CC(O)OCC1)=O)=O,,,5,1,3,0,3
61238_0,,,,2,1,2,3
61240_0,,,,2,1,2,3
C1(CC(OCC(C1)=O)O)=O,,,5,1,4,0,4
61241_0,,,,2,1,2,3
61242_0,,,,2,1,2,3
61243_0,,,,2,1,2,3
61244_0,,,,2,1,2,3
61245_0,,,,2,1,2,3
61246_0,,,,2,1,2,3
61248_0,,,,2,1,2,3
C(CC1CC(C(O1)=O)=O)=O,,,5,1,3,0,3
61250_0,,,,2,1,2,3
C(C)(C1CC(C(O1)=O)=O)=O,,,5,1,3,0,3
61252_0,,,,2,1,2,3
C1(CC(C(CC=O)O1)=O)=O,,,5,1,3,0,3
61254_0,,,,2,1,2,3
C1(C(C(C)=O)OC(C1)=O)=O,,,5,1,3,0,3
61255_0,,,,2,1,2,3
61256_0,,,,2,1,2,3
61257_0,,,,2,1,2,3
61258_0,,,,2,1,2,3
61260_0,,,,2,1,2,3
C1(CCOC(C(C1)=O)=O)=O,,,5,1,3,0,3
61262_0,,,,2,1,2,3
C1(COC(C(CC1)=O)=O)=O,,,5,1,3,0,3
61263_0,,,,2,1,2,3
61265_0,,,,2,1,2,3
C1(CC(C(CCO1)=O)=O)=O,,,5,1,3,0,3
61266_0,,,,2,1,2,3
61268_0,,,,2,1,2,3
C1(CC(OCC(C1)=O)=O)=O,,,5,1,3,0,3
61269_0,,,,2,1,2,3
61270_0,,,,2,1,2,3
61271_0,,,,2,1,2,3
61272_0,,,,2,1,2,3
61273_0,,,,2,1,2,3
61274_0,,,,2,1,2,3
61275_0,,,,2,1,2,3
61276_0,,,,2,1,2,3
61277_0,,,,2,1,2,3
61278_0,,,,2,1,2,3
61280_0,,,,2,1,2,3
C(CC(C=CC(C=O)=O)=O)=O,,,5,1,4,0,4
61282_0,,,,2,1,2,3
C(CC(C=O)=O)=CC(C=O)=O,,,5,1,5,0,5
61284_0,,,,2,1,2,3
C(CC(C=C(C=O)C=O)=O)=O,,,5,1,3,0,3
61286_0,,,,2,1,2,3
C(CC(C=O)=O)=C(C=O)C=O,,,5,1,4,0,4
61288_0,,,,2,1,2,3
C(C(C(C(C=O)=O)=C)CO)=O,,,5,1,3,0,3
61290_0,,,,2,1,2,3
C(C(C(C=O)=CC=O)CO)=O,,,5,1,3,0,3
61291_0,,,,2,1,2,3
61293_0,,,,2,1,2,3
C(C(C=C(C(C)=O)CO)=O)=O,,,5,1,2,0,2
61294_0,,,,2,1,2,3
61296_0,,,,2,1,2,3
C(C(C=O)=C(C(C)=O)CO)=O,,,5,1,2,0,2
61297_0,,,,2,1,2,3
61299_0,,,,2,1,2,3
C(C=C(C(C)=O)CO)=O,,,5,1,2,0,2
61300_0,,,,2,1,2,3
61302_0,,,,2,1,2,3
C=C(C=O)C(C(C(C)=O)=O)O,,,5,1,3,0,3
61303_0,,,,2,1,2,3
61304_0,,,,2,1,2,3
61305_0,,,,2,1,2,3
61307_0,,,,2,1,2,3
C=CC(C(C(C)=O)=O)O,,,5,1,2,0,2
61308_0,,,,2,1,2,3
61309_0,,,,2,1,2,3
61310_0,,,,2,1,2,3
61311_0,,,,2,1,2,3
61312_0,,,,2,1,2,3
61313_0,,,,2,1,2,3
61314_0,,,,2,1,2,3
61315_0,,,,2,1,2,3
61316_0,,,,2,1,2,3
61318_0,,,,2,1,2,3
C(CC(C=O)=CC(C=O)=O)=O,,,5,1,4,0,4
61320_0,,,,2,1,2,3
C(C(C(C)=O)=CC(C=O)=O)=O,,,5,1,2,0,2
61321_0,,,,2,1,2,3
61323_0,,,,2,1,2,3
C(C(C=CC(C(C)=O)=O)=O)=O,,,5,1,3,0,3
61324_0,,,,2,1,2,3
61325_0,,,,2,1,2,3
61326_0,,,,2,1,2,3
61327_0,,,,2,1,2,3
61328_0,,,,2,1,2,3
61329_0,,,,2,1,2,3
61331_0,,,,2,1,2,3
C(CC(C=O)=C(C=O)C=O)=O,,,5,1,4,0,4
61333_0,,,,2,1,2,3
C(C(C=O)=C(C=O)C(C)=O)=O,,,5,1,2,0,2
61334_0,,,,2,1,2,3
61336_0,,,,2,1,2,3
C(C(C=O)=CC(C(C)=O)=O)=O,,,5,1,2,0,2
61337_0,,,,2,1,2,3
61338_0,,,,2,1,2,3
61339_0,,,,2,1,2,3
61340_0,,,,2,1,2,3
61341_0,,,,2,1,2,3
61342_0,,,,2,1,2,3
61344_0,,,,2,1,2,3
C(C(C=O)C(C(C=O)=O)=C)=O,,,5,1,4,0,4
61345_0,,,,2,1,2,3
61346_0,,,,2,1,2,3
61348_0,,,,2,1,2,3
C(CO)(CC(C(C=O)=O)=C)=O,,,5,1,3,0,3
61349_0,,,,2,1,2,3
61351_0,,,,2,1,2,3
C=C(C(CCO)=O)C(C=O)=O,,,5,1,2,0,2
61352_0,,,,2,1,2,3
61354_0,,,,2,1,2,3
C(CC(C(C=O)=O)=C)=O,,,5,1,4,0,4
61356_0,,,,2,1,2,3
C=C(C(C)=O)C(C=O)=O,,,5,1,2,0,2
61358_0,,,,2,1,2,3
C(C(C=O)C(C=O)=CC=O)=O,,,5,1,3,0,3
61359_0,,,,2,1,2,3
61360_0,,,,2,1,2,3
61362_0,,,,2,1,2,3
C(CO)(CC(C=O)=CC=O)=O,,,5,1,3,0,3
61363_0,,,,2,1,2,3
61365_0,,,,2,1,2,3
C(C(C(CCO)=O)=CC=O)=O,,,5,1,3,0,3
61366_0,,,,2,1,2,3
61368_0,,,,2,1,2,3
C(CC(C=O)=CC=O)=O,,,5,1,7,0,7
61370_0,,,,2,1,2,3
C(C(C(C)=O)=CC=O)=O,,,5,1,3,0,3
61371_0,,,,2,1,2,3
61372_0,,,,2,1,2,3
61373_0,,,,2,1,2,3
61374_0,,,,2,1,2,3
61375_0,,,,2,1,2,3
61376_0,,,,2,1,2,3
61377_0,,,,2,1,2,3
61378_0,,,,2,1,2,3
61379_0,,,,2,1,2,3
61380_0,,,,2,1,2,3
61381_0,,,,2,1,2,3
61382_0,,,,2,1,2,3
61383_0,,,,2,1,2,3
61384_0,,,,2,1,2,3
61385_0,,,,2,1,2,3
61386_0,,,,2,1,2,3
61387_0,,,,2,1,2,3
61389_0,,,,2,1,2,3
C(C(C(C=O)=O)C(C=O)=C)=O,,,5,1,4,0,4
61391_0,,,,2,1,2,3
C(C(C=CC=O)C(C=O)=O)=O,,,5,1,4,0,4
61392_0,,,,2,1,2,3
61393_0,,,,2,1,2,3
61394_0,,,,2,1,2,3
61395_0,,,,2,1,2,3
61396_0,,,,2,1,2,3
61397_0,,,,2,1,2,3
61398_0,,,,2,1,2,3
61399_0,,,,2,1,2,3
61400_0,,,,2,1,2,3
61401_0,,,,2,1,2,3
61402_0,,,,2,1,2,3
61403_0,,,,2,1,2,3
61404_0,,,,2,1,2,3
61405_0,,,,2,1,2,3
61406_0,,,,2,1,2,3
61407_0,,,,2,1,2,3
61408_0,,,,2,1,2,3
61409_0,,,,2,1,2,3
61410_0,,,,2,1,2,3
61411_0,,,,2,1,2,3
61412_0,,,,2,1,2,3
61413_0,,,,2,1,2,3
61414_0,,,,2,1,2,3
61415_0,,,,2,1,2,3
61416_0,,,,2,1,2,3
61418_0,,,,2,1,2,3
C(C(C(C(O)=O)=C)CO)=O,,,5,1,2,0,2
61420_0,,,,2,1,2,3
C(CC(CC(C(O)=O)=C)=O)=O,,,5,1,2,0,2
61422_0,,,,2,1,2,3
C(CCC(C(C(O)=O)=C)=O)=O,,,5,1,2,0,2
61424_0,,,,2,1,2,3
C(C(C(C(O)=O)=C)CC=O)=O,,,5,1,2,0,2
61426_0,,,,2,1,2,3
C=C(C(O)=O)CC(C(C)=O)=O,,,5,1,2,0,2
61428_0,,,,2,1,2,3
C(C)(CC(C(C(O)=O)=C)=O)=O,,,5,1,2,0,2
61430_0,,,,2,1,2,3
C=C(C(O)=O)C(C(C=O)=O)C,,,5,1,2,0,2
61431_0,,,,2,1,2,3
61433_0,,,,2,1,2,3
C(CO)(CC(C(O)=O)=C)=O,,,5,1,2,0,2
61434_0,,,,2,1,2,3
61436_0,,,,2,1,2,3
C=C(C(O)=O)C(CCO)=O,,,5,1,2,0,2
61437_0,,,,2,1,2,3
61438_0,,,,2,1,2,3
61439_0,,,,2,1,2,3
61440_0,,,,2,1,2,3
61442_0,,,,2,1,2,3
C(CO)=C(C(O)=O)C(C)=O,,,5,1,3,0,3
61444_0,,,,2,1,2,3
C(C(C=O)C(C=C)=O)=O,,,5,1,3,0,3
61445_0,,,,2,1,2,3
61447_0,,,,2,1,2,3
C(CC(C(C=O)=C)=O)=O,,,5,1,2,0,2
61448_0,,,,2,1,2,3
61449_0,,,,2,1,2,3
61451_0,,,,2,1,2,3
C(CC(C=CC(O)=O)=O)=O,,,5,1,2,0,2
61453_0,,,,2,1,2,3
C(C=CC(C(C)=O)=O)(O)=O,,,5,1,2,0,2
61454_0,,,,2,1,2,3
61455_0,,,,2,1,2,3
61456_0,,,,2,1,2,3
61457_0,,,,2,1,2,3
61458_0,,,,2,1,2,3
61459_0,,,,2,1,2,3
61460_0,,,,2,1,2,3
61461_0,,,,2,1,2,3
61462_0,,,,2,1,2,3
61464_0,,,,2,1,2,3
C(C)(C(C1C(CC(O)O1)O)O)=O,,,5,1,2,0,2
61465_0,,,,2,1,2,3
61466_0,,,,2,1,2,3
61468_0,,,,2,1,2,3
C(CC(C1CC(C(O)O1)=O)=O)=O,,,5,1,3,0,3
61470_0,,,,2,1,2,3
C1(C(O)OC(CC(C=O)=O)C1)=O,,,5,1,4,0,4
61471_0,,,,2,1,2,3
61472_0,,,,2,1,2,3
61474_0,,,,2,1,2,3
C1(COC(C1O)CC(C=O)=O)=O,,,5,1,1,0,1
61476_0,,,,2,1,2,3
C1(CC(C(CC(C=O)=O)O1)O)=O,,,5,1,2,0,2
61477_0,,,,2,1,2,3
61479_0,,,,2,1,2,3
C(C(C=O)C1CC(C(O)O1)=O)=O,,,5,1,2,0,2
61481_0,,,,2,1,2,3
C(C(C=O)C1C(C(CO1)=O)O)=O,,,5,1,1,0,1
61483_0,,,,2,1,2,3
C(C(C=O)C1C(CC(O1)=O)O)=O,,,5,1,2,0,2
61484_0,,,,2,1,2,3
61485_0,,,,2,1,2,3
61486_0,,,,2,1,2,3
61488_0,,,,2,1,2,3
C1(CC(C(C(C=O)O)O1)O)=O,,,5,1,2,0,2
61489_0,,,,2,1,2,3
61490_0,,,,2,1,2,3
61492_0,,,,2,1,2,3
C(C1C(C(CO)(CO1)O)O)=O,,,5,1,1,0,1
61494_0,,,,2,1,2,3
C(C1COC(CO)(C1O)O)=O,,,5,1,2,0,2
61496_0,,,,2,1,2,3
C(C1COC(C=O)(C1)O)=O,,,5,1,2,0,2
61498_0,,,,2,1,2,3
C(C1COC(C1C=O)O)=O,,,5,1,2,0,2
61500_0,,,,2,1,2,3
C(C1COC(C=O)(C1CO)O)=O,,,5,1,2,0,2
61502_0,,,,2,1,2,3
C(C1C(COC1(CO)CO)=O)=O,,,5,1,1,0,1
61504_0,,,,2,1,2,3
C(C1C(CO)(CO)OC(C1)=O)=O,,,5,1,1,0,1
61506_0,,,,2,1,2,3
C(C1COC(C1C(C=O)O)O)=O,,,5,1,2,0,2
61508_0,,,,2,1,2,3
C(C1COC(C1C(CO)=O)O)=O,,,5,1,2,0,2
61510_0,,,,2,1,2,3
C(C1C(CO)(COC1C=O)O)=O,,,5,1,1,0,1
61512_0,,,,2,1,2,3
C(C1C(CO)(O)OCC1C=O)=O,,,5,1,2,0,2
61514_0,,,,2,1,2,3
C(CC1C(C(CO)(CO1)O)=O)=O,,,5,1,1,0,1
61516_0,,,,2,1,2,3
C(CC1(C(C(CO)CO1)=O)O)=O,,,5,1,2,0,2
61518_0,,,,2,1,2,3
C(C1COC(C1O)(CC=O)O)=O,,,5,1,2,0,2
61520_0,,,,2,1,2,3
C(C(C1CC(CO)(CO1)O)=O)=O,,,5,1,1,0,1
61522_0,,,,2,1,2,3
C(C1COC(C1)(C(C=O)O)O)=O,,,5,1,2,0,2
61524_0,,,,2,1,2,3
C(C1COC(C1)O)=O,,,5,1,2,0,2
61526_0,,,,2,1,2,3
C(C1C(C(CO)(CO1)O)=O)=O,,,5,1,1,0,1
61528_0,,,,2,1,2,3
C(C1(C(C(CO)CO1)=O)O)=O,,,5,1,2,0,2
61530_0,,,,2,1,2,3
C(C1COC(C=O)(C1O)O)=O,,,5,1,2,0,2
61532_0,,,,2,1,2,3
C1(C(CC(CO)(O)O1)=O)=O,,,5,1,2,0,2
61533_0,,,,2,1,2,3
61534_0,,,,2,1,2,3
61535_0,,,,2,1,2,3
61537_0,,,,2,1,2,3
C(CC1C(CC(CO)(O1)O)=O)=O,,,5,1,2,0,2
61538_0,,,,2,1,2,3
61540_0,,,,2,1,2,3
C(CC1C(C(C(CO)O1)=O)O)=O,,,5,1,1,0,1
61542_0,,,,2,1,2,3
C(CC1C(C(C(C=O)O1)O)O)=O,,,5,1,1,0,1
61544_0,,,,2,1,2,3
C(CO)(C(C1CC(CO1)=O)O)=O,,,5,1,1,0,1
61546_0,,,,2,1,2,3
C1(CCC(C(C(CO)=O)O)O1)=O,,,5,1,2,0,2
61548_0,,,,2,1,2,3
C(C1CC(C(C(CO)=O)O1)O)=O,,,5,1,1,0,1
61550_0,,,,2,1,2,3
C1(C(CO)(O)OCC1CC=O)=O,,,5,1,2,0,2
61552_0,,,,2,1,2,3
C1(C(COC1CO)(CC=O)O)=O,,,5,1,1,0,1
61554_0,,,,2,1,2,3
C(CC1(C(C(C=O)OC1)O)O)=O,,,5,1,1,0,1
61556_0,,,,2,1,2,3
C(C1CC(OC1C(CO)=O)O)=O,,,5,1,2,0,2
61558_0,,,,2,1,2,3
C1(CC(CO)(OC1C(C)=O)O)=O,,,5,1,2,0,2
61559_0,,,,2,1,2,3
61561_0,,,,2,1,2,3
C(C1C(C(C(CO)O1)=O)O)(C)=O,,,5,1,1,0,1
61563_0,,,,2,1,2,3
C(C1C(C(C(C(C)=O)O1)O)O)=O,,,5,1,1,0,1
61565_0,,,,2,1,2,3
C1(CC(C(CO)=O)OC1(C)O)=O,,,5,1,2,0,2
61567_0,,,,2,1,2,3
C(C1C(C(C(C)O1)=O)O)(CO)=O,,,5,1,1,0,1
61569_0,,,,2,1,2,3
C1(CC(C)(OC1C(CO)=O)O)=O,,,5,1,2,0,2
61571_0,,,,2,1,2,3
C1(C(CO)(OC(C=O)C1C)O)=O,,,5,1,2,0,2
61573_0,,,,2,1,2,3
C1(C(C)(C(C=O)OC1CO)O)=O,,,5,1,1,0,1
61575_0,,,,2,1,2,3
C(C1C(C(C)(C(C=O)O1)O)O)=O,,,5,1,1,0,1
61577_0,,,,2,1,2,3
C1(COC(C(CO)=O)C1(C)O)=O,,,5,1,1,0,1
61579_0,,,,2,1,2,3
C(C1C(C(C(O1)O)=O)C)(CO)=O,,,5,1,2,0,2
61581_0,,,,2,1,2,3
C1(CC(C)(C(C(CO)=O)O1)O)=O,,,5,1,1,0,1
61582_0,,,,2,1,2,3
61583_0,,,,2,1,2,3
61585_0,,,,2,1,2,3
C(C1(COC(C=O)C1O)O)=O,,,5,1,1,0,1
61587_0,,,,2,1,2,3
C1(C(CO)OC(CO)(C1)O)=O,,,5,1,2,0,2
61588_0,,,,2,1,2,3
61589_0,,,,2,1,2,3
61591_0,,,,2,1,2,3
C(C1C(C(C(CO)O1)O)O)=O,,,5,1,1,0,1
61593_0,,,,2,1,2,3
C1(COC(CO)(C1)O)=O,,,5,1,2,0,2
61594_0,,,,2,1,2,3
61595_0,,,,2,1,2,3
61597_0,,,,2,1,2,3
C(C1C(C(CO1)O)O)=O,,,5,1,1,0,1
61598_0,,,,2,1,2,3
61599_0,,,,2,1,2,3
61600_0,,,,2,1,2,3
61602_0,,,,2,1,2,3
C(C1(CC(C(CO)=O)CO1)O)=O,,,5,1,2,0,2
61604_0,,,,2,1,2,3
C(C1(CC(C(C)=O)(CO1)O)O)=O,,,5,1,2,0,2
61606_0,,,,2,1,2,3
C(C1CC(C=O)(O)OC1CO)=O,,,5,1,2,0,2
61607_0,,,,2,1,2,3
61609_0,,,,2,1,2,3
C(C1C(O)OCC1C(CO)=O)=O,,,5,1,2,0,2
61611_0,,,,2,1,2,3
C(C1C(O)OCC1(C(C)=O)O)=O,,,5,1,2,0,2
61613_0,,,,2,1,2,3
C(C1C(CO)OC(C1C=O)O)=O,,,5,1,2,0,2
61614_0,,,,2,1,2,3
61616_0,,,,2,1,2,3
C(CO)(C1COC(C1)O)=O,,,5,1,2,0,2
61618_0,,,,2,1,2,3
C(C)(C1(COC(C1)O)O)=O,,,5,1,2,0,2
61620_0,,,,2,1,2,3
C(C1C(CO)OC(C1)O)=O,,,5,1,2,0,2
61621_0,,,,2,1,2,3
61622_0,,,,2,1,2,3
61624_0,,,,2,1,2,3
C1(CC(CO1)(C(CO)O)O)=O,,,5,1,2,0,2
61625_0,,,,2,1,2,3
61626_0,,,,2,1,2,3
61628_0,,,,2,1,2,3
C(C)(C1(COC(C1O)O)O)=O,,,5,1,2,0,2
61630_0,,,,2,1,2,3
C1(C(CC(C(CO)O)(O)O1)=O)=O,,,5,1,2,0,2
61631_0,,,,2,1,2,3
61632_0,,,,2,1,2,3
61633_0,,,,2,1,2,3
61634_0,,,,2,1,2,3
61636_0,,,,2,1,2,3
C1(C(C(C(C(C)=O)(O)O1)O)O)=O,,,5,1,2,0,2
61637_0,,,,2,1,2,3
61638_0,,,,2,1,2,3
61640_0,,,,2,1,2,3
C1(COC(C(CO)O)(C1)O)=O,,,5,1,2,0,2
61641_0,,,,2,1,2,3
61642_0,,,,2,1,2,3
61643_0,,,,2,1,2,3
61645_0,,,,2,1,2,3
C(CO)(C1C(C(CO1)O)O)=O,,,5,1,1,0,1
61647_0,,,,2,1,2,3
C(C)(C1(C(C(CO1)O)O)O)=O,,,5,1,2,0,2
61649_0,,,,2,1,2,3
C(C1C(COC1C(O)=O)=O)=O,,,5,1,1,0,1
61651_0,,,,2,1,2,3
C1(CC(C=O)C(C(O)=O)O1)=O,,,5,1,1,0,1
61652_0,,,,2,1,2,3
61654_0,,,,2,1,2,3
C1(C(C(C(CC=O)O1)=O)O)=O,,,5,1,2,0,2
61656_0,,,,2,1,2,3
C1(CC(C(CC=O)(O)O1)=O)=O,,,5,1,2,0,2
61658_0,,,,2,1,2,3
C(CC1(CC(C(O1)=O)=O)O)=O,,,5,1,2,0,2
61660_0,,,,2,1,2,3
C1(C(CC(C(C=O)=O)O1)O)=O,,,5,1,2,0,2
61662_0,,,,2,1,2,3
C1(C(C(C(C=O)O1)=O)O)=O,,,5,1,2,0,2
61664_0,,,,2,1,2,3
C1(CC(C(C=O)(O)O1)=O)=O,,,5,1,2,0,2
61666_0,,,,2,1,2,3
C(C1(CC(C(O1)=O)=O)O)=O,,,5,1,2,0,2
61668_0,,,,2,1,2,3
C(CC1C(C(CO)C(O1)O)=O)=O,,,5,1,2,0,2
61670_0,,,,2,1,2,3
C1(C(CO)C(C(CC=O)O1)O)=O,,,5,1,1,0,1
61671_0,,,,2,1,2,3
61672_0,,,,2,1,2,3
61674_0,,,,2,1,2,3
C(CC1C(C(CO1)=O)(CO)O)=O,,,5,1,1,0,1
61675_0,,,,2,1,2,3
61677_0,,,,2,1,2,3
C1(CC(C(CC=O)O1)(CO)O)=O,,,5,1,1,0,1
61678_0,,,,2,1,2,3
61679_0,,,,2,1,2,3
61681_0,,,,2,1,2,3
C1(COC(CO)(CO)C1O)=O,,,5,1,1,0,1
61682_0,,,,2,1,2,3
61684_0,,,,2,1,2,3
C1(CC(C(CO)(CO)O1)O)=O,,,5,1,2,0,2
61685_0,,,,2,1,2,3
61686_0,,,,2,1,2,3
61687_0,,,,2,1,2,3
61688_0,,,,2,1,2,3
61690_0,,,,2,1,2,3
C(C(C1CC(C(O)O1)=O)O)(O)=O,,,5,1,2,0,2
61692_0,,,,2,1,2,3
C1(CC(C(C(C(O)=O)O)O1)O)=O,,,5,1,2,0,2
61693_0,,,,2,1,2,3
61695_0,,,,2,1,2,3
C1(C(C)C(C(C=O)=O)CO1)=O,,,5,1,1,0,1
61697_0,,,,2,1,2,3
C(C1C(C=O)C(C(O1)=O)C)=O,,,5,1,1,0,1
61699_0,,,,2,1,2,3
C(C1(C)C(C=O)C(CO1)=O)=O,,,5,1,1,0,1
61701_0,,,,2,1,2,3
C(C1(C)C(C=O)CC(O1)=O)=O,,,5,1,1,0,1
61703_0,,,,2,1,2,3
C1(C(C)OCC1C(C=O)=O)=O,,,5,1,1,0,1
61705_0,,,,2,1,2,3
C1(C(C)OC(C=O)C1C=O)=O,,,5,1,1,0,1
61707_0,,,,2,1,2,3
C(C1C(COC1C(C)=O)=O)=O,,,5,1,1,0,1
61709_0,,,,2,1,2,3
C(C1C(C(C)=O)OC(C1)=O)=O,,,5,1,1,0,1
61711_0,,,,2,1,2,3
C1(COC(CC(C=O)=O)C1)=O,,,5,1,1,0,1
61713_0,,,,2,1,2,3
C1(CCC(CC(C=O)=O)O1)=O,,,5,1,2,0,2
61715_0,,,,2,1,2,3
C(CC1(C=O)CC(C(O)O1)=O)=O,,,5,1,2,0,2
61717_0,,,,2,1,2,3
C(C1(C(C)=O)CC(C(O1)O)=O)=O,,,5,1,2,0,2
61718_0,,,,2,1,2,3
61720_0,,,,2,1,2,3
C1(C(O)OC(C(C(C)=O)=O)C1)=O,,,5,1,2,0,2
61721_0,,,,2,1,2,3
61722_0,,,,2,1,2,3
61723_0,,,,2,1,2,3
61724_0,,,,2,1,2,3
61725_0,,,,2,1,2,3
61726_0,,,,2,1,2,3
61728_0,,,,2,1,2,3
C(CC1C(C=O)C(CO1)=O)=O,,,5,1,1,0,1
61730_0,,,,2,1,2,3
C(CC1C(C=O)CC(O1)=O)=O,,,5,1,1,0,1
61732_0,,,,2,1,2,3
C(C(C=O)C1CC(CO1)=O)=O,,,5,1,1,0,1
61734_0,,,,2,1,2,3
C(C(C=O)C1CCC(O1)=O)=O,,,5,1,2,0,2
61735_0,,,,2,1,2,3
61736_0,,,,2,1,2,3
61738_0,,,,2,1,2,3
C1(C(CO)C(C(C=O)=O)CO1)=O,,,5,1,1,0,1
61740_0,,,,2,1,2,3
C(C1C(O)OCC1C(C=O)=O)=O,,,5,1,2,0,2
61742_0,,,,2,1,2,3
C1(C(CO)OCC1C(C=O)=O)=O,,,5,1,1,0,1
61744_0,,,,2,1,2,3
C(C1C(C(C(C=O)=O)CO1)O)=O,,,5,1,1,0,1
61745_0,,,,2,1,2,3
61746_0,,,,2,1,2,3
61747_0,,,,2,1,2,3
61749_0,,,,2,1,2,3
C1(CC(C(C=O)=O)CO1)=O,,,5,1,1,0,1
61751_0,,,,2,1,2,3
C(CC1C(C(C(C=O)O1)=O)O)=O,,,5,1,1,0,1
61753_0,,,,2,1,2,3
C(C1(C(CC(CC=O)O1)=O)O)=O,,,5,1,2,0,2
61755_0,,,,2,1,2,3
C(CC1C(CC(C=O)(O)O1)=O)=O,,,5,1,2,0,2
61757_0,,,,2,1,2,3
C(CC1CC(CO1)=O)=O,,,5,1,1,0,1
61759_0,,,,2,1,2,3
C(CC1CCC(O1)=O)=O,,,5,1,2,0,2
61761_0,,,,2,1,2,3
C1(COC(C(C(C=O)=O)O)C1)=O,,,5,1,1,0,1
61763_0,,,,2,1,2,3
C1(CCC(C(C(C=O)=O)O)O1)=O,,,5,1,2,0,2
61765_0,,,,2,1,2,3
C(C(C1CC(CO1)=O)O)=O,,,5,1,1,0,1
61767_0,,,,2,1,2,3
C1(CCC(C(C=O)O)O1)=O,,,5,1,2,0,2
61769_0,,,,2,1,2,3
C(C1C(COC1C)=O)=O,,,5,1,1,0,1
61771_0,,,,2,1,2,3
C(C1C(C)OC(C1)=O)=O,,,5,1,1,0,1
61773_0,,,,2,1,2,3
C1(C(CO)C(C=O)C(C=O)O1)=O,,,5,1,1,0,1
61775_0,,,,2,1,2,3
C(C1C(C=O)C(C=O)C(O1)O)=O,,,5,1,2,0,2
61777_0,,,,2,1,2,3
C(C1(CO)C(C=O)C(CO1)=O)=O,,,5,1,1,0,1
61779_0,,,,2,1,2,3
C1(CC(C=O)C(C=O)(CO)O1)=O,,,5,1,1,0,1
61781_0,,,,2,1,2,3
C1(C(CO)OC(C=O)C1C=O)=O,,,5,1,1,0,1
61783_0,,,,2,1,2,3
C(C1C(C(C=O)C(C=O)O1)O)=O,,,5,1,1,0,1
61785_0,,,,2,1,2,3
C(C1C(COC1C(CO)=O)=O)=O,,,5,1,1,0,1
61787_0,,,,2,1,2,3
C1(CC(C=O)C(C(CO)=O)O1)=O,,,5,1,1,0,1
61788_0,,,,2,1,2,3
61789_0,,,,2,1,2,3
61791_0,,,,2,1,2,3
C(C1C(COC1C(CO)O)=O)=O,,,5,1,1,0,1
61793_0,,,,2,1,2,3
C(C1C(C(CO)O)OC(C1)=O)=O,,,5,1,1,0,1
61795_0,,,,2,1,2,3
C(C1C(COC1C=O)=O)=O,,,5,1,1,0,1
61797_0,,,,2,1,2,3
C(C1C(C=O)CC(O1)=O)=O,,,5,1,1,0,1
61798_0,,,,2,1,2,3
61800_0,,,,2,1,2,3
C(C1COC(C1)=O)=O,,,5,1,1,0,1
61802_0,,,,2,1,2,3
C(C1C(COC1CO)=O)=O,,,5,1,1,0,1
61804_0,,,,2,1,2,3
C(C1C(CO)OC(C1)=O)=O,,,5,1,1,0,1
61806_0,,,,2,1,2,3
C(C1CC(C(C(C=O)=O)O1)O)=O,,,5,1,1,0,1
61808_0,,,,2,1,2,3
C(C1C(CC(C=O)O1)O)=O,,,5,1,1,0,1
61810_0,,,,2,1,2,3
C(C1CC(OC1C(C=O)=O)O)=O,,,5,1,2,0,2
61812_0,,,,2,1,2,3
C1(C(COC1C=O)(CC=O)O)=O,,,5,1,1,0,1
61814_0,,,,2,1,2,3
C1(C(COC1(C=O)O)CC=O)=O,,,5,1,2,0,2
61816_0,,,,2,1,2,3
C(C1CC(OC1C=O)O)=O,,,5,1,2,0,2
61817_0,,,,2,1,2,3
61818_0,,,,2,1,2,3
61819_0,,,,2,1,2,3
61821_0,,,,2,1,2,3
C(C1(COC(C=O)C1C=O)O)=O,,,5,1,1,0,1
61823_0,,,,2,1,2,3
C(C1C(C(CO)OC1C=O)O)=O,,,5,1,1,0,1
61825_0,,,,2,1,2,3
C(C1C(COC1C=O)O)=O,,,5,1,1,0,1
61827_0,,,,2,1,2,3
C(CC1(C(C(C=O)CO1)=O)O)=O,,,5,1,2,0,2
61829_0,,,,2,1,2,3
C(CC1C(C(C=O)(CO1)O)=O)=O,,,5,1,1,0,1
61831_0,,,,2,1,2,3
C(CC1(CC(C(CO)O1)=O)O)=O,,,5,1,2,0,2
61833_0,,,,2,1,2,3
C(CC1(C(CC(CO)O1)=O)O)=O,,,5,1,2,0,2
61835_0,,,,2,1,2,3
C(CC1C(C(C(CO)O1)O)=O)=O,,,5,1,1,0,1
61837_0,,,,2,1,2,3
C(CC1(CC(CO1)=O)O)=O,,,5,1,2,0,2
61838_0,,,,2,1,2,3
61839_0,,,,2,1,2,3
61841_0,,,,2,1,2,3
C1(CC(C(C=O)=O)OC1(C)O)=O,,,5,1,2,0,2
61843_0,,,,2,1,2,3
C1(C(C(C(C=O)=O)OC1C)O)=O,,,5,1,1,0,1
61845_0,,,,2,1,2,3
C1(CC(C)(OC1C(C=O)=O)O)=O,,,5,1,2,0,2
61847_0,,,,2,1,2,3
C(C1C(C(C(C(C)=O)O1)O)=O)=O,,,5,1,1,0,1
61849_0,,,,2,1,2,3
C(C1(C(CC(C(C)=O)O1)=O)O)=O,,,5,1,2,0,2
61851_0,,,,2,1,2,3
C(C1(CC(C(C(C)=O)O1)=O)O)=O,,,5,1,2,0,2
61853_0,,,,2,1,2,3
C1(CC(C=O)OC1(C)O)=O,,,5,1,2,0,2
61855_0,,,,2,1,2,3
C(C1C(C(C(C)O1)=O)O)=O,,,5,1,1,0,1
61857_0,,,,2,1,2,3
C(C1C(CC(C)(O1)O)=O)=O,,,5,1,2,0,2
61859_0,,,,2,1,2,3
C1(COC(C(C=O)=O)C1(C)O)=O,,,5,1,1,0,1
61861_0,,,,2,1,2,3
C1(C(OC(C(C=O)=O)C1C)O)=O,,,5,1,2,0,2
61863_0,,,,2,1,2,3
C1(CC(C)(C(C(C=O)=O)O1)O)=O,,,5,1,1,0,1
61865_0,,,,2,1,2,3
C1(C(C)(C(C=O)OC1C=O)O)=O,,,5,1,1,0,1
61867_0,,,,2,1,2,3
C1(C(C)C(C=O)OC1(C=O)O)=O,,,5,1,2,0,2
61869_0,,,,2,1,2,3
C1(COC(C=O)C1(C)O)=O,,,5,1,1,0,1
61871_0,,,,2,1,2,3
C1(C(OC(C=O)C1C)O)=O,,,5,1,2,0,2
61873_0,,,,2,1,2,3
C1(CC(C)(C(C=O)O1)O)=O,,,5,1,2,0,2
61875_0,,,,2,1,2,3
C(C1(COC(C(C=O)=O)C1)O)=O,,,5,1,1,0,1
61877_0,,,,2,1,2,3
C(C(C1CC(C(CO)O1)O)=O)=O,,,5,1,1,0,1
61879_0,,,,2,1,2,3
C(C(C1CC(CO1)O)=O)=O,,,5,1,1,0,1
61880_0,,,,2,1,2,3
61881_0,,,,2,1,2,3
61883_0,,,,2,1,2,3
C(C1(C(C(C=O)OC1)=O)O)=O,,,5,1,1,0,1
61885_0,,,,2,1,2,3
C(C1C(C(C=O)(O)OC1)=O)=O,,,5,1,2,0,2
61887_0,,,,2,1,2,3
C1(CC(C=O)(OC1CO)O)=O,,,5,1,2,0,2
61889_0,,,,2,1,2,3
C(C1(C(CC(CO)O1)=O)O)=O,,,5,1,2,0,2
61891_0,,,,2,1,2,3
C(C1C(C(C(CO)O1)O)=O)=O,,,5,1,1,0,1
61892_0,,,,2,1,2,3
61893_0,,,,2,1,2,3
61894_0,,,,2,1,2,3
61895_0,,,,2,1,2,3
61896_0,,,,2,1,2,3
61897_0,,,,2,1,2,3
61898_0,,,,2,1,2,3
61899_0,,,,2,1,2,3
61901_0,,,,2,1,2,3
C1(COC(C1(CC=O)O)O)=O,,,5,1,2,0,2
61902_0,,,,2,1,2,3
61904_0,,,,2,1,2,3
C(C)(C1(C(COC1O)=O)O)=O,,,5,1,2,0,2
61906_0,,,,2,1,2,3
C(C1(C(COC1C=O)O)O)=O,,,5,1,1,0,1
61908_0,,,,2,1,2,3
C(C1C(COC1(CO)O)=O)=O,,,5,1,2,0,2
61910_0,,,,2,1,2,3
C1(COCC1)=O,,,5,1,1,0,1
61912_0,,,,2,1,2,3
C1(CCCO1)=O,,,5,1,2,0,2
61913_0,,,,2,1,2,3
61914_0,,,,2,1,2,3
61915_0,,,,2,1,2,3
61916_0,,,,2,1,2,3
61917_0,,,,2,1,2,3
61918_0,,,,2,1,2,3
61919_0,,,,2,1,2,3
61920_0,,,,2,1,2,3
61921_0,,,,2,1,2,3
61923_0,,,,2,1,2,3
C1(CCC(O1)=O)=O,,,5,1,1,0,1
61925_0,,,,2,1,2,3
C(C)(C1C(O)OC(CO)C1O)=O,,,5,1,2,0,2
61926_0,,,,2,1,2,3
61927_0,,,,2,1,2,3
61928_0,,,,2,1,2,3
61929_0,,,,2,1,2,3
61931_0,,,,2,1,2,3
C1(C(C(C(C=O)=O)C(O)O1)O)=O,,,5,1,3,0,3
61933_0,,,,2,1,2,3
C(C1C(C(O)OC1C(O)=O)=O)=O,,,5,1,3,0,3
61935_0,,,,2,1,2,3
C(C1(C(COC1C(O)=O)=O)O)=O,,,5,1,1,0,1
61937_0,,,,2,1,2,3
C1(CC(C=O)(C(C(O)=O)O1)O)=O,,,5,1,2,0,2
61939_0,,,,2,1,2,3
C1(C(C)C(C=O)(C(C=O)O1)O)=O,,,5,1,1,0,1
61941_0,,,,2,1,2,3
C(C1(C)C(C=O)C(C(O1)O)=O)=O,,,5,1,3,0,3
61943_0,,,,2,1,2,3
C(C1(C)C(C=O)(C(CO1)=O)O)=O,,,5,1,1,0,1
61945_0,,,,2,1,2,3
C1(CC(C=O)(C(C=O)(C)O1)O)=O,,,5,1,2,0,2
61947_0,,,,2,1,2,3
C1(C(C)OC(C=O)C1(C=O)O)=O,,,5,1,1,0,1
61949_0,,,,2,1,2,3
C1(C(C)(OC(C=O)C1C=O)O)=O,,,5,1,2,0,2
61951_0,,,,2,1,2,3
C(C1C(C(O)OC1C(C)=O)=O)=O,,,5,1,3,0,3
61953_0,,,,2,1,2,3
C(C1(C(COC1C(C)=O)=O)O)=O,,,5,1,1,0,1
61955_0,,,,2,1,2,3
C1(CC(C=O)(C(C(C)=O)O1)O)=O,,,5,1,2,0,2
61957_0,,,,2,1,2,3
C(CC1C(C=O)C(C(O)O1)=O)=O,,,5,1,3,0,3
61959_0,,,,2,1,2,3
C(CC1C(C=O)(C(CO1)=O)O)=O,,,5,1,1,0,1
61961_0,,,,2,1,2,3
C(CC1C(C=O)(CC(O1)=O)O)=O,,,5,1,2,0,2
61963_0,,,,2,1,2,3
C(C1C(C(O)OC1C)=O)=O,,,5,1,3,0,3
61965_0,,,,2,1,2,3
C(C1(C(COC1C)=O)O)=O,,,5,1,1,0,1
61967_0,,,,2,1,2,3
C(C1(C(C)OC(C1)=O)O)=O,,,5,1,2,0,2
61969_0,,,,2,1,2,3
C(C1(C(COC1C=O)=O)O)=O,,,5,1,1,0,1
61971_0,,,,2,1,2,3
C(C1C(C(O)OC1C=O)=O)=O,,,5,1,3,0,3
61973_0,,,,2,1,2,3
C1(CC(C=O)(C(C=O)O1)O)=O,,,5,1,2,0,2
61975_0,,,,2,1,2,3
C1(C(C(C)=O)C(CO1)(CO)O)=O,,,5,1,1,0,1
61977_0,,,,2,1,2,3
C(C1COC(C1(C(C)=O)O)O)=O,,,5,1,2,0,2
61979_0,,,,2,1,2,3
C(C1COC(C)(C1(C=O)O)O)=O,,,5,1,2,0,2
61981_0,,,,2,1,2,3
C1(C(CO)C(CO1)(CO)O)=O,,,5,1,1,0,1
61982_0,,,,2,1,2,3
61984_0,,,,2,1,2,3
C(C1COC(C1(CO)O)O)=O,,,5,1,2,0,2
61986_0,,,,2,1,2,3
C1(C(C(CO)C(CO)(O)O1)=O)=O,,,5,1,2,0,2
61987_0,,,,2,1,2,3
61988_0,,,,2,1,2,3
61990_0,,,,2,1,2,3
C1(C(C)C(C(CO)=O)(CO1)O)=O,,,5,1,1,0,1
61992_0,,,,2,1,2,3
C1(C(C)OCC1(C(CO)=O)O)=O,,,5,1,1,0,1
61994_0,,,,2,1,2,3
C1(C(C)(O)OCC1C(CO)=O)=O,,,5,1,2,0,2
61995_0,,,,2,1,2,3
61996_0,,,,2,1,2,3
61998_0,,,,2,1,2,3
C(CO)(C1(COC(C1)=O)O)=O,,,5,1,1,0,1
62000_0,,,,2,1,2,3
C1(COC(CO)(C1CO)O)=O,,,5,1,2,0,2
62002_0,,,,2,1,2,3
C(C1C(CO)(C(CO1)O)O)=O,,,5,1,1,0,1
62003_0,,,,2,1,2,3
62005_0,,,,2,1,2,3
C1(C(C)C(C(O1)=O)(CO)O)=O,,,5,1,1,0,1
62007_0,,,,2,1,2,3
C1(C(C=O)C(C)(C(O)O1)O)=O,,,5,1,2,0,2
62009_0,,,,2,1,2,3
C1(C(C)C(C(O)=O)(CO1)O)=O,,,5,1,1,0,1
62011_0,,,,2,1,2,3
C1(C(C(C(C)O1)=O)(CO)O)=O,,,5,1,2,0,2
62013_0,,,,2,1,2,3
C1(C(C(C(C)(O)O1)=O)CO)=O,,,5,1,2,0,2
62015_0,,,,2,1,2,3
C1(C(C=O)C(C(C)(O)O1)O)=O,,,5,1,2,0,2
62017_0,,,,2,1,2,3
C(C1(C(C(C)OC1)=O)O)(O)=O,,,5,1,1,0,1
62019_0,,,,2,1,2,3
C(C1C(C(C)(O)OC1)=O)(O)=O,,,5,1,2,0,2
62021_0,,,,2,1,2,3
C1(C(CO)C(C(O1)=O)(CO)O)=O,,,5,1,1,0,1
62022_0,,,,2,1,2,3
62024_0,,,,2,1,2,3
C1(C(C=O)C(CO)(C(O)O1)O)=O,,,5,1,2,0,2
62026_0,,,,2,1,2,3
C1(C(CO)C(C(O)=O)(CO1)O)=O,,,5,1,1,0,1
62027_0,,,,2,1,2,3
62029_0,,,,2,1,2,3
C1(C(C(C(CO)O1)=O)(CO)O)=O,,,5,1,2,0,2
62031_0,,,,2,1,2,3
C1(C(C(C(CO)(O)O1)=O)CO)=O,,,5,1,2,0,2
62033_0,,,,2,1,2,3
C1(C(CO)(C(C(C=O)O1)O)O)=O,,,5,1,2,0,2
62035_0,,,,2,1,2,3
C1(C(C=O)C(C(CO)(O)O1)O)=O,,,5,1,2,0,2
62036_0,,,,2,1,2,3
62037_0,,,,2,1,2,3
62039_0,,,,2,1,2,3
C(C1(COC(C=O)C1O)O)(O)=O,,,5,1,1,0,1
62041_0,,,,2,1,2,3
C1(C(C(C)=O)C(C(O1)=O)O)=O,,,5,1,1,0,1
62043_0,,,,2,1,2,3
C(C)(C1C(C(OC1O)=O)=O)=O,,,5,1,2,0,2
62045_0,,,,2,1,2,3
C(C1C(C(OC1(C)O)=O)=O)=O,,,5,1,2,0,2
62046_0,,,,2,1,2,3
62048_0,,,,2,1,2,3
C1(C(C(C=O)C(C=O)(O)O1)O)=O,,,5,1,2,0,2
62050_0,,,,2,1,2,3
C(C1(C(C(C(O1)=O)=O)CO)O)=O,,,5,1,2,0,2
62052_0,,,,2,1,2,3
C1(C(CO)C(C=O)(C(C)O1)O)=O,,,5,1,1,0,1
62054_0,,,,2,1,2,3
C(C1C(O)OC(C)C1(C=O)O)=O,,,5,1,2,0,2
62056_0,,,,2,1,2,3
C(C1(COC(C1C(C)=O)O)O)=O,,,5,1,2,0,2
62057_0,,,,2,1,2,3
62058_0,,,,2,1,2,3
62059_0,,,,2,1,2,3
62061_0,,,,2,1,2,3
C(C)(C1C(O)OC(C1O)=O)=O,,,5,1,2,0,2
62062_0,,,,2,1,2,3
62063_0,,,,2,1,2,3
62065_0,,,,2,1,2,3
C(C1(C(COC1C)=O)O)(O)=O,,,5,1,1,0,1
62066_0,,,,2,1,2,3
62068_0,,,,2,1,2,3
C(C1(C(C)OC(C1)=O)O)(O)=O,,,5,1,2,0,2
62070_0,,,,2,1,2,3
C(C1(C(COC1C=O)=O)O)(O)=O,,,5,1,1,0,1
62071_0,,,,2,1,2,3
62073_0,,,,2,1,2,3
C1(CC(C(O)=O)(C(C=O)O1)O)=O,,,5,1,2,0,2
62075_0,,,,2,1,2,3
C1(C(C)C(C(C=O)=O)(CO1)O)=O,,,5,1,1,0,1
62076_0,,,,2,1,2,3
62078_0,,,,2,1,2,3
C1(C(C)C(C=O)(CO1)O)=O,,,5,1,1,0,1
62080_0,,,,2,1,2,3
C1(C(C)C(C=O)(C(CO)O1)O)=O,,,5,1,1,0,1
62082_0,,,,2,1,2,3
C1(C(C)(O)OCC1C(C=O)=O)=O,,,5,1,2,0,2
62084_0,,,,2,1,2,3
C1(C(C)OCC1(C(C=O)=O)O)=O,,,5,1,1,0,1
62085_0,,,,2,1,2,3
62087_0,,,,2,1,2,3
C(C1C(C(C)(O)OC1)=O)=O,,,5,1,2,0,2
62089_0,,,,2,1,2,3
C(C1(C(C(C)OC1)=O)O)=O,,,5,1,1,0,1
62091_0,,,,2,1,2,3
C(C1C(C(C)(O)OC1CO)=O)=O,,,5,1,2,0,2
62093_0,,,,2,1,2,3
C(C1(C(C(C)OC1CO)=O)O)=O,,,5,1,1,0,1
62094_0,,,,2,1,2,3
62095_0,,,,2,1,2,3
62096_0,,,,2,1,2,3
62097_0,,,,2,1,2,3
62098_0,,,,2,1,2,3
62100_0,,,,2,1,2,3
C(CC(C1C(O)OCC1O)=O)=O,,,5,1,2,0,2
62102_0,,,,2,1,2,3
C1(C(CCO)C(C=O)(CO1)O)=O,,,5,1,1,0,1
62104_0,,,,2,1,2,3
C(C1C(C(CCO)(O)OC1)=O)=O,,,5,1,2,0,2
62106_0,,,,2,1,2,3
C(C1(C(C(CCO)OC1)=O)O)=O,,,5,1,1,0,1
62107_0,,,,2,1,2,3
62109_0,,,,2,1,2,3
C(C(CO)(C1CC(CO1)=O)O)=O,,,5,1,1,0,1
62111_0,,,,2,1,2,3
C(C(CO)(C1CCC(O1)=O)O)=O,,,5,1,2,0,2
62113_0,,,,2,1,2,3
C(C1(CO)C(CC(C=O)O1)O)=O,,,5,1,1,0,1
62115_0,,,,2,1,2,3
C(C1CC(OC1(C=O)CO)O)=O,,,5,1,2,0,2
62117_0,,,,2,1,2,3
C1(C(CO)C(CO1)(CC=O)O)=O,,,5,1,1,0,1
62118_0,,,,2,1,2,3
62120_0,,,,2,1,2,3
C(C1(COC(C1C(C)=O)=O)O)=O,,,5,1,1,0,1
62122_0,,,,2,1,2,3
C1(C(CO)OC(C1C(C)=O)O)=O,,,5,1,2,0,2
62123_0,,,,2,1,2,3
62125_0,,,,2,1,2,3
C(C1C(C(CO)OC1(C)O)=O)=O,,,5,1,2,0,2
62127_0,,,,2,1,2,3
C(C1C(COC1(C)O)=O)=O,,,5,1,2,0,2
62129_0,,,,2,1,2,3
C(C1(CO)CC(C(C)(O1)O)=O)=O,,,5,1,2,0,2
62131_0,,,,2,1,2,3
C(C1(CO)C(C(C(C)O1)=O)O)=O,,,5,1,1,0,1
62133_0,,,,2,1,2,3
C(C1(C(CC(C)(O1)O)=O)CO)=O,,,5,1,2,0,2
62135_0,,,,2,1,2,3
C1(C(CO)C(C(C(C)=O)O1)O)=O,,,5,1,1,0,1
62136_0,,,,2,1,2,3
62138_0,,,,2,1,2,3
C1(C(CO)C(OC1C(C)=O)O)=O,,,5,1,2,0,2
62140_0,,,,2,1,2,3
C(C1(CO)C(C(CO1)=O)(C)O)=O,,,5,1,1,0,1
62142_0,,,,2,1,2,3
C(C1(CO)C(C(C(O1)O)=O)C)=O,,,5,1,2,0,2
62144_0,,,,2,1,2,3
C(C1(CO)C(C)(CC(O1)=O)O)=O,,,5,1,1,0,1
62146_0,,,,2,1,2,3
C1(C(CO)C(C)(C(C=O)O1)O)=O,,,5,1,1,0,1
62147_0,,,,2,1,2,3
62148_0,,,,2,1,2,3
62149_0,,,,2,1,2,3
62150_0,,,,2,1,2,3
62152_0,,,,2,1,2,3
C(C)(C1C(O)OCC1O)=O,,,5,1,2,0,2
62153_0,,,,2,1,2,3
62154_0,,,,2,1,2,3
62156_0,,,,2,1,2,3
C1(CC(C(C=O)=O)(CO1)O)=O,,,5,1,1,0,1
62157_0,,,,2,1,2,3
62159_0,,,,2,1,2,3
C1(COC(C=O)(C1CO)O)=O,,,5,1,2,0,2
62160_0,,,,2,1,2,3
62161_0,,,,2,1,2,3
62163_0,,,,2,1,2,3
C1(C(C(CO1)(CO)O)CC=O)=O,,,5,1,1,0,1
62164_0,,,,2,1,2,3
62166_0,,,,2,1,2,3
C1(C(C(C(O1)=O)CC=O)O)=O,,,5,1,1,0,1
62168_0,,,,2,1,2,3
C(CC1C(C(OC1O)=O)=O)=O,,,5,1,2,0,2
62170_0,,,,2,1,2,3
C1(C(C)C(C(O1)=O)(C)O)=O,,,5,1,1,0,1
62172_0,,,,2,1,2,3
C1(C(C)C(C(O1)=O)(CCO)O)=O,,,5,1,1,0,1
62174_0,,,,2,1,2,3
C1(C(C(C)C(O)O1)=O)=O,,,5,1,2,0,2
62176_0,,,,2,1,2,3
C1(C(C)C(C(O1)=O)O)=O,,,5,1,1,0,1
62178_0,,,,2,1,2,3
C1(C(C(C(C)(O)O1)=O)C)=O,,,5,1,2,0,2
62180_0,,,,2,1,2,3
C1(C(C(C(C)O1)=O)(C)O)=O,,,5,1,2,0,2
62182_0,,,,2,1,2,3
C1(C(C(C(C)(O)O1)=O)CCO)=O,,,5,1,2,0,2
62184_0,,,,2,1,2,3
C1(C(C(C(C)O1)=O)(CCO)O)=O,,,5,1,2,0,2
62186_0,,,,2,1,2,3
C1(C(CC(C)(O)O1)=O)=O,,,5,1,2,0,2
62188_0,,,,2,1,2,3
C1(CC(C(C)(O)O1)=O)=O,,,5,1,2,0,2
62190_0,,,,2,1,2,3
C1(C(C(C(C)O1)=O)O)=O,,,5,1,2,0,2
62192_0,,,,2,1,2,3
C1(C(CCO)C(C(O1)=O)(C)O)=O,,,5,1,1,0,1
62194_0,,,,2,1,2,3
C1(C(C(C(O)O1)CCO)=O)=O,,,5,1,2,0,2
62196_0,,,,2,1,2,3
C1(C(CCO)C(C(O1)=O)O)=O,,,5,1,1,0,1
62198_0,,,,2,1,2,3
C1(C(C(C(CCO)(O)O1)=O)C)=O,,,5,1,2,0,2
62200_0,,,,2,1,2,3
C1(C(C(C(CCO)O1)=O)(C)O)=O,,,5,1,2,0,2
62202_0,,,,2,1,2,3
C1(C(CC(CCO)(O)O1)=O)=O,,,5,1,2,0,2
62204_0,,,,2,1,2,3
C1(CC(C(CCO)(O)O1)=O)=O,,,5,1,2,0,2
62206_0,,,,2,1,2,3
C1(C(C(C(CCO)O1)=O)O)=O,,,5,1,2,0,2
62208_0,,,,2,1,2,3
C(CC1C(OCC1(C=O)O)=O)=O,,,5,1,1,0,1
62210_0,,,,2,1,2,3
C1(C(C(OC1CO)O)CC=O)=O,,,5,1,2,0,2
62212_0,,,,2,1,2,3
C1(C(C(C(CO)O1)O)CC=O)=O,,,5,1,1,0,1
62213_0,,,,2,1,2,3
62214_0,,,,2,1,2,3
62216_0,,,,2,1,2,3
C(C(C)(C1CC(CO1)=O)O)(O)=O,,,5,1,1,0,1
62218_0,,,,2,1,2,3
C(C(C)(C1CCC(O1)=O)O)(O)=O,,,5,1,2,0,2
62220_0,,,,2,1,2,3
C(C(C1CC(CO1)=O)O)(O)=O,,,5,1,1,0,1
62222_0,,,,2,1,2,3
C1(CCC(C(C(O)=O)O)O1)=O,,,5,1,2,0,2
62224_0,,,,2,1,2,3
C(C1(C)C(CC(C=O)O1)O)(O)=O,,,5,1,1,0,1
62226_0,,,,2,1,2,3
C(C1C(CC(C=O)O1)O)(O)=O,,,5,1,1,0,1
62228_0,,,,2,1,2,3
C(C1CC(OC1(C(O)=O)C)O)=O,,,5,1,2,0,2
62230_0,,,,2,1,2,3
C(C1CC(OC1C(O)=O)O)=O,,,5,1,2,0,2
62232_0,,,,2,1,2,3
C(C1(C)CC(C(C)(O1)O)=O)(O)=O,,,5,1,2,0,2
62234_0,,,,2,1,2,3
C(C1(C)C(C(C(C)O1)=O)O)(O)=O,,,5,1,1,0,1
62236_0,,,,2,1,2,3
C(C1(C(CC(C)(O1)O)=O)C)(O)=O,,,5,1,2,0,2
62238_0,,,,2,1,2,3
C1(CC(C(O)=O)OC1(C)O)=O,,,5,1,2,0,2
62240_0,,,,2,1,2,3
C(C1C(C(C(C)O1)=O)O)(O)=O,,,5,1,1,0,1
62242_0,,,,2,1,2,3
C(C1C(CC(C)(O1)O)=O)(O)=O,,,5,1,2,0,2
62244_0,,,,2,1,2,3
C(C1(C)C(C(CO1)=O)(C)O)(O)=O,,,5,1,1,0,1
62246_0,,,,2,1,2,3
C(C1(C)C(C(C(O1)O)=O)C)(O)=O,,,5,1,2,0,2
62248_0,,,,2,1,2,3
C(C1(C)C(C)(CC(O1)=O)O)(O)=O,,,5,1,1,0,1
62250_0,,,,2,1,2,3
C1(COC(C(O)=O)C1(C)O)=O,,,5,1,1,0,1
62252_0,,,,2,1,2,3
C1(C(OC(C(O)=O)C1C)O)=O,,,5,1,2,0,2
62254_0,,,,2,1,2,3
C1(CC(C)(C(C(O)=O)O1)O)=O,,,5,1,1,0,1
62256_0,,,,2,1,2,3
C1(C(CO)C(C(O1)=O)(C)O)=O,,,5,1,1,0,1
62258_0,,,,2,1,2,3
C(C1C(O)OC(C1(C)O)=O)=O,,,5,1,2,0,2
62260_0,,,,2,1,2,3
C1(C(C(C(CO)O1)=O)(C)O)=O,,,5,1,2,0,2
62262_0,,,,2,1,2,3
C1(C(C(C(CO)(O)O1)=O)C)=O,,,5,1,2,0,2
62264_0,,,,2,1,2,3
C1(C(C)(C(C(C=O)O1)O)O)=O,,,5,1,2,0,2
62265_0,,,,2,1,2,3
62267_0,,,,2,1,2,3
C1(C(C(C(O)O1)=O)C)=O,,,5,1,2,0,2
62269_0,,,,2,1,2,3
C1(C(C)(CC(O1)=O)O)=O,,,5,1,1,0,1
62271_0,,,,2,1,2,3
C1(C(C(CO1)=O)(CCO)O)=O,,,5,1,2,0,2
62273_0,,,,2,1,2,3
C1(C(C(C(O)O1)=O)CCO)=O,,,5,1,2,0,2
62275_0,,,,2,1,2,3
C1(C(CCO)(CC(O1)=O)O)=O,,,5,1,1,0,1
62277_0,,,,2,1,2,3
C(C1(COC(C=O)C1)O)=O,,,5,1,1,0,1
62278_0,,,,2,1,2,3
62280_0,,,,2,1,2,3
C(CC1(CC(C(O1)=O)O)O)=O,,,5,1,2,0,2
62281_0,,,,2,1,2,3
62283_0,,,,2,1,2,3
C1(C(CC(C(C)=O)(O)O1)O)=O,,,5,1,2,0,2
62284_0,,,,2,1,2,3
62285_0,,,,2,1,2,3
62287_0,,,,2,1,2,3
C(CC1(CC(CO1)=O)O)(O)=O,,,5,1,2,0,2
62289_0,,,,2,1,2,3
C(C(C1CC(CO1)O)=O)(O)=O,,,5,1,1,0,1
62291_0,,,,2,1,2,3
C1(C2OC(C1CO2)O)=O,,,5,1,2,0,2
62293_0,,,,2,1,2,3
C1(C2COC(C2O)O1)=O,,,5,1,1,0,1
62295_0,,,,2,1,2,3
C1(C2OC(CO)C1C(O2)O)=O,,,5,1,2,0,2
62297_0,,,,2,1,2,3
C1(C2C(CO)OC(C2O)O1)=O,,,5,1,1,0,1
62299_0,,,,2,1,2,3
C1(COC2COC(C12O)O)=O,,,5,1,2,0,2
62301_0,,,,2,1,2,3
C1(C(O)OC2COC(C12)O)=O,,,5,1,3,0,3
62303_0,,,,2,1,2,3
C1(CC2(C(O)OCC2O1)O)=O,,,5,1,2,0,2
62305_0,,,,2,1,2,3
C1(C2C(CO1)OC(C2O)O)=O,,,5,1,2,0,2
62307_0,,,,2,1,2,3
C1(COC2C1(C(CO2)O)O)=O,,,5,1,1,0,1
62309_0,,,,2,1,2,3
C1(C(O)OC2C1C(CO2)O)=O,,,5,1,2,0,2
62311_0,,,,2,1,2,3
C1(CC2(C(OCC2O)O1)O)=O,,,5,1,1,0,1
62313_0,,,,2,1,2,3
C1(COC2C1C(C(O)O2)O)=O,,,5,1,2,0,2
62315_0,,,,2,1,2,3
C1(C2OCC(C1C(O2)O)O)=O,,,5,1,2,0,2
62317_0,,,,2,1,2,3
C1(C2C(COC(C2O)O1)O)=O,,,5,1,1,0,1
62319_0,,,,2,1,2,3
C1(COC2C(C1C(O)O2)O)=O,,,5,1,2,0,2
62321_0,,,,2,1,2,3
C(C1(CC(CO1)=O)O)(O)=O,,,5,1,2,0,2
62322_0,,,,2,1,2,3
62323_0,,,,2,1,2,3
62325_0,,,,2,1,2,3
C1(CC(C(O)=O)(OC1CO)O)=O,,,5,1,2,0,2
62326_0,,,,2,1,2,3
62327_0,,,,2,1,2,3
62329_0,,,,2,1,2,3
C1(C(C(CO1)=O)=O)=O,,,5,1,2,0,2
62331_0,,,,2,1,2,3
C1(CC(C(O1)=O)=O)=O,,,5,1,3,0,3
62333_0,,,,2,1,2,3
C(C1C(COC1(C=O)O)=O)=O,,,5,1,2,0,2
62334_0,,,,2,1,2,3
62335_0,,,,2,1,2,3
62337_0,,,,2,1,2,3
C1(C(C(CO)O)OC(CC1)O)=O,,,5,1,2,0,2
62339_0,,,,2,1,2,3
C1(CC(C(CO)O)OC(C1)O)=O,,,5,1,2,0,2
62341_0,,,,2,1,2,3
C(C)(C1C(C(CC(O1)O)O)O)=O,,,5,1,2,0,2
62343_0,,,,2,1,2,3
C(CC1C(C(CC(O)O1)O)O)=O,,,5,1,2,0,2
62345_0,,,,2,1,2,3
C1(CCC(C=O)(OC1C=O)O)=O,,,5,1,2,0,2
62347_0,,,,2,1,2,3
C(C1CC(CC(C=O)(O)O1)=O)=O,,,5,1,3,0,3
62349_0,,,,2,1,2,3
C(C1C(OC(C=O)C(C1)=O)O)=O,,,5,1,3,0,3
62351_0,,,,2,1,2,3
C1(CC(C=O)OC(C1C=O)O)=O,,,5,1,2,0,2
62353_0,,,,2,1,2,3
C(C1C(CCC(O1)O)=O)=O,,,5,1,2,0,2
62355_0,,,,2,1,2,3
C1(CC(C=O)OC(C1)O)=O,,,5,1,3,0,3
62356_0,,,,2,1,2,3
62357_0,,,,2,1,2,3
62358_0,,,,2,1,2,3
62360_0,,,,2,1,2,3
C(C1C(CC(C(O1)O)=O)O)=O,,,5,1,2,0,2
62362_0,,,,2,1,2,3
C(C1C(C(C(CO1)=O)O)O)=O,,,5,1,2,0,2
62364_0,,,,2,1,2,3
C1(CC(C(C(C=O)O1)O)O)=O,,,5,1,2,0,2
62366_0,,,,2,1,2,3
C(C1COC(C(C1)=O)O)=O,,,5,1,2,0,2
62368_0,,,,2,1,2,3
C(C1COC(C(C1CO)=O)O)=O,,,5,1,2,0,2
62370_0,,,,2,1,2,3
C(C1C(COCC1(CO)O)=O)=O,,,5,1,1,0,1
62372_0,,,,2,1,2,3
C(C1C(COC(C1)=O)(CO)O)=O,,,5,1,1,0,1
62374_0,,,,2,1,2,3
C(C1C(C(O)OCC1C=O)O)=O,,,5,1,2,0,2
62376_0,,,,2,1,2,3
C1(C(COC(CO)(CO)C1)=O)=O,,,5,1,1,0,1
62378_0,,,,2,1,2,3
C1(CC(CC(CO)(CO)O1)=O)=O,,,5,1,1,0,1
62380_0,,,,2,1,2,3
C1(C(C(O)OCC1CO)=O)=O,,,5,1,2,0,2
62382_0,,,,2,1,2,3
C(C1COC(C(C1O)=O)O)=O,,,5,1,2,0,2
62384_0,,,,2,1,2,3
C1(C(C)C(C(CO1)=O)O)=O,,,5,1,1,0,1
62386_0,,,,2,1,2,3
C1(C(COC(C1C)O)=O)=O,,,5,1,2,0,2
62388_0,,,,2,1,2,3
C1(C(C)OCC(C1O)=O)=O,,,5,1,1,0,1
62390_0,,,,2,1,2,3
C1(C(C)(OCC(C1)=O)O)=O,,,5,1,2,0,2
62392_0,,,,2,1,2,3
C1(C(COC(C)(C1)O)=O)=O,,,5,1,2,0,2
62394_0,,,,2,1,2,3
C(C1C(C(CO)(O)OCC1)=O)=O,,,5,1,2,0,2
62396_0,,,,2,1,2,3
C(C1(C(C(CO)OCC1)=O)O)=O,,,5,1,1,0,1
62398_0,,,,2,1,2,3
C(C1(C(C(C=O)OCC1)O)O)=O,,,5,1,1,0,1
62400_0,,,,2,1,2,3
C1(C(CCO)C(C(CO1)=O)O)=O,,,5,1,1,0,1
62402_0,,,,2,1,2,3
C1(C(COC(C1CCO)O)=O)=O,,,5,1,2,0,2
62404_0,,,,2,1,2,3
C1(C(CCO)OCC(C1O)=O)=O,,,5,1,1,0,1
62406_0,,,,2,1,2,3
C1(C(CCO)(OCC(C1)=O)O)=O,,,5,1,2,0,2
62408_0,,,,2,1,2,3
C1(C(COC(CCO)(C1)O)=O)=O,,,5,1,2,0,2
62410_0,,,,2,1,2,3
C1(CC(C(CO)=O)OC(C1)O)=O,,,5,1,2,0,2
62412_0,,,,2,1,2,3
C1(CCC(OC1C(CO)=O)O)=O,,,5,1,2,0,2
62414_0,,,,2,1,2,3
C1(CC(C=O)OC(CO)(C1)O)=O,,,5,1,2,0,2
62416_0,,,,2,1,2,3
C(C1CCC(C(CO)(O1)O)=O)=O,,,5,1,2,0,2
62418_0,,,,2,1,2,3
C(C1CC(C(C(CO)O1)=O)O)=O,,,5,1,1,0,1
62420_0,,,,2,1,2,3
C(C1C(C(CC(C=O)O1)O)O)=O,,,5,1,1,0,1
62422_0,,,,2,1,2,3
C1(COC(C(CO)=O)C(C1)O)=O,,,5,1,1,0,1
62424_0,,,,2,1,2,3
C1(CCC(C(C(CO)=O)O1)O)=O,,,5,1,2,0,2
62426_0,,,,2,1,2,3
C1(C(CO)C(C(CO1)=O)O)=O,,,5,1,1,0,1
62427_0,,,,2,1,2,3
62429_0,,,,2,1,2,3
C1(C(COC(C1CO)O)=O)=O,,,5,1,2,0,2
62431_0,,,,2,1,2,3
C1(C(COC(CO)(C1)O)=O)=O,,,5,1,2,0,2
62433_0,,,,2,1,2,3
C1(C(CO)(OCC(C1)=O)O)=O,,,5,1,2,0,2
62435_0,,,,2,1,2,3
C1(C(CO)OCC(C1O)=O)=O,,,5,1,2,0,2
62436_0,,,,2,1,2,3
62438_0,,,,2,1,2,3
C1(COC(CO)(C(C1)O)O)=O,,,5,1,2,0,2
62440_0,,,,2,1,2,3
C1(C(C(CO)(O)OCC1)O)=O,,,5,1,2,0,2
62442_0,,,,2,1,2,3
C1(C(COC(CO)(C1)O)O)=O,,,5,1,2,0,2
62443_0,,,,2,1,2,3
62444_0,,,,2,1,2,3
62446_0,,,,2,1,2,3
C(C1C(C(C(CO1)O)O)O)=O,,,5,1,1,0,1
62448_0,,,,2,1,2,3
C1(COCC(C1O)=O)=O,,,5,1,1,0,1
62449_0,,,,2,1,2,3
62450_0,,,,2,1,2,3
62452_0,,,,2,1,2,3
C1(C(COC(C1)O)=O)=O,,,5,1,2,0,2
62453_0,,,,2,1,2,3
62455_0,,,,2,1,2,3
C(CO)(C1COC(C(C1)=O)O)=O,,,5,1,2,0,2
62457_0,,,,2,1,2,3
C(C)(C1(COC(C(C1)=O)O)O)=O,,,5,1,2,0,2
62459_0,,,,2,1,2,3
C(C1C(CO)OC(C(C1)=O)O)=O,,,5,1,2,0,2
62461_0,,,,2,1,2,3
C(C1CC(C=O)(O)OCC1O)=O,,,5,1,2,0,2
62463_0,,,,2,1,2,3
C(C1(CC(C(CO1)=O)CO)O)=O,,,5,1,2,0,2
62465_0,,,,2,1,2,3
C(C1C(COC(C1C=O)O)O)=O,,,5,1,2,0,2
62467_0,,,,2,1,2,3
C(C1C(OCC(C1CO)=O)O)=O,,,5,1,2,0,2
62469_0,,,,2,1,2,3
C(C1CC(O)OCC1O)=O,,,5,1,2,0,2
62471_0,,,,2,1,2,3
C1(COC(CC1CO)O)=O,,,5,1,2,0,2
62473_0,,,,2,1,2,3
C1(C(C)C(C(C(CO)O1)=O)O)=O,,,5,1,1,0,1
62475_0,,,,2,1,2,3
C1(C(C(CO)OC(C1C)O)=O)=O,,,5,1,2,0,2
62477_0,,,,2,1,2,3
C1(C(CO)OC(C(C1O)=O)C)=O,,,5,1,1,0,1
62479_0,,,,2,1,2,3
C1(C(CO)OC(C(C1)=O)(C)O)=O,,,5,1,2,0,2
62481_0,,,,2,1,2,3
C1(C(C(CO)OC(C)(C1)O)=O)=O,,,5,1,2,0,2
62482_0,,,,2,1,2,3
62484_0,,,,2,1,2,3
C1(C(CO)OC(C(C1)=O)O)=O,,,5,1,3,0,3
62485_0,,,,2,1,2,3
62487_0,,,,2,1,2,3
C1(C(C(CO)OC(C1)O)=O)=O,,,5,1,2,0,2
62488_0,,,,2,1,2,3
62490_0,,,,2,1,2,3
C1(CC(C=O)C(C(O1)=O)O)=O,,,5,1,1,0,1
62492_0,,,,2,1,2,3
C(C1CC(C(CO1)=O)=O)(O)=O,,,5,1,1,0,1
62494_0,,,,2,1,2,3
C1(CC(CC(C(O)=O)O1)=O)=O,,,5,1,1,0,1
62496_0,,,,2,1,2,3
C1(CC(C(C(O)O1)=O)=O)=O,,,5,1,2,0,2
62498_0,,,,2,1,2,3
C1(C(O)OC(C(C1)=O)=O)=O,,,5,1,2,0,2
62500_0,,,,2,1,2,3
C(C1(C(CCC(O1)O)=O)CO)=O,,,5,1,2,0,2
62502_0,,,,2,1,2,3
C(C1(CO)CC(CC(O1)O)=O)=O,,,5,1,2,0,2
62503_0,,,,2,1,2,3
62505_0,,,,2,1,2,3
C1(C(COC(C1)O)C(C=O)O)=O,,,5,1,2,0,2
62507_0,,,,2,1,2,3
C1(C(CO)C(C=O)OC(C1)O)=O,,,5,1,2,0,2
62508_0,,,,2,1,2,3
62510_0,,,,2,1,2,3
C(C1COC(C=O)(CC1O)O)=O,,,5,1,2,0,2
62512_0,,,,2,1,2,3
C1(CC(C=O)(O)OCC1CO)=O,,,5,1,2,0,2
62514_0,,,,2,1,2,3
C(C1C(O)OCC(C=O)C1O)=O,,,5,1,2,0,2
62516_0,,,,2,1,2,3
C(C1C(C(COC1O)CO)=O)=O,,,5,1,2,0,2
62518_0,,,,2,1,2,3
C(C1COC(CC1O)O)=O,,,5,1,2,0,2
62520_0,,,,2,1,2,3
C1(CC(O)OCC1CO)=O,,,5,1,2,0,2
62522_0,,,,2,1,2,3
C1(COCC(CO)(C1O)O)=O,,,5,1,1,0,1
62523_0,,,,2,1,2,3
62525_0,,,,2,1,2,3
C1(CC(C(CO1)(CO)O)O)=O,,,5,1,2,0,2
62527_0,,,,2,1,2,3
C(C1COC(C(C1O)O)O)=O,,,5,1,2,0,2
62528_0,,,,2,1,2,3
62529_0,,,,2,1,2,3
62530_0,,,,2,1,2,3
62532_0,,,,2,1,2,3
C(C)(C1(COC(CC1O)O)O)=O,,,5,1,2,0,2
62533_0,,,,2,1,2,3
62535_0,,,,2,1,2,3
C1(CC(O)OCC1C(CO)O)=O,,,5,1,2,0,2
62537_0,,,,2,1,2,3
C1(CC(O)OC(CO)C1CO)=O,,,5,1,2,0,2
62538_0,,,,2,1,2,3
62540_0,,,,2,1,2,3
C(C1C(CCC(O1)O)=O)(O)=O,,,5,1,2,0,2
62542_0,,,,2,1,2,3
C1(CC(C(O)=O)OC(C1)O)=O,,,5,1,2,0,2
62544_0,,,,2,1,2,3
C(C1C(C(C(CO1)=O)O)O)(O)=O,,,5,1,1,0,1
62546_0,,,,2,1,2,3
C(C1C(CC(C(O1)O)=O)O)(O)=O,,,5,1,2,0,2
62548_0,,,,2,1,2,3
C1(CC(C(C(C(O)=O)O1)O)O)=O,,,5,1,2,0,2
62549_0,,,,2,1,2,3
62550_0,,,,2,1,2,3
62551_0,,,,2,1,2,3
62553_0,,,,2,1,2,3
C(C1C(COC(C1C)=O)=O)=O,,,5,1,1,0,1
62555_0,,,,2,1,2,3
C(C1C(CC(C(O1)=O)C)=O)=O,,,5,1,1,0,1
62557_0,,,,2,1,2,3
C(C1(C)CC(C(CO1)=O)=O)=O,,,5,1,1,0,1
62559_0,,,,2,1,2,3
C(C1(C)CC(CC(O1)=O)=O)=O,,,5,1,1,0,1
62561_0,,,,2,1,2,3
C1(C(C)OCC(C1C=O)=O)=O,,,5,1,1,0,1
62563_0,,,,2,1,2,3
C1(C(C=O)OC(C(C1)=O)C)=O,,,5,1,1,0,1
62565_0,,,,2,1,2,3
C(C)(C1CC(C(CO1)=O)=O)=O,,,5,1,1,0,1
62567_0,,,,2,1,2,3
C1(CC(CC(C(C)=O)O1)=O)=O,,,5,1,1,0,1
62569_0,,,,2,1,2,3
C(C1(CC(C=O)C(CO1)=O)O)=O,,,5,1,2,0,2
62571_0,,,,2,1,2,3
C(C1(CCC(CO1)=O)O)=O,,,5,1,2,0,2
62573_0,,,,2,1,2,3
C1(CC(C=O)(O)OCC1)=O,,,5,1,2,0,2
62574_0,,,,2,1,2,3
62575_0,,,,2,1,2,3
62577_0,,,,2,1,2,3
C1(C(CO)OC(C=O)(CC1)O)=O,,,5,1,2,0,2
62579_0,,,,2,1,2,3
C1(CC(C=O)(O)OC(CO)C1)=O,,,5,1,2,0,2
62581_0,,,,2,1,2,3
C(CC1CC(C(CO1)=O)=O)=O,,,5,1,1,0,1
62583_0,,,,2,1,2,3
C(CC1CC(CC(O1)=O)=O)=O,,,5,1,1,0,1
62585_0,,,,2,1,2,3
C(C1C(OCC(C1C=O)=O)O)=O,,,5,1,3,0,3
62587_0,,,,2,1,2,3
C(C1C(OC(C(C1)=O)CO)O)=O,,,5,1,2,0,2
62589_0,,,,2,1,2,3
C(C1C(CC(CO)OC1O)=O)=O,,,5,1,2,0,2
62591_0,,,,2,1,2,3
C(C1(C(C(C=O)OCC1)=O)O)=O,,,5,1,1,0,1
62593_0,,,,2,1,2,3
C(C1C(C(C=O)(O)OCC1)=O)=O,,,5,1,2,0,2
62595_0,,,,2,1,2,3
C(C1(C(COCC1)=O)O)=O,,,5,1,1,0,1
62597_0,,,,2,1,2,3
C(C1C(C(O)OCC1)=O)=O,,,5,1,2,0,2
62599_0,,,,2,1,2,3
C(C1(CCOC(C1)=O)O)=O,,,5,1,2,0,2
62601_0,,,,2,1,2,3
C(C1(C(CO)CC(CO1)=O)O)=O,,,5,1,2,0,2
62603_0,,,,2,1,2,3
C1(C(CO)C(C=O)(O)OCC1)=O,,,5,1,2,0,2
62605_0,,,,2,1,2,3
C1(CC(C(C=O)=O)OC(C1)O)=O,,,5,1,2,0,2
62607_0,,,,2,1,2,3
C1(CCC(OC1C(C=O)=O)O)=O,,,5,1,2,0,2
62609_0,,,,2,1,2,3
C(CC1CC(C(C(O)O1)=O)=O)=O,,,5,1,2,0,2
62611_0,,,,2,1,2,3
C(CC1C(CC(C(O)O1)=O)=O)=O,,,5,1,2,0,2
62613_0,,,,2,1,2,3
C1(COC(C(C=O)=O)C(C1)O)=O,,,5,1,1,0,1
62615_0,,,,2,1,2,3
C1(CCC(C(C(C=O)=O)O1)O)=O,,,5,1,2,0,2
62617_0,,,,2,1,2,3
C(C1CC(C(C(C=O)O1)=O)O)=O,,,5,1,1,0,1
62619_0,,,,2,1,2,3
C1(CCC(C=O)OC1(C=O)O)=O,,,5,1,2,0,2
62620_0,,,,2,1,2,3
62622_0,,,,2,1,2,3
C(C1C(CC(CO1)=O)O)=O,,,5,1,1,0,1
62624_0,,,,2,1,2,3
C1(CCC(C(C=O)O1)O)=O,,,5,1,2,0,2
62626_0,,,,2,1,2,3
C(C1CC(C(CO1)=O)O)=O,,,5,1,1,0,1
62628_0,,,,2,1,2,3
C(C1CCC(C(O1)O)=O)=O,,,5,1,2,0,2
62630_0,,,,2,1,2,3
C1(CC(CC(C=O)O1)O)=O,,,5,1,2,0,2
62631_0,,,,2,1,2,3
62633_0,,,,2,1,2,3
C(C1(COCC(C1C=O)=O)O)=O,,,5,1,1,0,1
62635_0,,,,2,1,2,3
C1(CC(C=O)C(C=O)(CO1)O)=O,,,5,1,1,0,1
62637_0,,,,2,1,2,3
C(C1C(COC(CO)C1O)=O)=O,,,5,1,1,0,1
62639_0,,,,2,1,2,3
C(C1C(C(CO)OC(C1)=O)O)=O,,,5,1,1,0,1
62641_0,,,,2,1,2,3
C(C(C1C(OCC(C1)=O)O)O)=O,,,5,1,2,0,2
62643_0,,,,2,1,2,3
C1(C(C(O)OCC1)C(C=O)O)=O,,,5,1,2,0,2
62645_0,,,,2,1,2,3
C(C1C(COCC1O)=O)=O,,,5,1,1,0,1
62647_0,,,,2,1,2,3
C(C1C(COC(C1)=O)O)=O,,,5,1,1,0,1
62649_0,,,,2,1,2,3
C(CC1C(C(C(O)OC1)=O)=O)=O,,,5,1,2,0,2
62651_0,,,,2,1,2,3
C1(C(CO)C(C=O)C(CO1)=O)=O,,,5,1,1,0,1
62652_0,,,,2,1,2,3
62654_0,,,,2,1,2,3
C(C1C(C=O)C(C(CO1)=O)O)=O,,,5,1,1,0,1
62656_0,,,,2,1,2,3
C1(C(CO)OCC(C1C=O)=O)=O,,,5,1,1,0,1
62658_0,,,,2,1,2,3
C(C1C(C(C=O)C(CO1)=O)O)=O,,,5,1,1,0,1
62660_0,,,,2,1,2,3
C(CO)(C1C(OCC(C1)=O)O)=O,,,5,1,2,0,2
62662_0,,,,2,1,2,3
C1(CCOC(C1C(CO)=O)O)=O,,,5,1,2,0,2
62664_0,,,,2,1,2,3
C(C1C(CO)(OCC(C1)=O)O)=O,,,5,1,2,0,2
62666_0,,,,2,1,2,3
C(C1C(CCOC1(CO)O)=O)=O,,,5,1,2,0,2
62668_0,,,,2,1,2,3
C(C1C(C(COC1C=O)O)O)=O,,,5,1,1,0,1
62670_0,,,,2,1,2,3
C(CC1(CC(C(CO1)=O)=O)O)=O,,,5,1,2,0,2
62672_0,,,,2,1,2,3
C(CC1(C(CC(CO1)=O)=O)O)=O,,,5,1,2,0,2
62674_0,,,,2,1,2,3
C(CC1C(C(C(CO1)=O)O)=O)=O,,,5,1,1,0,1
62676_0,,,,2,1,2,3
C(CC1(C(CC(CO1)=O)O)O)=O,,,5,1,2,0,2
62678_0,,,,2,1,2,3
C(CC1(C(C(CCO1)=O)O)O)=O,,,5,1,2,0,2
62680_0,,,,2,1,2,3
C(CC1(CC(C(CO1)O)=O)O)=O,,,5,1,2,0,2
62682_0,,,,2,1,2,3
C(CC1(C(CC(CO1)O)=O)O)=O,,,5,1,2,0,2
62684_0,,,,2,1,2,3
C(CC1C(C(C(CO1)O)O)=O)=O,,,5,1,1,0,1
62685_0,,,,2,1,2,3
62686_0,,,,2,1,2,3
62688_0,,,,2,1,2,3
C(C)(C1CC(C(C(O)O1)=O)=O)=O,,,5,1,2,0,2
62690_0,,,,2,1,2,3
C1(C(C(C)=O)OC(C(C1)=O)O)=O,,,5,1,2,0,2
62692_0,,,,2,1,2,3
C(C1C(C(C(C(O1)O)=O)=O)C)=O,,,5,1,2,0,2
62694_0,,,,2,1,2,3
C1(C(COC(C)C1)=O)=O,,,5,1,1,0,1
62696_0,,,,2,1,2,3
C1(CC(C)OC(C1)=O)=O,,,5,1,1,0,1
62698_0,,,,2,1,2,3
C1(C(CO)CC(C(C=O)O1)=O)=O,,,5,1,1,0,1
62699_0,,,,2,1,2,3
62701_0,,,,2,1,2,3
C(C1(CO)CC(C(CO1)=O)=O)=O,,,5,1,1,0,1
62703_0,,,,2,1,2,3
C(C1(CO)CC(CC(O1)=O)=O)=O,,,5,1,1,0,1
62705_0,,,,2,1,2,3
C1(COC(C(C=O)=O)CC1O)=O,,,5,1,1,0,1
62707_0,,,,2,1,2,3
C1(C(C=O)OC(C(C1)=O)CO)=O,,,5,1,1,0,1
62709_0,,,,2,1,2,3
C1(CC(C(C=O)OC1C=O)O)=O,,,5,1,1,0,1
62711_0,,,,2,1,2,3
C(CO)(C1CC(C(CO1)=O)=O)=O,,,5,1,1,0,1
62713_0,,,,2,1,2,3
C1(CC(CC(C(CO)=O)O1)=O)=O,,,5,1,1,0,1
62715_0,,,,2,1,2,3
C(C(C1(CCC(CO1)=O)O)O)=O,,,5,1,2,0,2
62717_0,,,,2,1,2,3
C1(CCOC(C(C=O)O)(C1)O)=O,,,5,1,2,0,2
62719_0,,,,2,1,2,3
C(C(C1CC(C(CO1)O)O)=O)=O,,,5,1,1,0,1
62720_0,,,,2,1,2,3
62721_0,,,,2,1,2,3
62723_0,,,,2,1,2,3
C1(C(COC(C(CO)O)C1)=O)=O,,,5,1,1,0,1
62725_0,,,,2,1,2,3
C1(CC(CC(C(CO)O)O1)=O)=O,,,5,1,1,0,1
62727_0,,,,2,1,2,3
C1(C(C=O)OCC(C1)=O)=O,,,5,1,1,0,1
62729_0,,,,2,1,2,3
C(C1C(CCC(O1)=O)=O)=O,,,5,1,1,0,1
62731_0,,,,2,1,2,3
C(C1CC(C(CO1)=O)=O)=O,,,5,1,1,0,1
62733_0,,,,2,1,2,3
C1(CC(CC(C=O)O1)=O)=O,,,5,1,3,0,3
62735_0,,,,2,1,2,3
C(C1C(COC(C1)O)=O)=O,,,5,1,2,0,2
62737_0,,,,2,1,2,3
C1(COC(CC1)O)=O,,,5,1,2,0,2
62739_0,,,,2,1,2,3
C1(CCOC(C1)O)=O,,,5,1,2,0,2
62741_0,,,,2,1,2,3
C1(C(CO)OC(CC1)O)=O,,,5,1,2,0,2
62743_0,,,,2,1,2,3
C1(CC(CO)OC(C1)O)=O,,,5,1,2,0,2
62745_0,,,,2,1,2,3
C(C1C(C(C(O)OC1)=O)=O)=O,,,5,1,2,0,2
62747_0,,,,2,1,2,3
C1(C(C=O)OCC(C1O)=O)=O,,,5,1,1,0,1
62749_0,,,,2,1,2,3
C1(C(C=O)(O)OCC(C1)=O)=O,,,5,1,2,0,2
62751_0,,,,2,1,2,3
C(C1(CC(C(CO1)=O)=O)O)=O,,,5,1,2,0,2
62752_0,,,,2,1,2,3
62754_0,,,,2,1,2,3
C1(C(C(O)OC(CO)C1)=O)=O,,,5,1,2,0,2
62756_0,,,,2,1,2,3
C(C1(C(CC(CO1)=O)O)O)=O,,,5,1,2,0,2
62758_0,,,,2,1,2,3
C1(C(C(C=O)(O)OCC1)O)=O,,,5,1,2,0,2
62759_0,,,,2,1,2,3
62761_0,,,,2,1,2,3
C(C1(C(CC(CO1)O)=O)O)=O,,,5,1,2,0,2
62763_0,,,,2,1,2,3
C(C1C(C(C(CO1)O)O)=O)=O,,,5,1,1,0,1
62764_0,,,,2,1,2,3
62766_0,,,,2,1,2,3
C1(C(C(O)OCC1)=O)=O,,,5,1,2,0,2
62768_0,,,,2,1,2,3
C(C)(C1C(O)OCC(C1O)O)=O,,,5,1,2,0,2
62769_0,,,,2,1,2,3
62771_0,,,,2,1,2,3
C1(COC(C(C(C)O)(C1)O)O)=O,,,5,1,2,0,2
62772_0,,,,2,1,2,3
62773_0,,,,2,1,2,3
62775_0,,,,2,1,2,3
C(C1C(C(OC(C1O)O)=O)=O)=O,,,5,1,3,0,3
62777_0,,,,2,1,2,3
C(C1C(C(O)OC(C1O)=O)=O)=O,,,5,1,3,0,3
62779_0,,,,2,1,2,3
C(C1(C(COC(C1O)=O)=O)O)=O,,,5,1,2,0,2
62781_0,,,,2,1,2,3
C1(CC(C=O)(C(C(O1)=O)O)O)=O,,,5,1,2,0,2
62783_0,,,,2,1,2,3
C1(CC(OC(C=O)C1C=O)O)=O,,,5,1,2,0,2
62785_0,,,,2,1,2,3
C1(C(C)C(C(CO1)=O)(CO)O)=O,,,5,1,1,0,1
62786_0,,,,2,1,2,3
62788_0,,,,2,1,2,3
C1(C(C)OCC(C1(CO)O)=O)=O,,,5,1,1,0,1
62790_0,,,,2,1,2,3
C1(C(C)(OCC(C1CO)=O)O)=O,,,5,1,2,0,2
62791_0,,,,2,1,2,3
62793_0,,,,2,1,2,3
C1(CC(O)OCC1C(CO)=O)=O,,,5,1,2,0,2
62795_0,,,,2,1,2,3
C1(COCC(C1(CO)O)=O)=O,,,5,1,1,0,1
62797_0,,,,2,1,2,3
C1(COC(C(C1CO)=O)O)=O,,,5,1,3,0,3
62799_0,,,,2,1,2,3
C1(COC(CC1(CO)O)=O)=O,,,5,1,1,0,1
62800_0,,,,2,1,2,3
62802_0,,,,2,1,2,3
C1(C(C(CC(O)O1)=O)CO)=O,,,5,1,2,0,2
62804_0,,,,2,1,2,3
C1(C(C=O)C(CC(O)O1)O)=O,,,5,1,2,0,2
62806_0,,,,2,1,2,3
C(C1C(CC(O)OC1)=O)(O)=O,,,5,1,2,0,2
62807_0,,,,2,1,2,3
62809_0,,,,2,1,2,3
C1(C(O)OC(C(C1CO)=O)=O)=O,,,5,1,2,0,2
62810_0,,,,2,1,2,3
62812_0,,,,2,1,2,3
C1(C(C)C(C=O)(C(CO1)O)O)=O,,,5,1,1,0,1
62813_0,,,,2,1,2,3
62815_0,,,,2,1,2,3
C(C1C(C(C)(O)OCC1O)=O)=O,,,5,1,2,0,2
62817_0,,,,2,1,2,3
C(C1(C(C(C)OCC1O)=O)O)=O,,,5,1,1,0,1
62819_0,,,,2,1,2,3
C1(CC(O)OCC1C(C=O)=O)=O,,,5,1,2,0,2
62821_0,,,,2,1,2,3
C(C1C(CC(O)OC1)=O)=O,,,5,1,2,0,2
62823_0,,,,2,1,2,3
C(C1C(CC(O)OC1CO)=O)=O,,,5,1,2,0,2
62825_0,,,,2,1,2,3
C1(C(CO)C(C=O)(CCO1)O)=O,,,5,1,1,0,1
62826_0,,,,2,1,2,3
62828_0,,,,2,1,2,3
C(C1(CO)C(CC(CO1)=O)O)=O,,,5,1,1,0,1
62830_0,,,,2,1,2,3
C(C1(CO)C(CCC(O1)=O)O)=O,,,5,1,2,0,2
62832_0,,,,2,1,2,3
C1(C(CO)C(CC(C=O)O1)O)=O,,,5,1,1,0,1
62833_0,,,,2,1,2,3
62835_0,,,,2,1,2,3
C1(CC(C=O)OC(C1CO)O)=O,,,5,1,2,0,2
62837_0,,,,2,1,2,3
C(C1C(CC(CO)(O)OC1)=O)=O,,,5,1,2,0,2
62839_0,,,,2,1,2,3
C(C1(COC(C=O)CC1O)O)=O,,,5,1,1,0,1
62841_0,,,,2,1,2,3
C(C1CC(O)OCC1(C=O)O)=O,,,5,1,2,0,2
62843_0,,,,2,1,2,3
C(C)(C1C(C(COC1O)=O)=O)=O,,,5,1,2,0,2
62845_0,,,,2,1,2,3
C1(C(C(C)=O)C(C(CO1)=O)O)=O,,,5,1,1,0,1
62847_0,,,,2,1,2,3
C(C1C(C(COC1(C)O)=O)=O)=O,,,5,1,2,0,2
62849_0,,,,2,1,2,3
C(C)(C1(C(OCC(C1)=O)O)O)=O,,,5,1,2,0,2
62851_0,,,,2,1,2,3
C1(CCOC(C1(C(C)=O)O)O)=O,,,5,1,2,0,2
62853_0,,,,2,1,2,3
C1(C(COC(C1C(C)=O)O)O)=O,,,5,1,2,0,2
62854_0,,,,2,1,2,3
62856_0,,,,2,1,2,3
C(C1(C(C)(OCC(C1)=O)O)O)=O,,,5,1,2,0,2
62858_0,,,,2,1,2,3
C(C1(C(CCOC1(C)O)=O)O)=O,,,5,1,2,0,2
62860_0,,,,2,1,2,3
C(C1C(C(COC1(C)O)O)=O)=O,,,5,1,2,0,2
62862_0,,,,2,1,2,3
C(C1(COC(C(C1)=O)(C)O)O)=O,,,5,1,2,0,2
62864_0,,,,2,1,2,3
C(C1(COC(C(C1O)=O)C)O)=O,,,5,1,1,0,1
62866_0,,,,2,1,2,3
C(C1C(C(C(C)(O)OC1)O)=O)=O,,,5,1,2,0,2
62868_0,,,,2,1,2,3
C(C1(C(CC(C)(O)OC1)=O)O)=O,,,5,1,2,0,2
62870_0,,,,2,1,2,3
C(C1(COCC(C1(C)O)=O)O)=O,,,5,1,1,0,1
62872_0,,,,2,1,2,3
C(C1(COC(C(C1C)=O)O)O)=O,,,5,1,2,0,2
62874_0,,,,2,1,2,3
C(C1(COC(CC1(C)O)=O)O)=O,,,5,1,1,0,1
62875_0,,,,2,1,2,3
62876_0,,,,2,1,2,3
62878_0,,,,2,1,2,3
C(C1COC(CC1(C=O)O)O)=O,,,5,1,2,0,2
62880_0,,,,2,1,2,3
C(C1C(C(OC(C1)O)=O)=O)=O,,,5,1,2,0,2
62882_0,,,,2,1,2,3
C1(C(C)C(C(O)=O)(CCO1)O)=O,,,5,1,1,0,1
62884_0,,,,2,1,2,3
C(C1C(C(C)(O)OCC1)=O)(O)=O,,,5,1,2,0,2
62886_0,,,,2,1,2,3
C(C1(C(C(C)OCC1)=O)O)(O)=O,,,5,1,1,0,1
62888_0,,,,2,1,2,3
C1(C(C(CC(O)O1)=O)C)=O,,,5,1,2,0,2
62890_0,,,,2,1,2,3
C1(C(C(CC(O)O1)=O)CCO)=O,,,5,1,2,0,2
62892_0,,,,2,1,2,3
C1(C(CCC(O)O1)=O)=O,,,5,1,2,0,2
62894_0,,,,2,1,2,3
C1(CC(CC(O)O1)=O)=O,,,5,1,2,0,2
62896_0,,,,2,1,2,3
C(CC1C(C(COC1O)=O)=O)=O,,,5,1,2,0,2
62898_0,,,,2,1,2,3
C1(C(CC=O)C(C(CO1)=O)O)=O,,,5,1,1,0,1
62900_0,,,,2,1,2,3
C(C1C(C(CO)OC(C1)O)=O)=O,,,5,1,2,0,2
62902_0,,,,2,1,2,3
C(CC1(C(OCC(C1)=O)O)O)=O,,,5,1,2,0,2
62904_0,,,,2,1,2,3
C1(C(C(O)OCC1)(CC=O)O)=O,,,5,1,2,0,2
62906_0,,,,2,1,2,3
C1(C(C(O)OCC1O)CC=O)=O,,,5,1,2,0,2
62908_0,,,,2,1,2,3
C1(C(C(C(CO1)O)O)CC=O)=O,,,5,1,1,0,1
62910_0,,,,2,1,2,3
C(C1(C)CC(CC(O1)O)=O)(O)=O,,,5,1,2,0,2
62912_0,,,,2,1,2,3
C(C1(C(CCC(O1)O)=O)C)(O)=O,,,5,1,2,0,2
62914_0,,,,2,1,2,3
C(C1(C)C(CC(CO1)=O)O)(O)=O,,,5,1,1,0,1
62916_0,,,,2,1,2,3
C(C1(C)C(CCC(O1)=O)O)(O)=O,,,5,1,2,0,2
62918_0,,,,2,1,2,3
C(C1C(CC(CO1)=O)O)(O)=O,,,5,1,1,0,1
62920_0,,,,2,1,2,3
C1(CCC(C(C(O)=O)O1)O)=O,,,5,1,2,0,2
62922_0,,,,2,1,2,3
C1(C(C(CC(CO)(O)O1)=O)C)=O,,,5,1,2,0,2
62923_0,,,,2,1,2,3
62925_0,,,,2,1,2,3
C1(C(CCC(CO)(O)O1)=O)=O,,,5,1,2,0,2
62927_0,,,,2,1,2,3
C1(CC(CC(CO)(O)O1)=O)=O,,,5,1,2,0,2
62928_0,,,,2,1,2,3
62930_0,,,,2,1,2,3
C(C1CC(O)OC(C1(C)O)=O)=O,,,5,1,2,0,2
62932_0,,,,2,1,2,3
C1(C(C(CO)CC(O)O1)=O)=O,,,5,1,2,0,2
62934_0,,,,2,1,2,3
C(C1CC(O)OC(C1O)=O)=O,,,5,1,2,0,2
62936_0,,,,2,1,2,3
C1(C(C)(CC(C(C)(O)O1)=O)O)=O,,,5,1,2,0,2
62938_0,,,,2,1,2,3
C1(C(C)(C(C(C(C)O1)=O)O)O)=O,,,5,1,2,0,2
62940_0,,,,2,1,2,3
C1(C(C(C(C(C)(O)O1)O)=O)C)=O,,,5,1,2,0,2
62942_0,,,,2,1,2,3
C1(C(C(CC(C)(O)O1)=O)(C)O)=O,,,5,1,2,0,2
62944_0,,,,2,1,2,3
C1(C(CC(C(C)(O)O1)O)=O)=O,,,5,1,2,0,2
62946_0,,,,2,1,2,3
C1(CC(C(OC1(C)O)=O)O)=O,,,5,1,2,0,2
62948_0,,,,2,1,2,3
C1(C(C(C(OC1C)=O)O)O)=O,,,5,1,2,0,2
62950_0,,,,2,1,2,3
C1(CC(C(C(C)(O)O1)O)=O)=O,,,5,1,2,0,2
62952_0,,,,2,1,2,3
C1(C(C(CC(C)(O)O1)=O)O)=O,,,5,1,2,0,2
62954_0,,,,2,1,2,3
C1(C(C)(C(C(CO1)=O)(C)O)O)=O,,,5,1,2,0,2
62956_0,,,,2,1,2,3
C1(C(C)(C(C(C(O)O1)=O)C)O)=O,,,5,1,2,0,2
62958_0,,,,2,1,2,3
C1(C(C)(C(C)(CC(O1)=O)O)O)=O,,,5,1,1,0,1
62960_0,,,,2,1,2,3
C1(C(C(C)C(C(O)O1)O)=O)=O,,,5,1,2,0,2
62962_0,,,,2,1,2,3
C1(COC(C(C1(C)O)O)=O)=O,,,5,1,2,0,2
62964_0,,,,2,1,2,3
C1(C(O)OC(C(C1C)O)=O)=O,,,5,1,2,0,2
62966_0,,,,2,1,2,3
C1(CC(C)(C(C(O1)=O)O)O)=O,,,5,1,1,0,1
62968_0,,,,2,1,2,3
C(C1(C(COCC1)=O)O)(O)=O,,,5,1,1,0,1
62970_0,,,,2,1,2,3
C(C1C(C(O)OCC1)=O)(O)=O,,,5,1,2,0,2
62972_0,,,,2,1,2,3
C(C1(CCOC(C1)=O)O)(O)=O,,,5,1,1,0,1
62974_0,,,,2,1,2,3
C1(CC(C(O)=O)(O)OCC1)=O,,,5,1,2,0,2
62976_0,,,,2,1,2,3
C(C1(CCC(CO1)=O)O)(O)=O,,,5,1,2,0,2
62978_0,,,,2,1,2,3
C1(CC(C(O)=O)(O)OCC1O)=O,,,5,1,2,0,2
62980_0,,,,2,1,2,3
C1(C(C(C(O)=O)(O)OCC1)O)=O,,,5,1,2,0,2
62981_0,,,,2,1,2,3
62982_0,,,,2,1,2,3
62984_0,,,,2,1,2,3
C(C1(C(CC(CO1)=O)O)O)(O)=O,,,5,1,2,0,2
62986_0,,,,2,1,2,3
C(C1C(COC(C1=O)O)=O)=O,,,5,1,2,0,2
62988_0,,,,2,1,2,3
C1(C(C(CO)OC(CC1)O)O)=O,,,5,1,2,0,2
62990_0,,,,2,1,2,3
C1(C(CC(O)OC(CO)C1)O)=O,,,5,1,2,0,2
62992_0,,,,2,1,2,3
C1(CC(C(CO)OC(C1)O)O)=O,,,5,1,2,0,2
62993_0,,,,2,1,2,3
62995_0,,,,2,1,2,3
C(C1C(CCC(C(O1)O)=O)=O)=O,,,5,1,2,0,2
62997_0,,,,2,1,2,3
C(C1CC(CC(C(O)O1)=O)=O)=O,,,5,1,3,0,3
62999_0,,,,2,1,2,3
C1(C(CC(O)OCC1CO)=O)=O,,,5,1,2,0,2
63001_0,,,,2,1,2,3
C(C1COC(CC(C1O)=O)O)=O,,,5,1,2,0,2
63003_0,,,,2,1,2,3
C1(C(COCC(CO)(C1)O)=O)=O,,,5,1,1,0,1
63005_0,,,,2,1,2,3
C1(CC(CC(CO1)(CO)O)=O)=O,,,5,1,1,0,1
63007_0,,,,2,1,2,3
C(C1COC(C(C(C1)=O)O)O)=O,,,5,1,2,0,2
63008_0,,,,2,1,2,3
63010_0,,,,2,1,2,3
C1(C(COC(CC1)O)=O)=O,,,5,1,2,0,2
63012_0,,,,2,1,2,3
C1(C(CCOC(CO)(C1)O)=O)=O,,,5,1,2,0,2
63014_0,,,,2,1,2,3
C1(CCOC(C(C1)=O)(CO)O)=O,,,5,1,2,0,2
63016_0,,,,2,1,2,3
C1(CCOC(C(C1O)=O)CO)=O,,,5,1,1,0,1
63018_0,,,,2,1,2,3
C1(C(C(C(C=O)OCC1)O)O)=O,,,5,1,1,0,1
63020_0,,,,2,1,2,3
C1(CC(CO)(OCC(C1)=O)O)=O,,,5,1,3,0,3
63022_0,,,,2,1,2,3
C1(CCC(C(CO)(OC1)O)=O)=O,,,5,1,2,0,2
63024_0,,,,2,1,2,3
C1(CC(C(C(CO)OC1)=O)O)=O,,,5,1,1,0,1
63026_0,,,,2,1,2,3
C(C1C(C(CC(CO1)=O)O)O)=O,,,5,1,1,0,1
63027_0,,,,2,1,2,3
63029_0,,,,2,1,2,3
C(C1CC(C(C(CO1)=O)O)O)=O,,,5,1,1,0,1
63031_0,,,,2,1,2,3
C1(C(COC(CO)(CC1)O)=O)=O,,,5,1,2,0,2
63033_0,,,,2,1,2,3
C(C1CC(OCC(C1O)=O)O)=O,,,5,1,2,0,2
63035_0,,,,2,1,2,3
C1(C(COC(CC1CO)O)=O)=O,,,5,1,2,0,2
63037_0,,,,2,1,2,3
C1(CC(C(COC1(C)O)=O)O)=O,,,5,1,2,0,2
63039_0,,,,2,1,2,3
C1(C(C(C(C(C)OC1)=O)O)O)=O,,,5,1,1,0,1
63041_0,,,,2,1,2,3
C1(CC(C)(OCC(C1O)=O)O)=O,,,5,1,2,0,2
63043_0,,,,2,1,2,3
C1(C(C(C)(OCC(C1)=O)O)O)=O,,,5,1,2,0,2
63045_0,,,,2,1,2,3
C1(C(COC(C)(C(C1)O)O)=O)=O,,,5,1,2,0,2
63047_0,,,,2,1,2,3
C1(COCC(C(C1(C)O)O)=O)=O,,,5,1,1,0,1
63049_0,,,,2,1,2,3
C1(C(OCC(C(C1C)O)=O)O)=O,,,5,1,2,0,2
63051_0,,,,2,1,2,3
C1(CC(C)(C(C(CO1)=O)O)O)=O,,,5,1,1,0,1
63053_0,,,,2,1,2,3
C1(C(COC(C(C1C)O)O)=O)=O,,,5,1,2,0,2
63055_0,,,,2,1,2,3
C(C1C(COC(C(C1)=O)O)O)=O,,,5,1,2,0,2
63057_0,,,,2,1,2,3
C1(COC(C(CC1CO)=O)O)=O,,,5,1,2,0,2
63059_0,,,,2,1,2,3
C1(C(C)C(C(C(CO1)O)=O)O)=O,,,5,1,1,0,1
63061_0,,,,2,1,2,3
C1(C(C(COC(C1C)O)O)=O)=O,,,5,1,2,0,2
63063_0,,,,2,1,2,3
C1(C(COC(C(C1O)=O)C)O)=O,,,5,1,1,0,1
63065_0,,,,2,1,2,3
C1(C(COC(C(C1)=O)(C)O)O)=O,,,5,1,2,0,2
63067_0,,,,2,1,2,3
C1(C(C(COC(C)(C1)O)O)=O)=O,,,5,1,2,0,2
63069_0,,,,2,1,2,3
C1(CC(OC(C(C1)=O)CO)O)=O,,,5,1,3,0,3
63071_0,,,,2,1,2,3
C1(C(C(CO)OC(CC1)O)=O)=O,,,5,1,2,0,2
63073_0,,,,2,1,2,3
C1(C(COCC(C1O)=O)O)=O,,,5,1,1,0,1
63074_0,,,,2,1,2,3
63075_0,,,,2,1,2,3
63077_0,,,,2,1,2,3
C1(C(C(COC(C1)O)O)=O)=O,,,5,1,2,0,2
63079_0,,,,2,1,2,3
C1(CC(C(CC(O)O1)=O)=O)=O,,,5,1,2,0,2
63081_0,,,,2,1,2,3
C1(CC(O)OC(C(C1)=O)=O)=O,,,5,1,2,0,2
63083_0,,,,2,1,2,3
C1(C(CC(C(CO1)=O)=O)O)=O,,,5,1,2,0,2
63085_0,,,,2,1,2,3
C1(CC(CC(C(O1)=O)O)=O)=O,,,5,1,1,0,1
63087_0,,,,2,1,2,3
C(C1(C(CCC(O)OC1)=O)O)=O,,,5,1,2,0,2
63089_0,,,,2,1,2,3
C(C1C(C(CC(O)OC1)O)=O)=O,,,5,1,2,0,2
63091_0,,,,2,1,2,3
C(C1(COC(CC(C1)=O)O)O)=O,,,5,1,2,0,2
63093_0,,,,2,1,2,3
C(C1COC(C(CC1O)=O)O)=O,,,5,1,2,0,2
63095_0,,,,2,1,2,3
C1(C(CO)COC(C(C1)=O)O)=O,,,5,1,2,0,2
63096_0,,,,2,1,2,3
63098_0,,,,2,1,2,3
C1(CC(O)OCC(C1CO)O)=O,,,5,1,2,0,2
63100_0,,,,2,1,2,3
C(C1C(COC(CC1O)O)O)=O,,,5,1,2,0,2
63102_0,,,,2,1,2,3
C1(C(C(CCC(O)O1)=O)O)=O,,,5,1,2,0,2
63104_0,,,,2,1,2,3
C1(CC(C(CC(O)O1)O)=O)=O,,,5,1,2,0,2
63106_0,,,,2,1,2,3
C1(CC(C(OC(C1)O)=O)O)=O,,,5,1,2,0,2
63108_0,,,,2,1,2,3
C1(C(CC(CC(O)O1)O)=O)=O,,,5,1,2,0,2
63109_0,,,,2,1,2,3
63111_0,,,,2,1,2,3
C1(C(C(CC(C(O)O1)=O)O)O)=O,,,5,1,2,0,2
63113_0,,,,2,1,2,3
C1(CC(C(C(C(O1)=O)O)O)O)=O,,,5,1,2,0,2
63115_0,,,,2,1,2,3
C1(C(C(CC(C(O)O1)O)=O)O)=O,,,5,1,3,0,3
63117_0,,,,2,1,2,3
C1(CC(C(C(C(O)O1)O)O)=O)=O,,,5,1,3,0,3
63118_0,,,,2,1,2,3
63119_0,,,,2,1,2,3
63121_0,,,,2,1,2,3
C1(C(CC(C(C(O)O1)O)O)=O)=O,,,5,1,2,0,2
63123_0,,,,2,1,2,3
C(C1C(COC(C(C1)=O)O)=O)=O,,,5,1,2,0,2
63125_0,,,,2,1,2,3
C1(CCC(C(OC1CO)O)=O)=O,,,5,1,2,0,2
63127_0,,,,2,1,2,3
C1(CC(CO)OC(C(C1)=O)O)=O,,,5,1,2,0,2
63129_0,,,,2,1,2,3
C1(C(COC(C=O)(CC1)O)O)=O,,,5,1,2,0,2
63130_0,,,,2,1,2,3
63132_0,,,,2,1,2,3
C1(CC(C=O)(O)OCC(C1)O)=O,,,5,1,2,0,2
63133_0,,,,2,1,2,3
63135_0,,,,2,1,2,3
C(C1C(O)OCC(C(C1)=O)O)=O,,,5,1,2,0,2
63136_0,,,,2,1,2,3
63138_0,,,,2,1,2,3
C(C1C(CC(COC1O)O)=O)=O,,,5,1,2,0,2
63139_0,,,,2,1,2,3
63141_0,,,,2,1,2,3
C(C1C(C(C(O)OCC1)=O)=O)=O,,,5,1,2,0,2
63143_0,,,,2,1,2,3
C1(C(C=O)OCCC(C1O)=O)=O,,,5,1,1,0,1
63145_0,,,,2,1,2,3
C1(C(C=O)(O)OCCC(C1)=O)=O,,,5,1,2,0,2
63147_0,,,,2,1,2,3
C(C1(CC(C(CCO1)=O)=O)O)=O,,,5,1,2,0,2
63149_0,,,,2,1,2,3
C1(CC(C(C(OC1)O)=O)CO)=O,,,5,1,2,0,2
63151_0,,,,2,1,2,3
C1(CCOC(C(C1CO)=O)O)=O,,,5,1,2,0,2
63153_0,,,,2,1,2,3
C(C1CCC(C(C(O1)O)=O)=O)=O,,,5,1,2,0,2
63154_0,,,,2,1,2,3
63156_0,,,,2,1,2,3
C(C1C(COCC(C1O)=O)=O)=O,,,5,1,1,0,1
63158_0,,,,2,1,2,3
C1(CC(C=O)C(C(CO1)=O)O)=O,,,5,1,1,0,1
63160_0,,,,2,1,2,3
C(C1C(C(OCC(C1)=O)O)O)=O,,,5,1,2,0,2
63162_0,,,,2,1,2,3
C(C1C(CCOC(C1O)O)=O)=O,,,5,1,2,0,2
63164_0,,,,2,1,2,3
C(C1C(COCC(C1O)O)=O)=O,,,5,1,1,0,1
63166_0,,,,2,1,2,3
C(C1C(C(COC(C1)=O)O)O)=O,,,5,1,1,0,1
63168_0,,,,2,1,2,3
C(C1C(C(CC(CO1)=O)O)=O)=O,,,5,1,1,0,1
63170_0,,,,2,1,2,3
C(C1(C(CCC(CO1)=O)=O)O)=O,,,5,1,2,0,2
63172_0,,,,2,1,2,3
C(C1(CC(CC(CO1)=O)=O)O)=O,,,5,1,2,0,2
63174_0,,,,2,1,2,3
C(C1C(C(CC(O)OC1)=O)=O)=O,,,5,1,2,0,2
63175_0,,,,2,1,2,3
63177_0,,,,2,1,2,3
C1(C(CC(O)OC(CO)C1)=O)=O,,,5,1,2,0,2
63179_0,,,,2,1,2,3
C(C1(COCC(C(C1)=O)=O)O)=O,,,5,1,1,0,1
63181_0,,,,2,1,2,3
C(C1(COC(CC(C1)=O)=O)O)=O,,,5,1,1,0,1
63183_0,,,,2,1,2,3
C1(C(COC(CO)C(C1)O)=O)=O,,,5,1,1,0,1
63185_0,,,,2,1,2,3
C1(CC(CC(C(CO)O1)O)=O)=O,,,5,1,1,0,1
63187_0,,,,2,1,2,3
C1(C(COC(CC1)O)O)=O,,,5,1,2,0,2
63188_0,,,,2,1,2,3
63190_0,,,,2,1,2,3
C1(CC(COC(C1)O)O)=O,,,5,1,2,0,2
63191_0,,,,2,1,2,3
63193_0,,,,2,1,2,3
C1(COC(C(C(C1)=O)=O)O)=O,,,5,1,2,0,2
63195_0,,,,2,1,2,3
C1(C(O)OCC(C(C1)=O)=O)=O,,,5,1,2,0,2
63197_0,,,,2,1,2,3
C1(C(O)OCC(CC1O)=O)=O,,,5,1,2,0,2
63199_0,,,,2,1,2,3
C1(CCOC(C(C1O)=O)O)=O,,,5,1,2,0,2
63200_0,,,,2,1,2,3
63202_0,,,,2,1,2,3
C1(C(C(O)OCC(C1)O)=O)=O,,,5,1,2,0,2
63204_0,,,,2,1,2,3
C1(CC(OCC(C1CO)=O)O)=O,,,5,1,2,0,2
63205_0,,,,2,1,2,3
63206_0,,,,2,1,2,3
63208_0,,,,2,1,2,3
C(C1C(CC(O)OCC1O)=O)=O,,,5,1,2,0,2
63210_0,,,,2,1,2,3
C1(C(CO)C(C(CCO1)=O)O)=O,,,5,1,1,0,1
63211_0,,,,2,1,2,3
63213_0,,,,2,1,2,3
C1(C(CCOC(C1CO)O)=O)=O,,,5,1,2,0,2
63215_0,,,,2,1,2,3
C(C1(COCC(CC1O)=O)O)=O,,,5,1,1,0,1
63217_0,,,,2,1,2,3
C(C1(COC(CCC1O)=O)O)=O,,,5,1,2,0,2
63219_0,,,,2,1,2,3
C(C1C(CC(C(O)OC1)O)=O)=O,,,5,1,2,0,2
63221_0,,,,2,1,2,3
C1(C(CO)C(CC(CO1)=O)O)=O,,,5,1,1,0,1
63222_0,,,,2,1,2,3
63224_0,,,,2,1,2,3
C1(C(CO)C(OCC(C1)=O)O)=O,,,5,1,2,0,2
63226_0,,,,2,1,2,3
C(C1C(CC(O)OCC1)=O)(O)=O,,,5,1,2,0,2
63228_0,,,,2,1,2,3
C(C1C(C(COC(C1)O)=O)=O)=O,,,5,1,2,0,2
63230_0,,,,2,1,2,3
C(C1(CC(OCC(C1)=O)O)O)=O,,,5,1,2,0,2
63232_0,,,,2,1,2,3
C(C1(C(CCOC(C1)O)=O)O)=O,,,5,1,2,0,2
63234_0,,,,2,1,2,3
C(C1C(C(COC(C1)O)O)=O)=O,,,5,1,2,0,2
63236_0,,,,2,1,2,3
C1(C(C)(CC(CC(O)O1)=O)O)=O,,,5,1,2,0,2
63238_0,,,,2,1,2,3
C1(C(C(C(CC(O)O1)O)=O)C)=O,,,5,1,2,0,2
63240_0,,,,2,1,2,3
C1(C(C(CCC(O)O1)=O)(C)O)=O,,,5,1,2,0,2
63241_0,,,,2,1,2,3
63243_0,,,,2,1,2,3
C1(C(C)(C(CCC(O1)=O)O)O)=O,,,5,1,2,0,2
63245_0,,,,2,1,2,3
C1(C(C(CC(C(O)O1)O)=O)C)=O,,,5,1,2,0,2
63247_0,,,,2,1,2,3
C1(C(CCC(C(O)O1)O)=O)=O,,,5,1,2,0,2
63248_0,,,,2,1,2,3
63250_0,,,,2,1,2,3
C1(CCC(C(C(O1)=O)O)O)=O,,,5,1,2,0,2
63252_0,,,,2,1,2,3
C1(CC(CC(C(O)O1)O)=O)=O,,,5,1,2,0,2
63253_0,,,,2,1,2,3
63255_0,,,,2,1,2,3
C(C(C1CC(C(O1)=O)=O)O)=O,,,5,1,2,0,2
63257_0,,,,2,1,2,3
C(C1C(C(OC1)=O)=O)=O,,,5,1,2,0,2
63259_0,,,,2,1,2,3
C(C1C(C(OC1CO)=O)=O)=O,,,5,1,2,0,2
63260_0,,,,2,1,2,3
63262_0,,,,2,1,2,3
C(C1C(C(OC1C=O)=O)=O)=O,,,5,1,2,0,2
63264_0,,,,2,1,2,3
C1(C(C=O)C(CO1)(CO)O)=O,,,5,1,2,0,2
63266_0,,,,2,1,2,3
C(C1COC(C1(CO)O)=O)=O,,,5,1,2,0,2
63268_0,,,,2,1,2,3
C(CO)(C1C(C(OC1)=O)=O)=O,,,5,1,2,0,2
63270_0,,,,2,1,2,3
C1(C(C(C(O1)=O)=O)CO)=O,,,5,1,2,0,2
63272_0,,,,2,1,2,3
C1(C(C=O)C(C(O1)=O)O)=O,,,5,1,2,0,2
63273_0,,,,2,1,2,3
63275_0,,,,2,1,2,3
C1(C(C=O)C(C=O)(CO1)O)=O,,,5,1,2,0,2
63277_0,,,,2,1,2,3
C(C(C1C(C(OC1)=O)=O)=O)=O,,,5,1,2,0,2
63279_0,,,,2,1,2,3
C(C1C(C(OC1C)=O)=O)=O,,,5,1,2,0,2
63281_0,,,,2,1,2,3
C(C1COC(C1(C)O)=O)=O,,,5,1,2,0,2
63282_0,,,,2,1,2,3
63283_0,,,,2,1,2,3
63284_0,,,,2,1,2,3
63285_0,,,,2,1,2,3
63286_0,,,,2,1,2,3
63288_0,,,,2,1,2,3
C(C)(C1(COC(C1O)=O)O)=O,,,5,1,2,0,2
63289_0,,,,2,1,2,3
63290_0,,,,2,1,2,3
63292_0,,,,2,1,2,3
C1(C(C(C(O1)=O)=O)C)=O,,,5,1,2,0,2
63294_0,,,,2,1,2,3
C1(C(C(C(O1)=O)=O)CCO)=O,,,5,1,2,0,2
63296_0,,,,2,1,2,3
C1(C(CC(CO)(CO)O1)=O)=O,,,5,1,2,0,2
63297_0,,,,2,1,2,3
63299_0,,,,2,1,2,3
C(CC1C(C(C(O1)=O)C)=O)=O,,,5,1,2,0,2
63301_0,,,,2,1,2,3
C(CC1C(C(OC1)=O)=O)=O,,,5,1,2,0,2
63303_0,,,,2,1,2,3
C1(C(C(C)=O)OC(C1C)=O)=O,,,5,1,2,0,2
63305_0,,,,2,1,2,3
C(C1C(C(C(O1)=O)=O)C)=O,,,5,1,2,0,2
63307_0,,,,2,1,2,3
C1(C(C(C(CO)O1)=O)C)=O,,,5,1,2,0,2
63309_0,,,,2,1,2,3
C1(COC(C1C)=O)=O,,,5,1,2,0,2
63311_0,,,,2,1,2,3
C1(C(C(CO1)=O)CCO)=O,,,5,1,2,0,2
63313_0,,,,2,1,2,3
C(CC1C(C(C(O1)=O)=O)O)=O,,,5,1,2,0,2
63315_0,,,,2,1,2,3
C(C)(C1C(C(C(O1)=O)=O)O)=O,,,5,1,2,0,2
63316_0,,,,2,1,2,3
63317_0,,,,2,1,2,3
63319_0,,,,2,1,2,3
C1(COC(C(C1)=O)=O)=O,,,5,1,3,0,3
63321_0,,,,2,1,2,3
C1(CC(C(CO1)=O)=O)=O,,,5,1,2,0,2
63323_0,,,,2,1,2,3
C1(C(CO)OC(C(C1)=O)=O)=O,,,5,1,3,0,3
63325_0,,,,2,1,2,3
C1(CC(C(C(CO)O1)=O)=O)=O,,,5,1,2,0,2
63327_0,,,,2,1,2,3
C1(C(C(CC(C=O)O1)=O)O)=O,,,5,1,2,0,2
63329_0,,,,2,1,2,3
C1(CC(C(C(C=O)O1)O)=O)=O,,,5,1,2,0,2
63330_0,,,,2,1,2,3
63332_0,,,,2,1,2,3
C(C1C(CC(C(O1)=O)=O)O)=O,,,5,1,2,0,2
63334_0,,,,2,1,2,3
C(C1C(C(OCC1O)=O)=O)=O,,,5,1,2,0,2
63335_0,,,,2,1,2,3
63337_0,,,,2,1,2,3
C1(COC(C(C1CO)=O)=O)=O,,,5,1,2,0,2
63338_0,,,,2,1,2,3
63340_0,,,,2,1,2,3
C1(C(C(C(CO1)=O)=O)CO)=O,,,5,1,2,0,2
63342_0,,,,2,1,2,3
C1(C(C=O)C(C(CO1)=O)O)=O,,,5,1,2,0,2
63343_0,,,,2,1,2,3
63344_0,,,,2,1,2,3
63345_0,,,,2,1,2,3
63347_0,,,,2,1,2,3
C(C1C(C(OCC1)=O)=O)(O)=O,,,5,1,2,0,2
63349_0,,,,2,1,2,3
C1(C(CC(CO1)(CO)O)=O)=O,,,5,1,2,0,2
63350_0,,,,2,1,2,3
63351_0,,,,2,1,2,3
63353_0,,,,2,1,2,3
C(C1COC(C(C1O)O)=O)=O,,,5,1,2,0,2
63355_0,,,,2,1,2,3
C(C1C(C(OCC1)=O)=O)=O,,,5,1,2,0,2
63357_0,,,,2,1,2,3
C1(CC(C=O)OC(C1C)=O)=O,,,5,1,2,0,2
63359_0,,,,2,1,2,3
C(C1CCC(C(O1)=O)=O)=O,,,5,1,2,0,2
63360_0,,,,2,1,2,3
63362_0,,,,2,1,2,3
C1(C(C(C(CO1)=O)=O)C)=O,,,5,1,2,0,2
63364_0,,,,2,1,2,3
C1(C(C)(CC(CO1)=O)O)=O,,,5,1,2,0,2
63366_0,,,,2,1,2,3
C1(C(C(CCO1)=O)(C)O)=O,,,5,1,2,0,2
63368_0,,,,2,1,2,3
C1(C(C(C(CO1)O)=O)C)=O,,,5,1,2,0,2
63369_0,,,,2,1,2,3
63370_0,,,,2,1,2,3
63371_0,,,,2,1,2,3
63373_0,,,,2,1,2,3
C1(C(C(CC(CO)O1)=O)=O)=O,,,5,1,2,0,2
63375_0,,,,2,1,2,3
C1(C(COC(C(C1)=O)=O)O)=O,,,5,1,3,0,3
63377_0,,,,2,1,2,3
C1(CC(C(C(CO1)O)=O)=O)=O,,,5,1,2,0,2
63379_0,,,,2,1,2,3
C1(C(C(C(CCO1)=O)=O)C)=O,,,5,1,2,0,2
63381_0,,,,2,1,2,3
C1(CC(COC(C1C)=O)=O)=O,,,5,1,2,0,2
63382_0,,,,2,1,2,3
63384_0,,,,2,1,2,3
C1(CCOC(C(C1O)=O)=O)=O,,,5,1,2,0,2
63386_0,,,,2,1,2,3
C1(C(C(CC(CO1)O)=O)=O)=O,,,5,1,2,0,2
63388_0,,,,2,1,2,3
C1(COC(C(C(C1)O)=O)=O)=O,,,5,1,2,0,2
63390_0,,,,2,1,2,3
C1(CC(C(OCC1)=O)O)=O,,,5,1,2,0,2
63392_0,,,,2,1,2,3
C1(C(CCC(CO1)=O)O)=O,,,5,1,2,0,2
63394_0,,,,2,1,2,3
C(C(C(C)=O)CCC(C=O)=O)=O,,,5,1,4,0,4
63396_0,,,,2,1,2,3
C(C(C(C)=O)C(C=O)CC=O)=O,,,5,1,4,0,4
63398_0,,,,2,1,2,3
C(C(C(C)=O)CCC(O)=O)=O,,,5,1,4,0,4
63400_0,,,,2,1,2,3
C(C=O)(C(C)CCC(C=O)=O)=O,,,5,1,2,0,2
63402_0,,,,2,1,2,3
C(CC(C=O)C(C(C=O)=O)C)=O,,,5,1,2,0,2
63404_0,,,,2,1,2,3
C(CCC(C(C=O)=O)C)(O)=O,,,5,1,2,0,2
63406_0,,,,2,1,2,3
C(C(CCCCC(C=O)=O)=O)=O,,,5,1,2,0,2
63408_0,,,,2,1,2,3
C(CC(CCCC(C=O)=O)=O)=O,,,5,1,4,0,4
63410_0,,,,2,1,2,3
C(C(CCC(C=O)=O)CC=O)=O,,,5,1,6,0,6
63412_0,,,,2,1,2,3
C(CC(CC(C=O)CC=O)=O)=O,,,5,1,4,0,4
63414_0,,,,2,1,2,3
C(CCCCC(C=O)=O)(O)=O,,,5,1,2,0,2
63416_0,,,,2,1,2,3
C(CC(CCCC(O)=O)=O)=O,,,5,1,4,0,4
63418_0,,,,2,1,2,3
C(CCC(CCC(C=O)=O)=O)=O,,,5,1,1,0,1
63419_0,,,,2,1,2,3
63421_0,,,,2,1,2,3
C(C(C(CCC=O)=O)CC=O)=O,,,5,1,1,0,1
63422_0,,,,2,1,2,3
63424_0,,,,2,1,2,3
C(CCC(CCC(O)=O)=O)=O,,,5,1,1,0,1
63425_0,,,,2,1,2,3
63426_0,,,,2,1,2,3
63428_0,,,,2,1,2,3
C(CC(C=O)C(C=O)CC=O)=O,,,5,1,3,0,3
63430_0,,,,2,1,2,3
C(C(CCC(O)=O)CC=O)=O,,,5,1,4,0,4
63431_0,,,,2,1,2,3
63432_0,,,,2,1,2,3
63433_0,,,,2,1,2,3
63434_0,,,,2,1,2,3
63435_0,,,,2,1,2,3
63436_0,,,,2,1,2,3
63438_0,,,,2,1,2,3
C(CCC(O)=O)(C(CO)CO)=O,,,5,1,1,0,1
63439_0,,,,2,1,2,3
63440_0,,,,2,1,2,3
63441_0,,,,2,1,2,3
63442_0,,,,2,1,2,3
63444_0,,,,2,1,2,3
C(C=O)(CCCC(C(C)=O)=O)=O,,,5,1,3,0,3
63446_0,,,,2,1,2,3
C(CCC(C=O)=O)(CC(C)=O)=O,,,5,1,1,0,1
63448_0,,,,2,1,2,3
C(CC(C=O)CC(C(C)=O)=O)=O,,,5,1,3,0,3
63450_0,,,,2,1,2,3
C(C(C(CC(C)=O)=O)CC=O)=O,,,5,1,1,0,1
63452_0,,,,2,1,2,3
C(CCCC(C(C)=O)=O)(O)=O,,,5,1,3,0,3
63454_0,,,,2,1,2,3
C(CCC(O)=O)(CC(C)=O)=O,,,5,1,1,0,1
63455_0,,,,2,1,2,3
63456_0,,,,2,1,2,3
63457_0,,,,2,1,2,3
63458_0,,,,2,1,2,3
63459_0,,,,2,1,2,3
63460_0,,,,2,1,2,3
63462_0,,,,2,1,2,3
C(C)(C(C(O)=O)CCC(O)=O)=O,,,5,1,2,0,2
63464_0,,,,2,1,2,3
C(CCC(C(C(O)=O)=O)C)(O)=O,,,5,1,2,0,2
63466_0,,,,2,1,2,3
C(CCCCC(C(O)=O)=O)(O)=O,,,5,1,2,0,2
63468_0,,,,2,1,2,3
C(CCCC(O)=O)(CC(O)=O)=O,,,5,1,2,0,2
63470_0,,,,2,1,2,3
C(CCC(O)=O)(C(C(O)=O)C)=O,,,5,1,1,0,1
63472_0,,,,2,1,2,3
C(C(C(O)=O)CCCC(O)=O)=O,,,5,1,2,0,2
63473_0,,,,2,1,2,3
63474_0,,,,2,1,2,3
63475_0,,,,2,1,2,3
63476_0,,,,2,1,2,3
63477_0,,,,2,1,2,3
63478_0,,,,2,1,2,3
63479_0,,,,2,1,2,3
63480_0,,,,2,1,2,3
63481_0,,,,2,1,2,3
63482_0,,,,2,1,2,3
63483_0,,,,2,1,2,3
63484_0,,,,2,1,2,3
63485_0,,,,2,1,2,3
63486_0,,,,2,1,2,3
63487_0,,,,2,1,2,3
63488_0,,,,2,1,2,3
63489_0,,,,2,1,2,3
63490_0,,,,2,1,2,3
63491_0,,,,2,1,2,3
63492_0,,,,2,1,2,3
63493_0,,,,2,1,2,3
63494_0,,,,2,1,2,3
63495_0,,,,2,1,2,3
63497_0,,,,2,1,2,3
C(CCC1C(COC1=O)=O)(O)=O,,,5,1,3,0,3
63499_0,,,,2,1,2,3
C(CCC1CC(C(O1)=O)=O)(O)=O,,,5,1,3,0,3
63501_0,,,,2,1,2,3
C(CCC1C(CC(O1)=O)=O)(O)=O,,,5,1,3,0,3
63503_0,,,,2,1,2,3
C(CCC1C(C(OC1)=O)=O)(O)=O,,,5,1,3,0,3
63504_0,,,,2,1,2,3
63505_0,,,,2,1,2,3
63506_0,,,,2,1,2,3
63507_0,,,,2,1,2,3
63508_0,,,,2,1,2,3
63509_0,,,,2,1,2,3
63510_0,,,,2,1,2,3
63512_0,,,,2,1,2,3
C(CCC(CC(C=O)O)=O)(O)=O,,,5,1,1,0,1
63513_0,,,,2,1,2,3
63514_0,,,,2,1,2,3
63515_0,,,,2,1,2,3
63516_0,,,,2,1,2,3
63517_0,,,,2,1,2,3
63518_0,,,,2,1,2,3
63519_0,,,,2,1,2,3
63520_0,,,,2,1,2,3
63521_0,,,,2,1,2,3
63522_0,,,,2,1,2,3
63523_0,,,,2,1,2,3
63524_0,,,,2,1,2,3
63525_0,,,,2,1,2,3
63526_0,,,,2,1,2,3
63527_0,,,,2,1,2,3
63529_0,,,,2,1,2,3
C(CCC(O)=O)(CCO)=O,,,5,1,1,0,1
63530_0,,,,2,1,2,3
63531_0,,,,2,1,2,3
63532_0,,,,2,1,2,3
63533_0,,,,2,1,2,3
63534_0,,,,2,1,2,3
63535_0,,,,2,1,2,3
63536_0,,,,2,1,2,3
63538_0,,,,2,1,2,3
C(CCC(O)=O)(CC(CO)O)=O,,,5,1,1,0,1
63539_0,,,,2,1,2,3
63540_0,,,,2,1,2,3
63541_0,,,,2,1,2,3
63542_0,,,,2,1,2,3
63543_0,,,,2,1,2,3
63545_0,,,,2,1,2,3
C(CC(CCC(O)=O)=O)(O)=O,,,5,1,1,0,1
63546_0,,,,2,1,2,3
63547_0,,,,2,1,2,3
63548_0,,,,2,1,2,3
63549_0,,,,2,1,2,3
63550_0,,,,2,1,2,3
63551_0,,,,2,1,2,3
63552_0,,,,2,1,2,3
63553_0,,,,2,1,2,3
63554_0,,,,2,1,2,3
63555_0,,,,2,1,2,3
63556_0,,,,2,1,2,3
63557_0,,,,2,1,2,3
63558_0,,,,2,1,2,3
63559_0,,,,2,1,2,3
63560_0,,,,2,1,2,3
63561_0,,,,2,1,2,3
63562_0,,,,2,1,2,3
63563_0,,,,2,1,2,3
63564_0,,,,2,1,2,3
63566_0,,,,2,1,2,3
C(C(CO)CC(O)=O)(CC=O)=O,,,5,1,1,0,1
63567_0,,,,2,1,2,3
63568_0,,,,2,1,2,3
63569_0,,,,2,1,2,3
63570_0,,,,2,1,2,3
63571_0,,,,2,1,2,3
63573_0,,,,2,1,2,3
C(C(CO)CC(O)=O)(CCO)=O,,,5,1,1,0,1
63574_0,,,,2,1,2,3
63575_0,,,,2,1,2,3
63576_0,,,,2,1,2,3
63577_0,,,,2,1,2,3
63578_0,,,,2,1,2,3
63579_0,,,,2,1,2,3
63580_0,,,,2,1,2,3
63582_0,,,,2,1,2,3
C(C(CO)CC(C=O)O)=O,,,5,1,2,0,2
63584_0,,,,2,1,2,3
C(C(CC(C=O)O)C(CO)O)=O,,,5,1,3,0,3
63585_0,,,,2,1,2,3
63587_0,,,,2,1,2,3
C(C(CC(C(CO)=O)CO)O)=O,,,5,1,2,0,2
63588_0,,,,2,1,2,3
63590_0,,,,2,1,2,3
C(CCC(C=O)O)(CC=O)=O,,,5,1,2,0,2
63592_0,,,,2,1,2,3
C(CCC(CC(C=O)O)=O)=O,,,5,1,2,0,2
63594_0,,,,2,1,2,3
C(C(CC(C(C=O)=O)C)O)=O,,,5,1,2,0,2
63595_0,,,,2,1,2,3
63596_0,,,,2,1,2,3
63597_0,,,,2,1,2,3
63599_0,,,,2,1,2,3
C(C(CO)O)(CCC(C=O)O)=O,,,5,1,2,0,2
63600_0,,,,2,1,2,3
63602_0,,,,2,1,2,3
C(CC(C=O)O)(CC(CO)O)=O,,,5,1,2,0,2
63603_0,,,,2,1,2,3
63604_0,,,,2,1,2,3
63605_0,,,,2,1,2,3
63606_0,,,,2,1,2,3
63607_0,,,,2,1,2,3
63608_0,,,,2,1,2,3
63610_0,,,,2,1,2,3
C(CC[C](C(O)=O)O)=O,,,5,1,3,0,3
63611_0,,,,2,1,2,3
63612_0,,,,2,1,2,3
63613_0,,,,2,1,2,3
63615_0,,,,2,1,2,3
C(C)(C(C[C](C(O)=O)O)O)=O,,,5,1,2,0,2
63617_0,,,,2,1,2,3
C1C(C(C(C=1C(C=O)=O)O)O)O,,,5,1,1,0,1
63619_0,,,,2,1,2,3
C1C(C(C(C=1C=O)O)O)O,,,5,1,2,0,2
63620_0,,,,2,1,2,3
63621_0,,,,2,1,2,3
63622_0,,,,2,1,2,3
63623_0,,,,2,1,2,3
63624_0,,,,2,1,2,3
63626_0,,,,2,1,2,3
C=C1C(C(C(C1(CO)O)O)O)=O,,,5,1,1,0,1
63628_0,,,,2,1,2,3
C1(CO)C(C(C(C=1CO)=O)O)O,,,5,1,1,0,1
63629_0,,,,2,1,2,3
63630_0,,,,2,1,2,3
63632_0,,,,2,1,2,3
C1C(C(C(C=1C=O)(CO)O)O)O,,,5,1,2,0,2
63634_0,,,,2,1,2,3
C1(CO)C(C(C(C=1C=O)O)O)O,,,5,1,1,0,1
63635_0,,,,2,1,2,3
63636_0,,,,2,1,2,3
63637_0,,,,2,1,2,3
63638_0,,,,2,1,2,3
63640_0,,,,2,1,2,3
C1(CO)C(C(C(C(C=1)=O)O)O)O,,,5,1,1,0,1
63642_0,,,,2,1,2,3
C1(C(C(C(C=1)=O)O)O)C(CO)O,,,5,1,1,0,1
63644_0,,,,2,1,2,3
C1C(C(CO)(C(C=1C=O)O)O)O,,,5,1,2,0,2
63646_0,,,,2,1,2,3
C1C(CO)(C(C(C=1C=O)O)O)O,,,5,1,1,0,1
63647_0,,,,2,1,2,3
63648_0,,,,2,1,2,3
63649_0,,,,2,1,2,3
63650_0,,,,2,1,2,3
63652_0,,,,2,1,2,3
C1(CC(C=O)=CC1O)=O,,,5,1,1,0,1
63653_0,,,,2,1,2,3
63655_0,,,,2,1,2,3
C(C1CC(C(C=1)=O)O)=O,,,5,1,1,0,1
63656_0,,,,2,1,2,3
63658_0,,,,2,1,2,3
C1(CC=C(C=O)C1O)=O,,,5,1,1,0,1
63659_0,,,,2,1,2,3
63660_0,,,,2,1,2,3
63662_0,,,,2,1,2,3
C1(C(C(CO)=C(C=O)C1)O)=O,,,5,1,1,0,1
63663_0,,,,2,1,2,3
63664_0,,,,2,1,2,3
63666_0,,,,2,1,2,3
C(C1C(CO)C(C(C=1)=O)O)=O,,,5,1,1,0,1
63667_0,,,,2,1,2,3
63668_0,,,,2,1,2,3
63669_0,,,,2,1,2,3
63670_0,,,,2,1,2,3
63671_0,,,,2,1,2,3
63672_0,,,,2,1,2,3
63673_0,,,,2,1,2,3
63675_0,,,,2,1,2,3
C(C(C1C(C(CC=1)=O)O)O)=O,,,5,1,1,0,1
63676_0,,,,2,1,2,3
63678_0,,,,2,1,2,3
C(C(C1C=CC(C1O)=O)O)=O,,,5,1,1,0,1
63680_0,,,,2,1,2,3
C1(C(C(C(CO)=O)=CC1)O)=O,,,5,1,1,0,1
63681_0,,,,2,1,2,3
63682_0,,,,2,1,2,3
63684_0,,,,2,1,2,3
C1(C(C(C=O)=C(CO)C1)O)=O,,,5,1,1,0,1
63685_0,,,,2,1,2,3
63686_0,,,,2,1,2,3
63687_0,,,,2,1,2,3
63689_0,,,,2,1,2,3
C1(C(C(C(C1)=CC=O)O)O)=O,,,5,1,1,0,1
63691_0,,,,2,1,2,3
C(CC1C(C(C(C=1)=O)O)O)=O,,,5,1,1,0,1
63692_0,,,,2,1,2,3
63693_0,,,,2,1,2,3
63695_0,,,,2,1,2,3
C(C(C1CC(C(C=1)O)=O)O)=O,,,5,1,1,0,1
63696_0,,,,2,1,2,3
63698_0,,,,2,1,2,3
C(C(C1CC(C(C=1)=O)O)O)=O,,,5,1,1,0,1
63700_0,,,,2,1,2,3
C1(CC=CC1O)=O,,,5,1,1,0,1
63701_0,,,,2,1,2,3
63703_0,,,,2,1,2,3
C1CC(C(C=1)=O)O,,,5,1,1,0,1
63704_0,,,,2,1,2,3
63705_0,,,,2,1,2,3
63706_0,,,,2,1,2,3
63708_0,,,,2,1,2,3
C(C1(C(C(C(C1)O)=O)=C)O)=O,,,5,1,1,0,1
63710_0,,,,2,1,2,3
C(C1CC(C(C=1CO)=O)O)=O,,,5,1,1,0,1
63711_0,,,,2,1,2,3
63713_0,,,,2,1,2,3
C1(C(C=C(C=O)C1CO)O)=O,,,5,1,1,0,1
63714_0,,,,2,1,2,3
63715_0,,,,2,1,2,3
63717_0,,,,2,1,2,3
C1C(CC(C=1C(C=O)=O)O)O,,,5,1,1,0,1
63719_0,,,,2,1,2,3
C1CC(C(C=1C(C=O)=O)O)O,,,5,1,1,0,1
63721_0,,,,2,1,2,3
C(C1(C(C=O)=CC(C1)O)O)=O,,,5,1,2,0,2
63723_0,,,,2,1,2,3
C(C1CC(C(C=1C=O)O)O)=O,,,5,1,1,0,1
63724_0,,,,2,1,2,3
63726_0,,,,2,1,2,3
C(C1C(C=O)=CC(C1O)O)=O,,,5,1,1,0,1
63727_0,,,,2,1,2,3
63728_0,,,,2,1,2,3
63729_0,,,,2,1,2,3
63731_0,,,,2,1,2,3
C(C1CC(C(C(C=1)=O)O)O)=O,,,5,1,1,0,1
63732_0,,,,2,1,2,3
63734_0,,,,2,1,2,3
C1(C(C(C=C(C=O)C1)O)O)=O,,,5,1,1,0,1
63735_0,,,,2,1,2,3
63737_0,,,,2,1,2,3
C1(C(C(C=O)=CC1O)O)=O,,,5,1,2,0,2
63738_0,,,,2,1,2,3
63739_0,,,,2,1,2,3
63740_0,,,,2,1,2,3
63742_0,,,,2,1,2,3
C1(C(C(C=O)=CC1CO)O)=O,,,5,1,1,0,1
63743_0,,,,2,1,2,3
63744_0,,,,2,1,2,3
63745_0,,,,2,1,2,3
63746_0,,,,2,1,2,3
63747_0,,,,2,1,2,3
63748_0,,,,2,1,2,3
63749_0,,,,2,1,2,3
63750_0,,,,2,1,2,3
63751_0,,,,2,1,2,3
63752_0,,,,2,1,2,3
63754_0,,,,2,1,2,3
C1(C(C=CC1CO)O)=O,,,5,1,1,0,1
63755_0,,,,2,1,2,3
63757_0,,,,2,1,2,3
C1CC(C(C=1CO)=O)O,,,5,1,1,0,1
63759_0,,,,2,1,2,3
C=C1C(C(CC1O)O)=O,,,5,1,1,0,1
63761_0,,,,2,1,2,3
C(C1C(C(C(C=1CO)=O)O)O)=O,,,5,1,1,0,1
63763_0,,,,2,1,2,3
C(C1(C(C(C(C1O)O)=O)=C)O)=O,,,5,1,1,0,1
63764_0,,,,2,1,2,3
63765_0,,,,2,1,2,3
63767_0,,,,2,1,2,3
C1C(C(C(C=1CO)=O)O)O,,,5,1,1,0,1
63769_0,,,,2,1,2,3
C=C1C(C(C(C1O)O)O)=O,,,5,1,1,0,1
63770_0,,,,2,1,2,3
63772_0,,,,2,1,2,3
C1(C(C(C=O)=C(CO)C1O)O)=O,,,5,1,2,0,2
63773_0,,,,2,1,2,3
63774_0,,,,2,1,2,3
63775_0,,,,2,1,2,3
63777_0,,,,2,1,2,3
C1CC(C(C=1C=O)O)O,,,5,1,1,0,1
63779_0,,,,2,1,2,3
C1C(CC(C=1C=O)O)O,,,5,1,2,0,2
63781_0,,,,2,1,2,3
C(C1C(C(C(C=1C=O)O)O)O)=O,,,5,1,1,0,1
63783_0,,,,2,1,2,3
C(C1(C(C=O)=CC(C1O)O)O)=O,,,5,1,2,0,2
63784_0,,,,2,1,2,3
63785_0,,,,2,1,2,3
63786_0,,,,2,1,2,3
63787_0,,,,2,1,2,3
63789_0,,,,2,1,2,3
C(C(C1C(C(C(C=1)O)=O)O)O)=O,,,5,1,2,0,2
63790_0,,,,2,1,2,3
63791_0,,,,2,1,2,3
63792_0,,,,2,1,2,3
63793_0,,,,2,1,2,3
63794_0,,,,2,1,2,3
63796_0,,,,2,1,2,3
C1(C(C(C(CO)=O)=CC1O)O)=O,,,5,1,1,0,1
63797_0,,,,2,1,2,3
63798_0,,,,2,1,2,3
63799_0,,,,2,1,2,3
63800_0,,,,2,1,2,3
63801_0,,,,2,1,2,3
63802_0,,,,2,1,2,3
63803_0,,,,2,1,2,3
63804_0,,,,2,1,2,3
63805_0,,,,2,1,2,3
63806_0,,,,2,1,2,3
63807_0,,,,2,1,2,3
63808_0,,,,2,1,2,3
63809_0,,,,2,1,2,3
63811_0,,,,2,1,2,3
C1(C(C=CC1O)O)=O,,,5,1,1,0,1
63812_0,,,,2,1,2,3
63814_0,,,,2,1,2,3
C(C1(C=C(C=O)C(C1O)O)O)=O,,,5,1,1,0,1
63815_0,,,,2,1,2,3
63816_0,,,,2,1,2,3
63817_0,,,,2,1,2,3
63819_0,,,,2,1,2,3
C1(CO)C(CO)(C(C(C=1)=O)O)O,,,5,1,1,0,1
63820_0,,,,2,1,2,3
63821_0,,,,2,1,2,3
63822_0,,,,2,1,2,3
63823_0,,,,2,1,2,3
63824_0,,,,2,1,2,3
63825_0,,,,2,1,2,3
63826_0,,,,2,1,2,3
63827_0,,,,2,1,2,3
63828_0,,,,2,1,2,3
63829_0,,,,2,1,2,3
63830_0,,,,2,1,2,3
63832_0,,,,2,1,2,3
C1C(CO)(C(C(C=1)=O)O)O,,,5,1,1,0,1
63834_0,,,,2,1,2,3
C1C(C(CO)O)(C(C(C=1)=O)O)O,,,5,1,1,0,1
63835_0,,,,2,1,2,3
63836_0,,,,2,1,2,3
63837_0,,,,2,1,2,3
63838_0,,,,2,1,2,3
63840_0,,,,2,1,2,3
C1(C(C(C=O)=CC1(CO)O)O)=O,,,5,1,1,0,1
63842_0,,,,2,1,2,3
C1C(CO)(C(C(C=1CO)=O)O)O,,,5,1,1,0,1
63844_0,,,,2,1,2,3
C=C1C(C(C(CO)(C1O)O)O)=O,,,5,1,1,0,1
63845_0,,,,2,1,2,3
63846_0,,,,2,1,2,3
63847_0,,,,2,1,2,3
63848_0,,,,2,1,2,3
63849_0,,,,2,1,2,3
63850_0,,,,2,1,2,3
63852_0,,,,2,1,2,3
C(CC1(C=CC(C1O)=O)O)=O,,,5,1,1,0,1
63853_0,,,,2,1,2,3
63854_0,,,,2,1,2,3
63855_0,,,,2,1,2,3
63857_0,,,,2,1,2,3
C(C1(C=C(C=O)C(C1)O)O)=O,,,5,1,1,0,1
63859_0,,,,2,1,2,3
C(C1C(CC(C=1C=O)O)O)=O,,,5,1,1,0,1
63860_0,,,,2,1,2,3
63861_0,,,,2,1,2,3
63862_0,,,,2,1,2,3
63863_0,,,,2,1,2,3
63864_0,,,,2,1,2,3
63865_0,,,,2,1,2,3
63866_0,,,,2,1,2,3
63868_0,,,,2,1,2,3
C(CC(CO)(CO)O)=CC=O,,,5,1,1,0,1
63870_0,,,,2,1,2,3
C(CC=CC(CO)(CO)O)=O,,,5,1,1,0,1
63871_0,,,,2,1,2,3
63872_0,,,,2,1,2,3
63873_0,,,,2,1,2,3
63874_0,,,,2,1,2,3
63875_0,,,,2,1,2,3
63877_0,,,,2,1,2,3
C(C)=C(C=O)C(CO)(CO)O,,,5,1,1,0,1
63879_0,,,,2,1,2,3
C(CO)(CO)=C(C=O)C(C)O,,,5,1,1,0,1
63880_0,,,,2,1,2,3
63881_0,,,,2,1,2,3
63882_0,,,,2,1,2,3
63883_0,,,,2,1,2,3
63884_0,,,,2,1,2,3
63885_0,,,,2,1,2,3
63887_0,,,,2,1,2,3
C(CO)(C(C=C(C=O)CO)O)=O,,,5,1,1,0,1
63889_0,,,,2,1,2,3
C(CO)(C(C(C)O)O)=CC=O,,,5,1,1,0,1
63890_0,,,,2,1,2,3
63891_0,,,,2,1,2,3
63892_0,,,,2,1,2,3
63893_0,,,,2,1,2,3
63894_0,,,,2,1,2,3
63895_0,,,,2,1,2,3
63896_0,,,,2,1,2,3
63897_0,,,,2,1,2,3
63898_0,,,,2,1,2,3
63899_0,,,,2,1,2,3
63901_0,,,,2,1,2,3
C(C(CO)O)(C(CO)O)=CC=O,,,5,1,1,0,1
63903_0,,,,2,1,2,3
C(C(CC(C=O)=CC=O)O)(O)=O,,,5,1,1,0,1
63905_0,,,,2,1,2,3
C(C(C=C(C=O)CC=O)O)(O)=O,,,5,1,2,0,2
63906_0,,,,2,1,2,3
63907_0,,,,2,1,2,3
63908_0,,,,2,1,2,3
63910_0,,,,2,1,2,3
C(C(C(C(O)=O)=CC(O)=O)=O)=O,,,5,1,1,0,1
63911_0,,,,2,1,2,3
63913_0,,,,2,1,2,3
C(C(C(C(C=O)=O)=CC)O)(O)=O,,,5,1,1,0,1
63915_0,,,,2,1,2,3
C(C(C(C(C)O)=CC(O)=O)=O)=O,,,5,1,1,0,1
63916_0,,,,2,1,2,3
63917_0,,,,2,1,2,3
63918_0,,,,2,1,2,3
63920_0,,,,2,1,2,3
C(C(CC(C(C=O)=C)O)O)(O)=O,,,5,1,2,0,2
63922_0,,,,2,1,2,3
C(C(CC=C(C=O)CO)O)(O)=O,,,5,1,1,0,1
63924_0,,,,2,1,2,3
C(C(C=CC(C(O)=O)O)CO)=O,,,5,1,1,0,1
63925_0,,,,2,1,2,3
63926_0,,,,2,1,2,3
63927_0,,,,2,1,2,3
63928_0,,,,2,1,2,3
63929_0,,,,2,1,2,3
63930_0,,,,2,1,2,3
63931_0,,,,2,1,2,3
63932_0,,,,2,1,2,3
63933_0,,,,2,1,2,3
63934_0,,,,2,1,2,3
63935_0,,,,2,1,2,3
63936_0,,,,2,1,2,3
63937_0,,,,2,1,2,3
63938_0,,,,2,1,2,3
63939_0,,,,2,1,2,3
63940_0,,,,2,1,2,3
63941_0,,,,2,1,2,3
63942_0,,,,2,1,2,3
63944_0,,,,2,1,2,3
C(C(C=CCO)C(C(O)=O)O)=O,,,5,1,1,0,1
63946_0,,,,2,1,2,3
C(C(C(C=O)=CCCO)O)(O)=O,,,5,1,1,0,1
63948_0,,,,2,1,2,3
C(C=C(C=O)C(CCO)O)(O)=O,,,5,1,2,0,2
63950_0,,,,2,1,2,3
C(C(C(CO)=C)C(C(O)=O)O)=O,,,5,1,1,0,1
63952_0,,,,2,1,2,3
C(C(C(C=O)=C(CO)C)O)(O)=O,,,5,1,1,0,1
63954_0,,,,2,1,2,3
C(C=C(C=O)C(CO)(C)O)(O)=O,,,5,1,2,0,2
63955_0,,,,2,1,2,3
63957_0,,,,2,1,2,3
C(C(C(C=O)=CC(O)O)O)(O)=O,,,5,1,1,0,1
63959_0,,,,2,1,2,3
C(C=C(C=O)C(C(O)O)O)(O)=O,,,5,1,2,0,2
63960_0,,,,2,1,2,3
63962_0,,,,2,1,2,3
C(C(C(C=O)=CC(C)O)O)(O)=O,,,5,1,2,0,2
63964_0,,,,2,1,2,3
C(C=C(C=O)C(C(C)O)O)(O)=O,,,5,1,2,0,2
63965_0,,,,2,1,2,3
63966_0,,,,2,1,2,3
63967_0,,,,2,1,2,3
63968_0,,,,2,1,2,3
63969_0,,,,2,1,2,3
63970_0,,,,2,1,2,3
63971_0,,,,2,1,2,3
63972_0,,,,2,1,2,3
63973_0,,,,2,1,2,3
63974_0,,,,2,1,2,3
63975_0,,,,2,1,2,3
63976_0,,,,2,1,2,3
63977_0,,,,2,1,2,3
63979_0,,,,2,1,2,3
C=C(C=O)C(C(CO)(CO)O)O,,,5,1,2,0,2
63980_0,,,,2,1,2,3
63982_0,,,,2,1,2,3
C(C(C)(CC(C=O)=CC=O)O)=O,,,5,1,1,0,1
63984_0,,,,2,1,2,3
C(C(C=C(C=O)CC=O)(C)O)=O,,,5,1,1,0,1
63985_0,,,,2,1,2,3
63986_0,,,,2,1,2,3
63987_0,,,,2,1,2,3
63988_0,,,,2,1,2,3
63989_0,,,,2,1,2,3
63990_0,,,,2,1,2,3
63991_0,,,,2,1,2,3
63992_0,,,,2,1,2,3
63994_0,,,,2,1,2,3
C(C(C(C(O)=O)=C(C=O)C)=O)=O,,,5,1,1,0,1
63995_0,,,,2,1,2,3
63996_0,,,,2,1,2,3
63998_0,,,,2,1,2,3
C(C(C(C(C=O)=O)=CC)(C)O)=O,,,5,1,1,0,1
64000_0,,,,2,1,2,3
C(C(C(C(C)O)=C(C=O)C)=O)=O,,,5,1,1,0,1
64001_0,,,,2,1,2,3
64002_0,,,,2,1,2,3
64004_0,,,,2,1,2,3
C(C(C(C=O)=CCC=O)(C)O)=O,,,5,1,1,0,1
64005_0,,,,2,1,2,3
64006_0,,,,2,1,2,3
64007_0,,,,2,1,2,3
64008_0,,,,2,1,2,3
64009_0,,,,2,1,2,3
64011_0,,,,2,1,2,3
C(C(C)(CC(C(C=O)=C)O)O)=O,,,5,1,2,0,2
64013_0,,,,2,1,2,3
C(C(C)(CC=C(C=O)CO)O)=O,,,5,1,1,0,1
64015_0,,,,2,1,2,3
C(C(C=CC(C=O)(C)O)CO)=O,,,5,1,1,0,1
64016_0,,,,2,1,2,3
64017_0,,,,2,1,2,3
64019_0,,,,2,1,2,3
C(C(C=CC(C(C)=O)O)(C)O)=O,,,5,1,2,0,2
64020_0,,,,2,1,2,3
64021_0,,,,2,1,2,3
64023_0,,,,2,1,2,3
C(C(C)(CC=CC(CO)=O)O)=O,,,5,1,1,0,1
64025_0,,,,2,1,2,3
C(C(C=CCC(CO)=O)(C)O)=O,,,5,1,1,0,1
64026_0,,,,2,1,2,3
64027_0,,,,2,1,2,3
64029_0,,,,2,1,2,3
C(C(C)(CC=CC(C=O)=O)O)=O,,,5,1,1,0,1
64031_0,,,,2,1,2,3
C(C(C=CCC(C=O)=O)(C)O)=O,,,5,1,1,0,1
64032_0,,,,2,1,2,3
64033_0,,,,2,1,2,3
64035_0,,,,2,1,2,3
C(C(C)(CC=C(C=O)C=O)O)=O,,,5,1,1,0,1
64037_0,,,,2,1,2,3
C(C(C=O)C=CC(C=O)(C)O)=O,,,5,1,1,0,1
64038_0,,,,2,1,2,3
64039_0,,,,2,1,2,3
64041_0,,,,2,1,2,3
C(C(C)(CC=CC=O)O)=O,,,5,1,1,0,1
64043_0,,,,2,1,2,3
C(C(C=CCC=O)(C)O)=O,,,5,1,1,0,1
64044_0,,,,2,1,2,3
64045_0,,,,2,1,2,3
64047_0,,,,2,1,2,3
C(C(C=CC(C=O)O)(C)O)=O,,,5,1,2,0,2
64048_0,,,,2,1,2,3
64049_0,,,,2,1,2,3
64051_0,,,,2,1,2,3
C(CC(C)(C(C(C=O)=C)O)O)=O,,,5,1,2,0,2
64053_0,,,,2,1,2,3
C(CC(C=C(C=O)CO)(C)O)=O,,,5,1,1,0,1
64054_0,,,,2,1,2,3
64055_0,,,,2,1,2,3
64056_0,,,,2,1,2,3
64057_0,,,,2,1,2,3
64059_0,,,,2,1,2,3
C(CC(C=CC(CO)=O)(C)O)=O,,,5,1,1,0,1
64060_0,,,,2,1,2,3
64061_0,,,,2,1,2,3
64062_0,,,,2,1,2,3
64063_0,,,,2,1,2,3
64064_0,,,,2,1,2,3
64065_0,,,,2,1,2,3
64066_0,,,,2,1,2,3
64067_0,,,,2,1,2,3
64068_0,,,,2,1,2,3
64069_0,,,,2,1,2,3
64070_0,,,,2,1,2,3
64071_0,,,,2,1,2,3
64072_0,,,,2,1,2,3
64073_0,,,,2,1,2,3
64075_0,,,,2,1,2,3
C(C(C)(C(C=O)C=CCO)O)=O,,,5,1,1,0,1
64077_0,,,,2,1,2,3
C(C(C(C=O)=CCCO)(C)O)=O,,,5,1,1,0,1
64079_0,,,,2,1,2,3
C(C(C(CCO)O)=C(C=O)C)=O,,,5,1,1,0,1
64080_0,,,,2,1,2,3
64082_0,,,,2,1,2,3
C(C(C)(C(C=O)C(CO)=C)O)=O,,,5,1,1,0,1
64084_0,,,,2,1,2,3
C(C(C(C=O)=C(CO)C)(C)O)=O,,,5,1,1,0,1
64086_0,,,,2,1,2,3
C(C(C(CO)(C)O)=C(C=O)C)=O,,,5,1,1,0,1
64087_0,,,,2,1,2,3
64088_0,,,,2,1,2,3
64089_0,,,,2,1,2,3
64091_0,,,,2,1,2,3
C(C(C(C=O)=CC(O)O)(C)O)=O,,,5,1,1,0,1
64093_0,,,,2,1,2,3
C(C(C(C(O)O)O)=C(C=O)C)=O,,,5,1,1,0,1
64094_0,,,,2,1,2,3
64095_0,,,,2,1,2,3
64097_0,,,,2,1,2,3
C(C(C(C=O)=CC(C)O)(C)O)=O,,,5,1,2,0,2
64099_0,,,,2,1,2,3
C(C(C(C(C)O)O)=C(C=O)C)=O,,,5,1,1,0,1
64100_0,,,,2,1,2,3
64101_0,,,,2,1,2,3
64103_0,,,,2,1,2,3
C(C(C(C=O)=C(C=O)C)(C)O)=O,,,5,1,1,0,1
64105_0,,,,2,1,2,3
C(C(C(C=O)=CC(C)=O)(C)O)=O,,,5,1,1,0,1
64107_0,,,,2,1,2,3
C(C)(C(C(C=O)=C(C=O)C)O)=O,,,5,1,1,0,1
64108_0,,,,2,1,2,3
64109_0,,,,2,1,2,3
64111_0,,,,2,1,2,3
C(C(C(C=O)=CC)(C)O)=O,,,5,1,1,0,1
64113_0,,,,2,1,2,3
C(C(C(C)O)=C(C=O)C)=O,,,5,1,1,0,1
64114_0,,,,2,1,2,3
64116_0,,,,2,1,2,3
C(C(C(C=O)=C)(C)O)=O,,,5,1,3,0,3
64117_0,,,,2,1,2,3
64118_0,,,,2,1,2,3
64119_0,,,,2,1,2,3
64120_0,,,,2,1,2,3
64121_0,,,,2,1,2,3
64122_0,,,,2,1,2,3
64123_0,,,,2,1,2,3
64124_0,,,,2,1,2,3
64125_0,,,,2,1,2,3
64126_0,,,,2,1,2,3
64127_0,,,,2,1,2,3
64129_0,,,,2,1,2,3
C(C)(C(CC(C=O)=CC=O)O)=O,,,5,1,1,0,1
64131_0,,,,2,1,2,3
C(CC(C=O)=CC(C(C)=O)O)=O,,,5,1,2,0,2
64132_0,,,,2,1,2,3
64133_0,,,,2,1,2,3
64134_0,,,,2,1,2,3
64136_0,,,,2,1,2,3
C(C(C(C(O)=O)=CC(C)=O)=O)=O,,,5,1,1,0,1
64137_0,,,,2,1,2,3
64139_0,,,,2,1,2,3
C(C)(C(C(C(C=O)=O)=CC)O)=O,,,5,1,1,0,1
64141_0,,,,2,1,2,3
C(C(C(C(C)O)=CC(C)=O)=O)=O,,,5,1,1,0,1
64142_0,,,,2,1,2,3
64143_0,,,,2,1,2,3
64144_0,,,,2,1,2,3
64145_0,,,,2,1,2,3
64146_0,,,,2,1,2,3
64148_0,,,,2,1,2,3
C(CC=C(C=O)C(C(C)=O)O)=O,,,5,1,1,0,1
64149_0,,,,2,1,2,3
64150_0,,,,2,1,2,3
64151_0,,,,2,1,2,3
64152_0,,,,2,1,2,3
64153_0,,,,2,1,2,3
64155_0,,,,2,1,2,3
C(C)(C(CC(C(C=O)=C)O)O)=O,,,5,1,2,0,2
64157_0,,,,2,1,2,3
C(C)(C(CC=C(C=O)CO)O)=O,,,5,1,1,0,1
64159_0,,,,2,1,2,3
C(C(C=CC(C(C)=O)O)CO)=O,,,5,1,1,0,1
64160_0,,,,2,1,2,3
64162_0,,,,2,1,2,3
C(C)(C(C=CC(C(C)=O)O)O)=O,,,5,1,1,0,1
64163_0,,,,2,1,2,3
64165_0,,,,2,1,2,3
C(C)(C(CC=CC(CO)=O)O)=O,,,5,1,1,0,1
64167_0,,,,2,1,2,3
C(CO)(CC=CC(C(C)=O)O)=O,,,5,1,1,0,1
64168_0,,,,2,1,2,3
64170_0,,,,2,1,2,3
C(C)(C(CC=CC(C=O)=O)O)=O,,,5,1,1,0,1
64172_0,,,,2,1,2,3
C(C)(C(C=CCC(C=O)=O)O)=O,,,5,1,2,0,2
64173_0,,,,2,1,2,3
64175_0,,,,2,1,2,3
C(C)(C(CC=C(C=O)C=O)O)=O,,,5,1,1,0,1
64177_0,,,,2,1,2,3
C(C(C=O)C=CC(C(C)=O)O)=O,,,5,1,1,0,1
64178_0,,,,2,1,2,3
64180_0,,,,2,1,2,3
C(C)(C(CC=CC=O)O)=O,,,5,1,1,0,1
64182_0,,,,2,1,2,3
C(CC=CC(C(C)=O)O)=O,,,5,1,1,0,1
64183_0,,,,2,1,2,3
64185_0,,,,2,1,2,3
C(C(C=CC(C(C)=O)O)O)=O,,,5,1,3,0,3
64186_0,,,,2,1,2,3
64188_0,,,,2,1,2,3
C(CC(C(C(C=O)=C)(C)O)O)=O,,,5,1,2,0,2
64190_0,,,,2,1,2,3
C(CC(C(C)=C(C=O)CO)O)=O,,,5,1,1,0,1
64191_0,,,,2,1,2,3
64193_0,,,,2,1,2,3
C(CC(C(C(C=O)CO)=C)O)=O,,,5,1,1,0,1
64194_0,,,,2,1,2,3
64196_0,,,,2,1,2,3
C(CC(C(C(C(C)=O)O)=C)O)=O,,,5,1,1,0,1
64198_0,,,,2,1,2,3
C(CC(C(C)=CC(CO)=O)O)=O,,,5,1,1,0,1
64199_0,,,,2,1,2,3
64201_0,,,,2,1,2,3
C(CC(C(CC(CO)=O)=C)O)=O,,,5,1,1,0,1
64202_0,,,,2,1,2,3
64204_0,,,,2,1,2,3
C(C(C=CCO)C(C(C)=O)O)=O,,,5,1,1,0,1
64206_0,,,,2,1,2,3
C(C)(C(C(C=O)=CCCO)O)=O,,,5,1,1,0,1
64208_0,,,,2,1,2,3
C(C(C(CCO)O)=CC(C)=O)=O,,,5,1,1,0,1
64210_0,,,,2,1,2,3
C(C(C(CO)=C)C(C(C)=O)O)=O,,,5,1,1,0,1
64212_0,,,,2,1,2,3
C(C)(C(C(C=O)=C(CO)C)O)=O,,,5,1,1,0,1
64214_0,,,,2,1,2,3
C(C(C(CO)(C)O)=CC(C)=O)=O,,,5,1,1,0,1
64215_0,,,,2,1,2,3
64217_0,,,,2,1,2,3
C(C)(C(C(C=O)=CC(O)O)O)=O,,,5,1,1,0,1
64219_0,,,,2,1,2,3
C(C(C(C(O)O)O)=CC(C)=O)=O,,,5,1,1,0,1
64220_0,,,,2,1,2,3
64222_0,,,,2,1,2,3
C(C)(C(C(C=O)=CC(C)O)O)=O,,,5,1,2,0,2
64224_0,,,,2,1,2,3
C(C(C(C(C)O)O)=CC(C)=O)=O,,,5,1,1,0,1
64226_0,,,,2,1,2,3
C(C)(C(C(C=O)=CC(C)=O)O)=O,,,5,1,1,0,1
64227_0,,,,2,1,2,3
64229_0,,,,2,1,2,3
C(C)(C(C(C=O)=CC)O)=O,,,5,1,1,0,1
64231_0,,,,2,1,2,3
C(C(C(C)O)=CC(C)=O)=O,,,5,1,1,0,1
64233_0,,,,2,1,2,3
C(C)(C(C(C=O)=C)O)=O,,,5,1,3,0,3
64234_0,,,,2,1,2,3
64235_0,,,,2,1,2,3
64236_0,,,,2,1,2,3
64237_0,,,,2,1,2,3
64239_0,,,,2,1,2,3
C(CC(C(CC=CCO)=O)O)=O,,,5,1,1,0,1
64240_0,,,,2,1,2,3
64242_0,,,,2,1,2,3
C(CC(C(C=CCCO)=O)O)=O,,,5,1,1,0,1
64244_0,,,,2,1,2,3
C(CC(C(CC(CO)=C)=O)O)=O,,,5,1,1,0,1
64245_0,,,,2,1,2,3
64247_0,,,,2,1,2,3
C(CC(C(C=C(C)CO)=O)O)=O,,,5,1,1,0,1
64248_0,,,,2,1,2,3
64249_0,,,,2,1,2,3
64251_0,,,,2,1,2,3
C(CC(C(C=CC(O)O)=O)O)=O,,,5,1,1,0,1
64252_0,,,,2,1,2,3
64253_0,,,,2,1,2,3
64255_0,,,,2,1,2,3
C(CC(C(C=CC(C)O)=O)O)=O,,,5,1,1,0,1
64256_0,,,,2,1,2,3
64257_0,,,,2,1,2,3
64258_0,,,,2,1,2,3
64259_0,,,,2,1,2,3
64260_0,,,,2,1,2,3
64261_0,,,,2,1,2,3
64262_0,,,,2,1,2,3
64263_0,,,,2,1,2,3
64264_0,,,,2,1,2,3
64265_0,,,,2,1,2,3
64266_0,,,,2,1,2,3
64267_0,,,,2,1,2,3
64268_0,,,,2,1,2,3
64269_0,,,,2,1,2,3
64270_0,,,,2,1,2,3
64271_0,,,,2,1,2,3
64272_0,,,,2,1,2,3
64273_0,,,,2,1,2,3
64274_0,,,,2,1,2,3
64276_0,,,,2,1,2,3
C(CC(CC(C=O)=CC=O)O)=O,,,5,1,1,0,1
64277_0,,,,2,1,2,3
64278_0,,,,2,1,2,3
64280_0,,,,2,1,2,3
C(CC(C=O)=CC(CC=O)O)=O,,,5,1,2,0,2
64282_0,,,,2,1,2,3
C(CC(C=O)=O)=C(C=O)C(O)=O,,,5,1,1,0,1
64283_0,,,,2,1,2,3
64284_0,,,,2,1,2,3
64285_0,,,,2,1,2,3
64287_0,,,,2,1,2,3
C(CC(C=O)=O)=C(C=O)C(C)O,,,5,1,2,0,2
64288_0,,,,2,1,2,3
64289_0,,,,2,1,2,3
64291_0,,,,2,1,2,3
C(CC(C=O)=O)=C(C=O)CO,,,5,1,2,0,2
64292_0,,,,2,1,2,3
64293_0,,,,2,1,2,3
64295_0,,,,2,1,2,3
C(CC=C(C(O)=O)C(C=O)=O)=O,,,5,1,1,0,1
64296_0,,,,2,1,2,3
64297_0,,,,2,1,2,3
64299_0,,,,2,1,2,3
C(CC(C(C(C=O)=O)=CC)O)=O,,,5,1,1,0,1
64301_0,,,,2,1,2,3
C(CC=C(C(C=O)=O)C(C)O)=O,,,5,1,1,0,1
64303_0,,,,2,1,2,3
C(C(C(C=O)=C)(CC(C)O)O)=O,,,5,1,2,0,2
64305_0,,,,2,1,2,3
C(C(CC(C)O)=C(C=O)CO)=O,,,5,1,1,0,1
64306_0,,,,2,1,2,3
64307_0,,,,2,1,2,3
64309_0,,,,2,1,2,3
C(C(C(C=O)=CC(C)O)CO)=O,,,5,1,1,0,1
64310_0,,,,2,1,2,3
64311_0,,,,2,1,2,3
64312_0,,,,2,1,2,3
64314_0,,,,2,1,2,3
C(C(CC(C)O)=CC(CO)=O)=O,,,5,1,1,0,1
64315_0,,,,2,1,2,3
64316_0,,,,2,1,2,3
64318_0,,,,2,1,2,3
C(CO)(CC(C=O)=CC(C)O)=O,,,5,1,1,0,1
64320_0,,,,2,1,2,3
C(C(C=C(C=O)CC(C)O)=O)=O,,,5,1,1,0,1
64321_0,,,,2,1,2,3
64322_0,,,,2,1,2,3
64324_0,,,,2,1,2,3
C(C(C)O)=C(C=O)CC(C=O)=O,,,5,1,1,0,1
64326_0,,,,2,1,2,3
C(C(C=O)=C(C=O)CC(C)O)=O,,,5,1,1,0,1
64327_0,,,,2,1,2,3
64328_0,,,,2,1,2,3
64330_0,,,,2,1,2,3
C(C(C=O)C(C=O)=CC(C)O)=O,,,5,1,1,0,1
64332_0,,,,2,1,2,3
C(C=C(C=O)CC(C)O)=O,,,5,1,1,0,1
64333_0,,,,2,1,2,3
64334_0,,,,2,1,2,3
64336_0,,,,2,1,2,3
C(CC(C=O)=CC(C)O)=O,,,5,1,1,0,1
64337_0,,,,2,1,2,3
64338_0,,,,2,1,2,3
64340_0,,,,2,1,2,3
C(C(C(C=O)=CC(C)O)O)=O,,,5,1,2,0,2
64342_0,,,,2,1,2,3
C(CC(C)O)(C(C(C=O)=C)O)=O,,,5,1,2,0,2
64344_0,,,,2,1,2,3
C(C=C(C=O)CO)(CC(C)O)=O,,,5,1,1,0,1
64345_0,,,,2,1,2,3
64346_0,,,,2,1,2,3
64347_0,,,,2,1,2,3
64348_0,,,,2,1,2,3
64350_0,,,,2,1,2,3
C(C=CC(CO)=O)(CC(C)O)=O,,,5,1,1,0,1
64351_0,,,,2,1,2,3
64352_0,,,,2,1,2,3
64353_0,,,,2,1,2,3
64355_0,,,,2,1,2,3
C(C(C(C=O)=O)C(C)O)=CCO,,,5,1,1,0,1
64356_0,,,,2,1,2,3
64358_0,,,,2,1,2,3
C(CCO)=C(C(C=O)=O)C(C)O,,,5,1,1,0,1
64360_0,,,,2,1,2,3
C(C)=C(C(C=O)=O)C(CCO)O,,,5,1,1,0,1
64362_0,,,,2,1,2,3
C=C(CO)C(C(C=O)=O)C(C)O,,,5,1,1,0,1
64363_0,,,,2,1,2,3
64365_0,,,,2,1,2,3
C(CO)(C)=C(C(C=O)=O)C(C)O,,,5,1,1,0,1
64367_0,,,,2,1,2,3
C(C)=C(C(C=O)=O)C(CO)(C)O,,,5,1,1,0,1
64368_0,,,,2,1,2,3
64370_0,,,,2,1,2,3
C(C)=C(C(O)=O)C(C=O)=O,,,5,1,1,0,1
64371_0,,,,2,1,2,3
64373_0,,,,2,1,2,3
C(C(O)O)=C(C(C=O)=O)C(C)O,,,5,1,1,0,1
64375_0,,,,2,1,2,3
C(C)=C(C(C=O)=O)C(C(O)O)O,,,5,1,1,0,1
64376_0,,,,2,1,2,3
64377_0,,,,2,1,2,3
64379_0,,,,2,1,2,3
C(C(C)O)=C(C(C=O)=O)C(C)O,,,5,1,1,0,1
64381_0,,,,2,1,2,3
C(C)=C(C(C=O)=O)C(C(C)O)O,,,5,1,1,0,1
64382_0,,,,2,1,2,3
64384_0,,,,2,1,2,3
C(C(C(C(C)O)=CC=O)=O)=O,,,5,1,1,0,1
64386_0,,,,2,1,2,3
C(C(C(C(C=O)=O)=CC)O)=O,,,5,1,1,0,1
64387_0,,,,2,1,2,3
64389_0,,,,2,1,2,3
C(C)=C(C(C=O)=O)C(C)O,,,5,1,1,0,1
64390_0,,,,2,1,2,3
64392_0,,,,2,1,2,3
C(CO)=C(C(C=O)=O)C(C)O,,,5,1,1,0,1
64394_0,,,,2,1,2,3
C(C)=C(C(C=O)=O)C(CO)O,,,5,1,1,0,1
64396_0,,,,2,1,2,3
C(C(CC(C=O)=CC=O)O)=O,,,5,1,1,0,1
64397_0,,,,2,1,2,3
64399_0,,,,2,1,2,3
C(CC(C=O)=CC(C=O)O)=O,,,5,1,3,0,3
64400_0,,,,2,1,2,3
64401_0,,,,2,1,2,3
64403_0,,,,2,1,2,3
C(C(C(C(O)=O)=CC=O)=O)=O,,,5,1,1,0,1
64405_0,,,,2,1,2,3
C(C(C(C(C=O)=O)=CC=O)O)=O,,,5,1,1,0,1
64407_0,,,,2,1,2,3
C(C(C(C(C=O)=O)=CCO)O)=O,,,5,1,1,0,1
64409_0,,,,2,1,2,3
C(C(C(C(CO)O)=CC=O)=O)=O,,,5,1,1,0,1
64411_0,,,,2,1,2,3
C(C=C(C=O)CC(CO)O)=O,,,5,1,1,0,1
64412_0,,,,2,1,2,3
64414_0,,,,2,1,2,3
C(CC(C=O)=CC(CO)O)=O,,,5,1,2,0,2
64415_0,,,,2,1,2,3
64416_0,,,,2,1,2,3
64417_0,,,,2,1,2,3
64419_0,,,,2,1,2,3
C(CO)=C(C(C=O)=O)C(CO)O,,,5,1,1,0,1
64420_0,,,,2,1,2,3
64421_0,,,,2,1,2,3
64422_0,,,,2,1,2,3
64423_0,,,,2,1,2,3
64424_0,,,,2,1,2,3
64425_0,,,,2,1,2,3
64426_0,,,,2,1,2,3
64428_0,,,,2,1,2,3
C(C(C=O)C=C(C=O)C(O)=O)=O,,,5,1,1,0,1
64429_0,,,,2,1,2,3
64430_0,,,,2,1,2,3
64431_0,,,,2,1,2,3
64433_0,,,,2,1,2,3
C(C(C=O)C=C(C=O)C(C)O)=O,,,5,1,1,0,1
64434_0,,,,2,1,2,3
64435_0,,,,2,1,2,3
64437_0,,,,2,1,2,3
C(C(C=O)C=C(C=O)CO)=O,,,5,1,1,0,1
64439_0,,,,2,1,2,3
C(CC(CC(C(C=O)=C)O)O)=O,,,5,1,2,0,2
64441_0,,,,2,1,2,3
C(CC(CC=C(C=O)CO)O)=O,,,5,1,1,0,1
64443_0,,,,2,1,2,3
C(CC(C=CC(C=O)CO)O)=O,,,5,1,1,0,1
64444_0,,,,2,1,2,3
64445_0,,,,2,1,2,3
64446_0,,,,2,1,2,3
64447_0,,,,2,1,2,3
64448_0,,,,2,1,2,3
64449_0,,,,2,1,2,3
64450_0,,,,2,1,2,3
64451_0,,,,2,1,2,3
64452_0,,,,2,1,2,3
64453_0,,,,2,1,2,3
64454_0,,,,2,1,2,3
64455_0,,,,2,1,2,3
64456_0,,,,2,1,2,3
64457_0,,,,2,1,2,3
64458_0,,,,2,1,2,3
64460_0,,,,2,1,2,3
C(CC(C(C=O)C=CCO)O)=O,,,5,1,1,0,1
64462_0,,,,2,1,2,3
C(CC(C(C=O)=CCCO)O)=O,,,5,1,1,0,1
64464_0,,,,2,1,2,3
C(CC=C(C=O)C(CCO)O)=O,,,5,1,1,0,1
64465_0,,,,2,1,2,3
64467_0,,,,2,1,2,3
C(CC(C(C=O)C(CO)=C)O)=O,,,5,1,1,0,1
64469_0,,,,2,1,2,3
C(CC(C(C=O)=C(C)CO)O)=O,,,5,1,1,0,1
64471_0,,,,2,1,2,3
C(CC=C(C=O)C(CO)(C)O)=O,,,5,1,1,0,1
64472_0,,,,2,1,2,3
64473_0,,,,2,1,2,3
64474_0,,,,2,1,2,3
64476_0,,,,2,1,2,3
C(CC(C(C=O)=CC(O)O)O)=O,,,5,1,1,0,1
64478_0,,,,2,1,2,3
C(CC=C(C=O)C(C(O)O)O)=O,,,5,1,1,0,1
64479_0,,,,2,1,2,3
64480_0,,,,2,1,2,3
64482_0,,,,2,1,2,3
C(CC(C(C=O)=CC(C)O)O)=O,,,5,1,1,0,1
64484_0,,,,2,1,2,3
C(CC=C(C=O)C(C(C)O)O)=O,,,5,1,1,0,1
64485_0,,,,2,1,2,3
64486_0,,,,2,1,2,3
64487_0,,,,2,1,2,3
64489_0,,,,2,1,2,3
C(CC=C(C=O)C(C)O)=O,,,5,1,1,0,1
64490_0,,,,2,1,2,3
64491_0,,,,2,1,2,3
64492_0,,,,2,1,2,3
64493_0,,,,2,1,2,3
64494_0,,,,2,1,2,3
64495_0,,,,2,1,2,3
64496_0,,,,2,1,2,3
64497_0,,,,2,1,2,3
64498_0,,,,2,1,2,3
64499_0,,,,2,1,2,3
64500_0,,,,2,1,2,3
64501_0,,,,2,1,2,3
64503_0,,,,2,1,2,3
C(C(C=C(C(O)=O)C=O)O)=O,,,5,1,1,0,1
64504_0,,,,2,1,2,3
64505_0,,,,2,1,2,3
64506_0,,,,2,1,2,3
64507_0,,,,2,1,2,3
64509_0,,,,2,1,2,3
C(C(C=C(C=O)C(C)O)O)=O,,,5,1,1,0,1
64510_0,,,,2,1,2,3
64511_0,,,,2,1,2,3
64512_0,,,,2,1,2,3
64514_0,,,,2,1,2,3
C(C(C=C(C=O)C(CO)O)O)=O,,,5,1,3,0,3
64515_0,,,,2,1,2,3
64517_0,,,,2,1,2,3
C(C(C=C(C=O)CO)C(C)O)=O,,,5,1,1,0,1
64518_0,,,,2,1,2,3
64519_0,,,,2,1,2,3
64521_0,,,,2,1,2,3
C(C(C=C(C=O)C(C)O)CO)=O,,,5,1,1,0,1
64522_0,,,,2,1,2,3
64523_0,,,,2,1,2,3
64525_0,,,,2,1,2,3
C(C)(C(C=C(C=O)C(C)O)O)=O,,,5,1,1,0,1
64526_0,,,,2,1,2,3
64527_0,,,,2,1,2,3
64528_0,,,,2,1,2,3
64530_0,,,,2,1,2,3
C(CO)(CC=C(C=O)C(C)O)=O,,,5,1,1,0,1
64531_0,,,,2,1,2,3
64533_0,,,,2,1,2,3
C(C(C=C(C=O)CO)CO)=O,,,5,1,1,0,1
64534_0,,,,2,1,2,3
64535_0,,,,2,1,2,3
64536_0,,,,2,1,2,3
64537_0,,,,2,1,2,3
64538_0,,,,2,1,2,3
64540_0,,,,2,1,2,3
C(C(C=CC(C(O)=O)=O)CO)=O,,,5,1,1,0,1
64541_0,,,,2,1,2,3
64543_0,,,,2,1,2,3
C(CC(C(O)=O)=O)=C(C=O)CO,,,5,1,1,0,1
64545_0,,,,2,1,2,3
C(C(C=C(C(O)=O)C=O)CO)=O,,,5,1,1,0,1
64546_0,,,,2,1,2,3
64548_0,,,,2,1,2,3
C(C(C=O)C=C(C=O)CO)(O)=O,,,5,1,1,0,1
64550_0,,,,2,1,2,3
C(C(CCO)(CC=CC=O)O)=O,,,5,1,1,0,1
64552_0,,,,2,1,2,3
C(C(C=CCC=O)(CCO)O)=O,,,5,1,1,0,1
64553_0,,,,2,1,2,3
64554_0,,,,2,1,2,3
64555_0,,,,2,1,2,3
64556_0,,,,2,1,2,3
64557_0,,,,2,1,2,3
64558_0,,,,2,1,2,3
64559_0,,,,2,1,2,3
64560_0,,,,2,1,2,3
64561_0,,,,2,1,2,3
64562_0,,,,2,1,2,3
64563_0,,,,2,1,2,3
64565_0,,,,2,1,2,3
C(C(C(C=O)=CC)(CCO)O)=O,,,5,1,1,0,1
64567_0,,,,2,1,2,3
C(C(CCO)=C(C=O)C(C)O)=O,,,5,1,1,0,1
64568_0,,,,2,1,2,3
64569_0,,,,2,1,2,3
64570_0,,,,2,1,2,3
64571_0,,,,2,1,2,3
64572_0,,,,2,1,2,3
64573_0,,,,2,1,2,3
64575_0,,,,2,1,2,3
C(C(CC=CC=O)O)(CCO)=O,,,5,1,1,0,1
64577_0,,,,2,1,2,3
C(CC=CC(C(CCO)=O)O)=O,,,5,1,1,0,1
64578_0,,,,2,1,2,3
64579_0,,,,2,1,2,3
64580_0,,,,2,1,2,3
64581_0,,,,2,1,2,3
64582_0,,,,2,1,2,3
64584_0,,,,2,1,2,3
C(CCO)(C(C(C=O)=CC)O)=O,,,5,1,1,0,1
64586_0,,,,2,1,2,3
C(C=C(C=O)C(C)O)(CCO)=O,,,5,1,1,0,1
64587_0,,,,2,1,2,3
64588_0,,,,2,1,2,3
64589_0,,,,2,1,2,3
64590_0,,,,2,1,2,3
64591_0,,,,2,1,2,3
64593_0,,,,2,1,2,3
C(CC(C(C(C(O)=O)=C)=O)O)=O,,,5,1,1,0,1
64594_0,,,,2,1,2,3
64595_0,,,,2,1,2,3
64596_0,,,,2,1,2,3
64597_0,,,,2,1,2,3
64598_0,,,,2,1,2,3
64599_0,,,,2,1,2,3
64600_0,,,,2,1,2,3
64602_0,,,,2,1,2,3
C(C=C(C=O)C(CO)C(C)O)=O,,,5,1,1,0,1
64603_0,,,,2,1,2,3
64604_0,,,,2,1,2,3
64606_0,,,,2,1,2,3
C(CC(C=O)=C(CO)C(C)O)=O,,,5,1,1,0,1
64607_0,,,,2,1,2,3
64609_0,,,,2,1,2,3
C(C=C(C=O)C(CO)CO)=O,,,5,1,1,0,1
64610_0,,,,2,1,2,3
64612_0,,,,2,1,2,3
C(CC(C=O)=C(CO)CO)=O,,,5,1,2,0,2
64613_0,,,,2,1,2,3
64614_0,,,,2,1,2,3
64615_0,,,,2,1,2,3
64616_0,,,,2,1,2,3
64617_0,,,,2,1,2,3
64618_0,,,,2,1,2,3
64619_0,,,,2,1,2,3
64620_0,,,,2,1,2,3
64621_0,,,,2,1,2,3
64622_0,,,,2,1,2,3
64623_0,,,,2,1,2,3
64624_0,,,,2,1,2,3
64625_0,,,,2,1,2,3
64626_0,,,,2,1,2,3
64627_0,,,,2,1,2,3
64629_0,,,,2,1,2,3
C(C(CC(CC=CC=O)O)O)=O,,,5,1,1,0,1
64631_0,,,,2,1,2,3
C(CC=CC(CC(C=O)O)O)=O,,,5,1,1,0,1
64632_0,,,,2,1,2,3
64633_0,,,,2,1,2,3
64634_0,,,,2,1,2,3
64635_0,,,,2,1,2,3
64636_0,,,,2,1,2,3
64637_0,,,,2,1,2,3
64638_0,,,,2,1,2,3
64640_0,,,,2,1,2,3
C(C(CC(C(C=O)=CC)O)O)=O,,,5,1,1,0,1
64642_0,,,,2,1,2,3
C(C(CC=C(C=O)C(C)O)O)=O,,,5,1,1,0,1
64643_0,,,,2,1,2,3
64644_0,,,,2,1,2,3
64646_0,,,,2,1,2,3
C(C(CC(C(C=O)=C)O)O)=O,,,5,1,2,0,2
64647_0,,,,2,1,2,3
64648_0,,,,2,1,2,3
64649_0,,,,2,1,2,3
64651_0,,,,2,1,2,3
C(C(C(C=CC=O)C(C)O)O)=O,,,5,1,1,0,1
64652_0,,,,2,1,2,3
64653_0,,,,2,1,2,3
64654_0,,,,2,1,2,3
64656_0,,,,2,1,2,3
C(CC=C(C(C)O)C(C=O)O)=O,,,5,1,1,0,1
64657_0,,,,2,1,2,3
64658_0,,,,2,1,2,3
64659_0,,,,2,1,2,3
64660_0,,,,2,1,2,3
64661_0,,,,2,1,2,3
64662_0,,,,2,1,2,3
64664_0,,,,2,1,2,3
C(C(C=C(CO)C(C=O)O)O)=O,,,5,1,2,0,2
64665_0,,,,2,1,2,3
64666_0,,,,2,1,2,3
64667_0,,,,2,1,2,3
64668_0,,,,2,1,2,3
64669_0,,,,2,1,2,3
64670_0,,,,2,1,2,3
64671_0,,,,2,1,2,3
64672_0,,,,2,1,2,3
64673_0,,,,2,1,2,3
64674_0,,,,2,1,2,3
64675_0,,,,2,1,2,3
64677_0,,,,2,1,2,3
C(CC=C(C(CO)=O)C(C)O)=O,,,5,1,1,0,1
64678_0,,,,2,1,2,3
64679_0,,,,2,1,2,3
64680_0,,,,2,1,2,3
64681_0,,,,2,1,2,3
64682_0,,,,2,1,2,3
64683_0,,,,2,1,2,3
64684_0,,,,2,1,2,3
64685_0,,,,2,1,2,3
64686_0,,,,2,1,2,3
64687_0,,,,2,1,2,3
64688_0,,,,2,1,2,3
64690_0,,,,2,1,2,3
C(C(C=C(C(CO)=O)CO)O)=O,,,5,1,1,0,1
64691_0,,,,2,1,2,3
64692_0,,,,2,1,2,3
64693_0,,,,2,1,2,3
64694_0,,,,2,1,2,3
64695_0,,,,2,1,2,3
64697_0,,,,2,1,2,3
C(CC(CO)=C(C=O)C(C)O)=O,,,5,1,1,0,1
64698_0,,,,2,1,2,3
64699_0,,,,2,1,2,3
64700_0,,,,2,1,2,3
64701_0,,,,2,1,2,3
64702_0,,,,2,1,2,3
64703_0,,,,2,1,2,3
64704_0,,,,2,1,2,3
64705_0,,,,2,1,2,3
64706_0,,,,2,1,2,3
64707_0,,,,2,1,2,3
64708_0,,,,2,1,2,3
64709_0,,,,2,1,2,3
64710_0,,,,2,1,2,3
64711_0,,,,2,1,2,3
64712_0,,,,2,1,2,3
64713_0,,,,2,1,2,3
64714_0,,,,2,1,2,3
64715_0,,,,2,1,2,3
64716_0,,,,2,1,2,3
64717_0,,,,2,1,2,3
64719_0,,,,2,1,2,3
C(CC(C(C(C)O)O)=CC=O)=O,,,5,1,1,0,1
64720_0,,,,2,1,2,3
64721_0,,,,2,1,2,3
64723_0,,,,2,1,2,3
C(CC(C(CO)O)=CC=O)=O,,,5,1,1,0,1
64725_0,,,,2,1,2,3
C(C(C(C(CO)O)=CC=O)O)=O,,,5,1,1,0,1
64726_0,,,,2,1,2,3
64727_0,,,,2,1,2,3
64728_0,,,,2,1,2,3
64729_0,,,,2,1,2,3
64730_0,,,,2,1,2,3
64731_0,,,,2,1,2,3
64732_0,,,,2,1,2,3
64733_0,,,,2,1,2,3
64734_0,,,,2,1,2,3
64735_0,,,,2,1,2,3
64736_0,,,,2,1,2,3
64738_0,,,,2,1,2,3
C(C(C(C)(CC=CC=O)O)O)=O,,,5,1,1,0,1
64740_0,,,,2,1,2,3
C(CC=CC(C)(C(C=O)O)O)=O,,,5,1,1,0,1
64741_0,,,,2,1,2,3
64742_0,,,,2,1,2,3
64743_0,,,,2,1,2,3
64744_0,,,,2,1,2,3
64745_0,,,,2,1,2,3
64747_0,,,,2,1,2,3
C(C(C(C(C=O)=CC)(C)O)O)=O,,,5,1,1,0,1
64749_0,,,,2,1,2,3
C(C(C(C)=C(C=O)C(C)O)O)=O,,,5,1,1,0,1
64750_0,,,,2,1,2,3
64752_0,,,,2,1,2,3
C(C(C(C(C=O)=C)(C)O)O)=O,,,5,1,2,0,2
64753_0,,,,2,1,2,3
64754_0,,,,2,1,2,3
64756_0,,,,2,1,2,3
C(C(C(CC(C)O)=CC=O)O)=O,,,5,1,1,0,1
64757_0,,,,2,1,2,3
64758_0,,,,2,1,2,3
64760_0,,,,2,1,2,3
C(CC(C(C=O)O)=CC(C)O)=O,,,5,1,1,0,1
64761_0,,,,2,1,2,3
64763_0,,,,2,1,2,3
C(C(C(C(C(O)=O)=CC)=O)O)=O,,,5,1,1,0,1
64764_0,,,,2,1,2,3
64766_0,,,,2,1,2,3
C(C(C(C(C(C)O)=CC)=O)O)=O,,,5,1,1,0,1
64767_0,,,,2,1,2,3
64769_0,,,,2,1,2,3
C(C(C(C(C(C)O)=C)=O)O)=O,,,5,1,1,0,1
64771_0,,,,2,1,2,3
C(C(C(C(CO)=CC)=O)O)=O,,,5,1,1,0,1
64772_0,,,,2,1,2,3
64773_0,,,,2,1,2,3
64775_0,,,,2,1,2,3
C(C(C(CCO)=CC=O)O)=O,,,5,1,1,0,1
64776_0,,,,2,1,2,3
64778_0,,,,2,1,2,3
C(CC(C(C=O)O)=CCO)=O,,,5,1,1,0,1
64779_0,,,,2,1,2,3
64781_0,,,,2,1,2,3
C(C(C(C(C=O)O)=CCO)O)=O,,,5,1,1,0,1
64783_0,,,,2,1,2,3
C(C(C(C(C(O)=O)=C)=O)O)=O,,,5,1,1,0,1
64785_0,,,,2,1,2,3
C(C(C(C(CO)=C)=O)O)=O,,,5,1,1,0,1
64787_0,,,,2,1,2,3
C(C(C(C(CO)=CCO)=O)O)=O,,,5,1,1,0,1
64789_0,,,,2,1,2,3
C(C(C(C(C(CO)O)=C)=O)O)=O,,,5,1,1,0,1
64791_0,,,,2,1,2,3
C(C)=C(C=O)C(CC(C)O)O,,,5,1,1,0,1
64793_0,,,,2,1,2,3
C(CC(C)O)=C(C=O)C(C)O,,,5,1,1,0,1
64794_0,,,,2,1,2,3
64796_0,,,,2,1,2,3
C(C(C=CC(C)O)C(C)O)=O,,,5,1,1,0,1
64797_0,,,,2,1,2,3
64798_0,,,,2,1,2,3
64800_0,,,,2,1,2,3
C=C(C=O)C(CC(C)O)O,,,5,1,2,0,2
64802_0,,,,2,1,2,3
C(CC(C)O)=C(C=O)CO,,,5,1,1,0,1
64804_0,,,,2,1,2,3
C(C(C=CC(C)O)CO)=O,,,5,1,1,0,1
64805_0,,,,2,1,2,3
64806_0,,,,2,1,2,3
64808_0,,,,2,1,2,3
C(CO)=C(C=O)C(CC(C)O)O,,,5,1,2,0,2
64810_0,,,,2,1,2,3
C(CC(C)O)=C(C=O)C(CO)O,,,5,1,1,0,1
64812_0,,,,2,1,2,3
C(C(C=CC(C)O)C(CO)O)=O,,,5,1,1,0,1
64813_0,,,,2,1,2,3
64814_0,,,,2,1,2,3
64816_0,,,,2,1,2,3
C(C(C)O)=CC(C(C(C)=O)=O)O,,,5,1,1,0,1
64817_0,,,,2,1,2,3
64818_0,,,,2,1,2,3
64820_0,,,,2,1,2,3
C(CC(C)O)=CC(C(CO)=O)=O,,,5,1,1,0,1
64822_0,,,,2,1,2,3
C(C(C)O)=CCC(C(CO)=O)=O,,,5,1,1,0,1
64823_0,,,,2,1,2,3
64824_0,,,,2,1,2,3
64826_0,,,,2,1,2,3
C(C)(C(C=CC(C)O)O)=O,,,5,1,1,0,1
64827_0,,,,2,1,2,3
64828_0,,,,2,1,2,3
64830_0,,,,2,1,2,3
C(CC(C)O)=CC(CO)=O,,,5,1,1,0,1
64832_0,,,,2,1,2,3
C(CO)(CC=CC(C)O)=O,,,5,1,1,0,1
64833_0,,,,2,1,2,3
64834_0,,,,2,1,2,3
64835_0,,,,2,1,2,3
64837_0,,,,2,1,2,3
C(CCO)(C(C=CC(C)O)O)=O,,,5,1,1,0,1
64838_0,,,,2,1,2,3
64839_0,,,,2,1,2,3
64841_0,,,,2,1,2,3
C=C(C(CO)=O)C(CC(C)O)O,,,5,1,1,0,1
64843_0,,,,2,1,2,3
C(CC(C)O)=C(C(CO)=O)CO,,,5,1,1,0,1
64845_0,,,,2,1,2,3
C(CO)(C(C=CC(C)O)CO)=O,,,5,1,1,0,1
64846_0,,,,2,1,2,3
64847_0,,,,2,1,2,3
64849_0,,,,2,1,2,3
C(CC(C)O)=CC(C(CO)O)=O,,,5,1,1,0,1
64851_0,,,,2,1,2,3
C(C(CO)O)(CC=CC(C)O)=O,,,5,1,1,0,1
64852_0,,,,2,1,2,3
64853_0,,,,2,1,2,3
64855_0,,,,2,1,2,3
C(CC(C)O)=CC(C(O)=O)=O,,,5,1,1,0,1
64857_0,,,,2,1,2,3
C(CC(C(O)=O)=O)=CC(C)O,,,5,1,1,0,1
64858_0,,,,2,1,2,3
64859_0,,,,2,1,2,3
64861_0,,,,2,1,2,3
C(CC(C)O)=C(C(O)=O)C=O,,,5,1,1,0,1
64863_0,,,,2,1,2,3
C(C(C=O)C=CC(C)O)(O)=O,,,5,1,1,0,1
64864_0,,,,2,1,2,3
64865_0,,,,2,1,2,3
64867_0,,,,2,1,2,3
C(C(C(C(O)=O)=O)O)=CC(C)O,,,5,1,1,0,1
64868_0,,,,2,1,2,3
64869_0,,,,2,1,2,3
64871_0,,,,2,1,2,3
C(CC(C)O)=C(C=O)C(C=O)=O,,,5,1,1,0,1
64873_0,,,,2,1,2,3
C(C(C=CC(C)O)C(C=O)=O)=O,,,5,1,1,0,1
64874_0,,,,2,1,2,3
64875_0,,,,2,1,2,3
64877_0,,,,2,1,2,3
C1(C(COC1C=CC(C)O)O)=O,,,5,1,1,0,1
64878_0,,,,2,1,2,3
64879_0,,,,2,1,2,3
64881_0,,,,2,1,2,3
C(CC(C)O)=C1C(C(OC1)O)=O,,,5,1,1,0,1
64883_0,,,,2,1,2,3
C1(C(O)OCC1C=CC(C)O)=O,,,5,1,1,0,1
64884_0,,,,2,1,2,3
64885_0,,,,2,1,2,3
64887_0,,,,2,1,2,3
C1OCC(C=1C(CC(C)O)O)=O,,,5,1,1,0,1
64889_0,,,,2,1,2,3
C(CC(C)O)=C1C(COC1O)=O,,,5,1,1,0,1
64891_0,,,,2,1,2,3
C1(COC(C1C=CC(C)O)O)=O,,,5,1,1,0,1
64892_0,,,,2,1,2,3
64893_0,,,,2,1,2,3
64894_0,,,,2,1,2,3
64896_0,,,,2,1,2,3
C1(CC(OC1C=CC(C)O)O)=O,,,5,1,1,0,1
64897_0,,,,2,1,2,3
64898_0,,,,2,1,2,3
64900_0,,,,2,1,2,3
C(CC(C)O)=CC(C(C=O)=O)=O,,,5,1,1,0,1
64902_0,,,,2,1,2,3
C(CC(C(C=O)=O)=O)=CC(C)O,,,5,1,1,0,1
64903_0,,,,2,1,2,3
64904_0,,,,2,1,2,3
64906_0,,,,2,1,2,3
C(CO)(C(C=CC(C)O)O)=O,,,5,1,1,0,1
64907_0,,,,2,1,2,3
64908_0,,,,2,1,2,3
64910_0,,,,2,1,2,3
C(CC(C)O)=CC(C=O)=O,,,5,1,1,0,1
64912_0,,,,2,1,2,3
C(CC(C=O)=O)=CC(C)O,,,5,1,1,0,1
64913_0,,,,2,1,2,3
64914_0,,,,2,1,2,3
64916_0,,,,2,1,2,3
C(CC(C)O)=C(C=O)C=O,,,5,1,1,0,1
64918_0,,,,2,1,2,3
C(C(C=O)C=CC(C)O)=O,,,5,1,1,0,1
64919_0,,,,2,1,2,3
64920_0,,,,2,1,2,3
64922_0,,,,2,1,2,3
C=C(C(C=O)=O)C(CC(C)O)O,,,5,1,2,0,2
64924_0,,,,2,1,2,3
C(CC(C)O)=C(C(C=O)=O)CO,,,5,1,1,0,1
64926_0,,,,2,1,2,3
C(C(C(C=O)=O)CO)=CC(C)O,,,5,1,1,0,1
64927_0,,,,2,1,2,3
64928_0,,,,2,1,2,3
64930_0,,,,2,1,2,3
C(C=C(C=O)C(CC(C)O)O)=O,,,5,1,2,0,2
64932_0,,,,2,1,2,3
C(C(C(C=O)=CCC(C)O)O)=O,,,5,1,1,0,1
64934_0,,,,2,1,2,3
C(C(C=CC(C)O)C(C=O)O)=O,,,5,1,1,0,1
64935_0,,,,2,1,2,3
64936_0,,,,2,1,2,3
64938_0,,,,2,1,2,3
C(CC(C)O)=C(C=O)C(CO)=O,,,5,1,1,0,1
64940_0,,,,2,1,2,3
C(C(C(CO)=O)C=CC(C)O)=O,,,5,1,1,0,1
64941_0,,,,2,1,2,3
64942_0,,,,2,1,2,3
64944_0,,,,2,1,2,3
C(CC(C(C=CC(C)O)O)=O)=O,,,5,1,1,0,1
64945_0,,,,2,1,2,3
64946_0,,,,2,1,2,3
64948_0,,,,2,1,2,3
C(C(C(C=CCC(C)O)=O)O)=O,,,5,1,1,0,1
64950_0,,,,2,1,2,3
C(C(C=O)O)(CC=CC(C)O)=O,,,5,1,1,0,1
64951_0,,,,2,1,2,3
64952_0,,,,2,1,2,3
64954_0,,,,2,1,2,3
C(CC(C)O)=CC=O,,,5,1,1,0,1
64956_0,,,,2,1,2,3
C(CC=CC(C)O)=O,,,5,1,1,0,1
64957_0,,,,2,1,2,3
64958_0,,,,2,1,2,3
64960_0,,,,2,1,2,3
C(C(C(C=O)=O)O)=CC(C)O,,,5,1,1,0,1
64961_0,,,,2,1,2,3
64962_0,,,,2,1,2,3
64964_0,,,,2,1,2,3
C(C(C=CC(C)O)O)=O,,,5,1,2,0,2
64965_0,,,,2,1,2,3
64966_0,,,,2,1,2,3
64967_0,,,,2,1,2,3
64969_0,,,,2,1,2,3
C(C(C(C)O)O)=C(C=O)C(C)O,,,5,1,1,0,1
64971_0,,,,2,1,2,3
C(C)=C(C=O)C(C(C(C)O)O)O,,,5,1,1,0,1
64972_0,,,,2,1,2,3
64973_0,,,,2,1,2,3
64975_0,,,,2,1,2,3
C(C(C=CCO)C(C)O)=O,,,5,1,1,0,1
64977_0,,,,2,1,2,3
C(CCO)=C(C=O)C(C)O,,,5,1,1,0,1
64979_0,,,,2,1,2,3
C(C)=C(C=O)C(CCO)O,,,5,1,1,0,1
64980_0,,,,2,1,2,3
64981_0,,,,2,1,2,3
64983_0,,,,2,1,2,3
C(C(C=CC(CO)O)C(C)O)=O,,,5,1,1,0,1
64985_0,,,,2,1,2,3
C(CC(CO)O)=C(C=O)C(C)O,,,5,1,1,0,1
64987_0,,,,2,1,2,3
C(C)=C(C=O)C(CC(CO)O)O,,,5,1,1,0,1
64988_0,,,,2,1,2,3
64990_0,,,,2,1,2,3
C(C(CO)=C(C=O)C(C)O)(C)=O,,,5,1,1,0,1
64992_0,,,,2,1,2,3
C(C)(C(C(C=O)=CC)(CO)O)=O,,,5,1,1,0,1
64993_0,,,,2,1,2,3
64995_0,,,,2,1,2,3
C(C(C(C(CO)=O)=C)C(C)O)=O,,,5,1,1,0,1
64997_0,,,,2,1,2,3
C(C(C(C)O)=C(C(CO)=O)C)=O,,,5,1,1,0,1
64999_0,,,,2,1,2,3
C(CO)(C(C(C=O)=CC)(C)O)=O,,,5,1,1,0,1
65000_0,,,,2,1,2,3
65001_0,,,,2,1,2,3
65003_0,,,,2,1,2,3
C(C(C(C)O)=C(C=O)C(C)O)=O,,,5,1,1,0,1
65004_0,,,,2,1,2,3
65005_0,,,,2,1,2,3
65006_0,,,,2,1,2,3
65008_0,,,,2,1,2,3
C(C(C(C)O)=CC(C(C)O)=O)=O,,,5,1,1,0,1
65010_0,,,,2,1,2,3
C(C(C)O)(C(C(C=O)=CC)O)=O,,,5,1,1,0,1
65011_0,,,,2,1,2,3
65013_0,,,,2,1,2,3
C(C(C(CO)=C)C(C)O)=O,,,5,1,1,0,1
65015_0,,,,2,1,2,3
C(CO)(C)=C(C=O)C(C)O,,,5,1,1,0,1
65017_0,,,,2,1,2,3
C(C)=C(C=O)C(CO)(C)O,,,5,1,1,0,1
65018_0,,,,2,1,2,3
65020_0,,,,2,1,2,3
C(C(C(CO)=CCO)C(C)O)=O,,,5,1,1,0,1
65021_0,,,,2,1,2,3
65023_0,,,,2,1,2,3
C(CO)(CCO)=C(C=O)C(C)O,,,5,1,1,0,1
65025_0,,,,2,1,2,3
C(C)=C(C=O)C(CO)(CCO)O,,,5,1,1,0,1
65026_0,,,,2,1,2,3
65027_0,,,,2,1,2,3
65028_0,,,,2,1,2,3
65030_0,,,,2,1,2,3
C(C(CCO)O)=C(C=O)C(C)O,,,5,1,1,0,1
65032_0,,,,2,1,2,3
C(C)=C(C=O)C(C(CCO)O)O,,,5,1,1,0,1
65033_0,,,,2,1,2,3
65035_0,,,,2,1,2,3
C(C(C(C(CO)O)=C)C(C)O)=O,,,5,1,1,0,1
65037_0,,,,2,1,2,3
C(C)(C(CO)O)=C(C=O)C(C)O,,,5,1,1,0,1
65039_0,,,,2,1,2,3
C(C)=C(C=O)C(C)(C(CO)O)O,,,5,1,1,0,1
65040_0,,,,2,1,2,3
65042_0,,,,2,1,2,3
C(C(C(C(O)=O)=C)C(C)O)=O,,,5,1,1,0,1
65044_0,,,,2,1,2,3
C(C(C)=C(C=O)C(C)O)(O)=O,,,5,1,1,0,1
65046_0,,,,2,1,2,3
C(C(C(C=O)=CC)(C)O)(O)=O,,,5,1,1,0,1
65047_0,,,,2,1,2,3
65049_0,,,,2,1,2,3
C(C(C=CC(O)=O)C(C)O)=O,,,5,1,2,0,2
65051_0,,,,2,1,2,3
C(CC=C(C=O)C(C)O)(O)=O,,,5,1,3,0,3
65053_0,,,,2,1,2,3
C(CC(C(C=O)=CC)O)(O)=O,,,5,1,1,0,1
65054_0,,,,2,1,2,3
65056_0,,,,2,1,2,3
C(C(CO)=C(C=O)C(C)O)(O)=O,,,5,1,1,0,1
65058_0,,,,2,1,2,3
C(C(C(C=O)=CC)(CO)O)(O)=O,,,5,1,1,0,1
65059_0,,,,2,1,2,3
65061_0,,,,2,1,2,3
C(C(C(C=O)=CC=O)C(C)O)=O,,,5,1,1,0,1
65063_0,,,,2,1,2,3
C(CC(C=O)=C(C=O)C(C)O)=O,,,5,1,2,0,2
65065_0,,,,2,1,2,3
C(C(C(C=O)=CC)(CC=O)O)=O,,,5,1,1,0,1
65066_0,,,,2,1,2,3
65068_0,,,,2,1,2,3
C(CC(C=C(C=O)C(C)O)=O)=O,,,5,1,1,0,1
65070_0,,,,2,1,2,3
C(CC(C(C(C=O)=CC)O)=O)=O,,,5,1,1,0,1
65071_0,,,,2,1,2,3
65073_0,,,,2,1,2,3
C1(COCC1O)=C(C=O)C(C)O,,,5,1,1,0,1
65075_0,,,,2,1,2,3
C(C)=C(C=O)C1(COCC1O)O,,,5,1,1,0,1
65076_0,,,,2,1,2,3
65078_0,,,,2,1,2,3
C(C(C1C(OCC=1)O)C(C)O)=O,,,5,1,1,0,1
65080_0,,,,2,1,2,3
C1(C(O)OCC1)=C(C=O)C(C)O,,,5,1,1,0,1
65082_0,,,,2,1,2,3
C(C)=C(C=O)C1(C(O)OCC1)O,,,5,1,1,0,1
65083_0,,,,2,1,2,3
65084_0,,,,2,1,2,3
65086_0,,,,2,1,2,3
C(C(C1COC(C=1)O)C(C)O)=O,,,5,1,1,0,1
65088_0,,,,2,1,2,3
C1(COC(C1)O)=C(C=O)C(C)O,,,5,1,1,0,1
65090_0,,,,2,1,2,3
C(C)=C(C=O)C1(COC(C1)O)O,,,5,1,1,0,1
65091_0,,,,2,1,2,3
65093_0,,,,2,1,2,3
C(C(C(C)=O)=C(C=O)C(C)O)=O,,,5,1,1,0,1
65095_0,,,,2,1,2,3
C(C(C(C)=O)(C(C=O)=CC)O)=O,,,5,1,1,0,1
65096_0,,,,2,1,2,3
65098_0,,,,2,1,2,3
C(C(C=C(C=O)C(C)O)=O)(C)=O,,,5,1,1,0,1
65100_0,,,,2,1,2,3
C(C)=C(C=O)C(C(C(C)=O)=O)O,,,5,1,1,0,1
65101_0,,,,2,1,2,3
65103_0,,,,2,1,2,3
C(C(C(C(C=O)=O)=C)C(C)O)=O,,,5,1,1,0,1
65105_0,,,,2,1,2,3
C(C(C(C)=C(C=O)C(C)O)=O)=O,,,5,1,1,0,1
65107_0,,,,2,1,2,3
C(C)=C(C=O)C(C(C=O)=O)(C)O,,,5,1,1,0,1
65108_0,,,,2,1,2,3
65110_0,,,,2,1,2,3
C=CC(C=O)=C(C=O)C(C)O,,,5,1,1,0,1
65112_0,,,,2,1,2,3
C(C(C=C)(C(C=O)=CC)O)=O,,,5,1,1,0,1
65113_0,,,,2,1,2,3
65115_0,,,,2,1,2,3
C=CC(C=C(C=O)C(C)O)=O,,,5,1,1,0,1
65117_0,,,,2,1,2,3
C=CC(C(C(C=O)=CC)O)=O,,,5,1,1,0,1
65118_0,,,,2,1,2,3
65120_0,,,,2,1,2,3
C(C(C(C)O)=CC=CC=O)=O,,,5,1,1,0,1
65122_0,,,,2,1,2,3
C(C(C(C=O)=CC)O)=CC=O,,,5,1,1,0,1
65123_0,,,,2,1,2,3
65124_0,,,,2,1,2,3
65125_0,,,,2,1,2,3
65127_0,,,,2,1,2,3
C(C(O)O)=C(C=O)C(C)O,,,5,1,1,0,1
65129_0,,,,2,1,2,3
C(C)=C(C=O)C(C(O)O)O,,,5,1,1,0,1
65130_0,,,,2,1,2,3
65131_0,,,,2,1,2,3
65133_0,,,,2,1,2,3
C(C(C)O)=C(C=O)C(C)O,,,5,1,1,0,1
65135_0,,,,2,1,2,3
C(C)=C(C=O)C(C(C)O)O,,,5,1,1,0,1
65136_0,,,,2,1,2,3
65138_0,,,,2,1,2,3
C(C(CO)O)=C(C=O)C(C)O,,,5,1,1,0,1
65140_0,,,,2,1,2,3
C(C)=C(C=O)C(C(CO)O)O,,,5,1,1,0,1
65141_0,,,,2,1,2,3
65142_0,,,,2,1,2,3
65144_0,,,,2,1,2,3
C(C)=C(C=O)C(C)O,,,5,1,1,0,1
65146_0,,,,2,1,2,3
C(C(C(C)O)=C(C=O)CO)=O,,,5,1,2,0,2
65147_0,,,,2,1,2,3
65148_0,,,,2,1,2,3
65150_0,,,,2,1,2,3
C(C(C(C)O)=CC(CO)=O)=O,,,5,1,2,0,2
65152_0,,,,2,1,2,3
C(CO)(C(C(C=O)=CC)O)=O,,,5,1,1,0,1
65153_0,,,,2,1,2,3
65155_0,,,,2,1,2,3
C=C(C=O)C(C)O,,,5,1,5,0,5
65156_0,,,,2,1,2,3
65157_0,,,,2,1,2,3
65158_0,,,,2,1,2,3
65159_0,,,,2,1,2,3
65160_0,,,,2,1,2,3
65162_0,,,,2,1,2,3
C(C=C(C=O)C(C(C)O)O)=O,,,5,1,2,0,2
65163_0,,,,2,1,2,3
65164_0,,,,2,1,2,3
65165_0,,,,2,1,2,3
65166_0,,,,2,1,2,3
65168_0,,,,2,1,2,3
C=C(C=O)C(C(C(C)O)O)O,,,5,1,2,0,2
65170_0,,,,2,1,2,3
C(C(C(C)O)O)=C(C=O)CO,,,5,1,1,0,1
65171_0,,,,2,1,2,3
65172_0,,,,2,1,2,3
65174_0,,,,2,1,2,3
C(C(C(C)O)O)=CC(CO)=O,,,5,1,1,0,1
65175_0,,,,2,1,2,3
65177_0,,,,2,1,2,3
C(C(C(C)O)O)=CC(C(O)=O)=O,,,5,1,1,0,1
65178_0,,,,2,1,2,3
65180_0,,,,2,1,2,3
C(C(C(C)O)O)=C(C(O)=O)C=O,,,5,1,1,0,1
65181_0,,,,2,1,2,3
65182_0,,,,2,1,2,3
65184_0,,,,2,1,2,3
C(C(C(C)O)O)=CC(C=O)=O,,,5,1,1,0,1
65185_0,,,,2,1,2,3
65187_0,,,,2,1,2,3
C(C(C(C)O)O)=C(C=O)C=O,,,5,1,1,0,1
65188_0,,,,2,1,2,3
65190_0,,,,2,1,2,3
C(C(C(C)O)O)=CC=O,,,5,1,1,0,1
65191_0,,,,2,1,2,3
65192_0,,,,2,1,2,3
65193_0,,,,2,1,2,3
65194_0,,,,2,1,2,3
65195_0,,,,2,1,2,3
65196_0,,,,2,1,2,3
65197_0,,,,2,1,2,3
65198_0,,,,2,1,2,3
65199_0,,,,2,1,2,3
65200_0,,,,2,1,2,3
65201_0,,,,2,1,2,3
65202_0,,,,2,1,2,3
65203_0,,,,2,1,2,3
65204_0,,,,2,1,2,3
65205_0,,,,2,1,2,3
65207_0,,,,2,1,2,3
C(CO)(C(CC=CC=O)O)=O,,,5,1,1,0,1
65208_0,,,,2,1,2,3
65210_0,,,,2,1,2,3
C(CC=CC(C(CO)=O)O)=O,,,5,1,1,0,1
65211_0,,,,2,1,2,3
65212_0,,,,2,1,2,3
65213_0,,,,2,1,2,3
65214_0,,,,2,1,2,3
65215_0,,,,2,1,2,3
65216_0,,,,2,1,2,3
65217_0,,,,2,1,2,3
65218_0,,,,2,1,2,3
65219_0,,,,2,1,2,3
65220_0,,,,2,1,2,3
65221_0,,,,2,1,2,3
65222_0,,,,2,1,2,3
65223_0,,,,2,1,2,3
65224_0,,,,2,1,2,3
65226_0,,,,2,1,2,3
C(CC(C(CO)O)O)=CC=O,,,5,1,1,0,1
65227_0,,,,2,1,2,3
65229_0,,,,2,1,2,3
C(CC=CC(C(CO)O)O)=O,,,5,1,1,0,1
65230_0,,,,2,1,2,3
65232_0,,,,2,1,2,3
C(C(C=CC(C(CO)O)O)O)=O,,,5,1,3,0,3
65233_0,,,,2,1,2,3
65235_0,,,,2,1,2,3
C=C(C=O)C(C(CO)O)O,,,5,1,2,0,2
65236_0,,,,2,1,2,3
65237_0,,,,2,1,2,3
65238_0,,,,2,1,2,3
65240_0,,,,2,1,2,3
C=C(C=O)C(C(C(CO)O)O)O,,,5,1,2,0,2
65241_0,,,,2,1,2,3
65243_0,,,,2,1,2,3
C=C(C=O)C(CCO)O,,,5,1,3,0,3
65245_0,,,,2,1,2,3
C(CCO)=C(C=O)CO,,,5,1,1,0,1
65246_0,,,,2,1,2,3
65248_0,,,,2,1,2,3
C(C(C=CCO)CO)=O,,,5,1,1,0,1
65250_0,,,,2,1,2,3
C(CO)=C(C=O)C(CCO)O,,,5,1,2,0,2
65252_0,,,,2,1,2,3
C(CCO)=C(C=O)C(CO)O,,,5,1,1,0,1
65253_0,,,,2,1,2,3
65255_0,,,,2,1,2,3
C(C(C=CCO)C(CO)O)=O,,,5,1,1,0,1
65256_0,,,,2,1,2,3
65258_0,,,,2,1,2,3
C(C(C=O)O)(C(C=CCO)O)=O,,,5,1,1,0,1
65259_0,,,,2,1,2,3
65261_0,,,,2,1,2,3
C(C(C(C(C)=O)=O)O)=CCO,,,5,1,1,0,1
65263_0,,,,2,1,2,3
C(CCO)=CC(C(CO)=O)=O,,,5,1,1,0,1
65264_0,,,,2,1,2,3
65266_0,,,,2,1,2,3
C(CC(C(CO)=O)=O)=CCO,,,5,1,1,0,1
65267_0,,,,2,1,2,3
65268_0,,,,2,1,2,3
65269_0,,,,2,1,2,3
65270_0,,,,2,1,2,3
65271_0,,,,2,1,2,3
65272_0,,,,2,1,2,3
65273_0,,,,2,1,2,3
65275_0,,,,2,1,2,3
C(CCO)(C(C=CCO)O)=O,,,5,1,1,0,1
65277_0,,,,2,1,2,3
C=C(C(CO)=O)C(CCO)O,,,5,1,1,0,1
65279_0,,,,2,1,2,3
C(CCO)=C(C(CO)=O)CO,,,5,1,1,0,1
65280_0,,,,2,1,2,3
65282_0,,,,2,1,2,3
C(CO)(C(C=CCO)CO)=O,,,5,1,1,0,1
65284_0,,,,2,1,2,3
C(CCO)=CC(C(CO)O)=O,,,5,1,1,0,1
65285_0,,,,2,1,2,3
65287_0,,,,2,1,2,3
C(C(CO)O)(CC=CCO)=O,,,5,1,1,0,1
65289_0,,,,2,1,2,3
C(CCO)=CC(C(O)=O)=O,,,5,1,1,0,1
65290_0,,,,2,1,2,3
65292_0,,,,2,1,2,3
C(CC(C(O)=O)=O)=CCO,,,5,1,1,0,1
65294_0,,,,2,1,2,3
C(CCO)=C(C(O)=O)C=O,,,5,1,1,0,1
65295_0,,,,2,1,2,3
65297_0,,,,2,1,2,3
C(C(C=O)C=CCO)(O)=O,,,5,1,1,0,1
65299_0,,,,2,1,2,3
C=C(C(C(O)=O)=O)C(CCO)O,,,5,1,1,0,1
65301_0,,,,2,1,2,3
C(CCO)=C(C(C(O)=O)=O)CO,,,5,1,1,0,1
65302_0,,,,2,1,2,3
65304_0,,,,2,1,2,3
C(C(C(C(O)=O)=O)CO)=CCO,,,5,1,1,0,1
65306_0,,,,2,1,2,3
C(CCO)=C(C(O)=O)C(CO)=O,,,5,1,1,0,1
65307_0,,,,2,1,2,3
65309_0,,,,2,1,2,3
C(C(C(CO)=O)C=CCO)(O)=O,,,5,1,1,0,1
65310_0,,,,2,1,2,3
65312_0,,,,2,1,2,3
C(CC(C(C=CCO)O)=O)(O)=O,,,5,1,1,0,1
65314_0,,,,2,1,2,3
C(C(C(C=CCCO)=O)O)(O)=O,,,5,1,1,0,1
65315_0,,,,2,1,2,3
65317_0,,,,2,1,2,3
C(C(C(O)=O)O)(CC=CCO)=O,,,5,1,1,0,1
65318_0,,,,2,1,2,3
65319_0,,,,2,1,2,3
65321_0,,,,2,1,2,3
C(CCO)=C(C=O)C(C=O)=O,,,5,1,1,0,1
65322_0,,,,2,1,2,3
65324_0,,,,2,1,2,3
C(C(C=CCO)C(C=O)=O)=O,,,5,1,1,0,1
65326_0,,,,2,1,2,3
C(CCO)=C(C(O)=O)C(C=O)=O,,,5,1,1,0,1
65327_0,,,,2,1,2,3
65329_0,,,,2,1,2,3
C(C(C=CCO)C(C=O)=O)(O)=O,,,5,1,1,0,1
65331_0,,,,2,1,2,3
C(CCO)=C(C=O)C(C(O)=O)=O,,,5,1,1,0,1
65332_0,,,,2,1,2,3
65334_0,,,,2,1,2,3
C(C(C=CCO)C(C(O)=O)=O)=O,,,5,1,1,0,1
65335_0,,,,2,1,2,3
65337_0,,,,2,1,2,3
C1(C(COC1C=CCO)O)=O,,,5,1,1,0,1
65339_0,,,,2,1,2,3
C(CCO)=C1C(C(OC1)O)=O,,,5,1,1,0,1
65340_0,,,,2,1,2,3
65342_0,,,,2,1,2,3
C1(C(O)OCC1C=CCO)=O,,,5,1,1,0,1
65344_0,,,,2,1,2,3
C1OCC(C=1C(CCO)O)=O,,,5,1,1,0,1
65346_0,,,,2,1,2,3
C(CCO)=C1C(COC1O)=O,,,5,1,1,0,1
65347_0,,,,2,1,2,3
65349_0,,,,2,1,2,3
C1(COC(C1C=CCO)O)=O,,,5,1,1,0,1
65350_0,,,,2,1,2,3
65351_0,,,,2,1,2,3
65353_0,,,,2,1,2,3
C1(CC(OC1C=CCO)O)=O,,,5,1,1,0,1
65355_0,,,,2,1,2,3
C(CCO)=CC(C(C=O)=O)=O,,,5,1,1,0,1
65356_0,,,,2,1,2,3
65358_0,,,,2,1,2,3
C(CC(C(C=O)=O)=O)=CCO,,,5,1,1,0,1
65359_0,,,,2,1,2,3
65360_0,,,,2,1,2,3
65361_0,,,,2,1,2,3
65362_0,,,,2,1,2,3
65363_0,,,,2,1,2,3
65364_0,,,,2,1,2,3
65365_0,,,,2,1,2,3
65366_0,,,,2,1,2,3
65367_0,,,,2,1,2,3
65368_0,,,,2,1,2,3
65369_0,,,,2,1,2,3
65370_0,,,,2,1,2,3
65371_0,,,,2,1,2,3
65372_0,,,,2,1,2,3
65373_0,,,,2,1,2,3
65374_0,,,,2,1,2,3
65375_0,,,,2,1,2,3
65376_0,,,,2,1,2,3
65377_0,,,,2,1,2,3
65378_0,,,,2,1,2,3
65379_0,,,,2,1,2,3
65380_0,,,,2,1,2,3
65381_0,,,,2,1,2,3
65382_0,,,,2,1,2,3
65383_0,,,,2,1,2,3
65384_0,,,,2,1,2,3
65385_0,,,,2,1,2,3
65386_0,,,,2,1,2,3
65387_0,,,,2,1,2,3
65388_0,,,,2,1,2,3
65389_0,,,,2,1,2,3
65390_0,,,,2,1,2,3
65391_0,,,,2,1,2,3
65392_0,,,,2,1,2,3
65394_0,,,,2,1,2,3
C(C(C=CC(CO)O)CO)=O,,,5,1,1,0,1
65396_0,,,,2,1,2,3
C(CC(CO)O)=C(C=O)CO,,,5,1,1,0,1
65398_0,,,,2,1,2,3
C=C(C=O)C(CC(CO)O)O,,,5,1,2,0,2
65399_0,,,,2,1,2,3
65401_0,,,,2,1,2,3
C(C(C(C(C(C=O)=C)O)=O)O)=O,,,5,1,2,0,2
65402_0,,,,2,1,2,3
65403_0,,,,2,1,2,3
65405_0,,,,2,1,2,3
C(C(CO)=C(C(C)=O)CO)=O,,,5,1,1,0,1
65406_0,,,,2,1,2,3
65408_0,,,,2,1,2,3
C(C(C(C(CO)=O)=C)CO)=O,,,5,1,1,0,1
65410_0,,,,2,1,2,3
C(C(CO)=C(C(CO)=O)C)=O,,,5,1,1,0,1
65412_0,,,,2,1,2,3
C(CO)(C(C(C=O)=C)(C)O)=O,,,5,1,2,0,2
65413_0,,,,2,1,2,3
65414_0,,,,2,1,2,3
65415_0,,,,2,1,2,3
65416_0,,,,2,1,2,3
65418_0,,,,2,1,2,3
C(C=C(C=O)CO)(C(C)O)=O,,,5,1,1,0,1
65420_0,,,,2,1,2,3
C(C(C)O)(C(C(C=O)=C)O)=O,,,5,1,2,0,2
65422_0,,,,2,1,2,3
C(C(C(CO)=C)CO)=O,,,5,1,1,0,1
65424_0,,,,2,1,2,3
C(C)(CO)=C(C=O)CO,,,5,1,1,0,1
65426_0,,,,2,1,2,3
C=C(C=O)C(CO)(C)O,,,5,1,2,0,2
65428_0,,,,2,1,2,3
C(C(C(CO)=CCO)CO)=O,,,5,1,1,0,1
65429_0,,,,2,1,2,3
65431_0,,,,2,1,2,3
C(CO)(CCO)=C(C=O)CO,,,5,1,1,0,1
65433_0,,,,2,1,2,3
C=C(C=O)C(CO)(CCO)O,,,5,1,2,0,2
65434_0,,,,2,1,2,3
65435_0,,,,2,1,2,3
65437_0,,,,2,1,2,3
C(C(CCO)O)=C(C=O)CO,,,5,1,1,0,1
65439_0,,,,2,1,2,3
C=C(C=O)C(C(CCO)O)O,,,5,1,2,0,2
65441_0,,,,2,1,2,3
C(C(C(C(CO)O)=C)CO)=O,,,5,1,1,0,1
65443_0,,,,2,1,2,3
C(C)(C(CO)O)=C(C=O)CO,,,5,1,1,0,1
65445_0,,,,2,1,2,3
C=C(C=O)C(C)(C(CO)O)O,,,5,1,2,0,2
65446_0,,,,2,1,2,3
65448_0,,,,2,1,2,3
C(C(C)=C(C=O)CO)(O)=O,,,5,1,1,0,1
65449_0,,,,2,1,2,3
65451_0,,,,2,1,2,3
C(C(C=CC(O)=O)CO)=O,,,5,1,2,0,2
65453_0,,,,2,1,2,3
C(CC=C(C=O)CO)(O)=O,,,5,1,3,0,3
65455_0,,,,2,1,2,3
C(CC(C(C=O)=C)O)(O)=O,,,5,1,2,0,2
65457_0,,,,2,1,2,3
C(C(C(C(O)=O)=CCO)CO)=O,,,5,1,1,0,1
65458_0,,,,2,1,2,3
65460_0,,,,2,1,2,3
C(C(CCO)=C(C=O)CO)(O)=O,,,5,1,1,0,1
65461_0,,,,2,1,2,3
65462_0,,,,2,1,2,3
65464_0,,,,2,1,2,3
C(CC(C=C(C=O)CO)O)(O)=O,,,5,1,1,0,1
65466_0,,,,2,1,2,3
C(CC(C(C(C=O)=C)O)O)(O)=O,,,5,1,2,0,2
65468_0,,,,2,1,2,3
C(C(C(CO)=CC(O)=O)CO)=O,,,5,1,1,0,1
65470_0,,,,2,1,2,3
C(CC(CO)=C(C=O)CO)(O)=O,,,5,1,2,0,2
65472_0,,,,2,1,2,3
C(CC(C(C=O)=C)(CO)O)(O)=O,,,5,1,2,0,2
65474_0,,,,2,1,2,3
C(C(C(C(C(O)=O)O)=C)CO)=O,,,5,1,1,0,1
65476_0,,,,2,1,2,3
C(C(C(C)=C(C=O)CO)O)(O)=O,,,5,1,1,0,1
65478_0,,,,2,1,2,3
C(C(C(C(C=O)=C)(C)O)O)(O)=O,,,5,1,2,0,2
65480_0,,,,2,1,2,3
C(C(CO)=C(C=O)CO)(O)=O,,,5,1,1,0,1
65481_0,,,,2,1,2,3
65482_0,,,,2,1,2,3
65484_0,,,,2,1,2,3
C(CC(C=O)=C(C=O)CO)=O,,,5,1,2,0,2
65485_0,,,,2,1,2,3
65487_0,,,,2,1,2,3
C(CC(C=C(C=O)CO)=O)=O,,,5,1,2,0,2
65488_0,,,,2,1,2,3
65490_0,,,,2,1,2,3
C(C(C(C=O)=CC(O)=O)CO)=O,,,5,1,1,0,1
65492_0,,,,2,1,2,3
C(CC(C=O)=C(C=O)CO)(O)=O,,,5,1,1,0,1
65493_0,,,,2,1,2,3
65495_0,,,,2,1,2,3
C(CC(C=C(C=O)CO)=O)(O)=O,,,5,1,1,0,1
65496_0,,,,2,1,2,3
65498_0,,,,2,1,2,3
C(C(C(C(O)=O)=CC=O)CO)=O,,,5,1,1,0,1
65500_0,,,,2,1,2,3
C(CC(C(O)=O)=C(C=O)CO)=O,,,5,1,1,0,1
65501_0,,,,2,1,2,3
65503_0,,,,2,1,2,3
C1(COCC1O)=C(C=O)CO,,,5,1,1,0,1
65505_0,,,,2,1,2,3
C=C(C=O)C1(COCC1O)O,,,5,1,2,0,2
65507_0,,,,2,1,2,3
C(C(C1C(OCC=1)O)CO)=O,,,5,1,1,0,1
65509_0,,,,2,1,2,3
C1(C(O)OCC1)=C(C=O)CO,,,5,1,1,0,1
65511_0,,,,2,1,2,3
C=C(C=O)C1(C(O)OCC1)O,,,5,1,2,0,2
65512_0,,,,2,1,2,3
65514_0,,,,2,1,2,3
C(C(C1COC(C=1)O)CO)=O,,,5,1,1,0,1
65516_0,,,,2,1,2,3
C1(COC(C1)O)=C(C=O)CO,,,5,1,1,0,1
65518_0,,,,2,1,2,3
C=C(C=O)C1(COC(C1)O)O,,,5,1,2,0,2
65520_0,,,,2,1,2,3
C(C(C(C)=O)=C(C=O)CO)=O,,,5,1,2,0,2
65521_0,,,,2,1,2,3
65523_0,,,,2,1,2,3
C(C(CO)=CC(C(C)=O)=O)=O,,,5,1,2,0,2
65524_0,,,,2,1,2,3
65525_0,,,,2,1,2,3
65527_0,,,,2,1,2,3
C(C(C(C)=C(C=O)CO)=O)=O,,,5,1,2,0,2
65529_0,,,,2,1,2,3
C=C(C=O)C(C(C=O)=O)(C)O,,,5,1,2,0,2
65531_0,,,,2,1,2,3
C=CC(C=O)=C(C=O)CO,,,5,1,1,0,1
65533_0,,,,2,1,2,3
C(C(C=C)(C(C=O)=C)O)=O,,,5,1,2,0,2
65535_0,,,,2,1,2,3
C=CC(C=C(C=O)CO)=O,,,5,1,1,0,1
65537_0,,,,2,1,2,3
C=C(C=O)C(C(C=C)=O)O,,,5,1,2,0,2
65539_0,,,,2,1,2,3
C(C=CC=C(C=O)CO)=O,,,5,1,1,0,1
65541_0,,,,2,1,2,3
C=C(C=O)C(C=CC=O)O,,,5,1,2,0,2
65543_0,,,,2,1,2,3
C1(C(O)OCC1O)=C(C=O)CO,,,5,1,1,0,1
65545_0,,,,2,1,2,3
C=C(C=O)C1(C(O)OCC1O)O,,,5,1,3,0,3
65546_0,,,,2,1,2,3
65548_0,,,,2,1,2,3
C(C(O)O)=C(C=O)CO,,,5,1,1,0,1
65550_0,,,,2,1,2,3
C=C(C=O)C(C(O)O)O,,,5,1,2,0,2
65551_0,,,,2,1,2,3
65553_0,,,,2,1,2,3
C(C(C)O)=C(C=O)CO,,,5,1,1,0,1
65555_0,,,,2,1,2,3
C=C(C=O)C(C(C)O)O,,,5,1,2,0,2
65556_0,,,,2,1,2,3
65557_0,,,,2,1,2,3
65558_0,,,,2,1,2,3
65559_0,,,,2,1,2,3
65561_0,,,,2,1,2,3
C(C)(C(C=CC(CO)O)O)=O,,,5,1,1,0,1
65563_0,,,,2,1,2,3
C(CC(CO)O)=CC(CO)=O,,,5,1,1,0,1
65564_0,,,,2,1,2,3
65566_0,,,,2,1,2,3
C(CO)(CC=CC(CO)O)=O,,,5,1,1,0,1
65568_0,,,,2,1,2,3
C(CC(CO)O)=CC(C(O)=O)=O,,,5,1,1,0,1
65569_0,,,,2,1,2,3
65571_0,,,,2,1,2,3
C(CC(C(O)=O)=O)=CC(CO)O,,,5,1,1,0,1
65573_0,,,,2,1,2,3
C(CC(CO)O)=C(C(O)=O)C=O,,,5,1,1,0,1
65574_0,,,,2,1,2,3
65576_0,,,,2,1,2,3
C(C(C=O)C=CC(CO)O)(O)=O,,,5,1,1,0,1
65577_0,,,,2,1,2,3
65578_0,,,,2,1,2,3
65579_0,,,,2,1,2,3
65580_0,,,,2,1,2,3
65581_0,,,,2,1,2,3
65582_0,,,,2,1,2,3
65583_0,,,,2,1,2,3
65584_0,,,,2,1,2,3
65585_0,,,,2,1,2,3
65586_0,,,,2,1,2,3
65587_0,,,,2,1,2,3
65588_0,,,,2,1,2,3
65589_0,,,,2,1,2,3
65590_0,,,,2,1,2,3
65591_0,,,,2,1,2,3
65593_0,,,,2,1,2,3
C(C(C(CO)=C)C(CO)O)=O,,,5,1,1,0,1
65595_0,,,,2,1,2,3
C(CO)(C)=C(C=O)C(CO)O,,,5,1,1,0,1
65597_0,,,,2,1,2,3
C(CO)=C(C=O)C(CO)(C)O,,,5,1,2,0,2
65599_0,,,,2,1,2,3
C(C(C(C(O)=O)=C)C(CO)O)=O,,,5,1,1,0,1
65601_0,,,,2,1,2,3
C(C(C)=C(C=O)C(CO)O)(O)=O,,,5,1,1,0,1
65602_0,,,,2,1,2,3
65604_0,,,,2,1,2,3
C(C(C=CC(O)=O)C(CO)O)=O,,,5,1,1,0,1
65606_0,,,,2,1,2,3
C(CC=C(C=O)C(CO)O)(O)=O,,,5,1,2,0,2
65608_0,,,,2,1,2,3
C(CC(C(C=O)=CCO)O)(O)=O,,,5,1,2,0,2
65610_0,,,,2,1,2,3
C=CC(C=O)=C(C=O)C(CO)O,,,5,1,1,0,1
65612_0,,,,2,1,2,3
C(C(C=C)(C(C=O)=CCO)O)=O,,,5,1,2,0,2
65614_0,,,,2,1,2,3
C=CC(C=C(C=O)C(CO)O)=O,,,5,1,1,0,1
65616_0,,,,2,1,2,3
C=CC(C(C(C=O)=CCO)O)=O,,,5,1,2,0,2
65618_0,,,,2,1,2,3
C(C(C(CO)O)=CC=CC=O)=O,,,5,1,1,0,1
65620_0,,,,2,1,2,3
C(C(C(C=O)=CCO)O)=CC=O,,,5,1,2,0,2
65621_0,,,,2,1,2,3
65623_0,,,,2,1,2,3
C(C(O)O)=C(C=O)C(CO)O,,,5,1,1,0,1
65625_0,,,,2,1,2,3
C(CO)=C(C=O)C(C(O)O)O,,,5,1,2,0,2
65626_0,,,,2,1,2,3
65628_0,,,,2,1,2,3
C(C(C)O)=C(C=O)C(CO)O,,,5,1,1,0,1
65630_0,,,,2,1,2,3
C(CO)=C(C=O)C(C(C)O)O,,,5,1,2,0,2
65631_0,,,,2,1,2,3
65632_0,,,,2,1,2,3
65634_0,,,,2,1,2,3
C(C(C(C=O)=O)O)=CC(C=O)=O,,,5,1,3,0,3
65636_0,,,,2,1,2,3
C(C(C(C=O)=O)O)=C(C=O)C=O,,,5,1,2,0,2
65637_0,,,,2,1,2,3
65639_0,,,,2,1,2,3
C(C(C(C=CC(C=O)=O)=O)O)=O,,,5,1,1,0,1
65641_0,,,,2,1,2,3
C(C(C(C=C(C=O)C=O)=O)O)=O,,,5,1,1,0,1
65642_0,,,,2,1,2,3
65643_0,,,,2,1,2,3
65645_0,,,,2,1,2,3
C(C(C(C=O)=CC(C=O)=O)O)=O,,,5,1,1,0,1
65647_0,,,,2,1,2,3
C(C(C(C=O)=C(C=O)C=O)O)=O,,,5,1,1,0,1
65648_0,,,,2,1,2,3
65650_0,,,,2,1,2,3
C(C(C(CO)=CC(C=O)=O)O)=O,,,5,1,1,0,1
65652_0,,,,2,1,2,3
C(C(C(CO)=C(C=O)C=O)O)=O,,,5,1,1,0,1
65653_0,,,,2,1,2,3
65654_0,,,,2,1,2,3
65656_0,,,,2,1,2,3
C(C(C(C(C(CO)=C)O)=O)O)=O,,,5,1,1,0,1
65657_0,,,,2,1,2,3
65658_0,,,,2,1,2,3
65659_0,,,,2,1,2,3
65660_0,,,,2,1,2,3
65661_0,,,,2,1,2,3
65663_0,,,,2,1,2,3
C(C(CO)=CC(CO)=O)(C)=O,,,5,1,1,0,1
65665_0,,,,2,1,2,3
C(C(C=C(C(C)=O)CO)=O)(O)=O,,,5,1,1,0,1
65667_0,,,,2,1,2,3
C(C(C=O)=C(C(C)=O)CO)(O)=O,,,5,1,1,0,1
65668_0,,,,2,1,2,3
65669_0,,,,2,1,2,3
65670_0,,,,2,1,2,3
65671_0,,,,2,1,2,3
65673_0,,,,2,1,2,3
C(C(C)=CC(CO)=O)(CO)=O,,,5,1,1,0,1
65675_0,,,,2,1,2,3
C(CO)(CC(C(CO)=O)=C)=O,,,5,1,1,0,1
65677_0,,,,2,1,2,3
C(C(C=C(C(CO)=O)C)=O)(O)=O,,,5,1,1,0,1
65679_0,,,,2,1,2,3
C=C(C(CO)=O)CC(C(O)=O)=O,,,5,1,1,0,1
65681_0,,,,2,1,2,3
C(C(C=O)=C(C(CO)=O)C)(O)=O,,,5,1,1,0,1
65683_0,,,,2,1,2,3
C(C(C=O)C(C(CO)=O)=C)(O)=O,,,5,1,1,0,1
65684_0,,,,2,1,2,3
65685_0,,,,2,1,2,3
65686_0,,,,2,1,2,3
65687_0,,,,2,1,2,3
65688_0,,,,2,1,2,3
65689_0,,,,2,1,2,3
65690_0,,,,2,1,2,3
65691_0,,,,2,1,2,3
65692_0,,,,2,1,2,3
65694_0,,,,2,1,2,3
C=C(CO)C(C(C(C)=O)=O)O,,,5,1,1,0,1
65696_0,,,,2,1,2,3
C=C(C(O)=O)C(C(C(C)=O)=O)O,,,5,1,1,0,1
65698_0,,,,2,1,2,3
C(C(C(C(C)=O)=O)O)=CC(O)=O,,,5,1,1,0,1
65699_0,,,,2,1,2,3
65700_0,,,,2,1,2,3
65701_0,,,,2,1,2,3
65702_0,,,,2,1,2,3
65704_0,,,,2,1,2,3
C(C(C=CC(C(CO)=O)=O)O)=O,,,5,1,1,0,1
65706_0,,,,2,1,2,3
C=C(CO)CC(C(CO)=O)=O,,,5,1,1,0,1
65708_0,,,,2,1,2,3
C(C)(CO)=CC(C(CO)=O)=O,,,5,1,1,0,1
65710_0,,,,2,1,2,3
C=C(C(O)=O)CC(C(CO)=O)=O,,,5,1,1,0,1
65712_0,,,,2,1,2,3
C(C(C)=CC(C(CO)=O)=O)(O)=O,,,5,1,1,0,1
65714_0,,,,2,1,2,3
C(CC(C(CO)=O)=O)=CC(O)=O,,,5,1,1,0,1
65716_0,,,,2,1,2,3
C(CC=CC(C(CO)=O)=O)(O)=O,,,5,1,1,0,1
65718_0,,,,2,1,2,3
C=CC(C=O)=CC(C(CO)=O)=O,,,5,1,1,0,1
65720_0,,,,2,1,2,3
C=CC(C=CC(C(CO)=O)=O)=O,,,5,1,1,0,1
65722_0,,,,2,1,2,3
C(C=CC=CC(C(CO)=O)=O)=O,,,5,1,1,0,1
65724_0,,,,2,1,2,3
C(C(O)O)=CC(C(CO)=O)=O,,,5,1,1,0,1
65725_0,,,,2,1,2,3
65727_0,,,,2,1,2,3
C(C(C)O)=CC(C(CO)=O)=O,,,5,1,1,0,1
65728_0,,,,2,1,2,3
65729_0,,,,2,1,2,3
65730_0,,,,2,1,2,3
65731_0,,,,2,1,2,3
65732_0,,,,2,1,2,3
65733_0,,,,2,1,2,3
65734_0,,,,2,1,2,3
65735_0,,,,2,1,2,3
65736_0,,,,2,1,2,3
65737_0,,,,2,1,2,3
65738_0,,,,2,1,2,3
65739_0,,,,2,1,2,3
65740_0,,,,2,1,2,3
65741_0,,,,2,1,2,3
65742_0,,,,2,1,2,3
65743_0,,,,2,1,2,3
65744_0,,,,2,1,2,3
65745_0,,,,2,1,2,3
65747_0,,,,2,1,2,3
C(C(C=C(C=O)C(C)O)=O)(O)=O,,,5,1,1,0,1
65748_0,,,,2,1,2,3
65750_0,,,,2,1,2,3
C(C(C=O)=C(C=O)C(C)O)(O)=O,,,5,1,2,0,2
65751_0,,,,2,1,2,3
65752_0,,,,2,1,2,3
65754_0,,,,2,1,2,3
C(C(C=C(C=O)C(C)O)=O)=O,,,5,1,1,0,1
65755_0,,,,2,1,2,3
65757_0,,,,2,1,2,3
C(C(C=O)=C(C=O)C(C)O)=O,,,5,1,1,0,1
65758_0,,,,2,1,2,3
65759_0,,,,2,1,2,3
65760_0,,,,2,1,2,3
65762_0,,,,2,1,2,3
C(C=CC(CO)=O)(C(C)O)=O,,,5,1,1,0,1
65763_0,,,,2,1,2,3
65765_0,,,,2,1,2,3
C(C(C=CC(C(C)O)=O)=O)(O)=O,,,5,1,1,0,1
65766_0,,,,2,1,2,3
65768_0,,,,2,1,2,3
C(C(C=O)=CC(C(C)O)=O)(O)=O,,,5,1,1,0,1
65769_0,,,,2,1,2,3
65770_0,,,,2,1,2,3
65771_0,,,,2,1,2,3
65772_0,,,,2,1,2,3
65773_0,,,,2,1,2,3
65774_0,,,,2,1,2,3
65775_0,,,,2,1,2,3
65776_0,,,,2,1,2,3
65777_0,,,,2,1,2,3
65778_0,,,,2,1,2,3
65780_0,,,,2,1,2,3
C(C(C=CC(C(O)=O)=O)O)=O,,,5,1,3,0,3
65782_0,,,,2,1,2,3
C(C(C=C(C=O)C(C=O)=O)O)=O,,,5,1,1,0,1
65784_0,,,,2,1,2,3
C(C(C=C1C(C(O)OC1)=O)O)=O,,,5,1,1,0,1
65786_0,,,,2,1,2,3
C(C(C(C1C(COC=1)=O)O)O)=O,,,5,1,1,0,1
65788_0,,,,2,1,2,3
C(C(C=C1C(COC1O)=O)O)=O,,,5,1,1,0,1
65789_0,,,,2,1,2,3
65791_0,,,,2,1,2,3
C(C(C=CC(C(C=O)=O)=O)O)=O,,,5,1,1,0,1
65792_0,,,,2,1,2,3
65793_0,,,,2,1,2,3
65794_0,,,,2,1,2,3
65795_0,,,,2,1,2,3
65796_0,,,,2,1,2,3
65797_0,,,,2,1,2,3
65799_0,,,,2,1,2,3
C(C)(C(C(CO)=C)O)=O,,,5,1,1,0,1
65801_0,,,,2,1,2,3
C(C)(CO)=CC(CO)=O,,,5,1,1,0,1
65803_0,,,,2,1,2,3
C(CO)(CC(CO)=C)=O,,,5,1,1,0,1
65804_0,,,,2,1,2,3
65806_0,,,,2,1,2,3
C(CCO)(C(C(CO)=C)O)=O,,,5,1,1,0,1
65808_0,,,,2,1,2,3
C=C(C(CO)=O)C(CO)(C)O,,,5,1,1,0,1
65810_0,,,,2,1,2,3
C(C)(CO)=C(C(CO)=O)CO,,,5,1,1,0,1
65812_0,,,,2,1,2,3
C(CO)(C(C(CO)=C)CO)=O,,,5,1,1,0,1
65814_0,,,,2,1,2,3
C(CO)(C)=CC(C(CO)O)=O,,,5,1,1,0,1
65816_0,,,,2,1,2,3
C(C(CO)O)(CC(CO)=C)=O,,,5,1,1,0,1
65818_0,,,,2,1,2,3
C(C)(CO)=CC(C(O)=O)=O,,,5,1,1,0,1
65820_0,,,,2,1,2,3
C=C(CO)CC(C(O)=O)=O,,,5,1,1,0,1
65822_0,,,,2,1,2,3
C(C)(CO)=C(C(O)=O)C=O,,,5,1,1,0,1
65824_0,,,,2,1,2,3
C(C(C=O)C(CO)=C)(O)=O,,,5,1,1,0,1
65826_0,,,,2,1,2,3
C=C(C(C(O)=O)=O)C(CO)(C)O,,,5,1,1,0,1
65828_0,,,,2,1,2,3
C(C)(CO)=C(C(C(O)=O)=O)CO,,,5,1,1,0,1
65830_0,,,,2,1,2,3
C=C(CO)C(C(C(O)=O)=O)CO,,,5,1,1,0,1
65832_0,,,,2,1,2,3
C(C)(CO)=C(C(O)=O)C(CO)=O,,,5,1,1,0,1
65834_0,,,,2,1,2,3
C(C(C(CO)=O)C(CO)=C)(O)=O,,,5,1,1,0,1
65836_0,,,,2,1,2,3
C(CC(C(C(CO)=C)O)=O)(O)=O,,,5,1,1,0,1
65838_0,,,,2,1,2,3
C(C(C(C=C(CO)C)=O)O)(O)=O,,,5,1,1,0,1
65840_0,,,,2,1,2,3
C(C(C(O)=O)O)(CC(CO)=C)=O,,,5,1,1,0,1
65842_0,,,,2,1,2,3
C=C(CO)C(C(C(O)=O)=O)O,,,5,1,1,0,1
65844_0,,,,2,1,2,3
C(C)(CO)=C(C=O)C(C=O)=O,,,5,1,1,0,1
65846_0,,,,2,1,2,3
C(C(C(CO)=C)C(C=O)=O)=O,,,5,1,1,0,1
65848_0,,,,2,1,2,3
C(C)(CO)=C(C(O)=O)C(C=O)=O,,,5,1,1,0,1
65850_0,,,,2,1,2,3
C(C(C(CO)=C)C(C=O)=O)(O)=O,,,5,1,1,0,1
65852_0,,,,2,1,2,3
C(C)(CO)=C(C=O)C(C(O)=O)=O,,,5,1,1,0,1
65854_0,,,,2,1,2,3
C(C(C(CO)=C)C(C(O)=O)=O)=O,,,5,1,1,0,1
65856_0,,,,2,1,2,3
C1(C(COC1C(CO)=C)O)=O,,,5,1,1,0,1
65858_0,,,,2,1,2,3
C(C)(CO)=C1C(C(O)OC1)=O,,,5,1,1,0,1
65860_0,,,,2,1,2,3
C1(C(O)OCC1C(CO)=C)=O,,,5,1,1,0,1
65862_0,,,,2,1,2,3
C1OCC(C=1C(CO)(C)O)=O,,,5,1,1,0,1
65864_0,,,,2,1,2,3
C(C)(CO)=C1C(COC1O)=O,,,5,1,1,0,1
65866_0,,,,2,1,2,3
C1(COC(C1C(CO)=C)O)=O,,,5,1,1,0,1
65867_0,,,,2,1,2,3
65869_0,,,,2,1,2,3
C1(CC(OC1C(CO)=C)O)=O,,,5,1,1,0,1
65871_0,,,,2,1,2,3
C(C)(CO)=CC(C(C=O)=O)=O,,,5,1,1,0,1
65873_0,,,,2,1,2,3
C=C(CO)CC(C(C=O)=O)=O,,,5,1,1,0,1
65874_0,,,,2,1,2,3
65875_0,,,,2,1,2,3
65876_0,,,,2,1,2,3
65877_0,,,,2,1,2,3
65878_0,,,,2,1,2,3
65879_0,,,,2,1,2,3
65880_0,,,,2,1,2,3
65881_0,,,,2,1,2,3
65882_0,,,,2,1,2,3
65883_0,,,,2,1,2,3
65884_0,,,,2,1,2,3
65885_0,,,,2,1,2,3
65886_0,,,,2,1,2,3
65887_0,,,,2,1,2,3
65888_0,,,,2,1,2,3
65889_0,,,,2,1,2,3
65890_0,,,,2,1,2,3
65891_0,,,,2,1,2,3
65892_0,,,,2,1,2,3
65893_0,,,,2,1,2,3
65894_0,,,,2,1,2,3
65896_0,,,,2,1,2,3
C(C)(C(C(CO)=CCO)O)=O,,,5,1,1,0,1
65897_0,,,,2,1,2,3
65898_0,,,,2,1,2,3
65899_0,,,,2,1,2,3
65901_0,,,,2,1,2,3
C(C)(C(C(C(CO)O)=C)O)=O,,,5,1,1,0,1
65902_0,,,,2,1,2,3
65903_0,,,,2,1,2,3
65905_0,,,,2,1,2,3
C(C)(C(C(CO)=CC(O)=O)O)=O,,,5,1,2,0,2
65906_0,,,,2,1,2,3
65907_0,,,,2,1,2,3
65908_0,,,,2,1,2,3
65909_0,,,,2,1,2,3
65911_0,,,,2,1,2,3
C(C)(C(C1C(O)OCC=1)O)=O,,,5,1,1,0,1
65912_0,,,,2,1,2,3
65914_0,,,,2,1,2,3
C(C)(C(C1COC(C=1)O)O)=O,,,5,1,1,0,1
65915_0,,,,2,1,2,3
65916_0,,,,2,1,2,3
65917_0,,,,2,1,2,3
65918_0,,,,2,1,2,3
65919_0,,,,2,1,2,3
65920_0,,,,2,1,2,3
65921_0,,,,2,1,2,3
65922_0,,,,2,1,2,3
65923_0,,,,2,1,2,3
65924_0,,,,2,1,2,3
65926_0,,,,2,1,2,3
C(C(C(C(C(C)=O)O)=C)O)=O,,,5,1,3,0,3
65928_0,,,,2,1,2,3
C(C)(C(C=C)O)=O,,,5,1,2,0,2
65930_0,,,,2,1,2,3
C(CO)(CC(CO)=CCO)=O,,,5,1,1,0,1
65931_0,,,,2,1,2,3
65933_0,,,,2,1,2,3
C(CO)(CCO)=CC(CO)=O,,,5,1,1,0,1
65934_0,,,,2,1,2,3
65935_0,,,,2,1,2,3
65937_0,,,,2,1,2,3
C(C(CCO)O)=CC(CO)=O,,,5,1,1,0,1
65939_0,,,,2,1,2,3
C(CO)(CC(C(CO)O)=C)=O,,,5,1,1,0,1
65941_0,,,,2,1,2,3
C(C)(C(CO)O)=CC(CO)=O,,,5,1,1,0,1
65942_0,,,,2,1,2,3
65944_0,,,,2,1,2,3
C(C(C)=CC(CO)=O)(O)=O,,,5,1,1,0,1
65945_0,,,,2,1,2,3
65946_0,,,,2,1,2,3
65948_0,,,,2,1,2,3
C(CO)(CC(C(O)=O)=CCO)=O,,,5,1,1,0,1
65949_0,,,,2,1,2,3
65951_0,,,,2,1,2,3
C(C(CCO)=CC(CO)=O)(O)=O,,,5,1,1,0,1
65952_0,,,,2,1,2,3
65954_0,,,,2,1,2,3
C(CC(C=CC(CO)=O)O)(O)=O,,,5,1,1,0,1
65956_0,,,,2,1,2,3
C(CO)(CC(CO)=CC(O)=O)=O,,,5,1,1,0,1
65958_0,,,,2,1,2,3
C(CC(CO)=CC(CO)=O)(O)=O,,,5,1,2,0,2
65960_0,,,,2,1,2,3
C(C(C(CC(CO)=O)=C)O)(O)=O,,,5,1,1,0,1
65962_0,,,,2,1,2,3
C(C(C(C)=CC(CO)=O)O)(O)=O,,,5,1,1,0,1
65963_0,,,,2,1,2,3
65964_0,,,,2,1,2,3
65966_0,,,,2,1,2,3
C(CC(C=O)=CC(CO)=O)=O,,,5,1,3,0,3
65968_0,,,,2,1,2,3
C(CC(C=CC(CO)=O)=O)=O,,,5,1,2,0,2
65970_0,,,,2,1,2,3
C(CO)(CC(C=O)=CC(O)=O)=O,,,5,1,1,0,1
65972_0,,,,2,1,2,3
C(CC(C=O)=CC(CO)=O)(O)=O,,,5,1,1,0,1
65974_0,,,,2,1,2,3
C(CC(C=CC(CO)=O)=O)(O)=O,,,5,1,1,0,1
65975_0,,,,2,1,2,3
65976_0,,,,2,1,2,3
65978_0,,,,2,1,2,3
C(CO)(CC(C(O)=O)=CC=O)=O,,,5,1,1,0,1
65980_0,,,,2,1,2,3
C(CC(C(O)=O)=CC(CO)=O)=O,,,5,1,1,0,1
65982_0,,,,2,1,2,3
C1(COCC1O)=CC(CO)=O,,,5,1,1,0,1
65984_0,,,,2,1,2,3
C(CO)(CC1C(O)OCC=1)=O,,,5,1,1,0,1
65986_0,,,,2,1,2,3
C1(C(O)OCC1)=CC(CO)=O,,,5,1,1,0,1
65987_0,,,,2,1,2,3
65989_0,,,,2,1,2,3
C(CO)(CC1COC(C=1)O)=O,,,5,1,1,0,1
65991_0,,,,2,1,2,3
C1(COC(C1)O)=CC(CO)=O,,,5,1,1,0,1
65993_0,,,,2,1,2,3
C(C(C(C)=O)=CC(CO)=O)=O,,,5,1,1,0,1
65994_0,,,,2,1,2,3
65995_0,,,,2,1,2,3
65997_0,,,,2,1,2,3
C(C(C(C)=CC(CO)=O)=O)=O,,,5,1,2,0,2
65999_0,,,,2,1,2,3
C=CC(C=O)=CC(CO)=O,,,5,1,1,0,1
66001_0,,,,2,1,2,3
C=CC(C=CC(CO)=O)=O,,,5,1,1,0,1
66003_0,,,,2,1,2,3
C(C=CC=CC(CO)=O)=O,,,5,1,1,0,1
66005_0,,,,2,1,2,3
C1(C(O)OCC1O)=CC(CO)=O,,,5,1,1,0,1
66007_0,,,,2,1,2,3
C(C(O)O)=CC(CO)=O,,,5,1,1,0,1
66008_0,,,,2,1,2,3
66010_0,,,,2,1,2,3
C(C(C)O)=CC(CO)=O,,,5,1,2,0,2
66011_0,,,,2,1,2,3
66012_0,,,,2,1,2,3
66013_0,,,,2,1,2,3
66014_0,,,,2,1,2,3
66015_0,,,,2,1,2,3
66016_0,,,,2,1,2,3
66017_0,,,,2,1,2,3
66018_0,,,,2,1,2,3
66019_0,,,,2,1,2,3
66020_0,,,,2,1,2,3
66021_0,,,,2,1,2,3
66022_0,,,,2,1,2,3
66023_0,,,,2,1,2,3
66024_0,,,,2,1,2,3
66025_0,,,,2,1,2,3
66026_0,,,,2,1,2,3
66027_0,,,,2,1,2,3
66028_0,,,,2,1,2,3
66029_0,,,,2,1,2,3
66030_0,,,,2,1,2,3
66031_0,,,,2,1,2,3
66032_0,,,,2,1,2,3
66033_0,,,,2,1,2,3
66034_0,,,,2,1,2,3
66035_0,,,,2,1,2,3
66036_0,,,,2,1,2,3
66037_0,,,,2,1,2,3
66038_0,,,,2,1,2,3
66039_0,,,,2,1,2,3
66040_0,,,,2,1,2,3
66042_0,,,,2,1,2,3
C(CO)(CCO)=CC(C(O)=O)=O,,,5,1,1,0,1
66044_0,,,,2,1,2,3
C(CO)=C(CO)CC(C(O)=O)=O,,,5,1,1,0,1
66045_0,,,,2,1,2,3
66047_0,,,,2,1,2,3
C(CO)(CCO)=C(C(O)=O)C=O,,,5,1,1,0,1
66049_0,,,,2,1,2,3
C(C(C=O)C(CO)=CCO)(O)=O,,,5,1,1,0,1
66050_0,,,,2,1,2,3
66051_0,,,,2,1,2,3
66052_0,,,,2,1,2,3
66053_0,,,,2,1,2,3
66054_0,,,,2,1,2,3
66055_0,,,,2,1,2,3
66056_0,,,,2,1,2,3
66057_0,,,,2,1,2,3
66058_0,,,,2,1,2,3
66059_0,,,,2,1,2,3
66060_0,,,,2,1,2,3
66061_0,,,,2,1,2,3
66062_0,,,,2,1,2,3
66063_0,,,,2,1,2,3
66064_0,,,,2,1,2,3
66065_0,,,,2,1,2,3
66067_0,,,,2,1,2,3
C(CCO)(C(C=CC(O)=O)O)=O,,,5,1,2,0,2
66068_0,,,,2,1,2,3
66069_0,,,,2,1,2,3
66070_0,,,,2,1,2,3
66071_0,,,,2,1,2,3
66072_0,,,,2,1,2,3
66073_0,,,,2,1,2,3
66074_0,,,,2,1,2,3
66075_0,,,,2,1,2,3
66076_0,,,,2,1,2,3
66077_0,,,,2,1,2,3
66078_0,,,,2,1,2,3
66079_0,,,,2,1,2,3
66080_0,,,,2,1,2,3
66081_0,,,,2,1,2,3
66082_0,,,,2,1,2,3
66084_0,,,,2,1,2,3
C(CO)(C(C(C(O)=O)=C)CO)=O,,,5,1,1,0,1
66086_0,,,,2,1,2,3
C(C(C)=C(C(CO)=O)CO)(O)=O,,,5,1,1,0,1
66087_0,,,,2,1,2,3
66089_0,,,,2,1,2,3
C(CO)(C(C=CC(O)=O)CO)=O,,,5,1,1,0,1
66091_0,,,,2,1,2,3
C(CC=C(C(CO)=O)CO)(O)=O,,,5,1,2,0,2
66093_0,,,,2,1,2,3
C(CC(C(C(CO)=O)=C)O)(O)=O,,,5,1,1,0,1
66095_0,,,,2,1,2,3
C=CC(C=O)=C(C(CO)=O)CO,,,5,1,1,0,1
66097_0,,,,2,1,2,3
C(C(C=C)(C(C(CO)=O)=C)O)=O,,,5,1,1,0,1
66099_0,,,,2,1,2,3
C=CC(C=C(C(CO)=O)CO)=O,,,5,1,1,0,1
66101_0,,,,2,1,2,3
C=CC(C(C(C(CO)=O)=C)O)=O,,,5,1,1,0,1
66103_0,,,,2,1,2,3
C(C=CC=C(C(CO)=O)CO)=O,,,5,1,1,0,1
66105_0,,,,2,1,2,3
C(C(C(C(CO)=O)=C)O)=CC=O,,,5,1,1,0,1
66106_0,,,,2,1,2,3
66108_0,,,,2,1,2,3
C(C(O)O)=C(C(CO)=O)CO,,,5,1,1,0,1
66110_0,,,,2,1,2,3
C=C(C(CO)=O)C(C(O)O)O,,,5,1,1,0,1
66111_0,,,,2,1,2,3
66113_0,,,,2,1,2,3
C(C(C)O)=C(C(CO)=O)CO,,,5,1,1,0,1
66115_0,,,,2,1,2,3
C=C(C(CO)=O)C(C(C)O)O,,,5,1,1,0,1
66116_0,,,,2,1,2,3
66117_0,,,,2,1,2,3
66118_0,,,,2,1,2,3
66119_0,,,,2,1,2,3
66120_0,,,,2,1,2,3
66121_0,,,,2,1,2,3
66122_0,,,,2,1,2,3
66123_0,,,,2,1,2,3
66124_0,,,,2,1,2,3
66125_0,,,,2,1,2,3
66126_0,,,,2,1,2,3
66127_0,,,,2,1,2,3
66128_0,,,,2,1,2,3
66129_0,,,,2,1,2,3
66130_0,,,,2,1,2,3
66131_0,,,,2,1,2,3
66132_0,,,,2,1,2,3
66133_0,,,,2,1,2,3
66134_0,,,,2,1,2,3
66135_0,,,,2,1,2,3
66136_0,,,,2,1,2,3
66137_0,,,,2,1,2,3
66138_0,,,,2,1,2,3
66140_0,,,,2,1,2,3
C(C(CCO)O)=CC(C(O)=O)=O,,,5,1,1,0,1
66141_0,,,,2,1,2,3
66142_0,,,,2,1,2,3
66144_0,,,,2,1,2,3
C(C(CCO)O)=C(C(O)=O)C=O,,,5,1,1,0,1
66145_0,,,,2,1,2,3
66146_0,,,,2,1,2,3
66147_0,,,,2,1,2,3
66148_0,,,,2,1,2,3
66149_0,,,,2,1,2,3
66150_0,,,,2,1,2,3
66151_0,,,,2,1,2,3
66152_0,,,,2,1,2,3
66153_0,,,,2,1,2,3
66154_0,,,,2,1,2,3
66155_0,,,,2,1,2,3
66156_0,,,,2,1,2,3
66157_0,,,,2,1,2,3
66158_0,,,,2,1,2,3
66159_0,,,,2,1,2,3
66160_0,,,,2,1,2,3
66161_0,,,,2,1,2,3
66163_0,,,,2,1,2,3
C(C)(C(CO)O)=CC(C(O)=O)=O,,,5,1,1,0,1
66165_0,,,,2,1,2,3
C=C(C(CO)O)CC(C(O)=O)=O,,,5,1,1,0,1
66167_0,,,,2,1,2,3
C(C)(C(CO)O)=C(C(O)=O)C=O,,,5,1,1,0,1
66169_0,,,,2,1,2,3
C(C(C=O)C(C(CO)O)=C)(O)=O,,,5,1,1,0,1
66170_0,,,,2,1,2,3
66171_0,,,,2,1,2,3
66172_0,,,,2,1,2,3
66173_0,,,,2,1,2,3
66174_0,,,,2,1,2,3
66175_0,,,,2,1,2,3
66176_0,,,,2,1,2,3
66177_0,,,,2,1,2,3
66178_0,,,,2,1,2,3
66180_0,,,,2,1,2,3
C(C(CO)O)(CC(C(O)=O)=C)=O,,,5,1,1,0,1
66182_0,,,,2,1,2,3
C(C=C(C(O)=O)C)(C(CO)O)=O,,,5,1,1,0,1
66184_0,,,,2,1,2,3
C(C(CO)O)(CC=CC(O)=O)=O,,,5,1,1,0,1
66186_0,,,,2,1,2,3
C(CC=CC(C(CO)O)=O)(O)=O,,,5,1,2,0,2
66188_0,,,,2,1,2,3
C=CC(C=O)=CC(C(CO)O)=O,,,5,1,1,0,1
66190_0,,,,2,1,2,3
C=CC(C=CC(C(CO)O)=O)=O,,,5,1,1,0,1
66192_0,,,,2,1,2,3
C(C=CC=CC(C(CO)O)=O)=O,,,5,1,1,0,1
66194_0,,,,2,1,2,3
C(C(O)O)=CC(C(CO)O)=O,,,5,1,1,0,1
66195_0,,,,2,1,2,3
66197_0,,,,2,1,2,3
C(C(C)O)=CC(C(CO)O)=O,,,5,1,1,0,1
66198_0,,,,2,1,2,3
66199_0,,,,2,1,2,3
66200_0,,,,2,1,2,3
66201_0,,,,2,1,2,3
66202_0,,,,2,1,2,3
66203_0,,,,2,1,2,3
66204_0,,,,2,1,2,3
66205_0,,,,2,1,2,3
66206_0,,,,2,1,2,3
66207_0,,,,2,1,2,3
66209_0,,,,2,1,2,3
C(C(C)=CC(C(O)=O)=O)(O)=O,,,5,1,1,0,1
66211_0,,,,2,1,2,3
C=C(C(O)=O)CC(C(O)=O)=O,,,5,1,1,0,1
66213_0,,,,2,1,2,3
C(C(C(O)=O)=C(C(O)=O)C)=O,,,5,1,1,0,1
66215_0,,,,2,1,2,3
C(C(C(O)=O)C(C(O)=O)=C)=O,,,5,1,1,0,1
66217_0,,,,2,1,2,3
C=C(C(O)=O)C(C(C(O)=O)=O)O,,,5,1,1,0,1
66219_0,,,,2,1,2,3
C(C(C(C=O)=O)=C(C(O)=O)C)=O,,,5,1,1,0,1
66221_0,,,,2,1,2,3
C(C(C(C=O)=O)C(C(O)=O)=C)=O,,,5,1,1,0,1
66223_0,,,,2,1,2,3
C1(C(COC1C(C(O)=O)=C)O)=O,,,5,1,1,0,1
66225_0,,,,2,1,2,3
C(C(C)=C1C(C(O)OC1)=O)(O)=O,,,5,1,1,0,1
66227_0,,,,2,1,2,3
C1(C(O)OCC1C(C(O)=O)=C)=O,,,5,1,1,0,1
66229_0,,,,2,1,2,3
C(C(C1C(COC=1)=O)(C)O)(O)=O,,,5,1,1,0,1
66231_0,,,,2,1,2,3
C(C(C)=C1C(COC1O)=O)(O)=O,,,5,1,1,0,1
66233_0,,,,2,1,2,3
C1(COC(C1C(C(O)=O)=C)O)=O,,,5,1,1,0,1
66234_0,,,,2,1,2,3
66236_0,,,,2,1,2,3
C1(CC(OC1C(C(O)=O)=C)O)=O,,,5,1,1,0,1
66238_0,,,,2,1,2,3
C(C(C(C=C(C(O)=O)C)=O)=O)=O,,,5,1,1,0,1
66240_0,,,,2,1,2,3
C=C(C(O)=O)CC(C(C=O)=O)=O,,,5,1,1,0,1
66241_0,,,,2,1,2,3
66242_0,,,,2,1,2,3
66243_0,,,,2,1,2,3
66244_0,,,,2,1,2,3
66245_0,,,,2,1,2,3
66246_0,,,,2,1,2,3
66247_0,,,,2,1,2,3
66248_0,,,,2,1,2,3
66249_0,,,,2,1,2,3
66250_0,,,,2,1,2,3
66251_0,,,,2,1,2,3
66252_0,,,,2,1,2,3
66253_0,,,,2,1,2,3
66254_0,,,,2,1,2,3
66255_0,,,,2,1,2,3
66256_0,,,,2,1,2,3
66257_0,,,,2,1,2,3
66258_0,,,,2,1,2,3
66260_0,,,,2,1,2,3
C(CC(C(O)=O)=O)=CC(O)=O,,,5,1,2,0,2
66262_0,,,,2,1,2,3
C(CC=CC(C(O)=O)=O)(O)=O,,,5,1,3,0,3
66264_0,,,,2,1,2,3
C(C(CO)=CC(C(O)=O)=O)(O)=O,,,5,1,1,0,1
66266_0,,,,2,1,2,3
C(C(CC(C(O)=O)=O)=CC=O)=O,,,5,1,1,0,1
66268_0,,,,2,1,2,3
C(CC(C=O)=CC(C(O)=O)=O)=O,,,5,1,2,0,2
66270_0,,,,2,1,2,3
C(CC(C=CC(C(O)=O)=O)=O)=O,,,5,1,1,0,1
66272_0,,,,2,1,2,3
C(CC(C(O)=O)=O)=CC(C=O)=O,,,5,1,1,0,1
66274_0,,,,2,1,2,3
C(CC(C=O)=O)=CC(C(O)=O)=O,,,5,1,2,0,2
66276_0,,,,2,1,2,3
C1(COCC1O)=CC(C(O)=O)=O,,,5,1,1,0,1
66278_0,,,,2,1,2,3
C1COC(C=1CC(C(O)=O)=O)O,,,5,1,1,0,1
66280_0,,,,2,1,2,3
C1(C(O)OCC1)=CC(C(O)=O)=O,,,5,1,1,0,1
66281_0,,,,2,1,2,3
66283_0,,,,2,1,2,3
C1C(O)OCC=1CC(C(O)=O)=O,,,5,1,1,0,1
66285_0,,,,2,1,2,3
C1(COC(C1)O)=CC(C(O)=O)=O,,,5,1,1,0,1
66287_0,,,,2,1,2,3
C(C(C(C)=O)=CC(C(O)=O)=O)=O,,,5,1,1,0,1
66289_0,,,,2,1,2,3
C(C(C=CC(C(C)=O)=O)=O)(O)=O,,,5,1,1,0,1
66291_0,,,,2,1,2,3
C=C(C(C=O)=O)CC(C(O)=O)=O,,,5,1,1,0,1
66293_0,,,,2,1,2,3
C(C(C(C)=CC(C(O)=O)=O)=O)=O,,,5,1,1,0,1
66295_0,,,,2,1,2,3
C=CC(C=O)=CC(C(O)=O)=O,,,5,1,1,0,1
66297_0,,,,2,1,2,3
C=CC(C=CC(C(O)=O)=O)=O,,,5,1,1,0,1
66299_0,,,,2,1,2,3
C(C=CC=CC(C(O)=O)=O)=O,,,5,1,1,0,1
66301_0,,,,2,1,2,3
C(C(O)O)=CC(C(O)=O)=O,,,5,1,1,0,1
66302_0,,,,2,1,2,3
66304_0,,,,2,1,2,3
C(C(C)O)=CC(C(O)=O)=O,,,5,1,1,0,1
66305_0,,,,2,1,2,3
66306_0,,,,2,1,2,3
66307_0,,,,2,1,2,3
66308_0,,,,2,1,2,3
66309_0,,,,2,1,2,3
66310_0,,,,2,1,2,3
66311_0,,,,2,1,2,3
66312_0,,,,2,1,2,3
66313_0,,,,2,1,2,3
66314_0,,,,2,1,2,3
66315_0,,,,2,1,2,3
66316_0,,,,2,1,2,3
66317_0,,,,2,1,2,3
66318_0,,,,2,1,2,3
66319_0,,,,2,1,2,3
66320_0,,,,2,1,2,3
66321_0,,,,2,1,2,3
66322_0,,,,2,1,2,3
66323_0,,,,2,1,2,3
66324_0,,,,2,1,2,3
66325_0,,,,2,1,2,3
66326_0,,,,2,1,2,3
66327_0,,,,2,1,2,3
66328_0,,,,2,1,2,3
66329_0,,,,2,1,2,3
66330_0,,,,2,1,2,3
66332_0,,,,2,1,2,3
C(CC=C(C=O)C(O)=O)(O)=O,,,5,1,2,0,2
66334_0,,,,2,1,2,3
C(C(C(O)=O)C=CC(O)=O)=O,,,5,1,2,0,2
66336_0,,,,2,1,2,3
C(C(C(C(O)=O)=O)O)=CC(O)=O,,,5,1,1,0,1
66338_0,,,,2,1,2,3
C(CC=C(C=O)C(C=O)=O)(O)=O,,,5,1,2,0,2
66340_0,,,,2,1,2,3
C(C(C=CC(O)=O)C(C=O)=O)=O,,,5,1,1,0,1
66342_0,,,,2,1,2,3
C1(C(COC1C=CC(O)=O)O)=O,,,5,1,1,0,1
66344_0,,,,2,1,2,3
C(CC=C1C(C(O)OC1)=O)(O)=O,,,5,1,2,0,2
66346_0,,,,2,1,2,3
C1(C(O)OCC1C=CC(O)=O)=O,,,5,1,1,0,1
66348_0,,,,2,1,2,3
C(CC(C1C(COC=1)=O)O)(O)=O,,,5,1,1,0,1
66350_0,,,,2,1,2,3
C(CC=C1C(COC1O)=O)(O)=O,,,5,1,1,0,1
66352_0,,,,2,1,2,3
C1(COC(C1C=CC(O)=O)O)=O,,,5,1,1,0,1
66353_0,,,,2,1,2,3
66355_0,,,,2,1,2,3
C1(CC(OC1C=CC(O)=O)O)=O,,,5,1,1,0,1
66357_0,,,,2,1,2,3
C(CC=CC(C(C=O)=O)=O)(O)=O,,,5,1,1,0,1
66359_0,,,,2,1,2,3
C(CC(C(C=O)=O)=O)=CC(O)=O,,,5,1,1,0,1
66360_0,,,,2,1,2,3
66361_0,,,,2,1,2,3
66362_0,,,,2,1,2,3
66363_0,,,,2,1,2,3
66364_0,,,,2,1,2,3
66365_0,,,,2,1,2,3
66366_0,,,,2,1,2,3
66367_0,,,,2,1,2,3
66368_0,,,,2,1,2,3
66369_0,,,,2,1,2,3
66370_0,,,,2,1,2,3
66371_0,,,,2,1,2,3
66372_0,,,,2,1,2,3
66373_0,,,,2,1,2,3
66374_0,,,,2,1,2,3
66375_0,,,,2,1,2,3
66376_0,,,,2,1,2,3
66377_0,,,,2,1,2,3
66378_0,,,,2,1,2,3
66379_0,,,,2,1,2,3
66381_0,,,,2,1,2,3
C(C(C=O)=C(C(O)=O)CO)(O)=O,,,5,1,1,0,1
66383_0,,,,2,1,2,3
C(C(C(O)=O)C(C=O)=CC=O)=O,,,5,1,1,0,1
66385_0,,,,2,1,2,3
C(CC(C=O)=C(C=O)C(O)=O)=O,,,5,1,1,0,1
66387_0,,,,2,1,2,3
C(CC(C=C(C=O)C(O)=O)=O)=O,,,5,1,1,0,1
66389_0,,,,2,1,2,3
C1(COCC1O)=C(C(O)=O)C=O,,,5,1,1,0,1
66391_0,,,,2,1,2,3
C(C(C=O)C1C(O)OCC=1)(O)=O,,,5,1,1,0,1
66393_0,,,,2,1,2,3
C1(C(O)OCC1)=C(C(O)=O)C=O,,,5,1,1,0,1
66394_0,,,,2,1,2,3
66396_0,,,,2,1,2,3
C(C(C=O)C1COC(C=1)O)(O)=O,,,5,1,1,0,1
66398_0,,,,2,1,2,3
C1(COC(C1)O)=C(C(O)=O)C=O,,,5,1,1,0,1
66400_0,,,,2,1,2,3
C(C(C(O)=O)=C(C=O)C(C)=O)=O,,,5,1,1,0,1
66402_0,,,,2,1,2,3
C(C(C(O)=O)=CC(C(C)=O)=O)=O,,,5,1,1,0,1
66404_0,,,,2,1,2,3
C(C(C(O)=O)C(C(C=O)=O)=C)=O,,,5,1,1,0,1
66406_0,,,,2,1,2,3
C(C(C(O)=O)=C(C(C=O)=O)C)=O,,,5,1,1,0,1
66408_0,,,,2,1,2,3
C=CC(C=O)=C(C=O)C(O)=O,,,5,1,1,0,1
66410_0,,,,2,1,2,3
C=CC(C=C(C=O)C(O)=O)=O,,,5,1,1,0,1
66412_0,,,,2,1,2,3
C(C(C(O)=O)=CC=CC=O)=O,,,5,1,1,0,1
66414_0,,,,2,1,2,3
C(C(O)O)=C(C(O)=O)C=O,,,5,1,1,0,1
66415_0,,,,2,1,2,3
66417_0,,,,2,1,2,3
C(C(C)O)=C(C(O)=O)C=O,,,5,1,1,0,1
66418_0,,,,2,1,2,3
66419_0,,,,2,1,2,3
66420_0,,,,2,1,2,3
66421_0,,,,2,1,2,3
66422_0,,,,2,1,2,3
66423_0,,,,2,1,2,3
66424_0,,,,2,1,2,3
66425_0,,,,2,1,2,3
66426_0,,,,2,1,2,3
66427_0,,,,2,1,2,3
66429_0,,,,2,1,2,3
C=C(C(O)=O)C(C(O)=O)=O,,,5,1,4,0,4
66431_0,,,,2,1,2,3
C(C(O)O)=C(C(C(O)=O)=O)CO,,,5,1,1,0,1
66433_0,,,,2,1,2,3
C=C(C(C(O)=O)=O)C(C(O)O)O,,,5,1,1,0,1
66434_0,,,,2,1,2,3
66436_0,,,,2,1,2,3
C(C(C)O)=C(C(C(O)=O)=O)CO,,,5,1,1,0,1
66438_0,,,,2,1,2,3
C=C(C(C(O)=O)=O)C(C(C)O)O,,,5,1,1,0,1
66439_0,,,,2,1,2,3
66440_0,,,,2,1,2,3
66441_0,,,,2,1,2,3
66442_0,,,,2,1,2,3
66443_0,,,,2,1,2,3
66444_0,,,,2,1,2,3
66445_0,,,,2,1,2,3
66446_0,,,,2,1,2,3
66447_0,,,,2,1,2,3
66448_0,,,,2,1,2,3
66449_0,,,,2,1,2,3
66450_0,,,,2,1,2,3
66451_0,,,,2,1,2,3
66452_0,,,,2,1,2,3
66453_0,,,,2,1,2,3
66454_0,,,,2,1,2,3
66455_0,,,,2,1,2,3
66456_0,,,,2,1,2,3
66457_0,,,,2,1,2,3
66458_0,,,,2,1,2,3
66459_0,,,,2,1,2,3
66460_0,,,,2,1,2,3
66461_0,,,,2,1,2,3
66462_0,,,,2,1,2,3
66463_0,,,,2,1,2,3
66464_0,,,,2,1,2,3
66465_0,,,,2,1,2,3
66466_0,,,,2,1,2,3
66467_0,,,,2,1,2,3
66468_0,,,,2,1,2,3
66469_0,,,,2,1,2,3
66470_0,,,,2,1,2,3
66472_0,,,,2,1,2,3
C(C(O)O)=C(C(O)=O)C(CO)=O,,,5,1,1,0,1
66473_0,,,,2,1,2,3
66475_0,,,,2,1,2,3
C(C(C)O)=C(C(O)=O)C(CO)=O,,,5,1,1,0,1
66476_0,,,,2,1,2,3
66477_0,,,,2,1,2,3
66478_0,,,,2,1,2,3
66479_0,,,,2,1,2,3
66480_0,,,,2,1,2,3
66481_0,,,,2,1,2,3
66482_0,,,,2,1,2,3
66483_0,,,,2,1,2,3
66484_0,,,,2,1,2,3
66485_0,,,,2,1,2,3
66486_0,,,,2,1,2,3
66487_0,,,,2,1,2,3
66488_0,,,,2,1,2,3
66489_0,,,,2,1,2,3
66490_0,,,,2,1,2,3
66491_0,,,,2,1,2,3
66492_0,,,,2,1,2,3
66494_0,,,,2,1,2,3
C(C(C(C=CC(O)O)=O)O)(O)=O,,,5,1,1,0,1
66495_0,,,,2,1,2,3
66497_0,,,,2,1,2,3
C(C(C(C=CC(C)O)=O)O)(O)=O,,,5,1,1,0,1
66498_0,,,,2,1,2,3
66499_0,,,,2,1,2,3
66500_0,,,,2,1,2,3
66501_0,,,,2,1,2,3
66502_0,,,,2,1,2,3
66503_0,,,,2,1,2,3
66504_0,,,,2,1,2,3
66505_0,,,,2,1,2,3
66506_0,,,,2,1,2,3
66507_0,,,,2,1,2,3
66508_0,,,,2,1,2,3
66509_0,,,,2,1,2,3
66510_0,,,,2,1,2,3
66511_0,,,,2,1,2,3
66512_0,,,,2,1,2,3
66513_0,,,,2,1,2,3
66514_0,,,,2,1,2,3
66515_0,,,,2,1,2,3
66516_0,,,,2,1,2,3
66518_0,,,,2,1,2,3
C(C(C=C(C=O)CO)(CO)O)=O,,,5,1,1,0,1
66519_0,,,,2,1,2,3
66520_0,,,,2,1,2,3
66521_0,,,,2,1,2,3
66522_0,,,,2,1,2,3
66523_0,,,,2,1,2,3
66524_0,,,,2,1,2,3
66525_0,,,,2,1,2,3
66526_0,,,,2,1,2,3
66527_0,,,,2,1,2,3
66528_0,,,,2,1,2,3
66529_0,,,,2,1,2,3
66530_0,,,,2,1,2,3
66531_0,,,,2,1,2,3
66532_0,,,,2,1,2,3
66533_0,,,,2,1,2,3
66534_0,,,,2,1,2,3
66535_0,,,,2,1,2,3
66536_0,,,,2,1,2,3
66537_0,,,,2,1,2,3
66538_0,,,,2,1,2,3
66540_0,,,,2,1,2,3
C(C(CO)(C(C)O)O)=CC=O,,,5,1,1,0,1
66541_0,,,,2,1,2,3
66542_0,,,,2,1,2,3
66543_0,,,,2,1,2,3
66544_0,,,,2,1,2,3
66545_0,,,,2,1,2,3
66546_0,,,,2,1,2,3
66547_0,,,,2,1,2,3
66548_0,,,,2,1,2,3
66549_0,,,,2,1,2,3
66550_0,,,,2,1,2,3
66551_0,,,,2,1,2,3
66553_0,,,,2,1,2,3
C(C(C=C(C=O)CO)(C)O)(O)=O,,,5,1,1,0,1
66554_0,,,,2,1,2,3
66555_0,,,,2,1,2,3
66556_0,,,,2,1,2,3
66558_0,,,,2,1,2,3
C(C(C=C(C(O)=O)C=O)O)(O)=O,,,5,1,1,0,1
66559_0,,,,2,1,2,3
66560_0,,,,2,1,2,3
66562_0,,,,2,1,2,3
C(C(C=C(C=O)C(C)O)O)(O)=O,,,5,1,1,0,1
66563_0,,,,2,1,2,3
66564_0,,,,2,1,2,3
66566_0,,,,2,1,2,3
C(CC(C=CC=O)(C(C)O)O)=O,,,5,1,1,0,1
66567_0,,,,2,1,2,3
66568_0,,,,2,1,2,3
66569_0,,,,2,1,2,3
66570_0,,,,2,1,2,3
66571_0,,,,2,1,2,3
66572_0,,,,2,1,2,3
66574_0,,,,2,1,2,3
C(C(CC(CO)=CC=O)O)=O,,,5,1,2,0,2
66575_0,,,,2,1,2,3
66577_0,,,,2,1,2,3
C(CC(CO)=CC(C=O)O)=O,,,5,1,2,0,2
66578_0,,,,2,1,2,3
66579_0,,,,2,1,2,3
66581_0,,,,2,1,2,3
C(C(C(C(CO)=O)=CC=O)O)=O,,,5,1,2,0,2
66583_0,,,,2,1,2,3
C(C(C(C(CO)=O)C=C)O)=O,,,5,1,1,0,1
66585_0,,,,2,1,2,3
C(C(C(C(CO)=O)=CC)O)=O,,,5,1,1,0,1
66587_0,,,,2,1,2,3
C(C=C(C(CO)=O)C(C)O)=O,,,5,1,2,0,2
66589_0,,,,2,1,2,3
C(C(C(C(CO)=O)=CCO)O)=O,,,5,1,1,0,1
66591_0,,,,2,1,2,3
C(C=C(C(CO)=O)C(CO)O)=O,,,5,1,2,0,2
66593_0,,,,2,1,2,3
C(C(CC(C(C=C)O)=O)O)=O,,,5,1,1,0,1
66594_0,,,,2,1,2,3
66595_0,,,,2,1,2,3
66596_0,,,,2,1,2,3
66597_0,,,,2,1,2,3
66598_0,,,,2,1,2,3
66600_0,,,,2,1,2,3
C(C(CC(C=O)=O)=CC=O)=O,,,5,1,1,0,1
66601_0,,,,2,1,2,3
66602_0,,,,2,1,2,3
66603_0,,,,2,1,2,3
66605_0,,,,2,1,2,3
C(C(C(C(C=O)=O)O)=CC=O)=O,,,5,1,1,0,1
66606_0,,,,2,1,2,3
66607_0,,,,2,1,2,3
66608_0,,,,2,1,2,3
66609_0,,,,2,1,2,3
66610_0,,,,2,1,2,3
66612_0,,,,2,1,2,3
C(C(C=O)C=CC(C=O)=O)=O,,,5,1,2,0,2
66614_0,,,,2,1,2,3
C=CC(C=O)=C(C=O)C(C=O)=O,,,5,1,1,0,1
66616_0,,,,2,1,2,3
C=CC(C=C(C=O)C(C=O)=O)=O,,,5,1,1,0,1
66618_0,,,,2,1,2,3
C(C(C(C=O)=O)=CC=CC=O)=O,,,5,1,1,0,1
66620_0,,,,2,1,2,3
C(C(O)O)=C(C=O)C(C=O)=O,,,5,1,1,0,1
66621_0,,,,2,1,2,3
66623_0,,,,2,1,2,3
C(C(C)O)=C(C=O)C(C=O)=O,,,5,1,1,0,1
66625_0,,,,2,1,2,3
C(C(CO)O)=C(C=O)C(C=O)=O,,,5,1,2,0,2
66626_0,,,,2,1,2,3
66628_0,,,,2,1,2,3
C(CO)(CO)=C(C=O)C(C=O)=O,,,5,1,2,0,2
66630_0,,,,2,1,2,3
C(C(C(C=O)=O)=CC(O)=O)=O,,,5,1,2,0,2
66631_0,,,,2,1,2,3
66633_0,,,,2,1,2,3
C(C(C(C=O)=O)=C(C=O)C)=O,,,5,1,2,0,2
66635_0,,,,2,1,2,3
C(C(C(C=O)=O)=CC(C)=O)=O,,,5,1,2,0,2
66636_0,,,,2,1,2,3
66638_0,,,,2,1,2,3
C(CC=C(C=O)C(C=O)=O)=O,,,5,1,2,0,2
66639_0,,,,2,1,2,3
66641_0,,,,2,1,2,3
C(C)=C(C=O)C(C=O)=O,,,5,1,2,0,2
66643_0,,,,2,1,2,3
C(C(C(C=O)=O)=C(C=O)CO)=O,,,5,1,2,0,2
66645_0,,,,2,1,2,3
C(C(C(C=O)=O)=CC(CO)=O)=O,,,5,1,2,0,2
66647_0,,,,2,1,2,3
C(C(C(C(CO)=C)=O)(CO)O)=O,,,5,1,1,0,1
66648_0,,,,2,1,2,3
66649_0,,,,2,1,2,3
66651_0,,,,2,1,2,3
C(C(CC(CO)O)=CC=O)(O)=O,,,5,1,1,0,1
66653_0,,,,2,1,2,3
C(CC(C(O)=O)=CC(CO)O)=O,,,5,1,1,0,1
66654_0,,,,2,1,2,3
66656_0,,,,2,1,2,3
C(CO)=C(C(O)=O)C(C(O)=O)=O,,,5,1,3,0,3
66658_0,,,,2,1,2,3
C=CC(C(C(O)=O)=O)C(CO)O,,,5,1,1,0,1
66660_0,,,,2,1,2,3
C(C)=C(C(C(O)=O)=O)C(CO)O,,,5,1,1,0,1
66662_0,,,,2,1,2,3
C(CO)=C(C(C(O)=O)=O)C(C)O,,,5,1,1,0,1
66663_0,,,,2,1,2,3
66664_0,,,,2,1,2,3
66665_0,,,,2,1,2,3
66667_0,,,,2,1,2,3
C(C(C(C(CO)=O)C=C)O)(O)=O,,,5,1,1,0,1
66669_0,,,,2,1,2,3
C(C(C(C(CO)=O)=CC)O)(O)=O,,,5,1,1,0,1
66671_0,,,,2,1,2,3
C(C=C(C(CO)=O)C(C)O)(O)=O,,,5,1,1,0,1
66673_0,,,,2,1,2,3
C(C(CC(C(C=C)O)=O)O)(O)=O,,,5,1,1,0,1
66674_0,,,,2,1,2,3
66676_0,,,,2,1,2,3
C(CC(C(CO)O)=CC=O)(O)=O,,,5,1,1,0,1
66678_0,,,,2,1,2,3
C(CC(C(CO)O)=CC(O)=O)=O,,,5,1,1,0,1
66679_0,,,,2,1,2,3
66681_0,,,,2,1,2,3
C(C)=C(C(C(CO)O)=O)C(O)=O,,,5,1,1,0,1
66682_0,,,,2,1,2,3
66684_0,,,,2,1,2,3
C(C(C(CCO)=CC=O)O)(O)=O,,,5,1,1,0,1
66686_0,,,,2,1,2,3
C(CC(C(C(O)=O)O)=CCO)=O,,,5,1,1,0,1
66687_0,,,,2,1,2,3
66689_0,,,,2,1,2,3
C(C(C(C(C(O)=O)=C)=O)O)(O)=O,,,5,1,1,0,1
66691_0,,,,2,1,2,3
C(C(C(O)=O)O)(C(C=C)CO)=O,,,5,1,1,0,1
66693_0,,,,2,1,2,3
C(C(C(C(CO)=CC)=O)O)(O)=O,,,5,1,1,0,1
66695_0,,,,2,1,2,3
C(C(C(C(C(C)O)=C)=O)O)(O)=O,,,5,1,1,0,1
66697_0,,,,2,1,2,3
C(C(C(C(CO)=C)=O)O)(O)=O,,,5,1,1,0,1
66699_0,,,,2,1,2,3
C(CC(C=O)=CC(C=O)=O)(O)=O,,,5,1,1,0,1
66701_0,,,,2,1,2,3
C(C(CC(C=O)=O)=CC(O)=O)=O,,,5,1,1,0,1
66703_0,,,,2,1,2,3
C(CC(C=O)=C(C=O)C=O)(O)=O,,,5,1,1,0,1
66705_0,,,,2,1,2,3
C(C(C=O)C(C=O)=CC(O)=O)=O,,,5,1,1,0,1
66707_0,,,,2,1,2,3
C(CC(C=O)=CC=O)(O)=O,,,5,1,1,0,1
66709_0,,,,2,1,2,3
C(CC(C=O)=CC(O)=O)=O,,,5,1,2,0,2
66710_0,,,,2,1,2,3
66712_0,,,,2,1,2,3
C(C(O)O)=C(C(O)=O)C(C=O)=O,,,5,1,1,0,1
66713_0,,,,2,1,2,3
66715_0,,,,2,1,2,3
C(C(C)O)=C(C(O)=O)C(C=O)=O,,,5,1,1,0,1
66716_0,,,,2,1,2,3
66718_0,,,,2,1,2,3
C(CC(C(O)=O)=O)=C(C=O)C=O,,,5,1,1,0,1
66720_0,,,,2,1,2,3
C(C(C=O)C=CC(C(O)=O)=O)=O,,,5,1,1,0,1
66722_0,,,,2,1,2,3
C(CC(C(O)=O)=CC(C=O)=O)=O,,,5,1,1,0,1
66724_0,,,,2,1,2,3
C(C(CC(C(O)=O)=CC=O)=O)=O,,,5,1,1,0,1
66726_0,,,,2,1,2,3
C(CC(C(O)=O)=C(C=O)C=O)=O,,,5,1,1,0,1
66728_0,,,,2,1,2,3
C(C(C=O)C(C(O)=O)=CC=O)=O,,,5,1,1,0,1
66730_0,,,,2,1,2,3
C(CC(C(O)=O)=CC=O)=O,,,5,1,1,0,1
66731_0,,,,2,1,2,3
66733_0,,,,2,1,2,3
C(C(O)O)=C(C=O)C(C(O)=O)=O,,,5,1,1,0,1
66734_0,,,,2,1,2,3
66736_0,,,,2,1,2,3
C(C(C)O)=C(C=O)C(C(O)=O)=O,,,5,1,1,0,1
66738_0,,,,2,1,2,3
C(C(C(C(O)=O)=O)=CC=O)=O,,,5,1,3,0,3
66740_0,,,,2,1,2,3
C(C(C(C(O)=O)=O)=CC(O)=O)=O,,,5,1,1,0,1
66742_0,,,,2,1,2,3
C(C(C(C(O)=O)=O)C(C=O)=C)=O,,,5,1,1,0,1
66744_0,,,,2,1,2,3
C(C(C(C(O)=O)=O)=C(C=O)C)=O,,,5,1,1,0,1
66746_0,,,,2,1,2,3
C(C(C(C(O)=O)=O)=CC(C)=O)=O,,,5,1,1,0,1
66748_0,,,,2,1,2,3
C(C(C=CC=O)C(C(O)=O)=O)=O,,,5,1,1,0,1
66750_0,,,,2,1,2,3
C(CC=C(C=O)C(C(O)=O)=O)=O,,,5,1,1,0,1
66751_0,,,,2,1,2,3
66753_0,,,,2,1,2,3
C(C)=C(C=O)C(C(O)=O)=O,,,5,1,1,0,1
66754_0,,,,2,1,2,3
66755_0,,,,2,1,2,3
66757_0,,,,2,1,2,3
C1(COCC1O)=CC(C=O)=O,,,5,1,1,0,1
66759_0,,,,2,1,2,3
C1(COCC1O)=C(C=O)C=O,,,5,1,1,0,1
66761_0,,,,2,1,2,3
C1(COCC1O)=CC=O,,,5,1,1,0,1
66762_0,,,,2,1,2,3
66764_0,,,,2,1,2,3
C1(C(COC1C(C=O)=C)O)=O,,,5,1,1,0,1
66766_0,,,,2,1,2,3
C1(C(COC1C=CC=O)O)=O,,,5,1,1,0,1
66768_0,,,,2,1,2,3
C1(C(COC1C=C)O)=O,,,5,1,1,0,1
66770_0,,,,2,1,2,3
C(CO)(C(C1C(O)OCC=1)O)=O,,,5,1,1,0,1
66772_0,,,,2,1,2,3
C1(C(O)OCC1)=CC(C=O)=O,,,5,1,2,0,2
66774_0,,,,2,1,2,3
C1COC(C=1CC(C=O)=O)O,,,5,1,1,0,1
66776_0,,,,2,1,2,3
C1(C(O)OCC1)=C(C=O)C=O,,,5,1,2,0,2
66778_0,,,,2,1,2,3
C(C(C=O)C1C(O)OCC=1)=O,,,5,1,1,0,1
66780_0,,,,2,1,2,3
C1(C(O)OCC1)=CC=O,,,5,1,2,0,2
66782_0,,,,2,1,2,3
C(CC1C(O)OCC=1)=O,,,5,1,1,0,1
66784_0,,,,2,1,2,3
C1COC(C=1C(C(C=O)=O)O)O,,,5,1,1,0,1
66786_0,,,,2,1,2,3
C(C(C1C(O)OCC=1)O)=O,,,5,1,2,0,2
66788_0,,,,2,1,2,3
C=CC(C=O)=C1C(C(O)OC1)=O,,,5,1,1,0,1
66790_0,,,,2,1,2,3
C=CC(C=C1C(C(O)OC1)=O)=O,,,5,1,1,0,1
66792_0,,,,2,1,2,3
C(C=CC=C1C(C(O)OC1)=O)=O,,,5,1,1,0,1
66794_0,,,,2,1,2,3
C(C(O)O)=C1C(C(O)OC1)=O,,,5,1,1,0,1
66795_0,,,,2,1,2,3
66797_0,,,,2,1,2,3
C(C(C)O)=C1C(C(OC1)O)=O,,,5,1,1,0,1
66799_0,,,,2,1,2,3
C(C(CO)O)=C1C(C(OC1)O)=O,,,5,1,2,0,2
66801_0,,,,2,1,2,3
C(C=C1C(C(O)OC1)=O)=O,,,5,1,3,0,3
66803_0,,,,2,1,2,3
C(CO)(CO)=C1C(C(O)OC1)=O,,,5,1,2,0,2
66805_0,,,,2,1,2,3
C(C=C1C(C(O)OC1)=O)(O)=O,,,5,1,2,0,2
66807_0,,,,2,1,2,3
C1(C(O)OCC1C(C=O)=C)=O,,,5,1,2,0,2
66809_0,,,,2,1,2,3
C(C(C)=C1C(C(O)OC1)=O)=O,,,5,1,2,0,2
66811_0,,,,2,1,2,3
C1(C(COC1O)=CC(C)=O)=O,,,5,1,2,0,2
66813_0,,,,2,1,2,3
C1(C(O)OCC1C=CC=O)=O,,,5,1,2,0,2
66815_0,,,,2,1,2,3
C(CC=C1C(C(O)OC1)=O)=O,,,5,1,2,0,2
66817_0,,,,2,1,2,3
C1(C(O)OCC1C=C)=O,,,5,1,2,0,2
66819_0,,,,2,1,2,3
C(C)=C1C(C(O)OC1)=O,,,5,1,2,0,2
66821_0,,,,2,1,2,3
C(C(CO)=C1C(C(O)OC1)=O)=O,,,5,1,2,0,2
66823_0,,,,2,1,2,3
C1(C(COC1O)=CC(CO)=O)=O,,,5,1,2,0,2
66825_0,,,,2,1,2,3
C=C1C(C(O)OC1)=O,,,5,1,4,0,4
66827_0,,,,2,1,2,3
C(CO)=C1C(C(O)OC1)=O,,,5,1,2,0,2
66828_0,,,,2,1,2,3
66830_0,,,,2,1,2,3
C(CO)(C(C1COC(C=1)O)O)=O,,,5,1,1,0,1
66832_0,,,,2,1,2,3
C1(COC(C1)O)=CC(C=O)=O,,,5,1,2,0,2
66833_0,,,,2,1,2,3
66835_0,,,,2,1,2,3
C1C(O)OCC=1CC(C=O)=O,,,5,1,1,0,1
66837_0,,,,2,1,2,3
C1(COC(C1)O)=C(C=O)C=O,,,5,1,2,0,2
66838_0,,,,2,1,2,3
66840_0,,,,2,1,2,3
C(C(C=O)C1COC(C=1)O)=O,,,5,1,1,0,1
66842_0,,,,2,1,2,3
C1(COC(C1)O)=CC=O,,,5,1,2,0,2
66843_0,,,,2,1,2,3
66845_0,,,,2,1,2,3
C(CC1COC(C=1)O)=O,,,5,1,1,0,1
66846_0,,,,2,1,2,3
66848_0,,,,2,1,2,3
C1C(O)OCC=1C(C(C=O)=O)O,,,5,1,1,0,1
66849_0,,,,2,1,2,3
66851_0,,,,2,1,2,3
C(C(C1COC(C=1)O)O)=O,,,5,1,1,0,1
66853_0,,,,2,1,2,3
C=CC(C=O)=C1C(COC1O)=O,,,5,1,1,0,1
66855_0,,,,2,1,2,3
C(C(C=C)(C1C(COC=1)=O)O)=O,,,5,1,1,0,1
66857_0,,,,2,1,2,3
C=CC(C=C1C(COC1O)=O)=O,,,5,1,1,0,1
66859_0,,,,2,1,2,3
C=CC(C(C1C(COC=1)=O)O)=O,,,5,1,1,0,1
66861_0,,,,2,1,2,3
C(C=CC=C1C(COC1O)=O)=O,,,5,1,1,0,1
66863_0,,,,2,1,2,3
C(C(C1C(COC=1)=O)O)=CC=O,,,5,1,1,0,1
66865_0,,,,2,1,2,3
C1OCC(C=1C(O)=O)=O,,,5,1,1,0,1
66867_0,,,,2,1,2,3
C(C(O)O)=C1C(COC1O)=O,,,5,1,1,0,1
66869_0,,,,2,1,2,3
C1OCC(C=1C(C(O)O)O)=O,,,5,1,1,0,1
66870_0,,,,2,1,2,3
66872_0,,,,2,1,2,3
C(C(C)O)=C1C(COC1O)=O,,,5,1,1,0,1
66874_0,,,,2,1,2,3
C1OCC(C=1C(C(C)O)O)=O,,,5,1,1,0,1
66876_0,,,,2,1,2,3
C(C(CO)O)=C1C(COC1O)=O,,,5,1,2,0,2
66878_0,,,,2,1,2,3
C1OCC(C=1C(C(CO)O)O)=O,,,5,1,1,0,1
66880_0,,,,2,1,2,3
C(C=C1C(COC1O)=O)=O,,,5,1,3,0,3
66882_0,,,,2,1,2,3
C(C(C1C(COC=1)=O)O)=O,,,5,1,1,0,1
66884_0,,,,2,1,2,3
C(CO)(CO)=C1C(COC1O)=O,,,5,1,2,0,2
66886_0,,,,2,1,2,3
C1OCC(C=1C(CO)(CO)O)=O,,,5,1,1,0,1
66888_0,,,,2,1,2,3
C(C=C1C(COC1O)=O)(O)=O,,,5,1,2,0,2
66890_0,,,,2,1,2,3
C(C(C1C(COC=1)=O)O)(O)=O,,,5,1,1,0,1
66892_0,,,,2,1,2,3
C1(COC(C1C(C=O)=C)O)=O,,,5,1,2,0,2
66894_0,,,,2,1,2,3
C(C(C)=C1C(COC1O)=O)=O,,,5,1,2,0,2
66896_0,,,,2,1,2,3
C(C(C1C(COC=1)=O)(C)O)=O,,,5,1,1,0,1
66898_0,,,,2,1,2,3
C1(C(C(O)OC1)=CC(C)=O)=O,,,5,1,2,0,2
66900_0,,,,2,1,2,3
C(C)(C(C1C(COC=1)=O)O)=O,,,5,1,1,0,1
66902_0,,,,2,1,2,3
C1(COC(C1C=CC=O)O)=O,,,5,1,2,0,2
66904_0,,,,2,1,2,3
C(CC=C1C(COC1O)=O)=O,,,5,1,2,0,2
66906_0,,,,2,1,2,3
C(CC(C1C(COC=1)=O)O)=O,,,5,1,1,0,1
66908_0,,,,2,1,2,3
C1(COC(C1C=C)O)=O,,,5,1,2,0,2
66910_0,,,,2,1,2,3
C(C)=C1C(COC1O)=O,,,5,1,2,0,2
66912_0,,,,2,1,2,3
C1OCC(C=1C(C)O)=O,,,5,1,1,0,1
66914_0,,,,2,1,2,3
C(C(CO)=C1C(COC1O)=O)=O,,,5,1,2,0,2
66916_0,,,,2,1,2,3
C(C(C1C(COC=1)=O)(CO)O)=O,,,5,1,1,0,1
66918_0,,,,2,1,2,3
C1(C(C(O)OC1)=CC(CO)=O)=O,,,5,1,2,0,2
66920_0,,,,2,1,2,3
C(CO)(C(C1C(COC=1)=O)O)=O,,,5,1,1,0,1
66922_0,,,,2,1,2,3
C=C1C(COC1O)=O,,,5,1,4,0,4
66924_0,,,,2,1,2,3
C1OCC(C=1CO)=O,,,5,1,1,0,1
66926_0,,,,2,1,2,3
C(CO)=C1C(COC1O)=O,,,5,1,2,0,2
66928_0,,,,2,1,2,3
C1OCC(C=1C(CO)O)=O,,,5,1,1,0,1
66929_0,,,,2,1,2,3
66930_0,,,,2,1,2,3
66931_0,,,,2,1,2,3
66932_0,,,,2,1,2,3
66933_0,,,,2,1,2,3
66934_0,,,,2,1,2,3
66935_0,,,,2,1,2,3
66936_0,,,,2,1,2,3
66937_0,,,,2,1,2,3
66938_0,,,,2,1,2,3
66939_0,,,,2,1,2,3
66941_0,,,,2,1,2,3
C1(CC(OC1C(C=O)=C)O)=O,,,5,1,2,0,2
66942_0,,,,2,1,2,3
66943_0,,,,2,1,2,3
66945_0,,,,2,1,2,3
C1(CC(OC1C=CC=O)O)=O,,,5,1,2,0,2
66946_0,,,,2,1,2,3
66948_0,,,,2,1,2,3
C1(CC(OC1C=C)O)=O,,,5,1,2,0,2
66949_0,,,,2,1,2,3
66950_0,,,,2,1,2,3
66951_0,,,,2,1,2,3
66952_0,,,,2,1,2,3
66953_0,,,,2,1,2,3
66954_0,,,,2,1,2,3
66955_0,,,,2,1,2,3
66956_0,,,,2,1,2,3
66957_0,,,,2,1,2,3
66958_0,,,,2,1,2,3
66959_0,,,,2,1,2,3
66960_0,,,,2,1,2,3
66962_0,,,,2,1,2,3
C(C(C=C(C(C=O)=O)C)=O)=O,,,5,1,3,0,3
66964_0,,,,2,1,2,3
C=C(C(C=O)=O)CC(C=O)=O,,,5,1,2,0,2
66966_0,,,,2,1,2,3
C(C(C=O)=C(C(C=O)=O)C)=O,,,5,1,2,0,2
66967_0,,,,2,1,2,3
66969_0,,,,2,1,2,3
C(C(C(C)=CC=O)=O)=O,,,5,1,3,0,3
66970_0,,,,2,1,2,3
66972_0,,,,2,1,2,3
C=C(C(C=O)=O)C(C(C=O)=O)O,,,5,1,2,0,2
66973_0,,,,2,1,2,3
66975_0,,,,2,1,2,3
C=CC(C=O)=CC(C(C=O)=O)=O,,,5,1,1,0,1
66977_0,,,,2,1,2,3
C=CC(C=CC(C(C=O)=O)=O)=O,,,5,1,1,0,1
66979_0,,,,2,1,2,3
C(C(C(C=CC=CC=O)=O)=O)=O,,,5,1,1,0,1
66981_0,,,,2,1,2,3
C(C(O)O)=CC(C(C=O)=O)=O,,,5,1,1,0,1
66982_0,,,,2,1,2,3
66984_0,,,,2,1,2,3
C(C(C)O)=CC(C(C=O)=O)=O,,,5,1,1,0,1
66986_0,,,,2,1,2,3
C(C(CO)O)=CC(C(C=O)=O)=O,,,5,1,1,0,1
66988_0,,,,2,1,2,3
C(C(C(C=CC=O)=O)=O)=O,,,5,1,3,0,3
66990_0,,,,2,1,2,3
C(CO)(CO)=CC(C(C=O)=O)=O,,,5,1,1,0,1
66992_0,,,,2,1,2,3
C(C(C(C=CC(O)=O)=O)=O)=O,,,5,1,1,0,1
66994_0,,,,2,1,2,3
C=C(C=O)CC(C(C=O)=O)=O,,,5,1,1,0,1
66996_0,,,,2,1,2,3
C(C(C)=CC(C(C=O)=O)=O)=O,,,5,1,1,0,1
66998_0,,,,2,1,2,3
C(C(C(C=CC(C)=O)=O)=O)=O,,,5,1,1,0,1
66999_0,,,,2,1,2,3
67001_0,,,,2,1,2,3
C(CC=CC(C(C=O)=O)=O)=O,,,5,1,1,0,1
67003_0,,,,2,1,2,3
C=CCC(C(C=O)=O)=O,,,5,1,1,0,1
67005_0,,,,2,1,2,3
C(C)=CC(C(C=O)=O)=O,,,5,1,1,0,1
67007_0,,,,2,1,2,3
C(C(CO)=CC(C(C=O)=O)=O)=O,,,5,1,1,0,1
67009_0,,,,2,1,2,3
C(C(C(C=CC(CO)=O)=O)=O)=O,,,5,1,1,0,1
67010_0,,,,2,1,2,3
67011_0,,,,2,1,2,3
67013_0,,,,2,1,2,3
C=CC(C=O)=CC(C=O)=O,,,5,1,2,0,2
67015_0,,,,2,1,2,3
C=CC(C=O)=C(C=O)C=O,,,5,1,2,0,2
67017_0,,,,2,1,2,3
C(C(C=C)(C(C(C=O)=O)=C)O)=O,,,5,1,2,0,2
67019_0,,,,2,1,2,3
C=CC(C=O)=C(C(C=O)=O)CO,,,5,1,1,0,1
67021_0,,,,2,1,2,3
C(C(C=C)(C(C=O)=CC=O)O)=O,,,5,1,2,0,2
67023_0,,,,2,1,2,3
C(C(C(C=O)=C(C=O)C=C)O)=O,,,5,1,1,0,1
67025_0,,,,2,1,2,3
C=CC(C=O)=C(C=O)C(CO)=O,,,5,1,1,0,1
67027_0,,,,2,1,2,3
C(C(C(C=C(C=O)C=C)=O)O)=O,,,5,1,1,0,1
67029_0,,,,2,1,2,3
C=CC(C=O)=CC=O,,,5,1,4,0,4
67031_0,,,,2,1,2,3
C=CC(C=CC(C=O)=O)=O,,,5,1,2,0,2
67033_0,,,,2,1,2,3
C=CC(C=C(C=O)C=O)=O,,,5,1,2,0,2
67035_0,,,,2,1,2,3
C=C(C(C=O)=O)C(C(C=C)=O)O,,,5,1,2,0,2
67037_0,,,,2,1,2,3
C=CC(C=C(C(C=O)=O)CO)=O,,,5,1,1,0,1
67039_0,,,,2,1,2,3
C=CC(C(C(C=O)=CC=O)O)=O,,,5,1,2,0,2
67041_0,,,,2,1,2,3
C(C(C(C=O)=CC(C=C)=O)O)=O,,,5,1,1,0,1
67043_0,,,,2,1,2,3
C=CC(C=C(C=O)C(CO)=O)=O,,,5,1,1,0,1
67045_0,,,,2,1,2,3
C(C(C(C=CC(C=C)=O)=O)O)=O,,,5,1,1,0,1
67047_0,,,,2,1,2,3
C=CC(C=CC=O)=O,,,5,1,2,0,2
67049_0,,,,2,1,2,3
C(C=CC=CC(C=O)=O)=O,,,5,1,3,0,3
67051_0,,,,2,1,2,3
C(C(C=O)=CC=CC=O)=O,,,5,1,3,0,3
67053_0,,,,2,1,2,3
C=C(C(C=O)=O)C(C=CC=O)O,,,5,1,2,0,2
67055_0,,,,2,1,2,3
C(C=CC=C(C(C=O)=O)CO)=O,,,5,1,1,0,1
67057_0,,,,2,1,2,3
C(C(C(C=O)=CC=O)O)=CC=O,,,5,1,2,0,2
67059_0,,,,2,1,2,3
C(C(C(C=O)=CC=CC=O)O)=O,,,5,1,1,0,1
67061_0,,,,2,1,2,3
C(C(C(CO)=O)=CC=CC=O)=O,,,5,1,1,0,1
67063_0,,,,2,1,2,3
C(C(C(C=CC=CC=O)=O)O)=O,,,5,1,1,0,1
67065_0,,,,2,1,2,3
C(C=CC=CC=O)=O,,,5,1,2,0,2
67067_0,,,,2,1,2,3
C(C1(COC(C1O)O)O)=CC=O,,,5,1,2,0,2
67069_0,,,,2,1,2,3
C1(C(O)OCC1O)=CC(C=O)=O,,,5,1,2,0,2
67071_0,,,,2,1,2,3
C1(C(O)OCC1O)=C(C=O)C=O,,,5,1,2,0,2
67073_0,,,,2,1,2,3
C1(C(O)OCC1O)=CC=O,,,5,1,3,0,3
67074_0,,,,2,1,2,3
67076_0,,,,2,1,2,3
C(C(O)O)=CC(C=O)=O,,,5,1,1,0,1
67078_0,,,,2,1,2,3
C(C(O)O)=C(C=O)C=O,,,5,1,1,0,1
67080_0,,,,2,1,2,3
C=C(C(C=O)=O)C(C(O)O)O,,,5,1,2,0,2
67082_0,,,,2,1,2,3
C(C(O)O)=C(C(C=O)=O)CO,,,5,1,1,0,1
67084_0,,,,2,1,2,3
C(C=C(C=O)C(C(O)O)O)=O,,,5,1,2,0,2
67086_0,,,,2,1,2,3
C(C(C(C=O)=CC(O)O)O)=O,,,5,1,1,0,1
67088_0,,,,2,1,2,3
C(C(O)O)=C(C=O)C(CO)=O,,,5,1,1,0,1
67090_0,,,,2,1,2,3
C(C(C(C=CC(O)O)=O)O)=O,,,5,1,1,0,1
67092_0,,,,2,1,2,3
C(C(O)O)=CC=O,,,5,1,1,0,1
67093_0,,,,2,1,2,3
67094_0,,,,2,1,2,3
67096_0,,,,2,1,2,3
C(C(C)O)=CC(C=O)=O,,,5,1,2,0,2
67097_0,,,,2,1,2,3
67099_0,,,,2,1,2,3
C(C(C)O)=C(C=O)C=O,,,5,1,1,0,1
67100_0,,,,2,1,2,3
67102_0,,,,2,1,2,3
C=C(C(C=O)=O)C(C(C)O)O,,,5,1,2,0,2
67104_0,,,,2,1,2,3
C(C(C)O)=C(C(C=O)=O)CO,,,5,1,1,0,1
67105_0,,,,2,1,2,3
67106_0,,,,2,1,2,3
67107_0,,,,2,1,2,3
67108_0,,,,2,1,2,3
67110_0,,,,2,1,2,3
C(C(C)O)=C(C=O)C(CO)=O,,,5,1,1,0,1
67111_0,,,,2,1,2,3
67112_0,,,,2,1,2,3
67114_0,,,,2,1,2,3
C(C(C(C=CC(C)O)=O)O)=O,,,5,1,1,0,1
67115_0,,,,2,1,2,3
67117_0,,,,2,1,2,3
C(C(C)O)=CC=O,,,5,1,3,0,3
67118_0,,,,2,1,2,3
67119_0,,,,2,1,2,3
67120_0,,,,2,1,2,3
67121_0,,,,2,1,2,3
67122_0,,,,2,1,2,3
67123_0,,,,2,1,2,3
67124_0,,,,2,1,2,3
67125_0,,,,2,1,2,3
67127_0,,,,2,1,2,3
C(C(C=CC(O)=O)(C)O)=O,,,5,1,3,0,3
67128_0,,,,2,1,2,3
67129_0,,,,2,1,2,3
67131_0,,,,2,1,2,3
C(C(C(CO)=CC(O)=O)(C)O)=O,,,5,1,2,0,2
67132_0,,,,2,1,2,3
67133_0,,,,2,1,2,3
67134_0,,,,2,1,2,3
67135_0,,,,2,1,2,3
67136_0,,,,2,1,2,3
67137_0,,,,2,1,2,3
67138_0,,,,2,1,2,3
67139_0,,,,2,1,2,3
67140_0,,,,2,1,2,3
67141_0,,,,2,1,2,3
67142_0,,,,2,1,2,3
67143_0,,,,2,1,2,3
67145_0,,,,2,1,2,3
C(C(C=CC(O)=O)(CCO)O)=O,,,5,1,2,0,2
67146_0,,,,2,1,2,3
67147_0,,,,2,1,2,3
67148_0,,,,2,1,2,3
67149_0,,,,2,1,2,3
67150_0,,,,2,1,2,3
67152_0,,,,2,1,2,3
C(CC(C(C=CC(O)=O)O)O)=O,,,5,1,1,0,1
67153_0,,,,2,1,2,3
67154_0,,,,2,1,2,3
67155_0,,,,2,1,2,3
67157_0,,,,2,1,2,3
C(C(CC(C=CC(O)=O)O)O)=O,,,5,1,1,0,1
67158_0,,,,2,1,2,3
67159_0,,,,2,1,2,3
67161_0,,,,2,1,2,3
C(C(C(C=CC(O)=O)(C)O)O)=O,,,5,1,1,0,1
67162_0,,,,2,1,2,3
67163_0,,,,2,1,2,3
67165_0,,,,2,1,2,3
C(C(C)O)=CC(O)=O,,,5,1,2,0,2
67166_0,,,,2,1,2,3
67167_0,,,,2,1,2,3
67168_0,,,,2,1,2,3
67169_0,,,,2,1,2,3
67170_0,,,,2,1,2,3
67171_0,,,,2,1,2,3
67173_0,,,,2,1,2,3
C(CC(C(CO)=CC(O)=O)O)=O,,,5,1,1,0,1
67174_0,,,,2,1,2,3
67175_0,,,,2,1,2,3
67176_0,,,,2,1,2,3
67177_0,,,,2,1,2,3
67178_0,,,,2,1,2,3
67180_0,,,,2,1,2,3
C(CO)(C(C)O)=CC(O)=O,,,5,1,1,0,1
67181_0,,,,2,1,2,3
67182_0,,,,2,1,2,3
67183_0,,,,2,1,2,3
67184_0,,,,2,1,2,3
67185_0,,,,2,1,2,3
67186_0,,,,2,1,2,3
67187_0,,,,2,1,2,3
67188_0,,,,2,1,2,3
67189_0,,,,2,1,2,3
67190_0,,,,2,1,2,3
67191_0,,,,2,1,2,3
67192_0,,,,2,1,2,3
67193_0,,,,2,1,2,3
67194_0,,,,2,1,2,3
67195_0,,,,2,1,2,3
67196_0,,,,2,1,2,3
67197_0,,,,2,1,2,3
67198_0,,,,2,1,2,3
67199_0,,,,2,1,2,3
67200_0,,,,2,1,2,3
67201_0,,,,2,1,2,3
67202_0,,,,2,1,2,3
67203_0,,,,2,1,2,3
67204_0,,,,2,1,2,3
67205_0,,,,2,1,2,3
67206_0,,,,2,1,2,3
67207_0,,,,2,1,2,3
67208_0,,,,2,1,2,3
67209_0,,,,2,1,2,3
67210_0,,,,2,1,2,3
67211_0,,,,2,1,2,3
67212_0,,,,2,1,2,3
67213_0,,,,2,1,2,3
67214_0,,,,2,1,2,3
67215_0,,,,2,1,2,3
67216_0,,,,2,1,2,3
67217_0,,,,2,1,2,3
67218_0,,,,2,1,2,3
67219_0,,,,2,1,2,3
67220_0,,,,2,1,2,3
67221_0,,,,2,1,2,3
67222_0,,,,2,1,2,3
67223_0,,,,2,1,2,3
67224_0,,,,2,1,2,3
67225_0,,,,2,1,2,3
67226_0,,,,2,1,2,3
67227_0,,,,2,1,2,3
67228_0,,,,2,1,2,3
67229_0,,,,2,1,2,3
67230_0,,,,2,1,2,3
67231_0,,,,2,1,2,3
67232_0,,,,2,1,2,3
67233_0,,,,2,1,2,3
67234_0,,,,2,1,2,3
67235_0,,,,2,1,2,3
67236_0,,,,2,1,2,3
67237_0,,,,2,1,2,3
67238_0,,,,2,1,2,3
67239_0,,,,2,1,2,3
67240_0,,,,2,1,2,3
67241_0,,,,2,1,2,3
67242_0,,,,2,1,2,3
67243_0,,,,2,1,2,3
67244_0,,,,2,1,2,3
67245_0,,,,2,1,2,3
67246_0,,,,2,1,2,3
67247_0,,,,2,1,2,3
67248_0,,,,2,1,2,3
67249_0,,,,2,1,2,3
67250_0,,,,2,1,2,3
67251_0,,,,2,1,2,3
67252_0,,,,2,1,2,3
67254_0,,,,2,1,2,3
C(CO)(C(C(C=CCO)=O)O)=O,,,5,1,1,0,1
67255_0,,,,2,1,2,3
67256_0,,,,2,1,2,3
67257_0,,,,2,1,2,3
67258_0,,,,2,1,2,3
67259_0,,,,2,1,2,3
67260_0,,,,2,1,2,3
67261_0,,,,2,1,2,3
67262_0,,,,2,1,2,3
67263_0,,,,2,1,2,3
67264_0,,,,2,1,2,3
67265_0,,,,2,1,2,3
67266_0,,,,2,1,2,3
67267_0,,,,2,1,2,3
67269_0,,,,2,1,2,3
C(C(C=CC(C=O)=O)O)(O)=O,,,5,1,3,0,3
67270_0,,,,2,1,2,3
67272_0,,,,2,1,2,3
C(C(C(C=CC=O)=O)(C)O)=O,,,5,1,1,0,1
67273_0,,,,2,1,2,3
67275_0,,,,2,1,2,3
C(C(C=CC(C=O)=O)(C)O)=O,,,5,1,2,0,2
67276_0,,,,2,1,2,3
67277_0,,,,2,1,2,3
67278_0,,,,2,1,2,3
67279_0,,,,2,1,2,3
67280_0,,,,2,1,2,3
67281_0,,,,2,1,2,3
67283_0,,,,2,1,2,3
C=CC(C(C(C=O)=O)CO)=O,,,5,1,2,0,2
67284_0,,,,2,1,2,3
67286_0,,,,2,1,2,3
C(C(C(C=C)=O)C(C=O)O)=O,,,5,1,2,0,2
67288_0,,,,2,1,2,3
C(C(C(CO)=O)C(C=C)=O)=O,,,5,1,2,0,2
67290_0,,,,2,1,2,3
C(C)(C(C(C=CC=O)=O)O)=O,,,5,1,1,0,1
67292_0,,,,2,1,2,3
C(CC(C(C(C=C)=O)O)=O)=O,,,5,1,2,0,2
67293_0,,,,2,1,2,3
67294_0,,,,2,1,2,3
67296_0,,,,2,1,2,3
C(C(C(CC(C=C)=O)=O)O)=O,,,5,1,2,0,2
67298_0,,,,2,1,2,3
C(CC(C=C)=O)=O,,,5,1,2,0,2
67299_0,,,,2,1,2,3
67300_0,,,,2,1,2,3
67302_0,,,,2,1,2,3
C(CO)=CC(CC(C=O)=O)=O,,,5,1,2,0,2
67303_0,,,,2,1,2,3
67304_0,,,,2,1,2,3
67305_0,,,,2,1,2,3
67306_0,,,,2,1,2,3
67307_0,,,,2,1,2,3
67309_0,,,,2,1,2,3
C(C(C=O)C(C=CCO)=O)=O,,,5,1,2,0,2
67310_0,,,,2,1,2,3
67311_0,,,,2,1,2,3
67312_0,,,,2,1,2,3
67313_0,,,,2,1,2,3
67314_0,,,,2,1,2,3
67316_0,,,,2,1,2,3
C(CC(C=CCO)=O)=O,,,5,1,2,0,2
67317_0,,,,2,1,2,3
67318_0,,,,2,1,2,3
67320_0,,,,2,1,2,3
C(CO)=CC(C(C(C=O)=O)O)=O,,,5,1,1,0,1
67321_0,,,,2,1,2,3
67322_0,,,,2,1,2,3
67323_0,,,,2,1,2,3
67324_0,,,,2,1,2,3
67325_0,,,,2,1,2,3
67326_0,,,,2,1,2,3
67327_0,,,,2,1,2,3
67328_0,,,,2,1,2,3
67329_0,,,,2,1,2,3
67330_0,,,,2,1,2,3
67331_0,,,,2,1,2,3
67332_0,,,,2,1,2,3
67334_0,,,,2,1,2,3
C(CO)(C(C(C=CC=O)=O)O)=O,,,5,1,1,0,1
67335_0,,,,2,1,2,3
67336_0,,,,2,1,2,3
67337_0,,,,2,1,2,3
67338_0,,,,2,1,2,3
67339_0,,,,2,1,2,3
67341_0,,,,2,1,2,3
C(C(C=CC(C=O)=O)(CO)O)=O,,,5,1,3,0,3
67342_0,,,,2,1,2,3
67343_0,,,,2,1,2,3
67344_0,,,,2,1,2,3
67345_0,,,,2,1,2,3
67346_0,,,,2,1,2,3
67347_0,,,,2,1,2,3
67348_0,,,,2,1,2,3
67349_0,,,,2,1,2,3
67350_0,,,,2,1,2,3
67351_0,,,,2,1,2,3
67352_0,,,,2,1,2,3
67353_0,,,,2,1,2,3
67354_0,,,,2,1,2,3
67356_0,,,,2,1,2,3
C(CO)(C(C(C=C)=O)(CO)O)=O,,,5,1,1,0,1
67357_0,,,,2,1,2,3
67358_0,,,,2,1,2,3
67359_0,,,,2,1,2,3
67361_0,,,,2,1,2,3
C(C(C(C)=O)(C(C=C)=O)O)=O,,,5,1,2,0,2
67363_0,,,,2,1,2,3
C=CC(C(C(C=O)=O)(CO)O)=O,,,5,1,1,0,1
67364_0,,,,2,1,2,3
67365_0,,,,2,1,2,3
67366_0,,,,2,1,2,3
67367_0,,,,2,1,2,3
67368_0,,,,2,1,2,3
67369_0,,,,2,1,2,3
67370_0,,,,2,1,2,3
67372_0,,,,2,1,2,3
C(C(C(C=C)=O)(CC=O)O)=O,,,5,1,2,0,2
67373_0,,,,2,1,2,3
67375_0,,,,2,1,2,3
C(C(C(C=C)=O)(C)O)(O)=O,,,5,1,2,0,2
67376_0,,,,2,1,2,3
67377_0,,,,2,1,2,3
67379_0,,,,2,1,2,3
C(C(C(C=C)=O)(CCO)O)(O)=O,,,5,1,1,0,1
67380_0,,,,2,1,2,3
67381_0,,,,2,1,2,3
67383_0,,,,2,1,2,3
C(C(C(C=CCO)=O)(C)O)(O)=O,,,5,1,1,0,1
67384_0,,,,2,1,2,3
67385_0,,,,2,1,2,3
67386_0,,,,2,1,2,3
67387_0,,,,2,1,2,3
67388_0,,,,2,1,2,3
67389_0,,,,2,1,2,3
67390_0,,,,2,1,2,3
67391_0,,,,2,1,2,3
67392_0,,,,2,1,2,3
67393_0,,,,2,1,2,3
67394_0,,,,2,1,2,3
67395_0,,,,2,1,2,3
67396_0,,,,2,1,2,3
67397_0,,,,2,1,2,3
67398_0,,,,2,1,2,3
67399_0,,,,2,1,2,3
67400_0,,,,2,1,2,3
67401_0,,,,2,1,2,3
67402_0,,,,2,1,2,3
67403_0,,,,2,1,2,3
67404_0,,,,2,1,2,3
67405_0,,,,2,1,2,3
67406_0,,,,2,1,2,3
67408_0,,,,2,1,2,3
C=CC(C(C(C(CO)O)O)O)O,,,5,1,1,0,1
67409_0,,,,2,1,2,3
67410_0,,,,2,1,2,3
67411_0,,,,2,1,2,3
67412_0,,,,2,1,2,3
67413_0,,,,2,1,2,3
67414_0,,,,2,1,2,3
67415_0,,,,2,1,2,3
67416_0,,,,2,1,2,3
67417_0,,,,2,1,2,3
67418_0,,,,2,1,2,3
67419_0,,,,2,1,2,3
67420_0,,,,2,1,2,3
67422_0,,,,2,1,2,3
C=CC(C(CO)(CO)O)O,,,5,1,2,0,2
67423_0,,,,2,1,2,3
67425_0,,,,2,1,2,3
C=CC(C(CO)(C(CO)O)O)O,,,5,1,1,0,1
67426_0,,,,2,1,2,3
67427_0,,,,2,1,2,3
67428_0,,,,2,1,2,3
67429_0,,,,2,1,2,3
67431_0,,,,2,1,2,3
C(C(C(C(C=O)O)=C)(C)O)=O,,,5,1,3,0,3
67432_0,,,,2,1,2,3
67433_0,,,,2,1,2,3
67435_0,,,,2,1,2,3
C(C(C=C)(C)O)=O,,,5,1,2,0,2
67436_0,,,,2,1,2,3
67437_0,,,,2,1,2,3
67438_0,,,,2,1,2,3
67439_0,,,,2,1,2,3
67440_0,,,,2,1,2,3
67441_0,,,,2,1,2,3
67442_0,,,,2,1,2,3
67443_0,,,,2,1,2,3
67444_0,,,,2,1,2,3
67445_0,,,,2,1,2,3
67446_0,,,,2,1,2,3
67447_0,,,,2,1,2,3
67448_0,,,,2,1,2,3
67449_0,,,,2,1,2,3
67450_0,,,,2,1,2,3
67452_0,,,,2,1,2,3
C(C(CC(C=C)O)O)=O,,,5,1,1,0,1
67453_0,,,,2,1,2,3
67454_0,,,,2,1,2,3
67455_0,,,,2,1,2,3
67456_0,,,,2,1,2,3
67457_0,,,,2,1,2,3
67458_0,,,,2,1,2,3
67459_0,,,,2,1,2,3
67460_0,,,,2,1,2,3
67462_0,,,,2,1,2,3
C(C(C(C(C)O)=C)O)=O,,,5,1,3,0,3
67463_0,,,,2,1,2,3
67464_0,,,,2,1,2,3
67465_0,,,,2,1,2,3
67466_0,,,,2,1,2,3
67467_0,,,,2,1,2,3
67468_0,,,,2,1,2,3
67469_0,,,,2,1,2,3
67470_0,,,,2,1,2,3
67472_0,,,,2,1,2,3
C(C(C(C(C(CO)O)O)=C)O)=O,,,5,1,2,0,2
67473_0,,,,2,1,2,3
67474_0,,,,2,1,2,3
67475_0,,,,2,1,2,3
67476_0,,,,2,1,2,3
67477_0,,,,2,1,2,3
67478_0,,,,2,1,2,3
67479_0,,,,2,1,2,3
67481_0,,,,2,1,2,3
C(C(C(C=C)(C)O)O)=O,,,5,1,1,0,1
67482_0,,,,2,1,2,3
67483_0,,,,2,1,2,3
67485_0,,,,2,1,2,3
C=CC(C)O,,,5,1,2,0,2
67486_0,,,,2,1,2,3
67487_0,,,,2,1,2,3
67488_0,,,,2,1,2,3
67489_0,,,,2,1,2,3
67490_0,,,,2,1,2,3
67491_0,,,,2,1,2,3
67492_0,,,,2,1,2,3
67493_0,,,,2,1,2,3
67494_0,,,,2,1,2,3
67495_0,,,,2,1,2,3
67497_0,,,,2,1,2,3
C=CC(C(CO)O)O,,,5,1,3,0,3
67498_0,,,,2,1,2,3
67500_0,,,,2,1,2,3
C=CC(C(C(CO)O)O)O,,,5,1,2,0,2
67501_0,,,,2,1,2,3
67502_0,,,,2,1,2,3
67503_0,,,,2,1,2,3
67504_0,,,,2,1,2,3
67505_0,,,,2,1,2,3
67506_0,,,,2,1,2,3
67507_0,,,,2,1,2,3
67508_0,,,,2,1,2,3
67509_0,,,,2,1,2,3
67510_0,,,,2,1,2,3
67511_0,,,,2,1,2,3
67512_0,,,,2,1,2,3
67513_0,,,,2,1,2,3
67514_0,,,,2,1,2,3
67515_0,,,,2,1,2,3
67516_0,,,,2,1,2,3
67517_0,,,,2,1,2,3
67518_0,,,,2,1,2,3
67519_0,,,,2,1,2,3
67520_0,,,,2,1,2,3
67521_0,,,,2,1,2,3
67522_0,,,,2,1,2,3
67523_0,,,,2,1,2,3
67524_0,,,,2,1,2,3
67525_0,,,,2,1,2,3
67526_0,,,,2,1,2,3
67527_0,,,,2,1,2,3
67528_0,,,,2,1,2,3
67529_0,,,,2,1,2,3
67530_0,,,,2,1,2,3
67531_0,,,,2,1,2,3
67532_0,,,,2,1,2,3
67533_0,,,,2,1,2,3
67534_0,,,,2,1,2,3
67535_0,,,,2,1,2,3
67536_0,,,,2,1,2,3
67537_0,,,,2,1,2,3
67538_0,,,,2,1,2,3
67539_0,,,,2,1,2,3
67540_0,,,,2,1,2,3
67541_0,,,,2,1,2,3
67542_0,,,,2,1,2,3
67543_0,,,,2,1,2,3
67544_0,,,,2,1,2,3
67545_0,,,,2,1,2,3
67546_0,,,,2,1,2,3
67547_0,,,,2,1,2,3
67548_0,,,,2,1,2,3
67549_0,,,,2,1,2,3
67550_0,,,,2,1,2,3
67551_0,,,,2,1,2,3
67552_0,,,,2,1,2,3
67553_0,,,,2,1,2,3
67554_0,,,,2,1,2,3
67555_0,,,,2,1,2,3
67556_0,,,,2,1,2,3
67557_0,,,,2,1,2,3
67558_0,,,,2,1,2,3
67559_0,,,,2,1,2,3
67560_0,,,,2,1,2,3
67561_0,,,,2,1,2,3
67562_0,,,,2,1,2,3
67563_0,,,,2,1,2,3
67564_0,,,,2,1,2,3
67565_0,,,,2,1,2,3
67566_0,,,,2,1,2,3
67567_0,,,,2,1,2,3
67568_0,,,,2,1,2,3
67569_0,,,,2,1,2,3
67570_0,,,,2,1,2,3
67571_0,,,,2,1,2,3
67572_0,,,,2,1,2,3
67573_0,,,,2,1,2,3
67574_0,,,,2,1,2,3
67575_0,,,,2,1,2,3
67576_0,,,,2,1,2,3
67577_0,,,,2,1,2,3
67578_0,,,,2,1,2,3
67579_0,,,,2,1,2,3
67580_0,,,,2,1,2,3
67581_0,,,,2,1,2,3
67582_0,,,,2,1,2,3
67583_0,,,,2,1,2,3
67584_0,,,,2,1,2,3
67585_0,,,,2,1,2,3
67586_0,,,,2,1,2,3
67587_0,,,,2,1,2,3
67588_0,,,,2,1,2,3
67589_0,,,,2,1,2,3
67590_0,,,,2,1,2,3
67591_0,,,,2,1,2,3
67592_0,,,,2,1,2,3
67593_0,,,,2,1,2,3
67594_0,,,,2,1,2,3
67595_0,,,,2,1,2,3
67596_0,,,,2,1,2,3
67597_0,,,,2,1,2,3
67598_0,,,,2,1,2,3
67599_0,,,,2,1,2,3
67600_0,,,,2,1,2,3
67601_0,,,,2,1,2,3
67602_0,,,,2,1,2,3
67603_0,,,,2,1,2,3
67604_0,,,,2,1,2,3
67605_0,,,,2,1,2,3
67606_0,,,,2,1,2,3
67607_0,,,,2,1,2,3
67608_0,,,,2,1,2,3
67609_0,,,,2,1,2,3
67610_0,,,,2,1,2,3
67611_0,,,,2,1,2,3
67612_0,,,,2,1,2,3
67613_0,,,,2,1,2,3
67614_0,,,,2,1,2,3
67615_0,,,,2,1,2,3
67616_0,,,,2,1,2,3
67617_0,,,,2,1,2,3
67618_0,,,,2,1,2,3
67619_0,,,,2,1,2,3
67620_0,,,,2,1,2,3
67621_0,,,,2,1,2,3
67622_0,,,,2,1,2,3
67623_0,,,,2,1,2,3
67624_0,,,,2,1,2,3
67625_0,,,,2,1,2,3
67626_0,,,,2,1,2,3
67627_0,,,,2,1,2,3
67628_0,,,,2,1,2,3
67629_0,,,,2,1,2,3
67630_0,,,,2,1,2,3
67631_0,,,,2,1,2,3
67632_0,,,,2,1,2,3
67633_0,,,,2,1,2,3
67634_0,,,,2,1,2,3
67635_0,,,,2,1,2,3
67636_0,,,,2,1,2,3
67637_0,,,,2,1,2,3
67638_0,,,,2,1,2,3
67639_0,,,,2,1,2,3
67640_0,,,,2,1,2,3
67641_0,,,,2,1,2,3
67642_0,,,,2,1,2,3
67643_0,,,,2,1,2,3
67644_0,,,,2,1,2,3
67645_0,,,,2,1,2,3
67646_0,,,,2,1,2,3
67647_0,,,,2,1,2,3
67648_0,,,,2,1,2,3
67649_0,,,,2,1,2,3
67650_0,,,,2,1,2,3
67651_0,,,,2,1,2,3
67652_0,,,,2,1,2,3
67653_0,,,,2,1,2,3
67654_0,,,,2,1,2,3
67655_0,,,,2,1,2,3
67656_0,,,,2,1,2,3
67657_0,,,,2,1,2,3
67658_0,,,,2,1,2,3
67659_0,,,,2,1,2,3
67660_0,,,,2,1,2,3
67661_0,,,,2,1,2,3
67662_0,,,,2,1,2,3
67663_0,,,,2,1,2,3
67664_0,,,,2,1,2,3
67665_0,,,,2,1,2,3
67666_0,,,,2,1,2,3
67667_0,,,,2,1,2,3
67668_0,,,,2,1,2,3
67669_0,,,,2,1,2,3
67670_0,,,,2,1,2,3
67671_0,,,,2,1,2,3
67672_0,,,,2,1,2,3
67673_0,,,,2,1,2,3
67674_0,,,,2,1,2,3
67675_0,,,,2,1,2,3
67676_0,,,,2,1,2,3
67677_0,,,,2,1,2,3
67678_0,,,,2,1,2,3
67679_0,,,,2,1,2,3
67680_0,,,,2,1,2,3
67681_0,,,,2,1,2,3
67682_0,,,,2,1,2,3
67683_0,,,,2,1,2,3
67685_0,,,,2,1,2,3
C(C1(C=CC(C1O)=O)O)(O)=O,,,5,1,1,0,1
67686_0,,,,2,1,2,3
67687_0,,,,2,1,2,3
67688_0,,,,2,1,2,3
67689_0,,,,2,1,2,3
67690_0,,,,2,1,2,3
67692_0,,,,2,1,2,3
C1(C(C=C(C=O)C1(CO)O)O)=O,,,5,1,1,0,1
67693_0,,,,2,1,2,3
67694_0,,,,2,1,2,3
67695_0,,,,2,1,2,3
67696_0,,,,2,1,2,3
67698_0,,,,2,1,2,3
C(CO)(C1(C=CC(C1O)=O)O)=O,,,5,1,1,0,1
67699_0,,,,2,1,2,3
67700_0,,,,2,1,2,3
67702_0,,,,2,1,2,3
C1(C(C=CC1(CO)O)O)=O,,,5,1,1,0,1
67703_0,,,,2,1,2,3
67704_0,,,,2,1,2,3
67705_0,,,,2,1,2,3
67706_0,,,,2,1,2,3
67707_0,,,,2,1,2,3
67708_0,,,,2,1,2,3
67709_0,,,,2,1,2,3
67710_0,,,,2,1,2,3
67711_0,,,,2,1,2,3
67712_0,,,,2,1,2,3
67713_0,,,,2,1,2,3
67714_0,,,,2,1,2,3
67715_0,,,,2,1,2,3
67716_0,,,,2,1,2,3
67718_0,,,,2,1,2,3
C(C(C(C(C)=O)(C=C)O)O)=O,,,5,1,1,0,1
67719_0,,,,2,1,2,3
67720_0,,,,2,1,2,3
67721_0,,,,2,1,2,3
67722_0,,,,2,1,2,3
67723_0,,,,2,1,2,3
67724_0,,,,2,1,2,3
67725_0,,,,2,1,2,3
67726_0,,,,2,1,2,3
67728_0,,,,2,1,2,3
C(C(C=O)(C=CCO)C(C)O)=O,,,5,1,1,0,1
67729_0,,,,2,1,2,3
67731_0,,,,2,1,2,3
C(C(C=O)(C(CO)=C)C(C)O)=O,,,5,1,1,0,1
67732_0,,,,2,1,2,3
67733_0,,,,2,1,2,3
67734_0,,,,2,1,2,3
67735_0,,,,2,1,2,3
67736_0,,,,2,1,2,3
67737_0,,,,2,1,2,3
67738_0,,,,2,1,2,3
67739_0,,,,2,1,2,3
67740_0,,,,2,1,2,3
67742_0,,,,2,1,2,3
C(C(C=O)(C=CC(C)O)CO)=O,,,5,1,1,0,1
67743_0,,,,2,1,2,3
67744_0,,,,2,1,2,3
67745_0,,,,2,1,2,3
67747_0,,,,2,1,2,3
C(C(C=O)(C=CCO)CO)=O,,,5,1,1,0,1
67749_0,,,,2,1,2,3
C(C(C=O)(C(CO)=C)CO)=O,,,5,1,1,0,1
67751_0,,,,2,1,2,3
C(C(C=O)(C(C(O)=O)=C)CO)=O,,,5,1,1,0,1
67753_0,,,,2,1,2,3
C(C(C=O)(C=CC(O)=O)CO)=O,,,5,1,1,0,1
67754_0,,,,2,1,2,3
67755_0,,,,2,1,2,3
67757_0,,,,2,1,2,3
C(C(C=O)(C=C(C=O)CO)O)=O,,,5,1,1,0,1
67758_0,,,,2,1,2,3
67759_0,,,,2,1,2,3
67760_0,,,,2,1,2,3
67761_0,,,,2,1,2,3
67762_0,,,,2,1,2,3
67763_0,,,,2,1,2,3
67764_0,,,,2,1,2,3
67765_0,,,,2,1,2,3
67766_0,,,,2,1,2,3
67767_0,,,,2,1,2,3
67768_0,,,,2,1,2,3
67769_0,,,,2,1,2,3
67770_0,,,,2,1,2,3
67771_0,,,,2,1,2,3
67772_0,,,,2,1,2,3
67773_0,,,,2,1,2,3
67774_0,,,,2,1,2,3
67775_0,,,,2,1,2,3
67776_0,,,,2,1,2,3
67778_0,,,,2,1,2,3
C(C(C=CC(C)O)(C(C)O)O)=O,,,5,1,1,0,1
67779_0,,,,2,1,2,3
67780_0,,,,2,1,2,3
67782_0,,,,2,1,2,3
C(C(C=O)(C=CC(C)O)O)=O,,,5,1,1,0,1
67783_0,,,,2,1,2,3
67784_0,,,,2,1,2,3
67786_0,,,,2,1,2,3
C(C)(C(C=CC(C)O)(CO)O)=O,,,5,1,1,0,1
67787_0,,,,2,1,2,3
67788_0,,,,2,1,2,3
67790_0,,,,2,1,2,3
C1(COCC1(C=CC(C)O)O)=O,,,5,1,1,0,1
67791_0,,,,2,1,2,3
67792_0,,,,2,1,2,3
67794_0,,,,2,1,2,3
C1COC(C=1C(CC(C)O)O)=O,,,5,1,2,0,2
67796_0,,,,2,1,2,3
C(CC(C)O)=C1C(OCC1O)=O,,,5,1,1,0,1
67798_0,,,,2,1,2,3
C1(C(C=CC(C)O)C(CO1)O)=O,,,5,1,1,0,1
67799_0,,,,2,1,2,3
67800_0,,,,2,1,2,3
67802_0,,,,2,1,2,3
C(C(C=CC(C)O)(CO)O)=O,,,5,1,1,0,1
67803_0,,,,2,1,2,3
67804_0,,,,2,1,2,3
67806_0,,,,2,1,2,3
C(C(C=CC(C)O)(CO)O)(O)=O,,,5,1,1,0,1
67807_0,,,,2,1,2,3
67808_0,,,,2,1,2,3
67810_0,,,,2,1,2,3
C(C(C(C)=O)(C=CC(C)O)O)=O,,,5,1,1,0,1
67811_0,,,,2,1,2,3
67812_0,,,,2,1,2,3
67813_0,,,,2,1,2,3
67814_0,,,,2,1,2,3
67815_0,,,,2,1,2,3
67816_0,,,,2,1,2,3
67817_0,,,,2,1,2,3
67819_0,,,,2,1,2,3
C(C(C=CCO)(C(C)O)O)=O,,,5,1,1,0,1
67820_0,,,,2,1,2,3
67821_0,,,,2,1,2,3
67823_0,,,,2,1,2,3
C(C(C(CO)=C)(C(C)O)O)=O,,,5,1,1,0,1
67824_0,,,,2,1,2,3
67825_0,,,,2,1,2,3
67826_0,,,,2,1,2,3
67828_0,,,,2,1,2,3
C(C(C=CC(O)=O)(C(C)O)O)=O,,,5,1,1,0,1
67829_0,,,,2,1,2,3
67830_0,,,,2,1,2,3
67831_0,,,,2,1,2,3
67832_0,,,,2,1,2,3
67833_0,,,,2,1,2,3
67834_0,,,,2,1,2,3
67835_0,,,,2,1,2,3
67836_0,,,,2,1,2,3
67837_0,,,,2,1,2,3
67838_0,,,,2,1,2,3
67839_0,,,,2,1,2,3
67840_0,,,,2,1,2,3
67842_0,,,,2,1,2,3
C(C(C=CCO)(C(C=O)=O)O)=O,,,5,1,1,0,1
67843_0,,,,2,1,2,3
67845_0,,,,2,1,2,3
C(C(C(CO)=O)(C=CCO)O)=O,,,5,1,1,0,1
67846_0,,,,2,1,2,3
67848_0,,,,2,1,2,3
C(C(C=O)(C=CCO)O)=O,,,5,1,1,0,1
67849_0,,,,2,1,2,3
67851_0,,,,2,1,2,3
C(C)(C(C=CCO)(CO)O)=O,,,5,1,1,0,1
67853_0,,,,2,1,2,3
C(C(C(CCO)O)=CC=O)(O)=O,,,5,1,2,0,2
67855_0,,,,2,1,2,3
C(C(C(C(O)=O)=CCCO)O)=O,,,5,1,1,0,1
67856_0,,,,2,1,2,3
67858_0,,,,2,1,2,3
C(C(C=CCO)C(C=O)O)(O)=O,,,5,1,1,0,1
67859_0,,,,2,1,2,3
67861_0,,,,2,1,2,3
C(C(C(C)=O)(C=CCO)O)(O)=O,,,5,1,1,0,1
67862_0,,,,2,1,2,3
67863_0,,,,2,1,2,3
67864_0,,,,2,1,2,3
67865_0,,,,2,1,2,3
67867_0,,,,2,1,2,3
C1(COCC1(C=CCO)O)=O,,,5,1,1,0,1
67869_0,,,,2,1,2,3
C1COC(C=1C(CCO)O)=O,,,5,1,2,0,2
67871_0,,,,2,1,2,3
C(CCO)=C1C(OCC1O)=O,,,5,1,1,0,1
67872_0,,,,2,1,2,3
67874_0,,,,2,1,2,3
C1(C(C=CCO)C(CO1)O)=O,,,5,1,1,0,1
67875_0,,,,2,1,2,3
67877_0,,,,2,1,2,3
C1(C(O)OCC1(C=CCO)O)=O,,,5,1,1,0,1
67878_0,,,,2,1,2,3
67880_0,,,,2,1,2,3
C1(C(C=CCO)(C(CO1)O)O)=O,,,5,1,1,0,1
67881_0,,,,2,1,2,3
67883_0,,,,2,1,2,3
C(C(C=O)(C=CC(CO)O)O)=O,,,5,1,1,0,1
67885_0,,,,2,1,2,3
C(C(C(CO)=C)(C(C=O)=O)O)=O,,,5,1,1,0,1
67886_0,,,,2,1,2,3
67888_0,,,,2,1,2,3
C(C(C(C=O)=O)(C(C=O)=C)O)=O,,,5,1,2,0,2
67890_0,,,,2,1,2,3
C(C(C=CC=O)(C(C=O)=O)O)=O,,,5,1,2,0,2
67892_0,,,,2,1,2,3
C(C(C(CO)=O)(C(CO)=C)O)=O,,,5,1,1,0,1
67893_0,,,,2,1,2,3
67895_0,,,,2,1,2,3
C(C(C=O)(C(C(CO)=O)=C)O)=O,,,5,1,1,0,1
67896_0,,,,2,1,2,3
67897_0,,,,2,1,2,3
67899_0,,,,2,1,2,3
C(C(C=O)(C(CO)=C)O)=O,,,5,1,1,0,1
67901_0,,,,2,1,2,3
C(C(C=O)(C(CO)=CCO)O)=O,,,5,1,1,0,1
67902_0,,,,2,1,2,3
67903_0,,,,2,1,2,3
67904_0,,,,2,1,2,3
67906_0,,,,2,1,2,3
C(C(C=O)(C(C(CO)O)=C)O)=O,,,5,1,1,0,1
67908_0,,,,2,1,2,3
C(C(C=O)(C(C(O)=O)=C)O)=O,,,5,1,1,0,1
67910_0,,,,2,1,2,3
C(C(C=O)(C=CC(O)=O)O)=O,,,5,1,2,0,2
67912_0,,,,2,1,2,3
C(C(C=O)(C(C=O)=CC=O)O)=O,,,5,1,1,0,1
67914_0,,,,2,1,2,3
C(C(C=O)(C=CC(C=O)=O)O)=O,,,5,1,1,0,1
67916_0,,,,2,1,2,3
C(C(C=O)(C1C(O)OCC=1)O)=O,,,5,1,1,0,1
67917_0,,,,2,1,2,3
67919_0,,,,2,1,2,3
C(C(C=O)(C1COC(C=1)O)O)=O,,,5,1,1,0,1
67921_0,,,,2,1,2,3
C(C(C=O)(C(C(C=O)=O)=C)O)=O,,,5,1,1,0,1
67922_0,,,,2,1,2,3
67924_0,,,,2,1,2,3
C(C(C=O)(C(C=O)=C)O)=O,,,5,1,1,0,1
67926_0,,,,2,1,2,3
C(C(C=O)(C=CC=O)O)=O,,,5,1,1,0,1
67928_0,,,,2,1,2,3
C(C(C=O)(C(C=O)=CCO)O)=O,,,5,1,1,0,1
67929_0,,,,2,1,2,3
67930_0,,,,2,1,2,3
67931_0,,,,2,1,2,3
67932_0,,,,2,1,2,3
67934_0,,,,2,1,2,3
C(C(C=O)(C=CC(C=O)O)O)=O,,,5,1,1,0,1
67936_0,,,,2,1,2,3
C(C(C=O)(C=CC(CO)=O)O)=O,,,5,1,1,0,1
67938_0,,,,2,1,2,3
C(C(C=O)(C(CO)=CC=O)O)=O,,,5,1,1,0,1
67940_0,,,,2,1,2,3
C(C(C=O)(C(C(C=O)O)=C)O)=O,,,5,1,1,0,1
67941_0,,,,2,1,2,3
67943_0,,,,2,1,2,3
C(C(C(C1C(OCC=1)=O)O)O)=O,,,5,1,2,0,2
67945_0,,,,2,1,2,3
C(C(C=C1C(OCC1O)=O)O)=O,,,5,1,1,0,1
67947_0,,,,2,1,2,3
C(C)(C(C(CO)=C)(CO)O)=O,,,5,1,1,0,1
67949_0,,,,2,1,2,3
C(C(C(CO)(C)O)=CC=O)(O)=O,,,5,1,2,0,2
67951_0,,,,2,1,2,3
C(C(C(C(O)=O)=C(CO)C)O)=O,,,5,1,1,0,1
67953_0,,,,2,1,2,3
C(C(C(CO)=C)C(C=O)O)(O)=O,,,5,1,1,0,1
67955_0,,,,2,1,2,3
C(C(C(C)=O)(C(CO)=C)O)(O)=O,,,5,1,1,0,1
67956_0,,,,2,1,2,3
67958_0,,,,2,1,2,3
C(C(C(CO)=C)(C(C)O)O)(O)=O,,,5,1,1,0,1
67960_0,,,,2,1,2,3
C1(COCC1(C(CO)=C)O)=O,,,5,1,1,0,1
67962_0,,,,2,1,2,3
C1COC(C=1C(CO)(C)O)=O,,,5,1,2,0,2
67964_0,,,,2,1,2,3
C(CO)(C)=C1C(OCC1O)=O,,,5,1,1,0,1
67966_0,,,,2,1,2,3
C1(C(C(CO)=C)C(CO1)O)=O,,,5,1,1,0,1
67968_0,,,,2,1,2,3
C1(C(O)OCC1(C(CO)=C)O)=O,,,5,1,1,0,1
67970_0,,,,2,1,2,3
C1(C(C(CO)=C)(C(CO1)O)O)=O,,,5,1,1,0,1
67971_0,,,,2,1,2,3
67973_0,,,,2,1,2,3
C(C)(C(C=CC(O)=O)(CO)O)=O,,,5,1,1,0,1
67974_0,,,,2,1,2,3
67976_0,,,,2,1,2,3
C1(COCC1(C(C(O)=O)=C)O)=O,,,5,1,1,0,1
67978_0,,,,2,1,2,3
C(C(C1C(OCC=1)=O)(C)O)(O)=O,,,5,1,2,0,2
67980_0,,,,2,1,2,3
C1(C(C(CO1)O)=C(C(O)=O)C)=O,,,5,1,1,0,1
67982_0,,,,2,1,2,3
C1(C(C(C(O)=O)=C)C(CO1)O)=O,,,5,1,1,0,1
67984_0,,,,2,1,2,3
C1(COCC1(C=CC(O)=O)O)=O,,,5,1,1,0,1
67986_0,,,,2,1,2,3
C(CC(C1C(OCC=1)=O)O)(O)=O,,,5,1,2,0,2
67988_0,,,,2,1,2,3
C(CC=C1C(OCC1O)=O)(O)=O,,,5,1,2,0,2
67990_0,,,,2,1,2,3
C1(C(C=CC(O)=O)C(CO1)O)=O,,,5,1,1,0,1
67992_0,,,,2,1,2,3
C(C=C(C(O)=O)C(O)=O)=O,,,5,1,2,0,2
67994_0,,,,2,1,2,3
C(C(C(C(O)=O)=CC(O)O)O)=O,,,5,1,1,0,1
67996_0,,,,2,1,2,3
C(C(C(C(O)O)O)=CC=O)(O)=O,,,5,1,2,0,2
67997_0,,,,2,1,2,3
67999_0,,,,2,1,2,3
C(C(C(C(O)=O)=CC(C)O)O)=O,,,5,1,1,0,1
68001_0,,,,2,1,2,3
C(C(C(C(C)O)O)=CC=O)(O)=O,,,5,1,2,0,2
68002_0,,,,2,1,2,3
68003_0,,,,2,1,2,3
68004_0,,,,2,1,2,3
68005_0,,,,2,1,2,3
68006_0,,,,2,1,2,3
68008_0,,,,2,1,2,3
C(C(C(C(C)=O)(C=C)O)O)(O)=O,,,5,1,1,0,1
68009_0,,,,2,1,2,3
68010_0,,,,2,1,2,3
68011_0,,,,2,1,2,3
68012_0,,,,2,1,2,3
68013_0,,,,2,1,2,3
68014_0,,,,2,1,2,3
68015_0,,,,2,1,2,3
68016_0,,,,2,1,2,3
68017_0,,,,2,1,2,3
68018_0,,,,2,1,2,3
68019_0,,,,2,1,2,3
68020_0,,,,2,1,2,3
68022_0,,,,2,1,2,3
C(C(C=C)(C(C=O)=O)CO)=O,,,5,1,1,0,1
68024_0,,,,2,1,2,3
C(CC(O)=O)(C(C=C)(CO)O)=O,,,5,1,1,0,1
68025_0,,,,2,1,2,3
68026_0,,,,2,1,2,3
68027_0,,,,2,1,2,3
68028_0,,,,2,1,2,3
68030_0,,,,2,1,2,3
C1(COCC1(C(C=O)=C)O)=O,,,5,1,1,0,1
68032_0,,,,2,1,2,3
C1(COCC1(C=CC=O)O)=O,,,5,1,1,0,1
68034_0,,,,2,1,2,3
C1(COCC1(C=C)O)=O,,,5,1,1,0,1
68036_0,,,,2,1,2,3
C(C(C1C(OCC=1)O)(CO)O)=O,,,5,1,1,0,1
68038_0,,,,2,1,2,3
C=CC(C=O)=C1C(OCC1O)=O,,,5,1,1,0,1
68040_0,,,,2,1,2,3
C(C(C=C)(C1C(OCC=1)=O)O)=O,,,5,1,2,0,2
68042_0,,,,2,1,2,3
C=CC(C=C1C(OCC1O)=O)=O,,,5,1,1,0,1
68044_0,,,,2,1,2,3
C=CC(C(C1C(OCC=1)=O)O)=O,,,5,1,2,0,2
68046_0,,,,2,1,2,3
C(C=CC=C1C(OCC1O)=O)=O,,,5,1,1,0,1
68048_0,,,,2,1,2,3
C(C(C1C(OCC=1)=O)O)=CC=O,,,5,1,2,0,2
68050_0,,,,2,1,2,3
C1COC(C=1C(O)=O)=O,,,5,1,2,0,2
68052_0,,,,2,1,2,3
C(C(O)O)=C1C(OCC1O)=O,,,5,1,1,0,1
68054_0,,,,2,1,2,3
C1COC(C=1C(C(O)O)O)=O,,,5,1,2,0,2
68055_0,,,,2,1,2,3
68057_0,,,,2,1,2,3
C(C(C)O)=C1C(OCC1O)=O,,,5,1,1,0,1
68059_0,,,,2,1,2,3
C1COC(C=1C(C(C)O)O)=O,,,5,1,2,0,2
68061_0,,,,2,1,2,3
C(C(CO)O)=C1C(OCC1O)=O,,,5,1,1,0,1
68063_0,,,,2,1,2,3
C1COC(C=1C(C(CO)O)O)=O,,,5,1,2,0,2
68065_0,,,,2,1,2,3
C1(C(C(CO1)O)=CC=O)=O,,,5,1,2,0,2
68067_0,,,,2,1,2,3
C(C(C1C(OCC=1)=O)O)=O,,,5,1,2,0,2
68069_0,,,,2,1,2,3
C(CO)(CO)=C1C(OCC1O)=O,,,5,1,1,0,1
68071_0,,,,2,1,2,3
C1COC(C=1C(CO)(CO)O)=O,,,5,1,2,0,2
68073_0,,,,2,1,2,3
C1(C(C(CO1)O)=CC(O)=O)=O,,,5,1,1,0,1
68075_0,,,,2,1,2,3
C(C(C1C(OCC=1)=O)O)(O)=O,,,5,1,2,0,2
68077_0,,,,2,1,2,3
C1(C(C(C=O)=C)C(CO1)O)=O,,,5,1,1,0,1
68079_0,,,,2,1,2,3
C1(C(C(CO1)O)=C(C=O)C)=O,,,5,1,1,0,1
68081_0,,,,2,1,2,3
C(C(C1C(OCC=1)=O)(C)O)=O,,,5,1,2,0,2
68083_0,,,,2,1,2,3
C1(C(C(CO1)O)=CC(C)=O)=O,,,5,1,1,0,1
68085_0,,,,2,1,2,3
C(C)(C(C1C(OCC=1)=O)O)=O,,,5,1,2,0,2
68087_0,,,,2,1,2,3
C1(C(C=CC=O)C(CO1)O)=O,,,5,1,1,0,1
68089_0,,,,2,1,2,3
C(CC=C1C(OCC1O)=O)=O,,,5,1,1,0,1
68091_0,,,,2,1,2,3
C(CC(C1C(OCC=1)=O)O)=O,,,5,1,2,0,2
68093_0,,,,2,1,2,3
C1(C(C=C)C(CO1)O)=O,,,5,1,1,0,1
68095_0,,,,2,1,2,3
C(C)=C1C(OCC1O)=O,,,5,1,1,0,1
68097_0,,,,2,1,2,3
C1COC(C=1C(C)O)=O,,,5,1,2,0,2
68099_0,,,,2,1,2,3
C1(C(C(CO1)O)=C(C=O)CO)=O,,,5,1,1,0,1
68101_0,,,,2,1,2,3
C(C(C1C(OCC=1)=O)(CO)O)=O,,,5,1,2,0,2
68103_0,,,,2,1,2,3
C1(C(C(CO1)O)=CC(CO)=O)=O,,,5,1,1,0,1
68105_0,,,,2,1,2,3
C(CO)(C(C1C(OCC=1)=O)O)=O,,,5,1,2,0,2
68107_0,,,,2,1,2,3
C=C1C(OCC1O)=O,,,5,1,5,0,5
68109_0,,,,2,1,2,3
C1COC(C=1CO)=O,,,5,1,2,0,2
68111_0,,,,2,1,2,3
C(CO)=C1C(OCC1O)=O,,,5,1,3,0,3
68113_0,,,,2,1,2,3
C1COC(C=1C(CO)O)=O,,,5,1,2,0,2
68114_0,,,,2,1,2,3
68116_0,,,,2,1,2,3
C(C(C1COC(C=1)O)(CO)O)=O,,,5,1,1,0,1
68117_0,,,,2,1,2,3
68119_0,,,,2,1,2,3
C1(C(C=C)(C(C(O)O1)O)O)=O,,,5,1,4,0,4
68120_0,,,,2,1,2,3
68122_0,,,,2,1,2,3
C1(C(O)OCC1(C(C=O)=C)O)=O,,,5,1,2,0,2
68124_0,,,,2,1,2,3
C1(C(O)OCC1(C=CC=O)O)=O,,,5,1,2,0,2
68126_0,,,,2,1,2,3
C1(C(O)OCC1(C=C)O)=O,,,5,1,2,0,2
68128_0,,,,2,1,2,3
C(C(C(O)=O)=CC(O)=O)(O)=O,,,5,1,2,0,2
68129_0,,,,2,1,2,3
68131_0,,,,2,1,2,3
C1(C(C(C=O)=C)(C(CO1)O)O)=O,,,5,1,1,0,1
68133_0,,,,2,1,2,3
C1(C(C=CC=O)(C(CO1)O)O)=O,,,5,1,1,0,1
68135_0,,,,2,1,2,3
C1(C(C=C)(C(CO1)O)O)=O,,,5,1,3,0,3
68137_0,,,,2,1,2,3
C1(C(C=C)(C(C(CO)O1)O)O)=O,,,5,1,2,0,2
68139_0,,,,2,1,2,3
C1(C(C=C)(C(C(CO1)O)O)O)=O,,,5,1,2,0,2
68141_0,,,,2,1,2,3
C(C(C=C)(C(C(O)=O)=O)O)=O,,,5,1,3,0,3
68143_0,,,,2,1,2,3
C(C(C=C)C(C(O)=O)O)(O)=O,,,5,1,1,0,1
68145_0,,,,2,1,2,3
C(C(C(C(O)=O)=CC)O)(O)=O,,,5,1,1,0,1
68147_0,,,,2,1,2,3
C(C=C(C(O)=O)C(C)O)(O)=O,,,5,1,2,0,2
68148_0,,,,2,1,2,3
68150_0,,,,2,1,2,3
C(C(CO)=CC(O)=O)(O)=O,,,5,1,2,0,2
68151_0,,,,2,1,2,3
68153_0,,,,2,1,2,3
C(C=C(C(O)=O)C(CO)O)(O)=O,,,5,1,2,0,2
68154_0,,,,2,1,2,3
68155_0,,,,2,1,2,3
68156_0,,,,2,1,2,3
68157_0,,,,2,1,2,3
68158_0,,,,2,1,2,3
68159_0,,,,2,1,2,3
68160_0,,,,2,1,2,3
68161_0,,,,2,1,2,3
68163_0,,,,2,1,2,3
C(C1C(C(C(C=1)=O)O)O)(O)=O,,,5,1,1,0,1
68165_0,,,,2,1,2,3
C(C1C(C(C(C=1)=O)O)O)(C)=O,,,5,1,1,0,1
68166_0,,,,2,1,2,3
68167_0,,,,2,1,2,3
68169_0,,,,2,1,2,3
C(C1(C=CC(C1)O)O)=O,,,5,1,1,0,1
68170_0,,,,2,1,2,3
68171_0,,,,2,1,2,3
68172_0,,,,2,1,2,3
68173_0,,,,2,1,2,3
68174_0,,,,2,1,2,3
68175_0,,,,2,1,2,3
68176_0,,,,2,1,2,3
68177_0,,,,2,1,2,3
68179_0,,,,2,1,2,3
C(C(C=C(C(O)=O)C(O)=O)=O)=O,,,5,1,1,0,1
68180_0,,,,2,1,2,3
68182_0,,,,2,1,2,3
C(C(C=C(C(O)=O)C(C)O)=O)=O,,,5,1,1,0,1
68184_0,,,,2,1,2,3
C(C(C=O)=C(C(O)=O)C(O)=O)=O,,,5,1,1,0,1
68185_0,,,,2,1,2,3
68187_0,,,,2,1,2,3
C(C(C=O)=C(C(O)=O)C(C)O)=O,,,5,1,1,0,1
68188_0,,,,2,1,2,3
68189_0,,,,2,1,2,3
68190_0,,,,2,1,2,3
68192_0,,,,2,1,2,3
C(C(C(CO)=C)(CC=O)O)(O)=O,,,5,1,1,0,1
68193_0,,,,2,1,2,3
68194_0,,,,2,1,2,3
68195_0,,,,2,1,2,3
68196_0,,,,2,1,2,3
68197_0,,,,2,1,2,3
68199_0,,,,2,1,2,3
C(C(C=CC(C=O)(O)O)O)(O)=O,,,5,1,1,0,1
68200_0,,,,2,1,2,3
68201_0,,,,2,1,2,3
68203_0,,,,2,1,2,3
C(C(C=CC(C(O)=O)O)(C)O)=O,,,5,1,2,0,2
68204_0,,,,2,1,2,3
68206_0,,,,2,1,2,3
C(C(C=C[C](C(O)=O)O)O)(O)=O,,,5,1,1,0,1
68207_0,,,,2,1,2,3
68209_0,,,,2,1,2,3
C(C(C=CC(C=O)(O)O)(C)O)=O,,,5,1,1,0,1
68210_0,,,,2,1,2,3
68211_0,,,,2,1,2,3
68212_0,,,,2,1,2,3
68214_0,,,,2,1,2,3
C(C(C=CC(C=O)(C)O)(C)O)=O,,,5,1,1,0,1
68215_0,,,,2,1,2,3
68216_0,,,,2,1,2,3
68218_0,,,,2,1,2,3
C(C(C=C[C](C(O)=O)O)(C)O)=O,,,5,1,1,0,1
68219_0,,,,2,1,2,3
68220_0,,,,2,1,2,3
68221_0,,,,2,1,2,3
68222_0,,,,2,1,2,3
68223_0,,,,2,1,2,3
68224_0,,,,2,1,2,3
68225_0,,,,2,1,2,3
68226_0,,,,2,1,2,3
68227_0,,,,2,1,2,3
68228_0,,,,2,1,2,3
68229_0,,,,2,1,2,3
68230_0,,,,2,1,2,3
68232_0,,,,2,1,2,3
C(C(C=C(C(O)=O)C(C)=O)=O)=O,,,5,1,1,0,1
68234_0,,,,2,1,2,3
C(C)(C(C=C)(CC(C=O)=O)O)=O,,,5,1,1,0,1
68236_0,,,,2,1,2,3
C(C(C=C(C(C)=O)C(C)O)=O)=O,,,5,1,1,0,1
68238_0,,,,2,1,2,3
C(C(C=O)=C(C(O)=O)C(C)=O)=O,,,5,1,1,0,1
68240_0,,,,2,1,2,3
C(C(C=O)C(C(C)=O)(C=C)O)=O,,,5,1,1,0,1
68242_0,,,,2,1,2,3
C(C(C=O)=C(C(C)=O)C(C)O)=O,,,5,1,1,0,1
68243_0,,,,2,1,2,3
68245_0,,,,2,1,2,3
C(CC(C(C)=O)(C=CCO)O)=O,,,5,1,1,0,1
68247_0,,,,2,1,2,3
C(C=C(C(C)=O)C(CCO)O)=O,,,5,1,1,0,1
68249_0,,,,2,1,2,3
C(CC(C(C)=O)(C(CO)=C)O)=O,,,5,1,1,0,1
68251_0,,,,2,1,2,3
C(C=C(C(C)=O)C(CO)(C)O)=O,,,5,1,1,0,1
68253_0,,,,2,1,2,3
C(C=C(C(O)=O)C(C)=O)=O,,,5,1,2,0,2
68255_0,,,,2,1,2,3
C(C=C(C(C)=O)C(C(O)O)O)=O,,,5,1,1,0,1
68256_0,,,,2,1,2,3
68258_0,,,,2,1,2,3
C(C=C(C(C)=O)C(C(C)O)O)=O,,,5,1,1,0,1
68260_0,,,,2,1,2,3
C(C(C(C(C)=O)=CC=O)O)=O,,,5,1,1,0,1
68262_0,,,,2,1,2,3
C(C(C(C(C)=O)=CC=O)O)(O)=O,,,5,1,1,0,1
68264_0,,,,2,1,2,3
C(CC(C(C)=O)(C(C=O)=C)O)=O,,,5,1,1,0,1
68266_0,,,,2,1,2,3
C(C(C(C(C)=O)=CC=O)(C)O)=O,,,5,1,1,0,1
68268_0,,,,2,1,2,3
C(C)(C(C(C(C)=O)=CC=O)O)=O,,,5,1,1,0,1
68270_0,,,,2,1,2,3
C(CC(C(C)=O)(C=CC=O)O)=O,,,5,1,1,0,1
68272_0,,,,2,1,2,3
C(CC(C(C(C)=O)=CC=O)O)=O,,,5,1,1,0,1
68274_0,,,,2,1,2,3
C(CC(C(C)=O)(C=C)O)=O,,,5,1,1,0,1
68276_0,,,,2,1,2,3
C(C=C(C(C)=O)C(C)O)=O,,,5,1,1,0,1
68278_0,,,,2,1,2,3
C(C=C(C(C)=O)C(CO)O)=O,,,5,1,1,0,1
68280_0,,,,2,1,2,3
C(C(C=CC(C(C)=O)O)(O)O)=O,,,5,1,1,0,1
68281_0,,,,2,1,2,3
68282_0,,,,2,1,2,3
68283_0,,,,2,1,2,3
68284_0,,,,2,1,2,3
68286_0,,,,2,1,2,3
C(C)(C(C=C[C](C(O)=O)O)O)=O,,,5,1,1,0,1
68287_0,,,,2,1,2,3
68288_0,,,,2,1,2,3
68289_0,,,,2,1,2,3
68290_0,,,,2,1,2,3
68292_0,,,,2,1,2,3
C(C(C(C(CC=O)O)=C)(O)O)=O,,,5,1,1,0,1
68293_0,,,,2,1,2,3
68294_0,,,,2,1,2,3
68296_0,,,,2,1,2,3
C(CC(C(C(C=O)(C)O)=C)O)=O,,,5,1,1,0,1
68297_0,,,,2,1,2,3
68299_0,,,,2,1,2,3
C(CC(C([C](C(O)=O)O)=C)O)=O,,,5,1,1,0,1
68300_0,,,,2,1,2,3
68301_0,,,,2,1,2,3
68303_0,,,,2,1,2,3
C(C(C(C=O)=CC(C)O)(O)O)=O,,,5,1,1,0,1
68304_0,,,,2,1,2,3
68305_0,,,,2,1,2,3
68306_0,,,,2,1,2,3
68307_0,,,,2,1,2,3
68308_0,,,,2,1,2,3
68309_0,,,,2,1,2,3
68311_0,,,,2,1,2,3
C(C(C)O)=C(C=O)[C](C(O)=O)O,,,5,1,1,0,1
68312_0,,,,2,1,2,3
68313_0,,,,2,1,2,3
68314_0,,,,2,1,2,3
68315_0,,,,2,1,2,3
68316_0,,,,2,1,2,3
68317_0,,,,2,1,2,3
68318_0,,,,2,1,2,3
68319_0,,,,2,1,2,3
68320_0,,,,2,1,2,3
68321_0,,,,2,1,2,3
68323_0,,,,2,1,2,3
C(C(C=C(C(CO)=O)CO)=O)=O,,,5,1,1,0,1
68325_0,,,,2,1,2,3
C(C(C(O)=O)=CC(C=O)=O)=O,,,5,1,1,0,1
68327_0,,,,2,1,2,3
C(C(C=CC(CC=O)O)(O)O)=O,,,5,1,1,0,1
68328_0,,,,2,1,2,3
68329_0,,,,2,1,2,3
68330_0,,,,2,1,2,3
68332_0,,,,2,1,2,3
C(CC(C=CC(C=O)(C)O)O)=O,,,5,1,1,0,1
68333_0,,,,2,1,2,3
68334_0,,,,2,1,2,3
68336_0,,,,2,1,2,3
C(CC(C=C[C](C(O)=O)O)O)=O,,,5,1,1,0,1
68337_0,,,,2,1,2,3
68338_0,,,,2,1,2,3
68339_0,,,,2,1,2,3
68340_0,,,,2,1,2,3
68342_0,,,,2,1,2,3
C(C(C=C(C=O)C(C)O)(O)O)=O,,,5,1,1,0,1
68343_0,,,,2,1,2,3
68344_0,,,,2,1,2,3
68345_0,,,,2,1,2,3
68347_0,,,,2,1,2,3
C(C(C=C(C=O)C(C)O)(C)O)=O,,,5,1,1,0,1
68348_0,,,,2,1,2,3
68349_0,,,,2,1,2,3
68351_0,,,,2,1,2,3
C([C](C=C(C=O)C(C)O)O)(O)=O,,,5,1,1,0,1
68353_0,,,,2,1,2,3
C(C(C=O)=C(C(CO)=O)CO)=O,,,5,1,1,0,1
68355_0,,,,2,1,2,3
C(C(C=O)=C(C=O)C(O)=O)=O,,,5,1,1,0,1
68356_0,,,,2,1,2,3
68358_0,,,,2,1,2,3
C(C(C=C(C=O)CO)(O)O)=O,,,5,1,1,0,1
68359_0,,,,2,1,2,3
68360_0,,,,2,1,2,3
68362_0,,,,2,1,2,3
C(C(C=C(C=O)CO)(C)O)=O,,,5,1,1,0,1
68363_0,,,,2,1,2,3
68365_0,,,,2,1,2,3
C(C(CO)=C[C](C(O)=O)O)=O,,,5,1,1,0,1
68367_0,,,,2,1,2,3
C(C(C(CCO)=O)=CC=O)(O)=O,,,5,1,1,0,1
68368_0,,,,2,1,2,3
68370_0,,,,2,1,2,3
C(CCO)(C(C=C)(CC=O)O)=O,,,5,1,1,0,1
68372_0,,,,2,1,2,3
C(C(C(C)O)=CC=O)(CCO)=O,,,5,1,1,0,1
68373_0,,,,2,1,2,3
68375_0,,,,2,1,2,3
C(C(CO)=CC=O)(CCO)=O,,,5,1,1,0,1
68376_0,,,,2,1,2,3
68377_0,,,,2,1,2,3
68378_0,,,,2,1,2,3
68379_0,,,,2,1,2,3
68380_0,,,,2,1,2,3
68381_0,,,,2,1,2,3
68382_0,,,,2,1,2,3
68383_0,,,,2,1,2,3
68384_0,,,,2,1,2,3
68385_0,,,,2,1,2,3
68387_0,,,,2,1,2,3
C(C(C(C=O)=O)(C)O)=CC(C)O,,,5,1,1,0,1
68388_0,,,,2,1,2,3
68389_0,,,,2,1,2,3
68390_0,,,,2,1,2,3
68391_0,,,,2,1,2,3
68393_0,,,,2,1,2,3
C(C(C=CC(C)O)(CCO)O)=O,,,5,1,1,0,1
68394_0,,,,2,1,2,3
68395_0,,,,2,1,2,3
68397_0,,,,2,1,2,3
C1(CCOC1(C=CC(C)O)O)=O,,,5,1,1,0,1
68398_0,,,,2,1,2,3
68399_0,,,,2,1,2,3
68401_0,,,,2,1,2,3
C(C(C=C)(C=CC(C)O)O)(O)=O,,,5,1,1,0,1
68402_0,,,,2,1,2,3
68403_0,,,,2,1,2,3
68404_0,,,,2,1,2,3
68406_0,,,,2,1,2,3
C1(C(C=CC(C)O)(CCO1)O)=O,,,5,1,1,0,1
68407_0,,,,2,1,2,3
68408_0,,,,2,1,2,3
68410_0,,,,2,1,2,3
C(C(C=CC(C)O)(O)O)=O,,,5,1,1,0,1
68411_0,,,,2,1,2,3
68412_0,,,,2,1,2,3
68413_0,,,,2,1,2,3
68415_0,,,,2,1,2,3
C(C(C=CC(C)O)(C)O)=O,,,5,1,1,0,1
68416_0,,,,2,1,2,3
68417_0,,,,2,1,2,3
68419_0,,,,2,1,2,3
C(C(C)O)=C[C](C(O)=O)O,,,5,1,1,0,1
68420_0,,,,2,1,2,3
68421_0,,,,2,1,2,3
68423_0,,,,2,1,2,3
C(C(C=CC(C)O)O)(O)=O,,,5,1,1,0,1
68424_0,,,,2,1,2,3
68425_0,,,,2,1,2,3
68426_0,,,,2,1,2,3
68428_0,,,,2,1,2,3
C(C(C=CC(C)O)(CC=O)O)=O,,,5,1,1,0,1
68429_0,,,,2,1,2,3
68430_0,,,,2,1,2,3
68432_0,,,,2,1,2,3
C=C(C(O)=O)C(CC(C)O)O,,,5,1,1,0,1
68434_0,,,,2,1,2,3
C(C(C=CC(C)O)(C)O)(O)=O,,,5,1,1,0,1
68435_0,,,,2,1,2,3
68436_0,,,,2,1,2,3
68437_0,,,,2,1,2,3
68438_0,,,,2,1,2,3
68439_0,,,,2,1,2,3
68440_0,,,,2,1,2,3
68441_0,,,,2,1,2,3
68443_0,,,,2,1,2,3
C=C(C(O)=O)C(C(C(C)O)O)O,,,5,1,1,0,1
68444_0,,,,2,1,2,3
68445_0,,,,2,1,2,3
68446_0,,,,2,1,2,3
68448_0,,,,2,1,2,3
C(CC(C(CO)=O)(C=C)O)=O,,,5,1,1,0,1
68449_0,,,,2,1,2,3
68450_0,,,,2,1,2,3
68451_0,,,,2,1,2,3
68452_0,,,,2,1,2,3
68454_0,,,,2,1,2,3
C(C(C(C=O)=O)(C)O)=CCO,,,5,1,1,0,1
68455_0,,,,2,1,2,3
68456_0,,,,2,1,2,3
68457_0,,,,2,1,2,3
68459_0,,,,2,1,2,3
C(C(C=CCO)(CCO)O)=O,,,5,1,1,0,1
68460_0,,,,2,1,2,3
68461_0,,,,2,1,2,3
68463_0,,,,2,1,2,3
C(C(C=CCO)(CC(O)=O)O)=O,,,5,1,1,0,1
68464_0,,,,2,1,2,3
68466_0,,,,2,1,2,3
C1(CCOC1(C=CCO)O)=O,,,5,1,1,0,1
68467_0,,,,2,1,2,3
68469_0,,,,2,1,2,3
C(C(C=C)(C=CCO)O)(O)=O,,,5,1,1,0,1
68470_0,,,,2,1,2,3
68472_0,,,,2,1,2,3
C1(C(COC1(C=CCO)O)O)=O,,,5,1,1,0,1
68473_0,,,,2,1,2,3
68474_0,,,,2,1,2,3
68476_0,,,,2,1,2,3
C1(C(C=CCO)(CCO1)O)=O,,,5,1,1,0,1
68477_0,,,,2,1,2,3
68479_0,,,,2,1,2,3
C(C(C=CCO)(O)O)=O,,,5,1,1,0,1
68480_0,,,,2,1,2,3
68481_0,,,,2,1,2,3
68483_0,,,,2,1,2,3
C(C(C=CCO)(C)O)=O,,,5,1,1,0,1
68484_0,,,,2,1,2,3
68486_0,,,,2,1,2,3
C(CO)=C[C](C(O)=O)O,,,5,1,3,0,3
68487_0,,,,2,1,2,3
68489_0,,,,2,1,2,3
C(C(C=CC(CO)O)(O)O)=O,,,5,1,1,0,1
68490_0,,,,2,1,2,3
68491_0,,,,2,1,2,3
68493_0,,,,2,1,2,3
C(C(C=CC(CO)O)(C)O)=O,,,5,1,1,0,1
68494_0,,,,2,1,2,3
68496_0,,,,2,1,2,3
C(C(CO)O)=C[C](C(O)=O)O,,,5,1,3,0,3
68497_0,,,,2,1,2,3
68499_0,,,,2,1,2,3
C(C(C(C(CO)=O)=C)(O)O)=O,,,5,1,1,0,1
68500_0,,,,2,1,2,3
68501_0,,,,2,1,2,3
68503_0,,,,2,1,2,3
C=C(C(CO)=O)[C](C(O)=O)O,,,5,1,1,0,1
68504_0,,,,2,1,2,3
68506_0,,,,2,1,2,3
C=C(CO)C(C(C=O)=O)(C)O,,,5,1,1,0,1
68507_0,,,,2,1,2,3
68509_0,,,,2,1,2,3
C=C(C(O)=O)C(C(C=O)=O)(C)O,,,5,1,2,0,2
68510_0,,,,2,1,2,3
68512_0,,,,2,1,2,3
C(C(C(C=O)=O)(C)O)=CC(O)=O,,,5,1,1,0,1
68513_0,,,,2,1,2,3
68514_0,,,,2,1,2,3
68515_0,,,,2,1,2,3
68516_0,,,,2,1,2,3
68517_0,,,,2,1,2,3
68518_0,,,,2,1,2,3
68519_0,,,,2,1,2,3
68520_0,,,,2,1,2,3
68521_0,,,,2,1,2,3
68522_0,,,,2,1,2,3
68523_0,,,,2,1,2,3
68524_0,,,,2,1,2,3
68526_0,,,,2,1,2,3
C(C(C(C=O)=O)(C)O)=CC=O,,,5,1,1,0,1
68527_0,,,,2,1,2,3
68529_0,,,,2,1,2,3
C=CC(C(C=O)=O)(C)O,,,5,1,1,0,1
68530_0,,,,2,1,2,3
68531_0,,,,2,1,2,3
68532_0,,,,2,1,2,3
68533_0,,,,2,1,2,3
68534_0,,,,2,1,2,3
68535_0,,,,2,1,2,3
68536_0,,,,2,1,2,3
68537_0,,,,2,1,2,3
68538_0,,,,2,1,2,3
68539_0,,,,2,1,2,3
68540_0,,,,2,1,2,3
68541_0,,,,2,1,2,3
68543_0,,,,2,1,2,3
C(C(C(CO)=C)(CCO)O)=O,,,5,1,1,0,1
68544_0,,,,2,1,2,3
68546_0,,,,2,1,2,3
C(C(C(CO)=C)(CC(O)=O)O)=O,,,5,1,1,0,1
68548_0,,,,2,1,2,3
C1(CCOC1(C(CO)=C)O)=O,,,5,1,1,0,1
68550_0,,,,2,1,2,3
C(C(C=C)(C(CO)=C)O)(O)=O,,,5,1,1,0,1
68552_0,,,,2,1,2,3
C1(C(COC1(C(CO)=C)O)O)=O,,,5,1,1,0,1
68553_0,,,,2,1,2,3
68555_0,,,,2,1,2,3
C1(C(C(CO)=C)(CCO1)O)=O,,,5,1,1,0,1
68557_0,,,,2,1,2,3
C(C(C(CO)=C)(O)O)=O,,,5,1,1,0,1
68558_0,,,,2,1,2,3
68560_0,,,,2,1,2,3
C(C(C(CO)=C)(C)O)=O,,,5,1,1,0,1
68562_0,,,,2,1,2,3
C=C([C](C(O)=O)O)CO,,,5,1,1,0,1
68564_0,,,,2,1,2,3
C(C(C(CO)=CCO)(O)O)=O,,,5,1,1,0,1
68565_0,,,,2,1,2,3
68566_0,,,,2,1,2,3
68568_0,,,,2,1,2,3
C(C(C(CO)=CCO)(C)O)=O,,,5,1,1,0,1
68569_0,,,,2,1,2,3
68571_0,,,,2,1,2,3
C(CO)=C([C](C(O)=O)O)CO,,,5,1,1,0,1
68572_0,,,,2,1,2,3
68573_0,,,,2,1,2,3
68574_0,,,,2,1,2,3
68575_0,,,,2,1,2,3
68576_0,,,,2,1,2,3
68577_0,,,,2,1,2,3
68578_0,,,,2,1,2,3
68579_0,,,,2,1,2,3
68580_0,,,,2,1,2,3
68581_0,,,,2,1,2,3
68582_0,,,,2,1,2,3
68583_0,,,,2,1,2,3
68584_0,,,,2,1,2,3
68585_0,,,,2,1,2,3
68586_0,,,,2,1,2,3
68587_0,,,,2,1,2,3
68588_0,,,,2,1,2,3
68589_0,,,,2,1,2,3
68590_0,,,,2,1,2,3
68591_0,,,,2,1,2,3
68592_0,,,,2,1,2,3
68593_0,,,,2,1,2,3
68595_0,,,,2,1,2,3
C(C(C(C(CO)O)=C)(O)O)=O,,,5,1,1,0,1
68596_0,,,,2,1,2,3
68598_0,,,,2,1,2,3
C(C(C(C(CO)O)=C)(C)O)=O,,,5,1,1,0,1
68600_0,,,,2,1,2,3
C=C([C](C(O)=O)O)C(CO)O,,,5,1,1,0,1
68602_0,,,,2,1,2,3
C1(CCOC1(C(C(O)=O)=C)O)=O,,,5,1,1,0,1
68604_0,,,,2,1,2,3
C(C(C=C)(C(C(O)=O)=C)O)(O)=O,,,5,1,1,0,1
68605_0,,,,2,1,2,3
68607_0,,,,2,1,2,3
C1(C(C(C(O)=O)=C)(CCO1)O)=O,,,5,1,1,0,1
68609_0,,,,2,1,2,3
C(C(C(C(O)=O)=C)(O)O)=O,,,5,1,1,0,1
68611_0,,,,2,1,2,3
C=C(C(O)=O)[C](C(O)=O)O,,,5,1,1,0,1
68613_0,,,,2,1,2,3
C1(CCOC1(C=CC(O)=O)O)=O,,,5,1,1,0,1
68615_0,,,,2,1,2,3
C(C(C=C)(C=CC(O)=O)O)(O)=O,,,5,1,1,0,1
68616_0,,,,2,1,2,3
68618_0,,,,2,1,2,3
C1(C(C=CC(O)=O)(CCO1)O)=O,,,5,1,1,0,1
68620_0,,,,2,1,2,3
C(C(C=CC(O)=O)(O)O)=O,,,5,1,2,0,2
68621_0,,,,2,1,2,3
68622_0,,,,2,1,2,3
68624_0,,,,2,1,2,3
C([C](C=CC(O)=O)O)(O)=O,,,5,1,2,0,2
68626_0,,,,2,1,2,3
C(C(C(C(O)=O)=CCO)(O)O)=O,,,5,1,1,0,1
68627_0,,,,2,1,2,3
68629_0,,,,2,1,2,3
C(CO)=C(C(O)=O)[C](C(O)=O)O,,,5,1,1,0,1
68630_0,,,,2,1,2,3
68631_0,,,,2,1,2,3
68632_0,,,,2,1,2,3
68633_0,,,,2,1,2,3
68634_0,,,,2,1,2,3
68635_0,,,,2,1,2,3
68636_0,,,,2,1,2,3
68637_0,,,,2,1,2,3
68638_0,,,,2,1,2,3
68640_0,,,,2,1,2,3
C(C(C(CO)=CC(O)=O)(O)O)=O,,,5,1,1,0,1
68641_0,,,,2,1,2,3
68642_0,,,,2,1,2,3
68644_0,,,,2,1,2,3
C([C](C(CO)=CC(O)=O)O)(O)=O,,,5,1,1,0,1
68646_0,,,,2,1,2,3
C(C(C(C(C=O)(O)O)=C)O)(O)=O,,,5,1,1,0,1
68647_0,,,,2,1,2,3
68648_0,,,,2,1,2,3
68650_0,,,,2,1,2,3
C(C(C([C](C(O)=O)O)=C)O)(O)=O,,,5,1,1,0,1
68651_0,,,,2,1,2,3
68653_0,,,,2,1,2,3
C(C(C(C=O)=CC=O)(O)O)=O,,,5,1,1,0,1
68655_0,,,,2,1,2,3
C(C([C](C(O)=O)O)=CC=O)=O,,,5,1,1,0,1
68657_0,,,,2,1,2,3
C(C(C=CC(C=O)=O)(O)O)=O,,,5,1,1,0,1
68658_0,,,,2,1,2,3
68659_0,,,,2,1,2,3
68661_0,,,,2,1,2,3
C(C(C=C[C](C(O)=O)O)=O)=O,,,5,1,1,0,1
68662_0,,,,2,1,2,3
68664_0,,,,2,1,2,3
C=C(C(O)=O)C(CC(C=O)=O)O,,,5,1,2,0,2
68666_0,,,,2,1,2,3
C(C(C=CC(C=O)=O)(C)O)(O)=O,,,5,1,2,0,2
68668_0,,,,2,1,2,3
C(C(C(O)=O)=CC(CO)=O)(O)=O,,,5,1,1,0,1
68669_0,,,,2,1,2,3
68671_0,,,,2,1,2,3
C(C(C(C)O)=CC(CO)=O)(O)=O,,,5,1,1,0,1
68673_0,,,,2,1,2,3
C(C(C(C=O)=CC(O)=O)(O)O)=O,,,5,1,1,0,1
68675_0,,,,2,1,2,3
C(C([C](C(O)=O)O)=CC(O)=O)=O,,,5,1,1,0,1
68677_0,,,,2,1,2,3
C(C(C=CC(C(O)=O)=O)(O)O)=O,,,5,1,1,0,1
68678_0,,,,2,1,2,3
68680_0,,,,2,1,2,3
C(C(C=CC(C(O)=O)=O)(C)O)=O,,,5,1,1,0,1
68682_0,,,,2,1,2,3
C(C(C=C[C](C(O)=O)O)=O)(O)=O,,,5,1,1,0,1
68684_0,,,,2,1,2,3
C(C(C=CC(C(O)=O)=O)O)(O)=O,,,5,1,1,0,1
68686_0,,,,2,1,2,3
C(C(C(C(O)=O)=CC=O)(O)O)=O,,,5,1,1,0,1
68688_0,,,,2,1,2,3
C(C=C(C(O)=O)[C](C(O)=O)O)=O,,,5,1,1,0,1
68689_0,,,,2,1,2,3
68691_0,,,,2,1,2,3
C=C(C(O)=O)C1(COCC1O)O,,,5,1,1,0,1
68692_0,,,,2,1,2,3
68694_0,,,,2,1,2,3
C1(CCOC1(C(C=O)=C)O)=O,,,5,1,1,0,1
68696_0,,,,2,1,2,3
C1(CCOC1(C=CC=O)O)=O,,,5,1,1,0,1
68698_0,,,,2,1,2,3
C1(CCOC1(C=C)O)=O,,,5,1,1,0,1
68700_0,,,,2,1,2,3
C(C(C1C(O)OCC=1)(O)O)=O,,,5,1,1,0,1
68701_0,,,,2,1,2,3
68703_0,,,,2,1,2,3
C(C(C1C(OCC=1)O)(C)O)=O,,,5,1,1,0,1
68705_0,,,,2,1,2,3
C1COC(C=1[C](C(O)=O)O)O,,,5,1,1,0,1
68707_0,,,,2,1,2,3
C(C(C1C(O)OCC=1)O)(O)=O,,,5,1,1,0,1
68709_0,,,,2,1,2,3
C=C(C(O)=O)C1(C(O)OCC1)O,,,5,1,2,0,2
68711_0,,,,2,1,2,3
C(C(C1C(OCC=1)O)(C)O)(O)=O,,,5,1,1,0,1
68712_0,,,,2,1,2,3
68714_0,,,,2,1,2,3
C(C(C1COC(C=1)O)(O)O)=O,,,5,1,1,0,1
68715_0,,,,2,1,2,3
68716_0,,,,2,1,2,3
68718_0,,,,2,1,2,3
C(C(C1COC(C=1)O)(C)O)=O,,,5,1,1,0,1
68719_0,,,,2,1,2,3
68721_0,,,,2,1,2,3
C1C(O)OCC=1[C](C(O)=O)O,,,5,1,1,0,1
68722_0,,,,2,1,2,3
68724_0,,,,2,1,2,3
C(C(C1COC(C=1)O)O)(O)=O,,,5,1,1,0,1
68726_0,,,,2,1,2,3
C=C(C(O)=O)C1(COC(C1)O)O,,,5,1,2,0,2
68727_0,,,,2,1,2,3
68729_0,,,,2,1,2,3
C(C(C1COC(C=1)O)(C)O)(O)=O,,,5,1,1,0,1
68731_0,,,,2,1,2,3
C(C(C(C(C=O)=O)=C)(O)O)=O,,,5,1,1,0,1
68733_0,,,,2,1,2,3
C=C([C](C(O)=O)O)C(C=O)=O,,,5,1,1,0,1
68734_0,,,,2,1,2,3
68735_0,,,,2,1,2,3
68736_0,,,,2,1,2,3
68738_0,,,,2,1,2,3
C(C(C=C)(C(C(O)=O)=C)O)=O,,,5,1,2,0,2
68739_0,,,,2,1,2,3
68740_0,,,,2,1,2,3
68741_0,,,,2,1,2,3
68743_0,,,,2,1,2,3
C=C(C(O)=O)C(C(C=C)=O)O,,,5,1,2,0,2
68744_0,,,,2,1,2,3
68745_0,,,,2,1,2,3
68746_0,,,,2,1,2,3
68748_0,,,,2,1,2,3
C=C(C(O)=O)C(C=CC=O)O,,,5,1,3,0,3
68749_0,,,,2,1,2,3
68751_0,,,,2,1,2,3
C(C(C=C)(C(C=O)=C)O)(O)=O,,,5,1,2,0,2
68753_0,,,,2,1,2,3
C(C(C=C)(C=CC=O)O)(O)=O,,,5,1,2,0,2
68755_0,,,,2,1,2,3
C(C(C=C)(C=C)O)(O)=O,,,5,1,2,0,2
68756_0,,,,2,1,2,3
68758_0,,,,2,1,2,3
C1(C(COC1(C(C=O)=C)O)O)=O,,,5,1,1,0,1
68760_0,,,,2,1,2,3
C1(C(COC1(C=CC=O)O)O)=O,,,5,1,1,0,1
68762_0,,,,2,1,2,3
C1(C(COC1(C=C)O)O)=O,,,5,1,1,0,1
68763_0,,,,2,1,2,3
68764_0,,,,2,1,2,3
68766_0,,,,2,1,2,3
C(C(CO)O)=C(C(O)=O)C(O)=O,,,5,1,1,0,1
68767_0,,,,2,1,2,3
68768_0,,,,2,1,2,3
68769_0,,,,2,1,2,3
68771_0,,,,2,1,2,3
C=C(C(O)=O)C(O)=O,,,5,1,1,0,1
68773_0,,,,2,1,2,3
C(CO)=C(C(O)=O)C(O)=O,,,5,1,1,0,1
68774_0,,,,2,1,2,3
68775_0,,,,2,1,2,3
68776_0,,,,2,1,2,3
68777_0,,,,2,1,2,3
68778_0,,,,2,1,2,3
68779_0,,,,2,1,2,3
68780_0,,,,2,1,2,3
68781_0,,,,2,1,2,3
68783_0,,,,2,1,2,3
C1(C(C(C=O)=C)(CCO1)O)=O,,,5,1,2,0,2
68784_0,,,,2,1,2,3
68785_0,,,,2,1,2,3
68787_0,,,,2,1,2,3
C1(C(C=CC=O)(CCO1)O)=O,,,5,1,2,0,2
68788_0,,,,2,1,2,3
68790_0,,,,2,1,2,3
C1(C(C=C)(CCO1)O)=O,,,5,1,2,0,2
68791_0,,,,2,1,2,3
68792_0,,,,2,1,2,3
68793_0,,,,2,1,2,3
68794_0,,,,2,1,2,3
68795_0,,,,2,1,2,3
68797_0,,,,2,1,2,3
C(C(C=C)(CC(CO)O)O)(O)=O,,,5,1,1,0,1
68799_0,,,,2,1,2,3
C(C(CO)O)=C(C(O)=O)C(C)O,,,5,1,1,0,1
68800_0,,,,2,1,2,3
68802_0,,,,2,1,2,3
C(C(CO)O)=C(C(O)=O)CO,,,5,1,1,0,1
68803_0,,,,2,1,2,3
68804_0,,,,2,1,2,3
68805_0,,,,2,1,2,3
68806_0,,,,2,1,2,3
68807_0,,,,2,1,2,3
68808_0,,,,2,1,2,3
68809_0,,,,2,1,2,3
68811_0,,,,2,1,2,3
C(C(C(C=O)=C)(O)O)=O,,,5,1,1,0,1
68813_0,,,,2,1,2,3
C(C(C=CC=O)(O)O)=O,,,5,1,1,0,1
68815_0,,,,2,1,2,3
C(C(C(C=O)=CCO)(O)O)=O,,,5,1,1,0,1
68816_0,,,,2,1,2,3
68817_0,,,,2,1,2,3
68818_0,,,,2,1,2,3
68819_0,,,,2,1,2,3
68821_0,,,,2,1,2,3
C(C(C=CC(C=O)(O)O)O)=O,,,5,1,1,0,1
68823_0,,,,2,1,2,3
C(C(C=CC(CO)=O)(O)O)=O,,,5,1,1,0,1
68825_0,,,,2,1,2,3
C(C(C(CO)=CC=O)(O)O)=O,,,5,1,1,0,1
68827_0,,,,2,1,2,3
C(C(C(C(C=O)(O)O)=C)O)=O,,,5,1,1,0,1
68829_0,,,,2,1,2,3
C(C(C=C)(O)O)=O,,,5,1,1,0,1
68830_0,,,,2,1,2,3
68831_0,,,,2,1,2,3
68833_0,,,,2,1,2,3
C=C(C(O)=O)C(C(O)O)O,,,5,1,1,0,1
68835_0,,,,2,1,2,3
C(CO)=C(C(O)=O)C(C(O)O)O,,,5,1,1,0,1
68836_0,,,,2,1,2,3
68837_0,,,,2,1,2,3
68838_0,,,,2,1,2,3
68839_0,,,,2,1,2,3
68840_0,,,,2,1,2,3
68841_0,,,,2,1,2,3
68842_0,,,,2,1,2,3
68844_0,,,,2,1,2,3
C(C(C=CC=O)(C)O)=O,,,5,1,2,0,2
68845_0,,,,2,1,2,3
68846_0,,,,2,1,2,3
68847_0,,,,2,1,2,3
68848_0,,,,2,1,2,3
68850_0,,,,2,1,2,3
C(C(C=CC(CO)=O)(C)O)=O,,,5,1,1,0,1
68851_0,,,,2,1,2,3
68852_0,,,,2,1,2,3
68853_0,,,,2,1,2,3
68854_0,,,,2,1,2,3
68855_0,,,,2,1,2,3
68856_0,,,,2,1,2,3
68857_0,,,,2,1,2,3
68858_0,,,,2,1,2,3
68860_0,,,,2,1,2,3
C=C(C(O)=O)C(C(C)O)O,,,5,1,1,0,1
68861_0,,,,2,1,2,3
68863_0,,,,2,1,2,3
C(CO)=C(C(O)=O)C(C(C)O)O,,,5,1,1,0,1
68864_0,,,,2,1,2,3
68865_0,,,,2,1,2,3
68867_0,,,,2,1,2,3
C=C(C=O)[C](C(O)=O)O,,,5,1,1,0,1
68869_0,,,,2,1,2,3
C(C=C[C](C(O)=O)O)=O,,,5,1,1,0,1
68871_0,,,,2,1,2,3
C(CO)=C(C=O)[C](C(O)=O)O,,,5,1,1,0,1
68872_0,,,,2,1,2,3
68873_0,,,,2,1,2,3
68874_0,,,,2,1,2,3
68875_0,,,,2,1,2,3
68877_0,,,,2,1,2,3
C(C(C=C[C](C(O)=O)O)O)=O,,,5,1,1,0,1
68879_0,,,,2,1,2,3
C([C](C=CC(CO)=O)O)(O)=O,,,5,1,1,0,1
68881_0,,,,2,1,2,3
C([C](C(CO)=CC=O)O)(O)=O,,,5,1,1,0,1
68883_0,,,,2,1,2,3
C(C(C([C](C(O)=O)O)=C)O)=O,,,5,1,1,0,1
68885_0,,,,2,1,2,3
C=C[C](C(O)=O)O,,,5,1,3,0,3
68887_0,,,,2,1,2,3
C(CC(C=CC(CO)O)=O)=O,,,5,1,1,0,1
68888_0,,,,2,1,2,3
68889_0,,,,2,1,2,3
68890_0,,,,2,1,2,3
68892_0,,,,2,1,2,3
C=C(C(C(CO)=O)=O)CO,,,5,1,1,0,1
68893_0,,,,2,1,2,3
68894_0,,,,2,1,2,3
68895_0,,,,2,1,2,3
68896_0,,,,2,1,2,3
68897_0,,,,2,1,2,3
68898_0,,,,2,1,2,3
68899_0,,,,2,1,2,3
68901_0,,,,2,1,2,3
C(CC(C(C(CO)=C)=O)=O)=O,,,5,1,1,0,1
68902_0,,,,2,1,2,3
68903_0,,,,2,1,2,3
68905_0,,,,2,1,2,3
C=C(C(C(C=O)=O)=O)CO,,,5,1,1,0,1
68906_0,,,,2,1,2,3
68907_0,,,,2,1,2,3
68908_0,,,,2,1,2,3
68909_0,,,,2,1,2,3
68910_0,,,,2,1,2,3
68911_0,,,,2,1,2,3
68912_0,,,,2,1,2,3
68913_0,,,,2,1,2,3
68914_0,,,,2,1,2,3
68915_0,,,,2,1,2,3
68917_0,,,,2,1,2,3
C(CC(C(C(CO)=O)=O)=C)=O,,,5,1,1,0,1
68918_0,,,,2,1,2,3
68919_0,,,,2,1,2,3
68921_0,,,,2,1,2,3
C(C=C(C(C(CO)=O)=O)C)=O,,,5,1,1,0,1
68922_0,,,,2,1,2,3
68923_0,,,,2,1,2,3
68924_0,,,,2,1,2,3
68925_0,,,,2,1,2,3
68926_0,,,,2,1,2,3
68927_0,,,,2,1,2,3
68928_0,,,,2,1,2,3
68929_0,,,,2,1,2,3
68931_0,,,,2,1,2,3
C(CC(C(CO)=CC=O)=O)=O,,,5,1,1,0,1
68933_0,,,,2,1,2,3
C(CC(C(C(C=O)O)=C)=O)=O,,,5,1,1,0,1
68935_0,,,,2,1,2,3
C=C(C(CC(C=O)=O)=O)CO,,,5,1,1,0,1
68937_0,,,,2,1,2,3
C(C(C=O)C(C(CO)=C)=O)=O,,,5,1,1,0,1
68939_0,,,,2,1,2,3
C(CC(C(CO)=C)=O)=O,,,5,1,1,0,1
68941_0,,,,2,1,2,3
C(CC(C(CO)=CCO)=O)=O,,,5,1,1,0,1
68943_0,,,,2,1,2,3
C(CC(C(C(CO)O)=C)=O)=O,,,5,1,1,0,1
68944_0,,,,2,1,2,3
68945_0,,,,2,1,2,3
68946_0,,,,2,1,2,3
68947_0,,,,2,1,2,3
68948_0,,,,2,1,2,3
68949_0,,,,2,1,2,3
68950_0,,,,2,1,2,3
68951_0,,,,2,1,2,3
68952_0,,,,2,1,2,3
68953_0,,,,2,1,2,3
68954_0,,,,2,1,2,3
68955_0,,,,2,1,2,3
68956_0,,,,2,1,2,3
68957_0,,,,2,1,2,3
68958_0,,,,2,1,2,3
68959_0,,,,2,1,2,3
68960_0,,,,2,1,2,3
68961_0,,,,2,1,2,3
68962_0,,,,2,1,2,3
68963_0,,,,2,1,2,3
68964_0,,,,2,1,2,3
68965_0,,,,2,1,2,3
68966_0,,,,2,1,2,3
68967_0,,,,2,1,2,3
68968_0,,,,2,1,2,3
68969_0,,,,2,1,2,3
68971_0,,,,2,1,2,3
C(CC(C(C(C=O)=O)=O)=C)=O,,,5,1,1,0,1
68972_0,,,,2,1,2,3
68973_0,,,,2,1,2,3
68975_0,,,,2,1,2,3
C(CC(C(C(C=O)=C)=O)=O)=O,,,5,1,1,0,1
68976_0,,,,2,1,2,3
68978_0,,,,2,1,2,3
C(CC(C(C=CCO)=O)=O)=O,,,5,1,1,0,1
68979_0,,,,2,1,2,3
68980_0,,,,2,1,2,3
68982_0,,,,2,1,2,3
C(C(C(C(C)=CC=O)=O)=O)=O,,,5,1,1,0,1
68983_0,,,,2,1,2,3
68984_0,,,,2,1,2,3
68985_0,,,,2,1,2,3
68986_0,,,,2,1,2,3
68987_0,,,,2,1,2,3
68989_0,,,,2,1,2,3
C=C(C=O)C(C(C=O)=O)=O,,,5,1,2,0,2
68991_0,,,,2,1,2,3
C(C(C=O)=CC(C=O)=O)=O,,,5,1,3,0,3
68993_0,,,,2,1,2,3
C(C(CO)O)=C(C=O)C(C)=O,,,5,1,1,0,1
68995_0,,,,2,1,2,3
C(C(C(C(C)=O)=O)=CC=O)=O,,,5,1,1,0,1
68997_0,,,,2,1,2,3
C(CC(C(C=O)=CC=O)=O)=O,,,5,1,1,0,1
68999_0,,,,2,1,2,3
C=C(C(CO)=O)C(C(O)=O)=O,,,5,1,1,0,1
69001_0,,,,2,1,2,3
C=C(C(CO)=O)C(C(C)=O)=O,,,5,1,1,0,1
69003_0,,,,2,1,2,3
C(CC(C(C(CO)=O)=C)=O)=O,,,5,1,1,0,1
69005_0,,,,2,1,2,3
C=C(C(C)=O)C(CO)=O,,,5,1,1,0,1
69007_0,,,,2,1,2,3
C=C(C(CO)=O)C(CO)=O,,,5,1,1,0,1
69009_0,,,,2,1,2,3
C=C(C(O)=O)C(C(C)=O)=O,,,5,1,2,0,2
69011_0,,,,2,1,2,3
C(CC(C(C(O)=O)=C)=O)=O,,,5,1,2,0,2
69012_0,,,,2,1,2,3
69014_0,,,,2,1,2,3
C=C(C(O)=O)C(C(CO)=O)=O,,,5,1,1,0,1
69015_0,,,,2,1,2,3
69017_0,,,,2,1,2,3
C=C(C(C=O)=O)C(C(O)=O)=O,,,5,1,2,0,2
69018_0,,,,2,1,2,3
69020_0,,,,2,1,2,3
C(C(C(C)=O)=CC(O)=O)=O,,,5,1,1,0,1
69021_0,,,,2,1,2,3
69023_0,,,,2,1,2,3
C=C(C(C=O)=O)C(C(C)=O)=O,,,5,1,1,0,1
69024_0,,,,2,1,2,3
69025_0,,,,2,1,2,3
69027_0,,,,2,1,2,3
C(CC(C(C(C=O)=O)=C)=O)=O,,,5,1,1,0,1
69028_0,,,,2,1,2,3
69030_0,,,,2,1,2,3
C(CC(C(C=O)=CCO)=O)=O,,,5,1,1,0,1
69031_0,,,,2,1,2,3
69032_0,,,,2,1,2,3
69033_0,,,,2,1,2,3
69035_0,,,,2,1,2,3
C(C(CC(C(C=O)=C)=O)O)=O,,,5,1,1,0,1
69037_0,,,,2,1,2,3
C(CO)(CC(C(C=O)=C)=O)=O,,,5,1,1,0,1
69038_0,,,,2,1,2,3
69039_0,,,,2,1,2,3
69040_0,,,,2,1,2,3
69042_0,,,,2,1,2,3
C(C)(C(C(C(C=O)=C)=O)O)=O,,,5,1,1,0,1
69043_0,,,,2,1,2,3
69045_0,,,,2,1,2,3
C=C(C=O)C(C)=O,,,5,1,1,0,1
69047_0,,,,2,1,2,3
C(CO)=C(C=O)C(C)=O,,,5,1,1,0,1
69048_0,,,,2,1,2,3
69049_0,,,,2,1,2,3
69050_0,,,,2,1,2,3
69051_0,,,,2,1,2,3
69052_0,,,,2,1,2,3
69053_0,,,,2,1,2,3
69054_0,,,,2,1,2,3
69055_0,,,,2,1,2,3
69056_0,,,,2,1,2,3
69057_0,,,,2,1,2,3
69059_0,,,,2,1,2,3
C(CC(C=C(C(O)=O)C)=O)=O,,,5,1,1,0,1
69060_0,,,,2,1,2,3
69061_0,,,,2,1,2,3
69062_0,,,,2,1,2,3
69063_0,,,,2,1,2,3
69064_0,,,,2,1,2,3
69065_0,,,,2,1,2,3
69067_0,,,,2,1,2,3
C(CC(C=O)=C(C(O)=O)C)=O,,,5,1,1,0,1
69069_0,,,,2,1,2,3
C(CC(C(C(O)=O)=O)=C)=O,,,5,1,1,0,1
69070_0,,,,2,1,2,3
69071_0,,,,2,1,2,3
69073_0,,,,2,1,2,3
C(C(C)=CC(C(C)=O)=O)(O)=O,,,5,1,1,0,1
69074_0,,,,2,1,2,3
69075_0,,,,2,1,2,3
69076_0,,,,2,1,2,3
69078_0,,,,2,1,2,3
C(C(C(C)=C(C(O)=O)C)=O)=O,,,5,1,1,0,1
69080_0,,,,2,1,2,3
C(C=C(C(C(O)=O)=O)C)=O,,,5,1,1,0,1
69082_0,,,,2,1,2,3
C(C(C(C)=CC(O)=O)=O)=O,,,5,1,1,0,1
69083_0,,,,2,1,2,3
69084_0,,,,2,1,2,3
69085_0,,,,2,1,2,3
69086_0,,,,2,1,2,3
69087_0,,,,2,1,2,3
69088_0,,,,2,1,2,3
69089_0,,,,2,1,2,3
69090_0,,,,2,1,2,3
69092_0,,,,2,1,2,3
C1C(CO)OC(C=1)=O,,,5,1,2,0,2
69094_0,,,,2,1,2,3
C1C(C(CO)O)OC(C=1)=O,,,5,1,2,0,2
69096_0,,,,2,1,2,3
C1OC(C(C=1CO)=O)CO,,,5,1,1,0,1
69098_0,,,,2,1,2,3
C=C1C(C(CO)OC1O)=O,,,5,1,2,0,2
69100_0,,,,2,1,2,3
C1C(CO)OC(C=1CO)=O,,,5,1,1,0,1
69102_0,,,,2,1,2,3
C=C1C(OC(CO)C1O)=O,,,5,1,3,0,3
69104_0,,,,2,1,2,3
C1C(CO)OC(C=1C=O)O,,,5,1,1,0,1
69106_0,,,,2,1,2,3
C1OC(CO)C(C=1C=O)O,,,5,1,1,0,1
69108_0,,,,2,1,2,3
C(C1COC(C=1)=O)=O,,,5,1,1,0,1
69110_0,,,,2,1,2,3
C1COC(C=1C=O)O,,,5,1,1,0,1
69112_0,,,,2,1,2,3
C1OCC(C=1C=O)O,,,5,1,1,0,1
69114_0,,,,2,1,2,3
C1(C=C(C=O)C(CO)O1)=O,,,5,1,1,0,1
69116_0,,,,2,1,2,3
C1OCC(C=1C(C=O)=O)O,,,5,1,1,0,1
69118_0,,,,2,1,2,3
C1COC(C=1C(C=O)=O)O,,,5,1,1,0,1
69120_0,,,,2,1,2,3
C1COC(C=1C(CO)=O)O,,,5,1,1,0,1
69122_0,,,,2,1,2,3
C1OCC(C=1C(CO)=O)O,,,5,1,1,0,1
69124_0,,,,2,1,2,3
C1(C=CC(O1)=O)=O,,,5,1,1,0,1
69126_0,,,,2,1,2,3
C1OC(C(C=1)=O)=O,,,5,1,1,0,1
69128_0,,,,2,1,2,3
C1COC(C(C=1)=O)O,,,5,1,1,0,1
69130_0,,,,2,1,2,3
C1C(COC(C=1)=O)O,,,5,1,2,0,2
69132_0,,,,2,1,2,3
C1C(O)OCC(C=1)=O,,,5,1,2,0,2
69134_0,,,,2,1,2,3
C1OCC(C(C=1)=O)O,,,5,1,1,0,1
69136_0,,,,2,1,2,3
C1C(CO)OC(C(C=1)=O)O,,,5,1,1,0,1
69138_0,,,,2,1,2,3
C1C(C(CO)OC(C=1)=O)O,,,5,1,2,0,2
69140_0,,,,2,1,2,3
C1C(OC(C(C=1)=O)CO)O,,,5,1,2,0,2
69142_0,,,,2,1,2,3
C1OC(CO)C(C(C=1)=O)O,,,5,1,1,0,1
69144_0,,,,2,1,2,3
C1(C(O)OCC(C=1)=O)CO,,,5,1,1,0,1
69146_0,,,,2,1,2,3
C1OCC(C(C=1CO)=O)O,,,5,1,1,0,1
69148_0,,,,2,1,2,3
C=C1C(C(COC1O)O)=O,,,5,1,2,0,2
69150_0,,,,2,1,2,3
C1C(COC(C=1CO)=O)O,,,5,1,1,0,1
69152_0,,,,2,1,2,3
C=C1C(OCC(C1O)O)=O,,,5,1,3,0,3
69154_0,,,,2,1,2,3
C1C(COC(C=1C=O)O)O,,,5,1,1,0,1
69156_0,,,,2,1,2,3
C1OCC(C(C=1C=O)O)O,,,5,1,1,0,1
69158_0,,,,2,1,2,3
C1COC(C(C=1C=O)=O)O,,,5,1,1,0,1
69160_0,,,,2,1,2,3
C1(C=C(C=O)C(CO1)O)=O,,,5,1,1,0,1
69162_0,,,,2,1,2,3
C1C(O)OCC(C=1C=O)=O,,,5,1,1,0,1
69164_0,,,,2,1,2,3
C1C(COC(C(C=1)=O)O)O,,,5,1,1,0,1
69166_0,,,,2,1,2,3
C1C(C(COC(C=1)=O)O)O,,,5,1,2,0,2
69168_0,,,,2,1,2,3
C1C(O)OCC(C(C=1)=O)O,,,5,1,2,0,2
69170_0,,,,2,1,2,3
C1OCC(C(C(C=1)=O)O)O,,,5,1,1,0,1
69172_0,,,,2,1,2,3
C1COC(C(C(C=1)=O)O)O,,,5,1,1,0,1
69174_0,,,,2,1,2,3
C1C(C(OCC(C=1)=O)O)O,,,5,1,1,0,1
69176_0,,,,2,1,2,3
C1COC(C(C=1)=O)=O,,,5,1,1,0,1
69178_0,,,,2,1,2,3
C1(C=CC(CO1)=O)=O,,,5,1,1,0,1
69180_0,,,,2,1,2,3
C1C(CO)OC(C(C=1)=O)=O,,,5,1,1,0,1
69182_0,,,,2,1,2,3
C1(C=CC(C(CO)O1)=O)=O,,,5,1,1,0,1
69184_0,,,,2,1,2,3
C1C(COC(C(C=1)=O)=O)O,,,5,1,1,0,1
69186_0,,,,2,1,2,3
C1(C=CC(C(CO1)O)=O)=O,,,5,1,1,0,1
69188_0,,,,2,1,2,3
C1(C(C(C=CCO1)=O)O)=O,,,5,1,1,0,1
69190_0,,,,2,1,2,3
C1(C(C=CC(CO1)=O)O)=O,,,5,1,1,0,1
69191_0,,,,2,1,2,3
69192_0,,,,2,1,2,3
69194_0,,,,2,1,2,3
C=CC(C(C(C(O)=O)=O)O)=O,,,5,1,2,0,2
69196_0,,,,2,1,2,3
C(CO)=CC(C(C(O)=O)=O)=O,,,5,1,1,0,1
69197_0,,,,2,1,2,3
69198_0,,,,2,1,2,3
69199_0,,,,2,1,2,3
69200_0,,,,2,1,2,3
69202_0,,,,2,1,2,3
C(C(CC(C=C)=O)O)(O)=O,,,5,1,2,0,2
69203_0,,,,2,1,2,3
69205_0,,,,2,1,2,3
C=C(C=O)C(C(C=O)=O)=C,,,5,1,2,0,2
69206_0,,,,2,1,2,3
69208_0,,,,2,1,2,3
C=C(C=O)C(C=O)=CC=O,,,5,1,3,0,3
69209_0,,,,2,1,2,3
69210_0,,,,2,1,2,3
69211_0,,,,2,1,2,3
69212_0,,,,2,1,2,3
69213_0,,,,2,1,2,3
69215_0,,,,2,1,2,3
C=C(C=CC=O)C(C=O)=O,,,5,1,2,0,2
69216_0,,,,2,1,2,3
69218_0,,,,2,1,2,3
C(C(C=CC=O)=CC=O)=O,,,5,1,3,0,3
69219_0,,,,2,1,2,3
69220_0,,,,2,1,2,3
69221_0,,,,2,1,2,3
69222_0,,,,2,1,2,3
69223_0,,,,2,1,2,3
69224_0,,,,2,1,2,3
69225_0,,,,2,1,2,3
69227_0,,,,2,1,2,3
C=C(C=C)C(C=O)=O,,,5,1,2,0,2
69228_0,,,,2,1,2,3
69229_0,,,,2,1,2,3
69230_0,,,,2,1,2,3
69231_0,,,,2,1,2,3
69232_0,,,,2,1,2,3
69234_0,,,,2,1,2,3
C=C(C=O)C(C(O)=O)=C,,,5,1,2,0,2
69235_0,,,,2,1,2,3
69237_0,,,,2,1,2,3
C=C(C=O)C(C(O)=O)=CCO,,,5,1,2,0,2
69238_0,,,,2,1,2,3
69239_0,,,,2,1,2,3
69240_0,,,,2,1,2,3
69242_0,,,,2,1,2,3
C=C(C(O)=O)C=CC=O,,,5,1,2,0,2
69243_0,,,,2,1,2,3
69245_0,,,,2,1,2,3
C(CO)=C(C(O)=O)C=CC=O,,,5,1,2,0,2
69246_0,,,,2,1,2,3
69247_0,,,,2,1,2,3
69249_0,,,,2,1,2,3
C=C(C(O)=O)C(C=O)=CCO,,,5,1,2,0,2
69250_0,,,,2,1,2,3
69251_0,,,,2,1,2,3
69252_0,,,,2,1,2,3
69253_0,,,,2,1,2,3
69254_0,,,,2,1,2,3
69256_0,,,,2,1,2,3
C(C(C=CC(C(O)=O)=C)O)=O,,,5,1,2,0,2
69257_0,,,,2,1,2,3
69259_0,,,,2,1,2,3
C=C(C(O)=O)C=CC(CO)=O,,,5,1,2,0,2
69260_0,,,,2,1,2,3
69262_0,,,,2,1,2,3
C=C(C(O)=O)C(CO)=CC=O,,,5,1,2,0,2
69263_0,,,,2,1,2,3
69265_0,,,,2,1,2,3
C(C(C(C(C(O)=O)=C)=C)O)=O,,,5,1,2,0,2
69266_0,,,,2,1,2,3
69268_0,,,,2,1,2,3
C=C(C(O)=O)C=C,,,5,1,2,0,2
69269_0,,,,2,1,2,3
69271_0,,,,2,1,2,3
C=CC(C(O)=O)=CCO,,,5,1,2,0,2
69272_0,,,,2,1,2,3
69273_0,,,,2,1,2,3
69275_0,,,,2,1,2,3
C1OC(C(C(CO)O)O)C(C=1)O,,,5,1,1,0,1
69277_0,,,,2,1,2,3
C1C(C(C(CO)O)O)OC(C=1)O,,,5,1,1,0,1
69279_0,,,,2,1,2,3
C(C(C1C(C=C(C=O)O1)O)O)=O,,,5,1,1,0,1
69281_0,,,,2,1,2,3
C(C1(C=CC(C(C=O)O)O1)O)=O,,,5,1,1,0,1
69283_0,,,,2,1,2,3
C(C(C1C(C(C=O)=CO1)O)O)=O,,,5,1,1,0,1
69285_0,,,,2,1,2,3
C(C(C1C=C(C=O)C(O)O1)O)=O,,,5,1,1,0,1
69287_0,,,,2,1,2,3
C(C(C1C(C=CO1)O)O)=O,,,5,1,1,0,1
69289_0,,,,2,1,2,3
C(C(C1C=CC(O)O1)O)=O,,,5,1,2,0,2
69291_0,,,,2,1,2,3
C1C(CO)(COC=1C=O)O,,,5,1,1,0,1
69293_0,,,,2,1,2,3
C(C1(C=C(CO)CO1)O)=O,,,5,1,1,0,1
69295_0,,,,2,1,2,3
C1OCC(C=1C=O)(CO)O,,,5,1,1,0,1
69297_0,,,,2,1,2,3
C1(COC(C=1C=O)O)CO,,,5,1,1,0,1
69299_0,,,,2,1,2,3
C=C1C(C(OC1(CO)CO)O)=O,,,5,1,2,0,2
69301_0,,,,2,1,2,3
C1(CO)C(CO)(COC=1C=O)O,,,5,1,1,0,1
69303_0,,,,2,1,2,3
C(C1(C(C(CO)(CO1)O)=C)O)=O,,,5,1,2,0,2
69305_0,,,,2,1,2,3
C(C1(C(CO)=C(CO)CO1)O)=O,,,5,1,1,0,1
69307_0,,,,2,1,2,3
C1C(OC(C=1C=O)(CO)CO)O,,,5,1,2,0,2
69309_0,,,,2,1,2,3
C1(C(O)OCC1(CO)O)=CC=O,,,5,1,3,0,3
69311_0,,,,2,1,2,3
C(C(C1C(CO)(COC=1)O)O)=O,,,5,1,1,0,1
69313_0,,,,2,1,2,3
C(C(C1C(O)OCC=1CO)O)=O,,,5,1,1,0,1
69315_0,,,,2,1,2,3
C1OCC(C=1C(CO)=O)(CO)O,,,5,1,1,0,1
69317_0,,,,2,1,2,3
C1(COC(C=1C(CO)=O)O)CO,,,5,1,1,0,1
69319_0,,,,2,1,2,3
C1(CO)OCC(C=1C=O)(CO)O,,,5,1,1,0,1
69321_0,,,,2,1,2,3
C1(CO)COC(C=1C=O)(CO)O,,,5,1,1,0,1
69323_0,,,,2,1,2,3
C1(C(C(CO)(CO1)O)O)=CC=O,,,5,1,1,0,1
69325_0,,,,2,1,2,3
C(C(C1OCC(C=1)(CO)O)O)=O,,,5,1,1,0,1
69327_0,,,,2,1,2,3
C(C(C1(C=C(CO1)CO)O)O)=O,,,5,1,1,0,1
69329_0,,,,2,1,2,3
C1OCC(C=1)(CO)O,,,5,1,1,0,1
69331_0,,,,2,1,2,3
C1C(O)OCC=1CO,,,5,1,1,0,1
69333_0,,,,2,1,2,3
C(CO)(C1C=CC(O1)O)=O,,,5,1,1,0,1
69335_0,,,,2,1,2,3
C(CO)(C1C(C=CO1)O)=O,,,5,1,1,0,1
69337_0,,,,2,1,2,3
C(CO)(C(C1C=CC(O)O1)O)=O,,,5,1,2,0,2
69339_0,,,,2,1,2,3
C(CO)(C(C1C(C=CO1)O)O)=O,,,5,1,1,0,1
69340_0,,,,2,1,2,3
69342_0,,,,2,1,2,3
C(CO)(C1C=CC(CO)(O1)O)=O,,,5,1,1,0,1
69344_0,,,,2,1,2,3
C(CO)(C1C(C=C(CO)O1)O)=O,,,5,1,1,0,1
69346_0,,,,2,1,2,3
C1(COC(CO)(C1O)O)=CC=O,,,5,1,2,0,2
69348_0,,,,2,1,2,3
C(C1C(C=CO1)(CO)O)(CO)=O,,,5,1,1,0,1
69350_0,,,,2,1,2,3
C(CO)(C1C(CO)=CC(O1)O)=O,,,5,1,1,0,1
69352_0,,,,2,1,2,3
C(CO)(C1C(C(C(O1)=C)O)O)=O,,,5,1,1,0,1
69354_0,,,,2,1,2,3
C(C1C(C(C(CO)(O1)O)O)=C)=O,,,5,1,2,0,2
69356_0,,,,2,1,2,3
C(CO)(C1C(C(C(O1)O)O)=C)=O,,,5,1,2,0,2
69358_0,,,,2,1,2,3
C1C(COC=1C=O)(C(CO)O)O,,,5,1,1,0,1
69360_0,,,,2,1,2,3
C(C1(C=C(CO1)C(CO)O)O)=O,,,5,1,1,0,1
69362_0,,,,2,1,2,3
C1C(CO)(C(CO)OC=1C=O)O,,,5,1,1,0,1
69364_0,,,,2,1,2,3
C(C1(C=C(CO)C(CO)O1)O)=O,,,5,1,1,0,1
69366_0,,,,2,1,2,3
C1OCC(C=1C=O)(C(CO)O)O,,,5,1,1,0,1
69368_0,,,,2,1,2,3
C1(COC(C=1C=O)O)C(CO)O,,,5,1,1,0,1
69370_0,,,,2,1,2,3
C1OC(CO)C(C=1C=O)(CO)O,,,5,1,1,0,1
69372_0,,,,2,1,2,3
C1(CO)C(CO)OC(C=1C=O)O,,,5,1,1,0,1
69374_0,,,,2,1,2,3
C1OCC(C=1)(C(CO)O)O,,,5,1,1,0,1
69376_0,,,,2,1,2,3
C1(COC(C=1)O)C(CO)O,,,5,1,1,0,1
69378_0,,,,2,1,2,3
C1OC(CO)C(C=1)(CO)O,,,5,1,1,0,1
69380_0,,,,2,1,2,3
C1(CO)C(CO)OC(C=1)O,,,5,1,1,0,1
69382_0,,,,2,1,2,3
C(C(CO)O)(C1C=CC(O1)O)=O,,,5,1,1,0,1
69384_0,,,,2,1,2,3
C(C1C(C=CO1)O)(C(CO)O)=O,,,5,1,1,0,1
69386_0,,,,2,1,2,3
C1(C(C=C(C=O)O1)O)=O,,,5,1,1,0,1
69388_0,,,,2,1,2,3
C(C1(C=CC(O1)=O)O)=O,,,5,1,1,0,1
69390_0,,,,2,1,2,3
C1(C(C(C=O)=CO1)O)=O,,,5,1,1,0,1
69392_0,,,,2,1,2,3
C(C1C(O)OC(C=1)=O)=O,,,5,1,1,0,1
69394_0,,,,2,1,2,3
C(C1C(C(C(O1)O)=O)=C)(O)=O,,,5,1,2,0,2
69396_0,,,,2,1,2,3
C1(C(C(CO)=C(C=O)O1)O)=O,,,5,1,1,0,1
69398_0,,,,2,1,2,3
C1(C(C(C(C=O)(O)O1)=C)O)=O,,,5,1,2,0,2
69400_0,,,,2,1,2,3
C(C1(C(CO)=CC(O1)=O)O)=O,,,5,1,1,0,1
69402_0,,,,2,1,2,3
C(C1C(C=O)=CC(O1)O)(O)=O,,,5,1,2,0,2
69404_0,,,,2,1,2,3
C1(C(C(C(O)O1)=CC=O)O)=O,,,5,1,3,0,3
69406_0,,,,2,1,2,3
C1(C(C(C(C=O)O)=CO1)O)=O,,,5,1,1,0,1
69408_0,,,,2,1,2,3
C(C(C1C(O)OC(C=1)=O)O)=O,,,5,1,1,0,1
69410_0,,,,2,1,2,3
C1(C(C(C(CO)=O)=CO1)O)=O,,,5,1,1,0,1
69412_0,,,,2,1,2,3
C1(C=C(C(CO)=O)C(O)O1)=O,,,5,1,1,0,1
69414_0,,,,2,1,2,3
C1(C(C(C=O)=C(CO)O1)O)=O,,,5,1,1,0,1
69416_0,,,,2,1,2,3
C1(C=C(C=O)C(CO)(O)O1)=O,,,5,1,1,0,1
69418_0,,,,2,1,2,3
C1(C(C(C(O1)=CC=O)O)O)=O,,,5,1,1,0,1
69420_0,,,,2,1,2,3
C1(C(C=C(C(C=O)O)O1)O)=O,,,5,1,1,0,1
69422_0,,,,2,1,2,3
C(C(C1(C=CC(O1)=O)O)O)=O,,,5,1,1,0,1
69424_0,,,,2,1,2,3
C1(C(C=CO1)O)=O,,,5,1,1,0,1
69426_0,,,,2,1,2,3
C1C(O)OC(C=1)=O,,,5,1,2,0,2
69428_0,,,,2,1,2,3
C(C(CO)(C1C(C=CO1)O)O)=O,,,5,1,1,0,1
69430_0,,,,2,1,2,3
C(C(CO)(C1C=CC(O1)O)O)=O,,,5,1,2,0,2
69432_0,,,,2,1,2,3
C(C(C1(CO)C(C=CO1)O)O)=O,,,5,1,1,0,1
69434_0,,,,2,1,2,3
C(C(C1(C=CC(O1)O)CO)O)=O,,,5,1,1,0,1
69436_0,,,,2,1,2,3
C1C(C(CO)(CO)OC=1C=O)O,,,5,1,1,0,1
69438_0,,,,2,1,2,3
C(C1(C=CC(CO)(CO)O1)O)=O,,,5,1,1,0,1
69440_0,,,,2,1,2,3
C1OC(CO)(CO)C(C=1C=O)O,,,5,1,1,0,1
69442_0,,,,2,1,2,3
C1C(CO)(CO)OC(C=1C=O)O,,,5,1,1,0,1
69444_0,,,,2,1,2,3
C1OC(CO)(CO)C(C=1)O,,,5,1,1,0,1
69446_0,,,,2,1,2,3
C1C(CO)(CO)OC(C=1)O,,,5,1,1,0,1
69448_0,,,,2,1,2,3
C1OC(CO)(C(CO)O)C(C=1)O,,,5,1,1,0,1
69450_0,,,,2,1,2,3
C1C(CO)(C(CO)O)OC(C=1)O,,,5,1,1,0,1
69452_0,,,,2,1,2,3
C(C(C1C(C=CO1)O)O)(O)=O,,,5,1,1,0,1
69454_0,,,,2,1,2,3
C(C(C1C=CC(O)O1)O)(O)=O,,,5,1,2,0,2
69456_0,,,,2,1,2,3
C(C1(C(C(C(O1)O)=O)=C)C)=O,,,5,1,2,0,2
69458_0,,,,2,1,2,3
C1(C)C(O)OCC=1C(C=O)=O,,,5,1,1,0,1
69460_0,,,,2,1,2,3
C=C1C(O)OCC1C(C=O)=O,,,5,1,2,0,2
69462_0,,,,2,1,2,3
C(C1C(C=O)=C(C)C(O1)O)=O,,,5,1,1,0,1
69464_0,,,,2,1,2,3
C(C1C(C(O)OC1C=O)=C)=O,,,5,1,2,0,2
69466_0,,,,2,1,2,3
C(C1(C(C=O)=CC(O1)O)C)=O,,,5,1,2,0,2
69468_0,,,,2,1,2,3
C(C)(C1C(C(C(O1)O)=O)=C)=O,,,5,1,2,0,2
69470_0,,,,2,1,2,3
C1C(C)(OCC=1C(C=O)=O)O,,,5,1,1,0,1
69472_0,,,,2,1,2,3
C=C1C(C(C(C=O)=O)CO1)O,,,5,1,1,0,1
69474_0,,,,2,1,2,3
C(C1C(C=O)=CC(C)(O1)O)=O,,,5,1,1,0,1
69476_0,,,,2,1,2,3
C(C1C(C=O)C(C(O1)=C)O)=O,,,5,1,1,0,1
69478_0,,,,2,1,2,3
C(C)(C1C(C=O)=CC(O1)O)=O,,,5,1,2,0,2
69480_0,,,,2,1,2,3
C(C1(C=C)CC(C(O1)O)=O)=O,,,5,1,2,0,2
69482_0,,,,2,1,2,3
C1(C(O)OC(C(C=C)=O)C1)=O,,,5,1,2,0,2
69484_0,,,,2,1,2,3
C(C1(C=CC(CC=O)O1)O)=O,,,5,1,1,0,1
69486_0,,,,2,1,2,3
C(CC1C(C=C(C=O)O1)O)=O,,,5,1,1,0,1
69488_0,,,,2,1,2,3
C1C(CC(C=O)=O)OC(C=1)O,,,5,1,2,0,2
69490_0,,,,2,1,2,3
C1OC(C(C=1)O)CC(C=O)=O,,,5,1,1,0,1
69492_0,,,,2,1,2,3
C1(C(O)OC(C=CC=O)C1)=O,,,5,1,3,0,3
69493_0,,,,2,1,2,3
69494_0,,,,2,1,2,3
69496_0,,,,2,1,2,3
C(C1(CC(CO1)=CC=O)O)=O,,,5,1,2,0,2
69498_0,,,,2,1,2,3
C(CC1COC(C=O)(C=1)O)=O,,,5,1,1,0,1
69500_0,,,,2,1,2,3
C(CC1(C=C(C=O)OC1)O)=O,,,5,1,1,0,1
69502_0,,,,2,1,2,3
C(C1(C=CC(C(C)=O)O1)O)=O,,,5,1,1,0,1
69504_0,,,,2,1,2,3
C(C)(C1C(C=C(C=O)O1)O)=O,,,5,1,1,0,1
69506_0,,,,2,1,2,3
C(C1C(CC(C=O)(O1)O)=C)=O,,,5,1,2,0,2
69508_0,,,,2,1,2,3
C(C1C(C)=CC(C=O)(O1)O)=O,,,5,1,1,0,1
69510_0,,,,2,1,2,3
C(C1C(C=C(C=O)O1)(C)O)=O,,,5,1,1,0,1
69512_0,,,,2,1,2,3
C(C1(C=C(C=O)CO1)O)=O,,,5,1,1,0,1
69514_0,,,,2,1,2,3
C(C1(C=C(C=O)OC1)O)=O,,,5,1,1,0,1
69516_0,,,,2,1,2,3
C(C1(C=C(C=O)C(CO)O1)O)=O,,,5,1,1,0,1
69518_0,,,,2,1,2,3
C(C1(C=C(C=O)OC1CO)O)=O,,,5,1,1,0,1
69520_0,,,,2,1,2,3
C(C1(C=CC(CO)O1)O)=O,,,5,1,1,0,1
69522_0,,,,2,1,2,3
C1C(C(CO)OC=1C=O)O,,,5,1,1,0,1
69524_0,,,,2,1,2,3
C(C1(C=CC(C(CO)O)O1)O)=O,,,5,1,1,0,1
69526_0,,,,2,1,2,3
C1C(C(C(CO)O)OC=1C=O)O,,,5,1,1,0,1
69528_0,,,,2,1,2,3
C(C1(C=CCO1)O)=O,,,5,1,1,0,1
69530_0,,,,2,1,2,3
C1C(COC=1C=O)O,,,5,1,1,0,1
69532_0,,,,2,1,2,3
C(CC1C(C(C(O)O1)=O)=C)=O,,,5,1,2,0,2
69534_0,,,,2,1,2,3
C(CC1C(C=O)=CC(O)O1)=O,,,5,1,2,0,2
69536_0,,,,2,1,2,3
C(CC(C1C=CC(O1)O)=O)=O,,,5,1,1,0,1
69538_0,,,,2,1,2,3
C(CC(C1C(C=CO1)O)=O)=O,,,5,1,1,0,1
69540_0,,,,2,1,2,3
C1C(C(C=O)=O)OC(C=1)O,,,5,1,1,0,1
69542_0,,,,2,1,2,3
C1OC(C(C=O)=O)C(C=1)O,,,5,1,1,0,1
69544_0,,,,2,1,2,3
C(C1C=CC(O1)O)=O,,,5,1,1,0,1
69546_0,,,,2,1,2,3
C(C1C(C=CO1)O)=O,,,5,1,1,0,1
69548_0,,,,2,1,2,3
C(CC1C=C(C=O)C(O)O1)=O,,,5,1,1,0,1
69550_0,,,,2,1,2,3
C(CC1C(C(C=O)=CO1)O)=O,,,5,1,1,0,1
69552_0,,,,2,1,2,3
C(C(C=O)C1C=CC(O)O1)=O,,,5,1,2,0,2
69554_0,,,,2,1,2,3
C(C(C=O)C1C(C=CO1)O)=O,,,5,1,1,0,1
69555_0,,,,2,1,2,3
69557_0,,,,2,1,2,3
C(C1C(COC1O)=CC=O)=O,,,5,1,2,0,2
69559_0,,,,2,1,2,3
C(CC1COC(C=1C=O)O)=O,,,5,1,1,0,1
69561_0,,,,2,1,2,3
C(CC1(C(C=O)=COC1)O)=O,,,5,1,1,0,1
69563_0,,,,2,1,2,3
C(C)(C1C=C(C=O)C(O1)O)=O,,,5,1,1,0,1
69565_0,,,,2,1,2,3
C(C)(C1C(C(C=O)=CO1)O)=O,,,5,1,1,0,1
69567_0,,,,2,1,2,3
C(C1C(C(C=O)OC1O)=C)=O,,,5,1,2,0,2
69569_0,,,,2,1,2,3
C(C1C(C)=C(C=O)C(O1)O)=O,,,5,1,1,0,1
69571_0,,,,2,1,2,3
C(C1C(C(C=O)=CO1)(C)O)=O,,,5,1,1,0,1
69573_0,,,,2,1,2,3
C(C1COC(C=1C=O)O)=O,,,5,1,1,0,1
69575_0,,,,2,1,2,3
C(C1(C(C=O)=COC1)O)=O,,,5,1,1,0,1
69577_0,,,,2,1,2,3
C(C1C(CO)OC(C=1C=O)O)=O,,,5,1,1,0,1
69579_0,,,,2,1,2,3
C(C1(C(C=O)=COC1CO)O)=O,,,5,1,1,0,1
69581_0,,,,2,1,2,3
C1C(C(CO)O)OC(C=1C=O)O,,,5,1,1,0,1
69583_0,,,,2,1,2,3
C1OC(C(CO)O)C(C=1C=O)O,,,5,1,1,0,1
69585_0,,,,2,1,2,3
C(C1(C=C)C(C(C(O1)O)=O)O)=O,,,5,1,2,0,2
69587_0,,,,2,1,2,3
C1(C(O)OC(C(C=C)=O)C1O)=O,,,5,1,2,0,2
69589_0,,,,2,1,2,3
C=C1C(C(OC1C)O)=O,,,5,1,2,0,2
69591_0,,,,2,1,2,3
C(C1(C(CO)=C(C=O)CO1)O)=O,,,5,1,1,0,1
69593_0,,,,2,1,2,3
C(C1(C(CO)=C(C=O)OC1)O)=O,,,5,1,1,0,1
69595_0,,,,2,1,2,3
C(C1(C(C(C=O)(O)OC1)=C)O)=O,,,5,1,2,0,2
69597_0,,,,2,1,2,3
C(C1(C(C(C(O1)O)=O)=C)CO)=O,,,5,1,2,0,2
69599_0,,,,2,1,2,3
C1(C(O)OCC=1C(C=O)=O)CO,,,5,1,1,0,1
69601_0,,,,2,1,2,3
C(CO)(C1C(C(C(O1)O)=O)=C)=O,,,5,1,2,0,2
69603_0,,,,2,1,2,3
C1C(CO)(OCC=1C(C=O)=O)O,,,5,1,1,0,1
69605_0,,,,2,1,2,3
C(C1(C(CO)=CC(CO)O1)O)=O,,,5,1,1,0,1
69607_0,,,,2,1,2,3
C1(CO)C(C(CO)OC=1C=O)O,,,5,1,1,0,1
69609_0,,,,2,1,2,3
C(C1(C(C(C(CO)O1)O)=C)O)=O,,,5,1,2,0,2
69611_0,,,,2,1,2,3
C=C1C(C(OC1C(CO)O)O)=O,,,5,1,2,0,2
69613_0,,,,2,1,2,3
C(C1C(C(C(O1)O)=O)=C)=O,,,5,1,2,0,2
69615_0,,,,2,1,2,3
C1C(O)OCC=1C(C=O)=O,,,5,1,1,0,1
69617_0,,,,2,1,2,3
C(C1(C(CO)=CCO1)O)=O,,,5,1,1,0,1
69619_0,,,,2,1,2,3
C1(CO)C(COC=1C=O)O,,,5,1,1,0,1
69621_0,,,,2,1,2,3
C(C1(C(C(CO1)O)=C)O)=O,,,5,1,2,0,2
69623_0,,,,2,1,2,3
C=C1C(C(OC1CO)O)=O,,,5,1,2,0,2
69625_0,,,,2,1,2,3
C(CC1C=CC(O)O1)=O,,,5,1,2,0,2
69627_0,,,,2,1,2,3
C(CC1C(C=CO1)O)=O,,,5,1,1,0,1
69629_0,,,,2,1,2,3
C1(C(O)OC(C=CC=O)C1O)=O,,,5,1,3,0,3
69631_0,,,,2,1,2,3
C1C(C(C(C=O)=O)O)OC(C=1)O,,,5,1,2,0,2
69633_0,,,,2,1,2,3
C1OC(C(C=1)O)C(C(C=O)=O)O,,,5,1,1,0,1
69634_0,,,,2,1,2,3
69635_0,,,,2,1,2,3
69636_0,,,,2,1,2,3
69637_0,,,,2,1,2,3
69639_0,,,,2,1,2,3
C1C(OC(C=1C=O)C)O,,,5,1,2,0,2
69641_0,,,,2,1,2,3
C(C(C1C(O)OCC=1C=O)O)=O,,,5,1,1,0,1
69643_0,,,,2,1,2,3
C(C1(C(C(O)OC1)=CC=O)O)=O,,,5,1,3,0,3
69645_0,,,,2,1,2,3
C(C1(C(C(C=O)O)=COC1)O)=O,,,5,1,1,0,1
69647_0,,,,2,1,2,3
C(C1C(C=O)=C(CO)C(O1)O)=O,,,5,1,1,0,1
69649_0,,,,2,1,2,3
C(C1(C(C=O)=CC(O1)O)CO)=O,,,5,1,2,0,2
69651_0,,,,2,1,2,3
C(C1C(C=O)=CC(CO)(O1)O)=O,,,5,1,1,0,1
69653_0,,,,2,1,2,3
C(CO)(C1C(C=O)=CC(O1)O)=O,,,5,1,2,0,2
69655_0,,,,2,1,2,3
C(C(C1C(OC(C=1)CO)O)O)=O,,,5,1,1,0,1
69657_0,,,,2,1,2,3
C1(C(O)OC(CO)C1O)=CC=O,,,5,1,3,0,3
69659_0,,,,2,1,2,3
C(C(C1C(C(CO)OC=1)O)O)=O,,,5,1,1,0,1
69661_0,,,,2,1,2,3
C1C(OC(C=1C=O)C(CO)O)O,,,5,1,2,0,2
69663_0,,,,2,1,2,3
C(C1C(C=O)=CC(O1)O)=O,,,5,1,2,0,2
69665_0,,,,2,1,2,3
C1C(O)OCC=1C=O,,,5,1,2,0,2
69666_0,,,,2,1,2,3
69667_0,,,,2,1,2,3
69669_0,,,,2,1,2,3
C(C(C1C(COC=1)O)O)=O,,,5,1,1,0,1
69671_0,,,,2,1,2,3
C1C(OC(C=1C=O)CO)O,,,5,1,2,0,2
69673_0,,,,2,1,2,3
C1C(C(C=O)=O)OC(C=1)(CO)O,,,5,1,1,0,1
69675_0,,,,2,1,2,3
C1(CO)OC(C(C=O)=O)C(C=1)O,,,5,1,1,0,1
69677_0,,,,2,1,2,3
C(C1C=CC(CO)(O1)O)=O,,,5,1,1,0,1
69679_0,,,,2,1,2,3
C(C1C(C=C(CO)O1)O)=O,,,5,1,1,0,1
69681_0,,,,2,1,2,3
C1C(CO)(C(C(C=O)=O)OC=1)O,,,5,1,1,0,1
69683_0,,,,2,1,2,3
C1C(OC(C=1CO)C(C=O)=O)O,,,5,1,1,0,1
69685_0,,,,2,1,2,3
C(C1(C(C(CO1)=CC=O)O)O)=O,,,5,1,2,0,2
69687_0,,,,2,1,2,3
C(C1C(C=CO1)(CO)O)=O,,,5,1,1,0,1
69689_0,,,,2,1,2,3
C(C1C(CO)=CC(O1)O)=O,,,5,1,1,0,1
69691_0,,,,2,1,2,3
C1(COC(C1O)O)=CC=O,,,5,1,2,0,2
69693_0,,,,2,1,2,3
C(C1COC(C=1C(CO)=O)O)=O,,,5,1,1,0,1
69695_0,,,,2,1,2,3
C(C1(C(C(CO)=O)=COC1)O)=O,,,5,1,1,0,1
69697_0,,,,2,1,2,3
C(C1C(CO)(OCC=1C=O)O)=O,,,5,1,1,0,1
69699_0,,,,2,1,2,3
C(C1(C(C=O)=C(CO)OC1)O)=O,,,5,1,1,0,1
69701_0,,,,2,1,2,3
C1C(CO)OC(C=1C(CO)=O)O,,,5,1,1,0,1
69703_0,,,,2,1,2,3
C1OC(CO)C(C=1C(CO)=O)O,,,5,1,1,0,1
69705_0,,,,2,1,2,3
C1C(CO)OC(C=1C=O)(CO)O,,,5,1,1,0,1
69707_0,,,,2,1,2,3
C1(CO)OC(CO)C(C=1C=O)O,,,5,1,1,0,1
69709_0,,,,2,1,2,3
C1COC(C=1C=O)(CO)O,,,5,1,1,0,1
69711_0,,,,2,1,2,3
C1(CO)OCC(C=1C=O)O,,,5,1,1,0,1
69713_0,,,,2,1,2,3
C(C1(COC(C1O)=CC=O)O)=O,,,5,1,1,0,1
69715_0,,,,2,1,2,3
C1(C(C(C(CO)O1)O)O)=CC=O,,,5,1,1,0,1
69717_0,,,,2,1,2,3
C1(C(C(CO1)O)O)=CC=O,,,5,1,1,0,1
69719_0,,,,2,1,2,3
C(C)(C1C(C=CO1)O)=O,,,5,1,1,0,1
69721_0,,,,2,1,2,3
C(C)(C1C=CC(O1)O)=O,,,5,1,1,0,1
69723_0,,,,2,1,2,3
C1(C(C(C(C(C=O)=O)O1)O)O)=C,,,5,1,1,0,1
69725_0,,,,2,1,2,3
C(C1C(C(C(O1)=C)O)O)=O,,,5,1,1,0,1
69727_0,,,,2,1,2,3
C(C1C(C=CO1)(C)O)=O,,,5,1,1,0,1
69729_0,,,,2,1,2,3
C(C1C(C)=CC(O1)O)=O,,,5,1,1,0,1
69731_0,,,,2,1,2,3
C(C1C(CC(O1)O)=C)=O,,,5,1,2,0,2
69733_0,,,,2,1,2,3
C=C1C(C(OC1C(C=O)=O)O)O,,,5,1,2,0,2
69735_0,,,,2,1,2,3
C(C1C(C(C(C=O)(O1)O)O)=C)=O,,,5,1,2,0,2
69737_0,,,,2,1,2,3
C(C1C(C(C(O1)O)O)=C)=O,,,5,1,2,0,2
69739_0,,,,2,1,2,3
C(C(C1(C=C(C=O)CO1)O)O)=O,,,5,1,1,0,1
69741_0,,,,2,1,2,3
C(C1(C=C(C(C=O)O)OC1)O)=O,,,5,1,1,0,1
69743_0,,,,2,1,2,3
C(C(C1(C=CC(CO)O1)O)O)=O,,,5,1,1,0,1
69745_0,,,,2,1,2,3
C(C(C1OC(CO)C(C=1)O)O)=O,,,5,1,1,0,1
69747_0,,,,2,1,2,3
C(C(C1(C=CCO1)O)O)=O,,,5,1,1,0,1
69749_0,,,,2,1,2,3
C(C(C1OCC(C=1)O)O)=O,,,5,1,1,0,1
69750_0,,,,2,1,2,3
69752_0,,,,2,1,2,3
C(C1(C=COC1)O)=O,,,5,1,1,0,1
69753_0,,,,2,1,2,3
69755_0,,,,2,1,2,3
C(C1(C=COC1CO)O)=O,,,5,1,1,0,1
69757_0,,,,2,1,2,3
C1C(CO)OC(C=1)O,,,5,1,1,0,1
69759_0,,,,2,1,2,3
C1OC(CO)C(C=1)O,,,5,1,1,0,1
69761_0,,,,2,1,2,3
C1C(C(CO)O)OC(C=1)O,,,5,1,1,0,1
69763_0,,,,2,1,2,3
C1OC(C(CO)O)C(C=1)O,,,5,1,1,0,1
69765_0,,,,2,1,2,3
C1COC(C=1)O,,,5,1,2,0,2
69767_0,,,,2,1,2,3
C1OCC(C=1)O,,,5,1,1,0,1
69768_0,,,,2,1,2,3
69769_0,,,,2,1,2,3
69771_0,,,,2,1,2,3
C=CC1(C(O)OC(CO)C1O)O,,,5,1,2,0,2
69773_0,,,,2,1,2,3
C(C1(C(C(O)OC1C=O)=C)O)=O,,,5,1,2,0,2
69775_0,,,,2,1,2,3
C(C1C(C=O)(C(C(O1)=C)O)O)=O,,,5,1,1,0,1
69777_0,,,,2,1,2,3
C(C1(C=CC(O1)O)C(C=O)O)=O,,,5,1,1,0,1
69779_0,,,,2,1,2,3
C(C(C1(C=O)C(C=CO1)O)O)=O,,,5,1,1,0,1
69781_0,,,,2,1,2,3
C(C1(C(OCC1(CO)O)=C)O)=O,,,5,1,1,0,1
69783_0,,,,2,1,2,3
C(CO)(C1(C(C(O)OC1)=C)O)=O,,,5,1,2,0,2
69785_0,,,,2,1,2,3
C(CO)(C1(COC(C1O)=C)O)=O,,,5,1,1,0,1
69787_0,,,,2,1,2,3
C(CO)(C1(C=CC(O1)O)CO)=O,,,5,1,1,0,1
69789_0,,,,2,1,2,3
C(CO)(C1(CO)C(C=CO1)O)=O,,,5,1,1,0,1
69791_0,,,,2,1,2,3
C1(C(C(C(O)O1)=C)(CO)O)=O,,,5,1,2,0,2
69793_0,,,,2,1,2,3
C(C1(C(C(O)OC1)=C)O)(O)=O,,,5,1,2,0,2
69795_0,,,,2,1,2,3
C1(C(CO)(C(C(O1)=C)O)O)=O,,,5,1,1,0,1
69797_0,,,,2,1,2,3
C(C1(COC(C1O)=C)O)(O)=O,,,5,1,1,0,1
69799_0,,,,2,1,2,3
C(C1(C=CC(O1)O)CO)(O)=O,,,5,1,1,0,1
69801_0,,,,2,1,2,3
C(C1(CO)C(C=CO1)O)(O)=O,,,5,1,1,0,1
69803_0,,,,2,1,2,3
C(C1(C(OC(C1O)=O)=C)O)=O,,,5,1,1,0,1
69805_0,,,,2,1,2,3
C(C1(COC(C1(C=C)O)O)O)=O,,,5,1,3,0,3
69807_0,,,,2,1,2,3
C1(C(C(C=C)(C(O)O1)O)O)=O,,,5,1,3,0,3
69809_0,,,,2,1,2,3
C=C1C(O)OCC1(C(C=O)=O)O,,,5,1,2,0,2
69811_0,,,,2,1,2,3
C(C1(C(C(O)OC1)=C)O)=O,,,5,1,2,0,2
69813_0,,,,2,1,2,3
C(C1(C(C(O)OC1CO)=C)O)=O,,,5,1,2,0,2
69815_0,,,,2,1,2,3
C=C1C(C(C(C=O)=O)(CO1)O)O,,,5,1,1,0,1
69817_0,,,,2,1,2,3
C(C1(COC(C1O)=C)O)=O,,,5,1,1,0,1
69819_0,,,,2,1,2,3
C(C1(C(CO)OC(C1O)=C)O)=O,,,5,1,1,0,1
69821_0,,,,2,1,2,3
C(C1(C(C)=O)C=CC(O1)O)=O,,,5,1,1,0,1
69823_0,,,,2,1,2,3
C(C1(C(C)=O)C(C=CO1)O)=O,,,5,1,1,0,1
69825_0,,,,2,1,2,3
C1C(C(C=O)=O)(CO)OC(C=1)O,,,5,1,1,0,1
69827_0,,,,2,1,2,3
C1OC(C(C=O)=O)(CO)C(C=1)O,,,5,1,1,0,1
69829_0,,,,2,1,2,3
C(C1(C=CC(O1)O)CO)=O,,,5,1,1,0,1
69831_0,,,,2,1,2,3
C(C1(CO)C(C=CO1)O)=O,,,5,1,1,0,1
69833_0,,,,2,1,2,3
C(C1(C=CC(O1)O)C(CO)O)=O,,,5,1,1,0,1
69835_0,,,,2,1,2,3
C(C1(C(CO)O)C(C=CO1)O)=O,,,5,1,1,0,1
69837_0,,,,2,1,2,3
C(C1(C(O)OCC1O)O)=CC=O,,,5,1,2,0,2
69839_0,,,,2,1,2,3
C(C1(C(C(O)OC1)=CCO)O)=O,,,5,1,2,0,2
69840_0,,,,2,1,2,3
69842_0,,,,2,1,2,3
C(C1(COC(C1O)=CCO)O)=O,,,5,1,1,0,1
69844_0,,,,2,1,2,3
C(C1(COC(C=C)(C1O)O)O)=O,,,5,1,2,0,2
69845_0,,,,2,1,2,3
69847_0,,,,2,1,2,3
C(C1(C=CC(CO)(O1)O)CO)=O,,,5,1,1,0,1
69849_0,,,,2,1,2,3
C(C1(CO)C(C=C(CO)O1)O)=O,,,5,1,1,0,1
69851_0,,,,2,1,2,3
C(C1(CO)C(C=CO1)(CO)O)=O,,,5,1,1,0,1
69853_0,,,,2,1,2,3
C(C1(C(CO)=CC(O1)O)CO)=O,,,5,1,1,0,1
69855_0,,,,2,1,2,3
C1(COC(C1(CO)O)O)=CC=O,,,5,1,2,0,2
69857_0,,,,2,1,2,3
C(C1(C(OCC1(C=O)O)=C)O)=O,,,5,1,1,0,1
69859_0,,,,2,1,2,3
C(C1(C(OC(CO)C1O)=C)O)=O,,,5,1,1,0,1
69861_0,,,,2,1,2,3
C(C1(C(OCC1O)=C)O)=O,,,5,1,1,0,1
69863_0,,,,2,1,2,3
C(C1(CO)C(C(C(O1)=C)O)O)=O,,,5,1,1,0,1
69865_0,,,,2,1,2,3
C(C1(C(C(C(O1)O)O)=C)CO)=O,,,5,1,2,0,2
69867_0,,,,2,1,2,3
C(C1C(C(C(O1)O)(CO)O)=C)=O,,,5,1,2,0,2
69869_0,,,,2,1,2,3
C=CC1(C(O)OCC1O)O,,,5,1,2,0,2
69870_0,,,,2,1,2,3
69872_0,,,,2,1,2,3
C(C1(C=COC1(CO)CO)O)=O,,,5,1,1,0,1
69873_0,,,,2,1,2,3
69874_0,,,,2,1,2,3
69876_0,,,,2,1,2,3
C(C1(C=COC1C(O)=O)O)=O,,,5,1,1,0,1
69877_0,,,,2,1,2,3
69878_0,,,,2,1,2,3
69880_0,,,,2,1,2,3
C(C1(C=COC1(C=O)C)O)=O,,,5,1,1,0,1
69882_0,,,,2,1,2,3
C=C1C(OC(C1(C)O)O)=O,,,5,1,2,0,2
69884_0,,,,2,1,2,3
C1(C(C(C(O)O1)=C)(C)O)=O,,,5,1,2,0,2
69886_0,,,,2,1,2,3
C(CO)=C1C(OC(C1(C)O)O)=O,,,5,1,2,0,2
69888_0,,,,2,1,2,3
C1(C(C=C)(C(C)(C(O)O1)O)O)=O,,,5,1,2,0,2
69890_0,,,,2,1,2,3
C1(C(C(C(O)O1)=C)(CCO)O)=O,,,5,1,2,0,2
69892_0,,,,2,1,2,3
C1(C(C(C(O)O1)=C)O)=O,,,5,1,2,0,2
69893_0,,,,2,1,2,3
69895_0,,,,2,1,2,3
C(C1(C=COC1C(C)=O)O)=O,,,5,1,1,0,1
69897_0,,,,2,1,2,3
C=C1C(OC(C)(C1O)O)=O,,,5,1,2,0,2
69899_0,,,,2,1,2,3
C1(C(C)(C(C(O1)=C)O)O)=O,,,5,1,1,0,1
69901_0,,,,2,1,2,3
C(CO)=C1C(OC(C)(C1O)O)=O,,,5,1,2,0,2
69903_0,,,,2,1,2,3
C1(C(C=C)(C(C(C)(O)O1)O)O)=O,,,5,1,2,0,2
69905_0,,,,2,1,2,3
C1(C(CCO)(C(C(O1)=C)O)O)=O,,,5,1,1,0,1
69907_0,,,,2,1,2,3
C1(C(C(C(O1)=C)O)O)=O,,,5,1,1,0,1
69909_0,,,,2,1,2,3
C(C1(C=CC(O1)O)CC=O)=O,,,5,1,1,0,1
69911_0,,,,2,1,2,3
C(CC1(C=O)C(C=CO1)O)=O,,,5,1,1,0,1
69912_0,,,,2,1,2,3
69914_0,,,,2,1,2,3
C(C1(C=COC1CC=O)O)=O,,,5,1,1,0,1
69916_0,,,,2,1,2,3
C(C1(C=CC(O1)O)C)(O)=O,,,5,1,1,0,1
69918_0,,,,2,1,2,3
C(C1(C)C(C=CO1)O)(O)=O,,,5,1,1,0,1
69920_0,,,,2,1,2,3
C(C1(C=C)C(CC(O1)O)O)(O)=O,,,5,1,2,0,2
69922_0,,,,2,1,2,3
C(C1(C=CC(O1)O)CCO)(O)=O,,,5,1,1,0,1
69924_0,,,,2,1,2,3
C(C1(CCO)C(C=CO1)O)(O)=O,,,5,1,1,0,1
69926_0,,,,2,1,2,3
C(C1C=CC(O1)O)(O)=O,,,5,1,1,0,1
69928_0,,,,2,1,2,3
C(C1C(C=CO1)O)(O)=O,,,5,1,1,0,1
69930_0,,,,2,1,2,3
C=C1C(OC(C1(CCO)O)O)=O,,,5,1,2,0,2
69932_0,,,,2,1,2,3
C1(C(C(C(O)O1)=CCO)(C)O)=O,,,5,1,2,0,2
69934_0,,,,2,1,2,3
C1(C(C)(C(C=C)(C(O)O1)O)O)=O,,,5,1,2,0,2
69936_0,,,,2,1,2,3
C1(C(C(C(O)O1)=CCO)O)=O,,,5,1,2,0,2
69937_0,,,,2,1,2,3
69939_0,,,,2,1,2,3
C=C1C(OC(CCO)(C1O)O)=O,,,5,1,2,0,2
69941_0,,,,2,1,2,3
C1(C(C)(C(C(O1)=CCO)O)O)=O,,,5,1,1,0,1
69943_0,,,,2,1,2,3
C1(C(C)(C(C(C=C)(O)O1)O)O)=O,,,5,1,2,0,2
69945_0,,,,2,1,2,3
C1(C(C(C(O1)=CCO)O)O)=O,,,5,1,1,0,1
69947_0,,,,2,1,2,3
C1(C(C(C(C=C)(O)O1)O)O)=O,,,5,1,2,0,2
69948_0,,,,2,1,2,3
69950_0,,,,2,1,2,3
C(C1(C=COC1C)O)=O,,,5,1,1,0,1
69951_0,,,,2,1,2,3
69952_0,,,,2,1,2,3
69954_0,,,,2,1,2,3
C(C1(C=COC1(C=O)CO)O)=O,,,5,1,1,0,1
69955_0,,,,2,1,2,3
69957_0,,,,2,1,2,3
C(C1(C=COC1C(CO)=O)O)=O,,,5,1,1,0,1
69958_0,,,,2,1,2,3
69959_0,,,,2,1,2,3
69961_0,,,,2,1,2,3
C(C1(C=COC1C(CO)O)O)=O,,,5,1,1,0,1
69962_0,,,,2,1,2,3
69964_0,,,,2,1,2,3
C(C1(C=COC1C=O)O)=O,,,5,1,1,0,1
69966_0,,,,2,1,2,3
C=C(C(O)=O)C1C(CC(O1)O)O,,,5,1,2,0,2
69968_0,,,,2,1,2,3
C(C(C)(C1C=CC(O1)O)O)(O)=O,,,5,1,2,0,2
69970_0,,,,2,1,2,3
C(C(C)(C1C(C=CO1)O)O)(O)=O,,,5,1,1,0,1
69972_0,,,,2,1,2,3
C=C(C(O)=O)C1CC(C(O1)O)O,,,5,1,2,0,2
69973_0,,,,2,1,2,3
69974_0,,,,2,1,2,3
69976_0,,,,2,1,2,3
C(C1(C=CC(CO)(O1)O)C)(O)=O,,,5,1,1,0,1
69978_0,,,,2,1,2,3
C(C1(C)C(C=C(CO)O1)O)(O)=O,,,5,1,1,0,1
69980_0,,,,2,1,2,3
C(C1C=CC(CO)(O1)O)(O)=O,,,5,1,1,0,1
69982_0,,,,2,1,2,3
C(C1C(C=C(CO)O1)O)(O)=O,,,5,1,1,0,1
69984_0,,,,2,1,2,3
C(C1(C)C(C=CO1)(CO)O)(O)=O,,,5,1,1,0,1
69986_0,,,,2,1,2,3
C(C1(C(CO)=CC(O1)O)C)(O)=O,,,5,1,1,0,1
69988_0,,,,2,1,2,3
C(C1C(C=CO1)(CO)O)(O)=O,,,5,1,1,0,1
69990_0,,,,2,1,2,3
C(C1C(CO)=CC(O1)O)(O)=O,,,5,1,1,0,1
69992_0,,,,2,1,2,3
C(C1(C)C(C(C(O1)=C)O)O)(O)=O,,,5,1,1,0,1
69994_0,,,,2,1,2,3
C(C1C(C(C(O1)=C)O)O)(O)=O,,,5,1,1,0,1
69996_0,,,,2,1,2,3
C(C1(C(C(C(O1)O)O)=C)C)(O)=O,,,5,1,2,0,2
69998_0,,,,2,1,2,3
C(C1C(C(C(O1)O)O)=C)(O)=O,,,5,1,2,0,2
70000_0,,,,2,1,2,3
C=C1C(OC(C1(CO)O)O)=O,,,5,1,2,0,2
70002_0,,,,2,1,2,3
C=C1C(OC(CO)(C1O)O)=O,,,5,1,2,0,2
70004_0,,,,2,1,2,3
C=C1C(OC(C1O)O)=O,,,5,1,2,0,2
70006_0,,,,2,1,2,3
C(CO)=C1C(OC(C1O)O)=O,,,5,1,2,0,2
70007_0,,,,2,1,2,3
70009_0,,,,2,1,2,3
C(C1(C=C(CO)OC1)O)=O,,,5,1,1,0,1
70011_0,,,,2,1,2,3
C1C(CO)(OCC=1C=O)O,,,5,1,1,0,1
70013_0,,,,2,1,2,3
C(C1OCC(C=1C=O)O)=O,,,5,1,1,0,1
70015_0,,,,2,1,2,3
C(C1(C(C=O)=CCO1)O)=O,,,5,1,1,0,1
70017_0,,,,2,1,2,3
C1C(COC=1C(O)=O)O,,,5,1,1,0,1
70019_0,,,,2,1,2,3
C(C1(C=CCO1)O)(O)=O,,,5,1,1,0,1
70021_0,,,,2,1,2,3
C1C(CO)(O)OC(C=1)=O,,,5,1,1,0,1
70023_0,,,,2,1,2,3
C1(C(C=C(CO)O1)O)=O,,,5,1,1,0,1
70025_0,,,,2,1,2,3
C1C(C(CO)OC=1C(O)=O)O,,,5,1,1,0,1
70027_0,,,,2,1,2,3
C(C1(C=CC(CO)O1)O)(O)=O,,,5,1,1,0,1
70029_0,,,,2,1,2,3
C1C(C(CO)O)(O)OC(C=1)=O,,,5,1,1,0,1
70031_0,,,,2,1,2,3
C1(C(C=C(C(CO)O)O1)O)=O,,,5,1,1,0,1
70033_0,,,,2,1,2,3
C1(C(C(CO1)O)O)=CC(O)=O,,,5,1,1,0,1
70035_0,,,,2,1,2,3
C(C(C1OCC(C=1)O)O)(O)=O,,,5,1,1,0,1
70037_0,,,,2,1,2,3
C(C(C1(C=CCO1)O)O)(O)=O,,,5,1,1,0,1
70039_0,,,,2,1,2,3
C1OC(C(C(C=1)O)O)C(CO)O,,,5,1,1,0,1
70041_0,,,,2,1,2,3
C1C(C(C(CO)O)OC(C=1)O)O,,,5,1,1,0,1
70043_0,,,,2,1,2,3
C(C(C1C=CC(C(O)O1)=O)O)=O,,,5,1,1,0,1
70045_0,,,,2,1,2,3
C(C1C(C(C=C(C=O)O1)O)O)=O,,,5,1,1,0,1
70047_0,,,,2,1,2,3
C(C1(C=CC(C(C=O)O1)O)O)=O,,,5,1,1,0,1
70049_0,,,,2,1,2,3
C(C1C(C(C(C=O)=CO1)O)O)=O,,,5,1,1,0,1
70051_0,,,,2,1,2,3
C(C1C(C=C(C=O)C(O)O1)O)=O,,,5,1,1,0,1
70053_0,,,,2,1,2,3
C(C1C(C(C=CO1)O)O)=O,,,5,1,1,0,1
70055_0,,,,2,1,2,3
C(C1C(C=CC(O)O1)O)=O,,,5,1,2,0,2
70057_0,,,,2,1,2,3
C1(COC(C(C=1)=O)O)CO,,,5,1,1,0,1
70059_0,,,,2,1,2,3
C=C1C(C(O)OCC1(CO)O)=O,,,5,1,2,0,2
70061_0,,,,2,1,2,3
C1(COC(C(C=1CO)=O)O)CO,,,5,1,1,0,1
70063_0,,,,2,1,2,3
C1C(O)OCC(C=1C=O)(CO)O,,,5,1,2,0,2
70065_0,,,,2,1,2,3
C1(COC(C(C=1C=O)O)O)CO,,,5,1,1,0,1
70067_0,,,,2,1,2,3
C1OC(CO)(CO)C(C(C=1)=O)O,,,5,1,1,0,1
70069_0,,,,2,1,2,3
C1(COC(C(C1O)=C)O)=O,,,5,1,2,0,2
70071_0,,,,2,1,2,3
C1(COC(C(C1O)O)=C)=O,,,5,1,1,0,1
70073_0,,,,2,1,2,3
C1COC(CO)(C(C=1C=O)O)O,,,5,1,1,0,1
70075_0,,,,2,1,2,3
C1(COC(C(C1O)=CCO)O)=O,,,5,1,2,0,2
70077_0,,,,2,1,2,3
C1(C(C(C=C)(C(OC1)O)O)O)=O,,,5,1,2,0,2
70079_0,,,,2,1,2,3
C1(COC(C(C1O)O)=CCO)=O,,,5,1,1,0,1
70081_0,,,,2,1,2,3
C1(COC(C=C)(C(C1O)O)O)=O,,,5,1,2,0,2
70083_0,,,,2,1,2,3
C(CO)(C1C(C=CC(O)O1)O)=O,,,5,1,2,0,2
70085_0,,,,2,1,2,3
C(CO)(C1C(C(C=CO1)O)O)=O,,,5,1,1,0,1
70087_0,,,,2,1,2,3
C(C1C=CC(C(CO)(O1)O)O)=O,,,5,1,1,0,1
70088_0,,,,2,1,2,3
70090_0,,,,2,1,2,3
C(CO)(C1C=CC(C(O1)O)O)=O,,,5,1,1,0,1
70092_0,,,,2,1,2,3
C1(COC(C(C=1)=O)O)C(CO)O,,,5,1,1,0,1
70094_0,,,,2,1,2,3
C1(CO)C(CO)OC(C(C=1)=O)O,,,5,1,1,0,1
70096_0,,,,2,1,2,3
C1C(CO)(C(COC=1C=O)O)O,,,5,1,1,0,1
70098_0,,,,2,1,2,3
C(C1(C=C(CO)C(CO1)O)O)=O,,,5,1,1,0,1
70100_0,,,,2,1,2,3
C1OCC(C(C=1C=O)(CO)O)O,,,5,1,1,0,1
70102_0,,,,2,1,2,3
C1(CO)C(COC(C=1C=O)O)O,,,5,1,1,0,1
70104_0,,,,2,1,2,3
C1OCC(C(C=1)(CO)O)O,,,5,1,1,0,1
70106_0,,,,2,1,2,3
C1(CO)C(COC(C=1)O)O,,,5,1,1,0,1
70108_0,,,,2,1,2,3
C1(C(CO)OC(C(C1O)=C)O)=O,,,5,1,2,0,2
70110_0,,,,2,1,2,3
C1(C(C(C(OC1CO)=C)O)O)=O,,,5,1,1,0,1
70112_0,,,,2,1,2,3
C1(C=CC(C(O)O1)=O)=O,,,5,1,1,0,1
70114_0,,,,2,1,2,3
C1(C(C(C(C(O)O1)=O)=C)O)=O,,,5,1,2,0,2
70116_0,,,,2,1,2,3
C1(C=C(C(C(O)O1)=O)CO)=O,,,5,1,1,0,1
70118_0,,,,2,1,2,3
C1(C(C(C=O)=CC(O)O1)O)=O,,,5,1,2,0,2
70120_0,,,,2,1,2,3
C1(C=C(C=O)C(C(O)O1)O)=O,,,5,1,1,0,1
70122_0,,,,2,1,2,3
C(C1C(C(C=CO1)=O)O)(O)=O,,,5,1,1,0,1
70124_0,,,,2,1,2,3
C(C1(CO)C(C(C=CO1)O)O)=O,,,5,1,1,0,1
70126_0,,,,2,1,2,3
C(C1(CO)C(C=CC(O1)O)O)=O,,,5,1,2,0,2
70128_0,,,,2,1,2,3
C(C(C1(COC=CC1O)O)O)=O,,,5,1,1,0,1
70130_0,,,,2,1,2,3
C(C(C1(C=CC(O)OC1)O)O)=O,,,5,1,1,0,1
70132_0,,,,2,1,2,3
C(C1C(CO)(C(C=CO1)O)O)=O,,,5,1,1,0,1
70134_0,,,,2,1,2,3
C(C1C(C=CC(O1)O)(CO)O)=O,,,5,1,1,0,1
70136_0,,,,2,1,2,3
C1C(CO)(CO)OC(C(C=1)=O)O,,,5,1,1,0,1
70138_0,,,,2,1,2,3
C1C(C(CO)(COC=1C=O)O)O,,,5,1,1,0,1
70140_0,,,,2,1,2,3
C(C1(C=CC(CO)(CO1)O)O)=O,,,5,1,1,0,1
70142_0,,,,2,1,2,3
C1OCC(CO)(C(C=1C=O)O)O,,,5,1,1,0,1
70144_0,,,,2,1,2,3
C1C(CO)(COC(C=1C=O)O)O,,,5,1,1,0,1
70146_0,,,,2,1,2,3
C1OCC(CO)(C(C=1)O)O,,,5,1,1,0,1
70148_0,,,,2,1,2,3
C1C(CO)(COC(C=1)O)O,,,5,1,1,0,1
70150_0,,,,2,1,2,3
C1OCC(C(CO)O)(C(C=1)O)O,,,5,1,1,0,1
70152_0,,,,2,1,2,3
C1C(COC(C=1)O)(C(CO)O)O,,,5,1,1,0,1
70154_0,,,,2,1,2,3
C1OC(CO)C(CO)(C(C=1)O)O,,,5,1,1,0,1
70156_0,,,,2,1,2,3
C1C(CO)(C(CO)OC(C=1)O)O,,,5,1,1,0,1
70158_0,,,,2,1,2,3
C(C1C(C(C=CO1)O)O)(O)=O,,,5,1,1,0,1
70160_0,,,,2,1,2,3
C(C1C(C=CC(O)O1)O)(O)=O,,,5,1,2,0,2
70162_0,,,,2,1,2,3
C1(C)C(O)OCC(C=1C=O)=O,,,5,1,1,0,1
70164_0,,,,2,1,2,3
C(C1C(COC(C1=C)O)=O)=O,,,5,1,2,0,2
70166_0,,,,2,1,2,3
C(C1(C)C(C(C=CO1)=O)O)=O,,,5,1,1,0,1
70168_0,,,,2,1,2,3
C(C1C(C=C(C)C(O1)O)=O)=O,,,5,1,1,0,1
70170_0,,,,2,1,2,3
C1(C(C=O)OC(C(C1)=C)O)=O,,,5,1,2,0,2
70172_0,,,,2,1,2,3
C1C(C)(OCC(C=1C=O)=O)O,,,5,1,1,0,1
70174_0,,,,2,1,2,3
C(C1C(COC(C1O)=C)=O)=O,,,5,1,1,0,1
70176_0,,,,2,1,2,3
C(C)(C1C(C(C=CO1)=O)O)=O,,,5,1,1,0,1
70178_0,,,,2,1,2,3
C(C1C(C=CC(C)(O1)O)=O)=O,,,5,1,1,0,1
70180_0,,,,2,1,2,3
C(C1C(CC(C(O1)=C)O)=O)=O,,,5,1,1,0,1
70182_0,,,,2,1,2,3
C(C1(CC(C=O)=CCO1)O)=O,,,5,1,1,0,1
70184_0,,,,2,1,2,3
C(C1(C=C(C=O)CCO1)O)=O,,,5,1,1,0,1
70186_0,,,,2,1,2,3
C(C1(C=C(C=O)OCC1)O)=O,,,5,1,1,0,1
70188_0,,,,2,1,2,3
C(CC1C=CC(C(O)O1)=O)=O,,,5,1,1,0,1
70190_0,,,,2,1,2,3
C(C1C=CCC(C=O)(O1)O)=O,,,5,1,1,0,1
70192_0,,,,2,1,2,3
C(C1(C=CCC(C=O)O1)O)=O,,,5,1,1,0,1
70194_0,,,,2,1,2,3
C(C1CC(C=C(C=O)O1)O)=O,,,5,1,1,0,1
70196_0,,,,2,1,2,3
C1(C(O)OCC(C1)=CC=O)=O,,,5,1,2,0,2
70198_0,,,,2,1,2,3
C(CC1COC(C(C=1)=O)O)=O,,,5,1,1,0,1
70200_0,,,,2,1,2,3
C(C)(C1C=CC(C(O1)O)=O)=O,,,5,1,1,0,1
70202_0,,,,2,1,2,3
C(C1C(CC(C(O1)O)=O)=C)=O,,,5,1,2,0,2
70204_0,,,,2,1,2,3
C(C1C(C)=CC(C(O1)O)=O)=O,,,5,1,1,0,1
70206_0,,,,2,1,2,3
C(C1COC(C(C=1)=O)O)=O,,,5,1,1,0,1
70208_0,,,,2,1,2,3
C(C1(C=CC(CO1)=O)O)=O,,,5,1,1,0,1
70210_0,,,,2,1,2,3
C1(COC(C=O)=CC1O)=O,,,5,1,1,0,1
70212_0,,,,2,1,2,3
C(C1C(CO)OC(C(C=1)=O)O)=O,,,5,1,1,0,1
70214_0,,,,2,1,2,3
C(C1(C=C(C=O)C(CO1)O)O)=O,,,5,1,1,0,1
70216_0,,,,2,1,2,3
C(C1(C=C(C=O)OCC1O)O)=O,,,5,1,1,0,1
70218_0,,,,2,1,2,3
C(C1(C=CC(C(CO)O1)=O)O)=O,,,5,1,1,0,1
70220_0,,,,2,1,2,3
C1(C(CO)OC(C=O)=CC1O)=O,,,5,1,1,0,1
70222_0,,,,2,1,2,3
C(C1(C=CC(CO1)O)O)=O,,,5,1,1,0,1
70224_0,,,,2,1,2,3
C1C(C(COC=1C=O)O)O,,,5,1,1,0,1
70226_0,,,,2,1,2,3
C1C(C(CO)O)OC(C(C=1)=O)O,,,5,1,1,0,1
70228_0,,,,2,1,2,3
C(C1(C=CC(C(CO)O1)O)O)=O,,,5,1,1,0,1
70230_0,,,,2,1,2,3
C1C(C(C(CO)OC=1C=O)O)O,,,5,1,1,0,1
70232_0,,,,2,1,2,3
C1CC(OCC=1C(C=O)=O)O,,,5,1,1,0,1
70234_0,,,,2,1,2,3
C1C(C(C=O)=O)COC(C=1)O,,,5,1,1,0,1
70236_0,,,,2,1,2,3
C1OCC(C(C=O)=O)C(C=1)O,,,5,1,1,0,1
70238_0,,,,2,1,2,3
C(C1C(C=O)=CCC(O1)O)=O,,,5,1,1,0,1
70240_0,,,,2,1,2,3
C(C1C=CC(O)OC1C=O)=O,,,5,1,1,0,1
70242_0,,,,2,1,2,3
C(C1C(C=O)C(C=CO1)O)=O,,,5,1,1,0,1
70244_0,,,,2,1,2,3
C(CC1C(C(C=CO1)=O)O)=O,,,5,1,1,0,1
70246_0,,,,2,1,2,3
C(C1C(C=O)=CCOC1O)=O,,,5,1,1,0,1
70248_0,,,,2,1,2,3
C(C1CCOC(C=1C=O)O)=O,,,5,1,1,0,1
70250_0,,,,2,1,2,3
C(C1(C(C=O)=COCC1)O)=O,,,5,1,1,0,1
70252_0,,,,2,1,2,3
C(C1C=CC(C=O)OC1O)=O,,,5,1,1,0,1
70254_0,,,,2,1,2,3
C(C1CC=C(C=O)C(O)O1)=O,,,5,1,1,0,1
70256_0,,,,2,1,2,3
C(C1CC(C(C=O)=CO1)O)=O,,,5,1,1,0,1
70258_0,,,,2,1,2,3
C(C1C(O)OCC(C=1)=O)=O,,,5,1,1,0,1
70260_0,,,,2,1,2,3
C1(COC=C(C=O)C1O)=O,,,5,1,1,0,1
70262_0,,,,2,1,2,3
C(C1C(COC(C=1C=O)O)O)=O,,,5,1,1,0,1
70264_0,,,,2,1,2,3
C(C1(C(C=O)=COCC1O)O)=O,,,5,1,1,0,1
70266_0,,,,2,1,2,3
C1(C=C(C=O)C(OC1CO)O)=O,,,5,1,1,0,1
70268_0,,,,2,1,2,3
C1(C(CO)OC=C(C=O)C1O)=O,,,5,1,1,0,1
70270_0,,,,2,1,2,3
C1C(C(CO)OC(C=1C=O)O)O,,,5,1,1,0,1
70272_0,,,,2,1,2,3
C1OC(CO)C(C(C=1C=O)O)O,,,5,1,1,0,1
70274_0,,,,2,1,2,3
C(C1(C=COCC1)O)=O,,,5,1,1,0,1
70276_0,,,,2,1,2,3
C1C(O)OCCC=1C=O,,,5,1,1,0,1
70278_0,,,,2,1,2,3
C1COC(CC=1C=O)O,,,5,1,1,0,1
70280_0,,,,2,1,2,3
C(C1(C(C(C=O)=CCO1)O)O)=O,,,5,1,1,0,1
70282_0,,,,2,1,2,3
C1COC(C(C=1C=O)O)O,,,5,1,2,0,2
70284_0,,,,2,1,2,3
C(C1COC(C(C=1CO)=O)O)=O,,,5,1,1,0,1
70286_0,,,,2,1,2,3
C(C1(C(C(C(O)OC1)=O)=C)O)=O,,,5,1,2,0,2
70288_0,,,,2,1,2,3
C(C1(C(CO)=CC(CO1)=O)O)=O,,,5,1,1,0,1
70290_0,,,,2,1,2,3
C1(COC(C=O)=C(CO)C1O)=O,,,5,1,1,0,1
70292_0,,,,2,1,2,3
C(C1(C(C(C(CO1)=O)O)=C)O)=O,,,5,1,2,0,2
70294_0,,,,2,1,2,3
C1C(CO)OC(C(C=1CO)=O)O,,,5,1,1,0,1
70296_0,,,,2,1,2,3
C=C1C(C(O)OC(CO)C1O)=O,,,5,1,2,0,2
70298_0,,,,2,1,2,3
C(C1(C(CO)=CC(CO1)O)O)=O,,,5,1,1,0,1
70300_0,,,,2,1,2,3
C1(CO)C(C(COC=1C=O)O)O,,,5,1,1,0,1
70302_0,,,,2,1,2,3
C(C1(C(C(C(CO1)O)O)=C)O)=O,,,5,1,2,0,2
70304_0,,,,2,1,2,3
C1COC(C(C=1CO)=O)O,,,5,1,1,0,1
70306_0,,,,2,1,2,3
C=C1C(C(O)OCC1O)=O,,,5,1,2,0,2
70308_0,,,,2,1,2,3
C1C(C(C(C=O)=O)OC(C=1)O)O,,,5,1,2,0,2
70310_0,,,,2,1,2,3
C1C(C(C(C(C=O)=O)OC=1)O)O,,,5,1,1,0,1
70312_0,,,,2,1,2,3
C(C1CC(C=CO1)O)=O,,,5,1,1,0,1
70314_0,,,,2,1,2,3
C(C1CC=CC(O)O1)=O,,,5,1,1,0,1
70316_0,,,,2,1,2,3
C(C1C=CCC(O1)O)=O,,,5,1,1,0,1
70317_0,,,,2,1,2,3
70319_0,,,,2,1,2,3
C1C(C(C=O)=O)OC(C(C=1)O)O,,,5,1,1,0,1
70321_0,,,,2,1,2,3
C(C1C=CC(C(C=O)(O1)O)O)=O,,,5,1,1,0,1
70322_0,,,,2,1,2,3
70324_0,,,,2,1,2,3
C(C1C=CC(C(O1)O)O)=O,,,5,1,2,0,2
70325_0,,,,2,1,2,3
70327_0,,,,2,1,2,3
C(C1C(C(OCC=1C=O)O)O)=O,,,5,1,1,0,1
70329_0,,,,2,1,2,3
C(C1(C(C=O)=CC(O)OC1)O)=O,,,5,1,2,0,2
70331_0,,,,2,1,2,3
C(C(C1C(O)OCC(C=1)=O)O)=O,,,5,1,1,0,1
70333_0,,,,2,1,2,3
C1(COC(C(C1O)=CC=O)O)=O,,,5,1,3,0,3
70335_0,,,,2,1,2,3
C(C(C1C(C(COC=1)=O)O)O)=O,,,5,1,1,0,1
70337_0,,,,2,1,2,3
C1C(CO)OC(C(C=1C=O)O)O,,,5,1,1,0,1
70339_0,,,,2,1,2,3
C1C(O)OC(CO)C(C=1C=O)O,,,5,1,2,0,2
70341_0,,,,2,1,2,3
C(C(C1C(O)OCC(C=1)O)O)=O,,,5,1,1,0,1
70343_0,,,,2,1,2,3
C1(C(O)OCC(C1O)O)=CC=O,,,5,1,3,0,3
70345_0,,,,2,1,2,3
C(C(C1C(C(COC=1)O)O)O)=O,,,5,1,1,0,1
70346_0,,,,2,1,2,3
70348_0,,,,2,1,2,3
C1C(O)OCC(C=1C=O)O,,,5,1,2,0,2
70350_0,,,,2,1,2,3
C1(C(O)OCC(C1O)=CC=O)=O,,,5,1,2,0,2
70352_0,,,,2,1,2,3
C1(C(O)OCC(C=1C=O)=O)CO,,,5,1,1,0,1
70354_0,,,,2,1,2,3
C(C1C(O)OCC(C=1)=O)(CO)=O,,,5,1,1,0,1
70356_0,,,,2,1,2,3
C1(COC=C(C(CO)=O)C1O)=O,,,5,1,1,0,1
70358_0,,,,2,1,2,3
C(C1C(CO)(OCC(C=1)=O)O)=O,,,5,1,1,0,1
70360_0,,,,2,1,2,3
C1(COC(CO)=C(C=O)C1O)=O,,,5,1,1,0,1
70362_0,,,,2,1,2,3
C1C(CO)(OCC(C=1C=O)=O)O,,,5,1,1,0,1
70364_0,,,,2,1,2,3
C1C(COC(C=1C(CO)=O)O)O,,,5,1,1,0,1
70366_0,,,,2,1,2,3
C1OCC(C(C=1C(CO)=O)O)O,,,5,1,1,0,1
70368_0,,,,2,1,2,3
C1C(COC(C=1C=O)(CO)O)O,,,5,1,1,0,1
70370_0,,,,2,1,2,3
C1(CO)OCC(C(C=1C=O)O)O,,,5,1,1,0,1
70372_0,,,,2,1,2,3
C1OC(C)C(C(C=1)=O)O,,,5,1,1,0,1
70374_0,,,,2,1,2,3
C(C1(CO)C(C(C=CO1)=O)O)=O,,,5,1,1,0,1
70376_0,,,,2,1,2,3
C1(COC(C(C1O)O)=CC=O)=O,,,5,1,1,0,1
70378_0,,,,2,1,2,3
C(CO)(C1C(C(C=CO1)=O)O)=O,,,5,1,1,0,1
70380_0,,,,2,1,2,3
C1(C(C(C(CO1)O)O)O)=CC=O,,,5,1,1,0,1
70382_0,,,,2,1,2,3
C1OC(C(CO)O)C(C(C=1)=O)O,,,5,1,1,0,1
70384_0,,,,2,1,2,3
C(C1C(C(C=CO1)=O)O)=O,,,5,1,1,0,1
70386_0,,,,2,1,2,3
C(C1C(C(C(C(O1)O)=O)O)=C)=O,,,5,1,2,0,2
70388_0,,,,2,1,2,3
C(C1C(C=C(CO)C(O1)O)=O)=O,,,5,1,1,0,1
70390_0,,,,2,1,2,3
C(C(C1(C=CC(CO1)=O)O)O)=O,,,5,1,1,0,1
70392_0,,,,2,1,2,3
C(C(C1OCC(C(C=1)O)=O)O)=O,,,5,1,1,0,1
70394_0,,,,2,1,2,3
C(C1C(C=CC(CO)(O1)O)=O)=O,,,5,1,1,0,1
70396_0,,,,2,1,2,3
C(C(C1(C=CC(CO1)O)O)O)=O,,,5,1,1,0,1
70398_0,,,,2,1,2,3
C(C(C1OCC(C(C=1)O)O)O)=O,,,5,1,1,0,1
70400_0,,,,2,1,2,3
C(C1C(C=CC(O1)O)=O)=O,,,5,1,1,0,1
70401_0,,,,2,1,2,3
70403_0,,,,2,1,2,3
C1(COC=CC1O)=O,,,5,1,1,0,1
70404_0,,,,2,1,2,3
70406_0,,,,2,1,2,3
C(C1(C=COCC1O)O)=O,,,5,1,1,0,1
70407_0,,,,2,1,2,3
70409_0,,,,2,1,2,3
C1(C(CO)OC=CC1O)=O,,,5,1,1,0,1
70411_0,,,,2,1,2,3
C1C(COC(C=1)O)O,,,5,1,1,0,1
70413_0,,,,2,1,2,3
C1OCC(C(C=1)O)O,,,5,1,1,0,1
70415_0,,,,2,1,2,3
C1C(C(CO)OC(C=1)O)O,,,5,1,1,0,1
70417_0,,,,2,1,2,3
C1OC(CO)C(C(C=1)O)O,,,5,1,1,0,1
70419_0,,,,2,1,2,3
C=CC1(C(O)OCC(C1O)O)O,,,5,1,2,0,2
70421_0,,,,2,1,2,3
C(C1(C=CC(O)OC1C=O)O)=O,,,5,1,1,0,1
70423_0,,,,2,1,2,3
C(C1C(C=O)(C(C=CO1)O)O)=O,,,5,1,1,0,1
70425_0,,,,2,1,2,3
C1(COC(C(C1(CO)O)=C)O)=O,,,5,1,2,0,2
70427_0,,,,2,1,2,3
C1(COC(C(C1(CO)O)O)=C)=O,,,5,1,1,0,1
70429_0,,,,2,1,2,3
C(CO)(C1(C=CC(O)OC1)O)=O,,,5,1,1,0,1
70431_0,,,,2,1,2,3
C(CO)(C1(COC=CC1O)O)=O,,,5,1,1,0,1
70433_0,,,,2,1,2,3
C1(C(C=CC(O)O1)(CO)O)=O,,,5,1,1,0,1
70435_0,,,,2,1,2,3
C1(C(CO)(C(C=CO1)O)O)=O,,,5,1,1,0,1
70437_0,,,,2,1,2,3
C(C1(C=CC(O)OC1)O)(O)=O,,,5,1,1,0,1
70439_0,,,,2,1,2,3
C(C1(COC=CC1O)O)(O)=O,,,5,1,1,0,1
70441_0,,,,2,1,2,3
C(C1(C(C(O)OCC1O)=C)O)=O,,,5,1,2,0,2
70443_0,,,,2,1,2,3
C(C1(C(COC(C1O)=C)O)O)=O,,,5,1,1,0,1
70445_0,,,,2,1,2,3
C1C(C(C=O)=O)(COC(C=1)O)O,,,5,1,1,0,1
70447_0,,,,2,1,2,3
C1OCC(C(C=O)=O)(C(C=1)O)O,,,5,1,1,0,1
70449_0,,,,2,1,2,3
C(C1(C=CC(O)OC1)O)=O,,,5,1,1,0,1
70451_0,,,,2,1,2,3
C(C1(COC=CC1O)O)=O,,,5,1,1,0,1
70453_0,,,,2,1,2,3
C(C1(C=CC(O)OC1CO)O)=O,,,5,1,1,0,1
70455_0,,,,2,1,2,3
C(C1(C(CO)OC=CC1O)O)=O,,,5,1,1,0,1
70457_0,,,,2,1,2,3
C1COC(C(C=1C=O)(CO)O)O,,,5,1,1,0,1
70458_0,,,,2,1,2,3
70460_0,,,,2,1,2,3
C(C1(C=CC(C(O1)O)O)CO)=O,,,5,1,1,0,1
70462_0,,,,2,1,2,3
C(C1C=CC(C(O1)O)(CO)O)=O,,,5,1,1,0,1
70464_0,,,,2,1,2,3
C(C1(C=CC(CO)(O)OC1)O)=O,,,5,1,1,0,1
70466_0,,,,2,1,2,3
C(C1(COC(CO)=CC1O)O)=O,,,5,1,1,0,1
70468_0,,,,2,1,2,3
C(C1(COC=CC1(CO)O)O)=O,,,5,1,1,0,1
70470_0,,,,2,1,2,3
C(C1(C(CO)=CC(O)OC1)O)=O,,,5,1,1,0,1
70472_0,,,,2,1,2,3
C(C1(C(OCC(C1O)=O)=C)O)=O,,,5,1,1,0,1
70474_0,,,,2,1,2,3
C(C1(C(OCC(C1O)O)=C)O)=O,,,5,1,1,0,1
70476_0,,,,2,1,2,3
C(C1(COC(C(C1O)O)=C)O)=O,,,5,1,1,0,1
70478_0,,,,2,1,2,3
C(C1(C(C(C(O)OC1)O)=C)O)=O,,,5,1,2,0,2
70479_0,,,,2,1,2,3
70481_0,,,,2,1,2,3
C(C1(C=COCC1(CO)O)O)=O,,,5,1,1,0,1
70482_0,,,,2,1,2,3
70484_0,,,,2,1,2,3
C(C1(C=COC(C1O)=O)O)=O,,,5,1,1,0,1
70486_0,,,,2,1,2,3
C1COC(C(C=1C(O)=O)(C)O)O,,,5,1,1,0,1
70488_0,,,,2,1,2,3
C(C1(C(C(O)OCC1)=C)O)(O)=O,,,5,1,2,0,2
70490_0,,,,2,1,2,3
C1COC(C)(C(C=1C(O)=O)O)O,,,5,1,1,0,1
70492_0,,,,2,1,2,3
C(C1(CCOC(C1O)=C)O)(O)=O,,,5,1,1,0,1
70494_0,,,,2,1,2,3
C=C1C(OC(CC1O)O)=O,,,5,1,2,0,2
70496_0,,,,2,1,2,3
C1(C(C=CC(O)O1)(C)O)=O,,,5,1,1,0,1
70498_0,,,,2,1,2,3
C1(C(C)(C(C=CO1)O)O)=O,,,5,1,1,0,1
70500_0,,,,2,1,2,3
C(CO)=C1C(OC(CC1O)O)=O,,,5,1,2,0,2
70502_0,,,,2,1,2,3
C1(C(C=C)(C(CC(O)O1)O)O)=O,,,5,1,2,0,2
70504_0,,,,2,1,2,3
C1(C(C=CC(O)O1)(CCO)O)=O,,,5,1,1,0,1
70506_0,,,,2,1,2,3
C1(C(CCO)(C(C=CO1)O)O)=O,,,5,1,1,0,1
70508_0,,,,2,1,2,3
C1(C(C=CC(O)O1)O)=O,,,5,1,1,0,1
70510_0,,,,2,1,2,3
C1(C(C(C=CO1)O)O)=O,,,5,1,1,0,1
70511_0,,,,2,1,2,3
70513_0,,,,2,1,2,3
C(C1(C=COCC1(C=O)O)O)=O,,,5,1,1,0,1
70514_0,,,,2,1,2,3
70515_0,,,,2,1,2,3
70517_0,,,,2,1,2,3
C(C1(C=COC(CO)C1O)O)=O,,,5,1,1,0,1
70518_0,,,,2,1,2,3
70520_0,,,,2,1,2,3
C(C1(C)C(C=CC(O1)O)O)(O)=O,,,5,1,2,0,2
70522_0,,,,2,1,2,3
C(C1(C)C(C(C=CO1)O)O)(O)=O,,,5,1,1,0,1
70523_0,,,,2,1,2,3
70525_0,,,,2,1,2,3
C(C1(C=CC(C(O1)O)O)C)(O)=O,,,5,1,1,0,1
70526_0,,,,2,1,2,3
70528_0,,,,2,1,2,3
C(C1C=CC(C(O1)O)O)(O)=O,,,5,1,1,0,1
70530_0,,,,2,1,2,3
C=C1C(OC(CO)(CC1O)O)=O,,,5,1,2,0,2
70532_0,,,,2,1,2,3
C1(C(C=CC(CO)(O)O1)(C)O)=O,,,5,1,1,0,1
70534_0,,,,2,1,2,3
C1(C(C)(C(C=C(CO)O1)O)O)=O,,,5,1,1,0,1
70536_0,,,,2,1,2,3
C1(C(C=CC(CO)(O)O1)O)=O,,,5,1,1,0,1
70538_0,,,,2,1,2,3
C1(C(C(C=C(CO)O1)O)O)=O,,,5,1,1,0,1
70540_0,,,,2,1,2,3
C=C1C(OC(CC1(CO)O)O)=O,,,5,1,2,0,2
70542_0,,,,2,1,2,3
C1(C(C)(C(C=CO1)(CO)O)O)=O,,,5,1,1,0,1
70544_0,,,,2,1,2,3
C1(C(C(CO)=CC(O)O1)(C)O)=O,,,5,1,1,0,1
70546_0,,,,2,1,2,3
C1(C(C(C=CO1)(CO)O)O)=O,,,5,1,1,0,1
70548_0,,,,2,1,2,3
C1(C(C(CO)=CC(O)O1)O)=O,,,5,1,1,0,1
70550_0,,,,2,1,2,3
C=C1C(OC(C)(C(C1O)O)O)=O,,,5,1,2,0,2
70552_0,,,,2,1,2,3
C1(C(C)(C(C(C(O1)=C)O)O)O)=O,,,5,1,1,0,1
70554_0,,,,2,1,2,3
C1(C(C(C(C(O1)=C)O)O)O)=O,,,5,1,1,0,1
70556_0,,,,2,1,2,3
C=C1C(OC(C(C1(C)O)O)O)=O,,,5,1,2,0,2
70558_0,,,,2,1,2,3
C1(C(C(C(C(O)O1)O)=C)(C)O)=O,,,5,1,2,0,2
70560_0,,,,2,1,2,3
C1(C(C(C(C(O)O1)O)=C)O)=O,,,5,1,2,0,2
70562_0,,,,2,1,2,3
C1COC(C(C=1C(O)=O)O)O,,,5,1,1,0,1
70564_0,,,,2,1,2,3
C1C(C(COC=1C(O)=O)O)O,,,5,1,1,0,1
70566_0,,,,2,1,2,3
C(C1(C=CC(CO1)O)O)(O)=O,,,5,1,1,0,1
70568_0,,,,2,1,2,3
C1OC(CO)C(C(C(C=1)O)O)O,,,5,1,1,0,1
70570_0,,,,2,1,2,3
C1C(C(C(CO)OC(C=1)O)O)O,,,5,1,1,0,1
70572_0,,,,2,1,2,3
C(C1C(C=CC(C(O)O1)=O)O)=O,,,5,1,1,0,1
70574_0,,,,2,1,2,3
C1OCC(CO)(C(C(C=1)=O)O)O,,,5,1,1,0,1
70576_0,,,,2,1,2,3
C1(COC(C(C(C=1)=O)O)O)CO,,,5,1,1,0,1
70578_0,,,,2,1,2,3
C1(COC(C=CC1O)O)=O,,,5,1,1,0,1
70580_0,,,,2,1,2,3
C1(COC=CC(C1O)O)=O,,,5,1,1,0,1
70582_0,,,,2,1,2,3
C1C(C(CO)(OCC(C=1)=O)O)O,,,5,1,1,0,1
70584_0,,,,2,1,2,3
C1(COC(C=CC1O)(CO)O)=O,,,5,1,1,0,1
70586_0,,,,2,1,2,3
C1(COC(CO)=CC(C1O)O)=O,,,5,1,1,0,1
70588_0,,,,2,1,2,3
C1(C(C(C=COC1)(CO)O)O)=O,,,5,1,1,0,1
70590_0,,,,2,1,2,3
C1(COC(C=C(CO)C1O)O)=O,,,5,1,1,0,1
70592_0,,,,2,1,2,3
C1(COC(C(C(C1O)O)O)=C)=O,,,5,1,1,0,1
70594_0,,,,2,1,2,3
C1(COC(C(C(C1O)=C)O)O)=O,,,5,1,2,0,2
70596_0,,,,2,1,2,3
C1(CO)C(COC(C(C=1)=O)O)O,,,5,1,1,0,1
70598_0,,,,2,1,2,3
C1(C(COC(C(C1O)=C)O)O)=O,,,5,1,2,0,2
70600_0,,,,2,1,2,3
C1(C(C(C(OCC1O)=C)O)O)=O,,,5,1,1,0,1
70602_0,,,,2,1,2,3
C1(C(CO)OC(C=CC1O)O)=O,,,5,1,1,0,1
70604_0,,,,2,1,2,3
C1(C(C(C=COC1CO)O)O)=O,,,5,1,1,0,1
70606_0,,,,2,1,2,3
C1(C(C(C(C=CO1)=O)O)O)=O,,,5,1,1,0,1
70608_0,,,,2,1,2,3
C1(C=CC(C(C(O)O1)O)=O)=O,,,5,1,1,0,1
70610_0,,,,2,1,2,3
C(C1(COC=CC(C1O)O)O)=O,,,5,1,1,0,1
70612_0,,,,2,1,2,3
C(C1(COC(C=CC1O)O)O)=O,,,5,1,2,0,2
70614_0,,,,2,1,2,3
C1C(CO)(COC(C(C=1)=O)O)O,,,5,1,1,0,1
70616_0,,,,2,1,2,3
C1OCC(C(CO)(C(C=1)O)O)O,,,5,1,1,0,1
70618_0,,,,2,1,2,3
C1C(CO)(C(COC(C=1)O)O)O,,,5,1,1,0,1
70620_0,,,,2,1,2,3
C1(C(C(C(C=CO1)O)O)O)=O,,,5,1,1,0,1
70622_0,,,,2,1,2,3
C1(C(C(C=CC(O)O1)O)O)=O,,,5,1,2,0,2
70624_0,,,,2,1,2,3
C1(C(O)OCC=C(C=O)C1)=O,,,5,1,1,0,1
70626_0,,,,2,1,2,3
C(C1CCOC(C(C=1)=O)O)=O,,,5,1,1,0,1
70628_0,,,,2,1,2,3
C(C1(C=CC(CCO1)=O)O)=O,,,5,1,1,0,1
70630_0,,,,2,1,2,3
C1(CCOC(C=O)=CC1O)=O,,,5,1,1,0,1
70632_0,,,,2,1,2,3
C(C1C=CCC(C(O1)O)=O)=O,,,5,1,1,0,1
70634_0,,,,2,1,2,3
C(C1CC=CC(C(O)O1)=O)=O,,,5,1,1,0,1
70636_0,,,,2,1,2,3
C(C1(CC=CC(CO1)=O)O)=O,,,5,1,1,0,1
70638_0,,,,2,1,2,3
C(C1(C=CCC(CO1)=O)O)=O,,,5,1,1,0,1
70640_0,,,,2,1,2,3
C1(COC(C=O)=CC(C1)O)=O,,,5,1,1,0,1
70642_0,,,,2,1,2,3
C1(C=CC(C(O)OC1)=O)=O,,,5,1,1,0,1
70644_0,,,,2,1,2,3
C(C1C(COC(C(C=1)=O)O)O)=O,,,5,1,1,0,1
70646_0,,,,2,1,2,3
C1(C=CC(C(OC1CO)O)=O)=O,,,5,1,1,0,1
70648_0,,,,2,1,2,3
C(C1(C=CC(C(CO1)O)=O)O)=O,,,5,1,1,0,1
70650_0,,,,2,1,2,3
C1(C(COC(C=O)=CC1O)O)=O,,,5,1,1,0,1
70652_0,,,,2,1,2,3
C1C(C(CO)OC(C(C=1)=O)O)O,,,5,1,1,0,1
70654_0,,,,2,1,2,3
C(C1(C=CC(C(CO1)O)O)O)=O,,,5,1,1,0,1
70656_0,,,,2,1,2,3
C1C(C(C(COC=1C=O)O)O)O,,,5,1,1,0,1
70658_0,,,,2,1,2,3
C1CC(OCC(C=1C=O)=O)O,,,5,1,1,0,1
70660_0,,,,2,1,2,3
C(C1C(COC(C=C1)O)=O)=O,,,5,1,1,0,1
70662_0,,,,2,1,2,3
C(C1C(COC=CC1O)=O)=O,,,5,1,1,0,1
70664_0,,,,2,1,2,3
C(C1C(C=CCC(O1)O)=O)=O,,,5,1,1,0,1
70666_0,,,,2,1,2,3
C1(C(C=O)OC(C=CC1)O)=O,,,5,1,1,0,1
70668_0,,,,2,1,2,3
C(C1C(CC(C=CO1)O)=O)=O,,,5,1,1,0,1
70670_0,,,,2,1,2,3
C1(C=C(C=O)C(O)OCC1)=O,,,5,1,1,0,1
70672_0,,,,2,1,2,3
C1(CCOC=C(C=O)C1O)=O,,,5,1,1,0,1
70674_0,,,,2,1,2,3
C(C1C=CC(COC1O)=O)=O,,,5,1,1,0,1
70676_0,,,,2,1,2,3
C1(COC(C(C=O)=CC1)O)=O,,,5,1,1,0,1
70678_0,,,,2,1,2,3
C1(COC=C(C=O)C(C1)O)=O,,,5,1,1,0,1
70680_0,,,,2,1,2,3
C1(C=C(C=O)C(O)OCC1O)=O,,,5,1,1,0,1
70682_0,,,,2,1,2,3
C1(C(COC=C(C=O)C1O)O)=O,,,5,1,1,0,1
70684_0,,,,2,1,2,3
C1C(C(COC(C=1C=O)O)O)O,,,5,1,1,0,1
70686_0,,,,2,1,2,3
C1OCC(C(C(C=1C=O)O)O)O,,,5,1,1,0,1
70688_0,,,,2,1,2,3
C1(C(O)OCC=C(C=O)C1O)=O,,,5,1,1,0,1
70690_0,,,,2,1,2,3
C1(CCOC=CC1O)=O,,,5,1,1,0,1
70692_0,,,,2,1,2,3
C1C(O)OCCC(C=1)=O,,,5,1,1,0,1
70694_0,,,,2,1,2,3
C1(C(CO)=CC(COC1O)=O)=O,,,5,1,1,0,1
70696_0,,,,2,1,2,3
C1(COC(C(C(C1O)=C)=O)O)=O,,,5,1,2,0,2
70698_0,,,,2,1,2,3
C1C(COC(C(C=1CO)=O)O)O,,,5,1,1,0,1
70700_0,,,,2,1,2,3
C=C1C(C(O)OCC(C1O)O)=O,,,5,1,2,0,2
70702_0,,,,2,1,2,3
C(C1C=CC(C(C(O1)O)=O)O)=O,,,5,1,1,0,1
70704_0,,,,2,1,2,3
C(C1C(C(OCC(C=1)=O)O)O)=O,,,5,1,1,0,1
70706_0,,,,2,1,2,3
C1(COC(C=C(C=O)C1O)O)=O,,,5,1,2,0,2
70708_0,,,,2,1,2,3
C1C(COC(C(C=1C=O)O)O)O,,,5,1,1,0,1
70710_0,,,,2,1,2,3
C1C(O)OCC(C(C=1C=O)O)O,,,5,1,2,0,2
70712_0,,,,2,1,2,3
C1(COC=CC(C1)O)=O,,,5,1,1,0,1
70714_0,,,,2,1,2,3
C1(COC(C=CC1)O)=O,,,5,1,1,0,1
70716_0,,,,2,1,2,3
C1CC(OCC(C=1)=O)O,,,5,1,1,0,1
70718_0,,,,2,1,2,3
C(C1(C(C=CC(CO1)=O)O)O)=O,,,5,1,1,0,1
70720_0,,,,2,1,2,3
C(C1(COC=CC(C1O)=O)O)=O,,,5,1,1,0,1
70722_0,,,,2,1,2,3
C1OC(CO)C(C(C(C=1)=O)O)O,,,5,1,1,0,1
70724_0,,,,2,1,2,3
C1(C=C(C=O)COC(C1O)O)=O,,,5,1,1,0,1
70726_0,,,,2,1,2,3
C1C(CO)OC(C(C(C=1)=O)O)O,,,5,1,1,0,1
70727_0,,,,2,1,2,3
70729_0,,,,2,1,2,3
C1(C(COC=CC1O)O)=O,,,5,1,1,0,1
70731_0,,,,2,1,2,3
C1C(C(COC(C=1)O)O)O,,,5,1,1,0,1
70733_0,,,,2,1,2,3
C1OCC(C(C(C=1)O)O)O,,,5,1,1,0,1
70735_0,,,,2,1,2,3
C1(COC(C=CC1(CO)O)O)=O,,,5,1,1,0,1
70737_0,,,,2,1,2,3
C1(COC=CC(C1(CO)O)O)=O,,,5,1,1,0,1
70739_0,,,,2,1,2,3
C(C1(C=CC(O)OCC1O)O)=O,,,5,1,1,0,1
70741_0,,,,2,1,2,3
C(C1(C(COC=CC1O)O)O)=O,,,5,1,1,0,1
70742_0,,,,2,1,2,3
70744_0,,,,2,1,2,3
C(C1(C=CC(C(O)OC1)O)O)=O,,,5,1,1,0,1
70746_0,,,,2,1,2,3
C1C(C(OCC(C=1)=O)O)(CO)O,,,5,1,1,0,1
70748_0,,,,2,1,2,3
C1COC(CC(C=1C(O)=O)O)O,,,5,1,1,0,1
70750_0,,,,2,1,2,3
C(C1(C=CC(O)OCC1)O)(O)=O,,,5,1,1,0,1
70752_0,,,,2,1,2,3
C(C1(CCOC=CC1O)O)(O)=O,,,5,1,1,0,1
70753_0,,,,2,1,2,3
70755_0,,,,2,1,2,3
C(C1(C=COCC(C1O)=O)O)=O,,,5,1,1,0,1
70756_0,,,,2,1,2,3
70758_0,,,,2,1,2,3
C(C1(C=COCC(C1O)O)O)=O,,,5,1,1,0,1
70760_0,,,,2,1,2,3
C=C1C(OC(CC(C1O)O)O)=O,,,5,1,2,0,2
70762_0,,,,2,1,2,3
C1(C(C)(C(C=CC(O)O1)O)O)=O,,,5,1,2,0,2
70764_0,,,,2,1,2,3
C1(C(C)(C(C(C=CO1)O)O)O)=O,,,5,1,1,0,1
70766_0,,,,2,1,2,3
C=C1C(OC(C(CC1O)O)O)=O,,,5,1,2,0,2
70767_0,,,,2,1,2,3
70769_0,,,,2,1,2,3
C1(C(C=CC(C(O)O1)O)(C)O)=O,,,5,1,1,0,1
70770_0,,,,2,1,2,3
70772_0,,,,2,1,2,3
C1(C(C=CC(C(O)O1)O)O)=O,,,5,1,1,0,1
70774_0,,,,2,1,2,3
C(C(C1COC(C=1)=O)=O)=O,,,5,1,1,0,1
70776_0,,,,2,1,2,3
C(C1C(C=O)=CC(O1)=O)=O,,,5,1,1,0,1
70778_0,,,,2,1,2,3
C=C1C(OCC1(CO)O)=O,,,5,1,2,0,2
70780_0,,,,2,1,2,3
C1(C(C(C(O1)=O)=C)O)=O,,,5,1,2,0,2
70782_0,,,,2,1,2,3
C1(C(C(C(O1)=O)=CCO)O)=O,,,5,1,2,0,2
70784_0,,,,2,1,2,3
C1(C(C=C)(C(C(O1)=O)O)O)=O,,,5,1,2,0,2
70786_0,,,,2,1,2,3
C(CC1C(C(C(O1)=O)=C)O)=O,,,5,1,2,0,2
70788_0,,,,2,1,2,3
C(CC1(C(C(OC1)=O)=C)O)=O,,,5,1,2,0,2
70790_0,,,,2,1,2,3
C1(C(C(CO1)=CC=O)(C)O)=O,,,5,1,2,0,2
70792_0,,,,2,1,2,3
C1(C(C(CO1)=CC=O)O)=O,,,5,1,2,0,2
70794_0,,,,2,1,2,3
C(C)(C1C(C(C(O1)=O)=C)O)=O,,,5,1,2,0,2
70796_0,,,,2,1,2,3
C(C1C(C(C(O1)=O)=C)(C)O)=O,,,5,1,2,0,2
70798_0,,,,2,1,2,3
C1(C(C(C(C=O)O1)=C)(C)O)=O,,,5,1,2,0,2
70800_0,,,,2,1,2,3
C1(C(C(C(C=O)O1)=C)O)=O,,,5,1,2,0,2
70802_0,,,,2,1,2,3
C(C1(C(C(OC1)=O)=C)O)=O,,,5,1,2,0,2
70803_0,,,,2,1,2,3
70804_0,,,,2,1,2,3
70805_0,,,,2,1,2,3
70806_0,,,,2,1,2,3
70807_0,,,,2,1,2,3
70808_0,,,,2,1,2,3
70810_0,,,,2,1,2,3
C(C1C(COC(C=1)=O)=O)=O,,,5,1,1,0,1
70812_0,,,,2,1,2,3
C(C1C(C=CC(O1)=O)=O)=O,,,5,1,1,0,1
70814_0,,,,2,1,2,3
C1(C(C(C(O)=O)=CCO1)O)=O,,,5,1,1,0,1
70816_0,,,,2,1,2,3
C(C1(C(C(OCC1)=O)=C)O)=O,,,5,1,2,0,2
70818_0,,,,2,1,2,3
C1(C(C(C=O)=CCO1)(C)O)=O,,,5,1,1,0,1
70820_0,,,,2,1,2,3
C1(C(C(C=O)=CCO1)O)=O,,,5,1,1,0,1
70822_0,,,,2,1,2,3
C(C1CC(C(C(O1)=O)=C)O)=O,,,5,1,2,0,2
70824_0,,,,2,1,2,3
C1(C(C=CC(C=O)O1)(C)O)=O,,,5,1,1,0,1
70826_0,,,,2,1,2,3
C1(C(C=CC(C=O)O1)O)=O,,,5,1,1,0,1
70828_0,,,,2,1,2,3
C1(COC(C(C1O)=C)=O)=O,,,5,1,2,0,2
70829_0,,,,2,1,2,3
70830_0,,,,2,1,2,3
70832_0,,,,2,1,2,3
C1(C(C=CCO1)O)=O,,,5,1,1,0,1
70833_0,,,,2,1,2,3
70835_0,,,,2,1,2,3
C1(C(C=CC(CO)O1)O)=O,,,5,1,1,0,1
70837_0,,,,2,1,2,3
C1(CCOC(C(C1O)=C)=O)=O,,,5,1,2,0,2
70839_0,,,,2,1,2,3
C1(COC(C(C(C1)O)=C)=O)=O,,,5,1,2,0,2
70841_0,,,,2,1,2,3
C1(C(C=CC(CO1)=O)(C)O)=O,,,5,1,1,0,1
70842_0,,,,2,1,2,3
70844_0,,,,2,1,2,3
C1(C(C=CC(CO1)O)O)=O,,,5,1,1,0,1
70846_0,,,,2,1,2,3
C(CCC(C=O)=CC(O)=O)(O)=O,,,5,1,2,0,2
70848_0,,,,2,1,2,3
C(CC(C(O)=O)=CCC(O)=O)=O,,,5,1,1,0,1
70850_0,,,,2,1,2,3
C(CCC(C(O)=O)=CC=O)(O)=O,,,5,1,2,0,2
70852_0,,,,2,1,2,3
C(CCC(C=O)=C(C=O)C)(O)=O,,,5,1,1,0,1
70854_0,,,,2,1,2,3
C(C(C(C=O)=C)CCC(O)=O)=O,,,5,1,2,0,2
70856_0,,,,2,1,2,3
C(CCCC(C=O)=CC=O)(O)=O,,,5,1,2,0,2
70858_0,,,,2,1,2,3
C(CC(C=O)=CCCC(O)=O)=O,,,5,1,1,0,1
70860_0,,,,2,1,2,3
C(CCC(C=O)=CC(C)=O)(O)=O,,,5,1,1,0,1
70862_0,,,,2,1,2,3
C(CC(C(C)=O)=CCC(O)=O)=O,,,5,1,1,0,1
70864_0,,,,2,1,2,3
C(CCC(C(C)=O)=CC=O)(O)=O,,,5,1,1,0,1
70866_0,,,,2,1,2,3
C(CCCC(C=CC=O)=O)(O)=O,,,5,1,2,0,2
70868_0,,,,2,1,2,3
C(CC=C(C)CC(C=O)=O)(O)=O,,,5,1,1,0,1
70870_0,,,,2,1,2,3
C(CCC(CC(C=O)=O)=C)(O)=O,,,5,1,1,0,1
70872_0,,,,2,1,2,3
C(CCC(C)=CC(C=O)=O)(O)=O,,,5,1,1,0,1
70874_0,,,,2,1,2,3
C(CCC=CCC(C=O)=O)(O)=O,,,5,1,1,0,1
70876_0,,,,2,1,2,3
C(CCCC=CC(C=O)=O)(O)=O,,,5,1,2,0,2
70878_0,,,,2,1,2,3
C(CCC(C=C)C(C=O)=O)(O)=O,,,5,1,2,0,2
70880_0,,,,2,1,2,3
C(CCC(C(C=O)=O)=CC)(O)=O,,,5,1,1,0,1
70882_0,,,,2,1,2,3
C(CC=C(C=O)CCC(O)=O)=O,,,5,1,1,0,1
70884_0,,,,2,1,2,3
C(C(C=CC=O)CCC(O)=O)=O,,,5,1,2,0,2
70886_0,,,,2,1,2,3
C(CC(CC=O)=CCC(O)=O)=O,,,5,1,1,0,1
70888_0,,,,2,1,2,3
C(CC(CCC(O)=O)=CC=O)=O,,,5,1,1,0,1
70890_0,,,,2,1,2,3
C(C(C=O)C(C)=CCC(O)=O)=O,,,5,1,1,0,1
70892_0,,,,2,1,2,3
C(C(C=O)C(CCC(O)=O)=C)=O,,,5,1,1,0,1
70894_0,,,,2,1,2,3
C(CCC(C)=C(C=O)C=O)(O)=O,,,5,1,1,0,1
70896_0,,,,2,1,2,3
C(C(C=O)C=CCCC(O)=O)=O,,,5,1,1,0,1
70898_0,,,,2,1,2,3
C(CCCC=C(C=O)C=O)(O)=O,,,5,1,2,0,2
70900_0,,,,2,1,2,3
C(C(C=O)(C=C)CCC(O)=O)=O,,,5,1,2,0,2
70902_0,,,,2,1,2,3
C(C(C=O)C=CCC(C=O)=O)=O,,,5,1,1,0,1
70904_0,,,,2,1,2,3
C(CCC(C=O)=O)=C(C=O)C=O,,,5,1,1,0,1
70906_0,,,,2,1,2,3
C(C(C=O)C=C(C=O)CC=O)=O,,,5,1,1,0,1
70908_0,,,,2,1,2,3
C(C(C=C(C=O)C=O)CC=O)=O,,,5,1,1,0,1
70910_0,,,,2,1,2,3
C(C(C=O)C=CCC(O)=O)=O,,,5,1,1,0,1
70912_0,,,,2,1,2,3
C(CCC=C(C=O)C=O)(O)=O,,,5,1,1,0,1
70914_0,,,,2,1,2,3
C(C)=C(C=O)CCC(C=O)=O,,,5,1,1,0,1
70916_0,,,,2,1,2,3
C(C(C=C)CCC(C=O)=O)=O,,,5,1,2,0,2
70918_0,,,,2,1,2,3
C(C(C(C=O)=CC)CC=O)=O,,,5,1,1,0,1
70920_0,,,,2,1,2,3
C(C(C=C)C(C=O)CC=O)=O,,,5,1,2,0,2
70922_0,,,,2,1,2,3
C(CCC(C=O)=CC)(O)=O,,,5,1,1,0,1
70924_0,,,,2,1,2,3
C(C(C=C)CCC(O)=O)=O,,,5,1,2,0,2
70926_0,,,,2,1,2,3
C(C(C(CC(O)=O)=C)C(C)O)=O,,,5,1,1,0,1
70928_0,,,,2,1,2,3
C(CC(C(C=O)=CC)CO)(O)=O,,,5,1,1,0,1
70930_0,,,,2,1,2,3
C(C(C=C)C(CO)CC(O)=O)=O,,,5,1,2,0,2
70932_0,,,,2,1,2,3
C(CC(C)=CCC(C=O)=O)=O,,,5,1,1,0,1
70934_0,,,,2,1,2,3
C(C)(CCC(C=O)=O)=CC=O,,,5,1,1,0,1
70936_0,,,,2,1,2,3
C(CC(CCC(C=O)=O)=C)=O,,,5,1,1,0,1
70938_0,,,,2,1,2,3
C(CC(C)=C(C=O)CC=O)=O,,,5,1,1,0,1
70940_0,,,,2,1,2,3
C(C(C(C)=CC=O)CC=O)=O,,,5,1,1,0,1
70942_0,,,,2,1,2,3
C(C(C(CC=O)=C)CC=O)=O,,,5,1,1,0,1
70944_0,,,,2,1,2,3
C(CC(C)=CCC(O)=O)=O,,,5,1,1,0,1
70946_0,,,,2,1,2,3
C(CCC(C)=CC=O)(O)=O,,,5,1,1,0,1
70948_0,,,,2,1,2,3
C(CC(CCC(O)=O)=C)=O,,,5,1,1,0,1
70950_0,,,,2,1,2,3
C(CC(C(C)(CC=O)O)=C)(O)=O,,,5,1,1,0,1
70952_0,,,,2,1,2,3
C(CC(CO)=C(C)CC=O)(O)=O,,,5,1,1,0,1
70954_0,,,,2,1,2,3
C(CC(C(C)=CC=O)CO)(O)=O,,,5,1,1,0,1
70956_0,,,,2,1,2,3
C(CC(C(CO)CC(O)=O)=C)=O,,,5,1,1,0,1
70958_0,,,,2,1,2,3
C(CCCC(C=O)=O)=CC=O,,,5,1,2,0,2
70960_0,,,,2,1,2,3
C(CC=CCCC(C=O)=O)=O,,,5,1,1,0,1
70962_0,,,,2,1,2,3
C(CC(C=O)CC=CC=O)=O,,,5,1,2,0,2
70964_0,,,,2,1,2,3
C(C(C=CCC=O)CC=O)=O,,,5,1,1,0,1
70966_0,,,,2,1,2,3
C(CCCC=CC=O)(O)=O,,,5,1,2,0,2
70968_0,,,,2,1,2,3
C(CC=CCCC(O)=O)=O,,,5,1,1,0,1
70970_0,,,,2,1,2,3
C(CC(CC(CC=O)O)=C)(O)=O,,,5,1,1,0,1
70972_0,,,,2,1,2,3
C(CC(CO)CC=CC=O)(O)=O,,,5,1,2,0,2
70974_0,,,,2,1,2,3
C(CC=CC(CO)CC(O)=O)=O,,,5,1,1,0,1
70975_0,,,,2,1,2,3
70977_0,,,,2,1,2,3
C(C(C=C)(CCC(C=O)=O)O)=O,,,5,1,3,0,3
70978_0,,,,2,1,2,3
70979_0,,,,2,1,2,3
70980_0,,,,2,1,2,3
70982_0,,,,2,1,2,3
C(C(C=C)(CCC(O)=O)O)=O,,,5,1,3,0,3
70984_0,,,,2,1,2,3
C(C(C(C)=CCC(C=O)=O)O)=O,,,5,1,1,0,1
70986_0,,,,2,1,2,3
C(C(C(CCC(C=O)=O)=C)O)=O,,,5,1,2,0,2
70988_0,,,,2,1,2,3
C(CC(C=O)=C(C)C(C=O)O)=O,,,5,1,1,0,1
70990_0,,,,2,1,2,3
C(C(C(C(C=O)O)=C)CC=O)=O,,,5,1,2,0,2
70992_0,,,,2,1,2,3
C(CC=C(C)C(C=O)O)(O)=O,,,5,1,1,0,1
70994_0,,,,2,1,2,3
C(C(C(CCC(O)=O)=C)O)=O,,,5,1,2,0,2
70996_0,,,,2,1,2,3
C(C(C=CCCC(C=O)=O)O)=O,,,5,1,2,0,2
70998_0,,,,2,1,2,3
C(C(C=CC(C=O)O)CC=O)=O,,,5,1,2,0,2
71000_0,,,,2,1,2,3
C(C(C=CCCC(O)=O)O)=O,,,5,1,2,0,2
71002_0,,,,2,1,2,3
C(CC=CCC(C=O)=O)=O,,,5,1,1,0,1
71004_0,,,,2,1,2,3
C(CCC(C=O)=O)=CC=O,,,5,1,2,0,2
71006_0,,,,2,1,2,3
C(CC(C=O)=CCC=O)=O,,,5,1,1,0,1
71008_0,,,,2,1,2,3
C(C(C=CC=O)CC=O)=O,,,5,1,2,0,2
71010_0,,,,2,1,2,3
C(CC=CCC(O)=O)=O,,,5,1,1,0,1
71012_0,,,,2,1,2,3
C(CCC=CC=O)(O)=O,,,5,1,2,0,2
71014_0,,,,2,1,2,3
C(CC(C(CC=O)O)=C)(O)=O,,,5,1,1,0,1
71016_0,,,,2,1,2,3
C(CC=C(CO)CC(O)=O)=O,,,5,1,1,0,1
71018_0,,,,2,1,2,3
C(CC(C=CC=O)CO)(O)=O,,,5,1,2,0,2
71020_0,,,,2,1,2,3
C=C(C=O)CCC(C=O)=O,,,5,1,2,0,2
71022_0,,,,2,1,2,3
C(C(C(C=O)=C)CC=O)=O,,,5,1,2,0,2
71024_0,,,,2,1,2,3
C(CCC(C=O)=C)(O)=O,,,5,1,2,0,2
71026_0,,,,2,1,2,3
C(C(C(CC(O)=O)=C)CO)=O,,,5,1,1,0,1
71028_0,,,,2,1,2,3
C(CC(C(C=O)=C)CO)(O)=O,,,5,1,2,0,2
71029_0,,,,2,1,2,3
71031_0,,,,2,1,2,3
C(C(CCC(C=O)=O)O)=CC=O,,,5,1,3,0,3
71032_0,,,,2,1,2,3
71033_0,,,,2,1,2,3
71035_0,,,,2,1,2,3
C(CC=CC(CC=O)O)(O)=O,,,5,1,1,0,1
71037_0,,,,2,1,2,3
C(CCC(C=CC=O)O)(O)=O,,,5,1,3,0,3
71039_0,,,,2,1,2,3
C(CC(CO)=CCC(C=O)=O)=O,,,5,1,1,0,1
71041_0,,,,2,1,2,3
C(CO)(CCC(C=O)=O)=CC=O,,,5,1,2,0,2
71043_0,,,,2,1,2,3
C(CC(CO)=C(C=O)CC=O)=O,,,5,1,1,0,1
71045_0,,,,2,1,2,3
C(C(C(CO)=CC=O)CC=O)=O,,,5,1,2,0,2
71047_0,,,,2,1,2,3
C(CC=C(CO)CC=O)(O)=O,,,5,1,1,0,1
71049_0,,,,2,1,2,3
C(CCC(CO)=CC=O)(O)=O,,,5,1,2,0,2
71051_0,,,,2,1,2,3
C(CO)=C(C=O)CCC(C=O)=O,,,5,1,2,0,2
71053_0,,,,2,1,2,3
C(C(C(C=O)=CCO)CC=O)=O,,,5,1,2,0,2
71055_0,,,,2,1,2,3
C(CCC(C=O)=CCO)(O)=O,,,5,1,2,0,2
71056_0,,,,2,1,2,3
71057_0,,,,2,1,2,3
71058_0,,,,2,1,2,3
71060_0,,,,2,1,2,3
C(CC(C=O)=O)=CC(C(C)=O)=O,,,5,1,1,0,1
71062_0,,,,2,1,2,3
C(CC(C=O)=CC(C(C)=O)=O)=O,,,5,1,1,0,1
71064_0,,,,2,1,2,3
C(CC=CC(C(C)=O)=O)(O)=O,,,5,1,1,0,1
71066_0,,,,2,1,2,3
C(CCC(C=O)=O)=CC(C=O)=O,,,5,1,2,0,2
71068_0,,,,2,1,2,3
C(C(C=CC(C=O)=O)CC=O)=O,,,5,1,2,0,2
71070_0,,,,2,1,2,3
C(CCC=CC(C=O)=O)(O)=O,,,5,1,2,0,2
71072_0,,,,2,1,2,3
C(CC(C=O)=O)=C(C(C=O)=O)C,,,5,1,1,0,1
71074_0,,,,2,1,2,3
C=C(C(C=O)=O)CCC(C=O)=O,,,5,1,2,0,2
71076_0,,,,2,1,2,3
C(CC(C=O)=C(C(C=O)=O)C)=O,,,5,1,1,0,1
71078_0,,,,2,1,2,3
C(C(C(C(C=O)=O)=C)CC=O)=O,,,5,1,2,0,2
71080_0,,,,2,1,2,3
C(CC=C(C(C=O)=O)C)(O)=O,,,5,1,1,0,1
71082_0,,,,2,1,2,3
C(CCC(C(C=O)=O)=C)(O)=O,,,5,1,2,0,2
71083_0,,,,2,1,2,3
71084_0,,,,2,1,2,3
71085_0,,,,2,1,2,3
71087_0,,,,2,1,2,3
C(C(C=O)(C(CC(O)=O)=C)O)=O,,,5,1,1,0,1
71088_0,,,,2,1,2,3
71090_0,,,,2,1,2,3
C(CC=CC(CO)(CO)O)(O)=O,,,5,1,1,0,1
71092_0,,,,2,1,2,3
C(CC(C=O)=O)=CC(C)=O,,,5,1,1,0,1
71094_0,,,,2,1,2,3
C(CC(C=O)=CC(C)=O)=O,,,5,1,1,0,1
71096_0,,,,2,1,2,3
C(CC=CC(C)=O)(O)=O,,,5,1,1,0,1
71098_0,,,,2,1,2,3
C(CC(C(C(C)=O)O)=C)(O)=O,,,5,1,1,0,1
71100_0,,,,2,1,2,3
C(CC(CO)=CC(C)=O)(O)=O,,,5,1,1,0,1
71102_0,,,,2,1,2,3
C(CC(CC(CO)=O)=C)(O)=O,,,5,1,1,0,1
71104_0,,,,2,1,2,3
C(CC(C=O)=O)=CC(CCO)=O,,,5,1,1,0,1
71106_0,,,,2,1,2,3
C=CC(C(CCC(C=O)=O)O)=O,,,5,1,2,0,2
71108_0,,,,2,1,2,3
C(CC(C=O)=CC(CCO)=O)=O,,,5,1,1,0,1
71109_0,,,,2,1,2,3
71111_0,,,,2,1,2,3
C(CC=CC(CCO)=O)(O)=O,,,5,1,1,0,1
71113_0,,,,2,1,2,3
C(CCC(C(C=C)=O)O)(O)=O,,,5,1,2,0,2
71115_0,,,,2,1,2,3
C(CO)(CC=CCC(C=O)=O)=O,,,5,1,1,0,1
71117_0,,,,2,1,2,3
C(CCC(C=O)=O)=CC(CO)=O,,,5,1,1,0,1
71119_0,,,,2,1,2,3
C(CC(C=O)=CCC(CO)=O)=O,,,5,1,1,0,1
71121_0,,,,2,1,2,3
C(C(C=CC(CO)=O)CC=O)=O,,,5,1,1,0,1
71123_0,,,,2,1,2,3
C(CC=CCC(CO)=O)(O)=O,,,5,1,1,0,1
71125_0,,,,2,1,2,3
C(CCC=CC(CO)=O)(O)=O,,,5,1,1,0,1
71127_0,,,,2,1,2,3
C=C(C(CO)=O)CCC(C=O)=O,,,5,1,1,0,1
71129_0,,,,2,1,2,3
C(C(C(C(CO)=O)=C)CC=O)=O,,,5,1,1,0,1
71131_0,,,,2,1,2,3
C(CCC(C(CO)=O)=C)(O)=O,,,5,1,1,0,1
71133_0,,,,2,1,2,3
C(CC(C=O)=O)=C(C=O)CCO,,,5,1,1,0,1
71134_0,,,,2,1,2,3
71135_0,,,,2,1,2,3
71137_0,,,,2,1,2,3
C(CC(C=O)=C(C=O)CCO)=O,,,5,1,1,0,1
71138_0,,,,2,1,2,3
71139_0,,,,2,1,2,3
71141_0,,,,2,1,2,3
C(CC=C(C=O)CCO)(O)=O,,,5,1,1,0,1
71142_0,,,,2,1,2,3
71143_0,,,,2,1,2,3
71145_0,,,,2,1,2,3
C(C(CC=CCC(C=O)=O)O)=O,,,5,1,1,0,1
71146_0,,,,2,1,2,3
71147_0,,,,2,1,2,3
71149_0,,,,2,1,2,3
C(CC(C=O)=CCC(C=O)O)=O,,,5,1,1,0,1
71150_0,,,,2,1,2,3
71151_0,,,,2,1,2,3
71153_0,,,,2,1,2,3
C(CC=CCC(C=O)O)(O)=O,,,5,1,1,0,1
71154_0,,,,2,1,2,3
71155_0,,,,2,1,2,3
71156_0,,,,2,1,2,3
71157_0,,,,2,1,2,3
71158_0,,,,2,1,2,3
71159_0,,,,2,1,2,3
71160_0,,,,2,1,2,3
71161_0,,,,2,1,2,3
71163_0,,,,2,1,2,3
C(CC(C=O)=O)=C(C(C)=O)CO,,,5,1,1,0,1
71165_0,,,,2,1,2,3
C(CC(C=O)=C(C(C)=O)CO)=O,,,5,1,1,0,1
71167_0,,,,2,1,2,3
C(CC=C(C(C)=O)CO)(O)=O,,,5,1,1,0,1
71168_0,,,,2,1,2,3
71169_0,,,,2,1,2,3
71171_0,,,,2,1,2,3
C(CC=CC(C(C)=O)O)(O)=O,,,5,1,1,0,1
71173_0,,,,2,1,2,3
C(CC(C=O)=O)=CC,,,5,1,1,0,1
71175_0,,,,2,1,2,3
C=CCCC(C=O)=O,,,5,1,2,0,2
71177_0,,,,2,1,2,3
C(CC(C=O)=CC)=O,,,5,1,1,0,1
71179_0,,,,2,1,2,3
C(C(C=C)CC=O)=O,,,5,1,2,0,2
71181_0,,,,2,1,2,3
C(CC=CC)(O)=O,,,5,1,1,0,1
71183_0,,,,2,1,2,3
C(CCC=C)(O)=O,,,5,1,2,0,2
71185_0,,,,2,1,2,3
C(CC(C(C)O)=C)(O)=O,,,5,1,1,0,1
71187_0,,,,2,1,2,3
C(CC(CO)=CC)(O)=O,,,5,1,1,0,1
71189_0,,,,2,1,2,3
C(CC(C=C)CO)(O)=O,,,5,1,2,0,2
71190_0,,,,2,1,2,3
71191_0,,,,2,1,2,3
71192_0,,,,2,1,2,3
71194_0,,,,2,1,2,3
C(CC(CCO)=C)(O)=O,,,5,1,1,0,1
71195_0,,,,2,1,2,3
71197_0,,,,2,1,2,3
C(CC(CC(C(O)=O)=O)=C)(O)=O,,,5,1,1,0,1
71199_0,,,,2,1,2,3
C(C(C(O)=O)C(CC(O)=O)=C)=O,,,5,1,1,0,1
71201_0,,,,2,1,2,3
C(CC=CCC(C(O)=O)=O)(O)=O,,,5,1,1,0,1
71203_0,,,,2,1,2,3
C(CCC=CC(C(O)=O)=O)(O)=O,,,5,1,1,0,1
71205_0,,,,2,1,2,3
C(CCC(C(C(O)=O)=O)=C)(O)=O,,,5,1,1,0,1
71207_0,,,,2,1,2,3
C(CC(C=O)=CCC(O)=O)(O)=O,,,5,1,1,0,1
71208_0,,,,2,1,2,3
71209_0,,,,2,1,2,3
71211_0,,,,2,1,2,3
C(CC(C=CCC(O)=O)=O)(O)=O,,,5,1,1,0,1
71213_0,,,,2,1,2,3
C(CC=C(C(O)=O)C(C)=O)(O)=O,,,5,1,1,0,1
71215_0,,,,2,1,2,3
C(CC(CC(O)=O)=C)(O)=O,,,5,1,1,0,1
71216_0,,,,2,1,2,3
71217_0,,,,2,1,2,3
71218_0,,,,2,1,2,3
71220_0,,,,2,1,2,3
C(CC=C(C(O)=O)C(C)O)(O)=O,,,5,1,1,0,1
71221_0,,,,2,1,2,3
71223_0,,,,2,1,2,3
C(CC=C(C)C(C(O)=O)O)(O)=O,,,5,1,1,0,1
71225_0,,,,2,1,2,3
C(C(C(CCC(O)=O)=C)O)(O)=O,,,5,1,2,0,2
71227_0,,,,2,1,2,3
C(C(C=CCCC(O)=O)O)(O)=O,,,5,1,2,0,2
71229_0,,,,2,1,2,3
C(C(C=CCC(O)=O)(C)O)(O)=O,,,5,1,1,0,1
71231_0,,,,2,1,2,3
C(CCC(C(C(O)=O)=C)O)(O)=O,,,5,1,2,0,2
71233_0,,,,2,1,2,3
C(CCC=C(C(O)=O)CO)(O)=O,,,5,1,1,0,1
71235_0,,,,2,1,2,3
C(CC(C=O)=O)=C1C(COC1)=O,,,5,1,1,0,1
71237_0,,,,2,1,2,3
C(CC(C=O)=C1C(COC1)=O)=O,,,5,1,1,0,1
71239_0,,,,2,1,2,3
C(CC=C1C(COC1)=O)(O)=O,,,5,1,1,0,1
71241_0,,,,2,1,2,3
C(CC(C=O)=O)=C1C(CCO1)=O,,,5,1,1,0,1
71243_0,,,,2,1,2,3
C(CC(C=O)=C1C(CCO1)=O)=O,,,5,1,1,0,1
71245_0,,,,2,1,2,3
C(CC=C1C(CCO1)=O)(O)=O,,,5,1,1,0,1
71247_0,,,,2,1,2,3
C1COC(C=1CCC(C=O)=O)=O,,,5,1,2,0,2
71249_0,,,,2,1,2,3
C(C(C1C(OCC=1)=O)CC=O)=O,,,5,1,2,0,2
71251_0,,,,2,1,2,3
C(CCC1C(OCC=1)=O)(O)=O,,,5,1,2,0,2
71253_0,,,,2,1,2,3
C1C(CCC(C=O)=O)OC(C=1)=O,,,5,1,3,0,3
71255_0,,,,2,1,2,3
C(CC(C=O)C1C=CC(O1)=O)=O,,,5,1,3,0,3
71257_0,,,,2,1,2,3
C(CCC1C=CC(O1)=O)(O)=O,,,5,1,3,0,3
71259_0,,,,2,1,2,3
C1(CC(CO1)=CCC(C=O)=O)=O,,,5,1,1,0,1
71261_0,,,,2,1,2,3
C1(COC(C=1)=O)CCC(C=O)=O,,,5,1,2,0,2
71263_0,,,,2,1,2,3
C(CC(C=O)=C1COC(C1)=O)=O,,,5,1,1,0,1
71265_0,,,,2,1,2,3
C(C(C1COC(C=1)=O)CC=O)=O,,,5,1,2,0,2
71267_0,,,,2,1,2,3
C1(CC(CO1)=CCC(O)=O)=O,,,5,1,1,0,1
71269_0,,,,2,1,2,3
C(CCC1COC(C=1)=O)(O)=O,,,5,1,2,0,2
71271_0,,,,2,1,2,3
C1OCC(C=1CCC(C=O)=O)=O,,,5,1,1,0,1
71273_0,,,,2,1,2,3
C(C(C1C(COC=1)=O)CC=O)=O,,,5,1,1,0,1
71275_0,,,,2,1,2,3
C(CCC1C(COC=1)=O)(O)=O,,,5,1,1,0,1
71277_0,,,,2,1,2,3
C1(COC(C1)=CCC(C=O)=O)=O,,,5,1,1,0,1
71279_0,,,,2,1,2,3
C1(CCC(C=O)=O)OCC(C=1)=O,,,5,1,1,0,1
71281_0,,,,2,1,2,3
C(CC(C=O)=C1CC(CO1)=O)=O,,,5,1,1,0,1
71283_0,,,,2,1,2,3
C(C(C1OCC(C=1)=O)CC=O)=O,,,5,1,1,0,1
71285_0,,,,2,1,2,3
C(CC=C1CC(CO1)=O)(O)=O,,,5,1,1,0,1
71287_0,,,,2,1,2,3
C(CCC1OCC(C=1)=O)(O)=O,,,5,1,1,0,1
71289_0,,,,2,1,2,3
C1OC(C(C=1)=O)CCC(C=O)=O,,,5,1,2,0,2
71291_0,,,,2,1,2,3
C(CC(C=O)C1C(C=CO1)=O)=O,,,5,1,2,0,2
71293_0,,,,2,1,2,3
C(CCC1C(C=CO1)=O)(O)=O,,,5,1,2,0,2
71295_0,,,,2,1,2,3
C(CC(C=O)=O)=CC=CC(O)=O,,,5,1,1,0,1
71297_0,,,,2,1,2,3
C=CC(C(O)=O)=CCC(C=O)=O,,,5,1,1,0,1
71298_0,,,,2,1,2,3
71300_0,,,,2,1,2,3
C(CC(C=O)=O)=C1C(OCC1)=O,,,5,1,1,0,1
71301_0,,,,2,1,2,3
71302_0,,,,2,1,2,3
71304_0,,,,2,1,2,3
C(CC(C=O)=O)=C(C=O)O,,,5,1,1,0,1
71305_0,,,,2,1,2,3
71307_0,,,,2,1,2,3
C(CC(C=O)=O)=C(C=O)C,,,5,1,1,0,1
71308_0,,,,2,1,2,3
71310_0,,,,2,1,2,3
[C](C(O)=O)=CCC(C=O)=O,,,5,1,1,0,1
71311_0,,,,2,1,2,3
71312_0,,,,2,1,2,3
71313_0,,,,2,1,2,3
71314_0,,,,2,1,2,3
71315_0,,,,2,1,2,3
71316_0,,,,2,1,2,3
71318_0,,,,2,1,2,3
C(CC(C=O)=O)=C(CO)CO,,,5,1,1,0,1
71319_0,,,,2,1,2,3
71321_0,,,,2,1,2,3
C(CC(C=O)=O)=C(C(O)=O)CO,,,5,1,1,0,1
71322_0,,,,2,1,2,3
71323_0,,,,2,1,2,3
71325_0,,,,2,1,2,3
C(CC(C=O)=O)=CCC(C=O)=O,,,5,1,1,0,1
71326_0,,,,2,1,2,3
71328_0,,,,2,1,2,3
C(C(CCC(C=O)=O)=CC=O)=O,,,5,1,2,0,2
71330_0,,,,2,1,2,3
C(CC(C=O)=CCC(C=O)=O)=O,,,5,1,2,0,2
71331_0,,,,2,1,2,3
71333_0,,,,2,1,2,3
C(CC(C=CCC(C=O)=O)=O)=O,,,5,1,1,0,1
71335_0,,,,2,1,2,3
C(CC(C=O)=O)=C(C=O)C(C)=O,,,5,1,1,0,1
71337_0,,,,2,1,2,3
C=C(C(O)=O)CCC(C=O)=O,,,5,1,1,0,1
71339_0,,,,2,1,2,3
C(CC(C=O)=O)=C(C(O)=O)C,,,5,1,1,0,1
71341_0,,,,2,1,2,3
C(CCC(C=O)=O)=CC(O)=O,,,5,1,1,0,1
71342_0,,,,2,1,2,3
71344_0,,,,2,1,2,3
C(CC(C=O)=CC=CC(O)=O)=O,,,5,1,1,0,1
71346_0,,,,2,1,2,3
C(CC(C=O)=C(C(O)=O)C=C)=O,,,5,1,1,0,1
71347_0,,,,2,1,2,3
71349_0,,,,2,1,2,3
C(CC(C=O)=C1C(OCC1)=O)=O,,,5,1,1,0,1
71350_0,,,,2,1,2,3
71351_0,,,,2,1,2,3
71353_0,,,,2,1,2,3
C(CC(C=O)=C(C=O)O)=O,,,5,1,1,0,1
71354_0,,,,2,1,2,3
71356_0,,,,2,1,2,3
C(CC(C=O)=C(C=O)C)=O,,,5,1,1,0,1
71357_0,,,,2,1,2,3
71359_0,,,,2,1,2,3
[C](C(O)=O)=C(C=O)CC=O,,,5,1,1,0,1
71360_0,,,,2,1,2,3
71361_0,,,,2,1,2,3
71362_0,,,,2,1,2,3
71364_0,,,,2,1,2,3
C(CC(C=O)=C(C(O)=O)CO)=O,,,5,1,1,0,1
71365_0,,,,2,1,2,3
71366_0,,,,2,1,2,3
71367_0,,,,2,1,2,3
71368_0,,,,2,1,2,3
71370_0,,,,2,1,2,3
C(C(C(C=O)=CC=O)CC=O)=O,,,5,1,2,0,2
71372_0,,,,2,1,2,3
C(CC(C=O)=C(C=O)CC=O)=O,,,5,1,1,0,1
71373_0,,,,2,1,2,3
71375_0,,,,2,1,2,3
C(CC(C=O)=CC(CC=O)=O)=O,,,5,1,1,0,1
71377_0,,,,2,1,2,3
C(CC(C=O)=C(C=O)C(C)=O)=O,,,5,1,1,0,1
71379_0,,,,2,1,2,3
C(C(C=CC(O)=O)CC=O)=O,,,5,1,1,0,1
71381_0,,,,2,1,2,3
C(CC=CC=CC(O)=O)(O)=O,,,5,1,1,0,1
71383_0,,,,2,1,2,3
C(CC=C(C(O)=O)C=C)(O)=O,,,5,1,1,0,1
71385_0,,,,2,1,2,3
C(CC=C1C(C(CO1)O)=O)(O)=O,,,5,1,1,0,1
71386_0,,,,2,1,2,3
71387_0,,,,2,1,2,3
71389_0,,,,2,1,2,3
C(CC=C1COC(C1O)=O)(O)=O,,,5,1,1,0,1
71390_0,,,,2,1,2,3
71392_0,,,,2,1,2,3
C(CC=C1C(OCC1)=O)(O)=O,,,5,1,1,0,1
71393_0,,,,2,1,2,3
71394_0,,,,2,1,2,3
71396_0,,,,2,1,2,3
C(CC=C(C=O)O)(O)=O,,,5,1,1,0,1
71397_0,,,,2,1,2,3
71399_0,,,,2,1,2,3
C(CC=C(C=O)C)(O)=O,,,5,1,1,0,1
71400_0,,,,2,1,2,3
71402_0,,,,2,1,2,3
[C](C(O)=O)=CCC(O)=O,,,5,1,1,0,1
71403_0,,,,2,1,2,3
71404_0,,,,2,1,2,3
71405_0,,,,2,1,2,3
71407_0,,,,2,1,2,3
C(CC=CC(C(C=O)O)O)(O)=O,,,5,1,1,0,1
71409_0,,,,2,1,2,3
C(CC=C(CO)C(C=O)O)(O)=O,,,5,1,1,0,1
71410_0,,,,2,1,2,3
71412_0,,,,2,1,2,3
C(CC=CCO)(O)=O,,,5,1,1,0,1
71414_0,,,,2,1,2,3
C(CC=CC(O)=O)(O)=O,,,5,1,2,0,2
71415_0,,,,2,1,2,3
71416_0,,,,2,1,2,3
71417_0,,,,2,1,2,3
71419_0,,,,2,1,2,3
C(CC=CC(C(CO)=O)O)(O)=O,,,5,1,1,0,1
71420_0,,,,2,1,2,3
71422_0,,,,2,1,2,3
C(CC=C(CO)CO)(O)=O,,,5,1,1,0,1
71424_0,,,,2,1,2,3
C(CC=CC(CO)O)(O)=O,,,5,1,1,0,1
71426_0,,,,2,1,2,3
C(CC=C(CO)C(CO)O)(O)=O,,,5,1,1,0,1
71428_0,,,,2,1,2,3
C(CC=CC(C(CO)O)O)(O)=O,,,5,1,1,0,1
71430_0,,,,2,1,2,3
C(CC=C(C(O)=O)CO)(O)=O,,,5,1,1,0,1
71432_0,,,,2,1,2,3
C(CC=CC(C(O)=O)O)(O)=O,,,5,1,1,0,1
71434_0,,,,2,1,2,3
C(C(C=CCC(O)=O)(CO)O)=O,,,5,1,1,0,1
71435_0,,,,2,1,2,3
71437_0,,,,2,1,2,3
C(CC=CCC(C=O)=O)(O)=O,,,5,1,1,0,1
71438_0,,,,2,1,2,3
71440_0,,,,2,1,2,3
C(CCC(C=O)=CC=O)(O)=O,,,5,1,2,0,2
71442_0,,,,2,1,2,3
C(CC(C=O)=CCC(O)=O)=O,,,5,1,1,0,1
71443_0,,,,2,1,2,3
71445_0,,,,2,1,2,3
C(CC(C=CCC(O)=O)=O)=O,,,5,1,1,0,1
71447_0,,,,2,1,2,3
C(CC=C(C=O)C(C)=O)(O)=O,,,5,1,1,0,1
71449_0,,,,2,1,2,3
C(CC=C1C(O)OCC1O)(O)=O,,,5,1,1,0,1
71451_0,,,,2,1,2,3
C(CC=C1C(C(CO1)O)O)(O)=O,,,5,1,1,0,1
71453_0,,,,2,1,2,3
C(CC=C1COC(C1O)O)(O)=O,,,5,1,1,0,1
71455_0,,,,2,1,2,3
C(CCC(C(O)=O)=C)(O)=O,,,5,1,1,0,1
71457_0,,,,2,1,2,3
C(CC=C(C(O)=O)C)(O)=O,,,5,1,1,0,1
71459_0,,,,2,1,2,3
C(CCC=CC(O)=O)(O)=O,,,5,1,1,0,1
71461_0,,,,2,1,2,3
C(CCC(C(O)=O)=CCO)(O)=O,,,5,1,1,0,1
71462_0,,,,2,1,2,3
71464_0,,,,2,1,2,3
C(CC=C(C(O)=O)CCO)(O)=O,,,5,1,1,0,1
71465_0,,,,2,1,2,3
71466_0,,,,2,1,2,3
71468_0,,,,2,1,2,3
C(CC=CCC(C(O)=O)O)(O)=O,,,5,1,1,0,1
71470_0,,,,2,1,2,3
C(CCC(CO)=CC(O)=O)(O)=O,,,5,1,1,0,1
71471_0,,,,2,1,2,3
71472_0,,,,2,1,2,3
71474_0,,,,2,1,2,3
C(CC=CC(C(C=O)=O)O)(O)=O,,,5,1,1,0,1
71475_0,,,,2,1,2,3
71476_0,,,,2,1,2,3
71478_0,,,,2,1,2,3
C(CC(CO)=C(C=O)O)(O)=O,,,5,1,1,0,1
71480_0,,,,2,1,2,3
C(CC(C(C=O)(O)O)=C)(O)=O,,,5,1,1,0,1
71481_0,,,,2,1,2,3
71483_0,,,,2,1,2,3
C(CC(CO)=C(C=O)C)(O)=O,,,5,1,1,0,1
71485_0,,,,2,1,2,3
C(C(C(CC(O)=O)=C)(C)O)=O,,,5,1,1,0,1
71486_0,,,,2,1,2,3
71488_0,,,,2,1,2,3
C(CC(CC(C=O)O)=C)(O)=O,,,5,1,1,0,1
71490_0,,,,2,1,2,3
[C](C(O)=O)=C(CO)CC(O)=O,,,5,1,1,0,1
71492_0,,,,2,1,2,3
C(CC([C](C(O)=O)O)=C)(O)=O,,,5,1,1,0,1
71493_0,,,,2,1,2,3
71495_0,,,,2,1,2,3
C(C(C(CC(O)=O)=C)(CO)O)=O,,,5,1,1,0,1
71497_0,,,,2,1,2,3
C(CC(CO)=CC(C=O)O)(O)=O,,,5,1,1,0,1
71499_0,,,,2,1,2,3
C(CC(C(C(C=O)O)O)=C)(O)=O,,,5,1,1,0,1
71501_0,,,,2,1,2,3
C(CC(CO)=C)(O)=O,,,5,1,1,0,1
71503_0,,,,2,1,2,3
C(CC(CO)=CCO)(O)=O,,,5,1,1,0,1
71505_0,,,,2,1,2,3
C(CC(C(CO)O)=C)(O)=O,,,5,1,1,0,1
71507_0,,,,2,1,2,3
C(CC(CO)=CC(O)=O)(O)=O,,,5,1,1,0,1
71509_0,,,,2,1,2,3
C(CC(C(C(O)=O)O)=C)(O)=O,,,5,1,1,0,1
71510_0,,,,2,1,2,3
71512_0,,,,2,1,2,3
C(CC(C(C(CO)=O)O)=C)(O)=O,,,5,1,1,0,1
71514_0,,,,2,1,2,3
C(CC(CO)=C(CO)CO)(O)=O,,,5,1,1,0,1
71516_0,,,,2,1,2,3
C(CC(C(CO)(CO)O)=C)(O)=O,,,5,1,1,0,1
71518_0,,,,2,1,2,3
C(CC(CO)=CC(CO)O)(O)=O,,,5,1,1,0,1
71520_0,,,,2,1,2,3
C(CC(C(C(CO)O)O)=C)(O)=O,,,5,1,1,0,1
71522_0,,,,2,1,2,3
C(CC(CC(C=O)=O)=C)(O)=O,,,5,1,1,0,1
71524_0,,,,2,1,2,3
C(C(C=O)C(CC(O)=O)=C)=O,,,5,1,1,0,1
71526_0,,,,2,1,2,3
C(CC(CC(O)=O)=C)=O,,,5,1,1,0,1
71528_0,,,,2,1,2,3
C(CC(C(C(O)=O)=C)CO)(O)=O,,,5,1,1,0,1
71530_0,,,,2,1,2,3
C(CC(CO)=C(C(O)=O)C)(O)=O,,,5,1,1,0,1
71532_0,,,,2,1,2,3
C(C(C(CC(O)=O)=C)(C)O)(O)=O,,,5,1,1,0,1
71534_0,,,,2,1,2,3
C(CC(C=CC(O)=O)CO)(O)=O,,,5,1,1,0,1
71536_0,,,,2,1,2,3
C(CC(CC(C(O)=O)O)=C)(O)=O,,,5,1,1,0,1
71537_0,,,,2,1,2,3
71539_0,,,,2,1,2,3
C(CC(C(C(C=O)=O)O)=C)(O)=O,,,5,1,1,0,1
71540_0,,,,2,1,2,3
71541_0,,,,2,1,2,3
71542_0,,,,2,1,2,3
71543_0,,,,2,1,2,3
71544_0,,,,2,1,2,3
71546_0,,,,2,1,2,3
C(C(C=C)(C(C(O)=O)=O)O)(O)=O,,,5,1,2,0,2
71547_0,,,,2,1,2,3
71548_0,,,,2,1,2,3
71549_0,,,,2,1,2,3
71550_0,,,,2,1,2,3
71551_0,,,,2,1,2,3
71552_0,,,,2,1,2,3
71553_0,,,,2,1,2,3
71554_0,,,,2,1,2,3
71555_0,,,,2,1,2,3
71556_0,,,,2,1,2,3
71557_0,,,,2,1,2,3
71559_0,,,,2,1,2,3
C(C(C=C(CO)CO)O)=O,,,5,1,2,0,2
71560_0,,,,2,1,2,3
71562_0,,,,2,1,2,3
C(C(C=C(CO)C(CO)O)O)=O,,,5,1,2,0,2
71563_0,,,,2,1,2,3
71565_0,,,,2,1,2,3
C(C(C=C(C=O)C)O)=O,,,5,1,2,0,2
71567_0,,,,2,1,2,3
C(C(CC(C=O)=C)O)=O,,,5,1,2,0,2
71568_0,,,,2,1,2,3
71570_0,,,,2,1,2,3
C(C(C=CC(C)=O)O)=O,,,5,1,2,0,2
71572_0,,,,2,1,2,3
C(C(CC(C=O)=CCO)O)=O,,,5,1,2,0,2
71573_0,,,,2,1,2,3
71575_0,,,,2,1,2,3
C(C(C=C(C=O)CCO)O)=O,,,5,1,2,0,2
71576_0,,,,2,1,2,3
71577_0,,,,2,1,2,3
71579_0,,,,2,1,2,3
C(C(C=CC(CCO)=O)O)=O,,,5,1,2,0,2
71580_0,,,,2,1,2,3
71581_0,,,,2,1,2,3
71582_0,,,,2,1,2,3
71583_0,,,,2,1,2,3
71584_0,,,,2,1,2,3
71586_0,,,,2,1,2,3
C(C(C=CCC(C=O)O)O)=O,,,5,1,3,0,3
71588_0,,,,2,1,2,3
C(C(C(CC(C=O)O)=C)O)=O,,,5,1,2,0,2
71590_0,,,,2,1,2,3
C(C(C=C(C)C(C=O)O)O)=O,,,5,1,2,0,2
71591_0,,,,2,1,2,3
71593_0,,,,2,1,2,3
C(C(CC=C)O)=O,,,5,1,2,0,2
71595_0,,,,2,1,2,3
C(C(C=CC)O)=O,,,5,1,2,0,2
71596_0,,,,2,1,2,3
71597_0,,,,2,1,2,3
71598_0,,,,2,1,2,3
71599_0,,,,2,1,2,3
71600_0,,,,2,1,2,3
71601_0,,,,2,1,2,3
71602_0,,,,2,1,2,3
71604_0,,,,2,1,2,3
[C](C(O)=O)=C,,,5,1,1,0,1
71606_0,,,,2,1,2,3
[C](C(O)=O)=CCO,,,5,1,1,0,1
71607_0,,,,2,1,2,3
71609_0,,,,2,1,2,3
[C](C(O)=O)=CC(CO)O,,,5,1,1,0,1
71610_0,,,,2,1,2,3
71612_0,,,,2,1,2,3
[C](C(O)=O)=CC(C(CO)O)O,,,5,1,1,0,1
71613_0,,,,2,1,2,3
71615_0,,,,2,1,2,3
[C](C(O)=O)=CC=O,,,5,1,1,0,1
71616_0,,,,2,2,1,3
71617_0,,,,2,2,1,3
71618_0,,,,2,2,1,3
71619_0,,,,2,2,1,3
71620_0,,,,2,2,1,3
71621_0,,,,2,2,1,3
71622_0,,,,2,2,1,3
71623_0,,,,2,2,1,3
71624_0,,,,2,2,1,3
71625_0,,,,2,2,1,3
71626_0,,,,2,2,1,3
71627_0,,,,2,2,1,3
71628_0,,,,2,2,1,3
71629_0,,,,2,2,1,3
71630_0,,,,2,2,1,3
71632_0,,,,2,2,1,3
C(C(C1C(C(C(C1O)O)O)O)O)=O,,,5,1,2,0,2
71633_0,,,,2,2,1,3
71634_0,,,,2,2,1,3
71635_0,,,,2,2,1,3
71636_0,,,,2,2,1,3
71637_0,,,,2,2,1,3
71638_0,,,,2,2,1,3
71639_0,,,,2,2,1,3
71640_0,,,,2,2,1,3
71641_0,,,,2,2,1,3
71643_0,,,,2,2,1,3
C1C(C(C(C1O)O)O)O,,,5,1,1,0,1
71644_0,,,,2,2,1,3
71645_0,,,,2,2,1,3
71647_0,,,,2,2,1,3
C1(C(C(C(C1O)O)O)O)O,,,5,1,1,0,1
71648_0,,,,2,2,1,3
71649_0,,,,2,2,1,3
71650_0,,,,2,2,1,3
71651_0,,,,2,2,1,3
71652_0,,,,2,2,1,3
71653_0,,,,2,2,1,3
71654_0,,,,2,2,1,3
71655_0,,,,2,2,1,3
71656_0,,,,2,2,1,3
71657_0,,,,2,2,1,3
71658_0,,,,2,2,1,3
71659_0,,,,2,2,1,3
71660_0,,,,2,2,1,3
71661_0,,,,2,2,1,3
71662_0,,,,2,2,1,3
71663_0,,,,2,2,1,3
71665_0,,,,2,2,1,3
C1C(C(C(C(C1O)O)O)O)O,,,5,1,1,0,1
71667_0,,,,2,2,1,3
C1(C(C(C(C(C1O)O)O)O)O)O,,,5,1,1,0,1
71668_0,,,,2,2,1,3
71669_0,,,,2,2,1,3
71670_0,,,,2,2,1,3
71671_0,,,,2,2,1,3
71672_0,,,,2,2,1,3
71673_0,,,,2,2,1,3
71674_0,,,,2,2,1,3
71675_0,,,,2,2,1,3
71676_0,,,,2,2,1,3
71677_0,,,,2,2,1,3
71678_0,,,,2,2,1,3
71679_0,,,,2,2,1,3
71680_0,,,,2,2,1,3
71681_0,,,,2,2,1,3
71682_0,,,,2,2,1,3
71683_0,,,,2,2,1,3
71684_0,,,,2,2,1,3
71685_0,,,,2,2,1,3
71686_0,,,,2,2,1,3
71687_0,,,,2,2,1,3
71688_0,,,,2,2,1,3
71689_0,,,,2,2,1,3
71690_0,,,,2,2,1,3
71691_0,,,,2,2,1,3
71692_0,,,,2,2,1,3
71693_0,,,,2,2,1,3
71694_0,,,,2,2,1,3
71695_0,,,,2,2,1,3
71696_0,,,,2,2,1,3
71697_0,,,,2,2,1,3
71698_0,,,,2,2,1,3
71699_0,,,,2,2,1,3
71700_0,,,,2,2,1,3
71701_0,,,,2,2,1,3
71702_0,,,,2,2,1,3
71703_0,,,,2,2,1,3
71704_0,,,,2,2,1,3
71705_0,,,,2,2,1,3
71706_0,,,,2,2,1,3
71707_0,,,,2,2,1,3
71708_0,,,,2,2,1,3
71709_0,,,,2,2,1,3
71710_0,,,,2,2,1,3
71711_0,,,,2,2,1,3
71712_0,,,,2,2,1,3
71713_0,,,,2,2,1,3
71714_0,,,,2,2,1,3
71715_0,,,,2,2,1,3
71716_0,,,,2,2,1,3
71717_0,,,,2,2,1,3
71718_0,,,,2,2,1,3
71719_0,,,,2,2,1,3
71720_0,,,,2,2,1,3
71721_0,,,,2,2,1,3
71722_0,,,,2,2,1,3
71723_0,,,,2,2,1,3
71724_0,,,,2,2,1,3
71725_0,,,,2,2,1,3
71726_0,,,,2,2,1,3
71727_0,,,,2,2,1,3
71728_0,,,,2,2,1,3
71729_0,,,,2,2,1,3
71730_0,,,,2,2,1,3
71731_0,,,,2,2,1,3
71732_0,,,,2,2,1,3
71733_0,,,,2,2,1,3
71734_0,,,,2,2,1,3
71735_0,,,,2,2,1,3
71736_0,,,,2,2,1,3
71737_0,,,,2,2,1,3
71738_0,,,,2,2,1,3
71739_0,,,,2,2,1,3
71740_0,,,,2,2,1,3
71741_0,,,,2,2,1,3
71742_0,,,,2,2,1,3
71743_0,,,,2,2,1,3
71744_0,,,,2,2,1,3
71745_0,,,,2,2,1,3
71746_0,,,,2,2,1,3
71747_0,,,,2,2,1,3
71748_0,,,,2,2,1,3
71749_0,,,,2,2,1,3
71750_0,,,,2,2,1,3
71751_0,,,,2,2,1,3
71752_0,,,,2,2,1,3
71753_0,,,,2,2,1,3
71754_0,,,,2,2,1,3
71755_0,,,,2,2,1,3
71756_0,,,,2,2,1,3
71757_0,,,,2,2,1,3
71758_0,,,,2,2,1,3
71759_0,,,,2,2,1,3
71760_0,,,,2,2,1,3
71761_0,,,,2,2,1,3
71762_0,,,,2,2,1,3
71763_0,,,,2,2,1,3
71764_0,,,,2,2,1,3
71765_0,,,,2,2,1,3
71766_0,,,,2,2,1,3
71767_0,,,,2,2,1,3
71768_0,,,,2,2,1,3
71769_0,,,,2,2,1,3
71770_0,,,,2,2,1,3
71771_0,,,,2,2,1,3
71772_0,,,,2,2,1,3
71773_0,,,,2,2,1,3
71774_0,,,,2,2,1,3
71775_0,,,,2,2,1,3
71776_0,,,,2,2,1,3
71777_0,,,,2,2,1,3
71778_0,,,,2,2,1,3
71779_0,,,,2,2,1,3
71780_0,,,,2,2,1,3
71781_0,,,,2,2,1,3
71782_0,,,,2,2,1,3
71783_0,,,,2,2,1,3
71784_0,,,,2,2,1,3
71785_0,,,,2,2,1,3
71786_0,,,,2,2,1,3
71787_0,,,,2,2,1,3
71788_0,,,,2,2,1,3
71789_0,,,,2,2,1,3
71790_0,,,,2,2,1,3
71792_0,,,,2,2,1,3
CC(CC(C(C(CO)O)O)O)O,,,5,1,2,0,2
71793_0,,,,2,2,1,3
71794_0,,,,2,2,1,3
71795_0,,,,2,2,1,3
71796_0,,,,2,2,1,3
71797_0,,,,2,2,1,3
71798_0,,,,2,2,1,3
71799_0,,,,2,2,1,3
71800_0,,,,2,2,1,3
71801_0,,,,2,2,1,3
71802_0,,,,2,2,1,3
71803_0,,,,2,2,1,3
71804_0,,,,2,2,1,3
71805_0,,,,2,2,1,3
71806_0,,,,2,2,1,3
71807_0,,,,2,2,1,3
71808_0,,,,2,2,1,3
71809_0,,,,2,2,1,3
71810_0,,,,2,2,1,3
71811_0,,,,2,2,1,3
71812_0,,,,2,2,1,3
71813_0,,,,2,2,1,3
71814_0,,,,2,2,1,3
71815_0,,,,2,2,1,3
71816_0,,,,2,2,1,3
71817_0,,,,2,2,1,3
71819_0,,,,2,2,1,3
CC(C(C(C(C(CO)O)O)O)O)O,,,5,1,4,0,4
71820_0,,,,2,2,1,3
71821_0,,,,2,2,1,3
71822_0,,,,2,2,1,3
71823_0,,,,2,2,1,3
71824_0,,,,2,2,1,3
71825_0,,,,2,2,1,3
71826_0,,,,2,2,1,3
71827_0,,,,2,2,1,3
71828_0,,,,2,2,1,3
71829_0,,,,2,2,1,3
71830_0,,,,2,2,1,3
71831_0,,,,2,2,1,3
71832_0,,,,2,2,1,3
71833_0,,,,2,2,1,3
71834_0,,,,2,2,1,3
71835_0,,,,2,2,1,3
71836_0,,,,2,2,1,3
71837_0,,,,2,2,1,3
71838_0,,,,2,2,1,3
71839_0,,,,2,2,1,3
71840_0,,,,2,2,1,3
71841_0,,,,2,2,1,3
71842_0,,,,2,2,1,3
71843_0,,,,2,2,1,3
71844_0,,,,2,2,1,3
71845_0,,,,2,2,1,3
71846_0,,,,2,2,1,3
71847_0,,,,2,2,1,3
71848_0,,,,2,2,1,3
71849_0,,,,2,2,1,3
71850_0,,,,2,2,1,3
71852_0,,,,2,2,1,3
C(CC(C1C(C(C(O)O1)O)O)O)O,,,5,1,1,0,1
71853_0,,,,2,2,1,3
71854_0,,,,2,2,1,3
71855_0,,,,2,2,1,3
71856_0,,,,2,2,1,3
71857_0,,,,2,2,1,3
71858_0,,,,2,2,1,3
71859_0,,,,2,2,1,3
71860_0,,,,2,2,1,3
71861_0,,,,2,2,1,3
71862_0,,,,2,2,1,3
71863_0,,,,2,2,1,3
71864_0,,,,2,2,1,3
71865_0,,,,2,2,1,3
71866_0,,,,2,2,1,3
71867_0,,,,2,2,1,3
71868_0,,,,2,2,1,3
71869_0,,,,2,2,1,3
71870_0,,,,2,2,1,3
71871_0,,,,2,2,1,3
71872_0,,,,2,2,1,3
71873_0,,,,2,2,1,3
71874_0,,,,2,2,1,3
71875_0,,,,2,2,1,3
71876_0,,,,2,2,1,3
71877_0,,,,2,2,1,3
71878_0,,,,2,2,1,3
71879_0,,,,2,2,1,3
71880_0,,,,2,2,1,3
71881_0,,,,2,2,1,3
71882_0,,,,2,2,1,3
71883_0,,,,2,2,1,3
71884_0,,,,2,2,1,3
71885_0,,,,2,2,1,3
71886_0,,,,2,2,1,3
71887_0,,,,2,2,1,3
71888_0,,,,2,2,1,3
71889_0,,,,2,2,1,3
71890_0,,,,2,2,1,3
71891_0,,,,2,2,1,3
71892_0,,,,2,2,1,3
71893_0,,,,2,2,1,3
71894_0,,,,2,2,1,3
71895_0,,,,2,2,1,3
71896_0,,,,2,2,1,3
71897_0,,,,2,2,1,3
71898_0,,,,2,2,1,3
71899_0,,,,2,2,1,3
71900_0,,,,2,2,1,3
71901_0,,,,2,2,1,3
71902_0,,,,2,2,1,3
71903_0,,,,2,2,1,3
71904_0,,,,2,2,1,3
71905_0,,,,2,2,1,3
71906_0,,,,2,2,1,3
71907_0,,,,2,2,1,3
71908_0,,,,2,2,1,3
71909_0,,,,2,2,1,3
71910_0,,,,2,2,1,3
71911_0,,,,2,2,1,3
71912_0,,,,2,2,1,3
71913_0,,,,2,2,1,3
71914_0,,,,2,2,1,3
71915_0,,,,2,2,1,3
71916_0,,,,2,2,1,3
71917_0,,,,2,2,1,3
71918_0,,,,2,2,1,3
71919_0,,,,2,2,1,3
71920_0,,,,2,2,1,3
71921_0,,,,2,2,1,3
71922_0,,,,2,2,1,3
71923_0,,,,2,2,1,3
71924_0,,,,2,2,1,3
71925_0,,,,2,2,1,3
71926_0,,,,2,2,1,3
71927_0,,,,2,2,1,3
71928_0,,,,2,2,1,3
71929_0,,,,2,2,1,3
71930_0,,,,2,2,1,3
71931_0,,,,2,2,1,3
71932_0,,,,2,2,1,3
71933_0,,,,2,2,1,3
71934_0,,,,2,2,1,3
71935_0,,,,2,2,1,3
71936_0,,,,2,2,1,3
71937_0,,,,2,2,1,3
71938_0,,,,2,2,1,3
71939_0,,,,2,2,1,3
71940_0,,,,2,2,1,3
71941_0,,,,2,2,1,3
71942_0,,,,2,2,1,3
71943_0,,,,2,2,1,3
71944_0,,,,2,2,1,3
71945_0,,,,2,2,1,3
71946_0,,,,2,2,1,3
71947_0,,,,2,2,1,3
71948_0,,,,2,2,1,3
71949_0,,,,2,2,1,3
71950_0,,,,2,2,1,3
71951_0,,,,2,2,1,3
71952_0,,,,2,2,1,3
71953_0,,,,2,2,1,3
71954_0,,,,2,2,1,3
71955_0,,,,2,2,1,3
71956_0,,,,2,2,1,3
71957_0,,,,2,2,1,3
71958_0,,,,2,2,1,3
71959_0,,,,2,2,1,3
71960_0,,,,2,2,1,3
71961_0,,,,2,2,1,3
71962_0,,,,2,2,1,3
71963_0,,,,2,2,1,3
71964_0,,,,2,2,1,3
71965_0,,,,2,2,1,3
71966_0,,,,2,2,1,3
71967_0,,,,2,2,1,3
71968_0,,,,2,2,1,3
71969_0,,,,2,2,1,3
71970_0,,,,2,2,1,3
71971_0,,,,2,2,1,3
71972_0,,,,2,2,1,3
71973_0,,,,2,2,1,3
71975_0,,,,2,2,1,3
C1C(C(C(O)O1)O)(C(C)(CO)O)O,,,5,1,1,0,1
71976_0,,,,2,2,1,3
71978_0,,,,2,2,1,3
CC(CO)(C1C(C(C(O)O1)O)O)O,,,5,1,1,0,1
71979_0,,,,2,2,1,3
71980_0,,,,2,2,1,3
71981_0,,,,2,2,1,3
71982_0,,,,2,2,1,3
71983_0,,,,2,2,1,3
71984_0,,,,2,2,1,3
71985_0,,,,2,2,1,3
71986_0,,,,2,2,1,3
71987_0,,,,2,2,1,3
71988_0,,,,2,2,1,3
71989_0,,,,2,2,1,3
71990_0,,,,2,2,1,3
71991_0,,,,2,2,1,3
71993_0,,,,2,2,1,3
CC(C(CO)O)(C(C(CO)O)O)O,,,5,1,2,0,2
71994_0,,,,2,2,1,3
71996_0,,,,2,2,1,3
C1C(C(CO1)O)(C(C(CO)O)O)O,,,5,1,2,0,2
71998_0,,,,2,2,1,3
C1CC(C(O)O1)(C(C(CO)O)O)O,,,5,1,3,0,3
72000_0,,,,2,2,1,3
C1C(CC(O)O1)(C(C(CO)O)O)O,,,5,1,3,0,3
72001_0,,,,2,2,1,3
72002_0,,,,2,2,1,3
72003_0,,,,2,2,1,3
72004_0,,,,2,2,1,3
72006_0,,,,2,2,1,3
C(C(C(C(C(O)O)O)O)O)O,,,5,1,2,0,2
72007_0,,,,2,2,1,3
72008_0,,,,2,2,1,3
72009_0,,,,2,2,1,3
72010_0,,,,2,2,1,3
72011_0,,,,2,2,1,3
72012_0,,,,2,2,1,3
72013_0,,,,2,2,1,3
72014_0,,,,2,2,1,3
72015_0,,,,2,2,1,3
72016_0,,,,2,2,1,3
72017_0,,,,2,2,1,3
72018_0,,,,2,2,1,3
72019_0,,,,2,2,1,3
72020_0,,,,2,2,1,3
72021_0,,,,2,2,1,3
72022_0,,,,2,2,1,3
72023_0,,,,2,2,1,3
72024_0,,,,2,2,1,3
72025_0,,,,2,2,1,3
72026_0,,,,2,2,1,3
72027_0,,,,2,2,1,3
72028_0,,,,2,2,1,3
72029_0,,,,2,2,1,3
72030_0,,,,2,2,1,3
72031_0,,,,2,2,1,3
72032_0,,,,2,2,1,3
72033_0,,,,2,2,1,3
72034_0,,,,2,2,1,3
72035_0,,,,2,2,1,3
72036_0,,,,2,2,1,3
72037_0,,,,2,2,1,3
72038_0,,,,2,2,1,3
72039_0,,,,2,2,1,3
72040_0,,,,2,2,1,3
72041_0,,,,2,2,1,3
72042_0,,,,2,2,1,3
72043_0,,,,2,2,1,3
72044_0,,,,2,2,1,3
72045_0,,,,2,2,1,3
72046_0,,,,2,2,1,3
72047_0,,,,2,2,1,3
72048_0,,,,2,2,1,3
72049_0,,,,2,2,1,3
72050_0,,,,2,2,1,3
72051_0,,,,2,2,1,3
72052_0,,,,2,2,1,3
72053_0,,,,2,2,1,3
72054_0,,,,2,2,1,3
72055_0,,,,2,2,1,3
72056_0,,,,2,2,1,3
72057_0,,,,2,2,1,3
72058_0,,,,2,2,1,3
72059_0,,,,2,2,1,3
72060_0,,,,2,2,1,3
72061_0,,,,2,2,1,3
72062_0,,,,2,2,1,3
72063_0,,,,2,2,1,3
72064_0,,,,2,2,1,3
72065_0,,,,2,2,1,3
72066_0,,,,2,2,1,3
72067_0,,,,2,2,1,3
72068_0,,,,2,2,1,3
72070_0,,,,2,2,1,3
C(C(C(C(C(C(O)O)O)O)O)O)O,,,5,1,2,0,2
72071_0,,,,2,2,1,3
72072_0,,,,2,2,1,3
72073_0,,,,2,2,1,3
72074_0,,,,2,2,1,3
72075_0,,,,2,2,1,3
72076_0,,,,2,2,1,3
72077_0,,,,2,2,1,3
72078_0,,,,2,2,1,3
72079_0,,,,2,2,1,3
72080_0,,,,2,2,1,3
72081_0,,,,2,2,1,3
72082_0,,,,2,2,1,3
72083_0,,,,2,2,1,3
72084_0,,,,2,2,1,3
72085_0,,,,2,2,1,3
72086_0,,,,2,2,1,3
72087_0,,,,2,2,1,3
72088_0,,,,2,2,1,3
72089_0,,,,2,2,1,3
72090_0,,,,2,2,1,3
72091_0,,,,2,2,1,3
72092_0,,,,2,2,1,3
72093_0,,,,2,2,1,3
72094_0,,,,2,2,1,3
72095_0,,,,2,2,1,3
72096_0,,,,2,2,1,3
72097_0,,,,2,2,1,3
72098_0,,,,2,2,1,3
72099_0,,,,2,2,1,3
72100_0,,,,2,2,1,3
72101_0,,,,2,2,1,3
72102_0,,,,2,2,1,3
72103_0,,,,2,2,1,3
72104_0,,,,2,2,1,3
72105_0,,,,2,2,1,3
72106_0,,,,2,2,1,3
72107_0,,,,2,2,1,3
72108_0,,,,2,2,1,3
72109_0,,,,2,2,1,3
72110_0,,,,2,2,1,3
72111_0,,,,2,2,1,3
72112_0,,,,2,2,1,3
72113_0,,,,2,2,1,3
72114_0,,,,2,2,1,3
72115_0,,,,2,2,1,3
72116_0,,,,2,2,1,3
72117_0,,,,2,2,1,3
72118_0,,,,2,2,1,3
72119_0,,,,2,2,1,3
72120_0,,,,2,2,1,3
72121_0,,,,2,2,1,3
72122_0,,,,2,2,1,3
72123_0,,,,2,2,1,3
72124_0,,,,2,2,1,3
72125_0,,,,2,2,1,3
72126_0,,,,2,2,1,3
72127_0,,,,2,2,1,3
72128_0,,,,2,2,1,3
72129_0,,,,2,2,1,3
72130_0,,,,2,2,1,3
72131_0,,,,2,2,1,3
72132_0,,,,2,2,1,3
72133_0,,,,2,2,1,3
72134_0,,,,2,2,1,3
72135_0,,,,2,2,1,3
72136_0,,,,2,2,1,3
72137_0,,,,2,2,1,3
72138_0,,,,2,2,1,3
72139_0,,,,2,2,1,3
72140_0,,,,2,2,1,3
72141_0,,,,2,2,1,3
72142_0,,,,2,2,1,3
72143_0,,,,2,2,1,3
72144_0,,,,2,2,1,3
72145_0,,,,2,2,1,3
72146_0,,,,2,2,1,3
72147_0,,,,2,2,1,3
72148_0,,,,2,2,1,3
72149_0,,,,2,2,1,3
72150_0,,,,2,2,1,3
72151_0,,,,2,2,1,3
72152_0,,,,2,2,1,3
72153_0,,,,2,2,1,3
72154_0,,,,2,2,1,3
72155_0,,,,2,2,1,3
72156_0,,,,2,2,1,3
72157_0,,,,2,2,1,3
72158_0,,,,2,2,1,3
72159_0,,,,2,2,1,3
72160_0,,,,2,2,1,3
72161_0,,,,2,2,1,3
72162_0,,,,2,2,1,3
72163_0,,,,2,2,1,3
72164_0,,,,2,2,1,3
72165_0,,,,2,2,1,3
72166_0,,,,2,2,1,3
72167_0,,,,2,2,1,3
72168_0,,,,2,2,1,3
72169_0,,,,2,2,1,3
72170_0,,,,2,2,1,3
72171_0,,,,2,2,1,3
72172_0,,,,2,2,1,3
72173_0,,,,2,2,1,3
72174_0,,,,2,2,1,3
72175_0,,,,2,2,1,3
72176_0,,,,2,2,1,3
72177_0,,,,2,2,1,3
72178_0,,,,2,2,1,3
72179_0,,,,2,2,1,3
72180_0,,,,2,2,1,3
72181_0,,,,2,2,1,3
72182_0,,,,2,2,1,3
72183_0,,,,2,2,1,3
72184_0,,,,2,2,1,3
72185_0,,,,2,2,1,3
72186_0,,,,2,2,1,3
72187_0,,,,2,2,1,3
72188_0,,,,2,2,1,3
72189_0,,,,2,2,1,3
72190_0,,,,2,2,1,3
72191_0,,,,2,2,1,3
72192_0,,,,2,2,1,3
72193_0,,,,2,2,1,3
72194_0,,,,2,2,1,3
72195_0,,,,2,2,1,3
72196_0,,,,2,2,1,3
72197_0,,,,2,2,1,3
72198_0,,,,2,2,1,3
72199_0,,,,2,2,1,3
72200_0,,,,2,2,1,3
72201_0,,,,2,2,1,3
72202_0,,,,2,2,1,3
72203_0,,,,2,2,1,3
72204_0,,,,2,2,1,3
72205_0,,,,2,2,1,3
72206_0,,,,2,2,1,3
72207_0,,,,2,2,1,3
72208_0,,,,2,2,1,3
72209_0,,,,2,2,1,3
72210_0,,,,2,2,1,3
72211_0,,,,2,2,1,3
72212_0,,,,2,2,1,3
72213_0,,,,2,2,1,3
72214_0,,,,2,2,1,3
72215_0,,,,2,2,1,3
72216_0,,,,2,2,1,3
72217_0,,,,2,2,1,3
72218_0,,,,2,2,1,3
72219_0,,,,2,2,1,3
72220_0,,,,2,2,1,3
72221_0,,,,2,2,1,3
72222_0,,,,2,2,1,3
72223_0,,,,2,2,1,3
72224_0,,,,2,2,1,3
72225_0,,,,2,2,1,3
72226_0,,,,2,2,1,3
72227_0,,,,2,2,1,3
72228_0,,,,2,2,1,3
72229_0,,,,2,2,1,3
72230_0,,,,2,2,1,3
72231_0,,,,2,2,1,3
72232_0,,,,2,2,1,3
72233_0,,,,2,2,1,3
72235_0,,,,2,2,1,3
C1C(C(C(O)O)O)(C(C(O)O1)O)O,,,5,1,1,0,1
72237_0,,,,2,2,1,3
C1C(C(C(O)O1)O)(C(C(C)O)O)O,,,5,1,2,0,2
72238_0,,,,2,2,1,3
72239_0,,,,2,2,1,3
72240_0,,,,2,2,1,3
72241_0,,,,2,2,1,3
72242_0,,,,2,2,1,3
72243_0,,,,2,2,1,3
72244_0,,,,2,2,1,3
72246_0,,,,2,2,1,3
C1C(C(C)O)(C(C(O)O1)O)O,,,5,1,2,0,2
72247_0,,,,2,2,1,3
72248_0,,,,2,2,1,3
72249_0,,,,2,2,1,3
72250_0,,,,2,2,1,3
72251_0,,,,2,2,1,3
72253_0,,,,2,2,1,3
C(C1(C(O)OCC1O)O)(O)=O,,,5,1,2,0,2
72255_0,,,,2,2,1,3
C1C(C(C(O)O1)(C(C(O)O)O)O)O,,,5,1,2,0,2
72257_0,,,,2,2,1,3
C1C(C(C(O)O1)(C(C(C)O)O)O)O,,,5,1,2,0,2
72258_0,,,,2,2,1,3
72259_0,,,,2,2,1,3
72260_0,,,,2,2,1,3
72261_0,,,,2,2,1,3
72262_0,,,,2,2,1,3
72263_0,,,,2,2,1,3
72264_0,,,,2,2,1,3
72265_0,,,,2,2,1,3
72266_0,,,,2,2,1,3
72267_0,,,,2,2,1,3
72269_0,,,,2,2,1,3
C(C1C(C(C(O1)O)O)O)(O)=O,,,5,1,3,0,3
72271_0,,,,2,2,1,3
C1(C(C(C(C(C(O)O)O)O1)O)O)O,,,5,1,1,0,1
72273_0,,,,2,2,1,3
CC(C(C1C(C(C(O)O1)O)O)O)O,,,5,1,1,0,1
72274_0,,,,2,2,1,3
72275_0,,,,2,2,1,3
72277_0,,,,2,2,1,3
C(C(C)(C1C(C(C(O)O1)O)O)O)=O,,,5,1,2,0,2
72278_0,,,,2,2,1,3
72280_0,,,,2,2,1,3
C(C)(C(C1C(C(C(O)O1)O)O)O)=O,,,5,1,3,0,3
72281_0,,,,2,2,1,3
72283_0,,,,2,2,1,3
C(CC(C1C(C(C(O)O1)O)O)O)=O,,,5,1,3,0,3
72285_0,,,,2,2,1,3
CC(C1C(C(C(O)O1)O)O)O,,,5,1,2,0,2
72286_0,,,,2,2,1,3
72287_0,,,,2,2,1,3
72288_0,,,,2,2,1,3
72289_0,,,,2,2,1,3
72290_0,,,,2,2,1,3
72291_0,,,,2,2,1,3
72292_0,,,,2,2,1,3
72293_0,,,,2,2,1,3
72294_0,,,,2,2,1,3
72295_0,,,,2,2,1,3
72296_0,,,,2,2,1,3
72297_0,,,,2,2,1,3
72298_0,,,,2,2,1,3
72299_0,,,,2,2,1,3
72300_0,,,,2,2,1,3
72301_0,,,,2,2,1,3
72302_0,,,,2,2,1,3
72303_0,,,,2,2,1,3
72304_0,,,,2,2,1,3
72305_0,,,,2,2,1,3
72306_0,,,,2,2,1,3
72307_0,,,,2,2,1,3
72308_0,,,,2,2,1,3
72309_0,,,,2,2,1,3
72310_0,,,,2,2,1,3
72311_0,,,,2,2,1,3
72312_0,,,,2,2,1,3
72313_0,,,,2,2,1,3
72314_0,,,,2,2,1,3
72315_0,,,,2,2,1,3
72316_0,,,,2,2,1,3
72317_0,,,,2,2,1,3
72318_0,,,,2,2,1,3
72319_0,,,,2,2,1,3
72320_0,,,,2,2,1,3
72321_0,,,,2,2,1,3
72322_0,,,,2,2,1,3
72323_0,,,,2,2,1,3
72324_0,,,,2,2,1,3
72325_0,,,,2,2,1,3
72326_0,,,,2,2,1,3
72327_0,,,,2,2,1,3
72328_0,,,,2,2,1,3
72329_0,,,,2,2,1,3
72330_0,,,,2,2,1,3
72331_0,,,,2,2,1,3
72332_0,,,,2,2,1,3
72333_0,,,,2,2,1,3
72334_0,,,,2,2,1,3
72335_0,,,,2,2,1,3
72336_0,,,,2,2,1,3
72337_0,,,,2,2,1,3
72338_0,,,,2,2,1,3
72339_0,,,,2,2,1,3
72340_0,,,,2,2,1,3
72341_0,,,,2,2,1,3
72342_0,,,,2,2,1,3
72343_0,,,,2,2,1,3
72344_0,,,,2,2,1,3
72345_0,,,,2,2,1,3
72346_0,,,,2,2,1,3
72347_0,,,,2,2,1,3
72348_0,,,,2,2,1,3
72349_0,,,,2,2,1,3
72350_0,,,,2,2,1,3
72351_0,,,,2,2,1,3
72352_0,,,,2,2,1,3
72353_0,,,,2,2,1,3
72354_0,,,,2,2,1,3
72355_0,,,,2,2,1,3
72356_0,,,,2,2,1,3
72357_0,,,,2,2,1,3
72358_0,,,,2,2,1,3
72359_0,,,,2,2,1,3
72360_0,,,,2,2,1,3
72361_0,,,,2,2,1,3
72362_0,,,,2,2,1,3
72363_0,,,,2,2,1,3
72364_0,,,,2,2,1,3
72365_0,,,,2,2,1,3
72366_0,,,,2,2,1,3
72367_0,,,,2,2,1,3
72368_0,,,,2,2,1,3
72369_0,,,,2,2,1,3
72370_0,,,,2,2,1,3
72371_0,,,,2,2,1,3
72372_0,,,,2,2,1,3
72373_0,,,,2,2,1,3
72374_0,,,,2,2,1,3
72375_0,,,,2,2,1,3
72376_0,,,,2,2,1,3
72377_0,,,,2,2,1,3
72378_0,,,,2,2,1,3
72379_0,,,,2,2,1,3
72380_0,,,,2,2,1,3
72381_0,,,,2,2,1,3
72382_0,,,,2,2,1,3
72383_0,,,,2,2,1,3
72384_0,,,,2,2,1,3
72385_0,,,,2,2,1,3
72386_0,,,,2,2,1,3
72387_0,,,,2,2,1,3
72388_0,,,,2,2,1,3
72389_0,,,,2,2,1,3
72390_0,,,,2,2,1,3
72391_0,,,,2,2,1,3
72392_0,,,,2,2,1,3
72393_0,,,,2,2,1,3
72394_0,,,,2,2,1,3
72395_0,,,,2,2,1,3
72396_0,,,,2,2,1,3
72397_0,,,,2,2,1,3
72398_0,,,,2,2,1,3
72399_0,,,,2,2,1,3
72400_0,,,,2,2,1,3
72401_0,,,,2,2,1,3
72402_0,,,,2,2,1,3
72403_0,,,,2,2,1,3
72404_0,,,,2,2,1,3
72405_0,,,,2,2,1,3
72406_0,,,,2,2,1,3
72407_0,,,,2,2,1,3
72408_0,,,,2,2,1,3
72409_0,,,,2,2,1,3
72410_0,,,,2,2,1,3
72411_0,,,,2,2,1,3
72412_0,,,,2,2,1,3
72413_0,,,,2,2,1,3
72414_0,,,,2,2,1,3
72415_0,,,,2,2,1,3
72416_0,,,,2,2,1,3
72417_0,,,,2,2,1,3
72418_0,,,,2,2,1,3
72420_0,,,,2,2,1,3
C(OCC(CO)O)=O,,,5,1,1,0,1
72421_0,,,,2,2,1,3
72422_0,,,,2,2,1,3
72423_0,,,,2,2,1,3
72424_0,,,,2,2,1,3
72425_0,,,,2,2,1,3
72426_0,,,,2,2,1,3
72427_0,,,,2,2,1,3
72428_0,,,,2,2,1,3
72429_0,,,,2,2,1,3
72430_0,,,,2,2,1,3
72431_0,,,,2,2,1,3
72432_0,,,,2,2,1,3
72433_0,,,,2,2,1,3
72434_0,,,,2,2,1,3
72435_0,,,,2,2,1,3
72436_0,,,,2,2,1,3
72437_0,,,,2,2,1,3
72438_0,,,,2,2,1,3
72439_0,,,,2,2,1,3
72440_0,,,,2,2,1,3
72441_0,,,,2,2,1,3
72442_0,,,,2,2,1,3
72443_0,,,,2,2,1,3
72444_0,,,,2,2,1,3
72445_0,,,,2,2,1,3
72446_0,,,,2,2,1,3
72447_0,,,,2,2,1,3
72448_0,,,,2,2,1,3
72449_0,,,,2,2,1,3
72450_0,,,,2,2,1,3
72451_0,,,,2,2,1,3
72452_0,,,,2,2,1,3
72453_0,,,,2,2,1,3
72454_0,,,,2,2,1,3
72455_0,,,,2,2,1,3
72456_0,,,,2,2,1,3
72457_0,,,,2,2,1,3
72458_0,,,,2,2,1,3
72459_0,,,,2,2,1,3
72460_0,,,,2,2,1,3
72461_0,,,,2,2,1,3
72462_0,,,,2,2,1,3
72463_0,,,,2,2,1,3
72464_0,,,,2,2,1,3
72465_0,,,,2,2,1,3
72466_0,,,,2,2,1,3
72467_0,,,,2,2,1,3
72468_0,,,,2,2,1,3
72469_0,,,,2,2,1,3
72470_0,,,,2,2,1,3
72471_0,,,,2,2,1,3
72472_0,,,,2,2,1,3
72473_0,,,,2,2,1,3
72474_0,,,,2,2,1,3
72475_0,,,,2,2,1,3
72476_0,,,,2,2,1,3
72477_0,,,,2,2,1,3
72478_0,,,,2,2,1,3
72479_0,,,,2,2,1,3
72480_0,,,,2,2,1,3
72481_0,,,,2,2,1,3
72482_0,,,,2,2,1,3
72483_0,,,,2,2,1,3
72484_0,,,,2,2,1,3
72485_0,,,,2,2,1,3
72486_0,,,,2,2,1,3
72487_0,,,,2,2,1,3
72488_0,,,,2,2,1,3
72489_0,,,,2,2,1,3
72490_0,,,,2,2,1,3
72491_0,,,,2,2,1,3
72492_0,,,,2,2,1,3
72493_0,,,,2,2,1,3
72494_0,,,,2,2,1,3
72495_0,,,,2,2,1,3
72496_0,,,,2,2,1,3
72497_0,,,,2,2,1,3
72498_0,,,,2,2,1,3
72499_0,,,,2,2,1,3
72500_0,,,,2,2,1,3
72501_0,,,,2,2,1,3
72502_0,,,,2,2,1,3
72503_0,,,,2,2,1,3
72504_0,,,,2,2,1,3
72505_0,,,,2,2,1,3
72506_0,,,,2,2,1,3
72507_0,,,,2,2,1,3
72508_0,,,,2,2,1,3
72509_0,,,,2,2,1,3
72510_0,,,,2,2,1,3
72511_0,,,,2,2,1,3
72512_0,,,,2,2,1,3
72513_0,,,,2,2,1,3
72514_0,,,,2,2,1,3
72515_0,,,,2,2,1,3
72516_0,,,,2,2,1,3
72517_0,,,,2,2,1,3
72518_0,,,,2,2,1,3
72519_0,,,,2,2,1,3
72520_0,,,,2,2,1,3
72521_0,,,,2,2,1,3
72522_0,,,,2,2,1,3
72523_0,,,,2,2,1,3
72524_0,,,,2,2,1,3
72525_0,,,,2,2,1,3
72526_0,,,,2,2,1,3
72527_0,,,,2,2,1,3
72528_0,,,,2,2,1,3
72529_0,,,,2,2,1,3
72530_0,,,,2,2,1,3
72531_0,,,,2,2,1,3
72532_0,,,,2,2,1,3
72533_0,,,,2,2,1,3
72534_0,,,,2,2,1,3
72535_0,,,,2,2,1,3
72536_0,,,,2,2,1,3
72537_0,,,,2,2,1,3
72538_0,,,,2,2,1,3
72539_0,,,,2,2,1,3
72540_0,,,,2,2,1,3
72541_0,,,,2,2,1,3
72542_0,,,,2,2,1,3
72543_0,,,,2,2,1,3
72544_0,,,,2,2,1,3
72545_0,,,,2,2,1,3
72546_0,,,,2,2,1,3
72547_0,,,,2,2,1,3
72548_0,,,,2,2,1,3
72549_0,,,,2,2,1,3
72551_0,,,,2,2,1,3
C1C(C(C(C(CCO)O)(O)O1)O)O,,,5,1,1,0,1
72552_0,,,,2,2,1,3
72553_0,,,,2,2,1,3
72554_0,,,,2,2,1,3
72556_0,,,,2,2,1,3
CC(CO)(C1(C(C(CO1)O)O)O)O,,,5,1,1,0,1
72557_0,,,,2,2,1,3
72558_0,,,,2,2,1,3
72559_0,,,,2,2,1,3
72560_0,,,,2,2,1,3
72561_0,,,,2,2,1,3
72562_0,,,,2,2,1,3
72563_0,,,,2,2,1,3
72564_0,,,,2,2,1,3
72565_0,,,,2,2,1,3
72566_0,,,,2,2,1,3
72567_0,,,,2,2,1,3
72568_0,,,,2,2,1,3
72570_0,,,,2,2,1,3
C1C(C(C(C(C(O)O)O)(O)O1)O)O,,,5,1,1,0,1
72572_0,,,,2,2,1,3
CC(C(C1(C(C(CO1)O)O)O)O)O,,,5,1,2,0,2
72574_0,,,,2,2,1,3
C(C(C1(C(C(CO1)O)O)O)O)=O,,,5,1,2,0,2
72576_0,,,,2,2,1,3
C(C(C1(C(C(CO1)O)O)O)O)(O)=O,,,5,1,2,0,2
72578_0,,,,2,2,1,3
C(C(C)(C1(C(C(CO1)O)O)O)O)=O,,,5,1,2,0,2
72579_0,,,,2,2,1,3
72581_0,,,,2,2,1,3
C(C)(C(C1(C(C(CO1)O)O)O)O)=O,,,5,1,2,0,2
72582_0,,,,2,2,1,3
72583_0,,,,2,2,1,3
72585_0,,,,2,2,1,3
CC(C1(C(C(CO1)O)O)O)O,,,5,1,2,0,2
72586_0,,,,2,2,1,3
72587_0,,,,2,2,1,3
72588_0,,,,2,2,1,3
72589_0,,,,2,2,1,3
72590_0,,,,2,2,1,3
72591_0,,,,2,2,1,3
72592_0,,,,2,2,1,3
72593_0,,,,2,2,1,3
72594_0,,,,2,2,1,3
72595_0,,,,2,2,1,3
72596_0,,,,2,2,1,3
72597_0,,,,2,2,1,3
72598_0,,,,2,2,1,3
72599_0,,,,2,2,1,3
72600_0,,,,2,2,1,3
72601_0,,,,2,2,1,3
72602_0,,,,2,2,1,3
72603_0,,,,2,2,1,3
72604_0,,,,2,2,1,3
72605_0,,,,2,2,1,3
72606_0,,,,2,2,1,3
72607_0,,,,2,2,1,3
72608_0,,,,2,2,1,3
72609_0,,,,2,2,1,3
72610_0,,,,2,2,1,3
72611_0,,,,2,2,1,3
72612_0,,,,2,2,1,3
72613_0,,,,2,2,1,3
72614_0,,,,2,2,1,3
72615_0,,,,2,2,1,3
72616_0,,,,2,2,1,3
72617_0,,,,2,2,1,3
72618_0,,,,2,2,1,3
72619_0,,,,2,2,1,3
72620_0,,,,2,2,1,3
72621_0,,,,2,2,1,3
72622_0,,,,2,2,1,3
72623_0,,,,2,2,1,3
72624_0,,,,2,2,1,3
72625_0,,,,2,2,1,3
72626_0,,,,2,2,1,3
72627_0,,,,2,2,1,3
72628_0,,,,2,2,1,3
72629_0,,,,2,2,1,3
72630_0,,,,2,2,1,3
72631_0,,,,2,2,1,3
72632_0,,,,2,2,1,3
72633_0,,,,2,2,1,3
72634_0,,,,2,2,1,3
72635_0,,,,2,2,1,3
72636_0,,,,2,2,1,3
72637_0,,,,2,2,1,3
72638_0,,,,2,2,1,3
72639_0,,,,2,2,1,3
72640_0,,,,2,2,1,3
72641_0,,,,2,2,1,3
72642_0,,,,2,2,1,3
72643_0,,,,2,2,1,3
72644_0,,,,2,2,1,3
72645_0,,,,2,2,1,3
72646_0,,,,2,2,1,3
72647_0,,,,2,2,1,3
72648_0,,,,2,2,1,3
72649_0,,,,2,2,1,3
72650_0,,,,2,2,1,3
72651_0,,,,2,2,1,3
72652_0,,,,2,2,1,3
72653_0,,,,2,2,1,3
72654_0,,,,2,2,1,3
72655_0,,,,2,2,1,3
72656_0,,,,2,2,1,3
72657_0,,,,2,2,1,3
72658_0,,,,2,2,1,3
72659_0,,,,2,2,1,3
72660_0,,,,2,2,1,3
72661_0,,,,2,2,1,3
72662_0,,,,2,2,1,3
72663_0,,,,2,2,1,3
72664_0,,,,2,2,1,3
72665_0,,,,2,2,1,3
72666_0,,,,2,2,1,3
72667_0,,,,2,2,1,3
72668_0,,,,2,2,1,3
72669_0,,,,2,2,1,3
72670_0,,,,2,2,1,3
72671_0,,,,2,2,1,3
72673_0,,,,2,2,1,3
C(C(CO)=O)(C(CO)(CCO)O)=O,,,5,1,1,0,1
72674_0,,,,2,2,1,3
72675_0,,,,2,2,1,3
72676_0,,,,2,2,1,3
72677_0,,,,2,2,1,3
72678_0,,,,2,2,1,3
72679_0,,,,2,2,1,3
72680_0,,,,2,2,1,3
72681_0,,,,2,2,1,3
72682_0,,,,2,2,1,3
72683_0,,,,2,2,1,3
72684_0,,,,2,2,1,3
72685_0,,,,2,2,1,3
72686_0,,,,2,2,1,3
72687_0,,,,2,2,1,3
72688_0,,,,2,2,1,3
72689_0,,,,2,2,1,3
72690_0,,,,2,2,1,3
72691_0,,,,2,2,1,3
72692_0,,,,2,2,1,3
72693_0,,,,2,2,1,3
72694_0,,,,2,2,1,3
72695_0,,,,2,2,1,3
72696_0,,,,2,2,1,3
72697_0,,,,2,2,1,3
72698_0,,,,2,2,1,3
72699_0,,,,2,2,1,3
72700_0,,,,2,2,1,3
72701_0,,,,2,2,1,3
72702_0,,,,2,2,1,3
72703_0,,,,2,2,1,3
72704_0,,,,2,2,1,3
72705_0,,,,2,2,1,3
72706_0,,,,2,2,1,3
72707_0,,,,2,2,1,3
72708_0,,,,2,2,1,3
72709_0,,,,2,2,1,3
72710_0,,,,2,2,1,3
72711_0,,,,2,2,1,3
72712_0,,,,2,2,1,3
72713_0,,,,2,2,1,3
72714_0,,,,2,2,1,3
72715_0,,,,2,2,1,3
72716_0,,,,2,2,1,3
72717_0,,,,2,2,1,3
72718_0,,,,2,2,1,3
72719_0,,,,2,2,1,3
72720_0,,,,2,2,1,3
72721_0,,,,2,2,1,3
72722_0,,,,2,2,1,3
72723_0,,,,2,2,1,3
72724_0,,,,2,2,1,3
72725_0,,,,2,2,1,3
72726_0,,,,2,2,1,3
72727_0,,,,2,2,1,3
72728_0,,,,2,2,1,3
72729_0,,,,2,2,1,3
72730_0,,,,2,2,1,3
72731_0,,,,2,2,1,3
72732_0,,,,2,2,1,3
72733_0,,,,2,2,1,3
72734_0,,,,2,2,1,3
72735_0,,,,2,2,1,3
72736_0,,,,2,2,1,3
72737_0,,,,2,2,1,3
72738_0,,,,2,2,1,3
72739_0,,,,2,2,1,3
72740_0,,,,2,2,1,3
72741_0,,,,2,2,1,3
72742_0,,,,2,2,1,3
72743_0,,,,2,2,1,3
72744_0,,,,2,2,1,3
72745_0,,,,2,2,1,3
72746_0,,,,2,2,1,3
72747_0,,,,2,2,1,3
72748_0,,,,2,2,1,3
72749_0,,,,2,2,1,3
72750_0,,,,2,2,1,3
72751_0,,,,2,2,1,3
72752_0,,,,2,2,1,3
72753_0,,,,2,2,1,3
72754_0,,,,2,2,1,3
72755_0,,,,2,2,1,3
72756_0,,,,2,2,1,3
72757_0,,,,2,2,1,3
72758_0,,,,2,2,1,3
72759_0,,,,2,2,1,3
72760_0,,,,2,2,1,3
72761_0,,,,2,2,1,3
72762_0,,,,2,2,1,3
72763_0,,,,2,2,1,3
72764_0,,,,2,2,1,3
72765_0,,,,2,2,1,3
72766_0,,,,2,2,1,3
72767_0,,,,2,2,1,3
72768_0,,,,2,2,1,3
72769_0,,,,2,2,1,3
72770_0,,,,2,2,1,3
72771_0,,,,2,2,1,3
72772_0,,,,2,2,1,3
72773_0,,,,2,2,1,3
72774_0,,,,2,2,1,3
72775_0,,,,2,2,1,3
72776_0,,,,2,2,1,3
72777_0,,,,2,2,1,3
72778_0,,,,2,2,1,3
72779_0,,,,2,2,1,3
72780_0,,,,2,2,1,3
72781_0,,,,2,2,1,3
72782_0,,,,2,2,1,3
72783_0,,,,2,2,1,3
72784_0,,,,2,2,1,3
72785_0,,,,2,2,1,3
72786_0,,,,2,2,1,3
72787_0,,,,2,2,1,3
72788_0,,,,2,2,1,3
72789_0,,,,2,2,1,3
72790_0,,,,2,2,1,3
72791_0,,,,2,2,1,3
72792_0,,,,2,2,1,3
72793_0,,,,2,2,1,3
72794_0,,,,2,2,1,3
72796_0,,,,2,2,1,3
C(C(C(C(CO)(C)O)=O)=O)=O,,,5,1,1,0,1
72797_0,,,,2,2,1,3
72798_0,,,,2,2,1,3
72799_0,,,,2,2,1,3
72800_0,,,,2,2,1,3
72801_0,,,,2,2,1,3
72802_0,,,,2,2,1,3
72803_0,,,,2,2,1,3
72804_0,,,,2,2,1,3
72805_0,,,,2,2,1,3
72806_0,,,,2,2,1,3
72807_0,,,,2,2,1,3
72808_0,,,,2,2,1,3
72809_0,,,,2,2,1,3
72810_0,,,,2,2,1,3
72811_0,,,,2,2,1,3
72812_0,,,,2,2,1,3
72813_0,,,,2,2,1,3
72814_0,,,,2,2,1,3
72815_0,,,,2,2,1,3
72816_0,,,,2,2,1,3
72817_0,,,,2,2,1,3
72818_0,,,,2,2,1,3
72819_0,,,,2,2,1,3
72820_0,,,,2,2,1,3
72821_0,,,,2,2,1,3
72822_0,,,,2,2,1,3
72823_0,,,,2,2,1,3
72824_0,,,,2,2,1,3
72825_0,,,,2,2,1,3
72826_0,,,,2,2,1,3
72827_0,,,,2,2,1,3
72828_0,,,,2,2,1,3
72829_0,,,,2,2,1,3
72830_0,,,,2,2,1,3
72831_0,,,,2,2,1,3
72832_0,,,,2,2,1,3
72833_0,,,,2,2,1,3
72834_0,,,,2,2,1,3
72835_0,,,,2,2,1,3
72836_0,,,,2,2,1,3
72837_0,,,,2,2,1,3
72838_0,,,,2,2,1,3
72839_0,,,,2,2,1,3
72840_0,,,,2,2,1,3
72841_0,,,,2,2,1,3
72842_0,,,,2,2,1,3
72843_0,,,,2,2,1,3
72844_0,,,,2,2,1,3
72845_0,,,,2,2,1,3
72846_0,,,,2,2,1,3
72847_0,,,,2,2,1,3
72848_0,,,,2,2,1,3
72849_0,,,,2,2,1,3
72850_0,,,,2,2,1,3
72851_0,,,,2,2,1,3
72852_0,,,,2,2,1,3
72853_0,,,,2,2,1,3
72854_0,,,,2,2,1,3
72855_0,,,,2,2,1,3
72856_0,,,,2,2,1,3
72857_0,,,,2,2,1,3
72858_0,,,,2,2,1,3
72859_0,,,,2,2,1,3
72860_0,,,,2,2,1,3
72861_0,,,,2,2,1,3
72862_0,,,,2,2,1,3
72863_0,,,,2,2,1,3
72864_0,,,,2,2,1,3
72865_0,,,,2,2,1,3
72866_0,,,,2,2,1,3
72867_0,,,,2,2,1,3
72868_0,,,,2,2,1,3
72869_0,,,,2,2,1,3
72870_0,,,,2,2,1,3
72871_0,,,,2,2,1,3
72872_0,,,,2,2,1,3
72873_0,,,,2,2,1,3
72874_0,,,,2,2,1,3
72875_0,,,,2,2,1,3
72876_0,,,,2,2,1,3
72877_0,,,,2,2,1,3
72878_0,,,,2,2,1,3
72879_0,,,,2,2,1,3
72880_0,,,,2,2,1,3
72881_0,,,,2,2,1,3
72882_0,,,,2,2,1,3
72883_0,,,,2,2,1,3
72884_0,,,,2,2,1,3
72885_0,,,,2,2,1,3
72886_0,,,,2,2,1,3
72887_0,,,,2,2,1,3
72888_0,,,,2,2,1,3
72889_0,,,,2,2,1,3
72890_0,,,,2,2,1,3
72891_0,,,,2,2,1,3
72892_0,,,,2,2,1,3
72893_0,,,,2,2,1,3
72894_0,,,,2,2,1,3
72895_0,,,,2,2,1,3
72896_0,,,,2,2,1,3
72897_0,,,,2,2,1,3
72898_0,,,,2,2,1,3
72899_0,,,,2,2,1,3
72900_0,,,,2,2,1,3
72901_0,,,,2,2,1,3
72902_0,,,,2,2,1,3
72903_0,,,,2,2,1,3
72904_0,,,,2,2,1,3
72905_0,,,,2,2,1,3
72906_0,,,,2,2,1,3
72907_0,,,,2,2,1,3
72908_0,,,,2,2,1,3
72910_0,,,,2,2,1,3
C(C(C(C(CO)(CCO)O)=O)=O)=O,,,5,1,1,0,1
72911_0,,,,2,2,1,3
72912_0,,,,2,2,1,3
72913_0,,,,2,2,1,3
72914_0,,,,2,2,1,3
72915_0,,,,2,2,1,3
72916_0,,,,2,2,1,3
72917_0,,,,2,2,1,3
72918_0,,,,2,2,1,3
72919_0,,,,2,2,1,3
72920_0,,,,2,2,1,3
72921_0,,,,2,2,1,3
72922_0,,,,2,2,1,3
72923_0,,,,2,2,1,3
72924_0,,,,2,2,1,3
72925_0,,,,2,2,1,3
72926_0,,,,2,2,1,3
72927_0,,,,2,2,1,3
72928_0,,,,2,2,1,3
72929_0,,,,2,2,1,3
72930_0,,,,2,2,1,3
72931_0,,,,2,2,1,3
72932_0,,,,2,2,1,3
72933_0,,,,2,2,1,3
72934_0,,,,2,2,1,3
72935_0,,,,2,2,1,3
72936_0,,,,2,2,1,3
72937_0,,,,2,2,1,3
72938_0,,,,2,2,1,3
72939_0,,,,2,2,1,3
72940_0,,,,2,2,1,3
72941_0,,,,2,2,1,3
72942_0,,,,2,2,1,3
72943_0,,,,2,2,1,3
72944_0,,,,2,2,1,3
72945_0,,,,2,2,1,3
72946_0,,,,2,2,1,3
72947_0,,,,2,2,1,3
72948_0,,,,2,2,1,3
72949_0,,,,2,2,1,3
72950_0,,,,2,2,1,3
72951_0,,,,2,2,1,3
72952_0,,,,2,2,1,3
72953_0,,,,2,2,1,3
72954_0,,,,2,2,1,3
72955_0,,,,2,2,1,3
72956_0,,,,2,2,1,3
72957_0,,,,2,2,1,3
72958_0,,,,2,2,1,3
72959_0,,,,2,2,1,3
72960_0,,,,2,2,1,3
72961_0,,,,2,2,1,3
72962_0,,,,2,2,1,3
72963_0,,,,2,2,1,3
72964_0,,,,2,2,1,3
72965_0,,,,2,2,1,3
72966_0,,,,2,2,1,3
72967_0,,,,2,2,1,3
72968_0,,,,2,2,1,3
72969_0,,,,2,2,1,3
72970_0,,,,2,2,1,3
72971_0,,,,2,2,1,3
72972_0,,,,2,2,1,3
72973_0,,,,2,2,1,3
72974_0,,,,2,2,1,3
72975_0,,,,2,2,1,3
72976_0,,,,2,2,1,3
72977_0,,,,2,2,1,3
72978_0,,,,2,2,1,3
72979_0,,,,2,2,1,3
72980_0,,,,2,2,1,3
72981_0,,,,2,2,1,3
72982_0,,,,2,2,1,3
72983_0,,,,2,2,1,3
72984_0,,,,2,2,1,3
72985_0,,,,2,2,1,3
72986_0,,,,2,2,1,3
72987_0,,,,2,2,1,3
72988_0,,,,2,2,1,3
72989_0,,,,2,2,1,3
72990_0,,,,2,2,1,3
72991_0,,,,2,2,1,3
72992_0,,,,2,2,1,3
72993_0,,,,2,2,1,3
72994_0,,,,2,2,1,3
72995_0,,,,2,2,1,3
72996_0,,,,2,2,1,3
72997_0,,,,2,2,1,3
72998_0,,,,2,2,1,3
72999_0,,,,2,2,1,3
73000_0,,,,2,2,1,3
73001_0,,,,2,2,1,3
73002_0,,,,2,2,1,3
73003_0,,,,2,2,1,3
73004_0,,,,2,2,1,3
73005_0,,,,2,2,1,3
73006_0,,,,2,2,1,3
73007_0,,,,2,2,1,3
73008_0,,,,2,2,1,3
73009_0,,,,2,2,1,3
73010_0,,,,2,2,1,3
73011_0,,,,2,2,1,3
73012_0,,,,2,2,1,3
73013_0,,,,2,2,1,3
73014_0,,,,2,2,1,3
73015_0,,,,2,2,1,3
73016_0,,,,2,2,1,3
73017_0,,,,2,2,1,3
73018_0,,,,2,2,1,3
73019_0,,,,2,2,1,3
73020_0,,,,2,2,1,3
73021_0,,,,2,2,1,3
73022_0,,,,2,2,1,3
73023_0,,,,2,2,1,3
73024_0,,,,2,2,1,3
73025_0,,,,2,2,1,3
73026_0,,,,2,2,1,3
73027_0,,,,2,2,1,3
73028_0,,,,2,2,1,3
73029_0,,,,2,2,1,3
73030_0,,,,2,2,1,3
73031_0,,,,2,2,1,3
73032_0,,,,2,2,1,3
73033_0,,,,2,2,1,3
73034_0,,,,2,2,1,3
73035_0,,,,2,2,1,3
73036_0,,,,2,2,1,3
73037_0,,,,2,2,1,3
73038_0,,,,2,2,1,3
73039_0,,,,2,2,1,3
73040_0,,,,2,2,1,3
73041_0,,,,2,2,1,3
73042_0,,,,2,2,1,3
73043_0,,,,2,2,1,3
73044_0,,,,2,2,1,3
73045_0,,,,2,2,1,3
73046_0,,,,2,2,1,3
73047_0,,,,2,2,1,3
73048_0,,,,2,2,1,3
73049_0,,,,2,2,1,3
73050_0,,,,2,2,1,3
73051_0,,,,2,2,1,3
73052_0,,,,2,2,1,3
73053_0,,,,2,2,1,3
73054_0,,,,2,2,1,3
73055_0,,,,2,2,1,3
73056_0,,,,2,2,1,3
73057_0,,,,2,2,1,3
73058_0,,,,2,2,1,3
73059_0,,,,2,2,1,3
73060_0,,,,2,2,1,3
73061_0,,,,2,2,1,3
73062_0,,,,2,2,1,3
73063_0,,,,2,2,1,3
73064_0,,,,2,2,1,3
73065_0,,,,2,2,1,3
73066_0,,,,2,2,1,3
73067_0,,,,2,2,1,3
73068_0,,,,2,2,1,3
73069_0,,,,2,2,1,3
73070_0,,,,2,2,1,3
73071_0,,,,2,2,1,3
73072_0,,,,2,2,1,3
73073_0,,,,2,2,1,3
73074_0,,,,2,2,1,3
73075_0,,,,2,2,1,3
73076_0,,,,2,2,1,3
73077_0,,,,2,2,1,3
73078_0,,,,2,2,1,3
73079_0,,,,2,2,1,3
73080_0,,,,2,2,1,3
73081_0,,,,2,2,1,3
73082_0,,,,2,2,1,3
73083_0,,,,2,2,1,3
73084_0,,,,2,2,1,3
73085_0,,,,2,2,1,3
73086_0,,,,2,2,1,3
73087_0,,,,2,2,1,3
73088_0,,,,2,2,1,3
73089_0,,,,2,2,1,3
73090_0,,,,2,2,1,3
73091_0,,,,2,2,1,3
73092_0,,,,2,2,1,3
73093_0,,,,2,2,1,3
73094_0,,,,2,2,1,3
73095_0,,,,2,2,1,3
73096_0,,,,2,2,1,3
73097_0,,,,2,2,1,3
73098_0,,,,2,2,1,3
73099_0,,,,2,2,1,3
73100_0,,,,2,2,1,3
73101_0,,,,2,2,1,3
73102_0,,,,2,2,1,3
73103_0,,,,2,2,1,3
73104_0,,,,2,2,1,3
73105_0,,,,2,2,1,3
73106_0,,,,2,2,1,3
73107_0,,,,2,2,1,3
73108_0,,,,2,2,1,3
73109_0,,,,2,2,1,3
73110_0,,,,2,2,1,3
73111_0,,,,2,2,1,3
73112_0,,,,2,2,1,3
73113_0,,,,2,2,1,3
73114_0,,,,2,2,1,3
73115_0,,,,2,2,1,3
73116_0,,,,2,2,1,3
73117_0,,,,2,2,1,3
73118_0,,,,2,2,1,3
73119_0,,,,2,2,1,3
73120_0,,,,2,2,1,3
73121_0,,,,2,2,1,3
73122_0,,,,2,2,1,3
73123_0,,,,2,2,1,3
73124_0,,,,2,2,1,3
73125_0,,,,2,2,1,3
73126_0,,,,2,2,1,3
73127_0,,,,2,2,1,3
73128_0,,,,2,2,1,3
73129_0,,,,2,2,1,3
73130_0,,,,2,2,1,3
73131_0,,,,2,2,1,3
73132_0,,,,2,2,1,3
73133_0,,,,2,2,1,3
73134_0,,,,2,2,1,3
73135_0,,,,2,2,1,3
73136_0,,,,2,2,1,3
73137_0,,,,2,2,1,3
73138_0,,,,2,2,1,3
73139_0,,,,2,2,1,3
73140_0,,,,2,2,1,3
73141_0,,,,2,2,1,3
73142_0,,,,2,2,1,3
73143_0,,,,2,2,1,3
73144_0,,,,2,2,1,3
73145_0,,,,2,2,1,3
73146_0,,,,2,2,1,3
73147_0,,,,2,2,1,3
73148_0,,,,2,2,1,3
73149_0,,,,2,2,1,3
73150_0,,,,2,2,1,3
73151_0,,,,2,2,1,3
73152_0,,,,2,2,1,3
73153_0,,,,2,2,1,3
73154_0,,,,2,2,1,3
73155_0,,,,2,2,1,3
73156_0,,,,2,2,1,3
73157_0,,,,2,2,1,3
73158_0,,,,2,2,1,3
73159_0,,,,2,2,1,3
73160_0,,,,2,2,1,3
73161_0,,,,2,2,1,3
73162_0,,,,2,2,1,3
73163_0,,,,2,2,1,3
73164_0,,,,2,2,1,3
73165_0,,,,2,2,1,3
73166_0,,,,2,2,1,3
73167_0,,,,2,2,1,3
73168_0,,,,2,2,1,3
73169_0,,,,2,2,1,3
73170_0,,,,2,2,1,3
73171_0,,,,2,2,1,3
73172_0,,,,2,2,1,3
73173_0,,,,2,2,1,3
73174_0,,,,2,2,1,3
73175_0,,,,2,2,1,3
73176_0,,,,2,2,1,3
73177_0,,,,2,2,1,3
73178_0,,,,2,2,1,3
73179_0,,,,2,2,1,3
73180_0,,,,2,2,1,3
73181_0,,,,2,2,1,3
73182_0,,,,2,2,1,3
73183_0,,,,2,2,1,3
73184_0,,,,2,2,1,3
73185_0,,,,2,2,1,3
73186_0,,,,2,2,1,3
73187_0,,,,2,2,1,3
73188_0,,,,2,2,1,3
73189_0,,,,2,2,1,3
73190_0,,,,2,2,1,3
73191_0,,,,2,2,1,3
73192_0,,,,2,2,1,3
73193_0,,,,2,2,1,3
73194_0,,,,2,2,1,3
73195_0,,,,2,2,1,3
73196_0,,,,2,2,1,3
73197_0,,,,2,2,1,3
73198_0,,,,2,2,1,3
73199_0,,,,2,2,1,3
73200_0,,,,2,2,1,3
73201_0,,,,2,2,1,3
73202_0,,,,2,2,1,3
73203_0,,,,2,2,1,3
73204_0,,,,2,2,1,3
73205_0,,,,2,2,1,3
73206_0,,,,2,2,1,3
73207_0,,,,2,2,1,3
73208_0,,,,2,2,1,3
73209_0,,,,2,2,1,3
73210_0,,,,2,2,1,3
73211_0,,,,2,2,1,3
73212_0,,,,2,2,1,3
73213_0,,,,2,2,1,3
73214_0,,,,2,2,1,3
73215_0,,,,2,2,1,3
73216_0,,,,2,2,1,3
73217_0,,,,2,2,1,3
73218_0,,,,2,2,1,3
73219_0,,,,2,2,1,3
73220_0,,,,2,2,1,3
73221_0,,,,2,2,1,3
73222_0,,,,2,2,1,3
73223_0,,,,2,2,1,3
73224_0,,,,2,2,1,3
73225_0,,,,2,2,1,3
73226_0,,,,2,2,1,3
73227_0,,,,2,2,1,3
73228_0,,,,2,2,1,3
73229_0,,,,2,2,1,3
73230_0,,,,2,2,1,3
73231_0,,,,2,2,1,3
73232_0,,,,2,2,1,3
73233_0,,,,2,2,1,3
73234_0,,,,2,2,1,3
73235_0,,,,2,2,1,3
73236_0,,,,2,2,1,3
73237_0,,,,2,2,1,3
73238_0,,,,2,2,1,3
73239_0,,,,2,2,1,3
73240_0,,,,2,2,1,3
73241_0,,,,2,2,1,3
73242_0,,,,2,2,1,3
73243_0,,,,2,2,1,3
73244_0,,,,2,2,1,3
73245_0,,,,2,2,1,3
73246_0,,,,2,2,1,3
73247_0,,,,2,2,1,3
73248_0,,,,2,2,1,3
73249_0,,,,2,2,1,3
73250_0,,,,2,2,1,3
73251_0,,,,2,2,1,3
73252_0,,,,2,2,1,3
73253_0,,,,2,2,1,3
73254_0,,,,2,2,1,3
73255_0,,,,2,2,1,3
73256_0,,,,2,2,1,3
73257_0,,,,2,2,1,3
73258_0,,,,2,2,1,3
73259_0,,,,2,2,1,3
73261_0,,,,2,2,1,3
C(C(C)C(C(C(C=O)O)O)O)(O)=O,,,5,1,1,0,1
73262_0,,,,2,2,1,3
73263_0,,,,2,2,1,3
73264_0,,,,2,2,1,3
73265_0,,,,2,2,1,3
73266_0,,,,2,2,1,3
73267_0,,,,2,2,1,3
73268_0,,,,2,2,1,3
73269_0,,,,2,2,1,3
73270_0,,,,2,2,1,3
73271_0,,,,2,2,1,3
73272_0,,,,2,2,1,3
73273_0,,,,2,2,1,3
73274_0,,,,2,2,1,3
73275_0,,,,2,2,1,3
73276_0,,,,2,2,1,3
73277_0,,,,2,2,1,3
73278_0,,,,2,2,1,3
73279_0,,,,2,2,1,3
73280_0,,,,2,2,1,3
73281_0,,,,2,2,1,3
73282_0,,,,2,2,1,3
73283_0,,,,2,2,1,3
73284_0,,,,2,2,1,3
73285_0,,,,2,2,1,3
73286_0,,,,2,2,1,3
73287_0,,,,2,2,1,3
73288_0,,,,2,2,1,3
73289_0,,,,2,2,1,3
73290_0,,,,2,2,1,3
73291_0,,,,2,2,1,3
73292_0,,,,2,2,1,3
73293_0,,,,2,2,1,3
73294_0,,,,2,2,1,3
73295_0,,,,2,2,1,3
73296_0,,,,2,2,1,3
73298_0,,,,2,2,1,3
C(C(C)C(CO)O)(O)=O,,,5,1,1,0,1
73299_0,,,,2,2,1,3
73301_0,,,,2,2,1,3
C(C(CCO)C(CO)O)(O)=O,,,5,1,2,0,2
73302_0,,,,2,2,1,3
73303_0,,,,2,2,1,3
73304_0,,,,2,2,1,3
73305_0,,,,2,2,1,3
73306_0,,,,2,2,1,3
73307_0,,,,2,2,1,3
73308_0,,,,2,2,1,3
73309_0,,,,2,2,1,3
73310_0,,,,2,2,1,3
73311_0,,,,2,2,1,3
73312_0,,,,2,2,1,3
73313_0,,,,2,2,1,3
73314_0,,,,2,2,1,3
73315_0,,,,2,2,1,3
73316_0,,,,2,2,1,3
73317_0,,,,2,2,1,3
73318_0,,,,2,2,1,3
73319_0,,,,2,2,1,3
73320_0,,,,2,2,1,3
73321_0,,,,2,2,1,3
73322_0,,,,2,2,1,3
73323_0,,,,2,2,1,3
73324_0,,,,2,2,1,3
73325_0,,,,2,2,1,3
73326_0,,,,2,2,1,3
73327_0,,,,2,2,1,3
73328_0,,,,2,2,1,3
73329_0,,,,2,2,1,3
73330_0,,,,2,2,1,3
73331_0,,,,2,2,1,3
73332_0,,,,2,2,1,3
73333_0,,,,2,2,1,3
73334_0,,,,2,2,1,3
73335_0,,,,2,2,1,3
73336_0,,,,2,2,1,3
73337_0,,,,2,2,1,3
73338_0,,,,2,2,1,3
73339_0,,,,2,2,1,3
73340_0,,,,2,2,1,3
73341_0,,,,2,2,1,3
73342_0,,,,2,2,1,3
73343_0,,,,2,2,1,3
73344_0,,,,2,2,1,3
73345_0,,,,2,2,1,3
73346_0,,,,2,2,1,3
73347_0,,,,2,2,1,3
73348_0,,,,2,2,1,3
73349_0,,,,2,2,1,3
73350_0,,,,2,2,1,3
73351_0,,,,2,2,1,3
73352_0,,,,2,2,1,3
73353_0,,,,2,2,1,3
73354_0,,,,2,2,1,3
73355_0,,,,2,2,1,3
73356_0,,,,2,2,1,3
73357_0,,,,2,2,1,3
73358_0,,,,2,2,1,3
73359_0,,,,2,2,1,3
73360_0,,,,2,2,1,3
73361_0,,,,2,2,1,3
73362_0,,,,2,2,1,3
73363_0,,,,2,2,1,3
73364_0,,,,2,2,1,3
73365_0,,,,2,2,1,3
73366_0,,,,2,2,1,3
73367_0,,,,2,2,1,3
73368_0,,,,2,2,1,3
73369_0,,,,2,2,1,3
73370_0,,,,2,2,1,3
73371_0,,,,2,2,1,3
73372_0,,,,2,2,1,3
73373_0,,,,2,2,1,3
73374_0,,,,2,2,1,3
73375_0,,,,2,2,1,3
73376_0,,,,2,2,1,3
73377_0,,,,2,2,1,3
73378_0,,,,2,2,1,3
73379_0,,,,2,2,1,3
73380_0,,,,2,2,1,3
73381_0,,,,2,2,1,3
73382_0,,,,2,2,1,3
73383_0,,,,2,2,1,3
73384_0,,,,2,2,1,3
73385_0,,,,2,2,1,3
73386_0,,,,2,2,1,3
73387_0,,,,2,2,1,3
73388_0,,,,2,2,1,3
73389_0,,,,2,2,1,3
73390_0,,,,2,2,1,3
73391_0,,,,2,2,1,3
73392_0,,,,2,2,1,3
73393_0,,,,2,2,1,3
73394_0,,,,2,2,1,3
73395_0,,,,2,2,1,3
73396_0,,,,2,2,1,3
73397_0,,,,2,2,1,3
73398_0,,,,2,2,1,3
73399_0,,,,2,2,1,3
73400_0,,,,2,2,1,3
73401_0,,,,2,2,1,3
73402_0,,,,2,2,1,3
73403_0,,,,2,2,1,3
73404_0,,,,2,2,1,3
73405_0,,,,2,2,1,3
73406_0,,,,2,2,1,3
73407_0,,,,2,2,1,3
73408_0,,,,2,2,1,3
73409_0,,,,2,2,1,3
73410_0,,,,2,2,1,3
73411_0,,,,2,2,1,3
73412_0,,,,2,2,1,3
73413_0,,,,2,2,1,3
73414_0,,,,2,2,1,3
73415_0,,,,2,2,1,3
73416_0,,,,2,2,1,3
73417_0,,,,2,2,1,3
73418_0,,,,2,2,1,3
73419_0,,,,2,2,1,3
73420_0,,,,2,2,1,3
73421_0,,,,2,2,1,3
73422_0,,,,2,2,1,3
73423_0,,,,2,2,1,3
73424_0,,,,2,2,1,3
73425_0,,,,2,2,1,3
73426_0,,,,2,2,1,3
73427_0,,,,2,2,1,3
73428_0,,,,2,2,1,3
73429_0,,,,2,2,1,3
73430_0,,,,2,2,1,3
73431_0,,,,2,2,1,3
73432_0,,,,2,2,1,3
73433_0,,,,2,2,1,3
73434_0,,,,2,2,1,3
73435_0,,,,2,2,1,3
73436_0,,,,2,2,1,3
73437_0,,,,2,2,1,3
73438_0,,,,2,2,1,3
73439_0,,,,2,2,1,3
73440_0,,,,2,2,1,3
73441_0,,,,2,2,1,3
73442_0,,,,2,2,1,3
73443_0,,,,2,2,1,3
73444_0,,,,2,2,1,3
73445_0,,,,2,2,1,3
73446_0,,,,2,2,1,3
73447_0,,,,2,2,1,3
73448_0,,,,2,2,1,3
73449_0,,,,2,2,1,3
73450_0,,,,2,2,1,3
73451_0,,,,2,2,1,3
73452_0,,,,2,2,1,3
73453_0,,,,2,2,1,3
73454_0,,,,2,2,1,3
73455_0,,,,2,2,1,3
73456_0,,,,2,2,1,3
73457_0,,,,2,2,1,3
73458_0,,,,2,2,1,3
73459_0,,,,2,2,1,3
73460_0,,,,2,2,1,3
73461_0,,,,2,2,1,3
73462_0,,,,2,2,1,3
73463_0,,,,2,2,1,3
73464_0,,,,2,2,1,3
73465_0,,,,2,2,1,3
73466_0,,,,2,2,1,3
73468_0,,,,2,2,1,3
C(CO)=C(C(O)=O)C(C(CO)O)O,,,5,1,2,0,2
73469_0,,,,2,2,1,3
73470_0,,,,2,2,1,3
73471_0,,,,2,2,1,3
73473_0,,,,2,2,1,3
C=C(C(O)=O)C(C(C(CO)O)O)O,,,5,1,4,0,4
73474_0,,,,2,2,1,3
73475_0,,,,2,2,1,3
73477_0,,,,2,2,1,3
C=C(C(O)=O)C(CO)(C(CO)O)O,,,5,1,1,0,1
73478_0,,,,2,2,1,3
73479_0,,,,2,2,1,3
73480_0,,,,2,2,1,3
73481_0,,,,2,2,1,3
73482_0,,,,2,2,1,3
73483_0,,,,2,2,1,3
73484_0,,,,2,2,1,3
73485_0,,,,2,2,1,3
73486_0,,,,2,2,1,3
73487_0,,,,2,2,1,3
73489_0,,,,2,2,1,3
C(C1(C)C(C(C(O1)O)O)O)=O,,,5,1,2,0,2
73490_0,,,,2,2,1,3
73491_0,,,,2,2,1,3
73492_0,,,,2,2,1,3
73493_0,,,,2,2,1,3
73494_0,,,,2,2,1,3
73495_0,,,,2,2,1,3
73496_0,,,,2,2,1,3
73497_0,,,,2,2,1,3
73498_0,,,,2,2,1,3
73499_0,,,,2,2,1,3
73500_0,,,,2,2,1,3
73501_0,,,,2,2,1,3
73502_0,,,,2,2,1,3
73503_0,,,,2,2,1,3
73504_0,,,,2,2,1,3
73506_0,,,,2,2,1,3
C(C1(CCO)C(C(C(O1)O)O)O)=O,,,5,1,2,0,2
73507_0,,,,2,2,1,3
73508_0,,,,2,2,1,3
73509_0,,,,2,2,1,3
73510_0,,,,2,2,1,3
73511_0,,,,2,2,1,3
73512_0,,,,2,2,1,3
73513_0,,,,2,2,1,3
73515_0,,,,2,2,1,3
C(C(CC1C(C(C(O)O1)O)O)O)=O,,,5,1,3,0,3
73516_0,,,,2,2,1,3
73517_0,,,,2,2,1,3
73518_0,,,,2,2,1,3
73519_0,,,,2,2,1,3
73521_0,,,,2,2,1,3
C(CC1(CO)C(C(C(O)O1)O)O)=O,,,5,1,2,0,2
73522_0,,,,2,2,1,3
73523_0,,,,2,2,1,3
73524_0,,,,2,2,1,3
73526_0,,,,2,2,1,3
C(C(C1(C)C(C(C(O)O1)O)O)O)=O,,,5,1,2,0,2
73528_0,,,,2,2,1,3
CC1C(C(C(O)O1)O)O,,,5,1,2,0,2
73530_0,,,,2,2,1,3
C(C1(CO)C(C(C(O1)O)O)O)=O,,,5,1,2,0,2
73531_0,,,,2,2,1,3
73533_0,,,,2,2,1,3
C(C1C(C(C(O1)O)O)O)=O,,,5,1,2,0,2
73534_0,,,,2,2,1,3
73535_0,,,,2,2,1,3
73536_0,,,,2,2,1,3
73537_0,,,,2,2,1,3
73538_0,,,,2,2,1,3
73539_0,,,,2,2,1,3
73540_0,,,,2,2,1,3
73541_0,,,,2,2,1,3
73542_0,,,,2,2,1,3
73543_0,,,,2,2,1,3
73544_0,,,,2,2,1,3
73545_0,,,,2,2,1,3
73546_0,,,,2,2,1,3
73547_0,,,,2,2,1,3
73548_0,,,,2,2,1,3
73549_0,,,,2,2,1,3
73550_0,,,,2,2,1,3
73551_0,,,,2,2,1,3
73552_0,,,,2,2,1,3
73553_0,,,,2,2,1,3
73554_0,,,,2,2,1,3
73555_0,,,,2,2,1,3
73556_0,,,,2,2,1,3
73557_0,,,,2,2,1,3
73558_0,,,,2,2,1,3
73559_0,,,,2,2,1,3
73560_0,,,,2,2,1,3
73561_0,,,,2,2,1,3
73562_0,,,,2,2,1,3
73563_0,,,,2,2,1,3
73564_0,,,,2,2,1,3
73565_0,,,,2,2,1,3
73566_0,,,,2,2,1,3
73567_0,,,,2,2,1,3
73568_0,,,,2,2,1,3
73569_0,,,,2,2,1,3
73570_0,,,,2,2,1,3
73571_0,,,,2,2,1,3
73572_0,,,,2,2,1,3
73574_0,,,,2,2,1,3
C1(C(C(C(C(O)O1)O)O)O)=O,,,5,1,2,0,2
73575_0,,,,2,2,1,3
73576_0,,,,2,2,1,3
73577_0,,,,2,2,1,3
73578_0,,,,2,2,1,3
73579_0,,,,2,2,1,3
73580_0,,,,2,2,1,3
73582_0,,,,2,2,1,3
C(C1(C)C(C(C(C(O1)O)O)O)O)=O,,,5,1,3,0,3
73584_0,,,,2,2,1,3
C(C1C(C(C(C)(C(O1)O)O)O)O)=O,,,5,1,2,0,2
73585_0,,,,2,2,1,3
73586_0,,,,2,2,1,3
73587_0,,,,2,2,1,3
73589_0,,,,2,2,1,3
C(C)(C1C(C(C(C(O1)O)O)O)O)=O,,,5,1,4,0,4
73590_0,,,,2,2,1,3
73592_0,,,,2,2,1,3
C(C1C(C(C(C(C)(O1)O)O)O)O)=O,,,5,1,2,0,2
73593_0,,,,2,2,1,3
73594_0,,,,2,2,1,3
73595_0,,,,2,2,1,3
73597_0,,,,2,2,1,3
C(CC1C(C(C(C(O)O1)O)O)O)=O,,,5,1,4,0,4
73598_0,,,,2,2,1,3
73599_0,,,,2,2,1,3
73600_0,,,,2,2,1,3
73601_0,,,,2,2,1,3
73603_0,,,,2,2,1,3
C(C1C(C)(C(C(C(O1)O)O)O)O)=O,,,5,1,2,0,2
73605_0,,,,2,2,1,3
C(C1(COC(C(C1O)O)O)O)=O,,,5,1,2,0,2
73606_0,,,,2,2,1,3
73607_0,,,,2,2,1,3
73608_0,,,,2,2,1,3
73609_0,,,,2,2,1,3
73610_0,,,,2,2,1,3
73611_0,,,,2,2,1,3
73612_0,,,,2,2,1,3
73613_0,,,,2,2,1,3
73614_0,,,,2,2,1,3
73615_0,,,,2,2,1,3
73616_0,,,,2,2,1,3
73618_0,,,,2,2,1,3
CC1C(C(C(C(O)O1)O)O)O,,,5,1,3,0,3
73619_0,,,,2,2,1,3
73620_0,,,,2,2,1,3
73621_0,,,,2,2,1,3
73622_0,,,,2,2,1,3
73623_0,,,,2,2,1,3
73624_0,,,,2,2,1,3
73626_0,,,,2,2,1,3
C(C1(CCOC(C(C1O)O)O)O)=O,,,5,1,2,0,2
73627_0,,,,2,2,1,3
73629_0,,,,2,2,1,3
C(C1CC(C(C(C(O1)O)O)O)O)=O,,,5,1,2,0,2
73630_0,,,,2,2,1,3
73631_0,,,,2,2,1,3
73632_0,,,,2,2,1,3
73633_0,,,,2,2,1,3
73635_0,,,,2,2,1,3
C(C1C(C(C(CC(O1)O)O)O)O)=O,,,5,1,2,0,2
73636_0,,,,2,2,1,3
73637_0,,,,2,2,1,3
73638_0,,,,2,2,1,3
73639_0,,,,2,2,1,3
73640_0,,,,2,2,1,3
73641_0,,,,2,2,1,3
73642_0,,,,2,2,1,3
73643_0,,,,2,2,1,3
73645_0,,,,2,2,1,3
C1(C(C)(C(C(C(CO)O)O1)O)O)=O,,,5,1,2,0,2
73647_0,,,,2,2,1,3
C1(C(C)(C(CO1)(C(CO)O)O)O)=O,,,5,1,1,0,1
73648_0,,,,2,2,1,3
73649_0,,,,2,2,1,3
73650_0,,,,2,2,1,3
73651_0,,,,2,2,1,3
73652_0,,,,2,2,1,3
73654_0,,,,2,2,1,3
C1(C(C)(C(C(C(CO1)O)O)O)O)=O,,,5,1,2,0,2
73655_0,,,,2,2,1,3
73656_0,,,,2,2,1,3
73657_0,,,,2,2,1,3
73658_0,,,,2,2,1,3
73659_0,,,,2,2,1,3
73660_0,,,,2,2,1,3
73661_0,,,,2,2,1,3
73662_0,,,,2,2,1,3
73664_0,,,,2,2,1,3
C(CC(C)(CC(C(C=O)O)O)O)=O,,,5,1,1,0,1
73665_0,,,,2,2,1,3
73666_0,,,,2,2,1,3
73667_0,,,,2,2,1,3
73668_0,,,,2,2,1,3
73669_0,,,,2,2,1,3
73671_0,,,,2,2,1,3
C(CC(CCC(C(C=O)O)O)O)=O,,,5,1,1,0,1
73672_0,,,,2,2,1,3
73673_0,,,,2,2,1,3
73674_0,,,,2,2,1,3
73675_0,,,,2,2,1,3
73676_0,,,,2,2,1,3
73677_0,,,,2,2,1,3
73678_0,,,,2,2,1,3
73679_0,,,,2,2,1,3
73680_0,,,,2,2,1,3
73681_0,,,,2,2,1,3
73682_0,,,,2,2,1,3
73683_0,,,,2,2,1,3
73684_0,,,,2,2,1,3
73685_0,,,,2,2,1,3
73686_0,,,,2,2,1,3
73687_0,,,,2,2,1,3
73688_0,,,,2,2,1,3
73689_0,,,,2,2,1,3
73690_0,,,,2,2,1,3
73691_0,,,,2,2,1,3
73692_0,,,,2,2,1,3
73693_0,,,,2,2,1,3
73694_0,,,,2,2,1,3
73695_0,,,,2,2,1,3
73696_0,,,,2,2,1,3
73697_0,,,,2,2,1,3
73698_0,,,,2,2,1,3
73699_0,,,,2,2,1,3
73700_0,,,,2,2,1,3
73701_0,,,,2,2,1,3
73702_0,,,,2,2,1,3
73703_0,,,,2,2,1,3
73704_0,,,,2,2,1,3
73705_0,,,,2,2,1,3
73706_0,,,,2,2,1,3
73707_0,,,,2,2,1,3
73708_0,,,,2,2,1,3
73709_0,,,,2,2,1,3
73710_0,,,,2,2,1,3
73711_0,,,,2,2,1,3
73712_0,,,,2,2,1,3
73713_0,,,,2,2,1,3
73714_0,,,,2,2,1,3
73715_0,,,,2,2,1,3
73716_0,,,,2,2,1,3
73717_0,,,,2,2,1,3
73718_0,,,,2,2,1,3
73719_0,,,,2,2,1,3
73720_0,,,,2,2,1,3
73721_0,,,,2,2,1,3
73723_0,,,,2,2,1,3
C(C(C(CCCO)O)O)=O,,,5,1,1,0,1
73724_0,,,,2,2,1,3
73725_0,,,,2,2,1,3
73726_0,,,,2,2,1,3
73727_0,,,,2,2,1,3
73728_0,,,,2,2,1,3
73729_0,,,,2,2,1,3
73730_0,,,,2,2,1,3
73731_0,,,,2,2,1,3
73733_0,,,,2,2,1,3
C(C(C=O)CC(C(C=O)O)O)(O)=O,,,5,1,1,0,1
73734_0,,,,2,2,1,3
73735_0,,,,2,2,1,3
73736_0,,,,2,2,1,3
73737_0,,,,2,2,1,3
73738_0,,,,2,2,1,3
73739_0,,,,2,2,1,3
73740_0,,,,2,2,1,3
73741_0,,,,2,2,1,3
73742_0,,,,2,2,1,3
73743_0,,,,2,2,1,3
73744_0,,,,2,2,1,3
73745_0,,,,2,2,1,3
73746_0,,,,2,2,1,3
73747_0,,,,2,2,1,3
73748_0,,,,2,2,1,3
73749_0,,,,2,2,1,3
73750_0,,,,2,2,1,3
73752_0,,,,2,2,1,3
C(C(C(CC(C=O)(O)O)O)O)=O,,,5,1,1,0,1
73753_0,,,,2,2,1,3
73755_0,,,,2,2,1,3
C(C(C(CCC(C=O)O)O)O)=O,,,5,1,2,0,2
73756_0,,,,2,2,1,3
73757_0,,,,2,2,1,3
73758_0,,,,2,2,1,3
73759_0,,,,2,2,1,3
73760_0,,,,2,2,1,3
73761_0,,,,2,2,1,3
73762_0,,,,2,2,1,3
73763_0,,,,2,2,1,3
73764_0,,,,2,2,1,3
73765_0,,,,2,2,1,3
73766_0,,,,2,2,1,3
73767_0,,,,2,2,1,3
73768_0,,,,2,2,1,3
73769_0,,,,2,2,1,3
73770_0,,,,2,2,1,3
73771_0,,,,2,2,1,3
73772_0,,,,2,2,1,3
73773_0,,,,2,2,1,3
73774_0,,,,2,2,1,3
73775_0,,,,2,2,1,3
73776_0,,,,2,2,1,3
73777_0,,,,2,2,1,3
73778_0,,,,2,2,1,3
73779_0,,,,2,2,1,3
73780_0,,,,2,2,1,3
73781_0,,,,2,2,1,3
73782_0,,,,2,2,1,3
73783_0,,,,2,2,1,3
73784_0,,,,2,2,1,3
73785_0,,,,2,2,1,3
73786_0,,,,2,2,1,3
73787_0,,,,2,2,1,3
73788_0,,,,2,2,1,3
73789_0,,,,2,2,1,3
73790_0,,,,2,2,1,3
73791_0,,,,2,2,1,3
73792_0,,,,2,2,1,3
73793_0,,,,2,2,1,3
73794_0,,,,2,2,1,3
73795_0,,,,2,2,1,3
73796_0,,,,2,2,1,3
73797_0,,,,2,2,1,3
73798_0,,,,2,2,1,3
73799_0,,,,2,2,1,3
73800_0,,,,2,2,1,3
73801_0,,,,2,2,1,3
73802_0,,,,2,2,1,3
73803_0,,,,2,2,1,3
73804_0,,,,2,2,1,3
73805_0,,,,2,2,1,3
73806_0,,,,2,2,1,3
73807_0,,,,2,2,1,3
73808_0,,,,2,2,1,3
73809_0,,,,2,2,1,3
73810_0,,,,2,2,1,3
73811_0,,,,2,2,1,3
73812_0,,,,2,2,1,3
73813_0,,,,2,2,1,3
73814_0,,,,2,2,1,3
73815_0,,,,2,2,1,3
73816_0,,,,2,2,1,3
73817_0,,,,2,2,1,3
73818_0,,,,2,2,1,3
73819_0,,,,2,2,1,3
73820_0,,,,2,2,1,3
73821_0,,,,2,2,1,3
73822_0,,,,2,2,1,3
73823_0,,,,2,2,1,3
73824_0,,,,2,2,1,3
73825_0,,,,2,2,1,3
73826_0,,,,2,2,1,3
73827_0,,,,2,2,1,3
73828_0,,,,2,2,1,3
73829_0,,,,2,2,1,3
73830_0,,,,2,2,1,3
73831_0,,,,2,2,1,3
73832_0,,,,2,2,1,3
73833_0,,,,2,2,1,3
73834_0,,,,2,2,1,3
73835_0,,,,2,2,1,3
73836_0,,,,2,2,1,3
73837_0,,,,2,2,1,3
73838_0,,,,2,2,1,3
73839_0,,,,2,2,1,3
73840_0,,,,2,2,1,3
73841_0,,,,2,2,1,3
73842_0,,,,2,2,1,3
73843_0,,,,2,2,1,3
73844_0,,,,2,2,1,3
73845_0,,,,2,2,1,3
73846_0,,,,2,2,1,3
73847_0,,,,2,2,1,3
73848_0,,,,2,2,1,3
73849_0,,,,2,2,1,3
73850_0,,,,2,2,1,3
73851_0,,,,2,2,1,3
73852_0,,,,2,2,1,3
73853_0,,,,2,2,1,3
73854_0,,,,2,2,1,3
73855_0,,,,2,2,1,3
73856_0,,,,2,2,1,3
73857_0,,,,2,2,1,3
73858_0,,,,2,2,1,3
73859_0,,,,2,2,1,3
73860_0,,,,2,2,1,3
73861_0,,,,2,2,1,3
73862_0,,,,2,2,1,3
73863_0,,,,2,2,1,3
73864_0,,,,2,2,1,3
73865_0,,,,2,2,1,3
73866_0,,,,2,2,1,3
73867_0,,,,2,2,1,3
73868_0,,,,2,2,1,3
73869_0,,,,2,2,1,3
73870_0,,,,2,2,1,3
73871_0,,,,2,2,1,3
73872_0,,,,2,2,1,3
73873_0,,,,2,2,1,3
73874_0,,,,2,2,1,3
73875_0,,,,2,2,1,3
73876_0,,,,2,2,1,3
73877_0,,,,2,2,1,3
73878_0,,,,2,2,1,3
73879_0,,,,2,2,1,3
73880_0,,,,2,2,1,3
73881_0,,,,2,2,1,3
73882_0,,,,2,2,1,3
73883_0,,,,2,2,1,3
73884_0,,,,2,2,1,3
73885_0,,,,2,2,1,3
73886_0,,,,2,2,1,3
73887_0,,,,2,2,1,3
73888_0,,,,2,2,1,3
73889_0,,,,2,2,1,3
73890_0,,,,2,2,1,3
73891_0,,,,2,2,1,3
73892_0,,,,2,2,1,3
73893_0,,,,2,2,1,3
73894_0,,,,2,2,1,3
73895_0,,,,2,2,1,3
73896_0,,,,2,2,1,3
73897_0,,,,2,2,1,3
73898_0,,,,2,2,1,3
73899_0,,,,2,2,1,3
73900_0,,,,2,2,1,3
73901_0,,,,2,2,1,3
73902_0,,,,2,2,1,3
73903_0,,,,2,2,1,3
73904_0,,,,2,2,1,3
73905_0,,,,2,2,1,3
73906_0,,,,2,2,1,3
73907_0,,,,2,2,1,3
73908_0,,,,2,2,1,3
73909_0,,,,2,2,1,3
73910_0,,,,2,2,1,3
73911_0,,,,2,2,1,3
73912_0,,,,2,2,1,3
73913_0,,,,2,2,1,3
73914_0,,,,2,2,1,3
73915_0,,,,2,2,1,3
73916_0,,,,2,2,1,3
73917_0,,,,2,2,1,3
73918_0,,,,2,2,1,3
73919_0,,,,2,2,1,3
73920_0,,,,2,2,1,3
73921_0,,,,2,2,1,3
73922_0,,,,2,2,1,3
73923_0,,,,2,2,1,3
73924_0,,,,2,2,1,3
73925_0,,,,2,2,1,3
73926_0,,,,2,2,1,3
73927_0,,,,2,2,1,3
73928_0,,,,2,2,1,3
73929_0,,,,2,2,1,3
73930_0,,,,2,2,1,3
73931_0,,,,2,2,1,3
73932_0,,,,2,2,1,3
73933_0,,,,2,2,1,3
73934_0,,,,2,2,1,3
73935_0,,,,2,2,1,3
73936_0,,,,2,2,1,3
73937_0,,,,2,2,1,3
73938_0,,,,2,2,1,3
73939_0,,,,2,2,1,3
73940_0,,,,2,2,1,3
73941_0,,,,2,2,1,3
73942_0,,,,2,2,1,3
73943_0,,,,2,2,1,3
73944_0,,,,2,2,1,3
73945_0,,,,2,2,1,3
73946_0,,,,2,2,1,3
73947_0,,,,2,2,1,3
73948_0,,,,2,2,1,3
73949_0,,,,2,2,1,3
73950_0,,,,2,2,1,3
73951_0,,,,2,2,1,3
73952_0,,,,2,2,1,3
73953_0,,,,2,2,1,3
73954_0,,,,2,2,1,3
73955_0,,,,2,2,1,3
73956_0,,,,2,2,1,3
73957_0,,,,2,2,1,3
73958_0,,,,2,2,1,3
73959_0,,,,2,2,1,3
73960_0,,,,2,2,1,3
73961_0,,,,2,2,1,3
73962_0,,,,2,2,1,3
73963_0,,,,2,2,1,3
73964_0,,,,2,2,1,3
73965_0,,,,2,2,1,3
73966_0,,,,2,2,1,3
73967_0,,,,2,2,1,3
73968_0,,,,2,2,1,3
73969_0,,,,2,2,1,3
73970_0,,,,2,2,1,3
73971_0,,,,2,2,1,3
73972_0,,,,2,2,1,3
73973_0,,,,2,2,1,3
73974_0,,,,2,2,1,3
73975_0,,,,2,2,1,3
73976_0,,,,2,2,1,3
73978_0,,,,2,2,1,3
C(C(C=O)(C(CO)CO)O)=O,,,5,1,1,0,1
73979_0,,,,2,2,1,3
73980_0,,,,2,2,1,3
73981_0,,,,2,2,1,3
73983_0,,,,2,2,1,3
C(C(C(CO)(C(CO)CO)O)=O)=O,,,5,1,1,0,1
73984_0,,,,2,2,1,3
73985_0,,,,2,2,1,3
73986_0,,,,2,2,1,3
73987_0,,,,2,2,1,3
73988_0,,,,2,2,1,3
73989_0,,,,2,2,1,3
73990_0,,,,2,2,1,3
73991_0,,,,2,2,1,3
73992_0,,,,2,2,1,3
73993_0,,,,2,2,1,3
73994_0,,,,2,2,1,3
73995_0,,,,2,2,1,3
73996_0,,,,2,2,1,3
73997_0,,,,2,2,1,3
73998_0,,,,2,2,1,3
73999_0,,,,2,2,1,3
74000_0,,,,2,2,1,3
74001_0,,,,2,2,1,3
74002_0,,,,2,2,1,3
74003_0,,,,2,2,1,3
74004_0,,,,2,2,1,3
74005_0,,,,2,2,1,3
74006_0,,,,2,2,1,3
74007_0,,,,2,2,1,3
74008_0,,,,2,2,1,3
74009_0,,,,2,2,1,3
74010_0,,,,2,2,1,3
74011_0,,,,2,2,1,3
74012_0,,,,2,2,1,3
74014_0,,,,2,2,1,3
C(C(C=O)(C(CO)C(CO)O)O)=O,,,5,1,1,0,1
74015_0,,,,2,2,1,3
74016_0,,,,2,2,1,3
74017_0,,,,2,2,1,3
74018_0,,,,2,2,1,3
74019_0,,,,2,2,1,3
74020_0,,,,2,2,1,3
74021_0,,,,2,2,1,3
74022_0,,,,2,2,1,3
74023_0,,,,2,2,1,3
74024_0,,,,2,2,1,3
74025_0,,,,2,2,1,3
74026_0,,,,2,2,1,3
74027_0,,,,2,2,1,3
74028_0,,,,2,2,1,3
74029_0,,,,2,2,1,3
74030_0,,,,2,2,1,3
74031_0,,,,2,2,1,3
74032_0,,,,2,2,1,3
74033_0,,,,2,2,1,3
74034_0,,,,2,2,1,3
74035_0,,,,2,2,1,3
74036_0,,,,2,2,1,3
74037_0,,,,2,2,1,3
74038_0,,,,2,2,1,3
74039_0,,,,2,2,1,3
74040_0,,,,2,2,1,3
74041_0,,,,2,2,1,3
74042_0,,,,2,2,1,3
74043_0,,,,2,2,1,3
74045_0,,,,2,2,1,3
C(C(C=O)(CC(CO)(CO)O)O)=O,,,5,1,1,0,1
74046_0,,,,2,2,1,3
74047_0,,,,2,2,1,3
74048_0,,,,2,2,1,3
74049_0,,,,2,2,1,3
74050_0,,,,2,2,1,3
74051_0,,,,2,2,1,3
74052_0,,,,2,2,1,3
74053_0,,,,2,2,1,3
74054_0,,,,2,2,1,3
74055_0,,,,2,2,1,3
74056_0,,,,2,2,1,3
74057_0,,,,2,2,1,3
74058_0,,,,2,2,1,3
74059_0,,,,2,2,1,3
74060_0,,,,2,2,1,3
74061_0,,,,2,2,1,3
74062_0,,,,2,2,1,3
74063_0,,,,2,2,1,3
74064_0,,,,2,2,1,3
74065_0,,,,2,2,1,3
74066_0,,,,2,2,1,3
74067_0,,,,2,2,1,3
74068_0,,,,2,2,1,3
74069_0,,,,2,2,1,3
74070_0,,,,2,2,1,3
74071_0,,,,2,2,1,3
74072_0,,,,2,2,1,3
74073_0,,,,2,2,1,3
74074_0,,,,2,2,1,3
74075_0,,,,2,2,1,3
74076_0,,,,2,2,1,3
74077_0,,,,2,2,1,3
74078_0,,,,2,2,1,3
74079_0,,,,2,2,1,3
74080_0,,,,2,2,1,3
74081_0,,,,2,2,1,3
74082_0,,,,2,2,1,3
74083_0,,,,2,2,1,3
74084_0,,,,2,2,1,3
74085_0,,,,2,2,1,3
74086_0,,,,2,2,1,3
74087_0,,,,2,2,1,3
74088_0,,,,2,2,1,3
74089_0,,,,2,2,1,3
74090_0,,,,2,2,1,3
74091_0,,,,2,2,1,3
74092_0,,,,2,2,1,3
74093_0,,,,2,2,1,3
74094_0,,,,2,2,1,3
74095_0,,,,2,2,1,3
74096_0,,,,2,2,1,3
74097_0,,,,2,2,1,3
74098_0,,,,2,2,1,3
74099_0,,,,2,2,1,3
74100_0,,,,2,2,1,3
74101_0,,,,2,2,1,3
74102_0,,,,2,2,1,3
74103_0,,,,2,2,1,3
74104_0,,,,2,2,1,3
74105_0,,,,2,2,1,3
74106_0,,,,2,2,1,3
74107_0,,,,2,2,1,3
74108_0,,,,2,2,1,3
74109_0,,,,2,2,1,3
74110_0,,,,2,2,1,3
74111_0,,,,2,2,1,3
74112_0,,,,2,2,1,3
74113_0,,,,2,2,1,3
74114_0,,,,2,2,1,3
74115_0,,,,2,2,1,3
74116_0,,,,2,2,1,3
74117_0,,,,2,2,1,3
74118_0,,,,2,2,1,3
74119_0,,,,2,2,1,3
74121_0,,,,2,2,1,3
C(C(CCC(C(C=O)=O)O)O)=O,,,5,1,2,0,2
74122_0,,,,2,2,1,3
74123_0,,,,2,2,1,3
74124_0,,,,2,2,1,3
74125_0,,,,2,2,1,3
74126_0,,,,2,2,1,3
74127_0,,,,2,2,1,3
74128_0,,,,2,2,1,3
74129_0,,,,2,2,1,3
74130_0,,,,2,2,1,3
74131_0,,,,2,2,1,3
74132_0,,,,2,2,1,3
74133_0,,,,2,2,1,3
74134_0,,,,2,2,1,3
74136_0,,,,2,2,1,3
C(C(C(C)C(C(C=O)=O)O)O)=O,,,5,1,2,0,2
74137_0,,,,2,2,1,3
74138_0,,,,2,2,1,3
74139_0,,,,2,2,1,3
74141_0,,,,2,2,1,3
C(C(C(CC)O)=O)=O,,,5,1,1,0,1
74142_0,,,,2,2,1,3
74143_0,,,,2,2,1,3
74144_0,,,,2,2,1,3
74145_0,,,,2,2,1,3
74146_0,,,,2,2,1,3
74147_0,,,,2,2,1,3
74148_0,,,,2,2,1,3
74149_0,,,,2,2,1,3
74150_0,,,,2,2,1,3
74151_0,,,,2,2,1,3
74152_0,,,,2,2,1,3
74153_0,,,,2,2,1,3
74154_0,,,,2,2,1,3
74155_0,,,,2,2,1,3
74156_0,,,,2,2,1,3
74157_0,,,,2,2,1,3
74158_0,,,,2,2,1,3
74159_0,,,,2,2,1,3
74161_0,,,,2,2,1,3
C(C(C=O)(CCC=O)O)=O,,,5,1,2,0,2
74162_0,,,,2,2,1,3
74163_0,,,,2,2,1,3
74164_0,,,,2,2,1,3
74165_0,,,,2,2,1,3
74166_0,,,,2,2,1,3
74168_0,,,,2,2,1,3
C(CCC(C(C=O)=O)(CO)O)=O,,,5,1,2,0,2
74169_0,,,,2,2,1,3
74170_0,,,,2,2,1,3
74171_0,,,,2,2,1,3
74172_0,,,,2,2,1,3
74173_0,,,,2,2,1,3
74174_0,,,,2,2,1,3
74175_0,,,,2,2,1,3
74176_0,,,,2,2,1,3
74177_0,,,,2,2,1,3
74179_0,,,,2,2,1,3
C(CCC(C=O)(C(CO)=O)O)=O,,,5,1,2,0,2
74180_0,,,,2,2,1,3
74181_0,,,,2,2,1,3
74182_0,,,,2,2,1,3
74183_0,,,,2,2,1,3
74184_0,,,,2,2,1,3
74186_0,,,,2,2,1,3
C(CCC(C(C(C=O)O)=O)O)=O,,,5,1,2,0,2
74187_0,,,,2,2,1,3
74188_0,,,,2,2,1,3
74189_0,,,,2,2,1,3
74190_0,,,,2,2,1,3
74191_0,,,,2,2,1,3
74192_0,,,,2,2,1,3
74193_0,,,,2,2,1,3
74194_0,,,,2,2,1,3
74195_0,,,,2,2,1,3
74196_0,,,,2,2,1,3
74197_0,,,,2,2,1,3
74198_0,,,,2,2,1,3
74199_0,,,,2,2,1,3
74200_0,,,,2,2,1,3
74201_0,,,,2,2,1,3
74202_0,,,,2,2,1,3
74203_0,,,,2,2,1,3
74204_0,,,,2,2,1,3
74206_0,,,,2,2,1,3
C(C(C=O)(CCC(C=O)O)O)=O,,,5,1,2,0,2
74207_0,,,,2,2,1,3
74208_0,,,,2,2,1,3
74209_0,,,,2,2,1,3
74210_0,,,,2,2,1,3
74211_0,,,,2,2,1,3
74212_0,,,,2,2,1,3
74213_0,,,,2,2,1,3
74214_0,,,,2,2,1,3
74215_0,,,,2,2,1,3
74217_0,,,,2,2,1,3
C(C(C=O)(CC(C(C)=O)O)O)=O,,,5,1,1,0,1
74218_0,,,,2,2,1,3
74219_0,,,,2,2,1,3
74220_0,,,,2,2,1,3
74222_0,,,,2,2,1,3
C(C(C=O)(C(C)C(C=O)O)O)=O,,,5,1,1,0,1
74223_0,,,,2,2,1,3
74224_0,,,,2,2,1,3
74225_0,,,,2,2,1,3
74227_0,,,,2,2,1,3
C(C(C=O)(CC)O)=O,,,5,1,1,0,1
74228_0,,,,2,2,1,3
74229_0,,,,2,2,1,3
74230_0,,,,2,2,1,3
74231_0,,,,2,2,1,3
74232_0,,,,2,2,1,3
74233_0,,,,2,2,1,3
74234_0,,,,2,2,1,3
74235_0,,,,2,2,1,3
74236_0,,,,2,2,1,3
74238_0,,,,2,2,1,3
C(C(C=O)(CC(CO)O)O)=O,,,5,1,1,0,1
74239_0,,,,2,2,1,3
74241_0,,,,2,2,1,3
C(C(C=O)(CC(C(CO)O)O)O)=O,,,5,1,1,0,1
74242_0,,,,2,2,1,3
74243_0,,,,2,2,1,3
74244_0,,,,2,2,1,3
74245_0,,,,2,2,1,3
74246_0,,,,2,2,1,3
74247_0,,,,2,2,1,3
74248_0,,,,2,2,1,3
74249_0,,,,2,2,1,3
74250_0,,,,2,2,1,3
74251_0,,,,2,2,1,3
74252_0,,,,2,2,1,3
74253_0,,,,2,2,1,3
74254_0,,,,2,2,1,3
74255_0,,,,2,2,1,3
74256_0,,,,2,2,1,3
74257_0,,,,2,2,1,3
74258_0,,,,2,2,1,3
74259_0,,,,2,2,1,3
74260_0,,,,2,2,1,3
74262_0,,,,2,2,1,3
C(C(C(CO)(CC)O)=O)=O,,,5,1,1,0,1
74263_0,,,,2,2,1,3
74264_0,,,,2,2,1,3
74265_0,,,,2,2,1,3
74266_0,,,,2,2,1,3
74267_0,,,,2,2,1,3
74268_0,,,,2,2,1,3
74269_0,,,,2,2,1,3
74270_0,,,,2,2,1,3
74271_0,,,,2,2,1,3
74272_0,,,,2,2,1,3
74273_0,,,,2,2,1,3
74274_0,,,,2,2,1,3
74275_0,,,,2,2,1,3
74276_0,,,,2,2,1,3
74277_0,,,,2,2,1,3
74278_0,,,,2,2,1,3
74279_0,,,,2,2,1,3
74280_0,,,,2,2,1,3
74281_0,,,,2,2,1,3
74282_0,,,,2,2,1,3
74283_0,,,,2,2,1,3
74284_0,,,,2,2,1,3
74285_0,,,,2,2,1,3
74286_0,,,,2,2,1,3
74287_0,,,,2,2,1,3
74288_0,,,,2,2,1,3
74290_0,,,,2,2,1,3
C(C(CCC(C=O)O)O)=O,,,5,1,2,0,2
74291_0,,,,2,2,1,3
74292_0,,,,2,2,1,3
74293_0,,,,2,2,1,3
74294_0,,,,2,2,1,3
74295_0,,,,2,2,1,3
74296_0,,,,2,2,1,3
74297_0,,,,2,2,1,3
74298_0,,,,2,2,1,3
74299_0,,,,2,2,1,3
74300_0,,,,2,2,1,3
74301_0,,,,2,2,1,3
74302_0,,,,2,2,1,3
74303_0,,,,2,2,1,3
74304_0,,,,2,2,1,3
74305_0,,,,2,2,1,3
74306_0,,,,2,2,1,3
74307_0,,,,2,2,1,3
74308_0,,,,2,2,1,3
74309_0,,,,2,2,1,3
74310_0,,,,2,2,1,3
74311_0,,,,2,2,1,3
74312_0,,,,2,2,1,3
74313_0,,,,2,2,1,3
74314_0,,,,2,2,1,3
74315_0,,,,2,2,1,3
74316_0,,,,2,2,1,3
74317_0,,,,2,2,1,3
74318_0,,,,2,2,1,3
74319_0,,,,2,2,1,3
74320_0,,,,2,2,1,3
74321_0,,,,2,2,1,3
74322_0,,,,2,2,1,3
74323_0,,,,2,2,1,3
74324_0,,,,2,2,1,3
74325_0,,,,2,2,1,3
74326_0,,,,2,2,1,3
74327_0,,,,2,2,1,3
74328_0,,,,2,2,1,3
74329_0,,,,2,2,1,3
74330_0,,,,2,2,1,3
74331_0,,,,2,2,1,3
74332_0,,,,2,2,1,3
74333_0,,,,2,2,1,3
74334_0,,,,2,2,1,3
74335_0,,,,2,2,1,3
74337_0,,,,2,2,1,3
C(C(C(CO)=O)(CC)O)=O,,,5,1,1,0,1
74338_0,,,,2,2,1,3
74339_0,,,,2,2,1,3
74340_0,,,,2,2,1,3
74341_0,,,,2,2,1,3
74342_0,,,,2,2,1,3
74343_0,,,,2,2,1,3
74344_0,,,,2,2,1,3
74345_0,,,,2,2,1,3
74346_0,,,,2,2,1,3
74347_0,,,,2,2,1,3
74348_0,,,,2,2,1,3
74349_0,,,,2,2,1,3
74350_0,,,,2,2,1,3
74351_0,,,,2,2,1,3
74352_0,,,,2,2,1,3
74353_0,,,,2,2,1,3
74354_0,,,,2,2,1,3
74355_0,,,,2,2,1,3
74357_0,,,,2,2,1,3
C(C(C(C)C(C=O)O)O)=O,,,5,1,2,0,2
74358_0,,,,2,2,1,3
74359_0,,,,2,2,1,3
74360_0,,,,2,2,1,3
74361_0,,,,2,2,1,3
74362_0,,,,2,2,1,3
74363_0,,,,2,2,1,3
74364_0,,,,2,2,1,3
74365_0,,,,2,2,1,3
74367_0,,,,2,2,1,3
C(C(C(C(CC)O)=O)O)=O,,,5,1,1,0,1
74368_0,,,,2,2,1,3
74369_0,,,,2,2,1,3
74370_0,,,,2,2,1,3
74371_0,,,,2,2,1,3
74372_0,,,,2,2,1,3
74373_0,,,,2,2,1,3
74374_0,,,,2,2,1,3
74375_0,,,,2,2,1,3
74376_0,,,,2,2,1,3
74377_0,,,,2,2,1,3
74378_0,,,,2,2,1,3
74379_0,,,,2,2,1,3
74380_0,,,,2,2,1,3
74381_0,,,,2,2,1,3
74383_0,,,,2,2,1,3
C(C(CC)O)=O,,,5,1,2,0,2
74384_0,,,,2,2,1,3
74385_0,,,,2,2,1,3
74386_0,,,,2,2,1,3
74387_0,,,,2,2,1,3
74388_0,,,,2,2,1,3
74389_0,,,,2,2,1,3
74390_0,,,,2,2,1,3
74391_0,,,,2,2,1,3
74392_0,,,,2,2,1,3
74393_0,,,,2,2,1,3
74394_0,,,,2,2,1,3
74395_0,,,,2,2,1,3
74396_0,,,,2,2,1,3
74397_0,,,,2,2,1,3
74398_0,,,,2,2,1,3
74399_0,,,,2,2,1,3
74400_0,,,,2,2,1,3
74401_0,,,,2,2,1,3
74402_0,,,,2,2,1,3
74403_0,,,,2,2,1,3
74404_0,,,,2,2,1,3
74405_0,,,,2,2,1,3
74406_0,,,,2,2,1,3
74407_0,,,,2,2,1,3
74408_0,,,,2,2,1,3
74409_0,,,,2,2,1,3
74410_0,,,,2,2,1,3
74411_0,,,,2,2,1,3
74412_0,,,,2,2,1,3
74413_0,,,,2,2,1,3
74414_0,,,,2,2,1,3
74415_0,,,,2,2,1,3
74416_0,,,,2,2,1,3
74417_0,,,,2,2,1,3
74418_0,,,,2,2,1,3
74419_0,,,,2,2,1,3
74420_0,,,,2,2,1,3
74421_0,,,,2,2,1,3
74422_0,,,,2,2,1,3
74423_0,,,,2,2,1,3
74424_0,,,,2,2,1,3
74425_0,,,,2,2,1,3
74426_0,,,,2,2,1,3
74427_0,,,,2,2,1,3
74428_0,,,,2,2,1,3
74429_0,,,,2,2,1,3
74430_0,,,,2,2,1,3
74431_0,,,,2,2,1,3
74432_0,,,,2,2,1,3
74433_0,,,,2,2,1,3
74434_0,,,,2,2,1,3
74435_0,,,,2,2,1,3
74436_0,,,,2,2,1,3
74437_0,,,,2,2,1,3
74438_0,,,,2,2,1,3
74439_0,,,,2,2,1,3
74440_0,,,,2,2,1,3
74441_0,,,,2,2,1,3
74442_0,,,,2,2,1,3
74443_0,,,,2,2,1,3
74444_0,,,,2,2,1,3
74445_0,,,,2,2,1,3
74446_0,,,,2,2,1,3
74447_0,,,,2,2,1,3
74448_0,,,,2,2,1,3
74449_0,,,,2,2,1,3
74450_0,,,,2,2,1,3
74451_0,,,,2,2,1,3
74452_0,,,,2,2,1,3
74453_0,,,,2,2,1,3
74454_0,,,,2,2,1,3
74455_0,,,,2,2,1,3
74456_0,,,,2,2,1,3
74457_0,,,,2,2,1,3
74458_0,,,,2,2,1,3
74459_0,,,,2,2,1,3
74460_0,,,,2,2,1,3
74461_0,,,,2,2,1,3
74462_0,,,,2,2,1,3
74463_0,,,,2,2,1,3
74464_0,,,,2,2,1,3
74465_0,,,,2,2,1,3
74466_0,,,,2,2,1,3
74467_0,,,,2,2,1,3
74468_0,,,,2,2,1,3
74469_0,,,,2,2,1,3
74470_0,,,,2,2,1,3
74471_0,,,,2,2,1,3
74472_0,,,,2,2,1,3
74473_0,,,,2,2,1,3
74474_0,,,,2,2,1,3
74475_0,,,,2,2,1,3
74476_0,,,,2,2,1,3
74477_0,,,,2,2,1,3
74478_0,,,,2,2,1,3
74479_0,,,,2,2,1,3
74480_0,,,,2,2,1,3
74481_0,,,,2,2,1,3
74482_0,,,,2,2,1,3
74483_0,,,,2,2,1,3
74484_0,,,,2,2,1,3
74485_0,,,,2,2,1,3
74486_0,,,,2,2,1,3
74487_0,,,,2,2,1,3
74488_0,,,,2,2,1,3
74489_0,,,,2,2,1,3
74490_0,,,,2,2,1,3
74491_0,,,,2,2,1,3
74492_0,,,,2,2,1,3
74493_0,,,,2,2,1,3
74494_0,,,,2,2,1,3
74495_0,,,,2,2,1,3
74496_0,,,,2,2,1,3
74497_0,,,,2,2,1,3
74498_0,,,,2,2,1,3
74499_0,,,,2,2,1,3
74500_0,,,,2,2,1,3
74501_0,,,,2,2,1,3
74502_0,,,,2,2,1,3
74503_0,,,,2,2,1,3
74504_0,,,,2,2,1,3
74505_0,,,,2,2,1,3
74506_0,,,,2,2,1,3
74507_0,,,,2,2,1,3
74508_0,,,,2,2,1,3
74509_0,,,,2,2,1,3
74510_0,,,,2,2,1,3
74511_0,,,,2,2,1,3
74512_0,,,,2,2,1,3
74513_0,,,,2,2,1,3
74514_0,,,,2,2,1,3
74515_0,,,,2,2,1,3
74516_0,,,,2,2,1,3
74517_0,,,,2,2,1,3
74518_0,,,,2,2,1,3
74519_0,,,,2,2,1,3
74520_0,,,,2,2,1,3
74521_0,,,,2,2,1,3
74522_0,,,,2,2,1,3
74523_0,,,,2,2,1,3
74524_0,,,,2,2,1,3
74525_0,,,,2,2,1,3
74526_0,,,,2,2,1,3
74527_0,,,,2,2,1,3
74528_0,,,,2,2,1,3
74529_0,,,,2,2,1,3
74530_0,,,,2,2,1,3
74531_0,,,,2,2,1,3
74532_0,,,,2,2,1,3
74533_0,,,,2,2,1,3
74534_0,,,,2,2,1,3
74535_0,,,,2,2,1,3
74536_0,,,,2,2,1,3
74537_0,,,,2,2,1,3
74538_0,,,,2,2,1,3
74539_0,,,,2,2,1,3
74540_0,,,,2,2,1,3
74541_0,,,,2,2,1,3
74542_0,,,,2,2,1,3
74543_0,,,,2,2,1,3
74544_0,,,,2,2,1,3
74545_0,,,,2,2,1,3
74546_0,,,,2,2,1,3
74547_0,,,,2,2,1,3
74548_0,,,,2,2,1,3
74549_0,,,,2,2,1,3
74550_0,,,,2,2,1,3
74551_0,,,,2,2,1,3
74552_0,,,,2,2,1,3
74553_0,,,,2,2,1,3
74554_0,,,,2,2,1,3
74555_0,,,,2,2,1,3
74556_0,,,,2,2,1,3
74557_0,,,,2,2,1,3
74558_0,,,,2,2,1,3
74559_0,,,,2,2,1,3
74560_0,,,,2,2,1,3
74561_0,,,,2,2,1,3
74562_0,,,,2,2,1,3
74563_0,,,,2,2,1,3
74564_0,,,,2,2,1,3
74565_0,,,,2,2,1,3
74566_0,,,,2,2,1,3
74567_0,,,,2,2,1,3
74568_0,,,,2,2,1,3
74569_0,,,,2,2,1,3
74570_0,,,,2,2,1,3
74571_0,,,,2,2,1,3
74572_0,,,,2,2,1,3
74573_0,,,,2,2,1,3
74574_0,,,,2,2,1,3
74575_0,,,,2,2,1,3
74576_0,,,,2,2,1,3
74577_0,,,,2,2,1,3
74578_0,,,,2,2,1,3
74579_0,,,,2,2,1,3
74580_0,,,,2,2,1,3
74581_0,,,,2,2,1,3
74582_0,,,,2,2,1,3
74583_0,,,,2,2,1,3
74584_0,,,,2,2,1,3
74585_0,,,,2,2,1,3
74586_0,,,,2,2,1,3
74587_0,,,,2,1,2,3
74588_0,,,,2,1,2,3
74589_0,,,,2,1,2,3
74590_0,,,,2,1,2,3
74591_0,,,,2,1,2,3
74592_0,,,,2,1,2,3
74593_0,,,,2,1,2,3
74594_0,,,,2,1,2,3
74595_0,,,,2,1,2,3
74596_0,,,,2,1,2,3
74597_0,,,,2,1,2,3
74598_0,,,,2,1,2,3
74600_0,,,,2,1,2,3
C=CC(CCC(C=O)=O)O,,,5,1,3,0,3
74601_0,,,,2,1,2,3
74603_0,,,,2,1,2,3
C(CCC(C=C)O)(O)=O,,,5,1,3,0,3
74605_0,,,,2,1,2,3
C=CC(C(CC(C)O)O)O,,,5,1,1,0,1
74607_0,,,,2,1,2,3
C=CC(C(CCO)O)O,,,5,1,1,0,1
74608_0,,,,2,1,2,3
74610_0,,,,2,1,2,3
C=CC(C(CO)(C)O)O,,,5,1,1,0,1
74611_0,,,,2,1,2,3
74613_0,,,,2,1,2,3
C(CC(C(C=C)O)O)(O)=O,,,5,1,1,0,1
74614_0,,,,2,1,2,3
74615_0,,,,2,1,2,3
74617_0,,,,2,1,2,3
C=CC(C(C=CC=O)O)O,,,5,1,1,0,1
74618_0,,,,2,1,2,3
74620_0,,,,2,1,2,3
C=CC(C(C(O)O)O)O,,,5,1,1,0,1
74622_0,,,,2,1,2,3
C=CC(C(C(C)O)O)O,,,5,1,1,0,1
74623_0,,,,2,1,2,3
74624_0,,,,2,1,2,3
74625_0,,,,2,1,2,3
74626_0,,,,2,1,2,3
74627_0,,,,2,1,2,3
74628_0,,,,2,1,2,3
74629_0,,,,2,1,2,3
74631_0,,,,2,1,2,3
C=CC(C(C)O)O,,,5,1,1,0,1
74632_0,,,,2,1,2,3
74633_0,,,,2,1,2,3
74634_0,,,,2,1,2,3
74635_0,,,,2,1,2,3
74636_0,,,,2,1,2,3
74637_0,,,,2,1,2,3
74638_0,,,,2,1,2,3
74639_0,,,,2,1,2,3
74640_0,,,,2,1,2,3
74641_0,,,,2,1,2,3
74642_0,,,,2,1,2,3
74643_0,,,,2,1,2,3
74644_0,,,,2,1,2,3
74645_0,,,,2,1,2,3
74646_0,,,,2,1,2,3
74647_0,,,,2,1,2,3
74648_0,,,,2,1,2,3
74649_0,,,,2,1,2,3
74650_0,,,,2,1,2,3
74651_0,,,,2,1,2,3
74652_0,,,,2,1,2,3
74653_0,,,,2,1,2,3
74654_0,,,,2,1,2,3
74655_0,,,,2,1,2,3
74656_0,,,,2,1,2,3
74657_0,,,,2,1,2,3
74658_0,,,,2,1,2,3
74660_0,,,,2,1,2,3
C=CC(CCO)O,,,5,1,1,0,1
74661_0,,,,2,1,2,3
74662_0,,,,2,1,2,3
74663_0,,,,2,1,2,3
74664_0,,,,2,1,2,3
74665_0,,,,2,1,2,3
74666_0,,,,2,1,1,2
74668_0,,,,2,1,1,2
C(C1(C2C(C(C(C2O)O1)O)O)O)=O,,,5,1,2,0,2
74668_1,,,,2,1,1,2
74670_0,,,,2,1,1,2
C1(C2C(C(C(C2O)O1)O)O)O,,,5,1,2,0,2
74670_1,,,,2,1,1,2
74672_0,,,,2,1,1,2
C1C2(CC(C(C2O)O)(O)O1)O,,,5,1,2,0,2
74672_1,,,,2,1,1,2
74674_0,,,,2,1,1,2
C1C2(C(C(C(C2CO)(O)O1)O)O)O,,,5,1,2,0,2
74674_1,,,,2,1,1,2
74676_0,,,,2,1,1,2
C12CC(C(C(C(C1O)O)(O)O2)O)O,,,5,1,2,0,2
74676_1,,,,2,1,1,2
74678_0,,,,2,1,1,2
C(C1(C2C(C(C1C(O)O2)O)O)O)O,,,5,1,2,0,2
74678_1,,,,2,1,1,2
74680_0,,,,2,1,1,2
C1C2(C(C(C(C2C(O)O1)O)O)O)O,,,5,1,1,0,1
74682_0,,,,2,1,1,2
C(C1(C(C2C(C1C(O)O2)O)O)O)O,,,5,1,2,0,2
74682_1,,,,2,1,1,2
74684_0,,,,2,1,1,2
C1C2(CC(C(C(C2O)(O)O1)O)O)O,,,5,1,2,0,2
74684_1,,,,2,1,1,2
74686_0,,,,2,1,1,2
C(C1(C2C(CC(C1O)(O)O2)O)O)O,,,5,1,1,0,1
74688_0,,,,2,1,1,2
C1C2(C(C(CC(C2O)O)(O)O1)O)O,,,5,1,2,0,2
74688_1,,,,2,1,1,2
74690_0,,,,2,1,1,2
CC1(C2C(C(C(C1O)(O)O2)O)O)O,,,5,1,1,0,1
74692_0,,,,2,1,1,2
C(C1(C2C(C(C(C1)(O)O2)O)O)O)O,,,5,1,1,0,1
74694_0,,,,2,1,1,2
C1C2(CC(C(C(C2O)O)O)(O)O1)O,,,5,1,2,0,2
74694_1,,,,2,1,1,2
74696_0,,,,2,1,1,2
C1C2(C(C(C(C2O)O)(O)O1)O)O,,,5,1,2,0,2
74696_1,,,,2,1,1,2
74698_0,,,,2,1,1,2
C(C1C2(CC(C(C2O)O)(O)O1)O)O,,,5,1,2,0,2
74698_1,,,,2,1,1,2
74700_0,,,,2,1,1,2
C(C12C(C(C(C(O)O1)C2O)O)O)O,,,5,1,2,0,2
74700_1,,,,2,1,1,2
74702_0,,,,2,1,1,2
C(C1(C2C(C(C(O)O2)C1O)O)O)O,,,5,1,2,0,2
74702_1,,,,2,1,1,2
74703_0,,,,2,1,1,2
74703_1,,,,2,1,1,2
74704_0,,,,2,1,1,2
74704_1,,,,2,1,1,2
74705_0,,,,2,1,1,2
74705_1,,,,2,1,1,2
74706_0,,,,2,1,1,2
74706_1,,,,2,1,1,2
74707_0,,,,2,1,1,2
74707_1,,,,2,1,1,2
74708_0,,,,2,1,1,2
74708_1,,,,2,1,1,2
74709_0,,,,2,1,1,2
74711_0,,,,2,1,1,2
C(C1(CC2(C(C1CO2)O)O)O)=O,,,5,1,2,0,2
74711_1,,,,2,1,1,2
74712_0,,,,2,1,1,2
74712_1,,,,2,1,1,2
74713_0,,,,2,1,1,2
74715_0,,,,2,1,1,2
C1(C(C2C(O)OC(C2O)C1)O)=O,,,5,1,2,0,2
74715_1,,,,2,1,1,2
74717_0,,,,2,1,1,2
C(C1C2C(CC(C2O)(O1)O)O)=O,,,5,1,2,0,2
74717_1,,,,2,1,1,2
74718_0,,,,2,1,1,2
74720_0,,,,2,1,1,2
C1(C(C2C(C1)OC(C2O)O)O)=O,,,5,1,1,0,1
74721_0,,,,2,1,1,2
74722_0,,,,2,1,1,2
74722_1,,,,2,1,1,2
74723_0,,,,2,1,1,2
74724_0,,,,2,1,1,2
74724_1,,,,2,1,1,2
74726_0,,,,2,1,1,2
C(C1C2(CC(C(C2)(O1)O)O)O)=O,,,5,1,2,0,2
74726_1,,,,2,1,1,2
74727_0,,,,2,1,1,2
74727_1,,,,2,1,1,2
74729_0,,,,2,1,1,2
C1(C(CC2(C(O)OCC12)O)O)=O,,,5,1,1,0,1
74730_0,,,,2,1,1,2
74730_1,,,,2,1,1,2
74732_0,,,,2,1,1,2
C(C1(C2C(C(CC2O)O1)O)O)=O,,,5,1,2,0,2
74732_1,,,,2,1,1,2
74733_0,,,,2,1,1,2
74734_0,,,,2,1,1,2
74735_0,,,,2,1,1,2
74735_1,,,,2,1,1,2
74737_0,,,,2,1,1,2
C(C1(CC2C(C1C(O)O2)O)O)=O,,,5,1,2,0,2
74737_1,,,,2,1,1,2
74738_0,,,,2,1,1,2
74738_1,,,,2,1,1,2
74739_0,,,,2,1,1,2
74739_1,,,,2,1,1,2
74740_0,,,,2,1,1,2
74740_1,,,,2,1,1,2
74741_0,,,,2,1,1,2
74741_1,,,,2,1,1,2
74742_0,,,,2,1,1,2
74742_1,,,,2,1,1,2
74743_0,,,,2,1,1,2
74743_1,,,,2,1,1,2
74744_0,,,,2,1,1,2
74744_1,,,,2,1,1,2
74745_0,,,,2,1,1,2
74745_1,,,,2,1,1,2
74746_0,,,,2,1,1,2
74746_1,,,,2,1,1,2
74748_0,,,,2,1,1,2
C1(C(C(C2(C(O)OCC12)O)O)O)=O,,,5,1,1,0,1
74749_0,,,,2,1,1,2
74749_1,,,,2,1,1,2
74750_0,,,,2,1,1,2
74750_1,,,,2,1,1,2
74752_0,,,,2,1,1,2
C(C1(C(C2(C(C1CO2)O)O)O)O)=O,,,5,1,2,0,2
74752_1,,,,2,1,1,2
74753_0,,,,2,1,1,2
74755_0,,,,2,1,1,2
C1(C2C(C(CC2O)O1)O)O,,,5,1,2,0,2
74755_1,,,,2,1,1,2
74757_0,,,,2,1,1,2
C(C1(C2C(C(C1C(O)O2)O)O)O)=O,,,5,1,2,0,2
74757_1,,,,2,1,1,2
74758_0,,,,2,1,1,2
74758_1,,,,2,1,1,2
74760_0,,,,2,1,1,2
C(C1(C(C2C(C1C(O)O2)O)O)O)=O,,,5,1,2,0,2
74760_1,,,,2,1,1,2
74761_0,,,,2,1,1,2
74761_1,,,,2,1,1,2
74763_0,,,,2,1,1,2
C1(C(C2C(O)OC(C2O)C1O)O)=O,,,5,1,2,0,2
74763_1,,,,2,1,1,2
74764_0,,,,2,1,1,2
74766_0,,,,2,1,1,2
C1(C(C2C(C1O)OC(C2O)O)O)=O,,,5,1,1,0,1
74768_0,,,,2,1,1,2
C(C1C2C(C(C(C2O)(O1)O)O)O)=O,,,5,1,2,0,2
74768_1,,,,2,1,1,2
74769_0,,,,2,1,1,2
74770_0,,,,2,1,1,2
74771_0,,,,2,1,1,2
74771_1,,,,2,1,1,2
74772_0,,,,2,1,1,2
74772_1,,,,2,1,1,2
74773_0,,,,2,1,1,2
74773_1,,,,2,1,1,2
74775_0,,,,2,1,1,2
C12C(C(C(CC1O)(O)O2)O)O,,,5,1,1,0,1
74776_0,,,,2,1,1,2
74776_1,,,,2,1,1,2
74777_0,,,,2,1,1,2
74777_1,,,,2,1,1,2
74778_0,,,,2,1,1,2
74779_0,,,,2,1,1,2
74780_0,,,,2,1,1,2
74780_1,,,,2,1,1,2
74781_0,,,,2,1,1,2
74781_1,,,,2,1,1,2
74782_0,,,,2,1,1,2
74782_1,,,,2,1,1,2
74783_0,,,,2,1,1,2
74783_1,,,,2,1,1,2
74784_0,,,,2,1,1,2
74784_1,,,,2,1,1,2
74785_0,,,,2,1,1,2
74785_1,,,,2,1,1,2
74786_0,,,,2,1,1,2
74786_1,,,,2,1,1,2
74787_0,,,,2,1,1,2
74787_1,,,,2,1,1,2
74788_0,,,,2,1,1,2
74789_0,,,,2,1,1,2
74791_0,,,,2,1,1,2
C(C1(CC2(C(C(C1O2)O)O)O)O)=O,,,5,1,1,0,1
74792_0,,,,2,1,1,2
74792_1,,,,2,1,1,2
74793_0,,,,2,1,1,2
74793_1,,,,2,1,1,2
74794_0,,,,2,1,1,2
74794_1,,,,2,1,1,2
74796_0,,,,2,1,1,2
C1(C2C(CC1O)(C(C(O2)O)O)O)=O,,,5,1,1,0,1
74798_0,,,,2,1,1,2
C(C1C2(C(C(C(C2)O)(O1)O)O)O)=O,,,5,1,2,0,2
74798_1,,,,2,1,1,2
74799_0,,,,2,1,1,2
74799_1,,,,2,1,1,2
74801_0,,,,2,1,1,2
C1(C(C2(C(C1)OC(C2O)O)O)O)=O,,,5,1,1,0,1
74803_0,,,,2,1,1,2
C(C1C2(C(CC(C2O)(O1)O)O)O)=O,,,5,1,2,0,2
74803_1,,,,2,1,1,2
74804_0,,,,2,1,1,2
74806_0,,,,2,1,1,2
C(C1C2C(C(C(O)O2)(C1O)O)O)=O,,,5,1,2,0,2
74806_1,,,,2,1,1,2
74807_0,,,,2,1,1,2
74807_1,,,,2,1,1,2
74808_0,,,,2,1,1,2
74808_1,,,,2,1,1,2
74810_0,,,,2,1,1,2
C1C2(CC(C(C2(CO)O)O)(O)O1)O,,,5,1,2,0,2
74810_1,,,,2,1,1,2
74812_0,,,,2,1,1,2
C1C2(C(C(CC2(CO)O)(O)O1)O)O,,,5,1,2,0,2
74812_1,,,,2,1,1,2
74813_0,,,,2,1,1,2
74813_1,,,,2,1,1,2
74814_0,,,,2,1,1,2
74814_1,,,,2,1,1,2
74815_0,,,,2,1,1,2
74817_0,,,,2,1,1,2
C(C1(CC2(C(C1(CO2)O)O)O)O)=O,,,5,1,2,0,2
74817_1,,,,2,1,1,2
74818_0,,,,2,1,1,2
74818_1,,,,2,1,1,2
74819_0,,,,2,1,1,2
74819_1,,,,2,1,1,2
74821_0,,,,2,1,1,2
C1C2(C(C(CC2O)(O)O1)O)O,,,5,1,2,0,2
74821_1,,,,2,1,1,2
74823_0,,,,2,1,1,2
C(C1C2(C(C(CC2O)(O)O1)O)O)O,,,5,1,2,0,2
74823_1,,,,2,1,1,2
74824_0,,,,2,1,1,2
74824_1,,,,2,1,1,2
74826_0,,,,2,1,1,2
C1C2(C(C(C(CO)C2O)(O)O1)O)O,,,5,1,2,0,2
74826_1,,,,2,1,1,2
74828_0,,,,2,1,1,2
C(C12C(C(C(CC1O)(O)O2)O)O)O,,,5,1,1,0,1
74829_0,,,,2,1,1,2
74830_0,,,,2,1,1,2
74830_1,,,,2,1,1,2
74831_0,,,,2,1,1,2
74831_1,,,,2,1,1,2
74832_0,,,,2,1,1,2
74832_1,,,,2,1,1,2
74833_0,,,,2,1,1,2
74833_1,,,,2,1,1,2
74834_0,,,,2,1,1,2
74834_1,,,,2,1,1,2
74835_0,,,,2,1,1,2
74835_1,,,,2,1,1,2
74836_0,,,,2,1,1,2
74836_1,,,,2,1,1,2
74837_0,,,,2,1,1,2
74839_0,,,,2,1,1,2
C1(C(C2(C(C1)OC(C2)O)O)O)=O,,,5,1,1,0,1
74840_0,,,,2,1,1,2
74840_1,,,,2,1,1,2
74842_0,,,,2,1,1,2
C(C1C2CC(C(O)O2)(C1O)O)=O,,,5,1,2,0,2
74842_1,,,,2,1,1,2
74844_0,,,,2,1,1,2
C(C1(C2CC(C1C(O)O2)O)O)=O,,,5,1,2,0,2
74844_1,,,,2,1,1,2
74846_0,,,,2,1,1,2
C(C1C2CC(C1(C(O)O2)O)O)=O,,,5,1,2,0,2
74846_1,,,,2,1,1,2
74848_0,,,,2,1,1,2
C1(C(C2(C(O)OC(C2)C1O)O)O)=O,,,5,1,2,0,2
74848_1,,,,2,1,1,2
74849_0,,,,2,1,1,2
74850_0,,,,2,1,1,2
74851_0,,,,2,1,1,2
74853_0,,,,2,1,1,2
C1C(CO)(C(C(O)O1)C(C)O)O,,,5,1,1,0,1
74854_0,,,,2,1,1,2
74856_0,,,,2,1,1,2
C1C(C(C(O)O1)C(CO)(CO)O)O,,,5,1,1,0,1
74857_0,,,,2,1,1,2
74858_0,,,,2,1,1,2
74860_0,,,,2,1,1,2
C(CO)(C1C(C(C(O1)O)CO)O)=O,,,5,1,1,0,1
74862_0,,,,2,1,1,2
CC(C1C(CO)(CC(O)O1)O)O,,,5,1,1,0,1
74864_0,,,,2,1,1,2
CC(C(C1(COC(C1)O)O)O)O,,,5,1,1,0,1
74866_0,,,,2,1,1,2
CC(C1C(CO)(C(C(O)O1)O)O)O,,,5,1,1,0,1
74867_0,,,,2,1,1,2
74868_0,,,,2,1,1,2
74869_0,,,,2,1,1,2
74870_0,,,,2,1,1,2
74871_0,,,,2,1,1,2
74872_0,,,,2,1,1,2
74873_0,,,,2,1,1,2
74874_0,,,,2,1,1,2
74875_0,,,,2,1,1,2
74876_0,,,,2,1,1,2
74878_0,,,,2,1,1,2
C(C(C1(CC(O)OC1CO)O)O)O,,,5,1,1,0,1
74879_0,,,,2,1,1,2
74880_0,,,,2,1,1,2
74881_0,,,,2,1,1,2
74882_0,,,,2,1,1,2
74884_0,,,,2,1,1,2
C1(C(C(C(O)=O)C(C=O)(O)O1)O)=O,,,5,1,1,0,1
74885_0,,,,2,1,1,2
74886_0,,,,2,1,1,2
74888_0,,,,2,1,1,2
C1(C(C(C(C)O)C(C=O)(O)O1)O)=O,,,5,1,1,0,1
74889_0,,,,2,1,1,2
74890_0,,,,2,1,1,2
74892_0,,,,2,1,1,2
C1(C(C(C(O)O1)C(CCO)O)O)=O,,,5,1,1,0,1
74894_0,,,,2,1,1,2
C(C(C1C(O)OCC1(C)O)O)(O)=O,,,5,1,1,0,1
74896_0,,,,2,1,1,2
C1(C(C(C(O)O1)C(CO)(C)O)O)=O,,,5,1,1,0,1
74897_0,,,,2,1,1,2
74899_0,,,,2,1,1,2
C(C(C1C(O)OC(C1O)O)O)(O)=O,,,5,1,1,0,1
74901_0,,,,2,1,1,2
C1(C(C(C(O)O1)C(C(O)O)O)O)=O,,,5,1,1,0,1
74903_0,,,,2,1,1,2
C(C(C1C(O)OC(C)C1O)O)(O)=O,,,5,1,1,0,1
74905_0,,,,2,1,1,2
C1(C(C(C(O)O1)C(C(C)O)O)O)=O,,,5,1,1,0,1
74906_0,,,,2,1,1,2
74907_0,,,,2,1,1,2
74909_0,,,,2,1,1,2
C(C(C)(C1C(O)OC(C1O)=O)O)=O,,,5,1,1,0,1
74910_0,,,,2,1,1,2
74912_0,,,,2,1,1,2
C1(C(C(C(O)O1)C(C(C)=O)O)O)=O,,,5,1,1,0,1
74914_0,,,,2,1,1,2
C1(C(C(C(O)O1)C(C)O)O)=O,,,5,1,1,0,1
74915_0,,,,2,1,1,2
74916_0,,,,2,1,1,2
74917_0,,,,2,1,1,2
74918_0,,,,2,1,1,2
74920_0,,,,2,1,1,2
C(C1(CC(C)(C(O1)O)O)CC=O)=O,,,5,1,1,0,1
74921_0,,,,2,1,1,2
74923_0,,,,2,1,1,2
C(CC1C(C)(CC(C=O)(O)O1)O)=O,,,5,1,1,0,1
74924_0,,,,2,1,1,2
74926_0,,,,2,1,1,2
C(C(CC1(C)C(CC(O)O1)O)=O)=O,,,5,1,1,0,1
74927_0,,,,2,1,1,2
74928_0,,,,2,1,1,2
74930_0,,,,2,1,1,2
C1(C(C(C=O)=O)C(C)(C(O)O1)O)=O,,,5,1,1,0,1
74931_0,,,,2,1,1,2
74932_0,,,,2,1,1,2
74934_0,,,,2,1,1,2
C(C(C1C(C)OC(C1(C)O)O)=O)=O,,,5,1,1,0,1
74936_0,,,,2,1,1,2
C(C1C(CC=O)OC(C1(C)O)O)=O,,,5,1,1,0,1
74938_0,,,,2,1,1,2
C(C1C(O)OC(C1(C)O)CC=O)=O,,,5,1,1,0,1
74940_0,,,,2,1,1,2
C(C(C=O)C1(C)C(CC(O)O1)O)=O,,,5,1,1,0,1
74942_0,,,,2,1,1,2
C(C(CO)C1CC(C)(C(O)O1)O)=O,,,5,1,1,0,1
74944_0,,,,2,1,1,2
C(C)(C(C1CC(C(O)O1)(C)O)O)=O,,,5,1,1,0,1
74946_0,,,,2,1,1,2
C(CO)(CC1CC(C(O)O1)(C)O)=O,,,5,1,1,0,1
74948_0,,,,2,1,1,2
C(C(C)(CC1CC(C(O)O1)=O)O)=O,,,5,1,1,0,1
74950_0,,,,2,1,1,2
C(C(CC1CC(C)(C(O)O1)O)=O)=O,,,5,1,1,0,1
74952_0,,,,2,1,1,2
C(C(C=O)C1CC(C)(C(O)O1)O)=O,,,5,1,1,0,1
74954_0,,,,2,1,1,2
C(CC1CC(C)(C(O)O1)O)=O,,,5,1,1,0,1
74956_0,,,,2,1,1,2
C(C(C1CC(C(O)O1)(C)O)O)=O,,,5,1,1,0,1
74958_0,,,,2,1,1,2
C(C(CO)C1C(C)(CC(O)O1)O)=O,,,5,1,1,0,1
74960_0,,,,2,1,1,2
C(CC1(C)C(C(C(O)O1)CO)O)=O,,,5,1,1,0,1
74962_0,,,,2,1,1,2
C(C)(C(C1C(C)(CC(O)O1)O)O)=O,,,5,1,1,0,1
74964_0,,,,2,1,1,2
C(CC1(C)C(C(C(C)(O)O1)O)O)=O,,,5,1,1,0,1
74966_0,,,,2,1,1,2
C(CO)(CC1C(C)(CC(O)O1)O)=O,,,5,1,1,0,1
74968_0,,,,2,1,1,2
C(CC1(C)C(CC(CO)(O)O1)O)=O,,,5,1,1,0,1
74969_0,,,,2,1,1,2
74971_0,,,,2,1,1,2
C(C(CC1C(C)(CC(O)O1)O)=O)=O,,,5,1,1,0,1
74973_0,,,,2,1,1,2
C(CC1(C)C(CC(C=O)(O)O1)O)=O,,,5,1,1,0,1
74975_0,,,,2,1,1,2
C(C(C=O)C1C(C)(CC(O)O1)O)=O,,,5,1,1,0,1
74977_0,,,,2,1,1,2
C(C1C(O)OC(C)(C1O)CC=O)=O,,,5,1,1,0,1
74979_0,,,,2,1,1,2
C(CC1C(C)(CC(O)O1)O)=O,,,5,1,1,0,1
74981_0,,,,2,1,1,2
C(CC1(C)C(CC(O)O1)O)=O,,,5,1,1,0,1
74983_0,,,,2,1,1,2
C(C(C1C(C)(CC(O)O1)O)O)=O,,,5,1,1,0,1
74985_0,,,,2,1,1,2
C(CC1(C)C(C(C(O)O1)O)O)=O,,,5,1,1,0,1
74987_0,,,,2,1,1,2
C(C1C(CCO)OC(C1(C)O)O)=O,,,5,1,1,0,1
74989_0,,,,2,1,1,2
C(C(C)(C1C(O)OCC1(C)O)O)=O,,,5,1,1,0,1
74991_0,,,,2,1,1,2
C(C1C(C)(CO)OC(C1(C)O)O)=O,,,5,1,1,0,1
74992_0,,,,2,1,1,2
74994_0,,,,2,1,1,2
C(C(C)(C1C(O)OC(C1O)O)O)=O,,,5,1,1,0,1
74996_0,,,,2,1,1,2
C(C1C(C(O)O)OC(C1(C)O)O)=O,,,5,1,1,0,1
74998_0,,,,2,1,1,2
C(C(C)(C1C(O)OC(C)C1O)O)=O,,,5,1,1,0,1
75000_0,,,,2,1,1,2
C(C1C(C(C)O)OC(C1(C)O)O)=O,,,5,1,1,0,1
75002_0,,,,2,1,1,2
C(C1C(C)(C(OC1(C=O)C)O)O)=O,,,5,1,1,0,1
75004_0,,,,2,1,1,2
C(C1C(C(C)(OC1(C=O)C)O)O)=O,,,5,1,1,0,1
75006_0,,,,2,1,1,2
C(C1C(C)(C(OC1C(C)=O)O)O)=O,,,5,1,1,0,1
75008_0,,,,2,1,1,2
C(C1C(C)OC(C1(C)O)O)=O,,,5,1,1,0,1
75010_0,,,,2,1,1,2
C(C1COC(C1(C)O)O)=O,,,5,1,1,0,1
75012_0,,,,2,1,1,2
C(C(C)(C1C(O)OCC1O)O)=O,,,5,1,1,0,1
75013_0,,,,2,1,1,2
75015_0,,,,2,1,1,2
C(CC1C(C(C)(C(O)O1)O)O)=O,,,5,1,1,0,1
75017_0,,,,2,1,1,2
C(C(C)(C1C(CC(O)O1)O)O)=O,,,5,1,1,0,1
75019_0,,,,2,1,1,2
C(C(C1C(C(C(O)O1)(C)O)O)O)=O,,,5,1,1,0,1
75020_0,,,,2,1,1,2
75022_0,,,,2,1,1,2
C(CC1C(C)(C(C(O)O1)O)O)=O,,,5,1,1,0,1
75024_0,,,,2,1,1,2
C(C(C1(C)C(CC(O)O1)O)O)=O,,,5,1,1,0,1
75025_0,,,,2,1,1,2
75026_0,,,,2,1,1,2
75028_0,,,,2,1,1,2
C(C1(CC(C(C)(O1)O)O)CC=O)=O,,,5,1,1,0,1
75029_0,,,,2,1,1,2
75030_0,,,,2,1,1,2
75031_0,,,,2,1,1,2
75033_0,,,,2,1,1,2
C1(C(C(C=O)=O)C(C(C)(O)O1)O)=O,,,5,1,1,0,1
75034_0,,,,2,1,1,2
75035_0,,,,2,1,1,2
75037_0,,,,2,1,1,2
C(C(C1C(C)OC(C)(C1O)O)=O)=O,,,5,1,1,0,1
75038_0,,,,2,1,1,2
75039_0,,,,2,1,1,2
75041_0,,,,2,1,1,2
C(C1C(CC=O)OC(C)(C1O)O)=O,,,5,1,1,0,1
75043_0,,,,2,1,1,2
C(C(CO)C1CC(C(C)(O)O1)O)=O,,,5,1,1,0,1
75045_0,,,,2,1,1,2
C(C)(C(C1CC(C(C)(O)O1)O)O)=O,,,5,1,1,0,1
75047_0,,,,2,1,1,2
C(CO)(CC1CC(C(C)(O)O1)O)=O,,,5,1,1,0,1
75049_0,,,,2,1,1,2
C(C)(C(CC1CC(C(O)O1)=O)O)=O,,,5,1,1,0,1
75051_0,,,,2,1,1,2
C(C(CC1CC(C(C)(O)O1)O)=O)=O,,,5,1,1,0,1
75053_0,,,,2,1,1,2
C(C(C=O)C1CC(C(C)(O)O1)O)=O,,,5,1,1,0,1
75055_0,,,,2,1,1,2
C(CC1CC(C(C)(O)O1)O)=O,,,5,1,1,0,1
75057_0,,,,2,1,1,2
C(C(C1CC(C(C)(O)O1)O)O)=O,,,5,1,1,0,1
75059_0,,,,2,1,1,2
C(C(CO)C1(C)C(CC(O)O1)O)=O,,,5,1,1,0,1
75061_0,,,,2,1,1,2
C(CC1C(C)(C(C(O)O1)CO)O)=O,,,5,1,1,0,1
75063_0,,,,2,1,1,2
C(C)(C(C1(C)C(CC(O)O1)O)O)=O,,,5,1,1,0,1
75065_0,,,,2,1,1,2
C(CC1C(C)(C(C(C)(O)O1)O)O)=O,,,5,1,1,0,1
75067_0,,,,2,1,1,2
C(CO)(CC1(C)C(CC(O)O1)O)=O,,,5,1,1,0,1
75069_0,,,,2,1,1,2
C(CC1C(C)(CC(CO)(O)O1)O)=O,,,5,1,1,0,1
75071_0,,,,2,1,1,2
C(C1C(CCO)OC(C)(C1O)O)=O,,,5,1,1,0,1
75073_0,,,,2,1,1,2
C(C)(C(C1C(O)OCC1(C)O)O)=O,,,5,1,1,0,1
75075_0,,,,2,1,1,2
C(C1C(C(C)(O)OC1(C)CO)O)=O,,,5,1,1,0,1
75076_0,,,,2,1,1,2
75078_0,,,,2,1,1,2
C(C)(C(C1C(O)OC(C1O)O)O)=O,,,5,1,1,0,1
75080_0,,,,2,1,1,2
C(C1C(C(O)O)OC(C)(C1O)O)=O,,,5,1,1,0,1
75082_0,,,,2,1,1,2
C(C)(C(C1C(O)OC(C)C1O)O)=O,,,5,1,1,0,1
75084_0,,,,2,1,1,2
C(C1C(C(C)O)OC(C)(C1O)O)=O,,,5,1,1,0,1
75086_0,,,,2,1,1,2
C(C1C(C(C)(OC1C(C)=O)O)O)=O,,,5,1,1,0,1
75088_0,,,,2,1,1,2
C(C1C(C)OC(C)(C1O)O)=O,,,5,1,1,0,1
75090_0,,,,2,1,1,2
C(C1COC(C)(C1O)O)=O,,,5,1,1,0,1
75092_0,,,,2,1,1,2
C(C)(C(C1C(O)OCC1O)O)=O,,,5,1,1,0,1
75093_0,,,,2,1,1,2
75095_0,,,,2,1,1,2
C(CC(C1(CC(CO1)(C)O)O)O)=O,,,5,1,1,0,1
75097_0,,,,2,1,1,2
C(CC(C1(CC(C(O)O1)O)O)O)=O,,,5,1,1,0,1
75099_0,,,,2,1,1,2
C(CC(C1(CC(C(C)O1)O)O)O)=O,,,5,1,1,0,1
75100_0,,,,2,1,1,2
75102_0,,,,2,1,1,2
C(CC1C(C(C(C)(O)O1)O)O)=O,,,5,1,1,0,1
75103_0,,,,2,1,1,2
75104_0,,,,2,1,1,2
75105_0,,,,2,1,1,2
75106_0,,,,2,1,1,2
75107_0,,,,2,1,1,2
75108_0,,,,2,1,1,2
75109_0,,,,2,1,1,2
75110_0,,,,2,1,1,2
75111_0,,,,2,1,1,2
75112_0,,,,2,1,1,2
75113_0,,,,2,1,1,2
75114_0,,,,2,1,1,2
75115_0,,,,2,1,1,2
75117_0,,,,2,1,1,2
C(C1COC(C1(CC(C)O)O)O)=O,,,5,1,1,0,1
75118_0,,,,2,1,1,2
75119_0,,,,2,1,1,2
75120_0,,,,2,1,1,2
75122_0,,,,2,1,1,2
C(C1(CC(C)O)CC(C(O1)O)=O)=O,,,5,1,1,0,1
75123_0,,,,2,1,1,2
75124_0,,,,2,1,1,2
75125_0,,,,2,1,1,2
75126_0,,,,2,1,1,2
75128_0,,,,2,1,1,2
C(C1COC(C1O)(CC(C)O)O)=O,,,5,1,1,0,1
75129_0,,,,2,1,1,2
75131_0,,,,2,1,1,2
C1(C(O)OC(CCO)C1C(C)O)=O,,,5,1,1,0,1
75133_0,,,,2,1,1,2
C(C1(C(C(C)O)C(CO1)(C)O)O)=O,,,5,1,1,0,1
75134_0,,,,2,1,1,2
75136_0,,,,2,1,1,2
C1(C(O)OC(CO)(C)C1C(C)O)=O,,,5,1,1,0,1
75137_0,,,,2,1,1,2
75138_0,,,,2,1,1,2
75140_0,,,,2,1,1,2
C(C1(C(C(C)O)C(C(O1)O)O)O)=O,,,5,1,1,0,1
75141_0,,,,2,1,1,2
75143_0,,,,2,1,1,2
C1(C(O)OC(C(O)O)C1C(C)O)=O,,,5,1,1,0,1
75145_0,,,,2,1,1,2
C(C1(C(C(C(C)O1)O)C(C)O)O)=O,,,5,1,1,0,1
75146_0,,,,2,1,1,2
75148_0,,,,2,1,1,2
C1(C(O)OC(C(C)O)C1C(C)O)=O,,,5,1,1,0,1
75150_0,,,,2,1,1,2
C(C(C1C(C)OC(C1O)O)=O)=O,,,5,1,1,0,1
75151_0,,,,2,1,1,2
75152_0,,,,2,1,1,2
75153_0,,,,2,1,1,2
75155_0,,,,2,1,1,2
C(C1(C(C(C)O)C(CO1)O)O)=O,,,5,1,1,0,1
75156_0,,,,2,1,1,2
75157_0,,,,2,1,1,2
75159_0,,,,2,1,1,2
C(C1(CC(C(O1)O)O)CC=O)=O,,,5,1,1,0,1
75160_0,,,,2,1,1,2
75162_0,,,,2,1,1,2
C(C1(CC(C(O1)O)O)C(C=O)O)=O,,,5,1,1,0,1
75163_0,,,,2,1,1,2
75164_0,,,,2,1,1,2
75165_0,,,,2,1,1,2
75166_0,,,,2,1,1,2
75168_0,,,,2,1,1,2
C(C1C(C(C=O)=O)C(C(O1)O)O)=O,,,5,1,1,0,1
75169_0,,,,2,1,1,2
75171_0,,,,2,1,1,2
C(C(C1C(COC1(C=O)O)O)O)=O,,,5,1,1,0,1
75172_0,,,,2,1,1,2
75174_0,,,,2,1,1,2
C(C(C1C(CO)OC(C1O)O)=O)=O,,,5,1,1,0,1
75175_0,,,,2,1,1,2
75176_0,,,,2,1,1,2
75177_0,,,,2,1,1,2
75178_0,,,,2,1,1,2
75179_0,,,,2,1,1,2
75180_0,,,,2,1,1,2
75182_0,,,,2,1,1,2
C(C1(C(C(CO)O)C(CO1)O)O)=O,,,5,1,1,0,1
75183_0,,,,2,1,1,2
75185_0,,,,2,1,1,2
C(CC(C1C(O)OCC1(C)O)O)=O,,,5,1,1,0,1
75187_0,,,,2,1,1,2
C(CC(C1C(O)OC(C1O)O)O)=O,,,5,1,1,0,1
75189_0,,,,2,1,1,2
C(CC(C1C(O)OC(C)C1O)O)=O,,,5,1,1,0,1
75190_0,,,,2,1,1,2
75192_0,,,,2,1,1,2
C(C(C1C(C(CO)C(O1)O)O)=O)=O,,,5,1,1,0,1
75193_0,,,,2,1,1,2
75194_0,,,,2,1,1,2
75195_0,,,,2,1,1,2
75196_0,,,,2,1,1,2
75198_0,,,,2,1,1,2
C(C1C(C(C=O)OC1O)O)(O)=O,,,5,1,1,0,1
75200_0,,,,2,1,1,2
C(C(C1C(OC(C=O)C1O)O)O)=O,,,5,1,1,0,1
75201_0,,,,2,1,1,2
75203_0,,,,2,1,1,2
C(C1C(C(C(O1)O)C(C)O)O)=O,,,5,1,1,0,1
75205_0,,,,2,1,1,2
C(C1C(C(CO)C(O1)O)O)=O,,,5,1,1,0,1
75206_0,,,,2,1,1,2
75208_0,,,,2,1,1,2
C(C1C(C(C(O1)O)C(CO)O)O)=O,,,5,1,1,0,1
75210_0,,,,2,1,1,2
C(C)(C1C(C(C(O1)O)C(C)O)O)=O,,,5,1,1,0,1
75211_0,,,,2,1,1,2
75213_0,,,,2,1,1,2
C(CC1CC(C(O)O1)(CCO)O)=O,,,5,1,1,0,1
75214_0,,,,2,1,1,2
75216_0,,,,2,1,1,2
C(CC1C(CC(O)O1)(CCO)O)=O,,,5,1,1,0,1
75218_0,,,,2,1,1,2
C(CC1(CCO)C(CC(O)O1)O)=O,,,5,1,1,0,1
75220_0,,,,2,1,1,2
C1(C(C=O)C(C(O)O1)(CCO)O)=O,,,5,1,1,0,1
75221_0,,,,2,1,1,2
75223_0,,,,2,1,1,2
C(C1C(C)OC(C1(CCO)O)O)=O,,,5,1,1,0,1
75224_0,,,,2,1,1,2
75226_0,,,,2,1,1,2
C(C1COC(C1(CCO)O)O)=O,,,5,1,1,0,1
75227_0,,,,2,1,1,2
75229_0,,,,2,1,1,2
C(CC1CC(C(CCO)(O)O1)O)=O,,,5,1,1,0,1
75231_0,,,,2,1,1,2
C1(C(C=O)C(C(CCO)(O)O1)O)=O,,,5,1,1,0,1
75233_0,,,,2,1,1,2
C(C1C(C)OC(C1O)(CCO)O)=O,,,5,1,1,0,1
75235_0,,,,2,1,1,2
C(C1COC(C1O)(CCO)O)=O,,,5,1,1,0,1
75236_0,,,,2,1,1,2
75237_0,,,,2,1,1,2
75238_0,,,,2,1,1,2
75239_0,,,,2,1,1,2
75240_0,,,,2,1,1,2
75241_0,,,,2,1,1,2
75242_0,,,,2,1,1,2
75243_0,,,,2,1,1,2
75245_0,,,,2,1,1,2
C(CC1C(C(C(O)O1)C(C)O)O)=O,,,5,1,1,0,1
75246_0,,,,2,1,1,2
75247_0,,,,2,1,1,2
75248_0,,,,2,1,1,2
75249_0,,,,2,1,1,2
75250_0,,,,2,1,1,2
75251_0,,,,2,1,1,2
75253_0,,,,2,1,1,2
C(CC1C(C(C)O)C(C(O)O1)O)=O,,,5,1,1,0,1
75254_0,,,,2,1,1,2
75255_0,,,,2,1,1,2
75256_0,,,,2,1,1,2
75258_0,,,,2,1,1,2
C(C(C1C(CO)C(C(O)O1)O)O)=O,,,5,1,1,0,1
75259_0,,,,2,1,1,2
75260_0,,,,2,1,1,2
75262_0,,,,2,1,1,2
C(C1C(C(CO)C(CO)(O1)O)O)=O,,,5,1,1,0,1
75264_0,,,,2,1,1,2
C(C1C(CC(C(CO)O)(O1)O)O)=O,,,5,1,1,0,1
75265_0,,,,2,1,1,2
75266_0,,,,2,1,1,2
75267_0,,,,2,1,1,2
75268_0,,,,2,1,1,2
75269_0,,,,2,1,1,2
75270_0,,,,2,1,1,2
75272_0,,,,2,1,1,2
C(C1C(CO)(C(CO)C(O1)O)O)=O,,,5,1,1,0,1
75273_0,,,,2,1,1,2
75274_0,,,,2,1,1,2
75275_0,,,,2,1,1,2
75276_0,,,,2,1,1,2
75277_0,,,,2,1,1,2
75278_0,,,,2,1,1,2
75279_0,,,,2,1,1,2
75280_0,,,,2,1,1,2
75281_0,,,,2,1,1,2
75282_0,,,,2,1,1,2
75283_0,,,,2,1,1,2
75284_0,,,,2,1,1,2
75286_0,,,,2,1,1,2
C(C1C(COC1(C(CO)O)O)O)=O,,,5,1,1,0,1
75287_0,,,,2,1,1,2
75288_0,,,,2,1,1,2
75289_0,,,,2,1,1,2
75290_0,,,,2,1,1,2
75292_0,,,,2,1,1,2
C(C1C(CC(O1)O)(C(CO)O)O)=O,,,5,1,1,0,1
75294_0,,,,2,1,1,2
C(CC1(C(CO)OC(C1O)O)O)=O,,,5,1,1,0,1
75295_0,,,,2,1,1,2
75296_0,,,,2,1,1,2
75297_0,,,,2,1,1,2
75298_0,,,,2,1,1,2
75299_0,,,,2,1,1,2
75300_0,,,,2,1,1,2
75301_0,,,,2,1,1,2
75302_0,,,,2,1,1,2
75304_0,,,,2,1,1,2
C(C1C(C(C(CCO)(O1)O)O)O)=O,,,5,1,1,0,1
75305_0,,,,2,1,1,2
75306_0,,,,2,1,1,2
75308_0,,,,2,1,1,2
C(C1C(C)(C(C(O1)O)C(C)O)O)=O,,,5,1,1,0,1
75309_0,,,,2,1,1,2
75311_0,,,,2,1,1,2
C(C1C(CC(C)O)(CC(O1)O)O)=O,,,5,1,1,0,1
75313_0,,,,2,1,1,2
C(C(C(C1COC(C1O)O)=O)O)=O,,,5,1,1,0,1
75315_0,,,,2,1,1,2
C(C1C(CC(O1)O)(CCO)O)=O,,,5,1,1,0,1
75317_0,,,,2,1,1,2
C(C1C(C(C(O1)O)O)(CCO)O)=O,,,5,1,1,0,1
75319_0,,,,2,1,1,2
C(C(C1(C(CO)C(CO1)O)O)O)=O,,,5,1,1,0,1
75321_0,,,,2,1,1,2
CC(CC(C1C(O)OCC1O)O)O,,,5,1,1,0,1
75323_0,,,,2,1,1,2
C1(C(C)(O)OC(CC(C)O)C1O)=O,,,5,1,1,0,1
75325_0,,,,2,1,1,2
C1(C(CO)(O)OC(CC(C)O)C1)=O,,,5,1,1,0,1
75327_0,,,,2,1,1,2
C(C1C(C(O)OC1CC(C)O)=O)=O,,,5,1,1,0,1
75329_0,,,,2,1,1,2
C(C1(C(CC(CC(C)O)O1)=O)O)=O,,,5,1,1,0,1
75331_0,,,,2,1,1,2
C1(C(O)OC(CC(C)O)C1)=O,,,5,1,1,0,1
75333_0,,,,2,1,1,2
C1(C(O)OC(CC(C)O)C1CO)=O,,,5,1,1,0,1
75334_0,,,,2,1,1,2
75336_0,,,,2,1,1,2
C(C1C(CC(C)O)OC(C1O)O)=O,,,5,1,1,0,1
75337_0,,,,2,1,1,2
75338_0,,,,2,1,1,2
75340_0,,,,2,1,1,2
C1(C(O)OC(CC(C)O)C1O)=O,,,5,1,1,0,1
75342_0,,,,2,1,1,2
CC(C1C(C(C(O)O1)C(C)O)O)O,,,5,1,1,0,1
75344_0,,,,2,1,1,2
C(C)(C1(COC(C1C(C)O)O)O)=O,,,5,1,1,0,1
75346_0,,,,2,1,1,2
C(C1C(C)OC(C)(C1(CO)O)O)=O,,,5,1,1,0,1
75348_0,,,,2,1,1,2
C(C1C(C)OC(CO)(C1(C)O)O)=O,,,5,1,1,0,1
75350_0,,,,2,1,1,2
C(C1(C(C)OC(C1C(C)O)O)O)=O,,,5,1,1,0,1
75352_0,,,,2,1,1,2
C(C1C(C)OC(C1(C(C)O)O)O)=O,,,5,1,1,0,1
75354_0,,,,2,1,1,2
C(C1C(C)OC(C1O)(C(C)O)O)=O,,,5,1,1,0,1
75356_0,,,,2,1,1,2
C1C(C)(C(C(O)O1)C(C)O)O,,,5,1,1,0,1
75358_0,,,,2,1,1,2
C1C(CCO)(C(C(O)O1)C(C)O)O,,,5,1,1,0,1
75360_0,,,,2,1,1,2
CC(C1C(O)OC(CCO)C1O)O,,,5,1,1,0,1
75362_0,,,,2,1,1,2
CC1(C(CO)OC(C1C(C)O)O)O,,,5,1,1,0,1
75364_0,,,,2,1,1,2
C1(C(C)(C(C(O)O1)C(C)O)O)=O,,,5,1,1,0,1
75366_0,,,,2,1,1,2
C1(C(CO)(C(C(O)O1)C(C)O)O)=O,,,5,1,1,0,1
75368_0,,,,2,1,1,2
C(C1(COC(C1C(C)O)O)O)(O)=O,,,5,1,1,0,1
75370_0,,,,2,1,1,2
C(C1C(C)OC(C1(CC=O)O)O)=O,,,5,1,1,0,1
75372_0,,,,2,1,1,2
C(C1C(C)OC(C1O)(CC=O)O)=O,,,5,1,1,0,1
75374_0,,,,2,1,1,2
C(C(C(C)O)C1C(CC(O1)O)=O)=O,,,5,1,1,0,1
75376_0,,,,2,1,1,2
C1C2(C(CO1)OC(C2C(C)O)O)O,,,5,1,1,0,1
75378_0,,,,2,1,1,2
C12C(CCO1)(C(C(O)O2)C(C)O)O,,,5,1,1,0,1
75380_0,,,,2,1,1,2
C(C1C(C)OC(C1(C(C)=O)O)O)=O,,,5,1,1,0,1
75382_0,,,,2,1,1,2
C(C1C(C)OC(C)(C1(C=O)O)O)=O,,,5,1,1,0,1
75384_0,,,,2,1,1,2
C(C1C(C(C(C)=O)(O)OC1C)O)=O,,,5,1,1,0,1
75386_0,,,,2,1,1,2
C(C1C(C)OC(C=O)(C1(C)O)O)=O,,,5,1,1,0,1
75388_0,,,,2,1,1,2
C(C1C(C)OC(C1(C=C)O)O)=O,,,5,1,1,0,1
75390_0,,,,2,1,1,2
C(C1C(C(C=C)(O)OC1C)O)=O,,,5,1,1,0,1
75392_0,,,,2,1,1,2
CC(C1C(O)OC(C1O)O)O,,,5,1,1,0,1
75394_0,,,,2,1,1,2
CC(C1C(O)OC(C)C1O)O,,,5,1,1,0,1
75396_0,,,,2,1,1,2
CC(C1C(O)OC(CO)C1O)O,,,5,1,1,0,1
75398_0,,,,2,1,1,2
C(C1(COC(C1C(C)O)O)O)=O,,,5,1,1,0,1
75400_0,,,,2,1,1,2
C(C1C(C)OC(C1(CO)O)O)=O,,,5,1,1,0,1
75402_0,,,,2,1,1,2
C(C1C(C)OC(CO)(C1O)O)=O,,,5,1,1,0,1
75404_0,,,,2,1,1,2
C1C(C(C(O)O1)C(C)O)O,,,5,1,1,0,1
75406_0,,,,2,1,1,2
C(C1(CC(O)OC1C(C)O)O)=O,,,5,1,1,0,1
75407_0,,,,2,1,1,2
75409_0,,,,2,1,1,2
C(C1(C(C(O)OC1C(C)O)O)O)=O,,,5,1,1,0,1
75410_0,,,,2,1,1,2
75412_0,,,,2,1,1,2
CC(C1C(C(C(O)O1)CO)O)O,,,5,1,1,0,1
75414_0,,,,2,1,1,2
CC(C1C(C(C(C)(O)O1)O)O)O,,,5,1,1,0,1
75416_0,,,,2,1,1,2
CC(C1C(CC(CO)(O)O1)O)O,,,5,1,1,0,1
75418_0,,,,2,1,1,2
C(C1(CC(C(C(C)O)O1)O)O)(O)=O,,,5,1,1,0,1
75420_0,,,,2,1,1,2
C(C1C(O)OC(C1O)C(C)O)(O)=O,,,5,1,1,0,1
75422_0,,,,2,1,1,2
CC(C1C(C(C(CO)(O)O1)O)O)O,,,5,1,1,0,1
75424_0,,,,2,1,1,2
C1(C(O)OC(C(C(C)O)O)C1)=O,,,5,1,1,0,1
75426_0,,,,2,1,1,2
C(C1(CC(C(C(C)O)O1)O)O)=O,,,5,1,1,0,1
75428_0,,,,2,1,1,2
C(C1C(O)OC(C1O)C(C)O)=O,,,5,1,1,0,1
75430_0,,,,2,1,1,2
CC(C1C(CC(O)O1)O)O,,,5,1,1,0,1
75432_0,,,,2,1,1,2
C1(C(O)OC(C(C(C)O)O)C1O)=O,,,5,1,1,0,1
75434_0,,,,2,1,1,2
C(C1(C(C(C(C(C)O)O1)O)O)O)=O,,,5,1,1,0,1
75435_0,,,,2,1,1,2
75436_0,,,,2,1,1,2
75437_0,,,,2,1,1,2
75438_0,,,,2,1,1,2
75440_0,,,,2,1,1,2
C(CC1CC(C(O)O1)(CO)O)=O,,,5,1,1,0,1
75442_0,,,,2,1,1,2
C(C(C1CC(C(O)O1)(CO)O)O)=O,,,5,1,1,0,1
75443_0,,,,2,1,1,2
75444_0,,,,2,1,1,2
75445_0,,,,2,1,1,2
75446_0,,,,2,1,1,2
75447_0,,,,2,1,1,2
75448_0,,,,2,1,1,2
75449_0,,,,2,1,1,2
75451_0,,,,2,1,1,2
C(CC1CC(C(CO)(O)O1)O)=O,,,5,1,1,0,1
75453_0,,,,2,1,1,2
C(C(C1CC(C(CO)(O)O1)O)O)=O,,,5,1,1,0,1
75454_0,,,,2,1,1,2
75455_0,,,,2,1,1,2
75456_0,,,,2,1,1,2
75458_0,,,,2,1,1,2
C(CO)(C(C1C(O)OCC1O)O)=O,,,5,1,1,0,1
75459_0,,,,2,1,1,2
75460_0,,,,2,1,1,2
75461_0,,,,2,1,1,2
75463_0,,,,2,1,1,2
C(C1COC(C1(C(CO)O)O)O)=O,,,5,1,1,0,1
75465_0,,,,2,1,1,2
C(C1COC(C1O)(C(CO)O)O)=O,,,5,1,1,0,1
75466_0,,,,2,1,1,2
75467_0,,,,2,1,1,2
75469_0,,,,2,1,1,2
C1C(C(C(O)O1)C(C(CO)O)O)O,,,5,1,1,0,1
75470_0,,,,2,1,1,2
75471_0,,,,2,1,1,2
75473_0,,,,2,1,1,2
C1C(C(C(O)O1)C(CCO)O)O,,,5,1,1,0,1
75474_0,,,,2,1,1,2
75476_0,,,,2,1,1,2
C1(C(C)(O)OC(CCO)C1O)=O,,,5,1,1,0,1
75478_0,,,,2,1,1,2
C1(C(CO)(O)OC(CCO)C1)=O,,,5,1,1,0,1
75480_0,,,,2,1,1,2
C(C1C(C(O)OC1CCO)=O)=O,,,5,1,1,0,1
75482_0,,,,2,1,1,2
C(C1C(C(O)OC1CCO)=O)(O)=O,,,5,1,1,0,1
75483_0,,,,2,1,1,2
75484_0,,,,2,1,1,2
75486_0,,,,2,1,1,2
C(C1(C(CC(CCO)O1)=O)O)=O,,,5,1,1,0,1
75487_0,,,,2,1,1,2
75488_0,,,,2,1,1,2
75489_0,,,,2,1,1,2
75490_0,,,,2,1,1,2
75491_0,,,,2,1,1,2
75492_0,,,,2,1,1,2
75493_0,,,,2,1,1,2
75495_0,,,,2,1,1,2
C(C1COC(C1O)(C(C=O)O)O)=O,,,5,1,1,0,1
75497_0,,,,2,1,1,2
C(C(CO)C1C(C(C(O1)O)O)=O)=O,,,5,1,1,0,1
75499_0,,,,2,1,1,2
C(C1(C(C(OC1C=O)O)CO)O)=O,,,5,1,1,0,1
75500_0,,,,2,1,1,2
75502_0,,,,2,1,1,2
C(C)(C1(COC(C1CO)O)O)=O,,,5,1,1,0,1
75504_0,,,,2,1,1,2
C(C1COC(C)(C1(CO)O)O)=O,,,5,1,1,0,1
75506_0,,,,2,1,1,2
C(C1COC(CO)(C1(C)O)O)=O,,,5,1,1,0,1
75508_0,,,,2,1,1,2
C(C1(C(C)OC(C1CO)O)O)=O,,,5,1,1,0,1
75510_0,,,,2,1,1,2
C(C1COC(C1(C(C)O)O)O)=O,,,5,1,1,0,1
75512_0,,,,2,1,1,2
C(C1COC(C1O)(C(C)O)O)=O,,,5,1,1,0,1
75514_0,,,,2,1,1,2
C1C(C)(C(C(O)O1)CO)O,,,5,1,1,0,1
75516_0,,,,2,1,1,2
C1C(CCO)(C(C(O)O1)CO)O,,,5,1,1,0,1
75518_0,,,,2,1,1,2
C1(C(CO)C(C(CCO)O1)O)O,,,5,1,1,0,1
75520_0,,,,2,1,1,2
CC1(C(CO)OC(C1CO)O)O,,,5,1,1,0,1
75522_0,,,,2,1,1,2
C1(C(C)(C(CO)C(O)O1)O)=O,,,5,1,1,0,1
75524_0,,,,2,1,1,2
C1(C(CCO)(C(CO)C(O)O1)O)=O,,,5,1,1,0,1
75526_0,,,,2,1,1,2
C(CC1C(C(C(O)O1)CO)O)(O)=O,,,5,1,1,0,1
75528_0,,,,2,1,1,2
C(CC1(COC(C1CO)O)O)(O)=O,,,5,1,1,0,1
75530_0,,,,2,1,1,2
C(C1C(C)(C(CO)C(O1)O)O)(O)=O,,,5,1,1,0,1
75532_0,,,,2,1,1,2
C1(C(CO)(C(CO)C(O)O1)O)=O,,,5,1,1,0,1
75534_0,,,,2,1,1,2
C(C1(COC(C1CO)O)O)(O)=O,,,5,1,1,0,1
75535_0,,,,2,1,1,2
75536_0,,,,2,1,1,2
75537_0,,,,2,1,1,2
75538_0,,,,2,1,1,2
75540_0,,,,2,1,1,2
C(C1COC(C1(CC(O)=O)O)O)=O,,,5,1,1,0,1
75542_0,,,,2,1,1,2
C(C1COC(C1O)(CC(O)=O)O)=O,,,5,1,1,0,1
75543_0,,,,2,1,1,2
75545_0,,,,2,1,1,2
C1(C(C(CO)C(O)O1)(CC=O)O)=O,,,5,1,1,0,1
75547_0,,,,2,1,1,2
C1C2(C(CO1)OC(C2CO)O)O,,,5,1,1,0,1
75549_0,,,,2,1,1,2
C12C(CCO1)(C(C(O)O2)CO)O,,,5,1,1,0,1
75550_0,,,,2,1,1,2
75551_0,,,,2,1,1,2
75553_0,,,,2,1,1,2
C(C1COC(C(C)=O)(C1O)O)=O,,,5,1,1,0,1
75555_0,,,,2,1,1,2
C(C1COC(C=O)(C1(C)O)O)=O,,,5,1,1,0,1
75557_0,,,,2,1,1,2
C(C1COC(C1(C=C)O)O)=O,,,5,1,1,0,1
75559_0,,,,2,1,1,2
C(C1COC(C=C)(C1O)O)=O,,,5,1,1,0,1
75561_0,,,,2,1,1,2
C1C2C(C(O)O1)(C(C(O)O2)CO)O,,,5,1,1,0,1
75563_0,,,,2,1,1,2
C12C(C(CO1)O)(C(C(O)O2)CO)O,,,5,1,1,0,1
75565_0,,,,2,1,1,2
C1(C(CO)C(C(O)O1)O)O,,,5,1,1,0,1
75567_0,,,,2,1,1,2
CC1C(C(C(O)O1)CO)O,,,5,1,1,0,1
75568_0,,,,2,1,1,2
75569_0,,,,2,1,1,2
75570_0,,,,2,1,1,2
75572_0,,,,2,1,1,2
C1C(C)(C(C(O)O1)C(CO)O)O,,,5,1,1,0,1
75574_0,,,,2,1,1,2
CC(CO)(C1C(O)OCC1O)O,,,5,1,1,0,1
75576_0,,,,2,1,1,2
C1(C(C)(C(C(O)O1)C(CO)O)O)=O,,,5,1,1,0,1
75578_0,,,,2,1,1,2
C(C(C)(C1C(O)OCC1O)O)(O)=O,,,5,1,1,0,1
75580_0,,,,2,1,1,2
C(CC(C1C(O)OCC1O)O)(O)=O,,,5,1,1,0,1
75582_0,,,,2,1,1,2
C(C(C=C)(C1C(O)OCC1O)O)=O,,,5,1,1,0,1
75584_0,,,,2,1,1,2
C(C1C(CO)OC(C1(C=C)O)O)=O,,,5,1,1,0,1
75586_0,,,,2,1,1,2
C=CC(C(C1C(O)OCC1O)O)=O,,,5,1,1,0,1
75588_0,,,,2,1,1,2
C(C1C(C(C=C)(O)OC1CO)O)=O,,,5,1,1,0,1
75590_0,,,,2,1,1,2
C(C(C1C(O)OCC1O)O)=CC=O,,,5,1,1,0,1
75591_0,,,,2,1,1,2
75593_0,,,,2,1,1,2
C1(C(C(C(O)O1)O)C(CO)O)O,,,5,1,1,0,1
75595_0,,,,2,1,1,2
C1C(C(C(O)O1)C(C(O)O)O)O,,,5,1,1,0,1
75597_0,,,,2,1,1,2
CC1C(C(C(O)O1)C(CO)O)O,,,5,1,1,0,1
75599_0,,,,2,1,1,2
C1C(C(C(O)O1)C(C(C)O)O)O,,,5,1,1,0,1
75600_0,,,,2,1,1,2
75602_0,,,,2,1,1,2
C(C1(C(C(C(O1)O)O)O)CC=O)=O,,,5,1,1,0,1
75603_0,,,,2,1,1,2
75604_0,,,,2,1,1,2
75606_0,,,,2,1,1,2
C1(C(O)OC(C(C(C=O)=O)O)C1)=O,,,5,1,2,0,2
75608_0,,,,2,1,1,2
C1(C(O)OC(C1O)CC(C=O)=O)=O,,,5,1,2,0,2
75610_0,,,,2,1,1,2
C(C1(CC(C(C(C=O)=O)O1)O)O)=O,,,5,1,2,0,2
75612_0,,,,2,1,1,2
C(C(C=O)C1C(C(C(O)O1)=O)O)=O,,,5,1,1,0,1
75614_0,,,,2,1,1,2
C(C1C(C(C(C=O)=O)OC1O)O)=O,,,5,1,2,0,2
75616_0,,,,2,1,1,2
C(C1C(C(C(C=O)(O1)O)O)O)=O,,,5,1,1,0,1
75617_0,,,,2,1,1,2
75618_0,,,,2,1,1,2
75619_0,,,,2,1,1,2
75620_0,,,,2,1,1,2
75622_0,,,,2,1,1,2
C(C(C(C1CC(C(O)O1)=O)=O)O)=O,,,5,1,1,0,1
75624_0,,,,2,1,1,2
C1(C(CC(C=O)=O)OC(C1O)O)=O,,,5,1,1,0,1
75626_0,,,,2,1,1,2
C(C(C=O)C1C(C(C(O1)O)O)=O)=O,,,5,1,1,0,1
75627_0,,,,2,1,1,2
75628_0,,,,2,1,1,2
75630_0,,,,2,1,1,2
C(C1(CC(CO)(OC1C=O)O)O)=O,,,5,1,1,0,1
75631_0,,,,2,1,1,2
75633_0,,,,2,1,1,2
C(C1(CC(C=O)(C(C=O)O1)O)O)=O,,,5,1,1,0,1
75635_0,,,,2,1,1,2
C(C1C(C=O)(C(C=O)C(O1)O)O)=O,,,5,1,1,0,1
75636_0,,,,2,1,1,2
75637_0,,,,2,1,1,2
75638_0,,,,2,1,1,2
75639_0,,,,2,1,1,2
75641_0,,,,2,1,1,2
C(C(C1(COC(CO)(C1)O)O)O)=O,,,5,1,1,0,1
75642_0,,,,2,1,1,2
75644_0,,,,2,1,1,2
C(C1C(CO)(CC(CO)(O1)O)O)=O,,,5,1,1,0,1
75646_0,,,,2,1,1,2
C(C(C1(CO)CC(C(O)O1)=O)O)=O,,,5,1,1,0,1
75648_0,,,,2,1,1,2
C(C(C1(COC(C=O)(C1)O)O)O)=O,,,5,1,1,0,1
75649_0,,,,2,1,1,2
75651_0,,,,2,1,1,2
C(C1C(CO)(CC(C=O)(O1)O)O)=O,,,5,1,1,0,1
75653_0,,,,2,1,1,2
C(C1C(O)OCC1(C(C=O)O)O)=O,,,5,1,1,0,1
75654_0,,,,2,1,1,2
75656_0,,,,2,1,1,2
C(C1C(OC(C=O)C1(CO)O)O)=O,,,5,1,1,0,1
75657_0,,,,2,1,1,2
75658_0,,,,2,1,1,2
75659_0,,,,2,1,1,2
75660_0,,,,2,1,1,2
75661_0,,,,2,1,1,2
75663_0,,,,2,1,1,2
C(C1C(C(C(CO)(O1)O)O)O)=O,,,5,1,1,0,1
75664_0,,,,2,1,1,2
75666_0,,,,2,1,1,2
C(C(C1(C(C(CO1)(C)O)O)O)O)=O,,,5,1,1,0,1
75667_0,,,,2,1,1,2
75668_0,,,,2,1,1,2
75670_0,,,,2,1,1,2
C(C(C1(C(C(C(O)O1)O)O)O)O)=O,,,5,1,1,0,1
75671_0,,,,2,1,1,2
75673_0,,,,2,1,1,2
C(C(C1(C(C(C(C)O1)O)O)O)O)=O,,,5,1,1,0,1
75674_0,,,,2,1,1,2
75676_0,,,,2,1,1,2
C1(C(C(C(C(C=O)O)(O)O1)O)O)=O,,,5,1,1,0,1
75677_0,,,,2,1,1,2
75678_0,,,,2,1,1,2
75679_0,,,,2,1,1,2
75680_0,,,,2,1,1,2
75681_0,,,,2,1,1,2
75682_0,,,,2,1,1,2
75683_0,,,,2,1,1,2
75684_0,,,,2,1,1,2
75685_0,,,,2,1,1,2
75686_0,,,,2,1,1,2
75687_0,,,,2,1,1,2
75688_0,,,,2,1,1,2
75689_0,,,,2,1,1,2
75691_0,,,,2,1,1,2
C(C)(C1(COC(C)(C1O)O)O)=O,,,5,1,1,0,1
75693_0,,,,2,1,1,2
C(C)(C1(COC(CO)(C1)O)O)=O,,,5,1,1,0,1
75695_0,,,,2,1,1,2
C(C1(CC(C(C)=O)(CO1)O)O)(O)=O,,,5,1,1,0,1
75697_0,,,,2,1,1,2
C1(C(C=O)C(CO)(C(C)(O)O1)O)=O,,,5,1,1,0,1
75699_0,,,,2,1,1,2
C(C1C(O)OCC1(C(C)=O)O)(O)=O,,,5,1,1,0,1
75701_0,,,,2,1,1,2
C(C)(C1(COC(CO)(C1O)O)O)=O,,,5,1,1,0,1
75702_0,,,,2,1,1,2
75703_0,,,,2,1,1,2
75704_0,,,,2,1,1,2
75705_0,,,,2,1,1,2
75706_0,,,,2,1,1,2
75708_0,,,,2,1,1,2
C(C1(C(C(C(C)=O)(CO1)O)O)O)=O,,,5,1,1,0,1
75709_0,,,,2,1,1,2
75711_0,,,,2,1,1,2
C1(C(C=O)C(C)(C(CO)(O)O1)O)=O,,,5,1,1,0,1
75712_0,,,,2,1,1,2
75713_0,,,,2,1,1,2
75715_0,,,,2,1,1,2
C(C1C(C(C(C(C)=O)(O1)O)O)O)=O,,,5,1,1,0,1
75717_0,,,,2,1,1,2
C(C(C)=O)(C1C(C(C(O1)O)O)O)=O,,,5,1,1,0,1
75719_0,,,,2,1,1,2
C(C(C1C(C(C(C)(O)O1)=O)O)O)=O,,,5,1,1,0,1
75721_0,,,,2,1,1,2
C(C)(C1(C(C(CO1)(C)O)O)O)=O,,,5,1,1,0,1
75723_0,,,,2,1,1,2
C1(C(C)(O)OC(CO)(C)C1O)=O,,,5,1,1,0,1
75725_0,,,,2,1,1,2
C1(C(C)(C(C(C(C)=O)(O)O1)O)O)=O,,,5,1,1,0,1
75727_0,,,,2,1,1,2
C(C1(C)C(C(C(C)(O1)O)=O)O)(O)=O,,,5,1,1,0,1
75729_0,,,,2,1,1,2
C(CC1C(C(C(C)(O)O1)=O)O)(O)=O,,,5,1,1,0,1
75731_0,,,,2,1,1,2
C(C1(C=C)C(C(C(C)(O1)O)=O)O)=O,,,5,1,1,0,1
75733_0,,,,2,1,1,2
C1(C(C(C(C=C)=O)OC1(C)O)O)=O,,,5,1,1,0,1
75735_0,,,,2,1,1,2
C1(C(C(C=CC=O)OC1(C)O)O)=O,,,5,1,1,0,1
75737_0,,,,2,1,1,2
C1(C(C(C(C)(O)O1)=O)O)=O,,,5,1,1,0,1
75739_0,,,,2,1,1,2
C(C)(C1(C(C(C(O1)O)O)O)O)=O,,,5,1,1,0,1
75741_0,,,,2,1,1,2
C1(C(C)(O)OC(C(O)O)C1O)=O,,,5,1,1,0,1
75743_0,,,,2,1,1,2
C(C)(C1(C(C(C(C)O1)O)O)O)=O,,,5,1,1,0,1
75745_0,,,,2,1,1,2
C1(C(C)(O)OC(C(C)O)C1O)=O,,,5,1,1,0,1
75747_0,,,,2,1,1,2
C(C)(C1(C(C(C(CO)O1)O)O)O)=O,,,5,1,1,0,1
75749_0,,,,2,1,1,2
C1(C(C)(O)OC(C(CO)O)C1O)=O,,,5,1,1,0,1
75751_0,,,,2,1,1,2
C(C1C(C(C(C)(O1)O)=O)O)=O,,,5,1,1,0,1
75753_0,,,,2,1,1,2
C(C)(C1(C(C(CO)(CO1)O)O)O)=O,,,5,1,1,0,1
75755_0,,,,2,1,1,2
C1(C(C)(O)OC(CO)(CO)C1O)=O,,,5,1,1,0,1
75756_0,,,,2,1,1,2
75758_0,,,,2,1,1,2
C(C1C(C(C(C)(O1)O)=O)O)(O)=O,,,5,1,1,0,1
75760_0,,,,2,1,1,2
C(C1(C)C(C(C(C)(O1)O)=O)O)=O,,,5,1,1,0,1
75762_0,,,,2,1,1,2
C(C1C(C(C(C)(O1)O)=O)O)(C)=O,,,5,1,1,0,1
75763_0,,,,2,1,1,2
75765_0,,,,2,1,1,2
C(CC1C(C(C(C)(O)O1)=O)O)=O,,,5,1,1,0,1
75767_0,,,,2,1,1,2
C1(C(C)(O)OC(C)C1O)=O,,,5,1,1,0,1
75769_0,,,,2,1,1,2
C(C1(COC(C(C)=O)(C1O)O)O)=O,,,5,1,1,0,1
75771_0,,,,2,1,1,2
C(C1(CO)C(C(C(C)(O1)O)=O)O)=O,,,5,1,1,0,1
75773_0,,,,2,1,1,2
C(C1C(C(C(C)(O1)O)=O)O)(CO)=O,,,5,1,1,0,1
75775_0,,,,2,1,1,2
C1(C(C)(O)OCC1O)=O,,,5,1,1,0,1
75776_0,,,,2,1,1,2
75778_0,,,,2,1,1,2
C1(C(C)(O)OC(CO)C1O)=O,,,5,1,1,0,1
75780_0,,,,2,1,1,2
C(C1C(CC(C(CO)=O)(O1)O)O)=O,,,5,1,1,0,1
75782_0,,,,2,1,1,2
C(C(C1CC(C(CO)(O)O1)=O)O)=O,,,5,1,1,0,1
75784_0,,,,2,1,1,2
C(CO)(C1(CC(CO1)(C)O)O)=O,,,5,1,1,0,1
75786_0,,,,2,1,1,2
C1(C(CO)(O)OC(CO)(C)C1)=O,,,5,1,1,0,1
75788_0,,,,2,1,1,2
C1(C(C)(CC(C(CO)=O)(O)O1)O)=O,,,5,1,1,0,1
75790_0,,,,2,1,1,2
C(C1(C)CC(C(CO)(O1)O)=O)(O)=O,,,5,1,1,0,1
75792_0,,,,2,1,1,2
C(CC1CC(C(CO)(O)O1)=O)(O)=O,,,5,1,1,0,1
75794_0,,,,2,1,1,2
C(C1(C=C)CC(C(CO)(O1)O)=O)=O,,,5,1,1,0,1
75796_0,,,,2,1,1,2
C1(CC(C(C=C)=O)OC1(CO)O)=O,,,5,1,1,0,1
75798_0,,,,2,1,1,2
C1(CC(C=CC=O)OC1(CO)O)=O,,,5,1,1,0,1
75799_0,,,,2,1,1,2
75801_0,,,,2,1,1,2
C(CO)(C1(CC(C(O1)O)O)O)=O,,,5,1,1,0,1
75803_0,,,,2,1,1,2
C1(C(CO)(O)OC(C(O)O)C1)=O,,,5,1,1,0,1
75805_0,,,,2,1,1,2
C(CO)(C1(CC(C(C)O1)O)O)=O,,,5,1,1,0,1
75807_0,,,,2,1,1,2
C1(C(CO)(O)OC(C(C)O)C1)=O,,,5,1,1,0,1
75808_0,,,,2,1,1,2
75809_0,,,,2,1,1,2
75810_0,,,,2,1,1,2
75811_0,,,,2,1,1,2
75812_0,,,,2,1,1,2
75813_0,,,,2,1,1,2
75814_0,,,,2,1,1,2
75815_0,,,,2,1,1,2
75816_0,,,,2,1,1,2
75817_0,,,,2,1,1,2
75818_0,,,,2,1,1,2
75819_0,,,,2,1,1,2
75820_0,,,,2,1,1,2
75821_0,,,,2,1,1,2
75822_0,,,,2,1,1,2
75823_0,,,,2,1,1,2
75824_0,,,,2,1,1,2
75826_0,,,,2,1,1,2
C(C1(C(C)OC(C)(C1O)O)O)=O,,,5,1,1,0,1
75828_0,,,,2,1,1,2
C(C1(C(C)OC(CO)(C1)O)O)=O,,,5,1,1,0,1
75830_0,,,,2,1,1,2
C(C1(CC(C(O)=O)(O)OC1C)O)=O,,,5,1,1,0,1
75832_0,,,,2,1,1,2
C1(C(C=O)C(C(O)O1)(C(C)O)O)=O,,,5,1,1,0,1
75834_0,,,,2,1,1,2
C(C1C(O)OC(C)C1(C=O)O)(O)=O,,,5,1,1,0,1
75836_0,,,,2,1,1,2
C(C1(C(C)OC(CO)(C1O)O)O)=O,,,5,1,1,0,1
75837_0,,,,2,1,1,2
75839_0,,,,2,1,1,2
C(C1(CC(C=O)(O)OC1C)O)=O,,,5,1,1,0,1
75840_0,,,,2,1,1,2
75841_0,,,,2,1,1,2
75843_0,,,,2,1,1,2
C(C1(C(C(C=O)(O)OC1C)O)O)=O,,,5,1,1,0,1
75845_0,,,,2,1,1,2
C1(C(C=O)C(C(C(C)O)(O)O1)O)=O,,,5,1,1,0,1
75846_0,,,,2,1,1,2
75847_0,,,,2,1,1,2
75849_0,,,,2,1,1,2
C(C1C(CC(C(O)=O)(O1)O)O)=O,,,5,1,1,0,1
75851_0,,,,2,1,1,2
C(C(C1C(C(C(O1)O)O)O)=O)(O)=O,,,5,1,2,0,2
75853_0,,,,2,1,1,2
C(C1C(C(C(C(O)=O)(O1)O)O)O)=O,,,5,1,1,0,1
75855_0,,,,2,1,1,2
C(C(C1C(C=O)C(C(O)O1)=O)O)=O,,,5,1,1,0,1
75857_0,,,,2,1,1,2
C(C1C(C(C=O)C(C=O)(O1)O)O)=O,,,5,1,1,0,1
75859_0,,,,2,1,1,2
C(C1C(C(C(C=O)=O)C(O1)O)O)=O,,,5,1,1,0,1
75861_0,,,,2,1,1,2
C(C1C(C2C(C(CO2)O)(O1)O)O)=O,,,5,1,1,0,1
75863_0,,,,2,1,1,2
C(C1C(C2COC(C2(O1)O)O)O)=O,,,5,1,1,0,1
75865_0,,,,2,1,1,2
C(C1C(C2C(O)OCC2(O1)O)O)=O,,,5,1,1,0,1
75867_0,,,,2,1,1,2
C(C1C(C2C(CC(O)O2)(O1)O)O)=O,,,5,1,1,0,1
75869_0,,,,2,1,1,2
C1(CC(C(C=O)O)OC1(C=O)O)=O,,,5,1,1,0,1
75871_0,,,,2,1,1,2
C(C1C(CC(C(C=O)=O)(O1)O)O)=O,,,5,1,1,0,1
75872_0,,,,2,1,1,2
75874_0,,,,2,1,1,2
C(C1C(CC(C=O)(O1)O)O)=O,,,5,1,1,0,1
75876_0,,,,2,1,1,2
C(C1C(C(C=O)OC1O)O)=O,,,5,1,1,0,1
75877_0,,,,2,1,1,2
75878_0,,,,2,1,1,2
75880_0,,,,2,1,1,2
C(C1C(C(CO)C(C=O)(O1)O)O)=O,,,5,1,1,0,1
75881_0,,,,2,1,1,2
75883_0,,,,2,1,1,2
C(C1C(C(C(CO)=O)C(O1)O)O)=O,,,5,1,1,0,1
75885_0,,,,2,1,1,2
C(C1C(C(C=O)OC1(CO)O)O)=O,,,5,1,1,0,1
75886_0,,,,2,1,1,2
75888_0,,,,2,1,1,2
C(CC(C1C(C(C(O1)O)O)O)=O)=O,,,5,1,1,0,1
75890_0,,,,2,1,1,2
C(CC1(C(C(C(C=O)O1)O)O)O)=O,,,5,1,1,0,1
75892_0,,,,2,1,1,2
C(C(C1(CC(C(C=O)O1)O)O)O)=O,,,5,1,1,0,1
75893_0,,,,2,1,1,2
75895_0,,,,2,1,1,2
C1C(C)(C(C(C)(O)O1)O)O,,,5,1,1,0,1
75897_0,,,,2,1,1,2
C1C(C)(CC(CO)(O)O1)O,,,5,1,1,0,1
75899_0,,,,2,1,1,2
C1C(C)(C(C(CCO)(O)O1)O)O,,,5,1,1,0,1
75901_0,,,,2,1,1,2
C1C(C)(C(CO)C(CO)(O)O1)O,,,5,1,1,0,1
75903_0,,,,2,1,1,2
C1C(C)(CC(C(CO)O)(O)O1)O,,,5,1,1,0,1
75905_0,,,,2,1,1,2
C(C1(CC(CO1)(C)O)O)(O)=O,,,5,1,1,0,1
75907_0,,,,2,1,1,2
C(C1C(O)OCC1(C)O)(O)=O,,,5,1,1,0,1
75909_0,,,,2,1,1,2
C(C1(C(CO)C(CO1)(C)O)O)(O)=O,,,5,1,1,0,1
75911_0,,,,2,1,1,2
C(C1C(CO)(O)OCC1(C)O)(O)=O,,,5,1,1,0,1
75913_0,,,,2,1,1,2
C(CC1(C(C(CO1)(C)O)O)O)(O)=O,,,5,1,1,0,1
75915_0,,,,2,1,1,2
C(C(C1(CC(CO1)(C)O)O)O)(O)=O,,,5,1,1,0,1
75917_0,,,,2,1,1,2
C(C1(C(C(CO1)(C)O)O)O)(O)=O,,,5,1,1,0,1
75919_0,,,,2,1,1,2
C(C1C(C(O)OC1(CO)C)=O)=O,,,5,1,1,0,1
75921_0,,,,2,1,1,2
C(C1C(COC1(C=O)O)(C)O)=O,,,5,1,1,0,1
75923_0,,,,2,1,1,2
C(C(C1C(O)OCC1(C)O)=O)=O,,,5,1,1,0,1
75925_0,,,,2,1,1,2
C(C1C(C(O)OC1(CO)C)=O)(O)=O,,,5,1,1,0,1
75926_0,,,,2,1,1,2
75928_0,,,,2,1,1,2
C(C1C(COC1(C=O)O)(C)O)(O)=O,,,5,1,1,0,1
75929_0,,,,2,1,1,2
75931_0,,,,2,1,1,2
C(C(C1C(O)OCC1(C)O)=O)(O)=O,,,5,1,1,0,1
75933_0,,,,2,1,1,2
C(C1C(COC1(C(O)=O)O)(C)O)=O,,,5,1,1,0,1
75935_0,,,,2,1,1,2
C1C(C2(C(C(CO2)(C)O)O1)O)O,,,5,1,1,0,1
75937_0,,,,2,1,1,2
C1C(C)(C2COC(C2(O)O1)O)O,,,5,1,1,0,1
75939_0,,,,2,1,1,2
C1C(C)(C2C(O)OCC2(O)O1)O,,,5,1,1,0,1
75941_0,,,,2,1,1,2
C1C(C)(C2C(CC(O)O2)(O)O1)O,,,5,1,1,0,1
75943_0,,,,2,1,1,2
C(C1(C(CC(CO)(C)O1)=O)O)=O,,,5,1,1,0,1
75945_0,,,,2,1,1,2
C(C(C1(CC(CO1)(C)O)O)=O)=O,,,5,1,1,0,1
75947_0,,,,2,1,1,2
C1C(C)(C(C(CO)(O)O1)O)O,,,5,1,1,0,1
75949_0,,,,2,1,1,2
C1C(C)(C(C(C(CO)O)(O)O1)O)O,,,5,1,1,0,1
75950_0,,,,2,1,1,2
75952_0,,,,2,1,1,2
C(C1(CC(CO1)(C)O)O)=O,,,5,1,1,0,1
75954_0,,,,2,1,1,2
C(C1C(O)OCC1(C)O)=O,,,5,1,1,0,1
75955_0,,,,2,1,1,2
75956_0,,,,2,1,1,2
75958_0,,,,2,1,1,2
C(C1(C(CO)C(CO1)(C)O)O)=O,,,5,1,1,0,1
75959_0,,,,2,1,1,2
75961_0,,,,2,1,1,2
C(C(C1C(O)OCC1(C)O)O)=O,,,5,1,1,0,1
75962_0,,,,2,1,1,2
75964_0,,,,2,1,1,2
C(CO)(C1C(O)OCC1(C)O)=O,,,5,1,1,0,1
75966_0,,,,2,1,1,2
C(C1C(CO)(O)OCC1(C)O)=O,,,5,1,1,0,1
75967_0,,,,2,1,1,2
75969_0,,,,2,1,1,2
C(CC1(C(C(CO1)(C)O)O)O)=O,,,5,1,1,0,1
75971_0,,,,2,1,1,2
C(C(C1(CC(CO1)(C)O)O)O)=O,,,5,1,1,0,1
75973_0,,,,2,1,1,2
C1C(C)(CC(O)O1)O,,,5,1,1,0,1
75974_0,,,,2,1,1,2
75976_0,,,,2,1,1,2
C(C1(C(C(CO1)(C)O)O)O)=O,,,5,1,1,0,1
75978_0,,,,2,1,1,2
C1C(C)(C(C(O)O1)O)O,,,5,1,1,0,1
75980_0,,,,2,1,1,2
CC1(C(C(CO1)(CCO)O)O)O,,,5,1,1,0,1
75982_0,,,,2,1,1,2
CC1(C(C(C(CCO)O1)O)O)O,,,5,1,1,0,1
75984_0,,,,2,1,1,2
CC1(C(C(C)(C(CO)O1)O)O)O,,,5,1,1,0,1
75986_0,,,,2,1,1,2
C(CC1C(C(C(C)(O)O1)O)O)(O)=O,,,5,1,1,0,1
75988_0,,,,2,1,1,2
C(CC1(COC(C)(C1O)O)O)(O)=O,,,5,1,1,0,1
75990_0,,,,2,1,1,2
C(C1C(C)(C(C(C)(O1)O)O)O)(O)=O,,,5,1,1,0,1
75991_0,,,,2,1,1,2
75992_0,,,,2,1,1,2
75993_0,,,,2,1,1,2
75995_0,,,,2,1,1,2
C1(C(C(C(C)(O)O1)O)(CC=O)O)=O,,,5,1,1,0,1
75996_0,,,,2,1,1,2
75998_0,,,,2,1,1,2
CC1(C(C2(COCC2O1)O)O)O,,,5,1,1,0,1
76000_0,,,,2,1,1,2
CC1(C(C2(C(OCC2)O1)O)O)O,,,5,1,1,0,1
76002_0,,,,2,1,1,2
C(C1C(C(C(O1)O)=O)(C)O)(C)=O,,,5,1,1,0,1
76004_0,,,,2,1,1,2
CC1(C(C2(C(O)OCC2O1)O)O)O,,,5,1,2,0,2
76006_0,,,,2,1,1,2
C12C(C(CO1)O)(C(C(C)(O)O2)O)O,,,5,1,1,0,1
76008_0,,,,2,1,1,2
CC1(C(C(C(O)O1)O)O)O,,,5,1,1,0,1
76010_0,,,,2,1,1,2
CC1(C(C(C(C)O1)O)O)O,,,5,1,1,0,1
76011_0,,,,2,1,1,2
76013_0,,,,2,1,1,2
CC1(C(C(C(C(CO)O)O1)O)O)O,,,5,1,1,0,1
76014_0,,,,2,1,1,2
76016_0,,,,2,1,1,2
C1C(C(CO)O)(C(C(C)(O)O1)O)O,,,5,1,1,0,1
76017_0,,,,2,1,1,2
76018_0,,,,2,1,1,2
76019_0,,,,2,1,1,2
76021_0,,,,2,1,1,2
C(C)(C(C1CC(C(O)O1)O)O)=O,,,5,1,1,0,1
76022_0,,,,2,1,1,2
76023_0,,,,2,1,1,2
76025_0,,,,2,1,1,2
C(CC1(COC(C)(C1O)O)O)=O,,,5,1,1,0,1
76026_0,,,,2,1,1,2
76028_0,,,,2,1,1,2
C(C)(C1C(C(C(C)(O1)O)O)O)=O,,,5,1,1,0,1
76030_0,,,,2,1,1,2
C(C1C(C)(C(C(C)(O1)O)O)O)=O,,,5,1,1,0,1
76032_0,,,,2,1,1,2
C(C)(C1C(C)(C(C(O1)O)O)O)=O,,,5,1,1,0,1
76034_0,,,,2,1,1,2
CC1(C(C(CO1)O)O)O,,,5,1,1,0,1
76036_0,,,,2,1,1,2
C1C(CCO)(CC(CO)(O)O1)O,,,5,1,1,0,1
76038_0,,,,2,1,1,2
C(C1(CC(C(CCO)O1)O)O)O,,,5,1,1,0,1
76040_0,,,,2,1,1,2
CC1(CC(CO)(O)OC1CO)O,,,5,1,1,0,1
76042_0,,,,2,1,1,2
C1(C(C)(CC(CO)(O)O1)O)=O,,,5,1,1,0,1
76044_0,,,,2,1,1,2
C1(C(CCO)(CC(CO)(O)O1)O)=O,,,5,1,1,0,1
76046_0,,,,2,1,1,2
C(CC1C(CC(CO)(O)O1)O)(O)=O,,,5,1,1,0,1
76048_0,,,,2,1,1,2
C(CC1(COC(CO)(C1)O)O)(O)=O,,,5,1,1,0,1
76050_0,,,,2,1,1,2
C(C1C(C)(CC(CO)(O1)O)O)(O)=O,,,5,1,1,0,1
76051_0,,,,2,1,1,2
76052_0,,,,2,1,1,2
76053_0,,,,2,1,1,2
76054_0,,,,2,1,1,2
76055_0,,,,2,1,1,2
76057_0,,,,2,1,1,2
C1(C(CC(CO)(O)O1)(CC=O)O)=O,,,5,1,1,0,1
76059_0,,,,2,1,1,2
C1C2(C(CO1)OC(CO)(C2)O)O,,,5,1,1,0,1
76061_0,,,,2,1,1,2
C12C(CCO1)(CC(CO)(O)O2)O,,,5,1,1,0,1
76063_0,,,,2,1,1,2
C1C2C(C(O)O1)(CC(CO)(O)O2)O,,,5,1,1,0,1
76065_0,,,,2,1,1,2
C1C(C2(C(O1)OC(CO)(C2)O)O)O,,,5,1,1,0,1
76067_0,,,,2,1,1,2
C(C1(CC(C(O)O1)O)O)O,,,5,1,1,0,1
76069_0,,,,2,1,1,2
CC1C(CC(CO)(O)O1)O,,,5,1,1,0,1
76070_0,,,,2,1,1,2
76071_0,,,,2,1,1,2
76072_0,,,,2,1,1,2
76073_0,,,,2,1,1,2
76074_0,,,,2,1,1,2
76075_0,,,,2,1,1,2
76076_0,,,,2,1,1,2
76077_0,,,,2,1,1,2
76078_0,,,,2,1,1,2
76079_0,,,,2,1,1,2
76080_0,,,,2,1,1,2
76081_0,,,,2,1,1,2
76082_0,,,,2,1,1,2
76083_0,,,,2,1,1,2
76084_0,,,,2,1,1,2
76085_0,,,,2,1,1,2
76086_0,,,,2,1,1,2
76087_0,,,,2,1,1,2
76089_0,,,,2,1,1,2
C(C1(CC(CO1)(CCO)O)O)(O)=O,,,5,1,1,0,1
76091_0,,,,2,1,1,2
C(C1C(O)OCC1(CCO)O)(O)=O,,,5,1,1,0,1
76092_0,,,,2,1,1,2
76093_0,,,,2,1,1,2
76094_0,,,,2,1,1,2
76095_0,,,,2,1,1,2
76096_0,,,,2,1,1,2
76097_0,,,,2,1,1,2
76098_0,,,,2,1,1,2
76099_0,,,,2,1,1,2
76101_0,,,,2,1,1,2
C(CC1(C(C(C(O)O1)O)O)O)O,,,5,1,1,0,1
76103_0,,,,2,1,1,2
CC1C(C(C(CCO)(O)O1)O)O,,,5,1,1,0,1
76104_0,,,,2,1,1,2
76105_0,,,,2,1,1,2
76106_0,,,,2,1,1,2
76108_0,,,,2,1,1,2
C1(C(C)(C(CO)C(CO)(O)O1)O)=O,,,5,1,1,0,1
76110_0,,,,2,1,1,2
C(CO)(C1COC(C1(C=C)O)O)=O,,,5,1,1,0,1
76112_0,,,,2,1,1,2
C(CO)(C1COC(C=C)(C1O)O)=O,,,5,1,1,0,1
76114_0,,,,2,1,1,2
C(C1C(C(O)OC1(CO)O)O)O,,,5,1,1,0,1
76116_0,,,,2,1,1,2
CC1C(C(CO)C(CO)(O)O1)O,,,5,1,1,0,1
76117_0,,,,2,1,1,2
76118_0,,,,2,1,1,2
76119_0,,,,2,1,1,2
76120_0,,,,2,1,1,2
76121_0,,,,2,1,1,2
76122_0,,,,2,1,1,2
76123_0,,,,2,1,1,2
76124_0,,,,2,1,1,2
76125_0,,,,2,1,1,2
76126_0,,,,2,1,1,2
76128_0,,,,2,1,1,2
C(C1(CC(C(CCO)O1)O)O)(O)=O,,,5,1,1,0,1
76130_0,,,,2,1,1,2
C(C1C(O)OC(C1O)CCO)(O)=O,,,5,1,1,0,1
76131_0,,,,2,1,1,2
76132_0,,,,2,1,1,2
76133_0,,,,2,1,1,2
76134_0,,,,2,1,1,2
76135_0,,,,2,1,1,2
76136_0,,,,2,1,1,2
76137_0,,,,2,1,1,2
76138_0,,,,2,1,1,2
76140_0,,,,2,1,1,2
C(C1(CC(C)(C(CO)O1)O)O)(O)=O,,,5,1,1,0,1
76142_0,,,,2,1,1,2
C(C1C(O)OC(CO)C1(C)O)(O)=O,,,5,1,1,0,1
76143_0,,,,2,1,1,2
76144_0,,,,2,1,1,2
76145_0,,,,2,1,1,2
76146_0,,,,2,1,1,2
76147_0,,,,2,1,1,2
76148_0,,,,2,1,1,2
76149_0,,,,2,1,1,2
76150_0,,,,2,1,1,2
76152_0,,,,2,1,1,2
C1(C(C)(CC(C(CO)O)(O)O1)O)=O,,,5,1,1,0,1
76154_0,,,,2,1,1,2
C(C(C1(CC(C(O)O1)O)O)O)O,,,5,1,1,0,1
76156_0,,,,2,1,1,2
CC1C(CC(C(CO)O)(O)O1)O,,,5,1,1,0,1
76157_0,,,,2,1,1,2
76158_0,,,,2,1,1,2
76159_0,,,,2,1,1,2
76160_0,,,,2,1,1,2
76162_0,,,,2,1,1,2
C1(C(C)(CC(C(O)=O)(O)O1)O)=O,,,5,1,1,0,1
76164_0,,,,2,1,1,2
C(C1C(O)OC(C1(C)O)=O)(O)=O,,,5,1,1,0,1
76166_0,,,,2,1,1,2
C1(C(C)(C(C(C(O)=O)(O)O1)O)O)=O,,,5,1,1,0,1
76168_0,,,,2,1,1,2
C(C1(C)C(C=O)C(C(O1)O)=O)(O)=O,,,5,1,1,0,1
76170_0,,,,2,1,1,2
C1(C(C)(C(C=O)C(C=O)(O)O1)O)=O,,,5,1,1,0,1
76172_0,,,,2,1,1,2
C1(C(C)(C(C(C=O)=O)C(O)O1)O)=O,,,5,1,1,0,1
76174_0,,,,2,1,1,2
C1(C(C)(C2C(C(CO2)O)(O)O1)O)=O,,,5,1,1,0,1
76176_0,,,,2,1,1,2
C1(C(C)(C2COC(C2(O)O1)O)O)=O,,,5,1,1,0,1
76178_0,,,,2,1,1,2
C1(C(C)(C2C(O)OCC2(O)O1)O)=O,,,5,1,1,0,1
76180_0,,,,2,1,1,2
C1(C(C)(C2C(CC(O)O2)(O)O1)O)=O,,,5,1,1,0,1
76182_0,,,,2,1,1,2
C(C1(C)CC(C(C=O)(O1)O)=O)(O)=O,,,5,1,1,0,1
76184_0,,,,2,1,1,2
C1(C(C)(CC(C(C=O)=O)(O)O1)O)=O,,,5,1,1,0,1
76185_0,,,,2,1,1,2
76187_0,,,,2,1,1,2
C1(C(C)(CC(C=O)(O)O1)O)=O,,,5,1,1,0,1
76188_0,,,,2,1,1,2
76189_0,,,,2,1,1,2
76190_0,,,,2,1,1,2
76192_0,,,,2,1,1,2
C1(C(C)(C(CO)C(C=O)(O)O1)O)=O,,,5,1,1,0,1
76193_0,,,,2,1,1,2
76195_0,,,,2,1,1,2
C1(C(C)(C(C(O)O1)C(C=O)O)O)=O,,,5,1,1,0,1
76196_0,,,,2,1,1,2
76198_0,,,,2,1,1,2
C1(C(C)(C(C(CO)=O)C(O)O1)O)=O,,,5,1,1,0,1
76200_0,,,,2,1,1,2
C(C1C(CO)(O)OC(C1(C)O)=O)=O,,,5,1,1,0,1
76201_0,,,,2,1,1,2
76203_0,,,,2,1,1,2
C1(C(C)(C(C(CC=O)(O)O1)O)O)=O,,,5,1,1,0,1
76205_0,,,,2,1,1,2
C1(C(C)(CC(C(C=O)O)(O)O1)O)=O,,,5,1,1,0,1
76207_0,,,,2,1,1,2
C1(C(C)(CC(O)O1)O)=O,,,5,1,1,0,1
76208_0,,,,2,1,1,2
76210_0,,,,2,1,1,2
C1(C(C)(C(C(C=O)(O)O1)O)O)=O,,,5,1,1,0,1
76212_0,,,,2,1,1,2
C1(C(CO)(CC(C(O)=O)(O)O1)O)=O,,,5,1,1,0,1
76214_0,,,,2,1,1,2
C(C1(COC(C(O)=O)(C1)O)O)(O)=O,,,5,1,1,0,1
76216_0,,,,2,1,1,2
C1(C(CC(C(O)=O)=O)OC(C1)O)=O,,,5,1,1,0,1
76218_0,,,,2,1,1,2
C1(C(O)OC(CC(C(O)=O)=O)C1)=O,,,5,1,1,0,1
76220_0,,,,2,1,1,2
C(C1(CC2(COCC2O1)O)O)(O)=O,,,5,1,1,0,1
76222_0,,,,2,1,1,2
C(C1(CC2(C(O1)OCC2)O)O)(O)=O,,,5,1,1,0,1
76224_0,,,,2,1,1,2
C(C1(CC(C(O1)O)O)O)(O)=O,,,5,1,1,0,1
76226_0,,,,2,1,1,2
C(C1(CC(C(C)O1)O)O)(O)=O,,,5,1,1,0,1
76227_0,,,,2,1,1,2
76228_0,,,,2,1,1,2
76229_0,,,,2,1,1,2
76230_0,,,,2,1,1,2
76231_0,,,,2,1,1,2
76232_0,,,,2,1,1,2
76233_0,,,,2,1,1,2
76234_0,,,,2,1,1,2
76235_0,,,,2,1,1,2
76236_0,,,,2,1,1,2
76238_0,,,,2,1,1,2
C(CC1C(C=O)C(C(O)O1)=O)(O)=O,,,5,1,1,0,1
76240_0,,,,2,1,1,2
C(C1(C(CC(CC(O)=O)O1)=O)O)=O,,,5,1,1,0,1
76241_0,,,,2,1,1,2
76242_0,,,,2,1,1,2
76243_0,,,,2,1,1,2
76244_0,,,,2,1,1,2
76245_0,,,,2,1,1,2
76246_0,,,,2,1,1,2
76247_0,,,,2,1,1,2
76249_0,,,,2,1,1,2
C(C1C(O)OC(C1(CO)O)=O)(O)=O,,,5,1,1,0,1
76251_0,,,,2,1,1,2
C(C1C(O)OCC1(C(O)=O)O)(O)=O,,,5,1,1,0,1
76253_0,,,,2,1,1,2
C1(C(C=O)C(C(O)O1)(CC=O)O)=O,,,5,1,1,0,1
76255_0,,,,2,1,1,2
C1(C(C=O)C(C(CC=O)(O)O1)O)=O,,,5,1,1,0,1
76257_0,,,,2,1,1,2
C(C(C=O)C1C(CC(O1)O)=O)(O)=O,,,5,1,1,0,1
76259_0,,,,2,1,1,2
C(C1C(O)OC2COCC21O)(O)=O,,,5,1,1,0,1
76261_0,,,,2,1,1,2
C(C1C(O)OC2C1(CCO2)O)(O)=O,,,5,1,1,0,1
76263_0,,,,2,1,1,2
C1(C(C=O)C(C(C)=O)(C(O)O1)O)=O,,,5,1,1,0,1
76265_0,,,,2,1,1,2
C1(C(C=O)C(C=O)(C(C)(O)O1)O)=O,,,5,1,1,0,1
76267_0,,,,2,1,1,2
C1(C(C=O)C(C(C(C)=O)(O)O1)O)=O,,,5,1,1,0,1
76269_0,,,,2,1,1,2
C1(C(C=O)C(C)(C(C=O)(O)O1)O)=O,,,5,1,1,0,1
76271_0,,,,2,1,1,2
C1(C(C=O)C(C=C)(C(O)O1)O)=O,,,5,1,1,0,1
76273_0,,,,2,1,1,2
C1(C(C=O)C(C(C=C)(O)O1)O)=O,,,5,1,1,0,1
76275_0,,,,2,1,1,2
C(C1C(O)OC(C1O)O)(O)=O,,,5,1,1,0,1
76277_0,,,,2,1,1,2
C(C1C(O)OC(C)C1O)(O)=O,,,5,1,1,0,1
76278_0,,,,2,1,1,2
76279_0,,,,2,1,1,2
76281_0,,,,2,1,1,2
C1(C(CC(C=O)(O)O1)(CCO)O)=O,,,5,1,1,0,1
76283_0,,,,2,1,1,2
C(C1C(O)OC(C1(CCO)O)=O)=O,,,5,1,1,0,1
76285_0,,,,2,1,1,2
C1(C(CCO)(CC(O)O1)O)=O,,,5,1,1,0,1
76287_0,,,,2,1,1,2
C(C1(C(CO)C(C(O1)O)O)O)(O)=O,,,5,1,1,0,1
76289_0,,,,2,1,1,2
C(C1(C(CO)C(C(C)O1)O)O)(O)=O,,,5,1,1,0,1
76290_0,,,,2,1,1,2
76291_0,,,,2,1,1,2
76292_0,,,,2,1,1,2
76293_0,,,,2,1,1,2
76294_0,,,,2,1,1,2
76295_0,,,,2,1,1,2
76296_0,,,,2,1,1,2
76297_0,,,,2,1,1,2
76298_0,,,,2,1,1,2
76299_0,,,,2,1,1,2
76300_0,,,,2,1,1,2
76301_0,,,,2,1,1,2
76302_0,,,,2,1,1,2
76303_0,,,,2,1,1,2
76304_0,,,,2,1,1,2
76306_0,,,,2,1,1,2
C(C1C(CO)(O)OC(C1O)O)(O)=O,,,5,1,1,0,1
76308_0,,,,2,1,1,2
C(C1C(CO)(O)OC(C)C1O)(O)=O,,,5,1,1,0,1
76309_0,,,,2,1,1,2
76310_0,,,,2,1,1,2
76312_0,,,,2,1,1,2
C1(C(C(CO)=O)C(C)(C(O)O1)O)=O,,,5,1,1,0,1
76314_0,,,,2,1,1,2
C1(C(C(CO)=O)C(C(C)(O)O1)O)=O,,,5,1,1,0,1
76315_0,,,,2,1,1,2
76317_0,,,,2,1,1,2
C(CC1(C(C(C(O)O1)O)O)O)(O)=O,,,5,1,1,0,1
76319_0,,,,2,1,1,2
C(CC1(C(C(C(C)O1)O)O)O)(O)=O,,,5,1,1,0,1
76320_0,,,,2,1,1,2
76321_0,,,,2,1,1,2
76322_0,,,,2,1,1,2
76323_0,,,,2,1,1,2
76324_0,,,,2,1,1,2
76326_0,,,,2,1,1,2
C(C(C1(CC(C(O)O1)O)O)O)(O)=O,,,5,1,1,0,1
76328_0,,,,2,1,1,2
C(C(C1(CC(C(C)O1)O)O)O)(O)=O,,,5,1,1,0,1
76329_0,,,,2,1,1,2
76330_0,,,,2,1,1,2
76331_0,,,,2,1,1,2
76332_0,,,,2,1,1,2
76333_0,,,,2,1,1,2
76334_0,,,,2,1,1,2
76335_0,,,,2,1,1,2
76336_0,,,,2,1,1,2
76337_0,,,,2,1,1,2
76338_0,,,,2,1,1,2
76339_0,,,,2,1,1,2
76341_0,,,,2,1,1,2
C(C1(C(C(C(O1)O)O)O)O)(O)=O,,,5,1,1,0,1
76343_0,,,,2,1,1,2
C(C1(C(C(C(C)O1)O)O)O)(O)=O,,,5,1,1,0,1
76344_0,,,,2,1,1,2
76345_0,,,,2,1,1,2
76346_0,,,,2,1,1,2
76347_0,,,,2,1,1,2
76348_0,,,,2,1,1,2
76349_0,,,,2,1,1,2
76350_0,,,,2,1,1,2
76351_0,,,,2,1,1,2
76353_0,,,,2,1,1,2
C(C1(CO)C(C(CO)C(O1)O)O)=O,,,5,1,1,0,1
76354_0,,,,2,1,1,2
76355_0,,,,2,1,1,2
76356_0,,,,2,1,1,2
76358_0,,,,2,1,1,2
C(C1C(C(CO)(C(C)(O1)O)O)O)=O,,,5,1,1,0,1
76359_0,,,,2,1,1,2
76360_0,,,,2,1,1,2
76361_0,,,,2,1,1,2
76362_0,,,,2,1,1,2
76364_0,,,,2,1,1,2
C(C1(C(COC1(CCO)O)O)O)=O,,,5,1,1,0,1
76366_0,,,,2,1,1,2
CC(C1(CO)C(CC(O)O1)O)O,,,5,1,1,0,1
76368_0,,,,2,1,1,2
CC(C1(CO)C(C(C(O)O1)O)O)O,,,5,1,1,0,1
76370_0,,,,2,1,1,2
C(C(C1(C)C(CC(O)O1)O)O)(O)=O,,,5,1,1,0,1
76372_0,,,,2,1,1,2
C(C(C1C(C)(CC(O)O1)O)O)(O)=O,,,5,1,1,0,1
76374_0,,,,2,1,1,2
C1(C(C(C(CC(C)O)(O)O1)O)O)=O,,,5,1,1,0,1
76376_0,,,,2,1,1,2
C(C1(C)C(C(CO)C(O1)O)O)(O)=O,,,5,1,1,0,1
76378_0,,,,2,1,1,2
C(C1C(C(C(O)=O)OC1O)O)(O)=O,,,5,1,1,0,1
76380_0,,,,2,1,1,2
C(C1C(C(C(O1)O)C(C)O)O)(O)=O,,,5,1,1,0,1
76382_0,,,,2,1,1,2
C(C1C(C(CO)C(O1)O)O)(O)=O,,,5,1,1,0,1
76384_0,,,,2,1,1,2
C(CC1C(CC(O)O1)(C(C)O)O)=O,,,5,1,1,0,1
76386_0,,,,2,1,1,2
C(CC1(C(CC(O)O1)O)C(C)O)=O,,,5,1,1,0,1
76387_0,,,,2,1,1,2
76389_0,,,,2,1,1,2
C(CC1CC(C(O)O1)(C(C)O)O)=O,,,5,1,1,0,1
76391_0,,,,2,1,1,2
C(CC1(CO)CC(C(O)O1)O)=O,,,5,1,1,0,1
76392_0,,,,2,1,1,2
76394_0,,,,2,1,1,2
C(C(C1(CO)CC(C(O)O1)O)O)=O,,,5,1,1,0,1
76396_0,,,,2,1,1,2
C(C(CC1(COC(C1O)O)O)O)=O,,,5,1,1,0,1
76398_0,,,,2,1,1,2
C(CO)(C1C(C(OC1C=O)O)O)=O,,,5,1,1,0,1
76400_0,,,,2,1,1,2
C(CO)(C1C(C)OC(C1O)O)=O,,,5,1,1,0,1
76402_0,,,,2,1,1,2
C(C(C1C(CO)(O)OCC1O)O)=O,,,5,1,1,0,1
76404_0,,,,2,1,1,2
C(CO)(C1C(CO)OC(C1O)O)=O,,,5,1,1,0,1
76406_0,,,,2,1,1,2
C(C(CC1(C(C(CO1)O)O)O)O)=O,,,5,1,1,0,1
76408_0,,,,2,1,1,2
C(C(CO)O)(C1COC(C1O)O)=O,,,5,1,1,0,1
76409_0,,,,2,1,1,2
76411_0,,,,2,1,1,2
C(C1(CC(OC1C(C=O)=O)O)O)=O,,,5,1,1,0,1
76413_0,,,,2,1,1,2
C(CC1(C=O)C(C(C(O)O1)=O)O)=O,,,5,1,1,0,1
76414_0,,,,2,1,1,2
76415_0,,,,2,1,1,2
76416_0,,,,2,1,1,2
76417_0,,,,2,1,1,2
76419_0,,,,2,1,1,2
C(CC(C1C(C(C(O)O1)=O)O)=O)=O,,,5,1,1,0,1
76420_0,,,,2,1,1,2
76421_0,,,,2,1,1,2
76422_0,,,,2,1,1,2
76424_0,,,,2,1,1,2
C(C1C(C(OC1(C=O)C=C)O)=O)=O,,,5,1,1,0,1
76426_0,,,,2,1,1,2
C(C1C(C(O)OC1C(C=C)=O)=O)=O,,,5,1,1,0,1
76428_0,,,,2,1,1,2
C(C1C(C(O)OC1C=CC=O)=O)=O,,,5,1,1,0,1
76430_0,,,,2,1,1,2
C1(C(C=O)C(C(O)O1)=O)=O,,,5,1,1,0,1
76432_0,,,,2,1,1,2
C(C1C(C(OC1(C=O)O)O)O)=O,,,5,1,1,0,1
76434_0,,,,2,1,1,2
C(C(C1C(O)OC(C1O)O)=O)=O,,,5,1,1,0,1
76436_0,,,,2,1,1,2
C(C1C(C(O)OC1C(O)O)=O)=O,,,5,1,1,0,1
76438_0,,,,2,1,1,2
C(C1C(C(C)OC1(C=O)O)O)=O,,,5,1,1,0,1
76440_0,,,,2,1,1,2
C(C(C1C(O)OC(C)C1O)=O)=O,,,5,1,1,0,1
76442_0,,,,2,1,1,2
C(C1C(C(O)OC1C(C)O)=O)=O,,,5,1,1,0,1
76444_0,,,,2,1,1,2
C(C1C(C(CO)OC1(C=O)O)O)=O,,,5,1,1,0,1
76446_0,,,,2,1,1,2
C(C(C1C(O)OC(CO)C1O)=O)=O,,,5,1,2,0,2
76448_0,,,,2,1,1,2
C(C1C(C(O)OC1C(CO)O)=O)=O,,,5,1,1,0,1
76449_0,,,,2,1,1,2
76451_0,,,,2,1,1,2
C(C1C(CO)(COC1(C=O)O)O)=O,,,5,1,1,0,1
76453_0,,,,2,1,1,2
C(C(C1C(O)OCC1(CO)O)=O)=O,,,5,1,2,0,2
76455_0,,,,2,1,1,2
C(C1C(C(O)OC1(CO)CO)=O)=O,,,5,1,1,0,1
76456_0,,,,2,1,1,2
76457_0,,,,2,1,1,2
76458_0,,,,2,1,1,2
76459_0,,,,2,1,1,2
76460_0,,,,2,1,1,2
76461_0,,,,2,1,1,2
76462_0,,,,2,1,1,2
76464_0,,,,2,1,1,2
C(C1C(C=O)(O)OCC1(C=O)O)=O,,,5,1,1,0,1
76466_0,,,,2,1,1,2
C(C1(COC(C1C(C=O)=O)O)O)=O,,,5,1,2,0,2
76468_0,,,,2,1,1,2
C(C1(CO)C(C=O)C(C(O1)O)=O)=O,,,5,1,1,0,1
76470_0,,,,2,1,1,2
C(C1C(C(O)OC1C(CO)=O)=O)=O,,,5,1,1,0,1
76471_0,,,,2,1,1,2
76473_0,,,,2,1,1,2
C1(C(CC(O)O1)(CC(CO)O)O)=O,,,5,1,1,0,1
76475_0,,,,2,1,1,2
C(C1C(COC1(C(O)=O)O)O)(O)=O,,,5,1,1,0,1
76477_0,,,,2,1,1,2
C(C1(C(C(C)O)C(CO1)O)O)(O)=O,,,5,1,1,0,1
76478_0,,,,2,1,1,2
76480_0,,,,2,1,1,2
C1(C(C(C(C)O)C(CO)(O)O1)O)=O,,,5,1,1,0,1
76482_0,,,,2,1,1,2
C1(C(CC(C(C(C)O)O)(O)O1)O)=O,,,5,1,1,0,1
76484_0,,,,2,1,1,2
C(CC1(C(CO)OC(C1)O)O)(O)=O,,,5,1,1,0,1
76486_0,,,,2,1,1,2
C(C1C(CC(O1)O)(CCO)O)(O)=O,,,5,1,1,0,1
76488_0,,,,2,1,1,2
C(CC1(C=O)CC(C(O)O1)=O)(O)=O,,,5,1,1,0,1
76489_0,,,,2,1,1,2
76490_0,,,,2,1,1,2
76491_0,,,,2,1,1,2
76492_0,,,,2,1,1,2
76493_0,,,,2,1,1,2
76495_0,,,,2,1,1,2
C(C1C(C(OC1(C=O)O)O)O)(O)=O,,,5,1,1,0,1
76497_0,,,,2,1,1,2
C(C1C(C(O)OC1C(O)O)=O)(O)=O,,,5,1,1,0,1
76498_0,,,,2,1,1,2
76500_0,,,,2,1,1,2
C(C1C(C(C)OC1(C=O)O)O)(O)=O,,,5,1,1,0,1
76502_0,,,,2,1,1,2
C(C1C(C(O)OC1C(C)O)=O)(O)=O,,,5,1,1,0,1
76503_0,,,,2,1,1,2
76504_0,,,,2,1,1,2
76505_0,,,,2,1,1,2
76507_0,,,,2,1,1,2
C(C1(CC=O)CC(C(O)O1)=O)(O)=O,,,5,1,1,0,1
76509_0,,,,2,1,1,2
C1(C(CC(C=O)(O)O1)(CC=O)O)=O,,,5,1,1,0,1
76510_0,,,,2,1,1,2
76512_0,,,,2,1,1,2
C(CC1(C(OC(C1C=O)O)=O)O)=O,,,5,1,1,0,1
76513_0,,,,2,1,1,2
76514_0,,,,2,1,1,2
76515_0,,,,2,1,1,2
76516_0,,,,2,1,1,2
76517_0,,,,2,1,1,2
76518_0,,,,2,1,1,2
76520_0,,,,2,1,1,2
C(C(C1C(O)OC(C1O)O)=O)(O)=O,,,5,1,1,0,1
76522_0,,,,2,1,1,2
C(C1C(C(OC1(C(O)=O)O)O)O)=O,,,5,1,1,0,1
76523_0,,,,2,1,1,2
76525_0,,,,2,1,1,2
C(C(C1C(O)OC(C)C1O)=O)(O)=O,,,5,1,1,0,1
76527_0,,,,2,1,1,2
C(C1C(C(C)OC1(C(O)=O)O)O)=O,,,5,1,1,0,1
76528_0,,,,2,1,1,2
76529_0,,,,2,1,1,2
76531_0,,,,2,1,1,2
C1(C(C(C(C(O)=O)=O)C(O)O1)O)=O,,,5,1,1,0,1
76533_0,,,,2,1,1,2
C1(C(C(C=O)C(C(O)=O)(O)O1)O)=O,,,5,1,1,0,1
76534_0,,,,2,1,1,2
76535_0,,,,2,1,1,2
76536_0,,,,2,1,1,2
76537_0,,,,2,1,1,2
76538_0,,,,2,1,1,2
76539_0,,,,2,1,1,2
76540_0,,,,2,1,1,2
76541_0,,,,2,1,1,2
76542_0,,,,2,1,1,2
76544_0,,,,2,1,1,2
C1C2(C(CO1)OC(CO)(C2O)O)O,,,5,1,1,0,1
76546_0,,,,2,1,1,2
C1(C(O)OC2(COCC2O)C1)=O,,,5,1,1,0,1
76548_0,,,,2,1,1,2
C(C1(CC2(COCC2O1)O)O)=O,,,5,1,1,0,1
76550_0,,,,2,1,1,2
C(C1C(O)OC2COCC21O)=O,,,5,1,1,0,1
76552_0,,,,2,1,1,2
C1C2(C(CO1)OC(C2)O)O,,,5,1,1,0,1
76554_0,,,,2,1,1,2
C1(C(O)OC2(COCC2O)C1O)=O,,,5,1,1,0,1
76556_0,,,,2,1,1,2
C(C1(C(C2(COCC2O1)O)O)O)=O,,,5,1,1,0,1
76558_0,,,,2,1,1,2
C1C2(C(CO1)OC(C2O)O)O,,,5,1,1,0,1
76560_0,,,,2,1,1,2
C1C(C2(C(C(C(O)O2)O)O1)O)O,,,5,1,1,0,1
76562_0,,,,2,1,1,2
C1C(C2(C(C(C(C)O2)O)O1)O)O,,,5,1,1,0,1
76564_0,,,,2,1,1,2
C1C(C2(C(C(C(CO)O2)O)O1)O)O,,,5,1,1,0,1
76566_0,,,,2,1,1,2
C1C(C2(C(C(CO2)(CO)O)O1)O)O,,,5,1,1,0,1
76568_0,,,,2,1,1,2
C1(C(C2C(C(CO2)O)(O)O1)O)=O,,,5,1,1,0,1
76570_0,,,,2,1,1,2
C(C1(COC2(C1OCC2O)O)O)=O,,,5,1,1,0,1
76572_0,,,,2,1,1,2
C1C(C2(C(C(CO2)O)O1)O)O,,,5,1,1,0,1
76574_0,,,,2,1,1,2
C12C(CCO1)(C(C(CO)(O)O2)O)O,,,5,1,1,0,1
76576_0,,,,2,1,1,2
C1(C(O)OC2(C(O)OCC2)C1)=O,,,5,1,2,0,2
76578_0,,,,2,1,1,2
C(C1(CC2(C(O1)OCC2)O)O)=O,,,5,1,1,0,1
76580_0,,,,2,1,1,2
C(C1C(O)OC2C1(CCO2)O)=O,,,5,1,1,0,1
76582_0,,,,2,1,1,2
C12C(CCO1)(CC(O)O2)O,,,5,1,1,0,1
76584_0,,,,2,1,1,2
C1(C(O)OC2(C(O)OCC2)C1O)=O,,,5,1,2,0,2
76586_0,,,,2,1,1,2
C(C1(C(C2(C(O1)OCC2)O)O)O)=O,,,5,1,1,0,1
76588_0,,,,2,1,1,2
C12C(CCO1)(C(C(O)O2)O)O,,,5,1,1,0,1
76590_0,,,,2,1,1,2
C1C2C(C(O)O1)(O)OC(C2O)O,,,5,1,1,0,1
76592_0,,,,2,1,1,2
C1C2C(C(O)O1)(O)OC(C)C2O,,,5,1,1,0,1
76594_0,,,,2,1,1,2
C1C2C(C(O)O1)(O)OC(CO)C2O,,,5,1,2,0,2
76596_0,,,,2,1,1,2
C1C(CO)(C2COC(C2(O)O1)O)O,,,5,1,2,0,2
76598_0,,,,2,1,1,2
C1(C(C2COC(C2(O)O1)O)O)=O,,,5,1,2,0,2
76600_0,,,,2,1,1,2
C(C1(COC2(C(O)OCC21)O)O)=O,,,5,1,2,0,2
76602_0,,,,2,1,1,2
C1C2C(COC2(C(O)O1)O)O,,,5,1,2,0,2
76604_0,,,,2,1,1,2
C1(C(O)OC2(COC(C2)O)C1)=O,,,5,1,2,0,2
76606_0,,,,2,1,1,2
C1(C(O)OC2(COC(C2)O)C1O)=O,,,5,1,2,0,2
76608_0,,,,2,1,1,2
C1(COC2C1C(C=C)(C(O)O2)O)=O,,,5,1,1,0,1
76610_0,,,,2,1,1,2
C1(COC2C1C(C(C=C)(O)O2)O)=O,,,5,1,1,0,1
76612_0,,,,2,1,1,2
C1C2(C(C(O)O1)C(C(O)O2)O)O,,,5,1,1,0,1
76614_0,,,,2,1,1,2
C1C2(C(C(O)O1)C(C(C)O2)O)O,,,5,1,1,0,1
76616_0,,,,2,1,1,2
C1C2(C(C(O)O1)C(C(CO)O2)O)O,,,5,1,2,0,2
76617_0,,,,2,1,1,2
76619_0,,,,2,1,1,2
C1C(CO)(C2C(O)OCC2(O)O1)O,,,5,1,2,0,2
76621_0,,,,2,1,1,2
C1(C(C2C(O)OCC2(O)O1)O)=O,,,5,1,2,0,2
76623_0,,,,2,1,1,2
C1(COC2C1C(C(O)O2)(C)O)=O,,,5,1,1,0,1
76625_0,,,,2,1,1,2
C1(COC2C1C(C(C)(O)O2)O)=O,,,5,1,1,0,1
76627_0,,,,2,1,1,2
C(C1(COC2(COC(C21)O)O)O)=O,,,5,1,2,0,2
76629_0,,,,2,1,1,2
C1(COC2C1C(C(O)O2)(CO)O)=O,,,5,1,1,0,1
76631_0,,,,2,1,1,2
C1(COC2C1C(C(CO)(O)O2)O)=O,,,5,1,1,0,1
76633_0,,,,2,1,1,2
C1C(C2C(O)OCC2(O)O1)O,,,5,1,2,0,2
76635_0,,,,2,1,1,2
C1(C(C2C(CC(O)O2)(O)O1)O)O,,,5,1,1,0,1
76637_0,,,,2,1,1,2
CC1C(C2C(CC(O)O2)(O)O1)O,,,5,1,1,0,1
76639_0,,,,2,1,1,2
C1(CC2(C(C(C(CO)O2)O)O1)O)O,,,5,1,2,0,2
76641_0,,,,2,1,1,2
C1C(CO)(C2C(CC(O)O2)(O)O1)O,,,5,1,2,0,2
76643_0,,,,2,1,1,2
C1(C(C2C(CC(O)O2)(O)O1)O)=O,,,5,1,2,0,2
76645_0,,,,2,1,1,2
C(C1(COC2(C1OC(C2)O)O)O)=O,,,5,1,2,0,2
76647_0,,,,2,1,1,2
C1C(C2C(CC(O)O2)(O)O1)O,,,5,1,2,0,2
76648_0,,,,2,1,1,2
76650_0,,,,2,1,1,2
C(C1(C(C)=O)C(C(C(O1)O)=O)O)=O,,,5,1,1,0,1
76651_0,,,,2,1,1,2
76653_0,,,,2,1,1,2
C1(C(C(C(C=O)=O)OC1(C)O)O)=O,,,5,1,1,0,1
76655_0,,,,2,1,1,2
C1(C(O)OC(C(C(C)=O)=O)C1O)=O,,,5,1,1,0,1
76657_0,,,,2,1,1,2
C(C1C(C(C(O1)O)=O)(C)O)(CO)=O,,,5,1,1,0,1
76659_0,,,,2,1,1,2
C1(C(OC(C(C=O)=O)(C)C1)O)=O,,,5,1,2,0,2
76661_0,,,,2,1,1,2
C1(C(OC(C(C=O)=O)C1(C)O)O)=O,,,5,1,1,0,1
76663_0,,,,2,1,1,2
C1(C(C(C(C=O)=O)(C)OC1O)O)=O,,,5,1,2,0,2
76665_0,,,,2,1,1,2
C1(C(OC(C=O)C1(C)O)O)=O,,,5,1,1,0,1
76667_0,,,,2,1,1,2
C(C1(C=C)CC(C(C=O)(O1)O)=O)=O,,,5,1,1,0,1
76669_0,,,,2,1,1,2
C(C1(C(CC(C(C=C)=O)O1)=O)O)=O,,,5,1,1,0,1
76671_0,,,,2,1,1,2
C(C1(C(CC(C=CC=O)O1)=O)O)=O,,,5,1,1,0,1
76672_0,,,,2,1,1,2
76674_0,,,,2,1,1,2
C(C(C1(CC(C(O1)O)O)O)=O)=O,,,5,1,1,0,1
76676_0,,,,2,1,1,2
C(C1(C(CC(C(O)O)O1)=O)O)=O,,,5,1,1,0,1
76678_0,,,,2,1,1,2
C(C(C1(CC(C(C)O1)O)O)=O)=O,,,5,1,1,0,1
76680_0,,,,2,1,1,2
C(C1(C(CC(C(C)O)O1)=O)O)=O,,,5,1,1,0,1
76682_0,,,,2,1,1,2
C(C(C1(CC(C(CO)O1)O)O)=O)=O,,,5,1,2,0,2
76684_0,,,,2,1,1,2
C(C1(C(CC(C(CO)O)O1)=O)O)=O,,,5,1,1,0,1
76686_0,,,,2,1,1,2
C(C1(C(CC(C=O)O1)=O)O)=O,,,5,1,1,0,1
76688_0,,,,2,1,1,2
C(C(C1(CC(CO)(CO1)O)O)=O)=O,,,5,1,2,0,2
76690_0,,,,2,1,1,2
C(C1(C(CC(CO)(CO)O1)=O)O)=O,,,5,1,1,0,1
76692_0,,,,2,1,1,2
C1(C(CC(C(C=O)=O)(O)O1)O)=O,,,5,1,2,0,2
76694_0,,,,2,1,1,2
C(C1(C(CC(C(O)=O)O1)=O)O)=O,,,5,1,1,0,1
76696_0,,,,2,1,1,2
C(C1(C)CC(C(C=O)(O1)O)=O)=O,,,5,1,1,0,1
76697_0,,,,2,1,1,2
76698_0,,,,2,1,1,2
76700_0,,,,2,1,1,2
C(C1(C(CC(C)O1)=O)O)=O,,,5,1,1,0,1
76702_0,,,,2,1,1,2
C(C1(COC(C(C=O)=O)(C1)O)O)=O,,,5,1,2,0,2
76704_0,,,,2,1,1,2
C(C1(CO)CC(C(C=O)(O1)O)=O)=O,,,5,1,1,0,1
76706_0,,,,2,1,1,2
C(C1(C(CC(C(CO)=O)O1)=O)O)=O,,,5,1,1,0,1
76707_0,,,,2,1,1,2
76708_0,,,,2,1,1,2
76709_0,,,,2,1,1,2
76710_0,,,,2,1,1,2
76712_0,,,,2,1,1,2
C(C1(C=C)C(C(C(O1)O)=O)CO)=O,,,5,1,1,0,1
76713_0,,,,2,1,1,2
76715_0,,,,2,1,1,2
C=CC1(C(O)OCC1C(C=O)=O)O,,,5,1,1,0,1
76717_0,,,,2,1,1,2
C(C1C(C=O)C(C=C)(C(O1)O)O)=O,,,5,1,1,0,1
76719_0,,,,2,1,1,2
C(C1(C=C)C(C=O)C(C(O1)O)O)=O,,,5,1,1,0,1
76720_0,,,,2,1,1,2
76721_0,,,,2,1,1,2
76722_0,,,,2,1,1,2
76723_0,,,,2,1,1,2
76725_0,,,,2,1,1,2
C1(C(OC(C(C=C)=O)C1CO)O)=O,,,5,1,1,0,1
76726_0,,,,2,1,1,2
76728_0,,,,2,1,1,2
C=CC1(C(C(C(C=O)=O)CO1)O)O,,,5,1,1,0,1
76730_0,,,,2,1,1,2
C(C1C(C(C=C)(OC1C=O)O)O)=O,,,5,1,1,0,1
76732_0,,,,2,1,1,2
C(C1C(C(OC1C(C=C)=O)O)O)=O,,,5,1,1,0,1
76733_0,,,,2,1,1,2
76734_0,,,,2,1,1,2
76735_0,,,,2,1,1,2
76736_0,,,,2,1,1,2
76738_0,,,,2,1,1,2
C1(C(OC(C=CC=O)C1CO)O)=O,,,5,1,1,0,1
76739_0,,,,2,1,1,2
76741_0,,,,2,1,1,2
C(C1C(C(OC1C=CC=O)O)O)=O,,,5,1,1,0,1
76742_0,,,,2,1,1,2
76743_0,,,,2,1,1,2
76744_0,,,,2,1,1,2
76746_0,,,,2,1,1,2
C1C2(C(C(O)O1)O)C(CC(O)O2)O,,,5,1,2,0,2
76748_0,,,,2,1,1,2
C1(C(O)OC2(C(O)OCC2O)C1)=O,,,5,1,2,0,2
76750_0,,,,2,1,1,2
C(C1(CC2(C(O)OCC2O1)O)O)=O,,,5,1,2,0,2
76752_0,,,,2,1,1,2
C(C1(CC2(C(O1)OCC2O)O)O)=O,,,5,1,1,0,1
76754_0,,,,2,1,1,2
C(C1C(O)OC2COC(C21O)O)=O,,,5,1,2,0,2
76756_0,,,,2,1,1,2
C(C1C(O)OC2C1(C(CO2)O)O)=O,,,5,1,1,0,1
76758_0,,,,2,1,1,2
C1C2C(C(O)O1)(CC(O)O2)O,,,5,1,2,0,2
76760_0,,,,2,1,1,2
C1C(C2(C(O1)OC(C2)O)O)O,,,5,1,1,0,1
76761_0,,,,2,1,1,2
76762_0,,,,2,1,1,2
76764_0,,,,2,1,1,2
C(CC1C(C(C(O1)O)(CO)O)=O)=O,,,5,1,1,0,1
76766_0,,,,2,1,1,2
C(C1(C(C(C(O)O1)O)O)O)O,,,5,1,1,0,1
76768_0,,,,2,1,1,2
C(C(C1(C(C(C(O)O1)O)O)O)O)O,,,5,1,1,0,1
76770_0,,,,2,1,1,2
C1(C(O)OC(C(O)O)C1)=O,,,5,1,1,0,1
76772_0,,,,2,1,1,2
C(C1(CC(C(O1)O)O)O)=O,,,5,1,1,0,1
76774_0,,,,2,1,1,2
C(C1C(O)OC(C1O)O)=O,,,5,1,1,0,1
76776_0,,,,2,1,1,2
C1(C(O)OC(C(O)O)C1CO)=O,,,5,1,1,0,1
76777_0,,,,2,1,1,2
76779_0,,,,2,1,1,2
C(C1(C(CO)C(C(O1)O)O)O)=O,,,5,1,1,0,1
76781_0,,,,2,1,1,2
C(C1C(C(O)O)OC(C1O)O)=O,,,5,1,1,0,1
76783_0,,,,2,1,1,2
C(C(C1C(O)OC(C1O)O)O)=O,,,5,1,1,0,1
76784_0,,,,2,1,1,2
76786_0,,,,2,1,1,2
C(CO)(C1C(O)OC(C1O)O)=O,,,5,1,1,0,1
76788_0,,,,2,1,1,2
C(C1C(CO)(O)OC(C1O)O)=O,,,5,1,1,0,1
76789_0,,,,2,1,1,2
76791_0,,,,2,1,1,2
C(CC1(C(C(C(O)O1)O)O)O)=O,,,5,1,1,0,1
76793_0,,,,2,1,1,2
C(C(C1(CC(C(O)O1)O)O)O)=O,,,5,1,1,0,1
76795_0,,,,2,1,1,2
C1(C(CC(O)O1)O)O,,,5,1,1,0,1
76797_0,,,,2,1,1,2
C1(C(O)OC(C(O)O)C1O)=O,,,5,1,1,0,1
76799_0,,,,2,1,1,2
C(C1(C(C(C(O1)O)O)O)O)=O,,,5,1,2,0,2
76801_0,,,,2,1,1,2
C1(C(C(C(O)O1)O)O)O,,,5,1,1,0,1
76803_0,,,,2,1,1,2
CC1C(C(C(CO)(O)O1)O)O,,,5,1,1,0,1
76805_0,,,,2,1,1,2
CC1C(C(C(C(CO)O)(O)O1)O)O,,,5,1,1,0,1
76807_0,,,,2,1,1,2
C1(C(O)OC(C(C)O)C1)=O,,,5,1,1,0,1
76809_0,,,,2,1,1,2
C(C1(CC(C(C)O1)O)O)=O,,,5,1,1,0,1
76811_0,,,,2,1,1,2
C(C1C(O)OC(C)C1O)=O,,,5,1,1,0,1
76813_0,,,,2,1,1,2
C1(C(O)OC(C(C)O)C1CO)=O,,,5,1,1,0,1
76814_0,,,,2,1,1,2
76816_0,,,,2,1,1,2
C(C1(C(CO)C(C(C)O1)O)O)=O,,,5,1,1,0,1
76818_0,,,,2,1,1,2
C(C1C(C(C)O)OC(C1O)O)=O,,,5,1,1,0,1
76820_0,,,,2,1,1,2
C(C(C1C(O)OC(C)C1O)O)=O,,,5,1,1,0,1
76821_0,,,,2,1,1,2
76823_0,,,,2,1,1,2
C(CO)(C1C(O)OC(C)C1O)=O,,,5,1,1,0,1
76825_0,,,,2,1,1,2
C(C1C(CO)(O)OC(C)C1O)=O,,,5,1,1,0,1
76826_0,,,,2,1,1,2
76828_0,,,,2,1,1,2
C(CC1(C(C(C(C)O1)O)O)O)=O,,,5,1,1,0,1
76830_0,,,,2,1,1,2
C(C(C1(CC(C(C)O1)O)O)O)=O,,,5,1,1,0,1
76832_0,,,,2,1,1,2
CC1C(CC(O)O1)O,,,5,1,1,0,1
76834_0,,,,2,1,1,2
C1(C(O)OC(C(C)O)C1O)=O,,,5,1,1,0,1
76836_0,,,,2,1,1,2
C(C1(C(C(C(C)O1)O)O)O)=O,,,5,1,1,0,1
76837_0,,,,2,1,1,2
76839_0,,,,2,1,1,2
C(C1CC(C)(C(O1)O)O)(O)=O,,,5,1,1,0,1
76841_0,,,,2,1,1,2
C(C1C(CO)C(C)(C(O1)O)O)(O)=O,,,5,1,1,0,1
76842_0,,,,2,1,1,2
76844_0,,,,2,1,1,2
C(C1C(C(C)(C(O1)O)O)O)(O)=O,,,5,1,1,0,1
76846_0,,,,2,1,1,2
C(C1CC(C(C)(O1)O)O)(O)=O,,,5,1,1,0,1
76848_0,,,,2,1,1,2
C(C1C(CO)C(C(C)(O1)O)O)(O)=O,,,5,1,1,0,1
76849_0,,,,2,1,1,2
76851_0,,,,2,1,1,2
C(C1CC(C(O1)O)(CCO)O)(O)=O,,,5,1,1,0,1
76852_0,,,,2,1,1,2
76854_0,,,,2,1,1,2
C(C1CC(C(CCO)(O1)O)O)(O)=O,,,5,1,1,0,1
76855_0,,,,2,1,1,2
76856_0,,,,2,1,1,2
76858_0,,,,2,1,1,2
C(C1CC(CO)(C(O1)O)O)(O)=O,,,5,1,1,0,1
76860_0,,,,2,1,1,2
C(C1CC(C(CO)(O1)O)O)(O)=O,,,5,1,1,0,1
76862_0,,,,2,1,1,2
C(C1CC(C(O1)O)O)(O)=O,,,5,1,1,0,1
76863_0,,,,2,1,1,2
76864_0,,,,2,1,1,2
76866_0,,,,2,1,1,2
C(C1C(C(CO)(C(O1)O)O)O)(O)=O,,,5,1,1,0,1
76868_0,,,,2,1,1,2
C(C1C(C(C(CO)(O1)O)O)O)(O)=O,,,5,1,1,0,1
76869_0,,,,2,1,1,2
76870_0,,,,2,1,1,2
76872_0,,,,2,1,1,2
C1(C(C(C=O)(OC1CO)O)O)=O,,,5,1,1,0,1
76873_0,,,,2,1,1,2
76874_0,,,,2,1,1,2
76875_0,,,,2,1,1,2
76876_0,,,,2,1,1,2
76878_0,,,,2,1,1,2
C(C1C(CC(C=O)(O1)O)=O)=O,,,5,1,1,0,1
76879_0,,,,2,1,1,2
76880_0,,,,2,1,1,2
76882_0,,,,2,1,1,2
C(CO)(C1(C(C(CO1)O)O)O)=O,,,5,1,1,0,1
76883_0,,,,2,1,1,2
76884_0,,,,2,1,1,2
76885_0,,,,2,1,1,2
76887_0,,,,2,1,1,2
C(C1(C(C(O)OC1C=O)=O)O)=O,,,5,1,1,0,1
76888_0,,,,2,1,1,2
76890_0,,,,2,1,1,2
C1(COC(C=O)(C1(CO)O)O)=O,,,5,1,1,0,1
76891_0,,,,2,1,1,2
76892_0,,,,2,1,1,2
76893_0,,,,2,1,1,2
76894_0,,,,2,1,1,2
76895_0,,,,2,1,1,2
76897_0,,,,2,1,1,2
C1(COC(C(CO)=O)(C1O)O)=O,,,5,1,1,0,1
76898_0,,,,2,1,1,2
76899_0,,,,2,1,1,2
76901_0,,,,2,1,1,2
C(C1(C(C(O)OC1C)=O)O)=O,,,5,1,1,0,1
76903_0,,,,2,1,1,2
C1(C(C)(O)OCC1(CO)O)=O,,,5,1,1,0,1
76905_0,,,,2,1,1,2
C1(C(C(C(O)O1)=O)(C)O)=O,,,5,1,1,0,1
76906_0,,,,2,1,1,2
76908_0,,,,2,1,1,2
C1(C(C(C(CCO)(O)O1)=O)O)=O,,,5,1,1,0,1
76910_0,,,,2,1,1,2
C1(C(C(C(O)O1)=O)(CCO)O)=O,,,5,1,1,0,1
76912_0,,,,2,1,1,2
C(C1(CCOC1(C=O)O)O)(O)=O,,,5,1,1,0,1
76913_0,,,,2,1,1,2
76914_0,,,,2,1,1,2
76915_0,,,,2,1,1,2
76917_0,,,,2,1,1,2
C(C1(CCOC1(C(C)=O)O)O)=O,,,5,1,1,0,1
76918_0,,,,2,1,1,2
76920_0,,,,2,1,1,2
C(C1(CCOC1(C=O)O)O)=O,,,5,1,1,0,1
76921_0,,,,2,1,1,2
76922_0,,,,2,1,1,2
76924_0,,,,2,1,1,2
C(C1CC(C(C(C)=O)(O1)O)O)=O,,,5,1,1,0,1
76925_0,,,,2,1,1,2
76927_0,,,,2,1,1,2
C(C1CC(C(C=O)(O1)O)O)=O,,,5,1,1,0,1
76929_0,,,,2,1,1,2
C1(C(C)(O)OCC1(CC=O)O)=O,,,5,1,1,0,1
76930_0,,,,2,1,1,2
76931_0,,,,2,1,1,2
76932_0,,,,2,1,1,2
76934_0,,,,2,1,1,2
C1(C(C)(C(C=O)OC1(C)O)O)=O,,,5,1,1,0,1
76935_0,,,,2,1,1,2
76937_0,,,,2,1,1,2
C(C1(C(C(C)(O)OC1)=O)O)=O,,,5,1,1,0,1
76939_0,,,,2,1,1,2
C1(COC(C(C)=O)(C1O)O)=O,,,5,1,1,0,1
76940_0,,,,2,1,1,2
76942_0,,,,2,1,1,2
C1(C(CCO)(O)OCC1O)=O,,,5,1,1,0,1
76943_0,,,,2,1,1,2
76944_0,,,,2,1,1,2
76945_0,,,,2,1,1,2
76946_0,,,,2,1,1,2
76947_0,,,,2,1,1,2
76948_0,,,,2,1,1,2
76949_0,,,,2,1,1,2
76950_0,,,,2,1,1,2
76951_0,,,,2,1,1,2
76952_0,,,,2,1,1,2
76953_0,,,,2,1,1,2
76955_0,,,,2,1,1,2
C(C1(C(O)OCC1)O)(O)=O,,,5,1,1,0,1
76957_0,,,,2,1,1,2
C(C(O)OC1COC(C1O)O)=O,,,5,1,1,0,1
76959_0,,,,2,1,1,2
C(COC1C(C(C(O)O1)O)O)=O,,,5,1,1,0,1
76961_0,,,,2,1,1,2
C(C1(C(CC(CO)(CO)O1)O)O)=O,,,5,1,1,0,1
76962_0,,,,2,1,1,2
76964_0,,,,2,1,1,2
C1(C(CO)OC(C1(C)O)O)=O,,,5,1,1,0,1
76966_0,,,,2,1,1,2
C(C1C(C(C)(C(O1)O)O)O)=O,,,5,1,1,0,1
76967_0,,,,2,1,1,2
76968_0,,,,2,1,1,2
76970_0,,,,2,1,1,2
C1(C(C)OC(CO)(C1O)O)=O,,,5,1,1,0,1
76972_0,,,,2,1,1,2
C1(C(CO)OC(C)(C1O)O)=O,,,5,1,1,0,1
76973_0,,,,2,1,1,2
76975_0,,,,2,1,1,2
C(C1(CCOC1(C(CO)O)O)O)=O,,,5,1,1,0,1
76977_0,,,,2,1,1,2
C1(C(CO)OC(C1(CCO)O)O)=O,,,5,1,1,0,1
76978_0,,,,2,1,1,2
76980_0,,,,2,1,1,2
C(C1C(C(C(O1)O)(CCO)O)O)=O,,,5,1,1,0,1
76981_0,,,,2,1,1,2
76983_0,,,,2,1,1,2
C(CO)(C(C1(C(CCO1)O)O)O)=O,,,5,1,1,0,1
76984_0,,,,2,1,1,2
76986_0,,,,2,1,1,2
C1(C(CCO)OC(CO)(C1O)O)=O,,,5,1,1,0,1
76988_0,,,,2,1,1,2
C1(C(CO)OC(CCO)(C1O)O)=O,,,5,1,1,0,1
76990_0,,,,2,1,1,2
C(C1CC(C(C(CO)O)(O1)O)O)=O,,,5,1,1,0,1
76991_0,,,,2,1,1,2
76992_0,,,,2,1,1,2
76993_0,,,,2,1,1,2
76994_0,,,,2,1,1,2
76996_0,,,,2,1,1,2
C(C1C(C(CO)(C(O1)O)O)O)=O,,,5,1,1,0,1
76997_0,,,,2,1,1,2
76998_0,,,,2,1,1,2
77000_0,,,,2,1,1,2
C1(C(CO)OC(CO)(C1O)O)=O,,,5,1,1,0,1
77002_0,,,,2,1,1,2
C1(C(C(CO)O)OC(C1(C)O)O)=O,,,5,1,1,0,1
77003_0,,,,2,1,1,2
77005_0,,,,2,1,1,2
C(CO)(C1C(C(C(O1)O)(C)O)O)=O,,,5,1,1,0,1
77007_0,,,,2,1,1,2
C(C1(C)C(C(C(CO)(O1)O)O)O)=O,,,5,1,1,0,1
77009_0,,,,2,1,1,2
C1(C(CO)OC(C(C)O)(C1O)O)=O,,,5,1,1,0,1
77011_0,,,,2,1,1,2
C1(C(C)OC(C(CO)O)(C1O)O)=O,,,5,1,1,0,1
77013_0,,,,2,1,1,2
C1(C(C(CO)O)OC(C)(C1O)O)=O,,,5,1,1,0,1
77014_0,,,,2,1,1,2
77015_0,,,,2,1,1,2
77017_0,,,,2,1,1,2
C(C1CC(C(C=O)(O1)O)O)(O)=O,,,5,1,1,0,1
77019_0,,,,2,1,1,2
C(CC1C(C(C(O1)O)(C)O)=O)=O,,,5,1,1,0,1
77021_0,,,,2,1,1,2
C(C(C1CC(C)(C(O1)O)O)=O)=O,,,5,1,1,0,1
77023_0,,,,2,1,1,2
C(C1(C)CC(C(C=O)(O1)O)O)=O,,,5,1,1,0,1
77025_0,,,,2,1,1,2
C(C1C(C(C(O1)O)(C)O)=O)=O,,,5,1,1,0,1
77026_0,,,,2,1,1,2
77028_0,,,,2,1,1,2
C1(CC(C=O)(OC1C)O)=O,,,5,1,1,0,1
77030_0,,,,2,1,1,2
C(C1C(C(C)OC1O)=O)=O,,,5,1,1,0,1
77032_0,,,,2,1,1,2
C1(C(CO)C(C=O)(OC1C)O)=O,,,5,1,1,0,1
77033_0,,,,2,1,1,2
77035_0,,,,2,1,1,2
C1(C(C)OC(C1C(C=O)O)O)=O,,,5,1,1,0,1
77037_0,,,,2,1,1,2
C1(C(C)OC(C1C(CO)=O)O)=O,,,5,1,1,0,1
77039_0,,,,2,1,1,2
C(C1C(C(C)OC1(CO)O)=O)=O,,,5,1,1,0,1
77040_0,,,,2,1,1,2
77042_0,,,,2,1,1,2
C(C1C(COC1(C(C)O)O)=O)=O,,,5,1,1,0,1
77044_0,,,,2,1,1,2
C(CC1C(C(C(C)(O1)O)O)=O)=O,,,5,1,1,0,1
77045_0,,,,2,1,1,2
77047_0,,,,2,1,1,2
C(CC1(C(C(C(C)O1)=O)O)O)=O,,,5,1,1,0,1
77049_0,,,,2,1,1,2
C(C(C1CC(C(C)(O1)O)O)=O)=O,,,5,1,1,0,1
77051_0,,,,2,1,1,2
C(C1(C(CC(C(C)=O)O1)O)O)=O,,,5,1,1,0,1
77053_0,,,,2,1,1,2
C(C1C(CC(C(C)O)(O1)O)=O)=O,,,5,1,1,0,1
77055_0,,,,2,1,1,2
C(C(C1(CC(C(C)O1)=O)O)O)=O,,,5,1,1,0,1
77057_0,,,,2,1,1,2
C1(C(C)OC(C1)O)=O,,,5,1,1,0,1
77059_0,,,,2,1,1,2
C(C1C(C(C(C)(O1)O)O)=O)=O,,,5,1,1,0,1
77060_0,,,,2,1,1,2
77062_0,,,,2,1,1,2
C1(C(C(C=O)(OC1C)O)O)=O,,,5,1,1,0,1
77063_0,,,,2,1,1,2
77065_0,,,,2,1,1,2
C(C(CC1(C(CCO1)O)O)=O)=O,,,5,1,1,0,1
77067_0,,,,2,1,1,2
C1(CC(C=O)(OC1CCO)O)=O,,,5,1,1,0,1
77069_0,,,,2,1,1,2
C(C(CC1(C(C(CO1)O)O)O)=O)=O,,,5,1,1,0,1
77071_0,,,,2,1,1,2
C1(CC(C=O)(OC1C(CO)O)O)=O,,,5,1,1,0,1
77073_0,,,,2,1,1,2
C(CC1CC(C(C=O)(O)O1)O)=O,,,5,1,1,0,1
77075_0,,,,2,1,1,2
C(C(C=O)C1(C(CCO1)O)O)=O,,,5,1,1,0,1
77077_0,,,,2,1,1,2
C(C1C(C(CCO)OC1O)=O)=O,,,5,1,1,0,1
77079_0,,,,2,1,1,2
C(C1C(C(CO)OC1O)=O)=O,,,5,1,1,0,1
77081_0,,,,2,1,1,2
C(C(C=O)C1(C(C(CO1)O)O)O)=O,,,5,1,1,0,1
77083_0,,,,2,1,1,2
C(C1C(C(C(CO)O)OC1O)=O)=O,,,5,1,1,0,1
77085_0,,,,2,1,1,2
C(C1C(C(C(O1)O)(CCO)O)=O)=O,,,5,1,1,0,1
77086_0,,,,2,1,1,2
77088_0,,,,2,1,1,2
C(C1(C(C(C=O)O)(O)OCC1)O)=O,,,5,1,1,0,1
77089_0,,,,2,1,1,2
77091_0,,,,2,1,1,2
C1(COC(C1(CCO)O)O)=O,,,5,1,1,0,1
77093_0,,,,2,1,1,2
C(C1(C(CO)(O)OCC1)O)=O,,,5,1,1,0,1
77094_0,,,,2,1,1,2
77096_0,,,,2,1,1,2
C1(C(CCO)OC(C1)O)=O,,,5,1,1,0,1
77098_0,,,,2,1,1,2
C(CC1(C(CCO1)O)O)=O,,,5,1,1,0,1
77100_0,,,,2,1,1,2
C(C1C(C(C(CCO)(O1)O)O)=O)=O,,,5,1,1,0,1
77101_0,,,,2,1,1,2
77103_0,,,,2,1,1,2
C1(C(C(C=O)(OC1CCO)O)O)=O,,,5,1,1,0,1
77105_0,,,,2,1,1,2
C(C(C(C1(C(CCO1)O)O)O)=O)=O,,,5,1,1,0,1
77107_0,,,,2,1,1,2
C1(COC(CCO)(C1O)O)=O,,,5,1,1,0,1
77109_0,,,,2,1,1,2
C1(C(CCO)OC(C1O)O)=O,,,5,1,1,0,1
77111_0,,,,2,1,1,2
C(C(C1(C(CCO1)O)O)O)=O,,,5,1,1,0,1
77113_0,,,,2,1,1,2
C1(C(CO)C(C=O)(OC1CO)O)=O,,,5,1,1,0,1
77114_0,,,,2,1,1,2
77115_0,,,,2,1,1,2
77116_0,,,,2,1,1,2
77117_0,,,,2,1,1,2
77118_0,,,,2,1,1,2
77120_0,,,,2,1,1,2
C(C(C1(C(CC(C=O)O1)O)O)O)=O,,,5,1,1,0,1
77121_0,,,,2,1,1,2
77123_0,,,,2,1,1,2
C(C1CC(C(CO)(O1)O)O)=O,,,5,1,1,0,1
77124_0,,,,2,1,1,2
77125_0,,,,2,1,1,2
77126_0,,,,2,1,1,2
77128_0,,,,2,1,1,2
C1(C(CO)OC(C1C(CO)=O)O)=O,,,5,1,1,0,1
77130_0,,,,2,1,1,2
C(C1C(C(CO)OC1(CO)O)=O)=O,,,5,1,1,0,1
77132_0,,,,2,1,1,2
C(C1C(COC1(C(CO)O)O)=O)=O,,,5,1,1,0,1
77133_0,,,,2,1,1,2
77134_0,,,,2,1,1,2
77135_0,,,,2,1,1,2
77136_0,,,,2,1,1,2
77138_0,,,,2,1,1,2
C(CC1(C(C(C(CO)O1)=O)O)O)=O,,,5,1,1,0,1
77139_0,,,,2,1,1,2
77141_0,,,,2,1,1,2
C(CC1C(C(C(CO)(O1)O)O)=O)=O,,,5,1,1,0,1
77142_0,,,,2,1,1,2
77144_0,,,,2,1,1,2
C(CC1(C(C(CO1)=O)O)O)=O,,,5,1,1,0,1
77145_0,,,,2,1,1,2
77147_0,,,,2,1,1,2
C(C1(C(CC(C)O1)O)O)=O,,,5,1,1,0,1
77149_0,,,,2,1,1,2
C(C(C1CC(CO)(C(O1)O)O)=O)=O,,,5,1,1,0,1
77151_0,,,,2,1,1,2
C(C1(CO)CC(C(C=O)(O1)O)O)=O,,,5,1,1,0,1
77153_0,,,,2,1,1,2
C(C1C(CC(C(CO)O)(O1)O)=O)=O,,,5,1,1,0,1
77155_0,,,,2,1,1,2
C(C(C1(CC(C(CO)O1)=O)O)O)=O,,,5,1,1,0,1
77157_0,,,,2,1,1,2
C(C(C1CC(C(CO)(O1)O)O)=O)=O,,,5,1,1,0,1
77159_0,,,,2,1,1,2
C(C1(C(CC(C(CO)=O)O1)O)O)=O,,,5,1,1,0,1
77161_0,,,,2,1,1,2
C(C1(C(CC(C(CO)O)O1)O)O)=O,,,5,1,1,0,1
77163_0,,,,2,1,1,2
C(C1C(CC(CO)(O1)O)=O)=O,,,5,1,1,0,1
77165_0,,,,2,1,1,2
C(C(C1(CC(CO1)=O)O)O)=O,,,5,1,1,0,1
77167_0,,,,2,1,1,2
C(C1(C(CCO1)O)O)=O,,,5,1,1,0,1
77169_0,,,,2,1,1,2
C(C1(C(CC(CO)O1)O)O)=O,,,5,1,1,0,1
77171_0,,,,2,1,1,2
C(C1C(C(C(O1)O)(CO)O)=O)=O,,,5,1,1,0,1
77172_0,,,,2,1,1,2
77174_0,,,,2,1,1,2
C(C1C(C(C(CO)(O1)O)O)=O)=O,,,5,1,1,0,1
77175_0,,,,2,1,1,2
77176_0,,,,2,1,1,2
77177_0,,,,2,1,1,2
77178_0,,,,2,1,1,2
77179_0,,,,2,1,1,2
77181_0,,,,2,1,1,2
C(C1(C(CO)(O)OC(C1O)=O)O)=O,,,5,1,1,0,1
77182_0,,,,2,1,1,2
77183_0,,,,2,1,1,2
77185_0,,,,2,1,1,2
C1(C(C(OC1C)O)(C(C=O)O)O)=O,,,5,1,1,0,1
77186_0,,,,2,1,1,2
77187_0,,,,2,1,1,2
77188_0,,,,2,1,1,2
77189_0,,,,2,1,1,2
77190_0,,,,2,1,1,2
77191_0,,,,2,1,1,2
77192_0,,,,2,1,1,2
77193_0,,,,2,1,1,2
77194_0,,,,2,1,1,2
77196_0,,,,2,1,1,2
C1(COC(C(C)O)(C1(CO)O)O)=O,,,5,1,1,0,1
77198_0,,,,2,1,1,2
C1(C(C)OC(CO)(C1(CO)O)O)=O,,,5,1,1,0,1
77199_0,,,,2,1,1,2
77200_0,,,,2,1,1,2
77202_0,,,,2,1,1,2
C1(COC(CO)(C1(CO)O)O)=O,,,5,1,1,0,1
77204_0,,,,2,1,1,2
C(C1(CO)C(C(C(O1)O)O)O)(O)=O,,,5,1,1,0,1
77205_0,,,,2,1,1,2
77207_0,,,,2,1,1,2
C1(C(C)OC(C1(C(C)=O)O)O)=O,,,5,1,1,0,1
77209_0,,,,2,1,1,2
C(C1(C(C(C)OC1(C)O)=O)O)=O,,,5,1,1,0,1
77210_0,,,,2,1,1,2
77212_0,,,,2,1,1,2
C1(C(CO)(C(C=O)(OC1C)O)O)=O,,,5,1,1,0,1
77214_0,,,,2,1,1,2
C1(C(C)OC(C1(CO)O)O)=O,,,5,1,1,0,1
77216_0,,,,2,1,1,2
C1(C(C)OC(C1(C(CO)O)O)O)=O,,,5,1,1,0,1
77217_0,,,,2,1,1,2
77219_0,,,,2,1,1,2
C(C1(C(COC1(C(C)O)O)O)O)=O,,,5,1,1,0,1
77221_0,,,,2,1,1,2
C1(C(CCO)OC(C1(CO)O)O)=O,,,5,1,1,0,1
77223_0,,,,2,1,1,2
C(C(CO)(C1(C(CCO1)O)O)O)=O,,,5,1,1,0,1
77225_0,,,,2,1,1,2
C1(C(CO)OC(C1(C(C)=O)O)O)=O,,,5,1,1,0,1
77227_0,,,,2,1,1,2
C(C1(C(C(CO)OC1(C)O)=O)O)=O,,,5,1,1,0,1
77229_0,,,,2,1,1,2
C(C1C(C(C(C)=O)(C(O1)O)O)O)=O,,,5,1,1,0,1
77231_0,,,,2,1,1,2
C(C1(C(C(C=O)OC1(C)O)O)O)=O,,,5,1,1,0,1
77233_0,,,,2,1,1,2
C(C1(C(C)=O)C(C(C(O1)O)O)O)=O,,,5,1,1,0,1
77234_0,,,,2,1,1,2
77236_0,,,,2,1,1,2
C(C1(C(COC1(C)O)=O)O)=O,,,5,1,1,0,1
77238_0,,,,2,1,1,2
C(C1(COC(C1O)(C(C)O)O)O)=O,,,5,1,1,0,1
77240_0,,,,2,1,1,2
C(C1(COC(CO)(C1(C)O)O)O)=O,,,5,1,1,0,1
77242_0,,,,2,1,1,2
C1(C(C(OC1C)O)(CC=O)O)=O,,,5,1,1,0,1
77244_0,,,,2,1,1,2
C(C1(CCOC1(C(C)O)O)O)(O)=O,,,5,1,1,0,1
77246_0,,,,2,1,1,2
C(C(C)(C1(C(CCO1)O)O)O)(O)=O,,,5,1,1,0,1
77248_0,,,,2,1,1,2
C(C(C1(C(CCO1)O)O)O)(O)=O,,,5,1,1,0,1
77250_0,,,,2,1,1,2
C1(C(C(OC1CO)O)(CC=O)O)=O,,,5,1,1,0,1
77251_0,,,,2,1,1,2
77253_0,,,,2,1,1,2
C1(C(C)(C(C(C(C)O)(O)O1)O)O)=O,,,5,1,1,0,1
77255_0,,,,2,1,1,2
C1(C(C(C(C(C)O)(O)O1)O)O)=O,,,5,1,1,0,1
77257_0,,,,2,1,1,2
C1(C(C)(C(C)(C(CO)(O)O1)O)O)=O,,,5,1,1,0,1
77259_0,,,,2,1,1,2
C1(C(C(C)(C(CO)(O)O1)O)O)=O,,,5,1,1,0,1
77261_0,,,,2,1,1,2
C(C1(C)C(C(C(O1)O)O)O)(O)=O,,,5,1,1,0,1
77263_0,,,,2,1,1,2
C(C1(C(CO)(O)OCC1)O)(O)=O,,,5,1,1,0,1
77264_0,,,,2,1,1,2
77265_0,,,,2,1,1,2
77266_0,,,,2,1,1,2
77268_0,,,,2,1,1,2
C(C1CC(CO)(C(O1)O)O)=O,,,5,1,1,0,1
77270_0,,,,2,1,1,2
C(C1(CO)CC(C(O1)O)O)=O,,,5,1,1,0,1
77272_0,,,,2,1,1,2
C1(CC(C(CO)(O)O1)O)=O,,,5,1,1,0,1
77274_0,,,,2,1,1,2
C(C1(C(CCO1)O)O)(O)=O,,,5,1,1,0,1
77276_0,,,,2,1,1,2
C1(CC(C(C(CO)O)(O)O1)O)=O,,,5,1,1,0,1
77278_0,,,,2,1,1,2
C(C1(C(CC(CO)O1)O)O)(O)=O,,,5,1,1,0,1
77280_0,,,,2,1,1,2
C1C(C(C(O)O1)O)C(CO)(CO)O,,,5,1,1,0,1
77281_0,,,,2,1,1,2
77282_0,,,,2,1,1,2
77283_0,,,,2,1,1,2
77284_0,,,,2,1,1,2
77286_0,,,,2,1,1,2
C(C(C)(C1COC(C1O)O)O)=O,,,5,1,1,0,1
77288_0,,,,2,1,1,2
C(C(C1COC(C1(C)O)O)O)=O,,,5,1,2,0,2
77289_0,,,,2,1,1,2
77290_0,,,,2,1,1,2
77292_0,,,,2,1,1,2
CC1(C(O)OCC1)O,,,5,1,1,0,1
77294_0,,,,2,1,1,2
CC1(C(O)OCC1O)O,,,5,1,1,0,1
77296_0,,,,2,1,1,2
C(C)(C(C1COC(C1O)O)O)=O,,,5,1,1,0,1
77298_0,,,,2,1,1,2
C(C(C1COC(C)(C1O)O)O)=O,,,5,1,2,0,2
77299_0,,,,2,1,1,2
77300_0,,,,2,1,1,2
77302_0,,,,2,1,1,2
CC1(C(CCO1)O)O,,,5,1,1,0,1
77303_0,,,,2,1,1,2
77304_0,,,,2,1,1,2
77305_0,,,,2,1,1,2
77307_0,,,,2,1,1,2
C1CC(C(CCO)(O)O1)O,,,5,1,1,0,1
77308_0,,,,2,1,1,2
77309_0,,,,2,1,1,2
77311_0,,,,2,1,1,2
C1C(C(C)O)C(C(O)O1)O,,,5,1,1,0,1
77312_0,,,,2,1,1,2
77314_0,,,,2,1,1,2
C(C(C1COC(C1(CO)O)O)O)=O,,,5,1,2,0,2
77316_0,,,,2,1,1,2
C(C(CO)(C1COC(C1O)O)O)=O,,,5,1,1,0,1
77317_0,,,,2,1,1,2
77318_0,,,,2,1,1,2
77320_0,,,,2,1,1,2
C(C(C1COC(CO)(C1O)O)O)=O,,,5,1,2,0,2
77322_0,,,,2,1,1,2
C(CO)(C(C1COC(C1O)O)O)=O,,,5,1,1,0,1
77323_0,,,,2,1,1,2
77324_0,,,,2,1,1,2
77326_0,,,,2,1,1,2
C1C(C(C(O)O1)O)C(C(CO)O)O,,,5,1,1,0,1
77327_0,,,,2,1,1,2
77329_0,,,,2,1,1,2
C(C(C1COC(C1O)O)O)=O,,,5,1,2,0,2
77330_0,,,,2,1,1,2
77331_0,,,,2,1,1,2
77333_0,,,,2,1,1,2
C1C(C(C(O)O1)O)C(CO)O,,,5,1,1,0,1
77334_0,,,,2,1,1,2
77336_0,,,,2,1,1,2
C1CC(C(O)O1)(CO)O,,,5,1,1,0,1
77338_0,,,,2,1,1,2
C1CC(C(CO)(O)O1)O,,,5,1,1,0,1
77340_0,,,,2,1,1,2
C1CC(C(C(CO)O)(O)O1)O,,,5,1,1,0,1
77342_0,,,,2,1,1,2
C(C(C1(C(O)OCC1(C)O)O)O)=O,,,5,1,1,0,1
77343_0,,,,2,1,1,2
77344_0,,,,2,1,1,2
77345_0,,,,2,1,1,2
77347_0,,,,2,1,1,2
C1C(C)(C(CO)(C(CO)(O)O1)O)O,,,5,1,1,0,1
77348_0,,,,2,1,1,2
77350_0,,,,2,1,1,2
C1C(C(C)O)(C(C(O)O1)(CO)O)O,,,5,1,1,0,1
77351_0,,,,2,1,1,2
77352_0,,,,2,1,1,2
77354_0,,,,2,1,1,2
C(C)(C1(COC(C1(C)O)O)O)=O,,,5,1,1,0,1
77356_0,,,,2,1,1,2
C(C)(C1(C(O)OCC1(C)O)O)=O,,,5,1,1,0,1
77358_0,,,,2,1,1,2
C(C1(C(C)(O)OCC1(C)O)O)=O,,,5,1,1,0,1
77360_0,,,,2,1,1,2
C(C1(C(CO)(C(CO1)(C)O)O)O)=O,,,5,1,1,0,1
77361_0,,,,2,1,1,2
77362_0,,,,2,1,1,2
77363_0,,,,2,1,1,2
77365_0,,,,2,1,1,2
C1C(C)(C(C(O)O1)(CO)O)O,,,5,1,1,0,1
77367_0,,,,2,1,1,2
C1C(C(CO)O)(C(C)(C(O)O1)O)O,,,5,1,1,0,1
77368_0,,,,2,1,1,2
77370_0,,,,2,1,1,2
C1C(C)(C(C(O)O1)(C(CO)O)O)O,,,5,1,1,0,1
77371_0,,,,2,1,1,2
77372_0,,,,2,1,1,2
77373_0,,,,2,1,1,2
77374_0,,,,2,1,1,2
77375_0,,,,2,1,1,2
77376_0,,,,2,1,1,2
77377_0,,,,2,1,1,2
77378_0,,,,2,1,1,2
77380_0,,,,2,1,1,2
C(C)(C1(COC(C1(CO)O)O)O)=O,,,5,1,1,0,1
77381_0,,,,2,1,1,2
77382_0,,,,2,1,1,2
77383_0,,,,2,1,1,2
77384_0,,,,2,1,1,2
77385_0,,,,2,1,1,2
77386_0,,,,2,1,1,2
77388_0,,,,2,1,1,2
C(CC1(COC(C1(C)O)O)O)=O,,,5,1,1,0,1
77389_0,,,,2,1,1,2
77390_0,,,,2,1,1,2
77392_0,,,,2,1,1,2
C(CC1(C(O)OCC1(C)O)O)=O,,,5,1,1,0,1
77393_0,,,,2,1,1,2
77395_0,,,,2,1,1,2
C(CC(C1(C(O)OCC1)O)O)=O,,,5,1,1,0,1
77396_0,,,,2,1,1,2
77397_0,,,,2,1,1,2
77399_0,,,,2,1,1,2
CC(C1(COC(C1)O)O)O,,,5,1,1,0,1
77400_0,,,,2,1,1,2
77402_0,,,,2,1,1,2
CC(C1(C(O)OCC1)O)O,,,5,1,1,0,1
77403_0,,,,2,1,1,2
77404_0,,,,2,1,1,2
77405_0,,,,2,1,1,2
77406_0,,,,2,1,1,2
77407_0,,,,2,1,1,2
77409_0,,,,2,1,1,2
C1(C(C(C)(C(O)O1)O)C(C=O)O)=O,,,5,1,1,0,1
77410_0,,,,2,1,1,2
77411_0,,,,2,1,1,2
77413_0,,,,2,1,1,2
C1(CC(C)(C(O)O1)O)=O,,,5,1,1,0,1
77414_0,,,,2,1,1,2
77416_0,,,,2,1,1,2
C1(C(C(C(C)(O)O1)O)C(C=O)O)=O,,,5,1,1,0,1
77417_0,,,,2,1,1,2
77418_0,,,,2,1,1,2
77420_0,,,,2,1,1,2
C1(CC(C(C)(O)O1)O)=O,,,5,1,1,0,1
77421_0,,,,2,1,1,2
77422_0,,,,2,1,1,2
77424_0,,,,2,1,1,2
C1(CC(C(O)O1)(CCO)O)=O,,,5,1,1,0,1
77425_0,,,,2,1,1,2
77427_0,,,,2,1,1,2
C1(CC(C(CCO)(O)O1)O)=O,,,5,1,1,0,1
77428_0,,,,2,1,1,2
77429_0,,,,2,1,1,2
77430_0,,,,2,1,1,2
77431_0,,,,2,1,1,2
77432_0,,,,2,1,1,2
77433_0,,,,2,1,1,2
77434_0,,,,2,1,1,2
77435_0,,,,2,1,1,2
77436_0,,,,2,1,1,2
77438_0,,,,2,1,1,2
C1(CC(CO)(C(O)O1)O)=O,,,5,1,1,0,1
77440_0,,,,2,1,1,2
C1(CC(C(O)O1)(C(CO)O)O)=O,,,5,1,1,0,1
77441_0,,,,2,1,1,2
77442_0,,,,2,1,1,2
77444_0,,,,2,1,1,2
C1(C(C(C)=O)(C(C)(C(O)O1)O)O)=O,,,5,1,1,0,1
77446_0,,,,2,1,1,2
C1(C(C)(C(C(C)=O)(C(O)O1)O)O)=O,,,5,1,1,0,1
77448_0,,,,2,1,1,2
C1(C(C)(C(C=O)(C(C)(O)O1)O)O)=O,,,5,1,1,0,1
77450_0,,,,2,1,1,2
C1(C(C(C)=O)(C(C(C)(O)O1)O)O)=O,,,5,1,1,0,1
77451_0,,,,2,1,1,2
77452_0,,,,2,1,1,2
77453_0,,,,2,1,1,2
77454_0,,,,2,1,1,2
77455_0,,,,2,1,1,2
77456_0,,,,2,1,1,2
77457_0,,,,2,1,1,2
77458_0,,,,2,1,1,2
77459_0,,,,2,1,1,2
77460_0,,,,2,1,1,2
77462_0,,,,2,1,1,2
C1(C(C(C)(C(O)O1)O)(CC=O)O)=O,,,5,1,1,0,1
77463_0,,,,2,1,1,2
77464_0,,,,2,1,1,2
77466_0,,,,2,1,1,2
C1(C(C)(C(C(O)O1)(CC=O)O)O)=O,,,5,1,1,0,1
77467_0,,,,2,1,1,2
77468_0,,,,2,1,1,2
77469_0,,,,2,1,1,2
77470_0,,,,2,1,1,2
77472_0,,,,2,1,1,2
C1(CC(C(O)O1)(C(CC=O)O)O)=O,,,5,1,1,0,1
77473_0,,,,2,1,1,2
77474_0,,,,2,1,1,2
77475_0,,,,2,1,1,2
77476_0,,,,2,1,1,2
77478_0,,,,2,1,1,2
C1(CC(C(O)O1)(C(C)O)O)=O,,,5,1,1,0,1
77479_0,,,,2,1,1,2
77480_0,,,,2,1,1,2
77481_0,,,,2,1,1,2
77482_0,,,,2,1,1,2
77483_0,,,,2,1,1,2
77484_0,,,,2,1,1,2
77485_0,,,,2,1,1,2
77486_0,,,,2,1,1,2
77486_1,,,,2,1,1,2
77487_0,,,,2,1,1,2
77487_1,,,,2,1,1,2
77488_0,,,,2,1,1,2
77488_1,,,,2,1,1,2
77489_0,,,,2,1,1,2
77489_1,,,,2,1,1,2
77491_0,,,,2,1,1,2
C1(C2(C(C(CC2O)O1)O)O)O,,,5,1,2,0,2
77491_1,,,,2,1,1,2
77493_0,,,,2,1,1,2
C1(C2(C(C(C(C2O)O1)O)O)O)O,,,5,1,2,0,2
77493_1,,,,2,1,1,2
77495_0,,,,2,1,1,2
C(C1(C2(C(CC(C2O)O1)O)O)O)O,,,5,1,2,0,2
77495_1,,,,2,1,1,2
77496_0,,,,2,1,1,2
77496_1,,,,2,1,1,2
77498_0,,,,2,1,1,2
C(C1(C2CC(C1(C(O)O2)O)O)O)O,,,5,1,2,0,2
77498_1,,,,2,1,1,2
77500_0,,,,2,1,1,2
C1C2(C(CC(C2(C(O)O1)O)O)O)O,,,5,1,1,0,1
77502_0,,,,2,1,1,2
C1(C(CC2(C(O)OCC12O)O)O)=O,,,5,1,1,0,1
77503_0,,,,2,1,1,2
77503_1,,,,2,1,1,2
77504_0,,,,2,1,1,2
77504_1,,,,2,1,1,2
77505_0,,,,2,1,1,2
77506_0,,,,2,1,1,2
77508_0,,,,2,1,1,2
C(C1(C2(C(C(CC2O)O1)O)O)O)=O,,,5,1,2,0,2
77508_1,,,,2,1,1,2
77510_0,,,,2,1,1,2
C(C1(C2CC(C1(C(O)O2)O)O)O)=O,,,5,1,2,0,2
77510_1,,,,2,1,1,2
77511_0,,,,2,1,1,2
77513_0,,,,2,1,1,2
C(C1(C(O)OCC1(CO)O)O)(O)=O,,,5,1,1,0,1
77515_0,,,,2,1,1,2
C(CO)(C1(C(C)OC(C1O)O)O)=O,,,5,1,1,0,1
77517_0,,,,2,1,1,2
C1C(C(C(C)O)(C(CO)(O)O1)O)O,,,5,1,1,0,1
77519_0,,,,2,1,1,2
C1(C(C=O)(C(C(CO)(O)O1)O)O)=O,,,5,1,1,0,1
77520_0,,,,2,1,1,2
77521_0,,,,2,1,1,2
77522_0,,,,2,1,1,2
77524_0,,,,2,1,1,2
C1(C(C=O)(C=O)C(C)(C(O)O1)O)=O,,,5,1,1,0,1
77526_0,,,,2,1,1,2
C(C1(C=O)C(C)OC(C1(C)O)O)=O,,,5,1,1,0,1
77528_0,,,,2,1,1,2
C(C1(C=O)COC(C1(C)O)O)=O,,,5,1,1,0,1
77530_0,,,,2,1,1,2
C1(C(C=O)(C(C)(C(O)O1)O)O)=O,,,5,1,1,0,1
77532_0,,,,2,1,1,2
C(C1(C(C)OC(C1(C)O)O)O)=O,,,5,1,1,0,1
77534_0,,,,2,1,1,2
C1(C(C=O)(C=O)C(C(C)(O)O1)O)=O,,,5,1,1,0,1
77536_0,,,,2,1,1,2
C(C1(C=O)C(C)OC(C)(C1O)O)=O,,,5,1,1,0,1
77538_0,,,,2,1,1,2
C(C1(C=O)COC(C)(C1O)O)=O,,,5,1,1,0,1
77540_0,,,,2,1,1,2
C1(C(C=O)(C(C(C)(O)O1)O)O)=O,,,5,1,1,0,1
77542_0,,,,2,1,1,2
C(C)(C1(C(C(OC1C=O)O)O)O)=O,,,5,1,1,0,1
77544_0,,,,2,1,1,2
C(C)(C1(C(C)OC(C1O)O)O)=O,,,5,1,1,0,1
77546_0,,,,2,1,1,2
C(C(C1(C(C)(O)OCC1O)O)O)=O,,,5,1,1,0,1
77548_0,,,,2,1,1,2
C(C)(C1(C(CO)OC(C1O)O)O)=O,,,5,1,1,0,1
77549_0,,,,2,1,1,2
77550_0,,,,2,1,1,2
77552_0,,,,2,1,1,2
C(C1(C(O)OCC1(C)O)C(C)O)=O,,,5,1,1,0,1
77554_0,,,,2,1,1,2
C(C1(C(O)OC(C1O)O)C(C)O)=O,,,5,1,1,0,1
77556_0,,,,2,1,1,2
C(C1(C(O)OC(C)C1O)C(C)O)=O,,,5,1,1,0,1
77558_0,,,,2,1,1,2
C(C1(C=O)C(C)OC(C1O)O)=O,,,5,1,1,0,1
77559_0,,,,2,1,1,2
77560_0,,,,2,1,1,2
77562_0,,,,2,1,1,2
C(C1(C=O)COC(C1(CO)O)O)=O,,,5,1,1,0,1
77564_0,,,,2,1,1,2
C(C1(C=O)COC(CO)(C1O)O)=O,,,5,1,1,0,1
77565_0,,,,2,1,1,2
77567_0,,,,2,1,1,2
C1(C(C=O)(C=O)C(C(O)O1)O)=O,,,5,1,1,0,1
77569_0,,,,2,1,1,2
C(C1(C=O)C(C(OC1C=O)O)O)=O,,,5,1,1,0,1
77571_0,,,,2,1,1,2
C(C1(C=O)COC(C1O)O)=O,,,5,1,1,0,1
77572_0,,,,2,1,1,2
77574_0,,,,2,1,1,2
C(C1(C=O)C(CO)OC(C1O)O)=O,,,5,1,1,0,1
77576_0,,,,2,1,1,2
C(C1(CO)C(C(C=O)OC1O)O)=O,,,5,1,1,0,1
77578_0,,,,2,1,1,2
C(C1(C(O)OCC1(C)O)CO)=O,,,5,1,1,0,1
77580_0,,,,2,1,1,2
C(C1(CO)C(O)OC(C1(C)O)=O)=O,,,5,1,1,0,1
77582_0,,,,2,1,1,2
C(C1(C=O)COC(C1(C=C)O)O)=O,,,5,1,1,0,1
77584_0,,,,2,1,1,2
C(C1(C=O)COC(C=C)(C1O)O)=O,,,5,1,1,0,1
77586_0,,,,2,1,1,2
C(C1(C(O)OC(C1O)O)CO)=O,,,5,1,1,0,1
77588_0,,,,2,1,1,2
C(C1(C(O)OC(C)C1O)CO)=O,,,5,1,1,0,1
77589_0,,,,2,1,1,2
77591_0,,,,2,1,1,2
C(C1(C=O)C(C(CO)C(O1)O)O)=O,,,5,1,1,0,1
77592_0,,,,2,1,1,2
77593_0,,,,2,1,1,2
77595_0,,,,2,1,1,2
C(CCO)(C1(COC(C1O)O)O)=O,,,5,1,1,0,1
77596_0,,,,2,1,1,2
77597_0,,,,2,1,1,2
77599_0,,,,2,1,1,2
C1(C(C(C(O)O1)=O)(CO)C(C)O)=O,,,5,1,1,0,1
77600_0,,,,2,1,1,2
77601_0,,,,2,1,1,2
77602_0,,,,2,1,1,2
77603_0,,,,2,1,1,2
77604_0,,,,2,1,1,2
77605_0,,,,2,1,1,2
77606_0,,,,2,1,1,2
77607_0,,,,2,1,1,2
77609_0,,,,2,1,1,2
C1(C(C(C(O)O1)=O)(CO)CO)=O,,,5,1,1,0,1
77610_0,,,,2,1,1,2
77612_0,,,,2,1,1,2
C(C1(C(CO)(CO)C(CO1)O)O)=O,,,5,1,1,0,1
77613_0,,,,2,1,1,2
77614_0,,,,2,1,1,2
77615_0,,,,2,1,1,2
77617_0,,,,2,1,1,2
C1(C(C=O)(C(C(O)O1)O)C(C)O)=O,,,5,1,1,0,1
77618_0,,,,2,1,1,2
77619_0,,,,2,1,1,2
77620_0,,,,2,1,1,2
77621_0,,,,2,1,1,2
77622_0,,,,2,1,1,2
77623_0,,,,2,1,1,2
77625_0,,,,2,1,1,2
C1(C(C=O)(CO)C(C(O)O1)O)=O,,,5,1,1,0,1
77626_0,,,,2,1,1,2
77628_0,,,,2,1,1,2
C(C(C1(C(O)OCC1O)CO)O)=O,,,5,1,1,0,1
77629_0,,,,2,1,1,2
77630_0,,,,2,1,1,2
77631_0,,,,2,1,1,2
77632_0,,,,2,1,1,2
77633_0,,,,2,1,1,2
77634_0,,,,2,1,1,2
77636_0,,,,2,1,1,2
C(C1(C(CO)=O)COC(C1O)O)=O,,,5,1,1,0,1
77637_0,,,,2,1,1,2
77638_0,,,,2,1,1,2
77639_0,,,,2,1,1,2
77640_0,,,,2,1,1,2
77641_0,,,,2,1,1,2
77642_0,,,,2,1,1,2
77643_0,,,,2,1,1,2
77644_0,,,,2,1,1,2
77645_0,,,,2,1,1,2
77647_0,,,,2,1,1,2
C(CC(C1(COC(C1O)O)O)=O)=O,,,5,1,1,0,1
77648_0,,,,2,1,1,2
77649_0,,,,2,1,1,2
77651_0,,,,2,1,1,2
C(CC1(C(CO)(C(CO1)O)O)O)=O,,,5,1,1,0,1
77652_0,,,,2,1,1,2
77653_0,,,,2,1,1,2
77654_0,,,,2,1,1,2
77655_0,,,,2,1,1,2
77657_0,,,,2,1,1,2
C(C(C1(C(C)OC(C1O)O)O)=O)=O,,,5,1,1,0,1
77658_0,,,,2,1,1,2
77659_0,,,,2,1,1,2
77660_0,,,,2,1,1,2
77662_0,,,,2,1,1,2
C(C1(C(C(C)O)(C(CO1)O)O)O)=O,,,5,1,1,0,1
77663_0,,,,2,1,1,2
77664_0,,,,2,1,1,2
77666_0,,,,2,1,1,2
C(C1C(C(C(O1)O)(C(C)O)O)O)=O,,,5,1,1,0,1
77668_0,,,,2,1,1,2
C(C1(C(C)O)C(C(C(O1)O)O)O)=O,,,5,1,1,0,1
77670_0,,,,2,1,1,2
C1C(C)(C(C(O)O1)(C(C)O)O)O,,,5,1,1,0,1
77672_0,,,,2,1,1,2
C1(C(C)(C(C(O)O1)(C(C)O)O)O)=O,,,5,1,1,0,1
77674_0,,,,2,1,1,2
C(C1(C(C)OC(C1(C=C)O)O)O)=O,,,5,1,1,0,1
77676_0,,,,2,1,1,2
C(C1(C(C(C=C)(O)OC1C)O)O)=O,,,5,1,1,0,1
77678_0,,,,2,1,1,2
CC(C1(C(O)OC(C1O)O)O)O,,,5,1,1,0,1
77680_0,,,,2,1,1,2
CC(C1(C(O)OC(C)C1O)O)O,,,5,1,1,0,1
77682_0,,,,2,1,1,2
C(C1(C(O)OC(C1O)C(C)O)O)=O,,,5,1,1,0,1
77684_0,,,,2,1,1,2
CC(C1C(C(C(O)O1)(CO)O)O)O,,,5,1,1,0,1
77686_0,,,,2,1,1,2
C(C1(C(C(O)OC1CCO)=O)O)=O,,,5,1,1,0,1
77687_0,,,,2,1,1,2
77688_0,,,,2,1,1,2
77690_0,,,,2,1,1,2
C(C1C(CCO)OC(C1O)O)(O)=O,,,5,1,1,0,1
77692_0,,,,2,1,1,2
C1(C(C=O)(C(C(C=O)(O)O1)O)O)=O,,,5,1,1,0,1
77693_0,,,,2,1,1,2
77694_0,,,,2,1,1,2
77696_0,,,,2,1,1,2
C1(C(C(C=O)=O)(C(C(O)O1)O)O)=O,,,5,1,2,0,2
77697_0,,,,2,1,1,2
77699_0,,,,2,1,1,2
C(C(C1(C(O)OCC1(C)O)O)=O)=O,,,5,1,1,0,1
77701_0,,,,2,1,1,2
C(C1(C(COC1(C=O)O)(C)O)O)=O,,,5,1,1,0,1
77703_0,,,,2,1,1,2
C(C1(C(C(O)OC1(CO)C)=O)O)=O,,,5,1,1,0,1
77705_0,,,,2,1,1,2
C1(C(C=O)(C(C(O)O1)=O)O)=O,,,5,1,1,0,1
77707_0,,,,2,1,1,2
C(C(C1(C(O)OC(C1O)O)O)=O)=O,,,5,1,1,0,1
77709_0,,,,2,1,1,2
C(C1(C(C(OC1(C=O)O)O)O)O)=O,,,5,1,2,0,2
77711_0,,,,2,1,1,2
C(C1(C(C(O)OC1C(O)O)=O)O)=O,,,5,1,1,0,1
77713_0,,,,2,1,1,2
C(C(C1(C(O)OC(C)C1O)O)=O)=O,,,5,1,1,0,1
77715_0,,,,2,1,1,2
C(C1(C(C(C)OC1(C=O)O)O)O)=O,,,5,1,1,0,1
77717_0,,,,2,1,1,2
C(C1(C(C(O)OC1C(C)O)=O)O)=O,,,5,1,1,0,1
77719_0,,,,2,1,1,2
C1(C(C(C(C=O)=O)(C(O)O1)O)O)=O,,,5,1,2,0,2
77721_0,,,,2,1,1,2
C1(C(C(C=O)(C(C=O)(O)O1)O)O)=O,,,5,1,1,0,1
77723_0,,,,2,1,1,2
C(C1(C(C(O)OC1C(O)=O)=O)O)=O,,,5,1,1,0,1
77725_0,,,,2,1,1,2
C(C1(C)C(C=O)(C(C(O1)O)=O)O)=O,,,5,1,1,0,1
77727_0,,,,2,1,1,2
C(C1(C(C(O)OC1C(C)=O)=O)O)=O,,,5,1,1,0,1
77729_0,,,,2,1,1,2
C(CC1C(C=O)(C(C(O)O1)=O)O)=O,,,5,1,1,0,1
77731_0,,,,2,1,1,2
C(C1(C(C=O)=O)C(CC(O1)O)O)=O,,,5,1,2,0,2
77733_0,,,,2,1,1,2
C(C1(C(CO)(O)OCC1(C)O)O)=O,,,5,1,1,0,1
77735_0,,,,2,1,1,2
C(CO)(C1(C(O)OCC1(C)O)O)=O,,,5,1,1,0,1
77736_0,,,,2,1,1,2
77737_0,,,,2,1,1,2
77739_0,,,,2,1,1,2
C(C1(C(CO)(O)OC(C1O)O)O)=O,,,5,1,1,0,1
77741_0,,,,2,1,1,2
C(CO)(C1(C(O)OC(C1O)O)O)=O,,,5,1,1,0,1
77742_0,,,,2,1,1,2
77744_0,,,,2,1,1,2
C(C1(C(CO)(O)OC(C)C1O)O)=O,,,5,1,1,0,1
77746_0,,,,2,1,1,2
C(CO)(C1(C(O)OC(C)C1O)O)=O,,,5,1,1,0,1
77747_0,,,,2,1,1,2
77749_0,,,,2,1,1,2
C(C1(C(O)OCC1(C(C)=O)O)O)=O,,,5,1,1,0,1
77751_0,,,,2,1,1,2
C(C1(C(C)OC(C1(C=O)O)O)O)=O,,,5,1,1,0,1
77753_0,,,,2,1,1,2
C(C1(C(OC(C=O)C1O)O)O)=O,,,5,1,1,0,1
77755_0,,,,2,1,1,2
C(C1(C=O)C(C(C(O1)O)O)O)=O,,,5,1,1,0,1
77757_0,,,,2,1,1,2
C(C1(C(O)OCC1(C)O)O)=O,,,5,1,1,0,1
77759_0,,,,2,1,1,2
C(C1(C(O)OCC1(CCO)O)O)=O,,,5,1,1,0,1
77761_0,,,,2,1,1,2
C(C1(C(O)OC(C1O)CCO)O)=O,,,5,1,1,0,1
77763_0,,,,2,1,1,2
C(C1(C(O)OC(CO)C1(C)O)O)=O,,,5,1,1,0,1
77765_0,,,,2,1,1,2
C1(C(C)(C(C=O)(C(O)O1)O)O)=O,,,5,1,1,0,1
77767_0,,,,2,1,1,2
C1(C(CO)(C(C=O)(C(O)O1)O)O)=O,,,5,1,1,0,1
77769_0,,,,2,1,1,2
C(C1(COC(C1(C=O)O)O)O)(O)=O,,,5,1,1,0,1
77771_0,,,,2,1,1,2
C(C1(C=O)C(C=O)(CC(O1)O)O)=O,,,5,1,1,0,1
77772_0,,,,2,1,1,2
77774_0,,,,2,1,1,2
C(C1(C=O)C(CC(C=O)(O1)O)O)=O,,,5,1,1,0,1
77776_0,,,,2,1,1,2
C(C(C=O)(C1CC(C(O)O1)=O)O)=O,,,5,1,1,0,1
77778_0,,,,2,1,1,2
C(C1(C(O)OC2COCC21O)O)=O,,,5,1,1,0,1
77780_0,,,,2,1,1,2
C(C1(C(O)OC2C1(CCO2)O)O)=O,,,5,1,1,0,1
77782_0,,,,2,1,1,2
C(C1(C=O)C(C(C(C)(O1)O)=O)O)=O,,,5,1,1,0,1
77784_0,,,,2,1,1,2
C(C1(C=O)C(C(C(O1)O)=O)(C)O)=O,,,5,1,1,0,1
77786_0,,,,2,1,1,2
C(C1(C(O)OC(C1O)O)O)=O,,,5,1,1,0,1
77788_0,,,,2,1,1,2
C(C1(C(O)OC(C)C1O)O)=O,,,5,1,1,0,1
77790_0,,,,2,1,1,2
C(C1(C(O)OC(CO)C1O)O)=O,,,5,1,1,0,1
77792_0,,,,2,1,1,2
C(C1(C(O)OCC1(CO)O)O)=O,,,5,1,1,0,1
77794_0,,,,2,1,1,2
C(C1(C(O)OC(C1O)=O)O)=O,,,5,1,1,0,1
77796_0,,,,2,1,1,2
C(C1(C=O)C(CC(O1)O)O)=O,,,5,1,1,0,1
77797_0,,,,2,1,1,2
77799_0,,,,2,1,1,2
C(C1(C(O)OC(C1O)CC=O)O)=O,,,5,1,1,0,1
77801_0,,,,2,1,1,2
C(C(C=O)(C1C(CC(O)O1)O)O)=O,,,5,1,1,0,1
77803_0,,,,2,1,1,2
C(C(C=O)(C1CC(C(O)O1)O)O)=O,,,5,1,1,0,1
77805_0,,,,2,1,1,2
C(C1(C=O)C(CC(CO)(O1)O)O)=O,,,5,1,1,0,1
77806_0,,,,2,1,1,2
77808_0,,,,2,1,1,2
C(C1(C(O)OCC1(CC=O)O)O)=O,,,5,1,1,0,1
77810_0,,,,2,1,1,2
C(C1(C=O)C(CO)(CC(O1)O)O)=O,,,5,1,1,0,1
77812_0,,,,2,1,1,2
C(C1(C(OC(C(C)=O)C1O)O)O)=O,,,5,1,1,0,1
77814_0,,,,2,1,1,2
C(C1(C=O)C(C(C(C)(O1)O)O)O)=O,,,5,1,1,0,1
77816_0,,,,2,1,1,2
C(C1(C(OC(C=O)C1(C)O)O)O)=O,,,5,1,1,0,1
77818_0,,,,2,1,1,2
C(C1(C=O)C(C)(C(C(O1)O)O)O)=O,,,5,1,1,0,1
77820_0,,,,2,1,1,2
C(C1(C(O)OCC1(C=O)O)O)=O,,,5,1,1,0,1
77822_0,,,,2,1,1,2
C1(COCC21C(C(C(O2)O)O)O)=O,,,5,1,1,0,1
77824_0,,,,2,1,1,2
C(C1C(C2(COCC2(O1)O)O)O)=O,,,5,1,1,0,1
77826_0,,,,2,1,1,2
C1C(C)(C(CO)(C(C)(O)O1)O)O,,,5,1,1,0,1
77827_0,,,,2,1,1,2
77829_0,,,,2,1,1,2
C(C1C(C(O)OC1(C)CO)O)(O)=O,,,5,1,1,0,1
77831_0,,,,2,1,1,2
C(C1(C(C)(O)OCC1(C)O)O)(O)=O,,,5,1,1,0,1
77833_0,,,,2,1,1,2
C1C2(C(CO1)(O)OCC2(C)O)O,,,5,1,1,0,1
77835_0,,,,2,1,1,2
C1C2(C(C(O)O1)(O)OCC2(C)O)O,,,5,1,1,0,1
77837_0,,,,2,1,1,2
C1(C(C)(C(CO)(C(C)(O)O1)O)O)=O,,,5,1,1,0,1
77839_0,,,,2,1,1,2
C(C)(C1(COC(C1(C=C)O)O)O)=O,,,5,1,1,0,1
77841_0,,,,2,1,1,2
C(C)(C1(COC(C=C)(C1O)O)O)=O,,,5,1,1,0,1
77843_0,,,,2,1,1,2
CC1(C(CO)(C(C(O)O1)O)O)O,,,5,1,1,0,1
77845_0,,,,2,1,1,2
CC1(C(CO)(C(C(C)O1)O)O)O,,,5,1,1,0,1
77847_0,,,,2,1,1,2
C1(C(C)(C2(COCC2(O)O1)O)O)=O,,,5,1,1,0,1
77848_0,,,,2,1,1,2
77849_0,,,,2,1,1,2
77851_0,,,,2,1,1,2
C(C1C(C(O)O)OC(C1O)O)(O)=O,,,5,1,1,0,1
77852_0,,,,2,1,1,2
77854_0,,,,2,1,1,2
C(C1C(C(C)O)OC(C1O)O)(O)=O,,,5,1,1,0,1
77856_0,,,,2,1,1,2
C(C1(C(C)(O)OC(C1O)O)O)(O)=O,,,5,1,1,0,1
77858_0,,,,2,1,1,2
C(C1(C(C)(O)OC(C)C1O)O)(O)=O,,,5,1,1,0,1
77859_0,,,,2,1,1,2
77860_0,,,,2,1,1,2
77862_0,,,,2,1,1,2
C(C1(C(C)OC(C1(C)O)O)O)(O)=O,,,5,1,1,0,1
77863_0,,,,2,1,1,2
77864_0,,,,2,1,1,2
77866_0,,,,2,1,1,2
C(C1(C(C)OC(C)(C1O)O)O)(O)=O,,,5,1,1,0,1
77868_0,,,,2,1,1,2
C1(C(C(C(C)O)(C(C)(O)O1)O)O)=O,,,5,1,1,0,1
77869_0,,,,2,1,1,2
77870_0,,,,2,1,1,2
77872_0,,,,2,1,1,2
C1(C(C)(C(C(O)=O)(C(O)O1)O)O)=O,,,5,1,1,0,1
77874_0,,,,2,1,1,2
C(C1(CO)C(CC(C=O)(O1)O)O)=O,,,5,1,1,0,1
77876_0,,,,2,1,1,2
C(C(CO)(C1CC(C(O)O1)=O)O)=O,,,5,1,1,0,1
77877_0,,,,2,1,1,2
77878_0,,,,2,1,1,2
77880_0,,,,2,1,1,2
C1(C(C=O)(C(C(O)O1)=O)CO)=O,,,5,1,1,0,1
77881_0,,,,2,1,1,2
77883_0,,,,2,1,1,2
C(C1(C(C(OC1C=O)O)=O)CO)=O,,,5,1,1,0,1
77885_0,,,,2,1,1,2
C(C1(C(C=O)=O)COC(C1O)O)=O,,,5,1,1,0,1
77886_0,,,,2,1,1,2
77888_0,,,,2,1,1,2
C(C1(C(C(O)OC1C)=O)CO)=O,,,5,1,1,0,1
77889_0,,,,2,1,1,2
77890_0,,,,2,1,1,2
77891_0,,,,2,1,1,2
77892_0,,,,2,1,1,2
77893_0,,,,2,1,1,2
77894_0,,,,2,1,1,2
77896_0,,,,2,1,1,2
C1C2(C(CO1)(O)OC(C2O)O)O,,,5,1,1,0,1
77898_0,,,,2,1,1,2
C1C2(C(CO1)(C(C(C)O2)O)O)O,,,5,1,1,0,1
77900_0,,,,2,1,1,2
C1C2(C(CO1)(C(C(CO)O2)O)O)O,,,5,1,1,0,1
77902_0,,,,2,1,1,2
C1C2(C(CO1)(O)OCC2(CO)O)O,,,5,1,1,0,1
77904_0,,,,2,1,1,2
C1(C(C2(COCC2(O)O1)O)O)=O,,,5,1,1,0,1
77906_0,,,,2,1,1,2
C1(COCC21C(CC(O2)O)O)=O,,,5,1,1,0,1
77908_0,,,,2,1,1,2
C(C1(COC2(COCC21O)O)O)=O,,,5,1,1,0,1
77910_0,,,,2,1,1,2
C1C2(C(CO1)(O)OCC2O)O,,,5,1,1,0,1
77912_0,,,,2,1,1,2
C1C2(C(CO1)OC(C2(CO)O)O)O,,,5,1,1,0,1
77914_0,,,,2,1,1,2
C12C(CCO1)(C(C(O)O2)(CO)O)O,,,5,1,1,0,1
77916_0,,,,2,1,1,2
C1(C2C(CO1)OC(C2(C=C)O)O)=O,,,5,1,1,0,1
77918_0,,,,2,1,1,2
C1(C2C(C(C=C)(O)OC2CO1)O)=O,,,5,1,1,0,1
77919_0,,,,2,1,1,2
77921_0,,,,2,1,1,2
C1(C2C(CO1)OC(C2(C)O)O)=O,,,5,1,1,0,1
77923_0,,,,2,1,1,2
C1(C2C(CO1)OC(C)(C2O)O)=O,,,5,1,1,0,1
77925_0,,,,2,1,1,2
C1(C2C(CO1)OC(C2(CO)O)O)=O,,,5,1,1,0,1
77927_0,,,,2,1,1,2
C1(C2C(CO1)OC(CO)(C2O)O)=O,,,5,1,1,0,1
77929_0,,,,2,1,1,2
C(C1(CO)C(C(C(O1)O)=O)(C)O)=O,,,5,1,1,0,1
77931_0,,,,2,1,1,2
C(C1(COC(C=O)(C1(C)O)O)O)=O,,,5,1,1,0,1
77932_0,,,,2,1,1,2
77934_0,,,,2,1,1,2
C1(C(CO)(C(C=C)(C(O)O1)O)O)=O,,,5,1,1,0,1
77936_0,,,,2,1,1,2
C(C1(COC(C1(C=C)O)O)O)(O)=O,,,5,1,1,0,1
77937_0,,,,2,1,1,2
77939_0,,,,2,1,1,2
C1(C(CO)(C(C(C=C)(O)O1)O)O)=O,,,5,1,1,0,1
77941_0,,,,2,1,1,2
C(C1(COC(C=C)(C1O)O)O)(O)=O,,,5,1,1,0,1
77943_0,,,,2,1,1,2
C1(C2(C(C(O)O1)OC(C2O)O)O)=O,,,5,1,2,0,2
77945_0,,,,2,1,1,2
C1C2(C(C(O)O1)(O)OC(C2O)O)O,,,5,1,1,0,1
77947_0,,,,2,1,1,2
C1C2(C(C(O)O1)(O)OC(C)C2O)O,,,5,1,1,0,1
77949_0,,,,2,1,1,2
C1(C(C2(COC(C2(O)O1)O)O)O)=O,,,5,1,2,0,2
77951_0,,,,2,1,1,2
C1(C(O)OCC21C(CC(O2)O)O)=O,,,5,1,2,0,2
77953_0,,,,2,1,1,2
C1C2(C(COC2(C(O)O1)O)O)O,,,5,1,2,0,2
77954_0,,,,2,1,1,2
77955_0,,,,2,1,1,2
77956_0,,,,2,1,1,2
77958_0,,,,2,1,1,2
C(C1(C(O)OC(CO)C1O)O)(O)=O,,,5,1,1,0,1
77960_0,,,,2,1,1,2
C1(C(C=O)(C(C(O)O1)O)O)=O,,,5,1,1,0,1
77962_0,,,,2,1,1,2
C1(C(C=O)(C(CO)(C(O)O1)O)O)=O,,,5,1,1,0,1
77964_0,,,,2,1,1,2
C(C1(C(O)OCC1(C=O)O)O)(O)=O,,,5,1,1,0,1
77966_0,,,,2,1,1,2
C(C1(C(O)OC(C1O)=O)O)(O)=O,,,5,1,1,0,1
77967_0,,,,2,1,1,2
77969_0,,,,2,1,1,2
C1(C2(C(CO1)OC(C2O)O)O)=O,,,5,1,2,0,2
77971_0,,,,2,1,1,2
C1(C2(C(CO1)OC(C2(C)O)O)O)=O,,,5,1,1,0,1
77973_0,,,,2,1,1,2
C1(C2(C(CO1)OC(C)(C2O)O)O)=O,,,5,1,1,0,1
77975_0,,,,2,1,1,2
C1(C2(C(CO1)O)C(CC(O2)O)O)=O,,,5,1,1,0,1
77976_0,,,,2,1,1,2
77977_0,,,,2,1,1,2
77979_0,,,,2,1,1,2
C1(C(CO)(C(C(O)O1)O)O)O,,,5,1,1,0,1
77980_0,,,,2,1,1,2
77982_0,,,,2,1,1,2
C1(C(C(C(O)O1)O)(C(CO)O)O)O,,,5,1,1,0,1
77984_0,,,,2,1,1,2
C(C1(C(C(O)O)OC(C1O)O)O)=O,,,5,1,1,0,1
77986_0,,,,2,1,1,2
C(C(C1(C(O)OC(C1O)O)O)O)=O,,,5,1,1,0,1
77988_0,,,,2,1,1,2
C(C1(C(C(O)OC1(CO)O)O)O)O,,,5,1,1,0,1
77990_0,,,,2,1,1,2
C(C)(C1(C(O)OC(C1O)O)O)=O,,,5,1,1,0,1
77992_0,,,,2,1,1,2
C(C1(C(C)(O)OC(C1O)O)O)=O,,,5,1,1,0,1
77993_0,,,,2,1,1,2
77995_0,,,,2,1,1,2
C1(C(O)OC(C(O)O)C1(CO)O)=O,,,5,1,1,0,1
77997_0,,,,2,1,1,2
C(C1(C(CO)(C(C(O1)O)O)O)O)=O,,,5,1,2,0,2
77999_0,,,,2,1,1,2
CC1C(C(C(O)O1)(CO)O)O,,,5,1,1,0,1
78000_0,,,,2,1,1,2
78002_0,,,,2,1,1,2
CC1C(C(C(O)O1)(C(CO)O)O)O,,,5,1,1,0,1
78004_0,,,,2,1,1,2
CC1C(C(CO)(C(CO)(O)O1)O)O,,,5,1,1,0,1
78006_0,,,,2,1,1,2
C(C)(C1(C(O)OC(C)C1O)O)=O,,,5,1,1,0,1
78008_0,,,,2,1,1,2
C(C1(C(C)(O)OC(C)C1O)O)=O,,,5,1,1,0,1
78009_0,,,,2,1,1,2
78011_0,,,,2,1,1,2
C1(C(O)OC(C(C)O)C1(CO)O)=O,,,5,1,1,0,1
78013_0,,,,2,1,1,2
C(C1(C(CO)(C(C(C)O1)O)O)O)=O,,,5,1,1,0,1
78015_0,,,,2,1,1,2
C(C1(C2C(CC1(C(O)O2)O)O)O)O,,,5,1,2,0,2
78015_1,,,,2,1,1,2
78017_0,,,,2,1,1,2
C1C2(C(C(CC2(C(O)O1)O)O)O)O,,,5,1,1,0,1
78019_0,,,,2,1,1,2
C(C1(C(C2CC1(C(O)O2)O)O)O)O,,,5,1,2,0,2
78019_1,,,,2,1,1,2
78020_0,,,,2,1,1,2
78020_1,,,,2,1,1,2
78022_0,,,,2,1,1,2
C1(C2C(C(C(C)(O2)O)(C1)O)O)=O,,,5,1,2,0,2
78022_1,,,,2,1,1,2
78023_0,,,,2,1,1,2
78023_1,,,,2,1,1,2
78025_0,,,,2,1,1,2
C1(C2(CC(CC2O)O1)O)O,,,5,1,2,0,2
78025_1,,,,2,1,1,2
78027_0,,,,2,1,1,2
C1(C2(CC(C(C2O)O1)O)O)O,,,5,1,2,0,2
78027_1,,,,2,1,1,2
78029_0,,,,2,1,1,2
C1(C2(CC(C(C2O)O)O1)O)O,,,5,1,2,0,2
78029_1,,,,2,1,1,2
78031_0,,,,2,1,1,2
C1(C2C(C(C(CO)(O2)O)(C1)O)O)=O,,,5,1,2,0,2
78031_1,,,,2,1,1,2
78033_0,,,,2,1,1,2
C1(C2(CC(C(CO)(C2O)O1)O)O)O,,,5,1,2,0,2
78033_1,,,,2,1,1,2
78035_0,,,,2,1,1,2
C(C1(C2CC(C(O)O2)(C1O)O)O)O,,,5,1,2,0,2
78035_1,,,,2,1,1,2
78036_0,,,,2,1,1,2
78037_0,,,,2,1,1,2
78038_0,,,,2,1,1,2
78039_0,,,,2,1,1,2
78041_0,,,,2,1,1,2
C(C1(CC(C=O)(O)OC1C)O)(O)=O,,,5,1,1,0,1
78042_0,,,,2,1,1,2
78043_0,,,,2,1,1,2
78045_0,,,,2,1,1,2
C(C1C(O)OC(C)C1(C(O)=O)O)=O,,,5,1,1,0,1
78046_0,,,,2,1,1,2
78048_0,,,,2,1,1,2
C(C1(CC(O)OC1CCO)O)(O)=O,,,5,1,1,0,1
78049_0,,,,2,1,1,2
78051_0,,,,2,1,1,2
C(C1(CC(O)OC1(CO)C)O)(O)=O,,,5,1,1,0,1
78052_0,,,,2,1,1,2
78053_0,,,,2,1,1,2
78055_0,,,,2,1,1,2
C(C1(C(C(O)O)OC(C1)O)O)(O)=O,,,5,1,1,0,1
78056_0,,,,2,1,1,2
78058_0,,,,2,1,1,2
C(C1(CC(O)OC1C(C)O)O)(O)=O,,,5,1,1,0,1
78060_0,,,,2,1,1,2
C(C(C1CC(C(O)O1)(C)O)(O)O)=O,,,5,1,1,0,1
78062_0,,,,2,1,1,2
C(C(C)(C1CC(C(O)O1)(C)O)O)=O,,,5,1,1,0,1
78064_0,,,,2,1,1,2
[C](C(O)=O)(C1CC(C)(C(O1)O)O)O,,,5,1,1,0,1
78066_0,,,,2,1,1,2
C(C(C1CC(C(O)O1)(C)O)O)(O)=O,,,5,1,1,0,1
78068_0,,,,2,1,1,2
C(C(C1C(C)(CC(O)O1)O)(O)O)=O,,,5,1,1,0,1
78070_0,,,,2,1,1,2
C(CC1(C)C(C(C(O)O1)(O)O)O)=O,,,5,1,1,0,1
78072_0,,,,2,1,1,2
C(C(C)(C1C(C)(CC(O)O1)O)O)=O,,,5,1,1,0,1
78074_0,,,,2,1,1,2
C(CC1(C)C(C(C)(C(O)O1)O)O)=O,,,5,1,1,0,1
78076_0,,,,2,1,1,2
[C](C(O)=O)(C1C(C)(CC(O1)O)O)O,,,5,1,1,0,1
78077_0,,,,2,1,1,2
78079_0,,,,2,1,1,2
C(C1(CC(C(O1)=O)(C(C)=O)O)O)=O,,,5,1,1,0,1
78080_0,,,,2,1,1,2
78082_0,,,,2,1,1,2
C(C1(CC(C(C)=O)(C(C)O1)O)O)=O,,,5,1,1,0,1
78084_0,,,,2,1,1,2
C(C1C(O)OC(C1(C(C)=O)O)=O)=O,,,5,1,1,0,1
78086_0,,,,2,1,1,2
C(C1C(O)OC(C)C1(C(C)=O)O)=O,,,5,1,1,0,1
78088_0,,,,2,1,1,2
C(C)(C1(CC(O)OC1CCO)O)=O,,,5,1,1,0,1
78090_0,,,,2,1,1,2
C(CC1(C(C)(O)OCC1(C)O)O)=O,,,5,1,1,0,1
78092_0,,,,2,1,1,2
C(C)(C1(CC(O)OC1(CO)C)O)=O,,,5,1,1,0,1
78094_0,,,,2,1,1,2
C1(C(C(C)=O)(CC(O)O1)O)=O,,,5,1,1,0,1
78096_0,,,,2,1,1,2
C(CC1(C(C(O)OC1(C)O)O)O)=O,,,5,1,1,0,1
78098_0,,,,2,1,1,2
C(C)(C1(C(C(O)O)OC(C1)O)O)=O,,,5,1,1,0,1
78100_0,,,,2,1,1,2
C(CC1(C(C(C)OC1(C)O)O)O)=O,,,5,1,1,0,1
78102_0,,,,2,1,1,2
C(C)(C1(CC(O)OC1C(C)O)O)=O,,,5,1,1,0,1
78104_0,,,,2,1,1,2
C(C)(C1(CC(OC1C=O)O)O)=O,,,5,1,1,0,1
78106_0,,,,2,1,1,2
C(CC1(C(C)(O)OC(C1O)=O)O)=O,,,5,1,1,0,1
78108_0,,,,2,1,1,2
C(C)(C1(CC(OC1C(O)=O)O)O)=O,,,5,1,1,0,1
78110_0,,,,2,1,1,2
C(C1(C)C(C(C)=O)(CC(O1)O)O)=O,,,5,1,1,0,1
78112_0,,,,2,1,1,2
C(C)(C1(CC(OC1C(C)=O)O)O)=O,,,5,1,1,0,1
78114_0,,,,2,1,1,2
C(C)(C1(C(CC(O1)O)O)CC=O)=O,,,5,1,1,0,1
78116_0,,,,2,1,1,2
C(CC1C(C(C)=O)(CC(O)O1)O)=O,,,5,1,1,0,1
78118_0,,,,2,1,1,2
C(C)(C1(C(C)OC(C1)O)O)=O,,,5,1,1,0,1
78120_0,,,,2,1,1,2
C(CC1(C(C)(O)OCC1O)O)=O,,,5,1,1,0,1
78122_0,,,,2,1,1,2
C(C)(C1(C(CO)OC(C1)O)O)=O,,,5,1,1,0,1
78124_0,,,,2,1,1,2
C(C(C1CC(C(C)(O)O1)O)(O)O)=O,,,5,1,1,0,1
78126_0,,,,2,1,1,2
C(C(C)(C1CC(C(C)(O)O1)O)O)=O,,,5,1,1,0,1
78128_0,,,,2,1,1,2
[C](C(O)=O)(C1CC(C(C)(O1)O)O)O,,,5,1,1,0,1
78130_0,,,,2,1,1,2
C(C(C1CC(C(C)(O)O1)O)O)(O)=O,,,5,1,1,0,1
78132_0,,,,2,1,1,2
C(C(C1(C)C(CC(O)O1)O)(O)O)=O,,,5,1,1,0,1
78134_0,,,,2,1,1,2
C(CC1C(C)(C(C(O)O1)(O)O)O)=O,,,5,1,1,0,1
78136_0,,,,2,1,1,2
C(C(C)(C1(C)C(CC(O)O1)O)O)=O,,,5,1,1,0,1
78138_0,,,,2,1,1,2
C(CC1C(C)(C(C)(C(O)O1)O)O)=O,,,5,1,1,0,1
78140_0,,,,2,1,1,2
[C](C(O)=O)(C1(C)C(CC(O1)O)O)O,,,5,1,1,0,1
78141_0,,,,2,1,1,2
78142_0,,,,2,1,1,2
78144_0,,,,2,1,1,2
[C]1(C(OC(C1(CC(C)O)O)O)=O)O,,,5,1,1,0,1
78145_0,,,,2,1,1,2
78147_0,,,,2,1,1,2
C1(C(C(C(O)O1)(CC(C)O)O)O)=O,,,5,1,1,0,1
78148_0,,,,2,1,1,2
78150_0,,,,2,1,1,2
[C]1(C(OC(CC(C)O)(C1O)O)=O)O,,,5,1,1,0,1
78152_0,,,,2,1,1,2
C(C1(CC(C(CO)=O)(CO1)O)O)=O,,,5,1,1,0,1
78153_0,,,,2,1,1,2
78155_0,,,,2,1,1,2
C1(C(C=O)(CC(C=O)(O)O1)O)=O,,,5,1,1,0,1
78156_0,,,,2,1,1,2
78158_0,,,,2,1,1,2
C(C1(C(C(C(O1)O)C(C)O)O)O)=O,,,5,1,1,0,1
78160_0,,,,2,1,1,2
C(C1(C)C(C(C(O1)O)C(C)O)O)=O,,,5,1,1,0,1
78162_0,,,,2,1,1,2
[C]1(C(O)=O)C(C(C(O)O1)C(C)O)O,,,5,1,1,0,1
78164_0,,,,2,1,1,2
C(C1C(O)OCC1(C(CO)=O)O)=O,,,5,1,1,0,1
78166_0,,,,2,1,1,2
C1(C(C=O)(C(C=O)C(O)O1)O)=O,,,5,1,1,0,1
78168_0,,,,2,1,1,2
C(C1(C(C(C(O1)O)CO)O)O)=O,,,5,1,1,0,1
78170_0,,,,2,1,1,2
C(C1(C)C(C(CO)C(O1)O)O)=O,,,5,1,1,0,1
78172_0,,,,2,1,1,2
[C]1(C(O)=O)C(C(C(O)O1)CO)O,,,5,1,1,0,1
78174_0,,,,2,1,1,2
C1(C(C(CCO)=O)(CC(O)O1)O)=O,,,5,1,1,0,1
78176_0,,,,2,1,1,2
C(CCO)(C1(C(C)OC(C1)O)O)=O,,,5,1,1,0,1
78178_0,,,,2,1,1,2
C(CCO)(C1(COC(C1)O)O)=O,,,5,1,1,0,1
78180_0,,,,2,1,1,2
C(C1(C(O)OC(C1)CC=O)O)(O)=O,,,5,1,1,0,1
78182_0,,,,2,1,1,2
C1(C(C=O)(C(C(O)O1)C(C)O)O)=O,,,5,1,1,0,1
78184_0,,,,2,1,1,2
C(C1C(C)OC(C1(C(O)=O)O)O)=O,,,5,1,1,0,1
78186_0,,,,2,1,1,2
C1(C(C=O)(C(CO)C(O)O1)O)=O,,,5,1,1,0,1
78188_0,,,,2,1,1,2
C(C1COC(C1(C(O)=O)O)O)=O,,,5,1,1,0,1
78190_0,,,,2,1,1,2
C1(C(O)OC(CC(C)O)C1(C)O)=O,,,5,1,1,0,1
78192_0,,,,2,1,1,2
CC(CC(C1(C(O)OCC1)O)O)O,,,5,1,1,0,1
78194_0,,,,2,1,1,2
C(C1(CC(O)OC1CC(C)O)O)=O,,,5,1,1,0,1
78196_0,,,,2,1,1,2
CC(C1C(C(C(O)O1)(O)O)O)O,,,5,1,1,0,1
78198_0,,,,2,1,1,2
CC(C1C(C(C)(C(O)O1)O)O)O,,,5,1,1,0,1
78200_0,,,,2,1,1,2
C1(C(C(CO)=O)(CC(O)O1)O)=O,,,5,1,1,0,1
78202_0,,,,2,1,1,2
C(CO)(C1(CC(OC1C=O)O)O)=O,,,5,1,1,0,1
78204_0,,,,2,1,1,2
C(CO)(C1(C(C)OC(C1)O)O)=O,,,5,1,1,0,1
78205_0,,,,2,1,1,2
78207_0,,,,2,1,1,2
C(CO)(C1(C(CO)OC(C1)O)O)=O,,,5,1,1,0,1
78209_0,,,,2,1,1,2
C1(C(O)OC(CCO)C1(C)O)=O,,,5,1,1,0,1
78211_0,,,,2,1,1,2
C1CC(C(O)O1)(C(CCO)O)O,,,5,1,1,0,1
78213_0,,,,2,1,1,2
C1(CC(C(O)O1)(C(CCO)O)O)=O,,,5,1,1,0,1
78215_0,,,,2,1,1,2
C(C1(C(C(C(C=O)(O1)O)O)O)O)=O,,,5,1,1,0,1
78217_0,,,,2,1,1,2
C(C(C1C(C(C(O)O1)=O)O)(O)O)=O,,,5,1,1,0,1
78219_0,,,,2,1,1,2
C(C(C1C(C(C(O1)O)(O)O)O)=O)=O,,,5,1,1,0,1
78221_0,,,,2,1,1,2
C(C1(C)C(C(C(C=O)(O1)O)O)O)=O,,,5,1,1,0,1
78223_0,,,,2,1,1,2
C(C(C)(C1C(C(C(O)O1)=O)O)O)=O,,,5,1,1,0,1
78225_0,,,,2,1,1,2
C(C(C1C(C(C)(C(O1)O)O)O)=O)=O,,,5,1,1,0,1
78227_0,,,,2,1,1,2
C(C1(C(C([C](C(O)=O)O1)O)O)O)=O,,,5,1,1,0,1
78229_0,,,,2,1,1,2
C1(C(O)OC([C](C(O)=O)O)C1O)=O,,,5,1,1,0,1
78231_0,,,,2,1,1,2
C(C1C(C(C(C=O)(O1)O)O)O)(O)=O,,,5,1,1,0,1
78233_0,,,,2,1,1,2
C(C(C1C(C(C(O)O1)=O)O)O)(O)=O,,,5,1,1,0,1
78235_0,,,,2,1,1,2
C1(C(C(C=O)(O)O)OC(C1O)O)=O,,,5,1,1,0,1
78237_0,,,,2,1,1,2
C(C(C1(C([C](C(O1)=O)O)O)O)O)=O,,,5,1,1,0,1
78239_0,,,,2,1,1,2
C1(C(C(OC1[C](C(O)=O)O)O)O)=O,,,5,1,1,0,1
78240_0,,,,2,1,1,2
78242_0,,,,2,1,1,2
C(C1(C(C(OC1C=O)O)(O)O)O)=O,,,5,1,1,0,1
78244_0,,,,2,1,1,2
C(C1([C](C(O)=O)OC(C1O)O)O)=O,,,5,1,1,0,1
78246_0,,,,2,1,1,2
C(C(C1([C](C(OC1O)=O)O)O)O)=O,,,5,1,1,0,1
78247_0,,,,2,1,1,2
78249_0,,,,2,1,1,2
C(C(C1(COC(C1(O)O)O)O)O)=O,,,5,1,1,0,1
78250_0,,,,2,1,1,2
78252_0,,,,2,1,1,2
C(C1C(CO)(C(C(O1)O)(O)O)O)=O,,,5,1,1,0,1
78254_0,,,,2,1,1,2
[C]1(C(O)=O)C(CO)(C(C(O)O1)O)O,,,5,1,1,0,1
78255_0,,,,2,1,1,2
78257_0,,,,2,1,1,2
C(C1(C(C(C(CO)(O1)O)O)O)O)=O,,,5,1,1,0,1
78259_0,,,,2,1,1,2
C(CO)(C1C(C(C(O1)O)(O)O)O)=O,,,5,1,1,0,1
78261_0,,,,2,1,1,2
[C]1(C(O)=O)C(C(C(CO)(O)O1)O)O,,,5,1,1,0,1
78263_0,,,,2,1,1,2
C(C)(C1(COC(C1(O)O)O)O)=O,,,5,1,1,0,1
78265_0,,,,2,1,1,2
[C]1(C(OC(C)(C1(CO)O)O)=O)O,,,5,1,1,0,1
78267_0,,,,2,1,1,2
[C]1(C(OC(CO)(C1(C)O)O)=O)O,,,5,1,1,0,1
78269_0,,,,2,1,1,2
C(C1C(C(C)(C(C=O)(O1)O)O)O)=O,,,5,1,1,0,1
78271_0,,,,2,1,1,2
C(C(C1(C)C(C(C(O1)O)O)O)=O)=O,,,5,1,1,0,1
78273_0,,,,2,1,1,2
C(C(C1C(C(C(O)O1)=O)(C)O)O)=O,,,5,1,1,0,1
78275_0,,,,2,1,1,2
C(C1(C(C)(C(CO1)(C)O)O)O)=O,,,5,1,1,0,1
78277_0,,,,2,1,1,2
C1(C(O)OC(CO)(C)C1(C)O)=O,,,5,1,1,0,1
78279_0,,,,2,1,1,2
C1(C(C)(C(C)(C(C=O)(O)O1)O)O)=O,,,5,1,1,0,1
78281_0,,,,2,1,1,2
C(C1(C)C(C(C(O1)O)=O)(C)O)(O)=O,,,5,1,1,0,1
78283_0,,,,2,1,1,2
C(CC1C(C(C(O)O1)=O)(C)O)(O)=O,,,5,1,1,0,1
78285_0,,,,2,1,1,2
C(C1(C=C)C(C(C(O1)O)=O)(C)O)=O,,,5,1,1,0,1
78287_0,,,,2,1,1,2
C1(C(OC(C(C=C)=O)C1(C)O)O)=O,,,5,1,1,0,1
78289_0,,,,2,1,1,2
C1(C(OC(C=CC=O)C1(C)O)O)=O,,,5,1,1,0,1
78291_0,,,,2,1,1,2
C(C1(C(C)(C(C(O1)O)O)O)O)=O,,,5,1,2,0,2
78293_0,,,,2,1,1,2
C1(C(O)OC(C(O)O)C1(C)O)=O,,,5,1,1,0,1
78295_0,,,,2,1,1,2
C(C1(C(C)(C(C(C)O1)O)O)O)=O,,,5,1,1,0,1
78297_0,,,,2,1,1,2
C1(C(O)OC(C(C)O)C1(C)O)=O,,,5,1,1,0,1
78299_0,,,,2,1,1,2
C(C1(C(C)(C(C(CO)O1)O)O)O)=O,,,5,1,1,0,1
78301_0,,,,2,1,1,2
C1(C(O)OC(C(CO)O)C1(C)O)=O,,,5,1,1,0,1
78303_0,,,,2,1,1,2
C(C1(C(C)(C(CO)(CO1)O)O)O)=O,,,5,1,1,0,1
78305_0,,,,2,1,1,2
C1(C(O)OC(CO)(CO)C1(C)O)=O,,,5,1,1,0,1
78307_0,,,,2,1,1,2
C1(C(C(C)(C(C=O)(O)O1)O)O)=O,,,5,1,2,0,2
78309_0,,,,2,1,1,2
C1(C(OC(C(O)=O)C1(C)O)O)=O,,,5,1,1,0,1
78311_0,,,,2,1,1,2
C(C1(C)C(C(C(O1)O)=O)(C)O)=O,,,5,1,1,0,1
78313_0,,,,2,1,1,2
C(C(C1(C)C(CC(O1)O)O)=O)=O,,,5,1,1,0,1
78315_0,,,,2,1,1,2
C(CC1C(C(C(O)O1)=O)(C)O)=O,,,5,1,1,0,1
78317_0,,,,2,1,1,2
C1(C(O)OC(C)C1(C)O)=O,,,5,1,1,0,1
78319_0,,,,2,1,1,2
C1(C(O)OCC1(C)O)=O,,,5,1,1,0,1
78321_0,,,,2,1,1,2
C(C1(C(C)(C(CO1)O)O)O)=O,,,5,1,1,0,1
78323_0,,,,2,1,1,2
C1(C(O)OC(CO)C1(C)O)=O,,,5,1,1,0,1
78325_0,,,,2,1,1,2
C(C1(C(C(O)OC1C)(O)O)O)=O,,,5,1,1,0,1
78327_0,,,,2,1,1,2
[C]1(C(OC(C1(C(C)O)O)O)=O)O,,,5,1,1,0,1
78329_0,,,,2,1,1,2
[C]1(C(OC(C(C)O)(C1O)O)=O)O,,,5,1,1,0,1
78331_0,,,,2,1,1,2
C1(C2(C(C(C(O2)O)O)O)OCC1)=O,,,5,1,1,0,1
78333_0,,,,2,1,1,2
C(C1C(C2(C(CCO2)(O1)O)O)O)=O,,,5,1,1,0,1
78335_0,,,,2,1,1,2
C(C1(C=C)C(C(C(O1)O)O)O)(O)=O,,,5,1,1,0,1
78337_0,,,,2,1,1,2
C1(C2(CCO1)C(C(C(O2)O)O)O)=O,,,5,1,1,0,1
78338_0,,,,2,1,1,2
78340_0,,,,2,1,1,2
C(C1C(C(C(O1)O)(O)O)O)=O,,,5,1,1,0,1
78342_0,,,,2,1,1,2
[C]1(C(O)=O)C(C(C(O)O1)O)O,,,5,1,1,0,1
78343_0,,,,2,1,1,2
78345_0,,,,2,1,1,2
C1C(C)(C(C(O)O1)(CCO)O)O,,,5,1,1,0,1
78347_0,,,,2,1,1,2
C1(CC(C(O)O1)(C(C)(CO)O)O)=O,,,5,1,1,0,1
78349_0,,,,2,1,1,2
C(CC1(C(O)OCC1(C)O)O)(O)=O,,,5,1,1,0,1
78351_0,,,,2,1,1,2
C1C(C)(C2(C(CCO2)(O)O1)O)O,,,5,1,1,0,1
78353_0,,,,2,1,1,2
C1C(C)(C2(C(C(CO2)O)(O)O1)O)O,,,5,1,1,0,1
78355_0,,,,2,1,1,2
C1C(C)(C(C(O)O1)(O)O)O,,,5,1,1,0,1
78357_0,,,,2,1,1,2
C1C(C)(C(C)(C(O)O1)O)O,,,5,1,1,0,1
78359_0,,,,2,1,1,2
C1C(CCO)(C(C(O)O1)(O)O)O,,,5,1,1,0,1
78361_0,,,,2,1,1,2
C1C(CCO)(C(C)(C(O)O1)O)O,,,5,1,1,0,1
78363_0,,,,2,1,1,2
C(CC(C1(C(O)OCC1)O)O)(O)=O,,,5,1,1,0,1
78364_0,,,,2,1,1,2
78365_0,,,,2,1,1,2
78367_0,,,,2,1,1,2
C(C(C1(C(O)OCC1)O)O)=CC=O,,,5,1,1,0,1
78369_0,,,,2,1,1,2
C1(C(C(C(O)O1)(CCO)O)O)O,,,5,1,1,0,1
78371_0,,,,2,1,1,2
C1CC(C(O)O1)(C(C(O)O)O)O,,,5,1,1,0,1
78373_0,,,,2,1,1,2
CC1C(C(C(O)O1)(CCO)O)O,,,5,1,1,0,1
78375_0,,,,2,1,1,2
CC(C(C1(C(O)OCC1)O)O)O,,,5,1,1,0,1
78377_0,,,,2,1,1,2
C(CC1C(C(C(O)O1)(O)O)O)O,,,5,1,1,0,1
78379_0,,,,2,1,1,2
CC1(C(O)OC(CCO)C1O)O,,,5,1,1,0,1
78381_0,,,,2,1,1,2
CC1(C(CO)OC(C1(O)O)O)O,,,5,1,1,0,1
78383_0,,,,2,1,1,2
CC1(C(CO)OC(C1(C)O)O)O,,,5,1,1,0,1
78385_0,,,,2,1,1,2
C1(C(C)(C2(C(CCO2)(O)O1)O)O)=O,,,5,1,1,0,1
78387_0,,,,2,1,1,2
C1(C(C)(C(C(O)O1)(O)O)O)=O,,,5,1,1,0,1
78389_0,,,,2,1,1,2
C1(C(C(C(O)O1)(O)O)(CCO)O)=O,,,5,1,1,0,1
78391_0,,,,2,1,1,2
C(C1(C(O)OC(C1)=O)O)(O)=O,,,5,1,1,0,1
78393_0,,,,2,1,1,2
C(CC1(C(O)OC(C1O)O)O)(O)=O,,,5,1,1,0,1
78395_0,,,,2,1,1,2
C1(CC(C(O)O1)(C(C(O)O)O)O)=O,,,5,1,1,0,1
78397_0,,,,2,1,1,2
C(CC1(C(O)OC(C)C1O)O)(O)=O,,,5,1,1,0,1
78399_0,,,,2,1,1,2
C1(CC(C(O)O1)(C(C(C)O)O)O)=O,,,5,1,1,0,1
78401_0,,,,2,1,1,2
C(CC1C(C(C(O)O1)(O)O)O)(O)=O,,,5,1,1,0,1
78403_0,,,,2,1,1,2
C(CC1C(C(C)(C(O)O1)O)O)(O)=O,,,5,1,1,0,1
78405_0,,,,2,1,1,2
C(CC1(COC(C1(O)O)O)O)(O)=O,,,5,1,1,0,1
78407_0,,,,2,1,1,2
C(CC1(COC(C1(C)O)O)O)(O)=O,,,5,1,1,0,1
78409_0,,,,2,1,1,2
C(C1C(C)(C(C(O1)O)(O)O)O)(O)=O,,,5,1,1,0,1
78411_0,,,,2,1,1,2
C(C1C(C)(C(C)(C(O1)O)O)O)(O)=O,,,5,1,1,0,1
78413_0,,,,2,1,1,2
C1(C(CO)(C(C(O)O1)(O)O)O)=O,,,5,1,1,0,1
78415_0,,,,2,1,1,2
C(C1(COC(C1(O)O)O)O)(O)=O,,,5,1,1,0,1
78417_0,,,,2,1,1,2
C1(C(C=O)(CC(CO)(O)O1)O)=O,,,5,1,1,0,1
78419_0,,,,2,1,1,2
C(C1(CC(OC1(C=O)O)O)O)=O,,,5,1,1,0,1
78421_0,,,,2,1,1,2
C(C1([C](C(O)=O)OC(C1)O)O)=O,,,5,1,1,0,1
78423_0,,,,2,1,1,2
C(CC1([C](C(OC1O)=O)O)O)=O,,,5,1,1,0,1
78425_0,,,,2,1,1,2
C1(C(C(C=O)(O)O)OC(C1)O)=O,,,5,1,1,0,1
78427_0,,,,2,1,1,2
C(CC1(C([C](C(O1)=O)O)O)O)=O,,,5,1,1,0,1
78429_0,,,,2,1,1,2
C1(CC(OC1[C](C(O)=O)O)O)=O,,,5,1,1,0,1
78431_0,,,,2,1,1,2
C(C1(C(CC(C=O)(O1)O)O)O)=O,,,5,1,1,0,1
78433_0,,,,2,1,1,2
C(C(C1CC(C(O)O1)=O)(O)O)=O,,,5,1,1,0,1
78435_0,,,,2,1,1,2
C(C1(C)C(CC(C=O)(O1)O)O)=O,,,5,1,1,0,1
78437_0,,,,2,1,1,2
C(C(C)(C1CC(C(O)O1)=O)O)=O,,,5,1,1,0,1
78439_0,,,,2,1,1,2
C(C1(CC([C](C(O)=O)O1)O)O)=O,,,5,1,1,0,1
78441_0,,,,2,1,1,2
C1(C(O)OC([C](C(O)=O)O)C1)=O,,,5,1,1,0,1
78443_0,,,,2,1,1,2
C(C1C(CC(C=O)(O1)O)O)(O)=O,,,5,1,1,0,1
78444_0,,,,2,1,1,2
78446_0,,,,2,1,1,2
C(C1(C)C(CC(C=O)(O1)O)O)(O)=O,,,5,1,1,0,1
78448_0,,,,2,1,1,2
C(C(C)(C1CC(C(O)O1)=O)O)(O)=O,,,5,1,1,0,1
78449_0,,,,2,1,1,2
78450_0,,,,2,1,1,2
78452_0,,,,2,1,1,2
C(C1(C(C)OC(CO)(C1)O)O)(O)=O,,,5,1,1,0,1
78453_0,,,,2,1,1,2
78455_0,,,,2,1,1,2
C(CC1([C](C(OC1O)=O)O)O)(O)=O,,,5,1,1,0,1
78456_0,,,,2,1,1,2
78458_0,,,,2,1,1,2
C(CC1(C([C](C(O1)=O)O)O)O)(O)=O,,,5,1,1,0,1
78460_0,,,,2,1,1,2
C(C1(CC(C(C=O)(O1)O)O)O)(O)=O,,,5,1,1,0,1
78462_0,,,,2,1,1,2
C(C1(C)C(CC(C(O)=O)(O1)O)O)=O,,,5,1,1,0,1
78464_0,,,,2,1,1,2
C(C1(CC([C](C(O)=O)O1)O)O)(O)=O,,,5,1,1,0,1
78466_0,,,,2,1,1,2
C(C1C(CC(C(O)=O)(O1)O)O)(O)=O,,,5,1,1,0,1
78468_0,,,,2,1,1,2
C(C1(CC(OC1(C=O)O)O)O)(O)=O,,,5,1,1,0,1
78470_0,,,,2,1,1,2
C1(C(C(C(O)O1)(O)O)(CC=O)O)=O,,,5,1,1,0,1
78471_0,,,,2,1,1,2
78473_0,,,,2,1,1,2
C(C1([C](C(O)=O)OC(C1)O)O)(O)=O,,,5,1,1,0,1
78474_0,,,,2,1,1,2
78476_0,,,,2,1,1,2
C1C2(C(CO1)OC(C2(O)O)O)O,,,5,1,1,0,1
78478_0,,,,2,1,1,2
C1C2(C(CO1)OC(C2(C)O)O)O,,,5,1,1,0,1
78480_0,,,,2,1,1,2
C1CC2(C(C(C(O)O2)O)(O)O1)O,,,5,1,1,0,1
78482_0,,,,2,1,1,2
C1CC2(C(C(C(C)O2)O)(O)O1)O,,,5,1,1,0,1
78484_0,,,,2,1,1,2
C1CC2(C(C(C(CO)O2)O)(O)O1)O,,,5,1,1,0,1
78486_0,,,,2,1,1,2
C1C(CO)(C2(C(CCO2)(O)O1)O)O,,,5,1,1,0,1
78488_0,,,,2,1,1,2
C1(C(C2(C(CCO2)(O)O1)O)O)=O,,,5,1,1,0,1
78490_0,,,,2,1,1,2
C1(C2(C(CC(O2)O)O)OCC1)=O,,,5,1,1,0,1
78492_0,,,,2,1,1,2
C(C1(COC2(C1(O)OCC2)O)O)=O,,,5,1,1,0,1
78494_0,,,,2,1,1,2
C1C(C2(C(CCO2)(O)O1)O)O,,,5,1,1,0,1
78496_0,,,,2,1,1,2
C12C(CCO1)(C(C(O)O2)(O)O)O,,,5,1,1,0,1
78498_0,,,,2,1,1,2
C12C(CCO1)(C(C)(C(O)O2)O)O,,,5,1,1,0,1
78500_0,,,,2,1,1,2
C(C)(C1([C](C(OC1O)=O)O)O)=O,,,5,1,1,0,1
78502_0,,,,2,1,1,2
C(C1([C](C(OC1(C)O)=O)O)O)=O,,,5,1,1,0,1
78504_0,,,,2,1,1,2
C1(C(C(C=O)(OC1(C)O)O)O)=O,,,5,1,1,0,1
78506_0,,,,2,1,1,2
C1(C(C)(O)O[C](C(O)=O)C1O)=O,,,5,1,1,0,1
78508_0,,,,2,1,1,2
C(C)(C1(C([C](C(O1)=O)O)O)O)=O,,,5,1,1,0,1
78510_0,,,,2,1,1,2
C1(C(OC(C=O)(C1(C)O)O)O)=O,,,5,1,1,0,1
78512_0,,,,2,1,1,2
C1(C(O)O[C](C(O)=O)C1(C)O)=O,,,5,1,1,0,1
78514_0,,,,2,1,1,2
C(C1(C([C](C(O1)=O)O)(C)O)O)=O,,,5,1,1,0,1
78516_0,,,,2,1,1,2
C1(C(C=C)(C(C=C)(C(O)O1)O)O)=O,,,5,1,1,0,1
78518_0,,,,2,1,1,2
C=CC1([C](C(OC1O)=O)O)O,,,5,1,1,0,1
78519_0,,,,2,1,1,2
78521_0,,,,2,1,1,2
C(C1(C=C)C(C=O)(CC(O1)O)O)=O,,,5,1,1,0,1
78522_0,,,,2,1,1,2
78524_0,,,,2,1,1,2
C1(C(C=C)(C(C(C=C)(O)O1)O)O)=O,,,5,1,1,0,1
78526_0,,,,2,1,1,2
C=CC1(C([C](C(O1)=O)O)O)O,,,5,1,1,0,1
78527_0,,,,2,1,1,2
78529_0,,,,2,1,1,2
C(C1(CC(OC1C(C=C)=O)O)O)=O,,,5,1,1,0,1
78530_0,,,,2,1,1,2
78532_0,,,,2,1,1,2
C(C1(CC(OC1C=CC=O)O)O)=O,,,5,1,1,0,1
78533_0,,,,2,1,1,2
78534_0,,,,2,1,1,2
78535_0,,,,2,1,1,2
78536_0,,,,2,1,1,2
78538_0,,,,2,1,1,2
C1(C(C=C)(C(CO)(C(O)O1)O)O)=O,,,5,1,1,0,1
78540_0,,,,2,1,1,2
C1(C(C=C)(C(C(CO)(O)O1)O)O)=O,,,5,1,1,0,1
78542_0,,,,2,1,1,2
C1C(C2(C(C(C(O)O2)O)(O)O1)O)O,,,5,1,1,0,1
78544_0,,,,2,1,1,2
C1C(C2(C(C(C(C)O2)O)(O)O1)O)O,,,5,1,1,0,1
78546_0,,,,2,1,1,2
C1(C(C2(C(C(CO2)O)(O)O1)O)O)=O,,,5,1,1,0,1
78548_0,,,,2,1,1,2
C1(C2(C(CC(O2)O)O)OCC1O)=O,,,5,1,1,0,1
78550_0,,,,2,1,1,2
C1C(C2(C(C(CO2)O)(O)O1)O)O,,,5,1,1,0,1
78552_0,,,,2,1,1,2
C1C2C(C(O)O1)(C(C(O)O2)(O)O)O,,,5,1,1,0,1
78554_0,,,,2,1,1,2
C12C(C(CO1)O)(C(C(O)O2)(O)O)O,,,5,1,1,0,1
78556_0,,,,2,1,1,2
CC1(C(O)OC2COC(C21O)O)O,,,5,1,2,0,2
78558_0,,,,2,1,1,2
C12C(C(CO1)O)(C(C)(C(O)O2)O)O,,,5,1,1,0,1
78560_0,,,,2,1,1,2
C1(C(C=O)(CC(O)O1)O)=O,,,5,1,1,0,1
78562_0,,,,2,1,1,2
C1(C2(CCO1)C(CC(O2)O)O)=O,,,5,1,2,0,2
78564_0,,,,2,1,1,2
C1(C(C(C(O)O1)O)(CC(O)=O)O)=O,,,5,1,1,0,1
78566_0,,,,2,1,1,2
C1(C(C(C(O)O1)O)(O)O)O,,,5,1,1,0,1
78568_0,,,,2,1,1,2
CC1C(C(C(O)O1)(O)O)O,,,5,1,1,0,1
78570_0,,,,2,1,1,2
C(C1C(C(C(O)O1)(O)O)O)O,,,5,1,1,0,1
78572_0,,,,2,1,1,2
C(C(C1C(C(C(O)O1)(O)O)O)O)O,,,5,1,1,0,1
78574_0,,,,2,1,1,2
C(C(C1C(C(C(O)O1)(O)O)O)O)=O,,,5,1,1,0,1
78576_0,,,,2,1,1,2
C(C(C1C(C(C(O)O1)O)O)(O)O)=O,,,5,1,1,0,1
78578_0,,,,2,1,1,2
C1C(CO)(C(C(O)O1)(O)O)O,,,5,1,1,0,1
78580_0,,,,2,1,1,2
C1C(C(CO)O)(C(C(O)O1)(O)O)O,,,5,1,1,0,1
78582_0,,,,2,1,1,2
C1(C(C(CO)(C(CO)O1)O)(O)O)O,,,5,1,1,0,1
78584_0,,,,2,1,1,2
C1(C(C(C(O)O1)(O)O)O)=O,,,5,1,1,0,1
78586_0,,,,2,1,1,2
C1(C(C(C(CO)(CO)O1)O)(O)O)O,,,5,1,1,0,1
78588_0,,,,2,1,1,2
C(C1(C(CC(O1)O)O)O)=O,,,5,1,1,0,1
78589_0,,,,2,1,1,2
78591_0,,,,2,1,1,2
C(CC1C(C(C(O)O1)(O)O)O)=O,,,5,1,1,0,1
78593_0,,,,2,1,1,2
C(C(C1C(CC(O)O1)O)(O)O)=O,,,5,1,1,0,1
78595_0,,,,2,1,1,2
C(C(C1CC(C(O)O1)O)(O)O)=O,,,5,1,1,0,1
78597_0,,,,2,1,1,2
C(C1(C(CC(CO)(O1)O)O)O)=O,,,5,1,1,0,1
78598_0,,,,2,1,1,2
78600_0,,,,2,1,1,2
C(CC1(COC(C1(O)O)O)O)=O,,,5,1,1,0,1
78602_0,,,,2,1,1,2
C(C1(C(CO)(CC(O1)O)O)O)=O,,,5,1,1,0,1
78604_0,,,,2,1,1,2
C(C)(C1C(C(C(O1)O)(O)O)O)=O,,,5,1,1,0,1
78606_0,,,,2,1,1,2
C(C1(C(C(C(C)(O1)O)O)O)O)=O,,,5,1,1,0,1
78608_0,,,,2,1,1,2
C(C1C(C)(C(C(O1)O)(O)O)O)=O,,,5,1,1,0,1
78609_0,,,,2,1,1,2
78611_0,,,,2,1,1,2
C(C1(COC(C1(O)O)O)O)=O,,,5,1,1,0,1
78613_0,,,,2,1,1,2
C(C1(C(C(O)OC1CO)(O)O)O)=O,,,5,1,1,0,1
78614_0,,,,2,1,1,2
78616_0,,,,2,1,1,2
C1C(C(C(O)O1)(O)O)O,,,5,1,1,0,1
78618_0,,,,2,1,1,2
CC1(C(O)OC(C1O)O)O,,,5,1,1,0,1
78620_0,,,,2,1,1,2
C(C1(C(C(O)O)OC(C1)O)O)=O,,,5,1,1,0,1
78622_0,,,,2,1,1,2
C(CC1(C(O)OC(C1O)O)O)=O,,,5,1,1,0,1
78624_0,,,,2,1,1,2
CC1(C(O)OC(C)C1O)O,,,5,1,1,0,1
78626_0,,,,2,1,1,2
CC1(C(O)OC(CO)C1O)O,,,5,1,1,0,1
78628_0,,,,2,1,1,2
CC1(C(O)OC(C(CO)O)C1O)O,,,5,1,1,0,1
78630_0,,,,2,1,1,2
CC1(C(O)OC(CO)(CO)C1O)O,,,5,1,1,0,1
78632_0,,,,2,1,1,2
C(C1(C)C(CC(O1)O)O)=O,,,5,1,1,0,1
78634_0,,,,2,1,1,2
C(C(C)(C1CC(C(O)O1)O)O)=O,,,5,1,1,0,1
78636_0,,,,2,1,1,2
C(C1(C)C(CC(CO)(O1)O)O)=O,,,5,1,1,0,1
78638_0,,,,2,1,1,2
C(C)(C1C(C(C)(C(O1)O)O)O)=O,,,5,1,1,0,1
78640_0,,,,2,1,1,2
C(C1(C)C(C(C(C)(O1)O)O)O)=O,,,5,1,1,0,1
78642_0,,,,2,1,1,2
C(C1C(C)(C(C)(C(O1)O)O)O)=O,,,5,1,1,0,1
78644_0,,,,2,1,1,2
C(C1(C)C(C)(C(C(O1)O)O)O)=O,,,5,1,1,0,1
78646_0,,,,2,1,1,2
[C]1(C(OC(C1O)O)=O)O,,,5,1,2,0,2
78648_0,,,,2,1,1,2
[C](C(O)=O)(C1C(C(C(O1)O)O)O)O,,,5,1,1,0,1
78650_0,,,,2,1,1,2
[C]1(C(OC(C1(C)O)O)=O)O,,,5,1,1,0,1
78652_0,,,,2,1,1,2
[C]1(C(OC(C)(C1O)O)=O)O,,,5,1,1,0,1
78654_0,,,,2,1,1,2
[C]1(C(O)=O)C(CC(O)O1)O,,,5,1,1,0,1
78655_0,,,,2,1,1,2
78657_0,,,,2,1,1,2
[C]1(C(OC(C1(CCO)O)O)=O)O,,,5,1,1,0,1
78659_0,,,,2,1,1,2
[C]1(C(OC(CCO)(C1O)O)=O)O,,,5,1,1,0,1
78661_0,,,,2,1,1,2
[C](C(O)=O)(C1C(CC(O1)O)O)O,,,5,1,1,0,1
78663_0,,,,2,1,1,2
[C](C(O)=O)(C1CC(C(O1)O)O)O,,,5,1,1,0,1
78665_0,,,,2,1,1,2
[C]1(C(O)=O)C(CC(CO)(O)O1)O,,,5,1,1,0,1
78666_0,,,,2,1,1,2
78668_0,,,,2,1,1,2
[C]1(C(O)=O)C(CO)(CC(O)O1)O,,,5,1,1,0,1
78670_0,,,,2,1,1,2
[C]1(C(O)=O)C(C(C(C)(O)O1)O)O,,,5,1,1,0,1
78672_0,,,,2,1,1,2
[C]1(C(O)=O)C(C)(C(C(O)O1)O)O,,,5,1,1,0,1
78674_0,,,,2,1,1,2
[C]1(C(OC(C1(CO)O)O)=O)O,,,5,1,1,0,1
78676_0,,,,2,1,1,2
[C]1(C(OC(CO)(C1O)O)=O)O,,,5,1,1,0,1
78677_0,,,,2,1,1,2
78679_0,,,,2,1,1,2
[C]1(C(OC(C1(C(CO)O)O)O)=O)O,,,5,1,1,0,1
78681_0,,,,2,1,1,2
[C]1(C(OC(C(CO)O)(C1O)O)=O)O,,,5,1,1,0,1
78683_0,,,,2,1,1,2
C(CO)(OC1C(O)OCC1O)=O,,,5,1,1,0,1
78685_0,,,,2,1,1,2
C(CO)(OC1COC(C1O)O)=O,,,5,1,1,0,1
78687_0,,,,2,1,1,2
C(CCC1(C(C(CO1)O)O)O)=O,,,5,1,2,0,2
78689_0,,,,2,1,1,2
C(CC1(CC(C(CO)O1)O)O)=O,,,5,1,1,0,1
78690_0,,,,2,1,1,2
78691_0,,,,2,1,1,2
78692_0,,,,2,1,1,2
78693_0,,,,2,1,1,2
78695_0,,,,2,1,1,2
C(C(C1COC(C1CO)O)=O)=O,,,5,1,1,0,1
78696_0,,,,2,1,1,2
78698_0,,,,2,1,1,2
C(C1C(CO)C(OC1C=O)O)=O,,,5,1,1,0,1
78699_0,,,,2,1,1,2
78700_0,,,,2,1,1,2
78701_0,,,,2,1,1,2
78702_0,,,,2,1,1,2
78703_0,,,,2,1,1,2
78704_0,,,,2,1,1,2
78705_0,,,,2,1,1,2
78706_0,,,,2,1,1,2
78707_0,,,,2,1,1,2
78708_0,,,,2,1,1,2
78709_0,,,,2,1,1,2
78711_0,,,,2,1,1,2
C(C)(C1(CC(CO1)=O)O)=O,,,5,1,1,0,1
78712_0,,,,2,1,1,2
78713_0,,,,2,1,1,2
78715_0,,,,2,1,1,2
C(C1CCOC1(C(CO)=O)O)=O,,,5,1,1,0,1
78716_0,,,,2,1,1,2
78718_0,,,,2,1,1,2
C1(CC(C(CCO)=O)(OC1)O)=O,,,5,1,1,0,1
78720_0,,,,2,1,1,2
C(CCC1(C(C(CO1)=O)O)O)=O,,,5,1,2,0,2
78721_0,,,,2,1,1,2
78723_0,,,,2,1,1,2
C(CC(C1(CC(CO1)=O)O)O)=O,,,5,1,1,0,1
78725_0,,,,2,1,1,2
C(C(CC1(CC(CO1)=O)O)O)=O,,,5,1,1,0,1
78727_0,,,,2,1,1,2
C(C1CCC(C(CO)=O)(O1)O)=O,,,5,1,1,0,1
78729_0,,,,2,1,1,2
C(CO)(CC1(CC(CO1)=O)O)=O,,,5,1,1,0,1
78730_0,,,,2,1,1,2
78731_0,,,,2,1,1,2
78732_0,,,,2,1,1,2
78733_0,,,,2,1,1,2
78734_0,,,,2,1,1,2
78736_0,,,,2,1,1,2
C(C)(CC1(C(C(CO1)=O)O)O)=O,,,5,1,1,0,1
78737_0,,,,2,1,1,2
78739_0,,,,2,1,1,2
C(C)(C(C1(CC(CO1)=O)O)O)=O,,,5,1,1,0,1
78740_0,,,,2,1,1,2
78741_0,,,,2,1,1,2
78743_0,,,,2,1,1,2
C1(COC(C)(C1)O)=O,,,5,1,1,0,1
78744_0,,,,2,1,1,2
78746_0,,,,2,1,1,2
C(CO)(C1(CC(CO1)=O)O)=O,,,5,1,1,0,1
78747_0,,,,2,1,1,2
78749_0,,,,2,1,1,2
C(C(CC1C(O)OCC1O)=O)=O,,,5,1,1,0,1
78750_0,,,,2,1,1,2
78751_0,,,,2,1,1,2
78753_0,,,,2,1,1,2
C(C(C=O)C1C(O)OCC1O)=O,,,5,1,1,0,1
78754_0,,,,2,1,1,2
78755_0,,,,2,1,1,2
78757_0,,,,2,1,1,2
C(CC1C(O)OCC1O)=O,,,5,1,1,0,1
78758_0,,,,2,1,1,2
78759_0,,,,2,1,1,2
78760_0,,,,2,1,1,2
78761_0,,,,2,1,1,2
78762_0,,,,2,1,1,2
78763_0,,,,2,1,1,2
78765_0,,,,2,1,1,2
C1(CC(C(C)=O)(OC1CO)O)=O,,,5,1,1,0,1
78766_0,,,,2,1,1,2
78767_0,,,,2,1,1,2
78769_0,,,,2,1,1,2
C(CCC1(C(C(CO1)O)=O)O)=O,,,5,1,2,0,2
78771_0,,,,2,1,1,2
C1(C(CO)OC(C)(C1)O)=O,,,5,1,1,0,1
78773_0,,,,2,1,1,2
C1(C(CC)(O)OCC1O)=O,,,5,1,1,0,1
78774_0,,,,2,1,1,2
78775_0,,,,2,1,1,2
78776_0,,,,2,1,1,2
78777_0,,,,2,1,1,2
78779_0,,,,2,1,1,2
C(C1(COC(C1)(CC=O)O)O)=O,,,5,1,1,0,1
78780_0,,,,2,1,1,2
78782_0,,,,2,1,1,2
C(CC1(C(CO)C(CO1)O)O)=O,,,5,1,1,0,1
78783_0,,,,2,1,1,2
78784_0,,,,2,1,1,2
78786_0,,,,2,1,1,2
C(C(CC1(CC(CO1)O)O)=O)=O,,,5,1,1,0,1
78787_0,,,,2,1,1,2
78789_0,,,,2,1,1,2
C(C(C=O)C1(CC(CO1)O)O)=O,,,5,1,1,0,1
78791_0,,,,2,1,1,2
C(C1CCOC1(C(C=O)=O)O)=O,,,5,1,1,0,1
78792_0,,,,2,1,1,2
78794_0,,,,2,1,1,2
C(C1CCOC1(C=O)O)=O,,,5,1,1,0,1
78795_0,,,,2,1,1,2
78796_0,,,,2,1,1,2
78797_0,,,,2,1,1,2
78798_0,,,,2,1,1,2
78799_0,,,,2,1,1,2
78801_0,,,,2,1,1,2
C(C(C1COC(C1)(CO)O)=O)=O,,,5,1,1,0,1
78802_0,,,,2,1,1,2
78803_0,,,,2,1,1,2
78804_0,,,,2,1,1,2
78805_0,,,,2,1,1,2
78806_0,,,,2,1,1,2
78807_0,,,,2,1,1,2
78809_0,,,,2,1,1,2
C(C1CCC(C(C=O)=O)(O1)O)=O,,,5,1,1,0,1
78811_0,,,,2,1,1,2
C(C1CCC(C=O)(O1)O)=O,,,5,1,1,0,1
78812_0,,,,2,1,1,2
78814_0,,,,2,1,1,2
C(C1CC(CO)(OC1C=O)O)=O,,,5,1,1,0,1
78815_0,,,,2,1,1,2
78817_0,,,,2,1,1,2
C1(COC(CC(C=O)=O)(C1)O)=O,,,5,1,1,0,1
78818_0,,,,2,1,1,2
78819_0,,,,2,1,1,2
78820_0,,,,2,1,1,2
78821_0,,,,2,1,1,2
78823_0,,,,2,1,1,2
C(C1C(COC1(CCO)O)=O)=O,,,5,1,1,0,1
78824_0,,,,2,1,1,2
78825_0,,,,2,1,1,2
78826_0,,,,2,1,1,2
78827_0,,,,2,1,1,2
78828_0,,,,2,1,1,2
78830_0,,,,2,1,1,2
C(CC(C1(CC(CO1)=O)O)=O)=O,,,5,1,1,0,1
78831_0,,,,2,1,1,2
78832_0,,,,2,1,1,2
78834_0,,,,2,1,1,2
C(CC(C1(CC(CO1)O)O)=O)=O,,,5,1,1,0,1
78835_0,,,,2,1,1,2
78836_0,,,,2,1,1,2
78837_0,,,,2,1,1,2
78838_0,,,,2,1,1,2
78839_0,,,,2,1,1,2
78840_0,,,,2,1,1,2
78841_0,,,,2,1,1,2
78842_0,,,,2,1,1,2
78843_0,,,,2,1,1,2
78845_0,,,,2,1,1,2
C(C1C(CC(CCO)(O1)O)=O)=O,,,5,1,1,0,1
78847_0,,,,2,1,1,2
C(CC1(CC(CO1)O)O)=O,,,5,1,1,0,1
78848_0,,,,2,1,1,2
78850_0,,,,2,1,1,2
C1(COC(C(C=O)=O)(C1)O)=O,,,5,1,1,0,1
78852_0,,,,2,1,1,2
C(C1C(C)(O)OC(CO)C1O)=O,,,5,1,1,0,1
78853_0,,,,2,1,1,2
78854_0,,,,2,1,1,2
78855_0,,,,2,1,1,2
78857_0,,,,2,1,1,2
C1(COC(C(O)=O)(C1CO)O)=O,,,5,1,1,0,1
78859_0,,,,2,1,1,2
C1(COC(C(C)=O)(C1CO)O)=O,,,5,1,1,0,1
78860_0,,,,2,1,1,2
78862_0,,,,2,1,1,2
C(CC1(C(C(CO1)=O)CO)O)=O,,,5,1,1,0,1
78864_0,,,,2,1,1,2
C1(COC(C)(C1CO)O)=O,,,5,1,1,0,1
78866_0,,,,2,1,1,2
C1(COC(C)(C1(CO)O)O)=O,,,5,1,1,0,1
78867_0,,,,2,1,1,2
78868_0,,,,2,1,1,2
78869_0,,,,2,1,1,2
78870_0,,,,2,1,1,2
78871_0,,,,2,1,1,2
78873_0,,,,2,1,1,2
C(C1C(C)(O)OCC1O)(O)=O,,,5,1,1,0,1
78874_0,,,,2,1,1,2
78875_0,,,,2,1,1,2
78876_0,,,,2,1,1,2
78877_0,,,,2,1,1,2
78879_0,,,,2,1,1,2
C(C1C(C)(O)OCC1(C=O)O)=O,,,5,1,1,0,1
78880_0,,,,2,1,1,2
78882_0,,,,2,1,1,2
C(C1C(C)(O)OC(C1O)=O)=O,,,5,1,1,0,1
78883_0,,,,2,1,1,2
78884_0,,,,2,1,1,2
78885_0,,,,2,1,1,2
78886_0,,,,2,1,1,2
78887_0,,,,2,1,1,2
78888_0,,,,2,1,1,2
78889_0,,,,2,1,1,2
78891_0,,,,2,1,1,2
C(C1C(COC1(C(C)=O)O)O)=O,,,5,1,1,0,1
78892_0,,,,2,1,1,2
78893_0,,,,2,1,1,2
78895_0,,,,2,1,1,2
C(C1C(CC=O)(O)OCC1O)=O,,,5,1,1,0,1
78896_0,,,,2,1,1,2
78897_0,,,,2,1,1,2
78899_0,,,,2,1,1,2
C(C(CO)C1(CC(CO1)=O)O)=O,,,5,1,1,0,1
78900_0,,,,2,1,1,2
78902_0,,,,2,1,1,2
C(C1(COC(C1CC=O)O)O)=O,,,5,1,1,0,1
78903_0,,,,2,1,1,2
78904_0,,,,2,1,1,2
78905_0,,,,2,1,1,2
78907_0,,,,2,1,1,2
C(C1(COC(C(C)=O)(C1)O)O)=O,,,5,1,1,0,1
78908_0,,,,2,1,1,2
78909_0,,,,2,1,1,2
78910_0,,,,2,1,1,2
78912_0,,,,2,1,1,2
C(C1(COC(C=O)(C1C)O)O)=O,,,5,1,1,0,1
78913_0,,,,2,1,1,2
78915_0,,,,2,1,1,2
C(C1C(C)(O)OCC1O)=O,,,5,1,1,0,1
78916_0,,,,2,1,1,2
78917_0,,,,2,1,1,2
78919_0,,,,2,1,1,2
C(C1CCOC1(C(O)=O)O)(O)=O,,,5,1,1,0,1
78920_0,,,,2,1,1,2
78921_0,,,,2,1,1,2
78922_0,,,,2,1,1,2
78924_0,,,,2,1,1,2
C(C1CCOC1(C(C)=O)O)(O)=O,,,5,1,1,0,1
78925_0,,,,2,1,1,2
78926_0,,,,2,1,1,2
78928_0,,,,2,1,1,2
C(C1C(CC=O)(O)OCC1)(O)=O,,,5,1,1,0,1
78929_0,,,,2,1,1,2
78931_0,,,,2,1,1,2
C(C1CCOC1(C(O)=O)O)=O,,,5,1,1,0,1
78932_0,,,,2,1,1,2
78933_0,,,,2,1,1,2
78935_0,,,,2,1,1,2
C(C(C)C1(C(CCO1)=O)O)(O)=O,,,5,1,1,0,1
78936_0,,,,2,1,1,2
78937_0,,,,2,1,1,2
78938_0,,,,2,1,1,2
78939_0,,,,2,1,1,2
78941_0,,,,2,1,1,2
C1(C(C)(CC(CC=O)(O)O1)O)=O,,,5,1,1,0,1
78943_0,,,,2,1,1,2
C(C1CCC(C(O)=O)(O1)O)=O,,,5,1,1,0,1
78945_0,,,,2,1,1,2
C(C(C)C1(CC(CO1)=O)O)(O)=O,,,5,1,1,0,1
78946_0,,,,2,1,1,2
78947_0,,,,2,1,1,2
78949_0,,,,2,1,1,2
C1(C(C)(C(C(O)O1)CC=O)O)=O,,,5,1,1,0,1
78950_0,,,,2,1,1,2
78952_0,,,,2,1,1,2
C(CC1C(O)OC(C1O)=O)=O,,,5,1,1,0,1
78953_0,,,,2,1,1,2
78954_0,,,,2,1,1,2
78956_0,,,,2,1,1,2
C1(C(C)(CC(C(C)=O)(O)O1)O)=O,,,5,1,1,0,1
78957_0,,,,2,1,1,2
78958_0,,,,2,1,1,2
78959_0,,,,2,1,1,2
78960_0,,,,2,1,1,2
78961_0,,,,2,1,1,2
78963_0,,,,2,1,1,2
C1(C(C)(C(C)C(C=O)(O)O1)O)=O,,,5,1,1,0,1
78965_0,,,,2,1,1,2
C1(C(C(C)C(C=O)(O)O1)O)=O,,,5,1,1,0,1
78966_0,,,,2,1,1,2
78968_0,,,,2,1,1,2
C(C1CCOC1(C)O)(O)=O,,,5,1,1,0,1
78969_0,,,,2,1,1,2
78970_0,,,,2,1,1,2
78971_0,,,,2,1,1,2
78973_0,,,,2,1,1,2
C(C1CCOC1(C=O)O)(O)=O,,,5,1,1,0,1
78975_0,,,,2,1,1,2
C(C1C(O)OCC1)(O)=O,,,5,1,1,0,1
78977_0,,,,2,1,1,2
C(C1(C(C)(O)OCC1)O)(O)=O,,,5,1,1,0,1
78979_0,,,,2,1,1,2
C(C1CCOC1(CO)O)(O)=O,,,5,1,1,0,1
78981_0,,,,2,1,1,2
C1C2(C(C(CO2)O1)O)O,,,5,1,1,0,1
78983_0,,,,2,1,1,2
C1C2CC(C(O)O2)(O)O1,,,5,1,2,0,2
78985_0,,,,2,1,1,2
C1C2(C(C(C(CO)O2)O1)O)O,,,5,1,1,0,1
78987_0,,,,2,1,1,2
C(C1C2CC(C(O)O2)(O)O1)O,,,5,1,2,0,2
78989_0,,,,2,1,1,2
C1(CC2C(C(C(O)O2)O)O1)O,,,5,1,2,0,2
78991_0,,,,2,1,1,2
CC1(C2C(C(C(O)O2)O1)O)O,,,5,1,2,0,2
78992_0,,,,2,1,1,2
78994_0,,,,2,1,1,2
C(C1(C2(COC1CO2)O)O)=O,,,5,1,1,0,1
78995_0,,,,2,1,1,2
78996_0,,,,2,1,1,2
78998_0,,,,2,1,1,2
C(C1C2COC1(C(O)O2)O)=O,,,5,1,2,0,2
78999_0,,,,2,1,1,2
79000_0,,,,2,1,1,2
79001_0,,,,2,1,1,2
79002_0,,,,2,1,1,2
79004_0,,,,2,1,1,2
C1C2C(C(CC(O)O2)(O)O1)O,,,5,1,2,0,2
79006_0,,,,2,1,1,2
C1C2CC(C(C(O)O2)O)(O)O1,,,5,1,2,0,2
79008_0,,,,2,1,1,2
C1C2(CC(CO2)(C(O)O1)O)O,,,5,1,2,0,2
79010_0,,,,2,1,1,2
C1C2C(C(C(O)O2)C(O)O1)O,,,5,1,2,0,2
79011_0,,,,2,1,1,2
79012_0,,,,2,1,1,2
79014_0,,,,2,1,1,2
C1C2(C(C(C(CO1)O2)O)O)O,,,5,1,1,0,1
79016_0,,,,2,1,1,2
C1C2C(CC(C(O)O1)(O)O2)O,,,5,1,2,0,2
79018_0,,,,2,1,1,2
C1C(C2(CC(C(O2)O1)O)O)O,,,5,1,1,0,1
79020_0,,,,2,1,1,2
C1CC2(C(C(C(O2)O1)O)O)O,,,5,1,1,0,1
79022_0,,,,2,1,1,2
C1C2(CC(C(C(O)O1)O2)O)O,,,5,1,2,0,2
79024_0,,,,2,1,1,2
C1(C2(CC(CO2)O1)O)=O,,,5,1,2,0,2
79026_0,,,,2,1,1,2
C1(C2(CC(C(CO)O2)O1)O)=O,,,5,1,2,0,2
79028_0,,,,2,1,1,2
C1(CC2(C(C(CO2)O)O1)O)=O,,,5,1,2,0,2
79030_0,,,,2,1,1,2
C1(C(C2C(CC(O)O2)O1)O)=O,,,5,1,2,0,2
79032_0,,,,2,1,1,2
C1(C2C(C(C(C)(O2)O)O1)O)=O,,,5,1,2,0,2
79034_0,,,,2,1,1,2
C1(CC2(C(C(CO2)O1)O)O)=O,,,5,1,2,0,2
79036_0,,,,2,1,1,2
C1(C(C2(CC(CO2)O1)O)O)=O,,,5,1,2,0,2
79038_0,,,,2,1,1,2
C1(C2(CC(C(CO1)O2)O)O)=O,,,5,1,2,0,2
79040_0,,,,2,1,1,2
C1(C2C(CC(CO1)(O2)O)O)=O,,,5,1,2,0,2
79042_0,,,,2,1,1,2
C1(C(C(C(C)(O)O1)O)=O)=O,,,5,1,1,0,1
79043_0,,,,2,1,1,2
79045_0,,,,2,1,1,2
C1(C(C(C(CCO)(O)O1)O)=O)=O,,,5,1,1,0,1
79046_0,,,,2,1,1,2
79048_0,,,,2,1,1,2
C(C(C1(CC(CO1)O)O)=O)(O)=O,,,5,1,2,0,2
79050_0,,,,2,1,1,2
C1(C(CC(C)(O)O1)O)=O,,,5,1,1,0,1
79052_0,,,,2,1,1,2
C(C1CCC(O1)O)(O)=O,,,5,1,1,0,1
79054_0,,,,2,1,1,2
C1(C(CC(CCO)(O)O1)O)=O,,,5,1,1,0,1
79056_0,,,,2,1,1,2
C(C1CCC(CO)(O1)O)(O)=O,,,5,1,1,0,1
79057_0,,,,2,1,1,2
79058_0,,,,2,1,1,2
79059_0,,,,2,1,1,2
79060_0,,,,2,1,1,2
79061_0,,,,2,1,1,2
79062_0,,,,2,1,1,2
79063_0,,,,2,1,1,2
79064_0,,,,2,1,1,2
79065_0,,,,2,1,1,2
79066_0,,,,2,1,1,2
79067_0,,,,2,1,1,2
79068_0,,,,2,1,1,2
79069_0,,,,2,1,1,2
79070_0,,,,2,1,1,2
79071_0,,,,2,1,1,2
79072_0,,,,2,1,1,2
79073_0,,,,2,1,1,2
79074_0,,,,2,1,1,2
79075_0,,,,2,1,1,2
79076_0,,,,2,1,1,2
79077_0,,,,2,1,1,2
79078_0,,,,2,1,1,2
79079_0,,,,2,1,1,2
79080_0,,,,2,1,1,2
79081_0,,,,2,1,1,2
79082_0,,,,2,1,1,2
79083_0,,,,2,1,1,2
79084_0,,,,2,1,1,2
79085_0,,,,2,1,1,2
79086_0,,,,2,1,1,2
79087_0,,,,2,1,1,2
79088_0,,,,2,1,1,2
79089_0,,,,2,1,1,2
79090_0,,,,2,1,1,2
79091_0,,,,2,1,1,2
79092_0,,,,2,1,1,2
79093_0,,,,2,1,1,2
79094_0,,,,2,1,1,2
79095_0,,,,2,1,1,2
79096_0,,,,2,1,1,2
79097_0,,,,2,1,1,2
79098_0,,,,2,1,1,2
79099_0,,,,2,1,1,2
79100_0,,,,2,1,1,2
79101_0,,,,2,1,1,2
79102_0,,,,2,1,1,2
79103_0,,,,2,1,1,2
79104_0,,,,2,1,1,2
79105_0,,,,2,1,1,2
79106_0,,,,2,1,1,2
79107_0,,,,2,1,1,2
79108_0,,,,2,1,1,2
79109_0,,,,2,1,1,2
79110_0,,,,2,1,1,2
79111_0,,,,2,1,1,2
79112_0,,,,2,1,1,2
79113_0,,,,2,1,1,2
79114_0,,,,2,1,1,2
79115_0,,,,2,1,1,2
79116_0,,,,2,1,1,2
79117_0,,,,2,1,1,2
79118_0,,,,2,1,1,2
79119_0,,,,2,1,1,2
79120_0,,,,2,1,1,2
79121_0,,,,2,1,1,2
79122_0,,,,2,1,1,2
79123_0,,,,2,1,1,2
79124_0,,,,2,1,1,2
79125_0,,,,2,1,1,2
79126_0,,,,2,1,1,2
79127_0,,,,2,1,1,2
79128_0,,,,2,1,1,2
79129_0,,,,2,1,1,2
79130_0,,,,2,1,1,2
79131_0,,,,2,1,1,2
79132_0,,,,2,1,1,2
79133_0,,,,2,1,1,2
79134_0,,,,2,1,1,2
79135_0,,,,2,1,1,2
79136_0,,,,2,1,1,2
79137_0,,,,2,1,1,2
79138_0,,,,2,1,1,2
79139_0,,,,2,1,1,2
79140_0,,,,2,1,1,2
79141_0,,,,2,1,1,2
79142_0,,,,2,1,1,2
79143_0,,,,2,1,1,2
79144_0,,,,2,1,1,2
79145_0,,,,2,1,1,2
79146_0,,,,2,1,1,2
79147_0,,,,2,1,1,2
79148_0,,,,2,1,1,2
79149_0,,,,2,1,1,2
79150_0,,,,2,1,1,2
79151_0,,,,2,1,1,2
79152_0,,,,2,1,1,2
79153_0,,,,2,1,1,2
79154_0,,,,2,1,1,2
79155_0,,,,2,1,1,2
79156_0,,,,2,1,1,2
79157_0,,,,2,1,1,2
79158_0,,,,2,1,1,2
79159_0,,,,2,1,1,2
79160_0,,,,2,1,1,2
79161_0,,,,2,1,1,2
79162_0,,,,2,1,1,2
79163_0,,,,2,1,1,2
79164_0,,,,2,1,1,2
79165_0,,,,2,1,1,2
79166_0,,,,2,1,1,2
79167_0,,,,2,1,1,2
79168_0,,,,2,1,1,2
79169_0,,,,2,1,1,2
79170_0,,,,2,1,1,2
79171_0,,,,2,1,1,2
79172_0,,,,2,1,1,2
79173_0,,,,2,1,1,2
79174_0,,,,2,1,1,2
79176_0,,,,2,1,1,2
C(C(C1C2CC(C(O)O2)(O)O1)O)=O,,,5,1,2,0,2
79178_0,,,,2,1,1,2
C(C1(CC2C(C(C(O)O2)O)O1)O)=O,,,5,1,2,0,2
79179_0,,,,2,1,1,2
79180_0,,,,2,1,1,2
79182_0,,,,2,1,1,2
C(C1C(O)OC2C1OC(C2O)O)=O,,,5,1,2,0,2
79183_0,,,,2,1,1,2
79184_0,,,,2,1,1,2
79186_0,,,,2,1,1,2
C1(C(C2C(C(C(O)O2)O)O1)O)O,,,5,1,1,0,1
79188_0,,,,2,1,1,2
C1C2(CO)CC(C(O)O2)(O)O1,,,5,1,2,0,2
79189_0,,,,2,1,1,2
79191_0,,,,2,1,1,2
C1C2(COC(C2C(O)O1)O)O,,,5,1,1,0,1
79193_0,,,,2,1,1,2
C1C2(CO)C(CO)C(C(O)O2)(O)O1,,,5,1,2,0,2
79194_0,,,,2,1,1,2
79195_0,,,,2,1,1,2
79197_0,,,,2,1,1,2
C12C(C(C(O)O1)C(CO)(CO)O2)O,,,5,1,1,0,1
79199_0,,,,2,1,1,2
C1C2(CO)C(C(O)O1)C(C(O)O2)O,,,5,1,2,0,2
79200_0,,,,2,1,1,2
79202_0,,,,2,1,1,2
C1C(CO)(C2C(O1)OC(C2O)O)O,,,5,1,1,0,1
79204_0,,,,2,1,1,2
C1C2(COC(C2C(CO)(O)O1)O)O,,,5,1,2,0,2
79205_0,,,,2,1,1,2
79206_0,,,,2,1,1,2
79207_0,,,,2,1,1,2
79209_0,,,,2,1,1,2
C1C2(CO)C(C(C(O)O2)(O)O1)O,,,5,1,2,0,2
79210_0,,,,2,1,1,2
79212_0,,,,2,1,1,2
C(C1(C(C2C(CC(O)O2)O1)O)O)O,,,5,1,2,0,2
79213_0,,,,2,1,1,2
79215_0,,,,2,1,1,2
C1C2(CC(O)OC2C(CO)(O)O1)O,,,5,1,2,0,2
79216_0,,,,2,1,1,2
79218_0,,,,2,1,1,2
CC1(C2C(C(C(CO)(O)O2)O1)O)O,,,5,1,2,0,2
79219_0,,,,2,1,1,2
79221_0,,,,2,1,1,2
CC1(C2C(O)OC1C(CO)(O)O2)O,,,5,1,2,0,2
79222_0,,,,2,1,1,2
79224_0,,,,2,1,1,2
C1C2(C(O)OC(CO)(C2O)O1)O,,,5,1,1,0,1
79226_0,,,,2,1,1,2
C1C2(CC(C(O)O2)(O)O1)C(CO)O,,,5,1,2,0,2
79228_0,,,,2,1,1,2
C1(C2(CC(CO)(C(CO)O2)O1)O)O,,,5,1,2,0,2
79229_0,,,,2,1,1,2
79230_0,,,,2,1,1,2
79232_0,,,,2,1,1,2
C1C2(C(CO)OC(C2C(O)O1)O)O,,,5,1,2,0,2
79233_0,,,,2,1,1,2
79235_0,,,,2,1,1,2
C1(C2CC(C(O2)O)(O)O1)=O,,,5,1,2,0,2
79236_0,,,,2,1,1,2
79238_0,,,,2,1,1,2
C1(C2C(CO)C(C(O2)O)(O)O1)=O,,,5,1,2,0,2
79239_0,,,,2,1,1,2
79240_0,,,,2,1,1,2
79242_0,,,,2,1,1,2
C(C1C2C(O)OC(C2O)O1)(O)=O,,,5,1,1,0,1
79244_0,,,,2,1,1,2
C1(C2C(C(O)O1)C(C(O2)O)O)=O,,,5,1,2,0,2
79245_0,,,,2,1,1,2
79247_0,,,,2,1,1,2
C1(C(C2C(OC(C2O)O)O1)O)=O,,,5,1,1,0,1
79248_0,,,,2,1,1,2
79249_0,,,,2,1,1,2
79251_0,,,,2,1,1,2
C1(C2C(C(C(O2)O)(O)O1)O)=O,,,5,1,2,0,2
79252_0,,,,2,1,1,2
79254_0,,,,2,1,1,2
C1(C(CO)(C2C(CC(O)O2)O1)O)O,,,5,1,2,0,2
79255_0,,,,2,1,1,2
79257_0,,,,2,1,1,2
C1(C(C2(CO)C(CC(O)O2)O1)O)O,,,5,1,2,0,2
79258_0,,,,2,1,1,2
79259_0,,,,2,1,1,2
79261_0,,,,2,1,1,2
C1(C2(CC(C(CO)(CO)O2)O1)O)O,,,5,1,2,0,2
79262_0,,,,2,1,1,2
79264_0,,,,2,1,1,2
C1(C(O)OC2(C(O)OCC12)C)=O,,,5,1,2,0,2
79265_0,,,,2,1,1,2
79267_0,,,,2,1,1,2
C(C1(C2COC(C2(C)O)O1)O)=O,,,5,1,1,0,1
79269_0,,,,2,1,1,2
C(C1C2C(O)OC(C2(C)O)O1)=O,,,5,1,1,0,1
79271_0,,,,2,1,1,2
C(C1C2C(O)OC1(C)C(O)O2)=O,,,5,1,2,0,2
79272_0,,,,2,1,1,2
79274_0,,,,2,1,1,2
C(C1(C)C2C(O)OC(C2O)O1)=O,,,5,1,1,0,1
79276_0,,,,2,1,1,2
C1(C(O)OC2C(C)(O)OCC12)=O,,,5,1,2,0,2
79277_0,,,,2,1,1,2
79279_0,,,,2,1,1,2
C(C1(C2COC(C)(C2O)O1)O)=O,,,5,1,1,0,1
79281_0,,,,2,1,1,2
C(C1C2C(O)OC(C)(C2O)O1)=O,,,5,1,1,0,1
79283_0,,,,2,1,1,2
C(C1C2C(O)OC1C(C)(O)O2)=O,,,5,1,2,0,2
79284_0,,,,2,1,1,2
79286_0,,,,2,1,1,2
C(C)(C1C2C(O)OC(C2O)O1)=O,,,5,1,1,0,1
79287_0,,,,2,1,1,2
79289_0,,,,2,1,1,2
C(C1(CC2C(CC(O)O2)O1)O)=O,,,5,1,2,0,2
79291_0,,,,2,1,1,2
C(CC1C2CC(C(O)O2)(O)O1)=O,,,5,1,2,0,2
79292_0,,,,2,1,1,2
79293_0,,,,2,1,1,2
79295_0,,,,2,1,1,2
C(CC12COC(C(O)O1)(C2)O)=O,,,5,1,2,0,2
79296_0,,,,2,1,1,2
79297_0,,,,2,1,1,2
79299_0,,,,2,1,1,2
C(C)(C1C2CC(C(O)O2)(O1)O)=O,,,5,1,2,0,2
79300_0,,,,2,1,1,2
79302_0,,,,2,1,1,2
C(C1C2(C)CC(C(O)O2)(O1)O)=O,,,5,1,2,0,2
79303_0,,,,2,1,1,2
79305_0,,,,2,1,1,2
C(C12CC(C(O1)O)(CO2)O)=O,,,5,1,1,0,1
79307_0,,,,2,1,1,2
C(C12COC(C1)(C(O2)O)O)=O,,,5,1,2,0,2
79308_0,,,,2,1,1,2
79310_0,,,,2,1,1,2
C(C12CC(C(O1)O)(C(CO)O2)O)=O,,,5,1,1,0,1
79311_0,,,,2,1,1,2
79313_0,,,,2,1,1,2
C(C12C(CO)OC(C1)(C(O2)O)O)=O,,,5,1,2,0,2
79314_0,,,,2,1,1,2
79315_0,,,,2,1,1,2
79316_0,,,,2,1,1,2
79318_0,,,,2,1,1,2
C(C(C1C2CC(C(O)O2)(O)O1)O)O,,,5,1,2,0,2
79319_0,,,,2,1,1,2
79320_0,,,,2,1,1,2
79322_0,,,,2,1,1,2
C(CC1C2C(O)OC(C2O)O1)=O,,,5,1,1,0,1
79324_0,,,,2,1,1,2
C1(C(O)OC2CC(OC12)O)=O,,,5,1,2,0,2
79325_0,,,,2,1,1,2
79327_0,,,,2,1,1,2
C(C1C(O)OC2C1OC(C2)O)=O,,,5,1,2,0,2
79328_0,,,,2,1,1,2
79330_0,,,,2,1,1,2
C(C1C2OCC1(C(O)O2)O)=O,,,5,1,1,0,1
79332_0,,,,2,1,1,2
C(C1C2OC(C1(C(CO)O2)O)O)=O,,,5,1,1,0,1
79333_0,,,,2,1,1,2
79334_0,,,,2,1,1,2
79336_0,,,,2,1,1,2
C(C12C(CO)C(C(O1)O)(CO2)O)=O,,,5,1,1,0,1
79338_0,,,,2,1,1,2
C(C12COC(C(O1)O)(C2CO)O)=O,,,5,1,2,0,2
79340_0,,,,2,1,1,2
C(C1(C2COC(C2(CO1)O)O)O)=O,,,5,1,2,0,2
79341_0,,,,2,1,1,2
79342_0,,,,2,1,1,2
79344_0,,,,2,1,1,2
C1(C(O)OC2(C(O)OCC12)CO)=O,,,5,1,2,0,2
79345_0,,,,2,1,1,2
79346_0,,,,2,1,1,2
79348_0,,,,2,1,1,2
C(C1(C2COC(C2(CO)O)O1)O)=O,,,5,1,1,0,1
79350_0,,,,2,1,1,2
C1(C(O)OC2C(CO)(O)OCC12)=O,,,5,1,2,0,2
79351_0,,,,2,1,1,2
79353_0,,,,2,1,1,2
C(C1(C2COC(CO)(C2O)O1)O)=O,,,5,1,1,0,1
79355_0,,,,2,1,1,2
C1(C2(C(CO)C(C(CO)O2)O1)O)O,,,5,1,2,0,2
79356_0,,,,2,1,1,2
79357_0,,,,2,1,1,2
79359_0,,,,2,1,1,2
C1(C(O)OC2C(O)OCC12)=O,,,5,1,2,0,2
79360_0,,,,2,1,1,2
79362_0,,,,2,1,1,2
C(C1(C2COC(C2O)O1)O)=O,,,5,1,1,0,1
79364_0,,,,2,1,1,2
C1C2C(CO)C(C(O)O2)(O)O1,,,5,1,2,0,2
79365_0,,,,2,1,1,2
79366_0,,,,2,1,1,2
79368_0,,,,2,1,1,2
C1(CC2C(CC(O)O2)O1)O,,,5,1,1,0,1
79370_0,,,,2,1,1,2
C(CC1C2C(C(C(O)O2)(O)O1)O)=O,,,5,1,2,0,2
79372_0,,,,2,1,1,2
C(C1(C(C2C(CC(O)O2)O1)O)O)=O,,,5,1,2,0,2
79373_0,,,,2,1,1,2
79374_0,,,,2,1,1,2
79376_0,,,,2,1,1,2
C12C(C(C(O)O1)C(C)O2)O,,,5,1,1,0,1
79378_0,,,,2,1,1,2
C(C(C1C2OC(C1(CO2)O)O)O)=O,,,5,1,1,0,1
79380_0,,,,2,1,1,2
C(C1(COC2C1C(C(O)O2)O)O)=O,,,5,1,1,0,1
79382_0,,,,2,1,1,2
C(C1C2C(O)OCC2(C(O1)O)O)=O,,,5,1,2,0,2
79384_0,,,,2,1,1,2
C(C12COC(C1C(C(O2)O)O)O)=O,,,5,1,2,0,2
79385_0,,,,2,1,1,2
79387_0,,,,2,1,1,2
C(C1C2C(O)OC(C2(CO)O)O1)=O,,,5,1,1,0,1
79389_0,,,,2,1,1,2
C(C1C2C(O)OC1(C(O)O2)CO)=O,,,5,1,2,0,2
79390_0,,,,2,1,1,2
79391_0,,,,2,1,1,2
79393_0,,,,2,1,1,2
C(C1(CO)C2C(O)OC(C2O)O1)=O,,,5,1,1,0,1
79395_0,,,,2,1,1,2
C(C1C2C(O)OC(CO)(C2O)O1)=O,,,5,1,1,0,1
79397_0,,,,2,1,1,2
C(C1C2C(O)OC1C(CO)(O)O2)=O,,,5,1,2,0,2
79398_0,,,,2,1,1,2
79400_0,,,,2,1,1,2
C(CO)(C1C2C(O)OC(C2O)O1)=O,,,5,1,1,0,1
79402_0,,,,2,1,1,2
C12C(C(C(O)O1)O)C(C(CO)O2)O,,,5,1,1,0,1
79404_0,,,,2,1,1,2
C1(C(C2C(O)OC(CO)C2O1)O)O,,,5,1,2,0,2
79405_0,,,,2,1,1,2
79407_0,,,,2,1,1,2
C12C(C(C(O)O1)C(C(CO)O)O2)O,,,5,1,1,0,1
79409_0,,,,2,1,1,2
C(C1C2C(O)OC(C2O)O1)=O,,,5,1,1,0,1
79411_0,,,,2,1,1,2
C(C1C2C(O)OC1C(O)O2)=O,,,5,1,1,0,1
79413_0,,,,2,1,1,2
C1C2C(O)OC(C2O)O1,,,5,1,1,0,1
79415_0,,,,2,1,1,2
C12C(C(CO1)O)C(C(O)O2)O,,,5,1,1,0,1
79417_0,,,,2,1,1,2
C1C2C(C(O)O1)C(C(O)O2)O,,,5,1,2,0,2
79418_0,,,,2,1,1,2
79420_0,,,,2,1,1,2
C12C(C(C(O)O1)C(CO)O2)O,,,5,1,1,0,1
79422_0,,,,2,1,1,2
C1(C(O)OC2CC(CO)(OC12)O)=O,,,5,1,2,0,2
79423_0,,,,2,1,1,2
79425_0,,,,2,1,1,2
C1(C(O)OC2(CO)CC(OC12)O)=O,,,5,1,2,0,2
79427_0,,,,2,1,1,2
C(C1(C2C(CO1)(CC(O)O2)O)O)=O,,,5,1,2,0,2
79428_0,,,,2,1,1,2
79430_0,,,,2,1,1,2
C(CC12COC(C(O)O1)(C2O)O)=O,,,5,1,2,0,2
79431_0,,,,2,1,1,2
79432_0,,,,2,1,1,2
79433_0,,,,2,1,1,2
79435_0,,,,2,1,1,2
C1C2(C(C(O)O1)OC(C2)O)O,,,5,1,2,0,2
79436_0,,,,2,1,1,2
79438_0,,,,2,1,1,2
C(CO)(C1C2OC(C1(CO2)O)O)=O,,,5,1,1,0,1
79440_0,,,,2,1,1,2
C(C1C2(CO)OCC1(C(O)O2)O)=O,,,5,1,1,0,1
79441_0,,,,2,1,1,2
79442_0,,,,2,1,1,2
79443_0,,,,2,1,1,2
79445_0,,,,2,1,1,2
C(CC12C(C(CO1)(C(O)O2)O)O)=O,,,5,1,1,0,1
79446_0,,,,2,1,1,2
79447_0,,,,2,1,1,2
79448_0,,,,2,1,1,2
79450_0,,,,2,1,1,2
C1(C(O)OC2C(C(C)(OC12)O)O)=O,,,5,1,2,0,2
79452_0,,,,2,1,1,2
C(C1(C2C(C(C(C)(O)O2)O1)O)O)=O,,,5,1,2,0,2
79453_0,,,,2,1,1,2
79455_0,,,,2,1,1,2
C(C)(C1C2C(C(C(O)O2)(O1)O)O)=O,,,5,1,2,0,2
79456_0,,,,2,1,1,2
79457_0,,,,2,1,1,2
79458_0,,,,2,1,1,2
79460_0,,,,2,1,1,2
C1(C(O)OC2(C)C(C(OC12)O)O)=O,,,5,1,2,0,2
79462_0,,,,2,1,1,2
C(C1(C2C(C)(C(C(O)O2)O1)O)O)=O,,,5,1,2,0,2
79463_0,,,,2,1,1,2
79465_0,,,,2,1,1,2
C(C1C2(C)C(C(C(O)O2)(O1)O)O)=O,,,5,1,2,0,2
79466_0,,,,2,1,1,2
79467_0,,,,2,1,1,2
79469_0,,,,2,1,1,2
CC1(C2C(O)OC1C(O)O2)O,,,5,1,1,0,1
79471_0,,,,2,1,1,2
C(C(C12CC(C(O)O1)(CO2)O)O)=O,,,5,1,1,0,1
79473_0,,,,2,1,1,2
C1C2(C(O)OC(C2)O1)O,,,5,1,1,0,1
79475_0,,,,2,1,1,2
C12CC(C(O)O1)(C(CO)O2)O,,,5,1,1,0,1
79476_0,,,,2,1,1,2
79478_0,,,,2,1,1,2
C(C12COC(C1O)(C(O2)O)O)=O,,,5,1,2,0,2
79479_0,,,,2,1,1,2
79481_0,,,,2,1,1,2
C(C12C(C(C(O1)O)(CO2)O)O)=O,,,5,1,1,0,1
79483_0,,,,2,1,1,2
C1(C2(C(C(C(CO)O2)O1)O)O)O,,,5,1,2,0,2
79484_0,,,,2,1,1,2
79486_0,,,,2,1,1,2
C1C2C(C(C(O)O2)(O)O1)O,,,5,1,2,0,2
79487_0,,,,2,1,1,2
79489_0,,,,2,1,1,2
C1C(C2(C(O)OCC2(O)O1)O)O,,,5,1,2,0,2
79490_0,,,,2,1,1,2
79492_0,,,,2,1,1,2
C1(C(C2(C(OC(C2O)O)O1)O)O)=O,,,5,1,1,0,1
79494_0,,,,2,1,1,2
C1(C2C(C(O)O1)(C(C(O2)O)O)O)=O,,,5,1,2,0,2
79495_0,,,,2,1,1,2
79497_0,,,,2,1,1,2
C(C1C2(C(O)OC(C2O)O1)O)(O)=O,,,5,1,1,0,1
79499_0,,,,2,1,1,2
C(C1C2(C(O)OC(C2(C)O)O1)O)=O,,,5,1,1,0,1
79501_0,,,,2,1,1,2
C(C1(C2C(O)OC1(C(O)O2)C)O)=O,,,5,1,2,0,2
79502_0,,,,2,1,1,2
79504_0,,,,2,1,1,2
C(C1(C)C2(C(O)OC(C2O)O1)O)=O,,,5,1,1,0,1
79506_0,,,,2,1,1,2
C(C1C2(C(O)OC(C)(C2O)O1)O)=O,,,5,1,1,0,1
79508_0,,,,2,1,1,2
C(C1(C2C(O)OC1C(C)(O)O2)O)=O,,,5,1,2,0,2
79509_0,,,,2,1,1,2
79511_0,,,,2,1,1,2
C(C)(C1C2(C(O)OC(C2O)O1)O)=O,,,5,1,1,0,1
79513_0,,,,2,1,1,2
C(C12C(C(O)OC1CC(O2)O)O)=O,,,5,1,2,0,2
79514_0,,,,2,1,1,2
79516_0,,,,2,1,1,2
C(CC1C2(C(O)OC(C2O)O1)O)=O,,,5,1,1,0,1
79518_0,,,,2,1,1,2
C12C(C(C(O)O1)(C(C)O2)O)O,,,5,1,1,0,1
79520_0,,,,2,1,1,2
C(C1C2(C(O)OC(C2O)O1)O)=O,,,5,1,1,0,1
79522_0,,,,2,1,1,2
C(C1(C2C(O)OC1C(O)O2)O)=O,,,5,1,1,0,1
79524_0,,,,2,1,1,2
C1C2(COC(C2(C(C)(O)O1)O)O)O,,,5,1,2,0,2
79525_0,,,,2,1,1,2
79527_0,,,,2,1,1,2
C1C2(C(CO)(O)OC(C2(C)O)O1)O,,,5,1,1,0,1
79529_0,,,,2,1,1,2
C1C2(C(CO)(O)OC(C)(C2O)O1)O,,,5,1,1,0,1
79531_0,,,,2,1,1,2
C1C2(C(C(O1)OC2(CO)O)O)O,,,5,1,1,0,1
79533_0,,,,2,1,1,2
C1(C2C(CO)(C(C(O2)O)(O)O1)O)=O,,,5,1,2,0,2
79534_0,,,,2,1,1,2
79535_0,,,,2,1,1,2
79537_0,,,,2,1,1,2
C12C(CO)(C(C(O)O1)(C(C)O2)O)O,,,5,1,1,0,1
79539_0,,,,2,1,1,2
C1C2(C(O)OC(C)C2(C(O)O1)O)O,,,5,1,2,0,2
79540_0,,,,2,1,1,2
79542_0,,,,2,1,1,2
C12C(C(C)O)(C(CO1)(C(O)O2)O)O,,,5,1,1,0,1
79544_0,,,,2,1,1,2
C12C(CO)(C(CO1)(C(O)O2)O)O,,,5,1,1,0,1
79546_0,,,,2,1,1,2
C1C2(C(O)OCC2(C(O)O1)O)O,,,5,1,1,0,1
79547_0,,,,2,1,1,2
79549_0,,,,2,1,1,2
C(C1(C2C(O)OC1C(O)O2)O)(O)=O,,,5,1,1,0,1
79551_0,,,,2,1,1,2
C(C1(C2(COC(C2(C)O)O1)O)O)=O,,,5,1,1,0,1
79553_0,,,,2,1,1,2
C1(C(O)OC2(C(O)OCC12O)C)=O,,,5,1,2,0,2
79554_0,,,,2,1,1,2
79556_0,,,,2,1,1,2
C12C(C)(C(CO1)(C(O)O2)O)O,,,5,1,1,0,1
79558_0,,,,2,1,1,2
C12C(C)(C(C(O)O1)(C(CO)O2)O)O,,,5,1,1,0,1
79559_0,,,,2,1,1,2
79561_0,,,,2,1,1,2
C(C1(C2(COC(C)(C2O)O1)O)O)=O,,,5,1,1,0,1
79563_0,,,,2,1,1,2
C1(C(O)OC2C(C)(O)OCC12O)=O,,,5,1,2,0,2
79564_0,,,,2,1,1,2
79566_0,,,,2,1,1,2
C1C2(C(O)OC(C)(C2O)O1)O,,,5,1,1,0,1
79568_0,,,,2,1,1,2
CC12C(C(C(O)O1)(C(CO)O2)O)O,,,5,1,1,0,1
79569_0,,,,2,1,1,2
79570_0,,,,2,1,1,2
79572_0,,,,2,1,1,2
C1(C(O)OC2CC(OC12CO)O)=O,,,5,1,2,0,2
79573_0,,,,2,1,1,2
79575_0,,,,2,1,1,2
C1C(C2(C(O)O1)C(CC(O)O2)O)O,,,5,1,2,0,2
79576_0,,,,2,1,1,2
79578_0,,,,2,1,1,2
C12C(CCO)(C(CO1)(C(O)O2)O)O,,,5,1,1,0,1
79580_0,,,,2,1,1,2
C1C2(C(O)OC(CCO)(C2O)O1)O,,,5,1,1,0,1
79582_0,,,,2,1,1,2
C1C2(CC(O)OC2(C(O)O1)CO)O,,,5,1,2,0,2
79583_0,,,,2,1,1,2
79585_0,,,,2,1,1,2
C(C)(C1(C2OC(C1(CO2)O)O)O)=O,,,5,1,1,0,1
79587_0,,,,2,1,1,2
C(C1(C2(C)OC(C1(CO2)O)O)O)=O,,,5,1,1,0,1
79589_0,,,,2,1,1,2
CC1(C2C(C(C(O)O2)(CO)O1)O)O,,,5,1,2,0,2
79590_0,,,,2,1,1,2
79592_0,,,,2,1,1,2
CC1(C2C(O)OC1(C(O)O2)CO)O,,,5,1,2,0,2
79593_0,,,,2,1,1,2
79595_0,,,,2,1,1,2
C(C1(C2(COC(C2O)O1)O)O)=O,,,5,1,1,0,1
79597_0,,,,2,1,1,2
C1(C(O)OC2C(O)OCC12O)=O,,,5,1,2,0,2
79598_0,,,,2,1,1,2
79599_0,,,,2,1,1,2
79601_0,,,,2,1,1,2
C1C2C(CO)(C(C(O)O2)(O)O1)O,,,5,1,2,0,2
79602_0,,,,2,1,1,2
79604_0,,,,2,1,1,2
C12CC(C(O)O1)(C(CO)(CO)O2)O,,,5,1,1,0,1
79606_0,,,,2,1,1,2
C1C2(CO)C(C(O)O1)(CC(O)O2)O,,,5,1,2,0,2
79607_0,,,,2,1,1,2
79609_0,,,,2,1,1,2
C12C(CC(O)O1)(C(CO2)(CO)O)O,,,5,1,1,0,1
79611_0,,,,2,1,1,2
C(C1C2(C(O)OC(C2)O1)O)(O)=O,,,5,1,1,0,1
79613_0,,,,2,1,1,2
C1(C2C(C(O)O1)(CC(O2)O)O)=O,,,5,1,2,0,2
79614_0,,,,2,1,1,2
79616_0,,,,2,1,1,2
C1(C(C2(C(OC(C2)O)O1)O)O)=O,,,5,1,1,0,1
79618_0,,,,2,1,1,2
C(C1(C)C2(C(O)OC(C2)O1)O)=O,,,5,1,1,0,1
79620_0,,,,2,1,1,2
C(C)(C1C2(C(O)OC(C2)O1)O)=O,,,5,1,1,0,1
79622_0,,,,2,1,1,2
C(C12CC(O)OC1CC(O2)O)=O,,,5,1,2,0,2
79623_0,,,,2,1,1,2
79625_0,,,,2,1,1,2
C(CC1C2(C(O)OC(C2)O1)O)=O,,,5,1,1,0,1
79627_0,,,,2,1,1,2
C12CC(C(O)O1)(C(C)O2)O,,,5,1,1,0,1
79629_0,,,,2,1,1,2
C(CC1(C2OCC1(C(O)O2)O)O)=O,,,5,1,1,0,1
79631_0,,,,2,1,1,2
C(C1(COC2C1(CC(O)O2)O)O)=O,,,5,1,1,0,1
79633_0,,,,2,1,1,2
C(C12COC(C1(CC(O2)O)O)O)=O,,,5,1,2,0,2
79634_0,,,,2,1,1,2
79636_0,,,,2,1,1,2
C(C1(CO)C2(C(O)OC(C2)O1)O)=O,,,5,1,1,0,1
79638_0,,,,2,1,1,2
C(CO)(C1C2(C(O)OC(C2)O1)O)=O,,,5,1,1,0,1
79640_0,,,,2,1,1,2
C12C(CC(O)O1)(C(C(CO)O2)O)O,,,5,1,1,0,1
79642_0,,,,2,1,1,2
C1(C2(CC(O)OC2C(CO)O1)O)O,,,5,1,2,0,2
79643_0,,,,2,1,1,2
79645_0,,,,2,1,1,2
C12CC(C(O)O1)(C(C(CO)O)O2)O,,,5,1,1,0,1
79647_0,,,,2,1,1,2
C(C1C2(C(O)OC(C2)O1)O)=O,,,5,1,1,0,1
79649_0,,,,2,1,1,2
C1C2(C(O)OC(CO)(C2)O1)O,,,5,1,1,0,1
79650_0,,,,2,1,1,2
79652_0,,,,2,1,1,2
C1(C2OC(C1(CO2)O)O)=O,,,5,1,1,0,1
79654_0,,,,2,1,1,2
C1(C2OC(CO)C1(C(O2)O)O)=O,,,5,1,1,0,1
79656_0,,,,2,1,1,2
C(C1(C2(C(O)OC1CO2)O)O)=O,,,5,1,2,0,2
79658_0,,,,2,1,1,2
C1(C(O)OC2COC(C12O)O)=O,,,5,1,2,0,2
79659_0,,,,2,1,1,2
79660_0,,,,2,1,1,2
79662_0,,,,2,1,1,2
C1(C(O)OC2C1(C(CO2)O)O)=O,,,5,1,1,0,1
79664_0,,,,2,1,1,2
C1(C(O)OC2C(C1)OC(C2O)O)=O,,,5,1,2,0,2
79666_0,,,,2,1,1,2
C(C1C(C2CC(C(O)O2)(O1)O)O)=O,,,5,1,2,0,2
79668_0,,,,2,1,1,2
C(C1(CC2C(C(C(O)O2)O1)O)O)=O,,,5,1,2,0,2
79670_0,,,,2,1,1,2
C(C1C(O)OC2C(O)OC1C2O)=O,,,5,1,2,0,2
79672_0,,,,2,1,1,2
C(C1C2C(C(C(O)O2)C(O1)O)O)=O,,,5,1,2,0,2
79674_0,,,,2,1,1,2
C1(C2C(C(CC(O)O2)O1)O)O,,,5,1,2,0,2
79676_0,,,,2,1,1,2
C1(C(C2C(C(C(O)O2)O1)O)O)O,,,5,1,2,0,2
79678_0,,,,2,1,1,2
C1C2(COC(C(C2)(O)O1)O)O,,,5,1,2,0,2
79680_0,,,,2,1,1,2
C1C2(COC(C(C2CO)(O)O1)O)O,,,5,1,2,0,2
79682_0,,,,2,1,1,2
C1C(CO)(C2C(O)OC(C2O)O1)O,,,5,1,1,0,1
79684_0,,,,2,1,1,2
C1C2(COC(C2C(C(O)O1)O)O)O,,,5,1,2,0,2
79686_0,,,,2,1,1,2
C1C2(CO)C(C(CC(O)O2)(O)O1)O,,,5,1,2,0,2
79688_0,,,,2,1,1,2
C1C2(CO)CC(C(C(O)O2)O)(O)O1,,,5,1,2,0,2
79690_0,,,,2,1,1,2
C1C2(COC(C(C2O)(O)O1)O)O,,,5,1,2,0,2
79692_0,,,,2,1,1,2
C1CC2(C(O)OC(CO)(C2O)O1)O,,,5,1,1,0,1
79694_0,,,,2,1,1,2
C(C1(C2C(C(CC(O)O2)O1)O)O)O,,,5,1,2,0,2
79696_0,,,,2,1,1,2
C(C1(C(C2CC(C(O)O2)O1)O)O)O,,,5,1,2,0,2
79698_0,,,,2,1,1,2
C1C2(C(O)OCC(C2O)(O)O1)O,,,5,1,2,0,2
79700_0,,,,2,1,1,2
C1C2(C(CO)OC(C(O)O1)(C2)O)O,,,5,1,2,0,2
79702_0,,,,2,1,1,2
C1C2(C(CO)OC(C(C2)(O)O1)O)O,,,5,1,2,0,2
79704_0,,,,2,1,1,2
C1C(C2(CO)CC(C(O)O2)(O)O1)O,,,5,1,2,0,2
79706_0,,,,2,1,1,2
C1C2(C(COC(C2C(O)O1)O)O)O,,,5,1,2,0,2
79708_0,,,,2,1,1,2
C1C2C(CO)(C(C(O)O2)C(O)O1)O,,,5,1,2,0,2
79710_0,,,,2,1,1,2
C1(C(C2C(O)OC(C2O)O1)O)=O,,,5,1,1,0,1
79712_0,,,,2,1,1,2
C1(C2C(C(CC(O2)O)(O)O1)O)=O,,,5,1,2,0,2
79714_0,,,,2,1,1,2
C1(C2CC(C(C(O2)O)O)(O)O1)=O,,,5,1,2,0,2
79716_0,,,,2,1,1,2
C1(C2(CO)C(C(CC(O)O2)O1)O)O,,,5,1,2,0,2
79718_0,,,,2,1,1,2
C1C2(C(CC(O)O1)OC(C2O)O)O,,,5,1,2,0,2
79720_0,,,,2,1,1,2
C(C1(C2C(O)OC1CC(O)O2)O)O,,,5,1,2,0,2
79722_0,,,,2,1,1,2
C1C2(C(C(O)O1)OC(CC2O)O)O,,,5,1,2,0,2
79724_0,,,,2,1,1,2
C1C(CO)(C2CC(C(O)O2)(O)O1)O,,,5,1,2,0,2
79726_0,,,,2,1,1,2
C1C2(CO)C(C(C(O)O2)C(O)O1)O,,,5,1,2,0,2
79728_0,,,,2,1,1,2
C1(COC2C(C)(C1C(O)O2)O)=O,,,5,1,1,0,1
79730_0,,,,2,1,1,2
C1(COC2(C)C(C1C(O)O2)O)=O,,,5,1,1,0,1
79732_0,,,,2,1,1,2
C(C12CC(C(O1)O)(CCO2)O)=O,,,5,1,1,0,1
79734_0,,,,2,1,1,2
C(C12CCOC(C1)(C(O2)O)O)=O,,,5,1,2,0,2
79736_0,,,,2,1,1,2
C1(C(O)OC2C(C1)OC(C2)O)=O,,,5,1,2,0,2
79738_0,,,,2,1,1,2
C(C1(CC2CC(C(O)O2)O1)O)=O,,,5,1,2,0,2
79740_0,,,,2,1,1,2
C(C1CC2CC(C(O)O2)(O1)O)=O,,,5,1,2,0,2
79742_0,,,,2,1,1,2
C1(COC2(CC1OC2O)O)=O,,,5,1,2,0,2
79744_0,,,,2,1,1,2
C1(C(O)OC2COC(C2(C1)O)O)=O,,,5,1,2,0,2
79746_0,,,,2,1,1,2
C(C12CC(C(O1)O)(C(CO2)O)O)=O,,,5,1,1,0,1
79748_0,,,,2,1,1,2
C(C12C(COC(C1)(C(O2)O)O)O)=O,,,5,1,2,0,2
79750_0,,,,2,1,1,2
C1(C2CC(C(O2)O)(OC1CO)O)=O,,,5,1,2,0,2
79752_0,,,,2,1,1,2
C1C(C2CC(C(O)O2)(O)O1)O,,,5,1,2,0,2
79754_0,,,,2,1,1,2
C1(C2(CC(C(C(CO)O2)O)O1)O)O,,,5,1,2,0,2
79756_0,,,,2,1,1,2
C1(C(O)OC2CC(O)OCC12)=O,,,5,1,2,0,2
79758_0,,,,2,1,1,2
C(C1C2C(O)OC1CC(O)O2)=O,,,5,1,2,0,2
79760_0,,,,2,1,1,2
C1(C2C(CC(O2)O)OC(C1)O)=O,,,5,1,2,0,2
79762_0,,,,2,1,1,2
C(C1C2OCCC1(C(O)O2)O)=O,,,5,1,1,0,1
79764_0,,,,2,1,1,2
C(C1C(O)OC2C(O)OC1C2)=O,,,5,1,2,0,2
79766_0,,,,2,1,1,2
C(C1(C2COC(C1C(O)O2)O)O)=O,,,5,1,2,0,2
79768_0,,,,2,1,1,2
C(C1C2OCC(C1(C(O)O2)O)O)=O,,,5,1,1,0,1
79770_0,,,,2,1,1,2
C1(C2C(O)OC(C(CO)O1)C2O)O,,,5,1,2,0,2
79772_0,,,,2,1,1,2
C12CC(C(O)O1)(CCO2)O,,,5,1,1,0,1
79774_0,,,,2,1,1,2
C(C12CCOC(C1O)(C(O2)O)O)=O,,,5,1,2,0,2
79776_0,,,,2,1,1,2
C(C12C(C(C(O1)O)(CCO2)O)O)=O,,,5,1,1,0,1
79778_0,,,,2,1,1,2
C12C(C(C(O)O1)(CCO2)O)O,,,5,1,1,0,1
79780_0,,,,2,1,1,2
C1(C(O)OCC2(C(O)OCC12)O)=O,,,5,1,2,0,2
79782_0,,,,2,1,1,2
C1(COC2(C(OC1C2CO)O)O)=O,,,5,1,2,0,2
79784_0,,,,2,1,1,2
C(C1(C2COC(CO1)(C2O)O)O)=O,,,5,1,2,0,2
79786_0,,,,2,1,1,2
C1(COC2(C(O)OCC2C1O)O)=O,,,5,1,2,0,2
79788_0,,,,2,1,1,2
C1C(C2C(CO)C(C(O)O2)(O)O1)O,,,5,1,2,0,2
79790_0,,,,2,1,1,2
C1C2C(C(O)O1)(O)OCC(C2O)O,,,5,1,2,0,2
79792_0,,,,2,1,1,2
C1(C(O)OC2C(CC(OC12)O)O)=O,,,5,1,2,0,2
79794_0,,,,2,1,1,2
C(C1(C2C(C(CC(O)O2)O1)O)O)=O,,,5,1,2,0,2
79796_0,,,,2,1,1,2
C1(C(O)OC2C(C1O)OC(C2)O)=O,,,5,1,2,0,2
79798_0,,,,2,1,1,2
C1(CC2CC(C(O)O2)O1)O,,,5,1,2,0,2
79800_0,,,,2,1,1,2
C1(C(O)OC2CC(C(OC12)O)O)=O,,,5,1,2,0,2
79802_0,,,,2,1,1,2
C(C1CC2C(C(C(O)O2)(O1)O)O)=O,,,5,1,2,0,2
79804_0,,,,2,1,1,2
C(C1(C(C2CC(C(O)O2)O1)O)O)=O,,,5,1,2,0,2
79806_0,,,,2,1,1,2
C1(C2CC(C(C(O)O2)O)O1)O,,,5,1,2,0,2
79808_0,,,,2,1,1,2
C(C1(COC2C(C1C(O)O2)O)O)=O,,,5,1,1,0,1
79810_0,,,,2,1,1,2
C(C1C2C(O)OCC1(C(O)O2)O)=O,,,5,1,2,0,2
79812_0,,,,2,1,1,2
C1(COC2C(C(C(O)O2)O)C1O)=O,,,5,1,1,0,1
79814_0,,,,2,1,1,2
C(C1C2C(O)OCC(C2O)(O1)O)=O,,,5,1,2,0,2
79816_0,,,,2,1,1,2
C1(COC(C2C(C(OC12)O)O)O)=O,,,5,1,2,0,2
79818_0,,,,2,1,1,2
C12C(C(C(O)O1)C(C(CO)O2)O)O,,,5,1,1,0,1
79820_0,,,,2,1,1,2
C12C(C(C(O)O1)O)C(C(CO2)O)O,,,5,1,1,0,1
79822_0,,,,2,1,1,2
C1C(C2C(C(O)O1)C(C(O)O2)O)O,,,5,1,2,0,2
79824_0,,,,2,1,1,2
C12C(C(C(O)O1)C(CO2)O)O,,,5,1,1,0,1
79826_0,,,,2,1,1,2
C1(C(O)OCC2(CC(OC12)O)O)=O,,,5,1,2,0,2
79828_0,,,,2,1,1,2
C1(COC(C2(COC(C12)O)O)O)=O,,,5,1,2,0,2
79830_0,,,,2,1,1,2
C(C1C2(COC(C1(CO2)O)O)O)=O,,,5,1,2,0,2
79832_0,,,,2,1,1,2
C1(COC2C(CO)(C1C(O)O2)O)=O,,,5,1,1,0,1
79834_0,,,,2,1,1,2
C1(COC2(COC(C2C1O)O)O)=O,,,5,1,2,0,2
79836_0,,,,2,1,1,2
C1(COC2(CO)C(C1C(O)O2)O)=O,,,5,1,1,0,1
79838_0,,,,2,1,1,2
C1C2C(C(C(O)O1)C(CO)(O)O2)O,,,5,1,2,0,2
79840_0,,,,2,1,1,2
C1C2C(C(C(O)O2)C(CO)(O)O1)O,,,5,1,2,0,2
79842_0,,,,2,1,1,2
C1C(C(C2C(O)OCC2(O)O1)O)O,,,5,1,2,0,2
79844_0,,,,2,1,1,2
C(C12COC(C1O)(CC(O2)O)O)=O,,,5,1,2,0,2
79846_0,,,,2,1,1,2
C1(COC2(C(C1O)OC(C2)O)O)=O,,,5,1,2,0,2
79848_0,,,,2,1,1,2
C1C(C(C2C(CC(O)O2)(O)O1)O)O,,,5,1,2,0,2
79850_0,,,,2,1,1,2
C1(CC2(C(C(C(CO)O2)O1)O)O)O,,,5,1,2,0,2
79852_0,,,,2,1,1,2
C1(C(O)OC2C(C1OC2(C)O)O)=O,,,5,1,2,0,2
79854_0,,,,2,1,1,2
C1(C(O)OC2C(OC1C2(C)O)O)=O,,,5,1,2,0,2
79856_0,,,,2,1,1,2
C(C1C2(CC(CO2)(C(O1)O)O)O)=O,,,5,1,2,0,2
79858_0,,,,2,1,1,2
C(C12COC(C1)(C(C(O2)O)O)O)=O,,,5,1,2,0,2
79860_0,,,,2,1,1,2
C1(C(C2(CC(C(CO)O2)O1)O)O)O,,,5,1,2,0,2
79862_0,,,,2,1,1,2
C1C(C2(C(O)OC(C2)O1)O)O,,,5,1,1,0,1
79864_0,,,,2,1,1,2
C1(COC2(C(C1OC2O)O)O)=O,,,5,1,2,0,2
79866_0,,,,2,1,1,2
C1C(C2C(C(C(O)O2)(O)O1)O)O,,,5,1,2,0,2
79868_0,,,,2,1,1,2
C1(C(C2(C(O)OC(C2O)O1)O)O)=O,,,5,1,1,0,1
79870_0,,,,2,1,1,2
C(C1(C2C(O)OC1CC(O)O2)O)=O,,,5,1,2,0,2
79872_0,,,,2,1,1,2
C12C(C)(C(C(O)O1)(C(CO2)O)O)O,,,5,1,1,0,1
79874_0,,,,2,1,1,2
C1C(C2(C(O)OC(C)(C2O)O1)O)O,,,5,1,1,0,1
79876_0,,,,2,1,1,2
C1(C(O)OC2CC(O)OCC12O)=O,,,5,1,2,0,2
79878_0,,,,2,1,1,2
C1C2C(C(O)O1)(C(CC(O)O2)O)O,,,5,1,2,0,2
79880_0,,,,2,1,1,2
C1C2(C(O)OCCC2(C(O)O1)O)O,,,5,1,2,0,2
79882_0,,,,2,1,1,2
C12C(CO)(C(C(O)O1)(CCO2)O)O,,,5,1,1,0,1
79884_0,,,,2,1,1,2
C1(C(CO)(C2CC(C(O)O2)O1)O)O,,,5,1,2,0,2
79886_0,,,,2,1,1,2
C1C2(CC(O)OCC2(C(O)O1)O)O,,,5,1,2,0,2
79888_0,,,,2,1,1,2
CC1(C2(C(O)OCC(C2O)O1)O)O,,,5,1,2,0,2
79890_0,,,,2,1,1,2
CC1(C2(C(O)OC(CO1)C2O)O)O,,,5,1,2,0,2
79892_0,,,,2,1,1,2
CC1(C2C(C(CO1)(C(O)O2)O)O)O,,,5,1,2,0,2
79894_0,,,,2,1,1,2
CC1(C2C(O)OCC1(C(O)O2)O)O,,,5,1,2,0,2
79896_0,,,,2,1,1,2
C1C(CO)(C2(C(O)OC(C2)O1)O)O,,,5,1,1,0,1
79898_0,,,,2,1,1,2
C1C2(COC(C2(CC(O)O1)O)O)O,,,5,1,2,0,2
79900_0,,,,2,1,1,2
C1(C(C2(C(O)OC(C2)O1)O)O)=O,,,5,1,1,0,1
79902_0,,,,2,1,1,2
C(C1(COC2CC1(C(O)O2)O)O)=O,,,5,1,1,0,1
79904_0,,,,2,1,1,2
C1(COC2C(CC(O)O2)(C1O)O)=O,,,5,1,1,0,1
79906_0,,,,2,1,1,2
C1(COC(C2(CC(OC12)O)O)O)=O,,,5,1,2,0,2
79908_0,,,,2,1,1,2
C12CC(C(O)O1)(C(C(CO)O2)O)O,,,5,1,1,0,1
79910_0,,,,2,1,1,2
C1C(C(C2(C(O1)OC(C2)O)O)O)O,,,5,1,1,0,1
79912_0,,,,2,1,1,2
C1C(C2C(C(O)O1)(CC(O)O2)O)O,,,5,1,2,0,2
79914_0,,,,2,1,1,2
C1(C2OCC(C1(C(O2)O)O)O)=O,,,5,1,1,0,1
79916_0,,,,2,1,1,2
C1(C(O)OC2C(O)OC(C2O)C1)=O,,,5,1,2,0,2
79918_0,,,,2,1,1,2
C(C1C2C(CC(C(O1)O)(O)O2)O)=O,,,5,1,2,0,2
79920_0,,,,2,1,1,2
C1C2(COC(CC(C2O)(O)O1)O)O,,,5,1,2,0,2
79922_0,,,,2,1,1,2
C1C2(COC(C(C(C2)(O)O1)O)O)O,,,5,1,2,0,2
79924_0,,,,2,1,1,2
C1CC2(C(C(C(CO)(O2)O1)O)O)O,,,5,1,1,0,1
79926_0,,,,2,1,1,2
C1C2(CC(C(C(CO)(O)O1)O2)O)O,,,5,1,2,0,2
79928_0,,,,2,1,1,2
C1C2(C(C(CO2)(CC(O)O1)O)O)O,,,5,1,2,0,2
79930_0,,,,2,1,1,2
C1C2(C(C(C(C(C)(O)O1)O2)O)O)O,,,5,1,2,0,2
79932_0,,,,2,1,1,2
C1C2(C(C(C)(C(C(O)O1)O2)O)O)O,,,5,1,2,0,2
79934_0,,,,2,1,1,2
C1C(C2(COC(C(O)O1)(C2)O)O)O,,,5,1,2,0,2
79936_0,,,,2,1,1,2
C1C2C(CO)(CC(C(O)O1)(O)O2)O,,,5,1,2,0,2
79938_0,,,,2,1,1,2
C12C(C)(C(C(C(CO1)O)(O)O2)O)O,,,5,1,1,0,1
79940_0,,,,2,1,1,2
C1C(C2(C(C(C(C)(O2)O1)O)O)O)O,,,5,1,1,0,1
79942_0,,,,2,1,1,2
C1C(C2(C(C(C(O2)O1)O)O)O)O,,,5,1,1,0,1
79944_0,,,,2,1,1,2
C1C2(C(O)OC(CC(O)O1)C2O)O,,,5,1,2,0,2
79946_0,,,,2,1,1,2
C1C2(CO)C(CC(C(O)O1)(O)O2)O,,,5,1,2,0,2
79948_0,,,,2,1,1,2
C(C12CC(C(CCO1)(O2)O)O)=O,,,5,1,1,0,1
79950_0,,,,2,1,1,2
C1(C2CC(C(O2)O)(O)OCC1)=O,,,5,1,2,0,2
79952_0,,,,2,1,1,2
C1(C(O)OC2C(O)OC(C2)C1)=O,,,5,1,2,0,2
79954_0,,,,2,1,1,2
C1(COC2(C(O)OC(C2)C1)O)=O,,,5,1,2,0,2
79956_0,,,,2,1,1,2
C(C1(C2COC(C(C1)(O)O2)O)O)=O,,,5,1,2,0,2
79958_0,,,,2,1,1,2
C(C12CC(C(C(CO1)O)(O2)O)O)=O,,,5,1,1,0,1
79960_0,,,,2,1,1,2
C1(C2CC(C(O2)O)(O)OCC1O)=O,,,5,1,2,0,2
79962_0,,,,2,1,1,2
C1(C2(CC(C(C(CO)O1)O2)O)O)O,,,5,1,2,0,2
79964_0,,,,2,1,1,2
C1C(C(C2CC(C(O)O2)(O)O1)O)O,,,5,1,2,0,2
79966_0,,,,2,1,1,2
C(C1C2OCCC(C1O)(O)O2)=O,,,5,1,1,0,1
79968_0,,,,2,1,1,2
C(C1C2OCC(C(C1O)(O)O2)O)=O,,,5,1,1,0,1
79970_0,,,,2,1,1,2
C1C(C2C(C(C(O)O2)C(O)O1)O)O,,,5,1,2,0,2
79972_0,,,,2,1,1,2
C1CC2(C(CC(O2)O1)O)O,,,5,1,1,0,1
79974_0,,,,2,1,1,2
C1(C2C(C(C(O2)O)(O)OCC1)O)=O,,,5,1,2,0,2
79976_0,,,,2,1,1,2
C(C12C(C(C(CCO1)(O2)O)O)O)=O,,,5,1,1,0,1
79978_0,,,,2,1,1,2
C1(C(O)OCC2(C(C1CO2)O)O)=O,,,5,1,2,0,2
79980_0,,,,2,1,1,2
C1C2C(C(CO)C(C(O)O1)(O)O2)O,,,5,1,2,0,2
79982_0,,,,2,1,1,2
C1(C(O)OC2C(O)OC(C2)C1O)=O,,,5,1,2,0,2
79984_0,,,,2,1,1,2
C1(COC2C(C(C(O)O2)C1O)O)=O,,,5,1,1,0,1
79986_0,,,,2,1,1,2
C(C1C2C(O)OCC(C1O)(O)O2)=O,,,5,1,2,0,2
79988_0,,,,2,1,1,2
C1C2C(C(C(O)O2)C(C(O)O1)O)O,,,5,1,2,0,2
79990_0,,,,2,1,1,2
C12C(C(C(O)O1)C(C(CO2)O)O)O,,,5,1,1,0,1
79992_0,,,,2,1,1,2
C(C1(C2C(CC(CO1)(O)O2)O)O)=O,,,5,1,2,0,2
79994_0,,,,2,1,1,2
C1(COC2(C(O)OC(C2O)C1)O)=O,,,5,1,2,0,2
79996_0,,,,2,1,1,2
C1C(C2(C(CC(O2)O1)O)O)O,,,5,1,1,0,1
79998_0,,,,2,1,1,2
C1C2C(C(C(C(O)O1)(O)O2)O)O,,,5,1,2,0,2
80000_0,,,,2,1,1,2
C1C2(C(O)OCCC(C2O)(O)O1)O,,,5,1,2,0,2
80002_0,,,,2,1,1,2
C12C(CO)(C(C(CCO1)(O)O2)O)O,,,5,1,1,0,1
80004_0,,,,2,1,1,2
C1C2(CC(C(C(O)O1)(CO)O2)O)O,,,5,1,2,0,2
80006_0,,,,2,1,1,2
C1(COC2CC(C(O)O2)(C1O)O)=O,,,5,1,1,0,1
80008_0,,,,2,1,1,2
C1C2C(C(C(O)O2)(CC(O)O1)O)O,,,5,1,2,0,2
80010_0,,,,2,1,1,2
C1C(C(C2(C(O)OC(C2)O1)O)O)O,,,5,1,1,0,1
80012_0,,,,2,1,1,2
C1(C(OC2C(OCC12)=O)O)=O,,,5,1,2,0,2
80014_0,,,,2,1,1,2
C(C1C2C(OC1C(O2)=O)O)=O,,,5,1,2,0,2
80016_0,,,,2,1,1,2
C1(C(C2C(C(C(O)O2)O)O1)O)=O,,,5,1,2,0,2
80018_0,,,,2,1,1,2
C1(C(C2(C(O)OCC2O1)O)O)=O,,,5,1,2,0,2
80020_0,,,,2,1,1,2
C(C1(C2C(OC1C(O2)=O)O)O)=O,,,5,1,2,0,2
80022_0,,,,2,1,1,2
C1(C2(COC(C2(CO1)O)O)O)=O,,,5,1,2,0,2
80024_0,,,,2,1,1,2
C1(C(OC2C(OCC12O)=O)O)=O,,,5,1,2,0,2
80026_0,,,,2,1,1,2
C1(C(C)(C2C(CC(O)O2)O1)O)=O,,,5,1,2,0,2
80028_0,,,,2,1,1,2
C1(C2(C)C(CO1)(CC(O2)O)O)=O,,,5,1,2,0,2
80030_0,,,,2,1,1,2
C1(C2C(CO1)(CC(O2)O)O)=O,,,5,1,2,0,2
80032_0,,,,2,1,1,2
C1(C2(C)C(C(C(C)(O2)O)O1)O)=O,,,5,1,2,0,2
80034_0,,,,2,1,1,2
C1(C2(C)C(C)(C(C(O2)O)O1)O)=O,,,5,1,2,0,2
80036_0,,,,2,1,1,2
C1(C2C(C)(C(C(O2)O)O1)O)=O,,,5,1,2,0,2
80038_0,,,,2,1,1,2
C1(C2(C(C(CO2)O1)O)O)=O,,,5,1,2,0,2
80040_0,,,,2,1,1,2
C1(C2(C(C(C(CO)O2)O1)O)O)=O,,,5,1,2,0,2
80042_0,,,,2,1,1,2
C1(C(C2C(C(C(O)O2)O1)O)O)=O,,,5,1,2,0,2
80044_0,,,,2,1,1,2
C1(C2(COC(CO1)(C2O)O)O)=O,,,5,1,2,0,2
80046_0,,,,2,1,1,2
C1(C(C)(C2CC(C(O)O2)O1)O)=O,,,5,1,2,0,2
80048_0,,,,2,1,1,2
C1(C(C2CC(C(O)O2)O1)O)=O,,,5,1,2,0,2
80050_0,,,,2,1,1,2
C1(C2(C)C(CC(CO1)(O2)O)O)=O,,,5,1,2,0,2
80052_0,,,,2,1,1,2
C1(C2(C(C(C(CO1)O2)O)O)O)=O,,,5,1,2,0,2
80054_0,,,,2,1,1,2
C(CCC1C(O)OC(C1O)=O)(O)=O,,,5,1,2,0,2
80056_0,,,,2,1,1,2
C1(C(CCC(O)=O)(CC(O)O1)O)=O,,,5,1,2,0,2
80058_0,,,,2,1,1,2
C(CCC1(C)CC(C(O)O1)=O)(O)=O,,,5,1,2,0,2
80060_0,,,,2,1,1,2
C(CCCC1CC(C(O)O1)=O)(O)=O,,,5,1,2,0,2
80062_0,,,,2,1,1,2
C(CCC1C(C(O)OC1C)=O)(O)=O,,,5,1,2,0,2
80064_0,,,,2,1,1,2
C(C(C=O)C1CCC(C=O)(O)O1)=O,,,5,1,1,0,1
80066_0,,,,2,1,1,2
C(C(C=O)C1C(C=O)CC(O)O1)=O,,,5,1,1,0,1
80068_0,,,,2,1,1,2
C(C1(C=O)COC(C1CC=O)O)=O,,,5,1,1,0,1
80070_0,,,,2,1,1,2
C(C1C(C)OC(C1CC=O)O)=O,,,5,1,1,0,1
80072_0,,,,2,1,1,2
C(CC1COC(C1C(C)O)O)(O)=O,,,5,1,1,0,1
80074_0,,,,2,1,1,2
C(CC1(C)CCC(C=O)(O)O1)=O,,,5,1,1,0,1
80076_0,,,,2,1,1,2
C(C1CC(O)OC1(C)CC=O)=O,,,5,1,1,0,1
80078_0,,,,2,1,1,2
C(CC1CC(C(O)O1)CC=O)=O,,,5,1,1,0,1
80080_0,,,,2,1,1,2
C(C1(C(C)O)CCC(C=O)(O1)O)=O,,,5,1,1,0,1
80082_0,,,,2,1,1,2
C(C1CC(OC1(C=O)C(C)O)O)=O,,,5,1,1,0,1
80084_0,,,,2,1,1,2
C(C1(C(C)OC(C1CC=O)O)O)=O,,,5,1,1,0,1
80086_0,,,,2,1,1,2
C(C(C1(C)CCC(C=O)(O)O1)O)=O,,,5,1,1,0,1
80088_0,,,,2,1,1,2
C(CC1C(OC(C=O)C1(C)O)O)=O,,,5,1,1,0,1
80090_0,,,,2,1,1,2
C(C1CC(O)OC1(C)C(C=O)O)=O,,,5,1,1,0,1
80092_0,,,,2,1,1,2
C(CC1C(O)OC(C1)C(C=O)O)=O,,,5,1,1,0,1
80094_0,,,,2,1,1,2
C(CC1CCC(C=O)(O)O1)=O,,,5,1,1,0,1
80096_0,,,,2,1,1,2
C(C1C(CC=O)OC(C1)O)=O,,,5,1,1,0,1
80098_0,,,,2,1,1,2
C(C1COC(C1CC=O)O)=O,,,5,1,1,0,1
80100_0,,,,2,1,1,2
C(CC1COC(C1CO)O)(O)=O,,,5,1,1,0,1
80102_0,,,,2,1,1,2
C(CC(C1CCC(C=O)(O)O1)O)=O,,,5,1,1,0,1
80104_0,,,,2,1,1,2
C(C(CCC1C(CC(O)O1)O)=O)=O,,,5,1,2,0,2
80106_0,,,,2,1,1,2
C(C1C(C(CC=O)O)OC(C1)O)=O,,,5,1,1,0,1
80108_0,,,,2,1,1,2
C(C(C1C(CC(O)O1)O)CC=O)=O,,,5,1,2,0,2
80110_0,,,,2,1,1,2
C(CC1C(C(C(O)O1)CC=O)O)=O,,,5,1,1,0,1
80112_0,,,,2,1,1,2
C(CCC1C(CC(O)O1)O)(O)=O,,,5,1,2,0,2
80114_0,,,,2,1,1,2
C(C(CCC1(COC(C1)O)O)=O)=O,,,5,1,2,0,2
80116_0,,,,2,1,1,2
C(CC1(CO)CCC(C=O)(O)O1)=O,,,5,1,1,0,1
80118_0,,,,2,1,1,2
C(CC1(COC(C1CC=O)O)O)=O,,,5,1,1,0,1
80119_0,,,,2,1,1,2
80121_0,,,,2,1,1,2
C(C1CC(O)OC1(CO)CC=O)=O,,,5,1,1,0,1
80123_0,,,,2,1,1,2
C(CCC1(COC(C1)O)O)(O)=O,,,5,1,2,0,2
80125_0,,,,2,1,1,2
C(C(CCC1C(O)OCC1O)=O)=O,,,5,1,2,0,2
80127_0,,,,2,1,1,2
C(C(C1C(O)OCC1O)CC=O)=O,,,5,1,2,0,2
80129_0,,,,2,1,1,2
C(C1C(CO)OC(C1CC=O)O)=O,,,5,1,1,0,1
80131_0,,,,2,1,1,2
C(CCC1C(O)OCC1O)(O)=O,,,5,1,2,0,2
80132_0,,,,2,1,1,2
80134_0,,,,2,1,1,2
C(CCC1(C(COC1O)=O)O)(O)=O,,,5,1,2,0,2
80136_0,,,,2,1,1,2
C(C1(CCC(C(C(C)=O)=O)O1)O)=O,,,5,1,1,0,1
80138_0,,,,2,1,1,2
C(C1CC(OC1C(C(C)=O)=O)O)=O,,,5,1,1,0,1
80140_0,,,,2,1,1,2
C(CC1CC(C(C=O)=O)OC1O)=O,,,5,1,1,0,1
80142_0,,,,2,1,1,2
C(C1(CCC(C(C=O)=O)(C)O1)O)=O,,,5,1,1,0,1
80144_0,,,,2,1,1,2
C(C1CC(OC1(C(C=O)=O)C)O)=O,,,5,1,1,0,1
80146_0,,,,2,1,1,2
C(C1(C=O)CCC(C=O)(O1)O)=O,,,5,1,1,0,1
80148_0,,,,2,1,1,2
C(C1(C=O)C(C=O)CC(O1)O)=O,,,5,1,1,0,1
80150_0,,,,2,1,1,2
C(C1(C(O)OCC1CC(O)=O)O)=O,,,5,1,1,0,1
80152_0,,,,2,1,1,2
C(C1(CCC(C(C)=O)O1)O)=O,,,5,1,1,0,1
80154_0,,,,2,1,1,2
C(C1CC(OC1C(C)=O)O)=O,,,5,1,1,0,1
80156_0,,,,2,1,1,2
C(CC1COC(C)(C1O)O)(O)=O,,,5,1,1,0,1
80158_0,,,,2,1,1,2
C(CC1COC(CO)(C1)O)(O)=O,,,5,1,1,0,1
80160_0,,,,2,1,1,2
C(C1CCC(C=O)(O1)O)(CCO)=O,,,5,1,1,0,1
80162_0,,,,2,1,1,2
C(C1CC(OC1C(CCO)=O)O)=O,,,5,1,1,0,1
80164_0,,,,2,1,1,2
C(C1(CCC(CC(CO)=O)O1)O)=O,,,5,1,1,0,1
80166_0,,,,2,1,1,2
C(C1C(CC(CO)=O)OC(C1)O)=O,,,5,1,1,0,1
80168_0,,,,2,1,1,2
C(CC1C(O)OCC1C(CO)=O)=O,,,5,1,1,0,1
80170_0,,,,2,1,1,2
C(C(CCC1(C(O)OCC1)O)=O)=O,,,5,1,2,0,2
80172_0,,,,2,1,1,2
C(C1(CCO)CCC(C=O)(O1)O)=O,,,5,1,1,0,1
80173_0,,,,2,1,1,2
80175_0,,,,2,1,1,2
C(C1CC(OC1(C=O)CCO)O)=O,,,5,1,1,0,1
80177_0,,,,2,1,1,2
C(CCC1(C(O)OCC1)O)(O)=O,,,5,1,2,0,2
80179_0,,,,2,1,1,2
C(C(CC1CCC(C=O)(O)O1)O)=O,,,5,1,1,0,1
80181_0,,,,2,1,1,2
C(C(CCC1CC(C(O)O1)O)=O)=O,,,5,1,2,0,2
80183_0,,,,2,1,1,2
C(C1C(CC(C=O)O)OC(C1)O)=O,,,5,1,1,0,1
80185_0,,,,2,1,1,2
C(C(C1CC(C(O)O1)O)CC=O)=O,,,5,1,2,0,2
80187_0,,,,2,1,1,2
C(CCC1CC(C(O)O1)O)(O)=O,,,5,1,2,0,2
80189_0,,,,2,1,1,2
C(C(CCC1COC(C1O)O)=O)=O,,,5,1,2,0,2
80191_0,,,,2,1,1,2
C(CC1C(O)OCC1C(C=O)O)=O,,,5,1,1,0,1
80193_0,,,,2,1,1,2
C(C(C1COC(C1O)O)CC=O)=O,,,5,1,2,0,2
80195_0,,,,2,1,1,2
C(CC1C(OC(C=O)C1CO)O)=O,,,5,1,1,0,1
80197_0,,,,2,1,1,2
C(CCC1COC(C1O)O)(O)=O,,,5,1,2,0,2
80199_0,,,,2,1,1,2
C(C1(CCC(C(C)=O)(CO)O1)O)=O,,,5,1,1,0,1
80201_0,,,,2,1,1,2
C(CC1C(O)OCC1(C(C)=O)O)=O,,,5,1,1,0,1
80203_0,,,,2,1,1,2
C(C1CC(OC1(C(C)=O)CO)O)=O,,,5,1,1,0,1
80205_0,,,,2,1,1,2
C(C1(CCC(C(C(C)=O)O)O1)O)=O,,,5,1,1,0,1
80207_0,,,,2,1,1,2
C(C1C(C(C(C)=O)O)OC(C1)O)=O,,,5,1,1,0,1
80209_0,,,,2,1,1,2
C(CC1C(C(C(C)=O)OC1O)O)=O,,,5,1,1,0,1
80211_0,,,,2,1,1,2
C(C1(CCC(C)O1)O)=O,,,5,1,1,0,1
80213_0,,,,2,1,1,2
C(C1C(C)OC(C1)O)=O,,,5,1,1,0,1
80215_0,,,,2,1,1,2
C(CC1C(O)OCC1)=O,,,5,1,1,0,1
80217_0,,,,2,1,1,2
C(CC1COC(C(O)=O)(C1)O)(O)=O,,,5,1,1,0,1
80219_0,,,,2,1,1,2
C1(C(C=O)C(C(O)O1)CC=O)=O,,,5,1,1,0,1
80221_0,,,,2,1,1,2
C(C1C(O)OCC1CC(O)=O)(O)=O,,,5,1,1,0,1
80223_0,,,,2,1,1,2
C1(CC(CCC(O)=O)(C(O)O1)O)=O,,,5,1,2,0,2
80225_0,,,,2,1,1,2
C1(C(CCC(O)=O)C(C(O)O1)O)=O,,,5,1,2,0,2
80227_0,,,,2,1,1,2
C1(CC(C(O)O1)CC=O)=O,,,5,1,1,0,1
80229_0,,,,2,1,1,2
C(C1(CCC(C(C(O)=O)=O)O1)O)=O,,,5,1,1,0,1
80231_0,,,,2,1,1,2
C(C1CC(OC1C(C(O)=O)=O)O)=O,,,5,1,1,0,1
80233_0,,,,2,1,1,2
C(CCC1C(OC(C1=O)O)=O)(O)=O,,,5,1,2,0,2
80235_0,,,,2,1,1,2
C(CCC1C(C(OC1O)=O)=O)(O)=O,,,5,1,2,0,2
80237_0,,,,2,1,1,2
C(CC1C(OC2C(COC12)=O)O)=O,,,5,1,1,0,1
80239_0,,,,2,1,1,2
C(C1(CCC2(C(COC2)=O)O1)O)=O,,,5,1,1,0,1
80241_0,,,,2,1,1,2
C(C1CC(OC21C(COC2)=O)O)=O,,,5,1,1,0,1
80243_0,,,,2,1,1,2
C1(C2(CCC(C=O)(O2)O)OCC1)=O,,,5,1,1,0,1
80245_0,,,,2,1,1,2
C(C1CC(OC21C(CCO2)=O)O)=O,,,5,1,1,0,1
80247_0,,,,2,1,1,2
C1(C2C(CO1)OC(C2CC=O)O)=O,,,5,1,1,0,1
80249_0,,,,2,1,1,2
C1(CC2C(C(C(O)O2)CC=O)O1)=O,,,5,1,1,0,1
80251_0,,,,2,1,1,2
C1(CC2(CO1)CCC(C=O)(O)O2)=O,,,5,1,1,0,1
80253_0,,,,2,1,1,2
C(C1CC(O)OC21COC(C2)=O)=O,,,5,1,1,0,1
80255_0,,,,2,1,1,2
C(CC1C(O)OC2C1C(CO2)=O)=O,,,5,1,1,0,1
80257_0,,,,2,1,1,2
C(C1(CCC2(CC(CO2)=O)O1)O)=O,,,5,1,1,0,1
80259_0,,,,2,1,1,2
C(C1C2(CC(CO2)=O)OC(C1)O)=O,,,5,1,1,0,1
80261_0,,,,2,1,1,2
C(C1(CCC(C=CC(O)=O)O1)O)=O,,,5,1,1,0,1
80263_0,,,,2,1,1,2
C(C1(C=C)CCC(C=O)(O1)O)(O)=O,,,5,1,1,0,1
80265_0,,,,2,1,1,2
C1(C2(CCO1)CCC(C=O)(O2)O)=O,,,5,1,1,0,1
80267_0,,,,2,1,1,2
C(C1(CCC(C=O)(O1)O)O)=O,,,5,1,1,0,1
80269_0,,,,2,1,1,2
C(C1(C)CCC(C=O)(O1)O)=O,,,5,1,1,0,1
80271_0,,,,2,1,1,2
C(C1(CC[C](C(O)=O)O1)O)=O,,,5,1,1,0,1
80273_0,,,,2,1,1,2
C(C1(CO)CCC(C=O)(O1)O)=O,,,5,1,1,0,1
80275_0,,,,2,1,1,2
C(C(C1CCC(C=O)(O)O1)O)=O,,,5,1,1,0,1
80277_0,,,,2,1,1,2
C(C1(CCCO1)O)=O,,,5,1,1,0,1
80279_0,,,,2,1,1,2
C(C1(CCC(CO)O1)O)=O,,,5,1,1,0,1
80281_0,,,,2,1,1,2
C(C1CCC(C=O)(O1)O)(O)=O,,,5,1,1,0,1
80283_0,,,,2,1,1,2
C(C1(CCC(C(CO)=O)O1)O)=O,,,5,1,1,0,1
80285_0,,,,2,1,1,2
C(C1(CCC(CO)(CO)O1)O)=O,,,5,1,1,0,1
80287_0,,,,2,1,1,2
C(C1(CCC(C(CO)O)O1)O)=O,,,5,1,1,0,1
80289_0,,,,2,1,1,2
C(C1(CO)CCC(C=O)(O1)O)(O)=O,,,5,1,1,0,1
80291_0,,,,2,1,1,2
C(C(C1CCC(C=O)(O)O1)O)(O)=O,,,5,1,1,0,1
80292_0,,,,2,1,1,2
80294_0,,,,2,1,1,2
C(C1(CCC(CC(C=O)=O)O1)O)=O,,,5,1,1,0,1
80295_0,,,,2,1,1,2
80297_0,,,,2,1,1,2
C(C1(CCC(C=O)(O1)O)CC=O)=O,,,5,1,1,0,1
80298_0,,,,2,1,1,2
80299_0,,,,2,1,1,2
80301_0,,,,2,1,1,2
C(C1CCC(C=O)(O1)O)(CC=O)=O,,,5,1,1,0,1
80303_0,,,,2,1,1,2
C(C1(CCC(C=O)(C(C)=O)O1)O)=O,,,5,1,1,0,1
80305_0,,,,2,1,1,2
C(C1(C)CCC(C=O)(O1)O)(O)=O,,,5,1,1,0,1
80307_0,,,,2,1,1,2
C(C1(CCC(C(C=O)=O)O1)O)=O,,,5,1,1,0,1
80309_0,,,,2,1,1,2
C(C1CC(OC1C=CC(O)=O)O)=O,,,5,1,1,0,1
80311_0,,,,2,1,1,2
C(C1(C=C)C(C=O)CC(O1)O)(O)=O,,,5,1,1,0,1
80313_0,,,,2,1,1,2
C1(C(C=C)(C(C(O)O1)CC=O)O)=O,,,5,1,1,0,1
80315_0,,,,2,1,1,2
C(C1CC(OC21C(OCC2)=O)O)=O,,,5,1,1,0,1
80317_0,,,,2,1,1,2
C(CC1C(OC2C(OCC12)=O)O)=O,,,5,1,1,0,1
80319_0,,,,2,1,1,2
C(C1CC(OC1(C=O)O)O)=O,,,5,1,1,0,1
80321_0,,,,2,1,1,2
C(C1CC(OC1(C=O)C)O)=O,,,5,1,1,0,1
80323_0,,,,2,1,1,2
C(CC1CC(C=O)OC1O)=O,,,5,1,1,0,1
80325_0,,,,2,1,1,2
C(C1[C](C(O)=O)OC(C1)O)=O,,,5,1,1,0,1
80327_0,,,,2,1,1,2
C(CC1[C](C(OC1O)=O)O)=O,,,5,1,1,0,1
80329_0,,,,2,1,1,2
C(CC1C(C(C=O)OC1O)O)=O,,,5,1,1,0,1
80331_0,,,,2,1,1,2
C(C1C(C(C=O)O)OC(C1)O)=O,,,5,1,1,0,1
80333_0,,,,2,1,1,2
C(CC1C(O)OCC1(CO)O)=O,,,5,1,1,0,1
80335_0,,,,2,1,1,2
C(C1CC(O)OC1(CO)CO)=O,,,5,1,1,0,1
80337_0,,,,2,1,1,2
C(C1CC(O)OC1C(CO)O)=O,,,5,1,1,0,1
80339_0,,,,2,1,1,2
C(CC1C(O)OC(CO)C1O)=O,,,5,1,1,0,1
80341_0,,,,2,1,1,2
C1(C(CO)(C(C(O)O1)CC=O)O)=O,,,5,1,1,0,1
80343_0,,,,2,1,1,2
C(C1CC(OC1(C(O)=O)CO)O)=O,,,5,1,1,0,1
80345_0,,,,2,1,1,2
C(C1(COC(C1CC=O)O)O)(O)=O,,,5,1,1,0,1
80347_0,,,,2,1,1,2
C(CC1C(C(C(O)=O)OC1O)O)=O,,,5,1,1,0,1
80349_0,,,,2,1,1,2
C(C1C(C(C(O)=O)O)OC(C1)O)=O,,,5,1,1,0,1
80350_0,,,,2,1,1,2
80352_0,,,,2,1,1,2
C(C1C(CC(C=O)=O)OC(C1)O)=O,,,5,1,1,0,1
80353_0,,,,2,1,1,2
80355_0,,,,2,1,1,2
C(CC1C(O)OCC1C(C=O)=O)=O,,,5,1,1,0,1
80357_0,,,,2,1,1,2
C(CC1(C=O)C(C=O)CC(O1)O)=O,,,5,1,1,0,1
80359_0,,,,2,1,1,2
C(CC1C(OC(C=O)C1C=O)O)=O,,,5,1,1,0,1
80360_0,,,,2,1,1,2
80361_0,,,,2,1,1,2
80363_0,,,,2,1,1,2
C(C1CC(OC1C(CC=O)=O)O)=O,,,5,1,1,0,1
80365_0,,,,2,1,1,2
C(C1CC(OC1(C=O)C(C)=O)O)=O,,,5,1,1,0,1
80367_0,,,,2,1,1,2
C(CC1CC(C(O)=O)OC1O)=O,,,5,1,1,0,1
80368_0,,,,2,1,1,2
80369_0,,,,2,1,1,2
80370_0,,,,2,1,1,2
80371_0,,,,2,1,1,2
80372_0,,,,2,1,1,2
80373_0,,,,2,1,1,2
80374_0,,,,2,1,1,2
80375_0,,,,2,1,1,2
80376_0,,,,2,1,1,2
80378_0,,,,2,1,1,2
C(CC1COC(C1(O)O)O)(O)=O,,,5,1,1,0,1
80380_0,,,,2,1,1,2
C(CC1COC(C1(C)O)O)(O)=O,,,5,1,1,0,1
80382_0,,,,2,1,1,2
C(CC1COC(C1(CO)O)O)(O)=O,,,5,1,1,0,1
80384_0,,,,2,1,1,2
C(CC1COC(CO)(C1O)O)(O)=O,,,5,1,1,0,1
80386_0,,,,2,1,1,2
C(CC1COC(C=O)(C1)O)(O)=O,,,5,1,1,0,1
80388_0,,,,2,1,1,2
C(C1C(O)OCC1CC(O)=O)=O,,,5,1,1,0,1
80390_0,,,,2,1,1,2
C(CC1COC(C1)O)(O)=O,,,5,1,1,0,1
80392_0,,,,2,1,1,2
C(CC1COC(C=O)(C1O)O)(O)=O,,,5,1,1,0,1
80394_0,,,,2,1,1,2
C(CC1COC(C1O)O)(O)=O,,,5,1,1,0,1
80396_0,,,,2,1,1,2
C1(C(C(C(CO)(O)O1)O)=O)=O,,,5,1,1,0,1
80397_0,,,,2,1,1,2
80399_0,,,,2,1,1,2
C1(C(C(C(C(CO)O)(O)O1)O)=O)=O,,,5,1,1,0,1
80401_0,,,,2,1,1,2
C1(C(C(C(O)=O)(OC1CO)O)O)=O,,,5,1,1,0,1
80403_0,,,,2,1,1,2
C(C1C(C(OC1O)=O)=O)=O,,,5,1,1,0,1
80405_0,,,,2,1,1,2
C1(COC(C1C(C(O)=O)=O)O)=O,,,5,1,2,0,2
80407_0,,,,2,1,1,2
C(C1C(COC1(C(O)=O)O)=O)=O,,,5,1,1,0,1
80409_0,,,,2,1,1,2
C(CO)(C1C(C(OC1O)=O)=O)=O,,,5,1,1,0,1
80411_0,,,,2,1,1,2
C(C1C(C(OC1(CO)O)=O)=O)=O,,,5,1,1,0,1
80413_0,,,,2,1,1,2
C1(CC(OC1C(C(O)=O)=O)O)=O,,,5,1,2,0,2
80415_0,,,,2,1,1,2
C(CC1(C(C(C(O1)=O)=O)O)O)=O,,,5,1,1,0,1
80417_0,,,,2,1,1,2
C(C1C(CC(C(O)=O)(O1)O)=O)=O,,,5,1,1,0,1
80419_0,,,,2,1,1,2
C(C(C1(CC(C(O1)=O)=O)O)O)=O,,,5,1,1,0,1
80421_0,,,,2,1,1,2
C(C1(C(C(C(O1)=O)=O)O)O)=O,,,5,1,1,0,1
80423_0,,,,2,1,1,2
C1(C(C(CO)(C(CO)(O)O1)O)=O)=O,,,5,1,1,0,1
80425_0,,,,2,1,1,2
C1(COC(C(O)=O)(C1(CO)O)O)=O,,,5,1,1,0,1
80427_0,,,,2,1,1,2
C(C)(C1(C(C(OC1O)=O)=O)O)=O,,,5,1,1,0,1
80429_0,,,,2,1,1,2
C(C1(C(C(OC1(C)O)=O)=O)O)=O,,,5,1,1,0,1
80431_0,,,,2,1,1,2
C1(C(O)OCC1(C(C(O)=O)=O)O)=O,,,5,1,2,0,2
80433_0,,,,2,1,1,2
C(C1(C(C(C(O1)=O)=O)(CO)O)O)=O,,,5,1,1,0,1
80435_0,,,,2,1,1,2
C(CC1(C(C(OC1O)=O)=O)O)=O,,,5,1,1,0,1
80437_0,,,,2,1,1,2
C(C1(CCOC1(C(O)=O)O)O)(O)=O,,,5,1,1,0,1
80439_0,,,,2,1,1,2
C1(C(C(C)(C(O)O1)O)=O)=O,,,5,1,1,0,1
80441_0,,,,2,1,1,2
C1(C(C(C(O)O1)(CCO)O)=O)=O,,,5,1,1,0,1
80443_0,,,,2,1,1,2
C(C1(CCOC1(C(O)=O)O)O)=O,,,5,1,1,0,1
80445_0,,,,2,1,1,2
C(C(C1(C(O)OCC1)O)=O)(O)=O,,,5,1,2,0,2
80447_0,,,,2,1,1,2
C(C(C1CC(C(O1)O)O)=O)(O)=O,,,5,1,2,0,2
80449_0,,,,2,1,1,2
C(C1CC(C(C(O)=O)(O1)O)O)=O,,,5,1,1,0,1
80451_0,,,,2,1,1,2
C(C(C1(COC(C1)O)O)=O)(O)=O,,,5,1,2,0,2
80453_0,,,,2,1,1,2
C1(C(CC(CO)(CO)O1)O)O,,,5,1,1,0,1
80455_0,,,,2,1,1,2
C1(C(CC(CO)(C(CO)O)O1)O)O,,,5,1,1,0,1
80457_0,,,,2,1,1,2
C(C1CC(C)(C(O1)O)O)=O,,,5,1,1,0,1
80459_0,,,,2,1,1,2
C(C1(C)CC(C(O1)O)O)=O,,,5,1,1,0,1
80461_0,,,,2,1,1,2
C(C1CC(C(C)(O1)O)O)=O,,,5,1,1,0,1
80463_0,,,,2,1,1,2
C(C)(C1CC(C(O1)O)O)=O,,,5,1,1,0,1
80465_0,,,,2,1,1,2
C(C1CC(C(O1)O)(CCO)O)=O,,,5,1,1,0,1
80466_0,,,,2,1,1,2
80468_0,,,,2,1,1,2
C(C1(CCO)CC(C(O1)O)O)=O,,,5,1,1,0,1
80470_0,,,,2,1,1,2
C(C1CC(C(CCO)(O1)O)O)=O,,,5,1,1,0,1
80472_0,,,,2,1,1,2
C(C1CC(C(O1)O)O)(CCO)=O,,,5,1,1,0,1
80474_0,,,,2,1,1,2
C(C(CC1C(CC(O)O1)O)O)=O,,,5,1,2,0,2
80476_0,,,,2,1,1,2
C(CC(C1CC(C(O)O1)O)O)=O,,,5,1,1,0,1
80478_0,,,,2,1,1,2
C(C(CC1CC(C(O)O1)O)O)=O,,,5,1,2,0,2
80480_0,,,,2,1,1,2
C(C(C1(C)CC(C(O)O1)O)O)=O,,,5,1,1,0,1
80482_0,,,,2,1,1,2
CC1CC(C(O)O1)O,,,5,1,1,0,1
80484_0,,,,2,1,1,2
C(C1CC(C(O1)O)(C(CO)O)O)=O,,,5,1,1,0,1
80485_0,,,,2,1,1,2
80487_0,,,,2,1,1,2
C(C1(C(CO)O)CC(C(O1)O)O)=O,,,5,1,1,0,1
80489_0,,,,2,1,1,2
C(C(C(C1CC(C(O)O1)O)O)O)O,,,5,1,1,0,1
80491_0,,,,2,1,1,2
C(C1CC(C(O)O1)O)O,,,5,1,1,0,1
80493_0,,,,2,1,1,2
[C]1(C(OC(C1)O)=O)O,,,5,1,1,0,1
80494_0,,,,2,1,1,2
80494_1,,,,2,1,1,2
80496_0,,,,2,1,1,2
C1CC2(C(C(C(C2O)O)(O)O1)O)O,,,5,1,2,0,2
80496_1,,,,2,1,1,2
80498_0,,,,2,1,1,2
C1C(C2(CC(C(C2O)O)(O)O1)O)O,,,5,1,2,0,2
80498_1,,,,2,1,1,2
80500_0,,,,2,1,1,2
C1C2(C(C(C(C(O)O1)C2O)O)O)O,,,5,1,2,0,2
80500_1,,,,2,1,1,2
80501_0,,,,2,1,1,2
80501_1,,,,2,1,1,2
80502_0,,,,2,1,1,2
80502_1,,,,2,1,1,2
80503_0,,,,2,1,1,2
80503_1,,,,2,1,1,2
80504_0,,,,2,1,1,2
80504_1,,,,2,1,1,2
80505_0,,,,2,1,1,2
80506_0,,,,2,1,1,2
80506_1,,,,2,1,1,2
80507_0,,,,2,1,1,2
80508_0,,,,2,1,1,2
80509_0,,,,2,1,1,2
80509_1,,,,2,1,1,2
80510_0,,,,2,1,1,2
80510_1,,,,2,1,1,2
80511_0,,,,2,1,1,2
80511_1,,,,2,1,1,2
80512_0,,,,2,1,1,2
80512_1,,,,2,1,1,2
80513_0,,,,2,1,1,2
80514_0,,,,2,1,1,2
80514_1,,,,2,1,1,2
80516_0,,,,2,1,1,2
C1C(C2(C(C(CC2O)(O)O1)O)O)O,,,5,1,2,0,2
80516_1,,,,2,1,1,2
80517_0,,,,2,1,1,2
80518_0,,,,2,1,1,2
80518_1,,,,2,1,1,2
80520_0,,,,2,1,1,2
C1C2(C(C(C(CC2O)(O)O1)O)O)O,,,5,1,1,0,1
80521_0,,,,2,1,1,2
80521_1,,,,2,1,1,2
80522_0,,,,2,1,1,2
80523_0,,,,2,1,1,2
80525_0,,,,2,1,1,2
C(C1(CO)CC(CC(O)O1)O)O,,,5,1,1,0,1
80527_0,,,,2,1,1,2
C1(C(C(CC(CO)(CO)O1)O)O)O,,,5,1,1,0,1
80528_0,,,,2,1,1,2
80530_0,,,,2,1,1,2
C(C1COC(CO)(C(C1O)O)O)=O,,,5,1,1,0,1
80532_0,,,,2,1,1,2
CC1C(C(CO)(CC(O)O1)O)O,,,5,1,1,0,1
80534_0,,,,2,1,1,2
CC1C(C(CO)(C(C(O)O1)O)O)O,,,5,1,1,0,1
80535_0,,,,2,1,1,2
80536_0,,,,2,1,1,2
80538_0,,,,2,1,1,2
C(C1C(C(CO)(CC(O1)O)O)O)=O,,,5,1,1,0,1
80539_0,,,,2,1,1,2
80540_0,,,,2,1,1,2
80541_0,,,,2,1,1,2
80543_0,,,,2,1,1,2
C1C(C(CC(O)O1)(C(CO)O)O)O,,,5,1,1,0,1
80545_0,,,,2,1,1,2
C(C1(CC(C(O)=O)OC(C1)O)O)=O,,,5,1,1,0,1
80546_0,,,,2,1,1,2
80547_0,,,,2,1,1,2
80548_0,,,,2,1,1,2
80549_0,,,,2,1,1,2
80551_0,,,,2,1,1,2
C(C1CC(C(CO)C(O1)O)O)(O)=O,,,5,1,1,0,1
80553_0,,,,2,1,1,2
C(C1CC(C(C(C)(O1)O)O)O)(O)=O,,,5,1,1,0,1
80555_0,,,,2,1,1,2
C(C1CC(CC(CO)(O1)O)O)(O)=O,,,5,1,1,0,1
80556_0,,,,2,1,1,2
80557_0,,,,2,1,1,2
80558_0,,,,2,1,1,2
80559_0,,,,2,1,1,2
80561_0,,,,2,1,1,2
C(C(C1C(O)OCCC1O)O)(O)=O,,,5,1,1,0,1
80563_0,,,,2,1,1,2
C(C1C(C)(C(O)OC(C1O)=O)O)=O,,,5,1,1,0,1
80565_0,,,,2,1,1,2
C(C1C(C(C)(O)OC(C1O)=O)O)=O,,,5,1,1,0,1
80566_0,,,,2,1,1,2
80568_0,,,,2,1,1,2
C(C1(CC(C=O)(C)OC(C1)O)O)=O,,,5,1,1,0,1
80570_0,,,,2,1,1,2
C(CC1C(CC(C)(C(O1)O)O)=O)=O,,,5,1,1,0,1
80572_0,,,,2,1,1,2
C(CC1C(C)(CC(C(O)O1)=O)O)=O,,,5,1,1,0,1
80574_0,,,,2,1,1,2
C(C1C(CC(OC1(C=O)C)O)O)=O,,,5,1,1,0,1
80576_0,,,,2,1,1,2
C(C1(C)CC(C(CO)C(O1)O)O)=O,,,5,1,1,0,1
80578_0,,,,2,1,1,2
C(C)(C1C(CC(C)(C(O1)O)O)O)=O,,,5,1,1,0,1
80580_0,,,,2,1,1,2
C(C1(C)CC(C(C(C)(O1)O)O)O)=O,,,5,1,1,0,1
80582_0,,,,2,1,1,2
C(C1(C)CC(CC(CO)(O1)O)O)=O,,,5,1,1,0,1
80584_0,,,,2,1,1,2
C(C1(C)CC(CC(C=O)(O1)O)O)=O,,,5,1,1,0,1
80586_0,,,,2,1,1,2
C(C1C(OC(C=O)(C)CC1O)O)=O,,,5,1,1,0,1
80588_0,,,,2,1,1,2
C(C1(C)CC(CC(O1)O)O)=O,,,5,1,1,0,1
80590_0,,,,2,1,1,2
C(C1C(CC(C)(C(O1)O)O)O)=O,,,5,1,1,0,1
80592_0,,,,2,1,1,2
C(C1(C)CC(C(C(O1)O)O)O)=O,,,5,1,1,0,1
80594_0,,,,2,1,1,2
C(C)(C1C(C(C)(CC(O1)O)O)O)=O,,,5,1,1,0,1
80596_0,,,,2,1,1,2
C(CC1(C)C(CC(C(O)O1)=O)O)=O,,,5,1,1,0,1
80598_0,,,,2,1,1,2
C(C1C(C(C)(CC(O1)O)O)O)=O,,,5,1,1,0,1
80600_0,,,,2,1,1,2
C(C(C)(C1C(O)OCCC1O)O)=O,,,5,1,1,0,1
80602_0,,,,2,1,1,2
C(C1C(COC(C1(C)O)O)(C)O)=O,,,5,1,1,0,1
80604_0,,,,2,1,1,2
C(C1C(C(O)OC(C1(C)O)O)O)=O,,,5,1,1,0,1
80606_0,,,,2,1,1,2
C(C1C(C(C)OC(C1(C)O)O)O)=O,,,5,1,1,0,1
80608_0,,,,2,1,1,2
C(C1C(COC(C1(C)O)O)O)=O,,,5,1,1,0,1
80610_0,,,,2,1,1,2
C(C1(C)C(C(CC(O1)O)O)O)=O,,,5,1,1,0,1
80611_0,,,,2,1,1,2
80612_0,,,,2,1,1,2
80614_0,,,,2,1,1,2
C(C1C(C)(C(CC(O1)O)O)O)=O,,,5,1,1,0,1
80616_0,,,,2,1,1,2
C(C1C(C(C)(C(C(O1)O)O)O)O)=O,,,5,1,1,0,1
80617_0,,,,2,1,1,2
80619_0,,,,2,1,1,2
C(C1(CC(C(C)=O)OC(C1)O)O)=O,,,5,1,1,0,1
80621_0,,,,2,1,1,2
C(CC1C(CC(C(C)(O1)O)O)=O)=O,,,5,1,1,0,1
80623_0,,,,2,1,1,2
C(C1C(CC(OC1C(C)=O)O)O)=O,,,5,1,1,0,1
80625_0,,,,2,1,1,2
C(C)(C1CC(C(CO)C(O1)O)O)=O,,,5,1,1,0,1
80627_0,,,,2,1,1,2
C(C)(C1C(CC(C(C)(O1)O)O)O)=O,,,5,1,1,0,1
80629_0,,,,2,1,1,2
C(C)(C1CC(C(C(C)(O1)O)O)O)=O,,,5,1,1,0,1
80631_0,,,,2,1,1,2
C(C)(C1CC(CC(CO)(O1)O)O)=O,,,5,1,1,0,1
80633_0,,,,2,1,1,2
C(C1(CC(CC(C(C)=O)O1)O)O)=O,,,5,1,1,0,1
80635_0,,,,2,1,1,2
C(C1C(OC(C(C)=O)CC1O)O)=O,,,5,1,1,0,1
80637_0,,,,2,1,1,2
C(C)(C1CC(CC(O1)O)O)=O,,,5,1,1,0,1
80639_0,,,,2,1,1,2
C(C1C(CC(C(C)(O1)O)O)O)=O,,,5,1,1,0,1
80641_0,,,,2,1,1,2
C(C)(C1CC(C(C(O1)O)O)O)=O,,,5,1,1,0,1
80643_0,,,,2,1,1,2
C(C)(C1C(C)(C(CC(O1)O)O)O)=O,,,5,1,1,0,1
80645_0,,,,2,1,1,2
C(C)(C(C1C(O)OCCC1O)O)=O,,,5,1,1,0,1
80647_0,,,,2,1,1,2
C(C1C(C(C)(O)OCC1(C)O)O)=O,,,5,1,1,0,1
80649_0,,,,2,1,1,2
C(C1C(C(O)OC(C)(C1O)O)O)=O,,,5,1,1,0,1
80651_0,,,,2,1,1,2
C(C1C(C(C)(O)OC(C)C1O)O)=O,,,5,1,1,0,1
80653_0,,,,2,1,1,2
C(C1C(COC(C)(C1O)O)O)=O,,,5,1,1,0,1
80655_0,,,,2,1,1,2
C(CC(C1(CC(CCO1)O)O)O)=O,,,5,1,1,0,1
80657_0,,,,2,1,1,2
C(CC1C(CC(C(O1)O)O)=O)=O,,,5,1,1,0,1
80658_0,,,,2,1,1,2
80659_0,,,,2,1,1,2
80660_0,,,,2,1,1,2
80661_0,,,,2,1,1,2
80663_0,,,,2,1,1,2
C(CC1CC(CC(C=O)(O)O1)O)=O,,,5,1,1,0,1
80665_0,,,,2,1,1,2
C(C(CC1CC(CC(O)O1)O)=O)=O,,,5,1,1,0,1
80667_0,,,,2,1,1,2
C(C1(CC(CC(O1)O)O)CC=O)=O,,,5,1,1,0,1
80669_0,,,,2,1,1,2
C(C1(CC(O)OC(C1)CC=O)O)=O,,,5,1,1,0,1
80671_0,,,,2,1,1,2
C1(C(C=O)C(CC(C=O)(O)O1)O)=O,,,5,1,1,0,1
80673_0,,,,2,1,1,2
C(C1C(CC(C=O)(O)OC1C)O)=O,,,5,1,1,0,1
80674_0,,,,2,1,1,2
80676_0,,,,2,1,1,2
C1(C(C(C=O)=O)C(CC(O)O1)O)=O,,,5,1,1,0,1
80678_0,,,,2,1,1,2
C(C(C1C(C)OC(CC1O)O)=O)=O,,,5,1,1,0,1
80680_0,,,,2,1,1,2
C(C1(CC(C)OC(C1CO)O)O)=O,,,5,1,1,0,1
80682_0,,,,2,1,1,2
C(C1(C(C(C)(O)OC(C)C1)O)O)=O,,,5,1,1,0,1
80684_0,,,,2,1,1,2
C1(COC(C(CC(C)O)(C1)O)O)=O,,,5,1,1,0,1
80686_0,,,,2,1,1,2
C(C1(CC(CO)(O)OC(C)C1)O)=O,,,5,1,1,0,1
80688_0,,,,2,1,1,2
C(C1(CC(C=O)(O)OC(C)C1)O)=O,,,5,1,1,0,1
80690_0,,,,2,1,1,2
C(C1C(O)OC(C)CC1(C=O)O)=O,,,5,1,1,0,1
80692_0,,,,2,1,1,2
C(C1(CC(O)OC(C)C1)O)=O,,,5,1,1,0,1
80694_0,,,,2,1,1,2
C(C1(C(C(O)OC(C)C1)O)O)=O,,,5,1,1,0,1
80696_0,,,,2,1,1,2
C1(COC(C(C1)O)(CC(C)O)O)=O,,,5,1,1,0,1
80698_0,,,,2,1,1,2
C(C1(C(C(CCO1)O)C(C)O)O)=O,,,5,1,1,0,1
80700_0,,,,2,1,1,2
C1(C(O)OCC(C)(C1C(C)O)O)=O,,,5,1,1,0,1
80702_0,,,,2,1,1,2
C1(C(O)OC(C(C1C(C)O)O)O)=O,,,5,1,1,0,1
80704_0,,,,2,1,1,2
C1(C(O)OC(C)C(C1C(C)O)O)=O,,,5,1,1,0,1
80705_0,,,,2,1,1,2
80707_0,,,,2,1,1,2
C(C1(CC(C=O)OC(C1)O)O)=O,,,5,1,1,0,1
80709_0,,,,2,1,1,2
C(C1(CC(C(OC1C=O)O)O)O)=O,,,5,1,1,0,1
80711_0,,,,2,1,1,2
C(C1(CC(C=O)OC(C1O)O)O)=O,,,5,1,1,0,1
80713_0,,,,2,1,1,2
C(C(C1C(C(O)OCC1O)O)=O)=O,,,5,1,1,0,1
80714_0,,,,2,1,1,2
80715_0,,,,2,1,1,2
80717_0,,,,2,1,1,2
C(C1(CC(O)OC(CO)C1)O)=O,,,5,1,1,0,1
80718_0,,,,2,1,1,2
80720_0,,,,2,1,1,2
C(C1(C(C(O)OC(CO)C1)O)O)=O,,,5,1,1,0,1
80721_0,,,,2,1,1,2
80722_0,,,,2,1,1,2
80724_0,,,,2,1,1,2
C(C1C(CC=O)OC(CC1O)O)=O,,,5,1,1,0,1
80726_0,,,,2,1,1,2
C(C1C(O)OC(CC1O)CC=O)=O,,,5,1,1,0,1
80728_0,,,,2,1,1,2
C(C(C=O)C1CC(CC(O)O1)O)=O,,,5,1,1,0,1
80730_0,,,,2,1,1,2
C1(C(C=O)C(C(C=O)C(O)O1)O)=O,,,5,1,1,0,1
80732_0,,,,2,1,1,2
C(C1C(O)OC(C)C(C=O)C1O)=O,,,5,1,1,0,1
80733_0,,,,2,1,1,2
80735_0,,,,2,1,1,2
C(C(CO)C1CC(CC(O)O1)O)=O,,,5,1,1,0,1
80737_0,,,,2,1,1,2
C(CC1CC(C(C(O)O1)CO)O)=O,,,5,1,1,0,1
80739_0,,,,2,1,1,2
C(C)(C(C1CC(CC(O)O1)O)O)=O,,,5,1,1,0,1
80741_0,,,,2,1,1,2
C(CC1CC(C(C(C)(O)O1)O)O)=O,,,5,1,1,0,1
80743_0,,,,2,1,1,2
C(CO)(CC1CC(CC(O)O1)O)=O,,,5,1,1,0,1
80745_0,,,,2,1,1,2
C(CC1CC(CC(CO)(O)O1)O)=O,,,5,1,1,0,1
80747_0,,,,2,1,1,2
C(CC1CC(CC(O)O1)O)=O,,,5,1,1,0,1
80749_0,,,,2,1,1,2
C(C(C1CC(CC(O)O1)O)O)=O,,,5,1,1,0,1
80751_0,,,,2,1,1,2
C(CC1CC(C(C(O)O1)O)O)=O,,,5,1,1,0,1
80753_0,,,,2,1,1,2
C(CC(C1C(O)OCCC1O)O)=O,,,5,1,1,0,1
80755_0,,,,2,1,1,2
C(C1C(CCO)OC(CC1O)O)=O,,,5,1,1,0,1
80757_0,,,,2,1,1,2
C(C1C(CC(O)OC1(C)CO)O)=O,,,5,1,1,0,1
80758_0,,,,2,1,1,2
80760_0,,,,2,1,1,2
C(C1C(C(O)O)OC(CC1O)O)=O,,,5,1,1,0,1
80762_0,,,,2,1,1,2
C(C1C(C(C)O)OC(CC1O)O)=O,,,5,1,1,0,1
80764_0,,,,2,1,1,2
C(C1C(C)OC(CC1O)O)=O,,,5,1,1,0,1
80765_0,,,,2,1,1,2
80766_0,,,,2,1,1,2
80768_0,,,,2,1,1,2
C(C1COC(C=O)(C(C1O)O)O)=O,,,5,1,1,0,1
80769_0,,,,2,1,1,2
80770_0,,,,2,1,1,2
80771_0,,,,2,1,1,2
80773_0,,,,2,1,1,2
C(C(C1CC(C(C(O)O1)O)O)O)=O,,,5,1,1,0,1
80775_0,,,,2,1,1,2
C1(C(C=O)C(C(C(O)O1)O)O)=O,,,5,1,1,0,1
80777_0,,,,2,1,1,2
C(C1C(C(C=O)OC(C1O)O)O)=O,,,5,1,1,0,1
80779_0,,,,2,1,1,2
C(C1C(C(C(OC1C=O)O)O)O)=O,,,5,1,1,0,1
80781_0,,,,2,1,1,2
C(C1C(C)OC(C(C1O)O)O)=O,,,5,1,1,0,1
80782_0,,,,2,1,1,2
80784_0,,,,2,1,1,2
C(C1C(CO)OC(C(C1O)O)O)=O,,,5,1,1,0,1
80786_0,,,,2,1,1,2
C(C1COC(C(C1O)C(C)O)O)=O,,,5,1,1,0,1
80788_0,,,,2,1,1,2
C(C1C(C)OC(C(CO)C1O)O)=O,,,5,1,1,0,1
80790_0,,,,2,1,1,2
C(C1C(C)OC(C)(C(C1O)O)O)=O,,,5,1,1,0,1
80792_0,,,,2,1,1,2
C(C1C(C)OC(CO)(CC1O)O)=O,,,5,1,1,0,1
80794_0,,,,2,1,1,2
C(C1COC(C(CO)C1O)O)=O,,,5,1,1,0,1
80796_0,,,,2,1,1,2
C(C1COC(C)(C(C1O)O)O)=O,,,5,1,1,0,1
80798_0,,,,2,1,1,2
C(C1COC(CO)(CC1O)O)=O,,,5,1,1,0,1
80800_0,,,,2,1,1,2
C(C1COC(C(O)=O)(CC1O)O)=O,,,5,1,1,0,1
80802_0,,,,2,1,1,2
C1(C(C=O)C(C(CO)C(O)O1)O)=O,,,5,1,1,0,1
80804_0,,,,2,1,1,2
C(C1C(O)OCC(C=O)C1O)(O)=O,,,5,1,1,0,1
80806_0,,,,2,1,1,2
C(C1(CCO)CC(CC(O1)O)O)=O,,,5,1,1,0,1
80807_0,,,,2,1,1,2
80808_0,,,,2,1,1,2
80810_0,,,,2,1,1,2
C(C1(CCOC(C1C(C)O)O)O)=O,,,5,1,1,0,1
80811_0,,,,2,1,1,2
80813_0,,,,2,1,1,2
C(C1CC(CC(O1)O)O)(CCO)=O,,,5,1,1,0,1
80815_0,,,,2,1,1,2
C(C1(CC(O)OC(C)C1CO)O)=O,,,5,1,1,0,1
80817_0,,,,2,1,1,2
C(C1(CC(O)OCC1C(C)O)O)=O,,,5,1,1,0,1
80819_0,,,,2,1,1,2
C(C1(CC(O)OCC1CO)O)=O,,,5,1,1,0,1
80821_0,,,,2,1,1,2
C(C1(C(C(O)OCC1CO)O)O)=O,,,5,1,1,0,1
80822_0,,,,2,1,1,2
80824_0,,,,2,1,1,2
C(C(CC1CC(CC(O)O1)O)O)=O,,,5,1,1,0,1
80825_0,,,,2,1,1,2
80827_0,,,,2,1,1,2
C(C1CC(C(C(O1)O)C(C)O)O)=O,,,5,1,1,0,1
80828_0,,,,2,1,1,2
80830_0,,,,2,1,1,2
C(C1C(C(CC(O1)O)O)C(C)O)=O,,,5,1,1,0,1
80832_0,,,,2,1,1,2
C(C(C1C(CC(O)OC1C)O)O)=O,,,5,1,1,0,1
80833_0,,,,2,1,1,2
80835_0,,,,2,1,1,2
C(C(C1COC(CC1O)O)O)=O,,,5,1,2,0,2
80837_0,,,,2,1,1,2
C(C1C(C(CO)C(C(O1)O)O)O)=O,,,5,1,1,0,1
80839_0,,,,2,1,1,2
C(C1C(CO)C(C(C(O1)O)O)O)=O,,,5,1,1,0,1
80841_0,,,,2,1,1,2
C(C(C1COC(C(C1O)O)O)O)=O,,,5,1,1,0,1
80843_0,,,,2,1,1,2
C(CC1(CO)CC(CC(O)O1)O)=O,,,5,1,1,0,1
80845_0,,,,2,1,1,2
C(CC1CC(CO)(CC(O)O1)O)=O,,,5,1,1,0,1
80847_0,,,,2,1,1,2
C1(C(C=O)C(CC(CO)(O)O1)O)=O,,,5,1,1,0,1
80849_0,,,,2,1,1,2
C1(C(C(CO)=O)C(CC(O)O1)O)=O,,,5,1,1,0,1
80851_0,,,,2,1,1,2
C(CO)(C1C(C)OC(CC1O)O)=O,,,5,1,1,0,1
80852_0,,,,2,1,1,2
80854_0,,,,2,1,1,2
C(CO)(C1COC(C(C1O)O)O)=O,,,5,1,1,0,1
80856_0,,,,2,1,1,2
C1(C(C=O)C(CO)(CC(O)O1)O)=O,,,5,1,1,0,1
80858_0,,,,2,1,1,2
C(C1C(C)OC(CC1(CO)O)O)=O,,,5,1,1,0,1
80860_0,,,,2,1,1,2
C(C1COC(CC1(CO)O)O)=O,,,5,1,1,0,1
80862_0,,,,2,1,1,2
C(C1COC(C(C1(CO)O)O)O)=O,,,5,1,1,0,1
80864_0,,,,2,1,1,2
C1(C(C(C(C(O)O1)C(C)O)=O)O)=O,,,5,1,1,0,1
80865_0,,,,2,1,1,2
80866_0,,,,2,1,1,2
80867_0,,,,2,1,1,2
80868_0,,,,2,1,1,2
80870_0,,,,2,1,1,2
C1(C(C(C(CO)C(O)O1)=O)O)=O,,,5,1,1,0,1
80871_0,,,,2,1,1,2
80872_0,,,,2,1,1,2
80873_0,,,,2,1,1,2
80874_0,,,,2,1,1,2
80875_0,,,,2,1,1,2
80876_0,,,,2,1,1,2
80877_0,,,,2,1,1,2
80879_0,,,,2,1,1,2
C(CC1(C(C(O)OCC1O)O)O)=O,,,5,1,1,0,1
80880_0,,,,2,1,1,2
80881_0,,,,2,1,1,2
80883_0,,,,2,1,1,2
C(CC1(C)C(C(CC(O)O1)O)O)=O,,,5,1,1,0,1
80885_0,,,,2,1,1,2
C(CC1C(C(C)(CC(O)O1)O)O)=O,,,5,1,1,0,1
80887_0,,,,2,1,1,2
C1(C(C=O)C(C(C(C)(O)O1)O)O)=O,,,5,1,1,0,1
80889_0,,,,2,1,1,2
C(CC1CC(C)(C(C(O)O1)O)O)=O,,,5,1,1,0,1
80891_0,,,,2,1,1,2
C(C(C1(C)CC(CC(O)O1)O)O)=O,,,5,1,1,0,1
80893_0,,,,2,1,1,2
C1(C(C=O)C(C)(C(C(O)O1)O)O)=O,,,5,1,1,0,1
80895_0,,,,2,1,1,2
C(C1C(C)OC(C(C1(C)O)O)O)=O,,,5,1,1,0,1
80897_0,,,,2,1,1,2
C(C1COC(C(C1(C)O)O)O)=O,,,5,1,1,0,1
80899_0,,,,2,1,1,2
C(C(C1(CC(C)OC(C1)O)O)O)=O,,,5,1,1,0,1
80900_0,,,,2,1,1,2
80901_0,,,,2,1,1,2
80903_0,,,,2,1,1,2
C1(C(C(C(C(O)O1)O)=O)C(C)O)=O,,,5,1,1,0,1
80904_0,,,,2,1,1,2
80905_0,,,,2,1,1,2
80906_0,,,,2,1,1,2
80907_0,,,,2,1,1,2
80908_0,,,,2,1,1,2
80909_0,,,,2,1,1,2
80911_0,,,,2,1,1,2
C(C(C1(CC(O)OCC1)O)O)=O,,,5,1,1,0,1
80912_0,,,,2,1,1,2
80913_0,,,,2,1,1,2
80914_0,,,,2,1,1,2
80916_0,,,,2,1,1,2
C1(C(C(C(C(O)O1)O)=O)CO)=O,,,5,1,1,0,1
80917_0,,,,2,1,1,2
80918_0,,,,2,1,1,2
80919_0,,,,2,1,1,2
80921_0,,,,2,1,1,2
CC(C1C(O)OC(C)CC1O)O,,,5,1,1,0,1
80923_0,,,,2,1,1,2
CC1CC(C(C(O)O1)CO)O,,,5,1,1,0,1
80925_0,,,,2,1,1,2
CC1CC(C(C(O)O1)C(CO)O)O,,,5,1,1,0,1
80927_0,,,,2,1,1,2
C(C)(C1(C(C(CC(C)O1)O)O)O)=O,,,5,1,1,0,1
80929_0,,,,2,1,1,2
C(CO)(C1(CC(CC(C)O1)O)O)=O,,,5,1,1,0,1
80931_0,,,,2,1,1,2
CC1(C(C(CC(C)O1)O)O)O,,,5,1,1,0,1
80933_0,,,,2,1,1,2
CC1CC(CC(CO)(O)O1)O,,,5,1,1,0,1
80935_0,,,,2,1,1,2
CC1CC(C(C(CCO)(O)O1)O)O,,,5,1,1,0,1
80937_0,,,,2,1,1,2
CC1CC(C(CO)C(CO)(O)O1)O,,,5,1,1,0,1
80939_0,,,,2,1,1,2
CC1CC(CC(C(CO)O)(O)O1)O,,,5,1,1,0,1
80941_0,,,,2,1,1,2
C(C1(CC(CC(C)O1)O)O)(O)=O,,,5,1,1,0,1
80943_0,,,,2,1,1,2
C(C1C(O)OC(C)CC1O)(O)=O,,,5,1,1,0,1
80945_0,,,,2,1,1,2
C(C1(C(C(CC(C)O1)O)O)O)(O)=O,,,5,1,1,0,1
80947_0,,,,2,1,1,2
C(C1C(CC(C)OC1(C=O)O)O)=O,,,5,1,1,0,1
80949_0,,,,2,1,1,2
C(C(C1C(O)OC(C)CC1O)=O)=O,,,5,1,1,0,1
80951_0,,,,2,1,1,2
C1C(C2(C(C(CC(C)O2)O)O1)O)O,,,5,1,1,0,1
80953_0,,,,2,1,1,2
CC1CC(C2COC(C2(O)O1)O)O,,,5,1,1,0,1
80955_0,,,,2,1,1,2
C1C2(C(C(O)O1)C(CC(C)O2)O)O,,,5,1,1,0,1
80957_0,,,,2,1,1,2
CC1CC(C2C(CC(O)O2)(O)O1)O,,,5,1,1,0,1
80959_0,,,,2,1,1,2
C1(C(C(O)OC(CC(C)O)C1)=O)=O,,,5,1,1,0,1
80961_0,,,,2,1,1,2
C(C(C1(CC(CC(C)O1)O)O)=O)=O,,,5,1,1,0,1
80963_0,,,,2,1,1,2
CC1CC(C(C(CO)(O)O1)O)O,,,5,1,1,0,1
80965_0,,,,2,1,1,2
C(C1(CC(CC(C)O1)O)O)=O,,,5,1,1,0,1
80967_0,,,,2,1,1,2
C(C1C(O)OC(C)CC1O)=O,,,5,1,1,0,1
80969_0,,,,2,1,1,2
C(C1(C(CO)C(CC(C)O1)O)O)=O,,,5,1,1,0,1
80971_0,,,,2,1,1,2
C(C(C1C(O)OC(C)CC1O)O)=O,,,5,1,1,0,1
80973_0,,,,2,1,1,2
C(CO)(C1C(O)OC(C)CC1O)=O,,,5,1,1,0,1
80975_0,,,,2,1,1,2
C(C1C(CO)(O)OC(C)CC1O)=O,,,5,1,1,0,1
80977_0,,,,2,1,1,2
C1(C(C(CC(C)O)OC(C1)O)O)=O,,,5,1,1,0,1
80979_0,,,,2,1,1,2
C(CC1(C(C(CC(C)O1)O)O)O)=O,,,5,1,1,0,1
80981_0,,,,2,1,1,2
C1(C(C(O)OC(CC(C)O)C1)O)=O,,,5,1,1,0,1
80983_0,,,,2,1,1,2
C(C(C1(CC(CC(C)O1)O)O)O)=O,,,5,1,1,0,1
80985_0,,,,2,1,1,2
CC1CC(CC(O)O1)O,,,5,1,1,0,1
80987_0,,,,2,1,1,2
C(C1(C(C(CC(C)O1)O)O)O)=O,,,5,1,1,0,1
80989_0,,,,2,1,1,2
CC1CC(C(C(O)O1)O)O,,,5,1,1,0,1
80991_0,,,,2,1,1,2
CC(C1C(O)OC(C)C(C1O)O)O,,,5,1,1,0,1
80993_0,,,,2,1,1,2
CC(C1C(O)OCCC1O)O,,,5,1,1,0,1
80995_0,,,,2,1,1,2
CC(C1C(O)OC(CO)CC1O)O,,,5,1,1,0,1
80997_0,,,,2,1,1,2
C1(COC(C(C(C)O)C1(C)O)O)=O,,,5,1,1,0,1
80999_0,,,,2,1,1,2
C1(C(C)OC(C(C(C)O)C1O)O)=O,,,5,1,1,0,1
81001_0,,,,2,1,1,2
CC(C1C(O)OCCC1(CO)O)O,,,5,1,1,0,1
81003_0,,,,2,1,1,2
CC1(C(COC(C1C(C)O)O)O)O,,,5,1,1,0,1
81005_0,,,,2,1,1,2
C1(CC(C(C(O)O1)C(C)O)O)=O,,,5,1,1,0,1
81007_0,,,,2,1,1,2
C(C1C(C)OC(CC1(C=O)O)O)=O,,,5,1,1,0,1
81009_0,,,,2,1,1,2
C1C2(CC(O1)OC(C2C(C)O)O)O,,,5,1,1,0,1
81011_0,,,,2,1,1,2
C(C1C(C)OC(C(C1O)=O)(C)O)=O,,,5,1,1,0,1
81013_0,,,,2,1,1,2
C(C1C(C)OC(C(C1(C)O)=O)O)=O,,,5,1,1,0,1
81015_0,,,,2,1,1,2
C1C(C(C(C(O)O1)C(C)O)O)O,,,5,1,1,0,1
81017_0,,,,2,1,1,2
C1(COC(C(C(C)O)C1O)O)=O,,,5,1,1,0,1
81019_0,,,,2,1,1,2
C(C1(CC(O)OC(C)C1O)O)=O,,,5,1,1,0,1
81021_0,,,,2,1,1,2
C(C1(C(C(O)OC(C)C1O)O)O)=O,,,5,1,1,0,1
81022_0,,,,2,1,1,2
81024_0,,,,2,1,1,2
CC1C(C(C(C(O)O1)CO)O)O,,,5,1,1,0,1
81026_0,,,,2,1,1,2
CC1(C(C(C(C(C)O1)O)O)O)O,,,5,1,1,0,1
81028_0,,,,2,1,1,2
CC1C(C(CC(CO)(O)O1)O)O,,,5,1,1,0,1
81030_0,,,,2,1,1,2
C(C1(CC(C(C(C)O1)O)O)O)(O)=O,,,5,1,1,0,1
81032_0,,,,2,1,1,2
C(C1C(O)OC(C)C(C1O)O)(O)=O,,,5,1,1,0,1
81034_0,,,,2,1,1,2
CC1C(C(C(C(CO)(O)O1)O)O)O,,,5,1,1,0,1
81036_0,,,,2,1,1,2
C1(C(O)OC(C(C1)O)C(C)O)=O,,,5,1,1,0,1
81038_0,,,,2,1,1,2
C(C1(CC(C(C(C)O1)O)O)O)=O,,,5,1,1,0,1
81040_0,,,,2,1,1,2
C(C1C(O)OC(C)C(C1O)O)=O,,,5,1,1,0,1
81042_0,,,,2,1,1,2
CC1C(C(CC(O)O1)O)O,,,5,1,1,0,1
81044_0,,,,2,1,1,2
C1(C(O)OC(C(C1O)O)C(C)O)=O,,,5,1,1,0,1
81046_0,,,,2,1,1,2
C(C1(C(C(C(C(C)O1)O)O)O)O)=O,,,5,1,1,0,1
81047_0,,,,2,1,1,2
81048_0,,,,2,1,1,2
81049_0,,,,2,1,1,2
81051_0,,,,2,1,1,2
C(C1C(CC(CO)(C(O1)O)O)O)=O,,,5,1,1,0,1
81052_0,,,,2,1,1,2
81054_0,,,,2,1,1,2
C(C1C(COC(C1(CO)O)O)O)=O,,,5,1,1,0,1
81056_0,,,,2,1,1,2
C(CO)(C1CC(CC(O1)O)O)=O,,,5,1,1,0,1
81058_0,,,,2,1,1,2
C(C1C(CC(C(CO)(O1)O)O)O)=O,,,5,1,1,0,1
81060_0,,,,2,1,1,2
C(CO)(C1CC(C(C(O1)O)O)O)=O,,,5,1,1,0,1
81061_0,,,,2,1,1,2
81062_0,,,,2,1,1,2
81064_0,,,,2,1,1,2
C(CC1C(C(C(C(O1)O)O)O)=O)=O,,,5,1,1,0,1
81065_0,,,,2,1,1,2
81066_0,,,,2,1,1,2
81067_0,,,,2,1,1,2
81069_0,,,,2,1,1,2
C(C1C(COC(CO)(C1O)O)O)=O,,,5,1,1,0,1
81070_0,,,,2,1,1,2
81071_0,,,,2,1,1,2
81072_0,,,,2,1,1,2
81074_0,,,,2,1,1,2
C(C(C1CC(CC(O)O1)O)O)O,,,5,1,1,0,1
81076_0,,,,2,1,1,2
C(C(C1CC(C(C(O)O1)O)O)O)O,,,5,1,1,0,1
81077_0,,,,2,1,1,2
81078_0,,,,2,1,1,2
81079_0,,,,2,1,1,2
81080_0,,,,2,1,1,2
81082_0,,,,2,1,1,2
C1CC(C(C(O)O1)CO)O,,,5,1,1,0,1
81084_0,,,,2,1,1,2
C1CC(C(C(O)O1)C(CO)O)O,,,5,1,1,0,1
81086_0,,,,2,1,1,2
C1(C(C(CCO)OC(C1O)O)O)=O,,,5,1,1,0,1
81088_0,,,,2,1,1,2
C(C(C1(C(C(CCO1)O)O)O)O)=O,,,5,1,1,0,1
81090_0,,,,2,1,1,2
C(C)(C1(C(C(CCO1)O)O)O)=O,,,5,1,1,0,1
81092_0,,,,2,1,1,2
C(CO)(C1(CC(CCO1)O)O)=O,,,5,1,1,0,1
81094_0,,,,2,1,1,2
CC1(C(C(CCO1)O)O)O,,,5,1,1,0,1
81096_0,,,,2,1,1,2
C1CC(CC(CO)(O)O1)O,,,5,1,1,0,1
81098_0,,,,2,1,1,2
C1CC(C(C(CCO)(O)O1)O)O,,,5,1,1,0,1
81100_0,,,,2,1,1,2
C1CC(C(CO)C(CO)(O)O1)O,,,5,1,1,0,1
81102_0,,,,2,1,1,2
C1CC(CC(C(CO)O)(O)O1)O,,,5,1,1,0,1
81104_0,,,,2,1,1,2
C(C1(CC(CCO1)O)O)(O)=O,,,5,1,1,0,1
81106_0,,,,2,1,1,2
C(C1C(O)OCCC1O)(O)=O,,,5,1,1,0,1
81108_0,,,,2,1,1,2
C(C1(C(CO)C(CCO1)O)O)(O)=O,,,5,1,1,0,1
81110_0,,,,2,1,1,2
C(C1C(CO)(O)OCCC1O)(O)=O,,,5,1,1,0,1
81112_0,,,,2,1,1,2
C(CC1(C(C(CCO1)O)O)O)(O)=O,,,5,1,1,0,1
81114_0,,,,2,1,1,2
C(C(C1(CC(CCO1)O)O)O)(O)=O,,,5,1,1,0,1
81116_0,,,,2,1,1,2
C(C1(C(C(CCO1)O)O)O)(O)=O,,,5,1,1,0,1
81118_0,,,,2,1,1,2
C(C1C(CCOC1(C=O)O)O)=O,,,5,1,1,0,1
81120_0,,,,2,1,1,2
C(C(C1C(O)OCCC1O)=O)=O,,,5,1,1,0,1
81122_0,,,,2,1,1,2
C(C1C(CCOC1(C=O)O)O)(O)=O,,,5,1,1,0,1
81124_0,,,,2,1,1,2
C(C(C1C(O)OCCC1O)=O)(O)=O,,,5,1,1,0,1
81126_0,,,,2,1,1,2
C(C1C(CCOC1(C(O)=O)O)O)=O,,,5,1,1,0,1
81128_0,,,,2,1,1,2
C1C(C2(C(C(CCO2)O)O1)O)O,,,5,1,1,0,1
81130_0,,,,2,1,1,2
C1C2C(C(O)O1)(O)OCCC2O,,,5,1,1,0,1
81132_0,,,,2,1,1,2
C1C2(C(C(O)O1)C(CCO2)O)O,,,5,1,1,0,1
81134_0,,,,2,1,1,2
C1CC(C2C(CC(O)O2)(O)O1)O,,,5,1,1,0,1
81136_0,,,,2,1,1,2
C1(C(C(O)OC(CCO)C1)=O)=O,,,5,1,1,0,1
81138_0,,,,2,1,1,2
C(C(C1(CC(CCO1)O)O)=O)=O,,,5,1,1,0,1
81140_0,,,,2,1,1,2
C1CC(C(C(CO)(O)O1)O)O,,,5,1,1,0,1
81142_0,,,,2,1,1,2
C1CC(C(C(C(CO)O)(O)O1)O)O,,,5,1,1,0,1
81144_0,,,,2,1,1,2
C(C1(CC(CCO1)O)O)=O,,,5,1,1,0,1
81146_0,,,,2,1,1,2
C(C1C(O)OCCC1O)=O,,,5,1,1,0,1
81148_0,,,,2,1,1,2
C(C1(C(CO)C(CCO1)O)O)=O,,,5,1,1,0,1
81150_0,,,,2,1,1,2
C(C(C1C(O)OCCC1O)O)=O,,,5,1,1,0,1
81152_0,,,,2,1,1,2
C(CO)(C1C(O)OCCC1O)=O,,,5,1,1,0,1
81154_0,,,,2,1,1,2
C(C1C(CO)(O)OCCC1O)=O,,,5,1,1,0,1
81155_0,,,,2,1,1,2
81157_0,,,,2,1,1,2
C(CC1(C(C(CCO1)O)O)O)=O,,,5,1,1,0,1
81158_0,,,,2,1,1,2
81160_0,,,,2,1,1,2
C(C(C1(CC(CCO1)O)O)O)=O,,,5,1,1,0,1
81162_0,,,,2,1,1,2
C1CC(CC(O)O1)O,,,5,1,1,0,1
81164_0,,,,2,1,1,2
C(C1(C(C(CCO1)O)O)O)=O,,,5,1,1,0,1
81166_0,,,,2,1,1,2
C1CC(C(C(O)O1)O)O,,,5,1,1,0,1
81168_0,,,,2,1,1,2
C1(C(CO)C(CC(CO)O1)O)O,,,5,1,1,0,1
81170_0,,,,2,1,1,2
C(C1C(C(C(C(O1)O)CO)O)=O)=O,,,5,1,1,0,1
81172_0,,,,2,1,1,2
C(C1COC(C(C1(C=O)O)O)O)=O,,,5,1,1,0,1
81174_0,,,,2,1,1,2
C1(COC(C(CO)C1(C)O)O)=O,,,5,1,1,0,1
81176_0,,,,2,1,1,2
C1(C(C)OC(C(CO)C1O)O)=O,,,5,1,1,0,1
81178_0,,,,2,1,1,2
C1CC(CO)(C(C(O)O1)CO)O,,,5,1,1,0,1
81180_0,,,,2,1,1,2
CC1(C(COC(C1CO)O)O)O,,,5,1,1,0,1
81182_0,,,,2,1,1,2
C1(CC(C(CO)C(O)O1)O)=O,,,5,1,1,0,1
81184_0,,,,2,1,1,2
C(C1(CCOC(C1CO)O)O)(O)=O,,,5,1,1,0,1
81186_0,,,,2,1,1,2
C1(CC(CO)(C(CO)C(O)O1)O)=O,,,5,1,1,0,1
81188_0,,,,2,1,1,2
C1(C(C(C)(C(CO)C(O)O1)O)O)=O,,,5,1,1,0,1
81189_0,,,,2,1,1,2
81191_0,,,,2,1,1,2
C(C1(C(CO)C(O)OC(C1)=O)O)=O,,,5,1,1,0,1
81193_0,,,,2,1,1,2
C(C1COC(CC1(C(O)=O)O)O)=O,,,5,1,1,0,1
81195_0,,,,2,1,1,2
C1C2(CC(O1)OC(C2CO)O)O,,,5,1,1,0,1
81197_0,,,,2,1,1,2
C(C1COC(C(C1O)=O)(C)O)=O,,,5,1,1,0,1
81199_0,,,,2,1,1,2
C(C1COC(C(C1(C)O)=O)O)=O,,,5,1,1,0,1
81201_0,,,,2,1,1,2
CC1(C(C(CC(CO)O1)O)O)O,,,5,1,1,0,1
81203_0,,,,2,1,1,2
C(C1(CC(CC(CO)O1)O)O)O,,,5,1,1,0,1
81205_0,,,,2,1,1,2
C(C1(CC(CC(CO)O1)O)O)(O)=O,,,5,1,1,0,1
81207_0,,,,2,1,1,2
C(C1C(O)OC(CO)CC1O)(O)=O,,,5,1,1,0,1
81208_0,,,,2,1,1,2
81209_0,,,,2,1,1,2
81210_0,,,,2,1,1,2
81211_0,,,,2,1,1,2
81212_0,,,,2,1,1,2
81213_0,,,,2,1,1,2
81215_0,,,,2,1,1,2
C1(CC(C(C(O)O1)C(CO)O)O)=O,,,5,1,1,0,1
81217_0,,,,2,1,1,2
C(C1C(COC(C1(C=C)O)O)O)=O,,,5,1,1,0,1
81219_0,,,,2,1,1,2
C(C1C(C(C=C)(O)OCC1O)O)=O,,,5,1,1,0,1
81221_0,,,,2,1,1,2
C(C1(C(C(C=O)OC(C1)O)O)O)=O,,,5,1,1,0,1
81223_0,,,,2,1,1,2
C1(C(OC(C(C=O)=O)C(C1)O)O)=O,,,5,1,2,0,2
81225_0,,,,2,1,1,2
C(C1C(C(C(C(O1)O)=O)O)O)=O,,,5,1,1,0,1
81226_0,,,,2,1,1,2
81228_0,,,,2,1,1,2
C(C1C(C(C(C(C)(O1)O)O)O)=O)=O,,,5,1,1,0,1
81230_0,,,,2,1,1,2
C(C(C1(C(CC(CO1)=O)O)O)O)=O,,,5,1,1,0,1
81232_0,,,,2,1,1,2
C(C1C(C(CC(CO)(O1)O)O)=O)=O,,,5,1,1,0,1
81234_0,,,,2,1,1,2
C1(C(CC(C=O)(OC1C=O)O)O)=O,,,5,1,1,0,1
81236_0,,,,2,1,1,2
C(C1C(OC(C=O)C(C1O)=O)O)=O,,,5,1,1,0,1
81237_0,,,,2,1,1,2
81239_0,,,,2,1,1,2
C1(C(C(C=O)OC(C1O)O)O)=O,,,5,1,1,0,1
81241_0,,,,2,1,1,2
C(C1C(C(C(C(O1)O)O)O)=O)=O,,,5,1,1,0,1
81243_0,,,,2,1,1,2
C(C(C1(C(OCC(C1)=O)O)O)O)=O,,,5,1,1,0,1
81245_0,,,,2,1,1,2
C(C1C(C=O)(CC(C(O)O1)=O)O)=O,,,5,1,1,0,1
81247_0,,,,2,1,1,2
C(C(C1(COC(C(C1)=O)O)O)O)=O,,,5,1,1,0,1
81249_0,,,,2,1,1,2
C(C1C(CO)(CC(C(O1)O)=O)O)=O,,,5,1,1,0,1
81250_0,,,,2,1,1,2
81252_0,,,,2,1,1,2
C1(C(C(CO)(C)OC(C1O)O)O)=O,,,5,1,1,0,1
81253_0,,,,2,1,1,2
81255_0,,,,2,1,1,2
C1(C(C(C(O)O)OC(C1O)O)O)=O,,,5,1,1,0,1
81257_0,,,,2,1,1,2
C1(C(C(C(C)O)OC(C1O)O)O)=O,,,5,1,1,0,1
81259_0,,,,2,1,1,2
C1(C(C(C(O)=O)OC(C1O)O)O)=O,,,5,1,1,0,1
81261_0,,,,2,1,1,2
C(C1C(C(C(C(O1)O)(C)O)O)=O)=O,,,5,1,1,0,1
81263_0,,,,2,1,1,2
C(C1(C)C(C(C(C(O1)O)O)=O)O)=O,,,5,1,1,0,1
81264_0,,,,2,1,1,2
81266_0,,,,2,1,1,2
C1(C(C(C)OC(C1O)O)O)=O,,,5,1,1,0,1
81267_0,,,,2,1,1,2
81268_0,,,,2,1,1,2
81270_0,,,,2,1,1,2
C1(C(C(C(CO)(C(O)O1)O)=O)O)=O,,,5,1,1,0,1
81272_0,,,,2,1,1,2
C1(C(C(C)OC(C1(CO)O)O)O)=O,,,5,1,1,0,1
81273_0,,,,2,1,1,2
81274_0,,,,2,1,1,2
81276_0,,,,2,1,1,2
C1(COC(C)(C(CO)(C1)O)O)=O,,,5,1,1,0,1
81278_0,,,,2,1,1,2
C1(C(CC(CO)(C(C)(O)O1)O)=O)=O,,,5,1,1,0,1
81279_0,,,,2,1,1,2
81280_0,,,,2,1,1,2
81282_0,,,,2,1,1,2
C(C)(C1(COC(C(C1O)=O)O)O)=O,,,5,1,1,0,1
81284_0,,,,2,1,1,2
C1(COC(C)(C(C1(C)O)O)O)=O,,,5,1,1,0,1
81286_0,,,,2,1,1,2
C1(COC(CO)(C(C)(C1)O)O)=O,,,5,1,1,0,1
81288_0,,,,2,1,1,2
C1(COC(CO)(CC1(C)O)O)=O,,,5,1,1,0,1
81290_0,,,,2,1,1,2
C1(C(CC(C)(C(CO)(O)O1)O)=O)=O,,,5,1,1,0,1
81292_0,,,,2,1,1,2
C(C1(CC(C(CO1)=O)(C)O)O)(O)=O,,,5,1,1,0,1
81294_0,,,,2,1,1,2
C(C1C(OCC(C1(C)O)=O)O)(O)=O,,,5,1,1,0,1
81296_0,,,,2,1,1,2
C1(COC(CO)(C(C)(C1O)O)O)=O,,,5,1,1,0,1
81298_0,,,,2,1,1,2
C1(COC(CO)(C(C1(C)O)O)O)=O,,,5,1,1,0,1
81300_0,,,,2,1,1,2
C(C1(CC(C(CO1)=O)(C)O)O)=O,,,5,1,1,0,1
81302_0,,,,2,1,1,2
C(C1C(OCC(C1(C)O)=O)O)=O,,,5,1,1,0,1
81304_0,,,,2,1,1,2
C1(COC(CC1(C)O)O)=O,,,5,1,1,0,1
81306_0,,,,2,1,1,2
C(C1(C(C(C(CO1)=O)(C)O)O)O)=O,,,5,1,1,0,1
81308_0,,,,2,1,1,2
C1(COC(C(C1(C)O)O)O)=O,,,5,1,1,0,1
81310_0,,,,2,1,1,2
C(C1C(C(C(C(C)(O1)O)=O)O)O)=O,,,5,1,1,0,1
81312_0,,,,2,1,1,2
C1(C(C)(O)OCC(C)(C1O)O)=O,,,5,1,1,0,1
81314_0,,,,2,1,1,2
C1(C(C)(C(C(C(C)(O)O1)=O)O)O)=O,,,5,1,1,0,1
81316_0,,,,2,1,1,2
C1(CC(C(C(C(C)=O)(O)O1)O)O)=O,,,5,1,1,0,1
81318_0,,,,2,1,1,2
C1(C(C)(O)OC(C(C1O)O)O)=O,,,5,1,1,0,1
81320_0,,,,2,1,1,2
C1(C(C)(O)OC(C(C1O)O)C)=O,,,5,1,1,0,1
81322_0,,,,2,1,1,2
C1(C(C)(O)OC(C(C1O)O)CO)=O,,,5,1,1,0,1
81324_0,,,,2,1,1,2
C(C)(C1(C(C(C(CO1)O)O)O)O)=O,,,5,1,1,0,1
81326_0,,,,2,1,1,2
C1(C(C)(O)OCC(CO)(C1O)O)=O,,,5,1,1,0,1
81328_0,,,,2,1,1,2
C1(C(C(C(OC1(C)O)=O)O)O)=O,,,5,1,1,0,1
81330_0,,,,2,1,1,2
C(C1(COC(C(C1O)=O)(C)O)O)=O,,,5,1,1,0,1
81332_0,,,,2,1,1,2
C(C)(C1(C(C(C(CO1)=O)O)O)O)=O,,,5,1,1,0,1
81334_0,,,,2,1,1,2
C1(C(C)(O)OCC(C1O)O)=O,,,5,1,1,0,1
81336_0,,,,2,1,1,2
C(C1C(CC(C(CO)(O1)O)=O)O)=O,,,5,1,1,0,1
81338_0,,,,2,1,1,2
C1(C(CO)(O)OCC(C)(C1)O)=O,,,5,1,1,0,1
81340_0,,,,2,1,1,2
C1(C(C)(CC(C(CO)(O)O1)=O)O)=O,,,5,1,1,0,1
81342_0,,,,2,1,1,2
C1(CC(CC(C(CO)=O)(O)O1)O)=O,,,5,1,1,0,1
81344_0,,,,2,1,1,2
C1(C(CO)(O)OC(C(C1)O)O)=O,,,5,1,1,0,1
81346_0,,,,2,1,1,2
C1(C(CO)(O)OC(C(C1)O)C)=O,,,5,1,1,0,1
81347_0,,,,2,1,1,2
81348_0,,,,2,1,1,2
81349_0,,,,2,1,1,2
81350_0,,,,2,1,1,2
81351_0,,,,2,1,1,2
81352_0,,,,2,1,1,2
81353_0,,,,2,1,1,2
81354_0,,,,2,1,1,2
81356_0,,,,2,1,1,2
C1(C(CC(C(O)O1)(C(C)O)O)=O)=O,,,5,1,1,0,1
81358_0,,,,2,1,1,2
C1(COC(C(C(C)O)(C1O)O)O)=O,,,5,1,1,0,1
81360_0,,,,2,1,1,2
C(C1(C(C)OC(C(C1)=O)O)O)=O,,,5,1,1,0,1
81362_0,,,,2,1,1,2
C(C1(C(C)OC(C(C1O)=O)O)O)=O,,,5,1,1,0,1
81364_0,,,,2,1,1,2
C1(C(C)OC(C(C1O)O)(C)O)=O,,,5,1,1,0,1
81366_0,,,,2,1,1,2
C1(COC(C(C1)O)(C(C)O)O)=O,,,5,1,1,0,1
81368_0,,,,2,1,1,2
C1(C(C)OC(CC1O)(CO)O)=O,,,5,1,1,0,1
81370_0,,,,2,1,1,2
C1(C(CC(C(C(C)O)(O)O1)O)=O)=O,,,5,1,1,0,1
81372_0,,,,2,1,1,2
C1(C(CC(C(O)=O)(OC1C)O)O)=O,,,5,1,1,0,1
81374_0,,,,2,1,1,2
C(C1C(OC(C(C1O)=O)C)O)(O)=O,,,5,1,1,0,1
81376_0,,,,2,1,1,2
C1(COC(C(C1O)O)(C(C)O)O)=O,,,5,1,1,0,1
81378_0,,,,2,1,1,2
C1(C(C)OC(C(C1O)O)(CO)O)=O,,,5,1,1,0,1
81380_0,,,,2,1,1,2
C1(C(CC(C=O)(OC1C)O)O)=O,,,5,1,1,0,1
81382_0,,,,2,1,1,2
C(C1C(OC(C(C1O)=O)C)O)=O,,,5,1,1,0,1
81383_0,,,,2,1,1,2
81385_0,,,,2,1,1,2
C1(C(C(C(C=O)(OC1C)O)O)O)=O,,,5,1,1,0,1
81387_0,,,,2,1,1,2
C1(C(C)OC(C(C1O)O)O)=O,,,5,1,1,0,1
81389_0,,,,2,1,1,2
C(C1C(C(C=O)C(C(O1)O)=O)O)=O,,,5,1,1,0,1
81391_0,,,,2,1,1,2
C1(COC2C1C(C(C(O)O2)O)O)=O,,,5,1,1,0,1
81393_0,,,,2,1,1,2
C(C(C1CC(C(C(O)O1)=O)=O)O)=O,,,5,1,1,0,1
81395_0,,,,2,1,1,2
C1(CC(C(C=O)OC1(C=O)O)O)=O,,,5,1,1,0,1
81396_0,,,,2,1,1,2
81398_0,,,,2,1,1,2
C(C(C1COC(C(C1O)O)O)=O)=O,,,5,1,1,0,1
81400_0,,,,2,1,1,2
C(C1C(C(C(C(O1)O)=O)CO)O)=O,,,5,1,1,0,1
81401_0,,,,2,1,1,2
81402_0,,,,2,1,1,2
81404_0,,,,2,1,1,2
C(C1C(C(O)OCC1(C)O)=O)=O,,,5,1,1,0,1
81406_0,,,,2,1,1,2
C(C1C(C(O)OCC1(C)O)=O)(O)=O,,,5,1,1,0,1
81408_0,,,,2,1,1,2
C1(C(C(O)OC(CO)(C)C1)=O)=O,,,5,1,1,0,1
81410_0,,,,2,1,1,2
C(C1(C(CC(CO1)(C)O)=O)O)=O,,,5,1,1,0,1
81412_0,,,,2,1,1,2
C1(C(O)OCC(C)(C1)O)=O,,,5,1,1,0,1
81414_0,,,,2,1,1,2
C1(C(O)OCC(C)(C1CO)O)=O,,,5,1,1,0,1
81416_0,,,,2,1,1,2
C(C1C(C(O)OCC1(C)O)O)=O,,,5,1,1,0,1
81417_0,,,,2,1,1,2
81418_0,,,,2,1,1,2
81420_0,,,,2,1,1,2
C1(C(O)OCC(C)(C1O)O)=O,,,5,1,1,0,1
81422_0,,,,2,1,1,2
CC1(C(C(CO)(CCO1)O)O)O,,,5,1,1,0,1
81424_0,,,,2,1,1,2
CC1(C(COC(C)(C1O)O)O)O,,,5,1,1,0,1
81426_0,,,,2,1,1,2
C1(CC(C(C(C)(O)O1)O)O)=O,,,5,1,1,0,1
81428_0,,,,2,1,1,2
C1(CC(CO)(C(C(C)(O)O1)O)O)=O,,,5,1,1,0,1
81430_0,,,,2,1,1,2
C1(C(C(C)(C(C(C)(O)O1)O)O)O)=O,,,5,1,1,0,1
81432_0,,,,2,1,1,2
C(C1(C(C(C)(O)OC(C1)=O)O)O)=O,,,5,1,1,0,1
81434_0,,,,2,1,1,2
CC1(C(C2(COC(C2)O1)O)O)O,,,5,1,1,0,1
81436_0,,,,2,1,1,2
CC1(C(C(C(CO1)O)O)O)O,,,5,1,1,0,1
81438_0,,,,2,1,1,2
CC1(C(C(C(C(CO)O1)O)O)O)O,,,5,1,1,0,1
81439_0,,,,2,1,1,2
81440_0,,,,2,1,1,2
81442_0,,,,2,1,1,2
C(C1(CCOC(C)(C1O)O)O)=O,,,5,1,1,0,1
81444_0,,,,2,1,1,2
C(C1CC(C(C(C)(O1)O)O)O)=O,,,5,1,1,0,1
81446_0,,,,2,1,1,2
C(C)(C1C(CC(C(O1)O)O)O)=O,,,5,1,1,0,1
81448_0,,,,2,1,1,2
C1CC(CO)(CC(CO)(O)O1)O,,,5,1,1,0,1
81450_0,,,,2,1,1,2
C1C(C(C)(CC(CO)(O)O1)O)O,,,5,1,1,0,1
81452_0,,,,2,1,1,2
C1(CC(CC(CO)(O)O1)O)=O,,,5,1,1,0,1
81454_0,,,,2,1,1,2
C(C1(CCOC(CO)(C1)O)O)(O)=O,,,5,1,1,0,1
81456_0,,,,2,1,1,2
C1(CC(CO)(CC(CO)(O)O1)O)=O,,,5,1,1,0,1
81458_0,,,,2,1,1,2
C1(C(C(C)(CC(CO)(O)O1)O)O)=O,,,5,1,1,0,1
81459_0,,,,2,1,1,2
81460_0,,,,2,1,1,2
81462_0,,,,2,1,1,2
C(C1(CC(CO)(O)OC(C1)=O)O)=O,,,5,1,1,0,1
81464_0,,,,2,1,1,2
C(CC1(C(OCC(C1)=O)O)O)(O)=O,,,5,1,1,0,1
81466_0,,,,2,1,1,2
C(CC1(C(CC(CO1)=O)O)O)(O)=O,,,5,1,1,0,1
81468_0,,,,2,1,1,2
C1C2(CC(O1)OC(CO)(C2)O)O,,,5,1,1,0,1
81469_0,,,,2,1,1,2
81470_0,,,,2,1,1,2
81472_0,,,,2,1,1,2
C(C)(C1(C(CC(CO1)=O)O)O)=O,,,5,1,1,0,1
81474_0,,,,2,1,1,2
C(C1(C(C)(CC(CO1)=O)O)O)=O,,,5,1,1,0,1
81476_0,,,,2,1,1,2
C1(COC(C(C=C)(C1)O)O)=O,,,5,1,1,0,1
81478_0,,,,2,1,1,2
C1(COC(C=C)(C(C1)O)O)=O,,,5,1,1,0,1
81479_0,,,,2,1,1,2
81480_0,,,,2,1,1,2
81481_0,,,,2,1,1,2
81482_0,,,,2,1,1,2
81483_0,,,,2,1,1,2
81485_0,,,,2,1,1,2
C1(COC(C(C)(C1)O)O)=O,,,5,1,1,0,1
81487_0,,,,2,1,1,2
C1(COC(C)(C(C1)O)O)=O,,,5,1,1,0,1
81488_0,,,,2,1,1,2
81490_0,,,,2,1,1,2
C1(COC(C(CCO)(C1)O)O)=O,,,5,1,1,0,1
81492_0,,,,2,1,1,2
C1(COC(C(C1)O)(CCO)O)=O,,,5,1,1,0,1
81493_0,,,,2,1,1,2
81494_0,,,,2,1,1,2
81495_0,,,,2,1,1,2
81496_0,,,,2,1,1,2
81498_0,,,,2,1,1,2
C1(COC(C(C(CO)O)(C1)O)O)=O,,,5,1,1,0,1
81499_0,,,,2,1,1,2
81501_0,,,,2,1,1,2
C1(COC(C(C1)O)(C(CO)O)O)=O,,,5,1,1,0,1
81503_0,,,,2,1,1,2
C(C1(CC(CO)(CCO1)O)O)(O)=O,,,5,1,1,0,1
81505_0,,,,2,1,1,2
C(C1C(O)OCCC1(CO)O)(O)=O,,,5,1,1,0,1
81506_0,,,,2,1,1,2
81507_0,,,,2,1,1,2
81508_0,,,,2,1,1,2
81509_0,,,,2,1,1,2
81510_0,,,,2,1,1,2
81511_0,,,,2,1,1,2
81512_0,,,,2,1,1,2
81513_0,,,,2,1,1,2
81515_0,,,,2,1,1,2
C1(CC(C(C(CCO)(O)O1)O)O)=O,,,5,1,1,0,1
81516_0,,,,2,1,1,2
81518_0,,,,2,1,1,2
C1(CC(C(CO)C(CO)(O)O1)O)=O,,,5,1,1,0,1
81520_0,,,,2,1,1,2
C1(COC(C(C=C)(C1CO)O)O)=O,,,5,1,1,0,1
81522_0,,,,2,1,1,2
C1(COC(C=C)(C(C1CO)O)O)=O,,,5,1,1,0,1
81523_0,,,,2,1,1,2
81524_0,,,,2,1,1,2
81525_0,,,,2,1,1,2
81526_0,,,,2,1,1,2
81527_0,,,,2,1,1,2
81528_0,,,,2,1,1,2
81529_0,,,,2,1,1,2
81530_0,,,,2,1,1,2
81531_0,,,,2,1,1,2
81533_0,,,,2,1,1,2
C(C1(CC(C)(C(CO1)O)O)O)(O)=O,,,5,1,1,0,1
81535_0,,,,2,1,1,2
C(C1C(O)OCC(C1(C)O)O)(O)=O,,,5,1,1,0,1
81537_0,,,,2,1,1,2
CC1(C(COC(CO)(C1O)O)O)O,,,5,1,1,0,1
81539_0,,,,2,1,1,2
C(C1(CC(C)(C(CO1)O)O)O)=O,,,5,1,1,0,1
81540_0,,,,2,1,1,2
81542_0,,,,2,1,1,2
C(C1C(O)OCC(C1(C)O)O)=O,,,5,1,1,0,1
81544_0,,,,2,1,1,2
C1C(C(C)(CC(O)O1)O)O,,,5,1,1,0,1
81546_0,,,,2,1,1,2
C(C1(C(C(C)(C(CO1)O)O)O)O)=O,,,5,1,1,0,1
81547_0,,,,2,1,1,2
81549_0,,,,2,1,1,2
CC1(C(COC(C1O)O)O)O,,,5,1,1,0,1
81551_0,,,,2,1,1,2
C1(CC(CC(C(CO)O)(O)O1)O)=O,,,5,1,1,0,1
81553_0,,,,2,1,1,2
C1(CC(C=C)(C(OC1CO)O)O)=O,,,5,1,1,0,1
81555_0,,,,2,1,1,2
C1(C(CO)OC(C=C)(C(C1)O)O)=O,,,5,1,1,0,1
81556_0,,,,2,1,1,2
81557_0,,,,2,1,1,2
81558_0,,,,2,1,1,2
81559_0,,,,2,1,1,2
81560_0,,,,2,1,1,2
81561_0,,,,2,1,1,2
81563_0,,,,2,1,1,2
C1(C(C)(C(C=O)C(C(O)O1)=O)O)=O,,,5,1,1,0,1
81565_0,,,,2,1,1,2
C(C1(C)CC(C(C(O1)O)=O)=O)(O)=O,,,5,1,1,0,1
81567_0,,,,2,1,1,2
C1(C(C)(CC(C(C=O)(O)O1)=O)O)=O,,,5,1,1,0,1
81569_0,,,,2,1,1,2
C1(C(C)(CC(C(O)O1)=O)O)=O,,,5,1,1,0,1
81571_0,,,,2,1,1,2
C1(C(C)(C(C(C(O)O1)=O)CO)O)=O,,,5,1,1,0,1
81573_0,,,,2,1,1,2
C(C1C(C(O)OC(C1(C)O)=O)O)=O,,,5,1,1,0,1
81574_0,,,,2,1,1,2
81575_0,,,,2,1,1,2
81577_0,,,,2,1,1,2
C1(C(C)(C(C(C(O)O1)=O)O)O)=O,,,5,1,1,0,1
81579_0,,,,2,1,1,2
C1(CC(CC(C(O)=O)(O)O1)O)=O,,,5,1,1,0,1
81581_0,,,,2,1,1,2
C(CC1(C(O)OC(C(C1)=O)=O)O)=O,,,5,1,1,0,1
81583_0,,,,2,1,1,2
C(CC1(C(CC(C(O1)=O)=O)O)O)=O,,,5,1,1,0,1
81585_0,,,,2,1,1,2
C(C1(CC2(COC(C2)O1)O)O)(O)=O,,,5,1,1,0,1
81587_0,,,,2,1,1,2
C(C)(C1(C(O)OC(C(C1)=O)=O)O)=O,,,5,1,1,0,1
81589_0,,,,2,1,1,2
C(C1(C(C)(O)OC(C(C1)=O)=O)O)=O,,,5,1,1,0,1
81591_0,,,,2,1,1,2
C(C)(C1(C(CC(C(O1)=O)=O)O)O)=O,,,5,1,1,0,1
81593_0,,,,2,1,1,2
C(C1(C(C)(CC(C(O1)=O)=O)O)O)=O,,,5,1,1,0,1
81595_0,,,,2,1,1,2
C(C1(C(O)OC(C(C1)=O)=O)O)=C,,,5,1,1,0,1
81597_0,,,,2,1,1,2
C=CC1(C(CC(C(O1)=O)=O)O)O,,,5,1,1,0,1
81599_0,,,,2,1,1,2
C1(C(CC(C(O)O1)O)=O)=O,,,5,1,2,0,2
81601_0,,,,2,1,1,2
C1(C(CC(C)(C(O)O1)O)=O)=O,,,5,1,1,0,1
81602_0,,,,2,1,1,2
81603_0,,,,2,1,1,2
81605_0,,,,2,1,1,2
C1(C(CC(C(O)O1)(CCO)O)=O)=O,,,5,1,1,0,1
81607_0,,,,2,1,1,2
C1(C(CC(C(CCO)(O)O1)O)=O)=O,,,5,1,1,0,1
81608_0,,,,2,1,1,2
81610_0,,,,2,1,1,2
C1(C(CC(CO)(C(O)O1)O)=O)=O,,,5,1,1,0,1
81611_0,,,,2,1,1,2
81613_0,,,,2,1,1,2
C1(C(CC(C(CO)(O)O1)O)=O)=O,,,5,1,1,0,1
81615_0,,,,2,1,1,2
C(C1C(O)OC(CC1O)=O)(O)=O,,,5,1,1,0,1
81617_0,,,,2,1,1,2
C1(CC(C(C(C(O)=O)(O)O1)O)O)=O,,,5,1,1,0,1
81619_0,,,,2,1,1,2
C1(CC(C(C=O)C(C=O)(O)O1)O)=O,,,5,1,1,0,1
81621_0,,,,2,1,1,2
C1(CC(C(C(C=O)=O)C(O)O1)O)=O,,,5,1,1,0,1
81623_0,,,,2,1,1,2
C1(CC(C2C(C(CO2)O)(O)O1)O)=O,,,5,1,1,0,1
81625_0,,,,2,1,1,2
C1(CC(C2COC(C2(O)O1)O)O)=O,,,5,1,1,0,1
81627_0,,,,2,1,1,2
C1(CC(C2C(O)OCC2(O)O1)O)=O,,,5,1,1,0,1
81629_0,,,,2,1,1,2
C1(CC(C2C(CC(O)O2)(O)O1)O)=O,,,5,1,1,0,1
81631_0,,,,2,1,1,2
C(CC1CC(C(C(O)O1)=O)=O)(O)=O,,,5,1,1,0,1
81633_0,,,,2,1,1,2
C1(CC(CC(C(C=O)=O)(O)O1)O)=O,,,5,1,1,0,1
81635_0,,,,2,1,1,2
C1(CC(C(C(CO)(O)O1)O)O)=O,,,5,1,1,0,1
81637_0,,,,2,1,1,2
C1(CC(CC(C=O)(O)O1)O)=O,,,5,1,1,0,1
81639_0,,,,2,1,1,2
C(C1C(O)OC(CC1O)=O)=O,,,5,1,1,0,1
81641_0,,,,2,1,1,2
C1(CC(C(CO)C(C=O)(O)O1)O)=O,,,5,1,1,0,1
81643_0,,,,2,1,1,2
C1(CC(C(C(O)O1)C(C=O)O)O)=O,,,5,1,1,0,1
81645_0,,,,2,1,1,2
C1(CC(C(C(CO)=O)C(O)O1)O)=O,,,5,1,1,0,1
81647_0,,,,2,1,1,2
C(C1C(CC(OC1(CO)O)=O)O)=O,,,5,1,1,0,1
81648_0,,,,2,1,1,2
81650_0,,,,2,1,1,2
C1(CC(C(C(CC=O)(O)O1)O)O)=O,,,5,1,1,0,1
81651_0,,,,2,1,1,2
81653_0,,,,2,1,1,2
C1(CC(CC(C(C=O)O)(O)O1)O)=O,,,5,1,1,0,1
81655_0,,,,2,1,1,2
C1(CC(CC(O)O1)O)=O,,,5,1,1,0,1
81657_0,,,,2,1,1,2
C1(CC(C(C(C=O)(O)O1)O)O)=O,,,5,1,2,0,2
81659_0,,,,2,1,1,2
C1(CC(C(C(O)O1)O)O)=O,,,5,1,1,0,1
81661_0,,,,2,1,1,2
C1(C(C=O)C(C=O)(CC(O)O1)O)=O,,,5,1,1,0,1
81663_0,,,,2,1,1,2
C(C1C(O)OC2CC1(CO2)O)(O)=O,,,5,1,1,0,1
81665_0,,,,2,1,1,2
C1(C(C=O)C(C(C(C)(O)O1)=O)O)=O,,,5,1,1,0,1
81667_0,,,,2,1,1,2
C1(C(C=O)C(C(C(O)O1)=O)(C)O)=O,,,5,1,1,0,1
81669_0,,,,2,1,1,2
C1(C(CCO)(CC(C(O)O1)=O)O)=O,,,5,1,1,0,1
81670_0,,,,2,1,1,2
81671_0,,,,2,1,1,2
81672_0,,,,2,1,1,2
81674_0,,,,2,1,1,2
C1(C(C(CO)C(C(O)O1)O)=O)=O,,,5,1,2,0,2
81676_0,,,,2,1,1,2
C1(C(C(CO)C(C)(C(O)O1)O)=O)=O,,,5,1,1,0,1
81678_0,,,,2,1,1,2
C1(C(C(CO)C(C(C)(O)O1)O)=O)=O,,,5,1,1,0,1
81679_0,,,,2,1,1,2
81680_0,,,,2,1,1,2
81682_0,,,,2,1,1,2
C1(CC(CO)(CC(C=O)(O)O1)O)=O,,,5,1,1,0,1
81683_0,,,,2,1,1,2
81685_0,,,,2,1,1,2
C(C1C(O)OC(CC1(CO)O)=O)=O,,,5,1,1,0,1
81687_0,,,,2,1,1,2
C1(CC(CO)(CC(O)O1)O)=O,,,5,1,1,0,1
81689_0,,,,2,1,1,2
C1(CC(CO)(C(C(O)O1)O)O)=O,,,5,1,1,0,1
81690_0,,,,2,1,1,2
81691_0,,,,2,1,1,2
81692_0,,,,2,1,1,2
81694_0,,,,2,1,1,2
C1(C(C(C)(CC(C=O)(O)O1)O)O)=O,,,5,1,1,0,1
81695_0,,,,2,1,1,2
81697_0,,,,2,1,1,2
C(C1C(O)OC(C(C1(C)O)O)=O)=O,,,5,1,1,0,1
81699_0,,,,2,1,1,2
C1(C(C(C)(CC(O)O1)O)O)=O,,,5,1,1,0,1
81700_0,,,,2,1,1,2
81701_0,,,,2,1,1,2
81702_0,,,,2,1,1,2
81703_0,,,,2,1,1,2
81704_0,,,,2,1,1,2
81705_0,,,,2,1,1,2
81706_0,,,,2,1,1,2
81708_0,,,,2,1,1,2
C(C1(C(O)OC(C(C1O)=O)=O)O)=C,,,5,1,1,0,1
81710_0,,,,2,1,1,2
C=CC1(C(C(C(C(O1)=O)=O)O)O)O,,,5,1,1,0,1
81712_0,,,,2,1,1,2
C1(C(C(C(C(O)O1)O)O)=O)=O,,,5,1,2,0,2
81714_0,,,,2,1,1,2
C1(C(C(C(C)(C(O)O1)O)O)=O)=O,,,5,1,1,0,1
81716_0,,,,2,1,1,2
C1(C(C(C(C(C)(O)O1)O)O)=O)=O,,,5,1,1,0,1
81718_0,,,,2,1,1,2
C1(C(C(C(CO)(C(O)O1)O)O)=O)=O,,,5,1,1,0,1
81719_0,,,,2,1,1,2
81721_0,,,,2,1,1,2
C1(C(C(C(C(CO)(O)O1)O)O)=O)=O,,,5,1,1,0,1
81722_0,,,,2,1,1,2
81723_0,,,,2,1,1,2
81725_0,,,,2,1,1,2
C(C1(COC(C(CO)C1O)O)O)=O,,,5,1,1,0,1
81727_0,,,,2,1,1,2
C(C1COC(C(CO)(C1O)O)O)=O,,,5,1,1,0,1
81729_0,,,,2,1,1,2
C(C)(C1(C(C)OC(CC1O)O)O)=O,,,5,1,1,0,1
81731_0,,,,2,1,1,2
C(C1(C(C)OC(CC1(C)O)O)O)=O,,,5,1,1,0,1
81733_0,,,,2,1,1,2
C1(CC(C(C(O)O1)(C(C)O)O)=O)=O,,,5,1,1,0,1
81734_0,,,,2,1,1,2
81735_0,,,,2,1,1,2
81736_0,,,,2,1,1,2
81737_0,,,,2,1,1,2
81739_0,,,,2,1,1,2
C(C)(C1(COC(C(C1O)O)O)O)=O,,,5,1,1,0,1
81741_0,,,,2,1,1,2
C(C1(COC(CC1(C)O)O)O)=O,,,5,1,1,0,1
81743_0,,,,2,1,1,2
C1(CC(C(CO)(C(O)O1)O)=O)=O,,,5,1,1,0,1
81744_0,,,,2,1,1,2
81745_0,,,,2,1,1,2
81746_0,,,,2,1,1,2
81747_0,,,,2,1,1,2
81748_0,,,,2,1,1,2
81750_0,,,,2,1,1,2
CC(C1(COC(CC1O)O)O)O,,,5,1,1,0,1
81752_0,,,,2,1,1,2
CC1C(CO)(C(CC(O)O1)O)O,,,5,1,1,0,1
81754_0,,,,2,1,1,2
C1C(C(C)O)(C(C(C(O)O1)O)O)O,,,5,1,1,0,1
81756_0,,,,2,1,1,2
CC1C(CO)(C(C(C(O)O1)O)O)O,,,5,1,1,0,1
81757_0,,,,2,1,1,2
81759_0,,,,2,1,1,2
C(C1C(C)(C(CC(O1)O)O)O)(O)=O,,,5,1,1,0,1
81761_0,,,,2,1,1,2
C(C1C(C(C)(CC(O1)O)O)O)(O)=O,,,5,1,1,0,1
81763_0,,,,2,1,1,2
C1(C(C)(C(C(CO)C(O)O1)O)O)=O,,,5,1,1,0,1
81765_0,,,,2,1,1,2
C(C(C1CC(CC(O)O1)O)O)(O)=O,,,5,1,1,0,1
81767_0,,,,2,1,1,2
C(C1C(O)OC(C(C1O)O)=O)(O)=O,,,5,1,1,0,1
81769_0,,,,2,1,1,2
C1(C(C(C(C(O)O1)C(C)O)O)O)=O,,,5,1,1,0,1
81771_0,,,,2,1,1,2
C1(C(C(C(CO)C(O)O1)O)O)=O,,,5,1,1,0,1
81773_0,,,,2,1,1,2
C(CC1(C(C)OC(CC1O)O)O)=O,,,5,1,1,0,1
81774_0,,,,2,1,1,2
81776_0,,,,2,1,1,2
C(C1CC(CO)(CC(O1)O)O)=O,,,5,1,1,0,1
81777_0,,,,2,1,1,2
81779_0,,,,2,1,1,2
C(C1C(CO)(CC(C(O1)O)O)O)=O,,,5,1,1,0,1
81781_0,,,,2,1,1,2
C(C1CC(CO)(C(C(O1)O)O)O)=O,,,5,1,1,0,1
81782_0,,,,2,1,1,2
81783_0,,,,2,1,1,2
81784_0,,,,2,1,1,2
81786_0,,,,2,1,1,2
C(CO)(C1C(C(O)OCC1O)O)=O,,,5,1,1,0,1
81787_0,,,,2,1,1,2
81788_0,,,,2,1,1,2
81789_0,,,,2,1,1,2
81790_0,,,,2,1,1,2
81792_0,,,,2,1,1,2
C1(C(C(C(C=O)=O)OC(C1)O)O)=O,,,5,1,1,0,1
81794_0,,,,2,1,1,2
C(C1C(C(O)OC(C1O)O)=O)=O,,,5,1,1,0,1
81796_0,,,,2,1,1,2
C(C1C(C(O)OC(C)C1O)=O)=O,,,5,1,1,0,1
81798_0,,,,2,1,1,2
C(C1C(C(O)OC(CO)C1O)=O)=O,,,5,1,1,0,1
81800_0,,,,2,1,1,2
C(C1C(C(COC1(C=O)O)O)O)=O,,,5,1,1,0,1
81802_0,,,,2,1,1,2
C(C(C1C(O)OCC(C1O)O)=O)=O,,,5,1,2,0,2
81804_0,,,,2,1,1,2
C(C1C(C(O)OCC1(CO)O)=O)=O,,,5,1,1,0,1
81805_0,,,,2,1,1,2
81807_0,,,,2,1,1,2
C(C1(COC(C(C1C=O)=O)O)O)=O,,,5,1,1,0,1
81809_0,,,,2,1,1,2
C(C1(C(C=O)C(C(CO1)=O)O)O)=O,,,5,1,1,0,1
81811_0,,,,2,1,1,2
C1(C(C(C(C=O)=O)C(OC1)O)O)=O,,,5,1,2,0,2
81812_0,,,,2,1,1,2
81814_0,,,,2,1,1,2
C(C1(CC(O)OC(CO)C1)O)(O)=O,,,5,1,1,0,1
81816_0,,,,2,1,1,2
C(C1CC(CO)(CC(O1)O)O)(O)=O,,,5,1,1,0,1
81818_0,,,,2,1,1,2
C1(CC(CC(O)O1)(C(CO)O)O)=O,,,5,1,1,0,1
81820_0,,,,2,1,1,2
C(CC1(CC(O)OCC1O)O)(O)=O,,,5,1,1,0,1
81822_0,,,,2,1,1,2
C1(C(C(CC(O)O1)(CCO)O)O)=O,,,5,1,1,0,1
81824_0,,,,2,1,1,2
C(C(C1(CC(O)OCC1)O)O)(O)=O,,,5,1,1,0,1
81826_0,,,,2,1,1,2
C(C1(CC(C=O)(O)OC(C1)=O)O)=O,,,5,1,1,0,1
81828_0,,,,2,1,1,2
C1(CC(C=O)(C(C=O)C(O)O1)O)=O,,,5,1,1,0,1
81830_0,,,,2,1,1,2
C(C1(CC(O)OC(C1)=O)O)=O,,,5,1,1,0,1
81832_0,,,,2,1,1,2
C(C1(C(C(O)OC(C1)=O)O)O)=O,,,5,1,2,0,2
81834_0,,,,2,1,1,2
C(C1C(C(O)OC(C1O)O)=O)(O)=O,,,5,1,1,0,1
81836_0,,,,2,1,1,2
C(C1C(C(O)OC(C)C1O)=O)(O)=O,,,5,1,1,0,1
81838_0,,,,2,1,1,2
C1(C(CC=O)(CC(C(O)O1)=O)O)=O,,,5,1,1,0,1
81839_0,,,,2,1,1,2
81841_0,,,,2,1,1,2
C(C1C(C(OC(C1(C)O)O)=O)=O)=O,,,5,1,1,0,1
81843_0,,,,2,1,1,2
C(C1C(C(OC(C)(C1O)O)=O)=O)=O,,,5,1,1,0,1
81845_0,,,,2,1,1,2
C1(C(O)OC2COCC2(C1)O)=O,,,5,1,1,0,1
81847_0,,,,2,1,1,2
C1(C(O)OC2COCC2(C1O)O)=O,,,5,1,1,0,1
81849_0,,,,2,1,1,2
C1(C2C(C=C)(C(OC1CO2)O)O)=O,,,5,1,1,0,1
81851_0,,,,2,1,1,2
C1(C2C(C(C=C)(OC1CO2)O)O)=O,,,5,1,1,0,1
81853_0,,,,2,1,1,2
C1C(C(C2C(C(CO2)O)(O)O1)O)O,,,5,1,1,0,1
81855_0,,,,2,1,1,2
C1(C2C(C(OC1CO2)O)O)=O,,,5,1,1,0,1
81857_0,,,,2,1,1,2
C1(C2C(C)(C(OC1CO2)O)O)=O,,,5,1,1,0,1
81859_0,,,,2,1,1,2
C1(C2C(C(C)(OC1CO2)O)O)=O,,,5,1,1,0,1
81861_0,,,,2,1,1,2
C1(C2C(CO)(C(OC1CO2)O)O)=O,,,5,1,1,0,1
81863_0,,,,2,1,1,2
C1(COC2(C(C1O)OCC2O)O)=O,,,5,1,1,0,1
81865_0,,,,2,1,1,2
C1(C2C(C(CO)(OC1CO2)O)O)=O,,,5,1,1,0,1
81867_0,,,,2,1,1,2
C1(C(O)OC2C(CCO2)(C1)O)=O,,,5,1,1,0,1
81869_0,,,,2,1,1,2
C1(C(O)OC2C(CCO2)(C1O)O)=O,,,5,1,1,0,1
81871_0,,,,2,1,1,2
C1(C2OCC1C(C=C)(C(O2)O)O)=O,,,5,1,1,0,1
81873_0,,,,2,1,1,2
C1(C2OC(C=C)(C(C1CO2)O)O)=O,,,5,1,1,0,1
81874_0,,,,2,1,1,2
81876_0,,,,2,1,1,2
C1(C2OC(C(C1CO2)O)O)=O,,,5,1,1,0,1
81878_0,,,,2,1,1,2
C1(C2OC(C(C)(C1CO2)O)O)=O,,,5,1,1,0,1
81880_0,,,,2,1,1,2
C1(C2OC(C)(C(C1CO2)O)O)=O,,,5,1,1,0,1
81882_0,,,,2,1,1,2
C1(C2OC(C(CO)(C1CO2)O)O)=O,,,5,1,1,0,1
81883_0,,,,2,1,1,2
81885_0,,,,2,1,1,2
C1(C2OC(CO)(C(C1CO2)O)O)=O,,,5,1,1,0,1
81887_0,,,,2,1,1,2
C1C2(CC(O1)OC(CO)(C2O)O)O,,,5,1,1,0,1
81889_0,,,,2,1,1,2
C(C1(CC2(COC(C2)O1)O)O)=O,,,5,1,1,0,1
81891_0,,,,2,1,1,2
C(C1C(O)OC2CC1(CO2)O)=O,,,5,1,1,0,1
81893_0,,,,2,1,1,2
C1C2(CC(O1)OC(C2)O)O,,,5,1,1,0,1
81895_0,,,,2,1,1,2
C(C1(C(C2(COC(C2)O1)O)O)O)=O,,,5,1,1,0,1
81897_0,,,,2,1,1,2
C1C2(CC(O1)OC(C2O)O)O,,,5,1,1,0,1
81898_0,,,,2,1,1,2
81900_0,,,,2,1,1,2
C1(COC2C1C(CC(O)O2)O)=O,,,5,1,1,0,1
81901_0,,,,2,1,1,2
81902_0,,,,2,1,1,2
81903_0,,,,2,1,1,2
81905_0,,,,2,1,1,2
C(C1(C(C)(C(C(CO1)=O)O)O)O)=O,,,5,1,1,0,1
81907_0,,,,2,1,1,2
C(C1(C=C)CC(C(C(O1)O)=O)=O)=O,,,5,1,1,0,1
81909_0,,,,2,1,1,2
C=CC(C1CC(C(C(O)O1)=O)=O)=O,,,5,1,1,0,1
81911_0,,,,2,1,1,2
C(C1CC(C(C(O)O1)=O)=O)=CC=O,,,5,1,1,0,1
81912_0,,,,2,1,1,2
81914_0,,,,2,1,1,2
C(C1(C(CC(C(O1)O)O)=O)O)=O,,,5,1,1,0,1
81916_0,,,,2,1,1,2
C1(C(C(O)OC(C(O)O)C1)=O)=O,,,5,1,1,0,1
81918_0,,,,2,1,1,2
C(C1(C(CC(C(C)O1)O)=O)O)=O,,,5,1,1,0,1
81920_0,,,,2,1,1,2
C1(C(C(O)OC(C(C)O)C1)=O)=O,,,5,1,1,0,1
81922_0,,,,2,1,1,2
C(C1(C(CC(C(CO)O1)O)=O)O)=O,,,5,1,1,0,1
81924_0,,,,2,1,1,2
C(C(C1(CC(C(CO1)O)O)O)=O)=O,,,5,1,2,0,2
81926_0,,,,2,1,1,2
C1(C(C(O)OC(C(CO)O)C1)=O)=O,,,5,1,1,0,1
81928_0,,,,2,1,1,2
C(C1CC(C(C(O)O1)=O)=O)=O,,,5,1,1,0,1
81930_0,,,,2,1,1,2
C(C1(C(CC(CO)(CO1)O)=O)O)=O,,,5,1,1,0,1
81932_0,,,,2,1,1,2
C1(C(C(O)OC(CO)(CO)C1)=O)=O,,,5,1,1,0,1
81934_0,,,,2,1,1,2
C(C1(C(CC(C(O1)=O)O)=O)O)=O,,,5,1,1,0,1
81936_0,,,,2,1,1,2
C(C1CC(C(C(O)O1)=O)=O)(O)=O,,,5,1,1,0,1
81938_0,,,,2,1,1,2
C(C1(C)CC(C(C(O1)O)=O)=O)=O,,,5,1,1,0,1
81939_0,,,,2,1,1,2
81940_0,,,,2,1,1,2
81942_0,,,,2,1,1,2
C1(C(C(O)OC(C)C1)=O)=O,,,5,1,1,0,1
81944_0,,,,2,1,1,2
C(C1(COC(C=O)(C(C1)=O)O)O)=O,,,5,1,1,0,1
81946_0,,,,2,1,1,2
C(C1(CO)CC(C(C(O1)O)=O)=O)=O,,,5,1,1,0,1
81948_0,,,,2,1,1,2
C1(COC(C(C=O)=O)(CC1O)O)=O,,,5,1,2,0,2
81950_0,,,,2,1,1,2
C(CO)(C1CC(C(C(O)O1)=O)=O)=O,,,5,1,1,0,1
81951_0,,,,2,1,1,2
81952_0,,,,2,1,1,2
81953_0,,,,2,1,1,2
81954_0,,,,2,1,1,2
81956_0,,,,2,1,1,2
C(C1C(COC(C1(C=C)O)O)=O)=O,,,5,1,1,0,1
81958_0,,,,2,1,1,2
C(C1(C=C)C(C(CC(O1)O)=O)O)=O,,,5,1,1,0,1
81960_0,,,,2,1,1,2
C(C1C(CC(C=C)(C(O1)O)O)=O)=O,,,5,1,1,0,1
81962_0,,,,2,1,1,2
C(C1(C=C)CC(C(C(O1)O)O)=O)=O,,,5,1,1,0,1
81963_0,,,,2,1,1,2
81965_0,,,,2,1,1,2
C(C1C(COC(C=C)(C1O)O)=O)=O,,,5,1,1,0,1
81967_0,,,,2,1,1,2
C1(C(C(C(C=C)=O)OC(C1)O)O)=O,,,5,1,1,0,1
81969_0,,,,2,1,1,2
C1(CC(C(C=C)(OC1C=O)O)O)=O,,,5,1,1,0,1
81971_0,,,,2,1,1,2
C1(CC(C(C=C)=O)OC(C1O)O)=O,,,5,1,1,0,1
81973_0,,,,2,1,1,2
C1(C(C(C=CC=O)OC(C1)O)O)=O,,,5,1,1,0,1
81975_0,,,,2,1,1,2
C1(CC(C=CC=O)OC(C1O)O)=O,,,5,1,1,0,1
81976_0,,,,2,1,1,2
81977_0,,,,2,1,1,2
81979_0,,,,2,1,1,2
C1(C(O)OC2C(C(CO2)O)(C1)O)=O,,,5,1,1,0,1
81981_0,,,,2,1,1,2
C1(C(C(CC(O)O1)=O)O)=O,,,5,1,1,0,1
81983_0,,,,2,1,1,2
C1(CC(C(C(O)O1)O)=O)=O,,,5,1,1,0,1
81984_0,,,,2,1,1,2
81986_0,,,,2,1,1,2
C1(C(O)OC(C(C1)O)O)=O,,,5,1,1,0,1
81988_0,,,,2,1,1,2
C1(C(O)OC(C(C1CO)O)O)=O,,,5,1,1,0,1
81990_0,,,,2,1,1,2
C(C1C(C(O)OC(C1O)O)O)=O,,,5,1,1,0,1
81992_0,,,,2,1,1,2
C1(C(C(C(O)O)OC(C1)O)O)=O,,,5,1,1,0,1
81994_0,,,,2,1,1,2
C1(C(C(O)OC(C(O)O)C1)O)=O,,,5,1,1,0,1
81996_0,,,,2,1,1,2
C1(C(O)OC(C(C1O)O)O)=O,,,5,1,1,0,1
81998_0,,,,2,1,1,2
C1(C(O)OC(C)C(C1)O)=O,,,5,1,1,0,1
82000_0,,,,2,1,1,2
C1(C(O)OC(C)C(C1CO)O)=O,,,5,1,1,0,1
82002_0,,,,2,1,1,2
C(C1C(C(O)OC(C)C1O)O)=O,,,5,1,1,0,1
82004_0,,,,2,1,1,2
C1(C(C(C(C)O)OC(C1)O)O)=O,,,5,1,1,0,1
82006_0,,,,2,1,1,2
C1(C(C(O)OC(C(C)O)C1)O)=O,,,5,1,1,0,1
82008_0,,,,2,1,1,2
C1(C(O)OC(C)C(C1O)O)=O,,,5,1,1,0,1
82010_0,,,,2,1,1,2
C1(C(CC(C)(C(O)O1)O)O)=O,,,5,1,1,0,1
82012_0,,,,2,1,1,2
C1(C(C(CO)C(C)(C(O)O1)O)O)=O,,,5,1,1,0,1
82014_0,,,,2,1,1,2
C1(C(C(C(C)(C(O)O1)O)O)O)=O,,,5,1,1,0,1
82016_0,,,,2,1,1,2
C1(C(CC(C(C)(O)O1)O)O)=O,,,5,1,1,0,1
82018_0,,,,2,1,1,2
C1(C(C(CO)C(C(C)(O)O1)O)O)=O,,,5,1,1,0,1
82020_0,,,,2,1,1,2
C1(C(CC(C(O)O1)(CCO)O)O)=O,,,5,1,1,0,1
82022_0,,,,2,1,1,2
C1(C(CC(C(CCO)(O)O1)O)O)=O,,,5,1,1,0,1
82024_0,,,,2,1,1,2
C(C1CC(C)(C(C(O1)O)O)O)(O)=O,,,5,1,1,0,1
82026_0,,,,2,1,1,2
C1(C(CC(CO)(C(O)O1)O)O)=O,,,5,1,1,0,1
82028_0,,,,2,1,1,2
C1(C(CC(C(CO)(O)O1)O)O)=O,,,5,1,1,0,1
82030_0,,,,2,1,1,2
C1(C(CC(C(O)O1)O)O)=O,,,5,1,1,0,1
82032_0,,,,2,1,1,2
C(C1C(CO)C(CC(O1)O)O)(O)=O,,,5,1,1,0,1
82033_0,,,,2,1,1,2
82034_0,,,,2,1,1,2
82036_0,,,,2,1,1,2
C1(C(C(C(CO)(C(O)O1)O)O)O)=O,,,5,1,1,0,1
82038_0,,,,2,1,1,2
C1(C(C(C(C(CO)(O)O1)O)O)O)=O,,,5,1,1,0,1
82039_0,,,,2,1,1,2
82040_0,,,,2,1,1,2
82042_0,,,,2,1,1,2
C1(C(CO)OC(C(C1O)=O)O)=O,,,5,1,1,0,1
82043_0,,,,2,1,1,2
82044_0,,,,2,1,1,2
82046_0,,,,2,1,1,2
C1(C(C=O)OC(C(C1)=O)O)=O,,,5,1,1,0,1
82047_0,,,,2,1,1,2
82048_0,,,,2,1,1,2
82049_0,,,,2,1,1,2
82051_0,,,,2,1,1,2
C1(COC(C(C1(CO)O)=O)O)=O,,,5,1,1,0,1
82052_0,,,,2,1,1,2
82053_0,,,,2,1,1,2
82054_0,,,,2,1,1,2
82056_0,,,,2,1,1,2
C1(C(CO)(OCC(C1O)=O)O)=O,,,5,1,1,0,1
82057_0,,,,2,1,1,2
82058_0,,,,2,1,1,2
82059_0,,,,2,1,1,2
82061_0,,,,2,1,1,2
C(C1(C(C(O)OCC1)=O)O)(O)=O,,,5,1,1,0,1
82063_0,,,,2,1,1,2
C(C1(C(C(C)(O)OCC1)=O)O)=O,,,5,1,1,0,1
82065_0,,,,2,1,1,2
C(C1(C(C(O)OCC1)=O)O)=O,,,5,1,1,0,1
82067_0,,,,2,1,1,2
C1(C(C(C(C)=O)(O)OCC1)O)=O,,,5,1,1,0,1
82068_0,,,,2,1,1,2
82070_0,,,,2,1,1,2
C(C1CC(C(C(C)(O1)O)=O)O)=O,,,5,1,1,0,1
82071_0,,,,2,1,1,2
82072_0,,,,2,1,1,2
82074_0,,,,2,1,1,2
C1(C(C)(OCC(C1O)=O)O)=O,,,5,1,1,0,1
82075_0,,,,2,1,1,2
82076_0,,,,2,1,1,2
82077_0,,,,2,1,1,2
82078_0,,,,2,1,1,2
82080_0,,,,2,1,1,2
C(C1(C(CC(CO)(CO1)O)O)O)=O,,,5,1,1,0,1
82081_0,,,,2,1,1,2
82082_0,,,,2,1,1,2
82083_0,,,,2,1,1,2
82084_0,,,,2,1,1,2
82086_0,,,,2,1,1,2
C1(C(C(C(CO)O)(O)OCC1)O)=O,,,5,1,1,0,1
82087_0,,,,2,1,1,2
82088_0,,,,2,1,1,2
82089_0,,,,2,1,1,2
82091_0,,,,2,1,1,2
C1(C(CO)OC(C(C1(C)O)O)O)=O,,,5,1,1,0,1
82092_0,,,,2,1,1,2
82093_0,,,,2,1,1,2
82094_0,,,,2,1,1,2
82096_0,,,,2,1,1,2
C1(C(C(C(C)O)(O)OCC1O)O)=O,,,5,1,1,0,1
82097_0,,,,2,1,1,2
82098_0,,,,2,1,1,2
82100_0,,,,2,1,1,2
C1(C(CC(C(C=O)(O)O1)O)O)=O,,,5,1,2,0,2
82101_0,,,,2,1,1,2
82102_0,,,,2,1,1,2
82104_0,,,,2,1,1,2
C1(C(C)OC(C(C1)=O)O)=O,,,5,1,1,0,1
82106_0,,,,2,1,1,2
C1(C(C)OC(C(C1CO)=O)O)=O,,,5,1,1,0,1
82108_0,,,,2,1,1,2
C(C1C(C(C)OC(C1O)O)=O)=O,,,5,1,1,0,1
82109_0,,,,2,1,1,2
82110_0,,,,2,1,1,2
82112_0,,,,2,1,1,2
C1(C(C)OC(C(C1O)=O)O)=O,,,5,1,1,0,1
82114_0,,,,2,1,1,2
C1(C(CCO)OC(C(C1)=O)O)=O,,,5,1,1,0,1
82115_0,,,,2,1,1,2
82117_0,,,,2,1,1,2
C1(C(C(CO)O)OC(C(C1)=O)O)=O,,,5,1,1,0,1
82118_0,,,,2,1,1,2
82120_0,,,,2,1,1,2
C(C(C1CC(CC(O1)O)O)=O)=O,,,5,1,1,0,1
82121_0,,,,2,1,1,2
82122_0,,,,2,1,1,2
82123_0,,,,2,1,1,2
82125_0,,,,2,1,1,2
C1(C(C(C(C=O)O)(O)OCC1)O)=O,,,5,1,1,0,1
82127_0,,,,2,1,1,2
C1(C(CCO)OC(C(C1O)=O)O)=O,,,5,1,1,0,1
82128_0,,,,2,1,1,2
82129_0,,,,2,1,1,2
82131_0,,,,2,1,1,2
C1(C(CO)OC(C(C1CO)=O)O)=O,,,5,1,1,0,1
82132_0,,,,2,1,1,2
82134_0,,,,2,1,1,2
C(C1C(C(CO)(CC(O1)O)O)=O)=O,,,5,1,1,0,1
82135_0,,,,2,1,1,2
82136_0,,,,2,1,1,2
82137_0,,,,2,1,1,2
82138_0,,,,2,1,1,2
82139_0,,,,2,1,1,2
82140_0,,,,2,1,1,2
82142_0,,,,2,1,1,2
C(C1C(C(C)(C(C(O1)O)O)O)=O)=O,,,5,1,1,0,1
82143_0,,,,2,1,1,2
82144_0,,,,2,1,1,2
82146_0,,,,2,1,1,2
C(C1(COC(C=O)(C(C1)O)O)O)=O,,,5,1,1,0,1
82147_0,,,,2,1,1,2
82148_0,,,,2,1,1,2
82149_0,,,,2,1,1,2
82151_0,,,,2,1,1,2
C(C1(C(CC(C(CO)O1)O)O)O)=O,,,5,1,1,0,1
82152_0,,,,2,1,1,2
82153_0,,,,2,1,1,2
82155_0,,,,2,1,1,2
C(C1(C(CC(CO1)O)O)O)=O,,,5,1,1,0,1
82156_0,,,,2,1,1,2
82157_0,,,,2,1,1,2
82159_0,,,,2,1,1,2
C(C1(C(COC(C1(C)O)O)=O)O)=O,,,5,1,1,0,1
82161_0,,,,2,1,1,2
C(C1(C(C(C)OC(C1O)O)=O)O)=O,,,5,1,1,0,1
82163_0,,,,2,1,1,2
C(C1(C(COC(C)(C1O)O)=O)O)=O,,,5,1,1,0,1
82165_0,,,,2,1,1,2
C(C1(C(COC(C1O)O)=O)O)=O,,,5,1,1,0,1
82167_0,,,,2,1,1,2
C1(C(CO)(C(C(C(O)O1)O)O)O)=O,,,5,1,1,0,1
82169_0,,,,2,1,1,2
C(C1(COC(C(C1O)O)O)O)(O)=O,,,5,1,1,0,1
82170_0,,,,2,1,1,2
82172_0,,,,2,1,1,2
C1(C(C)OC(C(C1(CO)O)=O)O)=O,,,5,1,1,0,1
82173_0,,,,2,1,1,2
82174_0,,,,2,1,1,2
82176_0,,,,2,1,1,2
C1(C(C)OC(C(CO)(C1O)O)O)=O,,,5,1,1,0,1
82178_0,,,,2,1,1,2
C1(COC(C(CO)(C1(C)O)O)O)=O,,,5,1,1,0,1
82180_0,,,,2,1,1,2
C(C1(C(C(C)OC(C1)O)=O)O)=O,,,5,1,1,0,1
82181_0,,,,2,1,1,2
82183_0,,,,2,1,1,2
C(C1(C(C(CO)OC(C1)O)=O)O)=O,,,5,1,1,0,1
82185_0,,,,2,1,1,2
C(C1(C(COC(C1)O)=O)O)=O,,,5,1,1,0,1
82187_0,,,,2,1,1,2
C1(C(C)(C(C(C(O)O1)O)O)O)=O,,,5,1,1,0,1
82188_0,,,,2,1,1,2
82190_0,,,,2,1,1,2
C(C1(COC(C(C1)O)O)O)=O,,,5,1,1,0,1
82192_0,,,,2,1,1,2
C(C1(C(CC(CO1)O)O)O)(O)=O,,,5,1,1,0,1
82193_0,,,,2,1,1,2
82194_0,,,,2,1,1,2
82195_0,,,,2,1,1,2
82196_0,,,,2,1,1,2
82197_0,,,,2,1,1,2
82199_0,,,,2,1,1,2
CC1(CCOC(C1O)O)O,,,5,1,1,0,1
82201_0,,,,2,1,1,2
C(C1(C(C(O)OCC1(C)O)O)O)=O,,,5,1,1,0,1
82203_0,,,,2,1,1,2
C(C(C1(C(O)OCCC1O)O)O)=O,,,5,1,1,0,1
82205_0,,,,2,1,1,2
C1CC(C(CO)(C(CO)(O)O1)O)O,,,5,1,1,0,1
82207_0,,,,2,1,1,2
C1(C(O)OCC(C)(C1(CO)O)O)=O,,,5,1,1,0,1
82208_0,,,,2,1,1,2
82210_0,,,,2,1,1,2
C(C)(C1(C(O)OCCC1O)O)=O,,,5,1,1,0,1
82212_0,,,,2,1,1,2
C(C1(C(C)(O)OCCC1O)O)=O,,,5,1,1,0,1
82214_0,,,,2,1,1,2
C(C1(C(CO)(C(CCO1)O)O)O)=O,,,5,1,1,0,1
82216_0,,,,2,1,1,2
C1CC(C(C(O)O1)(CO)O)O,,,5,1,1,0,1
82218_0,,,,2,1,1,2
C1CC(C(C(O)O1)(C(CO)O)O)O,,,5,1,1,0,1
82219_0,,,,2,1,1,2
82220_0,,,,2,1,1,2
82221_0,,,,2,1,1,2
82222_0,,,,2,1,1,2
82223_0,,,,2,1,1,2
82225_0,,,,2,1,1,2
CC1(C(COC(C1(CO)O)O)O)O,,,5,1,1,0,1
82227_0,,,,2,1,1,2
C(C1(CCOC(C1(C)O)O)O)=O,,,5,1,1,0,1
82229_0,,,,2,1,1,2
C(C1(CC(O)OCC1(C)O)O)=O,,,5,1,1,0,1
82231_0,,,,2,1,1,2
C(CC1(C(O)OCCC1O)O)=O,,,5,1,1,0,1
82232_0,,,,2,1,1,2
82233_0,,,,2,1,1,2
82235_0,,,,2,1,1,2
C1(C(C(CC(O)O1)O)C(C=O)O)=O,,,5,1,1,0,1
82236_0,,,,2,1,1,2
82237_0,,,,2,1,1,2
82239_0,,,,2,1,1,2
C1(CC(C)(C(C(O)O1)O)O)=O,,,5,1,1,0,1
82241_0,,,,2,1,1,2
C1(C(C(C)=O)(C(CC(O)O1)O)O)=O,,,5,1,1,0,1
82243_0,,,,2,1,1,2
C1(CC(C(C(C)=O)(C(O)O1)O)O)=O,,,5,1,1,0,1
82245_0,,,,2,1,1,2
C(C1(C(CC(OC1(C)O)=O)O)O)=O,,,5,1,1,0,1
82247_0,,,,2,1,1,2
C1(CC(C(CO)(C(O)O1)O)O)=O,,,5,1,1,0,1
82249_0,,,,2,1,1,2
C1(C(C(CO)(C(C(O)O1)O)O)=O)=O,,,5,1,1,0,1
82250_0,,,,2,1,1,2
82252_0,,,,2,1,1,2
C(C1(C(C)(C(O)OC(C1)=O)O)O)=O,,,5,1,1,0,1
82254_0,,,,2,1,1,2
C1(C(C)(C(C=O)(CC(O)O1)O)O)=O,,,5,1,1,0,1
82256_0,,,,2,1,1,2
C1(C(C(CC(O)O1)O)(CC=O)O)=O,,,5,1,1,0,1
82258_0,,,,2,1,1,2
C1(CC(C(C(O)O1)(CC=O)O)O)=O,,,5,1,1,0,1
82259_0,,,,2,1,1,2
82260_0,,,,2,1,1,2
82260_1,,,,2,1,1,2
82261_0,,,,2,1,1,2
82261_1,,,,2,1,1,2
82262_0,,,,2,1,1,2
82264_0,,,,2,1,1,2
C(C1(C(OCC(C1O)=O)O)O)(O)=O,,,5,1,1,0,1
82266_0,,,,2,1,1,2
C(C)(C1(C(C(O)OCC1O)O)O)=O,,,5,1,1,0,1
82268_0,,,,2,1,1,2
C1(C(C=O)(C=O)C(CC(O)O1)O)=O,,,5,1,1,0,1
82270_0,,,,2,1,1,2
C(C1(C=O)C(C)OC(CC1O)O)=O,,,5,1,1,0,1
82272_0,,,,2,1,1,2
C(C1(C=O)COC(CC1O)O)=O,,,5,1,1,0,1
82274_0,,,,2,1,1,2
C1(C(C=O)(C(CC(O)O1)O)O)=O,,,5,1,1,0,1
82276_0,,,,2,1,1,2
C(C1(C(C)OC(CC1O)O)O)=O,,,5,1,1,0,1
82278_0,,,,2,1,1,2
C(C1(C(O)OCCC1O)C(C)O)=O,,,5,1,1,0,1
82279_0,,,,2,1,1,2
82280_0,,,,2,1,1,2
82282_0,,,,2,1,1,2
C(C1(C=O)C(C(O)OCC1O)O)=O,,,5,1,1,0,1
82284_0,,,,2,1,1,2
C(C1(C(O)OC(C)CC1O)CO)=O,,,5,1,1,0,1
82286_0,,,,2,1,1,2
C(C1(C(O)OCCC1O)CO)=O,,,5,1,1,0,1
82288_0,,,,2,1,1,2
C(C1(C=O)COC(C(C1O)O)O)=O,,,5,1,1,0,1
82290_0,,,,2,1,1,2
C(C1(CO)C(O)OC(CC1O)=O)=O,,,5,1,1,0,1
82292_0,,,,2,1,1,2
C(C1COC(C(C=O)(C1O)O)O)=O,,,5,1,1,0,1
82293_0,,,,2,1,1,2
82294_0,,,,2,1,1,2
82295_0,,,,2,1,1,2
82296_0,,,,2,1,1,2
82298_0,,,,2,1,1,2
C1(C(C(CC(O)O1)=O)(C(C)O)O)=O,,,5,1,1,0,1
82299_0,,,,2,1,1,2
82300_0,,,,2,1,1,2
82301_0,,,,2,1,1,2
82302_0,,,,2,1,1,2
82303_0,,,,2,1,1,2
82304_0,,,,2,1,1,2
82306_0,,,,2,1,1,2
C1(C(C(CC(O)O1)=O)(CO)O)=O,,,5,1,1,0,1
82307_0,,,,2,1,1,2
82308_0,,,,2,1,1,2
82309_0,,,,2,1,1,2
82311_0,,,,2,1,1,2
C1(C(C=O)(C(C)(CC(O)O1)O)O)=O,,,5,1,1,0,1
82312_0,,,,2,1,1,2
82313_0,,,,2,1,1,2
82315_0,,,,2,1,1,2
CC(C1(C(O)OC(C)CC1O)O)O,,,5,1,1,0,1
82317_0,,,,2,1,1,2
C(C1(C(O)OC(C)CC1O)O)=O,,,5,1,1,0,1
82319_0,,,,2,1,1,2
CC1(C(CO)(C(CC(C)O1)O)O)O,,,5,1,1,0,1
82321_0,,,,2,1,1,2
C1C2(C(CO1)(C(CC(C)O2)O)O)O,,,5,1,1,0,1
82323_0,,,,2,1,1,2
CC1CC(C(C(O)O1)(CO)O)O,,,5,1,1,0,1
82325_0,,,,2,1,1,2
C(C)(C1(C(O)OC(C)CC1O)O)=O,,,5,1,1,0,1
82327_0,,,,2,1,1,2
C(C1(C(C)(O)OC(C)CC1O)O)=O,,,5,1,1,0,1
82328_0,,,,2,1,1,2
82330_0,,,,2,1,1,2
CC(C1(C(O)OCCC1O)O)O,,,5,1,1,0,1
82332_0,,,,2,1,1,2
C(C1(C(C)OC(C(C1O)O)O)O)=O,,,5,1,1,0,1
82334_0,,,,2,1,1,2
C1(CC(C(C(O)O1)(C(C)O)O)O)=O,,,5,1,1,0,1
82336_0,,,,2,1,1,2
C(C1(C(O)OC(C)C(C1O)O)O)=O,,,5,1,1,0,1
82338_0,,,,2,1,1,2
CC1C(C(C(C(O)O1)(CO)O)O)O,,,5,1,1,0,1
82340_0,,,,2,1,1,2
C(C(C1(C(O)OCCC1O)O)=O)=O,,,5,1,1,0,1
82342_0,,,,2,1,1,2
C(C1(C(CCOC1(C=O)O)O)O)=O,,,5,1,1,0,1
82344_0,,,,2,1,1,2
C(C1(C(CO)(O)OCCC1O)O)=O,,,5,1,1,0,1
82346_0,,,,2,1,1,2
C(CO)(C1(C(O)OCCC1O)O)=O,,,5,1,1,0,1
82348_0,,,,2,1,1,2
C(C1(C(O)OCCC1O)O)=O,,,5,1,1,0,1
82350_0,,,,2,1,1,2
CC1(C(CO)(C(CCO1)O)O)O,,,5,1,1,0,1
82352_0,,,,2,1,1,2
C(C1(C(C)(O)OCCC1O)O)(O)=O,,,5,1,1,0,1
82354_0,,,,2,1,1,2
C1C2(C(CO1)(C(CCO2)O)O)O,,,5,1,1,0,1
82356_0,,,,2,1,1,2
C1C2(C(C(O)O1)(O)OCCC2O)O,,,5,1,1,0,1
82358_0,,,,2,1,1,2
C(C1(C(O)OC(CO)CC1O)O)=O,,,5,1,1,0,1
82360_0,,,,2,1,1,2
C1(C(C=O)(C(C(C(O)O1)=O)O)O)=O,,,5,1,1,0,1
82362_0,,,,2,1,1,2
C(C1(C(C(O)OCC1(C)O)=O)O)=O,,,5,1,1,0,1
82364_0,,,,2,1,1,2
C(C1(C(C(O)OC(C1O)O)=O)O)=O,,,5,1,1,0,1
82366_0,,,,2,1,1,2
C(C1(C(C(O)OC(C)C1O)=O)O)=O,,,5,1,1,0,1
82368_0,,,,2,1,1,2
C(C1(C(C(O)OC(C1O)=O)=O)O)=O,,,5,1,1,0,1
82370_0,,,,2,1,1,2
C(C1(C(OCC(C1(C)O)=O)O)O)=O,,,5,1,1,0,1
82372_0,,,,2,1,1,2
C(C1(C(OC(C(C1O)=O)C)O)O)=O,,,5,1,1,0,1
82374_0,,,,2,1,1,2
C(C1(C(O)OCCC1(CO)O)O)=O,,,5,1,1,0,1
82376_0,,,,2,1,1,2
C(C1(C(O)OCC(C1(C)O)O)O)=O,,,5,1,1,0,1
82378_0,,,,2,1,1,2
C(C1(C(O)OC(CC1O)=O)O)=O,,,5,1,1,0,1
82380_0,,,,2,1,1,2
C(C1(C=O)C(C(CC(O1)O)=O)O)=O,,,5,1,1,0,1
82382_0,,,,2,1,1,2
C(C1(C=O)C(CC(C(O1)O)=O)O)=O,,,5,1,1,0,1
82384_0,,,,2,1,1,2
C(C1(C(O)OC2CC1(CO2)O)O)=O,,,5,1,1,0,1
82386_0,,,,2,1,1,2
C(C1(C(O)OCC(C1O)O)O)=O,,,5,1,1,0,1
82388_0,,,,2,1,1,2
C(C1(CCOC(C1(C=O)O)O)O)=O,,,5,1,1,0,1
82390_0,,,,2,1,1,2
C(C1(C=O)C(C(CC(O1)O)O)O)=O,,,5,1,1,0,1
82392_0,,,,2,1,1,2
C(C1(C(OC(C=O)CC1O)O)O)=O,,,5,1,1,0,1
82394_0,,,,2,1,1,2
C(C1(C=O)C(CC(C(O1)O)O)O)=O,,,5,1,1,0,1
82396_0,,,,2,1,1,2
C(C1(C(OCC(C1O)=O)O)O)=O,,,5,1,1,0,1
82398_0,,,,2,1,1,2
C1(C2C(CO1)OC(C(C2O)O)O)=O,,,5,1,1,0,1
82400_0,,,,2,1,1,2
C(C1C(C(O)OCC1(C)O)O)(O)=O,,,5,1,1,0,1
82402_0,,,,2,1,1,2
C1(CC(C(CO)(C(C)(O)O1)O)O)=O,,,5,1,1,0,1
82404_0,,,,2,1,1,2
C1(CC(C2(COCC2(O)O1)O)O)=O,,,5,1,1,0,1
82406_0,,,,2,1,1,2
C(C1C(C(O)OC(C1O)O)O)(O)=O,,,5,1,1,0,1
82408_0,,,,2,1,1,2
C(C1C(C(O)OC(C)C1O)O)(O)=O,,,5,1,1,0,1
82409_0,,,,2,1,1,2
82410_0,,,,2,1,1,2
82412_0,,,,2,1,1,2
C(C1(C(C)OC(CC1O)O)O)(O)=O,,,5,1,1,0,1
82413_0,,,,2,1,1,2
82415_0,,,,2,1,1,2
C(C1(CO)C(CC(C(O1)O)=O)O)=O,,,5,1,1,0,1
82417_0,,,,2,1,1,2
C(C1(COC(C=O)(CC1O)O)O)=O,,,5,1,1,0,1
82418_0,,,,2,1,1,2
82419_0,,,,2,1,1,2
82420_0,,,,2,1,1,2
82422_0,,,,2,1,1,2
C1C2(C(CO1)(O)OCC(C2O)O)O,,,5,1,1,0,1
82424_0,,,,2,1,1,2
C1(COC2(COCC2(C1O)O)O)=O,,,5,1,1,0,1
82426_0,,,,2,1,1,2
C1(C2C(CO1)OC(CC2O)O)=O,,,5,1,1,0,1
82428_0,,,,2,1,1,2
C1C2(CC(O1)OC(C2(CO)O)O)O,,,5,1,1,0,1
82430_0,,,,2,1,1,2
C(C1(COC(C(C1(C)O)=O)O)O)=O,,,5,1,1,0,1
82432_0,,,,2,1,1,2
C1(C2(C(C(O)OC(C2O)O1)O)O)=O,,,5,1,1,0,1
82434_0,,,,2,1,1,2
C1(C2OC(C(C1(CO2)O)O)O)=O,,,5,1,1,0,1
82436_0,,,,2,1,1,2
C1(C2OC(C(C)(C1(CO2)O)O)O)=O,,,5,1,1,0,1
82438_0,,,,2,1,1,2
C1(C2OC(C)(C(C1(CO2)O)O)O)=O,,,5,1,1,0,1
82440_0,,,,2,1,1,2
C(C1(C(O)OCC(C1O)O)O)(O)=O,,,5,1,1,0,1
82442_0,,,,2,1,1,2
C1(C2(C(CO1)OC(CC2O)O)O)=O,,,5,1,1,0,1
82444_0,,,,2,1,1,2
C(C1(C(C(OC(C1O)O)=O)=O)O)=O,,,5,1,1,0,1
82446_0,,,,2,1,1,2
C(C1(C(C(O)OC(C1O)O)O)O)=O,,,5,1,1,0,1
82448_0,,,,2,1,1,2
C1(C(O)OC(C(C1(CO)O)O)O)=O,,,5,1,1,0,1
82450_0,,,,2,1,1,2
C1(C(O)OC(C)C(C1(CO)O)O)=O,,,5,1,1,0,1
82451_0,,,,2,1,1,2
82451_1,,,,2,1,1,2
82453_0,,,,2,1,1,2
C1C2(C(CC(C(O)O1)(C2O)O)O)O,,,5,1,2,0,2
82453_1,,,,2,1,1,2
82454_0,,,,2,1,1,2
82455_0,,,,2,1,1,2
82457_0,,,,2,1,1,2
C(C1(C(C)OC(C(C1)=O)O)O)(O)=O,,,5,1,1,0,1
82459_0,,,,2,1,1,2
C(C1(CC(O)OCC1(C)O)O)(O)=O,,,5,1,1,0,1
82461_0,,,,2,1,1,2
C(C1(C(C(O)OC(C1)O)O)O)(O)=O,,,5,1,1,0,1
82463_0,,,,2,1,1,2
C(C1(CC(O)OC(C)C1O)O)(O)=O,,,5,1,1,0,1
82465_0,,,,2,1,1,2
C(C1CC(C(C(O1)O)(O)O)O)(O)=O,,,5,1,1,0,1
82467_0,,,,2,1,1,2
C(C1CC(C(C)(C(O1)O)O)O)(O)=O,,,5,1,1,0,1
82469_0,,,,2,1,1,2
C(C1(C(CC(C(O1)O)(C)O)O)O)=O,,,5,1,1,0,1
82471_0,,,,2,1,1,2
C(C1(C)CC(C(C(O1)O)(O)O)O)=O,,,5,1,1,0,1
82473_0,,,,2,1,1,2
C(C1(C)C(CC(C)(C(O1)O)O)O)=O,,,5,1,1,0,1
82475_0,,,,2,1,1,2
C(C1(C)CC(C(C)(C(O1)O)O)O)=O,,,5,1,1,0,1
82477_0,,,,2,1,1,2
[C]1(C(O)=O)C(CC(C(O)O1)(C)O)O,,,5,1,1,0,1
82479_0,,,,2,1,1,2
C(C1C(CC(C)(C(O1)O)O)O)(O)=O,,,5,1,1,0,1
82481_0,,,,2,1,1,2
C(C1(C(C(C)(CC(O1)O)O)O)O)=O,,,5,1,1,0,1
82483_0,,,,2,1,1,2
C(C1(C)C(C(C)(CC(O1)O)O)O)=O,,,5,1,1,0,1
82485_0,,,,2,1,1,2
[C]1(C(O)=O)C(C(C)(CC(O)O1)O)O,,,5,1,1,0,1
82487_0,,,,2,1,1,2
C1(C(C(C)=O)(CC(C(O)O1)=O)O)=O,,,5,1,1,0,1
82489_0,,,,2,1,1,2
C(C)(C1(C(C)OC(C(C1)=O)O)O)=O,,,5,1,1,0,1
82491_0,,,,2,1,1,2
C(CC1(C(CCOC1(C)O)O)O)=O,,,5,1,1,0,1
82493_0,,,,2,1,1,2
C(C)(C1(CC(O)OCC1(C)O)O)=O,,,5,1,1,0,1
82495_0,,,,2,1,1,2
C(C)(C1(C(C(O)OC(C1)O)O)O)=O,,,5,1,1,0,1
82497_0,,,,2,1,1,2
C(C)(C1(CC(O)OC(C)C1O)O)=O,,,5,1,1,0,1
82499_0,,,,2,1,1,2
C(C)(C1(CC(O)OC(C1O)=O)O)=O,,,5,1,1,0,1
82501_0,,,,2,1,1,2
C(C)(C1(C(COC(C1)O)O)O)=O,,,5,1,1,0,1
82503_0,,,,2,1,1,2
C(C1(C(CC(C(C)(O1)O)O)O)O)=O,,,5,1,1,0,1
82505_0,,,,2,1,1,2
C(C)(C1CC(C(C(O1)O)(O)O)O)=O,,,5,1,1,0,1
82507_0,,,,2,1,1,2
C(C1(C)C(CC(C(C)(O1)O)O)O)=O,,,5,1,1,0,1
82509_0,,,,2,1,1,2
C(C)(C1CC(C(C)(C(O1)O)O)O)=O,,,5,1,1,0,1
82511_0,,,,2,1,1,2
[C]1(C(O)=O)C(CC(C(C)(O)O1)O)O,,,5,1,1,0,1
82513_0,,,,2,1,1,2
C(C1C(CC(C(C)(O1)O)O)O)(O)=O,,,5,1,1,0,1
82515_0,,,,2,1,1,2
C(C1(C(C)(C(CC(O1)O)O)O)O)=O,,,5,1,1,0,1
82517_0,,,,2,1,1,2
C(C1(C)C(C)(C(CC(O1)O)O)O)=O,,,5,1,1,0,1
82519_0,,,,2,1,1,2
[C]1(C(O)=O)C(C)(C(CC(O)O1)O)O,,,5,1,1,0,1
82521_0,,,,2,1,1,2
C(C1(C(C(O)OC(C)C1)(O)O)O)=O,,,5,1,1,0,1
82523_0,,,,2,1,1,2
C(C1(CC(C)OC(C1(C)O)O)O)=O,,,5,1,1,0,1
82524_0,,,,2,1,1,2
82526_0,,,,2,1,1,2
C(CO)(C1(COC(C(C1)=O)O)O)=O,,,5,1,1,0,1
82528_0,,,,2,1,1,2
C1(C(C=O)(CC(C(O)O1)=O)O)=O,,,5,1,1,0,1
82530_0,,,,2,1,1,2
C(C(C1CC(CC(O)O1)O)(O)O)=O,,,5,1,1,0,1
82532_0,,,,2,1,1,2
C(CC1CC(C(C(O)O1)(O)O)O)=O,,,5,1,1,0,1
82534_0,,,,2,1,1,2
C(C(C)(C1CC(CC(O)O1)O)O)=O,,,5,1,1,0,1
82536_0,,,,2,1,1,2
C(CC1CC(C(C)(C(O)O1)O)O)=O,,,5,1,1,0,1
82538_0,,,,2,1,1,2
[C](C(O)=O)(C1CC(CC(O1)O)O)O,,,5,1,1,0,1
82540_0,,,,2,1,1,2
C(C1C(C)OC(C(C1O)(O)O)O)=O,,,5,1,1,0,1
82542_0,,,,2,1,1,2
C(C1C(C)OC(C(C)(C1O)O)O)=O,,,5,1,1,0,1
82544_0,,,,2,1,1,2
[C]1(C(OC(C(C(C)O)C1O)O)=O)O,,,5,1,1,0,1
82545_0,,,,2,1,1,2
82547_0,,,,2,1,1,2
C(C1COC(C(C1O)(O)O)O)=O,,,5,1,1,0,1
82549_0,,,,2,1,1,2
C(C1COC(C(C)(C1O)O)O)=O,,,5,1,1,0,1
82551_0,,,,2,1,1,2
[C]1(C(OC(C(CO)C1O)O)=O)O,,,5,1,1,0,1
82552_0,,,,2,1,1,2
82554_0,,,,2,1,1,2
C(C1(C(C)(C(CC(C)O1)O)O)O)=O,,,5,1,1,0,1
82556_0,,,,2,1,1,2
CC1CC(C(C(O)O1)(CCO)O)O,,,5,1,1,0,1
82558_0,,,,2,1,1,2
C1CC2(C(C(CC(C)O2)O)(O)O1)O,,,5,1,1,0,1
82560_0,,,,2,1,1,2
CC1CC(C(C(O)O1)(O)O)O,,,5,1,1,0,1
82562_0,,,,2,1,1,2
CC1(C(O)OC(C)CC1O)O,,,5,1,1,0,1
82564_0,,,,2,1,1,2
C(CC1(C(O)OC(C)CC1O)O)=O,,,5,1,1,0,1
82566_0,,,,2,1,1,2
CC1C(C(C(C(O)O1)(O)O)O)O,,,5,1,1,0,1
82568_0,,,,2,1,1,2
CC1(C(O)OC(C)C(C1O)O)O,,,5,1,1,0,1
82569_0,,,,2,1,1,2
82571_0,,,,2,1,1,2
C1(COC(C(C1(CC=O)O)O)O)=O,,,5,1,1,0,1
82572_0,,,,2,1,1,2
82573_0,,,,2,1,1,2
82575_0,,,,2,1,1,2
C(CO)(C1(C(COC(C1)O)O)O)=O,,,5,1,1,0,1
82576_0,,,,2,1,1,2
82578_0,,,,2,1,1,2
C(C1(C(C)(C(CCO1)O)O)O)=O,,,5,1,1,0,1
82580_0,,,,2,1,1,2
C1CC(C(C(O)O1)(CCO)O)O,,,5,1,1,0,1
82582_0,,,,2,1,1,2
C(CC1(C(O)OCCC1O)O)(O)=O,,,5,1,1,0,1
82584_0,,,,2,1,1,2
C1CC2(C(C(CCO2)O)(O)O1)O,,,5,1,1,0,1
82586_0,,,,2,1,1,2
C1C(C2(C(C(CCO2)O)(O)O1)O)O,,,5,1,1,0,1
82588_0,,,,2,1,1,2
C1CC(C(C(O)O1)(O)O)O,,,5,1,1,0,1
82590_0,,,,2,1,1,2
CC1(C(O)OCCC1O)O,,,5,1,1,0,1
82592_0,,,,2,1,1,2
C(C1CC(C(C(O)O1)(O)O)O)O,,,5,1,1,0,1
82594_0,,,,2,1,1,2
CC1(C(O)OC(CO)CC1O)O,,,5,1,1,0,1
82596_0,,,,2,1,1,2
C(C1(C(C(C(C(O1)O)=O)O)O)O)=O,,,5,1,1,0,1
82598_0,,,,2,1,1,2
C(C1(C)C(C(C(C(O1)O)=O)O)O)=O,,,5,1,1,0,1
82600_0,,,,2,1,1,2
C1(C(O)O[C](C(O)=O)C(C1O)O)=O,,,5,1,1,0,1
82602_0,,,,2,1,1,2
C(C1(C(C([C](C(O1)=O)O)O)O)O)=O,,,5,1,1,0,1
82604_0,,,,2,1,1,2
C1(C(C(C(C(C=O)(O)O1)O)O)O)=O,,,5,1,1,0,1
82606_0,,,,2,1,1,2
C(C1C(C(C(C(O1)O)=O)O)O)(O)=O,,,5,1,1,0,1
82608_0,,,,2,1,1,2
C1(C(C(C=O)(O)OC(C1O)O)O)=O,,,5,1,1,0,1
82610_0,,,,2,1,1,2
C(C1C(C(C(C(O1)O)(O)O)O)=O)=O,,,5,1,1,0,1
82612_0,,,,2,1,1,2
C1(C(C(O)O[C](C(O)=O)C1O)O)=O,,,5,1,1,0,1
82614_0,,,,2,1,1,2
C(C1([C](C(OC(C1O)O)=O)O)O)=O,,,5,1,1,0,1
82616_0,,,,2,1,1,2
[C]1(C(OC(C(C1(CO)O)O)O)=O)O,,,5,1,1,0,1
82618_0,,,,2,1,1,2
[C]1(C(OC(CO)(C(C1O)O)O)=O)O,,,5,1,1,0,1
82620_0,,,,2,1,1,2
C1(COC(C(C1(C)O)(O)O)O)=O,,,5,1,1,0,1
82622_0,,,,2,1,1,2
C1(COC(C(C)(C1(C)O)O)O)=O,,,5,1,1,0,1
82624_0,,,,2,1,1,2
C(C1C(C(C(C(O1)O)=O)(C)O)O)=O,,,5,1,1,0,1
82626_0,,,,2,1,1,2
C1(C(O)OCC(C)(C1(C)O)O)=O,,,5,1,1,0,1
82628_0,,,,2,1,1,2
C1(C(C)(C(C(C(O)O1)=O)(C)O)O)=O,,,5,1,1,0,1
82630_0,,,,2,1,1,2
C1(CC(C(C)(C(C=O)(O)O1)O)O)=O,,,5,1,1,0,1
82632_0,,,,2,1,1,2
C1(C(O)OC(C(C1(C)O)O)O)=O,,,5,1,1,0,1
82634_0,,,,2,1,1,2
C1(C(O)OC(C)C(C1(C)O)O)=O,,,5,1,1,0,1
82636_0,,,,2,1,1,2
C1(C(O)OC(CO)C(C1(C)O)O)=O,,,5,1,1,0,1
82638_0,,,,2,1,1,2
C(C1(C(C)(C(C(CO1)O)O)O)O)=O,,,5,1,1,0,1
82640_0,,,,2,1,1,2
C1(C(O)OCC(CO)(C1(C)O)O)=O,,,5,1,1,0,1
82642_0,,,,2,1,1,2
C1(C(O)OC(C(C1(C)O)O)=O)=O,,,5,1,1,0,1
82644_0,,,,2,1,1,2
C1(C(O)OCC(C1(C)O)O)=O,,,5,1,1,0,1
82646_0,,,,2,1,1,2
C1(C(C)OC(C(C1O)(O)O)O)=O,,,5,1,1,0,1
82648_0,,,,2,1,1,2
C1(C(C)OC(C(C)(C1O)O)O)=O,,,5,1,1,0,1
82650_0,,,,2,1,1,2
C1(C(C=C)(C(C(C(O)O1)O)O)O)=O,,,5,1,1,0,1
82652_0,,,,2,1,1,2
[C]1(C(OC(C(C1O)O)O)=O)O,,,5,1,1,0,1
82654_0,,,,2,1,1,2
C1CC(CO)(C(C(O)O1)(O)O)O,,,5,1,1,0,1
82656_0,,,,2,1,1,2
CC1(C(O)OCCC1(CO)O)O,,,5,1,1,0,1
82658_0,,,,2,1,1,2
C1(CC(C(C(O)O1)(CCO)O)O)=O,,,5,1,1,0,1
82660_0,,,,2,1,1,2
C(C1(CCOC(C1(C=C)O)O)O)=O,,,5,1,1,0,1
82662_0,,,,2,1,1,2
C(C1(C(C(C=C)(O)OCC1)O)O)=O,,,5,1,1,0,1
82664_0,,,,2,1,1,2
CC1(C(COC(C1(O)O)O)O)O,,,5,1,1,0,1
82666_0,,,,2,1,1,2
CC1(C(COC(C1(C)O)O)O)O,,,5,1,1,0,1
82668_0,,,,2,1,1,2
C1(CC(C2(C(CCO2)(O)O1)O)O)=O,,,5,1,1,0,1
82670_0,,,,2,1,1,2
C1(CC(C(C(O)O1)(O)O)O)=O,,,5,1,1,0,1
82672_0,,,,2,1,1,2
C1(CC(C(C)(C(O)O1)O)O)=O,,,5,1,1,0,1
82674_0,,,,2,1,1,2
C(C1(C(C(O)OCC1)(O)O)O)(O)=O,,,5,1,1,0,1
82676_0,,,,2,1,1,2
C1(CC(CO)(C(C(O)O1)(O)O)O)=O,,,5,1,1,0,1
82678_0,,,,2,1,1,2
C1(CC(CO)(C(C)(C(O)O1)O)O)=O,,,5,1,1,0,1
82680_0,,,,2,1,1,2
C1(C(C(C)(C(C(O)O1)(O)O)O)O)=O,,,5,1,1,0,1
82682_0,,,,2,1,1,2
C1(C(C(C)(C(C)(C(O)O1)O)O)O)=O,,,5,1,1,0,1
82684_0,,,,2,1,1,2
C(C1(C(OCC(C1)=O)O)O)(O)=O,,,5,1,1,0,1
82686_0,,,,2,1,1,2
C(C1([C](C(OC(C1)O)=O)O)O)=O,,,5,1,1,0,1
82688_0,,,,2,1,1,2
C1(C(C(C=O)(O)OC(C1)O)O)=O,,,5,1,1,0,1
82690_0,,,,2,1,1,2
C1(CC(O)O[C](C(O)=O)C1O)=O,,,5,1,1,0,1
82692_0,,,,2,1,1,2
C(C1(C(CC(C(O1)O)=O)O)O)=O,,,5,1,1,0,1
82694_0,,,,2,1,1,2
C(C1(C)C(CC(C(O1)O)=O)O)=O,,,5,1,1,0,1
82696_0,,,,2,1,1,2
C1(C(O)O[C](C(O)=O)C(C1)O)=O,,,5,1,1,0,1
82698_0,,,,2,1,1,2
C(C1(CC([C](C(O1)=O)O)O)O)=O,,,5,1,1,0,1
82700_0,,,,2,1,1,2
C1(C(C(CC(C=O)(O)O1)O)O)=O,,,5,1,1,0,1
82701_0,,,,2,1,1,2
82703_0,,,,2,1,1,2
C(C1(C)C(CC(C(O1)O)=O)O)(O)=O,,,5,1,1,0,1
82705_0,,,,2,1,1,2
C1(C(C)(C(CC(C=O)(O)O1)O)O)=O,,,5,1,1,0,1
82707_0,,,,2,1,1,2
C(C1(C(C(O)OC(C1)=O)(O)O)O)=O,,,5,1,1,0,1
82709_0,,,,2,1,1,2
C(C1(CC([C](C(O1)=O)O)O)O)(O)=O,,,5,1,1,0,1
82711_0,,,,2,1,1,2
C1(C(C(CC(C(O)=O)(O)O1)O)O)=O,,,5,1,1,0,1
82713_0,,,,2,1,1,2
C(C1([C](C(OC(C1)O)=O)O)O)(O)=O,,,5,1,1,0,1
82715_0,,,,2,1,1,2
C1C(C(C2(C(CCO2)(O)O1)O)O)O,,,5,1,1,0,1
82717_0,,,,2,1,1,2
C1(COC2(C(C1O)(O)OCC2)O)=O,,,5,1,1,0,1
82719_0,,,,2,1,1,2
C1C2(CC(O1)OC(C2(O)O)O)O,,,5,1,1,0,1
82721_0,,,,2,1,1,2
C1C2(CC(O1)OC(C2(C)O)O)O,,,5,1,1,0,1
82723_0,,,,2,1,1,2
C1(C(C)(O)OC([C](C1O)O)=O)=O,,,5,1,1,0,1
82725_0,,,,2,1,1,2
C1(C(O)OC([C](C1(C)O)O)=O)=O,,,5,1,1,0,1
82726_0,,,,2,1,1,2
82728_0,,,,2,1,1,2
C1(C2(C(C(OC1CO2)O)O)O)=O,,,5,1,1,0,1
82730_0,,,,2,1,1,2
C1(C2(C(C(OC1CO2)O)(C)O)O)=O,,,5,1,1,0,1
82732_0,,,,2,1,1,2
C1(C2(C(C(C)(OC1CO2)O)O)O)=O,,,5,1,1,0,1
82734_0,,,,2,1,1,2
C(C1(C(C(O)OC(C1)=O)O)O)(O)=O,,,5,1,1,0,1
82736_0,,,,2,1,1,2
C1C(C(C(C(O)O1)(O)O)O)O,,,5,1,1,0,1
82738_0,,,,2,1,1,2
C(C1C(C(C(C(O)O1)(O)O)O)O)O,,,5,1,1,0,1
82740_0,,,,2,1,1,2
C(C1C(C(C(C(O1)O)(O)O)O)O)=O,,,5,1,1,0,1
82742_0,,,,2,1,1,2
C(C1(C(C(C(C(O1)O)O)O)O)O)=O,,,5,1,1,0,1
82744_0,,,,2,1,1,2
C1C(C(CO)(C(C(O)O1)(O)O)O)O,,,5,1,1,0,1
82746_0,,,,2,1,1,2
C1C(CO)(C(C(C(O)O1)(O)O)O)O,,,5,1,1,0,1
82748_0,,,,2,1,1,2
C(C1(C(C(O)OCC1)(O)O)O)=O,,,5,1,1,0,1
82750_0,,,,2,1,1,2
C(C1(C(C(CC(O1)O)O)O)O)=O,,,5,1,1,0,1
82752_0,,,,2,1,1,2
C(C1CC(C(C(O1)O)(O)O)O)=O,,,5,1,1,0,1
82754_0,,,,2,1,1,2
C(C1(C(CC(C(O1)O)O)O)O)=O,,,5,1,1,0,1
82756_0,,,,2,1,1,2
C1(COC(C(C1O)(O)O)O)=O,,,5,1,1,0,1
82758_0,,,,2,1,1,2
C(C1(C(C(O)OCC1O)(O)O)O)=O,,,5,1,1,0,1
82760_0,,,,2,1,1,2
C1(C(CO)OC(C(C1O)(O)O)O)=O,,,5,1,1,0,1
82762_0,,,,2,1,1,2
C(C1(C(C(O)OC(C1)O)O)O)=O,,,5,1,1,0,1
82764_0,,,,2,1,1,2
CC1(C(O)OCC(C1O)O)O,,,5,1,1,0,1
82766_0,,,,2,1,1,2
CC1(C(O)OC(CO)C(C1O)O)O,,,5,1,1,0,1
82768_0,,,,2,1,1,2
C1C(CO)(C(C(C)(C(O)O1)O)O)O,,,5,1,1,0,1
82770_0,,,,2,1,1,2
C(C1CC(C(C)(C(O1)O)O)O)=O,,,5,1,1,0,1
82772_0,,,,2,1,1,2
C(C1(C)C(CC(C(O1)O)O)O)=O,,,5,1,1,0,1
82774_0,,,,2,1,1,2
[C]1(C(O)=O)C(C(C(C(O)O1)O)O)O,,,5,1,1,0,1
82776_0,,,,2,1,1,2
[C]1(C(OC(CC1O)O)=O)O,,,5,1,1,0,1
82778_0,,,,2,1,1,2
[C]1(C(O)=O)C(C(CC(O)O1)O)O,,,5,1,1,0,1
82780_0,,,,2,1,1,2
[C]1(C(O)=O)C(CC(C(O)O1)O)O,,,5,1,1,0,1
82782_0,,,,2,1,1,2
[C]1(C(OC(CO)(CC1O)O)=O)O,,,5,1,1,0,1
82784_0,,,,2,1,1,2
[C]1(C(OC(CC1(CO)O)O)=O)O,,,5,1,1,0,1
82786_0,,,,2,1,1,2
[C]1(C(OC(C)(C(C1O)O)O)=O)O,,,5,1,1,0,1
82788_0,,,,2,1,1,2
[C]1(C(OC(C(C1(C)O)O)O)=O)O,,,5,1,1,0,1
82789_0,,,,2,1,1,2
82790_0,,,,2,1,1,2
82792_0,,,,2,1,1,2
C(CC1(CC(C(CO1)O)O)O)=O,,,5,1,1,0,1
82793_0,,,,2,1,1,2
82794_0,,,,2,1,1,2
82795_0,,,,2,1,1,2
82796_0,,,,2,1,1,2
82797_0,,,,2,1,1,2
82798_0,,,,2,1,1,2
82799_0,,,,2,1,1,2
82800_0,,,,2,1,1,2
82801_0,,,,2,1,1,2
82803_0,,,,2,1,1,2
C(C1C(COC(C1CO)O)=O)=O,,,5,1,1,0,1
82805_0,,,,2,1,1,2
C(C1C(CC(CO)C(O1)O)=O)=O,,,5,1,1,0,1
82806_0,,,,2,1,1,2
82807_0,,,,2,1,1,2
82808_0,,,,2,1,1,2
82809_0,,,,2,1,1,2
82810_0,,,,2,1,1,2
82811_0,,,,2,1,1,2
82812_0,,,,2,1,1,2
82813_0,,,,2,1,1,2
82815_0,,,,2,1,1,2
C1(CC(C(CO)=O)(O)OCC1)=O,,,5,1,1,0,1
82816_0,,,,2,1,1,2
82817_0,,,,2,1,1,2
82819_0,,,,2,1,1,2
C(CC1(CC(C(CO1)=O)O)O)=O,,,5,1,1,0,1
82820_0,,,,2,1,1,2
82821_0,,,,2,1,1,2
82822_0,,,,2,1,1,2
82824_0,,,,2,1,1,2
C1(COC(C(CO)=O)(CC1)O)=O,,,5,1,1,0,1
82826_0,,,,2,1,1,2
C(CC1C(OCC(C1O)=O)O)=O,,,5,1,1,0,1
82828_0,,,,2,1,1,2
C(C)(C1(CC(C(CO1)=O)O)O)=O,,,5,1,1,0,1
82830_0,,,,2,1,1,2
C(C1(C(C)C(C(CO1)=O)O)O)=O,,,5,1,1,0,1
82831_0,,,,2,1,1,2
82832_0,,,,2,1,1,2
82833_0,,,,2,1,1,2
82834_0,,,,2,1,1,2
82835_0,,,,2,1,1,2
82836_0,,,,2,1,1,2
82837_0,,,,2,1,1,2
82838_0,,,,2,1,1,2
82839_0,,,,2,1,1,2
82840_0,,,,2,1,1,2
82841_0,,,,2,1,1,2
82842_0,,,,2,1,1,2
82843_0,,,,2,1,1,2
82844_0,,,,2,1,1,2
82845_0,,,,2,1,1,2
82847_0,,,,2,1,1,2
C1(CC(C(C)=O)(O)OCC1O)=O,,,5,1,1,0,1
82848_0,,,,2,1,1,2
82849_0,,,,2,1,1,2
82851_0,,,,2,1,1,2
C1(C(COC(C)(C1)O)O)=O,,,5,1,1,0,1
82852_0,,,,2,1,1,2
82853_0,,,,2,1,1,2
82854_0,,,,2,1,1,2
82855_0,,,,2,1,1,2
82856_0,,,,2,1,1,2
82857_0,,,,2,1,1,2
82858_0,,,,2,1,1,2
82859_0,,,,2,1,1,2
82860_0,,,,2,1,1,2
82861_0,,,,2,1,1,2
82862_0,,,,2,1,1,2
82863_0,,,,2,1,1,2
82864_0,,,,2,1,1,2
82865_0,,,,2,1,1,2
82866_0,,,,2,1,1,2
82867_0,,,,2,1,1,2
82868_0,,,,2,1,1,2
82869_0,,,,2,1,1,2
82870_0,,,,2,1,1,2
82871_0,,,,2,1,1,2
82872_0,,,,2,1,1,2
82873_0,,,,2,1,1,2
82874_0,,,,2,1,1,2
82875_0,,,,2,1,1,2
82876_0,,,,2,1,1,2
82878_0,,,,2,1,1,2
C1(CC(C(C=O)=O)(O)OCC1)=O,,,5,1,1,0,1
82879_0,,,,2,1,1,2
82880_0,,,,2,1,1,2
82881_0,,,,2,1,1,2
82882_0,,,,2,1,1,2
82883_0,,,,2,1,1,2
82884_0,,,,2,1,1,2
82885_0,,,,2,1,1,2
82886_0,,,,2,1,1,2
82887_0,,,,2,1,1,2
82889_0,,,,2,1,1,2
C1(COC(C(C=O)=O)(CC1)O)=O,,,5,1,1,0,1
82890_0,,,,2,1,1,2
82891_0,,,,2,1,1,2
82892_0,,,,2,1,1,2
82894_0,,,,2,1,1,2
C(C1C(COC(CO)(C1)O)=O)=O,,,5,1,1,0,1
82895_0,,,,2,1,1,2
82896_0,,,,2,1,1,2
82897_0,,,,2,1,1,2
82898_0,,,,2,1,1,2
82899_0,,,,2,1,1,2
82900_0,,,,2,1,1,2
82901_0,,,,2,1,1,2
82902_0,,,,2,1,1,2
82903_0,,,,2,1,1,2
82904_0,,,,2,1,1,2
82906_0,,,,2,1,1,2
C(C1C(CCC(CO)(O1)O)=O)=O,,,5,1,1,0,1
82907_0,,,,2,1,1,2
82908_0,,,,2,1,1,2
82909_0,,,,2,1,1,2
82910_0,,,,2,1,1,2
82911_0,,,,2,1,1,2
82912_0,,,,2,1,1,2
82913_0,,,,2,1,1,2
82914_0,,,,2,1,1,2
82916_0,,,,2,1,1,2
C(C1C(C)(O)OCC(C1O)O)=O,,,5,1,1,0,1
82917_0,,,,2,1,1,2
82918_0,,,,2,1,1,2
82919_0,,,,2,1,1,2
82920_0,,,,2,1,1,2
82921_0,,,,2,1,1,2
82922_0,,,,2,1,1,2
82923_0,,,,2,1,1,2
82924_0,,,,2,1,1,2
82925_0,,,,2,1,1,2
82926_0,,,,2,1,1,2
82927_0,,,,2,1,1,2
82928_0,,,,2,1,1,2
82929_0,,,,2,1,1,2
82930_0,,,,2,1,1,2
82931_0,,,,2,1,1,2
82932_0,,,,2,1,1,2
82933_0,,,,2,1,1,2
82934_0,,,,2,1,1,2
82935_0,,,,2,1,1,2
82936_0,,,,2,1,1,2
82937_0,,,,2,1,1,2
82938_0,,,,2,1,1,2
82939_0,,,,2,1,1,2
82940_0,,,,2,1,1,2
82941_0,,,,2,1,1,2
82942_0,,,,2,1,1,2
82943_0,,,,2,1,1,2
82944_0,,,,2,1,1,2
82945_0,,,,2,1,1,2
82946_0,,,,2,1,1,2
82947_0,,,,2,1,1,2
82948_0,,,,2,1,1,2
82949_0,,,,2,1,1,2
82950_0,,,,2,1,1,2
82951_0,,,,2,1,1,2
82952_0,,,,2,1,1,2
82953_0,,,,2,1,1,2
82954_0,,,,2,1,1,2
82955_0,,,,2,1,1,2
82956_0,,,,2,1,1,2
82957_0,,,,2,1,1,2
82958_0,,,,2,1,1,2
82959_0,,,,2,1,1,2
82960_0,,,,2,1,1,2
82961_0,,,,2,1,1,2
82962_0,,,,2,1,1,2
82963_0,,,,2,1,1,2
82964_0,,,,2,1,1,2
82965_0,,,,2,1,1,2
82966_0,,,,2,1,1,2
82967_0,,,,2,1,1,2
82968_0,,,,2,1,1,2
82969_0,,,,2,1,1,2
82970_0,,,,2,1,1,2
82972_0,,,,2,1,1,2
C1C2(C(C(C(CO2)O)O1)O)O,,,5,1,1,0,1
82973_0,,,,2,1,1,2
82974_0,,,,2,1,1,2
82975_0,,,,2,1,1,2
82977_0,,,,2,1,1,2
C1C2(C(C(C(CO2)O1)O)O)O,,,5,1,1,0,1
82979_0,,,,2,1,1,2
C1C2C(CC(C(O)O2)(O)O1)O,,,5,1,2,0,2
82981_0,,,,2,1,1,2
C1(C2(CC(C(CO2)O)O1)O)=O,,,5,1,2,0,2
82983_0,,,,2,1,1,2
C1(C2C(C(CC(O2)O)O1)O)=O,,,5,1,2,0,2
82985_0,,,,2,1,1,2
C1(C2(CC(C(CO2)O1)O)O)=O,,,5,1,2,0,2
82987_0,,,,2,1,1,2
C1(C(C(CC(O)O1)O)=O)=O,,,5,1,1,0,1
82988_0,,,,2,1,1,2
82989_0,,,,2,1,1,2
82991_0,,,,2,1,1,2
C1(C(C(CC(CO)(O)O1)O)=O)=O,,,5,1,1,0,1
82992_0,,,,2,1,1,2
82994_0,,,,2,1,1,2
C1(C(CCC(O)O1)O)=O,,,5,1,1,0,1
82996_0,,,,2,1,1,2
C1(C(CCC(CO)(O)O1)O)=O,,,5,1,1,0,1
82997_0,,,,2,1,1,2
82998_0,,,,2,1,1,2
82999_0,,,,2,1,1,2
83000_0,,,,2,1,1,2
83001_0,,,,2,1,1,2
83002_0,,,,2,1,1,2
83003_0,,,,2,1,1,2
83004_0,,,,2,1,1,2
83005_0,,,,2,1,1,2
83006_0,,,,2,1,1,2
83007_0,,,,2,1,1,2
83008_0,,,,2,1,1,2
83009_0,,,,2,1,1,2
83010_0,,,,2,1,1,2
83011_0,,,,2,1,1,2
83012_0,,,,2,1,1,2
83013_0,,,,2,1,1,2
83014_0,,,,2,1,1,2
83015_0,,,,2,1,1,2
83016_0,,,,2,1,1,2
83017_0,,,,2,1,1,2
83018_0,,,,2,1,1,2
83019_0,,,,2,1,1,2
83020_0,,,,2,1,1,2
83021_0,,,,2,1,1,2
83022_0,,,,2,1,1,2
83023_0,,,,2,1,1,2
83024_0,,,,2,1,1,2
83025_0,,,,2,1,1,2
83026_0,,,,2,1,1,2
83027_0,,,,2,1,1,2
83028_0,,,,2,1,1,2
83029_0,,,,2,1,1,2
83030_0,,,,2,1,1,2
83031_0,,,,2,1,1,2
83032_0,,,,2,1,1,2
83033_0,,,,2,1,1,2
83034_0,,,,2,1,1,2
83035_0,,,,2,1,1,2
83036_0,,,,2,1,1,2
83037_0,,,,2,1,1,2
83038_0,,,,2,1,1,2
83039_0,,,,2,1,1,2
83040_0,,,,2,1,1,2
83041_0,,,,2,1,1,2
83042_0,,,,2,1,1,2
83044_0,,,,2,1,1,2
C1C2(CC(O)OC(CO)(C2O)O1)O,,,5,1,1,0,1
83045_0,,,,2,1,1,2
83046_0,,,,2,1,1,2
83047_0,,,,2,1,1,2
83048_0,,,,2,1,1,2
83049_0,,,,2,1,1,2
83050_0,,,,2,1,1,2
83051_0,,,,2,1,1,2
83052_0,,,,2,1,1,2
83053_0,,,,2,1,1,2
83054_0,,,,2,1,1,2
83055_0,,,,2,1,1,2
83056_0,,,,2,1,1,2
83057_0,,,,2,1,1,2
83059_0,,,,2,1,1,2
C1(C(O)OC2C(C)(C1CO2)O)=O,,,5,1,1,0,1
83061_0,,,,2,1,1,2
C1(C(O)OC2(C)C(C1CO2)O)=O,,,5,1,1,0,1
83062_0,,,,2,1,1,2
83063_0,,,,2,1,1,2
83064_0,,,,2,1,1,2
83065_0,,,,2,1,1,2
83067_0,,,,2,1,1,2
C(C12CC(CO1)(CC(O2)O)O)=O,,,5,1,1,0,1
83068_0,,,,2,1,1,2
83069_0,,,,2,1,1,2
83070_0,,,,2,1,1,2
83071_0,,,,2,1,1,2
83072_0,,,,2,1,1,2
83073_0,,,,2,1,1,2
83074_0,,,,2,1,1,2
83075_0,,,,2,1,1,2
83077_0,,,,2,1,1,2
C(C1C2OCC1(CC(O)O2)O)=O,,,5,1,1,0,1
83078_0,,,,2,1,1,2
83079_0,,,,2,1,1,2
83080_0,,,,2,1,1,2
83081_0,,,,2,1,1,2
83083_0,,,,2,1,1,2
C1(C(O)OC2C(CO)(C1CO2)O)=O,,,5,1,1,0,1
83084_0,,,,2,1,1,2
83085_0,,,,2,1,1,2
83087_0,,,,2,1,1,2
C1(C(O)OC2(CO)C(C1CO2)O)=O,,,5,1,1,0,1
83088_0,,,,2,1,1,2
83090_0,,,,2,1,1,2
C1(C(O)OC2C(C1CO2)O)=O,,,5,1,1,0,1
83091_0,,,,2,1,1,2
83092_0,,,,2,1,1,2
83093_0,,,,2,1,1,2
83094_0,,,,2,1,1,2
83095_0,,,,2,1,1,2
83096_0,,,,2,1,1,2
83097_0,,,,2,1,1,2
83098_0,,,,2,1,1,2
83099_0,,,,2,1,1,2
83100_0,,,,2,1,1,2
83101_0,,,,2,1,1,2
83102_0,,,,2,1,1,2
83103_0,,,,2,1,1,2
83105_0,,,,2,1,1,2
C(C12C(C(CO1)(CC(O2)O)O)O)=O,,,5,1,1,0,1
83107_0,,,,2,1,1,2
C12C(C(CO1)(CC(O)O2)O)O,,,5,1,1,0,1
83108_0,,,,2,1,1,2
83109_0,,,,2,1,1,2
83110_0,,,,2,1,1,2
83111_0,,,,2,1,1,2
83112_0,,,,2,1,1,2
83113_0,,,,2,1,1,2
83114_0,,,,2,1,1,2
83115_0,,,,2,1,1,2
83116_0,,,,2,1,1,2
83117_0,,,,2,1,1,2
83118_0,,,,2,1,1,2
83119_0,,,,2,1,1,2
83120_0,,,,2,1,1,2
83121_0,,,,2,1,1,2
83122_0,,,,2,1,1,2
83123_0,,,,2,1,1,2
83125_0,,,,2,1,1,2
C1(C(O)OC2C(C)(C1(CO2)O)O)=O,,,5,1,1,0,1
83127_0,,,,2,1,1,2
C1(C(O)OC2(C)C(C1(CO2)O)O)=O,,,5,1,1,0,1
83128_0,,,,2,1,1,2
83129_0,,,,2,1,1,2
83131_0,,,,2,1,1,2
C1C(C2(C(O1)OC(CC2O)O)O)O,,,5,1,1,0,1
83132_0,,,,2,1,1,2
83133_0,,,,2,1,1,2
83134_0,,,,2,1,1,2
83136_0,,,,2,1,1,2
C1C2(CC(O)OC(C2(CO)O)O1)O,,,5,1,1,0,1
83137_0,,,,2,1,1,2
83138_0,,,,2,1,1,2
83139_0,,,,2,1,1,2
83140_0,,,,2,1,1,2
83142_0,,,,2,1,1,2
C1(C(O)OC2C(C1(CO2)O)O)=O,,,5,1,1,0,1
83143_0,,,,2,1,1,2
83144_0,,,,2,1,1,2
83145_0,,,,2,1,1,2
83146_0,,,,2,1,1,2
83148_0,,,,2,1,1,2
C(C1C2C(CC(C(O)O2)(O1)O)O)=O,,,5,1,2,0,2
83149_0,,,,2,1,1,2
83151_0,,,,2,1,1,2
C1(C2C(C(C(C(O)O2)O1)O)O)O,,,5,1,1,0,1
83153_0,,,,2,1,1,2
C1C2(C(C(C(O)O1)(CCO2)O)O)O,,,5,1,2,0,2
83154_0,,,,2,1,1,2
83156_0,,,,2,1,1,2
C(C1(C2C(CC(C(O)O2)O1)O)O)O,,,5,1,2,0,2
83157_0,,,,2,1,1,2
83159_0,,,,2,1,1,2
C1C2(C(C(C(CO2)(O)O1)O)O)O,,,5,1,1,0,1
83161_0,,,,2,1,1,2
C1C(C2(COC(C(C2)(O)O1)O)O)O,,,5,1,2,0,2
83163_0,,,,2,1,1,2
C1C2C(CO)(CC(C(O)O2)(O)O1)O,,,5,1,2,0,2
83164_0,,,,2,1,1,2
83165_0,,,,2,1,1,2
83167_0,,,,2,1,1,2
C1C2(CO)C(CC(C(O)O2)(O)O1)O,,,5,1,2,0,2
83168_0,,,,2,1,1,2
83170_0,,,,2,1,1,2
C1C2(COC(C(C(O)O1)C2O)O)O,,,5,1,1,0,1
83172_0,,,,2,1,1,2
C1(C2C(O)OC(C)(C(O2)O)C1)=O,,,5,1,2,0,2
83173_0,,,,2,1,1,2
83175_0,,,,2,1,1,2
C1(C2C(O)OC(C(C)(O2)O)C1)=O,,,5,1,2,0,2
83176_0,,,,2,1,1,2
83178_0,,,,2,1,1,2
C1(C2OC(C(CO2)(C1)O)O)=O,,,5,1,1,0,1
83180_0,,,,2,1,1,2
C1(C2OC(CO)C(C(O2)O)(C1)O)=O,,,5,1,1,0,1
83182_0,,,,2,1,1,2
C(C1(C2COC(C(O)O2)(C1)O)O)=O,,,5,1,2,0,2
83183_0,,,,2,1,1,2
83184_0,,,,2,1,1,2
83186_0,,,,2,1,1,2
C1(C2(CC(C(C(CO)O2)O1)O)O)O,,,5,1,2,0,2
83187_0,,,,2,1,1,2
83189_0,,,,2,1,1,2
C(C1(C2COC(CC2O)O1)O)=O,,,5,1,1,0,1
83191_0,,,,2,1,1,2
C(C1C2C(O)OC(CC2O)O1)=O,,,5,1,1,0,1
83193_0,,,,2,1,1,2
C1(C2OC(C(CO2)(C1CO)O)O)=O,,,5,1,1,0,1
83195_0,,,,2,1,1,2
C1C2C(C(CO)C(C(O)O2)(O)O1)O,,,5,1,2,0,2
83196_0,,,,2,1,1,2
83198_0,,,,2,1,1,2
C1(C(O)OC2C(C1OC(C2)O)O)=O,,,5,1,2,0,2
83199_0,,,,2,1,1,2
83201_0,,,,2,1,1,2
C(C1(C2C(CC(C(O)O2)O1)O)O)=O,,,5,1,2,0,2
83202_0,,,,2,1,1,2
83204_0,,,,2,1,1,2
C1(C2CC(C(C(O)O2)O1)O)O,,,5,1,2,0,2
83205_0,,,,2,1,1,2
83207_0,,,,2,1,1,2
C(C1C(C2OCC1(C(O)O2)O)O)=O,,,5,1,1,0,1
83209_0,,,,2,1,1,2
C1C2C(C(C(O)O1)C(C(O)O2)O)O,,,5,1,2,0,2
83210_0,,,,2,1,1,2
83212_0,,,,2,1,1,2
C1(COC2(COC(C1C2O)O)O)=O,,,5,1,2,0,2
83214_0,,,,2,1,1,2
C(C1C2(COC(CO2)(C1O)O)O)=O,,,5,1,2,0,2
83215_0,,,,2,1,1,2
83216_0,,,,2,1,1,2
83218_0,,,,2,1,1,2
C1(COC2(C(C1OC(C2)O)O)O)=O,,,5,1,2,0,2
83219_0,,,,2,1,1,2
83221_0,,,,2,1,1,2
C1C(C2C(C(CC(O)O2)(O)O1)O)O,,,5,1,2,0,2
83222_0,,,,2,1,1,2
83224_0,,,,2,1,1,2
C1(C2C(O)OC(CO)(C(O2)O)C1)=O,,,5,1,2,0,2
83225_0,,,,2,1,1,2
83227_0,,,,2,1,1,2
C(C1C2(CC(C(CO2)(O1)O)O)O)=O,,,5,1,2,0,2
83229_0,,,,2,1,1,2
C1(COC2(CC1OC(C2O)O)O)=O,,,5,1,2,0,2
83230_0,,,,2,1,1,2
83232_0,,,,2,1,1,2
C1(C2C(O)OC(C(CO)(O2)O)C1)=O,,,5,1,2,0,2
83233_0,,,,2,1,1,2
83234_0,,,,2,1,1,2
83236_0,,,,2,1,1,2
C1C(C2CC(C(C(O)O2)O)(O)O1)O,,,5,1,2,0,2
83237_0,,,,2,1,1,2
83239_0,,,,2,1,1,2
C1(C2C(O)OC(C(O2)O)C1)=O,,,5,1,2,0,2
83240_0,,,,2,1,1,2
83242_0,,,,2,1,1,2
C1(C2OC(C(CO2)(C1O)O)O)=O,,,5,1,1,0,1
83244_0,,,,2,1,1,2
C1C2C(C(C(C(O)O2)(O)O1)O)O,,,5,1,2,0,2
83245_0,,,,2,1,1,2
83247_0,,,,2,1,1,2
C(C1C2(C(O)OC(CC2O)O1)O)=O,,,5,1,1,0,1
83249_0,,,,2,1,1,2
C1C2(C(CO)(O)OC(CC2O)O1)O,,,5,1,1,0,1
83251_0,,,,2,1,1,2
C(C1(C2(COC(CC2O)O1)O)O)=O,,,5,1,1,0,1
83253_0,,,,2,1,1,2
C1C2(C(O)OC(CC2O)O1)O,,,5,1,1,0,1
83255_0,,,,2,1,1,2
C12CC(C(C(O)O1)(C(CO)O2)O)O,,,5,1,1,0,1
83257_0,,,,2,1,1,2
C1(C2(CO)C(CC(C(O)O2)O1)O)O,,,5,1,2,0,2
83258_0,,,,2,1,1,2
83260_0,,,,2,1,1,2
C1C2(C(O)OC(CO)(CC2O)O1)O,,,5,1,1,0,1
83262_0,,,,2,1,1,2
C1C2(C(O)OC(CC2(CO)O)O1)O,,,5,1,1,0,1
83264_0,,,,2,1,1,2
C1C2(C(O)OC(C)(C(C2O)O)O1)O,,,5,1,1,0,1
83266_0,,,,2,1,1,2
CC1(C(C2OCC1(C(O)O2)O)O)O,,,5,1,1,0,1
83268_0,,,,2,1,1,2
C(C1(CC2OC(C1(CO2)O)O)O)=O,,,5,1,1,0,1
83270_0,,,,2,1,1,2
C1C2C(C(C(O)O1)(CC(O)O2)O)O,,,5,1,2,0,2
83271_0,,,,2,1,1,2
83273_0,,,,2,1,1,2
C1C2(C(C(C(CCO2)(O)O1)O)O)O,,,5,1,2,0,2
83275_0,,,,2,1,1,2
C1C2(COC(C(CC2O)(O)O1)O)O,,,5,1,2,0,2
83277_0,,,,2,1,1,2
C1(C2OC(C(CCO2)(C1)O)O)=O,,,5,1,1,0,1
83279_0,,,,2,1,1,2
C1(C2OC(C(C(CO2)O)(C1)O)O)=O,,,5,1,1,0,1
83281_0,,,,2,1,1,2
C1C(C2C(CC(C(O)O2)(O)O1)O)O,,,5,1,2,0,2
83283_0,,,,2,1,1,2
C1(COC2CC(C1C(O)O2)O)=O,,,5,1,1,0,1
83285_0,,,,2,1,1,2
C1(C2C(O)OC(CC(O2)O)C1)=O,,,5,1,2,0,2
83287_0,,,,2,1,1,2
C1(C2COC(C(C(O2)O)C1O)O)=O,,,5,1,2,0,2
83289_0,,,,2,1,1,2
C1C2C(C(C(C(O)O2)C(O)O1)O)O,,,5,1,2,0,2
83291_0,,,,2,1,1,2
C1(C2OC(C(CCO2)(C1O)O)O)=O,,,5,1,1,0,1
83293_0,,,,2,1,1,2
C1(C(O)OC2C(OC1C(C2)O)O)=O,,,5,1,2,0,2
83295_0,,,,2,1,1,2
C1C2C(C(C(CC(O)O2)(O)O1)O)O,,,5,1,2,0,2
83297_0,,,,2,1,1,2
C1(C2C(O)OCC(C(O2)O)(C1)O)=O,,,5,1,2,0,2
83299_0,,,,2,1,1,2
C1C2C(CC(C(C(O)O2)O)(O)O1)O,,,5,1,2,0,2
83301_0,,,,2,1,1,2
C1C(C2(C(O)OC(CC2O)O1)O)O,,,5,1,1,0,1
83303_0,,,,2,1,1,2
C1C2(C(O)OC(C(O)O1)CC2O)O,,,5,1,2,0,2
83305_0,,,,2,1,1,2
C1C2(CC(C(CO2)(C(O)O1)O)O)O,,,5,1,2,0,2
83307_0,,,,2,1,1,2
C1(C2C(C(C(C(O2)O)O)O1)O)=O,,,5,1,2,0,2
83309_0,,,,2,1,1,2
C1(C2(C)C(C(CC(O2)O)O1)O)=O,,,5,1,2,0,2
83311_0,,,,2,1,1,2
C1(C2(C(C(C(CO2)O)O1)O)O)=O,,,5,1,2,0,2
83313_0,,,,2,1,1,2
C1(CC2C(OC1C(O2)O)=O)=O,,,5,1,2,0,2
83315_0,,,,2,1,1,2
C1(C2C(C(C(C(O2)O)O1)O)O)=O,,,5,1,2,0,2
83317_0,,,,2,1,1,2
C1(C2(C)C(CC(C(O2)O)O1)O)=O,,,5,1,2,0,2
83319_0,,,,2,1,1,2
C1(C2C(CC(C(O2)O)O1)O)=O,,,5,1,2,0,2
83321_0,,,,2,1,1,2
C1(C2(C(C(C(CO2)O1)O)O)O)=O,,,5,1,2,0,2
83323_0,,,,2,1,1,2
C1(CCC(C(O)O1)C(C(O)=O)O)=O,,,5,1,1,0,1
83325_0,,,,2,1,1,2
C(C(C)(C1C(O)OC(CC1)=O)O)=O,,,5,1,1,0,1
83327_0,,,,2,1,1,2
C1(CCC(C(O)O1)C(C(C)=O)O)=O,,,5,1,1,0,1
83329_0,,,,2,1,1,2
C1(CCC(C(C)(O)O1)(CC=O)O)=O,,,5,1,1,0,1
83331_0,,,,2,1,1,2
C1(CCCC(C(CC=O)O)(O)O1)=O,,,5,1,1,0,1
83333_0,,,,2,1,1,2
C1(CCC(C(C)O)C(C=O)(O)O1)=O,,,5,1,1,0,1
83335_0,,,,2,1,1,2
C1(CCC(C(O)O1)C(CC=O)O)=O,,,5,1,1,0,1
83337_0,,,,2,1,1,2
C(C1(CCC(OC1O)=O)C(C)O)=O,,,5,1,1,0,1
83339_0,,,,2,1,1,2
C(C(C=O)C1CCC(C(O)O1)=O)=O,,,5,1,1,0,1
83341_0,,,,2,1,1,2
C(C1(C=O)COC(C=O)(CC1)O)=O,,,5,1,1,0,1
83343_0,,,,2,1,1,2
C(C1(C=O)COC(CC1C=O)O)=O,,,5,1,1,0,1
83345_0,,,,2,1,1,2
C(C1(CCC(OC1O)=O)CO)=O,,,5,1,1,0,1
83347_0,,,,2,1,1,2
C(C1C(C)OC(C=O)(CC1)O)=O,,,5,1,1,0,1
83349_0,,,,2,1,1,2
C(C1C(C)OC(CC1C=O)O)=O,,,5,1,1,0,1
83351_0,,,,2,1,1,2
C1(CCC(C(O)O1)C(C)O)=O,,,5,1,1,0,1
83353_0,,,,2,1,1,2
C1(CC(CO)C(C(O)O1)C(C)O)=O,,,5,1,1,0,1
83355_0,,,,2,1,1,2
C(CC1(C)CCC(C(O)O1)=O)=O,,,5,1,1,0,1
83357_0,,,,2,1,1,2
C(CC1COC(CC1(C)O)O)(O)=O,,,5,1,1,0,1
83359_0,,,,2,1,1,2
C(CC1CCCC(C=O)(O)O1)=O,,,5,1,1,0,1
83361_0,,,,2,1,1,2
C(C1CC(CC=O)OC(C1)O)=O,,,5,1,1,0,1
83363_0,,,,2,1,1,2
C(C1(CCC(C(O1)O)=O)C(C)O)=O,,,5,1,1,0,1
83365_0,,,,2,1,1,2
C(C1(C(C)OC(C=O)(CC1)O)O)=O,,,5,1,1,0,1
83367_0,,,,2,1,1,2
C(C1CC(O)OC(C)C1(C=O)O)=O,,,5,1,1,0,1
83369_0,,,,2,1,1,2
C1(CCC(C(O)O1)(C(C)O)O)=O,,,5,1,1,0,1
83371_0,,,,2,1,1,2
C(C1C(C)(CCC(C=O)(O1)O)O)=O,,,5,1,1,0,1
83373_0,,,,2,1,1,2
C(C(C1(CCC(C(O)O1)=O)C)O)=O,,,5,1,1,0,1
83375_0,,,,2,1,1,2
C(C1CC(OC(C=O)C1(C)O)O)=O,,,5,1,1,0,1
83377_0,,,,2,1,1,2
C(C(C1CCCC(C=O)(O)O1)O)=O,,,5,1,1,0,1
83379_0,,,,2,1,1,2
C(CC1C(OC(C=O)C(C1)O)O)=O,,,5,1,1,0,1
83381_0,,,,2,1,1,2
C(C1CC(O)OC(C1)C(C=O)O)=O,,,5,1,1,0,1
83383_0,,,,2,1,1,2
C(CC1CCC(C(O)O1)=O)=O,,,5,1,1,0,1
83385_0,,,,2,1,1,2
C(CC1COC(CC1O)O)(O)=O,,,5,1,1,0,1
83387_0,,,,2,1,1,2
C(C1COC(C=O)(CC1)O)=O,,,5,1,1,0,1
83389_0,,,,2,1,1,2
C(C1CC(O)OCC1C=O)=O,,,5,1,1,0,1
83391_0,,,,2,1,1,2
C1(CCC(CO)C(O)O1)=O,,,5,1,1,0,1
83393_0,,,,2,1,1,2
C1(CC(CO)C(CO)C(O)O1)=O,,,5,1,1,0,1
83395_0,,,,2,1,1,2
C(CC(C1CCC(C(O)O1)=O)O)=O,,,5,1,1,0,1
83397_0,,,,2,1,1,2
C(CC1C(CCC(C=O)(O)O1)O)=O,,,5,1,1,0,1
83399_0,,,,2,1,1,2
C(C1CC(O)OC(C1O)CC=O)=O,,,5,1,1,0,1
83401_0,,,,2,1,1,2
C(CC1(COC(C=O)(CC1)O)O)=O,,,5,1,1,0,1
83403_0,,,,2,1,1,2
C(CC1(CO)CCC(C(O)O1)=O)=O,,,5,1,1,0,1
83405_0,,,,2,1,1,2
C(C1CC(O)OCC1(CC=O)O)=O,,,5,1,1,0,1
83407_0,,,,2,1,1,2
C(C1C(CO)OC(C=O)(CC1)O)=O,,,5,1,1,0,1
83409_0,,,,2,1,1,2
C(C1C(C(O)OCC1O)CC=O)=O,,,5,1,1,0,1
83411_0,,,,2,1,1,2
C(C1C(CO)OC(CC1C=O)O)=O,,,5,1,1,0,1
83413_0,,,,2,1,1,2
C1(CCC(C(O)O1)C(CO)O)=O,,,5,1,1,0,1
83415_0,,,,2,1,1,2
C1(CCC(C(C=O)=O)(C(O)O1)O)=O,,,5,1,1,0,1
83417_0,,,,2,1,1,2
C1(CCC(C=O)(C(C=O)(O)O1)O)=O,,,5,1,1,0,1
83419_0,,,,2,1,1,2
C1(CCC(C(C(C=O)O)(O)O1)O)=O,,,5,1,1,0,1
83421_0,,,,2,1,1,2
C(C1(CCC(OC1(CO)O)=O)O)=O,,,5,1,1,0,1
83423_0,,,,2,1,1,2
C1(CCC(C(CO)=O)(C(O)O1)O)=O,,,5,1,1,0,1
83425_0,,,,2,1,1,2
C1(C(OC(C(C(C)=O)=O)CC1)O)=O,,,5,1,1,0,1
83427_0,,,,2,1,1,2
C1(CCC(C(C(C)=O)(O)O1)O)=O,,,5,1,1,0,1
83429_0,,,,2,1,1,2
C1(CCCC(C(CO)=O)(O)O1)=O,,,5,1,1,0,1
83431_0,,,,2,1,1,2
C(C1(CCCC(C(C=O)=O)O1)O)=O,,,5,1,1,0,1
83433_0,,,,2,1,1,2
C(C1CC(C(C=O)=O)OC(C1)O)=O,,,5,1,1,0,1
83435_0,,,,2,1,1,2
C1(C(OC(C(C=O)=O)(C)CC1)O)=O,,,5,1,1,0,1
83437_0,,,,2,1,1,2
C1(CCC(C)(C(C=O)(O)O1)O)=O,,,5,1,1,0,1
83439_0,,,,2,1,1,2
C(C1(C=O)CCC(C(O1)O)=O)=O,,,5,1,1,0,1
83441_0,,,,2,1,1,2
C(C1(C(O)OC(CC1)=O)O)=O,,,5,1,1,0,1
83443_0,,,,2,1,1,2
C(C1(C(O)OC(CC1CO)=O)O)=O,,,5,1,1,0,1
83445_0,,,,2,1,1,2
C(C)(C1CCC(C(O1)O)=O)=O,,,5,1,1,0,1
83447_0,,,,2,1,1,2
C1(CCC(C(C)(O)O1)O)=O,,,5,1,1,0,1
83449_0,,,,2,1,1,2
C1(CC(CO)C(C(C)(O)O1)O)=O,,,5,1,1,0,1
83451_0,,,,2,1,1,2
C(CC1C(OCC(C1)=O)O)=O,,,5,1,1,0,1
83453_0,,,,2,1,1,2
C1(CCCC(CO)(O)O1)=O,,,5,1,1,0,1
83455_0,,,,2,1,1,2
C1(CC(CO)CC(CO)(O)O1)=O,,,5,1,1,0,1
83457_0,,,,2,1,1,2
C(C1CCC(C(O1)O)=O)(CCO)=O,,,5,1,1,0,1
83459_0,,,,2,1,1,2
C1(CCC(C(CCO)(O)O1)O)=O,,,5,1,1,0,1
83461_0,,,,2,1,1,2
C(CO)(CC1CCC(C(O)O1)=O)=O,,,5,1,1,0,1
83463_0,,,,2,1,1,2
C(C1(CCC(C(CO)=O)CO1)O)=O,,,5,1,1,0,1
83465_0,,,,2,1,1,2
C(CC1C(OCC(C1CO)=O)O)=O,,,5,1,1,0,1
83467_0,,,,2,1,1,2
C(C1CC(O)OCC1C(CO)=O)=O,,,5,1,1,0,1
83469_0,,,,2,1,1,2
C1(CCC(CO)C(CO)(O)O1)=O,,,5,1,1,0,1
83471_0,,,,2,1,1,2
C(C1(CCC(C(O1)O)=O)CCO)=O,,,5,1,1,0,1
83473_0,,,,2,1,1,2
C(C1(CCOC(C1CC=O)O)O)=O,,,5,1,1,0,1
83475_0,,,,2,1,1,2
C1(CCC(C(O)O1)(CCO)O)=O,,,5,1,1,0,1
83477_0,,,,2,1,1,2
C(C(CC1CCC(C(O)O1)=O)O)=O,,,5,1,1,0,1
83479_0,,,,2,1,1,2
C(CC1C(OC(C=O)CC1O)O)=O,,,5,1,1,0,1
83481_0,,,,2,1,1,2
C(C(C1COC(C=O)(CC1)O)O)=O,,,5,1,1,0,1
83483_0,,,,2,1,1,2
C(C1C(CO)CCC(C=O)(O1)O)=O,,,5,1,1,0,1
83485_0,,,,2,1,1,2
C(C1CC(O)OCC1C(C=O)O)=O,,,5,1,1,0,1
83487_0,,,,2,1,1,2
C(C1CC(OC(C=O)C1CO)O)=O,,,5,1,1,0,1
83489_0,,,,2,1,1,2
C(C1(CCC(C(C)=O)(CO1)O)O)=O,,,5,1,1,0,1
83491_0,,,,2,1,1,2
C(C)(C1(CO)CCC(C(O1)O)=O)=O,,,5,1,1,0,1
83493_0,,,,2,1,1,2
C(C1CC(O)OCC1(C(C)=O)O)=O,,,5,1,1,0,1
83495_0,,,,2,1,1,2
C1(CCC(CO)(C(C)(O)O1)O)=O,,,5,1,1,0,1
83497_0,,,,2,1,1,2
C(C)(C(C1CCC(C(O)O1)=O)O)=O,,,5,1,1,0,1
83499_0,,,,2,1,1,2
C(C1(CCC(C(C(C)=O)O1)O)O)=O,,,5,1,1,0,1
83501_0,,,,2,1,1,2
C(C1C(C(C(C)=O)OC(C1)O)O)=O,,,5,1,1,0,1
83503_0,,,,2,1,1,2
C(CC1C(OC(C(C1)=O)CO)O)=O,,,5,1,1,0,1
83505_0,,,,2,1,1,2
C1(CCCC(C(CO)O)(O)O1)=O,,,5,1,1,0,1
83507_0,,,,2,1,1,2
C1(C(O)OC(C)CC1)=O,,,5,1,1,0,1
83509_0,,,,2,1,1,2
C(C1(CCCCO1)O)=O,,,5,1,1,0,1
83511_0,,,,2,1,1,2
C(C1CCOC(C1)O)=O,,,5,1,1,0,1
83513_0,,,,2,1,1,2
C(CC1C(O)OC(C(C1)=O)=O)=O,,,5,1,1,0,1
83515_0,,,,2,1,1,2
C1(CCCC(C(O)=O)(O)O1)=O,,,5,1,1,0,1
83517_0,,,,2,1,1,2
C1(CC(CO)CC(C(O)=O)(O)O1)=O,,,5,1,1,0,1
83519_0,,,,2,1,1,2
C1(C(C=O)CCC(C=O)(O)O1)=O,,,5,1,1,0,1
83521_0,,,,2,1,1,2
C1(C(C=O)C(C=O)CC(O)O1)=O,,,5,1,1,0,1
83523_0,,,,2,1,1,2
C(C1CCC(OC1O)=O)(O)=O,,,5,1,1,0,1
83525_0,,,,2,1,1,2
C(C1C(O)OC(CC1CO)=O)(O)=O,,,5,1,1,0,1
83527_0,,,,2,1,1,2
C1(CCC(CO)C(C(O)=O)(O)O1)=O,,,5,1,1,0,1
83529_0,,,,2,1,1,2
C1(CCC(C(O)O1)(CC(O)=O)O)=O,,,5,1,1,0,1
83531_0,,,,2,1,1,2
C(C1CCC(OC1(CO)O)=O)(O)=O,,,5,1,1,0,1
83533_0,,,,2,1,1,2
C1(CCC(C(CC(O)=O)(O)O1)O)=O,,,5,1,1,0,1
83535_0,,,,2,1,1,2
C(C1(CCC(OC1(C)O)=O)O)(O)=O,,,5,1,1,0,1
83537_0,,,,2,1,1,2
C1(CCCC(C(C(O)=O)O)(O)O1)=O,,,5,1,1,0,1
83539_0,,,,2,1,1,2
C1(CCCC(C=O)(O)O1)=O,,,5,1,1,0,1
83541_0,,,,2,1,1,2
C(C1CC(O)OC(C1)=O)=O,,,5,1,1,0,1
83543_0,,,,2,1,1,2
C1(C(OC(C(C(O)=O)=O)CC1)O)=O,,,5,1,1,0,1
83545_0,,,,2,1,1,2
C(CC1C(O)OC(C(C1O)=O)=O)=O,,,5,1,1,0,1
83547_0,,,,2,1,1,2
C1(CCC(C(C(O)=O)(O)O1)O)=O,,,5,1,1,0,1
83549_0,,,,2,1,1,2
C1(CCC(C=O)C(C=O)(O)O1)=O,,,5,1,1,0,1
83551_0,,,,2,1,1,2
C1(CCC(C(C=O)=O)C(O)O1)=O,,,5,1,1,0,1
83553_0,,,,2,1,1,2
C(C1CCC(OC1(C=O)O)=O)(O)=O,,,5,1,1,0,1
83555_0,,,,2,1,1,2
C1(CCC(C(C(O)=O)=O)C(O)O1)=O,,,5,1,1,0,1
83557_0,,,,2,1,1,2
C1(CCC(C=O)C(C(O)=O)(O)O1)=O,,,5,1,1,0,1
83559_0,,,,2,1,1,2
C(CC1C(OC2C(C1OC2)=O)O)=O,,,5,1,1,0,1
83561_0,,,,2,1,1,2
C1(CCC2C(C(CO2)O)(O)O1)=O,,,5,1,1,0,1
83563_0,,,,2,1,1,2
C(C1(CCC2C(C(CO2)=O)O1)O)=O,,,5,1,1,0,1
83565_0,,,,2,1,1,2
C(C1C2C(C(CO2)=O)OC(C1)O)=O,,,5,1,1,0,1
83567_0,,,,2,1,1,2
C1(COCC21CCC(C(O2)O)=O)=O,,,5,1,1,0,1
83569_0,,,,2,1,1,2
C1(CCC2(COCC2(O)O1)O)=O,,,5,1,1,0,1
83571_0,,,,2,1,1,2
C1(C2(CCC(C(O2)O)=O)OCC1)=O,,,5,1,1,0,1
83573_0,,,,2,1,1,2
C1(CCC2(C(CCO2)(O)O1)O)=O,,,5,1,1,0,1
83575_0,,,,2,1,1,2
C(CC1C(OC2C(C1CO2)=O)O)=O,,,5,1,1,0,1
83577_0,,,,2,1,1,2
C1(CCC2COC(C2(O)O1)O)=O,,,5,1,1,0,1
83579_0,,,,2,1,1,2
C1(C2C(CO1)OC(C=O)(CC2)O)=O,,,5,1,1,0,1
83581_0,,,,2,1,1,2
C1(C2C(CO1)OC(CC2C=O)O)=O,,,5,1,1,0,1
83583_0,,,,2,1,1,2
C1(CC2C(CCC(C=O)(O)O2)O1)=O,,,5,1,1,0,1
83585_0,,,,2,1,1,2
C(C1CC(O)OC2C1OC(C2)=O)=O,,,5,1,1,0,1
83587_0,,,,2,1,1,2
C1(CC2(CCC(C(O)O2)=O)CO1)=O,,,5,1,1,0,1
83589_0,,,,2,1,1,2
C(C1(CCC2C(COC2O1)=O)O)=O,,,5,1,1,0,1
83591_0,,,,2,1,1,2
C(C1CC(O)OC2C1C(CO2)=O)=O,,,5,1,1,0,1
83593_0,,,,2,1,1,2
C1(CCC2C(O)OCC2(O)O1)=O,,,5,1,1,0,1
83595_0,,,,2,1,1,2
C1(COC2(CCC(C(O)O2)=O)C1)=O,,,5,1,1,0,1
83597_0,,,,2,1,1,2
C1(CCC2C(CC(O)O2)(O)O1)=O,,,5,1,1,0,1
83599_0,,,,2,1,1,2
C1(CCCC(C(C=O)=O)(O)O1)=O,,,5,1,1,0,1
83601_0,,,,2,1,1,2
C1(C(OC(C=CC(O)=O)CC1)O)=O,,,5,1,1,0,1
83603_0,,,,2,1,1,2
C(C1(C=C)CCC(C(O1)O)=O)(O)=O,,,5,1,1,0,1
83605_0,,,,2,1,1,2
C1(C(C=C)(CCC(C=O)(O)O1)O)=O,,,5,1,1,0,1
83607_0,,,,2,1,1,2
C1(C2(CCC(C(O2)O)=O)CCO1)=O,,,5,1,1,0,1
83609_0,,,,2,1,1,2
C1(C2C(CO1)CCC(C=O)(O2)O)=O,,,5,1,1,0,1
83611_0,,,,2,1,1,2
C(C1(CCC(C(O1)O)=O)O)=O,,,5,1,1,0,1
83613_0,,,,2,1,1,2
C(C1(C)CCC(C(O1)O)=O)=O,,,5,1,1,0,1
83615_0,,,,2,1,1,2
C(C1CCCC(C=O)(O1)O)=O,,,5,1,1,0,1
83617_0,,,,2,1,1,2
C1(C(O)O[C](C(O)=O)CC1)=O,,,5,1,1,0,1
83619_0,,,,2,1,1,2
C(C1(CC[C](C(O1)=O)O)O)=O,,,5,1,1,0,1
83621_0,,,,2,1,1,2
C(C1(CO)CCC(C(O1)O)=O)=O,,,5,1,1,0,1
83623_0,,,,2,1,1,2
C(C1(COC(C=O)(CC1)O)O)=O,,,5,1,1,0,1
83625_0,,,,2,1,1,2
C(C1C(CCC(C=O)(O1)O)O)=O,,,5,1,1,0,1
83627_0,,,,2,1,1,2
C(C(C1CCC(C(O)O1)=O)O)=O,,,5,1,1,0,1
83629_0,,,,2,1,1,2
C1(C(O)OCCC1)=O,,,5,1,1,0,1
83631_0,,,,2,1,1,2
C1(C(O)OC(CO)CC1)=O,,,5,1,1,0,1
83633_0,,,,2,1,1,2
C(C1(CCC(CO1)O)O)=O,,,5,1,1,0,1
83635_0,,,,2,1,1,2
C1(C(CCC(C=O)(O)O1)O)=O,,,5,1,1,0,1
83637_0,,,,2,1,1,2
C(C1CCC(C(O1)O)=O)(O)=O,,,5,1,1,0,1
83639_0,,,,2,1,1,2
C(CO)(C1CCC(C(O1)O)=O)=O,,,5,1,1,0,1
83641_0,,,,2,1,1,2
C(C1(CCC(CO)(CO1)O)O)=O,,,5,1,1,0,1
83643_0,,,,2,1,1,2
C1(C(O)OC(CO)(CO)CC1)=O,,,5,1,1,0,1
83645_0,,,,2,1,1,2
C1(C(O)OC(CC1)C(CO)O)=O,,,5,1,1,0,1
83647_0,,,,2,1,1,2
C(C1(CCC(C(CO)O1)O)O)=O,,,5,1,1,0,1
83649_0,,,,2,1,1,2
C1(C(CO)(CCC(C=O)(O)O1)O)=O,,,5,1,1,0,1
83651_0,,,,2,1,1,2
C(C1(CO)CCC(C(O1)O)=O)(O)=O,,,5,1,1,0,1
83653_0,,,,2,1,1,2
C(C1(COC(C=O)(CC1)O)O)(O)=O,,,5,1,1,0,1
83655_0,,,,2,1,1,2
C(C1C(CCC(C=O)(O1)O)O)(O)=O,,,5,1,1,0,1
83657_0,,,,2,1,1,2
C(C(C1CCC(C(O)O1)=O)O)(O)=O,,,5,1,1,0,1
83659_0,,,,2,1,1,2
C1(C(O)OC(CC1)CC(C=O)=O)=O,,,5,1,1,0,1
83661_0,,,,2,1,1,2
C(C1(CCC(C(C=O)=O)CO1)O)=O,,,5,1,1,0,1
83663_0,,,,2,1,1,2
C(CC1(C=O)CCC(C(O1)O)=O)=O,,,5,1,1,0,1
83665_0,,,,2,1,1,2
C(C1CCC(C=O)(OC1C=O)O)=O,,,5,1,1,0,1
83667_0,,,,2,1,1,2
C(C1CCC(C(O1)O)=O)(CC=O)=O,,,5,1,1,0,1
83669_0,,,,2,1,1,2
C(C)(C1(C=O)CCC(C(O1)O)=O)=O,,,5,1,1,0,1
83671_0,,,,2,1,1,2
C(C1(C)CCC(C(O1)O)=O)(O)=O,,,5,1,1,0,1
83673_0,,,,2,1,1,2
C1(C(C)(CCC(C=O)(O)O1)O)=O,,,5,1,1,0,1
83675_0,,,,2,1,1,2
C(C1CCCC(C=O)(O1)O)(O)=O,,,5,1,1,0,1
83677_0,,,,2,1,1,2
C1(C(OC(C(C=O)=O)CC1)O)=O,,,5,1,1,0,1
83679_0,,,,2,1,1,2
C1(C(C=C)(C(C=O)CC(O)O1)O)=O,,,5,1,1,0,1
83681_0,,,,2,1,1,2
C(CC1C(OC2C(OC1C2)=O)O)=O,,,5,1,1,0,1
83683_0,,,,2,1,1,2
C(C1CC(OC2C(OCC21)=O)O)=O,,,5,1,1,0,1
83685_0,,,,2,1,1,2
C(C1CC(C=O)OC(C1)O)=O,,,5,1,1,0,1
83687_0,,,,2,1,1,2
C(C1[C](C(OC(C1)O)=O)O)=O,,,5,1,1,0,1
83689_0,,,,2,1,1,2
C(C1C(C(C=O)OC(C1)O)O)=O,,,5,1,1,0,1
83691_0,,,,2,1,1,2
C(C1CC(O)OCC1(CO)O)=O,,,5,1,1,0,1
83693_0,,,,2,1,1,2
C(C1CC(O)OC(CO)C1O)=O,,,5,1,1,0,1
83695_0,,,,2,1,1,2
C(CC1C(O)OCC(C1O)O)=O,,,5,1,1,0,1
83697_0,,,,2,1,1,2
C(C1CC(O)OC(C1(CO)O)=O)=O,,,5,1,1,0,1
83699_0,,,,2,1,1,2
C(C1CC(O)OCC1(C(O)=O)O)=O,,,5,1,1,0,1
83701_0,,,,2,1,1,2
C(CC1C(O)OC(C(C1O)O)=O)=O,,,5,1,1,0,1
83703_0,,,,2,1,1,2
C(C1C(C(C(O)=O)OC(C1)O)O)=O,,,5,1,1,0,1
83705_0,,,,2,1,1,2
C(C1CC(O)OCC1C(C=O)=O)=O,,,5,1,1,0,1
83707_0,,,,2,1,1,2
C(C1C(C=O)C(C=O)CC(O1)O)=O,,,5,1,1,0,1
83709_0,,,,2,1,1,2
C(CC1C(OCC(C1C=O)=O)O)=O,,,5,1,1,0,1
83711_0,,,,2,1,1,2
C(C1C(CC(C(O1)O)CC=O)=O)=O,,,5,1,1,0,1
83713_0,,,,2,1,1,2
C(C1CC(C(O)=O)OC(C1)O)=O,,,5,1,1,0,1
83715_0,,,,2,1,1,2
C(CC1C(O)OC(C(C1)O)=O)=O,,,5,1,1,0,1
83717_0,,,,2,1,1,2
C1(CCC2(C(C(CO2)O)(O)O1)O)=O,,,5,1,1,0,1
83719_0,,,,2,1,1,2
C1(CCC2(COC(C2(O)O1)O)O)=O,,,5,1,1,0,1
83721_0,,,,2,1,1,2
C1(CCC(C(O)O1)(O)O)=O,,,5,1,1,0,1
83723_0,,,,2,1,1,2
C1(CCC(C)(C(O)O1)O)=O,,,5,1,1,0,1
83725_0,,,,2,1,1,2
C1(CCC(CO)(C(O)O1)O)=O,,,5,1,1,0,1
83727_0,,,,2,1,1,2
C1(CCC(C(O)O1)(C(CO)O)O)=O,,,5,1,1,0,1
83729_0,,,,2,1,1,2
C1(CCC(C(O)O1)(C(C=O)O)O)=O,,,5,1,1,0,1
83731_0,,,,2,1,1,2
C1(CCC(C(CO)(O)O1)O)=O,,,5,1,1,0,1
83733_0,,,,2,1,1,2
C1(CCC(C(C(CO)O)(O)O1)O)=O,,,5,1,1,0,1
83735_0,,,,2,1,1,2
C1(CCC(CO)(C(CO)(O)O1)O)=O,,,5,1,1,0,1
83737_0,,,,2,1,1,2
C(C1CCC(OC1O)=O)=O,,,5,1,1,0,1
83739_0,,,,2,1,1,2
C1(CCC(CO)C(C=O)(O)O1)=O,,,5,1,1,0,1
83741_0,,,,2,1,1,2
C1(CCC(C(O)O1)(CC=O)O)=O,,,5,1,1,0,1
83743_0,,,,2,1,1,2
C1(CCC(C(O)O1)C(C=O)O)=O,,,5,1,1,0,1
83745_0,,,,2,1,1,2
C1(CCC(C(CO)=O)C(O)O1)=O,,,5,1,1,0,1
83747_0,,,,2,1,1,2
C(C1CCC(OC1(CO)O)=O)=O,,,5,1,1,0,1
83749_0,,,,2,1,1,2
C1(CCC(C(CC=O)(O)O1)O)=O,,,5,1,1,0,1
83751_0,,,,2,1,1,2
C1(CCC(C(C)=O)(C(O)O1)O)=O,,,5,1,1,0,1
83753_0,,,,2,1,1,2
C(C1(CCC(OC1(C)O)=O)O)=O,,,5,1,1,0,1
83755_0,,,,2,1,1,2
C1(CCCC(C(C=O)O)(O)O1)=O,,,5,1,1,0,1
83757_0,,,,2,1,1,2
C1(CCCC(O)O1)=O,,,5,1,1,0,1
83759_0,,,,2,1,1,2
C1(CCC(C(C=O)(O)O1)O)=O,,,5,1,1,0,1
83761_0,,,,2,1,1,2
C1(CCC(CO)(C(C=O)(O)O1)O)=O,,,5,1,1,0,1
83763_0,,,,2,1,1,2
C1(CCC(C(O)O1)O)=O,,,5,1,1,0,1
83765_0,,,,2,1,1,2
C1(CC(CO)C(C(O)O1)(O)O)=O,,,5,1,1,0,1
83767_0,,,,2,1,1,2
C1(CC(CO)C(C)(C(O)O1)O)=O,,,5,1,1,0,1
83769_0,,,,2,1,1,2
C(CC1COC(C(C1)O)O)(O)=O,,,5,1,1,0,1
83771_0,,,,2,1,1,2
C1(CC(CO)C(CO)(C(O)O1)O)=O,,,5,1,1,0,1
83773_0,,,,2,1,1,2
C(CC1COC(C(C1O)O)O)(O)=O,,,5,1,1,0,1
83775_0,,,,2,1,1,2
C1(CC(CO)C(C(CO)(O)O1)O)=O,,,5,1,1,0,1
83777_0,,,,2,1,1,2
C1(CC(CO)CC(C=O)(O)O1)=O,,,5,1,1,0,1
83779_0,,,,2,1,1,2
C(CC1COC(C(C1)=O)O)(O)=O,,,5,1,1,0,1
83781_0,,,,2,1,1,2
C(C1C(O)OC(CC1CO)=O)=O,,,5,1,1,0,1
83783_0,,,,2,1,1,2
C1(CC(CO)CC(O)O1)=O,,,5,1,1,0,1
83785_0,,,,2,1,1,2
C1(CC(CO)C(C(C=O)(O)O1)O)=O,,,5,1,1,0,1
83787_0,,,,2,1,1,2
C(CC1COC(C(C1O)=O)O)(O)=O,,,5,1,1,0,1
83789_0,,,,2,1,1,2
C1(CC(CO)C(C(O)O1)O)=O,,,5,1,1,0,1
83791_0,,,,2,1,1,2
C1(C(C(C(O)=O)(O)OCC1O)O)=O,,,5,1,1,0,1
83793_0,,,,2,1,1,2
C1(C(O)OC(C(C1O)=O)=O)=O,,,5,1,1,0,1
83795_0,,,,2,1,1,2
C1(C(O)OC(C(C1(CO)O)=O)=O)=O,,,5,1,1,0,1
83797_0,,,,2,1,1,2
C(C1(C(C(OC(C1)O)=O)=O)O)=O,,,5,1,1,0,1
83799_0,,,,2,1,1,2
C1(C(C(CO)(CC(O)O1)O)=O)=O,,,5,1,1,0,1
83801_0,,,,2,1,1,2
C1(C(C(C)(C(C(O)O1)O)O)=O)=O,,,5,1,1,0,1
83803_0,,,,2,1,1,2
C(C1CCC(C(O1)O)O)(O)=O,,,5,1,1,0,1
83805_0,,,,2,1,1,2
C1C(CO)(CC(C(O)O1)O)O,,,5,1,1,0,1
83807_0,,,,2,1,1,2
C1C(CC(C(O)O1)O)(C(CO)O)O,,,5,1,1,0,1
83809_0,,,,2,1,1,2
C1(C(CC(CO)(C(CO)O1)O)O)O,,,5,1,1,0,1
83811_0,,,,2,1,1,2
C(CC1C(CC(C(O)O1)O)O)=O,,,5,1,1,0,1
83813_0,,,,2,1,1,2
C(C1CC(C)(C(C(O1)O)O)O)=O,,,5,1,1,0,1
83815_0,,,,2,1,1,2
C(C1C(C)(CC(C(O1)O)O)O)=O,,,5,1,1,0,1
83817_0,,,,2,1,1,2
C(C1(C(CO)OC(C(C1)O)O)O)=O,,,5,1,1,0,1
83819_0,,,,2,1,1,2
C(C(C1C(CC(C(O)O1)O)O)O)O,,,5,1,1,0,1
83821_0,,,,2,1,1,2
C1C(CC(C(O)O1)O)O,,,5,1,1,0,1
83823_0,,,,2,1,1,2
C(C1COC(C(C(C1O)O)O)O)=O,,,5,1,1,0,1
83825_0,,,,2,1,1,2
C1C(CO)(CC(CC(O)O1)O)O,,,5,1,1,0,1
83827_0,,,,2,1,1,2
C1C(CO)(CC(C(C(O)O1)O)O)O,,,5,1,1,0,1
83828_0,,,,2,1,1,2
83830_0,,,,2,1,1,2
C1(COC(C(CO)C(C1O)O)O)=O,,,5,1,1,0,1
83832_0,,,,2,1,1,2
C1(C(C(C(O)OC(C)C1O)O)O)=O,,,5,1,1,0,1
83834_0,,,,2,1,1,2
C1(C(C(C(C(C(O)O1)O)O)=O)O)=O,,,5,1,1,0,1
83835_0,,,,2,1,1,2
83837_0,,,,2,1,1,2
C(C1(CC(C(OC(C1)O)=O)O)O)=O,,,5,1,1,0,1
83839_0,,,,2,1,1,2
C1(CC(C(O)=O)OC(CC1O)O)=O,,,5,1,1,0,1
83841_0,,,,2,1,1,2
C(C1C(CC(O)OC(C1O)=O)O)=O,,,5,1,1,0,1
83843_0,,,,2,1,1,2
C1(C(CC(C(CO)C(O)O1)O)O)=O,,,5,1,1,0,1
83845_0,,,,2,1,1,2
C1(C(CC(C(C(C)(O)O1)O)O)O)=O,,,5,1,1,0,1
83847_0,,,,2,1,1,2
C1(C(CC(CC(CO)(O)O1)O)O)=O,,,5,1,1,0,1
83848_0,,,,2,1,1,2
83850_0,,,,2,1,1,2
C1(C(CC(CC(C=O)(O)O1)O)O)=O,,,5,1,1,0,1
83852_0,,,,2,1,1,2
C(C1C(O)OC(C(CC1O)O)=O)=O,,,5,1,1,0,1
83854_0,,,,2,1,1,2
C1(C(CC(CC(O)O1)O)O)=O,,,5,1,1,0,1
83856_0,,,,2,1,1,2
C1(C(CC(C(C(O)O1)O)O)O)=O,,,5,1,1,0,1
83858_0,,,,2,1,1,2
C(C1(C)CC(C(CC(O1)O)O)=O)=O,,,5,1,1,0,1
83860_0,,,,2,1,1,2
C(C1COC(C(C)(CC1O)O)O)=O,,,5,1,1,0,1
83862_0,,,,2,1,1,2
C(C1(C)CC(CC(C(O1)O)=O)O)=O,,,5,1,1,0,1
83864_0,,,,2,1,1,2
C(C1COC(CC(C)(C1O)O)O)=O,,,5,1,1,0,1
83866_0,,,,2,1,1,2
C(C1C(CCOC(C1(C)O)O)O)=O,,,5,1,1,0,1
83868_0,,,,2,1,1,2
C1(CC(C(C)=O)OC(CC1O)O)=O,,,5,1,1,0,1
83870_0,,,,2,1,1,2
C1(C(CC(C=O)(O)OC(C1)=O)O)=O,,,5,1,1,0,1
83872_0,,,,2,1,1,2
C1(C(CC(C=O)(O)OC(C)C1)O)=O,,,5,1,1,0,1
83874_0,,,,2,1,1,2
C(C1C(O)OC(CC(C1O)=O)=O)=O,,,5,1,1,0,1
83876_0,,,,2,1,1,2
C(C1C(O)OC(C)CC(C1O)=O)=O,,,5,1,1,0,1
83878_0,,,,2,1,1,2
C(C1COC(C)(C(CC1O)O)O)=O,,,5,1,1,0,1
83880_0,,,,2,1,1,2
C(C)(C1CC(CC(C(O1)O)=O)O)=O,,,5,1,1,0,1
83882_0,,,,2,1,1,2
C(C1COC(CC(C1(C)O)O)O)=O,,,5,1,1,0,1
83884_0,,,,2,1,1,2
C(C1C(C(C)(O)OCCC1O)O)=O,,,5,1,1,0,1
83886_0,,,,2,1,1,2
C1(C(CC(O)OC(CCO)C1)O)=O,,,5,1,1,0,1
83888_0,,,,2,1,1,2
C1(C(CC(O)OC(CO)(C)C1)O)=O,,,5,1,1,0,1
83889_0,,,,2,1,1,2
83891_0,,,,2,1,1,2
C1(C(CC(O)OC(C(O)O)C1)O)=O,,,5,1,1,0,1
83893_0,,,,2,1,1,2
C1(C(CC(O)OC(C(C)O)C1)O)=O,,,5,1,1,0,1
83895_0,,,,2,1,1,2
C1(CC(C=O)OC(CC1O)O)=O,,,5,1,1,0,1
83897_0,,,,2,1,1,2
C(CC1C(CC(CC(O1)O)O)=O)=O,,,5,1,1,0,1
83899_0,,,,2,1,1,2
C(CC1CC(C(CC(O)O1)O)=O)=O,,,5,1,1,0,1
83901_0,,,,2,1,1,2
C1(C(CC(O)OC(C)C1)O)=O,,,5,1,1,0,1
83902_0,,,,2,1,1,2
83903_0,,,,2,1,1,2
83905_0,,,,2,1,1,2
C1(C(C(C=O)OC(C(C1)O)O)O)=O,,,5,1,1,0,1
83907_0,,,,2,1,1,2
C1(CC(C=O)OC(C(C1O)O)O)=O,,,5,1,1,0,1
83909_0,,,,2,1,1,2
C1(C(C(C(O)OC(C)C1)O)O)=O,,,5,1,1,0,1
83911_0,,,,2,1,1,2
C1(C(C(C(O)OC(CO)C1)O)O)=O,,,5,1,1,0,1
83913_0,,,,2,1,1,2
C(CC1CC(CC(C(O)O1)=O)O)=O,,,5,1,1,0,1
83915_0,,,,2,1,1,2
C1(C(C=O)C(CC(C(O)O1)=O)O)=O,,,5,1,1,0,1
83917_0,,,,2,1,1,2
C(C1C(CC(C(O)OC1C)=O)O)=O,,,5,1,1,0,1
83918_0,,,,2,1,1,2
83920_0,,,,2,1,1,2
C(C1(CC(C)OC(C(C1)=O)O)O)=O,,,5,1,1,0,1
83922_0,,,,2,1,1,2
C1(C(C(C(O)OC(C)C1)CO)O)=O,,,5,1,1,0,1
83924_0,,,,2,1,1,2
C1(C(C(C(C)(O)OC(C)C1)O)O)=O,,,5,1,1,0,1
83926_0,,,,2,1,1,2
C1(C(CC(CO)(O)OC(C)C1)O)=O,,,5,1,1,0,1
83928_0,,,,2,1,1,2
C1(C(O)OCCC(C1C(C)O)O)=O,,,5,1,1,0,1
83930_0,,,,2,1,1,2
C(C1(CC(O)OCC(C1)O)O)=O,,,5,1,1,0,1
83932_0,,,,2,1,1,2
C(C1(C(C(O)OCC(C1)O)O)O)=O,,,5,1,1,0,1
83934_0,,,,2,1,1,2
C(C)(C1C(CC(CC(O1)O)O)O)=O,,,5,1,1,0,1
83936_0,,,,2,1,1,2
C(C1C(CC(CC(O1)O)O)O)=O,,,5,1,1,0,1
83938_0,,,,2,1,1,2
C(C1C(CC(O)OCC1(C)O)O)=O,,,5,1,1,0,1
83940_0,,,,2,1,1,2
C(C1C(C(O)OC(CC1O)O)O)=O,,,5,1,1,0,1
83942_0,,,,2,1,1,2
C(C1C(CC(O)OC(C)C1O)O)=O,,,5,1,1,0,1
83943_0,,,,2,1,1,2
83945_0,,,,2,1,1,2
C(C1COC(C(C(C1O)O)=O)O)=O,,,5,1,1,0,1
83946_0,,,,2,1,1,2
83948_0,,,,2,1,1,2
C(C1C(CC(C(C(O1)O)O)O)O)=O,,,5,1,1,0,1
83950_0,,,,2,1,1,2
C(C1C(COC(C(C1O)O)O)O)=O,,,5,1,1,0,1
83952_0,,,,2,1,1,2
C1(COC(C(C(C1)O)C(C)O)O)=O,,,5,1,1,0,1
83953_0,,,,2,1,1,2
83955_0,,,,2,1,1,2
C1(C(CC(C(CO)C(O)O1)O)=O)=O,,,5,1,1,0,1
83956_0,,,,2,1,1,2
83957_0,,,,2,1,1,2
83959_0,,,,2,1,1,2
C1(C(C(C(O)OCC1)C(C)O)O)=O,,,5,1,1,0,1
83960_0,,,,2,1,1,2
83962_0,,,,2,1,1,2
C1(C(C(C(CC(O)O1)O)=O)CO)=O,,,5,1,1,0,1
83963_0,,,,2,1,1,2
83965_0,,,,2,1,1,2
C1(C(CC(O)OC(C)C1CO)O)=O,,,5,1,1,0,1
83966_0,,,,2,1,1,2
83967_0,,,,2,1,1,2
83968_0,,,,2,1,1,2
83970_0,,,,2,1,1,2
C(CC1CC(C(CC(O)O1)O)O)=O,,,5,1,1,0,1
83972_0,,,,2,1,1,2
C(CC1C(CC(CC(O)O1)O)O)=O,,,5,1,1,0,1
83974_0,,,,2,1,1,2
C1(C(C=O)C(C(CC(O)O1)O)O)=O,,,5,1,1,0,1
83976_0,,,,2,1,1,2
C(C1C(C)OC(CC(C1O)O)O)=O,,,5,1,1,0,1
83978_0,,,,2,1,1,2
C(C1COC(CC(C1O)O)O)=O,,,5,1,1,0,1
83980_0,,,,2,1,1,2
C(CC1CC(CC(C(O)O1)O)O)=O,,,5,1,1,0,1
83982_0,,,,2,1,1,2
C1(C(C=O)C(CC(C(O)O1)O)O)=O,,,5,1,1,0,1
83984_0,,,,2,1,1,2
C(C1C(C)OC(C(CC1O)O)O)=O,,,5,1,1,0,1
83986_0,,,,2,1,1,2
C(C1COC(C(CC1O)O)O)=O,,,5,1,1,0,1
83987_0,,,,2,1,1,2
83988_0,,,,2,1,1,2
83989_0,,,,2,1,1,2
83990_0,,,,2,1,1,2
83991_0,,,,2,1,1,2
83992_0,,,,2,1,1,2
83993_0,,,,2,1,1,2
83994_0,,,,2,1,1,2
83995_0,,,,2,1,1,2
83996_0,,,,2,1,1,2
83997_0,,,,2,1,1,2
83999_0,,,,2,1,1,2
C(C1C(C(C(C(O)OC1)O)O)=O)=O,,,5,1,1,0,1
84000_0,,,,2,1,1,2
84002_0,,,,2,1,1,2
C(C1C(C)(CC(CC(O1)O)O)O)=O,,,5,1,1,0,1
84003_0,,,,2,1,1,2
84005_0,,,,2,1,1,2
C1(C(C)(O)OC(C)CC(C1O)O)=O,,,5,1,1,0,1
84007_0,,,,2,1,1,2
C1(C(CO)(O)OC(C)CC(C1)O)=O,,,5,1,1,0,1
84009_0,,,,2,1,1,2
C(C1C(C(O)OC(C)CC1O)=O)=O,,,5,1,1,0,1
84011_0,,,,2,1,1,2
C(C1(C(CC(CC(C)O1)O)=O)O)=O,,,5,1,1,0,1
84013_0,,,,2,1,1,2
C1(C(O)OC(C)CC(C1)O)=O,,,5,1,1,0,1
84015_0,,,,2,1,1,2
C1(C(O)OC(C)CC(C1CO)O)=O,,,5,1,1,0,1
84017_0,,,,2,1,1,2
C(C1C(C(O)OC(C)CC1O)O)=O,,,5,1,1,0,1
84019_0,,,,2,1,1,2
C1(C(O)OC(C)CC(C1O)O)=O,,,5,1,1,0,1
84021_0,,,,2,1,1,2
CC(C1C(O)OCC(CC1O)O)O,,,5,1,1,0,1
84023_0,,,,2,1,1,2
CC(C1C(O)OCCC(C1O)O)O,,,5,1,1,0,1
84025_0,,,,2,1,1,2
C(C1C(C)OC(CC(C1O)=O)O)=O,,,5,1,1,0,1
84027_0,,,,2,1,1,2
C1(C(CC(O)OC(C)C1O)O)=O,,,5,1,1,0,1
84029_0,,,,2,1,1,2
C1(C(O)OC(C)C(C(C1)O)O)=O,,,5,1,1,0,1
84031_0,,,,2,1,1,2
C1(C(O)OC(C)C(C(C1O)O)O)=O,,,5,1,1,0,1
84033_0,,,,2,1,1,2
C(C1(COC(CC(C1)O)O)O)=O,,,5,1,1,0,1
84035_0,,,,2,1,1,2
C(C1(COC(C(C(C1)O)O)O)O)=O,,,5,1,1,0,1
84036_0,,,,2,1,1,2
84038_0,,,,2,1,1,2
C1(C(C(C=O)OC(CC1O)O)O)=O,,,5,1,1,0,1
84039_0,,,,2,1,1,2
84040_0,,,,2,1,1,2
84042_0,,,,2,1,1,2
C(C1C(CC(CC(O)O1)O)O)O,,,5,1,1,0,1
84044_0,,,,2,1,1,2
C(C1C(CC(C(C(O)O1)O)O)O)O,,,5,1,1,0,1
84045_0,,,,2,1,1,2
84047_0,,,,2,1,1,2
C1(C(C)(O)OCCC(C1O)O)=O,,,5,1,1,0,1
84049_0,,,,2,1,1,2
C1(C(CO)(O)OCCC(C1)O)=O,,,5,1,1,0,1
84051_0,,,,2,1,1,2
C(C1C(C(O)OCCC1O)=O)=O,,,5,1,1,0,1
84053_0,,,,2,1,1,2
C(C1C(C(O)OCCC1O)=O)(O)=O,,,5,1,1,0,1
84055_0,,,,2,1,1,2
C(C1(C(CC(CCO1)O)=O)O)=O,,,5,1,1,0,1
84057_0,,,,2,1,1,2
C1(C(O)OCCC(C1)O)=O,,,5,1,1,0,1
84059_0,,,,2,1,1,2
C1(C(O)OCCC(C1CO)O)=O,,,5,1,1,0,1
84061_0,,,,2,1,1,2
C(C1C(C(O)OCCC1O)O)=O,,,5,1,1,0,1
84063_0,,,,2,1,1,2
C1(C(O)OCCC(C1O)O)=O,,,5,1,1,0,1
84065_0,,,,2,1,1,2
C1C(CC(C(C(O)O1)CO)O)O,,,5,1,1,0,1
84067_0,,,,2,1,1,2
C(C1COC(C(C(C1O)=O)O)O)=O,,,5,1,1,0,1
84069_0,,,,2,1,1,2
C1CC(C(C(C(O)O1)CO)O)O,,,5,1,1,0,1
84071_0,,,,2,1,1,2
C1(CC(C(C(CO)C(O)O1)O)O)=O,,,5,1,1,0,1
84072_0,,,,2,1,1,2
84074_0,,,,2,1,1,2
C1(CC(C(C(CO)C(O)O1)O)=O)=O,,,5,1,1,0,1
84076_0,,,,2,1,1,2
CC1(C(C(CC(CO1)O)O)O)O,,,5,1,1,0,1
84078_0,,,,2,1,1,2
C1C(CC(CC(CO)(O)O1)O)O,,,5,1,1,0,1
84080_0,,,,2,1,1,2
C(C1(CC(CC(CO1)O)O)O)(O)=O,,,5,1,1,0,1
84082_0,,,,2,1,1,2
C(C1C(O)OCC(CC1O)O)(O)=O,,,5,1,1,0,1
84084_0,,,,2,1,1,2
C1C(CC(C(C(CO)(O)O1)O)O)O,,,5,1,1,0,1
84086_0,,,,2,1,1,2
C(C1(CC(CC(CO1)O)O)O)=O,,,5,1,1,0,1
84087_0,,,,2,1,1,2
84089_0,,,,2,1,1,2
C(C1C(O)OCC(CC1O)O)=O,,,5,1,1,0,1
84091_0,,,,2,1,1,2
C1C(CC(CC(O)O1)O)O,,,5,1,1,0,1
84093_0,,,,2,1,1,2
C(C1(C(C(CC(CO1)O)O)O)O)=O,,,5,1,1,0,1
84094_0,,,,2,1,1,2
84096_0,,,,2,1,1,2
C1C(CC(C(C(O)O1)O)O)O,,,5,1,1,0,1
84098_0,,,,2,1,1,2
C(C1C(C(CC(C(O1)O)=O)O)=O)=O,,,5,1,1,0,1
84100_0,,,,2,1,1,2
C(C1(C(C(OCC(C1)=O)O)O)O)=O,,,5,1,1,0,1
84102_0,,,,2,1,1,2
C1(COC(C(C(CO)(C1)O)O)O)=O,,,5,1,1,0,1
84103_0,,,,2,1,1,2
84104_0,,,,2,1,1,2
84105_0,,,,2,1,1,2
84107_0,,,,2,1,1,2
C1(C(C(COC(C1O)O)(C)O)O)=O,,,5,1,1,0,1
84109_0,,,,2,1,1,2
C1(C(C(C(O)OC(C1O)O)O)O)=O,,,5,1,1,0,1
84111_0,,,,2,1,1,2
C1(C(C(C(C)OC(C1O)O)O)O)=O,,,5,1,1,0,1
84113_0,,,,2,1,1,2
C1(C(C(C(OC(C1O)O)=O)O)O)=O,,,5,1,1,0,1
84115_0,,,,2,1,1,2
C(C1C(C(C(CC(O1)O)O)O)=O)=O,,,5,1,1,0,1
84116_0,,,,2,1,1,2
84118_0,,,,2,1,1,2
C1(COC(C(CC1(C)O)=O)O)=O,,,5,1,1,0,1
84120_0,,,,2,1,1,2
C1(COC(C(C(C1(C)O)O)=O)O)=O,,,5,1,1,0,1
84122_0,,,,2,1,1,2
C1(CC(C(C(C(C)(O)O1)=O)O)O)=O,,,5,1,1,0,1
84124_0,,,,2,1,1,2
C1(C(C)(O)OCC(C(C1O)O)O)=O,,,5,1,1,0,1
84126_0,,,,2,1,1,2
C1(C(C(C(C(C)(OC1)O)=O)O)O)=O,,,5,1,1,0,1
84128_0,,,,2,1,1,2
C1(CC(CC(C(CO)(O)O1)=O)O)=O,,,5,1,1,0,1
84130_0,,,,2,1,1,2
C(C1(C(OCC(C(C1)=O)=O)O)O)=C,,,5,1,1,0,1
84132_0,,,,2,1,1,2
C(C1(C(CC(C(CO1)=O)=O)O)O)=C,,,5,1,1,0,1
84133_0,,,,2,1,1,2
84135_0,,,,2,1,1,2
C1(C(COC(C(C1)O)O)=O)=O,,,5,1,1,0,1
84137_0,,,,2,1,1,2
C1(C(COC(C(C)(C1)O)O)=O)=O,,,5,1,1,0,1
84138_0,,,,2,1,1,2
84140_0,,,,2,1,1,2
C1(C(COC(C(CO)(C1)O)O)=O)=O,,,5,1,1,0,1
84141_0,,,,2,1,1,2
84143_0,,,,2,1,1,2
C1(C(COC(CO)(C(C1)O)O)=O)=O,,,5,1,1,0,1
84145_0,,,,2,1,1,2
C1(C(OC(C(C(C1)O)=O)C)O)=O,,,5,1,1,0,1
84147_0,,,,2,1,1,2
C1(C(C(C(C(C)OC1O)=O)O)O)=O,,,5,1,1,0,1
84148_0,,,,2,1,1,2
84150_0,,,,2,1,1,2
C1(C(C(C(C(C(O)O1)O)O)O)=O)=O,,,5,1,1,0,1
84152_0,,,,2,1,1,2
C1(C2C(C(C(OC1CO2)O)O)O)=O,,,5,1,1,0,1
84154_0,,,,2,1,1,2
C1(C2OC(C(C(C1CO2)O)O)O)=O,,,5,1,1,0,1
84156_0,,,,2,1,1,2
C(C1C(CC(C(C(O1)O)=O)=O)O)=O,,,5,1,1,0,1
84158_0,,,,2,1,1,2
C(C1C(COC(C(C1O)O)O)=O)=O,,,5,1,1,0,1
84160_0,,,,2,1,1,2
C1(C(C(C(C=O)OC(C1)O)O)O)=O,,,5,1,1,0,1
84162_0,,,,2,1,1,2
C(C1C(CC(C(C(O1)O)O)O)=O)=O,,,5,1,1,0,1
84164_0,,,,2,1,1,2
C1(C(C(OC(C=O)C(C1)O)O)O)=O,,,5,1,1,0,1
84166_0,,,,2,1,1,2
C1(C(C(O)OCC(C)(C1)O)=O)=O,,,5,1,1,0,1
84168_0,,,,2,1,1,2
C1(C(C(COC(C1)O)(C)O)O)=O,,,5,1,1,0,1
84170_0,,,,2,1,1,2
C1(C(C(O)OCC(C)(C1)O)O)=O,,,5,1,1,0,1
84172_0,,,,2,1,1,2
CC1(C(C(C(CCO1)O)O)O)O,,,5,1,1,0,1
84174_0,,,,2,1,1,2
C1(CC(C(C(C(C)(O)O1)O)O)O)=O,,,5,1,1,0,1
84176_0,,,,2,1,1,2
C1(CC(C(C(C(C)(O)O1)O)O)=O)=O,,,5,1,1,0,1
84178_0,,,,2,1,1,2
C1(C(CC(C(C(C)(O)O1)O)O)=O)=O,,,5,1,1,0,1
84180_0,,,,2,1,1,2
CC1(C(C(C(C(CO1)O)O)O)O)O,,,5,1,1,0,1
84182_0,,,,2,1,1,2
C1(C(C(C(C)(O)OCC1)O)O)=O,,,5,1,1,0,1
84184_0,,,,2,1,1,2
C1(COC(C)(C(C(C1)O)O)O)=O,,,5,1,1,0,1
84186_0,,,,2,1,1,2
C1CC(C(CC(CO)(O)O1)O)O,,,5,1,1,0,1
84188_0,,,,2,1,1,2
C1(CC(C(CC(CO)(O)O1)O)O)=O,,,5,1,1,0,1
84189_0,,,,2,1,1,2
84191_0,,,,2,1,1,2
C1(CC(C(CC(CO)(O)O1)O)=O)=O,,,5,1,1,0,1
84193_0,,,,2,1,1,2
C1(C(CC(CC(CO)(O)O1)O)=O)=O,,,5,1,1,0,1
84194_0,,,,2,1,1,2
84196_0,,,,2,1,1,2
C(C1(CC(OCC(C1)=O)O)O)(O)=O,,,5,1,1,0,1
84198_0,,,,2,1,1,2
C1(CC(C(C(C)(OC1)O)=O)O)=O,,,5,1,1,0,1
84200_0,,,,2,1,1,2
C1(CC(C(C(OC1)O)=O)(C)O)=O,,,5,1,1,0,1
84201_0,,,,2,1,1,2
84202_0,,,,2,1,1,2
84203_0,,,,2,1,1,2
84205_0,,,,2,1,1,2
C1(COC(CC(CO)(C1)O)O)=O,,,5,1,1,0,1
84207_0,,,,2,1,1,2
C1(COC(C(C(C)(C1)O)O)O)=O,,,5,1,1,0,1
84208_0,,,,2,1,1,2
84209_0,,,,2,1,1,2
84210_0,,,,2,1,1,2
84212_0,,,,2,1,1,2
C1(C(C(C=C)(C(O)OCC1)O)O)=O,,,5,1,1,0,1
84214_0,,,,2,1,1,2
C1(C(C(C(C=C)(O)OCC1)O)O)=O,,,5,1,1,0,1
84216_0,,,,2,1,1,2
C1(C(C(C(O)OCC1)(C)O)O)=O,,,5,1,1,0,1
84218_0,,,,2,1,1,2
C(C1(CC(C(CCO1)O)O)O)(O)=O,,,5,1,1,0,1
84220_0,,,,2,1,1,2
C(C1C(O)OCCC(C1O)O)(O)=O,,,5,1,1,0,1
84222_0,,,,2,1,1,2
C1CC(C(C(C(CO)(O)O1)O)O)O,,,5,1,1,0,1
84224_0,,,,2,1,1,2
C(C1(CC(C(CCO1)O)O)O)=O,,,5,1,1,0,1
84226_0,,,,2,1,1,2
C(C1C(O)OCCC(C1O)O)=O,,,5,1,1,0,1
84228_0,,,,2,1,1,2
C1CC(C(CC(O)O1)O)O,,,5,1,1,0,1
84230_0,,,,2,1,1,2
C(C1(C(C(C(CCO1)O)O)O)O)=O,,,5,1,1,0,1
84232_0,,,,2,1,1,2
C1CC(C(C(C(O)O1)O)O)O,,,5,1,1,0,1
84234_0,,,,2,1,1,2
C1(C(O)OCC(C(C)(C1)O)O)=O,,,5,1,1,0,1
84236_0,,,,2,1,1,2
C1(C(O)OCC(C(C)(C1O)O)O)=O,,,5,1,1,0,1
84238_0,,,,2,1,1,2
C1(CC(C=C)(C(O)OCC1O)O)=O,,,5,1,1,0,1
84240_0,,,,2,1,1,2
C1(C(COC(C=C)(C(C1)O)O)O)=O,,,5,1,1,0,1
84242_0,,,,2,1,1,2
C1(C(COC(C(C)(C1)O)O)O)=O,,,5,1,1,0,1
84244_0,,,,2,1,1,2
C1(C(COC(C(C1)O)(C)O)O)=O,,,5,1,1,0,1
84246_0,,,,2,1,1,2
C1(C(COC(C(CO)(C1)O)O)O)=O,,,5,1,1,0,1
84248_0,,,,2,1,1,2
C1(C(COC(C(C1)O)(CO)O)O)=O,,,5,1,1,0,1
84250_0,,,,2,1,1,2
C1(C(C)(CC(C(C(O)O1)=O)=O)O)=O,,,5,1,1,0,1
84252_0,,,,2,1,1,2
C1(C(C)(C(C(CC(O)O1)=O)O)O)=O,,,5,1,1,0,1
84254_0,,,,2,1,1,2
C1(C(C)(CC(C(C(O)O1)O)=O)O)=O,,,5,1,1,0,1
84256_0,,,,2,1,1,2
C(C1(CC(O)OC(C(C1)=O)=O)O)=O,,,5,1,1,0,1
84258_0,,,,2,1,1,2
C(C1(CC(CC(C(O1)=O)=O)O)O)=O,,,5,1,1,0,1
84260_0,,,,2,1,1,2
C1(C(CC(C(OC1(C)O)=O)=O)O)=O,,,5,1,1,0,1
84262_0,,,,2,1,1,2
C1(C(O)OC(C(CC1(C)O)=O)=O)=O,,,5,1,1,0,1
84263_0,,,,2,1,1,2
84264_0,,,,2,1,1,2
84266_0,,,,2,1,1,2
C1(C(CC(CO)(CC(O)O1)O)=O)=O,,,5,1,1,0,1
84268_0,,,,2,1,1,2
C1(C(CC(C)(C(C(O)O1)O)O)=O)=O,,,5,1,1,0,1
84270_0,,,,2,1,1,2
C1(CC(C(C=O)C(C(O)O1)=O)O)=O,,,5,1,1,0,1
84272_0,,,,2,1,1,2
C(C1(C(CC(CC(O1)=O)O)=O)O)=O,,,5,1,1,0,1
84274_0,,,,2,1,1,2
C1(CC(CC(C(O)O1)=O)O)=O,,,5,1,1,0,1
84276_0,,,,2,1,1,2
C1(CC(C(C(C(O)O1)=O)CO)O)=O,,,5,1,1,0,1
84278_0,,,,2,1,1,2
C(C1C(CC(OC(C1O)O)=O)O)=O,,,5,1,1,0,1
84280_0,,,,2,1,1,2
C1(CC(C(C(C(O)O1)=O)O)O)=O,,,5,1,1,0,1
84282_0,,,,2,1,1,2
C1(C(C=O)C(C(CC(O)O1)=O)O)=O,,,5,1,1,0,1
84283_0,,,,2,1,1,2
84285_0,,,,2,1,1,2
C1(C(C(CO)C(CC(O)O1)O)=O)=O,,,5,1,1,0,1
84287_0,,,,2,1,1,2
C1(CC(C(CC(C=O)(O)O1)O)O)=O,,,5,1,1,0,1
84289_0,,,,2,1,1,2
C(C1C(O)OC(CC(C1O)O)=O)=O,,,5,1,1,0,1
84291_0,,,,2,1,1,2
C1(CC(C(CC(O)O1)O)O)=O,,,5,1,1,0,1
84293_0,,,,2,1,1,2
C1(CC(C(C(C(O)O1)O)O)O)=O,,,5,1,1,0,1
84295_0,,,,2,1,1,2
C1(CC(CO)(CC(C(O)O1)=O)O)=O,,,5,1,1,0,1
84297_0,,,,2,1,1,2
C1(CC(C(C(C)(C(O)O1)O)O)=O)=O,,,5,1,1,0,1
84299_0,,,,2,1,1,2
C1(C(C(C)(CC(C(O)O1)=O)O)O)=O,,,5,1,1,0,1
84300_0,,,,2,1,1,2
84302_0,,,,2,1,1,2
C1(C(C(CC(C)(C(O)O1)O)=O)O)=O,,,5,1,1,0,1
84304_0,,,,2,1,1,2
C1(C(C(CC(C(C)(O)O1)O)=O)O)=O,,,5,1,1,0,1
84306_0,,,,2,1,1,2
C1(C(C(C(CC(O)O1)O)O)=O)=O,,,5,1,1,0,1
84308_0,,,,2,1,1,2
C(C1(C(CCOC(C1O)O)=O)O)=O,,,5,1,1,0,1
84310_0,,,,2,1,1,2
C(C1(C(CC(C(O)OC1)O)=O)O)=O,,,5,1,1,0,1
84311_0,,,,2,1,1,2
84312_0,,,,2,1,1,2
84314_0,,,,2,1,1,2
C1(C(C(C)(C(CC(O)O1)O)O)O)=O,,,5,1,1,0,1
84316_0,,,,2,1,1,2
C1(C(C(C(C)(CC(O)O1)O)O)O)=O,,,5,1,1,0,1
84318_0,,,,2,1,1,2
C(C1C(CC(CC(O1)O)O)O)(O)=O,,,5,1,1,0,1
84320_0,,,,2,1,1,2
C(C1(C(C)OC(CC(C1)O)O)O)=O,,,5,1,1,0,1
84322_0,,,,2,1,1,2
C1(C(C(C)OC(C(C1)O)O)O)=O,,,5,1,1,0,1
84324_0,,,,2,1,1,2
C1(C(C(CO)OC(C(C1)O)O)O)=O,,,5,1,1,0,1
84325_0,,,,2,1,1,2
84327_0,,,,2,1,1,2
C(C1C(C(O)OCC(C1O)O)=O)=O,,,5,1,1,0,1
84329_0,,,,2,1,1,2
C(C1C(C(O)OCC(C1O)=O)=O)=O,,,5,1,1,0,1
84330_0,,,,2,1,1,2
84332_0,,,,2,1,1,2
C(C1(CC(O)OCC(C1)O)O)(O)=O,,,5,1,1,0,1
84334_0,,,,2,1,1,2
C1(C(CC(CO)(CC(O)O1)O)O)=O,,,5,1,1,0,1
84336_0,,,,2,1,1,2
C1(CC(C=O)(CC(C(O)O1)=O)O)=O,,,5,1,1,0,1
84338_0,,,,2,1,1,2
C(C1C(O)OC(C(CC1O)=O)=O)=O,,,5,1,1,0,1
84340_0,,,,2,1,1,2
C(C1C(C(OC(CC1O)O)=O)=O)=O,,,5,1,1,0,1
84342_0,,,,2,1,1,2
C1(C2C(CC(OC1CO2)O)O)=O,,,5,1,1,0,1
84344_0,,,,2,1,1,2
C1(C2OC(CC(C1CO2)O)O)=O,,,5,1,1,0,1
84346_0,,,,2,1,1,2
C1(C(O)OC2CC(CO2)(C1)O)=O,,,5,1,1,0,1
84348_0,,,,2,1,1,2
C1(C(O)OC2CC(CO2)(C1O)O)=O,,,5,1,1,0,1
84350_0,,,,2,1,1,2
C1(C2C(C=C)(C(O)OC(C1)O2)O)=O,,,5,1,1,0,1
84352_0,,,,2,1,1,2
C1(C2C(C(C=C)(O)OC(C1)O2)O)=O,,,5,1,1,0,1
84354_0,,,,2,1,1,2
C1(C2C(C(O)OC(C1)O2)O)=O,,,5,1,1,0,1
84356_0,,,,2,1,1,2
C1(C2C(C(O)OC(C1)O2)(C)O)=O,,,5,1,1,0,1
84358_0,,,,2,1,1,2
C1(C2C(C(C)(O)OC(C1)O2)O)=O,,,5,1,1,0,1
84360_0,,,,2,1,1,2
C1(C2C(C(O)OC(C1)O2)(CO)O)=O,,,5,1,1,0,1
84362_0,,,,2,1,1,2
C1(C2C(C(CO)(O)OC(C1)O2)O)=O,,,5,1,1,0,1
84364_0,,,,2,1,1,2
C1(C(OCC(C(C1(C)O)O)=O)O)=O,,,5,1,1,0,1
84366_0,,,,2,1,1,2
C1(C(C(O)OC(C(C1)O)O)=O)=O,,,5,1,1,0,1
84368_0,,,,2,1,1,2
C1(C(C(O)OC(C)C(C1)O)=O)=O,,,5,1,1,0,1
84370_0,,,,2,1,1,2
C1(C(C(O)OC(CO)C(C1)O)=O)=O,,,5,1,1,0,1
84372_0,,,,2,1,1,2
C(C1(C(CC(C(CO1)O)O)=O)O)=O,,,5,1,1,0,1
84374_0,,,,2,1,1,2
C1(C(C(O)OCC(CO)(C1)O)=O)=O,,,5,1,1,0,1
84376_0,,,,2,1,1,2
C1(C(CC(C(C(O)O1)=O)=O)O)=O,,,5,1,1,0,1
84378_0,,,,2,1,1,2
C(C1(COC(C(C(C1)=O)=O)O)O)=O,,,5,1,1,0,1
84380_0,,,,2,1,1,2
C(C1(C(CC(C(CO1)=O)O)=O)O)=O,,,5,1,1,0,1
84381_0,,,,2,1,1,2
84383_0,,,,2,1,1,2
C12C(C(CO1)(C(CC(O)O2)O)O)O,,,5,1,1,0,1
84384_0,,,,2,1,1,2
84386_0,,,,2,1,1,2
C1(C(C(C(O)OC(C1)O)O)O)=O,,,5,1,1,0,1
84388_0,,,,2,1,1,2
C1(C(C(O)OC(C(C1)O)O)O)=O,,,5,1,1,0,1
84390_0,,,,2,1,1,2
C1(C(C(C(C)OC(C1)O)O)O)=O,,,5,1,1,0,1
84392_0,,,,2,1,1,2
C1(C(C(O)OC(C(C1)O)C)O)=O,,,5,1,1,0,1
84394_0,,,,2,1,1,2
C(C1CC(C(CC(O1)O)O)O)(O)=O,,,5,1,1,0,1
84396_0,,,,2,1,1,2
C(C1CC(CC(C(O1)O)O)O)(O)=O,,,5,1,1,0,1
84398_0,,,,2,1,1,2
C1(C(CC(C)(C(C(O)O1)O)O)O)=O,,,5,1,1,0,1
84400_0,,,,2,1,1,2
C1(C(C(CO)C(CC(O)O1)O)O)=O,,,5,1,1,0,1
84401_0,,,,2,1,1,2
84402_0,,,,2,1,1,2
84403_0,,,,2,1,1,2
84404_0,,,,2,1,1,2
84405_0,,,,2,1,1,2
84407_0,,,,2,1,1,2
C1(CCOC(C(C1O)=O)(C)O)=O,,,5,1,1,0,1
84408_0,,,,2,1,1,2
84409_0,,,,2,1,1,2
84410_0,,,,2,1,1,2
84411_0,,,,2,1,1,2
84412_0,,,,2,1,1,2
84413_0,,,,2,1,1,2
84414_0,,,,2,1,1,2
84416_0,,,,2,1,1,2
C1(C(CO)OC(C(CC1O)O)O)=O,,,5,1,1,0,1
84417_0,,,,2,1,1,2
84419_0,,,,2,1,1,2
C(C1C(C(CC(C(O1)O)O)O)O)=O,,,5,1,1,0,1
84420_0,,,,2,1,1,2
84421_0,,,,2,1,1,2
84422_0,,,,2,1,1,2
84423_0,,,,2,1,1,2
84424_0,,,,2,1,1,2
84425_0,,,,2,1,1,2
84427_0,,,,2,1,1,2
C1(CC(OC(C(C1O)=O)C)O)=O,,,5,1,1,0,1
84429_0,,,,2,1,1,2
C1(C(C(OC(C(C1)=O)C)O)O)=O,,,5,1,1,0,1
84430_0,,,,2,1,1,2
84431_0,,,,2,1,1,2
84432_0,,,,2,1,1,2
84433_0,,,,2,1,1,2
84434_0,,,,2,1,1,2
84435_0,,,,2,1,1,2
84436_0,,,,2,1,1,2
84437_0,,,,2,1,1,2
84438_0,,,,2,1,1,2
84439_0,,,,2,1,1,2
84441_0,,,,2,1,1,2
C(C1C(C(CC(C(O1)O)O)O)=O)=O,,,5,1,1,0,1
84442_0,,,,2,1,1,2
84443_0,,,,2,1,1,2
84445_0,,,,2,1,1,2
C1(CC(OC(C(C1O)=O)CO)O)=O,,,5,1,1,0,1
84447_0,,,,2,1,1,2
C1(CC(OCC(C1O)=O)O)=O,,,5,1,1,0,1
84448_0,,,,2,1,1,2
84450_0,,,,2,1,1,2
C1(C(C(OC(C(C1)=O)CO)O)O)=O,,,5,1,1,0,1
84452_0,,,,2,1,1,2
C(C1(C(CC(C(CO1)=O)O)O)O)=O,,,5,1,1,0,1
84453_0,,,,2,1,1,2
84455_0,,,,2,1,1,2
C(C1(C(CC(C(CO1)O)O)O)O)=O,,,5,1,1,0,1
84457_0,,,,2,1,1,2
C1(C(C(OCC(C1)=O)O)O)=O,,,5,1,1,0,1
84458_0,,,,2,1,1,2
84459_0,,,,2,1,1,2
84461_0,,,,2,1,1,2
C(C1(C(COC(CC1O)O)=O)O)=O,,,5,1,1,0,1
84462_0,,,,2,1,1,2
84463_0,,,,2,1,1,2
84465_0,,,,2,1,1,2
C1CC(C(C(C(O)O1)(CO)O)O)O,,,5,1,1,0,1
84467_0,,,,2,1,1,2
C1CC(C(CO)(C(C(O)O1)O)O)O,,,5,1,1,0,1
84469_0,,,,2,1,1,2
C1CC(CC(C(O)O1)O)O,,,5,1,1,0,1
84471_0,,,,2,1,1,2
C1C(C(CC(C(O)O1)O)O)O,,,5,1,1,0,1
84472_0,,,,2,1,1,2
84473_0,,,,2,1,1,2
84475_0,,,,2,1,1,2
C(C1(C(C(O)OCCC1O)O)O)=O,,,5,1,1,0,1
84477_0,,,,2,1,1,2
C1(C(O)OCCC(C1(CO)O)O)=O,,,5,1,1,0,1
84478_0,,,,2,1,1,2
84480_0,,,,2,1,1,2
C1C(CC(C(C(O)O1)(CO)O)O)O,,,5,1,1,0,1
84482_0,,,,2,1,1,2
C(C1(CCOC(CC1O)O)O)=O,,,5,1,1,0,1
84484_0,,,,2,1,1,2
C(C1(CC(O)OCCC1O)O)=O,,,5,1,1,0,1
84486_0,,,,2,1,1,2
C1(CC(CC(C(O)O1)O)O)=O,,,5,1,1,0,1
84488_0,,,,2,1,1,2
C(C1(C(CC(O)OC(C1)=O)O)O)=O,,,5,1,1,0,1
84490_0,,,,2,1,1,2
C(C1(C(CC(OC(C1)O)=O)O)O)=O,,,5,1,1,0,1
84491_0,,,,2,1,1,2
84492_0,,,,2,1,1,2
84494_0,,,,2,1,1,2
C(C1(C(C(O)OCCC1O)=O)O)=O,,,5,1,1,0,1
84496_0,,,,2,1,1,2
C(C1C(C(O)OCCC1O)O)(O)=O,,,5,1,1,0,1
84498_0,,,,2,1,1,2
C(C1(C(O)OCC(CC1O)O)O)=O,,,5,1,1,0,1
84500_0,,,,2,1,1,2
C(C1(C(O)OCCC(C1O)O)O)=O,,,5,1,1,0,1
84502_0,,,,2,1,1,2
C(C1(C(O)OCCC(C1O)=O)O)=O,,,5,1,1,0,1
84504_0,,,,2,1,1,2
C(C1(C(OCC(CC1O)=O)O)O)=O,,,5,1,1,0,1
84505_0,,,,2,1,1,2
84507_0,,,,2,1,1,2
C(C1(COC(C(CC1O)=O)O)O)=O,,,5,1,1,0,1
84509_0,,,,2,1,1,2
C1(C2OC(CC(C1(CO2)O)O)O)=O,,,5,1,1,0,1
84511_0,,,,2,1,1,2
C(C1(CC(O)OCCC1O)O)(O)=O,,,5,1,1,0,1
84513_0,,,,2,1,1,2
C1(C(CC(C(C(O)O1)(O)O)O)O)=O,,,5,1,1,0,1
84515_0,,,,2,1,1,2
C1(C(CC(C(C)(C(O)O1)O)O)O)=O,,,5,1,1,0,1
84517_0,,,,2,1,1,2
[C]1(C(OC(C(C)(CC1O)O)O)=O)O,,,5,1,1,0,1
84519_0,,,,2,1,1,2
C1(C(C(CC(C)(C(O)O1)O)O)O)=O,,,5,1,1,0,1
84521_0,,,,2,1,1,2
[C]1(C(OC(CC(C)(C1O)O)O)=O)O,,,5,1,1,0,1
84523_0,,,,2,1,1,2
C(C)(C1(CC(O)OCCC1O)O)=O,,,5,1,1,0,1
84525_0,,,,2,1,1,2
[C]1(C(OC(C)(C(CC1O)O)O)=O)O,,,5,1,1,0,1
84527_0,,,,2,1,1,2
C1(C(C(CC(C(C)(O)O1)O)O)O)=O,,,5,1,1,0,1
84529_0,,,,2,1,1,2
[C]1(C(OC(CC(C1(C)O)O)O)=O)O,,,5,1,1,0,1
84531_0,,,,2,1,1,2
C1(C(C(C(O)OC(C)C1)(O)O)O)=O,,,5,1,1,0,1
84533_0,,,,2,1,1,2
C1(C(C(C(O)OC(C)C1)(C)O)O)=O,,,5,1,1,0,1
84534_0,,,,2,1,1,2
84536_0,,,,2,1,1,2
C(C1(C(CC(CC(O1)O)O)O)O)=O,,,5,1,1,0,1
84538_0,,,,2,1,1,2
C(C1(C)C(CC(CC(O1)O)O)O)=O,,,5,1,1,0,1
84540_0,,,,2,1,1,2
[C]1(C(O)=O)C(CC(CC(O)O1)O)O,,,5,1,1,0,1
84541_0,,,,2,1,1,2
84542_0,,,,2,1,1,2
84543_0,,,,2,1,1,2
84545_0,,,,2,1,1,2
C1(C(C=O)(CC(CC(O)O1)O)O)=O,,,5,1,1,0,1
84547_0,,,,2,1,1,2
C1(C(O)OC(C)CC(C1(C)O)O)=O,,,5,1,1,0,1
84549_0,,,,2,1,1,2
C(C1(CC(O)OC(C)CC1O)O)=O,,,5,1,1,0,1
84551_0,,,,2,1,1,2
C1(C(O)OCCC(C1(C)O)O)=O,,,5,1,1,0,1
84553_0,,,,2,1,1,2
C1C(CC(C(C(O)O1)(O)O)O)O,,,5,1,1,0,1
84555_0,,,,2,1,1,2
C1C(CC(C(C)(C(O)O1)O)O)O,,,5,1,1,0,1
84557_0,,,,2,1,1,2
C1(C(O)OC([C](C(C1O)O)O)=O)=O,,,5,1,1,0,1
84559_0,,,,2,1,1,2
C1(C(C(C(C(C(O)O1)=O)O)O)O)=O,,,5,1,1,0,1
84561_0,,,,2,1,1,2
C1(C(C(O)OC([C](C1O)O)=O)O)=O,,,5,1,1,0,1
84563_0,,,,2,1,1,2
C1(COC(C(C(C1O)O)(O)O)O)=O,,,5,1,1,0,1
84565_0,,,,2,1,1,2
C1(CC(C(C(C(O)O1)=O)(C)O)O)=O,,,5,1,1,0,1
84567_0,,,,2,1,1,2
C1(C(O)OCC(C(C1(C)O)O)O)=O,,,5,1,1,0,1
84569_0,,,,2,1,1,2
C1CC(C(C(C(O)O1)(O)O)O)O,,,5,1,1,0,1
84571_0,,,,2,1,1,2
CC1(C(O)OCCC(C1O)O)O,,,5,1,1,0,1
84573_0,,,,2,1,1,2
C1(CC(C(C(C(O)O1)(O)O)O)O)=O,,,5,1,1,0,1
84575_0,,,,2,1,1,2
C1(CC(C(C(C)(C(O)O1)O)O)O)=O,,,5,1,1,0,1
84577_0,,,,2,1,1,2
C1(CC(O)OC([C](C1O)O)=O)=O,,,5,1,1,0,1
84579_0,,,,2,1,1,2
C1(C(O)OC([C](C(C1)O)O)=O)=O,,,5,1,1,0,1
84580_0,,,,2,1,1,2
84582_0,,,,2,1,1,2
C1(C(C)(C(CC(C(O)O1)=O)O)O)=O,,,5,1,1,0,1
84584_0,,,,2,1,1,2
C1(CC(C(C(C(O)O1)(O)O)O)=O)=O,,,5,1,1,0,1
84586_0,,,,2,1,1,2
C1(C(CC(C(C(O)O1)(O)O)O)=O)=O,,,5,1,1,0,1
84588_0,,,,2,1,1,2
C1(C(CC(C(C)(C(O)O1)O)O)=O)=O,,,5,1,1,0,1
84590_0,,,,2,1,1,2
C1(C2(C(CC(OC1CO2)O)O)O)=O,,,5,1,1,0,1
84592_0,,,,2,1,1,2
C1C(C(C(C(C(O)O1)(O)O)O)O)O,,,5,1,1,0,1
84594_0,,,,2,1,1,2
C1(C(C(C(O)OCC1)(O)O)O)=O,,,5,1,1,0,1
84596_0,,,,2,1,1,2
C1(COC(C(C(C1)O)(O)O)O)=O,,,5,1,1,0,1
84598_0,,,,2,1,1,2
C1(C(C(C(O)OCC1O)(O)O)O)=O,,,5,1,1,0,1
84600_0,,,,2,1,1,2
CC1(C(O)OCC(C(C1O)O)O)O,,,5,1,1,0,1
84602_0,,,,2,1,1,2
C1(COC(C(C)(C(C1)O)O)O)=O,,,5,1,1,0,1
84604_0,,,,2,1,1,2
[C]1(C(OC(C(C(C1O)O)O)O)=O)O,,,5,1,1,0,1
84606_0,,,,2,1,1,2
[C]1(C(OC(CC(C1O)O)O)=O)O,,,5,1,1,0,1
84608_0,,,,2,1,1,2
[C]1(C(OC(C(CC1O)O)O)=O)O,,,5,1,1,0,1
84609_0,,,,2,1,1,2
84610_0,,,,2,1,1,2
84611_0,,,,2,1,1,2
84612_0,,,,2,1,1,2
84613_0,,,,2,1,1,2
84614_0,,,,2,1,1,2
84615_0,,,,2,1,1,2
84616_0,,,,2,1,1,2
84617_0,,,,2,1,1,2
84618_0,,,,2,1,1,2
84619_0,,,,2,1,1,2
84620_0,,,,2,1,1,2
84621_0,,,,2,1,1,2
84622_0,,,,2,1,1,2
84623_0,,,,2,1,1,2
84624_0,,,,2,1,1,2
84625_0,,,,2,1,1,2
84626_0,,,,2,1,1,2
84627_0,,,,2,1,1,2
84628_0,,,,2,1,1,2
84629_0,,,,2,1,1,2
84630_0,,,,2,1,1,2
84631_0,,,,2,1,1,2
84632_0,,,,2,1,1,2
84633_0,,,,2,1,1,2
84634_0,,,,2,1,1,2
84635_0,,,,2,1,1,2
84636_0,,,,2,1,1,2
84637_0,,,,2,1,1,2
84638_0,,,,2,1,1,2
84639_0,,,,2,1,1,2
84640_0,,,,2,1,1,2
84641_0,,,,2,1,1,2
84642_0,,,,2,1,1,2
84643_0,,,,2,1,1,2
84644_0,,,,2,1,1,2
84645_0,,,,2,1,1,2
84646_0,,,,2,1,1,2
84647_0,,,,2,1,1,2
84648_0,,,,2,1,1,2
84649_0,,,,2,1,1,2
84650_0,,,,2,1,1,2
84651_0,,,,2,1,1,2
84652_0,,,,2,1,1,2
84653_0,,,,2,1,1,2
84654_0,,,,2,1,1,2
84655_0,,,,2,1,1,2
84656_0,,,,2,1,1,2
84657_0,,,,2,1,1,2
84658_0,,,,2,1,1,2
84659_0,,,,2,1,1,2
84660_0,,,,2,1,1,2
84661_0,,,,2,1,1,2
84662_0,,,,2,1,1,2
84663_0,,,,2,1,1,2
84664_0,,,,2,1,1,2
84665_0,,,,2,1,1,2
84666_0,,,,2,1,1,2
84667_0,,,,2,1,1,2
84668_0,,,,2,1,1,2
84669_0,,,,2,1,1,2
84670_0,,,,2,1,1,2
84671_0,,,,2,1,1,2
84672_0,,,,2,1,1,2
84673_0,,,,2,1,1,2
84674_0,,,,2,1,1,2
84675_0,,,,2,1,1,2
84676_0,,,,2,1,1,2
84677_0,,,,2,1,1,2
84678_0,,,,2,1,1,2
84679_0,,,,2,1,1,2
84680_0,,,,2,1,1,2
84681_0,,,,2,1,1,2
84682_0,,,,2,1,1,2
84683_0,,,,2,1,1,2
84684_0,,,,2,1,1,2
84685_0,,,,2,1,1,2
84687_0,,,,2,1,1,2
C12C(C(C(CC(O)O1)O2)O)O,,,5,1,1,0,1
84688_0,,,,2,1,1,2
84689_0,,,,2,1,1,2
84690_0,,,,2,1,1,2
84691_0,,,,2,1,1,2
84692_0,,,,2,1,1,2
84693_0,,,,2,1,1,2
84695_0,,,,2,1,1,2
C(C1(CC2C(C(C(O1)O2)O)O)O)=O,,,5,1,1,0,1
84696_0,,,,2,1,1,2
84698_0,,,,2,1,1,2
C(C12CC(C(C(C(O1)O)O)O2)O)=O,,,5,1,1,0,1
84699_0,,,,2,1,1,2
84701_0,,,,2,1,1,2
C(C1C(O)OC2C(C(C1O2)O)O)=O,,,5,1,1,0,1
84703_0,,,,2,1,1,2
C(C1C2OC(C(C(C1O)O2)O)O)=O,,,5,1,1,0,1
84705_0,,,,2,1,1,2
C12CC(C(C(C(O)O1)O)O2)O,,,5,1,1,0,1
84707_0,,,,2,1,1,2
C12C(C(C(C(C(O)O1)O)O2)O)O,,,5,1,1,0,1
84708_0,,,,2,1,1,2
84709_0,,,,2,1,1,2
84711_0,,,,2,1,1,2
C1(CC2C(C(C(CO)(O2)O1)O)O)O,,,5,1,1,0,1
84713_0,,,,2,1,1,2
C12CC(C(C(C(CO)(O)O1)O)O2)O,,,5,1,1,0,1
84715_0,,,,2,1,1,2
C12C(CC(C(C(CO)(O)O1)O)O2)O,,,5,1,1,0,1
84716_0,,,,2,1,1,2
84717_0,,,,2,1,1,2
84718_0,,,,2,1,1,2
84719_0,,,,2,1,1,2
84720_0,,,,2,1,1,2
84721_0,,,,2,1,1,2
84723_0,,,,2,1,1,2
C12C(CO)(C(C(CC(O)O1)O2)O)O,,,5,1,1,0,1
84724_0,,,,2,1,1,2
84726_0,,,,2,1,1,2
C12CC(C(C(C(O)O1)(CO)O)O2)O,,,5,1,1,0,1
84728_0,,,,2,1,1,2
C12C(C(CO)(C(CC(O)O1)O2)O)O,,,5,1,1,0,1
84730_0,,,,2,1,1,2
C12CC(C(CO)(C(C(O)O1)O)O2)O,,,5,1,1,0,1
84731_0,,,,2,1,1,2
84733_0,,,,2,1,1,2
C1(C2OC(CC(C1)O2)O)=O,,,5,1,1,0,1
84734_0,,,,2,1,1,2
84736_0,,,,2,1,1,2
C(C12CC(C(CC(O1)O)O2)O)=O,,,5,1,1,0,1
84738_0,,,,2,1,1,2
C(C1(CC2C(CC(O1)O2)O)O)=O,,,5,1,1,0,1
84739_0,,,,2,1,1,2
84741_0,,,,2,1,1,2
C(C1(CC2CC(C(O1)O2)O)O)=O,,,5,1,1,0,1
84742_0,,,,2,1,1,2
84744_0,,,,2,1,1,2
C1(C2OC(CO)(CC(C1)O2)O)=O,,,5,1,1,0,1
84746_0,,,,2,1,1,2
C1(C2OC(CO)(CC(O2)O)C1)=O,,,5,1,1,0,1
84748_0,,,,2,1,1,2
C1(C2OC(C)(C(C(C1)O2)O)O)=O,,,5,1,1,0,1
84750_0,,,,2,1,1,2
C1(C2OC(C)(C(C(O2)O)O)C1)=O,,,5,1,1,0,1
84751_0,,,,2,1,1,2
84752_0,,,,2,1,1,2
84753_0,,,,2,1,1,2
84754_0,,,,2,1,1,2
84755_0,,,,2,1,1,2
84757_0,,,,2,1,1,2
C1(C2OC(CC(C1CO)O2)O)=O,,,5,1,1,0,1
84759_0,,,,2,1,1,2
C(C1C2CC(O)OC(C1O)O2)=O,,,5,1,1,0,1
84761_0,,,,2,1,1,2
C1(C(O)OC2CC(C1O2)O)=O,,,5,1,1,0,1
84763_0,,,,2,1,1,2
C1(C2OC(CC(C1O)O2)O)=O,,,5,1,1,0,1
84765_0,,,,2,1,1,2
C(C1C2OC(CC(C1O)O2)O)=O,,,5,1,1,0,1
84767_0,,,,2,1,1,2
C(C1C(O)OC2CC(C1O2)O)=O,,,5,1,1,0,1
84769_0,,,,2,1,1,2
C(C1C(O)OC2C(CC1O2)O)=O,,,5,1,1,0,1
84770_0,,,,2,1,1,2
84771_0,,,,2,1,1,2
84772_0,,,,2,1,1,2
84773_0,,,,2,1,1,2
84775_0,,,,2,1,1,2
C12CC(C(CC(O)O1)O2)O,,,5,1,1,0,1
84777_0,,,,2,1,1,2
C(C1(C(C2C(CC(O1)O2)O)O)O)=O,,,5,1,1,0,1
84779_0,,,,2,1,1,2
C(C12C(C(C(CC(O1)O)O2)O)O)=O,,,5,1,1,0,1
84781_0,,,,2,1,1,2
C12C(CC(CC(O)O1)O2)O,,,5,1,1,0,1
84783_0,,,,2,1,1,2
C(C1(C(C2CC(C(O1)O2)O)O)O)=O,,,5,1,1,0,1
84784_0,,,,2,1,1,2
84786_0,,,,2,1,1,2
C12C(CC(C(C(O)O1)O)O2)O,,,5,1,1,0,1
84787_0,,,,2,1,1,2
84788_0,,,,2,1,1,2
84790_0,,,,2,1,1,2
C1(C(O)OC2(CO)CC(C1O2)O)=O,,,5,1,1,0,1
84791_0,,,,2,1,1,2
84793_0,,,,2,1,1,2
C1(C2OC(CC(CO)(O2)O)C1O)=O,,,5,1,1,0,1
84794_0,,,,2,1,1,2
84795_0,,,,2,1,1,2
84797_0,,,,2,1,1,2
C1(C(O)OC2CC(CO)(C1O2)O)=O,,,5,1,1,0,1
84799_0,,,,2,1,1,2
C1(C2OC(CC(CO)(C1O)O2)O)=O,,,5,1,1,0,1
84801_0,,,,2,1,1,2
C1(C(O)OC2(C)C(C(C1O2)O)O)=O,,,5,1,1,0,1
84803_0,,,,2,1,1,2
C1(C2OC(C(C(C)(O2)O)O)C1O)=O,,,5,1,1,0,1
84805_0,,,,2,1,1,2
C1(C(O)OC2C(C(C)(C1O2)O)O)=O,,,5,1,1,0,1
84807_0,,,,2,1,1,2
C1(C2OC(C(C(C)(C1O)O2)O)O)=O,,,5,1,1,0,1
84808_0,,,,2,1,1,2
84810_0,,,,2,1,1,2
C(C12C(C(O)OC(CC1O)O2)O)=O,,,5,1,1,0,1
84812_0,,,,2,1,1,2
C(C1(C(C2OC1CC(O)O2)O)O)=O,,,5,1,1,0,1
84814_0,,,,2,1,1,2
C1(C(O)OC2CC(C1(CO)O2)O)=O,,,5,1,1,0,1
84816_0,,,,2,1,1,2
C1(C2OC(CC(C1(CO)O)O2)O)=O,,,5,1,1,0,1
84817_0,,,,2,1,1,2
84819_0,,,,2,1,1,2
C12C(CC(C(C(O)O1)(CO)O)O2)O,,,5,1,1,0,1
84820_0,,,,2,1,1,2
84822_0,,,,2,1,1,2
C(C12CC(O)OC(CC1O)O2)=O,,,5,1,1,0,1
84824_0,,,,2,1,1,2
C(C1(CC2OC1CC(O)O2)O)=O,,,5,1,1,0,1
84825_0,,,,2,1,1,2
84826_0,,,,2,1,1,2
84828_0,,,,2,1,1,2
C1C2(C(C(O)OC(CC2O)O1)O)O,,,5,1,1,0,1
84829_0,,,,2,1,1,2
84831_0,,,,2,1,1,2
C1(C2OC(CC(CO2)(C1)O)O)=O,,,5,1,1,0,1
84832_0,,,,2,1,1,2
84834_0,,,,2,1,1,2
C1(C(O)OC2CC(C1CO2)O)=O,,,5,1,1,0,1
84835_0,,,,2,1,1,2
84836_0,,,,2,1,1,2
84837_0,,,,2,1,1,2
84838_0,,,,2,1,1,2
84840_0,,,,2,1,1,2
C1(C2OC(CC(CO2)(C1O)O)O)=O,,,5,1,1,0,1
84841_0,,,,2,1,1,2
84842_0,,,,2,1,1,2
84843_0,,,,2,1,1,2
84845_0,,,,2,1,1,2
C1(C(O)OC2CC(C1(CO2)O)O)=O,,,5,1,1,0,1
84846_0,,,,2,1,1,2
84847_0,,,,2,1,1,2
84849_0,,,,2,1,1,2
C1C2(CC(C(C(CO2)(O)O1)O)O)O,,,5,1,2,0,2
84850_0,,,,2,1,1,2
84852_0,,,,2,1,1,2
C1C2(C(O)OC(CC(C2O)O)O1)O,,,5,1,1,0,1
84854_0,,,,2,1,1,2
C1(C2COC(C(O2)O)(CC1O)O)=O,,,5,1,2,0,2
84855_0,,,,2,1,1,2
84857_0,,,,2,1,1,2
C1C2C(C(CC(C(O)O2)(O)O1)O)O,,,5,1,2,0,2
84858_0,,,,2,1,1,2
84860_0,,,,2,1,1,2
C1(C(C2(C(O)OC(C1)OC2)O)O)=O,,,5,1,1,0,1
84862_0,,,,2,1,1,2
C1(C(C2OC(C(CO2)(C1)O)O)O)=O,,,5,1,1,0,1
84864_0,,,,2,1,1,2
C12C(CC(C(CO1)(C(O)O2)O)O)O,,,5,1,1,0,1
84866_0,,,,2,1,1,2
C(C1(CCC(OC(C1)O)=O)O)(O)=O,,,5,1,1,0,1
84868_0,,,,2,1,1,2
C(C1CCC(OC(C1(C)O)O)=O)=O,,,5,1,1,0,1
84870_0,,,,2,1,1,2
C1(CCCC(C(O)O1)(CC=O)O)=O,,,5,1,1,0,1
84872_0,,,,2,1,1,2
C(C1CCC(OC(C)(C1O)O)=O)=O,,,5,1,1,0,1
84874_0,,,,2,1,1,2
C1(CCC(C(C)=O)(CC(O)O1)O)=O,,,5,1,1,0,1
84876_0,,,,2,1,1,2
C1(CCC(C)(CC(C=O)(O)O1)O)=O,,,5,1,1,0,1
84878_0,,,,2,1,1,2
C1(CCC(C(C(O)O1)=O)C(C)O)=O,,,5,1,1,0,1
84880_0,,,,2,1,1,2
C1(CCC(CC(O)O1)(CC=O)O)=O,,,5,1,1,0,1
84882_0,,,,2,1,1,2
C(C1C(O)OC(CCC1(C)O)=O)=O,,,5,1,1,0,1
84884_0,,,,2,1,1,2
C(C1C(O)OC(CCC1O)=O)=O,,,5,1,1,0,1
84886_0,,,,2,1,1,2
C(C1(C=O)COC(C(CC1)=O)O)=O,,,5,1,1,0,1
84888_0,,,,2,1,1,2
C(C1CCC(C(O)OC1C)=O)=O,,,5,1,1,0,1
84890_0,,,,2,1,1,2
C1(CCC(C)(CC(O)O1)O)=O,,,5,1,1,0,1
84892_0,,,,2,1,1,2
C1(CC(CO)C(C)(CC(O)O1)O)=O,,,5,1,1,0,1
84894_0,,,,2,1,1,2
C(CC1CCCC(C(O)O1)=O)=O,,,5,1,1,0,1
84896_0,,,,2,1,1,2
C(CC1COC(CC(C1)O)O)(O)=O,,,5,1,1,0,1
84898_0,,,,2,1,1,2
C(C1(CCC(C(O)OC1C)=O)O)=O,,,5,1,1,0,1
84900_0,,,,2,1,1,2
C(C1C(CCC(C(O1)O)=O)(C)O)=O,,,5,1,1,0,1
84902_0,,,,2,1,1,2
C1(CCC(C)(C(C(O)O1)O)O)=O,,,5,1,1,0,1
84904_0,,,,2,1,1,2
C(C1C(CCCC(C=O)(O1)O)O)=O,,,5,1,1,0,1
84906_0,,,,2,1,1,2
C(C(C1CCCC(C(O)O1)=O)O)=O,,,5,1,1,0,1
84908_0,,,,2,1,1,2
C(C1CC(C(C=O)OC(C1)O)O)=O,,,5,1,1,0,1
84910_0,,,,2,1,1,2
C1(CCC(CC(O)O1)O)=O,,,5,1,1,0,1
84912_0,,,,2,1,1,2
C1(CC(CO)C(CC(O)O1)O)=O,,,5,1,1,0,1
84914_0,,,,2,1,1,2
C(C1COC(C(CC1)=O)O)=O,,,5,1,1,0,1
84916_0,,,,2,1,1,2
C(CC1C(CCC(C(O)O1)=O)O)=O,,,5,1,1,0,1
84918_0,,,,2,1,1,2
C(CC1(COC(C(CC1)=O)O)O)=O,,,5,1,1,0,1
84920_0,,,,2,1,1,2
C1(CCC(CO)(CC(O)O1)O)=O,,,5,1,1,0,1
84922_0,,,,2,1,1,2
C(C1C(COC(C=O)(CC1)O)O)=O,,,5,1,1,0,1
84924_0,,,,2,1,1,2
C(C1CCC(C(O)OC1CO)=O)=O,,,5,1,1,0,1
84926_0,,,,2,1,1,2
C(C1C(COC(CC1C=O)O)O)=O,,,5,1,1,0,1
84928_0,,,,2,1,1,2
C1(CCC(C=O)(C(C(O)O1)=O)O)=O,,,5,1,1,0,1
84930_0,,,,2,1,1,2
C1(CCC(C(C(C)(O)O1)=O)O)=O,,,5,1,1,0,1
84932_0,,,,2,1,1,2
C(CC1C(OCC(C(C1)=O)=O)O)=O,,,5,1,1,0,1
84934_0,,,,2,1,1,2
C1(CCCC(C(CO)(O)O1)=O)=O,,,5,1,1,0,1
84936_0,,,,2,1,1,2
C1(C(OC(C(C=O)=O)CCC1)O)=O,,,5,1,1,0,1
84938_0,,,,2,1,1,2
C1(CCCC(C(C=O)(O)O1)O)=O,,,5,1,1,0,1
84940_0,,,,2,1,1,2
C1(CCC(C(C(O)O1)=O)(C)O)=O,,,5,1,1,0,1
84942_0,,,,2,1,1,2
C(C1(CCCC(CO1)=O)O)=O,,,5,1,1,0,1
84944_0,,,,2,1,1,2
C(C1CC(OCC(C1)=O)O)=O,,,5,1,1,0,1
84946_0,,,,2,1,1,2
C(CC1C(O)OCCC(C1O)=O)=O,,,5,1,1,0,1
84948_0,,,,2,1,1,2
C(CC1C(CC(COC1O)=O)O)=O,,,5,1,1,0,1
84950_0,,,,2,1,1,2
C1(CCC(CC(CO)(O)O1)O)=O,,,5,1,1,0,1
84952_0,,,,2,1,1,2
C(C1(CCC(C(CO1)=O)CO)O)=O,,,5,1,1,0,1
84954_0,,,,2,1,1,2
C(CO)(C1COC(C(CC1)=O)O)=O,,,5,1,1,0,1
84956_0,,,,2,1,1,2
C(C1CC(OCC(C1CO)=O)O)=O,,,5,1,1,0,1
84958_0,,,,2,1,1,2
C(C1(CCOC(C=O)(CC1)O)O)=O,,,5,1,1,0,1
84960_0,,,,2,1,1,2
C(C1CC(O)OCCC1(C=O)O)=O,,,5,1,1,0,1
84962_0,,,,2,1,1,2
C(C1CC(CCC(C=O)(O1)O)O)=O,,,5,1,1,0,1
84964_0,,,,2,1,1,2
C(C1C(CC(C=O)OC(C1)O)O)=O,,,5,1,1,0,1
84966_0,,,,2,1,1,2
C(C(C1CCC(C(O)OC1)=O)O)=O,,,5,1,1,0,1
84968_0,,,,2,1,1,2
C(C1C(CCC(C(O1)O)=O)CO)=O,,,5,1,1,0,1
84970_0,,,,2,1,1,2
C1(CCC(CO)C(C(O)O1)O)=O,,,5,1,1,0,1
84972_0,,,,2,1,1,2
C(C)(C1(COC(C(CC1)=O)O)O)=O,,,5,1,1,0,1
84974_0,,,,2,1,1,2
C(C)(C1C(CCC(C(O1)O)=O)O)=O,,,5,1,1,0,1
84976_0,,,,2,1,1,2
C1(CCC(C(C(C)(O)O1)O)O)=O,,,5,1,1,0,1
84978_0,,,,2,1,1,2
C1(C(CO)OC(C=O)(CCC1)O)=O,,,5,1,1,0,1
84980_0,,,,2,1,1,2
C(CC1C(O)OCC(C(C1)=O)O)=O,,,5,1,1,0,1
84982_0,,,,2,1,1,2
C(C1CC(OC(C(C1)=O)CO)O)=O,,,5,1,1,0,1
84984_0,,,,2,1,1,2
C1(C(O)OCCCC1)=O,,,5,1,1,0,1
84986_0,,,,2,1,1,2
C(C1(CCCC(C(O1)=O)=O)O)=O,,,5,1,1,0,1
84988_0,,,,2,1,1,2
C(C1CC(O)OC(C(C1)=O)=O)=O,,,5,1,1,0,1
84990_0,,,,2,1,1,2
C1(C(C=O)CCC(C(O)O1)=O)=O,,,5,1,1,0,1
84992_0,,,,2,1,1,2
C1(CCC(CC(C(O)=O)(O)O1)O)=O,,,5,1,1,0,1
84994_0,,,,2,1,1,2
C(C1CCC(OC(C1O)O)=O)(O)=O,,,5,1,1,0,1
84996_0,,,,2,1,1,2
C1(CCCC(C(O)O1)=O)=O,,,5,1,1,0,1
84998_0,,,,2,1,1,2
C(C1(CCC(C(C(O1)=O)=O)O)O)=O,,,5,1,1,0,1
85000_0,,,,2,1,1,2
C(C1CC(O)OC(C(C1O)=O)=O)=O,,,5,1,1,0,1
85002_0,,,,2,1,1,2
C1(CCC(C=O)C(C(O)O1)=O)=O,,,5,1,1,0,1
85004_0,,,,2,1,1,2
C1(CCC(C(O)=O)C(C(O)O1)=O)=O,,,5,1,1,0,1
85006_0,,,,2,1,1,2
C1(C2CCC(C=O)(OC1CO2)O)=O,,,5,1,1,0,1
85008_0,,,,2,1,1,2
C(C1CC(OC2C(C1OC2)=O)O)=O,,,5,1,1,0,1
85010_0,,,,2,1,1,2
C1(COC2CCC(C(OC12)O)=O)=O,,,5,1,1,0,1
85012_0,,,,2,1,1,2
C1(CCC2C(C(CO2)(O)O1)O)=O,,,5,1,1,0,1
85014_0,,,,2,1,1,2
C(CC1C(OC2C(CC1O2)=O)O)=O,,,5,1,1,0,1
85016_0,,,,2,1,1,2
C1(CCC2CC(C(O)O2)(O)O1)=O,,,5,1,1,0,1
85018_0,,,,2,1,1,2
C(C1(CCC2C(C(O1)OC2)=O)O)=O,,,5,1,1,0,1
85020_0,,,,2,1,1,2
C(C1CC(OC2C(C1CO2)=O)O)=O,,,5,1,1,0,1
85022_0,,,,2,1,1,2
C1(C2CCC(C(O)OC2CO1)=O)=O,,,5,1,1,0,1
85024_0,,,,2,1,1,2
C1(CC2C(CCC(C(O)O2)=O)O1)=O,,,5,1,1,0,1
85026_0,,,,2,1,1,2
C1(COC2C1CCC(C(O)O2)=O)=O,,,5,1,1,0,1
85028_0,,,,2,1,1,2
C1(CCC2(CC(CO2)(O)O1)O)=O,,,5,1,1,0,1
85030_0,,,,2,1,1,2
C(CC1C(O)OC2CC(C1O2)=O)=O,,,5,1,1,0,1
85032_0,,,,2,1,1,2
C(C1(C(CCCC(O1)=O)=O)O)=O,,,5,1,1,0,1
85034_0,,,,2,1,1,2
C1(C(C=C)(CCC(C(O)O1)=O)O)=O,,,5,1,1,0,1
85036_0,,,,2,1,1,2
C1(C2CC(CCC(C=O)(O2)O)O1)=O,,,5,1,1,0,1
85038_0,,,,2,1,1,2
C1(C2C(CCC(C(O2)O)=O)CO1)=O,,,5,1,1,0,1
85040_0,,,,2,1,1,2
C(C1CCCC(C(O1)O)=O)=O,,,5,1,1,0,1
85042_0,,,,2,1,1,2
C1(C(O)OC([C](CC1)O)=O)=O,,,5,1,1,0,1
85044_0,,,,2,1,1,2
C(C1(COC(C(CC1)=O)O)O)=O,,,5,1,1,0,1
85046_0,,,,2,1,1,2
C(C1C(CCC(C(O1)O)=O)O)=O,,,5,1,1,0,1
85048_0,,,,2,1,1,2
C1(C(O)OCC(CC1)O)=O,,,5,1,1,0,1
85050_0,,,,2,1,1,2
C1(C(CCC(C(O)O1)=O)O)=O,,,5,1,1,0,1
85052_0,,,,2,1,1,2
C(C1(CCC(C(CO1)=O)O)O)=O,,,5,1,1,0,1
85054_0,,,,2,1,1,2
C1(C(O)OCC(CO)(CC1)O)=O,,,5,1,1,0,1
85056_0,,,,2,1,1,2
C1(C(O)OC(CO)C(CC1)O)=O,,,5,1,1,0,1
85058_0,,,,2,1,1,2
C(C1(CCC(C(CO1)O)O)O)=O,,,5,1,1,0,1
85060_0,,,,2,1,1,2
C1(C(CO)(CCC(C(O)O1)=O)O)=O,,,5,1,1,0,1
85062_0,,,,2,1,1,2
C(C1(COC(C(CC1)=O)O)O)(O)=O,,,5,1,1,0,1
85064_0,,,,2,1,1,2
C1(C(C(CCC(C=O)(O)O1)O)O)=O,,,5,1,1,0,1
85066_0,,,,2,1,1,2
C(C1C(CCC(C(O1)O)=O)O)(O)=O,,,5,1,1,0,1
85068_0,,,,2,1,1,2
C1(C(O)OCC(C(C=O)=O)CC1)=O,,,5,1,1,0,1
85070_0,,,,2,1,1,2
C(C1CCC(C(OC1C=O)O)=O)=O,,,5,1,1,0,1
85072_0,,,,2,1,1,2
C(C1(CCC(C=O)C(CO1)=O)O)=O,,,5,1,1,0,1
85074_0,,,,2,1,1,2
C1(CCCC(C=O)(OC1C=O)O)=O,,,5,1,1,0,1
85076_0,,,,2,1,1,2
C1(C(C)(CCC(C(O)O1)=O)O)=O,,,5,1,1,0,1
85078_0,,,,2,1,1,2
C(C1CCCC(C(O1)O)=O)(O)=O,,,5,1,1,0,1
85080_0,,,,2,1,1,2
C1(C(CCCC(C=O)(O)O1)O)=O,,,5,1,1,0,1
85082_0,,,,2,1,1,2
C(C1CC(OC2C(OC1C2)=O)O)=O,,,5,1,1,0,1
85084_0,,,,2,1,1,2
C(C1CC(O)OCC(C1O)O)=O,,,5,1,1,0,1
85086_0,,,,2,1,1,2
C(C1C(C(C(OC(C1)O)=O)O)O)=O,,,5,1,1,0,1
85088_0,,,,2,1,1,2
C(C1CC(OCC(C1C=O)=O)O)=O,,,5,1,1,0,1
85090_0,,,,2,1,1,2
C(C1CC(OC(C=O)C(C1)=O)O)=O,,,5,1,1,0,1
85092_0,,,,2,1,1,2
C(C1CC(C(OC(C1)O)=O)O)=O,,,5,1,1,0,1
85094_0,,,,2,1,1,2
C1(CCC2C(C(C(O)O2)(O)O1)O)=O,,,5,1,1,0,1
85096_0,,,,2,1,1,2
C1(CCCC(C(O)O1)O)=O,,,5,1,1,0,1
85098_0,,,,2,1,1,2
C1(CCC(C(C(O)O1)O)O)=O,,,5,1,1,0,1
85100_0,,,,2,1,1,2
C1(CCC(CO)(C(C(O)O1)O)O)=O,,,5,1,1,0,1
85102_0,,,,2,1,1,2
C(C1(CCC(OC(C1O)O)=O)O)=O,,,5,1,1,0,1
85104_0,,,,2,1,1,2
C1(CCC(C(C(CO)(O)O1)O)O)=O,,,5,1,1,0,1
85106_0,,,,2,1,1,2
C1(CCC(C(CO)(C(O)O1)O)O)=O,,,5,1,1,0,1
85108_0,,,,2,1,1,2
C1(CCC(CC(C=O)(O)O1)O)=O,,,5,1,1,0,1
85110_0,,,,2,1,1,2
C1(CCC(C(C(O)O1)=O)CO)=O,,,5,1,1,0,1
85112_0,,,,2,1,1,2
C(C1(CCC(OC(C1)O)=O)O)=O,,,5,1,1,0,1
85114_0,,,,2,1,1,2
C(C1CCC(OC(C1O)O)=O)=O,,,5,1,1,0,1
85116_0,,,,2,1,1,2
C1(CCC(C(C(O)O1)=O)O)=O,,,5,1,1,0,1
85118_0,,,,2,1,1,2
C1(CCC(C(C(C=O)(O)O1)O)O)=O,,,5,1,1,0,1
85120_0,,,,2,1,1,2
C1(CCC(C(C(O)O1)=O)(CO)O)=O,,,5,1,1,0,1
85122_0,,,,2,1,1,2
C1(CC(CO)CC(C(O)O1)O)=O,,,5,1,1,0,1
85124_0,,,,2,1,1,2
C1(CC(CO)C(C(C(O)O1)O)O)=O,,,5,1,1,0,1
85126_0,,,,2,1,1,2
C1(CC(CO)CC(C(O)O1)=O)=O,,,5,1,1,0,1
85128_0,,,,2,1,1,2
C1(CC(CO)C(C(C(O)O1)=O)O)=O,,,5,1,1,0,1
85130_0,,,,2,1,1,2
C1(CC(O)OC(C(C1O)=O)=O)=O,,,5,1,1,0,1
85132_0,,,,2,1,1,2
C1(C(C(O)OC(C(C1)=O)=O)O)=O,,,5,1,1,0,1
85134_0,,,,2,1,1,2
C1(C(C(CC(C(O)O1)O)O)=O)=O,,,5,1,1,0,1
85136_0,,,,2,1,1,2
C1(C(CCC(C(O)O1)O)O)=O,,,5,1,1,0,1
85138_0,,,,2,1,1,2
C1C(C(CO)(CC(C(O)O1)O)O)O,,,5,1,1,0,1
85140_0,,,,2,1,1,2
C(C1(CCOC(C(C1)O)O)O)=O,,,5,1,1,0,1
85142_0,,,,2,1,1,2
C(C1CC(C(CC(O1)O)O)O)=O,,,5,1,1,0,1
85144_0,,,,2,1,1,2
C(C1CC(CC(C(O1)O)O)O)=O,,,5,1,1,0,1
85146_0,,,,2,1,1,2
C(C1(C(COC(C(C1)O)O)O)O)=O,,,5,1,1,0,1
85148_0,,,,2,1,1,2
C(C1C(C(CC(C(O)O1)O)O)O)O,,,5,1,1,0,1
85149_0,,,,2,1,1,2
85150_0,,,,2,1,1,2
85151_0,,,,2,1,1,2
85152_0,,,,2,1,1,2
85153_0,,,,2,1,1,2
85154_0,,,,2,1,1,2
85155_0,,,,2,1,1,2
85156_0,,,,2,1,1,2
85157_0,,,,2,1,1,2
85158_0,,,,2,1,1,2
85159_0,,,,2,1,1,2
85160_0,,,,2,1,1,2
85161_0,,,,2,1,1,2
85162_0,,,,2,1,1,2
85163_0,,,,2,1,1,2
85164_0,,,,2,1,1,2
85165_0,,,,2,1,1,2
85166_0,,,,2,1,1,2
85167_0,,,,2,1,1,2
85168_0,,,,2,1,1,2
85169_0,,,,2,1,1,2
85170_0,,,,2,1,1,2
85171_0,,,,2,1,1,2
85172_0,,,,2,1,1,2
85173_0,,,,2,1,1,2
85174_0,,,,2,1,1,2
85175_0,,,,2,1,1,2
85176_0,,,,2,1,1,2
85177_0,,,,2,1,1,2
85178_0,,,,2,1,1,2
85179_0,,,,2,1,1,2
85180_0,,,,2,1,1,2
85181_0,,,,2,1,1,2
85182_0,,,,2,1,1,2
85183_0,,,,2,1,1,2
85184_0,,,,2,1,1,2
85185_0,,,,2,1,1,2
85186_0,,,,2,1,1,2
85187_0,,,,2,1,1,2
85188_0,,,,2,1,1,2
85189_0,,,,2,1,1,2
85190_0,,,,2,1,1,2
85191_0,,,,2,1,1,2
85192_0,,,,2,1,1,2
85193_0,,,,2,1,1,2
85194_0,,,,2,1,1,2
85195_0,,,,2,1,1,2
85196_0,,,,2,1,1,2
85197_0,,,,2,1,1,2
85198_0,,,,2,1,1,2
85199_0,,,,2,1,1,2
85200_0,,,,2,1,1,2
85201_0,,,,2,1,1,2
85202_0,,,,2,1,1,2
85203_0,,,,2,1,1,2
85204_0,,,,2,1,1,2
85205_0,,,,2,1,1,2
85206_0,,,,2,1,1,2
85207_0,,,,2,1,1,2
85208_0,,,,2,1,1,2
85209_0,,,,2,1,1,2
85210_0,,,,2,1,1,2
85211_0,,,,2,1,1,2
85212_0,,,,2,1,1,2
85213_0,,,,2,1,1,2
85214_0,,,,2,1,1,2
85215_0,,,,2,1,1,2
85216_0,,,,2,1,1,2
85217_0,,,,2,1,1,2
85218_0,,,,2,1,1,2
85219_0,,,,2,1,1,2
85220_0,,,,2,1,1,2
85221_0,,,,2,1,1,2
85222_0,,,,2,1,1,2
85223_0,,,,2,1,1,2
85224_0,,,,2,1,1,2
85225_0,,,,2,1,1,2
85226_0,,,,2,1,1,2
85227_0,,,,2,1,1,2
85228_0,,,,2,1,1,2
85229_0,,,,2,1,1,2
85230_0,,,,2,1,1,2
85231_0,,,,2,1,1,2
85232_0,,,,2,1,1,2
85233_0,,,,2,1,1,2
85234_0,,,,2,1,1,2
85235_0,,,,2,1,1,2
85236_0,,,,2,1,1,2
85237_0,,,,2,1,1,2
85238_0,,,,2,1,1,2
85239_0,,,,2,1,1,2
85240_0,,,,2,1,1,2
85241_0,,,,2,1,1,2
85242_0,,,,2,1,1,2
85243_0,,,,2,1,1,2
85244_0,,,,2,1,1,2
85245_0,,,,2,1,1,2
85246_0,,,,2,1,1,2
85247_0,,,,2,1,1,2
85248_0,,,,2,1,1,2
85249_0,,,,2,1,1,2
85250_0,,,,2,1,1,2
85251_0,,,,2,1,1,2
85252_0,,,,2,1,1,2
85253_0,,,,2,1,1,2
85254_0,,,,2,1,1,2
85255_0,,,,2,1,1,2
85256_0,,,,2,1,1,2
85257_0,,,,2,1,1,2
85258_0,,,,2,1,1,2
85259_0,,,,2,1,1,2
85260_0,,,,2,1,1,2
85261_0,,,,2,1,1,2
85262_0,,,,2,1,1,2
85263_0,,,,2,1,1,2
85264_0,,,,2,1,1,2
85265_0,,,,2,1,1,2
85266_0,,,,2,1,1,2
85267_0,,,,2,1,1,2
85268_0,,,,2,1,1,2
85269_0,,,,2,1,1,2
85270_0,,,,2,1,1,2
85271_0,,,,2,1,1,2
85272_0,,,,2,1,1,2
85273_0,,,,2,1,1,2
85274_0,,,,2,1,1,2
85275_0,,,,2,1,1,2
85276_0,,,,2,1,1,2
85277_0,,,,2,1,1,2
85278_0,,,,2,1,1,2
85279_0,,,,2,1,1,2
85280_0,,,,2,1,1,2
85282_0,,,,2,1,1,2
C(C(C(CC(C)O)O)=O)(CCO)=O,,,5,1,1,0,1
85283_0,,,,2,1,1,2
85284_0,,,,2,1,1,2
85285_0,,,,2,1,1,2
85286_0,,,,2,1,1,2
85287_0,,,,2,1,1,2
85288_0,,,,2,1,1,2
85289_0,,,,2,1,1,2
85291_0,,,,2,1,1,2
C(C(C=C)(C(C(CCO)=O)=O)O)=O,,,5,1,1,0,1
85293_0,,,,2,1,1,2
C=CC(C(C(C(CCO)=O)=O)O)=O,,,5,1,1,0,1
85295_0,,,,2,1,1,2
C(C(C(C(CCO)=O)=O)O)=CC=O,,,5,1,1,0,1
85296_0,,,,2,1,1,2
85297_0,,,,2,1,1,2
85298_0,,,,2,1,1,2
85299_0,,,,2,1,1,2
85300_0,,,,2,1,1,2
85301_0,,,,2,1,1,2
85302_0,,,,2,1,1,2
85303_0,,,,2,1,1,2
85304_0,,,,2,1,1,2
85305_0,,,,2,1,1,2
85306_0,,,,2,1,1,2
85307_0,,,,2,1,1,2
85308_0,,,,2,1,1,2
85309_0,,,,2,1,1,2
85310_0,,,,2,1,1,2
85311_0,,,,2,1,1,2
85312_0,,,,2,1,1,2
85313_0,,,,2,1,1,2
85314_0,,,,2,1,1,2
85315_0,,,,2,1,1,2
85316_0,,,,2,1,1,2
85317_0,,,,2,1,1,2
85318_0,,,,2,1,1,2
85319_0,,,,2,1,1,2
85320_0,,,,2,1,1,2
85321_0,,,,2,1,1,2
85323_0,,,,2,1,1,2
C(C(C(CO)O)=O)(C(C(O)O)O)=O,,,5,1,1,0,1
85324_0,,,,2,1,1,2
85325_0,,,,2,1,1,2
85326_0,,,,2,1,1,2
85327_0,,,,2,1,1,2
85328_0,,,,2,1,1,2
85329_0,,,,2,1,1,2
85330_0,,,,2,1,1,2
85331_0,,,,2,1,1,2
85332_0,,,,2,1,1,2
85333_0,,,,2,1,1,2
85334_0,,,,2,1,1,2
85335_0,,,,2,1,1,2
85336_0,,,,2,1,1,2
85337_0,,,,2,1,1,2
85338_0,,,,2,1,1,2
85339_0,,,,2,1,1,2
85340_0,,,,2,1,1,2
85341_0,,,,2,1,1,2
85342_0,,,,2,1,1,2
85343_0,,,,2,1,1,2
85344_0,,,,2,1,1,2
85345_0,,,,2,1,1,2
85346_0,,,,2,1,1,2
85347_0,,,,2,1,1,2
85348_0,,,,2,1,1,2
85349_0,,,,2,1,1,2
85350_0,,,,2,1,1,2
85351_0,,,,2,1,1,2
85352_0,,,,2,1,1,2
85353_0,,,,2,1,1,2
85354_0,,,,2,1,1,2
85355_0,,,,2,1,1,2
85356_0,,,,2,1,1,2
85357_0,,,,2,1,1,2
85358_0,,,,2,1,1,2
85359_0,,,,2,1,1,2
85360_0,,,,2,1,1,2
85361_0,,,,2,1,1,2
85362_0,,,,2,1,1,2
85363_0,,,,2,1,1,2
85364_0,,,,2,1,1,2
85365_0,,,,2,1,1,2
85366_0,,,,2,1,1,2
85367_0,,,,2,1,1,2
85368_0,,,,2,1,1,2
85369_0,,,,2,1,1,2
85370_0,,,,2,1,1,2
85371_0,,,,2,1,1,2
85372_0,,,,2,1,1,2
85373_0,,,,2,1,1,2
85374_0,,,,2,1,1,2
85375_0,,,,2,1,1,2
85376_0,,,,2,1,1,2
85377_0,,,,2,1,1,2
85378_0,,,,2,1,1,2
85379_0,,,,2,1,1,2
85380_0,,,,2,1,1,2
85381_0,,,,2,1,1,2
85382_0,,,,2,1,1,2
85383_0,,,,2,1,1,2
85384_0,,,,2,1,1,2
85385_0,,,,2,1,1,2
85386_0,,,,2,1,1,2
85387_0,,,,2,1,1,2
85388_0,,,,2,1,1,2
85389_0,,,,2,1,1,2
85390_0,,,,2,1,1,2
85391_0,,,,2,1,1,2
85392_0,,,,2,1,1,2
85393_0,,,,2,1,1,2
85394_0,,,,2,1,1,2
85395_0,,,,2,1,1,2
85396_0,,,,2,1,1,2
85397_0,,,,2,1,1,2
85398_0,,,,2,1,1,2
85399_0,,,,2,1,1,2
85400_0,,,,2,1,1,2
85401_0,,,,2,1,1,2
85402_0,,,,2,1,1,2
85403_0,,,,2,1,1,2
85404_0,,,,2,1,1,2
85405_0,,,,2,1,1,2
85406_0,,,,2,1,1,2
85407_0,,,,2,1,1,2
85408_0,,,,2,1,1,2
85409_0,,,,2,1,1,2
85410_0,,,,2,1,1,2
85411_0,,,,2,1,1,2
85412_0,,,,2,1,1,2
85413_0,,,,2,1,1,2
85414_0,,,,2,1,1,2
85415_0,,,,2,1,1,2
85416_0,,,,2,1,1,2
85417_0,,,,2,1,1,2
85418_0,,,,2,1,1,2
85419_0,,,,2,1,1,2
85420_0,,,,2,1,1,2
85421_0,,,,2,1,1,2
85422_0,,,,2,1,1,2
85423_0,,,,2,1,1,2
85424_0,,,,2,1,1,2
85425_0,,,,2,1,1,2
85426_0,,,,2,1,1,2
85427_0,,,,2,1,1,2
85428_0,,,,2,1,1,2
85429_0,,,,2,1,1,2
85430_0,,,,2,1,1,2
85431_0,,,,2,1,1,2
85432_0,,,,2,1,1,2
85433_0,,,,2,1,1,2
85434_0,,,,2,1,1,2
85435_0,,,,2,1,1,2
85436_0,,,,2,1,1,2
85437_0,,,,2,1,1,2
85438_0,,,,2,1,1,2
85439_0,,,,2,1,1,2
85440_0,,,,2,1,1,2
85441_0,,,,2,1,1,2
85442_0,,,,2,1,1,2
85443_0,,,,2,1,1,2
85444_0,,,,2,1,1,2
85445_0,,,,2,1,1,2
85446_0,,,,2,1,1,2
85447_0,,,,2,1,1,2
85448_0,,,,2,1,1,2
85449_0,,,,2,1,1,2
85450_0,,,,2,1,1,2
85451_0,,,,2,1,1,2
85452_0,,,,2,1,1,2
85453_0,,,,2,1,1,2
85454_0,,,,2,1,1,2
85455_0,,,,2,1,1,2
85456_0,,,,2,1,1,2
85457_0,,,,2,1,1,2
85458_0,,,,2,1,1,2
85459_0,,,,2,1,1,2
85460_0,,,,2,1,1,2
85461_0,,,,2,1,1,2
85462_0,,,,2,1,1,2
85463_0,,,,2,1,1,2
85464_0,,,,2,1,1,2
85465_0,,,,2,1,1,2
85466_0,,,,2,1,1,2
85467_0,,,,2,1,1,2
85468_0,,,,2,1,1,2
85469_0,,,,2,1,1,2
85470_0,,,,2,1,1,2
85471_0,,,,2,1,1,2
85472_0,,,,2,1,1,2
85473_0,,,,2,1,1,2
85474_0,,,,2,1,1,2
85475_0,,,,2,1,1,2
85476_0,,,,2,1,1,2
85477_0,,,,2,1,1,2
85478_0,,,,2,1,1,2
85479_0,,,,2,1,1,2
85480_0,,,,2,1,1,2
85481_0,,,,2,1,1,2
85482_0,,,,2,1,1,2
85483_0,,,,2,1,1,2
85484_0,,,,2,1,1,2
85485_0,,,,2,1,1,2
85486_0,,,,2,1,1,2
85487_0,,,,2,1,1,2
85488_0,,,,2,1,1,2
85489_0,,,,2,1,1,2
85490_0,,,,2,1,1,2
85491_0,,,,2,1,1,2
85492_0,,,,2,1,1,2
85493_0,,,,2,1,1,2
85494_0,,,,2,1,1,2
85495_0,,,,2,1,1,2
85496_0,,,,2,1,1,2
85497_0,,,,2,1,1,2
85498_0,,,,2,1,1,2
85499_0,,,,2,1,1,2
85500_0,,,,2,1,1,2
85501_0,,,,2,1,1,2
85502_0,,,,2,1,1,2
85503_0,,,,2,1,1,2
85504_0,,,,2,1,1,2
85505_0,,,,2,1,1,2
85506_0,,,,2,1,1,2
85507_0,,,,2,1,1,2
85508_0,,,,2,1,1,2
85509_0,,,,2,1,1,2
85510_0,,,,2,1,1,2
85511_0,,,,2,1,1,2
85512_0,,,,2,1,1,2
85513_0,,,,2,1,1,2
85514_0,,,,2,1,1,2
85515_0,,,,2,1,1,2
85516_0,,,,2,1,1,2
85517_0,,,,2,1,1,2
85518_0,,,,2,1,1,2
85519_0,,,,2,1,1,2
85520_0,,,,2,1,1,2
85521_0,,,,2,1,1,2
85522_0,,,,2,1,1,2
85523_0,,,,2,1,1,2
85524_0,,,,2,1,1,2
85525_0,,,,2,1,1,2
85526_0,,,,2,1,1,2
85527_0,,,,2,1,1,2
85528_0,,,,2,1,1,2
85529_0,,,,2,1,1,2
85530_0,,,,2,1,1,2
85531_0,,,,2,1,1,2
85532_0,,,,2,1,1,2
85533_0,,,,2,1,1,2
85534_0,,,,2,1,1,2
85535_0,,,,2,1,1,2
85536_0,,,,2,1,1,2
85537_0,,,,2,1,1,2
85538_0,,,,2,1,1,2
85539_0,,,,2,1,1,2
85540_0,,,,2,1,1,2
85541_0,,,,2,1,1,2
85542_0,,,,2,1,1,2
85543_0,,,,2,1,1,2
85544_0,,,,2,1,1,2
85545_0,,,,2,1,1,2
85546_0,,,,2,1,1,2
85547_0,,,,2,1,1,2
85548_0,,,,2,1,1,2
85549_0,,,,2,1,1,2
85550_0,,,,2,1,1,2
85551_0,,,,2,1,1,2
85552_0,,,,2,1,1,2
85553_0,,,,2,1,1,2
85554_0,,,,2,1,1,2
85555_0,,,,2,1,1,2
85556_0,,,,2,1,1,2
85557_0,,,,2,1,1,2
85558_0,,,,2,1,1,2
85559_0,,,,2,1,1,2
85560_0,,,,2,1,1,2
85561_0,,,,2,1,1,2
85562_0,,,,2,1,1,2
85563_0,,,,2,1,1,2
85564_0,,,,2,1,1,2
85565_0,,,,2,1,1,2
85566_0,,,,2,1,1,2
85567_0,,,,2,1,1,2
85568_0,,,,2,1,1,2
85569_0,,,,2,1,1,2
85570_0,,,,2,1,1,2
85571_0,,,,2,1,1,2
85572_0,,,,2,1,1,2
85573_0,,,,2,1,1,2
85574_0,,,,2,1,1,2
85575_0,,,,2,1,1,2
85576_0,,,,2,1,1,2
85577_0,,,,2,1,1,2
85578_0,,,,2,1,1,2
85579_0,,,,2,1,1,2
85580_0,,,,2,1,1,2
85581_0,,,,2,1,1,2
85582_0,,,,2,1,1,2
85583_0,,,,2,1,1,2
85584_0,,,,2,1,1,2
85585_0,,,,2,1,1,2
85586_0,,,,2,1,1,2
85587_0,,,,2,1,1,2
85588_0,,,,2,1,1,2
85589_0,,,,2,1,1,2
85590_0,,,,2,1,1,2
85591_0,,,,2,1,1,2
85592_0,,,,2,1,1,2
85593_0,,,,2,1,1,2
85594_0,,,,2,1,1,2
85595_0,,,,2,1,1,2
85596_0,,,,2,1,1,2
85597_0,,,,2,1,1,2
85598_0,,,,2,1,1,2
85599_0,,,,2,1,1,2
85600_0,,,,2,1,1,2
85601_0,,,,2,1,1,2
85602_0,,,,2,1,1,2
85603_0,,,,2,1,1,2
85604_0,,,,2,1,1,2
85605_0,,,,2,1,1,2
85606_0,,,,2,1,1,2
85607_0,,,,2,1,1,2
85608_0,,,,2,1,1,2
85609_0,,,,2,1,1,2
85610_0,,,,2,1,1,2
85611_0,,,,2,1,1,2
85612_0,,,,2,1,1,2
85613_0,,,,2,1,1,2
85614_0,,,,2,1,1,2
85615_0,,,,2,1,1,2
85616_0,,,,2,1,1,2
85617_0,,,,2,1,1,2
85618_0,,,,2,1,1,2
85619_0,,,,2,1,1,2
85620_0,,,,2,1,1,2
85621_0,,,,2,1,1,2
85622_0,,,,2,1,1,2
85623_0,,,,2,1,1,2
85624_0,,,,2,1,1,2
85625_0,,,,2,1,1,2
85626_0,,,,2,1,1,2
85627_0,,,,2,1,1,2
85628_0,,,,2,1,1,2
85629_0,,,,2,1,1,2
85630_0,,,,2,1,1,2
85631_0,,,,2,1,1,2
85632_0,,,,2,1,1,2
85633_0,,,,2,1,1,2
85634_0,,,,2,1,1,2
85635_0,,,,2,1,1,2
85636_0,,,,2,1,1,2
85637_0,,,,2,1,1,2
85638_0,,,,2,1,1,2
85639_0,,,,2,1,1,2
85640_0,,,,2,1,1,2
85641_0,,,,2,1,1,2
85642_0,,,,2,1,1,2
85643_0,,,,2,1,1,2
85644_0,,,,2,1,1,2
85645_0,,,,2,1,1,2
85646_0,,,,2,1,1,2
85647_0,,,,2,1,1,2
85648_0,,,,2,1,1,2
85649_0,,,,2,1,1,2
85650_0,,,,2,1,1,2
85651_0,,,,2,1,1,2
85652_0,,,,2,1,1,2
85653_0,,,,2,1,1,2
85654_0,,,,2,1,1,2
85655_0,,,,2,1,1,2
85656_0,,,,2,1,1,2
85657_0,,,,2,1,1,2
85658_0,,,,2,1,1,2
85659_0,,,,2,1,1,2
85660_0,,,,2,1,1,2
85661_0,,,,2,1,1,2
85662_0,,,,2,1,1,2
85663_0,,,,2,1,1,2
85664_0,,,,2,1,1,2
85665_0,,,,2,1,1,2
85666_0,,,,2,1,1,2
85667_0,,,,2,1,1,2
85668_0,,,,2,1,1,2
85669_0,,,,2,1,1,2
85670_0,,,,2,1,1,2
85671_0,,,,2,1,1,2
85672_0,,,,2,1,1,2
85673_0,,,,2,1,1,2
85674_0,,,,2,1,1,2
85675_0,,,,2,1,1,2
85676_0,,,,2,1,1,2
85677_0,,,,2,1,1,2
85678_0,,,,2,1,1,2
85679_0,,,,2,1,1,2
85680_0,,,,2,1,1,2
85681_0,,,,2,1,1,2
85682_0,,,,2,1,1,2
85683_0,,,,2,1,1,2
85684_0,,,,2,1,1,2
85685_0,,,,2,1,1,2
85686_0,,,,2,1,1,2
85687_0,,,,2,1,1,2
85688_0,,,,2,1,1,2
85689_0,,,,2,1,1,2
85690_0,,,,2,1,1,2
85691_0,,,,2,1,1,2
85692_0,,,,2,1,1,2
85693_0,,,,2,1,1,2
85694_0,,,,2,1,1,2
85695_0,,,,2,1,1,2
85696_0,,,,2,1,1,2
85697_0,,,,2,1,1,2
85698_0,,,,2,1,1,2
85699_0,,,,2,1,1,2
85700_0,,,,2,1,1,2
85701_0,,,,2,1,1,2
85702_0,,,,2,1,1,2
85703_0,,,,2,1,1,2
85704_0,,,,2,1,1,2
85705_0,,,,2,1,1,2
85706_0,,,,2,1,1,2
85707_0,,,,2,1,1,2
85708_0,,,,2,1,1,2
85709_0,,,,2,1,1,2
85710_0,,,,2,1,1,2
85711_0,,,,2,1,1,2
85712_0,,,,2,1,1,2
85713_0,,,,2,1,1,2
85715_0,,,,2,1,1,2
C(CCC(C=O)=O)(CC(CO)=O)=O,,,5,1,1,0,1
85717_0,,,,2,1,1,2
C(C(C(CC(CO)=O)=O)CC=O)=O,,,5,1,1,0,1
85718_0,,,,2,1,1,2
85719_0,,,,2,1,1,2
85720_0,,,,2,1,1,2
85721_0,,,,2,1,1,2
85722_0,,,,2,1,1,2
85723_0,,,,2,1,1,2
85724_0,,,,2,1,1,2
85725_0,,,,2,1,1,2
85726_0,,,,2,1,1,2
85727_0,,,,2,1,1,2
85728_0,,,,2,1,1,2
85729_0,,,,2,1,1,2
85730_0,,,,2,1,1,2
85731_0,,,,2,1,1,2
85732_0,,,,2,1,1,2
85733_0,,,,2,1,1,2
85734_0,,,,2,1,1,2
85735_0,,,,2,1,1,2
85736_0,,,,2,1,1,2
85737_0,,,,2,1,1,2
85738_0,,,,2,1,1,2
85739_0,,,,2,1,1,2
85740_0,,,,2,1,1,2
85741_0,,,,2,1,1,2
85742_0,,,,2,1,1,2
85743_0,,,,2,1,1,2
85744_0,,,,2,1,1,2
85745_0,,,,2,1,1,2
85746_0,,,,2,1,1,2
85747_0,,,,2,1,1,2
85748_0,,,,2,1,1,2
85749_0,,,,2,1,1,2
85750_0,,,,2,1,1,2
85751_0,,,,2,1,1,2
85752_0,,,,2,1,1,2
85753_0,,,,2,1,1,2
85754_0,,,,2,1,1,2
85755_0,,,,2,1,1,2
85756_0,,,,2,1,1,2
85757_0,,,,2,1,1,2
85758_0,,,,2,1,1,2
85759_0,,,,2,1,1,2
85760_0,,,,2,1,1,2
85761_0,,,,2,1,1,2
85762_0,,,,2,1,1,2
85763_0,,,,2,1,1,2
85764_0,,,,2,1,1,2
85765_0,,,,2,1,1,2
85766_0,,,,2,1,1,2
85767_0,,,,2,1,1,2
85768_0,,,,2,1,1,2
85769_0,,,,2,1,1,2
85770_0,,,,2,1,1,2
85771_0,,,,2,1,1,2
85772_0,,,,2,1,1,2
85773_0,,,,2,1,1,2
85774_0,,,,2,1,1,2
85775_0,,,,2,1,1,2
85776_0,,,,2,1,1,2
85777_0,,,,2,1,1,2
85778_0,,,,2,1,1,2
85779_0,,,,2,1,1,2
85780_0,,,,2,1,1,2
85781_0,,,,2,1,1,2
85782_0,,,,2,1,1,2
85783_0,,,,2,1,1,2
85784_0,,,,2,1,1,2
85785_0,,,,2,1,1,2
85786_0,,,,2,1,1,2
85787_0,,,,2,1,1,2
85788_0,,,,2,1,1,2
85789_0,,,,2,1,1,2
85790_0,,,,2,1,1,2
85791_0,,,,2,1,1,2
85792_0,,,,2,1,1,2
85793_0,,,,2,1,1,2
85794_0,,,,2,1,1,2
85795_0,,,,2,1,1,2
85796_0,,,,2,1,1,2
85797_0,,,,2,1,1,2
85798_0,,,,2,1,1,2
85799_0,,,,2,1,1,2
85800_0,,,,2,1,1,2
85801_0,,,,2,1,1,2
85802_0,,,,2,1,1,2
85803_0,,,,2,1,1,2
85804_0,,,,2,1,1,2
85805_0,,,,2,1,1,2
85806_0,,,,2,1,1,2
85807_0,,,,2,1,1,2
85808_0,,,,2,1,1,2
85809_0,,,,2,1,1,2
85810_0,,,,2,1,1,2
85811_0,,,,2,1,1,2
85812_0,,,,2,1,1,2
85813_0,,,,2,1,1,2
85814_0,,,,2,1,1,2
85815_0,,,,2,1,1,2
85816_0,,,,2,1,1,2
85817_0,,,,2,1,1,2
85818_0,,,,2,1,1,2
85819_0,,,,2,1,1,2
85820_0,,,,2,1,1,2
85821_0,,,,2,1,1,2
85822_0,,,,2,1,1,2
85823_0,,,,2,1,1,2
85824_0,,,,2,1,1,2
85825_0,,,,2,1,1,2
85826_0,,,,2,1,1,2
85827_0,,,,2,1,1,2
85828_0,,,,2,1,1,2
85829_0,,,,2,1,1,2
85830_0,,,,2,1,1,2
85831_0,,,,2,1,1,2
85832_0,,,,2,1,1,2
85833_0,,,,2,1,1,2
85834_0,,,,2,1,1,2
85835_0,,,,2,1,1,2
85836_0,,,,2,1,1,2
85837_0,,,,2,1,1,2
85838_0,,,,2,1,1,2
85839_0,,,,2,1,1,2
85840_0,,,,2,1,1,2
85841_0,,,,2,1,1,2
85842_0,,,,2,1,1,2
85843_0,,,,2,1,1,2
85844_0,,,,2,1,1,2
85845_0,,,,2,1,1,2
85846_0,,,,2,1,1,2
85847_0,,,,2,1,1,2
85848_0,,,,2,1,1,2
85849_0,,,,2,1,1,2
85850_0,,,,2,1,1,2
85851_0,,,,2,1,1,2
85852_0,,,,2,1,1,2
85853_0,,,,2,1,1,2
85854_0,,,,2,1,1,2
85855_0,,,,2,1,1,2
85856_0,,,,2,1,1,2
85857_0,,,,2,1,1,2
85858_0,,,,2,1,1,2
85859_0,,,,2,1,1,2
85860_0,,,,2,1,1,2
85861_0,,,,2,1,1,2
85862_0,,,,2,1,1,2
85863_0,,,,2,1,1,2
85864_0,,,,2,1,1,2
85865_0,,,,2,1,1,2
85866_0,,,,2,1,1,2
85867_0,,,,2,1,1,2
85868_0,,,,2,1,1,2
85869_0,,,,2,1,1,2
85870_0,,,,2,1,1,2
85871_0,,,,2,1,1,2
85872_0,,,,2,1,1,2
85873_0,,,,2,1,1,2
85874_0,,,,2,1,1,2
85875_0,,,,2,1,1,2
85876_0,,,,2,1,1,2
85877_0,,,,2,1,1,2
85878_0,,,,2,1,1,2
85879_0,,,,2,1,1,2
85880_0,,,,2,1,1,2
85881_0,,,,2,1,1,2
85882_0,,,,2,1,1,2
85883_0,,,,2,1,1,2
85884_0,,,,2,1,1,2
85885_0,,,,2,1,1,2
85886_0,,,,2,1,1,2
85887_0,,,,2,1,1,2
85888_0,,,,2,1,1,2
85889_0,,,,2,1,1,2
85890_0,,,,2,1,1,2
85891_0,,,,2,1,1,2
85892_0,,,,2,1,1,2
85893_0,,,,2,1,1,2
85894_0,,,,2,1,1,2
85895_0,,,,2,1,1,2
85896_0,,,,2,1,1,2
85897_0,,,,2,1,1,2
85898_0,,,,2,1,1,2
85899_0,,,,2,1,1,2
85900_0,,,,2,1,1,2
85901_0,,,,2,1,1,2
85902_0,,,,2,1,1,2
85903_0,,,,2,1,1,2
85904_0,,,,2,1,1,2
85905_0,,,,2,1,1,2
85906_0,,,,2,1,1,2
85907_0,,,,2,1,1,2
85908_0,,,,2,1,1,2
85909_0,,,,2,1,1,2
85910_0,,,,2,1,1,2
85911_0,,,,2,1,1,2
85912_0,,,,2,1,1,2
85913_0,,,,2,1,1,2
85914_0,,,,2,1,1,2
85915_0,,,,2,1,1,2
85916_0,,,,2,1,1,2
85917_0,,,,2,1,1,2
85918_0,,,,2,1,1,2
85919_0,,,,2,1,1,2
85920_0,,,,2,1,1,2
85921_0,,,,2,1,1,2
85922_0,,,,2,1,1,2
85923_0,,,,2,1,1,2
85924_0,,,,2,1,1,2
85925_0,,,,2,1,1,2
85926_0,,,,2,1,1,2
85927_0,,,,2,1,1,2
85928_0,,,,2,1,1,2
85929_0,,,,2,1,1,2
85930_0,,,,2,1,1,2
85931_0,,,,2,1,1,2
85932_0,,,,2,1,1,2
85933_0,,,,2,1,1,2
85934_0,,,,2,1,1,2
85935_0,,,,2,1,1,2
85936_0,,,,2,1,1,2
85937_0,,,,2,1,1,2
85938_0,,,,2,1,1,2
85939_0,,,,2,1,1,2
85940_0,,,,2,1,1,2
85941_0,,,,2,1,1,2
85942_0,,,,2,1,1,2
85943_0,,,,2,1,1,2
85944_0,,,,2,1,1,2
85945_0,,,,2,1,1,2
85946_0,,,,2,1,1,2
85947_0,,,,2,1,1,2
85948_0,,,,2,1,1,2
85949_0,,,,2,1,1,2
85950_0,,,,2,1,1,2
85951_0,,,,2,1,1,2
85952_0,,,,2,1,1,2
85953_0,,,,2,1,1,2
85954_0,,,,2,1,1,2
85955_0,,,,2,1,1,2
85956_0,,,,2,1,1,2
85957_0,,,,2,1,1,2
85958_0,,,,2,1,1,2
85959_0,,,,2,1,1,2
85960_0,,,,2,1,1,2
85961_0,,,,2,1,1,2
85962_0,,,,2,1,1,2
85963_0,,,,2,1,1,2
85964_0,,,,2,1,1,2
85965_0,,,,2,1,1,2
85966_0,,,,2,1,1,2
85967_0,,,,2,1,1,2
85968_0,,,,2,1,1,2
85969_0,,,,2,1,1,2
85970_0,,,,2,1,1,2
85971_0,,,,2,1,1,2
85972_0,,,,2,1,1,2
85973_0,,,,2,1,1,2
85974_0,,,,2,1,1,2
85975_0,,,,2,1,1,2
85976_0,,,,2,1,1,2
85977_0,,,,2,1,1,2
85978_0,,,,2,1,1,2
85979_0,,,,2,1,1,2
85980_0,,,,2,1,1,2
85981_0,,,,2,1,1,2
85982_0,,,,2,1,1,2
85983_0,,,,2,1,1,2
85984_0,,,,2,1,1,2
85985_0,,,,2,1,1,2
85986_0,,,,2,1,1,2
85987_0,,,,2,1,1,2
85988_0,,,,2,1,1,2
85989_0,,,,2,1,1,2
85990_0,,,,2,1,1,2
85991_0,,,,2,1,1,2
85992_0,,,,2,1,1,2
85993_0,,,,2,1,1,2
85994_0,,,,2,1,1,2
85995_0,,,,2,1,1,2
85996_0,,,,2,1,1,2
85997_0,,,,2,1,1,2
85998_0,,,,2,1,1,2
85999_0,,,,2,1,1,2
86000_0,,,,2,1,1,2
86001_0,,,,2,1,1,2
86002_0,,,,2,1,1,2
86003_0,,,,2,1,1,2
86004_0,,,,2,1,1,2
86005_0,,,,2,1,1,2
86006_0,,,,2,1,1,2
86007_0,,,,2,1,1,2
86008_0,,,,2,1,1,2
86009_0,,,,2,1,1,2
86010_0,,,,2,1,2,3
86011_0,,,,2,1,2,3
86012_0,,,,2,1,2,3
86013_0,,,,2,1,2,3
86014_0,,,,2,1,2,3
86015_0,,,,2,1,2,3
86016_0,,,,2,1,2,3
86017_0,,,,2,1,2,3
86018_0,,,,2,1,2,3
86019_0,,,,2,1,2,3
86020_0,,,,2,1,2,3
86021_0,,,,2,1,2,3
86022_0,,,,2,1,2,3
86023_0,,,,2,1,2,3
86024_0,,,,2,1,2,3
86025_0,,,,2,1,2,3
86026_0,,,,2,1,2,3
86027_0,,,,2,1,2,3
86028_0,,,,2,1,2,3
86029_0,,,,2,1,2,3
86030_0,,,,2,1,2,3
86031_0,,,,2,1,2,3
86032_0,,,,2,1,2,3
86033_0,,,,2,1,2,3
86034_0,,,,2,1,2,3
86035_0,,,,2,1,2,3
86036_0,,,,2,1,2,3
86037_0,,,,2,1,2,3
86038_0,,,,2,1,2,3
86039_0,,,,2,1,2,3
86040_0,,,,2,1,2,3
86041_0,,,,2,1,2,3
86042_0,,,,2,1,2,3
86043_0,,,,2,1,2,3
86044_0,,,,2,1,2,3
86045_0,,,,2,1,2,3
86046_0,,,,2,1,2,3
86047_0,,,,2,1,2,3
86048_0,,,,2,1,2,3
86049_0,,,,2,1,2,3
86050_0,,,,2,1,2,3
86051_0,,,,2,1,2,3
86052_0,,,,2,1,2,3
86053_0,,,,2,1,2,3
86054_0,,,,2,1,2,3
86055_0,,,,2,1,2,3
86056_0,,,,2,1,2,3
86057_0,,,,2,1,2,3
86058_0,,,,2,1,2,3
86059_0,,,,2,1,2,3
86060_0,,,,2,1,2,3
86061_0,,,,2,1,2,3
86062_0,,,,2,1,2,3
86063_0,,,,2,1,2,3
86064_0,,,,2,1,2,3
86065_0,,,,2,1,2,3
86066_0,,,,2,1,2,3
86067_0,,,,2,1,2,3
86068_0,,,,2,1,2,3
86069_0,,,,2,1,2,3
86070_0,,,,2,1,2,3
86071_0,,,,2,1,2,3
86072_0,,,,2,1,2,3
86073_0,,,,2,1,2,3
86074_0,,,,2,1,2,3
86075_0,,,,2,1,2,3
86076_0,,,,2,1,2,3
86077_0,,,,2,1,2,3
86078_0,,,,2,1,2,3
86079_0,,,,2,1,2,3
86080_0,,,,2,1,2,3
86081_0,,,,2,1,2,3
86082_0,,,,2,1,2,3
86083_0,,,,2,1,2,3
86084_0,,,,2,1,2,3
86085_0,,,,2,1,2,3
86086_0,,,,2,1,2,3
86087_0,,,,2,1,2,3
86088_0,,,,2,1,2,3
86089_0,,,,2,1,2,3
86090_0,,,,2,1,2,3
86091_0,,,,2,1,2,3
86092_0,,,,2,1,2,3
86093_0,,,,2,1,2,3
86094_0,,,,2,1,2,3
86095_0,,,,2,1,2,3
86096_0,,,,2,1,2,3
86097_0,,,,2,1,2,3
86098_0,,,,2,1,2,3
86099_0,,,,2,1,2,3
86100_0,,,,2,1,2,3
86101_0,,,,2,1,2,3
86102_0,,,,2,1,2,3
86103_0,,,,2,1,2,3
86104_0,,,,2,1,2,3
86105_0,,,,2,1,2,3
86106_0,,,,2,1,2,3
86107_0,,,,2,1,2,3
86108_0,,,,2,1,2,3
86109_0,,,,2,1,2,3
86110_0,,,,2,1,2,3
86111_0,,,,2,1,2,3
86112_0,,,,2,1,2,3
86113_0,,,,2,1,2,3
86114_0,,,,2,1,2,3
86115_0,,,,2,1,2,3
86116_0,,,,2,1,2,3
86117_0,,,,2,1,2,3
86118_0,,,,2,1,2,3
86119_0,,,,2,1,2,3
86120_0,,,,2,1,2,3
86121_0,,,,2,1,2,3
86122_0,,,,2,1,2,3
86123_0,,,,2,1,2,3
86124_0,,,,2,1,2,3
86125_0,,,,2,1,2,3
86126_0,,,,2,1,2,3
86127_0,,,,2,1,2,3
86128_0,,,,2,1,2,3
86129_0,,,,2,1,2,3
86130_0,,,,2,1,2,3
86131_0,,,,2,1,2,3
86132_0,,,,2,1,2,3
86133_0,,,,2,1,2,3
86134_0,,,,2,1,2,3
86135_0,,,,2,1,2,3
86136_0,,,,2,1,2,3
86137_0,,,,2,1,2,3
86138_0,,,,2,1,2,3
86139_0,,,,2,1,2,3
86140_0,,,,2,1,2,3
86141_0,,,,2,1,2,3
86142_0,,,,2,1,2,3
86143_0,,,,2,1,2,3
86144_0,,,,2,1,2,3
86145_0,,,,2,1,2,3
86146_0,,,,2,1,2,3
86147_0,,,,2,1,2,3
86148_0,,,,2,1,2,3
86149_0,,,,2,1,2,3
86150_0,,,,2,1,2,3
86151_0,,,,2,1,2,3
86152_0,,,,2,1,2,3
86153_0,,,,2,1,2,3
86154_0,,,,2,1,2,3
86155_0,,,,2,1,2,3
86156_0,,,,2,1,2,3
86157_0,,,,2,1,2,3
86158_0,,,,2,1,2,3
86159_0,,,,2,1,2,3
86160_0,,,,2,1,2,3
86161_0,,,,2,1,2,3
86162_0,,,,2,1,2,3
86163_0,,,,2,1,2,3
86164_0,,,,2,1,2,3
86165_0,,,,2,1,2,3
86166_0,,,,2,1,2,3
86167_0,,,,2,1,2,3
86168_0,,,,2,1,2,3
86169_0,,,,2,1,2,3
86170_0,,,,2,1,2,3
86171_0,,,,2,1,2,3
86172_0,,,,2,1,2,3
86173_0,,,,2,1,2,3
86174_0,,,,2,1,2,3
86175_0,,,,2,1,2,3
86176_0,,,,2,1,2,3
86177_0,,,,2,1,2,3
86178_0,,,,2,1,2,3
86179_0,,,,2,1,2,3
86180_0,,,,2,1,2,3
86181_0,,,,2,1,2,3
86182_0,,,,2,1,2,3
86183_0,,,,2,1,2,3
86184_0,,,,2,1,2,3
86185_0,,,,2,1,2,3
86186_0,,,,2,1,2,3
86187_0,,,,2,1,2,3
86188_0,,,,2,1,2,3
86189_0,,,,2,1,2,3
86191_0,,,,2,1,2,3
C1(C(CC(C=O)(CC=O)O1)O)=O,,,5,1,1,0,1
86193_0,,,,2,1,2,3
C1(C(C(C=O)=O)C(C(O1)=O)O)=O,,,5,1,1,0,1
86195_0,,,,2,1,2,3
C1(C(C(C(C=O)=O)C(C)O1)O)=O,,,5,1,1,0,1
86197_0,,,,2,1,2,3
C(CC1C(C=O)C(C(O1)=O)O)=O,,,5,1,1,0,1
86199_0,,,,2,1,2,3
C(C(CO)C1CC(C(O1)=O)O)=O,,,5,1,1,0,1
86200_0,,,,2,1,2,3
86201_0,,,,2,1,2,3
86203_0,,,,2,1,2,3
C1(C(CC(CC(C=O)=O)O1)O)=O,,,5,1,1,0,1
86205_0,,,,2,1,2,3
C(C(C=O)C1CC(C(O1)=O)O)=O,,,5,1,1,0,1
86206_0,,,,2,1,2,3
86208_0,,,,2,1,2,3
C1(C(CC(C(C=O)O)O1)O)=O,,,5,1,1,0,1
86210_0,,,,2,1,2,3
C(C1C(CCO)OC(C1O)=O)=O,,,5,1,1,0,1
86212_0,,,,2,1,2,3
C(C1C(CO)(C)OC(C1O)=O)=O,,,5,1,1,0,1
86213_0,,,,2,1,2,3
86215_0,,,,2,1,2,3
C(C1C(C(O)O)OC(C1O)=O)=O,,,5,1,1,0,1
86217_0,,,,2,1,2,3
C(C1C(C(C)O)OC(C1O)=O)=O,,,5,1,1,0,1
86218_0,,,,2,1,2,3
86220_0,,,,2,1,2,3
C1(C(C(C=O)C(C=O)(C)O1)O)=O,,,5,1,1,0,1
86222_0,,,,2,1,2,3
C1(C(C(C=O)C(C(C)=O)O1)O)=O,,,5,1,1,0,1
86224_0,,,,2,1,2,3
C(C1C(C)OC(C1O)=O)=O,,,5,1,1,0,1
86225_0,,,,2,1,2,3
86226_0,,,,2,1,2,3
86228_0,,,,2,1,2,3
C1(CC(C(CC(C=O)=O)O1)=O)=O,,,5,1,1,0,1
86230_0,,,,2,1,2,3
C(C(C=O)C1C(CC(O1)=O)=O)=O,,,5,1,1,0,1
86231_0,,,,2,1,2,3
86232_0,,,,2,1,2,3
86233_0,,,,2,1,2,3
86235_0,,,,2,1,2,3
C1(C(C=O)C(C(C=O)O1)O)=O,,,5,1,1,0,1
86237_0,,,,2,1,2,3
C(C(C1CC(C(O1)=O)=O)CO)=O,,,5,1,1,0,1
86239_0,,,,2,1,2,3
C(CC1C(C(C(O1)=O)CO)=O)=O,,,5,1,1,0,1
86241_0,,,,2,1,2,3
C1(C(C=O)C(C(CC=O)O1)O)=O,,,5,1,1,0,1
86242_0,,,,2,1,2,3
86244_0,,,,2,1,2,3
C1(C(C=O)C(CO1)(CC=O)O)=O,,,5,1,1,0,1
86246_0,,,,2,1,2,3
C1(C(C=O)C(C(C(C)O)O1)=O)=O,,,5,1,1,0,1
86248_0,,,,2,1,2,3
C1(C(C=O)C(C(CO)O1)=O)=O,,,5,1,1,0,1
86250_0,,,,2,1,2,3
C1(C(C=O)C(C(C(C)=O)O1)O)=O,,,5,1,1,0,1
86251_0,,,,2,1,2,3
86253_0,,,,2,1,2,3
C1(C(C=O)C(C)(C(C=O)O1)O)=O,,,5,1,1,0,1
86255_0,,,,2,1,2,3
C1(C(C(C(C=O)O1)=O)C(C)O)=O,,,5,1,1,0,1
86257_0,,,,2,1,2,3
C1(C(C(C(C=O)O1)=O)CO)=O,,,5,1,1,0,1
86259_0,,,,2,1,2,3
C1(C(CC(CC(C)O)O1)=O)=O,,,5,1,1,0,1
86261_0,,,,2,1,2,3
C1(C(C(C(CC(C)O)O1)O)=O)=O,,,5,1,1,0,1
86263_0,,,,2,1,2,3
C(C1C(C)OC(C1(C)O)=O)=O,,,5,1,1,0,1
86265_0,,,,2,1,2,3
C(C1C(C)OC(C1(CO)O)=O)=O,,,5,1,1,0,1
86267_0,,,,2,1,2,3
C1(C(CC(C(C(C)O)O)O1)=O)=O,,,5,1,1,0,1
86269_0,,,,2,1,2,3
C1(C(C=O)C(C(C(C)O)O1)O)=O,,,5,1,1,0,1
86270_0,,,,2,1,2,3
86271_0,,,,2,1,2,3
86272_0,,,,2,1,2,3
86274_0,,,,2,1,2,3
C1(C(CC(CCO)O1)=O)=O,,,5,1,1,0,1
86275_0,,,,2,1,2,3
86277_0,,,,2,1,2,3
C1(C(C(CO)C(CCO)O1)=O)=O,,,5,1,1,0,1
86278_0,,,,2,1,2,3
86279_0,,,,2,1,2,3
86281_0,,,,2,1,2,3
C1(C(C(C(CCO)O1)O)=O)=O,,,5,1,1,0,1
86283_0,,,,2,1,2,3
C(C1C(C(OC1CCO)=O)=O)=O,,,5,1,1,0,1
86284_0,,,,2,1,2,3
86285_0,,,,2,1,2,3
86287_0,,,,2,1,2,3
C(C1COC(C1(CCO)O)=O)=O,,,5,1,1,0,1
86289_0,,,,2,1,2,3
C(C(CO)C1C(CC(O1)=O)O)=O,,,5,1,1,0,1
86290_0,,,,2,1,2,3
86291_0,,,,2,1,2,3
86293_0,,,,2,1,2,3
C(C(CO)C1C(CC(O1)=O)=O)=O,,,5,1,1,0,1
86295_0,,,,2,1,2,3
C(CC1(C(OCC1C=O)=O)O)=O,,,5,1,1,0,1
86297_0,,,,2,1,2,3
C1(C(CC(CC(CO)O)O1)=O)=O,,,5,1,1,0,1
86299_0,,,,2,1,2,3
C(C1C(CO)OC(C1(C)O)=O)=O,,,5,1,1,0,1
86300_0,,,,2,1,2,3
86301_0,,,,2,1,2,3
86303_0,,,,2,1,2,3
C(C1(C(C(C(O1)=O)O)=O)CO)=O,,,5,1,1,0,1
86304_0,,,,2,1,2,3
86305_0,,,,2,1,2,3
86306_0,,,,2,1,2,3
86307_0,,,,2,1,2,3
86309_0,,,,2,1,2,3
C(C)(C1(CO)CC(C(O1)=O)=O)=O,,,5,1,1,0,1
86311_0,,,,2,1,2,3
C1(C(C=O)C(C(C)=O)(CO1)O)=O,,,5,1,1,0,1
86313_0,,,,2,1,2,3
C(CO)(C1(C)CC(C(O1)=O)=O)=O,,,5,1,1,0,1
86315_0,,,,2,1,2,3
C1(CC(C(C(C(C)=O)=O)O1)O)=O,,,5,1,1,0,1
86317_0,,,,2,1,2,3
C(C1(C(C)O)CC(C(O1)=O)=O)=O,,,5,1,1,0,1
86319_0,,,,2,1,2,3
C1(C(C=O)C(C=O)(C(C)O1)O)=O,,,5,1,1,0,1
86321_0,,,,2,1,2,3
C(C1CC(C(O1)=O)=O)(C(C)O)=O,,,5,1,1,0,1
86322_0,,,,2,1,2,3
86324_0,,,,2,1,2,3
C(C(C1C(C(C(O1)=O)=O)O)O)=O,,,5,1,1,0,1
86326_0,,,,2,1,2,3
C1(C(CC(C)(CO)O1)=O)=O,,,5,1,1,0,1
86328_0,,,,2,1,2,3
C1(C(C=O)C(C)(CO1)O)=O,,,5,1,1,0,1
86329_0,,,,2,1,2,3
86331_0,,,,2,1,2,3
C1(C(C(CO)C(C)(CO)O1)=O)=O,,,5,1,1,0,1
86332_0,,,,2,1,2,3
86334_0,,,,2,1,2,3
C1(C(C(CO)=O)C(C)(CO1)O)=O,,,5,1,1,0,1
86335_0,,,,2,1,2,3
86337_0,,,,2,1,2,3
C1(C(C(C(CO)(C)O1)O)=O)=O,,,5,1,1,0,1
86339_0,,,,2,1,2,3
C1(C(C(C=O)=O)C(C)(CO1)O)=O,,,5,1,1,0,1
86341_0,,,,2,1,2,3
C(C1C(C(OC1(C)CO)=O)=O)=O,,,5,1,1,0,1
86342_0,,,,2,1,2,3
86344_0,,,,2,1,2,3
C1(CC(C(C(C(C)=O)O)O1)O)=O,,,5,1,1,0,1
86345_0,,,,2,1,2,3
86347_0,,,,2,1,2,3
C1(CC(CO)(C(C(C)=O)O1)O)=O,,,5,1,1,0,1
86349_0,,,,2,1,2,3
C1(C(C(C)(C(C(C)=O)O1)O)O)=O,,,5,1,1,0,1
86350_0,,,,2,1,2,3
86351_0,,,,2,1,2,3
86353_0,,,,2,1,2,3
C(C)(C(C1CC(C(O1)=O)=O)O)=O,,,5,1,1,0,1
86354_0,,,,2,1,2,3
86356_0,,,,2,1,2,3
C1(CC(C(CC(CO)=O)O1)O)=O,,,5,1,1,0,1
86357_0,,,,2,1,2,3
86359_0,,,,2,1,2,3
C1(CC(C(CC(CO)=O)O1)=O)=O,,,5,1,1,0,1
86361_0,,,,2,1,2,3
C(CO)(CC1CC(C(O1)=O)=O)=O,,,5,1,1,0,1
86363_0,,,,2,1,2,3
C1(C(CC(CO)(CCO)O1)=O)=O,,,5,1,1,0,1
86365_0,,,,2,1,2,3
C1(C(C=O)C(CO1)(CCO)O)=O,,,5,1,1,0,1
86367_0,,,,2,1,2,3
C1(CC(C(C(CCO)=O)O1)O)=O,,,5,1,1,0,1
86369_0,,,,2,1,2,3
C1(C(C)(C(C(CO)=O)CO1)O)=O,,,5,1,1,0,1
86370_0,,,,2,1,2,3
86371_0,,,,2,1,2,3
86373_0,,,,2,1,2,3
C1(C(CC(C(CCO)O)O1)=O)=O,,,5,1,1,0,1
86375_0,,,,2,1,2,3
C1(C(C=O)C(C(CCO)O1)O)=O,,,5,1,1,0,1
86377_0,,,,2,1,2,3
C1(C(CC(C)(C(CO)O)O1)=O)=O,,,5,1,1,0,1
86379_0,,,,2,1,2,3
C1(C(C=O)C(C)(C(CO)O1)O)=O,,,5,1,1,0,1
86381_0,,,,2,1,2,3
C(C1(C)CC(C(O1)=O)=O)(O)=O,,,5,1,1,0,1
86383_0,,,,2,1,2,3
C1(C(C=O)C(C(O1)=O)(C)O)=O,,,5,1,1,0,1
86385_0,,,,2,1,2,3
C(C1(C)C(C(C(O1)=O)=O)O)(O)=O,,,5,1,1,0,1
86387_0,,,,2,1,2,3
C1(C(C)(C2C(COC2O1)=O)O)=O,,,5,1,1,0,1
86389_0,,,,2,1,2,3
C1(C(C)(C(C(C=O)=O)CO1)O)=O,,,5,1,1,0,1
86391_0,,,,2,1,2,3
C1(C(C)(C(C=O)C(C=O)O1)O)=O,,,5,1,1,0,1
86393_0,,,,2,1,2,3
C(CC1CC(C(O1)=O)=O)(O)=O,,,5,1,1,0,1
86395_0,,,,2,1,2,3
C(C1(CO)CC(C(O1)=O)=O)(O)=O,,,5,1,1,0,1
86397_0,,,,2,1,2,3
C(CC1(C=O)CC(C(O1)=O)=O)=O,,,5,1,1,0,1
86399_0,,,,2,1,2,3
C(CC(C1CC(C(O1)=O)=O)=O)=O,,,5,1,1,0,1
86401_0,,,,2,1,2,3
C(C(CC1CC(C(O1)=O)=O)=O)=O,,,5,1,1,0,1
86403_0,,,,2,1,2,3
C1(C(CC2(COCC2O)O1)=O)=O,,,5,1,1,0,1
86405_0,,,,2,1,2,3
C1(C(CC2(C(O)OCC2)O1)=O)=O,,,5,1,1,0,1
86407_0,,,,2,1,2,3
C1(C(CC2(COC(C2)O)O1)=O)=O,,,5,1,1,0,1
86409_0,,,,2,1,2,3
C(C1(C(C)=O)CC(C(O1)=O)=O)=O,,,5,1,1,0,1
86411_0,,,,2,1,2,3
C1(C(CC(C(C(C)=O)=O)O1)=O)=O,,,5,1,1,0,1
86413_0,,,,2,1,2,3
C(C=O)(C1(C)CC(C(O1)=O)=O)=O,,,5,1,1,0,1
86415_0,,,,2,1,2,3
C(C1(C=C)CC(C(O1)=O)=O)=O,,,5,1,1,0,1
86417_0,,,,2,1,2,3
C=CC(C1CC(C(O1)=O)=O)=O,,,5,1,1,0,1
86419_0,,,,2,1,2,3
C(C1CC(C(O1)=O)=O)=CC=O,,,5,1,1,0,1
86420_0,,,,2,1,2,3
86422_0,,,,2,1,2,3
C1(C(CC(C(O)O)O1)=O)=O,,,5,1,1,0,1
86424_0,,,,2,1,2,3
C1(C(CC(C(C)O)O1)=O)=O,,,5,1,1,0,1
86426_0,,,,2,1,2,3
C(C1CC(C(O1)=O)=O)=O,,,5,1,1,0,1
86427_0,,,,2,1,2,3
86429_0,,,,2,1,2,3
C(C1CC(C(O1)=O)=O)(O)=O,,,5,1,1,0,1
86431_0,,,,2,1,2,3
C(C1(C)CC(C(O1)=O)=O)=O,,,5,1,1,0,1
86432_0,,,,2,1,2,3
86433_0,,,,2,1,2,3
86435_0,,,,2,1,2,3
C(C1(CCO)CC(C(O1)=O)=O)=O,,,5,1,1,0,1
86437_0,,,,2,1,2,3
C(C1CC(C(O1)=O)=O)(CCO)=O,,,5,1,1,0,1
86439_0,,,,2,1,2,3
C(CC(C1CC(C(O1)=O)=O)O)=O,,,5,1,1,0,1
86441_0,,,,2,1,2,3
C(C(CC1CC(C(O1)=O)=O)O)=O,,,5,1,1,0,1
86443_0,,,,2,1,2,3
C(CC1(CO)CC(C(O1)=O)=O)=O,,,5,1,1,0,1
86445_0,,,,2,1,2,3
C(C(C1(C)CC(C(O1)=O)=O)O)=O,,,5,1,1,0,1
86447_0,,,,2,1,2,3
C1(C(OC(C)C1)=O)=O,,,5,1,1,0,1
86449_0,,,,2,1,2,3
C(C1(CO)CC(C(O1)=O)=O)=O,,,5,1,1,0,1
86451_0,,,,2,1,2,3
C(CO)(C1CC(C(O1)=O)=O)=O,,,5,1,1,0,1
86453_0,,,,2,1,2,3
C(CC1C(C(C(O1)=O)=O)O)(O)=O,,,5,1,1,0,1
86455_0,,,,2,1,2,3
C1(CC(C(C(C(O)=O)=O)O1)O)=O,,,5,1,1,0,1
86457_0,,,,2,1,2,3
C1(CC(C(C(CO)=O)O1)O)=O,,,5,1,1,0,1
86459_0,,,,2,1,2,3
C1(CC(C(C(CC=O)=O)O1)O)=O,,,5,1,1,0,1
86461_0,,,,2,1,2,3
C1(CC(C(C(C=O)=O)O1)O)=O,,,5,1,1,0,1
86463_0,,,,2,1,2,3
C1(CC(C(C=O)O1)O)=O,,,5,1,1,0,1
86465_0,,,,2,1,2,3
C1(C(C=O)C(C(O1)=O)(CO)O)=O,,,5,1,1,0,1
86467_0,,,,2,1,2,3
C1(C(C=O)C(C(O)=O)(CO1)O)=O,,,5,1,1,0,1
86469_0,,,,2,1,2,3
C1(C(C=O)C2(COCC2O1)O)=O,,,5,1,1,0,1
86471_0,,,,2,1,2,3
C1(C(C=O)C2(C(OCC2)O1)O)=O,,,5,1,1,0,1
86472_0,,,,2,1,2,3
86474_0,,,,2,1,2,3
C1(C(C=O)C(C(C)O1)O)=O,,,5,1,1,0,1
86475_0,,,,2,1,2,3
86476_0,,,,2,1,2,3
86477_0,,,,2,1,2,3
86478_0,,,,2,1,2,3
86479_0,,,,2,1,2,3
86481_0,,,,2,1,2,3
C1(C(C(CO)C(C(O)O)O1)=O)=O,,,5,1,1,0,1
86482_0,,,,2,1,2,3
86484_0,,,,2,1,2,3
C1(C(C(CO)C(C(C)O)O1)=O)=O,,,5,1,1,0,1
86485_0,,,,2,1,2,3
86487_0,,,,2,1,2,3
C(C1C(C(C(O1)=O)=O)CO)=O,,,5,1,1,0,1
86488_0,,,,2,1,2,3
86489_0,,,,2,1,2,3
86491_0,,,,2,1,2,3
C(C1C(C(C(O1)=O)=O)CO)(O)=O,,,5,1,1,0,1
86492_0,,,,2,1,2,3
86494_0,,,,2,1,2,3
C(C1(C)C(C(C(O1)=O)=O)CO)=O,,,5,1,1,0,1
86495_0,,,,2,1,2,3
86497_0,,,,2,1,2,3
C(C1C(C(C(O1)=O)=O)CO)(C)=O,,,5,1,1,0,1
86498_0,,,,2,1,2,3
86500_0,,,,2,1,2,3
C(CC1C(C(C(O1)=O)=O)CO)=O,,,5,1,1,0,1
86501_0,,,,2,1,2,3
86503_0,,,,2,1,2,3
C1(C(C(CO)C(C)O1)=O)=O,,,5,1,1,0,1
86504_0,,,,2,1,2,3
86505_0,,,,2,1,2,3
86506_0,,,,2,1,2,3
86507_0,,,,2,1,2,3
86508_0,,,,2,1,2,3
86509_0,,,,2,1,2,3
86510_0,,,,2,1,2,3
86511_0,,,,2,1,2,3
86512_0,,,,2,1,2,3
86513_0,,,,2,1,2,3
86514_0,,,,2,1,2,3
86516_0,,,,2,1,2,3
C1(CC(CO)(C(C=O)O1)O)=O,,,5,1,1,0,1
86517_0,,,,2,1,2,3
86518_0,,,,2,1,2,3
86519_0,,,,2,1,2,3
86520_0,,,,2,1,2,3
86522_0,,,,2,1,2,3
C1(C(C(CO)=O)C(C(C)O1)O)=O,,,5,1,1,0,1
86523_0,,,,2,1,2,3
86524_0,,,,2,1,2,3
86526_0,,,,2,1,2,3
C1(C(C(CO)=O)C(C(O1)=O)O)=O,,,5,1,1,0,1
86527_0,,,,2,1,2,3
86528_0,,,,2,1,2,3
86529_0,,,,2,1,2,3
86530_0,,,,2,1,2,3
86531_0,,,,2,1,2,3
86532_0,,,,2,1,2,3
86533_0,,,,2,1,2,3
86534_0,,,,2,1,2,3
86535_0,,,,2,1,2,3
86536_0,,,,2,1,2,3
86537_0,,,,2,1,2,3
86538_0,,,,2,1,2,3
86540_0,,,,2,1,2,3
C(C1(C=C)C(C(C(O1)=O)=O)O)=O,,,5,1,1,0,1
86542_0,,,,2,1,2,3
C=CC(C1C(C(C(O1)=O)=O)O)=O,,,5,1,1,0,1
86544_0,,,,2,1,2,3
C(C1C(C(C(O1)=O)=O)O)=CC=O,,,5,1,1,0,1
86546_0,,,,2,1,2,3
C1(C(C(C(O1)=O)=O)O)=O,,,5,1,1,0,1
86548_0,,,,2,1,2,3
C1(C(C(C(C(O)O)O1)O)=O)=O,,,5,1,1,0,1
86550_0,,,,2,1,2,3
C1(C(C(C(C(C)O)O1)O)=O)=O,,,5,1,1,0,1
86552_0,,,,2,1,2,3
C(C1C(C(C(O1)=O)=O)O)=O,,,5,1,1,0,1
86554_0,,,,2,1,2,3
C1(C(C(C(CO)(CO)O1)O)=O)=O,,,5,1,1,0,1
86556_0,,,,2,1,2,3
C(C1C(C(C(O1)=O)=O)O)(O)=O,,,5,1,1,0,1
86558_0,,,,2,1,2,3
C(C1(C)C(C(C(O1)=O)=O)O)=O,,,5,1,1,0,1
86559_0,,,,2,1,2,3
86560_0,,,,2,1,2,3
86562_0,,,,2,1,2,3
C1(C(C(C(C)O1)O)=O)=O,,,5,1,1,0,1
86564_0,,,,2,1,2,3
C(C1(CO)C(C(C(O1)=O)=O)O)=O,,,5,1,1,0,1
86566_0,,,,2,1,2,3
C(CO)(C1C(C(C(O1)=O)=O)O)=O,,,5,1,1,0,1
86567_0,,,,2,1,2,3
86569_0,,,,2,1,2,3
C1(C(C(C(CO)(CO)O1)=O)O)=O,,,5,1,1,0,1
86571_0,,,,2,1,2,3
C(C1(C(CC(O1)=O)=O)C(C)O)=O,,,5,1,1,0,1
86573_0,,,,2,1,2,3
C(C1(C(CC(O1)=O)=O)CO)=O,,,5,1,1,0,1
86575_0,,,,2,1,2,3
C(CC1C(C)(C(C(O1)=O)O)O)=O,,,5,1,1,0,1
86577_0,,,,2,1,2,3
C(CC1(C)C(C(C(O1)=O)O)O)=O,,,5,1,1,0,1
86579_0,,,,2,1,2,3
C1(C(C=O)C(C(C(O)=O)O1)O)=O,,,5,1,1,0,1
86580_0,,,,2,1,2,3
86582_0,,,,2,1,2,3
C1(C(C(C(O1)=O)=O)C(CO)O)=O,,,5,1,1,0,1
86583_0,,,,2,1,2,3
86584_0,,,,2,1,2,3
86586_0,,,,2,1,2,3
C1(C(C(C(C)O1)C(CO)O)=O)=O,,,5,1,1,0,1
86587_0,,,,2,1,2,3
86588_0,,,,2,1,2,3
86590_0,,,,2,1,2,3
C(CO)(C1C(C)OC(C1O)=O)=O,,,5,1,1,0,1
86591_0,,,,2,1,2,3
86592_0,,,,2,1,2,3
86593_0,,,,2,1,2,3
86594_0,,,,2,1,2,3
86596_0,,,,2,1,2,3
C1(C(C(C(C(O)=O)O1)=O)CO)=O,,,5,1,1,0,1
86597_0,,,,2,1,2,3
86598_0,,,,2,1,2,3
86600_0,,,,2,1,2,3
C1(C(C(C=O)=O)C(C(C)O1)O)=O,,,5,1,1,0,1
86602_0,,,,2,1,2,3
C(C(C=O)C1CC(C(O1)=O)=O)=O,,,5,1,1,0,1
86604_0,,,,2,1,2,3
C(C1C(OC(C1=O)=O)=O)=O,,,5,1,1,0,1
86606_0,,,,2,1,2,3
C(C1C(C(OC1C(O)O)=O)=O)=O,,,5,1,1,0,1
86608_0,,,,2,1,2,3
C(C1C(C(OC1C(C)O)=O)=O)=O,,,5,1,1,0,1
86609_0,,,,2,1,2,3
86611_0,,,,2,1,2,3
C(C1C(C(OC1C(O)=O)=O)=O)=O,,,5,1,1,0,1
86613_0,,,,2,1,2,3
C(C1C(C(OC1(C=O)C)=O)=O)=O,,,5,1,1,0,1
86615_0,,,,2,1,2,3
C(C1C(C(OC1C(C)=O)=O)=O)=O,,,5,1,1,0,1
86617_0,,,,2,1,2,3
C(C1C(C(OC1CC=O)=O)=O)=O,,,5,1,1,0,1
86618_0,,,,2,1,2,3
86619_0,,,,2,1,2,3
86620_0,,,,2,1,2,3
86622_0,,,,2,1,2,3
C1(C2C(C(CO2)O1)=O)=O,,,5,1,1,0,1
86624_0,,,,2,1,2,3
C1(C2C(C(OC2)O1)=O)=O,,,5,1,1,0,1
86626_0,,,,2,1,2,3
C1(COC2C1C(C(O2)=O)O)=O,,,5,1,1,0,1
86628_0,,,,2,1,2,3
C(C1C(OCC1=O)=O)=O,,,5,1,1,0,1
86630_0,,,,2,1,2,3
C(C1C(CC(O1)=O)=O)=O,,,5,1,1,0,1
86631_0,,,,2,1,2,3
86632_0,,,,2,1,2,3
86633_0,,,,2,1,2,3
86634_0,,,,2,1,2,3
86635_0,,,,2,1,2,3
86636_0,,,,2,1,2,3
86637_0,,,,2,1,2,3
86638_0,,,,2,1,2,3
86639_0,,,,2,1,2,3
86640_0,,,,2,1,2,3
86641_0,,,,2,1,2,3
86642_0,,,,2,1,2,3
86643_0,,,,2,1,2,3
86644_0,,,,2,1,2,3
86645_0,,,,2,1,2,3
86646_0,,,,2,1,2,3
86647_0,,,,2,1,2,3
86648_0,,,,2,1,2,3
86649_0,,,,2,1,2,3
86650_0,,,,2,1,2,3
86651_0,,,,2,1,2,3
86652_0,,,,2,1,2,3
86653_0,,,,2,1,2,3
86654_0,,,,2,1,2,3
86655_0,,,,2,1,2,3
86656_0,,,,2,1,2,3
86657_0,,,,2,1,2,3
86658_0,,,,2,1,2,3
86659_0,,,,2,1,2,3
86660_0,,,,2,1,2,3
86661_0,,,,2,1,2,3
86662_0,,,,2,1,2,3
86663_0,,,,2,1,2,3
86664_0,,,,2,1,2,3
86665_0,,,,2,1,2,3
86666_0,,,,2,1,2,3
86667_0,,,,2,1,2,3
86668_0,,,,2,1,2,3
86669_0,,,,2,1,2,3
86670_0,,,,2,1,2,3
86671_0,,,,2,1,2,3
86672_0,,,,2,1,2,3
86673_0,,,,2,1,2,3
86674_0,,,,2,1,2,3
86675_0,,,,2,1,2,3
86676_0,,,,2,1,2,3
86677_0,,,,2,1,2,3
86678_0,,,,2,1,2,3
86679_0,,,,2,1,2,3
86680_0,,,,2,1,2,3
86681_0,,,,2,1,2,3
86682_0,,,,2,1,2,3
86683_0,,,,2,1,2,3
86684_0,,,,2,1,2,3
86685_0,,,,2,1,2,3
86686_0,,,,2,1,2,3
86687_0,,,,2,1,2,3
86688_0,,,,2,1,2,3
86689_0,,,,2,1,2,3
86690_0,,,,2,1,2,3
86691_0,,,,2,1,2,3
86693_0,,,,2,1,2,3
C1(C(CO)(C(C)(CO1)O)O)=O,,,5,1,1,0,1
86694_0,,,,2,1,2,3
86696_0,,,,2,1,2,3
C1(C(C)(C(C)(CO1)O)O)=O,,,5,1,1,0,1
86697_0,,,,2,1,2,3
86699_0,,,,2,1,2,3
C1(C(CCO)(C(C)(CO1)O)O)=O,,,5,1,2,0,2
86701_0,,,,2,1,2,3
C1(C(C(C)(CO1)O)O)=O,,,5,1,1,0,1
86702_0,,,,2,1,2,3
86703_0,,,,2,1,2,3
86704_0,,,,2,1,2,3
86705_0,,,,2,1,2,3
86706_0,,,,2,1,2,3
86707_0,,,,2,1,2,3
86708_0,,,,2,1,2,3
86709_0,,,,2,1,2,3
86710_0,,,,2,1,2,3
86711_0,,,,2,1,2,3
86712_0,,,,2,1,2,3
86713_0,,,,2,1,2,3
86714_0,,,,2,1,2,3
86715_0,,,,2,1,2,3
86716_0,,,,2,1,2,3
86717_0,,,,2,1,2,3
86718_0,,,,2,1,2,3
86719_0,,,,2,1,2,3
86720_0,,,,2,1,2,3
86721_0,,,,2,1,2,3
86722_0,,,,2,1,2,3
86723_0,,,,2,1,2,3
86725_0,,,,2,1,2,3
C(C1(CO)C(CC(O1)=O)O)(O)=O,,,5,1,1,0,1
86727_0,,,,2,1,2,3
C1(C(C(C)=O)(C(C(O1)=O)O)O)=O,,,5,1,1,0,1
86728_0,,,,2,1,2,3
86729_0,,,,2,1,2,3
86731_0,,,,2,1,2,3
C1(CC(C(C=O)(C(C)=O)O1)O)=O,,,5,1,1,0,1
86733_0,,,,2,1,2,3
C(C1(CO)C(CC(O1)=O)O)=O,,,5,1,1,0,1
86734_0,,,,2,1,2,3
86735_0,,,,2,1,2,3
86737_0,,,,2,1,2,3
C1(C(C(CO)(C(C)O1)O)=O)=O,,,5,1,1,0,1
86739_0,,,,2,1,2,3
C(C1C(C(C(O1)=O)=O)(CO)O)=O,,,5,1,1,0,1
86740_0,,,,2,1,2,3
86741_0,,,,2,1,2,3
86742_0,,,,2,1,2,3
86743_0,,,,2,1,2,3
86745_0,,,,2,1,2,3
C1(C(C(C(O1)=O)(CC=O)O)O)=O,,,5,1,1,0,1
86746_0,,,,2,1,2,3
86747_0,,,,2,1,2,3
86749_0,,,,2,1,2,3
C1(C(C)(C(C(O1)=O)(C)O)O)=O,,,5,1,1,0,1
86750_0,,,,2,1,2,3
86752_0,,,,2,1,2,3
C1(CC(C(C=O)(CC=O)O1)O)=O,,,5,1,1,0,1
86754_0,,,,2,1,2,3
C(C1(C)C(CC(O1)=O)O)(O)=O,,,5,1,1,0,1
86756_0,,,,2,1,2,3
C1(CC(C(C(O)=O)O1)O)=O,,,5,1,1,0,1
86757_0,,,,2,1,2,3
86759_0,,,,2,1,2,3
C1(C(CC(C(C(O)=O)O)O1)O)=O,,,5,1,1,0,1
86760_0,,,,2,1,2,3
86762_0,,,,2,1,2,3
C1(CC(CO)(C(C(O)=O)O1)O)=O,,,5,1,1,0,1
86763_0,,,,2,1,2,3
86764_0,,,,2,1,2,3
86766_0,,,,2,1,2,3
C1(C2(COC(C2O)O1)O)=O,,,5,1,1,0,1
86768_0,,,,2,1,2,3
C1(C2(C(CO)OC(C2O)O1)O)=O,,,5,1,1,0,1
86769_0,,,,2,1,2,3
86771_0,,,,2,1,2,3
C1(C(C2(C(OCC2O)O1)O)O)=O,,,5,1,1,0,1
86772_0,,,,2,1,2,3
86774_0,,,,2,1,2,3
C1(C2(C(COC(C2O)O1)O)O)=O,,,5,1,1,0,1
86776_0,,,,2,1,2,3
C(C1(C(C(OC1)=O)=O)O)=O,,,5,1,1,0,1
86778_0,,,,2,1,2,3
C(C1(C(C(OC1CO)=O)=O)O)=O,,,5,1,1,0,1
86779_0,,,,2,1,2,3
86780_0,,,,2,1,2,3
86780_1,,,,2,1,2,3
86781_0,,,,2,1,2,3
86781_1,,,,2,1,2,3
86783_0,,,,2,1,2,3
C1(C(C=O)(C(CO)(CO1)O)O)=O,,,5,1,1,0,1
86785_0,,,,2,1,2,3
C1(C(C=O)(C=O)C(C(O1)=O)O)=O,,,5,1,1,0,1
86787_0,,,,2,1,2,3
C(C1(C=O)C(C)OC(C1O)=O)=O,,,5,1,1,0,1
86789_0,,,,2,1,2,3
C(C1(C=O)COC(C1O)=O)=O,,,5,1,1,0,1
86791_0,,,,2,1,2,3
C(C1(C=O)COC(C1(C)O)=O)=O,,,5,1,1,0,1
86793_0,,,,2,1,2,3
C1(C(C=O)(C=O)C(CO1)O)=O,,,5,1,1,0,1
86795_0,,,,2,1,2,3
C1(C(C=O)(C(CO1)=O)C(C)O)=O,,,5,1,1,0,1
86797_0,,,,2,1,2,3
C1(C(C=O)(C(CO1)=O)CO)=O,,,5,1,1,0,1
86799_0,,,,2,1,2,3
C1(C(C)(C(C=O)(C(C)O1)O)O)=O,,,5,1,1,0,1
86801_0,,,,2,1,2,3
C(C1(C(CC(O1)=O)O)C(C)O)=O,,,5,1,1,0,1
86803_0,,,,2,1,2,3
C1(C(C=O)(C(CO1)=O)O)=O,,,5,1,1,0,1
86804_0,,,,2,1,2,3
86806_0,,,,2,1,2,3
C(C1(C=O)C(CC(O1)=O)O)=O,,,5,1,1,0,1
86808_0,,,,2,1,1,2
C1(C(C(C(C=O)O1)O)C(CO)O)=O,,,5,1,1,0,1
86810_0,,,,2,1,2,3
C1(C(C(C)(CO1)O)C(C=O)O)=O,,,5,1,1,0,1
86812_0,,,,2,1,2,3
C1(C(C(C)=O)(C(C)(CO1)O)O)=O,,,5,1,1,0,1
86814_0,,,,2,1,2,3
C1(C(C(C)O)(C(C)(CO1)O)O)=O,,,5,1,1,0,1
86816_0,,,,2,1,1,2
C1(C(C(CO)O)C(C)(CO1)O)=O,,,5,1,1,0,1
86818_0,,,,2,1,1,2
C1(C(C(CO)O)(C(C)(CO1)O)O)=O,,,5,1,1,0,1
86820_0,,,,2,1,2,3
C1(C(C)(C(C(C)=O)(CO1)O)O)=O,,,5,1,1,0,1
86822_0,,,,2,1,2,3
C1(CC(C(C(C)=O)(CO)O1)O)=O,,,5,1,1,0,1
86823_0,,,,2,1,2,3
86825_0,,,,2,1,1,2
C1(C(C(CO)O)C(C(O1)=O)(C)O)=O,,,5,1,1,0,1
86827_0,,,,2,1,2,3
C1(C2C(CO1)OC(C2(C)O)=O)=O,,,5,1,1,0,1
86829_0,,,,2,1,2,3
C1(CC(C2(C(COC2)=O)O1)O)=O,,,5,1,1,0,1
86830_0,,,,2,1,2,3
86832_0,,,,2,1,2,3
C1(C(C(C(C)O1)O)C(C=O)O)=O,,,5,1,1,0,1
86833_0,,,,2,1,2,3
86835_0,,,,2,1,2,3
C1(C(C(C)=O)(C(C(C)O1)O)O)=O,,,5,1,1,0,1
86837_0,,,,2,1,2,3
C1(C(C(C(O1)=O)=O)(CO)O)=O,,,5,1,1,0,1
86838_0,,,,2,1,2,3
86840_0,,,,2,1,2,3
C(C)(C1(C(C)OC(C1O)=O)O)=O,,,5,1,1,0,1
86841_0,,,,2,1,2,3
86843_0,,,,2,1,2,3
C1(C(C(C)O)(C(C(C)O1)O)O)=O,,,5,1,1,0,1
86845_0,,,,2,1,2,3
C1(C(C=O)(C(C(O1)=O)(C)O)O)=O,,,5,1,1,0,1
86846_0,,,,2,1,2,3
86847_0,,,,2,1,2,3
86848_0,,,,2,1,2,3
86849_0,,,,2,1,1,2
86851_0,,,,2,1,1,2
C1(C(C(CO)O)C(C(C)O1)O)=O,,,5,1,1,0,1
86852_0,,,,2,1,1,2
86854_0,,,,2,1,1,2
C1(C(C(CO)O)C(CO1)(CO)O)=O,,,5,1,1,0,1
86856_0,,,,2,1,2,3
C1(C2C(CO1)OC(C2O)=O)=O,,,5,1,1,0,1
86857_0,,,,2,1,1,2
86858_0,,,,2,1,1,2
86859_0,,,,2,1,1,2
86861_0,,,,2,1,2,3
C1(C2(C(OC(C2O)O1)=O)O)=O,,,5,1,1,0,1
86863_0,,,,2,1,2,3
C1(C2(C(C(OC2)O1)=O)O)=O,,,5,1,1,0,1
86864_0,,,,2,1,1,2
86866_0,,,,2,1,2,3
C1(C2(C(OC(CO1)C2O)=O)O)=O,,,5,1,2,0,2
86868_0,,,,2,1,2,3
C1(C(C=O)(C(C(O1)=O)=O)O)=O,,,5,1,1,0,1
86869_0,,,,2,1,2,3
86870_0,,,,2,1,2,3
86872_0,,,,2,1,2,3
C1(C(C=O)(C(C(CO)O1)O)O)=O,,,5,1,1,0,1
86873_0,,,,2,1,2,3
86875_0,,,,2,1,2,3
C1(C(C=O)(C(C=O)(CO1)O)O)=O,,,5,1,1,0,1
86877_0,,,,2,1,2,3
C1(C(C=O)(C(C(O1)=O)O)O)=O,,,5,1,1,0,1
86878_0,,,,2,1,1,2
86880_0,,,,2,1,1,2
C1(C(C(CO)O)(C(C(C)O1)O)O)=O,,,5,1,1,0,1
86882_0,,,,2,1,2,3
C1(C2(C(CO1)OC(C2O)=O)O)=O,,,5,1,1,0,1
86883_0,,,,2,1,1,2
86884_0,,,,2,1,1,2
86885_0,,,,2,1,1,2
86886_0,,,,2,1,1,2
86888_0,,,,2,1,2,3
C(C1(C(C(OC1C=O)=O)=O)O)=O,,,5,1,1,0,1
86890_0,,,,2,1,2,3
C(C1(C(C(OC1C)=O)=O)O)=O,,,5,1,1,0,1
86892_0,,,,2,1,2,3
C(C1C(C)OC(C1O)=O)(O)=O,,,5,1,1,0,1
86893_0,,,,2,1,2,3
86894_0,,,,2,1,2,3
86895_0,,,,2,1,2,3
86897_0,,,,2,1,2,3
C(C1C(CO)OC(C1O)=O)(O)=O,,,5,1,1,0,1
86898_0,,,,2,1,2,3
86899_0,,,,2,1,2,3
86900_0,,,,2,1,2,3
86902_0,,,,2,1,2,3
C1(C(CO)(C(C(C)O1)O)O)=O,,,5,1,1,0,1
86903_0,,,,2,1,2,3
86903_1,,,,2,1,2,3
86905_0,,,,2,1,2,3
C1(C(C(C)(CO1)O)(CC=O)O)=O,,,5,1,1,0,1
86906_0,,,,2,1,2,3
86908_0,,,,2,1,2,3
C1(C(C(C(C)O1)O)(CC=O)O)=O,,,5,1,1,0,1
86910_0,,,,2,1,2,3
C1(C(CC(C(C=O)(O)O)O1)O)=O,,,5,1,1,0,1
86912_0,,,,2,1,2,3
C(C(C)(C1CC(C(O1)=O)O)O)=O,,,5,1,1,0,1
86914_0,,,,2,1,2,3
C1(C(CC([C](C(O)=O)O)O1)O)=O,,,5,1,1,0,1
86916_0,,,,2,1,2,3
C(CC1(C)C([C](C(O1)=O)O)O)=O,,,5,1,1,0,1
86918_0,,,,2,1,2,3
C(CC1C([C](C(O1)=O)O)(C)O)=O,,,5,1,1,0,1
86920_0,,,,2,1,2,3
C1(C(C=O)(CC(CC=O)O1)O)=O,,,5,1,1,0,1
86922_0,,,,2,1,2,3
C1(C(C=O)(C(C=O)C(C)O1)O)=O,,,5,1,1,0,1
86924_0,,,,2,1,2,3
C1(C(C=O)(C(C=O)CO1)O)=O,,,5,1,1,0,1
86926_0,,,,2,1,2,3
[C]1(C(OC(C(C)O)C1O)=O)O,,,5,1,1,0,1
86928_0,,,,2,1,2,3
C1(C(C(C(C(C)O)O1)O)O)=O,,,5,1,1,0,1
86930_0,,,,2,1,2,3
C1(C(C)(C(C(C(C)O)O1)O)O)=O,,,5,1,1,0,1
86932_0,,,,2,1,2,3
C1(C(C(CO1)=O)(CC=O)O)=O,,,5,1,1,0,1
86934_0,,,,2,1,2,3
C(C1(C(CCO)OC(C1)=O)O)=O,,,5,1,1,0,1
86936_0,,,,2,1,2,3
C1([C](C(C(C(C=O)=O)O1)O)O)=O,,,5,1,1,0,1
86938_0,,,,2,1,2,3
C1(C(C(C(C(C=O)=O)O1)O)O)=O,,,5,1,2,0,2
86940_0,,,,2,1,2,3
C(C1([C](C(OC1C=O)=O)O)O)=O,,,5,1,1,0,1
86942_0,,,,2,1,2,3
C(C(C1([C](C(OC1)=O)O)O)O)=O,,,5,1,1,0,1
86944_0,,,,2,1,2,3
C(C1C([C](C(O1)=O)O)(CO)O)=O,,,5,1,1,0,1
86946_0,,,,2,1,2,3
C(CO)(C1C([C](C(O1)=O)O)O)=O,,,5,1,1,0,1
86948_0,,,,2,1,2,3
C(C)(C1([C](C(OC1)=O)O)O)=O,,,5,1,1,0,1
86950_0,,,,2,1,2,3
C1(CC(C(C(C=O)=O)(C)O1)O)=O,,,5,1,1,0,1
86952_0,,,,2,1,2,3
C(C1([C](C(OC1C)=O)O)O)=O,,,5,1,1,0,1
86954_0,,,,2,1,2,3
C1(C(C=C)(C(C(C=O)O1)O)O)=O,,,5,1,1,0,1
86956_0,,,,2,1,1,2
C1(C(C(C(C=O)O1)O)(CCO)O)=O,,,5,1,1,0,1
86958_0,,,,2,1,2,3
C(C1C([C](C(O1)=O)O)O)=O,,,5,1,1,0,1
86960_0,,,,2,1,2,3
C(C1(C(CO)(C)OC(C1)=O)O)=O,,,5,1,1,0,1
86962_0,,,,2,1,2,3
C1(C(C=C)(C(C)(CO1)O)O)=O,,,5,1,1,0,1
86963_0,,,,2,1,1,2
86965_0,,,,2,1,2,3
[C]1(C(OCC1(C)O)=O)O,,,5,1,1,0,1
86967_0,,,,2,1,2,3
[C]1(C(OCC1(CCO)O)=O)O,,,5,1,1,0,1
86969_0,,,,2,1,2,3
C(C1(C(CC(O1)=O)O)CCO)=O,,,5,1,1,0,1
86971_0,,,,2,1,2,3
[C]1(C(OC(CCO)C1O)=O)O,,,5,1,1,0,1
86973_0,,,,2,1,2,3
[C]1(C(OC(CO)C1(C)O)=O)O,,,5,1,1,0,1
86975_0,,,,2,1,2,3
C1(C(C=C)(C(C(O1)=O)(C)O)O)=O,,,5,1,1,0,1
86977_0,,,,2,1,1,2
C1(C(CCO)(C(C(O1)=O)(C)O)O)=O,,,5,1,1,0,1
86979_0,,,,2,1,2,3
C1(C([C](C(O1)=O)O)(C)O)=O,,,5,1,1,0,1
86981_0,,,,2,1,2,3
C1(CC(C2(C(CCO2)=O)O1)O)=O,,,5,1,1,0,1
86983_0,,,,2,1,2,3
C(C1(C=C)C(CC(O1)=O)O)(O)=O,,,5,1,1,0,1
86985_0,,,,2,1,2,3
C1(C2(C(CC(O2)=O)O)CCO1)=O,,,5,1,1,0,1
86987_0,,,,2,1,2,3
C1(CC(C(C=O)(O)O1)O)=O,,,5,1,1,0,1
86989_0,,,,2,1,2,3
C(C1(C)C(CC(O1)=O)O)=O,,,5,1,1,0,1
86991_0,,,,2,1,2,3
C1(CC([C](C(O)=O)O1)O)=O,,,5,1,1,0,1
86992_0,,,,2,1,2,3
86994_0,,,,2,1,2,3
C1(C([C](C(O1)=O)O)(CCO)O)=O,,,5,1,1,0,1
86995_0,,,,2,1,2,3
86997_0,,,,2,1,2,3
C1(C(C=O)(CC(O1)=O)O)=O,,,5,1,1,0,1
86999_0,,,,2,1,2,3
C(C1(C(C(O)O)OC(C1)=O)O)=O,,,5,1,1,0,1
87001_0,,,,2,1,2,3
C(C1(C(C(C)O)OC(C1)=O)O)=O,,,5,1,1,0,1
87003_0,,,,2,1,2,3
C1(CC(C(C(C=O)(O)O)O1)O)=O,,,5,1,1,0,1
87005_0,,,,2,1,2,3
C(C(C)(C1C(CC(O1)=O)O)O)=O,,,5,1,1,0,1
87007_0,,,,2,1,2,3
C(CC1C([C](C(O1)=O)O)O)(O)=O,,,5,1,1,0,1
87009_0,,,,2,1,2,3
C1(CC(C([C](C(O)=O)O)O1)O)=O,,,5,1,1,0,1
87011_0,,,,2,1,2,3
C1(CC(CO)(C(C=O)(O)O1)O)=O,,,5,1,1,0,1
87012_0,,,,2,1,2,3
87014_0,,,,2,1,2,3
C(C1(C)C(CO)(CC(O1)=O)O)=O,,,5,1,1,0,1
87015_0,,,,2,1,2,3
87017_0,,,,2,1,2,3
C(CC1([C](C(OC1)=O)O)O)(O)=O,,,5,1,1,0,1
87019_0,,,,2,1,2,3
C1(CC([C](C(O)=O)O1)(CO)O)=O,,,5,1,1,0,1
87020_0,,,,2,1,2,3
87021_0,,,,2,1,2,3
87023_0,,,,2,1,2,3
C(C1(C)C(C)(C(C(O1)=O)O)O)=O,,,5,1,1,0,1
87025_0,,,,2,1,2,3
C(C1C([C](C(O1)=O)O)(C)O)(O)=O,,,5,1,1,0,1
87027_0,,,,2,1,2,3
C1(C(C([C](C(O)=O)O1)(C)O)O)=O,,,5,1,1,0,1
87029_0,,,,2,1,2,3
C1(C([C](C(O1)=O)O)(CO)O)=O,,,5,1,1,0,1
87031_0,,,,2,1,2,3
C(C1([C](C(OC1)=O)O)O)(O)=O,,,5,1,1,0,1
87033_0,,,,2,1,2,3
C1(CC(C=O)(C(C=O)(O)O1)O)=O,,,5,1,1,0,1
87035_0,,,,2,1,2,3
C(C1([C](C(O)=O)OC(C1)=O)O)=O,,,5,1,1,0,1
87037_0,,,,2,1,2,3
C1(CC(C(C(C=O)(O)O)O1)=O)=O,,,5,1,1,0,1
87039_0,,,,2,1,2,3
C1(CC(C([C](C(O)=O)O)O1)=O)=O,,,5,1,1,0,1
87041_0,,,,2,1,2,3
C(C(C1CC(C(O1)=O)=O)(O)O)=O,,,5,1,1,0,1
87043_0,,,,2,1,2,3
C(C(C)(C1CC(C(O1)=O)=O)O)=O,,,5,1,1,0,1
87045_0,,,,2,1,2,3
C1(C(CC([C](C(O)=O)O)O1)=O)=O,,,5,1,1,0,1
87047_0,,,,2,1,2,3
C(C(C1CC(C(O1)=O)=O)O)(O)=O,,,5,1,1,0,1
87049_0,,,,2,1,2,3
C1(C([C](C(O1)=O)O)(CC=O)O)=O,,,5,1,1,0,1
87051_0,,,,2,1,2,3
[C]1(C(OC2COCC12O)=O)O,,,5,1,1,0,1
87053_0,,,,2,1,2,3
C1(C(C2(COCC2O1)O)O)=O,,,5,1,1,0,1
87055_0,,,,2,1,2,3
C1(C(C)(C2(COCC2O1)O)O)=O,,,5,1,1,0,1
87057_0,,,,2,1,2,3
[C]1(C(OC2C1(CCO2)O)=O)O,,,5,1,1,0,1
87059_0,,,,2,1,2,3
C1(C(C2(C(OCC2)O1)O)O)=O,,,5,1,1,0,1
87061_0,,,,2,1,2,3
C1(C(C)(C2(C(OCC2)O1)O)O)=O,,,5,1,1,0,1
87062_0,,,,2,1,2,3
87064_0,,,,2,1,2,3
C1(C(C=C)(C(C(C)O1)O)O)=O,,,5,1,1,0,1
87065_0,,,,2,1,2,3
87067_0,,,,2,1,2,3
C1(C(C=C)(C(CO)(CO1)O)O)=O,,,5,1,1,0,1
87068_0,,,,2,1,2,3
87070_0,,,,2,1,2,3
C1(C(C=C)(C(C=O)(CO1)O)O)=O,,,5,1,1,0,1
87071_0,,,,2,1,2,3
87073_0,,,,2,1,2,3
C1(C2(C(C(CO2)O1)=O)O)=O,,,5,1,1,0,1
87075_0,,,,2,1,2,3
[C]1(C(OC2C1(C(CO2)O)O)=O)O,,,5,1,1,0,1
87077_0,,,,2,1,2,3
[C]1(C(OC2COC(C12O)O)=O)O,,,5,1,1,0,1
87078_0,,,,2,1,2,3
87079_0,,,,2,1,2,3
87080_0,,,,2,1,2,3
87081_0,,,,2,1,1,2
87083_0,,,,2,1,1,2
C1(C(CCO)(C(C(C)O1)O)O)=O,,,5,1,2,0,2
87085_0,,,,2,1,1,2
C1(C(CCO)(C(C(CO)O1)O)O)=O,,,5,1,1,0,1
87087_0,,,,2,1,1,2
C1(C(CCO)(C(CO)(CO1)O)O)=O,,,5,1,1,0,1
87088_0,,,,2,1,1,2
87090_0,,,,2,1,1,2
C1(C(CCO)(C(C=O)(CO1)O)O)=O,,,5,1,1,0,1
87091_0,,,,2,1,1,2
87092_0,,,,2,1,2,3
87093_0,,,,2,1,2,3
87094_0,,,,2,1,2,3
87095_0,,,,2,1,2,3
87096_0,,,,2,1,2,3
87097_0,,,,2,1,2,3
87098_0,,,,2,1,2,3
87099_0,,,,2,1,2,3
87100_0,,,,2,1,2,3
87101_0,,,,2,1,2,3
87102_0,,,,2,1,2,3
87103_0,,,,2,1,2,3
87104_0,,,,2,1,2,3
87105_0,,,,2,1,2,3
87106_0,,,,2,1,2,3
87107_0,,,,2,1,2,3
87109_0,,,,2,1,2,3
[C]1(C(OC(C)C1O)=O)O,,,5,1,1,0,1
87111_0,,,,2,1,2,3
C1(C(C)(C(C(C)O1)O)O)=O,,,5,1,1,0,1
87112_0,,,,2,1,2,3
87113_0,,,,2,1,2,3
87115_0,,,,2,1,2,3
[C]1(C(OC(CO)C1O)=O)O,,,5,1,1,0,1
87117_0,,,,2,1,2,3
[C]1(C(OC(C(CO)O)C1O)=O)O,,,5,1,1,0,1
87119_0,,,,2,1,2,3
C(C(C1C([C](C(O1)=O)O)O)O)=O,,,5,1,1,0,1
87121_0,,,,2,1,2,3
[C]1(C(OCC1(CO)O)=O)O,,,5,1,1,0,1
87123_0,,,,2,1,2,3
[C]1(C(OCC1(C(CO)O)O)=O)O,,,5,1,1,0,1
87125_0,,,,2,1,2,3
[C]1(C(OC(CO)C1(CO)O)=O)O,,,5,1,1,0,1
87127_0,,,,2,1,2,3
C1(C([C](C(O1)=O)O)O)=O,,,5,1,1,0,1
87129_0,,,,2,1,2,3
[C]1(C(OC(CO)(CO)C1O)=O)O,,,5,1,1,0,1
87131_0,,,,2,1,2,3
C(CC1C([C](C(O1)=O)O)O)=O,,,5,1,1,0,1
87133_0,,,,2,1,2,3
C(CC1([C](C(OC1)=O)O)O)=O,,,5,1,1,0,1
87135_0,,,,2,1,2,3
C(C)(C1C([C](C(O1)=O)O)O)=O,,,5,1,1,0,1
87137_0,,,,2,1,2,3
C(C1C([C](C(O1)=O)O)(C)O)=O,,,5,1,1,0,1
87139_0,,,,2,1,2,3
C(C1([C](C(OC1)=O)O)O)=O,,,5,1,1,0,1
87141_0,,,,2,1,2,3
C(C1([C](C(OC1CO)=O)O)O)=O,,,5,1,1,0,1
87143_0,,,,2,1,2,3
[C]1(C(OCC1O)=O)O,,,5,1,1,0,1
87144_0,,,,2,1,2,3
87145_0,,,,2,1,2,3
87146_0,,,,2,1,2,3
87147_0,,,,2,1,2,3
87148_0,,,,2,1,2,3
87149_0,,,,2,1,2,3
87150_0,,,,2,1,2,3
87151_0,,,,2,1,2,3
87152_0,,,,2,1,2,3
87153_0,,,,2,1,2,3
87154_0,,,,2,1,2,3
87155_0,,,,2,1,2,3
87156_0,,,,2,1,2,3
87157_0,,,,2,1,2,3
87158_0,,,,2,1,2,3
87159_0,,,,2,1,2,3
87160_0,,,,2,1,2,3
87161_0,,,,2,1,2,3
87162_0,,,,2,1,2,3
87163_0,,,,2,1,2,3
87164_0,,,,2,1,2,3
87165_0,,,,2,1,1,2
87166_0,,,,2,1,1,2
87167_0,,,,2,1,1,2
87168_0,,,,2,1,1,2
87169_0,,,,2,1,1,2
87170_0,,,,2,1,1,2
87171_0,,,,2,1,1,2
87172_0,,,,2,1,1,2
87173_0,,,,2,1,1,2
87174_0,,,,2,1,1,2
87175_0,,,,2,1,1,2
87176_0,,,,2,1,2,3
87177_0,,,,2,1,2,3
87178_0,,,,2,1,2,3
87179_0,,,,2,1,2,3
87180_0,,,,2,1,2,3
87181_0,,,,2,1,2,3
87182_0,,,,2,1,2,3
87183_0,,,,2,1,2,3
87184_0,,,,2,1,2,3
87185_0,,,,2,1,2,3
87186_0,,,,2,1,2,3
87187_0,,,,2,1,2,3
87188_0,,,,2,1,2,3
87189_0,,,,2,1,2,3
87190_0,,,,2,1,2,3
87191_0,,,,2,1,2,3
87192_0,,,,2,1,2,3
87193_0,,,,2,1,2,3
87194_0,,,,2,1,2,3
87195_0,,,,2,1,2,3
87196_0,,,,2,1,2,3
87197_0,,,,2,1,2,3
87198_0,,,,2,1,2,3
87200_0,,,,2,1,2,3
C1(C2(COC(C2(C)O)O1)O)=O,,,5,1,1,0,1
87202_0,,,,2,1,2,3
C1(C2(COC(C)(C2O)O1)O)=O,,,5,1,1,0,1
87204_0,,,,2,1,2,3
C1(C2(COC(C2(CO)O)O1)O)=O,,,5,1,1,0,1
87205_0,,,,2,1,2,3
87207_0,,,,2,1,2,3
C1(C2(COC(CO)(C2O)O1)O)=O,,,5,1,1,0,1
87208_0,,,,2,1,2,3
87210_0,,,,2,1,2,3
C1(C2(C(C)OC(C2O)O1)O)=O,,,5,1,1,0,1
87212_0,,,,2,1,2,3
C1(C2(C(C(OC2C=O)O1)O)O)=O,,,5,1,1,0,1
87213_0,,,,2,1,2,3
87214_0,,,,2,1,2,3
87215_0,,,,2,1,2,3
87216_0,,,,2,1,2,3
87217_0,,,,2,1,2,3
87218_0,,,,2,1,2,3
87219_0,,,,2,1,2,3
87220_0,,,,2,1,2,3
87221_0,,,,2,1,2,3
87222_0,,,,2,1,2,3
87223_0,,,,2,1,2,3
87224_0,,,,2,1,2,3
87225_0,,,,2,1,2,3
87226_0,,,,2,1,2,3
87227_0,,,,2,1,2,3
87229_0,,,,2,1,2,3
C1(C2(CCOC(C2(C)O)O1)O)=O,,,5,1,1,0,1
87231_0,,,,2,1,2,3
C1(C2(CCOC(C)(C2O)O1)O)=O,,,5,1,1,0,1
87232_0,,,,2,1,2,3
87234_0,,,,2,1,2,3
C1(C2(C(C(OCC2)O1)O)O)=O,,,5,1,1,0,1
87235_0,,,,2,1,2,3
87236_0,,,,2,1,2,3
87237_0,,,,2,1,1,2
87238_0,,,,2,1,1,2
87239_0,,,,2,1,1,2
87240_0,,,,2,1,1,2
87241_0,,,,2,1,1,2
87242_0,,,,2,1,1,2
87243_0,,,,2,1,1,2
87244_0,,,,2,1,1,2
87245_0,,,,2,1,1,2
87246_0,,,,2,1,1,2
87247_0,,,,2,1,1,2
87248_0,,,,2,1,1,2
87249_0,,,,2,1,1,2
87250_0,,,,2,1,1,2
87251_0,,,,2,1,1,2
87252_0,,,,2,1,1,2
87253_0,,,,2,1,1,2
87254_0,,,,2,1,1,2
87255_0,,,,2,1,1,2
87256_0,,,,2,1,1,2
87257_0,,,,2,1,1,2
87258_0,,,,2,1,1,2
87259_0,,,,2,1,1,2
87261_0,,,,2,1,2,3
C(C1(CCC(O1)=O)CC=O)(O)=O,,,5,1,1,0,1
87263_0,,,,2,1,2,3
C(C)(C1(CCC(O1)=O)CC=O)=O,,,5,1,1,0,1
87265_0,,,,2,1,2,3
C1(CCC(C)(CC(C=O)=O)O1)=O,,,5,1,1,0,1
87267_0,,,,2,1,2,3
C(CC1(CCC(O1)=O)CC=O)=O,,,5,1,1,0,1
87269_0,,,,2,1,2,3
C(C(C=O)C1(C)CCC(O1)=O)=O,,,5,1,1,0,1
87270_0,,,,2,1,2,3
87272_0,,,,2,1,2,3
C(C(C1COC(C1)=O)C(C)O)=O,,,5,1,2,0,2
87274_0,,,,2,1,2,3
C(CC1(C)CCC(O1)=O)=O,,,5,1,1,0,1
87276_0,,,,2,1,2,3
C1(CC(CO1)C(C)(CC=O)O)=O,,,5,1,2,0,2
87278_0,,,,2,1,2,3
C1(CC(CO)C(C)(CC=O)O1)=O,,,5,1,1,0,1
87280_0,,,,2,1,2,3
C1(CC(CO1)CC(CC=O)O)=O,,,5,1,2,0,2
87282_0,,,,2,1,2,3
C(C1(CCC(O1)=O)C(C)O)=O,,,5,1,1,0,1
87284_0,,,,2,1,2,3
C1(CCC(C)(C(C=O)O)O1)=O,,,5,1,1,0,1
87285_0,,,,2,1,2,3
87287_0,,,,2,1,2,3
C1(CC(CO1)C(CC=O)O)=O,,,5,1,2,0,2
87289_0,,,,2,1,2,3
C1(CC(C(CC=O)O1)CO)=O,,,5,1,1,0,1
87291_0,,,,2,1,2,3
C(C(CO)C1COC(C1)=O)=O,,,5,1,2,0,2
87293_0,,,,2,1,2,3
C1(CCC(C(CC=O)O)O1)=O,,,5,1,1,0,1
87295_0,,,,2,1,2,3
C1(CCC(CO)(CC=O)O1)=O,,,5,1,1,0,1
87297_0,,,,2,1,2,3
C(C1(C(C=O)=O)CCC(O1)=O)=O,,,5,1,1,0,1
87299_0,,,,2,1,2,3
C1(CCC(C(C(C=O)O)=O)O1)=O,,,5,1,1,0,1
87301_0,,,,2,1,2,3
C1(CCC(C=O)(C(CO)=O)O1)=O,,,5,1,1,0,1
87303_0,,,,2,1,2,3
C1(CCC(C(C(C)=O)=O)O1)=O,,,5,1,1,0,1
87305_0,,,,2,1,2,3
C1(CCC(C(C=O)=O)(C)O1)=O,,,5,1,1,0,1
87307_0,,,,2,1,2,3
C(C1(C=O)CCC(O1)=O)=O,,,5,1,1,0,1
87309_0,,,,2,1,2,3
C(C(C=O)(C1COC(C1)=O)O)=O,,,5,1,2,0,2
87311_0,,,,2,1,2,3
C(C1(C=O)C(CO)CC(O1)=O)=O,,,5,1,1,0,1
87313_0,,,,2,1,2,3
C1(CCC(C(CO)(CO)O)O1)=O,,,5,1,1,0,1
87315_0,,,,2,1,2,3
C(C)(C1CCC(O1)=O)=O,,,5,1,1,0,1
87317_0,,,,2,1,2,3
C1(CC(CO1)C(C(C)=O)O)=O,,,5,1,2,0,2
87319_0,,,,2,1,2,3
C1(CC(CO)C(C(C)=O)O1)=O,,,5,1,1,0,1
87321_0,,,,2,1,2,3
C1(CC(CO1)CC(CO)=O)=O,,,5,1,2,0,2
87323_0,,,,2,1,2,3
C1(CCC(C(CCO)=O)O1)=O,,,5,1,1,0,1
87325_0,,,,2,1,2,3
C1(CCC(CC(CO)=O)O1)=O,,,5,1,1,0,1
87327_0,,,,2,1,2,3
C(C1(CCC(O1)=O)CCO)=O,,,5,1,1,0,1
87329_0,,,,2,1,2,3
C1(CCC(CC(C=O)O)O1)=O,,,5,1,1,0,1
87331_0,,,,2,1,2,3
C1(CCC(C(C)=O)(CO)O1)=O,,,5,1,1,0,1
87333_0,,,,2,1,2,3
C1(CCC(C(C(C)=O)O)O1)=O,,,5,1,1,0,1
87335_0,,,,2,1,2,3
C1(CCC(C)O1)=O,,,5,1,1,0,1
87337_0,,,,2,1,2,3
C1(CC(CO1)C(C)O)=O,,,5,1,2,0,2
87339_0,,,,2,1,2,3
C1(CC(CO)C(C)O1)=O,,,5,1,1,0,1
87341_0,,,,2,1,2,3
C1(CC(CO1)CCO)=O,,,5,1,2,0,2
87343_0,,,,2,1,2,3
C1(CC(CO1)CC(C(O)=O)=O)=O,,,5,1,2,0,2
87345_0,,,,2,1,2,3
C(C(C(O)=O)C1COC(C1)=O)=O,,,5,1,2,0,2
87347_0,,,,2,1,2,3
C1(C(C=O)C(CO1)CC(O)=O)=O,,,5,1,1,0,1
87349_0,,,,2,1,2,3
C1(CCC(CC(C(O)=O)=O)O1)=O,,,5,1,1,0,1
87350_0,,,,2,1,2,3
87351_0,,,,2,1,2,3
87353_0,,,,2,1,2,3
C(C1(CCC(O1)=O)CC(O)=O)=O,,,5,1,1,0,1
87354_0,,,,2,1,2,3
87356_0,,,,2,1,2,3
C(CC(C1CCC(O1)=O)=O)(O)=O,,,5,1,1,0,1
87357_0,,,,2,1,2,3
87359_0,,,,2,1,2,3
C(C1(C(C)=O)CCC(O1)=O)(O)=O,,,5,1,1,0,1
87361_0,,,,2,1,2,3
C1(CC(CO1)CC(O)=O)=O,,,5,1,2,0,2
87363_0,,,,2,1,2,3
C1(CCC(C(C(O)=O)=O)O1)=O,,,5,1,1,0,1
87365_0,,,,2,1,2,3
C(C1(CCC(O1)=O)C(C)O)(O)=O,,,5,1,1,0,1
87367_0,,,,2,1,2,3
C1(CCC(C)(C(C(O)=O)O)O1)=O,,,5,1,1,0,1
87368_0,,,,2,1,2,3
87370_0,,,,2,1,2,3
C1(CCC2(C(COC2)=O)O1)=O,,,5,1,1,0,1
87372_0,,,,2,1,2,3
C1(CCC2(C(CCO2)=O)O1)=O,,,5,1,1,0,1
87374_0,,,,2,1,2,3
C1(CCC2(COC(C2)=O)O1)=O,,,5,1,1,0,1
87376_0,,,,2,1,2,3
C1(CCC2(CC(CO2)=O)O1)=O,,,5,1,1,0,1
87378_0,,,,2,1,2,3
C1(CCC(C=CC(O)=O)O1)=O,,,5,1,1,0,1
87380_0,,,,2,1,2,3
C(C1(C=C)CCC(O1)=O)(O)=O,,,5,1,1,0,1
87382_0,,,,2,1,2,3
C1(CCC2(C(C(CO2)O)=O)O1)=O,,,5,1,1,0,1
87384_0,,,,2,1,2,3
C1(CCC2(C(C(O)OC2)=O)O1)=O,,,5,1,1,0,1
87386_0,,,,2,1,2,3
C1(C2(CCC(O2)=O)C(CO1)O)=O,,,5,1,1,0,1
87388_0,,,,2,1,2,3
C1(CCC2(COC(C2O)=O)O1)=O,,,5,1,1,0,1
87390_0,,,,2,1,2,3
C1(C2(CCC(O2)=O)CCO1)=O,,,5,1,1,0,1
87392_0,,,,2,1,2,3
C1(CCC(C=O)(O)O1)=O,,,5,1,1,0,1
87394_0,,,,2,1,2,3
C(C1(C)CCC(O1)=O)=O,,,5,1,1,0,1
87396_0,,,,2,1,2,3
C1(CC[C](C(O)=O)O1)=O,,,5,1,1,0,1
87398_0,,,,2,1,2,3
C(C1(CCC(O1)=O)CO)=O,,,5,1,1,0,1
87399_0,,,,2,1,2,3
87401_0,,,,2,1,2,3
C(C1(CCC(O1)=O)C(CO)O)=O,,,5,1,1,0,1
87403_0,,,,2,1,2,3
C1(CCC(C(C(C=O)O)O)O1)=O,,,5,1,1,0,1
87405_0,,,,2,1,2,3
C1(CCC(CO)(C(C=O)O)O1)=O,,,5,1,1,0,1
87406_0,,,,2,1,2,3
87408_0,,,,2,1,2,3
C1(CCC(CO)O1)=O,,,5,1,1,0,1
87410_0,,,,2,1,2,3
C(C1CCC(O1)=O)(O)=O,,,5,1,1,0,1
87412_0,,,,2,1,2,3
C1(CCC(C=O)(C(C=O)O)O1)=O,,,5,1,1,0,1
87414_0,,,,2,1,2,3
C1(CCC(C(CO)=O)O1)=O,,,5,1,1,0,1
87416_0,,,,2,1,2,3
C1(CCC(C(C(CO)O)=O)O1)=O,,,5,1,1,0,1
87417_0,,,,2,1,2,3
87419_0,,,,2,1,2,3
C1(CCC(C(CO)=O)(CO)O1)=O,,,5,1,1,0,1
87421_0,,,,2,1,2,3
C1(CCC(CO)(CO)O1)=O,,,5,1,1,0,1
87423_0,,,,2,1,2,3
C1(CCC(C(CO)O)O1)=O,,,5,1,1,0,1
87425_0,,,,2,1,2,3
C1(CCC(CO)(C(CO)O)O1)=O,,,5,1,1,0,1
87427_0,,,,2,1,2,3
C1(CCC(C(C(CO)O)O)O1)=O,,,5,1,1,0,1
87429_0,,,,2,1,2,3
C(C1(CCC(O1)=O)CO)(O)=O,,,5,1,1,0,1
87430_0,,,,2,1,2,3
87431_0,,,,2,1,2,3
87432_0,,,,2,1,2,3
87434_0,,,,2,1,2,3
C(C1(CCC(O1)=O)CC=O)=O,,,5,1,1,0,1
87436_0,,,,2,1,2,3
C(CC(C1CCC(O1)=O)=O)=O,,,5,1,1,0,1
87438_0,,,,2,1,2,3
C(C1(C(C)=O)CCC(O1)=O)=O,,,5,1,1,0,1
87440_0,,,,2,1,2,3
C1(CCC2(C(O)OCC2O)O1)=O,,,5,1,1,0,1
87442_0,,,,2,1,2,3
C1(CCC2(C(C(CO2)O)O)O1)=O,,,5,1,1,0,1
87444_0,,,,2,1,2,3
C1(CCC2(COC(C2O)O)O1)=O,,,5,1,1,0,1
87446_0,,,,2,1,2,3
C(C1(C)CCC(O1)=O)(O)=O,,,5,1,1,0,1
87447_0,,,,2,1,2,3
87449_0,,,,2,1,2,3
C(C1(CCC(O1)=O)CCO)(O)=O,,,5,1,1,0,1
87450_0,,,,2,1,2,3
87452_0,,,,2,1,2,3
C1(CCC(CC(C(O)=O)O)O1)=O,,,5,1,1,0,1
87453_0,,,,2,1,2,3
87455_0,,,,2,1,2,3
C1(CCC(C(C=O)=O)O1)=O,,,5,1,1,0,1
87456_0,,,,2,1,2,3
87458_0,,,,2,1,2,3
C1(CCC(C(C=O)=O)(CO)O1)=O,,,5,1,1,0,1
87460_0,,,,2,1,2,3
C(C1CCC(O1)=O)=O,,,5,1,1,0,1
87462_0,,,,2,1,2,3
C1(CC(CO)C(C=O)(O)O1)=O,,,5,1,1,0,1
87464_0,,,,2,1,2,3
C1(CC(CO1)C(C=O)(O)O)=O,,,5,1,2,0,2
87466_0,,,,2,1,2,3
C(C1(C)C(CO)CC(O1)=O)=O,,,5,1,1,0,1
87468_0,,,,2,1,2,3
C(C(C)(C1COC(C1)=O)O)=O,,,5,1,2,0,2
87470_0,,,,2,1,2,3
C1(CC(CO1)CC(C=O)O)=O,,,5,1,2,0,2
87472_0,,,,2,1,2,3
C(CC1[C](C(OC1)=O)O)(O)=O,,,5,1,1,0,1
87474_0,,,,2,1,2,3
C1(CC([C](C(O)=O)O1)CO)=O,,,5,1,1,0,1
87476_0,,,,2,1,2,3
C1(CC([C](C(O)=O)O)CO1)=O,,,5,1,2,0,2
87478_0,,,,2,1,2,3
C(C1(CO)C(CO)CC(O1)=O)=O,,,5,1,1,0,1
87480_0,,,,2,1,2,3
C(C(CO)(C1COC(C1)=O)O)=O,,,5,1,2,0,2
87482_0,,,,2,1,2,3
C1(CC(CO)C(C(C=O)O)O1)=O,,,5,1,1,0,1
87484_0,,,,2,1,2,3
C1(CC(CO1)C(C(C=O)O)O)=O,,,5,1,2,0,2
87486_0,,,,2,1,2,3
C1(CC(CO1)CO)=O,,,5,1,2,0,2
87488_0,,,,2,1,2,3
C1(CC(CO)C(CO)O1)=O,,,5,1,1,0,1
87490_0,,,,2,1,2,3
C1(CC(CO1)C(CO)O)=O,,,5,1,2,0,2
87492_0,,,,2,1,2,3
C(CC1COC(C1O)=O)(O)=O,,,5,1,1,0,1
87494_0,,,,2,1,2,3
C1(CC(CO)C(C(O)=O)O1)=O,,,5,1,1,0,1
87496_0,,,,2,1,2,3
C1(CC(CO1)C(C(O)=O)O)=O,,,5,1,2,0,2
87498_0,,,,2,1,2,3
C1(CC(CO)C(C(CO)=O)O1)=O,,,5,1,1,0,1
87500_0,,,,2,1,2,3
C1(CC(CO1)C(C(CO)=O)O)=O,,,5,1,2,0,2
87502_0,,,,2,1,2,3
C1(CC(CO)C(CO)(CO)O1)=O,,,5,1,1,0,1
87504_0,,,,2,1,2,3
C1(CC(CO1)C(CO)(CO)O)=O,,,5,1,2,0,2
87506_0,,,,2,1,2,3
C1(CC(CO)C(C(CO)O)O1)=O,,,5,1,1,0,1
87508_0,,,,2,1,2,3
C1(CC(CO1)C(C(CO)O)O)=O,,,5,1,2,0,2
87510_0,,,,2,1,2,3
C1(CC(CO1)CC(C=O)=O)=O,,,5,1,2,0,2
87512_0,,,,2,1,2,3
C(C(C=O)C1COC(C1)=O)=O,,,5,1,2,0,2
87514_0,,,,2,1,2,3
C(CC1COC(C1)=O)=O,,,5,1,2,0,2
87516_0,,,,2,1,2,3
C1(C(C)(C(CO1)CC(O)=O)O)=O,,,5,1,1,0,1
87518_0,,,,2,1,2,3
C(C1(C)C(CO)CC(O1)=O)(O)=O,,,5,1,1,0,1
87520_0,,,,2,1,2,3
C(C(C)(C1COC(C1)=O)O)(O)=O,,,5,1,2,0,2
87522_0,,,,2,1,2,3
C1(CC(CO1)CC(C(O)=O)O)=O,,,5,1,2,0,2
87524_0,,,,2,1,2,3
C1(CC(CO)C(C(C=O)=O)O1)=O,,,5,1,1,0,1
87526_0,,,,2,1,2,3
C1(CC(CO1)C(C(C=O)=O)O)=O,,,5,1,2,0,2
87528_0,,,,2,1,2,3
C1(CC(CO)C(C=O)O1)=O,,,5,1,1,0,1
87530_0,,,,2,1,2,3
C1(CC(CO1)C(C=O)O)=O,,,5,1,2,0,2
87532_0,,,,2,1,2,3
C(CO)(C1(C(C(OC1)=O)=O)O)=O,,,5,1,1,0,1
87534_0,,,,2,1,2,3
C1(C(C(C(C=O)=O)(CO1)O)=O)=O,,,5,1,1,0,1
87536_0,,,,2,1,2,3
C1(C(C(C(O1)=O)=O)(C)O)=O,,,5,1,1,0,1
87538_0,,,,2,1,2,3
C1(C(C(C(O)=O)=O)(CCO1)O)=O,,,5,1,2,0,2
87540_0,,,,2,1,2,3
C1(C(C(C(O1)=O)=O)(CCO)O)=O,,,5,1,1,0,1
87542_0,,,,2,1,2,3
C(CC1(C(C(OC1)=O)=O)O)=O,,,5,1,1,0,1
87544_0,,,,2,1,2,3
C(C1C(C(C(O1)=O)=O)(C)O)=O,,,5,1,1,0,1
87546_0,,,,2,1,2,3
[C]1(C(OCC1)=O)O,,,5,1,1,0,1
87548_0,,,,2,1,2,3
[C]1(C(OC(CO)C1)=O)O,,,5,1,1,0,1
87550_0,,,,2,1,2,3
[C]1(C(OC(C(CO)O)C1)=O)O,,,5,1,1,0,1
87552_0,,,,2,1,2,3
C1(C(C(C(C(C)O1)O)=O)O)=O,,,5,1,1,0,1
87554_0,,,,2,1,2,3
C1(C(C(C(C(C=O)O1)O)=O)O)=O,,,5,1,1,0,1
87555_0,,,,2,1,2,3
87557_0,,,,2,1,2,3
C1(C(CC(C(CC=O)O1)=O)O)=O,,,5,1,1,0,1
87558_0,,,,2,1,2,3
87560_0,,,,2,1,2,3
C1(C(CC(C(C=O)O1)O)O)=O,,,5,1,1,0,1
87562_0,,,,2,1,2,3
C(C1C(C)(COC(C1O)=O)O)=O,,,5,1,1,0,1
87563_0,,,,2,1,2,3
87565_0,,,,2,1,2,3
C(C1C(C(C)OC(C1O)=O)O)=O,,,5,1,1,0,1
87567_0,,,,2,1,2,3
C1(C(C(C=O)C(C(O1)=O)O)O)=O,,,5,1,1,0,1
87568_0,,,,2,1,2,3
87569_0,,,,2,1,2,3
87571_0,,,,2,1,2,3
C1(C(C=O)C(C(C=O)CO1)O)=O,,,5,1,1,0,1
87573_0,,,,2,1,2,3
C1(C(C=O)C(C=O)(CCO1)O)=O,,,5,1,1,0,1
87575_0,,,,2,1,2,3
C1(C(C=O)C(CC(C=O)O1)O)=O,,,5,1,1,0,1
87577_0,,,,2,1,2,3
C1(C(C(CC(CC=O)O1)=O)O)=O,,,5,1,1,0,1
87579_0,,,,2,1,2,3
C(C1C(C(C(OC1C)=O)O)=O)=O,,,5,1,1,0,1
87581_0,,,,2,1,2,3
C(C1C(C(C(OC1)=O)O)=O)=O,,,5,1,1,0,1
87583_0,,,,2,1,2,3
C1(C(C=O)C(C(C(C)O1)O)=O)=O,,,5,1,1,0,1
87585_0,,,,2,1,2,3
C1(C(C=O)C(C(CO1)O)=O)=O,,,5,1,1,0,1
87587_0,,,,2,1,2,3
C(CC1C(C(CC(O1)=O)=O)O)=O,,,5,1,1,0,1
87589_0,,,,2,1,2,3
C1(C(C=O)C(CC(C)O1)O)=O,,,5,1,1,0,1
87591_0,,,,2,1,2,3
C(C1C(CC(OC1C)=O)O)=O,,,5,1,1,0,1
87593_0,,,,2,1,2,3
C1(C(CC(C(C(C)O)O1)O)=O)=O,,,5,1,1,0,1
87595_0,,,,2,1,2,3
C1(C(C=O)C(C(C(C)O1)O)O)=O,,,5,1,1,0,1
87596_0,,,,2,1,2,3
87597_0,,,,2,1,2,3
87599_0,,,,2,1,2,3
C1(C(C=O)C(CCO1)O)=O,,,5,1,1,0,1
87601_0,,,,2,1,2,3
C1(C(C(CO)=O)C(CCO1)O)=O,,,5,1,1,0,1
87603_0,,,,2,1,2,3
C1(CC(C(C(CCO)O1)O)=O)=O,,,5,1,1,0,1
87605_0,,,,2,1,2,3
C1(C(C(CC(CCO)O1)=O)O)=O,,,5,1,1,0,1
87607_0,,,,2,1,2,3
C1(C(C(C=O)=O)C(CCO1)O)=O,,,5,1,1,0,1
87609_0,,,,2,1,2,3
C(C1COC(CC1O)=O)=O,,,5,1,1,0,1
87611_0,,,,2,1,2,3
C(C1COC(CC1(CO)O)=O)=O,,,5,1,1,0,1
87613_0,,,,2,1,2,3
C(C1COC(C(C1(C)O)O)=O)=O,,,5,1,1,0,1
87615_0,,,,2,1,2,3
C1(CC(C=O)(C(C=O)CO1)O)=O,,,5,1,1,0,1
87617_0,,,,2,1,2,3
C1(C(C=O)C(CC(CO)O1)O)=O,,,5,1,1,0,1
87619_0,,,,2,1,2,3
C(C1C(COC(C1(C)O)=O)O)=O,,,5,1,1,0,1
87621_0,,,,2,1,2,3
C(C1C(CC(OC1CO)=O)O)=O,,,5,1,1,0,1
87623_0,,,,2,1,2,3
C(C1C(C(C(C(O1)=O)O)O)=O)=O,,,5,1,1,0,1
87625_0,,,,2,1,2,3
C(C1(C(C(C(OC1)=O)O)=O)O)=O,,,5,1,1,0,1
87627_0,,,,2,1,2,3
C1(C(C(C(C(O1)=O)O)=O)O)=O,,,5,1,1,0,1
87628_0,,,,2,1,2,3
87630_0,,,,2,1,2,3
C(C)(C1(COC(C(C1)=O)=O)O)=O,,,5,1,1,0,1
87632_0,,,,2,1,2,3
C1(C(C=O)C(C(CO1)=O)(C)O)=O,,,5,1,1,0,1
87633_0,,,,2,1,2,3
87635_0,,,,2,1,2,3
C(C1(C(C)OC(C(C1)=O)=O)O)=O,,,5,1,1,0,1
87637_0,,,,2,1,2,3
C1(C(C=O)C(C(C(C)O1)=O)O)=O,,,5,1,1,0,1
87638_0,,,,2,1,2,3
87640_0,,,,2,1,2,3
C(C1C(C(C(C(O1)=O)=O)O)O)=O,,,5,1,1,0,1
87642_0,,,,2,1,2,3
C1(C(CC(C)(CO1)O)=O)=O,,,5,1,1,0,1
87644_0,,,,2,1,2,3
C1(C(C(CO)C(C)(CO1)O)=O)=O,,,5,1,1,0,1
87646_0,,,,2,1,2,3
C1(CC(C(C(CO)(C)O1)O)=O)=O,,,5,1,1,0,1
87648_0,,,,2,1,2,3
C1(C(C(CC(CO)(C)O1)=O)O)=O,,,5,1,1,0,1
87650_0,,,,2,1,2,3
C1(C(C(C(C)(CO1)O)O)=O)=O,,,5,1,1,0,1
87652_0,,,,2,1,2,3
C(C1C(C(OCC1(C)O)=O)=O)=O,,,5,1,1,0,1
87654_0,,,,2,1,2,3
C1(CC(C(C(C(C)=O)O1)O)O)=O,,,5,1,1,0,1
87656_0,,,,2,1,2,3
C1(CC(C(C(C(C)=O)O1)O)=O)=O,,,5,1,1,0,1
87658_0,,,,2,1,2,3
C(C)(C1C(CC(C(O1)=O)=O)O)=O,,,5,1,1,0,1
87659_0,,,,2,1,2,3
87661_0,,,,2,1,2,3
C1(C(CCO)(CC(CO1)=O)O)=O,,,5,1,1,0,1
87662_0,,,,2,1,2,3
87664_0,,,,2,1,2,3
C1(C(CC=O)(CC(CO1)=O)O)=O,,,5,1,1,0,1
87666_0,,,,2,1,2,3
C1(C(CC(CO1)(CCO)O)=O)=O,,,5,1,1,0,1
87668_0,,,,2,1,2,3
C1(C(C=O)C(CO)(CCO1)O)=O,,,5,1,1,0,1
87670_0,,,,2,1,2,3
C1(C(C)(C(C(CO1)=O)CO)O)=O,,,5,1,1,0,1
87672_0,,,,2,1,2,3
C1(CC(C(C(CO)=O)CO1)O)=O,,,5,1,1,0,1
87673_0,,,,2,1,2,3
87675_0,,,,2,1,2,3
C1(C(CC(C(CCO)O1)O)=O)=O,,,5,1,1,0,1
87677_0,,,,2,1,2,3
C1(C(CC(C)(C(CO)O1)O)=O)=O,,,5,1,1,0,1
87679_0,,,,2,1,2,3
C1(C(C=O)C(C)(C(CO1)O)O)=O,,,5,1,1,0,1
87681_0,,,,2,1,2,3
C1(C(C)(CC(C(CO)O1)=O)O)=O,,,5,1,1,0,1
87683_0,,,,2,1,2,3
C1(C(C)(CC(C(O1)=O)=O)O)=O,,,5,1,1,0,1
87685_0,,,,2,1,2,3
C1(C(C)(C(C(C(O1)=O)=O)O)O)=O,,,5,1,1,0,1
87687_0,,,,2,1,2,3
C1(C(C)(C2C(C(CO2)O1)=O)O)=O,,,5,1,1,0,1
87689_0,,,,2,1,2,3
C1(C(C)(C2C(C(OC2)O1)=O)O)=O,,,5,1,1,0,1
87691_0,,,,2,1,2,3
C1(C(C)(C(C=O)C(CO1)=O)O)=O,,,5,1,1,0,1
87693_0,,,,2,1,2,3
C1(C(C)(CC(C(C=O)O1)=O)O)=O,,,5,1,1,0,1
87695_0,,,,2,1,2,3
C1(C(CO)(CC(C(O1)=O)=O)O)=O,,,5,1,1,0,1
87697_0,,,,2,1,2,3
C(C1(COC(C(C1)=O)=O)O)(O)=O,,,5,1,1,0,1
87699_0,,,,2,1,2,3
C1(C(CC2(COCC2O1)O)=O)=O,,,5,1,1,0,1
87701_0,,,,2,1,2,3
C1(C(CC2(C(OCC2)O1)O)=O)=O,,,5,1,1,0,1
87702_0,,,,2,1,2,3
87704_0,,,,2,1,2,3
C1(C(CC(C(C)O1)O)=O)=O,,,5,1,1,0,1
87705_0,,,,2,1,2,3
87707_0,,,,2,1,2,3
C1(C(CC(C(O1)=O)=O)O)=O,,,5,1,1,0,1
87709_0,,,,2,1,2,3
C(CC1C(CC(C(O1)=O)=O)O)=O,,,5,1,1,0,1
87711_0,,,,2,1,2,3
C(CC1(COC(C(C1)=O)=O)O)=O,,,5,1,1,0,1
87713_0,,,,2,1,2,3
C(C1C(C)(CC(C(O1)=O)=O)O)=O,,,5,1,1,0,1
87715_0,,,,2,1,2,3
C(C1(COC(C(C1)=O)=O)O)=O,,,5,1,1,0,1
87717_0,,,,2,1,2,3
C1(C(C=O)C(CC(O1)=O)O)=O,,,5,1,1,0,1
87719_0,,,,2,1,2,3
C1(CC(C2C(COC2O1)=O)O)=O,,,5,1,1,0,1
87721_0,,,,2,1,2,3
C1(CC(C(C(C=O)=O)CO1)O)=O,,,5,1,1,0,1
87723_0,,,,2,1,2,3
C1(CC(C(C=O)C(C=O)O1)O)=O,,,5,1,1,0,1
87725_0,,,,2,1,2,3
C1(C(C=O)C2(COC(C2)O1)O)=O,,,5,1,1,0,1
87726_0,,,,2,1,2,3
87728_0,,,,2,1,2,3
C1(C(C(CO)C(C(C)O1)O)=O)=O,,,5,1,1,0,1
87730_0,,,,2,1,2,3
C1(C(C(C(C(O1)=O)=O)CO)O)=O,,,5,1,1,0,1
87731_0,,,,2,1,2,3
87732_0,,,,2,1,2,3
87733_0,,,,2,1,2,3
87735_0,,,,2,1,2,3
C1(CC(C(C(O1)=O)O)=O)=O,,,5,1,1,0,1
87737_0,,,,2,1,2,3
C1(CC(C(C(C(O)O)O1)O)=O)=O,,,5,1,1,0,1
87739_0,,,,2,1,2,3
C1(CC(C(C(C(C)O)O1)O)=O)=O,,,5,1,1,0,1
87741_0,,,,2,1,2,3
C1(CC(C(C(C(O)=O)O1)O)=O)=O,,,5,1,1,0,1
87743_0,,,,2,1,2,3
C(C1(C)C(C(CC(O1)=O)=O)O)=O,,,5,1,1,0,1
87745_0,,,,2,1,2,3
C1(CC(C(C(C)O1)O)=O)=O,,,5,1,1,0,1
87747_0,,,,2,1,2,3
C1(C(C(CC(C(O)O)O1)=O)O)=O,,,5,1,1,0,1
87749_0,,,,2,1,2,3
C1(C(C(CC(C(C)O)O1)=O)O)=O,,,5,1,1,0,1
87750_0,,,,2,1,2,3
87751_0,,,,2,1,2,3
87753_0,,,,2,1,2,3
C1(C(C(CC(C(O)=O)O1)=O)O)=O,,,5,1,1,0,1
87755_0,,,,2,1,2,3
C(C1(C)CC(C(C(O1)=O)O)=O)=O,,,5,1,1,0,1
87757_0,,,,2,1,2,3
C1(C(C(CC(C(C)=O)O1)=O)O)=O,,,5,1,1,0,1
87759_0,,,,2,1,2,3
C1(C(C(CC(C)O1)=O)O)=O,,,5,1,1,0,1
87760_0,,,,2,1,2,3
87762_0,,,,2,1,2,3
C1(C(C(C(C(C)O1)O)O)=O)=O,,,5,1,1,0,1
87764_0,,,,2,1,2,3
C1(C(C(C(CO)(CO1)O)O)=O)=O,,,5,1,1,0,1
87766_0,,,,2,1,2,3
C1(C(C(C(C(O1)=O)=O)O)O)=O,,,5,1,1,0,1
87768_0,,,,2,1,2,3
C(C1(COC(C(C1O)=O)=O)O)=O,,,5,1,1,0,1
87770_0,,,,2,1,2,3
C1(C(C(C(CO)(CO1)O)=O)O)=O,,,5,1,1,0,1
87772_0,,,,2,1,2,3
C(C1(C(CC(OC1C)=O)=O)O)=O,,,5,1,1,0,1
87774_0,,,,2,1,2,3
C(C1(C(CC(OC1)=O)=O)O)=O,,,5,1,1,0,1
87776_0,,,,2,1,2,3
C(C1COC(C(C1O)(C)O)=O)=O,,,5,1,1,0,1
87778_0,,,,2,1,2,3
C(CC1CC(C(C(O1)=O)O)O)=O,,,5,1,1,0,1
87780_0,,,,2,1,2,3
C1(C(C=O)C(C(C(O1)=O)O)O)=O,,,5,1,1,0,1
87782_0,,,,2,1,2,3
C(C1C(C(C(OC1C)=O)O)O)=O,,,5,1,1,0,1
87783_0,,,,2,1,2,3
87784_0,,,,2,1,2,3
87785_0,,,,2,1,2,3
87786_0,,,,2,1,2,3
87787_0,,,,2,1,2,3
87788_0,,,,2,1,2,3
87789_0,,,,2,1,2,3
87790_0,,,,2,1,2,3
87791_0,,,,2,1,2,3
87792_0,,,,2,1,2,3
87793_0,,,,2,1,2,3
87794_0,,,,2,1,2,3
87796_0,,,,2,1,2,3
C1(C(C(C(C(O1)=O)O)=O)CO)=O,,,5,1,1,0,1
87797_0,,,,2,1,2,3
87799_0,,,,2,1,2,3
C1(C(C(C(CO)C(C)O1)=O)O)=O,,,5,1,1,0,1
87800_0,,,,2,1,2,3
87801_0,,,,2,1,2,3
87802_0,,,,2,1,2,3
87804_0,,,,2,1,2,3
C(C1C(C(OC(C)C1O)=O)=O)=O,,,5,1,1,0,1
87806_0,,,,2,1,2,3
C(C1C(C(OC(C1O)=O)=O)=O)=O,,,5,1,1,0,1
87807_0,,,,2,1,2,3
87809_0,,,,2,1,2,3
C1(C(C2C(C(CO2)O1)=O)O)=O,,,5,1,1,0,1
87811_0,,,,2,1,2,3
C1(C(C2C(C(OC2)O1)=O)O)=O,,,5,1,1,0,1
87813_0,,,,2,1,2,3
C1(C2C(CC(O2)O1)=O)=O,,,5,1,1,0,1
87814_0,,,,2,1,2,3
87815_0,,,,2,1,2,3
87816_0,,,,2,1,2,3
87817_0,,,,2,1,2,3
87818_0,,,,2,1,2,3
87819_0,,,,2,1,2,3
87820_0,,,,2,1,2,3
87821_0,,,,2,1,2,3
87822_0,,,,2,1,2,3
87823_0,,,,2,1,2,3
87824_0,,,,2,1,2,3
87825_0,,,,2,1,2,3
87826_0,,,,2,1,2,3
87827_0,,,,2,1,2,3
87828_0,,,,2,1,2,3
87829_0,,,,2,1,2,3
87830_0,,,,2,1,2,3
87831_0,,,,2,1,2,3
87832_0,,,,2,1,2,3
87833_0,,,,2,1,2,3
87834_0,,,,2,1,2,3
87836_0,,,,2,1,2,3
C1(C(CO)(C(CCO1)O)O)=O,,,5,1,1,0,1
87838_0,,,,2,1,2,3
C1(C(C)(C(CCO1)O)O)=O,,,5,1,1,0,1
87840_0,,,,2,1,2,3
C1(C(CCO)(C(CCO1)O)O)=O,,,5,1,2,0,2
87842_0,,,,2,1,2,3
C1(C(C(CCO1)O)O)=O,,,5,1,1,0,1
87843_0,,,,2,1,2,3
87844_0,,,,2,1,2,3
87845_0,,,,2,1,2,3
87846_0,,,,2,1,2,3
87848_0,,,,2,1,2,3
C1(C(C)(C(C)(C(CO1)O)O)O)=O,,,5,1,1,0,1
87850_0,,,,2,1,2,3
C1(C(C(C)(C(CO1)O)O)O)=O,,,5,1,1,0,1
87851_0,,,,2,1,2,3
87852_0,,,,2,1,2,3
87853_0,,,,2,1,2,3
87854_0,,,,2,1,2,3
87855_0,,,,2,1,2,3
87856_0,,,,2,1,2,3
87857_0,,,,2,1,2,3
87858_0,,,,2,1,2,3
87860_0,,,,2,1,2,3
C1(C(CO)(C(CC(O1)=O)O)O)=O,,,5,1,1,0,1
87862_0,,,,2,1,2,3
C(C1(COC(CC1O)=O)O)(O)=O,,,5,1,1,0,1
87864_0,,,,2,1,2,3
C(C1(COC(CC1O)=O)O)=O,,,5,1,1,0,1
87865_0,,,,2,1,2,3
87866_0,,,,2,1,2,3
87868_0,,,,2,1,2,3
C1(C(C)(C(CC(O1)=O)O)O)=O,,,5,1,1,0,1
87870_0,,,,2,1,2,3
C1(CC(C(C(O1)=O)O)O)=O,,,5,1,1,0,1
87871_0,,,,2,1,2,3
87873_0,,,,2,1,2,3
C1(C(CC(C(C(O)=O)O1)O)O)=O,,,5,1,1,0,1
87875_0,,,,2,1,2,3
C1(CC(CO)(C(C(O1)=O)O)O)=O,,,5,1,1,0,1
87877_0,,,,2,1,2,3
C1(C(C(C)(C(C(O1)=O)O)O)O)=O,,,5,1,1,0,1
87878_0,,,,2,1,2,3
87880_0,,,,2,1,2,3
C(C1(C(C(OCC1O)=O)=O)O)=O,,,5,1,1,0,1
87882_0,,,,2,1,2,3
C1(C(C=O)(C(C(CO1)=O)O)O)=O,,,5,1,1,0,1
87884_0,,,,2,1,2,3
C(C1(C=O)COC(CC1O)=O)=O,,,5,1,1,0,1
87886_0,,,,2,1,2,3
C1(C(C=O)(C(CC(C)O1)=O)O)=O,,,5,1,1,0,1
87888_0,,,,2,1,2,3
C1(C(C=O)(C(CCO1)=O)O)=O,,,5,1,1,0,1
87890_0,,,,2,1,1,2
C1(C(C(CO)O)C(CC(C)O1)O)=O,,,5,1,1,0,1
87892_0,,,,2,1,2,3
C1(C(CO)(C(CC(C)O1)O)O)=O,,,5,1,1,0,1
87894_0,,,,2,1,2,3
C(C1(C(CC(OC1C)=O)O)O)=O,,,5,1,1,0,1
87896_0,,,,2,1,2,3
C1(C(C(CCO1)O)C(C=O)O)=O,,,5,1,1,0,1
87898_0,,,,2,1,2,3
C1(C(C(C)=O)(C(CCO1)O)O)=O,,,5,1,1,0,1
87900_0,,,,2,1,2,3
C1(C(C(C)O)(C(CCO1)O)O)=O,,,5,1,1,0,1
87902_0,,,,2,1,1,2
C1(C(C(CO)O)C(CCO1)O)=O,,,5,1,1,0,1
87904_0,,,,2,1,1,2
C1(C(C(CO)O)(C(CCO1)O)O)=O,,,5,1,1,0,1
87906_0,,,,2,1,2,3
C1(CC(C(C(C)=O)(CO1)O)O)=O,,,5,1,1,0,1
87908_0,,,,2,1,1,2
C1(C(C(CC(O1)=O)O)C(CO)O)=O,,,5,1,1,0,1
87910_0,,,,2,1,2,3
C1(C2C(CC(OC2CO1)=O)O)=O,,,5,1,1,0,1
87912_0,,,,2,1,2,3
C1(C(C(CC(O1)=O)=O)(CO)O)=O,,,5,1,1,0,1
87913_0,,,,2,1,2,3
87915_0,,,,2,1,2,3
C1(CC(C(CO)(C(C)O1)O)=O)=O,,,5,1,1,0,1
87916_0,,,,2,1,2,3
87917_0,,,,2,1,2,3
87918_0,,,,2,1,2,3
87919_0,,,,2,1,2,3
87920_0,,,,2,1,1,2
87922_0,,,,2,1,1,2
C1(C(C(CO)O)C(C(CO1)=O)O)=O,,,5,1,1,0,1
87924_0,,,,2,1,2,3
C1(C(C2(C(C(OC2)O1)=O)O)O)=O,,,5,1,1,0,1
87925_0,,,,2,1,2,3
87927_0,,,,2,1,2,3
C1(C(C=O)(C(C(CO1)O)O)O)=O,,,5,1,1,0,1
87929_0,,,,2,1,2,3
C(C1C(COC(C1O)=O)O)(O)=O,,,5,1,1,0,1
87931_0,,,,2,1,2,3
C1(C(C(CCO1)O)(CC=O)O)=O,,,5,1,1,0,1
87932_0,,,,2,1,2,3
87934_0,,,,2,1,2,3
C(C1(C)C(CC(C(O1)=O)O)O)=O,,,5,1,1,0,1
87936_0,,,,2,1,2,3
C(C1CC([C](C(O1)=O)O)O)(O)=O,,,5,1,1,0,1
87938_0,,,,2,1,2,3
C1(C(CC([C](C(O)=O)O1)O)O)=O,,,5,1,1,0,1
87940_0,,,,2,1,2,3
C(C1(C)CC([C](C(O1)=O)O)O)=O,,,5,1,1,0,1
87942_0,,,,2,1,2,3
C(C1(C)CC(C(C(O1)=O)O)O)=O,,,5,1,1,0,1
87944_0,,,,2,1,2,3
C(C)(C1CC([C](C(O1)=O)O)O)=O,,,5,1,1,0,1
87946_0,,,,2,1,2,3
C1(C(C(CC(C(C)=O)O1)O)O)=O,,,5,1,1,0,1
87948_0,,,,2,1,2,3
C(C1([C](C(OC(C)C1)=O)O)O)=O,,,5,1,1,0,1
87950_0,,,,2,1,2,3
C(C1(CC(C)OC(C1O)=O)O)=O,,,5,1,1,0,1
87952_0,,,,2,1,2,3
C(CC1CC([C](C(O1)=O)O)O)=O,,,5,1,1,0,1
87954_0,,,,2,1,2,3
C(C1C(C)OC([C](C1O)O)=O)=O,,,5,1,1,0,1
87956_0,,,,2,1,2,3
C(C1COC([C](C1O)O)=O)=O,,,5,1,1,0,1
87958_0,,,,2,1,2,3
C1(CCOC(C1(CC=O)O)=O)=O,,,5,1,1,0,1
87960_0,,,,2,1,2,3
C1(C(C=C)(C(CC(C)O1)O)O)=O,,,5,1,1,0,1
87962_0,,,,2,1,1,2
C1(C(CCO)(C(CC(C)O1)O)O)=O,,,5,1,1,0,1
87964_0,,,,2,1,2,3
[C]1(C(OC(C)CC1O)=O)O,,,5,1,1,0,1
87966_0,,,,2,1,2,3
C1(C(C(CC(C)O1)O)O)=O,,,5,1,1,0,1
87968_0,,,,2,1,2,3
C1(C(C)(C(CC(C)O1)O)O)=O,,,5,1,1,0,1
87970_0,,,,2,1,2,3
[C]1(C(OC(C)C(C1O)O)=O)O,,,5,1,1,0,1
87972_0,,,,2,1,2,3
C1(C(C(C(C(C)O1)O)O)O)=O,,,5,1,1,0,1
87974_0,,,,2,1,2,3
C1(C(C)(C(C(C(C)O1)O)O)O)=O,,,5,1,1,0,1
87976_0,,,,2,1,2,3
C1(C(C=C)(C(CCO1)O)O)=O,,,5,1,1,0,1
87977_0,,,,2,1,1,2
87979_0,,,,2,1,2,3
[C]1(C(OCCC1O)=O)O,,,5,1,1,0,1
87981_0,,,,2,1,2,3
[C]1(C(OC(CO)CC1O)=O)O,,,5,1,1,0,1
87983_0,,,,2,1,2,3
C(C1C(C([C](C(O1)=O)O)O)=O)=O,,,5,1,1,0,1
87985_0,,,,2,1,2,3
C1(COC([C](C1(C)O)O)=O)=O,,,5,1,1,0,1
87987_0,,,,2,1,2,3
C1(C(C)OC([C](C1O)O)=O)=O,,,5,1,1,0,1
87989_0,,,,2,1,2,3
C(C1(C(C)(COC(C1)=O)O)O)=O,,,5,1,1,0,1
87991_0,,,,2,1,2,3
[C]1(C(OCCC1(CO)O)=O)O,,,5,1,1,0,1
87993_0,,,,2,1,2,3
[C]1(C(OCC(C1(C)O)O)=O)O,,,5,1,1,0,1
87995_0,,,,2,1,2,3
C1(C(C=C)(C(CC(O1)=O)O)O)=O,,,5,1,1,0,1
87997_0,,,,2,1,1,2
C1(C(C(CC(O1)=O)O)(CCO)O)=O,,,5,1,1,0,1
87999_0,,,,2,1,2,3
C1(CC([C](C(O1)=O)O)O)=O,,,5,1,1,0,1
88001_0,,,,2,1,2,3
C(C1([C](C(OCC1)=O)O)O)(O)=O,,,5,1,1,0,1
88002_0,,,,2,1,2,3
88004_0,,,,2,1,2,3
C(C1(C(C(C)OC(C1)=O)O)O)=O,,,5,1,1,0,1
88005_0,,,,2,1,2,3
88007_0,,,,2,1,2,3
C(C1(C)C(C(CC(O1)=O)O)O)=O,,,5,1,1,0,1
88009_0,,,,2,1,2,3
C1(CC(C([C](C(O)=O)O1)O)O)=O,,,5,1,1,0,1
88011_0,,,,2,1,2,3
C1(CC([C](C(O1)=O)O)(CO)O)=O,,,5,1,1,0,1
88013_0,,,,2,1,2,3
C1(C(C([C](C(O1)=O)O)(C)O)O)=O,,,5,1,1,0,1
88015_0,,,,2,1,2,3
C1(C(C=O)(CC(CO1)=O)O)=O,,,5,1,1,0,1
88016_0,,,,2,1,2,3
88017_0,,,,2,1,2,3
88019_0,,,,2,1,2,3
C(C1([C](C(OC(C1)=O)=O)O)O)=O,,,5,1,1,0,1
88021_0,,,,2,1,2,3
C1(CC(C(C(C=O)(O)O1)O)=O)=O,,,5,1,1,0,1
88023_0,,,,2,1,2,3
C1(CC(C([C](C(O)=O)O1)O)=O)=O,,,5,1,1,0,1
88025_0,,,,2,1,2,3
C(C1(C(CC(C(O1)=O)=O)O)O)=O,,,5,1,1,0,1
88027_0,,,,2,1,2,3
C(C1(C)C(CC(C(O1)=O)=O)O)=O,,,5,1,1,0,1
88029_0,,,,2,1,2,3
C1(C(CC([C](C(O)=O)O1)O)=O)=O,,,5,1,1,0,1
88031_0,,,,2,1,2,3
C(C1C(CC(C(O1)=O)=O)O)(O)=O,,,5,1,1,0,1
88033_0,,,,2,1,2,3
[C]1(C(OC2CC1(CO2)O)=O)O,,,5,1,1,0,1
88035_0,,,,2,1,2,3
C1(C(C2(COC(C2)O1)O)O)=O,,,5,1,1,0,1
88037_0,,,,2,1,2,3
C1(C(C)(C2(COC(C2)O1)O)O)=O,,,5,1,1,0,1
88038_0,,,,2,1,2,3
88040_0,,,,2,1,2,3
C1(C(C=C)(C(C(CO1)=O)O)O)=O,,,5,1,1,0,1
88042_0,,,,2,1,2,3
C1(C(C2(C(C(CO2)O1)=O)O)O)=O,,,5,1,1,0,1
88043_0,,,,2,1,2,3
88045_0,,,,2,1,1,2
C1(C(CCO)(C(C(CO1)O)O)O)=O,,,5,1,1,0,1
88047_0,,,,2,1,1,2
C1(C(CCO)(C(C(CO1)=O)O)O)=O,,,5,1,1,0,1
88048_0,,,,2,1,2,3
88049_0,,,,2,1,2,3
88050_0,,,,2,1,2,3
88052_0,,,,2,1,2,3
[C]1(C(OCC(C1O)O)=O)O,,,5,1,1,0,1
88054_0,,,,2,1,2,3
[C]1(C(OC(CO)C(C1O)O)=O)O,,,5,1,1,0,1
88056_0,,,,2,1,2,3
C(C1C(C([C](C(O1)=O)O)O)O)=O,,,5,1,1,0,1
88058_0,,,,2,1,2,3
[C]1(C(OCC(C1(CO)O)O)=O)O,,,5,1,1,0,1
88060_0,,,,2,1,2,3
[C]1(C(OCC(CO)(C1O)O)=O)O,,,5,1,1,0,1
88062_0,,,,2,1,2,3
C(C1([C](C(OCC1)=O)O)O)=O,,,5,1,1,0,1
88064_0,,,,2,1,2,3
C(C1CC([C](C(O1)=O)O)O)=O,,,5,1,1,0,1
88066_0,,,,2,1,2,3
C1(COC([C](C1O)O)=O)=O,,,5,1,1,0,1
88068_0,,,,2,1,2,3
C(C1([C](C(OCC1O)=O)O)O)=O,,,5,1,1,0,1
88070_0,,,,2,1,2,3
C1(C(CO)OC([C](C1O)O)=O)=O,,,5,1,1,0,1
88071_0,,,,2,1,2,3
88072_0,,,,2,1,2,3
88073_0,,,,2,1,2,3
88074_0,,,,2,1,2,3
88075_0,,,,2,1,2,3
88076_0,,,,2,1,2,3
88077_0,,,,2,1,2,3
88078_0,,,,2,1,2,3
88079_0,,,,2,1,2,3
88080_0,,,,2,1,2,3
88081_0,,,,2,1,2,3
88082_0,,,,2,1,2,3
88083_0,,,,2,1,2,3
88084_0,,,,2,1,1,2
88085_0,,,,2,1,1,2
88086_0,,,,2,1,1,2
88087_0,,,,2,1,1,2
88088_0,,,,2,1,1,2
88089_0,,,,2,1,2,3
88090_0,,,,2,1,2,3
88091_0,,,,2,1,2,3
88092_0,,,,2,1,2,3
88093_0,,,,2,1,2,3
88094_0,,,,2,1,2,3
88096_0,,,,2,1,2,3
C1(C2CC(C(O2)O1)=O)=O,,,5,1,1,0,1
88098_0,,,,2,1,2,3
C1(C2OC(C(O2)=O)C1CO)=O,,,5,1,1,0,1
88100_0,,,,2,1,2,3
C(C1C(C2OC1C(O2)=O)O)=O,,,5,1,1,0,1
88102_0,,,,2,1,2,3
C1(C2C(C(C(O2)O1)=O)O)=O,,,5,1,1,0,1
88103_0,,,,2,1,2,3
88105_0,,,,2,1,2,3
C(C1(C(C2OC1C(O2)=O)O)O)=O,,,5,1,1,0,1
88107_0,,,,2,1,2,3
C1(C2(CO)C(CC(O2)O1)O)=O,,,5,1,1,0,1
88108_0,,,,2,1,2,3
88110_0,,,,2,1,2,3
C1(C2OC(C(O2)=O)C1(CO)O)=O,,,5,1,1,0,1
88112_0,,,,2,1,2,3
C(C1(CC2OC1C(O2)=O)O)=O,,,5,1,1,0,1
88114_0,,,,2,1,2,3
C1(C2(C)C(CC(O2)O1)O)=O,,,5,1,1,0,1
88116_0,,,,2,1,2,3
C1(C2(CCO)C(CC(O2)O1)O)=O,,,5,1,1,0,1
88118_0,,,,2,1,2,3
C1(C2C(CC(O2)O1)O)=O,,,5,1,1,0,1
88119_0,,,,2,1,2,3
88120_0,,,,2,1,2,3
88122_0,,,,2,1,2,3
C1(C2(C)C(CC(CO)(O2)O1)O)=O,,,5,1,1,0,1
88124_0,,,,2,1,2,3
C1(C2C(CC(CO)(O2)O1)O)=O,,,5,1,1,0,1
88126_0,,,,2,1,2,3
C1(C2(C)C(CO)(CC(O2)O1)O)=O,,,5,1,1,0,1
88128_0,,,,2,1,2,3
C1(C2C(CO)(CC(O2)O1)O)=O,,,5,1,1,0,1
88130_0,,,,2,1,2,3
C1(C2(C)C(C(C(C)(O2)O1)O)O)=O,,,5,1,1,0,1
88132_0,,,,2,1,2,3
C1(C2C(C(C(C)(O2)O1)O)O)=O,,,5,1,1,0,1
88134_0,,,,2,1,2,3
C1(C2(C)C(C)(C(C(O2)O1)O)O)=O,,,5,1,1,0,1
88136_0,,,,2,1,2,3
C1(C2C(C)(C(C(O2)O1)O)O)=O,,,5,1,1,0,1
88137_0,,,,2,1,2,3
88138_0,,,,2,1,2,3
88139_0,,,,2,1,2,3
88140_0,,,,2,1,2,3
88142_0,,,,2,1,2,3
C1(C2(COC(CC2O)O1)O)=O,,,5,1,1,0,1
88143_0,,,,2,1,2,3
88144_0,,,,2,1,2,3
88145_0,,,,2,1,2,3
88146_0,,,,2,1,2,3
88148_0,,,,2,1,2,3
C1(C2(CCOC(CC2O)O1)O)=O,,,5,1,1,0,1
88149_0,,,,2,1,1,2
88150_0,,,,2,1,1,2
88151_0,,,,2,1,1,2
88152_0,,,,2,1,1,2
88153_0,,,,2,1,1,2
88154_0,,,,2,1,1,2
88155_0,,,,2,1,1,2
88157_0,,,,2,1,2,3
C(C1CCC(OC1C(O)=O)=O)=O,,,5,1,1,0,1
88159_0,,,,2,1,2,3
C1(CCC(C(O1)=O)(CC=O)O)=O,,,5,1,1,0,1
88161_0,,,,2,1,2,3
C(C1CCC(OC1(C=O)C)=O)=O,,,5,1,1,0,1
88163_0,,,,2,1,2,3
C(C1(CCCC(O1)=O)CC=O)=O,,,5,1,1,0,1
88165_0,,,,2,1,2,3
C(C1CCC(OC1C(C)=O)=O)=O,,,5,1,1,0,1
88167_0,,,,2,1,2,3
C1(CCCC(CC(C=O)=O)O1)=O,,,5,1,1,0,1
88169_0,,,,2,1,2,3
C1(CCC(C(C=O)=O)C(C)O1)=O,,,5,1,1,0,1
88171_0,,,,2,1,2,3
C(C1CCC(OC1CC=O)=O)=O,,,5,1,1,0,1
88173_0,,,,2,1,2,3
C(C(C=O)C1CCCC(O1)=O)=O,,,5,1,1,0,1
88175_0,,,,2,1,2,3
C(C1(C=O)CCC(OC1C)=O)=O,,,5,1,1,0,1
88177_0,,,,2,1,2,3
C(C1(C=O)CCC(OC1)=O)=O,,,5,1,1,0,1
88179_0,,,,2,1,2,3
C(C1CCC(OC1C)=O)=O,,,5,1,1,0,1
88181_0,,,,2,1,2,3
C(C1C(C)OC(CC1CO)=O)=O,,,5,1,1,0,1
88183_0,,,,2,1,2,3
C(CC1CCCC(O1)=O)=O,,,5,1,1,0,1
88185_0,,,,2,1,2,3
C1(CC(CO)CC(CC=O)O1)=O,,,5,1,1,0,1
88187_0,,,,2,1,2,3
C(C1(CCC(OC1C)=O)O)=O,,,5,1,1,0,1
88189_0,,,,2,1,2,3
C1(CCC(C)(C(C=O)O1)O)=O,,,5,1,1,0,1
88191_0,,,,2,1,2,3
C1(CCCC(C(C=O)O)O1)=O,,,5,1,1,0,1
88193_0,,,,2,1,2,3
C(C1CCC(OC1)=O)=O,,,5,1,1,0,1
88195_0,,,,2,1,2,3
C(C1COC(CC1CO)=O)=O,,,5,1,1,0,1
88197_0,,,,2,1,2,3
C1(CCC(C(CC=O)O1)O)=O,,,5,1,1,0,1
88199_0,,,,2,1,2,3
C1(CCC(CO1)(CC=O)O)=O,,,5,1,1,0,1
88201_0,,,,2,1,2,3
C(C1CCC(OC1CO)=O)=O,,,5,1,1,0,1
88203_0,,,,2,1,2,3
C1(CCCC(C(C=O)=O)O1)=O,,,5,1,1,0,1
88205_0,,,,2,1,2,3
C1(CCC(C(CO)(CO)O1)O)=O,,,5,1,1,0,1
88207_0,,,,2,1,2,3
C1(CCC(C(CO)=O)CO1)=O,,,5,1,1,0,1
88209_0,,,,2,1,2,3
C1(CCC(CO)C(C=O)O1)=O,,,5,1,1,0,1
88211_0,,,,2,1,2,3
C1(CCC(CO1)C(C=O)O)=O,,,5,1,1,0,1
88213_0,,,,2,1,2,3
C1(CCC(C(C)=O)(CO1)O)=O,,,5,1,1,0,1
88215_0,,,,2,1,2,3
C1(CCC(C(C(C)=O)O1)O)=O,,,5,1,1,0,1
88217_0,,,,2,1,2,3
C1(CCCCO1)=O,,,5,1,1,0,1
88219_0,,,,2,1,2,3
C1(CC(CO)CCO1)=O,,,5,1,1,0,1
88221_0,,,,2,1,2,3
C(CC1COC(C(C1)=O)=O)(O)=O,,,5,1,1,0,1
88223_0,,,,2,1,2,3
C(C1C(OC(CC1)=O)=O)=O,,,5,1,1,0,1
88225_0,,,,2,1,2,3
C1(C(C=O)C(CO)CC(O1)=O)=O,,,5,1,1,0,1
88227_0,,,,2,1,2,3
C1(CCC(C(C(O)=O)=O)CO1)=O,,,5,1,1,0,1
88229_0,,,,2,1,2,3
C(C1CCC(OC1C=O)=O)(O)=O,,,5,1,1,0,1
88231_0,,,,2,1,2,3
C1(CCC(C(O1)=O)C(C=O)O)=O,,,5,1,1,0,1
88233_0,,,,2,1,2,3
C1(CCC(C(O1)=O)C(CO)=O)=O,,,5,1,1,0,1
88235_0,,,,2,1,2,3
C1(CCC(C(O1)=O)(C(C)=O)O)=O,,,5,1,1,0,1
88237_0,,,,2,1,2,3
C1(CCCC(O1)=O)=O,,,5,1,1,0,1
88239_0,,,,2,1,2,3
C1(CC(CO)CC(O1)=O)=O,,,5,1,1,0,1
88241_0,,,,2,1,2,3
C1(C(CCC(O1)=O)(C(C)O)O)=O,,,5,1,1,0,1
88243_0,,,,2,1,2,3
C(C1(CCC(OC1C)=O)O)(O)=O,,,5,1,1,0,1
88245_0,,,,2,1,2,3
C1(CCC(C)(C(C(O)=O)O1)O)=O,,,5,1,1,0,1
88247_0,,,,2,1,2,3
C1(CCCC(C(C(O)=O)O)O1)=O,,,5,1,1,0,1
88248_0,,,,2,1,2,3
88250_0,,,,2,1,2,3
C(C1(CO)CCCC(O1)=O)(O)=O,,,5,1,1,0,1
88252_0,,,,2,1,2,3
C1(C(C(C=O)=O)CCC(O1)=O)=O,,,5,1,1,0,1
88254_0,,,,2,1,2,3
C1(CCC2C(C(CO2)=O)O1)=O,,,5,1,1,0,1
88256_0,,,,2,1,2,3
C1(C2CCC(OC2CO1)=O)=O,,,5,1,1,0,1
88258_0,,,,2,1,1,2
C1(C(CCC(O1)=O)C(CO)O)=O,,,5,1,1,0,1
88260_0,,,,2,1,2,3
C1(CCC2C(CC(O2)=O)O1)=O,,,5,1,1,0,1
88262_0,,,,2,1,2,3
C1(CCC2C(COC2O1)=O)=O,,,5,1,1,0,1
88264_0,,,,2,1,2,3
C1(C(C=C)(CCC(O1)=O)O)=O,,,5,1,1,0,1
88266_0,,,,2,1,2,3
C1(CCC2C(C(C(O)O2)=O)O1)=O,,,5,1,1,0,1
88268_0,,,,2,1,1,2
C1(C(CCC(O1)=O)(C(CO)O)O)=O,,,5,1,1,0,1
88270_0,,,,2,1,2,3
C1(C2(CCC(OC2CO1)=O)O)=O,,,5,1,1,0,1
88272_0,,,,2,1,2,3
C1(CCC2C(C(C(O2)=O)O)O1)=O,,,5,1,1,0,1
88274_0,,,,2,1,2,3
C1(CCC2(COC(C2O1)=O)O)=O,,,5,1,1,0,1
88276_0,,,,2,1,1,2
C1(C(CCC(O1)=O)(CCO)O)=O,,,5,1,2,0,2
88278_0,,,,2,1,2,3
C1(C2C(CCC(O2)=O)CO1)=O,,,5,1,1,0,1
88280_0,,,,2,1,2,3
C(C1CCCC(O1)=O)=O,,,5,1,1,0,1
88282_0,,,,2,1,2,3
C1(CC[C](C(O1)=O)O)=O,,,5,1,1,0,1
88284_0,,,,2,1,2,3
C(C1(COC(CC1)=O)O)=O,,,5,1,1,0,1
88285_0,,,,2,1,2,3
88287_0,,,,2,1,2,3
C(C1(CCC(OC1CO)=O)O)=O,,,5,1,1,0,1
88289_0,,,,2,1,2,3
C1(CCC(C(C(C=O)O)O1)O)=O,,,5,1,1,0,1
88291_0,,,,2,1,2,3
C1(CCC(CO)(C(C=O)O1)O)=O,,,5,1,1,0,1
88293_0,,,,2,1,2,3
C1(CCC(CO1)(C(C=O)O)O)=O,,,5,1,1,0,1
88295_0,,,,2,1,2,3
C1(CCC(CO1)O)=O,,,5,1,1,0,1
88297_0,,,,2,1,2,3
C1(CCC(C(O1)=O)O)=O,,,5,1,1,0,1
88299_0,,,,2,1,2,3
C1(CCC(C=O)(C(C=O)O1)O)=O,,,5,1,1,0,1
88300_0,,,,2,1,2,3
88302_0,,,,2,1,2,3
C1(CCC(C(CO)=O)(CO1)O)=O,,,5,1,1,0,1
88304_0,,,,2,1,2,3
C1(CCC(CO1)(CO)O)=O,,,5,1,1,0,1
88306_0,,,,2,1,2,3
C1(CCC(C(CO)O1)O)=O,,,5,1,1,0,1
88308_0,,,,2,1,2,3
C1(CCC(CO1)(C(CO)O)O)=O,,,5,1,1,0,1
88310_0,,,,2,1,2,3
C1(CCC(CO)(C(CO)O1)O)=O,,,5,1,1,0,1
88312_0,,,,2,1,2,3
C1(CCC(C(C(CO)O)O1)O)=O,,,5,1,1,0,1
88314_0,,,,2,1,2,3
C1(C(CO)(CCC(O1)=O)O)=O,,,5,1,1,0,1
88316_0,,,,2,1,2,3
C(C1(COC(CC1)=O)O)(O)=O,,,5,1,1,0,1
88317_0,,,,2,1,2,3
88318_0,,,,2,1,2,3
88320_0,,,,2,1,2,3
C1(CCC(C(C=O)=O)CO1)=O,,,5,1,1,0,1
88322_0,,,,2,1,2,3
C(C1CCC(OC1C=O)=O)=O,,,5,1,1,0,1
88324_0,,,,2,1,2,3
C1(CCC2(C(OCC2O)O1)O)=O,,,5,1,1,0,1
88326_0,,,,2,1,2,3
C1(CCC2(C(O)OCC2O1)O)=O,,,5,1,1,0,1
88328_0,,,,2,1,2,3
C1(CCC2(C(C(CO2)O)O1)O)=O,,,5,1,1,0,1
88330_0,,,,2,1,2,3
C1(CCC2C(C(C(O)O2)O)O1)=O,,,5,1,1,0,1
88332_0,,,,2,1,2,3
C1(CCC2(COC(C2O1)O)O)=O,,,5,1,1,0,1
88334_0,,,,2,1,2,3
C1(C(C)(CCC(O1)=O)O)=O,,,5,1,1,0,1
88336_0,,,,2,1,2,3
C(C1CCCC(O1)=O)(O)=O,,,5,1,1,0,1
88337_0,,,,2,1,2,3
88339_0,,,,2,1,2,3
C1(CCC(CO)C(C(O)=O)O1)=O,,,5,1,1,0,1
88341_0,,,,2,1,2,3
C1(CCC(CO1)C(C(O)=O)O)=O,,,5,1,1,0,1
88342_0,,,,2,1,2,3
88344_0,,,,2,1,2,3
C1(CCC(C(C=O)=O)(CO1)O)=O,,,5,1,1,0,1
88346_0,,,,2,1,2,3
C1(CC(CC(C=O)O1)CO)=O,,,5,1,1,0,1
88348_0,,,,2,1,2,3
C1(CC([C](C(O1)=O)O)CO)=O,,,5,1,1,0,1
88350_0,,,,2,1,2,3
C(C1(COC(CC1CO)=O)O)=O,,,5,1,1,0,1
88352_0,,,,2,1,2,3
C1(CC(CO)C(C(C=O)O1)O)=O,,,5,1,1,0,1
88354_0,,,,2,1,2,3
C1(CC(CO)C(CO1)O)=O,,,5,1,1,0,1
88356_0,,,,2,1,2,3
C1(CC(CO)C(C(O1)=O)O)=O,,,5,1,1,0,1
88358_0,,,,2,1,2,3
C1(CC(CO)C(CO1)(CO)O)=O,,,5,1,1,0,1
88360_0,,,,2,1,2,3
C1(CC(CO)C(C(CO)O1)O)=O,,,5,1,1,0,1
88362_0,,,,2,1,2,3
C1(C(C)(C(CO)CC(O1)=O)O)=O,,,5,1,1,0,1
88364_0,,,,2,1,2,3
C(CC1COC(C(C1)O)=O)(O)=O,,,5,1,1,0,1
88366_0,,,,2,1,2,3
C1(CC(CC(C(O)=O)O1)CO)=O,,,5,1,1,0,1
88368_0,,,,2,1,2,3
C1(COC(C(C1O)=O)=O)=O,,,5,1,1,0,1
88370_0,,,,2,1,2,3
C1(C(CO)OC(C(C1O)=O)=O)=O,,,5,1,1,0,1
88372_0,,,,2,1,2,3
C(C1C(COC(C1=O)=O)=O)=O,,,5,1,1,0,1
88374_0,,,,2,1,2,3
C(C1C(CC(C(O1)=O)=O)=O)=O,,,5,1,1,0,1
88376_0,,,,2,1,2,3
C1(COC(C(C1(CO)O)=O)=O)=O,,,5,1,1,0,1
88378_0,,,,2,1,2,3
C(C1(C(C(OCC1)=O)=O)O)(O)=O,,,5,1,1,0,1
88380_0,,,,2,1,2,3
C(C1(C(C(OCC1)=O)=O)O)=O,,,5,1,1,0,1
88382_0,,,,2,1,2,3
C(C1CC(C(C(O1)=O)=O)O)=O,,,5,1,1,0,1
88384_0,,,,2,1,2,3
C1(C(CCC(C=O)O1)O)=O,,,5,1,1,0,1
88386_0,,,,2,1,2,3
[C]1(C(OCC(C1)O)=O)O,,,5,1,1,0,1
88388_0,,,,2,1,2,3
[C]1(C(OC(CO)C(C1)O)=O)O,,,5,1,1,0,1
88389_0,,,,2,1,2,3
88391_0,,,,2,1,2,3
C(C1COC(C(CC1O)O)=O)=O,,,5,1,1,0,1
88393_0,,,,2,1,2,3
C(C1C(CCOC(C1O)=O)O)=O,,,5,1,1,0,1
88395_0,,,,2,1,2,3
C(C1COC(C(CC1O)=O)=O)=O,,,5,1,1,0,1
88397_0,,,,2,1,2,3
C1(C(C=O)C(C(CCO1)=O)O)=O,,,5,1,1,0,1
88399_0,,,,2,1,2,3
C1(C(C=O)C(CC(CO1)=O)O)=O,,,5,1,1,0,1
88401_0,,,,2,1,2,3
C1(C(CC(CC(C)O1)O)=O)=O,,,5,1,1,0,1
88403_0,,,,2,1,2,3
C1(C(C(C(CC(C)O1)O)O)=O)=O,,,5,1,1,0,1
88405_0,,,,2,1,2,3
C1(C(CC(C(C(C)O1)O)O)=O)=O,,,5,1,1,0,1
88407_0,,,,2,1,2,3
C1(C(CC(CCO1)O)=O)=O,,,5,1,1,0,1
88409_0,,,,2,1,2,3
C1(C(C(CO)C(CCO1)O)=O)=O,,,5,1,1,0,1
88411_0,,,,2,1,2,3
C1(C(C(C(CCO1)O)O)=O)=O,,,5,1,1,0,1
88413_0,,,,2,1,2,3
C(C1C(C(OCCC1O)=O)=O)=O,,,5,1,1,0,1
88415_0,,,,2,1,2,3
C(C1COC(CC(C1O)O)=O)=O,,,5,1,1,0,1
88417_0,,,,2,1,2,3
C(C1COC(CC(C1O)=O)=O)=O,,,5,1,1,0,1
88419_0,,,,2,1,2,3
C1(C(CC(CC(CO)O1)O)=O)=O,,,5,1,1,0,1
88421_0,,,,2,1,2,3
C1(C(C=O)C(CC(CO1)O)O)=O,,,5,1,1,0,1
88423_0,,,,2,1,2,3
C(C1C(CC(OCC1O)=O)O)=O,,,5,1,1,0,1
88425_0,,,,2,1,2,3
C1(COC(C(CC1(C)O)=O)=O)=O,,,5,1,1,0,1
88427_0,,,,2,1,2,3
C1(C(C)(CC(C(CO1)=O)=O)O)=O,,,5,1,1,0,1
88428_0,,,,2,1,2,3
88430_0,,,,2,1,2,3
C1(C(CC(C(OC1C)=O)=O)O)=O,,,5,1,1,0,1
88432_0,,,,2,1,2,3
C1(CC(C(C(C)(CO1)O)O)=O)=O,,,5,1,1,0,1
88434_0,,,,2,1,2,3
C1(C(C(CC(C)(CO1)O)=O)O)=O,,,5,1,1,0,1
88435_0,,,,2,1,2,3
88437_0,,,,2,1,2,3
C1(CC(CO)(CC(CO1)=O)O)=O,,,5,1,1,0,1
88439_0,,,,2,1,2,3
C1(C(C(C)(CC(CO1)=O)O)O)=O,,,5,1,1,0,1
88441_0,,,,2,1,2,3
C1(CC(C=O)(CC(CO1)=O)O)=O,,,5,1,1,0,1
88443_0,,,,2,1,2,3
C1(C(CC(CO)(CCO1)O)=O)=O,,,5,1,1,0,1
88445_0,,,,2,1,2,3
C1(CC(C(C(CO1)=O)CO)O)=O,,,5,1,1,0,1
88447_0,,,,2,1,2,3
C1(C(C=O)C(C(CCO1)O)O)=O,,,5,1,1,0,1
88449_0,,,,2,1,2,3
C1(C(CC(C)(C(CO1)O)O)=O)=O,,,5,1,1,0,1
88451_0,,,,2,1,2,3
C1(C(C)(CC(C(CO1)O)=O)O)=O,,,5,1,1,0,1
88453_0,,,,2,1,2,3
C1(CC(CC(C(CO)O1)=O)O)=O,,,5,1,1,0,1
88455_0,,,,2,1,2,3
C1(C(C)(C2C(CC(O2)O1)=O)O)=O,,,5,1,1,0,1
88457_0,,,,2,1,2,3
C1(CC(CC(C(O1)=O)=O)O)=O,,,5,1,1,0,1
88459_0,,,,2,1,2,3
C1(C(CC2(COC(C2)O1)O)=O)=O,,,5,1,1,0,1
88461_0,,,,2,1,2,3
C(C1(CCOC(C(C1)=O)=O)O)=O,,,5,1,1,0,1
88463_0,,,,2,1,2,3
C(C1CC(CC(C(O1)=O)=O)O)=O,,,5,1,1,0,1
88465_0,,,,2,1,2,3
C1(COC(C(CC1O)=O)=O)=O,,,5,1,1,0,1
88467_0,,,,2,1,2,3
C1(CC(C(C(C(O1)=O)=O)O)O)=O,,,5,1,1,0,1
88469_0,,,,2,1,2,3
C1(CC(C2C(C(CO2)O1)=O)O)=O,,,5,1,1,0,1
88471_0,,,,2,1,2,3
C1(CC(C2C(C(OC2)O1)=O)O)=O,,,5,1,1,0,1
88473_0,,,,2,1,2,3
C1(CC(C(C(CO1)=O)O)O)=O,,,5,1,1,0,1
88475_0,,,,2,1,2,3
C1(CC(C(C=O)C(CO1)=O)O)=O,,,5,1,1,0,1
88477_0,,,,2,1,2,3
C(C1C(CC(CC(O1)=O)O)=O)=O,,,5,1,1,0,1
88478_0,,,,2,1,2,3
88480_0,,,,2,1,2,3
C1(CC(C(C(C(C)O1)O)O)=O)=O,,,5,1,1,0,1
88482_0,,,,2,1,2,3
C1(CC(C(C(C(O1)=O)O)O)=O)=O,,,5,1,1,0,1
88483_0,,,,2,1,2,3
88485_0,,,,2,1,2,3
C1(C(C(CC(C(C)O1)O)=O)O)=O,,,5,1,1,0,1
88487_0,,,,2,1,2,3
C1(C(C(CC(C(O1)=O)O)=O)O)=O,,,5,1,1,0,1
88489_0,,,,2,1,2,3
C1(COC(C(C(C1O)O)=O)=O)=O,,,5,1,1,0,1
88491_0,,,,2,1,2,3
C1(C(C(C(OC(C)C1)=O)O)O)=O,,,5,1,1,0,1
88493_0,,,,2,1,2,3
C1(CC(C(OC(C)C1O)=O)O)=O,,,5,1,1,0,1
88495_0,,,,2,1,2,3
C1(C(C2C(CC(O2)O1)=O)O)=O,,,5,1,1,0,1
88496_0,,,,2,1,2,3
88497_0,,,,2,1,2,3
88498_0,,,,2,1,2,3
88499_0,,,,2,1,2,3
88500_0,,,,2,1,2,3
88501_0,,,,2,1,2,3
88502_0,,,,2,1,2,3
88503_0,,,,2,1,2,3
88504_0,,,,2,1,2,3
88506_0,,,,2,1,2,3
C1(C(C(C(CCO1)O)O)O)=O,,,5,1,1,0,1
88508_0,,,,2,1,2,3
C1(C(C)(C(C(CCO1)O)O)O)=O,,,5,1,1,0,1
88510_0,,,,2,1,2,3
C1(C(C)(C(CC(CO1)O)O)O)=O,,,5,1,1,0,1
88512_0,,,,2,1,2,3
C1(C(C(CC(CO1)O)O)O)=O,,,5,1,1,0,1
88513_0,,,,2,1,2,3
88514_0,,,,2,1,2,3
88515_0,,,,2,1,2,3
88517_0,,,,2,1,2,3
C1(C(C(CC(C(O1)=O)O)O)O)=O,,,5,1,1,0,1
88519_0,,,,2,1,2,3
C1(C(CC([C](C(O1)=O)O)O)O)=O,,,5,1,1,0,1
88521_0,,,,2,1,2,3
C1(CC(C)OC([C](C1O)O)=O)=O,,,5,1,1,0,1
88523_0,,,,2,1,2,3
C(C1(C(CCOC(C1)=O)O)O)=O,,,5,1,1,0,1
88525_0,,,,2,1,2,3
[C]1(C(OCC(CC1O)O)=O)O,,,5,1,1,0,1
88527_0,,,,2,1,2,3
C1(COC([C](C(C1O)O)O)=O)=O,,,5,1,1,0,1
88529_0,,,,2,1,2,3
C(C1(C(CC(OCC1)=O)O)O)=O,,,5,1,1,0,1
88531_0,,,,2,1,2,3
[C]1(C(OCCC(C1O)O)=O)O,,,5,1,1,0,1
88533_0,,,,2,1,2,3
C1(CC(C([C](C(O1)=O)O)O)O)=O,,,5,1,1,0,1
88535_0,,,,2,1,2,3
C1(CC(C([C](C(O1)=O)O)O)=O)=O,,,5,1,1,0,1
88537_0,,,,2,1,2,3
C1(C(CC([C](C(O1)=O)O)O)=O)=O,,,5,1,1,0,1
88539_0,,,,2,1,2,3
C1(C(C(CC(C(O1)=O)=O)O)O)=O,,,5,1,1,0,1
88541_0,,,,2,1,2,3
[C]1(C(OCC(C(C1O)O)O)=O)O,,,5,1,1,0,1
88543_0,,,,2,1,2,3
C1(CCOC([C](C1O)O)=O)=O,,,5,1,1,0,1
88545_0,,,,2,1,2,3
C1(COC([C](C(C1)O)O)=O)=O,,,5,1,1,0,1
88547_0,,,,2,1,2,3
C1(C(COC([C](C1O)O)=O)O)=O,,,5,1,1,0,1
88548_0,,,,2,1,2,3
88549_0,,,,2,1,2,3
88550_0,,,,2,1,2,3
88551_0,,,,2,1,2,3
88552_0,,,,2,1,2,3
88553_0,,,,2,1,2,3
88554_0,,,,2,1,2,3
88555_0,,,,2,1,2,3
88556_0,,,,2,1,2,3
88557_0,,,,2,1,2,3
88558_0,,,,2,1,2,3
88559_0,,,,2,1,2,3
88560_0,,,,2,1,2,3
88561_0,,,,2,1,2,3
88562_0,,,,2,1,2,3
88564_0,,,,2,1,2,3
C1(C(C2C(CC(O2)O1)O)O)=O,,,5,1,1,0,1
88566_0,,,,2,1,2,3
C1(C(C2C(C(C(O2)O1)O)O)O)=O,,,5,1,1,0,1
88568_0,,,,2,1,2,3
C1(C(C)(C2C(CC(O2)O1)O)O)=O,,,5,1,1,0,1
88570_0,,,,2,1,2,3
C1(C(C)(C2CC(C(O2)O1)O)O)=O,,,5,1,1,0,1
88572_0,,,,2,1,2,3
C1(C(C2CC(C(O2)O1)O)O)=O,,,5,1,1,0,1
88573_0,,,,2,1,2,3
88574_0,,,,2,1,2,3
88575_0,,,,2,1,2,3
88576_0,,,,2,1,2,3
88578_0,,,,2,1,2,3
C1(C(C2C(OC(C1)O2)=O)O)=O,,,5,1,1,0,1
88580_0,,,,2,1,2,3
C1(CC2C(OC(C1O)O2)=O)=O,,,5,1,1,0,1
88582_0,,,,2,1,2,3
C1(C2C(C(CC(O2)O1)O)O)=O,,,5,1,1,0,1
88584_0,,,,2,1,2,3
C1(C2C(C(C(C(O2)O1)O)O)O)=O,,,5,1,1,0,1
88586_0,,,,2,1,2,3
C1(C2(C)C(C(CC(O2)O1)O)O)=O,,,5,1,1,0,1
88588_0,,,,2,1,2,3
C1(C2(C)C(CC(C(O2)O1)O)O)=O,,,5,1,1,0,1
88590_0,,,,2,1,2,3
C1(C2C(CC(C(O2)O1)O)O)=O,,,5,1,1,0,1
88592_0,,,,2,1,2,3
C1(CCC(C=O)C(C(O1)=O)O)=O,,,5,1,1,0,1
88594_0,,,,2,1,2,3
C(CC1C(CCCC(O1)=O)=O)=O,,,5,1,1,0,1
88596_0,,,,2,1,2,3
C1(CCCC(C(C=O)O1)O)=O,,,5,1,1,0,1
88598_0,,,,2,1,2,3
C(C1CCC(OCC1O)=O)=O,,,5,1,1,0,1
88600_0,,,,2,1,2,3
C1(CCC(C(C(C=O)O1)=O)O)=O,,,5,1,1,0,1
88602_0,,,,2,1,2,3
C1(CCC(C=O)(C(CO1)=O)O)=O,,,5,1,1,0,1
88604_0,,,,2,1,2,3
C1(CCC(C(CO1)(CO)O)O)=O,,,5,1,1,0,1
88606_0,,,,2,1,2,3
C1(COC(CCC1)=O)=O,,,5,1,1,0,1
88608_0,,,,2,1,2,3
C1(CC(CO)CC(CO1)=O)=O,,,5,1,1,0,1
88610_0,,,,2,1,2,3
C1(CCC(C(CO1)=O)CO)=O,,,5,1,1,0,1
88612_0,,,,2,1,2,3
C(C1(CCC(OCC1)=O)O)=O,,,5,1,1,0,1
88614_0,,,,2,1,2,3
C1(CCC(CC(C=O)O1)O)=O,,,5,1,1,0,1
88616_0,,,,2,1,2,3
C1(CCCC(C(CO)O1)=O)=O,,,5,1,1,0,1
88618_0,,,,2,1,2,3
C1(CCCC(C(O1)=O)=O)=O,,,5,1,1,0,1
88620_0,,,,2,1,2,3
C1(CC(CO)CC(C(O1)=O)=O)=O,,,5,1,1,0,1
88622_0,,,,2,1,2,3
C1(CCC(C(C(O1)=O)=O)CO)=O,,,5,1,1,0,1
88624_0,,,,2,1,2,3
C1(CCC(C=O)(CC(O1)=O)O)=O,,,5,1,1,0,1
88626_0,,,,2,1,2,3
C(C1C(COC(CC1)=O)=O)(O)=O,,,5,1,1,0,1
88628_0,,,,2,1,2,3
C(C1C(CCCC(O1)=O)=O)(O)=O,,,5,1,1,0,1
88630_0,,,,2,1,2,3
C1(CCC(C(C(O1)=O)=O)O)=O,,,5,1,1,0,1
88632_0,,,,2,1,2,3
C1(CCC(C)(C(C(O1)=O)O)O)=O,,,5,1,1,0,1
88634_0,,,,2,1,2,3
C1(CCCC(C(C(O)=O)O1)O)=O,,,5,1,1,0,1
88635_0,,,,2,1,2,3
88637_0,,,,2,1,2,3
C(C1(COC(CCC1)=O)O)(O)=O,,,5,1,1,0,1
88639_0,,,,2,1,2,3
C1(C(CO)(CCCC(O1)=O)O)=O,,,5,1,1,0,1
88641_0,,,,2,1,2,3
C(C1C(C(OC(CC1)=O)=O)=O)=O,,,5,1,1,0,1
88643_0,,,,2,1,2,3
C1(CCC2C(C(CO2)O1)=O)=O,,,5,1,1,0,1
88645_0,,,,2,1,2,3
C1(CCC2C(C(OC2)O1)=O)=O,,,5,1,1,0,1
88647_0,,,,2,1,1,2
C1(CCC(CO)(CC(O1)=O)O)=O,,,5,1,1,0,1
88649_0,,,,2,1,2,3
C1(CCC2(C(C(CO2)O1)=O)O)=O,,,5,1,1,0,1
88651_0,,,,2,1,2,3
C1(CCC2(C(C(OC2)O1)=O)O)=O,,,5,1,1,0,1
88653_0,,,,2,1,2,3
C1(CCC2C(C(C(O2)=O)O1)O)=O,,,5,1,1,0,1
88655_0,,,,2,1,1,2
C1(CCC(CO)(C(C(O1)=O)O)O)=O,,,5,1,1,0,1
88657_0,,,,2,1,2,3
C1(C2CC(CCC(O2)=O)O1)=O,,,5,1,1,0,1
88659_0,,,,2,1,1,2
C1(CCC(CO)C(C(O1)=O)O)=O,,,5,1,2,0,2
88661_0,,,,2,1,2,3
C(C1(CCC(OCC1O)=O)O)=O,,,5,1,1,0,1
88663_0,,,,2,1,2,3
C1(CCC(C(C(C=O)O1)O)O)=O,,,5,1,1,0,1
88665_0,,,,2,1,2,3
C1(CCC(C(CO1)=O)O)=O,,,5,1,1,0,1
88667_0,,,,2,1,2,3
C1(CCC(C(C(CO)O1)=O)O)=O,,,5,1,1,0,1
88669_0,,,,2,1,2,3
C1(CCC(C(CO1)=O)(CO)O)=O,,,5,1,1,0,1
88671_0,,,,2,1,2,3
C1(CCC(C(CO1)O)O)=O,,,5,1,1,0,1
88673_0,,,,2,1,2,3
C1(CCC(CO)(C(CO1)O)O)=O,,,5,1,1,0,1
88675_0,,,,2,1,2,3
C1(CCC(C(C(CO)O1)O)O)=O,,,5,1,1,0,1
88676_0,,,,2,1,2,3
88677_0,,,,2,1,2,3
88679_0,,,,2,1,2,3
C(C1C(COC(CC1)=O)=O)=O,,,5,1,1,0,1
88681_0,,,,2,1,2,3
C(C1C(CCCC(O1)=O)=O)=O,,,5,1,1,0,1
88683_0,,,,2,1,2,3
C1(CCC2(C(C(CO2)O1)O)O)=O,,,5,1,1,0,1
88685_0,,,,2,1,2,3
C1(CCC2C(C(C(O)O2)O1)O)=O,,,5,1,1,0,1
88687_0,,,,2,1,2,3
C1(CCC2(COC(C2O)O1)O)=O,,,5,1,1,0,1
88689_0,,,,2,1,2,3
C1(CCCC(C(O1)=O)O)=O,,,5,1,1,0,1
88691_0,,,,2,1,2,3
C(C1(CCC(OCC1)=O)O)(O)=O,,,5,1,1,0,1
88693_0,,,,2,1,2,3
C1(CCC(CC(C(O)=O)O1)O)=O,,,5,1,1,0,1
88694_0,,,,2,1,2,3
88696_0,,,,2,1,2,3
C1(CC(CO)C(C(CO1)=O)O)=O,,,5,1,1,0,1
88698_0,,,,2,1,2,3
C1(CC(CO)C(C(CO1)O)O)=O,,,5,1,1,0,1
88700_0,,,,2,1,2,3
C1(CC(CO)CC(C(O1)=O)O)=O,,,5,1,1,0,1
88702_0,,,,2,1,2,3
C1(C(COC(C(C1O)=O)=O)O)=O,,,5,1,1,0,1
88704_0,,,,2,1,2,3
[C]1(C(OCC(C(C1)O)O)=O)O,,,5,1,1,0,1
88705_0,,,,2,1,1,2
88706_0,,,,2,1,1,2
88707_0,,,,2,1,1,2
88708_0,,,,2,1,1,2
88709_0,,,,2,1,1,2
88710_0,,,,2,1,1,2
88711_0,,,,2,1,1,2
88712_0,,,,2,1,1,2
88713_0,,,,2,1,1,2
88714_0,,,,2,1,1,2
88715_0,,,,2,1,1,2
88716_0,,,,2,1,1,2
88717_0,,,,2,1,1,2
88718_0,,,,2,1,1,2
88719_0,,,,2,1,1,2
88720_0,,,,2,1,1,2
88721_0,,,,2,1,1,2
88722_0,,,,2,1,1,2
88723_0,,,,2,1,1,2
88724_0,,,,2,1,1,2
88725_0,,,,2,1,1,2
88726_0,,,,2,1,1,2
88727_0,,,,2,1,1,2
88728_0,,,,2,1,1,2
88729_0,,,,2,1,1,2
88730_0,,,,2,1,1,2
88731_0,,,,2,1,1,2
88732_0,,,,2,1,1,2
88733_0,,,,2,1,1,2
88734_0,,,,2,1,1,2
88735_0,,,,2,1,1,2
88736_0,,,,2,1,1,2
88737_0,,,,2,1,1,2
88738_0,,,,2,1,1,2
88739_0,,,,2,1,1,2
88740_0,,,,2,1,1,2
88741_0,,,,2,1,1,2
88742_0,,,,2,1,1,2
88743_0,,,,2,1,1,2
88744_0,,,,2,1,1,2
88745_0,,,,2,1,1,2
88746_0,,,,2,1,1,2
88747_0,,,,2,1,1,2
88748_0,,,,2,1,1,2
88749_0,,,,2,1,1,2
88750_0,,,,2,1,1,2
88751_0,,,,2,1,1,2
88752_0,,,,2,1,1,2
88753_0,,,,2,1,1,2
88754_0,,,,2,1,1,2
88755_0,,,,2,1,1,2
88756_0,,,,2,1,1,2
88757_0,,,,2,1,1,2
88758_0,,,,2,1,1,2
88759_0,,,,2,1,1,2
88760_0,,,,2,1,1,2
88761_0,,,,2,1,1,2
88762_0,,,,2,1,1,2
88763_0,,,,2,1,1,2
88764_0,,,,2,1,1,2
88765_0,,,,2,1,1,2
88766_0,,,,2,1,1,2
88767_0,,,,2,1,1,2
88768_0,,,,2,1,1,2
88769_0,,,,2,1,1,2
88770_0,,,,2,1,1,2
88771_0,,,,2,1,1,2
88772_0,,,,2,1,1,2
88773_0,,,,2,1,1,2
88774_0,,,,2,1,1,2
88775_0,,,,2,1,1,2
88776_0,,,,2,1,1,2
88777_0,,,,2,1,1,2
88778_0,,,,2,1,1,2
88779_0,,,,2,1,1,2
88780_0,,,,2,1,1,2
88781_0,,,,2,1,1,2
88782_0,,,,2,1,1,2
88783_0,,,,2,1,1,2
88784_0,,,,2,1,1,2
88785_0,,,,2,1,1,2
88786_0,,,,2,1,1,2
88787_0,,,,2,1,1,2
88788_0,,,,2,1,1,2
88789_0,,,,2,1,1,2
88790_0,,,,2,1,1,2
88791_0,,,,2,1,1,2
88792_0,,,,2,1,1,2
88793_0,,,,2,1,1,2
88794_0,,,,2,1,1,2
88795_0,,,,2,1,1,2
88796_0,,,,2,1,1,2
88797_0,,,,2,1,1,2
88798_0,,,,2,1,1,2
88799_0,,,,2,1,1,2
88800_0,,,,2,1,1,2
88801_0,,,,2,1,1,2
88802_0,,,,2,1,1,2
88803_0,,,,2,1,1,2
88804_0,,,,2,1,1,2
88805_0,,,,2,1,1,2
88806_0,,,,2,1,1,2
88807_0,,,,2,1,1,2
88808_0,,,,2,1,1,2
88809_0,,,,2,1,1,2
88810_0,,,,2,1,1,2
88811_0,,,,2,1,1,2
88812_0,,,,2,1,1,2
88813_0,,,,2,1,1,2
88814_0,,,,2,1,1,2
88815_0,,,,2,1,1,2
88816_0,,,,2,1,1,2
88817_0,,,,2,1,1,2
88819_0,,,,2,1,1,2
C(CC1C(C(C(C1O)O)O)O)=O,,,5,1,1,0,1
88821_0,,,,2,1,1,2
C(C1CC(C(C1O)=O)O)=O,,,5,1,1,0,1
88823_0,,,,2,1,1,2
C(C1C(CO)C(C(C1O)=O)O)=O,,,5,1,1,0,1
88824_0,,,,2,1,1,2
88826_0,,,,2,1,1,2
C(C1CC(C(C1O)=O)(CO)O)=O,,,5,1,1,0,1
88827_0,,,,2,1,1,2
88829_0,,,,2,1,1,2
C1(C(CC(C=O)C1C=O)O)=O,,,5,1,1,0,1
88831_0,,,,2,1,1,2
C(C1CC(C=O)C(C1O)=O)=O,,,5,1,1,0,1
88833_0,,,,2,1,1,2
C(C1CC(C=O)(C(C1)=O)O)=O,,,5,1,1,0,1
88834_0,,,,2,1,1,2
88835_0,,,,2,1,1,2
88836_0,,,,2,1,1,2
88837_0,,,,2,1,1,2
88838_0,,,,2,1,1,2
88839_0,,,,2,1,1,2
88840_0,,,,2,1,1,2
88841_0,,,,2,1,1,2
88842_0,,,,2,1,1,2
88843_0,,,,2,1,1,2
88844_0,,,,2,1,1,2
88845_0,,,,2,1,1,2
88847_0,,,,2,1,1,2
C(C1CC(C(C1(CO)O)=O)O)=O,,,5,1,1,0,1
88849_0,,,,2,1,1,2
C1(CCC(C=O)C1(C=O)O)=O,,,5,1,1,0,1
88851_0,,,,2,1,1,2
C(C1CC(C(C1(C=O)O)O)O)=O,,,5,1,1,0,1
88853_0,,,,2,1,1,2
C(C1CC(CC1(C(O)=O)O)O)=O,,,5,1,1,0,1
88855_0,,,,2,1,1,2
C(C1CCC(C1O)=O)(O)=O,,,5,1,1,0,1
88857_0,,,,2,1,1,2
C(C1C(CO)CC(C1O)=O)(O)=O,,,5,1,1,0,1
88859_0,,,,2,1,1,2
C(C1CC(CC1(C=O)O)O)(O)=O,,,5,1,1,0,1
88861_0,,,,2,1,1,2
C(C1CC(CC(C1O)=O)O)(O)=O,,,5,1,1,0,1
88863_0,,,,2,1,1,2
C(C1CC(C(C1O)=O)CO)(O)=O,,,5,1,1,0,1
88865_0,,,,2,1,1,2
C(C1CC(C=O)C(C1O)O)(O)=O,,,5,1,1,0,1
88867_0,,,,2,1,1,2
C(C1CC(C=O)(CC1O)O)(O)=O,,,5,1,1,0,1
88869_0,,,,2,1,1,2
C(C1C(CC(C(C1)O)=O)O)(O)=O,,,5,1,1,0,1
88871_0,,,,2,1,1,2
C(C1CCC(C(C1O)O)=O)(O)=O,,,5,1,1,0,1
88873_0,,,,2,1,1,2
C(C1CC(C(C1O)=O)O)(O)=O,,,5,1,1,0,1
88875_0,,,,2,1,1,2
C(C1CC(C(C1O)O)O)(O)=O,,,5,1,1,0,1
88876_0,,,,2,1,1,2
88877_0,,,,2,1,1,2
88879_0,,,,2,1,1,2
C(C1C(C(C(C1)=O)O)O)(O)=O,,,5,1,1,0,1
88881_0,,,,2,2,1,3
C(CC(C)C1(CC(C(C1)=O)O)O)=O,,,5,1,1,0,1
88883_0,,,,2,2,1,3
C(CCC1(CC(C(C1)=O)O)O)=O,,,5,1,1,0,1
88885_0,,,,2,2,1,3
C(CCC1(CC(C(C1)=O)O)O)(O)=O,,,5,1,1,0,1
88887_0,,,,2,2,1,3
C(CC(C)C1C(CC(C1O)=O)O)=O,,,5,1,1,0,1
88889_0,,,,2,2,1,3
C(CCC1C(CC(C1O)=O)O)=O,,,5,1,1,0,1
88890_0,,,,2,2,1,3
88892_0,,,,2,2,1,3
C1(CC(CC1(C(C)CC=O)O)O)=O,,,5,1,1,0,1
88894_0,,,,2,2,1,3
C1(CC(CC1(CCC=O)O)O)=O,,,5,1,1,0,1
88895_0,,,,2,2,1,3
88897_0,,,,2,2,1,3
C(CC(C)C1C(C(CC1O)O)=O)=O,,,5,1,1,0,1
88899_0,,,,2,2,1,3
C(CCC1C(C(CC1O)O)=O)=O,,,5,1,1,0,1
88900_0,,,,2,2,1,3
88902_0,,,,2,2,1,3
C(CCC1(C(CC(C1O)=O)O)O)=O,,,5,1,1,0,1
88904_0,,,,2,2,1,3
C(CCC1(C(C(C(C1)=O)O)O)O)=O,,,5,1,1,0,1
88906_0,,,,2,2,1,3
C1(CC(C(C1(CCC=O)O)O)O)=O,,,5,1,1,0,1
88908_0,,,,2,2,1,3
C(CCC1C(C(C(C1O)O)O)=O)=O,,,5,1,1,0,1
88910_0,,,,2,2,1,3
C(CCC1(C(C(C(C1)O)O)=O)O)=O,,,5,1,1,0,1
88912_0,,,,2,2,1,3
C(CCC1(C(C(CC1O)O)=O)O)=O,,,5,1,1,0,1
88914_0,,,,2,2,1,3
C(CCC1(CC(C(C1O)=O)O)O)=O,,,5,1,1,0,1
88916_0,,,,2,2,1,3
C(CCC1C(C(C(C1O)=O)O)O)=O,,,5,1,1,0,1
88918_0,,,,2,2,1,3
C(C(CCC=O)C(CC(C)O)O)=O,,,5,1,1,0,1
88920_0,,,,2,2,1,3
C(CC(CCC=O)(CC(C)O)O)=O,,,5,1,1,0,1
88922_0,,,,2,2,1,3
C(CCC(C(CC=O)O)C(C)O)=O,,,5,1,1,0,1
88924_0,,,,2,2,1,3
C(CCC(C)(CC(CC=O)O)O)=O,,,5,1,1,0,1
88926_0,,,,2,2,1,3
C(CC(CC(CCCC=O)O)O)=O,,,5,1,1,0,1
88928_0,,,,2,2,1,3
C(C(C=O)(CCC=O)C(C)O)(O)=O,,,5,1,1,0,1
88930_0,,,,2,2,1,3
C(C(C=O)C(C)(CCC=O)O)(O)=O,,,5,1,1,0,1
88932_0,,,,2,2,1,3
C(C(C=O)C(CCCC=O)O)(O)=O,,,5,1,1,0,1
88934_0,,,,2,2,1,3
C(C(C(C)O)C(C)(CCC=O)O)=O,,,5,1,1,0,1
88936_0,,,,2,2,1,3
C(C(C(C)O)C(CCCC=O)O)=O,,,5,1,1,0,1
88938_0,,,,2,2,1,3
C(C(CCC=O)(C(C)O)C(C)O)=O,,,5,1,1,0,1
88940_0,,,,2,2,1,3
C(C(C(C)O)C(C(C)CC=O)O)=O,,,5,1,1,0,1
88941_0,,,,2,2,1,3
88942_0,,,,2,2,1,3
88944_0,,,,2,2,1,3
C(C(CO)(C(C)CC=O)C(C)O)=O,,,5,1,1,0,1
88946_0,,,,2,2,1,3
C(C(CCC=O)(CO)C(C)O)=O,,,5,1,1,0,1
88947_0,,,,2,2,1,3
88949_0,,,,2,2,1,3
C(C(CO)C(C)(C(C)CC=O)O)=O,,,5,1,1,0,1
88951_0,,,,2,2,1,3
C(C(CO)C(C)(CCC=O)O)=O,,,5,1,1,0,1
88952_0,,,,2,2,1,3
88954_0,,,,2,2,1,3
C(C(CO)C(CC(C)CC=O)O)=O,,,5,1,1,0,1
88956_0,,,,2,2,1,3
C(C(CO)C(CCCC=O)O)=O,,,5,1,1,0,1
88957_0,,,,2,2,1,3
88959_0,,,,2,2,1,3
C(C(C(C)CC=O)C(CCO)O)=O,,,5,1,1,0,1
88961_0,,,,2,2,1,3
C(C(CCC=O)C(CCO)O)=O,,,5,1,1,0,1
88962_0,,,,2,2,1,3
88964_0,,,,2,2,1,3
C(CC(C)C(CC(CC=O)O)O)=O,,,5,1,1,0,1
88966_0,,,,2,2,1,3
C(CCC(CC(CC=O)O)O)=O,,,5,1,1,0,1
88967_0,,,,2,2,1,3
88969_0,,,,2,2,1,3
C(CC(C)C(CCO)(CC=O)O)=O,,,5,1,1,0,1
88971_0,,,,2,2,1,3
C(CCC(CCO)(CC=O)O)=O,,,5,1,1,0,1
88972_0,,,,2,2,1,3
88974_0,,,,2,2,1,3
C(CC(C(CO)C(C)CC=O)O)=O,,,5,1,1,0,1
88976_0,,,,2,2,1,3
C(CC(C(CCC=O)CO)O)=O,,,5,1,1,0,1
88977_0,,,,2,2,1,3
88979_0,,,,2,2,1,3
C(C(CCC=O)(C(CCO)O)O)=O,,,5,1,1,0,1
88981_0,,,,2,2,1,3
C(CCC(CC(C(C=O)O)O)O)=O,,,5,1,1,0,1
88983_0,,,,2,2,1,3
C(CCC(CCO)(C(C=O)O)O)=O,,,5,1,1,0,1
88985_0,,,,2,2,1,3
C(CCC(CO)C(C(C=O)O)O)=O,,,5,1,1,0,1
88986_0,,,,2,2,1,3
88987_0,,,,2,2,1,3
88989_0,,,,2,2,1,3
C(C(C=O)C(C(C)CC=O)O)(O)=O,,,5,1,1,0,1
88990_0,,,,2,2,1,3
88991_0,,,,2,2,1,3
88993_0,,,,2,2,1,3
C(C(C=O)(CO)C(C)CC=O)(O)=O,,,5,1,1,0,1
88995_0,,,,2,2,1,3
C(C(C=O)(CCC=O)CO)(O)=O,,,5,1,1,0,1
88996_0,,,,2,2,1,3
88997_0,,,,2,2,1,3
88998_0,,,,2,2,1,3
88999_0,,,,2,2,1,3
89001_0,,,,2,2,1,3
C(C(CO)C(C(C)CC=O)O)=O,,,5,1,1,0,1
89002_0,,,,2,2,1,3
89004_0,,,,2,2,1,3
C(C(CO)C(C1COC(C1)=O)O)=O,,,5,1,1,0,1
89005_0,,,,2,2,1,3
89006_0,,,,2,2,1,3
89007_0,,,,2,2,1,3
89009_0,,,,2,2,1,3
C(C(CO)(CO)CCC(CO)=O)=O,,,5,1,1,0,1
89011_0,,,,2,2,1,3
C(C(CO)(CO)C(CO)CC=O)=O,,,5,1,1,0,1
89013_0,,,,2,2,1,3
C(C(C=O)CC(C=O)(CO)CO)=O,,,5,1,1,0,1
89015_0,,,,2,2,1,3
C(C(CO)(CO)C(C)CC=O)=O,,,5,1,1,0,1
89017_0,,,,2,2,1,3
C(C(CCC=O)(CO)CO)=O,,,5,1,1,0,1
89019_0,,,,2,2,1,3
C(C(CO)(CO)C1COC(C1)=O)=O,,,5,1,1,0,1
89020_0,,,,2,2,1,3
89021_0,,,,2,2,1,3
89022_0,,,,2,2,1,3
89024_0,,,,2,2,1,3
C(C(CO)C(C(CCC=O)O)O)=O,,,5,1,1,0,1
89025_0,,,,2,2,1,3
89026_0,,,,2,2,1,3
89028_0,,,,2,2,1,3
C(C(CCC=O)(CO)C(CO)O)=O,,,5,1,1,0,1
89029_0,,,,2,2,1,3
89031_0,,,,2,2,1,3
C(CCC(C(C(C)=O)=O)(CO)O)=O,,,5,1,1,0,1
89033_0,,,,2,2,1,3
C(CCCC(C(C(CO)O)=O)=O)=O,,,5,1,1,0,1
89034_0,,,,2,2,1,3
89036_0,,,,2,2,1,3
C(CCC(C(C(CCO)=O)=O)O)=O,,,5,1,1,0,1
89038_0,,,,2,2,1,3
C(CCC(C(C(CO)=O)=O)CO)=O,,,5,1,1,0,1
89040_0,,,,2,2,1,3
C(C(C(C)CC=O)C(C)(CO)O)=O,,,5,1,1,0,1
89042_0,,,,2,2,1,3
C(C(CCC=O)C(C)(CO)O)=O,,,5,1,1,0,1
89043_0,,,,2,2,1,3
89045_0,,,,2,2,1,3
C(CC(C)(C(C(C)CC=O)O)O)=O,,,5,1,1,0,1
89047_0,,,,2,2,1,3
C(CC(C)(C(CCC=O)O)O)=O,,,5,1,1,0,1
89048_0,,,,2,2,1,3
89050_0,,,,2,2,1,3
C(CC(C)CC(CO)(CC=O)O)=O,,,5,1,1,0,1
89052_0,,,,2,2,1,3
C(CCCC(CO)(CC=O)O)=O,,,5,1,1,0,1
89053_0,,,,2,2,1,3
89055_0,,,,2,2,1,3
C(C(CCC=O)(C(CO)(C)O)O)=O,,,5,1,1,0,1
89057_0,,,,2,2,1,3
C(CCC(C(C)(C(C=O)O)O)O)=O,,,5,1,1,0,1
89059_0,,,,2,2,1,3
C(CCCC(CO)(C(C=O)O)O)=O,,,5,1,1,0,1
89060_0,,,,2,2,1,3
89061_0,,,,2,2,1,3
89063_0,,,,2,2,1,3
C(CC(C)C(C)(C(C(C)=O)O)O)=O,,,5,1,1,0,1
89065_0,,,,2,2,1,3
C(CCC(C)(C(C(C)=O)O)O)=O,,,5,1,1,0,1
89067_0,,,,2,2,1,3
C(CCC(C)(C(C(C)=O)O)O)(O)=O,,,5,1,1,0,1
89069_0,,,,2,2,1,3
C(CC(C)CC(C(C(C)=O)O)O)=O,,,5,1,1,0,1
89071_0,,,,2,2,1,3
C(CCCC(C(C(C)=O)O)O)=O,,,5,1,1,0,1
89072_0,,,,2,2,1,3
89074_0,,,,2,2,1,3
C(CC(C)C(C(C)=O)(C(C)O)O)=O,,,5,1,1,0,1
89076_0,,,,2,2,1,3
C(CCC(C(C)=O)(C(C)O)O)=O,,,5,1,1,0,1
89077_0,,,,2,2,1,3
89079_0,,,,2,2,1,3
C(CC(C)CC(C(C(C)O)O)=O)=O,,,5,1,1,0,1
89081_0,,,,2,2,1,3
C(CCCC(C(C(C)O)O)=O)=O,,,5,1,1,0,1
89082_0,,,,2,2,1,3
89084_0,,,,2,2,1,3
C(CCC(C(C(C(C)=O)O)O)O)=O,,,5,1,1,0,1
89085_0,,,,2,2,1,3
89087_0,,,,2,2,1,3
C(CCC(C(C)=O)(C(CO)O)O)=O,,,5,1,1,0,1
89089_0,,,,2,2,1,3
C(CCCC(C(C(CO)O)O)=O)=O,,,5,1,1,0,1
89090_0,,,,2,2,1,3
89091_0,,,,2,2,1,3
89093_0,,,,2,2,1,3
C(CC(C)C(C)(CC(CO)=O)O)=O,,,5,1,1,0,1
89095_0,,,,2,2,1,3
C(CCC(C)(CC(CO)=O)O)=O,,,5,1,1,0,1
89096_0,,,,2,2,1,3
89098_0,,,,2,2,1,3
C(CC(C)CC(CC(CO)=O)O)=O,,,5,1,1,0,1
89100_0,,,,2,2,1,3
C(CCCC(CC(CO)=O)O)=O,,,5,1,1,0,1
89101_0,,,,2,2,1,3
89103_0,,,,2,2,1,3
C(CC(C)C(C(CC(C)O)=O)O)=O,,,5,1,1,0,1
89105_0,,,,2,2,1,3
C(CCC(C(CC(C)O)=O)O)=O,,,5,1,1,0,1
89106_0,,,,2,2,1,3
89108_0,,,,2,2,1,3
C(CC(C)C(C(CO)=O)C(C)O)=O,,,5,1,1,0,1
89110_0,,,,2,2,1,3
C(CCC(C(CO)=O)C(C)O)=O,,,5,1,1,0,1
89111_0,,,,2,2,1,3
89113_0,,,,2,2,1,3
C(CCC(C(CC(CO)=O)O)O)=O,,,5,1,1,0,1
89114_0,,,,2,2,1,3
89116_0,,,,2,2,1,3
C(CCC(C(CC(CO)O)=O)O)=O,,,5,1,1,0,1
89118_0,,,,2,2,1,3
C(CCC(C(CO)=O)C(CO)O)=O,,,5,1,1,0,1
89119_0,,,,2,2,1,3
89121_0,,,,2,2,1,3
C(CCO)(C(CO)(CCC=O)O)=O,,,5,1,1,0,1
89122_0,,,,2,2,1,3
89124_0,,,,2,2,1,3
C(CCC(C(C(CO)O)=O)CO)=O,,,5,1,1,0,1
89125_0,,,,2,2,1,3
89127_0,,,,2,2,1,3
C(CCC(C(C(CO)CO)=O)O)=O,,,5,1,1,0,1
89129_0,,,,2,2,1,3
C(CCC(C(CO)=O)(CO)CO)=O,,,5,1,1,0,1
89131_0,,,,2,2,1,3
C(CCC(C=O)C(C(O)=O)(C)O)=O,,,5,1,2,0,2
89133_0,,,,2,2,1,3
C(C(CCCC=O)(CC=O)O)(O)=O,,,5,1,1,0,1
89135_0,,,,2,2,1,3
C(CCC(C(O)=O)C(C(O)=O)=O)=O,,,5,1,1,0,1
89137_0,,,,2,2,1,3
C(CCC(C)(CC(C(O)=O)=O)O)=O,,,5,1,1,0,1
89139_0,,,,2,2,1,3
C(CCCC(CC(C(O)=O)=O)O)=O,,,5,1,1,0,1
89141_0,,,,2,2,1,3
C(CCC(C(C(O)=O)=O)C(C)O)=O,,,5,1,1,0,1
89143_0,,,,2,2,1,3
C(C(CCC=O)C(CC(O)=O)O)=O,,,5,1,1,0,1
89145_0,,,,2,2,1,3
C(C(CCC=O)C(CC=O)O)(O)=O,,,5,1,2,0,2
89147_0,,,,2,2,1,3
C(CC(CCC=O)(CC=O)O)(O)=O,,,5,1,1,0,1
89148_0,,,,2,2,1,3
89150_0,,,,2,2,1,3
C(CCC1(C(C(CO1)O)=O)CO)=O,,,5,1,1,0,1
89152_0,,,,2,2,1,3
C(CCC1C(C(C(CO)O1)=O)O)=O,,,5,1,1,0,1
89154_0,,,,2,2,1,3
C(CCC1(C(C(CO)OC1)=O)O)=O,,,5,1,1,0,1
89155_0,,,,2,2,1,3
89157_0,,,,2,2,1,3
C(CCC1(C(C(CO)CO1)=O)O)=O,,,5,1,1,0,1
89159_0,,,,2,2,1,3
C(CCC1C(C(C(O)O1)=O)CO)=O,,,5,1,1,0,1
89161_0,,,,2,2,1,3
C(CCC1(C(C(O)OC1)=O)CO)=O,,,5,1,1,0,1
89162_0,,,,2,2,1,3
89164_0,,,,2,2,1,3
C(CCC1(C(COC1O)=O)CO)=O,,,5,1,1,0,1
89166_0,,,,2,2,1,3
C(CCC1(C(C(CO1)=O)CO)O)=O,,,5,1,1,0,1
89168_0,,,,2,2,1,3
C(CCC1C(C(CO)C(O1)O)=O)=O,,,5,1,1,0,1
89169_0,,,,2,2,1,3
89171_0,,,,2,2,1,3
C(CCC1C(C(CO)OC1O)=O)=O,,,5,1,1,0,1
89173_0,,,,2,2,1,3
C(CCC1(CC(C(CO)O1)=O)O)=O,,,5,1,1,0,1
89175_0,,,,2,2,1,3
C1(CC(OC1(CO)CCC=O)O)=O,,,5,1,1,0,1
89176_0,,,,2,2,1,3
89178_0,,,,2,2,1,3
C(CCC(C(C(C=O)=O)=O)CO)=O,,,5,1,1,0,1
89180_0,,,,2,2,1,3
C(CC(C)C(C=O)C(C=O)(C=C)O)=O,,,5,1,1,0,1
89182_0,,,,2,2,1,3
C(CCC(C=O)C(C=O)(C=C)O)=O,,,5,1,1,0,1
89183_0,,,,2,2,1,3
89184_0,,,,2,2,1,3
89186_0,,,,2,2,1,3
C(CC(C)C(C=O)C(C(C=C)=O)O)=O,,,5,1,1,0,1
89188_0,,,,2,2,1,3
C(CCC(C=O)C(C(C=C)=O)O)=O,,,5,1,1,0,1
89190_0,,,,2,2,1,3
C(CC(C)C(C(C=C)=O)(CC=O)O)=O,,,5,1,1,0,1
89192_0,,,,2,2,1,3
C(CCC(C(C=C)=O)(CC=O)O)=O,,,5,1,1,0,1
89194_0,,,,2,2,1,3
C(CC(C(CCCC=CC=O)=O)O)=O,,,5,1,1,0,1
89196_0,,,,2,2,1,3
C(CC(C(CCC(C=O)C=C)=O)O)=O,,,5,1,1,0,1
89198_0,,,,2,2,1,3
C(CC(C(CCC(C=C)O)=O)O)=O,,,5,1,1,0,1
89199_0,,,,2,2,1,3
89200_0,,,,2,2,1,3
89201_0,,,,2,2,1,3
89202_0,,,,2,2,1,3
89203_0,,,,2,2,1,3
89204_0,,,,2,2,1,3
89205_0,,,,2,2,1,3
89206_0,,,,2,2,1,3
89207_0,,,,2,2,1,3
89208_0,,,,2,2,1,3
89209_0,,,,2,2,1,3
89210_0,,,,2,2,1,3
89211_0,,,,2,2,1,3
89213_0,,,,2,2,1,3
C(CC(C)C(C=O)C(C=CC=O)O)=O,,,5,1,1,0,1
89215_0,,,,2,2,1,3
C(CCC(C=O)C(C=CC=O)O)=O,,,5,1,1,0,1
89217_0,,,,2,2,1,3
C(CC(C)C(C=CC=O)(CC=O)O)=O,,,5,1,1,0,1
89219_0,,,,2,2,1,3
C(CCC(C=CC=O)(CC=O)O)=O,,,5,1,1,0,1
89221_0,,,,2,2,1,3
C(CC(C(CC=O)O)CC=CC=O)=O,,,5,1,1,0,1
89223_0,,,,2,2,1,3
C(C(C=C)C(C(CC=O)O)CC=O)=O,,,5,1,1,0,1
89225_0,,,,2,2,1,3
C(CC(C(C(C=C)O)CC=O)O)=O,,,5,1,1,0,1
89226_0,,,,2,2,1,3
89227_0,,,,2,2,1,3
89228_0,,,,2,2,1,3
89229_0,,,,2,2,1,3
89230_0,,,,2,2,1,3
89231_0,,,,2,2,1,3
89232_0,,,,2,2,1,3
89233_0,,,,2,2,1,3
89234_0,,,,2,2,1,3
89235_0,,,,2,2,1,3
89236_0,,,,2,2,1,3
89237_0,,,,2,2,1,3
89238_0,,,,2,2,1,3
89240_0,,,,2,2,1,3
C(C(C=O)CC(C(O)=O)(C=O)O)=O,,,5,1,1,0,1
89242_0,,,,2,2,1,3
C(C(C=O)(C(C)CC=O)O)(O)=O,,,5,1,1,0,1
89243_0,,,,2,2,1,3
89245_0,,,,2,2,1,3
C(C(C=O)(C1COC(C1)=O)O)(O)=O,,,5,1,1,0,1
89246_0,,,,2,2,1,3
89247_0,,,,2,2,1,3
89248_0,,,,2,2,1,3
89250_0,,,,2,2,1,3
C(C(C(C)CC=O)C(C(O)O)O)=O,,,5,1,1,0,1
89252_0,,,,2,2,1,3
C(C(CCC=O)C(C(O)O)O)=O,,,5,1,1,0,1
89253_0,,,,2,2,1,3
89255_0,,,,2,2,1,3
C(CC(C(C(C)CC=O)(O)O)O)=O,,,5,1,1,0,1
89257_0,,,,2,2,1,3
C(CCC(C(CC=O)O)(O)O)=O,,,5,1,1,0,1
89258_0,,,,2,2,1,3
89260_0,,,,2,2,1,3
C(CC(C(O)O)(C(C)CC=O)O)=O,,,5,1,1,0,1
89262_0,,,,2,2,1,3
C(CCC(C(O)O)(CC=O)O)=O,,,5,1,1,0,1
89264_0,,,,2,2,1,3
C(CCC(C(O)O)(CC=O)O)(O)=O,,,5,1,1,0,1
89266_0,,,,2,2,1,3
C(C(CCC=O)(C(C(O)O)O)O)=O,,,5,1,1,0,1
89268_0,,,,2,2,1,3
C(CCC(C(C(C=O)O)O)(O)O)=O,,,5,1,1,0,1
89270_0,,,,2,2,1,3
C(CCC(C(O)O)(C(C=O)O)O)=O,,,5,1,1,0,1
89272_0,,,,2,2,1,3
C(C(C(C)CC=O)C(C(C)O)O)=O,,,5,1,1,0,1
89274_0,,,,2,2,1,3
C(C(CCC=O)C(C(C)O)O)=O,,,5,1,1,0,1
89275_0,,,,2,2,1,3
89277_0,,,,2,2,1,3
C(CC(C(C)(C(C)CC=O)O)O)=O,,,5,1,1,0,1
89279_0,,,,2,2,1,3
C(CCC(C)(C(CC=O)O)O)=O,,,5,1,1,0,1
89280_0,,,,2,2,1,3
89282_0,,,,2,2,1,3
C(CC(C(C)CC=O)(C(C)O)O)=O,,,5,1,1,0,1
89284_0,,,,2,2,1,3
C(CC(CCC=O)(C(C)O)O)=O,,,5,1,1,0,1
89286_0,,,,2,2,1,3
C(CCC(C(C)O)(CC=O)O)(O)=O,,,5,1,1,0,1
89288_0,,,,2,2,1,3
C(CC(C)CC(C(CC=O)O)O)=O,,,5,1,1,0,1
89290_0,,,,2,2,1,3
C(CCCC(C(CC=O)O)O)=O,,,5,1,1,0,1
89291_0,,,,2,2,1,3
89293_0,,,,2,2,1,3
C(C(CCC=O)(C(C(C)O)O)O)=O,,,5,1,1,0,1
89295_0,,,,2,2,1,3
C(CCC(C)(C(C(C=O)O)O)O)=O,,,5,1,1,0,1
89297_0,,,,2,2,1,3
C(CCC(C(C)O)(C(C=O)O)O)=O,,,5,1,1,0,1
89299_0,,,,2,2,1,3
C(CCCC(C(C(C=O)O)O)O)=O,,,5,1,1,0,1
89301_0,,,,2,2,1,3
C(CCC(C)(CC(C(O)=O)O)O)=O,,,5,1,1,0,1
89303_0,,,,2,2,1,3
C(CCCC(CC(C(O)=O)O)O)=O,,,5,1,1,0,1
89305_0,,,,2,2,1,3
C(C(CCC=O)(CC(C)O)O)(O)=O,,,5,1,1,0,1
89307_0,,,,2,2,1,3
C(CCC(C(C)O)C(C(O)=O)O)=O,,,5,1,1,0,1
89309_0,,,,2,2,1,3
C(C(C=O)(CC(C)CC=O)O)(O)=O,,,5,1,1,0,1
89311_0,,,,2,2,1,3
C(C(C=O)(CCCC=O)O)(O)=O,,,5,1,1,0,1
89312_0,,,,2,2,1,3
89314_0,,,,2,2,1,3
C(CC(C)C(C(C=O)=O)C(C=O)=O)=O,,,5,1,1,0,1
89316_0,,,,2,2,1,3
C(CCC(C(C=O)=O)C(C=O)=O)=O,,,5,1,1,0,1
89318_0,,,,2,2,1,3
C(CC(C)C(C(C(C=O)=O)=O)O)=O,,,5,1,1,0,1
89319_0,,,,2,2,1,3
89321_0,,,,2,2,1,3
C(CCC(C(C(C=O)=O)=O)O)(O)=O,,,5,1,1,0,1
89323_0,,,,2,2,1,3
C(CC(C)C(C(C(CO)=O)=O)O)=O,,,5,1,1,0,1
89324_0,,,,2,2,1,3
89325_0,,,,2,2,1,3
89327_0,,,,2,2,1,3
C(CCC(C(C(CO)=O)=O)(C)O)=O,,,5,1,1,0,1
89329_0,,,,2,2,1,3
C(CCCC(C(C(CO)=O)=O)O)=O,,,5,1,1,0,1
89331_0,,,,2,2,1,3
C(CCC(C(C(C(C)O)=O)=O)O)=O,,,5,1,1,0,1
89333_0,,,,2,2,1,3
C(C(C(C=O)=O)(CCCC=O)O)=O,,,5,1,1,0,1
89335_0,,,,2,2,1,3
C(CCC(C(C)=O)(C(C=O)=O)O)=O,,,5,1,1,0,1
89337_0,,,,2,2,1,3
C(CCCC(C(C(C=O)=O)O)=O)=O,,,5,1,1,0,1
89339_0,,,,2,2,1,3
C(CCC(C=O)C(C(C=O)=O)O)=O,,,5,1,2,0,2
89340_0,,,,2,2,1,3
89342_0,,,,2,2,1,3
C(CC(C)CC(C(C(C)O)=O)=O)=O,,,5,1,1,0,1
89344_0,,,,2,2,1,3
C(CCCC(C(C(C)O)=O)=O)=O,,,5,1,1,0,1
89346_0,,,,2,2,1,3
C(CCCC(C(C(C)O)=O)=O)(O)=O,,,5,1,1,0,1
89348_0,,,,2,2,1,3
C(CC(C)C(C(C(C)=O)=O)(C)O)=O,,,5,1,1,0,1
89350_0,,,,2,2,1,3
C(CCC(C(C(C)=O)=O)(C)O)=O,,,5,1,1,0,1
89352_0,,,,2,2,1,3
C(CCC(C(C(C)=O)=O)(C)O)(O)=O,,,5,1,1,0,1
89354_0,,,,2,2,1,3
C(CC(C)CC(C(C(C)=O)=O)O)=O,,,5,1,1,0,1
89356_0,,,,2,2,1,3
C(CCCC(C(C(C)=O)=O)O)=O,,,5,1,1,0,1
89358_0,,,,2,2,1,3
C(CCCC(C(C(C)=O)=O)O)(O)=O,,,5,1,1,0,1
89360_0,,,,2,2,1,3
C(CCC(C=O)(C(C(C)=O)=O)O)=O,,,5,1,1,0,1
89362_0,,,,2,2,1,3
C(C(C(C(CCCC=O)=O)=O)O)=O,,,5,1,1,0,1
89364_0,,,,2,2,1,3
C(CCC(C(CO)=O)C(C=O)=O)=O,,,5,1,1,0,1
89366_0,,,,2,2,1,3
C(CCC(C(CC(C=O)=O)=O)O)=O,,,5,1,1,0,1
89368_0,,,,2,2,1,3
C(CCCC(C(C(CO)=O)O)=O)=O,,,5,1,1,0,1
89370_0,,,,2,2,1,3
C(CCC(C(C)=O)(C(CO)=O)O)=O,,,5,1,1,0,1
89372_0,,,,2,2,1,3
C(CCC(C(C(C(C)=O)O)=O)O)=O,,,5,1,1,0,1
89374_0,,,,2,2,1,3
C(C(C=O)(CCCC(CO)=O)O)=O,,,5,1,1,0,1
89376_0,,,,2,2,1,3
C(C(C=O)(CC(CO)CC=O)O)=O,,,5,1,1,0,1
89378_0,,,,2,2,1,3
C(C(C=O)CCC(C=O)(C=O)O)=O,,,5,1,1,0,1
89380_0,,,,2,2,1,3
C(C(C=O)(CC(C)CC=O)O)=O,,,5,1,1,0,1
89382_0,,,,2,2,1,3
C(C(C=O)(CCCC=O)O)=O,,,5,1,1,0,1
89384_0,,,,2,2,1,3
C(C(C=O)(CC1COC(C1)=O)O)=O,,,5,1,1,0,1
89386_0,,,,2,2,1,3
C(C(C=O)(CCCC(C=O)=O)O)=O,,,5,1,1,0,1
89388_0,,,,2,2,1,3
C(C(CC(C=O)(C=O)O)CC=O)=O,,,5,1,2,0,2
89390_0,,,,2,2,1,3
C(C(C=O)(CCCC(O)=O)O)=O,,,5,1,1,0,1
89392_0,,,,2,2,1,3
C(C(C=O)CCC(CC(C=O)=O)=O)=O,,,5,1,1,0,1
89394_0,,,,2,2,1,3
C(CC(C)CC(CC(C=O)=O)=O)=O,,,5,1,1,0,1
89396_0,,,,2,2,1,3
C(CCCC(CC(C=O)=O)=O)=O,,,5,1,1,0,1
89398_0,,,,2,2,1,3
C(CC1COC(C1)=O)(CC(C=O)=O)=O,,,5,1,1,0,1
89400_0,,,,2,2,1,3
C(CCCC(C=O)=O)(CC(C=O)=O)=O,,,5,1,1,0,1
89402_0,,,,2,2,1,3
C(CC(C=O)CC(CC(C=O)=O)=O)=O,,,5,1,1,0,1
89404_0,,,,2,2,1,3
C(CCCC(O)=O)(CC(C=O)=O)=O,,,5,1,1,0,1
89406_0,,,,2,2,1,3
C(C(C=O)CC(C(C)=O)C(C=O)=O)=O,,,5,1,1,0,1
89408_0,,,,2,2,1,3
C(CC(C)C(C(C)=O)C(C=O)=O)=O,,,5,1,1,0,1
89410_0,,,,2,2,1,3
C(CCC(C(C)=O)C(C=O)=O)=O,,,5,1,1,0,1
89412_0,,,,2,2,1,3
C(C)(C(C(C=O)=O)C1COC(C1)=O)=O,,,5,1,1,0,1
89414_0,,,,2,2,1,3
C(C)(C(C(C=O)=O)CCC(C=O)=O)=O,,,5,1,1,0,1
89416_0,,,,2,2,1,3
C(CC(C=O)C(C(C)=O)C(C=O)=O)=O,,,5,1,1,0,1
89418_0,,,,2,2,1,3
C(C)(C(C(C=O)=O)CCC(O)=O)=O,,,5,1,1,0,1
89420_0,,,,2,2,1,3
C(CCC(C(C(C=O)C=O)=O)O)=O,,,5,1,1,0,1
89422_0,,,,2,2,1,3
C(C(C(C(C=O)O)=O)CCC=O)=O,,,5,1,1,0,1
89424_0,,,,2,2,1,3
C(C(C(CC=O)=O)(CCC=O)O)=O,,,5,1,1,0,1
89426_0,,,,2,2,1,3
C(C(C=O)C(CCC(C=O)C=O)=O)=O,,,5,1,1,0,1
89428_0,,,,2,2,1,3
C(C(C=O)C(CC(C)CC=O)=O)=O,,,5,1,1,0,1
89430_0,,,,2,2,1,3
C(C(C=O)C(CCCC=O)=O)=O,,,5,1,1,0,1
89432_0,,,,2,2,1,3
C(C(C=O)C(CC1COC(C1)=O)=O)=O,,,5,1,1,0,1
89434_0,,,,2,2,1,3
C(C(C=O)C(CCCC(C=O)=O)=O)=O,,,5,1,1,0,1
89436_0,,,,2,2,1,3
C(C(C=O)C(CC(C=O)CC=O)=O)=O,,,5,1,1,0,1
89438_0,,,,2,2,1,3
C(C(C=O)C(CCCC(O)=O)=O)=O,,,5,1,1,0,1
89440_0,,,,2,2,1,3
C(C(C=O)(CC(CCC=O)O)O)=O,,,5,1,1,0,1
89442_0,,,,2,2,1,3
C(C(C=O)(C(CO)CCC=O)O)=O,,,5,1,1,0,1
89444_0,,,,2,2,1,3
C(CCC(C=O)(CC(C=O)O)O)=O,,,5,1,1,0,1
89446_0,,,,2,2,1,3
C(CCC(C(C=O)O)C(C=O)O)=O,,,5,1,1,0,1
89448_0,,,,2,2,1,3
C(C)(C(C=O)CCC(CO)=O)=O,,,5,1,1,0,1
89450_0,,,,2,2,1,3
C(CC(CO)C(C=O)C(C)=O)=O,,,5,1,1,0,1
89452_0,,,,2,2,1,3
C(C(C(C)=O)CCC(C(O)=O)=O)=O,,,5,1,1,0,1
89454_0,,,,2,2,1,3
C(C(C(C)=O)C(C(O)=O)CC=O)=O,,,5,1,1,0,1
89456_0,,,,2,2,1,3
C(C(C(C)=O)C(C=O)CC(O)=O)=O,,,5,1,1,0,1
89458_0,,,,2,2,1,3
C(C(C)C(C=O)C(C(C)=O)C=O)=O,,,5,1,1,0,1
89460_0,,,,2,2,1,3
C(C(C)(CC=O)C(C(C)=O)C=O)=O,,,5,1,1,0,1
89462_0,,,,2,2,1,3
C(C(CC(C(C)=O)C=O)CC=O)=O,,,5,1,1,0,1
89464_0,,,,2,2,1,3
C(C(C(C)=O)C(C=O)CC(C)=O)=O,,,5,1,1,0,1
89466_0,,,,2,2,1,3
C(C(C(C)=O)C(C(C)=O)CC=O)=O,,,5,1,1,0,1
89468_0,,,,2,2,1,3
C(C(C(C)=O)C(C)CC(C=O)=O)=O,,,5,1,1,0,1
89470_0,,,,2,2,1,3
C(C(C(C)=O)C(C=O)CC(C=O)=O)=O,,,5,1,1,0,1
89472_0,,,,2,2,1,3
C(C(C(C)=O)C(C(C=O)=O)CC=O)=O,,,5,1,1,0,1
89474_0,,,,2,2,1,3
C(CC(CC=O)C(C=O)C(C)=O)=O,,,5,1,1,0,1
89476_0,,,,2,2,1,3
C(C(C=O)C(C)C(C=O)C(C)=O)=O,,,5,1,1,0,1
89478_0,,,,2,2,1,3
C(C(C=O)C(C=O)C(C=O)C(C)=O)=O,,,5,1,1,0,1
89480_0,,,,2,2,1,3
C(C(C=O)(CC=O)C(C=O)C(C)=O)=O,,,5,1,1,0,1
89482_0,,,,2,2,1,3
C(C(C=O)CC(C=O)C(C)=O)=O,,,5,1,1,0,1
89484_0,,,,2,2,1,3
C(CC(C)C(C=O)C(C)=O)=O,,,5,1,1,0,1
89486_0,,,,2,2,1,3
C(CCC(C=O)C(C)=O)=O,,,5,1,1,0,1
89488_0,,,,2,2,1,3
C(C(CC(C=O)C(C)=O)CO)(O)=O,,,5,1,1,0,1
89490_0,,,,2,2,1,3
C(C(C(C=O)=O)CC(C=O)C(C)=O)=O,,,5,1,1,0,1
89492_0,,,,2,2,1,3
C(C(C(C)=O)C1COC(C1)=O)=O,,,5,1,1,0,1
89493_0,,,,2,2,1,3
89494_0,,,,2,2,1,3
89495_0,,,,2,2,1,3
89497_0,,,,2,2,1,3
C(CC(CO)C(C=O)C(C)=O)(O)=O,,,5,1,1,0,1
89499_0,,,,2,2,1,3
C(CCCC(CO)=O)(CC=O)=O,,,5,1,1,0,1
89501_0,,,,2,2,1,3
C(CC(CC(CO)CC=O)=O)=O,,,5,1,1,0,1
89503_0,,,,2,2,1,3
C(CC(CCCC(C(O)=O)=O)=O)=O,,,5,1,1,0,1
89505_0,,,,2,2,1,3
C(CC(CC(C(O)=O)CC=O)=O)=O,,,5,1,1,0,1
89507_0,,,,2,2,1,3
C(CC(CC(C=O)CC(O)=O)=O)=O,,,5,1,1,0,1
89509_0,,,,2,2,1,3
C(C(C)C(C=O)CC(CC=O)=O)=O,,,5,1,1,0,1
89511_0,,,,2,2,1,3
C(C(C)(CC(CC=O)=O)CC=O)=O,,,5,1,1,0,1
89513_0,,,,2,2,1,3
C(C(CCC(CC=O)=O)CC=O)=O,,,5,1,1,0,1
89515_0,,,,2,2,1,3
C(CC(CC(C=O)CC(C)=O)=O)=O,,,5,1,1,0,1
89517_0,,,,2,2,1,3
C(CC(CC(C(C)=O)CC=O)=O)=O,,,5,1,1,0,1
89519_0,,,,2,2,1,3
C(CC(CC(C)CC(C=O)=O)=O)=O,,,5,1,1,0,1
89521_0,,,,2,2,1,3
C(CC(CC(C=O)CC(C=O)=O)=O)=O,,,5,1,1,0,1
89523_0,,,,2,2,1,3
C(CC(CC(C(C=O)=O)CC=O)=O)=O,,,5,1,1,0,1
89525_0,,,,2,2,1,3
C(CC(CC(CC=O)CC=O)=O)=O,,,5,1,1,0,1
89527_0,,,,2,2,1,3
C(C(C=O)C(C)CC(CC=O)=O)=O,,,5,1,1,0,1
89529_0,,,,2,2,1,3
C(C(C=O)C(C=O)CC(CC=O)=O)=O,,,5,1,1,0,1
89531_0,,,,2,2,1,3
C(C(C=O)(CC(CC=O)=O)CC=O)=O,,,5,1,1,0,1
89533_0,,,,2,2,1,3
C(C(C=O)CCC(CC=O)=O)=O,,,5,1,1,0,1
89535_0,,,,2,2,1,3
C(CC(CC(C)CC=O)=O)=O,,,5,1,1,0,1
89537_0,,,,2,2,1,3
C(CC(CCCC=O)=O)=O,,,5,1,1,0,1
89539_0,,,,2,2,1,3
C(C(CCC(CC=O)=O)CO)(O)=O,,,5,1,1,0,1
89541_0,,,,2,2,1,3
C(C(C(C=O)=O)CCC(CC=O)=O)=O,,,5,1,1,0,1
89543_0,,,,2,2,1,3
C(CC(CC1COC(C1)=O)=O)=O,,,5,1,1,0,1
89544_0,,,,2,2,1,3
89545_0,,,,2,2,1,3
89546_0,,,,2,2,1,3
89548_0,,,,2,2,1,3
C(CC(CC(CO)CC(O)=O)=O)=O,,,5,1,1,0,1
89550_0,,,,2,2,1,3
C(C(C=O)(C(C(C)CC=O)O)O)=O,,,5,1,1,0,1
89551_0,,,,2,2,1,3
89553_0,,,,2,2,1,3
C(C(C=O)(C(CCC(O)=O)O)O)=O,,,5,1,1,0,1
89554_0,,,,2,2,1,3
89556_0,,,,2,2,1,3
C(CC(C)C(C(C(O)=O)=O)(C)O)=O,,,5,1,1,0,1
89558_0,,,,2,2,1,3
C(CCC(C(C(O)=O)=O)(C)O)=O,,,5,1,1,0,1
89559_0,,,,2,2,1,3
89561_0,,,,2,2,1,3
C(CC(C)CC(C(C(O)=O)=O)O)=O,,,5,1,1,0,1
89563_0,,,,2,2,1,3
C(CCCC(C(C(O)=O)=O)O)=O,,,5,1,1,0,1
89564_0,,,,2,2,1,3
89566_0,,,,2,2,1,3
C(CCC(C(C(C=O)(C)O)=O)O)=O,,,5,1,1,0,1
89568_0,,,,2,2,1,3
C(CCCC(C=O)(C(CO)=O)O)=O,,,5,1,1,0,1
89570_0,,,,2,2,1,3
C(C(C=O)(C(CCCC=O)=O)O)=O,,,5,1,1,0,1
89572_0,,,,2,2,1,3
C(C(CCC(CO)=O)O)(C(C)O)=O,,,5,1,1,0,1
89574_0,,,,2,2,1,3
C(CC(CO)C(C(C(C)O)=O)O)=O,,,5,1,1,0,1
89576_0,,,,2,2,1,3
C(C(C=O)CC(C(C(C)O)=O)O)=O,,,5,1,1,0,1
89578_0,,,,2,2,1,3
C(CC(C)C(C(C(C)O)=O)O)=O,,,5,1,1,0,1
89580_0,,,,2,2,1,3
C(CCC(C(C(C)O)=O)O)=O,,,5,1,1,0,1
89582_0,,,,2,2,1,3
C1(CC(CO1)C(C(C(C)O)=O)O)=O,,,5,1,1,0,1
89583_0,,,,2,2,1,3
89584_0,,,,2,2,1,3
89585_0,,,,2,2,1,3
89587_0,,,,2,2,1,3
C(CO)(C(C)(CCC(CO)=O)O)=O,,,5,1,1,0,1
89589_0,,,,2,2,1,3
C(CC(CO)C(C(CO)=O)(C)O)=O,,,5,1,1,0,1
89591_0,,,,2,2,1,3
C(C(C=O)CC(C(CO)=O)(C)O)=O,,,5,1,1,0,1
89593_0,,,,2,2,1,3
C(CC(C)C(C(CO)=O)(C)O)=O,,,5,1,1,0,1
89595_0,,,,2,2,1,3
C(CCC(C(CO)=O)(C)O)=O,,,5,1,1,0,1
89597_0,,,,2,2,1,3
C1(CC(CO1)C(C(CO)=O)(C)O)=O,,,5,1,1,0,1
89598_0,,,,2,2,1,3
89599_0,,,,2,2,1,3
89600_0,,,,2,2,1,3
89602_0,,,,2,2,1,3
C(CO)(CCCC(C(CO)=O)O)=O,,,5,1,1,0,1
89604_0,,,,2,2,1,3
C(CC(CO)CC(C(CO)=O)O)=O,,,5,1,1,0,1
89606_0,,,,2,2,1,3
C(C(C=O)CCC(C(CO)=O)O)=O,,,5,1,1,0,1
89608_0,,,,2,2,1,3
C(CC(C)CC(C(CO)=O)O)=O,,,5,1,1,0,1
89610_0,,,,2,2,1,3
C(CCCC(C(CO)=O)O)=O,,,5,1,1,0,1
89612_0,,,,2,2,1,3
C1(CC(CC(C(CO)=O)O)CO1)=O,,,5,1,1,0,1
89613_0,,,,2,2,1,3
89614_0,,,,2,2,1,3
89615_0,,,,2,2,1,3
89617_0,,,,2,2,1,3
C(CCC(C=O)C(C=O)(C=O)O)=O,,,5,1,1,0,1
89619_0,,,,2,2,1,3
C(CCCC(C(O)=O)(C(C)=O)O)=O,,,5,1,1,0,1
89621_0,,,,2,2,1,3
C(C(C(CCCC=O)=O)(C)O)(O)=O,,,5,1,1,0,1
89623_0,,,,2,2,1,3
C(CO)(CCCC(COC=O)=O)=O,,,5,1,1,0,1
89625_0,,,,2,2,1,3
C(CC(CO)CC(COC=O)=O)=O,,,5,1,1,0,1
89627_0,,,,2,2,1,3
C(C(C=O)CCC(COC=O)=O)=O,,,5,1,1,0,1
89629_0,,,,2,2,1,3
C(CC(C)CC(COC=O)=O)=O,,,5,1,1,0,1
89631_0,,,,2,2,1,3
C(CCCC(COC=O)=O)=O,,,5,1,1,0,1
89633_0,,,,2,2,1,3
C1(CC(CO1)CC(COC=O)=O)=O,,,5,1,1,0,1
89634_0,,,,2,2,1,3
89635_0,,,,2,2,1,3
89636_0,,,,2,2,1,3
89638_0,,,,2,2,1,3
C(C)(C(CCC(CO)=O)OC=O)=O,,,5,1,1,0,1
89640_0,,,,2,2,1,3
C(CC(CO)C(C(C)=O)OC=O)=O,,,5,1,1,0,1
89642_0,,,,2,2,1,3
C(C(C=O)CC(C(C)=O)OC=O)=O,,,5,1,1,0,1
89644_0,,,,2,2,1,3
C(CC(C)C(C(C)=O)OC=O)=O,,,5,1,1,0,1
89646_0,,,,2,2,1,3
C(CCC(C(C)=O)OC=O)=O,,,5,1,1,0,1
89648_0,,,,2,2,1,3
C1(CC(CO1)C(C(C)=O)OC=O)=O,,,5,1,1,0,1
89649_0,,,,2,2,1,3
89650_0,,,,2,2,1,3
89651_0,,,,2,2,1,3
89653_0,,,,2,2,1,3
C(CCC(C(C(CO)O)=O)(C)O)=O,,,5,1,1,0,1
89655_0,,,,2,2,1,3
C(CCCC(C(C(CO)O)=O)O)=O,,,5,1,1,0,1
89657_0,,,,2,2,1,3
C(CCC(C(C(C)O)=O)(CO)O)=O,,,5,1,1,0,1
89658_0,,,,2,2,1,3
89660_0,,,,2,2,1,3
C(CC(C)C(C=O)C(C(C)O)=O)=O,,,5,1,1,0,1
89662_0,,,,2,2,1,3
C(CCC(C=O)C(C(C)O)=O)=O,,,5,1,1,0,1
89663_0,,,,2,2,1,3
89665_0,,,,2,2,1,3
C(C(C)(C(C)CC=O)O)(CC=O)=O,,,5,1,1,0,1
89667_0,,,,2,2,1,3
C(C(C)(CCC=O)O)(CC=O)=O,,,5,1,1,0,1
89669_0,,,,2,2,1,3
C(C(C)(CCC(O)=O)O)(CC=O)=O,,,5,1,1,0,1
89671_0,,,,2,2,1,3
C(CC(C)CC(C(CC=O)=O)O)=O,,,5,1,1,0,1
89673_0,,,,2,2,1,3
C(CCCC(C(CC=O)=O)O)=O,,,5,1,1,0,1
89674_0,,,,2,2,1,3
89676_0,,,,2,2,1,3
C(CCC(C=O)(C(C(C)O)=O)O)=O,,,5,1,1,0,1
89678_0,,,,2,2,1,3
C(C(C)(CCC=O)O)(C(C=O)O)=O,,,5,1,1,0,1
89680_0,,,,2,2,1,3
C(CCCC(C(C(C=O)O)=O)O)=O,,,5,1,1,0,1
89682_0,,,,2,2,1,3
C(CCC(CC(C(C=O)=O)O)O)=O,,,5,1,1,0,1
89684_0,,,,2,2,1,3
C(CCC(CO)C(C(C=O)=O)O)=O,,,5,1,1,0,1
89686_0,,,,2,2,1,3
C(CCC(C(C=O)=O)(CCO)O)=O,,,5,1,1,0,1
89688_0,,,,2,2,1,3
C(CCC(C(CC(CO)=O)=O)O)=O,,,5,1,1,0,1
89690_0,,,,2,2,1,3
C(CCC(C(CO)=O)C(CO)=O)=O,,,5,1,1,0,1
89692_0,,,,2,2,1,3
C(CC(C)C1(C(COC1O)=O)O)=O,,,5,1,1,0,1
89694_0,,,,2,2,1,3
C(CCC1(C(COC1O)=O)O)=O,,,5,1,1,0,1
89695_0,,,,2,2,1,3
89697_0,,,,2,2,1,3
C(CC(C)C1(C(C(CO1)=O)O)O)=O,,,5,1,1,0,1
89698_0,,,,2,2,1,3
89699_0,,,,2,2,1,3
89701_0,,,,2,2,1,3
C(CC(C)C1C(C(C(O1)O)O)=O)=O,,,5,1,1,0,1
89703_0,,,,2,2,1,3
C(CCC1C(C(C(O1)O)O)=O)=O,,,5,1,1,0,1
89704_0,,,,2,2,1,3
89706_0,,,,2,2,1,3
C(CCC(C(C(C(O)=O)=O)=O)O)=O,,,5,1,1,0,1
89708_0,,,,2,2,1,3
C(CCC(CC(CO)(CO)O)O)=O,,,5,1,1,0,1
89710_0,,,,2,2,1,3
C(CCC(CO)C(CO)(CO)O)=O,,,5,1,1,0,1
89712_0,,,,2,2,1,3
C(CCC(C(CO)(CCO)O)O)=O,,,5,1,1,0,1
89714_0,,,,2,2,1,3
C(C(C)(CC(C(C)CC=O)O)O)=O,,,5,1,1,0,1
89716_0,,,,2,2,1,3
C(C(C)(CC(CCC=O)O)O)=O,,,5,1,1,0,1
89718_0,,,,2,2,1,3
C(C(C)(CC(CCC(O)=O)O)O)=O,,,5,1,1,0,1
89720_0,,,,2,2,1,3
C(C(C)(C(CO)C(C)CC=O)O)=O,,,5,1,1,0,1
89722_0,,,,2,2,1,3
C(C(C)(C(CO)CCC=O)O)=O,,,5,1,1,0,1
89723_0,,,,2,2,1,3
89725_0,,,,2,2,1,3
C(C(CCO)(CC(C)CC=O)O)=O,,,5,1,1,0,1
89727_0,,,,2,2,1,3
C(C(CCO)(CCCC=O)O)=O,,,5,1,1,0,1
89728_0,,,,2,2,1,3
89729_0,,,,2,2,1,3
89731_0,,,,2,2,1,3
C(C(C)(C(C(CCC=O)O)O)O)=O,,,5,1,1,0,1
89733_0,,,,2,2,1,3
C(C(C(CO)O)(CCCC=O)O)=O,,,5,1,1,0,1
89735_0,,,,2,2,1,3
C(CC(C)C(CC(C(C)=O)O)O)=O,,,5,1,1,0,1
89737_0,,,,2,2,1,3
C(CCC(CC(C(C)=O)O)O)=O,,,5,1,1,0,1
89739_0,,,,2,2,1,3
C(CCC(CC(C(C)=O)O)O)(O)=O,,,5,1,1,0,1
89741_0,,,,2,2,1,3
C(CC(C)C(CO)C(C(C)=O)O)=O,,,5,1,1,0,1
89743_0,,,,2,2,1,3
C(CCC(CO)C(C(C)=O)O)=O,,,5,1,1,0,1
89744_0,,,,2,2,1,3
89746_0,,,,2,2,1,3
C(CC(C)C(C(C)=O)(CCO)O)=O,,,5,1,1,0,1
89748_0,,,,2,2,1,3
C(CCC(C(C)=O)(CCO)O)=O,,,5,1,1,0,1
89749_0,,,,2,2,1,3
89751_0,,,,2,2,1,3
C(CC(C)CC(C(CCO)O)=O)=O,,,5,1,1,0,1
89753_0,,,,2,2,1,3
C(CCCC(C(CCO)O)=O)=O,,,5,1,1,0,1
89754_0,,,,2,2,1,3
89756_0,,,,2,2,1,3
C(CCC(C(CO)C(C=O)O)O)=O,,,5,1,1,0,1
89758_0,,,,2,2,1,3
C(C(CCC=O)(C(CO)CO)O)=O,,,5,1,1,0,1
89760_0,,,,2,2,1,3
C(CCC(CO)(CO)C(C=O)O)=O,,,5,1,1,0,1
89762_0,,,,2,2,1,3
C(CO)(CCC(CC(C)O)O)=O,,,5,1,1,0,1
89764_0,,,,2,2,1,3
C(CC(CO)C(CC(C)O)O)=O,,,5,1,1,0,1
89766_0,,,,2,2,1,3
C(C(CCC(CC(C)O)O)=O)(O)=O,,,5,1,1,0,1
89768_0,,,,2,2,1,3
C(C(C(CC(C)O)O)CC=O)(O)=O,,,5,1,1,0,1
89770_0,,,,2,2,1,3
C(C(C(CC(C)O)O)CC(O)=O)=O,,,5,1,1,0,1
89772_0,,,,2,2,1,3
C(C(C(CC(C)O)O)C(C=O)C)=O,,,5,1,1,0,1
89774_0,,,,2,2,1,3
C(C(C)(C(CC(C)O)O)CC=O)=O,,,5,1,1,0,1
89776_0,,,,2,2,1,3
C(C(CC(CC(C)O)O)CC=O)=O,,,5,1,1,0,1
89778_0,,,,2,2,1,3
C(C(C(CC(C)O)O)CC(C)=O)=O,,,5,1,1,0,1
89780_0,,,,2,2,1,3
C(C)(C(C(CC(C)O)O)CC=O)=O,,,5,1,1,0,1
89782_0,,,,2,2,1,3
C(C(CC(C)C(CC(C)O)O)=O)=O,,,5,1,1,0,1
89784_0,,,,2,2,1,3
C(CC(C(CC(C)O)O)CC=O)=O,,,5,1,1,0,1
89786_0,,,,2,2,1,3
C(C(C=O)C(C)C(CC(C)O)O)=O,,,5,1,1,0,1
89788_0,,,,2,2,1,3
C(C(C=O)CC(CC(C)O)O)=O,,,5,1,1,0,1
89790_0,,,,2,2,1,3
C(CC(C)C(CC(C)O)O)=O,,,5,1,1,0,1
89792_0,,,,2,2,1,3
C(CCC(CC(C)O)O)=O,,,5,1,1,0,1
89794_0,,,,2,2,1,3
C(C(CO)CC(CC(C)O)O)(O)=O,,,5,1,1,0,1
89796_0,,,,2,2,1,3
C1(CC(CO1)C(CC(C)O)O)=O,,,5,1,1,0,1
89798_0,,,,2,2,1,3
C(C(CCC(CC(C)O)O)=O)=O,,,5,1,1,0,1
89799_0,,,,2,2,1,3
89801_0,,,,2,2,1,3
C(CCC(CC(C)O)O)(O)=O,,,5,1,1,0,1
89803_0,,,,2,2,1,3
C(CC(CO)C(CC(C)O)O)(O)=O,,,5,1,1,0,1
89805_0,,,,2,2,1,3
C(CO)(CCC(CO)C(C)O)=O,,,5,1,1,0,1
89807_0,,,,2,2,1,3
C(CC(CO)C(CO)C(C)O)=O,,,5,1,1,0,1
89809_0,,,,2,2,1,3
C(C(CCC(CO)C(C)O)=O)(O)=O,,,5,1,1,0,1
89811_0,,,,2,2,1,3
C(C(C(CO)C(C)O)CC=O)(O)=O,,,5,1,1,0,1
89813_0,,,,2,2,1,3
C(C(C(CO)C(C)O)CC(O)=O)=O,,,5,1,1,0,1
89815_0,,,,2,2,1,3
C(C(C(CO)C(C)O)C(C=O)C)=O,,,5,1,1,0,1
89817_0,,,,2,2,1,3
C(C(C)(C(CO)C(C)O)CC=O)=O,,,5,1,1,0,1
89819_0,,,,2,2,1,3
C(C(CC(CO)C(C)O)CC=O)=O,,,5,1,1,0,1
89821_0,,,,2,2,1,3
C(C(C(CO)C(C)O)CC(C)=O)=O,,,5,1,1,0,1
89823_0,,,,2,2,1,3
C(C)(C(C(CO)C(C)O)CC=O)=O,,,5,1,1,0,1
89825_0,,,,2,2,1,3
C(C(CC(C)C(CO)C(C)O)=O)=O,,,5,1,1,0,1
89827_0,,,,2,2,1,3
C(CC(C(CO)C(C)O)CC=O)=O,,,5,1,1,0,1
89829_0,,,,2,2,1,3
C(C(C=O)C(C)C(CO)C(C)O)=O,,,5,1,1,0,1
89831_0,,,,2,2,1,3
C(C(C=O)CC(CO)C(C)O)=O,,,5,1,1,0,1
89833_0,,,,2,2,1,3
C(CC(C)C(CO)C(C)O)=O,,,5,1,1,0,1
89835_0,,,,2,2,1,3
C(CCC(CO)C(C)O)=O,,,5,1,1,0,1
89837_0,,,,2,2,1,3
C(C(CO)CC(CO)C(C)O)(O)=O,,,5,1,1,0,1
89839_0,,,,2,2,1,3
C1(CC(CO1)C(CO)C(C)O)=O,,,5,1,1,0,1
89840_0,,,,2,2,1,3
89841_0,,,,2,2,1,3
89842_0,,,,2,2,1,3
89843_0,,,,2,2,1,3
89845_0,,,,2,2,1,3
C(CO)(CCC(C)(CCO)O)=O,,,5,1,1,0,1
89847_0,,,,2,2,1,3
C(CC(CO)C(C)(CCO)O)=O,,,5,1,1,0,1
89849_0,,,,2,2,1,3
C(C(CCC(C)(CCO)O)=O)(O)=O,,,5,1,1,0,1
89851_0,,,,2,2,1,3
C(C(C(C)(CCO)O)CC=O)(O)=O,,,5,1,1,0,1
89853_0,,,,2,2,1,3
C(C(C(C)(CCO)O)CC(O)=O)=O,,,5,1,1,0,1
89855_0,,,,2,2,1,3
C(C(C(C)(CCO)O)C(C=O)C)=O,,,5,1,1,0,1
89857_0,,,,2,2,1,3
C(C(C)(C(C)(CCO)O)CC=O)=O,,,5,1,1,0,1
89859_0,,,,2,2,1,3
C(C(CC(C)(CCO)O)CC=O)=O,,,5,1,1,0,1
89861_0,,,,2,2,1,3
C(C(C(C)(CCO)O)CC(C)=O)=O,,,5,1,1,0,1
89863_0,,,,2,2,1,3
C(C)(C(C(C)(CCO)O)CC=O)=O,,,5,1,1,0,1
89865_0,,,,2,2,1,3
C(C(CC(C)C(C)(CCO)O)=O)=O,,,5,1,1,0,1
89867_0,,,,2,2,1,3
C(CC(C(C)(CCO)O)CC=O)=O,,,5,1,1,0,1
89869_0,,,,2,2,1,3
C(C(C=O)C(C)C(C)(CCO)O)=O,,,5,1,1,0,1
89871_0,,,,2,2,1,3
C(C(C=O)CC(C)(CCO)O)=O,,,5,1,1,0,1
89873_0,,,,2,2,1,3
C(CC(C)C(C)(CCO)O)=O,,,5,1,1,0,1
89875_0,,,,2,2,1,3
C(CCC(C)(CCO)O)=O,,,5,1,1,0,1
89877_0,,,,2,2,1,3
C(C(CO)CC(C)(CCO)O)(O)=O,,,5,1,1,0,1
89879_0,,,,2,2,1,3
C1(CC(CO1)C(C)(CCO)O)=O,,,5,1,1,0,1
89880_0,,,,2,2,1,3
89881_0,,,,2,2,1,3
89882_0,,,,2,2,1,3
89883_0,,,,2,2,1,3
89885_0,,,,2,2,1,3
C(CO)(CCCC(CCO)O)=O,,,5,1,1,0,1
89887_0,,,,2,2,1,3
C(CC(CO)CC(CCO)O)=O,,,5,1,1,0,1
89889_0,,,,2,2,1,3
C(C(CCCC(CCO)O)=O)(O)=O,,,5,1,1,0,1
89891_0,,,,2,2,1,3
C(C(CC(CCO)O)CC=O)(O)=O,,,5,1,1,0,1
89893_0,,,,2,2,1,3
C(C(CC(CCO)O)CC(O)=O)=O,,,5,1,1,0,1
89895_0,,,,2,2,1,3
C(C(CC(CCO)O)C(C=O)C)=O,,,5,1,1,0,1
89897_0,,,,2,2,1,3
C(C(C)(CC(CCO)O)CC=O)=O,,,5,1,1,0,1
89899_0,,,,2,2,1,3
C(C(CCC(CCO)O)CC=O)=O,,,5,1,1,0,1
89901_0,,,,2,2,1,3
C(C(CC(CCO)O)CC(C)=O)=O,,,5,1,1,0,1
89903_0,,,,2,2,1,3
C(C)(C(CC(CCO)O)CC=O)=O,,,5,1,1,0,1
89905_0,,,,2,2,1,3
C(C(CC(C)CC(CCO)O)=O)=O,,,5,1,1,0,1
89907_0,,,,2,2,1,3
C(CC(CC(CCO)O)CC=O)=O,,,5,1,1,0,1
89909_0,,,,2,2,1,3
C(C(C=O)C(C)CC(CCO)O)=O,,,5,1,1,0,1
89911_0,,,,2,2,1,3
C(C(C=O)CCC(CCO)O)=O,,,5,1,1,0,1
89913_0,,,,2,2,1,3
C(CC(C)CC(CCO)O)=O,,,5,1,1,0,1
89915_0,,,,2,2,1,3
C(CCCC(CCO)O)=O,,,5,1,1,0,1
89917_0,,,,2,2,1,3
C(C(CO)CCC(CCO)O)(O)=O,,,5,1,1,0,1
89919_0,,,,2,2,1,3
C1(CC(CO1)CC(CCO)O)=O,,,5,1,1,0,1
89920_0,,,,2,2,1,3
89921_0,,,,2,2,1,3
89922_0,,,,2,2,1,3
89923_0,,,,2,2,1,3
89925_0,,,,2,2,1,3
C(CO)(CCC(CO)(C(C)O)O)=O,,,5,1,1,0,1
89927_0,,,,2,2,1,3
C(CC(CO)C(CO)(C(C)O)O)=O,,,5,1,1,0,1
89929_0,,,,2,2,1,3
C(C(C=O)CC(CO)(C(C)O)O)=O,,,5,1,1,0,1
89931_0,,,,2,2,1,3
C(CC(C)C(CO)(C(C)O)O)=O,,,5,1,1,0,1
89933_0,,,,2,2,1,3
C(CCC(CO)(C(C)O)O)=O,,,5,1,1,0,1
89935_0,,,,2,2,1,3
C1(CC(CO1)C(CO)(C(C)O)O)=O,,,5,1,1,0,1
89936_0,,,,2,2,1,3
89937_0,,,,2,2,1,3
89938_0,,,,2,2,1,3
89940_0,,,,2,2,1,3
C(CO)(CCC(C(C(C)O)O)O)=O,,,5,1,1,0,1
89942_0,,,,2,2,1,3
C(CC(CO)C(C(C(C)O)O)O)=O,,,5,1,1,0,1
89944_0,,,,2,2,1,3
C(C(C=O)CC(C(C(C)O)O)O)=O,,,5,1,1,0,1
89946_0,,,,2,2,1,3
C(CC(C)C(C(C(C)O)O)O)=O,,,5,1,1,0,1
89948_0,,,,2,2,1,3
C(CCC(C(C(C)O)O)O)=O,,,5,1,1,0,1
89950_0,,,,2,2,1,3
C1(CC(CO1)C(C(C(C)O)O)O)=O,,,5,1,1,0,1
89952_0,,,,2,2,1,3
C(C(CCC(C(C(C)O)O)O)=O)=O,,,5,1,1,0,1
89953_0,,,,2,2,1,3
89955_0,,,,2,2,1,3
C(CCC(C(C(C)O)O)O)(O)=O,,,5,1,1,0,1
89957_0,,,,2,2,1,3
C(CO)(CCC(C)(C(CO)O)O)=O,,,5,1,1,0,1
89959_0,,,,2,2,1,3
C(CC(CO)C(C)(C(CO)O)O)=O,,,5,1,1,0,1
89961_0,,,,2,2,1,3
C(C(C=O)CC(C)(C(CO)O)O)=O,,,5,1,1,0,1
89963_0,,,,2,2,1,3
C(CC(C)C(C)(C(CO)O)O)=O,,,5,1,1,0,1
89965_0,,,,2,2,1,3
C(CCC(C)(C(CO)O)O)=O,,,5,1,1,0,1
89967_0,,,,2,2,1,3
C1(CC(CO1)C(C)(C(CO)O)O)=O,,,5,1,1,0,1
89968_0,,,,2,2,1,3
89969_0,,,,2,2,1,3
89970_0,,,,2,2,1,3
89972_0,,,,2,2,1,3
C(CO)(CCCC(C(CO)O)O)=O,,,5,1,1,0,1
89974_0,,,,2,2,1,3
C(CC(CO)CC(C(CO)O)O)=O,,,5,1,1,0,1
89976_0,,,,2,2,1,3
C(C(C=O)CCC(C(CO)O)O)=O,,,5,1,1,0,1
89978_0,,,,2,2,1,3
C(CC(C)CC(C(CO)O)O)=O,,,5,1,1,0,1
89980_0,,,,2,2,1,3
C(CCCC(C(CO)O)O)=O,,,5,1,1,0,1
89982_0,,,,2,2,1,3
C1(CC(CO1)CC(C(CO)O)O)=O,,,5,1,1,0,1
89983_0,,,,2,2,1,3
89984_0,,,,2,2,1,3
89985_0,,,,2,2,1,3
89986_0,,,,2,2,1,3
89988_0,,,,2,2,1,3
C(C(CO)(CC(CCC=O)O)O)=O,,,5,1,1,0,1
89990_0,,,,2,2,1,3
C(C(CO)(C(CO)CCC=O)O)=O,,,5,1,1,0,1
89992_0,,,,2,2,1,3
C(CCC(C(CO)=O)(CCO)O)=O,,,5,1,1,0,1
89994_0,,,,2,2,1,3
C(CCC(C(C(CCO)O)=O)O)=O,,,5,1,1,0,1
89996_0,,,,2,2,1,3
C(CCC(CC(C(CO)=O)O)O)=O,,,5,1,1,0,1
89998_0,,,,2,2,1,3
C(CCC(CO)C(C(CO)=O)O)=O,,,5,1,1,0,1
90000_0,,,,2,2,1,3
C(CCC(CO)(C(CCO)O)O)=O,,,5,1,1,0,1
90002_0,,,,2,2,1,3
C(CCC(CCO)(C(CO)O)O)=O,,,5,1,1,0,1
90004_0,,,,2,2,1,3
C(CCC(C(C(CCO)O)O)O)=O,,,5,1,1,0,1
90006_0,,,,2,2,1,3
C(CCC(CC(C(CO)O)O)O)=O,,,5,1,1,0,1
90008_0,,,,2,2,1,3
C(CCC(CO)C(C(CO)O)O)=O,,,5,1,1,0,1
90010_0,,,,2,2,1,3
C(CO)(CCC(CCO)O)=O,,,5,1,1,0,1
90012_0,,,,2,2,1,3
C(CC(CO)C(CCO)O)=O,,,5,1,1,0,1
90014_0,,,,2,2,1,3
C(C(CCC(CCO)O)=O)(O)=O,,,5,1,1,0,1
90016_0,,,,2,2,1,3
C(C(C(CCO)O)CC=O)(O)=O,,,5,1,1,0,1
90018_0,,,,2,2,1,3
C(C(C(CCO)O)CC(O)=O)=O,,,5,1,1,0,1
90020_0,,,,2,2,1,3
C(CC(CO)(CO)C(CCO)O)=O,,,5,1,1,0,1
90022_0,,,,2,2,1,3
C(C(C(CCO)O)C(C=O)C)=O,,,5,1,1,0,1
90024_0,,,,2,2,1,3
C(C(C)(C(CCO)O)CC=O)=O,,,5,1,1,0,1
90025_0,,,,2,2,1,3
90027_0,,,,2,2,1,3
C(C(CC(CCO)O)C(C=O)O)=O,,,5,1,1,0,1
90029_0,,,,2,2,1,3
C(C(C(CCO)O)CC(C)=O)=O,,,5,1,1,0,1
90031_0,,,,2,2,1,3
C(C)(C(C(CCO)O)CC=O)=O,,,5,1,1,0,1
90033_0,,,,2,2,1,3
C(C(CC(C)C(CCO)O)=O)=O,,,5,1,1,0,1
90034_0,,,,2,2,1,3
90035_0,,,,2,2,1,3
90037_0,,,,2,2,1,3
C(C(CC(CO)C(CCO)O)=O)=O,,,5,1,1,0,1
90039_0,,,,2,2,1,3
C(CC(C(CCO)O)CC=O)=O,,,5,1,1,0,1
90041_0,,,,2,2,1,3
C(CC(C(CCO)O)C(C=O)O)=O,,,5,1,1,0,1
90043_0,,,,2,2,1,3
C(C(C=O)C(C)C(CCO)O)=O,,,5,1,1,0,1
90044_0,,,,2,2,1,3
90045_0,,,,2,2,1,3
90047_0,,,,2,2,1,3
C(C(C=O)CC(CCO)O)=O,,,5,1,1,0,1
90049_0,,,,2,2,1,3
C(C(C=O)C(CO)C(CCO)O)=O,,,5,1,1,0,1
90051_0,,,,2,2,1,3
C(C(C(CO)CC(CCO)O)=O)=O,,,5,1,1,0,1
90052_0,,,,2,2,1,3
90053_0,,,,2,2,1,3
90055_0,,,,2,2,1,3
C(C(C(CO)=O)CC(CCO)O)=O,,,5,1,1,0,1
90057_0,,,,2,2,1,3
C(C(C(CCC(CCO)O)=O)O)=O,,,5,1,1,0,1
90059_0,,,,2,2,1,3
C(CC(C)C(CCO)O)=O,,,5,1,1,0,1
90060_0,,,,2,2,1,3
90061_0,,,,2,2,1,3
90063_0,,,,2,2,1,3
C(CC(C(CCO)O)C(CO)O)=O,,,5,1,1,0,1
90065_0,,,,2,2,1,3
C(CCC(CCO)O)=O,,,5,1,1,0,1
90067_0,,,,2,2,1,3
C(C(CC(CCO)O)C(C)O)(O)=O,,,5,1,1,0,1
90069_0,,,,2,2,1,3
C(C(CO)CC(CCO)O)(O)=O,,,5,1,1,0,1
90071_0,,,,2,2,1,3
C(C(C(C=O)=O)CC(CCO)O)=O,,,5,1,1,0,1
90073_0,,,,2,2,1,3
C1(CC(CO1)C(CCO)O)=O,,,5,1,1,0,1
90075_0,,,,2,2,1,3
C(C(C(CCO)O)CC(O)=O)(O)=O,,,5,1,1,0,1
90076_0,,,,2,2,1,3
90077_0,,,,2,2,1,3
90078_0,,,,2,2,1,3
90079_0,,,,2,2,1,3
90081_0,,,,2,2,1,3
C(CO)(CCC(CO)CO)=O,,,5,1,1,0,1
90083_0,,,,2,2,1,3
C(CC(CO)C(CO)CO)=O,,,5,1,1,0,1
90085_0,,,,2,2,1,3
C(C(CCC(CO)CO)=O)(O)=O,,,5,1,1,0,1
90087_0,,,,2,2,1,3
C(C(C(CO)CO)CC=O)(O)=O,,,5,1,1,0,1
90089_0,,,,2,2,1,3
C(C(C(CO)CO)CC(O)=O)=O,,,5,1,1,0,1
90091_0,,,,2,2,1,3
C(CC(CO)(CO)C(CO)CO)=O,,,5,1,1,0,1
90093_0,,,,2,2,1,3
C(C(C(CO)CO)C(C=O)C)=O,,,5,1,1,0,1
90095_0,,,,2,2,1,3
C(C(C)(C(CO)CO)CC=O)=O,,,5,1,1,0,1
90097_0,,,,2,2,1,3
C(C(CC(CO)CO)CC=O)=O,,,5,1,1,0,1
90099_0,,,,2,2,1,3
C(C(CC(CO)CO)C(C=O)O)=O,,,5,1,1,0,1
90101_0,,,,2,2,1,3
C(C(C(CO)CO)CC(C)=O)=O,,,5,1,1,0,1
90103_0,,,,2,2,1,3
C(C)(C(C(CO)CO)CC=O)=O,,,5,1,1,0,1
90105_0,,,,2,2,1,3
C(C(CC(C)C(CO)CO)=O)=O,,,5,1,1,0,1
90107_0,,,,2,2,1,3
C(C(C(CO)CO)CC(C=O)=O)=O,,,5,1,2,0,2
90109_0,,,,2,2,1,3
C(CC(C(C=O)=O)C(CO)CO)=O,,,5,1,1,0,1
90111_0,,,,2,2,1,3
C(C(CC(CO)C(CO)CO)=O)=O,,,5,1,1,0,1
90113_0,,,,2,2,1,3
C(CC(C(CO)CO)CC=O)=O,,,5,1,1,0,1
90115_0,,,,2,2,1,3
C(CC(C(CO)CO)C(C=O)O)=O,,,5,1,1,0,1
90117_0,,,,2,2,1,3
C(C(C=O)C(C)C(CO)CO)=O,,,5,1,1,0,1
90119_0,,,,2,2,1,3
C(C(C=O)C(C=O)C(CO)CO)=O,,,5,1,2,0,2
90121_0,,,,2,2,1,3
C(C(C=O)(C(CO)CO)CC=O)=O,,,5,1,1,0,1
90123_0,,,,2,2,1,3
C(C(C=O)CC(CO)CO)=O,,,5,1,1,0,1
90125_0,,,,2,2,1,3
C(C(C=O)C(CO)C(CO)CO)=O,,,5,1,1,0,1
90127_0,,,,2,2,1,3
C(C(C(CO)CC(CO)CO)=O)=O,,,5,1,1,0,1
90129_0,,,,2,2,1,3
C(C(C(CO)CO)C(C=O)CO)=O,,,5,1,1,0,1
90131_0,,,,2,2,1,3
C(C(CO)(C(CO)CO)CC=O)=O,,,5,1,1,0,1
90133_0,,,,2,2,1,3
C(C(C(CO)=O)CC(CO)CO)=O,,,5,1,1,0,1
90135_0,,,,2,2,1,3
C(C(C(CCC(CO)CO)=O)O)=O,,,5,1,1,0,1
90137_0,,,,2,2,1,3
C(CC(C)C(CO)CO)=O,,,5,1,1,0,1
90139_0,,,,2,2,1,3
C(CO)(C(C(CO)CO)CC=O)=O,,,5,1,1,0,1
90141_0,,,,2,2,1,3
C(C(C(CO)CO)CC(CO)=O)=O,,,5,1,1,0,1
90143_0,,,,2,2,1,3
C(CC(C(CO)O)C(CO)CO)=O,,,5,1,1,0,1
90145_0,,,,2,2,1,3
C(CCC(CO)CO)=O,,,5,1,1,0,1
90147_0,,,,2,2,1,3
C(C(CC(CO)CO)C(C)O)(O)=O,,,5,1,1,0,1
90149_0,,,,2,2,1,3
C(C(CO)CC(CO)CO)(O)=O,,,5,1,1,0,1
90151_0,,,,2,2,1,3
C(C(C(C=O)=O)CC(CO)CO)=O,,,5,1,1,0,1
90153_0,,,,2,2,1,3
C1(CC(CO1)C(CO)CO)=O,,,5,1,1,0,1
90155_0,,,,2,2,1,3
C(C(C(CO)CO)CC(O)=O)(O)=O,,,5,1,1,0,1
90156_0,,,,2,2,1,3
90157_0,,,,2,2,1,3
90158_0,,,,2,2,1,3
90159_0,,,,2,2,1,3
90161_0,,,,2,2,1,3
C(CO)(CCC(C(CCO)O)O)=O,,,5,1,1,0,1
90163_0,,,,2,2,1,3
C(CC(CO)C(C(CCO)O)O)=O,,,5,1,1,0,1
90165_0,,,,2,2,1,3
C(C(C=O)CC(C(CCO)O)O)=O,,,5,1,1,0,1
90167_0,,,,2,2,1,3
C(CC(C)C(C(CCO)O)O)=O,,,5,1,1,0,1
90169_0,,,,2,2,1,3
C(CCC(C(CCO)O)O)=O,,,5,1,1,0,1
90171_0,,,,2,2,1,3
C1(CC(CO1)C(C(CCO)O)O)=O,,,5,1,1,0,1
90172_0,,,,2,2,1,3
90173_0,,,,2,2,1,3
90174_0,,,,2,2,1,3
90176_0,,,,2,2,1,3
C(CO)(CCC(CO)(CCO)O)=O,,,5,1,1,0,1
90178_0,,,,2,2,1,3
C(CC(CO)C(CO)(CCO)O)=O,,,5,1,1,0,1
90180_0,,,,2,2,1,3
C(C(C=O)CC(CO)(CCO)O)=O,,,5,1,1,0,1
90182_0,,,,2,2,1,3
C(CC(C)C(CO)(CCO)O)=O,,,5,1,1,0,1
90184_0,,,,2,2,1,3
C(CCC(CO)(CCO)O)=O,,,5,1,1,0,1
90186_0,,,,2,2,1,3
C1(CC(CO1)C(CO)(CCO)O)=O,,,5,1,1,0,1
90187_0,,,,2,2,1,3
90188_0,,,,2,2,1,3
90189_0,,,,2,2,1,3
90191_0,,,,2,2,1,3
C(CO)(CCC(CC(CO)O)O)=O,,,5,1,1,0,1
90193_0,,,,2,2,1,3
C(CC(CO)C(CC(CO)O)O)=O,,,5,1,1,0,1
90195_0,,,,2,2,1,3
C(C(C=O)CC(CC(CO)O)O)=O,,,5,1,1,0,1
90197_0,,,,2,2,1,3
C(CC(C)C(CC(CO)O)O)=O,,,5,1,1,0,1
90199_0,,,,2,2,1,3
C(CCC(CC(CO)O)O)=O,,,5,1,1,0,1
90201_0,,,,2,2,1,3
C1(CC(CO1)C(CC(CO)O)O)=O,,,5,1,1,0,1
90202_0,,,,2,2,1,3
90203_0,,,,2,2,1,3
90204_0,,,,2,2,1,3
90206_0,,,,2,2,1,3
C(CO)(CCC(CO)C(CO)O)=O,,,5,1,1,0,1
90208_0,,,,2,2,1,3
C(CC(CO)C(CO)C(CO)O)=O,,,5,1,1,0,1
90210_0,,,,2,2,1,3
C(C(C=O)CC(CO)C(CO)O)=O,,,5,1,1,0,1
90212_0,,,,2,2,1,3
C(CC(C)C(CO)C(CO)O)=O,,,5,1,1,0,1
90214_0,,,,2,2,1,3
C(CCC(CO)C(CO)O)=O,,,5,1,1,0,1
90216_0,,,,2,2,1,3
C1(CC(CO1)C(CO)C(CO)O)=O,,,5,1,1,0,1
90217_0,,,,2,2,1,3
90218_0,,,,2,2,1,3
90219_0,,,,2,2,1,3
90221_0,,,,2,2,1,3
C(C(CO)CCC(CO)=O)(O)=O,,,5,1,2,0,2
90223_0,,,,2,2,1,3
C(C(CO)C(CO)CC=O)(O)=O,,,5,1,2,0,2
90225_0,,,,2,2,1,3
C(C(CCC(C(O)=O)=O)CO)(O)=O,,,5,1,2,0,2
90227_0,,,,2,2,1,3
C(C(CO)C(C(O)=O)CC=O)(O)=O,,,5,1,1,0,1
90229_0,,,,2,2,1,3
C(CC(C=O)C(C(O)=O)CO)(O)=O,,,5,1,1,0,1
90231_0,,,,2,2,1,3
C(C(CO)C(C=O)C(C=O)C)(O)=O,,,5,1,1,0,1
90233_0,,,,2,2,1,3
C(C(CO)C(C=O)(C)CC=O)(O)=O,,,5,1,1,0,1
90235_0,,,,2,2,1,3
C(C(CC(C=O)CC=O)CO)(O)=O,,,5,1,2,0,2
90237_0,,,,2,2,1,3
C(CC(C=O)C(C(O)=O)CO)(C)=O,,,5,1,1,0,1
90239_0,,,,2,2,1,3
C(C(CO)C(C(C)=O)CC=O)(O)=O,,,5,1,1,0,1
90241_0,,,,2,2,1,3
C(C(CO)C(C)CC(C=O)=O)(O)=O,,,5,1,1,0,1
90243_0,,,,2,2,1,3
C(C(C(CC=O)CC=O)CO)(O)=O,,,5,1,1,0,1
90245_0,,,,2,2,1,3
C(C(C=O)C(C)C(C(O)=O)CO)=O,,,5,1,1,0,1
90247_0,,,,2,2,1,3
C(C(C=O)CC(C(O)=O)CO)=O,,,5,1,2,0,2
90249_0,,,,2,2,1,3
C(C(CO)C(C)CC=O)(O)=O,,,5,1,1,0,1
90251_0,,,,2,2,1,3
C(C(CCC=O)CO)(O)=O,,,5,1,2,0,2
90253_0,,,,2,2,1,3
C(C(CC(C(O)=O)CO)CO)(O)=O,,,5,1,1,0,1
90255_0,,,,2,2,1,3
C(C(CO)C1COC(C1)=O)(O)=O,,,5,1,1,0,1
90256_0,,,,2,2,1,3
90257_0,,,,2,2,1,3
90258_0,,,,2,2,1,3
90259_0,,,,2,2,1,3
90261_0,,,,2,2,1,3
C(CC(CCC(CO)=O)O)(O)=O,,,5,1,1,0,1
90263_0,,,,2,2,1,3
C(CC(C(CO)CC=O)O)(O)=O,,,5,1,1,0,1
90265_0,,,,2,2,1,3
C(CC(CCC(C(O)=O)=O)O)(O)=O,,,5,1,1,0,1
90267_0,,,,2,2,1,3
C(CC(C(C(O)=O)CC=O)O)(O)=O,,,5,1,1,0,1
90269_0,,,,2,2,1,3
C(CC(C(C=O)CC(O)=O)O)(O)=O,,,5,1,1,0,1
90271_0,,,,2,2,1,3
C(CC(C(C=O)C(C=O)C)O)(O)=O,,,5,1,1,0,1
90273_0,,,,2,2,1,3
C(CC(C(C=O)(C)CC=O)O)(O)=O,,,5,1,1,0,1
90274_0,,,,2,2,1,3
90276_0,,,,2,2,1,3
C(CC(C(C=O)CC(C)=O)O)(O)=O,,,5,1,1,0,1
90278_0,,,,2,2,1,3
C(C)(C(C(CC(O)=O)O)CC=O)=O,,,5,1,1,0,1
90280_0,,,,2,2,1,3
C(CC(C(C)CC(C=O)=O)O)(O)=O,,,5,1,1,0,1
90282_0,,,,2,2,1,3
C(CC(C(CC=O)CC=O)O)(O)=O,,,5,1,1,0,1
90284_0,,,,2,2,1,3
C(C(C=O)C(C)C(CC(O)=O)O)=O,,,5,1,1,0,1
90286_0,,,,2,2,1,3
C(C(C=O)CC(CC(O)=O)O)=O,,,5,1,1,0,1
90288_0,,,,2,2,1,3
C(CC(C(C)CC=O)O)(O)=O,,,5,1,1,0,1
90290_0,,,,2,2,1,3
C(CC(CCC=O)O)(O)=O,,,5,1,1,0,1
90292_0,,,,2,2,1,3
C(C(CO)CC(CC(O)=O)O)(O)=O,,,5,1,1,0,1
90294_0,,,,2,2,1,3
C1(CC(CO1)C(CC(O)=O)O)=O,,,5,1,1,0,1
90295_0,,,,2,2,1,3
90296_0,,,,2,2,1,3
90297_0,,,,2,2,1,3
90298_0,,,,2,2,1,3
90300_0,,,,2,2,1,3
C(CC(CO)(C(C)CC=O)O)(O)=O,,,5,1,1,0,1
90302_0,,,,2,2,1,3
C(CC(CCC=O)(CO)O)(O)=O,,,5,1,1,0,1
90303_0,,,,2,2,1,3
90305_0,,,,2,2,1,3
C(CC(C(C(C)CC=O)O)O)(O)=O,,,5,1,1,0,1
90307_0,,,,2,2,1,3
C(CC(C(CCC=O)O)O)(O)=O,,,5,1,1,0,1
90308_0,,,,2,2,1,3
90310_0,,,,2,2,1,3
C(C(C(C)CC=O)C(CO)O)(O)=O,,,5,1,1,0,1
90312_0,,,,2,2,1,3
C(C(CCC=O)C(CO)O)(O)=O,,,5,1,2,0,2
90313_0,,,,2,2,1,3
90314_0,,,,2,2,1,3
90316_0,,,,2,2,1,3
C(CCCC=O)(C(CO)(CO)O)=O,,,5,1,1,0,1
90318_0,,,,2,2,1,3
C(CCC(C(CO)(C(C)O)O)O)=O,,,5,1,1,0,1
90320_0,,,,2,2,1,3
C(CCC(C)(C(CO)(CO)O)O)=O,,,5,1,1,0,1
90322_0,,,,2,2,1,3
C(CCCC(C(CO)(CO)O)O)=O,,,5,1,1,0,1
90324_0,,,,2,2,1,3
C(CO)(CCC(C(C=C)=O)O)=O,,,5,1,1,0,1
90326_0,,,,2,2,1,3
C(CC(CO)C(C(C=C)=O)O)=O,,,5,1,1,0,1
90328_0,,,,2,2,1,3
C=CC(C(CCC(C(O)=O)=O)O)=O,,,5,1,1,0,1
90330_0,,,,2,2,1,3
C(C(CC=O)C(C(C=C)=O)O)(O)=O,,,5,1,1,0,1
90332_0,,,,2,2,1,3
C(CC(C=O)C(C(C=C)=O)O)(O)=O,,,5,1,1,0,1
90334_0,,,,2,2,1,3
C(C(C)C(C=O)C(C(C=C)=O)O)=O,,,5,1,1,0,1
90336_0,,,,2,2,1,3
C(CC(C=O)(C)C(C(C=C)=O)O)=O,,,5,1,1,0,1
90338_0,,,,2,2,1,3
C(C(CC(C(C=C)=O)O)CC=O)=O,,,5,1,1,0,1
90340_0,,,,2,2,1,3
C(C(CC(C)=O)C(C(C=C)=O)O)=O,,,5,1,1,0,1
90342_0,,,,2,2,1,3
C(CC(C(C)=O)C(C(C=C)=O)O)=O,,,5,1,1,0,1
90344_0,,,,2,2,1,3
C=CC(C(C(C)CC(C=O)=O)O)=O,,,5,1,1,0,1
90345_0,,,,2,2,1,3
90346_0,,,,2,2,1,3
90348_0,,,,2,2,1,3
C(CC(C(C(C=C)=O)O)CC=O)=O,,,5,1,1,0,1
90350_0,,,,2,2,1,3
C(C(C=O)C(C)C(C(C=C)=O)O)=O,,,5,1,1,0,1
90351_0,,,,2,2,1,3
90352_0,,,,2,2,1,3
90354_0,,,,2,2,1,3
C(C(C=O)CC(C(C=C)=O)O)=O,,,5,1,1,0,1
90356_0,,,,2,2,1,3
C(CC(C)C(C(C=C)=O)O)=O,,,5,1,1,0,1
90358_0,,,,2,2,1,3
C(CCC(C(C=C)=O)O)=O,,,5,1,1,0,1
90360_0,,,,2,2,1,3
C(C(CO)CC(C(C=C)=O)O)(O)=O,,,5,1,1,0,1
90362_0,,,,2,2,1,3
C(C(C(C=O)=O)CC(C(C=C)=O)O)=O,,,5,1,1,0,1
90364_0,,,,2,2,1,3
C1(CC(CO1)C(C(C=C)=O)O)=O,,,5,1,1,0,1
90365_0,,,,2,2,1,3
90366_0,,,,2,2,1,3
90367_0,,,,2,2,1,3
90369_0,,,,2,2,1,3
C(CC(CO)C(C(C=C)=O)O)(O)=O,,,5,1,1,0,1
90371_0,,,,2,2,1,3
C(CO)(CCC(C=CC=O)O)=O,,,5,1,1,0,1
90373_0,,,,2,2,1,3
C(CO)(CCC(CO)(O)O)=O,,,5,1,1,0,1
90375_0,,,,2,2,1,3
C(CO)(CCC(C(O)O)O)=O,,,5,1,1,0,1
90377_0,,,,2,2,1,3
C(CO)(CCC(CO)(C)O)=O,,,5,1,1,0,1
90379_0,,,,2,2,1,3
C(CO)(CCC(C(C)O)O)=O,,,5,1,1,0,1
90381_0,,,,2,2,1,3
C(CO)(CCCC(CO)O)=O,,,5,1,1,0,1
90383_0,,,,2,2,1,3
C(C(CCC(CO)=O)C(C)O)(O)=O,,,5,1,2,0,2
90385_0,,,,2,2,1,3
C(CC(C)(CCC(CO)=O)O)(O)=O,,,5,1,1,0,1
90387_0,,,,2,2,1,3
C(CC(CCCC(CO)=O)O)(O)=O,,,5,1,1,0,1
90389_0,,,,2,2,1,3
C(C(C(O)=O)CCC(CO)=O)(O)=O,,,5,1,1,0,1
90391_0,,,,2,2,1,3
C(C(CCC(CO)=O)(O)O)(O)=O,,,5,1,1,0,1
90392_0,,,,2,2,1,3
90393_0,,,,2,2,1,3
90395_0,,,,2,2,1,3
C(C(CO)(CCCC(CO)=O)O)=O,,,5,1,1,0,1
90396_0,,,,2,2,1,3
90398_0,,,,2,2,1,3
C(CO)(CCC(C(C=O)=O)C)=O,,,5,1,1,0,1
90400_0,,,,2,2,1,3
C(CO)(CCCCC(C=O)=O)=O,,,5,1,1,0,1
90402_0,,,,2,2,1,3
C(CO)(CCC(C=O)CC=O)=O,,,5,1,2,0,2
90404_0,,,,2,2,1,3
C(CO)(CCCC(C(C)=O)=O)=O,,,5,1,1,0,1
90406_0,,,,2,2,1,3
C(CO)(CCC(C(C(O)=O)=O)C)=O,,,5,1,1,0,1
90408_0,,,,2,2,1,3
C(CO)(CCCCC(C(O)=O)=O)=O,,,5,1,1,0,1
90410_0,,,,2,2,1,3
C(C)(C(C(O)=O)CCC(CO)=O)=O,,,5,1,1,0,1
90412_0,,,,2,2,1,3
C(CCCC(CO)=O)(CC(O)=O)=O,,,5,1,1,0,1
90414_0,,,,2,2,1,3
C(C(C=O)(C)CCC(CO)=O)(O)=O,,,5,1,1,0,1
90416_0,,,,2,2,1,3
C(C(C=O)CCCC(CO)=O)(O)=O,,,5,1,1,0,1
90418_0,,,,2,2,1,3
C(CO)(CCC1CC(C(O1)=O)=O)=O,,,5,1,1,0,1
90420_0,,,,2,2,1,3
C(CO)(CCC1C(C(OC1)=O)=O)=O,,,5,1,1,0,1
90422_0,,,,2,2,1,3
C(CO)(CCC1C(OCC1=O)=O)=O,,,5,1,1,0,1
90424_0,,,,2,2,1,3
C1(C(CCC(CO)=O)OC(C1)=O)=O,,,5,1,1,0,1
90426_0,,,,2,2,1,3
C(CO)(CCCC(C=O)=CC=O)=O,,,5,1,1,0,1
90428_0,,,,2,2,1,3
C(C(C(C=O)=C)CCC(CO)=O)=O,,,5,1,1,0,1
90430_0,,,,2,2,1,3
C(CO)(CCCC(C=CC=O)=O)=O,,,5,1,1,0,1
90432_0,,,,2,2,1,3
C(CO)(CCC(C=C)C(C=O)=O)=O,,,5,1,1,0,1
90434_0,,,,2,2,1,3
C(CO)(CCCC=CC(C=O)=O)=O,,,5,1,1,0,1
90436_0,,,,2,2,1,3
C(C(C=CC=O)CCC(CO)=O)=O,,,5,1,1,0,1
90438_0,,,,2,2,1,3
C(C(C=O)(C=C)CCC(CO)=O)=O,,,5,1,1,0,1
90440_0,,,,2,2,1,3
C(CO)(CCCC=C(C=O)C=O)=O,,,5,1,1,0,1
90442_0,,,,2,2,1,3
C(CO)(CCCC=CC=O)=O,,,5,1,1,0,1
90444_0,,,,2,2,1,3
C(C(C=C)CCC(CO)=O)=O,,,5,1,1,0,1
90446_0,,,,2,2,1,3
C(C(C=C)(CCC(CO)=O)O)=O,,,5,1,1,0,1
90448_0,,,,2,2,1,3
C(CO)(CCC(C(C(O)=O)=C)O)=O,,,5,1,1,0,1
90450_0,,,,2,2,1,3
C(CO)(CCC1C=CC(O1)=O)=O,,,5,1,1,0,1
90452_0,,,,2,2,1,3
C(CO)(CCC1C(C=CO1)=O)=O,,,5,1,1,0,1
90454_0,,,,2,2,1,3
C(CO)(CCC(C=C)O)=O,,,5,1,1,0,1
90456_0,,,,2,2,1,3
C(CO)(CCC1C(CC(O)O1)O)=O,,,5,1,1,0,1
90458_0,,,,2,2,1,3
C(CO)(CCC1(COC(C1)O)O)=O,,,5,1,1,0,1
90460_0,,,,2,2,1,3
C(CO)(CCC1(CC(CO1)O)O)=O,,,5,1,1,0,1
90462_0,,,,2,2,1,3
C(CO)(CCC1C(O)OCC1O)=O,,,5,1,1,0,1
90464_0,,,,2,2,1,3
C(CO)(CCC1(C(O)OCC1)O)=O,,,5,1,1,0,1
90466_0,,,,2,2,1,3
C(CO)(CCC1(C(CCO1)O)O)=O,,,5,1,1,0,1
90468_0,,,,2,2,1,3
C(CO)(CCC1CC(C(O)O1)O)=O,,,5,1,1,0,1
90470_0,,,,2,2,1,3
C(CO)(CCC1COC(C1O)O)=O,,,5,1,1,0,1
90472_0,,,,2,2,1,3
C(CCC(CCC(CO)=O)O)(O)=O,,,5,1,1,0,1
90474_0,,,,2,2,1,3
C(C(CCC(CO)=O)CCO)(O)=O,,,5,1,1,0,1
90476_0,,,,2,2,1,3
C(CC(CO)CCC(CO)=O)(O)=O,,,5,1,1,0,1
90478_0,,,,2,2,1,3
C(C(CCC(CO)=O)(CC)O)(O)=O,,,5,1,1,0,1
90480_0,,,,2,2,1,3
C(C(C(CCC(CO)=O)C)O)(O)=O,,,5,1,1,0,1
90482_0,,,,2,2,1,3
C(C(CCCCC(CO)=O)O)(O)=O,,,5,1,1,0,1
90484_0,,,,2,2,1,3
C(CO)(CCC[C](C(O)=O)O)=O,,,5,1,1,0,1
90485_0,,,,2,2,1,3
90486_0,,,,2,2,1,3
90487_0,,,,2,2,1,3
90488_0,,,,2,2,1,3
90489_0,,,,2,2,1,3
90490_0,,,,2,2,1,3
90491_0,,,,2,2,1,3
90492_0,,,,2,2,1,3
90493_0,,,,2,2,1,3
90494_0,,,,2,2,1,3
90495_0,,,,2,2,1,3
90496_0,,,,2,2,1,3
90497_0,,,,2,2,1,3
90498_0,,,,2,2,1,3
90499_0,,,,2,2,1,3
90500_0,,,,2,2,1,3
90501_0,,,,2,2,1,3
90502_0,,,,2,2,1,3
90503_0,,,,2,2,1,3
90504_0,,,,2,2,1,3
90505_0,,,,2,2,1,3
90506_0,,,,2,2,1,3
90507_0,,,,2,2,1,3
90508_0,,,,2,2,1,3
90509_0,,,,2,2,1,3
90510_0,,,,2,2,1,3
90511_0,,,,2,2,1,3
90512_0,,,,2,2,1,3
90513_0,,,,2,2,1,3
90514_0,,,,2,2,1,3
90515_0,,,,2,2,1,3
90516_0,,,,2,2,1,3
90517_0,,,,2,2,1,3
90518_0,,,,2,2,1,3
90519_0,,,,2,2,1,3
90520_0,,,,2,2,1,3
90521_0,,,,2,2,1,3
90522_0,,,,2,2,1,3
90523_0,,,,2,2,1,3
90524_0,,,,2,2,1,3
90525_0,,,,2,2,1,3
90526_0,,,,2,2,1,3
90527_0,,,,2,2,1,3
90528_0,,,,2,2,1,3
90529_0,,,,2,2,1,3
90530_0,,,,2,2,1,3
90531_0,,,,2,2,1,3
90532_0,,,,2,2,1,3
90533_0,,,,2,2,1,3
90534_0,,,,2,2,1,3
90535_0,,,,2,2,1,3
90536_0,,,,2,2,1,3
90537_0,,,,2,2,1,3
90538_0,,,,2,2,1,3
90539_0,,,,2,2,1,3
90540_0,,,,2,2,1,3
90541_0,,,,2,2,1,3
90542_0,,,,2,2,1,3
90543_0,,,,2,2,1,3
90544_0,,,,2,2,1,3
90545_0,,,,2,2,1,3
90546_0,,,,2,2,1,3
90547_0,,,,2,2,1,3
90548_0,,,,2,2,1,3
90549_0,,,,2,2,1,3
90550_0,,,,2,2,1,3
90551_0,,,,2,2,1,3
90552_0,,,,2,2,1,3
90553_0,,,,2,2,1,3
90554_0,,,,2,2,1,3
90555_0,,,,2,2,1,3
90556_0,,,,2,2,1,3
90557_0,,,,2,2,1,3
90558_0,,,,2,2,1,3
90559_0,,,,2,2,1,3
90560_0,,,,2,2,1,3
90561_0,,,,2,2,1,3
90562_0,,,,2,2,1,3
90563_0,,,,2,2,1,3
90564_0,,,,2,2,1,3
90565_0,,,,2,2,1,3
90566_0,,,,2,2,1,3
90567_0,,,,2,2,1,3
90569_0,,,,2,2,1,3
C(CC(CO)C(C=CC=O)O)=O,,,5,1,1,0,1
90571_0,,,,2,2,1,3
C(C(CCC(C(O)=O)=O)O)=CC=O,,,5,1,1,0,1
90573_0,,,,2,2,1,3
C(C(CC=O)C(C=CC=O)O)(O)=O,,,5,1,1,0,1
90575_0,,,,2,2,1,3
C(CC(C=O)C(C=CC=O)O)(O)=O,,,5,1,1,0,1
90577_0,,,,2,2,1,3
C(C(C)C(C=O)C(C=CC=O)O)=O,,,5,1,1,0,1
90579_0,,,,2,2,1,3
C(CC(C=O)(C)C(C=CC=O)O)=O,,,5,1,1,0,1
90581_0,,,,2,2,1,3
C(C(CC(C=CC=O)O)CC=O)=O,,,5,1,1,0,1
90583_0,,,,2,2,1,3
C(C(CC(C)=O)C(C=CC=O)O)=O,,,5,1,1,0,1
90585_0,,,,2,2,1,3
C(CC(C(C)=O)C(C=CC=O)O)=O,,,5,1,1,0,1
90587_0,,,,2,2,1,3
C(C(C(C)CC(C=O)=O)O)=CC=O,,,5,1,1,0,1
90588_0,,,,2,2,1,3
90589_0,,,,2,2,1,3
90591_0,,,,2,2,1,3
C(CC(C(C=CC=O)O)CC=O)=O,,,5,1,1,0,1
90593_0,,,,2,2,1,3
C(C(C=O)C(C)C(C=CC=O)O)=O,,,5,1,1,0,1
90594_0,,,,2,2,1,3
90595_0,,,,2,2,1,3
90597_0,,,,2,2,1,3
C(C(C=O)CC(C=CC=O)O)=O,,,5,1,1,0,1
90599_0,,,,2,2,1,3
C(CC(C)C(C=CC=O)O)=O,,,5,1,1,0,1
90601_0,,,,2,2,1,3
C(CCC(C=CC=O)O)=O,,,5,1,1,0,1
90603_0,,,,2,2,1,3
C(C(CO)CC(C=CC=O)O)(O)=O,,,5,1,1,0,1
90605_0,,,,2,2,1,3
C(C(C(C=O)=O)CC(C=CC=O)O)=O,,,5,1,1,0,1
90607_0,,,,2,2,1,3
C1(CC(CO1)C(C=CC=O)O)=O,,,5,1,1,0,1
90608_0,,,,2,2,1,3
90609_0,,,,2,2,1,3
90610_0,,,,2,2,1,3
90612_0,,,,2,2,1,3
C(CC(CO)C(C=CC=O)O)(O)=O,,,5,1,1,0,1
90614_0,,,,2,2,1,3
C(CC(CO)C(CO)(O)O)=O,,,5,1,1,0,1
90616_0,,,,2,2,1,3
C(CC(CO)C(C(O)O)O)=O,,,5,1,1,0,1
90618_0,,,,2,2,1,3
C(CC(CO)C(C)(CO)O)=O,,,5,1,1,0,1
90620_0,,,,2,2,1,3
C(CC(CO)C(C(C)O)O)=O,,,5,1,1,0,1
90622_0,,,,2,2,1,3
C(CC(CO)CC(CO)O)=O,,,5,1,1,0,1
90624_0,,,,2,2,1,3
C(C(C(CO)CC=O)C(C)O)(O)=O,,,5,1,2,0,2
90626_0,,,,2,2,1,3
C(CC(C)(C(CO)CC=O)O)(O)=O,,,5,1,1,0,1
90628_0,,,,2,2,1,3
C(CC(CC(CO)CC=O)O)(O)=O,,,5,1,1,0,1
90630_0,,,,2,2,1,3
C(C(C(O)=O)C(CO)CC=O)(O)=O,,,5,1,1,0,1
90632_0,,,,2,2,1,3
C(CC(CO)C(C(O)=O)(O)O)=O,,,5,1,1,0,1
90633_0,,,,2,2,1,3
90634_0,,,,2,2,1,3
90636_0,,,,2,2,1,3
C(C(CO)(CC(CO)CC=O)O)=O,,,5,1,1,0,1
90637_0,,,,2,2,1,3
90639_0,,,,2,2,1,3
C(CC(CO)C(C(C=O)=O)C)=O,,,5,1,1,0,1
90641_0,,,,2,2,1,3
C(CC(CCC(C=O)=O)CO)=O,,,5,1,1,0,1
90643_0,,,,2,2,1,3
C(CC(CO)C(C=O)CC=O)=O,,,5,1,2,0,2
90645_0,,,,2,2,1,3
C(CC(CO)CC(C(C)=O)=O)=O,,,5,1,1,0,1
90647_0,,,,2,2,1,3
C(CC(CO)C(C(C(O)=O)=O)C)=O,,,5,1,1,0,1
90649_0,,,,2,2,1,3
C(CC(CCC(C(O)=O)=O)CO)=O,,,5,1,1,0,1
90651_0,,,,2,2,1,3
C(CC(CO)C(C(O)=O)C(C)=O)=O,,,5,1,1,0,1
90653_0,,,,2,2,1,3
C(CC(CC(CO)CC=O)=O)(O)=O,,,5,1,1,0,1
90655_0,,,,2,2,1,3
C(C(C=O)(C)C(CO)CC=O)(O)=O,,,5,1,1,0,1
90657_0,,,,2,2,1,3
C(C(C=O)CC(CO)CC=O)(O)=O,,,5,1,1,0,1
90659_0,,,,2,2,1,3
C(CC(C1CC(C(O1)=O)=O)CO)=O,,,5,1,1,0,1
90661_0,,,,2,2,1,3
C(CC(CO)C1C(C(OC1)=O)=O)=O,,,5,1,1,0,1
90663_0,,,,2,2,1,3
C(CC(CO)C1C(OCC1=O)=O)=O,,,5,1,1,0,1
90665_0,,,,2,2,1,3
C(CC(CO)C1C(CC(O1)=O)=O)=O,,,5,1,1,0,1
90667_0,,,,2,2,1,3
C(CC(CO)CC(C=O)=CC=O)=O,,,5,1,1,0,1
90669_0,,,,2,2,1,3
C(C(C(C=O)=C)C(CO)CC=O)=O,,,5,1,1,0,1
90671_0,,,,2,2,1,3
C(CC(CO)CC(C=CC=O)=O)=O,,,5,1,1,0,1
90673_0,,,,2,2,1,3
C(CC(CO)C(C=C)C(C=O)=O)=O,,,5,1,1,0,1
90675_0,,,,2,2,1,3
C(CC(CO)CC=CC(C=O)=O)=O,,,5,1,1,0,1
90677_0,,,,2,2,1,3
C(C(C=CC=O)C(CO)CC=O)=O,,,5,1,1,0,1
90679_0,,,,2,2,1,3
C(C(C=O)(C=C)C(CO)CC=O)=O,,,5,1,1,0,1
90681_0,,,,2,2,1,3
C(CC(CO)CC=C(C=O)C=O)=O,,,5,1,1,0,1
90683_0,,,,2,2,1,3
C(CC(CO)CC=CC=O)=O,,,5,1,1,0,1
90685_0,,,,2,2,1,3
C(C(C=C)C(CO)CC=O)=O,,,5,1,1,0,1
90687_0,,,,2,2,1,3
C(C(C=C)(C(CO)CC=O)O)=O,,,5,1,1,0,1
90689_0,,,,2,2,1,3
C(CC(CO)C(C(C(O)=O)=C)O)=O,,,5,1,1,0,1
90691_0,,,,2,2,1,3
C(CC(CO)C1C=CC(O1)=O)=O,,,5,1,1,0,1
90693_0,,,,2,2,1,3
C(CC(CO)C1C(C=CO1)=O)=O,,,5,1,1,0,1
90695_0,,,,2,2,1,3
C(CC(CO)C(C=C)O)=O,,,5,1,1,0,1
90697_0,,,,2,2,1,3
C(CC(CO)C1C(CC(O)O1)O)=O,,,5,1,1,0,1
90699_0,,,,2,2,1,3
C(CC(CO)C1(COC(C1)O)O)=O,,,5,1,1,0,1
90701_0,,,,2,2,1,3
C(CC(CO)C1(CC(CO1)O)O)=O,,,5,1,1,0,1
90703_0,,,,2,2,1,3
C(CC(CO)C1C(O)OCC1O)=O,,,5,1,1,0,1
90705_0,,,,2,2,1,3
C(CC(CO)C1(C(O)OCC1)O)=O,,,5,1,1,0,1
90707_0,,,,2,2,1,3
C(CC(CO)C1(C(CCO1)O)O)=O,,,5,1,1,0,1
90709_0,,,,2,2,1,3
C(CC(CO)C1CC(C(O)O1)O)=O,,,5,1,1,0,1
90711_0,,,,2,2,1,3
C(CC(CO)C1COC(C1O)O)=O,,,5,1,1,0,1
90713_0,,,,2,2,1,3
C(CCC(C(CO)CC=O)O)(O)=O,,,5,1,1,0,1
90715_0,,,,2,2,1,3
C(C(CCO)C(CO)CC=O)(O)=O,,,5,1,1,0,1
90717_0,,,,2,2,1,3
C(CC(CO)C(CO)CC=O)(O)=O,,,5,1,1,0,1
90719_0,,,,2,2,1,3
C(C(CC)(C(CO)CC=O)O)(O)=O,,,5,1,1,0,1
90721_0,,,,2,2,1,3
C(CC(CO)C(C)C(C(O)=O)O)=O,,,5,1,1,0,1
90723_0,,,,2,2,1,3
C(CC(CO)CCC(C(O)=O)O)=O,,,5,1,1,0,1
90725_0,,,,2,2,1,3
C(CC(CO)C[C](C(O)=O)O)=O,,,5,1,1,0,1
90726_0,,,,2,2,1,3
90727_0,,,,2,2,1,3
90728_0,,,,2,2,1,3
90729_0,,,,2,2,1,3
90730_0,,,,2,2,1,3
90731_0,,,,2,2,1,3
90732_0,,,,2,2,1,3
90733_0,,,,2,2,1,3
90734_0,,,,2,2,1,3
90735_0,,,,2,2,1,3
90736_0,,,,2,2,1,3
90737_0,,,,2,2,1,3
90738_0,,,,2,2,1,3
90739_0,,,,2,2,1,3
90740_0,,,,2,2,1,3
90741_0,,,,2,2,1,3
90742_0,,,,2,2,1,3
90743_0,,,,2,2,1,3
90744_0,,,,2,2,1,3
90745_0,,,,2,2,1,3
90746_0,,,,2,2,1,3
90747_0,,,,2,2,1,3
90748_0,,,,2,2,1,3
90749_0,,,,2,2,1,3
90750_0,,,,2,2,1,3
90751_0,,,,2,2,1,3
90752_0,,,,2,2,1,3
90753_0,,,,2,2,1,3
90754_0,,,,2,2,1,3
90755_0,,,,2,2,1,3
90756_0,,,,2,2,1,3
90757_0,,,,2,2,1,3
90758_0,,,,2,2,1,3
90759_0,,,,2,2,1,3
90760_0,,,,2,2,1,3
90761_0,,,,2,2,1,3
90762_0,,,,2,2,1,3
90763_0,,,,2,2,1,3
90764_0,,,,2,2,1,3
90765_0,,,,2,2,1,3
90766_0,,,,2,2,1,3
90767_0,,,,2,2,1,3
90768_0,,,,2,2,1,3
90769_0,,,,2,2,1,3
90770_0,,,,2,2,1,3
90771_0,,,,2,2,1,3
90772_0,,,,2,2,1,3
90773_0,,,,2,2,1,3
90774_0,,,,2,2,1,3
90775_0,,,,2,2,1,3
90776_0,,,,2,2,1,3
90777_0,,,,2,2,1,3
90778_0,,,,2,2,1,3
90779_0,,,,2,2,1,3
90780_0,,,,2,2,1,3
90781_0,,,,2,2,1,3
90782_0,,,,2,2,1,3
90783_0,,,,2,2,1,3
90784_0,,,,2,2,1,3
90785_0,,,,2,2,1,3
90786_0,,,,2,2,1,3
90787_0,,,,2,2,1,3
90788_0,,,,2,2,1,3
90789_0,,,,2,2,1,3
90790_0,,,,2,2,1,3
90791_0,,,,2,2,1,3
90792_0,,,,2,2,1,3
90793_0,,,,2,2,1,3
90794_0,,,,2,2,1,3
90795_0,,,,2,2,1,3
90796_0,,,,2,2,1,3
90797_0,,,,2,2,1,3
90798_0,,,,2,2,1,3
90799_0,,,,2,2,1,3
90800_0,,,,2,2,1,3
90801_0,,,,2,2,1,3
90802_0,,,,2,2,1,3
90803_0,,,,2,2,1,3
90804_0,,,,2,2,1,3
90805_0,,,,2,2,1,3
90806_0,,,,2,2,1,3
90807_0,,,,2,2,1,3
90808_0,,,,2,2,1,3
90810_0,,,,2,2,1,3
C(C(CCC(CO)(O)O)=O)(O)=O,,,5,1,1,0,1
90812_0,,,,2,2,1,3
C(C(C(CO)(O)O)CC=O)(O)=O,,,5,1,1,0,1
90814_0,,,,2,2,1,3
C(C(C(CO)(O)O)CC(O)=O)=O,,,5,1,1,0,1
90816_0,,,,2,2,1,3
C(CC(CO)(CO)C(CO)(O)O)=O,,,5,1,1,0,1
90818_0,,,,2,2,1,3
C(C(C(CO)(O)O)C(C=O)C)=O,,,5,1,1,0,1
90820_0,,,,2,2,1,3
C(C(C)(C(CO)(O)O)CC=O)=O,,,5,1,1,0,1
90822_0,,,,2,2,1,3
C(C(CC(CO)(O)O)CC=O)=O,,,5,1,1,0,1
90824_0,,,,2,2,1,3
C(C(CC(CO)(O)O)C(C=O)O)=O,,,5,1,1,0,1
90826_0,,,,2,2,1,3
C(C(C(CO)(O)O)CC(C)=O)=O,,,5,1,1,0,1
90828_0,,,,2,2,1,3
C(C)(C(C(CO)(O)O)CC=O)=O,,,5,1,1,0,1
90830_0,,,,2,2,1,3
C(C(CC(C)C(CO)(O)O)=O)=O,,,5,1,1,0,1
90832_0,,,,2,2,1,3
C(C(C(CO)(O)O)CC(C=O)=O)=O,,,5,1,1,0,1
90834_0,,,,2,2,1,3
C(CC(C(C=O)=O)C(CO)(O)O)=O,,,5,1,1,0,1
90836_0,,,,2,2,1,3
C(C(CC(CO)C(CO)(O)O)=O)=O,,,5,1,1,0,1
90838_0,,,,2,2,1,3
C(CC(C(CO)(O)O)CC=O)=O,,,5,1,1,0,1
90840_0,,,,2,2,1,3
C(CC(C(CO)(O)O)C(C=O)O)=O,,,5,1,1,0,1
90842_0,,,,2,2,1,3
C(C(C=O)C(C)C(CO)(O)O)=O,,,5,1,1,0,1
90844_0,,,,2,2,1,3
C(C(C=O)C(C=O)C(CO)(O)O)=O,,,5,1,1,0,1
90846_0,,,,2,2,1,3
C(C(C=O)(C(CO)(O)O)CC=O)=O,,,5,1,1,0,1
90848_0,,,,2,2,1,3
C(C(C=O)CC(CO)(O)O)=O,,,5,1,1,0,1
90850_0,,,,2,2,1,3
C(C(C=O)C(CO)C(CO)(O)O)=O,,,5,1,1,0,1
90852_0,,,,2,2,1,3
C(C(C(CO)CC(CO)(O)O)=O)=O,,,5,1,1,0,1
90854_0,,,,2,2,1,3
C(C(C(CO)(O)O)C(C=O)CO)=O,,,5,1,1,0,1
90856_0,,,,2,2,1,3
C(C(CO)(C(CO)(O)O)CC=O)=O,,,5,1,1,0,1
90858_0,,,,2,2,1,3
C(C(C(CO)=O)CC(CO)(O)O)=O,,,5,1,1,0,1
90860_0,,,,2,2,1,3
C(C(C(CCC(CO)(O)O)=O)O)=O,,,5,1,1,0,1
90862_0,,,,2,2,1,3
C(CC(C)C(CO)(O)O)=O,,,5,1,1,0,1
90864_0,,,,2,2,1,3
C(CO)(C(C(CO)(O)O)CC=O)=O,,,5,1,1,0,1
90866_0,,,,2,2,1,3
C(C(C(CO)(O)O)CC(CO)=O)=O,,,5,1,1,0,1
90868_0,,,,2,2,1,3
C(CC(C(CO)O)C(CO)(O)O)=O,,,5,1,1,0,1
90870_0,,,,2,2,1,3
C(CCC(CO)(O)O)=O,,,5,1,1,0,1
90872_0,,,,2,2,1,3
C(C(CC(CO)(O)O)C(C)O)(O)=O,,,5,1,1,0,1
90874_0,,,,2,2,1,3
C(C(CO)CC(CO)(O)O)(O)=O,,,5,1,1,0,1
90876_0,,,,2,2,1,3
C(C(C(C=O)=O)CC(CO)(O)O)=O,,,5,1,1,0,1
90878_0,,,,2,2,1,3
C1(CC(CO1)C(CO)(O)O)=O,,,5,1,1,0,1
90880_0,,,,2,2,1,3
C(C(C(CO)(O)O)CC(O)=O)(O)=O,,,5,1,1,0,1
90881_0,,,,2,2,1,3
90882_0,,,,2,2,1,3
90883_0,,,,2,2,1,3
90884_0,,,,2,2,1,3
90886_0,,,,2,2,1,3
C(C(CCC(C(O)O)O)=O)(O)=O,,,5,1,1,0,1
90888_0,,,,2,2,1,3
C(C(C(C(O)O)O)CC=O)(O)=O,,,5,1,1,0,1
90890_0,,,,2,2,1,3
C(C(C(C(O)O)O)CC(O)=O)=O,,,5,1,1,0,1
90892_0,,,,2,2,1,3
C(CC(CO)(CO)C(C(O)O)O)=O,,,5,1,1,0,1
90894_0,,,,2,2,1,3
C(C(C(C(O)O)O)C(C=O)C)=O,,,5,1,1,0,1
90896_0,,,,2,2,1,3
C(C(C)(C(C(O)O)O)CC=O)=O,,,5,1,1,0,1
90898_0,,,,2,2,1,3
C(C(CC(C(O)O)O)CC=O)=O,,,5,1,1,0,1
90900_0,,,,2,2,1,3
C(C(CC(C(O)O)O)C(C=O)O)=O,,,5,1,1,0,1
90902_0,,,,2,2,1,3
C(C(C(C(O)O)O)CC(C)=O)=O,,,5,1,1,0,1
90904_0,,,,2,2,1,3
C(C)(C(C(C(O)O)O)CC=O)=O,,,5,1,1,0,1
90906_0,,,,2,2,1,3
C(C(CC(C)C(C(O)O)O)=O)=O,,,5,1,1,0,1
90907_0,,,,2,2,1,3
90908_0,,,,2,2,1,3
90910_0,,,,2,2,1,3
C(C(CC(CO)C(C(O)O)O)=O)=O,,,5,1,1,0,1
90912_0,,,,2,2,1,3
C(CC(C(C(O)O)O)CC=O)=O,,,5,1,1,0,1
90914_0,,,,2,2,1,3
C(CC(C(C(O)O)O)C(C=O)O)=O,,,5,1,1,0,1
90916_0,,,,2,2,1,3
C(C(C=O)C(C)C(C(O)O)O)=O,,,5,1,1,0,1
90917_0,,,,2,2,1,3
90918_0,,,,2,2,1,3
90920_0,,,,2,2,1,3
C(C(C=O)CC(C(O)O)O)=O,,,5,1,1,0,1
90922_0,,,,2,2,1,3
C(C(C=O)C(CO)C(C(O)O)O)=O,,,5,1,1,0,1
90924_0,,,,2,2,1,3
C(C(C(CO)CC(C(O)O)O)=O)=O,,,5,1,1,0,1
90925_0,,,,2,2,1,3
90926_0,,,,2,2,1,3
90928_0,,,,2,2,1,3
C(C(C(CO)=O)CC(C(O)O)O)=O,,,5,1,1,0,1
90930_0,,,,2,2,1,3
C(C(C(CCC(C(O)O)O)=O)O)=O,,,5,1,1,0,1
90932_0,,,,2,2,1,3
C(CC(C)C(C(O)O)O)=O,,,5,1,1,0,1
90933_0,,,,2,2,1,3
90934_0,,,,2,2,1,3
90936_0,,,,2,2,1,3
C(CC(C(C(O)O)O)C(CO)O)=O,,,5,1,1,0,1
90938_0,,,,2,2,1,3
C(CCC(C(O)O)O)=O,,,5,1,1,0,1
90940_0,,,,2,2,1,3
C(C(CC(C(O)O)O)C(C)O)(O)=O,,,5,1,1,0,1
90942_0,,,,2,2,1,3
C(C(CO)CC(C(O)O)O)(O)=O,,,5,1,1,0,1
90944_0,,,,2,2,1,3
C(C(C(C=O)=O)CC(C(O)O)O)=O,,,5,1,1,0,1
90946_0,,,,2,2,1,3
C1(CC(CO1)C(C(O)O)O)=O,,,5,1,1,0,1
90948_0,,,,2,2,1,3
C(C(C(C(O)O)O)CC(O)=O)(O)=O,,,5,1,1,0,1
90950_0,,,,2,2,1,3
C(C(CCC(C(O)O)O)=O)=O,,,5,1,1,0,1
90951_0,,,,2,2,1,3
90953_0,,,,2,2,1,3
C(CCC(C(O)O)O)(O)=O,,,5,1,1,0,1
90955_0,,,,2,2,1,3
C(CC(CO)C(C(O)O)O)(O)=O,,,5,1,1,0,1
90957_0,,,,2,2,1,3
C(C(CCC(C)(CO)O)=O)(O)=O,,,5,1,1,0,1
90959_0,,,,2,2,1,3
C(C(C(C)(CO)O)CC=O)(O)=O,,,5,1,1,0,1
90961_0,,,,2,2,1,3
C(C(C(C)(CO)O)CC(O)=O)=O,,,5,1,1,0,1
90963_0,,,,2,2,1,3
C(CC(CO)(CO)C(C)(CO)O)=O,,,5,1,1,0,1
90965_0,,,,2,2,1,3
C(C(C(C)(CO)O)C(C=O)C)=O,,,5,1,1,0,1
90967_0,,,,2,2,1,3
C(C(C)(C(C)(CO)O)CC=O)=O,,,5,1,1,0,1
90969_0,,,,2,2,1,3
C(C(CC(C)(CO)O)CC=O)=O,,,5,1,1,0,1
90971_0,,,,2,2,1,3
C(C(CC(CO)(C)O)C(C=O)O)=O,,,5,1,1,0,1
90973_0,,,,2,2,1,3
C(C(C(C)(CO)O)CC(C)=O)=O,,,5,1,1,0,1
90975_0,,,,2,2,1,3
C(C)(C(C(C)(CO)O)CC=O)=O,,,5,1,1,0,1
90977_0,,,,2,2,1,3
C(C(CC(C)C(C)(CO)O)=O)=O,,,5,1,1,0,1
90978_0,,,,2,2,1,3
90979_0,,,,2,2,1,3
90981_0,,,,2,2,1,3
C(C(CC(CO)C(C)(CO)O)=O)=O,,,5,1,1,0,1
90983_0,,,,2,2,1,3
C(CC(C(C)(CO)O)CC=O)=O,,,5,1,1,0,1
90985_0,,,,2,2,1,3
C(CC(C(CO)(C)O)C(C=O)O)=O,,,5,1,1,0,1
90987_0,,,,2,2,1,3
C(C(C=O)C(C)C(C)(CO)O)=O,,,5,1,1,0,1
90988_0,,,,2,2,1,3
90989_0,,,,2,2,1,3
90991_0,,,,2,2,1,3
C(C(C=O)CC(C)(CO)O)=O,,,5,1,1,0,1
90993_0,,,,2,2,1,3
C(C(C=O)C(CO)C(C)(CO)O)=O,,,5,1,1,0,1
90995_0,,,,2,2,1,3
C(C(C(CO)CC(C)(CO)O)=O)=O,,,5,1,1,0,1
90996_0,,,,2,2,1,3
90997_0,,,,2,2,1,3
90999_0,,,,2,2,1,3
C(C(C(CO)=O)CC(CO)(C)O)=O,,,5,1,1,0,1
91001_0,,,,2,2,1,3
C(C(C(CCC(CO)(C)O)=O)O)=O,,,5,1,1,0,1
91003_0,,,,2,2,1,3
C(CC(C)C(C)(CO)O)=O,,,5,1,1,0,1
91004_0,,,,2,2,1,3
91005_0,,,,2,2,1,3
91007_0,,,,2,2,1,3
C(CC(C(CO)O)C(C)(CO)O)=O,,,5,1,1,0,1
91009_0,,,,2,2,1,3
C(CCC(C)(CO)O)=O,,,5,1,1,0,1
91011_0,,,,2,2,1,3
C(C(CC(C)(CO)O)C(C)O)(O)=O,,,5,1,1,0,1
91013_0,,,,2,2,1,3
C(C(CO)CC(C)(CO)O)(O)=O,,,5,1,1,0,1
91015_0,,,,2,2,1,3
C(C(C(C=O)=O)CC(C)(CO)O)=O,,,5,1,1,0,1
91017_0,,,,2,2,1,3
C1(CC(CO1)C(C)(CO)O)=O,,,5,1,1,0,1
91019_0,,,,2,2,1,3
C(C(C(C)(CO)O)CC(O)=O)(O)=O,,,5,1,1,0,1
91020_0,,,,2,2,1,3
91021_0,,,,2,2,1,3
91022_0,,,,2,2,1,3
91023_0,,,,2,2,1,3
91025_0,,,,2,2,1,3
C(C(CCC(C(C)O)O)=O)(O)=O,,,5,1,1,0,1
91027_0,,,,2,2,1,3
C(C(C(C(C)O)O)CC=O)(O)=O,,,5,1,1,0,1
91029_0,,,,2,2,1,3
C(C(C(C(C)O)O)CC(O)=O)=O,,,5,1,1,0,1
91031_0,,,,2,2,1,3
C(CC(CO)(CO)C(C(C)O)O)=O,,,5,1,1,0,1
91033_0,,,,2,2,1,3
C(C(C(C(C)O)O)C(C=O)C)=O,,,5,1,1,0,1
91035_0,,,,2,2,1,3
C(C(C)(C(C(C)O)O)CC=O)=O,,,5,1,1,0,1
91037_0,,,,2,2,1,3
C(C(CC(C(C)O)O)CC=O)=O,,,5,1,1,0,1
91039_0,,,,2,2,1,3
C(C(CC(C(C)O)O)C(C=O)O)=O,,,5,1,1,0,1
91041_0,,,,2,2,1,3
C(C(C(C(C)O)O)CC(C)=O)=O,,,5,1,1,0,1
91043_0,,,,2,2,1,3
C(C)(C(C(C(C)O)O)CC=O)=O,,,5,1,1,0,1
91045_0,,,,2,2,1,3
C(C(CC(C)C(C(C)O)O)=O)=O,,,5,1,1,0,1
91046_0,,,,2,2,1,3
91047_0,,,,2,2,1,3
91049_0,,,,2,2,1,3
C(C(CC(CO)C(C(C)O)O)=O)=O,,,5,1,1,0,1
91051_0,,,,2,2,1,3
C(CC(C(C(C)O)O)CC=O)=O,,,5,1,1,0,1
91053_0,,,,2,2,1,3
C(CC(C(C(C)O)O)C(C=O)O)=O,,,5,1,1,0,1
91055_0,,,,2,2,1,3
C(C(C=O)C(C)C(C(C)O)O)=O,,,5,1,1,0,1
91056_0,,,,2,2,1,3
91057_0,,,,2,2,1,3
91059_0,,,,2,2,1,3
C(C(C=O)CC(C(C)O)O)=O,,,5,1,1,0,1
91061_0,,,,2,2,1,3
C(C(C=O)C(CO)C(C(C)O)O)=O,,,5,1,1,0,1
91063_0,,,,2,2,1,3
C(C(C(CO)CC(C(C)O)O)=O)=O,,,5,1,1,0,1
91064_0,,,,2,2,1,3
91065_0,,,,2,2,1,3
91067_0,,,,2,2,1,3
C(C(C(CO)=O)CC(C(C)O)O)=O,,,5,1,1,0,1
91069_0,,,,2,2,1,3
C(C(C(CCC(C(C)O)O)=O)O)=O,,,5,1,1,0,1
91071_0,,,,2,2,1,3
C(CC(C)C(C(C)O)O)=O,,,5,1,1,0,1
91072_0,,,,2,2,1,3
91073_0,,,,2,2,1,3
91075_0,,,,2,2,1,3
C(CC(C(C(C)O)O)C(CO)O)=O,,,5,1,1,0,1
91077_0,,,,2,2,1,3
C(CCC(C(C)O)O)=O,,,5,1,1,0,1
91079_0,,,,2,2,1,3
C(C(CC(C(C)O)O)C(C)O)(O)=O,,,5,1,1,0,1
91081_0,,,,2,2,1,3
C(C(CO)CC(C(C)O)O)(O)=O,,,5,1,1,0,1
91083_0,,,,2,2,1,3
C(C(C(C=O)=O)CC(C(C)O)O)=O,,,5,1,1,0,1
91085_0,,,,2,2,1,3
C1(CC(CO1)C(C(C)O)O)=O,,,5,1,1,0,1
91087_0,,,,2,2,1,3
C(C(C(C(C)O)O)CC(O)=O)(O)=O,,,5,1,1,0,1
91089_0,,,,2,2,1,3
C(C(CCC(C(C)O)O)=O)=O,,,5,1,1,0,1
91090_0,,,,2,2,1,3
91092_0,,,,2,2,1,3
C(CCC(C(C)O)O)(O)=O,,,5,1,1,0,1
91094_0,,,,2,2,1,3
C(CC(CO)C(C(C)O)O)(O)=O,,,5,1,1,0,1
91096_0,,,,2,2,1,3
C(C(CCCC(CO)O)=O)(O)=O,,,5,1,1,0,1
91098_0,,,,2,2,1,3
C(C(CC(CO)O)CC=O)(O)=O,,,5,1,1,0,1
91100_0,,,,2,2,1,3
C(C(CC(CO)O)CC(O)=O)=O,,,5,1,1,0,1
91102_0,,,,2,2,1,3
C(CC(CO)(CO)CC(CO)O)=O,,,5,1,1,0,1
91104_0,,,,2,2,1,3
C(C(CC(CO)O)C(C=O)C)=O,,,5,1,1,0,1
91106_0,,,,2,2,1,3
C(C(C)(CC(CO)O)CC=O)=O,,,5,1,1,0,1
91108_0,,,,2,2,1,3
C(C(CCC(CO)O)CC=O)=O,,,5,1,1,0,1
91110_0,,,,2,2,1,3
C(C(CCC(CO)O)C(C=O)O)=O,,,5,1,1,0,1
91112_0,,,,2,2,1,3
C(C(CC(CO)O)CC(C)=O)=O,,,5,1,1,0,1
91114_0,,,,2,2,1,3
C(C)(C(CC(CO)O)CC=O)=O,,,5,1,1,0,1
91116_0,,,,2,2,1,3
C(C(CC(C)CC(CO)O)=O)=O,,,5,1,1,0,1
91118_0,,,,2,2,1,3
C(C(CC(CO)O)CC(C=O)=O)=O,,,5,1,2,0,2
91120_0,,,,2,2,1,3
C(CC(C(C=O)=O)CC(CO)O)=O,,,5,1,1,0,1
91122_0,,,,2,2,1,3
C(C(CC(CO)CC(CO)O)=O)=O,,,5,1,1,0,1
91124_0,,,,2,2,1,3
C(CC(CC(CO)O)CC=O)=O,,,5,1,1,0,1
91126_0,,,,2,2,1,3
C(CC(CC(CO)O)C(C=O)O)=O,,,5,1,1,0,1
91128_0,,,,2,2,1,3
C(C(C=O)C(C)CC(CO)O)=O,,,5,1,1,0,1
91130_0,,,,2,2,1,3
C(C(C=O)C(C=O)CC(CO)O)=O,,,5,1,2,0,2
91132_0,,,,2,2,1,3
C(C(C=O)(CC(CO)O)CC=O)=O,,,5,1,1,0,1
91134_0,,,,2,2,1,3
C(C(C=O)CCC(CO)O)=O,,,5,1,1,0,1
91136_0,,,,2,2,1,3
C(C(C=O)C(CO)CC(CO)O)=O,,,5,1,1,0,1
91138_0,,,,2,2,1,3
C(C(C(CO)CCC(CO)O)=O)=O,,,5,1,1,0,1
91140_0,,,,2,2,1,3
C(C(CC(CO)O)C(C=O)CO)=O,,,5,1,1,0,1
91142_0,,,,2,2,1,3
C(C(CO)(CC(CO)O)CC=O)=O,,,5,1,1,0,1
91144_0,,,,2,2,1,3
C(C(C(CO)=O)CCC(CO)O)=O,,,5,1,1,0,1
91146_0,,,,2,2,1,3
C(C(C(CCCC(CO)O)=O)O)=O,,,5,1,1,0,1
91148_0,,,,2,2,1,3
C(CC(C)CC(CO)O)=O,,,5,1,1,0,1
91150_0,,,,2,2,1,3
C(CO)(C(CC(CO)O)CC=O)=O,,,5,1,1,0,1
91152_0,,,,2,2,1,3
C(C(CC(CO)O)CC(CO)=O)=O,,,5,1,1,0,1
91154_0,,,,2,2,1,3
C(CC(CC(CO)O)C(CO)O)=O,,,5,1,1,0,1
91156_0,,,,2,2,1,3
C(CCCC(CO)O)=O,,,5,1,1,0,1
91158_0,,,,2,2,1,3
C(C(CCC(CO)O)C(C)O)(O)=O,,,5,1,1,0,1
91160_0,,,,2,2,1,3
C(C(CO)CCC(CO)O)(O)=O,,,5,1,1,0,1
91162_0,,,,2,2,1,3
C(C(C(C=O)=O)CCC(CO)O)=O,,,5,1,1,0,1
91164_0,,,,2,2,1,3
C1(CC(CO1)CC(CO)O)=O,,,5,1,1,0,1
91166_0,,,,2,2,1,3
C(C(CC(CO)O)CC(O)=O)(O)=O,,,5,1,1,0,1
91167_0,,,,2,2,1,3
91168_0,,,,2,2,1,3
91169_0,,,,2,2,1,3
91170_0,,,,2,2,1,3
91172_0,,,,2,2,1,3
C(C(CCC=O)C(C=O)(C)O)(O)=O,,,5,1,2,0,2
91174_0,,,,2,2,1,3
C(CCCC(C=O)(CC(O)=O)O)=O,,,5,1,1,0,1
91176_0,,,,2,2,1,3
C(C(CCC=O)C(C(C)=O)O)(O)=O,,,5,1,2,0,2
91178_0,,,,2,2,1,3
C(C)(C(CCC=O)(CC(O)=O)O)=O,,,5,1,1,0,1
91180_0,,,,2,2,1,3
C(CC(C(CCCC=O)=O)O)(O)=O,,,5,1,1,0,1
91182_0,,,,2,2,1,3
C(C(C=O)CC(C(O)=O)C(C)O)=O,,,5,1,2,0,2
91184_0,,,,2,2,1,3
C(C(C(C)CC=O)C(C)O)(O)=O,,,5,1,1,0,1
91186_0,,,,2,2,1,3
C(C(CCC=O)C(C)O)(O)=O,,,5,1,2,0,2
91188_0,,,,2,2,1,3
C(C(C1COC(C1)=O)C(C)O)(O)=O,,,5,1,1,0,1
91189_0,,,,2,2,1,3
91190_0,,,,2,2,1,3
91191_0,,,,2,2,1,3
91193_0,,,,2,2,1,3
C(C(C=O)CC(C)(CC(O)=O)O)=O,,,5,1,1,0,1
91195_0,,,,2,2,1,3
C(CC(C)(C(C)CC=O)O)(O)=O,,,5,1,1,0,1
91197_0,,,,2,2,1,3
C(CC(C)(CCC=O)O)(O)=O,,,5,1,1,0,1
91199_0,,,,2,2,1,3
C1(CC(CO1)C(C)(CC(O)=O)O)=O,,,5,1,1,0,1
91200_0,,,,2,2,1,3
91201_0,,,,2,2,1,3
91202_0,,,,2,2,1,3
91204_0,,,,2,2,1,3
C(C(C=O)CCC(CC(O)=O)O)=O,,,5,1,1,0,1
91206_0,,,,2,2,1,3
C(CC(CC(C)CC=O)O)(O)=O,,,5,1,1,0,1
91208_0,,,,2,2,1,3
C(CC(CCCC=O)O)(O)=O,,,5,1,1,0,1
91210_0,,,,2,2,1,3
C1(CC(CO1)CC(CC(O)=O)O)=O,,,5,1,1,0,1
91211_0,,,,2,2,1,3
91212_0,,,,2,2,1,3
91213_0,,,,2,2,1,3
91215_0,,,,2,2,1,3
C(C(C=O)CC(C(O)=O)C(O)=O)=O,,,5,1,1,0,1
91217_0,,,,2,2,1,3
C(CC(C)C(C(O)=O)C(O)=O)=O,,,5,1,1,0,1
91219_0,,,,2,2,1,3
C(CCC(C(O)=O)C(O)=O)=O,,,5,1,1,0,1
91221_0,,,,2,2,1,3
C1(CC(CO1)C(C(O)=O)C(O)=O)=O,,,5,1,1,0,1
91222_0,,,,2,2,1,3
91223_0,,,,2,2,1,3
91224_0,,,,2,2,1,3
91226_0,,,,2,2,1,3
C(CC(C)CC(C(C(O)=O)=O)=O)=O,,,5,1,1,0,1
91228_0,,,,2,2,1,3
C(CCCC(C(C(O)=O)=O)=O)=O,,,5,1,1,0,1
91229_0,,,,2,2,1,3
91231_0,,,,2,2,1,3
C(C(CCC(C(O)=O)=O)(O)O)(O)=O,,,5,1,1,0,1
91233_0,,,,2,2,1,3
C(C=O)(C(C)CCC(C(O)=O)=O)=O,,,5,1,1,0,1
91235_0,,,,2,2,1,3
C(C(CCCCC(C(O)=O)=O)=O)=O,,,5,1,2,0,2
91237_0,,,,2,2,1,3
C(C(CCC(C(O)=O)=O)CC=O)=O,,,5,1,3,0,3
91239_0,,,,2,2,1,3
C(C(C)=O)(CCCC(C(O)=O)=O)=O,,,5,1,1,0,1
91241_0,,,,2,2,1,3
C(C(O)=O)(CCCC(C=O)=CC=O)=O,,,5,1,1,0,1
91243_0,,,,2,2,1,3
C(C(C(C=O)=C)CCC(C(O)=O)=O)=O,,,5,1,1,0,1
91245_0,,,,2,2,1,3
C(C(O)=O)(CCCC(C=CC=O)=O)=O,,,5,1,1,0,1
91247_0,,,,2,2,1,3
C=CC(C(C=O)=O)CCC(C(O)=O)=O,,,5,1,1,0,1
91249_0,,,,2,2,1,3
C(CCCC(C(O)=O)=O)=CC(C=O)=O,,,5,1,1,0,1
91251_0,,,,2,2,1,3
C(C(C=CC=O)CCC(C(O)=O)=O)=O,,,5,1,1,0,1
91253_0,,,,2,2,1,3
C(C(C=O)(C=C)CCC(C(O)=O)=O)=O,,,5,1,1,0,1
91255_0,,,,2,2,1,3
C(CCCC(C(O)=O)=O)=C(C=O)C=O,,,5,1,1,0,1
91257_0,,,,2,2,1,3
C(CCCC(C(O)=O)=O)=CC=O,,,5,1,1,0,1
91259_0,,,,2,2,1,3
C(C(C=C)CCC(C(O)=O)=O)=O,,,5,1,1,0,1
91261_0,,,,2,2,1,3
C(C(C=C)(CCC(C(O)=O)=O)O)=O,,,5,1,1,0,1
91263_0,,,,2,2,1,3
C1C(CCC(C(O)=O)=O)OC(C=1)=O,,,5,1,1,0,1
91265_0,,,,2,2,1,3
C1OC(C(C=1)=O)CCC(C(O)=O)=O,,,5,1,1,0,1
91267_0,,,,2,2,1,3
C=CC(CCC(C(O)=O)=O)O,,,5,1,1,0,1
91269_0,,,,2,2,1,3
[C](C(O)=O)(CCCC(C(O)=O)=O)O,,,5,1,1,0,1
91270_0,,,,2,2,1,3
91271_0,,,,2,2,1,3
91272_0,,,,2,2,1,3
91273_0,,,,2,2,1,3
91274_0,,,,2,2,1,3
91275_0,,,,2,2,1,3
91276_0,,,,2,2,1,3
91277_0,,,,2,2,1,3
91278_0,,,,2,2,1,3
91279_0,,,,2,2,1,3
91280_0,,,,2,2,1,3
91281_0,,,,2,2,1,3
91282_0,,,,2,2,1,3
91283_0,,,,2,2,1,3
91284_0,,,,2,2,1,3
91285_0,,,,2,2,1,3
91286_0,,,,2,2,1,3
91287_0,,,,2,2,1,3
91288_0,,,,2,2,1,3
91289_0,,,,2,2,1,3
91290_0,,,,2,2,1,3
91291_0,,,,2,2,1,3
91292_0,,,,2,2,1,3
91293_0,,,,2,2,1,3
91294_0,,,,2,2,1,3
91295_0,,,,2,2,1,3
91296_0,,,,2,2,1,3
91297_0,,,,2,2,1,3
91298_0,,,,2,2,1,3
91299_0,,,,2,2,1,3
91300_0,,,,2,2,1,3
91301_0,,,,2,2,1,3
91303_0,,,,2,2,1,3
C(C(C(C(O)=O)CC=O)(O)O)(O)=O,,,5,1,1,0,1
91305_0,,,,2,2,1,3
C(CC(C(O)=O)C(C(C=O)=O)C)=O,,,5,1,1,0,1
91307_0,,,,2,2,1,3
C(CC(C(O)=O)CCC(C=O)=O)=O,,,5,1,1,0,1
91309_0,,,,2,2,1,3
C(CC(C=O)C(C(O)=O)CC=O)=O,,,5,1,1,0,1
91311_0,,,,2,2,1,3
C(CC(C(O)=O)CC(C(C)=O)=O)=O,,,5,1,1,0,1
91313_0,,,,2,2,1,3
C(CC(C(O)=O)CC(C=O)=CC=O)=O,,,5,1,1,0,1
91315_0,,,,2,2,1,3
C(C(C(C=O)=C)C(C(O)=O)CC=O)=O,,,5,1,1,0,1
91317_0,,,,2,2,1,3
C(CC(C(O)=O)CC(C=CC=O)=O)=O,,,5,1,1,0,1
91319_0,,,,2,2,1,3
C(CC(C(O)=O)C(C=C)C(C=O)=O)=O,,,5,1,1,0,1
91321_0,,,,2,2,1,3
C(CC(C(O)=O)CC=CC(C=O)=O)=O,,,5,1,1,0,1
91323_0,,,,2,2,1,3
C(C(C=CC=O)C(C(O)=O)CC=O)=O,,,5,1,1,0,1
91325_0,,,,2,2,1,3
C(C(C=O)(C=C)C(C(O)=O)CC=O)=O,,,5,1,1,0,1
91327_0,,,,2,2,1,3
C(CC(C(O)=O)CC=C(C=O)C=O)=O,,,5,1,1,0,1
91329_0,,,,2,2,1,3
C(CC(C(O)=O)CC=CC=O)=O,,,5,1,1,0,1
91331_0,,,,2,2,1,3
C(C(C=C)C(C(O)=O)CC=O)=O,,,5,1,1,0,1
91333_0,,,,2,2,1,3
C(C(C=C)(C(C(O)=O)CC=O)O)=O,,,5,1,1,0,1
91335_0,,,,2,2,1,3
C(CC(C(O)=O)C1C=CC(O1)=O)=O,,,5,1,1,0,1
91337_0,,,,2,2,1,3
C(CC(C(O)=O)C1C(C=CO1)=O)=O,,,5,1,1,0,1
91339_0,,,,2,2,1,3
C(C(CC=O)C(C=C)O)(O)=O,,,5,1,1,0,1
91341_0,,,,2,2,1,3
C(CC(C(O)=O)C[C](C(O)=O)O)=O,,,5,1,1,0,1
91342_0,,,,2,2,1,3
91343_0,,,,2,2,1,3
91344_0,,,,2,2,1,3
91345_0,,,,2,2,1,3
91346_0,,,,2,2,1,3
91347_0,,,,2,2,1,3
91348_0,,,,2,2,1,3
91349_0,,,,2,2,1,3
91350_0,,,,2,2,1,3
91351_0,,,,2,2,1,3
91352_0,,,,2,2,1,3
91353_0,,,,2,2,1,3
91354_0,,,,2,2,1,3
91355_0,,,,2,2,1,3
91356_0,,,,2,2,1,3
91357_0,,,,2,2,1,3
91358_0,,,,2,2,1,3
91359_0,,,,2,2,1,3
91360_0,,,,2,2,1,3
91361_0,,,,2,2,1,3
91362_0,,,,2,2,1,3
91363_0,,,,2,2,1,3
91364_0,,,,2,2,1,3
91365_0,,,,2,2,1,3
91366_0,,,,2,2,1,3
91367_0,,,,2,2,1,3
91368_0,,,,2,2,1,3
91369_0,,,,2,2,1,3
91370_0,,,,2,2,1,3
91371_0,,,,2,2,1,3
91372_0,,,,2,2,1,3
91373_0,,,,2,2,1,3
91375_0,,,,2,2,1,3
C(CC(C=O)C(C(O)=O)(O)O)(O)=O,,,5,1,1,0,1
91377_0,,,,2,2,1,3
C(C(CC(O)=O)C(C(C=O)=O)C)=O,,,5,1,1,0,1
91379_0,,,,2,2,1,3
C(C(CCC(C=O)=O)CC(O)=O)=O,,,5,1,1,0,1
91381_0,,,,2,2,1,3
C(CC(C=O)C(C=O)CC(O)=O)=O,,,5,1,1,0,1
91383_0,,,,2,2,1,3
C(C(CC(O)=O)CC(C(C)=O)=O)=O,,,5,1,1,0,1
91385_0,,,,2,2,1,3
C(C(CC(O)=O)CC(C=O)=CC=O)=O,,,5,1,1,0,1
91387_0,,,,2,2,1,3
C(C(C(C=O)=C)C(C=O)CC(O)=O)=O,,,5,1,1,0,1
91389_0,,,,2,2,1,3
C(C(CC(O)=O)CC(C=CC=O)=O)=O,,,5,1,1,0,1
91391_0,,,,2,2,1,3
C(C(CC(O)=O)C(C=C)C(C=O)=O)=O,,,5,1,1,0,1
91393_0,,,,2,2,1,3
C(C(CC(O)=O)CC=CC(C=O)=O)=O,,,5,1,1,0,1
91395_0,,,,2,2,1,3
C(C(C=CC=O)C(C=O)CC(O)=O)=O,,,5,1,1,0,1
91397_0,,,,2,2,1,3
C(C(C=O)(C=C)C(C=O)CC(O)=O)=O,,,5,1,1,0,1
91399_0,,,,2,2,1,3
C(C(CC(O)=O)CC=C(C=O)C=O)=O,,,5,1,1,0,1
91401_0,,,,2,2,1,3
C(C(CC(O)=O)CC=CC=O)=O,,,5,1,1,0,1
91403_0,,,,2,2,1,3
C(C(C=C)C(C=O)CC(O)=O)=O,,,5,1,1,0,1
91405_0,,,,2,2,1,3
C(C(C=C)(C(C=O)CC(O)=O)O)=O,,,5,1,1,0,1
91407_0,,,,2,2,1,3
C(C(CC(O)=O)C1C=CC(O1)=O)=O,,,5,1,1,0,1
91409_0,,,,2,2,1,3
C(C(CC(O)=O)C1C(C=CO1)=O)=O,,,5,1,1,0,1
91411_0,,,,2,2,1,3
C(CC(C=O)C(C=C)O)(O)=O,,,5,1,1,0,1
91413_0,,,,2,2,1,3
C(C(CC(O)=O)C[C](C(O)=O)O)=O,,,5,1,1,0,1
91414_0,,,,2,2,1,3
91415_0,,,,2,2,1,3
91416_0,,,,2,2,1,3
91417_0,,,,2,2,1,3
91418_0,,,,2,2,1,3
91419_0,,,,2,2,1,3
91420_0,,,,2,2,1,3
91421_0,,,,2,2,1,3
91422_0,,,,2,2,1,3
91423_0,,,,2,2,1,3
91424_0,,,,2,2,1,3
91425_0,,,,2,2,1,3
91426_0,,,,2,2,1,3
91427_0,,,,2,2,1,3
91428_0,,,,2,2,1,3
91429_0,,,,2,2,1,3
91430_0,,,,2,2,1,3
91431_0,,,,2,2,1,3
91432_0,,,,2,2,1,3
91433_0,,,,2,2,1,3
91434_0,,,,2,2,1,3
91435_0,,,,2,2,1,3
91436_0,,,,2,2,1,3
91437_0,,,,2,2,1,3
91438_0,,,,2,2,1,3
91439_0,,,,2,2,1,3
91440_0,,,,2,2,1,3
91441_0,,,,2,2,1,3
91442_0,,,,2,2,1,3
91443_0,,,,2,2,1,3
91444_0,,,,2,2,1,3
91445_0,,,,2,2,1,3
91447_0,,,,2,2,1,3
C(C(C(C(O)=O)(O)O)C(C=O)C)=O,,,5,1,1,0,1
91449_0,,,,2,2,1,3
C(CC(C=O)(C)C(C(O)=O)(O)O)=O,,,5,1,1,0,1
91451_0,,,,2,2,1,3
C(C(CC(C=O)CC=O)(O)O)(O)=O,,,5,1,1,0,1
91453_0,,,,2,2,1,3
C(C(C(C=O)CC(C)=O)(O)O)(O)=O,,,5,1,1,0,1
91455_0,,,,2,2,1,3
C(C(C(C(C)=O)CC=O)(O)O)(O)=O,,,5,1,1,0,1
91457_0,,,,2,2,1,3
C(C(C(C)CC(C=O)=O)(O)O)(O)=O,,,5,1,1,0,1
91459_0,,,,2,2,1,3
C(CC(C(C(O)=O)(O)O)CC=O)=O,,,5,1,1,0,1
91461_0,,,,2,2,1,3
C(C(C=O)C(C)C(C(O)=O)(O)O)=O,,,5,1,1,0,1
91463_0,,,,2,2,1,3
C(C(C=O)CC(C(O)=O)(O)O)=O,,,5,1,1,0,1
91465_0,,,,2,2,1,3
C(CC(C)C(C(O)=O)(O)O)=O,,,5,1,1,0,1
91467_0,,,,2,2,1,3
C(CCC(C(O)=O)(O)O)=O,,,5,1,1,0,1
91469_0,,,,2,2,1,3
C(C(CO)CC(C(O)=O)(O)O)(O)=O,,,5,1,1,0,1
91471_0,,,,2,2,1,3
C1(CC(CO1)C(C(O)=O)(O)O)=O,,,5,1,1,0,1
91472_0,,,,2,2,1,3
91473_0,,,,2,2,1,3
91474_0,,,,2,2,1,3
91475_0,,,,2,2,1,3
91476_0,,,,2,2,1,3
91478_0,,,,2,2,1,3
C(C(C=O)(C(C)(CCC=O)O)O)=O,,,5,1,1,0,1
91480_0,,,,2,2,1,3
C(C(C=O)(C(CCCC=O)O)O)=O,,,5,1,1,0,1
91481_0,,,,2,2,1,3
91483_0,,,,2,2,1,3
C(CCC1C(C(CO)(CO1)O)=O)=O,,,5,1,1,0,1
91485_0,,,,2,2,1,3
C(CCC1C(C(CO1)=O)(CO)O)=O,,,5,1,1,0,1
91486_0,,,,2,2,1,3
91488_0,,,,2,2,1,3
C1(C(CCC=O)(CO)C(CO1)O)=O,,,5,1,1,0,1
91490_0,,,,2,2,1,3
C1(C(CO)C(C(CCC=O)O1)O)=O,,,5,1,1,0,1
91492_0,,,,2,2,1,3
C1(C(CO)C(CO1)(CCC=O)O)=O,,,5,1,1,0,1
91493_0,,,,2,2,1,3
91495_0,,,,2,2,1,3
C(CCCC(C(C=O)=O)(CO)O)=O,,,5,1,1,0,1
91496_0,,,,2,2,1,3
91498_0,,,,2,2,1,3
C(CCC1CC(C(CO)(O)O1)=O)=O,,,5,1,1,0,1
91500_0,,,,2,2,1,3
C(CCC1C(C(CO)(O)OC1)=O)=O,,,5,1,1,0,1
91501_0,,,,2,2,1,3
91502_0,,,,2,2,1,3
91503_0,,,,2,2,1,3
91504_0,,,,2,2,1,3
91505_0,,,,2,2,1,3
91506_0,,,,2,2,1,3
91507_0,,,,2,2,1,3
91508_0,,,,2,2,1,3
91509_0,,,,2,2,1,3
91511_0,,,,2,2,1,3
C(C(C(O)=O)(C(C)CC=O)O)(O)=O,,,5,1,1,0,1
91512_0,,,,2,2,1,3
91513_0,,,,2,2,1,3
91515_0,,,,2,2,1,3
C(C(C(O)=O)(CCCC=O)O)(O)=O,,,5,1,1,0,1
91516_0,,,,2,2,1,3
91518_0,,,,2,2,1,3
C1(C(CO)(CC(CCC=O)O1)O)=O,,,5,1,1,0,1
91520_0,,,,2,2,1,3
C1(C(CO)(C(CO1)CCC=O)O)=O,,,5,1,1,0,1
91521_0,,,,2,2,1,3
91523_0,,,,2,2,1,3
C(CC(C)C(C)(C(C=O)(O)O)O)=O,,,5,1,1,0,1
91525_0,,,,2,2,1,3
C(CCC(C)(C(C=O)(O)O)O)=O,,,5,1,1,0,1
91527_0,,,,2,2,1,3
C(CCC(C)(C(C=O)(O)O)O)(O)=O,,,5,1,1,0,1
91529_0,,,,2,2,1,3
C(CC(C)CC(C(C=O)(O)O)O)=O,,,5,1,1,0,1
91531_0,,,,2,2,1,3
C(CCCC(C(C=O)(O)O)O)=O,,,5,1,1,0,1
91532_0,,,,2,2,1,3
91533_0,,,,2,2,1,3
91535_0,,,,2,2,1,3
C(CC(C)C(C(C=O)(O)O)O)=O,,,5,1,1,0,1
91536_0,,,,2,2,1,3
91538_0,,,,2,2,1,3
C1(CC(CO1)C(C(C=O)(O)O)O)=O,,,5,1,1,0,1
91539_0,,,,2,2,1,3
91540_0,,,,2,2,1,3
91542_0,,,,2,2,1,3
C(CCC(C(C=O)(O)O)O)(O)=O,,,5,1,1,0,1
91544_0,,,,2,2,1,3
C(CCC(C(C(C=O)(O)O)O)O)=O,,,5,1,1,0,1
91545_0,,,,2,2,1,3
91547_0,,,,2,2,1,3
C(C(C)(C(C)(C(C)CC=O)O)O)=O,,,5,1,1,0,1
91549_0,,,,2,2,1,3
C(C(C)(C(C)(CCC=O)O)O)=O,,,5,1,1,0,1
91551_0,,,,2,2,1,3
C(C(C)(C(C)(CCC(O)=O)O)O)=O,,,5,1,1,0,1
91553_0,,,,2,2,1,3
C(C(C)(C(CC(C)CC=O)O)O)=O,,,5,1,1,0,1
91555_0,,,,2,2,1,3
C(C(C)(C(CCCC=O)O)O)=O,,,5,1,1,0,1
91556_0,,,,2,2,1,3
91558_0,,,,2,2,1,3
C(C(C(C)O)(CC(C)CC=O)O)=O,,,5,1,1,0,1
91560_0,,,,2,2,1,3
C(C(C(C)O)(CCCC=O)O)=O,,,5,1,1,0,1
91561_0,,,,2,2,1,3
91562_0,,,,2,2,1,3
91564_0,,,,2,2,1,3
C(C(C)(C(C(C)CC=O)O)O)=O,,,5,1,1,0,1
91565_0,,,,2,2,1,3
91567_0,,,,2,2,1,3
C(C(C)(C(C1COC(C1)=O)O)O)=O,,,5,1,1,0,1
91568_0,,,,2,2,1,3
91569_0,,,,2,2,1,3
91571_0,,,,2,2,1,3
C(C(C)(C(CCC(O)=O)O)O)=O,,,5,1,1,0,1
91573_0,,,,2,2,1,3
C(C(C=O)CCC(C=O)(CO)O)=O,,,5,1,1,0,1
91575_0,,,,2,2,1,3
C(C(CO)(CC(C)CC=O)O)=O,,,5,1,1,0,1
91577_0,,,,2,2,1,3
C(C(CO)(CCCC=O)O)=O,,,5,1,1,0,1
91579_0,,,,2,2,1,3
C(C(CO)(CC1COC(C1)=O)O)=O,,,5,1,1,0,1
91580_0,,,,2,2,1,3
91581_0,,,,2,2,1,3
91582_0,,,,2,2,1,3
91583_0,,,,2,2,1,3
91585_0,,,,2,2,1,3
C(CC(C)C([C](C(O)=O)O)(C)O)=O,,,5,1,1,0,1
91587_0,,,,2,2,1,3
C(CCC([C](C(O)=O)O)(C)O)=O,,,5,1,1,0,1
91589_0,,,,2,2,1,3
C(CCC([C](C(O)=O)O)(C)O)(O)=O,,,5,1,1,0,1
91591_0,,,,2,2,1,3
C(CC(C)CC([C](C(O)=O)O)O)=O,,,5,1,1,0,1
91593_0,,,,2,2,1,3
C(CCCC([C](C(O)=O)O)O)=O,,,5,1,1,0,1
91594_0,,,,2,2,1,3
91595_0,,,,2,2,1,3
91597_0,,,,2,2,1,3
C(CC(C)C([C](C(O)=O)O)O)=O,,,5,1,1,0,1
91598_0,,,,2,2,1,3
91600_0,,,,2,2,1,3
C1(CC(CO1)C([C](C(O)=O)O)O)=O,,,5,1,1,0,1
91601_0,,,,2,2,1,3
91602_0,,,,2,2,1,3
91604_0,,,,2,2,1,3
C(CCC([C](C(O)=O)O)O)(O)=O,,,5,1,2,0,2
91606_0,,,,2,2,1,3
C(CCC(C([C](C(O)=O)O)O)O)=O,,,5,1,1,0,1
91607_0,,,,2,2,1,3
91609_0,,,,2,2,1,3
C(CCC(C=O)(O)OC(CO)=O)=O,,,5,1,1,0,1
91611_0,,,,2,2,1,3
C(C(CCC=O)O)(OC(C=O)O)=O,,,5,1,1,0,1
91613_0,,,,2,2,1,3
C(C(C(C)CC=O)O)(OCC=O)=O,,,5,1,1,0,1
91615_0,,,,2,2,1,3
C(C(CCC=O)O)(OCC=O)=O,,,5,1,1,0,1
91616_0,,,,2,2,1,3
91618_0,,,,2,2,1,3
C(CC(C)C(C=O)OC(CO)=O)=O,,,5,1,1,0,1
91620_0,,,,2,2,1,3
C(CCC(C=O)OC(CO)=O)=O,,,5,1,1,0,1
91621_0,,,,2,2,1,3
91623_0,,,,2,2,1,3
C(CC(C)C(C=O)C(C=O)CO)=O,,,5,1,1,0,1
91625_0,,,,2,2,1,3
C(CCC(C=O)C(C=O)CO)=O,,,5,1,1,0,1
91627_0,,,,2,2,1,3
C(CCC(C=O)C(C=O)CO)(O)=O,,,5,1,1,0,1
91629_0,,,,2,2,1,3
C(C(CO)(C(C)CC=O)CC=O)=O,,,5,1,1,0,1
91631_0,,,,2,2,1,3
C(C(CCC=O)(CO)CC=O)=O,,,5,1,1,0,1
91633_0,,,,2,2,1,3
C(CCC(C=O)(CO)CC=O)(O)=O,,,5,1,1,0,1
91635_0,,,,2,2,1,3
C(CC(C)C(C(C=O)CC=O)O)=O,,,5,1,1,0,1
91636_0,,,,2,2,1,3
91638_0,,,,2,2,1,3
C(CCC(C(C=O)CC=O)O)(O)=O,,,5,1,2,0,2
91640_0,,,,2,2,1,3
C(CC(C)CC(CC(CO)=O)=O)=O,,,5,1,1,0,1
91642_0,,,,2,2,1,3
C(CCCC(CC(CO)=O)=O)=O,,,5,1,1,0,1
91644_0,,,,2,2,1,3
C(CCCC(CC(CO)=O)=O)(O)=O,,,5,1,1,0,1
91646_0,,,,2,2,1,3
C(CC(C)C(C(C)=O)C(CO)=O)=O,,,5,1,1,0,1
91648_0,,,,2,2,1,3
C(CCC(C(C)=O)C(CO)=O)=O,,,5,1,1,0,1
91650_0,,,,2,2,1,3
C(CCC(C(C)=O)C(CO)=O)(O)=O,,,5,1,1,0,1
91652_0,,,,2,2,1,3
C(CC(C)C(C(CC(C)=O)=O)O)=O,,,5,1,1,0,1
91654_0,,,,2,2,1,3
C(CCC(C(CC(C)=O)=O)O)=O,,,5,1,1,0,1
91656_0,,,,2,2,1,3
C(CCC(C(CC(C)=O)=O)O)(O)=O,,,5,1,1,0,1
91658_0,,,,2,2,1,3
C(CC(C)C(C(C(CO)=O)=O)C)=O,,,5,1,1,0,1
91660_0,,,,2,2,1,3
C(CCC(C(C(CO)=O)=O)C)=O,,,5,1,1,0,1
91662_0,,,,2,2,1,3
C(CCC(C(C(CO)=O)=O)C)(O)=O,,,5,1,1,0,1
91664_0,,,,2,2,1,3
C(CC(C)CCC(C(CO)=O)=O)=O,,,5,1,1,0,1
91666_0,,,,2,2,1,3
C(CCCCC(C(CO)=O)=O)=O,,,5,1,1,0,1
91668_0,,,,2,2,1,3
C(CCCCC(C(CO)=O)=O)(O)=O,,,5,1,1,0,1
91670_0,,,,2,2,1,3
C(CC(C)C(C(C(CC)=O)=O)O)=O,,,5,1,1,0,1
91672_0,,,,2,2,1,3
C(CCC(C(C(CC)=O)=O)O)=O,,,5,1,1,0,1
91674_0,,,,2,2,1,3
C(CCC(C(C(CC)=O)=O)O)(O)=O,,,5,1,1,0,1
91676_0,,,,2,2,1,3
C(CCC(C=O)C(C(CO)=O)=O)=O,,,5,1,1,0,1
91678_0,,,,2,2,1,3
C(CCC(C(C(CC=O)=O)=O)O)=O,,,5,1,1,0,1
91680_0,,,,2,2,1,3
C(C(C(C(C=O)=O)=O)(C)CCC=O)=O,,,5,1,1,0,1
91682_0,,,,2,2,1,3
C(C(C(C(C=O)=O)=O)CCCC=O)=O,,,5,1,1,0,1
91684_0,,,,2,2,1,3
C(C(C(C=O)=O)(C)CC(C=O)C=O)=O,,,5,1,1,0,1
91686_0,,,,2,2,1,3
C(C(C(C=O)=O)(C)C(C)CC=O)=O,,,5,1,1,0,1
91688_0,,,,2,2,1,3
C(C(C(C=O)=O)(C)CCC=O)=O,,,5,1,1,0,1
91690_0,,,,2,2,1,3
C(C(C(C=O)=O)(C)C1COC(C1)=O)=O,,,5,1,1,0,1
91692_0,,,,2,2,1,3
C(C(C(C=O)=O)(C)CCC(C=O)=O)=O,,,5,1,1,0,1
91694_0,,,,2,2,1,3
C(CC(C=O)C(C=O)(C(C=O)=O)C)=O,,,5,1,1,0,1
91696_0,,,,2,2,1,3
C(C(C(C=O)=O)(C)CCC(O)=O)=O,,,5,1,1,0,1
91698_0,,,,2,2,1,3
C(C(C(C=O)=O)CCC(C=O)C=O)=O,,,5,1,1,0,1
91700_0,,,,2,2,1,3
C(C(C(C=O)=O)CC(C)CC=O)=O,,,5,1,1,0,1
91702_0,,,,2,2,1,3
C(C(C(C=O)=O)CCCC=O)=O,,,5,1,1,0,1
91704_0,,,,2,2,1,3
C(C(C(C=O)=O)CC1COC(C1)=O)=O,,,5,1,1,0,1
91706_0,,,,2,2,1,3
C(C(C(C=O)=O)CCCC(C=O)=O)=O,,,5,1,2,0,2
91708_0,,,,2,2,1,3
C(C(CC(C=O)C(C=O)=O)CC=O)=O,,,5,1,3,0,3
91710_0,,,,2,2,1,3
C(C(C(C=O)=O)CCCC(O)=O)=O,,,5,1,1,0,1
91712_0,,,,2,2,1,3
C(CCC(C(C)=O)C(C(C=O)=O)=O)=O,,,5,1,1,0,1
91714_0,,,,2,2,1,3
C(CCCC(CC(C(C=O)=O)=O)=O)=O,,,5,1,1,0,1
91716_0,,,,2,2,1,3
C(CCC(C(C=O)=O)C(C(C)=O)=O)=O,,,5,1,1,0,1
91718_0,,,,2,2,1,3
C(CCCC(C(CC(C=O)=O)=O)=O)=O,,,5,1,1,0,1
91720_0,,,,2,2,1,3
C(C(C(C(C)=O)=O)CC(C=O)C=O)=O,,,5,1,1,0,1
91722_0,,,,2,2,1,3
C(CC(C)C(C=O)C(C(C)=O)=O)=O,,,5,1,1,0,1
91724_0,,,,2,2,1,3
C(CCC(C=O)C(C(C)=O)=O)=O,,,5,1,1,0,1
91726_0,,,,2,2,1,3
C(C(C(C(C)=O)=O)C1COC(C1)=O)=O,,,5,1,1,0,1
91728_0,,,,2,2,1,3
C(C(C(C(C)=O)=O)CCC(C=O)=O)=O,,,5,1,1,0,1
91730_0,,,,2,2,1,3
C(C(C(C(C)=O)=O)C(C=O)CC=O)=O,,,5,1,1,0,1
91732_0,,,,2,2,1,3
C(C(C(C(C)=O)=O)CCC(O)=O)=O,,,5,1,1,0,1
91734_0,,,,2,2,1,3
C(C(C=O)CCC(C(CC=O)=O)=O)=O,,,5,1,1,0,1
91736_0,,,,2,2,1,3
C(CC(C(CC(C)CC=O)=O)=O)=O,,,5,1,1,0,1
91738_0,,,,2,2,1,3
C(CC(C(CCCC=O)=O)=O)=O,,,5,1,1,0,1
91740_0,,,,2,2,1,3
C(CC(C(CC1COC(C1)=O)=O)=O)=O,,,5,1,1,0,1
91742_0,,,,2,2,1,3
C(CC(C(CCCC(C=O)=O)=O)=O)=O,,,5,1,1,0,1
91744_0,,,,2,2,1,3
C(CC(C(CC(C=O)CC=O)=O)=O)=O,,,5,1,1,0,1
91746_0,,,,2,2,1,3
C(CC(C(CCCC(O)=O)=O)=O)=O,,,5,1,1,0,1
91748_0,,,,2,2,1,3
C(CCC(C=O)(C=O)CC(C=O)=O)=O,,,5,1,1,0,1
91750_0,,,,2,2,1,3
C(CCC(C(C=O)=O)C(C=O)C=O)=O,,,5,1,1,0,1
91752_0,,,,2,2,1,3
C(C(CC(C=O)C=O)CC(C=O)=O)=O,,,5,1,2,0,2
91754_0,,,,2,2,1,3
C(CC(C)C(C=O)CC(C=O)=O)=O,,,5,1,1,0,1
91756_0,,,,2,2,1,3
C(CCC(C=O)CC(C=O)=O)=O,,,5,1,2,0,2
91758_0,,,,2,2,1,3
C(C(C1COC(C1)=O)CC(C=O)=O)=O,,,5,1,1,0,1
91760_0,,,,2,2,1,3
C(C(CCC(C=O)=O)CC(C=O)=O)=O,,,5,1,3,0,3
91762_0,,,,2,2,1,3
C(CC(C=O)C(C=O)CC(C=O)=O)=O,,,5,1,2,0,2
91764_0,,,,2,2,1,3
C(C(CCC(O)=O)CC(C=O)=O)=O,,,5,1,2,0,2
91766_0,,,,2,2,1,3
C(C(C=O)CC(C(C=O)=O)CC=O)=O,,,5,1,1,0,1
91768_0,,,,2,2,1,3
C(CC(C)C(C(C=O)=O)CC=O)=O,,,5,1,1,0,1
91770_0,,,,2,2,1,3
C(CCC(C(C=O)=O)CC=O)=O,,,5,1,1,0,1
91772_0,,,,2,2,1,3
C(CC(C(C=O)=O)C1COC(C1)=O)=O,,,5,1,1,0,1
91774_0,,,,2,2,1,3
C(CC(C(C=O)=O)CCC(C=O)=O)=O,,,5,1,2,0,2
91776_0,,,,2,2,1,3
C(CC(C(C=O)=O)C(C=O)CC=O)=O,,,5,1,2,0,2
91778_0,,,,2,2,1,3
C(CC(C(C=O)=O)CCC(O)=O)=O,,,5,1,1,0,1
91780_0,,,,2,2,1,3
C(CCC(C=O)CC(C(C=O)=O)=O)=O,,,5,1,1,0,1
91782_0,,,,2,2,1,3
C(CCC(C(C(C=O)=O)=O)CC=O)=O,,,5,1,1,0,1
91784_0,,,,2,2,1,3
C(CC=O)(C(C(C=O)=O)CCC=O)=O,,,5,1,1,0,1
91786_0,,,,2,2,1,3
C(C(C(CC(C=O)=O)=O)CCC=O)=O,,,5,1,1,0,1
91788_0,,,,2,2,1,3
C(C(C=O)CC(C=O)C(CC=O)=O)=O,,,5,1,1,0,1
91790_0,,,,2,2,1,3
C(C(C(CC=O)=O)C(C)CC=O)=O,,,5,1,1,0,1
91792_0,,,,2,2,1,3
C(C(C(CC=O)=O)CCC=O)=O,,,5,1,1,0,1
91794_0,,,,2,2,1,3
C(C(C(CC=O)=O)C1COC(C1)=O)=O,,,5,1,1,0,1
91796_0,,,,2,2,1,3
C(C(C(CC=O)=O)CCC(C=O)=O)=O,,,5,1,1,0,1
91798_0,,,,2,2,1,3
C(C(C(CC=O)=O)C(C=O)CC=O)=O,,,5,1,1,0,1
91800_0,,,,2,2,1,3
C(C(C(CC=O)=O)CCC(O)=O)=O,,,5,1,1,0,1
91802_0,,,,2,2,1,3
C(C(C=O)(CCC=O)C(C=O)C=O)=O,,,5,1,1,0,1
91804_0,,,,2,2,1,3
C(C(C=O)CC(C=O)C(C=O)C=O)=O,,,5,1,2,0,2
91806_0,,,,2,2,1,3
C(CC(C)C(C=O)C(C=O)C=O)=O,,,5,1,1,0,1
91808_0,,,,2,2,1,3
C(CCC(C=O)C(C=O)C=O)=O,,,5,1,2,0,2
91810_0,,,,2,2,1,3
C(C(C=O)C(C=O)C1COC(C1)=O)=O,,,5,1,1,0,1
91812_0,,,,2,2,1,3
C(C(C=O)C(C=O)CCC(C=O)=O)=O,,,5,1,3,0,3
91814_0,,,,2,2,1,3
C(C(C=O)C(C=O)C(C=O)CC=O)=O,,,5,1,2,0,2
91816_0,,,,2,2,1,3
C(C(C=O)C(C=O)CCC(O)=O)=O,,,5,1,2,0,2
91818_0,,,,2,2,1,3
C(C(C=O)CC(C=O)(C=O)CC=O)=O,,,5,1,1,0,1
91820_0,,,,2,2,1,3
C(CC(C)C(C=O)(C=O)CC=O)=O,,,5,1,1,0,1
91822_0,,,,2,2,1,3
C(CCC(C=O)(C=O)CC=O)=O,,,5,1,1,0,1
91824_0,,,,2,2,1,3
C(C(C=O)(C1COC(C1)=O)CC=O)=O,,,5,1,1,0,1
91826_0,,,,2,2,1,3
C(C(C=O)(CCC(C=O)=O)CC=O)=O,,,5,1,2,0,2
91828_0,,,,2,2,1,3
C(C(C=O)(CC=O)C(C=O)CC=O)=O,,,5,1,2,0,2
91830_0,,,,2,2,1,3
C(C(C=O)(CCC(O)=O)CC=O)=O,,,5,1,1,0,1
91832_0,,,,2,2,1,3
C(CC(C)C(C=O)CC(CC=O)=O)=O,,,5,1,1,0,1
91834_0,,,,2,2,1,3
C(CCC(C=O)CC(CC=O)=O)=O,,,5,1,1,0,1
91836_0,,,,2,2,1,3
C(CC(C)C(C(CC=O)=O)CC=O)=O,,,5,1,1,0,1
91838_0,,,,2,2,1,3
C(CCC(C(CC=O)=O)CC=O)=O,,,5,1,1,0,1
91840_0,,,,2,2,1,3
C(CC(C)C(C=O)C(CCC=O)=O)=O,,,5,1,1,0,1
91842_0,,,,2,2,1,3
C(CCC(C=O)C(CCC=O)=O)=O,,,5,1,1,0,1
91844_0,,,,2,2,1,3
C(CC(C)C(C=O)C(C=O)CC=O)=O,,,5,1,1,0,1
91846_0,,,,2,2,1,3
C(CCC(C=O)C(C=O)CC=O)=O,,,5,1,1,0,1
91848_0,,,,2,2,1,3
C(CC(C)C(C=O)(CC=O)CC=O)=O,,,5,1,1,0,1
91850_0,,,,2,2,1,3
C(CCC(C=O)(CC=O)CC=O)=O,,,5,1,1,0,1
91852_0,,,,2,2,1,3
C(CC(CC(CC(C)CC=O)=O)=O)=O,,,5,1,1,0,1
91854_0,,,,2,2,1,3
C(CC(CC(CCCC=O)=O)=O)=O,,,5,1,1,0,1
91856_0,,,,2,2,1,3
C(C(C(CC(C)=O)=O)C(C)CC=O)=O,,,5,1,1,0,1
91858_0,,,,2,2,1,3
C(C(C(CC(C)=O)=O)CCC=O)=O,,,5,1,1,0,1
91860_0,,,,2,2,1,3
C(CC(C)C(C(CC=O)=O)C(C)=O)=O,,,5,1,1,0,1
91862_0,,,,2,2,1,3
C(CCC(C(CC=O)=O)C(C)=O)=O,,,5,1,1,0,1
91864_0,,,,2,2,1,3
C(CC(C(C(C)C(C)CC=O)=O)=O)=O,,,5,1,1,0,1
91866_0,,,,2,2,1,3
C(CC(C(C(C)CCC=O)=O)=O)=O,,,5,1,1,0,1
91868_0,,,,2,2,1,3
C(CC(C(CCC(C)CC=O)=O)=O)=O,,,5,1,1,0,1
91870_0,,,,2,2,1,3
C(CC(C(CCCCC=O)=O)=O)=O,,,5,1,1,0,1
91872_0,,,,2,2,1,3
C(C(C(C(CC)=O)=O)C(C)CC=O)=O,,,5,1,1,0,1
91874_0,,,,2,2,1,3
C(C(C(C(CC)=O)=O)CCC=O)=O,,,5,1,1,0,1
91876_0,,,,2,2,1,3
C(C(C(C(CC=O)=O)=O)CCC=O)=O,,,5,1,1,0,1
91878_0,,,,2,2,1,3
C(CC(C)C(C=O)CC(C(C)=O)=O)=O,,,5,1,1,0,1
91880_0,,,,2,2,1,3
C(CCC(C=O)CC(C(C)=O)=O)=O,,,5,1,1,0,1
91882_0,,,,2,2,1,3
C(CC(C)C(C(C(C)=O)=O)CC=O)=O,,,5,1,1,0,1
91884_0,,,,2,2,1,3
C(CCC(C(C(C)=O)=O)CC=O)=O,,,5,1,1,0,1
91886_0,,,,2,2,1,3
C(CC(C)CC(C(CCC=O)=O)=O)=O,,,5,1,1,0,1
91888_0,,,,2,2,1,3
C(CCCC(C(CCC=O)=O)=O)=O,,,5,1,1,0,1
91890_0,,,,2,2,1,3
C(CC(C)C(C=O)C(C(C=O)=O)C)=O,,,5,1,1,0,1
91892_0,,,,2,2,1,3
C(CCC(C=O)C(C(C=O)=O)C)=O,,,5,1,1,0,1
91894_0,,,,2,2,1,3
C(CC(C)CC(C(C=O)=O)CC=O)=O,,,5,1,1,0,1
91896_0,,,,2,2,1,3
C(CCCC(C(C=O)=O)CC=O)=O,,,5,1,1,0,1
91898_0,,,,2,2,1,3
C(CC(C)C(C(C=O)=O)(C)CC=O)=O,,,5,1,1,0,1
91900_0,,,,2,2,1,3
C(CCC(C(C=O)=O)(C)CC=O)=O,,,5,1,1,0,1
91902_0,,,,2,2,1,3
C(C(C=O)CC(C(C(C=O)=O)=O)C)=O,,,5,1,1,0,1
91904_0,,,,2,2,1,3
C(CC(C)C(C(C(C=O)=O)=O)C)=O,,,5,1,1,0,1
91906_0,,,,2,2,1,3
C(CCC(C(C(C=O)=O)=O)C)=O,,,5,1,1,0,1
91908_0,,,,2,2,1,3
C1(CC(CO1)C(C(C(C=O)=O)=O)C)=O,,,5,1,1,0,1
91910_0,,,,2,2,1,3
C(C(CCC(C(C(C=O)=O)=O)C)=O)=O,,,5,1,1,0,1
91912_0,,,,2,2,1,3
C(CC(C=O)C(C(C(C=O)=O)=O)C)=O,,,5,1,1,0,1
91914_0,,,,2,2,1,3
C(CCC(C(C(C=O)=O)=O)C)(O)=O,,,5,1,1,0,1
91916_0,,,,2,2,1,3
C(C(C=O)CCCC(C(C=O)=O)=O)=O,,,5,1,1,0,1
91918_0,,,,2,2,1,3
C(CC(C)CCC(C(C=O)=O)=O)=O,,,5,1,1,0,1
91920_0,,,,2,2,1,3
C(CCCCC(C(C=O)=O)=O)=O,,,5,1,1,0,1
91922_0,,,,2,2,1,3
C1(CC(CCC(C(C=O)=O)=O)CO1)=O,,,5,1,1,0,1
91924_0,,,,2,2,1,3
C(C(CCCCC(C(C=O)=O)=O)=O)=O,,,5,1,1,0,1
91926_0,,,,2,2,1,3
C(C(CCC(C(C=O)=O)=O)CC=O)=O,,,5,1,2,0,2
91928_0,,,,2,2,1,3
C(CCCCC(C(C=O)=O)=O)(O)=O,,,5,1,1,0,1
91930_0,,,,2,2,1,3
C(C(C)C(C=O)C(C(C=O)=O)C)=O,,,5,1,1,0,1
91932_0,,,,2,2,1,3
C(C(C)(CC=O)C(C(C=O)=O)C)=O,,,5,1,1,0,1
91934_0,,,,2,2,1,3
C(C(CC(C(C=O)=O)C)CC=O)=O,,,5,1,1,0,1
91936_0,,,,2,2,1,3
C(CC(C=O)C(C(C=O)=O)C)(C)=O,,,5,1,1,0,1
91938_0,,,,2,2,1,3
C(CC(C(C)=O)C(C(C=O)=O)C)=O,,,5,1,1,0,1
91940_0,,,,2,2,1,3
C(C=O)(C(C)C(C)CC(C=O)=O)=O,,,5,1,1,0,1
91942_0,,,,2,2,1,3
C(C(CC(C=O)=O)C(C(C=O)=O)C)=O,,,5,1,1,0,1
91944_0,,,,2,2,1,3
C(CC(C(C=O)=O)C(C(C=O)=O)C)=O,,,5,1,1,0,1
91946_0,,,,2,2,1,3
C(CC(CC=O)C(C(C=O)=O)C)=O,,,5,1,1,0,1
91948_0,,,,2,2,1,3
C(C(C=O)C(C)C(C(C=O)=O)C)=O,,,5,1,1,0,1
91950_0,,,,2,2,1,3
C(C(C=O)C(C=O)C(C(C=O)=O)C)=O,,,5,1,1,0,1
91952_0,,,,2,2,1,3
C(C(C=O)(CC=O)C(C(C=O)=O)C)=O,,,5,1,1,0,1
91954_0,,,,2,2,1,3
C(C(C=O)CC(C(C=O)=O)C)=O,,,5,1,1,0,1
91956_0,,,,2,2,1,3
C(CC(C)C(C(C=O)=O)C)=O,,,5,1,1,0,1
91958_0,,,,2,2,1,3
C(CCC(C(C=O)=O)C)=O,,,5,1,1,0,1
91960_0,,,,2,2,1,3
C(C(CC(C(C=O)=O)C)CO)(O)=O,,,5,1,1,0,1
91962_0,,,,2,2,1,3
C(C(C(C=O)=O)CC(C(C=O)=O)C)=O,,,5,1,1,0,1
91964_0,,,,2,2,1,3
C1(CC(CO1)C(C(C=O)=O)C)=O,,,5,1,1,0,1
91965_0,,,,2,2,1,3
91966_0,,,,2,2,1,3
91967_0,,,,2,2,1,3
91969_0,,,,2,2,1,3
C(CC(CO)C(C(C=O)=O)C)(O)=O,,,5,1,1,0,1
91971_0,,,,2,2,1,3
C(C(CCC(C=O)=O)C(C=O)C)=O,,,5,1,1,0,1
91973_0,,,,2,2,1,3
C(C(C)(CCC(C=O)=O)CC=O)=O,,,5,1,1,0,1
91975_0,,,,2,2,1,3
C(C(CCCC(C=O)=O)CC=O)=O,,,5,1,1,0,1
91977_0,,,,2,2,1,3
C(C(CCC(C=O)=O)CC(C)=O)=O,,,5,1,1,0,1
91979_0,,,,2,2,1,3
C(C)(C(CCC(C=O)=O)CC=O)=O,,,5,1,1,0,1
91981_0,,,,2,2,1,3
C(C(CCC(C)CC(C=O)=O)=O)=O,,,5,1,1,0,1
91982_0,,,,2,2,1,3
91983_0,,,,2,2,1,3
91985_0,,,,2,2,1,3
C(CC(CCC(C=O)=O)CC=O)=O,,,5,1,1,0,1
91987_0,,,,2,2,1,3
C(C(C=O)C(C)CCC(C=O)=O)=O,,,5,1,1,0,1
91988_0,,,,2,2,1,3
91989_0,,,,2,2,1,3
91991_0,,,,2,2,1,3
C(C(C=O)CCCC(C=O)=O)=O,,,5,1,1,0,1
91993_0,,,,2,2,1,3
C(CC(C)CCC(C=O)=O)=O,,,5,1,1,0,1
91995_0,,,,2,2,1,3
C(CCCCC(C=O)=O)=O,,,5,1,1,0,1
91997_0,,,,2,2,1,3
C(C(CO)CCCC(C=O)=O)(O)=O,,,5,1,1,0,1
91998_0,,,,2,2,1,3
92000_0,,,,2,2,1,3
C1(CC(CCC(C=O)=O)CO1)=O,,,5,1,1,0,1
92001_0,,,,2,2,1,3
92002_0,,,,2,2,1,3
92003_0,,,,2,2,1,3
92005_0,,,,2,2,1,3
C(CC(CCC(C=O)=O)CO)(O)=O,,,5,1,2,0,2
92007_0,,,,2,2,1,3
C(CO)(C(C(C)CC=O)CC=O)=O,,,5,1,1,0,1
92009_0,,,,2,2,1,3
C(CO)(C(CCC=O)CC=O)=O,,,5,1,1,0,1
92011_0,,,,2,2,1,3
C(CO)(C(CCC(O)=O)CC=O)=O,,,5,1,1,0,1
92013_0,,,,2,2,1,3
C(CC(C)C(C(CCC=O)=O)O)=O,,,5,1,1,0,1
92015_0,,,,2,2,1,3
C(CCC(C(CCC=O)=O)O)=O,,,5,1,1,0,1
92017_0,,,,2,2,1,3
C(CCC(C(CCC=O)=O)O)(O)=O,,,5,1,1,0,1
92019_0,,,,2,2,1,3
C(CC(C)C(C=O)CC(CO)=O)=O,,,5,1,1,0,1
92021_0,,,,2,2,1,3
C(CCC(C=O)CC(CO)=O)=O,,,5,1,1,0,1
92023_0,,,,2,2,1,3
C(CCC(C=O)CC(CO)=O)(O)=O,,,5,1,1,0,1
92025_0,,,,2,2,1,3
C(C(CO)C(C)CC=O)(CC=O)=O,,,5,1,1,0,1
92027_0,,,,2,2,1,3
C(C(CCC=O)CO)(CC=O)=O,,,5,1,1,0,1
92029_0,,,,2,2,1,3
C(C(CCC(O)=O)CO)(CC=O)=O,,,5,1,1,0,1
92031_0,,,,2,2,1,3
C(CC(CC(C(C)CC=O)O)=O)=O,,,5,1,1,0,1
92032_0,,,,2,2,1,3
92034_0,,,,2,2,1,3
C(CC(CC(CCC(O)=O)O)=O)=O,,,5,1,1,0,1
92036_0,,,,2,2,1,3
C(C(C(CCO)=O)C(C)CC=O)=O,,,5,1,1,0,1
92038_0,,,,2,2,1,3
C(C(C(CCO)=O)CCC=O)=O,,,5,1,1,0,1
92040_0,,,,2,2,1,3
C(C(C(CCO)=O)CCC(O)=O)=O,,,5,1,1,0,1
92042_0,,,,2,2,1,3
C(CC(C=O)C(C=O)C(C=O)C)=O,,,5,1,1,0,1
92044_0,,,,2,2,1,3
C(CC(C=O)C(C=O)(C)CC=O)=O,,,5,1,1,0,1
92046_0,,,,2,2,1,3
C(C(CC(C=O)CC=O)CC=O)=O,,,5,1,1,0,1
92048_0,,,,2,2,1,3
C(CC(C=O)C(C=O)CC(C)=O)=O,,,5,1,1,0,1
92050_0,,,,2,2,1,3
C(CC(C(C)=O)C(C=O)CC=O)=O,,,5,1,1,0,1
92052_0,,,,2,2,1,3
C(C(C(C)CC(C=O)=O)CC=O)=O,,,5,1,1,0,1
92053_0,,,,2,2,1,3
92054_0,,,,2,2,1,3
92056_0,,,,2,2,1,3
C(CC(C(C=O)CC=O)CC=O)=O,,,5,1,1,0,1
92058_0,,,,2,2,1,3
C(C(C(C)C(C=O)C=O)CC=O)=O,,,5,1,1,0,1
92059_0,,,,2,2,1,3
92060_0,,,,2,2,1,3
92062_0,,,,2,2,1,3
C(C(CC(C=O)C=O)CC=O)=O,,,5,1,2,0,2
92064_0,,,,2,2,1,3
C(CC(C)C(C=O)CC=O)=O,,,5,1,1,0,1
92066_0,,,,2,2,1,3
C(CCC(C=O)CC=O)=O,,,5,1,2,0,2
92067_0,,,,2,2,1,3
92068_0,,,,2,2,1,3
92070_0,,,,2,2,1,3
C(C(C1COC(C1)=O)CC=O)=O,,,5,1,1,0,1
92071_0,,,,2,2,1,3
92072_0,,,,2,2,1,3
92073_0,,,,2,2,1,3
92075_0,,,,2,2,1,3
C(CC(CO)C(C=O)CC=O)(O)=O,,,5,1,3,0,3
92077_0,,,,2,2,1,3
C(C(C(C(C=O)=O)=O)C(C)CC=O)=O,,,5,1,1,0,1
92079_0,,,,2,2,1,3
C(C(C(C(C=O)=O)=O)CCC=O)=O,,,5,1,1,0,1
92081_0,,,,2,2,1,3
C(C(C)C(C=O)CC(C(C)=O)=O)=O,,,5,1,1,0,1
92083_0,,,,2,2,1,3
C(C(C)(CC=O)CC(C(C)=O)=O)=O,,,5,1,1,0,1
92085_0,,,,2,2,1,3
C(C(CCC(C(C)=O)=O)CC=O)=O,,,5,1,1,0,1
92087_0,,,,2,2,1,3
C(C(CC(C)=O)CC(C(C)=O)=O)=O,,,5,1,1,0,1
92089_0,,,,2,2,1,3
C(CC(C(C)=O)CC(C(C)=O)=O)=O,,,5,1,1,0,1
92091_0,,,,2,2,1,3
C(C=O)(CC(C)CC(C(C)=O)=O)=O,,,5,1,1,0,1
92093_0,,,,2,2,1,3
C(C(CC(C(C)=O)=O)CC(C=O)=O)=O,,,5,1,1,0,1
92095_0,,,,2,2,1,3
C(CC(C(C=O)=O)CC(C(C)=O)=O)=O,,,5,1,1,0,1
92097_0,,,,2,2,1,3
C(CC(CC=O)CC(C(C)=O)=O)=O,,,5,1,1,0,1
92099_0,,,,2,2,1,3
C(C(C=O)C(C)CC(C(C)=O)=O)=O,,,5,1,1,0,1
92101_0,,,,2,2,1,3
C(C(C=O)C(C=O)CC(C(C)=O)=O)=O,,,5,1,1,0,1
92103_0,,,,2,2,1,3
C(C(C=O)(CC=O)CC(C(C)=O)=O)=O,,,5,1,1,0,1
92105_0,,,,2,2,1,3
C(C(C=O)CCC(C(C)=O)=O)=O,,,5,1,1,0,1
92107_0,,,,2,2,1,3
C(CC(C)CC(C(C)=O)=O)=O,,,5,1,1,0,1
92109_0,,,,2,2,1,3
C(CCCC(C(C)=O)=O)=O,,,5,1,1,0,1
92111_0,,,,2,2,1,3
C(C(CCC(C(C)=O)=O)CO)(O)=O,,,5,1,1,0,1
92113_0,,,,2,2,1,3
C(C(C(C=O)=O)CCC(C(C)=O)=O)=O,,,5,1,1,0,1
92115_0,,,,2,2,1,3
C1(CC(CO1)CC(C(C)=O)=O)=O,,,5,1,1,0,1
92116_0,,,,2,2,1,3
92117_0,,,,2,2,1,3
92118_0,,,,2,2,1,3
92120_0,,,,2,2,1,3
C(CC(CO)CC(C(C)=O)=O)(O)=O,,,5,1,1,0,1
92122_0,,,,2,2,1,3
C(C(C(CCCC=O)=O)CO)(O)=O,,,5,1,1,0,1
92124_0,,,,2,2,1,3
C(CCC(C(O)=O)(C(C)=O)CO)=O,,,5,1,1,0,1
92125_0,,,,2,2,1,3
92127_0,,,,2,2,1,3
C(CC(C)CC(C(C=O)C(C)=O)=O)=O,,,5,1,1,0,1
92129_0,,,,2,2,1,3
C(CCCC(C(C=O)C(C)=O)=O)=O,,,5,1,1,0,1
92131_0,,,,2,2,1,3
C(C(C(CCCC=O)=O)C(C=O)=O)=O,,,5,1,1,0,1
92133_0,,,,2,2,1,3
C(CC(C)C(C=O)(C(C)=O)CO)=O,,,5,1,1,0,1
92135_0,,,,2,2,1,3
C(CCC(C=O)(C(C)=O)CO)=O,,,5,1,1,0,1
92137_0,,,,2,2,1,3
C(CCC(C=O)(C(C)=O)CO)(O)=O,,,5,1,1,0,1
92139_0,,,,2,2,1,3
C(CC(C)C(C(C=O)C(C)=O)O)=O,,,5,1,1,0,1
92140_0,,,,2,2,1,3
92142_0,,,,2,2,1,3
C(CCC(C(C=O)C(C)=O)O)(O)=O,,,5,1,1,0,1
92144_0,,,,2,2,1,3
C(C(C(CC(C)CC=O)=O)CO)=O,,,5,1,1,0,1
92146_0,,,,2,2,1,3
C(C(C(CCCC=O)=O)CO)=O,,,5,1,1,0,1
92148_0,,,,2,2,1,3
C(C(C(CCCC(O)=O)=O)CO)=O,,,5,1,1,0,1
92150_0,,,,2,2,1,3
C(C(C(C(O)=O)=O)(C)CCC=O)=O,,,5,1,1,0,1
92152_0,,,,2,2,1,3
C(C(C(C(O)=O)=O)CCCC=O)=O,,,5,1,1,0,1
92154_0,,,,2,2,1,3
C(CCC(C(C)=O)C(C(O)=O)=O)=O,,,5,1,1,0,1
92156_0,,,,2,2,1,3
C(CCCC(CC(C(O)=O)=O)=O)=O,,,5,1,1,0,1
92158_0,,,,2,2,1,3
C(CCC(C(O)=O)C(C(C)=O)=O)=O,,,5,1,1,0,1
92160_0,,,,2,2,1,3
C(CCCC(C(CC(O)=O)=O)=O)=O,,,5,1,1,0,1
92162_0,,,,2,2,1,3
C(CCC(C=O)CC(C(O)=O)=O)=O,,,5,1,1,0,1
92164_0,,,,2,2,1,3
C(CCC(C(C(O)=O)=O)CC=O)=O,,,5,1,1,0,1
92166_0,,,,2,2,1,3
C(CC=O)(C(C(O)=O)CCC=O)=O,,,5,1,1,0,1
92168_0,,,,2,2,1,3
C(C(C(CC(O)=O)=O)CCC=O)=O,,,5,1,1,0,1
92170_0,,,,2,2,1,3
C(CC(C)CC(C(C=O)CC=O)=O)=O,,,5,1,1,0,1
92172_0,,,,2,2,1,3
C(CCCC(C(C=O)CC=O)=O)=O,,,5,1,1,0,1
92174_0,,,,2,2,1,3
C(CC(C)C(C(C)=O)(C=O)CC=O)=O,,,5,1,1,0,1
92176_0,,,,2,2,1,3
C(CCC(C(C)=O)(C=O)CC=O)=O,,,5,1,1,0,1
92178_0,,,,2,2,1,3
C(CC(C)C(C=O)C(C=O)C(C)=O)=O,,,5,1,1,0,1
92180_0,,,,2,2,1,3
C(CCC(C=O)C(C=O)C(C)=O)=O,,,5,1,1,0,1
92182_0,,,,2,2,1,3
C(CCC(C=O)(C(C=O)=O)CC=O)=O,,,5,1,1,0,1
92184_0,,,,2,2,1,3
C(CCC(C=O)C(C=O)C(C=O)=O)=O,,,5,1,1,0,1
92186_0,,,,2,2,1,3
C(CC(C)C(C(C)=O)(C(O)=O)C)=O,,,5,1,1,0,1
92188_0,,,,2,2,1,3
C(CCC(C(C)=O)(C(O)=O)C)=O,,,5,1,1,0,1
92190_0,,,,2,2,1,3
C(C)(C(C(O)=O)(C)CCC(O)=O)=O,,,5,1,1,0,1
92192_0,,,,2,2,1,3
C(CC(C)CC(C(C)=O)C(O)=O)=O,,,5,1,1,0,1
92194_0,,,,2,2,1,3
C(CCCC(C(C)=O)C(O)=O)=O,,,5,1,1,0,1
92196_0,,,,2,2,1,3
C(C)(C(C(O)=O)CCCC(O)=O)=O,,,5,1,1,0,1
92198_0,,,,2,2,1,3
C(CC(C)CC(C(C(O)=O)C)=O)=O,,,5,1,1,0,1
92200_0,,,,2,2,1,3
C(CCCC(C(C(O)=O)C)=O)=O,,,5,1,1,0,1
92202_0,,,,2,2,1,3
C(CCCC(O)=O)(C(C(O)=O)C)=O,,,5,1,1,0,1
92204_0,,,,2,2,1,3
C(C(C=O)CC(C(C(O)=O)=O)C)=O,,,5,1,1,0,1
92206_0,,,,2,2,1,3
C(CC(C)C(C(C(O)=O)=O)C)=O,,,5,1,1,0,1
92208_0,,,,2,2,1,3
C(CCC(C(C(O)=O)=O)C)=O,,,5,1,1,0,1
92210_0,,,,2,2,1,3
C1(CC(CO1)C(C(C(O)=O)=O)C)=O,,,5,1,1,0,1
92212_0,,,,2,2,1,3
C(C(O)=O)(C(C)CCC(C=O)=O)=O,,,5,1,1,0,1
92214_0,,,,2,2,1,3
C(CC(C=O)C(C(C(O)=O)=O)C)=O,,,5,1,1,0,1
92215_0,,,,2,2,1,3
92217_0,,,,2,2,1,3
C(C(C=O)CCCC(C(O)=O)=O)=O,,,5,1,1,0,1
92219_0,,,,2,2,1,3
C(CC(C)CCC(C(O)=O)=O)=O,,,5,1,1,0,1
92221_0,,,,2,2,1,3
C(CCCCC(C(O)=O)=O)=O,,,5,1,1,0,1
92223_0,,,,2,2,1,3
C1(CC(CO1)CCC(C(O)=O)=O)=O,,,5,1,1,0,1
92224_0,,,,2,2,1,3
92225_0,,,,2,2,1,3
92226_0,,,,2,2,1,3
92228_0,,,,2,2,1,3
C(C(C=O)CC(C(C)=O)C(O)=O)=O,,,5,1,1,0,1
92230_0,,,,2,2,1,3
C(CC(C)C(C(C)=O)C(O)=O)=O,,,5,1,1,0,1
92232_0,,,,2,2,1,3
C(CCC(C(C)=O)C(O)=O)=O,,,5,1,1,0,1
92234_0,,,,2,2,1,3
C1(CC(CO1)C(C(C)=O)C(O)=O)=O,,,5,1,1,0,1
92236_0,,,,2,2,1,3
C(C)(C(C(O)=O)CCC(C=O)=O)=O,,,5,1,1,0,1
92238_0,,,,2,2,1,3
C(C(C(C)=O)C(C=O)CC=O)(O)=O,,,5,1,1,0,1
92239_0,,,,2,2,1,3
92241_0,,,,2,2,1,3
C(C(C=O)CCC(CC(O)=O)=O)=O,,,5,1,1,0,1
92243_0,,,,2,2,1,3
C(CC(C)CC(CC(O)=O)=O)=O,,,5,1,1,0,1
92245_0,,,,2,2,1,3
C(CCCC(CC(O)=O)=O)=O,,,5,1,1,0,1
92247_0,,,,2,2,1,3
C1(CC(CO1)CC(CC(O)=O)=O)=O,,,5,1,1,0,1
92249_0,,,,2,2,1,3
C(CCCC(C=O)=O)(CC(O)=O)=O,,,5,1,1,0,1
92251_0,,,,2,2,1,3
C(CC(CC(C=O)CC=O)=O)(O)=O,,,5,1,1,0,1
92252_0,,,,2,2,1,3
92254_0,,,,2,2,1,3
C(CCC(C(O)=O)(C(C=O)=O)C)=O,,,5,1,1,0,1
92256_0,,,,2,2,1,3
C(CCCC(C(O)=O)C(C=O)=O)=O,,,5,1,1,0,1
92258_0,,,,2,2,1,3
C(C(C(O)=O)(C)CC(C=O)C=O)=O,,,5,1,1,0,1
92260_0,,,,2,2,1,3
C(C(C(O)=O)(C)C(C)CC=O)=O,,,5,1,1,0,1
92262_0,,,,2,2,1,3
C(C(C(O)=O)(C)CCC=O)=O,,,5,1,1,0,1
92264_0,,,,2,2,1,3
C(C(C(O)=O)(C)C1COC(C1)=O)=O,,,5,1,1,0,1
92266_0,,,,2,2,1,3
C(C(C(O)=O)(C)CCC(C=O)=O)=O,,,5,1,1,0,1
92268_0,,,,2,2,1,3
C(CC(C=O)C(C=O)(C(O)=O)C)=O,,,5,1,1,0,1
92270_0,,,,2,2,1,3
C(C(C(O)=O)(C)CCC(O)=O)=O,,,5,1,1,0,1
92272_0,,,,2,2,1,3
C(C(C=O)CCC(C=O)C(O)=O)=O,,,5,1,1,0,1
92274_0,,,,2,2,1,3
C(C(C(O)=O)CC(C)CC=O)=O,,,5,1,1,0,1
92276_0,,,,2,2,1,3
C(C(C(O)=O)CCCC=O)=O,,,5,1,1,0,1
92278_0,,,,2,2,1,3
C(C(C(O)=O)CC1COC(C1)=O)=O,,,5,1,1,0,1
92280_0,,,,2,2,1,3
C(C(C(O)=O)CCCC(C=O)=O)=O,,,5,1,1,0,1
92282_0,,,,2,2,1,3
C(C(CC(C=O)C(O)=O)CC=O)=O,,,5,1,2,0,2
92283_0,,,,2,2,1,3
92285_0,,,,2,2,1,3
C(CCC(C(C(C(O)=O)C)=O)O)=O,,,5,1,1,0,1
92287_0,,,,2,2,1,3
C(CCC(C(O)=O)(C(CO)=O)C)=O,,,5,1,1,0,1
92289_0,,,,2,2,1,3
C(CCCC(C(O)=O)C(CO)=O)=O,,,5,1,1,0,1
92291_0,,,,2,2,1,3
C(C(C=O)(CCC=O)CCO)(O)=O,,,5,1,1,0,1
92293_0,,,,2,2,1,3
C(C(C=O)CC(CCC=O)O)(O)=O,,,5,1,1,0,1
92295_0,,,,2,2,1,3
C(C(C=O)C(CCC=O)CO)(O)=O,,,5,1,1,0,1
92297_0,,,,2,2,1,3
C(CCC1C(C(C(CO)O1)O)=O)=O,,,5,1,1,0,1
92299_0,,,,2,2,1,3
C(CCC1(CO)C(C(CO1)=O)O)=O,,,5,1,1,0,1
92301_0,,,,2,2,1,3
C(CCC1(C(COC1CO)=O)O)=O,,,5,1,1,0,1
92303_0,,,,2,2,1,3
C(CCC(C1C(C(CO1)=O)O)O)=O,,,5,1,1,0,1
92305_0,,,,2,2,1,3
C(CCC1(C(CC(CO)O1)=O)O)=O,,,5,1,1,0,1
92307_0,,,,2,2,1,3
C(CCC1(CO)CC(C(O)O1)=O)=O,,,5,1,1,0,1
92309_0,,,,2,2,1,3
C(CCC1C(C(O)OC1CO)=O)=O,,,5,1,1,0,1
92311_0,,,,2,2,1,3
C(CCC(C1CC(C(O)O1)=O)O)=O,,,5,1,1,0,1
92313_0,,,,2,2,1,3
C1(C(CCC=O)C(C(CO)O1)O)=O,,,5,1,1,0,1
92315_0,,,,2,2,1,3
C1(CC(C(CCC=O)(CO)O1)O)=O,,,5,1,1,0,1
92317_0,,,,2,2,1,3
C1(CC(CCC=O)(C(CO)O1)O)=O,,,5,1,1,0,1
92319_0,,,,2,2,1,3
C1(CC(C(C(CCC=O)O)O1)O)=O,,,5,1,1,0,1
92321_0,,,,2,2,1,3
C(CCC1C(C(C=O)(CO1)O)=O)=O,,,5,1,1,0,1
92323_0,,,,2,2,1,3
C(CCC1C(C=O)(C(CO1)=O)O)=O,,,5,1,1,0,1
92325_0,,,,2,2,1,3
C(CCC1(C(C(C=O)CO1)=O)O)=O,,,5,1,1,0,1
92327_0,,,,2,2,1,3
C(CCC1(C=O)C(C(O)OC1)=O)=O,,,5,1,1,0,1
92329_0,,,,2,2,1,3
C(CCC1C(C=O)C(C(O)O1)=O)=O,,,5,1,1,0,1
92331_0,,,,2,2,1,3
C1(C(CCC=O)C(C=O)(CO1)O)=O,,,5,1,1,0,1
92333_0,,,,2,2,1,3
C(CCC1C(C=O)(CC(O1)=O)O)=O,,,5,1,1,0,1
92335_0,,,,2,2,1,3
C(C1C(O)OC(CCC=O)C1O)=O,,,5,1,1,0,1
92337_0,,,,2,2,1,3
C(C1C(O)OCC1(CCC=O)O)=O,,,5,1,1,0,1
92339_0,,,,2,2,1,3
C(C1(CCC=O)C(O)OCC1O)=O,,,5,1,1,0,1
92341_0,,,,2,2,1,3
C(C1C(CCC=O)(O)OCC1O)=O,,,5,1,1,0,1
92343_0,,,,2,2,1,3
C(CC(C)C1C(C(C(O1)=O)O)=O)=O,,,5,1,1,0,1
92345_0,,,,2,2,1,3
C(CCC1C(C(C(O1)=O)O)=O)=O,,,5,1,1,0,1
92347_0,,,,2,2,1,3
C(CCC1C(C(C(O1)=O)O)=O)(O)=O,,,5,1,1,0,1
92349_0,,,,2,2,1,3
C(CC(C)C1(C(OCC1=O)=O)O)=O,,,5,1,1,0,1
92351_0,,,,2,2,1,3
C(CCC1(C(OCC1=O)=O)O)=O,,,5,1,1,0,1
92353_0,,,,2,2,1,3
C(CCC1(C(OCC1=O)=O)O)(O)=O,,,5,1,1,0,1
92355_0,,,,2,2,1,3
C(CC(C)C1(C(CC(O1)=O)=O)O)=O,,,5,1,1,0,1
92357_0,,,,2,2,1,3
C(CCC1(C(CC(O1)=O)=O)O)=O,,,5,1,1,0,1
92359_0,,,,2,2,1,3
C(CCC1(C(CC(O1)=O)=O)O)(O)=O,,,5,1,1,0,1
92361_0,,,,2,2,1,3
C(CC(C)C1C(OC(C1=O)O)=O)=O,,,5,1,1,0,1
92363_0,,,,2,2,1,3
C(CCC1C(OC(C1=O)O)=O)=O,,,5,1,1,0,1
92364_0,,,,2,2,1,3
92366_0,,,,2,2,1,3
C1(C(C(C)CC=O)C(C(O1)=O)O)=O,,,5,1,1,0,1
92368_0,,,,2,2,1,3
C1(C(CCC=O)C(C(O1)=O)O)=O,,,5,1,1,0,1
92370_0,,,,2,2,1,3
C1(C(CCC(O)=O)C(C(O1)=O)O)=O,,,5,1,1,0,1
92372_0,,,,2,2,1,3
C1(C(C(C)CC=O)(CC(O1)=O)O)=O,,,5,1,1,0,1
92374_0,,,,2,2,1,3
C1(C(CCC=O)(CC(O1)=O)O)=O,,,5,1,1,0,1
92376_0,,,,2,2,1,3
C1(C(CCC(O)=O)(CC(O1)=O)O)=O,,,5,1,1,0,1
92378_0,,,,2,2,1,3
C(CC(C)C1C(C(OC1O)=O)=O)=O,,,5,1,1,0,1
92380_0,,,,2,2,1,3
C(CCC1C(C(OC1O)=O)=O)=O,,,5,1,1,0,1
92381_0,,,,2,2,1,3
92383_0,,,,2,2,1,3
C(CC(C)C1(CC(C(O1)=O)=O)O)=O,,,5,1,1,0,1
92385_0,,,,2,2,1,3
C(CCC1(CC(C(O1)=O)=O)O)=O,,,5,1,1,0,1
92387_0,,,,2,2,1,3
C(CCC1(CC(C(O1)=O)=O)O)(O)=O,,,5,1,1,0,1
92389_0,,,,2,2,1,3
C(CCC1C(C(C(CO1)O)O)=O)=O,,,5,1,1,0,1
92391_0,,,,2,2,1,3
C(CCC1(COCC(C1O)=O)O)=O,,,5,1,1,0,1
92393_0,,,,2,2,1,3
C(CCC1(C(COCC1O)=O)O)=O,,,5,1,1,0,1
92395_0,,,,2,2,1,3
C(CCC1C(C(C(CO1)=O)O)O)=O,,,5,1,1,0,1
92397_0,,,,2,2,1,3
C(CCC1(C(CC(CO1)O)=O)O)=O,,,5,1,1,0,1
92399_0,,,,2,2,1,3
C(CCC1(COC(C(C1)=O)O)O)=O,,,5,1,1,0,1
92401_0,,,,2,2,1,3
C(CCC1C(C(O)OCC1O)=O)=O,,,5,1,1,0,1
92403_0,,,,2,2,1,3
C(CCC1C(CC(C(O)O1)=O)O)=O,,,5,1,1,0,1
92405_0,,,,2,2,1,3
C1(C(CCC=O)C(C(CO1)O)O)=O,,,5,1,1,0,1
92407_0,,,,2,2,1,3
C1(CC(C(CO1)(CCC=O)O)O)=O,,,5,1,1,0,1
92409_0,,,,2,2,1,3
C1(CC(CCC=O)(C(CO1)O)O)=O,,,5,1,1,0,1
92411_0,,,,2,2,1,3
C1(CC(C(C(CCC=O)O1)O)O)=O,,,5,1,1,0,1
92413_0,,,,2,2,1,3
C(CCC1(C(OCC(C1)=O)O)O)=O,,,5,1,1,0,1
92415_0,,,,2,2,1,3
C(CCC1(C(CC(CO1)=O)O)O)=O,,,5,1,1,0,1
92417_0,,,,2,2,1,3
C(CCC1C(COC(C1O)O)=O)=O,,,5,1,1,0,1
92419_0,,,,2,2,1,3
C(CCC1C(CC(C(O1)O)O)=O)=O,,,5,1,1,0,1
92421_0,,,,2,2,1,3
C(CCC1C(C(COC1O)O)=O)=O,,,5,1,1,0,1
92423_0,,,,2,2,1,3
C(CCC1(CC(C(CO1)O)=O)O)=O,,,5,1,1,0,1
92425_0,,,,2,2,1,3
C1(CC(O)OCC1(CCC=O)O)=O,,,5,1,1,0,1
92427_0,,,,2,2,1,3
C(CCC1C(C(CC(O)O1)=O)O)=O,,,5,1,1,0,1
92429_0,,,,2,2,1,3
C1(CCOC(C1(CCC=O)O)O)=O,,,5,1,1,0,1
92431_0,,,,2,2,1,3
C(CCC1(C(C(CCO1)=O)O)O)=O,,,5,1,1,0,1
92433_0,,,,2,2,1,3
C(CCC1C(C(C(O)OC1)O)=O)=O,,,5,1,1,0,1
92435_0,,,,2,2,1,3
C(CCC1CC(C(C(O)O1)O)=O)=O,,,5,1,1,0,1
92437_0,,,,2,2,1,3
C(C(C)C(C=O)C1CC(C(O1)=O)=O)=O,,,5,1,1,0,1
92439_0,,,,2,2,1,3
C(C(C)(C1CC(C(O1)=O)=O)CC=O)=O,,,5,1,1,0,1
92441_0,,,,2,2,1,3
C(C(CC1CC(C(O1)=O)=O)CC=O)=O,,,5,1,1,0,1
92443_0,,,,2,2,1,3
C(C(C1CC(C(O1)=O)=O)CC(C)=O)=O,,,5,1,1,0,1
92445_0,,,,2,2,1,3
C(C)(C(C1CC(C(O1)=O)=O)CC=O)=O,,,5,1,1,0,1
92447_0,,,,2,2,1,3
C(C(CC(C)C1CC(C(O1)=O)=O)=O)=O,,,5,1,1,0,1
92449_0,,,,2,2,1,3
C(CC(C1CC(C(O1)=O)=O)CC=O)=O,,,5,1,1,0,1
92451_0,,,,2,2,1,3
C(C(C=O)C(C)C1CC(C(O1)=O)=O)=O,,,5,1,1,0,1
92453_0,,,,2,2,1,3
C(C(C=O)CC1CC(C(O1)=O)=O)=O,,,5,1,1,0,1
92455_0,,,,2,2,1,3
C(CC(C)C1CC(C(O1)=O)=O)=O,,,5,1,1,0,1
92457_0,,,,2,2,1,3
C(CCC1CC(C(O1)=O)=O)=O,,,5,1,1,0,1
92459_0,,,,2,2,1,3
C1(CC(CO1)C2CC(C(O2)=O)=O)=O,,,5,1,1,0,1
92461_0,,,,2,2,1,3
C(C(CCC1CC(C(O1)=O)=O)=O)=O,,,5,1,1,0,1
92463_0,,,,2,2,1,3
C(C(C1CC(C(O1)=O)=O)CC=O)=O,,,5,1,1,0,1
92464_0,,,,2,2,1,3
92466_0,,,,2,2,1,3
C(C(C)C(C=O)C1C(C(OC1)=O)=O)=O,,,5,1,1,0,1
92468_0,,,,2,2,1,3
C(C(C)(CC=O)C1C(C(OC1)=O)=O)=O,,,5,1,1,0,1
92470_0,,,,2,2,1,3
C(C(CC1C(C(OC1)=O)=O)CC=O)=O,,,5,1,1,0,1
92472_0,,,,2,2,1,3
C(CC(C=O)C1C(C(OC1)=O)=O)(C)=O,,,5,1,1,0,1
92474_0,,,,2,2,1,3
C(CC(C(C)=O)C1C(C(OC1)=O)=O)=O,,,5,1,1,0,1
92476_0,,,,2,2,1,3
C1(C(OCC1C(C)CC(C=O)=O)=O)=O,,,5,1,1,0,1
92478_0,,,,2,2,1,3
C(CC(CC=O)C1C(C(OC1)=O)=O)=O,,,5,1,1,0,1
92480_0,,,,2,2,1,3
C(C(C=O)C(C)C1C(C(OC1)=O)=O)=O,,,5,1,1,0,1
92482_0,,,,2,2,1,3
C(C(C=O)CC1C(C(OC1)=O)=O)=O,,,5,1,1,0,1
92484_0,,,,2,2,1,3
C(CC(C)C1C(C(OC1)=O)=O)=O,,,5,1,1,0,1
92486_0,,,,2,2,1,3
C(CCC1C(C(OC1)=O)=O)=O,,,5,1,1,0,1
92488_0,,,,2,2,1,3
C1(CC(CO1)C2C(C(OC2)=O)=O)=O,,,5,1,1,0,1
92490_0,,,,2,2,1,3
C1(C(OCC1CCC(C=O)=O)=O)=O,,,5,1,1,0,1
92492_0,,,,2,2,1,3
C(CC(C=O)C1C(C(OC1)=O)=O)=O,,,5,1,1,0,1
92493_0,,,,2,2,1,3
92495_0,,,,2,2,1,3
C(C(C)C(C=O)C1C(COC1=O)=O)=O,,,5,1,1,0,1
92497_0,,,,2,2,1,3
C(C(C)(CC=O)C1C(COC1=O)=O)=O,,,5,1,1,0,1
92499_0,,,,2,2,1,3
C(C(CC1C(COC1=O)=O)CC=O)=O,,,5,1,1,0,1
92501_0,,,,2,2,1,3
C1(C(C(CO1)=O)C(C=O)CC(C)=O)=O,,,5,1,1,0,1
92503_0,,,,2,2,1,3
C1(C(C(CO1)=O)C(C(C)=O)CC=O)=O,,,5,1,1,0,1
92505_0,,,,2,2,1,3
C1(COC(C1C(C)CC(C=O)=O)=O)=O,,,5,1,1,0,1
92507_0,,,,2,2,1,3
C(CC(CC=O)C1C(COC1=O)=O)=O,,,5,1,1,0,1
92509_0,,,,2,2,1,3
C(C(C=O)C(C)C1C(COC1=O)=O)=O,,,5,1,1,0,1
92511_0,,,,2,2,1,3
C(C(C=O)CC1C(COC1=O)=O)=O,,,5,1,1,0,1
92513_0,,,,2,2,1,3
C(CC(C)C1C(COC1=O)=O)=O,,,5,1,1,0,1
92515_0,,,,2,2,1,3
C(CCC1C(COC1=O)=O)=O,,,5,1,1,0,1
92517_0,,,,2,2,1,3
C1(CC(CO1)C2C(COC2=O)=O)=O,,,5,1,1,0,1
92519_0,,,,2,2,1,3
C1(COC(C1CCC(C=O)=O)=O)=O,,,5,1,1,0,1
92521_0,,,,2,2,1,3
C1(C(C(CO1)=O)C(C=O)CC=O)=O,,,5,1,1,0,1
92522_0,,,,2,2,1,3
92524_0,,,,2,2,1,3
C(C(C)C(C=O)C1C(CC(O1)=O)=O)=O,,,5,1,1,0,1
92526_0,,,,2,2,1,3
C(CC(C=O)(C)C1C(CC(O1)=O)=O)=O,,,5,1,1,0,1
92528_0,,,,2,2,1,3
C(C(CC1C(CC(O1)=O)=O)CC=O)=O,,,5,1,1,0,1
92530_0,,,,2,2,1,3
C1(CC(C(C(C=O)CC(C)=O)O1)=O)=O,,,5,1,1,0,1
92532_0,,,,2,2,1,3
C1(CC(C(C(C(C)=O)CC=O)O1)=O)=O,,,5,1,1,0,1
92534_0,,,,2,2,1,3
C1(C(C(C)CC(C=O)=O)OC(C1)=O)=O,,,5,1,1,0,1
92536_0,,,,2,2,1,3
C(CC(C1C(CC(O1)=O)=O)CC=O)=O,,,5,1,1,0,1
92538_0,,,,2,2,1,3
C(C(C=O)C(C)C1C(CC(O1)=O)=O)=O,,,5,1,1,0,1
92540_0,,,,2,2,1,3
C(C(C=O)CC1C(CC(O1)=O)=O)=O,,,5,1,1,0,1
92542_0,,,,2,2,1,3
C(CC(C)C1C(CC(O1)=O)=O)=O,,,5,1,1,0,1
92544_0,,,,2,2,1,3
C(CCC1C(CC(O1)=O)=O)=O,,,5,1,1,0,1
92546_0,,,,2,2,1,3
C1(CC(CO1)C2C(CC(O2)=O)=O)=O,,,5,1,1,0,1
92548_0,,,,2,2,1,3
C1(C(CCC(C=O)=O)OC(C1)=O)=O,,,5,1,1,0,1
92550_0,,,,2,2,1,3
C1(CC(C(C(C=O)CC=O)O1)=O)=O,,,5,1,1,0,1
92551_0,,,,2,2,1,3
92553_0,,,,2,2,1,3
C(CCC1(CO)CC(C(O1)=O)=O)=O,,,5,1,1,0,1
92555_0,,,,2,2,1,3
C(CCC1C(C(OC1CO)=O)=O)=O,,,5,1,1,0,1
92557_0,,,,2,2,1,3
C(CCC(C1CC(C(O1)=O)=O)O)=O,,,5,1,1,0,1
92559_0,,,,2,2,1,3
C(CCC1C(OC(C1=O)CO)=O)=O,,,5,1,1,0,1
92561_0,,,,2,2,1,3
C1(C(CCC=O)(CO)OC(C1)=O)=O,,,5,1,1,0,1
92562_0,,,,2,2,1,3
92564_0,,,,2,2,1,3
C(CCC1(COC(C(C1)=O)=O)O)=O,,,5,1,1,0,1
92566_0,,,,2,2,1,3
C(CCC1C(C(OCC1O)=O)=O)=O,,,5,1,1,0,1
92568_0,,,,2,2,1,3
C(CCC1C(CC(C(O1)=O)=O)O)=O,,,5,1,1,0,1
92570_0,,,,2,2,1,3
C1(C(CCC=O)(CC(CO1)=O)O)=O,,,5,1,1,0,1
92572_0,,,,2,2,1,3
C1(COC(C(C1CCC=O)O)=O)=O,,,5,1,1,0,1
92574_0,,,,2,2,1,3
C1(CC(C(OC1CCC=O)=O)O)=O,,,5,1,1,0,1
92576_0,,,,2,2,1,3
C(CCC1C(OCC(C1=O)O)=O)=O,,,5,1,1,0,1
92578_0,,,,2,2,1,3
C1(C(COC(C1)=O)(CCC=O)O)=O,,,5,1,1,0,1
92580_0,,,,2,2,1,3
C(CCC1C(C(CC(O1)=O)=O)O)=O,,,5,1,1,0,1
92582_0,,,,2,2,1,3
C1(C(C(CCO1)=O)(CCC=O)O)=O,,,5,1,1,0,1
92584_0,,,,2,2,1,3
C1(C(COC(C1O)=O)CCC=O)=O,,,5,1,1,0,1
92586_0,,,,2,2,1,3
C1(C(C(CC(CCC=O)O1)=O)O)=O,,,5,1,1,0,1
92588_0,,,,2,2,1,3
C(C(CCC=O)(CC(C)=O)O)(O)=O,,,5,1,1,0,1
92590_0,,,,2,2,1,3
C(C)(C(CCC=O)C(C(O)=O)O)=O,,,5,1,1,0,1
92592_0,,,,2,2,1,3
C(CC(C(O)=O)O)(CCCC=O)=O,,,5,1,1,0,1
92594_0,,,,2,2,1,3
C(C(CCC=O)(CCC=O)O)(O)=O,,,5,1,1,0,1
92596_0,,,,2,2,1,3
C(CCC(C=O)CC(C(O)=O)O)=O,,,5,1,1,0,1
92598_0,,,,2,2,1,3
C(CCC(C(C(O)=O)O)CC=O)=O,,,5,1,1,0,1
92600_0,,,,2,2,1,3
C(C(CC(CO)(CO)CO)=O)=O,,,5,1,1,0,1
92602_0,,,,2,2,1,3
C(CC(CO)(CO)CC(C=O)=O)=O,,,5,1,4,0,4
92604_0,,,,2,2,1,3
C(C(CC(CO)(CO)C(C)O)=O)=O,,,5,1,1,0,1
92606_0,,,,2,2,1,3
C(C(CC(CO)(CO)CCO)=O)=O,,,5,1,1,0,1
92608_0,,,,2,2,1,3
C(C(C=O)C(CO)(CO)CO)=O,,,5,1,1,0,1
92610_0,,,,2,2,1,3
C(C(C=O)C(CO)(CO)CC=O)=O,,,5,1,4,0,4
92612_0,,,,2,2,1,3
C(C(C=O)C(CO)(CO)C(C)O)=O,,,5,1,1,0,1
92614_0,,,,2,2,1,3
C(C(C=O)C(CO)(CO)CCO)=O,,,5,1,1,0,1
92616_0,,,,2,2,1,3
C(CC(C)C(C(CO)=CC=O)O)=O,,,5,1,1,0,1
92618_0,,,,2,2,1,3
C(CCC(C(CO)=CC=O)O)=O,,,5,1,1,0,1
92620_0,,,,2,2,1,3
C(CCC(C(CO)=CC=O)O)(O)=O,,,5,1,1,0,1
92622_0,,,,2,2,1,3
C(CC(CO)(CO)CC=CC=O)=O,,,5,1,1,0,1
92624_0,,,,2,2,1,3
C(C(C=C)C(CO)(CO)CC=O)=O,,,5,1,1,0,1
92626_0,,,,2,2,1,3
C(CC(CO)(CO)C(C=C)O)=O,,,5,1,1,0,1
92628_0,,,,2,2,1,3
C(CC(CO)(CO)CO)=O,,,5,1,1,0,1
92630_0,,,,2,2,1,3
C(CC(CO)(CO)C(CO)O)=O,,,5,1,2,0,2
92632_0,,,,2,2,1,3
C(CC(CO)(CO)C(C(O)=O)O)=O,,,5,1,2,0,2
92633_0,,,,2,2,1,3
92634_0,,,,2,2,1,3
92636_0,,,,2,2,1,3
C(CC(CO)(CO)CC=O)=O,,,5,1,2,0,2
92638_0,,,,2,2,1,3
C(CC(C(CO)(CO)CC=O)O)=O,,,5,1,1,0,1
92640_0,,,,2,2,1,3
C(C(CO)C(CO)(CO)CC=O)=O,,,5,1,1,0,1
92642_0,,,,2,2,1,3
C(CC(CO)(CO)C(C(C)=O)O)=O,,,5,1,1,0,1
92644_0,,,,2,2,1,3
C(CC(CO)(CO)CC(CO)=O)=O,,,5,1,1,0,1
92646_0,,,,2,2,1,3
C(CC(CO)(CO)C(C)O)=O,,,5,1,1,0,1
92648_0,,,,2,2,1,3
C(CC(CO)(CO)CCO)=O,,,5,1,1,0,1
92650_0,,,,2,2,1,3
C(CC(CO)(CO)CC=O)(O)=O,,,5,1,1,0,1
92652_0,,,,2,2,1,3
C(CC(CO)(CO)C(C=O)(O)O)=O,,,5,1,1,0,1
92654_0,,,,2,2,1,3
C(C(C)(C(CO)(CO)CC=O)O)=O,,,5,1,1,0,1
92656_0,,,,2,2,1,3
C(CC(CO)(CO)CC(C=O)O)=O,,,5,1,1,0,1
92658_0,,,,2,2,1,3
C(CC([C](C(O)=O)O)(CO)CO)=O,,,5,1,1,0,1
92660_0,,,,2,2,1,3
C(CC(CO)(CO)C(C=O)O)=O,,,5,1,2,0,2
92661_0,,,,2,2,1,3
92663_0,,,,2,2,1,3
C(CCC(C=O)C(C(CO)=O)O)=O,,,5,1,2,0,2
92665_0,,,,2,2,1,3
C(C(CC(C)O)C(C(CO)=O)O)=O,,,5,1,1,0,1
92667_0,,,,2,2,1,3
C(C(CCCO)C(C(CO)=O)O)=O,,,5,1,1,0,1
92668_0,,,,2,2,1,3
92670_0,,,,2,2,1,3
C(CC(C(C(CO)=O)O)CC=O)=O,,,5,1,2,0,2
92672_0,,,,2,2,1,3
C(CC(C(C)O)C(C(CO)=O)O)=O,,,5,1,1,0,1
92674_0,,,,2,2,1,3
C(CC(CCO)C(C(CO)=O)O)=O,,,5,1,1,0,1
92676_0,,,,2,2,1,3
C(CC(C)C(C(CO)=O)(C=C)O)=O,,,5,1,1,0,1
92678_0,,,,2,2,1,3
C(CCC(C(CO)=O)(C=C)O)=O,,,5,1,1,0,1
92680_0,,,,2,2,1,3
C(CCC(C(CO)=O)(C=C)O)(O)=O,,,5,1,1,0,1
92682_0,,,,2,2,1,3
C(CC(C)C(C(C(C=C)O)=O)O)=O,,,5,1,1,0,1
92684_0,,,,2,2,1,3
C(CCC(C(C(C=C)O)=O)O)=O,,,5,1,1,0,1
92686_0,,,,2,2,1,3
C(CCC(C(C(C=C)O)=O)O)(O)=O,,,5,1,1,0,1
92687_0,,,,2,2,1,3
92689_0,,,,2,2,1,3
C(CC(CO)(C(CO)O)CC=O)=O,,,5,1,2,0,2
92691_0,,,,2,2,1,3
C(CC(CO)(C(CO)O)C(C)O)=O,,,5,1,1,0,1
92693_0,,,,2,2,1,3
C(CC(CO)(CCO)C(CO)O)=O,,,5,1,1,0,1
92695_0,,,,2,2,1,3
C(CC(C(C=O)=O)CC=CC=O)(O)=O,,,5,1,1,0,1
92697_0,,,,2,2,1,3
C(C(C=C)C(C(C=O)=O)CC(O)=O)=O,,,5,1,1,0,1
92699_0,,,,2,2,1,3
C(CC(C(C=O)=O)C(C=C)O)(O)=O,,,5,1,1,0,1
92700_0,,,,2,2,1,3
92702_0,,,,2,2,1,3
C(CC(C(C=O)=O)C(CO)O)(O)=O,,,5,1,1,0,1
92704_0,,,,2,2,1,3
C(CC(C(C=O)=O)CC(O)=O)=O,,,5,1,2,0,2
92705_0,,,,2,2,1,3
92707_0,,,,2,2,1,3
C(CC(C(C=O)=O)CCO)(O)=O,,,5,1,1,0,1
92709_0,,,,2,2,1,3
C(CC(C(C=O)=O)CC(O)=O)(O)=O,,,5,1,1,0,1
92711_0,,,,2,2,1,3
C(CC(C(C=O)=O)C(C=O)O)(O)=O,,,5,1,1,0,1
92713_0,,,,2,2,1,3
C(C(CC(C=O)=O)CC=CC=O)(O)=O,,,5,1,1,0,1
92715_0,,,,2,2,1,3
C(C(C=C)C(C(O)=O)CC(C=O)=O)=O,,,5,1,1,0,1
92717_0,,,,2,2,1,3
C(C(CC(C=O)=O)C(C=C)O)(O)=O,,,5,1,1,0,1
92718_0,,,,2,2,1,3
92719_0,,,,2,2,1,3
92720_0,,,,2,2,1,3
92722_0,,,,2,2,1,3
C(C(C(C)O)CC(C=O)=O)(O)=O,,,5,1,1,0,1
92724_0,,,,2,2,1,3
C(C(CCO)CC(C=O)=O)(O)=O,,,5,1,1,0,1
92726_0,,,,2,2,1,3
C(CC(C(O)=O)CC(C=O)=O)(O)=O,,,5,1,2,0,2
92728_0,,,,2,2,1,3
C(C(CC(C=O)=O)C(C=O)O)(O)=O,,,5,1,1,0,1
92730_0,,,,2,2,1,3
C(C(C=O)(CC(O)=O)CC=CC=O)=O,,,5,1,1,0,1
92732_0,,,,2,2,1,3
C(C(C=O)(CC(O)=O)C(C=O)C=C)=O,,,5,1,1,0,1
92734_0,,,,2,2,1,3
C(C(C=O)(CC(O)=O)C(C=C)O)=O,,,5,1,1,0,1
92735_0,,,,2,2,1,3
92737_0,,,,2,2,1,3
C(C(C=O)(C(CO)O)CC(O)=O)=O,,,5,1,1,0,1
92739_0,,,,2,2,1,3
C(C(C=O)(CC(O)=O)CC=O)=O,,,5,1,2,0,2
92740_0,,,,2,2,1,3
92742_0,,,,2,2,1,3
C(C(C=O)(CCO)CC(O)=O)=O,,,5,1,1,0,1
92744_0,,,,2,2,1,3
C(C(C=O)(CC(O)=O)CC(O)=O)=O,,,5,1,1,0,1
92746_0,,,,2,2,1,3
C(C(C=O)(CC(O)=O)C(C=O)O)=O,,,5,1,1,0,1
92748_0,,,,2,2,1,3
C(C(C=O)C(C(O)=O)CC=CC=O)=O,,,5,1,1,0,1
92750_0,,,,2,2,1,3
C(C(C=C)C(C(O)=O)C(C=O)C=O)=O,,,5,1,1,0,1
92752_0,,,,2,2,1,3
C(C(C=O)C(C(O)=O)C(C=C)O)=O,,,5,1,1,0,1
92753_0,,,,2,2,1,3
92754_0,,,,2,2,1,3
92755_0,,,,2,2,1,3
92757_0,,,,2,2,1,3
C(C(C=O)C(C(O)=O)C(C)O)=O,,,5,1,1,0,1
92759_0,,,,2,2,1,3
C(C(C=O)C(C(O)=O)CCO)=O,,,5,1,1,0,1
92761_0,,,,2,2,1,3
C(C(C=O)C(C(O)=O)CC(O)=O)=O,,,5,1,2,0,2
92762_0,,,,2,2,1,3
92763_0,,,,2,2,1,3
92765_0,,,,2,2,1,3
C(CC(C(C=O)=O)(CO)CO)(O)=O,,,5,1,1,0,1
92766_0,,,,2,2,1,3
92767_0,,,,2,2,1,3
92768_0,,,,2,2,1,3
92770_0,,,,2,2,1,3
C(CC(C=O)(CO)C(C=O)O)(O)=O,,,5,1,1,0,1
92771_0,,,,2,2,1,3
92773_0,,,,2,2,1,3
C(CO)(C(C=O)(CO)CC(O)=O)=O,,,5,1,1,0,1
92774_0,,,,2,2,1,3
92775_0,,,,2,2,1,3
92776_0,,,,2,2,1,3
92777_0,,,,2,2,1,3
92779_0,,,,2,2,1,3
C(CC(C(CO)(CO)O)CC=O)=O,,,5,1,2,0,2
92781_0,,,,2,2,1,3
C(CC(C(C)O)C(CO)(CO)O)=O,,,5,1,1,0,1
92783_0,,,,2,2,1,3
C(CC(CCO)C(CO)(CO)O)=O,,,5,1,1,0,1
92785_0,,,,2,2,1,3
C(CC(C)CC(C=O)=CC(C=O)=O)=O,,,5,1,1,0,1
92787_0,,,,2,2,1,3
C(CCCC(C=O)=CC(C=O)=O)=O,,,5,1,1,0,1
92789_0,,,,2,2,1,3
C(CCCC(C=O)=CC(C=O)=O)(O)=O,,,5,1,1,0,1
92791_0,,,,2,2,1,3
C(C(C)C(C(C=O)=O)CC=CC=O)=O,,,5,1,1,0,1
92793_0,,,,2,2,1,3
C(C(C)C(C(C=O)=O)C(C=O)C=C)=O,,,5,1,1,0,1
92795_0,,,,2,2,1,3
C(C(C)C(C(C=O)=O)C(C=C)O)=O,,,5,1,1,0,1
92796_0,,,,2,2,1,3
92798_0,,,,2,2,1,3
C(C(C)C(C(C=O)=O)C(CO)O)=O,,,5,1,1,0,1
92800_0,,,,2,2,1,3
C(C(C)C(C(C=O)=O)CC(C=O)=O)=O,,,5,1,1,0,1
92802_0,,,,2,2,1,3
C(C(C)C(C(C=O)=O)C(C=O)C=O)=O,,,5,1,1,0,1
92804_0,,,,2,2,1,3
C(CC(C(C=O)=O)C(C=O)C)=O,,,5,1,1,0,1
92805_0,,,,2,2,1,3
92807_0,,,,2,2,1,3
C(C(C)C(C(C=O)=O)CCO)=O,,,5,1,1,0,1
92809_0,,,,2,2,1,3
C(C(C)C(C(C=O)=O)CC(O)=O)=O,,,5,1,1,0,1
92811_0,,,,2,2,1,3
C(C(C(C(C=O)=O)C(C=O)C)O)=O,,,5,1,1,0,1
92813_0,,,,2,2,1,3
C(C(C)(CC(C=O)=O)CC=CC=O)=O,,,5,1,1,0,1
92815_0,,,,2,2,1,3
C(C(C)(CC(C=O)=O)C(C=O)C=C)=O,,,5,1,1,0,1
92817_0,,,,2,2,1,3
C(C(C)(C(C=C)O)CC(C=O)=O)=O,,,5,1,1,0,1
92819_0,,,,2,2,1,3
C(C(C)(CO)CC(C=O)=O)=O,,,5,1,1,0,1
92821_0,,,,2,2,1,3
C(C(C)(C(CO)O)CC(C=O)=O)=O,,,5,1,1,0,1
92823_0,,,,2,2,1,3
C(C(C)(CC(C=O)=O)CC(C=O)=O)=O,,,5,1,1,0,1
92825_0,,,,2,2,1,3
C(C(C)(CC(C=O)=O)C(C=O)C=O)=O,,,5,1,2,0,2
92827_0,,,,2,2,1,3
C(C(C)(CC=O)CC(C=O)=O)=O,,,5,1,2,0,2
92829_0,,,,2,2,1,3
C(C(C)(C(C)O)CC(C=O)=O)=O,,,5,1,1,0,1
92831_0,,,,2,2,1,3
C(C(C)(CCO)CC(C=O)=O)=O,,,5,1,1,0,1
92833_0,,,,2,2,1,3
C(C(C)(CC(O)=O)CC(C=O)=O)=O,,,5,1,1,0,1
92835_0,,,,2,2,1,3
C(C(C)(C(C=O)O)CC(C=O)=O)=O,,,5,1,1,0,1
92837_0,,,,2,2,1,3
C(CC(C)C(C(C=O)=O)C(C=O)=C)=O,,,5,1,1,0,1
92839_0,,,,2,2,1,3
C(CCC(C(C=O)=O)C(C=O)=C)=O,,,5,1,1,0,1
92841_0,,,,2,2,1,3
C(CCC(C(C=O)=O)C(C=O)=C)(O)=O,,,5,1,1,0,1
92843_0,,,,2,2,1,3
C(C(CCC=CC=O)CC(C=O)=O)=O,,,5,1,1,0,1
92845_0,,,,2,2,1,3
C(C(CC(C=O)C=C)CC(C=O)=O)=O,,,5,1,1,0,1
92847_0,,,,2,2,1,3
C(C(CC(C=C)O)CC(C=O)=O)=O,,,5,1,1,0,1
92848_0,,,,2,2,1,3
92849_0,,,,2,2,1,3
92850_0,,,,2,2,1,3
92851_0,,,,2,2,1,3
92852_0,,,,2,2,1,3
92854_0,,,,2,2,1,3
C(C(CC(C)O)CC(C=O)=O)=O,,,5,1,1,0,1
92856_0,,,,2,2,1,3
C(C(CCCO)CC(C=O)=O)=O,,,5,1,1,0,1
92857_0,,,,2,2,1,3
92859_0,,,,2,2,1,3
C(C(CC(C=O)CC(C=O)=O)O)=O,,,5,1,2,0,2
92861_0,,,,2,2,1,3
C(CC(C)CC(C=O)=C(C=O)C=O)=O,,,5,1,1,0,1
92863_0,,,,2,2,1,3
C(CCCC(C=O)=C(C=O)C=O)=O,,,5,1,1,0,1
92865_0,,,,2,2,1,3
C(CCCC(C=O)=C(C=O)C=O)(O)=O,,,5,1,1,0,1
92867_0,,,,2,2,1,3
C(C(C)C(C=O)(C=O)CC=CC=O)=O,,,5,1,1,0,1
92869_0,,,,2,2,1,3
C(C(C=C)C(C=O)(C=O)C(C=O)C)=O,,,5,1,1,0,1
92871_0,,,,2,2,1,3
C(C(C)C(C=O)(C=O)C(C=C)O)=O,,,5,1,1,0,1
92872_0,,,,2,2,1,3
92874_0,,,,2,2,1,3
C(C(C=O)(C(CO)O)C(C=O)C)=O,,,5,1,1,0,1
92876_0,,,,2,2,1,3
C(C(C)C(C=O)(C=O)CC(C=O)=O)=O,,,5,1,1,0,1
92878_0,,,,2,2,1,3
C(C(C=O)C(C=O)(C=O)C(C=O)C)=O,,,5,1,1,0,1
92880_0,,,,2,2,1,3
C(C(C)C(C=O)(C=O)CC=O)=O,,,5,1,1,0,1
92881_0,,,,2,2,1,3
92883_0,,,,2,2,1,3
C(C(C=O)(CCO)C(C=O)C)=O,,,5,1,1,0,1
92885_0,,,,2,2,1,3
C(C(C)C(C=O)(C=O)CC(O)=O)=O,,,5,1,1,0,1
92887_0,,,,2,2,1,3
C(C(C)C(C=O)(C=O)C(C=O)O)=O,,,5,1,1,0,1
92889_0,,,,2,2,1,3
C(C(C)(CC=CC=O)C(C=O)C=O)=O,,,5,1,1,0,1
92891_0,,,,2,2,1,3
C(C(C=C)C(C=O)(C)C(C=O)C=O)=O,,,5,1,1,0,1
92893_0,,,,2,2,1,3
C(C(C)(C(C=C)O)C(C=O)C=O)=O,,,5,1,1,0,1
92895_0,,,,2,2,1,3
C(C(C=O)C(C=O)(C)CO)=O,,,5,1,1,0,1
92897_0,,,,2,2,1,3
C(C(C=O)C(C=O)(C)C(CO)O)=O,,,5,1,1,0,1
92898_0,,,,2,2,1,3
92900_0,,,,2,2,1,3
C(C(C=O)C(C=O)(C)C(C=O)C=O)=O,,,5,1,1,0,1
92902_0,,,,2,2,1,3
C(C(C)(CC=O)C(C=O)C=O)=O,,,5,1,2,0,2
92904_0,,,,2,2,1,3
C(C(C=O)C(C=O)(C)C(C)O)=O,,,5,1,1,0,1
92906_0,,,,2,2,1,3
C(C(C=O)C(C=O)(C)CCO)=O,,,5,1,1,0,1
92908_0,,,,2,2,1,3
C(C(C)(CC(O)=O)C(C=O)C=O)=O,,,5,1,1,0,1
92910_0,,,,2,2,1,3
C(C(C)(C(C=O)O)C(C=O)C=O)=O,,,5,1,1,0,1
92912_0,,,,2,2,1,3
C(C(C=O)(C(C=O)=C)C(C)CC=O)=O,,,5,1,1,0,1
92914_0,,,,2,2,1,3
C(C(C=O)(C(C=O)=C)CCC=O)=O,,,5,1,1,0,1
92916_0,,,,2,2,1,3
C(C(C=O)(C(C=O)=C)CCC(O)=O)=O,,,5,1,1,0,1
92918_0,,,,2,2,1,3
C(C(C=O)C(C=O)CCC=CC=O)=O,,,5,1,1,0,1
92920_0,,,,2,2,1,3
C(C(C=C)CC(C=O)C(C=O)C=O)=O,,,5,1,1,0,1
92922_0,,,,2,2,1,3
C(C(C=O)C(C=O)CC(C=C)O)=O,,,5,1,1,0,1
92923_0,,,,2,2,1,3
92924_0,,,,2,2,1,3
92925_0,,,,2,2,1,3
92926_0,,,,2,2,1,3
92927_0,,,,2,2,1,3
92929_0,,,,2,2,1,3
C(C(C=O)C(C=O)CC(C)O)=O,,,5,1,1,0,1
92931_0,,,,2,2,1,3
C(C(C=O)C(C=O)CCCO)=O,,,5,1,1,0,1
92932_0,,,,2,2,1,3
92934_0,,,,2,2,1,3
C(C(CC(C=O)C(C=O)C=O)O)=O,,,5,1,2,0,2
92935_0,,,,2,2,1,3
92937_0,,,,2,2,1,3
C(C(C)C(C(C=O)=O)(CO)CO)=O,,,5,1,1,0,1
92939_0,,,,2,2,1,3
C(C(C)(CO)C(C(C=O)=O)CO)=O,,,5,1,1,0,1
92940_0,,,,2,2,1,3
92941_0,,,,2,2,1,3
92942_0,,,,2,2,1,3
92944_0,,,,2,2,1,3
C(C(C)C(C=O)(CO)C(C=O)O)=O,,,5,1,1,0,1
92946_0,,,,2,2,1,3
C(C(C(C=O)C(C=O)(CO)C)O)=O,,,5,1,1,0,1
92947_0,,,,2,2,1,3
92949_0,,,,2,2,1,3
C(C(C)C(C=O)(C(CO)=O)CO)=O,,,5,1,1,0,1
92951_0,,,,2,2,1,3
C(C(CO)(C)C(C=O)C(CO)=O)=O,,,5,1,1,0,1
92952_0,,,,2,2,1,3
92953_0,,,,2,2,1,3
92955_0,,,,2,2,1,3
C(C(C(C(CO)C(C=O)C)=O)O)=O,,,5,1,1,0,1
92957_0,,,,2,2,1,3
C(C(CO)(C)CC(C(C=O)O)=O)=O,,,5,1,1,0,1
92958_0,,,,2,2,1,3
92960_0,,,,2,2,1,3
C(C(C)C(C=O)CC(C=O)=CC=O)=O,,,5,1,1,0,1
92962_0,,,,2,2,1,3
C(C(C)(CC=O)CC(C=O)=CC=O)=O,,,5,1,1,0,1
92964_0,,,,2,2,1,3
C(C(CCC(C=O)=CC=O)CC=O)=O,,,5,1,1,0,1
92966_0,,,,2,2,1,3
C(C(CC(C=O)=CC=O)CC(C)=O)=O,,,5,1,1,0,1
92968_0,,,,2,2,1,3
C(CC(C(C)=O)CC(C=O)=CC=O)=O,,,5,1,1,0,1
92970_0,,,,2,2,1,3
C(C(CC(C)CC(C=O)=CC=O)=O)=O,,,5,1,1,0,1
92972_0,,,,2,2,1,3
C(CC(CC=O)CC(C=O)=CC=O)=O,,,5,1,1,0,1
92974_0,,,,2,2,1,3
C(C(C=O)C(C)CC(C=O)=CC=O)=O,,,5,1,1,0,1
92976_0,,,,2,2,1,3
C(C(C=O)CCC(C=O)=CC=O)=O,,,5,1,1,0,1
92978_0,,,,2,2,1,3
C(CC(C)CC(C=O)=CC=O)=O,,,5,1,1,0,1
92980_0,,,,2,2,1,3
C(CCCC(C=O)=CC=O)=O,,,5,1,1,0,1
92982_0,,,,2,2,1,3
C1(CC(CO1)CC(C=O)=CC=O)=O,,,5,1,1,0,1
92984_0,,,,2,2,1,3
C(C(CCCC(C=O)=CC=O)=O)=O,,,5,1,1,0,1
92986_0,,,,2,2,1,3
C(CC(C=O)CC(C=O)=CC=O)=O,,,5,1,1,0,1
92987_0,,,,2,2,1,3
92989_0,,,,2,2,1,3
C(C(C)C(C=O)C(C=O)C(C=O)=C)=O,,,5,1,1,0,1
92991_0,,,,2,2,1,3
C(C(C)C(C=O)CC(C=CC=O)=O)=O,,,5,1,1,0,1
92993_0,,,,2,2,1,3
C(C(C)C(C=O)C(C=C)C(C=O)=O)=O,,,5,1,1,0,1
92995_0,,,,2,2,1,3
C(C(C)C(C=O)CC=CC(C=O)=O)=O,,,5,1,1,0,1
92997_0,,,,2,2,1,3
C(C(C)C(C=O)C(C=O)C=CC=O)=O,,,5,1,1,0,1
92999_0,,,,2,2,1,3
C(C(C)C(C=O)C(C=O)(C=O)C=C)=O,,,5,1,1,0,1
93001_0,,,,2,2,1,3
C(C(C)C(C=O)CC=C(C=O)C=O)=O,,,5,1,1,0,1
93003_0,,,,2,2,1,3
C(C(C)C(C=O)CC=CC=O)=O,,,5,1,1,0,1
93005_0,,,,2,2,1,3
C(C(C)C(C=O)C(C=O)C=C)=O,,,5,1,1,0,1
93007_0,,,,2,2,1,3
C(C(C)C(C=O)C(C=O)(C=C)O)=O,,,5,1,1,0,1
93009_0,,,,2,2,1,3
C(C(C)C(C=O)C1C=CC(O1)=O)=O,,,5,1,1,0,1
93011_0,,,,2,2,1,3
C(C(C)C(C=O)C1C(C=CO1)=O)=O,,,5,1,1,0,1
93013_0,,,,2,2,1,3
C(C(C)C(C=O)C(C=C)O)=O,,,5,1,1,0,1
93015_0,,,,2,2,1,3
C(C(C)C(C=O)C[C](C(O)=O)O)=O,,,5,1,1,0,1
93017_0,,,,2,2,1,3
C(C(C)C(C=O)C(C=O)(CO)O)=O,,,5,1,1,0,1
93019_0,,,,2,2,1,3
C(C(C(C(C=O)C(C=O)C)O)O)=O,,,5,1,1,0,1
93020_0,,,,2,2,1,3
93021_0,,,,2,2,1,3
93022_0,,,,2,2,1,3
93024_0,,,,2,2,1,3
C(C(C(C=O)C(C=O)C)O)(CO)=O,,,5,1,1,0,1
93026_0,,,,2,2,1,3
C(C(C(CO)(CO)O)C(C=O)C)=O,,,5,1,1,0,1
93028_0,,,,2,2,1,3
C(C(C(C(CO)O)O)C(C=O)C)=O,,,5,1,1,0,1
93030_0,,,,2,2,1,3
C(C(C)C(C=O)CC(C=O)=O)=O,,,5,1,1,0,1
93032_0,,,,2,2,1,3
C(C(C)C(C=O)C(C=O)C=O)=O,,,5,1,1,0,1
93034_0,,,,2,2,1,3
C(CC(C=O)C(C=O)C)=O,,,5,1,1,0,1
93036_0,,,,2,2,1,3
C(C(C)(C(C=O)C(C=O)C)O)(O)=O,,,5,1,1,0,1
93038_0,,,,2,2,1,3
C(C(CC(C=O)C(C=O)C)O)(O)=O,,,5,1,1,0,1
93040_0,,,,2,2,1,3
C(C(C)C(C=O)C(C(C=O)=O)O)=O,,,5,1,1,0,1
93042_0,,,,2,2,1,3
C(C(C)C(C=O)C(C=O)C(C)O)=O,,,5,1,1,0,1
93044_0,,,,2,2,1,3
C(CC(C)(C(C=O)C(C=O)C)O)=O,,,5,1,1,0,1
93046_0,,,,2,2,1,3
C(CC(CC(C=O)C(C=O)C)O)=O,,,5,1,1,0,1
93047_0,,,,2,2,1,3
93049_0,,,,2,2,1,3
C(C(C)C(C=O)C(C=O)CO)=O,,,5,1,1,0,1
93051_0,,,,2,2,1,3
C(C(C)C(C=O)C(C=O)(C=O)O)=O,,,5,1,1,0,1
93052_0,,,,2,2,1,3
93054_0,,,,2,2,1,3
C(CC(C=O)C(C=O)C)(CO)=O,,,5,1,1,0,1
93055_0,,,,2,2,1,3
93057_0,,,,2,2,1,3
C(C(CCO)C(C=O)C)=O,,,5,1,1,0,1
93059_0,,,,2,2,1,3
C(C(C)C(C=O)CC(C(O)=O)=O)=O,,,5,1,1,0,1
93061_0,,,,2,2,1,3
C(C(C)C(C=O)C(C=O)C(O)=O)=O,,,5,1,1,0,1
93063_0,,,,2,2,1,3
C(C(C)C(C=O)CC(O)=O)=O,,,5,1,1,0,1
93065_0,,,,2,2,1,3
C(C(C)C(C=O)C(C=O)C(C=O)=O)=O,,,5,1,1,0,1
93067_0,,,,2,2,1,3
C(C(C)C(C=O)CC(C(C=O)=O)=O)=O,,,5,1,1,0,1
93069_0,,,,2,2,1,3
C(C(C(C=O)(O)O)C(C=O)C)=O,,,5,1,1,0,1
93070_0,,,,2,2,1,3
93072_0,,,,2,2,1,3
C(C(CC(C=O)C(C=O)C)O)=O,,,5,1,1,0,1
93074_0,,,,2,2,1,3
C(C([C](C(O)=O)O)C(C=O)C)=O,,,5,1,1,0,1
93075_0,,,,2,2,1,3
93077_0,,,,2,2,1,3
C(C(C)(CC=O)C(C=O)C(C=O)=C)=O,,,5,1,1,0,1
93079_0,,,,2,2,1,3
C(C(C)(CC=O)CC(C=CC=O)=O)=O,,,5,1,1,0,1
93081_0,,,,2,2,1,3
C(C(C)(CC=O)C(C=C)C(C=O)=O)=O,,,5,1,1,0,1
93083_0,,,,2,2,1,3
C(C(C)(CC=O)CC=CC(C=O)=O)=O,,,5,1,1,0,1
93085_0,,,,2,2,1,3
C(C(C)(CC=O)C(C=O)C=CC=O)=O,,,5,1,1,0,1
93087_0,,,,2,2,1,3
C(C(C)(CC=O)C(C=O)(C=O)C=C)=O,,,5,1,1,0,1
93089_0,,,,2,2,1,3
C(C(C)(CC=O)CC=C(C=O)C=O)=O,,,5,1,1,0,1
93091_0,,,,2,2,1,3
C(C(C)(CC=O)CC=CC=O)=O,,,5,1,1,0,1
93093_0,,,,2,2,1,3
C(C(C)(CC=O)C(C=O)C=C)=O,,,5,1,1,0,1
93095_0,,,,2,2,1,3
C(C(C)(CC=O)C(C=O)(C=C)O)=O,,,5,1,1,0,1
93097_0,,,,2,2,1,3
C(CC(C=O)(C)C1C=CC(O1)=O)=O,,,5,1,1,0,1
93099_0,,,,2,2,1,3
C(CC(C=O)(C)C1C(C=CO1)=O)=O,,,5,1,1,0,1
93101_0,,,,2,2,1,3
C(CC(C=O)(C)C(C=C)O)=O,,,5,1,1,0,1
93103_0,,,,2,2,1,3
C(C(C)(CC=O)C[C](C(O)=O)O)=O,,,5,1,1,0,1
93105_0,,,,2,2,1,3
C(C(CO)(C(C=O)(C)CC=O)O)=O,,,5,1,1,0,1
93107_0,,,,2,2,1,3
C(C(C)(C(C(C=O)O)O)CC=O)=O,,,5,1,1,0,1
93109_0,,,,2,2,1,3
C(C(C)(CO)CC=O)=O,,,5,1,1,0,1
93111_0,,,,2,2,1,3
C(C(C)(C(CO)O)CC=O)=O,,,5,1,1,0,1
93113_0,,,,2,2,1,3
C(CC(C=O)(C)C(C(O)=O)O)=O,,,5,1,1,0,1
93115_0,,,,2,2,1,3
C(CC(C=O)(C)C(C(CO)=O)O)=O,,,5,1,1,0,1
93117_0,,,,2,2,1,3
C(C(C)(C(CO)(CO)O)CC=O)=O,,,5,1,1,0,1
93119_0,,,,2,2,1,3
C(C(C)(C(C(CO)O)O)CC=O)=O,,,5,1,1,0,1
93120_0,,,,2,2,1,3
93121_0,,,,2,2,1,3
93123_0,,,,2,2,1,3
C(C(C)(CC=O)CC=O)=O,,,5,1,1,0,1
93125_0,,,,2,2,1,3
C(C(C)(C(C=O)(C)CC=O)O)(O)=O,,,5,1,1,0,1
93127_0,,,,2,2,1,3
C(C(CC(C=O)(C)CC=O)O)(O)=O,,,5,1,1,0,1
93129_0,,,,2,2,1,3
C(CC(C=O)(C)C(C(C=O)=O)O)=O,,,5,1,1,0,1
93131_0,,,,2,2,1,3
C(C(C(C)O)C(C=O)(C)CC=O)=O,,,5,1,1,0,1
93133_0,,,,2,2,1,3
C(C(C)(C(C)(CC=O)O)CC=O)=O,,,5,1,1,0,1
93135_0,,,,2,2,1,3
C(C(C)(CC(CC=O)O)CC=O)=O,,,5,1,1,0,1
93137_0,,,,2,2,1,3
C(C(C)(C(CC=O)O)CC=O)=O,,,5,1,1,0,1
93139_0,,,,2,2,1,3
C(C(CO)C(C=O)(C)CC=O)=O,,,5,1,1,0,1
93141_0,,,,2,2,1,3
C(C(C)(CC=O)C(C=O)(C=O)O)=O,,,5,1,1,0,1
93143_0,,,,2,2,1,3
C(CC(C=O)(C)C(C(C)=O)O)=O,,,5,1,1,0,1
93145_0,,,,2,2,1,3
C(C(C)(CC(CO)=O)CC=O)=O,,,5,1,1,0,1
93147_0,,,,2,2,1,3
C(C(C)(C(C)O)CC=O)=O,,,5,1,1,0,1
93149_0,,,,2,2,1,3
C(C(C)(CCO)CC=O)=O,,,5,1,1,0,1
93151_0,,,,2,2,1,3
C(C(C)(CC=O)CC(C(O)=O)=O)=O,,,5,1,1,0,1
93153_0,,,,2,2,1,3
C(C(C)(CC=O)C(C=O)C(O)=O)=O,,,5,1,1,0,1
93155_0,,,,2,2,1,3
C(C(C)(CC=O)CC(O)=O)=O,,,5,1,1,0,1
93157_0,,,,2,2,1,3
C(C(C)(CC=O)C(C=O)C(C=O)=O)=O,,,5,1,1,0,1
93159_0,,,,2,2,1,3
C(C(C)(CC=O)CC(C(C=O)=O)=O)=O,,,5,1,1,0,1
93161_0,,,,2,2,1,3
C(CC(C=O)(C)C(C=O)(O)O)=O,,,5,1,1,0,1
93163_0,,,,2,2,1,3
C(C(C)(C(C=O)(C)CC=O)O)=O,,,5,1,1,0,1
93165_0,,,,2,2,1,3
C(C(C)(CC(C=O)O)CC=O)=O,,,5,1,1,0,1
93167_0,,,,2,2,1,3
C(C([C](C(O)=O)O)(C)CC=O)=O,,,5,1,1,0,1
93169_0,,,,2,2,1,3
C(CC(C=O)(C)C(C=O)O)=O,,,5,1,1,0,1
93171_0,,,,2,2,1,3
C(C(CC(C=O)C(C=O)=C)CC=O)=O,,,5,1,1,0,1
93173_0,,,,2,2,1,3
C(C(C(C=O)=C)C(C=O)CC(C)=O)=O,,,5,1,1,0,1
93175_0,,,,2,2,1,3
C(C(C(C=O)=C)C(C(C)=O)CC=O)=O,,,5,1,1,0,1
93177_0,,,,2,2,1,3
C(C(C(C=O)=C)C(C)CC(C=O)=O)=O,,,5,1,1,0,1
93179_0,,,,2,2,1,3
C(C(C(C=O)=C)C(CC=O)CC=O)=O,,,5,1,1,0,1
93181_0,,,,2,2,1,3
C(C(C(C=O)=C)C(C)C(C=O)C=O)=O,,,5,1,1,0,1
93183_0,,,,2,2,1,3
C(C(C(C=O)=C)CC(C=O)C=O)=O,,,5,1,1,0,1
93185_0,,,,2,2,1,3
C(C(C(C=O)=C)C(C)CC=O)=O,,,5,1,1,0,1
93187_0,,,,2,2,1,3
C(C(C(C=O)=C)CCC=O)=O,,,5,1,1,0,1
93189_0,,,,2,2,1,3
C(C(C(C=O)=C)C1COC(C1)=O)=O,,,5,1,1,0,1
93191_0,,,,2,2,1,3
C(C(C(C=O)=C)CCC(C=O)=O)=O,,,5,1,1,0,1
93193_0,,,,2,2,1,3
C(C(C(C=O)=C)C(C=O)CC=O)=O,,,5,1,1,0,1
93194_0,,,,2,2,1,3
93196_0,,,,2,2,1,3
C(C(CCC(C=CC=O)=O)CC=O)=O,,,5,1,1,0,1
93198_0,,,,2,2,1,3
C(C(CC(C=C)C(C=O)=O)CC=O)=O,,,5,1,1,0,1
93200_0,,,,2,2,1,3
C(C(CCC=CC(C=O)=O)CC=O)=O,,,5,1,1,0,1
93202_0,,,,2,2,1,3
C(C(CC(C=O)C=CC=O)CC=O)=O,,,5,1,1,0,1
93204_0,,,,2,2,1,3
C(C(CC(C=O)(C=O)C=C)CC=O)=O,,,5,1,1,0,1
93206_0,,,,2,2,1,3
C(C(CCC=C(C=O)C=O)CC=O)=O,,,5,1,1,0,1
93208_0,,,,2,2,1,3
C(C(CCC=CC=O)CC=O)=O,,,5,1,1,0,1
93210_0,,,,2,2,1,3
C(C(CC(C=O)C=C)CC=O)=O,,,5,1,1,0,1
93212_0,,,,2,2,1,3
C(C(CC(C=O)(C=C)O)CC=O)=O,,,5,1,1,0,1
93214_0,,,,2,2,1,3
C(C(CC1C=CC(O1)=O)CC=O)=O,,,5,1,1,0,1
93216_0,,,,2,2,1,3
C(C(CC1C(C=CO1)=O)CC=O)=O,,,5,1,1,0,1
93218_0,,,,2,2,1,3
C(C(CC(C=C)O)CC=O)=O,,,5,1,1,0,1
93220_0,,,,2,2,1,3
C(C(CC[C](C(O)=O)O)CC=O)=O,,,5,1,1,0,1
93221_0,,,,2,2,1,3
93222_0,,,,2,2,1,3
93223_0,,,,2,2,1,3
93224_0,,,,2,2,1,3
93225_0,,,,2,2,1,3
93226_0,,,,2,2,1,3
93228_0,,,,2,2,1,3
C(C(CC(CO)(CO)O)CC=O)=O,,,5,1,1,0,1
93229_0,,,,2,2,1,3
93230_0,,,,2,2,1,3
93231_0,,,,2,2,1,3
93232_0,,,,2,2,1,3
93234_0,,,,2,2,1,3
C(C(C)(CC(C=O)CC=O)O)(O)=O,,,5,1,1,0,1
93236_0,,,,2,2,1,3
C(C(CCC(C=O)CC=O)O)(O)=O,,,5,1,3,0,3
93237_0,,,,2,2,1,3
93239_0,,,,2,2,1,3
C(C(CC(C=O)CC=O)C(C)O)=O,,,5,1,1,0,1
93241_0,,,,2,2,1,3
C(CC(C)(CC(C=O)CC=O)O)=O,,,5,1,1,0,1
93243_0,,,,2,2,1,3
C(CC(CCC(C=O)CC=O)O)=O,,,5,1,1,0,1
93244_0,,,,2,2,1,3
93246_0,,,,2,2,1,3
C(C(CC(C=O)CC=O)CO)=O,,,5,1,1,0,1
93247_0,,,,2,2,1,3
93249_0,,,,2,2,1,3
C(C)(C(CC(C=O)CC=O)O)=O,,,5,1,1,0,1
93250_0,,,,2,2,1,3
93252_0,,,,2,2,1,3
C(C(CC(C)O)CC=O)=O,,,5,1,1,0,1
93254_0,,,,2,2,1,3
C(C(CCCO)CC=O)=O,,,5,1,1,0,1
93255_0,,,,2,2,1,3
93256_0,,,,2,2,1,3
93257_0,,,,2,2,1,3
93258_0,,,,2,2,1,3
93259_0,,,,2,2,1,3
93261_0,,,,2,2,1,3
C(C(CC(C=O)(O)O)CC=O)=O,,,5,1,1,0,1
93263_0,,,,2,2,1,3
C(C(C)(CC(C=O)CC=O)O)=O,,,5,1,1,0,1
93265_0,,,,2,2,1,3
C(C(CCC(C=O)CC=O)O)=O,,,5,1,1,0,1
93267_0,,,,2,2,1,3
C(CC(C=O)C[C](C(O)=O)O)=O,,,5,1,3,0,3
93268_0,,,,2,2,1,3
93270_0,,,,2,2,1,3
C(CCC(C(C=O)=O)(C(C=O)=C)O)=O,,,5,1,1,0,1
93271_0,,,,2,2,1,3
93272_0,,,,2,2,1,3
93274_0,,,,2,2,1,3
C(C(CC(C)O)C(C(C=O)=O)O)=O,,,5,1,1,0,1
93276_0,,,,2,2,1,3
C(C(CCCO)C(C(C=O)=O)O)=O,,,5,1,1,0,1
93278_0,,,,2,2,1,3
C(C(C=O)CC(C=O)(C(C=O)=C)O)=O,,,5,1,1,0,1
93280_0,,,,2,2,1,3
C(C(C(C=O)=C)(C(C)CC=O)O)=O,,,5,1,1,0,1
93282_0,,,,2,2,1,3
C(C(C(C=O)=C)(CCC=O)O)=O,,,5,1,1,0,1
93284_0,,,,2,2,1,3
C(C(C(C=O)=C)(C1COC(C1)=O)O)=O,,,5,1,1,0,1
93286_0,,,,2,2,1,3
C(C(C(C=O)=C)(CCC(C=O)=O)O)=O,,,5,1,1,0,1
93287_0,,,,2,2,1,3
93289_0,,,,2,2,1,3
C(C(C(C=O)=C)(CCC(O)=O)O)=O,,,5,1,1,0,1
93291_0,,,,2,2,1,3
C(C(CCC=CC=O)C(C=O)O)=O,,,5,1,1,0,1
93293_0,,,,2,2,1,3
C(C(CC(C=O)C=C)C(C=O)O)=O,,,5,1,1,0,1
93295_0,,,,2,2,1,3
C(C(CC1C=CC(O1)=O)C(C=O)O)=O,,,5,1,1,0,1
93297_0,,,,2,2,1,3
C(C(CC1C(C=CO1)=O)C(C=O)O)=O,,,5,1,1,0,1
93299_0,,,,2,2,1,3
C(C(CC(C=C)O)C(C=O)O)=O,,,5,1,1,0,1
93300_0,,,,2,2,1,3
93302_0,,,,2,2,1,3
C(C(CC(CO)O)C(C=O)O)=O,,,5,1,1,0,1
93303_0,,,,2,2,1,3
93304_0,,,,2,2,1,3
93306_0,,,,2,2,1,3
C(C(CC(C=O)C=O)C(C=O)O)=O,,,5,1,2,0,2
93308_0,,,,2,2,1,3
C(CCC(C=O)C(C=O)O)=O,,,5,1,2,0,2
93309_0,,,,2,2,1,3
93311_0,,,,2,2,1,3
C(C(CO)CC(C=O)C(C=O)O)=O,,,5,1,1,0,1
93313_0,,,,2,2,1,3
C(C)(C(CC(C=O)C(C=O)O)O)=O,,,5,1,1,0,1
93314_0,,,,2,2,1,3
93316_0,,,,2,2,1,3
C(C(CC(C)O)C(C=O)O)=O,,,5,1,1,0,1
93318_0,,,,2,2,1,3
C(C(CCCO)C(C=O)O)=O,,,5,1,1,0,1
93319_0,,,,2,2,1,3
93321_0,,,,2,2,1,3
C(C(CC(C=O)(O)O)C(C=O)O)=O,,,5,1,1,0,1
93323_0,,,,2,2,1,3
C(C(C)(CC(C=O)C(C=O)O)O)=O,,,5,1,1,0,1
93325_0,,,,2,2,1,3
C(C(CCC(C=O)C(C=O)O)O)=O,,,5,1,2,0,2
93327_0,,,,2,2,1,3
C(C(C(C=O)C[C](C(O)=O)O)O)=O,,,5,1,1,0,1
93328_0,,,,2,2,1,3
93330_0,,,,2,2,1,3
C(CC(C)CC(C=CC(C=O)=O)=O)=O,,,5,1,1,0,1
93332_0,,,,2,2,1,3
C(CCCC(C=CC(C=O)=O)=O)=O,,,5,1,1,0,1
93334_0,,,,2,2,1,3
C(CCCC(C=CC(C=O)=O)=O)(O)=O,,,5,1,1,0,1
93336_0,,,,2,2,1,3
C(C)(CC(C(C=O)=O)CC=CC=O)=O,,,5,1,1,0,1
93338_0,,,,2,2,1,3
C(C(C=C)C(C(C=O)=O)CC(C)=O)=O,,,5,1,1,0,1
93340_0,,,,2,2,1,3
C(C)(CC(C(C=O)=O)C(C=C)O)=O,,,5,1,1,0,1
93341_0,,,,2,2,1,3
93343_0,,,,2,2,1,3
C(CC(C(C=O)=O)C(CO)O)(C)=O,,,5,1,1,0,1
93345_0,,,,2,2,1,3
C(C)(CC(C(C=O)=O)CC(C=O)=O)=O,,,5,1,1,0,1
93347_0,,,,2,2,1,3
C(C(C=O)C(C(C=O)=O)CC(C)=O)=O,,,5,1,1,0,1
93349_0,,,,2,2,1,3
C(CC(C(C=O)=O)CC(C)=O)=O,,,5,1,1,0,1
93350_0,,,,2,2,1,3
93352_0,,,,2,2,1,3
C(CC(C(C=O)=O)CCO)(C)=O,,,5,1,1,0,1
93354_0,,,,2,2,1,3
C(CC(C(C=O)=O)CC(C)=O)(O)=O,,,5,1,1,0,1
93356_0,,,,2,2,1,3
C(C(C(C(C=O)=O)CC(C)=O)O)=O,,,5,1,1,0,1
93358_0,,,,2,2,1,3
C(C)(C(CC(C=O)=O)CC=CC=O)=O,,,5,1,1,0,1
93360_0,,,,2,2,1,3
C(C(C=C)C(C(C)=O)CC(C=O)=O)=O,,,5,1,1,0,1
93362_0,,,,2,2,1,3
C(C)(C(CC(C=O)=O)C(C=C)O)=O,,,5,1,1,0,1
93364_0,,,,2,2,1,3
C(C)(C(CO)CC(C=O)=O)=O,,,5,1,1,0,1
93366_0,,,,2,2,1,3
C(C)(C(C(CO)O)CC(C=O)=O)=O,,,5,1,1,0,1
93368_0,,,,2,2,1,3
C(C)(C(CC(C=O)=O)CC(C=O)=O)=O,,,5,1,1,0,1
93370_0,,,,2,2,1,3
C(C(C=O)C(C(C)=O)CC(C=O)=O)=O,,,5,1,2,0,2
93372_0,,,,2,2,1,3
C(CC(C(C)=O)CC(C=O)=O)=O,,,5,1,2,0,2
93374_0,,,,2,2,1,3
C(C)(C(C(C)O)CC(C=O)=O)=O,,,5,1,1,0,1
93376_0,,,,2,2,1,3
C(C)(C(CCO)CC(C=O)=O)=O,,,5,1,1,0,1
93378_0,,,,2,2,1,3
C(CC(C(C)=O)CC(C=O)=O)(O)=O,,,5,1,1,0,1
93380_0,,,,2,2,1,3
C(C(C(C(C)=O)CC(C=O)=O)O)=O,,,5,1,1,0,1
93382_0,,,,2,2,1,3
C(CC(C)CC(C=C(C=O)C=O)=O)=O,,,5,1,1,0,1
93384_0,,,,2,2,1,3
C(CCCC(C=C(C=O)C=O)=O)=O,,,5,1,1,0,1
93386_0,,,,2,2,1,3
C(CCCC(C=C(C=O)C=O)=O)(O)=O,,,5,1,1,0,1
93388_0,,,,2,2,1,3
C(C(C=O)(CC(C)=O)CC=CC=O)=O,,,5,1,1,0,1
93390_0,,,,2,2,1,3
C(C(C=O)(CC(C)=O)C(C=O)C=C)=O,,,5,1,1,0,1
93392_0,,,,2,2,1,3
C(C(C=O)(CC(C)=O)C(C=C)O)=O,,,5,1,1,0,1
93393_0,,,,2,2,1,3
93395_0,,,,2,2,1,3
C(C(C=O)(C(CO)O)CC(C)=O)=O,,,5,1,1,0,1
93397_0,,,,2,2,1,3
C(C(C=O)(CC(C=O)=O)CC(C)=O)=O,,,5,1,1,0,1
93399_0,,,,2,2,1,3
C(C(C=O)(CC(C)=O)C(C=O)C=O)=O,,,5,1,1,0,1
93401_0,,,,2,2,1,3
C(C(C=O)(CC(C)=O)CC=O)=O,,,5,1,1,0,1
93402_0,,,,2,2,1,3
93404_0,,,,2,2,1,3
C(C(C=O)(CCO)CC(C)=O)=O,,,5,1,1,0,1
93406_0,,,,2,2,1,3
C(C(C=O)(CC(C)=O)CC(O)=O)=O,,,5,1,1,0,1
93408_0,,,,2,2,1,3
C(C(C=O)(CC(C)=O)C(C=O)O)=O,,,5,1,1,0,1
93410_0,,,,2,2,1,3
C(C(C=O)C(C(C)=O)CC=CC=O)=O,,,5,1,1,0,1
93412_0,,,,2,2,1,3
C(C(C=C)C(C(C)=O)C(C=O)C=O)=O,,,5,1,1,0,1
93414_0,,,,2,2,1,3
C(C(C=O)C(C(C)=O)C(C=C)O)=O,,,5,1,1,0,1
93416_0,,,,2,2,1,3
C(C(C=O)C(C(C)=O)CO)=O,,,5,1,1,0,1
93418_0,,,,2,2,1,3
C(C(C=O)C(C(C)=O)C(CO)O)=O,,,5,1,1,0,1
93419_0,,,,2,2,1,3
93421_0,,,,2,2,1,3
C(C(C=O)C(C(C)=O)C(C=O)C=O)=O,,,5,1,1,0,1
93423_0,,,,2,2,1,3
C(C(C=O)C(C(C)=O)CC=O)=O,,,5,1,2,0,2
93425_0,,,,2,2,1,3
C(C(C=O)C(C(C)=O)C(C)O)=O,,,5,1,1,0,1
93427_0,,,,2,2,1,3
C(C(C=O)C(C(C)=O)CCO)=O,,,5,1,1,0,1
93429_0,,,,2,2,1,3
C(C(C=O)C(C(C)=O)CC(O)=O)=O,,,5,1,1,0,1
93431_0,,,,2,2,1,3
C(C(C=O)C(C(C)=O)C(C=O)O)=O,,,5,1,1,0,1
93432_0,,,,2,2,1,3
93434_0,,,,2,2,1,3
C(CC(C(C=O)=O)(CO)CO)(C)=O,,,5,1,1,0,1
93436_0,,,,2,2,1,3
C(C)(C(CO)C(C(C=O)=O)CO)=O,,,5,1,1,0,1
93437_0,,,,2,2,1,3
93438_0,,,,2,2,1,3
93440_0,,,,2,2,1,3
C(CC(C=O)(CO)C(C=O)O)(C)=O,,,5,1,1,0,1
93442_0,,,,2,2,1,3
C(C)(C(CO)C(C=O)C(C=O)O)=O,,,5,1,1,0,1
93444_0,,,,2,2,1,3
C(CO)(C(C=O)(CO)CC(C)=O)=O,,,5,1,1,0,1
93446_0,,,,2,2,1,3
C(C)(C(CO)C(C=O)C(CO)=O)=O,,,5,1,1,0,1
93448_0,,,,2,2,1,3
C(C(CO)CC(C)=O)(C(C=O)O)=O,,,5,1,1,0,1
93450_0,,,,2,2,1,3
C(C)(C(CO)CC(C(C=O)O)=O)=O,,,5,1,1,0,1
93452_0,,,,2,2,1,3
C(C(CC(C=CC=O)=O)CC(C)=O)=O,,,5,1,1,0,1
93454_0,,,,2,2,1,3
C(CC(C(C)=O)CC(C=CC=O)=O)=O,,,5,1,1,0,1
93456_0,,,,2,2,1,3
C(C(CC(C)CC(C=CC=O)=O)=O)=O,,,5,1,1,0,1
93458_0,,,,2,2,1,3
C(CC(CC=O)CC(C=CC=O)=O)=O,,,5,1,1,0,1
93460_0,,,,2,2,1,3
C(C(C=O)C(C)CC(C=CC=O)=O)=O,,,5,1,1,0,1
93462_0,,,,2,2,1,3
C(C(C=O)CCC(C=CC=O)=O)=O,,,5,1,1,0,1
93464_0,,,,2,2,1,3
C(CC(C)CC(C=CC=O)=O)=O,,,5,1,1,0,1
93466_0,,,,2,2,1,3
C(CCCC(C=CC=O)=O)=O,,,5,1,1,0,1
93468_0,,,,2,2,1,3
C1(CC(CO1)CC(C=CC=O)=O)=O,,,5,1,1,0,1
93470_0,,,,2,2,1,3
C(C(CCCC(C=CC=O)=O)=O)=O,,,5,1,1,0,1
93472_0,,,,2,2,1,3
C(CC(C=O)CC(C=CC=O)=O)=O,,,5,1,1,0,1
93473_0,,,,2,2,1,3
93475_0,,,,2,2,1,3
C(C(CC(C)=O)C(C=C)C(C=O)=O)=O,,,5,1,1,0,1
93477_0,,,,2,2,1,3
C(C(CC(C)=O)CC=CC(C=O)=O)=O,,,5,1,1,0,1
93479_0,,,,2,2,1,3
C(C(C=CC=O)C(C=O)CC(C)=O)=O,,,5,1,1,0,1
93481_0,,,,2,2,1,3
C(C(C=O)(C=C)C(C=O)CC(C)=O)=O,,,5,1,1,0,1
93483_0,,,,2,2,1,3
C(C(CC(C)=O)CC=C(C=O)C=O)=O,,,5,1,1,0,1
93485_0,,,,2,2,1,3
C(C(CC(C)=O)CC=CC=O)=O,,,5,1,1,0,1
93487_0,,,,2,2,1,3
C(C(C=C)C(C=O)CC(C)=O)=O,,,5,1,1,0,1
93489_0,,,,2,2,1,3
C(C(C=C)(C(C=O)CC(C)=O)O)=O,,,5,1,1,0,1
93491_0,,,,2,2,1,3
C(C(C1C=CC(O1)=O)CC(C)=O)=O,,,5,1,1,0,1
93493_0,,,,2,2,1,3
C(C(C1C(C=CO1)=O)CC(C)=O)=O,,,5,1,1,0,1
93495_0,,,,2,2,1,3
C(C(CC(C)=O)C(C=C)O)=O,,,5,1,1,0,1
93497_0,,,,2,2,1,3
C(C(C[C](C(O)=O)O)CC(C)=O)=O,,,5,1,1,0,1
93499_0,,,,2,2,1,3
C(CC(C=O)C(C=O)(CO)O)(C)=O,,,5,1,1,0,1
93501_0,,,,2,2,1,3
C(C(C(C(C=O)CC(C)=O)O)O)=O,,,5,1,1,0,1
93502_0,,,,2,2,1,3
93503_0,,,,2,2,1,3
93504_0,,,,2,2,1,3
93506_0,,,,2,2,1,3
C(C(CC(C)=O)C(C(CO)=O)O)=O,,,5,1,1,0,1
93508_0,,,,2,2,1,3
C(C(C(CO)(CO)O)CC(C)=O)=O,,,5,1,1,0,1
93510_0,,,,2,2,1,3
C(C(C(C(CO)O)O)CC(C)=O)=O,,,5,1,1,0,1
93512_0,,,,2,2,1,3
C(C(CC(C=O)=O)CC(C)=O)=O,,,5,1,1,0,1
93514_0,,,,2,2,1,3
C(C(C=O)C(C=O)CC(C)=O)=O,,,5,1,1,0,1
93516_0,,,,2,2,1,3
C(CC(C=O)CC(C)=O)=O,,,5,1,1,0,1
93518_0,,,,2,2,1,3
C(CC(C=O)C(C(O)=O)(C)O)(C)=O,,,5,1,1,0,1
93520_0,,,,2,2,1,3
C(C(CC(C=O)CC(C)=O)O)(O)=O,,,5,1,1,0,1
93522_0,,,,2,2,1,3
C(C(CC(C)=O)C(C(C=O)=O)O)=O,,,5,1,1,0,1
93524_0,,,,2,2,1,3
C(CC(C=O)C(C=O)C(C)O)(C)=O,,,5,1,1,0,1
93526_0,,,,2,2,1,3
C(CC(C)(C(C=O)CC(C)=O)O)=O,,,5,1,1,0,1
93528_0,,,,2,2,1,3
C(CC(CC(C=O)CC(C)=O)O)=O,,,5,1,1,0,1
93529_0,,,,2,2,1,3
93531_0,,,,2,2,1,3
C(CC(C=O)C(C=O)CO)(C)=O,,,5,1,1,0,1
93533_0,,,,2,2,1,3
C(C(C=O)(C(C=O)CC(C)=O)O)=O,,,5,1,1,0,1
93534_0,,,,2,2,1,3
93536_0,,,,2,2,1,3
C(C(CC(C)=O)CC(CO)=O)=O,,,5,1,1,0,1
93537_0,,,,2,2,1,3
93539_0,,,,2,2,1,3
C(C(CCO)CC(C)=O)=O,,,5,1,1,0,1
93541_0,,,,2,2,1,3
C(C(CC(C(O)=O)=O)CC(C)=O)=O,,,5,1,1,0,1
93543_0,,,,2,2,1,3
C(C(C(O)=O)C(C=O)CC(C)=O)=O,,,5,1,1,0,1
93545_0,,,,2,2,1,3
C(C(CC(O)=O)CC(C)=O)=O,,,5,1,1,0,1
93547_0,,,,2,2,1,3
C(C(C(C=O)=O)C(C=O)CC(C)=O)=O,,,5,1,1,0,1
93549_0,,,,2,2,1,3
C(C(CC(C(C=O)=O)=O)CC(C)=O)=O,,,5,1,1,0,1
93551_0,,,,2,2,1,3
C(C(C(C=O)CC(C)=O)(O)O)=O,,,5,1,1,0,1
93552_0,,,,2,2,1,3
93554_0,,,,2,2,1,3
C(C(CC(C=O)CC(C)=O)O)=O,,,5,1,1,0,1
93556_0,,,,2,2,1,3
C(C([C](C(O)=O)O)CC(C)=O)=O,,,5,1,1,0,1
93557_0,,,,2,2,1,3
93559_0,,,,2,2,1,3
C(CC(C(C)=O)C(C=C)C(C=O)=O)=O,,,5,1,1,0,1
93561_0,,,,2,2,1,3
C(CC(C(C)=O)CC=CC(C=O)=O)=O,,,5,1,1,0,1
93563_0,,,,2,2,1,3
C(C(C=CC=O)C(C(C)=O)CC=O)=O,,,5,1,1,0,1
93565_0,,,,2,2,1,3
C(C(C=O)(C=C)C(C(C)=O)CC=O)=O,,,5,1,1,0,1
93567_0,,,,2,2,1,3
C(CC(C(C)=O)CC=C(C=O)C=O)=O,,,5,1,1,0,1
93569_0,,,,2,2,1,3
C(CC(C(C)=O)CC=CC=O)=O,,,5,1,1,0,1
93571_0,,,,2,2,1,3
C(C(C=C)C(C(C)=O)CC=O)=O,,,5,1,1,0,1
93573_0,,,,2,2,1,3
C(C(C=C)(C(C(C)=O)CC=O)O)=O,,,5,1,1,0,1
93575_0,,,,2,2,1,3
C(CC(C(C)=O)C1C=CC(O1)=O)=O,,,5,1,1,0,1
93577_0,,,,2,2,1,3
C(CC(C(C)=O)C1C(C=CO1)=O)=O,,,5,1,1,0,1
93579_0,,,,2,2,1,3
C(CC(C(C)=O)C(C=C)O)=O,,,5,1,1,0,1
93581_0,,,,2,2,1,3
C(CC(C(C)=O)C[C](C(O)=O)O)=O,,,5,1,1,0,1
93583_0,,,,2,2,1,3
C(CC(C(C)=O)C(C=O)(CO)O)=O,,,5,1,1,0,1
93584_0,,,,2,2,1,3
93585_0,,,,2,2,1,3
93587_0,,,,2,2,1,3
C(C)(C(C(CO)O)CC=O)=O,,,5,1,1,0,1
93589_0,,,,2,2,1,3
C(C(C(C(C)=O)CC=O)O)(O)=O,,,5,1,1,0,1
93591_0,,,,2,2,1,3
C(CC(C(C)=O)C(C(CO)=O)O)=O,,,5,1,1,0,1
93593_0,,,,2,2,1,3
C(C)(C(C(CO)(CO)O)CC=O)=O,,,5,1,1,0,1
93595_0,,,,2,2,1,3
C(C)(C(C(C(CO)O)O)CC=O)=O,,,5,1,1,0,1
93596_0,,,,2,2,1,3
93597_0,,,,2,2,1,3
93599_0,,,,2,2,1,3
C(CC(C(C)=O)CC=O)=O,,,5,1,1,0,1
93601_0,,,,2,2,1,3
C(C(C)(C(C(C)=O)CC=O)O)(O)=O,,,5,1,1,0,1
93603_0,,,,2,2,1,3
C(C)(C(CC(C(O)=O)O)CC=O)=O,,,5,1,1,0,1
93605_0,,,,2,2,1,3
C(CC(C(C)=O)C(C(C=O)=O)O)=O,,,5,1,1,0,1
93607_0,,,,2,2,1,3
C(CC(C(C)=O)C(C=O)C(C)O)=O,,,5,1,1,0,1
93609_0,,,,2,2,1,3
C(C)(C(C(C)(CC=O)O)CC=O)=O,,,5,1,1,0,1
93611_0,,,,2,2,1,3
C(C)(C(CC(CC=O)O)CC=O)=O,,,5,1,1,0,1
93612_0,,,,2,2,1,3
93614_0,,,,2,2,1,3
C(CC(C(C)=O)C(C=O)CO)=O,,,5,1,1,0,1
93616_0,,,,2,2,1,3
C(C(C=O)(C(C(C)=O)CC=O)O)=O,,,5,1,1,0,1
93618_0,,,,2,2,1,3
C(CC(C(C)=O)C(C(C)=O)O)=O,,,5,1,1,0,1
93620_0,,,,2,2,1,3
C(CC(C(C)=O)CC(CO)=O)=O,,,5,1,1,0,1
93622_0,,,,2,2,1,3
C(C)(C(C(C)O)CC=O)=O,,,5,1,1,0,1
93624_0,,,,2,2,1,3
C(C)(C(CCO)CC=O)=O,,,5,1,1,0,1
93626_0,,,,2,2,1,3
C(CC(C(C)=O)CC(C(O)=O)=O)=O,,,5,1,1,0,1
93628_0,,,,2,2,1,3
C(C(C(O)=O)C(C(C)=O)CC=O)=O,,,5,1,1,0,1
93630_0,,,,2,2,1,3
C(CC(C(C)=O)CC(O)=O)=O,,,5,1,1,0,1
93632_0,,,,2,2,1,3
C(C(C(C=O)=O)C(C(C)=O)CC=O)=O,,,5,1,1,0,1
93634_0,,,,2,2,1,3
C(CC(C(C)=O)CC(C(C=O)=O)=O)=O,,,5,1,1,0,1
93636_0,,,,2,2,1,3
C(CC(C(C)=O)C(C=O)(O)O)=O,,,5,1,1,0,1
93638_0,,,,2,2,1,3
C(CC(C(C)=O)C(C=O)(C)O)=O,,,5,1,1,0,1
93640_0,,,,2,2,1,3
C(C)(C(CC(C=O)O)CC=O)=O,,,5,1,1,0,1
93642_0,,,,2,2,1,3
C(CC(C(C)=O)[C](C(O)=O)O)=O,,,5,1,1,0,1
93644_0,,,,2,2,1,3
C(CC(C(C)=O)C(C=O)O)=O,,,5,1,1,0,1
93646_0,,,,2,2,1,3
C(CC(C)C(C=CC=O)C(C=O)=O)=O,,,5,1,1,0,1
93648_0,,,,2,2,1,3
C(CCC(C=CC=O)C(C=O)=O)=O,,,5,1,1,0,1
93650_0,,,,2,2,1,3
C(CCC(C=CC=O)C(C=O)=O)(O)=O,,,5,1,1,0,1
93652_0,,,,2,2,1,3
C(CC(CC(C=O)=O)CC=CC=O)=O,,,5,1,2,0,2
93654_0,,,,2,2,1,3
C(C(C=C)C(CC=O)CC(C=O)=O)=O,,,5,1,2,0,2
93656_0,,,,2,2,1,3
C(CC(C(C=C)O)CC(C=O)=O)=O,,,5,1,2,0,2
93657_0,,,,2,2,1,3
93659_0,,,,2,2,1,3
C(CC(C(CO)O)CC(C=O)=O)=O,,,5,1,4,0,4
93661_0,,,,2,2,1,3
C(CC(CC(C=O)=O)CC(C=O)=O)=O,,,5,1,2,0,2
93663_0,,,,2,2,1,3
C(C(C=O)C(CC=O)CC(C=O)=O)=O,,,5,1,4,0,4
93665_0,,,,2,2,1,3
C(CC(CC=O)CC(C=O)=O)=O,,,5,1,3,0,3
93667_0,,,,2,2,1,3
C(CC(C(C)O)CC(C=O)=O)=O,,,5,1,2,0,2
93669_0,,,,2,2,1,3
C(CC(CCO)CC(C=O)=O)=O,,,5,1,2,0,2
93671_0,,,,2,2,1,3
C(CC(CC(O)=O)CC(C=O)=O)=O,,,5,1,2,0,2
93673_0,,,,2,2,1,3
C(CC(C(C=O)O)CC(C=O)=O)=O,,,5,1,3,0,3
93675_0,,,,2,2,1,3
C(C(C=CC(C=O)=O)C(C)CC=O)=O,,,5,1,1,0,1
93677_0,,,,2,2,1,3
C(C(C=CC(C=O)=O)CCC=O)=O,,,5,1,1,0,1
93679_0,,,,2,2,1,3
C(C(C=CC(C=O)=O)CCC(O)=O)=O,,,5,1,1,0,1
93680_0,,,,2,2,1,3
93681_0,,,,2,2,1,3
93682_0,,,,2,2,1,3
93683_0,,,,2,2,1,3
93684_0,,,,2,2,1,3
93685_0,,,,2,2,1,3
93686_0,,,,2,2,1,3
93687_0,,,,2,2,1,3
93688_0,,,,2,2,1,3
93689_0,,,,2,2,1,3
93690_0,,,,2,2,1,3
93691_0,,,,2,2,1,3
93692_0,,,,2,2,1,3
93694_0,,,,2,2,1,3
C(C(CO)(CCO)CC(C=O)=O)=O,,,5,1,2,0,2
93695_0,,,,2,2,1,3
93697_0,,,,2,2,1,3
C(C(CO)CC(C=O)=O)(CCO)=O,,,5,1,1,0,1
93699_0,,,,2,2,1,3
C(CC(C(C=O)=O)CO)(CCO)=O,,,5,1,1,0,1
93700_0,,,,2,2,1,3
93702_0,,,,2,2,1,3
C(C(CC(CO)CC(C=O)=O)O)=O,,,5,1,2,0,2
93704_0,,,,2,2,1,3
C(CO)(CC(CO)CC(C=O)=O)=O,,,5,1,3,0,3
93705_0,,,,2,2,1,3
93706_0,,,,2,2,1,3
93707_0,,,,2,2,1,3
93709_0,,,,2,2,1,3
C(C)(C(C(CO)CC(C=O)=O)O)=O,,,5,1,2,0,2
93711_0,,,,2,2,1,3
C(C(C(CO)(C)CC(C=O)=O)O)=O,,,5,1,1,0,1
93713_0,,,,2,2,1,3
C=CC(C(C=O)=O)C(C)CC(C=O)=O,,,5,1,1,0,1
93715_0,,,,2,2,1,3
C(CC(CC=O)C(C=C)C(C=O)=O)=O,,,5,1,1,0,1
93717_0,,,,2,2,1,3
C(C(C=O)C(C)C(C=C)C(C=O)=O)=O,,,5,1,1,0,1
93719_0,,,,2,2,1,3
C(C(C=O)CC(C=C)C(C=O)=O)=O,,,5,1,1,0,1
93721_0,,,,2,2,1,3
C(CC(C)C(C=C)C(C=O)=O)=O,,,5,1,1,0,1
93723_0,,,,2,2,1,3
C(CCC(C=C)C(C=O)=O)=O,,,5,1,1,0,1
93725_0,,,,2,2,1,3
C1(CC(CO1)C(C=C)C(C=O)=O)=O,,,5,1,1,0,1
93727_0,,,,2,2,1,3
C=CC(C(C=O)=O)CCC(C=O)=O,,,5,1,1,0,1
93729_0,,,,2,2,1,3
C(CC(C=O)C(C=C)C(C=O)=O)=O,,,5,1,1,0,1
93730_0,,,,2,2,1,3
93732_0,,,,2,2,1,3
C(CC(C)CC(C=O)=O)=CC(C=O)=O,,,5,1,1,0,1
93734_0,,,,2,2,1,3
C(CC(CC=O)CC=CC(C=O)=O)=O,,,5,1,1,0,1
93736_0,,,,2,2,1,3
C(C(C=O)C(C)CC=CC(C=O)=O)=O,,,5,1,1,0,1
93738_0,,,,2,2,1,3
C(C(C=O)CCC=CC(C=O)=O)=O,,,5,1,1,0,1
93740_0,,,,2,2,1,3
C(CC(C)CC=CC(C=O)=O)=O,,,5,1,1,0,1
93742_0,,,,2,2,1,3
C(CCCC=CC(C=O)=O)=O,,,5,1,1,0,1
93744_0,,,,2,2,1,3
C1(CC(CO1)CC=CC(C=O)=O)=O,,,5,1,1,0,1
93746_0,,,,2,2,1,3
C(CCCC(C=O)=O)=CC(C=O)=O,,,5,1,1,0,1
93748_0,,,,2,2,1,3
C(CC(C=O)CC=CC(C=O)=O)=O,,,5,1,1,0,1
93749_0,,,,2,2,1,3
93751_0,,,,2,2,1,3
C(C(C=CC=O)C(C)CC(C=O)=O)=O,,,5,1,1,0,1
93753_0,,,,2,2,1,3
C(C(C=O)(C=C)C(C)CC(C=O)=O)=O,,,5,1,1,0,1
93755_0,,,,2,2,1,3
C(CC(C)CC(C=O)=O)=C(C=O)C=O,,,5,1,1,0,1
93757_0,,,,2,2,1,3
C(CC(C)CC(C=O)=O)=CC=O,,,5,1,1,0,1
93759_0,,,,2,2,1,3
C(C(C=C)C(C)CC(C=O)=O)=O,,,5,1,1,0,1
93761_0,,,,2,2,1,3
C(C(C=C)(C(C)CC(C=O)=O)O)=O,,,5,1,1,0,1
93763_0,,,,2,2,1,3
C1C(C(C)CC(C=O)=O)OC(C=1)=O,,,5,1,1,0,1
93765_0,,,,2,2,1,3
C1OC(C(C=1)=O)C(C)CC(C=O)=O,,,5,1,1,0,1
93767_0,,,,2,2,1,3
C=CC(C(C)CC(C=O)=O)O,,,5,1,1,0,1
93769_0,,,,2,2,1,3
[C](C(O)=O)(CC(C)CC(C=O)=O)O,,,5,1,1,0,1
93771_0,,,,2,2,1,3
C(C(CO)(C(C)CC(C=O)=O)O)=O,,,5,1,1,0,1
93773_0,,,,2,2,1,3
C(C(C(C(C)CC(C=O)=O)O)O)=O,,,5,1,1,0,1
93775_0,,,,2,2,1,3
C(C(CC(C)CO)=O)=O,,,5,1,1,0,1
93777_0,,,,2,2,1,3
C(C(CC(C)C(CO)O)=O)=O,,,5,1,1,0,1
93778_0,,,,2,2,1,3
93780_0,,,,2,2,1,3
C(CO)(C(C(C)CC(C=O)=O)O)=O,,,5,1,1,0,1
93782_0,,,,2,2,1,3
C(C(CC(C)C(CO)(CO)O)=O)=O,,,5,1,1,0,1
93784_0,,,,2,2,1,3
C(C(CC(C)C(C(CO)O)O)=O)=O,,,5,1,1,0,1
93786_0,,,,2,2,1,3
C(C(CC(C)CC(C=O)=O)=O)=O,,,5,1,1,0,1
93788_0,,,,2,2,1,3
C(C(C=O)C(C)CC(C=O)=O)=O,,,5,1,2,0,2
93790_0,,,,2,2,1,3
C(CC(C)CC(C=O)=O)=O,,,5,1,2,0,2
93792_0,,,,2,2,1,3
C(C(C)(C(C)CC(C=O)=O)O)(O)=O,,,5,1,1,0,1
93794_0,,,,2,2,1,3
C(C(CC(C)CC(C=O)=O)O)(O)=O,,,5,1,1,0,1
93796_0,,,,2,2,1,3
C(C=O)(CC(C)C(C(C=O)=O)O)=O,,,5,1,1,0,1
93798_0,,,,2,2,1,3
C(C(C(C)CC(C=O)=O)C(C)O)=O,,,5,1,1,0,1
93800_0,,,,2,2,1,3
C(CC(C)(C(C)CC(C=O)=O)O)=O,,,5,1,1,0,1
93802_0,,,,2,2,1,3
C(CC(CC(C)CC(C=O)=O)O)=O,,,5,1,1,0,1
93804_0,,,,2,2,1,3
C(CC(C(C)CC(C=O)=O)O)=O,,,5,1,1,0,1
93806_0,,,,2,2,1,3
C(C(CO)C(C)CC(C=O)=O)=O,,,5,1,1,0,1
93808_0,,,,2,2,1,3
C(C(C=O)(C(C)CC(C=O)=O)O)=O,,,5,1,1,0,1
93810_0,,,,2,2,1,3
C(C)(C(C(C)CC(C=O)=O)O)=O,,,5,1,1,0,1
93812_0,,,,2,2,1,3
C(CO)(CC(C)CC(C=O)=O)=O,,,5,1,1,0,1
93814_0,,,,2,2,1,3
C(C(CC(C)C(C)O)=O)=O,,,5,1,1,0,1
93816_0,,,,2,2,1,3
C(C(CC(C)CCO)=O)=O,,,5,1,1,0,1
93818_0,,,,2,2,1,3
C(C(CC(C)CC(C(O)=O)=O)=O)=O,,,5,1,1,0,1
93820_0,,,,2,2,1,3
C(C(C(O)=O)C(C)CC(C=O)=O)=O,,,5,1,1,0,1
93822_0,,,,2,2,1,3
C(CC(C)CC(C=O)=O)(O)=O,,,5,1,1,0,1
93824_0,,,,2,2,1,3
C(C(C(C=O)=O)C(C)CC(C=O)=O)=O,,,5,1,1,0,1
93826_0,,,,2,2,1,3
C(C(CC(C)CC(C(C=O)=O)=O)=O)=O,,,5,1,1,0,1
93828_0,,,,2,2,1,3
C(C(C(C)CC(C=O)=O)(O)O)=O,,,5,1,1,0,1
93830_0,,,,2,2,1,3
C(C(C)(C(C)CC(C=O)=O)O)=O,,,5,1,1,0,1
93832_0,,,,2,2,1,3
C(C(CC(C)CC(C=O)=O)O)=O,,,5,1,1,0,1
93834_0,,,,2,2,1,3
[C](C(O)=O)(C(C)CC(C=O)=O)O,,,5,1,1,0,1
93836_0,,,,2,2,1,3
C(C(C(C)CC(C=O)=O)O)=O,,,5,1,2,0,2
93838_0,,,,2,2,1,3
C(CCC(C(C=O)=CC(C=O)=O)O)=O,,,5,1,1,0,1
93839_0,,,,2,2,1,3
93841_0,,,,2,2,1,3
C(C(CO)(CC=O)CC(C=O)=O)=O,,,5,1,2,0,2
93842_0,,,,2,2,1,3
93843_0,,,,2,2,1,3
93844_0,,,,2,2,1,3
93846_0,,,,2,2,1,3
C(CC(C(C=O)=O)C(C=O)CO)=O,,,5,1,2,0,2
93847_0,,,,2,2,1,3
93849_0,,,,2,2,1,3
C(C(CO)C(C(C=O)=O)CCO)=O,,,5,1,1,0,1
93851_0,,,,2,2,1,3
C(CCC(C(C=CC(C=O)=O)=O)O)=O,,,5,1,1,0,1
93852_0,,,,2,2,1,3
93854_0,,,,2,2,1,3
C(CC(C(CO)=O)CC(C=O)=O)=O,,,5,1,2,0,2
93855_0,,,,2,2,1,3
93857_0,,,,2,2,1,3
C(CO)(C(CCO)CC(C=O)=O)=O,,,5,1,1,0,1
93858_0,,,,2,2,1,3
93860_0,,,,2,2,1,3
C(CC(C(C=O)=O)CC(CO)=O)=O,,,5,1,2,0,2
93861_0,,,,2,2,1,3
93863_0,,,,2,2,1,3
C(CC(C(C=O)=O)CCO)(CO)=O,,,5,1,1,0,1
93864_0,,,,2,2,1,3
93865_0,,,,2,2,1,3
93867_0,,,,2,2,1,3
C(C(CC(C(CO)O)C(C)O)=O)=O,,,5,1,1,0,1
93869_0,,,,2,2,1,3
C(C(CC(CCO)C(CO)O)=O)=O,,,5,1,1,0,1
93871_0,,,,2,2,1,3
C(C(CC(C=O)=O)CC=CC=O)=O,,,5,1,1,0,1
93873_0,,,,2,2,1,3
C(C(C=C)C(C=O)CC(C=O)=O)=O,,,5,1,1,0,1
93874_0,,,,2,2,1,3
93876_0,,,,2,2,1,3
C(C(C1C=CC(O1)=O)CC(C=O)=O)=O,,,5,1,1,0,1
93878_0,,,,2,2,1,3
C(C(C1C(C=CO1)=O)CC(C=O)=O)=O,,,5,1,1,0,1
93879_0,,,,2,2,1,3
93880_0,,,,2,2,1,3
93881_0,,,,2,2,1,3
93882_0,,,,2,2,1,3
93884_0,,,,2,2,1,3
C(C(CC(C=O)=O)CC(C=O)=O)=O,,,5,1,1,0,1
93886_0,,,,2,2,1,3
C(C(C=O)C(C=O)CC(C=O)=O)=O,,,5,1,2,0,2
93887_0,,,,2,2,1,3
93888_0,,,,2,2,1,3
93889_0,,,,2,2,1,3
93890_0,,,,2,2,1,3
93892_0,,,,2,2,1,3
C(C(CC(C=O)=O)CC(CO)=O)=O,,,5,1,2,0,2
93893_0,,,,2,2,1,3
93894_0,,,,2,2,1,3
93895_0,,,,2,2,1,3
93897_0,,,,2,2,1,3
C(C(C(C=O)CC(C=O)=O)(O)O)=O,,,5,1,1,0,1
93898_0,,,,2,2,1,3
93899_0,,,,2,2,1,3
93901_0,,,,2,2,1,3
C(C([C](C(O)=O)O)CC(C=O)=O)=O,,,5,1,1,0,1
93902_0,,,,2,2,1,3
93904_0,,,,2,2,1,3
C(CC(C(C=O)=O)CC=CC=O)=O,,,5,1,1,0,1
93906_0,,,,2,2,1,3
C(C(C=C)C(C(C=O)=O)CC=O)=O,,,5,1,1,0,1
93907_0,,,,2,2,1,3
93909_0,,,,2,2,1,3
C(CC(C(C=O)=O)C1C=CC(O1)=O)=O,,,5,1,1,0,1
93911_0,,,,2,2,1,3
C(CC(C(C=O)=O)C1C(C=CO1)=O)=O,,,5,1,1,0,1
93912_0,,,,2,2,1,3
93913_0,,,,2,2,1,3
93914_0,,,,2,2,1,3
93915_0,,,,2,2,1,3
93917_0,,,,2,2,1,3
C(CC(C(C=O)=O)CC(C=O)=O)=O,,,5,1,1,0,1
93919_0,,,,2,2,1,3
C(C(C=O)C(C(C=O)=O)CC=O)=O,,,5,1,1,0,1
93921_0,,,,2,2,1,3
C(CC(C(C=O)=O)CC=O)=O,,,5,1,1,0,1
93922_0,,,,2,2,1,3
93923_0,,,,2,2,1,3
93924_0,,,,2,2,1,3
93925_0,,,,2,2,1,3
93926_0,,,,2,2,1,3
93927_0,,,,2,2,1,3
93928_0,,,,2,2,1,3
93930_0,,,,2,2,1,3
C(CC(C(C=O)=O)C(C=O)(O)O)=O,,,5,1,1,0,1
93931_0,,,,2,2,1,3
93933_0,,,,2,2,1,3
C(C(CC(C(C=O)=O)CC=O)O)=O,,,5,1,1,0,1
93935_0,,,,2,2,1,3
C(CC([C](C(O)=O)O)C(C=O)=O)=O,,,5,1,1,0,1
93936_0,,,,2,2,1,3
93938_0,,,,2,2,1,3
C(C(C=O)CC(C=CC(C=O)=O)O)=O,,,5,1,1,0,1
93940_0,,,,2,2,1,3
C(CC(C)C(C=CC(C=O)=O)O)=O,,,5,1,1,0,1
93942_0,,,,2,2,1,3
C(CCC(C=CC(C=O)=O)O)=O,,,5,1,1,0,1
93944_0,,,,2,2,1,3
C1(CC(CO1)C(C=CC(C=O)=O)O)=O,,,5,1,1,0,1
93946_0,,,,2,2,1,3
C(C(CCC(C=O)=O)O)=CC(C=O)=O,,,5,1,1,0,1
93947_0,,,,2,2,1,3
93949_0,,,,2,2,1,3
C(CCC(C=CC(C=O)=O)O)(O)=O,,,5,1,1,0,1
93951_0,,,,2,2,1,3
C(CC(CO)CC(C=O)=O)=CC=O,,,5,1,1,0,1
93953_0,,,,2,2,1,3
C(C(C=C)C(CO)CC(C=O)=O)=O,,,5,1,1,0,1
93955_0,,,,2,2,1,3
C1C(C(CO)CC(C=O)=O)OC(C=1)=O,,,5,1,1,0,1
93957_0,,,,2,2,1,3
C1OC(C(C=1)=O)C(CO)CC(C=O)=O,,,5,1,1,0,1
93959_0,,,,2,2,1,3
C=CC(C(CO)CC(C=O)=O)O,,,5,1,1,0,1
93960_0,,,,2,2,1,3
93961_0,,,,2,2,1,3
93963_0,,,,2,2,1,3
C(C(C(CO)CC(C=O)=O)O)(O)=O,,,5,1,1,0,1
93965_0,,,,2,2,1,3
C(C(CC(CO)CC(C=O)=O)=O)=O,,,5,1,1,0,1
93967_0,,,,2,2,1,3
C(C(C=O)C(CO)CC(C=O)=O)=O,,,5,1,2,0,2
93968_0,,,,2,2,1,3
93969_0,,,,2,2,1,3
93971_0,,,,2,2,1,3
C(C(CO)C(CO)CC(C=O)=O)=O,,,5,1,1,0,1
93972_0,,,,2,2,1,3
93973_0,,,,2,2,1,3
93975_0,,,,2,2,1,3
C(C(CC(CO)C(C)O)=O)=O,,,5,1,1,0,1
93977_0,,,,2,2,1,3
C(C(CC(CO)CCO)=O)=O,,,5,1,1,0,1
93978_0,,,,2,2,1,3
93980_0,,,,2,2,1,3
C(C(C(CO)CC(C=O)=O)(O)O)=O,,,5,1,1,0,1
93982_0,,,,2,2,1,3
C(C(C)(C(CO)CC(C=O)=O)O)=O,,,5,1,1,0,1
93983_0,,,,2,2,1,3
93985_0,,,,2,2,1,3
[C](C(O)=O)(C(CO)CC(C=O)=O)O,,,5,1,1,0,1
93986_0,,,,2,2,1,3
93988_0,,,,2,2,1,3
C(C(C=C(C=O)C=O)C(C)CC=O)=O,,,5,1,1,0,1
93990_0,,,,2,2,1,3
C(C(C=C(C=O)C=O)CCC=O)=O,,,5,1,1,0,1
93992_0,,,,2,2,1,3
C(C(C=C(C=O)C=O)CCC(O)=O)=O,,,5,1,1,0,1
93994_0,,,,2,2,1,3
C(C(C=O)C(CC=O)CC=CC=O)=O,,,5,1,2,0,2
93996_0,,,,2,2,1,3
C(C(C=C)C(CC=O)C(C=O)C=O)=O,,,5,1,2,0,2
93998_0,,,,2,2,1,3
C(CC(C(C=C)O)C(C=O)C=O)=O,,,5,1,2,0,2
93999_0,,,,2,2,1,3
94001_0,,,,2,2,1,3
C(C(C=O)C(C(CO)O)CC=O)=O,,,5,1,4,0,4
94002_0,,,,2,2,1,3
94004_0,,,,2,2,1,3
C(C(C=O)C(CC=O)C(C=O)C=O)=O,,,5,1,2,0,2
94006_0,,,,2,2,1,3
C(C(C=O)C(CC=O)CC=O)=O,,,5,1,3,0,3
94008_0,,,,2,2,1,3
C(C(C=O)C(C(C)O)CC=O)=O,,,5,1,2,0,2
94010_0,,,,2,2,1,3
C(C(C=O)C(CCO)CC=O)=O,,,5,1,2,0,2
94012_0,,,,2,2,1,3
C(C(C=O)C(CC=O)CC(O)=O)=O,,,5,1,2,0,2
94014_0,,,,2,2,1,3
C(CC(C(C=O)O)C(C=O)C=O)=O,,,5,1,3,0,3
94016_0,,,,2,2,1,3
C(C(C=O)(C=CC=O)C(C)CC=O)=O,,,5,1,1,0,1
94018_0,,,,2,2,1,3
C(C(C=O)(C=CC=O)CCC=O)=O,,,5,1,1,0,1
94020_0,,,,2,2,1,3
C(C(C=O)(C=CC=O)CCC(O)=O)=O,,,5,1,1,0,1
94021_0,,,,2,2,1,3
94022_0,,,,2,2,1,3
94023_0,,,,2,2,1,3
94024_0,,,,2,2,1,3
94025_0,,,,2,2,1,3
94026_0,,,,2,2,1,3
94027_0,,,,2,2,1,3
94028_0,,,,2,2,1,3
94029_0,,,,2,2,1,3
94030_0,,,,2,2,1,3
94031_0,,,,2,2,1,3
94032_0,,,,2,2,1,3
94033_0,,,,2,2,1,3
94034_0,,,,2,2,1,3
94035_0,,,,2,2,1,3
94036_0,,,,2,2,1,3
94037_0,,,,2,2,1,3
94038_0,,,,2,2,1,3
94039_0,,,,2,2,1,3
94040_0,,,,2,2,1,3
94041_0,,,,2,2,1,3
94042_0,,,,2,2,1,3
94043_0,,,,2,2,1,3
94044_0,,,,2,2,1,3
94046_0,,,,2,2,1,3
C(C(C=CC=O)C(CC=O)CC=O)=O,,,5,1,1,0,1
94048_0,,,,2,2,1,3
C(C(C=CC=O)C(C)C(C=O)C=O)=O,,,5,1,1,0,1
94050_0,,,,2,2,1,3
C(C(C=CC=O)CC(C=O)C=O)=O,,,5,1,1,0,1
94052_0,,,,2,2,1,3
C(C(C=CC=O)C(C)CC=O)=O,,,5,1,1,0,1
94054_0,,,,2,2,1,3
C(C(C=CC=O)CCC=O)=O,,,5,1,1,0,1
94056_0,,,,2,2,1,3
C(C(C=CC=O)C1COC(C1)=O)=O,,,5,1,1,0,1
94058_0,,,,2,2,1,3
C(C(C=CC=O)CCC(C=O)=O)=O,,,5,1,1,0,1
94060_0,,,,2,2,1,3
C(C(C=CC=O)C(C=O)CC=O)=O,,,5,1,1,0,1
94061_0,,,,2,2,1,3
94063_0,,,,2,2,1,3
C(C(C=O)(C=C)C(CC=O)CC=O)=O,,,5,1,1,0,1
94065_0,,,,2,2,1,3
C(CC(CC=O)CC=C(C=O)C=O)=O,,,5,1,1,0,1
94067_0,,,,2,2,1,3
C(CC(CC=O)CC=CC=O)=O,,,5,1,1,0,1
94069_0,,,,2,2,1,3
C(C(C=C)C(CC=O)CC=O)=O,,,5,1,1,0,1
94071_0,,,,2,2,1,3
C(C(C=C)(C(CC=O)CC=O)O)=O,,,5,1,1,0,1
94073_0,,,,2,2,1,3
C(CC(C1C=CC(O1)=O)CC=O)=O,,,5,1,1,0,1
94075_0,,,,2,2,1,3
C(CC(C1C(C=CO1)=O)CC=O)=O,,,5,1,1,0,1
94077_0,,,,2,2,1,3
C(CC(C(C=C)O)CC=O)=O,,,5,1,1,0,1
94079_0,,,,2,2,1,3
C(CC(CC=O)C[C](C(O)=O)O)=O,,,5,1,1,0,1
94081_0,,,,2,2,1,3
C(C(CO)(C(CC=O)CC=O)O)=O,,,5,1,2,0,2
94082_0,,,,2,2,1,3
94083_0,,,,2,2,1,3
94085_0,,,,2,2,1,3
C(CC(C(CO)O)CC=O)=O,,,5,1,2,0,2
94087_0,,,,2,2,1,3
C(CC(C(C(O)=O)O)CC=O)=O,,,5,1,2,0,2
94088_0,,,,2,2,1,3
94089_0,,,,2,2,1,3
94091_0,,,,2,2,1,3
C(CC(C(C(CO)O)O)CC=O)=O,,,5,1,2,0,2
94092_0,,,,2,2,1,3
94093_0,,,,2,2,1,3
94095_0,,,,2,2,1,3
C(CC(CC=O)CC=O)=O,,,5,1,1,0,1
94097_0,,,,2,2,1,3
C(C(C)(C(CC=O)CC=O)O)(O)=O,,,5,1,2,0,2
94099_0,,,,2,2,1,3
C(CC(CC(C(O)=O)O)CC=O)=O,,,5,1,1,0,1
94101_0,,,,2,2,1,3
C(CC(C(C(C=O)=O)O)CC=O)=O,,,5,1,2,0,2
94103_0,,,,2,2,1,3
C(C(C(CC=O)CC=O)C(C)O)=O,,,5,1,1,0,1
94105_0,,,,2,2,1,3
C(CC(C(C)(CC=O)O)CC=O)=O,,,5,1,1,0,1
94107_0,,,,2,2,1,3
C(CC(CC(CC=O)O)CC=O)=O,,,5,1,1,0,1
94108_0,,,,2,2,1,3
94110_0,,,,2,2,1,3
C(C(C(CC=O)CC=O)CO)=O,,,5,1,1,0,1
94112_0,,,,2,2,1,3
C(C(C=O)(C(CC=O)CC=O)O)=O,,,5,1,1,0,1
94114_0,,,,2,2,1,3
C(CC(C(C(C)=O)O)CC=O)=O,,,5,1,2,0,2
94116_0,,,,2,2,1,3
C(CC(CC=O)CC(CO)=O)=O,,,5,1,3,0,3
94118_0,,,,2,2,1,3
C(CC(C(C)O)CC=O)=O,,,5,1,1,0,1
94120_0,,,,2,2,1,3
C(CC(CCO)CC=O)=O,,,5,1,1,0,1
94122_0,,,,2,2,1,3
C(CC(CC=O)CC(C(O)=O)=O)=O,,,5,1,1,0,1
94124_0,,,,2,2,1,3
C(C(C(O)=O)C(CC=O)CC=O)=O,,,5,1,1,0,1
94126_0,,,,2,2,1,3
C(CC(CC=O)CC(O)=O)=O,,,5,1,1,0,1
94128_0,,,,2,2,1,3
C(C(C(C=O)=O)C(CC=O)CC=O)=O,,,5,1,1,0,1
94130_0,,,,2,2,1,3
C(CC(CC=O)CC(C(C=O)=O)=O)=O,,,5,1,1,0,1
94132_0,,,,2,2,1,3
C(CC(C(C=O)(O)O)CC=O)=O,,,5,1,1,0,1
94134_0,,,,2,2,1,3
C(C(C)(C(CC=O)CC=O)O)=O,,,5,1,1,0,1
94136_0,,,,2,2,1,3
C(CC(CC(C=O)O)CC=O)=O,,,5,1,2,0,2
94138_0,,,,2,2,1,3
C(CC([C](C(O)=O)O)CC=O)=O,,,5,1,1,0,1
94140_0,,,,2,2,1,3
C(CC(C(C=O)O)CC=O)=O,,,5,1,2,0,2
94142_0,,,,2,2,1,3
C(CCC(C=CC=O)(C(C=O)=O)O)=O,,,5,1,1,0,1
94143_0,,,,2,2,1,3
94144_0,,,,2,2,1,3
94146_0,,,,2,2,1,3
C(CC(C(C)O)C(C(C=O)=O)O)=O,,,5,1,1,0,1
94148_0,,,,2,2,1,3
C(CC(CCO)C(C(C=O)=O)O)=O,,,5,1,1,0,1
94150_0,,,,2,2,1,3
C(C(C=O)CC(C=O)(C=CC=O)O)=O,,,5,1,1,0,1
94152_0,,,,2,2,1,3
C(C(C=CC=O)(C(C)CC=O)O)=O,,,5,1,1,0,1
94154_0,,,,2,2,1,3
C(C(C=CC=O)(CCC=O)O)=O,,,5,1,1,0,1
94156_0,,,,2,2,1,3
C(C(C=CC=O)(C1COC(C1)=O)O)=O,,,5,1,1,0,1
94158_0,,,,2,2,1,3
C(C(C=CC=O)(CCC(C=O)=O)O)=O,,,5,1,1,0,1
94159_0,,,,2,2,1,3
94161_0,,,,2,2,1,3
C(C(C=CC=O)(CCC(O)=O)O)=O,,,5,1,1,0,1
94163_0,,,,2,2,1,3
C(CC(C(C=O)O)CC=CC=O)=O,,,5,1,1,0,1
94165_0,,,,2,2,1,3
C(CC(C(C=O)O)C(C=O)C=C)=O,,,5,1,1,0,1
94167_0,,,,2,2,1,3
C(C(C(C1C=CC(O1)=O)CC=O)O)=O,,,5,1,1,0,1
94169_0,,,,2,2,1,3
C(C(C(C1C(C=CO1)=O)CC=O)O)=O,,,5,1,1,0,1
94171_0,,,,2,2,1,3
C(CC(C(C=O)O)C(C=C)O)=O,,,5,1,1,0,1
94172_0,,,,2,2,1,3
94174_0,,,,2,2,1,3
C(CC(C(CO)O)C(C=O)O)=O,,,5,1,2,0,2
94176_0,,,,2,2,1,3
C(CC(C(C(O)=O)O)C(C=O)O)=O,,,5,1,2,0,2
94177_0,,,,2,2,1,3
94178_0,,,,2,2,1,3
94179_0,,,,2,2,1,3
94180_0,,,,2,2,1,3
94182_0,,,,2,2,1,3
C(CC(C(C=O)O)C(C=O)CO)=O,,,5,1,1,0,1
94184_0,,,,2,2,1,3
C(CC(C(C=O)O)C(C(C)=O)O)=O,,,5,1,2,0,2
94186_0,,,,2,2,1,3
C(CC(C(C=O)O)CC(CO)=O)=O,,,5,1,4,0,4
94188_0,,,,2,2,1,3
C(CC(C(C)O)C(C=O)O)=O,,,5,1,1,0,1
94190_0,,,,2,2,1,3
C(CC(CCO)C(C=O)O)=O,,,5,1,1,0,1
94192_0,,,,2,2,1,3
C(CC(C(C=O)O)CC=O)(O)=O,,,5,1,1,0,1
94194_0,,,,2,2,1,3
C(CC(C(C=O)(O)O)C(C=O)O)=O,,,5,1,1,0,1
94196_0,,,,2,2,1,3
C(CC(C(C=O)O)C(C=O)(C)O)=O,,,5,1,1,0,1
94198_0,,,,2,2,1,3
C(CC(CC(C=O)O)C(C=O)O)=O,,,5,1,2,0,2
94200_0,,,,2,2,1,3
C(CC([C](C(O)=O)O)C(C=O)O)=O,,,5,1,1,0,1
94202_0,,,,2,2,1,3
C(CC(C(C=O)O)C(C=O)O)=O,,,5,1,1,0,1
94203_0,,,,2,2,1,3
94205_0,,,,2,2,1,3
C(C(C=O)C(C=O)(CO)CCO)=O,,,5,1,2,0,2
94206_0,,,,2,2,1,3
94208_0,,,,2,2,1,3
C(C(C=O)C(C(CCO)=O)CO)=O,,,5,1,1,0,1
94210_0,,,,2,2,1,3
C(C(C=O)(CO)CC(CCO)=O)=O,,,5,1,1,0,1
94211_0,,,,2,2,1,3
94213_0,,,,2,2,1,3
C(C(C=O)C(CO)CC(C=O)O)=O,,,5,1,2,0,2
94215_0,,,,2,2,1,3
C(C(C=O)C(CO)CC(CO)=O)=O,,,5,1,3,0,3
94216_0,,,,2,2,1,3
94217_0,,,,2,2,1,3
94218_0,,,,2,2,1,3
94220_0,,,,2,2,1,3
C(C(C=O)C(CO)C(C(C)=O)O)=O,,,5,1,2,0,2
94222_0,,,,2,2,1,3
C(C(C=O)C(CO)(C)C(C=O)O)=O,,,5,1,1,0,1
94224_0,,,,2,2,1,3
C(C(C=O)(C=C)C(C)C(C=O)C=O)=O,,,5,1,1,0,1
94226_0,,,,2,2,1,3
C(C(C=O)(C=C)CC(C=O)C=O)=O,,,5,1,1,0,1
94228_0,,,,2,2,1,3
C(C(C=O)(C=C)C(C)CC=O)=O,,,5,1,1,0,1
94230_0,,,,2,2,1,3
C(C(C=O)(C=C)CCC=O)=O,,,5,1,1,0,1
94232_0,,,,2,2,1,3
C(C(C=O)(C=C)C1COC(C1)=O)=O,,,5,1,1,0,1
94234_0,,,,2,2,1,3
C(C(C=O)(C=C)CCC(C=O)=O)=O,,,5,1,1,0,1
94236_0,,,,2,2,1,3
C(C(C=O)(C=C)C(C=O)CC=O)=O,,,5,1,1,0,1
94237_0,,,,2,2,1,3
94239_0,,,,2,2,1,3
C(C(C=O)C(C)CC=C(C=O)C=O)=O,,,5,1,1,0,1
94241_0,,,,2,2,1,3
C(C(C=O)CCC=C(C=O)C=O)=O,,,5,1,1,0,1
94243_0,,,,2,2,1,3
C(CC(C)CC=C(C=O)C=O)=O,,,5,1,1,0,1
94245_0,,,,2,2,1,3
C(CCCC=C(C=O)C=O)=O,,,5,1,1,0,1
94247_0,,,,2,2,1,3
C1(CC(CO1)CC=C(C=O)C=O)=O,,,5,1,1,0,1
94249_0,,,,2,2,1,3
C(CCCC(C=O)=O)=C(C=O)C=O,,,5,1,1,0,1
94251_0,,,,2,2,1,3
C(CC(C=O)CC=C(C=O)C=O)=O,,,5,1,1,0,1
94252_0,,,,2,2,1,3
94254_0,,,,2,2,1,3
C(C(C=O)C(C)CC=CC=O)=O,,,5,1,1,0,1
94256_0,,,,2,2,1,3
C(C(C=C)C(C)C(C=O)C=O)=O,,,5,1,1,0,1
94258_0,,,,2,2,1,3
C(C(C=O)C(C)C(C=O)(C=C)O)=O,,,5,1,1,0,1
94260_0,,,,2,2,1,3
C(C(C=O)C(C)C1C=CC(O1)=O)=O,,,5,1,1,0,1
94262_0,,,,2,2,1,3
C(C(C=O)C(C)C1C(C=CO1)=O)=O,,,5,1,1,0,1
94264_0,,,,2,2,1,3
C(C(C=O)C(C)C(C=C)O)=O,,,5,1,1,0,1
94266_0,,,,2,2,1,3
C(C(C=O)C(C)C[C](C(O)=O)O)=O,,,5,1,1,0,1
94268_0,,,,2,2,1,3
C(C(C=O)C(C)C(C=O)(CO)O)=O,,,5,1,1,0,1
94270_0,,,,2,2,1,3
C(C(C=O)C(C)C(C(C=O)O)O)=O,,,5,1,1,0,1
94272_0,,,,2,2,1,3
C(C(C=O)C(C)CO)=O,,,5,1,1,0,1
94274_0,,,,2,2,1,3
C(C(C=O)C(C)C(CO)O)=O,,,5,1,1,0,1
94275_0,,,,2,2,1,3
94277_0,,,,2,2,1,3
C(C(C=O)C(C)C(C(CO)=O)O)=O,,,5,1,1,0,1
94279_0,,,,2,2,1,3
C(C(C=O)C(C)C(CO)(CO)O)=O,,,5,1,1,0,1
94281_0,,,,2,2,1,3
C(C(C=O)C(C)C(C(CO)O)O)=O,,,5,1,1,0,1
94282_0,,,,2,2,1,3
94284_0,,,,2,2,1,3
C(C(C=O)C(C)C(C=O)C=O)=O,,,5,1,1,0,1
94286_0,,,,2,2,1,3
C(C(C=O)C(C)CC=O)=O,,,5,1,2,0,2
94288_0,,,,2,2,1,3
C(C(C=O)C(C)C(C(O)=O)(C)O)=O,,,5,1,1,0,1
94290_0,,,,2,2,1,3
C(C(C=O)C(C)CC(C(O)=O)O)=O,,,5,1,1,0,1
94292_0,,,,2,2,1,3
C(C(C=O)C(C)C(C(C=O)=O)O)=O,,,5,1,1,0,1
94294_0,,,,2,2,1,3
C(C(C=O)C(C)C(C=O)C(C)O)=O,,,5,1,1,0,1
94296_0,,,,2,2,1,3
C(C(C=O)C(C)C(C)(CC=O)O)=O,,,5,1,1,0,1
94298_0,,,,2,2,1,3
C(C(C=O)C(C)CC(CC=O)O)=O,,,5,1,1,0,1
94300_0,,,,2,2,1,3
C(C(C=O)C(C)C(CC=O)O)=O,,,5,1,1,0,1
94302_0,,,,2,2,1,3
C(C(C=O)C(C)C(C=O)CO)=O,,,5,1,1,0,1
94304_0,,,,2,2,1,3
C(C(C=O)C(C)C(C=O)(C=O)O)=O,,,5,1,1,0,1
94306_0,,,,2,2,1,3
C(C(C=O)C(C)C(C(C)=O)O)=O,,,5,1,1,0,1
94308_0,,,,2,2,1,3
C(C(C=O)C(C)CC(CO)=O)=O,,,5,1,1,0,1
94310_0,,,,2,2,1,3
C(C(C=O)C(C)C(C)O)=O,,,5,1,1,0,1
94312_0,,,,2,2,1,3
C(C(C=O)C(C)CCO)=O,,,5,1,1,0,1
94314_0,,,,2,2,1,3
C(C(C=O)C(C)CC(C(O)=O)=O)=O,,,5,1,1,0,1
94316_0,,,,2,2,1,3
C(C(C=O)C(C)C(C=O)C(O)=O)=O,,,5,1,1,0,1
94318_0,,,,2,2,1,3
C(C(C=O)C(C)CC(O)=O)=O,,,5,1,1,0,1
94320_0,,,,2,2,1,3
C(C(C(C=O)=O)C(C)C(C=O)C=O)=O,,,5,1,1,0,1
94322_0,,,,2,2,1,3
C(C(C=O)C(C)CC(C(C=O)=O)=O)=O,,,5,1,1,0,1
94324_0,,,,2,2,1,3
C(C(C=O)C(C)C(C=O)(O)O)=O,,,5,1,1,0,1
94326_0,,,,2,2,1,3
C(C(C=O)C(C)C(C=O)(C)O)=O,,,5,1,1,0,1
94328_0,,,,2,2,1,3
C(C(C=O)C(C)CC(C=O)O)=O,,,5,1,1,0,1
94330_0,,,,2,2,1,3
C(C(C=O)C([C](C(O)=O)O)C)=O,,,5,1,1,0,1
94332_0,,,,2,2,1,3
C(C(C=O)C(C)C(C=O)O)=O,,,5,1,2,0,2
94334_0,,,,2,2,1,3
C(CCC(C(C=O)=C(C=O)C=O)O)=O,,,5,1,1,0,1
94335_0,,,,2,2,1,3
94337_0,,,,2,2,1,3
C(C(CO)(CC=O)C(C=O)C=O)=O,,,5,1,2,0,2
94338_0,,,,2,2,1,3
94339_0,,,,2,2,1,3
94340_0,,,,2,2,1,3
94342_0,,,,2,2,1,3
C(C(CO)C(C=O)(C=O)CC=O)=O,,,5,1,2,0,2
94343_0,,,,2,2,1,3
94345_0,,,,2,2,1,3
C(C(C=O)(CCO)C(C=O)CO)=O,,,5,1,1,0,1
94347_0,,,,2,2,1,3
C(CCC(C(C=C(C=O)C=O)=O)O)=O,,,5,1,1,0,1
94348_0,,,,2,2,1,3
94350_0,,,,2,2,1,3
C(C(C=O)C(C(CO)=O)CC=O)=O,,,5,1,2,0,2
94351_0,,,,2,2,1,3
94353_0,,,,2,2,1,3
C(C(C=O)C(C(CO)=O)CCO)=O,,,5,1,1,0,1
94354_0,,,,2,2,1,3
94356_0,,,,2,2,1,3
C(C(C=O)(CC(CO)=O)CC=O)=O,,,5,1,2,0,2
94357_0,,,,2,2,1,3
94359_0,,,,2,2,1,3
C(C(C=O)(CCO)CC(CO)=O)=O,,,5,1,1,0,1
94360_0,,,,2,2,1,3
94361_0,,,,2,2,1,3
94363_0,,,,2,2,1,3
C(C(C=O)C(C(CO)O)C(C)O)=O,,,5,1,1,0,1
94365_0,,,,2,2,1,3
C(C(C=O)C(CCO)C(CO)O)=O,,,5,1,1,0,1
94367_0,,,,2,2,1,3
C(C(C=O)C(C=O)CC=CC=O)=O,,,5,1,1,0,1
94369_0,,,,2,2,1,3
C(C(C=C)C(C=O)C(C=O)C=O)=O,,,5,1,1,0,1
94370_0,,,,2,2,1,3
94372_0,,,,2,2,1,3
C(C(C=O)C(C=O)C1C=CC(O1)=O)=O,,,5,1,1,0,1
94374_0,,,,2,2,1,3
C(C(C=O)C(C=O)C1C(C=CO1)=O)=O,,,5,1,1,0,1
94375_0,,,,2,2,1,3
94376_0,,,,2,2,1,3
94377_0,,,,2,2,1,3
94378_0,,,,2,2,1,3
94379_0,,,,2,2,1,3
94381_0,,,,2,2,1,3
C(C(C=O)C(C=O)C(C=O)C=O)=O,,,5,1,1,0,1
94382_0,,,,2,2,1,3
94383_0,,,,2,2,1,3
94384_0,,,,2,2,1,3
94385_0,,,,2,2,1,3
94387_0,,,,2,2,1,3
C(C(C=O)C(C=O)CC(CO)=O)=O,,,5,1,2,0,2
94388_0,,,,2,2,1,3
94389_0,,,,2,2,1,3
94390_0,,,,2,2,1,3
94392_0,,,,2,2,1,3
C(C(C=O)C(C=O)C(C=O)(O)O)=O,,,5,1,1,0,1
94393_0,,,,2,2,1,3
94394_0,,,,2,2,1,3
94396_0,,,,2,2,1,3
C(C(C=O)C(C=O)[C](C(O)=O)O)=O,,,5,1,1,0,1
94397_0,,,,2,2,1,3
94399_0,,,,2,2,1,3
C(C(C=O)(CC=O)CC=CC=O)=O,,,5,1,1,0,1
94401_0,,,,2,2,1,3
C(C(C=O)(CC=O)C(C=O)C=C)=O,,,5,1,1,0,1
94402_0,,,,2,2,1,3
94404_0,,,,2,2,1,3
C(C(C=O)(C1C=CC(O1)=O)CC=O)=O,,,5,1,1,0,1
94406_0,,,,2,2,1,3
C(C(C=O)(C1C(C=CO1)=O)CC=O)=O,,,5,1,1,0,1
94407_0,,,,2,2,1,3
94408_0,,,,2,2,1,3
94409_0,,,,2,2,1,3
94410_0,,,,2,2,1,3
94412_0,,,,2,2,1,3
C(C(C=O)(CC(C=O)=O)CC=O)=O,,,5,1,1,0,1
94414_0,,,,2,2,1,3
C(C(C=O)(CC=O)C(C=O)C=O)=O,,,5,1,1,0,1
94416_0,,,,2,2,1,3
C(C(C=O)(CC=O)CC=O)=O,,,5,1,1,0,1
94417_0,,,,2,2,1,3
94418_0,,,,2,2,1,3
94419_0,,,,2,2,1,3
94420_0,,,,2,2,1,3
94421_0,,,,2,2,1,3
94423_0,,,,2,2,1,3
C(C(C=O)(CCO)CC=O)=O,,,5,1,1,0,1
94424_0,,,,2,2,1,3
94426_0,,,,2,2,1,3
C(C(C=O)(CC=O)C(C=O)(O)O)=O,,,5,1,1,0,1
94427_0,,,,2,2,1,3
94429_0,,,,2,2,1,3
C(C(CC(C=O)(C=O)CC=O)O)=O,,,5,1,1,0,1
94431_0,,,,2,2,1,3
C(C(C=O)([C](C(O)=O)O)CC=O)=O,,,5,1,1,0,1
94432_0,,,,2,2,1,3
94434_0,,,,2,2,1,3
C(C(C=O)CC(C=C(C=O)C=O)O)=O,,,5,1,1,0,1
94436_0,,,,2,2,1,3
C(C(C=O)CC(C(C(C=O)=O)=C)O)=O,,,5,1,1,0,1
94438_0,,,,2,2,1,3
C(C(C=O)CC(C(C=O)=CC=O)O)=O,,,5,1,1,0,1
94440_0,,,,2,2,1,3
C(C(C=O)CC(C(C(C=O)=C)=O)O)=O,,,5,1,1,0,1
94442_0,,,,2,2,1,3
C(C(C=O)CC(C=O)(C(C=C)=O)O)=O,,,5,1,1,0,1
94444_0,,,,2,2,1,3
C(C(C=O)CCC=CC=O)=O,,,5,1,1,0,1
94446_0,,,,2,2,1,3
C(C(C=C)CC(C=O)C=O)=O,,,5,1,1,0,1
94448_0,,,,2,2,1,3
C(C(C=O)CC(C=C)(C(C=O)=O)O)=O,,,5,1,1,0,1
94450_0,,,,2,2,1,3
C(C(C=O)CC(C=O)(C=C)O)=O,,,5,1,1,0,1
94452_0,,,,2,2,1,3
C(C(C=O)CC(C(C=CC=O)=O)O)=O,,,5,1,1,0,1
94454_0,,,,2,2,1,3
C(C(C=O)CC(C(C(O)=O)=C)O)=O,,,5,1,1,0,1
94456_0,,,,2,2,1,3
C(C(C=O)CC1C=CC(O1)=O)=O,,,5,1,1,0,1
94458_0,,,,2,2,1,3
C(C(C=O)CC1C(C=CO1)=O)=O,,,5,1,1,0,1
94460_0,,,,2,2,1,3
C(C(C=O)CC(C=C)O)=O,,,5,1,1,0,1
94462_0,,,,2,2,1,3
C(C(C=O)CC1C(CC(O)O1)O)=O,,,5,1,1,0,1
94464_0,,,,2,2,1,3
C(C(C=O)CC1(COC(C1)O)O)=O,,,5,1,1,0,1
94466_0,,,,2,2,1,3
C(C(C=O)CC1(CC(CO1)O)O)=O,,,5,1,1,0,1
94468_0,,,,2,2,1,3
C(C(C=O)CC1C(O)OCC1O)=O,,,5,1,1,0,1
94470_0,,,,2,2,1,3
C(C(C=O)CC1(C(O)OCC1)O)=O,,,5,1,1,0,1
94472_0,,,,2,2,1,3
C(C(C=O)CC1(C(CCO1)O)O)=O,,,5,1,1,0,1
94474_0,,,,2,2,1,3
C(C(C=O)CC1CC(C(O)O1)O)=O,,,5,1,1,0,1
94476_0,,,,2,2,1,3
C(C(C=O)CC1COC(C1O)O)=O,,,5,1,1,0,1
94478_0,,,,2,2,1,3
C(C(C=O)CC(CCC(O)=O)O)=O,,,5,1,1,0,1
94480_0,,,,2,2,1,3
C(C(C=O)CC(C(O)=O)CCO)=O,,,5,1,1,0,1
94482_0,,,,2,2,1,3
C(C(C=O)CC(CO)CC(O)=O)=O,,,5,1,1,0,1
94484_0,,,,2,2,1,3
C(C(C=O)CC(C(O)=O)(CC)O)=O,,,5,1,1,0,1
94486_0,,,,2,2,1,3
C(C(C=O)CC(C)C(C(O)=O)O)=O,,,5,1,1,0,1
94488_0,,,,2,2,1,3
C(C(C=O)CCCC(C(O)=O)O)=O,,,5,1,1,0,1
94490_0,,,,2,2,1,3
C(C(C=O)CC[C](C(O)=O)O)=O,,,5,1,1,0,1
94492_0,,,,2,2,1,3
C(C(C=O)CC(C=O)(CO)O)=O,,,5,1,1,0,1
94493_0,,,,2,2,1,3
94494_0,,,,2,2,1,3
94496_0,,,,2,2,1,3
C(C(C=O)CC(CO)O)=O,,,5,1,1,0,1
94497_0,,,,2,2,1,3
94498_0,,,,2,2,1,3
94500_0,,,,2,2,1,3
C(C(C=O)CC(CO)(CO)O)=O,,,5,1,1,0,1
94502_0,,,,2,2,1,3
C(C(C=O)CC(C(CO)O)O)=O,,,5,1,1,0,1
94504_0,,,,2,2,1,3
C(C(C=O)CC(C(O)=O)(CO)O)=O,,,5,1,1,0,1
94505_0,,,,2,2,1,3
94506_0,,,,2,2,1,3
94508_0,,,,2,2,1,3
C(C(C=O)CC(C=O)C=O)=O,,,5,1,1,0,1
94509_0,,,,2,2,1,3
94510_0,,,,2,2,1,3
94511_0,,,,2,2,1,3
94512_0,,,,2,2,1,3
94514_0,,,,2,2,1,3
C(C(C=O)CC(C=O)C(CO)=O)=O,,,5,1,2,0,2
94516_0,,,,2,2,1,3
C(C(C=O)CC(C(CC=O)=O)O)=O,,,5,1,1,0,1
94518_0,,,,2,2,1,3
C(C(C=O)CC(C=O)(C(C)=O)O)=O,,,5,1,1,0,1
94520_0,,,,2,2,1,3
C(C(C=O)CCC(C(C=O)O)=O)=O,,,5,1,2,0,2
94522_0,,,,2,2,1,3
C(C(C=O)CCC=O)=O,,,5,1,2,0,2
94523_0,,,,2,2,1,3
94524_0,,,,2,2,1,3
94525_0,,,,2,2,1,3
94526_0,,,,2,2,1,3
94528_0,,,,2,2,1,3
C(C(C=O)(CC(C=O)C=O)CO)=O,,,5,1,1,0,1
94530_0,,,,2,2,1,3
C(C(C=O)CC(C=O)C(C)O)=O,,,5,1,1,0,1
94532_0,,,,2,2,1,3
C(C(C=O)CC(C)(CC=O)O)=O,,,5,1,1,0,1
94534_0,,,,2,2,1,3
C(C(C=O)CCC(CC=O)O)=O,,,5,1,1,0,1
94536_0,,,,2,2,1,3
C(C(C=O)CC(C=O)(C(C)O)O)=O,,,5,1,1,0,1
94538_0,,,,2,2,1,3
C(C(C=O)CC(C)(C(C=O)O)O)=O,,,5,1,1,0,1
94540_0,,,,2,2,1,3
C(C(C=O)CCC(C(C=O)O)O)=O,,,5,1,1,0,1
94541_0,,,,2,2,1,3
94543_0,,,,2,2,1,3
C(C(C=O)CC(C=O)CO)=O,,,5,1,1,0,1
94545_0,,,,2,2,1,3
C(C(C=O)CC(C(CC=O)O)O)=O,,,5,1,1,0,1
94546_0,,,,2,2,1,3
94548_0,,,,2,2,1,3
C(C(C=O)CC(C=O)C(CO)O)=O,,,5,1,1,0,1
94550_0,,,,2,2,1,3
C(C(C=O)CC(C(C(C)=O)=O)O)=O,,,5,1,1,0,1
94552_0,,,,2,2,1,3
C(C(C=O)CCC(C(CO)=O)=O)=O,,,5,1,1,0,1
94554_0,,,,2,2,1,3
C(C(C=O)CCC(C(C=O)=O)O)=O,,,5,1,1,0,1
94556_0,,,,2,2,1,3
C(C(C=O)CC(C(C=O)=O)(C)O)=O,,,5,1,1,0,1
94558_0,,,,2,2,1,3
C(C(C=O)CC(C=O)(C=O)O)=O,,,5,1,1,0,1
94560_0,,,,2,2,1,3
C(C(C=O)CC(C(C)=O)O)=O,,,5,1,1,0,1
94561_0,,,,2,2,1,3
94563_0,,,,2,2,1,3
C(C(C=O)CC(C(CCO)=O)O)=O,,,5,1,1,0,1
94564_0,,,,2,2,1,3
94566_0,,,,2,2,1,3
C(C(C=O)CC(C(CO)=O)CO)=O,,,5,1,1,0,1
94568_0,,,,2,2,1,3
C(C(C=O)CC(C=O)(CCO)O)=O,,,5,1,1,0,1
94570_0,,,,2,2,1,3
C(C(C=O)CC(CC(C=O)O)O)=O,,,5,1,1,0,1
94572_0,,,,2,2,1,3
C(C(C=O)CC(CO)C(C=O)O)=O,,,5,1,1,0,1
94574_0,,,,2,2,1,3
C(C(C=O)CC(C(C)=O)(CO)O)=O,,,5,1,1,0,1
94575_0,,,,2,2,1,3
94577_0,,,,2,2,1,3
C(C(C=O)CCC(C(CO)O)=O)=O,,,5,1,1,0,1
94579_0,,,,2,2,1,3
C(C(C=O)CC(C)O)=O,,,5,1,1,0,1
94581_0,,,,2,2,1,3
C(C(C=O)CCCO)=O,,,5,1,1,0,1
94582_0,,,,2,2,1,3
94584_0,,,,2,2,1,3
C(C(C=O)CC(C=O)C(O)=O)=O,,,5,1,1,0,1
94585_0,,,,2,2,1,3
94587_0,,,,2,2,1,3
C(C(C=O)CC(C(C(O)=O)=O)O)=O,,,5,1,1,0,1
94589_0,,,,2,2,1,3
C(C(C(C=O)=O)CC(C=O)C=O)=O,,,5,1,2,0,2
94591_0,,,,2,2,1,3
C(C(C=O)CC1C(C(CO1)O)=O)=O,,,5,1,1,0,1
94593_0,,,,2,2,1,3
C(C(C=O)CC1C(C(CO1)=O)O)=O,,,5,1,1,0,1
94595_0,,,,2,2,1,3
C(C(C=O)CC1(C(COC1)=O)O)=O,,,5,1,1,0,1
94597_0,,,,2,2,1,3
C(C(C=O)CC1(C(CCO1)=O)O)=O,,,5,1,1,0,1
94599_0,,,,2,2,1,3
C(C(C=O)CC1CC(C(O)O1)=O)=O,,,5,1,1,0,1
94601_0,,,,2,2,1,3
C(C(C=O)CC1C(C(O)OC1)=O)=O,,,5,1,1,0,1
94603_0,,,,2,2,1,3
C(C(C=O)CC1C(OCC1O)=O)=O,,,5,1,1,0,1
94605_0,,,,2,2,1,3
C(C(C=O)CC1C(CC(O1)=O)O)=O,,,5,1,1,0,1
94607_0,,,,2,2,1,3
C(C(C=O)CC1(COC(C1)=O)O)=O,,,5,1,1,0,1
94609_0,,,,2,2,1,3
C(C(C=O)CC1C(COC1O)=O)=O,,,5,1,1,0,1
94611_0,,,,2,2,1,3
C(C(C=O)CC1(CC(CO1)=O)O)=O,,,5,1,1,0,1
94613_0,,,,2,2,1,3
C(C(C=O)CC1C(CC(O1)O)=O)=O,,,5,1,1,0,1
94615_0,,,,2,2,1,3
C(C(C=O)CCC(C(C=O)=O)=O)=O,,,5,1,1,0,1
94617_0,,,,2,2,1,3
C(C(C=O)CC(C=CC(O)=O)O)=O,,,5,1,1,0,1
94619_0,,,,2,2,1,3
C(C(C=O)CC(C(O)=O)(C=C)O)=O,,,5,1,1,0,1
94621_0,,,,2,2,1,3
C(C(C=O)CC1(C(OCC1)=O)O)=O,,,5,1,1,0,1
94623_0,,,,2,2,1,3
C(C(C=O)CC1CC(C(O1)=O)O)=O,,,5,1,1,0,1
94625_0,,,,2,2,1,3
C(C(C=O)CC1COC(C1O)=O)=O,,,5,1,1,0,1
94627_0,,,,2,2,1,3
C(C(C=O)CC(C=O)(O)O)=O,,,5,1,1,0,1
94629_0,,,,2,2,1,3
C(C(C=O)CC(C=O)(C)O)=O,,,5,1,1,0,1
94631_0,,,,2,2,1,3
C(C(C=O)CCC(C=O)O)=O,,,5,1,2,0,2
94633_0,,,,2,2,1,3
C(C(C=O)C[C](C(O)=O)O)=O,,,5,1,1,0,1
94634_0,,,,2,2,1,3
94636_0,,,,2,2,1,3
C(CC(C)C(C=C(C=O)C=O)O)=O,,,5,1,1,0,1
94638_0,,,,2,2,1,3
C(CCC(C=C(C=O)C=O)O)=O,,,5,1,1,0,1
94640_0,,,,2,2,1,3
C1(CC(CO1)C(C=C(C=O)C=O)O)=O,,,5,1,1,0,1
94642_0,,,,2,2,1,3
C(C(CCC(C=O)=O)O)=C(C=O)C=O,,,5,1,1,0,1
94643_0,,,,2,2,1,3
94645_0,,,,2,2,1,3
C(CCC(C=C(C=O)C=O)O)(O)=O,,,5,1,1,0,1
94647_0,,,,2,2,1,3
C(C(C=O)C(CO)CC=CC=O)=O,,,5,1,1,0,1
94649_0,,,,2,2,1,3
C(C(C=C)C(CO)C(C=O)C=O)=O,,,5,1,1,0,1
94651_0,,,,2,2,1,3
C(C(C=O)C(CO)C1C=CC(O1)=O)=O,,,5,1,1,0,1
94653_0,,,,2,2,1,3
C(C(C=O)C(CO)C1C(C=CO1)=O)=O,,,5,1,1,0,1
94655_0,,,,2,2,1,3
C(C(C=O)C(CO)C(C=C)O)=O,,,5,1,1,0,1
94656_0,,,,2,2,1,3
94657_0,,,,2,2,1,3
94658_0,,,,2,2,1,3
94659_0,,,,2,2,1,3
94661_0,,,,2,2,1,3
C(C(C=O)C(CO)C(C=O)C=O)=O,,,5,1,1,0,1
94662_0,,,,2,2,1,3
94663_0,,,,2,2,1,3
94665_0,,,,2,2,1,3
C(C(C=O)C(CO)C(C=O)CO)=O,,,5,1,1,0,1
94666_0,,,,2,2,1,3
94667_0,,,,2,2,1,3
94669_0,,,,2,2,1,3
C(C(C=O)C(CO)C(C)O)=O,,,5,1,1,0,1
94671_0,,,,2,2,1,3
C(C(C=O)C(CO)CCO)=O,,,5,1,1,0,1
94672_0,,,,2,2,1,3
94674_0,,,,2,2,1,3
C(C(C=O)C(CO)C(C=O)(O)O)=O,,,5,1,1,0,1
94676_0,,,,2,2,1,3
C(C(C=O)C(CO)C(C=O)(C)O)=O,,,5,1,1,0,1
94677_0,,,,2,2,1,3
94679_0,,,,2,2,1,3
C(C(C=O)C([C](C(O)=O)O)CO)=O,,,5,1,1,0,1
94680_0,,,,2,2,1,3
94682_0,,,,2,2,1,3
C(CC(C)C(CC(C=O)=CC=O)O)=O,,,5,1,1,0,1
94684_0,,,,2,2,1,3
C(CCC(CC(C=O)=CC=O)O)=O,,,5,1,1,0,1
94686_0,,,,2,2,1,3
C(CC(C)C(C(C=O)=CC=O)CO)=O,,,5,1,1,0,1
94688_0,,,,2,2,1,3
C(CCC(C(C=O)=CC=O)CO)=O,,,5,1,1,0,1
94690_0,,,,2,2,1,3
C(C(CCO)C(C=O)CC=CC=O)=O,,,5,1,1,0,1
94692_0,,,,2,2,1,3
C(C(CCO)C(C=O)C(C=O)C=C)=O,,,5,1,1,0,1
94693_0,,,,2,2,1,3
94694_0,,,,2,2,1,3
94695_0,,,,2,2,1,3
94697_0,,,,2,2,1,3
C(CC(C=O)C(C=O)CCO)=O,,,5,1,1,0,1
94698_0,,,,2,2,1,3
94700_0,,,,2,2,1,3
C(C(CCO)C(C=O)CCO)=O,,,5,1,1,0,1
94702_0,,,,2,2,1,3
C(CC(C=O)C(C=O)CCO)(O)=O,,,5,1,1,0,1
94703_0,,,,2,2,1,3
94705_0,,,,2,2,1,3
C(C(CCO)(CC=O)CC=CC=O)=O,,,5,1,1,0,1
94707_0,,,,2,2,1,3
C(C(CCO)(CC=O)C(C=O)C=C)=O,,,5,1,1,0,1
94709_0,,,,2,2,1,3
C(CC(C=O)(CCO)C(C=C)O)=O,,,5,1,1,0,1
94711_0,,,,2,2,1,3
C(C(CO)(CCO)CC=O)=O,,,5,1,2,0,2
94713_0,,,,2,2,1,3
C(C(CCO)(C(CO)O)CC=O)=O,,,5,1,2,0,2
94715_0,,,,2,2,1,3
C(C(CCO)(CC=O)CC=O)=O,,,5,1,1,0,1
94717_0,,,,2,2,1,3
C(C(CCO)(C(C)O)CC=O)=O,,,5,1,2,0,2
94719_0,,,,2,2,1,3
C(C(CCO)(CCO)CC=O)=O,,,5,1,1,0,1
94721_0,,,,2,2,1,3
C(C(CCO)(CC(O)=O)CC=O)=O,,,5,1,1,0,1
94723_0,,,,2,2,1,3
C(CC(C=O)(CCO)C(C=O)O)=O,,,5,1,2,0,2
94725_0,,,,2,2,1,3
C(CC(C)C(C=O)C(C=O)=CCO)=O,,,5,1,1,0,1
94727_0,,,,2,2,1,3
C(CCC(C=O)C(C=O)=CCO)=O,,,5,1,1,0,1
94729_0,,,,2,2,1,3
C(CC(C)C(C=C(C=O)CC=O)O)=O,,,5,1,1,0,1
94731_0,,,,2,2,1,3
C(CCC(C=C(C=O)CC=O)O)=O,,,5,1,1,0,1
94733_0,,,,2,2,1,3
C(C(C(CO)CC=CC=O)CC=O)=O,,,5,1,1,0,1
94735_0,,,,2,2,1,3
C(C(C(CO)C(C=O)C=C)CC=O)=O,,,5,1,1,0,1
94737_0,,,,2,2,1,3
C(C(C(CO)C(C=C)O)CC=O)=O,,,5,1,1,0,1
94738_0,,,,2,2,1,3
94739_0,,,,2,2,1,3
94740_0,,,,2,2,1,3
94741_0,,,,2,2,1,3
94743_0,,,,2,2,1,3
C(C(C(CO)CCO)CC=O)=O,,,5,1,1,0,1
94744_0,,,,2,2,1,3
94745_0,,,,2,2,1,3
94746_0,,,,2,2,1,3
94747_0,,,,2,2,1,3
94749_0,,,,2,2,1,3
C(C(C(CO)C(C)O)C(C=O)O)=O,,,5,1,1,0,1
94751_0,,,,2,2,1,3
C(C(C(CO)CCO)C(C=O)O)=O,,,5,1,1,0,1
94753_0,,,,2,2,1,3
C(CC(C)C(CC(C=CC=O)=O)O)=O,,,5,1,1,0,1
94754_0,,,,2,2,1,3
94756_0,,,,2,2,1,3
C(CC(C)C(C(C=CC=O)=O)CO)=O,,,5,1,1,0,1
94758_0,,,,2,2,1,3
C(CCC(C(C=CC=O)=O)CO)=O,,,5,1,1,0,1
94760_0,,,,2,2,1,3
C(CC(C=O)CC=CC=O)(CCO)=O,,,5,1,1,0,1
94762_0,,,,2,2,1,3
C(CC(C=O)C(C=O)C=C)(CCO)=O,,,5,1,1,0,1
94764_0,,,,2,2,1,3
C(CC(C=O)C(C=C)O)(CCO)=O,,,5,1,1,0,1
94765_0,,,,2,2,1,3
94767_0,,,,2,2,1,3
C(C(C(CO)O)CC(CCO)=O)=O,,,5,1,1,0,1
94769_0,,,,2,2,1,3
C(CC(C=O)CC=O)(CCO)=O,,,5,1,1,0,1
94770_0,,,,2,2,1,3
94772_0,,,,2,2,1,3
C(C(CCO)CC(CCO)=O)=O,,,5,1,1,0,1
94774_0,,,,2,2,1,3
C(CC(C=O)CC(O)=O)(CCO)=O,,,5,1,1,0,1
94776_0,,,,2,2,1,3
C(CC(C=O)C(C=O)O)(CCO)=O,,,5,1,1,0,1
94778_0,,,,2,2,1,3
C(CC(C(CCO)=O)CC=CC=O)=O,,,5,1,1,0,1
94780_0,,,,2,2,1,3
C(CC(C(CCO)=O)C(C=O)C=C)=O,,,5,1,1,0,1
94782_0,,,,2,2,1,3
C(CC(C(CCO)=O)C(C=C)O)=O,,,5,1,1,0,1
94784_0,,,,2,2,1,3
C(C(CO)CC=O)(CCO)=O,,,5,1,1,0,1
94786_0,,,,2,2,1,3
C(C(C(CO)O)CC=O)(CCO)=O,,,5,1,1,0,1
94788_0,,,,2,2,1,3
C(CC(C(CCO)=O)CC=O)=O,,,5,1,1,0,1
94790_0,,,,2,2,1,3
C(C(C(C)O)CC=O)(CCO)=O,,,5,1,1,0,1
94792_0,,,,2,2,1,3
C(C(CCO)CC=O)(CCO)=O,,,5,1,1,0,1
94794_0,,,,2,2,1,3
C(CC(C(CCO)=O)CC=O)(O)=O,,,5,1,1,0,1
94796_0,,,,2,2,1,3
C(C(C(C(CCO)=O)CC=O)O)=O,,,5,1,1,0,1
94798_0,,,,2,2,1,3
C(CC(C)C(C(C=C)C(C=O)=O)O)=O,,,5,1,1,0,1
94799_0,,,,2,2,1,3
94801_0,,,,2,2,1,3
C(CC(C)C(C=C)(C(C=O)=O)CO)=O,,,5,1,1,0,1
94803_0,,,,2,2,1,3
C(CCC(C=C)(C(C=O)=O)CO)=O,,,5,1,1,0,1
94805_0,,,,2,2,1,3
C(CC(C)CC=C(C(C=O)=O)CO)=O,,,5,1,1,0,1
94807_0,,,,2,2,1,3
C(CCCC=C(C(C=O)=O)CO)=O,,,5,1,1,0,1
94809_0,,,,2,2,1,3
C(CC(C)C(C(C(C=O)=O)=CC)O)=O,,,5,1,1,0,1
94811_0,,,,2,2,1,3
C(CCC(C(C(C=O)=O)=CC)O)=O,,,5,1,1,0,1
94813_0,,,,2,2,1,3
C(CC(C)C(C(C=O)=O)CO)=CC=O,,,5,1,1,0,1
94815_0,,,,2,2,1,3
C(C(C=C)C(C)C(C(C=O)=O)CO)=O,,,5,1,1,0,1
94817_0,,,,2,2,1,3
C=CC(C(C)C(C(C=O)=O)CO)O,,,5,1,1,0,1
94819_0,,,,2,2,1,3
C(C(C(CO)C(C)CO)=O)=O,,,5,1,1,0,1
94821_0,,,,2,2,1,3
C(C(C(CO)C(C)C(CO)O)=O)=O,,,5,1,1,0,1
94823_0,,,,2,2,1,3
C(CC(C)C(C(C=O)=O)CO)=O,,,5,1,2,0,2
94825_0,,,,2,2,1,3
C(C(C(CO)C(C)C(C)O)=O)=O,,,5,1,1,0,1
94827_0,,,,2,2,1,3
C(C(C(CO)C(C)CCO)=O)=O,,,5,1,1,0,1
94829_0,,,,2,2,1,3
C(CC(C)C(C(C=O)=O)CO)(O)=O,,,5,1,1,0,1
94831_0,,,,2,2,1,3
C(C(C(C)C(C(C=O)=O)CO)O)=O,,,5,1,1,0,1
94833_0,,,,2,2,1,3
C(CC(C)C(C(C(C=O)=O)=C)(C)O)=O,,,5,1,1,0,1
94835_0,,,,2,2,1,3
C(CCC(C(C(C=O)=O)=C)(C)O)=O,,,5,1,1,0,1
94837_0,,,,2,2,1,3
C(CC(C)CC(C(C(C=O)=O)=C)O)=O,,,5,1,1,0,1
94839_0,,,,2,2,1,3
C(CCCC(C(C(C=O)=O)=C)O)=O,,,5,1,1,0,1
94841_0,,,,2,2,1,3
C(CCC(C(C=O)=O)C(C)O)=CC=O,,,5,1,1,0,1
94843_0,,,,2,2,1,3
C(C(C=C)CC(C(C=O)=O)C(C)O)=O,,,5,1,1,0,1
94845_0,,,,2,2,1,3
C=CC(CC(C(C=O)=O)C(C)O)O,,,5,1,1,0,1
94846_0,,,,2,2,1,3
94847_0,,,,2,2,1,3
94848_0,,,,2,2,1,3
94849_0,,,,2,2,1,3
94850_0,,,,2,2,1,3
94851_0,,,,2,2,1,3
94852_0,,,,2,2,1,3
94854_0,,,,2,2,1,3
C(CCC(C(C(C=O)=O)=CC=O)O)=O,,,5,1,1,0,1
94855_0,,,,2,2,1,3
94856_0,,,,2,2,1,3
94857_0,,,,2,2,1,3
94858_0,,,,2,2,1,3
94859_0,,,,2,2,1,3
94861_0,,,,2,2,1,3
C(CC(C(C=O)=O)(CO)CC=O)=O,,,5,1,1,0,1
94862_0,,,,2,2,1,3
94864_0,,,,2,2,1,3
C(CC(C(C=O)=O)(CO)CCO)=O,,,5,1,1,0,1
94866_0,,,,2,2,1,3
C(C(C(C(C=O)=O)=C)(CCC=O)O)=O,,,5,1,1,0,1
94867_0,,,,2,2,1,3
94868_0,,,,2,2,1,3
94869_0,,,,2,2,1,3
94870_0,,,,2,2,1,3
94872_0,,,,2,2,1,3
C(CC(C)C(C(C(C=O)=O)=C)O)=O,,,5,1,1,0,1
94874_0,,,,2,2,1,3
C(CCC(C(C(C=O)=O)=C)O)=O,,,5,1,1,0,1
94876_0,,,,2,2,1,3
C1(CC(CO1)C(C(C(C=O)=O)=C)O)=O,,,5,1,1,0,1
94878_0,,,,2,2,1,3
C=C(C(C=O)=O)C(CCC(C=O)=O)O,,,5,1,1,0,1
94879_0,,,,2,2,1,3
94881_0,,,,2,2,1,3
C(CCC(C(C(C=O)=O)=C)O)(O)=O,,,5,1,1,0,1
94883_0,,,,2,2,1,3
C(CCC(C(C=O)=O)CO)=CC=O,,,5,1,1,0,1
94885_0,,,,2,2,1,3
C(C(C=C)CC(C(C=O)=O)CO)=O,,,5,1,1,0,1
94887_0,,,,2,2,1,3
C1C(CC(C(C=O)=O)CO)OC(C=1)=O,,,5,1,1,0,1
94889_0,,,,2,2,1,3
C1OC(C(C=1)=O)CC(C(C=O)=O)CO,,,5,1,1,0,1
94891_0,,,,2,2,1,3
C=CC(CC(C(C=O)=O)CO)O,,,5,1,1,0,1
94892_0,,,,2,2,1,3
94893_0,,,,2,2,1,3
94894_0,,,,2,2,1,3
94895_0,,,,2,2,1,3
94896_0,,,,2,2,1,3
94897_0,,,,2,2,1,3
94898_0,,,,2,2,1,3
94899_0,,,,2,2,1,3
94900_0,,,,2,2,1,3
94901_0,,,,2,2,1,3
94902_0,,,,2,2,1,3
94903_0,,,,2,2,1,3
94904_0,,,,2,2,1,3
94905_0,,,,2,2,1,3
94906_0,,,,2,2,1,3
94907_0,,,,2,2,1,3
94908_0,,,,2,2,1,3
94909_0,,,,2,2,1,3
94910_0,,,,2,2,1,3
94911_0,,,,2,2,1,3
94913_0,,,,2,2,1,3
C(C(C(CO)C(CO)C(C)O)=O)=O,,,5,1,1,0,1
94915_0,,,,2,2,1,3
C(C(C(CO)C(CO)CCO)=O)=O,,,5,1,1,0,1
94916_0,,,,2,2,1,3
94917_0,,,,2,2,1,3
94918_0,,,,2,2,1,3
94919_0,,,,2,2,1,3
94921_0,,,,2,2,1,3
C(CC(C)C(C=O)(CC=CC=O)O)=O,,,5,1,1,0,1
94923_0,,,,2,2,1,3
C(CCC(C=O)(CC=CC=O)O)=O,,,5,1,1,0,1
94925_0,,,,2,2,1,3
C(CC(C)C(C=CC=O)C(C=O)O)=O,,,5,1,1,0,1
94927_0,,,,2,2,1,3
C(CCC(C=CC=O)C(C=O)O)=O,,,5,1,1,0,1
94929_0,,,,2,2,1,3
C(CC(CC(C=O)O)CC=CC=O)=O,,,5,1,1,0,1
94931_0,,,,2,2,1,3
C(CC(CC(C=O)O)C(C=O)C=C)=O,,,5,1,1,0,1
94933_0,,,,2,2,1,3
C(CC(CC(C=O)O)C(C=C)O)=O,,,5,1,1,0,1
94934_0,,,,2,2,1,3
94936_0,,,,2,2,1,3
C(CC(CC(C=O)O)C(CO)O)=O,,,5,1,2,0,2
94937_0,,,,2,2,1,3
94939_0,,,,2,2,1,3
C(CC(CC(C=O)O)C(C)O)=O,,,5,1,1,0,1
94941_0,,,,2,2,1,3
C(CC(CC(C=O)O)CCO)=O,,,5,1,1,0,1
94943_0,,,,2,2,1,3
C(CC(CC(C=O)O)CC=O)(O)=O,,,5,1,1,0,1
94944_0,,,,2,2,1,3
94946_0,,,,2,2,1,3
C(C(C=CC(C=O)O)C(C)CC=O)=O,,,5,1,1,0,1
94948_0,,,,2,2,1,3
C(C(C=CC(C=O)O)CCC=O)=O,,,5,1,1,0,1
94950_0,,,,2,2,1,3
C(C(C=CCC=O)(C(C)CC=O)O)=O,,,5,1,1,0,1
94952_0,,,,2,2,1,3
C(C(C=CCC=O)(CCC=O)O)=O,,,5,1,1,0,1
94953_0,,,,2,2,1,3
94954_0,,,,2,2,1,3
94956_0,,,,2,2,1,3
C(CC(C)C(C=O)(C=C)C(C=O)O)=O,,,5,1,1,0,1
94958_0,,,,2,2,1,3
C(CCC(C=O)(C=C)C(C=O)O)=O,,,5,1,1,0,1
94960_0,,,,2,2,1,3
C(C(C(C=O)=CCC(C)CC=O)O)=O,,,5,1,1,0,1
94962_0,,,,2,2,1,3
C(C(C(C=O)=CCCCC=O)O)=O,,,5,1,1,0,1
94964_0,,,,2,2,1,3
C(CC(C)C(C=O)(C(C=O)=CC)O)=O,,,5,1,1,0,1
94966_0,,,,2,2,1,3
C(CCC(C=O)(C(C=O)=CC)O)=O,,,5,1,1,0,1
94968_0,,,,2,2,1,3
C(C(C(C)CC=CC=O)C(C=O)O)=O,,,5,1,1,0,1
94970_0,,,,2,2,1,3
C(C(C(C)C(C=O)C=C)C(C=O)O)=O,,,5,1,1,0,1
94972_0,,,,2,2,1,3
C(C(C(C)C(C=C)O)C(C=O)O)=O,,,5,1,1,0,1
94974_0,,,,2,2,1,3
C(C(C(CO)C)C(C=O)O)=O,,,5,1,1,0,1
94976_0,,,,2,2,1,3
C(C(C(C)C(CO)O)C(C=O)O)=O,,,5,1,1,0,1
94978_0,,,,2,2,1,3
C(CC(C)C(C=O)C(C=O)O)=O,,,5,1,2,0,2
94980_0,,,,2,2,1,3
C(C(C(C)C(C)O)C(C=O)O)=O,,,5,1,1,0,1
94982_0,,,,2,2,1,3
C(C(C(C)CCO)C(C=O)O)=O,,,5,1,1,0,1
94984_0,,,,2,2,1,3
C(CC(C)C(C=O)C(C=O)O)(O)=O,,,5,1,1,0,1
94986_0,,,,2,2,1,3
C(C(C(C)C(C=O)C(C=O)O)O)=O,,,5,1,1,0,1
94988_0,,,,2,2,1,3
C(CC(C)C(C(C=O)=CC=O)(C)O)=O,,,5,1,1,0,1
94990_0,,,,2,2,1,3
C(CCC(C(C=O)=CC=O)(C)O)=O,,,5,1,1,0,1
94992_0,,,,2,2,1,3
C(CC(C)CC(C(C=O)=CC=O)O)=O,,,5,1,1,0,1
94994_0,,,,2,2,1,3
C(CCCC(C(C=O)=CC=O)O)=O,,,5,1,1,0,1
94996_0,,,,2,2,1,3
C(C(C(C)O)C(C=O)CC=CC=O)=O,,,5,1,1,0,1
94998_0,,,,2,2,1,3
C(C(C(C)O)C(C=O)C(C=O)C=C)=O,,,5,1,1,0,1
94999_0,,,,2,2,1,3
95000_0,,,,2,2,1,3
95001_0,,,,2,2,1,3
95002_0,,,,2,2,1,3
95003_0,,,,2,2,1,3
95004_0,,,,2,2,1,3
95005_0,,,,2,2,1,3
95006_0,,,,2,2,1,3
95008_0,,,,2,2,1,3
C(C(C(C)O)(CC=O)CC=CC=O)=O,,,5,1,1,0,1
95010_0,,,,2,2,1,3
C(C(C(C)O)(CC=O)C(C=O)C=C)=O,,,5,1,1,0,1
95011_0,,,,2,2,1,3
95012_0,,,,2,2,1,3
95013_0,,,,2,2,1,3
95015_0,,,,2,2,1,3
C(C(C(C)O)(CC=O)CC=O)=O,,,5,1,1,0,1
95016_0,,,,2,2,1,3
95017_0,,,,2,2,1,3
95019_0,,,,2,2,1,3
C(C(C(C)O)(CC(O)=O)CC=O)=O,,,5,1,1,0,1
95020_0,,,,2,2,1,3
95022_0,,,,2,2,1,3
C(C(C(C=O)=CC=O)(CCC=O)O)=O,,,5,1,1,0,1
95023_0,,,,2,2,1,3
95024_0,,,,2,2,1,3
95025_0,,,,2,2,1,3
95026_0,,,,2,2,1,3
95027_0,,,,2,2,1,3
95029_0,,,,2,2,1,3
C(CC(C=O)(CC=O)C(C=O)O)=O,,,5,1,1,0,1
95030_0,,,,2,2,1,3
95031_0,,,,2,2,1,3
95033_0,,,,2,2,1,3
C(CC(C)C(C(C=O)=CC=O)O)=O,,,5,1,1,0,1
95035_0,,,,2,2,1,3
C(CCC(C(C=O)=CC=O)O)=O,,,5,1,1,0,1
95037_0,,,,2,2,1,3
C1(CC(CO1)C(C(C=O)=CC=O)O)=O,,,5,1,1,0,1
95039_0,,,,2,2,1,3
C(C=O)(CCC(C(C=O)=CC=O)O)=O,,,5,1,1,0,1
95040_0,,,,2,2,1,3
95042_0,,,,2,2,1,3
C(CCC(C(C=O)=CC=O)O)(O)=O,,,5,1,1,0,1
95044_0,,,,2,2,1,3
C(C(CO)C(C=O)CC=CC=O)=O,,,5,1,1,0,1
95046_0,,,,2,2,1,3
C(C(CO)C(C=O)C(C=O)C=C)=O,,,5,1,1,0,1
95048_0,,,,2,2,1,3
C(C(CO)C(C=O)C1C=CC(O1)=O)=O,,,5,1,1,0,1
95050_0,,,,2,2,1,3
C(C(CO)C(C=O)C1C(C=CO1)=O)=O,,,5,1,1,0,1
95051_0,,,,2,2,1,3
95052_0,,,,2,2,1,3
95053_0,,,,2,2,1,3
95054_0,,,,2,2,1,3
95055_0,,,,2,2,1,3
95056_0,,,,2,2,1,3
95057_0,,,,2,2,1,3
95058_0,,,,2,2,1,3
95059_0,,,,2,2,1,3
95060_0,,,,2,2,1,3
95061_0,,,,2,2,1,3
95062_0,,,,2,2,1,3
95063_0,,,,2,2,1,3
95064_0,,,,2,2,1,3
95065_0,,,,2,2,1,3
95066_0,,,,2,2,1,3
95067_0,,,,2,2,1,3
95068_0,,,,2,2,1,3
95069_0,,,,2,2,1,3
95071_0,,,,2,2,1,3
C(C(CO)(CC=O)CC=CC=O)=O,,,5,1,1,0,1
95073_0,,,,2,2,1,3
C(C(CO)(CC=O)C(C=O)C=C)=O,,,5,1,1,0,1
95075_0,,,,2,2,1,3
C(CC(C=O)(CO)C1C=CC(O1)=O)=O,,,5,1,1,0,1
95077_0,,,,2,2,1,3
C(CC(C=O)(CO)C1C(C=CO1)=O)=O,,,5,1,1,0,1
95078_0,,,,2,2,1,3
95079_0,,,,2,2,1,3
95080_0,,,,2,2,1,3
95081_0,,,,2,2,1,3
95082_0,,,,2,2,1,3
95083_0,,,,2,2,1,3
95085_0,,,,2,2,1,3
C(C(CO)(CC=O)CC=O)=O,,,5,1,1,0,1
95086_0,,,,2,2,1,3
95088_0,,,,2,2,1,3
C(C(CO)C(C=O)(CO)CC=O)=O,,,5,1,1,0,1
95089_0,,,,2,2,1,3
95091_0,,,,2,2,1,3
C(C(CO)(CC(CO)=O)CC=O)=O,,,5,1,2,0,2
95092_0,,,,2,2,1,3
95093_0,,,,2,2,1,3
95095_0,,,,2,2,1,3
C(C(CO)(CC(O)=O)CC=O)=O,,,5,1,1,0,1
95096_0,,,,2,2,1,3
95097_0,,,,2,2,1,3
95099_0,,,,2,2,1,3
C(C(CO)(CC(C=O)O)CC=O)=O,,,5,1,1,0,1
95100_0,,,,2,2,1,3
95101_0,,,,2,2,1,3
95102_0,,,,2,2,1,3
95103_0,,,,2,2,1,3
95104_0,,,,2,2,1,3
95105_0,,,,2,2,1,3
95106_0,,,,2,2,1,3
95108_0,,,,2,2,1,3
C(C(C(CO)O)(CC=O)CC=O)=O,,,5,1,1,0,1
95109_0,,,,2,2,1,3
95110_0,,,,2,2,1,3
95112_0,,,,2,2,1,3
C(CC(C)C(C(CO)=O)C=CC=O)=O,,,5,1,1,0,1
95114_0,,,,2,2,1,3
C(CCC(C(CO)=O)C=CC=O)=O,,,5,1,1,0,1
95116_0,,,,2,2,1,3
C(CC(C)C(C(CC=CC=O)=O)O)=O,,,5,1,1,0,1
95118_0,,,,2,2,1,3
C(CCC(C(CC=CC=O)=O)O)=O,,,5,1,1,0,1
95120_0,,,,2,2,1,3
C(CC(CC(CO)=O)CC=CC=O)=O,,,5,1,2,0,2
95122_0,,,,2,2,1,3
C(CC(CC(CO)=O)C(C=O)C=C)=O,,,5,1,2,0,2
95124_0,,,,2,2,1,3
C(CC(C(C=C)O)CC(CO)=O)=O,,,5,1,2,0,2
95125_0,,,,2,2,1,3
95127_0,,,,2,2,1,3
C(CC(C(CO)O)CC(CO)=O)=O,,,5,1,3,0,3
95128_0,,,,2,2,1,3
95130_0,,,,2,2,1,3
C(CC(C(C)O)CC(CO)=O)=O,,,5,1,2,0,2
95132_0,,,,2,2,1,3
C(CC(CCO)CC(CO)=O)=O,,,5,1,2,0,2
95134_0,,,,2,2,1,3
C(CC(CC=O)CC(CO)=O)(O)=O,,,5,1,2,0,2
95135_0,,,,2,2,1,3
95137_0,,,,2,2,1,3
C(CC(C)C(C=O)C=CC(CO)=O)=O,,,5,1,1,0,1
95139_0,,,,2,2,1,3
C(CCC(C=O)C=CC(CO)=O)=O,,,5,1,1,0,1
95141_0,,,,2,2,1,3
C(CC(C)C(C(C=CCC=O)=O)O)=O,,,5,1,1,0,1
95143_0,,,,2,2,1,3
C(CCC(C(C=CCC=O)=O)O)=O,,,5,1,1,0,1
95144_0,,,,2,2,1,3
95145_0,,,,2,2,1,3
95146_0,,,,2,2,1,3
95147_0,,,,2,2,1,3
95148_0,,,,2,2,1,3
95149_0,,,,2,2,1,3
95150_0,,,,2,2,1,3
95151_0,,,,2,2,1,3
95152_0,,,,2,2,1,3
95153_0,,,,2,2,1,3
95154_0,,,,2,2,1,3
95155_0,,,,2,2,1,3
95157_0,,,,2,2,1,3
C(C(C(C(C)O)CC(CO)=O)O)=O,,,5,1,1,0,1
95159_0,,,,2,2,1,3
C(C(C(CCO)CC(CO)=O)O)=O,,,5,1,1,0,1
95161_0,,,,2,2,1,3
C(CC(C)C(C=O)C(CO)=CC=O)=O,,,5,1,1,0,1
95163_0,,,,2,2,1,3
C(CCC(C=O)C(CO)=CC=O)=O,,,5,1,1,0,1
95165_0,,,,2,2,1,3
C(CC(C)C(C(CC=O)=CC=O)O)=O,,,5,1,1,0,1
95167_0,,,,2,2,1,3
C(CCC(C(CC=O)=CC=O)O)=O,,,5,1,1,0,1
95169_0,,,,2,2,1,3
C(CC(CO)(CC=O)CC=CC=O)=O,,,5,1,1,0,1
95171_0,,,,2,2,1,3
C(C(C=C)C(CO)(CC=O)CC=O)=O,,,5,1,1,0,1
95173_0,,,,2,2,1,3
C(CC(CO)(C(C=C)O)CC=O)=O,,,5,1,1,0,1
95174_0,,,,2,2,1,3
95175_0,,,,2,2,1,3
95177_0,,,,2,2,1,3
C(CC(CO)(CC=O)CC=O)=O,,,5,1,1,0,1
95179_0,,,,2,2,1,3
C(CC(CO)(C(C)O)CC=O)=O,,,5,1,1,0,1
95181_0,,,,2,2,1,3
C(CC(CO)(CCO)CC=O)=O,,,5,1,1,0,1
95183_0,,,,2,2,1,3
C(CC(CO)(CC=O)CC=O)(O)=O,,,5,1,1,0,1
95185_0,,,,2,2,1,3
C(CC(CO)(C(C=O)O)CC=O)=O,,,5,1,2,0,2
95186_0,,,,2,2,1,3
95187_0,,,,2,2,1,3
95189_0,,,,2,2,1,3
C(CC(CO)(C(C)O)C(C=O)O)=O,,,5,1,1,0,1
95191_0,,,,2,2,1,3
C(CC(CO)(CCO)C(C=O)O)=O,,,5,1,1,0,1
95193_0,,,,2,2,1,3
C(CC(C)C(C=O)(C(CO)=O)C=C)=O,,,5,1,1,0,1
95195_0,,,,2,2,1,3
C(CCC(C=O)(C(CO)=O)C=C)=O,,,5,1,1,0,1
95197_0,,,,2,2,1,3
C(CC(C)C(C(C(C=O)C=C)=O)O)=O,,,5,1,1,0,1
95199_0,,,,2,2,1,3
C(CCC(C(C(C=O)C=C)=O)O)=O,,,5,1,1,0,1
95201_0,,,,2,2,1,3
C(CC(C)CC=C(C=O)C(CO)=O)=O,,,5,1,1,0,1
95203_0,,,,2,2,1,3
C(CCCC=C(C=O)C(CO)=O)=O,,,5,1,1,0,1
95205_0,,,,2,2,1,3
C(CC(C)C(C(C(C=O)=CC)=O)O)=O,,,5,1,1,0,1
95207_0,,,,2,2,1,3
C(CCC(C(C(C=O)=CC)=O)O)=O,,,5,1,1,0,1
95209_0,,,,2,2,1,3
C(C(C(CO)=O)C(C)CC=CC=O)=O,,,5,1,1,0,1
95211_0,,,,2,2,1,3
C(C(C=C)C(C)C(C=O)C(CO)=O)=O,,,5,1,1,0,1
95213_0,,,,2,2,1,3
C(C(C(CO)=O)C(C)C(C=C)O)=O,,,5,1,1,0,1
95215_0,,,,2,2,1,3
C(C(C(CO)=O)C(CO)C)=O,,,5,1,1,0,1
95217_0,,,,2,2,1,3
C(C(C(CO)=O)C(C)C(CO)O)=O,,,5,1,1,0,1
95219_0,,,,2,2,1,3
C(CC(C)C(C=O)C(CO)=O)=O,,,5,1,2,0,2
95221_0,,,,2,2,1,3
C(C(C(CO)=O)C(C)C(C)O)=O,,,5,1,1,0,1
95223_0,,,,2,2,1,3
C(C(C(CO)=O)C(C)CCO)=O,,,5,1,1,0,1
95225_0,,,,2,2,1,3
C(CC(C)C(C=O)C(CO)=O)(O)=O,,,5,1,1,0,1
95227_0,,,,2,2,1,3
C(C(C(C)C(C=O)C(CO)=O)O)=O,,,5,1,1,0,1
95229_0,,,,2,2,1,3
C(CCC(C(C(C=O)=CC=O)=O)O)=O,,,5,1,1,0,1
95230_0,,,,2,2,1,3
95231_0,,,,2,2,1,3
95232_0,,,,2,2,1,3
95233_0,,,,2,2,1,3
95234_0,,,,2,2,1,3
95236_0,,,,2,2,1,3
C(C(C(CO)=O)(CC=O)CC=O)=O,,,5,1,1,0,1
95237_0,,,,2,2,1,3
95239_0,,,,2,2,1,3
C(CO)(C(C=O)(CCO)CC=O)=O,,,5,1,1,0,1
95241_0,,,,2,2,1,3
C(CC(C)C(C(C(C=O)=C)=O)O)=O,,,5,1,1,0,1
95243_0,,,,2,2,1,3
C(CCC(C(C(C=O)=C)=O)O)=O,,,5,1,1,0,1
95245_0,,,,2,2,1,3
C1(CC(CO1)C(C(C(C=O)=C)=O)O)=O,,,5,1,1,0,1
95247_0,,,,2,2,1,3
C=C(C=O)C(C(CCC(C=O)=O)O)=O,,,5,1,1,0,1
95248_0,,,,2,2,1,3
95250_0,,,,2,2,1,3
C(CCC(C(C(C=O)=C)=O)O)(O)=O,,,5,1,1,0,1
95252_0,,,,2,2,1,3
C(C(C(CO)=O)CCC=CC=O)=O,,,5,1,1,0,1
95254_0,,,,2,2,1,3
C(C(C=C)CC(C=O)C(CO)=O)=O,,,5,1,1,0,1
95256_0,,,,2,2,1,3
C(C(C(CO)=O)CC1C=CC(O1)=O)=O,,,5,1,1,0,1
95258_0,,,,2,2,1,3
C(C(C(CO)=O)CC1C(C=CO1)=O)=O,,,5,1,1,0,1
95260_0,,,,2,2,1,3
C(C(C(CO)=O)CC(C=C)O)=O,,,5,1,1,0,1
95261_0,,,,2,2,1,3
95263_0,,,,2,2,1,3
C(C(C(CO)=O)CC(CO)O)=O,,,5,1,1,0,1
95264_0,,,,2,2,1,3
95265_0,,,,2,2,1,3
95266_0,,,,2,2,1,3
95268_0,,,,2,2,1,3
C(CCC(C=O)C(CO)=O)=O,,,5,1,2,0,2
95269_0,,,,2,2,1,3
95271_0,,,,2,2,1,3
C(C(CO)CC(C=O)C(CO)=O)=O,,,5,1,1,0,1
95273_0,,,,2,2,1,3
C(C)(C(CC(C=O)C(CO)=O)O)=O,,,5,1,1,0,1
95274_0,,,,2,2,1,3
95276_0,,,,2,2,1,3
C(C(C(CO)=O)CC(C)O)=O,,,5,1,1,0,1
95278_0,,,,2,2,1,3
C(C(C(CO)=O)CCCO)=O,,,5,1,1,0,1
95279_0,,,,2,2,1,3
95281_0,,,,2,2,1,3
C(C(CC(C=O)C(CO)=O)(O)O)=O,,,5,1,1,0,1
95283_0,,,,2,2,1,3
C(C(C)(CC(C=O)C(CO)=O)O)=O,,,5,1,1,0,1
95285_0,,,,2,2,1,3
C(C(CCC(C=O)C(CO)=O)O)=O,,,5,1,2,0,2
95287_0,,,,2,2,1,3
C(C(C(CO)=O)C[C](C(O)=O)O)=O,,,5,1,1,0,1
95288_0,,,,2,2,1,3
95289_0,,,,2,2,1,3
95290_0,,,,2,2,1,3
95292_0,,,,2,2,1,3
C(C(C(CO)=O)C(CO)C(C)O)=O,,,5,1,1,0,1
95294_0,,,,2,2,1,3
C(C(C(CO)=O)C(CO)CCO)=O,,,5,1,1,0,1
95296_0,,,,2,2,1,3
C(C(C(C(C=C)O)=O)C(C)CC=O)=O,,,5,1,1,0,1
95298_0,,,,2,2,1,3
C(C(C(C(C=C)O)=O)CCC=O)=O,,,5,1,1,0,1
95300_0,,,,2,2,1,3
C(CC=O)(C(C=C)(C(C)CC=O)O)=O,,,5,1,1,0,1
95302_0,,,,2,2,1,3
C(CC=O)(C(C=C)(CCC=O)O)=O,,,5,1,1,0,1
95304_0,,,,2,2,1,3
C(CC(C)C(C(C)=O)(C=CC=O)O)=O,,,5,1,1,0,1
95306_0,,,,2,2,1,3
C(CCC(C(C)=O)(C=CC=O)O)=O,,,5,1,1,0,1
95308_0,,,,2,2,1,3
C(CC(C)CC(C(C=CC=O)O)=O)=O,,,5,1,1,0,1
95310_0,,,,2,2,1,3
C(CCCC(C(C=CC=O)O)=O)=O,,,5,1,1,0,1
95312_0,,,,2,2,1,3
C(CC(C(C(C)=O)O)CC=CC=O)=O,,,5,1,1,0,1
95314_0,,,,2,2,1,3
C(CC(C(C(C)=O)O)C(C=O)C=C)=O,,,5,1,1,0,1
95316_0,,,,2,2,1,3
C(CC(C(C(C)=O)O)C(C=C)O)=O,,,5,1,1,0,1
95317_0,,,,2,2,1,3
95319_0,,,,2,2,1,3
C(CC(C(CO)O)C(C(C)=O)O)=O,,,5,1,2,0,2
95320_0,,,,2,2,1,3
95322_0,,,,2,2,1,3
C(CC(C(C)O)C(C(C)=O)O)=O,,,5,1,1,0,1
95324_0,,,,2,2,1,3
C(CC(CCO)C(C(C)=O)O)=O,,,5,1,1,0,1
95326_0,,,,2,2,1,3
C(CC(C(C(C)=O)O)CC=O)(O)=O,,,5,1,1,0,1
95327_0,,,,2,2,1,3
95329_0,,,,2,2,1,3
C(CC(C)C(C=O)(C(C)=CC=O)O)=O,,,5,1,1,0,1
95331_0,,,,2,2,1,3
C(CCC(C=O)(C(C)=CC=O)O)=O,,,5,1,1,0,1
95333_0,,,,2,2,1,3
C(C(C(CC(C)CC=O)=CC=O)O)=O,,,5,1,1,0,1
95335_0,,,,2,2,1,3
C(C(C(CCCC=O)=CC=O)O)=O,,,5,1,1,0,1
95337_0,,,,2,2,1,3
C(CC(C)(C(C=O)O)CC=CC=O)=O,,,5,1,1,0,1
95339_0,,,,2,2,1,3
C(CC(C)(C(C=O)O)C(C=O)C=C)=O,,,5,1,1,0,1
95341_0,,,,2,2,1,3
C(CC(C)(C(C=O)O)C(C=C)O)=O,,,5,1,1,0,1
95343_0,,,,2,2,1,3
C(CC(CO)(C)C(C=O)O)=O,,,5,1,1,0,1
95345_0,,,,2,2,1,3
C(CC(C)(C(CO)O)C(C=O)O)=O,,,5,1,1,0,1
95347_0,,,,2,2,1,3
C(CC(C)(C(C=O)O)CC=O)=O,,,5,1,1,0,1
95349_0,,,,2,2,1,3
C(CC(C)(C(C)O)C(C=O)O)=O,,,5,1,1,0,1
95351_0,,,,2,2,1,3
C(CC(C)(CCO)C(C=O)O)=O,,,5,1,1,0,1
95353_0,,,,2,2,1,3
C(CC(C)(C(C=O)O)CC=O)(O)=O,,,5,1,1,0,1
95355_0,,,,2,2,1,3
C(CC(C)(C(C=O)O)C(C=O)O)=O,,,5,1,1,0,1
95357_0,,,,2,2,1,3
C(C(C(C(C=O)O)=C)C(C)CC=O)=O,,,5,1,1,0,1
95359_0,,,,2,2,1,3
C(C(C(C(C=O)O)=C)CCC=O)=O,,,5,1,1,0,1
95361_0,,,,2,2,1,3
C(C(C(CC=O)=C)(C(C)CC=O)O)=O,,,5,1,1,0,1
95363_0,,,,2,2,1,3
C(C(C(CC=O)=C)(CCC=O)O)=O,,,5,1,1,0,1
95365_0,,,,2,2,1,3
C(C(C(CC=C)=O)(C(C)CC=O)O)=O,,,5,1,1,0,1
95367_0,,,,2,2,1,3
C(C(C(CC=C)=O)(CCC=O)O)=O,,,5,1,1,0,1
95369_0,,,,2,2,1,3
C(C(C=O)O)(C(C=C)C(C)CC=O)=O,,,5,1,1,0,1
95371_0,,,,2,2,1,3
C(C(C=O)O)(C(C=C)CCC=O)=O,,,5,1,1,0,1
95373_0,,,,2,2,1,3
C(C(C(C=CCC(C)CC=O)=O)O)=O,,,5,1,1,0,1
95375_0,,,,2,2,1,3
C(C(C(C=CCCCC=O)=O)O)=O,,,5,1,1,0,1
95377_0,,,,2,2,1,3
C(CC(C)C(C=O)(C(C=CC)=O)O)=O,,,5,1,1,0,1
95379_0,,,,2,2,1,3
C(CCC(C=O)(C(C=CC)=O)O)=O,,,5,1,1,0,1
95381_0,,,,2,2,1,3
C(C(C(CC(C)CC=CC=O)=O)O)=O,,,5,1,1,0,1
95383_0,,,,2,2,1,3
C(C(C=C)C(C)CC(C(C=O)O)=O)=O,,,5,1,1,0,1
95385_0,,,,2,2,1,3
C(CC(C)C(C=C)O)(C(C=O)O)=O,,,5,1,1,0,1
95387_0,,,,2,2,1,3
C(C(C(CC(CO)C)=O)O)=O,,,5,1,1,0,1
95389_0,,,,2,2,1,3
C(C(C(CC(C)C(CO)O)=O)O)=O,,,5,1,1,0,1
95391_0,,,,2,2,1,3
C(C(C(CC(C)CC=O)=O)O)=O,,,5,1,2,0,2
95393_0,,,,2,2,1,3
C(C(C(CC(C)C(C)O)=O)O)=O,,,5,1,1,0,1
95395_0,,,,2,2,1,3
C(C(C(CC(C)CCO)=O)O)=O,,,5,1,1,0,1
95397_0,,,,2,2,1,3
C(C(C(CC(C)CC(O)=O)=O)O)=O,,,5,1,1,0,1
95399_0,,,,2,2,1,3
C(CC(C)C(C=O)O)(C(C=O)O)=O,,,5,1,1,0,1
95401_0,,,,2,2,1,3
C(C(C(C=CC=O)=O)(CCC=O)O)=O,,,5,1,1,0,1
95402_0,,,,2,2,1,3
95403_0,,,,2,2,1,3
95404_0,,,,2,2,1,3
95405_0,,,,2,2,1,3
95406_0,,,,2,2,1,3
95408_0,,,,2,2,1,3
C(C(C(C(CC=O)CC=O)=O)O)=O,,,5,1,1,0,1
95409_0,,,,2,2,1,3
95411_0,,,,2,2,1,3
C(C(CCO)CC=O)(C(C=O)O)=O,,,5,1,1,0,1
95413_0,,,,2,2,1,3
C(C(C(C=C)=O)(C(C)CC=O)O)=O,,,5,1,1,0,1
95415_0,,,,2,2,1,3
C(C(C(C=C)=O)(CCC=O)O)=O,,,5,1,1,0,1
95417_0,,,,2,2,1,3
C(C(C(C=C)=O)(C1COC(C1)=O)O)=O,,,5,1,1,0,1
95419_0,,,,2,2,1,3
C(C(C(C=C)=O)(CCC(C=O)=O)O)=O,,,5,1,1,0,1
95421_0,,,,2,2,1,3
C(C(C(C=C)=O)(C(C=O)CC=O)O)=O,,,5,1,1,0,1
95423_0,,,,2,2,1,3
C(C(C(C=C)=O)(CCC(O)=O)O)=O,,,5,1,1,0,1
95425_0,,,,2,2,1,3
C(C(C(CCCC=CC=O)=O)O)=O,,,5,1,1,0,1
95427_0,,,,2,2,1,3
C(C(C=C)CCC(C(C=O)O)=O)=O,,,5,1,1,0,1
95429_0,,,,2,2,1,3
C(CCC1C=CC(O1)=O)(C(C=O)O)=O,,,5,1,1,0,1
95431_0,,,,2,2,1,3
C(CCC1C(C=CO1)=O)(C(C=O)O)=O,,,5,1,1,0,1
95433_0,,,,2,2,1,3
C(CCC(C=C)O)(C(C=O)O)=O,,,5,1,1,0,1
95434_0,,,,2,2,1,3
95436_0,,,,2,2,1,3
C(C(C(CCC(CO)O)=O)O)=O,,,5,1,1,0,1
95437_0,,,,2,2,1,3
95438_0,,,,2,2,1,3
95439_0,,,,2,2,1,3
95441_0,,,,2,2,1,3
C(C(C(CCCC=O)=O)O)=O,,,5,1,2,0,2
95442_0,,,,2,2,1,3
95444_0,,,,2,2,1,3
C(C(CO)CCC(C(C=O)O)=O)=O,,,5,1,1,0,1
95446_0,,,,2,2,1,3
C(CCC(C(C)=O)O)(C(C=O)O)=O,,,5,1,1,0,1
95447_0,,,,2,2,1,3
95449_0,,,,2,2,1,3
C(C(C(CCC(C)O)=O)O)=O,,,5,1,1,0,1
95451_0,,,,2,2,1,3
C(C(C(CCCCO)=O)O)=O,,,5,1,1,0,1
95452_0,,,,2,2,1,3
95454_0,,,,2,2,1,3
C(CCC(C=O)(O)O)(C(C=O)O)=O,,,5,1,1,0,1
95456_0,,,,2,2,1,3
C(C(C)(CCC(C(C=O)O)=O)O)=O,,,5,1,1,0,1
95458_0,,,,2,2,1,3
C(CCCC(C=O)O)(C(C=O)O)=O,,,5,1,2,0,2
95460_0,,,,2,2,1,3
C(C(C(CC[C](C(O)=O)O)=O)O)=O,,,5,1,1,0,1
95461_0,,,,2,2,1,3
95462_0,,,,2,2,1,3
95463_0,,,,2,2,1,3
95465_0,,,,2,2,1,3
C(C(C(CC(CO)C(C)O)=O)O)=O,,,5,1,1,0,1
95467_0,,,,2,2,1,3
C(C(C(CC(CO)CCO)=O)O)=O,,,5,1,1,0,1
95469_0,,,,2,2,1,3
C(CC(C)CC=CC=O)=O,,,5,1,1,0,1
95471_0,,,,2,2,1,3
C(CC(C(CO)=O)CC=CC=O)=O,,,5,1,1,0,1
95473_0,,,,2,2,1,3
C(C(CC(CO)=O)CC=CC=O)=O,,,5,1,1,0,1
95475_0,,,,2,2,1,3
C(CC(C(CO)O)CC=CC=O)=O,,,5,1,1,0,1
95477_0,,,,2,2,1,3
C(CCCC=CC=O)=O,,,5,1,1,0,1
95479_0,,,,2,2,1,3
C(C(CCC=CC=O)C(C)O)(O)=O,,,5,1,1,0,1
95481_0,,,,2,2,1,3
C(C(CCC=CC=O)CO)(O)=O,,,5,1,1,0,1
95483_0,,,,2,2,1,3
C(C(C(C=O)=O)CCC=CC=O)=O,,,5,1,1,0,1
95485_0,,,,2,2,1,3
C1(CC(CO1)CC=CC=O)=O,,,5,1,1,0,1
95487_0,,,,2,2,1,3
C(CC(C(O)=O)CC=CC=O)(O)=O,,,5,1,1,0,1
95488_0,,,,2,2,1,3
95489_0,,,,2,2,1,3
95490_0,,,,2,2,1,3
95491_0,,,,2,2,1,3
95493_0,,,,2,2,1,3
C(C(C=C)C(C)CC=O)=O,,,5,1,1,0,1
95495_0,,,,2,2,1,3
C(CC(C)C(C=C)(C(C=O)=O)O)=O,,,5,1,1,0,1
95497_0,,,,2,2,1,3
C(C(C=C)(C(C)CC=O)O)=O,,,5,1,1,0,1
95499_0,,,,2,2,1,3
C(CC(C)C(C(C=CC=O)=O)O)=O,,,5,1,1,0,1
95501_0,,,,2,2,1,3
C(CC(C)C(C=CC=O)(CO)O)=O,,,5,1,1,0,1
95503_0,,,,2,2,1,3
C(CC(C)C(C(C=CC=O)O)O)=O,,,5,1,1,0,1
95505_0,,,,2,2,1,3
C(C(C(CC(C)CC=O)=O)(C=C)O)=O,,,5,1,1,0,1
95507_0,,,,2,2,1,3
C(C(C=C)(C(C(C)CC=O)O)O)=O,,,5,1,1,0,1
95509_0,,,,2,2,1,3
C(CC(C)C(C(C(O)=O)=C)(C)O)=O,,,5,1,1,0,1
95511_0,,,,2,2,1,3
C(CC(C)CC(C(C(O)=O)=C)O)=O,,,5,1,1,0,1
95513_0,,,,2,2,1,3
C(C(C=C)(CC(C)CC=O)O)(O)=O,,,5,1,1,0,1
95515_0,,,,2,2,1,3
C(CC(C)C(C(C(O)=O)=C)O)=O,,,5,1,1,0,1
95517_0,,,,2,2,1,3
C(CC(C)C1C=CC(O1)=O)=O,,,5,1,1,0,1
95519_0,,,,2,2,1,3
C(CC(C)C1C(C=CO1)=O)=O,,,5,1,1,0,1
95521_0,,,,2,2,1,3
C(CC(C)C(C=C)O)=O,,,5,1,1,0,1
95523_0,,,,2,2,1,3
C(CC(C)C1(CC(C(O1)=O)O)O)=O,,,5,1,1,0,1
95525_0,,,,2,2,1,3
C(CC(C)C1C(O)OC(C1O)=O)=O,,,5,1,1,0,1
95527_0,,,,2,2,1,3
C1(C(CC(O)O1)(C(C)CC=O)O)=O,,,5,1,1,0,1
95529_0,,,,2,2,1,3
C(CC(C)C1(C)CC(C(O)O1)=O)=O,,,5,1,1,0,1
95531_0,,,,2,2,1,3
C(CC(C)CC1CC(C(O)O1)=O)=O,,,5,1,1,0,1
95533_0,,,,2,2,1,3
C(CC(C)C1(C(CC(C)O1)=O)O)=O,,,5,1,1,0,1
95535_0,,,,2,2,1,3
C(CC(C)C1C(C(O)OC1C)=O)=O,,,5,1,1,0,1
95537_0,,,,2,2,1,3
C(CC(C)C1C(CC(O)O1)O)=O,,,5,1,1,0,1
95539_0,,,,2,2,1,3
C(CC(C)C1(COC(C1)O)O)=O,,,5,1,1,0,1
95541_0,,,,2,2,1,3
C(CC(C)C1(CC(CO1)O)O)=O,,,5,1,1,0,1
95543_0,,,,2,2,1,3
C(CC(C)C1C(O)OCC1O)=O,,,5,1,1,0,1
95545_0,,,,2,2,1,3
C(CC(C)C1(C(O)OCC1)O)=O,,,5,1,1,0,1
95547_0,,,,2,2,1,3
C(CC(C)C1(C(CCO1)O)O)=O,,,5,1,1,0,1
95549_0,,,,2,2,1,3
C(CC(C)C1CC(C(O)O1)O)=O,,,5,1,1,0,1
95551_0,,,,2,2,1,3
C(CC(C)C1COC(C1O)O)=O,,,5,1,1,0,1
95553_0,,,,2,2,1,3
C1(CC(C(O)O1)(C(C)CC=O)O)=O,,,5,1,1,0,1
95555_0,,,,2,2,1,3
C1(CC(C(C(C)CC=O)(O)O1)O)=O,,,5,1,1,0,1
95557_0,,,,2,2,1,3
C1(C(C(C)CC=O)C(C(O)O1)O)=O,,,5,1,1,0,1
95559_0,,,,2,2,1,3
C(CC(C)C1C(C(C(O1)=O)=O)O)=O,,,5,1,1,0,1
95561_0,,,,2,2,1,3
C(CC(C)C1(C(C(OC1)=O)=O)O)=O,,,5,1,1,0,1
95563_0,,,,2,2,1,3
C(C(CC(C)O)C(C)CC=O)(O)=O,,,5,1,1,0,1
95565_0,,,,2,2,1,3
C(CC(C(C)CC=O)C(C)O)(O)=O,,,5,1,1,0,1
95567_0,,,,2,2,1,3
C(CCC(C)(C(C)CC=O)O)(O)=O,,,5,1,1,0,1
95569_0,,,,2,2,1,3
C(CCC(CC(C)CC=O)O)(O)=O,,,5,1,1,0,1
95571_0,,,,2,2,1,3
C(C(CCCO)C(C)CC=O)(O)=O,,,5,1,1,0,1
95573_0,,,,2,2,1,3
C(CC(CCO)C(C)CC=O)(O)=O,,,5,1,1,0,1
95575_0,,,,2,2,1,3
C(CCCC(C(C)CC=O)O)(O)=O,,,5,1,1,0,1
95577_0,,,,2,2,1,3
C(CCC(CO)C(C)CC=O)(O)=O,,,5,1,1,0,1
95579_0,,,,2,2,1,3
C(CC(C)C(CCC(C=O)=O)O)=O,,,5,1,1,0,1
95581_0,,,,2,2,1,3
C(CC(C)C(CO)CC(C=O)=O)=O,,,5,1,1,0,1
95583_0,,,,2,2,1,3
C(CC(C)C(C(C=O)=O)CCO)=O,,,5,1,1,0,1
95585_0,,,,2,2,1,3
C(C(CCC(C=O)=O)C(C)CC=O)=O,,,5,1,1,0,1
95587_0,,,,2,2,1,3
C(CC(C(C)CC=O)CC(C=O)=O)=O,,,5,1,1,0,1
95589_0,,,,2,2,1,3
C(CC(C)C(C(C=O)=O)CCC=O)=O,,,5,1,1,0,1
95591_0,,,,2,2,1,3
C(CCC(C(C)CC=O)O)(O)=O,,,5,1,1,0,1
95593_0,,,,2,2,1,3
C(C(CCO)C(C)CC=O)(O)=O,,,5,1,1,0,1
95595_0,,,,2,2,1,3
C(CC(CO)C(C)CC=O)(O)=O,,,5,1,1,0,1
95597_0,,,,2,2,1,3
C(C(CCC(O)=O)C(C)CC=O)=O,,,5,1,1,0,1
95599_0,,,,2,2,1,3
C(CC(C)C(C(O)=O)CCC=O)=O,,,5,1,1,0,1
95601_0,,,,2,2,1,3
C(CC(C(C)CC=O)CC(O)=O)=O,,,5,1,1,0,1
95603_0,,,,2,2,1,3
C(C(CC)(C(C)CC=O)O)(O)=O,,,5,1,1,0,1
95605_0,,,,2,2,1,3
C(CC(C)C(C)C(C(O)=O)O)=O,,,5,1,1,0,1
95607_0,,,,2,2,1,3
C(CC(C)CCC(C(O)=O)O)=O,,,5,1,1,0,1
95609_0,,,,2,2,1,3
C(CC(C)C(C)(CC(C=O)O)O)=O,,,5,1,1,0,1
95611_0,,,,2,2,1,3
C(CC(C)CC(CC(C=O)O)O)=O,,,5,1,1,0,1
95613_0,,,,2,2,1,3
C(C(CC(C)O)(C(C)CC=O)O)=O,,,5,1,1,0,1
95615_0,,,,2,2,1,3
C(CC(C)C(C(C)O)C(C=O)O)=O,,,5,1,1,0,1
95617_0,,,,2,2,1,3
C(CC(C)C[C](C(O)=O)O)=O,,,5,1,1,0,1
95619_0,,,,2,2,1,3
C(CC(C)C(C[C](C(O)=O)O)O)=O,,,5,1,1,0,1
95621_0,,,,2,2,1,3
C(CC(C)C([C](C(O)=O)O)CO)=O,,,5,1,1,0,1
95623_0,,,,2,2,1,3
C(C([C](C(O)=O)O)C(C)CC=O)=O,,,5,1,1,0,1
95625_0,,,,2,2,1,3
C(C(CO)(C(C)CC=O)O)=O,,,5,1,1,0,1
95627_0,,,,2,2,1,3
C(CC(C)C(C(C=O)O)O)=O,,,5,1,1,0,1
95629_0,,,,2,2,1,3
C(C(C(CO)O)(C(C)CC=O)O)=O,,,5,1,1,0,1
95631_0,,,,2,2,1,3
C(CC(C)C(C(C(C=O)O)O)O)=O,,,5,1,1,0,1
95633_0,,,,2,2,1,3
C(CC(C)C(CO)(C(C=O)O)O)=O,,,5,1,1,0,1
95635_0,,,,2,2,1,3
C(CC(C)CO)=O,,,5,1,1,0,1
95637_0,,,,2,2,1,3
C(CC(C)C(CO)O)=O,,,5,1,1,0,1
95638_0,,,,2,2,1,3
95639_0,,,,2,2,1,3
95641_0,,,,2,2,1,3
C(CC(C)C(C(CO)=O)O)=O,,,5,1,1,0,1
95643_0,,,,2,2,1,3
C(CC(C)C(C(C(CO)O)=O)O)=O,,,5,1,1,0,1
95645_0,,,,2,2,1,3
C(CC(C)C(C(C(CO)=O)O)O)=O,,,5,1,1,0,1
95647_0,,,,2,2,1,3
C(CC(C)C(C(CO)=O)(CO)O)=O,,,5,1,1,0,1
95649_0,,,,2,2,1,3
C(CC(C)C(CO)(CO)O)=O,,,5,1,1,0,1
95651_0,,,,2,2,1,3
C(CC(C)C(C(CO)O)O)=O,,,5,1,1,0,1
95653_0,,,,2,2,1,3
C(CC(C)C(CO)(C(CO)O)O)=O,,,5,1,1,0,1
95655_0,,,,2,2,1,3
C(CC(C)C(C(C(CO)O)O)O)=O,,,5,1,1,0,1
95657_0,,,,2,2,1,3
C(C(CO)(C(C)CC=O)O)(O)=O,,,5,1,1,0,1
95659_0,,,,2,2,1,3
C(CC(C)C(C(C(O)=O)O)O)=O,,,5,1,1,0,1
95661_0,,,,2,2,1,3
C(C(CO)(C(C(C)CC=O)O)O)=O,,,5,1,1,0,1
95662_0,,,,2,2,1,3
95663_0,,,,2,2,1,3
95665_0,,,,2,2,1,3
C(CC(C)C(CC(C=O)=O)O)=O,,,5,1,1,0,1
95666_0,,,,2,2,1,3
95667_0,,,,2,2,1,3
95668_0,,,,2,2,1,3
95669_0,,,,2,2,1,3
95671_0,,,,2,2,1,3
C(CC(C)C(C(CC=O)=O)O)=O,,,5,1,1,0,1
95673_0,,,,2,2,1,3
C(CC(C)C(C=O)(C(C)=O)O)=O,,,5,1,1,0,1
95674_0,,,,2,2,1,3
95676_0,,,,2,2,1,3
C(CC(C)CC=O)=O,,,5,1,1,0,1
95678_0,,,,2,2,1,3
C(CC(C)C1(C(O)OCC1O)O)=O,,,5,1,1,0,1
95680_0,,,,2,2,1,3
C(CC(C)C1(C(C(CO1)O)O)O)=O,,,5,1,1,0,1
95682_0,,,,2,2,1,3
C(CC(C)C1C(C(C(O)O1)O)O)=O,,,5,1,1,0,1
95684_0,,,,2,2,1,3
C(CC(C)C1(COC(C1O)O)O)=O,,,5,1,1,0,1
95686_0,,,,2,2,1,3
C(C(C)(C(C)CC=O)O)(O)=O,,,5,1,1,0,1
95688_0,,,,2,2,1,3
C(CC(C)CC(C(O)=O)O)=O,,,5,1,1,0,1
95690_0,,,,2,2,1,3
C(C(CCO)(C(C)CC=O)O)(O)=O,,,5,1,1,0,1
95692_0,,,,2,2,1,3
C(CC(C)C(CC(C(O)=O)O)O)=O,,,5,1,1,0,1
95694_0,,,,2,2,1,3
C(CC(C)C(CO)C(C(O)=O)O)=O,,,5,1,1,0,1
95696_0,,,,2,2,1,3
C(CC(C)C(C(C=O)=O)O)=O,,,5,1,1,0,1
95698_0,,,,2,2,1,3
C(CC(C)C(C(C(C=O)=O)O)O)=O,,,5,1,1,0,1
95700_0,,,,2,2,1,3
C(CC(C)C(C(C=O)=O)(CO)O)=O,,,5,1,1,0,1
95702_0,,,,2,2,1,3
C(CC(C)C(C=O)C(C(O)=O)O)=O,,,5,1,1,0,1
95704_0,,,,2,2,1,3
C(C(C(C)CC=O)(CC=O)O)(O)=O,,,5,1,1,0,1
95706_0,,,,2,2,1,3
C(CC(C)C(C=O)C(C=O)(C)O)=O,,,5,1,1,0,1
95708_0,,,,2,2,1,3
C(CC(C)CC(C=O)(CC=O)O)=O,,,5,1,1,0,1
95710_0,,,,2,2,1,3
C(CC(C)C(C=O)C(C(C)=O)O)=O,,,5,1,1,0,1
95712_0,,,,2,2,1,3
C(C)(C(C(C)CC=O)(CC=O)O)=O,,,5,1,1,0,1
95714_0,,,,2,2,1,3
C(CC(C(CC(C)CC=O)=O)O)=O,,,5,1,1,0,1
95716_0,,,,2,2,1,3
C(CC(C)C(C)(CC(C=O)=O)O)=O,,,5,1,1,0,1
95718_0,,,,2,2,1,3
C(CC(C)CC(CC(C=O)=O)O)=O,,,5,1,1,0,1
95720_0,,,,2,2,1,3
C(CC(C)C(C(C=O)=O)C(C)O)=O,,,5,1,1,0,1
95722_0,,,,2,2,1,3
C(C(C(CC=O)O)C(C)CC=O)=O,,,5,1,1,0,1
95724_0,,,,2,2,1,3
C(CC(C(C)CC=O)(CC=O)O)=O,,,5,1,1,0,1
95726_0,,,,2,2,1,3
C(C(C=O)C(C)(C(C)CC=O)O)=O,,,5,1,1,0,1
95728_0,,,,2,2,1,3
C(C(C=O)C(CC(C)CC=O)O)=O,,,5,1,1,0,1
95730_0,,,,2,2,1,3
C(C(C=O)(C(C)CC=O)C(C)O)=O,,,5,1,1,0,1
95732_0,,,,2,2,1,3
C(C(C=O)C(C(C)CC=O)O)=O,,,5,1,1,0,1
95734_0,,,,2,2,1,3
C(C(C=O)(CO)C(C)CC=O)=O,,,5,1,1,0,1
95736_0,,,,2,2,1,3
C(C(C(C)CC=O)C(C)O)=O,,,5,1,1,0,1
95738_0,,,,2,2,1,3
C(CC(C)(C(C)CC=O)O)=O,,,5,1,1,0,1
95740_0,,,,2,2,1,3
C(CC(C)CC(CC=O)O)=O,,,5,1,1,0,1
95742_0,,,,2,2,1,3
C(C(C(C)O)(C(C)CC=O)O)=O,,,5,1,1,0,1
95744_0,,,,2,2,1,3
C(CC(C)C(C)(C(C=O)O)O)=O,,,5,1,1,0,1
95746_0,,,,2,2,1,3
C(CC(C)CC(C(C=O)O)O)=O,,,5,1,1,0,1
95748_0,,,,2,2,1,3
C(CC(C(C)CC=O)O)=O,,,5,1,1,0,1
95750_0,,,,2,2,1,3
C(C(CO)C(C)CC=O)=O,,,5,1,1,0,1
95752_0,,,,2,2,1,3
C(CC(C(C(C)CC=O)O)O)=O,,,5,1,1,0,1
95754_0,,,,2,2,1,3
C(CC(CO)(C(C)CC=O)O)=O,,,5,1,1,0,1
95756_0,,,,2,2,1,3
C(C(C(C)CC=O)C(CO)O)=O,,,5,1,1,0,1
95758_0,,,,2,2,1,3
C(C(C(C=O)=O)(C(C)CC=O)O)=O,,,5,1,1,0,1
95760_0,,,,2,2,1,3
C(CC(C)C(C(C(C=O)O)=O)O)=O,,,5,1,1,0,1
95762_0,,,,2,2,1,3
C(CC(C)C(C=O)(C(CO)=O)O)=O,,,5,1,1,0,1
95764_0,,,,2,2,1,3
C(CC(C)C(C(C(C)=O)=O)O)=O,,,5,1,1,0,1
95766_0,,,,2,2,1,3
C(CC(C)CC(C(CO)=O)=O)=O,,,5,1,1,0,1
95768_0,,,,2,2,1,3
C(CC(C)CC(C(C=O)=O)O)=O,,,5,1,1,0,1
95770_0,,,,2,2,1,3
C(CC(C)C(C(C=O)=O)(C)O)=O,,,5,1,1,0,1
95772_0,,,,2,2,1,3
C(C(C=O)(C(C)CC=O)O)=O,,,5,1,1,0,1
95774_0,,,,2,2,1,3
C(CC(C)C(C(CO)(CO)O)O)=O,,,5,1,1,0,1
95776_0,,,,2,2,1,3
C(CC(C)C(C(C)=O)O)=O,,,5,1,1,0,1
95778_0,,,,2,2,1,3
C(CC(C)CC(CO)=O)=O,,,5,1,1,0,1
95780_0,,,,2,2,1,3
C(CC(C)C(C(CCO)=O)O)=O,,,5,1,1,0,1
95782_0,,,,2,2,1,3
C(CC(C)C(CC(CO)=O)O)=O,,,5,1,1,0,1
95784_0,,,,2,2,1,3
C(CC(C)C(C(CO)=O)CO)=O,,,5,1,1,0,1
95786_0,,,,2,2,1,3
C(C(CCO)(C(C)CC=O)O)=O,,,5,1,1,0,1
95788_0,,,,2,2,1,3
C(CC(C)C(CC(C=O)O)O)=O,,,5,1,1,0,1
95790_0,,,,2,2,1,3
C(CC(C)C(CO)C(C=O)O)=O,,,5,1,1,0,1
95792_0,,,,2,2,1,3
C(CC(C)C(C(C)=O)(CO)O)=O,,,5,1,1,0,1
95794_0,,,,2,2,1,3
C(CC(C)C(C(C(C)=O)O)O)=O,,,5,1,1,0,1
95796_0,,,,2,2,1,3
C(CC(C)CC(C(CO)O)=O)=O,,,5,1,1,0,1
95798_0,,,,2,2,1,3
C(CC(C)C(C)O)=O,,,5,1,1,0,1
95800_0,,,,2,2,1,3
C(CC(C)CCO)=O,,,5,1,1,0,1
95802_0,,,,2,2,1,3
C(CC(C)CC(C(O)=O)=O)=O,,,5,1,1,0,1
95804_0,,,,2,2,1,3
C(C(C(O)=O)C(C)CC=O)=O,,,5,1,1,0,1
95806_0,,,,2,2,1,3
C(CC(C)C(CC(C(O)=O)=O)O)=O,,,5,1,1,0,1
95808_0,,,,2,2,1,3
C(CC(C)C(C(C(O)=O)=O)CO)=O,,,5,1,1,0,1
95810_0,,,,2,2,1,3
C(CC(C)C(C=O)(CC(O)=O)O)=O,,,5,1,1,0,1
95812_0,,,,2,2,1,3
C(C(C(C)CC=O)C(C=O)O)(O)=O,,,5,1,1,0,1
95814_0,,,,2,2,1,3
C(CC(C)C(C(O)=O)C(CO)=O)=O,,,5,1,1,0,1
95816_0,,,,2,2,1,3
C(CC(C)C(C(CC(O)=O)=O)O)=O,,,5,1,1,0,1
95818_0,,,,2,2,1,3
C(CC(C)C(C(O)=O)(C(C)=O)O)=O,,,5,1,1,0,1
95820_0,,,,2,2,1,3
C(C(C(CC(C)CC=O)=O)O)(O)=O,,,5,1,1,0,1
95822_0,,,,2,2,1,3
C(CC(C)CC(O)=O)=O,,,5,1,1,0,1
95824_0,,,,2,2,1,3
C(CC(C)C(C(C(O)=O)=O)O)=O,,,5,1,1,0,1
95826_0,,,,2,2,1,3
C(C(C(C)O)(C(C)CC=O)O)(O)=O,,,5,1,1,0,1
95828_0,,,,2,2,1,3
C(CC(C)C(C)(C(C(O)=O)O)O)=O,,,5,1,1,0,1
95830_0,,,,2,2,1,3
C(CC(C)CC(C(C(O)=O)O)O)=O,,,5,1,1,0,1
95832_0,,,,2,2,1,3
C(C(C)(C(C(C)CC=O)O)O)(O)=O,,,5,1,1,0,1
95834_0,,,,2,2,1,3
C(C(CO)(CC(C)CC=O)O)(O)=O,,,5,1,1,0,1
95836_0,,,,2,2,1,3
C(C(C(C=O)=O)C(C)CC=O)=O,,,5,1,1,0,1
95838_0,,,,2,2,1,3
C(CC(C)C(C(O)=O)C(C=O)=O)=O,,,5,1,1,0,1
95840_0,,,,2,2,1,3
C(C(C(C(O)=O)=O)C(C)CC=O)=O,,,5,1,1,0,1
95842_0,,,,2,2,1,3
C(CC(C)C1C(C(CO1)O)=O)=O,,,5,1,1,0,1
95844_0,,,,2,2,1,3
C(CC(C)C1C(C(CO1)=O)O)=O,,,5,1,1,0,1
95846_0,,,,2,2,1,3
C(CC(C)C1(C(COC1)=O)O)=O,,,5,1,1,0,1
95848_0,,,,2,2,1,3
C(CC(C)C1(C(CCO1)=O)O)=O,,,5,1,1,0,1
95850_0,,,,2,2,1,3
C(CC(C)C1CC(C(O)O1)=O)=O,,,5,1,1,0,1
95852_0,,,,2,2,1,3
C(CC(C)C1C(C(O)OC1)=O)=O,,,5,1,1,0,1
95854_0,,,,2,2,1,3
C1(C(C(C)CC=O)C(CO1)O)=O,,,5,1,1,0,1
95856_0,,,,2,2,1,3
C1(CC(C(C(C)CC=O)O1)O)=O,,,5,1,1,0,1
95858_0,,,,2,2,1,3
C1(CC(CO1)(C(C)CC=O)O)=O,,,5,1,1,0,1
95860_0,,,,2,2,1,3
C(CC(C)C1C(COC1O)=O)=O,,,5,1,1,0,1
95862_0,,,,2,2,1,3
C(CC(C)C1(CC(CO1)=O)O)=O,,,5,1,1,0,1
95864_0,,,,2,2,1,3
C(CC(C)C1C(CC(O1)O)=O)=O,,,5,1,1,0,1
95866_0,,,,2,2,1,3
C(CC(C)CC(C(C=O)=O)=O)=O,,,5,1,1,0,1
95868_0,,,,2,2,1,3
C(CC(C)C(C=CC(O)=O)O)=O,,,5,1,1,0,1
95870_0,,,,2,2,1,3
C(C(C=C)(C(C)CC=O)O)(O)=O,,,5,1,1,0,1
95872_0,,,,2,2,1,3
C(CC(C)C1(C(C(CO1)O)=O)O)=O,,,5,1,1,0,1
95874_0,,,,2,2,1,3
C(CC(C)C1C(C(C(O)O1)=O)O)=O,,,5,1,1,0,1
95876_0,,,,2,2,1,3
C(CC(C)C1(C(C(O)OC1)=O)O)=O,,,5,1,1,0,1
95878_0,,,,2,2,1,3
C1(C(C(CO1)O)(C(C)CC=O)O)=O,,,5,1,1,0,1
95880_0,,,,2,2,1,3
C(CC(C)C1C(C(C(O1)=O)O)O)=O,,,5,1,1,0,1
95882_0,,,,2,2,1,3
C(CC(C)C1(COC(C1O)=O)O)=O,,,5,1,1,0,1
95884_0,,,,2,2,1,3
C1(C(CCO1)(C(C)CC=O)O)=O,,,5,1,1,0,1
95886_0,,,,2,2,1,3
C(CC(C)C1CC(C(O1)=O)O)=O,,,5,1,1,0,1
95888_0,,,,2,2,1,3
C(CC(C)C1COC(C1O)=O)=O,,,5,1,1,0,1
95890_0,,,,2,2,1,3
C(CC(C)C(C=O)(O)O)=O,,,5,1,1,0,1
95892_0,,,,2,2,1,3
C(C(C)(C(C)CC=O)O)=O,,,5,1,1,0,1
95894_0,,,,2,2,1,3
C(CC(C)CC(C=O)O)=O,,,5,1,1,0,1
95896_0,,,,2,2,1,3
C(CC([C](C(O)=O)O)C)=O,,,5,1,1,0,1
95898_0,,,,2,2,1,3
C(CC(C)C(C=O)O)=O,,,5,1,2,0,2
95900_0,,,,2,2,1,3
C(C(C=C)C(C(CO)=O)CC=O)=O,,,5,1,1,0,1
95902_0,,,,2,2,1,3
C(C(C=C)C(C=O)CC(CO)=O)=O,,,5,1,1,0,1
95904_0,,,,2,2,1,3
C(C(C=C)C(C(CO)O)CC=O)=O,,,5,1,1,0,1
95906_0,,,,2,2,1,3
C(C(C=C)CCC=O)=O,,,5,1,1,0,1
95908_0,,,,2,2,1,3
C(C(C=C)CC(C(O)=O)C(C)O)=O,,,5,1,1,0,1
95910_0,,,,2,2,1,3
C(C(C=C)CC(C(O)=O)CO)=O,,,5,1,1,0,1
95912_0,,,,2,2,1,3
C(C(C=C)CC(C=O)C(C=O)=O)=O,,,5,1,1,0,1
95914_0,,,,2,2,1,3
C(C(C=C)C1COC(C1)=O)=O,,,5,1,1,0,1
95916_0,,,,2,2,1,3
C(C(C=C)C(C(O)=O)CC(O)=O)=O,,,5,1,1,0,1
95917_0,,,,2,2,1,3
95918_0,,,,2,2,1,3
95919_0,,,,2,2,1,3
95920_0,,,,2,2,1,3
95922_0,,,,2,2,1,3
C(CCC(C=C)(C(C=O)=O)O)=O,,,5,1,1,0,1
95924_0,,,,2,2,1,3
C1(CC(CO1)C(C=C)(C(C=O)=O)O)=O,,,5,1,1,0,1
95926_0,,,,2,2,1,3
C=CC(C(C=O)=O)(CCC(C=O)=O)O,,,5,1,1,0,1
95928_0,,,,2,2,1,3
C(CC(C=O)C(C=C)(C(C=O)=O)O)=O,,,5,1,1,0,1
95930_0,,,,2,2,1,3
C(CCC(C=C)(C(C=O)=O)O)(O)=O,,,5,1,1,0,1
95932_0,,,,2,2,1,3
C(C(C=C)(CCC=O)O)=O,,,5,1,1,0,1
95934_0,,,,2,2,1,3
C(C(C=C)(CC(C(O)=O)CO)O)=O,,,5,1,1,0,1
95936_0,,,,2,2,1,3
C(C(C(C=O)=O)CC(C=O)(C=C)O)=O,,,5,1,1,0,1
95938_0,,,,2,2,1,3
C(C(C=C)(C1COC(C1)=O)O)=O,,,5,1,1,0,1
95939_0,,,,2,2,1,3
95940_0,,,,2,2,1,3
95941_0,,,,2,2,1,3
95943_0,,,,2,2,1,3
C(C(C=C)(C(CO)CC(O)=O)O)=O,,,5,1,1,0,1
95945_0,,,,2,2,1,3
C(CCC(C(C=CC=O)=O)O)=O,,,5,1,1,0,1
95947_0,,,,2,2,1,3
C1(CC(CO1)C(C(C=CC=O)=O)O)=O,,,5,1,1,0,1
95949_0,,,,2,2,1,3
C(C=O)(CCC(C(C=CC=O)=O)O)=O,,,5,1,1,0,1
95950_0,,,,2,2,1,3
95952_0,,,,2,2,1,3
C(CCC(C(C=CC=O)=O)O)(O)=O,,,5,1,1,0,1
95954_0,,,,2,2,1,3
C(CC(C(CO)=O)C1C=CC(O1)=O)=O,,,5,1,1,0,1
95956_0,,,,2,2,1,3
C(CC(C(CO)=O)C1C(C=CO1)=O)=O,,,5,1,1,0,1
95957_0,,,,2,2,1,3
95958_0,,,,2,2,1,3
95959_0,,,,2,2,1,3
95960_0,,,,2,2,1,3
95961_0,,,,2,2,1,3
95962_0,,,,2,2,1,3
95963_0,,,,2,2,1,3
95964_0,,,,2,2,1,3
95966_0,,,,2,2,1,3
C(CC(C(CO)=O)C(C=O)CO)=O,,,5,1,2,0,2
95967_0,,,,2,2,1,3
95969_0,,,,2,2,1,3
C(CC(C(CO)=O)CC(CO)=O)=O,,,5,1,1,0,1
95970_0,,,,2,2,1,3
95972_0,,,,2,2,1,3
C(CO)(C(CCO)CC=O)=O,,,5,1,1,0,1
95973_0,,,,2,2,1,3
95975_0,,,,2,2,1,3
C(CC(C(CO)=O)C(C=O)(O)O)=O,,,5,1,1,0,1
95976_0,,,,2,2,1,3
95978_0,,,,2,2,1,3
C(CO)(C(CC(C=O)O)CC=O)=O,,,5,1,1,0,1
95980_0,,,,2,2,1,3
C(CC(C(CO)=O)[C](C(O)=O)O)=O,,,5,1,1,0,1
95981_0,,,,2,2,1,3
95983_0,,,,2,2,1,3
C(C(CC(CO)=O)C1C=CC(O1)=O)=O,,,5,1,1,0,1
95985_0,,,,2,2,1,3
C(C(CC(CO)=O)C1C(C=CO1)=O)=O,,,5,1,1,0,1
95986_0,,,,2,2,1,3
95987_0,,,,2,2,1,3
95988_0,,,,2,2,1,3
95989_0,,,,2,2,1,3
95990_0,,,,2,2,1,3
95991_0,,,,2,2,1,3
95992_0,,,,2,2,1,3
95993_0,,,,2,2,1,3
95994_0,,,,2,2,1,3
95995_0,,,,2,2,1,3
95997_0,,,,2,2,1,3
C(C(CC(CO)=O)CC(CO)=O)=O,,,5,1,1,0,1
95998_0,,,,2,2,1,3
95999_0,,,,2,2,1,3
96000_0,,,,2,2,1,3
96002_0,,,,2,2,1,3
C(C(C(C=O)CC(CO)=O)(O)O)=O,,,5,1,1,0,1
96003_0,,,,2,2,1,3
96005_0,,,,2,2,1,3
C(C(CC(C=O)CC(CO)=O)O)=O,,,5,1,1,0,1
96007_0,,,,2,2,1,3
C(C([C](C(O)=O)O)CC(CO)=O)=O,,,5,1,1,0,1
96008_0,,,,2,2,1,3
96009_0,,,,2,2,1,3
96011_0,,,,2,2,1,3
C(CC(C(C(CO)O)=O)CC=O)=O,,,5,1,1,0,1
96012_0,,,,2,2,1,3
96014_0,,,,2,2,1,3
C(C(CCO)CC=O)(C(CO)O)=O,,,5,1,1,0,1
96015_0,,,,2,2,1,3
96016_0,,,,2,2,1,3
96017_0,,,,2,2,1,3
96018_0,,,,2,2,1,3
96020_0,,,,2,2,1,3
C(CCC(C=CC=O)(CO)O)=O,,,5,1,1,0,1
96022_0,,,,2,2,1,3
C(CCC(C=CC=O)(CO)O)(O)=O,,,5,1,1,0,1
96024_0,,,,2,2,1,3
C(CCC(C(C=CC=O)O)O)=O,,,5,1,1,0,1
96026_0,,,,2,2,1,3
C(CCC(C(C=CC=O)O)O)(O)=O,,,5,1,1,0,1
96028_0,,,,2,2,1,3
C(CC(C(CO)O)C(C=C)O)=O,,,5,1,1,0,1
96029_0,,,,2,2,1,3
96031_0,,,,2,2,1,3
C(CC(C(CO)O)C(CO)O)=O,,,5,1,1,0,1
96033_0,,,,2,2,1,3
C(CC(C(CO)O)C(C(O)=O)O)=O,,,5,1,2,0,2
96034_0,,,,2,2,1,3
96035_0,,,,2,2,1,3
96036_0,,,,2,2,1,3
96037_0,,,,2,2,1,3
96039_0,,,,2,2,1,3
C(C(CO)C(C(CO)O)CC=O)=O,,,5,1,1,0,1
96040_0,,,,2,2,1,3
96041_0,,,,2,2,1,3
96043_0,,,,2,2,1,3
C(CC(C(CO)O)C(C)O)=O,,,5,1,1,0,1
96045_0,,,,2,2,1,3
C(CC(CCO)C(CO)O)=O,,,5,1,1,0,1
96047_0,,,,2,2,1,3
C(CC(C(CO)O)CC=O)(O)=O,,,5,1,2,0,2
96049_0,,,,2,2,1,3
C(CC(C(CO)O)C(C=O)(O)O)=O,,,5,1,1,0,1
96051_0,,,,2,2,1,3
C(C(C)(C(C(CO)O)CC=O)O)=O,,,5,1,1,0,1
96052_0,,,,2,2,1,3
96054_0,,,,2,2,1,3
C(CC([C](C(O)=O)O)C(CO)O)=O,,,5,1,1,0,1
96055_0,,,,2,2,1,3
96056_0,,,,2,2,1,3
96057_0,,,,2,2,1,3
96059_0,,,,2,2,1,3
C(CC(C(C(CO)O)O)C(C)O)=O,,,5,1,1,0,1
96061_0,,,,2,2,1,3
C(CC(CCO)C(C(CO)O)O)=O,,,5,1,1,0,1
96063_0,,,,2,2,1,3
C(C(C(CCCC=O)=O)(C=C)O)=O,,,5,1,1,0,1
96064_0,,,,2,2,1,3
96066_0,,,,2,2,1,3
C(C(C(C=O)=C)(CCC=O)O)(O)=O,,,5,1,1,0,1
96068_0,,,,2,2,1,3
C(C(C=CC=O)(CCC=O)O)(O)=O,,,5,1,1,0,1
96070_0,,,,2,2,1,3
C(CCC(C(C(O)=O)=C)(C)O)=O,,,5,1,1,0,1
96072_0,,,,2,2,1,3
C(CCCC(C(C(O)=O)=C)O)=O,,,5,1,1,0,1
96074_0,,,,2,2,1,3
C(C(C=C)(CCCC=O)O)(O)=O,,,5,1,1,0,1
96076_0,,,,2,2,1,3
C(C(C(C(O)=O)=C)(CCC=O)O)=O,,,5,1,1,0,1
96078_0,,,,2,2,1,3
C(CCC(C(C(O)=O)=C)O)=O,,,5,1,1,0,1
96080_0,,,,2,2,1,3
C(CCC(C(C(C(O)=O)=C)O)O)=O,,,5,1,1,0,1
96082_0,,,,2,2,1,3
C(CCC(C(C(O)=O)=C)(CO)O)=O,,,5,1,1,0,1
96084_0,,,,2,2,1,3
C(CCC(C(C(O)=O)=CCO)O)=O,,,5,1,1,0,1
96086_0,,,,2,2,1,3
C(CCC(C=C(C(O)=O)CO)O)=O,,,5,1,1,0,1
96088_0,,,,2,2,1,3
C(CCC(C=C(C=O)C(C=O)=O)O)=O,,,5,1,1,0,1
96090_0,,,,2,2,1,3
C(CCC(C=CC(C(O)=O)=O)O)=O,,,5,1,1,0,1
96092_0,,,,2,2,1,3
C(CCC(C(C=CC(O)=O)=O)O)=O,,,5,1,1,0,1
96094_0,,,,2,2,1,3
C(C(C(C=C)=O)(CCC=O)O)(O)=O,,,5,1,1,0,1
96096_0,,,,2,2,1,3
C(CCC1C=CC(O1)=O)=O,,,5,1,1,0,1
96098_0,,,,2,2,1,3
C(CCC1C(C=CO1)=O)=O,,,5,1,1,0,1
96100_0,,,,2,2,1,3
C(CCC(C=CC(O)=O)(CO)O)=O,,,5,1,1,0,1
96102_0,,,,2,2,1,3
C(CCC(C(C=CC(O)=O)O)O)=O,,,5,1,1,0,1
96104_0,,,,2,2,1,3
C(CCC(C(O)=O)(C=CCO)O)=O,,,5,1,1,0,1
96106_0,,,,2,2,1,3
C(CCC(C=CC(C(O)=O)O)O)=O,,,5,1,1,0,1
96108_0,,,,2,2,1,3
C(CCC(C=C)O)=O,,,5,1,1,0,1
96110_0,,,,2,2,1,3
C(CCC1(CC(CO1)(CO)O)O)=O,,,5,1,1,0,1
96112_0,,,,2,2,1,3
C(CCC1C(O)OCC1(CO)O)=O,,,5,1,1,0,1
96114_0,,,,2,2,1,3
C(CCC1C(CO)(CC(O)O1)O)=O,,,5,1,1,0,1
96116_0,,,,2,2,1,3
C(CCC(C1(COC(C1)O)O)O)=O,,,5,1,1,0,1
96118_0,,,,2,2,1,3
C(CCC1(CC(C(O1)=O)O)O)=O,,,5,1,1,0,1
96120_0,,,,2,2,1,3
C(CCC1C(O)OC(C1O)=O)=O,,,5,1,1,0,1
96122_0,,,,2,2,1,3
C1(C(CCC=O)(CC(O)O1)O)=O,,,5,1,1,0,1
96124_0,,,,2,2,1,3
C(CCC1(C)CC(C(O)O1)=O)=O,,,5,1,1,0,1
96126_0,,,,2,2,1,3
C(CCCC1CC(C(O)O1)=O)=O,,,5,1,1,0,1
96128_0,,,,2,2,1,3
C(CCC1(C(CC(C)O1)=O)O)=O,,,5,1,1,0,1
96130_0,,,,2,2,1,3
C(CCC1C(C(O)OC1C)=O)=O,,,5,1,1,0,1
96132_0,,,,2,2,1,3
C(CCC1(C=O)CC(C(O1)O)=O)=O,,,5,1,1,0,1
96134_0,,,,2,2,1,3
C1(CC(C=O)OC1(CCC=O)O)=O,,,5,1,1,0,1
96136_0,,,,2,2,1,3
C(CCC1C(C(OC1C=O)O)=O)=O,,,5,1,1,0,1
96138_0,,,,2,2,1,3
C(CCC1C(CC(C=O)(O)O1)O)=O,,,5,1,1,0,1
96140_0,,,,2,2,1,3
C(CCC1(COC(C=O)(C1)O)O)=O,,,5,1,1,0,1
96142_0,,,,2,2,1,3
C(CCC1C(COC1(C=O)O)O)=O,,,5,1,1,0,1
96144_0,,,,2,2,1,3
C(C1(CCC=O)C(CC(O1)O)O)=O,,,5,1,1,0,1
96146_0,,,,2,2,1,3
C(CCC1C(C(C=O)OC1O)O)=O,,,5,1,1,0,1
96148_0,,,,2,2,1,3
C(CCC1(CC(OC1C=O)O)O)=O,,,5,1,1,0,1
96150_0,,,,2,2,1,3
C(CCC1(CC(C(C=O)O1)O)O)=O,,,5,1,1,0,1
96152_0,,,,2,2,1,3
C(C1C(CCC=O)OC(C1O)O)=O,,,5,1,1,0,1
96154_0,,,,2,2,1,3
C(C1COC(C1(CCC=O)O)O)=O,,,5,1,1,0,1
96156_0,,,,2,2,1,3
C(C1COC(CCC=O)(C1O)O)=O,,,5,1,1,0,1
96158_0,,,,2,2,1,3
C(C1(COC(C1O)O)CCC=O)=O,,,5,1,1,0,1
96160_0,,,,2,2,1,3
C(CCC1(C(C(C(C)O1)O)=O)O)=O,,,5,1,1,0,1
96162_0,,,,2,2,1,3
C(CCC1(C(C(O)OC1C)=O)O)=O,,,5,1,1,0,1
96164_0,,,,2,2,1,3
C(CCC1(C)C(C(C(O)O1)=O)O)=O,,,5,1,1,0,1
96166_0,,,,2,2,1,3
C(CCCC1C(C(C(O)O1)=O)O)=O,,,5,1,1,0,1
96168_0,,,,2,2,1,3
C(C1(C(CCC=O)OC(C1)O)O)=O,,,5,1,1,0,1
96170_0,,,,2,2,1,3
C(C1(COC(C1)(CCC=O)O)O)=O,,,5,1,1,0,1
96172_0,,,,2,2,1,3
C(C1(COC(C1CCC=O)O)O)=O,,,5,1,1,0,1
96174_0,,,,2,2,1,3
C(CCC1(CO)C(CC(O)O1)O)=O,,,5,1,1,0,1
96176_0,,,,2,2,1,3
C(CCC1(CC(O)OC1CO)O)=O,,,5,1,1,0,1
96178_0,,,,2,2,1,3
C(CCC(C1C(CC(O)O1)O)O)=O,,,5,1,1,0,1
96180_0,,,,2,2,1,3
C(CCC1(CC(C(CO)O1)O)O)=O,,,5,1,1,0,1
96182_0,,,,2,2,1,3
C(CCC1C(O)OC(CO)C1O)=O,,,5,1,1,0,1
96184_0,,,,2,2,1,3
C(CCC1C(CC(O)O1)O)=O,,,5,1,1,0,1
96186_0,,,,2,2,1,3
C(CCC1(COC(C1)O)O)=O,,,5,1,1,0,1
96188_0,,,,2,2,1,3
C(CCC1(CC(CO1)O)O)=O,,,5,1,1,0,1
96190_0,,,,2,2,1,3
C(CCC1C(O)OCC1O)=O,,,5,1,1,0,1
96192_0,,,,2,2,1,3
C(CCC1(C(O)OCC1)O)=O,,,5,1,1,0,1
96194_0,,,,2,2,1,3
C(CCC1(C(CCO1)O)O)=O,,,5,1,1,0,1
96196_0,,,,2,2,1,3
C(CCC1CC(C(O)O1)O)=O,,,5,1,1,0,1
96198_0,,,,2,2,1,3
C(CCC1COC(C1O)O)=O,,,5,1,1,0,1
96200_0,,,,2,2,1,3
C1(CC(CCC=O)(C(O)O1)O)=O,,,5,1,1,0,1
96202_0,,,,2,2,1,3
C1(CC(C(CCC=O)(O)O1)O)=O,,,5,1,1,0,1
96204_0,,,,2,2,1,3
C1(C(CCC=O)C(C(O)O1)O)=O,,,5,1,1,0,1
96206_0,,,,2,2,1,3
C(CCC1(C(C(OC1O)=O)=O)O)=O,,,5,1,1,0,1
96208_0,,,,2,2,1,3
C(CCC1(C(C(C(O1)=O)=O)O)O)=O,,,5,1,1,0,1
96210_0,,,,2,2,1,3
C(CCC1(C(C(C(O1)=O)O)=O)O)=O,,,5,1,1,0,1
96212_0,,,,2,2,1,3
C(CCC1(C(OC(C1=O)O)=O)O)=O,,,5,1,1,0,1
96214_0,,,,2,2,1,3
C(CCC1(C(COC(C1)O)=O)O)=O,,,5,1,1,0,1
96216_0,,,,2,2,1,3
C(CCC1C(C(CC(O1)O)O)=O)=O,,,5,1,1,0,1
96218_0,,,,2,2,1,3
C(CCC1(CC(C(CO1)=O)O)O)=O,,,5,1,1,0,1
96220_0,,,,2,2,1,3
C(CCC1C(OCC(C1O)=O)O)=O,,,5,1,1,0,1
96222_0,,,,2,2,1,3
C(CCC1(COC(CC1O)O)O)=O,,,5,1,1,0,1
96224_0,,,,2,2,1,3
C(CCC1(CC(O)OCC1O)O)=O,,,5,1,1,0,1
96226_0,,,,2,2,1,3
C(CCC1C(C(CC(O)O1)O)O)=O,,,5,1,1,0,1
96228_0,,,,2,2,1,3
C(CCC1(CC(C(CO1)O)O)O)=O,,,5,1,1,0,1
96230_0,,,,2,2,1,3
C(CCC1C(O)OCC(C1O)O)=O,,,5,1,1,0,1
96232_0,,,,2,2,1,3
C1(C(CCC=O)(C(C(O1)=O)O)O)=O,,,5,1,1,0,1
96234_0,,,,2,2,1,3
C(CCC1C(C(C(O1)=O)=O)O)=O,,,5,1,1,0,1
96236_0,,,,2,2,1,3
C(CCC1(C(C(OC1)=O)=O)O)=O,,,5,1,1,0,1
96238_0,,,,2,2,1,3
C1(C(C)(C(C(CCC=O)O1)O)O)=O,,,5,1,1,0,1
96240_0,,,,2,2,1,3
C1(C(C)(C(CO1)(CCC=O)O)O)=O,,,5,1,1,0,1
96242_0,,,,2,2,1,3
C1(C(C(CO1)O)(CCCC=O)O)=O,,,5,1,1,0,1
96244_0,,,,2,2,1,3
C1(C(CCC=O)(CC(CO)O1)O)=O,,,5,1,1,0,1
96246_0,,,,2,2,1,3
C(CCC1(CO)CC(C(O1)=O)O)=O,,,5,1,1,0,1
96248_0,,,,2,2,1,3
C(CCC1C(CO)OC(C1O)=O)=O,,,5,1,1,0,1
96250_0,,,,2,2,1,3
C(CCC(C1CC(C(O1)=O)O)O)=O,,,5,1,1,0,1
96252_0,,,,2,2,1,3
C1(C(CCC=O)(CC(CO1)O)O)=O,,,5,1,1,0,1
96254_0,,,,2,2,1,3
C(CCC1(COC(C(C1)O)=O)O)=O,,,5,1,1,0,1
96256_0,,,,2,2,1,3
C(CCC1C(COC(C1O)=O)O)=O,,,5,1,1,0,1
96258_0,,,,2,2,1,3
C(CCC1C(CC(C(O1)=O)O)O)=O,,,5,1,1,0,1
96260_0,,,,2,2,1,3
C(CCC(C(C)O)CC(C=O)=O)=O,,,5,1,1,0,1
96262_0,,,,2,2,1,3
C(CCC(C(C=O)=O)CC(C)O)=O,,,5,1,1,0,1
96264_0,,,,2,2,1,3
C(CCC(C)(CCC(C=O)=O)O)=O,,,5,1,1,0,1
96266_0,,,,2,2,1,3
C(CCCC(CCC(C=O)=O)O)=O,,,5,1,1,0,1
96268_0,,,,2,2,1,3
C(C(CCC=O)(C(C)O)CC=O)=O,,,5,1,1,0,1
96270_0,,,,2,2,1,3
C(CCC(C=O)C(C=O)C(C)O)=O,,,5,1,1,0,1
96272_0,,,,2,2,1,3
C(CCC(C)(C(C=O)CC=O)O)=O,,,5,1,1,0,1
96274_0,,,,2,2,1,3
C(CCCC(C(C=O)CC=O)O)=O,,,5,1,1,0,1
96276_0,,,,2,2,1,3
C(C(CCC=O)CC(C)O)(O)=O,,,5,1,1,0,1
96278_0,,,,2,2,1,3
C(CC(CCC=O)C(C)O)(O)=O,,,5,1,1,0,1
96280_0,,,,2,2,1,3
C(CCC(C)(CCC=O)O)(O)=O,,,5,1,1,0,1
96282_0,,,,2,2,1,3
C(CCC(CCCC=O)O)(O)=O,,,5,1,1,0,1
96284_0,,,,2,2,1,3
C(CCC(CCO)CC(C=O)=O)=O,,,5,1,1,0,1
96286_0,,,,2,2,1,3
C(CCC(C(C=O)=O)CCCO)=O,,,5,1,1,0,1
96288_0,,,,2,2,1,3
C(CCC(CCCC(C=O)=O)O)=O,,,5,1,1,0,1
96290_0,,,,2,2,1,3
C(CCC(CCC(C=O)=O)CO)=O,,,5,1,1,0,1
96292_0,,,,2,2,1,3
C(C(CCC=O)(CCO)CC=O)=O,,,5,1,1,0,1
96294_0,,,,2,2,1,3
C(CCC(C=O)C(C=O)CCO)=O,,,5,1,1,0,1
96296_0,,,,2,2,1,3
C(CCC(CC(C=O)CC=O)O)=O,,,5,1,1,0,1
96298_0,,,,2,2,1,3
C(CCC(CO)C(C=O)CC=O)=O,,,5,1,1,0,1
96300_0,,,,2,2,1,3
C(C(CCC=O)CCCO)(O)=O,,,5,1,1,0,1
96302_0,,,,2,2,1,3
C(CC(CCC=O)CCO)(O)=O,,,5,1,1,0,1
96304_0,,,,2,2,1,3
C(CCCC(CCC=O)O)(O)=O,,,5,1,1,0,1
96306_0,,,,2,2,1,3
C(CCC(CCC=O)CO)(O)=O,,,5,1,1,0,1
96308_0,,,,2,2,1,3
C(CCC(C(O)=O)CCC(O)=O)=O,,,5,1,2,0,2
96310_0,,,,2,2,1,3
C(CCC(CC(O)=O)CC(O)=O)=O,,,5,1,1,0,1
96312_0,,,,2,2,1,3
C(CCC(CCC(C=O)=O)O)=O,,,5,1,1,0,1
96314_0,,,,2,2,1,3
C(CCC(CO)CC(C=O)=O)=O,,,5,1,1,0,1
96316_0,,,,2,2,1,3
C(CCC(C(C=O)=O)CCO)=O,,,5,1,1,0,1
96318_0,,,,2,2,1,3
C(C(CCC(C=O)=O)CCC=O)=O,,,5,1,1,0,1
96320_0,,,,2,2,1,3
C(CC(CCC=O)CC(C=O)=O)=O,,,5,1,1,0,1
96322_0,,,,2,2,1,3
C(CCC(C(C=O)=O)CCC=O)=O,,,5,1,1,0,1
96324_0,,,,2,2,1,3
C(CCC(CCC=O)O)(O)=O,,,5,1,1,0,1
96326_0,,,,2,2,1,3
C(C(CCC=O)CCO)(O)=O,,,5,1,1,0,1
96328_0,,,,2,2,1,3
C(CC(CCC=O)CO)(O)=O,,,5,1,1,0,1
96330_0,,,,2,2,1,3
C(CCC(CCC=O)(CO)O)(O)=O,,,5,1,1,0,1
96332_0,,,,2,2,1,3
C(CCC(C(CCC=O)O)O)(O)=O,,,5,1,1,0,1
96334_0,,,,2,2,1,3
C(C(CCC=O)CC(CO)O)(O)=O,,,5,1,1,0,1
96336_0,,,,2,2,1,3
C(CC(CCC=O)C(CO)O)(O)=O,,,5,1,1,0,1
96338_0,,,,2,2,1,3
C(C(CCC=O)CCC(O)=O)=O,,,5,1,1,0,1
96340_0,,,,2,2,1,3
C(CCC(C(O)=O)CCC=O)=O,,,5,1,1,0,1
96342_0,,,,2,2,1,3
C(CCC(CC=O)CC(O)=O)=O,,,5,1,1,0,1
96344_0,,,,2,2,1,3
C(C(CCC(O)=O)(CCC=O)O)=O,,,5,1,1,0,1
96346_0,,,,2,2,1,3
C(C(CCC=O)CC(C=O)O)(O)=O,,,5,1,1,0,1
96348_0,,,,2,2,1,3
C(CC(CCC=O)C(C=O)O)(O)=O,,,5,1,1,0,1
96350_0,,,,2,2,1,3
C(CC(CO)C(CCC=O)O)(O)=O,,,5,1,1,0,1
96352_0,,,,2,2,1,3
C(C(CCC=O)C(CO)CO)(O)=O,,,5,1,1,0,1
96354_0,,,,2,2,1,3
C(CC(CCC=O)(CO)CO)(O)=O,,,5,1,1,0,1
96356_0,,,,2,2,1,3
C(C(CCC=O)(CC)O)(O)=O,,,5,1,1,0,1
96358_0,,,,2,2,1,3
C(CCC(C)C(C(O)=O)O)=O,,,5,1,1,0,1
96360_0,,,,2,2,1,3
C(CCCCC(C(O)=O)O)=O,,,5,1,1,0,1
96362_0,,,,2,2,1,3
C(CCC(C)(CC(C=O)O)O)=O,,,5,1,1,0,1
96364_0,,,,2,2,1,3
C(CCCC(CC(C=O)O)O)=O,,,5,1,1,0,1
96366_0,,,,2,2,1,3
C(C(CCC=O)(CC(C)O)O)=O,,,5,1,1,0,1
96368_0,,,,2,2,1,3
C(CCC(C(C)O)C(C=O)O)=O,,,5,1,1,0,1
96370_0,,,,2,2,1,3
C(CCC(C(CC(C=O)O)O)O)=O,,,5,1,1,0,1
96372_0,,,,2,2,1,3
C(CCC(CO)(CC(C=O)O)O)=O,,,5,1,1,0,1
96374_0,,,,2,2,1,3
C(C(CCC=O)(CC(CO)O)O)=O,,,5,1,1,0,1
96376_0,,,,2,2,1,3
C(CCC(C(CO)O)C(C=O)O)=O,,,5,1,1,0,1
96378_0,,,,2,2,1,3
C(CCC[C](C(O)=O)O)=O,,,5,1,1,0,1
96380_0,,,,2,2,1,3
C(CCC(C[C](C(O)=O)O)O)=O,,,5,1,1,0,1
96382_0,,,,2,2,1,3
C(CCC([C](C(O)=O)O)CO)=O,,,5,1,1,0,1
96384_0,,,,2,2,1,3
C(C([C](C(O)=O)O)CCC=O)=O,,,5,1,1,0,1
96386_0,,,,2,2,1,3
C(C(CO)(CCC=O)O)=O,,,5,1,1,0,1
96387_0,,,,2,2,1,3
96389_0,,,,2,2,1,3
C(C(CCC=O)(C(CO)O)O)=O,,,5,1,1,0,1
96391_0,,,,2,2,1,3
C(CCC(C(C(C=O)O)O)O)=O,,,5,1,1,0,1
96392_0,,,,2,2,1,3
96393_0,,,,2,2,1,3
96395_0,,,,2,2,1,3
C(CCC(CO)O)=O,,,5,1,1,0,1
96396_0,,,,2,2,1,3
96397_0,,,,2,2,1,3
96398_0,,,,2,2,1,3
96399_0,,,,2,2,1,3
96400_0,,,,2,2,1,3
96402_0,,,,2,2,1,3
C(CCC(C(CO)=O)(CO)O)=O,,,5,1,1,0,1
96404_0,,,,2,2,1,3
C(CCC(CO)(CO)O)=O,,,5,1,1,0,1
96406_0,,,,2,2,1,3
C(CCC(C(CO)O)O)=O,,,5,1,1,0,1
96408_0,,,,2,2,1,3
C(CCC(CO)(C(CO)O)O)=O,,,5,1,1,0,1
96410_0,,,,2,2,1,3
C(CCC(C(C(CO)O)O)O)=O,,,5,1,1,0,1
96411_0,,,,2,2,1,3
96412_0,,,,2,2,1,3
96413_0,,,,2,2,1,3
96415_0,,,,2,2,1,3
C(CCC(C(C(C(O)=O)O)O)O)=O,,,5,1,1,0,1
96416_0,,,,2,2,1,3
96417_0,,,,2,2,1,3
96418_0,,,,2,2,1,3
96419_0,,,,2,2,1,3
96420_0,,,,2,2,1,3
96421_0,,,,2,2,1,3
96422_0,,,,2,2,1,3
96423_0,,,,2,2,1,3
96424_0,,,,2,2,1,3
96425_0,,,,2,2,1,3
96426_0,,,,2,2,1,3
96428_0,,,,2,2,1,3
C(CCC(C(CC=O)=O)O)=O,,,5,1,1,0,1
96430_0,,,,2,2,1,3
C(CCC(C=O)(C(C)=O)O)=O,,,5,1,1,0,1
96431_0,,,,2,2,1,3
96433_0,,,,2,2,1,3
C(CCCC=O)=O,,,5,1,1,0,1
96435_0,,,,2,2,1,3
C(CCC1(C(O)OCC1O)O)=O,,,5,1,1,0,1
96436_0,,,,2,2,1,3
96438_0,,,,2,2,1,3
C(CCC1C(C(C(O)O1)O)O)=O,,,5,1,1,0,1
96440_0,,,,2,2,1,3
C(CCC1(COC(C1O)O)O)=O,,,5,1,1,0,1
96441_0,,,,2,2,1,3
96442_0,,,,2,2,1,3
96444_0,,,,2,2,1,3
C(C(CCC=O)(CCO)O)(O)=O,,,5,1,1,0,1
96446_0,,,,2,2,1,3
C(CCC(CC(C(O)=O)O)O)=O,,,5,1,1,0,1
96448_0,,,,2,2,1,3
C(CCC(CO)C(C(O)=O)O)=O,,,5,1,1,0,1
96449_0,,,,2,2,1,3
96450_0,,,,2,2,1,3
96451_0,,,,2,2,1,3
96453_0,,,,2,2,1,3
C(C(CCC=O)C(CO)(CO)O)=O,,,5,1,1,0,1
96455_0,,,,2,2,1,3
C(CCC(C(CO)(CC=O)O)O)=O,,,5,1,1,0,1
96457_0,,,,2,2,1,3
C(CCC(C)(C(C(CO)=O)O)O)=O,,,5,1,1,0,1
96459_0,,,,2,2,1,3
C(CCCC(C(C(CO)=O)O)O)=O,,,5,1,1,0,1
96461_0,,,,2,2,1,3
C(CCC(C(CO)=O)(C(C)O)O)=O,,,5,1,1,0,1
96463_0,,,,2,2,1,3
C(CCC(C(C(C(C)O)O)=O)O)=O,,,5,1,1,0,1
96465_0,,,,2,2,1,3
C(CCC(C=O)C(C(O)=O)O)=O,,,5,1,2,0,2
96466_0,,,,2,2,1,3
96468_0,,,,2,2,1,3
C(CCC(C=O)C(C=O)(C)O)=O,,,5,1,1,0,1
96469_0,,,,2,2,1,3
96470_0,,,,2,2,1,3
96471_0,,,,2,2,1,3
96473_0,,,,2,2,1,3
C(CCC(C=O)C(C(C)=O)O)=O,,,5,1,1,0,1
96474_0,,,,2,2,1,3
96475_0,,,,2,2,1,3
96476_0,,,,2,2,1,3
96477_0,,,,2,2,1,3
96478_0,,,,2,2,1,3
96480_0,,,,2,2,1,3
C(CCC(C)(CC(C=O)=O)O)=O,,,5,1,1,0,1
96482_0,,,,2,2,1,3
C(CCCC(CC(C=O)=O)O)=O,,,5,1,1,0,1
96483_0,,,,2,2,1,3
96484_0,,,,2,2,1,3
96485_0,,,,2,2,1,3
96487_0,,,,2,2,1,3
C(CCC(C(CC(C=O)=O)O)O)=O,,,5,1,1,0,1
96488_0,,,,2,2,1,3
96489_0,,,,2,2,1,3
96491_0,,,,2,2,1,3
C(C(CCC=O)C(CC=O)O)=O,,,5,1,1,0,1
96492_0,,,,2,2,1,3
96494_0,,,,2,2,1,3
C(C(C(CC=O)O)(CCC=O)O)=O,,,5,1,1,0,1
96496_0,,,,2,2,1,3
C(CCC(C=O)C(C(C=O)O)O)=O,,,5,1,1,0,1
96497_0,,,,2,2,1,3
96499_0,,,,2,2,1,3
C(C(C=O)C(C)(CCC=O)O)=O,,,5,1,1,0,1
96501_0,,,,2,2,1,3
C(C(C=O)C(CCCC=O)O)=O,,,5,1,1,0,1
96503_0,,,,2,2,1,3
C(C(C=O)(CCC=O)C(C)O)=O,,,5,1,1,0,1
96504_0,,,,2,2,1,3
96506_0,,,,2,2,1,3
C(CCC(C=O)(C=O)C(C=O)O)=O,,,5,1,1,0,1
96507_0,,,,2,2,1,3
96509_0,,,,2,2,1,3
C(C(C=O)(CCC=O)CO)=O,,,5,1,1,0,1
96511_0,,,,2,2,1,3
C(C(C=O)C(C(CCC=O)O)O)=O,,,5,1,1,0,1
96512_0,,,,2,2,1,3
96514_0,,,,2,2,1,3
C(C(C=O)(CCC=O)C(CO)O)=O,,,5,1,1,0,1
96515_0,,,,2,2,1,3
96517_0,,,,2,2,1,3
C(CCC(C(C=O)=O)(CO)CO)=O,,,5,1,1,0,1
96518_0,,,,2,2,1,3
96519_0,,,,2,2,1,3
96521_0,,,,2,2,1,3
C(C(CO)(CCC=O)C(C=O)O)=O,,,5,1,1,0,1
96522_0,,,,2,2,1,3
96524_0,,,,2,2,1,3
C(CCC(C=O)(C(CO)=O)CO)=O,,,5,1,1,0,1
96526_0,,,,2,2,1,3
C(CCC(C(C(C=O)CO)=O)O)=O,,,5,1,1,0,1
96527_0,,,,2,2,1,3
96529_0,,,,2,2,1,3
C(CCC(C=O)C(C(CO)O)=O)=O,,,5,1,2,0,2
96531_0,,,,2,2,1,3
C(C(CO)(CCC=O)O)(CC=O)=O,,,5,1,1,0,1
96532_0,,,,2,2,1,3
96534_0,,,,2,2,1,3
C(C(C(CCO)=O)(CCC=O)O)=O,,,5,1,1,0,1
96536_0,,,,2,2,1,3
C(C(CO)CCC=O)(C(C=O)O)=O,,,5,1,1,0,1
96538_0,,,,2,2,1,3
C(C(CCC=O)C(C)O)=O,,,5,1,1,0,1
96540_0,,,,2,2,1,3
C(CCC(C)(CC=O)O)=O,,,5,1,1,0,1
96542_0,,,,2,2,1,3
C(CCCC(CC=O)O)=O,,,5,1,1,0,1
96544_0,,,,2,2,1,3
C(CCC(C(C=O)=O)(C(C)O)O)=O,,,5,1,1,0,1
96546_0,,,,2,2,1,3
C(CCC(C)(C(C(C=O)=O)O)O)=O,,,5,1,1,0,1
96548_0,,,,2,2,1,3
C(CCCC(C(C(C=O)=O)O)O)=O,,,5,1,1,0,1
96550_0,,,,2,2,1,3
C(C(CCC=O)(C(C)O)O)=O,,,5,1,1,0,1
96552_0,,,,2,2,1,3
C(CCC(C)(C(C=O)O)O)=O,,,5,1,1,0,1
96554_0,,,,2,2,1,3
C(CCCC(C(C=O)O)O)=O,,,5,1,1,0,1
96555_0,,,,2,2,1,3
96557_0,,,,2,2,1,3
C(CCC(C=O)C(C=O)(CO)O)=O,,,5,1,2,0,2
96558_0,,,,2,2,1,3
96560_0,,,,2,2,1,3
C(CCC(C(C(CC=O)O)=O)O)=O,,,5,1,1,0,1
96561_0,,,,2,2,1,3
96563_0,,,,2,2,1,3
C(CC(C(CCC=O)(CO)O)O)=O,,,5,1,1,0,1
96564_0,,,,2,2,1,3
96566_0,,,,2,2,1,3
C(CCC(C(C(CC=O)O)O)O)=O,,,5,1,1,0,1
96568_0,,,,2,2,1,3
C(C(CCC=O)C(C(CO)O)O)=O,,,5,1,1,0,1
96569_0,,,,2,2,1,3
96571_0,,,,2,2,1,3
C(C(CCC=O)CO)=O,,,5,1,1,0,1
96573_0,,,,2,2,1,3
C(CCC(C(CC=O)O)O)=O,,,5,1,1,0,1
96574_0,,,,2,2,1,3
96576_0,,,,2,2,1,3
C(C(CCC=O)C(CO)O)=O,,,5,1,1,0,1
96578_0,,,,2,2,1,3
C(C(C(C=O)=O)(CCC=O)O)=O,,,5,1,1,0,1
96579_0,,,,2,2,1,3
96580_0,,,,2,2,1,3
96582_0,,,,2,2,1,3
C(CCC(C(C(C(O)=O)O)=O)O)=O,,,5,1,1,0,1
96584_0,,,,2,2,1,3
C(CCC(C(O)=O)(C(CO)=O)O)=O,,,5,1,1,0,1
96586_0,,,,2,2,1,3
C(CCC(C(C(C)=O)=O)O)=O,,,5,1,1,0,1
96588_0,,,,2,2,1,3
C(CCCC(C(CO)=O)=O)=O,,,5,1,1,0,1
96590_0,,,,2,2,1,3
C(CCCC(C(C=O)=O)O)=O,,,5,1,1,0,1
96592_0,,,,2,2,1,3
C(CCC(C(C=O)=O)(C)O)=O,,,5,1,1,0,1
96593_0,,,,2,2,1,3
96595_0,,,,2,2,1,3
C(CCC(C(CO)(CO)O)O)=O,,,5,1,1,0,1
96597_0,,,,2,2,1,3
C(CCC(C(C)=O)O)=O,,,5,1,1,0,1
96598_0,,,,2,2,1,3
96600_0,,,,2,2,1,3
C(CCC(C(CCO)=O)O)=O,,,5,1,1,0,1
96601_0,,,,2,2,1,3
96603_0,,,,2,2,1,3
C(CCC(C(CO)=O)CO)=O,,,5,1,1,0,1
96605_0,,,,2,2,1,3
C(C(CCC=O)(CCO)O)=O,,,5,1,1,0,1
96607_0,,,,2,2,1,3
C(CCC(CC(C=O)O)O)=O,,,5,1,1,0,1
96609_0,,,,2,2,1,3
C(CCC(CO)C(C=O)O)=O,,,5,1,1,0,1
96611_0,,,,2,2,1,3
C(CCC(C(C)=O)(CO)O)=O,,,5,1,1,0,1
96612_0,,,,2,2,1,3
96614_0,,,,2,2,1,3
C(CCCC(C(CO)O)=O)=O,,,5,1,1,0,1
96616_0,,,,2,2,1,3
C(CCC(C)O)=O,,,5,1,1,0,1
96618_0,,,,2,2,1,3
C(CCCCO)=O,,,5,1,1,0,1
96619_0,,,,2,2,1,3
96620_0,,,,2,2,1,3
96622_0,,,,2,2,1,3
C(C(C(O)=O)CCC=O)=O,,,5,1,1,0,1
96623_0,,,,2,2,1,3
96625_0,,,,2,2,1,3
C(CCC(C(C(O)=O)=O)CO)=O,,,5,1,1,0,1
96627_0,,,,2,2,1,3
C(CCC(C=O)(CC(O)=O)O)=O,,,5,1,1,0,1
96629_0,,,,2,2,1,3
C(C(CCC=O)C(C=O)O)(O)=O,,,5,1,2,0,2
96631_0,,,,2,2,1,3
C(CCC(C(O)=O)C(CO)=O)=O,,,5,1,1,0,1
96633_0,,,,2,2,1,3
C(CCC(C(CC(O)=O)=O)O)=O,,,5,1,1,0,1
96635_0,,,,2,2,1,3
C(CCC(C(O)=O)(C(C)=O)O)=O,,,5,1,1,0,1
96637_0,,,,2,2,1,3
C(C(C(CCCC=O)=O)O)(O)=O,,,5,1,2,0,2
96638_0,,,,2,2,1,3
96639_0,,,,2,2,1,3
96640_0,,,,2,2,1,3
96642_0,,,,2,2,1,3
C(CCC(C(C(O)=O)=O)(CO)O)=O,,,5,1,1,0,1
96643_0,,,,2,2,1,3
96645_0,,,,2,2,1,3
C(C(C(CCCC=O)=O)(CO)O)=O,,,5,1,2,0,2
96646_0,,,,2,2,1,3
96648_0,,,,2,2,1,3
C(C(CO)(C(C)(CCC=O)O)O)=O,,,5,1,1,0,1
96650_0,,,,2,2,1,3
C(C(CO)(C(CCCC=O)O)O)=O,,,5,1,1,0,1
96652_0,,,,2,2,1,3
C(C(C(C)O)(CCCC=O)O)(O)=O,,,5,1,1,0,1
96654_0,,,,2,2,1,3
C(C(C)(C(C)(CCC=O)O)O)(O)=O,,,5,1,1,0,1
96656_0,,,,2,2,1,3
C(C(C)(C(CCCC=O)O)O)(O)=O,,,5,1,1,0,1
96657_0,,,,2,2,1,3
96659_0,,,,2,2,1,3
C(CCC(C)(C(C(O)=O)O)O)=O,,,5,1,1,0,1
96661_0,,,,2,2,1,3
C(CCCC(C(C(O)=O)O)O)=O,,,5,1,1,0,1
96662_0,,,,2,2,1,3
96664_0,,,,2,2,1,3
C(C(CO)(CCCC=O)O)(O)=O,,,5,1,1,0,1
96665_0,,,,2,2,1,3
96667_0,,,,2,2,1,3
C(CO)(C(CCC=O)C(C=O)O)=O,,,5,1,1,0,1
96669_0,,,,2,2,1,3
C(CC(C=O)O)(C(CCC=O)O)=O,,,5,1,1,0,1
96671_0,,,,2,2,1,3
C(C(C(C=O)=O)CCC=O)=O,,,5,1,2,0,2
96673_0,,,,2,2,1,3
C(C(C(C=O)=O)(CCC=O)CO)=O,,,5,1,1,0,1
96674_0,,,,2,2,1,3
96675_0,,,,2,2,1,3
96677_0,,,,2,2,1,3
C(C(C(C(O)=O)=O)CCC=O)=O,,,5,1,1,0,1
96679_0,,,,2,2,1,3
C(CCC1C(C(CO1)O)=O)=O,,,5,1,1,0,1
96681_0,,,,2,2,1,3
C(CCC1C(C(CO1)=O)O)=O,,,5,1,1,0,1
96683_0,,,,2,2,1,3
C(CCC1(C(COC1)=O)O)=O,,,5,1,1,0,1
96685_0,,,,2,2,1,3
C(CCC1(C(CCO1)=O)O)=O,,,5,1,1,0,1
96687_0,,,,2,2,1,3
C(CCC1CC(C(O)O1)=O)=O,,,5,1,1,0,1
96689_0,,,,2,2,1,3
C(CCC1C(C(O)OC1)=O)=O,,,5,1,1,0,1
96691_0,,,,2,2,1,3
C1(C(CCC=O)C(CO1)O)=O,,,5,1,1,0,1
96693_0,,,,2,2,1,3
C1(CC(C(CCC=O)O1)O)=O,,,5,1,1,0,1
96695_0,,,,2,2,1,3
C1(CC(CO1)(CCC=O)O)=O,,,5,1,1,0,1
96697_0,,,,2,2,1,3
C(CCC1C(COC1O)=O)=O,,,5,1,1,0,1
96699_0,,,,2,2,1,3
C(CCC1(CC(CO1)=O)O)=O,,,5,1,1,0,1
96701_0,,,,2,2,1,3
C(CCC1C(CC(O1)O)=O)=O,,,5,1,1,0,1
96703_0,,,,2,2,1,3
C(CCCC(C(C=O)=O)=O)=O,,,5,1,1,0,1
96705_0,,,,2,2,1,3
C(CCC(C=CC(O)=O)O)=O,,,5,1,1,0,1
96707_0,,,,2,2,1,3
C(C(C=C)(CCC=O)O)(O)=O,,,5,1,1,0,1
96709_0,,,,2,2,1,3
C(CCC1(C(O)OC(C1O)=O)O)=O,,,5,1,1,0,1
96711_0,,,,2,2,1,3
C(CCC1(C(C(C(O1)=O)O)O)O)=O,,,5,1,1,0,1
96713_0,,,,2,2,1,3
C1(C(CCC=O)(C(C(O)O1)O)O)=O,,,5,1,1,0,1
96714_0,,,,2,2,1,3
96716_0,,,,2,2,1,3
C(CCC1C(C(C(O)O1)=O)O)=O,,,5,1,1,0,1
96718_0,,,,2,2,1,3
C(CCC1(C(C(O)OC1)=O)O)=O,,,5,1,1,0,1
96720_0,,,,2,2,1,3
C1(C(CCC=O)(C(CO1)O)O)=O,,,5,1,1,0,1
96722_0,,,,2,2,1,3
C(CCC1C(C(C(O1)=O)O)O)=O,,,5,1,1,0,1
96724_0,,,,2,2,1,3
C(CCC1(COC(C1O)=O)O)=O,,,5,1,1,0,1
96726_0,,,,2,2,1,3
C1(C(CCC=O)(CCO1)O)=O,,,5,1,1,0,1
96728_0,,,,2,2,1,3
C(CCC1CC(C(O1)=O)O)=O,,,5,1,1,0,1
96730_0,,,,2,2,1,3
C(CCC1COC(C1O)=O)=O,,,5,1,1,0,1
96732_0,,,,2,2,1,3
C(C(C(C(O)=O)=O)(CCC=O)O)=O,,,5,1,1,0,1
96734_0,,,,2,2,1,3
C(C(CCC=O)(CC(O)=O)O)(O)=O,,,5,1,1,0,1
96736_0,,,,2,2,1,3
C(C(CCC=O)C(C(O)=O)O)(O)=O,,,5,1,2,0,2
96738_0,,,,2,2,1,3
C(C(C(C=O)=O)(CCC=O)O)(O)=O,,,5,1,1,0,1
96740_0,,,,2,2,1,3
C(CCC(C=O)(O)O)=O,,,5,1,1,0,1
96742_0,,,,2,2,1,3
C(C(C)(CCC=O)O)=O,,,5,1,1,0,1
96744_0,,,,2,2,1,3
C(CCCC(C=O)O)=O,,,5,1,2,0,2
96745_0,,,,2,2,1,3
96746_0,,,,2,2,1,3
96747_0,,,,2,2,1,3
96748_0,,,,2,2,1,3
96749_0,,,,2,2,1,3
96750_0,,,,2,2,1,3
96751_0,,,,2,2,1,3
96753_0,,,,2,2,1,3
C(C(CC(C)O)C(C=O)(CO)O)=O,,,5,1,1,0,1
96755_0,,,,2,2,1,3
C(C(CCCO)C(C=O)(CO)O)=O,,,5,1,1,0,1
96756_0,,,,2,2,1,3
96757_0,,,,2,2,1,3
96758_0,,,,2,2,1,3
96760_0,,,,2,2,1,3
C(C(CO)(C(C(C)O)CC=O)O)=O,,,5,1,1,0,1
96762_0,,,,2,2,1,3
C(C(CO)(C(CCO)CC=O)O)=O,,,5,1,1,0,1
96764_0,,,,2,2,1,3
C(C(C=C)(C(CCC(O)=O)O)O)=O,,,5,1,1,0,1
96766_0,,,,2,2,1,3
C(C(CCO)C(CO)(CO)O)(O)=O,,,5,1,1,0,1
96767_0,,,,2,2,1,3
96768_0,,,,2,2,1,3
96770_0,,,,2,2,1,3
C(C(CC(C)O)C(C(O)=O)O)(O)=O,,,5,1,1,0,1
96772_0,,,,2,2,1,3
C(C(CCCO)C(C(O)=O)O)(O)=O,,,5,1,1,0,1
96773_0,,,,2,2,1,3
96775_0,,,,2,2,1,3
C(C(CCO)C(C=O)(C)O)(O)=O,,,5,1,1,0,1
96776_0,,,,2,2,1,3
96778_0,,,,2,2,1,3
C(C(CC(C)O)C(C=O)(C)O)(O)=O,,,5,1,1,0,1
96780_0,,,,2,2,1,3
C(C(CCCO)C(C=O)(C)O)(O)=O,,,5,1,1,0,1
96781_0,,,,2,2,1,3
96782_0,,,,2,2,1,3
96784_0,,,,2,2,1,3
C(C(CC(C)O)C(C(O)=O)(C)O)=O,,,5,1,1,0,1
96786_0,,,,2,2,1,3
C(C(CCCO)C(C(O)=O)(C)O)=O,,,5,1,1,0,1
96788_0,,,,2,2,1,3
C(C(CC(C=C)O)C(C(O)=O)O)=O,,,5,1,1,0,1
96789_0,,,,2,2,1,3
96791_0,,,,2,2,1,3
C(C(CC(CO)O)C(C(O)=O)O)=O,,,5,1,1,0,1
96792_0,,,,2,2,1,3
96794_0,,,,2,2,1,3
C(C(CC(C)O)C(C(O)=O)O)=O,,,5,1,1,0,1
96796_0,,,,2,2,1,3
C(C(CCCO)C(C(O)=O)O)=O,,,5,1,1,0,1
96797_0,,,,2,2,1,3
96799_0,,,,2,2,1,3
C(C(CC(C=O)C(C(O)=O)O)O)=O,,,5,1,1,0,1
96801_0,,,,2,2,1,3
C(C(CCO)C(C(C)=O)O)(O)=O,,,5,1,1,0,1
96802_0,,,,2,2,1,3
96804_0,,,,2,2,1,3
C(C(CC(C)O)C(C(C)=O)O)(O)=O,,,5,1,1,0,1
96806_0,,,,2,2,1,3
C(C(CCCO)C(C(C)=O)O)(O)=O,,,5,1,1,0,1
96807_0,,,,2,2,1,3
96808_0,,,,2,2,1,3
96809_0,,,,2,2,1,3
96811_0,,,,2,2,1,3
C(C(C(CC=O)O)CC(C)O)(O)=O,,,5,1,1,0,1
96813_0,,,,2,2,1,3
C(C(C(CC=O)O)CCCO)(O)=O,,,5,1,1,0,1
96814_0,,,,2,2,1,3
96815_0,,,,2,2,1,3
96817_0,,,,2,2,1,3
C(C(C)(C(C(C)O)CC=O)O)(O)=O,,,5,1,1,0,1
96819_0,,,,2,2,1,3
C(C(C)(C(CCO)CC=O)O)(O)=O,,,5,1,1,0,1
96821_0,,,,2,2,1,3
C(CC(C(C(O)=O)O)C(C=C)O)=O,,,5,1,1,0,1
96822_0,,,,2,2,1,3
96823_0,,,,2,2,1,3
96824_0,,,,2,2,1,3
96826_0,,,,2,2,1,3
C(CC(C(C)O)C(C(O)=O)O)=O,,,5,1,1,0,1
96828_0,,,,2,2,1,3
C(CC(CCO)C(C(O)=O)O)=O,,,5,1,1,0,1
96830_0,,,,2,2,1,3
C(CC(C(C(O)=O)O)CC=O)(O)=O,,,5,1,1,0,1
96831_0,,,,2,2,1,3
96833_0,,,,2,2,1,3
C(C(C(CO)CO)C(C(O)=O)O)=O,,,5,1,1,0,1
96834_0,,,,2,2,1,3
96835_0,,,,2,2,1,3
96837_0,,,,2,2,1,3
C(CCC(C(C(O)=O)=C)(C)O)(O)=O,,,5,1,1,0,1
96839_0,,,,2,2,1,3
C(CCCC(C(C(O)=O)=C)O)(O)=O,,,5,1,1,0,1
96841_0,,,,2,2,1,3
C(C(CC(C=C)O)C(C)O)(O)=O,,,5,1,1,0,1
96843_0,,,,2,2,1,3
C(C(CCO)C(C)O)(O)=O,,,5,1,1,0,1
96845_0,,,,2,2,1,3
C(C(CC(CO)O)C(C)O)(O)=O,,,5,1,1,0,1
96847_0,,,,2,2,1,3
C(C(CC(C(O)=O)O)C(C)O)(O)=O,,,5,1,1,0,1
96848_0,,,,2,2,1,3
96849_0,,,,2,2,1,3
96850_0,,,,2,2,1,3
96852_0,,,,2,2,1,3
C(C(CC(CC=O)O)C(C)O)(O)=O,,,5,1,1,0,1
96854_0,,,,2,2,1,3
C(C(CC(C=O)CO)C(C)O)(O)=O,,,5,1,1,0,1
96856_0,,,,2,2,1,3
C(C(CC(C(C)=O)O)C(C)O)(O)=O,,,5,1,1,0,1
96857_0,,,,2,2,1,3
96859_0,,,,2,2,1,3
C(C(CC(C)O)C(C)O)(O)=O,,,5,1,1,0,1
96861_0,,,,2,2,1,3
C(C(CCCO)C(C)O)(O)=O,,,5,1,1,0,1
96862_0,,,,2,2,1,3
96864_0,,,,2,2,1,3
C(C(CC(C=O)(O)O)C(C)O)(O)=O,,,5,1,1,0,1
96866_0,,,,2,2,1,3
C(C(CC(C=O)(C)O)C(C)O)(O)=O,,,5,1,1,0,1
96868_0,,,,2,2,1,3
C(C(C(C)O)CCC(C=O)O)(O)=O,,,5,1,1,0,1
96870_0,,,,2,2,1,3
C(C(C(C)O)C[C](C(O)=O)O)(O)=O,,,5,1,1,0,1
96872_0,,,,2,2,1,3
C(C(CC(C=O)O)C(C)O)(O)=O,,,5,1,1,0,1
96874_0,,,,2,2,1,3
C(C(C=C)(CCCC(O)=O)O)(O)=O,,,5,1,1,0,1
96876_0,,,,2,2,1,3
C(C(C(C)O)C(CO)CO)(O)=O,,,5,1,1,0,1
96877_0,,,,2,2,1,3
96879_0,,,,2,2,1,3
C(C(C(C)O)C(CO)C(C)O)(O)=O,,,5,1,1,0,1
96881_0,,,,2,2,1,3
C(C(C(C)O)C(CO)CCO)(O)=O,,,5,1,1,0,1
96883_0,,,,2,2,1,3
C(C(CCO)C(C=O)(CO)O)(O)=O,,,5,1,1,0,1
96885_0,,,,2,2,1,3
C(C(CCO)C(C(CO)=O)O)(O)=O,,,5,1,1,0,1
96887_0,,,,2,2,1,3
C(C(CCO)C(C(CO)O)O)(O)=O,,,5,1,1,0,1
96889_0,,,,2,2,1,3
C(C(CC(C=C)O)C(C=O)O)(O)=O,,,5,1,1,0,1
96890_0,,,,2,2,1,3
96892_0,,,,2,2,1,3
C(C(CC(CO)O)C(C=O)O)(O)=O,,,5,1,1,0,1
96893_0,,,,2,2,1,3
96895_0,,,,2,2,1,3
C(C(CC(C)O)C(C=O)O)(O)=O,,,5,1,1,0,1
96897_0,,,,2,2,1,3
C(C(CCCO)C(C=O)O)(O)=O,,,5,1,1,0,1
96898_0,,,,2,2,1,3
96900_0,,,,2,2,1,3
C(C(CC(C=O)O)C(C=O)O)(O)=O,,,5,1,1,0,1
96902_0,,,,2,2,1,3
C1(CC(CO1)C(C(C(O)=O)=C)O)=O,,,5,1,1,0,1
96904_0,,,,2,2,1,3
C=C(C(O)=O)C(CCC(C=O)=O)O,,,5,1,1,0,1
96906_0,,,,2,2,1,3
C(CC(C=O)C(C(C(O)=O)=C)O)=O,,,5,1,1,0,1
96907_0,,,,2,2,1,3
96909_0,,,,2,2,1,3
C(C(CC1C=CC(O1)=O)CO)(O)=O,,,5,1,1,0,1
96911_0,,,,2,2,1,3
C(C(CC1C(C=CO1)=O)CO)(O)=O,,,5,1,1,0,1
96913_0,,,,2,2,1,3
C(C(CO)CC(C=C)O)(O)=O,,,5,1,1,0,1
96915_0,,,,2,2,1,3
C(C(CC[C](C(O)=O)O)CO)(O)=O,,,5,1,1,0,1
96917_0,,,,2,2,1,3
C(C(CO)CC(C=O)(CO)O)(O)=O,,,5,1,1,0,1
96919_0,,,,2,2,1,3
C(C(CO)CC(C(C=O)O)O)(O)=O,,,5,1,1,0,1
96920_0,,,,2,2,1,3
96922_0,,,,2,2,1,3
C(C(CO)CC(CO)O)(O)=O,,,5,1,1,0,1
96924_0,,,,2,2,1,3
C(C(CO)CC(C(O)=O)O)(O)=O,,,5,1,1,0,1
96926_0,,,,2,2,1,3
C(C(CO)CC(C(CO)=O)O)(O)=O,,,5,1,1,0,1
96928_0,,,,2,2,1,3
C(C(CO)CC(CO)(CO)O)(O)=O,,,5,1,1,0,1
96930_0,,,,2,2,1,3
C(C(CO)CC(C(CO)O)O)(O)=O,,,5,1,1,0,1
96931_0,,,,2,2,1,3
96932_0,,,,2,2,1,3
96933_0,,,,2,2,1,3
96935_0,,,,2,2,1,3
C(C(CO)CC(C(O)=O)(C)O)(O)=O,,,5,1,1,0,1
96937_0,,,,2,2,1,3
C(C(CO)CCC(C(O)=O)O)(O)=O,,,5,1,1,0,1
96939_0,,,,2,2,1,3
C(C(CO)CC(C(C=O)=O)O)(O)=O,,,5,1,1,0,1
96941_0,,,,2,2,1,3
C(C(CC(C=O)C(C)O)CO)(O)=O,,,5,1,1,0,1
96943_0,,,,2,2,1,3
C(C(CO)CC(C)(CC=O)O)(O)=O,,,5,1,1,0,1
96945_0,,,,2,2,1,3
C(C(CO)CCC(CC=O)O)(O)=O,,,5,1,1,0,1
96947_0,,,,2,2,1,3
C(C(CO)CC(CC=O)O)(O)=O,,,5,1,1,0,1
96949_0,,,,2,2,1,3
C(C(CC(C=O)CO)CO)(O)=O,,,5,1,1,0,1
96951_0,,,,2,2,1,3
C(C(C=O)(CC(C(O)=O)CO)O)=O,,,5,1,1,0,1
96953_0,,,,2,2,1,3
C(C(CO)CC(C(C)=O)O)(O)=O,,,5,1,1,0,1
96954_0,,,,2,2,1,3
96956_0,,,,2,2,1,3
C(C(CO)CC(C)O)(O)=O,,,5,1,1,0,1
96958_0,,,,2,2,1,3
C(C(CO)CCCO)(O)=O,,,5,1,1,0,1
96959_0,,,,2,2,1,3
96961_0,,,,2,2,1,3
C(C(C=O)CC(C(O)=O)CO)(O)=O,,,5,1,1,0,1
96962_0,,,,2,2,1,3
96964_0,,,,2,2,1,3
C(C(CO)CC(C=O)(O)O)(O)=O,,,5,1,1,0,1
96966_0,,,,2,2,1,3
C(C(CO)CC(C=O)(C)O)(O)=O,,,5,1,1,0,1
96968_0,,,,2,2,1,3
C(C(CO)CCC(C=O)O)(O)=O,,,5,1,1,0,1
96970_0,,,,2,2,1,3
C(C(CO)C[C](C(O)=O)O)(O)=O,,,5,1,1,0,1
96972_0,,,,2,2,1,3
C(C(CO)CC(C=O)O)(O)=O,,,5,1,1,0,1
96974_0,,,,2,2,1,3
C(C(CC(C=C)O)C(CO)O)(O)=O,,,5,1,1,0,1
96975_0,,,,2,2,1,3
96977_0,,,,2,2,1,3
C(C(CC(CO)O)C(CO)O)(O)=O,,,5,1,1,0,1
96978_0,,,,2,2,1,3
96980_0,,,,2,2,1,3
C(C(CC(C)O)C(CO)O)(O)=O,,,5,1,1,0,1
96982_0,,,,2,2,1,3
C(C(CCCO)C(CO)O)(O)=O,,,5,1,1,0,1
96983_0,,,,2,2,1,3
96985_0,,,,2,2,1,3
C(C(CC(C=O)O)C(CO)O)(O)=O,,,5,1,1,0,1
96987_0,,,,2,2,1,3
C(C(C(CO)CO)C(C=O)O)(O)=O,,,5,1,1,0,1
96989_0,,,,2,2,1,3
C(C(CO)C(CO)C(C=C)O)(O)=O,,,5,1,1,0,1
96991_0,,,,2,2,1,3
C(C(CO)C(CO)CO)(O)=O,,,5,1,1,0,1
96993_0,,,,2,2,1,3
C(C(CO)C(CO)C(CO)O)(O)=O,,,5,1,1,0,1
96994_0,,,,2,2,1,3
96996_0,,,,2,2,1,3
C(C(CO)C(CO)C(C)O)(O)=O,,,5,1,1,0,1
96998_0,,,,2,2,1,3
C(C(CO)C(CO)CCO)(O)=O,,,5,1,1,0,1
96999_0,,,,2,2,1,3
97001_0,,,,2,2,1,3
C(C(CO)C(CO)C(C=O)O)(O)=O,,,5,1,1,0,1
97003_0,,,,2,2,1,3
C(C(C(CO)O)C(CO)CO)(O)=O,,,5,1,1,0,1
97004_0,,,,2,2,1,3
97005_0,,,,2,2,1,3
97007_0,,,,2,2,1,3
C(C(CO)C(C(CO)=O)C(C)O)=O,,,5,1,1,0,1
97009_0,,,,2,2,1,3
C(C(CO)C(C(CO)=O)CCO)=O,,,5,1,1,0,1
97011_0,,,,2,2,1,3
C(C(CO)(CO)CC(CO)=O)=O,,,5,1,1,0,1
97012_0,,,,2,2,1,3
97014_0,,,,2,2,1,3
C(C(CO)(C(C)O)CC(CO)=O)=O,,,5,1,1,0,1
97016_0,,,,2,2,1,3
C(C(CO)(CCO)CC(CO)=O)=O,,,5,1,1,0,1
97017_0,,,,2,2,1,3
97018_0,,,,2,2,1,3
97020_0,,,,2,2,1,3
C(C(C(CCC(C)O)=O)(CO)O)=O,,,5,1,1,0,1
97022_0,,,,2,2,1,3
C(C(C(CCCCO)=O)(CO)O)=O,,,5,1,1,0,1
97023_0,,,,2,2,1,3
97024_0,,,,2,2,1,3
97026_0,,,,2,2,1,3
C(C(C(C(CO)O)=O)CC(C)O)=O,,,5,1,1,0,1
97028_0,,,,2,2,1,3
C(C(C(C(CO)O)=O)CCCO)=O,,,5,1,1,0,1
97030_0,,,,2,2,1,3
C(C(C(C=O)=O)CC1C=CC(O1)=O)=O,,,5,1,1,0,1
97032_0,,,,2,2,1,3
C(C(C(C=O)=O)CC1C(C=CO1)=O)=O,,,5,1,1,0,1
97034_0,,,,2,2,1,3
C(C(C(C=O)=O)CC(C=C)O)=O,,,5,1,1,0,1
97035_0,,,,2,2,1,3
97036_0,,,,2,2,1,3
97038_0,,,,2,2,1,3
C(C(C(C=O)=O)CC(C(O)=O)O)=O,,,5,1,2,0,2
97039_0,,,,2,2,1,3
97040_0,,,,2,2,1,3
97041_0,,,,2,2,1,3
97042_0,,,,2,2,1,3
97044_0,,,,2,2,1,3
C(C(C(C=O)=O)CC(C=O)CO)=O,,,5,1,1,0,1
97046_0,,,,2,2,1,3
C(C(C(C=O)=O)CC(C(C)=O)O)=O,,,5,1,1,0,1
97047_0,,,,2,2,1,3
97048_0,,,,2,2,1,3
97050_0,,,,2,2,1,3
C(C(C(C=O)=O)CCCO)=O,,,5,1,1,0,1
97051_0,,,,2,2,1,3
97053_0,,,,2,2,1,3
C(C(C(C=O)=O)CC(C=O)(O)O)=O,,,5,1,1,0,1
97055_0,,,,2,2,1,3
C(C(C(C=O)=O)CC(C=O)(C)O)=O,,,5,1,1,0,1
97057_0,,,,2,2,1,3
C(C(C(C=O)=O)CCC(C=O)O)=O,,,5,1,2,0,2
97059_0,,,,2,2,1,3
C(C(C(C=O)=O)C[C](C(O)=O)O)=O,,,5,1,1,0,1
97060_0,,,,2,2,1,3
97061_0,,,,2,2,1,3
97062_0,,,,2,2,1,3
97064_0,,,,2,2,1,3
C(C(C(C=O)=O)C(CO)C(C)O)=O,,,5,1,1,0,1
97066_0,,,,2,2,1,3
C(C(C(C=O)=O)C(CO)CCO)=O,,,5,1,1,0,1
97068_0,,,,2,2,1,3
C=CC(C(CO)CC(C(O)=O)=O)O,,,5,1,1,0,1
97070_0,,,,2,2,1,3
C(C(CC(CO)CO)=O)(O)=O,,,5,1,1,0,1
97072_0,,,,2,2,1,3
C(C(CC(CO)C(CO)O)=O)(O)=O,,,5,1,2,0,2
97073_0,,,,2,2,1,3
97075_0,,,,2,2,1,3
C(C(CC(CO)C(C)O)=O)(O)=O,,,5,1,1,0,1
97077_0,,,,2,2,1,3
C(C(CC(CO)CCO)=O)(O)=O,,,5,1,1,0,1
97078_0,,,,2,2,1,3
97080_0,,,,2,2,1,3
C(C(C(CO)CC(C(O)=O)=O)O)=O,,,5,1,1,0,1
97082_0,,,,2,2,1,3
C(C(CC(CO)=O)C(C=C)O)(O)=O,,,5,1,1,0,1
97084_0,,,,2,2,1,3
C(C(CO)CC(CO)=O)(O)=O,,,5,1,1,0,1
97086_0,,,,2,2,1,3
C(C(C(CO)O)CC(CO)=O)(O)=O,,,5,1,1,0,1
97087_0,,,,2,2,1,3
97089_0,,,,2,2,1,3
C(C(C(C)O)CC(CO)=O)(O)=O,,,5,1,1,0,1
97091_0,,,,2,2,1,3
C(C(CCO)CC(CO)=O)(O)=O,,,5,1,1,0,1
97093_0,,,,2,2,1,3
C(CC(C(O)=O)CC(CO)=O)(O)=O,,,5,1,2,0,2
97094_0,,,,2,2,1,3
97096_0,,,,2,2,1,3
C(CC(C(CO)=O)C(C=C)O)(O)=O,,,5,1,1,0,1
97097_0,,,,2,2,1,3
97099_0,,,,2,2,1,3
C(CO)(C(C(CO)O)CC(O)=O)=O,,,5,1,1,0,1
97100_0,,,,2,2,1,3
97102_0,,,,2,2,1,3
C(CO)(C(C(C)O)CC(O)=O)=O,,,5,1,1,0,1
97104_0,,,,2,2,1,3
C(CO)(C(CCO)CC(O)=O)=O,,,5,1,1,0,1
97106_0,,,,2,2,1,3
C(CC(C(CO)=O)CC(O)=O)(O)=O,,,5,1,1,0,1
97108_0,,,,2,2,1,3
C(CC(C(CO)=O)C(C=O)O)(O)=O,,,5,1,1,0,1
97110_0,,,,2,2,1,3
C(CCC(C=C)O)(C(C(O)=O)O)=O,,,5,1,1,0,1
97111_0,,,,2,2,1,3
97113_0,,,,2,2,1,3
C(C(C(CCC(CO)O)=O)O)(O)=O,,,5,1,1,0,1
97114_0,,,,2,2,1,3
97116_0,,,,2,2,1,3
C(C(C(CCC(C)O)=O)O)(O)=O,,,5,1,1,0,1
97118_0,,,,2,2,1,3
C(C(C(CCCCO)=O)O)(O)=O,,,5,1,1,0,1
97119_0,,,,2,2,1,3
97120_0,,,,2,2,1,3
97121_0,,,,2,2,1,3
97123_0,,,,2,2,1,3
C(C(CO)CC(C(CO)O)=O)(O)=O,,,5,1,1,0,1
97124_0,,,,2,2,1,3
97126_0,,,,2,2,1,3
C(C(C(CC(CO)CO)=O)O)(O)=O,,,5,1,1,0,1
97128_0,,,,2,2,1,3
C1(CC(CO1)C2C=CC(O2)=O)=O,,,5,1,1,0,1
97129_0,,,,2,2,1,3
97130_0,,,,2,2,1,3
97131_0,,,,2,2,1,3
97133_0,,,,2,2,1,3
C(CC(CO)C1C=CC(O1)=O)(O)=O,,,5,1,1,0,1
97135_0,,,,2,2,1,3
C1(CC(CO1)C2C(C=CO2)=O)=O,,,5,1,1,0,1
97137_0,,,,2,2,1,3
C1(CC(CO1)C(C=C)O)=O,,,5,1,1,0,1
97139_0,,,,2,2,1,3
C1(CC(CO1)C2C(CC(O)O2)O)=O,,,5,1,1,0,1
97141_0,,,,2,2,1,3
C1(CC(CO1)C2(COC(C2)O)O)=O,,,5,1,1,0,1
97143_0,,,,2,2,1,3
C1(CC(CO1)C2(CC(CO2)O)O)=O,,,5,1,1,0,1
97145_0,,,,2,2,1,3
C1(CC(CO1)C2C(O)OCC2O)=O,,,5,1,1,0,1
97147_0,,,,2,2,1,3
C1(CC(CO1)C2(C(O)OCC2)O)=O,,,5,1,1,0,1
97149_0,,,,2,2,1,3
C1(CC(CO1)C2(C(CCO2)O)O)=O,,,5,1,1,0,1
97151_0,,,,2,2,1,3
C1(CC(CO1)C2CC(C(O)O2)O)=O,,,5,1,1,0,1
97153_0,,,,2,2,1,3
C1(CC(CO1)C2COC(C2O)O)=O,,,5,1,1,0,1
97155_0,,,,2,2,1,3
C1(CC(CO1)C(CCC(O)=O)O)=O,,,5,1,1,0,1
97157_0,,,,2,2,1,3
C(C(CCO)C1COC(C1)=O)(O)=O,,,5,1,1,0,1
97159_0,,,,2,2,1,3
C1(CC(CO1)C(CO)CC(O)=O)=O,,,5,1,1,0,1
97161_0,,,,2,2,1,3
C(C(CC)(C1COC(C1)=O)O)(O)=O,,,5,1,1,0,1
97163_0,,,,2,2,1,3
C1(CC(CO1)C(C)C(C(O)=O)O)=O,,,5,1,1,0,1
97165_0,,,,2,2,1,3
C1(CC(CO1)CCC(C(O)=O)O)=O,,,5,1,1,0,1
97167_0,,,,2,2,1,3
C1(CC(CO1)C[C](C(O)=O)O)=O,,,5,1,1,0,1
97168_0,,,,2,2,1,3
97169_0,,,,2,2,1,3
97170_0,,,,2,2,1,3
97171_0,,,,2,2,1,3
97172_0,,,,2,2,1,3
97173_0,,,,2,2,1,3
97174_0,,,,2,2,1,3
97175_0,,,,2,2,1,3
97177_0,,,,2,2,1,3
C(C(CO)(C1COC(C1)=O)O)(O)=O,,,5,1,1,0,1
97179_0,,,,2,2,1,3
C1(CC(CO1)C(C(C(O)=O)O)O)=O,,,5,1,1,0,1
97180_0,,,,2,2,1,3
97181_0,,,,2,2,1,3
97183_0,,,,2,2,1,3
C1(CC(CO1)C(CC(C=O)=O)O)=O,,,5,1,1,0,1
97185_0,,,,2,2,1,3
C1(CC(CO1)C(C(C=O)=O)CO)=O,,,5,1,1,0,1
97187_0,,,,2,2,1,3
C1(CC(CO1)C(C=O)(CC=O)O)=O,,,5,1,1,0,1
97189_0,,,,2,2,1,3
C1(CC(CO1)C(C=O)C(C=O)O)=O,,,5,1,1,0,1
97191_0,,,,2,2,1,3
C1(CC(CO1)C(C=O)C(CO)=O)=O,,,5,1,1,0,1
97193_0,,,,2,2,1,3
C1(CC(CO1)C(C(CC=O)=O)O)=O,,,5,1,1,0,1
97195_0,,,,2,2,1,3
C1(CC(CO1)C(C=O)(C(C)=O)O)=O,,,5,1,1,0,1
97197_0,,,,2,2,1,3
C(C(C(CC1COC(C1)=O)=O)O)=O,,,5,1,1,0,1
97198_0,,,,2,2,1,3
97199_0,,,,2,2,1,3
97200_0,,,,2,2,1,3
97201_0,,,,2,2,1,3
97203_0,,,,2,2,1,3
C(C(C=O)C(C1COC(C1)=O)O)=O,,,5,1,1,0,1
97205_0,,,,2,2,1,3
C(C(C=O)(CO)C1COC(C1)=O)=O,,,5,1,1,0,1
97206_0,,,,2,2,1,3
97207_0,,,,2,2,1,3
97208_0,,,,2,2,1,3
97210_0,,,,2,2,1,3
C(C(C(C)O)(C1COC(C1)=O)O)=O,,,5,1,1,0,1
97212_0,,,,2,2,1,3
C1(CC(CO1)C(C)(C(C=O)O)O)=O,,,5,1,1,0,1
97214_0,,,,2,2,1,3
C1(CC(CO1)CC(C(C=O)O)O)=O,,,5,1,1,0,1
97215_0,,,,2,2,1,3
97216_0,,,,2,2,1,3
97218_0,,,,2,2,1,3
C1(CC(CO1)C(C(CC=O)O)O)=O,,,5,1,1,0,1
97220_0,,,,2,2,1,3
C1(CC(CO1)C(CO)(CC=O)O)=O,,,5,1,1,0,1
97222_0,,,,2,2,1,3
C(C(C1COC(C1)=O)C(CO)O)=O,,,5,1,1,0,1
97224_0,,,,2,2,1,3
C1(CC(CO1)C(C(C(C)=O)=O)O)=O,,,5,1,1,0,1
97226_0,,,,2,2,1,3
C1(CC(CO1)CC(C(CO)=O)=O)=O,,,5,1,1,0,1
97228_0,,,,2,2,1,3
C1(CC(CO1)CC(C(C=O)=O)O)=O,,,5,1,1,0,1
97230_0,,,,2,2,1,3
C1(CC(CO1)C(C(C=O)=O)(C)O)=O,,,5,1,1,0,1
97231_0,,,,2,2,1,3
97232_0,,,,2,2,1,3
97233_0,,,,2,2,1,3
97235_0,,,,2,2,1,3
C1(CC(CO1)C(C(CCO)=O)O)=O,,,5,1,1,0,1
97237_0,,,,2,2,1,3
C1(CC(C(CC(CO)=O)O)CO1)=O,,,5,1,1,0,1
97239_0,,,,2,2,1,3
C1(CC(CO1)C(C(CO)=O)CO)=O,,,5,1,1,0,1
97241_0,,,,2,2,1,3
C(C(CCO)(C1COC(C1)=O)O)=O,,,5,1,1,0,1
97243_0,,,,2,2,1,3
C1(CC(CO1)C(CC(C=O)O)O)=O,,,5,1,1,0,1
97245_0,,,,2,2,1,3
C1(CC(CO1)C(CO)C(C=O)O)=O,,,5,1,1,0,1
97247_0,,,,2,2,1,3
C1(CC(CO1)C(C(C)=O)(CO)O)=O,,,5,1,1,0,1
97249_0,,,,2,2,1,3
C1(CC(C(C(C(C)=O)O)O)CO1)=O,,,5,1,1,0,1
97251_0,,,,2,2,1,3
C1(CC(CO1)CC(C(CO)O)=O)=O,,,5,1,1,0,1
97252_0,,,,2,2,1,3
97253_0,,,,2,2,1,3
97254_0,,,,2,2,1,3
97255_0,,,,2,2,1,3
97256_0,,,,2,2,1,3
97258_0,,,,2,2,1,3
C1(CC(CO1)C(C(C(O)=O)=O)O)=O,,,5,1,1,0,1
97260_0,,,,2,2,1,3
C(C(C(C=O)=O)C1COC(C1)=O)=O,,,5,1,1,0,1
97262_0,,,,2,2,1,3
C1(CC(CO1)C2C(C(CO2)O)=O)=O,,,5,1,1,0,1
97264_0,,,,2,2,1,3
C1(CC(C2C(C(CO2)=O)O)CO1)=O,,,5,1,1,0,1
97266_0,,,,2,2,1,3
C1(CC(CO1)C2(C(COC2)=O)O)=O,,,5,1,1,0,1
97268_0,,,,2,2,1,3
C1(CC(CO1)C2(C(CCO2)=O)O)=O,,,5,1,1,0,1
97270_0,,,,2,2,1,3
C1(CC(C2CC(C(O)O2)=O)CO1)=O,,,5,1,1,0,1
97272_0,,,,2,2,1,3
C1(CC(CO1)C2C(C(O)OC2)=O)=O,,,5,1,1,0,1
97274_0,,,,2,2,1,3
C1(C(C2COC(C2)=O)C(CO1)O)=O,,,5,1,1,0,1
97276_0,,,,2,2,1,3
C1(CC(CO1)C2C(CC(O2)=O)O)=O,,,5,1,1,0,1
97278_0,,,,2,2,1,3
C1(CC(CO1)(C2COC(C2)=O)O)=O,,,5,1,1,0,1
97280_0,,,,2,2,1,3
C1(CC(CO1)C2C(COC2O)=O)=O,,,5,1,1,0,1
97282_0,,,,2,2,1,3
C1(CC(CO1)C2(CC(CO2)=O)O)=O,,,5,1,1,0,1
97284_0,,,,2,2,1,3
C1(CC(CO1)C2C(CC(O2)O)=O)=O,,,5,1,1,0,1
97286_0,,,,2,2,1,3
C1(CC(CO1)CC(C(C=O)=O)=O)=O,,,5,1,1,0,1
97288_0,,,,2,2,1,3
C1(CC(CO1)C(C=CC(O)=O)O)=O,,,5,1,1,0,1
97290_0,,,,2,2,1,3
C(C(C=C)(C1COC(C1)=O)O)(O)=O,,,5,1,1,0,1
97292_0,,,,2,2,1,3
C1(C(CCO1)(C2COC(C2)=O)O)=O,,,5,1,1,0,1
97294_0,,,,2,2,1,3
C1(CC(CO1)C2CC(C(O2)=O)O)=O,,,5,1,1,0,1
97296_0,,,,2,2,1,3
C1(CC(CO1)C2COC(C2O)=O)=O,,,5,1,1,0,1
97297_0,,,,2,2,1,3
97298_0,,,,2,2,1,3
97299_0,,,,2,2,1,3
97300_0,,,,2,2,1,3
97301_0,,,,2,2,1,3
97302_0,,,,2,2,1,3
97303_0,,,,2,2,1,3
97304_0,,,,2,2,1,3
97306_0,,,,2,2,1,3
C(CC(CO)C1C(C=CO1)=O)(O)=O,,,5,1,1,0,1
97308_0,,,,2,2,1,3
C(CC(C(CO)O)C(C=C)O)(O)=O,,,5,1,1,0,1
97309_0,,,,2,2,1,3
97311_0,,,,2,2,1,3
C(CC(C(CO)O)C(CO)O)(O)=O,,,5,1,1,0,1
97312_0,,,,2,2,1,3
97314_0,,,,2,2,1,3
C(CC(C(CO)O)C(C)O)(O)=O,,,5,1,1,0,1
97316_0,,,,2,2,1,3
C(CC(CCO)C(CO)O)(O)=O,,,5,1,1,0,1
97318_0,,,,2,2,1,3
C(CC(C(CO)O)CC(O)=O)(O)=O,,,5,1,1,0,1
97320_0,,,,2,2,1,3
C(CC(C(CO)O)C(C=O)O)(O)=O,,,5,1,1,0,1
97321_0,,,,2,2,1,3
97323_0,,,,2,2,1,3
C(CC(C(O)=O)C(C=C)O)(O)=O,,,5,1,1,0,1
97325_0,,,,2,2,1,3
C(C(CO)CC(O)=O)(O)=O,,,5,1,1,0,1
97327_0,,,,2,2,1,3
C(C(C(CO)O)CC(O)=O)(O)=O,,,5,1,1,0,1
97329_0,,,,2,2,1,3
C(CC(C(O)=O)C(C(O)=O)O)(O)=O,,,5,1,1,0,1
97330_0,,,,2,2,1,3
97331_0,,,,2,2,1,3
97332_0,,,,2,2,1,3
97334_0,,,,2,2,1,3
C(C(C(CC=O)O)CC(O)=O)(O)=O,,,5,1,1,0,1
97336_0,,,,2,2,1,3
C(CC(C(O)=O)C(C=O)CO)(O)=O,,,5,1,1,0,1
97338_0,,,,2,2,1,3
C(CC(C(O)=O)C(C(C)=O)O)(O)=O,,,5,1,1,0,1
97339_0,,,,2,2,1,3
97341_0,,,,2,2,1,3
C(C(C(C)O)CC(O)=O)(O)=O,,,5,1,1,0,1
97343_0,,,,2,2,1,3
C(C(CCO)CC(O)=O)(O)=O,,,5,1,1,0,1
97345_0,,,,2,2,1,3
C(CC(C(O)=O)CC(O)=O)(O)=O,,,5,1,1,0,1
97347_0,,,,2,2,1,3
C(CC(C(O)=O)C(C=O)(O)O)(O)=O,,,5,1,1,0,1
97349_0,,,,2,2,1,3
C(CC(C(O)=O)C(C=O)(C)O)(O)=O,,,5,1,1,0,1
97351_0,,,,2,2,1,3
C(C(CC(C=O)O)CC(O)=O)(O)=O,,,5,1,1,0,1
97353_0,,,,2,2,1,3
C(C([C](C(O)=O)O)CC(O)=O)(O)=O,,,5,1,1,0,1
97354_0,,,,2,2,1,3
97355_0,,,,2,2,1,3
97356_0,,,,2,2,1,3
97357_0,,,,2,2,1,3
97359_0,,,,2,2,1,3
C(CC(CO)C(C=C)O)(O)=O,,,5,1,1,0,1
97361_0,,,,2,2,1,3
C(CCC1(CC(C(O1)=O)O)O)(O)=O,,,5,1,1,0,1
97362_0,,,,2,2,1,3
97363_0,,,,2,2,1,3
97364_0,,,,2,2,1,3
97365_0,,,,2,2,1,3
97367_0,,,,2,2,1,3
C(CCC1(C(CC(C)O1)=O)O)(O)=O,,,5,1,1,0,1
97368_0,,,,2,2,1,3
97369_0,,,,2,2,1,3
97370_0,,,,2,2,1,3
97371_0,,,,2,2,1,3
97372_0,,,,2,2,1,3
97373_0,,,,2,2,1,3
97374_0,,,,2,2,1,3
97376_0,,,,2,2,1,3
C(C(CCC1(CC(CO1)O)O)=O)=O,,,5,1,1,0,1
97378_0,,,,2,2,1,3
C(C(C1(CC(CO1)O)O)CC=O)=O,,,5,1,1,0,1
97380_0,,,,2,2,1,3
C(CCC1(CC(CO1)O)O)(O)=O,,,5,1,1,0,1
97381_0,,,,2,2,1,3
97382_0,,,,2,2,1,3
97383_0,,,,2,2,1,3
97384_0,,,,2,2,1,3
97385_0,,,,2,2,1,3
97386_0,,,,2,2,1,3
97388_0,,,,2,2,1,3
C(C(CCC1(C(CCO1)O)O)=O)=O,,,5,1,1,0,1
97390_0,,,,2,2,1,3
C(C(C1(C(CCO1)O)O)CC=O)=O,,,5,1,1,0,1
97392_0,,,,2,2,1,3
C(CCC1(C(CCO1)O)O)(O)=O,,,5,1,1,0,1
97393_0,,,,2,2,1,3
97394_0,,,,2,2,1,3
97395_0,,,,2,2,1,3
97396_0,,,,2,2,1,3
97397_0,,,,2,2,1,3
97398_0,,,,2,2,1,3
97399_0,,,,2,2,1,3
97401_0,,,,2,2,1,3
C1(CC(C(CCC(O)=O)(O)O1)O)=O,,,5,1,1,0,1
97402_0,,,,2,2,1,3
97404_0,,,,2,2,1,3
C(CCC1C(C(C(O1)=O)=O)O)(O)=O,,,5,1,1,0,1
97406_0,,,,2,2,1,3
C(CCC1(C(C(OC1)=O)=O)O)(O)=O,,,5,1,1,0,1
97408_0,,,,2,2,1,3
C(C(CCC(O)=O)CC(C)O)(O)=O,,,5,1,1,0,1
97410_0,,,,2,2,1,3
C(CCC(C(C)O)CC(O)=O)(O)=O,,,5,1,1,0,1
97412_0,,,,2,2,1,3
C(CCC(C)(CCC(O)=O)O)(O)=O,,,5,1,1,0,1
97414_0,,,,2,2,1,3
C(CCC(CCCC(O)=O)O)(O)=O,,,5,1,2,0,2
97416_0,,,,2,2,1,3
C(C(CCC(O)=O)CCCO)(O)=O,,,5,1,1,0,1
97418_0,,,,2,2,1,3
C(CCC(CCO)CC(O)=O)(O)=O,,,5,1,1,0,1
97419_0,,,,2,2,1,3
97421_0,,,,2,2,1,3
C(CCC(CCC(O)=O)CO)(O)=O,,,5,1,1,0,1
97423_0,,,,2,2,1,3
C(CCC(CCC(C=O)=O)O)(O)=O,,,5,1,2,0,2
97425_0,,,,2,2,1,3
C(CCC(CO)CC(C=O)=O)(O)=O,,,5,1,1,0,1
97427_0,,,,2,2,1,3
C(CCC(C(C=O)=O)CCO)(O)=O,,,5,1,1,0,1
97428_0,,,,2,2,1,3
97429_0,,,,2,2,1,3
97431_0,,,,2,2,1,3
C(CCC(CCC(O)=O)O)(O)=O,,,5,1,1,0,1
97433_0,,,,2,2,1,3
C(C(CCC(C=O)=O)CCO)(O)=O,,,5,1,1,0,1
97435_0,,,,2,2,1,3
C(C(CCO)C(C=O)CC=O)(O)=O,,,5,1,1,0,1
97437_0,,,,2,2,1,3
C(C(CCC(O)=O)CCO)(O)=O,,,5,1,1,0,1
97438_0,,,,2,2,1,3
97439_0,,,,2,2,1,3
97441_0,,,,2,2,1,3
C(CCC(CO)CC(O)=O)(O)=O,,,5,1,1,0,1
97443_0,,,,2,2,1,3
C(C(CCC(O)=O)CCC(O)=O)=O,,,5,1,1,0,1
97444_0,,,,2,2,1,3
97446_0,,,,2,2,1,3
C(CC(CCC(O)=O)CC(O)=O)=O,,,5,1,1,0,1
97448_0,,,,2,2,1,3
C(C(CCC(C=O)=O)(CC)O)(O)=O,,,5,1,1,0,1
97449_0,,,,2,2,1,3
97451_0,,,,2,2,1,3
C(C(CCC(O)=O)(CC)O)(O)=O,,,5,1,1,0,1
97453_0,,,,2,2,1,3
C(C(C(CCC(C=O)=O)C)O)(O)=O,,,5,1,1,0,1
97455_0,,,,2,2,1,3
C(C(C(C)C(C=O)CC=O)O)(O)=O,,,5,1,1,0,1
97457_0,,,,2,2,1,3
C(CCC(C)C(C(O)=O)O)(O)=O,,,5,1,1,0,1
97459_0,,,,2,2,1,3
C(C(CCCCC(C=O)=O)O)(O)=O,,,5,1,2,0,2
97460_0,,,,2,2,1,3
97462_0,,,,2,2,1,3
C(CCCCC(C(O)=O)O)(O)=O,,,5,1,2,0,2
97464_0,,,,2,2,1,3
C(CCC(C)(CC(C=O)O)O)(O)=O,,,5,1,2,0,2
97466_0,,,,2,2,1,3
C(CCCC(CC(C=O)O)O)(O)=O,,,5,1,2,0,2
97468_0,,,,2,2,1,3
C(C(CCC(O)=O)(CC(C)O)O)=O,,,5,1,1,0,1
97470_0,,,,2,2,1,3
C(CCC(C(C)O)C(C=O)O)(O)=O,,,5,1,2,0,2
97472_0,,,,2,2,1,3
[C](C(O)=O)(CCCC(C=O)=O)O,,,5,1,2,0,2
97473_0,,,,2,2,1,3
97475_0,,,,2,2,1,3
C(CCC[C](C(O)=O)O)(O)=O,,,5,1,2,0,2
97477_0,,,,2,2,1,3
C(CC(CO)C[C](C(O)=O)O)(O)=O,,,5,1,2,0,2
97479_0,,,,2,2,1,3
C(CCC(C[C](C(O)=O)O)O)(O)=O,,,5,1,2,0,2
97481_0,,,,2,2,1,3
C(CCC([C](C(O)=O)O)CO)(O)=O,,,5,1,2,0,2
97483_0,,,,2,2,1,3
C(C([C](C(O)=O)O)CCC(O)=O)=O,,,5,1,2,0,2
97484_0,,,,2,1,2,3
97485_0,,,,2,1,2,3
97486_0,,,,2,1,2,3
97487_0,,,,2,1,2,3
97488_0,,,,2,1,2,3
97489_0,,,,2,1,2,3
97490_0,,,,2,1,2,3
97491_0,,,,2,1,2,3
97492_0,,,,2,1,2,3
97493_0,,,,2,1,2,3
97494_0,,,,2,1,2,3
97495_0,,,,2,1,2,3
97496_0,,,,2,1,2,3
97497_0,,,,2,1,2,3
97498_0,,,,2,1,2,3
97499_0,,,,2,1,2,3
97500_0,,,,2,1,2,3
97501_0,,,,2,1,2,3
97502_0,,,,2,1,2,3
97503_0,,,,2,1,2,3
97504_0,,,,2,1,2,3
97507_0,,,,2,1,2,3
C(C(C=CC(C=O)=O)=O)=O,,,5,1,1,0,1
C,,,5,1,3,0,3
97508_0,,,,2,1,2,3
97509_0,,,,2,1,2,3
97510_0,,,,2,1,2,3
97511_0,,,,2,1,2,3
97512_0,,,,2,1,2,3
97513_0,,,,2,1,2,3
97514_0,,,,2,1,2,3
97515_0,,,,2,1,2,3
97516_0,,,,2,1,2,3
97517_0,,,,2,1,2,3
97518_0,,,,2,1,2,3
97519_0,,,,2,1,2,3
97520_0,,,,2,1,2,3
97521_0,,,,2,1,2,3
97522_0,,,,2,1,2,3
97523_0,,,,2,1,2,3
97524_0,,,,2,1,2,3
97525_0,,,,2,1,2,3
97526_0,,,,2,1,2,3
97527_0,,,,2,1,2,3
97528_0,,,,2,1,2,3
97529_0,,,,2,1,2,3
97530_0,,,,2,1,2,3
97531_0,,,,2,1,2,3
97532_0,,,,2,1,2,3
97533_0,,,,2,1,2,3
97534_0,,,,2,1,2,3
97535_0,,,,2,1,2,3
97536_0,,,,2,1,2,3
97537_0,,,,2,1,2,3
97538_0,,,,2,1,2,3
97539_0,,,,2,1,2,3
97540_0,,,,2,1,2,3
97541_0,,,,2,1,2,3
97542_0,,,,2,1,2,3
97543_0,,,,2,1,2,3
97544_0,,,,2,1,2,3
97545_0,,,,2,1,2,3
97546_0,,,,2,1,2,3
97547_0,,,,2,1,2,3
97548_0,,,,2,1,2,3
97549_0,,,,2,1,2,3
97550_0,,,,2,1,2,3
97551_0,,,,2,1,2,3
97552_0,,,,2,1,2,3
97553_0,,,,2,1,2,3
97554_0,,,,2,1,2,3
97555_0,,,,2,1,2,3
97556_0,,,,2,1,2,3
97557_0,,,,2,1,2,3
97558_0,,,,2,1,2,3
97559_0,,,,2,1,2,3
97560_0,,,,2,1,2,3
97561_0,,,,2,1,2,3
97562_0,,,,2,1,2,3
97563_0,,,,2,1,2,3
97564_0,,,,2,1,2,3
97565_0,,,,2,1,2,3
97566_0,,,,2,1,2,3
97567_0,,,,2,1,2,3
97568_0,,,,2,1,2,3
97569_0,,,,2,1,2,3
97570_0,,,,2,1,2,3
97571_0,,,,2,1,2,3
97572_0,,,,2,1,2,3
97573_0,,,,2,1,2,3
97574_0,,,,2,1,2,3
97575_0,,,,2,1,2,3
97576_0,,,,2,1,2,3
97577_0,,,,2,1,2,3
97578_0,,,,2,1,2,3
97579_0,,,,2,1,2,3
97580_0,,,,2,1,2,3
97581_0,,,,2,1,2,3
97583_0,,,,2,1,2,3
C(CC(C=CC(O)=O)(C)O)=O,,,5,1,1,0,1
97584_0,,,,2,1,2,3
97585_0,,,,2,1,2,3
97586_0,,,,2,1,2,3
97587_0,,,,2,1,2,3
97588_0,,,,2,1,2,3
97590_0,,,,2,1,2,3
C(CC(CC=CC(O)=O)O)=O,,,5,1,1,0,1
97591_0,,,,2,1,2,3
97592_0,,,,2,1,2,3
97593_0,,,,2,1,2,3
97594_0,,,,2,1,2,3
97595_0,,,,2,1,2,3
97596_0,,,,2,1,2,3
97597_0,,,,2,1,2,3
97598_0,,,,2,1,2,3
97599_0,,,,2,1,2,3
97600_0,,,,2,1,2,3
97601_0,,,,2,1,2,3
97602_0,,,,2,1,2,3
97603_0,,,,2,1,2,3
97604_0,,,,2,1,2,3
97605_0,,,,2,1,2,3
97606_0,,,,2,1,2,3
97607_0,,,,2,1,2,3
97608_0,,,,2,1,2,3
97609_0,,,,2,1,2,3
97610_0,,,,2,1,2,3
97611_0,,,,2,1,2,3
97612_0,,,,2,1,2,3
97613_0,,,,2,1,2,3
97614_0,,,,2,1,2,3
97615_0,,,,2,1,2,3
97616_0,,,,2,1,2,3
97617_0,,,,2,1,2,3
97618_0,,,,2,1,2,3
97619_0,,,,2,1,2,3
97620_0,,,,2,1,2,3
97621_0,,,,2,1,2,3
97622_0,,,,2,1,2,3
97623_0,,,,2,1,2,3
97624_0,,,,2,1,2,3
97625_0,,,,2,1,2,3
97626_0,,,,2,1,2,3
97627_0,,,,2,1,2,3
97628_0,,,,2,1,2,3
97629_0,,,,2,1,2,3
97630_0,,,,2,1,2,3
97631_0,,,,2,1,2,3
97632_0,,,,2,1,2,3
97633_0,,,,2,1,2,3
97634_0,,,,2,1,2,3
97635_0,,,,2,1,2,3
97636_0,,,,2,1,2,3
97637_0,,,,2,1,2,3
97638_0,,,,2,1,2,3
97639_0,,,,2,1,2,3
97640_0,,,,2,1,2,3
97641_0,,,,2,1,2,3
97642_0,,,,2,1,2,3
97643_0,,,,2,1,2,3
97644_0,,,,2,1,2,3
97645_0,,,,2,1,2,3
97646_0,,,,2,1,2,3
97647_0,,,,2,1,2,3
97648_0,,,,2,1,2,3
97649_0,,,,2,1,2,3
97650_0,,,,2,1,2,3
97651_0,,,,2,1,2,3
97652_0,,,,2,1,2,3
97653_0,,,,2,1,2,3
97654_0,,,,2,1,2,3
97655_0,,,,2,1,2,3
97656_0,,,,2,1,2,3
97657_0,,,,2,1,2,3
97658_0,,,,2,1,2,3
97659_0,,,,2,1,2,3
97660_0,,,,2,1,2,3
97661_0,,,,2,1,2,3
97662_0,,,,2,1,2,3
97663_0,,,,2,1,2,3
97664_0,,,,2,1,2,3
97665_0,,,,2,1,2,3
97666_0,,,,2,1,2,3
97667_0,,,,2,1,2,3
97668_0,,,,2,1,2,3
97669_0,,,,2,1,2,3
97670_0,,,,2,1,2,3
97671_0,,,,2,1,2,3
97672_0,,,,2,1,2,3
97673_0,,,,2,1,2,3
97674_0,,,,2,1,2,3
97675_0,,,,2,1,2,3
97676_0,,,,2,1,2,3
97677_0,,,,2,1,2,3
97678_0,,,,2,1,2,3
97679_0,,,,2,1,2,3
97680_0,,,,2,1,2,3
97681_0,,,,2,1,2,3
97682_0,,,,2,1,2,3
97683_0,,,,2,1,2,3
97684_0,,,,2,1,2,3
97685_0,,,,2,1,2,3
97686_0,,,,2,1,2,3
97687_0,,,,2,1,2,3
97688_0,,,,2,1,2,3
97689_0,,,,2,1,2,3
97690_0,,,,2,1,2,3
97691_0,,,,2,1,2,3
97692_0,,,,2,1,2,3
97693_0,,,,2,1,2,3
97694_0,,,,2,1,2,3
97695_0,,,,2,1,2,3
97696_0,,,,2,1,2,3
97697_0,,,,2,1,2,3
97698_0,,,,2,1,2,3
97699_0,,,,2,1,2,3
97700_0,,,,2,1,2,3
97701_0,,,,2,1,2,3
97702_0,,,,2,1,2,3
97703_0,,,,2,1,2,3
97704_0,,,,2,1,2,3
97705_0,,,,2,1,2,3
97706_0,,,,2,1,2,3
97707_0,,,,2,1,2,3
97708_0,,,,2,1,2,3
97709_0,,,,2,1,2,3
97710_0,,,,2,1,2,3
97711_0,,,,2,1,2,3
97712_0,,,,2,1,2,3
97713_0,,,,2,1,2,3
97714_0,,,,2,1,2,3
97715_0,,,,2,1,2,3
97717_0,,,,2,1,2,3
C(CCO)=CC(O)=O,,,5,1,1,0,1
97718_0,,,,2,1,2,3
97719_0,,,,2,1,2,3
97720_0,,,,2,1,2,3
97721_0,,,,2,1,2,3
97722_0,,,,2,1,2,3
97723_0,,,,2,1,2,3
97724_0,,,,2,1,2,3
97725_0,,,,2,1,2,3
97726_0,,,,2,1,2,3
97727_0,,,,2,1,2,3
97728_0,,,,2,1,2,3
97729_0,,,,2,1,2,3
97730_0,,,,2,1,2,3
97731_0,,,,2,1,2,3
97732_0,,,,2,1,2,3
97733_0,,,,2,1,2,3
97734_0,,,,2,1,2,3
97735_0,,,,2,1,2,3
97736_0,,,,2,1,2,3
97737_0,,,,2,1,2,3
97738_0,,,,2,1,2,3
97739_0,,,,2,1,2,3
97740_0,,,,2,1,2,3
97741_0,,,,2,1,2,3
97742_0,,,,2,1,2,3
97743_0,,,,2,1,2,3
97744_0,,,,2,1,2,3
97745_0,,,,2,1,2,3
97746_0,,,,2,1,2,3
97747_0,,,,2,1,2,3
97748_0,,,,2,1,2,3
97749_0,,,,2,1,2,3
97750_0,,,,2,1,2,3
97751_0,,,,2,1,2,3
97752_0,,,,2,1,2,3
97753_0,,,,2,1,2,3
97754_0,,,,2,1,2,3
97755_0,,,,2,1,2,3
97756_0,,,,2,1,2,3
97757_0,,,,2,1,2,3
97758_0,,,,2,1,2,3
97759_0,,,,2,1,2,3
97760_0,,,,2,1,2,3
97761_0,,,,2,1,2,3
97762_0,,,,2,1,2,3
97763_0,,,,2,1,2,3
97764_0,,,,2,1,2,3
97765_0,,,,2,1,2,3
97766_0,,,,2,1,2,3
97767_0,,,,2,1,2,3
97768_0,,,,2,1,2,3
97769_0,,,,2,1,2,3
97770_0,,,,2,1,2,3
97771_0,,,,2,1,2,3
97772_0,,,,2,1,2,3
97773_0,,,,2,1,2,3
97774_0,,,,2,1,2,3
97775_0,,,,2,1,2,3
97776_0,,,,2,1,2,3
97777_0,,,,2,1,2,3
97778_0,,,,2,1,2,3
97779_0,,,,2,1,2,3
97780_0,,,,2,1,2,3
97781_0,,,,2,1,2,3
97782_0,,,,2,1,2,3
97783_0,,,,2,1,2,3
97784_0,,,,2,1,2,3
97785_0,,,,2,1,2,3
97786_0,,,,2,1,2,3
97787_0,,,,2,1,2,3
97788_0,,,,2,1,2,3
97789_0,,,,2,1,2,3
97790_0,,,,2,1,2,3
97791_0,,,,2,1,2,3
97792_0,,,,2,1,2,3
97793_0,,,,2,1,2,3
97794_0,,,,2,1,2,3
97796_0,,,,2,1,1,2
C(CC(C=O)=CC(C(O)OC)=O)=O,,,5,1,1,0,1
97797_0,,,,2,1,2,3
97798_0,,,,2,1,2,3
97799_0,,,,2,1,2,3
97800_0,,,,2,1,2,3
97801_0,,,,2,1,2,3
97802_0,,,,2,1,2,3
97804_0,,,,2,1,1,2
C(CC(C=O)=CC(OCCO)=O)=O,,,5,1,1,0,1
97805_0,,,,2,1,2,3
97806_0,,,,2,1,2,3
97807_0,,,,2,1,2,3
97808_0,,,,2,1,2,3
97809_0,,,,2,1,2,3
97810_0,,,,2,1,2,3
97811_0,,,,2,1,2,3
97812_0,,,,2,1,2,3
97813_0,,,,2,1,2,3
97814_0,,,,2,1,2,3
97815_0,,,,2,1,2,3
97816_0,,,,2,1,2,3
97818_0,,,,2,1,1,2
C(CC(C=O)=CC(COCO)=O)=O,,,5,1,1,0,1
97819_0,,,,2,1,2,3
97820_0,,,,2,1,2,3
97821_0,,,,2,1,2,3
97822_0,,,,2,1,2,3
97823_0,,,,2,1,2,3
97824_0,,,,2,1,2,3
97825_0,,,,2,1,2,3
97826_0,,,,2,1,2,3
97827_0,,,,2,1,2,3
97828_0,,,,2,1,2,3
97829_0,,,,2,1,2,3
97830_0,,,,2,1,2,3
97831_0,,,,2,1,2,3
97832_0,,,,2,1,2,3
97833_0,,,,2,1,2,3
97834_0,,,,2,1,2,3
97835_0,,,,2,1,2,3
97836_0,,,,2,1,2,3
97837_0,,,,2,1,2,3
97838_0,,,,2,1,2,3
97839_0,,,,2,1,2,3
97840_0,,,,2,1,2,3
97841_0,,,,2,1,2,3
97842_0,,,,2,1,2,3
97843_0,,,,2,1,2,3
97844_0,,,,2,1,2,3
97845_0,,,,2,1,2,3
97846_0,,,,2,1,2,3
97847_0,,,,2,1,2,3
97848_0,,,,2,1,2,3
97849_0,,,,2,1,2,3
97850_0,,,,2,1,2,3
97851_0,,,,2,1,2,3
97852_0,,,,2,1,2,3
97853_0,,,,2,1,2,3
97854_0,,,,2,1,2,3
97855_0,,,,2,1,2,3
97856_0,,,,2,1,2,3
97857_0,,,,2,1,2,3
97858_0,,,,2,1,2,3
97859_0,,,,2,1,2,3
97860_0,,,,2,1,2,3
97861_0,,,,2,1,2,3
97862_0,,,,2,1,2,3
97863_0,,,,2,1,2,3
97864_0,,,,2,1,2,3
97865_0,,,,2,1,2,3
97866_0,,,,2,1,2,3
97867_0,,,,2,1,2,3
97868_0,,,,2,1,2,3
97869_0,,,,2,1,2,3
97870_0,,,,2,1,2,3
97871_0,,,,2,1,2,3
97872_0,,,,2,1,2,3
97873_0,,,,2,1,2,3
97874_0,,,,2,1,2,3
97875_0,,,,2,1,2,3
97877_0,,,,2,1,1,2
C(CC(C=O)=CCOC(CO)=O)=O,,,5,1,1,0,1
97879_0,,,,2,1,1,2
C(CC(C=O)=CC(C(OC)=O)O)=O,,,5,1,1,0,1
97880_0,,,,2,1,2,3
97881_0,,,,2,1,2,3
97882_0,,,,2,1,2,3
97883_0,,,,2,1,2,3
97884_0,,,,2,1,2,3
97885_0,,,,2,1,2,3
97886_0,,,,2,1,2,3
97887_0,,,,2,1,2,3
97888_0,,,,2,1,2,3
97889_0,,,,2,1,2,3
97890_0,,,,2,1,2,3
97891_0,,,,2,1,2,3
97892_0,,,,2,1,2,3
97893_0,,,,2,1,2,3
97894_0,,,,2,1,2,3
97895_0,,,,2,1,2,3
97896_0,,,,2,1,2,3
97897_0,,,,2,1,2,3
97898_0,,,,2,1,2,3
97899_0,,,,2,1,2,3
97900_0,,,,2,1,2,3
97901_0,,,,2,1,2,3
97902_0,,,,2,1,2,3
97903_0,,,,2,1,2,3
97904_0,,,,2,1,2,3
97905_0,,,,2,1,2,3
97906_0,,,,2,1,2,3
97907_0,,,,2,1,2,3
97908_0,,,,2,1,2,3
97909_0,,,,2,1,2,3
97910_0,,,,2,1,2,3
97911_0,,,,2,1,2,3
97912_0,,,,2,1,2,3
97913_0,,,,2,1,2,3
97914_0,,,,2,1,2,3
97915_0,,,,2,1,2,3
97916_0,,,,2,1,2,3
97917_0,,,,2,1,2,3
97918_0,,,,2,1,2,3
97919_0,,,,2,1,2,3
97920_0,,,,2,1,2,3
97921_0,,,,2,1,2,3
97922_0,,,,2,1,2,3
97923_0,,,,2,1,2,3
97924_0,,,,2,1,2,3
97925_0,,,,2,1,2,3
97926_0,,,,2,1,2,3
97927_0,,,,2,1,2,3
97928_0,,,,2,1,2,3
97929_0,,,,2,1,2,3
97930_0,,,,2,1,2,3
97931_0,,,,2,1,2,3
97932_0,,,,2,1,2,3
97933_0,,,,2,1,2,3
97934_0,,,,2,1,2,3
97935_0,,,,2,1,2,3
97936_0,,,,2,1,2,3
97937_0,,,,2,1,2,3
97938_0,,,,2,1,2,3
97939_0,,,,2,1,2,3
97940_0,,,,2,1,2,3
97941_0,,,,2,1,2,3
97942_0,,,,2,1,2,3
97943_0,,,,2,1,2,3
97944_0,,,,2,1,2,3
97945_0,,,,2,1,2,3
97946_0,,,,2,1,2,3
97947_0,,,,2,1,2,3
97948_0,,,,2,1,2,3
97949_0,,,,2,1,2,3
97950_0,,,,2,1,2,3
97951_0,,,,2,1,2,3
97952_0,,,,2,1,2,3
97953_0,,,,2,1,2,3
97954_0,,,,2,1,2,3
97955_0,,,,2,1,2,3
97956_0,,,,2,1,2,3
97957_0,,,,2,1,2,3
97958_0,,,,2,1,2,3
97959_0,,,,2,1,2,3
97960_0,,,,2,1,2,3
97961_0,,,,2,1,2,3
97962_0,,,,2,1,2,3
97963_0,,,,2,1,2,3
97964_0,,,,2,1,2,3
97965_0,,,,2,1,2,3
97966_0,,,,2,1,2,3
97967_0,,,,2,1,2,3
97968_0,,,,2,1,2,3
97969_0,,,,2,1,2,3
97970_0,,,,2,1,2,3
97971_0,,,,2,1,2,3
97972_0,,,,2,1,2,3
97973_0,,,,2,1,2,3
97974_0,,,,2,1,2,3
97975_0,,,,2,1,2,3
97976_0,,,,2,1,2,3
97977_0,,,,2,1,2,3
97978_0,,,,2,1,2,3
97979_0,,,,2,1,2,3
97980_0,,,,2,1,2,3
97981_0,,,,2,1,2,3
97982_0,,,,2,1,2,3
97983_0,,,,2,1,2,3
97984_0,,,,2,1,2,3
97985_0,,,,2,1,2,3
97986_0,,,,2,1,2,3
97987_0,,,,2,1,2,3
97988_0,,,,2,1,2,3
97989_0,,,,2,1,2,3
97990_0,,,,2,1,2,3
97991_0,,,,2,1,2,3
97992_0,,,,2,1,2,3
97993_0,,,,2,1,2,3
97994_0,,,,2,1,2,3
97995_0,,,,2,1,2,3
97996_0,,,,2,1,2,3
97997_0,,,,2,1,2,3
97998_0,,,,2,1,2,3
97999_0,,,,2,1,2,3
98000_0,,,,2,1,2,3
98001_0,,,,2,1,2,3
98002_0,,,,2,1,2,3
98003_0,,,,2,1,2,3
98004_0,,,,2,1,2,3
98005_0,,,,2,1,2,3
98006_0,,,,2,1,2,3
98007_0,,,,2,1,2,3
98008_0,,,,2,1,2,3
98010_0,,,,2,1,2,3
C(C(CC=CC(O)=O)O)(O)=O,,,5,1,1,0,1
98011_0,,,,2,1,2,3
98012_0,,,,2,1,2,3
98013_0,,,,2,1,2,3
98014_0,,,,2,1,2,3
98015_0,,,,2,3,5,8
98016_0,,,,2,3,5,8
98017_0,,,,2,3,5,8
98018_0,,,,2,3,5,8
98019_0,,,,2,3,5,8
98020_0,,,,2,3,5,8
98021_0,,,,2,3,5,8
98022_0,,,,2,3,5,8
98023_0,,,,2,3,5,8
98024_0,,,,2,3,5,8
98025_0,,,,2,3,5,8
98026_0,,,,2,3,5,8
98027_0,,,,2,3,5,8
98028_0,,,,2,3,5,8
98029_0,,,,2,3,5,8
98030_0,,,,2,3,5,8
98031_0,,,,2,3,5,8
98032_0,,,,2,3,5,8
98033_0,,,,2,3,5,8
98034_0,,,,2,3,5,8
98035_0,,,,2,3,5,8
98036_0,,,,2,3,5,8
98037_0,,,,2,3,5,8
98038_0,,,,2,3,5,8
98040_0,,,,2,3,5,8
C(C(C(C(C(C(O)=O)=O)O)=O)O)=O,,,5,1,1,0,1
98041_0,,,,2,3,5,8
98042_0,,,,2,3,5,8
98043_0,,,,2,3,5,8
98044_0,,,,2,3,5,8
98045_0,,,,2,3,5,8
98046_0,,,,2,3,5,8
98047_0,,,,2,3,5,8
98048_0,,,,2,3,5,8
98049_0,,,,2,3,5,8
98050_0,,,,2,3,5,8
98051_0,,,,2,3,5,8
98052_0,,,,2,3,5,8
98053_0,,,,2,3,5,8
98054_0,,,,2,3,5,8
98055_0,,,,2,3,5,8
98056_0,,,,2,3,5,8
98057_0,,,,2,3,5,8
98058_0,,,,2,3,5,8
98059_0,,,,2,3,5,8
98060_0,,,,2,3,5,8
98061_0,,,,2,3,5,8
98062_0,,,,2,3,5,8
98063_0,,,,2,3,5,8
98064_0,,,,2,3,5,8
98065_0,,,,2,3,5,8
98066_0,,,,2,3,5,8
98067_0,,,,2,3,5,8
98069_0,,,,2,3,5,8
C(C(C(C(O)=O)=O)C(C(O)=O)=O)=O,,,5,1,1,0,1
98070_0,,,,2,3,5,8
98071_0,,,,2,3,5,8
98072_0,,,,2,3,5,8
98073_0,,,,2,3,5,8
98075_0,,,,2,3,5,8
C(C(C(CC(C(O)=O)=O)=O)=O)=O,,,5,1,1,0,1
98076_0,,,,2,3,5,8
98077_0,,,,2,3,5,8
98078_0,,,,2,3,5,8
98079_0,,,,2,3,5,8
98080_0,,,,2,3,5,8
98081_0,,,,2,3,5,8
98082_0,,,,2,3,5,8
98083_0,,,,2,3,5,8
98084_0,,,,2,3,5,8
98085_0,,,,2,3,5,8
98086_0,,,,2,3,5,8
98087_0,,,,2,3,5,8
98088_0,,,,2,3,5,8
98089_0,,,,2,3,5,8
98090_0,,,,2,3,5,8
98091_0,,,,2,3,5,8
98092_0,,,,2,3,5,8
98093_0,,,,2,3,5,8
98094_0,,,,2,3,5,8
98095_0,,,,2,3,5,8
98096_0,,,,2,3,5,8
98097_0,,,,2,3,5,8
98098_0,,,,2,3,5,8
98099_0,,,,2,3,5,8
98100_0,,,,2,3,5,8
98101_0,,,,2,3,5,8
98102_0,,,,2,3,5,8
98103_0,,,,2,3,5,8
98104_0,,,,2,3,5,8
98105_0,,,,2,3,5,8
98106_0,,,,2,3,5,8
98107_0,,,,2,3,5,8
98108_0,,,,2,3,5,8
98109_0,,,,2,3,5,8
98110_0,,,,2,3,5,8
98111_0,,,,2,3,5,8
98112_0,,,,2,3,5,8
98113_0,,,,2,3,5,8
98114_0,,,,2,3,5,8
98115_0,,,,2,3,5,8
98116_0,,,,2,3,5,8
98117_0,,,,2,3,5,8
98118_0,,,,2,3,5,8
98119_0,,,,2,3,5,8
98120_0,,,,2,3,5,8
98121_0,,,,2,3,5,8
98122_0,,,,2,3,5,8
98123_0,,,,2,3,5,8
98124_0,,,,2,3,5,8
98125_0,,,,2,3,5,8
98126_0,,,,2,3,5,8
98127_0,,,,2,3,5,8
98128_0,,,,2,3,5,8
98129_0,,,,2,3,5,8
98130_0,,,,2,3,5,8
98132_0,,,,2,3,5,8
C(C(C(C(O)=O)=O)(C(C=O)=O)O)=O,,,5,1,2,0,2
98134_0,,,,2,3,5,8
C(C(C=O)(C(C(O)=O)=O)O)=O,,,5,1,1,0,1
98135_0,,,,2,3,5,8
98136_0,,,,2,3,5,8
98138_0,,,,2,3,5,8
C1(COCC1(C(C(O)=O)=O)O)=O,,,5,1,1,0,1
98139_0,,,,2,3,5,8
98140_0,,,,2,3,5,8
98141_0,,,,2,3,5,8
98142_0,,,,2,3,5,8
98144_0,,,,2,3,5,8
C1(C(C(C(O)=O)=O)(C(CO1)O)O)=O,,,5,1,1,0,1
98145_0,,,,2,3,5,8
98146_0,,,,2,3,5,8
98147_0,,,,2,3,5,8
98148_0,,,,2,3,5,8
98149_0,,,,2,3,5,8
98150_0,,,,2,3,5,8
98151_0,,,,2,3,5,8
98153_0,,,,2,3,5,8
C(CC(C(C)=O)(C(C(O)=O)=O)O)=O,,,5,1,1,0,1
98154_0,,,,2,3,5,8
98156_0,,,,2,3,5,8
C(C(C(C(O)=O)=O)(CC(C)O)O)=O,,,5,1,1,0,1
98157_0,,,,2,3,5,8
98158_0,,,,2,3,5,8
98159_0,,,,2,3,5,8
98161_0,,,,2,3,5,8
C(C(C(C(C=O)=O)(C)O)=O)(O)=O,,,5,1,2,0,2
98162_0,,,,2,3,5,8
98163_0,,,,2,3,5,8
98164_0,,,,2,3,5,8
98165_0,,,,2,3,5,8
98167_0,,,,2,3,5,8
C(C(CC(C(C(O)=O)=O)O)=O)(O)=O,,,5,1,1,0,1
98169_0,,,,2,3,5,8
C(C(C1(COCC1O)O)=O)(O)=O,,,5,1,1,0,1
98171_0,,,,2,3,5,8
C1(CCOC1(C(C(O)=O)=O)O)=O,,,5,1,1,0,1
98172_0,,,,2,3,5,8
98173_0,,,,2,3,5,8
98174_0,,,,2,3,5,8
98175_0,,,,2,3,5,8
98176_0,,,,2,3,5,8
98177_0,,,,2,3,5,8
98179_0,,,,2,3,5,8
C1(C(COC1(C(C(O)=O)=O)O)O)=O,,,5,1,1,0,1
98180_0,,,,2,3,5,8
98181_0,,,,2,3,5,8
98182_0,,,,2,3,5,8
98183_0,,,,2,3,5,8
98184_0,,,,2,3,5,8
98185_0,,,,2,3,5,8
98186_0,,,,2,3,5,8
98187_0,,,,2,3,5,8
98188_0,,,,2,3,5,8
98189_0,,,,2,3,5,8
98190_0,,,,2,3,5,8
98191_0,,,,2,3,5,8
98192_0,,,,2,3,5,8
98193_0,,,,2,3,5,8
98194_0,,,,2,3,5,8
98195_0,,,,2,3,5,8
98196_0,,,,2,3,5,8
98197_0,,,,2,3,5,8
98198_0,,,,2,3,5,8
98199_0,,,,2,3,5,8
98200_0,,,,2,3,5,8
98201_0,,,,2,3,5,8
98202_0,,,,2,3,5,8
98203_0,,,,2,3,5,8
98204_0,,,,2,3,5,8
98205_0,,,,2,3,5,8
98206_0,,,,2,3,5,8
98207_0,,,,2,3,5,8
98208_0,,,,2,3,5,8
98209_0,,,,2,3,5,8
98210_0,,,,2,3,5,8
98211_0,,,,2,3,5,8
98212_0,,,,2,3,5,8
98213_0,,,,2,3,5,8
98214_0,,,,2,3,5,8
98215_0,,,,2,3,5,8
98216_0,,,,2,3,5,8
98217_0,,,,2,3,5,8
98218_0,,,,2,3,5,8
98219_0,,,,2,3,5,8
98220_0,,,,2,3,5,8
98221_0,,,,2,3,5,8
98222_0,,,,2,3,5,8
98223_0,,,,2,3,5,8
98224_0,,,,2,3,5,8
98225_0,,,,2,3,5,8
98226_0,,,,2,3,5,8
98227_0,,,,2,5,3,8
98228_0,,,,2,5,3,8
98229_0,,,,2,5,3,8
98230_0,,,,2,5,3,8
98231_0,,,,2,5,3,8
98232_0,,,,2,5,3,8
98233_0,,,,2,5,3,8
98234_0,,,,2,5,3,8
98235_0,,,,2,5,3,8
98236_0,,,,2,5,3,8
98237_0,,,,2,5,3,8
98238_0,,,,2,5,3,8
98239_0,,,,2,5,3,8
98240_0,,,,2,5,3,8
98241_0,,,,2,5,3,8
98242_0,,,,2,5,3,8
98243_0,,,,2,5,3,8
98244_0,,,,2,5,3,8
98245_0,,,,2,5,3,8
98246_0,,,,2,5,3,8
98247_0,,,,2,5,3,8
98248_0,,,,2,5,3,8
98249_0,,,,2,5,3,8
98250_0,,,,2,5,3,8
98251_0,,,,2,5,3,8
98252_0,,,,2,5,3,8
98253_0,,,,2,5,3,8
98254_0,,,,2,5,3,8
98255_0,,,,2,5,3,8
98256_0,,,,2,5,3,8
98257_0,,,,2,5,3,8
98258_0,,,,2,5,3,8
98259_0,,,,2,5,3,8
98260_0,,,,2,5,3,8
98261_0,,,,2,5,3,8
98262_0,,,,2,5,3,8
98263_0,,,,2,5,3,8
98264_0,,,,2,5,3,8
98265_0,,,,2,5,3,8
98266_0,,,,2,5,3,8
98267_0,,,,2,5,3,8
98268_0,,,,2,5,3,8
98269_0,,,,2,5,3,8
98270_0,,,,2,5,3,8
98271_0,,,,2,5,3,8
98272_0,,,,2,5,3,8
98273_0,,,,2,5,3,8
98274_0,,,,2,5,3,8
98275_0,,,,2,5,3,8
98276_0,,,,2,5,3,8
98277_0,,,,2,5,3,8
98278_0,,,,2,5,3,8
98279_0,,,,2,5,3,8
98280_0,,,,2,5,3,8
98281_0,,,,2,5,3,8
98282_0,,,,2,5,3,8
98283_0,,,,2,5,3,8
98284_0,,,,2,5,3,8
98285_0,,,,2,5,3,8
98286_0,,,,2,5,3,8
98287_0,,,,2,5,3,8
98288_0,,,,2,5,3,8
98289_0,,,,2,5,3,8
98290_0,,,,2,5,3,8
98291_0,,,,2,5,3,8
98292_0,,,,2,5,3,8
98293_0,,,,2,5,3,8
98294_0,,,,2,5,3,8
98295_0,,,,2,5,3,8
98296_0,,,,2,5,3,8
98297_0,,,,2,5,3,8
98298_0,,,,2,5,3,8
98299_0,,,,2,5,3,8
98300_0,,,,2,5,3,8
98301_0,,,,2,5,3,8
98302_0,,,,2,5,3,8
98303_0,,,,2,5,3,8
98304_0,,,,2,5,3,8
98305_0,,,,2,5,3,8
98306_0,,,,2,5,3,8
98307_0,,,,2,5,3,8
98308_0,,,,2,5,3,8
98309_0,,,,2,5,3,8
98310_0,,,,2,5,3,8
98311_0,,,,2,5,3,8
98312_0,,,,2,5,3,8
98313_0,,,,2,5,3,8
98314_0,,,,2,5,3,8
98315_0,,,,2,5,3,8
98316_0,,,,2,5,3,8
98317_0,,,,2,5,3,8
98318_0,,,,2,5,3,8
98319_0,,,,2,5,3,8
98320_0,,,,2,5,3,8
98321_0,,,,2,5,3,8
98322_0,,,,2,5,3,8
98323_0,,,,2,5,3,8
98324_0,,,,2,5,3,8
98325_0,,,,2,5,3,8
98326_0,,,,2,5,3,8
98327_0,,,,2,5,3,8
98328_0,,,,2,5,3,8
98329_0,,,,2,5,3,8
98330_0,,,,2,5,3,8
98331_0,,,,2,5,3,8
98332_0,,,,2,5,3,8
98333_0,,,,2,5,3,8
98334_0,,,,2,5,3,8
98335_0,,,,2,5,3,8
98336_0,,,,2,5,3,8
98337_0,,,,2,5,3,8
98338_0,,,,2,5,3,8
98339_0,,,,2,5,3,8
98340_0,,,,2,5,3,8
98341_0,,,,2,5,3,8
98342_0,,,,2,5,3,8
98343_0,,,,2,5,3,8
98344_0,,,,2,5,3,8
98345_0,,,,2,5,3,8
98346_0,,,,2,5,3,8
98347_0,,,,2,5,3,8
98348_0,,,,2,5,3,8
98349_0,,,,2,5,3,8
98350_0,,,,2,5,3,8
98351_0,,,,2,5,3,8
98352_0,,,,2,5,3,8
98353_0,,,,2,5,3,8
98354_0,,,,2,5,3,8
98355_0,,,,2,5,3,8
98356_0,,,,2,5,3,8
98357_0,,,,2,5,3,8
98358_0,,,,2,5,3,8
98359_0,,,,2,5,3,8
98360_0,,,,2,5,3,8
98361_0,,,,2,5,3,8
98362_0,,,,2,5,3,8
98363_0,,,,2,5,3,8
98364_0,,,,2,5,3,8
98365_0,,,,2,5,3,8
98366_0,,,,2,5,3,8
98367_0,,,,2,5,3,8
98368_0,,,,2,5,3,8
98369_0,,,,2,5,3,8
98370_0,,,,2,5,3,8
98371_0,,,,2,5,3,8
98372_0,,,,2,5,3,8
98373_0,,,,2,5,3,8
98374_0,,,,2,5,3,8
98375_0,,,,2,5,3,8
98376_0,,,,2,5,3,8
98377_0,,,,2,5,3,8
98378_0,,,,2,5,3,8
98379_0,,,,2,5,3,8
98380_0,,,,2,5,3,8
98381_0,,,,2,5,3,8
98382_0,,,,2,5,3,8
98383_0,,,,2,5,3,8
98384_0,,,,2,5,3,8
98385_0,,,,2,5,3,8
98386_0,,,,2,5,3,8
98387_0,,,,2,5,3,8
98388_0,,,,2,5,3,8
98389_0,,,,2,5,3,8
98390_0,,,,2,5,3,8
98391_0,,,,2,5,3,8
98392_0,,,,2,5,3,8
98393_0,,,,2,5,3,8
98394_0,,,,2,5,3,8
98395_0,,,,2,5,3,8
98396_0,,,,2,5,3,8
98397_0,,,,2,5,3,8
98398_0,,,,2,2,2,4
98399_0,,,,2,2,2,4
98400_0,,,,2,2,2,4
98401_0,,,,2,2,2,4
98402_0,,,,2,2,2,4
98403_0,,,,2,2,2,4
98404_0,,,,2,2,2,4
98405_0,,,,2,2,2,4
98406_0,,,,2,2,2,4
98407_0,,,,2,2,2,4
98408_0,,,,2,2,2,4
98409_0,,,,2,2,2,4
98410_0,,,,2,2,2,4
98411_0,,,,2,2,2,4
98412_0,,,,2,2,2,4
98413_0,,,,2,2,2,4
98414_0,,,,2,2,2,4
98415_0,,,,2,2,2,4
98416_0,,,,2,2,2,4
98417_0,,,,2,2,2,4
98418_0,,,,2,2,2,4
98419_0,,,,2,2,2,4
98420_0,,,,2,2,2,4
98421_0,,,,2,2,2,4
98422_0,,,,2,2,2,4
98424_0,,,,2,2,2,4
C(C(CC(CO)C(C=O)O)O)(O)=O,,,5,1,1,0,1
98425_0,,,,2,2,2,4
98426_0,,,,2,2,2,4
98427_0,,,,2,2,2,4
98428_0,,,,2,2,2,4
98429_0,,,,2,2,2,4
98430_0,,,,2,2,2,4
98431_0,,,,2,2,2,4
98432_0,,,,2,2,2,4
98433_0,,,,2,2,2,4
98434_0,,,,2,2,2,4
98435_0,,,,2,2,2,4
98436_0,,,,2,2,2,4
98437_0,,,,2,2,2,4
98438_0,,,,2,2,2,4
98439_0,,,,2,2,2,4
98440_0,,,,2,2,2,4
98441_0,,,,2,2,2,4
98442_0,,,,2,2,2,4
98443_0,,,,2,2,2,4
98444_0,,,,2,2,2,4
98445_0,,,,2,2,2,4
98446_0,,,,2,2,2,4
98447_0,,,,2,2,2,4
98449_0,,,,2,2,2,4
C(C(CC1C(C(CO1)O)=O)O)(O)=O,,,5,1,1,0,1
98451_0,,,,2,2,2,4
C(C(CC1C(C(O)OC1)=O)O)(O)=O,,,5,1,1,0,1
98453_0,,,,2,2,2,4
C(C(CC1C(COC1O)=O)O)(O)=O,,,5,1,1,0,1
98455_0,,,,2,2,2,4
C(C(CC1C(CC(O1)O)=O)O)(O)=O,,,5,1,1,0,1
98456_0,,,,2,2,2,4
98457_0,,,,2,2,2,4
98458_0,,,,2,2,2,4
98459_0,,,,2,2,2,4
98460_0,,,,2,2,2,4
98461_0,,,,2,2,2,4
98462_0,,,,2,2,2,4
98463_0,,,,2,2,2,4
98464_0,,,,2,2,2,4
98465_0,,,,2,2,2,4
98466_0,,,,2,2,2,4
98467_0,,,,2,2,2,4
98468_0,,,,2,2,2,4
98469_0,,,,2,2,2,4
98471_0,,,,2,2,2,4
C(C(CC(CO)(C(C)O)O)O)(O)=O,,,5,1,1,0,1
98472_0,,,,2,2,2,4
98473_0,,,,2,2,2,4
98475_0,,,,2,2,2,4
C(C(CC(O)O)O)(O)=O,,,5,1,1,0,1
98476_0,,,,2,2,2,4
98477_0,,,,2,2,2,4
98478_0,,,,2,2,2,4
98480_0,,,,2,2,2,4
C(C(CC(OCC=O)O)O)(O)=O,,,5,1,1,0,1
98481_0,,,,2,2,2,4
98482_0,,,,2,2,2,4
98483_0,,,,2,2,2,4
98484_0,,,,2,2,2,4
98485_0,,,,2,2,2,4
98486_0,,,,2,2,2,4
98487_0,,,,2,2,2,4
98489_0,,,,2,2,2,4
C(C(C=O)(CO)CC(C(O)=O)O)=O,,,5,1,1,0,1
98490_0,,,,2,2,2,4
98492_0,,,,2,2,2,4
C(C(C=O)(CC(C(O)=O)O)O)=O,,,5,1,1,0,1
98494_0,,,,2,2,2,4
C(C(CC1(C(COC1)=O)O)O)(O)=O,,,5,1,1,0,1
98496_0,,,,2,2,2,4
C1(C(CC(C(O)=O)O)C(CO1)O)=O,,,5,1,1,0,1
98497_0,,,,2,2,2,4
98499_0,,,,2,2,2,4
C(C(CC1(C(CCO1)=O)O)O)(O)=O,,,5,1,1,0,1
98501_0,,,,2,2,2,4
C(C(C=C)(CC(C(O)=O)O)O)(O)=O,,,5,1,1,0,1
98503_0,,,,2,2,2,4
C1(C(CC(C(O)=O)O)(CCO1)O)=O,,,5,1,1,0,1
98505_0,,,,2,2,2,4
C(C(CC(C=O)(O)O)O)(O)=O,,,5,1,1,0,1
98507_0,,,,2,2,2,4
C(C(C[C](C(O)=O)O)O)(O)=O,,,5,1,2,0,2
98508_0,,,,2,2,2,4
98509_0,,,,2,2,2,4
98511_0,,,,2,2,2,4
C(C(CCOC(CO)=O)O)(O)=O,,,5,1,1,0,1
98512_0,,,,2,2,2,4
98513_0,,,,2,2,2,4
98514_0,,,,2,2,2,4
98515_0,,,,2,2,2,4
98516_0,,,,2,2,2,4
98517_0,,,,2,2,2,4
98518_0,,,,2,2,2,4
98519_0,,,,2,2,2,4
98520_0,,,,2,2,2,4
98521_0,,,,2,2,2,4
98522_0,,,,2,2,2,4
98523_0,,,,2,3,5,8
98524_0,,,,2,3,5,8
98525_0,,,,2,3,5,8
98526_0,,,,2,3,5,8
98527_0,,,,2,3,5,8
98528_0,,,,2,3,5,8
98529_0,,,,2,3,5,8
98530_0,,,,2,3,5,8
98531_0,,,,2,3,5,8
98532_0,,,,2,3,5,8
98533_0,,,,2,3,5,8
98534_0,,,,2,3,5,8
98535_0,,,,2,3,5,8
98536_0,,,,2,3,5,8
98537_0,,,,2,3,5,8
98538_0,,,,2,3,5,8
98539_0,,,,2,3,5,8
98540_0,,,,2,3,5,8
98541_0,,,,2,3,5,8
98542_0,,,,2,3,5,8
98543_0,,,,2,3,5,8
98544_0,,,,2,3,5,8
98545_0,,,,2,3,5,8
98546_0,,,,2,3,5,8
98547_0,,,,2,3,5,8
98548_0,,,,2,3,5,8
98549_0,,,,2,3,5,8
98550_0,,,,2,3,5,8
98551_0,,,,2,3,5,8
98553_0,,,,2,3,5,8
C(C(C(C=O)=O)(CC(C=O)O)O)=O,,,5,1,1,0,1
98554_0,,,,2,3,5,8
98555_0,,,,2,3,5,8
98556_0,,,,2,3,5,8
98557_0,,,,2,3,5,8
98559_0,,,,2,3,5,8
C(C(C(C=O)=O)(CC(CO)O)O)=O,,,5,1,1,0,1
98560_0,,,,2,3,5,8
98561_0,,,,2,3,5,8
98562_0,,,,2,3,5,8
98563_0,,,,2,3,5,8
98564_0,,,,2,3,5,8
98565_0,,,,2,3,5,8
98566_0,,,,2,3,5,8
98567_0,,,,2,3,5,8
98568_0,,,,2,3,5,8
98569_0,,,,2,3,5,8
98571_0,,,,2,3,5,8
C(C(C(C=O)=O)(C(CO)CO)O)=O,,,5,1,1,0,1
98572_0,,,,2,3,5,8
98573_0,,,,2,3,5,8
98574_0,,,,2,3,5,8
98575_0,,,,2,3,5,8
98576_0,,,,2,3,5,8
98577_0,,,,2,3,5,8
98578_0,,,,2,3,5,8
98579_0,,,,2,3,5,8
98580_0,,,,2,3,5,8
98581_0,,,,2,3,5,8
98582_0,,,,2,3,5,8
98583_0,,,,2,3,5,8
98584_0,,,,2,3,5,8
98585_0,,,,2,3,5,8
98586_0,,,,2,3,5,8
98587_0,,,,2,3,5,8
98588_0,,,,2,3,5,8
98589_0,,,,2,3,5,8
98590_0,,,,2,3,5,8
98591_0,,,,2,3,5,8
98592_0,,,,2,3,5,8
98593_0,,,,2,3,5,8
98594_0,,,,2,3,5,8
98595_0,,,,2,3,5,8
98596_0,,,,2,3,5,8
98597_0,,,,2,3,5,8
98598_0,,,,2,3,5,8
98599_0,,,,2,3,5,8
98600_0,,,,2,3,5,8
98601_0,,,,2,3,5,8
98602_0,,,,2,3,5,8
98603_0,,,,2,3,5,8
98604_0,,,,2,3,5,8
98605_0,,,,2,3,5,8
98606_0,,,,2,3,5,8
98607_0,,,,2,3,5,8
98608_0,,,,2,3,5,8
98609_0,,,,2,3,5,8
98610_0,,,,2,3,5,8
98611_0,,,,2,3,5,8
98612_0,,,,2,3,5,8
98613_0,,,,2,3,5,8
98614_0,,,,2,3,5,8
98615_0,,,,2,3,5,8
98616_0,,,,2,3,5,8
98617_0,,,,2,3,5,8
98618_0,,,,2,3,5,8
98619_0,,,,2,3,5,8
98620_0,,,,2,3,5,8
98621_0,,,,2,3,5,8
98622_0,,,,2,3,5,8
98623_0,,,,2,3,5,8
98624_0,,,,2,3,5,8
98625_0,,,,2,3,5,8
98626_0,,,,2,3,5,8
98627_0,,,,2,3,5,8
98628_0,,,,2,3,5,8
98629_0,,,,2,3,5,8
98630_0,,,,2,3,5,8
98631_0,,,,2,3,5,8
98632_0,,,,2,3,5,8
98633_0,,,,2,3,5,8
98634_0,,,,2,3,5,8
98635_0,,,,2,3,5,8
98636_0,,,,2,3,5,8
98637_0,,,,2,3,5,8
98638_0,,,,2,3,5,8
98639_0,,,,2,3,5,8
98640_0,,,,2,3,5,8
98641_0,,,,2,3,5,8
98642_0,,,,2,3,5,8
98643_0,,,,2,3,5,8
98644_0,,,,2,3,5,8
98645_0,,,,2,3,5,8
98646_0,,,,2,3,5,8
98647_0,,,,2,3,5,8
98648_0,,,,2,3,5,8
98649_0,,,,2,3,5,8
98650_0,,,,2,3,5,8
98651_0,,,,2,3,5,8
98652_0,,,,2,3,5,8
98653_0,,,,2,3,5,8
98654_0,,,,2,3,5,8
98655_0,,,,2,3,5,8
98656_0,,,,2,3,5,8
98657_0,,,,2,3,5,8
98658_0,,,,2,3,5,8
98659_0,,,,2,3,5,8
98660_0,,,,2,3,5,8
98661_0,,,,2,3,5,8
98662_0,,,,2,3,5,8
98663_0,,,,2,3,5,8
98664_0,,,,2,3,5,8
98665_0,,,,2,3,5,8
98666_0,,,,2,3,5,8
98667_0,,,,2,3,5,8
98668_0,,,,2,3,5,8
98669_0,,,,2,3,5,8
98670_0,,,,2,3,5,8
98671_0,,,,2,3,5,8
98672_0,,,,2,3,5,8
98673_0,,,,2,3,5,8
98674_0,,,,2,3,5,8
98675_0,,,,2,3,5,8
98676_0,,,,2,3,5,8
98677_0,,,,2,3,5,8
98678_0,,,,2,3,5,8
98679_0,,,,2,3,5,8
98680_0,,,,2,3,5,8
98681_0,,,,2,3,5,8
98682_0,,,,2,3,5,8
98683_0,,,,2,3,5,8
98684_0,,,,2,3,5,8
98685_0,,,,2,3,5,8
98686_0,,,,2,3,5,8
98687_0,,,,2,3,5,8
98688_0,,,,2,3,5,8
98689_0,,,,2,3,5,8
98690_0,,,,2,3,5,8
98691_0,,,,2,3,5,8
98692_0,,,,2,3,5,8
98693_0,,,,2,3,5,8
98694_0,,,,2,3,5,8
98695_0,,,,2,3,5,8
98696_0,,,,2,3,5,8
98697_0,,,,2,3,5,8
98698_0,,,,2,3,5,8
98699_0,,,,2,3,5,8
98700_0,,,,2,3,5,8
98701_0,,,,2,3,5,8
98702_0,,,,2,3,5,8
98703_0,,,,2,3,5,8
98704_0,,,,2,3,5,8
98705_0,,,,2,3,5,8
98706_0,,,,2,3,5,8
98707_0,,,,2,3,5,8
98708_0,,,,2,3,5,8
98709_0,,,,2,3,5,8
98710_0,,,,2,3,5,8
98711_0,,,,2,3,5,8
98712_0,,,,2,3,5,8
98713_0,,,,2,3,5,8
98715_0,,,,2,3,5,8
C(C(O)OCC(C=O)=O)=O,,,5,1,1,0,1
98716_0,,,,2,3,5,8
98718_0,,,,2,3,5,8
C(C(OC(C(C=O)=O)CO)O)=O,,,5,1,1,0,1
98719_0,,,,2,3,5,8
98720_0,,,,2,3,5,8
98721_0,,,,2,3,5,8
98722_0,,,,2,3,5,8
98723_0,,,,2,3,5,8
98724_0,,,,2,3,5,8
98725_0,,,,2,3,5,8
98726_0,,,,2,3,5,8
98727_0,,,,2,3,5,8
98728_0,,,,2,3,5,8
98729_0,,,,2,3,5,8
98730_0,,,,2,3,5,8
98731_0,,,,2,3,5,8
98732_0,,,,2,3,5,8
98733_0,,,,2,3,5,8
98734_0,,,,2,3,5,8
98735_0,,,,2,3,5,8
98736_0,,,,2,3,5,8
98737_0,,,,2,3,5,8
98738_0,,,,2,3,5,8
98739_0,,,,2,3,5,8
98740_0,,,,2,3,5,8
98741_0,,,,2,3,5,8
98742_0,,,,2,3,5,8
98743_0,,,,2,3,5,8
98744_0,,,,2,3,5,8
98745_0,,,,2,3,5,8
98746_0,,,,2,3,5,8
98747_0,,,,2,3,5,8
98748_0,,,,2,3,5,8
98749_0,,,,2,3,5,8
98750_0,,,,2,3,5,8
98751_0,,,,2,3,5,8
98752_0,,,,2,3,5,8
98753_0,,,,2,3,5,8
98754_0,,,,2,3,5,8
98755_0,,,,2,3,5,8
98756_0,,,,2,3,5,8
98757_0,,,,2,3,5,8
98758_0,,,,2,3,5,8
98759_0,,,,2,3,5,8
98760_0,,,,2,3,5,8
98761_0,,,,2,3,5,8
98762_0,,,,2,3,5,8
98763_0,,,,2,3,5,8
98764_0,,,,2,3,5,8
98765_0,,,,2,3,5,8
98766_0,,,,2,3,5,8
98767_0,,,,2,3,5,8
98768_0,,,,2,3,5,8
98769_0,,,,2,3,5,8
98770_0,,,,2,3,5,8
98771_0,,,,2,3,5,8
98772_0,,,,2,3,5,8
98773_0,,,,2,3,5,8
98774_0,,,,2,3,5,8
98775_0,,,,2,3,5,8
98776_0,,,,2,3,5,8
98777_0,,,,2,3,5,8
98778_0,,,,2,3,5,8
98779_0,,,,2,3,5,8
98780_0,,,,2,3,5,8
98781_0,,,,2,3,5,8
98782_0,,,,2,3,5,8
98783_0,,,,2,3,5,8
98784_0,,,,2,3,5,8
98785_0,,,,2,3,5,8
98786_0,,,,2,3,5,8
98787_0,,,,2,3,5,8
98788_0,,,,2,3,5,8
98789_0,,,,2,3,5,8
98790_0,,,,2,3,5,8
98791_0,,,,2,3,5,8
98792_0,,,,2,3,5,8
98793_0,,,,2,3,5,8
98794_0,,,,2,3,5,8
98795_0,,,,2,3,5,8
98796_0,,,,2,3,5,8
98797_0,,,,2,3,5,8
98798_0,,,,2,3,5,8
98799_0,,,,2,3,5,8
98800_0,,,,2,3,5,8
98801_0,,,,2,3,5,8
98802_0,,,,2,3,5,8
98803_0,,,,2,3,5,8
98804_0,,,,2,3,5,8
98805_0,,,,2,3,5,8
98806_0,,,,2,3,5,8
98808_0,,,,2,3,5,8
C(C(C(C=O)=O)(C(C=O)=O)CO)=O,,,5,1,1,0,1
98809_0,,,,2,3,5,8
98810_0,,,,2,3,5,8
98811_0,,,,2,3,5,8
98812_0,,,,2,3,5,8
98813_0,,,,2,3,5,8
98814_0,,,,2,3,5,8
98815_0,,,,2,3,5,8
98816_0,,,,2,3,5,8
98817_0,,,,2,3,5,8
98818_0,,,,2,3,5,8
98820_0,,,,2,3,5,8
C(CC(C(CO)=O)(C(C=O)=O)O)=O,,,5,1,1,0,1
98821_0,,,,2,3,5,8
98822_0,,,,2,3,5,8
98823_0,,,,2,3,5,8
98824_0,,,,2,3,5,8
98825_0,,,,2,3,5,8
98826_0,,,,2,3,5,8
98827_0,,,,2,3,5,8
98828_0,,,,2,3,5,8
98829_0,,,,2,3,5,8
98830_0,,,,2,3,5,8
98831_0,,,,2,3,5,8
98832_0,,,,2,3,5,8
98833_0,,,,2,3,5,8
98834_0,,,,2,3,5,8
98836_0,,,,2,3,5,8
C(C(C(C=O)=O)(CC(O)=O)O)(O)=O,,,5,1,1,0,1
98837_0,,,,2,3,5,8
98838_0,,,,2,3,5,8
98839_0,,,,2,3,5,8
98840_0,,,,2,3,5,8
98841_0,,,,2,3,5,8
98842_0,,,,2,3,5,8
98843_0,,,,2,3,5,8
98844_0,,,,2,3,5,8
98845_0,,,,2,3,5,8
98846_0,,,,2,3,5,8
98847_0,,,,2,3,5,8
98848_0,,,,2,3,5,8
98849_0,,,,2,3,5,8
98850_0,,,,2,3,5,8
98851_0,,,,2,3,5,8
98852_0,,,,2,3,5,8
98853_0,,,,2,3,5,8
98854_0,,,,2,3,5,8
98855_0,,,,2,3,5,8
98856_0,,,,2,3,5,8
98857_0,,,,2,3,5,8
98858_0,,,,2,3,5,8
98859_0,,,,2,3,5,8
98860_0,,,,2,3,5,8
98861_0,,,,2,3,5,8
98862_0,,,,2,3,5,8
98863_0,,,,2,3,5,8
98864_0,,,,2,3,5,8
98865_0,,,,2,3,5,8
98866_0,,,,2,3,5,8
98867_0,,,,2,3,5,8
98868_0,,,,2,3,5,8
98869_0,,,,2,3,5,8
98870_0,,,,2,3,5,8
98871_0,,,,2,3,5,8
98872_0,,,,2,3,5,8
98873_0,,,,2,3,5,8
98874_0,,,,2,3,5,8
98875_0,,,,2,3,5,8
98876_0,,,,2,3,5,8
98877_0,,,,2,3,5,8
98878_0,,,,2,3,5,8
98879_0,,,,2,3,5,8
98880_0,,,,2,3,5,8
98881_0,,,,2,3,5,8
98882_0,,,,2,3,5,8
98883_0,,,,2,3,5,8
98884_0,,,,2,3,5,8
98885_0,,,,2,3,5,8
98886_0,,,,2,3,5,8
98887_0,,,,2,3,5,8
98888_0,,,,2,3,5,8
98889_0,,,,2,3,5,8
98890_0,,,,2,3,5,8
98891_0,,,,2,3,5,8
98892_0,,,,2,3,5,8
98893_0,,,,2,3,5,8
98894_0,,,,2,3,5,8
98895_0,,,,2,3,5,8
98896_0,,,,2,3,5,8
98897_0,,,,2,3,5,8
98898_0,,,,2,3,5,8
98899_0,,,,2,3,5,8
98900_0,,,,2,3,5,8
98901_0,,,,2,3,5,8
98902_0,,,,2,3,5,8
98903_0,,,,2,3,5,8
98904_0,,,,2,3,5,8
98905_0,,,,2,3,5,8
98906_0,,,,2,3,5,8
98907_0,,,,2,3,5,8
98908_0,,,,2,3,5,8
98909_0,,,,2,3,5,8
98910_0,,,,2,3,5,8
98911_0,,,,2,3,5,8
98912_0,,,,2,3,5,8
98913_0,,,,2,3,5,8
98914_0,,,,2,3,5,8
98915_0,,,,2,3,5,8
98916_0,,,,2,3,5,8
98917_0,,,,2,3,5,8
98918_0,,,,2,3,5,8
98919_0,,,,2,3,5,8
98920_0,,,,2,3,5,8
98921_0,,,,2,3,5,8
98922_0,,,,2,3,5,8
98923_0,,,,2,3,5,8
98924_0,,,,2,3,5,8
98925_0,,,,2,3,5,8
98926_0,,,,2,3,5,8
98927_0,,,,2,3,5,8
98928_0,,,,2,3,5,8
98929_0,,,,2,3,5,8
98930_0,,,,2,3,5,8
98931_0,,,,2,3,5,8
98932_0,,,,2,3,5,8
98933_0,,,,2,3,5,8
98934_0,,,,2,3,5,8
98935_0,,,,2,3,5,8
98936_0,,,,2,3,5,8
98937_0,,,,2,3,5,8
98938_0,,,,2,3,5,8
98939_0,,,,2,3,5,8
98940_0,,,,2,3,5,8
98941_0,,,,2,3,5,8
98942_0,,,,2,3,5,8
98943_0,,,,2,3,5,8
98944_0,,,,2,3,5,8
98945_0,,,,2,3,5,8
98946_0,,,,2,3,5,8
98947_0,,,,2,3,5,8
98948_0,,,,2,3,5,8
98949_0,,,,2,3,5,8
98950_0,,,,2,3,5,8
98951_0,,,,2,3,5,8
98952_0,,,,2,3,5,8
98953_0,,,,2,3,5,8
98954_0,,,,2,3,5,8
98955_0,,,,2,3,5,8
98956_0,,,,2,3,5,8
98957_0,,,,2,3,5,8
98958_0,,,,2,3,5,8
98959_0,,,,2,3,5,8
98960_0,,,,2,3,5,8
98961_0,,,,2,3,5,8
98962_0,,,,2,3,5,8
98963_0,,,,2,3,5,8
98964_0,,,,2,3,5,8
98965_0,,,,2,3,5,8
98966_0,,,,2,3,5,8
98967_0,,,,2,3,5,8
98968_0,,,,2,3,5,8
98969_0,,,,2,3,5,8
98970_0,,,,2,3,5,8
98971_0,,,,2,3,5,8
98972_0,,,,2,3,5,8
98973_0,,,,2,3,5,8
98974_0,,,,2,3,5,8
98975_0,,,,2,3,5,8
98976_0,,,,2,3,5,8
98977_0,,,,2,3,5,8
98978_0,,,,2,3,5,8
98979_0,,,,2,3,5,8
98980_0,,,,2,3,5,8
98981_0,,,,2,3,5,8
98982_0,,,,2,3,5,8
98983_0,,,,2,3,5,8
98984_0,,,,2,3,5,8
98985_0,,,,2,3,5,8
98986_0,,,,2,3,5,8
98987_0,,,,2,3,5,8
98988_0,,,,2,3,5,8
98989_0,,,,2,3,5,8
98990_0,,,,2,3,5,8
98991_0,,,,2,3,5,8
98992_0,,,,2,3,5,8
98993_0,,,,2,3,5,8
98994_0,,,,2,3,5,8
98995_0,,,,2,3,5,8
98996_0,,,,2,3,5,8
98997_0,,,,2,3,5,8
98998_0,,,,2,3,5,8
98999_0,,,,2,3,5,8
99000_0,,,,2,3,5,8
99001_0,,,,2,3,5,8
99002_0,,,,2,3,5,8
99003_0,,,,2,3,5,8
99004_0,,,,2,3,5,8
99005_0,,,,2,3,5,8
99006_0,,,,2,5,3,8
99008_0,,,,2,5,3,8
C(C(C1C(C(CC1O)O)O)O)=O,,,5,1,1,0,1
99009_0,,,,2,5,3,8
99010_0,,,,2,5,3,8
99011_0,,,,2,5,3,8
99012_0,,,,2,5,3,8
99013_0,,,,2,5,3,8
99015_0,,,,2,5,3,8
C(C(C)(C(C(C)O)C(C=O)O)O)=O,,,5,1,1,0,1
99016_0,,,,2,5,3,8
99017_0,,,,2,5,3,8
99018_0,,,,2,5,3,8
99020_0,,,,2,5,3,8
C(C(C(C(C)O)C(C(C)=O)O)O)=O,,,5,1,1,0,1
99021_0,,,,2,5,3,8
99022_0,,,,2,5,3,8
99023_0,,,,2,5,3,8
99024_0,,,,2,5,3,8
99025_0,,,,2,5,3,8
99026_0,,,,2,5,3,8
99027_0,,,,2,5,3,8
99028_0,,,,2,5,3,8
99029_0,,,,2,5,3,8
99030_0,,,,2,5,3,8
99031_0,,,,2,5,3,8
99033_0,,,,2,5,3,8
C(C(C(C(C)O)C(CO)(C)O)O)=O,,,5,1,1,0,1
99034_0,,,,2,5,3,8
99036_0,,,,2,5,3,8
C(C(C(C(C(O)O)O)C(C)O)O)=O,,,5,1,1,0,1
99038_0,,,,2,5,3,8
C(C(C(C(C(C)O)O)C(C)O)O)=O,,,5,1,1,0,1
99039_0,,,,2,5,3,8
99041_0,,,,2,5,3,8
C(C(C(C(C)O)C(C)O)O)=O,,,5,1,1,0,1
99043_0,,,,2,5,3,8
C(C(C(C(CO)O)C(C)O)O)=O,,,5,1,1,0,1
99044_0,,,,2,5,3,8
99045_0,,,,2,5,3,8
99046_0,,,,2,5,3,8
99047_0,,,,2,5,3,8
99049_0,,,,2,5,3,8
C(C(C(C(CO)O)C(CO)O)O)=O,,,5,1,1,0,1
99050_0,,,,2,5,3,8
99051_0,,,,2,5,3,8
99052_0,,,,2,5,3,8
99053_0,,,,2,5,3,8
99054_0,,,,2,5,3,8
99055_0,,,,2,5,3,8
99056_0,,,,2,5,3,8
99057_0,,,,2,5,3,8
99058_0,,,,2,5,3,8
99059_0,,,,2,5,3,8
99060_0,,,,2,5,3,8
99061_0,,,,2,5,3,8
99062_0,,,,2,5,3,8
99063_0,,,,2,5,3,8
99064_0,,,,2,5,3,8
99065_0,,,,2,5,3,8
99066_0,,,,2,5,3,8
99067_0,,,,2,5,3,8
99068_0,,,,2,5,3,8
99069_0,,,,2,5,3,8
99070_0,,,,2,5,3,8
99071_0,,,,2,5,3,8
99072_0,,,,2,5,3,8
99073_0,,,,2,5,3,8
99074_0,,,,2,5,3,8
99075_0,,,,2,5,3,8
99076_0,,,,2,5,3,8
99077_0,,,,2,5,3,8
99078_0,,,,2,5,3,8
99079_0,,,,2,5,3,8
99080_0,,,,2,5,3,8
99081_0,,,,2,5,3,8
99082_0,,,,2,5,3,8
99083_0,,,,2,5,3,8
99084_0,,,,2,5,3,8
99085_0,,,,2,5,3,8
99086_0,,,,2,5,3,8
99087_0,,,,2,5,3,8
99088_0,,,,2,5,3,8
99089_0,,,,2,5,3,8
99090_0,,,,2,5,3,8
99091_0,,,,2,5,3,8
99092_0,,,,2,5,3,8
99093_0,,,,2,5,3,8
99094_0,,,,2,5,3,8
99095_0,,,,2,5,3,8
99096_0,,,,2,5,3,8
99097_0,,,,2,5,3,8
99098_0,,,,2,5,3,8
99099_0,,,,2,5,3,8
99100_0,,,,2,5,3,8
99101_0,,,,2,5,3,8
99102_0,,,,2,5,3,8
99103_0,,,,2,5,3,8
99104_0,,,,2,5,3,8
99105_0,,,,2,5,3,8
99106_0,,,,2,5,3,8
99107_0,,,,2,5,3,8
99108_0,,,,2,5,3,8
99109_0,,,,2,5,3,8
99110_0,,,,2,5,3,8
99111_0,,,,2,5,3,8
99112_0,,,,2,5,3,8
99113_0,,,,2,5,3,8
99114_0,,,,2,5,3,8
99115_0,,,,2,5,3,8
99116_0,,,,2,5,3,8
99117_0,,,,2,5,3,8
99118_0,,,,2,5,3,8
99119_0,,,,2,5,3,8
99120_0,,,,2,5,3,8
99121_0,,,,2,5,3,8
99122_0,,,,2,5,3,8
99123_0,,,,2,5,3,8
99124_0,,,,2,5,3,8
99125_0,,,,2,5,3,8
99126_0,,,,2,5,3,8
99127_0,,,,2,5,3,8
99128_0,,,,2,5,3,8
99129_0,,,,2,5,3,8
99130_0,,,,2,5,3,8
99131_0,,,,2,5,3,8
99132_0,,,,2,5,3,8
99133_0,,,,2,5,3,8
99134_0,,,,2,5,3,8
99135_0,,,,2,5,3,8
99136_0,,,,2,5,3,8
99137_0,,,,2,5,3,8
99138_0,,,,2,5,3,8
99139_0,,,,2,5,3,8
99140_0,,,,2,5,3,8
99141_0,,,,2,5,3,8
99142_0,,,,2,5,3,8
99143_0,,,,2,5,3,8
99144_0,,,,2,5,3,8
99145_0,,,,2,5,3,8
99146_0,,,,2,5,3,8
99147_0,,,,2,5,3,8
99148_0,,,,2,5,3,8
99149_0,,,,2,5,3,8
99150_0,,,,2,5,3,8
99151_0,,,,2,5,3,8
99152_0,,,,2,5,3,8
99153_0,,,,2,5,3,8
99154_0,,,,2,5,3,8
99155_0,,,,2,5,3,8
99156_0,,,,2,5,3,8
99157_0,,,,2,5,3,8
99158_0,,,,2,5,3,8
99159_0,,,,2,5,3,8
99160_0,,,,2,5,3,8
99161_0,,,,2,5,3,8
99162_0,,,,2,5,3,8
99163_0,,,,2,5,3,8
99164_0,,,,2,5,3,8
99165_0,,,,2,5,3,8
99166_0,,,,2,5,3,8
99167_0,,,,2,5,3,8
99168_0,,,,2,5,3,8
99169_0,,,,2,5,3,8
99170_0,,,,2,5,3,8
99171_0,,,,2,5,3,8
99172_0,,,,2,5,3,8
99173_0,,,,2,5,3,8
99174_0,,,,2,5,3,8
99175_0,,,,2,5,3,8
99176_0,,,,2,5,3,8
99177_0,,,,2,5,3,8
99178_0,,,,2,5,3,8
99179_0,,,,2,5,3,8
99180_0,,,,2,5,3,8
99181_0,,,,2,5,3,8
99182_0,,,,2,5,3,8
99183_0,,,,2,5,3,8
99184_0,,,,2,5,3,8
99185_0,,,,2,5,3,8
99186_0,,,,2,5,3,8
99187_0,,,,2,5,3,8
99188_0,,,,2,5,3,8
99189_0,,,,2,5,3,8
99190_0,,,,2,5,3,8
99191_0,,,,2,5,3,8
99192_0,,,,2,5,3,8
99193_0,,,,2,5,3,8
99194_0,,,,2,5,3,8
99195_0,,,,2,5,3,8
99196_0,,,,2,5,3,8
99197_0,,,,2,5,3,8
99198_0,,,,2,5,3,8
99199_0,,,,2,5,3,8
99200_0,,,,2,5,3,8
99201_0,,,,2,5,3,8
99202_0,,,,2,5,3,8
99203_0,,,,2,5,3,8
99204_0,,,,2,5,3,8
99205_0,,,,2,5,3,8
99206_0,,,,2,5,3,8
99207_0,,,,2,5,3,8
99208_0,,,,2,5,3,8
99209_0,,,,2,5,3,8
99210_0,,,,2,5,3,8
99211_0,,,,2,5,3,8
99212_0,,,,2,5,3,8
99213_0,,,,2,5,3,8
99214_0,,,,2,5,3,8
99215_0,,,,2,5,3,8
99216_0,,,,2,5,3,8
99217_0,,,,2,5,3,8
99218_0,,,,2,5,3,8
99219_0,,,,2,5,3,8
99220_0,,,,2,5,3,8
99221_0,,,,2,5,3,8
99222_0,,,,2,5,3,8
99223_0,,,,2,5,3,8
99224_0,,,,2,5,3,8
99225_0,,,,2,5,3,8
99226_0,,,,2,5,3,8
99227_0,,,,2,5,3,8
99228_0,,,,2,5,3,8
99229_0,,,,2,5,3,8
99230_0,,,,2,5,3,8
99231_0,,,,2,5,3,8
99232_0,,,,2,5,3,8
99233_0,,,,2,5,3,8
99234_0,,,,2,5,3,8
99235_0,,,,2,5,3,8
99236_0,,,,2,5,3,8
99237_0,,,,2,5,3,8
99238_0,,,,2,5,3,8
99239_0,,,,2,5,3,8
99240_0,,,,2,5,3,8
99241_0,,,,2,5,3,8
99242_0,,,,2,5,3,8
99243_0,,,,2,5,3,8
99244_0,,,,2,5,3,8
99245_0,,,,2,5,3,8
99246_0,,,,2,5,3,8
99247_0,,,,2,5,3,8
99248_0,,,,2,5,3,8
99249_0,,,,2,5,3,8
99250_0,,,,2,5,3,8
99251_0,,,,2,5,3,8
99252_0,,,,2,5,3,8
99253_0,,,,2,5,3,8
99254_0,,,,2,5,3,8
99255_0,,,,2,5,3,8
99256_0,,,,2,5,3,8
99257_0,,,,2,5,3,8
99258_0,,,,2,5,3,8
99259_0,,,,2,5,3,8
99260_0,,,,2,5,3,8
99261_0,,,,2,5,3,8
99262_0,,,,2,5,3,8
99263_0,,,,2,5,3,8
99264_0,,,,2,5,3,8
99265_0,,,,2,5,3,8
99266_0,,,,2,5,3,8
99267_0,,,,2,5,3,8
99268_0,,,,2,5,3,8
99269_0,,,,2,5,3,8
99271_0,,,,2,5,3,8
C(C(C(C)(C(CC(C)O)O)O)O)=O,,,5,1,1,0,1
99272_0,,,,2,5,3,8
99273_0,,,,2,5,3,8
99274_0,,,,2,5,3,8
99275_0,,,,2,5,3,8
99276_0,,,,2,5,3,8
99277_0,,,,2,5,3,8
99278_0,,,,2,5,3,8
99279_0,,,,2,5,3,8
99280_0,,,,2,5,3,8
99281_0,,,,2,5,3,8
99282_0,,,,2,5,3,8
99283_0,,,,2,5,3,8
99285_0,,,,2,5,3,8
C(C(C(C)(C(C(O)O)O)O)O)=O,,,5,1,1,0,1
99286_0,,,,2,5,3,8
99287_0,,,,2,5,3,8
99288_0,,,,2,5,3,8
99289_0,,,,2,5,3,8
99290_0,,,,2,5,3,8
99291_0,,,,2,5,3,8
99293_0,,,,2,5,3,8
C(C(C(C)(C(C)O)O)O)=O,,,5,1,1,0,1
99294_0,,,,2,5,3,8
99295_0,,,,2,5,3,8
99296_0,,,,2,5,3,8
99297_0,,,,2,5,3,8
99298_0,,,,2,5,3,8
99299_0,,,,2,5,3,8
99300_0,,,,2,5,3,8
99301_0,,,,2,5,3,8
99302_0,,,,2,5,3,8
99303_0,,,,2,5,3,8
99304_0,,,,2,5,3,8
99305_0,,,,2,5,3,8
99306_0,,,,2,5,3,8
99307_0,,,,2,5,3,8
99309_0,,,,2,5,3,8
C(C(C(C)C(C(CO)=O)O)O)=O,,,5,1,1,0,1
99310_0,,,,2,5,3,8
99311_0,,,,2,5,3,8
99312_0,,,,2,5,3,8
99313_0,,,,2,5,3,8
99314_0,,,,2,5,3,8
99315_0,,,,2,5,3,8
99316_0,,,,2,5,3,8
99317_0,,,,2,5,3,8
99318_0,,,,2,5,3,8
99319_0,,,,2,5,3,8
99320_0,,,,2,5,3,8
99321_0,,,,2,5,3,8
99322_0,,,,2,5,3,8
99323_0,,,,2,5,3,8
99324_0,,,,2,5,3,8
99325_0,,,,2,5,3,8
99326_0,,,,2,5,3,8
99327_0,,,,2,5,3,8
99328_0,,,,2,5,3,8
99329_0,,,,2,5,3,8
99330_0,,,,2,5,3,8
99331_0,,,,2,5,3,8
99332_0,,,,2,5,3,8
99333_0,,,,2,5,3,8
99334_0,,,,2,5,3,8
99335_0,,,,2,5,3,8
99336_0,,,,2,5,3,8
99337_0,,,,2,5,3,8
99338_0,,,,2,5,3,8
99339_0,,,,2,5,3,8
99340_0,,,,2,5,3,8
99341_0,,,,2,5,3,8
99342_0,,,,2,5,3,8
99343_0,,,,2,5,3,8
99344_0,,,,2,5,3,8
99345_0,,,,2,5,3,8
99346_0,,,,2,5,3,8
99347_0,,,,2,5,3,8
99348_0,,,,2,5,3,8
99349_0,,,,2,5,3,8
99350_0,,,,2,5,3,8
99351_0,,,,2,5,3,8
99352_0,,,,2,5,3,8
99353_0,,,,2,5,3,8
99354_0,,,,2,5,3,8
99355_0,,,,2,5,3,8
99356_0,,,,2,5,3,8
99357_0,,,,2,5,3,8
99358_0,,,,2,5,3,8
99360_0,,,,2,5,3,8
C(C(CO)(C(C)C(C=O)O)O)=O,,,5,1,1,0,1
99361_0,,,,2,5,3,8
99362_0,,,,2,5,3,8
99364_0,,,,2,5,3,8
C(C(C)(C(C)C(C=O)O)O)(O)=O,,,5,1,1,0,1
99365_0,,,,2,5,3,8
99366_0,,,,2,5,3,8
99367_0,,,,2,5,3,8
99368_0,,,,2,5,3,8
99369_0,,,,2,5,3,8
99370_0,,,,2,5,3,8
99371_0,,,,2,5,3,8
99372_0,,,,2,5,3,8
99373_0,,,,2,5,3,8
99374_0,,,,2,5,3,8
99375_0,,,,2,5,3,8
99376_0,,,,2,5,3,8
99377_0,,,,2,5,3,8
99378_0,,,,2,5,3,8
99379_0,,,,2,5,3,8
99380_0,,,,2,5,3,8
99381_0,,,,2,5,3,8
99382_0,,,,2,5,3,8
99383_0,,,,2,5,3,8
99384_0,,,,2,5,3,8
99385_0,,,,2,5,3,8
99386_0,,,,2,5,3,8
99387_0,,,,2,5,3,8
99388_0,,,,2,5,3,8
99389_0,,,,2,5,3,8
99390_0,,,,2,5,3,8
99391_0,,,,2,5,3,8
99392_0,,,,2,5,3,8
99393_0,,,,2,5,3,8
99394_0,,,,2,5,3,8
99395_0,,,,2,5,3,8
99396_0,,,,2,5,3,8
99397_0,,,,2,5,3,8
99398_0,,,,2,5,3,8
99399_0,,,,2,5,3,8
99400_0,,,,2,5,3,8
99401_0,,,,2,5,3,8
99402_0,,,,2,5,3,8
99403_0,,,,2,5,3,8
99404_0,,,,2,5,3,8
99405_0,,,,2,5,3,8
99406_0,,,,2,5,3,8
99407_0,,,,2,5,3,8
99408_0,,,,2,5,3,8
99409_0,,,,2,5,3,8
99410_0,,,,2,5,3,8
99411_0,,,,2,5,3,8
99412_0,,,,2,5,3,8
99413_0,,,,2,5,3,8
99414_0,,,,2,5,3,8
99415_0,,,,2,5,3,8
99416_0,,,,2,5,3,8
99417_0,,,,2,5,3,8
99418_0,,,,2,5,3,8
99419_0,,,,2,5,3,8
99420_0,,,,2,5,3,8
99421_0,,,,2,5,3,8
99422_0,,,,2,5,3,8
99423_0,,,,2,5,3,8
99424_0,,,,2,5,3,8
99425_0,,,,2,5,3,8
99426_0,,,,2,5,3,8
99427_0,,,,2,5,3,8
99428_0,,,,2,5,3,8
99429_0,,,,2,5,3,8
99430_0,,,,2,5,3,8
99431_0,,,,2,5,3,8
99432_0,,,,2,5,3,8
99433_0,,,,2,5,3,8
99434_0,,,,2,5,3,8
99435_0,,,,2,5,3,8
99436_0,,,,2,5,3,8
99437_0,,,,2,5,3,8
99438_0,,,,2,5,3,8
99439_0,,,,2,5,3,8
99440_0,,,,2,5,3,8
99441_0,,,,2,5,3,8
99442_0,,,,2,5,3,8
99443_0,,,,2,5,3,8
99444_0,,,,2,5,3,8
99445_0,,,,2,5,3,8
99446_0,,,,2,5,3,8
99447_0,,,,2,5,3,8
99448_0,,,,2,5,3,8
99449_0,,,,2,5,3,8
99450_0,,,,2,5,3,8
99451_0,,,,2,5,3,8
99452_0,,,,2,5,3,8
99453_0,,,,2,5,3,8
99454_0,,,,2,5,3,8
99455_0,,,,2,5,3,8
99456_0,,,,2,5,3,8
99457_0,,,,2,5,3,8
99458_0,,,,2,5,3,8
99459_0,,,,2,5,3,8
99460_0,,,,2,5,3,8
99461_0,,,,2,5,3,8
99462_0,,,,2,5,3,8
99463_0,,,,2,5,3,8
99464_0,,,,2,5,3,8
99465_0,,,,2,5,3,8
99466_0,,,,2,5,3,8
99467_0,,,,2,5,3,8
99468_0,,,,2,5,3,8
99469_0,,,,2,5,3,8
99471_0,,,,2,5,3,8
C(C(C=O)C(CCC(C=O)O)O)=O,,,5,1,1,0,1
99473_0,,,,2,5,3,8
C(C(C=O)(CO)CCC(C=O)O)=O,,,5,1,1,0,1
99475_0,,,,2,5,3,8
C(C(C(C)O)CCC(C=O)O)=O,,,5,1,1,0,1
99477_0,,,,2,5,3,8
C(CC(C)(CCC(C=O)O)O)=O,,,5,1,1,0,1
99479_0,,,,2,5,3,8
C(CC(CCCC(C=O)O)O)=O,,,5,1,1,0,1
99481_0,,,,2,5,3,8
C(C(C(C)O)(CCC(C=O)O)O)=O,,,5,1,1,0,1
99483_0,,,,2,5,3,8
C(C(C(C)(CCC(C=O)O)O)O)=O,,,5,1,1,0,1
99485_0,,,,2,5,3,8
C(C(C(CCCC(C=O)O)O)O)=O,,,5,1,1,0,1
99487_0,,,,2,5,3,8
C(CC(CCC(C=O)O)O)=O,,,5,1,1,0,1
99489_0,,,,2,5,3,8
C(C(CO)CCC(C=O)O)=O,,,5,1,1,0,1
99491_0,,,,2,5,3,8
C(CC(C(CCC(C=O)O)O)O)=O,,,5,1,1,0,1
99493_0,,,,2,5,3,8
C(CC(CO)(CCC(C=O)O)O)=O,,,5,1,1,0,1
99495_0,,,,2,5,3,8
C(C(C(CO)O)CCC(C=O)O)=O,,,5,1,1,0,1
99496_0,,,,2,5,3,8
99498_0,,,,2,5,3,8
C(C(CCC(C(C(C)=O)=O)O)O)=O,,,5,1,1,0,1
99500_0,,,,2,5,3,8
C(C(CCCC(C(CO)=O)=O)O)=O,,,5,1,1,0,1
99502_0,,,,2,5,3,8
C(C(CCCC(C(C=O)=O)O)O)=O,,,5,1,1,0,1
99503_0,,,,2,5,3,8
99504_0,,,,2,5,3,8
99505_0,,,,2,5,3,8
99507_0,,,,2,5,3,8
C(C(CCC(C(C=O)=O)(C)O)O)=O,,,5,1,1,0,1
99508_0,,,,2,5,3,8
99509_0,,,,2,5,3,8
99510_0,,,,2,5,3,8
99511_0,,,,2,5,3,8
99513_0,,,,2,5,3,8
C(C(CCC(C(C)=O)O)O)=O,,,5,1,1,0,1
99514_0,,,,2,5,3,8
99516_0,,,,2,5,3,8
C(C(CCC(C=O)O)O)(CCO)=O,,,5,1,1,0,1
99518_0,,,,2,5,3,8
C(C(CCC(CC(CO)=O)O)O)=O,,,5,1,1,0,1
99520_0,,,,2,5,3,8
C(C(CCC(C(CO)=O)CO)O)=O,,,5,1,1,0,1
99522_0,,,,2,5,3,8
C(C(CCO)(CCC(C=O)O)O)=O,,,5,1,1,0,1
99524_0,,,,2,5,3,8
C(C(CCC(CC(C=O)O)O)O)=O,,,5,1,1,0,1
99526_0,,,,2,5,3,8
C(C(C(CO)CCC(C=O)O)O)=O,,,5,1,1,0,1
99528_0,,,,2,5,3,8
C(C(CCC(C(C)=O)(CO)O)O)=O,,,5,1,1,0,1
99530_0,,,,2,5,3,8
C(C(CCC(C(C(C)=O)O)O)O)=O,,,5,1,1,0,1
99532_0,,,,2,5,3,8
C(C(CO)O)(CCCC(C=O)O)=O,,,5,1,1,0,1
99534_0,,,,2,5,3,8
C(C(CCC(C)O)O)=O,,,5,1,1,0,1
99536_0,,,,2,5,3,8
C(C(CCCCO)O)=O,,,5,1,1,0,1
99537_0,,,,2,5,3,8
99539_0,,,,2,5,3,8
C(C(C=O)CCC(C=O)O)(O)=O,,,5,1,1,0,1
99540_0,,,,2,5,3,8
99542_0,,,,2,5,3,8
C(C(CCC(C(C(O)=O)=O)O)O)=O,,,5,1,1,0,1
99543_0,,,,2,5,3,8
99544_0,,,,2,5,3,8
99545_0,,,,2,5,3,8
99546_0,,,,2,5,3,8
99547_0,,,,2,5,3,8
99549_0,,,,2,5,3,8
C(C(CCC1C(C(CO1)O)=O)O)=O,,,5,1,1,0,1
99551_0,,,,2,5,3,8
C(C(CCC1C(C(CO1)=O)O)O)=O,,,5,1,1,0,1
99553_0,,,,2,5,3,8
C(C(CCC1(C(COC1)=O)O)O)=O,,,5,1,1,0,1
99555_0,,,,2,5,3,8
C(C(CCC1(C(CCO1)=O)O)O)=O,,,5,1,1,0,1
99557_0,,,,2,5,3,8
C(C(CCC1CC(C(O)O1)=O)O)=O,,,5,1,1,0,1
99559_0,,,,2,5,3,8
C(C(CCC1C(C(O)OC1)=O)O)=O,,,5,1,1,0,1
99561_0,,,,2,5,3,8
C1(C(C(CO1)O)CCC(C=O)O)=O,,,5,1,1,0,1
99563_0,,,,2,5,3,8
C1(CC(C(CCC(C=O)O)O1)O)=O,,,5,1,1,0,1
99565_0,,,,2,5,3,8
C1(CC(CO1)(CCC(C=O)O)O)=O,,,5,1,1,0,1
99567_0,,,,2,5,3,8
C(C(CCC1C(COC1O)=O)O)=O,,,5,1,1,0,1
99569_0,,,,2,5,3,8
C(C(CCC1(CC(CO1)=O)O)O)=O,,,5,1,1,0,1
99571_0,,,,2,5,3,8
C(C(CCC1C(CC(O1)O)=O)O)=O,,,5,1,1,0,1
99573_0,,,,2,5,3,8
C(C(CCCC(C(C=O)=O)=O)O)=O,,,5,1,1,0,1
99575_0,,,,2,5,3,8
C(C(CCC(C=CC(O)=O)O)O)=O,,,5,1,1,0,1
99577_0,,,,2,5,3,8
C(C(C=C)(CCC(C=O)O)O)(O)=O,,,5,1,1,0,1
99579_0,,,,2,5,3,8
C1(C(CCO1)(CCC(C=O)O)O)=O,,,5,1,1,0,1
99581_0,,,,2,5,3,8
C1(C(CC(CCC(C=O)O)O1)O)=O,,,5,1,1,0,1
99583_0,,,,2,5,3,8
C1(C(C(CO1)CCC(C=O)O)O)=O,,,5,1,1,0,1
99585_0,,,,2,5,3,8
C(C(CCC(C=O)(O)O)O)=O,,,5,1,1,0,1
99587_0,,,,2,5,3,8
C(C(C)(CCC(C=O)O)O)=O,,,5,1,1,0,1
99589_0,,,,2,5,3,8
C(C(CCCC(C=O)O)O)=O,,,5,1,1,0,1
99591_0,,,,2,5,3,8
C(C(CC[C](C(O)=O)O)O)=O,,,5,1,2,0,2
99593_0,,,,2,5,3,8
C(C(CO)(CCC(C=O)O)O)=O,,,5,1,1,0,1
99594_0,,,,2,5,3,8
99596_0,,,,2,5,3,8
C(C(CCCO)O)=O,,,5,1,1,0,1
99598_0,,,,2,5,3,8
C(C(CCC(CO)O)O)=O,,,5,1,1,0,1
99599_0,,,,2,5,3,8
99601_0,,,,2,5,3,8
C(C(CCC(C(CO)=O)O)O)=O,,,5,1,1,0,1
99603_0,,,,2,5,3,8
C(C(CCC(CO)(CO)O)O)=O,,,5,1,1,0,1
99605_0,,,,2,5,3,8
C(C(CCC(C(CO)O)O)O)=O,,,5,1,1,0,1
99606_0,,,,2,5,3,8
99608_0,,,,2,5,3,8
C(C(C(CCC(C=O)O)O)O)(O)=O,,,5,1,1,0,1
99609_0,,,,2,5,3,8
99610_0,,,,2,5,3,8
99611_0,,,,2,5,3,8
99613_0,,,,2,5,3,8
C(C(CCC(CC(C=O)=O)O)O)=O,,,5,1,1,0,1
99614_0,,,,2,5,3,8
99615_0,,,,2,5,3,8
99616_0,,,,2,5,3,8
99617_0,,,,2,5,3,8
99618_0,,,,2,5,3,8
99620_0,,,,2,5,3,8
C(CC(C(CCC(C=O)O)O)=O)=O,,,5,1,1,0,1
99622_0,,,,2,5,3,8
C(C(CCC(C=O)(C(C)=O)O)O)=O,,,5,1,1,0,1
99623_0,,,,2,5,3,8
99624_0,,,,2,5,3,8
99626_0,,,,2,5,3,8
C(C(C)(CCC(C=O)O)O)(O)=O,,,5,1,1,0,1
99627_0,,,,2,5,3,8
99628_0,,,,2,5,3,8
99629_0,,,,2,5,3,8
99630_0,,,,2,5,3,8
99631_0,,,,2,5,3,8
99632_0,,,,2,5,3,8
99633_0,,,,2,5,3,8
99634_0,,,,2,5,3,8
99635_0,,,,2,5,3,8
99636_0,,,,2,5,3,8
99637_0,,,,2,5,3,8
99638_0,,,,2,5,3,8
99639_0,,,,2,5,3,8
99640_0,,,,2,5,3,8
99641_0,,,,2,4,4,8
99642_0,,,,2,4,4,8
99643_0,,,,2,4,4,8
99644_0,,,,2,4,4,8
99645_0,,,,2,4,4,8
99646_0,,,,2,4,4,8
99647_0,,,,2,4,4,8
99648_0,,,,2,4,4,8
99649_0,,,,2,4,4,8
99650_0,,,,2,4,4,8
99651_0,,,,2,4,4,8
99652_0,,,,2,4,4,8
99653_0,,,,2,4,4,8
99654_0,,,,2,4,4,8
99655_0,,,,2,4,4,8
99656_0,,,,2,4,4,8
99657_0,,,,2,4,4,8
99658_0,,,,2,4,4,8
99659_0,,,,2,4,4,8
99660_0,,,,2,4,4,8
99661_0,,,,2,4,4,8
99662_0,,,,2,4,4,8
99663_0,,,,2,4,4,8
99664_0,,,,2,4,4,8
99665_0,,,,2,4,4,8
99666_0,,,,2,4,4,8
99667_0,,,,2,4,4,8
99668_0,,,,2,4,4,8
99669_0,,,,2,4,4,8
99670_0,,,,2,4,4,8
99671_0,,,,2,4,4,8
99672_0,,,,2,4,4,8
99673_0,,,,2,4,4,8
99674_0,,,,2,4,4,8
99675_0,,,,2,4,4,8
99676_0,,,,2,4,4,8
99677_0,,,,2,4,4,8
99678_0,,,,2,4,4,8
99679_0,,,,2,4,4,8
99680_0,,,,2,4,4,8
99681_0,,,,2,4,4,8
99682_0,,,,2,4,4,8
99683_0,,,,2,4,4,8
99684_0,,,,2,4,4,8
99685_0,,,,2,4,4,8
99686_0,,,,2,4,4,8
99687_0,,,,2,4,4,8
99688_0,,,,2,4,4,8
99689_0,,,,2,4,4,8
99690_0,,,,2,4,4,8
99691_0,,,,2,4,4,8
99692_0,,,,2,4,4,8
99693_0,,,,2,4,4,8
99694_0,,,,2,4,4,8
99695_0,,,,2,4,4,8
99696_0,,,,2,4,4,8
99697_0,,,,2,4,4,8
99698_0,,,,2,4,4,8
99699_0,,,,2,4,4,8
99700_0,,,,2,4,4,8
99701_0,,,,2,4,4,8
99702_0,,,,2,4,4,8
99703_0,,,,2,4,4,8
99704_0,,,,2,4,4,8
99705_0,,,,2,4,4,8
99706_0,,,,2,4,4,8
99707_0,,,,2,4,4,8
99708_0,,,,2,4,4,8
99709_0,,,,2,4,4,8
99710_0,,,,2,4,4,8
99711_0,,,,2,4,4,8
99712_0,,,,2,4,4,8
99713_0,,,,2,4,4,8
99714_0,,,,2,4,4,8
99715_0,,,,2,4,4,8
99716_0,,,,2,4,4,8
99717_0,,,,2,4,4,8
99718_0,,,,2,4,4,8
99719_0,,,,2,4,4,8
99720_0,,,,2,4,4,8
99721_0,,,,2,4,4,8
99722_0,,,,2,4,4,8
99723_0,,,,2,4,4,8
99724_0,,,,2,4,4,8
99725_0,,,,2,4,4,8
99726_0,,,,2,4,4,8
99727_0,,,,2,4,4,8
99728_0,,,,2,4,4,8
99729_0,,,,2,4,4,8
99730_0,,,,2,4,4,8
99731_0,,,,2,4,4,8
99732_0,,,,2,4,4,8
99733_0,,,,2,4,4,8
99734_0,,,,2,4,4,8
99735_0,,,,2,4,4,8
99736_0,,,,2,4,4,8
99737_0,,,,2,4,4,8
99738_0,,,,2,4,4,8
99739_0,,,,2,4,4,8
99740_0,,,,2,4,4,8
99741_0,,,,2,4,4,8
99742_0,,,,2,4,4,8
99743_0,,,,2,4,4,8
99744_0,,,,2,4,4,8
99745_0,,,,2,4,4,8
99746_0,,,,2,4,4,8
99747_0,,,,2,4,4,8
99748_0,,,,2,4,4,8
99749_0,,,,2,4,4,8
99750_0,,,,2,4,4,8
99751_0,,,,2,4,4,8
99752_0,,,,2,4,4,8
99753_0,,,,2,4,4,8
99754_0,,,,2,4,4,8
99755_0,,,,2,4,4,8
99756_0,,,,2,4,4,8
99757_0,,,,2,4,4,8
99758_0,,,,2,4,4,8
99759_0,,,,2,4,4,8
99760_0,,,,2,4,4,8
99761_0,,,,2,4,4,8
99762_0,,,,2,4,4,8
99763_0,,,,2,4,4,8
99764_0,,,,2,4,4,8
99765_0,,,,2,4,4,8
99766_0,,,,2,4,4,8
99767_0,,,,2,4,4,8
99768_0,,,,2,4,4,8
99769_0,,,,2,4,4,8
99770_0,,,,2,4,4,8
99771_0,,,,2,4,4,8
99772_0,,,,2,4,4,8
99773_0,,,,2,4,4,8
99774_0,,,,2,4,4,8
99775_0,,,,2,4,4,8
99776_0,,,,2,4,4,8
99777_0,,,,2,4,4,8
99778_0,,,,2,4,4,8
99779_0,,,,2,4,4,8
99780_0,,,,2,4,4,8
99781_0,,,,2,4,4,8
99782_0,,,,2,4,4,8
99783_0,,,,2,4,4,8
99784_0,,,,2,4,4,8
99785_0,,,,2,4,4,8
99786_0,,,,2,4,4,8
99787_0,,,,2,4,4,8
99788_0,,,,2,4,4,8
99789_0,,,,2,4,4,8
99790_0,,,,2,4,4,8
99791_0,,,,2,4,4,8
99792_0,,,,2,4,4,8
99793_0,,,,2,4,4,8
99794_0,,,,2,4,4,8
99795_0,,,,2,4,4,8
99796_0,,,,2,4,4,8
99797_0,,,,2,4,4,8
99798_0,,,,2,4,4,8
99799_0,,,,2,4,4,8
99800_0,,,,2,4,4,8
99801_0,,,,2,4,4,8
99802_0,,,,2,4,4,8
99803_0,,,,2,4,4,8
99804_0,,,,2,4,4,8
99805_0,,,,2,4,4,8
99806_0,,,,2,4,4,8
99807_0,,,,2,4,4,8
99808_0,,,,2,4,4,8
99809_0,,,,2,4,4,8
99810_0,,,,2,4,4,8
99811_0,,,,2,4,4,8
99812_0,,,,2,4,4,8
99813_0,,,,2,4,4,8
99814_0,,,,2,4,4,8
99815_0,,,,2,4,4,8
99816_0,,,,2,4,4,8
99817_0,,,,2,4,4,8
99818_0,,,,2,4,4,8
99819_0,,,,2,4,4,8
99820_0,,,,2,4,4,8
99821_0,,,,2,4,4,8
99822_0,,,,2,4,4,8
99823_0,,,,2,4,4,8
99824_0,,,,2,4,4,8
99825_0,,,,2,4,4,8
99826_0,,,,2,4,4,8
99827_0,,,,2,4,4,8
99828_0,,,,2,4,4,8
99829_0,,,,2,4,4,8
99830_0,,,,2,4,4,8
99831_0,,,,2,4,4,8
99832_0,,,,2,4,4,8
99833_0,,,,2,4,4,8
99834_0,,,,2,4,4,8
99835_0,,,,2,4,4,8
99836_0,,,,2,4,4,8
99837_0,,,,2,4,4,8
99838_0,,,,2,4,4,8
99839_0,,,,2,4,4,8
99840_0,,,,2,4,4,8
99841_0,,,,2,4,4,8
99842_0,,,,2,4,4,8
99843_0,,,,2,4,4,8
99844_0,,,,2,4,4,8
99845_0,,,,2,4,4,8
99846_0,,,,2,4,4,8
99847_0,,,,2,4,4,8
99848_0,,,,2,4,4,8
99849_0,,,,2,4,4,8
99850_0,,,,2,4,4,8
99851_0,,,,2,4,4,8
99852_0,,,,2,4,4,8
99853_0,,,,2,4,4,8
99854_0,,,,2,4,4,8
99855_0,,,,2,4,4,8
99856_0,,,,2,4,4,8
99857_0,,,,2,4,4,8
99858_0,,,,2,4,4,8
99859_0,,,,2,4,4,8
99860_0,,,,2,4,4,8
99861_0,,,,2,4,4,8
99862_0,,,,2,4,4,8
99863_0,,,,2,4,4,8
99864_0,,,,2,4,4,8
99865_0,,,,2,4,4,8
99866_0,,,,2,4,4,8
99867_0,,,,2,4,4,8
99868_0,,,,2,4,4,8
99869_0,,,,2,4,4,8
99870_0,,,,2,4,4,8
99871_0,,,,2,4,4,8
99872_0,,,,2,4,4,8
99873_0,,,,2,4,4,8
99874_0,,,,2,4,4,8
99875_0,,,,2,4,4,8
99876_0,,,,2,4,4,8
99877_0,,,,2,4,4,8
99878_0,,,,2,4,4,8
99879_0,,,,2,4,4,8
99880_0,,,,2,4,4,8
99881_0,,,,2,4,4,8
99882_0,,,,2,4,4,8
99883_0,,,,2,4,4,8
99884_0,,,,2,4,4,8
99885_0,,,,2,4,4,8
99886_0,,,,2,4,4,8
99887_0,,,,2,4,4,8
99888_0,,,,2,4,4,8
99889_0,,,,2,4,4,8
99890_0,,,,2,4,4,8
99891_0,,,,2,4,4,8
99892_0,,,,2,4,4,8
99893_0,,,,2,4,4,8
99894_0,,,,2,4,4,8
99895_0,,,,2,4,4,8
99896_0,,,,2,4,4,8
99897_0,,,,2,4,4,8
99898_0,,,,2,4,4,8
99899_0,,,,2,4,4,8
99900_0,,,,2,4,4,8
99901_0,,,,2,4,4,8
99902_0,,,,2,4,4,8
99903_0,,,,2,4,4,8
99904_0,,,,2,4,4,8
99905_0,,,,2,4,4,8
99906_0,,,,2,4,4,8
99907_0,,,,2,4,4,8
99908_0,,,,2,4,4,8
99909_0,,,,2,4,4,8
99910_0,,,,2,4,4,8
99911_0,,,,2,4,4,8
99912_0,,,,2,4,4,8
99913_0,,,,2,4,4,8
99914_0,,,,2,4,4,8
99915_0,,,,2,4,4,8
99916_0,,,,2,4,4,8
99917_0,,,,2,4,4,8
99918_0,,,,2,4,4,8
99919_0,,,,2,4,4,8
99920_0,,,,2,4,4,8
99921_0,,,,2,4,4,8
99922_0,,,,2,4,4,8
99923_0,,,,2,4,4,8
99924_0,,,,2,4,4,8
99925_0,,,,2,4,4,8
99926_0,,,,2,4,4,8
99927_0,,,,2,4,4,8
99928_0,,,,2,4,4,8
99929_0,,,,2,4,4,8
99930_0,,,,2,4,4,8
99931_0,,,,2,4,4,8
99932_0,,,,2,4,4,8
99933_0,,,,2,4,4,8
99934_0,,,,2,4,4,8
99935_0,,,,2,4,4,8
99936_0,,,,2,4,4,8
99937_0,,,,2,4,4,8
99938_0,,,,2,4,4,8
99939_0,,,,2,4,4,8
99940_0,,,,2,4,4,8
99941_0,,,,2,4,4,8
99942_0,,,,2,4,4,8
99943_0,,,,2,4,4,8
99944_0,,,,2,4,4,8
99945_0,,,,2,4,4,8
99946_0,,,,2,4,4,8
99947_0,,,,2,4,4,8
99948_0,,,,2,4,4,8
99949_0,,,,2,4,4,8
99950_0,,,,2,4,4,8
99951_0,,,,2,4,4,8
99952_0,,,,2,4,4,8
99953_0,,,,2,4,4,8
99954_0,,,,2,4,4,8
99955_0,,,,2,4,4,8
99956_0,,,,2,4,4,8
99957_0,,,,2,4,4,8
99958_0,,,,2,4,4,8
99959_0,,,,2,4,4,8
99960_0,,,,2,4,4,8
99961_0,,,,2,4,4,8
99962_0,,,,2,4,4,8
99963_0,,,,2,4,4,8
99964_0,,,,2,4,4,8
99965_0,,,,2,4,4,8
99966_0,,,,2,4,4,8
99967_0,,,,2,4,4,8
99968_0,,,,2,4,4,8
99969_0,,,,2,4,4,8
99970_0,,,,2,4,4,8
99971_0,,,,2,4,3,7
99973_0,,,,2,4,3,7
[C](C(O)=O)(CC(CC(C)O)O)O,,,5,1,1,0,1
99974_0,,,,2,4,3,7
99976_0,,,,2,4,3,7
[C](C(O)=O)(CC(C(C(C)O)O)O)O,,,5,1,1,0,1
99978_0,,,,2,4,3,7
[C](C(O)=O)(CC(CCO)O)O,,,5,1,1,0,1
99980_0,,,,2,4,3,7
[C](C(O)=O)(C(CO)C(CCO)O)O,,,5,1,1,0,1
99981_0,,,,2,4,3,7
99982_0,,,,2,4,3,7
99984_0,,,,2,4,3,7
[C](C(O)=O)(CC(CC(CO)O)O)O,,,5,1,1,0,1
99986_0,,,,2,4,3,7
C(C)(C(CO)(C[C](C(O)=O)O)O)=O,,,5,1,1,0,1
99988_0,,,,2,4,3,7
C(CO)(C(C)(C[C](C(O)=O)O)O)=O,,,5,1,1,0,1
99990_0,,,,2,4,3,7
C(C(C(C)O)(C[C](C(O)=O)O)O)=O,,,5,1,1,0,1
99992_0,,,,2,4,3,7
C(C(C[C](C(O)=O)O)O)(C(C)O)=O,,,5,1,1,0,1
99993_0,,,,2,4,3,7
99994_0,,,,2,4,3,7
99996_0,,,,2,4,3,7
[C](C(O)=O)(CC(C)(CO)O)O,,,5,1,1,0,1
99998_0,,,,2,4,3,7
[C](C(O)=O)(C(CO)C(C)(CO)O)O,,,5,1,1,0,1
99999_0,,,,2,4,3,7
100000_0,,,,2,4,3,7
100001_0,,,,2,4,3,7
100002_0,,,,2,4,3,7
100004_0,,,,2,4,3,7
[C](C(O)=O)(CC(CO)(CCO)O)O,,,5,1,1,0,1
100006_0,,,,2,4,3,7
[C](C(O)=O)(CC(C(CCO)O)O)O,,,5,1,1,0,1
100008_0,,,,2,4,3,7
[C](C(O)=O)(CC(C)(C(CO)O)O)O,,,5,1,1,0,1
100010_0,,,,2,4,3,7
C(C(C)(C[C](C(O)=O)O)O)(O)=O,,,5,1,1,0,1
100011_0,,,,2,4,3,7
100013_0,,,,2,4,3,7
C(CC(C[C](C(O)=O)O)O)(O)=O,,,5,1,1,0,1
100015_0,,,,2,4,3,7
C(C(CO)(C[C](C(O)=O)O)O)(O)=O,,,5,1,1,0,1
100017_0,,,,2,4,3,7
C(CC(C=O)(C[C](C(O)=O)O)O)=O,,,5,1,1,0,1
100019_0,,,,2,4,3,7
C(CC(C(C[C](C(O)=O)O)O)=O)=O,,,5,1,1,0,1
100020_0,,,,2,4,3,7
100022_0,,,,2,4,3,7
[C](C(O)=O)(CC1(COCC1O)O)O,,,5,1,1,0,1
100024_0,,,,2,4,3,7
[C](C(O)=O)(CC1(C(O)OCC1)O)O,,,5,1,1,0,1
100026_0,,,,2,4,3,7
[C](C(O)=O)(CC1(COC(C1)O)O)O,,,5,1,1,0,1
100028_0,,,,2,4,3,7
C(C(C(C)=O)(C[C](C(O)=O)O)O)=O,,,5,1,1,0,1
100030_0,,,,2,4,3,7
C([C](CC(C(C(C)=O)=O)O)O)(O)=O,,,5,1,1,0,1
100032_0,,,,2,4,3,7
[C](C(O)=O)(CC(C(C=O)=O)(C)O)O,,,5,1,1,0,1
100034_0,,,,2,4,3,7
C(C(C=C)(C[C](C(O)=O)O)O)=O,,,5,1,1,0,1
100036_0,,,,2,4,3,7
C=CC(C(C[C](C(O)=O)O)O)=O,,,5,1,1,0,1
100038_0,,,,2,4,3,7
C(C(C[C](C(O)=O)O)O)=CC=O,,,5,1,1,0,1
100039_0,,,,2,4,3,7
100041_0,,,,2,4,3,7
[C](C(O)=O)(CC(C(O)O)O)O,,,5,1,1,0,1
100043_0,,,,2,4,3,7
[C](C(O)=O)(CC(C(C)O)O)O,,,5,1,1,0,1
100045_0,,,,2,4,3,7
C(C(C[C](C(O)=O)O)O)=O,,,5,1,1,0,1
100047_0,,,,2,4,3,7
[C](C(O)=O)(CC(CO)(CO)O)O,,,5,1,1,0,1
100048_0,,,,2,4,3,7
100050_0,,,,2,4,3,7
C(C(C)(C[C](C(O)=O)O)O)=O,,,5,1,1,0,1
100051_0,,,,2,4,3,7
100052_0,,,,2,4,3,7
100054_0,,,,2,4,3,7
C(C(CCO)(C[C](C(O)=O)O)O)=O,,,5,1,1,0,1
100056_0,,,,2,4,3,7
C(C(C[C](C(O)=O)O)O)(CCO)=O,,,5,1,1,0,1
100058_0,,,,2,4,3,7
C(CC(C(C[C](C(O)=O)O)O)O)=O,,,5,1,1,0,1
100060_0,,,,2,4,3,7
C(C(CC(C[C](C(O)=O)O)O)O)=O,,,5,1,1,0,1
100062_0,,,,2,4,3,7
C(CC(CO)(C[C](C(O)=O)O)O)=O,,,5,1,1,0,1
100064_0,,,,2,4,3,7
C(C(C(C)(C[C](C(O)=O)O)O)O)=O,,,5,1,1,0,1
100066_0,,,,2,4,3,7
[C](C(O)=O)(CC(C)O)O,,,5,1,1,0,1
100068_0,,,,2,4,3,7
C(C(CO)(C[C](C(O)=O)O)O)=O,,,5,1,1,0,1
100070_0,,,,2,4,3,7
C(CO)(C(C[C](C(O)=O)O)O)=O,,,5,1,1,0,1
100071_0,,,,2,4,3,7
100073_0,,,,2,4,3,7
C(C([C](C(O)=O)O)CO)(O)=O,,,5,1,1,0,1
100075_0,,,,2,4,3,7
[C](C(O)=O)(C(CO)C(C(O)O)O)O,,,5,1,1,0,1
100077_0,,,,2,4,3,7
[C](C(O)=O)(C(CO)C(C(C)O)O)O,,,5,1,1,0,1
100079_0,,,,2,4,3,7
C(C(C([C](C(O)=O)O)CO)O)=O,,,5,1,1,0,1
100081_0,,,,2,4,3,7
C(C(C([C](C(O)=O)O)CO)O)(O)=O,,,5,1,1,0,1
100083_0,,,,2,4,3,7
C(C(C)(C([C](C(O)=O)O)CO)O)=O,,,5,1,1,0,1
100085_0,,,,2,4,3,7
C(C(C([C](C(O)=O)O)CO)O)(C)=O,,,5,1,1,0,1
100087_0,,,,2,4,3,7
C(CC(C([C](C(O)=O)O)CO)O)=O,,,5,1,1,0,1
100089_0,,,,2,4,3,7
[C](C(O)=O)(C(CO)C(C)O)O,,,5,1,1,0,1
100091_0,,,,2,4,3,7
[C](C(O)=O)(C(CO)CO)O,,,5,1,1,0,1
100093_0,,,,2,4,3,7
[C](C(O)=O)(C(CO)C(CO)O)O,,,5,1,1,0,1
100095_0,,,,2,4,3,7
C(C(C=C)(C([C](C(O)=O)O)O)O)=O,,,5,1,1,0,1
100096_0,,,,2,4,3,7
100097_0,,,,2,4,3,7
100098_0,,,,2,4,3,7
100100_0,,,,2,4,3,7
[C](C(O)=O)(C(C(C(O)O)O)O)O,,,5,1,1,0,1
100101_0,,,,2,4,3,7
100102_0,,,,2,4,3,7
100103_0,,,,2,4,3,7
100104_0,,,,2,4,3,7
100105_0,,,,2,4,3,7
100106_0,,,,2,4,3,7
100107_0,,,,2,4,3,7
100108_0,,,,2,4,3,7
100109_0,,,,2,4,3,7
100110_0,,,,2,4,3,7
100112_0,,,,2,4,3,7
C(C([C](C(O)=O)O)C(CO)O)(O)=O,,,5,1,1,0,1
100114_0,,,,2,4,3,7
[C](C(O)=O)(C(C(CO)O)C(C)O)O,,,5,1,1,0,1
100115_0,,,,2,4,3,7
100116_0,,,,2,4,3,7
100117_0,,,,2,4,3,7
100118_0,,,,2,4,3,7
100119_0,,,,2,4,3,7
100120_0,,,,2,4,3,7
100121_0,,,,2,4,3,7
100122_0,,,,2,4,3,7
100123_0,,,,2,4,3,7
100124_0,,,,2,4,3,7
100125_0,,,,2,4,3,7
100126_0,,,,2,4,3,7
100127_0,,,,2,4,3,7
100128_0,,,,2,4,3,7
100129_0,,,,2,4,3,7
100130_0,,,,2,4,3,7
100131_0,,,,2,4,3,7
100132_0,,,,2,4,3,7
100133_0,,,,2,4,3,7
100134_0,,,,2,4,3,7
100135_0,,,,2,4,3,7
100136_0,,,,2,4,3,7
100137_0,,,,2,4,3,7
100138_0,,,,2,4,3,7
100139_0,,,,2,4,3,7
100140_0,,,,2,4,3,7
100141_0,,,,2,4,3,7
100142_0,,,,2,4,3,7
100143_0,,,,2,4,3,7
100144_0,,,,2,4,3,7
100145_0,,,,2,4,3,7
100146_0,,,,2,4,3,7
100147_0,,,,2,4,3,7
100148_0,,,,2,4,3,7
100149_0,,,,2,4,3,7
100150_0,,,,2,4,3,7
100151_0,,,,2,4,3,7
100152_0,,,,2,4,3,7
100153_0,,,,2,4,3,7
100154_0,,,,2,4,3,7
100156_0,,,,2,4,3,7
C(C([C](C(O)=O)O)C)(O)=O,,,5,1,1,0,1
100158_0,,,,2,4,3,7
C(C([C](C(O)=O)O)CCO)(O)=O,,,5,1,1,0,1
100159_0,,,,2,4,3,7
100160_0,,,,2,4,3,7
100161_0,,,,2,4,3,7
100162_0,,,,2,4,3,7
100163_0,,,,2,4,3,7
100164_0,,,,2,4,3,7
100165_0,,,,2,4,3,7
100166_0,,,,2,4,3,7
100168_0,,,,2,4,3,7
C(C(C([C](C(O)=O)O)C)O)=O,,,5,1,1,0,1
100170_0,,,,2,4,3,7
[C](C(O)=O)(CC)O,,,5,1,1,0,1
100171_0,,,,2,4,3,7
100172_0,,,,2,4,3,7
100173_0,,,,2,4,3,7
100174_0,,,,2,4,3,7
100175_0,,,,2,4,3,7
100176_0,,,,2,4,3,7
100177_0,,,,2,4,3,7
100178_0,,,,2,4,3,7
100179_0,,,,2,4,3,7
100180_0,,,,2,4,3,7
100181_0,,,,2,4,3,7
100182_0,,,,2,4,3,7
100183_0,,,,2,4,3,7
100184_0,,,,2,4,3,7
100185_0,,,,2,4,3,7
100186_0,,,,2,4,3,7
100187_0,,,,2,4,3,7
100188_0,,,,2,4,3,7
100189_0,,,,2,4,3,7
100190_0,,,,2,4,3,7
100191_0,,,,2,4,3,7
100192_0,,,,2,4,3,7
100193_0,,,,2,4,3,7
100194_0,,,,2,4,3,7
100195_0,,,,2,4,3,7
100196_0,,,,2,4,3,7
100197_0,,,,2,4,3,7
100198_0,,,,2,4,3,7
100199_0,,,,2,4,3,7
100200_0,,,,2,4,3,7
100201_0,,,,2,4,3,7
100202_0,,,,2,4,3,7
100203_0,,,,2,4,3,7
100204_0,,,,2,4,3,7
100205_0,,,,2,4,3,7
100206_0,,,,2,4,3,7
[OH-],,,0,1,0,412,412
