Id,Label,timeset,gen,type,weighted indegree,weighted outdegree,Weighted Degree
4_0,,,,2,2,1,3
C(C(CO)O)=O,,,1,1,256,346,602
4_1,,,,2,2,1,3
6_0,,,,2,2,1,3
C(C(C(CO)O)O)=O,,,1,1,54,63,117
6_1,,,,2,2,1,3
7_0,,,,2,1,1,2
C(CO)=O,,,0,1,681,1594,2275
10_0,,,,2,3,2,5
C(O)=O,,,1,1,2733,0,2733
CO,,,1,1,1717,205,1922
10_1,,,,2,3,2,5
12_0,,,,2,3,2,5
C(CO)O,,,1,1,7,79,86
14_0,,,,2,3,2,5
C(CO)(O)=O,,,1,1,97,232,329
16_0,,,,2,2,1,3
C(C(C(C(CO)O)O)O)=O,,,2,1,20,20,40
16_1,,,,2,2,1,3
18_0,,,,2,2,1,3
C(C(C(C(C(CO)O)O)O)O)=O,,,2,1,15,16,31
18_1,,,,2,2,1,3
20_0,,,,2,1,2,3
O,,,0,1,8817,7243,16060
C(C=O)=O,,,2,1,415,601,1016
21_0,,,,2,1,2,3
C=O,,,0,1,1486,6867,8353
21_1,,,,2,1,2,3
22_0,,,,2,1,2,3
22_1,,,,2,1,2,3
24_0,,,,2,1,1,2
C(CO)(CO)=O,,,2,1,196,319,515
26_0,,,,2,1,1,2
C(CO)(C(CO)O)=O,,,2,1,74,89,163
28_0,,,,2,3,2,5
C(C(CO)O)O,,,2,1,7,44,51
30_0,,,,2,3,2,5
C(C(C(CO)O)O)O,,,2,1,4,9,13
32_0,,,,2,3,2,5
C(C(CO)O)(O)=O,,,2,1,51,96,147
34_0,,,,2,3,2,5
C(C(C(CO)O)O)(O)=O,,,2,1,17,22,39
36_0,,,,2,2,1,3
C(C(CO)(C(C(CO)O)O)O)=O,,,2,1,12,16,28
36_1,,,,2,2,1,3
38_0,,,,2,2,1,3
C(C(CO)(CO)O)=O,,,2,1,18,23,41
38_1,,,,2,2,1,3
40_0,,,,2,2,1,3
C(C(CO)(C(CO)O)O)=O,,,2,1,12,14,26
40_1,,,,2,2,1,3
41_0,,,,2,2,1,3
41_1,,,,2,2,1,3
43_0,,,,2,2,1,3
C(C(C(CO)O)(C(CO)O)O)=O,,,2,1,7,9,16
43_1,,,,2,2,1,3
45_0,,,,2,2,1,3
C(C(C(C(CO)O)O)O)(O)=O,,,2,1,12,12,24
47_0,,,,2,2,1,3
C(C(C(C(C(CO)O)O)O)O)(O)=O,,,2,1,13,13,26
48_0,,,,2,2,1,3
49_0,,,,2,2,1,3
51_0,,,,2,1,2,3
C(C(C)=O)=O,,,2,1,393,791,1184
53_0,,,,2,1,2,3
C(CC=O)=O,,,2,1,274,749,1023
55_0,,,,2,1,2,3
C(C(CCO)=O)=O,,,2,1,120,180,300
57_0,,,,2,1,2,3
C(CC(C=O)O)=O,,,2,1,150,217,367
59_0,,,,2,1,2,3
C(CC(CO)=O)=O,,,2,1,145,252,397
61_0,,,,2,1,2,3
C(C(C(C)=O)O)=O,,,2,1,142,214,356
63_0,,,,2,1,2,3
C(C)=O,,,2,1,811,2181,2992
65_0,,,,2,1,1,2
C1C(C(C(O)O1)O)O,,,2,1,3,17,20
67_0,,,,2,2,1,3
C(CC(C(C(C(CO)O)O)O)O)=O,,,3,1,14,14,28
69_0,,,,2,2,1,3
C(C(C(C(CO)=O)O)O)=O,,,3,1,31,34,65
69_1,,,,2,2,1,3
71_0,,,,2,2,1,3
C(C(C(C=O)O)O)(C(CO)O)=O,,,3,1,18,19,37
71_1,,,,2,2,1,3
73_0,,,,2,2,1,3
C(C(CC(C=O)=O)O)=O,,,3,1,32,40,72
75_0,,,,2,2,1,3
C(C(C=O)C(C=O)O)=O,,,3,1,27,29,56
75_1,,,,2,2,1,3
77_0,,,,2,2,1,3
C(C(C(C(C=O)=O)CO)O)=O,,,3,1,16,19,35
77_1,,,,2,2,1,3
79_0,,,,2,2,1,3
C(C(C(C=O)C(C=O)O)O)=O,,,3,1,10,12,22
79_1,,,,2,2,1,3
81_0,,,,2,2,1,3
C(C(C(CO)=O)C(C=O)O)=O,,,3,1,17,19,36
81_1,,,,2,2,1,3
83_0,,,,2,2,1,3
C(CC(C(C(C=O)O)O)=O)=O,,,3,1,25,26,51
83_1,,,,2,2,1,3
85_0,,,,2,2,1,3
C(C(C(CC(C=O)O)=O)O)=O,,,3,1,20,20,40
86_0,,,,2,2,1,3
88_0,,,,2,2,1,3
C(C(C(C=O)O)O)=O,,,3,1,48,53,101
88_1,,,,2,2,1,3
90_0,,,,2,2,1,3
C(CO)(C(C(CO)(CO)O)O)=O,,,3,1,9,7,16
90_1,,,,2,2,1,3
92_0,,,,2,2,1,3
C(C(CC(CO)(CO)O)=O)=O,,,3,1,12,13,25
94_0,,,,2,2,1,3
C(C(C=O)C(CO)(CO)O)=O,,,3,1,9,9,18
94_1,,,,2,2,1,3
96_0,,,,2,2,1,3
C(C(C(CO)C(CO)(CO)O)=O)=O,,,3,1,12,12,24
96_1,,,,2,2,1,3
98_0,,,,2,2,1,3
C(C(C(CO)(CO)O)C(C=O)O)=O,,,3,1,12,13,25
98_1,,,,2,2,1,3
100_0,,,,2,2,1,3
C(C(C(CO)=O)C(CO)(CO)O)=O,,,3,1,9,9,18
100_1,,,,2,2,1,3
102_0,,,,2,2,1,3
C(CC(C(C(CO)(CO)O)O)=O)=O,,,3,1,10,10,20
102_1,,,,2,2,1,3
104_0,,,,2,2,1,3
C(C(C(CC(CO)(CO)O)=O)O)=O,,,3,1,9,9,18
106_0,,,,2,2,1,3
C(CC(CO)(CO)O)=O,,,3,1,21,24,45
108_0,,,,2,2,1,3
C(C(C(CO)(CO)O)O)=O,,,3,1,14,15,29
108_1,,,,2,2,1,3
110_0,,,,2,2,1,3
C(C(C)(C(C(CO)=O)O)O)=O,,,3,1,16,17,33
110_1,,,,2,2,1,3
112_0,,,,2,2,1,3
C(C)(C(C(C(CO)=O)O)O)=O,,,3,1,24,21,45
112_1,,,,2,2,1,3
114_0,,,,2,2,1,3
C(CC(C(C(CO)=O)O)O)=O,,,3,1,21,21,42
114_1,,,,2,2,1,3
116_0,,,,2,2,1,3
C(C(CCO)(C(C(CO)=O)O)O)=O,,,3,1,15,15,30
116_1,,,,2,2,1,3
118_0,,,,2,2,1,3
C(C(C(C(CCO)=O)O)O)(CO)=O,,,3,1,19,17,36
118_1,,,,2,2,1,3
120_0,,,,2,2,1,3
C(CC(C(C(C(CO)=O)O)O)O)=O,,,3,1,21,20,41
120_1,,,,2,2,1,3
122_0,,,,2,2,1,3
C(C(CC(C(C(CO)=O)O)O)O)=O,,,3,1,20,18,38
122_1,,,,2,2,1,3
124_0,,,,2,2,1,3
C(CO)(CC(C(C(CO)=O)O)O)=O,,,3,1,17,16,33
124_1,,,,2,2,1,3
126_0,,,,2,2,1,3
C(CC(CO)(C(C(CO)=O)O)O)=O,,,3,1,16,15,31
126_1,,,,2,2,1,3
128_0,,,,2,2,1,3
C(C)(C(C(C(C(CO)=O)O)O)O)=O,,,3,1,18,17,35
128_1,,,,2,2,1,3
130_0,,,,2,2,1,3
C(C(C(C)(C(C(CO)=O)O)O)O)=O,,,3,1,16,16,32
130_1,,,,2,2,1,3
132_0,,,,2,2,1,3
C(CO)(C(C(C)O)O)=O,,,3,1,31,38,69
132_1,,,,2,2,1,3
134_0,,,,2,2,1,3
C(CO)(C(C(C(CO)O)O)O)=O,,,3,1,14,12,26
134_1,,,,2,2,1,3
135_0,,,,2,2,1,3
135_1,,,,2,2,1,3
137_0,,,,2,2,1,3
C(CO)(C(C(CO)O)O)=O,,,3,1,23,22,45
137_1,,,,2,2,1,3
139_0,,,,2,2,1,3
C(C(CC(CO)(C(CO)O)O)=O)=O,,,3,1,14,14,28
141_0,,,,2,2,1,3
C(C(C=O)C(CO)(C(CO)O)O)=O,,,3,1,11,11,22
141_1,,,,2,2,1,3
143_0,,,,2,2,1,3
C(CC(CO)(C(CO)O)O)=O,,,3,1,14,14,28
145_0,,,,2,2,1,3
C(C(C(CO)(C(CO)O)O)O)=O,,,3,1,13,13,26
145_1,,,,2,2,1,3
147_0,,,,2,2,1,3
C(C(C)(C(C(C(CO)O)=O)O)O)=O,,,3,1,16,17,33
147_1,,,,2,2,1,3
149_0,,,,2,2,1,3
C(C(C(C(C(CO)O)=O)O)O)(C)=O,,,3,1,19,18,37
149_1,,,,2,2,1,3
151_0,,,,2,2,1,3
C(CC(C(C(C(CO)O)=O)O)O)=O,,,3,1,17,17,34
151_1,,,,2,2,1,3
153_0,,,,2,2,1,3
C(C(C(C)O)O)(C(CO)O)=O,,,3,1,17,15,32
153_1,,,,2,2,1,3
155_0,,,,2,2,1,3
C(C(CO)O)(C(CO)O)=O,,,3,1,13,12,25
155_1,,,,2,2,1,3
157_0,,,,2,2,1,3
C(C(C(CO)O)O)(C(CO)O)=O,,,3,1,15,13,28
157_1,,,,2,2,1,3
159_0,,,,2,2,1,3
C(C(CC(C(CO)(CO)O)O)=O)=O,,,3,1,9,10,19
161_0,,,,2,2,1,3
C(C(C=O)C(C(CO)(CO)O)O)=O,,,3,1,7,8,15
161_1,,,,2,2,1,3
163_0,,,,2,2,1,3
C(CC(C(CO)(CO)O)O)=O,,,3,1,10,11,21
165_0,,,,2,2,1,3
C(C(C(C(CO)(CO)O)O)O)=O,,,3,1,9,11,20
165_1,,,,2,2,1,3
167_0,,,,2,2,1,3
C(CC(C(CO)(C(CO)O)O)O)=O,,,3,1,13,12,25
169_0,,,,2,2,1,3
C(C(C)(CC(C=O)=O)O)=O,,,3,1,14,20,34
171_0,,,,2,2,1,3
C(C(C=O)C(C=O)(C)O)=O,,,3,1,11,14,25
171_1,,,,2,2,1,3
173_0,,,,2,2,1,3
C(C(C)(C(C(C=O)=O)CO)O)=O,,,3,1,12,17,29
173_1,,,,2,2,1,3
175_0,,,,2,2,1,3
C(C(C(C=O)C(C=O)(C)O)O)=O,,,3,1,11,17,28
175_1,,,,2,2,1,3
177_0,,,,2,2,1,3
C(C(C)(C(C=O)C(CO)=O)O)=O,,,3,1,11,15,26
177_1,,,,2,2,1,3
179_0,,,,2,2,1,3
C(C(C)(C(C(CC=O)=O)O)O)=O,,,3,1,12,17,29
179_1,,,,2,2,1,3
181_0,,,,2,2,1,3
C(C(C)(CC(C(C=O)O)=O)O)=O,,,3,1,11,14,25
183_0,,,,2,2,1,3
C(C(C)(CC=O)O)=O,,,3,1,52,72,124
185_0,,,,2,2,1,3
C(C(C)(C(C=O)O)O)=O,,,3,1,25,31,56
185_1,,,,2,2,1,3
187_0,,,,2,2,1,3
C(C)(C(CC(C=O)=O)O)=O,,,3,1,23,27,50
189_0,,,,2,2,1,3
C(C(C=O)C(C(C)=O)O)=O,,,3,1,19,20,39
189_1,,,,2,2,1,3
191_0,,,,2,2,1,3
C(C(C(C(C=O)=O)CO)O)(C)=O,,,3,1,15,18,33
191_1,,,,2,2,1,3
193_0,,,,2,2,1,3
C(C(C(C=O)C(C(C)=O)O)O)=O,,,3,1,14,18,32
193_1,,,,2,2,1,3
195_0,,,,2,2,1,3
C(C(C(CO)=O)C(C(C)=O)O)=O,,,3,1,14,16,30
195_1,,,,2,2,1,3
197_0,,,,2,2,1,3
C(CC(C(C(C(C)=O)O)O)=O)=O,,,3,1,20,21,41
197_1,,,,2,2,1,3
199_0,,,,2,2,1,3
C(C(C(CC(C(C)=O)O)=O)O)=O,,,3,1,16,16,32
201_0,,,,2,2,1,3
C(CC(C(C)=O)O)=O,,,3,1,87,105,192
203_0,,,,2,2,1,3
C(C(C(C(C)=O)O)O)=O,,,3,1,48,51,99
203_1,,,,2,2,1,3
205_0,,,,2,2,1,3
C(CC(CC(C=O)=O)O)=O,,,3,1,22,30,52
207_0,,,,2,2,1,3
C(C(CCO)(CC(C=O)=O)O)=O,,,3,1,10,15,25
209_0,,,,2,2,1,3
C(C(CC(C=O)=O)O)(CCO)=O,,,3,1,14,17,31
211_0,,,,2,2,1,3
C(CC(C(CC(C=O)=O)O)O)=O,,,3,1,19,24,43
213_0,,,,2,2,1,3
C(C(CC(CC(C=O)=O)O)O)=O,,,3,1,17,20,37
215_0,,,,2,2,1,3
C(CO)(CC(CC(C=O)=O)O)=O,,,3,1,16,19,35
217_0,,,,2,2,1,3
C(CC(CO)(CC(C=O)=O)O)=O,,,3,1,14,19,33
219_0,,,,2,2,1,3
C(C)(C(C(CC(C=O)=O)O)O)=O,,,3,1,18,20,38
221_0,,,,2,2,1,3
C(C(C(C)(CC(C=O)=O)O)O)=O,,,3,1,15,19,34
223_0,,,,2,2,1,3
C(C(CC(C)O)=O)=O,,,3,1,51,76,127
225_0,,,,2,2,1,3
C(C(CC(C(CO)O)O)=O)=O,,,3,1,16,18,34
227_0,,,,2,2,1,3
C(C(CC(C(C(CO)O)O)O)=O)=O,,,3,1,15,15,30
228_0,,,,2,2,1,3
230_0,,,,2,2,1,3
C(C(CC(CO)O)=O)=O,,,3,1,27,33,60
232_0,,,,2,2,1,3
C(C(C=O)C(CC=O)O)=O,,,3,1,17,22,39
232_1,,,,2,2,1,3
234_0,,,,2,2,1,3
C(CC(C(C(C=O)=O)CO)O)=O,,,3,1,16,21,37
234_1,,,,2,2,1,3
236_0,,,,2,2,1,3
C(CC(C(C=O)C(C=O)O)O)=O,,,3,1,17,22,39
236_1,,,,2,2,1,3
238_0,,,,2,2,1,3
C(CC(C(C=O)C(CO)=O)O)=O,,,3,1,13,17,30
238_1,,,,2,2,1,3
240_0,,,,2,2,1,3
C(CC(C(C(CC=O)=O)O)O)=O,,,3,1,17,21,38
240_1,,,,2,2,1,3
242_0,,,,2,2,1,3
C(C(C(CC(CC=O)O)=O)O)=O,,,3,1,15,18,33
244_0,,,,2,2,1,3
C(CC(CC=O)O)=O,,,3,1,39,55,94
246_0,,,,2,2,1,3
C(CC(C(C=O)O)O)=O,,,3,1,36,46,82
246_1,,,,2,2,1,3
248_0,,,,2,2,1,3
C(C(C=O)C(C=O)(CCO)O)=O,,,3,1,8,12,20
248_1,,,,2,2,1,3
250_0,,,,2,2,1,3
C(C(C=O)C(C(CCO)=O)O)=O,,,3,1,11,13,24
250_1,,,,2,2,1,3
252_0,,,,2,2,1,3
C(C(C=O)C(C(CC=O)O)O)=O,,,3,1,15,18,33
252_1,,,,2,2,1,3
254_0,,,,2,2,1,3
C(C(C=O)C(CC(C=O)O)O)=O,,,3,1,13,15,28
254_1,,,,2,2,1,3
256_0,,,,2,2,1,3
C(C(C=O)C(CC(CO)=O)O)=O,,,3,1,11,13,24
256_1,,,,2,2,1,3
258_0,,,,2,2,1,3
C(C(C=O)C(CO)(CC=O)O)=O,,,3,1,10,14,24
258_1,,,,2,2,1,3
260_0,,,,2,2,1,3
C(C(C=O)C(C(C(C)=O)O)O)=O,,,3,1,12,14,26
260_1,,,,2,2,1,3
262_0,,,,2,2,1,3
C(C(C=O)C(C)(C(C=O)O)O)=O,,,3,1,10,14,24
262_1,,,,2,2,1,3
264_0,,,,2,2,1,3
C(C(C=O)C(C)O)=O,,,3,1,37,45,82
264_1,,,,2,2,1,3
266_0,,,,2,2,1,3
C(C(C=O)C(C(CO)O)O)=O,,,3,1,12,13,25
266_1,,,,2,2,1,3
268_0,,,,2,2,1,3
C(C(C=O)C(C(C(CO)O)O)O)=O,,,3,1,13,13,26
268_1,,,,2,2,1,3
270_0,,,,2,2,1,3
C(C(C=O)CO)=O,,,3,1,74,101,175
270_1,,,,2,2,1,3
272_0,,,,2,2,1,3
C(C(C=O)C(CO)O)=O,,,3,1,19,21,40
272_1,,,,2,2,1,3
274_0,,,,2,2,1,3
C(C(CCO)(CC=O)O)=O,,,3,1,17,19,36
276_0,,,,2,2,1,3
C(C(CCO)(C(C=O)O)O)=O,,,3,1,13,16,29
276_1,,,,2,2,1,3
278_0,,,,2,2,1,3
C(CC(C(CCO)=O)O)=O,,,3,1,28,29,57
280_0,,,,2,2,1,3
C(C(C(C=O)O)O)(CCO)=O,,,3,1,23,22,45
280_1,,,,2,2,1,3
282_0,,,,2,2,1,3
C(C(C(CO)C(C)O)=O)=O,,,3,1,17,19,36
282_1,,,,2,2,1,3
284_0,,,,2,2,1,3
C(C(C(CO)C(C(CO)O)O)=O)=O,,,3,1,16,17,33
284_1,,,,2,2,1,3
286_0,,,,2,2,1,3
C(C(C(CO)CO)=O)=O,,,3,1,22,23,45
286_1,,,,2,2,1,3
288_0,,,,2,2,1,3
C(C(C(CO)C(CO)O)=O)=O,,,3,1,18,18,36
288_1,,,,2,2,1,3
290_0,,,,2,2,1,3
C(CC(C(CC=O)O)O)=O,,,3,1,15,16,31
292_0,,,,2,2,1,3
C(CC(C(C(C=O)O)O)O)=O,,,3,1,23,25,48
292_1,,,,2,2,1,3
294_0,,,,2,2,1,3
C(CC(CC(C=O)O)O)=O,,,3,1,25,26,51
296_0,,,,2,2,1,3
C(C(C(CC(C=O)O)O)O)=O,,,3,1,21,21,42
296_1,,,,2,2,1,3
298_0,,,,2,2,1,3
C(C(C(C)O)C(C=O)O)=O,,,3,1,20,22,42
298_1,,,,2,2,1,3
300_0,,,,2,2,1,3
C(C(C(C(CO)O)O)C(C=O)O)=O,,,3,1,17,18,35
300_1,,,,2,2,1,3
302_0,,,,2,2,1,3
C(C(CO)C(C=O)O)=O,,,3,1,34,34,68
302_1,,,,2,2,1,3
304_0,,,,2,2,1,3
C(C(C(CO)O)C(C=O)O)=O,,,3,1,18,19,37
304_1,,,,2,2,1,3
306_0,,,,2,2,1,3
C(CC(CC(CO)=O)O)=O,,,3,1,32,32,64
308_0,,,,2,2,1,3
C(C(C(CC(CO)=O)O)O)=O,,,3,1,20,21,41
308_1,,,,2,2,1,3
310_0,,,,2,2,1,3
C(CC(CO)(CC=O)O)=O,,,3,1,14,14,28
312_0,,,,2,2,1,3
C(CC(CO)(C(C=O)O)O)=O,,,3,1,17,19,36
312_1,,,,2,2,1,3
314_0,,,,2,2,1,3
C(C(C(CO)=O)C(C)O)=O,,,3,1,18,21,39
314_1,,,,2,2,1,3
316_0,,,,2,2,1,3
C(C(C(CO)=O)C(C(CO)O)O)=O,,,3,1,13,14,27
316_1,,,,2,2,1,3
318_0,,,,2,2,1,3
C(C(C(CO)=O)CO)=O,,,3,1,31,36,67
318_1,,,,2,2,1,3
320_0,,,,2,2,1,3
C(C(C(CO)=O)C(CO)O)=O,,,3,1,17,16,33
320_1,,,,2,2,1,3
322_0,,,,2,2,1,3
C(CC(C(C(C)O)O)=O)=O,,,3,1,22,26,48
322_1,,,,2,2,1,3
324_0,,,,2,2,1,3
C(CC(C(C(C(CO)O)O)O)=O)=O,,,3,1,14,15,29
324_1,,,,2,2,1,3
326_0,,,,2,2,1,3
C(CC(C(CO)O)=O)=O,,,3,1,36,44,80
326_1,,,,2,2,1,3
328_0,,,,2,2,1,3
C(CC(C(C(CO)O)O)=O)=O,,,3,1,19,19,38
328_1,,,,2,2,1,3
330_0,,,,2,2,1,3
C(CC(C(C(C)=O)O)O)=O,,,3,1,31,30,61
332_0,,,,2,2,1,3
C(C(C(C(C(C)=O)O)O)O)=O,,,3,1,21,21,42
332_1,,,,2,2,1,3
334_0,,,,2,2,1,3
C(CC(C)(C(C=O)O)O)=O,,,3,1,24,27,51
336_0,,,,2,2,1,3
C(C(C(C)(C(C=O)O)O)O)=O,,,3,1,9,10,19
336_1,,,,2,2,1,3
338_0,,,,2,2,1,3
C(C(C(CC(C)O)=O)O)=O,,,3,1,19,23,42
340_0,,,,2,2,1,3
C(C(C(CC(C(CO)O)O)=O)O)=O,,,3,1,12,13,25
342_0,,,,2,2,1,3
C(C(C(CCO)=O)O)=O,,,3,1,34,41,75
344_0,,,,2,2,1,3
C(C(C(CC(CO)O)=O)O)=O,,,3,1,16,16,32
346_0,,,,2,2,1,3
C(CC(C)O)=O,,,3,1,181,366,547
348_0,,,,2,2,1,3
C(C(C(C)O)O)=O,,,3,1,103,149,252
348_1,,,,2,2,1,3
350_0,,,,2,2,1,3
C(CC(C(CO)O)O)=O,,,3,1,25,30,55
352_0,,,,2,2,1,3
C(CC(C(C(CO)O)O)O)=O,,,3,1,15,16,31
354_0,,,,2,2,1,3
C(CCO)=O,,,3,1,290,717,1007
356_0,,,,2,2,1,3
C(CC(CO)O)=O,,,3,1,84,149,233
357_0,,,,2,2,1,3
357_1,,,,2,2,1,3
359_0,,,,2,2,1,3
C(C(C)O)(O)=O,,,3,1,58,134,192
359_1,,,,2,2,1,3
361_0,,,,2,2,1,3
C(C(CCO)O)(O)=O,,,3,1,16,28,44
361_1,,,,2,2,1,3
363_0,,,,2,1,2,3
C(C(CO)=O)=O,,,3,1,282,441,723
365_0,,,,2,1,2,3
C(C(C(CO)O)=O)=O,,,3,1,72,75,147
367_0,,,,2,1,2,3
C(C(C(C(CO)O)O)=O)=O,,,3,1,21,23,44
369_0,,,,2,1,2,3
C(C(C(C(C(CO)O)O)O)=O)=O,,,3,1,15,19,34
370_0,,,,2,1,2,3
370_1,,,,2,1,2,3
371_0,,,,2,1,2,3
371_1,,,,2,1,2,3
372_0,,,,2,1,2,3
372_1,,,,2,1,2,3
373_0,,,,2,1,2,3
373_1,,,,2,1,2,3
373_2,,,,2,1,2,3
374_0,,,,2,1,2,3
374_1,,,,2,1,2,3
374_2,,,,2,1,2,3
375_0,,,,2,1,2,3
375_1,,,,2,1,2,3
375_2,,,,2,1,2,3
376_0,,,,2,1,2,3
376_1,,,,2,1,2,3
376_2,,,,2,1,2,3
377_0,,,,2,1,2,3
377_1,,,,2,1,2,3
377_2,,,,2,1,2,3
378_0,,,,2,1,2,3
378_1,,,,2,1,2,3
378_2,,,,2,1,2,3
379_0,,,,2,1,2,3
380_0,,,,2,1,2,3
381_0,,,,2,1,1,2
382_0,,,,2,1,1,2
383_0,,,,2,1,1,2
384_0,,,,2,1,1,2
385_0,,,,2,1,1,2
386_0,,,,2,1,1,2
387_0,,,,2,1,1,2
389_0,,,,2,1,1,2
C(C(CO)=O)(C)=O,,,3,1,125,213,338
391_0,,,,2,1,1,2
C(C(C(C)O)=O)=O,,,3,1,106,142,248
393_0,,,,2,3,2,5
C(C(C(C(CO)O)O)O)O,,,3,1,5,4,9
395_0,,,,2,3,2,5
C(C(C(C(C(CO)O)O)O)O)O,,,3,1,6,5,11
396_0,,,,2,3,2,5
398_0,,,,2,3,2,5
C(C(CO)(C(C(CO)O)O)O)O,,,3,1,8,6,14
400_0,,,,2,3,2,5
C(C(CO)(CO)O)O,,,3,1,2,4,6
402_0,,,,2,3,2,5
C(C(CO)(C(CO)O)O)O,,,3,1,6,4,10
404_0,,,,2,3,2,5
C(C(C(CO)O)(C(CO)O)O)O,,,3,1,6,4,10
406_0,,,,2,3,2,5
C(C)(CO)=O,,,3,1,402,907,1309
407_0,,,,2,3,2,5
409_0,,,,2,3,2,5
C(CO)(CCO)=O,,,3,1,127,219,346
410_0,,,,2,3,2,5
412_0,,,,2,3,2,5
C(C(CCO)O)=O,,,3,1,83,110,193
413_0,,,,2,3,2,5
415_0,,,,2,3,2,5
C(C)(C(CO)O)=O,,,3,1,129,184,313
417_0,,,,2,3,2,5
CCO,,,3,1,7,231,238
418_0,,,,2,3,2,5
419_0,,,,2,3,2,5
421_0,,,,2,3,2,5
C(C(O)=O)=O,,,3,1,156,253,409
423_0,,,,2,3,2,5
C(C(CO)(C(C(CO)O)O)O)(O)=O,,,3,1,12,13,25
425_0,,,,2,3,2,5
C(C(CO)(CO)O)(O)=O,,,3,1,6,5,11
427_0,,,,2,3,2,5
C(C(CO)(C(CO)O)O)(O)=O,,,3,1,11,10,21
429_0,,,,2,3,2,5
C(C(C(CO)O)(C(CO)O)O)(O)=O,,,3,1,8,7,15
431_0,,,,2,3,2,5
C(C(C)=O)(O)=O,,,3,1,133,230,363
433_0,,,,2,3,2,5
C(CC(O)=O)=O,,,3,1,164,323,487
435_0,,,,2,3,2,5
C(C(CCO)=O)(O)=O,,,3,1,39,55,94
437_0,,,,2,3,2,5
C(C(CC=O)O)(O)=O,,,3,1,52,72,124
439_0,,,,2,3,2,5
C(CC(C=O)O)(O)=O,,,3,1,48,55,103
441_0,,,,2,3,2,5
C(CC(CO)=O)(O)=O,,,3,1,57,85,142
443_0,,,,2,3,2,5
C(C(C(C)=O)O)(O)=O,,,3,1,60,70,130
445_0,,,,2,3,2,5
C(C)(O)=O,,,3,1,4,78,82
447_0,,,,2,2,1,3
C(C(C(C)O)(C(C(CO)O)O)O)=O,,,3,1,13,16,29
447_1,,,,2,2,1,3
448_0,,,,2,2,1,3
448_1,,,,2,2,1,3
450_0,,,,2,2,1,3
C(CO)(C(CO)(C(C=O)O)O)=O,,,3,1,15,18,33
450_1,,,,2,2,1,3
452_0,,,,2,2,1,3
C(C(CO)(C(C=O)O)O)(O)=O,,,3,1,16,16,32
452_1,,,,2,2,1,3
454_0,,,,2,2,1,3
C(C(C(CO)O)(C(C=O)O)O)(O)=O,,,3,1,17,17,34
454_1,,,,2,2,1,3
456_0,,,,2,2,1,3
C(C(C(C)=O)(C(C=O)O)O)=O,,,3,1,12,16,28
456_1,,,,2,2,1,3
458_0,,,,2,2,1,3
C(C(CO)(C(C=O)O)O)=O,,,3,1,18,24,42
458_1,,,,2,2,1,3
460_0,,,,2,2,1,3
C(C(C(CO)O)(C(C=O)O)O)=O,,,3,1,15,20,35
460_1,,,,2,2,1,3
462_0,,,,2,2,1,3
C(C(CO)(C(CO)(CO)O)O)(O)=O,,,3,1,9,8,17
462_1,,,,2,2,1,3
464_0,,,,2,2,1,3
C(C(C(C)=O)(C(CO)(CO)O)O)=O,,,3,1,6,7,13
464_1,,,,2,2,1,3
466_0,,,,2,2,1,3
C(C(CO)(C(CO)(CO)O)O)=O,,,3,1,8,11,19
466_1,,,,2,2,1,3
468_0,,,,2,2,1,3
C(C(C)(C(C(CO)=O)(CO)O)O)=O,,,3,1,13,16,29
468_1,,,,2,2,1,3
470_0,,,,2,2,1,3
C(CO)(C(CO)(C(C(C)=O)O)O)=O,,,3,1,16,17,33
470_1,,,,2,2,1,3
472_0,,,,2,2,1,3
C(CC(C(C(CO)=O)(CO)O)O)=O,,,3,1,15,17,32
472_1,,,,2,2,1,3
474_0,,,,2,2,1,3
C(CO)(C(CO)(C(C)O)O)=O,,,3,1,11,12,23
474_1,,,,2,2,1,3
476_0,,,,2,2,1,3
C(CO)(C(CO)(CO)O)=O,,,3,1,11,12,23
476_1,,,,2,2,1,3
478_0,,,,2,2,1,3
C(CO)(C(CO)(C(CO)O)O)=O,,,3,1,13,12,25
478_1,,,,2,2,1,3
480_0,,,,2,2,1,3
C(C(CO)(C(C=O)(C)O)O)(O)=O,,,3,1,11,13,24
480_1,,,,2,2,1,3
482_0,,,,2,2,1,3
C(C(CO)(C(C(C)=O)O)O)(O)=O,,,3,1,14,13,27
482_1,,,,2,2,1,3
484_0,,,,2,2,1,3
C(C(CO)(C(CC=O)O)O)(O)=O,,,3,1,14,15,29
484_1,,,,2,2,1,3
486_0,,,,2,2,1,3
C(C(CO)(C(C)O)O)(O)=O,,,3,1,9,8,17
486_1,,,,2,2,1,3
487_0,,,,2,2,1,3
487_1,,,,2,2,1,3
488_0,,,,2,2,1,3
488_1,,,,2,2,1,3
489_0,,,,2,2,1,3
489_1,,,,2,2,1,3
491_0,,,,2,2,1,3
C(C(C(CO)O)(C(C)O)O)(O)=O,,,3,1,12,11,23
491_1,,,,2,2,1,3
492_0,,,,2,2,1,3
492_1,,,,2,2,1,3
493_0,,,,2,2,1,3
493_1,,,,2,2,1,3
494_0,,,,2,2,1,3
494_1,,,,2,2,1,3
496_0,,,,2,2,1,3
C(C(C)(C(C=O)(C(C)=O)O)O)=O,,,3,1,6,12,18
496_1,,,,2,2,1,3
498_0,,,,2,2,1,3
C(C(CO)(C(C=O)(C)O)O)=O,,,3,1,8,15,23
498_1,,,,2,2,1,3
500_0,,,,2,2,1,3
C(C(C(CO)O)(C(C=O)(C)O)O)=O,,,3,1,13,17,30
500_1,,,,2,2,1,3
502_0,,,,2,2,1,3
C(C(C(C)=O)(C(C(C)=O)O)O)=O,,,3,1,11,14,25
502_1,,,,2,2,1,3
504_0,,,,2,2,1,3
C(C(CO)(C(C(C)=O)O)O)=O,,,3,1,16,19,35
504_1,,,,2,2,1,3
506_0,,,,2,2,1,3
C(C(C(CO)O)(C(C(C)=O)O)O)=O,,,3,1,16,18,34
506_1,,,,2,2,1,3
508_0,,,,2,2,1,3
C(CC(C(C=O)(C(C)=O)O)O)=O,,,3,1,9,14,23
508_1,,,,2,2,1,3
510_0,,,,2,2,1,3
C(C(CO)(C(CC=O)O)O)=O,,,3,1,13,19,32
510_1,,,,2,2,1,3
512_0,,,,2,2,1,3
C(C(C(CC=O)O)(C(CO)O)O)=O,,,3,1,15,18,33
512_1,,,,2,2,1,3
514_0,,,,2,2,1,3
C(C(CCO)(C(C=O)(CO)O)O)=O,,,3,1,12,16,28
514_1,,,,2,2,1,3
516_0,,,,2,2,1,3
C(C(CO)(C(C(CCO)=O)O)O)=O,,,3,1,16,18,34
516_1,,,,2,2,1,3
518_0,,,,2,2,1,3
C(C(CO)(C(C(CC=O)O)O)O)=O,,,3,1,16,20,36
518_1,,,,2,2,1,3
520_0,,,,2,2,1,3
C(C(CO)(C(CC(C=O)O)O)O)=O,,,3,1,15,18,33
520_1,,,,2,2,1,3
522_0,,,,2,2,1,3
C(C(CO)(C(CC(CO)=O)O)O)=O,,,3,1,14,17,31
522_1,,,,2,2,1,3
524_0,,,,2,2,1,3
C(C(CO)(C(CO)(CC=O)O)O)=O,,,3,1,13,16,29
524_1,,,,2,2,1,3
526_0,,,,2,2,1,3
C(C(C(C)=O)(C(C)O)O)=O,,,3,1,9,13,22
526_1,,,,2,2,1,3
528_0,,,,2,2,1,3
C(C(C(C)=O)(C(C(CO)O)O)O)=O,,,3,1,11,13,24
528_1,,,,2,2,1,3
530_0,,,,2,2,1,3
C(C(C(C)=O)(CO)O)=O,,,3,1,17,21,38
530_1,,,,2,2,1,3
532_0,,,,2,2,1,3
C(C(C(C)=O)(C(CO)O)O)=O,,,3,1,10,12,22
532_1,,,,2,2,1,3
534_0,,,,2,2,1,3
C(C(CO)(C(C(C(C)=O)O)O)O)=O,,,3,1,15,18,33
534_1,,,,2,2,1,3
536_0,,,,2,2,1,3
C(C(CO)(C(C)(C(C=O)O)O)O)=O,,,3,1,13,17,30
536_1,,,,2,2,1,3
538_0,,,,2,2,1,3
C(C(CO)(C(C)O)O)=O,,,3,1,10,17,27
538_1,,,,2,2,1,3
540_0,,,,2,2,1,3
C(C(C(CO)O)(C(C)O)O)=O,,,3,1,11,14,25
540_1,,,,2,2,1,3
542_0,,,,2,2,1,3
C(CC(C=O)(C(C=O)O)O)=O,,,3,1,14,20,34
544_0,,,,2,2,1,3
C(C(C(C=O)O)O)(O)=O,,,3,1,33,39,72
546_0,,,,2,2,1,3
C(C(C(CO)(CO)O)(CC=O)O)=O,,,3,1,8,10,18
548_0,,,,2,2,1,3
C(C(C(CO)(CO)O)O)(O)=O,,,3,1,9,7,16
550_0,,,,2,2,1,3
C(C(C(CO)(C(CO)O)O)O)(O)=O,,,3,1,10,10,20
552_0,,,,2,2,1,3
C(C(C(C(CO)(CO)O)O)O)(O)=O,,,3,1,8,8,16
554_0,,,,2,2,1,3
C(CC(C=O)(C(C=O)(C)O)O)=O,,,3,1,7,15,22
556_0,,,,2,2,1,3
C(C(C)(C(C(O)=O)O)O)=O,,,3,1,13,16,29
558_0,,,,2,2,1,3
C(CC(C=O)(C(C(C)=O)O)O)=O,,,3,1,12,17,29
560_0,,,,2,2,1,3
C(C(C(C(C)=O)O)O)(O)=O,,,3,1,27,25,52
562_0,,,,2,2,1,3
C(CC(C(C=O)(CC=O)O)O)=O,,,3,1,14,21,35
564_0,,,,2,2,1,3
C(CC(C(C(O)=O)O)O)=O,,,3,1,20,24,44
566_0,,,,2,2,1,3
C(C(CCO)(C(C(O)=O)O)O)=O,,,3,1,11,12,23
568_0,,,,2,2,1,3
C(C(C(C(O)=O)O)O)(CCO)=O,,,3,1,14,12,26
570_0,,,,2,2,1,3
C(C(C(C)O)(CC=O)O)=O,,,3,1,16,20,36
572_0,,,,2,2,1,3
C(C(C(C(CO)O)O)(CC=O)O)=O,,,3,1,13,16,29
574_0,,,,2,2,1,3
C(C(CO)(CC=O)O)=O,,,3,1,25,31,56
576_0,,,,2,2,1,3
C(C(C(CO)O)(CC=O)O)=O,,,3,1,13,17,30
578_0,,,,2,2,1,3
C(CC(C(C(C(O)=O)O)O)O)=O,,,3,1,16,17,33
580_0,,,,2,2,1,3
C(C(C(CC(C=O)O)O)O)(O)=O,,,3,1,14,15,29
582_0,,,,2,2,1,3
C(C(C(CC(CO)=O)O)O)(O)=O,,,3,1,12,11,23
584_0,,,,2,2,1,3
C(CC(CO)(C(C(O)=O)O)O)=O,,,3,1,13,13,26
586_0,,,,2,2,1,3
C(C(C(C(C(C)=O)O)O)O)(O)=O,,,3,1,14,13,27
588_0,,,,2,2,1,3
C(C(C(C)(C(C=O)O)O)O)(O)=O,,,3,1,12,13,25
590_0,,,,2,2,1,3
C(C(C(C)O)O)(O)=O,,,3,1,27,44,71
591_0,,,,2,1,2,3
592_0,,,,2,1,2,3
593_0,,,,2,1,2,3
594_0,,,,2,1,2,3
595_0,,,,2,1,2,3
597_0,,,,2,1,2,3
C(C(CC(CO)=O)O)=O,,,3,1,44,49,93
598_0,,,,2,1,2,3
599_0,,,,2,1,2,3
600_0,,,,2,1,2,3
601_0,,,,2,1,2,3
602_0,,,,2,1,2,3
604_0,,,,2,1,2,3
C(CC(C=O)O)(C(CO)O)=O,,,3,1,22,20,42
605_0,,,,2,1,2,3
606_0,,,,2,1,2,3
607_0,,,,2,1,2,3
608_0,,,,2,1,2,3
609_0,,,,2,1,2,3
610_0,,,,2,1,2,3
611_0,,,,2,1,2,3
612_0,,,,2,1,2,3
613_0,,,,2,1,2,3
614_0,,,,2,1,2,3
615_0,,,,2,1,2,3
616_0,,,,2,1,2,3
617_0,,,,2,1,2,3
618_0,,,,2,1,2,3
619_0,,,,2,1,2,3
620_0,,,,2,1,2,3
621_0,,,,2,1,2,3
622_0,,,,2,1,2,3
623_0,,,,2,1,2,3
625_0,,,,2,1,2,3
C(C(CO)(CC(CO)=O)O)=O,,,3,1,15,17,32
626_0,,,,2,1,2,3
628_0,,,,2,1,2,3
C(C(C(CCO)=O)(CO)O)=O,,,3,1,9,12,21
630_0,,,,2,1,2,3
C(C(C(C(CO)O)=O)CO)=O,,,3,1,17,17,34
631_0,,,,2,1,2,3
632_0,,,,2,1,2,3
633_0,,,,2,1,2,3
634_0,,,,2,1,2,3
635_0,,,,2,1,2,3
636_0,,,,2,1,2,3
637_0,,,,2,1,2,3
638_0,,,,2,1,2,3
639_0,,,,2,1,2,3
640_0,,,,2,1,2,3
642_0,,,,2,1,2,3
C(C(CC(CO)O)=O)(O)=O,,,3,1,13,16,29
644_0,,,,2,1,2,3
C(C(CC(CO)=O)O)(O)=O,,,3,1,24,23,47
645_0,,,,2,1,2,3
647_0,,,,2,1,2,3
C(CC(C(CO)O)=O)(O)=O,,,3,1,19,23,42
649_0,,,,2,1,2,3
C(C(C(CCO)=O)O)(O)=O,,,3,1,20,21,41
650_0,,,,2,1,2,3
652_0,,,,2,1,2,3
C(C(CC(C(CO)O)O)=O)(O)=O,,,3,1,10,13,23
654_0,,,,2,1,2,3
C(CC(C(O)=O)O)(C(CO)O)=O,,,3,1,13,12,25
655_0,,,,2,1,2,3
657_0,,,,2,1,2,3
C(CC(C(C(CO)O)O)=O)(O)=O,,,3,1,12,14,26
659_0,,,,2,1,2,3
C(C(C(CC(CO)O)=O)O)(O)=O,,,3,1,13,12,25
660_0,,,,2,1,2,3
661_0,,,,2,1,2,3
662_0,,,,2,1,2,3
664_0,,,,2,1,2,3
C1(COCC1O)=O,,,3,1,134,216,350
666_0,,,,2,1,2,3
C1(C(O)OCC1)=O,,,3,1,113,181,294
668_0,,,,2,1,2,3
C1(CC(CO1)O)=O,,,3,1,32,65,97
670_0,,,,2,1,2,3
C1(COC(C1)O)=O,,,3,1,113,219,332
672_0,,,,2,1,2,3
C=CC(C=O)=O,,,3,1,236,453,689
674_0,,,,2,1,2,3
C(C=CC=O)=O,,,3,1,157,310,467
675_0,,,,2,2,1,3
676_0,,,,2,2,1,3
677_0,,,,2,2,1,3
678_0,,,,2,2,1,3
679_0,,,,2,2,1,3
680_0,,,,2,2,1,3
681_0,,,,2,2,1,3
682_0,,,,2,2,1,3
684_0,,,,2,1,1,2
C(C1C(C(C(O)O1)O)O)O,,,3,1,3,5,8
686_0,,,,2,1,1,2
C(C(C1C(C(C(O)O1)O)O)O)O,,,3,1,5,7,12
688_0,,,,2,1,1,2
C1(C(CO)(C(C(CO)O1)O)O)O,,,3,1,3,4,7
690_0,,,,2,1,1,2
C1C(C(C(O)O1)(CO)O)O,,,3,1,3,4,7
692_0,,,,2,1,1,2
C1C(C(C(O)O1)(C(CO)O)O)O,,,3,1,6,6,12
693_0,,,,2,1,1,2
694_0,,,,2,1,1,2
696_0,,,,2,1,1,2
C1C(C(C(C(O)O1)O)O)O,,,3,1,5,7,12
698_0,,,,2,1,1,2
C(C1C(C(C(C(O)O1)O)O)O)O,,,3,1,5,7,12
700_0,,,,2,1,1,2
C1C(C(C(C(O)O1)(CO)O)O)O,,,3,1,5,6,11
702_0,,,,2,1,1,2
C1C(C(C(C(C(O)O1)O)O)O)O,,,3,1,7,9,16
703_0,,,,2,1,1,2
705_0,,,,2,1,2,3
C1(C(C(CO1)O)O)=O,,,3,1,26,42,68
707_0,,,,2,1,2,3
C1(C(C(C(CO)O1)O)O)=O,,,3,1,11,9,20
709_0,,,,2,1,2,3
C1(C(C(C(C(CO)O)O1)O)O)=O,,,3,1,9,5,14
711_0,,,,2,1,2,3
C1(C(C(C(CO1)O)O)O)=O,,,3,1,12,12,24
713_0,,,,2,1,2,3
C1(C(C(C(C(CO)O1)O)O)O)=O,,,3,1,8,6,14
715_0,,,,2,1,2,3
C1(C(C(C(C(CO1)O)O)O)O)=O,,,3,1,9,9,18
717_0,,,,2,1,1,2
C1(C(C(C(C1O)O)O)O)=O,,,4,1,6,13,19
717_1,,,,2,1,1,2
719_0,,,,2,1,1,2
C(C1C(C(C(C1O)O)O)=O)=O,,,4,1,5,21,26
719_1,,,,2,1,1,2
720_0,,,,2,1,1,2
720_1,,,,2,1,1,2
722_0,,,,2,1,1,2
C1(C(C(C(C)(C1O)O)O)O)=O,,,4,1,11,15,26
722_1,,,,2,1,1,2
723_0,,,,2,1,1,2
723_1,,,,2,1,1,2
725_0,,,,2,1,1,2
C1(C(C(C(CO)(C1)O)O)O)=O,,,4,1,6,16,22
727_0,,,,2,1,1,2
C1(C(C(CC(C1O)O)O)O)=O,,,4,1,5,8,13
727_1,,,,2,1,1,2
729_0,,,,2,1,1,2
C1(C(C(C(C1O)O)(CCO)O)O)=O,,,4,1,5,14,19
729_1,,,,2,1,1,2
730_0,,,,2,1,1,2
730_1,,,,2,1,1,2
732_0,,,,2,1,1,2
C1(C(C(C(CO)(C1CO)O)O)O)=O,,,4,1,6,15,21
732_1,,,,2,1,1,2
734_0,,,,2,1,1,2
C1(C(C(C(CC(C1O)O)O)O)O)=O,,,4,1,5,16,21
734_1,,,,2,1,1,2
736_0,,,,2,1,1,2
C(C1C(C(C(C1(CO)O)O)O)O)=O,,,4,1,5,18,23
736_1,,,,2,1,1,2
737_0,,,,2,1,1,2
737_1,,,,2,1,1,2
739_0,,,,2,1,1,2
C1(C(C(CO)(CC(C1O)O)O)O)=O,,,4,1,4,14,18
739_1,,,,2,1,1,2
741_0,,,,2,1,1,2
C1(C(C(CO)(C(C(C1)O)O)O)O)=O,,,4,1,5,13,18
741_1,,,,2,1,1,2
742_0,,,,2,1,1,2
742_1,,,,2,1,1,2
744_0,,,,2,1,1,2
C1(C(C(C)(C(C(C1O)O)O)O)O)=O,,,4,1,4,14,18
744_1,,,,2,1,1,2
746_0,,,,2,1,1,2
C1(C(C(C(C(CO)(C1)O)O)O)O)=O,,,4,1,1,14,15
747_0,,,,2,1,1,2
747_1,,,,2,1,1,2
749_0,,,,2,1,1,2
C1(C(C(C(C(CO)O)(C1)O)O)O)=O,,,4,1,5,15,20
751_0,,,,2,1,1,2
C(C1C(C(C(C1(C)O)O)O)=O)=O,,,4,1,5,18,23
751_1,,,,2,1,1,2
753_0,,,,2,1,1,2
C(C1C(C(C(C)(C1O)O)O)=O)=O,,,4,1,5,17,22
753_1,,,,2,1,1,2
755_0,,,,2,1,1,2
C(C1(CC(C(C1)=O)O)O)=O,,,4,1,5,21,26
757_0,,,,2,1,1,2
C1(CC(C(CC1O)=O)O)=O,,,4,1,4,14,18
759_0,,,,2,1,1,2
C(C1C(CC(C1O)=O)O)=O,,,4,1,9,27,36
761_0,,,,2,1,1,2
C(C1(C(CO)C(C(C1)=O)O)O)=O,,,4,1,2,14,16
763_0,,,,2,1,1,2
C1(C(C(C(C(C1)O)=O)CO)O)=O,,,4,1,6,14,20
765_0,,,,2,1,1,2
C(C1C(C(CC(C1O)=O)O)O)=O,,,4,1,6,20,26
767_0,,,,2,1,1,2
C1(C(C(C(C1)O)C(C=O)O)O)=O,,,4,1,2,16,18
769_0,,,,2,1,1,2
C(CO)(C1C(CC(C1O)=O)O)=O,,,4,1,7,16,23
771_0,,,,2,1,1,2
C(C1C(CO)(CC(C1O)=O)O)=O,,,4,1,7,17,24
772_0,,,,2,1,1,2
772_1,,,,2,1,1,2
774_0,,,,2,1,1,2
C1(C(C(C(CC(C1)O)=O)O)O)=O,,,4,1,3,7,10
776_0,,,,2,1,1,2
C(CC1(C(C(C(C1)=O)O)O)O)=O,,,4,1,4,19,23
777_0,,,,2,1,1,2
777_1,,,,2,1,1,2
779_0,,,,2,1,1,2
C1(CC(C(CC(C1O)O)=O)O)=O,,,4,1,4,13,17
781_0,,,,2,1,1,2
C1(C(CC(C(C=O)O)(C1)O)O)=O,,,4,1,2,17,19
783_0,,,,2,1,1,2
C1(C(CC(C1)O)O)=O,,,4,1,4,77,81
785_0,,,,2,1,1,2
C1(C(C(C(C1)O)O)O)=O,,,4,1,8,40,48
786_0,,,,2,1,1,2
786_1,,,,2,1,1,2
788_0,,,,2,1,1,2
C1(C(CO)C(C=O)(CC1O)O)=O,,,4,1,6,15,21
788_1,,,,2,1,1,2
789_0,,,,2,1,1,2
789_1,,,,2,1,1,2
791_0,,,,2,1,1,2
C(C(C1C(C(CC1O)O)O)=O)=O,,,4,1,4,21,25
791_1,,,,2,1,1,2
793_0,,,,2,1,1,2
C(C1C(C(CC1(C=O)O)O)O)=O,,,4,1,5,21,26
793_1,,,,2,1,1,2
794_0,,,,2,1,1,2
794_1,,,,2,1,1,2
795_0,,,,2,1,1,2
795_1,,,,2,1,1,2
797_0,,,,2,1,1,2
C(C1(CC(CC(C1O)=O)O)O)=O,,,4,1,4,17,21
797_1,,,,2,1,1,2
798_0,,,,2,1,1,2
798_1,,,,2,1,1,2
799_0,,,,2,1,1,2
799_1,,,,2,1,1,2
800_0,,,,2,1,1,2
800_1,,,,2,1,1,2
802_0,,,,2,1,1,2
C(C1(CC(C(C(C1)=O)O)O)O)=O,,,4,1,3,17,20
803_0,,,,2,1,1,2
805_0,,,,2,1,1,2
C(C1C(C(C(C1O)=O)CO)O)=O,,,4,1,10,19,29
805_1,,,,2,1,1,2
807_0,,,,2,1,1,2
C(C1C(C(C=O)C(C1O)O)O)=O,,,4,1,5,12,17
807_1,,,,2,1,1,2
809_0,,,,2,1,1,2
C(C1C(C(C(CC1O)O)O)=O)=O,,,4,1,5,17,22
809_1,,,,2,1,1,2
811_0,,,,2,1,1,2
C(C1C(CC(C(C1O)O)=O)O)=O,,,4,1,8,19,27
811_1,,,,2,1,1,2
812_0,,,,2,1,1,2
812_1,,,,2,1,1,2
813_0,,,,2,1,1,2
813_1,,,,2,1,1,2
814_0,,,,2,1,1,2
814_1,,,,2,1,1,2
815_0,,,,2,1,1,2
815_1,,,,2,1,1,2
816_0,,,,2,1,1,2
816_1,,,,2,1,1,2
817_0,,,,2,1,1,2
819_0,,,,2,1,1,2
C1(C(CC(C1CO)O)O)=O,,,4,1,4,17,21
819_1,,,,2,1,1,2
821_0,,,,2,1,1,2
C1(C(C(C(C1CO)O)O)O)=O,,,4,1,7,17,24
821_1,,,,2,1,1,2
823_0,,,,2,1,1,2
C(C1C(C(CC1O)O)O)=O,,,4,1,4,19,23
823_1,,,,2,1,1,2
825_0,,,,2,1,1,2
C(C1C(C(C(C1O)O)O)O)=O,,,4,1,3,12,15
825_1,,,,2,1,1,2
826_0,,,,2,1,1,2
826_1,,,,2,1,1,2
828_0,,,,2,1,1,2
C1(C(C(CC(C1)O)O)O)=O,,,4,1,3,23,26
828_1,,,,2,1,1,2
830_0,,,,2,1,1,2
C1(C(C(C(C(C1)O)O)O)O)=O,,,4,1,4,16,20
830_1,,,,2,1,1,2
831_0,,,,2,1,1,2
832_0,,,,2,1,1,2
834_0,,,,2,1,1,2
C1(C(C(C(C1(CO)O)O)O)O)=O,,,4,1,7,15,22
834_1,,,,2,1,1,2
836_0,,,,2,1,1,2
C(C1(C(CC(C1O)O)=O)O)=O,,,4,1,3,15,18
838_0,,,,2,1,1,2
C1(C(C(C(C)(C1(CO)O)O)O)O)=O,,,4,1,7,14,21
838_1,,,,2,1,1,2
840_0,,,,2,1,1,2
C1(C(C(C)(C(C1(CO)O)O)O)O)=O,,,4,1,7,14,21
840_1,,,,2,1,1,2
842_0,,,,2,1,1,2
C1(C(C(CO)(C(CO)(C1)O)O)O)=O,,,4,1,2,12,14
844_0,,,,2,1,1,2
C1(C(C(CC(C1(CO)O)O)O)O)=O,,,4,1,7,15,22
844_1,,,,2,1,1,2
846_0,,,,2,1,1,2
C(C1(C(CC(C1(C)O)O)=O)O)=O,,,4,1,3,12,15
848_0,,,,2,1,1,2
C(C)(C1(C(CC(C1O)=O)O)O)=O,,,4,1,6,16,22
850_0,,,,2,1,1,2
C(C1(C(C)(CC(C1O)=O)O)O)=O,,,4,1,3,16,19
852_0,,,,2,1,1,2
C(C1(C(CC(C)(C1O)O)=O)O)=O,,,4,1,3,13,16
854_0,,,,2,1,1,2
C1(C(C(C(C1)O)(CO)O)O)=O,,,4,1,7,15,22
856_0,,,,2,1,1,2
C1(C(C(C(C1)O)(C(CO)O)O)O)=O,,,4,1,6,14,20
858_0,,,,2,1,1,2
C(C1(C(CC(CC1O)O)=O)O)=O,,,4,1,3,12,15
860_0,,,,2,1,1,2
C1(C(C(CO)(C(C1CO)O)O)O)=O,,,4,1,7,14,21
860_1,,,,2,1,1,2
862_0,,,,2,1,1,2
C(C1C(C(CO)(C(C1O)O)O)O)=O,,,4,1,6,18,24
862_1,,,,2,1,1,2
864_0,,,,2,1,1,2
C1(C(C(C(C(C1)O)(CO)O)O)O)=O,,,4,1,4,12,16
864_1,,,,2,1,1,2
865_0,,,,2,1,1,2
867_0,,,,2,1,1,2
C(CC1(C(CC(C1O)=O)O)O)=O,,,4,1,4,17,21
868_0,,,,2,1,1,2
870_0,,,,2,1,1,2
C(C1C(C(C=O)(CC1O)O)O)=O,,,4,1,4,20,24
870_1,,,,2,1,1,2
872_0,,,,2,1,1,2
C(C1C(CC(C1(C=O)O)O)O)=O,,,4,1,5,20,25
872_1,,,,2,1,1,2
873_0,,,,2,1,1,2
873_1,,,,2,1,1,2
874_0,,,,2,1,1,2
874_1,,,,2,1,1,2
876_0,,,,2,2,1,3
C(CC(CO)(C(C(C=O)O)O)O)=O,,,4,1,8,20,28
877_0,,,,2,2,1,3
879_0,,,,2,2,1,3
C(C(C(C=O)O)O)(C(C(C)O)O)=O,,,4,1,6,19,25
879_1,,,,2,2,1,3
880_0,,,,2,2,1,3
880_1,,,,2,2,1,3
882_0,,,,2,2,1,3
C(C(CC(C=O)(CC=O)O)O)=O,,,4,1,5,18,23
884_0,,,,2,2,1,3
C(C(CC(C=O)(C(C=O)O)O)O)=O,,,4,1,4,19,23
884_1,,,,2,2,1,3
886_0,,,,2,2,1,3
C(CC(C(CC(C=O)O)=O)O)=O,,,4,1,7,20,27
888_0,,,,2,2,1,3
C(C(C(C(CC(C=O)O)=O)O)O)=O,,,4,1,5,23,28
888_1,,,,2,2,1,3
889_0,,,,2,2,1,3
891_0,,,,2,2,1,3
C(C(C(C(CC(C=O)=O)O)O)O)=O,,,4,1,3,23,26
891_1,,,,2,2,1,3
893_0,,,,2,2,1,3
C(C(C(C(C=O)=O)C(C=O)O)O)=O,,,4,1,2,8,10
893_1,,,,2,2,1,3
895_0,,,,2,2,1,3
C(C(C(C(C=O)=O)C(C)O)O)=O,,,4,1,4,18,22
895_1,,,,2,2,1,3
896_0,,,,2,2,1,3
896_1,,,,2,2,1,3
898_0,,,,2,2,1,3
C(C(C(C(C=O)=O)C(CO)O)O)=O,,,4,1,5,17,22
898_1,,,,2,2,1,3
899_0,,,,2,2,1,3
901_0,,,,2,2,1,3
C(C(C(C(C=O)C(C=O)O)O)O)=O,,,4,1,7,22,29
901_1,,,,2,2,1,3
902_0,,,,2,2,1,3
904_0,,,,2,2,1,3
C(C(C=O)C(C(C(C=O)O)O)O)=O,,,4,1,4,18,22
904_1,,,,2,2,1,3
906_0,,,,2,2,1,3
C(C(CO)O)(C(C=O)C(C=O)O)=O,,,4,1,5,17,22
906_1,,,,2,2,1,3
908_0,,,,2,2,1,3
C(C(C(C(C(C=O)O)O)=O)CO)=O,,,4,1,6,19,25
908_1,,,,2,2,1,3
910_0,,,,2,2,1,3
C(C(CO)C(C=O)O)(C(C=O)O)=O,,,4,1,4,18,22
910_1,,,,2,2,1,3
912_0,,,,2,2,1,3
C(C(CO)C(C(C(C=O)O)O)O)=O,,,4,1,12,22,34
912_1,,,,2,2,1,3
914_0,,,,2,2,1,3
C(C(C(C(C(C(C)=O)O)O)O)O)=O,,,4,1,8,22,30
914_1,,,,2,2,1,3
916_0,,,,2,2,1,3
C(C(C(C(CC(CO)=O)O)O)O)=O,,,4,1,10,20,30
917_0,,,,2,2,1,3
918_0,,,,2,2,1,3
918_1,,,,2,2,1,3
919_0,,,,2,2,1,3
921_0,,,,2,2,1,3
C(C(C(C(C(C=O)O)O)O)O)=O,,,4,1,5,12,17
921_1,,,,2,2,1,3
922_0,,,,2,2,1,3
922_1,,,,2,2,1,3
924_0,,,,2,2,1,3
C(CC(CC(CO)(CO)O)O)=O,,,4,1,2,10,12
926_0,,,,2,2,1,3
C(C(C(CC(CO)(CO)O)O)O)=O,,,4,1,4,11,15
926_1,,,,2,2,1,3
927_0,,,,2,2,1,3
927_1,,,,2,2,1,3
929_0,,,,2,2,1,3
C(C(C(C)O)C(CO)(CO)O)=O,,,4,1,5,12,17
929_1,,,,2,2,1,3
931_0,,,,2,2,1,3
C(C(CO)C(CO)(CO)O)=O,,,4,1,7,12,19
931_1,,,,2,2,1,3
933_0,,,,2,2,1,3
C(C(C(CO)O)C(CO)(CO)O)=O,,,4,1,7,12,19
933_1,,,,2,2,1,3
935_0,,,,2,2,1,3
C(CC(C(C(CO)(CO)O)O)O)=O,,,4,1,4,10,14
936_0,,,,2,2,1,3
936_1,,,,2,2,1,3
937_0,,,,2,2,1,3
938_0,,,,2,2,1,3
938_1,,,,2,2,1,3
940_0,,,,2,2,1,3
C(C(CO)C(C(C(CO)=O)O)O)=O,,,4,1,10,18,28
940_1,,,,2,2,1,3
941_0,,,,2,2,1,3
941_1,,,,2,2,1,3
943_0,,,,2,2,1,3
C(CC(CO)(C(C(C)O)O)O)=O,,,4,1,1,13,14
945_0,,,,2,2,1,3
C(C(C(CO)(C(C(C)O)O)O)O)=O,,,4,1,2,13,15
945_1,,,,2,2,1,3
946_0,,,,2,2,1,3
946_1,,,,2,2,1,3
948_0,,,,2,2,1,3
C(C(C(C)O)O)(C(C(C)O)O)=O,,,4,1,2,6,8
948_1,,,,2,2,1,3
949_0,,,,2,2,1,3
949_1,,,,2,2,1,3
951_0,,,,2,2,1,3
C(C(C(CO)O)O)(C(C(C)O)O)=O,,,4,1,5,14,19
951_1,,,,2,2,1,3
953_0,,,,2,2,1,3
C(CC(CO)(C(C(CO)O)O)O)=O,,,4,1,8,13,21
954_0,,,,2,2,1,3
954_1,,,,2,2,1,3
955_0,,,,2,2,1,3
955_1,,,,2,2,1,3
957_0,,,,2,2,1,3
C(C(CO)C(CO)(C(CO)O)O)=O,,,4,1,9,14,23
957_1,,,,2,2,1,3
959_0,,,,2,2,1,3
C(CC(C(CO)O)(C(CO)O)O)=O,,,4,1,4,8,12
961_0,,,,2,2,1,3
C(C(CO)C(C(CO)(CO)O)O)=O,,,4,1,7,11,18
961_1,,,,2,2,1,3
963_0,,,,2,2,1,3
C(C(C)(CC(C=O)(CC=O)O)O)=O,,,4,1,1,13,14
965_0,,,,2,2,1,3
C(CC(C(CC(C=O)(C)O)=O)O)=O,,,4,1,2,15,17
967_0,,,,2,2,1,3
C(CC(C(C)(CC(C=O)=O)O)O)=O,,,4,1,2,18,20
969_0,,,,2,2,1,3
C(C(C)(C(C(C=O)=O)C(C)O)O)=O,,,4,1,4,13,17
969_1,,,,2,2,1,3
970_0,,,,2,2,1,3
970_1,,,,2,2,1,3
972_0,,,,2,2,1,3
C(CC(C(C=O)C(C=O)(C)O)O)=O,,,4,1,5,16,21
974_0,,,,2,2,1,3
C(C(C=O)C(C)(C(CC=O)O)O)=O,,,4,1,3,14,17
976_0,,,,2,2,1,3
C(C(CO)C(CC(C=O)(C)O)O)=O,,,4,1,5,15,20
976_1,,,,2,2,1,3
978_0,,,,2,2,1,3
C(C(C)(CC(C(C(C)=O)O)O)O)=O,,,4,1,2,15,17
978_1,,,,2,2,1,3
980_0,,,,2,2,1,3
C(C(C)(CC(CC(CO)=O)O)O)=O,,,4,1,2,13,15
982_0,,,,2,2,1,3
C(C(C)(CC(CC(C=O)=O)O)O)=O,,,4,1,1,13,14
984_0,,,,2,2,1,3
C(C(C=O)C(CC(C=O)(C)O)O)=O,,,4,1,2,11,13
984_1,,,,2,2,1,3
986_0,,,,2,2,1,3
C(C(C)(CC(CC=O)O)O)=O,,,4,1,3,16,19
988_0,,,,2,2,1,3
C(C(C)(CC(C(C=O)O)O)O)=O,,,4,1,2,17,19
988_1,,,,2,2,1,3
990_0,,,,2,2,1,3
C(C(CO)C(C(C)(CC=O)O)O)=O,,,4,1,6,18,24
990_1,,,,2,2,1,3
992_0,,,,2,2,1,3
C(CC(C)(C(C(C(C)=O)O)O)O)=O,,,4,1,3,18,21
992_1,,,,2,2,1,3
994_0,,,,2,2,1,3
C(CC(C)(C(CC(CO)=O)O)O)=O,,,4,1,3,16,19
996_0,,,,2,2,1,3
C(CC(C)(C(CC(C=O)=O)O)O)=O,,,4,1,2,18,20
998_0,,,,2,2,1,3
C(C(C=O)C(C(C)(CC=O)O)O)=O,,,4,1,3,14,17
998_1,,,,2,2,1,3
1000_0,,,,2,2,1,3
C(CC(C(C)(CC=O)O)O)=O,,,4,1,6,22,28
1002_0,,,,2,2,1,3
C(CC(C)(C(C(C=O)O)O)O)=O,,,4,1,3,21,24
1002_1,,,,2,2,1,3
1004_0,,,,2,2,1,3
C(C(C(CCO)O)C(C=O)(C)O)=O,,,4,1,5,14,19
1004_1,,,,2,2,1,3
1006_0,,,,2,2,1,3
C(C(C(CO)(C)O)C(C=O)(C)O)=O,,,4,1,5,14,19
1006_1,,,,2,2,1,3
1008_0,,,,2,2,1,3
C(C(C(C=O)C(C=O)(C)O)O)(O)=O,,,4,1,5,14,19
1008_1,,,,2,2,1,3
1009_0,,,,2,2,1,3
1009_1,,,,2,2,1,3
1011_0,,,,2,2,1,3
C(C(C)(C(C=O)C(C=O)(C)O)O)=O,,,4,1,2,7,9
1011_1,,,,2,2,1,3
1013_0,,,,2,2,1,3
C(C(C(C=O)C(C=O)(C)O)O)(C)=O,,,4,1,4,14,18
1013_1,,,,2,2,1,3
1014_0,,,,2,2,1,3
1014_1,,,,2,2,1,3
1016_0,,,,2,2,1,3
C(C(C(C)O)C(C=O)(C)O)=O,,,4,1,4,15,19
1016_1,,,,2,2,1,3
1018_0,,,,2,2,1,3
C(C(CO)C(C=O)(C)O)=O,,,4,1,8,18,26
1018_1,,,,2,2,1,3
1020_0,,,,2,2,1,3
C(C(C(CO)O)C(C=O)(C)O)=O,,,4,1,6,17,23
1020_1,,,,2,2,1,3
1022_0,,,,2,2,1,3
C(C(C)(C(C(CC=O)O)O)O)=O,,,4,1,2,18,20
1024_0,,,,2,2,1,3
C(C(C)(C(C(C(C=O)O)O)O)O)=O,,,4,1,6,19,25
1024_1,,,,2,2,1,3
1026_0,,,,2,2,1,3
C(CC(C(C)(C(C=O)O)O)O)=O,,,4,1,3,20,23
1028_0,,,,2,2,1,3
C(C(C(C(C)(C(C=O)O)O)O)O)=O,,,4,1,6,21,27
1028_1,,,,2,2,1,3
1030_0,,,,2,2,1,3
C(C)(C(CC(C=O)(CC=O)O)O)=O,,,4,1,1,15,16
1032_0,,,,2,2,1,3
C(CC(C(CC(C(C)=O)O)=O)O)=O,,,4,1,2,17,19
1033_0,,,,2,2,1,3
1035_0,,,,2,2,1,3
C(C(C(C(C=O)=O)C(C)O)O)(C)=O,,,4,1,4,14,18
1035_1,,,,2,2,1,3
1036_0,,,,2,2,1,3
1036_1,,,,2,2,1,3
1038_0,,,,2,2,1,3
C(C(CC(C=O)=O)O)(CC(C)O)=O,,,4,1,2,13,15
1039_0,,,,2,2,1,3
1041_0,,,,2,2,1,3
C(CC(C(C=O)C(C(C)=O)O)O)=O,,,4,1,5,18,23
1042_0,,,,2,2,1,3
1044_0,,,,2,2,1,3
C(C(C=O)C(C(CC(C)O)=O)O)=O,,,4,1,3,11,14
1045_0,,,,2,2,1,3
1047_0,,,,2,2,1,3
C(C(CO)C(CC(C(C)=O)O)O)=O,,,4,1,5,16,21
1047_1,,,,2,2,1,3
1049_0,,,,2,2,1,3
C(C)(C(C(CC(C(C)=O)O)O)O)=O,,,4,1,2,16,18
1049_1,,,,2,2,1,3
1051_0,,,,2,2,1,3
C(C)(C(CC(CC(CO)=O)O)O)=O,,,4,1,2,14,16
1053_0,,,,2,2,1,3
C(C)(C(CC(CC(C=O)=O)O)O)=O,,,4,1,1,16,17
1055_0,,,,2,2,1,3
C(C(C=O)C(CC(C(C)=O)O)O)=O,,,4,1,2,12,14
1055_1,,,,2,2,1,3
1057_0,,,,2,2,1,3
C(CC(CC(C(C)=O)O)O)=O,,,4,1,5,19,24
1059_0,,,,2,2,1,3
C(C(C(CC(C(C)=O)O)O)O)=O,,,4,1,4,18,22
1059_1,,,,2,2,1,3
1061_0,,,,2,2,1,3
C(C(CO)C(C)(C(CC=O)O)O)=O,,,4,1,6,18,24
1061_1,,,,2,2,1,3
1063_0,,,,2,2,1,3
C(CC(C(C)(C(C(C)=O)O)O)O)=O,,,4,1,3,17,20
1063_1,,,,2,2,1,3
1065_0,,,,2,2,1,3
C(CC(C(C)(CC(CO)=O)O)O)=O,,,4,1,3,16,19
1066_0,,,,2,2,1,3
1067_0,,,,2,2,1,3
1067_1,,,,2,2,1,3
1068_0,,,,2,2,1,3
1069_0,,,,2,2,1,3
1069_1,,,,2,2,1,3
1071_0,,,,2,2,1,3
C(C(C(CCO)O)C(C(C)=O)O)=O,,,4,1,5,14,19
1071_1,,,,2,2,1,3
1073_0,,,,2,2,1,3
C(C(C(CO)(C)O)C(C(C)=O)O)=O,,,4,1,5,14,19
1073_1,,,,2,2,1,3
1075_0,,,,2,2,1,3
C(C(C(C=O)C(C(C)=O)O)O)(O)=O,,,4,1,5,14,19
1075_1,,,,2,2,1,3
1076_0,,,,2,2,1,3
1076_1,,,,2,2,1,3
1077_0,,,,2,2,1,3
1077_1,,,,2,2,1,3
1079_0,,,,2,2,1,3
C(C(C(C(C)=O)O)C(C(C)=O)O)=O,,,4,1,2,8,10
1079_1,,,,2,2,1,3
1080_0,,,,2,2,1,3
1080_1,,,,2,2,1,3
1082_0,,,,2,2,1,3
C(C(C(C)O)C(C(C)=O)O)=O,,,4,1,8,17,25
1082_1,,,,2,2,1,3
1084_0,,,,2,2,1,3
C(C(CO)C(C(C)=O)O)=O,,,4,1,13,24,37
1084_1,,,,2,2,1,3
1086_0,,,,2,2,1,3
C(C(C(CO)O)C(C(C)=O)O)=O,,,4,1,8,17,25
1086_1,,,,2,2,1,3
1088_0,,,,2,2,1,3
C(CC(C(CC(CCO)O)=O)O)=O,,,4,1,3,12,15
1090_0,,,,2,2,1,3
C(CC(C(CC(CO)(C)O)=O)O)=O,,,4,1,3,12,15
1092_0,,,,2,2,1,3
C(C(CC(C(CC=O)O)=O)O)(O)=O,,,4,1,3,13,16
1093_0,,,,2,2,1,3
1094_0,,,,2,2,1,3
1095_0,,,,2,2,1,3
1097_0,,,,2,2,1,3
C(CC(C(CC(CC=O)O)=O)O)=O,,,4,1,3,18,21
1099_0,,,,2,2,1,3
C(CC(C(CC(C)O)=O)O)=O,,,4,1,6,18,24
1100_0,,,,2,2,1,3
1102_0,,,,2,2,1,3
C(CC(C(CC(CO)O)=O)O)=O,,,4,1,4,15,19
1104_0,,,,2,2,1,3
C(CC(C(C(C(C)=O)O)O)O)=O,,,4,1,6,21,27
1105_0,,,,2,2,1,3
1105_1,,,,2,2,1,3
1106_0,,,,2,2,1,3
1107_0,,,,2,2,1,3
1107_1,,,,2,2,1,3
1108_0,,,,2,2,1,3
1110_0,,,,2,2,1,3
C(C(C(C=O)O)O)(CC(C)O)=O,,,4,1,5,17,22
1111_0,,,,2,2,1,3
1113_0,,,,2,2,1,3
C(C(C(C=O)O)O)(CC(CO)O)=O,,,4,1,8,17,25
1115_0,,,,2,2,1,3
C(CC(CC(CC(C=O)=O)O)O)=O,,,4,1,2,18,20
1117_0,,,,2,2,1,3
C(CC(CC(C=O)(CC=O)O)O)=O,,,4,1,2,18,20
1118_0,,,,2,2,1,3
1120_0,,,,2,2,1,3
C(C(C(CC(C=O)=O)O)C(C)O)=O,,,4,1,5,15,20
1120_1,,,,2,2,1,3
1122_0,,,,2,2,1,3
C(C(CO)C(CC(C=O)=O)O)=O,,,4,1,8,20,28
1122_1,,,,2,2,1,3
1124_0,,,,2,2,1,3
C(CC(C(C(C=O)=O)C(C)O)O)=O,,,4,1,4,16,20
1124_1,,,,2,2,1,3
1125_0,,,,2,2,1,3
1125_1,,,,2,2,1,3
1127_0,,,,2,2,1,3
C(C(CO)C(C=O)(CC(C)O)O)=O,,,4,1,5,14,19
1127_1,,,,2,2,1,3
1129_0,,,,2,2,1,3
C(C(CC(C)O)(C(C(C)=O)O)O)=O,,,4,1,2,13,15
1129_1,,,,2,2,1,3
1131_0,,,,2,2,1,3
C(C(CC(C)O)(CC(CO)=O)O)=O,,,4,1,2,12,14
1133_0,,,,2,2,1,3
C(C(CC(C)O)(CC(C=O)=O)O)=O,,,4,1,1,11,12
1135_0,,,,2,2,1,3
C(C(C=O)C(C=O)(CC(C)O)O)=O,,,4,1,2,10,12
1135_1,,,,2,2,1,3
1137_0,,,,2,2,1,3
C(C(CC(C)O)(CC=O)O)=O,,,4,1,3,14,17
1139_0,,,,2,2,1,3
C(C(CC(C)O)(C(C=O)O)O)=O,,,4,1,2,15,17
1139_1,,,,2,2,1,3
1141_0,,,,2,2,1,3
C(C(CO)C(C(CC(C)O)=O)O)=O,,,4,1,6,15,21
1141_1,,,,2,2,1,3
1143_0,,,,2,2,1,3
C(C(C(C(CC(C)O)=O)O)O)(C)=O,,,4,1,5,15,20
1143_1,,,,2,2,1,3
1145_0,,,,2,2,1,3
C(CC(C(CC(C)O)=O)O)(CO)=O,,,4,1,3,13,16
1146_0,,,,2,2,1,3
1147_0,,,,2,2,1,3
1147_1,,,,2,2,1,3
1148_0,,,,2,2,1,3
1149_0,,,,2,2,1,3
1149_1,,,,2,2,1,3
1151_0,,,,2,2,1,3
C(C(C(C(C)O)C(CCO)O)=O)=O,,,4,1,5,14,19
1151_1,,,,2,2,1,3
1153_0,,,,2,2,1,3
C(C(C(C(C)O)C(C)(CO)O)=O)=O,,,4,1,5,14,19
1153_1,,,,2,2,1,3
1155_0,,,,2,2,1,3
C(C(C(C(C=O)=O)C(C)O)O)(O)=O,,,4,1,5,14,19
1155_1,,,,2,2,1,3
1156_0,,,,2,2,1,3
1156_1,,,,2,2,1,3
1157_0,,,,2,2,1,3
1157_1,,,,2,2,1,3
1158_0,,,,2,2,1,3
1158_1,,,,2,2,1,3
1159_0,,,,2,2,1,3
1159_1,,,,2,2,1,3
1161_0,,,,2,2,1,3
C(C(C(C(C)O)C(C)O)=O)=O,,,4,1,4,11,15
1161_1,,,,2,2,1,3
1162_0,,,,2,2,1,3
1162_1,,,,2,2,1,3
1164_0,,,,2,2,1,3
C(C(C(C(CO)O)C(C)O)=O)=O,,,4,1,5,18,23
1164_1,,,,2,2,1,3
1165_0,,,,2,2,1,3
1165_1,,,,2,2,1,3
1167_0,,,,2,2,1,3
C(C(CC(CO)O)(CC=O)O)=O,,,4,1,2,15,17
1169_0,,,,2,2,1,3
C(C(CC(CO)O)(C(C=O)O)O)=O,,,4,1,4,16,20
1169_1,,,,2,2,1,3
1170_0,,,,2,2,1,3
1171_0,,,,2,2,1,3
1171_1,,,,2,2,1,3
1172_0,,,,2,2,1,3
1172_1,,,,2,2,1,3
1173_0,,,,2,2,1,3
1173_1,,,,2,2,1,3
1174_0,,,,2,2,1,3
1174_1,,,,2,2,1,3
1176_0,,,,2,2,1,3
C(C(C(C(CO)O)C(CO)O)=O)=O,,,4,1,3,9,12
1176_1,,,,2,2,1,3
1178_0,,,,2,2,1,3
C(C(C(CC=O)O)C(CC=O)O)=O,,,4,1,3,10,13
1180_0,,,,2,2,1,3
C(C(C=O)C(CC(CC=O)O)O)=O,,,4,1,3,14,17
1182_0,,,,2,2,1,3
C(C(C=O)C(C(C=O)C(C)O)O)=O,,,4,1,6,13,19
1182_1,,,,2,2,1,3
1184_0,,,,2,2,1,3
C(C(C=O)C(C(C=O)CO)O)=O,,,4,1,8,16,24
1184_1,,,,2,2,1,3
1186_0,,,,2,2,1,3
C(C(CO)C(CC(CC=O)O)O)=O,,,4,1,6,17,23
1186_1,,,,2,2,1,3
1188_0,,,,2,2,1,3
C(CC(CC(C(C(C)=O)O)O)O)=O,,,4,1,3,18,21
1188_1,,,,2,2,1,3
1190_0,,,,2,2,1,3
C(CC(CC(CC(CO)=O)O)O)=O,,,4,1,4,16,20
1191_0,,,,2,2,1,3
1192_0,,,,2,2,1,3
1192_1,,,,2,2,1,3
1194_0,,,,2,2,1,3
C(CC(CC(CC=O)O)O)=O,,,4,1,4,11,15
1196_0,,,,2,2,1,3
C(CC(CC(C(C=O)O)O)O)=O,,,4,1,5,21,26
1196_1,,,,2,2,1,3
1198_0,,,,2,2,1,3
C(C(C(CC=O)O)C(CCO)O)=O,,,4,1,6,14,20
1198_1,,,,2,2,1,3
1200_0,,,,2,2,1,3
C(C(C(CC=O)O)C(C)(CO)O)=O,,,4,1,6,15,21
1200_1,,,,2,2,1,3
1202_0,,,,2,2,1,3
C(CC(C(C=O)C(C(O)=O)O)O)=O,,,4,1,6,16,22
1202_1,,,,2,2,1,3
1203_0,,,,2,2,1,3
1203_1,,,,2,2,1,3
1204_0,,,,2,2,1,3
1204_1,,,,2,2,1,3
1205_0,,,,2,2,1,3
1205_1,,,,2,2,1,3
1206_0,,,,2,2,1,3
1206_1,,,,2,2,1,3
1208_0,,,,2,2,1,3
C(C(C(CC=O)O)C(C)O)=O,,,4,1,9,19,28
1208_1,,,,2,2,1,3
1210_0,,,,2,2,1,3
C(C(CO)C(CC=O)O)=O,,,4,1,17,26,43
1210_1,,,,2,2,1,3
1212_0,,,,2,2,1,3
C(C(C(CC=O)O)C(CO)O)=O,,,4,1,9,19,28
1212_1,,,,2,2,1,3
1214_0,,,,2,2,1,3
C(CC(C(C(CC=O)O)O)O)=O,,,4,1,2,11,13
1216_0,,,,2,2,1,3
C(CC(C(C(C(C=O)O)O)O)O)=O,,,4,1,8,22,30
1216_1,,,,2,2,1,3
1217_0,,,,2,2,1,3
1219_0,,,,2,2,1,3
C(C(C(CC(C(C=O)O)O)O)O)=O,,,4,1,3,11,14
1219_1,,,,2,2,1,3
1220_0,,,,2,2,1,3
1220_1,,,,2,2,1,3
1222_0,,,,2,2,1,3
C(C(C(C(C=O)O)O)C(C)O)=O,,,4,1,8,19,27
1222_1,,,,2,2,1,3
1224_0,,,,2,2,1,3
C(C(CO)C(C(C=O)O)O)=O,,,4,1,13,21,34
1224_1,,,,2,2,1,3
1226_0,,,,2,2,1,3
C(C(C(C(C=O)O)O)C(CO)O)=O,,,4,1,11,19,30
1226_1,,,,2,2,1,3
1228_0,,,,2,2,1,3
C(C(CO)C(C(C=O)C(C)O)O)=O,,,4,1,9,17,26
1228_1,,,,2,2,1,3
1230_0,,,,2,2,1,3
C(C(C(C(C(C)=O)O)O)C(C)O)=O,,,4,1,7,16,23
1230_1,,,,2,2,1,3
1232_0,,,,2,2,1,3
C(C(C(CC(CO)=O)O)C(C)O)=O,,,4,1,7,15,22
1233_0,,,,2,2,1,3
1234_0,,,,2,2,1,3
1234_1,,,,2,2,1,3
1235_0,,,,2,2,1,3
1236_0,,,,2,2,1,3
1236_1,,,,2,2,1,3
1237_0,,,,2,2,1,3
1237_1,,,,2,2,1,3
1239_0,,,,2,2,1,3
C(C(CO)C(C(C=O)CO)O)=O,,,4,1,6,10,16
1239_1,,,,2,2,1,3
1241_0,,,,2,2,1,3
C(C(CO)C(C(C(C=O)=O)O)O)=O,,,4,1,6,19,25
1241_1,,,,2,2,1,3
1243_0,,,,2,2,1,3
C(C(CO)C(C(C(C)=O)O)O)=O,,,4,1,10,18,28
1243_1,,,,2,2,1,3
1245_0,,,,2,2,1,3
C(C(CO)C(CC(CO)=O)O)=O,,,4,1,10,17,27
1247_0,,,,2,2,1,3
C(C(CO)C(CC(C(O)=O)=O)O)=O,,,4,1,6,14,20
1249_0,,,,2,2,1,3
C(C(C=O)C(C(C=O)CO)O)(O)=O,,,4,1,7,16,23
1249_1,,,,2,2,1,3
1250_0,,,,2,2,1,3
1250_1,,,,2,2,1,3
1251_0,,,,2,2,1,3
1252_0,,,,2,2,1,3
1252_1,,,,2,2,1,3
1253_0,,,,2,2,1,3
1254_0,,,,2,2,1,3
1254_1,,,,2,2,1,3
1255_0,,,,2,2,1,3
1256_0,,,,2,2,1,3
1256_1,,,,2,2,1,3
1258_0,,,,2,2,1,3
C(C(CCO)(CC(CC=O)O)O)=O,,,4,1,2,13,15
1260_0,,,,2,2,1,3
C(CC(C(CCO)(CC=O)O)O)=O,,,4,1,2,17,19
1262_0,,,,2,2,1,3
C(C(C(C)O)C(C=O)(CCO)O)=O,,,4,1,6,14,20
1262_1,,,,2,2,1,3
1264_0,,,,2,2,1,3
C(C(CO)C(C=O)(CCO)O)=O,,,4,1,9,16,25
1264_1,,,,2,2,1,3
1266_0,,,,2,2,1,3
C(CC(CC(C(CCO)=O)O)O)=O,,,4,1,2,15,17
1267_0,,,,2,2,1,3
1269_0,,,,2,2,1,3
C(C(C(C)O)C(C(CCO)=O)O)=O,,,4,1,6,15,21
1269_1,,,,2,2,1,3
1271_0,,,,2,2,1,3
C(C(CO)C(C(CCO)=O)O)=O,,,4,1,10,17,27
1271_1,,,,2,2,1,3
1273_0,,,,2,2,1,3
C(CC(C(C(CO)C(C)O)=O)O)=O,,,4,1,5,14,19
1273_1,,,,2,2,1,3
1275_0,,,,2,2,1,3
C(CC(C(C(CO)CO)=O)O)=O,,,4,1,5,12,17
1275_1,,,,2,2,1,3
1277_0,,,,2,2,1,3
C(C(C(C=O)O)O)(C(CO)CO)=O,,,4,1,9,14,23
1277_1,,,,2,2,1,3
1279_0,,,,2,2,1,3
C(C(C(CO)C(C)O)(CC=O)O)=O,,,4,1,1,12,13
1280_0,,,,2,2,1,3
1282_0,,,,2,2,1,3
C(C(C(CO)CO)(CC=O)O)=O,,,4,1,2,11,13
1284_0,,,,2,2,1,3
C(C(C(CO)CO)(C(C=O)O)O)=O,,,4,1,5,12,17
1284_1,,,,2,2,1,3
1285_0,,,,2,2,1,3
1286_0,,,,2,2,1,3
1286_1,,,,2,2,1,3
1288_0,,,,2,2,1,3
C(CC(C(CC(CC=O)O)O)O)=O,,,4,1,2,18,20
1290_0,,,,2,2,1,3
C(C(C(C(CC=O)O)O)C(C)O)=O,,,4,1,6,19,25
1290_1,,,,2,2,1,3
1292_0,,,,2,2,1,3
C(C(CO)C(C(CC=O)O)O)=O,,,4,1,9,22,31
1292_1,,,,2,2,1,3
1293_0,,,,2,2,1,3
1293_1,,,,2,2,1,3
1295_0,,,,2,2,1,3
C(CC(CC(CC(C=O)O)O)O)=O,,,4,1,2,15,17
1296_0,,,,2,2,1,3
1298_0,,,,2,2,1,3
C(C(C(C)O)C(CC(C=O)O)O)=O,,,4,1,6,17,23
1298_1,,,,2,2,1,3
1300_0,,,,2,2,1,3
C(C(CO)C(CC(C=O)O)O)=O,,,4,1,8,19,27
1300_1,,,,2,2,1,3
1301_0,,,,2,2,1,3
1303_0,,,,2,2,1,3
C(CC(C(C(C)O)C(C=O)O)O)=O,,,4,1,2,16,18
1304_0,,,,2,2,1,3
1305_0,,,,2,2,1,3
1305_1,,,,2,2,1,3
1307_0,,,,2,2,1,3
C(CC(C(CO)C(C=O)O)O)=O,,,4,1,4,18,22
1309_0,,,,2,2,1,3
C(C(C(C(CO)C(C=O)O)O)O)=O,,,4,1,4,19,23
1309_1,,,,2,2,1,3
1310_0,,,,2,2,1,3
1312_0,,,,2,2,1,3
C(CC(CC(CO)(CC=O)O)O)=O,,,4,1,4,17,21
1313_0,,,,2,2,1,3
1313_1,,,,2,2,1,3
1314_0,,,,2,2,1,3
1314_1,,,,2,2,1,3
1316_0,,,,2,2,1,3
C(CC(C(C(CO)=O)C(C)O)O)=O,,,4,1,7,15,22
1316_1,,,,2,2,1,3
1318_0,,,,2,2,1,3
C(CC(C(C(CO)=O)CO)O)=O,,,4,1,10,17,27
1318_1,,,,2,2,1,3
1320_0,,,,2,2,1,3
C(CC(CC(C(C(C)O)O)=O)O)=O,,,4,1,4,14,18
1320_1,,,,2,2,1,3
1322_0,,,,2,2,1,3
C(CC(CC(C(CO)O)=O)O)=O,,,4,1,7,16,23
1322_1,,,,2,2,1,3
1324_0,,,,2,2,1,3
C(C(C(C(C(CO)=O)CO)O)O)=O,,,4,1,10,18,28
1324_1,,,,2,2,1,3
1326_0,,,,2,2,1,3
C(C(CO)O)(CC(C(C=O)O)O)=O,,,4,1,8,17,25
1326_1,,,,2,2,1,3
1327_0,,,,2,2,1,3
1329_0,,,,2,2,1,3
C(C(C(C)O)C(CO)(CC=O)O)=O,,,4,1,7,15,22
1329_1,,,,2,2,1,3
1331_0,,,,2,2,1,3
C(C(CO)C(CO)(CC=O)O)=O,,,4,1,11,18,29
1331_1,,,,2,2,1,3
1333_0,,,,2,2,1,3
C(C(CO)C(CO)(C(C=O)O)O)=O,,,4,1,9,17,26
1333_1,,,,2,2,1,3
1334_0,,,,2,2,1,3
1335_0,,,,2,2,1,3
1337_0,,,,2,2,1,3
C(C(C(C(C(C)O)O)=O)C(C)O)=O,,,4,1,5,13,18
1337_1,,,,2,2,1,3
1339_0,,,,2,2,1,3
C(C(C(C(CO)O)=O)C(C)O)=O,,,4,1,7,15,22
1339_1,,,,2,2,1,3
1340_0,,,,2,2,1,3
1341_0,,,,2,2,1,3
1341_1,,,,2,2,1,3
1342_0,,,,2,2,1,3
1343_0,,,,2,2,1,3
1343_1,,,,2,2,1,3
1344_0,,,,2,2,1,3
1344_1,,,,2,2,1,3
1346_0,,,,2,2,1,3
C(C(C(C(C(C)O)O)=O)CO)=O,,,4,1,7,15,22
1346_1,,,,2,2,1,3
1347_0,,,,2,2,1,3
1347_1,,,,2,2,1,3
1349_0,,,,2,2,1,3
C(C(C(C(C(CO)O)O)=O)CO)=O,,,4,1,10,15,25
1349_1,,,,2,2,1,3
1351_0,,,,2,2,1,3
C(C(C(C(CO)O)=O)C(CO)O)=O,,,4,1,10,15,25
1351_1,,,,2,2,1,3
1352_0,,,,2,2,1,3
1354_0,,,,2,2,1,3
C(CC(C(C(C)O)O)(CC=O)O)=O,,,4,1,1,9,10
1355_0,,,,2,2,1,3
1355_1,,,,2,2,1,3
1356_0,,,,2,2,1,3
1356_1,,,,2,2,1,3
1357_0,,,,2,2,1,3
1358_0,,,,2,2,1,3
1358_1,,,,2,2,1,3
1360_0,,,,2,2,1,3
C(CC(C(CO)O)(CC=O)O)=O,,,4,1,2,10,12
1362_0,,,,2,2,1,3
C(CC(C(CO)O)(C(C=O)O)O)=O,,,4,1,4,16,20
1362_1,,,,2,2,1,3
1363_0,,,,2,2,1,3
1363_1,,,,2,2,1,3
1364_0,,,,2,2,1,3
1364_1,,,,2,2,1,3
1365_0,,,,2,2,1,3
1365_1,,,,2,2,1,3
1366_0,,,,2,2,1,3
1366_1,,,,2,2,1,3
1367_0,,,,2,2,1,3
1367_1,,,,2,2,1,3
1368_0,,,,2,2,1,3
1370_0,,,,2,2,1,3
C(CC(C)(C(C(CC=O)O)O)O)=O,,,4,1,2,18,20
1371_0,,,,2,2,1,3
1371_1,,,,2,2,1,3
1372_0,,,,2,2,1,3
1372_1,,,,2,2,1,3
1374_0,,,,2,2,1,3
C(CC(C(C(CC(C)O)=O)O)O)=O,,,4,1,4,14,18
1376_0,,,,2,2,1,3
C(CC(C(C(CCO)=O)O)O)=O,,,4,1,7,16,23
1378_0,,,,2,2,1,3
C(C(C(C(C=O)O)O)O)(CCO)=O,,,4,1,9,17,26
1380_0,,,,2,2,1,3
C(CC(CC(C)(C(C=O)O)O)O)=O,,,4,1,1,18,19
1381_0,,,,2,2,1,3
1383_0,,,,2,2,1,3
C(C(C(C)O)C(C)(C(C=O)O)O)=O,,,4,1,5,16,21
1383_1,,,,2,2,1,3
1385_0,,,,2,2,1,3
C(C(CO)C(C)(C(C=O)O)O)=O,,,4,1,9,18,27
1385_1,,,,2,2,1,3
1386_0,,,,2,2,1,3
1388_0,,,,2,2,1,3
C(CC(CC(C)O)(C(C=O)O)O)=O,,,4,1,1,14,15
1390_0,,,,2,2,1,3
C(C(C(C(C(C)O)C(C)O)=O)O)=O,,,4,1,2,8,10
1390_1,,,,2,2,1,3
1392_0,,,,2,2,1,3
C(C(C(C(CO)C(C)O)=O)O)=O,,,4,1,5,14,19
1392_1,,,,2,2,1,3
1393_0,,,,2,2,1,3
1394_0,,,,2,2,1,3
1394_1,,,,2,2,1,3
1396_0,,,,2,2,1,3
C(CC(CCO)(C(C=O)O)O)=O,,,4,1,3,16,19
1398_0,,,,2,2,1,3
C(C(C(CCO)(C(C=O)O)O)O)=O,,,4,1,2,9,11
1398_1,,,,2,2,1,3
1399_0,,,,2,2,1,3
1399_1,,,,2,2,1,3
1400_0,,,,2,2,1,3
1400_1,,,,2,2,1,3
1402_0,,,,2,2,1,3
C(C(C(C(CO)CO)=O)O)=O,,,4,1,7,12,19
1402_1,,,,2,2,1,3
1404_0,,,,2,2,1,3
C(C(C(C(CO)C(CO)O)=O)O)=O,,,4,1,5,15,20
1404_1,,,,2,2,1,3
1405_0,,,,2,2,1,3
1405_1,,,,2,2,1,3
1407_0,,,,2,2,1,3
C(C(C(C)O)C(CC(C)O)O)=O,,,4,1,4,14,18
1407_1,,,,2,2,1,3
1409_0,,,,2,2,1,3
C(C(CO)C(CC(C)O)O)=O,,,4,1,5,14,19
1409_1,,,,2,2,1,3
1411_0,,,,2,2,1,3
C(C(C(CO)O)C(CC(C)O)O)=O,,,4,1,5,14,19
1411_1,,,,2,2,1,3
1413_0,,,,2,2,1,3
C(C(C(C(CC(C)O)O)O)=O)=O,,,4,1,2,16,18
1413_1,,,,2,2,1,3
1415_0,,,,2,2,1,3
C(C(C)=O)(C(C(CC(C)O)O)O)=O,,,4,1,2,12,14
1415_1,,,,2,2,1,3
1417_0,,,,2,2,1,3
C(C(CO)=O)(CC(CC(C)O)O)=O,,,4,1,2,10,12
1419_0,,,,2,2,1,3
C(C)(C(C(CC(C)O)O)O)=O,,,4,1,6,13,19
1419_1,,,,2,2,1,3
1421_0,,,,2,2,1,3
C(CO)(CC(CC(C)O)O)=O,,,4,1,6,12,18
1423_0,,,,2,2,1,3
C(C(C(CC(C)O)O)O)(CCO)=O,,,4,1,4,11,15
1423_1,,,,2,2,1,3
1425_0,,,,2,2,1,3
C(CO)(C(CO)C(CC(C)O)O)=O,,,4,1,6,11,17
1425_1,,,,2,2,1,3
1427_0,,,,2,2,1,3
C(C(CO)O)(CC(CC(C)O)O)=O,,,4,1,4,11,15
1429_0,,,,2,2,1,3
C(C(CC(CC(C)O)O)=O)(O)=O,,,4,1,2,10,12
1431_0,,,,2,2,1,3
C(C(C=O)C(CC(C)O)O)(O)=O,,,4,1,6,13,19
1431_1,,,,2,2,1,3
1433_0,,,,2,2,1,3
C1(C(C(CC(C)O)O)OCC1O)=O,,,4,1,2,7,9
1433_1,,,,2,2,1,3
1435_0,,,,2,2,1,3
C1(C(O)OCC1C(CC(C)O)O)=O,,,4,1,3,9,12
1435_1,,,,2,2,1,3
1437_0,,,,2,2,1,3
C1(COC(C1C(CC(C)O)O)O)=O,,,4,1,3,11,14
1437_1,,,,2,2,1,3
1439_0,,,,2,2,1,3
C1(C(C(CC(C)O)O)OC(C1)O)=O,,,4,1,3,9,12
1439_1,,,,2,2,1,3
1441_0,,,,2,2,1,3
C(CO)(C(C(CC(C)O)O)O)=O,,,4,1,3,10,13
1441_1,,,,2,2,1,3
1443_0,,,,2,2,1,3
C(C(CC(CC(C)O)O)=O)=O,,,4,1,4,15,19
1445_0,,,,2,2,1,3
C(C(C=O)C(CC(C)O)O)=O,,,4,1,5,11,16
1445_1,,,,2,2,1,3
1447_0,,,,2,2,1,3
C(C(C(CO)C(CC(C)O)O)=O)=O,,,4,1,5,14,19
1447_1,,,,2,2,1,3
1449_0,,,,2,2,1,3
C(C(C(CC(C)O)O)C(C=O)O)=O,,,4,1,5,15,20
1449_1,,,,2,2,1,3
1451_0,,,,2,2,1,3
C(C(C(CO)=O)C(CC(C)O)O)=O,,,4,1,4,11,15
1451_1,,,,2,2,1,3
1453_0,,,,2,2,1,3
C(CC(C(C(CC(C)O)O)O)=O)=O,,,4,1,3,12,15
1453_1,,,,2,2,1,3
1455_0,,,,2,2,1,3
C(C(C(CC(CC(C)O)O)=O)O)=O,,,4,1,2,10,12
1457_0,,,,2,2,1,3
C(CC(CC(C)O)O)=O,,,4,1,12,29,41
1459_0,,,,2,2,1,3
C(C(C(CC(C)O)O)O)=O,,,4,1,9,18,27
1459_1,,,,2,2,1,3
1461_0,,,,2,2,1,3
C(C(C(C)O)C(C(C(C)O)O)O)=O,,,4,1,4,15,19
1461_1,,,,2,2,1,3
1463_0,,,,2,2,1,3
C(C(C(C)O)C(CCO)O)=O,,,4,1,5,14,19
1463_1,,,,2,2,1,3
1465_0,,,,2,2,1,3
C(C(C(C)O)C(CC(CO)O)O)=O,,,4,1,5,14,19
1465_1,,,,2,2,1,3
1467_0,,,,2,2,1,3
C(C(C(C)O)C(C=O)(CO)O)=O,,,4,1,5,17,22
1467_1,,,,2,2,1,3
1469_0,,,,2,2,1,3
C(C(C(C)O)C(C(CO)=O)O)=O,,,4,1,6,16,22
1469_1,,,,2,2,1,3
1471_0,,,,2,2,1,3
C(C(C(C)O)C(C(C)=O)(CO)O)=O,,,4,1,5,14,19
1471_1,,,,2,2,1,3
1473_0,,,,2,2,1,3
C(C(C(C)O)C(C(CO)=O)(C)O)=O,,,4,1,5,14,19
1473_1,,,,2,2,1,3
1475_0,,,,2,2,1,3
C(C(C(C)O)C(C=O)(C(C)O)O)=O,,,4,1,6,15,21
1475_1,,,,2,2,1,3
1477_0,,,,2,2,1,3
C(C(C(C)O)C(C(C(C)O)=O)O)=O,,,4,1,7,14,21
1477_1,,,,2,2,1,3
1479_0,,,,2,2,1,3
C(C(C(C)O)C(C)(CO)O)=O,,,4,1,5,14,19
1479_1,,,,2,2,1,3
1481_0,,,,2,2,1,3
C(C(C(C)O)C(CO)(CCO)O)=O,,,4,1,6,13,19
1481_1,,,,2,2,1,3
1483_0,,,,2,2,1,3
C(C(C(C(CCO)O)O)C(C)O)=O,,,4,1,5,14,19
1483_1,,,,2,2,1,3
1485_0,,,,2,2,1,3
C(C(C(C)O)C(C)(C(CO)O)O)=O,,,4,1,5,14,19
1485_1,,,,2,2,1,3
1487_0,,,,2,2,1,3
C(C(C(C)O)C(C(O)=O)O)=O,,,4,1,5,15,20
1487_1,,,,2,2,1,3
1489_0,,,,2,2,1,3
C(C(C(C)O)C(C(O)=O)(C)O)=O,,,4,1,5,14,19
1489_1,,,,2,2,1,3
1491_0,,,,2,2,1,3
C(C(C(CC(O)=O)O)C(C)O)=O,,,4,1,5,13,18
1491_1,,,,2,2,1,3
1493_0,,,,2,2,1,3
C(C(C(C)O)C1(COCC1O)O)=O,,,4,1,4,10,14
1493_1,,,,2,2,1,3
1495_0,,,,2,2,1,3
C(C(C(C)O)C1(C(O)OCC1)O)=O,,,4,1,5,12,17
1495_1,,,,2,2,1,3
1497_0,,,,2,2,1,3
C(C(C(C)O)C1(COC(C1)O)O)=O,,,4,1,5,12,17
1497_1,,,,2,2,1,3
1499_0,,,,2,2,1,3
C(C(C=C)(C(C=O)C(C)O)O)=O,,,4,1,6,15,21
1499_1,,,,2,2,1,3
1501_0,,,,2,2,1,3
C(C(C(C)O)C(C(C=C)=O)O)=O,,,4,1,6,17,23
1501_1,,,,2,2,1,3
1503_0,,,,2,2,1,3
C(C(C(C)O)C(C=CC=O)O)=O,,,4,1,6,16,22
1503_1,,,,2,2,1,3
1505_0,,,,2,2,1,3
C(C(C(C)O)C(C(CO)O)O)=O,,,4,1,8,16,24
1505_1,,,,2,2,1,3
1506_0,,,,2,2,1,3
1506_1,,,,2,2,1,3
1507_0,,,,2,2,1,3
1507_1,,,,2,2,1,3
1508_0,,,,2,2,1,3
1508_1,,,,2,2,1,3
1509_0,,,,2,2,1,3
1509_1,,,,2,2,1,3
1510_0,,,,2,2,1,3
1510_1,,,,2,2,1,3
1511_0,,,,2,2,1,3
1511_1,,,,2,2,1,3
1512_0,,,,2,2,1,3
1512_1,,,,2,2,1,3
1513_0,,,,2,2,1,3
1513_1,,,,2,2,1,3
1514_0,,,,2,2,1,3
1514_1,,,,2,2,1,3
1515_0,,,,2,2,1,3
1515_1,,,,2,2,1,3
1516_0,,,,2,2,1,3
1516_1,,,,2,2,1,3
1517_0,,,,2,2,1,3
1517_1,,,,2,2,1,3
1518_0,,,,2,2,1,3
1518_1,,,,2,2,1,3
1520_0,,,,2,2,1,3
C(C(C(C)O)C(C)O)=O,,,4,1,4,19,23
1520_1,,,,2,2,1,3
1522_0,,,,2,2,1,3
C(C(CO)C(C)O)=O,,,4,1,9,51,60
1522_1,,,,2,2,1,3
1524_0,,,,2,2,1,3
C(C(C(CO)O)C(C)O)=O,,,4,1,8,17,25
1524_1,,,,2,2,1,3
1526_0,,,,2,2,1,3
C(C(CO)C(C(C(C)O)O)O)=O,,,4,1,5,16,21
1526_1,,,,2,2,1,3
1528_0,,,,2,2,1,3
C(C(C(C(C(C(C)O)O)O)O)=O)=O,,,4,1,2,17,19
1528_1,,,,2,2,1,3
1530_0,,,,2,2,1,3
C(C)(C(C(C(C(C)O)O)O)O)=O,,,4,1,2,13,15
1530_1,,,,2,2,1,3
1532_0,,,,2,2,1,3
C(CO)(CC(C(C(C)O)O)O)=O,,,4,1,2,11,13
1534_0,,,,2,2,1,3
C(C(CC(C(C(C)O)O)O)=O)(O)=O,,,4,1,2,13,15
1536_0,,,,2,2,1,3
C(C(C=O)C(C(C(C)O)O)O)(O)=O,,,4,1,5,15,20
1536_1,,,,2,2,1,3
1538_0,,,,2,2,1,3
C(CO)(C(C(C(C(C)O)O)O)O)=O,,,4,1,3,13,16
1538_1,,,,2,2,1,3
1540_0,,,,2,2,1,3
C(C(CC(C(C(C)O)O)O)=O)=O,,,4,1,1,17,18
1542_0,,,,2,2,1,3
C(C(C=O)C(C(C(C)O)O)O)=O,,,4,1,3,13,16
1542_1,,,,2,2,1,3
1544_0,,,,2,2,1,3
C(CC(C(C(C)O)O)O)=O,,,4,1,8,19,27
1546_0,,,,2,2,1,3
C(C(C(C(C(C)O)O)O)O)=O,,,4,1,8,16,24
1546_1,,,,2,2,1,3
1548_0,,,,2,2,1,3
C(CC(CC(C(CO)O)O)O)=O,,,4,1,4,13,17
1550_0,,,,2,2,1,3
C(C(C(CC(C(CO)O)O)O)O)=O,,,4,1,7,14,21
1550_1,,,,2,2,1,3
1551_0,,,,2,2,1,3
1551_1,,,,2,2,1,3
1552_0,,,,2,2,1,3
1552_1,,,,2,2,1,3
1554_0,,,,2,2,1,3
C(C(CO)C(C(CO)O)O)=O,,,4,1,9,16,25
1554_1,,,,2,2,1,3
1556_0,,,,2,2,1,3
C(C(C(CO)O)C(C(CO)O)O)=O,,,4,1,10,16,26
1556_1,,,,2,2,1,3
1558_0,,,,2,2,1,3
C(C(CO)C(C(C(CO)O)O)O)=O,,,4,1,10,16,26
1558_1,,,,2,2,1,3
1560_0,,,,2,2,1,3
C(C(CO)C(CCO)O)=O,,,4,1,8,16,24
1560_1,,,,2,2,1,3
1562_0,,,,2,2,1,3
C(C(C(CO)O)C(CCO)O)=O,,,4,1,7,15,22
1562_1,,,,2,2,1,3
1564_0,,,,2,2,1,3
C(C(C(C(CCO)O)O)=O)=O,,,4,1,9,17,26
1564_1,,,,2,2,1,3
1566_0,,,,2,2,1,3
C(C(C)=O)(C(C(CCO)O)O)=O,,,4,1,5,13,18
1566_1,,,,2,2,1,3
1568_0,,,,2,2,1,3
C(C(CO)=O)(CC(CCO)O)=O,,,4,1,4,11,15
1570_0,,,,2,2,1,3
C(C)(C(C(CCO)O)O)=O,,,4,1,11,19,30
1570_1,,,,2,2,1,3
1572_0,,,,2,2,1,3
C(CO)(CC(CCO)O)=O,,,4,1,13,20,33
1574_0,,,,2,2,1,3
C(C(C(CCO)O)O)(CCO)=O,,,4,1,6,11,17
1574_1,,,,2,2,1,3
1576_0,,,,2,2,1,3
C(CO)(C(CO)C(CCO)O)=O,,,4,1,8,11,19
1576_1,,,,2,2,1,3
1578_0,,,,2,2,1,3
C(C(CO)O)(CC(CCO)O)=O,,,4,1,6,11,17
1580_0,,,,2,2,1,3
C(C(CC(CCO)O)=O)(O)=O,,,4,1,6,11,17
1582_0,,,,2,2,1,3
C(C(C=O)C(CCO)O)(O)=O,,,4,1,7,13,20
1582_1,,,,2,2,1,3
1584_0,,,,2,2,1,3
C(C(C(CO)C(CCO)O)=O)(O)=O,,,4,1,6,13,19
1584_1,,,,2,2,1,3
1586_0,,,,2,2,1,3
C(C(C(CCO)O)C(C(O)=O)O)=O,,,4,1,6,14,20
1586_1,,,,2,2,1,3
1588_0,,,,2,2,1,3
C(C(C(CO)=O)C(CCO)O)(O)=O,,,4,1,7,11,18
1588_1,,,,2,2,1,3
1590_0,,,,2,2,1,3
C(CC(C(C(CCO)O)O)=O)(O)=O,,,4,1,5,12,17
1590_1,,,,2,2,1,3
1592_0,,,,2,2,1,3
C(C(C(CC(CCO)O)=O)O)(O)=O,,,4,1,5,10,15
1594_0,,,,2,2,1,3
C1(C(C(CCO)O)OCC1O)=O,,,4,1,3,6,9
1594_1,,,,2,2,1,3
1596_0,,,,2,2,1,3
C1(C(O)OCC1C(CCO)O)=O,,,4,1,4,9,13
1596_1,,,,2,2,1,3
1598_0,,,,2,2,1,3
C1(COC(C1C(CCO)O)O)=O,,,4,1,4,11,15
1598_1,,,,2,2,1,3
1600_0,,,,2,2,1,3
C1(C(C(CCO)O)OC(C1)O)=O,,,4,1,4,9,13
1600_1,,,,2,2,1,3
1602_0,,,,2,2,1,3
C(CO)(C(C(CCO)O)O)=O,,,4,1,10,13,23
1602_1,,,,2,2,1,3
1604_0,,,,2,2,1,3
C(C(C(CCO)O)O)(C(CO)O)=O,,,4,1,8,13,21
1604_1,,,,2,2,1,3
1606_0,,,,2,2,1,3
C(C(CC(CCO)O)=O)=O,,,4,1,9,20,29
1608_0,,,,2,2,1,3
C(C(C=O)C(CCO)O)=O,,,4,1,9,13,22
1608_1,,,,2,2,1,3
1610_0,,,,2,2,1,3
C(C(C(CO)C(CCO)O)=O)=O,,,4,1,6,17,23
1610_1,,,,2,2,1,3
1612_0,,,,2,2,1,3
C(C(C(CCO)O)C(C=O)O)=O,,,4,1,6,17,23
1612_1,,,,2,2,1,3
1614_0,,,,2,2,1,3
C(C(C(CO)=O)C(CCO)O)=O,,,4,1,7,13,20
1614_1,,,,2,2,1,3
1616_0,,,,2,2,1,3
C(CC(C(C(CCO)O)O)=O)=O,,,4,1,5,14,19
1616_1,,,,2,2,1,3
1618_0,,,,2,2,1,3
C(C(C(CC(CCO)O)=O)O)=O,,,4,1,3,11,14
1620_0,,,,2,2,1,3
C(CC(CCO)O)=O,,,4,1,22,64,86
1622_0,,,,2,2,1,3
C(C(C(CCO)O)O)=O,,,4,1,18,29,47
1622_1,,,,2,2,1,3
1624_0,,,,2,2,1,3
C(C(CO)C(CC(CO)O)O)=O,,,4,1,6,15,21
1624_1,,,,2,2,1,3
1626_0,,,,2,2,1,3
C(C(CO)C(C=O)(CO)O)=O,,,4,1,9,17,26
1626_1,,,,2,2,1,3
1628_0,,,,2,2,1,3
C(C(CO)C(C(CO)=O)O)=O,,,4,1,12,19,31
1628_1,,,,2,2,1,3
1630_0,,,,2,2,1,3
C(C(CO)C(C=O)(C(CO)O)O)=O,,,4,1,11,17,28
1630_1,,,,2,2,1,3
1632_0,,,,2,2,1,3
C(C(CO)C(C(C(CO)O)=O)O)=O,,,4,1,11,18,29
1632_1,,,,2,2,1,3
1634_0,,,,2,2,1,3
C(C(CO)C(C(C)=O)(CO)O)=O,,,4,1,9,16,25
1634_1,,,,2,2,1,3
1636_0,,,,2,2,1,3
C(C(CO)C(C(CO)=O)(C)O)=O,,,4,1,6,15,21
1636_1,,,,2,2,1,3
1638_0,,,,2,2,1,3
C(C(CO)C(C=O)(C(C)O)O)=O,,,4,1,8,17,25
1638_1,,,,2,2,1,3
1640_0,,,,2,2,1,3
C(C(CO)C(C(C(C)O)=O)O)=O,,,4,1,8,15,23
1640_1,,,,2,2,1,3
1642_0,,,,2,2,1,3
C(C(CO)C(C)(CO)O)=O,,,4,1,7,16,23
1642_1,,,,2,2,1,3
1644_0,,,,2,2,1,3
C(C(CO)C(CO)(CCO)O)=O,,,4,1,7,14,21
1644_1,,,,2,2,1,3
1646_0,,,,2,2,1,3
C(C(CO)C(C(CCO)O)O)=O,,,4,1,6,15,21
1646_1,,,,2,2,1,3
1648_0,,,,2,2,1,3
C(C(CO)C(C)(C(CO)O)O)=O,,,4,1,6,15,21
1648_1,,,,2,2,1,3
1650_0,,,,2,2,1,3
C(C(CO)C(C(O)=O)O)=O,,,4,1,13,19,32
1650_1,,,,2,2,1,3
1652_0,,,,2,2,1,3
C(C(CO)C(C(O)=O)(C)O)=O,,,4,1,8,14,22
1652_1,,,,2,2,1,3
1654_0,,,,2,2,1,3
C(C(CO)C(CC(O)=O)O)=O,,,4,1,7,14,21
1654_1,,,,2,2,1,3
1656_0,,,,2,2,1,3
C(C(CO)C(C(O)=O)(CCO)O)=O,,,4,1,7,14,21
1656_1,,,,2,2,1,3
1658_0,,,,2,2,1,3
C(C(CO)C(CC(C(O)=O)O)O)=O,,,4,1,8,15,23
1658_1,,,,2,2,1,3
1660_0,,,,2,2,1,3
C(C(CO)C(C(CC(O)=O)O)O)=O,,,4,1,6,15,21
1660_1,,,,2,2,1,3
1662_0,,,,2,2,1,3
C(C(CO)C(CO)(CC(O)=O)O)=O,,,4,1,6,13,19
1662_1,,,,2,2,1,3
1664_0,,,,2,2,1,3
C(C(CO)C(C)(C(C(O)=O)O)O)=O,,,4,1,7,14,21
1664_1,,,,2,2,1,3
1666_0,,,,2,2,1,3
C(C(CO)C1(COCC1O)O)=O,,,4,1,5,11,16
1666_1,,,,2,2,1,3
1668_0,,,,2,2,1,3
C(C(CO)C1(C(O)OCC1)O)=O,,,4,1,6,13,19
1668_1,,,,2,2,1,3
1670_0,,,,2,2,1,3
C(C(CO)C1(COC(C1)O)O)=O,,,4,1,6,13,19
1670_1,,,,2,2,1,3
1672_0,,,,2,2,1,3
C(C(C=C)(C(C=O)CO)O)=O,,,4,1,7,15,22
1672_1,,,,2,2,1,3
1674_0,,,,2,2,1,3
C(C(CO)C(C(C=C)=O)O)=O,,,4,1,7,18,25
1674_1,,,,2,2,1,3
1676_0,,,,2,2,1,3
C(C(CO)C(C=CC=O)O)=O,,,4,1,7,16,23
1676_1,,,,2,2,1,3
1677_0,,,,2,2,1,3
1677_1,,,,2,2,1,3
1678_0,,,,2,2,1,3
1678_1,,,,2,2,1,3
1679_0,,,,2,2,1,3
1679_1,,,,2,2,1,3
1680_0,,,,2,2,1,3
1680_1,,,,2,2,1,3
1681_0,,,,2,2,1,3
1681_1,,,,2,2,1,3
1682_0,,,,2,2,1,3
1682_1,,,,2,2,1,3
1683_0,,,,2,2,1,3
1683_1,,,,2,2,1,3
1684_0,,,,2,2,1,3
1684_1,,,,2,2,1,3
1685_0,,,,2,2,1,3
1685_1,,,,2,2,1,3
1686_0,,,,2,2,1,3
1686_1,,,,2,2,1,3
1687_0,,,,2,2,1,3
1687_1,,,,2,2,1,3
1688_0,,,,2,2,1,3
1688_1,,,,2,2,1,3
1689_0,,,,2,2,1,3
1689_1,,,,2,2,1,3
1690_0,,,,2,2,1,3
1690_1,,,,2,2,1,3
1691_0,,,,2,2,1,3
1691_1,,,,2,2,1,3
1692_0,,,,2,2,1,3
1692_1,,,,2,2,1,3
1693_0,,,,2,2,1,3
1693_1,,,,2,2,1,3
1694_0,,,,2,2,1,3
1694_1,,,,2,2,1,3
1696_0,,,,2,2,1,3
C(C(CO)CO)=O,,,4,1,7,101,108
1696_1,,,,2,2,1,3
1698_0,,,,2,2,1,3
C(C(CO)C(CO)O)=O,,,4,1,12,25,37
1698_1,,,,2,2,1,3
1700_0,,,,2,2,1,3
C(C(C(C(CC(CO)O)O)O)=O)=O,,,4,1,4,15,19
1700_1,,,,2,2,1,3
1702_0,,,,2,2,1,3
C(C)(C(C(CC(CO)O)O)O)=O,,,4,1,3,12,15
1702_1,,,,2,2,1,3
1704_0,,,,2,2,1,3
C(CO)(CC(CC(CO)O)O)=O,,,4,1,3,10,13
1706_0,,,,2,2,1,3
C(C(CC(CC(CO)O)O)=O)(O)=O,,,4,1,3,11,14
1708_0,,,,2,2,1,3
C(C(C=O)C(CC(CO)O)O)(O)=O,,,4,1,6,14,20
1708_1,,,,2,2,1,3
1710_0,,,,2,2,1,3
C(CO)(C(C(CC(CO)O)O)O)=O,,,4,1,4,12,16
1710_1,,,,2,2,1,3
1712_0,,,,2,2,1,3
C(C(CC(CC(CO)O)O)=O)=O,,,4,1,2,15,17
1714_0,,,,2,2,1,3
C(C(C=O)C(CC(CO)O)O)=O,,,4,1,4,12,16
1714_1,,,,2,2,1,3
1716_0,,,,2,2,1,3
C(CC(CC(CO)O)O)=O,,,4,1,9,18,27
1718_0,,,,2,2,1,3
C(C(C(CC(CO)O)O)O)=O,,,4,1,8,15,23
1718_1,,,,2,2,1,3
1720_0,,,,2,2,1,3
C(C(C(CO)O)C(C=O)(CO)O)=O,,,4,1,9,17,26
1720_1,,,,2,2,1,3
1722_0,,,,2,2,1,3
C(C(C(CO)O)C(C(CO)=O)O)=O,,,4,1,9,17,26
1722_1,,,,2,2,1,3
1724_0,,,,2,2,1,3
C(C(C(CO)O)C(C)(CO)O)=O,,,4,1,6,15,21
1724_1,,,,2,2,1,3
1726_0,,,,2,2,1,3
C(C(C(CO)O)C(C(O)=O)O)=O,,,4,1,11,16,27
1726_1,,,,2,2,1,3
1728_0,,,,2,2,1,3
C(C(C(CO)O)C(C(O)=O)(C)O)=O,,,4,1,8,15,23
1728_1,,,,2,2,1,3
1730_0,,,,2,2,1,3
C(C(C(CC(O)=O)O)C(CO)O)=O,,,4,1,6,14,20
1730_1,,,,2,2,1,3
1732_0,,,,2,2,1,3
C(C(C=C)(C(C=O)C(CO)O)O)=O,,,4,1,5,13,18
1732_1,,,,2,2,1,3
1734_0,,,,2,2,1,3
C(C(C(CO)O)C(C(C=C)=O)O)=O,,,4,1,5,16,21
1734_1,,,,2,2,1,3
1736_0,,,,2,2,1,3
C(C(C(CO)O)C(C=CC=O)O)=O,,,4,1,5,13,18
1736_1,,,,2,2,1,3
1737_0,,,,2,2,1,3
1737_1,,,,2,2,1,3
1738_0,,,,2,2,1,3
1738_1,,,,2,2,1,3
1739_0,,,,2,2,1,3
1739_1,,,,2,2,1,3
1740_0,,,,2,2,1,3
1740_1,,,,2,2,1,3
1741_0,,,,2,2,1,3
1741_1,,,,2,2,1,3
1742_0,,,,2,2,1,3
1742_1,,,,2,2,1,3
1743_0,,,,2,2,1,3
1743_1,,,,2,2,1,3
1744_0,,,,2,2,1,3
1744_1,,,,2,2,1,3
1746_0,,,,2,2,1,3
C(C(C(CO)O)C(CO)O)=O,,,4,1,6,10,16
1746_1,,,,2,2,1,3
1748_0,,,,2,2,1,3
C(C(CO)(C(C(C=O)=O)O)O)=O,,,4,1,4,21,25
1748_1,,,,2,2,1,3
1750_0,,,,2,2,1,3
C(C(CO)(C(C(C(C)=O)=O)O)O)=O,,,4,1,6,17,23
1750_1,,,,2,2,1,3
1752_0,,,,2,2,1,3
C(C(CO)(CC(C(CO)=O)=O)O)=O,,,4,1,3,14,17
1753_0,,,,2,2,1,3
1753_1,,,,2,2,1,3
1754_0,,,,2,2,1,3
1755_0,,,,2,2,1,3
1755_1,,,,2,2,1,3
1757_0,,,,2,2,1,3
C(C(CO)(C(C(CO)=O)CO)O)=O,,,4,1,10,16,26
1757_1,,,,2,2,1,3
1759_0,,,,2,2,1,3
C(C(CO)(CC(C(CO)O)=O)O)=O,,,4,1,8,16,24
1761_0,,,,2,2,1,3
C(C(CO)(CC(C(O)=O)=O)O)=O,,,4,1,3,13,16
1763_0,,,,2,2,1,3
C(C(C=O)C(C=O)(CO)O)(O)=O,,,4,1,7,16,23
1763_1,,,,2,2,1,3
1765_0,,,,2,2,1,3
C(C(CO)(C1C(C(CO1)O)=O)O)=O,,,4,1,4,12,16
1765_1,,,,2,2,1,3
1767_0,,,,2,2,1,3
C(C(CO)(C1C(C(O)OC1)=O)O)=O,,,4,1,4,12,16
1767_1,,,,2,2,1,3
1769_0,,,,2,2,1,3
C(C(CO)(C1C(COC1O)=O)O)=O,,,4,1,4,15,19
1769_1,,,,2,2,1,3
1771_0,,,,2,2,1,3
C(C(CO)(C1C(CC(O1)O)=O)O)=O,,,4,1,5,14,19
1771_1,,,,2,2,1,3
1773_0,,,,2,2,1,3
C(C(CO)(C(C(CO)=O)O)O)=O,,,4,1,8,18,26
1773_1,,,,2,2,1,3
1775_0,,,,2,2,1,3
C(C(CO)(CC(C=O)=O)O)=O,,,4,1,5,17,22
1777_0,,,,2,2,1,3
C(C(C=O)C(C=O)(CO)O)=O,,,4,1,6,13,19
1777_1,,,,2,2,1,3
1779_0,,,,2,2,1,3
C(C(CO)(C(C(C=O)=O)CO)O)=O,,,4,1,6,16,22
1779_1,,,,2,2,1,3
1781_0,,,,2,2,1,3
C(C(C(C=O)C(C=O)(CO)O)O)=O,,,4,1,6,17,23
1781_1,,,,2,2,1,3
1783_0,,,,2,2,1,3
C(C(CO)(C(C=O)C(CO)=O)O)=O,,,4,1,5,15,20
1783_1,,,,2,2,1,3
1785_0,,,,2,2,1,3
C(C(CO)(C(C(CC=O)=O)O)O)=O,,,4,1,7,19,26
1785_1,,,,2,2,1,3
1787_0,,,,2,2,1,3
C(C(CO)(CC(C(C=O)O)=O)O)=O,,,4,1,3,15,18
1788_0,,,,2,2,1,3
1789_0,,,,2,2,1,3
1789_1,,,,2,2,1,3
1791_0,,,,2,2,1,3
C(CO)(C(C(C(C=O)=O)O)O)=O,,,4,1,2,21,23
1791_1,,,,2,2,1,3
1793_0,,,,2,2,1,3
C(CO)(C(C(C(C(C)=O)=O)O)O)=O,,,4,1,4,18,22
1793_1,,,,2,2,1,3
1795_0,,,,2,2,1,3
C(CO)(C(CC(C(CO)=O)=O)O)=O,,,4,1,2,16,18
1796_0,,,,2,2,1,3
1796_1,,,,2,2,1,3
1798_0,,,,2,2,1,3
C(CO)(C(CC(CO)=O)O)=O,,,4,1,15,19,34
1799_0,,,,2,2,1,3
1799_1,,,,2,2,1,3
1801_0,,,,2,2,1,3
C(CO)(C(CO)C(C(CO)=O)O)=O,,,4,1,9,16,25
1801_1,,,,2,2,1,3
1803_0,,,,2,2,1,3
C(CC(C(CO)=O)O)(C(CO)O)=O,,,4,1,7,16,23
1805_0,,,,2,2,1,3
C(CO)(C(CC(C(O)=O)=O)O)=O,,,4,1,2,12,14
1807_0,,,,2,2,1,3
C(C(C=O)C(C(CO)=O)O)(O)=O,,,4,1,6,15,21
1807_1,,,,2,2,1,3
1809_0,,,,2,2,1,3
C(C(C1C(C(CO1)O)=O)O)(CO)=O,,,4,1,2,11,13
1809_1,,,,2,2,1,3
1811_0,,,,2,2,1,3
C(C(C1C(C(O)OC1)=O)O)(CO)=O,,,4,1,3,12,15
1811_1,,,,2,2,1,3
1813_0,,,,2,2,1,3
C1(COC(C1C(C(CO)=O)O)O)=O,,,4,1,3,15,18
1813_1,,,,2,2,1,3
1815_0,,,,2,2,1,3
C(C(C1C(CC(O1)O)=O)O)(CO)=O,,,4,1,3,13,16
1815_1,,,,2,2,1,3
1817_0,,,,2,2,1,3
C(CO)(C(C(C(CO)=O)O)O)=O,,,4,1,5,8,13
1817_1,,,,2,2,1,3
1819_0,,,,2,2,1,3
C(CO)(C(CC(C=O)=O)O)=O,,,4,1,9,21,30
1821_0,,,,2,2,1,3
C(C(C=O)C(C(CO)=O)O)=O,,,4,1,7,15,22
1821_1,,,,2,2,1,3
1823_0,,,,2,2,1,3
C(C(C(C(C=O)=O)CO)O)(CO)=O,,,4,1,5,18,23
1823_1,,,,2,2,1,3
1825_0,,,,2,2,1,3
C(C(C(C=O)C(C(CO)=O)O)O)=O,,,4,1,7,19,26
1825_1,,,,2,2,1,3
1827_0,,,,2,2,1,3
C(C(C(CO)=O)C(C(CO)=O)O)=O,,,4,1,4,17,21
1827_1,,,,2,2,1,3
1829_0,,,,2,2,1,3
C(CC(C(C(C(CO)=O)O)O)=O)=O,,,4,1,5,21,26
1829_1,,,,2,2,1,3
1831_0,,,,2,2,1,3
C(C(C(CC(C(CO)=O)O)=O)O)=O,,,4,1,2,17,19
1833_0,,,,2,2,1,3
C(CC(C(CO)=O)O)=O,,,4,1,27,49,76
1834_0,,,,2,2,1,3
1834_1,,,,2,2,1,3
1836_0,,,,2,2,1,3
C(C)(C(CO)(C(C(C=O)=O)O)O)=O,,,4,1,4,18,22
1836_1,,,,2,2,1,3
1838_0,,,,2,2,1,3
C(CO)(C(C)(C(C(C=O)=O)O)O)=O,,,4,1,3,17,20
1838_1,,,,2,2,1,3
1840_0,,,,2,2,1,3
C(C(C(C)O)(C(C(C=O)=O)O)O)=O,,,4,1,5,18,23
1840_1,,,,2,2,1,3
1842_0,,,,2,2,1,3
C(C(C(C(C=O)=O)O)O)(C(C)O)=O,,,4,1,4,17,21
1842_1,,,,2,2,1,3
1844_0,,,,2,2,1,3
C(C(C(C(CO)(C)O)O)=O)=O,,,4,1,6,16,22
1844_1,,,,2,2,1,3
1846_0,,,,2,2,1,3
C(C(C(C(CO)(CCO)O)O)=O)=O,,,4,1,4,14,18
1846_1,,,,2,2,1,3
1848_0,,,,2,2,1,3
C(C(C(C(C(CCO)O)O)O)=O)=O,,,4,1,4,15,19
1848_1,,,,2,2,1,3
1850_0,,,,2,2,1,3
C(C(C(C(C)(C(CO)O)O)O)=O)=O,,,4,1,3,15,18
1850_1,,,,2,2,1,3
1852_0,,,,2,2,1,3
C(C(C(C(C=O)=O)O)O)(O)=O,,,4,1,6,19,25
1852_1,,,,2,2,1,3
1854_0,,,,2,2,1,3
C(C(C)(C(C(C=O)=O)O)O)(O)=O,,,4,1,3,15,18
1854_1,,,,2,2,1,3
1856_0,,,,2,2,1,3
C(CC(C(C(C=O)=O)O)O)(O)=O,,,4,1,4,16,20
1856_1,,,,2,2,1,3
1858_0,,,,2,2,1,3
C(C(C(C1(COCC1O)O)O)=O)=O,,,4,1,2,10,12
1858_1,,,,2,2,1,3
1860_0,,,,2,2,1,3
C(C(C(C1(C(O)OCC1)O)O)=O)=O,,,4,1,3,12,15
1860_1,,,,2,2,1,3
1862_0,,,,2,2,1,3
C(C(C(C1(COC(C1)O)O)O)=O)=O,,,4,1,3,12,15
1862_1,,,,2,2,1,3
1864_0,,,,2,2,1,3
C(C(C=C)(C(C(C=O)=O)O)O)=O,,,4,1,4,16,20
1864_1,,,,2,2,1,3
1866_0,,,,2,2,1,3
C=CC(C(C(C(C=O)=O)O)O)=O,,,4,1,4,17,21
1866_1,,,,2,2,1,3
1868_0,,,,2,2,1,3
C(C(C(C(C=O)=O)O)O)=CC=O,,,4,1,4,17,21
1868_1,,,,2,2,1,3
1869_0,,,,2,2,1,3
1869_1,,,,2,2,1,3
1871_0,,,,2,2,1,3
C(C(C(C(C=O)=O)O)O)=O,,,4,1,12,31,43
1871_1,,,,2,2,1,3
1873_0,,,,2,2,1,3
C(C(C(C(CO)(CO)O)O)=O)=O,,,4,1,4,13,17
1873_1,,,,2,2,1,3
1875_0,,,,2,2,1,3
C(C(C)(C(C(C=O)=O)O)O)=O,,,4,1,5,17,22
1875_1,,,,2,2,1,3
1877_0,,,,2,2,1,3
C(C)(C(C(C(C=O)=O)O)O)=O,,,4,1,12,22,34
1877_1,,,,2,2,1,3
1879_0,,,,2,2,1,3
C(CC(C(C(C=O)=O)O)O)=O,,,4,1,12,23,35
1879_1,,,,2,2,1,3
1881_0,,,,2,2,1,3
C(C(CCO)(C(C(C=O)=O)O)O)=O,,,4,1,4,15,19
1881_1,,,,2,2,1,3
1883_0,,,,2,2,1,3
C(C(C(C(C=O)=O)O)O)(CCO)=O,,,4,1,4,18,22
1883_1,,,,2,2,1,3
1885_0,,,,2,2,1,3
C(CC(C(C(C(C=O)=O)O)O)O)=O,,,4,1,4,23,27
1885_1,,,,2,2,1,3
1887_0,,,,2,2,1,3
C(C(CC(C(C(C=O)=O)O)O)O)=O,,,4,1,4,20,24
1887_1,,,,2,2,1,3
1889_0,,,,2,2,1,3
C(CO)(CC(C(C(C=O)=O)O)O)=O,,,4,1,4,19,23
1889_1,,,,2,2,1,3
1891_0,,,,2,2,1,3
C(CC(CO)(C(C(C=O)=O)O)O)=O,,,4,1,4,17,21
1891_1,,,,2,2,1,3
1893_0,,,,2,2,1,3
C(C)(C(C(C(C(C=O)=O)O)O)O)=O,,,4,1,5,20,25
1893_1,,,,2,2,1,3
1895_0,,,,2,2,1,3
C(C(C(C)(C(C(C=O)=O)O)O)O)=O,,,4,1,5,18,23
1895_1,,,,2,2,1,3
1897_0,,,,2,2,1,3
C(C(C(C(C)O)O)=O)=O,,,4,1,12,33,45
1897_1,,,,2,2,1,3
1898_0,,,,2,2,1,3
1898_1,,,,2,2,1,3
1899_0,,,,2,2,1,3
1899_1,,,,2,2,1,3
1900_0,,,,2,2,1,3
1900_1,,,,2,2,1,3
1902_0,,,,2,2,1,3
C(C(C(CO)O)(CC(CO)=O)O)=O,,,4,1,9,15,24
1904_0,,,,2,2,1,3
C(C(C(CO)O)(CC(C=O)=O)O)=O,,,4,1,3,15,18
1906_0,,,,2,2,1,3
C(C(C=O)C(C=O)(C(CO)O)O)=O,,,4,1,4,13,17
1906_1,,,,2,2,1,3
1907_0,,,,2,2,1,3
1908_0,,,,2,2,1,3
1908_1,,,,2,2,1,3
1909_0,,,,2,2,1,3
1909_1,,,,2,2,1,3
1911_0,,,,2,2,1,3
C(CC(C(C(CO)O)=O)O)(CO)=O,,,4,1,9,16,25
1913_0,,,,2,2,1,3
C(C(CC(C=O)=O)O)(C(CO)O)=O,,,4,1,3,17,20
1915_0,,,,2,2,1,3
C(C(C=O)C(C(C(CO)O)=O)O)=O,,,4,1,4,14,18
1915_1,,,,2,2,1,3
1917_0,,,,2,2,1,3
C(CC(C(C(CO)O)=O)O)=O,,,4,1,16,20,36
1918_0,,,,2,2,1,3
1918_1,,,,2,2,1,3
1919_0,,,,2,2,1,3
1921_0,,,,2,2,1,3
C(CC(C(C(C(CO)O)O)=O)O)=O,,,4,1,8,16,24
1923_0,,,,2,2,1,3
C(C)(C(CO)(C(C(C)=O)O)O)=O,,,4,1,9,16,25
1923_1,,,,2,2,1,3
1925_0,,,,2,2,1,3
C(C)(C(CO)(CC(CO)=O)O)=O,,,4,1,6,13,19
1927_0,,,,2,2,1,3
C(C)(C(CO)(CC(C(O)=O)=O)O)=O,,,4,1,3,11,14
1929_0,,,,2,2,1,3
C(C(C=O)C(C(C)=O)(CO)O)(O)=O,,,4,1,6,13,19
1929_1,,,,2,2,1,3
1931_0,,,,2,2,1,3
C(C)(C(CO)(C(C(CO)=O)O)O)=O,,,4,1,9,17,26
1931_1,,,,2,2,1,3
1933_0,,,,2,2,1,3
C(C)(C(CO)(CC(C=O)=O)O)=O,,,4,1,4,16,20
1935_0,,,,2,2,1,3
C(C(C=O)C(C(C)=O)(CO)O)=O,,,4,1,5,12,17
1935_1,,,,2,2,1,3
1937_0,,,,2,2,1,3
C(C)(C(CO)(CC=O)O)=O,,,4,1,14,22,36
1939_0,,,,2,2,1,3
C(C)(C(CO)(C(C=O)O)O)=O,,,4,1,16,19,35
1939_1,,,,2,2,1,3
1941_0,,,,2,2,1,3
C(CO)(C(C)(C(C(C)=O)O)O)=O,,,4,1,5,13,18
1941_1,,,,2,2,1,3
1943_0,,,,2,2,1,3
C(CO)(C(C)(CC(CO)=O)O)=O,,,4,1,3,12,15
1945_0,,,,2,2,1,3
C(CO)(C(C)(CC(C(O)=O)=O)O)=O,,,4,1,3,11,14
1947_0,,,,2,2,1,3
C(C(C=O)C(C(CO)=O)(C)O)(O)=O,,,4,1,6,13,19
1947_1,,,,2,2,1,3
1949_0,,,,2,2,1,3
C(CO)(C(C)(C(C(CO)=O)O)O)=O,,,4,1,6,15,21
1949_1,,,,2,2,1,3
1951_0,,,,2,2,1,3
C(CO)(C(C)(CC(C=O)=O)O)=O,,,4,1,2,16,18
1953_0,,,,2,2,1,3
C(C(C=O)C(C(CO)=O)(C)O)=O,,,4,1,4,11,15
1953_1,,,,2,2,1,3
1955_0,,,,2,2,1,3
C(CO)(C(C)(CC=O)O)=O,,,4,1,9,24,33
1957_0,,,,2,2,1,3
C(CO)(C(C)(C(C=O)O)O)=O,,,4,1,10,17,27
1957_1,,,,2,2,1,3
1959_0,,,,2,2,1,3
C(C(C)=O)(C(C(CO)(C)O)O)=O,,,4,1,4,12,16
1959_1,,,,2,2,1,3
1961_0,,,,2,2,1,3
C(C(C(C(C(C)=O)=O)O)O)(O)=O,,,4,1,5,13,18
1961_1,,,,2,2,1,3
1963_0,,,,2,2,1,3
C(C(C)(C(C(C(C)=O)=O)O)O)(O)=O,,,4,1,4,11,15
1963_1,,,,2,2,1,3
1965_0,,,,2,2,1,3
C(CC(C(C(C(C)=O)=O)O)O)(O)=O,,,4,1,3,12,15
1965_1,,,,2,2,1,3
1967_0,,,,2,2,1,3
C(C(C=C)(C(C(C(C)=O)=O)O)O)=O,,,4,1,3,10,13
1967_1,,,,2,2,1,3
1969_0,,,,2,2,1,3
C=CC(C(C(C(C(C)=O)=O)O)O)=O,,,4,1,4,13,17
1969_1,,,,2,2,1,3
1971_0,,,,2,2,1,3
C(C(C(C(C(C)=O)=O)O)O)=CC=O,,,4,1,2,12,14
1971_1,,,,2,2,1,3
1973_0,,,,2,2,1,3
C(C(C)=O)(C(C(C(CO)O)O)O)=O,,,4,1,6,15,21
1973_1,,,,2,2,1,3
1975_0,,,,2,2,1,3
C(C(C(C(C(C)=O)=O)O)O)=O,,,4,1,8,20,28
1975_1,,,,2,2,1,3
1977_0,,,,2,2,1,3
C(C(C)=O)(C(C(CO)(CO)O)O)=O,,,4,1,3,9,12
1977_1,,,,2,2,1,3
1979_0,,,,2,2,1,3
C(C(C)(C(C(C(C)=O)=O)O)O)=O,,,4,1,4,14,18
1979_1,,,,2,2,1,3
1981_0,,,,2,2,1,3
C(C)(C(C(C(C(C)=O)=O)O)O)=O,,,4,1,8,16,24
1981_1,,,,2,2,1,3
1983_0,,,,2,2,1,3
C(CC(C(C(C(C)=O)=O)O)O)=O,,,4,1,7,18,25
1983_1,,,,2,2,1,3
1985_0,,,,2,2,1,3
C(C(C)=O)(C(C(C)O)O)=O,,,4,1,3,21,24
1985_1,,,,2,2,1,3
1987_0,,,,2,2,1,3
C(C(C)=O)(C(CO)O)=O,,,4,1,12,36,48
1987_1,,,,2,2,1,3
1989_0,,,,2,2,1,3
C(C(C)=O)(C(C(CO)O)O)=O,,,4,1,7,16,23
1989_1,,,,2,2,1,3
1991_0,,,,2,2,1,3
C(C(CO)=O)(CC(CO)(C)O)=O,,,4,1,3,11,14
1993_0,,,,2,2,1,3
C(C(CC(C(CO)=O)=O)O)(O)=O,,,4,1,3,11,14
1995_0,,,,2,2,1,3
C(C(C)(CC(C(CO)=O)=O)O)(O)=O,,,4,1,3,10,13
1997_0,,,,2,2,1,3
C(CC(CC(C(CO)=O)=O)O)(O)=O,,,4,1,3,9,12
1999_0,,,,2,2,1,3
C(C(C=C)(CC(C(CO)=O)=O)O)=O,,,4,1,2,9,11
2001_0,,,,2,2,1,3
C=CC(C(CC(C(CO)=O)=O)O)=O,,,4,1,2,11,13
2003_0,,,,2,2,1,3
C(C(CC(C(CO)=O)=O)O)=CC=O,,,4,1,2,11,13
2005_0,,,,2,2,1,3
C(C(CO)=O)(CC(C(CO)O)O)=O,,,4,1,6,13,19
2007_0,,,,2,2,1,3
C(C(CC(C(CO)=O)=O)O)=O,,,4,1,5,18,23
2009_0,,,,2,2,1,3
C(C(CO)=O)(CC(CO)(CO)O)=O,,,4,1,3,8,11
2011_0,,,,2,2,1,3
C(C(C)(CC(C(CO)=O)=O)O)=O,,,4,1,3,13,16
2013_0,,,,2,2,1,3
C(C)(C(CC(C(CO)=O)=O)O)=O,,,4,1,4,14,18
2015_0,,,,2,2,1,3
C(CC(CC(C(CO)=O)=O)O)=O,,,4,1,5,16,21
2017_0,,,,2,2,1,3
C(C(CO)=O)(CC(C)O)=O,,,4,1,3,22,25
2019_0,,,,2,2,1,3
C(C(CO)=O)(CCO)=O,,,4,1,14,40,54
2021_0,,,,2,2,1,3
C(C(CO)=O)(CC(CO)O)=O,,,4,1,7,15,22
2023_0,,,,2,2,1,3
C(C(C(C)O)(C(C(C)=O)O)O)=O,,,4,1,8,17,25
2023_1,,,,2,2,1,3
2025_0,,,,2,2,1,3
C(C(C(C)O)(CC(CO)=O)O)=O,,,4,1,5,14,19
2027_0,,,,2,2,1,3
C(C(C(C)O)(CC(C(O)=O)=O)O)=O,,,4,1,4,12,16
2029_0,,,,2,2,1,3
C(C(C=O)C(C=O)(C(C)O)O)(O)=O,,,4,1,7,14,21
2029_1,,,,2,2,1,3
2031_0,,,,2,2,1,3
C(C(C(C)O)(C(C(CO)=O)O)O)=O,,,4,1,8,18,26
2031_1,,,,2,2,1,3
2033_0,,,,2,2,1,3
C(C(C(C)O)(CC(C=O)=O)O)=O,,,4,1,3,16,19
2035_0,,,,2,2,1,3
C(C(C=O)C(C=O)(C(C)O)O)=O,,,4,1,5,13,18
2035_1,,,,2,2,1,3
2036_0,,,,2,2,1,3
2038_0,,,,2,2,1,3
C(C(C(C)O)(C(C=O)O)O)=O,,,4,1,11,19,30
2038_1,,,,2,2,1,3
2040_0,,,,2,2,1,3
C(C(C(C(C(C)O)=O)O)O)(C)=O,,,4,1,6,14,20
2040_1,,,,2,2,1,3
2042_0,,,,2,2,1,3
C(CC(C(C(C)O)=O)O)(CO)=O,,,4,1,4,12,16
2044_0,,,,2,2,1,3
C(C(CC(C(O)=O)=O)O)(C(C)O)=O,,,4,1,4,11,15
2046_0,,,,2,2,1,3
C(C(C=O)C(C(C(C)O)=O)O)(O)=O,,,4,1,7,13,20
2046_1,,,,2,2,1,3
2048_0,,,,2,2,1,3
C(C(C(C(C(C)O)=O)O)O)(CO)=O,,,4,1,8,16,24
2048_1,,,,2,2,1,3
2050_0,,,,2,2,1,3
C(C(CC(C=O)=O)O)(C(C)O)=O,,,4,1,3,15,18
2052_0,,,,2,2,1,3
C(C(C=O)C(C(C(C)O)=O)O)=O,,,4,1,5,11,16
2052_1,,,,2,2,1,3
2054_0,,,,2,2,1,3
C(CC(C(C(C)O)=O)O)=O,,,4,1,13,24,37
2056_0,,,,2,2,1,3
C(C(C(C=O)O)O)(C(C)O)=O,,,4,1,11,19,30
2056_1,,,,2,2,1,3
2058_0,,,,2,2,1,3
C(C)(C(C(CO)(C)O)O)=O,,,4,1,10,18,28
2058_1,,,,2,2,1,3
2060_0,,,,2,2,1,3
C(CO)(CC(CO)(C)O)=O,,,4,1,11,20,31
2062_0,,,,2,2,1,3
C(C(C(CO)(C)O)O)(CCO)=O,,,4,1,5,10,15
2062_1,,,,2,2,1,3
2064_0,,,,2,2,1,3
C(CO)(C(CO)C(CO)(C)O)=O,,,4,1,7,11,18
2064_1,,,,2,2,1,3
2066_0,,,,2,2,1,3
C(C(CO)O)(CC(CO)(C)O)=O,,,4,1,5,11,16
2068_0,,,,2,2,1,3
C(C(CC(C)(CO)O)=O)(O)=O,,,4,1,5,11,16
2070_0,,,,2,2,1,3
C(C(C=O)C(C)(CO)O)(O)=O,,,4,1,7,13,20
2070_1,,,,2,2,1,3
2072_0,,,,2,2,1,3
C(C(C(CO)C(C)(CO)O)=O)(O)=O,,,4,1,6,13,19
2072_1,,,,2,2,1,3
2074_0,,,,2,2,1,3
C(C(C(CO)(C)O)C(C(O)=O)O)=O,,,4,1,6,14,20
2074_1,,,,2,2,1,3
2076_0,,,,2,2,1,3
C(C(C(CO)=O)C(CO)(C)O)(O)=O,,,4,1,7,11,18
2076_1,,,,2,2,1,3
2078_0,,,,2,2,1,3
C(CC(C(C(CO)(C)O)O)=O)(O)=O,,,4,1,5,12,17
2078_1,,,,2,2,1,3
2080_0,,,,2,2,1,3
C(C(C(CC(CO)(C)O)=O)O)(O)=O,,,4,1,5,11,16
2082_0,,,,2,2,1,3
C1(C(C(CO)(C)O)OCC1O)=O,,,4,1,3,6,9
2082_1,,,,2,2,1,3
2084_0,,,,2,2,1,3
C1(C(O)OCC1C(CO)(C)O)=O,,,4,1,4,9,13
2084_1,,,,2,2,1,3
2086_0,,,,2,2,1,3
C1(COC(C1C(CO)(C)O)O)=O,,,4,1,4,11,15
2086_1,,,,2,2,1,3
2088_0,,,,2,2,1,3
C1(C(C(CO)(C)O)OC(C1)O)=O,,,4,1,4,9,13
2088_1,,,,2,2,1,3
2090_0,,,,2,2,1,3
C(CO)(C(C(CO)(C)O)O)=O,,,4,1,9,12,21
2090_1,,,,2,2,1,3
2092_0,,,,2,2,1,3
C(C(C(CO)(C)O)O)(C(CO)O)=O,,,4,1,7,12,19
2092_1,,,,2,2,1,3
2094_0,,,,2,2,1,3
C(C(CC(C)(CO)O)=O)=O,,,4,1,8,20,28
2096_0,,,,2,2,1,3
C(C(C=O)C(C)(CO)O)=O,,,4,1,9,13,22
2096_1,,,,2,2,1,3
2098_0,,,,2,2,1,3
C(C(C(CO)C(C)(CO)O)=O)=O,,,4,1,6,17,23
2098_1,,,,2,2,1,3
2100_0,,,,2,2,1,3
C(C(C(CO)(C)O)C(C=O)O)=O,,,4,1,6,17,23
2100_1,,,,2,2,1,3
2102_0,,,,2,2,1,3
C(C(C(CO)=O)C(CO)(C)O)=O,,,4,1,7,13,20
2102_1,,,,2,2,1,3
2104_0,,,,2,2,1,3
C(CC(C(C(CO)(C)O)O)=O)=O,,,4,1,5,14,19
2104_1,,,,2,2,1,3
2106_0,,,,2,2,1,3
C(C(C(CC(CO)(C)O)=O)O)=O,,,4,1,3,12,15
2108_0,,,,2,2,1,3
C(CC(C)(CO)O)=O,,,4,1,21,61,82
2110_0,,,,2,2,1,3
C(C(C(CO)(C)O)O)=O,,,4,1,15,27,42
2110_1,,,,2,2,1,3
2112_0,,,,2,2,1,3
C(C)(C(C(CO)(CCO)O)O)=O,,,4,1,4,10,14
2112_1,,,,2,2,1,3
2114_0,,,,2,2,1,3
C(C)(C(C(C(CCO)O)O)O)=O,,,4,1,4,12,16
2114_1,,,,2,2,1,3
2116_0,,,,2,2,1,3
C(C)(C(C(C)(C(CO)O)O)O)=O,,,4,1,3,11,14
2116_1,,,,2,2,1,3
2117_0,,,,2,2,1,3
2117_1,,,,2,2,1,3
2119_0,,,,2,2,1,3
C(C(C)(C(C(C)=O)O)O)(O)=O,,,4,1,9,12,21
2119_1,,,,2,2,1,3
2121_0,,,,2,2,1,3
C(CC(C(C(C)=O)O)O)(O)=O,,,4,1,8,13,21
2121_1,,,,2,2,1,3
2123_0,,,,2,2,1,3
C(C(CCO)(C(C(C)=O)O)O)(O)=O,,,4,1,5,11,16
2123_1,,,,2,2,1,3
2125_0,,,,2,2,1,3
C(C(CC(C(C(C)=O)O)O)O)(O)=O,,,4,1,5,13,18
2125_1,,,,2,2,1,3
2127_0,,,,2,2,1,3
C(CC(C(C(C(C)=O)O)O)O)(O)=O,,,4,1,3,13,16
2127_1,,,,2,2,1,3
2129_0,,,,2,2,1,3
C(CC(CO)(C(C(C)=O)O)O)(O)=O,,,4,1,4,10,14
2129_1,,,,2,2,1,3
2131_0,,,,2,2,1,3
C(C(C(C)(C(C(C)=O)O)O)O)(O)=O,,,4,1,5,11,16
2131_1,,,,2,2,1,3
2133_0,,,,2,2,1,3
C(C)(C(C1(COCC1O)O)O)=O,,,4,1,2,7,9
2133_1,,,,2,2,1,3
2135_0,,,,2,2,1,3
C(C)(C(C1(C(O)OCC1)O)O)=O,,,4,1,3,9,12
2135_1,,,,2,2,1,3
2137_0,,,,2,2,1,3
C(C)(C(C1(COC(C1)O)O)O)=O,,,4,1,3,9,12
2137_1,,,,2,2,1,3
2139_0,,,,2,2,1,3
C(C(C=C)(C(C(C)=O)O)O)=O,,,4,1,10,15,25
2139_1,,,,2,2,1,3
2141_0,,,,2,2,1,3
C(C)(C(C(C(C=C)=O)O)O)=O,,,4,1,10,20,30
2141_1,,,,2,2,1,3
2143_0,,,,2,2,1,3
C(C)(C(C(C=CC=O)O)O)=O,,,4,1,9,18,27
2143_1,,,,2,2,1,3
2145_0,,,,2,2,1,3
C(C)(C(C(C(CO)O)O)O)=O,,,4,1,13,15,28
2145_1,,,,2,2,1,3
2147_0,,,,2,2,1,3
C(C)(C(C(C(C(CO)O)O)O)O)=O,,,4,1,8,14,22
2147_1,,,,2,2,1,3
2148_0,,,,2,2,1,3
2148_1,,,,2,2,1,3
2150_0,,,,2,2,1,3
C(C)(C(C(CO)(CO)O)O)=O,,,4,1,9,10,19
2150_1,,,,2,2,1,3
2152_0,,,,2,2,1,3
C(C)(C(C(CO)(C(CO)O)O)O)=O,,,4,1,8,11,19
2152_1,,,,2,2,1,3
2154_0,,,,2,2,1,3
C(C)(C(C(C(CO)(CO)O)O)O)=O,,,4,1,4,9,13
2154_1,,,,2,2,1,3
2156_0,,,,2,2,1,3
C(C(C)(C(C(C)=O)O)O)=O,,,4,1,11,22,33
2156_1,,,,2,2,1,3
2158_0,,,,2,2,1,3
C(C)(C(C(C(C)=O)O)O)=O,,,4,1,12,16,28
2158_1,,,,2,2,1,3
2159_0,,,,2,2,1,3
2159_1,,,,2,2,1,3
2161_0,,,,2,2,1,3
C(C(CCO)(C(C(C)=O)O)O)=O,,,4,1,7,14,21
2161_1,,,,2,2,1,3
2163_0,,,,2,2,1,3
C(C(C(C(CCO)=O)O)O)(C)=O,,,4,1,9,16,25
2163_1,,,,2,2,1,3
2164_0,,,,2,2,1,3
2164_1,,,,2,2,1,3
2166_0,,,,2,2,1,3
C(C(CC(C(C(C)=O)O)O)O)=O,,,4,1,4,18,22
2166_1,,,,2,2,1,3
2168_0,,,,2,2,1,3
C(C)(C(C(CC(CO)=O)O)O)=O,,,4,1,8,15,23
2168_1,,,,2,2,1,3
2170_0,,,,2,2,1,3
C(CC(CO)(C(C(C)=O)O)O)=O,,,4,1,8,15,23
2170_1,,,,2,2,1,3
2172_0,,,,2,2,1,3
C(C)(C(C(C(C(C)=O)O)O)O)=O,,,4,1,4,8,12
2172_1,,,,2,2,1,3
2174_0,,,,2,2,1,3
C(C(C(C)(C(C(C)=O)O)O)O)=O,,,4,1,3,15,18
2174_1,,,,2,2,1,3
2176_0,,,,2,2,1,3
C(C)(C(C(C)O)O)=O,,,4,1,21,78,99
2176_1,,,,2,2,1,3
2177_0,,,,2,2,1,3
2177_1,,,,2,2,1,3
2179_0,,,,2,2,1,3
C(C)(C(C(CO)O)O)=O,,,4,1,19,34,53
2179_1,,,,2,2,1,3
2181_0,,,,2,2,1,3
C(CO)(CC(CO)(CCO)O)=O,,,4,1,4,9,13
2183_0,,,,2,2,1,3
C(CO)(CC(C(CCO)O)O)=O,,,4,1,4,10,14
2185_0,,,,2,2,1,3
C(CO)(CC(C)(C(CO)O)O)=O,,,4,1,3,10,13
2186_0,,,,2,2,1,3
2188_0,,,,2,2,1,3
C(C(C)(CC(CO)=O)O)(O)=O,,,4,1,9,12,21
2190_0,,,,2,2,1,3
C(CC(CC(CO)=O)O)(O)=O,,,4,1,9,12,21
2192_0,,,,2,2,1,3
C(C(CCO)(CC(CO)=O)O)(O)=O,,,4,1,4,10,14
2194_0,,,,2,2,1,3
C(C(CC(CC(CO)=O)O)O)(O)=O,,,4,1,6,10,16
2196_0,,,,2,2,1,3
C(CC(C(CC(CO)=O)O)O)(O)=O,,,4,1,3,10,13
2198_0,,,,2,2,1,3
C(CC(CO)(CC(CO)=O)O)(O)=O,,,4,1,3,9,12
2200_0,,,,2,2,1,3
C(C(C(C)(CC(CO)=O)O)O)(O)=O,,,4,1,4,10,14
2202_0,,,,2,2,1,3
C(CO)(CC1(COCC1O)O)=O,,,4,1,2,6,8
2204_0,,,,2,2,1,3
C(CO)(CC1(C(O)OCC1)O)=O,,,4,1,3,8,11
2206_0,,,,2,2,1,3
C(CO)(CC1(COC(C1)O)O)=O,,,4,1,3,8,11
2208_0,,,,2,2,1,3
C(C(C=C)(CC(CO)=O)O)=O,,,4,1,9,15,24
2210_0,,,,2,2,1,3
C(CO)(CC(C(C=C)=O)O)=O,,,4,1,8,18,26
2212_0,,,,2,2,1,3
C(CO)(CC(C=CC=O)O)=O,,,4,1,9,18,27
2214_0,,,,2,2,1,3
C(CO)(CC(C(CO)O)O)=O,,,4,1,11,14,25
2216_0,,,,2,2,1,3
C(CO)(CC(C(C(CO)O)O)O)=O,,,4,1,7,12,19
2217_0,,,,2,2,1,3
2219_0,,,,2,2,1,3
C(CO)(CC(CO)(CO)O)=O,,,4,1,8,10,18
2221_0,,,,2,2,1,3
C(CO)(CC(CO)(C(CO)O)O)=O,,,4,1,5,10,15
2223_0,,,,2,2,1,3
C(CO)(CC(C(CO)(CO)O)O)=O,,,4,1,5,7,12
2225_0,,,,2,2,1,3
C(C(C)(CC(CO)=O)O)=O,,,4,1,11,24,35
2227_0,,,,2,2,1,3
C(C)(C(CC(CO)=O)O)=O,,,4,1,17,30,47
2228_0,,,,2,2,1,3
2230_0,,,,2,2,1,3
C(C(CCO)(CC(CO)=O)O)=O,,,4,1,6,13,19
2232_0,,,,2,2,1,3
C(CC(C(CCO)=O)O)(CO)=O,,,4,1,7,14,21
2234_0,,,,2,2,1,3
C(CC(C(CC(CO)=O)O)O)=O,,,4,1,6,19,25
2236_0,,,,2,2,1,3
C(C(CC(CC(CO)=O)O)O)=O,,,4,1,4,16,20
2238_0,,,,2,2,1,3
C(CO)(CC(CC(CO)=O)O)=O,,,4,1,4,7,11
2240_0,,,,2,2,1,3
C(CC(CO)(CC(CO)=O)O)=O,,,4,1,9,15,24
2241_0,,,,2,2,1,3
2243_0,,,,2,2,1,3
C(C(C(C)(CC(CO)=O)O)O)=O,,,4,1,5,15,20
2245_0,,,,2,2,1,3
C(CO)(CC(C)O)=O,,,4,1,24,91,115
2246_0,,,,2,2,1,3
2248_0,,,,2,2,1,3
C(CO)(CC(CO)O)=O,,,4,1,18,38,56
2250_0,,,,2,2,1,3
C(C(CC(CO)(CCO)O)=O)(O)=O,,,4,1,4,11,15
2252_0,,,,2,2,1,3
C(C(C=O)C(CO)(CCO)O)(O)=O,,,4,1,7,13,20
2252_1,,,,2,2,1,3
2254_0,,,,2,2,1,3
C(CO)(C(C(CO)(CCO)O)O)=O,,,4,1,5,10,15
2254_1,,,,2,2,1,3
2256_0,,,,2,2,1,3
C(C(CC(CO)(CCO)O)=O)=O,,,4,1,3,15,18
2258_0,,,,2,2,1,3
C(C(C=O)C(CO)(CCO)O)=O,,,4,1,5,11,16
2258_1,,,,2,2,1,3
2260_0,,,,2,2,1,3
C(CC(CO)(CCO)O)=O,,,4,1,12,17,29
2262_0,,,,2,2,1,3
C(C(C(CO)(CCO)O)O)=O,,,4,1,7,13,20
2262_1,,,,2,2,1,3
2263_0,,,,2,2,1,3
2263_1,,,,2,2,1,3
2265_0,,,,2,2,1,3
C(C(C)(C(C(CCO)=O)O)O)(O)=O,,,4,1,7,11,18
2265_1,,,,2,2,1,3
2267_0,,,,2,2,1,3
C(CC(C(C(CCO)=O)O)O)(O)=O,,,4,1,5,10,15
2267_1,,,,2,2,1,3
2269_0,,,,2,2,1,3
C(C(C=C)(C(C(CCO)=O)O)O)=O,,,4,1,5,12,17
2269_1,,,,2,2,1,3
2271_0,,,,2,2,1,3
C(C(C(C(C=C)=O)O)O)(CCO)=O,,,4,1,6,16,22
2271_1,,,,2,2,1,3
2273_0,,,,2,2,1,3
C(C(C(C=CC=O)O)O)(CCO)=O,,,4,1,4,14,18
2273_1,,,,2,2,1,3
2275_0,,,,2,2,1,3
C(C(C(C(CO)O)O)O)(CCO)=O,,,4,1,8,13,21
2275_1,,,,2,2,1,3
2276_0,,,,2,2,1,3
2276_1,,,,2,2,1,3
2278_0,,,,2,2,1,3
C(C(C(CO)(CO)O)O)(CCO)=O,,,4,1,6,8,14
2278_1,,,,2,2,1,3
2280_0,,,,2,2,1,3
C(C(C)(C(C(CCO)=O)O)O)=O,,,4,1,5,15,20
2280_1,,,,2,2,1,3
2281_0,,,,2,2,1,3
2281_1,,,,2,2,1,3
2282_0,,,,2,2,1,3
2282_1,,,,2,2,1,3
2284_0,,,,2,2,1,3
C(C(C(C)O)O)(CCO)=O,,,4,1,5,22,27
2284_1,,,,2,2,1,3
2286_0,,,,2,2,1,3
C(C(CO)O)(CCO)=O,,,4,1,20,39,59
2286_1,,,,2,2,1,3
2288_0,,,,2,2,1,3
C(C(C(CO)O)O)(CCO)=O,,,4,1,7,15,22
2288_1,,,,2,2,1,3
2290_0,,,,2,2,1,3
C(CO)(C(CO)C(C(O)=O)O)=O,,,4,1,11,12,23
2290_1,,,,2,2,1,3
2292_0,,,,2,2,1,3
C(C(C)(C(C(CO)=O)CO)O)(O)=O,,,4,1,8,12,20
2292_1,,,,2,2,1,3
2294_0,,,,2,2,1,3
C(CC(C(C(CO)=O)CO)O)(O)=O,,,4,1,7,11,18
2294_1,,,,2,2,1,3
2296_0,,,,2,2,1,3
C(C(C=C)(C(C(CO)=O)CO)O)=O,,,4,1,6,12,18
2296_1,,,,2,2,1,3
2298_0,,,,2,2,1,3
C(CO)(C(CO)C(C(C=C)=O)O)=O,,,4,1,6,15,21
2298_1,,,,2,2,1,3
2300_0,,,,2,2,1,3
C(CO)(C(CO)C(C=CC=O)O)=O,,,4,1,6,12,18
2300_1,,,,2,2,1,3
2302_0,,,,2,2,1,3
C(CO)(C(CO)C(C(CO)O)O)=O,,,4,1,10,13,23
2302_1,,,,2,2,1,3
2304_0,,,,2,2,1,3
C(CO)(C(CO)C(C=O)O)=O,,,4,1,15,19,34
2304_1,,,,2,2,1,3
2306_0,,,,2,2,1,3
C(CO)(C(CO)C(CO)(CO)O)=O,,,4,1,8,9,17
2306_1,,,,2,2,1,3
2308_0,,,,2,2,1,3
C(C(C)(C(C(CO)=O)CO)O)=O,,,4,1,8,15,23
2308_1,,,,2,2,1,3
2310_0,,,,2,2,1,3
C(CO)(C(CO)C(C(C)=O)O)=O,,,4,1,9,15,24
2310_1,,,,2,2,1,3
2311_0,,,,2,2,1,3
2311_1,,,,2,2,1,3
2313_0,,,,2,2,1,3
C(CO)(C(CO)C(C)O)=O,,,4,1,10,19,29
2313_1,,,,2,2,1,3
2315_0,,,,2,2,1,3
C(CO)(C(CO)CO)=O,,,4,1,12,29,41
2315_1,,,,2,2,1,3
2317_0,,,,2,2,1,3
C(CO)(C(CO)C(CO)O)=O,,,4,1,11,14,25
2317_1,,,,2,2,1,3
2319_0,,,,2,2,1,3
C(C(CC(C(CCO)O)O)=O)(O)=O,,,4,1,3,11,14
2321_0,,,,2,2,1,3
C(C(C=O)C(C(CCO)O)O)(O)=O,,,4,1,6,14,20
2321_1,,,,2,2,1,3
2323_0,,,,2,2,1,3
C(CO)(C(C(C(CCO)O)O)O)=O,,,4,1,6,12,18
2323_1,,,,2,2,1,3
2325_0,,,,2,2,1,3
C(C(CC(C(CCO)O)O)=O)=O,,,4,1,2,15,17
2327_0,,,,2,2,1,3
C(C(C=O)C(C(CCO)O)O)=O,,,4,1,4,12,16
2327_1,,,,2,2,1,3
2329_0,,,,2,2,1,3
C(CC(C(CCO)O)O)=O,,,4,1,10,18,28
2331_0,,,,2,2,1,3
C(C(C(C(CCO)O)O)O)=O,,,4,1,9,15,24
2331_1,,,,2,2,1,3
2333_0,,,,2,2,1,3
C(C(CC(C)(C(CO)O)O)=O)(O)=O,,,4,1,3,12,15
2335_0,,,,2,2,1,3
C(C(C=O)C(C)(C(CO)O)O)(O)=O,,,4,1,6,14,20
2335_1,,,,2,2,1,3
2337_0,,,,2,2,1,3
C(CO)(C(C(C)(C(CO)O)O)O)=O,,,4,1,4,11,15
2337_1,,,,2,2,1,3
2339_0,,,,2,2,1,3
C(C(CC(C)(C(CO)O)O)=O)=O,,,4,1,2,16,18
2341_0,,,,2,2,1,3
C(C(C=O)C(C)(C(CO)O)O)=O,,,4,1,4,12,16
2341_1,,,,2,2,1,3
2343_0,,,,2,2,1,3
C(CC(C)(C(CO)O)O)=O,,,4,1,9,18,27
2345_0,,,,2,2,1,3
C(C(C(C)(C(CO)O)O)O)=O,,,4,1,7,14,21
2345_1,,,,2,2,1,3
2346_0,,,,2,2,1,3
2348_0,,,,2,2,1,3
C(C(C)(CC(C(CO)O)=O)O)(O)=O,,,4,1,6,12,18
2350_0,,,,2,2,1,3
C(CC(CC(C(CO)O)=O)O)(O)=O,,,4,1,5,10,15
2352_0,,,,2,2,1,3
C(C(C=C)(CC(C(CO)O)=O)O)=O,,,4,1,4,12,16
2354_0,,,,2,2,1,3
C(CC(C(C=C)=O)O)(C(CO)O)=O,,,4,1,4,15,19
2356_0,,,,2,2,1,3
C(CC(C=CC=O)O)(C(CO)O)=O,,,4,1,4,14,18
2358_0,,,,2,2,1,3
C(C(CO)O)(CC(C(CO)O)O)=O,,,4,1,8,13,21
2359_0,,,,2,2,1,3
2361_0,,,,2,2,1,3
C(C(CO)O)(CC(CO)(CO)O)=O,,,4,1,5,9,14
2363_0,,,,2,2,1,3
C(C(C)(CC(C(CO)O)=O)O)=O,,,4,1,4,15,19
2365_0,,,,2,2,1,3
C(CC(C(C)=O)O)(C(CO)O)=O,,,4,1,6,15,21
2366_0,,,,2,2,1,3
2368_0,,,,2,2,1,3
C(C(CO)O)(CC(C)O)=O,,,4,1,6,22,28
2369_0,,,,2,2,1,3
2371_0,,,,2,2,1,3
C(C(CO)O)(CC(CO)O)=O,,,4,1,9,15,24
2373_0,,,,2,2,1,3
C(C(CC(C(O)=O)=O)O)(O)=O,,,4,1,5,11,16
2375_0,,,,2,2,1,3
C(C(C=O)C(C(O)=O)O)(O)=O,,,4,1,7,13,20
2375_1,,,,2,2,1,3
2377_0,,,,2,2,1,3
C(C(C(C(C(O)=O)=O)CO)O)(O)=O,,,4,1,6,13,19
2377_1,,,,2,2,1,3
2379_0,,,,2,2,1,3
C(C(C(C=O)C(C(O)=O)O)O)(O)=O,,,4,1,3,8,11
2379_1,,,,2,2,1,3
2381_0,,,,2,2,1,3
C(C(C(CO)=O)C(C(O)=O)O)(O)=O,,,4,1,7,11,18
2381_1,,,,2,2,1,3
2383_0,,,,2,2,1,3
C(CC(C(C(C(O)=O)O)O)=O)(O)=O,,,4,1,6,13,19
2383_1,,,,2,2,1,3
2385_0,,,,2,2,1,3
C(C(C(CC(C(O)=O)O)=O)O)(O)=O,,,4,1,5,11,16
2387_0,,,,2,2,1,3
C(C(C1C(C(CO1)O)=O)O)(O)=O,,,4,1,3,6,9
2387_1,,,,2,2,1,3
2389_0,,,,2,2,1,3
C1(C(O)OCC1C(C(O)=O)O)=O,,,4,1,4,9,13
2389_1,,,,2,2,1,3
2391_0,,,,2,2,1,3
C1(COC(C1C(C(O)=O)O)O)=O,,,4,1,4,11,15
2391_1,,,,2,2,1,3
2393_0,,,,2,2,1,3
C(C(C1C(CC(O1)O)=O)O)(O)=O,,,4,1,4,9,13
2393_1,,,,2,2,1,3
2395_0,,,,2,2,1,3
C(C(C(C(CO)=O)O)O)(O)=O,,,4,1,12,16,28
2395_1,,,,2,2,1,3
2397_0,,,,2,2,1,3
C(C(C(C(O)=O)O)O)(C(CO)O)=O,,,4,1,8,15,23
2397_1,,,,2,2,1,3
2399_0,,,,2,2,1,3
C(C(CC(C=O)=O)O)(O)=O,,,4,1,8,22,30
2401_0,,,,2,2,1,3
C(C(C=O)C(C(O)=O)O)=O,,,4,1,9,15,24
2401_1,,,,2,2,1,3
2403_0,,,,2,2,1,3
C(C(C(C(C=O)=O)CO)O)(O)=O,,,4,1,6,17,23
2403_1,,,,2,2,1,3
2405_0,,,,2,2,1,3
C(C(C(C=O)C(C=O)O)O)(O)=O,,,4,1,6,17,23
2405_1,,,,2,2,1,3
2407_0,,,,2,2,1,3
C(C(C(CO)=O)C(C(O)=O)O)=O,,,4,1,7,13,20
2407_1,,,,2,2,1,3
2409_0,,,,2,2,1,3
C(CC(C(C(C(O)=O)O)O)=O)=O,,,4,1,7,17,24
2409_1,,,,2,2,1,3
2411_0,,,,2,2,1,3
C(C(C(CC(C(O)=O)O)=O)O)=O,,,4,1,4,13,17
2412_0,,,,2,2,1,3
2413_0,,,,2,2,1,3
2413_1,,,,2,2,1,3
2415_0,,,,2,2,1,3
C(C(C)(CC(C(O)=O)=O)O)(O)=O,,,4,1,3,9,12
2417_0,,,,2,2,1,3
C(C(C=O)C(C(O)=O)(C)O)(O)=O,,,4,1,7,12,19
2417_1,,,,2,2,1,3
2419_0,,,,2,2,1,3
C(C(C)(C1C(C(CO1)O)=O)O)(O)=O,,,4,1,3,7,10
2419_1,,,,2,2,1,3
2421_0,,,,2,2,1,3
C(C(C)(C1C(C(O)OC1)=O)O)(O)=O,,,4,1,4,9,13
2421_1,,,,2,2,1,3
2423_0,,,,2,2,1,3
C(C(C)(C1C(COC1O)=O)O)(O)=O,,,4,1,4,11,15
2423_1,,,,2,2,1,3
2425_0,,,,2,2,1,3
C(C(C)(C1C(CC(O1)O)=O)O)(O)=O,,,4,1,4,9,13
2425_1,,,,2,2,1,3
2427_0,,,,2,2,1,3
C(C(C)(C(C(CO)=O)O)O)(O)=O,,,4,1,5,10,15
2427_1,,,,2,2,1,3
2429_0,,,,2,2,1,3
C(C(C)(CC(C=O)=O)O)(O)=O,,,4,1,5,14,19
2431_0,,,,2,2,1,3
C(C(C=O)C(C(O)=O)(C)O)=O,,,4,1,6,10,16
2431_1,,,,2,2,1,3
2433_0,,,,2,2,1,3
C(C(C)(C(C(C=O)=O)CO)O)(O)=O,,,4,1,6,14,20
2433_1,,,,2,2,1,3
2435_0,,,,2,2,1,3
C(C(C)(C(C=O)C(C=O)O)O)(O)=O,,,4,1,6,15,21
2435_1,,,,2,2,1,3
2437_0,,,,2,2,1,3
C(C(C)(C(C=O)C(CO)=O)O)(O)=O,,,4,1,5,11,16
2437_1,,,,2,2,1,3
2439_0,,,,2,2,1,3
C(C(C)(C(C(CC=O)=O)O)O)(O)=O,,,4,1,5,12,17
2439_1,,,,2,2,1,3
2441_0,,,,2,2,1,3
C(C(C)(CC(C(C=O)O)=O)O)(O)=O,,,4,1,3,11,14
2443_0,,,,2,2,1,3
C(C(C)(CC=O)O)(O)=O,,,4,1,15,25,40
2445_0,,,,2,2,1,3
C(C(C)(C(C=O)O)O)(O)=O,,,4,1,11,17,28
2445_1,,,,2,2,1,3
2447_0,,,,2,2,1,3
C(CC(CC(C(O)=O)=O)O)(O)=O,,,4,1,4,8,12
2449_0,,,,2,2,1,3
C(C(CC1(COCC1O)O)=O)(O)=O,,,4,1,2,7,9
2451_0,,,,2,2,1,3
C(C(CC1(C(O)OCC1)O)=O)(O)=O,,,4,1,3,9,12
2453_0,,,,2,2,1,3
C(C(CC1(COC(C1)O)O)=O)(O)=O,,,4,1,3,9,12
2455_0,,,,2,2,1,3
C(C(C=C)(CC(C(O)=O)=O)O)=O,,,4,1,4,10,14
2457_0,,,,2,2,1,3
C=CC(C(CC(C(O)=O)=O)O)=O,,,4,1,4,10,14
2459_0,,,,2,2,1,3
C(C(CC(C(O)=O)=O)O)=CC=O,,,4,1,4,11,15
2460_0,,,,2,2,1,3
2462_0,,,,2,2,1,3
C(C(CC(C(O)=O)=O)O)=O,,,4,1,9,20,29
2464_0,,,,2,2,1,3
C(C(CC(CO)(CO)O)=O)(O)=O,,,4,1,4,8,12
2466_0,,,,2,2,1,3
C(C(C)(CC(C(O)=O)=O)O)=O,,,4,1,4,11,15
2468_0,,,,2,2,1,3
C(C)(C(CC(C(O)=O)=O)O)=O,,,4,1,9,13,22
2470_0,,,,2,2,1,3
C(CC(CC(C(O)=O)=O)O)=O,,,4,1,9,15,24
2472_0,,,,2,2,1,3
C(C(CCO)(CC(C(O)=O)=O)O)=O,,,4,1,4,11,15
2474_0,,,,2,2,1,3
C(C(CC(C(O)=O)=O)O)(CCO)=O,,,4,1,4,11,15
2476_0,,,,2,2,1,3
C(CC(C(CC(C(O)=O)=O)O)O)=O,,,4,1,4,16,20
2478_0,,,,2,2,1,3
C(C(CC(CC(C(O)=O)=O)O)O)=O,,,4,1,4,14,18
2480_0,,,,2,2,1,3
C(CO)(CC(CC(C(O)=O)=O)O)=O,,,4,1,4,11,15
2482_0,,,,2,2,1,3
C(CC(CO)(CC(C(O)=O)=O)O)=O,,,4,1,4,12,16
2484_0,,,,2,2,1,3
C(C)(C(C(CC(C(O)=O)=O)O)O)=O,,,4,1,5,13,18
2486_0,,,,2,2,1,3
C(C(C(C)(CC(C(O)=O)=O)O)O)=O,,,4,1,5,13,18
2488_0,,,,2,2,1,3
C(C(CC(C)O)=O)(O)=O,,,4,1,6,24,30
2489_0,,,,2,2,1,3
2490_0,,,,2,2,1,3
2492_0,,,,2,2,1,3
C(C(C=O)C(CC(O)=O)O)(O)=O,,,4,1,7,11,18
2492_1,,,,2,2,1,3
2494_0,,,,2,2,1,3
C(CC(C1C(C(CO1)O)=O)O)(O)=O,,,4,1,3,6,9
2494_1,,,,2,2,1,3
2496_0,,,,2,2,1,3
C(CC(C1C(C(O)OC1)=O)O)(O)=O,,,4,1,4,8,12
2496_1,,,,2,2,1,3
2498_0,,,,2,2,1,3
C(CC(C1C(COC1O)=O)O)(O)=O,,,4,1,4,10,14
2498_1,,,,2,2,1,3
2500_0,,,,2,2,1,3
C(CC(C1C(CC(O1)O)=O)O)(O)=O,,,4,1,4,7,11
2500_1,,,,2,2,1,3
2502_0,,,,2,2,1,3
C(CC(C(C(CO)=O)O)O)(O)=O,,,4,1,7,10,17
2502_1,,,,2,2,1,3
2504_0,,,,2,2,1,3
C(CC(CC(C=O)=O)O)(O)=O,,,4,1,6,15,21
2506_0,,,,2,2,1,3
C(C(C=O)C(CC(O)=O)O)=O,,,4,1,6,10,16
2506_1,,,,2,2,1,3
2508_0,,,,2,2,1,3
C(CC(C(C(C=O)=O)CO)O)(O)=O,,,4,1,6,14,20
2508_1,,,,2,2,1,3
2510_0,,,,2,2,1,3
C(CC(C(C=O)C(C=O)O)O)(O)=O,,,4,1,6,15,21
2510_1,,,,2,2,1,3
2512_0,,,,2,2,1,3
C(CC(C(C=O)C(CO)=O)O)(O)=O,,,4,1,5,10,15
2512_1,,,,2,2,1,3
2514_0,,,,2,2,1,3
C(CC(C(C(CC=O)=O)O)O)(O)=O,,,4,1,4,12,16
2514_1,,,,2,2,1,3
2516_0,,,,2,2,1,3
C(C(C(CC(CC(O)=O)O)=O)O)=O,,,4,1,3,10,13
2518_0,,,,2,2,1,3
C(CC(CC=O)O)(O)=O,,,4,1,15,31,46
2520_0,,,,2,2,1,3
C(CC(C(C=O)O)O)(O)=O,,,4,1,11,20,31
2520_1,,,,2,2,1,3
2522_0,,,,2,2,1,3
C(C(C=O)C1(COCC1O)O)(O)=O,,,4,1,5,9,14
2522_1,,,,2,2,1,3
2524_0,,,,2,2,1,3
C(C(C=O)C1(C(O)OCC1)O)(O)=O,,,4,1,6,11,17
2524_1,,,,2,2,1,3
2526_0,,,,2,2,1,3
C(C(C=O)C1(COC(C1)O)O)(O)=O,,,4,1,6,11,17
2526_1,,,,2,2,1,3
2528_0,,,,2,2,1,3
C(C(C=O)C(C=O)(C=C)O)(O)=O,,,4,1,8,13,21
2528_1,,,,2,2,1,3
2530_0,,,,2,2,1,3
C(C(C=O)C(C(C=C)=O)O)(O)=O,,,4,1,8,13,21
2530_1,,,,2,2,1,3
2532_0,,,,2,2,1,3
C(C(C=O)C(C=CC=O)O)(O)=O,,,4,1,8,13,21
2532_1,,,,2,2,1,3
2534_0,,,,2,2,1,3
C(C(C=O)C(C(CO)O)O)(O)=O,,,4,1,8,16,24
2534_1,,,,2,2,1,3
2536_0,,,,2,2,1,3
C(C(C=O)C(C=O)O)(O)=O,,,4,1,12,20,32
2536_1,,,,2,2,1,3
2538_0,,,,2,2,1,3
C(C(C=O)C(CO)(CO)O)(O)=O,,,4,1,7,11,18
2538_1,,,,2,2,1,3
2540_0,,,,2,2,1,3
C(C(C=O)C(C=O)(C)O)(O)=O,,,4,1,6,13,19
2540_1,,,,2,2,1,3
2542_0,,,,2,2,1,3
C(C(C=O)C(C(C)=O)O)(O)=O,,,4,1,10,15,25
2542_1,,,,2,2,1,3
2544_0,,,,2,2,1,3
C(C(C=O)C(CC=O)O)(O)=O,,,4,1,9,17,26
2544_1,,,,2,2,1,3
2546_0,,,,2,2,1,3
C(C(C=O)C(C=O)(CCO)O)(O)=O,,,4,1,7,13,20
2546_1,,,,2,2,1,3
2548_0,,,,2,2,1,3
C(C(C=O)C(C(CCO)=O)O)(O)=O,,,4,1,7,14,21
2548_1,,,,2,2,1,3
2550_0,,,,2,2,1,3
C(C(C=O)C(C(CC=O)O)O)(O)=O,,,4,1,7,18,25
2550_1,,,,2,2,1,3
2552_0,,,,2,2,1,3
C(C(C=O)C(CC(C=O)O)O)(O)=O,,,4,1,7,16,23
2552_1,,,,2,2,1,3
2554_0,,,,2,2,1,3
C(C(C=O)C(CC(CO)=O)O)(O)=O,,,4,1,6,14,20
2554_1,,,,2,2,1,3
2556_0,,,,2,2,1,3
C(C(C=O)C(CO)(CC=O)O)(O)=O,,,4,1,7,14,21
2556_1,,,,2,2,1,3
2558_0,,,,2,2,1,3
C(C(C=O)C(C(C(C)=O)O)O)(O)=O,,,4,1,6,15,21
2558_1,,,,2,2,1,3
2560_0,,,,2,2,1,3
C(C(C=O)C(C)(C(C=O)O)O)(O)=O,,,4,1,6,15,21
2560_1,,,,2,2,1,3
2562_0,,,,2,2,1,3
C(C(C=O)C(C)O)(O)=O,,,4,1,6,21,27
2562_1,,,,2,2,1,3
2564_0,,,,2,2,1,3
C(C(C=O)CO)(O)=O,,,4,1,6,43,49
2564_1,,,,2,2,1,3
2566_0,,,,2,2,1,3
C(C(C=O)C(CO)O)(O)=O,,,4,1,7,16,23
2566_1,,,,2,2,1,3
2568_0,,,,2,2,1,3
C(C(CCO)(CC(C=O)=O)O)(O)=O,,,4,1,2,12,14
2570_0,,,,2,2,1,3
C(C(C=O)C(C(O)=O)(CCO)O)=O,,,4,1,3,10,13
2570_1,,,,2,2,1,3
2572_0,,,,2,2,1,3
C(C(CCO)(CC=O)O)(O)=O,,,4,1,6,13,19
2574_0,,,,2,2,1,3
C(C(CCO)(C(C=O)O)O)(O)=O,,,4,1,5,13,18
2574_1,,,,2,2,1,3
2576_0,,,,2,2,1,3
C(C(C(C(C(O)=O)=O)CO)O)=O,,,4,1,5,15,20
2576_1,,,,2,2,1,3
2578_0,,,,2,2,1,3
C(C(C)(C(C(C(O)=O)=O)CO)O)=O,,,4,1,5,13,18
2578_1,,,,2,2,1,3
2580_0,,,,2,2,1,3
C(C(C(C(C(O)=O)=O)CO)O)(C)=O,,,4,1,5,13,18
2580_1,,,,2,2,1,3
2582_0,,,,2,2,1,3
C(CC(C(C(C(O)=O)=O)CO)O)=O,,,4,1,5,14,19
2582_1,,,,2,2,1,3
2584_0,,,,2,2,1,3
C(C(C(CO)C(C)O)=O)(O)=O,,,4,1,5,12,17
2584_1,,,,2,2,1,3
2586_0,,,,2,2,1,3
C(C(C(CO)CO)=O)(O)=O,,,4,1,4,10,14
2586_1,,,,2,2,1,3
2588_0,,,,2,2,1,3
C(C(C(CO)C(CO)O)=O)(O)=O,,,4,1,8,14,22
2588_1,,,,2,2,1,3
2590_0,,,,2,2,1,3
C(C(CC(CC(C=O)=O)O)O)(O)=O,,,4,1,2,13,15
2592_0,,,,2,2,1,3
C(C(C=O)C(CC(C(O)=O)O)O)=O,,,4,1,3,11,14
2592_1,,,,2,2,1,3
2594_0,,,,2,2,1,3
C(CC(CC(C(O)=O)O)O)=O,,,4,1,7,15,22
2596_0,,,,2,2,1,3
C(C(CC(C(C=O)O)O)O)(O)=O,,,4,1,7,15,22
2596_1,,,,2,2,1,3
2597_0,,,,2,2,1,3
2597_1,,,,2,2,1,3
2598_0,,,,2,2,1,3
2598_1,,,,2,2,1,3
2599_0,,,,2,2,1,3
2599_1,,,,2,2,1,3
2600_0,,,,2,2,1,3
2600_1,,,,2,2,1,3
2601_0,,,,2,2,1,3
2601_1,,,,2,2,1,3
2602_0,,,,2,2,1,3
2602_1,,,,2,2,1,3
2603_0,,,,2,2,1,3
2603_1,,,,2,2,1,3
2605_0,,,,2,2,1,3
C(CC(C(CC(C=O)=O)O)O)(O)=O,,,4,1,2,13,15
2607_0,,,,2,2,1,3
C(C(C=O)C(C(CC(O)=O)O)O)=O,,,4,1,3,11,14
2607_1,,,,2,2,1,3
2609_0,,,,2,2,1,3
C(CC(C(CC=O)O)O)(O)=O,,,4,1,5,15,20
2611_0,,,,2,2,1,3
C(CC(C(C(C=O)O)O)O)(O)=O,,,4,1,6,15,21
2611_1,,,,2,2,1,3
2613_0,,,,2,2,1,3
C(CC(CO)(CC(C=O)=O)O)(O)=O,,,4,1,2,12,14
2615_0,,,,2,2,1,3
C(C(C=O)C(CO)(CC(O)=O)O)=O,,,4,1,3,9,12
2615_1,,,,2,2,1,3
2617_0,,,,2,2,1,3
C(CC(CO)(CC=O)O)(O)=O,,,4,1,6,13,19
2619_0,,,,2,2,1,3
C(CC(CO)(C(C=O)O)O)(O)=O,,,4,1,4,12,16
2619_1,,,,2,2,1,3
2621_0,,,,2,2,1,3
C(C(C(CO)=O)C(C=O)O)(O)=O,,,4,1,7,15,22
2621_1,,,,2,2,1,3
2623_0,,,,2,2,1,3
C(C(C)(C(C(O)=O)C(CO)=O)O)=O,,,4,1,6,13,19
2623_1,,,,2,2,1,3
2625_0,,,,2,2,1,3
C(C(C(CO)=O)C(C(C)=O)O)(O)=O,,,4,1,6,13,19
2625_1,,,,2,2,1,3
2627_0,,,,2,2,1,3
C(CC(C(C(O)=O)C(CO)=O)O)=O,,,4,1,6,14,20
2627_1,,,,2,2,1,3
2629_0,,,,2,2,1,3
C(C(C(CO)=O)C(C)O)(O)=O,,,4,1,9,12,21
2629_1,,,,2,2,1,3
2631_0,,,,2,2,1,3
C(C(C(CO)=O)CO)(O)=O,,,4,1,10,18,28
2631_1,,,,2,2,1,3
2633_0,,,,2,2,1,3
C(C(C(CO)=O)C(CO)O)(O)=O,,,4,1,9,12,21
2633_1,,,,2,2,1,3
2635_0,,,,2,2,1,3
C(CC(C(C(C=O)O)O)=O)(O)=O,,,4,1,7,18,25
2635_1,,,,2,2,1,3
2637_0,,,,2,2,1,3
C(C(C)(C(C(CC(O)=O)=O)O)O)=O,,,4,1,5,15,20
2637_1,,,,2,2,1,3
2639_0,,,,2,2,1,3
C(CC(C(C(C(C)=O)O)O)=O)(O)=O,,,4,1,6,16,22
2639_1,,,,2,2,1,3
2641_0,,,,2,2,1,3
C(CC(C(C(CC(O)=O)=O)O)O)=O,,,4,1,4,15,19
2641_1,,,,2,2,1,3
2643_0,,,,2,2,1,3
C(CC(C(C(C)O)O)=O)(O)=O,,,4,1,8,15,23
2643_1,,,,2,2,1,3
2644_0,,,,2,2,1,3
2644_1,,,,2,2,1,3
2645_0,,,,2,2,1,3
2645_1,,,,2,2,1,3
2647_0,,,,2,2,1,3
C(C(C(C)(CC(C=O)=O)O)O)(O)=O,,,4,1,3,14,17
2649_0,,,,2,2,1,3
C(C(C=O)C(C)(C(C(O)=O)O)O)=O,,,4,1,4,10,14
2649_1,,,,2,2,1,3
2651_0,,,,2,2,1,3
C(CC(C)(C(C(O)=O)O)O)=O,,,4,1,6,15,21
2652_0,,,,2,2,1,3
2652_1,,,,2,2,1,3
2654_0,,,,2,2,1,3
C(C(C(CC(C=O)O)=O)O)(O)=O,,,4,1,5,15,20
2656_0,,,,2,2,1,3
C(C(C)(CC(C(C(O)=O)O)=O)O)=O,,,4,1,4,13,17
2658_0,,,,2,2,1,3
C(C(C(CC(C(C)=O)O)=O)O)(O)=O,,,4,1,4,13,17
2660_0,,,,2,2,1,3
C(C(C(CC(CC=O)O)=O)O)(O)=O,,,4,1,4,13,17
2662_0,,,,2,2,1,3
C(C(C(CC(C)O)=O)O)(O)=O,,,4,1,7,13,20
2663_0,,,,2,2,1,3
2664_0,,,,2,2,1,3
2666_0,,,,2,2,1,3
C(CCO)(C(C=O)(C(C=O)O)O)=O,,,4,1,5,15,20
2668_0,,,,2,2,1,3
C(CC(C(CO)(C(C=O)O)O)O)=O,,,4,1,9,19,28
2669_0,,,,2,2,1,3
2671_0,,,,2,2,1,3
C(C(CO)O)(C(CO)(C(C)O)O)=O,,,4,1,8,14,22
2671_1,,,,2,2,1,3
2673_0,,,,2,2,1,3
C(CC(CO)(C(CO)(CO)O)O)=O,,,4,1,5,8,13
2675_0,,,,2,2,1,3
C(C(C(C)O)O)(C(CO)(CO)O)=O,,,4,1,5,10,15
2675_1,,,,2,2,1,3
2677_0,,,,2,2,1,3
C(C(CO)O)(C(CO)(CO)O)=O,,,4,1,7,9,16
2677_1,,,,2,2,1,3
2678_0,,,,2,2,1,3
2680_0,,,,2,2,1,3
C(C(CO)C(C(C=O)(CO)O)O)=O,,,4,1,9,19,28
2680_1,,,,2,2,1,3
2682_0,,,,2,2,1,3
C(CC(C(C(C)=O)(C(C)O)O)O)=O,,,4,1,5,15,20
2684_0,,,,2,2,1,3
C(C(C(C)O)(C(C)(CC=O)O)O)=O,,,4,1,5,15,20
2686_0,,,,2,2,1,3
C(C(C(CC(C)O)=O)(C(C)O)O)=O,,,4,1,3,10,13
2688_0,,,,2,2,1,3
C(C(C(CCO)=O)(C(C)O)O)=O,,,4,1,4,11,15
2690_0,,,,2,2,1,3
C(CC(C(C(C)=O)(CO)O)O)=O,,,4,1,8,17,25
2692_0,,,,2,2,1,3
C(C(C(C(C(C)=O)(CO)O)O)O)=O,,,4,1,8,18,26
2692_1,,,,2,2,1,3
2694_0,,,,2,2,1,3
C(C(CO)(C(C)(CC=O)O)O)=O,,,4,1,6,17,23
2695_0,,,,2,2,1,3
2695_1,,,,2,2,1,3
2697_0,,,,2,2,1,3
C(CC(C=O)O)(C(C=O)(CO)O)=O,,,4,1,3,13,16
2699_0,,,,2,2,1,3
C(C(C(CC(C)O)=O)(CO)O)=O,,,4,1,4,11,15
2700_0,,,,2,2,1,3
2702_0,,,,2,2,1,3
C(C(C(CC(CO)O)=O)(CO)O)=O,,,4,1,7,12,19
2704_0,,,,2,2,1,3
C(C(C(CCO)=O)(C(CO)O)O)=O,,,4,1,7,12,19
2706_0,,,,2,2,1,3
C(CC(C(CO)(C(C)O)O)O)=O,,,4,1,4,12,16
2708_0,,,,2,2,1,3
C(C(C(C(CO)(C(C)O)O)O)O)=O,,,4,1,5,13,18
2708_1,,,,2,2,1,3
2710_0,,,,2,2,1,3
C(C(C(C=O)(C(C=O)CO)O)O)=O,,,4,1,8,18,26
2710_1,,,,2,2,1,3
2711_0,,,,2,2,1,3
2713_0,,,,2,2,1,3
C(C(C(C(C(C=O)O)O)O)O)(O)=O,,,4,1,8,19,27
2713_1,,,,2,2,1,3
2715_0,,,,2,2,1,3
C(CC(C(C)(C(C(O)=O)O)O)O)=O,,,4,1,5,14,19
2717_0,,,,2,2,1,3
C(CC(C)(C(C(C(O)=O)O)O)O)=O,,,4,1,3,15,18
2719_0,,,,2,2,1,3
C(C(C(C(O)=O)O)O)(CC(C)O)=O,,,4,1,5,12,17
2720_0,,,,2,2,1,3
2722_0,,,,2,2,1,3
C(CC(CC(C(C(O)=O)O)O)O)=O,,,4,1,5,14,19
2724_0,,,,2,2,1,3
C(C(C(C(C(O)=O)O)O)C(C)O)=O,,,4,1,6,15,21
2724_1,,,,2,2,1,3
2726_0,,,,2,2,1,3
C(C(CO)C(C(C(O)=O)O)O)=O,,,4,1,7,16,23
2726_1,,,,2,2,1,3
2728_0,,,,2,2,1,3
C(CC(C(CC=O)O)(C(C)O)O)=O,,,4,1,2,17,19
2730_0,,,,2,2,1,3
C(C(C(C)O)(CC(CC=O)O)O)=O,,,4,1,2,15,17
2731_0,,,,2,2,1,3
2731_1,,,,2,2,1,3
2732_0,,,,2,2,1,3
2732_1,,,,2,2,1,3
2734_0,,,,2,2,1,3
C(CC(C(CO)(CC=O)O)O)=O,,,4,1,6,20,26
2735_0,,,,2,2,1,3
2735_1,,,,2,2,1,3
2737_0,,,,2,2,1,3
C(C(CO)(CC(CC=O)O)O)=O,,,4,1,2,17,19
2739_0,,,,2,2,1,3
C(C(CO)(CC(C(C=O)O)O)O)=O,,,4,1,6,18,24
2739_1,,,,2,2,1,3
2740_0,,,,2,2,1,3
2740_1,,,,2,2,1,3
2741_0,,,,2,2,1,3
2741_1,,,,2,2,1,3
2742_0,,,,2,2,1,3
2742_1,,,,2,2,1,3
2743_0,,,,2,2,1,3
2743_1,,,,2,2,1,3
2744_0,,,,2,2,1,3
2744_1,,,,2,2,1,3
2745_0,,,,2,2,1,3
2746_0,,,,2,2,1,3
2746_1,,,,2,2,1,3
2748_0,,,,2,2,1,3
C(CC(CO)(CC(C=O)O)O)=O,,,4,1,3,18,21
2750_0,,,,2,2,1,3
C(C(CC(CO)(C(C=O)O)O)O)=O,,,4,1,3,18,21
2750_1,,,,2,2,1,3
2752_0,,,,2,2,1,3
C(C(C(C(CO)=O)C(C=O)O)O)=O,,,4,1,3,10,13
2752_1,,,,2,2,1,3
2754_0,,,,2,2,1,3
C(CO)(C(C(C)O)C(C=O)O)=O,,,4,1,5,16,21
2754_1,,,,2,2,1,3
2755_0,,,,2,2,1,3
2755_1,,,,2,2,1,3
2757_0,,,,2,2,1,3
C(CO)(C(C(CO)O)C(C=O)O)=O,,,4,1,6,17,23
2757_1,,,,2,2,1,3
2758_0,,,,2,2,1,3
2758_1,,,,2,2,1,3
2760_0,,,,2,2,1,3
C(CC(C=O)O)(C(C(C)O)O)=O,,,4,1,3,16,19
2760_1,,,,2,2,1,3
2761_0,,,,2,2,1,3
2761_1,,,,2,2,1,3
2763_0,,,,2,2,1,3
C(CC(C=O)O)(C(C(CO)O)O)=O,,,4,1,7,16,23
2763_1,,,,2,2,1,3
2765_0,,,,2,2,1,3
C(C(CO)C(C=O)O)(C(CO)O)=O,,,4,1,8,18,26
2765_1,,,,2,2,1,3
2766_0,,,,2,2,1,3
2766_1,,,,2,2,1,3
2767_0,,,,2,2,1,3
2767_1,,,,2,2,1,3
2769_0,,,,2,2,1,3
C(C(C(C(CO)CO)=O)(CO)O)=O,,,4,1,5,9,14
2769_1,,,,2,2,1,3
2771_0,,,,2,2,1,3
C(C(CC(CO)O)(CC=O)O)(O)=O,,,4,1,3,13,16
2773_0,,,,2,2,1,3
C(C(C(C(CO)O)C(C)O)=O)(O)=O,,,4,1,5,14,19
2773_1,,,,2,2,1,3
2774_0,,,,2,2,1,3
2774_1,,,,2,2,1,3
2776_0,,,,2,2,1,3
C(CC(CO)(CC(C(O)=O)O)O)=O,,,4,1,5,13,18
2778_0,,,,2,2,1,3
C(CO)(C(C(C)O)C(C(O)=O)O)=O,,,4,1,6,12,18
2778_1,,,,2,2,1,3
2779_0,,,,2,2,1,3
2779_1,,,,2,2,1,3
2781_0,,,,2,2,1,3
C(CC(C(O)=O)O)(C(C(C)O)O)=O,,,4,1,4,12,16
2781_1,,,,2,2,1,3
2782_0,,,,2,2,1,3
2782_1,,,,2,2,1,3
2784_0,,,,2,2,1,3
C(CC(C(CO)O)(CC=O)O)(O)=O,,,4,1,2,12,14
2786_0,,,,2,2,1,3
C(C(C(C(CO)O)=O)C(C)O)(O)=O,,,4,1,7,13,20
2786_1,,,,2,2,1,3
2788_0,,,,2,2,1,3
C(C(C(C(CO)O)=O)CO)(O)=O,,,4,1,10,13,23
2788_1,,,,2,2,1,3
2790_0,,,,2,2,1,3
C(CC(CCO)(C(C(O)=O)O)O)=O,,,4,1,3,12,15
2792_0,,,,2,2,1,3
C(C(C(C(CO)C(C)O)=O)O)(O)=O,,,4,1,7,13,20
2792_1,,,,2,2,1,3
2794_0,,,,2,2,1,3
C(C(C(C(CO)CO)=O)O)(O)=O,,,4,1,6,9,15
2794_1,,,,2,2,1,3
2796_0,,,,2,2,1,3
C(CO)(C(C1(COCC1O)O)O)=O,,,4,1,3,7,10
2796_1,,,,2,2,1,3
2798_0,,,,2,2,1,3
C(C(CC1(COCC1O)O)=O)=O,,,4,1,1,11,12
2800_0,,,,2,2,1,3
C(C(C=O)C1(COCC1O)O)=O,,,4,1,3,8,11
2800_1,,,,2,2,1,3
2802_0,,,,2,2,1,3
C(CC1(COCC1O)O)=O,,,4,1,8,14,22
2804_0,,,,2,2,1,3
C(C(C1(COCC1O)O)O)=O,,,4,1,5,10,15
2804_1,,,,2,2,1,3
2806_0,,,,2,2,1,3
C(C(C=C)(C1C(C(CO1)O)=O)O)=O,,,4,1,2,7,9
2806_1,,,,2,2,1,3
2808_0,,,,2,2,1,3
C1(C(C(C(C=C)=O)O)OCC1O)=O,,,4,1,2,10,12
2808_1,,,,2,2,1,3
2810_0,,,,2,2,1,3
C1(C(C(C=CC=O)O)OCC1O)=O,,,4,1,2,10,12
2810_1,,,,2,2,1,3
2812_0,,,,2,2,1,3
C1(C(C(C(CO)O)O)OCC1O)=O,,,4,1,4,9,13
2812_1,,,,2,2,1,3
2814_0,,,,2,2,1,3
C(C(C1C(C(CO1)O)=O)O)=O,,,4,1,5,15,20
2814_1,,,,2,2,1,3
2816_0,,,,2,2,1,3
C1(C(C(CO)(CO)O)OCC1O)=O,,,4,1,3,5,8
2816_1,,,,2,2,1,3
2818_0,,,,2,2,1,3
C(C(C)(C1C(C(CO1)O)=O)O)=O,,,4,1,2,9,11
2818_1,,,,2,2,1,3
2820_0,,,,2,2,1,3
C(C(C1C(C(CO1)O)=O)O)(C)=O,,,4,1,3,9,12
2820_1,,,,2,2,1,3
2822_0,,,,2,2,1,3
C(CC(C1C(C(CO1)O)=O)O)=O,,,4,1,3,11,14
2822_1,,,,2,2,1,3
2824_0,,,,2,2,1,3
C1(C(C(C)O)OCC1O)=O,,,4,1,2,17,19
2824_1,,,,2,2,1,3
2826_0,,,,2,2,1,3
C1(C(CO)OCC1O)=O,,,4,1,4,34,38
2826_1,,,,2,2,1,3
2828_0,,,,2,2,1,3
C1(C(C(CO)O)OCC1O)=O,,,4,1,5,10,15
2828_1,,,,2,2,1,3
2830_0,,,,2,2,1,3
C(CO)(C(C1(C(O)OCC1)O)O)=O,,,4,1,4,9,13
2830_1,,,,2,2,1,3
2832_0,,,,2,2,1,3
C(C(CC1(C(O)OCC1)O)=O)=O,,,4,1,2,13,15
2834_0,,,,2,2,1,3
C(C(C=O)C1(C(O)OCC1)O)=O,,,4,1,4,10,14
2834_1,,,,2,2,1,3
2836_0,,,,2,2,1,3
C(CC1(C(O)OCC1)O)=O,,,4,1,9,16,25
2838_0,,,,2,2,1,3
C(C(C1(C(O)OCC1)O)O)=O,,,4,1,6,12,18
2838_1,,,,2,2,1,3
2840_0,,,,2,2,1,3
C(C(C=C)(C1C(C(O)OC1)=O)O)=O,,,4,1,3,8,11
2840_1,,,,2,2,1,3
2842_0,,,,2,2,1,3
C1(C(O)OCC1C(C(C=C)=O)O)=O,,,4,1,3,11,14
2842_1,,,,2,2,1,3
2844_0,,,,2,2,1,3
C1(C(O)OCC1C(C=CC=O)O)=O,,,4,1,3,9,12
2844_1,,,,2,2,1,3
2846_0,,,,2,2,1,3
C1(C(O)OCC1C(C(CO)O)O)=O,,,4,1,5,11,16
2846_1,,,,2,2,1,3
2848_0,,,,2,2,1,3
C1(C(O)OCC1C(C=O)O)=O,,,4,1,5,14,19
2848_1,,,,2,2,1,3
2850_0,,,,2,2,1,3
C1(C(O)OCC1C(CO)(CO)O)=O,,,4,1,4,7,11
2850_1,,,,2,2,1,3
2852_0,,,,2,2,1,3
C(C(C)(C1C(C(O)OC1)=O)O)=O,,,4,1,3,11,14
2852_1,,,,2,2,1,3
2854_0,,,,2,2,1,3
C(C(C1C(C(O)OC1)=O)O)(C)=O,,,4,1,4,11,15
2854_1,,,,2,2,1,3
2856_0,,,,2,2,1,3
C(CC(C1C(C(O)OC1)=O)O)=O,,,4,1,4,13,17
2856_1,,,,2,2,1,3
2858_0,,,,2,2,1,3
C1(C(O)OCC1C(C)O)=O,,,4,1,3,14,17
2858_1,,,,2,2,1,3
2860_0,,,,2,2,1,3
C1(C(O)OCC1CO)=O,,,4,1,4,25,29
2860_1,,,,2,2,1,3
2862_0,,,,2,2,1,3
C1(C(O)OCC1C(CO)O)=O,,,4,1,5,11,16
2862_1,,,,2,2,1,3
2864_0,,,,2,2,1,3
C(CO)(C(C1(COC(C1)O)O)O)=O,,,4,1,4,9,13
2864_1,,,,2,2,1,3
2866_0,,,,2,2,1,3
C(C(CC1(COC(C1)O)O)=O)=O,,,4,1,2,13,15
2868_0,,,,2,2,1,3
C(C(C=O)C1(COC(C1)O)O)=O,,,4,1,4,10,14
2868_1,,,,2,2,1,3
2870_0,,,,2,2,1,3
C(CC1(COC(C1)O)O)=O,,,4,1,10,16,26
2872_0,,,,2,2,1,3
C(C(C1(COC(C1)O)O)O)=O,,,4,1,6,12,18
2872_1,,,,2,2,1,3
2874_0,,,,2,2,1,3
C(C(C=C)(C1C(COC1O)=O)O)=O,,,4,1,3,11,14
2874_1,,,,2,2,1,3
2876_0,,,,2,2,1,3
C1(COC(C1C(C(C=C)=O)O)O)=O,,,4,1,3,14,17
2876_1,,,,2,2,1,3
2878_0,,,,2,2,1,3
C1(COC(C1C(C=CC=O)O)O)=O,,,4,1,3,12,15
2878_1,,,,2,2,1,3
2880_0,,,,2,2,1,3
C1(COC(C1C(C(CO)O)O)O)=O,,,4,1,5,13,18
2880_1,,,,2,2,1,3
2882_0,,,,2,2,1,3
C1(COC(C1C(C=O)O)O)=O,,,4,1,6,18,24
2882_1,,,,2,2,1,3
2884_0,,,,2,2,1,3
C1(COC(C1C(CO)(CO)O)O)=O,,,4,1,4,9,13
2884_1,,,,2,2,1,3
2886_0,,,,2,2,1,3
C(C(C)(C1C(COC1O)=O)O)=O,,,4,1,4,14,18
2886_1,,,,2,2,1,3
2888_0,,,,2,2,1,3
C1(COC(C1C(C(C)=O)O)O)=O,,,4,1,5,14,19
2888_1,,,,2,2,1,3
2890_0,,,,2,2,1,3
C(CC(C1C(COC1O)=O)O)=O,,,4,1,5,16,21
2890_1,,,,2,2,1,3
2892_0,,,,2,2,1,3
C1(COC(C1C(C)O)O)=O,,,4,1,4,19,23
2892_1,,,,2,2,1,3
2894_0,,,,2,2,1,3
C1(COC(C1CO)O)=O,,,4,1,6,33,39
2894_1,,,,2,2,1,3
2896_0,,,,2,2,1,3
C1(COC(C1C(CO)O)O)=O,,,4,1,5,14,19
2896_1,,,,2,2,1,3
2898_0,,,,2,2,1,3
C(C(C=C)(C1C(CC(O1)O)=O)O)=O,,,4,1,3,9,12
2898_1,,,,2,2,1,3
2900_0,,,,2,2,1,3
C1(C(C(C(C=C)=O)O)OC(C1)O)=O,,,4,1,3,12,15
2900_1,,,,2,2,1,3
2902_0,,,,2,2,1,3
C1(C(C(C=CC=O)O)OC(C1)O)=O,,,4,1,3,12,15
2902_1,,,,2,2,1,3
2904_0,,,,2,2,1,3
C1(C(C(C(CO)O)O)OC(C1)O)=O,,,4,1,5,11,16
2904_1,,,,2,2,1,3
2906_0,,,,2,2,1,3
C(C(C1C(CC(O1)O)=O)O)=O,,,4,1,6,18,24
2906_1,,,,2,2,1,3
2908_0,,,,2,2,1,3
C1(C(C(CO)(CO)O)OC(C1)O)=O,,,4,1,4,7,11
2908_1,,,,2,2,1,3
2910_0,,,,2,2,1,3
C(C(C)(C1C(CC(O1)O)=O)O)=O,,,4,1,3,12,15
2910_1,,,,2,2,1,3
2912_0,,,,2,2,1,3
C(C(C1C(CC(O1)O)=O)O)(C)=O,,,4,1,4,12,16
2912_1,,,,2,2,1,3
2914_0,,,,2,2,1,3
C(CC(C1C(CC(O1)O)=O)O)=O,,,4,1,4,13,17
2914_1,,,,2,2,1,3
2916_0,,,,2,2,1,3
C1(C(C(C)O)OC(C1)O)=O,,,4,1,3,20,23
2916_1,,,,2,2,1,3
2918_0,,,,2,2,1,3
C1(C(CO)OC(C1)O)=O,,,4,1,6,37,43
2918_1,,,,2,2,1,3
2920_0,,,,2,2,1,3
C1(C(C(CO)O)OC(C1)O)=O,,,4,1,5,13,18
2920_1,,,,2,2,1,3
2922_0,,,,2,2,1,3
C(C(C=C)(C(C(CO)=O)O)O)=O,,,4,1,6,14,20
2922_1,,,,2,2,1,3
2924_0,,,,2,2,1,3
C(C(C=C)(CC(C=O)=O)O)=O,,,4,1,6,14,20
2926_0,,,,2,2,1,3
C(C(C=O)C(C=O)(C=C)O)=O,,,4,1,7,11,18
2926_1,,,,2,2,1,3
2928_0,,,,2,2,1,3
C(C(C=C)(C(C(C=O)=O)CO)O)=O,,,4,1,5,11,16
2928_1,,,,2,2,1,3
2930_0,,,,2,2,1,3
C(C(C=C)(C(C=O)C(C=O)O)O)=O,,,4,1,5,12,17
2930_1,,,,2,2,1,3
2932_0,,,,2,2,1,3
C(C(C(CO)=O)C(C=O)(C=C)O)=O,,,4,1,4,10,14
2932_1,,,,2,2,1,3
2934_0,,,,2,2,1,3
C(C(C=C)(C(C(CC=O)=O)O)O)=O,,,4,1,4,12,16
2934_1,,,,2,2,1,3
2936_0,,,,2,2,1,3
C(C(C=C)(CC(C(C=O)O)=O)O)=O,,,4,1,2,10,12
2938_0,,,,2,2,1,3
C(C(C=C)(CC=O)O)=O,,,4,1,15,35,50
2940_0,,,,2,2,1,3
C(C(C=C)(C(C=O)O)O)=O,,,4,1,11,20,31
2940_1,,,,2,2,1,3
2942_0,,,,2,2,1,3
C(CO)(C(C(C(C=C)=O)O)O)=O,,,4,1,7,16,23
2942_1,,,,2,2,1,3
2944_0,,,,2,2,1,3
C=CC(C(CC(C=O)=O)O)=O,,,4,1,6,16,22
2946_0,,,,2,2,1,3
C(C(C=O)C(C(C=C)=O)O)=O,,,4,1,7,13,20
2946_1,,,,2,2,1,3
2948_0,,,,2,2,1,3
C=CC(C(C(C(C=O)=O)CO)O)=O,,,4,1,5,13,18
2948_1,,,,2,2,1,3
2950_0,,,,2,2,1,3
C(C(C(C=O)C(C(C=C)=O)O)O)=O,,,4,1,5,14,19
2950_1,,,,2,2,1,3
2952_0,,,,2,2,1,3
C(C(C(CO)=O)C(C(C=C)=O)O)=O,,,4,1,4,12,16
2952_1,,,,2,2,1,3
2954_0,,,,2,2,1,3
C(CC(C(C(C(C=C)=O)O)O)=O)=O,,,4,1,5,17,22
2954_1,,,,2,2,1,3
2956_0,,,,2,2,1,3
C(C(C(CC(C(C=C)=O)O)=O)O)=O,,,4,1,2,13,15
2958_0,,,,2,2,1,3
C(CC(C(C=C)=O)O)=O,,,4,1,15,54,69
2960_0,,,,2,2,1,3
C(C(C(C(C=C)=O)O)O)=O,,,4,1,12,31,43
2960_1,,,,2,2,1,3
2962_0,,,,2,2,1,3
C(CO)(C(C(C=CC=O)O)O)=O,,,4,1,6,15,21
2962_1,,,,2,2,1,3
2964_0,,,,2,2,1,3
C(C(CC(C=O)=O)O)=CC=O,,,4,1,6,17,23
2966_0,,,,2,2,1,3
C(C(C=O)C(C=CC=O)O)=O,,,4,1,7,13,20
2966_1,,,,2,2,1,3
2968_0,,,,2,2,1,3
C(C(C(C(C=O)=O)CO)O)=CC=O,,,4,1,5,11,16
2968_1,,,,2,2,1,3
2970_0,,,,2,2,1,3
C(C(C(C=O)C(C=CC=O)O)O)=O,,,4,1,5,13,18
2970_1,,,,2,2,1,3
2972_0,,,,2,2,1,3
C(C(C(CO)=O)C(C=CC=O)O)=O,,,4,1,4,11,15
2972_1,,,,2,2,1,3
2974_0,,,,2,2,1,3
C(CC(C(C(C=CC=O)O)O)=O)=O,,,4,1,3,14,17
2974_1,,,,2,2,1,3
2976_0,,,,2,2,1,3
C(C(C(CC(C=CC=O)O)=O)O)=O,,,4,1,2,12,14
2978_0,,,,2,2,1,3
C(CC(C=CC=O)O)=O,,,4,1,15,48,63
2980_0,,,,2,2,1,3
C(C(C(C=CC=O)O)O)=O,,,4,1,12,25,37
2980_1,,,,2,2,1,3
2982_0,,,,2,2,1,3
C(C(CC(C=O)O)O)(O)=O,,,4,1,6,16,22
2982_1,,,,2,2,1,3
2984_0,,,,2,2,1,3
C(C(C(CO)C(C=O)O)O)(O)=O,,,4,1,7,12,19
2984_1,,,,2,2,1,3
2986_0,,,,2,2,1,3
C(C(CC(CO)(CO)O)O)(O)=O,,,4,1,2,6,8
2986_1,,,,2,2,1,3
2988_0,,,,2,2,1,3
C(C(C)(CC(C(O)=O)O)O)=O,,,4,1,2,10,12
2988_1,,,,2,2,1,3
2990_0,,,,2,2,1,3
C(C(C)(C(CO)C(C(O)=O)O)O)=O,,,4,1,4,11,15
2990_1,,,,2,2,1,3
2992_0,,,,2,2,1,3
C(C(CC(C(C)=O)O)O)(O)=O,,,4,1,4,11,15
2992_1,,,,2,2,1,3
2994_0,,,,2,2,1,3
C(C(C(CO)C(C(C)=O)O)O)(O)=O,,,4,1,4,10,14
2994_1,,,,2,2,1,3
2995_0,,,,2,2,1,3
2995_1,,,,2,2,1,3
2997_0,,,,2,2,1,3
C(C(CC(C(O)=O)O)(CCO)O)=O,,,4,1,2,11,13
2997_1,,,,2,2,1,3
2999_0,,,,2,2,1,3
C(C(CC(C(O)=O)O)O)(CCO)=O,,,4,1,3,9,12
2999_1,,,,2,2,1,3
3001_0,,,,2,2,1,3
C(CC(C(CC(C(O)=O)O)O)O)=O,,,4,1,3,13,16
3001_1,,,,2,2,1,3
3003_0,,,,2,2,1,3
C(C(CC(CC(C=O)O)O)O)(O)=O,,,4,1,3,12,15
3003_1,,,,2,2,1,3
3004_0,,,,2,2,1,3
3004_1,,,,2,2,1,3
3005_0,,,,2,2,1,3
3005_1,,,,2,2,1,3
3006_0,,,,2,2,1,3
3006_1,,,,2,2,1,3
3008_0,,,,2,2,1,3
C(C(CC(C)(C(C=O)O)O)O)(O)=O,,,4,1,2,14,16
3008_1,,,,2,2,1,3
3010_0,,,,2,2,1,3
C(C(CC(C)O)O)(O)=O,,,4,1,2,15,17
3010_1,,,,2,2,1,3
3012_0,,,,2,2,1,3
C(C(CC(C(CO)O)O)O)(O)=O,,,4,1,6,10,16
3012_1,,,,2,2,1,3
3014_0,,,,2,2,1,3
C(C(CC(CO)O)O)(O)=O,,,4,1,3,10,13
3014_1,,,,2,2,1,3
3016_0,,,,2,2,1,3
C(CC(C(CO)C(C(O)=O)O)O)=O,,,4,1,5,13,18
3016_1,,,,2,2,1,3
3018_0,,,,2,2,1,3
C(C(C(CO)C(C)O)O)(O)=O,,,4,1,4,8,12
3018_1,,,,2,2,1,3
3020_0,,,,2,2,1,3
C(C(C(CO)CO)O)(O)=O,,,4,1,4,7,11
3020_1,,,,2,2,1,3
3022_0,,,,2,2,1,3
C(C(C(CO)C(CO)O)O)(O)=O,,,4,1,5,9,14
3022_1,,,,2,2,1,3
3023_0,,,,2,2,1,3
3023_1,,,,2,2,1,3
3024_0,,,,2,2,1,3
3024_1,,,,2,2,1,3
3025_0,,,,2,2,1,3
3025_1,,,,2,2,1,3
3026_0,,,,2,2,1,3
3026_1,,,,2,2,1,3
3028_0,,,,2,2,1,3
C(C(CO)(C)O)(O)=O,,,4,1,2,10,12
3029_0,,,,2,2,1,3
3029_1,,,,2,2,1,3
3031_0,,,,2,2,1,3
C(C(C=C)O)(O)=O,,,4,1,7,50,57
3031_1,,,,2,2,1,3
3032_0,,,,2,1,2,3
3033_0,,,,2,1,2,3
3035_0,,,,2,1,2,3
C(C(CO)=O)(C(C(CO)O)O)=O,,,4,1,7,14,21
3037_0,,,,2,1,2,3
C(C(CO)=O)(CO)=O,,,4,1,15,50,65
3039_0,,,,2,1,2,3
C(C(CO)=O)(C(CO)O)=O,,,4,1,13,24,37
3041_0,,,,2,1,2,3
C(C(C(CO)O)=O)(C(CO)O)=O,,,4,1,6,8,14
3043_0,,,,2,1,2,3
C(CC(C=O)=O)=O,,,4,1,64,262,326
3045_0,,,,2,1,2,3
C(C(C(C)=O)=O)=O,,,4,1,63,209,272
3047_0,,,,2,1,2,3
C(C(C(C(CO)=O)=O)O)=O,,,4,1,3,26,29
3049_0,,,,2,1,2,3
C(C(C(C(C(CO)O)=O)=O)O)=O,,,4,1,3,17,20
3051_0,,,,2,1,2,3
C(C(CO)=O)(C(CO)(CO)O)=O,,,4,1,3,9,12
3053_0,,,,2,1,2,3
C(C(C(C(CO)=O)=O)(C)O)=O,,,4,1,1,12,13
3055_0,,,,2,1,2,3
C(C)(C(C(C(CO)=O)=O)O)=O,,,4,1,2,16,18
3057_0,,,,2,1,2,3
C(CC(C(C(CO)=O)=O)O)=O,,,4,1,4,18,22
3059_0,,,,2,1,2,3
C(C(CO)=O)(C(C)O)=O,,,4,1,7,33,40
3061_0,,,,2,1,2,3
C(C(C(C)O)=O)(C(CO)O)=O,,,4,1,5,14,19
3063_0,,,,2,1,2,3
C(C(C(C=O)=O)O)=O,,,4,1,25,84,109
3065_0,,,,2,1,2,3
C(C(C(CO)(CO)O)=O)=O,,,4,1,7,12,19
3067_0,,,,2,1,2,3
C(C(C(CO)(C(CO)O)O)=O)=O,,,4,1,9,19,28
3068_0,,,,2,1,2,3
3070_0,,,,2,1,2,3
C(C(C(C=O)=O)(C)O)=O,,,4,1,7,18,25
3072_0,,,,2,1,2,3
C(C)(C(C(C=O)=O)O)=O,,,4,1,10,38,48
3074_0,,,,2,1,2,3
C(CC(C(C=O)=O)O)=O,,,4,1,12,40,52
3076_0,,,,2,1,2,3
C(C(C(C=O)=O)(CCO)O)=O,,,4,1,1,12,13
3078_0,,,,2,1,2,3
C(CCO)(C(C(C=O)=O)O)=O,,,4,1,3,18,21
3079_0,,,,2,1,2,3
3081_0,,,,2,1,2,3
C(C(CC(C(C=O)=O)O)O)=O,,,4,1,3,17,20
3083_0,,,,2,1,2,3
C(CO)(CC(C(C=O)=O)O)=O,,,4,1,6,21,27
3085_0,,,,2,1,2,3
C(CC(C(C=O)=O)(CO)O)=O,,,4,1,5,17,22
3086_0,,,,2,1,2,3
3088_0,,,,2,1,2,3
C(C(C(C(C=O)=O)(C)O)O)=O,,,4,1,8,17,25
3089_0,,,,2,1,2,3
3091_0,,,,2,1,2,3
C(CO)(CC(C=O)=O)=O,,,4,1,13,46,59
3093_0,,,,2,1,2,3
C(C(C(CCO)=O)=O)=O,,,4,1,6,33,39
3095_0,,,,2,1,2,3
C(C(CO)O)(CC(C=O)=O)=O,,,4,1,7,21,28
3097_0,,,,2,1,2,3
C(C(C(CC(CO)O)=O)=O)=O,,,4,1,3,17,20
3098_0,,,,2,1,2,3
3099_0,,,,2,1,2,3
3099_1,,,,2,1,2,3
3100_0,,,,2,1,2,3
3100_1,,,,2,1,2,3
3101_0,,,,2,1,2,3
3101_1,,,,2,1,2,3
3102_0,,,,2,1,2,3
3102_1,,,,2,1,2,3
3103_0,,,,2,1,2,3
3103_1,,,,2,1,2,3
3104_0,,,,2,1,2,3
3105_0,,,,2,1,2,3
3105_1,,,,2,1,2,3
3106_0,,,,2,1,2,3
3106_1,,,,2,1,2,3
3107_0,,,,2,1,2,3
3107_1,,,,2,1,2,3
3108_0,,,,2,1,2,3
3108_1,,,,2,1,2,3
3109_0,,,,2,1,2,3
3109_1,,,,2,1,2,3
3110_0,,,,2,1,2,3
3110_1,,,,2,1,2,3
3111_0,,,,2,1,2,3
3111_1,,,,2,1,2,3
3112_0,,,,2,1,2,3
3113_0,,,,2,1,2,3
3113_1,,,,2,1,2,3
3114_0,,,,2,1,2,3
3114_1,,,,2,1,2,3
3115_0,,,,2,1,2,3
3116_0,,,,2,1,2,3
3116_1,,,,2,1,2,3
3117_0,,,,2,1,2,3
3117_1,,,,2,1,2,3
3118_0,,,,2,1,2,3
3118_1,,,,2,1,2,3
3119_0,,,,2,1,2,3
3119_1,,,,2,1,2,3
3120_0,,,,2,1,2,3
3120_1,,,,2,1,2,3
3121_0,,,,2,1,2,3
3121_1,,,,2,1,2,3
3122_0,,,,2,1,2,3
3122_1,,,,2,1,2,3
3123_0,,,,2,1,2,3
3124_0,,,,2,1,2,3
3125_0,,,,2,1,2,3
3125_1,,,,2,1,2,3
3127_0,,,,2,1,2,3
C(C(C)O)=O,,,4,1,93,523,616
3127_1,,,,2,1,2,3
3128_0,,,,2,1,2,3
3128_1,,,,2,1,2,3
3129_0,,,,2,1,2,3
3129_1,,,,2,1,2,3
3130_0,,,,2,1,2,3
3130_1,,,,2,1,2,3
3132_0,,,,2,1,2,3
C(C(C(CO)=O)O)=O,,,4,1,36,100,136
3133_0,,,,2,1,2,3
3133_1,,,,2,1,2,3
3134_0,,,,2,1,2,3
3134_1,,,,2,1,2,3
3135_0,,,,2,1,2,3
3135_1,,,,2,1,2,3
3136_0,,,,2,1,2,3
3136_1,,,,2,1,2,3
3137_0,,,,2,1,2,3
3138_0,,,,2,1,2,3
3138_1,,,,2,1,2,3
3139_0,,,,2,1,2,3
3140_0,,,,2,1,2,3
3140_1,,,,2,1,2,3
3141_0,,,,2,1,2,3
3141_1,,,,2,1,2,3
3142_0,,,,2,1,2,3
3143_0,,,,2,1,2,3
3143_1,,,,2,1,2,3
3145_0,,,,2,1,2,3
C(CO)(C(C(CO)=O)O)=O,,,4,1,8,16,24
3146_0,,,,2,1,2,3
3146_1,,,,2,1,2,3
3147_0,,,,2,1,2,3
3147_1,,,,2,1,2,3
3148_0,,,,2,1,2,3
3148_1,,,,2,1,2,3
3150_0,,,,2,1,2,3
C(CO)(C(C(C)=O)O)=O,,,4,1,20,44,64
3150_1,,,,2,1,2,3
3151_0,,,,2,1,2,3
3151_1,,,,2,1,2,3
3152_0,,,,2,1,2,3
3152_1,,,,2,1,2,3
3153_0,,,,2,1,2,3
3153_1,,,,2,1,2,3
3154_0,,,,2,1,2,3
3154_1,,,,2,1,2,3
3155_0,,,,2,1,2,3
3156_0,,,,2,1,2,3
3156_1,,,,2,1,2,3
3157_0,,,,2,1,2,3
3158_0,,,,2,1,2,3
3158_1,,,,2,1,2,3
3159_0,,,,2,1,2,3
3159_1,,,,2,1,2,3
3160_0,,,,2,1,2,3
3160_1,,,,2,1,2,3
3161_0,,,,2,1,2,3
3161_1,,,,2,1,2,3
3162_0,,,,2,1,2,3
3162_1,,,,2,1,2,3
3163_0,,,,2,1,2,3
3163_1,,,,2,1,2,3
3164_0,,,,2,1,2,3
3164_1,,,,2,1,2,3
3166_0,,,,2,1,2,3
C(C(C(C(CO)O)=O)O)=O,,,4,1,8,25,33
3167_0,,,,2,1,2,3
3167_1,,,,2,1,2,3
3168_0,,,,2,1,2,3
3168_1,,,,2,1,2,3
3169_0,,,,2,1,2,3
3169_1,,,,2,1,2,3
3170_0,,,,2,1,2,3
3170_1,,,,2,1,2,3
3171_0,,,,2,1,2,3
3171_1,,,,2,1,2,3
3172_0,,,,2,1,2,3
3172_1,,,,2,1,2,3
3173_0,,,,2,1,2,3
3173_1,,,,2,1,2,3
3174_0,,,,2,1,2,3
3175_0,,,,2,1,2,3
3175_1,,,,2,1,2,3
3176_0,,,,2,1,2,3
3177_0,,,,2,1,2,3
3177_1,,,,2,1,2,3
3178_0,,,,2,1,2,3
3179_0,,,,2,1,2,3
3180_0,,,,2,1,2,3
3180_1,,,,2,1,2,3
3181_0,,,,2,1,2,3
3181_1,,,,2,1,2,3
3182_0,,,,2,1,2,3
3182_1,,,,2,1,2,3
3183_0,,,,2,1,2,3
3183_1,,,,2,1,2,3
3184_0,,,,2,1,2,3
3184_1,,,,2,1,2,3
3185_0,,,,2,1,2,3
3185_1,,,,2,1,2,3
3186_0,,,,2,1,2,3
3186_1,,,,2,1,2,3
3187_0,,,,2,1,2,3
3187_1,,,,2,1,2,3
3188_0,,,,2,1,2,3
3189_0,,,,2,1,2,3
3190_0,,,,2,1,2,3
3190_1,,,,2,1,2,3
3191_0,,,,2,1,2,3
3191_1,,,,2,1,2,3
3192_0,,,,2,1,2,3
3193_0,,,,2,1,2,3
3193_1,,,,2,1,2,3
3194_0,,,,2,1,2,3
3194_1,,,,2,1,2,3
3195_0,,,,2,1,2,3
3195_1,,,,2,1,2,3
3196_0,,,,2,1,2,3
3196_1,,,,2,1,2,3
3197_0,,,,2,1,2,3
3197_1,,,,2,1,2,3
3198_0,,,,2,1,2,3
3198_1,,,,2,1,2,3
3199_0,,,,2,1,2,3
3199_1,,,,2,1,2,3
3200_0,,,,2,1,2,3
3200_1,,,,2,1,2,3
3201_0,,,,2,1,2,3
3202_0,,,,2,1,2,3
3203_0,,,,2,1,2,3
3203_1,,,,2,1,2,3
3204_0,,,,2,1,2,3
3204_1,,,,2,1,2,3
3205_0,,,,2,1,2,3
3206_0,,,,2,1,2,3
3207_0,,,,2,1,2,3
3208_0,,,,2,1,2,3
3209_0,,,,2,1,2,3
3210_0,,,,2,1,2,3
3211_0,,,,2,1,2,3
3212_0,,,,2,1,2,3
3213_0,,,,2,1,2,3
3214_0,,,,2,1,2,3
3215_0,,,,2,1,2,3
3216_0,,,,2,1,2,3
3217_0,,,,2,1,2,3
3217_1,,,,2,1,2,3
3218_0,,,,2,1,2,3
3220_0,,,,2,1,2,3
C(C)(CC(C=O)=O)=O,,,4,1,12,130,142
3220_1,,,,2,1,2,3
3221_0,,,,2,1,2,3
3222_0,,,,2,1,2,3
3223_0,,,,2,1,2,3
3224_0,,,,2,1,2,3
3225_0,,,,2,1,2,3
3226_0,,,,2,1,2,3
3226_1,,,,2,1,2,3
3228_0,,,,2,1,2,3
C(C(C=O)C=O)=O,,,4,1,10,99,109
3229_0,,,,2,1,2,3
3229_1,,,,2,1,2,3
3230_0,,,,2,1,2,3
3230_1,,,,2,1,2,3
3232_0,,,,2,1,2,3
C(C(C(C=O)=O)CO)=O,,,4,1,12,29,41
3233_0,,,,2,1,2,3
3233_1,,,,2,1,2,3
3234_0,,,,2,1,2,3
3234_1,,,,2,1,2,3
3235_0,,,,2,1,2,3
3236_0,,,,2,1,2,3
3236_1,,,,2,1,2,3
3238_0,,,,2,1,2,3
C(C(C=O)C(CO)=O)=O,,,4,1,5,31,36
3239_0,,,,2,1,2,3
3239_1,,,,2,1,2,3
3241_0,,,,2,1,2,3
C(CC(C(C=O)O)=O)=O,,,4,1,6,44,50
3242_0,,,,2,1,2,3
3243_0,,,,2,1,2,3
3244_0,,,,2,1,2,3
3245_0,,,,2,1,2,3
3245_1,,,,2,1,2,3
3247_0,,,,2,1,2,3
C(C(C=O)O)=O,,,4,1,38,321,359
3248_0,,,,2,1,2,3
3248_1,,,,2,1,2,3
3249_0,,,,2,1,2,3
3250_0,,,,2,1,2,3
3250_1,,,,2,1,2,3
3251_0,,,,2,1,2,3
3252_0,,,,2,1,2,3
3252_1,,,,2,1,2,3
3253_0,,,,2,1,2,3
3253_1,,,,2,1,2,3
3254_0,,,,2,1,2,3
3255_0,,,,2,1,2,3
3255_1,,,,2,1,2,3
3256_0,,,,2,1,2,3
3257_0,,,,2,1,2,3
3257_1,,,,2,1,2,3
3258_0,,,,2,1,2,3
3258_1,,,,2,1,2,3
3259_0,,,,2,1,2,3
3259_1,,,,2,1,2,3
3261_0,,,,2,1,2,3
C(C(C=O)C(C)=O)=O,,,4,1,7,84,91
3261_1,,,,2,1,2,3
3262_0,,,,2,1,2,3
3262_1,,,,2,1,2,3
3263_0,,,,2,1,2,3
3263_1,,,,2,1,2,3
3264_0,,,,2,1,2,3
3264_1,,,,2,1,2,3
3265_0,,,,2,1,2,3
3265_1,,,,2,1,2,3
3266_0,,,,2,1,2,3
3266_1,,,,2,1,2,3
3267_0,,,,2,1,2,3
3267_1,,,,2,1,2,3
3268_0,,,,2,1,2,3
3269_0,,,,2,1,2,3
3269_1,,,,2,1,2,3
3270_0,,,,2,1,2,3
3270_1,,,,2,1,2,3
3271_0,,,,2,1,2,3
3272_0,,,,2,1,2,3
3273_0,,,,2,1,2,3
3273_1,,,,2,1,2,3
3274_0,,,,2,1,2,3
3274_1,,,,2,1,2,3
3275_0,,,,2,1,2,3
3276_0,,,,2,1,2,3
3276_1,,,,2,1,2,3
3277_0,,,,2,1,2,3
3277_1,,,,2,1,2,3
3278_0,,,,2,1,2,3
3278_1,,,,2,1,2,3
3279_0,,,,2,1,2,3
3279_1,,,,2,1,2,3
3280_0,,,,2,1,2,3
3280_1,,,,2,1,2,3
3281_0,,,,2,1,2,3
3281_1,,,,2,1,2,3
3282_0,,,,2,1,2,3
3282_1,,,,2,1,2,3
3283_0,,,,2,1,2,3
3284_0,,,,2,1,2,3
3284_1,,,,2,1,2,3
3285_0,,,,2,1,2,3
3286_0,,,,2,1,2,3
3287_0,,,,2,1,2,3
3287_1,,,,2,1,2,3
3288_0,,,,2,1,2,3
3288_1,,,,2,1,2,3
3289_0,,,,2,1,2,3
3289_1,,,,2,1,2,3
3290_0,,,,2,1,2,3
3290_1,,,,2,1,2,3
3291_0,,,,2,1,2,3
3291_1,,,,2,1,2,3
3292_0,,,,2,1,2,3
3292_1,,,,2,1,2,3
3293_0,,,,2,1,2,3
3293_1,,,,2,1,2,3
3294_0,,,,2,1,2,3
3294_1,,,,2,1,2,3
3295_0,,,,2,1,2,3
3295_1,,,,2,1,2,3
3296_0,,,,2,1,2,3
3297_0,,,,2,1,2,3
3298_0,,,,2,1,2,3
3298_1,,,,2,1,2,3
3299_0,,,,2,1,2,3
3300_0,,,,2,1,2,3
3301_0,,,,2,1,2,3
3301_1,,,,2,1,2,3
3302_0,,,,2,1,2,3
3303_0,,,,2,1,2,3
3303_1,,,,2,1,2,3
3304_0,,,,2,1,2,3
3304_1,,,,2,1,2,3
3305_0,,,,2,1,2,3
3305_1,,,,2,1,2,3
3306_0,,,,2,1,2,3
3306_1,,,,2,1,2,3
3307_0,,,,2,1,2,3
3307_1,,,,2,1,2,3
3308_0,,,,2,1,2,3
3308_1,,,,2,1,2,3
3309_0,,,,2,1,2,3
3309_1,,,,2,1,2,3
3310_0,,,,2,1,2,3
3310_1,,,,2,1,2,3
3311_0,,,,2,1,2,3
3312_0,,,,2,1,2,3
3312_1,,,,2,1,2,3
3313_0,,,,2,1,2,3
3313_1,,,,2,1,2,3
3314_0,,,,2,1,2,3
3314_1,,,,2,1,2,3
3315_0,,,,2,1,2,3
3317_0,,,,2,1,2,3
C(CC(C)=O)=O,,,4,1,31,574,605
3317_1,,,,2,1,2,3
3318_0,,,,2,1,2,3
3318_1,,,,2,1,2,3
3319_0,,,,2,1,2,3
3320_0,,,,2,1,2,3
3321_0,,,,2,1,2,3
3322_0,,,,2,1,2,3
3323_0,,,,2,1,2,3
3324_0,,,,2,1,2,3
3324_1,,,,2,1,2,3
3325_0,,,,2,1,2,3
3326_0,,,,2,1,2,3
3327_0,,,,2,1,2,3
3328_0,,,,2,1,2,3
3329_0,,,,2,1,2,3
3330_0,,,,2,1,2,3
3330_1,,,,2,1,2,3
3331_0,,,,2,1,2,3
3332_0,,,,2,1,2,3
3332_1,,,,2,1,2,3
3333_0,,,,2,1,2,3
3334_0,,,,2,1,2,3
3334_1,,,,2,1,2,3
3335_0,,,,2,1,2,3
3336_0,,,,2,1,2,3
3337_0,,,,2,1,2,3
3338_0,,,,2,1,2,3
3339_0,,,,2,1,2,3
3339_1,,,,2,1,2,3
3341_0,,,,2,1,2,3
C(=O)=O,,,4,1,322,1196,1518
3341_1,,,,2,1,2,3
3342_0,,,,2,1,2,3
3343_0,,,,2,1,2,3
3344_0,,,,2,1,2,3
3344_1,,,,2,1,2,3
3345_0,,,,2,1,2,3
3345_1,,,,2,1,2,3
3346_0,,,,2,1,2,3
3346_1,,,,2,1,2,3
3346_2,,,,2,1,2,3
3347_0,,,,2,1,2,3
3347_1,,,,2,1,2,3
3347_2,,,,2,1,2,3
3348_0,,,,2,1,2,3
3348_1,,,,2,1,2,3
3348_2,,,,2,1,2,3
3349_0,,,,2,1,2,3
3349_1,,,,2,1,2,3
3349_2,,,,2,1,2,3
3350_0,,,,2,1,2,3
3350_1,,,,2,1,2,3
3352_0,,,,2,1,2,3
C(C(CO)=O)(O)=O,,,4,1,31,125,156
3352_1,,,,2,1,2,3
3354_0,,,,2,1,2,3
C(C(C(CO)O)=O)(O)=O,,,4,1,8,24,32
3354_1,,,,2,1,2,3
3355_0,,,,2,1,2,3
3355_1,,,,2,1,2,3
3355_2,,,,2,1,2,3
3356_0,,,,2,1,2,3
3356_1,,,,2,1,2,3
3357_0,,,,2,1,2,3
3357_1,,,,2,1,2,3
3357_2,,,,2,1,2,3
3358_0,,,,2,1,2,3
3358_1,,,,2,1,2,3
3358_2,,,,2,1,2,3
3359_0,,,,2,1,2,3
3359_1,,,,2,1,2,3
3360_0,,,,2,1,2,3
3360_1,,,,2,1,2,3
3360_2,,,,2,1,2,3
3361_0,,,,2,1,2,3
3361_1,,,,2,1,2,3
3361_2,,,,2,1,2,3
3362_0,,,,2,1,2,3
3362_1,,,,2,1,2,3
3363_0,,,,2,1,2,3
3363_1,,,,2,1,2,3
3363_2,,,,2,1,2,3
3364_0,,,,2,1,2,3
3364_1,,,,2,1,2,3
3364_2,,,,2,1,2,3
3365_0,,,,2,1,2,3
3365_1,,,,2,1,2,3
3365_2,,,,2,1,2,3
3366_0,,,,2,1,2,3
3366_1,,,,2,1,2,3
3367_0,,,,2,1,2,3
3367_1,,,,2,1,2,3
3367_2,,,,2,1,2,3
3368_0,,,,2,1,2,3
3368_1,,,,2,1,2,3
3368_2,,,,2,1,2,3
3369_0,,,,2,1,2,3
3369_1,,,,2,1,2,3
3370_0,,,,2,1,2,3
3370_1,,,,2,1,2,3
3370_2,,,,2,1,2,3
3371_0,,,,2,1,2,3
3371_1,,,,2,1,2,3
3371_2,,,,2,1,2,3
3373_0,,,,2,1,2,3
C(C(C(CO)=O)(CO)O)=O,,,4,1,6,16,22
3374_0,,,,2,1,2,3
3374_1,,,,2,1,2,3
3374_2,,,,2,1,2,3
3375_0,,,,2,1,2,3
3375_1,,,,2,1,2,3
3375_2,,,,2,1,2,3
3376_0,,,,2,1,2,3
3376_1,,,,2,1,2,3
3376_2,,,,2,1,2,3
3377_0,,,,2,1,2,3
3377_1,,,,2,1,2,3
3377_2,,,,2,1,2,3
3378_0,,,,2,1,2,3
3378_1,,,,2,1,2,3
3378_2,,,,2,1,2,3
3379_0,,,,2,1,2,3
3379_1,,,,2,1,2,3
3379_2,,,,2,1,2,3
3380_0,,,,2,1,2,3
3380_1,,,,2,1,2,3
3380_2,,,,2,1,2,3
3381_0,,,,2,1,2,3
3381_1,,,,2,1,2,3
3382_0,,,,2,1,2,3
3382_1,,,,2,1,2,3
3384_0,,,,2,1,2,3
C(C(C=O)(CO)O)(O)=O,,,4,1,6,12,18
3385_0,,,,2,1,2,3
3385_1,,,,2,1,2,3
3385_2,,,,2,1,2,3
3386_0,,,,2,1,2,3
3386_1,,,,2,1,2,3
3387_0,,,,2,1,2,3
3387_1,,,,2,1,2,3
3387_2,,,,2,1,2,3
3388_0,,,,2,1,2,3
3388_1,,,,2,1,2,3
3388_2,,,,2,1,2,3
3389_0,,,,2,1,2,3
3389_1,,,,2,1,2,3
3390_0,,,,2,1,2,3
3390_1,,,,2,1,2,3
3390_2,,,,2,1,2,3
3391_0,,,,2,1,2,3
3391_1,,,,2,1,2,3
3391_2,,,,2,1,2,3
3392_0,,,,2,1,2,3
3392_1,,,,2,1,2,3
3393_0,,,,2,1,2,3
3393_1,,,,2,1,2,3
3393_2,,,,2,1,2,3
3394_0,,,,2,1,2,3
3394_1,,,,2,1,2,3
3395_0,,,,2,1,2,3
3395_1,,,,2,1,2,3
3395_2,,,,2,1,2,3
3396_0,,,,2,1,2,3
3396_1,,,,2,1,2,3
3396_2,,,,2,1,2,3
3397_0,,,,2,1,2,3
3397_1,,,,2,1,2,3
3398_0,,,,2,1,2,3
3398_1,,,,2,1,2,3
3398_2,,,,2,1,2,3
3399_0,,,,2,1,2,3
3399_1,,,,2,1,2,3
3399_2,,,,2,1,2,3
3400_0,,,,2,1,2,3
3400_1,,,,2,1,2,3
3401_0,,,,2,1,2,3
3401_1,,,,2,1,2,3
3401_2,,,,2,1,2,3
3403_0,,,,2,1,2,3
C(C(C=O)(C(C)=O)O)=O,,,4,1,2,16,18
3404_0,,,,2,1,2,3
3404_1,,,,2,1,2,3
3404_2,,,,2,1,2,3
3405_0,,,,2,1,2,3
3405_1,,,,2,1,2,3
3405_2,,,,2,1,2,3
3407_0,,,,2,1,2,3
C(C(C=O)(CO)O)=O,,,4,1,11,23,34
3408_0,,,,2,1,2,3
3408_1,,,,2,1,2,3
3408_2,,,,2,1,2,3
3409_0,,,,2,1,2,3
3409_1,,,,2,1,2,3
3409_2,,,,2,1,2,3
3411_0,,,,2,1,2,3
C(C(C=O)(C(CO)O)O)=O,,,4,1,6,10,16
3412_0,,,,2,1,2,3
3412_1,,,,2,1,2,3
3412_2,,,,2,1,2,3
3413_0,,,,2,1,2,3
3413_1,,,,2,1,2,3
3413_2,,,,2,1,2,3
3414_0,,,,2,1,2,3
3414_1,,,,2,1,2,3
3415_0,,,,2,1,2,3
3415_1,,,,2,1,2,3
3415_2,,,,2,1,2,3
3416_0,,,,2,1,2,3
3416_1,,,,2,1,2,3
3416_2,,,,2,1,2,3
3417_0,,,,2,1,2,3
3417_1,,,,2,1,2,3
3418_0,,,,2,1,2,3
3419_0,,,,2,1,2,3
3419_1,,,,2,1,2,3
3419_2,,,,2,1,2,3
3420_0,,,,2,1,2,3
3420_1,,,,2,1,2,3
3420_2,,,,2,1,2,3
3421_0,,,,2,1,2,3
3422_0,,,,2,1,2,3
3422_1,,,,2,1,2,3
3422_2,,,,2,1,2,3
3423_0,,,,2,1,2,3
3423_1,,,,2,1,2,3
3423_2,,,,2,1,2,3
3424_0,,,,2,1,2,3
3424_1,,,,2,1,2,3
3424_2,,,,2,1,2,3
3425_0,,,,2,1,2,3
3425_1,,,,2,1,2,3
3425_2,,,,2,1,2,3
3426_0,,,,2,1,2,3
3427_0,,,,2,1,2,3
3427_1,,,,2,1,2,3
3427_2,,,,2,1,2,3
3428_0,,,,2,1,2,3
3428_1,,,,2,1,2,3
3428_2,,,,2,1,2,3
3429_0,,,,2,1,2,3
3430_0,,,,2,1,2,3
3430_1,,,,2,1,2,3
3430_2,,,,2,1,2,3
3431_0,,,,2,1,2,3
3431_1,,,,2,1,2,3
3431_2,,,,2,1,2,3
3432_0,,,,2,1,2,3
3432_1,,,,2,1,2,3
3432_2,,,,2,1,2,3
3433_0,,,,2,1,2,3
3433_1,,,,2,1,2,3
3433_2,,,,2,1,2,3
3434_0,,,,2,1,2,3
3434_1,,,,2,1,2,3
3434_2,,,,2,1,2,3
3435_0,,,,2,1,2,3
3435_1,,,,2,1,2,3
3435_2,,,,2,1,2,3
3436_0,,,,2,1,2,3
3436_1,,,,2,1,2,3
3437_0,,,,2,1,2,3
3437_1,,,,2,1,2,3
3437_2,,,,2,1,2,3
3438_0,,,,2,1,2,3
3438_1,,,,2,1,2,3
3438_2,,,,2,1,2,3
3439_0,,,,2,1,2,3
3439_1,,,,2,1,2,3
3440_0,,,,2,1,2,3
3440_1,,,,2,1,2,3
3440_2,,,,2,1,2,3
3441_0,,,,2,1,2,3
3441_1,,,,2,1,2,3
3441_2,,,,2,1,2,3
3442_0,,,,2,1,2,3
3442_1,,,,2,1,2,3
3442_2,,,,2,1,2,3
3443_0,,,,2,1,2,3
3443_1,,,,2,1,2,3
3443_2,,,,2,1,2,3
3444_0,,,,2,1,2,3
3444_1,,,,2,1,2,3
3445_0,,,,2,1,2,3
3446_0,,,,2,1,2,3
3446_1,,,,2,1,2,3
3447_0,,,,2,1,2,3
3447_1,,,,2,1,2,3
3448_0,,,,2,1,2,3
3448_1,,,,2,1,2,3
3449_0,,,,2,1,2,3
3450_0,,,,2,1,2,3
3450_1,,,,2,1,2,3
3451_0,,,,2,1,2,3
3452_0,,,,2,1,2,3
3452_1,,,,2,1,2,3
3453_0,,,,2,1,2,3
3453_1,,,,2,1,2,3
3454_0,,,,2,1,2,3
3454_1,,,,2,1,2,3
3455_0,,,,2,1,2,3
3456_0,,,,2,1,2,3
3456_1,,,,2,1,2,3
3457_0,,,,2,1,2,3
3457_1,,,,2,1,2,3
3458_0,,,,2,1,2,3
3458_1,,,,2,1,2,3
3459_0,,,,2,1,2,3
3461_0,,,,2,1,2,3
C(C(C=O)(CC=O)O)=O,,,4,1,3,26,29
3463_0,,,,2,1,2,3
C(C(C=O)O)(O)=O,,,4,1,18,129,147
3464_0,,,,2,1,2,3
3464_1,,,,2,1,2,3
3465_0,,,,2,1,2,3
3465_1,,,,2,1,2,3
3466_0,,,,2,1,2,3
3467_0,,,,2,1,2,3
3467_1,,,,2,1,2,3
3468_0,,,,2,1,2,3
3469_0,,,,2,1,2,3
3469_1,,,,2,1,2,3
3470_0,,,,2,1,2,3
3471_0,,,,2,1,2,3
3471_1,,,,2,1,2,3
3472_0,,,,2,1,2,3
3473_0,,,,2,1,2,3
3473_1,,,,2,1,2,3
3474_0,,,,2,1,2,3
3475_0,,,,2,1,2,3
3476_0,,,,2,1,2,3
3478_0,,,,2,1,2,3
C(C(C(CO)=O)O)(O)=O,,,4,1,13,35,48
3479_0,,,,2,1,2,3
3479_1,,,,2,1,2,3
3480_0,,,,2,1,2,3
3480_1,,,,2,1,2,3
3481_0,,,,2,1,2,3
3482_0,,,,2,1,2,3
3483_0,,,,2,1,2,3
3483_1,,,,2,1,2,3
3484_0,,,,2,1,2,3
3485_0,,,,2,1,2,3
3485_1,,,,2,1,2,3
3486_0,,,,2,1,2,3
3487_0,,,,2,1,2,3
3487_1,,,,2,1,2,3
3487_2,,,,2,1,2,3
3488_0,,,,2,1,2,3
3488_1,,,,2,1,2,3
3489_0,,,,2,1,2,3
3489_1,,,,2,1,2,3
3490_0,,,,2,1,2,3
3491_0,,,,2,1,2,3
3492_0,,,,2,1,2,3
3492_1,,,,2,1,2,3
3493_0,,,,2,1,2,3
3493_1,,,,2,1,2,3
3494_0,,,,2,1,2,3
3494_1,,,,2,1,2,3
3495_0,,,,2,1,2,3
3496_0,,,,2,1,2,3
3497_0,,,,2,1,2,3
3498_0,,,,2,1,2,3
3498_1,,,,2,1,2,3
3499_0,,,,2,1,2,3
3499_1,,,,2,1,2,3
3500_0,,,,2,1,2,3
3500_1,,,,2,1,2,3
3501_0,,,,2,1,2,3
3501_1,,,,2,1,2,3
3502_0,,,,2,1,2,3
3504_0,,,,2,1,1,2
C(OCC(C)=O)=O,,,4,1,1,170,171
3505_0,,,,2,1,1,2
3507_0,,,,2,1,1,2
C(C(C(C(C=O)O)O)O)=O,,,4,1,6,15,21
3508_0,,,,2,1,1,2
3510_0,,,,2,1,1,2
C(C(C(C(C(CO)O)O)=O)O)=O,,,4,1,7,15,22
3512_0,,,,2,1,1,2
C(C(C(C(C(CO)=O)O)O)O)=O,,,4,1,11,18,29
3514_0,,,,2,1,1,2
C(C(CO)O)(C(C(CO)=O)O)=O,,,4,1,7,11,18
3515_0,,,,2,1,1,2
3516_0,,,,2,1,1,2
3518_0,,,,2,1,1,2
C(CO)(C(C(C=O)=O)CO)=O,,,4,1,6,18,24
3519_0,,,,2,1,1,2
3520_0,,,,2,1,1,2
3522_0,,,,2,1,1,2
C(C(C(CO)=O)C(CO)=O)=O,,,4,1,3,10,13
3524_0,,,,2,1,1,2
C(C(C(C(CC=O)O)=O)O)=O,,,4,1,6,21,27
3526_0,,,,2,1,1,2
C(CC(C(C(CO)=O)O)=O)=O,,,4,1,5,18,23
3527_0,,,,2,1,1,2
3528_0,,,,2,1,1,2
3530_0,,,,2,1,1,2
C(C(C=O)O)(CC(CO)=O)=O,,,4,1,4,18,22
3531_0,,,,2,1,1,2
3532_0,,,,2,1,1,2
3533_0,,,,2,1,1,2
3534_0,,,,2,1,1,2
3535_0,,,,2,1,1,2
3537_0,,,,2,1,1,2
C(CC(C(C(CO)(CO)O)=O)O)=O,,,4,1,5,10,15
3538_0,,,,2,1,1,2
3540_0,,,,2,1,1,2
C(C(C(CC(CO)(CO)O)O)=O)=O,,,4,1,2,10,12
3541_0,,,,2,1,1,2
3543_0,,,,2,1,1,2
C(C(C(C(CO)O)=O)(C)O)=O,,,4,1,4,12,16
3545_0,,,,2,1,1,2
C(C(C)(C(C(C=O)O)O)O)=O,,,4,1,3,17,20
3547_0,,,,2,1,1,2
C(C(C)O)(C(C(CO)=O)O)=O,,,4,1,8,12,20
3549_0,,,,2,1,1,2
C(C(CO)O)(C(C(C)=O)O)=O,,,4,1,8,15,23
3550_0,,,,2,1,1,2
3551_0,,,,2,1,1,2
3552_0,,,,2,1,1,2
3554_0,,,,2,1,1,2
C(C(C(C(CO)O)=O)(CCO)O)=O,,,4,1,3,12,15
3556_0,,,,2,1,1,2
C(C(C(C(C=O)O)O)(CCO)O)=O,,,4,1,3,16,19
3558_0,,,,2,1,1,2
C(C(CCO)O)(C(C(CO)=O)O)=O,,,4,1,1,10,11
3560_0,,,,2,1,1,2
C(CCO)(C(C(C(CO)O)=O)O)=O,,,4,1,5,12,17
3561_0,,,,2,1,1,2
3562_0,,,,2,1,1,2
3563_0,,,,2,1,1,2
3564_0,,,,2,1,1,2
3566_0,,,,2,1,1,2
C(C(CC(C(C(CO)O)=O)O)O)=O,,,4,1,6,15,21
3568_0,,,,2,1,1,2
C(C(C(C(CC(C=O)O)O)O)O)=O,,,4,1,5,20,25
3569_0,,,,2,1,1,2
3570_0,,,,2,1,1,2
3571_0,,,,2,1,1,2
3573_0,,,,2,1,1,2
C(C(CO)(CC=O)O)(C(CO)O)=O,,,4,1,6,16,22
3574_0,,,,2,1,1,2
3575_0,,,,2,1,1,2
3576_0,,,,2,1,1,2
3577_0,,,,2,1,1,2
3578_0,,,,2,1,1,2
3580_0,,,,2,1,1,2
C(C(C)(C(C=O)O)O)(C(CO)O)=O,,,4,1,6,17,23
3581_0,,,,2,1,1,2
3583_0,,,,2,1,1,2
C(C(CO)O)(C(C)O)=O,,,4,1,10,32,42
3585_0,,,,2,1,1,2
C(C(C(C(C)O)O)O)=O,,,4,1,6,30,36
3586_0,,,,2,1,1,2
3587_0,,,,2,1,1,2
3588_0,,,,2,1,1,2
3589_0,,,,2,1,1,2
3590_0,,,,2,1,1,2
3592_0,,,,2,1,1,2
C(C(C(C(C(CO)O)O)=O)(C)O)=O,,,4,1,4,13,17
3594_0,,,,2,1,1,2
C(C(C)(C(C(C(CO)=O)O)O)O)=O,,,4,1,4,16,20
3596_0,,,,2,1,1,2
C(C(CO)O)(C(C(C(C)O)=O)O)=O,,,4,1,5,12,17
3598_0,,,,2,1,1,2
C(C(C(CO)O)O)(C(C(C)=O)O)=O,,,4,1,6,13,19
3599_0,,,,2,1,1,2
3600_0,,,,2,1,1,2
3601_0,,,,2,1,1,2
3603_0,,,,2,1,1,2
C(C(C(CO)O)O)(C(C)O)=O,,,4,1,6,13,19
3605_0,,,,2,1,1,2
C(CO)(C(C(C(C)O)O)O)=O,,,4,1,5,14,19
3606_0,,,,2,1,1,2
3607_0,,,,2,1,1,2
3608_0,,,,2,1,1,2
3609_0,,,,2,1,1,2
3610_0,,,,2,1,1,2
3611_0,,,,2,1,1,2
3613_0,,,,2,1,1,2
C(CC(C(C(C=O)(C)O)=O)O)=O,,,4,1,3,13,16
3614_0,,,,2,1,1,2
3616_0,,,,2,1,1,2
C(C(C)(CC(C(C=O)=O)O)O)=O,,,4,1,2,14,16
3618_0,,,,2,1,1,2
C(C(C(CO)=O)(C)O)=O,,,4,1,12,25,37
3620_0,,,,2,1,1,2
C(C(C)O)(CC(C=O)=O)=O,,,4,1,4,23,27
3622_0,,,,2,1,1,2
C(C(C=O)C(C(C)O)=O)=O,,,4,1,2,15,17
3624_0,,,,2,1,1,2
C(C(C)O)(C(C(C=O)=O)CO)=O,,,4,1,3,15,18
3625_0,,,,2,1,1,2
3627_0,,,,2,1,1,2
C(C(C)O)(C(C=O)C(C=O)O)=O,,,4,1,4,15,19
3628_0,,,,2,1,1,2
3630_0,,,,2,1,1,2
C(C(C)O)(C(C=O)C(CO)=O)=O,,,4,1,4,12,16
3632_0,,,,2,1,1,2
C(CC(C(C(C(C)=O)O)=O)O)=O,,,4,1,5,16,21
3634_0,,,,2,1,1,2
C(CC(C(C(C(C)O)=O)O)=O)=O,,,4,1,2,12,14
3635_0,,,,2,1,1,2
3637_0,,,,2,1,1,2
C(C)(C(CC(C(C=O)=O)O)O)=O,,,4,1,4,16,20
3639_0,,,,2,1,1,2
C(C(C=O)O)(CC(C(C)O)=O)=O,,,4,1,1,12,13
3641_0,,,,2,1,1,2
C(CC(C(C)O)=O)=O,,,4,1,5,89,94
3642_0,,,,2,1,1,2
3644_0,,,,2,1,1,2
C(C(C(C(C)O)=O)O)=O,,,4,1,11,34,45
3646_0,,,,2,1,1,2
C(C(CCO)O)(CC(C=O)=O)=O,,,4,1,2,14,16
3647_0,,,,2,1,1,2
3648_0,,,,2,1,1,2
3649_0,,,,2,1,1,2
3650_0,,,,2,1,1,2
3651_0,,,,2,1,1,2
3652_0,,,,2,1,1,2
3654_0,,,,2,1,1,2
C(CC(C(C(CC=O)O)=O)O)=O,,,4,1,3,10,13
3655_0,,,,2,1,1,2
3657_0,,,,2,1,1,2
C(CC(CC(C(C=O)=O)O)O)=O,,,4,1,7,21,28
3658_0,,,,2,1,1,2
3660_0,,,,2,1,1,2
C(C(C=O)C(C(CCO)O)=O)=O,,,4,1,2,10,12
3661_0,,,,2,1,1,2
3662_0,,,,2,1,1,2
3663_0,,,,2,1,1,2
3664_0,,,,2,1,1,2
3666_0,,,,2,1,1,2
C(C(C(CO)=O)(CCO)O)=O,,,4,1,6,10,16
3668_0,,,,2,1,1,2
C(CC(C(CCO)O)=O)=O,,,4,1,4,21,25
3670_0,,,,2,1,1,2
C(CCO)(C(C(CO)=O)O)=O,,,4,1,8,14,22
3672_0,,,,2,1,1,2
C(C(C(C(CCO)O)=O)O)=O,,,4,1,7,13,20
3673_0,,,,2,1,1,2
3674_0,,,,2,1,1,2
3676_0,,,,2,1,1,2
C(C(CC(C(CO)=O)O)O)=O,,,4,1,8,16,24
3677_0,,,,2,1,1,2
3678_0,,,,2,1,1,2
3679_0,,,,2,1,1,2
3680_0,,,,2,1,1,2
3681_0,,,,2,1,1,2
3682_0,,,,2,1,1,2
3683_0,,,,2,1,1,2
3684_0,,,,2,1,1,2
3686_0,,,,2,1,1,2
C(CO)(C(CO)(CC=O)O)=O,,,4,1,9,17,26
3687_0,,,,2,1,1,2
3688_0,,,,2,1,1,2
3689_0,,,,2,1,1,2
3690_0,,,,2,1,1,2
3691_0,,,,2,1,1,2
3692_0,,,,2,1,1,2
3693_0,,,,2,1,1,2
3694_0,,,,2,1,1,2
3695_0,,,,2,1,1,2
3696_0,,,,2,1,1,2
3697_0,,,,2,1,1,2
3698_0,,,,2,1,1,2
3699_0,,,,2,1,1,2
3700_0,,,,2,1,1,2
3702_0,,,,2,1,1,2
C(C(C(CC(C)O)O)=O)=O,,,4,1,3,16,19
3703_0,,,,2,1,1,2
3705_0,,,,2,1,1,2
C(C(C(CC(C(CO)O)O)O)=O)=O,,,4,1,4,14,18
3706_0,,,,2,1,1,2
3708_0,,,,2,1,1,2
C(C(C(CCO)O)=O)=O,,,4,1,7,25,32
3709_0,,,,2,1,1,2
3711_0,,,,2,1,1,2
C(C(C(CC(CO)O)O)=O)=O,,,4,1,4,15,19
3713_0,,,,2,1,1,2
C(CO)(C(C)O)=O,,,4,1,42,181,223
3714_0,,,,2,1,1,2
3715_0,,,,2,1,1,2
3716_0,,,,2,1,1,2
3717_0,,,,2,1,1,2
3718_0,,,,2,1,1,2
3719_0,,,,2,1,1,2
3720_0,,,,2,1,1,2
3721_0,,,,2,1,1,2
3722_0,,,,2,1,1,2
3723_0,,,,2,1,1,2
3724_0,,,,2,1,1,2
3725_0,,,,2,1,1,2
3727_0,,,,2,1,1,2
C(C(C(C)O)=O)(O)=O,,,4,1,12,38,50
3729_0,,,,2,1,1,2
C(C(C(CO)(C(C=O)O)O)O)=O,,,4,1,6,9,15
3731_0,,,,2,1,1,2
C(CO)(C(C(CO)=O)(CO)O)=O,,,4,1,4,6,10
3733_0,,,,2,1,1,2
C(C(C(CO)=O)(CO)O)(O)=O,,,4,1,6,10,16
3735_0,,,,2,1,1,2
C(C(C(CO)=O)(C(CO)O)O)(O)=O,,,4,1,6,12,18
3737_0,,,,2,1,1,2
C(C(C(CO)=O)(C(C)=O)O)=O,,,4,1,2,9,11
3738_0,,,,2,1,1,2
3740_0,,,,2,1,1,2
C(C(C(CO)=O)(C(CO)O)O)=O,,,4,1,6,12,18
3742_0,,,,2,1,1,2
C(C(C)(C(CO)(C(C=O)O)O)O)=O,,,4,1,7,14,21
3744_0,,,,2,1,1,2
C(C(C)O)(C(C(CO)=O)(CO)O)=O,,,4,1,4,9,13
3746_0,,,,2,1,1,2
C(C(C(CO)(C(C(C)=O)O)O)O)=O,,,4,1,9,15,24
3747_0,,,,2,1,1,2
3749_0,,,,2,1,1,2
C(C(C(CO)(C(C)O)O)O)=O,,,4,1,6,13,19
3750_0,,,,2,1,1,2
3751_0,,,,2,1,1,2
3753_0,,,,2,1,1,2
C(C(C(C(C)O)=O)(CO)O)(O)=O,,,4,1,6,9,15
3755_0,,,,2,1,1,2
C(C(C)O)(C(C=O)(C(C)=O)O)=O,,,4,1,2,7,9
3757_0,,,,2,1,1,2
C(C(C(C(C)O)=O)(CO)O)=O,,,4,1,5,10,15
3759_0,,,,2,1,1,2
C(C(C(C(C)O)=O)(C(CO)O)O)=O,,,4,1,6,12,18
3761_0,,,,2,1,1,2
C(C(C(C(CCO)O)=O)(CO)O)=O,,,4,1,4,11,15
3762_0,,,,2,1,1,2
3763_0,,,,2,1,1,2
3765_0,,,,2,1,1,2
C(C(CO)(C(C(C(C)O)=O)O)O)=O,,,4,1,9,17,26
3767_0,,,,2,1,1,2
C(C(CO)(C(C(CO)=O)(C)O)O)=O,,,4,1,8,16,24
3769_0,,,,2,1,1,2
C(C(C(CO)=O)(CC=O)O)=O,,,4,1,3,16,19
3770_0,,,,2,1,1,2
3772_0,,,,2,1,1,2
C(C(C)O)(C(C=O)(CC=O)O)=O,,,4,1,2,12,14
3774_0,,,,2,1,1,2
C(C(C(C(C)O)=O)O)(O)=O,,,4,1,8,17,25
3776_0,,,,2,1,1,2
C(C(C(C(CCO)O)=O)O)(O)=O,,,4,1,3,10,13
3777_0,,,,2,1,1,2
3778_0,,,,2,1,1,2
3780_0,,,,2,1,1,2
C(C(C(C(O)=O)O)O)(C(C)O)=O,,,4,1,6,11,17
3782_0,,,,2,1,1,2
C(CO)(C(C)(C(C(O)=O)O)O)=O,,,4,1,5,9,14
3784_0,,,,2,1,1,2
C(CO)(CC(CO)=O)=O,,,4,1,8,32,40
3786_0,,,,2,1,1,2
C(C(CC(C=O)O)O)=O,,,4,1,9,16,25
3788_0,,,,2,1,1,2
C(C(CO)O)(CC(CO)=O)=O,,,4,1,10,17,27
3789_0,,,,2,1,1,2
3791_0,,,,2,1,1,2
C(C(CO)(CC(C=O)O)O)=O,,,4,1,3,14,17
3792_0,,,,2,1,1,2
3793_0,,,,2,1,1,2
3795_0,,,,2,1,1,2
C(CC(C(CO)=O)O)(O)=O,,,4,1,6,18,24
3797_0,,,,2,1,1,2
C(C(C(CCO)O)=O)(O)=O,,,4,1,4,10,14
3799_0,,,,2,1,1,2
C(C(CC(C(CO)=O)O)O)(O)=O,,,4,1,6,9,15
3801_0,,,,2,1,1,2
C(CC(C(C(CO)O)=O)O)(O)=O,,,4,1,6,10,16
3803_0,,,,2,1,1,2
C(C(C(CC(CO)O)O)=O)(O)=O,,,4,1,3,10,13
3804_0,,,,2,1,1,2
3806_0,,,,2,1,1,2
C1(C(CCO1)O)=O,,,4,1,3,65,68
3808_0,,,,2,3,2,5
C(C(C(C(C(CCO)O)O)O)O)O,,,4,1,5,10,15
3809_0,,,,2,3,2,5
3810_0,,,,2,3,2,5
3811_0,,,,2,3,2,5
3812_0,,,,2,3,2,5
3813_0,,,,2,3,2,5
3814_0,,,,2,3,2,5
3815_0,,,,2,3,2,5
3816_0,,,,2,3,2,5
3817_0,,,,2,3,2,5
3819_0,,,,2,3,2,5
C(C(C(CO)C(C=O)O)O)=O,,,4,1,4,8,12
3820_0,,,,2,3,2,5
3821_0,,,,2,3,2,5
3822_0,,,,2,3,2,5
3823_0,,,,2,3,2,5
3824_0,,,,2,3,2,5
3825_0,,,,2,3,2,5
3826_0,,,,2,3,2,5
3827_0,,,,2,3,2,5
3828_0,,,,2,3,2,5
3829_0,,,,2,3,2,5
3830_0,,,,2,3,2,5
3832_0,,,,2,3,2,5
C(C(C(CO)C(CO)(CO)O)O)=O,,,4,1,2,9,11
3833_0,,,,2,3,2,5
3834_0,,,,2,3,2,5
3835_0,,,,2,3,2,5
3837_0,,,,2,3,2,5
C(C(CO)(CCO)O)O,,,4,1,2,6,8
3838_0,,,,2,3,2,5
3839_0,,,,2,3,2,5
3840_0,,,,2,3,2,5
3841_0,,,,2,3,2,5
3842_0,,,,2,3,2,5
3843_0,,,,2,3,2,5
3844_0,,,,2,3,2,5
3845_0,,,,2,3,2,5
3846_0,,,,2,3,2,5
3847_0,,,,2,3,2,5
3849_0,,,,2,3,2,5
C(C(C(CO)(CCO)O)O)O,,,4,1,4,6,10
3850_0,,,,2,3,2,5
3851_0,,,,2,3,2,5
3852_0,,,,2,3,2,5
3853_0,,,,2,3,2,5
3854_0,,,,2,3,2,5
3856_0,,,,2,3,2,5
C(C(CO)(C(CCO)O)O)O,,,4,1,3,4,7
3857_0,,,,2,3,2,5
3859_0,,,,2,3,2,5
C(C(C(CO)(C(CCO)O)O)O)O,,,4,1,5,7,12
3860_0,,,,2,3,2,5
3861_0,,,,2,3,2,5
3862_0,,,,2,3,2,5
3863_0,,,,2,3,2,5
3864_0,,,,2,3,2,5
3865_0,,,,2,3,2,5
3866_0,,,,2,3,2,5
3868_0,,,,2,3,2,5
C(C(C)(C(CO)C(C=O)O)O)=O,,,4,1,2,13,15
3869_0,,,,2,3,2,5
3870_0,,,,2,3,2,5
3871_0,,,,2,3,2,5
3872_0,,,,2,3,2,5
3873_0,,,,2,3,2,5
3874_0,,,,2,3,2,5
3875_0,,,,2,3,2,5
3877_0,,,,2,3,2,5
C(C(C)(CCO)O)=O,,,4,1,1,29,30
3878_0,,,,2,3,2,5
3880_0,,,,2,3,2,5
C(C(C)(C(CO)O)O)=O,,,4,1,4,15,19
3881_0,,,,2,3,2,5
3882_0,,,,2,3,2,5
3883_0,,,,2,3,2,5
3884_0,,,,2,3,2,5
3885_0,,,,2,3,2,5
3887_0,,,,2,3,2,5
C(C(C(CO)C(C(C)=O)O)O)=O,,,4,1,3,13,16
3888_0,,,,2,3,2,5
3889_0,,,,2,3,2,5
3890_0,,,,2,3,2,5
3892_0,,,,2,3,2,5
C(C)(C(CCO)O)=O,,,4,1,4,61,65
3893_0,,,,2,3,2,5
3894_0,,,,2,3,2,5
3895_0,,,,2,3,2,5
3896_0,,,,2,3,2,5
3897_0,,,,2,3,2,5
3898_0,,,,2,3,2,5
3899_0,,,,2,3,2,5
3900_0,,,,2,3,2,5
3901_0,,,,2,3,2,5
3902_0,,,,2,3,2,5
3903_0,,,,2,3,2,5
3904_0,,,,2,3,2,5
3905_0,,,,2,3,2,5
3906_0,,,,2,3,2,5
3907_0,,,,2,3,2,5
3908_0,,,,2,3,2,5
3909_0,,,,2,3,2,5
3910_0,,,,2,3,2,5
3911_0,,,,2,3,2,5
3912_0,,,,2,3,2,5
3913_0,,,,2,3,2,5
3914_0,,,,2,3,2,5
3915_0,,,,2,3,2,5
3916_0,,,,2,3,2,5
3917_0,,,,2,3,2,5
3918_0,,,,2,3,2,5
3919_0,,,,2,3,2,5
3920_0,,,,2,3,2,5
3921_0,,,,2,3,2,5
3922_0,,,,2,3,2,5
3923_0,,,,2,3,2,5
3924_0,,,,2,3,2,5
3925_0,,,,2,3,2,5
3926_0,,,,2,3,2,5
3927_0,,,,2,3,2,5
3928_0,,,,2,3,2,5
3929_0,,,,2,3,2,5
3930_0,,,,2,3,2,5
3931_0,,,,2,3,2,5
3932_0,,,,2,3,2,5
3933_0,,,,2,3,2,5
3934_0,,,,2,3,2,5
3935_0,,,,2,3,2,5
3936_0,,,,2,3,2,5
3937_0,,,,2,3,2,5
3938_0,,,,2,3,2,5
3939_0,,,,2,3,2,5
3940_0,,,,2,3,2,5
3941_0,,,,2,3,2,5
3942_0,,,,2,3,2,5
3943_0,,,,2,3,2,5
3944_0,,,,2,3,2,5
3945_0,,,,2,3,2,5
3946_0,,,,2,3,2,5
3948_0,,,,2,3,2,5
C(C(CCO)(CCO)O)=O,,,4,1,1,6,7
3949_0,,,,2,3,2,5
3951_0,,,,2,3,2,5
C(C(C(CO)O)(CCO)O)=O,,,4,1,5,11,16
3952_0,,,,2,3,2,5
3954_0,,,,2,3,2,5
C(C(CCO)O)(CCO)=O,,,4,1,5,17,22
3955_0,,,,2,3,2,5
3956_0,,,,2,3,2,5
3957_0,,,,2,3,2,5
3958_0,,,,2,3,2,5
3959_0,,,,2,3,2,5
3960_0,,,,2,3,2,5
3961_0,,,,2,3,2,5
3962_0,,,,2,3,2,5
3964_0,,,,2,3,2,5
C(C(CC(CCO)O)O)=O,,,4,1,2,13,15
3965_0,,,,2,3,2,5
3967_0,,,,2,3,2,5
C(C(CC(C(CO)O)O)O)=O,,,4,1,4,13,17
3968_0,,,,2,3,2,5
3969_0,,,,2,3,2,5
3971_0,,,,2,3,2,5
C(C(C(CO)C(C)O)O)=O,,,4,1,2,13,15
3972_0,,,,2,3,2,5
3974_0,,,,2,3,2,5
C(C(C(CO)C(C(CO)O)O)O)=O,,,4,1,5,13,18
3975_0,,,,2,3,2,5
3977_0,,,,2,3,2,5
C(C(C(CO)CO)O)=O,,,4,1,5,18,23
3978_0,,,,2,3,2,5
3980_0,,,,2,3,2,5
C(C(C(CO)C(CO)O)O)=O,,,4,1,4,12,16
3981_0,,,,2,3,2,5
3982_0,,,,2,3,2,5
3983_0,,,,2,3,2,5
3984_0,,,,2,3,2,5
3985_0,,,,2,3,2,5
3986_0,,,,2,3,2,5
3987_0,,,,2,3,2,5
3988_0,,,,2,3,2,5
3989_0,,,,2,3,2,5
3990_0,,,,2,3,2,5
3991_0,,,,2,3,2,5
3992_0,,,,2,3,2,5
3993_0,,,,2,3,2,5
3994_0,,,,2,3,2,5
3995_0,,,,2,3,2,5
3997_0,,,,2,3,2,5
C(C(C(C)(CCO)O)O)=O,,,4,1,1,17,18
3998_0,,,,2,3,2,5
3999_0,,,,2,3,2,5
4000_0,,,,2,3,2,5
4001_0,,,,2,3,2,5
4002_0,,,,2,3,2,5
4003_0,,,,2,3,2,5
4005_0,,,,2,3,2,5
CC(CCO)O,,,4,1,1,87,88
4007_0,,,,2,3,2,5
CC(C(CO)O)O,,,4,1,2,41,43
4009_0,,,,2,3,2,5
C(C(C(CCO)O)O)O,,,4,1,4,11,15
4011_0,,,,2,3,2,5
C(C(C(C(CCO)O)O)O)O,,,4,1,6,8,14
4013_0,,,,2,3,2,5
C(CCO)O,,,4,1,1,77,78
4015_0,,,,2,3,2,5
C(C(CCO)O)O,,,4,1,2,40,42
4016_0,,,,2,3,2,5
4017_0,,,,2,3,2,5
4018_0,,,,2,3,2,5
4019_0,,,,2,3,2,5
4020_0,,,,2,3,2,5
4021_0,,,,2,3,2,5
4022_0,,,,2,3,2,5
4024_0,,,,2,3,2,5
C(CCO)(O)=O,,,4,1,4,133,137
4025_0,,,,2,3,2,5
4027_0,,,,2,3,2,5
C(CC(CO)O)(O)=O,,,4,1,5,28,33
4029_0,,,,2,3,2,5
CC(C(CO)(C(C(CO)O)O)O)O,,,4,1,4,8,12
4030_0,,,,2,3,2,5
4031_0,,,,2,3,2,5
4032_0,,,,2,3,2,5
4033_0,,,,2,3,2,5
4034_0,,,,2,3,2,5
4035_0,,,,2,3,2,5
4036_0,,,,2,3,2,5
4037_0,,,,2,3,2,5
4038_0,,,,2,3,2,5
4040_0,,,,2,3,2,5
C(C)(C(CO)(C(CO)(CO)O)O)=O,,,4,1,7,9,16
4042_0,,,,2,3,2,5
C(C(CO)(C(CO)(CO)O)O)O,,,4,1,2,1,3
4044_0,,,,2,3,2,5
C(CO)(C(CO)(C(CO)(C)O)O)=O,,,4,1,7,11,18
4046_0,,,,2,3,2,5
C(CO)(C(CO)(C(CCO)O)O)=O,,,4,1,7,12,19
4048_0,,,,2,3,2,5
C(C(CO)(C(CO)(C)O)O)(O)=O,,,4,1,7,9,16
4050_0,,,,2,3,2,5
C(C(CO)(C(CCO)O)O)(O)=O,,,4,1,7,10,17
4052_0,,,,2,3,2,5
C(C(C)(C(C(C)=O)(CO)O)O)=O,,,4,1,7,15,22
4054_0,,,,2,3,2,5
C(C(C(C)=O)(C(CO)(C)O)O)=O,,,4,1,4,10,14
4056_0,,,,2,3,2,5
C(C(C)(C(CO)(CO)O)O)=O,,,4,1,3,7,10
4058_0,,,,2,3,2,5
C(C(CO)(C(CO)(C)O)O)=O,,,4,1,6,12,18
4060_0,,,,2,3,2,5
C(C(C)(C(CO)(C(CO)O)O)O)=O,,,4,1,7,11,18
4062_0,,,,2,3,2,5
C(C(C(CO)O)(C(CO)(C)O)O)=O,,,4,1,9,14,23
4063_0,,,,2,3,2,5
4064_0,,,,2,3,2,5
4065_0,,,,2,3,2,5
4066_0,,,,2,3,2,5
4068_0,,,,2,3,2,5
C(C(C(C)=O)(C(CCO)O)O)=O,,,4,1,4,11,15
4069_0,,,,2,3,2,5
4071_0,,,,2,3,2,5
C(C(CO)(C(CCO)O)O)=O,,,4,1,6,13,19
4072_0,,,,2,3,2,5
4074_0,,,,2,3,2,5
C(C(C(CO)O)(C(CCO)O)O)=O,,,4,1,9,15,24
4076_0,,,,2,3,2,5
C(C(CCO)(C(CO)(CO)O)O)=O,,,4,1,4,8,12
4078_0,,,,2,3,2,5
C(C(CO)(C(CO)(CCO)O)O)=O,,,4,1,7,13,20
4079_0,,,,2,3,2,5
4080_0,,,,2,3,2,5
4082_0,,,,2,3,2,5
C(C(CO)(C(C(CCO)O)O)O)=O,,,4,1,6,15,21
4084_0,,,,2,3,2,5
C(C(CC(C(CO)(CO)O)O)O)=O,,,4,1,3,9,12
4086_0,,,,2,3,2,5
C(C(CO)(C(CC(CO)O)O)O)=O,,,4,1,6,15,21
4087_0,,,,2,3,2,5
4088_0,,,,2,3,2,5
4089_0,,,,2,3,2,5
4091_0,,,,2,3,2,5
C(C)(C(CO)(C(C)O)O)=O,,,4,1,8,14,22
4093_0,,,,2,3,2,5
C(C)(C(CO)(C(C(CO)O)O)O)=O,,,4,1,10,14,24
4095_0,,,,2,3,2,5
C(C)(C(CO)(CO)O)=O,,,4,1,12,16,28
4097_0,,,,2,3,2,5
C(C)(C(CO)(C(CO)O)O)=O,,,4,1,10,13,23
4098_0,,,,2,3,2,5
4100_0,,,,2,3,2,5
C(C(C(C)(C(CO)(CO)O)O)O)=O,,,4,1,4,9,13
4102_0,,,,2,3,2,5
C(C(CO)(C(C)(C(CO)O)O)O)=O,,,4,1,7,14,21
4104_0,,,,2,3,2,5
CC(C(CO)(CO)O)O,,,4,1,2,6,8
4106_0,,,,2,3,2,5
CC(C(CO)(C(CO)O)O)O,,,4,1,6,6,12
4107_0,,,,2,3,2,5
4108_0,,,,2,3,2,5
4109_0,,,,2,3,2,5
4110_0,,,,2,3,2,5
4111_0,,,,2,3,2,5
4112_0,,,,2,3,2,5
4114_0,,,,2,3,2,5
C(C(C)(C(CO)(CC=O)O)O)=O,,,4,1,4,14,18
4116_0,,,,2,3,2,5
C(C(CCO)(C(C=O)(C)O)O)=O,,,4,1,3,13,16
4118_0,,,,2,3,2,5
C(C(C(CO)(C)O)(CC=O)O)=O,,,4,1,4,14,18
4120_0,,,,2,3,2,5
C(C(C(CO)(C)O)O)(O)=O,,,4,1,9,12,21
4121_0,,,,2,3,2,5
4122_0,,,,2,3,2,5
4123_0,,,,2,3,2,5
4125_0,,,,2,3,2,5
C(C(C(CC=O)O)(CCO)O)=O,,,4,1,3,15,18
4127_0,,,,2,3,2,5
C(C(C(CCO)O)(CC=O)O)=O,,,4,1,4,15,19
4129_0,,,,2,3,2,5
C(C(C(CCO)O)O)(O)=O,,,4,1,9,13,22
4131_0,,,,2,3,2,5
C(C(C(CO)(CCO)O)O)(O)=O,,,4,1,4,8,12
4133_0,,,,2,3,2,5
C(CC(CO)(C(C)O)O)=O,,,4,1,4,17,21
4135_0,,,,2,3,2,5
C(C(C(C)O)(CCO)O)=O,,,4,1,2,10,12
4136_0,,,,2,3,2,5
4138_0,,,,2,3,2,5
C(C(CCO)(C(C(CO)O)O)O)=O,,,4,1,7,13,20
4139_0,,,,2,3,2,5
4141_0,,,,2,3,2,5
C(C(CO)(CCO)O)=O,,,4,1,4,14,18
4142_0,,,,2,3,2,5
4143_0,,,,2,3,2,5
4145_0,,,,2,3,2,5
C(C(C(C(CCO)O)O)O)(O)=O,,,4,1,6,10,16
4147_0,,,,2,3,2,5
C(C(C(CC(CO)O)O)O)(O)=O,,,4,1,5,10,15
4148_0,,,,2,3,2,5
4150_0,,,,2,3,2,5
C(C(C(C)(C(CO)O)O)O)(O)=O,,,4,1,6,9,15
4151_0,,,,2,3,2,5
4152_0,,,,2,3,2,5
4153_0,,,,2,3,2,5
4155_0,,,,2,3,2,5
C(CCO)(C(CO)(CO)O)=O,,,4,1,6,9,15
4157_0,,,,2,3,2,5
C(C(CO)O)(C(CO)CO)=O,,,4,1,8,12,20
4159_0,,,,2,3,2,5
C=CC(CO)=O,,,4,1,46,481,527
4161_0,,,,2,3,2,5
C(CO)=CC=O,,,4,1,9,292,301
4162_0,,,,2,3,2,5
4163_0,,,,2,3,2,5
4164_0,,,,2,3,2,5
4165_0,,,,2,3,2,5
4166_0,,,,2,3,2,5
4167_0,,,,2,3,2,5
4168_0,,,,2,3,2,5
4169_0,,,,2,3,2,5
4170_0,,,,2,3,2,5
4172_0,,,,2,3,2,5
C(C(C(C=O)O)C(C=O)O)(O)=O,,,4,1,3,7,10
4173_0,,,,2,3,2,5
4174_0,,,,2,3,2,5
4175_0,,,,2,3,2,5
4176_0,,,,2,3,2,5
4177_0,,,,2,3,2,5
4178_0,,,,2,3,2,5
4179_0,,,,2,3,2,5
4180_0,,,,2,3,2,5
4181_0,,,,2,3,2,5
4183_0,,,,2,3,2,5
C(CC(CO)(CO)O)(O)=O,,,4,1,2,6,8
4184_0,,,,2,3,2,5
4185_0,,,,2,3,2,5
4186_0,,,,2,3,2,5
4188_0,,,,2,3,2,5
C(CC(CO)(C(CO)O)O)(O)=O,,,4,1,4,8,12
4189_0,,,,2,3,2,5
4191_0,,,,2,3,2,5
C(CC(C(CO)(CO)O)O)(O)=O,,,4,1,3,5,8
4192_0,,,,2,3,2,5
4193_0,,,,2,3,2,5
4194_0,,,,2,3,2,5
4195_0,,,,2,3,2,5
4196_0,,,,2,3,2,5
4197_0,,,,2,3,2,5
4198_0,,,,2,3,2,5
4199_0,,,,2,3,2,5
4201_0,,,,2,3,2,5
C(C(C(C(O)=O)C(C=O)(C)O)O)=O,,,4,1,4,12,16
4202_0,,,,2,3,2,5
4203_0,,,,2,3,2,5
4204_0,,,,2,3,2,5
4205_0,,,,2,3,2,5
4206_0,,,,2,3,2,5
4207_0,,,,2,3,2,5
4208_0,,,,2,3,2,5
4210_0,,,,2,3,2,5
C(C(C)(CC(O)=O)O)=O,,,4,1,2,16,18
4211_0,,,,2,3,2,5
4212_0,,,,2,3,2,5
4213_0,,,,2,3,2,5
4214_0,,,,2,3,2,5
4215_0,,,,2,3,2,5
4216_0,,,,2,3,2,5
4217_0,,,,2,3,2,5
4219_0,,,,2,3,2,5
C(C(C(C=O)O)C(C(C)=O)O)(O)=O,,,4,1,4,12,16
4220_0,,,,2,3,2,5
4221_0,,,,2,3,2,5
4222_0,,,,2,3,2,5
4224_0,,,,2,3,2,5
C(CC(C(C)=O)O)(O)=O,,,4,1,5,28,33
4225_0,,,,2,3,2,5
4226_0,,,,2,3,2,5
4227_0,,,,2,3,2,5
4228_0,,,,2,3,2,5
4229_0,,,,2,3,2,5
4230_0,,,,2,3,2,5
4231_0,,,,2,3,2,5
4232_0,,,,2,3,2,5
4233_0,,,,2,3,2,5
4234_0,,,,2,3,2,5
4235_0,,,,2,3,2,5
4236_0,,,,2,3,2,5
4237_0,,,,2,3,2,5
4238_0,,,,2,3,2,5
4239_0,,,,2,3,2,5
4240_0,,,,2,3,2,5
4241_0,,,,2,3,2,5
4242_0,,,,2,3,2,5
4243_0,,,,2,3,2,5
4244_0,,,,2,3,2,5
4245_0,,,,2,3,2,5
4246_0,,,,2,3,2,5
4247_0,,,,2,3,2,5
4248_0,,,,2,3,2,5
4250_0,,,,2,3,2,5
C(C(C(CC=O)O)C(C=O)O)(O)=O,,,4,1,5,16,21
4251_0,,,,2,3,2,5
4252_0,,,,2,3,2,5
4253_0,,,,2,3,2,5
4254_0,,,,2,3,2,5
4255_0,,,,2,3,2,5
4256_0,,,,2,3,2,5
4257_0,,,,2,3,2,5
4258_0,,,,2,3,2,5
4259_0,,,,2,3,2,5
4260_0,,,,2,3,2,5
4261_0,,,,2,3,2,5
4262_0,,,,2,3,2,5
4263_0,,,,2,3,2,5
4264_0,,,,2,3,2,5
4265_0,,,,2,3,2,5
4266_0,,,,2,3,2,5
4267_0,,,,2,3,2,5
4268_0,,,,2,3,2,5
4269_0,,,,2,3,2,5
4270_0,,,,2,3,2,5
4271_0,,,,2,3,2,5
4272_0,,,,2,3,2,5
4273_0,,,,2,3,2,5
4274_0,,,,2,3,2,5
4275_0,,,,2,3,2,5
4276_0,,,,2,3,2,5
4277_0,,,,2,3,2,5
4279_0,,,,2,3,2,5
C(C(CCO)(CC(O)=O)O)=O,,,4,1,1,9,10
4280_0,,,,2,3,2,5
4281_0,,,,2,3,2,5
4282_0,,,,2,3,2,5
4284_0,,,,2,3,2,5
C(CC(C(CCO)=O)O)(O)=O,,,4,1,3,11,14
4285_0,,,,2,3,2,5
4286_0,,,,2,3,2,5
4287_0,,,,2,3,2,5
4288_0,,,,2,3,2,5
4289_0,,,,2,3,2,5
4290_0,,,,2,3,2,5
4291_0,,,,2,3,2,5
4293_0,,,,2,3,2,5
C(CC(CC(C=O)O)O)(O)=O,,,4,1,2,12,14
4294_0,,,,2,3,2,5
4295_0,,,,2,3,2,5
4296_0,,,,2,3,2,5
4297_0,,,,2,3,2,5
4299_0,,,,2,3,2,5
C(C(C(C)O)C(C=O)O)(O)=O,,,4,1,4,12,16
4300_0,,,,2,3,2,5
4302_0,,,,2,3,2,5
C(C(CO)C(C=O)O)(O)=O,,,4,1,5,16,21
4303_0,,,,2,3,2,5
4305_0,,,,2,3,2,5
C(C(C(CO)O)C(C=O)O)(O)=O,,,4,1,5,13,18
4306_0,,,,2,3,2,5
4307_0,,,,2,3,2,5
4308_0,,,,2,3,2,5
4309_0,,,,2,3,2,5
4310_0,,,,2,3,2,5
4311_0,,,,2,3,2,5
4312_0,,,,2,3,2,5
4313_0,,,,2,3,2,5
4314_0,,,,2,3,2,5
4315_0,,,,2,3,2,5
4316_0,,,,2,3,2,5
4317_0,,,,2,3,2,5
4318_0,,,,2,3,2,5
4320_0,,,,2,3,2,5
C(CC(C)(C(C=O)O)O)(O)=O,,,4,1,3,13,16
4321_0,,,,2,3,2,5
4322_0,,,,2,3,2,5
4323_0,,,,2,3,2,5
4324_0,,,,2,3,2,5
4325_0,,,,2,3,2,5
4327_0,,,,2,3,2,5
C(CC(C)O)(O)=O,,,4,1,2,66,68
4328_0,,,,2,3,2,5
4330_0,,,,2,3,2,5
C(CC(C(CO)O)O)(O)=O,,,4,1,4,10,14
4332_0,,,,2,3,2,5
C(CC(C(C(CO)O)O)O)(O)=O,,,4,1,6,10,16
4333_0,,,,2,3,2,5
4334_0,,,,2,3,2,5
4335_0,,,,2,3,2,5
4336_0,,,,2,3,2,5
4338_0,,,,2,3,2,5
C(C(C(C(CO)O)O)=O)(O)=O,,,4,1,3,13,16
4340_0,,,,2,3,2,5
C(C(C(C(C(CO)O)O)O)=O)(O)=O,,,4,1,3,15,18
4341_0,,,,2,3,2,5
4342_0,,,,2,3,2,5
4344_0,,,,2,3,2,5
C(C(O)=O)(O)=O,,,4,1,1,1,2
4346_0,,,,2,3,2,5
C(CC(O)=O)(O)=O,,,4,1,1,47,48
4348_0,,,,2,3,2,5
C(CC(C(O)=O)O)(O)=O,,,4,1,5,17,22
4349_0,,,,2,3,2,5
4351_0,,,,2,3,2,5
C(CO)(C(CO)(C(C(O)=O)O)O)=O,,,4,1,8,14,22
4353_0,,,,2,3,2,5
C(C(CO)(C(C(O)=O)O)O)(O)=O,,,4,1,8,11,19
4355_0,,,,2,3,2,5
C(C(C(C)=O)(C(C=O)O)O)(O)=O,,,4,1,6,14,20
4357_0,,,,2,3,2,5
C(C(C(C)=O)(C(C(O)=O)O)O)=O,,,4,1,5,11,16
4358_0,,,,2,3,2,5
4360_0,,,,2,3,2,5
C(C(CO)(C(C(O)=O)O)O)=O,,,4,1,9,16,25
4361_0,,,,2,3,2,5
4363_0,,,,2,3,2,5
C(C(C(CO)O)(C(C(O)=O)O)O)=O,,,4,1,10,17,27
4364_0,,,,2,3,2,5
4366_0,,,,2,3,2,5
C(C(CO)(C(C(O)=O)(C)O)O)(O)=O,,,4,1,8,11,19
4368_0,,,,2,3,2,5
C(C(CO)(C(CC(O)=O)O)O)(O)=O,,,4,1,7,11,18
4370_0,,,,2,3,2,5
C(C(C)(C(C(O)=O)(C(C)=O)O)O)=O,,,4,1,5,11,16
4372_0,,,,2,3,2,5
C(C(C)(C(C=O)(C(C)=O)O)O)(O)=O,,,4,1,4,9,13
4373_0,,,,2,3,2,5
4375_0,,,,2,3,2,5
C(C(C)(C(C=O)(CO)O)O)(O)=O,,,4,1,7,14,21
4377_0,,,,2,3,2,5
C(C(C(C)=O)(C(C(C)=O)O)O)(O)=O,,,4,1,5,12,17
4378_0,,,,2,3,2,5
4380_0,,,,2,3,2,5
C(CC(C(C(O)=O)(C(C)=O)O)O)=O,,,4,1,5,12,17
4382_0,,,,2,3,2,5
C(CC(C(C=O)(C(C)=O)O)O)(O)=O,,,4,1,3,9,12
4383_0,,,,2,3,2,5
4385_0,,,,2,3,2,5
C(C(CO)(C(CC(O)=O)O)O)=O,,,4,1,6,14,20
4387_0,,,,2,3,2,5
C(C(C(C)=O)(C(C)O)O)(O)=O,,,4,1,7,9,16
4389_0,,,,2,3,2,5
C(C(C(C)=O)(CO)O)(O)=O,,,4,1,7,11,18
4391_0,,,,2,3,2,5
C(C(C(C)=O)(C(CO)O)O)(O)=O,,,4,1,7,11,18
4392_0,,,,2,3,2,5
4393_0,,,,2,3,2,5
4395_0,,,,2,3,2,5
C(C(CC=O)(C(C=O)O)O)(O)=O,,,4,1,5,16,21
4397_0,,,,2,3,2,5
C(CC(C=O)(C(C=O)O)O)(O)=O,,,4,1,4,14,18
4399_0,,,,2,3,2,5
C(C(C(C=O)(CC=O)O)O)(O)=O,,,4,1,4,15,19
4401_0,,,,2,3,2,5
C(C(C(C(O)=O)O)O)(O)=O,,,4,1,6,10,16
4403_0,,,,2,3,2,5
C(CC(C(O)=O)(C(C=O)(C)O)O)=O,,,4,1,3,12,15
4405_0,,,,2,3,2,5
C(CC(C=O)(C(C=O)(C)O)O)(O)=O,,,4,1,3,11,14
4407_0,,,,2,3,2,5
C(C(C)(C(C=O)(CC=O)O)O)(O)=O,,,4,1,3,12,15
4409_0,,,,2,3,2,5
C(C(C)(C(C(O)=O)O)O)(O)=O,,,4,1,6,9,15
4411_0,,,,2,3,2,5
C(C(CC=O)(C(C(C)=O)O)O)(O)=O,,,4,1,4,13,17
4413_0,,,,2,3,2,5
C(CC(C=O)(C(C(C)=O)O)O)(O)=O,,,4,1,4,12,16
4415_0,,,,2,3,2,5
C(C(C(CC=O)O)(CC=O)O)(O)=O,,,4,1,2,17,19
4417_0,,,,2,3,2,5
C(CC(C(C=O)(CC(O)=O)O)O)=O,,,4,1,2,13,15
4419_0,,,,2,3,2,5
C(CC(C(C=O)(CC=O)O)O)(O)=O,,,4,1,2,13,15
4421_0,,,,2,3,2,5
C(CC(C(C(O)=O)O)O)(O)=O,,,4,1,5,10,15
4423_0,,,,2,3,2,5
C(C(CCO)(C(C(O)=O)O)O)(O)=O,,,4,1,5,10,15
4425_0,,,,2,3,2,5
C(C(C(C)O)(CC=O)O)(O)=O,,,4,1,4,13,17
4427_0,,,,2,3,2,5
C(C(C(C)O)(CC(O)=O)O)=O,,,4,1,2,10,12
4429_0,,,,2,3,2,5
C(C(CO)(CC=O)O)(O)=O,,,4,1,7,17,24
4431_0,,,,2,3,2,5
C(C(CO)(CC(O)=O)O)=O,,,4,1,2,12,14
4433_0,,,,2,3,2,5
C(C(C(CO)O)(CC=O)O)(O)=O,,,4,1,6,14,20
4435_0,,,,2,3,2,5
C(C(C(CO)O)(CC(O)=O)O)=O,,,4,1,3,12,15
4437_0,,,,2,3,2,5
C(CC(C(C(C(O)=O)O)O)O)(O)=O,,,4,1,6,11,17
4439_0,,,,2,3,2,5
C(C(C(CC(C(O)=O)O)O)O)(O)=O,,,4,1,3,11,14
4441_0,,,,2,3,2,5
C(CC(CO)(C(C(O)=O)O)O)(O)=O,,,4,1,4,9,13
4443_0,,,,2,3,2,5
C(C(C(C)(C(C(O)=O)O)O)O)(O)=O,,,4,1,4,6,10
4444_0,,,,2,3,2,5
4445_0,,,,2,3,2,5
4447_0,,,,2,3,2,5
C(C(CO)(CC(CO)=O)O)(O)=O,,,4,1,4,10,14
4449_0,,,,2,3,2,5
C(C(C(CCO)=O)(CO)O)(O)=O,,,4,1,7,10,17
4450_0,,,,2,3,2,5
4452_0,,,,2,3,2,5
C=CC(C(O)=O)=O,,,4,1,5,107,112
4454_0,,,,2,3,2,5
C(C=CC(O)=O)=O,,,4,1,4,168,172
4455_0,,,,2,1,1,2
4455_1,,,,2,1,1,2
4457_0,,,,2,1,1,2
C(C1(C(CC(C1O)=O)O)O)=O,,,4,1,4,20,24
4457_1,,,,2,1,1,2
4458_0,,,,2,1,1,2
4458_1,,,,2,1,1,2
4460_0,,,,2,1,1,2
C(CO)(C1(C(C(CC1O)O)O)O)=O,,,4,1,4,15,19
4460_1,,,,2,1,1,2
4461_0,,,,2,1,1,2
4461_1,,,,2,1,1,2
4462_0,,,,2,1,1,2
4462_1,,,,2,1,1,2
4463_0,,,,2,1,1,2
4463_1,,,,2,1,1,2
4464_0,,,,2,1,1,2
4464_1,,,,2,1,1,2
4465_0,,,,2,1,1,2
4465_1,,,,2,1,1,2
4466_0,,,,2,1,1,2
4466_1,,,,2,1,1,2
4467_0,,,,2,1,1,2
4467_1,,,,2,1,1,2
4468_0,,,,2,1,1,2
4468_1,,,,2,1,1,2
4469_0,,,,2,1,1,2
4469_1,,,,2,1,1,2
4470_0,,,,2,1,1,2
4470_1,,,,2,1,1,2
4472_0,,,,2,1,1,2
C(C1(C=O)C(C(CC1O)O)O)=O,,,4,1,2,12,14
4473_0,,,,2,1,1,2
4475_0,,,,2,1,1,2
C(C1(C(C(CC1O)O)O)O)=O,,,4,1,4,16,20
4475_1,,,,2,1,1,2
4476_0,,,,2,1,1,2
4476_1,,,,2,1,1,2
4478_0,,,,2,1,1,2
C(C1(C(C(CC1O)O)O)O)(O)=O,,,4,1,5,13,18
4478_1,,,,2,1,1,2
4479_0,,,,2,1,1,2
4479_1,,,,2,1,1,2
4481_0,,,,2,1,1,2
C1(CC(C(C1(CO)O)O)O)=O,,,4,1,6,15,21
4481_1,,,,2,1,1,2
4483_0,,,,2,2,1,3
C(CO)(C(C(C)O)(C(C=O)O)O)=O,,,4,1,6,18,24
4483_1,,,,2,2,1,3
4484_0,,,,2,2,1,3
4484_1,,,,2,2,1,3
4485_0,,,,2,2,1,3
4485_1,,,,2,2,1,3
4486_0,,,,2,2,1,3
4486_1,,,,2,2,1,3
4488_0,,,,2,2,1,3
C(C(C=O)(C(C=O)O)C(C=O)O)=O,,,4,1,1,6,7
4490_0,,,,2,2,1,3
C(C(C=O)(C(C)O)C(C=O)O)=O,,,4,1,2,11,13
4492_0,,,,2,2,1,3
C(C(C=O)(CO)C(C=O)O)=O,,,4,1,4,11,15
4494_0,,,,2,2,1,3
C(C(C=O)(C(CO)O)C(C=O)O)=O,,,4,1,3,12,15
4496_0,,,,2,2,1,3
C(C(C(C(C=O)=O)(CO)CO)O)=O,,,4,1,2,10,12
4498_0,,,,2,2,1,3
C(C(CO)(C(C=O)O)C(C=O)O)=O,,,4,1,4,9,13
4500_0,,,,2,2,1,3
C(CO)(C(C=O)(CO)C(C=O)O)=O,,,4,1,3,13,16
4502_0,,,,2,2,1,3
C(C(CO)(C(C=O)O)O)(CC=O)=O,,,4,1,6,21,27
4502_1,,,,2,2,1,3
4503_0,,,,2,2,1,3
4503_1,,,,2,2,1,3
4504_0,,,,2,2,1,3
4504_1,,,,2,2,1,3
4506_0,,,,2,2,1,3
C(C(C(CCO)O)(C(C=O)O)O)=O,,,4,1,8,18,26
4506_1,,,,2,2,1,3
4508_0,,,,2,2,1,3
C(C(C(CO)(C)O)(C(C=O)O)O)=O,,,4,1,7,17,24
4508_1,,,,2,2,1,3
4510_0,,,,2,2,1,3
C(C(C(C=O)(C(C=O)O)O)O)(O)=O,,,4,1,6,19,25
4510_1,,,,2,2,1,3
4512_0,,,,2,2,1,3
C(C(C(C=O)(C(C=O)O)O)O)=O,,,4,1,4,12,16
4512_1,,,,2,2,1,3
4514_0,,,,2,2,1,3
C(C(C(C=O)(C(C=O)(C)O)O)O)=O,,,4,1,7,18,25
4514_1,,,,2,2,1,3
4516_0,,,,2,2,1,3
C(C(C(C=O)(C(C(C)=O)O)O)O)=O,,,4,1,8,20,28
4516_1,,,,2,2,1,3
4518_0,,,,2,2,1,3
C(CC(C(C=O)(C(C=O)O)O)O)=O,,,4,1,6,23,29
4518_1,,,,2,2,1,3
4519_0,,,,2,2,1,3
4519_1,,,,2,2,1,3
4520_0,,,,2,2,1,3
4520_1,,,,2,2,1,3
4521_0,,,,2,2,1,3
4521_1,,,,2,2,1,3
4523_0,,,,2,2,1,3
C(C(C=O)(CO)C(CO)(CO)O)=O,,,4,1,3,7,10
4525_0,,,,2,2,1,3
C(C(C(C)O)(C(CO)(CO)O)O)=O,,,4,1,6,11,17
4525_1,,,,2,2,1,3
4526_0,,,,2,2,1,3
4526_1,,,,2,2,1,3
4527_0,,,,2,2,1,3
4527_1,,,,2,2,1,3
4528_0,,,,2,2,1,3
4528_1,,,,2,2,1,3
4529_0,,,,2,2,1,3
4529_1,,,,2,2,1,3
4530_0,,,,2,2,1,3
4530_1,,,,2,2,1,3
4531_0,,,,2,2,1,3
4531_1,,,,2,2,1,3
4533_0,,,,2,2,1,3
C(CO)(C(C(C)O)(C(C)O)O)=O,,,4,1,2,6,8
4533_1,,,,2,2,1,3
4534_0,,,,2,2,1,3
4534_1,,,,2,2,1,3
4536_0,,,,2,2,1,3
C(CO)(C(C(CO)O)(C(C)O)O)=O,,,4,1,6,13,19
4536_1,,,,2,2,1,3
4537_0,,,,2,2,1,3
4537_1,,,,2,2,1,3
4538_0,,,,2,2,1,3
4538_1,,,,2,2,1,3
4539_0,,,,2,2,1,3
4539_1,,,,2,2,1,3
4540_0,,,,2,2,1,3
4540_1,,,,2,2,1,3
4541_0,,,,2,2,1,3
4541_1,,,,2,2,1,3
4542_0,,,,2,2,1,3
4542_1,,,,2,2,1,3
4544_0,,,,2,2,1,3
C(C(C=O)(C(C)O)C(C=O)(C)O)=O,,,4,1,2,9,11
4546_0,,,,2,2,1,3
C(C(C=O)(CO)C(C=O)(C)O)=O,,,4,1,2,10,12
4547_0,,,,2,2,1,3
4547_1,,,,2,2,1,3
4549_0,,,,2,2,1,3
C(C(C(C)O)(C(C=O)(C)O)O)=O,,,4,1,5,16,21
4549_1,,,,2,2,1,3
4550_0,,,,2,2,1,3
4550_1,,,,2,2,1,3
4551_0,,,,2,2,1,3
4551_1,,,,2,2,1,3
4553_0,,,,2,2,1,3
C(C(C=O)(C(C)O)C(C(C)=O)O)=O,,,4,1,2,9,11
4555_0,,,,2,2,1,3
C(C(C=O)(CO)C(C(C)=O)O)=O,,,4,1,3,10,13
4556_0,,,,2,2,1,3
4556_1,,,,2,2,1,3
4557_0,,,,2,2,1,3
4557_1,,,,2,2,1,3
4558_0,,,,2,2,1,3
4558_1,,,,2,2,1,3
4559_0,,,,2,2,1,3
4559_1,,,,2,2,1,3
4561_0,,,,2,2,1,3
C(C(C(C(C)=O)(C(C=O)O)O)O)=O,,,4,1,2,10,12
4561_1,,,,2,2,1,3
4563_0,,,,2,2,1,3
C(C)(C(C(C)O)(C(C=O)O)O)=O,,,4,1,4,17,21
4563_1,,,,2,2,1,3
4564_0,,,,2,2,1,3
4564_1,,,,2,2,1,3
4566_0,,,,2,2,1,3
C(C)(C(C(CO)O)(C(C=O)O)O)=O,,,4,1,8,18,26
4566_1,,,,2,2,1,3
4568_0,,,,2,2,1,3
C(C(C=O)(C(CC=O)O)C(C)O)=O,,,4,1,2,10,12
4570_0,,,,2,2,1,3
C(C(C=O)(CO)C(CC=O)O)=O,,,4,1,3,12,15
4571_0,,,,2,2,1,3
4571_1,,,,2,2,1,3
4573_0,,,,2,2,1,3
C(C(C(CC=O)O)(C(C)O)O)=O,,,4,1,5,18,23
4573_1,,,,2,2,1,3
4574_0,,,,2,2,1,3
4574_1,,,,2,2,1,3
4575_0,,,,2,2,1,3
4575_1,,,,2,2,1,3
4577_0,,,,2,2,1,3
C(C(C=O)(C(C)O)C(CCO)O)=O,,,4,1,3,9,12
4579_0,,,,2,2,1,3
C(C(C=O)(C(C)O)C(C)(CO)O)=O,,,4,1,3,9,12
4581_0,,,,2,2,1,3
C(C(C=O)(C(C)O)C(C(O)=O)O)=O,,,4,1,3,9,12
4582_0,,,,2,2,1,3
4583_0,,,,2,2,1,3
4584_0,,,,2,2,1,3
4585_0,,,,2,2,1,3
4587_0,,,,2,2,1,3
C(C(C=O)(C(C)O)C(C)O)=O,,,4,1,1,5,6
4589_0,,,,2,2,1,3
C(C(C=O)(CO)C(C)O)=O,,,4,1,2,8,10
4591_0,,,,2,2,1,3
C(C(C=O)(C(CO)O)C(C)O)=O,,,4,1,3,10,13
4593_0,,,,2,2,1,3
C(C(C=O)(CO)C(C(CO)O)O)=O,,,4,1,4,11,15
4595_0,,,,2,2,1,3
C(C(C=O)(CO)C(CC(C)O)O)=O,,,4,1,2,9,11
4597_0,,,,2,2,1,3
C(C(C=O)(CO)C(CCO)O)=O,,,4,1,3,9,12
4599_0,,,,2,2,1,3
C(C(C=O)(CO)C(C=O)(CO)O)=O,,,4,1,3,11,14
4601_0,,,,2,2,1,3
C(C(C=O)(CO)C(C(CO)=O)O)=O,,,4,1,2,11,13
4603_0,,,,2,2,1,3
C(C(C=O)(CO)C(C)(CO)O)=O,,,4,1,3,9,12
4605_0,,,,2,2,1,3
C(C(C=O)(CO)C(C(O)=O)O)=O,,,4,1,3,9,12
4607_0,,,,2,2,1,3
C(C(C=O)(CO)C(C(O)=O)(C)O)=O,,,4,1,3,9,12
4609_0,,,,2,2,1,3
C(C(C=O)(CO)C(CC(O)=O)O)=O,,,4,1,3,8,11
4611_0,,,,2,2,1,3
C(C(C=O)(CO)C(C=O)(C=C)O)=O,,,4,1,2,7,9
4613_0,,,,2,2,1,3
C(C(C=O)(CO)C(C(C=C)=O)O)=O,,,4,1,2,8,10
4615_0,,,,2,2,1,3
C(C(C=O)(CO)C(C=CC=O)O)=O,,,4,1,2,6,8
4616_0,,,,2,2,1,3
4617_0,,,,2,2,1,3
4618_0,,,,2,2,1,3
4619_0,,,,2,2,1,3
4620_0,,,,2,2,1,3
4621_0,,,,2,2,1,3
4622_0,,,,2,2,1,3
4624_0,,,,2,2,1,3
C(C(C=O)(CO)CO)=O,,,4,1,1,8,9
4626_0,,,,2,2,1,3
C(C(C=O)(CO)C(CO)O)=O,,,4,1,3,9,12
4627_0,,,,2,2,1,3
4627_1,,,,2,2,1,3
4628_0,,,,2,2,1,3
4629_0,,,,2,2,1,3
4630_0,,,,2,2,1,3
4632_0,,,,2,2,1,3
C(C(C=O)(C(CO)O)C(CO)O)=O,,,4,1,2,6,8
4633_0,,,,2,2,1,3
4633_1,,,,2,2,1,3
4634_0,,,,2,2,1,3
4634_1,,,,2,2,1,3
4636_0,,,,2,2,1,3
C(C(CO)(C(C=O)O)O)(CCO)=O,,,4,1,11,18,29
4636_1,,,,2,2,1,3
4638_0,,,,2,2,1,3
C(C(C(CO)(C(C)O)C(C)O)=O)=O,,,4,1,2,8,10
4640_0,,,,2,2,1,3
C(C(C(CO)(CO)C(C)O)=O)=O,,,4,1,2,11,13
4641_0,,,,2,2,1,3
4642_0,,,,2,2,1,3
4644_0,,,,2,2,1,3
C(C(C(CO)(CO)CO)=O)=O,,,4,1,1,7,8
4646_0,,,,2,2,1,3
C(C(C(CO)(CO)C(CO)O)=O)=O,,,4,1,3,11,14
4647_0,,,,2,2,1,3
4648_0,,,,2,2,1,3
4648_1,,,,2,2,1,3
4649_0,,,,2,2,1,3
4649_1,,,,2,2,1,3
4651_0,,,,2,2,1,3
C(C(C(C)O)(C(C)O)C(C=O)O)=O,,,4,1,3,9,12
4653_0,,,,2,2,1,3
C(C(CO)(C(C)O)C(C=O)O)=O,,,4,1,5,14,19
4654_0,,,,2,2,1,3
4655_0,,,,2,2,1,3
4657_0,,,,2,2,1,3
C(C(CO)(CO)C(C=O)O)=O,,,4,1,4,11,15
4659_0,,,,2,2,1,3
C(C(CO)(C(CO)O)C(C=O)O)=O,,,4,1,6,15,21
4660_0,,,,2,2,1,3
4661_0,,,,2,2,1,3
4661_1,,,,2,2,1,3
4662_0,,,,2,2,1,3
4662_1,,,,2,2,1,3
4664_0,,,,2,2,1,3
C(C(C(CO)=O)(C(C)O)C(C)O)=O,,,4,1,2,6,8
4666_0,,,,2,2,1,3
C(C(C(CO)=O)(CO)C(C)O)=O,,,4,1,3,9,12
4667_0,,,,2,2,1,3
4668_0,,,,2,2,1,3
4670_0,,,,2,2,1,3
C(C(C(CO)=O)(CO)CO)=O,,,4,1,4,8,12
4672_0,,,,2,2,1,3
C(C(C(CO)=O)(CO)C(CO)O)=O,,,4,1,4,11,15
4673_0,,,,2,2,1,3
4675_0,,,,2,2,1,3
C(CC(C(C(C)O)(C(C)O)O)=O)=O,,,4,1,2,8,10
4675_1,,,,2,2,1,3
4677_0,,,,2,2,1,3
C(CC(C(CO)(C(C)O)O)=O)=O,,,4,1,6,16,22
4677_1,,,,2,2,1,3
4678_0,,,,2,2,1,3
4678_1,,,,2,2,1,3
4679_0,,,,2,2,1,3
4679_1,,,,2,2,1,3
4681_0,,,,2,2,1,3
C(CC(C(CO)(CO)O)=O)=O,,,4,1,7,12,19
4681_1,,,,2,2,1,3
4683_0,,,,2,2,1,3
C(CC(C(CO)(C(CO)O)O)=O)=O,,,4,1,7,16,23
4683_1,,,,2,2,1,3
4684_0,,,,2,2,1,3
4684_1,,,,2,2,1,3
4685_0,,,,2,2,1,3
4685_1,,,,2,2,1,3
4686_0,,,,2,2,1,3
4686_1,,,,2,2,1,3
4687_0,,,,2,2,1,3
4687_1,,,,2,2,1,3
4688_0,,,,2,2,1,3
4688_1,,,,2,2,1,3
4689_0,,,,2,2,1,3
4689_1,,,,2,2,1,3
4690_0,,,,2,2,1,3
4690_1,,,,2,2,1,3
4691_0,,,,2,2,1,3
4691_1,,,,2,2,1,3
4692_0,,,,2,2,1,3
4692_1,,,,2,2,1,3
4693_0,,,,2,2,1,3
4693_1,,,,2,2,1,3
4694_0,,,,2,2,1,3
4694_1,,,,2,2,1,3
4695_0,,,,2,2,1,3
4695_1,,,,2,2,1,3
4696_0,,,,2,2,1,3
4696_1,,,,2,2,1,3
4697_0,,,,2,2,1,3
4697_1,,,,2,2,1,3
4698_0,,,,2,2,1,3
4698_1,,,,2,2,1,3
4700_0,,,,2,2,1,3
C(C(C(C)O)(C(CC(C)O)O)O)=O,,,4,1,4,14,18
4700_1,,,,2,2,1,3
4702_0,,,,2,2,1,3
C(C)(C(CO)(C(CC(C)O)O)O)=O,,,4,1,5,12,17
4702_1,,,,2,2,1,3
4704_0,,,,2,2,1,3
C1(COCC1(C(CC(C)O)O)O)=O,,,4,1,2,8,10
4704_1,,,,2,2,1,3
4706_0,,,,2,2,1,3
C1(C(C(CO1)O)C(CC(C)O)O)=O,,,4,1,1,8,9
4708_0,,,,2,2,1,3
C(C(CO)(C(CC(C)O)O)O)=O,,,4,1,5,14,19
4708_1,,,,2,2,1,3
4710_0,,,,2,2,1,3
C(C(CO)(C(CC(C)O)O)O)(O)=O,,,4,1,6,11,17
4710_1,,,,2,2,1,3
4712_0,,,,2,2,1,3
C(C(C(C)=O)(C(CC(C)O)O)O)=O,,,4,1,2,10,12
4712_1,,,,2,2,1,3
4714_0,,,,2,2,1,3
C(C(C(C)O)(C(CCO)O)O)=O,,,4,1,5,14,19
4714_1,,,,2,2,1,3
4716_0,,,,2,2,1,3
C(C(C(C)O)(C(C=O)(CO)O)O)=O,,,4,1,10,19,29
4716_1,,,,2,2,1,3
4717_0,,,,2,2,1,3
4717_1,,,,2,2,1,3
4719_0,,,,2,2,1,3
C(C(C(C)O)(C(CO)(C)O)O)=O,,,4,1,5,13,18
4719_1,,,,2,2,1,3
4721_0,,,,2,2,1,3
C(C(C(C)O)(C(C(O)=O)O)O)=O,,,4,1,7,15,22
4721_1,,,,2,2,1,3
4723_0,,,,2,2,1,3
C(C(C)(C(C=O)(C(C)O)O)O)(O)=O,,,4,1,7,14,21
4723_1,,,,2,2,1,3
4725_0,,,,2,2,1,3
C(C(C(CC(O)=O)O)(C(C)O)O)=O,,,4,1,5,14,19
4725_1,,,,2,2,1,3
4727_0,,,,2,2,1,3
C(C(C=C)(C(C=O)(C(C)O)O)O)=O,,,4,1,5,13,18
4727_1,,,,2,2,1,3
4729_0,,,,2,2,1,3
C(C(C(C)O)(C(C(C=C)=O)O)O)=O,,,4,1,6,16,22
4729_1,,,,2,2,1,3
4731_0,,,,2,2,1,3
C(C(C(C)O)(C(C=CC=O)O)O)=O,,,4,1,4,12,16
4731_1,,,,2,2,1,3
4732_0,,,,2,2,1,3
4732_1,,,,2,2,1,3
4733_0,,,,2,2,1,3
4733_1,,,,2,2,1,3
4734_0,,,,2,2,1,3
4734_1,,,,2,2,1,3
4735_0,,,,2,2,1,3
4735_1,,,,2,2,1,3
4736_0,,,,2,2,1,3
4736_1,,,,2,2,1,3
4737_0,,,,2,2,1,3
4737_1,,,,2,2,1,3
4739_0,,,,2,2,1,3
C(C(C(C)O)(C(C)O)O)=O,,,4,1,2,8,10
4739_1,,,,2,2,1,3
4740_0,,,,2,2,1,3
4740_1,,,,2,2,1,3
4741_0,,,,2,2,1,3
4741_1,,,,2,2,1,3
4743_0,,,,2,2,1,3
C(C(CO)(C(C(C(C)O)O)O)O)=O,,,4,1,7,16,23
4743_1,,,,2,2,1,3
4745_0,,,,2,2,1,3
C(C(C(CO)(C(CCO)O)O)=O)=O,,,4,1,6,16,22
4745_1,,,,2,2,1,3
4747_0,,,,2,2,1,3
C(C)(C(CO)(C(CCO)O)O)=O,,,4,1,7,12,19
4747_1,,,,2,2,1,3
4749_0,,,,2,2,1,3
C(C(C(CCO)O)C(C=O)O)(O)=O,,,4,1,4,12,16
4751_0,,,,2,2,1,3
C(C(C(C)=O)(C(CCO)O)O)(O)=O,,,4,1,6,10,16
4751_1,,,,2,2,1,3
4753_0,,,,2,2,1,3
C(C(C(C)O)(C(CCO)O)O)(O)=O,,,4,1,6,11,17
4753_1,,,,2,2,1,3
4755_0,,,,2,2,1,3
C1(COCC1(C(CCO)O)O)=O,,,4,1,3,7,10
4755_1,,,,2,2,1,3
4757_0,,,,2,2,1,3
C1(C(C(CO1)O)C(CCO)O)=O,,,4,1,2,7,9
4759_0,,,,2,2,1,3
C1(C(C(CO1)O)(C(CCO)O)O)=O,,,4,1,3,9,12
4759_1,,,,2,2,1,3
4760_0,,,,2,2,1,3
4760_1,,,,2,2,1,3
4761_0,,,,2,2,1,3
4761_1,,,,2,2,1,3
4762_0,,,,2,2,1,3
4762_1,,,,2,2,1,3
4763_0,,,,2,2,1,3
4763_1,,,,2,2,1,3
4764_0,,,,2,2,1,3
4764_1,,,,2,2,1,3
4765_0,,,,2,2,1,3
4765_1,,,,2,2,1,3
4767_0,,,,2,2,1,3
C(C(CO)(C(C(C)=O)(CO)O)O)=O,,,4,1,10,18,28
4767_1,,,,2,2,1,3
4769_0,,,,2,2,1,3
C(C(CO)(C1(C(COC1)=O)O)O)=O,,,4,1,4,14,18
4769_1,,,,2,2,1,3
4771_0,,,,2,2,1,3
C1(C(C(CO1)O)C(C=O)(CO)O)=O,,,4,1,2,10,12
4773_0,,,,2,2,1,3
C(C(CO)(C(C=O)(CO)O)O)=O,,,4,1,5,10,15
4773_1,,,,2,2,1,3
4775_0,,,,2,2,1,3
C(C(CO)(C(C=O)(CO)O)O)(O)=O,,,4,1,10,17,27
4775_1,,,,2,2,1,3
4777_0,,,,2,2,1,3
C(C(CO)(C(C=O)(C(C)=O)O)O)=O,,,4,1,6,15,21
4777_1,,,,2,2,1,3
4778_0,,,,2,2,1,3
4778_1,,,,2,2,1,3
4780_0,,,,2,2,1,3
C1(COCC1(C(C(CO)=O)O)O)=O,,,4,1,2,13,15
4780_1,,,,2,2,1,3
4782_0,,,,2,2,1,3
C1(C(C(CO1)O)C(C(CO)=O)O)=O,,,4,1,1,8,9
4783_0,,,,2,2,1,3
4783_1,,,,2,2,1,3
4785_0,,,,2,2,1,3
C(C(CO)(C(C(CO)=O)O)O)(O)=O,,,4,1,8,14,22
4785_1,,,,2,2,1,3
4787_0,,,,2,2,1,3
C(C(C(C)=O)(C(C(CO)=O)O)O)=O,,,4,1,4,16,20
4787_1,,,,2,2,1,3
4789_0,,,,2,2,1,3
C(C(C(CO)(C(CO)(C)O)O)=O)=O,,,4,1,5,15,20
4789_1,,,,2,2,1,3
4791_0,,,,2,2,1,3
C(C(C(C(C=O)=O)(CO)O)O)(O)=O,,,4,1,5,17,22
4791_1,,,,2,2,1,3
4793_0,,,,2,2,1,3
C(C(C(C(C=O)=O)(CO)O)O)=O,,,4,1,4,21,25
4793_1,,,,2,2,1,3
4795_0,,,,2,2,1,3
C(C(C)(C(C(C=O)=O)(CO)O)O)=O,,,4,1,4,16,20
4795_1,,,,2,2,1,3
4797_0,,,,2,2,1,3
C(C(C(C(C=O)=O)(CO)O)O)(C)=O,,,4,1,4,18,22
4797_1,,,,2,2,1,3
4799_0,,,,2,2,1,3
C(CC(C(C(C=O)=O)(CO)O)O)=O,,,4,1,4,19,23
4799_1,,,,2,2,1,3
4801_0,,,,2,2,1,3
C(C(C(CO)(C(C)O)O)=O)=O,,,4,1,5,16,21
4801_1,,,,2,2,1,3
4802_0,,,,2,2,1,3
4802_1,,,,2,2,1,3
4803_0,,,,2,2,1,3
4803_1,,,,2,2,1,3
4805_0,,,,2,2,1,3
C(C(C(C(CO)O)(C(C)O)O)=O)=O,,,4,1,4,17,21
4805_1,,,,2,2,1,3
4806_0,,,,2,2,1,3
4806_1,,,,2,2,1,3
4807_0,,,,2,2,1,3
4807_1,,,,2,2,1,3
4808_0,,,,2,2,1,3
4808_1,,,,2,2,1,3
4809_0,,,,2,2,1,3
4809_1,,,,2,2,1,3
4810_0,,,,2,2,1,3
4810_1,,,,2,2,1,3
4812_0,,,,2,2,1,3
C(C)(C(CO)(C(CO)(C)O)O)=O,,,4,1,6,11,17
4812_1,,,,2,2,1,3
4814_0,,,,2,2,1,3
C(C(C(CO)(C)O)C(C=O)O)(O)=O,,,4,1,4,12,16
4816_0,,,,2,2,1,3
C(C(C(C)=O)(C(CO)(C)O)O)(O)=O,,,4,1,6,9,15
4816_1,,,,2,2,1,3
4818_0,,,,2,2,1,3
C(C(C(C)O)(C(CO)(C)O)O)(O)=O,,,4,1,6,10,16
4818_1,,,,2,2,1,3
4820_0,,,,2,2,1,3
C1(COCC1(C(CO)(C)O)O)=O,,,4,1,3,6,9
4820_1,,,,2,2,1,3
4822_0,,,,2,2,1,3
C1(C(C(CO1)O)C(C)(CO)O)=O,,,4,1,2,7,9
4824_0,,,,2,2,1,3
C1(C(C(CO1)O)(C(CO)(C)O)O)=O,,,4,1,3,8,11
4824_1,,,,2,2,1,3
4825_0,,,,2,2,1,3
4825_1,,,,2,2,1,3
4826_0,,,,2,2,1,3
4826_1,,,,2,2,1,3
4827_0,,,,2,2,1,3
4827_1,,,,2,2,1,3
4828_0,,,,2,2,1,3
4828_1,,,,2,2,1,3
4829_0,,,,2,2,1,3
4829_1,,,,2,2,1,3
4830_0,,,,2,2,1,3
4830_1,,,,2,2,1,3
4831_0,,,,2,2,1,3
4831_1,,,,2,2,1,3
4833_0,,,,2,2,1,3
C(C)(C(CO)(C(C(O)=O)O)O)=O,,,4,1,8,13,21
4833_1,,,,2,2,1,3
4835_0,,,,2,2,1,3
C(C(C)(C(C(C)=O)(CO)O)O)(O)=O,,,4,1,7,12,19
4835_1,,,,2,2,1,3
4837_0,,,,2,2,1,3
C(CC(C(C(C)=O)(CO)O)O)(O)=O,,,4,1,6,12,18
4837_1,,,,2,2,1,3
4839_0,,,,2,2,1,3
C(C(C=C)(C(C(C)=O)(CO)O)O)=O,,,4,1,6,12,18
4839_1,,,,2,2,1,3
4841_0,,,,2,2,1,3
C(C)(C(CO)(C(C(C=C)=O)O)O)=O,,,4,1,7,15,22
4841_1,,,,2,2,1,3
4843_0,,,,2,2,1,3
C(C)(C(CO)(C(C=CC=O)O)O)=O,,,4,1,5,11,16
4843_1,,,,2,2,1,3
4844_0,,,,2,2,1,3
4844_1,,,,2,2,1,3
4845_0,,,,2,2,1,3
4845_1,,,,2,2,1,3
4846_0,,,,2,2,1,3
4846_1,,,,2,2,1,3
4847_0,,,,2,2,1,3
4847_1,,,,2,2,1,3
4848_0,,,,2,2,1,3
4848_1,,,,2,2,1,3
4849_0,,,,2,2,1,3
4849_1,,,,2,2,1,3
4850_0,,,,2,2,1,3
4850_1,,,,2,2,1,3
4851_0,,,,2,2,1,3
4851_1,,,,2,2,1,3
4852_0,,,,2,2,1,3
4852_1,,,,2,2,1,3
4853_0,,,,2,2,1,3
4853_1,,,,2,2,1,3
4855_0,,,,2,2,1,3
C(C(C(C(O)=O)C(C=O)O)O)(O)=O,,,4,1,5,12,17
4857_0,,,,2,2,1,3
C(C(C(C)=O)(C(C(O)=O)O)O)(O)=O,,,4,1,6,10,16
4857_1,,,,2,2,1,3
4859_0,,,,2,2,1,3
C(C(C(C)O)(C(C(O)=O)O)O)(O)=O,,,4,1,7,12,19
4859_1,,,,2,2,1,3
4861_0,,,,2,2,1,3
C1(COCC1(C(C(O)=O)O)O)=O,,,4,1,3,7,10
4861_1,,,,2,2,1,3
4863_0,,,,2,2,1,3
C1(C(C(CO1)O)C(C(O)=O)O)=O,,,4,1,2,7,9
4865_0,,,,2,2,1,3
C1(C(C(CO1)O)(C(C(O)=O)O)O)=O,,,4,1,3,10,13
4865_1,,,,2,2,1,3
4866_0,,,,2,2,1,3
4866_1,,,,2,2,1,3
4867_0,,,,2,2,1,3
4867_1,,,,2,2,1,3
4868_0,,,,2,2,1,3
4868_1,,,,2,2,1,3
4869_0,,,,2,2,1,3
4869_1,,,,2,2,1,3
4870_0,,,,2,2,1,3
4870_1,,,,2,2,1,3
4872_0,,,,2,2,1,3
C(C(C)(C1(C(COC1)=O)O)O)(O)=O,,,4,1,3,7,10
4872_1,,,,2,2,1,3
4874_0,,,,2,2,1,3
C1(C(C(CO1)O)C(C(O)=O)(C)O)=O,,,4,1,2,8,10
4875_0,,,,2,2,1,3
4875_1,,,,2,2,1,3
4876_0,,,,2,2,1,3
4876_1,,,,2,2,1,3
4877_0,,,,2,2,1,3
4877_1,,,,2,2,1,3
4879_0,,,,2,2,1,3
C(CC(C1(C(COC1)=O)O)O)(O)=O,,,4,1,3,7,10
4879_1,,,,2,2,1,3
4881_0,,,,2,2,1,3
C1(C(C(CC(O)=O)O)C(CO1)O)=O,,,4,1,2,7,9
4882_0,,,,2,2,1,3
4882_1,,,,2,2,1,3
4883_0,,,,2,2,1,3
4883_1,,,,2,2,1,3
4884_0,,,,2,2,1,3
4884_1,,,,2,2,1,3
4885_0,,,,2,2,1,3
4886_0,,,,2,2,1,3
4887_0,,,,2,2,1,3
4888_0,,,,2,2,1,3
4889_0,,,,2,2,1,3
4890_0,,,,2,2,1,3
4891_0,,,,2,2,1,3
4892_0,,,,2,2,1,3
4892_1,,,,2,2,1,3
4893_0,,,,2,2,1,3
4893_1,,,,2,2,1,3
4894_0,,,,2,2,1,3
4894_1,,,,2,2,1,3
4895_0,,,,2,2,1,3
4895_1,,,,2,2,1,3
4896_0,,,,2,2,1,3
4896_1,,,,2,2,1,3
4897_0,,,,2,2,1,3
4897_1,,,,2,2,1,3
4898_0,,,,2,2,1,3
4898_1,,,,2,2,1,3
4899_0,,,,2,2,1,3
4899_1,,,,2,2,1,3
4900_0,,,,2,2,1,3
4900_1,,,,2,2,1,3
4901_0,,,,2,2,1,3
4901_1,,,,2,2,1,3
4902_0,,,,2,2,1,3
4902_1,,,,2,2,1,3
4903_0,,,,2,2,1,3
4903_1,,,,2,2,1,3
4905_0,,,,2,2,1,3
C(CC(C=O)(C(C=O)(CO)O)O)=O,,,4,1,5,17,22
4905_1,,,,2,2,1,3
4907_0,,,,2,2,1,3
C(C(C(C=O)O)(C(C=O)O)O)(O)=O,,,4,1,3,10,13
4907_1,,,,2,2,1,3
4909_0,,,,2,2,1,3
C(C(C(C)O)(C(C=O)O)O)(O)=O,,,4,1,7,15,22
4909_1,,,,2,2,1,3
4910_0,,,,2,2,1,3
4910_1,,,,2,2,1,3
4911_0,,,,2,2,1,3
4911_1,,,,2,2,1,3
4912_0,,,,2,2,1,3
4912_1,,,,2,2,1,3
4913_0,,,,2,2,1,3
4913_1,,,,2,2,1,3
4914_0,,,,2,2,1,3
4914_1,,,,2,2,1,3
4915_0,,,,2,2,1,3
4915_1,,,,2,2,1,3
4916_0,,,,2,2,1,3
4916_1,,,,2,2,1,3
4918_0,,,,2,2,1,3
C(C(C(C)O)(C(C=O)(C)O)O)(O)=O,,,4,1,6,13,19
4918_1,,,,2,2,1,3
4919_0,,,,2,2,1,3
4919_1,,,,2,2,1,3
4921_0,,,,2,2,1,3
C(C(C(C)O)(C(C(C)=O)O)O)(O)=O,,,4,1,7,13,20
4921_1,,,,2,2,1,3
4922_0,,,,2,2,1,3
4922_1,,,,2,2,1,3
4924_0,,,,2,2,1,3
C(C)(C(C(C)O)(C(C(O)=O)O)O)=O,,,4,1,5,13,18
4924_1,,,,2,2,1,3
4925_0,,,,2,2,1,3
4925_1,,,,2,2,1,3
4927_0,,,,2,2,1,3
C(C(C(CC=O)O)(C(C)O)O)(O)=O,,,4,1,5,14,19
4927_1,,,,2,2,1,3
4928_0,,,,2,2,1,3
4928_1,,,,2,2,1,3
4929_0,,,,2,2,1,3
4929_1,,,,2,2,1,3
4930_0,,,,2,2,1,3
4930_1,,,,2,2,1,3
4931_0,,,,2,2,1,3
4931_1,,,,2,2,1,3
4932_0,,,,2,2,1,3
4932_1,,,,2,2,1,3
4934_0,,,,2,2,1,3
C(C(C(C)O)(C(C)O)O)(O)=O,,,4,1,3,5,8
4934_1,,,,2,2,1,3
4935_0,,,,2,2,1,3
4935_1,,,,2,2,1,3
4936_0,,,,2,2,1,3
4936_1,,,,2,2,1,3
4938_0,,,,2,2,1,3
C(CC(C=O)O)(C(CO)(CO)O)=O,,,4,1,5,10,15
4938_1,,,,2,2,1,3
4940_0,,,,2,2,1,3
C(C(C(C(CO)(CO)O)=O)CO)=O,,,4,1,4,10,14
4940_1,,,,2,2,1,3
4942_0,,,,2,2,1,3
C(C(C(C(CO)O)=O)(CO)CO)=O,,,4,1,3,10,13
4944_0,,,,2,2,1,3
C(CC(C(CO)(C(C)O)O)=O)(O)=O,,,4,1,6,14,20
4944_1,,,,2,2,1,3
4946_0,,,,2,2,1,3
C(CC(C(CO)(CO)O)=O)(O)=O,,,4,1,5,9,14
4946_1,,,,2,2,1,3
4948_0,,,,2,2,1,3
C(C(C(CCO)=O)(C(C)O)O)(O)=O,,,4,1,6,10,16
4948_1,,,,2,2,1,3
4949_0,,,,2,2,1,3
4949_1,,,,2,2,1,3
4951_0,,,,2,2,1,3
C(C(C=C)(C1(C(COC1)=O)O)O)=O,,,4,1,2,8,10
4951_1,,,,2,2,1,3
4953_0,,,,2,2,1,3
C1(COCC1(C(C(C=C)=O)O)O)=O,,,4,1,2,11,13
4953_1,,,,2,2,1,3
4955_0,,,,2,2,1,3
C1(COCC1(C(C=CC=O)O)O)=O,,,4,1,2,8,10
4955_1,,,,2,2,1,3
4957_0,,,,2,2,1,3
C1(COCC1(C(C(CO)O)O)O)=O,,,4,1,4,10,14
4957_1,,,,2,2,1,3
4959_0,,,,2,2,1,3
C1(COCC1(C(C=O)O)O)=O,,,4,1,5,15,20
4959_1,,,,2,2,1,3
4961_0,,,,2,2,1,3
C1(COCC1(C(CO)(CO)O)O)=O,,,4,1,3,5,8
4961_1,,,,2,2,1,3
4963_0,,,,2,2,1,3
C(C(C)(C1(C(COC1)=O)O)O)=O,,,4,1,2,10,12
4963_1,,,,2,2,1,3
4965_0,,,,2,2,1,3
C1(COCC1(C(C(C)=O)O)O)=O,,,4,1,3,11,14
4965_1,,,,2,2,1,3
4967_0,,,,2,2,1,3
C(CC(C1(C(COC1)=O)O)O)=O,,,4,1,3,12,15
4967_1,,,,2,2,1,3
4969_0,,,,2,2,1,3
C1(COCC1(C(C)O)O)=O,,,4,1,2,12,14
4969_1,,,,2,2,1,3
4971_0,,,,2,2,1,3
C1(COCC1(CO)O)=O,,,4,1,3,22,25
4971_1,,,,2,2,1,3
4973_0,,,,2,2,1,3
C1(COCC1(C(CO)O)O)=O,,,4,1,4,9,13
4973_1,,,,2,2,1,3
4975_0,,,,2,2,1,3
C(C(CO)(C1(COCC1O)O)O)=O,,,4,1,5,10,15
4975_1,,,,2,2,1,3
4977_0,,,,2,2,1,3
C(C(CO)(C1(C(O)OCC1)O)O)=O,,,4,1,6,12,18
4977_1,,,,2,2,1,3
4979_0,,,,2,2,1,3
C(C(C=C)(C1C(OCC1O)=O)O)=O,,,4,1,1,6,7
4981_0,,,,2,2,1,3
C1(C(C(CO1)O)C(C(C=C)=O)O)=O,,,4,1,1,9,10
4983_0,,,,2,2,1,3
C1(C(C(CO1)O)C(C=CC=O)O)=O,,,4,1,1,7,8
4985_0,,,,2,2,1,3
C1(C(C(CO1)O)C(C(CO)O)O)=O,,,4,1,3,10,13
4987_0,,,,2,2,1,3
C1(C(C(CO1)O)C(C=O)O)=O,,,4,1,5,10,15
4989_0,,,,2,2,1,3
C1(C(C(CO1)O)C(CO)(CO)O)=O,,,4,1,2,6,8
4991_0,,,,2,2,1,3
C1(C(C(CO1)O)C(C=O)(C)O)=O,,,4,1,2,8,10
4993_0,,,,2,2,1,3
C1(C(C(CO1)O)C(C(C)=O)O)=O,,,4,1,3,7,10
4995_0,,,,2,2,1,3
C1(C(C(CC=O)O)C(CO1)O)=O,,,4,1,3,10,13
4997_0,,,,2,2,1,3
C1(C(C(C)O)C(CO1)O)=O,,,4,1,2,8,10
4999_0,,,,2,2,1,3
C1(C(CO)C(CO1)O)=O,,,4,1,2,14,16
5001_0,,,,2,2,1,3
C1(C(C(CO)O)C(CO1)O)=O,,,4,1,4,8,12
5003_0,,,,2,2,1,3
C(C(CO)(C1(COC(C1)O)O)O)=O,,,4,1,6,12,18
5003_1,,,,2,2,1,3
5005_0,,,,2,2,1,3
C(C(C=C)(C(C=O)(CO)O)O)=O,,,4,1,8,16,24
5005_1,,,,2,2,1,3
5007_0,,,,2,2,1,3
C(C(C=C)(C(C(O)=O)(CO)O)O)=O,,,4,1,7,11,18
5007_1,,,,2,2,1,3
5009_0,,,,2,2,1,3
C(C(C=C)(C(C=O)(C(C)=O)O)O)=O,,,4,1,3,8,11
5009_1,,,,2,2,1,3
5011_0,,,,2,2,1,3
C(C(CO)(C(C(C=C)=O)O)O)=O,,,4,1,9,17,26
5011_1,,,,2,2,1,3
5013_0,,,,2,2,1,3
C(C(CO)(C(C(C=C)=O)O)O)(O)=O,,,4,1,8,13,21
5013_1,,,,2,2,1,3
5015_0,,,,2,2,1,3
C(C(C(C)=O)(C(C(C=C)=O)O)O)=O,,,4,1,4,10,14
5015_1,,,,2,2,1,3
5017_0,,,,2,2,1,3
C(C(CO)(C(C=CC=O)O)O)=O,,,4,1,7,14,21
5017_1,,,,2,2,1,3
5019_0,,,,2,2,1,3
C(C(CO)(C(C=CC=O)O)O)(O)=O,,,4,1,6,8,14
5019_1,,,,2,2,1,3
5021_0,,,,2,2,1,3
C(C(C(C)=O)(C(C=CC=O)O)O)=O,,,4,1,2,8,10
5021_1,,,,2,2,1,3
5023_0,,,,2,2,1,3
C1(C(C(CO1)O)(C(C=O)O)O)=O,,,4,1,3,12,15
5023_1,,,,2,2,1,3
5025_0,,,,2,2,1,3
C1(C(C(CO1)O)(C(C=O)(C)O)O)=O,,,4,1,2,10,12
5025_1,,,,2,2,1,3
5027_0,,,,2,2,1,3
C1(C(C(CO1)O)(C(C(C)=O)O)O)=O,,,4,1,2,10,12
5027_1,,,,2,2,1,3
5029_0,,,,2,2,1,3
C1(C(C(CC=O)O)(C(CO1)O)O)=O,,,4,1,2,11,13
5029_1,,,,2,2,1,3
5031_0,,,,2,2,1,3
C1(C(C(C)O)(C(CO1)O)O)=O,,,4,1,3,7,10
5031_1,,,,2,2,1,3
5033_0,,,,2,2,1,3
C1(C(CO)(C(CO1)O)O)=O,,,4,1,3,6,9
5033_1,,,,2,2,1,3
5035_0,,,,2,2,1,3
C1(C(C(CO)O)(C(CO1)O)O)=O,,,4,1,5,9,14
5035_1,,,,2,2,1,3
5037_0,,,,2,2,1,3
C1(C(C(C)O)(C(C(CO)O1)O)O)=O,,,4,1,3,7,10
5037_1,,,,2,2,1,3
5039_0,,,,2,2,1,3
C1(C(CO)(C(C(CO)O1)O)O)=O,,,4,1,4,6,10
5039_1,,,,2,2,1,3
5041_0,,,,2,2,1,3
C1(C(C(C)O)(C(C(CO1)O)O)O)=O,,,4,1,2,10,12
5041_1,,,,2,2,1,3
5043_0,,,,2,2,1,3
C1(C(CO)(C(C(CO1)O)O)O)=O,,,4,1,3,9,12
5043_1,,,,2,2,1,3
5045_0,,,,2,1,1,2
C(C1(C(C(C(C1)=O)O)O)O)=O,,,4,1,2,19,21
5047_0,,,,2,1,1,2
C(C1(CC(C(C1(CO)O)O)O)O)=O,,,4,1,3,14,17
5049_0,,,,2,1,1,2
C(C)(C1(C(C(C(C1)=O)O)O)O)=O,,,4,1,5,15,20
5051_0,,,,2,1,1,2
C(C1(CC(CC1(C=O)O)O)O)=O,,,4,1,1,8,9
5052_0,,,,2,1,1,2
5053_0,,,,2,1,1,2
5054_0,,,,2,1,1,2
5056_0,,,,2,1,1,2
C(C1(C(CC(C1)O)O)O)=O,,,4,1,1,12,13
5058_0,,,,2,1,1,2
C(C1(C(C(C(C1)O)O)O)O)=O,,,4,1,2,15,17
5060_0,,,,2,1,1,2
C(C1(C(C(CO)(C(C1)O)O)O)O)=O,,,4,1,2,15,17
5062_0,,,,2,2,1,3
C(C(C(C=O)(CC(C=O)=O)O)O)=O,,,4,1,2,16,18
5063_0,,,,2,2,1,3
5064_0,,,,2,2,1,3
5065_0,,,,2,2,1,3
5067_0,,,,2,2,1,3
C(C(C=O)C(C=O)(C(C=O)O)O)=O,,,4,1,3,13,16
5068_0,,,,2,2,1,3
5069_0,,,,2,2,1,3
5070_0,,,,2,2,1,3
5071_0,,,,2,2,1,3
5072_0,,,,2,2,1,3
5073_0,,,,2,2,1,3
5074_0,,,,2,2,1,3
5075_0,,,,2,2,1,3
5077_0,,,,2,2,1,3
C(C(C)(CC(C(C(O)=O)O)O)O)=O,,,4,1,4,14,18
5078_0,,,,2,2,1,3
5080_0,,,,2,2,1,3
C(C)(C(C(C)O)(CC(C=O)=O)O)=O,,,4,1,1,12,13
5081_0,,,,2,2,1,3
5083_0,,,,2,2,1,3
C(C(C=O)C(C(C)=O)(C(C)O)O)=O,,,4,1,1,10,11
5084_0,,,,2,2,1,3
5086_0,,,,2,2,1,3
C(C)(C(C(CCO)O)(CC=O)O)=O,,,4,1,2,12,14
5088_0,,,,2,2,1,3
C(C)(C(C(CO)(C)O)(CC=O)O)=O,,,4,1,2,11,13
5090_0,,,,2,2,1,3
C(C(C(C(C)=O)(CC=O)O)O)(O)=O,,,4,1,3,12,15
5092_0,,,,2,2,1,3
C(CC(C(C)=O)(C(C=O)O)O)=O,,,4,1,5,17,22
5094_0,,,,2,2,1,3
C(CC(C(C)=O)(C(C=O)(C)O)O)=O,,,4,1,2,12,14
5096_0,,,,2,2,1,3
C(CC(C(C)=O)(C(C(C)=O)O)O)=O,,,4,1,3,14,17
5098_0,,,,2,2,1,3
C(C)(C(C(CC=O)O)(CC=O)O)=O,,,4,1,2,17,19
5100_0,,,,2,2,1,3
C(C)(C(C(C)O)(CC=O)O)=O,,,4,1,2,15,17
5101_0,,,,2,2,1,3
5103_0,,,,2,2,1,3
C(C)(C(C(CO)O)(CC=O)O)=O,,,4,1,4,15,19
5105_0,,,,2,2,1,3
C(C(C(CC(C(C)=O)O)O)O)(O)=O,,,4,1,4,13,17
5106_0,,,,2,2,1,3
5108_0,,,,2,2,1,3
C(C(CC(C)O)(C(C(O)=O)O)O)=O,,,4,1,2,12,14
5109_0,,,,2,2,1,3
5110_0,,,,2,2,1,3
5111_0,,,,2,2,1,3
5113_0,,,,2,2,1,3
C(C(CO)C(C(C(O)=O)(C)O)O)=O,,,4,1,3,14,17
5114_0,,,,2,2,1,3
5116_0,,,,2,2,1,3
C(C(C(C)O)(CC=O)O)(CCO)=O,,,4,1,2,13,15
5118_0,,,,2,2,1,3
C(C(CO)(CC=O)O)(CCO)=O,,,4,1,5,15,20
5119_0,,,,2,2,1,3
5120_0,,,,2,2,1,3
5121_0,,,,2,2,1,3
5122_0,,,,2,2,1,3
5123_0,,,,2,2,1,3
5124_0,,,,2,2,1,3
5125_0,,,,2,2,1,3
5126_0,,,,2,2,1,3
5127_0,,,,2,2,1,3
5128_0,,,,2,2,1,3
5130_0,,,,2,2,1,3
C(C(C)(C(CC(C)O)O)O)(O)=O,,,4,1,1,8,9
5132_0,,,,2,2,1,3
C(C(C(C)(C(CC(C)O)O)O)=O)=O,,,4,1,1,12,13
5134_0,,,,2,2,1,3
C(C(CCO)(C(CC(C)O)O)O)=O,,,4,1,2,11,13
5136_0,,,,2,2,1,3
C1(C(C(CC(C)O)O)(O)OCC1)=O,,,4,1,1,8,9
5138_0,,,,2,2,1,3
C(C(C(CC(C)O)O)O)(O)=O,,,4,1,6,10,16
5140_0,,,,2,2,1,3
C(C(C(CC(C)O)O)(CC=O)O)=O,,,4,1,2,13,15
5142_0,,,,2,2,1,3
C(C(C)(C(C(C(C)O)O)O)O)(O)=O,,,4,1,1,11,12
5144_0,,,,2,2,1,3
C(C(C(C(C(C)O)O)O)O)(O)=O,,,4,1,4,11,15
5146_0,,,,2,2,1,3
C(C(C)(C(CCO)O)O)(O)=O,,,4,1,2,7,9
5148_0,,,,2,2,1,3
C(C(CCO)(C(CCO)O)O)(O)=O,,,4,1,4,9,13
5150_0,,,,2,2,1,3
C(C(C(C)(C(CCO)O)O)=O)=O,,,4,1,2,14,16
5152_0,,,,2,2,1,3
C(C(CCO)(C(CCO)O)O)=O,,,4,1,3,11,14
5154_0,,,,2,2,1,3
C(C(C(CCO)O)(CC=O)O)(O)=O,,,4,1,4,12,16
5156_0,,,,2,2,1,3
C(C(C(CCO)O)(CC(O)=O)O)=O,,,4,1,3,11,14
5158_0,,,,2,2,1,3
C1(C(C(CCO)O)(O)OCC1)=O,,,4,1,2,8,10
5159_0,,,,2,2,1,3
5160_0,,,,2,2,1,3
5162_0,,,,2,2,1,3
C(C(C)(C(CC(CO)O)O)O)(O)=O,,,4,1,2,10,12
5163_0,,,,2,2,1,3
5164_0,,,,2,2,1,3
5165_0,,,,2,2,1,3
5166_0,,,,2,2,1,3
5168_0,,,,2,2,1,3
C(C(C)(C(C(CO)=O)(C)O)O)(O)=O,,,4,1,4,9,13
5169_0,,,,2,2,1,3
5171_0,,,,2,2,1,3
C(C(C)(C(C(C(C)O)=O)O)O)(O)=O,,,4,1,5,11,16
5173_0,,,,2,2,1,3
C(C(C)(C(CO)(C)O)O)(O)=O,,,4,1,2,6,8
5175_0,,,,2,2,1,3
C(C(C)(C(CO)(CCO)O)O)(O)=O,,,4,1,3,8,11
5177_0,,,,2,2,1,3
C(C(C)(C(C(CCO)O)O)O)(O)=O,,,4,1,3,10,13
5179_0,,,,2,2,1,3
C(C(C)(C(C)(C(CO)O)O)O)(O)=O,,,4,1,2,9,11
5180_0,,,,2,2,1,3
5182_0,,,,2,2,1,3
C(C(C)(C(C(O)=O)(C)O)O)(O)=O,,,4,1,2,4,6
5184_0,,,,2,2,1,3
C(C(C)(C(CC(O)=O)O)O)(O)=O,,,4,1,2,7,9
5186_0,,,,2,2,1,3
C(C(C)(C1(COCC1O)O)O)(O)=O,,,4,1,1,5,6
5188_0,,,,2,2,1,3
C(C(C)(C1(C(O)OCC1)O)O)(O)=O,,,4,1,2,7,9
5190_0,,,,2,2,1,3
C(C(C)(C1(COC(C1)O)O)O)(O)=O,,,4,1,2,7,9
5192_0,,,,2,2,1,3
C(C(C=C)(C(C(O)=O)(C)O)O)=O,,,4,1,4,10,14
5194_0,,,,2,2,1,3
C(C(C)(C(C(C=C)=O)O)O)(O)=O,,,4,1,5,11,16
5196_0,,,,2,2,1,3
C(C(C)(C(C=CC=O)O)O)(O)=O,,,4,1,3,8,11
5198_0,,,,2,2,1,3
C(C(C)(C(C(CO)O)O)O)(O)=O,,,4,1,5,10,15
5199_0,,,,2,2,1,3
5201_0,,,,2,2,1,3
C(C(C)(C(CO)(CO)O)O)(O)=O,,,4,1,4,5,9
5203_0,,,,2,2,1,3
C(C(C)(C(C=O)(C)O)O)(O)=O,,,4,1,2,9,11
5204_0,,,,2,2,1,3
5206_0,,,,2,2,1,3
C(C(C)(C(CC=O)O)O)(O)=O,,,4,1,4,13,17
5208_0,,,,2,2,1,3
C(C(C)(C(C=O)(CCO)O)O)(O)=O,,,4,1,6,11,17
5209_0,,,,2,2,1,3
5211_0,,,,2,2,1,3
C(C(C)(C(C(CC=O)O)O)O)(O)=O,,,4,1,5,13,18
5213_0,,,,2,2,1,3
C(C(C)(C(CC(C=O)O)O)O)(O)=O,,,4,1,3,12,15
5215_0,,,,2,2,1,3
C(C(C)(C(CC(CO)=O)O)O)(O)=O,,,4,1,2,10,12
5217_0,,,,2,2,1,3
C(C(C)(C(CO)(CC=O)O)O)(O)=O,,,4,1,5,11,16
5219_0,,,,2,2,1,3
C(C(C)(C(C(C(C)=O)O)O)O)(O)=O,,,4,1,3,12,15
5221_0,,,,2,2,1,3
C(C(C)(C(C)(C(C=O)O)O)O)(O)=O,,,4,1,2,12,14
5223_0,,,,2,2,1,3
C(C(C)(C(C)O)O)(O)=O,,,4,1,1,8,9
5224_0,,,,2,2,1,3
5226_0,,,,2,2,1,3
C(C(C)(C(CO)O)O)(O)=O,,,4,1,5,7,12
5228_0,,,,2,2,1,3
C(C(CCO)(C(CO)(C)O)O)(O)=O,,,4,1,4,8,12
5229_0,,,,2,2,1,3
5230_0,,,,2,2,1,3
5232_0,,,,2,2,1,3
C(C(CCO)(C(C=O)(C)O)O)(O)=O,,,4,1,4,11,15
5233_0,,,,2,2,1,3
5235_0,,,,2,2,1,3
C(C(C(CC=O)O)(CCO)O)(O)=O,,,4,1,3,12,15
5237_0,,,,2,2,1,3
C(C(C(C)O)(CCO)O)(O)=O,,,4,1,3,7,10
5239_0,,,,2,2,1,3
C(C(CO)(CCO)O)(O)=O,,,4,1,5,6,11
5241_0,,,,2,2,1,3
C(C(C(CO)O)(CCO)O)(O)=O,,,4,1,7,9,16
5243_0,,,,2,2,1,3
C(C(CO)(C(C(C=O)=O)(C)O)O)=O,,,4,1,5,16,21
5244_0,,,,2,2,1,3
5246_0,,,,2,2,1,3
C(C(CO)(C1(C(CCO1)=O)O)O)=O,,,4,1,3,14,17
5247_0,,,,2,2,1,3
5248_0,,,,2,2,1,3
5250_0,,,,2,2,1,3
C(C(C(C(C=O)=O)(C)O)O)(CO)=O,,,4,1,3,17,20
5251_0,,,,2,2,1,3
5253_0,,,,2,2,1,3
C(C(C1(C(CCO1)=O)O)O)(CO)=O,,,4,1,1,13,14
5254_0,,,,2,2,1,3
5256_0,,,,2,2,1,3
C(CC(C=O)(C(C(CO)=O)O)O)=O,,,4,1,3,18,21
5257_0,,,,2,2,1,3
5258_0,,,,2,2,1,3
5259_0,,,,2,2,1,3
5260_0,,,,2,2,1,3
5262_0,,,,2,2,1,3
C(C(C(C)(C(CO)(C)O)O)=O)=O,,,4,1,2,13,15
5264_0,,,,2,2,1,3
C(C(C(C(C=O)=O)(C)O)O)(O)=O,,,4,1,4,14,18
5266_0,,,,2,2,1,3
C(C(C)(C(C(C=O)=O)(C)O)O)(O)=O,,,4,1,3,11,14
5268_0,,,,2,2,1,3
C(CC(C(C(C=O)=O)(C)O)O)(O)=O,,,4,1,2,12,14
5270_0,,,,2,2,1,3
C(C(C=C)(C(C(C=O)=O)(C)O)O)=O,,,4,1,2,9,11
5272_0,,,,2,2,1,3
C=CC(C(C(C(C=O)=O)(C)O)O)=O,,,4,1,3,11,14
5274_0,,,,2,2,1,3
C(C(C(C(C=O)=O)(C)O)O)=CC=O,,,4,1,1,8,9
5276_0,,,,2,2,1,3
C(C(C(C)(C(C(CO)O)O)O)=O)=O,,,4,1,4,15,19
5277_0,,,,2,2,1,3
5279_0,,,,2,2,1,3
C(C(C(C)(C(CO)(CO)O)O)=O)=O,,,4,1,3,9,12
5281_0,,,,2,2,1,3
C(C(C)(C(C(C=O)=O)(C)O)O)=O,,,4,1,3,14,17
5283_0,,,,2,2,1,3
C(C(C(C(C=O)=O)(C)O)O)(C)=O,,,4,1,6,16,22
5285_0,,,,2,2,1,3
C(CC(C(C(C=O)=O)(C)O)O)=O,,,4,1,5,18,23
5287_0,,,,2,2,1,3
C(C(C(C)(C(C)O)O)=O)=O,,,4,1,2,13,15
5289_0,,,,2,2,1,3
C(C(C(CO)(C)O)=O)=O,,,4,1,8,18,26
5291_0,,,,2,2,1,3
C(C(C(C)(C(CO)O)O)=O)=O,,,4,1,4,14,18
5292_0,,,,2,2,1,3
5293_0,,,,2,2,1,3
5295_0,,,,2,2,1,3
C(C(CCO)(C(CO)(C)O)O)=O,,,4,1,3,10,13
5297_0,,,,2,2,1,3
C(C(C(CO)(C)O)(CC=O)O)(O)=O,,,4,1,3,11,14
5299_0,,,,2,2,1,3
C(C(C(CO)(C)O)(CC(O)=O)O)=O,,,4,1,3,10,13
5301_0,,,,2,2,1,3
C1(C(C(CO)(C)O)(O)OCC1)=O,,,4,1,2,7,9
5302_0,,,,2,2,1,3
5303_0,,,,2,2,1,3
5304_0,,,,2,2,1,3
5305_0,,,,2,2,1,3
5306_0,,,,2,2,1,3
5308_0,,,,2,2,1,3
C(C(C(CC(O)=O)O)(CCO)O)=O,,,4,1,3,11,14
5310_0,,,,2,2,1,3
C(C(C=C)(C(C=O)(CCO)O)O)=O,,,4,1,3,10,13
5312_0,,,,2,2,1,3
C(C(CCO)(C(C(C=C)=O)O)O)=O,,,4,1,4,13,17
5314_0,,,,2,2,1,3
C(C(CCO)(C(C=CC=O)O)O)=O,,,4,1,2,9,11
5315_0,,,,2,2,1,3
5316_0,,,,2,2,1,3
5317_0,,,,2,2,1,3
5318_0,,,,2,2,1,3
5319_0,,,,2,2,1,3
5320_0,,,,2,2,1,3
5321_0,,,,2,2,1,3
5322_0,,,,2,2,1,3
5323_0,,,,2,2,1,3
5324_0,,,,2,2,1,3
5325_0,,,,2,2,1,3
5327_0,,,,2,2,1,3
C(C(C(C(O)=O)(CC=O)O)O)(O)=O,,,4,1,4,12,16
5329_0,,,,2,2,1,3
C(CC(C=O)(C(C(O)=O)O)O)(O)=O,,,4,1,4,11,15
5331_0,,,,2,2,1,3
C(C(C1(C(CCO1)=O)O)O)(O)=O,,,4,1,2,8,10
5332_0,,,,2,2,1,3
5333_0,,,,2,2,1,3
5335_0,,,,2,2,1,3
C(C(C)(C1(C(CCO1)=O)O)O)(O)=O,,,4,1,2,7,9
5336_0,,,,2,2,1,3
5337_0,,,,2,2,1,3
5339_0,,,,2,2,1,3
C(CC(C1(C(CCO1)=O)O)O)(O)=O,,,4,1,2,7,9
5340_0,,,,2,2,1,3
5341_0,,,,2,2,1,3
5342_0,,,,2,2,1,3
5343_0,,,,2,2,1,3
5344_0,,,,2,2,1,3
5345_0,,,,2,2,1,3
5346_0,,,,2,2,1,3
5347_0,,,,2,2,1,3
5348_0,,,,2,2,1,3
5349_0,,,,2,2,1,3
5350_0,,,,2,2,1,3
5351_0,,,,2,2,1,3
5352_0,,,,2,2,1,3
5353_0,,,,2,2,1,3
5354_0,,,,2,2,1,3
5355_0,,,,2,2,1,3
5356_0,,,,2,2,1,3
5357_0,,,,2,2,1,3
5358_0,,,,2,2,1,3
5359_0,,,,2,2,1,3
5360_0,,,,2,2,1,3
5362_0,,,,2,2,1,3
C(C(C(C=O)(CC(CO)=O)O)O)=O,,,4,1,6,18,24
5363_0,,,,2,2,1,3
5364_0,,,,2,2,1,3
5365_0,,,,2,2,1,3
5366_0,,,,2,2,1,3
5368_0,,,,2,2,1,3
C(C(C(C)O)(CC(CO)=O)O)(O)=O,,,4,1,3,10,13
5369_0,,,,2,2,1,3
5371_0,,,,2,2,1,3
C(C(C1(COCC1O)O)O)(O)=O,,,4,1,2,5,7
5373_0,,,,2,2,1,3
C(C(C=C)(C1(C(CCO1)=O)O)O)=O,,,4,1,1,8,9
5375_0,,,,2,2,1,3
C1(C(C(C(C=C)=O)O)(O)OCC1)=O,,,4,1,1,11,12
5377_0,,,,2,2,1,3
C1(C(C(C=CC=O)O)(O)OCC1)=O,,,4,1,1,9,10
5379_0,,,,2,2,1,3
C1(C(C(C(CO)O)O)(O)OCC1)=O,,,4,1,3,10,13
5381_0,,,,2,2,1,3
C(C(C1(C(CCO1)=O)O)O)=O,,,4,1,4,16,20
5383_0,,,,2,2,1,3
C1(C(C(CO)(CO)O)(O)OCC1)=O,,,4,1,2,5,7
5385_0,,,,2,2,1,3
C(C(C)(C1(C(CCO1)=O)O)O)=O,,,4,1,1,11,12
5387_0,,,,2,2,1,3
C(C(C1(C(CCO1)=O)O)O)(C)=O,,,4,1,2,12,14
5389_0,,,,2,2,1,3
C(CC(C1(C(CCO1)=O)O)O)=O,,,4,1,2,13,15
5391_0,,,,2,2,1,3
C1(C(C(C)O)(O)OCC1)=O,,,4,1,1,13,14
5393_0,,,,2,2,1,3
C1(C(CO)(O)OCC1)=O,,,4,1,3,23,26
5395_0,,,,2,2,1,3
C1(C(C(CO)O)(O)OCC1)=O,,,4,1,4,10,14
5397_0,,,,2,2,1,3
C(C(C1(C(O)OCC1)O)O)(O)=O,,,4,1,3,7,10
5399_0,,,,2,2,1,3
C(C(C1(COC(C1)O)O)O)(O)=O,,,4,1,3,7,10
5401_0,,,,2,2,1,3
C(C(C=C)(C(C(O)=O)O)O)=O,,,4,1,7,12,19
5403_0,,,,2,2,1,3
C(C(C=C)(C(C=O)(CC=O)O)O)=O,,,4,1,2,10,12
5405_0,,,,2,2,1,3
C(C(C(C(C=C)=O)O)O)(O)=O,,,4,1,8,16,24
5407_0,,,,2,2,1,3
C(CC(C=O)(C(C(C=C)=O)O)O)=O,,,4,1,3,12,15
5409_0,,,,2,2,1,3
C(C(C(C=CC=O)O)O)(O)=O,,,4,1,6,13,19
5411_0,,,,2,2,1,3
C(CC(C=O)(C(C=CC=O)O)O)=O,,,4,1,1,11,12
5412_0,,,,2,1,2,3
5412_1,,,,2,1,2,3
5413_0,,,,2,1,2,3
5413_1,,,,2,1,2,3
5414_0,,,,2,1,2,3
5414_1,,,,2,1,2,3
5415_0,,,,2,1,2,3
5415_1,,,,2,1,2,3
5416_0,,,,2,1,2,3
5416_1,,,,2,1,2,3
5417_0,,,,2,1,2,3
5417_1,,,,2,1,2,3
5418_0,,,,2,1,2,3
5418_1,,,,2,1,2,3
5419_0,,,,2,1,2,3
5419_1,,,,2,1,2,3
5420_0,,,,2,1,2,3
5420_1,,,,2,1,2,3
5421_0,,,,2,1,2,3
5421_1,,,,2,1,2,3
5422_0,,,,2,1,2,3
5422_1,,,,2,1,2,3
5423_0,,,,2,1,2,3
5423_1,,,,2,1,2,3
5424_0,,,,2,1,2,3
5424_1,,,,2,1,2,3
5425_0,,,,2,1,2,3
5425_1,,,,2,1,2,3
5426_0,,,,2,1,2,3
5426_1,,,,2,1,2,3
5427_0,,,,2,1,2,3
5427_1,,,,2,1,2,3
5428_0,,,,2,1,2,3
5428_1,,,,2,1,2,3
5429_0,,,,2,1,2,3
5429_1,,,,2,1,2,3
5430_0,,,,2,1,2,3
5430_1,,,,2,1,2,3
5431_0,,,,2,1,2,3
5431_1,,,,2,1,2,3
5432_0,,,,2,1,2,3
5432_1,,,,2,1,2,3
5433_0,,,,2,1,2,3
5433_1,,,,2,1,2,3
5434_0,,,,2,1,2,3
5435_0,,,,2,1,2,3
5436_0,,,,2,1,2,3
5437_0,,,,2,1,2,3
5438_0,,,,2,1,2,3
5439_0,,,,2,1,2,3
5440_0,,,,2,1,2,3
5441_0,,,,2,1,2,3
5442_0,,,,2,1,2,3
5443_0,,,,2,1,2,3
5444_0,,,,2,1,2,3
5445_0,,,,2,1,2,3
5446_0,,,,2,1,2,3
5447_0,,,,2,1,2,3
5448_0,,,,2,1,2,3
5449_0,,,,2,1,2,3
5451_0,,,,2,1,1,2
C(CO)(OCC=O)=O,,,4,1,7,68,75
5453_0,,,,2,1,1,2
C(C(CO)OC(CO)=O)=O,,,4,1,3,15,18
5455_0,,,,2,1,1,2
C(C(C(CO)O)OC(CO)=O)=O,,,4,1,3,8,11
5457_0,,,,2,1,1,2
C(C(COC(CO)=O)O)=O,,,4,1,1,14,15
5459_0,,,,2,1,1,2
C(C(C(CO)OC(CO)=O)O)=O,,,4,1,1,5,6
5461_0,,,,2,1,1,2
C(C(C(COC(CO)=O)O)O)=O,,,4,1,3,8,11
5463_0,,,,2,1,2,3
C(CCC=O)(C(C(CO)O)O)=O,,,4,1,3,16,19
5464_0,,,,2,1,2,3
5466_0,,,,2,1,2,3
C(CC(CC(C(CO)O)O)=O)=O,,,4,1,4,15,19
5467_0,,,,2,1,2,3
5468_0,,,,2,1,2,3
5469_0,,,,2,1,2,3
5470_0,,,,2,1,2,3
5471_0,,,,2,1,2,3
5473_0,,,,2,1,2,3
C(CC(C(CO)=O)=O)=O,,,4,1,9,45,54
5474_0,,,,2,1,2,3
5476_0,,,,2,1,2,3
C(CC(C(C(CO)O)=O)=O)=O,,,4,1,7,20,27
5477_0,,,,2,1,2,3
5478_0,,,,2,1,2,3
5479_0,,,,2,1,2,3
5481_0,,,,2,1,2,3
C(CC(C(CC=O)=O)=O)=O,,,4,1,2,18,20
5483_0,,,,2,1,2,3
C(CC(CC(C=O)=O)=O)=O,,,4,1,4,34,38
5484_0,,,,2,1,2,3
5486_0,,,,2,1,2,3
C(C(CO)=O)(C(CO)CO)=O,,,4,1,4,11,15
5487_0,,,,2,1,2,3
5489_0,,,,2,1,2,3
C(C(CO)CC(C=O)=O)=O,,,4,1,6,22,28
5491_0,,,,2,1,2,3
C(C(C=O)C(C=O)CO)=O,,,4,1,5,18,23
5493_0,,,,2,1,2,3
C(C(CO)C(C(C=O)=O)CO)=O,,,4,1,6,18,24
5495_0,,,,2,1,2,3
C(C(C(C=O)C(C=O)CO)O)=O,,,4,1,8,18,26
5497_0,,,,2,1,2,3
C(C(CO)C(C=O)C(CO)=O)=O,,,4,1,6,17,23
5499_0,,,,2,1,2,3
C(CC(C(C(CO)CO)=O)=O)=O,,,4,1,4,12,16
5501_0,,,,2,1,2,3
C(C(CO)C(C(CC=O)=O)O)=O,,,4,1,9,20,29
5503_0,,,,2,1,2,3
C(C(CO)CC(C(C=O)O)=O)=O,,,4,1,5,17,22
5505_0,,,,2,1,2,3
C(C(CO)CC=O)=O,,,4,1,8,77,85
5506_0,,,,2,1,2,3
5507_0,,,,2,1,2,3
5509_0,,,,2,1,2,3
C(C(C(C(CO)=O)=O)C)=O,,,4,1,3,22,25
5511_0,,,,2,1,2,3
C(CO)(CC(C(C)=O)=O)=O,,,4,1,10,28,38
5513_0,,,,2,1,2,3
C(C)(CC(C(CO)=O)=O)=O,,,4,1,6,28,34
5515_0,,,,2,1,2,3
C(CC(CC(CO)=O)=O)=O,,,4,1,12,32,44
5517_0,,,,2,1,2,3
C(CCC(C(CO)=O)=O)=O,,,4,1,6,25,31
5519_0,,,,2,1,2,3
C(C(C(C(CO)=O)=O)CCO)=O,,,4,1,1,15,16
5521_0,,,,2,1,2,3
C(CO)(CC(C(CCO)=O)=O)=O,,,4,1,3,15,18
5523_0,,,,2,1,2,3
C(CCO)(CC(C(CO)=O)=O)=O,,,4,1,4,15,19
5525_0,,,,2,1,2,3
C(CC(CC(C(CO)=O)O)=O)=O,,,4,1,4,18,22
5527_0,,,,2,1,2,3
C(CCC(C(C(CO)=O)O)=O)=O,,,4,1,2,14,16
5529_0,,,,2,1,2,3
C(CC(C(CC(CO)=O)=O)O)=O,,,4,1,7,17,24
5530_0,,,,2,1,2,3
5532_0,,,,2,1,2,3
C(C(CC(CC(CO)=O)=O)O)=O,,,4,1,5,16,21
5534_0,,,,2,1,2,3
C(C(CCC(C(CO)=O)=O)O)=O,,,4,1,2,14,16
5536_0,,,,2,1,2,3
C(CC(CO)=O)(CC(CO)=O)=O,,,4,1,2,7,9
5538_0,,,,2,1,2,3
C(CO)(CCC(C(CO)=O)=O)=O,,,4,1,4,15,19
5540_0,,,,2,1,2,3
C(CC(C=O)C(C(CO)=O)O)=O,,,4,1,7,18,25
5542_0,,,,2,1,2,3
C(CC(C(C(CO)=O)=O)CO)=O,,,4,1,2,15,17
5544_0,,,,2,1,2,3
C(CO)(C(CC(C(C)=O)=O)O)=O,,,4,1,4,15,19
5546_0,,,,2,1,2,3
C(C(C(CO)=O)O)(CC(C)=O)=O,,,4,1,2,12,14
5548_0,,,,2,1,2,3
C(C(C(C)=O)O)(CC(CO)=O)=O,,,4,1,2,12,14
5549_0,,,,2,1,2,3
5551_0,,,,2,1,2,3
C(C(C(C(C=O)=O)C)O)(CO)=O,,,4,1,2,16,18
5553_0,,,,2,1,2,3
C(C(C(C(C(CO)=O)=O)C)O)=O,,,4,1,2,13,15
5555_0,,,,2,1,2,3
C(C)(CC(CO)=O)=O,,,4,1,16,117,133
5557_0,,,,2,1,2,3
C(C(CO)=O)(CC)=O,,,4,1,4,86,90
5558_0,,,,2,1,2,3
5559_0,,,,2,1,2,3
5560_0,,,,2,1,2,3
5561_0,,,,2,1,2,3
5562_0,,,,2,1,2,3
5563_0,,,,2,1,2,3
5564_0,,,,2,1,2,3
5565_0,,,,2,1,2,3
5566_0,,,,2,1,2,3
5567_0,,,,2,1,2,3
5569_0,,,,2,1,2,3
C(C(C(CO)O)CC(C=O)=O)=O,,,4,1,6,18,24
5570_0,,,,2,1,2,3
5572_0,,,,2,1,2,3
C(CO)(C(CO)CC(C=O)=O)=O,,,4,1,3,18,21
5573_0,,,,2,1,2,3
5575_0,,,,2,1,2,3
C(C(C=O)C(C=O)C(CO)O)=O,,,4,1,6,14,20
5576_0,,,,2,1,2,3
5578_0,,,,2,1,2,3
C(C(C=O)C(C(CO)=O)CO)=O,,,4,1,3,12,15
5579_0,,,,2,1,2,3
5581_0,,,,2,1,2,3
C(C(C(CO)O)CC=O)=O,,,4,1,8,22,30
5582_0,,,,2,1,2,3
5584_0,,,,2,1,2,3
C(CO)(C(CO)CC=O)=O,,,4,1,6,26,32
5585_0,,,,2,1,2,3
5586_0,,,,2,1,2,3
5587_0,,,,2,1,2,3
5588_0,,,,2,1,2,3
5589_0,,,,2,1,2,3
5590_0,,,,2,1,2,3
5592_0,,,,2,1,2,3
C(C(C(C(C(CO)O)=O)=O)C)=O,,,4,1,4,16,20
5593_0,,,,2,1,2,3
5594_0,,,,2,1,2,3
5596_0,,,,2,1,2,3
C(C(CO)O)(CC(C(C)=O)=O)=O,,,4,1,7,16,23
5598_0,,,,2,1,2,3
C(C)(CC(C(C(CO)O)=O)=O)=O,,,4,1,5,16,21
5599_0,,,,2,1,2,3
5600_0,,,,2,1,2,3
5602_0,,,,2,1,2,3
C(CC(CC(C(CO)O)=O)=O)=O,,,4,1,8,16,24
5604_0,,,,2,1,2,3
C(CCC(C(C(CO)O)=O)=O)=O,,,4,1,5,15,20
5605_0,,,,2,1,2,3
5606_0,,,,2,1,2,3
5608_0,,,,2,1,2,3
C(C(CO)O)(CC(C)=O)=O,,,4,1,7,27,34
5610_0,,,,2,1,2,3
C(C(C(CO)O)=O)(CC)=O,,,4,1,4,20,24
5611_0,,,,2,1,2,3
5612_0,,,,2,1,2,3
5613_0,,,,2,1,2,3
5614_0,,,,2,1,2,3
5615_0,,,,2,1,2,3
5616_0,,,,2,1,2,3
5617_0,,,,2,1,2,3
5619_0,,,,2,1,2,3
C(C(C(CO)O)=O)(CCO)=O,,,4,1,9,16,25
5620_0,,,,2,1,2,3
5621_0,,,,2,1,2,3
5622_0,,,,2,1,2,3
5624_0,,,,2,1,2,3
C(C(CO)CO)(CC(C=O)=O)=O,,,4,1,4,13,17
5625_0,,,,2,1,2,3
5627_0,,,,2,1,2,3
C(C(C=O)C(C(CO)CO)=O)=O,,,4,1,4,9,13
5628_0,,,,2,1,2,3
5630_0,,,,2,1,2,3
C(CC(C(CO)CO)=O)=O,,,4,1,5,20,25
5631_0,,,,2,1,2,3
5632_0,,,,2,1,2,3
5633_0,,,,2,1,2,3
5634_0,,,,2,1,2,3
5635_0,,,,2,1,2,3
5636_0,,,,2,1,2,3
5637_0,,,,2,1,2,3
5639_0,,,,2,1,2,3
C(CC(C(CO)C(CO)O)=O)=O,,,4,1,6,17,23
5640_0,,,,2,1,2,3
5642_0,,,,2,1,2,3
C(C(C(C(CC=O)=O)=O)C)=O,,,4,1,2,15,17
5644_0,,,,2,1,2,3
C(C(C(C=O)=O)C)=O,,,4,1,4,90,94
5646_0,,,,2,1,2,3
C(CC(C(CC(C)=O)=O)=O)=O,,,4,1,3,19,22
5648_0,,,,2,1,2,3
C(CC=O)(CC(C(C)=O)=O)=O,,,4,1,4,17,21
5649_0,,,,2,1,2,3
5651_0,,,,2,1,2,3
C(CC(C(C)=O)=O)=O,,,4,1,17,129,146
5653_0,,,,2,1,2,3
C(CC(CCC(C=O)=O)=O)=O,,,4,1,3,19,22
5655_0,,,,2,1,2,3
C(CCC(CC(C=O)=O)=O)=O,,,4,1,2,19,21
5657_0,,,,2,1,2,3
C(CC(C=O)CC(C=O)=O)=O,,,4,1,8,16,24
5659_0,,,,2,1,2,3
C(C(CCC(C(C)=O)=O)=O)=O,,,4,1,3,13,16
5661_0,,,,2,1,2,3
C(CC(C)=O)(CC(C=O)=O)=O,,,4,1,2,18,20
5663_0,,,,2,1,2,3
C(C=O)(C(C)CC(C=O)=O)=O,,,4,1,1,12,13
5665_0,,,,2,1,2,3
C(CO)(CCC(C=O)=O)=O,,,4,1,9,28,37
5666_0,,,,2,1,2,3
5668_0,,,,2,1,2,3
C(CCO)(CC(C=O)=O)=O,,,4,1,10,28,38
5669_0,,,,2,1,2,3
5671_0,,,,2,1,2,3
C(CCC(C=O)=O)(C(CO)O)=O,,,4,1,7,18,25
5672_0,,,,2,1,2,3
5674_0,,,,2,1,2,3
C(CC(CO)O)(CC(C=O)=O)=O,,,4,1,6,17,23
5675_0,,,,2,1,2,3
5676_0,,,,2,1,2,3
5677_0,,,,2,1,2,3
5679_0,,,,2,1,2,3
C(CCC(C=O)=O)=O,,,4,1,19,110,129
5680_0,,,,2,1,2,3
5682_0,,,,2,1,2,3
C(CC(C(CCC=O)=O)=O)=O,,,4,1,3,17,20
5684_0,,,,2,1,2,3
C(CC(CC(CC=O)=O)=O)=O,,,4,1,2,11,13
5685_0,,,,2,1,2,3
5687_0,,,,2,1,2,3
C(CC(CC=O)=O)=O,,,4,1,6,83,89
5689_0,,,,2,1,2,3
C(C(C=O)CC(CC=O)=O)=O,,,4,1,3,15,18
5691_0,,,,2,1,2,3
C(C(C=O)C(CCC=O)=O)=O,,,4,1,3,13,16
5693_0,,,,2,1,2,3
C(C(C=O)C(C=O)CC=O)=O,,,4,1,7,13,20
5695_0,,,,2,1,2,3
C(C(C=O)CC(C(C)=O)=O)=O,,,4,1,3,10,13
5697_0,,,,2,1,2,3
C(C(C=O)C(CC(C)=O)=O)=O,,,4,1,3,12,15
5699_0,,,,2,1,2,3
C(C(C=O)C(C(C=O)=O)C)=O,,,4,1,2,10,12
5701_0,,,,2,1,2,3
C(C(C=O)CC(CO)=O)=O,,,4,1,5,22,27
5702_0,,,,2,1,2,3
5704_0,,,,2,1,2,3
C(C(C=O)C(CCO)=O)=O,,,4,1,5,19,24
5705_0,,,,2,1,2,3
5707_0,,,,2,1,2,3
C(C(C=O)CC(C(CO)O)=O)=O,,,4,1,6,13,19
5708_0,,,,2,1,2,3
5710_0,,,,2,1,2,3
C(C(C=O)C(CC(CO)O)=O)=O,,,4,1,5,12,17
5711_0,,,,2,1,2,3
5712_0,,,,2,1,2,3
5713_0,,,,2,1,2,3
5715_0,,,,2,1,2,3
C(C(C=O)CC=O)=O,,,4,1,16,92,108
5716_0,,,,2,1,2,3
5718_0,,,,2,1,2,3
C(C(C(C=O)=O)CCO)=O,,,4,1,3,19,22
5719_0,,,,2,1,2,3
5721_0,,,,2,1,2,3
C(CC(C(CCO)=O)=O)=O,,,4,1,10,27,37
5723_0,,,,2,1,2,3
C(CC(C(C=O)=O)CO)(CO)=O,,,4,1,2,18,20
5724_0,,,,2,1,2,3
5726_0,,,,2,1,2,3
C(CCO)(C(C(C=O)=O)CO)=O,,,4,1,6,17,23
5727_0,,,,2,1,2,3
5729_0,,,,2,1,2,3
C(CC(C(C=O)=O)CO)=O,,,4,1,7,22,29
5731_0,,,,2,1,2,3
C(C)(C(C(C=O)=O)CO)=O,,,4,1,7,21,28
5733_0,,,,2,1,2,3
C(CC(CCC=O)=O)=O,,,4,1,3,61,64
5734_0,,,,2,1,2,3
5736_0,,,,2,1,2,3
C(CC(CC(C=O)O)=O)=O,,,4,1,9,32,41
5738_0,,,,2,1,2,3
C(CC(C(CC=O)O)=O)=O,,,4,1,12,33,45
5740_0,,,,2,1,2,3
C(C(C(CCC=O)=O)O)=O,,,4,1,7,27,34
5742_0,,,,2,1,2,3
C(C(CCC(C=O)=O)O)=O,,,4,1,10,22,32
5743_0,,,,2,1,2,3
5745_0,,,,2,1,2,3
C(C(C(C=O)CC(CO)=O)O)=O,,,4,1,4,18,22
5746_0,,,,2,1,2,3
5748_0,,,,2,1,2,3
C(CCO)(C(C=O)C(C=O)O)=O,,,4,1,7,17,24
5749_0,,,,2,1,2,3
5751_0,,,,2,1,2,3
C(CC(C=O)C(C=O)O)=O,,,4,1,11,25,36
5753_0,,,,2,1,2,3
C(C(C(C)=O)C(C=O)O)=O,,,4,1,7,24,31
5754_0,,,,2,1,2,3
5755_0,,,,2,1,2,3
5757_0,,,,2,1,2,3
C(CC(C=O)CC=O)=O,,,4,1,14,27,41
5758_0,,,,2,1,2,3
5759_0,,,,2,1,2,3
5761_0,,,,2,1,2,3
C(C(C(CO)=O)CC(CO)=O)=O,,,4,1,3,17,20
5762_0,,,,2,1,2,3
5764_0,,,,2,1,2,3
C(CCO)(C(C=O)C(CO)=O)=O,,,4,1,4,13,17
5765_0,,,,2,1,2,3
5767_0,,,,2,1,2,3
C(C(C(CO)=O)CC=O)=O,,,4,1,9,27,36
5769_0,,,,2,1,2,3
C(C(C(C)=O)C(CO)=O)=O,,,4,1,8,24,32
5771_0,,,,2,1,2,3
C(CC(CC(C)=O)=O)=O,,,4,1,4,66,70
5773_0,,,,2,1,2,3
C(CC(C(CC)=O)=O)=O,,,4,1,2,49,51
5775_0,,,,2,1,2,3
C(CC(C(CC(CO)=O)O)=O)=O,,,4,1,11,19,30
5776_0,,,,2,1,2,3
5778_0,,,,2,1,2,3
C(CC(C(C(CCO)=O)O)=O)=O,,,4,1,4,13,17
5779_0,,,,2,1,2,3
5780_0,,,,2,1,2,3
5782_0,,,,2,1,2,3
C(CC(C(CC(CO)O)=O)=O)=O,,,4,1,6,16,22
5783_0,,,,2,1,2,3
5784_0,,,,2,1,2,3
5785_0,,,,2,1,2,3
5787_0,,,,2,1,2,3
C(CC(C(C(C)=O)O)=O)=O,,,4,1,6,27,33
5788_0,,,,2,1,2,3
5789_0,,,,2,1,2,3
5791_0,,,,2,1,2,3
C(CCC(C(C)=O)=O)=O,,,4,1,2,49,51
5792_0,,,,2,1,2,3
5793_0,,,,2,1,2,3
5795_0,,,,2,1,2,3
C(C(CC(C(C)=O)=O)O)=O,,,4,1,6,25,31
5796_0,,,,2,1,2,3
5798_0,,,,2,1,2,3
C(C(C=O)O)(CC(C)=O)=O,,,4,1,7,27,34
5800_0,,,,2,1,2,3
C(CC(C(C=O)=O)C)=O,,,4,1,1,35,36
5802_0,,,,2,1,2,3
C(C(C(C(C=O)=O)C)O)=O,,,4,1,5,20,25
5804_0,,,,2,1,2,3
C(C(C(CCC(CO)=O)=O)O)=O,,,4,1,3,16,19
5805_0,,,,2,1,2,3
5807_0,,,,2,1,2,3
C(C(C=O)O)(CC(CCO)=O)=O,,,4,1,4,13,17
5808_0,,,,2,1,2,3
5809_0,,,,2,1,2,3
5810_0,,,,2,1,2,3
5812_0,,,,2,1,2,3
C(C(CC)=O)=O,,,4,1,7,384,391
5813_0,,,,2,1,2,3
5815_0,,,,2,1,2,3
C(CCC(CO)=O)=O,,,4,1,12,105,117
5816_0,,,,2,1,2,3
5818_0,,,,2,1,2,3
C(CC(CCO)=O)=O,,,4,1,17,105,122
5819_0,,,,2,1,2,3
5821_0,,,,2,1,2,3
C(CCC=O)(C(CO)O)=O,,,4,1,7,27,34
5822_0,,,,2,1,2,3
5824_0,,,,2,1,2,3
C(CC(CC(CO)O)=O)=O,,,4,1,9,26,35
5825_0,,,,2,1,2,3
5826_0,,,,2,1,2,3
5827_0,,,,2,1,2,3
5829_0,,,,2,1,2,3
C(CCC=O)=O,,,4,1,40,240,280
5830_0,,,,2,1,2,3
5831_0,,,,2,1,2,3
5832_0,,,,2,1,2,3
5833_0,,,,2,1,2,3
5834_0,,,,2,1,2,3
5835_0,,,,2,1,2,3
5836_0,,,,2,1,2,3
5837_0,,,,2,1,2,3
5838_0,,,,2,1,2,3
5839_0,,,,2,1,2,3
5840_0,,,,2,1,2,3
5841_0,,,,2,1,2,3
5842_0,,,,2,1,2,3
5843_0,,,,2,1,2,3
5844_0,,,,2,1,2,3
5845_0,,,,2,1,2,3
5846_0,,,,2,1,2,3
5847_0,,,,2,1,2,3
5848_0,,,,2,1,2,3
5849_0,,,,2,1,2,3
5850_0,,,,2,1,2,3
5851_0,,,,2,1,2,3
5852_0,,,,2,1,2,3
5853_0,,,,2,1,2,3
5854_0,,,,2,1,2,3
5855_0,,,,2,1,2,3
5856_0,,,,2,1,2,3
5857_0,,,,2,1,2,3
5858_0,,,,2,1,2,3
5859_0,,,,2,1,2,3
5860_0,,,,2,1,2,3
5861_0,,,,2,1,2,3
5862_0,,,,2,1,2,3
5863_0,,,,2,1,2,3
5864_0,,,,2,1,2,3
5865_0,,,,2,1,2,3
5866_0,,,,2,1,2,3
5868_0,,,,2,1,2,3
C(C(C)=O)(C)=O,,,4,1,7,239,246
5869_0,,,,2,1,2,3
5870_0,,,,2,1,2,3
5871_0,,,,2,1,2,3
5872_0,,,,2,1,2,3
5873_0,,,,2,1,2,3
5874_0,,,,2,1,2,3
5875_0,,,,2,1,2,3
5876_0,,,,2,1,2,3
5877_0,,,,2,1,2,3
5878_0,,,,2,1,2,3
5879_0,,,,2,1,2,3
5880_0,,,,2,1,2,3
5881_0,,,,2,1,2,3
5882_0,,,,2,1,2,3
5883_0,,,,2,1,2,3
5885_0,,,,2,1,2,3
C(C(C(C)=O)C(C(CO)O)O)=O,,,4,1,5,16,21
5886_0,,,,2,1,2,3
5887_0,,,,2,1,2,3
5888_0,,,,2,1,2,3
5889_0,,,,2,1,2,3
5890_0,,,,2,1,2,3
5891_0,,,,2,1,2,3
5892_0,,,,2,1,2,3
5893_0,,,,2,1,2,3
5895_0,,,,2,1,2,3
C(C(C(C=O)=O)CO)(O)=O,,,4,1,6,17,23
5896_0,,,,2,1,2,3
5897_0,,,,2,1,2,3
5898_0,,,,2,1,2,3
5900_0,,,,2,1,2,3
C(C(C(C=O)=O)C(CO)O)(O)=O,,,4,1,6,17,23
5902_0,,,,2,1,2,3
C(C(C(C)=O)C(C=O)=O)=O,,,4,1,2,24,26
5903_0,,,,2,1,2,3
5904_0,,,,2,1,2,3
5905_0,,,,2,1,2,3
5906_0,,,,2,1,2,3
5907_0,,,,2,1,2,3
5909_0,,,,2,1,2,3
C(C(C(C=O)=O)C(CO)O)=O,,,4,1,7,18,25
5910_0,,,,2,1,2,3
5912_0,,,,2,1,2,3
C(C(CO)C(C(O)=O)(CO)O)=O,,,4,1,8,15,23
5914_0,,,,2,1,2,3
C(C(CO)C(C=O)(C(C)=O)O)=O,,,4,1,7,15,22
5915_0,,,,2,1,2,3
5916_0,,,,2,1,2,3
5917_0,,,,2,1,2,3
5919_0,,,,2,1,2,3
C(CO)(C(C(C(C)=O)=O)CO)=O,,,4,1,4,14,18
5920_0,,,,2,1,2,3
5922_0,,,,2,1,2,3
C(CC=O)(C(C(CO)=O)CO)=O,,,4,1,5,15,20
5923_0,,,,2,1,2,3
5925_0,,,,2,1,2,3
C(C)(C(C(CO)=O)CO)=O,,,4,1,7,22,29
5926_0,,,,2,1,2,3
5927_0,,,,2,1,2,3
5928_0,,,,2,1,2,3
5930_0,,,,2,1,2,3
C(C)(C(C(CO)=O)(CO)O)=O,,,4,1,6,10,16
5932_0,,,,2,1,2,3
C(CO)(C(C(CO)=O)CO)=O,,,4,1,6,9,15
5933_0,,,,2,1,2,3
5934_0,,,,2,1,2,3
5936_0,,,,2,1,2,3
C(C(C(C(C)=O)=O)CO)(O)=O,,,4,1,5,12,17
5937_0,,,,2,1,2,3
5939_0,,,,2,1,2,3
C(C(C(CC=O)=O)CO)(O)=O,,,4,1,7,15,22
5940_0,,,,2,1,2,3
5942_0,,,,2,1,2,3
C(C(C(C)=O)CO)(O)=O,,,4,1,4,25,29
5943_0,,,,2,1,2,3
5945_0,,,,2,1,2,3
C(C(C(C)=O)C(CO)O)(O)=O,,,4,1,4,13,17
5946_0,,,,2,1,2,3
5947_0,,,,2,1,2,3
5948_0,,,,2,1,2,3
5949_0,,,,2,1,2,3
5950_0,,,,2,1,2,3
5951_0,,,,2,1,2,3
5952_0,,,,2,1,2,3
5954_0,,,,2,1,2,3
C(C(C(C)=O)C(C(C)=O)=O)=O,,,4,1,3,14,17
5955_0,,,,2,1,2,3
5957_0,,,,2,1,2,3
C(C(C(C(C)=O)=O)CO)=O,,,4,1,6,20,26
5958_0,,,,2,1,2,3
5959_0,,,,2,1,2,3
5960_0,,,,2,1,2,3
5962_0,,,,2,1,2,3
C(C(C(C(C)=O)=O)C(CO)O)=O,,,4,1,7,16,23
5964_0,,,,2,1,2,3
C(C(C(CC=O)=O)C(C)=O)=O,,,4,1,3,15,18
5965_0,,,,2,1,2,3
5967_0,,,,2,1,2,3
C(C(C(CC=O)=O)CO)=O,,,4,1,6,24,30
5968_0,,,,2,1,2,3
5969_0,,,,2,1,2,3
5970_0,,,,2,1,2,3
5972_0,,,,2,1,2,3
C(C(C(CC=O)=O)C(CO)O)=O,,,4,1,8,17,25
5973_0,,,,2,1,2,3
5974_0,,,,2,1,2,3
5976_0,,,,2,1,2,3
C(C(C(C(CCO)=O)=O)CO)=O,,,4,1,6,16,22
5977_0,,,,2,1,2,3
5979_0,,,,2,1,2,3
C(C(CO)(CC(CC=O)=O)O)=O,,,4,1,6,17,23
5981_0,,,,2,1,2,3
C(CC(C(C(C=O)CO)=O)O)=O,,,4,1,9,18,27
5983_0,,,,2,1,2,3
C(C(C(CCC=O)=O)(CO)O)=O,,,4,1,5,13,18
5984_0,,,,2,1,2,3
5986_0,,,,2,1,2,3
C(CC(C=O)O)(C(C=O)CO)=O,,,4,1,7,17,24
5987_0,,,,2,1,2,3
5989_0,,,,2,1,2,3
C(C(C(CC(CO)=O)=O)CO)=O,,,4,1,6,15,21
5990_0,,,,2,1,2,3
5992_0,,,,2,1,2,3
C(CC(C=O)C(C=O)(CO)O)=O,,,4,1,6,17,23
5994_0,,,,2,1,2,3
C(C(C(C)=O)C(C)=O)=O,,,4,1,2,31,33
5996_0,,,,2,1,2,3
C(C(C(C)=O)(CC(CO)=O)O)=O,,,4,1,5,14,19
5997_0,,,,2,1,2,3
5999_0,,,,2,1,2,3
C(CCO)(C(C=O)(C(C)=O)O)=O,,,4,1,3,8,11
6001_0,,,,2,1,2,3
C(C(CO)O)(C(C=O)C(C)=O)=O,,,4,1,6,15,21
6002_0,,,,2,1,2,3
6003_0,,,,2,1,2,3
6005_0,,,,2,1,2,3
C(C(C(C)=O)(CC=O)O)=O,,,4,1,7,21,28
6007_0,,,,2,1,2,3
C(C(C(C)=O)(C(C)=O)O)=O,,,4,1,2,8,10
6008_0,,,,2,1,2,3
6009_0,,,,2,1,2,3
6011_0,,,,2,1,2,3
C(C(CO)(CC(C(C)=O)=O)O)=O,,,4,1,5,14,19
6013_0,,,,2,1,2,3
C(C(C(C(C(C)=O)O)=O)CO)=O,,,4,1,4,13,17
6015_0,,,,2,1,2,3
C(C(C(CC(C)=O)=O)(CO)O)=O,,,4,1,5,12,17
6016_0,,,,2,1,2,3
6018_0,,,,2,1,2,3
C(C(CO)(C(C(C=O)=O)C)O)=O,,,4,1,4,15,19
6019_0,,,,2,1,2,3
6021_0,,,,2,1,2,3
C(C(C(C)=O)CO)=O,,,4,1,10,75,85
6022_0,,,,2,1,2,3
6023_0,,,,2,1,2,3
6024_0,,,,2,1,2,3
6026_0,,,,2,1,2,3
C(C(C(C)=O)C(CO)O)=O,,,4,1,8,20,28
6028_0,,,,2,1,2,3
C(C(C(C=O)=O)CC=O)=O,,,4,1,5,25,30
6030_0,,,,2,1,2,3
C(CC(C(O)=O)=O)=O,,,4,1,16,67,83
6032_0,,,,2,1,2,3
C(CC(C=O)=O)(O)=O,,,4,1,23,69,92
6034_0,,,,2,1,2,3
C(CC(C=O)(C(C=O)CO)O)=O,,,4,1,8,18,26
6035_0,,,,2,1,2,3
6036_0,,,,2,1,2,3
6037_0,,,,2,1,2,3
6038_0,,,,2,1,2,3
6039_0,,,,2,1,2,3
6040_0,,,,2,1,2,3
6041_0,,,,2,1,2,3
6042_0,,,,2,1,2,3
6043_0,,,,2,1,2,3
6044_0,,,,2,1,2,3
6045_0,,,,2,1,2,3
6047_0,,,,2,1,2,3
C(C(C(C(O)=O)=O)C)=O,,,4,1,2,20,22
6049_0,,,,2,1,2,3
C(C(C(C(C)=O)=O)CC=O)=O,,,4,1,4,14,18
6051_0,,,,2,1,2,3
C(C)(CC(C(O)=O)=O)=O,,,4,1,6,31,37
6053_0,,,,2,1,2,3
C(CC(C(C)=O)=O)(O)=O,,,4,1,7,32,39
6055_0,,,,2,1,2,3
C(C(C(CC=O)=O)CC=O)=O,,,4,1,4,18,22
6057_0,,,,2,1,2,3
C(CCC(C(O)=O)=O)=O,,,4,1,4,26,30
6059_0,,,,2,1,2,3
C(CC(CC(O)=O)=O)=O,,,4,1,7,40,47
6061_0,,,,2,1,2,3
C(C(C(C(O)=O)=O)CCO)=O,,,4,1,2,12,14
6063_0,,,,2,1,2,3
C(CCO)(CC(C(O)=O)=O)=O,,,4,1,4,13,17
6065_0,,,,2,1,2,3
C(CC(C(CCO)=O)=O)(O)=O,,,4,1,4,14,18
6067_0,,,,2,1,2,3
C(C(C(C)=O)CC=O)=O,,,4,1,8,51,59
6069_0,,,,2,1,2,3
C(CC(C=O)(CC(CO)=O)O)=O,,,4,1,9,17,26
6070_0,,,,2,1,2,3
6072_0,,,,2,1,2,3
C(CCO)(C(C=O)(CC=O)O)=O,,,4,1,4,14,18
6074_0,,,,2,1,2,3
C(C(CO)O)(C(C=O)CC=O)=O,,,4,1,8,18,26
6075_0,,,,2,1,2,3
6076_0,,,,2,1,2,3
6078_0,,,,2,1,2,3
C(CC(C=O)(CC=O)O)=O,,,4,1,5,15,20
6079_0,,,,2,1,2,3
6080_0,,,,2,1,2,3
6081_0,,,,2,1,2,3
6083_0,,,,2,1,2,3
C(CC(CC(C(O)=O)O)=O)=O,,,4,1,7,17,24
6085_0,,,,2,1,2,3
C(CC(C(CC=O)O)=O)(O)=O,,,4,1,5,18,23
6087_0,,,,2,1,2,3
C(C(C(CCC=O)=O)O)(O)=O,,,4,1,5,16,21
6089_0,,,,2,1,2,3
C(C(CCC(C(O)=O)=O)O)=O,,,4,1,4,12,16
6091_0,,,,2,1,2,3
C(CC(CC(C=O)O)=O)(O)=O,,,4,1,5,18,23
6093_0,,,,2,1,2,3
C(CO)(CCC(C(O)=O)=O)=O,,,4,1,4,13,17
6095_0,,,,2,1,2,3
C(CC(CC(CO)=O)=O)(O)=O,,,4,1,6,15,21
6097_0,,,,2,1,2,3
C(CC(C(C(O)=O)=O)CO)=O,,,4,1,4,13,17
6099_0,,,,2,1,2,3
C(C(C(C=O)CC=O)O)(O)=O,,,4,1,8,16,24
6100_0,,,,2,1,2,3
6102_0,,,,2,1,2,3
C(C(CC(C(C)=O)=O)O)(O)=O,,,4,1,4,13,17
6104_0,,,,2,1,2,3
C(CC(C(C(C)=O)O)=O)(O)=O,,,4,1,3,13,16
6106_0,,,,2,1,2,3
C(C(C(O)=O)O)(CC(C)=O)=O,,,4,1,5,14,19
6108_0,,,,2,1,2,3
C(C(C(C(C(O)=O)=O)C)O)=O,,,4,1,3,11,14
6110_0,,,,2,1,2,3
C(C(C(C(C=O)=O)C)O)(O)=O,,,4,1,3,13,16
6112_0,,,,2,1,2,3
C(C(O)=O)(CC)=O,,,4,1,3,97,100
6114_0,,,,2,1,2,3
C(CC(C)=O)(O)=O,,,4,1,10,173,183
6115_0,,,,2,1,2,3
6116_0,,,,2,1,2,3
6117_0,,,,2,1,2,3
6118_0,,,,2,1,2,3
6119_0,,,,2,1,2,3
6120_0,,,,2,1,2,3
6121_0,,,,2,1,2,3
6122_0,,,,2,1,2,3
6123_0,,,,2,1,2,3
6124_0,,,,2,1,2,3
6125_0,,,,2,1,2,3
6126_0,,,,2,1,2,3
6127_0,,,,2,1,2,3
6128_0,,,,2,1,2,3
6129_0,,,,2,1,2,3
6130_0,,,,2,1,2,3
6131_0,,,,2,1,2,3
6132_0,,,,2,1,2,3
6133_0,,,,2,1,2,3
6134_0,,,,2,1,2,3
6135_0,,,,2,1,2,3
6136_0,,,,2,1,2,3
6138_0,,,,2,1,2,3
C1(COC(CO)C1O)=O,,,4,1,2,33,35
6140_0,,,,2,1,2,3
C1(C(O)OC(CO)C1)=O,,,4,1,5,29,34
6142_0,,,,2,1,2,3
C1(CC(C(CO)O1)O)=O,,,4,1,6,11,17
6143_0,,,,2,1,2,3
6145_0,,,,2,1,2,3
C1(COC(C(CO)O)C1O)=O,,,4,1,2,9,11
6147_0,,,,2,1,2,3
C1(C(O)OC(C(CO)O)C1)=O,,,4,1,6,10,16
6149_0,,,,2,1,2,3
C1(CC(C(C(CO)O)O1)O)=O,,,4,1,4,4,8
6150_0,,,,2,1,2,3
6152_0,,,,2,1,2,3
C(CC1C(C(C(O)O1)O)O)=O,,,4,1,3,13,16
6154_0,,,,2,1,2,3
C(C)(C1C(C(C(O1)O)O)O)=O,,,4,1,3,12,15
6156_0,,,,2,1,2,3
C1(C(CO)OC(C1CO)O)=O,,,4,1,6,13,19
6158_0,,,,2,1,2,3
C1(C(CO)C(C(CO)O1)O)=O,,,4,1,3,5,8
6160_0,,,,2,1,2,3
C(C1C(O)OC(CO)C1O)=O,,,4,1,2,12,14
6161_0,,,,2,1,2,3
6162_0,,,,2,1,2,3
6164_0,,,,2,1,2,3
C(C1C(O)OCC1O)=O,,,4,1,2,23,25
6165_0,,,,2,1,2,3
6166_0,,,,2,1,2,3
6168_0,,,,2,1,2,3
C(CC1(C(O)OCC1O)O)=O,,,4,1,3,12,15
6170_0,,,,2,1,2,3
C(CO)(C1C(O)OCC1O)=O,,,4,1,3,12,15
6172_0,,,,2,1,2,3
C(C)(C1(C(O)OCC1O)O)=O,,,4,1,2,11,13
6174_0,,,,2,1,2,3
C1(COCC(C1O)O)=O,,,4,1,1,36,37
6176_0,,,,2,1,2,3
C1(C(O)OCC(C1)O)=O,,,4,1,4,30,34
6178_0,,,,2,1,2,3
C1(CC(C(CO1)O)O)=O,,,4,1,5,14,19
6180_0,,,,2,1,2,3
C1(COC(C(C1)O)O)=O,,,4,1,4,37,41
6182_0,,,,2,1,2,3
C1(C(COC(C1)O)O)=O,,,4,1,4,36,40
6184_0,,,,2,1,2,3
C1(C(C(O)OCC1)O)=O,,,4,1,5,38,43
6186_0,,,,2,1,2,3
C1(COC(CO)C(C1O)O)=O,,,4,1,1,10,11
6188_0,,,,2,1,2,3
C1(C(O)OC(CO)C(C1)O)=O,,,4,1,4,9,13
6190_0,,,,2,1,2,3
C1(CC(C(C(CO)O1)O)O)=O,,,4,1,3,5,8
6192_0,,,,2,1,2,3
C1(C(CO)OC(C(C1)O)O)=O,,,4,1,5,12,17
6194_0,,,,2,1,2,3
C1(C(C(CO)OC(C1)O)O)=O,,,4,1,3,10,13
6196_0,,,,2,1,2,3
C1(C(C(O)OC(CO)C1)O)=O,,,4,1,3,12,15
6198_0,,,,2,1,2,3
C1(COC(C(CO)(C1)O)O)=O,,,4,1,2,11,13
6200_0,,,,2,1,2,3
C1(CCOC(C1(CO)O)O)=O,,,4,1,4,12,16
6202_0,,,,2,1,2,3
C1(C(COC(C1CO)O)O)=O,,,4,1,4,12,16
6204_0,,,,2,1,2,3
C1(C(CO)C(C(CO1)O)O)=O,,,4,1,2,8,10
6206_0,,,,2,1,2,3
C(C1C(O)OCC(C1O)O)=O,,,4,1,2,14,16
6208_0,,,,2,1,2,3
C1(COCC(C(C1O)O)O)=O,,,4,1,1,12,13
6210_0,,,,2,1,2,3
C1(C(O)OCC(C(C1)O)O)=O,,,4,1,4,11,15
6212_0,,,,2,1,2,3
C1(CC(C(C(CO1)O)O)O)=O,,,4,1,2,8,10
6214_0,,,,2,1,2,3
C1(C(COC(C(C1)O)O)O)=O,,,4,1,2,12,14
6216_0,,,,2,1,2,3
C1(C(C(C(O)OCC1)O)O)=O,,,4,1,2,14,16
6218_0,,,,2,1,2,3
C1(C(C(COC(C1)O)O)O)=O,,,4,1,2,13,15
6220_0,,,,2,1,2,3
C1(C(C(O)OCC(C1)O)O)=O,,,4,1,2,13,15
6222_0,,,,2,1,2,3
C1(COC(C(C(C1)O)O)O)=O,,,4,1,2,13,15
6224_0,,,,2,1,2,3
C1(C(OCC1)=O)=O,,,4,1,20,182,202
6226_0,,,,2,1,2,3
C1(CC(CO1)=O)=O,,,4,1,9,284,293
6228_0,,,,2,1,2,3
C1(C(CC(CO)O1)=O)=O,,,4,1,3,20,23
6230_0,,,,2,1,2,3
C1(CC(C(CO)O1)=O)=O,,,4,1,5,33,38
6232_0,,,,2,1,2,3
C1(C(CC(C(CO)O)O1)=O)=O,,,4,1,4,7,11
6234_0,,,,2,1,2,3
C1(CC(C(C(CO)O)O1)=O)=O,,,4,1,6,10,16
6236_0,,,,2,1,2,3
C(CC1C(C(C(O1)=O)O)O)=O,,,4,1,2,14,16
6238_0,,,,2,1,2,3
C1(C(C(C(C(C)=O)O1)O)O)=O,,,4,1,2,12,14
6240_0,,,,2,1,2,3
C1(C(CC(CO1)O)=O)=O,,,4,1,3,22,25
6242_0,,,,2,1,2,3
C1(C(CC(CO1)=O)O)=O,,,4,1,4,39,43
6244_0,,,,2,1,2,3
C1(CC(C(CO1)O)=O)=O,,,4,1,2,33,35
6246_0,,,,2,1,2,3
C1(C(C(CCO1)=O)O)=O,,,4,1,2,32,34
6248_0,,,,2,1,2,3
C1(C(CC(C(CO)O1)O)=O)=O,,,4,1,4,7,11
6250_0,,,,2,1,2,3
C1(CC(C(OC1CO)=O)O)=O,,,4,1,5,10,15
6252_0,,,,2,1,2,3
C1(CC(C(C(CO)O1)O)=O)=O,,,4,1,3,8,11
6254_0,,,,2,1,2,3
C1(C(C(CC(CO)O1)=O)O)=O,,,4,1,3,7,10
6256_0,,,,2,1,2,3
C1(C(CC(C(CO1)O)O)=O)=O,,,4,1,3,10,13
6258_0,,,,2,1,2,3
C1(CC(C(OCC1O)=O)O)=O,,,4,1,2,10,12
6260_0,,,,2,1,2,3
C1(C(C(C(OCC1)=O)O)O)=O,,,4,1,2,13,15
6262_0,,,,2,1,2,3
C1(CC(C(C(CO1)O)O)=O)=O,,,4,1,2,12,14
6264_0,,,,2,1,2,3
C1(C(C(CC(CO1)O)=O)O)=O,,,4,1,2,9,11
6266_0,,,,2,1,2,3
C1(C(C(CC(CO1)=O)O)O)=O,,,4,1,3,13,16
6268_0,,,,2,1,2,3
C(C(C(C(CO)O)O)O)=CC=O,,,4,1,3,11,14
6270_0,,,,2,1,2,3
C(C(C=CC=O)=O)=O,,,4,1,11,145,156
6272_0,,,,2,1,2,3
C(C(C=O)=CC=O)=O,,,4,1,7,118,125
6274_0,,,,2,1,2,3
C(C(C(C(C=O)=O)=C)O)=O,,,4,1,3,23,26
6276_0,,,,2,1,2,3
C(C(C(CO)=CC=O)=O)=O,,,4,1,5,22,27
6278_0,,,,2,1,2,3
C(C(C(C=O)=CC=O)O)=O,,,4,1,5,26,31
6280_0,,,,2,1,2,3
C(C(C(CO)=O)=CC=O)=O,,,4,1,5,30,35
6282_0,,,,2,1,2,3
C(C(C(C=CC=O)=O)O)=O,,,4,1,4,30,34
6284_0,,,,2,1,2,3
C(CO)(CO)=CC(C=O)=O,,,4,1,2,12,14
6286_0,,,,2,1,2,3
C(CO)(CO)=C(C=O)C=O,,,4,1,1,9,10
6288_0,,,,2,1,2,3
C=C(C(C=O)=O)C(CO)(CO)O,,,4,1,2,11,13
6290_0,,,,2,1,2,3
C(CO)(CO)=C(C(C=O)=O)CO,,,4,1,1,8,9
6292_0,,,,2,1,2,3
C(C=C(C=O)C(CO)(CO)O)=O,,,4,1,2,9,11
6294_0,,,,2,1,2,3
C(C(C(C=O)=C(CO)CO)O)=O,,,4,1,3,8,11
6296_0,,,,2,1,2,3
C(CO)(CO)=C(C=O)C(CO)=O,,,4,1,2,6,8
6298_0,,,,2,1,2,3
C(C(C(C=C(CO)CO)=O)O)=O,,,4,1,1,6,7
6300_0,,,,2,1,2,3
C(CO)(CO)=CC=O,,,4,1,5,41,46
6302_0,,,,2,1,2,3
C(CO)(C(C(C=O)=C)O)=O,,,4,1,7,26,33
6304_0,,,,2,1,2,3
C(CO)(C(C=CC=O)O)=O,,,4,1,8,23,31
6306_0,,,,2,1,2,3
C(CO)(C(C(C=O)=CCO)O)=O,,,4,1,2,11,13
6307_0,,,,2,1,2,3
6308_0,,,,2,1,2,3
6309_0,,,,2,1,2,3
6310_0,,,,2,1,2,3
6312_0,,,,2,1,2,3
C(C(C=CC(C(CO)=O)O)O)=O,,,4,1,2,11,13
6314_0,,,,2,1,2,3
C(CO)(C(C=CC(CO)=O)O)=O,,,4,1,2,9,11
6316_0,,,,2,1,2,3
C(CO)(C(C(CO)=CC=O)O)=O,,,4,1,1,9,10
6318_0,,,,2,1,2,3
C(C(C(C(C(CO)=O)O)=C)O)=O,,,4,1,1,12,13
6320_0,,,,2,1,2,3
C(CO)(C(C=C)O)=O,,,4,1,5,69,74
6322_0,,,,2,1,2,3
C(CO)(C(CO)O)=CC(C=O)=O,,,4,1,2,8,10
6324_0,,,,2,1,2,3
C(CO)(C(CO)O)=C(C=O)C=O,,,4,1,2,6,8
6326_0,,,,2,1,2,3
C(CO)(C(CO)O)=CC=O,,,4,1,5,11,16
6328_0,,,,2,1,2,3
C(C(CO)O)(C(C(C=O)=C)O)=O,,,4,1,5,17,22
6330_0,,,,2,1,2,3
C(C(CO)O)(C(C=CC=O)O)=O,,,4,1,6,13,19
6332_0,,,,2,1,2,3
C(C(CO)O)(C(C=C)O)=O,,,4,1,4,18,22
6334_0,,,,2,1,2,3
C(C(CO)(CO)O)=CC(C=O)=O,,,4,1,2,7,9
6336_0,,,,2,1,2,3
C(C(CO)(CO)O)=C(C=O)C=O,,,4,1,1,5,6
6338_0,,,,2,1,2,3
C(C(CO)(CO)O)=CC=O,,,4,1,2,10,12
6340_0,,,,2,1,2,3
C(C(CO)(C(CO)O)O)=CC=O,,,4,1,2,8,10
6342_0,,,,2,1,2,3
C(C(C)=CC(C=O)=O)=O,,,4,1,2,54,56
6344_0,,,,2,1,2,3
C=C(C=O)CC(C=O)=O,,,4,1,3,55,58
6346_0,,,,2,1,2,3
C(C(C=O)=C(C=O)C)=O,,,4,1,1,45,46
6348_0,,,,2,1,2,3
C(C(C=O)C(C=O)=C)=O,,,4,1,3,46,49
6350_0,,,,2,1,2,3
C(C(C(C(C=O)=O)=C)(C)O)=O,,,4,1,2,12,14
6352_0,,,,2,1,2,3
C(C(C(CO)=C(C=O)C)=O)=O,,,4,1,1,12,13
6354_0,,,,2,1,2,3
C=C(C=O)C(C(C=O)=O)CO,,,4,1,3,15,18
6356_0,,,,2,1,2,3
C(C(C(C=O)=CC=O)(C)O)=O,,,4,1,2,12,14
6358_0,,,,2,1,2,3
C(C(C(C=O)=C(C=O)C)O)=O,,,4,1,2,13,15
6360_0,,,,2,1,2,3
C(C(C(C=O)=C)C(C=O)O)=O,,,4,1,4,16,20
6362_0,,,,2,1,2,3
C(C(C(CO)=O)=C(C=O)C)=O,,,4,1,2,14,16
6364_0,,,,2,1,2,3
C(C(C(CO)=O)C(C=O)=C)=O,,,4,1,5,18,23
6366_0,,,,2,1,2,3
C(CC(C(C(C=O)=C)O)=O)=O,,,4,1,3,18,21
6368_0,,,,2,1,2,3
C(C(C(C=C(C=O)C)=O)O)=O,,,4,1,1,14,15
6370_0,,,,2,1,2,3
C(C(C(CC(C=O)=C)=O)O)=O,,,4,1,2,17,19
6372_0,,,,2,1,2,3
C(C(C)=CC=O)=O,,,4,1,2,266,268
6374_0,,,,2,1,2,3
C(CC(C=O)=C)=O,,,4,1,8,264,272
6376_0,,,,2,1,2,3
C(C(C(C=O)=C)O)=O,,,4,1,8,89,97
6378_0,,,,2,1,2,3
C(C(C=CC(C)=O)=O)=O,,,4,1,4,66,70
6380_0,,,,2,1,2,3
C(C(C=O)=CC(C)=O)=O,,,4,1,3,56,59
6382_0,,,,2,1,2,3
C(C)(C(C(C(C=O)=O)=C)O)=O,,,4,1,3,16,19
6384_0,,,,2,1,2,3
C(C(C(CO)=CC(C)=O)=O)=O,,,4,1,2,14,16
6386_0,,,,2,1,2,3
C(C)(C(C(C=O)=CC=O)O)=O,,,4,1,3,16,19
6388_0,,,,2,1,2,3
C(C(C(C=O)=CC(C)=O)O)=O,,,4,1,3,15,18
6390_0,,,,2,1,2,3
C(C(C(CO)=O)=CC(C)=O)=O,,,4,1,3,16,19
6392_0,,,,2,1,2,3
C(C(C(C=CC(C)=O)=O)O)=O,,,4,1,2,16,18
6394_0,,,,2,1,2,3
C(C=CC(C)=O)=O,,,4,1,4,328,332
6396_0,,,,2,1,2,3
C(CC(C=O)=O)=CC=O,,,4,1,4,55,59
6398_0,,,,2,1,2,3
C(CC=CC(C=O)=O)=O,,,4,1,3,56,59
6400_0,,,,2,1,2,3
C(CO)=C(C=O)CC(C=O)=O,,,4,1,2,11,13
6401_0,,,,2,1,2,3
6403_0,,,,2,1,2,3
C(C(C=C(C=O)CCO)=O)=O,,,4,1,1,12,13
6404_0,,,,2,1,2,3
6406_0,,,,2,1,2,3
C(C(C=CC(CCO)=O)=O)=O,,,4,1,3,18,21
6407_0,,,,2,1,2,3
6409_0,,,,2,1,2,3
C(CC(C=CC(C=O)=O)O)=O,,,4,1,4,18,22
6410_0,,,,2,1,2,3
6412_0,,,,2,1,2,3
C(C(C=CCC(C=O)=O)O)=O,,,4,1,3,15,18
6414_0,,,,2,1,2,3
C(C(CC=CC(C=O)=O)O)=O,,,4,1,2,14,16
6416_0,,,,2,1,2,3
C(CC(C=O)=O)=CC(CO)=O,,,4,1,3,16,19
6418_0,,,,2,1,2,3
C(CO)(CC=CC(C=O)=O)=O,,,4,1,3,17,20
6420_0,,,,2,1,2,3
C(CO)(CC(C=O)=O)=CC=O,,,4,1,1,13,14
6422_0,,,,2,1,2,3
C(CC(CO)=CC(C=O)=O)=O,,,4,1,2,13,15
6424_0,,,,2,1,2,3
C(C)(C(C=CC(C=O)=O)O)=O,,,4,1,3,14,17
6426_0,,,,2,1,2,3
C(C(C(CC(C=O)=O)=C)O)=O,,,4,1,1,15,16
6428_0,,,,2,1,2,3
C(C(C(C)=CC(C=O)=O)O)=O,,,4,1,1,12,13
6430_0,,,,2,1,2,3
C=CCC(C=O)=O,,,4,1,3,199,202
6432_0,,,,2,1,2,3
C(C)=CC(C=O)=O,,,4,1,2,201,203
6434_0,,,,2,1,2,3
C(C(CO)O)=CC(C=O)=O,,,4,1,5,14,19
6436_0,,,,2,1,2,3
C(C(C(CO)O)O)=CC(C=O)=O,,,4,1,6,10,16
6438_0,,,,2,1,2,3
C(CO)=CC(C=O)=O,,,4,1,4,67,71
6440_0,,,,2,1,2,3
C(CC=C(C=O)C=O)=O,,,4,1,2,46,48
6442_0,,,,2,1,2,3
C(C(C=O)C=CC=O)=O,,,4,1,2,46,48
6444_0,,,,2,1,2,3
C(CC(C(C(C=O)=O)=C)O)=O,,,4,1,3,18,21
6446_0,,,,2,1,2,3
C(CC=C(C(C=O)=O)CO)=O,,,4,1,2,14,16
6448_0,,,,2,1,2,3
C(C(C(C=O)=O)CO)=CC=O,,,4,1,2,14,16
6450_0,,,,2,1,2,3
C(CC(C(C=O)=CC=O)O)=O,,,4,1,4,18,22
6452_0,,,,2,1,2,3
C(CC=C(C=O)C(C=O)O)=O,,,4,1,3,16,19
6454_0,,,,2,1,2,3
C(C(C=CC=O)C(C=O)O)=O,,,4,1,3,16,19
6456_0,,,,2,1,2,3
C(CC=C(C=O)C(CO)=O)=O,,,4,1,3,15,18
6458_0,,,,2,1,2,3
C(C(C(CO)=O)C=CC=O)=O,,,4,1,4,16,20
6460_0,,,,2,1,2,3
C(CC(C(C=CC=O)O)=O)=O,,,4,1,2,16,18
6462_0,,,,2,1,2,3
C(CC=CC(C(C=O)O)=O)=O,,,4,1,2,16,18
6464_0,,,,2,1,2,3
C(C(C(CC=CC=O)=O)O)=O,,,4,1,1,15,16
6466_0,,,,2,1,2,3
C(CC=CC=O)=O,,,4,1,4,264,268
6468_0,,,,2,1,2,3
C(C(C=CC=O)O)=O,,,4,1,9,88,97
6470_0,,,,2,1,2,3
C(C(C=O)C(C=O)=CCO)=O,,,4,1,3,9,12
6471_0,,,,2,1,2,3
6473_0,,,,2,1,2,3
C(C(C=O)=C(C=O)CCO)=O,,,4,1,1,10,11
6474_0,,,,2,1,2,3
6476_0,,,,2,1,2,3
C(C(C=O)=CC(CCO)=O)=O,,,4,1,3,14,17
6477_0,,,,2,1,2,3
6479_0,,,,2,1,2,3
C(CC(C=C(C=O)C=O)O)=O,,,4,1,3,14,17
6480_0,,,,2,1,2,3
6482_0,,,,2,1,2,3
C(C(C=O)C=CC(C=O)O)=O,,,4,1,3,12,15
6484_0,,,,2,1,2,3
C(C(CC=C(C=O)C=O)O)=O,,,4,1,2,11,13
6486_0,,,,2,1,2,3
C(C(C=O)C=CC(CO)=O)=O,,,4,1,3,12,15
6488_0,,,,2,1,2,3
C(CO)(CC=C(C=O)C=O)=O,,,4,1,3,12,15
6490_0,,,,2,1,2,3
C(C(C=O)C(CO)=CC=O)=O,,,4,1,2,10,12
6492_0,,,,2,1,2,3
C(CC(CO)=C(C=O)C=O)=O,,,4,1,2,10,12
6494_0,,,,2,1,2,3
C(C)(C(C=C(C=O)C=O)O)=O,,,4,1,2,10,12
6496_0,,,,2,1,2,3
C(C(C=O)C(C(C=O)O)=C)=O,,,4,1,2,11,13
6498_0,,,,2,1,2,3
C(C(C(C)=C(C=O)C=O)O)=O,,,4,1,1,9,10
6500_0,,,,2,1,2,3
C(C(C=O)C=C)=O,,,4,1,2,142,144
6502_0,,,,2,1,2,3
C(C)=C(C=O)C=O,,,4,1,1,144,145
6504_0,,,,2,1,2,3
C(C(CO)O)=C(C=O)C=O,,,4,1,3,11,14
6506_0,,,,2,1,2,3
C(C(C(CO)O)O)=C(C=O)C=O,,,4,1,5,8,13
6508_0,,,,2,1,2,3
C=C(C=O)C=O,,,4,1,2,311,313
6510_0,,,,2,1,2,3
C(CO)=C(C=O)C=O,,,4,1,2,49,51
6512_0,,,,2,1,2,3
C(C=C(C=O)CCO)=O,,,4,1,1,38,39
6514_0,,,,2,1,2,3
C(CC(C=O)=CCO)=O,,,4,1,3,36,39
6515_0,,,,2,1,2,3
6517_0,,,,2,1,2,3
C(C(C(C=O)=CCO)O)=O,,,4,1,6,17,23
6518_0,,,,2,1,2,3
6520_0,,,,2,1,2,3
C(C=CC(CCO)=O)=O,,,4,1,3,56,59
6521_0,,,,2,1,2,3
6522_0,,,,2,1,2,3
6524_0,,,,2,1,2,3
C=CC(C(C=O)=O)CO,,,4,1,2,30,32
6526_0,,,,2,1,2,3
C(C)=C(C(C=O)=O)CO,,,4,1,1,29,30
6528_0,,,,2,1,2,3
C=C(C(C=O)=O)C(C)O,,,4,1,2,30,32
6530_0,,,,2,1,2,3
C(C(CO)O)=C(C(C=O)=O)CO,,,4,1,3,10,13
6532_0,,,,2,1,2,3
C=C(C(C=O)=O)C(C(CO)O)O,,,4,1,4,17,21
6534_0,,,,2,1,2,3
C=C(C(C=O)=O)CO,,,4,1,3,69,72
6536_0,,,,2,1,2,3
C(CO)=C(C(C=O)=O)CO,,,4,1,2,14,16
6538_0,,,,2,1,2,3
C=C(C(C=O)=O)C(CO)O,,,4,1,3,18,21
6539_0,,,,2,1,2,3
6540_0,,,,2,1,2,3
6542_0,,,,2,1,2,3
C(C(CC=CC=O)O)=O,,,4,1,2,38,40
6543_0,,,,2,1,2,3
6545_0,,,,2,1,2,3
C(CC=CC(C=O)O)=O,,,4,1,2,38,40
6546_0,,,,2,1,2,3
6548_0,,,,2,1,2,3
C(C(C=CC(C=O)O)O)=O,,,4,1,4,9,13
6550_0,,,,2,1,2,3
C(C(C=C)C(C=O)O)=O,,,4,1,3,38,41
6552_0,,,,2,1,2,3
C(C(C(C=O)=CC)O)=O,,,4,1,2,37,39
6554_0,,,,2,1,2,3
C(C=C(C=O)C(C)O)=O,,,4,1,3,38,41
6556_0,,,,2,1,2,3
C(C(C(C=O)=CC(CO)O)O)=O,,,4,1,5,10,15
6558_0,,,,2,1,2,3
C(C=C(C=O)C(C(CO)O)O)=O,,,4,1,4,14,18
6559_0,,,,2,1,2,3
6561_0,,,,2,1,2,3
C(C(CO)=CC=O)=O,,,4,1,5,90,95
6562_0,,,,2,1,2,3
6564_0,,,,2,1,2,3
C(C=C(C=O)C(CO)O)=O,,,4,1,4,20,24
6566_0,,,,2,1,2,3
C(CO)(CC=CC=O)=O,,,4,1,4,53,57
6568_0,,,,2,1,2,3
C(CC=CC(CO)=O)=O,,,4,1,3,53,56
6570_0,,,,2,1,2,3
C(C(C=CC(CO)=O)O)=O,,,4,1,5,23,28
6572_0,,,,2,1,2,3
C(CC(CO)=CC=O)=O,,,4,1,2,37,39
6574_0,,,,2,1,2,3
C(C(C(CO)=CC=O)O)=O,,,4,1,5,17,22
6576_0,,,,2,1,2,3
C(C(C(CO)=O)C=C)=O,,,4,1,4,44,48
6578_0,,,,2,1,2,3
C(C)=C(C=O)C(CO)=O,,,4,1,2,43,45
6580_0,,,,2,1,2,3
C(C(CO)O)=C(C=O)C(CO)=O,,,4,1,4,8,12
6582_0,,,,2,1,2,3
C=C(C=O)C(CO)=O,,,4,1,6,107,113
6584_0,,,,2,1,2,3
C(CO)=C(C=O)C(CO)=O,,,4,1,4,18,22
6586_0,,,,2,1,2,3
C(CC(C(C=C)O)=O)=O,,,4,1,4,44,48
6588_0,,,,2,1,2,3
C(C)(C(C=CC=O)O)=O,,,4,1,3,44,47
6590_0,,,,2,1,2,3
C(C(C(C)=CC=O)O)=O,,,4,1,1,36,37
6592_0,,,,2,1,2,3
C(CC(C(C=O)O)=C)=O,,,4,1,1,37,38
6594_0,,,,2,1,2,3
C(C(C(C(C=O)O)=C)O)=O,,,4,1,4,10,14
6596_0,,,,2,1,2,3
C(C(C(CC=C)=O)O)=O,,,4,1,1,43,44
6598_0,,,,2,1,2,3
C(C(C(C=CC)=O)O)=O,,,4,1,1,43,44
6600_0,,,,2,1,2,3
C(C(C(C=CC(CO)O)=O)O)=O,,,4,1,3,8,11
6602_0,,,,2,1,2,3
C(C(C(C=C)=O)O)=O,,,4,1,8,107,115
6604_0,,,,2,1,2,3
C(C(C(C=CCO)=O)O)=O,,,4,1,3,18,21
6606_0,,,,2,1,2,3
C(C)=CC=O,,,4,1,2,792,794
6608_0,,,,2,1,2,3
C(CC=C)=O,,,4,1,2,697,699
6610_0,,,,2,1,2,3
C(C(C=C)O)=O,,,4,1,47,242,289
6612_0,,,,2,1,2,3
C(C(CO)O)=CC=O,,,4,1,7,46,53
6614_0,,,,2,1,2,3
C(C(C(CO)O)O)=CC=O,,,4,1,7,13,20
6616_0,,,,2,1,2,3
C=CC=O,,,4,1,16,1379,1395
6617_0,,,,2,1,2,3
6619_0,,,,2,1,2,3
C=CC(O)=O,,,4,1,4,320,324
6621_0,,,,2,1,2,3
C(CO)=CC(O)=O,,,4,1,4,63,67
6622_0,,,,2,1,2,3
6623_0,,,,2,1,2,3
6624_0,,,,2,1,2,3
6625_0,,,,2,1,2,3
6626_0,,,,2,1,2,3
6628_0,,,,2,1,2,3
C=C,,,4,1,2,1,3
6629_0,,,,2,1,2,3
6630_0,,,,2,1,2,3
6631_0,,,,2,1,2,3
6633_0,,,,2,1,2,3
C(C(C=C)(C(C(CO)O)O)O)=O,,,4,1,5,13,18
6635_0,,,,2,1,2,3
C(CO)(C(C(C=O)=C)(CO)O)=O,,,4,1,3,14,17
6637_0,,,,2,1,2,3
C(CO)(C(C=CC=O)(CO)O)=O,,,4,1,3,10,13
6639_0,,,,2,1,2,3
C(CO)(C(C=C)(CO)O)=O,,,4,1,3,13,16
6641_0,,,,2,1,2,3
C(C(C(C=O)=C)(CO)O)(O)=O,,,4,1,4,12,16
6643_0,,,,2,1,2,3
C(C(C=CC=O)(CO)O)(O)=O,,,4,1,3,9,12
6645_0,,,,2,1,2,3
C(C(C=C)(CO)O)(O)=O,,,4,1,4,7,11
6647_0,,,,2,1,2,3
C(C(C=C)(C(CO)O)O)(O)=O,,,4,1,4,9,13
6649_0,,,,2,1,2,3
C(C(C(C)=O)(C(C=O)=C)O)=O,,,4,1,3,12,15
6651_0,,,,2,1,2,3
C(C(C(C=O)=C)(CO)O)=O,,,4,1,4,17,21
6653_0,,,,2,1,2,3
C(C(C(C=O)=C)(C(CO)O)O)=O,,,4,1,6,16,22
6655_0,,,,2,1,2,3
C(C(C(C)=O)(C=CC=O)O)=O,,,4,1,2,10,12
6657_0,,,,2,1,2,3
C(C(C=CC=O)(CO)O)=O,,,4,1,4,15,19
6659_0,,,,2,1,2,3
C(C(C=CC=O)(C(CO)O)O)=O,,,4,1,5,12,17
6661_0,,,,2,1,2,3
C(C(C(C=O)=CCO)(CO)O)=O,,,4,1,4,11,15
6662_0,,,,2,1,2,3
6663_0,,,,2,1,2,3
6664_0,,,,2,1,2,3
6665_0,,,,2,1,2,3
6667_0,,,,2,1,2,3
C(C(C=CC(C=O)O)(CO)O)=O,,,4,1,5,11,16
6669_0,,,,2,1,2,3
C(C(C=CC(CO)=O)(CO)O)=O,,,4,1,4,10,14
6671_0,,,,2,1,2,3
C(C(C(CO)=CC=O)(CO)O)=O,,,4,1,3,10,13
6673_0,,,,2,1,2,3
C(C(C(C)=O)(C=C)O)=O,,,4,1,3,23,26
6675_0,,,,2,1,2,3
C(C(C(C(C=O)O)=C)(CO)O)=O,,,4,1,3,13,16
6677_0,,,,2,1,2,3
C(C(C=C)(CO)O)=O,,,4,1,4,24,28
6679_0,,,,2,1,2,3
C(C(C=C)(C(CO)O)O)=O,,,4,1,7,11,18
6680_0,,,,2,1,2,3
6681_0,,,,2,1,2,3
6682_0,,,,2,1,2,3
6684_0,,,,2,1,2,3
C(C(C(C=O)=C)(CC=O)O)=O,,,4,1,3,15,18
6686_0,,,,2,1,2,3
C(C(C(C=O)=C)O)(O)=O,,,4,1,4,25,29
6687_0,,,,2,1,2,3
6688_0,,,,2,1,2,3
6690_0,,,,2,1,2,3
C(C(C=CC=O)(CC=O)O)=O,,,4,1,4,16,20
6692_0,,,,2,1,2,3
C(C(C=CC=O)O)(O)=O,,,4,1,6,23,29
6694_0,,,,2,1,2,3
C(C(C(C=O)=CCO)O)(O)=O,,,4,1,3,10,13
6695_0,,,,2,1,2,3
6696_0,,,,2,1,2,3
6697_0,,,,2,1,2,3
6698_0,,,,2,1,2,3
6699_0,,,,2,1,2,3
6700_0,,,,2,1,2,3
6701_0,,,,2,1,2,3
6702_0,,,,2,1,2,3
6703_0,,,,2,1,2,3
6705_0,,,,2,1,2,3
C(C(C=CC(C=O)O)O)(O)=O,,,4,1,4,10,14
6707_0,,,,2,1,2,3
C(C(C=CC(CO)=O)O)(O)=O,,,4,1,4,9,13
6709_0,,,,2,1,2,3
C(C(C(CO)=CC=O)O)(O)=O,,,4,1,5,9,14
6711_0,,,,2,1,2,3
C(C(C(C(C=O)O)=C)O)(O)=O,,,4,1,5,12,17
6712_0,,,,2,1,2,3
6714_0,,,,2,1,2,3
C(C=CC(CO)=O)=O,,,4,1,10,130,140
6716_0,,,,2,1,2,3
C(C=CC(C(CO)O)=O)=O,,,4,1,7,28,35
6718_0,,,,2,1,2,3
C(C(CO)=CC(CO)=O)=O,,,4,1,2,24,26
6720_0,,,,2,1,2,3
C(C(C(C=C)=O)(CO)O)=O,,,4,1,4,15,19
6722_0,,,,2,1,2,3
C=C(C=O)C(C(CO)O)=O,,,4,1,5,24,29
6724_0,,,,2,1,2,3
C(CO)=CC(C(O)=O)=O,,,4,1,3,14,17
6726_0,,,,2,1,2,3
C(C=CC(CO)=O)(O)=O,,,4,1,5,34,39
6728_0,,,,2,1,2,3
C(C(C(C=C)=O)O)(O)=O,,,4,1,5,29,34
6730_0,,,,2,1,2,3
C(C(CO)O)=CC(C(O)=O)=O,,,4,1,3,6,9
6732_0,,,,2,1,2,3
C(C=CC(C(CO)O)=O)(O)=O,,,4,1,5,13,18
6734_0,,,,2,1,2,3
C(C(C(C=CCO)=O)O)(O)=O,,,4,1,3,9,12
6736_0,,,,2,1,2,3
C1COC(C=1)=O,,,4,1,2,205,207
6738_0,,,,2,1,2,3
C1OCC(C=1)=O,,,4,1,1,437,438
6739_0,,,,2,2,1,3
6740_0,,,,2,2,1,3
6741_0,,,,2,2,1,3
6742_0,,,,2,2,1,3
6743_0,,,,2,2,1,3
6744_0,,,,2,2,1,3
6745_0,,,,2,2,1,3
6746_0,,,,2,2,1,3
6747_0,,,,2,2,1,3
6748_0,,,,2,2,1,3
6749_0,,,,2,2,1,3
6750_0,,,,2,2,1,3
6751_0,,,,2,2,1,3
6752_0,,,,2,2,1,3
6753_0,,,,2,2,1,3
6754_0,,,,2,2,1,3
6755_0,,,,2,2,1,3
6756_0,,,,2,2,1,3
6757_0,,,,2,2,1,3
6758_0,,,,2,2,1,3
6759_0,,,,2,2,1,3
6760_0,,,,2,2,1,3
6761_0,,,,2,2,1,3
6762_0,,,,2,2,1,3
6763_0,,,,2,2,1,3
6764_0,,,,2,2,1,3
6765_0,,,,2,2,1,3
6766_0,,,,2,2,1,3
6767_0,,,,2,2,1,3
6768_0,,,,2,2,1,3
6769_0,,,,2,2,1,3
6770_0,,,,2,2,1,3
6771_0,,,,2,2,1,3
6772_0,,,,2,2,1,3
6773_0,,,,2,2,1,3
6774_0,,,,2,2,1,3
6775_0,,,,2,2,1,3
6776_0,,,,2,2,1,3
6777_0,,,,2,2,1,3
6778_0,,,,2,2,1,3
6779_0,,,,2,2,1,3
6780_0,,,,2,2,1,3
6781_0,,,,2,2,1,3
6782_0,,,,2,2,1,3
6783_0,,,,2,2,1,3
6784_0,,,,2,2,1,3
6785_0,,,,2,2,1,3
6786_0,,,,2,2,1,3
6787_0,,,,2,2,1,3
6788_0,,,,2,2,1,3
6789_0,,,,2,2,1,3
6790_0,,,,2,2,1,3
6791_0,,,,2,2,1,3
6792_0,,,,2,2,1,3
6793_0,,,,2,2,1,3
6794_0,,,,2,2,1,3
6795_0,,,,2,2,1,3
6796_0,,,,2,2,1,3
6797_0,,,,2,2,1,3
6798_0,,,,2,2,1,3
6799_0,,,,2,2,1,3
6800_0,,,,2,2,1,3
6801_0,,,,2,2,1,3
6802_0,,,,2,2,1,3
6803_0,,,,2,2,1,3
6804_0,,,,2,2,1,3
6805_0,,,,2,2,1,3
6806_0,,,,2,2,1,3
6807_0,,,,2,2,1,3
6808_0,,,,2,2,1,3
6809_0,,,,2,2,1,3
6810_0,,,,2,2,1,3
6811_0,,,,2,2,1,3
6812_0,,,,2,2,1,3
6813_0,,,,2,2,1,3
6814_0,,,,2,2,1,3
6815_0,,,,2,2,1,3
6816_0,,,,2,2,1,3
6817_0,,,,2,2,1,3
6818_0,,,,2,2,1,3
6819_0,,,,2,2,1,3
6820_0,,,,2,2,1,3
6821_0,,,,2,2,1,3
6822_0,,,,2,2,1,3
6823_0,,,,2,2,1,3
6824_0,,,,2,2,1,3
6825_0,,,,2,2,1,3
6826_0,,,,2,2,1,3
6827_0,,,,2,2,1,3
6828_0,,,,2,2,1,3
6829_0,,,,2,2,1,3
6830_0,,,,2,2,1,3
6831_0,,,,2,2,1,3
6832_0,,,,2,2,1,3
6833_0,,,,2,2,1,3
6834_0,,,,2,2,1,3
6835_0,,,,2,2,1,3
6836_0,,,,2,2,1,3
6837_0,,,,2,2,1,3
6838_0,,,,2,2,1,3
6839_0,,,,2,2,1,3
6840_0,,,,2,2,1,3
6841_0,,,,2,2,1,3
6842_0,,,,2,2,1,3
6843_0,,,,2,2,1,3
6844_0,,,,2,2,1,3
6845_0,,,,2,2,1,3
6846_0,,,,2,2,1,3
6847_0,,,,2,2,1,3
6848_0,,,,2,2,1,3
6849_0,,,,2,2,1,3
6850_0,,,,2,2,1,3
6851_0,,,,2,2,1,3
6852_0,,,,2,2,1,3
6853_0,,,,2,2,1,3
6854_0,,,,2,2,1,3
6855_0,,,,2,2,1,3
6856_0,,,,2,2,1,3
6857_0,,,,2,2,1,3
6858_0,,,,2,2,1,3
6859_0,,,,2,2,1,3
6860_0,,,,2,2,1,3
6861_0,,,,2,2,1,3
6862_0,,,,2,2,1,3
6863_0,,,,2,2,1,3
6864_0,,,,2,2,1,3
6865_0,,,,2,2,1,3
6866_0,,,,2,2,1,3
6867_0,,,,2,2,1,3
6868_0,,,,2,2,1,3
6869_0,,,,2,2,1,3
6870_0,,,,2,2,1,3
6871_0,,,,2,2,1,3
6872_0,,,,2,2,1,3
6873_0,,,,2,2,1,3
6874_0,,,,2,2,1,3
6875_0,,,,2,2,1,3
6876_0,,,,2,2,1,3
6877_0,,,,2,2,1,3
6878_0,,,,2,2,1,3
6879_0,,,,2,2,1,3
6880_0,,,,2,2,1,3
6881_0,,,,2,2,1,3
6882_0,,,,2,2,1,3
6883_0,,,,2,2,1,3
6884_0,,,,2,2,1,3
6885_0,,,,2,2,1,3
6886_0,,,,2,2,1,3
6887_0,,,,2,2,1,3
6888_0,,,,2,2,1,3
6889_0,,,,2,2,1,3
6890_0,,,,2,2,1,3
6891_0,,,,2,2,1,3
6892_0,,,,2,2,1,3
6893_0,,,,2,2,1,3
6894_0,,,,2,2,1,3
6895_0,,,,2,2,1,3
6896_0,,,,2,2,1,3
6897_0,,,,2,2,1,3
6898_0,,,,2,2,1,3
6899_0,,,,2,2,1,3
6900_0,,,,2,2,1,3
6901_0,,,,2,2,1,3
6902_0,,,,2,2,1,3
6903_0,,,,2,2,1,3
6904_0,,,,2,2,1,3
6905_0,,,,2,2,1,3
6906_0,,,,2,2,1,3
6907_0,,,,2,2,1,3
6908_0,,,,2,2,1,3
6909_0,,,,2,2,1,3
6910_0,,,,2,2,1,3
6911_0,,,,2,2,1,3
6912_0,,,,2,2,1,3
6913_0,,,,2,2,1,3
6914_0,,,,2,2,1,3
6915_0,,,,2,2,1,3
6916_0,,,,2,2,1,3
6917_0,,,,2,2,1,3
6918_0,,,,2,2,1,3
6919_0,,,,2,2,1,3
6920_0,,,,2,2,1,3
6921_0,,,,2,2,1,3
6922_0,,,,2,2,1,3
6923_0,,,,2,2,1,3
6924_0,,,,2,2,1,3
6925_0,,,,2,2,1,3
6926_0,,,,2,2,1,3
6927_0,,,,2,2,1,3
6928_0,,,,2,2,1,3
6929_0,,,,2,2,1,3
6930_0,,,,2,2,1,3
6931_0,,,,2,2,1,3
6932_0,,,,2,2,1,3
6933_0,,,,2,2,1,3
6934_0,,,,2,2,1,3
6936_0,,,,2,1,1,2
C(C(C(C1C(CC(O)O1)O)O)O)O,,,4,1,1,7,8
6938_0,,,,2,1,1,2
C(C1CC(C(O)O1)=O)=O,,,4,1,4,38,42
6940_0,,,,2,1,1,2
C1(C(OC(C=O)C1CO)O)=O,,,4,1,3,12,15
6941_0,,,,2,1,1,2
6943_0,,,,2,1,1,2
C(C(C1COC(C1O)O)=O)=O,,,4,1,1,15,16
6945_0,,,,2,1,1,2
C(C1C(C(OC1C=O)O)O)=O,,,4,1,1,15,16
6946_0,,,,2,1,1,2
6947_0,,,,2,1,1,2
6949_0,,,,2,1,1,2
C1C(CO)(C(C(CO)(O)O1)O)O,,,4,1,1,5,6
6951_0,,,,2,1,1,2
C1(C(O)OC(CO)(CO)C1)=O,,,4,1,4,7,11
6953_0,,,,2,1,1,2
C(C1(CC(CO)(CO1)O)O)=O,,,4,1,1,8,9
6955_0,,,,2,1,1,2
C(C1C(O)OCC1(CO)O)=O,,,4,1,2,13,15
6957_0,,,,2,1,1,2
C1(C(O)OC(CO)(CO)C1CO)=O,,,4,1,3,6,9
6958_0,,,,2,1,1,2
6960_0,,,,2,1,1,2
C(C1(C(CO)C(CO)(CO1)O)O)=O,,,4,1,1,9,10
6962_0,,,,2,1,1,2
C(C1C(C(O)OC1(CO)CO)O)=O,,,4,1,1,9,10
6964_0,,,,2,1,1,2
C(C(C1C(O)OCC1(CO)O)O)=O,,,4,1,2,10,12
6965_0,,,,2,1,1,2
6967_0,,,,2,1,1,2
C(CO)(C1C(O)OCC1(CO)O)=O,,,4,1,2,10,12
6969_0,,,,2,1,1,2
C(C1C(CO)(O)OCC1(CO)O)=O,,,4,1,1,12,13
6970_0,,,,2,1,1,2
6972_0,,,,2,1,1,2
C(CC1(C(C(CO1)(CO)O)O)O)=O,,,4,1,1,10,11
6974_0,,,,2,1,1,2
C(C(C1(CC(CO1)(CO)O)O)O)=O,,,4,1,1,11,12
6976_0,,,,2,1,1,2
C1C(CO)(CC(O)O1)O,,,4,1,2,8,10
6978_0,,,,2,1,1,2
C1C(CO)(C(C(O)O1)O)O,,,4,1,4,5,9
6980_0,,,,2,1,1,2
C(CO)(C1C(CC(O1)O)O)=O,,,4,1,7,10,17
6981_0,,,,2,1,1,2
6983_0,,,,2,1,1,2
C(CC1C(C(C(CO)(O)O1)O)O)=O,,,4,1,1,9,10
6985_0,,,,2,1,1,2
C(CO)(C(C1C(CC(O)O1)O)O)=O,,,4,1,2,7,9
6987_0,,,,2,1,1,2
C(CO)(C(C1CC(C(O)O1)O)O)=O,,,4,1,1,8,9
6989_0,,,,2,1,1,2
C(CO)(C1C(CC(CO)(O1)O)O)=O,,,4,1,1,8,9
6990_0,,,,2,1,1,2
6992_0,,,,2,1,1,2
C(CC1(COC(CO)(C1O)O)O)=O,,,4,1,1,10,11
6994_0,,,,2,1,1,2
C(CO)(C1C(CO)(CC(O1)O)O)=O,,,4,1,1,8,9
6996_0,,,,2,1,1,2
C(C)(C1C(C(C(CO)(O1)O)O)O)=O,,,4,1,1,9,10
6998_0,,,,2,1,1,2
C(CO)(C1C(C(C(C)(O1)O)O)O)=O,,,4,1,1,9,10
7000_0,,,,2,1,1,2
C(C1C(C)(C(C(CO)(O1)O)O)O)=O,,,4,1,1,10,11
7002_0,,,,2,1,1,2
C(CO)(C1C(C)(C(C(O1)O)O)O)=O,,,4,1,1,9,10
7004_0,,,,2,1,1,2
C(C1(C(C(C(CO)O1)O)O)O)O,,,4,1,2,5,7
7006_0,,,,2,1,1,2
C1C(C(C(CO)(O)O1)O)O,,,4,1,3,5,8
7008_0,,,,2,1,1,2
C1(C(O)OC(CO)(C(CO)O)C1)=O,,,4,1,2,7,9
7010_0,,,,2,1,1,2
C(C1(CC(CO1)(C(CO)O)O)O)=O,,,4,1,2,10,12
7012_0,,,,2,1,1,2
C(C1(CC(CO)(C(CO)O1)O)O)=O,,,4,1,1,8,9
7014_0,,,,2,1,1,2
C(C1C(O)OCC1(C(CO)O)O)=O,,,4,1,2,13,15
7016_0,,,,2,1,1,2
C(C1C(O)OC(CO)C1(CO)O)=O,,,4,1,1,11,12
7018_0,,,,2,1,1,2
C1C(CC(O)O1)(C(CO)O)O,,,4,1,3,6,9
7020_0,,,,2,1,1,2
C(C1(CC(O)OC1CO)O)O,,,4,1,3,4,7
7022_0,,,,2,1,1,2
C1C(C(C(O)O1)O)(C(CO)O)O,,,4,1,3,7,10
7024_0,,,,2,1,1,2
C1(C(C(CO)(C(CO)O1)O)O)O,,,4,1,4,5,9
7026_0,,,,2,1,1,2
C(C1C(CC(O1)O)O)(C(CO)O)=O,,,4,1,5,10,15
7028_0,,,,2,1,1,2
C1C(C(C(C(CO)O)(O)O1)O)O,,,4,1,3,7,10
7030_0,,,,2,1,1,2
C1(C(O)OC(C(CO)(CO)O)C1)=O,,,4,1,1,5,6
7032_0,,,,2,1,1,2
C(C1(CC(C(CO)(CO)O1)O)O)=O,,,4,1,1,6,7
7034_0,,,,2,1,1,2
C(C1C(O)OC(CO)(CO)C1O)=O,,,4,1,1,9,10
7036_0,,,,2,1,1,2
C(C1(CO)C(CC(O)O1)O)O,,,4,1,2,3,5
7038_0,,,,2,1,1,2
C(C1(CO)C(C(C(O)O1)O)O)O,,,4,1,2,5,7
7040_0,,,,2,1,1,2
C(C(C1(CO)C(CC(O)O1)O)O)O,,,4,1,2,5,7
7042_0,,,,2,1,1,2
C(C1(C)CC(C(O1)O)=O)=O,,,4,1,3,16,19
7044_0,,,,2,1,1,2
C(C1(C)C(C(C(O1)O)=O)CO)=O,,,4,1,3,9,12
7045_0,,,,2,1,1,2
7047_0,,,,2,1,1,2
C(C(C1COC(C1(C)O)O)=O)=O,,,4,1,1,14,15
7049_0,,,,2,1,1,2
C(C1C(C)(C(OC1C=O)O)O)=O,,,4,1,1,13,14
7051_0,,,,2,1,1,2
C(C1C(C(OC1(C=O)C)O)O)=O,,,4,1,1,13,14
7052_0,,,,2,1,1,2
7053_0,,,,2,1,1,2
7055_0,,,,2,1,1,2
C(C)(C1CC(C(O)O1)=O)=O,,,4,1,6,22,28
7057_0,,,,2,1,1,2
C(C1C(C(C(O1)O)=O)CO)(C)=O,,,4,1,4,9,13
7058_0,,,,2,1,1,2
7060_0,,,,2,1,1,2
C(C(C1COC(C)(C1O)O)=O)=O,,,4,1,1,14,15
7062_0,,,,2,1,1,2
C(C1C(C(C)(OC1C=O)O)O)=O,,,4,1,1,13,14
7064_0,,,,2,1,1,2
C(C1C(C(OC1C(C)=O)O)O)=O,,,4,1,2,13,15
7065_0,,,,2,1,1,2
7066_0,,,,2,1,1,2
7068_0,,,,2,1,1,2
C(CC1CC(C(O)O1)=O)=O,,,4,1,5,25,30
7069_0,,,,2,1,1,2
7071_0,,,,2,1,1,2
C(C1(CCO)CC(C(O1)O)=O)=O,,,4,1,1,8,9
7073_0,,,,2,1,1,2
C1(C(OC(C(CCO)=O)C1)O)=O,,,4,1,3,9,12
7075_0,,,,2,1,1,2
C(CC1C(CC(C=O)(O)O1)O)=O,,,4,1,2,13,15
7077_0,,,,2,1,1,2
C(C(CC1C(CC(O)O1)O)=O)=O,,,4,1,1,11,12
7079_0,,,,2,1,1,2
C(CC(C1CC(C(O)O1)=O)O)=O,,,4,1,3,14,17
7081_0,,,,2,1,1,2
C(C(CC1CC(C(O)O1)O)=O)=O,,,4,1,1,12,13
7083_0,,,,2,1,1,2
C(C(CC1CC(C(O)O1)=O)O)=O,,,4,1,2,12,14
7085_0,,,,2,1,1,2
C(CO)(CC1CC(C(O)O1)=O)=O,,,4,1,3,10,13
7086_0,,,,2,1,1,2
7088_0,,,,2,1,1,2
C(CC1(COC(C=O)(C1)O)O)=O,,,4,1,2,14,16
7090_0,,,,2,1,1,2
C(CC1(CO)CC(C(O)O1)=O)=O,,,4,1,2,10,12
7092_0,,,,2,1,1,2
C(C1(CC(C(C(C)=O)O1)O)O)=O,,,4,1,2,10,12
7094_0,,,,2,1,1,2
C(C)(C(C1CC(C(O)O1)=O)O)=O,,,4,1,2,9,11
7096_0,,,,2,1,1,2
C(C1C(C)(CC(C=O)(O1)O)O)=O,,,4,1,1,11,12
7098_0,,,,2,1,1,2
C(C(C1(C)CC(C(O)O1)=O)O)=O,,,4,1,1,9,10
7100_0,,,,2,1,1,2
C1(C(O)OC(C)C1)=O,,,4,1,3,74,77
7102_0,,,,2,1,1,2
C(C1(CC(C(CO)O1)O)O)=O,,,4,1,1,7,8
7103_0,,,,2,1,1,2
7105_0,,,,2,1,1,2
C(C1(CC(C(C(CO)O)O1)O)O)=O,,,4,1,3,8,11
7107_0,,,,2,1,1,2
C1(C(O)OC(C(C(CO)O)O)C1)=O,,,4,1,5,9,14
7109_0,,,,2,1,1,2
C(C1(CC(CO1)O)O)=O,,,4,1,1,12,13
7110_0,,,,2,1,1,2
7112_0,,,,2,1,1,2
C(CC1C(C(C(O)O1)=O)CO)=O,,,4,1,4,12,16
7113_0,,,,2,1,1,2
7115_0,,,,2,1,1,2
C(C1C(CC=O)OC(C1O)O)=O,,,4,1,2,15,17
7116_0,,,,2,1,1,2
7117_0,,,,2,1,1,2
7119_0,,,,2,1,1,2
C(CC(C1C(CC(O1)O)O)=O)=O,,,4,1,2,10,12
7121_0,,,,2,1,1,2
C(C1C(CC(O1)O)O)=O,,,4,1,7,26,33
7122_0,,,,2,1,1,2
7124_0,,,,2,1,1,2
C(C1C(O)OC(C1O)CC=O)=O,,,4,1,3,18,21
7126_0,,,,2,1,1,2
C(C(C=O)C1C(CC(O)O1)O)=O,,,4,1,2,8,10
7128_0,,,,2,1,1,2
C(C(C=O)C1CC(C(O)O1)O)=O,,,4,1,2,9,11
7129_0,,,,2,1,1,2
7131_0,,,,2,1,1,2
C(C1C(O)OCC1(CC=O)O)=O,,,4,1,3,16,19
7133_0,,,,2,1,1,2
C(C1C(C(C(C)=O)OC1O)O)=O,,,4,1,3,14,17
7135_0,,,,2,1,1,2
C(C1C(OC(C=O)C1(C)O)O)=O,,,4,1,2,15,17
7136_0,,,,2,1,1,2
7138_0,,,,2,1,1,2
C(C1C(O)OC(C1O)C(CO)O)=O,,,4,1,3,12,15
7139_0,,,,2,1,1,2
7140_0,,,,2,1,1,2
7141_0,,,,2,1,1,2
7143_0,,,,2,1,1,2
C1(C(O)OC(C)C1CO)=O,,,4,1,3,13,16
7144_0,,,,2,1,1,2
7146_0,,,,2,1,1,2
C(C1(C(CO)C(C(CO)O1)O)O)=O,,,4,1,1,8,9
7148_0,,,,2,1,1,2
C1(C(O)OC(C(CO)O)C1CO)=O,,,4,1,5,9,14
7149_0,,,,2,1,1,2
7150_0,,,,2,1,1,2
7152_0,,,,2,1,1,2
C(C1(C(CO)C(CO1)O)O)=O,,,4,1,1,8,9
7154_0,,,,2,1,1,2
C1(C(O)OC(CO)C1CO)=O,,,4,1,5,9,14
7155_0,,,,2,1,1,2
7157_0,,,,2,1,1,2
C(CC1C(CC(O)O1)O)=O,,,4,1,2,15,17
7159_0,,,,2,1,1,2
C(C(C1C(CC(O)O1)O)O)=O,,,4,1,5,10,15
7160_0,,,,2,1,1,2
7162_0,,,,2,1,1,2
C(CC1CC(C(O)O1)O)=O,,,4,1,1,16,17
7164_0,,,,2,1,1,2
C(C(C1CC(C(O)O1)O)O)=O,,,4,1,4,11,15
7166_0,,,,2,1,1,2
C(C1C(C)OC(C1O)O)=O,,,4,1,1,14,15
7168_0,,,,2,1,1,2
C(C(C1C(O)OC(CO)C1O)O)=O,,,4,1,2,9,11
7170_0,,,,2,1,1,2
C(C1C(C(CO)O)OC(C1O)O)=O,,,4,1,3,12,15
7172_0,,,,2,1,1,2
C(C1COC(C1O)O)=O,,,4,1,2,23,25
7174_0,,,,2,1,1,2
C(C(C1C(O)OCC1O)O)=O,,,4,1,2,10,12
7176_0,,,,2,1,1,2
C(C1C(CO)OC(C1O)O)=O,,,4,1,3,12,15
7178_0,,,,2,1,1,2
C(C1C(CC(CO)(O1)O)O)=O,,,4,1,4,11,15
7179_0,,,,2,1,1,2
7181_0,,,,2,1,1,2
C(C1C(CO)(CC(O1)O)O)=O,,,4,1,5,11,16
7183_0,,,,2,1,1,2
C(CC1(COC(C1O)O)O)=O,,,4,1,2,13,15
7184_0,,,,2,1,1,2
7185_0,,,,2,1,1,2
7187_0,,,,2,1,1,2
C(CO)(C1C(O)OC(CO)C1O)=O,,,4,1,2,9,11
7189_0,,,,2,1,1,2
C(C1C(CO)(O)OC(CO)C1O)=O,,,4,1,1,11,12
7190_0,,,,2,1,1,2
7191_0,,,,2,1,1,2
7192_0,,,,2,1,1,2
7194_0,,,,2,1,1,2
C(C1C(CO)(O)OCC1O)=O,,,4,1,2,13,15
7195_0,,,,2,1,1,2
7196_0,,,,2,1,1,2
7198_0,,,,2,1,1,2
C(CC1(C(C(C(CO)O1)O)O)O)=O,,,4,1,1,9,10
7199_0,,,,2,1,1,2
7200_0,,,,2,1,1,2
7202_0,,,,2,1,1,2
C(CC1(C(C(CO1)O)O)O)=O,,,4,1,2,13,15
7203_0,,,,2,1,1,2
7205_0,,,,2,1,1,2
C(C)(C1C(CC(O1)O)O)=O,,,4,1,2,16,18
7207_0,,,,2,1,1,2
C(C1C(C(C(C)(O1)O)O)O)=O,,,4,1,4,12,16
7208_0,,,,2,1,1,2
7210_0,,,,2,1,1,2
C(C1C(C)(CC(O1)O)O)=O,,,4,1,1,15,16
7212_0,,,,2,1,1,2
C(C1C(C)(C(C(O1)O)O)O)=O,,,4,1,4,12,16
7214_0,,,,2,1,1,2
C(C(C1(CC(C(CO)O1)O)O)O)=O,,,4,1,1,9,10
7216_0,,,,2,1,1,2
C(C(C1(CC(CO1)O)O)O)=O,,,4,1,1,12,13
7218_0,,,,2,1,1,2
C(C1C(CC(O)O1)O)O,,,4,1,2,8,10
7220_0,,,,2,1,1,2
C(C(C1C(CC(O)O1)O)O)O,,,4,1,4,5,9
7222_0,,,,2,1,1,2
C1C(CC(O)O1)O,,,4,1,1,39,40
7224_0,,,,2,1,1,2
C1(C(O)OCC1O)=O,,,4,1,8,71,79
7226_0,,,,2,1,1,2
C1(C(O)OC(CO)C1O)=O,,,4,1,2,14,16
7228_0,,,,2,1,1,2
C(C1(C(C(CO1)O)O)O)=O,,,4,1,1,10,11
7230_0,,,,2,1,1,2
C1(C(O)OC(C(CO)O)C1O)=O,,,4,1,1,7,8
7232_0,,,,2,1,1,2
C(C1(C(C(C(CO)O1)O)O)O)=O,,,4,1,1,10,11
7234_0,,,,2,1,1,2
C1CC(C(O)O1)O,,,4,1,1,40,41
7236_0,,,,2,1,1,2
C1(C(CC(O)O1)O)=O,,,4,1,1,27,28
7238_0,,,,2,1,1,2
C1(CC(C(O)O1)O)=O,,,4,1,1,28,29
7240_0,,,,2,1,1,2
CC(C1(C(O)OC(CO)C1O)O)O,,,4,1,1,5,6
7242_0,,,,2,1,1,2
C(CO)(C1(COC(C1O)O)O)=O,,,4,1,1,9,10
7244_0,,,,2,1,1,2
C1(C(CO)(C(C(O)O1)O)O)=O,,,4,1,3,9,12
7246_0,,,,2,1,1,2
C(C1(COC(C1O)O)O)(O)=O,,,4,1,2,8,10
7248_0,,,,2,1,1,2
C1(C(C(CO)O)(C(C(O)O1)O)O)=O,,,4,1,3,11,14
7250_0,,,,2,1,1,2
C(C1(C(CO)OC(C1O)O)O)(O)=O,,,4,1,2,9,11
7252_0,,,,2,1,1,2
C(C1(COC(C1O)O)O)=O,,,4,1,1,11,12
7254_0,,,,2,1,1,2
C(C1(C(CO)OC(C1O)O)O)=O,,,4,1,1,11,12
7256_0,,,,2,1,1,2
C(C(C1(C(O)OCC1O)O)O)=O,,,4,1,4,11,15
7258_0,,,,2,1,1,2
C(C)(C1(C(O)OCC1(CO)O)O)=O,,,4,1,1,10,11
7260_0,,,,2,1,1,2
C(C1(C(C)(O)OCC1(CO)O)O)=O,,,4,1,1,11,12
7262_0,,,,2,1,1,2
C1C(CO)(C(C(O)O1)(CO)O)O,,,4,1,2,4,6
7264_0,,,,2,1,1,2
C(CO)(C1(COC(C1(C)O)O)O)=O,,,4,1,1,8,9
7266_0,,,,2,1,1,2
C(CO)(C1(COC(C)(C1O)O)O)=O,,,4,1,1,9,10
7268_0,,,,2,1,1,2
C(CO)(C1(CO)C(CC(O1)O)O)=O,,,4,1,3,10,13
7270_0,,,,2,1,1,2
C1C(C(CO)(C(CO)(O)O1)O)O,,,4,1,2,4,6
7272_0,,,,2,1,1,2
C1(C(CO)(C(C)(C(O)O1)O)O)=O,,,4,1,3,8,11
7274_0,,,,2,1,1,2
C(C1(COC(C1(C)O)O)O)(O)=O,,,4,1,2,7,9
7276_0,,,,2,1,1,2
C1(C(CO)(C(C(C)(O)O1)O)O)=O,,,4,1,3,9,12
7278_0,,,,2,1,1,2
C(C1(COC(C)(C1O)O)O)(O)=O,,,4,1,2,8,10
7280_0,,,,2,1,1,2
C(C1(CO)C(CC(O1)O)O)(O)=O,,,4,1,4,8,12
7282_0,,,,2,1,1,2
C(C1(COC(C1(C)O)O)O)=O,,,4,1,1,9,10
7284_0,,,,2,1,1,2
C(C1(C(CO)OC(C1(C)O)O)O)=O,,,4,1,1,9,10
7286_0,,,,2,1,1,2
C(C(C)(C1(C(O)OCC1O)O)O)=O,,,4,1,3,9,12
7288_0,,,,2,1,1,2
C(C1(COC(C)(C1O)O)O)=O,,,4,1,1,10,11
7290_0,,,,2,1,1,2
C(C1(C(CO)OC(C)(C1O)O)O)=O,,,4,1,1,10,11
7292_0,,,,2,1,1,2
C(C)(C(C1(C(O)OCC1O)O)O)=O,,,4,1,4,9,13
7294_0,,,,2,1,1,2
C(C1(C(C)=O)C(CC(O1)O)O)=O,,,4,1,2,9,11
7296_0,,,,2,1,1,2
C(C1(CO)C(CC(O1)O)O)=O,,,4,1,3,11,14
7298_0,,,,2,1,1,2
C(C1(C(CO)O)C(CC(O1)O)O)=O,,,4,1,5,13,18
7300_0,,,,2,1,1,2
C(CC(C1(C(O)OCC1O)O)O)=O,,,4,1,2,10,12
7302_0,,,,2,1,1,2
C(C1(COC(C1(CCO)O)O)O)=O,,,4,1,1,10,11
7303_0,,,,2,1,1,2
7305_0,,,,2,1,1,2
C(C1(COC(C1O)(CCO)O)O)=O,,,4,1,1,11,12
7307_0,,,,2,1,1,2
C(C(CO)(C1C(CC(O)O1)O)O)=O,,,4,1,4,10,14
7309_0,,,,2,1,1,2
C(CC1C(C(C(O)O1)(CO)O)O)=O,,,4,1,2,9,11
7311_0,,,,2,1,1,2
C(C(CO)(C1CC(C(O)O1)O)O)=O,,,4,1,4,11,15
7313_0,,,,2,1,1,2
C(C1(CO)C(CC(CO)(O1)O)O)=O,,,4,1,3,12,15
7315_0,,,,2,1,1,2
C(C1(CO)C(CO)(CC(O1)O)O)=O,,,4,1,3,12,15
7317_0,,,,2,1,1,2
C(CC1(COC(C1(CO)O)O)O)=O,,,4,1,2,9,11
7318_0,,,,2,1,1,2
7320_0,,,,2,1,1,2
C(C)(C1(C(O)OC(CO)C1O)O)=O,,,4,1,1,10,11
7322_0,,,,2,1,1,2
C(C1(C(C)(O)OC(CO)C1O)O)=O,,,4,1,1,11,12
7323_0,,,,2,1,1,2
7325_0,,,,2,1,1,2
C(C1(C(C)(O)OCC1O)O)=O,,,4,1,1,11,12
7327_0,,,,2,1,1,2
C(C1(CO)C(C(C(C)(O1)O)O)O)=O,,,4,1,3,13,16
7329_0,,,,2,1,1,2
C(C)(C1C(C(CO)(C(O1)O)O)O)=O,,,4,1,2,8,10
7331_0,,,,2,1,1,2
C(C1(CO)C(C)(C(C(O1)O)O)O)=O,,,4,1,3,13,16
7333_0,,,,2,1,1,2
C(C1C(C)(C(CO)(C(O1)O)O)O)=O,,,4,1,2,9,11
7335_0,,,,2,1,1,2
C1C(C(C(O)O1)(C(C)O)O)O,,,4,1,2,5,7
7337_0,,,,2,1,1,2
C(C1(CC(OC1C=O)O)O)=O,,,4,1,1,12,13
7339_0,,,,2,1,1,2
C1(C(C(C(O)O1)O)O)=O,,,4,1,5,21,26
7341_0,,,,2,1,1,2
C(C1(CC(O)OC1(CO)CO)O)=O,,,4,1,1,6,7
7343_0,,,,2,1,1,2
C(CC1(C(O)OCC1(CO)O)O)=O,,,4,1,1,9,10
7345_0,,,,2,1,1,2
C(C1(CC(OC1(C=O)C)O)O)=O,,,4,1,1,10,11
7347_0,,,,2,1,1,2
C1(C(C(C)(C(O)O1)O)O)=O,,,4,1,3,11,14
7349_0,,,,2,1,1,2
C(C1(CC(OC1C(C)=O)O)O)=O,,,4,1,2,10,12
7351_0,,,,2,1,1,2
C1(C(C(C(C)(O)O1)O)O)=O,,,4,1,3,12,15
7353_0,,,,2,1,1,2
C(C1(C(CC(O1)O)O)CC=O)=O,,,4,1,2,12,14
7355_0,,,,2,1,1,2
C(C1(C(CC=O)OC(C1)O)O)=O,,,4,1,2,11,13
7357_0,,,,2,1,1,2
C(C1C(CC(O1)O)O)(O)=O,,,4,1,4,11,15
7359_0,,,,2,1,1,2
C1(C(C(C(O)O1)(CCO)O)O)=O,,,4,1,1,6,7
7360_0,,,,2,1,1,2
7362_0,,,,2,1,1,2
C1(C(C(C(CCO)(O)O1)O)O)=O,,,4,1,1,7,8
7364_0,,,,2,1,1,2
C(C1(C(C)OC(C1)O)O)=O,,,4,1,1,7,8
7366_0,,,,2,1,1,2
C(CC1(C(O)OC(CO)C1O)O)=O,,,4,1,2,9,11
7368_0,,,,2,1,1,2
C(C1(CC(O)OC1C(CO)O)O)=O,,,4,1,3,9,12
7370_0,,,,2,1,1,2
C(C1(COC(C1)O)O)=O,,,4,1,2,12,14
7371_0,,,,2,1,1,2
7373_0,,,,2,1,1,2
C(C1(C(CO)OC(C1)O)O)=O,,,4,1,2,7,9
7375_0,,,,2,1,1,2
C(C(C1C(CC(O)O1)O)O)(O)=O,,,4,1,2,6,8
7377_0,,,,2,1,1,2
C(C(C1CC(C(O)O1)O)O)(O)=O,,,4,1,2,7,9
7379_0,,,,2,1,1,2
C(C1C(CC(CO)(O1)O)O)(O)=O,,,4,1,2,7,9
7381_0,,,,2,1,1,2
C(C1C(CO)(CC(O1)O)O)(O)=O,,,4,1,2,7,9
7382_0,,,,2,1,1,2
7384_0,,,,2,1,1,2
C(C1C(C(C(C)(O1)O)O)O)(O)=O,,,4,1,2,8,10
7386_0,,,,2,1,1,2
C(C1C(C)(C(C(O1)O)O)O)(O)=O,,,4,1,2,8,10
7388_0,,,,2,1,1,2
C(C1(COC(CO)(C1)O)O)=O,,,4,1,1,8,9
7389_0,,,,2,1,1,2
7391_0,,,,2,1,1,2
C(C1(CC(CO1)O)O)(O)=O,,,4,1,2,5,7
7393_0,,,,2,1,1,2
C1(C(CC(CO)(O)O1)O)=O,,,4,1,1,7,8
7395_0,,,,2,1,1,2
C(C1(CC(C(CO)O1)O)O)(O)=O,,,4,1,2,6,8
7397_0,,,,2,1,1,2
C1(C(CC(C(CO)O)(O)O1)O)=O,,,4,1,1,6,7
7399_0,,,,2,1,1,2
C(CC1(C(C(CO1)O)O)O)(O)=O,,,4,1,2,7,9
7401_0,,,,2,1,1,2
C(C(C1(CC(CO1)O)O)O)(O)=O,,,4,1,2,7,9
7403_0,,,,2,1,1,2
C(C(C1C(C(CC(O)O1)O)O)O)O,,,4,1,1,7,8
7405_0,,,,2,1,1,2
C1(COC(C(C1O)O)O)=O,,,4,1,6,21,27
7407_0,,,,2,1,1,2
C1(C(CO)OC(C(C1O)O)O)=O,,,4,1,3,10,13
7409_0,,,,2,1,1,2
C(C1C(COC(C1O)O)=O)=O,,,4,1,3,14,17
7411_0,,,,2,1,1,2
C1(C(C(C=O)OC(C1)O)O)=O,,,4,1,1,17,18
7413_0,,,,2,1,1,2
C(C1C(CC(C(O1)O)O)=O)=O,,,4,1,1,13,14
7415_0,,,,2,1,1,2
C1(CC(C=O)OC(C1O)O)=O,,,4,1,1,17,18
7417_0,,,,2,1,1,2
C1(C(O)OCC(CO)(C1)O)=O,,,4,1,4,10,14
7419_0,,,,2,1,1,2
C1(C(O)OCC(CO)(C1CO)O)=O,,,4,1,3,10,13
7421_0,,,,2,1,1,2
C(C1C(C(O)OCC1(CO)O)O)=O,,,4,1,1,13,14
7423_0,,,,2,1,1,2
C1(C(C(CO)(CO)OC(C1)O)O)=O,,,4,1,1,5,6
7425_0,,,,2,1,1,2
C1(C(C(O)OC(CO)(CO)C1)O)=O,,,4,1,1,7,8
7427_0,,,,2,1,1,2
C1(COC(C(C)(C1O)O)O)=O,,,4,1,6,11,17
7429_0,,,,2,1,1,2
C1(COC(C)(C(C1O)O)O)=O,,,4,1,6,12,18
7431_0,,,,2,1,1,2
C(C1(CCOC(CO)(C1O)O)O)=O,,,4,1,1,10,11
7433_0,,,,2,1,1,2
C1(COC(C(CCO)(C1O)O)O)=O,,,4,1,1,9,10
7435_0,,,,2,1,1,2
C1(COC(C(C1O)O)(CCO)O)=O,,,4,1,1,10,11
7437_0,,,,2,1,1,2
C(CO)(C1C(C(CC(O1)O)O)O)=O,,,4,1,1,9,10
7439_0,,,,2,1,1,2
C(C1CC(C(C(CO)(O1)O)O)O)=O,,,4,1,1,9,10
7441_0,,,,2,1,1,2
C(CO)(C1C(CC(C(O1)O)O)O)=O,,,4,1,1,9,10
7443_0,,,,2,1,1,2
C1C(C(C(C(CO)(O)O1)O)O)O,,,4,1,2,7,9
7445_0,,,,2,1,1,2
C1(C(O)OCC(C(CO)O)(C1)O)=O,,,4,1,2,9,11
7447_0,,,,2,1,1,2
C1(C(O)OC(CO)C(CO)(C1)O)=O,,,4,1,1,7,8
7449_0,,,,2,1,1,2
C(C1(CC(CO)(C(CO1)O)O)O)=O,,,4,1,1,9,10
7451_0,,,,2,1,1,2
C(C1C(O)OCC(C1(CO)O)O)=O,,,4,1,1,12,13
7453_0,,,,2,1,1,2
C1C(C(CO)(CC(O)O1)O)O,,,4,1,2,5,7
7455_0,,,,2,1,1,2
C1C(C(CO)(C(C(O)O1)O)O)O,,,4,1,4,6,10
7457_0,,,,2,1,1,2
C1(C(CO)OC(C(C)(C1O)O)O)=O,,,4,1,3,9,12
7459_0,,,,2,1,1,2
C1(C(CO)OC(C(C1O)O)(C)O)=O,,,4,1,3,10,13
7461_0,,,,2,1,1,2
C1(C(O)OC(CO)(CO)C(C1)O)=O,,,4,1,1,5,6
7463_0,,,,2,1,1,2
C(C1(CC(C(CO)(CO1)O)O)O)=O,,,4,1,1,9,10
7465_0,,,,2,1,1,2
C(C1C(O)OCC(CO)(C1O)O)=O,,,4,1,1,12,13
7467_0,,,,2,1,1,2
C1C(CO)(C(CC(O)O1)O)O,,,4,1,2,5,7
7469_0,,,,2,1,1,2
C1C(CO)(C(C(C(O)O1)O)O)O,,,4,1,2,7,9
7471_0,,,,2,1,1,2
C1C(C(CO)O)(C(CC(O)O1)O)O,,,4,1,1,7,8
7473_0,,,,2,1,1,2
C(C1(C(CO)OC(CC1O)O)O)O,,,4,1,2,5,7
7475_0,,,,2,1,1,2
C(C1C(COC(C1(C)O)O)=O)=O,,,4,1,3,11,14
7477_0,,,,2,1,1,2
C(C1(C)C(C(CC(O1)O)=O)O)=O,,,4,1,1,11,12
7479_0,,,,2,1,1,2
C(C1C(CC(C)(C(O1)O)O)=O)=O,,,4,1,1,9,10
7481_0,,,,2,1,1,2
C(C1(C)CC(C(C(O1)O)O)=O)=O,,,4,1,1,12,13
7483_0,,,,2,1,1,2
C(C1C(COC(C)(C1O)O)=O)=O,,,4,1,3,11,14
7485_0,,,,2,1,1,2
C1(C(C(C(C)=O)OC(C1)O)O)=O,,,4,1,2,11,13
7487_0,,,,2,1,1,2
C(C1C(CC(C(C)(O1)O)O)=O)=O,,,4,1,1,9,10
7489_0,,,,2,1,1,2
C1(CC(C(C)=O)OC(C1O)O)=O,,,4,1,2,12,14
7491_0,,,,2,1,1,2
C(C1(CC(C=O)(O)OCC1)O)=O,,,4,1,1,10,11
7493_0,,,,2,1,1,2
C(CC1C(CC(C(O)O1)=O)O)=O,,,4,1,2,14,16
7495_0,,,,2,1,1,2
C(C1CC(CC(C=O)(O1)O)O)=O,,,4,1,1,10,11
7497_0,,,,2,1,1,2
C(CC1(COC(C(C1)=O)O)O)=O,,,4,1,2,12,14
7499_0,,,,2,1,1,2
C(C)(C1C(CC(C(O1)O)=O)O)=O,,,4,1,2,9,11
7501_0,,,,2,1,1,2
C(C1C(C)(CC(C(O1)O)=O)O)=O,,,4,1,1,10,11
7502_0,,,,2,1,1,2
7504_0,,,,2,1,1,2
C(C1(CC(C(CO1)O)O)O)=O,,,4,1,1,9,10
7506_0,,,,2,1,1,2
C1(C(O)OC(C(C1)O)C(CO)O)=O,,,4,1,3,8,11
7508_0,,,,2,1,1,2
C(C1(CC(C(C(CO)O1)O)O)O)=O,,,4,1,1,8,9
7509_0,,,,2,1,1,2
7511_0,,,,2,1,1,2
C(C(C1COC(CC1O)O)=O)=O,,,4,1,1,14,15
7513_0,,,,2,1,1,2
C(C1C(CC(OC1C=O)O)O)=O,,,4,1,1,13,14
7515_0,,,,2,1,1,2
C(CC1C(C(CC(O)O1)=O)O)=O,,,4,1,2,11,13
7517_0,,,,2,1,1,2
C(CC1CC(C(C(O)O1)O)=O)=O,,,4,1,2,13,15
7519_0,,,,2,1,1,2
C(C1C(O)OCCC1(C=O)O)=O,,,4,1,2,14,16
7521_0,,,,2,1,1,2
C(C1C(OC(C=O)CC1O)O)=O,,,4,1,2,16,18
7522_0,,,,2,1,1,2
7524_0,,,,2,1,1,2
C(C1C(O)OC(CO)C(C1O)O)=O,,,4,1,1,12,13
7526_0,,,,2,1,1,2
C(C1(CC(O)OCC1)O)=O,,,4,1,1,8,9
7528_0,,,,2,1,1,2
C(C1(C(C(O)OCC1)O)O)=O,,,4,1,1,10,11
7530_0,,,,2,1,1,2
C1(C(O)OC(CO)C(C1CO)O)=O,,,4,1,3,9,12
7532_0,,,,2,1,1,2
C(C1(C(CO)C(C(CO1)O)O)O)=O,,,4,1,1,10,11
7534_0,,,,2,1,1,2
C1(C(O)OCC(C1CO)O)=O,,,4,1,4,11,15
7536_0,,,,2,1,1,2
C(C1C(C(CC(O1)O)O)O)=O,,,4,1,4,12,16
7538_0,,,,2,1,1,2
C(C1CC(CC(O1)O)O)=O,,,4,1,1,11,12
7540_0,,,,2,1,1,2
C(C1C(CC(C(O1)O)O)O)=O,,,4,1,4,12,16
7542_0,,,,2,1,1,2
C(C1CC(C(C(O1)O)O)O)=O,,,4,1,1,11,12
7544_0,,,,2,1,1,2
C(C1C(C(O)OC(CO)C1O)O)=O,,,4,1,1,12,13
7546_0,,,,2,1,1,2
C(C(C1C(O)OCC(C1O)O)O)=O,,,4,1,2,11,13
7548_0,,,,2,1,1,2
C(C1C(C(O)OCC1O)O)=O,,,4,1,2,14,16
7550_0,,,,2,1,1,2
C(CO)(C1C(O)OCC(C1O)O)=O,,,4,1,2,11,13
7552_0,,,,2,1,1,2
C(C1C(CO)(O)OCC(C1O)O)=O,,,4,1,1,13,14
7554_0,,,,2,1,1,2
C1(C(C(C)OC(C1)O)O)=O,,,4,1,1,18,19
7556_0,,,,2,1,1,2
C(CC1(C(C(C(CO1)O)O)O)O)=O,,,4,1,1,12,13
7558_0,,,,2,1,1,2
C1(C(C(C(CO)O)OC(C1)O)O)=O,,,4,1,3,8,11
7559_0,,,,2,1,1,2
7560_0,,,,2,1,1,2
7562_0,,,,2,1,1,2
C1(C(C(O)OC(C)C1)O)=O,,,4,1,1,20,21
7564_0,,,,2,1,1,2
C(C(C1(CC(C(CO1)O)O)O)O)=O,,,4,1,1,12,13
7566_0,,,,2,1,1,2
C1(C(C(O)OC(C(CO)O)C1)O)=O,,,4,1,3,10,13
7567_0,,,,2,1,1,2
7568_0,,,,2,1,1,2
7570_0,,,,2,1,1,2
C1C(C(CC(O)O1)O)O,,,4,1,1,10,11
7572_0,,,,2,1,1,2
C(C1C(C(CC(O)O1)O)O)O,,,4,1,2,5,7
7574_0,,,,2,1,1,2
C1(C(O)OCC(C1O)O)=O,,,4,1,2,17,19
7576_0,,,,2,1,1,2
C1(C(O)OC(CO)C(C1O)O)=O,,,4,1,1,8,9
7578_0,,,,2,1,1,2
C(C1(C(C(C(CO1)O)O)O)O)=O,,,4,1,1,12,13
7580_0,,,,2,1,1,2
C1C(C(C(C(O)O1)(C(C)O)O)O)O,,,4,1,1,7,8
7582_0,,,,2,1,1,2
C1(COC(C(C1(CO)O)O)O)=O,,,4,1,4,11,15
7584_0,,,,2,1,1,2
C(C1(C(C(O)OCC1O)O)O)(O)=O,,,4,1,2,11,13
7586_0,,,,2,1,1,2
C(C1(C(C(O)OCC1O)O)O)=O,,,4,1,2,14,16
7588_0,,,,2,1,1,2
C1(COC(C(C)(C1(CO)O)O)O)=O,,,4,1,4,10,14
7590_0,,,,2,1,1,2
C1(COC(C)(C(C1(CO)O)O)O)=O,,,4,1,4,11,15
7592_0,,,,2,1,1,2
C(CO)(C1(COC(CC1O)O)O)=O,,,4,1,1,9,10
7594_0,,,,2,1,1,2
C1(C(CO)(C(CC(O)O1)O)O)=O,,,4,1,3,9,12
7596_0,,,,2,1,1,2
C(C1(COC(CC1O)O)O)(O)=O,,,4,1,2,8,10
7598_0,,,,2,1,1,2
C(C1(C(COC(C1(C)O)O)O)O)=O,,,4,1,2,12,14
7600_0,,,,2,1,1,2
C(C1(C(COC(C)(C1O)O)O)O)=O,,,4,1,2,13,15
7602_0,,,,2,1,1,2
C(C1(COC(CC1O)O)O)=O,,,4,1,1,10,11
7604_0,,,,2,1,1,2
C(C1(C(CO)OC(CC1O)O)O)=O,,,4,1,1,10,11
7606_0,,,,2,1,1,2
C(C1(CCOC(C1(CO)O)O)O)=O,,,4,1,2,9,11
7608_0,,,,2,1,1,2
C(C1(CO)C(C(CC(O1)O)O)O)=O,,,4,1,3,13,16
7610_0,,,,2,1,1,2
C(C1(CO)C(CC(C(O1)O)O)O)=O,,,4,1,3,13,16
7612_0,,,,2,1,1,2
C(C1CC(C(CO)(C(O1)O)O)O)=O,,,4,1,2,9,11
7614_0,,,,2,1,1,2
C(C1(COC(CO)(CC1O)O)O)=O,,,4,1,1,11,12
7616_0,,,,2,1,1,2
C(C1(COC(CC1(CO)O)O)O)=O,,,4,1,1,10,11
7618_0,,,,2,1,1,2
C(C)(C1(C(O)OCC(C1O)O)O)=O,,,4,1,1,12,13
7620_0,,,,2,1,1,2
C(C1(C(C)(O)OCC(C1O)O)O)=O,,,4,1,1,13,14
7622_0,,,,2,1,1,2
C(C1(COC(C)(C(C1O)O)O)O)=O,,,4,1,1,12,13
7624_0,,,,2,1,1,2
C(C1(COC(C(C1(C)O)O)O)O)=O,,,4,1,1,11,12
7626_0,,,,2,1,1,2
C(C1(CC(O)OCC1(CO)O)O)=O,,,4,1,1,9,10
7628_0,,,,2,1,1,2
C1(C(C(CC(O)O1)O)O)=O,,,4,1,3,12,15
7630_0,,,,2,1,1,2
C(C1(CC(O)OC(CO)C1O)O)=O,,,4,1,1,9,10
7632_0,,,,2,1,1,2
C(CC1(C(O)OCC(C1O)O)O)=O,,,4,1,2,11,13
7634_0,,,,2,1,1,2
C(C1(C(COC(C1)O)O)O)=O,,,4,1,1,9,10
7636_0,,,,2,1,1,2
C(C1C(C(CC(O1)O)O)O)(O)=O,,,4,1,2,8,10
7638_0,,,,2,1,1,2
C(C1C(CC(C(O1)O)O)O)(O)=O,,,4,1,2,8,10
7640_0,,,,2,1,1,2
C1(C(C(CC(CO)(O)O1)O)O)=O,,,4,1,1,7,8
7642_0,,,,2,1,1,2
C1(C(C(CO)(CC(O)O1)O)O)=O,,,4,1,1,6,7
7644_0,,,,2,1,1,2
C1(C(C(C(C(C)(O)O1)O)O)O)=O,,,4,1,1,8,9
7646_0,,,,2,1,1,2
C1(C(C(C)(C(C(O)O1)O)O)O)=O,,,4,1,1,7,8
7647_0,,,,2,1,1,2
7648_0,,,,2,1,1,2
7649_0,,,,2,1,1,2
7650_0,,,,2,1,1,2
7651_0,,,,2,1,1,2
7653_0,,,,2,1,1,2
C(C1(CC(C(CO1)O)O)O)(O)=O,,,4,1,2,8,10
7655_0,,,,2,1,1,2
C(C1C(C(C(CC(O)O1)O)O)O)O,,,4,1,1,7,8
7657_0,,,,2,1,1,2
C1(C(C(C(O)OCC1O)O)O)=O,,,4,1,1,10,11
7659_0,,,,2,1,1,2
C1(C(C(COC(C1)O)(CO)O)O)=O,,,4,1,1,9,10
7661_0,,,,2,1,1,2
C1(C(C(O)OCC(CO)(C1)O)O)=O,,,4,1,1,10,11
7663_0,,,,2,1,1,2
C1(COC(CC(C1O)O)O)=O,,,4,1,6,12,18
7665_0,,,,2,1,1,2
C1(C(C(C(CO)(O)OCC1)O)O)=O,,,4,1,1,10,11
7667_0,,,,2,1,1,2
C1(COC(CO)(C(C(C1)O)O)O)=O,,,4,1,1,9,10
7669_0,,,,2,1,1,2
C1(COC(CO)(CC(C1O)O)O)=O,,,4,1,1,10,11
7671_0,,,,2,1,1,2
C1(COC(CC(CO)(C1O)O)O)=O,,,4,1,1,9,10
7673_0,,,,2,1,1,2
C1(COC(C)(C(C(C1O)O)O)O)=O,,,4,1,2,11,13
7675_0,,,,2,1,1,2
C1(COC(C(C(C)(C1O)O)O)O)=O,,,4,1,1,10,11
7677_0,,,,2,1,1,2
C1(C(O)OCC(C(CO)(C1)O)O)=O,,,4,1,1,8,9
7679_0,,,,2,1,1,2
C1(C(C(C(O)OCC1O)(C)O)O)=O,,,4,1,1,9,10
7681_0,,,,2,1,1,2
C1(C(C(C(C)(O)OCC1O)O)O)=O,,,4,1,2,10,12
7683_0,,,,2,1,1,2
C1(C(CO)OC(CC(C1O)O)O)=O,,,4,1,3,10,13
7685_0,,,,2,1,1,2
C1(C(O)OCC(CO)(C(C1)O)O)=O,,,4,1,1,8,9
7687_0,,,,2,1,1,2
C1C(C(CO)(C(CC(O)O1)O)O)O,,,4,1,2,6,8
7689_0,,,,2,1,1,2
C(C1(CCOC(C(C1)=O)O)O)=O,,,4,1,1,10,11
7691_0,,,,2,1,1,2
C1(C(CC(C=O)(O)OCC1)O)=O,,,4,1,2,11,13
7693_0,,,,2,1,1,2
C(C1CC(CC(C(O1)O)=O)O)=O,,,4,1,1,11,12
7695_0,,,,2,1,1,2
C(C1(CC(CC(CO1)=O)O)O)=O,,,4,1,2,11,13
7696_0,,,,2,1,1,2
7698_0,,,,2,1,1,2
C1(C(O)OC(CO)C(C(C1)O)O)=O,,,4,1,1,8,9
7700_0,,,,2,1,1,2
C(C1(CC(C(C(CO1)O)O)O)O)=O,,,4,1,3,11,14
7702_0,,,,2,1,1,2
C(C1C(COC(CC1O)O)=O)=O,,,4,1,3,11,14
7704_0,,,,2,1,1,2
C(C1C(CC(CC(O1)O)O)=O)=O,,,4,1,1,9,10
7706_0,,,,2,1,1,2
C(C1C(O)OCCC(C1O)=O)=O,,,4,1,3,15,18
7708_0,,,,2,1,1,2
C(C1C(CC(COC1O)=O)O)=O,,,4,1,3,15,18
7710_0,,,,2,1,1,2
C(C1C(O)OCC(C(C1O)O)O)=O,,,4,1,3,14,17
7712_0,,,,2,1,1,2
C1(C(CC(O)OCC1)O)=O,,,4,1,2,16,18
7713_0,,,,2,1,1,2
7715_0,,,,2,1,1,2
C1(C(O)OCC(C(C1CO)O)O)=O,,,4,1,3,11,14
7717_0,,,,2,1,1,2
C(C1C(C(O)OCC(C1O)O)O)=O,,,4,1,1,14,15
7719_0,,,,2,1,1,2
C1(COC(CC(C1)O)O)=O,,,4,1,2,19,21
7720_0,,,,2,1,1,2
7722_0,,,,2,1,1,2
C1(C(C(C(CO)OC(C1)O)O)O)=O,,,4,1,1,9,10
7723_0,,,,2,1,1,2
7725_0,,,,2,1,1,2
C1(C(C(O)OC(C(C1)O)CO)O)=O,,,4,1,1,9,10
7726_0,,,,2,1,1,2
7728_0,,,,2,1,1,2
C1C(C(C(CC(O)O1)O)O)O,,,4,1,3,7,10
7730_0,,,,2,1,1,2
C1(C(O)OCC(C(C1O)O)O)=O,,,4,1,1,10,11
7732_0,,,,2,1,1,2
C1(COC(CC(C1(CO)O)O)O)=O,,,4,1,4,11,15
7734_0,,,,2,1,1,2
C(C1(C(COC(CC1O)O)O)O)=O,,,4,1,2,13,15
7736_0,,,,2,1,1,2
C1(C(C(C(O)OCC1)(CO)O)O)=O,,,4,1,2,9,11
7738_0,,,,2,1,1,2
C(C1(COC(CC(C1O)O)O)O)=O,,,4,1,1,12,13
7740_0,,,,2,1,1,2
C(C1(COC(C(CC1O)O)O)O)=O,,,4,1,1,12,13
7742_0,,,,2,1,1,2
C1(COC(C(CO)(C(C1)O)O)O)=O,,,4,1,2,8,10
7744_0,,,,2,1,1,2
C(C1(CC(O)OCC(C1O)O)O)=O,,,4,1,1,11,12
7746_0,,,,2,1,1,2
C1(C(C(C(CC(O)O1)O)O)O)=O,,,4,1,1,8,9
7748_0,,,,2,1,1,2
C1(C(C(CC(C(O)O1)O)O)O)=O,,,4,1,1,8,9
7749_0,,,,2,1,1,2
7750_0,,,,2,1,1,2
7751_0,,,,2,1,1,2
7752_0,,,,2,1,1,2
7753_0,,,,2,1,1,2
7754_0,,,,2,1,1,2
7755_0,,,,2,1,1,2
7756_0,,,,2,1,1,2
7757_0,,,,2,1,1,2
7758_0,,,,2,1,1,2
7759_0,,,,2,1,1,2
7760_0,,,,2,1,1,2
7761_0,,,,2,1,2,3
7762_0,,,,2,1,2,3
7763_0,,,,2,1,2,3
7764_0,,,,2,1,2,3
7765_0,,,,2,1,2,3
7766_0,,,,2,1,2,3
7767_0,,,,2,1,2,3
7768_0,,,,2,1,2,3
7769_0,,,,2,1,2,3
7770_0,,,,2,1,2,3
7771_0,,,,2,1,2,3
7772_0,,,,2,1,2,3
7774_0,,,,2,1,2,3
C1(C(CO)(C(CO)(CO1)O)O)=O,,,4,1,4,7,11
7775_0,,,,2,1,2,3
7777_0,,,,2,1,2,3
C1(C(C(CO)(CO1)O)O)=O,,,4,1,5,10,15
7779_0,,,,2,1,2,3
C1(C(C(CO1)(C(CO)O)O)O)=O,,,4,1,4,7,11
7781_0,,,,2,1,2,3
C1(C(C(CO)(C(CO)O1)O)O)=O,,,4,1,3,4,7
7783_0,,,,2,1,2,3
C1(C(C(C(CO)(CO)O1)O)O)=O,,,4,1,2,3,5
7784_0,,,,2,1,2,3
7786_0,,,,2,1,2,3
C(CC1(COC(C1O)=O)O)=O,,,4,1,2,12,14
7787_0,,,,2,1,2,3
7789_0,,,,2,1,2,3
C1(C(C(C)(C(C=O)O1)O)O)=O,,,4,1,1,12,13
7790_0,,,,2,1,2,3
7791_0,,,,2,1,2,3
7792_0,,,,2,1,2,3
7793_0,,,,2,1,2,3
7794_0,,,,2,1,1,2
7795_0,,,,2,1,1,2
7796_0,,,,2,1,1,2
7797_0,,,,2,1,2,3
7799_0,,,,2,1,2,3
C1(C(C(CO)(C(CO1)O)O)O)=O,,,4,1,2,6,8
7801_0,,,,2,1,2,3
C1(C(C(C(CO)(CO1)O)O)O)=O,,,4,1,2,7,9
7803_0,,,,2,1,2,3
C(C1(CCOC(C1O)=O)O)=O,,,4,1,1,9,10
7805_0,,,,2,1,2,3
C1(C(C(CC(C=O)O1)O)O)=O,,,4,1,2,13,15
7806_0,,,,2,1,2,3
7807_0,,,,2,1,2,3
7808_0,,,,2,1,2,3
7809_0,,,,2,1,2,3
7810_0,,,,2,1,2,3
7811_0,,,,2,1,2,3
7812_0,,,,2,1,2,3
7813_0,,,,2,1,2,3
7814_0,,,,2,1,1,2
7815_0,,,,2,1,2,3
7816_0,,,,2,1,2,3
7817_0,,,,2,1,2,3
7818_0,,,,2,1,2,3
7819_0,,,,2,1,2,3
7820_0,,,,2,1,2,3
7822_0,,,,2,2,1,3
C(C(C=O)C(CCC(C=O)=O)O)=O,,,4,1,3,12,15
7824_0,,,,2,2,1,3
C(C(C(C(C=O)C=O)O)CC=O)=O,,,4,1,4,12,16
7826_0,,,,2,2,1,3
C(C(C=O)(CCC(C=O)=O)CO)=O,,,4,1,2,7,9
7828_0,,,,2,2,1,3
C(CC(C=O)C(C=O)(C=O)CO)=O,,,4,1,2,9,11
7830_0,,,,2,2,1,3
C(C(CCC(C=O)=O)C(C)O)=O,,,4,1,2,16,18
7832_0,,,,2,2,1,3
C(CC(C=O)C(C=O)C(C)O)=O,,,4,1,4,17,21
7834_0,,,,2,2,1,3
C(CC(C)(CCC(C=O)=O)O)=O,,,4,1,1,20,21
7836_0,,,,2,2,1,3
C(CC(C)(C(C=O)CC=O)O)=O,,,4,1,3,19,22
7838_0,,,,2,2,1,3
C(CC(CCCC(C=O)=O)O)=O,,,4,1,2,19,21
7840_0,,,,2,2,1,3
C(CC(CC(C=O)CC=O)O)=O,,,4,1,4,21,25
7842_0,,,,2,2,1,3
C(C(CCC(C=O)=O)(C(C)O)O)=O,,,4,1,2,12,14
7844_0,,,,2,2,1,3
C(CC(C=O)C(C=O)(C(C)O)O)=O,,,4,1,3,13,16
7846_0,,,,2,2,1,3
C(C(C(CCC(C=O)=O)(C)O)O)=O,,,4,1,1,18,19
7848_0,,,,2,2,1,3
C(C(C(C)(C(C=O)CC=O)O)O)=O,,,4,1,4,17,21
7850_0,,,,2,2,1,3
C(C(C(CCCC(C=O)=O)O)O)=O,,,4,1,3,17,20
7852_0,,,,2,2,1,3
C(C(C(CC(C=O)CC=O)O)O)=O,,,4,1,4,20,24
7854_0,,,,2,2,1,3
C(CC(CCC(C=O)=O)O)=O,,,4,1,4,22,26
7856_0,,,,2,2,1,3
C(CC(C(C=O)CC=O)O)=O,,,4,1,6,22,28
7858_0,,,,2,2,1,3
C(C(CCC(C=O)=O)CO)=O,,,4,1,4,17,21
7860_0,,,,2,2,1,3
C(CC(C=O)C(C=O)CO)=O,,,4,1,6,18,24
7862_0,,,,2,2,1,3
C(CC(C(CCC(C=O)=O)O)O)=O,,,4,1,2,18,20
7864_0,,,,2,2,1,3
C(CC(C(C(C=O)CC=O)O)O)=O,,,4,1,3,20,23
7866_0,,,,2,2,1,3
C(CC(CCC(C=O)=O)(CO)O)=O,,,4,1,3,17,20
7868_0,,,,2,2,1,3
C(CC(CO)(C(C=O)CC=O)O)=O,,,4,1,4,16,20
7870_0,,,,2,2,1,3
C(C(CCC(C=O)=O)C(CO)O)=O,,,4,1,3,13,16
7872_0,,,,2,2,1,3
C(CC(C=O)C(C=O)C(CO)O)=O,,,4,1,4,15,19
7874_0,,,,2,2,1,3
C(C(C)(CCC(C=O)=O)O)(O)=O,,,4,1,2,13,15
7876_0,,,,2,2,1,3
C(C(C)(C(C=O)CC=O)O)(O)=O,,,4,1,5,14,19
7878_0,,,,2,2,1,3
C(C(CCCC(C=O)=O)O)(O)=O,,,4,1,3,13,16
7880_0,,,,2,2,1,3
C(C(CC(C=O)CC=O)O)(O)=O,,,4,1,5,15,20
7882_0,,,,2,2,1,3
C(C=O)(CCC(C(C=O)=O)O)=O,,,4,1,2,17,19
7884_0,,,,2,2,1,3
C(CC(C=O)C(C(C=O)=O)O)=O,,,4,1,3,17,20
7886_0,,,,2,2,1,3
C(C=O)(CCC(C(C(C)=O)=O)O)=O,,,4,1,1,11,12
7888_0,,,,2,2,1,3
C(CC(C=O)C(C(C(C)=O)=O)O)=O,,,4,1,2,11,13
7890_0,,,,2,2,1,3
C(C=O)(CCCC(C(CO)=O)=O)=O,,,4,1,2,11,13
7892_0,,,,2,2,1,3
C(CC(C=O)CC(C(CO)=O)=O)=O,,,4,1,2,12,14
7894_0,,,,2,2,1,3
C(C=O)(CCCC(C(C=O)=O)O)=O,,,4,1,2,12,14
7896_0,,,,2,2,1,3
C(C(CC(C(C=O)=O)O)CC=O)=O,,,4,1,3,13,16
7898_0,,,,2,2,1,3
C(C=O)(C(C)(CCC(C=O)=O)O)=O,,,4,1,1,9,10
7900_0,,,,2,2,1,3
C(CC(C=O)C(C(C=O)=O)(C)O)=O,,,4,1,2,10,12
7902_0,,,,2,2,1,3
C(C)(C(CCC(C=O)=O)O)=O,,,4,1,6,17,23
7904_0,,,,2,2,1,3
C(CC(C=O)C(C(C)=O)O)=O,,,4,1,8,18,26
7906_0,,,,2,2,1,3
C(CO)(CCCC(C=O)=O)=O,,,4,1,7,19,26
7908_0,,,,2,2,1,3
C(CC(C=O)CC(CO)=O)=O,,,4,1,8,20,28
7910_0,,,,2,2,1,3
C(C(CCC(C=O)=O)O)(CCO)=O,,,4,1,3,13,16
7912_0,,,,2,2,1,3
C(C(C(C=O)CC=O)O)(CCO)=O,,,4,1,4,14,18
7914_0,,,,2,2,1,3
C(CO)(CC(CCC(C=O)=O)O)=O,,,4,1,4,17,21
7916_0,,,,2,2,1,3
C(CO)(CC(C(C=O)CC=O)O)=O,,,4,1,5,17,22
7918_0,,,,2,2,1,3
C(CO)(C(CO)CCC(C=O)=O)=O,,,4,1,5,14,19
7920_0,,,,2,2,1,3
C(CO)(C(CO)C(C=O)CC=O)=O,,,4,1,5,16,21
7922_0,,,,2,2,1,3
C(C(CCC(C=O)=O)(CCO)O)=O,,,4,1,2,10,12
7924_0,,,,2,2,1,3
C(CC(C=O)C(C=O)(CCO)O)=O,,,4,1,3,12,15
7926_0,,,,2,2,1,3
C(C(CC(CCC(C=O)=O)O)O)=O,,,4,1,2,14,16
7928_0,,,,2,2,1,3
C(C(CC(C(C=O)CC=O)O)O)=O,,,4,1,3,17,20
7930_0,,,,2,2,1,3
C(C(C(CCC(C=O)=O)CO)O)=O,,,4,1,3,14,17
7932_0,,,,2,2,1,3
C(C(C(CO)C(C=O)CC=O)O)=O,,,4,1,4,16,20
7934_0,,,,2,2,1,3
C(C)(C(CO)(CCC(C=O)=O)O)=O,,,4,1,3,12,15
7936_0,,,,2,2,1,3
C(C)(C(CO)(C(C=O)CC=O)O)=O,,,4,1,4,13,17
7938_0,,,,2,2,1,3
C(C)(C(C(CCC(C=O)=O)O)O)=O,,,4,1,3,19,22
7940_0,,,,2,2,1,3
C(C)(C(C(C(C=O)CC=O)O)O)=O,,,4,1,4,18,22
7942_0,,,,2,2,1,3
C(C(CO)O)(CCCC(C=O)=O)=O,,,4,1,4,14,18
7944_0,,,,2,2,1,3
C(CC(C=O)CC=O)(C(CO)O)=O,,,4,1,5,16,21
7946_0,,,,2,2,1,3
C(C(CCC(C)O)=O)=O,,,4,1,2,26,28
7948_0,,,,2,2,1,3
C(C(C(C)O)CC=O)=O,,,4,1,4,33,37
7950_0,,,,2,2,1,3
C(C(CCCCO)=O)=O,,,4,1,2,25,27
7952_0,,,,2,2,1,3
C(C(CCO)CC=O)=O,,,4,1,4,27,31
7954_0,,,,2,2,1,3
C(C(CCCC(C(O)=O)=O)=O)=O,,,4,1,4,11,15
7956_0,,,,2,2,1,3
C(CC(C=O)CC(C(O)=O)=O)=O,,,4,1,4,12,16
7958_0,,,,2,2,1,3
C(C(C(O)=O)CCC(C=O)=O)=O,,,4,1,4,15,19
7960_0,,,,2,2,1,3
C(C(C(O)=O)C(C=O)CC=O)=O,,,4,1,5,15,20
7962_0,,,,2,2,1,3
C(CCCC(C=O)=O)(O)=O,,,4,1,3,14,17
7964_0,,,,2,2,1,3
C(CC(C=O)CC(O)=O)=O,,,4,1,4,15,19
7966_0,,,,2,2,1,3
C1(C(CCC(C=O)=O)OCC1O)=O,,,4,1,2,9,11
7968_0,,,,2,2,1,3
C(CC(C=O)C1C(C(CO1)O)=O)=O,,,4,1,2,10,12
7970_0,,,,2,2,1,3
C1(COC(CCC(C=O)=O)C1O)=O,,,4,1,2,14,16
7972_0,,,,2,2,1,3
C(C(C1C(C(CO1)=O)O)CC=O)=O,,,4,1,2,13,15
7974_0,,,,2,2,1,3
C1(COCC1(CCC(C=O)=O)O)=O,,,4,1,1,9,10
7976_0,,,,2,2,1,3
C1(COCC1(C(C=O)CC=O)O)=O,,,4,1,1,10,11
7978_0,,,,2,2,1,3
C1(C(CCC(C=O)=O)(O)OCC1)=O,,,4,1,1,10,11
7980_0,,,,2,2,1,3
C(CC(C=O)C1(C(CCO1)=O)O)=O,,,4,1,1,11,12
7982_0,,,,2,2,1,3
C1(C(O)OC(CCC(C=O)=O)C1)=O,,,4,1,2,11,13
7984_0,,,,2,2,1,3
C(CC(C=O)C1CC(C(O)O1)=O)=O,,,4,1,2,11,13
7986_0,,,,2,2,1,3
C1(C(O)OCC1CCC(C=O)=O)=O,,,4,1,2,9,11
7988_0,,,,2,2,1,3
C1(C(O)OCC1C(C=O)CC=O)=O,,,4,1,2,11,13
7990_0,,,,2,2,1,3
C1(C(CCC(C=O)=O)C(CO1)O)=O,,,4,1,1,7,8
7992_0,,,,2,2,1,3
C1(C(C(CO1)O)C(C=O)CC=O)=O,,,4,1,1,8,9
7994_0,,,,2,2,1,3
C1(CC(C(CCC(C=O)=O)O1)O)=O,,,4,1,1,7,8
7996_0,,,,2,2,1,3
C1(CC(C(C(C=O)CC=O)O1)O)=O,,,4,1,1,8,9
7998_0,,,,2,2,1,3
C1(CC(CO1)(CCC(C=O)=O)O)=O,,,4,1,1,8,9
8000_0,,,,2,2,1,3
C1(CC(CO1)(C(C=O)CC=O)O)=O,,,4,1,2,8,10
8002_0,,,,2,2,1,3
C1(COC(C1CCC(C=O)=O)O)=O,,,4,1,2,13,15
8004_0,,,,2,2,1,3
C1(COC(C1C(C=O)CC=O)O)=O,,,4,1,2,14,16
8006_0,,,,2,2,1,3
C1(COC(CCC(C=O)=O)(C1)O)=O,,,4,1,1,17,18
8008_0,,,,2,2,1,3
C1(COC(C(C=O)CC=O)(C1)O)=O,,,4,1,1,16,17
8010_0,,,,2,2,1,3
C1(C(CCC(C=O)=O)OC(C1)O)=O,,,4,1,2,10,12
8012_0,,,,2,2,1,3
C1(C(C(C=O)CC=O)OC(C1)O)=O,,,4,1,2,11,13
8014_0,,,,2,2,1,3
C(C(CO)(CCC(C=O)=O)O)=O,,,4,1,4,16,20
8016_0,,,,2,2,1,3
C(C(C(CCC(C=O)=O)O)O)=O,,,4,1,8,23,31
8018_0,,,,2,2,1,3
C(C(CCCO)=O)=O,,,4,1,4,61,65
8020_0,,,,2,2,1,3
C(C(CCC(CO)O)=O)=O,,,4,1,4,18,22
8022_0,,,,2,2,1,3
C(C(CCC(C=O)=O)O)(O)=O,,,4,1,4,15,19
8024_0,,,,2,2,1,3
C(CO)(C(CCC(C=O)=O)O)=O,,,4,1,5,17,22
8026_0,,,,2,2,1,3
C(C(CCC(CO)(CO)O)=O)=O,,,4,1,4,12,16
8028_0,,,,2,2,1,3
C(C(CCC(C(CO)O)O)=O)=O,,,4,1,6,16,22
8030_0,,,,2,2,1,3
C(C(CO)(CCC(C=O)=O)O)(O)=O,,,4,1,4,12,16
8032_0,,,,2,2,1,3
C(C(C(CCC(C=O)=O)O)O)(O)=O,,,4,1,6,16,22
8034_0,,,,2,2,1,3
C(C(CCCC(C=O)=O)=O)=O,,,4,1,5,8,13
8036_0,,,,2,2,1,3
C(C(C=O)CCC(C=O)=O)=O,,,4,1,5,13,18
8038_0,,,,2,2,1,3
C(C(CCC(CC(C=O)=O)O)=O)=O,,,4,1,3,15,18
8040_0,,,,2,2,1,3
C(C=O)(C(CCC(C=O)=O)CO)=O,,,4,1,4,11,15
8042_0,,,,2,2,1,3
C(C(CCC(C=O)=O)(CC=O)O)=O,,,4,1,1,14,15
8044_0,,,,2,2,1,3
C(C(CCC(C=O)=O)C(C=O)O)=O,,,4,1,4,14,18
8046_0,,,,2,2,1,3
C(C(C(CO)=O)CCC(C=O)=O)=O,,,4,1,4,12,16
8048_0,,,,2,2,1,3
C(CC(C(CCC(C=O)=O)O)=O)=O,,,4,1,2,14,16
8050_0,,,,2,2,1,3
C(C(C(C)=O)(CCC(C=O)=O)O)=O,,,4,1,1,8,9
8052_0,,,,2,2,1,3
C(C(C(CCCC(C=O)=O)=O)O)=O,,,4,1,4,13,17
8054_0,,,,2,2,1,3
C(CCCC(C=O)=O)=O,,,4,1,14,45,59
8055_0,,,,2,2,1,3
8056_0,,,,2,2,1,3
8058_0,,,,2,2,1,3
C(C(C(C(C=O)CC=O)O)O)=O,,,4,1,9,22,31
8059_0,,,,2,2,1,3
8060_0,,,,2,2,1,3
8061_0,,,,2,2,1,3
8062_0,,,,2,2,1,3
8064_0,,,,2,2,1,3
C(C(C(CO)(CO)O)CC=O)=O,,,4,1,6,13,19
8066_0,,,,2,2,1,3
C(C(C(C(CO)O)O)CC=O)=O,,,4,1,8,18,26
8068_0,,,,2,2,1,3
C(C(CO)(C(C=O)CC=O)O)(O)=O,,,4,1,5,13,18
8070_0,,,,2,2,1,3
C(C(C(C(C=O)CC=O)O)O)(O)=O,,,4,1,7,16,23
8071_0,,,,2,2,1,3
8072_0,,,,2,2,1,3
8074_0,,,,2,2,1,3
C(C(C(CC(C=O)=O)O)CC=O)=O,,,4,1,4,15,19
8076_0,,,,2,2,1,3
C(CC(C=O)C(C(C=O)=O)CO)=O,,,4,1,4,12,16
8078_0,,,,2,2,1,3
C(CC(C=O)(C(C=O)CC=O)O)=O,,,4,1,3,13,16
8080_0,,,,2,2,1,3
C(CC(C=O)C(C=O)C(C=O)O)=O,,,4,1,4,14,18
8082_0,,,,2,2,1,3
C(C(C(CO)=O)C(C=O)CC=O)=O,,,4,1,4,13,17
8084_0,,,,2,2,1,3
C(CC(C(C(C=O)CC=O)O)=O)=O,,,4,1,3,15,18
8086_0,,,,2,2,1,3
C(C(C(C)=O)(C(C=O)CC=O)O)=O,,,4,1,2,9,11
8088_0,,,,2,2,1,3
C(C(C(CC(C=O)CC=O)=O)O)=O,,,4,1,4,14,18
8089_0,,,,2,2,1,3
8090_0,,,,2,2,1,3
8092_0,,,,2,1,1,2
C1(C(C2C(C1C(C2O)O)O)O)=O,,,5,1,4,0,4
8092_1,,,,2,1,1,2
8093_0,,,,2,1,1,2
8093_1,,,,2,1,1,2
8095_0,,,,2,1,1,2
C1(C(C2(C(C1C(C2)O)O)O)O)=O,,,5,1,6,0,6
8095_1,,,,2,1,1,2
8096_0,,,,2,1,1,2
8096_1,,,,2,1,1,2
8098_0,,,,2,1,1,2
C1(CC2(C(C1(C(C2)O)O)O)O)=O,,,5,1,5,0,5
8099_0,,,,2,1,1,2
8099_1,,,,2,1,1,2
8100_0,,,,2,1,1,2
8100_1,,,,2,1,1,2
8101_0,,,,2,1,1,2
8101_1,,,,2,1,1,2
8103_0,,,,2,1,1,2
C1(C(C(CC1O)O)C(C=O)O)=O,,,5,1,5,0,5
8103_1,,,,2,1,1,2
8104_0,,,,2,1,1,2
8104_1,,,,2,1,1,2
8106_0,,,,2,1,1,2
C1(C(C(C(C1O)O)O)C(C=O)O)=O,,,5,1,6,0,6
8106_1,,,,2,1,1,2
8108_0,,,,2,1,1,2
C(C(C1C(C(C(C1O)O)O)O)=O)=O,,,5,1,2,0,2
8108_1,,,,2,1,1,2
8110_0,,,,2,1,1,2
C1(C(C(C(C(C(C1)O)O)O)O)O)=O,,,5,1,5,0,5
8111_0,,,,2,1,1,2
8111_1,,,,2,1,1,2
8113_0,,,,2,1,1,2
C(CO)(C1C(C(C(C1O)O)O)O)=O,,,5,1,3,0,3
8113_1,,,,2,1,1,2
8115_0,,,,2,1,1,2
C1(C(C(C(CO)C(C1O)O)O)O)=O,,,5,1,2,0,2
8115_1,,,,2,1,1,2
8117_0,,,,2,1,1,2
C(C1C(C(C)(CC1(C=O)O)O)O)=O,,,5,1,4,0,4
8117_1,,,,2,1,1,2
8119_0,,,,2,1,1,2
C1(C(C(CC1O)O)C(C=O)(C)O)=O,,,5,1,4,0,4
8119_1,,,,2,1,1,2
8121_0,,,,2,1,1,2
C(C1C(C(C)(CC(C1O)=O)O)O)=O,,,5,1,5,0,5
8121_1,,,,2,1,1,2
8123_0,,,,2,1,1,2
C(C(C1C(CC(C1(C)O)O)O)=O)=O,,,5,1,4,0,4
8123_1,,,,2,1,1,2
8124_0,,,,2,1,1,2
8124_1,,,,2,1,1,2
8125_0,,,,2,1,1,2
8125_1,,,,2,1,1,2
8127_0,,,,2,1,1,2
C(C1C(C(C=O)C(C)(C1O)O)O)=O,,,5,1,8,0,8
8127_1,,,,2,1,1,2
8128_0,,,,2,1,1,2
8128_1,,,,2,1,1,2
8130_0,,,,2,1,1,2
C1(C(C(CC(C(C1)O)(C)O)O)O)=O,,,5,1,3,0,3
8132_0,,,,2,1,1,2
C1(C(C(C(C)(CC(C1)O)O)O)O)=O,,,5,1,3,0,3
8132_1,,,,2,1,1,2
8134_0,,,,2,1,1,2
C(CO)(C1C(C(C)(CC1O)O)O)=O,,,5,1,4,0,4
8134_1,,,,2,1,1,2
8136_0,,,,2,1,1,2
C(C(C1C(C(C)(CC1O)O)O)=O)=O,,,5,1,4,0,4
8136_1,,,,2,1,1,2
8138_0,,,,2,1,1,2
C(C1C(C(C)(CC1O)O)O)=O,,,5,1,4,0,4
8138_1,,,,2,1,1,2
8140_0,,,,2,1,1,2
C(C1C(C(CO)C(C1(C)O)O)O)=O,,,5,1,2,0,2
8140_1,,,,2,1,1,2
8142_0,,,,2,1,1,2
C(C1C(C)(C(C(C1(C)O)O)O)O)=O,,,5,1,2,0,2
8142_1,,,,2,1,1,2
8143_0,,,,2,1,1,2
8145_0,,,,2,1,1,2
C(C1C(CO)(CC(C1(C)O)O)O)=O,,,5,1,2,0,2
8145_1,,,,2,1,1,2
8146_0,,,,2,1,1,2
8146_1,,,,2,1,1,2
8147_0,,,,2,1,1,2
8147_1,,,,2,1,1,2
8149_0,,,,2,1,1,2
C(C1C(C)(C(CC1(C=O)O)O)O)=O,,,5,1,4,0,4
8149_1,,,,2,1,1,2
8151_0,,,,2,1,1,2
C(C1C(C(CC(C1O)=O)O)(C)O)=O,,,5,1,5,0,5
8151_1,,,,2,1,1,2
8152_0,,,,2,1,1,2
8152_1,,,,2,1,1,2
8153_0,,,,2,1,1,2
8153_1,,,,2,1,1,2
8155_0,,,,2,1,1,2
C(C1C(CC(C1(C)O)O)O)=O,,,5,1,4,0,4
8155_1,,,,2,1,1,2
8156_0,,,,2,1,1,2
8156_1,,,,2,1,1,2
8158_0,,,,2,1,1,2
C(C1C(C(C(C1(C)O)O)O)O)=O,,,5,1,4,0,4
8158_1,,,,2,1,1,2
8160_0,,,,2,1,1,2
C(C(C)(C1C(CC(C1O)=O)O)O)=O,,,5,1,1,0,1
8161_0,,,,2,1,1,2
8163_0,,,,2,1,1,2
C(C1C(C(C)(C(C1O)O)O)O)=O,,,5,1,4,0,4
8163_1,,,,2,1,1,2
8164_0,,,,2,1,1,2
8164_1,,,,2,1,1,2
8166_0,,,,2,1,1,2
C(C1(CC(C(CC(C1)O)=O)O)O)=O,,,5,1,1,0,1
8168_0,,,,2,1,1,2
C(CC1(C(CC(C(C1)O)=O)O)O)=O,,,5,1,2,0,2
8169_0,,,,2,1,1,2
8169_1,,,,2,1,1,2
8171_0,,,,2,1,1,2
C1(C(C(CC1O)O)C(C(C)=O)O)=O,,,5,1,4,0,4
8171_1,,,,2,1,1,2
8173_0,,,,2,1,1,2
C1(CC(C(CC(CC1O)O)=O)O)=O,,,5,1,2,0,2
8175_0,,,,2,1,1,2
C(CC(C1(CC(C(C1)=O)O)O)O)=O,,,5,1,2,0,2
8176_0,,,,2,1,1,2
8176_1,,,,2,1,1,2
8178_0,,,,2,1,1,2
C(C1(C(C(C)O)C(C(C1)=O)O)O)=O,,,5,1,1,0,1
8180_0,,,,2,1,1,2
C1(C(C(C(C(C1)O)=O)C(C)O)O)=O,,,5,1,5,0,5
8182_0,,,,2,1,1,2
C1(C(C(C)O)C(C=O)(CC1O)O)=O,,,5,1,4,0,4
8182_1,,,,2,1,1,2
8183_0,,,,2,1,1,2
8183_1,,,,2,1,1,2
8185_0,,,,2,1,1,2
C(C1C(CC(CC(C1O)=O)O)O)=O,,,5,1,5,0,5
8187_0,,,,2,1,1,2
C(CC(C1C(CC(C1O)=O)O)O)=O,,,5,1,2,0,2
8188_0,,,,2,1,1,2
8188_1,,,,2,1,1,2
8190_0,,,,2,1,1,2
C(C1C(C(C(C1O)=O)C(C)O)O)=O,,,5,1,6,0,6
8190_1,,,,2,1,1,2
8192_0,,,,2,1,1,2
C1(C(CC(C(C(C1)O)CO)O)O)=O,,,5,1,1,0,1
8194_0,,,,2,1,1,2
C1(C(CC(C(C(C)(C1)O)O)O)O)=O,,,5,1,1,0,1
8196_0,,,,2,1,1,2
C1(C(C(CC(C(C)(C1)O)O)O)O)=O,,,5,1,3,0,3
8198_0,,,,2,1,1,2
C1(C(CC(CC(CO)(C1)O)O)O)=O,,,5,1,1,0,1
8200_0,,,,2,1,1,2
C1(C(C(C)(C(CC(C1)O)O)O)O)=O,,,5,1,3,0,3
8200_1,,,,2,1,1,2
8202_0,,,,2,1,1,2
C(CO)(C1C(CC(C1(C)O)O)O)=O,,,5,1,4,0,4
8202_1,,,,2,1,1,2
8204_0,,,,2,1,1,2
C(C1(CC(CC(C(C1)=O)O)O)O)=O,,,5,1,1,0,1
8205_0,,,,2,1,1,2
8206_0,,,,2,1,1,2
8206_1,,,,2,1,1,2
8208_0,,,,2,1,1,2
C(C1C(CC(C(CC1O)O)=O)O)=O,,,5,1,3,0,3
8210_0,,,,2,1,1,2
C1(C(CC(CC(C1)O)O)O)=O,,,5,1,1,0,1
8211_0,,,,2,1,1,2
8211_1,,,,2,1,1,2
8213_0,,,,2,1,1,2
C1(C(CC(C(C(C1)O)O)O)O)=O,,,5,1,1,0,1
8215_0,,,,2,1,1,2
C(C1C(C(C)(C(CO)C1O)O)O)=O,,,5,1,2,0,2
8215_1,,,,2,1,1,2
8217_0,,,,2,1,1,2
C(C1C(C(C)(C(C1(C)O)O)O)O)=O,,,5,1,2,0,2
8217_1,,,,2,1,1,2
8218_0,,,,2,1,1,2
8220_0,,,,2,1,1,2
C(C1C(C(C)(CC1(CO)O)O)O)=O,,,5,1,2,0,2
8220_1,,,,2,1,1,2
8221_0,,,,2,1,1,2
8221_1,,,,2,1,1,2
8222_0,,,,2,1,1,2
8222_1,,,,2,1,1,2
8224_0,,,,2,1,1,2
C1(C(C(C(C1)O)C(CCO)O)O)=O,,,5,1,1,0,1
8226_0,,,,2,1,1,2
C1(C(C(C(C1)O)C(CO)(C)O)O)=O,,,5,1,1,0,1
8228_0,,,,2,1,1,2
C1(C(C(C(C1)O)C(C(O)=O)O)O)=O,,,5,1,2,0,2
8229_0,,,,2,1,1,2
8231_0,,,,2,1,1,2
C1(C(C(C(C1)O)C(C(C)=O)O)O)=O,,,5,1,1,0,1
8233_0,,,,2,1,1,2
C1(C(C(C(C1)O)C(C)O)O)=O,,,5,1,1,0,1
8235_0,,,,2,1,1,2
C1(C(C(C(C1)O)CO)O)=O,,,5,1,3,0,3
8237_0,,,,2,1,1,2
C1(C(C(C(C1)O)C(CO)O)O)=O,,,5,1,2,0,2
8239_0,,,,2,1,1,2
C1(C(CC(C1C(CCO)O)O)O)=O,,,5,1,4,0,4
8239_1,,,,2,1,1,2
8241_0,,,,2,1,1,2
C1(C(CC(C1C(CO)(C)O)O)O)=O,,,5,1,4,0,4
8241_1,,,,2,1,1,2
8243_0,,,,2,1,1,2
C1(C(C(CC1O)O)C(C(O)=O)O)=O,,,5,1,4,0,4
8243_1,,,,2,1,1,2
8244_0,,,,2,1,1,2
8244_1,,,,2,1,1,2
8245_0,,,,2,1,1,2
8245_1,,,,2,1,1,2
8247_0,,,,2,1,1,2
C(CC(C1C(C(CC1O)O)=O)O)=O,,,5,1,4,0,4
8247_1,,,,2,1,1,2
8249_0,,,,2,1,1,2
C1(C(CC(C1C(C)O)O)O)=O,,,5,1,4,0,4
8249_1,,,,2,1,1,2
8251_0,,,,2,1,1,2
C1(C(CC(C1C(CO)O)O)O)=O,,,5,1,4,0,4
8251_1,,,,2,1,1,2
8253_0,,,,2,1,1,2
C1(C(C(C(CC(C1)O)O)O)O)=O,,,5,1,3,0,3
8254_0,,,,2,1,1,2
8254_1,,,,2,1,1,2
8256_0,,,,2,1,1,2
C1(C(C(C(C1C(C)O)O)O)O)=O,,,5,1,6,0,6
8256_1,,,,2,1,1,2
8258_0,,,,2,1,1,2
C1(C(C(C(C1C(CO)O)O)O)O)=O,,,5,1,6,0,6
8258_1,,,,2,1,1,2
8260_0,,,,2,1,1,2
C(C(C1C(CC(CC1O)O)O)=O)=O,,,5,1,2,0,2
8260_1,,,,2,1,1,2
8262_0,,,,2,1,1,2
C(C1C(CC(CC1(C=O)O)O)O)=O,,,5,1,4,0,4
8262_1,,,,2,1,1,2
8263_0,,,,2,1,1,2
8263_1,,,,2,1,1,2
8265_0,,,,2,1,1,2
C(C1C(CC(C=O)(CC1O)O)O)=O,,,5,1,2,0,2
8265_1,,,,2,1,1,2
8266_0,,,,2,1,1,2
8266_1,,,,2,1,1,2
8268_0,,,,2,1,1,2
C(C1C(C(CC1O)(CC=O)O)O)=O,,,5,1,3,0,3
8268_1,,,,2,1,1,2
8269_0,,,,2,1,1,2
8269_1,,,,2,1,1,2
8271_0,,,,2,1,1,2
C1(C(C(C(C1)O)(CC(C)O)O)O)=O,,,5,1,3,0,3
8273_0,,,,2,1,1,2
C1(C(C(C(CC(C)O)(C1)O)O)O)=O,,,5,1,3,0,3
8273_1,,,,2,1,1,2
8275_0,,,,2,1,1,2
C1(C(C(CO)C(C1C(C)O)O)O)=O,,,5,1,2,0,2
8275_1,,,,2,1,1,2
8277_0,,,,2,1,1,2
C1(C(C(C(C)(C1C(C)O)O)O)O)=O,,,5,1,2,0,2
8277_1,,,,2,1,1,2
8278_0,,,,2,1,1,2
8280_0,,,,2,1,1,2
C1(C(CC(CO)(C1C(C)O)O)O)=O,,,5,1,2,0,2
8280_1,,,,2,1,1,2
8281_0,,,,2,1,1,2
8281_1,,,,2,1,1,2
8283_0,,,,2,1,1,2
C(C1C(C(C=O)C(CC1O)O)O)=O,,,5,1,4,0,4
8283_1,,,,2,1,1,2
8284_0,,,,2,1,1,2
8284_1,,,,2,1,1,2
8286_0,,,,2,1,1,2
C(C1C(C(CO)C(CC1O)O)O)=O,,,5,1,2,0,2
8286_1,,,,2,1,1,2
8288_0,,,,2,1,1,2
C(C1C(CC(C(C1(C)O)O)O)O)=O,,,5,1,4,0,4
8288_1,,,,2,1,1,2
8290_0,,,,2,1,1,2
C1(C(C(CC(CC(C1)O)O)O)O)=O,,,5,1,3,0,3
8292_0,,,,2,1,1,2
C(C1C(CC(CC1(CO)O)O)O)=O,,,5,1,4,0,4
8292_1,,,,2,1,1,2
8293_0,,,,2,1,1,2
8293_1,,,,2,1,1,2
8295_0,,,,2,1,1,2
C(CO)(C1C(CC(CC1O)O)O)=O,,,5,1,2,0,2
8295_1,,,,2,1,1,2
8297_0,,,,2,1,1,2
C(C1C(CC(CC1O)O)O)=O,,,5,1,2,0,2
8297_1,,,,2,1,1,2
8299_0,,,,2,1,1,2
C(C1C(C(C(CC1O)O)O)O)=O,,,5,1,4,0,4
8299_1,,,,2,1,1,2
8300_0,,,,2,1,1,2
8300_1,,,,2,1,1,2
8302_0,,,,2,1,1,2
C(C1C(C(C(C(C1O)O)O)O)O)=O,,,5,1,4,0,4
8302_1,,,,2,1,1,2
8304_0,,,,2,1,1,2
C1(C(C(C(C(C1)O)C(C)O)O)O)=O,,,5,1,3,0,3
8305_0,,,,2,1,1,2
8305_1,,,,2,1,1,2
8307_0,,,,2,1,1,2
C1(C(C(C(C(C1)O)CO)O)O)=O,,,5,1,4,0,4
8308_0,,,,2,1,1,2
8308_1,,,,2,1,1,2
8310_0,,,,2,1,1,2
C(C1C(C(CC1O)(CCO)O)O)=O,,,5,1,4,0,4
8310_1,,,,2,1,1,2
8312_0,,,,2,1,1,2
C(C1C(CC(C1(CCO)O)O)O)=O,,,5,1,4,0,4
8312_1,,,,2,1,1,2
8313_0,,,,2,1,1,2
8313_1,,,,2,1,1,2
8315_0,,,,2,1,1,2
C1(C(CC(CC(C1CO)O)O)O)=O,,,5,1,2,0,2
8315_1,,,,2,1,1,2
8316_0,,,,2,1,1,2
8316_1,,,,2,1,1,2
8318_0,,,,2,1,1,2
C1(C(C(C(C1CO)O)C(C)O)O)=O,,,5,1,2,0,2
8318_1,,,,2,1,1,2
8320_0,,,,2,1,1,2
C1(C(C(CO)C(C1CO)O)O)=O,,,5,1,3,0,3
8320_1,,,,2,1,1,2
8322_0,,,,2,1,1,2
C(C1C(C(CC(CC1O)O)O)O)=O,,,5,1,4,0,4
8322_1,,,,2,1,1,2
8324_0,,,,2,1,1,2
C(C1C(CC(C(CC1O)O)O)O)=O,,,5,1,2,0,2
8324_1,,,,2,1,1,2
8326_0,,,,2,1,1,2
C(C1C(C(C(C1O)O)C(C)O)O)=O,,,5,1,4,0,4
8326_1,,,,2,1,1,2
8328_0,,,,2,1,1,2
C(C1C(C(CO)C(C1O)O)O)=O,,,5,1,5,0,5
8328_1,,,,2,1,1,2
8329_0,,,,2,1,1,2
8329_1,,,,2,1,1,2
8330_0,,,,2,1,1,2
8330_1,,,,2,1,1,2
8331_0,,,,2,1,1,2
8331_1,,,,2,1,1,2
8333_0,,,,2,1,1,2
C(C1C(CC(CO)(CC1O)O)O)=O,,,5,1,2,0,2
8333_1,,,,2,1,1,2
8334_0,,,,2,1,1,2
8334_1,,,,2,1,1,2
8336_0,,,,2,1,1,2
C1(C(C(CC(C1C(C)O)O)O)O)=O,,,5,1,6,0,6
8336_1,,,,2,1,1,2
8338_0,,,,2,1,1,2
C1(C(C(CC(C1CO)O)O)O)=O,,,5,1,7,0,7
8338_1,,,,2,1,1,2
8340_0,,,,2,1,1,2
C1(C(C(C(C(C1CO)O)O)O)O)=O,,,5,1,7,0,7
8340_1,,,,2,1,1,2
8342_0,,,,2,1,1,2
C(C1C(C(C(C)(CC1O)O)O)O)=O,,,5,1,4,0,4
8342_1,,,,2,1,1,2
8343_0,,,,2,1,1,2
8343_1,,,,2,1,1,2
8344_0,,,,2,1,1,2
8344_1,,,,2,1,1,2
8345_0,,,,2,1,1,2
8345_1,,,,2,1,1,2
8346_0,,,,2,1,1,2
8346_1,,,,2,1,1,2
8347_0,,,,2,1,1,2
8347_1,,,,2,1,1,2
8349_0,,,,2,1,1,2
C1(C(C(C(C1O)O)C(C)O)O)=O,,,5,1,2,0,2
8349_1,,,,2,1,1,2
8351_0,,,,2,1,1,2
C1(CC(C(C(C)O)C1(CO)O)O)=O,,,5,1,1,0,1
8353_0,,,,2,1,1,2
C1(C(C(C(C(C)O)C1(C)O)O)O)=O,,,5,1,2,0,2
8353_1,,,,2,1,1,2
8355_0,,,,2,1,1,2
C1(C(C(C(CO)C1O)O)O)=O,,,5,1,3,0,3
8355_1,,,,2,1,1,2
8357_0,,,,2,1,1,2
C1(CC(C(CO)C1(CO)O)O)=O,,,5,1,1,0,1
8359_0,,,,2,1,1,2
C1(C(C(C(CO)C1(C)O)O)O)=O,,,5,1,2,0,2
8359_1,,,,2,1,1,2
8361_0,,,,2,1,1,2
C1(C(C(C(C1O)O)C(CO)O)O)=O,,,5,1,2,0,2
8361_1,,,,2,1,1,2
8363_0,,,,2,1,1,2
C1(C(C(C(C(C1)O)(CO)O)O)=O)=O,,,5,1,3,0,3
8365_0,,,,2,1,1,2
C1(C(C(C(C(CO)(C1)O)O)O)=O)=O,,,5,1,3,0,3
8365_1,,,,2,1,1,2
8366_0,,,,2,1,1,2
8366_1,,,,2,1,1,2
8368_0,,,,2,1,1,2
C1(C2C(C(CO)(C1C(O2)O)O)O)=O,,,5,1,4,0,4
8368_1,,,,2,1,1,2
8370_0,,,,2,1,1,2
C1(C2C(CO)(C(C1C(O2)O)O)O)=O,,,5,1,4,0,4
8370_1,,,,2,1,1,2
8372_0,,,,2,1,1,2
C1(C(C(C(CO)(C1O)O)O)O)=O,,,5,1,5,0,5
8372_1,,,,2,1,1,2
8374_0,,,,2,1,1,2
C(C1C(C(C(C1(CO)O)O)O)=O)=O,,,5,1,4,0,4
8374_1,,,,2,1,1,2
8376_0,,,,2,1,1,2
C(C1C(C(C(CO)(C1O)O)O)=O)=O,,,5,1,4,0,4
8376_1,,,,2,1,1,2
8378_0,,,,2,1,1,2
C(C1(C(C(C(C1O)=O)O)O)O)=O,,,5,1,2,0,2
8378_1,,,,2,1,1,2
8380_0,,,,2,1,1,2
C1(C(C(C(C(C1O)O)=O)O)O)=O,,,5,1,2,0,2
8380_1,,,,2,1,1,2
8382_0,,,,2,1,1,2
C(C)(C1(C(C(C(C1O)=O)O)O)O)=O,,,5,1,6,0,6
8382_1,,,,2,1,1,2
8384_0,,,,2,1,1,2
C1(C(C(C(C(C1(C)O)O)=O)O)O)=O,,,5,1,7,0,7
8384_1,,,,2,1,1,2
8385_0,,,,2,1,1,2
8387_0,,,,2,1,1,2
C1(CC(C(C(C1(CO)O)O)=O)O)=O,,,5,1,3,0,3
8387_1,,,,2,1,1,2
8389_0,,,,2,1,1,2
C(CO)(C1(CC(C(C1O)=O)O)O)=O,,,5,1,2,0,2
8389_1,,,,2,1,1,2
8390_0,,,,2,1,1,2
8390_1,,,,2,1,1,2
8392_0,,,,2,1,1,2
C1(C(CC(CO)(C1O)O)O)=O,,,5,1,3,0,3
8392_1,,,,2,1,1,2
8393_0,,,,2,1,1,2
8393_1,,,,2,1,1,2
8395_0,,,,2,1,1,2
C1(C(C(CO)(C(CO)C1O)O)O)=O,,,5,1,3,0,3
8395_1,,,,2,1,1,2
8396_0,,,,2,1,1,2
8396_1,,,,2,1,1,2
8398_0,,,,2,1,1,2
C1(C(C(CC1O)(C(CO)O)O)O)=O,,,5,1,3,0,3
8398_1,,,,2,1,1,2
8400_0,,,,2,1,1,2
C(C1(CC(C(C1O)=O)O)O)(O)=O,,,5,1,2,0,2
8400_1,,,,2,1,1,2
8402_0,,,,2,1,1,2
C(C1C(C(C(C1O)=O)O)O)(O)=O,,,5,1,3,0,3
8402_1,,,,2,1,1,2
8404_0,,,,2,1,1,2
C1(C(C2(C(C1O)OCC2O)O)O)=O,,,5,1,2,0,2
8404_1,,,,2,1,1,2
8406_0,,,,2,1,1,2
C1(C(C2(C(O)OCC2C1O)O)O)=O,,,5,1,2,0,2
8406_1,,,,2,1,1,2
8408_0,,,,2,1,1,2
C1(C(C2(COC(C2C1O)O)O)O)=O,,,5,1,2,0,2
8408_1,,,,2,1,1,2
8409_0,,,,2,1,1,2
8409_1,,,,2,1,1,2
8411_0,,,,2,1,1,2
C1(C(C2(C(C1O)OC(C2)O)O)O)=O,,,5,1,2,0,2
8411_1,,,,2,1,1,2
8412_0,,,,2,1,1,2
8412_1,,,,2,1,1,2
8413_0,,,,2,1,1,2
8413_1,,,,2,1,1,2
8415_0,,,,2,1,1,2
C(C1(CC(C(C1O)=O)O)O)=O,,,5,1,4,0,4
8415_1,,,,2,1,1,2
8417_0,,,,2,1,1,2
C1(C(C(C(CC1O)=O)O)O)=O,,,5,1,5,0,5
8417_1,,,,2,1,1,2
8419_0,,,,2,1,1,2
C(C1C(C(C(C1O)=O)O)O)=O,,,5,1,7,0,7
8419_1,,,,2,1,1,2
8421_0,,,,2,1,1,2
C(C1(C(CO)C(C(C1O)=O)O)O)=O,,,5,1,2,0,2
8421_1,,,,2,1,1,2
8423_0,,,,2,1,1,2
C1(C(C(C(C(C1CO)O)=O)O)O)=O,,,5,1,4,0,4
8423_1,,,,2,1,1,2
8425_0,,,,2,1,1,2
C(C1C(C(C(C(C1O)=O)O)O)O)=O,,,5,1,4,0,4
8425_1,,,,2,1,1,2
8427_0,,,,2,1,1,2
C(C(C1C(C(C(C1O)=O)O)O)O)=O,,,5,1,2,0,2
8427_1,,,,2,1,1,2
8429_0,,,,2,1,1,2
C(CO)(C1C(C(C(C1O)=O)O)O)=O,,,5,1,4,0,4
8429_1,,,,2,1,1,2
8431_0,,,,2,1,1,2
C(C1C(CO)(C(C(C1O)=O)O)O)=O,,,5,1,4,0,4
8431_1,,,,2,1,1,2
8432_0,,,,2,1,1,2
8432_1,,,,2,1,1,2
8434_0,,,,2,1,1,2
C1(C(C(C(C(C(C1)O)O)=O)O)O)=O,,,5,1,4,0,4
8434_1,,,,2,1,1,2
8436_0,,,,2,1,1,2
C(CC1(C(C(C(C1O)=O)O)O)O)=O,,,5,1,4,0,4
8436_1,,,,2,1,1,2
8437_0,,,,2,1,1,2
8437_1,,,,2,1,1,2
8439_0,,,,2,1,1,2
C1(CC(C(C(C(C1O)O)O)=O)O)=O,,,5,1,3,0,3
8439_1,,,,2,1,1,2
8441_0,,,,2,1,1,2
C(C(C1(CC(C(C1O)=O)O)O)O)=O,,,5,1,2,0,2
8441_1,,,,2,1,1,2
8443_0,,,,2,1,1,2
C1(C(C(CC1O)O)O)=O,,,5,1,3,0,3
8443_1,,,,2,1,1,2
8445_0,,,,2,1,1,2
C(C1(C(C(C(C1)=O)(CO)O)O)O)=O,,,5,1,4,0,4
8446_0,,,,2,1,1,2
8448_0,,,,2,1,1,2
C(C1(C(C(C(C1O)=O)(C)O)O)O)=O,,,5,1,2,0,2
8448_1,,,,2,1,1,2
8449_0,,,,2,1,1,2
8449_1,,,,2,1,1,2
8450_0,,,,2,1,1,2
8451_0,,,,2,1,1,2
8452_0,,,,2,1,1,2
8452_1,,,,2,1,1,2
8454_0,,,,2,1,1,2
C1(C(CO)C(C=O)(C(C1O)O)O)=O,,,5,1,5,0,5
8454_1,,,,2,1,1,2
8455_0,,,,2,1,1,2
8455_1,,,,2,1,1,2
8457_0,,,,2,1,1,2
C(C1C(C(C(C1(C=O)O)O)O)O)=O,,,5,1,3,0,3
8457_1,,,,2,1,1,2
8458_0,,,,2,1,1,2
8458_1,,,,2,1,1,2
8460_0,,,,2,1,1,2
C(C1(C(C(CC(C1O)=O)O)O)O)=O,,,5,1,7,0,7
8460_1,,,,2,1,1,2
8461_0,,,,2,1,1,2
8461_1,,,,2,1,1,2
8462_0,,,,2,1,1,2
8462_1,,,,2,1,1,2
8463_0,,,,2,1,1,2
8463_1,,,,2,1,1,2
8465_0,,,,2,1,1,2
C(C1(C(C(C(C(C1)=O)O)O)O)O)=O,,,5,1,4,0,4
8466_0,,,,2,1,1,2
8467_0,,,,2,1,1,2
8467_1,,,,2,1,1,2
8468_0,,,,2,1,1,2
8468_1,,,,2,1,1,2
8470_0,,,,2,1,1,2
C1(CC(C)(C(C1(CO)O)O)O)=O,,,5,1,4,0,4
8472_0,,,,2,1,1,2
C1(C(C(CO)(C(C)(C1)O)O)O)=O,,,5,1,4,0,4
8474_0,,,,2,1,1,2
C1(CC(CO)(CC1(CO)O)O)=O,,,5,1,1,0,1
8476_0,,,,2,1,1,2
C1(C(C(C)(C(CO)(C1)O)O)O)=O,,,5,1,3,0,3
8476_1,,,,2,1,1,2
8478_0,,,,2,1,1,2
C(C1(CC(C(C1)=O)(CO)O)O)(O)=O,,,5,1,1,0,1
8480_0,,,,2,1,1,2
C(C1C(CC(C1(CO)O)=O)O)(O)=O,,,5,1,2,0,2
8482_0,,,,2,1,1,2
C1(CC(CO)(C(C1(CO)O)O)O)=O,,,5,1,5,0,5
8484_0,,,,2,1,1,2
C1(C(C(CO)(C(C)(C1O)O)O)O)=O,,,5,1,5,0,5
8484_1,,,,2,1,1,2
8486_0,,,,2,1,1,2
C(C1(CC(C(C1)=O)(CO)O)O)=O,,,5,1,2,0,2
8488_0,,,,2,1,1,2
C1(CC(C(CC1(CO)O)=O)O)=O,,,5,1,4,0,4
8490_0,,,,2,1,1,2
C(C1C(CC(C1(CO)O)=O)O)=O,,,5,1,5,0,5
8492_0,,,,2,1,1,2
C1(CC(CC1(CO)O)O)=O,,,5,1,2,0,2
8493_0,,,,2,1,1,2
8495_0,,,,2,1,1,2
C1(C(C(C)(C(C1(C)O)O)O)O)=O,,,5,1,2,0,2
8495_1,,,,2,1,1,2
8496_0,,,,2,1,1,2
8498_0,,,,2,1,1,2
C1(C(C(CO)(CC1(C)O)O)O)=O,,,5,1,2,0,2
8498_1,,,,2,1,1,2
8499_0,,,,2,1,1,2
8499_1,,,,2,1,1,2
8501_0,,,,2,1,1,2
C(C1(CC(C(C1O)=O)(C)O)O)(O)=O,,,5,1,2,0,2
8501_1,,,,2,1,1,2
8503_0,,,,2,1,1,2
C(C1C(C(C(C1(C)O)=O)O)O)(O)=O,,,5,1,3,0,3
8503_1,,,,2,1,1,2
8505_0,,,,2,1,1,2
C1(C(C(CO)(C(C1(C)O)O)O)O)=O,,,5,1,4,0,4
8505_1,,,,2,1,1,2
8506_0,,,,2,1,1,2
8506_1,,,,2,1,1,2
8508_0,,,,2,1,1,2
C(C1(CC(C(C1O)=O)(C)O)O)=O,,,5,1,2,0,2
8508_1,,,,2,1,1,2
8510_0,,,,2,1,1,2
C1(C(C(C(C(C)(C1)O)=O)O)O)=O,,,5,1,3,0,3
8510_1,,,,2,1,1,2
8512_0,,,,2,1,1,2
C(C1C(C(C(C1(C)O)=O)O)O)=O,,,5,1,4,0,4
8512_1,,,,2,1,1,2
8514_0,,,,2,1,1,2
C1(C(C(CC1(C)O)O)O)=O,,,5,1,2,0,2
8514_1,,,,2,1,1,2
8516_0,,,,2,1,1,2
C1(C(C(C(C1(C)O)O)O)O)=O,,,5,1,4,0,4
8516_1,,,,2,1,1,2
8518_0,,,,2,1,1,2
C(C1(C(CC(C(C1O)=O)=O)O)O)=C,,,5,1,3,0,3
8520_0,,,,2,1,1,2
C(C1(C(C(C(C(C1)=O)=O)O)O)O)=C,,,5,1,3,0,3
8522_0,,,,2,1,1,2
C1C(C(C(C(CC(C=1)O)=O)=O)O)O,,,5,1,3,0,3
8524_0,,,,2,1,1,2
C1(C(C(C(C(C1)O)O)O)=O)=O,,,5,1,3,0,3
8526_0,,,,2,1,1,2
C1(C(C(C(C(C1)O)(C)O)O)=O)=O,,,5,1,4,0,4
8528_0,,,,2,1,1,2
C1(C(C(C(C(C)(C1)O)O)O)=O)=O,,,5,1,3,0,3
8529_0,,,,2,1,1,2
8530_0,,,,2,1,1,2
8532_0,,,,2,1,1,2
C1(C(C(C(CC(C1)O)O)O)=O)=O,,,5,1,4,0,4
8533_0,,,,2,1,1,2
8533_1,,,,2,1,1,2
8534_0,,,,2,1,1,2
8534_1,,,,2,1,1,2
8535_0,,,,2,1,1,2
8535_1,,,,2,1,1,2
8536_0,,,,2,1,1,2
8536_1,,,,2,1,1,2
8538_0,,,,2,1,1,2
C1C(C(C(C(CO)=O)=O)C(C=1)O)O,,,5,1,2,0,2
8538_1,,,,2,1,1,2
8539_0,,,,2,1,1,2
8539_1,,,,2,1,1,2
8540_0,,,,2,1,1,2
8540_1,,,,2,1,1,2
8541_0,,,,2,1,1,2
8541_1,,,,2,1,1,2
8542_0,,,,2,1,1,2
8544_0,,,,2,1,1,2
C(CO)(C1(CC(C(C1)=O)O)O)=O,,,5,1,2,0,2
8545_0,,,,2,1,1,2
8545_1,,,,2,1,1,2
8546_0,,,,2,1,1,2
8546_1,,,,2,1,1,2
8548_0,,,,2,1,1,2
C1(C(C(C(C1)O)(C(C)O)O)O)=O,,,5,1,3,0,3
8550_0,,,,2,1,1,2
C1(C(C(C(C(C)O)(C1)O)O)O)=O,,,5,1,3,0,3
8550_1,,,,2,1,1,2
8552_0,,,,2,1,1,2
C1(C(C(C(C1O)O)(C(C)O)O)O)=O,,,5,1,4,0,4
8552_1,,,,2,1,1,2
8553_0,,,,2,1,1,2
8554_0,,,,2,1,1,2
8554_1,,,,2,1,1,2
8555_0,,,,2,1,1,2
8555_1,,,,2,1,1,2
8557_0,,,,2,1,1,2
C1(C(C(C=C)(C(C1)O)O)O)=O,,,5,1,3,0,3
8559_0,,,,2,1,1,2
C1(CC(C=C)(C(C1O)O)O)=O,,,5,1,3,0,3
8561_0,,,,2,1,1,2
C1(CC(C=CC(C1O)O)O)=O,,,5,1,3,0,3
8563_0,,,,2,1,1,2
C1(C(C(C(C1)O)(C)O)O)=O,,,5,1,3,0,3
8565_0,,,,2,1,1,2
C1(C(C(C(C)(C1)O)O)O)=O,,,5,1,3,0,3
8567_0,,,,2,1,1,2
C1(C(C(C(C1)O)(CCO)O)O)=O,,,5,1,4,0,4
8569_0,,,,2,1,1,2
C1(C(C(C(CCO)(C1)O)O)O)=O,,,5,1,4,0,4
8571_0,,,,2,1,1,2
C1(C(C(C(C)(C1CO)O)O)O)=O,,,5,1,5,0,5
8571_1,,,,2,1,1,2
8573_0,,,,2,1,1,2
C1(C(C(CC(C(C1)O)O)O)O)=O,,,5,1,3,0,3
8575_0,,,,2,1,1,2
C1(C(C(CC(CO)(C1)O)O)O)=O,,,5,1,4,0,4
8577_0,,,,2,1,1,2
C1(C(C(C)(C(C(C1)O)O)O)O)=O,,,5,1,3,0,3
8577_1,,,,2,1,1,2
8579_0,,,,2,1,1,2
C1(C(C(CO)(CC(C1)O)O)O)=O,,,5,1,4,0,4
8581_0,,,,2,1,1,2
C1(C(C(C(C(C)(C1)O)O)O)O)=O,,,5,1,3,0,3
8582_0,,,,2,1,1,2
8583_0,,,,2,1,1,2
8583_1,,,,2,1,1,2
8584_0,,,,2,1,1,2
8584_1,,,,2,1,1,2
8585_0,,,,2,1,1,2
8585_1,,,,2,1,1,2
8587_0,,,,2,1,1,2
C(CO)(C1C(C=CC1O)O)=O,,,5,1,2,0,2
8587_1,,,,2,1,1,2
8588_0,,,,2,1,1,2
8588_1,,,,2,1,1,2
8589_0,,,,2,1,1,2
8589_1,,,,2,1,1,2
8591_0,,,,2,1,1,2
C1(C(CC(CO)(C1)O)O)=O,,,5,1,2,0,2
8592_0,,,,2,1,1,2
8592_1,,,,2,1,1,2
8593_0,,,,2,1,1,2
8593_1,,,,2,1,1,2
8595_0,,,,2,1,1,2
C1(C(CC(CO)(C1CO)O)O)=O,,,5,1,3,0,3
8595_1,,,,2,1,1,2
8596_0,,,,2,1,1,2
8596_1,,,,2,1,1,2
8598_0,,,,2,1,1,2
C(CO)(C1C(C(CC1O)O)O)=O,,,5,1,5,0,5
8598_1,,,,2,1,1,2
8600_0,,,,2,1,1,2
C(C1C(C(CC1(CO)O)O)O)=O,,,5,1,5,0,5
8600_1,,,,2,1,1,2
8601_0,,,,2,1,1,2
8601_1,,,,2,1,1,2
8602_0,,,,2,1,1,2
8602_1,,,,2,1,1,2
8603_0,,,,2,1,1,2
8603_1,,,,2,1,1,2
8604_0,,,,2,1,1,2
8604_1,,,,2,1,1,2
8605_0,,,,2,1,1,2
8605_1,,,,2,1,1,2
8607_0,,,,2,1,1,2
C1(C(C(C=C)(C(C1CO)O)O)O)=O,,,5,1,4,0,4
8607_1,,,,2,1,1,2
8609_0,,,,2,1,1,2
C1(C(CO)C(C=C)(C(C1O)O)O)=O,,,5,1,4,0,4
8609_1,,,,2,1,1,2
8611_0,,,,2,1,1,2
C1(C(C(C=CC(C1CO)O)O)O)=O,,,5,1,4,0,4
8611_1,,,,2,1,1,2
8613_0,,,,2,1,1,2
C1(C(C(C)(C(C1CO)O)O)O)=O,,,5,1,5,0,5
8613_1,,,,2,1,1,2
8614_0,,,,2,1,1,2
8614_1,,,,2,1,1,2
8615_0,,,,2,1,1,2
8615_1,,,,2,1,1,2
8616_0,,,,2,1,1,2
8616_1,,,,2,1,1,2
8617_0,,,,2,1,1,2
8617_1,,,,2,1,1,2
8618_0,,,,2,1,1,2
8618_1,,,,2,1,1,2
8619_0,,,,2,1,1,2
8619_1,,,,2,1,1,2
8621_0,,,,2,1,1,2
C1(C(C(CO)C(CO)(C1)O)O)=O,,,5,1,3,0,3
8623_0,,,,2,1,1,2
C(C1C(C=CC1O)O)(C(CO)O)=O,,,5,1,2,0,2
8623_1,,,,2,1,1,2
8625_0,,,,2,1,1,2
C1(C(CC(C(CO)O)(C1)O)O)=O,,,5,1,2,0,2
8627_0,,,,2,1,1,2
C1C(C(C(C(O)=O)=O)C(C=1)O)O,,,5,1,2,0,2
8627_1,,,,2,1,1,2
8629_0,,,,2,1,1,2
C(C1(CC(C(C1)=O)O)O)(O)=O,,,5,1,2,0,2
8631_0,,,,2,1,1,2
C1(C(CO)C(C(O)=O)(CC1O)O)=O,,,5,1,3,0,3
8631_1,,,,2,1,1,2
8633_0,,,,2,1,1,2
C(C(C1C(C(CC1O)O)O)=O)(O)=O,,,5,1,5,0,5
8633_1,,,,2,1,1,2
8635_0,,,,2,1,1,2
C(C1C(C(CC1(C(O)=O)O)O)O)=O,,,5,1,3,0,3
8635_1,,,,2,1,1,2
8636_0,,,,2,1,1,2
8636_1,,,,2,1,1,2
8638_0,,,,2,1,1,2
C(C1(CC(CC(C1O)=O)O)O)(O)=O,,,5,1,5,0,5
8638_1,,,,2,1,1,2
8640_0,,,,2,1,1,2
C(C1(CC(C(C(C1)=O)O)O)O)(O)=O,,,5,1,2,0,2
8642_0,,,,2,1,1,2
C(C1C(CC(C1O)=O)O)(O)=O,,,5,1,3,0,3
8644_0,,,,2,1,1,2
C(C1C(C(C(C1O)=O)CO)O)(O)=O,,,5,1,4,0,4
8644_1,,,,2,1,1,2
8646_0,,,,2,1,1,2
C(C1C(C(C=O)C(C1O)O)O)(O)=O,,,5,1,7,0,7
8646_1,,,,2,1,1,2
8648_0,,,,2,1,1,2
C(C1C(CC(C(C1O)O)=O)O)(O)=O,,,5,1,6,0,6
8648_1,,,,2,1,1,2
8649_0,,,,2,1,1,2
8651_0,,,,2,1,1,2
C(C1(C(CO)C(C(C1)=O)O)O)(O)=O,,,5,1,2,0,2
8653_0,,,,2,1,1,2
C(C1C(C(C(C1O)O)O)=O)(O)=O,,,5,1,7,0,7
8653_1,,,,2,1,1,2
8655_0,,,,2,1,1,2
C(C1C(C(C(C1(C)O)O)O)=O)(O)=O,,,5,1,5,0,5
8655_1,,,,2,1,1,2
8657_0,,,,2,1,1,2
C(C1C(C(C(C)(C1O)O)O)=O)(O)=O,,,5,1,5,0,5
8657_1,,,,2,1,1,2
8659_0,,,,2,1,1,2
C(C1C(CO)(CC(C1O)=O)O)(O)=O,,,5,1,3,0,3
8661_0,,,,2,1,1,2
C(C1C(C(C(CC1O)O)O)=O)(O)=O,,,5,1,7,0,7
8661_1,,,,2,1,1,2
8662_0,,,,2,1,1,2
8662_1,,,,2,1,1,2
8663_0,,,,2,1,1,2
8663_1,,,,2,1,1,2
8664_0,,,,2,1,1,2
8664_1,,,,2,1,1,2
8666_0,,,,2,1,1,2
C(CC1(C(C(C(C1)=O)O)O)O)(O)=O,,,5,1,2,0,2
8667_0,,,,2,1,1,2
8667_1,,,,2,1,1,2
8669_0,,,,2,1,1,2
C1(C(CC(C(C(O)=O)O)(C1)O)O)=O,,,5,1,2,0,2
8671_0,,,,2,1,1,2
C(C1(C(C(CO)C(C1O)O)=O)O)=O,,,5,1,6,0,6
8671_1,,,,2,1,1,2
8672_0,,,,2,1,1,2
8672_1,,,,2,1,1,2
8674_0,,,,2,1,1,2
C1(CC(CC(C1(C(C)O)O)O)O)=O,,,5,1,5,0,5
8676_0,,,,2,1,1,2
C1(CC(CC(C1(CO)O)O)O)=O,,,5,1,6,0,6
8678_0,,,,2,1,1,2
C1(CC(C(C(C1(CO)O)O)O)O)=O,,,5,1,5,0,5
8680_0,,,,2,1,1,2
C(C1C(CC(C1(C(C)O)O)O)O)=O,,,5,1,2,0,2
8680_1,,,,2,1,1,2
8682_0,,,,2,1,1,2
C(C1C(C(CC1O)(C(C)O)O)O)=O,,,5,1,4,0,4
8682_1,,,,2,1,1,2
8683_0,,,,2,1,1,2
8683_1,,,,2,1,1,2
8685_0,,,,2,1,1,2
C(C1C(CC(C1(CO)O)O)O)=O,,,5,1,3,0,3
8685_1,,,,2,1,1,2
8687_0,,,,2,1,1,2
C(C1C(C(CO)(CC1O)O)O)=O,,,5,1,5,0,5
8687_1,,,,2,1,1,2
8688_0,,,,2,1,1,2
8688_1,,,,2,1,1,2
8689_0,,,,2,1,1,2
8689_1,,,,2,1,1,2
8690_0,,,,2,1,1,2
8690_1,,,,2,1,1,2
8691_0,,,,2,1,1,2
8691_1,,,,2,1,1,2
8692_0,,,,2,1,1,2
8692_1,,,,2,1,1,2
8694_0,,,,2,1,1,2
C1(C(C2C(C(CO2)O)(C1)O)O)=O,,,5,1,1,0,1
8696_0,,,,2,1,1,2
C1(C(C2COC(C2(C1)O)O)O)=O,,,5,1,2,0,2
8698_0,,,,2,1,1,2
C1(C2C(C(C=C)(C1C(O2)O)O)O)=O,,,5,1,4,0,4
8698_1,,,,2,1,1,2
8700_0,,,,2,1,1,2
C1(C2C(C=C)(C(C1C(O2)O)O)O)=O,,,5,1,4,0,4
8700_1,,,,2,1,1,2
8702_0,,,,2,1,1,2
C1(C2C(C=CC(C1C(O2)O)O)O)=O,,,5,1,4,0,4
8702_1,,,,2,1,1,2
8704_0,,,,2,1,1,2
C1(C2C(C(C1C(O2)O)O)O)=O,,,5,1,6,0,6
8704_1,,,,2,1,1,2
8706_0,,,,2,1,1,2
C1(C2C(C(C)(C1C(O2)O)O)O)=O,,,5,1,6,0,6
8706_1,,,,2,1,1,2
8708_0,,,,2,1,1,2
C1(C2C(C)(C(C1C(O2)O)O)O)=O,,,5,1,6,0,6
8708_1,,,,2,1,1,2
8710_0,,,,2,1,1,2
C1(C(C2C(O)OCC2(C1)O)O)=O,,,5,1,2,0,2
8712_0,,,,2,1,1,2
C1(C2C(CC(C1C(O2)O)O)O)=O,,,5,1,6,0,6
8712_1,,,,2,1,1,2
8713_0,,,,2,1,1,2
8713_1,,,,2,1,1,2
8714_0,,,,2,1,1,2
8714_1,,,,2,1,1,2
8715_0,,,,2,1,1,2
8715_1,,,,2,1,1,2
8716_0,,,,2,1,1,2
8716_1,,,,2,1,1,2
8717_0,,,,2,1,1,2
8717_1,,,,2,1,1,2
8718_0,,,,2,1,1,2
8718_1,,,,2,1,1,2
8720_0,,,,2,1,1,2
C1(C(C2C(CC(O)O2)(C1)O)O)=O,,,5,1,2,0,2
8721_0,,,,2,1,1,2
8721_1,,,,2,1,1,2
8723_0,,,,2,1,1,2
C1(C(C(C=C)(C(C1O)O)O)O)=O,,,5,1,5,0,5
8723_1,,,,2,1,1,2
8725_0,,,,2,1,1,2
C1(C(C(C(C=C)(C1C=O)O)O)O)=O,,,5,1,4,0,4
8725_1,,,,2,1,1,2
8727_0,,,,2,1,1,2
C(C1C(C(C(C=C)(C1O)O)O)=O)=O,,,5,1,4,0,4
8727_1,,,,2,1,1,2
8728_0,,,,2,1,1,2
8728_1,,,,2,1,1,2
8729_0,,,,2,1,1,2
8729_1,,,,2,1,1,2
8730_0,,,,2,1,1,2
8730_1,,,,2,1,1,2
8732_0,,,,2,1,1,2
C1(C(C(C=CC(C1O)O)O)O)=O,,,5,1,3,0,3
8732_1,,,,2,1,1,2
8734_0,,,,2,1,1,2
C1C(C(C(C=O)=O)C(C=1)O)O,,,5,1,3,0,3
8734_1,,,,2,1,1,2
8736_0,,,,2,1,1,2
C(C1C(C(C(C=CC1O)O)O)=O)=O,,,5,1,4,0,4
8736_1,,,,2,1,1,2
8737_0,,,,2,1,1,2
8737_1,,,,2,1,1,2
8739_0,,,,2,1,1,2
C(C(C(C1C(C=CC1O)O)=O)O)=O,,,5,1,2,0,2
8739_1,,,,2,1,1,2
8741_0,,,,2,1,1,2
C(C1C(C=CC1O)O)=O,,,5,1,3,0,3
8741_1,,,,2,1,1,2
8743_0,,,,2,1,1,2
C1(C(C(C(C1O)O)O)=O)=O,,,5,1,2,0,2
8743_1,,,,2,1,1,2
8745_0,,,,2,1,1,2
C1(C(C(C(C1(C)O)O)O)=O)=O,,,5,1,2,0,2
8745_1,,,,2,1,1,2
8747_0,,,,2,1,1,2
C1(C(C(C(C)(C1O)O)O)=O)=O,,,5,1,2,0,2
8747_1,,,,2,1,1,2
8749_0,,,,2,1,1,2
C1(C(CO)(CC(C1O)=O)O)=O,,,5,1,2,0,2
8751_0,,,,2,1,1,2
C1(C(C(CC(C1O)O)O)=O)=O,,,5,1,3,0,3
8751_1,,,,2,1,1,2
8753_0,,,,2,1,1,2
C1(C(CC(C1O)=O)O)=O,,,5,1,3,0,3
8755_0,,,,2,1,1,2
C1(C(CO)C(C(C1O)=O)O)=O,,,5,1,2,0,2
8755_1,,,,2,1,1,2
8756_0,,,,2,1,1,2
8756_1,,,,2,1,1,2
8757_0,,,,2,1,1,2
8757_1,,,,2,1,1,2
8759_0,,,,2,1,1,2
C1(C(C(C(C1)=O)O)O)=O,,,5,1,4,0,4
8759_1,,,,2,1,1,2
8761_0,,,,2,1,1,2
C1(CC(C(C1)=O)O)=O,,,5,1,4,0,4
8763_0,,,,2,1,1,2
C1(C(C(C(C(C1O)O)O)O)O)=O,,,5,1,2,0,2
8763_1,,,,2,1,1,2
8765_0,,,,2,1,1,2
C1(C(C(C(C1CO)=O)O)O)=O,,,5,1,3,0,3
8765_1,,,,2,1,1,2
8766_0,,,,2,1,1,2
8766_1,,,,2,1,1,2
8768_0,,,,2,1,1,2
C1(CC(C(C(C1O)=O)O)O)=O,,,5,1,2,0,2
8768_1,,,,2,1,1,2
8770_0,,,,2,1,1,2
C1(C(C(C(C(C1)=O)O)O)O)=O,,,5,1,2,0,2
8770_1,,,,2,1,1,2
8772_0,,,,2,1,1,2
C1(C(C(C(C)(C(C1O)O)O)O)O)=O,,,5,1,3,0,3
8772_1,,,,2,1,1,2
8774_0,,,,2,1,1,2
C(C1C(C(C(C1O)=O)(C)O)O)=O,,,5,1,6,0,6
8774_1,,,,2,1,1,2
8776_0,,,,2,1,1,2
C1(CC(CC(C(C1O)=O)O)O)=O,,,5,1,2,0,2
8778_0,,,,2,1,1,2
C(C1C(C)(C(C(C1O)=O)O)O)=O,,,5,1,3,0,3
8778_1,,,,2,1,1,2
8780_0,,,,2,1,1,2
C(C1(C(CC(C(C1)=O)O)O)O)=O,,,5,1,2,0,2
8782_0,,,,2,1,1,2
C1(CC(C(C(CC1O)O)=O)O)=O,,,5,1,2,0,2
8784_0,,,,2,1,1,2
C(C1C(CC(C(C1O)=O)O)O)=O,,,5,1,6,0,6
8784_1,,,,2,1,1,2
8785_0,,,,2,1,1,2
8785_1,,,,2,1,1,2
8786_0,,,,2,1,1,2
8786_1,,,,2,1,1,2
8788_0,,,,2,1,1,2
C1(C(C(C(CC1O)O)O)O)=O,,,5,1,4,0,4
8788_1,,,,2,1,1,2
8790_0,,,,2,1,1,2
C1(C(C(CC1(CO)O)O)O)=O,,,5,1,2,0,2
8790_1,,,,2,1,1,2
8791_0,,,,2,1,1,2
8793_0,,,,2,1,1,2
C1(C(C(C(CO)(C1(C)O)O)O)O)=O,,,5,1,3,0,3
8793_1,,,,2,1,1,2
8795_0,,,,2,1,1,2
C(C1(C(C(C(C1)O)O)=O)O)=O,,,5,1,2,0,2
8795_1,,,,2,1,1,2
8797_0,,,,2,1,1,2
C1(C(C(CO)C(C(C1)O)O)O)=O,,,5,1,2,0,2
8799_0,,,,2,1,1,2
C1(CC(C(C)(C1(CO)O)O)O)=O,,,5,1,4,0,4
8801_0,,,,2,1,1,2
C(C1C(C(CC(C1O)=O)O)O)(O)=O,,,5,1,3,0,3
8802_0,,,,2,1,1,2
8802_1,,,,2,1,1,2
8804_0,,,,2,1,1,2
C(C1(C(CC(C1O)O)=O)O)(O)=O,,,5,1,6,0,6
8806_0,,,,2,1,1,2
C(C1(C(CC(C1(C)O)O)=O)O)(O)=O,,,5,1,4,0,4
8808_0,,,,2,1,1,2
C(C1(C(C)(CC(C1O)=O)O)O)(O)=O,,,5,1,4,0,4
8810_0,,,,2,1,1,2
C(C1(C(CC(C)(C1O)O)=O)O)(O)=O,,,5,1,4,0,4
8812_0,,,,2,1,1,2
C(C1(C(CC(CC1O)O)=O)O)(O)=O,,,5,1,6,0,6
8813_0,,,,2,1,1,2
8815_0,,,,2,1,1,2
C(CC1(C(CC(C1O)=O)O)O)(O)=O,,,5,1,2,0,2
8817_0,,,,2,1,1,2
C(C1C(C(C(O)=O)(CC1O)O)O)=O,,,5,1,4,0,4
8817_1,,,,2,1,1,2
8819_0,,,,2,1,1,2
C(C1C(CC(C1(C(O)=O)O)O)O)=O,,,5,1,4,0,4
8819_1,,,,2,1,1,2
8821_0,,,,2,1,1,2
C1(C(C(C(C1(C(C)O)O)O)O)O)=O,,,5,1,6,0,6
8821_1,,,,2,1,1,2
8823_0,,,,2,1,1,2
C(C1(C(C(C(C1O)O)O)=O)CO)=O,,,5,1,4,0,4
8823_1,,,,2,1,1,2
8825_0,,,,2,1,1,2
C(C1C(C(CO)(C(C1O)O)O)=O)=O,,,5,1,6,0,6
8825_1,,,,2,1,1,2
8827_0,,,,2,1,1,2
C1(C(C(C(C1)O)(C(C=O)O)O)O)=O,,,5,1,1,0,1
8828_0,,,,2,1,1,2
8830_0,,,,2,1,1,2
C(C1C(C(C=O)(C(C1O)O)O)O)=O,,,5,1,6,0,6
8830_1,,,,2,1,1,2
8832_0,,,,2,1,1,2
C(C1(C(CC(C1O)=O)O)C(C)O)=O,,,5,1,3,0,3
8834_0,,,,2,1,1,2
C(C1(CO)C(CC(C1O)=O)O)=O,,,5,1,4,0,4
8836_0,,,,2,1,1,2
C1(C(C(C(C1)O)O)(C(C=O)O)O)=O,,,5,1,5,0,5
8838_0,,,,2,1,1,2
C1(CC(C(C1(C(C)O)O)O)O)=O,,,5,1,5,0,5
8840_0,,,,2,1,1,2
C1(CC(C(C1(C(CO)O)O)O)O)=O,,,5,1,5,0,5
8842_0,,,,2,1,1,2
C(C1(CO)C(C(C(C1O)=O)O)O)=O,,,5,1,3,0,3
8842_1,,,,2,1,1,2
8844_0,,,,2,1,1,2
C1(C(CO)(C(C(C1CO)O)O)O)=O,,,5,1,8,0,8
8844_1,,,,2,1,1,2
8846_0,,,,2,1,1,2
C1(CC(C(CO)(C1(CO)O)O)O)=O,,,5,1,5,0,5
8848_0,,,,2,1,1,2
C1(C2C(C(CO)(C1(CO2)O)O)O)=O,,,5,1,4,0,4
8848_1,,,,2,1,1,2
8850_0,,,,2,1,1,2
C(C1(C(CC(C1(CO)O)O)=O)O)=O,,,5,1,3,0,3
8852_0,,,,2,1,1,2
C1(C(C2(COCC2(C1O)O)O)O)=O,,,5,1,2,0,2
8852_1,,,,2,1,1,2
8854_0,,,,2,1,1,2
C1(C2C(CO)(C(C1(CO2)O)O)O)=O,,,5,1,4,0,4
8854_1,,,,2,1,1,2
8855_0,,,,2,1,1,2
8855_1,,,,2,1,1,2
8857_0,,,,2,1,1,2
C(C1(C(C)(C(C(C1O)=O)O)O)O)=O,,,5,1,6,0,6
8857_1,,,,2,1,1,2
8859_0,,,,2,1,1,2
C(C1(C(CC(CO)(C1O)O)=O)O)=O,,,5,1,3,0,3
8861_0,,,,2,1,1,2
C(C1(C(CO)(C(C(C1)=O)O)O)O)=O,,,5,1,1,0,1
8863_0,,,,2,1,1,2
C1(C(C(C(C(C1)O)=O)(CO)O)O)=O,,,5,1,3,0,3
8865_0,,,,2,1,1,2
C(C1C(C(C(C1O)=O)(CO)O)O)=O,,,5,1,4,0,4
8865_1,,,,2,1,1,2
8867_0,,,,2,1,1,2
C1(C(CO)(C(C=C)(C(C1)O)O)O)=O,,,5,1,3,0,3
8869_0,,,,2,1,1,2
C1(CC(C=C)(C(C1(CO)O)O)O)=O,,,5,1,3,0,3
8871_0,,,,2,1,1,2
C1(CC(C=CC(C1(CO)O)O)O)=O,,,5,1,3,0,3
8873_0,,,,2,1,1,2
C1(C2(COC1C(C2(C=C)O)O)O)=O,,,5,1,4,0,4
8873_1,,,,2,1,1,2
8875_0,,,,2,1,1,2
C1(C2C(C=C)(C(C1(CO2)O)O)O)=O,,,5,1,4,0,4
8875_1,,,,2,1,1,2
8877_0,,,,2,1,1,2
C1(C2C(C=CC(C1(CO2)O)O)O)=O,,,5,1,4,0,4
8877_1,,,,2,1,1,2
8879_0,,,,2,1,1,2
C1(C2C(C(C1(CO2)O)O)O)=O,,,5,1,4,0,4
8879_1,,,,2,1,1,2
8881_0,,,,2,1,1,2
C1(C2C(C(C)(C1(CO2)O)O)O)=O,,,5,1,4,0,4
8881_1,,,,2,1,1,2
8883_0,,,,2,1,1,2
C1(C2C(C)(C(C1(CO2)O)O)O)=O,,,5,1,4,0,4
8883_1,,,,2,1,1,2
8885_0,,,,2,1,1,2
C1(C(C2(COCC2(C1)O)O)O)=O,,,5,1,1,0,1
8887_0,,,,2,1,1,2
C1(C2C(CC(C1(CO2)O)O)O)=O,,,5,1,4,0,4
8887_1,,,,2,1,1,2
8889_0,,,,2,1,1,2
C1(CC(C(C=C)(C1(C=O)O)O)O)=O,,,5,1,3,0,3
8891_0,,,,2,1,1,2
C(C1(C(CC(C=C)(C1O)O)=O)O)=O,,,5,1,3,0,3
8893_0,,,,2,1,1,2
C(C1(C(CC(C=CC1O)O)=O)O)=O,,,5,1,3,0,3
8895_0,,,,2,1,1,2
C1(CC2(CC1(C(C2O)O)O)O)=O,,,5,1,2,0,2
8897_0,,,,2,1,1,2
C(C1(CC(C(C1)=O)(C(C)O)O)O)=O,,,5,1,2,0,2
8899_0,,,,2,1,1,2
C1(CC(C(CC1(C(C)O)O)=O)O)=O,,,5,1,2,0,2
8901_0,,,,2,1,1,2
C(C1C(CC(C1(C(C)O)O)=O)O)=O,,,5,1,2,0,2
8903_0,,,,2,1,1,2
C1(CC(CC1(C(CCO)O)O)O)=O,,,5,1,2,0,2
8905_0,,,,2,1,1,2
C1(CC(CC1(C(CO)(C)O)O)O)=O,,,5,1,2,0,2
8907_0,,,,2,1,1,2
C1(C(CC(C1)O)(C(C(O)=O)O)O)=O,,,5,1,2,0,2
8909_0,,,,2,1,1,2
C1(C(C(C(C1)O)O)(CC=O)O)=O,,,5,1,2,0,2
8911_0,,,,2,1,1,2
C1(C(CC(C1)O)(C(C=O)O)O)=O,,,5,1,2,0,2
8913_0,,,,2,1,1,2
C1(C(C(C(C1)O)(C)O)(CC=O)O)=O,,,5,1,2,0,2
8915_0,,,,2,1,1,2
C1(C(CC(C1)O)(C(C=O)(C)O)O)=O,,,5,1,2,0,2
8917_0,,,,2,1,1,2
C1(C(C(C(C)(C1)O)O)(CC=O)O)=O,,,5,1,2,0,2
8919_0,,,,2,1,1,2
C(C)(C1(CC(CC(C1O)=O)O)O)=O,,,5,1,2,0,2
8921_0,,,,2,1,1,2
C1(C(CC(C1)O)(C(C(C)=O)O)O)=O,,,5,1,2,0,2
8923_0,,,,2,1,1,2
C(CC1(C(C)(CC(C1O)=O)O)O)=O,,,5,1,1,0,1
8925_0,,,,2,1,1,2
C(C1C(CC(C1(C(C)=O)O)O)O)=O,,,5,1,3,0,3
8925_1,,,,2,1,1,2
8927_0,,,,2,1,1,2
C1(C(C(CC(C1)O)O)(CC=O)O)=O,,,5,1,2,0,2
8929_0,,,,2,1,1,2
C(C1C(C(C(C)=O)(CC1O)O)O)=O,,,5,1,3,0,3
8929_1,,,,2,1,1,2
8931_0,,,,2,1,1,2
C1(CC(CC1(C(CC=O)O)O)O)=O,,,5,1,2,0,2
8933_0,,,,2,1,1,2
C1(CC(CC1(C(C)O)O)O)=O,,,5,1,2,0,2
8935_0,,,,2,1,1,2
C1(CC(CC1(C(CO)O)O)O)=O,,,5,1,2,0,2
8937_0,,,,2,1,1,2
C1(C(C(C)O)(CC(C1CO)O)O)=O,,,5,1,3,0,3
8937_1,,,,2,1,1,2
8939_0,,,,2,1,1,2
C1(C(CO)(CC(C1CO)O)O)=O,,,5,1,3,0,3
8939_1,,,,2,1,1,2
8941_0,,,,2,1,1,2
C1(C2(C(CO)(C(C1CO2)O)O)O)=O,,,5,1,3,0,3
8941_1,,,,2,1,1,2
8942_0,,,,2,1,1,2
8942_1,,,,2,1,1,2
8943_0,,,,2,1,1,2
8943_1,,,,2,1,1,2
8945_0,,,,2,1,1,2
C1(C(C2(C(C1O)(O)OCC2)O)O)=O,,,5,1,2,0,2
8945_1,,,,2,1,1,2
8947_0,,,,2,1,1,2
C1(C2(C(C(CO)(C1CO2)O)O)O)=O,,,5,1,3,0,3
8947_1,,,,2,1,1,2
8948_0,,,,2,1,1,2
8948_1,,,,2,1,1,2
8950_0,,,,2,1,1,2
C(C1(CC(C(C(C1O)=O)O)O)O)=O,,,5,1,3,0,3
8950_1,,,,2,1,1,2
8952_0,,,,2,1,1,2
C(C1(C(C)(C(C(C1)=O)O)O)O)=O,,,5,1,3,0,3
8954_0,,,,2,1,1,2
C1(C(C(C(C(C1)O)=O)(C)O)O)=O,,,5,1,2,0,2
8955_0,,,,2,1,1,2
8955_1,,,,2,1,1,2
8956_0,,,,2,1,1,2
8956_1,,,,2,1,1,2
8958_0,,,,2,1,1,2
C1(C(C(C(C(C=O)O)(C1)O)O)O)=O,,,5,1,2,0,2
8958_1,,,,2,1,1,2
8960_0,,,,2,1,1,2
C1(C2(C(C=C)(C(C1CO2)O)O)O)=O,,,5,1,3,0,3
8960_1,,,,2,1,1,2
8962_0,,,,2,1,1,2
C1(C2(C(C(C=C)(C1CO2)O)O)O)=O,,,5,1,3,0,3
8962_1,,,,2,1,1,2
8964_0,,,,2,1,1,2
C1(C2(C(C=CC(C1CO2)O)O)O)=O,,,5,1,3,0,3
8964_1,,,,2,1,1,2
8966_0,,,,2,1,1,2
C1(C2(C(C(C1CO2)O)O)O)=O,,,5,1,3,0,3
8966_1,,,,2,1,1,2
8968_0,,,,2,1,1,2
C1(C2(C(C)(C(C1CO2)O)O)O)=O,,,5,1,3,0,3
8968_1,,,,2,1,1,2
8970_0,,,,2,1,1,2
C1(C2(C(C(C)(C1CO2)O)O)O)=O,,,5,1,3,0,3
8970_1,,,,2,1,1,2
8972_0,,,,2,1,1,2
C1(C(C2(C(CCO2)(C1)O)O)O)=O,,,5,1,1,0,1
8974_0,,,,2,1,1,2
C1(C2(C(CC(C1CO2)O)O)O)=O,,,5,1,3,0,3
8974_1,,,,2,1,1,2
8976_0,,,,2,1,1,2
C(C1(C(C=CC(C1C=O)O)O)O)=O,,,5,1,3,0,3
8976_1,,,,2,1,1,2
8978_0,,,,2,1,1,2
C1(C(C(C(C1)O)O)=O)=O,,,5,1,3,0,3
8978_1,,,,2,1,1,2
8980_0,,,,2,1,1,2
C(C1C(C(CC1O)=O)=O)=O,,,5,1,4,0,4
8980_1,,,,2,1,1,2
8982_0,,,,2,1,1,2
C(C1C(CC(C1O)=O)=O)=O,,,5,1,4,0,4
8982_1,,,,2,1,1,2
8984_0,,,,2,1,1,2
C(C1C(C(C(C1CO)O)O)=O)=O,,,5,1,2,0,2
8984_1,,,,2,1,1,2
8986_0,,,,2,1,1,2
C(C1C(C(C(CO)C1O)O)=O)=O,,,5,1,3,0,3
8986_1,,,,2,1,1,2
8988_0,,,,2,1,1,2
C1(C(C(C(C1C)O)O)=O)=O,,,5,1,3,0,3
8988_1,,,,2,1,1,2
8990_0,,,,2,1,1,2
C1(C(C)(C(C(C1)=O)O)O)=O,,,5,1,4,0,4
8990_1,,,,2,1,1,2
8992_0,,,,2,1,1,2
C1(C(CC(CO)(C1)O)=O)=O,,,5,1,2,0,2
8994_0,,,,2,1,1,2
C1(C(C(C(C)(C1)O)O)=O)=O,,,5,1,3,0,3
8994_1,,,,2,1,1,2
8996_0,,,,2,1,1,2
C1(C(CO)(CC(C1)=O)O)=O,,,5,1,3,0,3
8998_0,,,,2,1,1,2
C1(CC(C(C(C1)=O)O)O)=O,,,5,1,5,0,5
8998_1,,,,2,1,1,2
9000_0,,,,2,1,1,2
C1(C(C(C(CC1)O)O)=O)=O,,,5,1,3,0,3
9000_1,,,,2,1,1,2
9002_0,,,,2,1,1,2
C1(C(C(C(C1CCO)O)O)=O)=O,,,5,1,3,0,3
9002_1,,,,2,1,1,2
9004_0,,,,2,1,1,2
C1(C(CCO)(C(C(C1)=O)O)O)=O,,,5,1,4,0,4
9004_1,,,,2,1,1,2
9006_0,,,,2,1,1,2
C1(C(CC(CO)(C1CO)O)=O)=O,,,5,1,5,0,5
9006_1,,,,2,1,1,2
9008_0,,,,2,1,1,2
C1(C(C(C(CCO)(C1)O)O)=O)=O,,,5,1,3,0,3
9008_1,,,,2,1,1,2
9010_0,,,,2,1,1,2
C1(C(CO)C(C(C1)=O)(CO)O)=O,,,5,1,3,0,3
9010_1,,,,2,1,1,2
9012_0,,,,2,1,1,2
C(CC1(CC(C(C1O)=O)O)O)=O,,,5,1,3,0,3
9012_1,,,,2,1,1,2
9014_0,,,,2,1,1,2
C1(CC(C(C(C(C1)O)O)=O)O)=O,,,5,1,3,0,3
9014_1,,,,2,1,1,2
9016_0,,,,2,1,1,2
C(C1C(CC(C1(CO)O)O)=O)=O,,,5,1,3,0,3
9016_1,,,,2,1,1,2
9018_0,,,,2,1,1,2
C1(CCC(C(C(C1O)=O)O)O)=O,,,5,1,3,0,3
9018_1,,,,2,1,1,2
9020_0,,,,2,1,1,2
C(C1C(CO)(C(C(C1)=O)O)O)=O,,,5,1,5,0,5
9022_0,,,,2,1,1,2
C1(C(CC(C1C(CO)=O)O)O)=O,,,5,1,4,0,4
9022_1,,,,2,1,1,2
9024_0,,,,2,1,1,2
C1(C(C(CC(C(C1)=O)O)O)O)=O,,,5,1,4,0,4
9024_1,,,,2,1,1,2
9025_0,,,,2,1,1,2
9025_1,,,,2,1,1,2
9027_0,,,,2,1,1,2
C1(CC(C(C1C(CO)=O)O)O)=O,,,5,1,3,0,3
9027_1,,,,2,1,1,2
9029_0,,,,2,1,1,2
C1(CC(C(C(C(C1)=O)O)O)O)=O,,,5,1,3,0,3
9029_1,,,,2,1,1,2
9031_0,,,,2,1,1,2
C1(C(C(C(C(CC1)O)O)O)=O)=O,,,5,1,3,0,3
9031_1,,,,2,1,1,2
9033_0,,,,2,1,1,2
C1(CC(CO)(C(C(C1)=O)O)O)=O,,,5,1,6,0,6
9033_1,,,,2,1,1,2
9035_0,,,,2,1,1,2
C1(C(C(C(CC1)(CO)O)O)=O)=O,,,5,1,3,0,3
9035_1,,,,2,1,1,2
9037_0,,,,2,1,1,2
C1(CCC(C(C1(CO)O)O)=O)=O,,,5,1,5,0,5
9037_1,,,,2,1,1,2
9039_0,,,,2,1,1,2
C(CO)(C1(CCC(C1O)=O)O)=O,,,5,1,4,0,4
9039_1,,,,2,1,1,2
9041_0,,,,2,1,1,2
C(C1CC(C(C(C1O)=O)O)O)=O,,,5,1,4,0,4
9041_1,,,,2,1,1,2
9043_0,,,,2,1,1,2
C(CC1C(C(C(C1O)=O)O)O)=O,,,5,1,4,0,4
9043_1,,,,2,1,1,2
9045_0,,,,2,1,1,2
C1(C(C(C(CC1CO)O)O)=O)=O,,,5,1,3,0,3
9045_1,,,,2,1,1,2
9047_0,,,,2,1,1,2
C(C)(C1(CC(C(C1O)=O)O)O)=O,,,5,1,4,0,4
9047_1,,,,2,1,1,2
9049_0,,,,2,1,1,2
C1(CC(C(C(C1(C)O)O)=O)O)=O,,,5,1,3,0,3
9049_1,,,,2,1,1,2
9051_0,,,,2,1,1,2
C1(C(CC(CO)(C(C1)O)O)=O)=O,,,5,1,4,0,4
9053_0,,,,2,1,1,2
C1(CC(C)(C(C(C1O)=O)O)O)=O,,,5,1,3,0,3
9053_1,,,,2,1,1,2
9054_0,,,,2,1,1,2
9056_0,,,,2,1,1,2
C1(C(C(C)(C(C(C1)=O)O)O)O)=O,,,5,1,3,0,3
9056_1,,,,2,1,1,2
9058_0,,,,2,1,1,2
C1(CC(CO)(CC(C1O)=O)O)=O,,,5,1,2,0,2
9060_0,,,,2,1,1,2
C(C1(C(C)C(C(C1O)=O)O)O)=O,,,5,1,2,0,2
9060_1,,,,2,1,1,2
9062_0,,,,2,1,1,2
C1(C(C(C(C(C1C)O)=O)O)O)=O,,,5,1,3,0,3
9062_1,,,,2,1,1,2
9064_0,,,,2,1,1,2
C1(C(C(C(C(C1C)O)O)O)=O)=O,,,5,1,3,0,3
9064_1,,,,2,1,1,2
9066_0,,,,2,1,1,2
C(C1(CC(C(C1O)=O)CO)O)=O,,,5,1,2,0,2
9066_1,,,,2,1,1,2
9068_0,,,,2,1,1,2
C1(C(C(C(C(CO)C1)=O)O)O)=O,,,5,1,5,0,5
9068_1,,,,2,1,1,2
9070_0,,,,2,1,1,2
C1(C(CO)C(C=O)C(C1O)O)=O,,,5,1,4,0,4
9070_1,,,,2,1,1,2
9072_0,,,,2,1,1,2
C1(C(C(CC1CO)O)O)=O,,,5,1,2,0,2
9072_1,,,,2,1,1,2
9074_0,,,,2,1,1,2
C1(C(CC(C(CO)O)(C1)O)=O)=O,,,5,1,2,0,2
9076_0,,,,2,1,1,2
C1(C(C(CO)O)(CC(C1)=O)O)=O,,,5,1,2,0,2
9078_0,,,,2,1,1,2
C(C1C(C(C(C)C1O)=O)=O)=O,,,5,1,3,0,3
9078_1,,,,2,1,1,2
9080_0,,,,2,1,1,2
C(C)(C1C(C(CC1O)=O)=O)=O,,,5,1,4,0,4
9080_1,,,,2,1,1,2
9082_0,,,,2,1,1,2
C1(CC(CC(C(C1)=O)=O)O)=O,,,5,1,3,0,3
9084_0,,,,2,1,1,2
C(CC1(C(CC(C1)=O)=O)O)=O,,,5,1,2,0,2
9086_0,,,,2,1,1,2
C(C1C(C(CC1(C)O)=O)=O)=O,,,5,1,5,0,5
9086_1,,,,2,1,1,2
9087_0,,,,2,1,1,2
9089_0,,,,2,1,1,2
C(CC1(CC(C(C1)=O)=O)O)=O,,,5,1,2,0,2
9091_0,,,,2,1,1,2
C1(C(C=O)C(C(C1)=O)(C)O)=O,,,5,1,3,0,3
9091_1,,,,2,1,1,2
9093_0,,,,2,1,1,2
C1(C(CC(C1)O)=O)=O,,,5,1,2,0,2
9095_0,,,,2,1,1,2
C1(CC(C(C=O)=O)C(C1)O)=O,,,5,1,3,0,3
9097_0,,,,2,1,1,2
C1(CCC(C=O)(C1C=O)O)=O,,,5,1,3,0,3
9097_1,,,,2,1,1,2
9099_0,,,,2,1,1,2
C(C1C(CCC(C1O)=O)=O)=O,,,5,1,3,0,3
9099_1,,,,2,1,1,2
9101_0,,,,2,1,1,2
C1(CCC(C1C(C=O)=O)O)=O,,,5,1,3,0,3
9101_1,,,,2,1,1,2
9103_0,,,,2,1,1,2
C(C1(CC(CC1C=O)=O)O)=O,,,5,1,2,0,2
9105_0,,,,2,1,1,2
C(CC1C(CC(C1O)=O)=O)=O,,,5,1,2,0,2
9107_0,,,,2,1,1,2
C(C1CC(CC(C1O)=O)=O)=O,,,5,1,2,0,2
9109_0,,,,2,1,1,2
C(C1CC(C(C1C=O)O)=O)=O,,,5,1,3,0,3
9111_0,,,,2,1,1,2
C(C1(CCC(C(C1)=O)=O)O)=O,,,5,1,2,0,2
9113_0,,,,2,1,1,2
C1(CCC(C(CC1O)=O)=O)=O,,,5,1,2,0,2
9115_0,,,,2,1,1,2
C(C1(CC(CC(C1)=O)=O)O)=O,,,5,1,2,0,2
9117_0,,,,2,1,1,2
C1(CC(C(C1C(C)=O)O)=O)=O,,,5,1,3,0,3
9117_1,,,,2,1,1,2
9119_0,,,,2,1,1,2
C1(CC(CC(C(C1)=O)O)=O)=O,,,5,1,2,0,2
9121_0,,,,2,1,1,2
C(C1(CCC(C1O)=O)O)=O,,,5,1,5,0,5
9121_1,,,,2,1,1,2
9123_0,,,,2,1,1,2
C1(CCC(C(C1O)O)=O)=O,,,5,1,3,0,3
9123_1,,,,2,1,1,2
9125_0,,,,2,1,1,2
C1(C(CO)C(C(C1)=O)O)=O,,,5,1,4,0,4
9125_1,,,,2,1,1,2
9127_0,,,,2,1,1,2
C1(C(C(CO)O)C(C(C1)=O)O)=O,,,5,1,3,0,3
9127_1,,,,2,1,1,2
9129_0,,,,2,1,1,2
C(CC1C(C(CC1O)=O)=O)=O,,,5,1,3,0,3
9131_0,,,,2,1,1,2
C(C1C(CC(C(C1)=O)=O)O)=O,,,5,1,3,0,3
9133_0,,,,2,1,1,2
C(C1C(C(CCC1O)=O)=O)=O,,,5,1,3,0,3
9133_1,,,,2,1,1,2
9135_0,,,,2,1,1,2
C(C1C(CC(CC1O)=O)=O)=O,,,5,1,5,0,5
9135_1,,,,2,1,1,2
9137_0,,,,2,1,1,2
C(C1C(C(C=O)C(C1)=O)O)=O,,,5,1,4,0,4
9137_1,,,,2,1,1,2
9138_0,,,,2,1,1,2
9139_0,,,,2,1,1,2
9140_0,,,,2,1,1,2
9142_0,,,,2,1,1,2
C(C1C(C(C(C1)=O)O)O)=O,,,5,1,6,0,6
9142_1,,,,2,1,1,2
9144_0,,,,2,1,1,2
C1(C(CC(C1CO)O)=O)=O,,,5,1,5,0,5
9144_1,,,,2,1,1,2
9146_0,,,,2,1,1,2
C(C1(C(CO)CC(C1O)=O)O)=O,,,5,1,2,0,2
9146_1,,,,2,1,1,2
9147_0,,,,2,1,1,2
9147_1,,,,2,1,1,2
9149_0,,,,2,1,1,2
C1(C(CO)C(C(C1CO)=O)O)=O,,,5,1,3,0,3
9149_1,,,,2,1,1,2
9151_0,,,,2,1,1,2
C1(CC(C(C1CO)=O)O)=O,,,5,1,3,0,3
9153_0,,,,2,1,1,2
C(C1C(CCC1O)=O)=O,,,5,1,3,0,3
9153_1,,,,2,1,1,2
9155_0,,,,2,1,1,2
C(C1C(CC(C1)=O)O)=O,,,5,1,3,0,3
9157_0,,,,2,1,1,2
C(C1C(CC(C1O)O)=O)=O,,,5,1,6,0,6
9157_1,,,,2,1,1,2
9158_0,,,,2,1,1,2
9158_1,,,,2,1,1,2
9160_0,,,,2,1,1,2
C(C1C(C(CC1O)O)=O)=O,,,5,1,4,0,4
9160_1,,,,2,1,1,2
9161_0,,,,2,1,1,2
9163_0,,,,2,1,1,2
C(C1C(C(C(C(C1)=O)O)O)O)=O,,,5,1,3,0,3
9163_1,,,,2,1,1,2
9165_0,,,,2,1,1,2
C1(C(C(C(C(C=O)O)C1)O)O)=O,,,5,1,2,0,2
9165_1,,,,2,1,1,2
9167_0,,,,2,1,1,2
C(C1C(C(CO)C(C1O)O)=O)=O,,,5,1,3,0,3
9167_1,,,,2,1,1,2
9168_0,,,,2,1,1,2
9170_0,,,,2,1,1,2
C(C1C(C(C(CO)(C1)O)O)=O)=O,,,5,1,2,0,2
9170_1,,,,2,1,1,2
9172_0,,,,2,1,1,2
C(CO)(C1C(C(C(C1)=O)O)O)=O,,,5,1,4,0,4
9172_1,,,,2,1,1,2
9173_0,,,,2,1,1,2
9173_1,,,,2,1,1,2
9175_0,,,,2,1,1,2
C(C1C(C(C(C1)O)O)=O)=O,,,5,1,4,0,4
9175_1,,,,2,1,1,2
9177_0,,,,2,1,1,2
C1(CC(CC(C1)=O)O)=O,,,5,1,2,0,2
9179_0,,,,2,1,1,2
C1(C(CC(C1C)O)=O)=O,,,5,1,1,0,1
9181_0,,,,2,1,1,2
C(C1C(C(CC1(CO)O)O)=O)=O,,,5,1,3,0,3
9181_1,,,,2,1,1,2
9182_0,,,,2,1,1,2
9182_1,,,,2,1,1,2
9183_0,,,,2,1,1,2
9183_1,,,,2,1,1,2
9184_0,,,,2,1,1,2
9184_1,,,,2,1,1,2
9186_0,,,,2,1,1,2
C1(C(CO)C(CC(C1O)=O)O)=O,,,5,1,4,0,4
9186_1,,,,2,1,1,2
9188_0,,,,2,1,1,2
C1(C(CC(C1C(CO)O)O)=O)=O,,,5,1,4,0,4
9188_1,,,,2,1,1,2
9190_0,,,,2,1,1,2
C1(CC(CC(C1O)=O)O)=O,,,5,1,2,0,2
9192_0,,,,2,1,1,2
C1(C(CC(CC1)O)=O)=O,,,5,1,2,0,2
9194_0,,,,2,1,1,2
C1(C(CC(C(C1)O)O)=O)=O,,,5,1,2,0,2
9195_0,,,,2,1,1,2
9196_0,,,,2,1,1,2
9198_0,,,,2,1,1,2
C1(CCC(C(C(C1O)O)O)=O)=O,,,5,1,2,0,2
9198_1,,,,2,1,1,2
9200_0,,,,2,1,1,2
C1(C(C(CC1)(C(C=O)O)O)O)=O,,,5,1,2,0,2
9200_1,,,,2,1,1,2
9202_0,,,,2,1,1,2
C1(C(CO)C(C(C(C1)=O)O)O)=O,,,5,1,5,0,5
9202_1,,,,2,1,1,2
9204_0,,,,2,1,1,2
C1(C(C(CC1)O)O)=O,,,5,1,2,0,2
9204_1,,,,2,1,1,2
9206_0,,,,2,1,1,2
C(C1C(CC(C1=O)O)=O)=O,,,5,1,3,0,3
9208_0,,,,2,1,1,2
C(C1(C(CC(C1CO)O)=O)O)=O,,,5,1,1,0,1
9210_0,,,,2,1,1,2
C1(C(C)(C(C(C1CO)=O)O)O)=O,,,5,1,4,0,4
9210_1,,,,2,1,1,2
9211_0,,,,2,1,1,2
9213_0,,,,2,1,1,2
C1(CC(C(C(C1CO)=O)O)O)=O,,,5,1,3,0,3
9213_1,,,,2,1,1,2
9214_0,,,,2,1,1,2
9215_0,,,,2,1,1,2
9217_0,,,,2,1,1,2
C1(C(C)(CC(C1C=O)=O)O)=O,,,5,1,2,0,2
9218_0,,,,2,1,1,2
9219_0,,,,2,1,1,2
9221_0,,,,2,1,1,2
C(C1C(CC(CC1=O)O)=O)=O,,,5,1,2,0,2
9223_0,,,,2,1,1,2
C1(C(C(CO)C(C1CO)O)=O)=O,,,5,1,3,0,3
9223_1,,,,2,1,1,2
9225_0,,,,2,1,1,2
C(C1C(CC(CO)(C1O)O)=O)=O,,,5,1,3,0,3
9225_1,,,,2,1,1,2
9226_0,,,,2,1,1,2
9226_1,,,,2,1,1,2
9228_0,,,,2,1,1,2
C(C1C(C(C(C1)=O)(CO)O)O)=O,,,5,1,4,0,4
9229_0,,,,2,1,1,2
9229_1,,,,2,1,1,2
9231_0,,,,2,1,1,2
C(C1(C(CC(CO)(C1)O)=O)O)=O,,,5,1,1,0,1
9232_0,,,,2,1,1,2
9232_1,,,,2,1,1,2
9233_0,,,,2,1,1,2
9233_1,,,,2,1,1,2
9235_0,,,,2,1,1,2
C(C1(C(CC(C1)O)=O)O)=O,,,5,1,2,0,2
9236_0,,,,2,1,1,2
9237_0,,,,2,1,1,2
9239_0,,,,2,1,1,2
C1(C(CO)(C(CC(C1)=O)O)O)=O,,,5,1,5,0,5
9240_0,,,,2,1,1,2
9242_0,,,,2,1,1,2
C(C1C(C(CC(C1)O)=O)=O)=O,,,5,1,2,0,2
9244_0,,,,2,1,1,2
C(C1C(C(C=O)C(C1)O)=O)=O,,,5,1,3,0,3
9244_1,,,,2,1,1,2
9246_0,,,,2,1,1,2
C1(CC(C(C=O)C1C=O)O)=O,,,5,1,2,0,2
9248_0,,,,2,1,1,2
C(C1C(CC(C1)O)=O)=O,,,5,1,2,0,2
9249_0,,,,2,1,1,2
9249_1,,,,2,1,1,2
9250_0,,,,2,1,1,2
9250_1,,,,2,1,1,2
9252_0,,,,2,1,1,2
C(C1(C(C(CO)C(C1)O)=O)O)=O,,,5,1,3,0,3
9252_1,,,,2,1,1,2
9254_0,,,,2,1,1,2
C(C1C(C(CC1O)O)=O)(O)=O,,,5,1,5,0,5
9254_1,,,,2,1,1,2
9256_0,,,,2,1,1,2
C(C1C(CC(C1O)O)=O)(O)=O,,,5,1,3,0,3
9256_1,,,,2,1,1,2
9258_0,,,,2,1,1,2
C(C1(CCC(C1O)=O)O)(O)=O,,,5,1,4,0,4
9258_1,,,,2,1,1,2
9260_0,,,,2,1,1,2
C1C(C(C(C=1C=O)=O)O)O,,,5,1,3,0,3
9260_1,,,,2,1,1,2
9262_0,,,,2,1,1,2
C1(C(C(C(C1O)=C)O)O)=O,,,5,1,3,0,3
9262_1,,,,2,1,1,2
9264_0,,,,2,1,1,2
C1(C(C(C=CC1O)O)O)=O,,,5,1,3,0,3
9264_1,,,,2,1,1,2
9266_0,,,,2,1,1,2
C1(C(C(C(C1O)=CCO)O)O)=O,,,5,1,3,0,3
9266_1,,,,2,1,1,2
9268_0,,,,2,1,1,2
C1(C(C(C(C=CC1O)O)O)O)=O,,,5,1,3,0,3
9268_1,,,,2,1,1,2
9270_0,,,,2,1,1,2
C1(C(C(C=CC1O)(CO)O)O)=O,,,5,1,3,0,3
9270_1,,,,2,1,1,2
9272_0,,,,2,1,1,2
C1C(C(CO)(C(C(C=1)=O)O)O)O,,,5,1,3,0,3
9272_1,,,,2,1,1,2
9274_0,,,,2,1,1,2
C1(C(C(C=C(CO)C1O)O)O)=O,,,5,1,3,0,3
9274_1,,,,2,1,1,2
9276_0,,,,2,1,1,2
C1(C(C(C(C(C1O)=C)O)O)O)=O,,,5,1,3,0,3
9276_1,,,,2,1,1,2
9278_0,,,,2,1,1,2
C1(C)C(C(C(C=1C=O)=O)O)O,,,5,1,3,0,3
9278_1,,,,2,1,1,2
9280_0,,,,2,1,1,2
C(C1C(C(C(C1=C)O)O)=O)=O,,,5,1,3,0,3
9280_1,,,,2,1,1,2
9282_0,,,,2,1,1,2
C(C1C(C(C(C1O)=C)O)=O)=O,,,5,1,3,0,3
9282_1,,,,2,1,1,2
9284_0,,,,2,1,1,2
C(C1(C=CC(C1)=O)O)=O,,,5,1,2,0,2
9286_0,,,,2,1,1,2
C1(C=CC(C(C1)O)=O)=O,,,5,1,2,0,2
9288_0,,,,2,1,1,2
C(C1C(CC(C=1)=O)O)=O,,,5,1,2,0,2
9290_0,,,,2,1,1,2
C(C1(C(C(C(C1)=O)O)=C)O)=O,,,5,1,2,0,2
9292_0,,,,2,1,1,2
C1(CC(C(C(C1O)=C)=O)O)=O,,,5,1,2,0,2
9294_0,,,,2,1,1,2
C(C1(C(CO)=CC(C1)=O)O)=O,,,5,1,2,0,2
9296_0,,,,2,1,1,2
C1(C(CO)=CC(CC1O)=O)=O,,,5,1,2,0,2
9298_0,,,,2,1,1,2
C1(CC(C=C(C=O)C1O)O)=O,,,5,1,3,0,3
9300_0,,,,2,1,1,2
C1(CC(C(C1O)=CC=O)O)=O,,,5,1,3,0,3
9302_0,,,,2,1,1,2
C1(C=C(C=O)C(C(C1)O)O)=O,,,5,1,2,0,2
9304_0,,,,2,1,1,2
C(C(C1C(CC(C=1)=O)O)O)=O,,,5,1,2,0,2
9306_0,,,,2,1,1,2
C(C1C(CC(C=1)=O)O)(CO)=O,,,5,1,2,0,2
9308_0,,,,2,1,1,2
C(C1C(CO)(CC(C=1)=O)O)=O,,,5,1,2,0,2
9310_0,,,,2,1,1,2
C1C(C)(C(C(C=1C=O)=O)O)O,,,5,1,3,0,3
9310_1,,,,2,1,1,2
9312_0,,,,2,1,1,2
C1(C=CC(C(C(C1)O)O)=O)=O,,,5,1,2,0,2
9314_0,,,,2,1,1,2
C(C(C1(C=CC(C1)=O)O)O)=O,,,5,1,2,0,2
9316_0,,,,2,1,1,2
C1C(CC(C=1)=O)O,,,5,1,2,0,2
9318_0,,,,2,1,1,2
C(C1C=CC(C1O)=O)=O,,,5,1,2,0,2
9320_0,,,,2,1,1,2
C(C1(C=CC(C1CO)=O)O)=O,,,5,1,3,0,3
9320_1,,,,2,1,1,2
9322_0,,,,2,1,1,2
C1(C=CC(C(C1CO)O)=O)=O,,,5,1,3,0,3
9322_1,,,,2,1,1,2
9324_0,,,,2,1,1,2
C(C1(C=CC(C1C=O)O)O)=O,,,5,1,6,0,6
9324_1,,,,2,1,1,2
9326_0,,,,2,1,1,2
C(C1C(C(C=CC1O)=O)O)=O,,,5,1,3,0,3
9326_1,,,,2,1,1,2
9328_0,,,,2,1,1,2
C1C(C(C=O)=O)C(C(C=1)O)O,,,5,1,2,0,2
9330_0,,,,2,1,1,2
C(C1(CC=CC(C1O)=O)O)=O,,,5,1,4,0,4
9330_1,,,,2,1,1,2
9332_0,,,,2,1,1,2
C1(C(C(C(C=CC1)=O)O)O)=O,,,5,1,5,0,5
9332_1,,,,2,1,1,2
9334_0,,,,2,1,1,2
C(C1(C=CCC(C1O)=O)O)=O,,,5,1,4,0,4
9334_1,,,,2,1,1,2
9336_0,,,,2,1,1,2
C(CO)(C1C=CC(C1O)=O)=O,,,5,1,2,0,2
9337_0,,,,2,1,1,2
9337_1,,,,2,1,1,2
9339_0,,,,2,1,1,2
C(C1C(CO)=CC(C1O)=O)=O,,,5,1,2,0,2
9341_0,,,,2,1,1,2
C(C1(C=CC(C(C1)=O)O)O)=O,,,5,1,2,0,2
9343_0,,,,2,1,1,2
C1(CC(C(C=CC1O)=O)O)=O,,,5,1,2,0,2
9345_0,,,,2,1,1,2
C(C1C(C(C(C1O)=O)=C)O)=O,,,5,1,3,0,3
9345_1,,,,2,1,1,2
9347_0,,,,2,1,1,2
C(C1C=C(C(C1O)=O)CO)=O,,,5,1,2,0,2
9349_0,,,,2,1,1,2
C(C1C(C(C=O)=CC1O)O)=O,,,5,1,6,0,6
9349_1,,,,2,1,1,2
9351_0,,,,2,1,1,2
C(C1C=C(C=O)C(C1O)O)=O,,,5,1,2,0,2
9353_0,,,,2,1,1,2
C1CC(C(C(C=1C=O)=O)O)O,,,5,1,3,0,3
9353_1,,,,2,1,1,2
9355_0,,,,2,1,1,2
C(C1C(C(C(C=C1)O)O)=O)=O,,,5,1,3,0,3
9355_1,,,,2,1,1,2
9357_0,,,,2,1,1,2
C(C1C(C(C=CC1O)O)=O)=O,,,5,1,3,0,3
9357_1,,,,2,1,1,2
9359_0,,,,2,1,1,2
C(C1C=CC(C(C1O)O)=O)=O,,,5,1,4,0,4
9361_0,,,,2,1,1,2
C1(C=C(C=O)C(C1CO)O)=O,,,5,1,3,0,3
9361_1,,,,2,1,1,2
9362_0,,,,2,1,1,2
9362_1,,,,2,1,1,2
9363_0,,,,2,1,1,2
9363_1,,,,2,1,1,2
9365_0,,,,2,1,1,2
C1(C(C(C(C=O)=CC1)O)O)=O,,,5,1,3,0,3
9365_1,,,,2,1,1,2
9367_0,,,,2,1,1,2
C1(CC(C(C=O)=CC1O)O)=O,,,5,1,2,0,2
9369_0,,,,2,1,1,2
C1C(C(C(C=1)=O)CO)O,,,5,1,3,0,3
9369_1,,,,2,1,1,2
9371_0,,,,2,1,1,2
C(C1C=CC(C1O)O)=O,,,5,1,2,0,2
9373_0,,,,2,1,1,2
C1(C(C(C=CC1)O)O)=O,,,5,1,3,0,3
9373_1,,,,2,1,1,2
9375_0,,,,2,1,1,2
C1CC(C(C(C=1)=O)O)O,,,5,1,3,0,3
9375_1,,,,2,1,1,2
9377_0,,,,2,1,1,2
C1C(C(C(C(C=1)=O)O)O)O,,,5,1,3,0,3
9377_1,,,,2,1,1,2
9379_0,,,,2,1,1,2
C1(CC(C=CC1O)O)=O,,,5,1,2,0,2
9381_0,,,,2,1,1,2
C1(C(C(C(C1(CO)O)=C)O)O)=O,,,5,1,3,0,3
9381_1,,,,2,1,1,2
9383_0,,,,2,1,1,2
C1(C(C(C=CC1(CO)O)O)O)=O,,,5,1,3,0,3
9383_1,,,,2,1,1,2
9385_0,,,,2,1,1,2
C(C1(C(CC(C1=C)O)=O)O)=O,,,5,1,2,0,2
9387_0,,,,2,1,1,2
C(C1(C(CC(C=C1)O)=O)O)=O,,,5,1,2,0,2
9389_0,,,,2,1,1,2
C1C(CO)(C(C(C(C=1)=O)O)O)O,,,5,1,3,0,3
9389_1,,,,2,1,1,2
9390_0,,,,2,1,1,2
9390_1,,,,2,1,1,2
9392_0,,,,2,1,1,2
C1C(C(C(C=1)=O)O)O,,,5,1,3,0,3
9392_1,,,,2,1,1,2
9394_0,,,,2,1,1,2
C1(CO)C(C(C(C=1)=O)O)O,,,5,1,3,0,3
9394_1,,,,2,1,1,2
9396_0,,,,2,1,1,2
C1(C2CC(C(O2)O)(C1)O)=O,,,5,1,3,0,3
9398_0,,,,2,1,1,2
C1(C2C(CO)C(C(O2)O)(C1)O)=O,,,5,1,3,0,3
9400_0,,,,2,1,1,2
C1(C2C(C(C1)O)C(C(O2)O)O)=O,,,5,1,2,0,2
9402_0,,,,2,1,1,2
C1(C2CC(C(O2)O)(C1CO)O)=O,,,5,1,4,0,4
9402_1,,,,2,1,1,2
9404_0,,,,2,1,1,2
C(C1C2C(CC(C1O)(O)O2)O)=O,,,5,1,3,0,3
9404_1,,,,2,1,1,2
9406_0,,,,2,1,1,2
C1(C(O)OC2C(CC(C12)O)O)=O,,,5,1,3,0,3
9406_1,,,,2,1,1,2
9408_0,,,,2,1,1,2
C(C1C(C2CC1(C(O)O2)O)O)=O,,,5,1,4,0,4
9408_1,,,,2,1,1,2
9410_0,,,,2,1,1,2
C1(C(O)OC2CC(C(C12)O)O)=O,,,5,1,3,0,3
9410_1,,,,2,1,1,2
9412_0,,,,2,1,1,2
C1(C(C2(C(O)OC(C2)C1)O)O)=O,,,5,1,4,0,4
9412_1,,,,2,1,1,2
9414_0,,,,2,1,1,2
C(C1C(C2(CC1(CO2)O)O)O)=O,,,5,1,4,0,4
9414_1,,,,2,1,1,2
9416_0,,,,2,1,1,2
C1(C2C(CC(C(C1)O)(O2)O)O)=O,,,5,1,3,0,3
9418_0,,,,2,1,1,2
C1(C(C2CC(C(O)O2)(C1)O)O)=O,,,5,1,3,0,3
9420_0,,,,2,1,1,2
C(C1C2C(C(C(O)O2)C1O)O)=O,,,5,1,4,0,4
9420_1,,,,2,1,1,2
9422_0,,,,2,1,1,2
C1(C2C(C(C(C1)O)C(O2)O)O)=O,,,5,1,5,0,5
9424_0,,,,2,1,1,2
C1(C2C(C(C1)O)(CC(O2)O)O)=O,,,5,1,2,0,2
9426_0,,,,2,1,1,2
C1(C(C2C(C1C(O)O2)O)O)=O,,,5,1,4,0,4
9426_1,,,,2,1,1,2
9428_0,,,,2,1,1,2
C1(C(C2(C)C(C1C(O)O2)O)O)=O,,,5,1,4,0,4
9428_1,,,,2,1,1,2
9430_0,,,,2,1,1,2
C1(C2C(C(CC(O2)O)(C1)O)O)=O,,,5,1,3,0,3
9432_0,,,,2,1,1,2
C1(C(C2C(C)(C1C(O)O2)O)O)=O,,,5,1,4,0,4
9432_1,,,,2,1,1,2
9434_0,,,,2,1,1,2
C1(C2CC(C(C(O2)O)O)(C1)O)=O,,,5,1,3,0,3
9436_0,,,,2,1,1,2
C1(C(O)OC2C(C1C(C2)O)O)=O,,,5,1,6,0,6
9436_1,,,,2,1,1,2
9438_0,,,,2,1,1,2
C(C1C2C(CC1(C(O)O2)O)O)=O,,,5,1,4,0,4
9438_1,,,,2,1,1,2
9440_0,,,,2,1,1,2
C1(C2C(CC(C(O2)O)(C1)O)O)=O,,,5,1,2,0,2
9442_0,,,,2,1,1,2
C1(C(C2CC(C1C(O)O2)O)O)=O,,,5,1,3,0,3
9442_1,,,,2,1,1,2
9444_0,,,,2,1,1,2
C1(C(CC2(C(C1CO2)O)O)O)=O,,,5,1,4,0,4
9444_1,,,,2,1,1,2
9445_0,,,,2,1,1,2
9445_1,,,,2,1,1,2
9447_0,,,,2,1,1,2
C1(COC2(C(C1C(C2)O)O)O)=O,,,5,1,4,0,4
9447_1,,,,2,1,1,2
9449_0,,,,2,1,1,2
C1(C(C2C(O)OCC1C2O)O)=O,,,5,1,4,0,4
9449_1,,,,2,1,1,2
9450_0,,,,2,1,1,2
9450_1,,,,2,1,1,2
9452_0,,,,2,1,1,2
C(C1C(C(C(C=O)=O)CC1O)O)=O,,,5,1,1,0,1
9454_0,,,,2,1,1,2
C(C1C(C(C=O)C(C=O)C1O)O)=O,,,5,1,1,0,1
9456_0,,,,2,1,1,2
C(C1C(C)(CCC1(C=O)O)O)=O,,,5,1,2,0,2
9456_1,,,,2,1,1,2
9458_0,,,,2,1,1,2
C(C1C(CCC(C1O)=O)(C)O)=O,,,5,1,3,0,3
9458_1,,,,2,1,1,2
9460_0,,,,2,1,1,2
C(C(C1CC(C)(CC1O)O)=O)=O,,,5,1,1,0,1
9462_0,,,,2,1,1,2
C(C1CC(C(C=O)C1(C)O)O)=O,,,5,1,2,0,2
9462_1,,,,2,1,1,2
9464_0,,,,2,1,1,2
C(C1C(C)(CC(C1C=O)O)O)=O,,,5,1,1,0,1
9466_0,,,,2,1,1,2
C(C1C(CCCC1(C=O)O)O)=O,,,5,1,2,0,2
9466_1,,,,2,1,1,2
9468_0,,,,2,1,1,2
C(C1C(CCCC(C1O)=O)O)=O,,,5,1,3,0,3
9468_1,,,,2,1,1,2
9470_0,,,,2,1,1,2
C(C(C1CCC(CC1O)O)=O)=O,,,5,1,1,0,1
9472_0,,,,2,1,1,2
C(C1C(C(CC1O)CC=O)O)=O,,,5,1,3,0,3
9472_1,,,,2,1,1,2
9474_0,,,,2,1,1,2
C(C1CC(C(C=O)C(C1)O)O)=O,,,5,1,2,0,2
9474_1,,,,2,1,1,2
9476_0,,,,2,1,1,2
C(C1CC(CC(C1C=O)O)O)=O,,,5,1,1,0,1
9478_0,,,,2,1,1,2
C(C(C1CC(C)(C(C1O)O)O)=O)=O,,,5,1,1,0,1
9480_0,,,,2,1,1,2
C(C1C(C)(C(C(C1C=O)O)O)O)=O,,,5,1,2,0,2
9482_0,,,,2,1,1,2
C(C(C1CCC(C(C1O)O)O)=O)=O,,,5,1,1,0,1
9484_0,,,,2,1,1,2
C(C1CC(C(C(C1C=O)O)O)O)=O,,,5,1,1,0,1
9486_0,,,,2,1,1,2
C(C1C(CCC1(C=O)O)O)=O,,,5,1,2,0,2
9486_1,,,,2,1,1,2
9488_0,,,,2,1,1,2
C(C1C(CCC(C1O)=O)O)=O,,,5,1,3,0,3
9488_1,,,,2,1,1,2
9490_0,,,,2,1,1,2
C(C(C1CC(CC1O)O)=O)=O,,,5,1,1,0,1
9492_0,,,,2,1,1,2
C(C1C(C(C=O)C(C1)O)O)=O,,,5,1,2,0,2
9492_1,,,,2,1,1,2
9494_0,,,,2,1,1,2
C(C1C(CC(C1C=O)O)O)=O,,,5,1,1,0,1
9496_0,,,,2,1,1,2
C(C1C(C(CCC1(C=O)O)O)O)=O,,,5,1,2,0,2
9496_1,,,,2,1,1,2
9498_0,,,,2,1,1,2
C(C1C(C(CCC(C1O)=O)O)O)=O,,,5,1,3,0,3
9498_1,,,,2,1,1,2
9500_0,,,,2,1,1,2
C(C(C1CC(C(CC1O)O)O)=O)=O,,,5,1,1,0,1
9502_0,,,,2,1,1,2
C(C1C(C(C(C1O)CC=O)O)O)=O,,,5,1,3,0,3
9502_1,,,,2,1,1,2
9504_0,,,,2,1,1,2
C(C1C(C(C(C=O)CC1O)O)O)=O,,,5,1,2,0,2
9504_1,,,,2,1,1,2
9506_0,,,,2,1,1,2
C(C1C(C(CC(C1C=O)O)O)O)=O,,,5,1,2,0,2
9508_0,,,,2,1,1,2
C(C1C(CO)(CCC1(C=O)O)O)=O,,,5,1,2,0,2
9508_1,,,,2,1,1,2
9510_0,,,,2,1,1,2
C(C1C(CCC(C1O)=O)(CO)O)=O,,,5,1,3,0,3
9510_1,,,,2,1,1,2
9512_0,,,,2,1,1,2
C(C(C1CC(CO)(CC1O)O)=O)=O,,,5,1,1,0,1
9514_0,,,,2,1,1,2
C(C1C(CC(C=O)C1(CO)O)O)=O,,,5,1,2,0,2
9514_1,,,,2,1,1,2
9516_0,,,,2,1,1,2
C(C1C(CC(CO)(C1C=O)O)O)=O,,,5,1,2,0,2
9518_0,,,,2,1,1,2
C1(C(C(C(C=O)=O)CC1O)O)=O,,,5,1,1,0,1
9520_0,,,,2,1,1,2
C(C1C(C(C(C1C=O)O)=O)O)=O,,,5,1,1,0,1
9522_0,,,,2,1,1,2
C(C1(CCC(C(C(C1)=O)=O)O)O)=O,,,5,1,1,0,1
9524_0,,,,2,1,1,2
C1(C(CC(C(C(CC1)O)=O)=O)O)=O,,,5,1,2,0,2
9526_0,,,,2,1,1,2
C1(C(C)(C(C(C=O)=O)CC1O)O)=O,,,5,1,1,0,1
9528_0,,,,2,1,1,2
C(CC1C(CC(C(C1O)=O)=O)O)=O,,,5,1,2,0,2
9530_0,,,,2,1,1,2
C(C1CC(CC(C(C1O)=O)=O)O)=O,,,5,1,1,0,1
9532_0,,,,2,1,1,2
C1(C(C(C=O)C(C=O)C1(C)O)O)=O,,,5,1,2,0,2
9534_0,,,,2,1,1,2
C(C1(CCCC(C(C1O)=O)=O)O)=O,,,5,1,2,0,2
9534_1,,,,2,1,1,2
9536_0,,,,2,1,1,2
C1(C(C(C(C(CCC1)=O)=O)O)O)=O,,,5,1,3,0,3
9536_1,,,,2,1,1,2
9538_0,,,,2,1,1,2
C1(C(C(C(C(CO)=O)=O)CC1)O)=O,,,5,1,2,0,2
9540_0,,,,2,1,1,2
C1(C(CO)(C(C(C=O)=O)CC1)O)=O,,,5,1,1,0,1
9542_0,,,,2,1,1,2
C(CC1C(C(C(C(C1)=O)=O)O)O)=O,,,5,1,3,0,3
9542_1,,,,2,1,1,2
9544_0,,,,2,1,1,2
C(C1CC(C(C(C(C1)=O)=O)O)O)=O,,,5,1,2,0,2
9544_1,,,,2,1,1,2
9546_0,,,,2,1,1,2
C1(CC(C=O)C(C=O)C1(CO)O)=O,,,5,1,1,0,1
9548_0,,,,2,1,1,2
C(C1(C(CCC1C(C=O)=O)O)O)=O,,,5,1,1,0,1
9550_0,,,,2,1,1,2
C1(C(C(C(C=O)=O)CCC1O)O)=O,,,5,1,1,0,1
9552_0,,,,2,1,1,2
C(C1CC(C(C=O)(C1C=O)O)O)=O,,,5,1,2,0,2
9554_0,,,,2,1,1,2
C1(C(C(C=O)C(C=O)CC1O)O)=O,,,5,1,1,0,1
9556_0,,,,2,1,1,2
C1(C(C(C(C=O)=O)CC1(C)O)O)=O,,,5,1,1,0,1
9557_0,,,,2,1,1,2
9559_0,,,,2,1,1,2
C(C1(CCC(C(C1)=O)O)O)=O,,,5,1,1,0,1
9561_0,,,,2,1,1,2
C1(CC(C(CCC1O)=O)O)=O,,,5,1,2,0,2
9563_0,,,,2,1,1,2
C(CC1C(CC(C1O)=O)O)=O,,,5,1,2,0,2
9565_0,,,,2,1,1,2
C(C1CC(CC(C1O)=O)O)=O,,,5,1,1,0,1
9567_0,,,,2,1,1,2
C(C1(CCCC(C1O)=O)O)=O,,,5,1,2,0,2
9567_1,,,,2,1,1,2
9569_0,,,,2,1,1,2
C1(C(C(C(CCC1)=O)O)O)=O,,,5,1,3,0,3
9569_1,,,,2,1,1,2
9571_0,,,,2,1,1,2
C(CO)(C1CCC(C1O)=O)=O,,,5,1,2,0,2
9573_0,,,,2,1,1,2
C(CC1C(C(C(C1)=O)O)O)=O,,,5,1,3,0,3
9573_1,,,,2,1,1,2
9575_0,,,,2,1,1,2
C(C1CC(C(C(C1)=O)O)O)=O,,,5,1,2,0,2
9575_1,,,,2,1,1,2
9577_0,,,,2,1,1,2
C1(C(CO)C(C=O)(CCC1O)O)=O,,,5,1,2,0,2
9577_1,,,,2,1,1,2
9579_0,,,,2,1,1,2
C1(C(CO)C(C(CCC1O)=O)O)=O,,,5,1,3,0,3
9579_1,,,,2,1,1,2
9581_0,,,,2,1,1,2
C(CC1C(C(C(C1O)=O)CO)O)=O,,,5,1,3,0,3
9581_1,,,,2,1,1,2
9583_0,,,,2,1,1,2
C(C1CC(C(C(C1O)=O)CO)O)=O,,,5,1,2,0,2
9583_1,,,,2,1,1,2
9585_0,,,,2,1,1,2
C(C1(CCC(CC(C1O)=O)O)O)=O,,,5,1,2,0,2
9585_1,,,,2,1,1,2
9587_0,,,,2,1,1,2
C(C1(CCC(C1C(CO)=O)O)O)=O,,,5,1,2,0,2
9587_1,,,,2,1,1,2
9589_0,,,,2,1,1,2
C1(C(C(C(CCC(C1)O)=O)O)O)=O,,,5,1,3,0,3
9589_1,,,,2,1,1,2
9591_0,,,,2,1,1,2
C(CO)(C1C(CCC(C1O)=O)O)=O,,,5,1,3,0,3
9591_1,,,,2,1,1,2
9593_0,,,,2,1,1,2
C(C(C1CC(CC1(CO)O)O)=O)=O,,,5,1,1,0,1
9595_0,,,,2,1,1,2
C(CC1C(CC(C(C1O)O)=O)O)=O,,,5,1,5,0,5
9595_1,,,,2,1,1,2
9597_0,,,,2,1,1,2
C(C1C(CC(C(C(C1)O)O)=O)O)=O,,,5,1,2,0,2
9597_1,,,,2,1,1,2
9599_0,,,,2,1,1,2
C(C1C(C(C(CO)=O)C(C1)O)O)=O,,,5,1,2,0,2
9599_1,,,,2,1,1,2
9600_0,,,,2,1,1,2
9602_0,,,,2,1,1,2
C(C1(CCC(C(C1O)=O)CO)O)=O,,,5,1,2,0,2
9602_1,,,,2,1,1,2
9604_0,,,,2,1,1,2
C1(C(C(C(CCC1CO)=O)O)O)=O,,,5,1,3,0,3
9604_1,,,,2,1,1,2
9606_0,,,,2,1,1,2
C(CC1C(C(C(C1CO)=O)O)O)=O,,,5,1,3,0,3
9606_1,,,,2,1,1,2
9608_0,,,,2,1,1,2
C1(C(CO)C(C=O)CC(C1O)O)=O,,,5,1,2,0,2
9608_1,,,,2,1,1,2
9610_0,,,,2,1,1,2
C(C(C1CC(CC(C1O)O)O)=O)=O,,,5,1,1,0,1
9611_0,,,,2,1,1,2
9613_0,,,,2,1,1,2
C(C(C1CC(CO)C(C1O)O)=O)=O,,,5,1,1,0,1
9615_0,,,,2,1,1,2
C(C1C(C(C(CO)C1C=O)O)O)=O,,,5,1,1,0,1
9617_0,,,,2,1,1,2
C(C1(CCC(C(C1)=O)(CO)O)O)=O,,,5,1,1,0,1
9619_0,,,,2,1,1,2
C1(CC(C(CCC1(CO)O)=O)O)=O,,,5,1,2,0,2
9621_0,,,,2,1,1,2
C1(CC(C(CC=O)C1(CO)O)O)=O,,,5,1,2,0,2
9623_0,,,,2,1,1,2
C(C1CC(CC(C1(CO)O)=O)O)=O,,,5,1,1,0,1
9625_0,,,,2,1,1,2
C(C1(CCC(C(C(C1)=O)O)O)O)=O,,,5,1,1,0,1
9627_0,,,,2,1,1,2
C1(CC(C(CCC(C1O)O)=O)O)=O,,,5,1,2,0,2
9629_0,,,,2,1,1,2
C(C(C1CC(C(C1(C)O)O)O)=O)=O,,,5,1,1,0,1
9630_0,,,,2,1,1,2
9632_0,,,,2,1,1,2
C(C1C(C(C(CC(C1)O)=O)O)O)=O,,,5,1,1,0,1
9633_0,,,,2,1,1,2
9635_0,,,,2,1,1,2
C(C1CCC(C1O)=O)(C(CO)O)=O,,,5,1,2,0,2
9637_0,,,,2,1,1,2
C1(C(C(C(C(O)=O)=O)CC1)O)=O,,,5,1,2,0,2
9639_0,,,,2,1,1,2
C(C1(CCC2C(C(C1O2)=O)O)O)=O,,,5,1,2,0,2
9639_1,,,,2,1,1,2
9641_0,,,,2,1,1,2
C1(C(C2C(C(C(CC1)O2)O)=O)O)=O,,,5,1,3,0,3
9641_1,,,,2,1,1,2
9643_0,,,,2,1,1,2
C(C(C1CC2C(C1(CO2)O)O)=O)=O,,,5,1,1,0,1
9645_0,,,,2,1,1,2
C(CC1C2C(C(C(C1O)O2)=O)O)=O,,,5,1,3,0,3
9645_1,,,,2,1,1,2
9647_0,,,,2,1,1,2
C(C1C2C(C(C(C(C1)O)O2)=O)O)=O,,,5,1,2,0,2
9647_1,,,,2,1,1,2
9649_0,,,,2,1,1,2
C(C1C2(COC(C2O)C1C=O)O)=O,,,5,1,1,0,1
9651_0,,,,2,1,1,2
C(C1(CCC2(C(C1OC2)=O)O)O)=O,,,5,1,2,0,2
9651_1,,,,2,1,1,2
9653_0,,,,2,1,1,2
C1(C(C2C(C(CO2)(CC1)O)=O)O)=O,,,5,1,3,0,3
9653_1,,,,2,1,1,2
9655_0,,,,2,1,1,2
C(CC1C(C2C(C1(CO2)O)=O)O)=O,,,5,1,3,0,3
9655_1,,,,2,1,1,2
9657_0,,,,2,1,1,2
C(C1CC(C2C(C1(CO2)O)=O)O)=O,,,5,1,2,0,2
9657_1,,,,2,1,1,2
9659_0,,,,2,1,1,2
C1(C2(CCC(C=O)(C1CO2)O)O)=O,,,5,1,2,0,2
9659_1,,,,2,1,1,2
9661_0,,,,2,1,1,2
C1(C2(CCC(C(C1CO2)O)=O)O)=O,,,5,1,3,0,3
9661_1,,,,2,1,1,2
9663_0,,,,2,1,1,2
C(CC1C(C2C(C1(O)OC2)=O)O)=O,,,5,1,3,0,3
9663_1,,,,2,1,1,2
9665_0,,,,2,1,1,2
C(C1CC(C2C(C1(O)OC2)=O)O)=O,,,5,1,2,0,2
9665_1,,,,2,1,1,2
9667_0,,,,2,1,1,2
C(C1(CCC2C1C(C(O)O2)=O)O)=O,,,5,1,2,0,2
9667_1,,,,2,1,1,2
9669_0,,,,2,1,1,2
C1(C(C2C(C(O)OC2CC1)=O)O)=O,,,5,1,3,0,3
9669_1,,,,2,1,1,2
9671_0,,,,2,1,1,2
C(C(C1CC2CC1(C(O)O2)O)=O)=O,,,5,1,1,0,1
9673_0,,,,2,1,1,2
C(C1C2C(C(C(O)O2)=O)C(C1)O)=O,,,5,1,2,0,2
9673_1,,,,2,1,1,2
9675_0,,,,2,1,1,2
C(C1C2CC(C(O)O2)(C1C=O)O)=O,,,5,1,1,0,1
9677_0,,,,2,1,1,2
C(C1(CCC2C(C1OC2O)=O)O)=O,,,5,1,2,0,2
9677_1,,,,2,1,1,2
9679_0,,,,2,1,1,2
C1(C(C2C(C(C(O2)O)CC1)=O)O)=O,,,5,1,3,0,3
9679_1,,,,2,1,1,2
9681_0,,,,2,1,1,2
C(CC1C(C2C(C1C(O2)O)=O)O)=O,,,5,1,3,0,3
9681_1,,,,2,1,1,2
9683_0,,,,2,1,1,2
C1(C2C(OC1C(CC2C=O)O)O)=O,,,5,1,2,0,2
9683_1,,,,2,1,1,2
9685_0,,,,2,1,1,2
C(C1(CCC2(C1C(CO2)=O)O)O)=O,,,5,1,2,0,2
9685_1,,,,2,1,1,2
9687_0,,,,2,1,1,2
C(C1(CCC2(CC(C1O2)=O)O)O)=O,,,5,1,2,0,2
9687_1,,,,2,1,1,2
9689_0,,,,2,1,1,2
C1(COC2(CCC(C(C12)O)=O)O)=O,,,5,1,3,0,3
9689_1,,,,2,1,1,2
9691_0,,,,2,1,1,2
C1(C(C2C(CC(CC1)(O2)O)=O)O)=O,,,5,1,3,0,3
9691_1,,,,2,1,1,2
9693_0,,,,2,1,1,2
C(C(C1CC2(CC1(CO2)O)O)=O)=O,,,5,1,1,0,1
9695_0,,,,2,1,1,2
C(CC1C(C2C(CC1(O2)O)=O)O)=O,,,5,1,3,0,3
9695_1,,,,2,1,1,2
9697_0,,,,2,1,1,2
C(C1C2(C(C(CO2)=O)C(C1)O)O)=O,,,5,1,2,0,2
9697_1,,,,2,1,1,2
9699_0,,,,2,1,1,2
C(C1C2(CC(C(C(C1)O)O2)=O)O)=O,,,5,1,2,0,2
9699_1,,,,2,1,1,2
9701_0,,,,2,1,1,2
C(C1C2(COC(C2)(C1C=O)O)O)=O,,,5,1,1,0,1
9703_0,,,,2,1,1,2
C1(C2CCC(C=O)(C1C(O2)O)O)=O,,,5,1,2,0,2
9703_1,,,,2,1,1,2
9705_0,,,,2,1,1,2
C1(C2CCC(C(C1C(O2)O)O)=O)=O,,,5,1,3,0,3
9705_1,,,,2,1,1,2
9707_0,,,,2,1,1,2
C(CC1C(C2C(C1OC2O)=O)O)=O,,,5,1,3,0,3
9707_1,,,,2,1,1,2
9709_0,,,,2,1,1,2
C(C1CC(C2C(C1OC2O)=O)O)=O,,,5,1,2,0,2
9709_1,,,,2,1,1,2
9711_0,,,,2,1,1,2
C(C(C1CC(C(C1O)O)O)=O)=O,,,5,1,2,0,2
9713_0,,,,2,1,1,2
C(C1(CCC(C(C1O)=O)O)O)=O,,,5,1,2,0,2
9713_1,,,,2,1,1,2
9715_0,,,,2,1,1,2
C1(C(C(C(C(CC1)O)=O)O)O)=O,,,5,1,3,0,3
9715_1,,,,2,1,1,2
9717_0,,,,2,1,1,2
C1(C(C(C(C=O)=O)CC1)O)=O,,,5,1,3,0,3
9719_0,,,,2,1,1,2
C(C1(CC(CC1C(C=O)=O)O)O)=O,,,5,1,1,0,1
9721_0,,,,2,1,1,2
C1(C(C(C(C=O)=O)CC(C1)O)O)=O,,,5,1,1,0,1
9723_0,,,,2,1,1,2
C(C1(CCC(C1C(C=O)=O)O)O)=O,,,5,1,2,0,2
9723_1,,,,2,1,1,2
9725_0,,,,2,1,1,2
C1(C(C(C(C=O)=O)C(CC1)O)O)=O,,,5,1,3,0,3
9725_1,,,,2,1,1,2
9727_0,,,,2,1,1,2
C1(C(C(C(C=O)=O)CC1CO)O)=O,,,5,1,1,0,1
9729_0,,,,2,1,1,2
C(C1(CC(C(C=O)=O)C(C1)O)O)=O,,,5,1,1,0,1
9731_0,,,,2,1,1,2
C(C1(CCC(C=O)(C1C=O)O)O)=O,,,5,1,2,0,2
9731_1,,,,2,1,1,2
9733_0,,,,2,1,1,2
C1(C(C(C=O)C(C=O)(CC1)O)O)=O,,,5,1,3,0,3
9733_1,,,,2,1,1,2
9735_0,,,,2,1,1,2
C(C1CC(C(C=O)=O)C(C1O)O)=O,,,5,1,1,0,1
9737_0,,,,2,1,1,2
C(C1(CCC(C=O)C(C1O)=O)O)=O,,,5,1,2,0,2
9737_1,,,,2,1,1,2
9739_0,,,,2,1,1,2
C(C1C(C(C(C(CC1)=O)O)O)=O)=O,,,5,1,3,0,3
9739_1,,,,2,1,1,2
9741_0,,,,2,1,1,2
C1(C(CC(C(C=O)=O)C(C1)O)O)=O,,,5,1,1,0,1
9743_0,,,,2,1,1,2
C1(C(CCC(C=O)(C1C=O)O)O)=O,,,5,1,2,0,2
9743_1,,,,2,1,1,2
9745_0,,,,2,1,1,2
C1(C(CCC(C(C1C=O)O)=O)O)=O,,,5,1,3,0,3
9745_1,,,,2,1,1,2
9747_0,,,,2,1,1,2
C(C1(CCC(C=O)(C(C1)=O)O)O)=O,,,5,1,1,0,1
9749_0,,,,2,1,1,2
C1(CC(C(CCC1(C=O)O)=O)O)=O,,,5,1,2,0,2
9751_0,,,,2,1,1,2
C1(C(C(C(C(C=O)=O)CC1)O)O)=O,,,5,1,1,0,1
9753_0,,,,2,1,1,2
C(C1CCC(C1O)=O)(C(C=O)O)=O,,,5,1,2,0,2
9755_0,,,,2,1,1,2
C(C1CCC(C1O)=O)=O,,,5,1,2,0,2
9757_0,,,,2,1,1,2
C(C1C(C(C(C1C=O)O)O)O)=O,,,5,1,3,0,3
9759_0,,,,2,1,1,2
C(C1C(CC(C=O)(C1C=O)O)O)=O,,,5,1,2,0,2
9761_0,,,,2,1,1,2
C1(C(C(C=O)C(C=O)C(C1)O)O)=O,,,5,1,2,0,2
9763_0,,,,2,1,1,2
C(C1C(C(C(C=O)=O)C(C1)O)O)=O,,,5,1,2,0,2
9763_1,,,,2,1,1,2
9765_0,,,,2,1,1,2
C1(C(C(C=O)C(C=O)C1CO)O)=O,,,5,1,1,0,1
9766_0,,,,2,1,1,2
9768_0,,,,2,1,1,2
C(C1C(CC(C=O)C1(C=O)O)O)=O,,,5,1,2,0,2
9768_1,,,,2,1,1,2
9770_0,,,,2,1,1,2
C(C1C(C(C(C=O)C1C=O)O)O)=O,,,5,1,1,0,1
9772_0,,,,2,1,1,2
C(CC1C(C(C(C1C=O)=O)O)O)=O,,,5,1,3,0,3
9772_1,,,,2,1,1,2
9774_0,,,,2,1,1,2
C1(C(C(CC(C=O)C1C=O)O)O)=O,,,5,1,2,0,2
9774_1,,,,2,1,1,2
9775_0,,,,2,1,1,2
9777_0,,,,2,1,1,2
C(CC1C(C(C=O)C(C1O)=O)O)=O,,,5,1,3,0,3
9777_1,,,,2,1,1,2
9779_0,,,,2,1,1,2
C(C1CC(C(C=O)C(C1O)=O)O)=O,,,5,1,2,0,2
9779_1,,,,2,1,1,2
9781_0,,,,2,1,1,2
C(C1(C(CC(C1CC=O)O)=O)O)=O,,,5,1,2,0,2
9783_0,,,,2,1,1,2
C1(CC(CC(C=O)C1(C=O)O)O)=O,,,5,1,1,0,1
9785_0,,,,2,1,1,2
C1(CC(C=O)C(C=O)C(C1O)O)=O,,,5,1,1,0,1
9787_0,,,,2,2,1,3
C(CC1(C(C(C(C1O)O)O)O)O)=O,,,5,1,3,0,3
9788_0,,,,2,2,1,3
9788_1,,,,2,2,1,3
9789_0,,,,2,2,1,3
9791_0,,,,2,2,1,3
C(C1(CC(C(C1)O)(CC=O)O)O)=O,,,5,1,1,0,1
9793_0,,,,2,2,1,3
C1(C(CC(C=O)(C1C(O)=O)O)O)=O,,,5,1,2,0,2
9793_1,,,,2,2,1,3
9794_0,,,,2,2,1,3
9794_1,,,,2,2,1,3
9795_0,,,,2,2,1,3
9795_1,,,,2,2,1,3
9796_0,,,,2,2,1,3
9798_0,,,,2,2,1,3
C(C1C(C(CC(C1O)=O)O)=O)(O)=O,,,5,1,2,0,2
9798_1,,,,2,2,1,3
9799_0,,,,2,2,1,3
9799_1,,,,2,2,1,3
9800_0,,,,2,2,1,3
9800_1,,,,2,2,1,3
9801_0,,,,2,2,1,3
9802_0,,,,2,2,1,3
9804_0,,,,2,2,1,3
C(C1C(C(C(O)=O)C(C1O)=O)O)=O,,,5,1,2,0,2
9804_1,,,,2,2,1,3
9805_0,,,,2,2,1,3
9805_1,,,,2,2,1,3
9806_0,,,,2,2,1,3
9806_1,,,,2,2,1,3
9808_0,,,,2,2,1,3
C(C(C=C)C1(CC(CC1O)O)O)=O,,,5,1,1,0,1
9810_0,,,,2,2,1,3
C(C(CC1(CC(CC1O)O)O)=O)=O,,,5,1,1,0,1
9812_0,,,,2,2,1,3
C(C(C=O)C1(CC(CC1O)O)O)=O,,,5,1,2,0,2
9812_1,,,,2,2,1,3
9814_0,,,,2,2,1,3
C(CC1(CC(CC1O)O)O)=O,,,5,1,1,0,1
9816_0,,,,2,2,1,3
C(C(CO)C1(CC(CC1O)O)O)=O,,,5,1,2,0,2
9816_1,,,,2,2,1,3
9818_0,,,,2,2,1,3
C(C)(C(C1(C(CC(C1)O)O)O)O)=O,,,5,1,2,0,2
9818_1,,,,2,2,1,3
9820_0,,,,2,2,1,3
C(CO)(CC1(C(CC(C1)O)O)O)=O,,,5,1,1,0,1
9822_0,,,,2,2,1,3
C(C(C1(C(CC(C1)O)O)O)O)=O,,,5,1,2,0,2
9822_1,,,,2,2,1,3
9824_0,,,,2,2,1,3
C1(C(CC(C1C(C(C)O)O)O)O)=O,,,5,1,2,0,2
9824_1,,,,2,2,1,3
9825_0,,,,2,2,1,3
9825_1,,,,2,2,1,3
9827_0,,,,2,2,1,3
C1(C(C(CC1O)O)C(C=CC)O)=O,,,5,1,2,0,2
9827_1,,,,2,2,1,3
9829_0,,,,2,2,1,3
C1(C(CC(C1C(CC=C)O)O)O)=O,,,5,1,2,0,2
9829_1,,,,2,2,1,3
9831_0,,,,2,2,1,3
C1(C(C(CC1O)O)C(C=C)O)=O,,,5,1,2,0,2
9831_1,,,,2,2,1,3
9832_0,,,,2,2,1,3
9832_1,,,,2,2,1,3
9833_0,,,,2,2,1,3
9833_1,,,,2,2,1,3
9834_0,,,,2,2,1,3
9834_1,,,,2,2,1,3
9835_0,,,,2,2,1,3
9835_1,,,,2,2,1,3
9836_0,,,,2,2,1,3
9836_1,,,,2,2,1,3
9837_0,,,,2,2,1,3
9837_1,,,,2,2,1,3
9838_0,,,,2,2,1,3
9838_1,,,,2,2,1,3
9839_0,,,,2,2,1,3
9839_1,,,,2,2,1,3
9840_0,,,,2,2,1,3
9840_1,,,,2,2,1,3
9841_0,,,,2,2,1,3
9841_1,,,,2,2,1,3
9843_0,,,,2,2,1,3
C(CC1(CC(C(C1O)O)O)O)=O,,,5,1,1,0,1
9845_0,,,,2,2,1,3
C(C(C1(C(C(C(C1)O)O)O)O)O)=O,,,5,1,3,0,3
9845_1,,,,2,2,1,3
9846_0,,,,2,2,1,3
9846_1,,,,2,2,1,3
9848_0,,,,2,2,1,3
C1(C(C(C(C1O)O)O)C(C=C)O)=O,,,5,1,2,0,2
9848_1,,,,2,2,1,3
9849_0,,,,2,2,1,3
9849_1,,,,2,2,1,3
9850_0,,,,2,2,1,3
9850_1,,,,2,2,1,3
9851_0,,,,2,2,1,3
9851_1,,,,2,2,1,3
9852_0,,,,2,2,1,3
9852_1,,,,2,2,1,3
9854_0,,,,2,2,1,3
C(CC1(C(CC(C1CO)O)O)O)=O,,,5,1,1,0,1
9856_0,,,,2,2,1,3
C(CC(C1C(C(CC1O)O)O)O)=O,,,5,1,1,0,1
9858_0,,,,2,2,1,3
C(CC1(CC(CC(C1O)O)O)O)=O,,,5,1,1,0,1
9859_0,,,,2,2,1,3
9859_1,,,,2,2,1,3
9860_0,,,,2,2,1,3
9860_1,,,,2,2,1,3
9861_0,,,,2,2,1,3
9861_1,,,,2,2,1,3
9862_0,,,,2,2,1,3
9862_1,,,,2,2,1,3
9863_0,,,,2,2,1,3
9863_1,,,,2,2,1,3
9864_0,,,,2,2,1,3
9864_1,,,,2,2,1,3
9865_0,,,,2,2,1,3
9865_1,,,,2,2,1,3
9866_0,,,,2,2,1,3
9866_1,,,,2,2,1,3
9867_0,,,,2,2,1,3
9867_1,,,,2,2,1,3
9869_0,,,,2,2,1,3
C(C(C)(C(CO)C(CC=O)O)O)=O,,,5,1,2,0,2
9870_0,,,,2,2,1,3
9871_0,,,,2,2,1,3
9871_1,,,,2,2,1,3
9872_0,,,,2,2,1,3
9873_0,,,,2,2,1,3
9875_0,,,,2,2,1,3
C(CC(C(CO)C(C(C)=O)O)O)=O,,,5,1,2,0,2
9876_0,,,,2,2,1,3
9878_0,,,,2,2,1,3
C(C(CO)C(C(CC(O)=O)=O)O)=O,,,5,1,6,0,6
9879_0,,,,2,2,1,3
9880_0,,,,2,2,1,3
9881_0,,,,2,2,1,3
9881_1,,,,2,2,1,3
9882_0,,,,2,2,1,3
9882_1,,,,2,2,1,3
9883_0,,,,2,2,1,3
9883_1,,,,2,2,1,3
9884_0,,,,2,2,1,3
9884_1,,,,2,2,1,3
9885_0,,,,2,2,1,3
9885_1,,,,2,2,1,3
9887_0,,,,2,2,1,3
C(CC(C(CO)C(CC=O)O)O)=O,,,5,1,2,0,2
9888_0,,,,2,2,1,3
9889_0,,,,2,2,1,3
9889_1,,,,2,2,1,3
9890_0,,,,2,2,1,3
9890_1,,,,2,2,1,3
9891_0,,,,2,2,1,3
9891_1,,,,2,2,1,3
9892_0,,,,2,2,1,3
9893_0,,,,2,2,1,3
9893_1,,,,2,2,1,3
9894_0,,,,2,2,1,3
9894_1,,,,2,2,1,3
9895_0,,,,2,2,1,3
9895_1,,,,2,2,1,3
9897_0,,,,2,2,1,3
C(CC(CC(CC(C)O)O)O)=O,,,5,1,1,0,1
9899_0,,,,2,2,1,3
C(C(C(CC(CC(C)O)O)O)O)=O,,,5,1,2,0,2
9899_1,,,,2,2,1,3
9900_0,,,,2,2,1,3
9900_1,,,,2,2,1,3
9902_0,,,,2,2,1,3
C(C(C(CC(C)O)O)C(C=C)O)=O,,,5,1,2,0,2
9902_1,,,,2,2,1,3
9903_0,,,,2,2,1,3
9903_1,,,,2,2,1,3
9904_0,,,,2,2,1,3
9904_1,,,,2,2,1,3
9905_0,,,,2,2,1,3
9905_1,,,,2,2,1,3
9906_0,,,,2,2,1,3
9906_1,,,,2,2,1,3
9908_0,,,,2,2,1,3
C(CC(C(C(CC(C)O)O)O)O)=O,,,5,1,1,0,1
9910_0,,,,2,2,1,3
C(CC(C(C(C)O)C(C)O)O)=O,,,5,1,1,0,1
9912_0,,,,2,2,1,3
C(C(C(C(C(C)O)C(C)O)O)O)=O,,,5,1,2,0,2
9912_1,,,,2,2,1,3
9914_0,,,,2,2,1,3
C(C(C=C)C(C(CO)C(C)O)O)=O,,,5,1,1,0,1
9916_0,,,,2,2,1,3
C(C(CC(C(CO)C(C)O)O)=O)=O,,,5,1,2,0,2
9918_0,,,,2,2,1,3
C(C(C=O)C(C(CO)C(C)O)O)=O,,,5,1,3,0,3
9918_1,,,,2,2,1,3
9920_0,,,,2,2,1,3
C(CC(C(CO)C(C)O)O)=O,,,5,1,2,0,2
9922_0,,,,2,2,1,3
C(C(CO)C(C(CO)C(C)O)O)=O,,,5,1,3,0,3
9922_1,,,,2,2,1,3
9924_0,,,,2,2,1,3
C(C)(C(C(C(CO)C(C)O)O)O)=O,,,5,1,3,0,3
9924_1,,,,2,2,1,3
9926_0,,,,2,2,1,3
C(CO)(CC(C(CO)C(C)O)O)=O,,,5,1,2,0,2
9928_0,,,,2,2,1,3
C(C(C(C(CO)C(C)O)O)O)=O,,,5,1,3,0,3
9928_1,,,,2,2,1,3
9930_0,,,,2,2,1,3
C(CC(C(C(CO)O)C(C)O)O)=O,,,5,1,2,0,2
9932_0,,,,2,2,1,3
C(CC(CC(C(C(C)O)O)O)O)=O,,,5,1,1,0,1
9933_0,,,,2,2,1,3
9933_1,,,,2,2,1,3
9934_0,,,,2,2,1,3
9934_1,,,,2,2,1,3
9935_0,,,,2,2,1,3
9935_1,,,,2,2,1,3
9937_0,,,,2,2,1,3
C(CC(C(CO)C(CCO)O)O)=O,,,5,1,2,0,2
9939_0,,,,2,2,1,3
C(CC(C)(C(C(CCO)O)O)O)=O,,,5,1,2,0,2
9940_0,,,,2,2,1,3
9942_0,,,,2,2,1,3
C(C(C(CCO)O)O)(CC(C)O)=O,,,5,1,4,0,4
9943_0,,,,2,2,1,3
9945_0,,,,2,2,1,3
C(CC(CO)(CC(CCO)O)O)=O,,,5,1,2,0,2
9946_0,,,,2,2,1,3
9946_1,,,,2,2,1,3
9948_0,,,,2,2,1,3
C(C(C(C)O)O)(CC(CCO)O)=O,,,5,1,4,0,4
9948_1,,,,2,2,1,3
9949_0,,,,2,2,1,3
9949_1,,,,2,2,1,3
9950_0,,,,2,2,1,3
9950_1,,,,2,2,1,3
9952_0,,,,2,2,1,3
C(CO)(C(C(C)O)C(CCO)O)=O,,,5,1,6,0,6
9952_1,,,,2,2,1,3
9953_0,,,,2,2,1,3
9953_1,,,,2,2,1,3
9954_0,,,,2,2,1,3
9954_1,,,,2,2,1,3
9955_0,,,,2,2,1,3
9955_1,,,,2,2,1,3
9957_0,,,,2,2,1,3
C(C(CC(CCO)O)(CC=O)O)=O,,,5,1,2,0,2
9958_0,,,,2,2,1,3
9960_0,,,,2,2,1,3
C(C(C(C=O)=O)C(CCO)O)(O)=O,,,5,1,4,0,4
9960_1,,,,2,2,1,3
9961_0,,,,2,2,1,3
9961_1,,,,2,2,1,3
9962_0,,,,2,2,1,3
9962_1,,,,2,2,1,3
9963_0,,,,2,2,1,3
9965_0,,,,2,2,1,3
C(C(C=C)C(CC(CCO)O)O)=O,,,5,1,1,0,1
9967_0,,,,2,2,1,3
C(C(CC(CC(CCO)O)O)=O)=O,,,5,1,2,0,2
9969_0,,,,2,2,1,3
C(C(C=O)C(CC(CCO)O)O)=O,,,5,1,3,0,3
9969_1,,,,2,2,1,3
9971_0,,,,2,2,1,3
C(CC(CC(CCO)O)O)=O,,,5,1,2,0,2
9973_0,,,,2,2,1,3
C(C(CO)C(CC(CCO)O)O)=O,,,5,1,3,0,3
9973_1,,,,2,2,1,3
9975_0,,,,2,2,1,3
C(C)(C(C(CC(CCO)O)O)O)=O,,,5,1,3,0,3
9975_1,,,,2,2,1,3
9977_0,,,,2,2,1,3
C(CO)(CC(CC(CCO)O)O)=O,,,5,1,2,0,2
9979_0,,,,2,2,1,3
C(C(C(CC(CCO)O)O)O)=O,,,5,1,3,0,3
9979_1,,,,2,2,1,3
9981_0,,,,2,2,1,3
C(C(C(C(C)O)O)C(CCO)O)=O,,,5,1,2,0,2
9981_1,,,,2,2,1,3
9982_0,,,,2,2,1,3
9982_1,,,,2,2,1,3
9984_0,,,,2,2,1,3
C(C(C(CCO)O)C(C=CC)O)=O,,,5,1,2,0,2
9984_1,,,,2,2,1,3
9986_0,,,,2,2,1,3
C(C(C(CC=C)O)C(CCO)O)=O,,,5,1,2,0,2
9986_1,,,,2,2,1,3
9988_0,,,,2,2,1,3
C(C(C(CCO)O)C(C=C)O)=O,,,5,1,2,0,2
9988_1,,,,2,2,1,3
9989_0,,,,2,2,1,3
9989_1,,,,2,2,1,3
9990_0,,,,2,2,1,3
9990_1,,,,2,2,1,3
9991_0,,,,2,2,1,3
9991_1,,,,2,2,1,3
9992_0,,,,2,2,1,3
9992_1,,,,2,2,1,3
9993_0,,,,2,2,1,3
9993_1,,,,2,2,1,3
9995_0,,,,2,2,1,3
C(C(C(CCO)O)C(CCO)O)=O,,,5,1,3,0,3
9995_1,,,,2,2,1,3
9997_0,,,,2,2,1,3
C(C(C(CCO)O)C(C)(CO)O)=O,,,5,1,6,0,6
9997_1,,,,2,2,1,3
9998_0,,,,2,2,1,3
9998_1,,,,2,2,1,3
9999_0,,,,2,2,1,3
9999_1,,,,2,2,1,3
10000_0,,,,2,2,1,3
10000_1,,,,2,2,1,3
10002_0,,,,2,2,1,3
C(CC(C(C(CCO)O)O)O)=O,,,5,1,3,0,3
10004_0,,,,2,2,1,3
C(C(C(C(C(CCO)O)O)O)O)=O,,,5,1,7,0,7
10004_1,,,,2,2,1,3
10005_0,,,,2,2,1,3
10005_1,,,,2,2,1,3
10007_0,,,,2,2,1,3
C(CC(C(CO)C(C)(CO)O)O)=O,,,5,1,2,0,2
10008_0,,,,2,2,1,3
10010_0,,,,2,2,1,3
C(C(C(C)=O)C(C(CO)CO)O)=O,,,5,1,2,0,2
10010_1,,,,2,2,1,3
10012_0,,,,2,2,1,3
C(CC(CC(C(CO)CO)O)=O)=O,,,5,1,1,0,1
10014_0,,,,2,2,1,3
C=CC(C(C(C(CO)CO)O)O)=O,,,5,1,2,0,2
10014_1,,,,2,2,1,3
10016_0,,,,2,2,1,3
C(C(C(C)C(C(CO)CO)O)=O)=O,,,5,1,1,0,1
10018_0,,,,2,2,1,3
C(C(C(C(CO)CO)O)CC=O)=O,,,5,1,1,0,1
10020_0,,,,2,2,1,3
C(C(C)=O)(CC(C(CO)CO)O)=O,,,5,1,1,0,1
10022_0,,,,2,2,1,3
C(C(C=C)C(C(CO)CO)O)=O,,,5,1,1,0,1
10024_0,,,,2,2,1,3
C1OC(C(C=1)=O)C(C(CO)CO)O,,,5,1,2,0,2
10024_1,,,,2,2,1,3
10026_0,,,,2,2,1,3
C(CO)(C(C(C(CO)CO)O)O)=O,,,5,1,3,0,3
10026_1,,,,2,2,1,3
10028_0,,,,2,2,1,3
C(C(CC(C(CO)CO)O)=O)=O,,,5,1,2,0,2
10030_0,,,,2,2,1,3
C(C(C=O)C(C(CO)CO)O)=O,,,5,1,3,0,3
10030_1,,,,2,2,1,3
10032_0,,,,2,2,1,3
C(CC(C(CO)CO)O)=O,,,5,1,2,0,2
10034_0,,,,2,2,1,3
C(C(C(C)O)C(C(CO)CO)O)=O,,,5,1,3,0,3
10034_1,,,,2,2,1,3
10036_0,,,,2,2,1,3
C(C(CO)C(C(CO)CO)O)=O,,,5,1,3,0,3
10036_1,,,,2,2,1,3
10038_0,,,,2,2,1,3
C(C(C(C(C(CO)CO)O)O)=O)=O,,,5,1,4,0,4
10038_1,,,,2,2,1,3
10040_0,,,,2,2,1,3
C(C)(C(C(C(CO)CO)O)O)=O,,,5,1,3,0,3
10040_1,,,,2,2,1,3
10042_0,,,,2,2,1,3
C(CO)(CC(C(CO)CO)O)=O,,,5,1,2,0,2
10044_0,,,,2,2,1,3
C(C(CC(C(CO)CO)O)=O)(O)=O,,,5,1,2,0,2
10046_0,,,,2,2,1,3
C(C(C=O)C(C(CO)CO)O)(O)=O,,,5,1,3,0,3
10046_1,,,,2,2,1,3
10048_0,,,,2,2,1,3
C(C(C(C(CO)CO)O)O)=O,,,5,1,4,0,4
10048_1,,,,2,2,1,3
10050_0,,,,2,2,1,3
C(CC(C(CO)C(CO)O)O)=O,,,5,1,3,0,3
10052_0,,,,2,2,1,3
C(C(C(C(CO)C(CO)O)O)O)=O,,,5,1,5,0,5
10052_1,,,,2,2,1,3
10054_0,,,,2,2,1,3
C(CC(CC(CC(CO)O)O)O)=O,,,5,1,2,0,2
10055_0,,,,2,2,1,3
10055_1,,,,2,2,1,3
10056_0,,,,2,2,1,3
10056_1,,,,2,2,1,3
10057_0,,,,2,2,1,3
10057_1,,,,2,2,1,3
10058_0,,,,2,2,1,3
10058_1,,,,2,2,1,3
10059_0,,,,2,2,1,3
10059_1,,,,2,2,1,3
10060_0,,,,2,2,1,3
10060_1,,,,2,2,1,3
10061_0,,,,2,2,1,3
10061_1,,,,2,2,1,3
10062_0,,,,2,2,1,3
10062_1,,,,2,2,1,3
10063_0,,,,2,2,1,3
10063_1,,,,2,2,1,3
10064_0,,,,2,2,1,3
10064_1,,,,2,2,1,3
10066_0,,,,2,2,1,3
C(CC(CC(C(CO)=O)O)O)=O,,,5,1,4,0,4
10068_0,,,,2,2,1,3
C(C(C(CC(C(CO)=O)O)O)O)=O,,,5,1,7,0,7
10068_1,,,,2,2,1,3
10069_0,,,,2,2,1,3
10070_0,,,,2,2,1,3
10070_1,,,,2,2,1,3
10071_0,,,,2,2,1,3
10071_1,,,,2,2,1,3
10073_0,,,,2,2,1,3
C(C(C(C=C)O)C(C(CO)=O)O)=O,,,5,1,2,0,2
10073_1,,,,2,2,1,3
10074_0,,,,2,2,1,3
10074_1,,,,2,2,1,3
10075_0,,,,2,2,1,3
10075_1,,,,2,2,1,3
10076_0,,,,2,2,1,3
10076_1,,,,2,2,1,3
10077_0,,,,2,2,1,3
10077_1,,,,2,2,1,3
10079_0,,,,2,2,1,3
C(C(C(C(CC=O)O)=O)O)(O)=O,,,5,1,4,0,4
10079_1,,,,2,2,1,3
10081_0,,,,2,2,1,3
C(CC(C(C(C(C=C)O)O)=O)O)=O,,,5,1,2,0,2
10081_1,,,,2,2,1,3
10083_0,,,,2,2,1,3
C(C(C(C(C(CC=O)O)=O)O)O)=O,,,5,1,5,0,5
10083_1,,,,2,2,1,3
10085_0,,,,2,2,1,3
C(CC(C(C(C(C)O)O)=O)O)=O,,,5,1,4,0,4
10085_1,,,,2,2,1,3
10086_0,,,,2,2,1,3
10086_1,,,,2,2,1,3
10087_0,,,,2,2,1,3
10087_1,,,,2,2,1,3
10088_0,,,,2,2,1,3
10090_0,,,,2,2,1,3
C(C(C(C(C=O)(CC=O)O)O)O)=O,,,5,1,5,0,5
10091_0,,,,2,2,1,3
10092_0,,,,2,2,1,3
10093_0,,,,2,2,1,3
10093_1,,,,2,2,1,3
10095_0,,,,2,2,1,3
C(C(C(C(C)O)O)(CC=O)O)=O,,,5,1,2,0,2
10097_0,,,,2,2,1,3
C(C(C(C(C)O)O)(C(C=O)O)O)=O,,,5,1,7,0,7
10097_1,,,,2,2,1,3
10098_0,,,,2,2,1,3
10099_0,,,,2,2,1,3
10099_1,,,,2,2,1,3
10100_0,,,,2,2,1,3
10100_1,,,,2,2,1,3
10102_0,,,,2,2,1,3
C(CC(CC(C(C)=O)(CO)O)O)=O,,,5,1,2,0,2
10104_0,,,,2,2,1,3
C(CC(C)(C(CO)(CC=O)O)O)=O,,,5,1,3,0,3
10105_0,,,,2,2,1,3
10105_1,,,,2,2,1,3
10106_0,,,,2,2,1,3
10106_1,,,,2,2,1,3
10107_0,,,,2,2,1,3
10107_1,,,,2,2,1,3
10109_0,,,,2,2,1,3
C(C(CO)(CC=O)O)(CC(O)=O)=O,,,5,1,2,0,2
10111_0,,,,2,2,1,3
C(C(CO)(CC=O)O)(CC(C)O)=O,,,5,1,3,0,3
10112_0,,,,2,2,1,3
10113_0,,,,2,2,1,3
10115_0,,,,2,2,1,3
C(CC(CC(C(CO)=O)(C)O)O)=O,,,5,1,2,0,2
10116_0,,,,2,2,1,3
10117_0,,,,2,2,1,3
10117_1,,,,2,2,1,3
10118_0,,,,2,2,1,3
10118_1,,,,2,2,1,3
10119_0,,,,2,2,1,3
10119_1,,,,2,2,1,3
10121_0,,,,2,2,1,3
C(C(C)(CC=O)O)(C(C(O)=O)O)=O,,,5,1,2,0,2
10121_1,,,,2,2,1,3
10123_0,,,,2,2,1,3
C(C(C)(CC=O)O)(C(C(C)O)O)=O,,,5,1,3,0,3
10123_1,,,,2,2,1,3
10125_0,,,,2,2,1,3
C(C(C)(CC=O)O)(C(CO)O)=O,,,5,1,3,0,3
10125_1,,,,2,2,1,3
10126_0,,,,2,2,1,3
10126_1,,,,2,2,1,3
10128_0,,,,2,2,1,3
C(C(C(C(C(CCO)=O)=O)O)O)=O,,,5,1,5,0,5
10130_0,,,,2,2,1,3
C(C)(C(C(C(C)O)O)(CC=O)O)=O,,,5,1,2,0,2
10131_0,,,,2,2,1,3
10133_0,,,,2,2,1,3
C(CC(C(C(C(C)O)O)=O)=O)(O)=O,,,5,1,1,0,1
10135_0,,,,2,2,1,3
C(C(C(C(C)O)O)=O)(CC(C)O)=O,,,5,1,3,0,3
10137_0,,,,2,2,1,3
C(C(C(C(C)O)O)=O)(CCO)=O,,,5,1,4,0,4
10138_0,,,,2,2,1,3
10139_0,,,,2,2,1,3
10139_1,,,,2,2,1,3
10140_0,,,,2,2,1,3
10141_0,,,,2,2,1,3
10141_1,,,,2,2,1,3
10143_0,,,,2,2,1,3
C(CC(C(C(CO)O)=O)=O)(O)=O,,,5,1,3,0,3
10145_0,,,,2,2,1,3
C=CC(CC(C(C(CO)O)=O)=O)O,,,5,1,1,0,1
10147_0,,,,2,2,1,3
C(C(CC(C(C(CO)O)=O)=O)O)=O,,,5,1,3,0,3
10149_0,,,,2,2,1,3
C(C(C(CO)O)=O)(CC(C)O)=O,,,5,1,3,0,3
10150_0,,,,2,2,1,3
10152_0,,,,2,2,1,3
C(C(C(CO)O)=O)(CC(CO)O)=O,,,5,1,6,0,6
10154_0,,,,2,2,1,3
C(C(C(C(CO)O)O)=O)(CCO)=O,,,5,1,6,0,6
10155_0,,,,2,2,1,3
10155_1,,,,2,2,1,3
10157_0,,,,2,2,1,3
C(C(C(C(C(CO)=O)=O)CO)O)=O,,,5,1,5,0,5
10157_1,,,,2,2,1,3
10158_0,,,,2,2,1,3
10160_0,,,,2,2,1,3
C(CO)(C(CC(C)O)(CC=O)O)=O,,,5,1,2,0,2
10162_0,,,,2,2,1,3
C(C(C(C(CC(C)O)=O)=O)O)(O)=O,,,5,1,2,0,2
10162_1,,,,2,2,1,3
10163_0,,,,2,2,1,3
10163_1,,,,2,2,1,3
10164_0,,,,2,2,1,3
10164_1,,,,2,2,1,3
10166_0,,,,2,2,1,3
C(C(C(C(CO)=O)=O)C(C)O)(O)=O,,,5,1,2,0,2
10166_1,,,,2,2,1,3
10168_0,,,,2,2,1,3
C(C(CO)=O)(C(C(C)O)C(C)O)=O,,,5,1,3,0,3
10168_1,,,,2,2,1,3
10170_0,,,,2,2,1,3
C(C(CO)=O)(C(CO)C(C)O)=O,,,5,1,5,0,5
10170_1,,,,2,2,1,3
10171_0,,,,2,2,1,3
10172_0,,,,2,2,1,3
10172_1,,,,2,2,1,3
10174_0,,,,2,2,1,3
C(CO)(C(CCO)(CC=O)O)=O,,,5,1,2,0,2
10176_0,,,,2,2,1,3
C(CO)(C(CCO)(C(C=O)O)O)=O,,,5,1,3,0,3
10176_1,,,,2,2,1,3
10178_0,,,,2,2,1,3
C(C(C(C(CCO)=O)=O)O)(O)=O,,,5,1,4,0,4
10178_1,,,,2,2,1,3
10180_0,,,,2,2,1,3
C=CC(C(C(C(CCO)=O)=O)O)O,,,5,1,2,0,2
10180_1,,,,2,2,1,3
10181_0,,,,2,2,1,3
10181_1,,,,2,2,1,3
10182_0,,,,2,2,1,3
10182_1,,,,2,2,1,3
10183_0,,,,2,2,1,3
10183_1,,,,2,2,1,3
10184_0,,,,2,2,1,3
10184_1,,,,2,2,1,3
10186_0,,,,2,2,1,3
C(C(C(C(CO)=O)=O)CO)(O)=O,,,5,1,3,0,3
10186_1,,,,2,2,1,3
10188_0,,,,2,2,1,3
C=CC(C(C(C(CO)=O)=O)CO)O,,,5,1,2,0,2
10188_1,,,,2,2,1,3
10189_0,,,,2,2,1,3
10189_1,,,,2,2,1,3
10190_0,,,,2,2,1,3
10190_1,,,,2,2,1,3
10191_0,,,,2,2,1,3
10191_1,,,,2,2,1,3
10193_0,,,,2,2,1,3
C(C(CO)=O)(C(CO)C(CO)O)=O,,,5,1,6,0,6
10193_1,,,,2,2,1,3
10194_0,,,,2,2,1,3
10194_1,,,,2,2,1,3
10195_0,,,,2,2,1,3
10195_1,,,,2,2,1,3
10197_0,,,,2,2,1,3
C(CC(CC(C(C(C)O)=O)O)O)=O,,,5,1,3,0,3
10198_0,,,,2,2,1,3
10199_0,,,,2,2,1,3
10199_1,,,,2,2,1,3
10200_0,,,,2,2,1,3
10200_1,,,,2,2,1,3
10201_0,,,,2,2,1,3
10201_1,,,,2,2,1,3
10203_0,,,,2,2,1,3
C(CC(C)(C(C(C)(CO)O)O)O)=O,,,5,1,1,0,1
10204_0,,,,2,2,1,3
10206_0,,,,2,2,1,3
C(C(C(CO)(C)O)O)(CC(C)O)=O,,,5,1,3,0,3
10207_0,,,,2,2,1,3
10209_0,,,,2,2,1,3
C(CC(CO)(CC(C)(CO)O)O)=O,,,5,1,1,0,1
10210_0,,,,2,2,1,3
10210_1,,,,2,2,1,3
10212_0,,,,2,2,1,3
C(C(C(C)O)O)(CC(CO)(C)O)=O,,,5,1,3,0,3
10212_1,,,,2,2,1,3
10213_0,,,,2,2,1,3
10213_1,,,,2,2,1,3
10214_0,,,,2,2,1,3
10214_1,,,,2,2,1,3
10216_0,,,,2,2,1,3
C(CO)(C(C(C)O)C(CO)(C)O)=O,,,5,1,5,0,5
10216_1,,,,2,2,1,3
10217_0,,,,2,2,1,3
10217_1,,,,2,2,1,3
10218_0,,,,2,2,1,3
10218_1,,,,2,2,1,3
10219_0,,,,2,2,1,3
10219_1,,,,2,2,1,3
10221_0,,,,2,2,1,3
C(C(CC(CO)(C)O)(CC=O)O)=O,,,5,1,2,0,2
10222_0,,,,2,2,1,3
10224_0,,,,2,2,1,3
C(C(C(C=O)=O)C(C)(CO)O)(O)=O,,,5,1,4,0,4
10224_1,,,,2,2,1,3
10225_0,,,,2,2,1,3
10225_1,,,,2,2,1,3
10226_0,,,,2,2,1,3
10226_1,,,,2,2,1,3
10227_0,,,,2,2,1,3
10229_0,,,,2,2,1,3
C(C(C=C)C(CC(C)(CO)O)O)=O,,,5,1,1,0,1
10231_0,,,,2,2,1,3
C(C(CC(CC(C)(CO)O)O)=O)=O,,,5,1,2,0,2
10233_0,,,,2,2,1,3
C(C(C=O)C(CC(C)(CO)O)O)=O,,,5,1,3,0,3
10233_1,,,,2,2,1,3
10235_0,,,,2,2,1,3
C(CC(CC(C)(CO)O)O)=O,,,5,1,2,0,2
10237_0,,,,2,2,1,3
C(C(CO)C(CC(C)(CO)O)O)=O,,,5,1,3,0,3
10237_1,,,,2,2,1,3
10239_0,,,,2,2,1,3
C(C)(C(C(CC(CO)(C)O)O)O)=O,,,5,1,3,0,3
10239_1,,,,2,2,1,3
10241_0,,,,2,2,1,3
C(CO)(CC(CC(CO)(C)O)O)=O,,,5,1,2,0,2
10243_0,,,,2,2,1,3
C(C(C(CC(CO)(C)O)O)O)=O,,,5,1,3,0,3
10243_1,,,,2,2,1,3
10245_0,,,,2,2,1,3
C(C(C(C(C)O)O)C(C)(CO)O)=O,,,5,1,2,0,2
10245_1,,,,2,2,1,3
10246_0,,,,2,2,1,3
10246_1,,,,2,2,1,3
10248_0,,,,2,2,1,3
C(C(C(CO)(C)O)C(C=CC)O)=O,,,5,1,2,0,2
10248_1,,,,2,2,1,3
10250_0,,,,2,2,1,3
C(C(C(CC=C)O)C(C)(CO)O)=O,,,5,1,2,0,2
10250_1,,,,2,2,1,3
10252_0,,,,2,2,1,3
C(C(C(CO)(C)O)C(C=C)O)=O,,,5,1,2,0,2
10252_1,,,,2,2,1,3
10253_0,,,,2,2,1,3
10253_1,,,,2,2,1,3
10254_0,,,,2,2,1,3
10254_1,,,,2,2,1,3
10255_0,,,,2,2,1,3
10255_1,,,,2,2,1,3
10256_0,,,,2,2,1,3
10256_1,,,,2,2,1,3
10257_0,,,,2,2,1,3
10257_1,,,,2,2,1,3
10258_0,,,,2,2,1,3
10258_1,,,,2,2,1,3
10260_0,,,,2,2,1,3
C(C(C(C)(CO)O)C(C)(CO)O)=O,,,5,1,3,0,3
10260_1,,,,2,2,1,3
10261_0,,,,2,2,1,3
10261_1,,,,2,2,1,3
10262_0,,,,2,2,1,3
10262_1,,,,2,2,1,3
10263_0,,,,2,2,1,3
10263_1,,,,2,2,1,3
10265_0,,,,2,2,1,3
C(CC(C(C(C)(CO)O)O)O)=O,,,5,1,2,0,2
10267_0,,,,2,2,1,3
C(C(C(C(C(CO)(C)O)O)O)O)=O,,,5,1,5,0,5
10267_1,,,,2,2,1,3
10268_0,,,,2,2,1,3
10269_0,,,,2,2,1,3
10270_0,,,,2,2,1,3
10271_0,,,,2,2,1,3
10272_0,,,,2,2,1,3
10273_0,,,,2,2,1,3
10274_0,,,,2,2,1,3
10275_0,,,,2,2,1,3
10277_0,,,,2,2,1,3
C(C(C)(C(C(C)(CC=O)O)O)O)=O,,,5,1,2,0,2
10278_0,,,,2,2,1,3
10280_0,,,,2,2,1,3
C(C(C)(C(C(CC(C)O)=O)O)O)=O,,,5,1,4,0,4
10281_0,,,,2,2,1,3
10282_0,,,,2,2,1,3
10283_0,,,,2,2,1,3
10284_0,,,,2,2,1,3
10285_0,,,,2,2,1,3
10287_0,,,,2,2,1,3
C(C(C=C)C(C)(C(C(C)O)O)O)=O,,,5,1,1,0,1
10289_0,,,,2,2,1,3
C(C(CC(C)(C(C(C)O)O)O)=O)=O,,,5,1,1,0,1
10291_0,,,,2,2,1,3
C(C(C=O)C(C)(C(C(C)O)O)O)=O,,,5,1,2,0,2
10291_1,,,,2,2,1,3
10293_0,,,,2,2,1,3
C(CC(C)(C(C(C)O)O)O)=O,,,5,1,1,0,1
10295_0,,,,2,2,1,3
C(C(CO)C(C)(C(C(C)O)O)O)=O,,,5,1,2,0,2
10295_1,,,,2,2,1,3
10297_0,,,,2,2,1,3
C(C)(C(C(C)(C(C(C)O)O)O)O)=O,,,5,1,2,0,2
10297_1,,,,2,2,1,3
10299_0,,,,2,2,1,3
C(CO)(CC(C)(C(C(C)O)O)O)=O,,,5,1,1,0,1
10301_0,,,,2,2,1,3
C(C(C(C)(C(C(C)O)O)O)O)=O,,,5,1,2,0,2
10301_1,,,,2,2,1,3
10303_0,,,,2,2,1,3
C(C(C(C)O)O)(CC(C(C)O)O)=O,,,5,1,1,0,1
10304_0,,,,2,2,1,3
10306_0,,,,2,2,1,3
C(CC(C=CC)O)(C(C(C)O)O)=O,,,5,1,1,0,1
10308_0,,,,2,2,1,3
C(C(C(C)O)O)(CC(CC=C)O)=O,,,5,1,1,0,1
10310_0,,,,2,2,1,3
C(CC(C=C)O)(C(C(C)O)O)=O,,,5,1,1,0,1
10311_0,,,,2,2,1,3
10313_0,,,,2,2,1,3
C(C(C)(CC(C(C(C)O)O)=O)O)=O,,,5,1,3,0,3
10315_0,,,,2,2,1,3
C(CC(C(C)=O)O)(C(C(C)O)O)=O,,,5,1,3,0,3
10316_0,,,,2,2,1,3
10318_0,,,,2,2,1,3
C(C(C(C)O)O)(CC(C)O)=O,,,5,1,3,0,3
10319_0,,,,2,2,1,3
10320_0,,,,2,2,1,3
10321_0,,,,2,2,1,3
10322_0,,,,2,2,1,3
10324_0,,,,2,2,1,3
C(C(C(C)O)O)(CC(CO)O)=O,,,5,1,4,0,4
10326_0,,,,2,2,1,3
C(CC(C)(C(C(CO)O)O)O)=O,,,5,1,3,0,3
10328_0,,,,2,2,1,3
C(C(C(C)(C(C(CO)O)O)O)O)=O,,,5,1,6,0,6
10328_1,,,,2,2,1,3
10329_0,,,,2,2,1,3
10331_0,,,,2,2,1,3
C(CC(C=C)O)(C(C(CO)O)O)=O,,,5,1,1,0,1
10332_0,,,,2,2,1,3
10334_0,,,,2,2,1,3
C(C(C(CO)O)O)(CC(C)O)=O,,,5,1,5,0,5
10335_0,,,,2,2,1,3
10337_0,,,,2,2,1,3
C(C(C(CO)O)O)(CC(CO)O)=O,,,5,1,7,0,7
10338_0,,,,2,2,1,3
10338_1,,,,2,2,1,3
10339_0,,,,2,2,1,3
10339_1,,,,2,2,1,3
10340_0,,,,2,2,1,3
10340_1,,,,2,2,1,3
10341_0,,,,2,2,1,3
10341_1,,,,2,2,1,3
10342_0,,,,2,2,1,3
10342_1,,,,2,2,1,3
10343_0,,,,2,2,1,3
10343_1,,,,2,2,1,3
10344_0,,,,2,2,1,3
10344_1,,,,2,2,1,3
10345_0,,,,2,2,1,3
10345_1,,,,2,2,1,3
10346_0,,,,2,2,1,3
10346_1,,,,2,2,1,3
10347_0,,,,2,2,1,3
10347_1,,,,2,2,1,3
10348_0,,,,2,2,1,3
10348_1,,,,2,2,1,3
10349_0,,,,2,2,1,3
10349_1,,,,2,2,1,3
10350_0,,,,2,2,1,3
10350_1,,,,2,2,1,3
10351_0,,,,2,2,1,3
10351_1,,,,2,2,1,3
10352_0,,,,2,2,1,3
10354_0,,,,2,2,1,3
C(C(C)(CC(CO)(CC=O)O)O)=O,,,5,1,2,0,2
10355_0,,,,2,2,1,3
10355_1,,,,2,2,1,3
10356_0,,,,2,2,1,3
10356_1,,,,2,2,1,3
10357_0,,,,2,2,1,3
10357_1,,,,2,2,1,3
10358_0,,,,2,2,1,3
10358_1,,,,2,2,1,3
10360_0,,,,2,2,1,3
C(C(C)(C(C(CO)=O)C(C)O)O)=O,,,5,1,5,0,5
10360_1,,,,2,2,1,3
10361_0,,,,2,2,1,3
10361_1,,,,2,2,1,3
10362_0,,,,2,2,1,3
10364_0,,,,2,2,1,3
C(CC(CO)(CC(C(C)=O)O)O)=O,,,5,1,2,0,2
10366_0,,,,2,2,1,3
C(CC(C(CC(CO)=O)O)=O)(O)=O,,,5,1,3,0,3
10367_0,,,,2,2,1,3
10368_0,,,,2,2,1,3
10369_0,,,,2,2,1,3
10369_1,,,,2,2,1,3
10370_0,,,,2,2,1,3
10370_1,,,,2,2,1,3
10371_0,,,,2,2,1,3
10371_1,,,,2,2,1,3
10372_0,,,,2,2,1,3
10372_1,,,,2,2,1,3
10374_0,,,,2,2,1,3
C(CO)(C(C(C)O)C(C(C)=O)O)=O,,,5,1,5,0,5
10374_1,,,,2,2,1,3
10375_0,,,,2,2,1,3
10375_1,,,,2,2,1,3
10377_0,,,,2,2,1,3
C(C(C=C)C(CO)(CC(C)O)O)=O,,,5,1,1,0,1
10379_0,,,,2,2,1,3
C(C(CC(CO)(CC(C)O)O)=O)=O,,,5,1,2,0,2
10381_0,,,,2,2,1,3
C(C(C=O)C(CO)(CC(C)O)O)=O,,,5,1,3,0,3
10381_1,,,,2,2,1,3
10383_0,,,,2,2,1,3
C(CC(CO)(CC(C)O)O)=O,,,5,1,2,0,2
10385_0,,,,2,2,1,3
C(C(CO)C(CO)(CC(C)O)O)=O,,,5,1,3,0,3
10385_1,,,,2,2,1,3
10387_0,,,,2,2,1,3
C(C)(C(C(CO)(CC(C)O)O)O)=O,,,5,1,3,0,3
10387_1,,,,2,2,1,3
10389_0,,,,2,2,1,3
C(CO)(CC(CO)(CC(C)O)O)=O,,,5,1,2,0,2
10391_0,,,,2,2,1,3
C(C(C(CO)(CC(C)O)O)O)=O,,,5,1,3,0,3
10391_1,,,,2,2,1,3
10393_0,,,,2,2,1,3
C(C(C(C(C)O)O)O)(CC(C)O)=O,,,5,1,2,0,2
10393_1,,,,2,2,1,3
10394_0,,,,2,2,1,3
10394_1,,,,2,2,1,3
10396_0,,,,2,2,1,3
C(C(C(C=CC)O)O)(CC(C)O)=O,,,5,1,2,0,2
10396_1,,,,2,2,1,3
10398_0,,,,2,2,1,3
C(C(C(CC=C)O)O)(CC(C)O)=O,,,5,1,2,0,2
10398_1,,,,2,2,1,3
10400_0,,,,2,2,1,3
C(C(C(C=C)O)O)(CC(C)O)=O,,,5,1,2,0,2
10400_1,,,,2,2,1,3
10401_0,,,,2,2,1,3
10401_1,,,,2,2,1,3
10402_0,,,,2,2,1,3
10402_1,,,,2,2,1,3
10403_0,,,,2,2,1,3
10403_1,,,,2,2,1,3
10404_0,,,,2,2,1,3
10404_1,,,,2,2,1,3
10405_0,,,,2,2,1,3
10405_1,,,,2,2,1,3
10406_0,,,,2,2,1,3
10406_1,,,,2,2,1,3
10407_0,,,,2,2,1,3
10407_1,,,,2,2,1,3
10408_0,,,,2,2,1,3
10408_1,,,,2,2,1,3
10409_0,,,,2,2,1,3
10409_1,,,,2,2,1,3
10410_0,,,,2,2,1,3
10410_1,,,,2,2,1,3
10412_0,,,,2,2,1,3
C(CO)(C(C(C)O)C(C(C)O)O)=O,,,5,1,2,0,2
10412_1,,,,2,2,1,3
10413_0,,,,2,2,1,3
10413_1,,,,2,2,1,3
10415_0,,,,2,2,1,3
C(CO)(C(C(C)O)C(C=CC)O)=O,,,5,1,2,0,2
10415_1,,,,2,2,1,3
10417_0,,,,2,2,1,3
C(CO)(C(C(CC=C)O)C(C)O)=O,,,5,1,2,0,2
10417_1,,,,2,2,1,3
10419_0,,,,2,2,1,3
C(CO)(C(C(C)O)C(C=C)O)=O,,,5,1,2,0,2
10419_1,,,,2,2,1,3
10420_0,,,,2,2,1,3
10420_1,,,,2,2,1,3
10421_0,,,,2,2,1,3
10421_1,,,,2,2,1,3
10422_0,,,,2,2,1,3
10422_1,,,,2,2,1,3
10423_0,,,,2,2,1,3
10423_1,,,,2,2,1,3
10425_0,,,,2,2,1,3
C(CO)(C(C(C)O)C(C)O)=O,,,5,1,3,0,3
10425_1,,,,2,2,1,3
10426_0,,,,2,2,1,3
10426_1,,,,2,2,1,3
10427_0,,,,2,2,1,3
10427_1,,,,2,2,1,3
10428_0,,,,2,2,1,3
10428_1,,,,2,2,1,3
10429_0,,,,2,2,1,3
10429_1,,,,2,2,1,3
10431_0,,,,2,2,1,3
C(CO)(C(C(CO)O)C(C)O)=O,,,5,1,6,0,6
10431_1,,,,2,2,1,3
10433_0,,,,2,2,1,3
C(CC(CO)(CC(CO)O)O)=O,,,5,1,3,0,3
10435_0,,,,2,2,1,3
C(C(C(CO)(CC(CO)O)O)O)=O,,,5,1,4,0,4
10435_1,,,,2,2,1,3
10436_0,,,,2,2,1,3
10436_1,,,,2,2,1,3
10438_0,,,,2,2,1,3
C(C(C(C=C)O)O)(CC(CO)O)=O,,,5,1,2,0,2
10438_1,,,,2,2,1,3
10439_0,,,,2,2,1,3
10439_1,,,,2,2,1,3
10440_0,,,,2,2,1,3
10440_1,,,,2,2,1,3
10441_0,,,,2,2,1,3
10441_1,,,,2,2,1,3
10442_0,,,,2,2,1,3
10442_1,,,,2,2,1,3
10443_0,,,,2,2,1,3
10443_1,,,,2,2,1,3
10445_0,,,,2,2,1,3
C(CO)(C(C(CO)O)C(C=C)O)=O,,,5,1,2,0,2
10445_1,,,,2,2,1,3
10446_0,,,,2,2,1,3
10446_1,,,,2,2,1,3
10447_0,,,,2,2,1,3
10447_1,,,,2,2,1,3
10448_0,,,,2,2,1,3
10448_1,,,,2,2,1,3
10450_0,,,,2,2,1,3
C(CO)(C(C(CO)O)C(CO)O)=O,,,5,1,4,0,4
10450_1,,,,2,2,1,3
10452_0,,,,2,2,1,3
C(CC(CC(CO)(CCO)O)O)=O,,,5,1,3,0,3
10453_0,,,,2,2,1,3
10453_1,,,,2,2,1,3
10454_0,,,,2,2,1,3
10454_1,,,,2,2,1,3
10455_0,,,,2,2,1,3
10455_1,,,,2,2,1,3
10457_0,,,,2,2,1,3
C(CC(CCO)(C(C(C)O)O)O)=O,,,5,1,2,0,2
10459_0,,,,2,2,1,3
C(C(C(C(C(C)O)O)=O)CO)(O)=O,,,5,1,7,0,7
10459_1,,,,2,2,1,3
10461_0,,,,2,2,1,3
C(C(C(C)O)O)(C(CO)C(C)O)=O,,,5,1,5,0,5
10461_1,,,,2,2,1,3
10463_0,,,,2,2,1,3
C(C(C(C)O)O)(C(CO)CO)=O,,,5,1,5,0,5
10463_1,,,,2,2,1,3
10465_0,,,,2,2,1,3
C(CC(CCO)(C(CO)O)O)=O,,,5,1,3,0,3
10467_0,,,,2,2,1,3
C(C(C(C(CO)O)(CCO)O)O)=O,,,5,1,5,0,5
10467_1,,,,2,2,1,3
10468_0,,,,2,2,1,3
10468_1,,,,2,2,1,3
10470_0,,,,2,2,1,3
C(C(CO)C(C=C)O)(C(CO)O)=O,,,5,1,2,0,2
10470_1,,,,2,2,1,3
10471_0,,,,2,2,1,3
10471_1,,,,2,2,1,3
10473_0,,,,2,2,1,3
C(C(CO)O)(C(CO)C(C)O)=O,,,5,1,9,0,9
10473_1,,,,2,2,1,3
10474_0,,,,2,2,1,3
10474_1,,,,2,2,1,3
10476_0,,,,2,2,1,3
C(C(CO)O)(C(CO)C(CO)O)=O,,,5,1,10,0,10
10476_1,,,,2,2,1,3
10478_0,,,,2,2,1,3
C(C(C(CO)O)O)(C(CO)CO)=O,,,5,1,7,0,7
10478_1,,,,2,2,1,3
10479_0,,,,2,2,1,3
10479_1,,,,2,2,1,3
10481_0,,,,2,2,1,3
C(CC(CO)(C(CO)C(C)O)O)=O,,,5,1,3,0,3
10482_0,,,,2,2,1,3
10482_1,,,,2,2,1,3
10483_0,,,,2,2,1,3
10483_1,,,,2,2,1,3
10484_0,,,,2,2,1,3
10484_1,,,,2,2,1,3
10486_0,,,,2,2,1,3
C(CC(CO)(C(CO)CO)O)=O,,,5,1,3,0,3
10488_0,,,,2,2,1,3
C(C(C(CO)(C(CO)CO)O)O)=O,,,5,1,4,0,4
10488_1,,,,2,2,1,3
10489_0,,,,2,2,1,3
10489_1,,,,2,2,1,3
10491_0,,,,2,2,1,3
C(C(C(C=C)O)O)(C(CO)CO)=O,,,5,1,2,0,2
10491_1,,,,2,2,1,3
10492_0,,,,2,2,1,3
10492_1,,,,2,2,1,3
10493_0,,,,2,2,1,3
10493_1,,,,2,2,1,3
10494_0,,,,2,2,1,3
10494_1,,,,2,2,1,3
10495_0,,,,2,2,1,3
10495_1,,,,2,2,1,3
10496_0,,,,2,2,1,3
10496_1,,,,2,2,1,3
10498_0,,,,2,2,1,3
C(CC(CC(C(CCO)O)O)O)=O,,,5,1,2,0,2
10499_0,,,,2,2,1,3
10499_1,,,,2,2,1,3
10500_0,,,,2,2,1,3
10500_1,,,,2,2,1,3
10501_0,,,,2,2,1,3
10501_1,,,,2,2,1,3
10503_0,,,,2,2,1,3
C(CC(CC(C)(C(CO)O)O)O)=O,,,5,1,2,0,2
10504_0,,,,2,2,1,3
10504_1,,,,2,2,1,3
10505_0,,,,2,2,1,3
10505_1,,,,2,2,1,3
10506_0,,,,2,2,1,3
10506_1,,,,2,2,1,3
10508_0,,,,2,2,1,3
C(CC(CC(C)O)(C(CO)O)O)=O,,,5,1,2,0,2
10509_0,,,,2,2,1,3
10509_1,,,,2,2,1,3
10511_0,,,,2,2,1,3
C(C(CO)O)(C(C(C)O)C(C)O)=O,,,5,1,3,0,3
10511_1,,,,2,2,1,3
10512_0,,,,2,2,1,3
10512_1,,,,2,2,1,3
10513_0,,,,2,2,1,3
10513_1,,,,2,2,1,3
10514_0,,,,2,2,1,3
10514_1,,,,2,2,1,3
10515_0,,,,2,2,1,3
10515_1,,,,2,2,1,3
10517_0,,,,2,2,1,3
C(C(CC(C=O)(CC=O)O)O)(O)=O,,,5,1,2,0,2
10518_0,,,,2,2,1,3
10520_0,,,,2,2,1,3
C(C(C(C=O)=O)C(C(O)=O)O)(O)=O,,,5,1,4,0,4
10520_1,,,,2,2,1,3
10521_0,,,,2,2,1,3
10521_1,,,,2,2,1,3
10522_0,,,,2,2,1,3
10522_1,,,,2,2,1,3
10523_0,,,,2,2,1,3
10524_0,,,,2,2,1,3
10524_1,,,,2,2,1,3
10526_0,,,,2,2,1,3
C(C(C)(CC(CC=O)O)O)(O)=O,,,5,1,2,0,2
10528_0,,,,2,2,1,3
C(C(C)(CC(C(C=O)O)O)O)(O)=O,,,5,1,4,0,4
10528_1,,,,2,2,1,3
10529_0,,,,2,2,1,3
10529_1,,,,2,2,1,3
10531_0,,,,2,2,1,3
C(C(C)(C(C=O)C(C=C)O)O)(O)=O,,,5,1,2,0,2
10531_1,,,,2,2,1,3
10532_0,,,,2,2,1,3
10532_1,,,,2,2,1,3
10533_0,,,,2,2,1,3
10533_1,,,,2,2,1,3
10534_0,,,,2,2,1,3
10534_1,,,,2,2,1,3
10535_0,,,,2,2,1,3
10535_1,,,,2,2,1,3
10536_0,,,,2,2,1,3
10537_0,,,,2,2,1,3
10539_0,,,,2,2,1,3
C(C(CC(C=O)O)(CC=O)O)(O)=O,,,5,1,2,0,2
10541_0,,,,2,2,1,3
C(C(C(C(O)=O)=O)C(C=O)O)(O)=O,,,5,1,2,0,2
10541_1,,,,2,2,1,3
10543_0,,,,2,2,1,3
C(C(C(C(C(O)=O)=O)C(C)O)O)=O,,,5,1,5,0,5
10543_1,,,,2,2,1,3
10544_0,,,,2,2,1,3
10544_1,,,,2,2,1,3
10545_0,,,,2,2,1,3
10545_1,,,,2,2,1,3
10546_0,,,,2,2,1,3
10547_0,,,,2,2,1,3
10547_1,,,,2,2,1,3
10548_0,,,,2,2,1,3
10548_1,,,,2,2,1,3
10549_0,,,,2,2,1,3
10549_1,,,,2,2,1,3
10551_0,,,,2,2,1,3
C(C(CC(C)O)(CC=O)O)(O)=O,,,5,1,2,0,2
10553_0,,,,2,2,1,3
C(C(CC(C)O)(C(C=O)O)O)(O)=O,,,5,1,4,0,4
10553_1,,,,2,2,1,3
10555_0,,,,2,2,1,3
C(C(C(C(O)=O)=O)C(C)O)(O)=O,,,5,1,3,0,3
10555_1,,,,2,2,1,3
10557_0,,,,2,2,1,3
C=CC(C(C(C(O)=O)=O)C(C)O)O,,,5,1,2,0,2
10557_1,,,,2,2,1,3
10558_0,,,,2,2,1,3
10558_1,,,,2,2,1,3
10560_0,,,,2,2,1,3
C(C(C(C(C)O)C(C)O)=O)(O)=O,,,5,1,3,0,3
10560_1,,,,2,2,1,3
10561_0,,,,2,2,1,3
10561_1,,,,2,2,1,3
10562_0,,,,2,2,1,3
10562_1,,,,2,2,1,3
10563_0,,,,2,2,1,3
10563_1,,,,2,2,1,3
10565_0,,,,2,2,1,3
C(CC(CC(CC=O)O)O)(O)=O,,,5,1,2,0,2
10567_0,,,,2,2,1,3
C(CC(CC(C(C=O)O)O)O)(O)=O,,,5,1,3,0,3
10567_1,,,,2,2,1,3
10568_0,,,,2,2,1,3
10568_1,,,,2,2,1,3
10570_0,,,,2,2,1,3
C(CC(C(C=O)C(C=C)O)O)(O)=O,,,5,1,2,0,2
10570_1,,,,2,2,1,3
10571_0,,,,2,2,1,3
10571_1,,,,2,2,1,3
10572_0,,,,2,2,1,3
10572_1,,,,2,2,1,3
10573_0,,,,2,2,1,3
10573_1,,,,2,2,1,3
10574_0,,,,2,2,1,3
10574_1,,,,2,2,1,3
10576_0,,,,2,2,1,3
C(CC(C(C(CC=O)O)O)O)(O)=O,,,5,1,2,0,2
10577_0,,,,2,2,1,3
10578_0,,,,2,2,1,3
10579_0,,,,2,2,1,3
10580_0,,,,2,2,1,3
10580_1,,,,2,2,1,3
10582_0,,,,2,2,1,3
C(C(C(CC=O)O)C(C)O)(O)=O,,,5,1,4,0,4
10584_0,,,,2,2,1,3
C(C(C(C(C=O)O)O)C(C)O)(O)=O,,,5,1,5,0,5
10584_1,,,,2,2,1,3
10586_0,,,,2,2,1,3
C(C(C=C)C(C(C(O)=O)CO)O)=O,,,5,1,2,0,2
10588_0,,,,2,2,1,3
C(C(CO)C(CC(C=O)=O)O)(O)=O,,,5,1,4,0,4
10590_0,,,,2,2,1,3
C(C(C=O)C(C(C(O)=O)CO)O)=O,,,5,1,5,0,5
10590_1,,,,2,2,1,3
10592_0,,,,2,2,1,3
C(C(CO)C(CC=O)O)(O)=O,,,5,1,5,0,5
10594_0,,,,2,2,1,3
C(C(CO)C(C(C=O)CO)O)(O)=O,,,5,1,6,0,6
10594_1,,,,2,2,1,3
10596_0,,,,2,2,1,3
C(C(CO)C(C(C(C)=O)O)O)(O)=O,,,5,1,6,0,6
10596_1,,,,2,2,1,3
10598_0,,,,2,2,1,3
C(C(CO)C(CC(CO)=O)O)(O)=O,,,5,1,5,0,5
10600_0,,,,2,2,1,3
C(C(CO)C(C(C=O)O)O)(O)=O,,,5,1,6,0,6
10600_1,,,,2,2,1,3
10602_0,,,,2,2,1,3
C(C(C(CC=O)O)C(CO)O)(O)=O,,,5,1,5,0,5
10603_0,,,,2,2,1,3
10603_1,,,,2,2,1,3
10605_0,,,,2,2,1,3
C(C(C(CO)CO)(CC=O)O)(O)=O,,,5,1,3,0,3
10606_0,,,,2,2,1,3
10606_1,,,,2,2,1,3
10607_0,,,,2,2,1,3
10607_1,,,,2,2,1,3
10608_0,,,,2,2,1,3
10608_1,,,,2,2,1,3
10609_0,,,,2,2,1,3
10609_1,,,,2,2,1,3
10611_0,,,,2,2,1,3
C(C(CO)C(CO)(CC=O)O)(O)=O,,,5,1,5,0,5
10613_0,,,,2,2,1,3
C(C(C(C(C(O)=O)O)=O)CO)(O)=O,,,5,1,4,0,4
10613_1,,,,2,2,1,3
10614_0,,,,2,2,1,3
10614_1,,,,2,2,1,3
10615_0,,,,2,2,1,3
10615_1,,,,2,2,1,3
10616_0,,,,2,2,1,3
10616_1,,,,2,2,1,3
10617_0,,,,2,2,1,3
10617_1,,,,2,2,1,3
10618_0,,,,2,2,1,3
10618_1,,,,2,2,1,3
10620_0,,,,2,2,1,3
C(CC(CC1(COCC1O)O)O)=O,,,5,1,1,0,1
10621_0,,,,2,2,1,3
10621_1,,,,2,2,1,3
10622_0,,,,2,2,1,3
10622_1,,,,2,2,1,3
10623_0,,,,2,2,1,3
10623_1,,,,2,2,1,3
10625_0,,,,2,2,1,3
C(CC1(C(C(C)O)OCC1O)O)=O,,,5,1,1,0,1
10627_0,,,,2,2,1,3
C(CC1(C(CO)OCC1O)O)=O,,,5,1,1,0,1
10629_0,,,,2,2,1,3
C(C(C1(C(CO)OCC1O)O)O)=O,,,5,1,2,0,2
10629_1,,,,2,2,1,3
10631_0,,,,2,2,1,3
C(CC(CC1(C(O)OCC1)O)O)=O,,,5,1,2,0,2
10632_0,,,,2,2,1,3
10632_1,,,,2,2,1,3
10633_0,,,,2,2,1,3
10633_1,,,,2,2,1,3
10634_0,,,,2,2,1,3
10634_1,,,,2,2,1,3
10636_0,,,,2,2,1,3
C(CC1(C(O)OCC1C(C)O)O)=O,,,5,1,2,0,2
10638_0,,,,2,2,1,3
C(CC1(C(O)OCC1CO)O)=O,,,5,1,2,0,2
10640_0,,,,2,2,1,3
C(C(C1(C(O)OCC1CO)O)O)=O,,,5,1,3,0,3
10640_1,,,,2,2,1,3
10642_0,,,,2,2,1,3
C(CC(CC1(COC(C1)O)O)O)=O,,,5,1,2,0,2
10643_0,,,,2,2,1,3
10643_1,,,,2,2,1,3
10644_0,,,,2,2,1,3
10644_1,,,,2,2,1,3
10645_0,,,,2,2,1,3
10645_1,,,,2,2,1,3
10647_0,,,,2,2,1,3
C1(C(CO)OC(C1C(C=O)O)O)=O,,,5,1,5,0,5
10647_1,,,,2,2,1,3
10649_0,,,,2,2,1,3
C(CC1(COC(C1C(C)O)O)O)=O,,,5,1,2,0,2
10651_0,,,,2,2,1,3
C(C1C(C(C(O1)O)C(C)O)=O)(O)=O,,,5,1,2,0,2
10651_1,,,,2,2,1,3
10653_0,,,,2,2,1,3
C1(C(C(C)O)OC(C1C(C)O)O)=O,,,5,1,5,0,5
10653_1,,,,2,2,1,3
10655_0,,,,2,2,1,3
C1(C(CO)OC(C1C(C)O)O)=O,,,5,1,6,0,6
10655_1,,,,2,2,1,3
10657_0,,,,2,2,1,3
C(CC1(COC(C1CO)O)O)=O,,,5,1,3,0,3
10659_0,,,,2,2,1,3
C(C(C1(COC(C1CO)O)O)O)=O,,,5,1,3,0,3
10659_1,,,,2,2,1,3
10661_0,,,,2,2,1,3
C(C1C(C(CO)C(O1)O)=O)(O)=O,,,5,1,2,0,2
10661_1,,,,2,2,1,3
10663_0,,,,2,2,1,3
C1(C(C(C=C)O)OC(C1CO)O)=O,,,5,1,2,0,2
10663_1,,,,2,2,1,3
10665_0,,,,2,2,1,3
C(C(C1C(C(C(O1)O)CO)=O)O)=O,,,5,1,5,0,5
10665_1,,,,2,2,1,3
10667_0,,,,2,2,1,3
C1(C(C(C)O)OC(C1CO)O)=O,,,5,1,5,0,5
10667_1,,,,2,2,1,3
10668_0,,,,2,2,1,3
10668_1,,,,2,2,1,3
10670_0,,,,2,2,1,3
C1(C(C(CO)O)OC(C1CO)O)=O,,,5,1,5,0,5
10670_1,,,,2,2,1,3
10672_0,,,,2,2,1,3
C1(C(CO)OC(C1C(CO)O)O)=O,,,5,1,5,0,5
10672_1,,,,2,2,1,3
10673_0,,,,2,2,1,3
10673_1,,,,2,2,1,3
10675_0,,,,2,2,1,3
C(CC1(C(C(C)O)OC(C1)O)O)=O,,,5,1,2,0,2
10677_0,,,,2,2,1,3
C(C1C(C(C(C)O)OC1O)=O)(O)=O,,,5,1,2,0,2
10677_1,,,,2,2,1,3
10678_0,,,,2,2,1,3
10678_1,,,,2,2,1,3
10679_0,,,,2,2,1,3
10679_1,,,,2,2,1,3
10681_0,,,,2,2,1,3
C(CC1(C(CO)OC(C1)O)O)=O,,,5,1,2,0,2
10683_0,,,,2,2,1,3
C(C(C1(C(CO)OC(C1)O)O)O)=O,,,5,1,3,0,3
10683_1,,,,2,2,1,3
10685_0,,,,2,2,1,3
C(C1C(C(CO)OC1O)=O)(O)=O,,,5,1,2,0,2
10685_1,,,,2,2,1,3
10687_0,,,,2,2,1,3
C1(C(CO)OC(C1C(C=C)O)O)=O,,,5,1,2,0,2
10687_1,,,,2,2,1,3
10688_0,,,,2,2,1,3
10688_1,,,,2,2,1,3
10689_0,,,,2,2,1,3
10689_1,,,,2,2,1,3
10690_0,,,,2,2,1,3
10690_1,,,,2,2,1,3
10691_0,,,,2,2,1,3
10691_1,,,,2,2,1,3
10692_0,,,,2,2,1,3
10692_1,,,,2,2,1,3
10693_0,,,,2,2,1,3
10693_1,,,,2,2,1,3
10695_0,,,,2,2,1,3
C(C(C=C)C(CC(C=O)(C=C)O)O)=O,,,5,1,1,0,1
10697_0,,,,2,2,1,3
C(C(C=C)(CC(CC=O)O)O)=O,,,5,1,3,0,3
10699_0,,,,2,2,1,3
C(C(C=C)(CC(C(C=O)O)O)O)=O,,,5,1,2,0,2
10699_1,,,,2,2,1,3
10701_0,,,,2,2,1,3
C(C(C=C)C(C(C=C)(CC=O)O)O)=O,,,5,1,1,0,1
10703_0,,,,2,2,1,3
C(CC(C(C=C)(CC=O)O)O)=O,,,5,1,4,0,4
10705_0,,,,2,2,1,3
C(C(C(C(C=C)(CC=O)O)O)O)=O,,,5,1,3,0,3
10705_1,,,,2,2,1,3
10706_0,,,,2,2,1,3
10706_1,,,,2,2,1,3
10708_0,,,,2,2,1,3
C(C(C=C)(C(C=O)C(C=CC)O)O)=O,,,5,1,2,0,2
10708_1,,,,2,2,1,3
10710_0,,,,2,2,1,3
C(C(C=C)(C(C=O)C(CC=C)O)O)=O,,,5,1,2,0,2
10710_1,,,,2,2,1,3
10712_0,,,,2,2,1,3
C(C(C=C)(C(C=O)C(C=C)O)O)=O,,,5,1,2,0,2
10712_1,,,,2,2,1,3
10713_0,,,,2,2,1,3
10713_1,,,,2,2,1,3
10714_0,,,,2,2,1,3
10714_1,,,,2,2,1,3
10715_0,,,,2,2,1,3
10715_1,,,,2,2,1,3
10716_0,,,,2,2,1,3
10716_1,,,,2,2,1,3
10718_0,,,,2,2,1,3
C(C(C=C)(C(C(CC=O)O)O)O)=O,,,5,1,2,0,2
10720_0,,,,2,2,1,3
C(CC(C(C=C)(C(C=O)O)O)O)=O,,,5,1,3,0,3
10721_0,,,,2,2,1,3
10721_1,,,,2,2,1,3
10723_0,,,,2,2,1,3
C(C(C=C)C(CC(C(C=C)=O)O)O)=O,,,5,1,1,0,1
10725_0,,,,2,2,1,3
C(CC(CC(C(C=C)=O)O)O)=O,,,5,1,2,0,2
10727_0,,,,2,2,1,3
C(C(C(CC(C(C=C)=O)O)O)O)=O,,,5,1,2,0,2
10727_1,,,,2,2,1,3
10729_0,,,,2,2,1,3
C(CC(C(C=C)(C(C=O)C=C)O)O)=O,,,5,1,1,0,1
10730_0,,,,2,2,1,3
10731_0,,,,2,2,1,3
10731_1,,,,2,2,1,3
10732_0,,,,2,2,1,3
10732_1,,,,2,2,1,3
10734_0,,,,2,2,1,3
C(C(C(C=CC)O)C(C(C=C)=O)O)=O,,,5,1,2,0,2
10734_1,,,,2,2,1,3
10736_0,,,,2,2,1,3
C(C(C(CC=C)O)C(C(C=C)=O)O)=O,,,5,1,2,0,2
10736_1,,,,2,2,1,3
10738_0,,,,2,2,1,3
C(C(C(C=C)O)C(C(C=C)=O)O)=O,,,5,1,2,0,2
10738_1,,,,2,2,1,3
10739_0,,,,2,2,1,3
10739_1,,,,2,2,1,3
10740_0,,,,2,2,1,3
10740_1,,,,2,2,1,3
10741_0,,,,2,2,1,3
10741_1,,,,2,2,1,3
10742_0,,,,2,2,1,3
10742_1,,,,2,2,1,3
10744_0,,,,2,2,1,3
C(CC(C(C(C(C=C)=O)O)O)O)=O,,,5,1,3,0,3
10745_0,,,,2,2,1,3
10746_0,,,,2,2,1,3
10746_1,,,,2,2,1,3
10748_0,,,,2,2,1,3
C(C(C=C)C(CC(C=CC=O)O)O)=O,,,5,1,1,0,1
10750_0,,,,2,2,1,3
C(CC(CC(C=CC=O)O)O)=O,,,5,1,3,0,3
10752_0,,,,2,2,1,3
C(C(C(CC(C=CC=O)O)O)O)=O,,,5,1,2,0,2
10752_1,,,,2,2,1,3
10754_0,,,,2,2,1,3
C(C(C=C)C(C=CC(CC=O)O)O)=O,,,5,1,1,0,1
10756_0,,,,2,2,1,3
C(CC(C=CC(CC=O)O)O)=O,,,5,1,2,0,2
10758_0,,,,2,2,1,3
C(C(C(C=CC(CC=O)O)O)O)=O,,,5,1,3,0,3
10758_1,,,,2,2,1,3
10759_0,,,,2,2,1,3
10759_1,,,,2,2,1,3
10761_0,,,,2,2,1,3
C(C(C(C=CC)O)C(C=CC=O)O)=O,,,5,1,2,0,2
10761_1,,,,2,2,1,3
10763_0,,,,2,2,1,3
C(C(C(CC=C)O)C(C=CC=O)O)=O,,,5,1,2,0,2
10763_1,,,,2,2,1,3
10765_0,,,,2,2,1,3
C(C(C(C=C)O)C(C=CC=O)O)=O,,,5,1,2,0,2
10765_1,,,,2,2,1,3
10766_0,,,,2,2,1,3
10766_1,,,,2,2,1,3
10767_0,,,,2,2,1,3
10767_1,,,,2,2,1,3
10768_0,,,,2,2,1,3
10768_1,,,,2,2,1,3
10769_0,,,,2,2,1,3
10769_1,,,,2,2,1,3
10771_0,,,,2,2,1,3
C(CC(C(C(C=CC=O)O)O)O)=O,,,5,1,1,0,1
10772_0,,,,2,2,1,3
10773_0,,,,2,2,1,3
10774_0,,,,2,2,1,3
10776_0,,,,2,2,1,3
C(C(C=C)C(C(CO)=O)(CO)O)=O,,,5,1,1,0,1
10778_0,,,,2,2,1,3
C(CO)(C(CO)(CC(C=O)=O)O)=O,,,5,1,2,0,2
10780_0,,,,2,2,1,3
C(C(C=O)C(C(CO)=O)(CO)O)=O,,,5,1,3,0,3
10780_1,,,,2,2,1,3
10781_0,,,,2,2,1,3
10783_0,,,,2,2,1,3
C(C(CO)C(C(CO)=O)(CO)O)=O,,,5,1,8,0,8
10783_1,,,,2,2,1,3
10784_0,,,,2,2,1,3
10784_1,,,,2,2,1,3
10786_0,,,,2,2,1,3
C(CO)(C(CO)(CC(CO)=O)O)=O,,,5,1,5,0,5
10787_0,,,,2,2,1,3
10787_1,,,,2,2,1,3
10789_0,,,,2,2,1,3
C(C(CO)=O)(C(C(C(C)O)O)O)=O,,,5,1,2,0,2
10789_1,,,,2,2,1,3
10791_0,,,,2,2,1,3
C(C(C(C(CO)=O)=O)O)(O)=O,,,5,1,4,0,4
10791_1,,,,2,2,1,3
10793_0,,,,2,2,1,3
C(C)=CC(C(C(C(CO)=O)=O)O)O,,,5,1,2,0,2
10793_1,,,,2,2,1,3
10795_0,,,,2,2,1,3
C(CC(C(C(C(CO)=O)=O)O)O)=C,,,5,1,2,0,2
10795_1,,,,2,2,1,3
10797_0,,,,2,2,1,3
C=CC(C(C(C(CO)=O)=O)O)O,,,5,1,2,0,2
10797_1,,,,2,2,1,3
10799_0,,,,2,2,1,3
C(C(C(C(C(CO)=O)=O)O)O)=O,,,5,1,2,0,2
10799_1,,,,2,2,1,3
10801_0,,,,2,2,1,3
C(C(C)(C(C(C(CO)=O)=O)O)O)=O,,,5,1,2,0,2
10801_1,,,,2,2,1,3
10803_0,,,,2,2,1,3
C(C)(C(C(C(C(CO)=O)=O)O)O)=O,,,5,1,2,0,2
10803_1,,,,2,2,1,3
10805_0,,,,2,2,1,3
C(CC(C(C(C(CO)=O)=O)O)O)=O,,,5,1,3,0,3
10805_1,,,,2,2,1,3
10807_0,,,,2,2,1,3
C(C(CO)=O)(C(C(C)O)O)=O,,,5,1,4,0,4
10807_1,,,,2,2,1,3
10809_0,,,,2,2,1,3
C(C(CO)=O)(C(C(CCO)O)O)=O,,,5,1,4,0,4
10809_1,,,,2,2,1,3
10811_0,,,,2,2,1,3
C(C(CO)=O)(C(C(CO)(C)O)O)=O,,,5,1,2,0,2
10811_1,,,,2,2,1,3
10813_0,,,,2,2,1,3
C(C(C(C(C(CO)=O)=O)O)O)(O)=O,,,5,1,2,0,2
10813_1,,,,2,2,1,3
10814_0,,,,2,2,1,3
10814_1,,,,2,2,1,3
10815_0,,,,2,2,1,3
10815_1,,,,2,2,1,3
10816_0,,,,2,2,1,3
10818_0,,,,2,2,1,3
C(CO)(C(C(CO)O)(CC=O)O)=O,,,5,1,3,0,3
10820_0,,,,2,2,1,3
C(C(C(C(C(CO)O)=O)=O)O)(O)=O,,,5,1,3,0,3
10820_1,,,,2,2,1,3
10822_0,,,,2,2,1,3
C(C(C(CO)O)=O)(C(C(C)O)O)=O,,,5,1,4,0,4
10822_1,,,,2,2,1,3
10823_0,,,,2,2,1,3
10823_1,,,,2,2,1,3
10825_0,,,,2,2,1,3
C(C(C(C)=O)C(C=O)(CC=O)O)=O,,,5,1,3,0,3
10825_1,,,,2,2,1,3
10827_0,,,,2,2,1,3
C(CC(CC(C=O)(CC=O)O)=O)=O,,,5,1,2,0,2
10828_0,,,,2,2,1,3
10828_1,,,,2,2,1,3
10830_0,,,,2,2,1,3
C(CC(C=O)(C(C(C=O)=O)C)O)=O,,,5,1,1,0,1
10831_0,,,,2,2,1,3
10833_0,,,,2,2,1,3
C(CC(C=O)(CC(C(C)=O)=O)O)=O,,,5,1,1,0,1
10835_0,,,,2,2,1,3
C(C(C(C=O)=C)C(C=O)(CC=O)O)=O,,,5,1,1,0,1
10837_0,,,,2,2,1,3
C(CC(C=O)(CC(C=CC=O)=O)O)=O,,,5,1,1,0,1
10839_0,,,,2,2,1,3
C(CC(C=O)(C(C=C)C(C=O)=O)O)=O,,,5,1,1,0,1
10841_0,,,,2,2,1,3
C(C(C=CC=O)C(C=O)(CC=O)O)=O,,,5,1,1,0,1
10843_0,,,,2,2,1,3
C(C(C=C)C(C=O)(CC=O)O)=O,,,5,1,1,0,1
10845_0,,,,2,2,1,3
C(CC(C=O)(C1C(C=CO1)=O)O)=O,,,5,1,2,0,2
10845_1,,,,2,2,1,3
10846_0,,,,2,2,1,3
10846_1,,,,2,2,1,3
10848_0,,,,2,2,1,3
C(CC(C=O)(CC(C=O)=O)O)=O,,,5,1,2,0,2
10850_0,,,,2,2,1,3
C(C(C=O)C(C=O)(CC=O)O)=O,,,5,1,4,0,4
10850_1,,,,2,2,1,3
10851_0,,,,2,2,1,3
10853_0,,,,2,2,1,3
C(CC(C=O)(C(C=O)C(C)O)O)=O,,,5,1,4,0,4
10853_1,,,,2,2,1,3
10854_0,,,,2,2,1,3
10854_1,,,,2,2,1,3
10856_0,,,,2,2,1,3
C(CC(C=O)(C(C(C=O)=O)O)O)=O,,,5,1,2,0,2
10856_1,,,,2,2,1,3
10857_0,,,,2,2,1,3
10857_1,,,,2,2,1,3
10858_0,,,,2,2,1,3
10860_0,,,,2,2,1,3
C(CC(C=O)(CC(C(O)=O)=O)O)=O,,,5,1,1,0,1
10862_0,,,,2,2,1,3
C(C(C=O)C(C=O)(CC=O)O)(O)=O,,,5,1,4,0,4
10862_1,,,,2,2,1,3
10863_0,,,,2,2,1,3
10863_1,,,,2,2,1,3
10865_0,,,,2,2,1,3
C(C(C(C)=O)C(C(CC=O)=O)O)=O,,,5,1,2,0,2
10865_1,,,,2,2,1,3
10867_0,,,,2,2,1,3
C(CC(CC(C(CC=O)=O)O)=O)=O,,,5,1,1,0,1
10868_0,,,,2,2,1,3
10868_1,,,,2,2,1,3
10870_0,,,,2,2,1,3
C(CC(C(C(C(C=O)=O)C)O)=O)=O,,,5,1,1,0,1
10871_0,,,,2,2,1,3
10873_0,,,,2,2,1,3
C(CC(C(CC(C(C)=O)=O)O)=O)=O,,,5,1,1,0,1
10875_0,,,,2,2,1,3
C(C(C(C=O)=C)C(C(CC=O)=O)O)=O,,,5,1,1,0,1
10877_0,,,,2,2,1,3
C(CC(C(CC(C=CC=O)=O)O)=O)=O,,,5,1,1,0,1
10879_0,,,,2,2,1,3
C(CC(C(C(C=C)C(C=O)=O)O)=O)=O,,,5,1,1,0,1
10881_0,,,,2,2,1,3
C(C(C=CC=O)C(C(CC=O)=O)O)=O,,,5,1,1,0,1
10883_0,,,,2,2,1,3
C(C(C=C)C(C(CC=O)=O)O)=O,,,5,1,1,0,1
10885_0,,,,2,2,1,3
C(CC(C(C1C(C=CO1)=O)O)=O)=O,,,5,1,2,0,2
10885_1,,,,2,2,1,3
10886_0,,,,2,2,1,3
10886_1,,,,2,2,1,3
10888_0,,,,2,2,1,3
C(CC(C(CC(C=O)=O)O)=O)=O,,,5,1,3,0,3
10890_0,,,,2,2,1,3
C(C(C=O)C(C(CC=O)=O)O)=O,,,5,1,5,0,5
10890_1,,,,2,2,1,3
10891_0,,,,2,2,1,3
10893_0,,,,2,2,1,3
C(C(C(C)O)C(C(CC=O)=O)O)=O,,,5,1,4,0,4
10893_1,,,,2,2,1,3
10894_0,,,,2,2,1,3
10894_1,,,,2,2,1,3
10896_0,,,,2,2,1,3
C(CC(C(C(C(C=O)=O)O)O)=O)=O,,,5,1,2,0,2
10896_1,,,,2,2,1,3
10897_0,,,,2,2,1,3
10897_1,,,,2,2,1,3
10898_0,,,,2,2,1,3
10900_0,,,,2,2,1,3
C(CC(C(CC(C(O)=O)=O)O)=O)=O,,,5,1,1,0,1
10902_0,,,,2,2,1,3
C(C(C=O)C(C(CC=O)=O)O)(O)=O,,,5,1,4,0,4
10902_1,,,,2,2,1,3
10903_0,,,,2,2,1,3
10903_1,,,,2,2,1,3
10905_0,,,,2,2,1,3
C(C(C(C)=O)C(CC(C=O)=O)O)=O,,,5,1,3,0,3
10905_1,,,,2,2,1,3
10907_0,,,,2,2,1,3
C(CC(CC(CC(C=O)=O)O)=O)=O,,,5,1,2,0,2
10909_0,,,,2,2,1,3
C=CC(C(C(CC(C=O)=O)O)O)=O,,,5,1,3,0,3
10909_1,,,,2,2,1,3
10911_0,,,,2,2,1,3
C(C=O)(C(C)C(CC(C=O)=O)O)=O,,,5,1,2,0,2
10912_0,,,,2,2,1,3
10914_0,,,,2,2,1,3
C(C=O)(CC(CC(C(C)=O)=O)O)=O,,,5,1,2,0,2
10916_0,,,,2,2,1,3
C(C(C(C=O)=C)C(CC(C=O)=O)O)=O,,,5,1,2,0,2
10918_0,,,,2,2,1,3
C(C(CC(CC(C=CC=O)=O)O)=O)=O,,,5,1,1,0,1
10920_0,,,,2,2,1,3
C=CC(C(C=O)=O)C(CC(C=O)=O)O,,,5,1,1,0,1
10922_0,,,,2,2,1,3
C(C(C=CC=O)C(CC(C=O)=O)O)=O,,,5,1,2,0,2
10924_0,,,,2,2,1,3
C(C(C=C)C(CC(C=O)=O)O)=O,,,5,1,3,0,3
10926_0,,,,2,2,1,3
C1OC(C(C=1)=O)C(CC(C=O)=O)O,,,5,1,2,0,2
10926_1,,,,2,2,1,3
10928_0,,,,2,2,1,3
C(CO)(C(C(CC(C=O)=O)O)O)=O,,,5,1,5,0,5
10928_1,,,,2,2,1,3
10930_0,,,,2,2,1,3
C(C(CC(CC(C=O)=O)O)=O)=O,,,5,1,3,0,3
10932_0,,,,2,2,1,3
C(C(C=O)C(CC(C=O)=O)O)=O,,,5,1,5,0,5
10932_1,,,,2,2,1,3
10933_0,,,,2,2,1,3
10934_0,,,,2,2,1,3
10934_1,,,,2,2,1,3
10935_0,,,,2,2,1,3
10935_1,,,,2,2,1,3
10937_0,,,,2,2,1,3
C(C=O)(CC(C(C(C=O)=O)O)O)=O,,,5,1,3,0,3
10937_1,,,,2,2,1,3
10938_0,,,,2,2,1,3
10938_1,,,,2,2,1,3
10939_0,,,,2,2,1,3
10941_0,,,,2,2,1,3
C(C(CC(CC(C=O)=O)O)=O)(O)=O,,,5,1,2,0,2
10943_0,,,,2,2,1,3
C(C(C=O)C(CC(C=O)=O)O)(O)=O,,,5,1,4,0,4
10943_1,,,,2,2,1,3
10945_0,,,,2,2,1,3
C(C(C(CC(C=O)=O)O)O)=O,,,5,1,10,0,10
10945_1,,,,2,2,1,3
10947_0,,,,2,2,1,3
C(C(C(C=O)=O)C(C(C)O)O)=O,,,5,1,2,0,2
10947_1,,,,2,2,1,3
10949_0,,,,2,2,1,3
C(C(C(C=O)=O)C(C(C=O)O)O)=O,,,5,1,2,0,2
10949_1,,,,2,2,1,3
10951_0,,,,2,2,1,3
C(C(C(C=O)=O)C(CC(C)=O)O)=O,,,5,1,2,0,2
10951_1,,,,2,2,1,3
10953_0,,,,2,2,1,3
C(C(C(C=O)=O)C(C)(CC=O)O)=O,,,5,1,3,0,3
10953_1,,,,2,2,1,3
10955_0,,,,2,2,1,3
C(C(C(O)=O)C(C=O)=O)=O,,,5,1,3,0,3
10955_1,,,,2,2,1,3
10957_0,,,,2,2,1,3
C(C(C(C=O)=O)C(C=C)(CO)O)=O,,,5,1,2,0,2
10957_1,,,,2,2,1,3
10959_0,,,,2,2,1,3
C(C(C(C=O)=O)C(C=CCO)O)=O,,,5,1,2,0,2
10959_1,,,,2,2,1,3
10961_0,,,,2,2,1,3
C(C(C(C=O)=O)C(C=O)(CC)O)=O,,,5,1,2,0,2
10961_1,,,,2,2,1,3
10963_0,,,,2,2,1,3
C(C(C(C=O)=O)C(C(CC)=O)O)=O,,,5,1,2,0,2
10963_1,,,,2,2,1,3
10965_0,,,,2,2,1,3
C(C(C(C=O)=O)C(CCC=O)O)=O,,,5,1,3,0,3
10965_1,,,,2,2,1,3
10967_0,,,,2,2,1,3
C(C(C(C=O)=O)C(C(C)=O)(C)O)=O,,,5,1,2,0,2
10967_1,,,,2,2,1,3
10969_0,,,,2,2,1,3
C(C(C(C=O)=O)C(C=C(C=O)C)O)=O,,,5,1,2,0,2
10969_1,,,,2,2,1,3
10971_0,,,,2,2,1,3
C(C(C(C=O)=O)C(C(C)=CC=O)O)=O,,,5,1,2,0,2
10971_1,,,,2,2,1,3
10973_0,,,,2,2,1,3
C(C(C(C=O)=O)C(CC(C=O)=C)O)=O,,,5,1,2,0,2
10973_1,,,,2,2,1,3
10975_0,,,,2,2,1,3
C(C(C(C=O)=O)C(C(CC=O)=C)O)=O,,,5,1,2,0,2
10975_1,,,,2,2,1,3
10977_0,,,,2,2,1,3
C(C(C(C=O)=O)C(C=CC(C)=O)O)=O,,,5,1,2,0,2
10977_1,,,,2,2,1,3
10979_0,,,,2,2,1,3
C(C(C(C=O)=O)C(C=CC=O)(C)O)=O,,,5,1,2,0,2
10979_1,,,,2,2,1,3
10981_0,,,,2,2,1,3
C(C(C(C=O)=O)C(C=O)(CC=C)O)=O,,,5,1,2,0,2
10981_1,,,,2,2,1,3
10983_0,,,,2,2,1,3
C(C(C(C=O)=O)C(C(CC=C)=O)O)=O,,,5,1,2,0,2
10983_1,,,,2,2,1,3
10985_0,,,,2,2,1,3
C(C(C(C=O)=O)C(C=O)(C=CC)O)=O,,,5,1,2,0,2
10985_1,,,,2,2,1,3
10987_0,,,,2,2,1,3
C(C(C(C=O)=O)C(C(C=CC)=O)O)=O,,,5,1,2,0,2
10987_1,,,,2,2,1,3
10989_0,,,,2,2,1,3
C(C(C(C=O)=O)C(C=CCC=O)O)=O,,,5,1,2,0,2
10989_1,,,,2,2,1,3
10991_0,,,,2,2,1,3
C(C(C(C=O)=O)C(CC=CC=O)O)=O,,,5,1,2,0,2
10991_1,,,,2,2,1,3
10993_0,,,,2,2,1,3
C(C(C=C)C(C(C=O)C(C=O)=O)O)=O,,,5,1,2,0,2
10993_1,,,,2,2,1,3
10995_0,,,,2,2,1,3
C(C(C(C=O)=O)C(C(C=O)=CC)O)=O,,,5,1,2,0,2
10995_1,,,,2,2,1,3
10997_0,,,,2,2,1,3
C(C(C(C=O)=O)C(C(C=O)=C)O)=O,,,5,1,2,0,2
10997_1,,,,2,2,1,3
10999_0,,,,2,2,1,3
C(C(C(C=O)=O)C(C=CC)O)=O,,,5,1,2,0,2
10999_1,,,,2,2,1,3
11001_0,,,,2,2,1,3
C(C(C(C=O)=O)C(CC=C)O)=O,,,5,1,2,0,2
11001_1,,,,2,2,1,3
11003_0,,,,2,2,1,3
C(C(C(C=O)=O)C(C(C=C)O)O)=O,,,5,1,2,0,2
11003_1,,,,2,2,1,3
11005_0,,,,2,2,1,3
C(C(C(C=O)=O)C(C=C)O)=O,,,5,1,2,0,2
11005_1,,,,2,2,1,3
11007_0,,,,2,2,1,3
C(C(C(C=O)=O)C1(C=COC1)O)=O,,,5,1,2,0,2
11007_1,,,,2,2,1,3
11009_0,,,,2,2,1,3
C(C(C(C=O)=O)C(C(CO)O)O)=O,,,5,1,2,0,2
11009_1,,,,2,2,1,3
11011_0,,,,2,2,1,3
C(C(C(C=O)=O)C(C=O)O)=O,,,5,1,5,0,5
11011_1,,,,2,2,1,3
11013_0,,,,2,2,1,3
C(C(C(C=O)=O)C(CO)(CO)O)=O,,,5,1,2,0,2
11013_1,,,,2,2,1,3
11015_0,,,,2,2,1,3
C(C(C(C=O)=O)C(C=O)(C)O)=O,,,5,1,5,0,5
11015_1,,,,2,2,1,3
11017_0,,,,2,2,1,3
C(C(C(C=O)=O)C(C(C)=O)O)=O,,,5,1,5,0,5
11017_1,,,,2,2,1,3
11019_0,,,,2,2,1,3
C(C(C(C=O)=O)C(CC=O)O)=O,,,5,1,5,0,5
11019_1,,,,2,2,1,3
11021_0,,,,2,2,1,3
C(C(C(C=O)=O)C(C)O)=O,,,5,1,6,0,6
11021_1,,,,2,2,1,3
11023_0,,,,2,2,1,3
C(C(C(C=O)=O)C(CC(C)O)O)=O,,,5,1,2,0,2
11023_1,,,,2,2,1,3
11025_0,,,,2,2,1,3
C(C(C(C=O)=O)C(CCO)O)=O,,,5,1,5,0,5
11025_1,,,,2,2,1,3
11027_0,,,,2,2,1,3
C(C(C(C=O)=O)C(C=O)(CO)O)=O,,,5,1,2,0,2
11027_1,,,,2,2,1,3
11029_0,,,,2,2,1,3
C(C(C(C=O)=O)C(C(CO)=O)O)=O,,,5,1,2,0,2
11029_1,,,,2,2,1,3
11031_0,,,,2,2,1,3
C(C(C(C=O)=O)C(C)(CO)O)=O,,,5,1,5,0,5
11031_1,,,,2,2,1,3
11033_0,,,,2,2,1,3
C(C(C(C=O)=O)C(C(O)=O)O)=O,,,5,1,5,0,5
11033_1,,,,2,2,1,3
11035_0,,,,2,2,1,3
C(C(C(C=O)=O)C(C(O)=O)(C)O)=O,,,5,1,2,0,2
11035_1,,,,2,2,1,3
11037_0,,,,2,2,1,3
C(C(C(C=O)=O)C(CC(O)=O)O)=O,,,5,1,2,0,2
11037_1,,,,2,2,1,3
11039_0,,,,2,2,1,3
C(C(C(C=O)=O)C(C=O)(C=C)O)=O,,,5,1,2,0,2
11039_1,,,,2,2,1,3
11041_0,,,,2,2,1,3
C(C(C(C=O)=O)C(C(C=C)=O)O)=O,,,5,1,2,0,2
11041_1,,,,2,2,1,3
11043_0,,,,2,2,1,3
C(C(C(C=O)=O)C(C=CC=O)O)=O,,,5,1,2,0,2
11043_1,,,,2,2,1,3
11044_0,,,,2,2,1,3
11044_1,,,,2,2,1,3
11045_0,,,,2,2,1,3
11045_1,,,,2,2,1,3
11047_0,,,,2,2,1,3
C(C(C(C)=O)C(C=O)(C(C)=O)O)=O,,,5,1,2,0,2
11047_1,,,,2,2,1,3
11049_0,,,,2,2,1,3
C(C(C(C)=O)(CC(CC=O)=O)O)=O,,,5,1,1,0,1
11050_0,,,,2,2,1,3
11050_1,,,,2,2,1,3
11052_0,,,,2,2,1,3
C(C(C(C)=O)(C(C(C=O)=O)C)O)=O,,,5,1,1,0,1
11053_0,,,,2,2,1,3
11055_0,,,,2,2,1,3
C(C(C(C)=O)(CC(C(C)=O)=O)O)=O,,,5,1,1,0,1
11057_0,,,,2,2,1,3
C(C(C(C=O)=C)C(C=O)(C(C)=O)O)=O,,,5,1,1,0,1
11059_0,,,,2,2,1,3
C(C(C(C)=O)(CC(C=CC=O)=O)O)=O,,,5,1,1,0,1
11061_0,,,,2,2,1,3
C(C(C(C)=O)(C(C=C)C(C=O)=O)O)=O,,,5,1,1,0,1
11063_0,,,,2,2,1,3
C(C(C=CC=O)C(C=O)(C(C)=O)O)=O,,,5,1,1,0,1
11065_0,,,,2,2,1,3
C(C(C=C)C(C=O)(C(C)=O)O)=O,,,5,1,1,0,1
11067_0,,,,2,2,1,3
C(C(C(C)=O)(C1C(C=CO1)=O)O)=O,,,5,1,2,0,2
11067_1,,,,2,2,1,3
11068_0,,,,2,2,1,3
11068_1,,,,2,2,1,3
11070_0,,,,2,2,1,3
C(C(C(C)=O)(CC(C=O)=O)O)=O,,,5,1,2,0,2
11072_0,,,,2,2,1,3
C(C(C=O)C(C=O)(C(C)=O)O)=O,,,5,1,4,0,4
11072_1,,,,2,2,1,3
11073_0,,,,2,2,1,3
11075_0,,,,2,2,1,3
C(C(C(C)O)C(C=O)(C(C)=O)O)=O,,,5,1,4,0,4
11075_1,,,,2,2,1,3
11076_0,,,,2,2,1,3
11076_1,,,,2,2,1,3
11078_0,,,,2,2,1,3
C(C(C(C)=O)(C(C(C=O)=O)O)O)=O,,,5,1,2,0,2
11078_1,,,,2,2,1,3
11079_0,,,,2,2,1,3
11079_1,,,,2,2,1,3
11080_0,,,,2,2,1,3
11082_0,,,,2,2,1,3
C(C(C(C)=O)(CC(C(O)=O)=O)O)=O,,,5,1,1,0,1
11084_0,,,,2,2,1,3
C(C(C=O)C(C=O)(C(C)=O)O)(O)=O,,,5,1,4,0,4
11084_1,,,,2,2,1,3
11085_0,,,,2,2,1,3
11085_1,,,,2,2,1,3
11087_0,,,,2,2,1,3
C(C(C(C)=O)C(C(C(C)=O)=O)O)=O,,,5,1,2,0,2
11087_1,,,,2,2,1,3
11089_0,,,,2,2,1,3
C(CC(CC(C(C(C)=O)=O)O)=O)=O,,,5,1,1,0,1
11090_0,,,,2,2,1,3
11090_1,,,,2,2,1,3
11092_0,,,,2,2,1,3
C(C(C(C(C(C=O)=O)C)O)=O)(C)=O,,,5,1,1,0,1
11093_0,,,,2,2,1,3
11095_0,,,,2,2,1,3
C(C(C(CC(C(C)=O)=O)O)=O)(C)=O,,,5,1,1,0,1
11097_0,,,,2,2,1,3
C(C(C(C=O)=C)C(C(C(C)=O)=O)O)=O,,,5,1,1,0,1
11099_0,,,,2,2,1,3
C(C=CC(CC(C(C(C)=O)=O)O)=O)=O,,,5,1,1,0,1
11101_0,,,,2,2,1,3
C=CC(C(C=O)=O)C(C(C(C)=O)=O)O,,,5,1,1,0,1
11103_0,,,,2,2,1,3
C(C(C=CC=O)C(C(C(C)=O)=O)O)=O,,,5,1,1,0,1
11105_0,,,,2,2,1,3
C(C(C=C)C(C(C(C)=O)=O)O)=O,,,5,1,1,0,1
11107_0,,,,2,2,1,3
C1OC(C(C=1)=O)C(C(C(C)=O)=O)O,,,5,1,2,0,2
11107_1,,,,2,2,1,3
11108_0,,,,2,2,1,3
11108_1,,,,2,2,1,3
11110_0,,,,2,2,1,3
C(C(CC(C(C(C)=O)=O)O)=O)=O,,,5,1,2,0,2
11112_0,,,,2,2,1,3
C(C(C=O)C(C(C(C)=O)=O)O)=O,,,5,1,4,0,4
11112_1,,,,2,2,1,3
11114_0,,,,2,2,1,3
C(CC(C(C(C)=O)=O)O)=O,,,5,1,6,0,6
11116_0,,,,2,2,1,3
C(C(C(C)O)C(C(C(C)=O)=O)O)=O,,,5,1,2,0,2
11116_1,,,,2,2,1,3
11118_0,,,,2,2,1,3
C(C(CO)C(C(C(C)=O)=O)O)=O,,,5,1,6,0,6
11118_1,,,,2,2,1,3
11120_0,,,,2,2,1,3
C(C(C(C(C(C(C)=O)=O)O)O)=O)=O,,,5,1,2,0,2
11120_1,,,,2,2,1,3
11121_0,,,,2,2,1,3
11121_1,,,,2,2,1,3
11123_0,,,,2,2,1,3
C(CO)(CC(C(C(C)=O)=O)O)=O,,,5,1,7,0,7
11125_0,,,,2,2,1,3
C(C(CC(C(C(C)=O)=O)O)=O)(O)=O,,,5,1,1,0,1
11127_0,,,,2,2,1,3
C(C(C=O)C(C(C(C)=O)=O)O)(O)=O,,,5,1,2,0,2
11127_1,,,,2,2,1,3
11128_0,,,,2,2,1,3
11128_1,,,,2,2,1,3
11130_0,,,,2,2,1,3
C(C(C(C)=O)C(C(C=O)=O)(C)O)=O,,,5,1,2,0,2
11130_1,,,,2,2,1,3
11132_0,,,,2,2,1,3
C(CC(CC(C(C=O)=O)(C)O)=O)=O,,,5,1,1,0,1
11133_0,,,,2,2,1,3
11133_1,,,,2,2,1,3
11135_0,,,,2,2,1,3
C(C=O)(C(C)C(C(C=O)=O)(C)O)=O,,,5,1,1,0,1
11136_0,,,,2,2,1,3
11138_0,,,,2,2,1,3
C(C(CC(C(C=O)=O)(C)O)=O)(C)=O,,,5,1,1,0,1
11140_0,,,,2,2,1,3
C(C(C(C=O)=C)C(C(C=O)=O)(C)O)=O,,,5,1,1,0,1
11142_0,,,,2,2,1,3
C(C=O)(C(C)(CC(C=CC=O)=O)O)=O,,,5,1,1,0,1
11144_0,,,,2,2,1,3
C=CC(C(C=O)=O)C(C(C=O)=O)(C)O,,,5,1,1,0,1
11146_0,,,,2,2,1,3
C(C(C=CC=O)C(C(C=O)=O)(C)O)=O,,,5,1,1,0,1
11148_0,,,,2,2,1,3
C(C(C=C)C(C(C=O)=O)(C)O)=O,,,5,1,1,0,1
11150_0,,,,2,2,1,3
C1OC(C(C=1)=O)C(C(C=O)=O)(C)O,,,5,1,2,0,2
11150_1,,,,2,2,1,3
11151_0,,,,2,2,1,3
11151_1,,,,2,2,1,3
11153_0,,,,2,2,1,3
C(C=O)(C(C)(CC(C=O)=O)O)=O,,,5,1,2,0,2
11155_0,,,,2,2,1,3
C(C(C=O)C(C(C=O)=O)(C)O)=O,,,5,1,4,0,4
11155_1,,,,2,2,1,3
11157_0,,,,2,2,1,3
C(CC(C(C=O)=O)(C)O)=O,,,5,1,3,0,3
11159_0,,,,2,2,1,3
C(C(C(C)O)C(C(C=O)=O)(C)O)=O,,,5,1,2,0,2
11159_1,,,,2,2,1,3
11161_0,,,,2,2,1,3
C(C(CO)C(C(C=O)=O)(C)O)=O,,,5,1,4,0,4
11161_1,,,,2,2,1,3
11163_0,,,,2,2,1,3
C(C=O)(C(C)(C(C(C=O)=O)O)O)=O,,,5,1,2,0,2
11163_1,,,,2,2,1,3
11164_0,,,,2,2,1,3
11164_1,,,,2,2,1,3
11166_0,,,,2,2,1,3
C(CC(C(C=O)=O)(C)O)(CO)=O,,,5,1,5,0,5
11168_0,,,,2,2,1,3
C(C=O)(C(C)(CC(C(O)=O)=O)O)=O,,,5,1,1,0,1
11170_0,,,,2,2,1,3
C(C(C=O)C(C(C=O)=O)(C)O)(O)=O,,,5,1,2,0,2
11170_1,,,,2,2,1,3
11171_0,,,,2,2,1,3
11171_1,,,,2,2,1,3
11173_0,,,,2,2,1,3
C(C(C(CC(C(C)O)O)=O)=O)=O,,,5,1,2,0,2
11175_0,,,,2,2,1,3
C(C(C(CC(C(C=O)=O)=O)O)O)=O,,,5,1,1,0,1
11177_0,,,,2,2,1,3
C(C)(CC(CC(C(C=O)=O)=O)O)=O,,,5,1,1,0,1
11179_0,,,,2,2,1,3
C(CC(C)(CC(C(C=O)=O)=O)O)=O,,,5,1,1,0,1
11181_0,,,,2,2,1,3
C(CC(C(C=O)=O)=O)(O)=O,,,5,1,2,0,2
11183_0,,,,2,2,1,3
C(C(CO)(CC(C(C=O)=O)=O)O)=C,,,5,1,1,0,1
11185_0,,,,2,2,1,3
C(C(CC(C(C=O)=O)=O)O)=CCO,,,5,1,1,0,1
11187_0,,,,2,2,1,3
C(C(CC)(CC(C(C=O)=O)=O)O)=O,,,5,1,1,0,1
11189_0,,,,2,2,1,3
C(C(CC(C(C=O)=O)=O)O)(CC)=O,,,5,1,1,0,1
11191_0,,,,2,2,1,3
C(CCC(CC(C(C=O)=O)=O)O)=O,,,5,1,2,0,2
11193_0,,,,2,2,1,3
C(C)(C(C)(CC(C(C=O)=O)=O)O)=O,,,5,1,1,0,1
11195_0,,,,2,2,1,3
C(C(CC(C(C=O)=O)=O)O)=C(C=O)C,,,5,1,1,0,1
11197_0,,,,2,2,1,3
C(C)(C(CC(C(C=O)=O)=O)O)=CC=O,,,5,1,1,0,1
11199_0,,,,2,2,1,3
C=C(C=O)CC(CC(C(C=O)=O)=O)O,,,5,1,1,0,1
11201_0,,,,2,2,1,3
C(CC(C(CC(C(C=O)=O)=O)O)=C)=O,,,5,1,1,0,1
11203_0,,,,2,2,1,3
C(C(CC(C(C=O)=O)=O)O)=CC(C)=O,,,5,1,1,0,1
11205_0,,,,2,2,1,3
C(C(C)(CC(C(C=O)=O)=O)O)=CC=O,,,5,1,1,0,1
11207_0,,,,2,2,1,3
C(C(CC(C(C=O)=O)=O)(CC=C)O)=O,,,5,1,1,0,1
11209_0,,,,2,2,1,3
C(C(CC(C(C=O)=O)=O)O)(CC=C)=O,,,5,1,1,0,1
11211_0,,,,2,2,1,3
C(C(C=CC)(CC(C(C=O)=O)=O)O)=O,,,5,1,1,0,1
11213_0,,,,2,2,1,3
C(C)=CC(C(CC(C(C=O)=O)=O)O)=O,,,5,1,1,0,1
11215_0,,,,2,2,1,3
C(CC=CC(CC(C(C=O)=O)=O)O)=O,,,5,1,1,0,1
11217_0,,,,2,2,1,3
C(CC(CC(C(C=O)=O)=O)O)=CC=O,,,5,1,1,0,1
11219_0,,,,2,2,1,3
C(C(C=C)C(CC(C(C=O)=O)=O)O)=O,,,5,1,1,0,1
11221_0,,,,2,2,1,3
C(C)=C(C=O)C(CC(C(C=O)=O)=O)O,,,5,1,1,0,1
11223_0,,,,2,2,1,3
C=C(C=O)C(CC(C(C=O)=O)=O)O,,,5,1,1,0,1
11225_0,,,,2,2,1,3
C(C(CC(C(C=O)=O)=O)O)=CC,,,5,1,1,0,1
11227_0,,,,2,2,1,3
C=CCC(CC(C(C=O)=O)=O)O,,,5,1,1,0,1
11229_0,,,,2,2,1,3
C=CC(C(CC(C(C=O)=O)=O)O)O,,,5,1,1,0,1
11231_0,,,,2,2,1,3
C=CC(CC(C(C=O)=O)=O)O,,,5,1,1,0,1
11233_0,,,,2,2,1,3
C1C(COC=1)(CC(C(C=O)=O)=O)O,,,5,1,1,0,1
11235_0,,,,2,2,1,3
C(C(C(CC(C(CO)O)O)=O)=O)=O,,,5,1,1,0,1
11237_0,,,,2,2,1,3
C(C(CC(C(C=O)=O)=O)O)=O,,,5,1,2,0,2
11239_0,,,,2,2,1,3
C(C(C(CC(CO)(CO)O)=O)=O)=O,,,5,1,1,0,1
11241_0,,,,2,2,1,3
C(C(C)(CC(C(C=O)=O)=O)O)=O,,,5,1,2,0,2
11243_0,,,,2,2,1,3
C(C)(C(CC(C(C=O)=O)=O)O)=O,,,5,1,3,0,3
11245_0,,,,2,2,1,3
C(CC(CC(C(C=O)=O)=O)O)=O,,,5,1,3,0,3
11247_0,,,,2,2,1,3
C(C(C(CC(C)O)=O)=O)=O,,,5,1,2,0,2
11249_0,,,,2,2,1,3
C(C(C(CC(CC(C)O)O)=O)=O)=O,,,5,1,1,0,1
11251_0,,,,2,2,1,3
C(C(C(CC(CCO)O)=O)=O)=O,,,5,1,3,0,3
11253_0,,,,2,2,1,3
C(C(CO)(CC(C(C=O)=O)=O)O)=O,,,5,1,1,0,1
11255_0,,,,2,2,1,3
C(CO)(C(CC(C(C=O)=O)=O)O)=O,,,5,1,1,0,1
11257_0,,,,2,2,1,3
C(C(C(CC(C)(CO)O)=O)=O)=O,,,5,1,2,0,2
11259_0,,,,2,2,1,3
C(C(CC(C(C=O)=O)=O)O)(O)=O,,,5,1,2,0,2
11261_0,,,,2,2,1,3
C(C(C)(CC(C(C=O)=O)=O)O)(O)=O,,,5,1,1,0,1
11263_0,,,,2,2,1,3
C(CC(CC(C(C=O)=O)=O)O)(O)=O,,,5,1,1,0,1
11265_0,,,,2,2,1,3
C(C(C=C)(CC(C(C=O)=O)=O)O)=O,,,5,1,1,0,1
11267_0,,,,2,2,1,3
C=CC(C(CC(C(C=O)=O)=O)O)=O,,,5,1,1,0,1
11269_0,,,,2,2,1,3
C(C(CC(C(C=O)=O)=O)O)=CC=O,,,5,1,1,0,1
11270_0,,,,2,2,1,3
11271_0,,,,2,2,1,3
11273_0,,,,2,2,1,3
C(CC(C(CO)=O)(C(C=O)O)O)=O,,,5,1,4,0,4
11275_0,,,,2,2,1,3
C(C(CO)(CC=O)O)(C(C=O)O)=O,,,5,1,3,0,3
11276_0,,,,2,2,1,3
11278_0,,,,2,2,1,3
C(C(C(C(C(C=O)O)=O)=O)O)(O)=O,,,5,1,2,0,2
11278_1,,,,2,2,1,3
11280_0,,,,2,2,1,3
C(C(C(C(C(C(C)O)O)=O)=O)O)=O,,,5,1,2,0,2
11280_1,,,,2,2,1,3
11281_0,,,,2,2,1,3
11281_1,,,,2,2,1,3
11283_0,,,,2,2,1,3
C(C(C(C(C(CO)O)=O)=O)(C)O)=O,,,5,1,2,0,2
11283_1,,,,2,2,1,3
11285_0,,,,2,2,1,3
C(CCO)(C(C(C(CO)=O)=O)O)=O,,,5,1,1,0,1
11287_0,,,,2,2,1,3
C(C)(C(C(C(C(CO)O)=O)=O)O)=O,,,5,1,2,0,2
11287_1,,,,2,2,1,3
11289_0,,,,2,2,1,3
C(C(CO)C(C(C(CO)=O)=O)O)=O,,,5,1,2,0,2
11289_1,,,,2,2,1,3
11291_0,,,,2,2,1,3
C(CC(C(C(C(CO)O)=O)=O)O)=O,,,5,1,2,0,2
11291_1,,,,2,2,1,3
11293_0,,,,2,2,1,3
C(C(CO)(CC=O)O)(C(C)O)=O,,,5,1,4,0,4
11295_0,,,,2,2,1,3
C(C(CO)(C(C=O)O)O)(C(C)O)=O,,,5,1,10,0,10
11295_1,,,,2,2,1,3
11297_0,,,,2,2,1,3
C(CO)(C(C(C)O)(CC=O)O)=O,,,5,1,3,0,3
11298_0,,,,2,2,1,3
11298_1,,,,2,2,1,3
11300_0,,,,2,2,1,3
C(C(C(C(C(C)O)=O)=O)O)(O)=O,,,5,1,3,0,3
11300_1,,,,2,2,1,3
11302_0,,,,2,2,1,3
C=CC(C(C(C(C(C)O)=O)=O)O)O,,,5,1,2,0,2
11302_1,,,,2,2,1,3
11304_0,,,,2,2,1,3
C(C(C(C(C(C(C)O)=O)=O)O)O)=O,,,5,1,2,0,2
11304_1,,,,2,2,1,3
11306_0,,,,2,2,1,3
C(C(C(C)O)=O)(C(C(C)O)O)=O,,,5,1,2,0,2
11306_1,,,,2,2,1,3
11307_0,,,,2,2,1,3
11307_1,,,,2,2,1,3
11309_0,,,,2,2,1,3
C(C(C(C)O)=O)(C(C(CO)O)O)=O,,,5,1,4,0,4
11309_1,,,,2,2,1,3
11311_0,,,,2,2,1,3
C(C(C=C)C(C=O)(C(C=O)O)O)=O,,,5,1,2,0,2
11312_0,,,,2,2,1,3
11313_0,,,,2,2,1,3
11313_1,,,,2,2,1,3
11314_0,,,,2,2,1,3
11315_0,,,,2,2,1,3
11315_1,,,,2,2,1,3
11316_0,,,,2,2,1,3
11316_1,,,,2,2,1,3
11317_0,,,,2,2,1,3
11318_0,,,,2,2,1,3
11318_1,,,,2,2,1,3
11320_0,,,,2,2,1,3
C(C(C=C)C(C(C(C=O)O)=O)O)=O,,,5,1,1,0,1
11322_0,,,,2,2,1,3
C(C(C(C(CC(C=O)=O)O)=O)O)=O,,,5,1,1,0,1
11324_0,,,,2,2,1,3
C(C(C=O)C(C(C(C=O)O)=O)O)=O,,,5,1,2,0,2
11324_1,,,,2,2,1,3
11325_0,,,,2,2,1,3
11327_0,,,,2,2,1,3
C(C(CO)C(C(C(C=O)O)=O)O)=O,,,5,1,6,0,6
11327_1,,,,2,2,1,3
11329_0,,,,2,2,1,3
C(C(C(C(C(C(C)=O)O)O)=O)O)=O,,,5,1,5,0,5
11329_1,,,,2,2,1,3
11331_0,,,,2,2,1,3
C(C(C(C(CC(CO)=O)O)=O)O)=O,,,5,1,2,0,2
11333_0,,,,2,2,1,3
C(C(C(C(C(C=O)O)O)=O)O)=O,,,5,1,4,0,4
11333_1,,,,2,2,1,3
11335_0,,,,2,2,1,3
C(C(C=C)C(C(C(C=O)=O)O)O)=O,,,5,1,3,0,3
11336_0,,,,2,2,1,3
11338_0,,,,2,2,1,3
C(C(C=O)C(C(C(C=O)=O)O)O)=O,,,5,1,4,0,4
11338_1,,,,2,2,1,3
11339_0,,,,2,2,1,3
11340_0,,,,2,2,1,3
11340_1,,,,2,2,1,3
11341_0,,,,2,2,1,3
11341_1,,,,2,2,1,3
11342_0,,,,2,2,1,3
11344_0,,,,2,2,1,3
C(C(C(C(C(C=O)=O)O)O)O)=O,,,5,1,6,0,6
11344_1,,,,2,2,1,3
11345_0,,,,2,2,1,3
11346_0,,,,2,2,1,3
11347_0,,,,2,2,1,3
11348_0,,,,2,2,1,3
11348_1,,,,2,2,1,3
11349_0,,,,2,2,1,3
11351_0,,,,2,2,1,3
C(C(C(C(C(C=O)O)O)=O)(C)O)=O,,,5,1,4,0,4
11351_1,,,,2,2,1,3
11352_0,,,,2,2,1,3
11354_0,,,,2,2,1,3
C(C(C(C(C(C=O)=O)(C)O)O)O)=O,,,5,1,4,0,4
11354_1,,,,2,2,1,3
11355_0,,,,2,2,1,3
11356_0,,,,2,2,1,3
11356_1,,,,2,2,1,3
11357_0,,,,2,2,1,3
11359_0,,,,2,2,1,3
C(C(C(C(C(C(C)=O)O)=O)O)O)=O,,,5,1,4,0,4
11359_1,,,,2,2,1,3
11361_0,,,,2,2,1,3
C(CC(C)(C(C(C=O)=O)O)O)=O,,,5,1,5,0,5
11362_0,,,,2,2,1,3
11362_1,,,,2,2,1,3
11364_0,,,,2,2,1,3
C(CC(C(C(C=O)=O)O)=O)(O)=O,,,5,1,2,0,2
11366_0,,,,2,2,1,3
C(CC(C=C)O)(C(C(C=O)=O)O)=O,,,5,1,1,0,1
11368_0,,,,2,2,1,3
C(C(CC(C(C(C=O)=O)O)=O)O)=O,,,5,1,1,0,1
11370_0,,,,2,2,1,3
C(CC(C)O)(C(C(C=O)=O)O)=O,,,5,1,3,0,3
11371_0,,,,2,2,1,3
11373_0,,,,2,2,1,3
C(CC(CO)O)(C(C(C=O)=O)O)=O,,,5,1,1,0,1
11374_0,,,,2,2,1,3
11375_0,,,,2,2,1,3
11375_1,,,,2,2,1,3
11376_0,,,,2,2,1,3
11377_0,,,,2,2,1,3
11377_1,,,,2,2,1,3
11378_0,,,,2,2,1,3
11380_0,,,,2,2,1,3
C(C(C(CC(C(C=O)=O)O)O)O)=O,,,5,1,3,0,3
11380_1,,,,2,2,1,3
11382_0,,,,2,2,1,3
C(C(C=O)C(C(C=O)=O)O)(O)=O,,,5,1,2,0,2
11382_1,,,,2,2,1,3
11384_0,,,,2,2,1,3
C(C(C(C(C=O)=O)O)C(C=C)O)=O,,,5,1,2,0,2
11384_1,,,,2,2,1,3
11386_0,,,,2,2,1,3
C(C(C(C=O)C(C(C=O)=O)O)O)=O,,,5,1,2,0,2
11386_1,,,,2,2,1,3
11388_0,,,,2,2,1,3
C(C(C(C)O)C(C(C=O)=O)O)=O,,,5,1,3,0,3
11388_1,,,,2,2,1,3
11390_0,,,,2,2,1,3
C(C(CO)C(C(C=O)=O)O)=O,,,5,1,4,0,4
11390_1,,,,2,2,1,3
11392_0,,,,2,2,1,3
C(C(C(CO)O)C(C(C=O)=O)O)=O,,,5,1,3,0,3
11392_1,,,,2,2,1,3
11394_0,,,,2,2,1,3
C(C(CO)CO)(C(C(C=O)=O)O)=O,,,5,1,2,0,2
11394_1,,,,2,2,1,3
11396_0,,,,2,2,1,3
C(CO)(C(CO)C(C(C=O)=O)O)=O,,,5,1,2,0,2
11396_1,,,,2,2,1,3
11398_0,,,,2,2,1,3
C(CC(C(C=O)=O)O)(C(CO)O)=O,,,5,1,2,0,2
11398_1,,,,2,2,1,3
11400_0,,,,2,2,1,3
C(C(CO)C(C(C=O)=O)(CO)O)=O,,,5,1,2,0,2
11400_1,,,,2,2,1,3
11401_0,,,,2,2,1,3
11402_0,,,,2,2,1,3
11402_1,,,,2,2,1,3
11403_0,,,,2,2,1,3
11405_0,,,,2,2,1,3
C(C(C(C(CC(CO)=O)=O)O)O)=O,,,5,1,5,0,5
11405_1,,,,2,2,1,3
11406_0,,,,2,2,1,3
11408_0,,,,2,2,1,3
C(C(C(CO)(CC(C=O)=O)O)O)=O,,,5,1,4,0,4
11408_1,,,,2,2,1,3
11410_0,,,,2,2,1,3
C(C(C(CO)=O)C(C=O)=O)(O)=O,,,5,1,3,0,3
11410_1,,,,2,2,1,3
11412_0,,,,2,2,1,3
C(CO)(C(C(C=O)=O)C(C=C)O)=O,,,5,1,2,0,2
11412_1,,,,2,2,1,3
11414_0,,,,2,2,1,3
C(C(C(C(CO)=O)C(C=O)=O)O)=O,,,5,1,3,0,3
11414_1,,,,2,2,1,3
11416_0,,,,2,2,1,3
C(CO)(C(C(C=O)=O)C(C)O)=O,,,5,1,6,0,6
11416_1,,,,2,2,1,3
11417_0,,,,2,2,1,3
11417_1,,,,2,2,1,3
11419_0,,,,2,2,1,3
C(CO)(C(C(C=O)=O)C(CO)O)=O,,,5,1,3,0,3
11419_1,,,,2,2,1,3
11421_0,,,,2,2,1,3
C(C(C(CC(C=O)=O)=O)O)(O)=O,,,5,1,3,0,3
11421_1,,,,2,2,1,3
11423_0,,,,2,2,1,3
C(C(C(C=C)O)O)(CC(C=O)=O)=O,,,5,1,2,0,2
11423_1,,,,2,2,1,3
11425_0,,,,2,2,1,3
C(C(C(C(CC(C=O)=O)=O)O)O)=O,,,5,1,2,0,2
11425_1,,,,2,2,1,3
11427_0,,,,2,2,1,3
C(C(C(C)O)O)(CC(C=O)=O)=O,,,5,1,7,0,7
11427_1,,,,2,2,1,3
11428_0,,,,2,2,1,3
11428_1,,,,2,2,1,3
11430_0,,,,2,2,1,3
C(C(C(CO)O)O)(CC(C=O)=O)=O,,,5,1,3,0,3
11430_1,,,,2,2,1,3
11431_0,,,,2,2,1,3
11432_0,,,,2,2,1,3
11432_1,,,,2,2,1,3
11434_0,,,,2,2,1,3
C(CC(C(C(CCO)=O)=O)O)=O,,,5,1,5,0,5
11435_0,,,,2,2,1,3
11435_1,,,,2,2,1,3
11437_0,,,,2,2,1,3
C(CC(C(C=O)=O)(CCO)O)=O,,,5,1,2,0,2
11439_0,,,,2,2,1,3
C(C(C(C(C=O)=O)(CCO)O)O)=O,,,5,1,3,0,3
11439_1,,,,2,2,1,3
11441_0,,,,2,2,1,3
C(C(C(C(C=O)=O)=O)CO)(O)=O,,,5,1,2,0,2
11441_1,,,,2,2,1,3
11443_0,,,,2,2,1,3
C=CC(C(C(C(C=O)=O)=O)CO)O,,,5,1,2,0,2
11443_1,,,,2,2,1,3
11445_0,,,,2,2,1,3
C(C(C(C(C(C=O)=O)=O)CO)O)=O,,,5,1,2,0,2
11445_1,,,,2,2,1,3
11447_0,,,,2,2,1,3
C(C(C(C(CO)C(C)O)=O)=O)=O,,,5,1,3,0,3
11447_1,,,,2,2,1,3
11449_0,,,,2,2,1,3
C(C(C(C(CO)CO)=O)=O)=O,,,5,1,4,0,4
11449_1,,,,2,2,1,3
11451_0,,,,2,2,1,3
C(C(C(C(CO)C(CO)O)=O)=O)=O,,,5,1,4,0,4
11451_1,,,,2,2,1,3
11453_0,,,,2,2,1,3
C(C(CO)O)(C(C(C=O)=O)CO)=O,,,5,1,5,0,5
11453_1,,,,2,2,1,3
11454_0,,,,2,2,1,3
11454_1,,,,2,2,1,3
11456_0,,,,2,2,1,3
C(C(C(C(C(C(C)O)O)O)=O)O)=O,,,5,1,5,0,5
11456_1,,,,2,2,1,3
11458_0,,,,2,2,1,3
C(CC(C(C)O)O)(CC(C=O)=O)=O,,,5,1,1,0,1
11460_0,,,,2,2,1,3
C(C)(C(C(C=O)=O)C(C(C)O)O)=O,,,5,1,2,0,2
11460_1,,,,2,2,1,3
11462_0,,,,2,2,1,3
C(C(C=O)C(CC(C(C)O)O)=O)=O,,,5,1,1,0,1
11464_0,,,,2,2,1,3
C(C(C(C)=O)C(C(C)O)O)=O,,,5,1,2,0,2
11464_1,,,,2,2,1,3
11466_0,,,,2,2,1,3
C(CC(CC(C(C)O)O)=O)=O,,,5,1,1,0,1
11468_0,,,,2,2,1,3
C(C(C(C(C(C)O)O)O)=O)(O)=O,,,5,1,2,0,2
11468_1,,,,2,2,1,3
11470_0,,,,2,2,1,3
C(OCC(CC(C(C)O)O)=O)=O,,,5,1,1,0,1
11472_0,,,,2,2,1,3
C(OC(C(C)=O)C(C(C)O)O)=O,,,5,1,2,0,2
11472_1,,,,2,2,1,3
11474_0,,,,2,2,1,3
C(C(C(C(C)O)=O)C(C(C)O)O)=O,,,5,1,2,0,2
11474_1,,,,2,2,1,3
11476_0,,,,2,2,1,3
C(C(C(C(C)O)O)O)(C(C)O)=O,,,5,1,4,0,4
11476_1,,,,2,2,1,3
11478_0,,,,2,2,1,3
C(C(CCO)O)(CC(C(C)O)O)=O,,,5,1,1,0,1
11480_0,,,,2,2,1,3
C=CC(C(C(C(C)O)O)O)=O,,,5,1,2,0,2
11480_1,,,,2,2,1,3
11482_0,,,,2,2,1,3
C(C(C(C(C)O)O)OC(CO)=O)=O,,,5,1,2,0,2
11482_1,,,,2,2,1,3
11484_0,,,,2,2,1,3
C(C(C(C(C)O)O)C(C=O)CO)=O,,,5,1,1,0,1
11486_0,,,,2,2,1,3
C(CC(C(C)O)O)(CC(CO)=O)=O,,,5,1,1,0,1
11488_0,,,,2,2,1,3
C(C)(C(C(CO)=O)C(C(C)O)O)=O,,,5,1,2,0,2
11488_1,,,,2,2,1,3
11490_0,,,,2,2,1,3
C(C(C(C(C)O)O)O)(CC(C)=O)=O,,,5,1,2,0,2
11490_1,,,,2,2,1,3
11492_0,,,,2,2,1,3
C(C(C(C(C(C)O)O)O)=O)(CC)=O,,,5,1,2,0,2
11492_1,,,,2,2,1,3
11494_0,,,,2,2,1,3
C(C(CO)=O)(C(C)C(C(C)O)O)=O,,,5,1,1,0,1
11496_0,,,,2,2,1,3
C(C(C(C(C)=O)=O)C(C(C)O)O)=O,,,5,1,2,0,2
11496_1,,,,2,2,1,3
11498_0,,,,2,2,1,3
C(CC(C(CC(C(C)O)O)=O)=O)=O,,,5,1,1,0,1
11500_0,,,,2,2,1,3
C(C(C(C(C)O)O)CC(C=O)=O)=O,,,5,1,1,0,1
11502_0,,,,2,2,1,3
C(CC(C(C=O)=O)C(C(C)O)O)=O,,,5,1,1,0,1
11504_0,,,,2,2,1,3
C(C(C(CC=O)=O)C(C(C)O)O)=O,,,5,1,2,0,2
11504_1,,,,2,2,1,3
11506_0,,,,2,2,1,3
C(C(C=O)C(C=O)C(C(C)O)O)=O,,,5,1,1,0,1
11508_0,,,,2,2,1,3
C(C(C(C)C(C(C)O)O)=O)=O,,,5,1,1,0,1
11510_0,,,,2,2,1,3
C(CO)(C(C(C(C)O)O)CC=O)=O,,,5,1,1,0,1
11512_0,,,,2,2,1,3
C(CCC=O)(C(C(C(C)O)O)O)=O,,,5,1,2,0,2
11512_1,,,,2,2,1,3
11514_0,,,,2,2,1,3
C(C(C(C(C)O)O)CC(CO)=O)=O,,,5,1,1,0,1
11516_0,,,,2,2,1,3
C(CC(C(CO)C(C(C)O)O)=O)=O,,,5,1,2,0,2
11516_1,,,,2,2,1,3
11518_0,,,,2,2,1,3
C(C(C(CCO)=O)C(C(C)O)O)=O,,,5,1,2,0,2
11518_1,,,,2,2,1,3
11520_0,,,,2,2,1,3
C(C(C(C(C)O)O)CC=O)=O,,,5,1,2,0,2
11522_0,,,,2,2,1,3
C(C(C)=O)(CC(C(C)O)O)=O,,,5,1,2,0,2
11524_0,,,,2,2,1,3
C(C(C(CC(C(C)O)O)=O)CO)=O,,,5,1,1,0,1
11526_0,,,,2,2,1,3
C(C(C(C(O)=O)=O)C(C(C)O)O)=O,,,5,1,2,0,2
11526_1,,,,2,2,1,3
11528_0,,,,2,2,1,3
C(C(C(C=O)=O)C(C(C)O)O)(O)=O,,,5,1,2,0,2
11528_1,,,,2,2,1,3
11530_0,,,,2,2,1,3
C(C(C(C)C(C(C)O)O)=O)(O)=O,,,5,1,1,0,1
11532_0,,,,2,2,1,3
C(C(C(C)=O)C(C(C)O)O)(O)=O,,,5,1,2,0,2
11532_1,,,,2,2,1,3
11534_0,,,,2,2,1,3
C(CC(CC(C(C)O)O)=O)(O)=O,,,5,1,1,0,1
11536_0,,,,2,2,1,3
C1(C(C(CO1)C(C(C)O)O)=O)=O,,,5,1,2,0,2
11536_1,,,,2,2,1,3
11538_0,,,,2,2,1,3
C1(C(C(CO1)=O)C(C(C)O)O)=O,,,5,1,2,0,2
11538_1,,,,2,2,1,3
11540_0,,,,2,2,1,3
C1(CC(C(C(C(C)O)O)O1)=O)=O,,,5,1,2,0,2
11540_1,,,,2,2,1,3
11542_0,,,,2,2,1,3
C(C(C(C(C)O)O)O)(C(C=C)O)=O,,,5,1,2,0,2
11542_1,,,,2,2,1,3
11544_0,,,,2,2,1,3
C(C(C(C=O)=C)C(C(C)O)O)=O,,,5,1,1,0,1
11546_0,,,,2,2,1,3
C(C=CC(CC(C(C)O)O)=O)=O,,,5,1,1,0,1
11548_0,,,,2,2,1,3
C=CC(C(C=O)=O)C(C(C)O)O,,,5,1,1,0,1
11550_0,,,,2,2,1,3
C(C(C=CC=O)C(C(C)O)O)=O,,,5,1,1,0,1
11552_0,,,,2,2,1,3
C=C(C=O)C(C(C(C(C)O)O)O)=O,,,5,1,2,0,2
11552_1,,,,2,2,1,3
11554_0,,,,2,2,1,3
C(C(C=C)C(C(C)O)O)=O,,,5,1,1,0,1
11556_0,,,,2,2,1,3
C(C=CC(C(C(C(C)O)O)O)=O)=O,,,5,1,2,0,2
11556_1,,,,2,2,1,3
11558_0,,,,2,2,1,3
C1OC(C(C=1)=O)C(C(C)O)O,,,5,1,2,0,2
11558_1,,,,2,2,1,3
11560_0,,,,2,2,1,3
C1(C(O)OC(C)C1C(C(C)O)O)=O,,,5,1,2,0,2
11560_1,,,,2,2,1,3
11562_0,,,,2,2,1,3
C(C(C(CCO)C(C(C)O)O)=O)=O,,,5,1,1,0,1
11563_0,,,,2,2,1,3
11563_1,,,,2,2,1,3
11565_0,,,,2,2,1,3
C(C(C(C(C)O)O)O)(C(CO)O)=O,,,5,1,6,0,6
11565_1,,,,2,2,1,3
11567_0,,,,2,2,1,3
C(C(CC(C(C)O)O)=O)=O,,,5,1,2,0,2
11569_0,,,,2,2,1,3
C(C(C=O)C(C(C)O)O)=O,,,5,1,2,0,2
11569_1,,,,2,2,1,3
11571_0,,,,2,2,1,3
C(C(C(CO)C(C(C)O)O)=O)=O,,,5,1,3,0,3
11571_1,,,,2,2,1,3
11573_0,,,,2,2,1,3
C(C(C(C(C)O)O)C(C=O)O)=O,,,5,1,3,0,3
11573_1,,,,2,2,1,3
11575_0,,,,2,2,1,3
C(C(C(CO)=O)C(C(C)O)O)=O,,,5,1,2,0,2
11575_1,,,,2,2,1,3
11577_0,,,,2,2,1,3
C(CC(C(C(C(C)O)O)O)=O)=O,,,5,1,2,0,2
11577_1,,,,2,2,1,3
11579_0,,,,2,2,1,3
C(C(C(CC(C(C)O)O)=O)O)=O,,,5,1,1,0,1
11581_0,,,,2,2,1,3
C(CC(C(C)O)O)=O,,,5,1,1,0,1
11583_0,,,,2,2,1,3
C(C(C(C(C)O)O)C(C=O)(C)O)=O,,,5,1,2,0,2
11583_1,,,,2,2,1,3
11585_0,,,,2,2,1,3
C(C(C(C(C)O)O)C(C(C)=O)O)=O,,,5,1,2,0,2
11585_1,,,,2,2,1,3
11587_0,,,,2,2,1,3
C(CC(C(CC(C(C)O)O)=O)O)=O,,,5,1,1,0,1
11589_0,,,,2,2,1,3
C(C(C(C(C)O)C(C(C)O)O)=O)=O,,,5,1,2,0,2
11589_1,,,,2,2,1,3
11591_0,,,,2,2,1,3
C(C(C(CC=O)O)C(C(C)O)O)=O,,,5,1,2,0,2
11591_1,,,,2,2,1,3
11593_0,,,,2,2,1,3
C(C(C(C)O)C(C(C)O)O)=O,,,5,1,2,0,2
11593_1,,,,2,2,1,3
11595_0,,,,2,2,1,3
C(C(CO)C(C(C)O)O)=O,,,5,1,2,0,2
11595_1,,,,2,2,1,3
11597_0,,,,2,2,1,3
C(C(C(CO)O)C(C(C)O)O)=O,,,5,1,2,0,2
11597_1,,,,2,2,1,3
11599_0,,,,2,2,1,3
C(C(C(C(C(C)O)O)O)=O)=O,,,5,1,4,0,4
11599_1,,,,2,2,1,3
11601_0,,,,2,2,1,3
C(C(C)=O)(C(C(C(C)O)O)O)=O,,,5,1,3,0,3
11601_1,,,,2,2,1,3
11603_0,,,,2,2,1,3
C(C(CO)=O)(CC(C(C)O)O)=O,,,5,1,2,0,2
11605_0,,,,2,2,1,3
C(C)(C(C(C(C)O)O)O)=O,,,5,1,2,0,2
11605_1,,,,2,2,1,3
11607_0,,,,2,2,1,3
C(CO)(CC(C(C)O)O)=O,,,5,1,1,0,1
11609_0,,,,2,2,1,3
C(C(C(C(C)O)O)O)(CCO)=O,,,5,1,2,0,2
11609_1,,,,2,2,1,3
11611_0,,,,2,2,1,3
C(CO)(C(CO)C(C(C)O)O)=O,,,5,1,2,0,2
11611_1,,,,2,2,1,3
11613_0,,,,2,2,1,3
C(C(CO)O)(CC(C(C)O)O)=O,,,5,1,1,0,1
11615_0,,,,2,2,1,3
C(C(CC(C(C)O)O)=O)(O)=O,,,5,1,2,0,2
11617_0,,,,2,2,1,3
C(C(C=O)C(C(C)O)O)(O)=O,,,5,1,2,0,2
11617_1,,,,2,2,1,3
11619_0,,,,2,2,1,3
C(C(C(CO)C(C(C)O)O)=O)(O)=O,,,5,1,2,0,2
11619_1,,,,2,2,1,3
11621_0,,,,2,2,1,3
C(C(C(C(C)O)O)C(C(O)=O)O)=O,,,5,1,2,0,2
11621_1,,,,2,2,1,3
11623_0,,,,2,2,1,3
C(C(C(CO)=O)C(C(C)O)O)(O)=O,,,5,1,2,0,2
11623_1,,,,2,2,1,3
11625_0,,,,2,2,1,3
C(CC(C(C(C(C)O)O)O)=O)(O)=O,,,5,1,2,0,2
11625_1,,,,2,2,1,3
11627_0,,,,2,2,1,3
C(C(C(CC(C(C)O)O)=O)O)(O)=O,,,5,1,1,0,1
11629_0,,,,2,2,1,3
C1(C(C(C(C)O)O)OCC1O)=O,,,5,1,2,0,2
11629_1,,,,2,2,1,3
11631_0,,,,2,2,1,3
C1(C(O)OCC1C(C(C)O)O)=O,,,5,1,2,0,2
11631_1,,,,2,2,1,3
11633_0,,,,2,2,1,3
C1(COC(C1C(C(C)O)O)O)=O,,,5,1,2,0,2
11633_1,,,,2,2,1,3
11635_0,,,,2,2,1,3
C1(C(C(C(C)O)O)OC(C1)O)=O,,,5,1,2,0,2
11635_1,,,,2,2,1,3
11636_0,,,,2,2,1,3
11636_1,,,,2,2,1,3
11638_0,,,,2,2,1,3
C(C(C=C)C(C(C(CO)=O)O)O)=O,,,5,1,3,0,3
11639_0,,,,2,2,1,3
11641_0,,,,2,2,1,3
C(C(C=O)C(C(C(CO)=O)O)O)=O,,,5,1,6,0,6
11641_1,,,,2,2,1,3
11642_0,,,,2,2,1,3
11643_0,,,,2,2,1,3
11643_1,,,,2,2,1,3
11644_0,,,,2,2,1,3
11644_1,,,,2,2,1,3
11645_0,,,,2,2,1,3
11646_0,,,,2,2,1,3
11646_1,,,,2,2,1,3
11648_0,,,,2,2,1,3
C(C(C=C)C(CO)(C(C=O)O)O)=O,,,5,1,3,0,3
11649_0,,,,2,2,1,3
11651_0,,,,2,2,1,3
C(C(C=O)C(CO)(C(C=O)O)O)=O,,,5,1,5,0,5
11651_1,,,,2,2,1,3
11652_0,,,,2,2,1,3
11653_0,,,,2,2,1,3
11653_1,,,,2,2,1,3
11654_0,,,,2,2,1,3
11654_1,,,,2,2,1,3
11656_0,,,,2,2,1,3
C(C(C(CO)(CC(CO)=O)O)O)=O,,,5,1,9,0,9
11657_0,,,,2,2,1,3
11657_1,,,,2,2,1,3
11659_0,,,,2,2,1,3
C(C(C(C(C=O)O)=O)O)(O)=O,,,5,1,3,0,3
11659_1,,,,2,2,1,3
11661_0,,,,2,2,1,3
C(C(C(C(C(C=CC)O)O)=O)O)=O,,,5,1,2,0,2
11661_1,,,,2,2,1,3
11663_0,,,,2,2,1,3
C(C(C(C(C(CC=C)O)O)=O)O)=O,,,5,1,2,0,2
11663_1,,,,2,2,1,3
11665_0,,,,2,2,1,3
C(C(C(C(C(C=C)O)O)=O)O)=O,,,5,1,2,0,2
11665_1,,,,2,2,1,3
11666_0,,,,2,2,1,3
11666_1,,,,2,2,1,3
11668_0,,,,2,2,1,3
C(C(C)(C(C(C(C=O)O)=O)O)O)=O,,,5,1,3,0,3
11668_1,,,,2,2,1,3
11669_0,,,,2,2,1,3
11669_1,,,,2,2,1,3
11671_0,,,,2,2,1,3
C(CC(C(C(C(C=O)O)=O)O)O)=O,,,5,1,3,0,3
11671_1,,,,2,2,1,3
11673_0,,,,2,2,1,3
C(C(C(C(C(C)O)O)=O)O)=O,,,5,1,4,0,4
11673_1,,,,2,2,1,3
11675_0,,,,2,2,1,3
C(C(C(C(C(CCO)O)O)=O)O)=O,,,5,1,4,0,4
11675_1,,,,2,2,1,3
11677_0,,,,2,2,1,3
C(C(C(C(C(CO)(C)O)O)=O)O)=O,,,5,1,2,0,2
11677_1,,,,2,2,1,3
11679_0,,,,2,2,1,3
C(C(C(C(C(C(O)=O)O)O)=O)O)=O,,,5,1,3,0,3
11679_1,,,,2,2,1,3
11680_0,,,,2,2,1,3
11680_1,,,,2,2,1,3
11681_0,,,,2,2,1,3
11681_1,,,,2,2,1,3
11682_0,,,,2,2,1,3
11684_0,,,,2,2,1,3
C(C(C(C(C(CO)=O)O)=O)O)(O)=O,,,5,1,2,0,2
11684_1,,,,2,2,1,3
11686_0,,,,2,2,1,3
C(C(C(C)O)O)(C(C(CO)=O)O)=O,,,5,1,5,0,5
11686_1,,,,2,2,1,3
11687_0,,,,2,2,1,3
11687_1,,,,2,2,1,3
11689_0,,,,2,2,1,3
C(CC(C)(C(C(CO)=O)O)O)=O,,,5,1,5,0,5
11690_0,,,,2,2,1,3
11690_1,,,,2,2,1,3
11691_0,,,,2,2,1,3
11692_0,,,,2,2,1,3
11692_1,,,,2,2,1,3
11694_0,,,,2,2,1,3
C(CC(C(C(CO)=O)O)=O)(O)=O,,,5,1,3,0,3
11696_0,,,,2,2,1,3
C(CC(C=C)O)(C(C(CO)=O)O)=O,,,5,1,1,0,1
11698_0,,,,2,2,1,3
C(C(CC(C(C(CO)=O)O)=O)O)=O,,,5,1,2,0,2
11700_0,,,,2,2,1,3
C(CC(C)O)(C(C(CO)=O)O)=O,,,5,1,3,0,3
11701_0,,,,2,2,1,3
11703_0,,,,2,2,1,3
C(CC(CO)O)(C(C(CO)=O)O)=O,,,5,1,4,0,4
11705_0,,,,2,2,1,3
C(C(C(C(C(C)=O)O)=O)O)(O)=O,,,5,1,3,0,3
11705_1,,,,2,2,1,3
11707_0,,,,2,2,1,3
C(C(C(C=C)O)O)(C(C(C)=O)O)=O,,,5,1,2,0,2
11707_1,,,,2,2,1,3
11708_0,,,,2,2,1,3
11708_1,,,,2,2,1,3
11710_0,,,,2,2,1,3
C(C(C(C)O)O)(C(C(C)=O)O)=O,,,5,1,4,0,4
11710_1,,,,2,2,1,3
11711_0,,,,2,2,1,3
11711_1,,,,2,2,1,3
11712_0,,,,2,2,1,3
11712_1,,,,2,2,1,3
11713_0,,,,2,2,1,3
11714_0,,,,2,2,1,3
11716_0,,,,2,2,1,3
C(C(C=C)C(C)(CC(C=O)=O)O)=O,,,5,1,1,0,1
11718_0,,,,2,2,1,3
C1OC(C(C=1)=O)C(C)(CC(C=O)=O)O,,,5,1,2,0,2
11718_1,,,,2,2,1,3
11720_0,,,,2,2,1,3
C(C(CC(C)(CC(C=O)=O)O)=O)=O,,,5,1,1,0,1
11722_0,,,,2,2,1,3
C(C(C=O)C(C)(CC(C=O)=O)O)=O,,,5,1,3,0,3
11722_1,,,,2,2,1,3
11724_0,,,,2,2,1,3
C(CC(C)(CC(C=O)=O)O)=O,,,5,1,4,0,4
11726_0,,,,2,2,1,3
C(C(CO)C(C)(CC(C=O)=O)O)=O,,,5,1,3,0,3
11726_1,,,,2,2,1,3
11728_0,,,,2,2,1,3
C(C)(C(C(C)(CC(C=O)=O)O)O)=O,,,5,1,2,0,2
11728_1,,,,2,2,1,3
11730_0,,,,2,2,1,3
C(CO)(CC(C)(CC(C=O)=O)O)=O,,,5,1,2,0,2
11731_0,,,,2,2,1,3
11731_1,,,,2,2,1,3
11733_0,,,,2,2,1,3
C(C(C=C)C(C=O)(CC(C)=O)O)=O,,,5,1,1,0,1
11735_0,,,,2,2,1,3
C(C(CC(C)=O)(C1C(C=CO1)=O)O)=O,,,5,1,2,0,2
11735_1,,,,2,2,1,3
11737_0,,,,2,2,1,3
C(C(CC(C=O)=O)(CC(C)=O)O)=O,,,5,1,1,0,1
11739_0,,,,2,2,1,3
C(C(C=O)C(C=O)(CC(C)=O)O)=O,,,5,1,2,0,2
11739_1,,,,2,2,1,3
11741_0,,,,2,2,1,3
C(CC(C=O)(CC(C)=O)O)=O,,,5,1,2,0,2
11743_0,,,,2,2,1,3
C(CC(C=O)(C(C=O)CO)O)(C)=O,,,5,1,2,0,2
11743_1,,,,2,2,1,3
11745_0,,,,2,2,1,3
C(C(CC(C)=O)(C(C(C)=O)O)O)=O,,,5,1,2,0,2
11745_1,,,,2,2,1,3
11747_0,,,,2,2,1,3
C(C(CC(C)=O)(CC(CO)=O)O)=O,,,5,1,1,0,1
11749_0,,,,2,2,1,3
C(C(C(C=O)(CC(C)=O)O)O)=O,,,5,1,4,0,4
11749_1,,,,2,2,1,3
11751_0,,,,2,2,1,3
C(C(C=C)C(C(CC(C)=O)=O)O)=O,,,5,1,1,0,1
11753_0,,,,2,2,1,3
C(C(C1C(C=CO1)=O)O)(CC(C)=O)=O,,,5,1,2,0,2
11753_1,,,,2,2,1,3
11755_0,,,,2,2,1,3
C(C(CC(C=O)=O)O)(CC(C)=O)=O,,,5,1,1,0,1
11757_0,,,,2,2,1,3
C(C(C=O)C(C(CC(C)=O)=O)O)=O,,,5,1,2,0,2
11757_1,,,,2,2,1,3
11759_0,,,,2,2,1,3
C(CC(C(CC(C)=O)=O)O)=O,,,5,1,3,0,3
11761_0,,,,2,2,1,3
C(C(CO)C(C(CC(C)=O)=O)O)=O,,,5,1,2,0,2
11761_1,,,,2,2,1,3
11763_0,,,,2,2,1,3
C(C)(CC(C(C(C(C)=O)O)O)=O)=O,,,5,1,4,0,4
11763_1,,,,2,2,1,3
11765_0,,,,2,2,1,3
C(C)(CC(C(CC(CO)=O)O)=O)=O,,,5,1,1,0,1
11767_0,,,,2,2,1,3
C(C(C(C(CC(C)=O)=O)O)O)=O,,,5,1,13,0,13
11767_1,,,,2,2,1,3
11769_0,,,,2,2,1,3
C(CC(CC(C=O)=O)=O)(O)=O,,,5,1,4,0,4
11771_0,,,,2,2,1,3
C(CC(C(C=O)=C)O)(CC(C=O)=O)=O,,,5,1,1,0,1
11773_0,,,,2,2,1,3
C(CC(C=CC)O)(CC(C=O)=O)=O,,,5,1,1,0,1
11775_0,,,,2,2,1,3
C(CC(CC=C)O)(CC(C=O)=O)=O,,,5,1,1,0,1
11777_0,,,,2,2,1,3
C(CC(C=C)O)(CC(C=O)=O)=O,,,5,1,1,0,1
11779_0,,,,2,2,1,3
C(CC1(C=COC1)O)(CC(C=O)=O)=O,,,5,1,1,0,1
11781_0,,,,2,2,1,3
C(C(CC(CC(C=O)=O)=O)O)=O,,,5,1,4,0,4
11783_0,,,,2,2,1,3
C(C(C)(CC(CC(C=O)=O)=O)O)=O,,,5,1,1,0,1
11785_0,,,,2,2,1,3
C(CC(C(C)=O)O)(CC(C=O)=O)=O,,,5,1,1,0,1
11787_0,,,,2,2,1,3
C(CC(CC(CC(C=O)=O)=O)O)=O,,,5,1,2,0,2
11789_0,,,,2,2,1,3
C(CC(C)O)(CC(C=O)=O)=O,,,5,1,4,0,4
11791_0,,,,2,2,1,3
C(CC(CCO)O)(CC(C=O)=O)=O,,,5,1,1,0,1
11793_0,,,,2,2,1,3
C(CC(C)(CO)O)(CC(C=O)=O)=O,,,5,1,1,0,1
11795_0,,,,2,2,1,3
C(C(CC(CC(C=O)=O)=O)O)(O)=O,,,5,1,1,0,1
11797_0,,,,2,2,1,3
C(C(C=C)(CC(CC(C=O)=O)=O)O)=O,,,5,1,1,0,1
11799_0,,,,2,2,1,3
C(CC(C(C=C)=O)O)(CC(C=O)=O)=O,,,5,1,1,0,1
11801_0,,,,2,2,1,3
C(CC(C=CC=O)O)(CC(C=O)=O)=O,,,5,1,1,0,1
11802_0,,,,2,2,1,3
11803_0,,,,2,2,1,3
11805_0,,,,2,2,1,3
C(C(C(C)=O)C(C=O)=O)(O)=O,,,5,1,5,0,5
11805_1,,,,2,2,1,3
11807_0,,,,2,2,1,3
C(C)(C(C(C=O)=O)C(C(C=O)=C)O)=O,,,5,1,2,0,2
11807_1,,,,2,2,1,3
11809_0,,,,2,2,1,3
C(C)(C(C(C=O)=O)C(C=CC)O)=O,,,5,1,2,0,2
11809_1,,,,2,2,1,3
11811_0,,,,2,2,1,3
C(C)(C(C(C=O)=O)C(CC=C)O)=O,,,5,1,2,0,2
11811_1,,,,2,2,1,3
11813_0,,,,2,2,1,3
C(C)(C(C(C=O)=O)C(C=C)O)=O,,,5,1,2,0,2
11813_1,,,,2,2,1,3
11815_0,,,,2,2,1,3
C(C)(C(C(C=O)=O)C1(C=COC1)O)=O,,,5,1,2,0,2
11815_1,,,,2,2,1,3
11817_0,,,,2,2,1,3
C(C(C(C(C)=O)C(C=O)=O)O)=O,,,5,1,4,0,4
11817_1,,,,2,2,1,3
11819_0,,,,2,2,1,3
C(C(C)(C(C(C)=O)C(C=O)=O)O)=O,,,5,1,2,0,2
11819_1,,,,2,2,1,3
11821_0,,,,2,2,1,3
C(C)(C(C(C=O)=O)C(C(C)=O)O)=O,,,5,1,2,0,2
11821_1,,,,2,2,1,3
11823_0,,,,2,2,1,3
C(CC(C(C(C)=O)C(C=O)=O)O)=O,,,5,1,3,0,3
11823_1,,,,2,2,1,3
11825_0,,,,2,2,1,3
C(C)(C(C(C=O)=O)C(C)O)=O,,,5,1,4,0,4
11825_1,,,,2,2,1,3
11827_0,,,,2,2,1,3
C(C)(C(C(C=O)=O)C(CCO)O)=O,,,5,1,2,0,2
11827_1,,,,2,2,1,3
11829_0,,,,2,2,1,3
C(C)(C(C(C=O)=O)C(C)(CO)O)=O,,,5,1,2,0,2
11829_1,,,,2,2,1,3
11831_0,,,,2,2,1,3
C(C(C(C(C)=O)C(C=O)=O)O)(O)=O,,,5,1,2,0,2
11831_1,,,,2,2,1,3
11833_0,,,,2,2,1,3
C(C(C=C)(C(C(C)=O)C(C=O)=O)O)=O,,,5,1,2,0,2
11833_1,,,,2,2,1,3
11835_0,,,,2,2,1,3
C(C)(C(C(C=O)=O)C(C(C=C)=O)O)=O,,,5,1,2,0,2
11835_1,,,,2,2,1,3
11837_0,,,,2,2,1,3
C(C)(C(C(C=O)=O)C(C=CC=O)O)=O,,,5,1,2,0,2
11837_1,,,,2,2,1,3
11838_0,,,,2,2,1,3
11838_1,,,,2,2,1,3
11840_0,,,,2,2,1,3
C(C)(C(C(C=O)=O)C(CO)O)=O,,,5,1,5,0,5
11840_1,,,,2,2,1,3
11842_0,,,,2,2,1,3
C(C(C=O)C(C(C=O)C(C)=O)O)=O,,,5,1,4,0,4
11842_1,,,,2,2,1,3
11844_0,,,,2,2,1,3
C(C(C=O)C(CC(CC=O)=O)O)=O,,,5,1,3,0,3
11846_0,,,,2,2,1,3
C(C(C=O)C(C(C(C=C)=O)O)O)=O,,,5,1,4,0,4
11846_1,,,,2,2,1,3
11848_0,,,,2,2,1,3
C(C(C=O)C(C(C(C=O)=O)C)O)=O,,,5,1,3,0,3
11849_0,,,,2,2,1,3
11851_0,,,,2,2,1,3
C(C(C=O)C(CC(C(C)=O)=O)O)=O,,,5,1,3,0,3
11853_0,,,,2,2,1,3
C(C(C(C=O)=C)C(C(C=O)C=O)O)=O,,,5,1,3,0,3
11855_0,,,,2,2,1,3
C(C(C=O)C(CC(C=CC=O)=O)O)=O,,,5,1,1,0,1
11857_0,,,,2,2,1,3
C(C(C=O)C(C(C=C)C(C=O)=O)O)=O,,,5,1,1,0,1
11859_0,,,,2,2,1,3
C(C(C=CC=O)C(C(C=O)C=O)O)=O,,,5,1,3,0,3
11861_0,,,,2,2,1,3
C(C(C=C)C(C(C=O)C=O)O)=O,,,5,1,4,0,4
11863_0,,,,2,2,1,3
C(C(C=O)C(C1C(C=CO1)=O)O)=O,,,5,1,2,0,2
11863_1,,,,2,2,1,3
11864_0,,,,2,2,1,3
11864_1,,,,2,2,1,3
11865_0,,,,2,2,1,3
11867_0,,,,2,2,1,3
C(C(C=O)C(C(C=O)C=O)O)=O,,,5,1,2,0,2
11867_1,,,,2,2,1,3
11868_0,,,,2,2,1,3
11869_0,,,,2,2,1,3
11869_1,,,,2,2,1,3
11870_0,,,,2,2,1,3
11870_1,,,,2,2,1,3
11871_0,,,,2,2,1,3
11871_1,,,,2,2,1,3
11872_0,,,,2,2,1,3
11872_1,,,,2,2,1,3
11873_0,,,,2,2,1,3
11875_0,,,,2,2,1,3
C(C(C=O)C(CC(C(O)=O)=O)O)=O,,,5,1,3,0,3
11877_0,,,,2,2,1,3
C(C(C=O)C(C(C=O)C=O)O)(O)=O,,,5,1,4,0,4
11877_1,,,,2,2,1,3
11879_0,,,,2,2,1,3
C(C(C=O)C(C(C=O)O)O)=O,,,5,1,5,0,5
11879_1,,,,2,2,1,3
11880_0,,,,2,2,1,3
11881_0,,,,2,2,1,3
11881_1,,,,2,2,1,3
11882_0,,,,2,2,1,3
11883_0,,,,2,2,1,3
11883_1,,,,2,2,1,3
11884_0,,,,2,2,1,3
11886_0,,,,2,2,1,3
C(C(C(C(C(C=O)=O)CO)O)O)=O,,,5,1,5,0,5
11886_1,,,,2,2,1,3
11887_0,,,,2,2,1,3
11889_0,,,,2,2,1,3
C(C(C(C(C=O)C(CO)=O)O)O)=O,,,5,1,6,0,6
11889_1,,,,2,2,1,3
11890_0,,,,2,2,1,3
11891_0,,,,2,2,1,3
11891_1,,,,2,2,1,3
11893_0,,,,2,2,1,3
C(C(C=O)C(C(C(O)=O)O)=O)=O,,,5,1,2,0,2
11893_1,,,,2,2,1,3
11895_0,,,,2,2,1,3
C(C(C=O)C(C(C(C=C)O)O)=O)=O,,,5,1,2,0,2
11895_1,,,,2,2,1,3
11897_0,,,,2,2,1,3
C(C(C=O)C(C(C(C=O)O)O)=O)=O,,,5,1,2,0,2
11897_1,,,,2,2,1,3
11899_0,,,,2,2,1,3
C(C(C=O)C(C(C(C)O)O)=O)=O,,,5,1,4,0,4
11899_1,,,,2,2,1,3
11901_0,,,,2,2,1,3
C(C(C=O)C(C(CO)O)=O)=O,,,5,1,3,0,3
11901_1,,,,2,2,1,3
11903_0,,,,2,2,1,3
C(C(C=O)C(C(C(CO)O)O)=O)=O,,,5,1,3,0,3
11903_1,,,,2,2,1,3
11904_0,,,,2,2,1,3
11906_0,,,,2,2,1,3
C(CC(C(C=O)O)O)(C(C=O)O)=O,,,5,1,4,0,4
11906_1,,,,2,2,1,3
11908_0,,,,2,2,1,3
C(CC(C(C=O)O)(CC=O)O)=O,,,5,1,4,0,4
11910_0,,,,2,2,1,3
C(CC(C(C=O)O)(C(C=O)O)O)=O,,,5,1,2,0,2
11910_1,,,,2,2,1,3
11911_0,,,,2,2,1,3
11913_0,,,,2,2,1,3
C(CC(C(C(C(C=O)O)O)O)=O)=O,,,5,1,5,0,5
11913_1,,,,2,2,1,3
11915_0,,,,2,2,1,3
C(C(C=O)C(C(C=O)O)=O)(O)=O,,,5,1,2,0,2
11915_1,,,,2,2,1,3
11917_0,,,,2,2,1,3
C(C(C(C(C=O)O)=O)C(C=C)O)=O,,,5,1,2,0,2
11917_1,,,,2,2,1,3
11919_0,,,,2,2,1,3
C(C(C(C(C=O)O)=O)C(C=O)O)=O,,,5,1,2,0,2
11919_1,,,,2,2,1,3
11921_0,,,,2,2,1,3
C(C(C(C(C=O)O)=O)C(C)O)=O,,,5,1,2,0,2
11921_1,,,,2,2,1,3
11923_0,,,,2,2,1,3
C(C(C(C(C=O)O)=O)CO)=O,,,5,1,2,0,2
11923_1,,,,2,2,1,3
11925_0,,,,2,2,1,3
C(C(C(C(C=O)O)=O)C(CO)O)=O,,,5,1,2,0,2
11925_1,,,,2,2,1,3
11927_0,,,,2,2,1,3
C(C(C(C(C=O)C(C)=O)O)O)=O,,,5,1,7,0,7
11927_1,,,,2,2,1,3
11929_0,,,,2,2,1,3
C(CC(C(C=O)O)O)(CC=O)=O,,,5,1,9,0,9
11931_0,,,,2,2,1,3
C(C(C(C(C(C(O)=O)=O)O)O)O)=O,,,5,1,2,0,2
11931_1,,,,2,2,1,3
11933_0,,,,2,2,1,3
C(C(C(CC(COC=O)=O)O)O)=O,,,5,1,1,0,1
11935_0,,,,2,2,1,3
C(C(C(C(C(C)=O)OC=O)O)O)=O,,,5,1,2,0,2
11935_1,,,,2,2,1,3
11937_0,,,,2,2,1,3
C(C(C(C(C(C(C)O)=O)O)O)O)=O,,,5,1,10,0,10
11937_1,,,,2,2,1,3
11939_0,,,,2,2,1,3
C(C(C(C(C(C=C)=O)O)O)O)=O,,,5,1,7,0,7
11939_1,,,,2,2,1,3
11941_0,,,,2,2,1,3
C(C(C(C(C(C=O)=O)C)O)O)=O,,,5,1,6,0,6
11942_0,,,,2,2,1,3
11944_0,,,,2,2,1,3
C(C(C(CC(C(C)=O)=O)O)O)=O,,,5,1,8,0,8
11946_0,,,,2,2,1,3
C(C(C(C(C(C(O)=O)=O)C)O)O)=O,,,5,1,3,0,3
11948_0,,,,2,2,1,3
C(C(C(C(C(O)=O)C(C)=O)O)O)=O,,,5,1,2,0,2
11948_1,,,,2,2,1,3
11950_0,,,,2,2,1,3
C(CC(C(C=O)O)O)(CC(O)=O)=O,,,5,1,3,0,3
11952_0,,,,2,2,1,3
C(C(C(C1C(C(OC1)=O)=O)O)O)=O,,,5,1,2,0,2
11952_1,,,,2,2,1,3
11954_0,,,,2,2,1,3
C(C(C(C1C(OCC1=O)=O)O)O)=O,,,5,1,2,0,2
11954_1,,,,2,2,1,3
11956_0,,,,2,2,1,3
C(C(C(C1C(CC(O1)=O)=O)O)O)=O,,,5,1,2,0,2
11956_1,,,,2,2,1,3
11958_0,,,,2,2,1,3
C(C(C(C=O)=C)C(C(C=O)O)O)=O,,,5,1,3,0,3
11960_0,,,,2,2,1,3
C(C(C(CC(C=CC=O)=O)O)O)=O,,,5,1,1,0,1
11962_0,,,,2,2,1,3
C(C(C(C(C=C)C(C=O)=O)O)O)=O,,,5,1,1,0,1
11964_0,,,,2,2,1,3
C(C(C=CC=O)C(C(C=O)O)O)=O,,,5,1,3,0,3
11966_0,,,,2,2,1,3
C(C(C=C)C(C(C=O)O)O)=O,,,5,1,4,0,4
11968_0,,,,2,2,1,3
C(C(C(C1C(C=CO1)=O)O)O)=O,,,5,1,2,0,2
11968_1,,,,2,2,1,3
11969_0,,,,2,2,1,3
11969_1,,,,2,2,1,3
11970_0,,,,2,2,1,3
11971_0,,,,2,2,1,3
11971_1,,,,2,2,1,3
11972_0,,,,2,2,1,3
11972_1,,,,2,2,1,3
11973_0,,,,2,2,1,3
11973_1,,,,2,2,1,3
11974_0,,,,2,2,1,3
11974_1,,,,2,2,1,3
11975_0,,,,2,2,1,3
11975_1,,,,2,2,1,3
11976_0,,,,2,2,1,3
11977_0,,,,2,2,1,3
11978_0,,,,2,2,1,3
11978_1,,,,2,2,1,3
11979_0,,,,2,2,1,3
11979_1,,,,2,2,1,3
11980_0,,,,2,2,1,3
11980_1,,,,2,2,1,3
11981_0,,,,2,2,1,3
11981_1,,,,2,2,1,3
11983_0,,,,2,2,1,3
C(C(C(C(C(C(C)=O)=O)O)O)O)=O,,,5,1,3,0,3
11983_1,,,,2,2,1,3
11985_0,,,,2,2,1,3
C(C(C(CC(C(CO)=O)=O)O)O)=O,,,5,1,4,0,4
11986_0,,,,2,2,1,3
11986_1,,,,2,2,1,3
11987_0,,,,2,2,1,3
11988_0,,,,2,2,1,3
11988_1,,,,2,2,1,3
11989_0,,,,2,2,1,3
11989_1,,,,2,2,1,3
11990_0,,,,2,2,1,3
11992_0,,,,2,2,1,3
C(C(C(CC(C(O)=O)=O)O)O)=O,,,5,1,5,0,5
11994_0,,,,2,2,1,3
C(C(C=O)C(C(C=O)O)O)(O)=O,,,5,1,5,0,5
11994_1,,,,2,2,1,3
11996_0,,,,2,2,1,3
C(C(C(C1C(C(CO1)O)=O)O)O)=O,,,5,1,3,0,3
11996_1,,,,2,2,1,3
11998_0,,,,2,2,1,3
C(C(C(C1C(C(O)OC1)=O)O)O)=O,,,5,1,3,0,3
11998_1,,,,2,2,1,3
12000_0,,,,2,2,1,3
C(C(C(C1C(COC1O)=O)O)O)=O,,,5,1,3,0,3
12000_1,,,,2,2,1,3
12002_0,,,,2,2,1,3
C(C(C(C1C(CC(O1)O)=O)O)O)=O,,,5,1,3,0,3
12002_1,,,,2,2,1,3
12003_0,,,,2,2,1,3
12003_1,,,,2,2,1,3
12005_0,,,,2,2,1,3
C(C(C=C)C(C)(C(C=O)C=O)O)=O,,,5,1,1,0,1
12007_0,,,,2,2,1,3
C(C(C=O)C(C)(C1C(C=CO1)=O)O)=O,,,5,1,2,0,2
12007_1,,,,2,2,1,3
12008_0,,,,2,2,1,3
12010_0,,,,2,2,1,3
C(C(C=O)C(C)(C(C=O)C=O)O)=O,,,5,1,2,0,2
12010_1,,,,2,2,1,3
12012_0,,,,2,2,1,3
C(C(C=O)C(C)(CC=O)O)=O,,,5,1,5,0,5
12014_0,,,,2,2,1,3
C(C(C=O)C(C)(C(C=O)CO)O)=O,,,5,1,4,0,4
12014_1,,,,2,2,1,3
12016_0,,,,2,2,1,3
C(C(C=O)C(C)(C(C(C)=O)O)O)=O,,,5,1,2,0,2
12016_1,,,,2,2,1,3
12018_0,,,,2,2,1,3
C(C(C=O)C(C)(CC(CO)=O)O)=O,,,5,1,3,0,3
12019_0,,,,2,2,1,3
12019_1,,,,2,2,1,3
12021_0,,,,2,2,1,3
C(C(C=C)C(C(C=O)C(C)=O)O)=O,,,5,1,3,0,3
12023_0,,,,2,2,1,3
C(C(C(C)=O)C(C1C(C=CO1)=O)O)=O,,,5,1,2,0,2
12023_1,,,,2,2,1,3
12024_0,,,,2,2,1,3
12025_0,,,,2,2,1,3
12025_1,,,,2,2,1,3
12027_0,,,,2,2,1,3
C(CC(C(C=O)C(C)=O)O)=O,,,5,1,7,0,7
12029_0,,,,2,2,1,3
C(C(CO)C(C(C=O)C(C)=O)O)=O,,,5,1,4,0,4
12029_1,,,,2,2,1,3
12031_0,,,,2,2,1,3
C(C(C(C)=O)C(C(C(C)=O)O)O)=O,,,5,1,4,0,4
12031_1,,,,2,2,1,3
12033_0,,,,2,2,1,3
C(C)(C(C=O)C(CC(CO)=O)O)=O,,,5,1,3,0,3
12034_0,,,,2,2,1,3
12034_1,,,,2,2,1,3
12036_0,,,,2,2,1,3
C(C(C=O)C(CC(O)=O)=O)=O,,,5,1,1,0,1
12038_0,,,,2,2,1,3
C(C(C=O)C(CC(C(C=O)=C)O)=O)=O,,,5,1,1,0,1
12040_0,,,,2,2,1,3
C(C(C=O)C(CC(C=CC)O)=O)=O,,,5,1,1,0,1
12042_0,,,,2,2,1,3
C(C(C=O)C(CC(CC=C)O)=O)=O,,,5,1,1,0,1
12044_0,,,,2,2,1,3
C(C(C=O)C(CC(C=C)O)=O)=O,,,5,1,1,0,1
12046_0,,,,2,2,1,3
C(C(C=O)C(CC1(C=COC1)O)=O)=O,,,5,1,1,0,1
12048_0,,,,2,2,1,3
C(C(C=O)C(CC(C=O)O)=O)=O,,,5,1,3,0,3
12050_0,,,,2,2,1,3
C(C(C)(CC(C(C=O)C=O)=O)O)=O,,,5,1,1,0,1
12052_0,,,,2,2,1,3
C(C(C=O)C(CC(C(C)=O)O)=O)=O,,,5,1,1,0,1
12054_0,,,,2,2,1,3
C(C(C=O)C(CC(CC=O)O)=O)=O,,,5,1,1,0,1
12056_0,,,,2,2,1,3
C(C(C=O)C(CC(C)O)=O)=O,,,5,1,3,0,3
12058_0,,,,2,2,1,3
C(C(C=O)C(CC(CCO)O)=O)=O,,,5,1,1,0,1
12060_0,,,,2,2,1,3
C(C(C=O)C(CC(C)(CO)O)=O)=O,,,5,1,1,0,1
12062_0,,,,2,2,1,3
C(C(C=O)C(CC(C(O)=O)O)=O)=O,,,5,1,1,0,1
12064_0,,,,2,2,1,3
C(C(C=O)C(CC(C=O)(C=C)O)=O)=O,,,5,1,1,0,1
12066_0,,,,2,2,1,3
C(C(C=O)C(CC(C(C=C)=O)O)=O)=O,,,5,1,1,0,1
12068_0,,,,2,2,1,3
C(C(C=O)C(CC(C=CC=O)O)=O)=O,,,5,1,1,0,1
12069_0,,,,2,2,1,3
12070_0,,,,2,2,1,3
12072_0,,,,2,2,1,3
C(C(C(C)=O)C(CC(C)=O)O)=O,,,5,1,2,0,2
12072_1,,,,2,2,1,3
12074_0,,,,2,2,1,3
C(CC(CC(C)=O)O)(CC=O)=O,,,5,1,1,0,1
12076_0,,,,2,2,1,3
C(C)(CC(C(C(C(O)=O)=O)O)O)=O,,,5,1,2,0,2
12076_1,,,,2,2,1,3
12078_0,,,,2,2,1,3
C(C)(CC(CC(COC=O)=O)O)=O,,,5,1,1,0,1
12080_0,,,,2,2,1,3
C(OC(C(C)=O)C(CC(C)=O)O)=O,,,5,1,2,0,2
12080_1,,,,2,2,1,3
12082_0,,,,2,2,1,3
C(C(C(CC(C)=O)O)O)(C(C)O)=O,,,5,1,2,0,2
12082_1,,,,2,2,1,3
12084_0,,,,2,2,1,3
C(C)(CC(C(C(C=C)=O)O)O)=O,,,5,1,2,0,2
12084_1,,,,2,2,1,3
12086_0,,,,2,2,1,3
C(C)(CC(C(C(C=O)=O)C)O)=O,,,5,1,1,0,1
12088_0,,,,2,2,1,3
C(C)(CC(C(C=O)CC=O)O)=O,,,5,1,1,0,1
12090_0,,,,2,2,1,3
C(C)(CC(CC(C(C)=O)=O)O)=O,,,5,1,1,0,1
12092_0,,,,2,2,1,3
C(C)(CC(C(C(C(O)=O)=O)C)O)=O,,,5,1,1,0,1
12094_0,,,,2,2,1,3
C(C(C(C)=O)C(CC(C)=O)O)(O)=O,,,5,1,2,0,2
12094_1,,,,2,2,1,3
12096_0,,,,2,2,1,3
C(CC(CC(C)=O)O)(CC(O)=O)=O,,,5,1,1,0,1
12098_0,,,,2,2,1,3
C(C)(CC(C1C(C(OC1)=O)=O)O)=O,,,5,1,2,0,2
12098_1,,,,2,2,1,3
12100_0,,,,2,2,1,3
C(C)(CC(C1C(OCC1=O)=O)O)=O,,,5,1,2,0,2
12100_1,,,,2,2,1,3
12102_0,,,,2,2,1,3
C1(C(C(CC(C)=O)O)OC(C1)=O)=O,,,5,1,2,0,2
12102_1,,,,2,2,1,3
12104_0,,,,2,2,1,3
C(C(C(C=O)=C)C(CC(C)=O)O)=O,,,5,1,1,0,1
12106_0,,,,2,2,1,3
C(C)(CC(CC(C=CC=O)=O)O)=O,,,5,1,1,0,1
12108_0,,,,2,2,1,3
C(C)(CC(C(C=C)C(C=O)=O)O)=O,,,5,1,1,0,1
12110_0,,,,2,2,1,3
C(C(C=CC=O)C(CC(C)=O)O)=O,,,5,1,1,0,1
12112_0,,,,2,2,1,3
C(C(C=C)C(CC(C)=O)O)=O,,,5,1,1,0,1
12114_0,,,,2,2,1,3
C(C)(CC(C1C(C=CO1)=O)O)=O,,,5,1,2,0,2
12114_1,,,,2,2,1,3
12116_0,,,,2,2,1,3
C(C)(CC(C(C(CO)=O)O)O)=O,,,5,1,4,0,4
12116_1,,,,2,2,1,3
12118_0,,,,2,2,1,3
C(C)(CC(CC(C=O)=O)O)=O,,,5,1,3,0,3
12120_0,,,,2,2,1,3
C(C(C=O)C(CC(C)=O)O)=O,,,5,1,4,0,4
12120_1,,,,2,2,1,3
12122_0,,,,2,2,1,3
C(C)(CC(C(C(C=O)=O)CO)O)=O,,,5,1,2,0,2
12122_1,,,,2,2,1,3
12124_0,,,,2,2,1,3
C(C)(CC(C(C=O)C(C=O)O)O)=O,,,5,1,2,0,2
12124_1,,,,2,2,1,3
12126_0,,,,2,2,1,3
C(C)(CC(C(C=O)C(CO)=O)O)=O,,,5,1,2,0,2
12126_1,,,,2,2,1,3
12128_0,,,,2,2,1,3
C(C(C(CC(C)=O)O)O)(CC=O)=O,,,5,1,2,0,2
12128_1,,,,2,2,1,3
12130_0,,,,2,2,1,3
C(CC(CC(C)=O)O)(C(C=O)O)=O,,,5,1,1,0,1
12132_0,,,,2,2,1,3
C(CC(CC(C)=O)O)=O,,,5,1,5,0,5
12134_0,,,,2,2,1,3
C(C(C(CC(C)=O)O)C(C)O)=O,,,5,1,4,0,4
12134_1,,,,2,2,1,3
12136_0,,,,2,2,1,3
C(C(CO)C(CC(C)=O)O)=O,,,5,1,4,0,4
12136_1,,,,2,2,1,3
12138_0,,,,2,2,1,3
C(C(C(CC(C)=O)O)C(CO)O)=O,,,5,1,2,0,2
12138_1,,,,2,2,1,3
12140_0,,,,2,2,1,3
C(C)(CC(C(C(C=O)=O)O)O)=O,,,5,1,5,0,5
12140_1,,,,2,2,1,3
12142_0,,,,2,2,1,3
C(C)(CC(C(C(C(C)=O)=O)O)O)=O,,,5,1,2,0,2
12142_1,,,,2,2,1,3
12144_0,,,,2,2,1,3
C(C)(CC(CC(C(CO)=O)=O)O)=O,,,5,1,1,0,1
12146_0,,,,2,2,1,3
C(C)(CC(C(C(C)=O)O)O)=O,,,5,1,4,0,4
12146_1,,,,2,2,1,3
12148_0,,,,2,2,1,3
C(C)(CC(CC(CO)=O)O)=O,,,5,1,3,0,3
12150_0,,,,2,2,1,3
C(C(C(CC(C)=O)O)O)(CCO)=O,,,5,1,2,0,2
12150_1,,,,2,2,1,3
12152_0,,,,2,2,1,3
C(C)(CC(C(C(CO)=O)CO)O)=O,,,5,1,2,0,2
12152_1,,,,2,2,1,3
12154_0,,,,2,2,1,3
C(C(CO)O)(CC(CC(C)=O)O)=O,,,5,1,1,0,1
12156_0,,,,2,2,1,3
C(C)(CC(CC(C(O)=O)=O)O)=O,,,5,1,3,0,3
12158_0,,,,2,2,1,3
C(C(C=O)C(CC(C)=O)O)(O)=O,,,5,1,4,0,4
12158_1,,,,2,2,1,3
12160_0,,,,2,2,1,3
C1(C(C(CC(C)=O)O)OCC1O)=O,,,5,1,2,0,2
12160_1,,,,2,2,1,3
12162_0,,,,2,2,1,3
C(C)(CC(C1C(C(O)OC1)=O)O)=O,,,5,1,2,0,2
12162_1,,,,2,2,1,3
12164_0,,,,2,2,1,3
C(C)(CC(C1C(COC1O)=O)O)=O,,,5,1,2,0,2
12164_1,,,,2,2,1,3
12166_0,,,,2,2,1,3
C1(C(C(CC(C)=O)O)OC(C1)O)=O,,,5,1,2,0,2
12166_1,,,,2,2,1,3
12168_0,,,,2,2,1,3
C(C(C(CC(C)=O)O)O)=O,,,5,1,5,0,5
12168_1,,,,2,2,1,3
12170_0,,,,2,2,1,3
C(CC(C)(C(C=O)C(C)=O)O)=O,,,5,1,4,0,4
12170_1,,,,2,2,1,3
12172_0,,,,2,2,1,3
C(CC(CC(C)(CC=O)O)=O)=O,,,5,1,3,0,3
12174_0,,,,2,2,1,3
C(CC(C)(C(C(C(O)=O)=O)O)O)=O,,,5,1,2,0,2
12174_1,,,,2,2,1,3
12176_0,,,,2,2,1,3
C(CC(C)(CC(COC=O)=O)O)=O,,,5,1,1,0,1
12178_0,,,,2,2,1,3
C(CC(C)(C(C(C)=O)OC=O)O)=O,,,5,1,2,0,2
12178_1,,,,2,2,1,3
12180_0,,,,2,2,1,3
C(CC(C)(C(C(C(C)O)=O)O)O)=O,,,5,1,3,0,3
12180_1,,,,2,2,1,3
12182_0,,,,2,2,1,3
C(CC(C)(C(C(C=C)=O)O)O)=O,,,5,1,2,0,2
12182_1,,,,2,2,1,3
12184_0,,,,2,2,1,3
C(CC(C)(C(C(C=O)=O)C)O)=O,,,5,1,1,0,1
12185_0,,,,2,2,1,3
12187_0,,,,2,2,1,3
C(CC(C)(CC(C(C)=O)=O)O)=O,,,5,1,2,0,2
12189_0,,,,2,2,1,3
C(CC(C)(C(C(C(O)=O)=O)C)O)=O,,,5,1,1,0,1
12191_0,,,,2,2,1,3
C(CC(C)(C(C(O)=O)C(C)=O)O)=O,,,5,1,2,0,2
12191_1,,,,2,2,1,3
12193_0,,,,2,2,1,3
C(CC(CC(C)(CC=O)O)=O)(O)=O,,,5,1,1,0,1
12195_0,,,,2,2,1,3
C(CC(C)(C1C(C(OC1)=O)=O)O)=O,,,5,1,2,0,2
12195_1,,,,2,2,1,3
12197_0,,,,2,2,1,3
C(CC(C)(C1C(OCC1=O)=O)O)=O,,,5,1,2,0,2
12197_1,,,,2,2,1,3
12199_0,,,,2,2,1,3
C(CC(C)(C1C(CC(O1)=O)=O)O)=O,,,5,1,2,0,2
12199_1,,,,2,2,1,3
12201_0,,,,2,2,1,3
C(C(C(C=O)=C)C(C)(CC=O)O)=O,,,5,1,1,0,1
12203_0,,,,2,2,1,3
C(CC(C)(CC(C=CC=O)=O)O)=O,,,5,1,1,0,1
12205_0,,,,2,2,1,3
C(CC(C)(C(C=C)C(C=O)=O)O)=O,,,5,1,1,0,1
12207_0,,,,2,2,1,3
C(C(C=CC=O)C(C)(CC=O)O)=O,,,5,1,1,0,1
12209_0,,,,2,2,1,3
C(C(C=C)C(C)(CC=O)O)=O,,,5,1,1,0,1
12211_0,,,,2,2,1,3
C(CC(C)(C1C(C=CO1)=O)O)=O,,,5,1,2,0,2
12211_1,,,,2,2,1,3
12212_0,,,,2,2,1,3
12212_1,,,,2,2,1,3
12213_0,,,,2,2,1,3
12214_0,,,,2,2,1,3
12214_1,,,,2,2,1,3
12216_0,,,,2,2,1,3
C(CC(C)(C(C(C=O)=O)CO)O)=O,,,5,1,3,0,3
12216_1,,,,2,2,1,3
12218_0,,,,2,2,1,3
C(CC(C)(C(C=O)C(C=O)O)O)=O,,,5,1,3,0,3
12218_1,,,,2,2,1,3
12220_0,,,,2,2,1,3
C(CC(C)(C(C=O)C(CO)=O)O)=O,,,5,1,3,0,3
12220_1,,,,2,2,1,3
12222_0,,,,2,2,1,3
C(CC(C)(C(C(CC=O)=O)O)O)=O,,,5,1,3,0,3
12222_1,,,,2,2,1,3
12224_0,,,,2,2,1,3
C(C(C(CC(C)(CC=O)O)=O)O)=O,,,5,1,2,0,2
12226_0,,,,2,2,1,3
C(CC(C)(CC=O)O)=O,,,5,1,2,0,2
12228_0,,,,2,2,1,3
C(C(C(C)O)C(C)(CC=O)O)=O,,,5,1,3,0,3
12228_1,,,,2,2,1,3
12230_0,,,,2,2,1,3
C(C(CO)C(C)(CC=O)O)=O,,,5,1,4,0,4
12230_1,,,,2,2,1,3
12232_0,,,,2,2,1,3
C(C(C(CO)O)C(C)(CC=O)O)=O,,,5,1,4,0,4
12232_1,,,,2,2,1,3
12233_0,,,,2,2,1,3
12233_1,,,,2,2,1,3
12235_0,,,,2,2,1,3
C(CC(C)(C(C(C(C)=O)=O)O)O)=O,,,5,1,2,0,2
12235_1,,,,2,2,1,3
12237_0,,,,2,2,1,3
C(CC(C)(CC(C(CO)=O)=O)O)=O,,,5,1,2,0,2
12239_0,,,,2,2,1,3
C(CC(C)(C(C(C)=O)O)O)=O,,,5,1,3,0,3
12239_1,,,,2,2,1,3
12241_0,,,,2,2,1,3
C(CC(C)(CC(CO)=O)O)=O,,,5,1,3,0,3
12243_0,,,,2,2,1,3
C(CC(C)(C(C(CCO)=O)O)O)=O,,,5,1,2,0,2
12243_1,,,,2,2,1,3
12245_0,,,,2,2,1,3
C(CC(C)(C(C(CO)=O)CO)O)=O,,,5,1,3,0,3
12245_1,,,,2,2,1,3
12247_0,,,,2,2,1,3
C(CC(C)(CC(C(CO)O)=O)O)=O,,,5,1,2,0,2
12249_0,,,,2,2,1,3
C(CC(C)(CC(C(O)=O)=O)O)=O,,,5,1,4,0,4
12251_0,,,,2,2,1,3
C(C(C=O)C(C)(CC=O)O)(O)=O,,,5,1,3,0,3
12251_1,,,,2,2,1,3
12253_0,,,,2,2,1,3
C(CC(C)(C1C(C(CO1)O)=O)O)=O,,,5,1,2,0,2
12253_1,,,,2,2,1,3
12255_0,,,,2,2,1,3
C(CC(C)(C1C(C(O)OC1)=O)O)=O,,,5,1,2,0,2
12255_1,,,,2,2,1,3
12257_0,,,,2,2,1,3
C(CC(C)(C1C(COC1O)=O)O)=O,,,5,1,2,0,2
12257_1,,,,2,2,1,3
12259_0,,,,2,2,1,3
C(CC(C)(C1C(CC(O1)O)=O)O)=O,,,5,1,2,0,2
12259_1,,,,2,2,1,3
12260_0,,,,2,2,1,3
12260_1,,,,2,2,1,3
12262_0,,,,2,2,1,3
C(C(C(O)=O)C(C)=O)=O,,,5,1,7,0,7
12262_1,,,,2,2,1,3
12264_0,,,,2,2,1,3
C(C(CO)(C(C=O)C(C)=O)O)(O)=O,,,5,1,2,0,2
12264_1,,,,2,2,1,3
12266_0,,,,2,2,1,3
C(C(C(C(C=O)C(C)=O)O)O)(O)=O,,,5,1,3,0,3
12266_1,,,,2,2,1,3
12268_0,,,,2,2,1,3
C(OCC(C)(C(C=O)C(C)=O)O)=O,,,5,1,2,0,2
12268_1,,,,2,2,1,3
12270_0,,,,2,2,1,3
C(C(C(C)=O)C(CO)(C(C)O)O)=O,,,5,1,2,0,2
12270_1,,,,2,2,1,3
12272_0,,,,2,2,1,3
C(C(C(C)=O)C(C=C)(CO)O)=O,,,5,1,2,0,2
12272_1,,,,2,2,1,3
12274_0,,,,2,2,1,3
C(C(C(C)=O)C(C=CCO)O)=O,,,5,1,2,0,2
12274_1,,,,2,2,1,3
12276_0,,,,2,2,1,3
C(C(C(C)=O)C(C(O)=O)(C=C)O)=O,,,5,1,2,0,2
12276_1,,,,2,2,1,3
12278_0,,,,2,2,1,3
C(C(C(C)=O)C(C=CC(O)=O)O)=O,,,5,1,2,0,2
12278_1,,,,2,2,1,3
12280_0,,,,2,2,1,3
C(C(CC)(C(C=O)C(C)=O)O)=O,,,5,1,2,0,2
12280_1,,,,2,2,1,3
12282_0,,,,2,2,1,3
C(C)(C(C=O)C(C(CC)=O)O)=O,,,5,1,2,0,2
12282_1,,,,2,2,1,3
12284_0,,,,2,2,1,3
C(CCC(C(C=O)C(C)=O)O)=O,,,5,1,3,0,3
12284_1,,,,2,2,1,3
12286_0,,,,2,2,1,3
C(C(C(C)=O)C(C(C)=O)(C)O)=O,,,5,1,2,0,2
12286_1,,,,2,2,1,3
12288_0,,,,2,2,1,3
C(C(CC)(C(C=O)C(C)=O)O)(O)=O,,,5,1,2,0,2
12288_1,,,,2,2,1,3
12290_0,,,,2,2,1,3
C(CC(C)(C(C=O)C(C)=O)O)(O)=O,,,5,1,2,0,2
12290_1,,,,2,2,1,3
12292_0,,,,2,2,1,3
C1(C(CCO1)(C(C=O)C(C)=O)O)=O,,,5,1,2,0,2
12292_1,,,,2,2,1,3
12294_0,,,,2,2,1,3
C1(CC(CO1)(C(C=O)C(C)=O)O)=O,,,5,1,2,0,2
12294_1,,,,2,2,1,3
12296_0,,,,2,2,1,3
C(C(C(C)=O)C(C=O)(C=CC=O)O)=O,,,5,1,2,0,2
12296_1,,,,2,2,1,3
12298_0,,,,2,2,1,3
C(C(C(C)=O)C(C(C=CC=O)=O)O)=O,,,5,1,2,0,2
12298_1,,,,2,2,1,3
12300_0,,,,2,2,1,3
C(C(C(C)=O)C(C=CC(C=O)=O)O)=O,,,5,1,2,0,2
12300_1,,,,2,2,1,3
12302_0,,,,2,2,1,3
C(C(C(C)=O)C(C(C=O)=CC=O)O)=O,,,5,1,2,0,2
12302_1,,,,2,2,1,3
12304_0,,,,2,2,1,3
C(C(C(C)=O)C(C=C(C=O)C=O)O)=O,,,5,1,2,0,2
12304_1,,,,2,2,1,3
12306_0,,,,2,2,1,3
C(C(C(C)=O)C(C=C(C=O)C)O)=O,,,5,1,2,0,2
12306_1,,,,2,2,1,3
12308_0,,,,2,2,1,3
C(C(C(C)=O)C(C(C)=CC=O)O)=O,,,5,1,2,0,2
12308_1,,,,2,2,1,3
12310_0,,,,2,2,1,3
C(C(C(C)=O)C(CC(C=O)=C)O)=O,,,5,1,2,0,2
12310_1,,,,2,2,1,3
12312_0,,,,2,2,1,3
C(C(C(C)=O)C(C(CC=O)=C)O)=O,,,5,1,2,0,2
12312_1,,,,2,2,1,3
12314_0,,,,2,2,1,3
C(C(C(C)=O)C(C=CC(C)=O)O)=O,,,5,1,2,0,2
12314_1,,,,2,2,1,3
12316_0,,,,2,2,1,3
C(C(C(C)=O)C(C=CC=O)(C)O)=O,,,5,1,2,0,2
12316_1,,,,2,2,1,3
12318_0,,,,2,2,1,3
C(C(C(C)=O)C(C=O)(CC=C)O)=O,,,5,1,2,0,2
12318_1,,,,2,2,1,3
12320_0,,,,2,2,1,3
C(C(C(C)=O)C(C(CC=C)=O)O)=O,,,5,1,2,0,2
12320_1,,,,2,2,1,3
12322_0,,,,2,2,1,3
C(C(C(C)=O)C(C=O)(C=CC)O)=O,,,5,1,2,0,2
12322_1,,,,2,2,1,3
12324_0,,,,2,2,1,3
C(C(C(C)=O)C(C(C=CC)=O)O)=O,,,5,1,2,0,2
12324_1,,,,2,2,1,3
12326_0,,,,2,2,1,3
C(C(C(C)=O)C(C=CCC=O)O)=O,,,5,1,2,0,2
12326_1,,,,2,2,1,3
12328_0,,,,2,2,1,3
C(C(C(C)=O)C(CC=CC=O)O)=O,,,5,1,2,0,2
12328_1,,,,2,2,1,3
12329_0,,,,2,2,1,3
12329_1,,,,2,2,1,3
12331_0,,,,2,2,1,3
C(C(C(C)=O)C(C(C=O)=CC)O)=O,,,5,1,2,0,2
12331_1,,,,2,2,1,3
12333_0,,,,2,2,1,3
C(C(C(C)=O)C(C(C=O)=C)O)=O,,,5,1,2,0,2
12333_1,,,,2,2,1,3
12335_0,,,,2,2,1,3
C(C(C(C)=O)C(C=CC)O)=O,,,5,1,2,0,2
12335_1,,,,2,2,1,3
12337_0,,,,2,2,1,3
C(C(C(C)=O)C(CC=C)O)=O,,,5,1,2,0,2
12337_1,,,,2,2,1,3
12339_0,,,,2,2,1,3
C(C(C(C)=O)C(C(C=C)O)O)=O,,,5,1,2,0,2
12339_1,,,,2,2,1,3
12341_0,,,,2,2,1,3
C(C(C(C)=O)C(C=C)O)=O,,,5,1,2,0,2
12341_1,,,,2,2,1,3
12343_0,,,,2,2,1,3
C(C(C(C)=O)C1(C=COC1)O)=O,,,5,1,2,0,2
12343_1,,,,2,2,1,3
12344_0,,,,2,2,1,3
12344_1,,,,2,2,1,3
12345_0,,,,2,2,1,3
12345_1,,,,2,2,1,3
12347_0,,,,2,2,1,3
C(C(C(C)=O)C(CO)(CO)O)=O,,,5,1,5,0,5
12347_1,,,,2,2,1,3
12349_0,,,,2,2,1,3
C(C(C)(C(C=O)C(C)=O)O)=O,,,5,1,5,0,5
12349_1,,,,2,2,1,3
12351_0,,,,2,2,1,3
C(C(C(C)=O)C(C(C)=O)O)=O,,,5,1,6,0,6
12351_1,,,,2,2,1,3
12352_0,,,,2,2,1,3
12352_1,,,,2,2,1,3
12354_0,,,,2,2,1,3
C(C(CCO)(C(C=O)C(C)=O)O)=O,,,5,1,2,0,2
12354_1,,,,2,2,1,3
12356_0,,,,2,2,1,3
C(C)(C(C=O)C(C(CCO)=O)O)=O,,,5,1,2,0,2
12356_1,,,,2,2,1,3
12358_0,,,,2,2,1,3
C(CC(C(C(C=O)C(C)=O)O)O)=O,,,5,1,3,0,3
12358_1,,,,2,2,1,3
12360_0,,,,2,2,1,3
C(C(CC(C(C=O)C(C)=O)O)O)=O,,,5,1,2,0,2
12360_1,,,,2,2,1,3
12361_0,,,,2,2,1,3
12361_1,,,,2,2,1,3
12363_0,,,,2,2,1,3
C(CC(CO)(C(C=O)C(C)=O)O)=O,,,5,1,3,0,3
12363_1,,,,2,2,1,3
12364_0,,,,2,2,1,3
12364_1,,,,2,2,1,3
12366_0,,,,2,2,1,3
C(C(C(C)(C(C=O)C(C)=O)O)O)=O,,,5,1,4,0,4
12366_1,,,,2,2,1,3
12368_0,,,,2,2,1,3
C(C(C(C)=O)C(C)O)=O,,,5,1,7,0,7
12368_1,,,,2,2,1,3
12369_0,,,,2,2,1,3
12369_1,,,,2,2,1,3
12371_0,,,,2,2,1,3
C(C(C(C)=O)C(CC(C)O)O)=O,,,5,1,5,0,5
12371_1,,,,2,2,1,3
12373_0,,,,2,2,1,3
C(C(C(C)=O)C(C(C(C)O)O)O)=O,,,5,1,2,0,2
12373_1,,,,2,2,1,3
12375_0,,,,2,2,1,3
C(C(C(C)=O)C(CCO)O)=O,,,5,1,5,0,5
12375_1,,,,2,2,1,3
12377_0,,,,2,2,1,3
C(C(C(C)=O)C(CC(CO)O)O)=O,,,5,1,2,0,2
12377_1,,,,2,2,1,3
12379_0,,,,2,2,1,3
C(C(CO)(C(C=O)C(C)=O)O)=O,,,5,1,6,0,6
12379_1,,,,2,2,1,3
12381_0,,,,2,2,1,3
C(C(C(C)=O)C(C(CO)=O)O)=O,,,5,1,6,0,6
12381_1,,,,2,2,1,3
12383_0,,,,2,2,1,3
C(C(C(C)=O)C(C(C)=O)(CO)O)=O,,,5,1,2,0,2
12383_1,,,,2,2,1,3
12385_0,,,,2,2,1,3
C(C)(C(C=O)C(C(CO)=O)(C)O)=O,,,5,1,2,0,2
12385_1,,,,2,2,1,3
12387_0,,,,2,2,1,3
C(C(C(C)O)(C(C=O)C(C)=O)O)=O,,,5,1,3,0,3
12387_1,,,,2,2,1,3
12389_0,,,,2,2,1,3
C(C)(C(C=O)C(C(C(C)O)=O)O)=O,,,5,1,2,0,2
12389_1,,,,2,2,1,3
12391_0,,,,2,2,1,3
C(C(C(C)=O)C(C)(CO)O)=O,,,5,1,5,0,5
12391_1,,,,2,2,1,3
12393_0,,,,2,2,1,3
C(C(C(C)=O)C(CO)(CCO)O)=O,,,5,1,2,0,2
12393_1,,,,2,2,1,3
12395_0,,,,2,2,1,3
C(C(C(C)=O)C(C(CCO)O)O)=O,,,5,1,2,0,2
12395_1,,,,2,2,1,3
12397_0,,,,2,2,1,3
C(C(C(C)=O)C(C)(C(CO)O)O)=O,,,5,1,2,0,2
12397_1,,,,2,2,1,3
12399_0,,,,2,2,1,3
C(C(C(C)=O)C(C(O)=O)O)=O,,,5,1,8,0,8
12399_1,,,,2,2,1,3
12401_0,,,,2,2,1,3
C(C(C)(C(C=O)C(C)=O)O)(O)=O,,,5,1,6,0,6
12401_1,,,,2,2,1,3
12403_0,,,,2,2,1,3
C(CC(C(C=O)C(C)=O)O)(O)=O,,,5,1,5,0,5
12403_1,,,,2,2,1,3
12405_0,,,,2,2,1,3
C(C(C(C)=O)C1(COCC1O)O)=O,,,5,1,2,0,2
12405_1,,,,2,2,1,3
12407_0,,,,2,2,1,3
C(C(C(C)=O)C1(C(O)OCC1)O)=O,,,5,1,2,0,2
12407_1,,,,2,2,1,3
12409_0,,,,2,2,1,3
C(C(C(C)=O)C1(COC(C1)O)O)=O,,,5,1,2,0,2
12409_1,,,,2,2,1,3
12411_0,,,,2,2,1,3
C(C(C(C)=O)C(C=O)(C=C)O)=O,,,5,1,5,0,5
12411_1,,,,2,2,1,3
12413_0,,,,2,2,1,3
C(C(C(C)=O)C(C(C=C)=O)O)=O,,,5,1,5,0,5
12413_1,,,,2,2,1,3
12415_0,,,,2,2,1,3
C(C(C(C)=O)C(C=CC=O)O)=O,,,5,1,5,0,5
12415_1,,,,2,2,1,3
12416_0,,,,2,2,1,3
12416_1,,,,2,2,1,3
12417_0,,,,2,2,1,3
12417_1,,,,2,2,1,3
12418_0,,,,2,2,1,3
12420_0,,,,2,2,1,3
C(C(CO)(CC(CC=O)=O)O)(O)=O,,,5,1,3,0,3
12422_0,,,,2,2,1,3
C(CC(C(C(O)=O)O)O)(CC=O)=O,,,5,1,2,0,2
12424_0,,,,2,2,1,3
C(OCC(C)(CC(CC=O)=O)O)=O,,,5,1,1,0,1
12426_0,,,,2,2,1,3
C(CC(CC(CO)(C(C)O)O)=O)=O,,,5,1,1,0,1
12428_0,,,,2,2,1,3
C(CC(CC(C=C)(CO)O)=O)=O,,,5,1,1,0,1
12430_0,,,,2,2,1,3
C(CC(CC(C=CCO)O)=O)=O,,,5,1,1,0,1
12432_0,,,,2,2,1,3
C(C(C=C)(CC(CC=O)=O)O)(O)=O,,,5,1,1,0,1
12434_0,,,,2,2,1,3
C(CC(CC(C=CC(O)=O)O)=O)=O,,,5,1,1,0,1
12436_0,,,,2,2,1,3
C(C(CC)(CC(CC=O)=O)O)=O,,,5,1,1,0,1
12438_0,,,,2,2,1,3
C(CC(C(CC)=O)O)(CC=O)=O,,,5,1,1,0,1
12440_0,,,,2,2,1,3
C(CC(CC(CCC=O)O)=O)=O,,,5,1,2,0,2
12442_0,,,,2,2,1,3
C(C)(C(C)(CC(CC=O)=O)O)=O,,,5,1,1,0,1
12444_0,,,,2,2,1,3
C(C(CC)(CC(CC=O)=O)O)(O)=O,,,5,1,1,0,1
12446_0,,,,2,2,1,3
C(CC(CC(C)(CC(O)=O)O)=O)=O,,,5,1,1,0,1
12448_0,,,,2,2,1,3
C1(C(CCO1)(CC(CC=O)=O)O)=O,,,5,1,1,0,1
12450_0,,,,2,2,1,3
C(CC(CC1(COC(C1)=O)O)=O)=O,,,5,1,1,0,1
12452_0,,,,2,2,1,3
C(C(C=CC=O)(CC(CC=O)=O)O)=O,,,5,1,1,0,1
12454_0,,,,2,2,1,3
C(CC(CC(C(C=CC=O)=O)O)=O)=O,,,5,1,1,0,1
12456_0,,,,2,2,1,3
C(CC(CC(C=CC(C=O)=O)O)=O)=O,,,5,1,1,0,1
12458_0,,,,2,2,1,3
C(CC(CC(C(C=O)=CC=O)O)=O)=O,,,5,1,1,0,1
12460_0,,,,2,2,1,3
C(CC(CC(C=C(C=O)C=O)O)=O)=O,,,5,1,1,0,1
12462_0,,,,2,2,1,3
C(CC(CC(C=C(C=O)C)O)=O)=O,,,5,1,1,0,1
12464_0,,,,2,2,1,3
C(CC(CC(C(C)=CC=O)O)=O)=O,,,5,1,1,0,1
12466_0,,,,2,2,1,3
C(CC(CC(CC(C=O)=C)O)=O)=O,,,5,1,1,0,1
12468_0,,,,2,2,1,3
C(CC(C(CC(CC=O)=O)O)=C)=O,,,5,1,1,0,1
12470_0,,,,2,2,1,3
C(CC(CC(C=CC(C)=O)O)=O)=O,,,5,1,1,0,1
12472_0,,,,2,2,1,3
C(CC(CC(C=CC=O)(C)O)=O)=O,,,5,1,1,0,1
12474_0,,,,2,2,1,3
C(CC(CC(C=O)(CC=C)O)=O)=O,,,5,1,1,0,1
12476_0,,,,2,2,1,3
C(CC(CC(C(CC=C)=O)O)=O)=O,,,5,1,1,0,1
12478_0,,,,2,2,1,3
C(C(C=CC)(CC(CC=O)=O)O)=O,,,5,1,1,0,1
12480_0,,,,2,2,1,3
C(CC(CC(C(C=CC)=O)O)=O)=O,,,5,1,1,0,1
12482_0,,,,2,2,1,3
C(CC=CC(CC(CC=O)=O)O)=O,,,5,1,1,0,1
12484_0,,,,2,2,1,3
C(CC(CC(CC=CC=O)O)=O)=O,,,5,1,1,0,1
12486_0,,,,2,2,1,3
C(C(C=C)C(CC(CC=O)=O)O)=O,,,5,1,2,0,2
12488_0,,,,2,2,1,3
C(CC(CC(C(C=O)=CC)O)=O)=O,,,5,1,1,0,1
12490_0,,,,2,2,1,3
C(CC(CC(C(C=O)=C)O)=O)=O,,,5,1,1,0,1
12492_0,,,,2,2,1,3
C(CC(CC(C=CC)O)=O)=O,,,5,1,1,0,1
12494_0,,,,2,2,1,3
C(CC(CC(CC=C)O)=O)=O,,,5,1,1,0,1
12496_0,,,,2,2,1,3
C(CC(C(C=C)O)O)(CC=O)=O,,,5,1,1,0,1
12498_0,,,,2,2,1,3
C(CC(CC(C=C)O)=O)=O,,,5,1,1,0,1
12500_0,,,,2,2,1,3
C(CC(CC1(C=COC1)O)=O)=O,,,5,1,1,0,1
12501_0,,,,2,2,1,3
12502_0,,,,2,2,1,3
12504_0,,,,2,2,1,3
C(CC(CC(CO)(CO)O)=O)=O,,,5,1,5,0,5
12506_0,,,,2,2,1,3
C(C(C)(CC(CC=O)=O)O)=O,,,5,1,4,0,4
12508_0,,,,2,2,1,3
C(CC(CC(C(C)=O)O)=O)=O,,,5,1,5,0,5
12510_0,,,,2,2,1,3
C(CC(CC(CC=O)O)=O)=O,,,5,1,6,0,6
12512_0,,,,2,2,1,3
C(C(CCO)(CC(CC=O)=O)O)=O,,,5,1,1,0,1
12514_0,,,,2,2,1,3
C(CC(C(CCO)=O)O)(CC=O)=O,,,5,1,1,0,1
12516_0,,,,2,2,1,3
C(CC(CC(C(CC=O)O)O)=O)=O,,,5,1,2,0,2
12518_0,,,,2,2,1,3
C(CC(CC(C=O)O)O)(CC=O)=O,,,5,1,1,0,1
12520_0,,,,2,2,1,3
C(CC(CC(CO)=O)O)(CC=O)=O,,,5,1,2,0,2
12522_0,,,,2,2,1,3
C(CC(CC(CO)(CC=O)O)=O)=O,,,5,1,2,0,2
12524_0,,,,2,2,1,3
C(CC(C(C(C)=O)O)O)(CC=O)=O,,,5,1,3,0,3
12526_0,,,,2,2,1,3
C(CC(C)(C(C=O)O)O)(CC=O)=O,,,5,1,3,0,3
12528_0,,,,2,2,1,3
C(CC(CC(C)O)=O)=O,,,5,1,6,0,6
12530_0,,,,2,2,1,3
C(C(CO)C(CC(CC=O)=O)O)=O,,,5,1,3,0,3
12532_0,,,,2,2,1,3
C(CC(CC(CC(C)O)O)=O)=O,,,5,1,2,0,2
12534_0,,,,2,2,1,3
C(CC(CC(C(C(C)O)O)O)=O)=O,,,5,1,1,0,1
12536_0,,,,2,2,1,3
C(CC(CC(CCO)O)=O)=O,,,5,1,2,0,2
12538_0,,,,2,2,1,3
C(CC(CC(CC(CO)O)O)=O)=O,,,5,1,1,0,1
12539_0,,,,2,2,1,3
12540_0,,,,2,2,1,3
12542_0,,,,2,2,1,3
C(C)(C(CO)(CC(CC=O)=O)O)=O,,,5,1,1,0,1
12544_0,,,,2,2,1,3
C(CO)(C(C)(CC(CC=O)=O)O)=O,,,5,1,1,0,1
12546_0,,,,2,2,1,3
C(C(C(C)O)(CC(CC=O)=O)O)=O,,,5,1,2,0,2
12548_0,,,,2,2,1,3
C(CC(C(C(C)O)=O)O)(CC=O)=O,,,5,1,1,0,1
12550_0,,,,2,2,1,3
C(CC(CC(C)(CO)O)=O)=O,,,5,1,2,0,2
12552_0,,,,2,2,1,3
C(CC(CC(CO)(CCO)O)=O)=O,,,5,1,1,0,1
12554_0,,,,2,2,1,3
C(CC(CC(C(CCO)O)O)=O)=O,,,5,1,1,0,1
12556_0,,,,2,2,1,3
C(CC(CC(C)(C(CO)O)O)=O)=O,,,5,1,1,0,1
12557_0,,,,2,2,1,3
12559_0,,,,2,2,1,3
C(C(C)(CC(CC=O)=O)O)(O)=O,,,5,1,4,0,4
12561_0,,,,2,2,1,3
C(CC(CC(CC(O)=O)O)=O)=O,,,5,1,2,0,2
12563_0,,,,2,2,1,3
C(CC(CC1(COCC1O)O)=O)=O,,,5,1,1,0,1
12565_0,,,,2,2,1,3
C(CC(CC1(C(O)OCC1)O)=O)=O,,,5,1,1,0,1
12567_0,,,,2,2,1,3
C(CC(CC1(COC(C1)O)O)=O)=O,,,5,1,1,0,1
12569_0,,,,2,2,1,3
C(C(C=C)(CC(CC=O)=O)O)=O,,,5,1,2,0,2
12571_0,,,,2,2,1,3
C(CC(CC(C(C=C)=O)O)=O)=O,,,5,1,2,0,2
12573_0,,,,2,2,1,3
C(CC(CC(C=CC=O)O)=O)=O,,,5,1,2,0,2
12574_0,,,,2,2,1,3
12575_0,,,,2,2,1,3
12577_0,,,,2,2,1,3
C(C(C(C(O)=O)=O)O)(O)=O,,,5,1,3,0,3
12577_1,,,,2,2,1,3
12579_0,,,,2,2,1,3
C(C(C(C(C(O)=O)O)=O)(CO)O)=O,,,5,1,2,0,2
12579_1,,,,2,2,1,3
12581_0,,,,2,2,1,3
C(C(C=O)(C(CC(O)=O)=O)O)=O,,,5,1,1,0,1
12583_0,,,,2,2,1,3
C(C(C=O)C(C=O)(C=O)O)(O)=O,,,5,1,2,0,2
12583_1,,,,2,2,1,3
12585_0,,,,2,2,1,3
C(C(C(C(C(O)=O)O)=O)O)(O)=O,,,5,1,2,0,2
12585_1,,,,2,2,1,3
12587_0,,,,2,2,1,3
C(OCC(CC(O)=O)=O)=O,,,5,1,1,0,1
12589_0,,,,2,2,1,3
C(C(C(C)=O)OC=O)(O)=O,,,5,1,2,0,2
12589_1,,,,2,2,1,3
12591_0,,,,2,2,1,3
C(C(C(C(C(O)=O)O)=O)(C)O)=O,,,5,1,2,0,2
12591_1,,,,2,2,1,3
12593_0,,,,2,2,1,3
C(C(C(C(C)O)=O)C(C=O)=O)(O)=O,,,5,1,2,0,2
12593_1,,,,2,2,1,3
12595_0,,,,2,2,1,3
C(C(C=O)C(C(C)O)=O)(O)=O,,,5,1,5,0,5
12595_1,,,,2,2,1,3
12597_0,,,,2,2,1,3
C(C(C=O)C(C(CCO)O)=O)(O)=O,,,5,1,4,0,4
12597_1,,,,2,2,1,3
12598_0,,,,2,2,1,3
12598_1,,,,2,2,1,3
12600_0,,,,2,2,1,3
C(C(C(O)=O)O)(CC(CO)=O)=O,,,5,1,4,0,4
12600_1,,,,2,2,1,3
12602_0,,,,2,2,1,3
C(C(C(CO)=O)C(CO)=O)(O)=O,,,5,1,5,0,5
12602_1,,,,2,2,1,3
12604_0,,,,2,2,1,3
C(C(C(C(CC(O)=O)O)=O)O)(O)=O,,,5,1,3,0,3
12604_1,,,,2,2,1,3
12606_0,,,,2,2,1,3
C(CC(C(CCO)O)=O)(O)=O,,,5,1,5,0,5
12608_0,,,,2,2,1,3
C(C(C(C(CCO)O)=O)CO)(O)=O,,,5,1,2,0,2
12608_1,,,,2,2,1,3
12609_0,,,,2,2,1,3
12610_0,,,,2,2,1,3
12612_0,,,,2,2,1,3
C(C(C=O)C(CO)(C(C)O)O)(O)=O,,,5,1,5,0,5
12612_1,,,,2,2,1,3
12613_0,,,,2,2,1,3
12613_1,,,,2,2,1,3
12615_0,,,,2,2,1,3
C(CC(C(CC(O)=O)O)=O)(O)=O,,,5,1,3,0,3
12617_0,,,,2,2,1,3
C(C(C(CC(O)=O)=O)(CO)O)(O)=O,,,5,1,3,0,3
12619_0,,,,2,2,1,3
C(C(C=O)C(C(O)=O)(CO)O)(O)=O,,,5,1,6,0,6
12619_1,,,,2,2,1,3
12621_0,,,,2,2,1,3
C(C1C(C(CO1)(C(C)O)O)=O)(O)=O,,,5,1,2,0,2
12621_1,,,,2,2,1,3
12623_0,,,,2,2,1,3
C(C1C(C(CO)(CO1)O)=O)(O)=O,,,5,1,2,0,2
12623_1,,,,2,2,1,3
12625_0,,,,2,2,1,3
C(C1C(C(C(C)O)(O)OC1)=O)(O)=O,,,5,1,2,0,2
12625_1,,,,2,2,1,3
12627_0,,,,2,2,1,3
C(C1C(C(CO)(O)OC1)=O)(O)=O,,,5,1,2,0,2
12627_1,,,,2,2,1,3
12629_0,,,,2,2,1,3
C(C(C=O)OC(CO)=O)(O)=O,,,5,1,2,0,2
12629_1,,,,2,2,1,3
12631_0,,,,2,2,1,3
C(C(C(C(CC=O)=O)=O)O)(O)=O,,,5,1,3,0,3
12631_1,,,,2,2,1,3
12633_0,,,,2,2,1,3
C(C(C=O)C(C(CO)=O)=O)(O)=O,,,5,1,2,0,2
12633_1,,,,2,2,1,3
12635_0,,,,2,2,1,3
C(C(C(O)=O)C(C(CC=O)=O)=O)=O,,,5,1,2,0,2
12635_1,,,,2,2,1,3
12637_0,,,,2,2,1,3
C(C(C(O)=O)C(CC(C=O)=O)=O)=O,,,5,1,2,0,2
12637_1,,,,2,2,1,3
12639_0,,,,2,2,1,3
C(C(C(CC=O)=O)C(C=O)=O)(O)=O,,,5,1,2,0,2
12639_1,,,,2,2,1,3
12641_0,,,,2,2,1,3
C(C(C(C=O)=O)C(C=O)CO)(O)=O,,,5,1,1,0,1
12643_0,,,,2,2,1,3
C(C(C=O)C(C=O)CO)(O)=O,,,5,1,4,0,4
12645_0,,,,2,2,1,3
C(C(C(C(C(C(O)=O)O)=O)=O)C)=O,,,5,1,2,0,2
12645_1,,,,2,2,1,3
12647_0,,,,2,2,1,3
C(CC(C(CC(CO)=O)=O)=O)(O)=O,,,5,1,1,0,1
12649_0,,,,2,2,1,3
C(C(C(CO)=O)C(C(C)=O)=O)(O)=O,,,5,1,2,0,2
12649_1,,,,2,2,1,3
12651_0,,,,2,2,1,3
C(C(C(O)=O)O)(CC(C(C)=O)=O)=O,,,5,1,2,0,2
12651_1,,,,2,2,1,3
12653_0,,,,2,2,1,3
C(C(C(C)=O)C(C(CO)=O)=O)(O)=O,,,5,1,2,0,2
12653_1,,,,2,2,1,3
12655_0,,,,2,2,1,3
C(CC(O)=O)(CC(C(CO)=O)=O)=O,,,5,1,1,0,1
12657_0,,,,2,2,1,3
C(C(C(C(CC(C)=O)=O)=O)O)(O)=O,,,5,1,2,0,2
12657_1,,,,2,2,1,3
12659_0,,,,2,2,1,3
C(C(C=O)C(CC(CO)=O)=O)(O)=O,,,5,1,2,0,2
12659_1,,,,2,2,1,3
12661_0,,,,2,2,1,3
C(C(C(CC=O)=O)C(CO)=O)(O)=O,,,5,1,2,0,2
12661_1,,,,2,2,1,3
12663_0,,,,2,2,1,3
C(C(C(CC(CC=O)=O)=O)O)(O)=O,,,5,1,2,0,2
12663_1,,,,2,2,1,3
12665_0,,,,2,2,1,3
C(C(C=O)CC(C(CO)=O)=O)(O)=O,,,5,1,1,0,1
12667_0,,,,2,2,1,3
C(C(C(C(CCC=O)=O)=O)O)(O)=O,,,5,1,2,0,2
12667_1,,,,2,2,1,3
12669_0,,,,2,2,1,3
C(C(C(C(CO)=O)=O)CC=O)(O)=O,,,5,1,1,0,1
12670_0,,,,2,2,1,3
12672_0,,,,2,2,1,3
C(C(C(C)=O)C(CO)=O)(O)=O,,,5,1,5,0,5
12672_1,,,,2,2,1,3
12673_0,,,,2,2,1,3
12673_1,,,,2,2,1,3
12675_0,,,,2,2,1,3
C(C(C(C(CC)=O)=O)O)(O)=O,,,5,1,2,0,2
12675_1,,,,2,2,1,3
12677_0,,,,2,2,1,3
C(C(C(C(CO)=O)=O)C)(O)=O,,,5,1,3,0,3
12679_0,,,,2,2,1,3
C(C(C=O)C(C=O)C(CO)O)(O)=O,,,5,1,3,0,3
12681_0,,,,2,2,1,3
C(C(C=O)C(C(CO)=O)CO)(O)=O,,,5,1,2,0,2
12683_0,,,,2,2,1,3
C(C(CO)CC=O)(C(C(O)=O)O)=O,,,5,1,3,0,3
12683_1,,,,2,2,1,3
12685_0,,,,2,2,1,3
C(CC(CC(C(CO)O)=O)=O)(O)=O,,,5,1,4,0,4
12687_0,,,,2,2,1,3
C(C(CO)O)(C(C(O)=O)C(C)=O)=O,,,5,1,3,0,3
12687_1,,,,2,2,1,3
12689_0,,,,2,2,1,3
C(C(C(C(C(CO)O)=O)=O)C)(O)=O,,,5,1,2,0,2
12691_0,,,,2,2,1,3
C(C(C=O)C(C(CO)CO)=O)(O)=O,,,5,1,3,0,3
12691_1,,,,2,2,1,3
12693_0,,,,2,2,1,3
C(C(C(O)=O)C(C(C)=O)=O)=O,,,5,1,3,0,3
12693_1,,,,2,2,1,3
12695_0,,,,2,2,1,3
C(CC(C(CC(O)=O)=O)=O)=O,,,5,1,4,0,4
12697_0,,,,2,2,1,3
C(C(C(CO)=O)CC(C=O)=O)(O)=O,,,5,1,1,0,1
12699_0,,,,2,2,1,3
C(C(C(CCC(C=O)=O)=O)O)(O)=O,,,5,1,2,0,2
12699_1,,,,2,2,1,3
12701_0,,,,2,2,1,3
C(C(C(C=O)=O)CC(CO)=O)(O)=O,,,5,1,1,0,1
12703_0,,,,2,2,1,3
C(C(C(CC(C=O)=O)=O)CO)(O)=O,,,5,1,2,0,2
12703_1,,,,2,2,1,3
12705_0,,,,2,2,1,3
C(C(C(CCO)=O)C(C=O)=O)(O)=O,,,5,1,2,0,2
12705_1,,,,2,2,1,3
12707_0,,,,2,2,1,3
C(C(C(O)=O)CC(C=O)=O)=O,,,5,1,1,0,1
12709_0,,,,2,2,1,3
C(C(C(C=O)=O)CC=O)(O)=O,,,5,1,4,0,4
12711_0,,,,2,2,1,3
C(C(C(O)=O)C(CC=O)=O)=O,,,5,1,2,0,2
12711_1,,,,2,2,1,3
12713_0,,,,2,2,1,3
C(C(C(CO)=O)C(C=O)C=O)(O)=O,,,5,1,1,0,1
12715_0,,,,2,2,1,3
C(C(C=O)CC(C(C(O)=O)O)=O)=O,,,5,1,2,0,2
12715_1,,,,2,2,1,3
12717_0,,,,2,2,1,3
C(C(C=O)C(C(C(O)=O)CO)=O)=O,,,5,1,2,0,2
12717_1,,,,2,2,1,3
12719_0,,,,2,2,1,3
C(C(C=O)C(C=O)C(O)=O)=O,,,5,1,2,0,2
12721_0,,,,2,2,1,3
C(C(C=O)C(C(CCO)=O)=O)(O)=O,,,5,1,2,0,2
12721_1,,,,2,2,1,3
12723_0,,,,2,2,1,3
C(C(C(C(CC=O)=O)=O)CO)(O)=O,,,5,1,2,0,2
12723_1,,,,2,2,1,3
12725_0,,,,2,2,1,3
C(C(C=O)C(C(C=O)=O)CO)(O)=O,,,5,1,1,0,1
12727_0,,,,2,2,1,3
C(CC(O)=O)(C(C(C=O)=O)CO)=O,,,5,1,1,0,1
12729_0,,,,2,2,1,3
C(C(C(O)=O)CC(CC=O)=O)=O,,,5,1,3,0,3
12731_0,,,,2,2,1,3
C(CC=O)(C(C(O)=O)CC=O)=O,,,5,1,3,0,3
12733_0,,,,2,2,1,3
C(C(C(O)=O)C(CCC=O)=O)=O,,,5,1,4,0,4
12733_1,,,,2,2,1,3
12735_0,,,,2,2,1,3
C(C(C(CC=O)=O)C(C=O)O)(O)=O,,,5,1,4,0,4
12735_1,,,,2,2,1,3
12737_0,,,,2,2,1,3
C(C(C=O)C(CC(C=O)O)=O)(O)=O,,,5,1,2,0,2
12737_1,,,,2,2,1,3
12739_0,,,,2,2,1,3
C(C(C=O)C(C(CC=O)O)=O)(O)=O,,,5,1,2,0,2
12739_1,,,,2,2,1,3
12740_0,,,,2,2,1,3
12740_1,,,,2,2,1,3
12742_0,,,,2,2,1,3
C(C(C(C(C=O)O)=O)CC=O)(O)=O,,,5,1,1,0,1
12744_0,,,,2,2,1,3
C(C(C=O)CC(C(C=O)O)=O)(O)=O,,,5,1,1,0,1
12746_0,,,,2,2,1,3
C(C(C(C=O)=O)CC(C=O)O)(O)=O,,,5,1,1,0,1
12748_0,,,,2,2,1,3
C(C(C=O)C(C=O)C(C=O)O)(O)=O,,,5,1,1,0,1
12750_0,,,,2,2,1,3
C(C(C(CC(O)=O)=O)C(C=O)O)=O,,,5,1,3,0,3
12751_0,,,,2,2,1,3
12753_0,,,,2,2,1,3
C(C(C=O)C(C=O)C(CO)=O)(O)=O,,,5,1,1,0,1
12755_0,,,,2,2,1,3
C(C(C(C(C(O)=O)O)=O)CC=O)=O,,,5,1,2,0,2
12755_1,,,,2,2,1,3
12757_0,,,,2,2,1,3
C(C(C(CC(O)=O)=O)C(CO)=O)=O,,,5,1,1,0,1
12759_0,,,,2,2,1,3
C(C(C(C(C(O)=O)O)=O)C(C)=O)=O,,,5,1,2,0,2
12759_1,,,,2,2,1,3
12761_0,,,,2,2,1,3
C(CC(CC(CC(O)=O)=O)=O)=O,,,5,1,4,0,4
12763_0,,,,2,2,1,3
C(CC(C(C(O)=O)C(C)=O)=O)=O,,,5,1,4,0,4
12763_1,,,,2,2,1,3
12765_0,,,,2,2,1,3
C(C(C(CC(C)=O)=O)C(O)=O)=O,,,5,1,4,0,4
12765_1,,,,2,2,1,3
12767_0,,,,2,2,1,3
C(C(C(O)=O)C(C(CC)=O)=O)=O,,,5,1,2,0,2
12767_1,,,,2,2,1,3
12769_0,,,,2,2,1,3
C(CC(C(C(C(O)=O)C)=O)=O)=O,,,5,1,3,0,3
12771_0,,,,2,2,1,3
C(CC(C(C(CC=O)=O)O)=O)(O)=O,,,5,1,1,0,1
12773_0,,,,2,2,1,3
C(C(C=O)C(C(C(C)=O)O)=O)(O)=O,,,5,1,2,0,2
12773_1,,,,2,2,1,3
12775_0,,,,2,2,1,3
C(C(C(O)=O)CC(C(C)=O)=O)=O,,,5,1,3,0,3
12777_0,,,,2,2,1,3
C(C(C(C(C)=O)=O)CC=O)(O)=O,,,5,1,3,0,3
12779_0,,,,2,2,1,3
C(CC(C(CCC=O)=O)=O)(O)=O,,,5,1,3,0,3
12781_0,,,,2,2,1,3
C(C(C(C(C)=O)=O)C(C=O)O)(O)=O,,,5,1,4,0,4
12781_1,,,,2,2,1,3
12783_0,,,,2,2,1,3
C(CC(C(CC(C=O)O)=O)=O)(O)=O,,,5,1,2,0,2
12785_0,,,,2,2,1,3
C(C(C(C(C=O)O)=O)C(C)=O)(O)=O,,,5,1,2,0,2
12785_1,,,,2,2,1,3
12787_0,,,,2,2,1,3
C(CC(CC(C(C=O)O)=O)=O)(O)=O,,,5,1,1,0,1
12789_0,,,,2,2,1,3
C(C(C(O)=O)C(C(C=O)=O)C)=O,,,5,1,3,0,3
12791_0,,,,2,2,1,3
C(C(C(C=O)=O)C)(O)=O,,,5,1,3,0,3
12793_0,,,,2,2,1,3
C(C(C(CO)=O)CC=O)(O)=O,,,5,1,4,0,4
12794_0,,,,2,2,1,3
12794_1,,,,2,2,1,3
12796_0,,,,2,2,1,3
C(C(C=O)CC(CO)=O)(O)=O,,,5,1,4,0,4
12797_0,,,,2,2,1,3
12797_1,,,,2,2,1,3
12799_0,,,,2,2,1,3
C(C(C=O)C(CCO)=O)(O)=O,,,5,1,5,0,5
12799_1,,,,2,2,1,3
12801_0,,,,2,2,1,3
C(C(CO)O)(C(C(O)=O)CC=O)=O,,,5,1,2,0,2
12803_0,,,,2,2,1,3
C(C(C=O)CC(C(CO)O)=O)(O)=O,,,5,1,2,0,2
12805_0,,,,2,2,1,3
C(C(C(CC=O)=O)C(CO)O)(O)=O,,,5,1,5,0,5
12805_1,,,,2,2,1,3
12807_0,,,,2,2,1,3
C(C(C=O)C(CC(CO)O)=O)(O)=O,,,5,1,3,0,3
12807_1,,,,2,2,1,3
12809_0,,,,2,2,1,3
C(C(C(O)=O)CC=O)=O,,,5,1,4,0,4
12810_0,,,,2,2,1,3
12812_0,,,,2,2,1,3
C(C(C(CC(O)=O)=O)C(C=O)=O)=O,,,5,1,1,0,1
12814_0,,,,2,2,1,3
C(CC(O)=O)(C(C(CO)=O)CO)=O,,,5,1,4,0,4
12816_0,,,,2,2,1,3
C(C(C(O)=O)O)(C(C(C)=O)CO)=O,,,5,1,4,0,4
12816_1,,,,2,2,1,3
12818_0,,,,2,2,1,3
C(C(C(CC(O)=O)=O)CO)(O)=O,,,5,1,3,0,3
12820_0,,,,2,2,1,3
C(C(C(C(CC(O)=O)=O)=O)CO)=O,,,5,1,1,0,1
12822_0,,,,2,2,1,3
C(C(C=O)C(C(C=O)CO)=O)(O)=O,,,5,1,2,0,2
12822_1,,,,2,2,1,3
12824_0,,,,2,2,1,3
C(C(C(CC(O)=O)=O)C(C)=O)=O,,,5,1,3,0,3
12825_0,,,,2,2,1,3
12825_1,,,,2,2,1,3
12827_0,,,,2,2,1,3
C(C(C(CC(O)=O)=O)(CC=O)O)=O,,,5,1,1,0,1
12829_0,,,,2,2,1,3
C(C(C(CC(O)=O)=O)(C(C)=O)O)=O,,,5,1,1,0,1
12831_0,,,,2,2,1,3
C(C(C(CC(O)=O)=O)CO)=O,,,5,1,7,0,7
12833_0,,,,2,2,1,3
C(C(C(CC(O)=O)=O)C(CO)O)=O,,,5,1,4,0,4
12835_0,,,,2,2,1,3
C(C(C(O)=O)C(C=O)C(C=O)=O)=O,,,5,1,1,0,1
12837_0,,,,2,2,1,3
C(C(C(O)=O)C(C(O)=O)=O)=O,,,5,1,2,0,2
12837_1,,,,2,2,1,3
12839_0,,,,2,2,1,3
C(C(C(O)=O)C(C=O)=O)(O)=O,,,5,1,2,0,2
12839_1,,,,2,2,1,3
12841_0,,,,2,2,1,3
C(C(C(C)=O)C(C(O)=O)=O)(O)=O,,,5,1,3,0,3
12841_1,,,,2,2,1,3
12843_0,,,,2,2,1,3
C(CC(CC(C(O)=O)=O)=O)(O)=O,,,5,1,2,0,2
12845_0,,,,2,2,1,3
C(CC(C(CC(O)=O)=O)=O)(O)=O,,,5,1,2,0,2
12847_0,,,,2,2,1,3
C(C(C(O)=O)C(C(C)=O)=O)(O)=O,,,5,1,2,0,2
12847_1,,,,2,2,1,3
12849_0,,,,2,2,1,3
C(C(C(C(O)=O)=O)CC=O)(O)=O,,,5,1,2,0,2
12851_0,,,,2,2,1,3
C(C(C(O)=O)CC(C(O)=O)=O)=O,,,5,1,1,0,1
12853_0,,,,2,2,1,3
C(C(C(O)=O)C(CC=O)=O)(O)=O,,,5,1,2,0,2
12853_1,,,,2,2,1,3
12855_0,,,,2,2,1,3
C(C(C(O)=O)C(CC(O)=O)=O)=O,,,5,1,2,0,2
12855_1,,,,2,2,1,3
12857_0,,,,2,2,1,3
C(C(C(CC(O)=O)=O)CC=O)=O,,,5,1,4,0,4
12859_0,,,,2,2,1,3
C(C(C(O)=O)C(C=O)C(C)=O)=O,,,5,1,3,0,3
12860_0,,,,2,2,1,3
12860_1,,,,2,2,1,3
12862_0,,,,2,2,1,3
C(C(C(C(O)=O)=O)C)(O)=O,,,5,1,3,0,3
12864_0,,,,2,2,1,3
C(C(C(O)=O)C(C)=O)(O)=O,,,5,1,2,0,2
12864_1,,,,2,2,1,3
12866_0,,,,2,2,1,3
C(CC(CC(O)=O)=O)(O)=O,,,5,1,3,0,3
12868_0,,,,2,2,1,3
C(C1C(C(C(CO)O1)O)=O)(O)=O,,,5,1,2,0,2
12868_1,,,,2,2,1,3
12870_0,,,,2,2,1,3
C(C1C(C(O)OC1CO)=O)(O)=O,,,5,1,4,0,4
12870_1,,,,2,2,1,3
12872_0,,,,2,2,1,3
C(C1C(C(C(CO1)O)O)=O)(O)=O,,,5,1,2,0,2
12872_1,,,,2,2,1,3
12874_0,,,,2,2,1,3
C(C1C(C(O)OCC1O)=O)(O)=O,,,5,1,4,0,4
12874_1,,,,2,2,1,3
12876_0,,,,2,2,1,3
C(C1C(COC(C1O)O)=O)(O)=O,,,5,1,5,0,5
12876_1,,,,2,2,1,3
12878_0,,,,2,2,1,3
C(C1C(CC(C(O1)O)O)=O)(O)=O,,,5,1,4,0,4
12878_1,,,,2,2,1,3
12880_0,,,,2,2,1,3
C(C1C(C(COC1O)O)=O)(O)=O,,,5,1,2,0,2
12880_1,,,,2,2,1,3
12882_0,,,,2,2,1,3
C(C1C(C(C(O)OC1)O)=O)(O)=O,,,5,1,2,0,2
12882_1,,,,2,2,1,3
12884_0,,,,2,2,1,3
C(C1C(C(OC1)=O)=O)(O)=O,,,5,1,2,0,2
12884_1,,,,2,2,1,3
12886_0,,,,2,2,1,3
C1(C(C(O)=O)C(CO1)=O)=O,,,5,1,2,0,2
12886_1,,,,2,2,1,3
12888_0,,,,2,2,1,3
C1(CC(C(C(O)=O)O1)=O)=O,,,5,1,2,0,2
12888_1,,,,2,2,1,3
12890_0,,,,2,2,1,3
C(C1C(C(OC1CO)=O)=O)(O)=O,,,5,1,2,0,2
12890_1,,,,2,2,1,3
12892_0,,,,2,2,1,3
C(C1C(OC(C1=O)CO)=O)(O)=O,,,5,1,2,0,2
12892_1,,,,2,2,1,3
12894_0,,,,2,2,1,3
C(C1C(C(OCC1O)=O)=O)(O)=O,,,5,1,2,0,2
12894_1,,,,2,2,1,3
12896_0,,,,2,2,1,3
C(C1C(COC(C1O)=O)=O)(O)=O,,,5,1,3,0,3
12896_1,,,,2,2,1,3
12898_0,,,,2,2,1,3
C(C1C(CC(C(O1)=O)O)=O)(O)=O,,,5,1,3,0,3
12898_1,,,,2,2,1,3
12900_0,,,,2,2,1,3
C1(C(C(O)=O)C(C(CO1)O)=O)=O,,,5,1,2,0,2
12900_1,,,,2,2,1,3
12902_0,,,,2,2,1,3
C(C1C(C(C(OC1)=O)O)=O)(O)=O,,,5,1,2,0,2
12902_1,,,,2,2,1,3
12904_0,,,,2,2,1,3
C(C(C(C(C=O)=CC=O)=O)O)(O)=O,,,5,1,2,0,2
12904_1,,,,2,2,1,3
12906_0,,,,2,2,1,3
C(C(C(C(C(C=O)=C)O)=O)O)(O)=O,,,5,1,2,0,2
12906_1,,,,2,2,1,3
12908_0,,,,2,2,1,3
C(C(C(C(C=CC=O)O)=O)O)(O)=O,,,5,1,2,0,2
12908_1,,,,2,2,1,3
12910_0,,,,2,2,1,3
C(C(C(C(C=C)O)=O)O)(O)=O,,,5,1,4,0,4
12910_1,,,,2,2,1,3
12912_0,,,,2,2,1,3
C(C(C(C=O)=O)C(C=O)=C)(O)=O,,,5,1,1,0,1
12914_0,,,,2,2,1,3
C(C(C(O)=O)C(C=O)=C)=O,,,5,1,4,0,4
12916_0,,,,2,2,1,3
C(CC(C=CC(C=O)=O)=O)(O)=O,,,5,1,1,0,1
12918_0,,,,2,2,1,3
C(CC(C=C(C=O)C=O)=O)(O)=O,,,5,1,1,0,1
12920_0,,,,2,2,1,3
C(CC(C=CC=O)=O)(O)=O,,,5,1,4,0,4
12922_0,,,,2,2,1,3
C(C(C=CC=O)C(C=O)=O)(O)=O,,,5,1,1,0,1
12924_0,,,,2,2,1,3
C(C(C(O)=O)C=CC(C=O)=O)=O,,,5,1,1,0,1
12926_0,,,,2,2,1,3
C(C(C=C)C(C=O)=O)(O)=O,,,5,1,1,0,1
12928_0,,,,2,2,1,3
C(C(C(O)=O)C=C(C=O)C=O)=O,,,5,1,1,0,1
12930_0,,,,2,2,1,3
C(C(C(O)=O)C=CC=O)=O,,,5,1,4,0,4
12932_0,,,,2,2,1,3
C(C(C=O)C(C=O)=CCO)(O)=O,,,5,1,3,0,3
12934_0,,,,2,2,1,3
C(C(C(C=CC=O)=O)CO)(O)=O,,,5,1,3,0,3
12934_1,,,,2,2,1,3
12936_0,,,,2,2,1,3
C(C(C=O)C=CC(C=O)O)(O)=O,,,5,1,3,0,3
12938_0,,,,2,2,1,3
C(C(C(CO)=O)C=CC=O)(O)=O,,,5,1,3,0,3
12940_0,,,,2,2,1,3
C(C(C(CC=CC=O)=O)O)(O)=O,,,5,1,4,0,4
12940_1,,,,2,2,1,3
12942_0,,,,2,2,1,3
C(C(C=O)C=CC(CO)=O)(O)=O,,,5,1,3,0,3
12944_0,,,,2,2,1,3
C(C(C(C=CCC=O)=O)O)(O)=O,,,5,1,4,0,4
12944_1,,,,2,2,1,3
12946_0,,,,2,2,1,3
C(C(C(C=CC(C=O)O)=O)O)(O)=O,,,5,1,2,0,2
12946_1,,,,2,2,1,3
12948_0,,,,2,2,1,3
C(C(C=O)C(CO)=CC=O)(O)=O,,,5,1,3,0,3
12950_0,,,,2,2,1,3
C(C(C(C(C(O)=O)O)=O)C=C)=O,,,5,1,2,0,2
12950_1,,,,2,2,1,3
12952_0,,,,2,2,1,3
C(C(C(C(C=O)=CC)=O)O)(O)=O,,,5,1,2,0,2
12952_1,,,,2,2,1,3
12954_0,,,,2,2,1,3
C(C(C(C(C=O)=C)=O)O)(O)=O,,,5,1,2,0,2
12954_1,,,,2,2,1,3
12956_0,,,,2,2,1,3
C(C(C(C(C=O)=CCO)=O)O)(O)=O,,,5,1,2,0,2
12956_1,,,,2,2,1,3
12958_0,,,,2,2,1,3
C(C(C=O)C(C(C=C)O)=O)(O)=O,,,5,1,3,0,3
12958_1,,,,2,2,1,3
12960_0,,,,2,2,1,3
C(CC(C(C=CC=O)O)=O)(O)=O,,,5,1,3,0,3
12962_0,,,,2,2,1,3
C(C(C=O)C(C(C=O)O)=C)(O)=O,,,5,1,3,0,3
12964_0,,,,2,2,1,3
C(C(C(C(C=O)O)=O)C=C)(O)=O,,,5,1,1,0,1
12966_0,,,,2,2,1,3
C(C(C(O)=O)C=C)=O,,,5,1,4,0,4
12968_0,,,,2,2,1,3
C(C(C(O)=O)O)(C(C=C)(CO)O)=O,,,5,1,2,0,2
12968_1,,,,2,2,1,3
12970_0,,,,2,2,1,3
C(C(C(CC(O)=O)=O)(C=C)O)=O,,,5,1,1,0,1
12972_0,,,,2,2,1,3
C(C(C(C=CC=O)=O)O)(O)=O,,,5,1,4,0,4
12972_1,,,,2,2,1,3
12974_0,,,,2,2,1,3
C(C(C(C=C(C=O)CO)=O)O)(O)=O,,,5,1,2,0,2
12974_1,,,,2,2,1,3
12976_0,,,,2,2,1,3
C(C(C(C=CC(O)=O)=O)O)(O)=O,,,5,1,3,0,3
12976_1,,,,2,2,1,3
12978_0,,,,2,2,1,3
C(C1C(C=CO1)=O)(O)=O,,,5,1,2,0,2
12978_1,,,,2,2,1,3
12980_0,,,,2,2,1,3
C(C1C(C(O)OC1C=O)=O)(O)=O,,,5,1,2,0,2
12980_1,,,,2,2,1,3
12982_0,,,,2,2,1,3
C(C1(C)C(C(O)=O)C(C(O1)O)=O)=O,,,5,1,2,0,2
12982_1,,,,2,2,1,3
12984_0,,,,2,2,1,3
C(C1C(C(O)OC1C(C)=O)=O)(O)=O,,,5,1,2,0,2
12984_1,,,,2,2,1,3
12986_0,,,,2,2,1,3
C(CC(C1CC(C(O)O1)=O)=O)(O)=O,,,5,1,1,0,1
12988_0,,,,2,2,1,3
C(C(C=O)C1CC(C(O)O1)=O)(O)=O,,,5,1,2,0,2
12988_1,,,,2,2,1,3
12990_0,,,,2,2,1,3
C(CC1C(C(O)=O)C(C(O)O1)=O)=O,,,5,1,2,0,2
12990_1,,,,2,2,1,3
12992_0,,,,2,2,1,3
C(C1C(C(O)OC1C)=O)(O)=O,,,5,1,2,0,2
12992_1,,,,2,2,1,3
12994_0,,,,2,2,1,3
C(C(C=O)C1C(CC(O)O1)O)(O)=O,,,5,1,4,0,4
12994_1,,,,2,2,1,3
12996_0,,,,2,2,1,3
C(C(C=O)C1CC(C(O)O1)O)(O)=O,,,5,1,4,0,4
12996_1,,,,2,2,1,3
12998_0,,,,2,2,1,3
C(CC(C1C(CC(O1)O)O)=O)(O)=O,,,5,1,3,0,3
13000_0,,,,2,2,1,3
C(C1C(C(C(C(O1)O)O)O)=O)(O)=O,,,5,1,2,0,2
13000_1,,,,2,2,1,3
13002_0,,,,2,2,1,3
C(C1C(C(C(C)OC1O)O)=O)(O)=O,,,5,1,2,0,2
13002_1,,,,2,2,1,3
13004_0,,,,2,2,1,3
C(C1C(C(C(O)OC1C)O)=O)(O)=O,,,5,1,2,0,2
13004_1,,,,2,2,1,3
13006_0,,,,2,2,1,3
C(C1C(C(CC(O)OC1)O)=O)(O)=O,,,5,1,2,0,2
13006_1,,,,2,2,1,3
13008_0,,,,2,2,1,3
C(C1C(COC(CC1O)O)=O)(O)=O,,,5,1,4,0,4
13008_1,,,,2,2,1,3
13010_0,,,,2,2,1,3
C(C1C(CC(CC(O1)O)O)=O)(O)=O,,,5,1,4,0,4
13010_1,,,,2,2,1,3
13012_0,,,,2,2,1,3
C(C(C(C=O)=O)CC(C)O)(O)=O,,,5,1,1,0,1
13014_0,,,,2,2,1,3
C(C(C=O)C(C=O)C(C)O)(O)=O,,,5,1,1,0,1
13016_0,,,,2,2,1,3
C(C(C(C=O)=O)CCCO)(O)=O,,,5,1,1,0,1
13018_0,,,,2,2,1,3
C(C(C=O)C(C=O)CCO)(O)=O,,,5,1,3,0,3
13020_0,,,,2,2,1,3
C(C(C(C=O)=O)CCC(O)=O)(O)=O,,,5,1,2,0,2
13022_0,,,,2,2,1,3
C(C(C(O)=O)C(C=O)CC(O)=O)=O,,,5,1,3,0,3
13024_0,,,,2,2,1,3
C(C(C(C=O)=O)CCO)(O)=O,,,5,1,3,0,3
13026_0,,,,2,2,1,3
C(C(C(C=O)=O)CC(CO)O)(O)=O,,,5,1,1,0,1
13027_0,,,,2,2,1,3
13029_0,,,,2,2,1,3
C(CCC(C(O)=O)C(C=O)=O)=O,,,5,1,2,0,2
13030_0,,,,2,2,1,3
13030_1,,,,2,2,1,3
13032_0,,,,2,2,1,3
C(C(C(C(CO)O)=O)O)(O)=O,,,5,1,7,0,7
13032_1,,,,2,2,1,3
13033_0,,,,2,2,1,3
13035_0,,,,2,2,1,3
C(C(C=O)C(O)=O)=O,,,5,1,10,0,10
13035_1,,,,2,2,1,3
13036_0,,,,2,2,1,3
13036_1,,,,2,2,1,3
13037_0,,,,2,2,1,3
13037_1,,,,2,2,1,3
13039_0,,,,2,2,1,3
C(C(C=O)C(CO)=O)(O)=O,,,5,1,7,0,7
13039_1,,,,2,2,1,3
13041_0,,,,2,2,1,3
C(C(C(CC=O)=O)O)(O)=O,,,5,1,4,0,4
13041_1,,,,2,2,1,3
13043_0,,,,2,2,1,3
C(CC(C(C=O)O)=O)(O)=O,,,5,1,3,0,3
13044_0,,,,2,2,1,3
13046_0,,,,2,2,1,3
C(C(C(C(C(C=O)O)O)=O)O)(O)=O,,,5,1,4,0,4
13046_1,,,,2,2,1,3
13048_0,,,,2,2,1,3
C(C(C(C=O)=O)C(C=O)O)(O)=O,,,5,1,6,0,6
13048_1,,,,2,2,1,3
13049_0,,,,2,2,1,3
13049_1,,,,2,2,1,3
13051_0,,,,2,2,1,3
C(C(C(C(C(C)O)O)=O)O)(O)=O,,,5,1,6,0,6
13051_1,,,,2,2,1,3
13053_0,,,,2,2,1,3
C(C(C(C(C(CO)O)O)=O)O)(O)=O,,,5,1,7,0,7
13053_1,,,,2,2,1,3
13055_0,,,,2,2,1,3
C(C(C(C=O)=O)C(C=O)(C)O)(O)=O,,,5,1,4,0,4
13055_1,,,,2,2,1,3
13056_0,,,,2,2,1,3
13056_1,,,,2,2,1,3
13058_0,,,,2,2,1,3
C(C(C(C=O)=O)C(C(C)=O)O)(O)=O,,,5,1,4,0,4
13058_1,,,,2,2,1,3
13060_0,,,,2,2,1,3
C(CC(C(CC(C=O)=O)O)=O)(O)=O,,,5,1,2,0,2
13062_0,,,,2,2,1,3
C(C(C=O)C(C(CC(O)=O)=O)O)=O,,,5,1,3,0,3
13063_0,,,,2,2,1,3
13063_1,,,,2,2,1,3
13064_0,,,,2,2,1,3
13065_0,,,,2,2,1,3
13066_0,,,,2,2,1,3
13066_1,,,,2,2,1,3
13068_0,,,,2,2,1,3
C(C(C(C=O)=O)C(CC=O)O)(O)=O,,,5,1,4,0,4
13068_1,,,,2,2,1,3
13070_0,,,,2,2,1,3
C(C(C(C=O)=O)C(C)O)(O)=O,,,5,1,5,0,5
13070_1,,,,2,2,1,3
13071_0,,,,2,2,1,3
13071_1,,,,2,2,1,3
13072_0,,,,2,2,1,3
13072_1,,,,2,2,1,3
13073_0,,,,2,2,1,3
13073_1,,,,2,2,1,3
13074_0,,,,2,2,1,3
13074_1,,,,2,2,1,3
13075_0,,,,2,2,1,3
13075_1,,,,2,2,1,3
13076_0,,,,2,2,1,3
13076_1,,,,2,2,1,3
13078_0,,,,2,2,1,3
C(CC(C(C(C(O)=O)CO)=O)O)=O,,,5,1,6,0,6
13078_1,,,,2,2,1,3
13079_0,,,,2,2,1,3
13079_1,,,,2,2,1,3
13080_0,,,,2,2,1,3
13080_1,,,,2,2,1,3
13081_0,,,,2,2,1,3
13081_1,,,,2,2,1,3
13082_0,,,,2,2,1,3
13082_1,,,,2,2,1,3
13083_0,,,,2,2,1,3
13083_1,,,,2,2,1,3
13084_0,,,,2,2,1,3
13084_1,,,,2,2,1,3
13086_0,,,,2,2,1,3
C(C(C(C(C(O)=O)O)=O)C(C)O)=O,,,5,1,2,0,2
13086_1,,,,2,2,1,3
13088_0,,,,2,2,1,3
C(C(C(C(C(O)=O)O)=O)CO)=O,,,5,1,2,0,2
13088_1,,,,2,2,1,3
13090_0,,,,2,2,1,3
C(C(C=O)C(C(C(C)O)O)=O)(O)=O,,,5,1,3,0,3
13090_1,,,,2,2,1,3
13092_0,,,,2,2,1,3
C(C(C=O)C(C(CO)O)=O)(O)=O,,,5,1,3,0,3
13092_1,,,,2,2,1,3
13093_0,,,,2,2,1,3
13093_1,,,,2,2,1,3
13094_0,,,,2,2,1,3
13095_0,,,,2,2,1,3
13095_1,,,,2,2,1,3
13097_0,,,,2,2,1,3
C(C(C(C(C=O)O)=O)C(C)O)(O)=O,,,5,1,2,0,2
13097_1,,,,2,2,1,3
13099_0,,,,2,2,1,3
C(C(C(C(C=O)O)=O)CO)(O)=O,,,5,1,2,0,2
13099_1,,,,2,2,1,3
13100_0,,,,2,2,1,3
13100_1,,,,2,2,1,3
13101_0,,,,2,2,1,3
13101_1,,,,2,2,1,3
13102_0,,,,2,2,1,3
13102_1,,,,2,2,1,3
13103_0,,,,2,2,1,3
13103_1,,,,2,2,1,3
13105_0,,,,2,2,1,3
C(C(C(C=O)=O)O)(O)=O,,,5,1,7,0,7
13105_1,,,,2,2,1,3
13107_0,,,,2,2,1,3
C(C(C(C(C)=O)=O)O)(O)=O,,,5,1,4,0,4
13107_1,,,,2,2,1,3
13109_0,,,,2,2,1,3
C(CC(C(CO)=O)=O)(O)=O,,,5,1,3,0,3
13110_0,,,,2,2,1,3
13110_1,,,,2,2,1,3
13111_0,,,,2,2,1,3
13112_0,,,,2,2,1,3
13112_1,,,,2,2,1,3
13113_0,,,,2,2,1,3
13113_1,,,,2,2,1,3
13114_0,,,,2,2,1,3
13116_0,,,,2,2,1,3
C(CC(C(O)=O)=O)(O)=O,,,5,1,4,0,4
13118_0,,,,2,2,1,3
C(C(C(O)=O)C(O)=O)=O,,,5,1,2,0,2
13118_1,,,,2,2,1,3
13120_0,,,,2,2,1,3
C(C(C(C(O)=O)=O)CO)(O)=O,,,5,1,4,0,4
13120_1,,,,2,2,1,3
13121_0,,,,2,2,1,3
13121_1,,,,2,2,1,3
13123_0,,,,2,2,1,3
C(C(C(O)=O)C(CO)=O)(O)=O,,,5,1,2,0,2
13123_1,,,,2,2,1,3
13125_0,,,,2,2,1,3
C(CC(C(C(O)=O)O)=O)(O)=O,,,5,1,3,0,3
13125_1,,,,2,2,1,3
13126_0,,,,2,2,1,3
13128_0,,,,2,2,1,3
C(C(C(C(CO)(CO)O)=O)O)(O)=O,,,5,1,2,0,2
13128_1,,,,2,2,1,3
13130_0,,,,2,2,1,3
C(C(C(CC(O)=O)=O)(C(C)O)O)=O,,,5,1,1,0,1
13132_0,,,,2,2,1,3
C(C(C(CC(O)=O)=O)(CO)O)=O,,,5,1,1,0,1
13133_0,,,,2,2,1,3
13135_0,,,,2,2,1,3
C(C(C=O)C(C(C(O)=O)O)O)(O)=O,,,5,1,4,0,4
13135_1,,,,2,2,1,3
13136_0,,,,2,2,1,3
13136_1,,,,2,2,1,3
13137_0,,,,2,2,1,3
13137_1,,,,2,2,1,3
13138_0,,,,2,2,1,3
13138_1,,,,2,2,1,3
13139_0,,,,2,2,1,3
13139_1,,,,2,2,1,3
13141_0,,,,2,2,1,3
C(C(C(C(O)=O)=O)C(CO)O)(O)=O,,,5,1,3,0,3
13141_1,,,,2,2,1,3
13142_0,,,,2,2,1,3
13142_1,,,,2,2,1,3
13143_0,,,,2,2,1,3
13143_1,,,,2,2,1,3
13145_0,,,,2,2,1,3
C(C(C(O)=O)C(C(CO)O)=O)(O)=O,,,5,1,2,0,2
13145_1,,,,2,2,1,3
13146_0,,,,2,2,1,3
13146_1,,,,2,2,1,3
13148_0,,,,2,2,1,3
C(C1C(C(CO1)O)=O)(O)=O,,,5,1,2,0,2
13148_1,,,,2,2,1,3
13150_0,,,,2,2,1,3
C(C1C(C(O)OC1)=O)(O)=O,,,5,1,4,0,4
13150_1,,,,2,2,1,3
13152_0,,,,2,2,1,3
C(C1C(COC1O)=O)(O)=O,,,5,1,2,0,2
13152_1,,,,2,2,1,3
13154_0,,,,2,2,1,3
C(C1C(CC(O1)O)=O)(O)=O,,,5,1,2,0,2
13154_1,,,,2,2,1,3
13155_0,,,,2,2,1,3
13155_1,,,,2,2,1,3
13156_0,,,,2,2,1,3
13156_1,,,,2,2,1,3
13158_0,,,,2,2,1,3
C(C(CO)(C(C(C=O)=O)C)O)(O)=O,,,5,1,3,0,3
13159_0,,,,2,2,1,3
13161_0,,,,2,2,1,3
C(C(CO)(CC(C(C)=O)=O)O)(O)=O,,,5,1,3,0,3
13163_0,,,,2,2,1,3
C(C(C=C)C(C(O)=O)(CO)O)=O,,,5,1,1,0,1
13165_0,,,,2,2,1,3
C(C(CO)(C1C(C=CO1)=O)O)(O)=O,,,5,1,2,0,2
13165_1,,,,2,2,1,3
13166_0,,,,2,2,1,3
13166_1,,,,2,2,1,3
13168_0,,,,2,2,1,3
C(C(CO)(CC(C=O)=O)O)(O)=O,,,5,1,3,0,3
13170_0,,,,2,2,1,3
C(C(C=O)C(C(O)=O)(CO)O)=O,,,5,1,5,0,5
13170_1,,,,2,2,1,3
13171_0,,,,2,2,1,3
13173_0,,,,2,2,1,3
C(C(C(C)O)C(C(O)=O)(CO)O)=O,,,5,1,6,0,6
13173_1,,,,2,2,1,3
13174_0,,,,2,2,1,3
13174_1,,,,2,2,1,3
13176_0,,,,2,2,1,3
C(C(CO)(C(C(C=O)=O)O)O)(O)=O,,,5,1,5,0,5
13176_1,,,,2,2,1,3
13177_0,,,,2,2,1,3
13177_1,,,,2,2,1,3
13178_0,,,,2,2,1,3
13180_0,,,,2,2,1,3
C(C(CO)(CC(C(O)=O)=O)O)(O)=O,,,5,1,3,0,3
13181_0,,,,2,2,1,3
13181_1,,,,2,2,1,3
13182_0,,,,2,2,1,3
13182_1,,,,2,2,1,3
13184_0,,,,2,2,1,3
C(C(CO)(C(C(C(O)=O)=O)O)O)=C,,,5,1,2,0,2
13184_1,,,,2,2,1,3
13186_0,,,,2,2,1,3
C(C(C(C(C(O)=O)=O)O)O)=CCO,,,5,1,2,0,2
13186_1,,,,2,2,1,3
13188_0,,,,2,2,1,3
C(C(CC)(C(C(C(O)=O)=O)O)O)=O,,,5,1,2,0,2
13188_1,,,,2,2,1,3
13190_0,,,,2,2,1,3
C(C(C(C(C(O)=O)=O)O)O)(CC)=O,,,5,1,2,0,2
13190_1,,,,2,2,1,3
13192_0,,,,2,2,1,3
C(CCC(C(C(C(O)=O)=O)O)O)=O,,,5,1,3,0,3
13192_1,,,,2,2,1,3
13194_0,,,,2,2,1,3
C(C)(C(C)(C(C(C(O)=O)=O)O)O)=O,,,5,1,2,0,2
13194_1,,,,2,2,1,3
13196_0,,,,2,2,1,3
C=C(C=O)C(C(C(C(O)=O)=O)O)O,,,5,1,2,0,2
13196_1,,,,2,2,1,3
13198_0,,,,2,2,1,3
C(C(C(C(C(O)=O)=O)O)O)=CC,,,5,1,2,0,2
13198_1,,,,2,2,1,3
13200_0,,,,2,2,1,3
C(CC(C(C(C(O)=O)=O)O)O)=C,,,5,1,2,0,2
13200_1,,,,2,2,1,3
13202_0,,,,2,2,1,3
C=CC(C(C(C(C(O)=O)=O)O)O)O,,,5,1,2,0,2
13202_1,,,,2,2,1,3
13204_0,,,,2,2,1,3
C=CC(C(C(C(O)=O)=O)O)O,,,5,1,2,0,2
13204_1,,,,2,2,1,3
13206_0,,,,2,2,1,3
C1OCC(C=1)(C(C(C(O)=O)=O)O)O,,,5,1,2,0,2
13206_1,,,,2,2,1,3
13207_0,,,,2,2,1,3
13207_1,,,,2,2,1,3
13209_0,,,,2,2,1,3
C(C(C(C(C(O)=O)=O)O)O)=O,,,5,1,3,0,3
13209_1,,,,2,2,1,3
13211_0,,,,2,2,1,3
C(C(C(C(CO)(CO)O)O)=O)(O)=O,,,5,1,3,0,3
13211_1,,,,2,2,1,3
13213_0,,,,2,2,1,3
C(C(C)(C(C(C(O)=O)=O)O)O)=O,,,5,1,3,0,3
13213_1,,,,2,2,1,3
13215_0,,,,2,2,1,3
C(C)(C(C(C(C(O)=O)=O)O)O)=O,,,5,1,4,0,4
13215_1,,,,2,2,1,3
13217_0,,,,2,2,1,3
C(CC(C(C(C(O)=O)=O)O)O)=O,,,5,1,4,0,4
13217_1,,,,2,2,1,3
13219_0,,,,2,2,1,3
C(C(C(C(C)O)O)=O)(O)=O,,,5,1,5,0,5
13219_1,,,,2,2,1,3
13221_0,,,,2,2,1,3
C(C(C(C(CC(C)O)O)O)=O)(O)=O,,,5,1,3,0,3
13221_1,,,,2,2,1,3
13223_0,,,,2,2,1,3
C(C(C(C(CCO)O)O)=O)(O)=O,,,5,1,5,0,5
13223_1,,,,2,2,1,3
13225_0,,,,2,2,1,3
C(C(CO)(C(C(C(O)=O)=O)O)O)=O,,,5,1,3,0,3
13225_1,,,,2,2,1,3
13227_0,,,,2,2,1,3
C(CO)(C(C(C(C(O)=O)=O)O)O)=O,,,5,1,3,0,3
13227_1,,,,2,2,1,3
13229_0,,,,2,2,1,3
C(C(C(C(CO)(C)O)O)=O)(O)=O,,,5,1,3,0,3
13229_1,,,,2,2,1,3
13231_0,,,,2,2,1,3
C(C(C(C(C(O)=O)=O)O)O)(O)=O,,,5,1,3,0,3
13231_1,,,,2,2,1,3
13233_0,,,,2,2,1,3
C(C(C)(C(C(C(O)=O)=O)O)O)(O)=O,,,5,1,3,0,3
13233_1,,,,2,2,1,3
13235_0,,,,2,2,1,3
C(CC(C(C(C(O)=O)=O)O)O)(O)=O,,,5,1,3,0,3
13235_1,,,,2,2,1,3
13237_0,,,,2,2,1,3
C(C(C=C)(C(C(C(O)=O)=O)O)O)=O,,,5,1,3,0,3
13237_1,,,,2,2,1,3
13239_0,,,,2,2,1,3
C=CC(C(C(C(C(O)=O)=O)O)O)=O,,,5,1,3,0,3
13239_1,,,,2,2,1,3
13241_0,,,,2,2,1,3
C(C(C(C(C(O)=O)=O)O)O)=CC=O,,,5,1,3,0,3
13241_1,,,,2,2,1,3
13242_0,,,,2,2,1,3
13242_1,,,,2,2,1,3
13243_0,,,,2,2,1,3
13243_1,,,,2,2,1,3
13244_0,,,,2,2,1,3
13245_0,,,,2,2,1,3
13245_1,,,,2,2,1,3
13246_0,,,,2,2,1,3
13247_0,,,,2,2,1,3
13249_0,,,,2,2,1,3
C(C(C(C(C(C)O)O)=O)(CO)O)=O,,,5,1,4,0,4
13249_1,,,,2,2,1,3
13251_0,,,,2,2,1,3
C(C(C(C(CO)O)=O)(CO)O)=O,,,5,1,5,0,5
13251_1,,,,2,2,1,3
13252_0,,,,2,2,1,3
13254_0,,,,2,2,1,3
C(C(CO)(C(C(C=O)O)O)O)(O)=O,,,5,1,5,0,5
13254_1,,,,2,2,1,3
13255_0,,,,2,2,1,3
13257_0,,,,2,2,1,3
C(C(C(C(C=O)(C(C)=O)O)O)O)=O,,,5,1,5,0,5
13257_1,,,,2,2,1,3
13259_0,,,,2,2,1,3
C(C(C=O)(C(C)(CC=O)O)O)=O,,,5,1,3,0,3
13261_0,,,,2,2,1,3
C(C(C=O)(C(C)(C(C=O)O)O)O)=O,,,5,1,4,0,4
13261_1,,,,2,2,1,3
13263_0,,,,2,2,1,3
C(C(C=O)(C(CC(C=C)O)=O)O)=O,,,5,1,1,0,1
13265_0,,,,2,2,1,3
C(C(C=O)(C(CC(C=O)O)=O)O)=O,,,5,1,1,0,1
13267_0,,,,2,2,1,3
C(C(C=O)(C(CC(C)O)=O)O)=O,,,5,1,1,0,1
13269_0,,,,2,2,1,3
C(C(C=O)(C(CCO)=O)O)=O,,,5,1,1,0,1
13271_0,,,,2,2,1,3
C(C(C=O)(C(CC(CO)O)=O)O)=O,,,5,1,1,0,1
13273_0,,,,2,2,1,3
C(C(C=C)C(C(C=O)(CO)O)O)=O,,,5,1,3,0,3
13275_0,,,,2,2,1,3
C(C(CO)(C(CC(C=O)=O)O)O)=O,,,5,1,3,0,3
13277_0,,,,2,2,1,3
C(C(C=O)C(C(C=O)(CO)O)O)=O,,,5,1,4,0,4
13277_1,,,,2,2,1,3
13278_0,,,,2,2,1,3
13279_0,,,,2,2,1,3
13279_1,,,,2,2,1,3
13280_0,,,,2,2,1,3
13280_1,,,,2,2,1,3
13281_0,,,,2,2,1,3
13283_0,,,,2,2,1,3
C(C(CO)(C(C(C=O)O)O)O)=O,,,5,1,8,0,8
13283_1,,,,2,2,1,3
13284_0,,,,2,2,1,3
13285_0,,,,2,2,1,3
13286_0,,,,2,2,1,3
13286_1,,,,2,2,1,3
13288_0,,,,2,2,1,3
C(C(C=O)(CC(CC=O)O)O)=O,,,5,1,4,0,4
13290_0,,,,2,2,1,3
C(C(C=O)(CC(C(C=O)O)O)O)=O,,,5,1,2,0,2
13290_1,,,,2,2,1,3
13292_0,,,,2,2,1,3
C(C(C=O)(C(C=O)C(C=C)O)O)=O,,,5,1,2,0,2
13292_1,,,,2,2,1,3
13294_0,,,,2,2,1,3
C(C(C=O)(C(C=O)C(C=O)O)O)=O,,,5,1,2,0,2
13294_1,,,,2,2,1,3
13296_0,,,,2,2,1,3
C(C(C=O)(C(C=O)C(C)O)O)=O,,,5,1,2,0,2
13296_1,,,,2,2,1,3
13298_0,,,,2,2,1,3
C(C(C=O)(C(C=O)CO)O)=O,,,5,1,2,0,2
13298_1,,,,2,2,1,3
13300_0,,,,2,2,1,3
C(C(C=O)(C(C=O)C(CO)O)O)=O,,,5,1,2,0,2
13300_1,,,,2,2,1,3
13302_0,,,,2,2,1,3
C(C(C(C(C(C=C)=O)O)O)O)(O)=O,,,5,1,6,0,6
13302_1,,,,2,2,1,3
13304_0,,,,2,2,1,3
C(C(C(C(C(C=O)=O)C)O)O)(O)=O,,,5,1,2,0,2
13305_0,,,,2,2,1,3
13307_0,,,,2,2,1,3
C(C(C(CC(C(C)=O)=O)O)O)(O)=O,,,5,1,2,0,2
13309_0,,,,2,2,1,3
C(C(C=C)C(C(C(O)=O)O)O)=O,,,5,1,3,0,3
13311_0,,,,2,2,1,3
C(C(C(C1C(C=CO1)=O)O)O)(O)=O,,,5,1,2,0,2
13311_1,,,,2,2,1,3
13313_0,,,,2,2,1,3
C(C(C(C(C(CO)=O)O)O)O)(O)=O,,,5,1,10,0,10
13313_1,,,,2,2,1,3
13315_0,,,,2,2,1,3
C(C(C(CC(C=O)=O)O)O)(O)=O,,,5,1,4,0,4
13317_0,,,,2,2,1,3
C(C(C=O)C(C(C(O)=O)O)O)=O,,,5,1,3,0,3
13317_1,,,,2,2,1,3
13318_0,,,,2,2,1,3
13319_0,,,,2,2,1,3
13319_1,,,,2,2,1,3
13320_0,,,,2,2,1,3
13320_1,,,,2,2,1,3
13322_0,,,,2,2,1,3
C(C(C(C(C(C=O)=O)O)O)O)(O)=O,,,5,1,3,0,3
13322_1,,,,2,2,1,3
13323_0,,,,2,2,1,3
13323_1,,,,2,2,1,3
13324_0,,,,2,2,1,3
13326_0,,,,2,2,1,3
C(C(C(CC(C(O)=O)=O)O)O)(O)=O,,,5,1,2,0,2
13327_0,,,,2,2,1,3
13327_1,,,,2,2,1,3
13329_0,,,,2,2,1,3
C(C(C(C(C=O)O)O)O)(O)=O,,,5,1,9,0,9
13329_1,,,,2,2,1,3
13330_0,,,,2,2,1,3
13332_0,,,,2,2,1,3
C(C(C(CO)(C(C=O)O)O)O)(O)=O,,,5,1,11,0,11
13332_1,,,,2,2,1,3
13334_0,,,,2,2,1,3
C(C(C(C(C(C=C)O)O)=O)O)(O)=O,,,5,1,2,0,2
13334_1,,,,2,2,1,3
13335_0,,,,2,2,1,3
13335_1,,,,2,2,1,3
13336_0,,,,2,2,1,3
13336_1,,,,2,2,1,3
13337_0,,,,2,2,1,3
13337_1,,,,2,2,1,3
13338_0,,,,2,2,1,3
13338_1,,,,2,2,1,3
13340_0,,,,2,2,1,3
C(OCC(C)(C(C(C=C)=O)O)O)=O,,,5,1,2,0,2
13340_1,,,,2,2,1,3
13342_0,,,,2,2,1,3
C(OCC(C)(C(C(C=O)=O)C)O)=O,,,5,1,1,0,1
13344_0,,,,2,2,1,3
C(C(C(C)(COC=O)O)CC=O)=O,,,5,1,1,0,1
13346_0,,,,2,2,1,3
C(OCC(C)(CC(C(C)=O)=O)O)=O,,,5,1,1,0,1
13348_0,,,,2,2,1,3
C(OCC(C)(C(C=O)C=C)O)=O,,,5,1,1,0,1
13350_0,,,,2,2,1,3
C(OCC(C)(C1C(C=CO1)=O)O)=O,,,5,1,2,0,2
13350_1,,,,2,2,1,3
13352_0,,,,2,2,1,3
C(OCC(C)(C(C(CO)=O)O)O)=O,,,5,1,2,0,2
13352_1,,,,2,2,1,3
13354_0,,,,2,2,1,3
C(OCC(C)(CC(C=O)=O)O)=O,,,5,1,1,0,1
13356_0,,,,2,2,1,3
C(OCC(C)(C(C=O)C=O)O)=O,,,5,1,2,0,2
13356_1,,,,2,2,1,3
13358_0,,,,2,2,1,3
C(OCC(C)(CC=O)O)=O,,,5,1,1,0,1
13360_0,,,,2,2,1,3
C(OCC(C)(C(C=O)C(C)O)O)=O,,,5,1,2,0,2
13360_1,,,,2,2,1,3
13362_0,,,,2,2,1,3
C(OCC(C)(C(C=O)CO)O)=O,,,5,1,2,0,2
13362_1,,,,2,2,1,3
13364_0,,,,2,2,1,3
C(OCC(C)(C(C(C=O)=O)O)O)=O,,,5,1,2,0,2
13364_1,,,,2,2,1,3
13366_0,,,,2,2,1,3
C(OCC(C)(C(C(C)=O)O)O)=O,,,5,1,2,0,2
13366_1,,,,2,2,1,3
13368_0,,,,2,2,1,3
C(OCC(C)(CC(CO)=O)O)=O,,,5,1,1,0,1
13370_0,,,,2,2,1,3
C(OCC(C)(CC(C(O)=O)=O)O)=O,,,5,1,1,0,1
13372_0,,,,2,2,1,3
C(OCC(C)(C(C(O)=O)C=O)O)=O,,,5,1,2,0,2
13372_1,,,,2,2,1,3
13374_0,,,,2,2,1,3
C(OCC(C)(C(C=O)O)O)=O,,,5,1,2,0,2
13374_1,,,,2,2,1,3
13376_0,,,,2,2,1,3
C(OCC(CC(C=C)(CO)O)=O)=O,,,5,1,1,0,1
13378_0,,,,2,2,1,3
C(OCC(CC(C=CCO)O)=O)=O,,,5,1,1,0,1
13380_0,,,,2,2,1,3
C(C(CC)(CC(COC=O)=O)O)=O,,,5,1,1,0,1
13382_0,,,,2,2,1,3
C(COC=O)(CC(C(CC)=O)O)=O,,,5,1,1,0,1
13384_0,,,,2,2,1,3
C(CCC(CC(COC=O)=O)O)=O,,,5,1,1,0,1
13386_0,,,,2,2,1,3
C(C)(C(C)(CC(COC=O)=O)O)=O,,,5,1,1,0,1
13388_0,,,,2,2,1,3
C(OCC(CC(C(C=O)=C)O)=O)=O,,,5,1,1,0,1
13390_0,,,,2,2,1,3
C(OCC(CC(C=CC)O)=O)=O,,,5,1,1,0,1
13392_0,,,,2,2,1,3
C(OCC(CC(CC=C)O)=O)=O,,,5,1,1,0,1
13394_0,,,,2,2,1,3
C(OCC(CC(C(C=C)O)O)=O)=O,,,5,1,1,0,1
13396_0,,,,2,2,1,3
C(OCC(CC(C=C)O)=O)=O,,,5,1,1,0,1
13398_0,,,,2,2,1,3
C(OCC(CC1(C=COC1)O)=O)=O,,,5,1,1,0,1
13400_0,,,,2,2,1,3
C(OCC(CC(C(CO)O)O)=O)=O,,,5,1,3,0,3
13402_0,,,,2,2,1,3
C(OCC(CC(C=O)O)=O)=O,,,5,1,3,0,3
13404_0,,,,2,2,1,3
C(OCC(CC(CO)(CO)O)=O)=O,,,5,1,3,0,3
13406_0,,,,2,2,1,3
C(C(C)(CC(COC=O)=O)O)=O,,,5,1,3,0,3
13408_0,,,,2,2,1,3
C(OCC(CC(C(C)=O)O)=O)=O,,,5,1,3,0,3
13410_0,,,,2,2,1,3
C(CC(CC(COC=O)=O)O)=O,,,5,1,5,0,5
13412_0,,,,2,2,1,3
C(OCC(CC(C)O)=O)=O,,,5,1,3,0,3
13414_0,,,,2,2,1,3
C(OCC(CC(CC(C)O)O)=O)=O,,,5,1,3,0,3
13416_0,,,,2,2,1,3
C(OCC(CC(CCO)O)=O)=O,,,5,1,3,0,3
13418_0,,,,2,2,1,3
C(C(CO)(CC(COC=O)=O)O)=O,,,5,1,3,0,3
13420_0,,,,2,2,1,3
C(OCC(CC(C(CO)=O)O)=O)=O,,,5,1,3,0,3
13422_0,,,,2,2,1,3
C(OCC(CC(C)(CO)O)=O)=O,,,5,1,3,0,3
13424_0,,,,2,2,1,3
C(OCC(CC(C(O)=O)O)=O)=O,,,5,1,3,0,3
13426_0,,,,2,2,1,3
C(C(C)(CC(COC=O)=O)O)(O)=O,,,5,1,3,0,3
13428_0,,,,2,2,1,3
C(CC(CC(COC=O)=O)O)(O)=O,,,5,1,3,0,3
13430_0,,,,2,2,1,3
C(OCC(CC(C=O)(C=C)O)=O)=O,,,5,1,3,0,3
13432_0,,,,2,2,1,3
C(OCC(CC(C(C=C)=O)O)=O)=O,,,5,1,3,0,3
13434_0,,,,2,2,1,3
C(OCC(CC(C=CC=O)O)=O)=O,,,5,1,3,0,3
13436_0,,,,2,2,1,3
C(OCC(CCO)=O)=O,,,5,1,3,0,3
13438_0,,,,2,2,1,3
C(OCC(CC(CO)O)=O)=O,,,5,1,3,0,3
13440_0,,,,2,2,1,3
C(OC(C(C)=O)C(C=C)(CO)O)=O,,,5,1,2,0,2
13440_1,,,,2,2,1,3
13442_0,,,,2,2,1,3
C(OC(C(C)=O)C(C=CCO)O)=O,,,5,1,2,0,2
13442_1,,,,2,2,1,3
13444_0,,,,2,2,1,3
C(C(CC)(C(C(C)=O)OC=O)O)=O,,,5,1,2,0,2
13444_1,,,,2,2,1,3
13446_0,,,,2,2,1,3
C(C(C(C(C)=O)OC=O)O)(CC)=O,,,5,1,2,0,2
13446_1,,,,2,2,1,3
13448_0,,,,2,2,1,3
C(CCC(C(C(C)=O)OC=O)O)=O,,,5,1,2,0,2
13448_1,,,,2,2,1,3
13450_0,,,,2,2,1,3
C(C)(C(C)(C(C(C)=O)OC=O)O)=O,,,5,1,2,0,2
13450_1,,,,2,2,1,3
13452_0,,,,2,2,1,3
C(OC(C(C)=O)C(C(C=O)=C)O)=O,,,5,1,2,0,2
13452_1,,,,2,2,1,3
13454_0,,,,2,2,1,3
C(OC(C(C)=O)C(C=CC)O)=O,,,5,1,2,0,2
13454_1,,,,2,2,1,3
13456_0,,,,2,2,1,3
C(OC(C(C)=O)C(CC=C)O)=O,,,5,1,2,0,2
13456_1,,,,2,2,1,3
13458_0,,,,2,2,1,3
C(OC(C(C)=O)C(C(C=C)O)O)=O,,,5,1,2,0,2
13458_1,,,,2,2,1,3
13460_0,,,,2,2,1,3
C(OC(C(C)=O)C(C=C)O)=O,,,5,1,2,0,2
13460_1,,,,2,2,1,3
13462_0,,,,2,2,1,3
C(OC(C(C)=O)C1(C=COC1)O)=O,,,5,1,2,0,2
13462_1,,,,2,2,1,3
13464_0,,,,2,2,1,3
C(OC(C(C)=O)C(C(CO)O)O)=O,,,5,1,3,0,3
13464_1,,,,2,2,1,3
13466_0,,,,2,2,1,3
C(OC(C(C)=O)C(C=O)O)=O,,,5,1,3,0,3
13466_1,,,,2,2,1,3
13468_0,,,,2,2,1,3
C(OC(C(C)=O)C(CO)(CO)O)=O,,,5,1,3,0,3
13468_1,,,,2,2,1,3
13470_0,,,,2,2,1,3
C(C(C)(C(C(C)=O)OC=O)O)=O,,,5,1,3,0,3
13470_1,,,,2,2,1,3
13472_0,,,,2,2,1,3
C(OC(C(C)=O)C(C(C)=O)O)=O,,,5,1,4,0,4
13472_1,,,,2,2,1,3
13474_0,,,,2,2,1,3
C(CC(C(C(C)=O)OC=O)O)=O,,,5,1,5,0,5
13474_1,,,,2,2,1,3
13476_0,,,,2,2,1,3
C(OC(C(C)=O)C(C)O)=O,,,5,1,3,0,3
13476_1,,,,2,2,1,3
13478_0,,,,2,2,1,3
C(OC(C(C)=O)C(CC(C)O)O)=O,,,5,1,3,0,3
13478_1,,,,2,2,1,3
13480_0,,,,2,2,1,3
C(OC(C(C)=O)C(CCO)O)=O,,,5,1,3,0,3
13480_1,,,,2,2,1,3
13482_0,,,,2,2,1,3
C(C(CO)(C(C(C)=O)OC=O)O)=O,,,5,1,3,0,3
13482_1,,,,2,2,1,3
13484_0,,,,2,2,1,3
C(OC(C(C)=O)C(C(CO)=O)O)=O,,,5,1,3,0,3
13484_1,,,,2,2,1,3
13486_0,,,,2,2,1,3
C(OC(C(C)=O)C(C)(CO)O)=O,,,5,1,3,0,3
13486_1,,,,2,2,1,3
13488_0,,,,2,2,1,3
C(OC(C(C)=O)C(C(O)=O)O)=O,,,5,1,3,0,3
13488_1,,,,2,2,1,3
13490_0,,,,2,2,1,3
C(C(C)(C(C(C)=O)OC=O)O)(O)=O,,,5,1,3,0,3
13490_1,,,,2,2,1,3
13492_0,,,,2,2,1,3
C(CC(C(C(C)=O)OC=O)O)(O)=O,,,5,1,3,0,3
13492_1,,,,2,2,1,3
13494_0,,,,2,2,1,3
C(OC(C(C)=O)C(C=O)(C=C)O)=O,,,5,1,3,0,3
13494_1,,,,2,2,1,3
13496_0,,,,2,2,1,3
C(OC(C(C)=O)C(C(C=C)=O)O)=O,,,5,1,3,0,3
13496_1,,,,2,2,1,3
13498_0,,,,2,2,1,3
C(OC(C(C)=O)C(C=CC=O)O)=O,,,5,1,3,0,3
13498_1,,,,2,2,1,3
13500_0,,,,2,2,1,3
C(OC(C(C)=O)CO)=O,,,5,1,3,0,3
13500_1,,,,2,2,1,3
13502_0,,,,2,2,1,3
C(OC(C(C)=O)C(CO)O)=O,,,5,1,3,0,3
13502_1,,,,2,2,1,3
13503_0,,,,2,2,1,3
13504_0,,,,2,2,1,3
13504_1,,,,2,2,1,3
13506_0,,,,2,2,1,3
C(C(CO)O)(C(C=O)C(CO)=O)=O,,,5,1,4,0,4
13506_1,,,,2,2,1,3
13507_0,,,,2,2,1,3
13507_1,,,,2,2,1,3
13509_0,,,,2,2,1,3
C(C(C(C(C(CO)=O)O)=O)CO)=O,,,5,1,3,0,3
13509_1,,,,2,2,1,3
13511_0,,,,2,2,1,3
C(CC(C(C(C(CO)O)=O)O)=O)=O,,,5,1,3,0,3
13511_1,,,,2,2,1,3
13513_0,,,,2,2,1,3
C(C(C=O)O)(C(C(CO)=O)CO)=O,,,5,1,3,0,3
13513_1,,,,2,2,1,3
13515_0,,,,2,2,1,3
C(C(C=O)O)(CC(C(CO)O)=O)=O,,,5,1,3,0,3
13515_1,,,,2,2,1,3
13516_0,,,,2,2,1,3
13516_1,,,,2,2,1,3
13517_0,,,,2,2,1,3
13519_0,,,,2,2,1,3
C(CC(C(CO)O)(C(C)O)O)=O,,,5,1,2,0,2
13521_0,,,,2,2,1,3
C(C(C(C(CO)O)(C(C)O)O)O)=O,,,5,1,6,0,6
13521_1,,,,2,2,1,3
13523_0,,,,2,2,1,3
C(CC(C(C(C(C)O)O)O)O)=O,,,5,1,2,0,2
13525_0,,,,2,2,1,3
C(C(C(C(C(C(C)O)O)O)O)O)=O,,,5,1,6,0,6
13525_1,,,,2,2,1,3
13526_0,,,,2,2,1,3
13526_1,,,,2,2,1,3
13527_0,,,,2,2,1,3
13528_0,,,,2,2,1,3
13528_1,,,,2,2,1,3
13530_0,,,,2,2,1,3
C(CC(C(C(CO)=O)(C)O)O)=O,,,5,1,4,0,4
13532_0,,,,2,2,1,3
C(C(C(C(C(CO)=O)(C)O)O)O)=O,,,5,1,6,0,6
13532_1,,,,2,2,1,3
13534_0,,,,2,2,1,3
C(C(C(C(C(C=C)O)O)=O)(C)O)=O,,,5,1,2,0,2
13534_1,,,,2,2,1,3
13535_0,,,,2,2,1,3
13535_1,,,,2,2,1,3
13537_0,,,,2,2,1,3
C(C(C(C(C(C)O)O)=O)(C)O)=O,,,5,1,2,0,2
13537_1,,,,2,2,1,3
13538_0,,,,2,2,1,3
13538_1,,,,2,2,1,3
13539_0,,,,2,2,1,3
13539_1,,,,2,2,1,3
13541_0,,,,2,2,1,3
C(CC(C=O)(CC=O)O)(C(C)O)=O,,,5,1,2,0,2
13543_0,,,,2,2,1,3
C(CC(C(CC(C(C)O)=O)=O)O)=O,,,5,1,2,0,2
13545_0,,,,2,2,1,3
C(CC(C(C)O)(CC(C=O)=O)O)=O,,,5,1,2,0,2
13547_0,,,,2,2,1,3
C(C(C)O)(C(C(C=O)=O)C(C)O)=O,,,5,1,3,0,3
13547_1,,,,2,2,1,3
13548_0,,,,2,2,1,3
13548_1,,,,2,2,1,3
13550_0,,,,2,2,1,3
C(CC(C(C=O)C(C(C)O)=O)O)=O,,,5,1,4,0,4
13552_0,,,,2,2,1,3
C(C(C=O)C(C(C)O)(CC=O)O)=O,,,5,1,3,0,3
13554_0,,,,2,2,1,3
C(C(C=C)C(CC(C(C)O)=O)O)=O,,,5,1,1,0,1
13556_0,,,,2,2,1,3
C(C(C)O)(CC(CC(C=O)=O)O)=O,,,5,1,2,0,2
13558_0,,,,2,2,1,3
C(C(C=O)C(CC(C(C)O)=O)O)=O,,,5,1,3,0,3
13558_1,,,,2,2,1,3
13560_0,,,,2,2,1,3
C(CC(CC(C(C)O)=O)O)=O,,,5,1,2,0,2
13562_0,,,,2,2,1,3
C(C(C(CC(C(C)O)=O)O)CO)=O,,,5,1,3,0,3
13562_1,,,,2,2,1,3
13564_0,,,,2,2,1,3
C(C(C)O)(CC(C(C(C)=O)O)O)=O,,,5,1,3,0,3
13564_1,,,,2,2,1,3
13566_0,,,,2,2,1,3
C(C(C)O)(CC(CC(CO)=O)O)=O,,,5,1,2,0,2
13568_0,,,,2,2,1,3
C(C(C)O)(CC(C(C=O)O)O)=O,,,5,1,3,0,3
13568_1,,,,2,2,1,3
13570_0,,,,2,2,1,3
C(C(C=C)C(C(C)O)(CC=O)O)=O,,,5,1,1,0,1
13571_0,,,,2,2,1,3
13572_0,,,,2,2,1,3
13572_1,,,,2,2,1,3
13574_0,,,,2,2,1,3
C(CC(C(C)O)(CC=O)O)=O,,,5,1,1,0,1
13576_0,,,,2,2,1,3
C(C(CO)C(C(C)O)(CC=O)O)=O,,,5,1,2,0,2
13576_1,,,,2,2,1,3
13578_0,,,,2,2,1,3
C(CC(C(C)O)(C(C(C)=O)O)O)=O,,,5,1,2,0,2
13578_1,,,,2,2,1,3
13580_0,,,,2,2,1,3
C(CC(C(C)O)(CC(CO)=O)O)=O,,,5,1,1,0,1
13582_0,,,,2,2,1,3
C(CC(C(C)O)(C(C=O)O)O)=O,,,5,1,3,0,3
13582_1,,,,2,2,1,3
13584_0,,,,2,2,1,3
C(C(C)O)(C(C=O)C(C=CC)O)=O,,,5,1,2,0,2
13584_1,,,,2,2,1,3
13586_0,,,,2,2,1,3
C(C(C(C(C)O)=O)C(CC=C)O)=O,,,5,1,2,0,2
13586_1,,,,2,2,1,3
13588_0,,,,2,2,1,3
C(C(C)O)(C(C=O)C(C=C)O)=O,,,5,1,2,0,2
13588_1,,,,2,2,1,3
13589_0,,,,2,2,1,3
13589_1,,,,2,2,1,3
13591_0,,,,2,2,1,3
C(C(C)O)(C(C=O)C(C=O)(C)O)=O,,,5,1,3,0,3
13591_1,,,,2,2,1,3
13593_0,,,,2,2,1,3
C(C(C)O)(C(C=O)C(C(C)=O)O)=O,,,5,1,3,0,3
13593_1,,,,2,2,1,3
13594_0,,,,2,2,1,3
13594_1,,,,2,2,1,3
13596_0,,,,2,2,1,3
C(C(C(C(C)O)=O)C(C)O)=O,,,5,1,3,0,3
13596_1,,,,2,2,1,3
13598_0,,,,2,2,1,3
C(C(C(C(C)O)=O)C(CCO)O)=O,,,5,1,3,0,3
13598_1,,,,2,2,1,3
13600_0,,,,2,2,1,3
C(C(C(C(C)O)=O)C(CO)(C)O)=O,,,5,1,3,0,3
13600_1,,,,2,2,1,3
13602_0,,,,2,2,1,3
C(C(C)O)(C(C=O)C(C(O)=O)O)=O,,,5,1,4,0,4
13602_1,,,,2,2,1,3
13604_0,,,,2,2,1,3
C(C(C(C(C)O)=O)CO)=O,,,5,1,4,0,4
13604_1,,,,2,2,1,3
13606_0,,,,2,2,1,3
C(C(C(C(C)O)=O)C(CO)O)=O,,,5,1,4,0,4
13606_1,,,,2,2,1,3
13608_0,,,,2,2,1,3
C(CC(C(C(C(C)O)=O)O)O)=O,,,5,1,4,0,4
13609_0,,,,2,2,1,3
13609_1,,,,2,2,1,3
13610_0,,,,2,2,1,3
13612_0,,,,2,2,1,3
C(C(C(C(C)O)(C(C=O)O)O)O)=O,,,5,1,4,0,4
13612_1,,,,2,2,1,3
13613_0,,,,2,2,1,3
13613_1,,,,2,2,1,3
13615_0,,,,2,2,1,3
C(CC(CC(C(CCO)O)=O)O)=O,,,5,1,4,0,4
13617_0,,,,2,2,1,3
C(CC(C(CCO)O)(CC=O)O)=O,,,5,1,1,0,1
13619_0,,,,2,2,1,3
C(C(C(C(CCO)O)=O)C(C)O)=O,,,5,1,3,0,3
13619_1,,,,2,2,1,3
13621_0,,,,2,2,1,3
C(C(C(C(CCO)O)=O)CO)=O,,,5,1,6,0,6
13621_1,,,,2,2,1,3
13622_0,,,,2,2,1,3
13622_1,,,,2,2,1,3
13624_0,,,,2,2,1,3
C(C(CO)CO)(C(C(CO)=O)O)=O,,,5,1,3,0,3
13624_1,,,,2,2,1,3
13625_0,,,,2,2,1,3
13625_1,,,,2,2,1,3
13626_0,,,,2,2,1,3
13626_1,,,,2,2,1,3
13627_0,,,,2,2,1,3
13627_1,,,,2,2,1,3
13628_0,,,,2,2,1,3
13630_0,,,,2,2,1,3
C(CC(C(C(CC(C)O)O)=O)O)=O,,,5,1,3,0,3
13631_0,,,,2,2,1,3
13632_0,,,,2,2,1,3
13632_1,,,,2,2,1,3
13634_0,,,,2,2,1,3
C(CC(C(C(CCO)O)=O)O)=O,,,5,1,4,0,4
13636_0,,,,2,2,1,3
C(C(C(C=O)O)O)(C(CCO)O)=O,,,5,1,5,0,5
13636_1,,,,2,2,1,3
13638_0,,,,2,2,1,3
C=CC(C(C(CO)(C(C)O)O)O)=O,,,5,1,4,0,4
13638_1,,,,2,2,1,3
13640_0,,,,2,2,1,3
C(C(C(C)C(CO)(C(C)O)O)=O)=O,,,5,1,1,0,1
13642_0,,,,2,2,1,3
C(C(C(CO)(C(C)O)O)CC=O)=O,,,5,1,4,0,4
13644_0,,,,2,2,1,3
C(C(C)=O)(CC(CO)(C(C)O)O)=O,,,5,1,1,0,1
13646_0,,,,2,2,1,3
C(C(C=C)C(CO)(C(C)O)O)=O,,,5,1,1,0,1
13648_0,,,,2,2,1,3
C1OC(C(C=1)=O)C(CO)(C(C)O)O,,,5,1,2,0,2
13648_1,,,,2,2,1,3
13650_0,,,,2,2,1,3
C(CO)(C(C(CO)(C(C)O)O)O)=O,,,5,1,6,0,6
13650_1,,,,2,2,1,3
13652_0,,,,2,2,1,3
C(C(CC(CO)(C(C)O)O)=O)=O,,,5,1,3,0,3
13654_0,,,,2,2,1,3
C(C(C=O)C(CO)(C(C)O)O)=O,,,5,1,3,0,3
13654_1,,,,2,2,1,3
13655_0,,,,2,2,1,3
13657_0,,,,2,2,1,3
C(C(C(C)O)C(CO)(C(C)O)O)=O,,,5,1,5,0,5
13657_1,,,,2,2,1,3
13659_0,,,,2,2,1,3
C(C(CO)C(CO)(C(C)O)O)=O,,,5,1,5,0,5
13659_1,,,,2,2,1,3
13661_0,,,,2,2,1,3
C(C(C(C(CO)(C(C)O)O)O)=O)=O,,,5,1,3,0,3
13661_1,,,,2,2,1,3
13663_0,,,,2,2,1,3
C(C)(C(C(CO)(C(C)O)O)O)=O,,,5,1,5,0,5
13663_1,,,,2,2,1,3
13665_0,,,,2,2,1,3
C(CO)(CC(CO)(C(C)O)O)=O,,,5,1,3,0,3
13667_0,,,,2,2,1,3
C(C(CC(CO)(C(C)O)O)=O)(O)=O,,,5,1,2,0,2
13668_0,,,,2,2,1,3
13668_1,,,,2,2,1,3
13669_0,,,,2,2,1,3
13669_1,,,,2,2,1,3
13671_0,,,,2,2,1,3
C(C(C(C=C)(CO)O)O)(C(C)O)=O,,,5,1,2,0,2
13671_1,,,,2,2,1,3
13673_0,,,,2,2,1,3
C(C(C(C=CCO)O)O)(C(C)O)=O,,,5,1,2,0,2
13673_1,,,,2,2,1,3
13675_0,,,,2,2,1,3
C(C(CC)(C(C(C(C)O)=O)O)O)=O,,,5,1,2,0,2
13675_1,,,,2,2,1,3
13677_0,,,,2,2,1,3
C(C(C(C(C(C)O)=O)O)O)(CC)=O,,,5,1,2,0,2
13677_1,,,,2,2,1,3
13679_0,,,,2,2,1,3
C(CCC(C(C(C(C)O)=O)O)O)=O,,,5,1,3,0,3
13679_1,,,,2,2,1,3
13681_0,,,,2,2,1,3
C(C)(C(C)(C(C(C(C)O)=O)O)O)=O,,,5,1,2,0,2
13681_1,,,,2,2,1,3
13683_0,,,,2,2,1,3
C(C(C(C(C=O)=C)O)O)(C(C)O)=O,,,5,1,2,0,2
13683_1,,,,2,2,1,3
13685_0,,,,2,2,1,3
C(C(C(C=CC)O)O)(C(C)O)=O,,,5,1,2,0,2
13685_1,,,,2,2,1,3
13687_0,,,,2,2,1,3
C(C(C(CC=C)O)O)(C(C)O)=O,,,5,1,2,0,2
13687_1,,,,2,2,1,3
13689_0,,,,2,2,1,3
C(C(C)O)(C(C(C(C=C)O)O)O)=O,,,5,1,2,0,2
13689_1,,,,2,2,1,3
13691_0,,,,2,2,1,3
C(C(C(C=C)O)O)(C(C)O)=O,,,5,1,2,0,2
13691_1,,,,2,2,1,3
13693_0,,,,2,2,1,3
C(C(C1(C=COC1)O)O)(C(C)O)=O,,,5,1,2,0,2
13693_1,,,,2,2,1,3
13695_0,,,,2,2,1,3
C(C(C(C(CO)O)O)O)(C(C)O)=O,,,5,1,6,0,6
13695_1,,,,2,2,1,3
13696_0,,,,2,2,1,3
13696_1,,,,2,2,1,3
13698_0,,,,2,2,1,3
C(C(C(CO)(CO)O)O)(C(C)O)=O,,,5,1,6,0,6
13698_1,,,,2,2,1,3
13700_0,,,,2,2,1,3
C(C(C)(C(C(C(C)O)=O)O)O)=O,,,5,1,3,0,3
13700_1,,,,2,2,1,3
13701_0,,,,2,2,1,3
13701_1,,,,2,2,1,3
13702_0,,,,2,2,1,3
13702_1,,,,2,2,1,3
13704_0,,,,2,2,1,3
C(C(C(C)O)O)(C(C)O)=O,,,5,1,2,0,2
13704_1,,,,2,2,1,3
13706_0,,,,2,2,1,3
C(C(C(CC(C)O)O)O)(C(C)O)=O,,,5,1,2,0,2
13706_1,,,,2,2,1,3
13708_0,,,,2,2,1,3
C(C(C(CCO)O)O)(C(C)O)=O,,,5,1,3,0,3
13708_1,,,,2,2,1,3
13709_0,,,,2,2,1,3
13709_1,,,,2,2,1,3
13710_0,,,,2,2,1,3
13710_1,,,,2,2,1,3
13712_0,,,,2,2,1,3
C(C(C(CO)(C)O)O)(C(C)O)=O,,,5,1,2,0,2
13712_1,,,,2,2,1,3
13713_0,,,,2,2,1,3
13713_1,,,,2,2,1,3
13714_0,,,,2,2,1,3
13714_1,,,,2,2,1,3
13716_0,,,,2,2,1,3
C(CC(C(C(C(C)O)=O)O)O)(O)=O,,,5,1,3,0,3
13716_1,,,,2,2,1,3
13718_0,,,,2,2,1,3
C(C(C=C)(C(C(C(C)O)=O)O)O)=O,,,5,1,3,0,3
13718_1,,,,2,2,1,3
13720_0,,,,2,2,1,3
C(C(C(C(C=C)=O)O)O)(C(C)O)=O,,,5,1,4,0,4
13720_1,,,,2,2,1,3
13722_0,,,,2,2,1,3
C(C(C(C=CC=O)O)O)(C(C)O)=O,,,5,1,2,0,2
13722_1,,,,2,2,1,3
13723_0,,,,2,2,1,3
13723_1,,,,2,2,1,3
13724_0,,,,2,2,1,3
13724_1,,,,2,2,1,3
13726_0,,,,2,2,1,3
C(C(C=C)C(C(O)=O)(C(C)O)O)=O,,,5,1,1,0,1
13728_0,,,,2,2,1,3
C(C(C(C)O)(CC(C=O)=O)O)(O)=O,,,5,1,3,0,3
13730_0,,,,2,2,1,3
C(C(C=O)C(C(O)=O)(C(C)O)O)=O,,,5,1,4,0,4
13730_1,,,,2,2,1,3
13731_0,,,,2,2,1,3
13733_0,,,,2,2,1,3
C(C(CO)C(C(O)=O)(C(C)O)O)=O,,,5,1,6,0,6
13733_1,,,,2,2,1,3
13734_0,,,,2,2,1,3
13734_1,,,,2,2,1,3
13735_0,,,,2,2,1,3
13736_0,,,,2,2,1,3
13736_1,,,,2,2,1,3
13738_0,,,,2,2,1,3
C(C(C(C(CO)O)=O)(CO)O)(O)=O,,,5,1,5,0,5
13738_1,,,,2,2,1,3
13740_0,,,,2,2,1,3
C(CCO)(C(C=O)(C(CO)=O)O)=O,,,5,1,2,0,2
13742_0,,,,2,2,1,3
C(C(CO)O)(C(C=O)(C(C)=O)O)=O,,,5,1,3,0,3
13742_1,,,,2,2,1,3
13744_0,,,,2,2,1,3
C(C(CO)C(C=O)(C(CO)=O)O)=O,,,5,1,3,0,3
13744_1,,,,2,2,1,3
13746_0,,,,2,2,1,3
C(C(CO)O)(C(C=O)(CC=O)O)=O,,,5,1,3,0,3
13746_1,,,,2,2,1,3
13748_0,,,,2,2,1,3
C(CC(C(C)O)(C(C(O)=O)O)O)=O,,,5,1,2,0,2
13749_0,,,,2,2,1,3
13750_0,,,,2,2,1,3
13750_1,,,,2,2,1,3
13752_0,,,,2,2,1,3
C(C(C(C=C)O)O)(CC(CO)=O)=O,,,5,1,2,0,2
13752_1,,,,2,2,1,3
13753_0,,,,2,2,1,3
13753_1,,,,2,2,1,3
13755_0,,,,2,2,1,3
C(C(C(C)O)O)(CC(CO)=O)=O,,,5,1,6,0,6
13755_1,,,,2,2,1,3
13756_0,,,,2,2,1,3
13756_1,,,,2,2,1,3
13758_0,,,,2,2,1,3
C(C(C(CO)O)O)(CC(CO)=O)=O,,,5,1,8,0,8
13758_1,,,,2,2,1,3
13760_0,,,,2,2,1,3
C(CO)(C(C(CO)=O)C(C=C)O)=O,,,5,1,2,0,2
13760_1,,,,2,2,1,3
13762_0,,,,2,2,1,3
C(C(C(C(CO)=O)C(CO)=O)O)=O,,,5,1,3,0,3
13762_1,,,,2,2,1,3
13764_0,,,,2,2,1,3
C(CO)(C(C(CO)=O)C(C)O)=O,,,5,1,4,0,4
13764_1,,,,2,2,1,3
13765_0,,,,2,2,1,3
13765_1,,,,2,2,1,3
13767_0,,,,2,2,1,3
C(CO)(C(C(CO)=O)C(CO)O)=O,,,5,1,3,0,3
13767_1,,,,2,2,1,3
13769_0,,,,2,2,1,3
C(CC(C(CC(C=O)O)O)O)=O,,,5,1,2,0,2
13770_0,,,,2,2,1,3
13770_1,,,,2,2,1,3
13772_0,,,,2,2,1,3
C(C(CO)O)(CC(C(CO)O)=O)=O,,,5,1,5,0,5
13772_1,,,,2,2,1,3
13774_0,,,,2,2,1,3
C(C(CO)O)(C(C(CO)=O)CO)=O,,,5,1,8,0,8
13774_1,,,,2,2,1,3
13776_0,,,,2,2,1,3
C(CC(C(CO)(CC=O)O)O)(O)=O,,,5,1,3,0,3
13778_0,,,,2,2,1,3
C(CC(C(C(C(C)O)O)=O)O)(O)=O,,,5,1,2,0,2
13778_1,,,,2,2,1,3
13779_0,,,,2,2,1,3
13779_1,,,,2,2,1,3
13780_0,,,,2,2,1,3
13782_0,,,,2,2,1,3
C(C(C=C)C(C(C)(CCO)O)O)=O,,,5,1,1,0,1
13784_0,,,,2,2,1,3
C(C(CC(C(C)(CCO)O)O)=O)=O,,,5,1,2,0,2
13786_0,,,,2,2,1,3
C(C(C=O)C(C(C)(CCO)O)O)=O,,,5,1,3,0,3
13786_1,,,,2,2,1,3
13788_0,,,,2,2,1,3
C(CC(C(C)(CCO)O)O)=O,,,5,1,2,0,2
13790_0,,,,2,2,1,3
C(C(CO)C(C(C)(CCO)O)O)=O,,,5,1,3,0,3
13790_1,,,,2,2,1,3
13792_0,,,,2,2,1,3
C(C)(C(C(C(C)(CCO)O)O)O)=O,,,5,1,3,0,3
13792_1,,,,2,2,1,3
13794_0,,,,2,2,1,3
C(CO)(CC(C(C)(CCO)O)O)=O,,,5,1,2,0,2
13796_0,,,,2,2,1,3
C(C(C(C(C)(CCO)O)O)O)=O,,,5,1,3,0,3
13796_1,,,,2,2,1,3
13798_0,,,,2,2,1,3
C(CC(C(C)(C(CO)O)O)O)=O,,,5,1,3,0,3
13800_0,,,,2,2,1,3
C(C(C(C(C)(C(CO)O)O)O)O)=O,,,5,1,6,0,6
13800_1,,,,2,2,1,3
13802_0,,,,2,2,1,3
C(C(C=C)C(C)(C(CCO)O)O)=O,,,5,1,1,0,1
13804_0,,,,2,2,1,3
C(C(CC(C)(C(CCO)O)O)=O)=O,,,5,1,2,0,2
13806_0,,,,2,2,1,3
C(C(C=O)C(C)(C(CCO)O)O)=O,,,5,1,3,0,3
13806_1,,,,2,2,1,3
13808_0,,,,2,2,1,3
C(CC(C)(C(CCO)O)O)=O,,,5,1,2,0,2
13810_0,,,,2,2,1,3
C(C(CO)C(C)(C(CCO)O)O)=O,,,5,1,3,0,3
13810_1,,,,2,2,1,3
13812_0,,,,2,2,1,3
C(C)(C(C(C)(C(CCO)O)O)O)=O,,,5,1,3,0,3
13812_1,,,,2,2,1,3
13814_0,,,,2,2,1,3
C(CO)(CC(C)(C(CCO)O)O)=O,,,5,1,2,0,2
13816_0,,,,2,2,1,3
C(C(C(C)(C(CCO)O)O)O)=O,,,5,1,3,0,3
13816_1,,,,2,2,1,3
13818_0,,,,2,2,1,3
C(CC(C=CC)O)(C(CCO)O)=O,,,5,1,1,0,1
13820_0,,,,2,2,1,3
C(C(CCO)O)(CC(CC=C)O)=O,,,5,1,1,0,1
13822_0,,,,2,2,1,3
C(CC(C=C)O)(C(CCO)O)=O,,,5,1,1,0,1
13824_0,,,,2,2,1,3
C(CC(C=O)O)(C(CCO)O)=O,,,5,1,2,0,2
13826_0,,,,2,2,1,3
C(C(C)(CC(C(CCO)O)=O)O)=O,,,5,1,2,0,2
13828_0,,,,2,2,1,3
C(CC(C(C)=O)O)(C(CCO)O)=O,,,5,1,2,0,2
13829_0,,,,2,2,1,3
13831_0,,,,2,2,1,3
C(C(CCO)O)(CC(C)O)=O,,,5,1,2,0,2
13833_0,,,,2,2,1,3
C(C(CCO)O)(CC(CCO)O)=O,,,5,1,2,0,2
13835_0,,,,2,2,1,3
C(C(CCO)O)(CC(CO)(C)O)=O,,,5,1,2,0,2
13837_0,,,,2,2,1,3
C(CC(C(O)=O)O)(C(CCO)O)=O,,,5,1,5,0,5
13838_0,,,,2,2,1,3
13840_0,,,,2,2,1,3
C(C(CCO)O)(CC(CO)O)=O,,,5,1,3,0,3
13842_0,,,,2,2,1,3
C(CC(C(CCO)(CCO)O)O)=O,,,5,1,2,0,2
13844_0,,,,2,2,1,3
C(CC(CCO)(C(CCO)O)O)=O,,,5,1,2,0,2
13846_0,,,,2,2,1,3
C(C(CCO)O)(C(CO)C(C)O)=O,,,5,1,3,0,3
13846_1,,,,2,2,1,3
13848_0,,,,2,2,1,3
C(C(CCO)O)(C(CO)CO)=O,,,5,1,3,0,3
13848_1,,,,2,2,1,3
13850_0,,,,2,2,1,3
C(CC(C(CC(CCO)O)O)O)=O,,,5,1,2,0,2
13852_0,,,,2,2,1,3
C(CC(C(C(CO)C(C)O)O)O)=O,,,5,1,2,0,2
13854_0,,,,2,2,1,3
C(CC(C(C(CO)CO)O)O)=O,,,5,1,2,0,2
13856_0,,,,2,2,1,3
C(C(C(C(C(CO)CO)O)O)O)=O,,,5,1,3,0,3
13856_1,,,,2,2,1,3
13858_0,,,,2,2,1,3
C(CC(C(C(C)(CCO)O)O)O)=O,,,5,1,2,0,2
13860_0,,,,2,2,1,3
C(CC(C)(C(CO)(C(C)O)O)O)=O,,,5,1,2,0,2
13862_0,,,,2,2,1,3
C(CC(C)O)(C(CO)(C(C)O)O)=O,,,5,1,4,0,4
13864_0,,,,2,2,1,3
C(CCO)(C(CO)(C(C)O)O)=O,,,5,1,8,0,8
13866_0,,,,2,2,1,3
C(CC(C)(C(CO)(CO)O)O)=O,,,5,1,2,0,2
13867_0,,,,2,2,1,3
13867_1,,,,2,2,1,3
13869_0,,,,2,2,1,3
C(CC(C=C)O)(C(CO)(CO)O)=O,,,5,1,1,0,1
13870_0,,,,2,2,1,3
13872_0,,,,2,2,1,3
C(CC(C)O)(C(CO)(CO)O)=O,,,5,1,4,0,4
13873_0,,,,2,2,1,3
13875_0,,,,2,2,1,3
C(CC(CO)O)(C(CO)(CO)O)=O,,,5,1,5,0,5
13877_0,,,,2,2,1,3
C(CCO)(C(CO)(C(CO)O)O)=O,,,5,1,9,0,9
13879_0,,,,2,2,1,3
C(CC(CC(CO)(C(C)O)O)O)=O,,,5,1,2,0,2
13880_0,,,,2,2,1,3
13880_1,,,,2,2,1,3
13881_0,,,,2,2,1,3
13881_1,,,,2,2,1,3
13883_0,,,,2,2,1,3
C(CC(C(CCO)(C(C)O)O)O)=O,,,5,1,2,0,2
13885_0,,,,2,2,1,3
C(CC(C(CO)(CCO)O)O)=O,,,5,1,3,0,3
13887_0,,,,2,2,1,3
C(C(C(C(CO)(CCO)O)O)O)=O,,,5,1,6,0,6
13887_1,,,,2,2,1,3
13889_0,,,,2,2,1,3
C(C(CO)(CO)O)(C(CO)CO)=O,,,5,1,6,0,6
13889_1,,,,2,2,1,3
13891_0,,,,2,2,1,3
C(C(CO)(C(C(C=C)=O)O)O)=C,,,5,1,2,0,2
13891_1,,,,2,2,1,3
13893_0,,,,2,2,1,3
C=CC(CO)(C(C(C=O)=O)C)O,,,5,1,1,0,1
13895_0,,,,2,2,1,3
C(CC(C=O)C(C=C)(CO)O)=O,,,5,1,1,0,1
13897_0,,,,2,2,1,3
C(C(CO)(CC(C(C)=O)=O)O)=C,,,5,1,1,0,1
13899_0,,,,2,2,1,3
C=CC(CO)(C(C(C(O)=O)=O)C)O,,,5,1,1,0,1
13901_0,,,,2,2,1,3
C(C(C(C)=O)C(C=C)(CO)O)(O)=O,,,5,1,2,0,2
13901_1,,,,2,2,1,3
13903_0,,,,2,2,1,3
C(CC(CC(C=C)(CO)O)=O)(O)=O,,,5,1,1,0,1
13905_0,,,,2,2,1,3
C=CC(CO)(C1C(C(OC1)=O)=O)O,,,5,1,2,0,2
13905_1,,,,2,2,1,3
13907_0,,,,2,2,1,3
C1(C(C(CO1)=O)C(C=C)(CO)O)=O,,,5,1,2,0,2
13907_1,,,,2,2,1,3
13909_0,,,,2,2,1,3
C1(CC(C(C(C=C)(CO)O)O1)=O)=O,,,5,1,2,0,2
13909_1,,,,2,2,1,3
13911_0,,,,2,2,1,3
C(C(C(C=O)=C)C(C=C)(CO)O)=O,,,5,1,1,0,1
13913_0,,,,2,2,1,3
C(C(CO)(CC(C=CC=O)=O)O)=C,,,5,1,1,0,1
13915_0,,,,2,2,1,3
C=CC(C(C=O)=O)C(C=C)(CO)O,,,5,1,1,0,1
13917_0,,,,2,2,1,3
C(C(C=CC=O)C(C=C)(CO)O)=O,,,5,1,1,0,1
13919_0,,,,2,2,1,3
C(C(C=C)C(C=C)(CO)O)=O,,,5,1,1,0,1
13921_0,,,,2,2,1,3
C(C(CO)(C1C(C=CO1)=O)O)=C,,,5,1,2,0,2
13921_1,,,,2,2,1,3
13923_0,,,,2,2,1,3
C(C(C(C=C)(CO)O)O)(CO)=O,,,5,1,4,0,4
13923_1,,,,2,2,1,3
13925_0,,,,2,2,1,3
C(C(CO)(CC(C=O)=O)O)=C,,,5,1,3,0,3
13927_0,,,,2,2,1,3
C(C(C=O)C(C=C)(CO)O)=O,,,5,1,4,0,4
13927_1,,,,2,2,1,3
13929_0,,,,2,2,1,3
C=CC(CO)(C(C(C=O)=O)CO)O,,,5,1,3,0,3
13929_1,,,,2,2,1,3
13931_0,,,,2,2,1,3
C(C(C(C=O)C(C=C)(CO)O)O)=O,,,5,1,3,0,3
13931_1,,,,2,2,1,3
13933_0,,,,2,2,1,3
C(C(C(CO)=O)C(C=C)(CO)O)=O,,,5,1,3,0,3
13933_1,,,,2,2,1,3
13935_0,,,,2,2,1,3
C(CC(C(C(C=C)(CO)O)O)=O)=O,,,5,1,3,0,3
13935_1,,,,2,2,1,3
13937_0,,,,2,2,1,3
C(C(C(CC(C=C)(CO)O)=O)O)=O,,,5,1,2,0,2
13939_0,,,,2,2,1,3
C(CC(C=C)(CO)O)=O,,,5,1,4,0,4
13941_0,,,,2,2,1,3
C(C(C(C)O)C(C=C)(CO)O)=O,,,5,1,4,0,4
13941_1,,,,2,2,1,3
13943_0,,,,2,2,1,3
C(C(CO)C(C=C)(CO)O)=O,,,5,1,4,0,4
13943_1,,,,2,2,1,3
13945_0,,,,2,2,1,3
C(C(C(CO)O)C(C=C)(CO)O)=O,,,5,1,3,0,3
13945_1,,,,2,2,1,3
13947_0,,,,2,2,1,3
C(C(CO)(C(C(C=O)=O)O)O)=C,,,5,1,4,0,4
13947_1,,,,2,2,1,3
13949_0,,,,2,2,1,3
C(C(CO)(C(C(C(C)=O)=O)O)O)=C,,,5,1,3,0,3
13949_1,,,,2,2,1,3
13951_0,,,,2,2,1,3
C(C(CO)(CC(C(CO)=O)=O)O)=C,,,5,1,2,0,2
13953_0,,,,2,2,1,3
C(C(C(C=C)(CO)O)O)(C)=O,,,5,1,4,0,4
13953_1,,,,2,2,1,3
13955_0,,,,2,2,1,3
C(CC(C=C)(CO)O)(CO)=O,,,5,1,3,0,3
13957_0,,,,2,2,1,3
C(C(C(C=C)(CO)O)O)(CCO)=O,,,5,1,3,0,3
13957_1,,,,2,2,1,3
13959_0,,,,2,2,1,3
C(CO)(C(CO)C(C=C)(CO)O)=O,,,5,1,3,0,3
13959_1,,,,2,2,1,3
13961_0,,,,2,2,1,3
C(CC(C=C)(CO)O)(C(CO)O)=O,,,5,1,2,0,2
13963_0,,,,2,2,1,3
C(C(CO)(CC(C(O)=O)=O)O)=C,,,5,1,3,0,3
13965_0,,,,2,2,1,3
C(C(C=O)C(C=C)(CO)O)(O)=O,,,5,1,4,0,4
13965_1,,,,2,2,1,3
13967_0,,,,2,2,1,3
C1(C(C(C=C)(CO)O)OCC1O)=O,,,5,1,3,0,3
13967_1,,,,2,2,1,3
13969_0,,,,2,2,1,3
C1(C(O)OCC1C(C=C)(CO)O)=O,,,5,1,3,0,3
13969_1,,,,2,2,1,3
13971_0,,,,2,2,1,3
C1(COC(C1C(C=C)(CO)O)O)=O,,,5,1,3,0,3
13971_1,,,,2,2,1,3
13973_0,,,,2,2,1,3
C1(C(C(C=C)(CO)O)OC(C1)O)=O,,,5,1,3,0,3
13973_1,,,,2,2,1,3
13975_0,,,,2,2,1,3
C(C(C(C=C)(CO)O)O)=O,,,5,1,8,0,8
13975_1,,,,2,2,1,3
13977_0,,,,2,2,1,3
C=CC(C(C(C=CCO)O)O)=O,,,5,1,2,0,2
13977_1,,,,2,2,1,3
13979_0,,,,2,2,1,3
C(C(C=C)(C(C(C=C)=O)O)O)(O)=O,,,5,1,3,0,3
13979_1,,,,2,2,1,3
13981_0,,,,2,2,1,3
C=CC(C(C(C=CC(O)=O)O)O)=O,,,5,1,2,0,2
13981_1,,,,2,2,1,3
13983_0,,,,2,2,1,3
C(C(CC)(C(C(C=C)=O)O)O)=O,,,5,1,2,0,2
13983_1,,,,2,2,1,3
13985_0,,,,2,2,1,3
C(C(C(C(C=C)=O)O)O)(CC)=O,,,5,1,2,0,2
13985_1,,,,2,2,1,3
13987_0,,,,2,2,1,3
C(CCC(C(C(C=C)=O)O)O)=O,,,5,1,2,0,2
13987_1,,,,2,2,1,3
13989_0,,,,2,2,1,3
C(C)(C(C)(C(C(C=C)=O)O)O)=O,,,5,1,2,0,2
13989_1,,,,2,2,1,3
13991_0,,,,2,2,1,3
C(C(CC)(C(C(C=C)=O)O)O)(O)=O,,,5,1,2,0,2
13991_1,,,,2,2,1,3
13993_0,,,,2,2,1,3
C(CC(C)(C(C(C=C)=O)O)O)(O)=O,,,5,1,2,0,2
13993_1,,,,2,2,1,3
13995_0,,,,2,2,1,3
C1(C(CCO1)(C(C(C=C)=O)O)O)=O,,,5,1,3,0,3
13995_1,,,,2,2,1,3
13997_0,,,,2,2,1,3
C1(CC(CO1)(C(C(C=C)=O)O)O)=O,,,5,1,2,0,2
13997_1,,,,2,2,1,3
13999_0,,,,2,2,1,3
C(C(C=CC=O)(C(C(C=C)=O)O)O)=O,,,5,1,3,0,3
13999_1,,,,2,2,1,3
14001_0,,,,2,2,1,3
C=CC(C(C(C(C=CC=O)=O)O)O)=O,,,5,1,4,0,4
14001_1,,,,2,2,1,3
14003_0,,,,2,2,1,3
C=CC(C(C(C=CC(C=O)=O)O)O)=O,,,5,1,2,0,2
14003_1,,,,2,2,1,3
14005_0,,,,2,2,1,3
C=CC(C(C(C(C=O)=CC=O)O)O)=O,,,5,1,2,0,2
14005_1,,,,2,2,1,3
14007_0,,,,2,2,1,3
C=CC(C(C(C=C(C=O)C=O)O)O)=O,,,5,1,2,0,2
14007_1,,,,2,2,1,3
14009_0,,,,2,2,1,3
C=CC(C(C(C=C(C=O)C)O)O)=O,,,5,1,2,0,2
14009_1,,,,2,2,1,3
14011_0,,,,2,2,1,3
C=CC(C(C(C(C)=CC=O)O)O)=O,,,5,1,2,0,2
14011_1,,,,2,2,1,3
14013_0,,,,2,2,1,3
C=CC(C(C(CC(C=O)=C)O)O)=O,,,5,1,2,0,2
14013_1,,,,2,2,1,3
14015_0,,,,2,2,1,3
C(CC(C(C(C(C=C)=O)O)O)=C)=O,,,5,1,2,0,2
14015_1,,,,2,2,1,3
14017_0,,,,2,2,1,3
C=CC(C(C(C=CC(C)=O)O)O)=O,,,5,1,2,0,2
14017_1,,,,2,2,1,3
14019_0,,,,2,2,1,3
C(C(C)(C(C(C=C)=O)O)O)=CC=O,,,5,1,2,0,2
14019_1,,,,2,2,1,3
14021_0,,,,2,2,1,3
C(C(CC=C)(C(C(C=C)=O)O)O)=O,,,5,1,2,0,2
14021_1,,,,2,2,1,3
14023_0,,,,2,2,1,3
C(C(C(C(C=C)=O)O)O)(CC=C)=O,,,5,1,2,0,2
14023_1,,,,2,2,1,3
14025_0,,,,2,2,1,3
C(C(C=CC)(C(C(C=C)=O)O)O)=O,,,5,1,2,0,2
14025_1,,,,2,2,1,3
14027_0,,,,2,2,1,3
C=CC(C(C(C(C=CC)=O)O)O)=O,,,5,1,2,0,2
14027_1,,,,2,2,1,3
14029_0,,,,2,2,1,3
C(CC=CC(C(C(C=C)=O)O)O)=O,,,5,1,2,0,2
14029_1,,,,2,2,1,3
14031_0,,,,2,2,1,3
C(CC(C(C(C=C)=O)O)O)=CC=O,,,5,1,2,0,2
14031_1,,,,2,2,1,3
14033_0,,,,2,2,1,3
C(C(C=C)C(C(C(C=C)=O)O)O)=O,,,5,1,3,0,3
14033_1,,,,2,2,1,3
14035_0,,,,2,2,1,3
C=CC(C(C(C(C=O)=CC)O)O)=O,,,5,1,2,0,2
14035_1,,,,2,2,1,3
14037_0,,,,2,2,1,3
C=C(C=O)C(C(C(C=C)=O)O)O,,,5,1,2,0,2
14037_1,,,,2,2,1,3
14039_0,,,,2,2,1,3
C=CC(C(C(C=CC)O)O)=O,,,5,1,2,0,2
14039_1,,,,2,2,1,3
14041_0,,,,2,2,1,3
C(CC(C(C(C=C)=O)O)O)=C,,,5,1,2,0,2
14041_1,,,,2,2,1,3
14043_0,,,,2,2,1,3
C=CC(C(C(C(C=C)=O)O)O)O,,,5,1,2,0,2
14043_1,,,,2,2,1,3
14045_0,,,,2,2,1,3
C=CC(C(C(C=C)=O)O)O,,,5,1,2,0,2
14045_1,,,,2,2,1,3
14047_0,,,,2,2,1,3
C1C(COC=1)(C(C(C=C)=O)O)O,,,5,1,2,0,2
14047_1,,,,2,2,1,3
14049_0,,,,2,2,1,3
C=CC(C(C(C(CO)O)O)O)=O,,,5,1,5,0,5
14049_1,,,,2,2,1,3
14050_0,,,,2,2,1,3
14050_1,,,,2,2,1,3
14052_0,,,,2,2,1,3
C=CC(C(C(CO)(CO)O)O)=O,,,5,1,5,0,5
14052_1,,,,2,2,1,3
14054_0,,,,2,2,1,3
C(C(C)(C(C(C=C)=O)O)O)=O,,,5,1,4,0,4
14054_1,,,,2,2,1,3
14055_0,,,,2,2,1,3
14055_1,,,,2,2,1,3
14057_0,,,,2,2,1,3
C(CC(C(C(C=C)=O)O)O)=O,,,5,1,4,0,4
14057_1,,,,2,2,1,3
14058_0,,,,2,2,1,3
14058_1,,,,2,2,1,3
14059_0,,,,2,2,1,3
14059_1,,,,2,2,1,3
14060_0,,,,2,2,1,3
14060_1,,,,2,2,1,3
14062_0,,,,2,2,1,3
C(C(CC(C(C(C=C)=O)O)O)O)=O,,,5,1,2,0,2
14062_1,,,,2,2,1,3
14064_0,,,,2,2,1,3
C(CO)(CC(C(C(C=C)=O)O)O)=O,,,5,1,3,0,3
14064_1,,,,2,2,1,3
14066_0,,,,2,2,1,3
C(CC(CO)(C(C(C=C)=O)O)O)=O,,,5,1,3,0,3
14066_1,,,,2,2,1,3
14068_0,,,,2,2,1,3
C(C)(C(C(C(C(C=C)=O)O)O)O)=O,,,5,1,4,0,4
14068_1,,,,2,2,1,3
14070_0,,,,2,2,1,3
C(C(C(C)(C(C(C=C)=O)O)O)O)=O,,,5,1,2,0,2
14070_1,,,,2,2,1,3
14072_0,,,,2,2,1,3
C=CC(C(C(C)O)O)=O,,,5,1,3,0,3
14072_1,,,,2,2,1,3
14074_0,,,,2,2,1,3
C(C(CO)C(C(C(C=C)=O)O)O)=O,,,5,1,4,0,4
14074_1,,,,2,2,1,3
14076_0,,,,2,2,1,3
C=CC(C(C(CC(C)O)O)O)=O,,,5,1,3,0,3
14076_1,,,,2,2,1,3
14078_0,,,,2,2,1,3
C=CC(C(C(C(C(C)O)O)O)O)=O,,,5,1,2,0,2
14078_1,,,,2,2,1,3
14080_0,,,,2,2,1,3
C=CC(C(C(CCO)O)O)=O,,,5,1,3,0,3
14080_1,,,,2,2,1,3
14082_0,,,,2,2,1,3
C=CC(C(C(CC(CO)O)O)O)=O,,,5,1,2,0,2
14082_1,,,,2,2,1,3
14083_0,,,,2,2,1,3
14083_1,,,,2,2,1,3
14084_0,,,,2,2,1,3
14084_1,,,,2,2,1,3
14085_0,,,,2,2,1,3
14085_1,,,,2,2,1,3
14087_0,,,,2,2,1,3
C(CO)(C(C)(C(C(C=C)=O)O)O)=O,,,5,1,4,0,4
14087_1,,,,2,2,1,3
14088_0,,,,2,2,1,3
14088_1,,,,2,2,1,3
14089_0,,,,2,2,1,3
14089_1,,,,2,2,1,3
14091_0,,,,2,2,1,3
C=CC(C(C(CO)(C)O)O)=O,,,5,1,3,0,3
14091_1,,,,2,2,1,3
14093_0,,,,2,2,1,3
C=CC(C(C(CO)(CCO)O)O)=O,,,5,1,3,0,3
14093_1,,,,2,2,1,3
14095_0,,,,2,2,1,3
C=CC(C(C(C(CCO)O)O)O)=O,,,5,1,2,0,2
14095_1,,,,2,2,1,3
14097_0,,,,2,2,1,3
C=CC(C(C(C)(C(CO)O)O)O)=O,,,5,1,2,0,2
14097_1,,,,2,2,1,3
14098_0,,,,2,2,1,3
14098_1,,,,2,2,1,3
14099_0,,,,2,2,1,3
14099_1,,,,2,2,1,3
14101_0,,,,2,2,1,3
C(CC(C(C(C=C)=O)O)O)(O)=O,,,5,1,3,0,3
14101_1,,,,2,2,1,3
14103_0,,,,2,2,1,3
C=CC(C(C1(COCC1O)O)O)=O,,,5,1,2,0,2
14103_1,,,,2,2,1,3
14105_0,,,,2,2,1,3
C=CC(C(C1(C(O)OCC1)O)O)=O,,,5,1,3,0,3
14105_1,,,,2,2,1,3
14107_0,,,,2,2,1,3
C=CC(C(C1(COC(C1)O)O)O)=O,,,5,1,2,0,2
14107_1,,,,2,2,1,3
14109_0,,,,2,2,1,3
C(C(C=C)(C(C(C=C)=O)O)O)=O,,,5,1,6,0,6
14109_1,,,,2,2,1,3
14111_0,,,,2,2,1,3
C=CC(C(C(C(C=C)=O)O)O)=O,,,5,1,3,0,3
14111_1,,,,2,2,1,3
14113_0,,,,2,2,1,3
C=CC(C(C(C=CC=O)O)O)=O,,,5,1,3,0,3
14113_1,,,,2,2,1,3
14115_0,,,,2,2,1,3
C=CC(C(CO)O)=O,,,5,1,8,0,8
14115_1,,,,2,2,1,3
14117_0,,,,2,2,1,3
C=CC(C(C(CO)O)O)=O,,,5,1,7,0,7
14117_1,,,,2,2,1,3
14119_0,,,,2,2,1,3
C(CO)=CC(C(C(C=O)=O)C)O,,,5,1,1,0,1
14121_0,,,,2,2,1,3
C(CC(C=O)C(C=CCO)O)=O,,,5,1,1,0,1
14123_0,,,,2,2,1,3
C(C(CC(C(C)=O)=O)O)=CCO,,,5,1,1,0,1
14125_0,,,,2,2,1,3
C(CO)=CC(C(C(C(O)=O)=O)C)O,,,5,1,1,0,1
14127_0,,,,2,2,1,3
C(C(C(C)=O)C(C=CCO)O)(O)=O,,,5,1,2,0,2
14127_1,,,,2,2,1,3
14129_0,,,,2,2,1,3
C(CC(CC(C=CCO)O)=O)(O)=O,,,5,1,1,0,1
14131_0,,,,2,2,1,3
C(CO)=CC(C1C(C(OC1)=O)=O)O,,,5,1,2,0,2
14131_1,,,,2,2,1,3
14133_0,,,,2,2,1,3
C1(C(C(CO1)=O)C(C=CCO)O)=O,,,5,1,2,0,2
14133_1,,,,2,2,1,3
14135_0,,,,2,2,1,3
C1(CC(C(C(C=CCO)O)O1)=O)=O,,,5,1,2,0,2
14135_1,,,,2,2,1,3
14137_0,,,,2,2,1,3
C(C(C(C=O)=C)C(C=CCO)O)=O,,,5,1,1,0,1
14139_0,,,,2,2,1,3
C(C(CC(C=CC=O)=O)O)=CCO,,,5,1,1,0,1
14141_0,,,,2,2,1,3
C=CC(C(C=O)=O)C(C=CCO)O,,,5,1,1,0,1
14143_0,,,,2,2,1,3
C(C(C=CC=O)C(C=CCO)O)=O,,,5,1,1,0,1
14145_0,,,,2,2,1,3
C(C(C=C)C(C=CCO)O)=O,,,5,1,1,0,1
14147_0,,,,2,2,1,3
C1OC(C(C=1)=O)C(C=CCO)O,,,5,1,2,0,2
14147_1,,,,2,2,1,3
14149_0,,,,2,2,1,3
C(CO)(C(C(C=CCO)O)O)=O,,,5,1,5,0,5
14149_1,,,,2,2,1,3
14151_0,,,,2,2,1,3
C(C(CC(C=O)=O)O)=CCO,,,5,1,4,0,4
14153_0,,,,2,2,1,3
C(C(C=O)C(C=CCO)O)=O,,,5,1,5,0,5
14153_1,,,,2,2,1,3
14155_0,,,,2,2,1,3
C(CO)=CC(C(C(C=O)=O)CO)O,,,5,1,3,0,3
14155_1,,,,2,2,1,3
14157_0,,,,2,2,1,3
C(C(C(C=O)C(C=CCO)O)O)=O,,,5,1,3,0,3
14157_1,,,,2,2,1,3
14159_0,,,,2,2,1,3
C(C(C(CO)=O)C(C=CCO)O)=O,,,5,1,3,0,3
14159_1,,,,2,2,1,3
14161_0,,,,2,2,1,3
C(CC(C(C(C=CCO)O)O)=O)=O,,,5,1,3,0,3
14161_1,,,,2,2,1,3
14163_0,,,,2,2,1,3
C(C(C(CC(C=CCO)O)=O)O)=O,,,5,1,2,0,2
14165_0,,,,2,2,1,3
C(CC(C=CCO)O)=O,,,5,1,4,0,4
14167_0,,,,2,2,1,3
C(C(C(C)O)C(C=CCO)O)=O,,,5,1,5,0,5
14167_1,,,,2,2,1,3
14169_0,,,,2,2,1,3
C(C(CO)C(C=CCO)O)=O,,,5,1,5,0,5
14169_1,,,,2,2,1,3
14171_0,,,,2,2,1,3
C(C(C(CO)O)C(C=CCO)O)=O,,,5,1,3,0,3
14171_1,,,,2,2,1,3
14173_0,,,,2,2,1,3
C(C(C(C(C=O)=O)O)O)=CCO,,,5,1,5,0,5
14173_1,,,,2,2,1,3
14175_0,,,,2,2,1,3
C(CO)=CC(C(C(C(C)=O)=O)O)O,,,5,1,3,0,3
14175_1,,,,2,2,1,3
14177_0,,,,2,2,1,3
C(CO)=CC(CC(C(CO)=O)=O)O,,,5,1,2,0,2
14179_0,,,,2,2,1,3
C(C)(C(C(C=CCO)O)O)=O,,,5,1,5,0,5
14179_1,,,,2,2,1,3
14181_0,,,,2,2,1,3
C(CO)(CC(C=CCO)O)=O,,,5,1,4,0,4
14183_0,,,,2,2,1,3
C(C(C(C=CCO)O)O)(CCO)=O,,,5,1,3,0,3
14183_1,,,,2,2,1,3
14185_0,,,,2,2,1,3
C(CO)(C(CO)C(C=CCO)O)=O,,,5,1,3,0,3
14185_1,,,,2,2,1,3
14187_0,,,,2,2,1,3
C(CC(C=CCO)O)(C(CO)O)=O,,,5,1,2,0,2
14189_0,,,,2,2,1,3
C(C(CC(C(O)=O)=O)O)=CCO,,,5,1,4,0,4
14191_0,,,,2,2,1,3
C(C(C=O)C(C=CCO)O)(O)=O,,,5,1,5,0,5
14191_1,,,,2,2,1,3
14193_0,,,,2,2,1,3
C1(C(C(C=CCO)O)OCC1O)=O,,,5,1,3,0,3
14193_1,,,,2,2,1,3
14195_0,,,,2,2,1,3
C1(C(O)OCC1C(C=CCO)O)=O,,,5,1,3,0,3
14195_1,,,,2,2,1,3
14197_0,,,,2,2,1,3
C1(COC(C1C(C=CCO)O)O)=O,,,5,1,3,0,3
14197_1,,,,2,2,1,3
14199_0,,,,2,2,1,3
C1(C(C(C=CCO)O)OC(C1)O)=O,,,5,1,3,0,3
14199_1,,,,2,2,1,3
14201_0,,,,2,2,1,3
C(C(C(C=CCO)O)O)=O,,,5,1,5,0,5
14201_1,,,,2,2,1,3
14203_0,,,,2,2,1,3
C(CC(C)(C(CC=O)O)O)(O)=O,,,5,1,2,0,2
14205_0,,,,2,2,1,3
C(CC(C)(C(C(C=O)O)O)O)(O)=O,,,5,1,3,0,3
14205_1,,,,2,2,1,3
14207_0,,,,2,2,1,3
C(CC(C(C)(CC=O)O)O)(O)=O,,,5,1,2,0,2
14209_0,,,,2,2,1,3
C(CC(C(C)(C(C=O)O)O)O)(O)=O,,,5,1,3,0,3
14209_1,,,,2,2,1,3
14211_0,,,,2,2,1,3
C(CC(C(CC(C=C)O)=O)O)(O)=O,,,5,1,1,0,1
14213_0,,,,2,2,1,3
C(CC(C(CC(C=O)O)=O)O)(O)=O,,,5,1,2,0,2
14215_0,,,,2,2,1,3
C(CC(C(CC(C)O)=O)O)(O)=O,,,5,1,2,0,2
14216_0,,,,2,2,1,3
14218_0,,,,2,2,1,3
C(CC(C(CC(CO)O)=O)O)(O)=O,,,5,1,2,0,2
14220_0,,,,2,2,1,3
C(CC(C(C(CO)CO)=O)O)(O)=O,,,5,1,3,0,3
14220_1,,,,2,2,1,3
14222_0,,,,2,2,1,3
C(C(CO)C(C(CC=O)O)O)(O)=O,,,5,1,5,0,5
14223_0,,,,2,2,1,3
14225_0,,,,2,2,1,3
C(C(CO)(C(C)(CC=O)O)O)(O)=O,,,5,1,6,0,6
14227_0,,,,2,2,1,3
C(C(C(CC(C)O)=O)(CO)O)(O)=O,,,5,1,6,0,6
14228_0,,,,2,2,1,3
14229_0,,,,2,2,1,3
14229_1,,,,2,2,1,3
14231_0,,,,2,2,1,3
C(C(CO)(CC(CC=O)O)O)(O)=O,,,5,1,4,0,4
14232_0,,,,2,2,1,3
14232_1,,,,2,2,1,3
14233_0,,,,2,2,1,3
14233_1,,,,2,2,1,3
14235_0,,,,2,2,1,3
C(CC(CO)(C(CC=O)O)O)(O)=O,,,5,1,3,0,3
14237_0,,,,2,2,1,3
C(C(C=C)(C(C(C=O)=O)C)O)(O)=O,,,5,1,1,0,1
14239_0,,,,2,2,1,3
C(C(C=C)(C(C=O)CC=O)O)(O)=O,,,5,1,2,0,2
14241_0,,,,2,2,1,3
C(C(C=C)(CC(C(C)=O)=O)O)(O)=O,,,5,1,1,0,1
14243_0,,,,2,2,1,3
C(C(C(C=O)=C)C(C(O)=O)(C=C)O)=O,,,5,1,1,0,1
14245_0,,,,2,2,1,3
C(C(C=C)(CC(C=CC=O)=O)O)(O)=O,,,5,1,1,0,1
14247_0,,,,2,2,1,3
C(C(C=C)(C(C=C)C(C=O)=O)O)(O)=O,,,5,1,1,0,1
14249_0,,,,2,2,1,3
C(C(C=CC=O)C(C(O)=O)(C=C)O)=O,,,5,1,1,0,1
14251_0,,,,2,2,1,3
C(C(C=C)C(C(O)=O)(C=C)O)=O,,,5,1,1,0,1
14253_0,,,,2,2,1,3
C(C(C=C)(C1C(C=CO1)=O)O)(O)=O,,,5,1,2,0,2
14253_1,,,,2,2,1,3
14255_0,,,,2,2,1,3
C(C(C=C)(C(C(CO)=O)O)O)(O)=O,,,5,1,4,0,4
14255_1,,,,2,2,1,3
14257_0,,,,2,2,1,3
C(C(C=C)(CC(C=O)=O)O)(O)=O,,,5,1,3,0,3
14259_0,,,,2,2,1,3
C(C(C=C)(C(C=O)C=O)O)(O)=O,,,5,1,4,0,4
14259_1,,,,2,2,1,3
14261_0,,,,2,2,1,3
C(C(C=C)(CC=O)O)(O)=O,,,5,1,5,0,5
14263_0,,,,2,2,1,3
C(C(C=C)(C(C=O)C(C)O)O)(O)=O,,,5,1,3,0,3
14263_1,,,,2,2,1,3
14265_0,,,,2,2,1,3
C(C(C=C)(C(C=O)CO)O)(O)=O,,,5,1,4,0,4
14265_1,,,,2,2,1,3
14267_0,,,,2,2,1,3
C(C(C=C)(C(C(C=O)=O)O)O)(O)=O,,,5,1,3,0,3
14267_1,,,,2,2,1,3
14269_0,,,,2,2,1,3
C(C(C=C)(C(C(C)=O)O)O)(O)=O,,,5,1,6,0,6
14269_1,,,,2,2,1,3
14271_0,,,,2,2,1,3
C(C(C=C)(CC(CO)=O)O)(O)=O,,,5,1,4,0,4
14273_0,,,,2,2,1,3
C(C(C=C)(CC(C(O)=O)=O)O)(O)=O,,,5,1,2,0,2
14275_0,,,,2,2,1,3
C(C(C=O)C(C(O)=O)(C=C)O)(O)=O,,,5,1,3,0,3
14275_1,,,,2,2,1,3
14277_0,,,,2,2,1,3
C(C(C=C)(C(C=O)O)O)(O)=O,,,5,1,6,0,6
14277_1,,,,2,2,1,3
14279_0,,,,2,2,1,3
C(C(C(C(C=O)=O)C)O)=CC(O)=O,,,5,1,1,0,1
14281_0,,,,2,2,1,3
C(CC(C=O)C(C=CC(O)=O)O)=O,,,5,1,2,0,2
14283_0,,,,2,2,1,3
C(C(CC(C(C)=O)=O)O)=CC(O)=O,,,5,1,1,0,1
14285_0,,,,2,2,1,3
C(C(C(C=O)=C)C(C=CC(O)=O)O)=O,,,5,1,1,0,1
14287_0,,,,2,2,1,3
C(C(CC(C=CC=O)=O)O)=CC(O)=O,,,5,1,1,0,1
14289_0,,,,2,2,1,3
C=CC(C(C=O)=O)C(C=CC(O)=O)O,,,5,1,1,0,1
14291_0,,,,2,2,1,3
C(C(C=CC=O)C(C=CC(O)=O)O)=O,,,5,1,1,0,1
14293_0,,,,2,2,1,3
C(C(C=C)C(C=CC(O)=O)O)=O,,,5,1,1,0,1
14295_0,,,,2,2,1,3
C1OC(C(C=1)=O)C(C=CC(O)=O)O,,,5,1,2,0,2
14295_1,,,,2,2,1,3
14297_0,,,,2,2,1,3
C(CO)(C(C(C=CC(O)=O)O)O)=O,,,5,1,3,0,3
14297_1,,,,2,2,1,3
14299_0,,,,2,2,1,3
C(C(CC(C=O)=O)O)=CC(O)=O,,,5,1,4,0,4
14301_0,,,,2,2,1,3
C(C(C=O)C(C=CC(O)=O)O)=O,,,5,1,5,0,5
14301_1,,,,2,2,1,3
14303_0,,,,2,2,1,3
C(CC(C=CC(O)=O)O)=O,,,5,1,4,0,4
14305_0,,,,2,2,1,3
C(C(C(C)O)C(C=CC(O)=O)O)=O,,,5,1,3,0,3
14305_1,,,,2,2,1,3
14307_0,,,,2,2,1,3
C(C(CO)C(C=CC(O)=O)O)=O,,,5,1,5,0,5
14307_1,,,,2,2,1,3
14309_0,,,,2,2,1,3
C(C(C(C(C=O)=O)O)O)=CC(O)=O,,,5,1,3,0,3
14309_1,,,,2,2,1,3
14311_0,,,,2,2,1,3
C(C)(C(C(C=CC(O)=O)O)O)=O,,,5,1,5,0,5
14311_1,,,,2,2,1,3
14313_0,,,,2,2,1,3
C(CO)(CC(C=CC(O)=O)O)=O,,,5,1,4,0,4
14315_0,,,,2,2,1,3
C(C(CC(C(O)=O)=O)O)=CC(O)=O,,,5,1,2,0,2
14317_0,,,,2,2,1,3
C(C(C=O)C(C=CC(O)=O)O)(O)=O,,,5,1,3,0,3
14317_1,,,,2,2,1,3
14319_0,,,,2,2,1,3
C(C(C(C=CC(O)=O)O)O)=O,,,5,1,5,0,5
14319_1,,,,2,2,1,3
14321_0,,,,2,2,1,3
C(C1(C(C(C(C1O)=O)CO)O)O)=O,,,5,1,4,0,4
14321_1,,,,2,2,1,3
14322_0,,,,2,2,1,3
14322_1,,,,2,2,1,3
14324_0,,,,2,2,1,3
C(C(CO)(C(CC=O)O)C(C)O)=O,,,5,1,5,0,5
14326_0,,,,2,2,1,3
C(C(CO)(CO)C(CC=O)O)=O,,,5,1,4,0,4
14328_0,,,,2,2,1,3
C(C(CO)(CO)C(C(C=O)O)O)=O,,,5,1,4,0,4
14328_1,,,,2,2,1,3
14329_0,,,,2,2,1,3
14329_1,,,,2,2,1,3
14330_0,,,,2,2,1,3
14330_1,,,,2,2,1,3
14332_0,,,,2,2,1,3
C(CC(C(C(C)O)(C(C)O)O)O)=O,,,5,1,1,0,1
14334_0,,,,2,2,1,3
C1(C(COC1CO)(C(C=O)O)O)=O,,,5,1,4,0,4
14334_1,,,,2,2,1,3
14336_0,,,,2,2,1,3
C(CC1(COCC1(C(C)O)O)O)=O,,,5,1,1,0,1
14338_0,,,,2,2,1,3
C1(C(C(C)O)OCC1(C(C)O)O)=O,,,5,1,4,0,4
14338_1,,,,2,2,1,3
14340_0,,,,2,2,1,3
C1(C(CO)OCC1(C(C)O)O)=O,,,5,1,4,0,4
14340_1,,,,2,2,1,3
14342_0,,,,2,2,1,3
C(CC1(COCC1(CO)O)O)=O,,,5,1,1,0,1
14344_0,,,,2,2,1,3
C(C(C1(COCC1(CO)O)O)O)=O,,,5,1,2,0,2
14344_1,,,,2,2,1,3
14346_0,,,,2,2,1,3
C1(C(C(C=C)O)OCC1(CO)O)=O,,,5,1,2,0,2
14346_1,,,,2,2,1,3
14348_0,,,,2,2,1,3
C(C(C1C(C(CO)(CO1)O)=O)O)=O,,,5,1,4,0,4
14348_1,,,,2,2,1,3
14350_0,,,,2,2,1,3
C1(C(C(C)O)OCC1(CO)O)=O,,,5,1,4,0,4
14350_1,,,,2,2,1,3
14352_0,,,,2,2,1,3
C1(C(CO)OCC1(CO)O)=O,,,5,1,5,0,5
14352_1,,,,2,2,1,3
14354_0,,,,2,2,1,3
C1(C(C(CO)O)OCC1(CO)O)=O,,,5,1,4,0,4
14354_1,,,,2,2,1,3
14356_0,,,,2,2,1,3
C1(C(CO)OCC1(C(CO)O)O)=O,,,5,1,4,0,4
14356_1,,,,2,2,1,3
14357_0,,,,2,2,1,3
14357_1,,,,2,2,1,3
14359_0,,,,2,2,1,3
C(CC(C1(CC(CC1O)O)O)O)=O,,,5,1,1,0,1
14361_0,,,,2,2,1,3
C(C(CO)C(C(C)=O)(C(C)O)O)=O,,,5,1,4,0,4
14361_1,,,,2,2,1,3
14362_0,,,,2,2,1,3
14363_0,,,,2,2,1,3
14363_1,,,,2,2,1,3
14365_0,,,,2,2,1,3
C(C(C(C)(C(C)O)O)(CC=O)O)=O,,,5,1,1,0,1
14367_0,,,,2,2,1,3
C(CC(C(C(C)(C(C)O)O)=O)O)=O,,,5,1,2,0,2
14368_0,,,,2,2,1,3
14369_0,,,,2,2,1,3
14369_1,,,,2,2,1,3
14371_0,,,,2,2,1,3
C(CC(C(C(CO)(C)O)=O)O)=O,,,5,1,4,0,4
14373_0,,,,2,2,1,3
C(C(C(C=O)O)O)(C(CO)(C)O)=O,,,5,1,3,0,3
14373_1,,,,2,2,1,3
14375_0,,,,2,2,1,3
C(C(C1(C(C(CO)CO1)=O)O)O)=O,,,5,1,3,0,3
14375_1,,,,2,2,1,3
14377_0,,,,2,2,1,3
C(CC1(CCOC1(C(C)O)O)O)=O,,,5,1,1,0,1
14379_0,,,,2,2,1,3
C1(C(C(C)O)(O)OCC1C(C)O)=O,,,5,1,3,0,3
14379_1,,,,2,2,1,3
14381_0,,,,2,2,1,3
C1(C(C(C)O)(O)OCC1CO)=O,,,5,1,3,0,3
14381_1,,,,2,2,1,3
14383_0,,,,2,2,1,3
C(CC1(CCOC1(CO)O)O)=O,,,5,1,1,0,1
14385_0,,,,2,2,1,3
C(C(C1(C(CO)(O)OCC1)O)O)=O,,,5,1,2,0,2
14385_1,,,,2,2,1,3
14387_0,,,,2,2,1,3
C1(C(CO)(O)OCC1C(C=C)O)=O,,,5,1,2,0,2
14387_1,,,,2,2,1,3
14389_0,,,,2,2,1,3
C1(C(CO)(O)OCC1C(C=O)O)=O,,,5,1,3,0,3
14389_1,,,,2,2,1,3
14391_0,,,,2,2,1,3
C1(C(CO)(O)OCC1C(C)O)=O,,,5,1,3,0,3
14391_1,,,,2,2,1,3
14393_0,,,,2,2,1,3
C1(C(CO)(O)OCC1CO)=O,,,5,1,5,0,5
14393_1,,,,2,2,1,3
14395_0,,,,2,2,1,3
C1(C(CO)(O)OCC1C(CO)O)=O,,,5,1,3,0,3
14395_1,,,,2,2,1,3
14397_0,,,,2,2,1,3
C1(C(C(CO)O)(O)OCC1CO)=O,,,5,1,3,0,3
14397_1,,,,2,2,1,3
14399_0,,,,2,2,1,3
C(C(C=C)C(COC(CO)=O)O)=O,,,5,1,1,0,1
14401_0,,,,2,2,1,3
C(CO)(OCC(CC(C=O)=O)O)=O,,,5,1,1,0,1
14403_0,,,,2,2,1,3
C(C(C=O)C(COC(CO)=O)O)=O,,,5,1,2,0,2
14403_1,,,,2,2,1,3
14405_0,,,,2,2,1,3
C(CC(COC(CO)=O)O)=O,,,5,1,3,0,3
14407_0,,,,2,2,1,3
C(C(CO)C(COC(CO)=O)O)=O,,,5,1,2,0,2
14407_1,,,,2,2,1,3
14409_0,,,,2,2,1,3
C(C)(C(C(COC(CO)=O)O)O)=O,,,5,1,2,0,2
14409_1,,,,2,2,1,3
14411_0,,,,2,2,1,3
C(CO)(CC(COC(CO)=O)O)=O,,,5,1,1,0,1
14412_0,,,,2,2,1,3
14412_1,,,,2,2,1,3
14414_0,,,,2,2,1,3
C(CO)(OC(C=O)C(C=CC)O)=O,,,5,1,2,0,2
14414_1,,,,2,2,1,3
14416_0,,,,2,2,1,3
C(C(C(CC=C)O)OC(CO)=O)=O,,,5,1,2,0,2
14416_1,,,,2,2,1,3
14418_0,,,,2,2,1,3
C(CO)(OC(C=O)C(C=C)O)=O,,,5,1,2,0,2
14418_1,,,,2,2,1,3
14420_0,,,,2,2,1,3
C(CO)(OC(C=O)C(C=O)O)=O,,,5,1,2,0,2
14420_1,,,,2,2,1,3
14422_0,,,,2,2,1,3
C(CO)(OC(C=O)C(C=O)(C)O)=O,,,5,1,2,0,2
14422_1,,,,2,2,1,3
14424_0,,,,2,2,1,3
C(CO)(OC(C=O)C(C(C)=O)O)=O,,,5,1,2,0,2
14424_1,,,,2,2,1,3
14426_0,,,,2,2,1,3
C(CC(C(C=O)OC(CO)=O)O)=O,,,5,1,2,0,2
14426_1,,,,2,2,1,3
14428_0,,,,2,2,1,3
C(C(C(C)O)OC(CO)=O)=O,,,5,1,2,0,2
14428_1,,,,2,2,1,3
14430_0,,,,2,2,1,3
C(C(C(CCO)O)OC(CO)=O)=O,,,5,1,2,0,2
14430_1,,,,2,2,1,3
14432_0,,,,2,2,1,3
C(C(C(CO)(C)O)OC(CO)=O)=O,,,5,1,2,0,2
14432_1,,,,2,2,1,3
14434_0,,,,2,2,1,3
C(CO)(OC(C=O)C(C(O)=O)O)=O,,,5,1,2,0,2
14434_1,,,,2,2,1,3
14435_0,,,,2,2,1,3
14435_1,,,,2,2,1,3
14436_0,,,,2,2,1,3
14436_1,,,,2,2,1,3
14438_0,,,,2,2,1,3
C(CC(C(CO)OC(CO)=O)O)=O,,,5,1,3,0,3
14440_0,,,,2,2,1,3
C(CC(C(COC(CO)=O)O)O)=O,,,5,1,3,0,3
14442_0,,,,2,2,1,3
C(C(CO)(CC=O)O)(CC=O)=O,,,5,1,6,0,6
14443_0,,,,2,2,1,3
14443_1,,,,2,2,1,3
14445_0,,,,2,2,1,3
C(CC(C(CO)=O)(CC=O)O)=O,,,5,1,1,0,1
14446_0,,,,2,2,1,3
14446_1,,,,2,2,1,3
14447_0,,,,2,2,1,3
14448_0,,,,2,2,1,3
14448_1,,,,2,2,1,3
14450_0,,,,2,2,1,3
C(CC(C(C(C(C=C)O)O)=O)=O)=O,,,5,1,2,0,2
14450_1,,,,2,2,1,3
14452_0,,,,2,2,1,3
C(CC(C(C(C(C=O)O)O)=O)=O)=O,,,5,1,2,0,2
14452_1,,,,2,2,1,3
14454_0,,,,2,2,1,3
C(CC(C(C(C(C)O)O)=O)=O)=O,,,5,1,5,0,5
14454_1,,,,2,2,1,3
14455_0,,,,2,2,1,3
14455_1,,,,2,2,1,3
14457_0,,,,2,2,1,3
C(CC(C(C(C(CO)O)O)=O)=O)=O,,,5,1,2,0,2
14457_1,,,,2,2,1,3
14459_0,,,,2,2,1,3
C(C(C(C(CO)=O)=O)C(C=C)O)=O,,,5,1,2,0,2
14459_1,,,,2,2,1,3
14461_0,,,,2,2,1,3
C(C(C(C(CO)=O)=O)C(C=O)O)=O,,,5,1,2,0,2
14461_1,,,,2,2,1,3
14463_0,,,,2,2,1,3
C(C(C(C(CO)=O)=O)C(C)O)=O,,,5,1,3,0,3
14463_1,,,,2,2,1,3
14465_0,,,,2,2,1,3
C(C(C(C(CO)=O)=O)CO)=O,,,5,1,5,0,5
14465_1,,,,2,2,1,3
14467_0,,,,2,2,1,3
C(C(C(C(CO)=O)=O)C(CO)O)=O,,,5,1,2,0,2
14467_1,,,,2,2,1,3
14469_0,,,,2,2,1,3
C(C(C(C(C(CO)O)=O)=O)CO)=O,,,5,1,2,0,2
14469_1,,,,2,2,1,3
14471_0,,,,2,2,1,3
C(CC(C(CC(CC=O)O)=O)=O)=O,,,5,1,2,0,2
14473_0,,,,2,2,1,3
C(CC(C(CC=O)(CC=O)O)=O)=O,,,5,1,1,0,1
14475_0,,,,2,2,1,3
C(C(C(C(CC=O)=O)=O)C(C=C)O)=O,,,5,1,2,0,2
14475_1,,,,2,2,1,3
14477_0,,,,2,2,1,3
C(C(C(C(CC=O)=O)=O)C(C)O)=O,,,5,1,2,0,2
14477_1,,,,2,2,1,3
14479_0,,,,2,2,1,3
C(C(C(C(CC=O)=O)=O)CO)=O,,,5,1,4,0,4
14479_1,,,,2,2,1,3
14480_0,,,,2,2,1,3
14482_0,,,,2,2,1,3
C(CC(CC=O)(CC(C=O)=O)O)=O,,,5,1,2,0,2
14483_0,,,,2,2,1,3
14485_0,,,,2,2,1,3
C(CC(CC(C(CC=O)O)=O)=O)=O,,,5,1,1,0,1
14487_0,,,,2,2,1,3
C(C(C(CC(C=O)=O)=O)C(C=C)O)=O,,,5,1,2,0,2
14487_1,,,,2,2,1,3
14489_0,,,,2,2,1,3
C(C(C(CC(C=O)=O)=O)C(C)O)=O,,,5,1,2,0,2
14489_1,,,,2,2,1,3
14491_0,,,,2,2,1,3
C(C(C(CC(C=O)=O)=O)CO)=O,,,5,1,4,0,4
14491_1,,,,2,2,1,3
14493_0,,,,2,2,1,3
C(CC=O)(C(C(C=O)=O)C(C=C)O)=O,,,5,1,2,0,2
14493_1,,,,2,2,1,3
14495_0,,,,2,2,1,3
C(CC=O)(C(C(C=O)=O)C(C)O)=O,,,5,1,2,0,2
14495_1,,,,2,2,1,3
14497_0,,,,2,2,1,3
C(CC=O)(C(C(C=O)=O)CO)=O,,,5,1,4,0,4
14497_1,,,,2,2,1,3
14499_0,,,,2,2,1,3
C(C(C(CO)O)=O)(C(CO)CO)=O,,,5,1,5,0,5
14499_1,,,,2,2,1,3
14501_0,,,,2,2,1,3
C(C(CO)CC(C=O)(CC=O)O)=O,,,5,1,1,0,1
14503_0,,,,2,2,1,3
C(CC(C(CC(C=O)CO)=O)O)=O,,,5,1,1,0,1
14505_0,,,,2,2,1,3
C(CC(C(CO)CC(C=O)=O)O)=O,,,5,1,3,0,3
14507_0,,,,2,2,1,3
C(C(CO)C(C(C=O)=O)C(C)O)=O,,,5,1,1,0,1
14508_0,,,,2,2,1,3
14510_0,,,,2,2,1,3
C(CC(C(C=O)C(C=O)CO)O)=O,,,5,1,5,0,5
14512_0,,,,2,2,1,3
C(C(C=O)C(CO)C(CC=O)O)=O,,,5,1,3,0,3
14514_0,,,,2,2,1,3
C(C(C=C)C(CC(C=O)CO)O)=O,,,5,1,1,0,1
14516_0,,,,2,2,1,3
C(C(CO)CC(CC(C=O)=O)O)=O,,,5,1,1,0,1
14518_0,,,,2,2,1,3
C(C(C=O)C(CC(C=O)CO)O)=O,,,5,1,2,0,2
14518_1,,,,2,2,1,3
14520_0,,,,2,2,1,3
C(C(CO)CC(CC=O)O)=O,,,5,1,2,0,2
14522_0,,,,2,2,1,3
C(C(CO)C(CC(C=O)CO)O)=O,,,5,1,2,0,2
14522_1,,,,2,2,1,3
14524_0,,,,2,2,1,3
C(C(CO)CC(C(C(C)=O)O)O)=O,,,5,1,2,0,2
14524_1,,,,2,2,1,3
14526_0,,,,2,2,1,3
C(C(CO)CC(CC(CO)=O)O)=O,,,5,1,1,0,1
14528_0,,,,2,2,1,3
C(C(CO)CC(C(C=O)O)O)=O,,,5,1,4,0,4
14528_1,,,,2,2,1,3
14530_0,,,,2,2,1,3
C(C(C=C)C(C(CO)CC=O)O)=O,,,5,1,1,0,1
14532_0,,,,2,2,1,3
C(CC(CO)C(CC(C=O)=O)O)=O,,,5,1,4,0,4
14534_0,,,,2,2,1,3
C(C(C=O)C(C(CO)CC=O)O)=O,,,5,1,5,0,5
14534_1,,,,2,2,1,3
14536_0,,,,2,2,1,3
C(CC(C(CO)CC=O)O)=O,,,5,1,4,0,4
14538_0,,,,2,2,1,3
C(C(CO)C(C(CO)CC=O)O)=O,,,5,1,4,0,4
14538_1,,,,2,2,1,3
14540_0,,,,2,2,1,3
C(CC(CO)C(C(C(C)=O)O)O)=O,,,5,1,5,0,5
14540_1,,,,2,2,1,3
14542_0,,,,2,2,1,3
C(CC(CO)C(CC(CO)=O)O)=O,,,5,1,4,0,4
14544_0,,,,2,2,1,3
C(CC(CO)C(C(C=O)O)O)=O,,,5,1,5,0,5
14544_1,,,,2,2,1,3
14546_0,,,,2,2,1,3
C(C(CO)C(C=O)C(C=CC)O)=O,,,5,1,1,0,1
14548_0,,,,2,2,1,3
C(C(C(CC=C)O)C(C=O)CO)=O,,,5,1,1,0,1
14550_0,,,,2,2,1,3
C(C(CO)C(C=O)C(C=C)O)=O,,,5,1,1,0,1
14551_0,,,,2,2,1,3
14553_0,,,,2,2,1,3
C(C(CO)C(C=O)C(C=O)(C)O)=O,,,5,1,3,0,3
14555_0,,,,2,2,1,3
C(C(C(C=O)C(C=O)CO)O)(C)=O,,,5,1,4,0,4
14556_0,,,,2,2,1,3
14558_0,,,,2,2,1,3
C(C(C(C)O)C(C=O)CO)=O,,,5,1,5,0,5
14560_0,,,,2,2,1,3
C(C(C(CCO)O)C(C=O)CO)=O,,,5,1,2,0,2
14562_0,,,,2,2,1,3
C(C(C(C)(CO)O)C(C=O)CO)=O,,,5,1,1,0,1
14564_0,,,,2,2,1,3
C(C(C(C=O)C(C=O)CO)O)(O)=O,,,5,1,4,0,4
14566_0,,,,2,2,1,3
C(C(CO)C(C=O)CO)=O,,,5,1,4,0,4
14568_0,,,,2,2,1,3
C(C(C(CO)O)C(C=O)CO)=O,,,5,1,9,0,9
14570_0,,,,2,2,1,3
C(CC(C(C(C(CO)=O)=O)C)O)=O,,,5,1,2,0,2
14572_0,,,,2,2,1,3
C(C(CO)(CC=O)O)(C(C=O)C)=O,,,5,1,1,0,1
14574_0,,,,2,2,1,3
C(CC(C(CO)=O)(C(C=O)C)O)=O,,,5,1,1,0,1
14576_0,,,,2,2,1,3
C(C(C(C(C(C(C)O)O)=O)=O)C)=O,,,5,1,2,0,2
14576_1,,,,2,2,1,3
14577_0,,,,2,2,1,3
14577_1,,,,2,2,1,3
14579_0,,,,2,2,1,3
C(CO)(CC(C(C)(CC=O)O)=O)=O,,,5,1,1,0,1
14581_0,,,,2,2,1,3
C(CC(C(C)=O)(CC(CO)=O)O)=O,,,5,1,2,0,2
14583_0,,,,2,2,1,3
C(CC(CO)(CC(C(C)=O)=O)O)=O,,,5,1,2,0,2
14585_0,,,,2,2,1,3
C(CO)(CC(C(CC(C)O)=O)=O)=O,,,5,1,1,0,1
14586_0,,,,2,2,1,3
14588_0,,,,2,2,1,3
C(CO)(C(C(C(C)=O)=O)C(C)O)=O,,,5,1,2,0,2
14588_1,,,,2,2,1,3
14589_0,,,,2,2,1,3
14589_1,,,,2,2,1,3
14591_0,,,,2,2,1,3
C(C(C(C)O)O)(CC(C(C)=O)=O)=O,,,5,1,2,0,2
14591_1,,,,2,2,1,3
14592_0,,,,2,2,1,3
14592_1,,,,2,2,1,3
14593_0,,,,2,2,1,3
14595_0,,,,2,2,1,3
C(C)(CC(C(CO)(CC=O)O)=O)=O,,,5,1,1,0,1
14597_0,,,,2,2,1,3
C(CC(C(CO)=O)(CC(C)=O)O)=O,,,5,1,1,0,1
14599_0,,,,2,2,1,3
C(C)(C(C(C(CO)=O)=O)C(C)O)=O,,,5,1,2,0,2
14599_1,,,,2,2,1,3
14601_0,,,,2,2,1,3
C(C)(C(C(C(CO)=O)=O)CO)=O,,,5,1,3,0,3
14601_1,,,,2,2,1,3
14603_0,,,,2,2,1,3
C(CC(C)O)(CC(C(CO)=O)=O)=O,,,5,1,1,0,1
14604_0,,,,2,2,1,3
14606_0,,,,2,2,1,3
C(C)(CC(C(C(C(C)O)O)=O)=O)=O,,,5,1,2,0,2
14606_1,,,,2,2,1,3
14607_0,,,,2,2,1,3
14607_1,,,,2,2,1,3
14609_0,,,,2,2,1,3
C(CC(CC=O)(CC(CO)=O)O)=O,,,5,1,2,0,2
14611_0,,,,2,2,1,3
C(CC(CC(CC(CO)=O)=O)O)=O,,,5,1,2,0,2
14612_0,,,,2,2,1,3
14614_0,,,,2,2,1,3
C(C(C(CC(CO)=O)=O)C(C)O)=O,,,5,1,2,0,2
14614_1,,,,2,2,1,3
14615_0,,,,2,2,1,3
14615_1,,,,2,2,1,3
14617_0,,,,2,2,1,3
C(CC=O)(C(C(CO)=O)C(C)O)=O,,,5,1,2,0,2
14617_1,,,,2,2,1,3
14618_0,,,,2,2,1,3
14618_1,,,,2,2,1,3
14620_0,,,,2,2,1,3
C(CC(CC(C(C(C)O)O)=O)=O)=O,,,5,1,2,0,2
14620_1,,,,2,2,1,3
14621_0,,,,2,2,1,3
14621_1,,,,2,2,1,3
14623_0,,,,2,2,1,3
C(CC(CCC(C(CO)=O)=O)O)=O,,,5,1,1,0,1
14625_0,,,,2,2,1,3
C(CCC=O)(C(CO)(CC=O)O)=O,,,5,1,1,0,1
14627_0,,,,2,2,1,3
C(CO)(C(CCC=O)(CC=O)O)=O,,,5,1,2,0,2
14629_0,,,,2,2,1,3
C(C(C(C)O)CC(C(CO)=O)=O)=O,,,5,1,1,0,1
14631_0,,,,2,2,1,3
C(C(CO)CC(C(CO)=O)=O)=O,,,5,1,4,0,4
14633_0,,,,2,2,1,3
C(CCC(C(C(C(C)O)O)=O)=O)=O,,,5,1,2,0,2
14633_1,,,,2,2,1,3
14634_0,,,,2,2,1,3
14634_1,,,,2,2,1,3
14636_0,,,,2,2,1,3
C(CC(C(C(CO)=O)=O)C(C)O)=O,,,5,1,1,0,1
14637_0,,,,2,2,1,3
14639_0,,,,2,2,1,3
C(C(C=C)C(C)(CC(CO)=O)O)=O,,,5,1,1,0,1
14640_0,,,,2,2,1,3
14641_0,,,,2,2,1,3
14641_1,,,,2,2,1,3
14642_0,,,,2,2,1,3
14644_0,,,,2,2,1,3
C(C(CO)C(C)(CC(CO)=O)O)=O,,,5,1,3,0,3
14644_1,,,,2,2,1,3
14646_0,,,,2,2,1,3
C(C)(C(C(C)(CC(CO)=O)O)O)=O,,,5,1,2,0,2
14646_1,,,,2,2,1,3
14648_0,,,,2,2,1,3
C(CO)(CC(C)(CC(CO)=O)O)=O,,,5,1,1,0,1
14649_0,,,,2,2,1,3
14649_1,,,,2,2,1,3
14651_0,,,,2,2,1,3
C(C(C=C)C(CO)(CC(C)=O)O)=O,,,5,1,1,0,1
14653_0,,,,2,2,1,3
C(C)(CC(CO)(CC(C=O)=O)O)=O,,,5,1,1,0,1
14655_0,,,,2,2,1,3
C(C(C=O)C(CO)(CC(C)=O)O)=O,,,5,1,2,0,2
14655_1,,,,2,2,1,3
14657_0,,,,2,2,1,3
C(CC(CO)(CC(C)=O)O)=O,,,5,1,2,0,2
14659_0,,,,2,2,1,3
C(C(CO)C(CO)(CC(C)=O)O)=O,,,5,1,2,0,2
14659_1,,,,2,2,1,3
14661_0,,,,2,2,1,3
C(C)(CC(CO)(C(C(C)=O)O)O)=O,,,5,1,2,0,2
14661_1,,,,2,2,1,3
14663_0,,,,2,2,1,3
C(C)(CC(CO)(CC(CO)=O)O)=O,,,5,1,1,0,1
14665_0,,,,2,2,1,3
C(C(C(CO)(CC(C)=O)O)O)=O,,,5,1,3,0,3
14665_1,,,,2,2,1,3
14667_0,,,,2,2,1,3
C(CO)(CC(CC(C=CC)O)=O)=O,,,5,1,1,0,1
14669_0,,,,2,2,1,3
C(CC(CC=C)O)(CC(CO)=O)=O,,,5,1,1,0,1
14671_0,,,,2,2,1,3
C(CC(C=C)O)(CC(CO)=O)=O,,,5,1,1,0,1
14672_0,,,,2,2,1,3
14674_0,,,,2,2,1,3
C(C(C)(CC(CC(CO)=O)=O)O)=O,,,5,1,1,0,1
14676_0,,,,2,2,1,3
C(CO)(CC(CC(C(C)=O)O)=O)=O,,,5,1,1,0,1
14677_0,,,,2,2,1,3
14679_0,,,,2,2,1,3
C(CC(C)O)(CC(CO)=O)=O,,,5,1,3,0,3
14681_0,,,,2,2,1,3
C(CC(CCO)O)(CC(CO)=O)=O,,,5,1,1,0,1
14683_0,,,,2,2,1,3
C(CC(CO)(C)O)(CC(CO)=O)=O,,,5,1,1,0,1
14685_0,,,,2,2,1,3
C(C(CC(CC(CO)=O)=O)O)(O)=O,,,5,1,2,0,2
14687_0,,,,2,2,1,3
C(CCO)(CC(CO)=O)=O,,,5,1,6,0,6
14689_0,,,,2,2,1,3
C(CC(CO)O)(CC(CO)=O)=O,,,5,1,5,0,5
14691_0,,,,2,2,1,3
C(C)(C(C(CO)=O)C(C=CC)O)=O,,,5,1,2,0,2
14691_1,,,,2,2,1,3
14693_0,,,,2,2,1,3
C(C)(C(C(CO)=O)C(CC=C)O)=O,,,5,1,2,0,2
14693_1,,,,2,2,1,3
14695_0,,,,2,2,1,3
C(CO)(C(C(C)=O)C(C=C)O)=O,,,5,1,2,0,2
14695_1,,,,2,2,1,3
14697_0,,,,2,2,1,3
C(C(C(C(CO)=O)C(C)=O)O)=O,,,5,1,5,0,5
14697_1,,,,2,2,1,3
14699_0,,,,2,2,1,3
C(C(C)(C(C(C)=O)C(CO)=O)O)=O,,,5,1,2,0,2
14699_1,,,,2,2,1,3
14701_0,,,,2,2,1,3
C(C)(C(C(CO)=O)C(C(C)=O)O)=O,,,5,1,2,0,2
14701_1,,,,2,2,1,3
14703_0,,,,2,2,1,3
C(CC(C(C(C)=O)C(CO)=O)O)=O,,,5,1,3,0,3
14703_1,,,,2,2,1,3
14705_0,,,,2,2,1,3
C(C)(C(C(CO)=O)C(C)O)=O,,,5,1,3,0,3
14705_1,,,,2,2,1,3
14707_0,,,,2,2,1,3
C(C)(C(C(CO)=O)C(CCO)O)=O,,,5,1,2,0,2
14707_1,,,,2,2,1,3
14709_0,,,,2,2,1,3
C(C)(C(C(CO)=O)C(CO)(C)O)=O,,,5,1,2,0,2
14709_1,,,,2,2,1,3
14711_0,,,,2,2,1,3
C(C(C(C(CO)=O)C(C)=O)O)(O)=O,,,5,1,2,0,2
14711_1,,,,2,2,1,3
14712_0,,,,2,2,1,3
14712_1,,,,2,2,1,3
14714_0,,,,2,2,1,3
C(C)(C(C(CO)=O)C(CO)O)=O,,,5,1,3,0,3
14714_1,,,,2,2,1,3
14716_0,,,,2,2,1,3
C(C)(CC(C(C(C=CC)O)O)=O)=O,,,5,1,2,0,2
14716_1,,,,2,2,1,3
14718_0,,,,2,2,1,3
C(C(C(CC=C)O)O)(CC(C)=O)=O,,,5,1,2,0,2
14718_1,,,,2,2,1,3
14720_0,,,,2,2,1,3
C(C(C(C=C)O)O)(CC(C)=O)=O,,,5,1,2,0,2
14720_1,,,,2,2,1,3
14721_0,,,,2,2,1,3
14721_1,,,,2,2,1,3
14723_0,,,,2,2,1,3
C(C(C)(C(C(CC(C)=O)=O)O)O)=O,,,5,1,3,0,3
14723_1,,,,2,2,1,3
14724_0,,,,2,2,1,3
14724_1,,,,2,2,1,3
14726_0,,,,2,2,1,3
C(CC(C(C(CC(C)=O)=O)O)O)=O,,,5,1,3,0,3
14726_1,,,,2,2,1,3
14728_0,,,,2,2,1,3
C(C(C(C)O)O)(CC(C)=O)=O,,,5,1,4,0,4
14728_1,,,,2,2,1,3
14730_0,,,,2,2,1,3
C(C(C(CCO)O)O)(CC(C)=O)=O,,,5,1,2,0,2
14730_1,,,,2,2,1,3
14732_0,,,,2,2,1,3
C(C(C(CO)(C)O)O)(CC(C)=O)=O,,,5,1,2,0,2
14732_1,,,,2,2,1,3
14734_0,,,,2,2,1,3
C(C(C(C(CC(C)=O)=O)O)O)(O)=O,,,5,1,3,0,3
14734_1,,,,2,2,1,3
14735_0,,,,2,2,1,3
14735_1,,,,2,2,1,3
14737_0,,,,2,2,1,3
C(C(C(CO)O)O)(CC(C)=O)=O,,,5,1,4,0,4
14737_1,,,,2,2,1,3
14739_0,,,,2,2,1,3
C(C(C=C)C(C(CC)=O)(CO)O)=O,,,5,1,1,0,1
14741_0,,,,2,2,1,3
C(C(CO)(CC(C=O)=O)O)(CC)=O,,,5,1,1,0,1
14743_0,,,,2,2,1,3
C(C(C=O)C(C(CC)=O)(CO)O)=O,,,5,1,2,0,2
14743_1,,,,2,2,1,3
14745_0,,,,2,2,1,3
C(C(CO)(CC=O)O)(CC)=O,,,5,1,2,0,2
14747_0,,,,2,2,1,3
C(C(CO)C(C(CC)=O)(CO)O)=O,,,5,1,2,0,2
14747_1,,,,2,2,1,3
14749_0,,,,2,2,1,3
C(C(CO)(C(C(C)=O)O)O)(CC)=O,,,5,1,2,0,2
14749_1,,,,2,2,1,3
14751_0,,,,2,2,1,3
C(C(CO)(CC(CO)=O)O)(CC)=O,,,5,1,1,0,1
14753_0,,,,2,2,1,3
C(C(CO)(C(C=O)O)O)(CC)=O,,,5,1,3,0,3
14753_1,,,,2,2,1,3
14755_0,,,,2,2,1,3
C(C(C=C)C(C(CO)=O)(CC)O)=O,,,5,1,1,0,1
14757_0,,,,2,2,1,3
C(CO)(C(CC)(CC(C=O)=O)O)=O,,,5,1,1,0,1
14759_0,,,,2,2,1,3
C(C(C=O)C(C(CO)=O)(CC)O)=O,,,5,1,2,0,2
14759_1,,,,2,2,1,3
14761_0,,,,2,2,1,3
C(CO)(C(CC)(CC=O)O)=O,,,5,1,1,0,1
14763_0,,,,2,2,1,3
C(C(CO)C(C(CO)=O)(CC)O)=O,,,5,1,2,0,2
14763_1,,,,2,2,1,3
14765_0,,,,2,2,1,3
C(CO)(C(CC)(C(C(C)=O)O)O)=O,,,5,1,2,0,2
14765_1,,,,2,2,1,3
14767_0,,,,2,2,1,3
C(CO)(C(CC)(CC(CO)=O)O)=O,,,5,1,1,0,1
14769_0,,,,2,2,1,3
C(CO)(C(CC)(C(C=O)O)O)=O,,,5,1,2,0,2
14769_1,,,,2,2,1,3
14771_0,,,,2,2,1,3
C(C)=CC(C(C(C(CC)=O)=O)O)O,,,5,1,2,0,2
14771_1,,,,2,2,1,3
14773_0,,,,2,2,1,3
C(CC(C(C(C(CC)=O)=O)O)O)=C,,,5,1,2,0,2
14773_1,,,,2,2,1,3
14775_0,,,,2,2,1,3
C=CC(C(C(C(CC)=O)=O)O)O,,,5,1,2,0,2
14775_1,,,,2,2,1,3
14777_0,,,,2,2,1,3
C(C(C(C(C(CC)=O)=O)O)O)=O,,,5,1,3,0,3
14777_1,,,,2,2,1,3
14779_0,,,,2,2,1,3
C(C(C)(C(C(C(CC)=O)=O)O)O)=O,,,5,1,2,0,2
14779_1,,,,2,2,1,3
14781_0,,,,2,2,1,3
C(C(C(C(C(CC)=O)=O)O)O)(C)=O,,,5,1,2,0,2
14781_1,,,,2,2,1,3
14783_0,,,,2,2,1,3
C(CC(C(C(C(CC)=O)=O)O)O)=O,,,5,1,2,0,2
14783_1,,,,2,2,1,3
14785_0,,,,2,2,1,3
C(C(C(C(C)O)O)=O)(CC)=O,,,5,1,3,0,3
14785_1,,,,2,2,1,3
14787_0,,,,2,2,1,3
C(C(C(C(CCO)O)O)=O)(CC)=O,,,5,1,2,0,2
14787_1,,,,2,2,1,3
14789_0,,,,2,2,1,3
C(C(C(C(CO)(C)O)O)=O)(CC)=O,,,5,1,2,0,2
14789_1,,,,2,2,1,3
14791_0,,,,2,2,1,3
C(C(C(C(C(CC)=O)=O)O)O)(O)=O,,,5,1,2,0,2
14791_1,,,,2,2,1,3
14792_0,,,,2,2,1,3
14792_1,,,,2,2,1,3
14794_0,,,,2,2,1,3
C(C(C(C(CO)O)O)=O)(CC)=O,,,5,1,3,0,3
14794_1,,,,2,2,1,3
14796_0,,,,2,2,1,3
C(C)=CC(C(C(C(CO)=O)=O)C)O,,,5,1,1,0,1
14798_0,,,,2,2,1,3
C(CC(C(C(C(CO)=O)=O)C)O)=C,,,5,1,1,0,1
14800_0,,,,2,2,1,3
C=CC(C(C(C(CO)=O)=O)C)O,,,5,1,1,0,1
14801_0,,,,2,2,1,3
14803_0,,,,2,2,1,3
C(C(C)(C(C(C(CO)=O)=O)C)O)=O,,,5,1,1,0,1
14805_0,,,,2,2,1,3
C(C(C(C(C(CO)=O)=O)C)O)(C)=O,,,5,1,1,0,1
14806_0,,,,2,2,1,3
14808_0,,,,2,2,1,3
C(C(CO)=O)(C(C)C(C)O)=O,,,5,1,1,0,1
14810_0,,,,2,2,1,3
C(C(CO)=O)(C(C)C(CCO)O)=O,,,5,1,1,0,1
14812_0,,,,2,2,1,3
C(C(CO)=O)(C(C)C(CO)(C)O)=O,,,5,1,1,0,1
14814_0,,,,2,2,1,3
C(C(C(C(C(CO)=O)=O)C)O)(O)=O,,,5,1,2,0,2
14816_0,,,,2,2,1,3
C(C(CO)=O)(C(CO)C)=O,,,5,1,3,0,3
14818_0,,,,2,2,1,3
C(C(CO)=O)(C(C)C(CO)O)=O,,,5,1,3,0,3
14820_0,,,,2,2,1,3
C(C(CC(CC=O)O)C(CO)O)=O,,,5,1,2,0,2
14822_0,,,,2,2,1,3
C(CC(C(C(CO)O)CC=O)O)=O,,,5,1,3,0,3
14824_0,,,,2,2,1,3
C(C(C(CO)O)C(C=O)C(C)O)=O,,,5,1,5,0,5
14825_0,,,,2,2,1,3
14827_0,,,,2,2,1,3
C(CC(CC(C(CO)=O)CO)O)=O,,,5,1,1,0,1
14829_0,,,,2,2,1,3
C(CC(CO)(C(CO)CC=O)O)=O,,,5,1,3,0,3
14831_0,,,,2,2,1,3
C(C(C(C)O)C(C(CO)=O)CO)=O,,,5,1,1,0,1
14833_0,,,,2,2,1,3
C(C(CO)C(C(CO)=O)CO)=O,,,5,1,7,0,7
14835_0,,,,2,2,1,3
C(C(CO)CC=O)(C(C(C)O)O)=O,,,5,1,2,0,2
14835_1,,,,2,2,1,3
14837_0,,,,2,2,1,3
C(C(CO)CC=O)(C(CO)O)=O,,,5,1,6,0,6
14837_1,,,,2,2,1,3
14838_0,,,,2,2,1,3
14840_0,,,,2,2,1,3
C(CC(C(CO)O)(CC(C)=O)O)=O,,,5,1,1,0,1
14842_0,,,,2,2,1,3
C(CC(C)O)(CC(C(CO)O)=O)=O,,,5,1,1,0,1
14844_0,,,,2,2,1,3
C(CCO)(CC(C(CO)O)=O)=O,,,5,1,6,0,6
14846_0,,,,2,2,1,3
C(C(CO)O)(C(C(C)=O)C(C)O)=O,,,5,1,2,0,2
14846_1,,,,2,2,1,3
14848_0,,,,2,2,1,3
C(C(CO)O)(C(C(C)=O)CO)=O,,,5,1,7,0,7
14848_1,,,,2,2,1,3
14850_0,,,,2,2,1,3
C(C(C(CO)O)(CC=O)O)(CC)=O,,,5,1,1,0,1
14852_0,,,,2,2,1,3
C(C(CC)(CC=O)O)(C(CO)O)=O,,,5,1,1,0,1
14854_0,,,,2,2,1,3
C(C(C(CO)O)=O)(C(C)C(C)O)=O,,,5,1,1,0,1
14856_0,,,,2,2,1,3
C(C(C(CO)O)=O)(C(CO)C)=O,,,5,1,3,0,3
14857_0,,,,2,2,1,3
14857_1,,,,2,2,1,3
14859_0,,,,2,2,1,3
C(CC(CC=O)O)(C(CO)CO)=O,,,5,1,1,0,1
14861_0,,,,2,2,1,3
C(CC(C(CO)CO)(CC=O)O)=O,,,5,1,1,0,1
14863_0,,,,2,2,1,3
C(C(C(C(CO)CO)=O)C(C)O)=O,,,5,1,2,0,2
14863_1,,,,2,2,1,3
14865_0,,,,2,2,1,3
C(C(C(C(CO)CO)=O)CO)=O,,,5,1,4,0,4
14865_1,,,,2,2,1,3
14867_0,,,,2,2,1,3
C(C(C(C(C(C=O)CO)=O)=O)C)=O,,,5,1,2,0,2
14867_1,,,,2,2,1,3
14869_0,,,,2,2,1,3
C(C(C)C(C=O)(C(C=O)C=C)O)=O,,,5,1,1,0,1
14871_0,,,,2,2,1,3
C(C(C)C(C=O)(C1C(C=CO1)=O)O)=O,,,5,1,2,0,2
14871_1,,,,2,2,1,3
14873_0,,,,2,2,1,3
C(C(C)C(C=O)(CC(C=O)=O)O)=O,,,5,1,1,0,1
14875_0,,,,2,2,1,3
C(C(C)C(C=O)(C(C=O)C=O)O)=O,,,5,1,2,0,2
14875_1,,,,2,2,1,3
14877_0,,,,2,2,1,3
C(CC(C=O)(C(C=O)C)O)=O,,,5,1,2,0,2
14879_0,,,,2,2,1,3
C(C(CO)C(C=O)(C(C=O)C)O)=O,,,5,1,2,0,2
14879_1,,,,2,2,1,3
14881_0,,,,2,2,1,3
C(C(C(C=O)(C(C=O)C)O)O)(C)=O,,,5,1,2,0,2
14881_1,,,,2,2,1,3
14883_0,,,,2,2,1,3
C(CC(C=O)(C(C=O)C)O)(CO)=O,,,5,1,1,0,1
14885_0,,,,2,2,1,3
C(C(C(C=O)(C(C=O)C)O)O)=O,,,5,1,4,0,4
14885_1,,,,2,2,1,3
14887_0,,,,2,2,1,3
C(C(C(C(C(C=O)C=C)O)=O)C)=O,,,5,1,1,0,1
14889_0,,,,2,2,1,3
C(C(C1C(C=CO1)=O)O)(C(C=O)C)=O,,,5,1,2,0,2
14889_1,,,,2,2,1,3
14891_0,,,,2,2,1,3
C(C(C(C(CC(C=O)=O)O)=O)C)=O,,,5,1,1,0,1
14893_0,,,,2,2,1,3
C(C(C(C(C(C=O)C=O)O)=O)C)=O,,,5,1,2,0,2
14893_1,,,,2,2,1,3
14895_0,,,,2,2,1,3
C(CC(C(C(C=O)C)=O)O)=O,,,5,1,2,0,2
14897_0,,,,2,2,1,3
C(C(CO)C(C(C(C=O)C)=O)O)=O,,,5,1,2,0,2
14897_1,,,,2,2,1,3
14899_0,,,,2,2,1,3
C(C(C(C(C(C(C)=O)O)O)=O)C)=O,,,5,1,2,0,2
14899_1,,,,2,2,1,3
14901_0,,,,2,2,1,3
C(CC(C(C(C=O)C)=O)O)(CO)=O,,,5,1,1,0,1
14903_0,,,,2,2,1,3
C(C(C(C(C(C=O)O)O)=O)C)=O,,,5,1,4,0,4
14903_1,,,,2,2,1,3
14905_0,,,,2,2,1,3
C(C(C=C)C(C(C(C=O)=O)C)O)=O,,,5,1,2,0,2
14907_0,,,,2,2,1,3
C1OC(C(C=1)=O)C(C(C(C=O)=O)C)O,,,5,1,2,0,2
14907_1,,,,2,2,1,3
14908_0,,,,2,2,1,3
14909_0,,,,2,2,1,3
14909_1,,,,2,2,1,3
14911_0,,,,2,2,1,3
C(CC(C(C(C=O)=O)C)O)=O,,,5,1,3,0,3
14913_0,,,,2,2,1,3
C(C(CO)C(C(C(C=O)=O)C)O)=O,,,5,1,3,0,3
14913_1,,,,2,2,1,3
14915_0,,,,2,2,1,3
C(C)(C(C(C(C(C=O)=O)C)O)O)=O,,,5,1,3,0,3
14915_1,,,,2,2,1,3
14917_0,,,,2,2,1,3
C(CO)(CC(C(C(C=O)=O)C)O)=O,,,5,1,2,0,2
14918_0,,,,2,2,1,3
14918_1,,,,2,2,1,3
14920_0,,,,2,2,1,3
C(C(C(C(CC(C)=O)=O)=O)CO)=O,,,5,1,2,0,2
14920_1,,,,2,2,1,3
14922_0,,,,2,2,1,3
C(CC(C(C(C(C)=O)CO)=O)=O)=O,,,5,1,2,0,2
14922_1,,,,2,2,1,3
14924_0,,,,2,2,1,3
C(CC(C(CC(CCO)=O)=O)=O)=O,,,5,1,1,0,1
14926_0,,,,2,2,1,3
C(C(C(CC(C(C)=O)=O)=O)CO)=O,,,5,1,2,0,2
14926_1,,,,2,2,1,3
14928_0,,,,2,2,1,3
C(CC=O)(C(C(C(C)=O)=O)CO)=O,,,5,1,2,0,2
14928_1,,,,2,2,1,3
14930_0,,,,2,2,1,3
C(CC=O)(CC(C(CCO)=O)=O)=O,,,5,1,1,0,1
14932_0,,,,2,2,1,3
C(C(C=C)C(CC(C(C)=O)=O)O)=O,,,5,1,2,0,2
14934_0,,,,2,2,1,3
C1OC(C(C=1)=O)C(CC(C(C)=O)=O)O,,,5,1,2,0,2
14934_1,,,,2,2,1,3
14935_0,,,,2,2,1,3
14936_0,,,,2,2,1,3
14936_1,,,,2,2,1,3
14938_0,,,,2,2,1,3
C(CC(CC(C(C)=O)=O)O)=O,,,5,1,4,0,4
14940_0,,,,2,2,1,3
C(C(CO)C(CC(C(C)=O)=O)O)=O,,,5,1,3,0,3
14940_1,,,,2,2,1,3
14942_0,,,,2,2,1,3
C(C)(C(C(CC(C(C)=O)=O)O)O)=O,,,5,1,3,0,3
14942_1,,,,2,2,1,3
14944_0,,,,2,2,1,3
C(CO)(CC(CC(C(C)=O)=O)O)=O,,,5,1,2,0,2
14945_0,,,,2,2,1,3
14945_1,,,,2,2,1,3
14947_0,,,,2,2,1,3
C(CC(C(C)(C(C=O)C=C)O)=O)=O,,,5,1,1,0,1
14949_0,,,,2,2,1,3
C(C(C)(C1C(C=CO1)=O)O)(CC=O)=O,,,5,1,2,0,2
14949_1,,,,2,2,1,3
14951_0,,,,2,2,1,3
C(C(C)(CC(C=O)=O)O)(CC=O)=O,,,5,1,1,0,1
14953_0,,,,2,2,1,3
C(CC(C(C)(C(C=O)C=O)O)=O)=O,,,5,1,2,0,2
14953_1,,,,2,2,1,3
14955_0,,,,2,2,1,3
C(C(C)(CC=O)O)(CC=O)=O,,,5,1,2,0,2
14957_0,,,,2,2,1,3
C(C(CO)C(C(CC=O)=O)(C)O)=O,,,5,1,2,0,2
14957_1,,,,2,2,1,3
14959_0,,,,2,2,1,3
C(C(C)(C(C(C)=O)O)O)(CC=O)=O,,,5,1,3,0,3
14959_1,,,,2,2,1,3
14961_0,,,,2,2,1,3
C(C(C)(CC(CO)=O)O)(CC=O)=O,,,5,1,1,0,1
14963_0,,,,2,2,1,3
C(C(C)(C(C=O)O)O)(CC=O)=O,,,5,1,5,0,5
14963_1,,,,2,2,1,3
14965_0,,,,2,2,1,3
C(C(C=C)C(C(C)=O)(CC=O)O)=O,,,5,1,1,0,1
14967_0,,,,2,2,1,3
C(CC(C(C)=O)(C1C(C=CO1)=O)O)=O,,,5,1,2,0,2
14967_1,,,,2,2,1,3
14969_0,,,,2,2,1,3
C(CC(C(C)=O)(CC(C=O)=O)O)=O,,,5,1,1,0,1
14971_0,,,,2,2,1,3
C(C(C=O)C(C(C)=O)(CC=O)O)=O,,,5,1,2,0,2
14971_1,,,,2,2,1,3
14973_0,,,,2,2,1,3
C(CC(C(C)=O)(CC=O)O)=O,,,5,1,3,0,3
14975_0,,,,2,2,1,3
C(CC(C(C)=O)(C(C=O)CO)O)=O,,,5,1,3,0,3
14975_1,,,,2,2,1,3
14976_0,,,,2,2,1,3
14976_1,,,,2,2,1,3
14977_0,,,,2,2,1,3
14978_0,,,,2,2,1,3
14978_1,,,,2,2,1,3
14980_0,,,,2,2,1,3
C(C(C(C(C)=O)=O)C(C(C=O)=C)O)=O,,,5,1,2,0,2
14980_1,,,,2,2,1,3
14982_0,,,,2,2,1,3
C(C(C(C(C)=O)=O)C(C=CC)O)=O,,,5,1,2,0,2
14982_1,,,,2,2,1,3
14984_0,,,,2,2,1,3
C(C(C(C(C)=O)=O)C(CC=C)O)=O,,,5,1,2,0,2
14984_1,,,,2,2,1,3
14986_0,,,,2,2,1,3
C(C(C(C(C)=O)=O)C(C=C)O)=O,,,5,1,2,0,2
14986_1,,,,2,2,1,3
14988_0,,,,2,2,1,3
C(C(C(C(C)=O)=O)C1(C=COC1)O)=O,,,5,1,2,0,2
14988_1,,,,2,2,1,3
14990_0,,,,2,2,1,3
C(C(C(C(C)=O)=O)C(C=O)O)=O,,,5,1,5,0,5
14990_1,,,,2,2,1,3
14992_0,,,,2,2,1,3
C(C(C)(C(C=O)C(C(C)=O)=O)O)=O,,,5,1,2,0,2
14992_1,,,,2,2,1,3
14994_0,,,,2,2,1,3
C(C(C(C(C)=O)=O)C(C(C)=O)O)=O,,,5,1,2,0,2
14994_1,,,,2,2,1,3
14996_0,,,,2,2,1,3
C(CC(C(C=O)C(C(C)=O)=O)O)=O,,,5,1,2,0,2
14996_1,,,,2,2,1,3
14998_0,,,,2,2,1,3
C(C(C(C(C)=O)=O)C(C)O)=O,,,5,1,5,0,5
14998_1,,,,2,2,1,3
15000_0,,,,2,2,1,3
C(C(C(C(C)=O)=O)C(CCO)O)=O,,,5,1,2,0,2
15000_1,,,,2,2,1,3
15002_0,,,,2,2,1,3
C(C(C(C(C)=O)=O)C(C)(CO)O)=O,,,5,1,2,0,2
15002_1,,,,2,2,1,3
15004_0,,,,2,2,1,3
C(C(C(C(C)=O)=O)C(C(O)=O)O)=O,,,5,1,2,0,2
15004_1,,,,2,2,1,3
15006_0,,,,2,2,1,3
C(C(C(C(C)=O)=O)C(C=O)(C=C)O)=O,,,5,1,2,0,2
15006_1,,,,2,2,1,3
15008_0,,,,2,2,1,3
C(C(C(C(C)=O)=O)C(C(C=C)=O)O)=O,,,5,1,2,0,2
15008_1,,,,2,2,1,3
15010_0,,,,2,2,1,3
C(C(C(C(C)=O)=O)C(C=CC=O)O)=O,,,5,1,2,0,2
15010_1,,,,2,2,1,3
15011_0,,,,2,2,1,3
15011_1,,,,2,2,1,3
15012_0,,,,2,2,1,3
15012_1,,,,2,2,1,3
15014_0,,,,2,2,1,3
C(CC(C(CC(C(C=O)=C)O)=O)=O)=O,,,5,1,1,0,1
15016_0,,,,2,2,1,3
C(CC(C(CC(C=CC)O)=O)=O)=O,,,5,1,1,0,1
15018_0,,,,2,2,1,3
C(CC(C(CC(CC=C)O)=O)=O)=O,,,5,1,1,0,1
15020_0,,,,2,2,1,3
C(CC(C(CC(C=C)O)=O)=O)=O,,,5,1,1,0,1
15022_0,,,,2,2,1,3
C(CC(C(CC1(C=COC1)O)=O)=O)=O,,,5,1,1,0,1
15024_0,,,,2,2,1,3
C(CC(C(CC(C=O)O)=O)=O)=O,,,5,1,2,0,2
15026_0,,,,2,2,1,3
C(C(C)(CC(C(CC=O)=O)=O)O)=O,,,5,1,1,0,1
15028_0,,,,2,2,1,3
C(CC(C(CC(C(C)=O)O)=O)=O)=O,,,5,1,1,0,1
15029_0,,,,2,2,1,3
15031_0,,,,2,2,1,3
C(CC(C(CC(C)O)=O)=O)=O,,,5,1,2,0,2
15033_0,,,,2,2,1,3
C(CC(C(CC(CCO)O)=O)=O)=O,,,5,1,1,0,1
15035_0,,,,2,2,1,3
C(CC(C(CC(C)(CO)O)=O)=O)=O,,,5,1,1,0,1
15037_0,,,,2,2,1,3
C(CC(C(CC(C(O)=O)O)=O)=O)=O,,,5,1,1,0,1
15039_0,,,,2,2,1,3
C(C(C=C)(CC(C(CC=O)=O)=O)O)=O,,,5,1,1,0,1
15041_0,,,,2,2,1,3
C(CC(C(CC(C(C=C)=O)O)=O)=O)=O,,,5,1,1,0,1
15043_0,,,,2,2,1,3
C(CC(C(CC(C=CC=O)O)=O)=O)=O,,,5,1,1,0,1
15044_0,,,,2,2,1,3
15045_0,,,,2,2,1,3
15047_0,,,,2,2,1,3
C(C(CO)CC(C=O)=O)(CC=O)=O,,,5,1,1,0,1
15049_0,,,,2,2,1,3
C(C(C(CCC(C=O)=O)=O)CO)=O,,,5,1,2,0,2
15049_1,,,,2,2,1,3
15051_0,,,,2,2,1,3
C(CC(CC(C(C=O)=O)CO)=O)=O,,,5,1,1,0,1
15053_0,,,,2,2,1,3
C(C(CO)CC=O)(CC(C=O)=O)=O,,,5,1,1,0,1
15055_0,,,,2,2,1,3
C(CCC(C(C(C=O)=O)CO)=O)=O,,,5,1,2,0,2
15055_1,,,,2,2,1,3
15057_0,,,,2,2,1,3
C(C(CO)CC(CC(C=O)=O)=O)=O,,,5,1,1,0,1
15059_0,,,,2,2,1,3
C(C(CO)C(C=O)CC(C=O)=O)=O,,,5,1,3,0,3
15060_0,,,,2,2,1,3
15062_0,,,,2,2,1,3
C(C(C(CO)CC(C=O)=O)=O)(C)=O,,,5,1,1,0,1
15064_0,,,,2,2,1,3
C(C(CCC(C=O)=O)=O)(CCO)=O,,,5,1,2,0,2
15066_0,,,,2,2,1,3
C(C(CC(C(C=O)=O)CO)=O)(C)=O,,,5,1,1,0,1
15068_0,,,,2,2,1,3
C(CC(C=O)=O)(C(C(C)=O)CO)=O,,,5,1,2,0,2
15068_1,,,,2,2,1,3
15070_0,,,,2,2,1,3
C(CC(C)=O)(C(C(C=O)=O)CO)=O,,,5,1,2,0,2
15070_1,,,,2,2,1,3
15072_0,,,,2,2,1,3
C(CC(CCO)=O)(CC(C=O)=O)=O,,,5,1,1,0,1
15074_0,,,,2,2,1,3
C(C(C(C)C(C(C=O)=O)CO)=O)=O,,,5,1,1,0,1
15075_0,,,,2,2,1,3
15077_0,,,,2,2,1,3
C(CO)(CCC(C=O)(CC=O)O)=O,,,5,1,3,0,3
15079_0,,,,2,2,1,3
C(CC(C(CCC(CO)=O)=O)O)=O,,,5,1,1,0,1
15081_0,,,,2,2,1,3
C(CO)(C(C(C)O)CC(C=O)=O)=O,,,5,1,1,0,1
15082_0,,,,2,2,1,3
15084_0,,,,2,2,1,3
C(CCC(C=O)=O)(C(C(C)O)O)=O,,,5,1,2,0,2
15084_1,,,,2,2,1,3
15085_0,,,,2,2,1,3
15085_1,,,,2,2,1,3
15087_0,,,,2,2,1,3
C(CC(C(C=O)=O)C(C)O)(CO)=O,,,5,1,1,0,1
15088_0,,,,2,2,1,3
15090_0,,,,2,2,1,3
C(CC(CCO)(CC(C=O)=O)O)=O,,,5,1,2,0,2
15092_0,,,,2,2,1,3
C(CC(C=O)(CC=O)O)(CCO)=O,,,5,1,1,0,1
15094_0,,,,2,2,1,3
C(CC(C(CC(CCO)=O)=O)O)=O,,,5,1,1,0,1
15096_0,,,,2,2,1,3
C(C(CO)C(C)O)(CC(C=O)=O)=O,,,5,1,2,0,2
15096_1,,,,2,2,1,3
15097_0,,,,2,2,1,3
15097_1,,,,2,2,1,3
15099_0,,,,2,2,1,3
C(CCO)(C(C(C=O)=O)C(C)O)=O,,,5,1,2,0,2
15099_1,,,,2,2,1,3
15100_0,,,,2,2,1,3
15100_1,,,,2,2,1,3
15102_0,,,,2,2,1,3
C(C(C=C)C(CCC(C=O)=O)O)=O,,,5,1,1,0,1
15104_0,,,,2,2,1,3
C1OC(C(C=1)=O)C(CCC(C=O)=O)O,,,5,1,2,0,2
15104_1,,,,2,2,1,3
15105_0,,,,2,2,1,3
15106_0,,,,2,2,1,3
15106_1,,,,2,2,1,3
15107_0,,,,2,2,1,3
15109_0,,,,2,2,1,3
C(C(CO)C(CCC(C=O)=O)O)=O,,,5,1,6,0,6
15109_1,,,,2,2,1,3
15110_0,,,,2,2,1,3
15110_1,,,,2,2,1,3
15111_0,,,,2,2,1,3
15112_0,,,,2,2,1,3
15112_1,,,,2,2,1,3
15114_0,,,,2,2,1,3
C(CCC(C=O)(C(C=O)C=C)O)=O,,,5,1,2,0,2
15116_0,,,,2,2,1,3
C(CCC(C=O)(C1C(C=CO1)=O)O)=O,,,5,1,2,0,2
15116_1,,,,2,2,1,3
15118_0,,,,2,2,1,3
C(CCC(C=O)(CC(C=O)=O)O)=O,,,5,1,2,0,2
15120_0,,,,2,2,1,3
C(CCC(C=O)(C(C=O)C=O)O)=O,,,5,1,3,0,3
15120_1,,,,2,2,1,3
15122_0,,,,2,2,1,3
C(CCC(C=O)(CC=O)O)=O,,,5,1,3,0,3
15124_0,,,,2,2,1,3
C(CCC(C=O)(C(C=O)CO)O)=O,,,5,1,3,0,3
15124_1,,,,2,2,1,3
15126_0,,,,2,2,1,3
C(CCC(C=O)(C(C(C)=O)O)O)=O,,,5,1,3,0,3
15126_1,,,,2,2,1,3
15128_0,,,,2,2,1,3
C(CCC(C=O)(CC(CO)=O)O)=O,,,5,1,2,0,2
15130_0,,,,2,2,1,3
C(CCC(C=O)(C(C=O)O)O)=O,,,5,1,5,0,5
15130_1,,,,2,2,1,3
15132_0,,,,2,2,1,3
C(C(C=C)C(C(CCC=O)=O)O)=O,,,5,1,1,0,1
15134_0,,,,2,2,1,3
C(CCC(C(C1C(C=CO1)=O)O)=O)=O,,,5,1,2,0,2
15134_1,,,,2,2,1,3
15136_0,,,,2,2,1,3
C(CCC(C(CC(C=O)=O)O)=O)=O,,,5,1,1,0,1
15138_0,,,,2,2,1,3
C(C(C=O)C(C(CCC=O)=O)O)=O,,,5,1,2,0,2
15138_1,,,,2,2,1,3
15140_0,,,,2,2,1,3
C(CCC(C(CC=O)O)=O)=O,,,5,1,4,0,4
15142_0,,,,2,2,1,3
C(CCC(C(C(C=O)CO)O)=O)=O,,,5,1,2,0,2
15142_1,,,,2,2,1,3
15144_0,,,,2,2,1,3
C(CCC(C(C(C(C)=O)O)O)=O)=O,,,5,1,4,0,4
15144_1,,,,2,2,1,3
15146_0,,,,2,2,1,3
C(CCC(C(CC(CO)=O)O)=O)=O,,,5,1,1,0,1
15148_0,,,,2,2,1,3
C(CCC(C(C(C=O)O)O)=O)=O,,,5,1,9,0,9
15148_1,,,,2,2,1,3
15150_0,,,,2,2,1,3
C(C(CC(C=O)=O)C(C(C=O)=C)O)=O,,,5,1,1,0,1
15152_0,,,,2,2,1,3
C(C(CC(C=O)=O)C(C=CC)O)=O,,,5,1,1,0,1
15154_0,,,,2,2,1,3
C(C(C(CC=C)O)CC(C=O)=O)=O,,,5,1,1,0,1
15156_0,,,,2,2,1,3
C(C(CC(C=O)=O)C(C=C)O)=O,,,5,1,1,0,1
15158_0,,,,2,2,1,3
C(C(CC(C=O)=O)C1(C=COC1)O)=O,,,5,1,1,0,1
15160_0,,,,2,2,1,3
C(C(C(C=O)CC(C=O)=O)O)=O,,,5,1,3,0,3
15162_0,,,,2,2,1,3
C(C(C)(C(C=O)CC(C=O)=O)O)=O,,,5,1,2,0,2
15164_0,,,,2,2,1,3
C(C(CC(C=O)=O)C(C(C)=O)O)=O,,,5,1,2,0,2
15166_0,,,,2,2,1,3
C(CC(C(C=O)CC(C=O)=O)O)=O,,,5,1,2,0,2
15168_0,,,,2,2,1,3
C(C(C(C)O)CC(C=O)=O)=O,,,5,1,3,0,3
15170_0,,,,2,2,1,3
C(C(C(CCO)O)CC(C=O)=O)=O,,,5,1,2,0,2
15172_0,,,,2,2,1,3
C(C(C(C)(CO)O)CC(C=O)=O)=O,,,5,1,1,0,1
15174_0,,,,2,2,1,3
C(C(C(C=O)CC(C=O)=O)O)(O)=O,,,5,1,2,0,2
15176_0,,,,2,2,1,3
C(C(C=C)(C(C=O)CC(C=O)=O)O)=O,,,5,1,2,0,2
15178_0,,,,2,2,1,3
C(C(CC(C=O)=O)C(C(C=C)=O)O)=O,,,5,1,2,0,2
15180_0,,,,2,2,1,3
C(C(CC(C=O)=O)C(C=CC=O)O)=O,,,5,1,2,0,2
15181_0,,,,2,2,1,3
15182_0,,,,2,2,1,3
15184_0,,,,2,2,1,3
C(CC(C(C=O)=O)C(C(C=O)=C)O)=O,,,5,1,1,0,1
15186_0,,,,2,2,1,3
C(CC(C(C=O)=O)C(C=CC)O)=O,,,5,1,1,0,1
15188_0,,,,2,2,1,3
C(CC(C(C=O)=O)C(CC=C)O)=O,,,5,1,1,0,1
15190_0,,,,2,2,1,3
C(CC(C(C=O)=O)C(C=C)O)=O,,,5,1,1,0,1
15192_0,,,,2,2,1,3
C(CC(C(C=O)=O)C1(C=COC1)O)=O,,,5,1,1,0,1
15194_0,,,,2,2,1,3
C(CC(C(C=O)=O)C(C=O)O)=O,,,5,1,3,0,3
15196_0,,,,2,2,1,3
C(CC(C(C=O)=O)C(C=O)(C)O)=O,,,5,1,2,0,2
15198_0,,,,2,2,1,3
C(CC(C(C=O)=O)C(C(C)=O)O)=O,,,5,1,2,0,2
15200_0,,,,2,2,1,3
C(CC(C(C(C=O)=O)CC=O)O)=O,,,5,1,3,0,3
15202_0,,,,2,2,1,3
C(CC(C(C=O)=O)C(C)O)=O,,,5,1,3,0,3
15204_0,,,,2,2,1,3
C(CC(C(C=O)=O)C(CCO)O)=O,,,5,1,2,0,2
15206_0,,,,2,2,1,3
C(CC(C(C=O)=O)C(C)(CO)O)=O,,,5,1,1,0,1
15208_0,,,,2,2,1,3
C(C(C(C(C=O)=O)CC=O)O)(O)=O,,,5,1,2,0,2
15210_0,,,,2,2,1,3
C(C(C=C)(C(C(C=O)=O)CC=O)O)=O,,,5,1,2,0,2
15212_0,,,,2,2,1,3
C(CC(C(C=O)=O)C(C(C=C)=O)O)=O,,,5,1,2,0,2
15214_0,,,,2,2,1,3
C(CC(C(C=O)=O)C(C=CC=O)O)=O,,,5,1,2,0,2
15215_0,,,,2,2,1,3
15217_0,,,,2,2,1,3
C(CC(C(C=O)=O)C(CO)O)=O,,,5,1,4,0,4
15219_0,,,,2,2,1,3
C(C(C(C(CCC=O)=O)=O)CO)=O,,,5,1,2,0,2
15219_1,,,,2,2,1,3
15221_0,,,,2,2,1,3
C(CC(C(C(CO)CC=O)=O)=O)=O,,,5,1,1,0,1
15223_0,,,,2,2,1,3
C(C(CO)CC(C(CC=O)=O)=O)=O,,,5,1,1,0,1
15225_0,,,,2,2,1,3
C(C(C(CC(CC=O)=O)=O)CO)=O,,,5,1,2,0,2
15225_1,,,,2,2,1,3
15227_0,,,,2,2,1,3
C(CC=O)(C(C(CC=O)=O)CO)=O,,,5,1,2,0,2
15227_1,,,,2,2,1,3
15228_0,,,,2,2,1,3
15230_0,,,,2,2,1,3
C(CC(C1C(C=CO1)=O)O)(CC=O)=O,,,5,1,2,0,2
15230_1,,,,2,2,1,3
15231_0,,,,2,2,1,3
15232_0,,,,2,2,1,3
15232_1,,,,2,2,1,3
15233_0,,,,2,2,1,3
15234_0,,,,2,2,1,3
15234_1,,,,2,2,1,3
15235_0,,,,2,2,1,3
15235_1,,,,2,2,1,3
15236_0,,,,2,2,1,3
15237_0,,,,2,2,1,3
15237_1,,,,2,2,1,3
15239_0,,,,2,2,1,3
C(C(C=C)C(CC=O)(CC=O)O)=O,,,5,1,1,0,1
15241_0,,,,2,2,1,3
C(CC(C1C(C=CO1)=O)(CC=O)O)=O,,,5,1,2,0,2
15241_1,,,,2,2,1,3
15242_0,,,,2,2,1,3
15244_0,,,,2,2,1,3
C(C(C=O)C(CC=O)(CC=O)O)=O,,,5,1,2,0,2
15244_1,,,,2,2,1,3
15246_0,,,,2,2,1,3
C(CC(CC=O)(CC=O)O)=O,,,5,1,2,0,2
15248_0,,,,2,2,1,3
C(C(CO)C(CC=O)(CC=O)O)=O,,,5,1,3,0,3
15248_1,,,,2,2,1,3
15250_0,,,,2,2,1,3
C(CC(C(C(C)=O)O)(CC=O)O)=O,,,5,1,3,0,3
15250_1,,,,2,2,1,3
15251_0,,,,2,2,1,3
15252_0,,,,2,2,1,3
15252_1,,,,2,2,1,3
15254_0,,,,2,2,1,3
C(C(C(CC=O)=O)C(C(C=O)=C)O)=O,,,5,1,2,0,2
15254_1,,,,2,2,1,3
15256_0,,,,2,2,1,3
C(C(C(CC=O)=O)C(C=CC)O)=O,,,5,1,2,0,2
15256_1,,,,2,2,1,3
15258_0,,,,2,2,1,3
C(C(C(CC=O)=O)C(CC=C)O)=O,,,5,1,2,0,2
15258_1,,,,2,2,1,3
15260_0,,,,2,2,1,3
C(C(C(CC=O)=O)C(C=C)O)=O,,,5,1,2,0,2
15260_1,,,,2,2,1,3
15262_0,,,,2,2,1,3
C(CC(C(C=O)C1(C=COC1)O)=O)=O,,,5,1,2,0,2
15262_1,,,,2,2,1,3
15264_0,,,,2,2,1,3
C(C(C(CC=O)=O)C(C=O)O)=O,,,5,1,6,0,6
15264_1,,,,2,2,1,3
15266_0,,,,2,2,1,3
C(CC(C(C=O)C(C=O)(C)O)=O)=O,,,5,1,2,0,2
15266_1,,,,2,2,1,3
15268_0,,,,2,2,1,3
C(C(C(CC=O)=O)C(C(C)=O)O)=O,,,5,1,2,0,2
15268_1,,,,2,2,1,3
15270_0,,,,2,2,1,3
C(C(C(CC=O)=O)C(CC=O)O)=O,,,5,1,2,0,2
15270_1,,,,2,2,1,3
15272_0,,,,2,2,1,3
C(C(C(CC=O)=O)C(C)O)=O,,,5,1,6,0,6
15272_1,,,,2,2,1,3
15274_0,,,,2,2,1,3
C(C(C(CC=O)=O)C(CCO)O)=O,,,5,1,2,0,2
15274_1,,,,2,2,1,3
15276_0,,,,2,2,1,3
C(C(C(CC=O)=O)C(C)(CO)O)=O,,,5,1,2,0,2
15276_1,,,,2,2,1,3
15278_0,,,,2,2,1,3
C(C(C(CC=O)=O)C(C(O)=O)O)=O,,,5,1,2,0,2
15278_1,,,,2,2,1,3
15280_0,,,,2,2,1,3
C(C(C(CC=O)=O)C(C=O)(C=C)O)=O,,,5,1,2,0,2
15280_1,,,,2,2,1,3
15282_0,,,,2,2,1,3
C(C(C(CC=O)=O)C(C(C=C)=O)O)=O,,,5,1,2,0,2
15282_1,,,,2,2,1,3
15284_0,,,,2,2,1,3
C(C(C(CC=O)=O)C(C=CC=O)O)=O,,,5,1,2,0,2
15284_1,,,,2,2,1,3
15285_0,,,,2,2,1,3
15285_1,,,,2,2,1,3
15286_0,,,,2,2,1,3
15286_1,,,,2,2,1,3
15288_0,,,,2,2,1,3
C(CC(C(CO)C(C=O)C=O)=O)=O,,,5,1,1,0,1
15290_0,,,,2,2,1,3
C(C(C(CC(C=O)C=O)=O)CO)=O,,,5,1,2,0,2
15290_1,,,,2,2,1,3
15292_0,,,,2,2,1,3
C(C(CO)CC=O)(C(C=O)C=O)=O,,,5,1,1,0,1
15294_0,,,,2,2,1,3
C(C(CO)CC(C(C=O)C=O)=O)=O,,,5,1,1,0,1
15296_0,,,,2,2,1,3
C(C(CO)C(C=O)C(C=O)C=O)=O,,,5,1,3,0,3
15298_0,,,,2,2,1,3
C(C(C=O)C(C(C(C)=O)=O)CO)=O,,,5,1,1,0,1
15300_0,,,,2,2,1,3
C(C(C=O)CC(C(CCO)=O)=O)=O,,,5,1,1,0,1
15302_0,,,,2,2,1,3
C(C(C=O)C(C(C(C)=O)CO)=O)=O,,,5,1,2,0,2
15302_1,,,,2,2,1,3
15304_0,,,,2,2,1,3
C(C(C=O)C(CC(CCO)=O)=O)=O,,,5,1,1,0,1
15306_0,,,,2,2,1,3
C(C(C=O)CC(CO)(CC=O)O)=O,,,5,1,2,0,2
15308_0,,,,2,2,1,3
C(CC(C(C=O)CC(CO)=O)O)=O,,,5,1,3,0,3
15310_0,,,,2,2,1,3
C(C(C=O)C(C(CO)=O)C(C)O)=O,,,5,1,1,0,1
15311_0,,,,2,2,1,3
15313_0,,,,2,2,1,3
C(C(C=O)CC(C(C(C)O)O)=O)=O,,,5,1,2,0,2
15313_1,,,,2,2,1,3
15314_0,,,,2,2,1,3
15314_1,,,,2,2,1,3
15316_0,,,,2,2,1,3
C(C(C=O)C(CCO)(CC=O)O)=O,,,5,1,3,0,3
15318_0,,,,2,2,1,3
C(C(C(CCO)=O)C(CC=O)O)=O,,,5,1,3,0,3
15320_0,,,,2,2,1,3
C(C(C=O)C(C(CO)C(C)O)=O)=O,,,5,1,2,0,2
15320_1,,,,2,2,1,3
15321_0,,,,2,2,1,3
15321_1,,,,2,2,1,3
15323_0,,,,2,2,1,3
C(C(C=C)C(CC(C=O)C=O)O)=O,,,5,1,1,0,1
15325_0,,,,2,2,1,3
C(C(C=O)CC(C1C(C=CO1)=O)O)=O,,,5,1,2,0,2
15325_1,,,,2,2,1,3
15327_0,,,,2,2,1,3
C(C(C=O)CC(CC(C=O)=O)O)=O,,,5,1,2,0,2
15329_0,,,,2,2,1,3
C(C(C=O)CC(C(C=O)C=O)O)=O,,,5,1,3,0,3
15329_1,,,,2,2,1,3
15331_0,,,,2,2,1,3
C(C(C=O)CC(CC=O)O)=O,,,5,1,3,0,3
15333_0,,,,2,2,1,3
C(C(C=O)CC(C(C=O)CO)O)=O,,,5,1,3,0,3
15333_1,,,,2,2,1,3
15335_0,,,,2,2,1,3
C(C(C=O)CC(C(C(C)=O)O)O)=O,,,5,1,3,0,3
15335_1,,,,2,2,1,3
15337_0,,,,2,2,1,3
C(C(C=O)CC(CC(CO)=O)O)=O,,,5,1,2,0,2
15339_0,,,,2,2,1,3
C(C(C=O)CC(C(C=O)O)O)=O,,,5,1,7,0,7
15339_1,,,,2,2,1,3
15341_0,,,,2,2,1,3
C(C(C(C(C=O)C=C)O)CC=O)=O,,,5,1,2,0,2
15343_0,,,,2,2,1,3
C(C(C(C1C(C=CO1)=O)O)CC=O)=O,,,5,1,2,0,2
15343_1,,,,2,2,1,3
15344_0,,,,2,2,1,3
15345_0,,,,2,2,1,3
15345_1,,,,2,2,1,3
15346_0,,,,2,2,1,3
15348_0,,,,2,2,1,3
C(C(CO)C(C(C=O)CC=O)O)=O,,,5,1,7,0,7
15348_1,,,,2,2,1,3
15349_0,,,,2,2,1,3
15349_1,,,,2,2,1,3
15350_0,,,,2,2,1,3
15351_0,,,,2,2,1,3
15351_1,,,,2,2,1,3
15353_0,,,,2,2,1,3
C(C(C=O)C(C=O)C(C(C=O)=C)O)=O,,,5,1,1,0,1
15355_0,,,,2,2,1,3
C(C(C=O)C(C=O)C(C=CC)O)=O,,,5,1,1,0,1
15357_0,,,,2,2,1,3
C(C(C=O)C(C=O)C(CC=C)O)=O,,,5,1,1,0,1
15359_0,,,,2,2,1,3
C(C(C=O)C(C=O)C(C=C)O)=O,,,5,1,1,0,1
15361_0,,,,2,2,1,3
C(C(C=O)C(C=O)C1(C=COC1)O)=O,,,5,1,1,0,1
15363_0,,,,2,2,1,3
C(C(C=O)C(C=O)C(C=O)O)=O,,,5,1,3,0,3
15365_0,,,,2,2,1,3
C(C(C)(C(C=O)C(C=O)C=O)O)=O,,,5,1,2,0,2
15367_0,,,,2,2,1,3
C(C(C=O)C(C=O)C(C(C)=O)O)=O,,,5,1,2,0,2
15369_0,,,,2,2,1,3
C(CC(C(C=O)C(C=O)C=O)O)=O,,,5,1,2,0,2
15371_0,,,,2,2,1,3
C(C(C=O)C(C=O)C(C)O)=O,,,5,1,3,0,3
15373_0,,,,2,2,1,3
C(C(C=O)C(C=O)C(CCO)O)=O,,,5,1,2,0,2
15375_0,,,,2,2,1,3
C(C(C=O)C(C=O)C(C)(CO)O)=O,,,5,1,1,0,1
15377_0,,,,2,2,1,3
C(C(C=O)C(C=O)C(C(O)=O)O)=O,,,5,1,2,0,2
15379_0,,,,2,2,1,3
C(C(C=O)C(C=O)C(C=O)(C=C)O)=O,,,5,1,2,0,2
15381_0,,,,2,2,1,3
C(C(C=O)C(C=O)C(C(C=C)=O)O)=O,,,5,1,2,0,2
15383_0,,,,2,2,1,3
C(C(C=O)C(C=O)C(C=CC=O)O)=O,,,5,1,2,0,2
15384_0,,,,2,2,1,3
15385_0,,,,2,2,1,3
15387_0,,,,2,2,1,3
C(CC(C=O)(C(C=O)CCO)O)=O,,,5,1,3,0,3
15389_0,,,,2,2,1,3
C(CC(C(C(C=O)CCO)=O)O)=O,,,5,1,1,0,1
15391_0,,,,2,2,1,3
C(CC(C(C(C=O)=O)CCO)O)=O,,,5,1,3,0,3
15393_0,,,,2,2,1,3
C(CC(CC(C(CCO)=O)=O)O)=O,,,5,1,1,0,1
15395_0,,,,2,2,1,3
C(C(CCO)(CC=O)O)(CC=O)=O,,,5,1,1,0,1
15397_0,,,,2,2,1,3
C(CC(C(CCO)=O)(CC=O)O)=O,,,5,1,1,0,1
15399_0,,,,2,2,1,3
C(C(C(C(CCO)=O)=O)C(C)O)=O,,,5,1,2,0,2
15399_1,,,,2,2,1,3
15400_0,,,,2,2,1,3
15400_1,,,,2,2,1,3
15402_0,,,,2,2,1,3
C(CC(C(C(CO)C(C)O)=O)=O)=O,,,5,1,2,0,2
15402_1,,,,2,2,1,3
15403_0,,,,2,2,1,3
15403_1,,,,2,2,1,3
15405_0,,,,2,2,1,3
C(CC(CC(C(C=O)=O)CO)O)=O,,,5,1,3,0,3
15407_0,,,,2,2,1,3
C(CC(CO)C(C=O)(CC=O)O)=O,,,5,1,4,0,4
15409_0,,,,2,2,1,3
C(CC(C(C(CO)CC=O)=O)O)=O,,,5,1,1,0,1
15411_0,,,,2,2,1,3
C(C(C(C)O)C(C(C=O)=O)CO)=O,,,5,1,2,0,2
15412_0,,,,2,2,1,3
15413_0,,,,2,2,1,3
15415_0,,,,2,2,1,3
C(C)(C(CO)C(C=O)(CC=O)O)=O,,,5,1,1,0,1
15417_0,,,,2,2,1,3
C(CC(C(C(C(C)=O)CO)=O)O)=O,,,5,1,1,0,1
15419_0,,,,2,2,1,3
C(CC(C)O)(C(C(C=O)=O)CO)=O,,,5,1,1,0,1
15420_0,,,,2,2,1,3
15422_0,,,,2,2,1,3
C(C(C=C)C(CCC(CC=O)=O)O)=O,,,5,1,1,0,1
15424_0,,,,2,2,1,3
C(CC(CCC(CC=O)O)=O)=O,,,5,1,2,0,2
15426_0,,,,2,2,1,3
C(CCC(C(C=O)O)O)(CC=O)=O,,,5,1,2,0,2
15426_1,,,,2,2,1,3
15428_0,,,,2,2,1,3
C(C(C=C)C(CCC=O)(CC=O)O)=O,,,5,1,1,0,1
15430_0,,,,2,2,1,3
C(CC(CCC=O)(CC=O)O)=O,,,5,1,2,0,2
15432_0,,,,2,2,1,3
C(CCC(C(C=O)O)(CC=O)O)=O,,,5,1,4,0,4
15432_1,,,,2,2,1,3
15434_0,,,,2,2,1,3
C(C(C=C)C(CC(CCC=O)=O)O)=O,,,5,1,1,0,1
15436_0,,,,2,2,1,3
C(CC(CC(CCC=O)=O)O)=O,,,5,1,2,0,2
15438_0,,,,2,2,1,3
C(C(C(CC(CCC=O)=O)O)O)=O,,,5,1,2,0,2
15438_1,,,,2,2,1,3
15440_0,,,,2,2,1,3
C(CC(CC(C=O)C(C=CC)O)=O)=O,,,5,1,1,0,1
15442_0,,,,2,2,1,3
C(C(C(CC=C)O)CC(CC=O)=O)=O,,,5,1,1,0,1
15444_0,,,,2,2,1,3
C(CC(CC(C=O)C(C=C)O)=O)=O,,,5,1,1,0,1
15446_0,,,,2,2,1,3
C(CC(CC(C=O)C(C=O)O)=O)=O,,,5,1,1,0,1
15448_0,,,,2,2,1,3
C(C(C(C)O)CC(CC=O)=O)=O,,,5,1,2,0,2
15450_0,,,,2,2,1,3
C(C(CO)CC(CC=O)=O)=O,,,5,1,3,0,3
15452_0,,,,2,2,1,3
C(C(C(CO)O)CC(CC=O)=O)=O,,,5,1,1,0,1
15454_0,,,,2,2,1,3
C(CC(C(CC=O)C(C=CC)O)=O)=O,,,5,1,1,0,1
15456_0,,,,2,2,1,3
C(C(C(CC=C)O)CC=O)(CC=O)=O,,,5,1,1,0,1
15458_0,,,,2,2,1,3
C(CC(C(CC=O)C(C=C)O)=O)=O,,,5,1,1,0,1
15460_0,,,,2,2,1,3
C(CC(C(CC=O)C(C=O)O)=O)=O,,,5,1,1,0,1
15462_0,,,,2,2,1,3
C(C(C(C)O)CC=O)(CC=O)=O,,,5,1,2,0,2
15464_0,,,,2,2,1,3
C(C(CO)CC=O)(CC=O)=O,,,5,1,4,0,4
15466_0,,,,2,2,1,3
C(C(C(CO)O)CC=O)(CC=O)=O,,,5,1,1,0,1
15468_0,,,,2,2,1,3
C(C(C(CCC=O)=O)C(C=CC)O)=O,,,5,1,2,0,2
15468_1,,,,2,2,1,3
15470_0,,,,2,2,1,3
C(C(C(CCC=O)=O)C(CC=C)O)=O,,,5,1,2,0,2
15470_1,,,,2,2,1,3
15472_0,,,,2,2,1,3
C(C(C(CCC=O)=O)C(C=C)O)=O,,,5,1,2,0,2
15472_1,,,,2,2,1,3
15474_0,,,,2,2,1,3
C(C(C(CCC=O)=O)C(C=O)O)=O,,,5,1,2,0,2
15474_1,,,,2,2,1,3
15476_0,,,,2,2,1,3
C(C(C(CCC=O)=O)C(C)O)=O,,,5,1,3,0,3
15476_1,,,,2,2,1,3
15478_0,,,,2,2,1,3
C(C(C(CCC=O)=O)CO)=O,,,5,1,4,0,4
15478_1,,,,2,2,1,3
15480_0,,,,2,2,1,3
C(C(C(CCC=O)=O)C(CO)O)=O,,,5,1,2,0,2
15480_1,,,,2,2,1,3
15481_0,,,,2,2,1,3
15483_0,,,,2,2,1,3
C(CC(CC(C=O)O)(CC=O)O)=O,,,5,1,1,0,1
15485_0,,,,2,2,1,3
C(CC(C=O)O)(CC(CC=O)O)=O,,,5,1,1,0,1
15487_0,,,,2,2,1,3
C(C(C(C)O)C(C=O)O)(CC=O)=O,,,5,1,2,0,2
15487_1,,,,2,2,1,3
15489_0,,,,2,2,1,3
C(C(CO)C(C=O)O)(CC=O)=O,,,5,1,8,0,8
15489_1,,,,2,2,1,3
15491_0,,,,2,2,1,3
C(CC(C=O)O)(C(C=O)C(C)O)=O,,,5,1,2,0,2
15491_1,,,,2,2,1,3
15492_0,,,,2,2,1,3
15492_1,,,,2,2,1,3
15493_0,,,,2,2,1,3
15495_0,,,,2,2,1,3
C(CC(C(CC=O)O)(CC=O)O)=O,,,5,1,2,0,2
15497_0,,,,2,2,1,3
C(CC(CC(C(CC=O)=O)O)O)=O,,,5,1,2,0,2
15499_0,,,,2,2,1,3
C(CC(C(C(C=O)C(C)O)=O)O)=O,,,5,1,2,0,2
15499_1,,,,2,2,1,3
15500_0,,,,2,2,1,3
15500_1,,,,2,2,1,3
15501_0,,,,2,2,1,3
15501_1,,,,2,2,1,3
15502_0,,,,2,2,1,3
15502_1,,,,2,2,1,3
15504_0,,,,2,2,1,3
C(CC(C(C(CCC=O)=O)O)O)=O,,,5,1,3,0,3
15505_0,,,,2,2,1,3
15507_0,,,,2,2,1,3
C(C(C(CCC(CC=O)O)=O)O)=O,,,5,1,2,0,2
15509_0,,,,2,2,1,3
C(C(C(C)O)CC=O)(C(C=O)O)=O,,,5,1,2,0,2
15511_0,,,,2,2,1,3
C(C(CO)CC=O)(C(C=O)O)=O,,,5,1,5,0,5
15513_0,,,,2,2,1,3
C(C(C(C)O)CC(C(C=O)O)=O)=O,,,5,1,2,0,2
15514_0,,,,2,2,1,3
15516_0,,,,2,2,1,3
C(C(CCC(C=O)(CC=O)O)O)=O,,,5,1,1,0,1
15518_0,,,,2,2,1,3
C(CC(C(CCC(C=O)O)=O)O)=O,,,5,1,2,0,2
15519_0,,,,2,2,1,3
15521_0,,,,2,2,1,3
C(C(CC(C(C=O)=O)C(C)O)O)=O,,,5,1,2,0,2
15523_0,,,,2,2,1,3
C(C(CC(C(C=O)=O)CO)O)=O,,,5,1,5,0,5
15525_0,,,,2,2,1,3
C(CC(CC(C=O)C(C=O)O)O)=O,,,5,1,2,0,2
15526_0,,,,2,2,1,3
15528_0,,,,2,2,1,3
C(CC(C(C(C=O)O)CC=O)O)=O,,,5,1,3,0,3
15530_0,,,,2,2,1,3
C(C(C(C=O)C(C=O)C(C)O)O)=O,,,5,1,4,0,4
15531_0,,,,2,2,1,3
15532_0,,,,2,2,1,3
15533_0,,,,2,2,1,3
15535_0,,,,2,2,1,3
C(C)(C(C(CC=O)O)C(C=O)O)=O,,,5,1,1,0,1
15537_0,,,,2,2,1,3
C(CC(C)O)(C(C=O)C(C=O)O)=O,,,5,1,1,0,1
15538_0,,,,2,2,1,3
15540_0,,,,2,2,1,3
C(C(CC(C(C=O)C=C)O)CC=O)=O,,,5,1,1,0,1
15541_0,,,,2,2,1,3
15542_0,,,,2,2,1,3
15542_1,,,,2,2,1,3
15544_0,,,,2,2,1,3
C(C(C=C)C(C(CC=O)CC=O)O)=O,,,5,1,1,0,1
15546_0,,,,2,2,1,3
C(CC(C(CC=O)O)CC=O)=O,,,5,1,3,0,3
15548_0,,,,2,2,1,3
C(CC(C(C(C=O)O)O)CC=O)=O,,,5,1,4,0,4
15548_1,,,,2,2,1,3
15550_0,,,,2,2,1,3
C(CC(C=O)C(C=O)C(C=CC)O)=O,,,5,1,1,0,1
15552_0,,,,2,2,1,3
C(CC(C=O)C(C=O)C(CC=C)O)=O,,,5,1,1,0,1
15554_0,,,,2,2,1,3
C(CC(C=O)C(C=O)C(C=C)O)=O,,,5,1,1,0,1
15555_0,,,,2,2,1,3
15556_0,,,,2,2,1,3
15557_0,,,,2,2,1,3
15558_0,,,,2,2,1,3
15560_0,,,,2,2,1,3
C(CC(CC(C=O)C(CO)=O)O)=O,,,5,1,2,0,2
15562_0,,,,2,2,1,3
C(CO)(C(C(CC=O)O)CC=O)=O,,,5,1,3,0,3
15563_0,,,,2,2,1,3
15565_0,,,,2,2,1,3
C(C(C(C)O)C(C=O)C(CO)=O)=O,,,5,1,2,0,2
15566_0,,,,2,2,1,3
15568_0,,,,2,2,1,3
C(C(C(C)O)O)(C(C=O)CC=O)=O,,,5,1,2,0,2
15568_1,,,,2,2,1,3
15569_0,,,,2,2,1,3
15569_1,,,,2,2,1,3
15570_0,,,,2,2,1,3
15571_0,,,,2,2,1,3
15572_0,,,,2,2,1,3
15574_0,,,,2,2,1,3
C(CC(C)O)(C(C=O)C(CO)=O)=O,,,5,1,1,0,1
15575_0,,,,2,2,1,3
15577_0,,,,2,2,1,3
C(C(C(C)O)O)(C(C=O)C(C)=O)=O,,,5,1,2,0,2
15577_1,,,,2,2,1,3
15578_0,,,,2,2,1,3
15578_1,,,,2,2,1,3
15580_0,,,,2,2,1,3
C(C(C=C)C(C)(CC(CC=O)=O)O)=O,,,5,1,1,0,1
15581_0,,,,2,2,1,3
15582_0,,,,2,2,1,3
15582_1,,,,2,2,1,3
15584_0,,,,2,2,1,3
C(C(C=C)C(CC(CC(C)=O)=O)O)=O,,,5,1,1,0,1
15586_0,,,,2,2,1,3
C(CC(CC(CC(C)=O)=O)O)=O,,,5,1,3,0,3
15588_0,,,,2,2,1,3
C(C(C(CC(CC(C)=O)=O)O)O)=O,,,5,1,2,0,2
15588_1,,,,2,2,1,3
15590_0,,,,2,2,1,3
C(CC(CC(C)=O)(C(C=O)C=C)O)=O,,,5,1,1,0,1
15592_0,,,,2,2,1,3
C(CC(CC=O)(CC(C)=O)O)=O,,,5,1,2,0,2
15594_0,,,,2,2,1,3
C(CC(C(C=O)O)(CC(C)=O)O)=O,,,5,1,3,0,3
15594_1,,,,2,2,1,3
15596_0,,,,2,2,1,3
C(CC(CC(CC(C=CC)O)=O)=O)=O,,,5,1,1,0,1
15598_0,,,,2,2,1,3
C(CC(CC(CC(CC=C)O)=O)=O)=O,,,5,1,1,0,1
15600_0,,,,2,2,1,3
C(CC(CC(CC(C=C)O)=O)=O)=O,,,5,1,1,0,1
15602_0,,,,2,2,1,3
C(CC(CC(CC(C=O)O)=O)=O)=O,,,5,1,1,0,1
15604_0,,,,2,2,1,3
C(CC(CC(CC(C)O)=O)=O)=O,,,5,1,3,0,3
15606_0,,,,2,2,1,3
C(CC(CC(CCO)=O)=O)=O,,,5,1,5,0,5
15608_0,,,,2,2,1,3
C(CC(CC(CC(CO)O)=O)=O)=O,,,5,1,1,0,1
15610_0,,,,2,2,1,3
C(CC=O)(C(C(C)=O)C(C=CC)O)=O,,,5,1,2,0,2
15610_1,,,,2,2,1,3
15612_0,,,,2,2,1,3
C(CC=O)(C(C(C)=O)C(CC=C)O)=O,,,5,1,2,0,2
15612_1,,,,2,2,1,3
15614_0,,,,2,2,1,3
C(CC=O)(C(C(C)=O)C(C=C)O)=O,,,5,1,2,0,2
15614_1,,,,2,2,1,3
15616_0,,,,2,2,1,3
C(CC=O)(C(C(C)=O)C(C=O)O)=O,,,5,1,2,0,2
15616_1,,,,2,2,1,3
15618_0,,,,2,2,1,3
C(CC=O)(C(C(C)=O)C(C)O)=O,,,5,1,4,0,4
15618_1,,,,2,2,1,3
15620_0,,,,2,2,1,3
C(CC=O)(C(C(C)=O)CO)=O,,,5,1,6,0,6
15620_1,,,,2,2,1,3
15622_0,,,,2,2,1,3
C(CC=O)(C(C(C)=O)C(CO)O)=O,,,5,1,2,0,2
15622_1,,,,2,2,1,3
15624_0,,,,2,2,1,3
C(C(C(CC(C)=O)=O)C(C=CC)O)=O,,,5,1,2,0,2
15624_1,,,,2,2,1,3
15626_0,,,,2,2,1,3
C(C(C(CC(C)=O)=O)C(CC=C)O)=O,,,5,1,2,0,2
15626_1,,,,2,2,1,3
15628_0,,,,2,2,1,3
C(C(C(CC(C)=O)=O)C(C=C)O)=O,,,5,1,2,0,2
15628_1,,,,2,2,1,3
15630_0,,,,2,2,1,3
C(C(C(CC(C)=O)=O)C(C=O)O)=O,,,5,1,2,0,2
15630_1,,,,2,2,1,3
15632_0,,,,2,2,1,3
C(C(C(CC(C)=O)=O)C(C)O)=O,,,5,1,4,0,4
15632_1,,,,2,2,1,3
15634_0,,,,2,2,1,3
C(C(C(CC(C)=O)=O)CO)=O,,,5,1,5,0,5
15634_1,,,,2,2,1,3
15636_0,,,,2,2,1,3
C(C(C(CC(C)=O)=O)C(CO)O)=O,,,5,1,2,0,2
15636_1,,,,2,2,1,3
15638_0,,,,2,2,1,3
C(C(C=C)C(CC(C(CC)=O)=O)O)=O,,,5,1,1,0,1
15640_0,,,,2,2,1,3
C(CC(CC(C(CC)=O)=O)O)=O,,,5,1,2,0,2
15642_0,,,,2,2,1,3
C(C(C(CC(C(CC)=O)=O)O)O)=O,,,5,1,2,0,2
15642_1,,,,2,2,1,3
15644_0,,,,2,2,1,3
C(CC(C(CC)(C(C=O)C=C)O)=O)=O,,,5,1,1,0,1
15646_0,,,,2,2,1,3
C(C(CC)(CC=O)O)(CC=O)=O,,,5,1,1,0,1
15648_0,,,,2,2,1,3
C(C(CC)(C(C=O)O)O)(CC=O)=O,,,5,1,2,0,2
15648_1,,,,2,2,1,3
15650_0,,,,2,2,1,3
C(CC(C(CC)=O)(C(C=O)C=C)O)=O,,,5,1,1,0,1
15652_0,,,,2,2,1,3
C(CC(C(CC)=O)(CC=O)O)=O,,,5,1,2,0,2
15654_0,,,,2,2,1,3
C(CC(C(CC)=O)(C(C=O)O)O)=O,,,5,1,2,0,2
15654_1,,,,2,2,1,3
15656_0,,,,2,2,1,3
C(C(C(C(CC)=O)=O)C(C=CC)O)=O,,,5,1,2,0,2
15656_1,,,,2,2,1,3
15658_0,,,,2,2,1,3
C(C(C(C(CC)=O)=O)C(CC=C)O)=O,,,5,1,2,0,2
15658_1,,,,2,2,1,3
15660_0,,,,2,2,1,3
C(C(C(C(CC)=O)=O)C(C=C)O)=O,,,5,1,2,0,2
15660_1,,,,2,2,1,3
15662_0,,,,2,2,1,3
C(C(C(C(CC)=O)=O)C(C=O)O)=O,,,5,1,2,0,2
15662_1,,,,2,2,1,3
15664_0,,,,2,2,1,3
C(C(C(C(CC)=O)=O)C(C)O)=O,,,5,1,3,0,3
15664_1,,,,2,2,1,3
15666_0,,,,2,2,1,3
C(C(C(C(CC)=O)=O)CO)=O,,,5,1,3,0,3
15666_1,,,,2,2,1,3
15668_0,,,,2,2,1,3
C(C(C(C(CC)=O)=O)C(CO)O)=O,,,5,1,2,0,2
15668_1,,,,2,2,1,3
15670_0,,,,2,2,1,3
C(CC(C(C(C)C(C=CC)O)=O)=O)=O,,,5,1,1,0,1
15672_0,,,,2,2,1,3
C(CC(C(C(C)C(CC=C)O)=O)=O)=O,,,5,1,1,0,1
15674_0,,,,2,2,1,3
C(CC(C(C(C)C(C=C)O)=O)=O)=O,,,5,1,1,0,1
15676_0,,,,2,2,1,3
C(CC(C(C(C)C(C=O)O)=O)=O)=O,,,5,1,1,0,1
15678_0,,,,2,2,1,3
C(CC(C(C(C)C(C)O)=O)=O)=O,,,5,1,1,0,1
15680_0,,,,2,2,1,3
C(CC(C(C(C)CO)=O)=O)=O,,,5,1,3,0,3
15682_0,,,,2,2,1,3
C(CC(C(C(C)C(CO)O)=O)=O)=O,,,5,1,1,0,1
15683_0,,,,2,2,1,3
15685_0,,,,2,2,1,3
C(CC(CC(C(C(C)=O)O)=O)O)=O,,,5,1,1,0,1
15686_0,,,,2,2,1,3
15688_0,,,,2,2,1,3
C(CC(C(C(CC(C)O)=O)O)=O)=O,,,5,1,1,0,1
15689_0,,,,2,2,1,3
15691_0,,,,2,2,1,3
C(C(C(C(C(C)=O)O)=O)C(C)O)=O,,,5,1,2,0,2
15691_1,,,,2,2,1,3
15692_0,,,,2,2,1,3
15692_1,,,,2,2,1,3
15694_0,,,,2,2,1,3
C(C(C=C)C(CCC(C(C)=O)=O)O)=O,,,5,1,1,0,1
15696_0,,,,2,2,1,3
C(CC(CCC(C(C)=O)=O)O)=O,,,5,1,2,0,2
15698_0,,,,2,2,1,3
C(C(C(CCC(C(C)=O)=O)O)O)=O,,,5,1,2,0,2
15698_1,,,,2,2,1,3
15700_0,,,,2,2,1,3
C(CCC(C(C)=O)(C(C=O)C=C)O)=O,,,5,1,1,0,1
15702_0,,,,2,2,1,3
C(C)(C(CCC=O)(CC=O)O)=O,,,5,1,2,0,2
15704_0,,,,2,2,1,3
C(C)(C(CCC=O)(C(C=O)O)O)=O,,,5,1,3,0,3
15704_1,,,,2,2,1,3
15706_0,,,,2,2,1,3
C(C(C=C)C(C(CCC=O)=O)(C)O)=O,,,5,1,1,0,1
15708_0,,,,2,2,1,3
C(CCC=O)(C(C)(CC=O)O)=O,,,5,1,2,0,2
15710_0,,,,2,2,1,3
C(CCC=O)(C(C)(C(C=O)O)O)=O,,,5,1,2,0,2
15710_1,,,,2,2,1,3
15712_0,,,,2,2,1,3
C(C(CC(C(C)=O)=O)C(C=CC)O)=O,,,5,1,1,0,1
15714_0,,,,2,2,1,3
C(C(C(CC=C)O)CC(C(C)=O)=O)=O,,,5,1,1,0,1
15716_0,,,,2,2,1,3
C(C(CC(C(C)=O)=O)C(C=C)O)=O,,,5,1,1,0,1
15718_0,,,,2,2,1,3
C(C(C(C=O)CC(C(C)=O)=O)O)=O,,,5,1,1,0,1
15720_0,,,,2,2,1,3
C(C(C(C)O)CC(C(C)=O)=O)=O,,,5,1,2,0,2
15722_0,,,,2,2,1,3
C(C(CO)CC(C(C)=O)=O)=O,,,5,1,3,0,3
15724_0,,,,2,2,1,3
C(C(C(CO)O)CC(C(C)=O)=O)=O,,,5,1,1,0,1
15726_0,,,,2,2,1,3
C(CC(C(C(C)=O)=O)C(C=CC)O)=O,,,5,1,1,0,1
15728_0,,,,2,2,1,3
C(CC(C(C(C)=O)=O)C(CC=C)O)=O,,,5,1,1,0,1
15730_0,,,,2,2,1,3
C(CC(C(C(C)=O)=O)C(C=C)O)=O,,,5,1,1,0,1
15732_0,,,,2,2,1,3
C(CC(C(C(C)=O)=O)C(C=O)O)=O,,,5,1,1,0,1
15734_0,,,,2,2,1,3
C(CC(C(C(C)=O)=O)C(C)O)=O,,,5,1,1,0,1
15736_0,,,,2,2,1,3
C(CC(C(C(C)=O)=O)CO)=O,,,5,1,3,0,3
15738_0,,,,2,2,1,3
C(CC(C(C(C)=O)=O)C(CO)O)=O,,,5,1,1,0,1
15740_0,,,,2,2,1,3
C(CCC(C(CC(C=CC)O)=O)=O)=O,,,5,1,1,0,1
15742_0,,,,2,2,1,3
C(CCC(C(CC(CC=C)O)=O)=O)=O,,,5,1,1,0,1
15744_0,,,,2,2,1,3
C(CCC(C(CC(C=C)O)=O)=O)=O,,,5,1,1,0,1
15746_0,,,,2,2,1,3
C(CCC(C(CC(C=O)O)=O)=O)=O,,,5,1,1,0,1
15748_0,,,,2,2,1,3
C(CCC(C(CC(C)O)=O)=O)=O,,,5,1,2,0,2
15750_0,,,,2,2,1,3
C(CCC(C(CCO)=O)=O)=O,,,5,1,4,0,4
15752_0,,,,2,2,1,3
C(CCC(C(CC(CO)O)=O)=O)=O,,,5,1,1,0,1
15754_0,,,,2,2,1,3
C(CC(C(CC(C(C)=O)=O)O)O)=O,,,5,1,2,0,2
15756_0,,,,2,2,1,3
C(C)(C(CC(C=O)O)(CC=O)O)=O,,,5,1,1,0,1
15758_0,,,,2,2,1,3
C(CC(C=O)O)(C(C)(CC=O)O)=O,,,5,1,1,0,1
15760_0,,,,2,2,1,3
C(C(C(C(C(C)=O)=O)C(C)O)O)=O,,,5,1,2,0,2
15760_1,,,,2,2,1,3
15762_0,,,,2,2,1,3
C(C(C(C(C(C)=O)=O)CO)O)=O,,,5,1,5,0,5
15762_1,,,,2,2,1,3
15764_0,,,,2,2,1,3
C(C(CC(C(CC(C)O)=O)=O)O)=O,,,5,1,1,0,1
15766_0,,,,2,2,1,3
C(C(CC(C(CCO)=O)=O)O)=O,,,5,1,4,0,4
15767_0,,,,2,2,1,3
15768_0,,,,2,2,1,3
15769_0,,,,2,2,1,3
15771_0,,,,2,2,1,3
C(C(C=O)O)(C(C(C)=O)C(C)O)=O,,,5,1,2,0,2
15771_1,,,,2,2,1,3
15773_0,,,,2,2,1,3
C(C(C=O)O)(C(C(C)=O)CO)=O,,,5,1,4,0,4
15773_1,,,,2,2,1,3
15775_0,,,,2,2,1,3
C(C(C=O)O)(CC(CC(C)O)=O)=O,,,5,1,1,0,1
15776_0,,,,2,2,1,3
15778_0,,,,2,2,1,3
C(C(C=C)C(CC(C(C=O)=O)C)O)=O,,,5,1,1,0,1
15780_0,,,,2,2,1,3
C(CC(CC(C(C=O)=O)C)O)=O,,,5,1,2,0,2
15782_0,,,,2,2,1,3
C(C(C(CC(C(C=O)=O)C)O)O)=O,,,5,1,2,0,2
15782_1,,,,2,2,1,3
15784_0,,,,2,2,1,3
C(CC(C)C(C=O)(C(C=O)C=C)O)=O,,,5,1,2,0,2
15786_0,,,,2,2,1,3
C(CC(C)C(C=O)(CC=O)O)=O,,,5,1,2,0,2
15788_0,,,,2,2,1,3
C(CC(C)C(C=O)(C(C=O)O)O)=O,,,5,1,3,0,3
15788_1,,,,2,2,1,3
15790_0,,,,2,2,1,3
C(CC(C(C(C(C=O)C=C)O)=O)C)=O,,,5,1,1,0,1
15792_0,,,,2,2,1,3
C(CC(C(C(C)CC=O)=O)O)=O,,,5,1,2,0,2
15794_0,,,,2,2,1,3
C(CC(C(C(C(C=O)O)O)=O)C)=O,,,5,1,2,0,2
15794_1,,,,2,2,1,3
15796_0,,,,2,2,1,3
C(C(C(C=CC)O)C(C(C=O)=O)C)=O,,,5,1,1,0,1
15798_0,,,,2,2,1,3
C(C(C(CC=C)O)C(C(C=O)=O)C)=O,,,5,1,1,0,1
15800_0,,,,2,2,1,3
C(C(C(C=C)O)C(C(C=O)=O)C)=O,,,5,1,1,0,1
15802_0,,,,2,2,1,3
C(C(C(C=O)C(C(C=O)=O)C)O)=O,,,5,1,1,0,1
15804_0,,,,2,2,1,3
C(C(C(C)O)C(C(C=O)=O)C)=O,,,5,1,2,0,2
15806_0,,,,2,2,1,3
C(C(CO)C(C(C=O)=O)C)=O,,,5,1,3,0,3
15808_0,,,,2,2,1,3
C(C(C(CO)O)C(C(C=O)=O)C)=O,,,5,1,1,0,1
15810_0,,,,2,2,1,3
C(C(C(C)C(C=O)(CC=O)O)O)=O,,,5,1,1,0,1
15812_0,,,,2,2,1,3
C(CC(C(C(C)C(C=O)O)=O)O)=O,,,5,1,1,0,1
15814_0,,,,2,2,1,3
C(CC(C(C(C(C=O)=O)C)O)O)=O,,,5,1,2,0,2
15816_0,,,,2,2,1,3
C(C(CC)(C(C(C=O)=O)C)O)=O,,,5,1,1,0,1
15818_0,,,,2,2,1,3
C(CC(C=O)C(C=O)(CC)O)=O,,,5,1,1,0,1
15820_0,,,,2,2,1,3
C(C(CC)(CC(C(C)=O)=O)O)=O,,,5,1,1,0,1
15822_0,,,,2,2,1,3
C(C(CC)(C(C(C(O)=O)=O)C)O)=O,,,5,1,1,0,1
15824_0,,,,2,2,1,3
C(C(CC)(C(C(O)=O)C(C)=O)O)=O,,,5,1,2,0,2
15824_1,,,,2,2,1,3
15826_0,,,,2,2,1,3
C(C(CC)(CC(CC(O)=O)=O)O)=O,,,5,1,1,0,1
15828_0,,,,2,2,1,3
C(C(CC)(C1C(C(OC1)=O)=O)O)=O,,,5,1,2,0,2
15828_1,,,,2,2,1,3
15830_0,,,,2,2,1,3
C(C(CC)(C1C(OCC1=O)=O)O)=O,,,5,1,2,0,2
15830_1,,,,2,2,1,3
15832_0,,,,2,2,1,3
C(C(CC)(C1C(CC(O1)=O)=O)O)=O,,,5,1,2,0,2
15832_1,,,,2,2,1,3
15834_0,,,,2,2,1,3
C(C(C(C=O)=C)C(C=O)(CC)O)=O,,,5,1,1,0,1
15836_0,,,,2,2,1,3
C(C(CC)(CC(C=CC=O)=O)O)=O,,,5,1,1,0,1
15838_0,,,,2,2,1,3
C(C(CC)(C(C=C)C(C=O)=O)O)=O,,,5,1,1,0,1
15840_0,,,,2,2,1,3
C(C(C=CC=O)C(C=O)(CC)O)=O,,,5,1,1,0,1
15842_0,,,,2,2,1,3
C(C(C=C)C(C=O)(CC)O)=O,,,5,1,1,0,1
15844_0,,,,2,2,1,3
C(C(CC)(C1C(C=CO1)=O)O)=O,,,5,1,2,0,2
15844_1,,,,2,2,1,3
15846_0,,,,2,2,1,3
C(C(CC)(C(C(CO)=O)O)O)=O,,,5,1,2,0,2
15846_1,,,,2,2,1,3
15848_0,,,,2,2,1,3
C(C(CC)(CC(C=O)=O)O)=O,,,5,1,1,0,1
15850_0,,,,2,2,1,3
C(C(C=O)C(C=O)(CC)O)=O,,,5,1,2,0,2
15850_1,,,,2,2,1,3
15852_0,,,,2,2,1,3
C(C(CC)(C(C(C=O)=O)CO)O)=O,,,5,1,2,0,2
15852_1,,,,2,2,1,3
15854_0,,,,2,2,1,3
C(C(C(C=O)C(C=O)(CC)O)O)=O,,,5,1,2,0,2
15854_1,,,,2,2,1,3
15856_0,,,,2,2,1,3
C(C(CC)(C(C=O)C(CO)=O)O)=O,,,5,1,2,0,2
15856_1,,,,2,2,1,3
15858_0,,,,2,2,1,3
C(C(CC)(C(C(CC=O)=O)O)O)=O,,,5,1,2,0,2
15858_1,,,,2,2,1,3
15860_0,,,,2,2,1,3
C(C(CC)(CC(C(C=O)O)=O)O)=O,,,5,1,1,0,1
15862_0,,,,2,2,1,3
C(C(CC)(CC=O)O)=O,,,5,1,1,0,1
15864_0,,,,2,2,1,3
C(C(C(C)O)C(C=O)(CC)O)=O,,,5,1,2,0,2
15864_1,,,,2,2,1,3
15866_0,,,,2,2,1,3
C(C(CO)C(C=O)(CC)O)=O,,,5,1,2,0,2
15866_1,,,,2,2,1,3
15868_0,,,,2,2,1,3
C(C(C(CO)O)C(C=O)(CC)O)=O,,,5,1,2,0,2
15868_1,,,,2,2,1,3
15870_0,,,,2,2,1,3
C(C(CC)(C(C(C=O)=O)O)O)=O,,,5,1,2,0,2
15870_1,,,,2,2,1,3
15872_0,,,,2,2,1,3
C(C(CC)(C(C(C(C)=O)=O)O)O)=O,,,5,1,2,0,2
15872_1,,,,2,2,1,3
15874_0,,,,2,2,1,3
C(C(CC)(CC(C(CO)=O)=O)O)=O,,,5,1,1,0,1
15876_0,,,,2,2,1,3
C(C(CC)(C(C(C)=O)O)O)=O,,,5,1,2,0,2
15876_1,,,,2,2,1,3
15878_0,,,,2,2,1,3
C(C(CC)(CC(CO)=O)O)=O,,,5,1,1,0,1
15880_0,,,,2,2,1,3
C(C(CC)(C(C(CCO)=O)O)O)=O,,,5,1,2,0,2
15880_1,,,,2,2,1,3
15882_0,,,,2,2,1,3
C(C(CC)(C(C(CO)=O)CO)O)=O,,,5,1,2,0,2
15882_1,,,,2,2,1,3
15884_0,,,,2,2,1,3
C(C(CC)(CC(C(CO)O)=O)O)=O,,,5,1,1,0,1
15886_0,,,,2,2,1,3
C(C(CC)(CC(C(O)=O)=O)O)=O,,,5,1,1,0,1
15888_0,,,,2,2,1,3
C(C(C=O)C(C=O)(CC)O)(O)=O,,,5,1,2,0,2
15888_1,,,,2,2,1,3
15890_0,,,,2,2,1,3
C(C(CC)(C1C(C(CO1)O)=O)O)=O,,,5,1,2,0,2
15890_1,,,,2,2,1,3
15892_0,,,,2,2,1,3
C(C(CC)(C1C(C(O)OC1)=O)O)=O,,,5,1,2,0,2
15892_1,,,,2,2,1,3
15894_0,,,,2,2,1,3
C(C(CC)(C1C(COC1O)=O)O)=O,,,5,1,2,0,2
15894_1,,,,2,2,1,3
15896_0,,,,2,2,1,3
C(C(CC)(C1C(CC(O1)O)=O)O)=O,,,5,1,2,0,2
15896_1,,,,2,2,1,3
15898_0,,,,2,2,1,3
C(C(CC)(C(C=O)O)O)=O,,,5,1,3,0,3
15898_1,,,,2,2,1,3
15900_0,,,,2,2,1,3
C(C(C(C(C=O)=O)C)O)(CC)=O,,,5,1,1,0,1
15902_0,,,,2,2,1,3
C(C(C(C=O)CC=O)O)(CC)=O,,,5,1,1,0,1
15904_0,,,,2,2,1,3
C(C(CC(C(C)=O)=O)O)(CC)=O,,,5,1,1,0,1
15906_0,,,,2,2,1,3
C(C(C(C(C(O)=O)=O)C)O)(CC)=O,,,5,1,1,0,1
15908_0,,,,2,2,1,3
C(C)(C(C(O)=O)C(C(CC)=O)O)=O,,,5,1,2,0,2
15908_1,,,,2,2,1,3
15910_0,,,,2,2,1,3
C(CC(C(CC)=O)O)(CC(O)=O)=O,,,5,1,1,0,1
15912_0,,,,2,2,1,3
C(C(C1C(C(OC1)=O)=O)O)(CC)=O,,,5,1,2,0,2
15912_1,,,,2,2,1,3
15914_0,,,,2,2,1,3
C1(COC(C1C(C(CC)=O)O)=O)=O,,,5,1,2,0,2
15914_1,,,,2,2,1,3
15916_0,,,,2,2,1,3
C(C(C1C(CC(O1)=O)=O)O)(CC)=O,,,5,1,2,0,2
15916_1,,,,2,2,1,3
15918_0,,,,2,2,1,3
C(C(C(C=O)=C)C(C(CC)=O)O)=O,,,5,1,1,0,1
15920_0,,,,2,2,1,3
C(C(CC(C=CC=O)=O)O)(CC)=O,,,5,1,1,0,1
15922_0,,,,2,2,1,3
C(C(C(C=C)C(C=O)=O)O)(CC)=O,,,5,1,1,0,1
15924_0,,,,2,2,1,3
C(C(C=CC=O)C(C(CC)=O)O)=O,,,5,1,1,0,1
15926_0,,,,2,2,1,3
C(C(C=C)C(C(CC)=O)O)=O,,,5,1,1,0,1
15928_0,,,,2,2,1,3
C(C(C1C(C=CO1)=O)O)(CC)=O,,,5,1,2,0,2
15928_1,,,,2,2,1,3
15930_0,,,,2,2,1,3
C(C(C(C(CC)=O)O)O)(CO)=O,,,5,1,3,0,3
15930_1,,,,2,2,1,3
15932_0,,,,2,2,1,3
C(C(CC(C=O)=O)O)(CC)=O,,,5,1,2,0,2
15934_0,,,,2,2,1,3
C(C(C=O)C(C(CC)=O)O)=O,,,5,1,3,0,3
15934_1,,,,2,2,1,3
15936_0,,,,2,2,1,3
C(C(C(C(C=O)=O)CO)O)(CC)=O,,,5,1,2,0,2
15936_1,,,,2,2,1,3
15938_0,,,,2,2,1,3
C(C(C(C=O)C(C=O)O)O)(CC)=O,,,5,1,2,0,2
15938_1,,,,2,2,1,3
15940_0,,,,2,2,1,3
C(CO)(C(C=O)C(C(CC)=O)O)=O,,,5,1,2,0,2
15940_1,,,,2,2,1,3
15942_0,,,,2,2,1,3
C(CC(C(C(C(CC)=O)O)O)=O)=O,,,5,1,2,0,2
15942_1,,,,2,2,1,3
15944_0,,,,2,2,1,3
C(CC(C(CC)=O)O)(C(C=O)O)=O,,,5,1,1,0,1
15946_0,,,,2,2,1,3
C(CC(C(CC)=O)O)=O,,,5,1,2,0,2
15948_0,,,,2,2,1,3
C(C(C(C)O)C(C(CC)=O)O)=O,,,5,1,3,0,3
15948_1,,,,2,2,1,3
15950_0,,,,2,2,1,3
C(C(CO)C(C(CC)=O)O)=O,,,5,1,3,0,3
15950_1,,,,2,2,1,3
15952_0,,,,2,2,1,3
C(C(C(CO)O)C(C(CC)=O)O)=O,,,5,1,2,0,2
15952_1,,,,2,2,1,3
15954_0,,,,2,2,1,3
C(C(C(C(C=O)=O)O)O)(CC)=O,,,5,1,3,0,3
15954_1,,,,2,2,1,3
15956_0,,,,2,2,1,3
C(C(C(C(C(C)=O)=O)O)O)(CC)=O,,,5,1,2,0,2
15956_1,,,,2,2,1,3
15958_0,,,,2,2,1,3
C(C(CC(C(CO)=O)=O)O)(CC)=O,,,5,1,1,0,1
15960_0,,,,2,2,1,3
C(C(C(C(CC)=O)O)O)(C)=O,,,5,1,3,0,3
15960_1,,,,2,2,1,3
15962_0,,,,2,2,1,3
C(CC(C(CC)=O)O)(CO)=O,,,5,1,2,0,2
15964_0,,,,2,2,1,3
C(C(C(C(CC)=O)O)O)(CCO)=O,,,5,1,2,0,2
15964_1,,,,2,2,1,3
15966_0,,,,2,2,1,3
C(CO)(C(CO)C(C(CC)=O)O)=O,,,5,1,2,0,2
15966_1,,,,2,2,1,3
15968_0,,,,2,2,1,3
C(CC(C(CC)=O)O)(C(CO)O)=O,,,5,1,1,0,1
15970_0,,,,2,2,1,3
C(C(CC(C(O)=O)=O)O)(CC)=O,,,5,1,2,0,2
15972_0,,,,2,2,1,3
C(C(C=O)C(C(CC)=O)O)(O)=O,,,5,1,3,0,3
15972_1,,,,2,2,1,3
15974_0,,,,2,2,1,3
C(C(C1C(C(CO1)O)=O)O)(CC)=O,,,5,1,2,0,2
15974_1,,,,2,2,1,3
15976_0,,,,2,2,1,3
C(C(C1C(C(O)OC1)=O)O)(CC)=O,,,5,1,2,0,2
15976_1,,,,2,2,1,3
15978_0,,,,2,2,1,3
C1(COC(C1C(C(CC)=O)O)O)=O,,,5,1,2,0,2
15978_1,,,,2,2,1,3
15980_0,,,,2,2,1,3
C(C(C1C(CC(O1)O)=O)O)(CC)=O,,,5,1,2,0,2
15980_1,,,,2,2,1,3
15982_0,,,,2,2,1,3
C(C(C(C=O)O)O)(CC)=O,,,5,1,4,0,4
15982_1,,,,2,2,1,3
15984_0,,,,2,2,1,3
C(CCC(C(C(C=O)=O)C)O)=O,,,5,1,1,0,1
15986_0,,,,2,2,1,3
C(C)(C(C)(C(C(C=O)=O)C)O)=O,,,5,1,1,0,1
15988_0,,,,2,2,1,3
C(C(CC)(C(C(C=O)=O)C)O)(O)=O,,,5,1,1,0,1
15990_0,,,,2,2,1,3
C(CC(C)(C(C(C=O)=O)C)O)(O)=O,,,5,1,1,0,1
15992_0,,,,2,2,1,3
C1(C(CCO1)(C(C(C=O)=O)C)O)=O,,,5,1,1,0,1
15994_0,,,,2,2,1,3
C1(CC(CO1)(C(C(C=O)=O)C)O)=O,,,5,1,1,0,1
15996_0,,,,2,2,1,3
C(C(C=CC=O)(C(C(C=O)=O)C)O)=O,,,5,1,1,0,1
15998_0,,,,2,2,1,3
C(C=O)(C(C)C(C(C=CC=O)=O)O)=O,,,5,1,1,0,1
16000_0,,,,2,2,1,3
C(C(C(C(C=O)=O)C)O)=CC(C=O)=O,,,5,1,1,0,1
16002_0,,,,2,2,1,3
C(C=O)(C(C)C(C(C=O)=CC=O)O)=O,,,5,1,1,0,1
16004_0,,,,2,2,1,3
C(C(C(C(C=O)=O)C)O)=C(C=O)C=O,,,5,1,1,0,1
16006_0,,,,2,2,1,3
C(C(C(C(C=O)=O)C)O)=C(C=O)C,,,5,1,1,0,1
16008_0,,,,2,2,1,3
C(C(C(C(C=O)=O)C)O)(C)=CC=O,,,5,1,1,0,1
16010_0,,,,2,2,1,3
C=C(C=O)CC(C(C(C=O)=O)C)O,,,5,1,1,0,1
16012_0,,,,2,2,1,3
C(CC(C(C(C(C=O)=O)C)O)=C)=O,,,5,1,1,0,1
16014_0,,,,2,2,1,3
C(C(C(C(C=O)=O)C)O)=CC(C)=O,,,5,1,1,0,1
16016_0,,,,2,2,1,3
C(C(C)(C(C(C=O)=O)C)O)=CC=O,,,5,1,1,0,1
16018_0,,,,2,2,1,3
C(C(CC=C)(C(C(C=O)=O)C)O)=O,,,5,1,1,0,1
16020_0,,,,2,2,1,3
C(C(C(C(C=O)=O)C)O)(CC=C)=O,,,5,1,1,0,1
16022_0,,,,2,2,1,3
C(C(C=CC)(C(C(C=O)=O)C)O)=O,,,5,1,1,0,1
16024_0,,,,2,2,1,3
C(C)=CC(C(C(C(C=O)=O)C)O)=O,,,5,1,1,0,1
16026_0,,,,2,2,1,3
C(CC=CC(C(C(C=O)=O)C)O)=O,,,5,1,1,0,1
16028_0,,,,2,2,1,3
C(CC(C(C(C=O)=O)C)O)=CC=O,,,5,1,1,0,1
16029_0,,,,2,2,1,3
16031_0,,,,2,2,1,3
C(C)=C(C=O)C(C(C(C=O)=O)C)O,,,5,1,1,0,1
16033_0,,,,2,2,1,3
C=C(C=O)C(C(C(C=O)=O)C)O,,,5,1,1,0,1
16035_0,,,,2,2,1,3
C(C)=CC(C(C(C=O)=O)C)O,,,5,1,1,0,1
16037_0,,,,2,2,1,3
C=CCC(C(C(C=O)=O)C)O,,,5,1,1,0,1
16039_0,,,,2,2,1,3
C=CC(C(C(C(C=O)=O)C)O)O,,,5,1,1,0,1
16041_0,,,,2,2,1,3
C=CC(C(C(C=O)=O)C)O,,,5,1,1,0,1
16043_0,,,,2,2,1,3
C1OCC(C=1)(C(C(C=O)=O)C)O,,,5,1,1,0,1
16045_0,,,,2,2,1,3
C(C(C(C)C(C(CO)O)O)=O)=O,,,5,1,1,0,1
16046_0,,,,2,2,1,3
16048_0,,,,2,2,1,3
C(C(C(C)C(CO)(CO)O)=O)=O,,,5,1,3,0,3
16050_0,,,,2,2,1,3
C(C(C)(C(C(C=O)=O)C)O)=O,,,5,1,1,0,1
16052_0,,,,2,2,1,3
C(C(C(C(C=O)=O)C)O)(C)=O,,,5,1,2,0,2
16053_0,,,,2,2,1,3
16055_0,,,,2,2,1,3
C(C(CCO)(C(C(C=O)=O)C)O)=O,,,5,1,1,0,1
16057_0,,,,2,2,1,3
C(C(C(C(C=O)=O)C)O)(CCO)=O,,,5,1,1,0,1
16058_0,,,,2,2,1,3
16060_0,,,,2,2,1,3
C(C(CC(C(C(C=O)=O)C)O)O)=O,,,5,1,1,0,1
16061_0,,,,2,2,1,3
16063_0,,,,2,2,1,3
C(CC(CO)(C(C(C=O)=O)C)O)=O,,,5,1,1,0,1
16064_0,,,,2,2,1,3
16066_0,,,,2,2,1,3
C(C(C(C)(C(C(C=O)=O)C)O)O)=O,,,5,1,1,0,1
16068_0,,,,2,2,1,3
C(C(C(C)C(C)O)=O)=O,,,5,1,1,0,1
16069_0,,,,2,2,1,3
16071_0,,,,2,2,1,3
C(C(C(C)C(CC(C)O)O)=O)=O,,,5,1,1,0,1
16073_0,,,,2,2,1,3
C(C(C(C)C(C(C(C)O)O)O)=O)=O,,,5,1,1,0,1
16075_0,,,,2,2,1,3
C(C(C(C)C(CCO)O)=O)=O,,,5,1,1,0,1
16077_0,,,,2,2,1,3
C(C(C(C)C(CC(CO)O)O)=O)=O,,,5,1,1,0,1
16078_0,,,,2,2,1,3
16079_0,,,,2,2,1,3
16081_0,,,,2,2,1,3
C(C)(C(CO)(C(C(C=O)=O)C)O)=O,,,5,1,1,0,1
16083_0,,,,2,2,1,3
C(CO)(C(C)(C(C(C=O)=O)C)O)=O,,,5,1,1,0,1
16085_0,,,,2,2,1,3
C(C(C(C)O)(C(C(C=O)=O)C)O)=O,,,5,1,2,0,2
16087_0,,,,2,2,1,3
C(C(C(C(C=O)=O)C)O)(C(C)O)=O,,,5,1,1,0,1
16089_0,,,,2,2,1,3
C(C(C(C)C(C)(CO)O)=O)=O,,,5,1,1,0,1
16091_0,,,,2,2,1,3
C(C(C(C)C(CO)(CCO)O)=O)=O,,,5,1,1,0,1
16093_0,,,,2,2,1,3
C(C(C(C)C(C(CCO)O)O)=O)=O,,,5,1,1,0,1
16095_0,,,,2,2,1,3
C(C(C(C)C(C)(C(CO)O)O)=O)=O,,,5,1,1,0,1
16096_0,,,,2,2,1,3
16098_0,,,,2,2,1,3
C(C(C)(C(C(C=O)=O)C)O)(O)=O,,,5,1,2,0,2
16100_0,,,,2,2,1,3
C(CC(C(C(C=O)=O)C)O)(O)=O,,,5,1,1,0,1
16102_0,,,,2,2,1,3
C(C(C(C)C1(COCC1O)O)=O)=O,,,5,1,1,0,1
16104_0,,,,2,2,1,3
C(C(C(C)C1(C(O)OCC1)O)=O)=O,,,5,1,1,0,1
16106_0,,,,2,2,1,3
C(C(C(C)C1(COC(C1)O)O)=O)=O,,,5,1,1,0,1
16108_0,,,,2,2,1,3
C(C(C=C)(C(C(C=O)=O)C)O)=O,,,5,1,1,0,1
16110_0,,,,2,2,1,3
C=CC(C(C(C(C=O)=O)C)O)=O,,,5,1,1,0,1
16112_0,,,,2,2,1,3
C(C(C(C(C=O)=O)C)O)=CC=O,,,5,1,1,0,1
16114_0,,,,2,2,1,3
C(C(C(C)CO)=O)=O,,,5,1,3,0,3
16116_0,,,,2,2,1,3
C(C(C(C)C(CO)O)=O)=O,,,5,1,4,0,4
16118_0,,,,2,2,1,3
C(C(C=C)C(CCC=O)(CO)O)=O,,,5,1,1,0,1
16120_0,,,,2,2,1,3
C(CCC(CO)(CC(C=O)=O)O)=O,,,5,1,2,0,2
16122_0,,,,2,2,1,3
C(C(C=O)C(CCC=O)(CO)O)=O,,,5,1,3,0,3
16122_1,,,,2,2,1,3
16124_0,,,,2,2,1,3
C(CCC(CO)(CC=O)O)=O,,,5,1,2,0,2
16126_0,,,,2,2,1,3
C(C(CO)C(CCC=O)(CO)O)=O,,,5,1,3,0,3
16126_1,,,,2,2,1,3
16128_0,,,,2,2,1,3
C(CCC(CO)(C(C(C)=O)O)O)=O,,,5,1,3,0,3
16128_1,,,,2,2,1,3
16130_0,,,,2,2,1,3
C(CCC(CO)(CC(CO)=O)O)=O,,,5,1,2,0,2
16132_0,,,,2,2,1,3
C(CCC(CO)(C(C=O)O)O)=O,,,5,1,3,0,3
16132_1,,,,2,2,1,3
16134_0,,,,2,2,1,3
C(C(C=C)C(CCC(CO)=O)O)=O,,,5,1,1,0,1
16136_0,,,,2,2,1,3
C(CO)(CCC(CC(C=O)=O)O)=O,,,5,1,3,0,3
16138_0,,,,2,2,1,3
C(C(C=O)C(CCC(CO)=O)O)=O,,,5,1,4,0,4
16138_1,,,,2,2,1,3
16140_0,,,,2,2,1,3
C(CC(CCC(CO)=O)O)=O,,,5,1,4,0,4
16142_0,,,,2,2,1,3
C(C(CO)C(CCC(CO)=O)O)=O,,,5,1,3,0,3
16142_1,,,,2,2,1,3
16144_0,,,,2,2,1,3
C(C)(C(C(CCC(CO)=O)O)O)=O,,,5,1,4,0,4
16144_1,,,,2,2,1,3
16146_0,,,,2,2,1,3
C(CO)(CC(CCC(CO)=O)O)=O,,,5,1,3,0,3
16148_0,,,,2,2,1,3
C(C(C(CCC(CO)=O)O)O)=O,,,5,1,6,0,6
16148_1,,,,2,2,1,3
16150_0,,,,2,2,1,3
C(CC(C(CO)=O)C(C=CC)O)=O,,,5,1,1,0,1
16152_0,,,,2,2,1,3
C(CO)(C(C(CC=C)O)CC=O)=O,,,5,1,1,0,1
16154_0,,,,2,2,1,3
C(CC(C(CO)=O)C(C=C)O)=O,,,5,1,1,0,1
16156_0,,,,2,2,1,3
C(CC(C(CO)=O)C(C=O)O)=O,,,5,1,4,0,4
16158_0,,,,2,2,1,3
C(CC(C(CO)=O)C(C=O)(C)O)=O,,,5,1,2,0,2
16160_0,,,,2,2,1,3
C(CC(C(CO)=O)C(C(C)=O)O)=O,,,5,1,2,0,2
16161_0,,,,2,2,1,3
16163_0,,,,2,2,1,3
C(CO)(C(C(C)O)CC=O)=O,,,5,1,2,0,2
16165_0,,,,2,2,1,3
C(CO)(C(C(CCO)O)CC=O)=O,,,5,1,2,0,2
16167_0,,,,2,2,1,3
C(CO)(C(C(CO)(C)O)CC=O)=O,,,5,1,1,0,1
16169_0,,,,2,2,1,3
C(C(C(C(CO)=O)CC=O)O)(O)=O,,,5,1,2,0,2
16170_0,,,,2,2,1,3
16172_0,,,,2,2,1,3
C(CO)(C(C(CO)O)CC=O)=O,,,5,1,3,0,3
16174_0,,,,2,2,1,3
C(CCC(C(C(C=CC)O)O)=O)=O,,,5,1,2,0,2
16174_1,,,,2,2,1,3
16176_0,,,,2,2,1,3
C(CCC=O)(C(C(CC=C)O)O)=O,,,5,1,2,0,2
16176_1,,,,2,2,1,3
16178_0,,,,2,2,1,3
C(CCC(C(C(C=C)O)O)=O)=O,,,5,1,2,0,2
16178_1,,,,2,2,1,3
16179_0,,,,2,2,1,3
16179_1,,,,2,2,1,3
16181_0,,,,2,2,1,3
C(CCC(C(C(C=O)(C)O)O)=O)=O,,,5,1,3,0,3
16181_1,,,,2,2,1,3
16182_0,,,,2,2,1,3
16182_1,,,,2,2,1,3
16183_0,,,,2,2,1,3
16183_1,,,,2,2,1,3
16185_0,,,,2,2,1,3
C(CCC=O)(C(C(C)O)O)=O,,,5,1,2,0,2
16185_1,,,,2,2,1,3
16187_0,,,,2,2,1,3
C(CCC=O)(C(C(CCO)O)O)=O,,,5,1,2,0,2
16187_1,,,,2,2,1,3
16189_0,,,,2,2,1,3
C(CCC=O)(C(C(CO)(C)O)O)=O,,,5,1,2,0,2
16189_1,,,,2,2,1,3
16191_0,,,,2,2,1,3
C(C(C(C(CCC=O)=O)O)O)(O)=O,,,5,1,3,0,3
16191_1,,,,2,2,1,3
16192_0,,,,2,2,1,3
16192_1,,,,2,2,1,3
16193_0,,,,2,2,1,3
16193_1,,,,2,2,1,3
16195_0,,,,2,2,1,3
C(C(CC(CO)=O)C(C=CC)O)=O,,,5,1,1,0,1
16197_0,,,,2,2,1,3
C(C(C(CC=C)O)CC(CO)=O)=O,,,5,1,1,0,1
16199_0,,,,2,2,1,3
C(C(CC(CO)=O)C(C=C)O)=O,,,5,1,1,0,1
16200_0,,,,2,2,1,3
16202_0,,,,2,2,1,3
C(CC(C=O)C(C=O)(C)O)(CO)=O,,,5,1,2,0,2
16204_0,,,,2,2,1,3
C(C(CC(CO)=O)C(C(C)=O)O)=O,,,5,1,2,0,2
16205_0,,,,2,2,1,3
16207_0,,,,2,2,1,3
C(C(C(C)O)CC(CO)=O)=O,,,5,1,3,0,3
16209_0,,,,2,2,1,3
C(C(C(CCO)O)CC(CO)=O)=O,,,5,1,2,0,2
16211_0,,,,2,2,1,3
C(C(C(CO)(C)O)CC(CO)=O)=O,,,5,1,1,0,1
16213_0,,,,2,2,1,3
C(C(C(C=O)CC(CO)=O)O)(O)=O,,,5,1,3,0,3
16215_0,,,,2,2,1,3
C(C(CO)CC(CO)=O)=O,,,5,1,6,0,6
16217_0,,,,2,2,1,3
C(C(C(CO)O)CC(CO)=O)=O,,,5,1,7,0,7
16219_0,,,,2,2,1,3
C(C(C=C)C(CCO)(CC=O)O)=O,,,5,1,1,0,1
16220_0,,,,2,2,1,3
16221_0,,,,2,2,1,3
16221_1,,,,2,2,1,3
16223_0,,,,2,2,1,3
C(CC(CCO)(CC=O)O)=O,,,5,1,1,0,1
16225_0,,,,2,2,1,3
C(C(CO)C(CCO)(CC=O)O)=O,,,5,1,2,0,2
16225_1,,,,2,2,1,3
16227_0,,,,2,2,1,3
C(CC(CCO)(C(C(C)=O)O)O)=O,,,5,1,2,0,2
16227_1,,,,2,2,1,3
16229_0,,,,2,2,1,3
C(CC(CCO)(CC(CO)=O)O)=O,,,5,1,1,0,1
16230_0,,,,2,2,1,3
16230_1,,,,2,2,1,3
16232_0,,,,2,2,1,3
C(C(C=C)C(CC(CCO)=O)O)=O,,,5,1,1,0,1
16234_0,,,,2,2,1,3
C(CCO)(CC(CC(C=O)=O)O)=O,,,5,1,1,0,1
16236_0,,,,2,2,1,3
C(C(C=O)C(CC(CCO)=O)O)=O,,,5,1,2,0,2
16236_1,,,,2,2,1,3
16238_0,,,,2,2,1,3
C(CC(CC(CCO)=O)O)=O,,,5,1,2,0,2
16240_0,,,,2,2,1,3
C(C(CO)C(CC(CCO)=O)O)=O,,,5,1,2,0,2
16240_1,,,,2,2,1,3
16242_0,,,,2,2,1,3
C(CCO)(CC(C(C(C)=O)O)O)=O,,,5,1,2,0,2
16242_1,,,,2,2,1,3
16244_0,,,,2,2,1,3
C(CCO)(CC(CC(CO)=O)O)=O,,,5,1,1,0,1
16246_0,,,,2,2,1,3
C(CCO)(CC(C(C=O)O)O)=O,,,5,1,3,0,3
16246_1,,,,2,2,1,3
16248_0,,,,2,2,1,3
C(C(CO)C(C=CC)O)(CC=O)=O,,,5,1,2,0,2
16248_1,,,,2,2,1,3
16250_0,,,,2,2,1,3
C(C(CO)C(CC=C)O)(CC=O)=O,,,5,1,2,0,2
16250_1,,,,2,2,1,3
16252_0,,,,2,2,1,3
C(C(CO)C(C=C)O)(CC=O)=O,,,5,1,2,0,2
16252_1,,,,2,2,1,3
16253_0,,,,2,2,1,3
16253_1,,,,2,2,1,3
16255_0,,,,2,2,1,3
C(C(CO)C(C=O)(C)O)(CC=O)=O,,,5,1,2,0,2
16255_1,,,,2,2,1,3
16257_0,,,,2,2,1,3
C(C(CO)C(C(C)=O)O)(CC=O)=O,,,5,1,2,0,2
16257_1,,,,2,2,1,3
16259_0,,,,2,2,1,3
C(C(CO)C(CC=O)O)(CC=O)=O,,,5,1,3,0,3
16259_1,,,,2,2,1,3
16261_0,,,,2,2,1,3
C(CC(C(CO)C(C)O)=O)=O,,,5,1,3,0,3
16261_1,,,,2,2,1,3
16263_0,,,,2,2,1,3
C(CC(C(CO)C(CCO)O)=O)=O,,,5,1,2,0,2
16263_1,,,,2,2,1,3
16265_0,,,,2,2,1,3
C(CC(C(CO)C(C)(CO)O)=O)=O,,,5,1,2,0,2
16265_1,,,,2,2,1,3
16267_0,,,,2,2,1,3
C(C(CO)C(C(O)=O)O)(CC=O)=O,,,5,1,4,0,4
16267_1,,,,2,2,1,3
16268_0,,,,2,2,1,3
16268_1,,,,2,2,1,3
16269_0,,,,2,2,1,3
16269_1,,,,2,2,1,3
16271_0,,,,2,2,1,3
C(CCO)(C(C=O)C(C=CC)O)=O,,,5,1,2,0,2
16271_1,,,,2,2,1,3
16273_0,,,,2,2,1,3
C(C(C(CCO)=O)C(CC=C)O)=O,,,5,1,2,0,2
16273_1,,,,2,2,1,3
16275_0,,,,2,2,1,3
C(CCO)(C(C=O)C(C=C)O)=O,,,5,1,2,0,2
16275_1,,,,2,2,1,3
16276_0,,,,2,2,1,3
16276_1,,,,2,2,1,3
16278_0,,,,2,2,1,3
C(CCO)(C(C=O)C(C=O)(C)O)=O,,,5,1,2,0,2
16278_1,,,,2,2,1,3
16280_0,,,,2,2,1,3
C(CCO)(C(C=O)C(C(C)=O)O)=O,,,5,1,2,0,2
16280_1,,,,2,2,1,3
16281_0,,,,2,2,1,3
16281_1,,,,2,2,1,3
16283_0,,,,2,2,1,3
C(C(C(CCO)=O)C(C)O)=O,,,5,1,4,0,4
16283_1,,,,2,2,1,3
16285_0,,,,2,2,1,3
C(C(C(CCO)=O)C(CCO)O)=O,,,5,1,2,0,2
16285_1,,,,2,2,1,3
16287_0,,,,2,2,1,3
C(C(C(CCO)=O)C(C)(CO)O)=O,,,5,1,2,0,2
16287_1,,,,2,2,1,3
16289_0,,,,2,2,1,3
C(CCO)(C(C=O)C(C(O)=O)O)=O,,,5,1,3,0,3
16289_1,,,,2,2,1,3
16291_0,,,,2,2,1,3
C(C(C(CCO)=O)CO)=O,,,5,1,8,0,8
16291_1,,,,2,2,1,3
16293_0,,,,2,2,1,3
C(C(C(CCO)=O)C(CO)O)=O,,,5,1,7,0,7
16293_1,,,,2,2,1,3
16295_0,,,,2,2,1,3
C(CCC(C(CO)O)(CC=O)O)=O,,,5,1,2,0,2
16297_0,,,,2,2,1,3
C(CC(CCC(C(CO)O)=O)O)=O,,,5,1,1,0,1
16299_0,,,,2,2,1,3
C(C(C(C)O)CC=O)(C(CO)O)=O,,,5,1,2,0,2
16300_0,,,,2,2,1,3
16302_0,,,,2,2,1,3
C(C(C(C)O)CC(C(CO)O)=O)=O,,,5,1,2,0,2
16304_0,,,,2,2,1,3
C(C(CO)CC(C(CO)O)=O)=O,,,5,1,6,0,6
16306_0,,,,2,2,1,3
C(CC(CC(CO)O)(CC=O)O)=O,,,5,1,1,0,1
16308_0,,,,2,2,1,3
C(CC(CC(CC(CO)O)=O)O)=O,,,5,1,1,0,1
16310_0,,,,2,2,1,3
C(CC(C(C(CO)O)C(C)O)=O)=O,,,5,1,2,0,2
16310_1,,,,2,2,1,3
16311_0,,,,2,2,1,3
16311_1,,,,2,2,1,3
16313_0,,,,2,2,1,3
C(C(C(CC(CO)O)=O)C(C)O)=O,,,5,1,2,0,2
16313_1,,,,2,2,1,3
16315_0,,,,2,2,1,3
C(C(C(CC(CO)O)=O)CO)=O,,,5,1,7,0,7
16315_1,,,,2,2,1,3
16317_0,,,,2,2,1,3
C(CCC(C(C=O)CC=O)O)=O,,,5,1,2,0,2
16319_0,,,,2,2,1,3
C(CCC(CC(C(C)=O)=O)O)=O,,,5,1,1,0,1
16321_0,,,,2,2,1,3
C(CCC(C(C(C(O)=O)=O)C)O)=O,,,5,1,1,0,1
16323_0,,,,2,2,1,3
C(CCC(C(C(O)=O)C(C)=O)O)=O,,,5,1,3,0,3
16323_1,,,,2,2,1,3
16325_0,,,,2,2,1,3
C(CC(CC(CCC=O)O)=O)(O)=O,,,5,1,1,0,1
16327_0,,,,2,2,1,3
C(CCC(C1C(C(OC1)=O)=O)O)=O,,,5,1,2,0,2
16327_1,,,,2,2,1,3
16329_0,,,,2,2,1,3
C(CCC(C1C(OCC1=O)=O)O)=O,,,5,1,2,0,2
16329_1,,,,2,2,1,3
16331_0,,,,2,2,1,3
C(CCC(C1C(CC(O1)=O)=O)O)=O,,,5,1,3,0,3
16331_1,,,,2,2,1,3
16333_0,,,,2,2,1,3
C(C(C(C=O)=C)C(CCC=O)O)=O,,,5,1,1,0,1
16335_0,,,,2,2,1,3
C(CCC(CC(C=CC=O)=O)O)=O,,,5,1,2,0,2
16337_0,,,,2,2,1,3
C(CCC(C(C=C)C(C=O)=O)O)=O,,,5,1,2,0,2
16339_0,,,,2,2,1,3
C(C(C=CC=O)C(CCC=O)O)=O,,,5,1,1,0,1
16341_0,,,,2,2,1,3
C(C(C=C)C(CCC=O)O)=O,,,5,1,1,0,1
16343_0,,,,2,2,1,3
C(CCC(C1C(C=CO1)=O)O)=O,,,5,1,2,0,2
16343_1,,,,2,2,1,3
16345_0,,,,2,2,1,3
C(CCC(C(C(CO)=O)O)O)=O,,,5,1,4,0,4
16345_1,,,,2,2,1,3
16347_0,,,,2,2,1,3
C(CCC(CC(C=O)=O)O)=O,,,5,1,3,0,3
16349_0,,,,2,2,1,3
C(C(C=O)C(CCC=O)O)=O,,,5,1,4,0,4
16349_1,,,,2,2,1,3
16351_0,,,,2,2,1,3
C(CCC(C(C(C=O)=O)CO)O)=O,,,5,1,3,0,3
16351_1,,,,2,2,1,3
16353_0,,,,2,2,1,3
C(CCC(C(C=O)C(C=O)O)O)=O,,,5,1,3,0,3
16353_1,,,,2,2,1,3
16355_0,,,,2,2,1,3
C(CCC(C(C=O)C(CO)=O)O)=O,,,5,1,3,0,3
16355_1,,,,2,2,1,3
16357_0,,,,2,2,1,3
C(CCC(C(C(CC=O)=O)O)O)=O,,,5,1,3,0,3
16357_1,,,,2,2,1,3
16359_0,,,,2,2,1,3
C(C(C(CC(CCC=O)O)=O)O)=O,,,5,1,2,0,2
16361_0,,,,2,2,1,3
C(CCC(CC=O)O)=O,,,5,1,3,0,3
16363_0,,,,2,2,1,3
C(C(C(C)O)C(CCC=O)O)=O,,,5,1,4,0,4
16363_1,,,,2,2,1,3
16365_0,,,,2,2,1,3
C(C(CO)C(CCC=O)O)=O,,,5,1,4,0,4
16365_1,,,,2,2,1,3
16367_0,,,,2,2,1,3
C(C(C(CO)O)C(CCC=O)O)=O,,,5,1,3,0,3
16367_1,,,,2,2,1,3
16369_0,,,,2,2,1,3
C(CCC(C(C(C=O)=O)O)O)=O,,,5,1,5,0,5
16369_1,,,,2,2,1,3
16371_0,,,,2,2,1,3
C(CCC(C(C(C(C)=O)=O)O)O)=O,,,5,1,3,0,3
16371_1,,,,2,2,1,3
16373_0,,,,2,2,1,3
C(CCC(CC(C(CO)=O)=O)O)=O,,,5,1,2,0,2
16375_0,,,,2,2,1,3
C(CCC(C(C(C)=O)O)O)=O,,,5,1,4,0,4
16375_1,,,,2,2,1,3
16377_0,,,,2,2,1,3
C(CCC(CC(CO)=O)O)=O,,,5,1,3,0,3
16379_0,,,,2,2,1,3
C(CCC(C(C(CCO)=O)O)O)=O,,,5,1,3,0,3
16379_1,,,,2,2,1,3
16381_0,,,,2,2,1,3
C(CCC(C(C(CO)=O)CO)O)=O,,,5,1,3,0,3
16381_1,,,,2,2,1,3
16383_0,,,,2,2,1,3
C(CCC(CC(C(CO)O)=O)O)=O,,,5,1,2,0,2
16385_0,,,,2,2,1,3
C(CCC(CC(C(O)=O)=O)O)=O,,,5,1,3,0,3
16387_0,,,,2,2,1,3
C(C(C=O)C(CCC=O)O)(O)=O,,,5,1,4,0,4
16387_1,,,,2,2,1,3
16389_0,,,,2,2,1,3
C(CCC(C1C(C(CO1)O)=O)O)=O,,,5,1,3,0,3
16389_1,,,,2,2,1,3
16391_0,,,,2,2,1,3
C(CCC(C1C(C(O)OC1)=O)O)=O,,,5,1,3,0,3
16391_1,,,,2,2,1,3
16393_0,,,,2,2,1,3
C(CCC(C1C(COC1O)=O)O)=O,,,5,1,3,0,3
16393_1,,,,2,2,1,3
16395_0,,,,2,2,1,3
C(CCC(C1C(CC(O1)O)=O)O)=O,,,5,1,3,0,3
16395_1,,,,2,2,1,3
16397_0,,,,2,2,1,3
C(CCC(C(C=O)O)O)=O,,,5,1,7,0,7
16397_1,,,,2,2,1,3
16399_0,,,,2,2,1,3
C(C)(C(C)(C(C=O)CC=O)O)=O,,,5,1,1,0,1
16401_0,,,,2,2,1,3
C(C(CC)(C(C=O)CC=O)O)(O)=O,,,5,1,1,0,1
16403_0,,,,2,2,1,3
C(CC(C)(C(C=O)CC=O)O)(O)=O,,,5,1,3,0,3
16405_0,,,,2,2,1,3
C1(C(CCO1)(C(C=O)CC=O)O)=O,,,5,1,2,0,2
16406_0,,,,2,2,1,3
16408_0,,,,2,2,1,3
C(C(C=CC=O)(C(C=O)CC=O)O)=O,,,5,1,2,0,2
16410_0,,,,2,2,1,3
C(CC(C=O)C(C(C=CC=O)=O)O)=O,,,5,1,2,0,2
16412_0,,,,2,2,1,3
C(CC(C=O)C(C=CC(C=O)=O)O)=O,,,5,1,2,0,2
16414_0,,,,2,2,1,3
C(CC(C=O)C(C(C=O)=CC=O)O)=O,,,5,1,2,0,2
16416_0,,,,2,2,1,3
C(CC(C=O)C(C=C(C=O)C=O)O)=O,,,5,1,2,0,2
16418_0,,,,2,2,1,3
C(CC(C=O)C(C=C(C=O)C)O)=O,,,5,1,1,0,1
16420_0,,,,2,2,1,3
C(CC(C=O)C(C(C)=CC=O)O)=O,,,5,1,1,0,1
16422_0,,,,2,2,1,3
C(C(C(CC(C=O)=C)O)CC=O)=O,,,5,1,1,0,1
16424_0,,,,2,2,1,3
C(CC(C(C(C=O)CC=O)O)=C)=O,,,5,1,1,0,1
16426_0,,,,2,2,1,3
C(CC(C=O)C(C=CC(C)=O)O)=O,,,5,1,1,0,1
16428_0,,,,2,2,1,3
C(CC(C=O)C(C=CC=O)(C)O)=O,,,5,1,1,0,1
16430_0,,,,2,2,1,3
C(CC(C=O)C(C=O)(CC=C)O)=O,,,5,1,1,0,1
16432_0,,,,2,2,1,3
C(CC(C=O)C(C(CC=C)=O)O)=O,,,5,1,1,0,1
16434_0,,,,2,2,1,3
C(C(C=CC)(C(C=O)CC=O)O)=O,,,5,1,1,0,1
16436_0,,,,2,2,1,3
C(CC(C=O)C(C(C=CC)=O)O)=O,,,5,1,1,0,1
16438_0,,,,2,2,1,3
C(CC=CC(C(C=O)CC=O)O)=O,,,5,1,1,0,1
16440_0,,,,2,2,1,3
C(C(C(CC=CC=O)O)CC=O)=O,,,5,1,1,0,1
16441_0,,,,2,2,1,3
16443_0,,,,2,2,1,3
C(CC(C=O)C(C(C=O)=CC)O)=O,,,5,1,1,0,1
16445_0,,,,2,2,1,3
C(CC(C=O)C(C(C=O)=C)O)=O,,,5,1,1,0,1
16447_0,,,,2,2,1,3
C(CC(C=O)C(C=CC)O)=O,,,5,1,1,0,1
16449_0,,,,2,2,1,3
C(C(C(CC=C)O)CC=O)=O,,,5,1,1,0,1
16451_0,,,,2,2,1,3
C(C(C(C(C=C)O)O)CC=O)=O,,,5,1,1,0,1
16453_0,,,,2,2,1,3
C(CC(C=O)C(C=C)O)=O,,,5,1,1,0,1
16455_0,,,,2,2,1,3
C(CC(C=O)C1(C=COC1)O)=O,,,5,1,1,0,1
16456_0,,,,2,2,1,3
16457_0,,,,2,2,1,3
16458_0,,,,2,2,1,3
16460_0,,,,2,2,1,3
C(CC(C=O)C(C=O)(C)O)=O,,,5,1,4,0,4
16461_0,,,,2,2,1,3
16462_0,,,,2,2,1,3
16463_0,,,,2,2,1,3
16464_0,,,,2,2,1,3
16465_0,,,,2,2,1,3
16466_0,,,,2,2,1,3
16467_0,,,,2,2,1,3
16468_0,,,,2,2,1,3
16469_0,,,,2,2,1,3
16470_0,,,,2,2,1,3
16471_0,,,,2,2,1,3
16472_0,,,,2,2,1,3
16474_0,,,,2,2,1,3
C(C(C(CC(C)O)O)CC=O)=O,,,5,1,3,0,3
16476_0,,,,2,2,1,3
C(C(C(C(C(C)O)O)O)CC=O)=O,,,5,1,2,0,2
16478_0,,,,2,2,1,3
C(C(C(CCO)O)CC=O)=O,,,5,1,4,0,4
16480_0,,,,2,2,1,3
C(C(C(CC(CO)O)O)CC=O)=O,,,5,1,3,0,3
16481_0,,,,2,2,1,3
16482_0,,,,2,2,1,3
16483_0,,,,2,2,1,3
16485_0,,,,2,2,1,3
C(CO)(C(C)(C(C=O)CC=O)O)=O,,,5,1,4,0,4
16486_0,,,,2,2,1,3
16488_0,,,,2,2,1,3
C(C(C(C=O)CC=O)O)(C(C)O)=O,,,5,1,3,0,3
16490_0,,,,2,2,1,3
C(C(C(C)(CO)O)CC=O)=O,,,5,1,2,0,2
16492_0,,,,2,2,1,3
C(C(C(CO)(CCO)O)CC=O)=O,,,5,1,4,0,4
16494_0,,,,2,2,1,3
C(C(C(C(CCO)O)O)CC=O)=O,,,5,1,3,0,3
16496_0,,,,2,2,1,3
C(C(C(C)(C(CO)O)O)CC=O)=O,,,5,1,4,0,4
16497_0,,,,2,2,1,3
16498_0,,,,2,2,1,3
16500_0,,,,2,2,1,3
C(CC(C(C=O)CC=O)O)(O)=O,,,5,1,4,0,4
16502_0,,,,2,2,1,3
C(C(C1(COCC1O)O)CC=O)=O,,,5,1,1,0,1
16504_0,,,,2,2,1,3
C(C(C1(C(O)OCC1)O)CC=O)=O,,,5,1,3,0,3
16506_0,,,,2,2,1,3
C(C(C1(COC(C1)O)O)CC=O)=O,,,5,1,3,0,3
16508_0,,,,2,2,1,3
C(C(C=C)(C(C=O)CC=O)O)=O,,,5,1,5,0,5
16510_0,,,,2,2,1,3
C(CC(C=O)C(C(C=C)=O)O)=O,,,5,1,4,0,4
16512_0,,,,2,2,1,3
C(CC(C=O)C(C=CC=O)O)=O,,,5,1,5,0,5
16513_0,,,,2,2,1,3
16514_0,,,,2,2,1,3
16516_0,,,,2,2,1,3
C(C)(C(C)(CC(C(C)=O)=O)O)=O,,,5,1,1,0,1
16518_0,,,,2,2,1,3
C(C)(C(C)(C(C(C(O)=O)=O)C)O)=O,,,5,1,1,0,1
16520_0,,,,2,2,1,3
C(C(C(C)=O)C(C(C)=O)(C)O)(O)=O,,,5,1,2,0,2
16520_1,,,,2,2,1,3
16522_0,,,,2,2,1,3
C(C)(C(C)(CC(CC(O)=O)=O)O)=O,,,5,1,1,0,1
16524_0,,,,2,2,1,3
C(C)(C(C)(C1C(C(OC1)=O)=O)O)=O,,,5,1,2,0,2
16524_1,,,,2,2,1,3
16526_0,,,,2,2,1,3
C(C)(C(C)(C1C(OCC1=O)=O)O)=O,,,5,1,2,0,2
16526_1,,,,2,2,1,3
16528_0,,,,2,2,1,3
C(C)(C(C)(C1C(CC(O1)=O)=O)O)=O,,,5,1,2,0,2
16528_1,,,,2,2,1,3
16530_0,,,,2,2,1,3
C(C(C(C=O)=C)C(C(C)=O)(C)O)=O,,,5,1,1,0,1
16532_0,,,,2,2,1,3
C(C)(C(C)(CC(C=CC=O)=O)O)=O,,,5,1,1,0,1
16534_0,,,,2,2,1,3
C(C)(C(C)(C(C=C)C(C=O)=O)O)=O,,,5,1,1,0,1
16536_0,,,,2,2,1,3
C(C(C=CC=O)C(C(C)=O)(C)O)=O,,,5,1,1,0,1
16538_0,,,,2,2,1,3
C(C(C=C)C(C(C)=O)(C)O)=O,,,5,1,1,0,1
16540_0,,,,2,2,1,3
C(C)(C(C)(C1C(C=CO1)=O)O)=O,,,5,1,2,0,2
16540_1,,,,2,2,1,3
16542_0,,,,2,2,1,3
C(C)(C(C)(C(C(CO)=O)O)O)=O,,,5,1,3,0,3
16542_1,,,,2,2,1,3
16544_0,,,,2,2,1,3
C(C)(C(C)(CC(C=O)=O)O)=O,,,5,1,2,0,2
16546_0,,,,2,2,1,3
C(C(C=O)C(C(C)=O)(C)O)=O,,,5,1,3,0,3
16546_1,,,,2,2,1,3
16548_0,,,,2,2,1,3
C(C)(C(C)(C(C(C=O)=O)CO)O)=O,,,5,1,2,0,2
16548_1,,,,2,2,1,3
16550_0,,,,2,2,1,3
C(C)(C(C)(C(C=O)C(C=O)O)O)=O,,,5,1,2,0,2
16550_1,,,,2,2,1,3
16552_0,,,,2,2,1,3
C(C)(C(C)(C(C=O)C(CO)=O)O)=O,,,5,1,2,0,2
16552_1,,,,2,2,1,3
16554_0,,,,2,2,1,3
C(C)(C(C)(C(C(CC=O)=O)O)O)=O,,,5,1,2,0,2
16554_1,,,,2,2,1,3
16556_0,,,,2,2,1,3
C(C)(C(C)(CC(C(C=O)O)=O)O)=O,,,5,1,1,0,1
16558_0,,,,2,2,1,3
C(C)(C(C)(CC=O)O)=O,,,5,1,2,0,2
16560_0,,,,2,2,1,3
C(C(C(C)O)C(C(C)=O)(C)O)=O,,,5,1,3,0,3
16560_1,,,,2,2,1,3
16562_0,,,,2,2,1,3
C(C(CO)C(C(C)=O)(C)O)=O,,,5,1,3,0,3
16562_1,,,,2,2,1,3
16564_0,,,,2,2,1,3
C(C(C(CO)O)C(C(C)=O)(C)O)=O,,,5,1,2,0,2
16564_1,,,,2,2,1,3
16566_0,,,,2,2,1,3
C(C)(C(C)(C(C(C=O)=O)O)O)=O,,,5,1,3,0,3
16566_1,,,,2,2,1,3
16568_0,,,,2,2,1,3
C(C)(C(C)(C(C(C(C)=O)=O)O)O)=O,,,5,1,2,0,2
16568_1,,,,2,2,1,3
16570_0,,,,2,2,1,3
C(C)(C(C)(CC(C(CO)=O)=O)O)=O,,,5,1,1,0,1
16572_0,,,,2,2,1,3
C(C)(C(C)(C(C(C)=O)O)O)=O,,,5,1,3,0,3
16572_1,,,,2,2,1,3
16574_0,,,,2,2,1,3
C(C)(C(C)(CC(CO)=O)O)=O,,,5,1,2,0,2
16576_0,,,,2,2,1,3
C(C)(C(C)(C(C(CCO)=O)O)O)=O,,,5,1,2,0,2
16576_1,,,,2,2,1,3
16578_0,,,,2,2,1,3
C(C)(C(C)(C(C(CO)=O)CO)O)=O,,,5,1,2,0,2
16578_1,,,,2,2,1,3
16580_0,,,,2,2,1,3
C(C)(C(C)(CC(C(CO)O)=O)O)=O,,,5,1,1,0,1
16582_0,,,,2,2,1,3
C(C)(C(C)(CC(C(O)=O)=O)O)=O,,,5,1,2,0,2
16584_0,,,,2,2,1,3
C(C(C=O)C(C(C)=O)(C)O)(O)=O,,,5,1,3,0,3
16584_1,,,,2,2,1,3
16586_0,,,,2,2,1,3
C(C)(C(C)(C1C(C(CO1)O)=O)O)=O,,,5,1,2,0,2
16586_1,,,,2,2,1,3
16588_0,,,,2,2,1,3
C(C)(C(C)(C1C(C(O)OC1)=O)O)=O,,,5,1,2,0,2
16588_1,,,,2,2,1,3
16590_0,,,,2,2,1,3
C(C)(C(C)(C1C(COC1O)=O)O)=O,,,5,1,2,0,2
16590_1,,,,2,2,1,3
16592_0,,,,2,2,1,3
C(C)(C(C)(C1C(CC(O1)O)=O)O)=O,,,5,1,2,0,2
16592_1,,,,2,2,1,3
16594_0,,,,2,2,1,3
C(C)(C(C)(C(C=O)O)O)=O,,,5,1,3,0,3
16594_1,,,,2,2,1,3
16596_0,,,,2,2,1,3
C(C(CC)(CC(C(C)=O)=O)O)(O)=O,,,5,1,1,0,1
16598_0,,,,2,2,1,3
C(CC(C)(CC(C(C)=O)=O)O)(O)=O,,,5,1,1,0,1
16600_0,,,,2,2,1,3
C1(C(CCO1)(CC(C(C)=O)=O)O)=O,,,5,1,1,0,1
16602_0,,,,2,2,1,3
C1(CC(CO1)(CC(C(C)=O)=O)O)=O,,,5,1,1,0,1
16604_0,,,,2,2,1,3
C(C(C=CC=O)(CC(C(C)=O)=O)O)=O,,,5,1,1,0,1
16606_0,,,,2,2,1,3
C(C=CC(C(CC(C(C)=O)=O)O)=O)=O,,,5,1,1,0,1
16608_0,,,,2,2,1,3
C(C(CC(C(C)=O)=O)O)=CC(C=O)=O,,,5,1,1,0,1
16610_0,,,,2,2,1,3
C(C(C(CC(C(C)=O)=O)O)=CC=O)=O,,,5,1,1,0,1
16612_0,,,,2,2,1,3
C(C(CC(C(C)=O)=O)O)=C(C=O)C=O,,,5,1,1,0,1
16614_0,,,,2,2,1,3
C(C(CC(C(C)=O)=O)O)=C(C=O)C,,,5,1,1,0,1
16616_0,,,,2,2,1,3
C(C)(C(CC(C(C)=O)=O)O)=CC=O,,,5,1,1,0,1
16618_0,,,,2,2,1,3
C=C(C=O)CC(CC(C(C)=O)=O)O,,,5,1,1,0,1
16620_0,,,,2,2,1,3
C(CC(C(CC(C(C)=O)=O)O)=C)=O,,,5,1,1,0,1
16622_0,,,,2,2,1,3
C(C(CC(C(C)=O)=O)O)=CC(C)=O,,,5,1,1,0,1
16624_0,,,,2,2,1,3
C(C(C)(CC(C(C)=O)=O)O)=CC=O,,,5,1,1,0,1
16626_0,,,,2,2,1,3
C(C(CC=C)(CC(C(C)=O)=O)O)=O,,,5,1,1,0,1
16628_0,,,,2,2,1,3
C(C(CC(C(C)=O)=O)O)(CC=C)=O,,,5,1,1,0,1
16630_0,,,,2,2,1,3
C(C(C=CC)(CC(C(C)=O)=O)O)=O,,,5,1,1,0,1
16632_0,,,,2,2,1,3
C(C)=CC(C(CC(C(C)=O)=O)O)=O,,,5,1,1,0,1
16634_0,,,,2,2,1,3
C(CC=CC(CC(C(C)=O)=O)O)=O,,,5,1,1,0,1
16636_0,,,,2,2,1,3
C(CC(CC(C(C)=O)=O)O)=CC=O,,,5,1,1,0,1
16637_0,,,,2,2,1,3
16639_0,,,,2,2,1,3
C(C)=C(C=O)C(CC(C(C)=O)=O)O,,,5,1,1,0,1
16641_0,,,,2,2,1,3
C=C(C=O)C(CC(C(C)=O)=O)O,,,5,1,1,0,1
16643_0,,,,2,2,1,3
C(C)=CC(CC(C(C)=O)=O)O,,,5,1,1,0,1
16645_0,,,,2,2,1,3
C(CC(CC(C(C)=O)=O)O)=C,,,5,1,1,0,1
16647_0,,,,2,2,1,3
C(C(C(CC(C(C)=O)=O)O)O)=C,,,5,1,1,0,1
16649_0,,,,2,2,1,3
C=CC(CC(C(C)=O)=O)O,,,5,1,1,0,1
16651_0,,,,2,2,1,3
C1C(COC=1)(CC(C(C)=O)=O)O,,,5,1,1,0,1
16653_0,,,,2,2,1,3
C(C(C)=O)(CC(C(CO)O)O)=O,,,5,1,3,0,3
16654_0,,,,2,2,1,3
16656_0,,,,2,2,1,3
C(C(C)=O)(CC(CO)(CO)O)=O,,,5,1,4,0,4
16658_0,,,,2,2,1,3
C(C(C)(CC(C(C)=O)=O)O)=O,,,5,1,2,0,2
16660_0,,,,2,2,1,3
C(C)(C(CC(C(C)=O)=O)O)=O,,,5,1,3,0,3
16661_0,,,,2,2,1,3
16663_0,,,,2,2,1,3
C(C(CCO)(CC(C(C)=O)=O)O)=O,,,5,1,1,0,1
16665_0,,,,2,2,1,3
C(C(CC(C(C)=O)=O)O)(CCO)=O,,,5,1,1,0,1
16666_0,,,,2,2,1,3
16668_0,,,,2,2,1,3
C(C(CC(CC(C(C)=O)=O)O)O)=O,,,5,1,1,0,1
16669_0,,,,2,2,1,3
16670_0,,,,2,2,1,3
16671_0,,,,2,2,1,3
16673_0,,,,2,2,1,3
C(C(C(C)(CC(C(C)=O)=O)O)O)=O,,,5,1,1,0,1
16675_0,,,,2,2,1,3
C(C(C)=O)(CC(C)O)=O,,,5,1,2,0,2
16676_0,,,,2,2,1,3
16678_0,,,,2,2,1,3
C(C(C)=O)(CC(CC(C)O)O)=O,,,5,1,2,0,2
16680_0,,,,2,2,1,3
C(C(C)=O)(CC(C(C(C)O)O)O)=O,,,5,1,1,0,1
16682_0,,,,2,2,1,3
C(C(C)=O)(CC(CCO)O)=O,,,5,1,3,0,3
16684_0,,,,2,2,1,3
C(C(C)=O)(CC(CC(CO)O)O)=O,,,5,1,1,0,1
16685_0,,,,2,2,1,3
16686_0,,,,2,2,1,3
16688_0,,,,2,2,1,3
C(C)(C(CO)(CC(C(C)=O)=O)O)=O,,,5,1,1,0,1
16690_0,,,,2,2,1,3
C(CO)(C(C)(CC(C(C)=O)=O)O)=O,,,5,1,1,0,1
16692_0,,,,2,2,1,3
C(C(C(C)O)(CC(C(C)=O)=O)O)=O,,,5,1,2,0,2
16694_0,,,,2,2,1,3
C(C(CC(C(C)=O)=O)O)(C(C)O)=O,,,5,1,1,0,1
16696_0,,,,2,2,1,3
C(C(C)=O)(CC(C)(CO)O)=O,,,5,1,2,0,2
16698_0,,,,2,2,1,3
C(C(C)=O)(CC(CO)(CCO)O)=O,,,5,1,1,0,1
16700_0,,,,2,2,1,3
C(C(C)=O)(CC(C(CCO)O)O)=O,,,5,1,1,0,1
16702_0,,,,2,2,1,3
C(C(C)=O)(CC(C)(C(CO)O)O)=O,,,5,1,1,0,1
16703_0,,,,2,2,1,3
16705_0,,,,2,2,1,3
C(C(C)(CC(C(C)=O)=O)O)(O)=O,,,5,1,3,0,3
16707_0,,,,2,2,1,3
C(CC(CC(C(C)=O)=O)O)(O)=O,,,5,1,3,0,3
16709_0,,,,2,2,1,3
C(C(C)=O)(CC1(COCC1O)O)=O,,,5,1,1,0,1
16711_0,,,,2,2,1,3
C(C(C)=O)(CC1(C(O)OCC1)O)=O,,,5,1,1,0,1
16713_0,,,,2,2,1,3
C(C(C)=O)(CC1(COC(C1)O)O)=O,,,5,1,1,0,1
16715_0,,,,2,2,1,3
C(C(C=C)(CC(C(C)=O)=O)O)=O,,,5,1,2,0,2
16717_0,,,,2,2,1,3
C=CC(C(CC(C(C)=O)=O)O)=O,,,5,1,2,0,2
16719_0,,,,2,2,1,3
C(C(CC(C(C)=O)=O)O)=CC=O,,,5,1,2,0,2
16721_0,,,,2,2,1,3
C(C(C)=O)(CCO)=O,,,5,1,8,0,8
16723_0,,,,2,2,1,3
C(C(C)=O)(CC(CO)O)=O,,,5,1,5,0,5
16725_0,,,,2,2,1,3
C(C(CO)C(C=O)(CC=O)O)(O)=O,,,5,1,3,0,3
16726_0,,,,2,2,1,3
16727_0,,,,2,2,1,3
16728_0,,,,2,2,1,3
16729_0,,,,2,2,1,3
16731_0,,,,2,2,1,3
C(C(C(C(CC=O)O)=O)C(C)=O)=O,,,5,1,1,0,1
16733_0,,,,2,2,1,3
C(C(C(CC(C=C)O)=O)C(C=O)=O)=O,,,5,1,1,0,1
16735_0,,,,2,2,1,3
C(C(C(CC(C)O)=O)C(C=O)=O)=O,,,5,1,1,0,1
16737_0,,,,2,2,1,3
C(C(C(CCO)=O)C(C=O)=O)=O,,,5,1,2,0,2
16738_0,,,,2,2,1,3
16740_0,,,,2,2,1,3
C(CC(CO)(C(C(C)=O)CO)O)=O,,,5,1,1,0,1
16742_0,,,,2,2,1,3
C(CC(C)O)(C(C(CO)=O)CO)=O,,,5,1,1,0,1
16744_0,,,,2,2,1,3
C(CCO)(C(C(CO)=O)CO)=O,,,5,1,6,0,6
16746_0,,,,2,2,1,3
C(C(C(C)O)O)(C(C(C)=O)CO)=O,,,5,1,2,0,2
16746_1,,,,2,2,1,3
16747_0,,,,2,2,1,3
16747_1,,,,2,2,1,3
16749_0,,,,2,2,1,3
C(CCO)(C(C(CO)=O)(CO)O)=O,,,5,1,5,0,5
16751_0,,,,2,2,1,3
C(C(CO)O)(C(C(C)=O)(CO)O)=O,,,5,1,6,0,6
16751_1,,,,2,2,1,3
16752_0,,,,2,2,1,3
16752_1,,,,2,2,1,3
16754_0,,,,2,2,1,3
C(C(C(C(CCO)=O)=O)CO)(O)=O,,,5,1,4,0,4
16756_0,,,,2,2,1,3
C(C(C(C(C=O)CO)=O)CO)(O)=O,,,5,1,2,0,2
16756_1,,,,2,2,1,3
16758_0,,,,2,2,1,3
C(C(CO)C(C)(CC=O)O)(O)=O,,,5,1,2,0,2
16760_0,,,,2,2,1,3
C(C(CO)C(C)(C(C=O)O)O)(O)=O,,,5,1,6,0,6
16760_1,,,,2,2,1,3
16762_0,,,,2,2,1,3
C(CC(C=C)O)(C(C(O)=O)CO)=O,,,5,1,1,0,1
16764_0,,,,2,2,1,3
C(CC(C=O)O)(C(C(O)=O)CO)=O,,,5,1,4,0,4
16766_0,,,,2,2,1,3
C(C(C(CC(C)O)=O)CO)(O)=O,,,5,1,2,0,2
16768_0,,,,2,2,1,3
C(C(C(CCO)=O)CO)(O)=O,,,5,1,3,0,3
16770_0,,,,2,2,1,3
C(C(C(CC(CO)O)=O)CO)(O)=O,,,5,1,1,0,1
16772_0,,,,2,2,1,3
C(C(C(CCO)=O)C(CO)O)(O)=O,,,5,1,1,0,1
16774_0,,,,2,2,1,3
C(CCO)(C(C=O)C(C(C)=O)=O)=O,,,5,1,1,0,1
16776_0,,,,2,2,1,3
C(C(C(C)=O)C(C(CCO)=O)=O)=O,,,5,1,1,0,1
16778_0,,,,2,2,1,3
C(CC(C(C(C(C)=O)=O)CO)O)=O,,,5,1,1,0,1
16780_0,,,,2,2,1,3
C(C(C)(CC=O)O)(C(C=O)CO)=O,,,5,1,1,0,1
16781_0,,,,2,2,1,3
16783_0,,,,2,2,1,3
C(C(C(C(CC(C)O)=O)=O)CO)=O,,,5,1,1,0,1
16784_0,,,,2,2,1,3
16786_0,,,,2,2,1,3
C(C(C(CC=O)=O)C(CCO)=O)=O,,,5,1,1,0,1
16788_0,,,,2,2,1,3
C(C(C(C(C=O)CO)=O)C(C)=O)=O,,,5,1,2,0,2
16788_1,,,,2,2,1,3
16789_0,,,,2,2,1,3
16790_0,,,,2,2,1,3
16792_0,,,,2,2,1,3
C(C(C(CC(CC=O)O)=O)CO)=O,,,5,1,2,0,2
16794_0,,,,2,2,1,3
C(C(C(C(C=O)CO)=O)C(C)O)=O,,,5,1,2,0,2
16794_1,,,,2,2,1,3
16796_0,,,,2,2,1,3
C(C(C(C(C=O)CO)=O)CO)=O,,,5,1,4,0,4
16796_1,,,,2,2,1,3
16798_0,,,,2,2,1,3
C(C(C=C)C(C)(C(C=O)C(C)=O)O)=O,,,5,1,1,0,1
16799_0,,,,2,2,1,3
16800_0,,,,2,2,1,3
16800_1,,,,2,2,1,3
16802_0,,,,2,2,1,3
C(C(C=C)C(C(C(C)=O)C(C)=O)O)=O,,,5,1,1,0,1
16804_0,,,,2,2,1,3
C(CC(C(C(C)=O)C(C)=O)O)=O,,,5,1,2,0,2
16806_0,,,,2,2,1,3
C(C(C(C(C(C)=O)C(C)=O)O)O)=O,,,5,1,2,0,2
16806_1,,,,2,2,1,3
16808_0,,,,2,2,1,3
C(C(C(C)=O)C(CC(C=CC)O)=O)=O,,,5,1,1,0,1
16810_0,,,,2,2,1,3
C(CC(CC=C)O)(C(C=O)C(C)=O)=O,,,5,1,1,0,1
16812_0,,,,2,2,1,3
C(C(C(CC(C=C)O)=O)C(C)=O)=O,,,5,1,1,0,1
16814_0,,,,2,2,1,3
C(C(C(CC(C=O)O)=O)C(C)=O)=O,,,5,1,1,0,1
16816_0,,,,2,2,1,3
C(CC(C)O)(C(C=O)C(C)=O)=O,,,5,1,3,0,3
16818_0,,,,2,2,1,3
C(CCO)(C(C=O)C(C)=O)=O,,,5,1,5,0,5
16820_0,,,,2,2,1,3
C(CC(CO)O)(C(C=O)C(C)=O)=O,,,5,1,1,0,1
16822_0,,,,2,2,1,3
C(CC(CC(C=O)(C(C)=O)O)O)=O,,,5,1,1,0,1
16823_0,,,,2,2,1,3
16825_0,,,,2,2,1,3
C(CC(C)(C(C=O)(CC=O)O)O)=O,,,5,1,2,0,2
16826_0,,,,2,2,1,3
16826_1,,,,2,2,1,3
16827_0,,,,2,2,1,3
16827_1,,,,2,2,1,3
16829_0,,,,2,2,1,3
C(CC(C)O)(C(C=O)(CC=O)O)=O,,,5,1,1,0,1
16830_0,,,,2,2,1,3
16832_0,,,,2,2,1,3
C(CC(C)(C(C=O)(C(C)=O)O)O)=O,,,5,1,3,0,3
16834_0,,,,2,2,1,3
C(CC(C(C(C)=O)(C(C)=O)O)O)=O,,,5,1,1,0,1
16836_0,,,,2,2,1,3
C(CC(C)O)(C(C=O)(C(C)=O)O)=O,,,5,1,1,0,1
16837_0,,,,2,2,1,3
16839_0,,,,2,2,1,3
C(C(C=C)C(C(C(C)=O)CO)O)=O,,,5,1,1,0,1
16841_0,,,,2,2,1,3
C(C)(C(CO)C(CC(C=O)=O)O)=O,,,5,1,1,0,1
16843_0,,,,2,2,1,3
C(C(C=O)C(C(C(C)=O)CO)O)=O,,,5,1,2,0,2
16843_1,,,,2,2,1,3
16845_0,,,,2,2,1,3
C(CC(C(C(C)=O)CO)O)=O,,,5,1,2,0,2
16847_0,,,,2,2,1,3
C(C(CO)C(C(C(C)=O)CO)O)=O,,,5,1,2,0,2
16847_1,,,,2,2,1,3
16849_0,,,,2,2,1,3
C(C)(C(CO)C(C(C(C)=O)O)O)=O,,,5,1,2,0,2
16849_1,,,,2,2,1,3
16851_0,,,,2,2,1,3
C(C)(C(CO)C(CC(CO)=O)O)=O,,,5,1,1,0,1
16853_0,,,,2,2,1,3
C(C(C(C(C(C)=O)CO)O)O)=O,,,5,1,3,0,3
16853_1,,,,2,2,1,3
16855_0,,,,2,2,1,3
C(C(C=C)C(C)(C(C=O)CO)O)=O,,,5,1,1,0,1
16856_0,,,,2,2,1,3
16857_0,,,,2,2,1,3
16857_1,,,,2,2,1,3
16858_0,,,,2,2,1,3
16860_0,,,,2,2,1,3
C(C(CO)C(C)(C(C=O)CO)O)=O,,,5,1,2,0,2
16860_1,,,,2,2,1,3
16862_0,,,,2,2,1,3
C(C(CO)C(C)(C(C(C)=O)O)O)=O,,,5,1,2,0,2
16862_1,,,,2,2,1,3
16863_0,,,,2,2,1,3
16864_0,,,,2,2,1,3
16864_1,,,,2,2,1,3
16866_0,,,,2,2,1,3
C(CC(C=CC)O)(C(C=O)CO)=O,,,5,1,1,0,1
16868_0,,,,2,2,1,3
C(C(C(CC(CC=C)O)=O)CO)=O,,,5,1,1,0,1
16870_0,,,,2,2,1,3
C(CC(C=C)O)(C(C=O)CO)=O,,,5,1,1,0,1
16871_0,,,,2,2,1,3
16873_0,,,,2,2,1,3
C(C(C)(CC(C(C=O)CO)=O)O)=O,,,5,1,1,0,1
16875_0,,,,2,2,1,3
C(CC(C(C)=O)O)(C(C=O)CO)=O,,,5,1,1,0,1
16876_0,,,,2,2,1,3
16878_0,,,,2,2,1,3
C(C(C(CC(C)O)=O)CO)=O,,,5,1,3,0,3
16880_0,,,,2,2,1,3
C(C(C(CC(CCO)O)=O)CO)=O,,,5,1,1,0,1
16882_0,,,,2,2,1,3
C(C(C(CC(C)(CO)O)=O)CO)=O,,,5,1,1,0,1
16884_0,,,,2,2,1,3
C(CC(C(O)=O)O)(C(C=O)CO)=O,,,5,1,4,0,4
16885_0,,,,2,2,1,3
16886_0,,,,2,2,1,3
16888_0,,,,2,2,1,3
C(CC(C(C(C)=O)C(CO)O)O)=O,,,5,1,1,0,1
16889_0,,,,2,2,1,3
16891_0,,,,2,2,1,3
C(C(C(CC(C)O)=O)C(CO)O)=O,,,5,1,1,0,1
16892_0,,,,2,2,1,3
16893_0,,,,2,2,1,3
16895_0,,,,2,2,1,3
C(C(C(C=O)=O)CC(CC=O)O)=O,,,5,1,1,0,1
16896_0,,,,2,2,1,3
16898_0,,,,2,2,1,3
C(C(C(C(CC=O)O)=O)CC=O)=O,,,5,1,2,0,2
16900_0,,,,2,2,1,3
C(C(C(C=O)=O)C(C=O)C(C=C)O)=O,,,5,1,1,0,1
16902_0,,,,2,2,1,3
C(C(C(C=O)=O)C(C=O)C(C)O)=O,,,5,1,1,0,1
16904_0,,,,2,2,1,3
C(C(C(C=O)=O)C(C=O)CO)=O,,,5,1,2,0,2
16906_0,,,,2,2,1,3
C(C(C=C)C(C(O)=O)(CC=O)O)=O,,,5,1,1,0,1
16908_0,,,,2,2,1,3
C(C(CC=O)(CC(C=O)=O)O)(O)=O,,,5,1,1,0,1
16910_0,,,,2,2,1,3
C(C(C=O)C(C(O)=O)(CC=O)O)=O,,,5,1,2,0,2
16910_1,,,,2,2,1,3
16912_0,,,,2,2,1,3
C(C(CC=O)(CC=O)O)(O)=O,,,5,1,4,0,4
16914_0,,,,2,2,1,3
C(CC(C(O)=O)(C(C=O)CO)O)=O,,,5,1,3,0,3
16914_1,,,,2,2,1,3
16915_0,,,,2,2,1,3
16915_1,,,,2,2,1,3
16917_0,,,,2,2,1,3
C(C(CC=O)(CC(CO)=O)O)(O)=O,,,5,1,2,0,2
16918_0,,,,2,2,1,3
16918_1,,,,2,2,1,3
16920_0,,,,2,2,1,3
C(C(C=C)C(CC(C(O)=O)=O)O)=O,,,5,1,2,0,2
16921_0,,,,2,2,1,3
16922_0,,,,2,2,1,3
16922_1,,,,2,2,1,3
16923_0,,,,2,2,1,3
16924_0,,,,2,2,1,3
16924_1,,,,2,2,1,3
16925_0,,,,2,2,1,3
16925_1,,,,2,2,1,3
16926_0,,,,2,2,1,3
16927_0,,,,2,2,1,3
16927_1,,,,2,2,1,3
16929_0,,,,2,2,1,3
C(C(C(C(O)=O)=O)C(C=CC)O)=O,,,5,1,2,0,2
16929_1,,,,2,2,1,3
16931_0,,,,2,2,1,3
C(C(C(C(O)=O)=O)C(CC=C)O)=O,,,5,1,2,0,2
16931_1,,,,2,2,1,3
16933_0,,,,2,2,1,3
C(C(C(C(O)=O)=O)C(C=C)O)=O,,,5,1,2,0,2
16933_1,,,,2,2,1,3
16935_0,,,,2,2,1,3
C(C(C(C(O)=O)=O)C(C=O)O)=O,,,5,1,3,0,3
16935_1,,,,2,2,1,3
16937_0,,,,2,2,1,3
C(C(C(C(O)=O)=O)C(C=O)(C)O)=O,,,5,1,2,0,2
16937_1,,,,2,2,1,3
16939_0,,,,2,2,1,3
C(C(C(C(O)=O)=O)C(C(C)=O)O)=O,,,5,1,2,0,2
16939_1,,,,2,2,1,3
16941_0,,,,2,2,1,3
C(C(C(C(O)=O)=O)C(CC=O)O)=O,,,5,1,2,0,2
16941_1,,,,2,2,1,3
16943_0,,,,2,2,1,3
C(C(C(C(O)=O)=O)C(C)O)=O,,,5,1,3,0,3
16943_1,,,,2,2,1,3
16945_0,,,,2,2,1,3
C(C(C(C(O)=O)=O)C(CCO)O)=O,,,5,1,2,0,2
16945_1,,,,2,2,1,3
16947_0,,,,2,2,1,3
C(C(C(C(O)=O)=O)C(C)(CO)O)=O,,,5,1,2,0,2
16947_1,,,,2,2,1,3
16949_0,,,,2,2,1,3
C(C(C(C(O)=O)=O)C(C(O)=O)O)=O,,,5,1,2,0,2
16949_1,,,,2,2,1,3
16951_0,,,,2,2,1,3
C(C(C(C(O)=O)=O)CO)=O,,,5,1,5,0,5
16951_1,,,,2,2,1,3
16953_0,,,,2,2,1,3
C(C(C(C(O)=O)=O)C(CO)O)=O,,,5,1,4,0,4
16953_1,,,,2,2,1,3
16955_0,,,,2,2,1,3
C(C(C=C)C(C=O)(CC(O)=O)O)=O,,,5,1,1,0,1
16957_0,,,,2,2,1,3
C(CC(C=O)(CC(C=O)=O)O)(O)=O,,,5,1,1,0,1
16959_0,,,,2,2,1,3
C(C(C=O)C(C=O)(CC(O)=O)O)=O,,,5,1,2,0,2
16959_1,,,,2,2,1,3
16961_0,,,,2,2,1,3
C(CC(C=O)(CC=O)O)(O)=O,,,5,1,3,0,3
16963_0,,,,2,2,1,3
C(CC(C=O)(C(C=O)CO)O)(O)=O,,,5,1,3,0,3
16963_1,,,,2,2,1,3
16964_0,,,,2,2,1,3
16964_1,,,,2,2,1,3
16966_0,,,,2,2,1,3
C(CC(C=O)(CC(CO)=O)O)(O)=O,,,5,1,2,0,2
16967_0,,,,2,2,1,3
16967_1,,,,2,2,1,3
16969_0,,,,2,2,1,3
C(C(C=C)C(C(CC(O)=O)=O)O)=O,,,5,1,1,0,1
16970_0,,,,2,2,1,3
16971_0,,,,2,2,1,3
16971_1,,,,2,2,1,3
16972_0,,,,2,2,1,3
16973_0,,,,2,2,1,3
16973_1,,,,2,2,1,3
16974_0,,,,2,2,1,3
16974_1,,,,2,2,1,3
16975_0,,,,2,2,1,3
16976_0,,,,2,2,1,3
16976_1,,,,2,2,1,3
16978_0,,,,2,2,1,3
C(C(C(C=O)=O)C(C=CC)O)(O)=O,,,5,1,2,0,2
16978_1,,,,2,2,1,3
16980_0,,,,2,2,1,3
C(C(C(C=O)=O)C(CC=C)O)(O)=O,,,5,1,2,0,2
16980_1,,,,2,2,1,3
16982_0,,,,2,2,1,3
C(C(C(C=O)=O)C(C=C)O)(O)=O,,,5,1,2,0,2
16982_1,,,,2,2,1,3
16983_0,,,,2,2,1,3
16983_1,,,,2,2,1,3
16984_0,,,,2,2,1,3
16984_1,,,,2,2,1,3
16985_0,,,,2,2,1,3
16985_1,,,,2,2,1,3
16986_0,,,,2,2,1,3
16986_1,,,,2,2,1,3
16987_0,,,,2,2,1,3
16987_1,,,,2,2,1,3
16988_0,,,,2,2,1,3
16988_1,,,,2,2,1,3
16989_0,,,,2,2,1,3
16989_1,,,,2,2,1,3
16990_0,,,,2,2,1,3
16990_1,,,,2,2,1,3
16991_0,,,,2,2,1,3
16991_1,,,,2,2,1,3
16992_0,,,,2,2,1,3
16992_1,,,,2,2,1,3
16994_0,,,,2,2,1,3
C(CC(C(O)=O)(C(C=O)C)O)=O,,,5,1,3,0,3
16996_0,,,,2,2,1,3
C(C(C(C(O)=O)(C(C=O)C)O)O)=O,,,5,1,2,0,2
16996_1,,,,2,2,1,3
16998_0,,,,2,2,1,3
C(CC(C(C(C(O)=O)=O)C)O)=O,,,5,1,3,0,3
16999_0,,,,2,2,1,3
16999_1,,,,2,2,1,3
17001_0,,,,2,2,1,3
C(C(CO)C(C=O)C(C(C)=O)=O)=O,,,5,1,1,0,1
17003_0,,,,2,2,1,3
C(C(C(C(CCO)=O)=O)CC=O)=O,,,5,1,2,0,2
17005_0,,,,2,2,1,3
C(C(CC=O)(CC(C)=O)O)(O)=O,,,5,1,3,0,3
17007_0,,,,2,2,1,3
C(C(CC(C)=O)(C(C=O)O)O)(O)=O,,,5,1,2,0,2
17007_1,,,,2,2,1,3
17008_0,,,,2,2,1,3
17009_0,,,,2,2,1,3
17009_1,,,,2,2,1,3
17011_0,,,,2,2,1,3
C(C)(C(C(C(O)=O)=O)C(C=C)O)=O,,,5,1,2,0,2
17011_1,,,,2,2,1,3
17013_0,,,,2,2,1,3
C(C(C(C(C)=O)C(C(O)=O)=O)O)=O,,,5,1,2,0,2
17013_1,,,,2,2,1,3
17015_0,,,,2,2,1,3
C(C)(C(C(C(O)=O)=O)C(C)O)=O,,,5,1,4,0,4
17015_1,,,,2,2,1,3
17017_0,,,,2,2,1,3
C(C)(C(C(C(O)=O)=O)CO)=O,,,5,1,5,0,5
17017_1,,,,2,2,1,3
17019_0,,,,2,2,1,3
C(C)(C(C(C(O)=O)=O)C(CO)O)=O,,,5,1,2,0,2
17019_1,,,,2,2,1,3
17021_0,,,,2,2,1,3
C(CC(C=C)O)(CC(C(O)=O)=O)=O,,,5,1,1,0,1
17023_0,,,,2,2,1,3
C(C(CC(CC(C(O)=O)=O)=O)O)=O,,,5,1,1,0,1
17025_0,,,,2,2,1,3
C(CC(C)O)(CC(C(O)=O)=O)=O,,,5,1,3,0,3
17026_0,,,,2,2,1,3
17028_0,,,,2,2,1,3
C(CC(CO)O)(CC(C(O)=O)=O)=O,,,5,1,2,0,2
17030_0,,,,2,2,1,3
C(C(C)(CC=O)O)(CC(O)=O)=O,,,5,1,2,0,2
17032_0,,,,2,2,1,3
C(C(C)(C(C=O)O)O)(CC(O)=O)=O,,,5,1,2,0,2
17032_1,,,,2,2,1,3
17034_0,,,,2,2,1,3
C(CC(C(C)=O)(CC=O)O)(O)=O,,,5,1,2,0,2
17036_0,,,,2,2,1,3
C(CC(C(C)=O)(C(C=O)O)O)(O)=O,,,5,1,4,0,4
17036_1,,,,2,2,1,3
17038_0,,,,2,2,1,3
C(CC(C(CC(C=C)O)=O)=O)(O)=O,,,5,1,1,0,1
17039_0,,,,2,2,1,3
17041_0,,,,2,2,1,3
C(CC(C(CC(C)O)=O)=O)(O)=O,,,5,1,2,0,2
17042_0,,,,2,2,1,3
17044_0,,,,2,2,1,3
C(CC(C(CC(CO)O)=O)=O)(O)=O,,,5,1,2,0,2
17046_0,,,,2,2,1,3
C(C(C(C(C)=O)=O)C(C=C)O)(O)=O,,,5,1,2,0,2
17046_1,,,,2,2,1,3
17047_0,,,,2,2,1,3
17047_1,,,,2,2,1,3
17049_0,,,,2,2,1,3
C(C(C(C(C)=O)=O)C(C)O)(O)=O,,,5,1,4,0,4
17049_1,,,,2,2,1,3
17050_0,,,,2,2,1,3
17050_1,,,,2,2,1,3
17052_0,,,,2,2,1,3
C(C(C(C(C)=O)=O)C(CO)O)(O)=O,,,5,1,3,0,3
17052_1,,,,2,2,1,3
17054_0,,,,2,2,1,3
C(CC(C(C=O)C(C=O)CO)=O)=O,,,5,1,1,0,1
17056_0,,,,2,2,1,3
C(C(C(C(C=O)CC=O)=O)CO)=O,,,5,1,2,0,2
17056_1,,,,2,2,1,3
17058_0,,,,2,2,1,3
C(C(CCC=O)(CC=O)O)(O)=O,,,5,1,4,0,4
17060_0,,,,2,2,1,3
C(C(CCC=O)(C(C=O)O)O)(O)=O,,,5,1,3,0,3
17060_1,,,,2,2,1,3
17062_0,,,,2,2,1,3
C(CC(CCC(C(O)=O)=O)O)=O,,,5,1,4,0,4
17064_0,,,,2,2,1,3
C(C(C(CCC(C(O)=O)=O)O)O)=O,,,5,1,5,0,5
17064_1,,,,2,2,1,3
17066_0,,,,2,2,1,3
C(CC(C(C(O)=O)=O)C(C=C)O)=O,,,5,1,1,0,1
17068_0,,,,2,2,1,3
C(CC(C(C(O)=O)=O)C(C=O)O)=O,,,5,1,1,0,1
17070_0,,,,2,2,1,3
C(CC(C(C(O)=O)=O)C(C)O)=O,,,5,1,2,0,2
17071_0,,,,2,2,1,3
17073_0,,,,2,2,1,3
C(CC(C(C(O)=O)=O)C(CO)O)=O,,,5,1,1,0,1
17075_0,,,,2,2,1,3
C(C(CC(C(O)=O)=O)C(C=C)O)=O,,,5,1,1,0,1
17077_0,,,,2,2,1,3
C(C(C(C=O)CC(C(O)=O)=O)O)=O,,,5,1,1,0,1
17079_0,,,,2,2,1,3
C(C(C(C)O)CC(C(O)=O)=O)=O,,,5,1,2,0,2
17081_0,,,,2,2,1,3
C(C(CO)CC(C(O)=O)=O)=O,,,5,1,4,0,4
17083_0,,,,2,2,1,3
C(C(C(CO)O)CC(C(O)=O)=O)=O,,,5,1,3,0,3
17085_0,,,,2,2,1,3
C(CC(CC=O)(CC=O)O)(O)=O,,,5,1,2,0,2
17087_0,,,,2,2,1,3
C(CC(C(C=O)O)(CC=O)O)(O)=O,,,5,1,2,0,2
17087_1,,,,2,2,1,3
17089_0,,,,2,2,1,3
C(CC(CC(CC=O)O)=O)(O)=O,,,5,1,3,0,3
17090_0,,,,2,2,1,3
17090_1,,,,2,2,1,3
17092_0,,,,2,2,1,3
C(C(C(CC=O)=O)C(C=C)O)(O)=O,,,5,1,2,0,2
17092_1,,,,2,2,1,3
17093_0,,,,2,2,1,3
17093_1,,,,2,2,1,3
17095_0,,,,2,2,1,3
C(C(C(CC=O)=O)C(C)O)(O)=O,,,5,1,4,0,4
17095_1,,,,2,2,1,3
17096_0,,,,2,2,1,3
17096_1,,,,2,2,1,3
17097_0,,,,2,2,1,3
17097_1,,,,2,2,1,3
17099_0,,,,2,2,1,3
C(C(C(CC(O)=O)=O)C(C=C)O)=O,,,5,1,2,0,2
17099_1,,,,2,2,1,3
17100_0,,,,2,2,1,3
17100_1,,,,2,2,1,3
17102_0,,,,2,2,1,3
C(C(C(CC(O)=O)=O)C(C)O)=O,,,5,1,5,0,5
17102_1,,,,2,2,1,3
17103_0,,,,2,2,1,3
17103_1,,,,2,2,1,3
17104_0,,,,2,2,1,3
17104_1,,,,2,2,1,3
17106_0,,,,2,2,1,3
C(CCO)(C(C(C(O)=O)=O)CO)=O,,,5,1,3,0,3
17106_1,,,,2,2,1,3
17108_0,,,,2,2,1,3
C(C(CO)CO)(CC(C(O)=O)=O)=O,,,5,1,3,0,3
17108_1,,,,2,2,1,3
17110_0,,,,2,2,1,3
C(CC(C(C(CO)CO)=O)=O)(O)=O,,,5,1,3,0,3
17110_1,,,,2,2,1,3
17111_0,,,,2,2,1,3
17111_1,,,,2,2,1,3
17113_0,,,,2,2,1,3
C(C(C(C)(C(C=O)C=C)O)CC=O)=O,,,5,1,1,0,1
17114_0,,,,2,2,1,3
17115_0,,,,2,2,1,3
17115_1,,,,2,2,1,3
17117_0,,,,2,2,1,3
C(C)(C(C(C(C=O)C=C)O)CC=O)=O,,,5,1,1,0,1
17119_0,,,,2,2,1,3
C(C)(C(C(CC=O)O)CC=O)=O,,,5,1,3,0,3
17121_0,,,,2,2,1,3
C(C)(C(C(C(C=O)O)O)CC=O)=O,,,5,1,3,0,3
17121_1,,,,2,2,1,3
17123_0,,,,2,2,1,3
C(C(C=C)C(CC(C=O)C(C)=O)O)=O,,,5,1,1,0,1
17125_0,,,,2,2,1,3
C(CC(CC(C=O)C(C)=O)O)=O,,,5,1,2,0,2
17127_0,,,,2,2,1,3
C(C(C(CC(C=O)C(C)=O)O)O)=O,,,5,1,2,0,2
17127_1,,,,2,2,1,3
17129_0,,,,2,2,1,3
C(C(C(CC(C=CC)O)=O)CC=O)=O,,,5,1,1,0,1
17131_0,,,,2,2,1,3
C(CC(CC=C)O)(C(C=O)CC=O)=O,,,5,1,1,0,1
17133_0,,,,2,2,1,3
C(C(C(CC(C=C)O)=O)CC=O)=O,,,5,1,1,0,1
17135_0,,,,2,2,1,3
C(C(C(CC(C=O)O)=O)CC=O)=O,,,5,1,1,0,1
17137_0,,,,2,2,1,3
C(CC(C)O)(C(C=O)CC=O)=O,,,5,1,2,0,2
17139_0,,,,2,2,1,3
C(CCO)(C(C=O)CC=O)=O,,,5,1,5,0,5
17141_0,,,,2,2,1,3
C(CC(CO)O)(C(C=O)CC=O)=O,,,5,1,1,0,1
17143_0,,,,2,2,1,3
C(C(C(C)=O)C(C=O)C(C=CC)O)=O,,,5,1,1,0,1
17145_0,,,,2,2,1,3
C(C(C(CC=C)O)C(C=O)C(C)=O)=O,,,5,1,1,0,1
17147_0,,,,2,2,1,3
C(C(C(C)=O)C(C=O)C(C=C)O)=O,,,5,1,1,0,1
17149_0,,,,2,2,1,3
C(C(C(C)=O)C(C=O)C(C=O)O)=O,,,5,1,1,0,1
17151_0,,,,2,2,1,3
C(C(C(C)O)C(C=O)C(C)=O)=O,,,5,1,3,0,3
17153_0,,,,2,2,1,3
C(C(CO)C(C=O)C(C)=O)=O,,,5,1,3,0,3
17155_0,,,,2,2,1,3
C(C(C(CO)O)C(C=O)C(C)=O)=O,,,5,1,1,0,1
17156_0,,,,2,2,1,3
17157_0,,,,2,2,1,3
17158_0,,,,2,2,1,3
17158_1,,,,2,2,1,3
17159_0,,,,2,2,1,3
17159_1,,,,2,2,1,3
17160_0,,,,2,2,1,3
17160_1,,,,2,2,1,3
17161_0,,,,2,2,1,3
17161_1,,,,2,2,1,3
17162_0,,,,2,2,1,3
17162_1,,,,2,2,1,3
17163_0,,,,2,2,1,3
17163_1,,,,2,2,1,3
17164_0,,,,2,2,1,3
17166_0,,,,2,2,1,3
C(C(CO)CC(C(C(O)=O)O)=O)=O,,,5,1,2,0,2
17168_0,,,,2,2,1,3
C(C(CC(C(C(O)=O)=O)CO)O)=O,,,5,1,1,0,1
17169_0,,,,2,2,1,3
17169_1,,,,2,2,1,3
17171_0,,,,2,2,1,3
C(C(CO)C(C=O)O)(CC(O)=O)=O,,,5,1,2,0,2
17171_1,,,,2,2,1,3
17173_0,,,,2,2,1,3
C(CC(C(C(O)=O)=O)CO)(CO)=O,,,5,1,2,0,2
17175_0,,,,2,2,1,3
C(CO)(C(CO)CC(C(O)=O)=O)=O,,,5,1,2,0,2
17177_0,,,,2,2,1,3
C(CCC(C(O)=O)=O)(C(CO)O)=O,,,5,1,3,0,3
17177_1,,,,2,2,1,3
17179_0,,,,2,2,1,3
C(C(C(CC(CO)=O)=O)CO)(O)=O,,,5,1,3,0,3
17179_1,,,,2,2,1,3
17180_0,,,,2,2,1,3
17180_1,,,,2,2,1,3
17181_0,,,,2,2,1,3
17181_1,,,,2,2,1,3
17183_0,,,,2,2,1,3
C(C(CO)C(C(C(O)=O)=O)CO)=O,,,5,1,2,0,2
17184_0,,,,2,2,1,3
17186_0,,,,2,2,1,3
C(C(C(C(C(C)=O)=O)CO)O)(O)=O,,,5,1,2,0,2
17186_1,,,,2,2,1,3
17188_0,,,,2,2,1,3
C(C(CC(C(CCO)=O)=O)O)(O)=O,,,5,1,1,0,1
17190_0,,,,2,2,1,3
C(C(C(C(C(C)=O)O)=O)CO)(O)=O,,,5,1,3,0,3
17190_1,,,,2,2,1,3
17192_0,,,,2,2,1,3
C(CC(C(C(CCO)=O)O)=O)(O)=O,,,5,1,2,0,2
17193_0,,,,2,2,1,3
17193_1,,,,2,2,1,3
17195_0,,,,2,2,1,3
C(C(C(O)=O)O)(CC(CCO)=O)=O,,,5,1,2,0,2
17197_0,,,,2,2,1,3
C(C(C=C)C(C(O)=O)(CC)O)=O,,,5,1,1,0,1
17199_0,,,,2,2,1,3
C(C(CC)(C1C(C=CO1)=O)O)(O)=O,,,5,1,2,0,2
17199_1,,,,2,2,1,3
17201_0,,,,2,2,1,3
C(C(CC)(C(C(CO)=O)O)O)(O)=O,,,5,1,2,0,2
17201_1,,,,2,2,1,3
17203_0,,,,2,2,1,3
C(C(CC)(CC(C=O)=O)O)(O)=O,,,5,1,1,0,1
17205_0,,,,2,2,1,3
C(C(C=O)C(C(O)=O)(CC)O)=O,,,5,1,2,0,2
17205_1,,,,2,2,1,3
17207_0,,,,2,2,1,3
C(C(CC)(CC=O)O)(O)=O,,,5,1,2,0,2
17209_0,,,,2,2,1,3
C(C(C(C)O)C(C(O)=O)(CC)O)=O,,,5,1,2,0,2
17209_1,,,,2,2,1,3
17211_0,,,,2,2,1,3
C(C(CO)C(C(O)=O)(CC)O)=O,,,5,1,2,0,2
17211_1,,,,2,2,1,3
17213_0,,,,2,2,1,3
C(C(CC)(C(C(C=O)=O)O)O)(O)=O,,,5,1,2,0,2
17213_1,,,,2,2,1,3
17215_0,,,,2,2,1,3
C(C(CC)(C(C(C)=O)O)O)(O)=O,,,5,1,2,0,2
17215_1,,,,2,2,1,3
17217_0,,,,2,2,1,3
C(C(CC)(CC(CO)=O)O)(O)=O,,,5,1,1,0,1
17219_0,,,,2,2,1,3
C(C(CC)(CC(C(O)=O)=O)O)(O)=O,,,5,1,1,0,1
17221_0,,,,2,2,1,3
C(C(C=O)C(C(O)=O)(CC)O)(O)=O,,,5,1,2,0,2
17221_1,,,,2,2,1,3
17223_0,,,,2,2,1,3
C(C(CC)(C(C=O)O)O)(O)=O,,,5,1,2,0,2
17223_1,,,,2,2,1,3
17225_0,,,,2,2,1,3
C=C(C=O)C(C(C(C(O)=O)=O)C)O,,,5,1,1,0,1
17227_0,,,,2,2,1,3
C(C)=CC(C(C(C(O)=O)=O)C)O,,,5,1,1,0,1
17229_0,,,,2,2,1,3
C=CCC(C(C(C(O)=O)=O)C)O,,,5,1,1,0,1
17231_0,,,,2,2,1,3
C=CC(C(C(C(C(O)=O)=O)C)O)O,,,5,1,1,0,1
17233_0,,,,2,2,1,3
C=CC(C(C(C(O)=O)=O)C)O,,,5,1,1,0,1
17235_0,,,,2,2,1,3
C1OCC(C=1)(C(C(C(O)=O)=O)C)O,,,5,1,1,0,1
17237_0,,,,2,2,1,3
C(C(C(C)C(C(CO)O)O)=O)(O)=O,,,5,1,1,0,1
17238_0,,,,2,2,1,3
17240_0,,,,2,2,1,3
C(C(C(C)C(CO)(CO)O)=O)(O)=O,,,5,1,1,0,1
17242_0,,,,2,2,1,3
C(C(C)(C(C(C(O)=O)=O)C)O)=O,,,5,1,1,0,1
17244_0,,,,2,2,1,3
C(C(C(C(C(O)=O)=O)C)O)(C)=O,,,5,1,2,0,2
17245_0,,,,2,2,1,3
17247_0,,,,2,2,1,3
C(C(C(C)C(C)O)=O)(O)=O,,,5,1,1,0,1
17249_0,,,,2,2,1,3
C(C(C(C)C(CC(C)O)O)=O)(O)=O,,,5,1,1,0,1
17251_0,,,,2,2,1,3
C(C(C(C)C(CCO)O)=O)(O)=O,,,5,1,1,0,1
17253_0,,,,2,2,1,3
C(C(CO)(C(C(C(O)=O)=O)C)O)=O,,,5,1,3,0,3
17255_0,,,,2,2,1,3
C(C(C(C(C(O)=O)=O)C)O)(CO)=O,,,5,1,2,0,2
17257_0,,,,2,2,1,3
C(C(C(C)C(C)(CO)O)=O)(O)=O,,,5,1,1,0,1
17259_0,,,,2,2,1,3
C(C(C(C(C(O)=O)=O)C)O)(O)=O,,,5,1,4,0,4
17261_0,,,,2,2,1,3
C(C(C)(C(C(C(O)=O)=O)C)O)(O)=O,,,5,1,1,0,1
17263_0,,,,2,2,1,3
C(CC(C(C(C(O)=O)=O)C)O)(O)=O,,,5,1,1,0,1
17265_0,,,,2,2,1,3
C(C(C=C)(C(C(C(O)=O)=O)C)O)=O,,,5,1,1,0,1
17267_0,,,,2,2,1,3
C=CC(C(C(C(C(O)=O)=O)C)O)=O,,,5,1,1,0,1
17269_0,,,,2,2,1,3
C(C(C(C(C(O)=O)=O)C)O)=CC=O,,,5,1,1,0,1
17271_0,,,,2,2,1,3
C(C(C(C)CO)=O)(O)=O,,,5,1,3,0,3
17273_0,,,,2,2,1,3
C(C(C(C)C(CO)O)=O)(O)=O,,,5,1,3,0,3
17275_0,,,,2,2,1,3
C(C(C=C)C(C)(CC(O)=O)O)=O,,,5,1,1,0,1
17277_0,,,,2,2,1,3
C(CC(C)(C1C(C=CO1)=O)O)(O)=O,,,5,1,2,0,2
17277_1,,,,2,2,1,3
17279_0,,,,2,2,1,3
C(CC(C)(C(C(CO)=O)O)O)(O)=O,,,5,1,2,0,2
17279_1,,,,2,2,1,3
17281_0,,,,2,2,1,3
C(CC(C)(CC(C=O)=O)O)(O)=O,,,5,1,1,0,1
17283_0,,,,2,2,1,3
C(C(C=O)C(C)(CC(O)=O)O)=O,,,5,1,2,0,2
17283_1,,,,2,2,1,3
17285_0,,,,2,2,1,3
C(CC(C)(CC=O)O)(O)=O,,,5,1,1,0,1
17287_0,,,,2,2,1,3
C(C(C(C)O)C(C)(CC(O)=O)O)=O,,,5,1,2,0,2
17287_1,,,,2,2,1,3
17289_0,,,,2,2,1,3
C(C(CO)C(C)(CC(O)=O)O)=O,,,5,1,2,0,2
17289_1,,,,2,2,1,3
17291_0,,,,2,2,1,3
C(CC(C)(C(C(C=O)=O)O)O)(O)=O,,,5,1,2,0,2
17291_1,,,,2,2,1,3
17293_0,,,,2,2,1,3
C(CC(C)(C(C(C)=O)O)O)(O)=O,,,5,1,2,0,2
17293_1,,,,2,2,1,3
17295_0,,,,2,2,1,3
C(CC(C)(CC(CO)=O)O)(O)=O,,,5,1,1,0,1
17297_0,,,,2,2,1,3
C(CC(C)(CC(C(O)=O)=O)O)(O)=O,,,5,1,1,0,1
17299_0,,,,2,2,1,3
C(C(C=O)C(C)(CC(O)=O)O)(O)=O,,,5,1,2,0,2
17299_1,,,,2,2,1,3
17300_0,,,,2,2,1,3
17300_1,,,,2,2,1,3
17302_0,,,,2,2,1,3
C(C(C(C)=O)C(C(C=O)=C)O)(O)=O,,,5,1,2,0,2
17302_1,,,,2,2,1,3
17304_0,,,,2,2,1,3
C(C(C(C)=O)C(C=CC)O)(O)=O,,,5,1,2,0,2
17304_1,,,,2,2,1,3
17306_0,,,,2,2,1,3
C(C(C(C)=O)C(CC=C)O)(O)=O,,,5,1,2,0,2
17306_1,,,,2,2,1,3
17308_0,,,,2,2,1,3
C(C(C(C)=O)C(C(C=C)O)O)(O)=O,,,5,1,2,0,2
17308_1,,,,2,2,1,3
17310_0,,,,2,2,1,3
C(C(C(C)=O)C(C=C)O)(O)=O,,,5,1,2,0,2
17310_1,,,,2,2,1,3
17312_0,,,,2,2,1,3
C(C(C(C)=O)C1(C=COC1)O)(O)=O,,,5,1,2,0,2
17312_1,,,,2,2,1,3
17314_0,,,,2,2,1,3
C(C(C(C)=O)C(C(CO)O)O)(O)=O,,,5,1,3,0,3
17314_1,,,,2,2,1,3
17316_0,,,,2,2,1,3
C(C(C(C)=O)C(C=O)O)(O)=O,,,5,1,5,0,5
17316_1,,,,2,2,1,3
17318_0,,,,2,2,1,3
C(C(C(C)=O)C(CO)(CO)O)(O)=O,,,5,1,2,0,2
17318_1,,,,2,2,1,3
17320_0,,,,2,2,1,3
C(C(C)(C(C(O)=O)C(C)=O)O)=O,,,5,1,3,0,3
17320_1,,,,2,2,1,3
17322_0,,,,2,2,1,3
C(C(C(C)=O)C(C(C)=O)O)(O)=O,,,5,1,3,0,3
17322_1,,,,2,2,1,3
17324_0,,,,2,2,1,3
C(CC(C(C(O)=O)C(C)=O)O)=O,,,5,1,3,0,3
17324_1,,,,2,2,1,3
17326_0,,,,2,2,1,3
C(C(C(C)=O)C(C)O)(O)=O,,,5,1,3,0,3
17326_1,,,,2,2,1,3
17328_0,,,,2,2,1,3
C(C(C(C)=O)C(CC(C)O)O)(O)=O,,,5,1,2,0,2
17328_1,,,,2,2,1,3
17330_0,,,,2,2,1,3
C(C(C(C)=O)C(CCO)O)(O)=O,,,5,1,3,0,3
17330_1,,,,2,2,1,3
17332_0,,,,2,2,1,3
C(C(CO)(C(C(O)=O)C(C)=O)O)=O,,,5,1,2,0,2
17332_1,,,,2,2,1,3
17334_0,,,,2,2,1,3
C(C(C(C)=O)C(C(CO)=O)O)(O)=O,,,5,1,2,0,2
17334_1,,,,2,2,1,3
17336_0,,,,2,2,1,3
C(C(C(C)=O)C(C)(CO)O)(O)=O,,,5,1,3,0,3
17336_1,,,,2,2,1,3
17338_0,,,,2,2,1,3
C(C(C(C)=O)C(C(O)=O)O)(O)=O,,,5,1,3,0,3
17338_1,,,,2,2,1,3
17340_0,,,,2,2,1,3
C(C(C)(C(C(O)=O)C(C)=O)O)(O)=O,,,5,1,2,0,2
17340_1,,,,2,2,1,3
17342_0,,,,2,2,1,3
C(CC(C(C(O)=O)C(C)=O)O)(O)=O,,,5,1,2,0,2
17342_1,,,,2,2,1,3
17344_0,,,,2,2,1,3
C(C(C(C)=O)C(C=O)(C=C)O)(O)=O,,,5,1,2,0,2
17344_1,,,,2,2,1,3
17346_0,,,,2,2,1,3
C(C(C(C)=O)C(C(C=C)=O)O)(O)=O,,,5,1,2,0,2
17346_1,,,,2,2,1,3
17348_0,,,,2,2,1,3
C(C(C(C)=O)C(C=CC=O)O)(O)=O,,,5,1,2,0,2
17348_1,,,,2,2,1,3
17349_0,,,,2,2,1,3
17349_1,,,,2,2,1,3
17350_0,,,,2,2,1,3
17350_1,,,,2,2,1,3
17352_0,,,,2,2,1,3
C(CC(CC(C(C=O)=C)O)=O)(O)=O,,,5,1,1,0,1
17354_0,,,,2,2,1,3
C(CC(CC(C=CC)O)=O)(O)=O,,,5,1,1,0,1
17356_0,,,,2,2,1,3
C(CC(CC(CC=C)O)=O)(O)=O,,,5,1,1,0,1
17358_0,,,,2,2,1,3
C(CC(C(C=C)O)O)(CC(O)=O)=O,,,5,1,1,0,1
17360_0,,,,2,2,1,3
C(CC(CC(C=C)O)=O)(O)=O,,,5,1,1,0,1
17362_0,,,,2,2,1,3
C(CC(CC1(C=COC1)O)=O)(O)=O,,,5,1,1,0,1
17364_0,,,,2,2,1,3
C(CC(CC(C(CO)O)O)=O)(O)=O,,,5,1,2,0,2
17365_0,,,,2,2,1,3
17367_0,,,,2,2,1,3
C(CC(CC(CO)(CO)O)=O)(O)=O,,,5,1,1,0,1
17369_0,,,,2,2,1,3
C(C(C)(CC(CC(O)=O)=O)O)=O,,,5,1,2,0,2
17371_0,,,,2,2,1,3
C(CC(CC(C(C)=O)O)=O)(O)=O,,,5,1,3,0,3
17372_0,,,,2,2,1,3
17374_0,,,,2,2,1,3
C(CC(CC(C)O)=O)(O)=O,,,5,1,2,0,2
17376_0,,,,2,2,1,3
C(CC(CC(CC(C)O)O)=O)(O)=O,,,5,1,1,0,1
17378_0,,,,2,2,1,3
C(CC(CC(CCO)O)=O)(O)=O,,,5,1,1,0,1
17380_0,,,,2,2,1,3
C(C(CO)(CC(CC(O)=O)=O)O)=O,,,5,1,3,0,3
17382_0,,,,2,2,1,3
C(CC(CC(C(CO)=O)O)=O)(O)=O,,,5,1,2,0,2
17384_0,,,,2,2,1,3
C(CC(CC(C)(CO)O)=O)(O)=O,,,5,1,1,0,1
17386_0,,,,2,2,1,3
C(CC(CC(C(O)=O)O)=O)(O)=O,,,5,1,5,0,5
17388_0,,,,2,2,1,3
C(C(C)(CC(CC(O)=O)=O)O)(O)=O,,,5,1,1,0,1
17390_0,,,,2,2,1,3
C(CC(CC(CC(O)=O)O)=O)(O)=O,,,5,1,1,0,1
17392_0,,,,2,2,1,3
C(C(C=C)(CC(CC(O)=O)=O)O)=O,,,5,1,1,0,1
17394_0,,,,2,2,1,3
C(CC(CC(C(C=C)=O)O)=O)(O)=O,,,5,1,1,0,1
17396_0,,,,2,2,1,3
C(CC(CC(C=CC=O)O)=O)(O)=O,,,5,1,1,0,1
17398_0,,,,2,2,1,3
C(CC(CCO)=O)(O)=O,,,5,1,5,0,5
17400_0,,,,2,2,1,3
C(CC(CC(CO)O)=O)(O)=O,,,5,1,5,0,5
17402_0,,,,2,2,1,3
C(CC1(COC(CO)C1O)O)=O,,,5,1,1,0,1
17404_0,,,,2,2,1,3
C(C(C1(COC(CO)C1O)O)O)=O,,,5,1,2,0,2
17404_1,,,,2,2,1,3
17406_0,,,,2,2,1,3
C1(C(C(C=C)O)OC(CO)C1O)=O,,,5,1,2,0,2
17406_1,,,,2,2,1,3
17408_0,,,,2,2,1,3
C(C(C1C(C(C(CO)O1)O)=O)O)=O,,,5,1,2,0,2
17408_1,,,,2,2,1,3
17410_0,,,,2,2,1,3
C1(C(C(C)O)OC(CO)C1O)=O,,,5,1,2,0,2
17410_1,,,,2,2,1,3
17412_0,,,,2,2,1,3
C1(C(CO)OC(CO)C1O)=O,,,5,1,3,0,3
17412_1,,,,2,2,1,3
17414_0,,,,2,2,1,3
C1(C(C(CO)O)OC(CO)C1O)=O,,,5,1,2,0,2
17414_1,,,,2,2,1,3
17416_0,,,,2,2,1,3
C(CC1(C(O)OC(CO)C1)O)=O,,,5,1,2,0,2
17418_0,,,,2,2,1,3
C(C(C1(C(O)OC(CO)C1)O)O)=O,,,5,1,3,0,3
17418_1,,,,2,2,1,3
17420_0,,,,2,2,1,3
C1(C(O)OC(CO)C1C(C=C)O)=O,,,5,1,2,0,2
17420_1,,,,2,2,1,3
17422_0,,,,2,2,1,3
C1(C(O)OC(CO)C1C(C=O)O)=O,,,5,1,3,0,3
17422_1,,,,2,2,1,3
17424_0,,,,2,2,1,3
C1(C(O)OC(CO)C1C(C)O)=O,,,5,1,3,0,3
17424_1,,,,2,2,1,3
17425_0,,,,2,2,1,3
17425_1,,,,2,2,1,3
17427_0,,,,2,2,1,3
C1(C(O)OC(CO)C1C(CO)O)=O,,,5,1,3,0,3
17427_1,,,,2,2,1,3
17429_0,,,,2,2,1,3
C1(C(CO)OC(C(CO)O)C1O)=O,,,5,1,2,0,2
17429_1,,,,2,2,1,3
17430_0,,,,2,2,1,3
17430_1,,,,2,2,1,3
17432_0,,,,2,2,1,3
C(C(CO)C1C(C(C(O)O1)O)O)=O,,,5,1,3,0,3
17432_1,,,,2,2,1,3
17434_0,,,,2,2,1,3
C(C1C(C(C(O1)O)O)O)(CCO)=O,,,5,1,3,0,3
17436_0,,,,2,2,1,3
C(CC(C1C(O)OCC1O)O)=O,,,5,1,2,0,2
17438_0,,,,2,2,1,3
C(C(C(C1C(O)OCC1O)O)O)=O,,,5,1,3,0,3
17438_1,,,,2,2,1,3
17440_0,,,,2,2,1,3
C(C(CO)C1(C(O)OCC1O)O)=O,,,5,1,5,0,5
17440_1,,,,2,2,1,3
17442_0,,,,2,2,1,3
C(C(CO)O)(C1C(O)OCC1O)=O,,,5,1,3,0,3
17442_1,,,,2,2,1,3
17444_0,,,,2,2,1,3
C(CCO)(C1(C(O)OCC1O)O)=O,,,5,1,2,0,2
17446_0,,,,2,2,1,3
C(CC1(COCC(C1O)O)O)=O,,,5,1,1,0,1
17448_0,,,,2,2,1,3
C(C(C1(COCC(C1O)O)O)O)=O,,,5,1,2,0,2
17448_1,,,,2,2,1,3
17450_0,,,,2,2,1,3
C1(C(C(C=C)O)OCC(C1O)O)=O,,,5,1,2,0,2
17450_1,,,,2,2,1,3
17452_0,,,,2,2,1,3
C(C(C1C(C(C(CO1)O)O)=O)O)=O,,,5,1,2,0,2
17452_1,,,,2,2,1,3
17454_0,,,,2,2,1,3
C1(C(C(C)O)OCC(C1O)O)=O,,,5,1,2,0,2
17454_1,,,,2,2,1,3
17456_0,,,,2,2,1,3
C1(C(CO)OCC(C1O)O)=O,,,5,1,3,0,3
17456_1,,,,2,2,1,3
17458_0,,,,2,2,1,3
C1(C(C(CO)O)OCC(C1O)O)=O,,,5,1,2,0,2
17458_1,,,,2,2,1,3
17460_0,,,,2,2,1,3
C(CC1(C(O)OCC(C1)O)O)=O,,,5,1,2,0,2
17462_0,,,,2,2,1,3
C(C(C1(C(O)OCC(C1)O)O)O)=O,,,5,1,3,0,3
17462_1,,,,2,2,1,3
17464_0,,,,2,2,1,3
C1(C(O)OCC(C1C(C=C)O)O)=O,,,5,1,2,0,2
17464_1,,,,2,2,1,3
17466_0,,,,2,2,1,3
C1(C(O)OCC(C1C(C=O)O)O)=O,,,5,1,3,0,3
17466_1,,,,2,2,1,3
17468_0,,,,2,2,1,3
C1(C(O)OCC(C1C(C)O)O)=O,,,5,1,3,0,3
17468_1,,,,2,2,1,3
17469_0,,,,2,2,1,3
17469_1,,,,2,2,1,3
17471_0,,,,2,2,1,3
C1(C(O)OCC(C1C(CO)O)O)=O,,,5,1,3,0,3
17471_1,,,,2,2,1,3
17473_0,,,,2,2,1,3
C(CC1(COC(C(C1)O)O)O)=O,,,5,1,2,0,2
17475_0,,,,2,2,1,3
C(C(C1(COC(C(C1)O)O)O)O)=O,,,5,1,3,0,3
17475_1,,,,2,2,1,3
17477_0,,,,2,2,1,3
C1(COC(C(C1C(C=C)O)O)O)=O,,,5,1,2,0,2
17477_1,,,,2,2,1,3
17479_0,,,,2,2,1,3
C1(COC(C(C1C(C=O)O)O)O)=O,,,5,1,3,0,3
17479_1,,,,2,2,1,3
17481_0,,,,2,2,1,3
C1(COC(C(C1C(C)O)O)O)=O,,,5,1,3,0,3
17481_1,,,,2,2,1,3
17483_0,,,,2,2,1,3
C1(COC(C(C1CO)O)O)=O,,,5,1,5,0,5
17483_1,,,,2,2,1,3
17485_0,,,,2,2,1,3
C1(COC(C(C1C(CO)O)O)O)=O,,,5,1,3,0,3
17485_1,,,,2,2,1,3
17487_0,,,,2,2,1,3
C1(C(C(C=C)O)OC(C(C1)O)O)=O,,,5,1,2,0,2
17487_1,,,,2,2,1,3
17489_0,,,,2,2,1,3
C(C(C1C(CC(C(O1)O)O)=O)O)=O,,,5,1,3,0,3
17489_1,,,,2,2,1,3
17491_0,,,,2,2,1,3
C1(C(C(C)O)OC(C(C1)O)O)=O,,,5,1,3,0,3
17491_1,,,,2,2,1,3
17492_0,,,,2,2,1,3
17492_1,,,,2,2,1,3
17494_0,,,,2,2,1,3
C1(C(C(CO)O)OC(C(C1)O)O)=O,,,5,1,3,0,3
17494_1,,,,2,2,1,3
17496_0,,,,2,2,1,3
C(CC1(CC(O)OCC1O)O)=O,,,5,1,2,0,2
17498_0,,,,2,2,1,3
C(C(C1(C(COC(C1)O)O)O)O)=O,,,5,1,3,0,3
17498_1,,,,2,2,1,3
17500_0,,,,2,2,1,3
C1(C(C(O)OCC1O)C(C=C)O)=O,,,5,1,2,0,2
17500_1,,,,2,2,1,3
17502_0,,,,2,2,1,3
C1(C(C(O)OCC1O)C(C=O)O)=O,,,5,1,3,0,3
17502_1,,,,2,2,1,3
17504_0,,,,2,2,1,3
C1(C(COC(C1C(C)O)O)O)=O,,,5,1,4,0,4
17504_1,,,,2,2,1,3
17505_0,,,,2,2,1,3
17505_1,,,,2,2,1,3
17507_0,,,,2,2,1,3
C1(C(COC(C1C(CO)O)O)O)=O,,,5,1,3,0,3
17507_1,,,,2,2,1,3
17509_0,,,,2,2,1,3
C(CC1(CCOC(C1O)O)O)=O,,,5,1,2,0,2
17511_0,,,,2,2,1,3
C(C(C1(C(C(O)OCC1)O)O)O)=O,,,5,1,3,0,3
17511_1,,,,2,2,1,3
17513_0,,,,2,2,1,3
C1(C(COC(C1O)O)C(C=C)O)=O,,,5,1,2,0,2
17513_1,,,,2,2,1,3
17515_0,,,,2,2,1,3
C1(C(COC(C1O)O)C(C=O)O)=O,,,5,1,3,0,3
17515_1,,,,2,2,1,3
17517_0,,,,2,2,1,3
C1(C(C(O)OCC1C(C)O)O)=O,,,5,1,3,0,3
17517_1,,,,2,2,1,3
17519_0,,,,2,2,1,3
C1(C(C(O)OCC1CO)O)=O,,,5,1,4,0,4
17519_1,,,,2,2,1,3
17521_0,,,,2,2,1,3
C1(C(C(O)OCC1C(CO)O)O)=O,,,5,1,3,0,3
17521_1,,,,2,2,1,3
17523_0,,,,2,2,1,3
C1(C(CO)OC(C(C1O)O)CO)=O,,,5,1,2,0,2
17523_1,,,,2,2,1,3
17524_0,,,,2,2,1,3
17524_1,,,,2,2,1,3
17526_0,,,,2,2,1,3
C1(C(CO)OC(C(C1CO)O)O)=O,,,5,1,3,0,3
17526_1,,,,2,2,1,3
17528_0,,,,2,2,1,3
C1(C(C(CO)OC(C1CO)O)O)=O,,,5,1,3,0,3
17528_1,,,,2,2,1,3
17530_0,,,,2,2,1,3
C1(C(C(O)OC(CO)C1CO)O)=O,,,5,1,3,0,3
17530_1,,,,2,2,1,3
17532_0,,,,2,2,1,3
C1(COC(C(CO)(C1CO)O)O)=O,,,5,1,3,0,3
17532_1,,,,2,2,1,3
17534_0,,,,2,2,1,3
C1(C(CO)OC(C(CO)(C1)O)O)=O,,,5,1,3,0,3
17534_1,,,,2,2,1,3
17536_0,,,,2,2,1,3
C1(C(C(O)OCC1CO)(CO)O)=O,,,5,1,3,0,3
17536_1,,,,2,2,1,3
17538_0,,,,2,2,1,3
C1(C(CO)OCC(C(C1O)O)O)=O,,,5,1,2,0,2
17538_1,,,,2,2,1,3
17539_0,,,,2,2,1,3
17539_1,,,,2,2,1,3
17541_0,,,,2,2,1,3
C1(C(COC(C(C1CO)O)O)O)=O,,,5,1,3,0,3
17541_1,,,,2,2,1,3
17543_0,,,,2,2,1,3
C1(C(C(C(O)OCC1CO)O)O)=O,,,5,1,3,0,3
17543_1,,,,2,2,1,3
17545_0,,,,2,2,1,3
C1(C(C(COC(C1CO)O)O)O)=O,,,5,1,3,0,3
17545_1,,,,2,2,1,3
17547_0,,,,2,2,1,3
C1(C(C(O)OCC(C1CO)O)O)=O,,,5,1,3,0,3
17547_1,,,,2,2,1,3
17549_0,,,,2,2,1,3
C1(COC(C(C(C1CO)O)O)O)=O,,,5,1,3,0,3
17549_1,,,,2,2,1,3
17551_0,,,,2,2,1,3
C1(C(CO)OC(C(C(C1)O)O)O)=O,,,5,1,3,0,3
17551_1,,,,2,2,1,3
17553_0,,,,2,2,1,3
C(C(C(C=O)=C)C1(C(OCC1)=O)O)=O,,,5,1,1,0,1
17555_0,,,,2,2,1,3
C1(C(CCO1)(CC(C=CC=O)=O)O)=O,,,5,1,1,0,1
17557_0,,,,2,2,1,3
C1(C(CCO1)(C(C=C)C(C=O)=O)O)=O,,,5,1,1,0,1
17559_0,,,,2,2,1,3
C(C(C=CC=O)C1(C(OCC1)=O)O)=O,,,5,1,1,0,1
17561_0,,,,2,2,1,3
C(C(C=C)C1(C(OCC1)=O)O)=O,,,5,1,1,0,1
17563_0,,,,2,2,1,3
C1(C(CCO1)(C2C(C=CO2)=O)O)=O,,,5,1,2,0,2
17563_1,,,,2,2,1,3
17565_0,,,,2,2,1,3
C1(C(CCO1)(C(C(CO)=O)O)O)=O,,,5,1,3,0,3
17565_1,,,,2,2,1,3
17567_0,,,,2,2,1,3
C1(C(CCO1)(CC(C=O)=O)O)=O,,,5,1,2,0,2
17569_0,,,,2,2,1,3
C(C(C=O)C1(C(OCC1)=O)O)=O,,,5,1,3,0,3
17569_1,,,,2,2,1,3
17571_0,,,,2,2,1,3
C1(C(CCO1)(CC=O)O)=O,,,5,1,2,0,2
17573_0,,,,2,2,1,3
C(C(C(C)O)C1(C(OCC1)=O)O)=O,,,5,1,2,0,2
17573_1,,,,2,2,1,3
17575_0,,,,2,2,1,3
C(C(CO)C1(C(OCC1)=O)O)=O,,,5,1,3,0,3
17575_1,,,,2,2,1,3
17577_0,,,,2,2,1,3
C1(C(CCO1)(C(C(C=O)=O)O)O)=O,,,5,1,2,0,2
17577_1,,,,2,2,1,3
17579_0,,,,2,2,1,3
C1(C(CCO1)(C(C(C)=O)O)O)=O,,,5,1,4,0,4
17579_1,,,,2,2,1,3
17581_0,,,,2,2,1,3
C1(C(CCO1)(CC(CO)=O)O)=O,,,5,1,2,0,2
17583_0,,,,2,2,1,3
C1(C(CCO1)(CC(C(O)=O)=O)O)=O,,,5,1,1,0,1
17585_0,,,,2,2,1,3
C(C(C=O)C1(C(OCC1)=O)O)(O)=O,,,5,1,2,0,2
17585_1,,,,2,2,1,3
17587_0,,,,2,2,1,3
C1(C(CCO1)(C(C=O)O)O)=O,,,5,1,4,0,4
17587_1,,,,2,2,1,3
17589_0,,,,2,2,1,3
C(C(C1C(C(OC1)=O)=O)O)=C(C=O)C,,,5,1,2,0,2
17589_1,,,,2,2,1,3
17591_0,,,,2,2,1,3
C(C(C1C(C(OC1)=O)=O)O)(C)=CC=O,,,5,1,2,0,2
17591_1,,,,2,2,1,3
17593_0,,,,2,2,1,3
C=C(C=O)CC(C1C(C(OC1)=O)=O)O,,,5,1,2,0,2
17593_1,,,,2,2,1,3
17595_0,,,,2,2,1,3
C(CC(C(C1C(C(OC1)=O)=O)O)=C)=O,,,5,1,2,0,2
17595_1,,,,2,2,1,3
17597_0,,,,2,2,1,3
C(C(C1C(C(OC1)=O)=O)O)=CC(C)=O,,,5,1,2,0,2
17597_1,,,,2,2,1,3
17599_0,,,,2,2,1,3
C(C(C)(C1C(C(OC1)=O)=O)O)=CC=O,,,5,1,2,0,2
17599_1,,,,2,2,1,3
17601_0,,,,2,2,1,3
C(C(CC=C)(C1C(C(OC1)=O)=O)O)=O,,,5,1,2,0,2
17601_1,,,,2,2,1,3
17603_0,,,,2,2,1,3
C(C(C1C(C(OC1)=O)=O)O)(CC=C)=O,,,5,1,2,0,2
17603_1,,,,2,2,1,3
17605_0,,,,2,2,1,3
C(C(C=CC)(C1C(C(OC1)=O)=O)O)=O,,,5,1,2,0,2
17605_1,,,,2,2,1,3
17607_0,,,,2,2,1,3
C(C)=CC(C(C1C(C(OC1)=O)=O)O)=O,,,5,1,2,0,2
17607_1,,,,2,2,1,3
17609_0,,,,2,2,1,3
C(CC=CC(C1C(C(OC1)=O)=O)O)=O,,,5,1,2,0,2
17609_1,,,,2,2,1,3
17611_0,,,,2,2,1,3
C(CC(C1C(C(OC1)=O)=O)O)=CC=O,,,5,1,2,0,2
17611_1,,,,2,2,1,3
17613_0,,,,2,2,1,3
C(C(C=C)C(C1C(C(OC1)=O)=O)O)=O,,,5,1,2,0,2
17613_1,,,,2,2,1,3
17615_0,,,,2,2,1,3
C(C)=C(C=O)C(C1C(C(OC1)=O)=O)O,,,5,1,2,0,2
17615_1,,,,2,2,1,3
17617_0,,,,2,2,1,3
C=C(C=O)C(C1C(C(OC1)=O)=O)O,,,5,1,2,0,2
17617_1,,,,2,2,1,3
17619_0,,,,2,2,1,3
C(C)=CC(C1C(C(OC1)=O)=O)O,,,5,1,2,0,2
17619_1,,,,2,2,1,3
17621_0,,,,2,2,1,3
C=CCC(C1C(C(OC1)=O)=O)O,,,5,1,2,0,2
17621_1,,,,2,2,1,3
17623_0,,,,2,2,1,3
C=CC(C(C1C(C(OC1)=O)=O)O)O,,,5,1,2,0,2
17623_1,,,,2,2,1,3
17625_0,,,,2,2,1,3
C=CC(C1C(C(OC1)=O)=O)O,,,5,1,2,0,2
17625_1,,,,2,2,1,3
17627_0,,,,2,2,1,3
C1OCC(C=1)(C2C(C(OC2)=O)=O)O,,,5,1,2,0,2
17627_1,,,,2,2,1,3
17629_0,,,,2,2,1,3
C1(C(C(CO1)C(C(CO)O)O)=O)=O,,,5,1,2,0,2
17629_1,,,,2,2,1,3
17631_0,,,,2,2,1,3
C(C(C1C(C(OC1)=O)=O)O)=O,,,5,1,3,0,3
17631_1,,,,2,2,1,3
17633_0,,,,2,2,1,3
C1(C(C(CO1)C(CO)(CO)O)=O)=O,,,5,1,2,0,2
17633_1,,,,2,2,1,3
17635_0,,,,2,2,1,3
C(C(C)(C1C(C(OC1)=O)=O)O)=O,,,5,1,3,0,3
17635_1,,,,2,2,1,3
17637_0,,,,2,2,1,3
C(C(C1C(C(OC1)=O)=O)O)(C)=O,,,5,1,3,0,3
17637_1,,,,2,2,1,3
17639_0,,,,2,2,1,3
C(CC(C1C(C(OC1)=O)=O)O)=O,,,5,1,3,0,3
17639_1,,,,2,2,1,3
17641_0,,,,2,2,1,3
C1(C(C(CO1)C(C)O)=O)=O,,,5,1,3,0,3
17641_1,,,,2,2,1,3
17643_0,,,,2,2,1,3
C1(C(C(CO1)C(CC(C)O)O)=O)=O,,,5,1,2,0,2
17643_1,,,,2,2,1,3
17645_0,,,,2,2,1,3
C1(C(C(CO1)C(CCO)O)=O)=O,,,5,1,3,0,3
17645_1,,,,2,2,1,3
17647_0,,,,2,2,1,3
C(C(CO)(C1C(C(OC1)=O)=O)O)=O,,,5,1,2,0,2
17647_1,,,,2,2,1,3
17649_0,,,,2,2,1,3
C(C(C1C(C(OC1)=O)=O)O)(CO)=O,,,5,1,2,0,2
17649_1,,,,2,2,1,3
17651_0,,,,2,2,1,3
C1(C(C(CO1)C(C)(CO)O)=O)=O,,,5,1,3,0,3
17651_1,,,,2,2,1,3
17653_0,,,,2,2,1,3
C(C(C1C(C(OC1)=O)=O)O)(O)=O,,,5,1,3,0,3
17653_1,,,,2,2,1,3
17655_0,,,,2,2,1,3
C(C(C)(C1C(C(OC1)=O)=O)O)(O)=O,,,5,1,2,0,2
17655_1,,,,2,2,1,3
17657_0,,,,2,2,1,3
C(CC(C1C(C(OC1)=O)=O)O)(O)=O,,,5,1,2,0,2
17657_1,,,,2,2,1,3
17659_0,,,,2,2,1,3
C(C(C=C)(C1C(C(OC1)=O)=O)O)=O,,,5,1,2,0,2
17659_1,,,,2,2,1,3
17661_0,,,,2,2,1,3
C=CC(C(C1C(C(OC1)=O)=O)O)=O,,,5,1,2,0,2
17661_1,,,,2,2,1,3
17663_0,,,,2,2,1,3
C(C(C1C(C(OC1)=O)=O)O)=CC=O,,,5,1,2,0,2
17663_1,,,,2,2,1,3
17665_0,,,,2,2,1,3
C1(C(C(CO1)CO)=O)=O,,,5,1,4,0,4
17665_1,,,,2,2,1,3
17667_0,,,,2,2,1,3
C1(C(C(CO1)C(CO)O)=O)=O,,,5,1,4,0,4
17667_1,,,,2,2,1,3
17669_0,,,,2,2,1,3
C(C(C(C=O)=C)C1(COC(C1)=O)O)=O,,,5,1,1,0,1
17671_0,,,,2,2,1,3
C1(CC(CO1)(CC(C=CC=O)=O)O)=O,,,5,1,1,0,1
17673_0,,,,2,2,1,3
C1(CC(CO1)(C(C=C)C(C=O)=O)O)=O,,,5,1,1,0,1
17675_0,,,,2,2,1,3
C(C(C=CC=O)C1(COC(C1)=O)O)=O,,,5,1,1,0,1
17677_0,,,,2,2,1,3
C(C(C=C)C1(COC(C1)=O)O)=O,,,5,1,1,0,1
17679_0,,,,2,2,1,3
C1(CC(CO1)(C2C(C=CO2)=O)O)=O,,,5,1,2,0,2
17679_1,,,,2,2,1,3
17681_0,,,,2,2,1,3
C1(CC(CO1)(C(C(CO)=O)O)O)=O,,,5,1,2,0,2
17681_1,,,,2,2,1,3
17683_0,,,,2,2,1,3
C1(CC(CO1)(CC(C=O)=O)O)=O,,,5,1,2,0,2
17685_0,,,,2,2,1,3
C(C(C=O)C1(COC(C1)=O)O)=O,,,5,1,3,0,3
17685_1,,,,2,2,1,3
17687_0,,,,2,2,1,3
C1(CC(CO1)(CC=O)O)=O,,,5,1,3,0,3
17689_0,,,,2,2,1,3
C(C(C(C)O)C1(COC(C1)=O)O)=O,,,5,1,2,0,2
17689_1,,,,2,2,1,3
17691_0,,,,2,2,1,3
C(C(CO)C1(COC(C1)=O)O)=O,,,5,1,3,0,3
17691_1,,,,2,2,1,3
17693_0,,,,2,2,1,3
C1(CC(CO1)(C(C(C=O)=O)O)O)=O,,,5,1,2,0,2
17693_1,,,,2,2,1,3
17695_0,,,,2,2,1,3
C1(CC(CO1)(C(C(C)=O)O)O)=O,,,5,1,3,0,3
17695_1,,,,2,2,1,3
17697_0,,,,2,2,1,3
C1(CC(CO1)(CC(CO)=O)O)=O,,,5,1,2,0,2
17699_0,,,,2,2,1,3
C1(CC(CO1)(CC(C(O)=O)=O)O)=O,,,5,1,1,0,1
17701_0,,,,2,2,1,3
C(C(C=O)C1(COC(C1)=O)O)(O)=O,,,5,1,2,0,2
17701_1,,,,2,2,1,3
17703_0,,,,2,2,1,3
C1(CC(CO1)(C(C=O)O)O)=O,,,5,1,3,0,3
17703_1,,,,2,2,1,3
17705_0,,,,2,2,1,3
C1(C(C(CO1)=O)C(C=C(C=O)C)O)=O,,,5,1,2,0,2
17705_1,,,,2,2,1,3
17707_0,,,,2,2,1,3
C1(C(C(CO1)=O)C(C(C)=CC=O)O)=O,,,5,1,2,0,2
17707_1,,,,2,2,1,3
17709_0,,,,2,2,1,3
C1(C(C(CO1)=O)C(CC(C=O)=C)O)=O,,,5,1,2,0,2
17709_1,,,,2,2,1,3
17711_0,,,,2,2,1,3
C1(C(C(CO1)=O)C(C(CC=O)=C)O)=O,,,5,1,2,0,2
17711_1,,,,2,2,1,3
17713_0,,,,2,2,1,3
C1(C(C(CO1)=O)C(C=CC(C)=O)O)=O,,,5,1,2,0,2
17713_1,,,,2,2,1,3
17715_0,,,,2,2,1,3
C1(C(C(CO1)=O)C(C=CC=O)(C)O)=O,,,5,1,2,0,2
17715_1,,,,2,2,1,3
17717_0,,,,2,2,1,3
C1(C(C(CO1)=O)C(C=O)(CC=C)O)=O,,,5,1,2,0,2
17717_1,,,,2,2,1,3
17719_0,,,,2,2,1,3
C1(C(C(CO1)=O)C(C(CC=C)=O)O)=O,,,5,1,2,0,2
17719_1,,,,2,2,1,3
17721_0,,,,2,2,1,3
C1(C(C(CO1)=O)C(C=O)(C=CC)O)=O,,,5,1,2,0,2
17721_1,,,,2,2,1,3
17723_0,,,,2,2,1,3
C1(C(C(CO1)=O)C(C(C=CC)=O)O)=O,,,5,1,2,0,2
17723_1,,,,2,2,1,3
17725_0,,,,2,2,1,3
C1(C(C(CO1)=O)C(C=CCC=O)O)=O,,,5,1,2,0,2
17725_1,,,,2,2,1,3
17727_0,,,,2,2,1,3
C1(C(C(CO1)=O)C(CC=CC=O)O)=O,,,5,1,2,0,2
17727_1,,,,2,2,1,3
17729_0,,,,2,2,1,3
C(C(C=C)C(C1C(OCC1=O)=O)O)=O,,,5,1,2,0,2
17729_1,,,,2,2,1,3
17731_0,,,,2,2,1,3
C1(C(C(CO1)=O)C(C(C=O)=CC)O)=O,,,5,1,2,0,2
17731_1,,,,2,2,1,3
17733_0,,,,2,2,1,3
C1(C(C(CO1)=O)C(C(C=O)=C)O)=O,,,5,1,2,0,2
17733_1,,,,2,2,1,3
17735_0,,,,2,2,1,3
C1(C(C(CO1)=O)C(C=CC)O)=O,,,5,1,2,0,2
17735_1,,,,2,2,1,3
17737_0,,,,2,2,1,3
C1(C(C(CO1)=O)C(CC=C)O)=O,,,5,1,2,0,2
17737_1,,,,2,2,1,3
17739_0,,,,2,2,1,3
C1(C(C(CO1)=O)C(C(C=C)O)O)=O,,,5,1,2,0,2
17739_1,,,,2,2,1,3
17741_0,,,,2,2,1,3
C1(C(C(CO1)=O)C(C=C)O)=O,,,5,1,2,0,2
17741_1,,,,2,2,1,3
17743_0,,,,2,2,1,3
C1(C(C(CO1)=O)C2(C=COC2)O)=O,,,5,1,2,0,2
17743_1,,,,2,2,1,3
17745_0,,,,2,2,1,3
C1(C(C(CO1)=O)C(C(CO)O)O)=O,,,5,1,2,0,2
17745_1,,,,2,2,1,3
17747_0,,,,2,2,1,3
C1(C(C(CO1)=O)C(C=O)O)=O,,,5,1,4,0,4
17747_1,,,,2,2,1,3
17749_0,,,,2,2,1,3
C1(C(C(CO1)=O)C(CO)(CO)O)=O,,,5,1,2,0,2
17749_1,,,,2,2,1,3
17751_0,,,,2,2,1,3
C(C(C)(C1C(OCC1=O)=O)O)=O,,,5,1,4,0,4
17751_1,,,,2,2,1,3
17753_0,,,,2,2,1,3
C1(C(C(CO1)=O)C(C(C)=O)O)=O,,,5,1,4,0,4
17753_1,,,,2,2,1,3
17755_0,,,,2,2,1,3
C(CC(C1C(OCC1=O)=O)O)=O,,,5,1,4,0,4
17755_1,,,,2,2,1,3
17757_0,,,,2,2,1,3
C1(C(C(CO1)=O)C(C)O)=O,,,5,1,4,0,4
17757_1,,,,2,2,1,3
17759_0,,,,2,2,1,3
C1(C(C(CO1)=O)C(CC(C)O)O)=O,,,5,1,2,0,2
17759_1,,,,2,2,1,3
17761_0,,,,2,2,1,3
C1(C(C(CO1)=O)C(CCO)O)=O,,,5,1,4,0,4
17761_1,,,,2,2,1,3
17763_0,,,,2,2,1,3
C(C(CO)(C1C(OCC1=O)=O)O)=O,,,5,1,2,0,2
17763_1,,,,2,2,1,3
17765_0,,,,2,2,1,3
C1(C(C(CO1)=O)C(C(CO)=O)O)=O,,,5,1,2,0,2
17765_1,,,,2,2,1,3
17767_0,,,,2,2,1,3
C1(C(C(CO1)=O)C(C)(CO)O)=O,,,5,1,4,0,4
17767_1,,,,2,2,1,3
17769_0,,,,2,2,1,3
C1(C(C(CO1)=O)C(C(O)=O)O)=O,,,5,1,4,0,4
17769_1,,,,2,2,1,3
17771_0,,,,2,2,1,3
C(C(C)(C1C(OCC1=O)=O)O)(O)=O,,,5,1,2,0,2
17771_1,,,,2,2,1,3
17773_0,,,,2,2,1,3
C(CC(C1C(OCC1=O)=O)O)(O)=O,,,5,1,2,0,2
17773_1,,,,2,2,1,3
17775_0,,,,2,2,1,3
C1(C(C(CO1)=O)C(C=O)(C=C)O)=O,,,5,1,2,0,2
17775_1,,,,2,2,1,3
17777_0,,,,2,2,1,3
C1(C(C(CO1)=O)C(C(C=C)=O)O)=O,,,5,1,2,0,2
17777_1,,,,2,2,1,3
17779_0,,,,2,2,1,3
C1(C(C(CO1)=O)C(C=CC=O)O)=O,,,5,1,2,0,2
17779_1,,,,2,2,1,3
17781_0,,,,2,2,1,3
C1(C(C(CO1)=O)CO)=O,,,5,1,4,0,4
17781_1,,,,2,2,1,3
17783_0,,,,2,2,1,3
C1(C(C(CO1)=O)C(CO)O)=O,,,5,1,4,0,4
17783_1,,,,2,2,1,3
17785_0,,,,2,2,1,3
C1(CC(C(C(C=C(C=O)C)O)O1)=O)=O,,,5,1,2,0,2
17785_1,,,,2,2,1,3
17787_0,,,,2,2,1,3
C1(CC(C(C(C(C)=CC=O)O)O1)=O)=O,,,5,1,2,0,2
17787_1,,,,2,2,1,3
17789_0,,,,2,2,1,3
C1(CC(C(C(CC(C=O)=C)O)O1)=O)=O,,,5,1,2,0,2
17789_1,,,,2,2,1,3
17791_0,,,,2,2,1,3
C1(CC(C(C(C(CC=O)=C)O)O1)=O)=O,,,5,1,2,0,2
17791_1,,,,2,2,1,3
17793_0,,,,2,2,1,3
C1(CC(C(C(C=CC(C)=O)O)O1)=O)=O,,,5,1,2,0,2
17793_1,,,,2,2,1,3
17795_0,,,,2,2,1,3
C1(CC(C(C(C=CC=O)(C)O)O1)=O)=O,,,5,1,2,0,2
17795_1,,,,2,2,1,3
17797_0,,,,2,2,1,3
C1(CC(C(C(C=O)(CC=C)O)O1)=O)=O,,,5,1,2,0,2
17797_1,,,,2,2,1,3
17799_0,,,,2,2,1,3
C1(CC(C(C(C(CC=C)=O)O)O1)=O)=O,,,5,1,2,0,2
17799_1,,,,2,2,1,3
17801_0,,,,2,2,1,3
C(C(C=CC)(C1C(CC(O1)=O)=O)O)=O,,,5,1,2,0,2
17801_1,,,,2,2,1,3
17803_0,,,,2,2,1,3
C1(CC(C(C(C(C=CC)=O)O)O1)=O)=O,,,5,1,2,0,2
17803_1,,,,2,2,1,3
17805_0,,,,2,2,1,3
C(CC=CC(C1C(CC(O1)=O)=O)O)=O,,,5,1,2,0,2
17805_1,,,,2,2,1,3
17807_0,,,,2,2,1,3
C1(CC(C(C(CC=CC=O)O)O1)=O)=O,,,5,1,2,0,2
17807_1,,,,2,2,1,3
17809_0,,,,2,2,1,3
C(C(C=C)C(C1C(CC(O1)=O)=O)O)=O,,,5,1,2,0,2
17809_1,,,,2,2,1,3
17811_0,,,,2,2,1,3
C1(CC(C(C(C(C=O)=CC)O)O1)=O)=O,,,5,1,2,0,2
17811_1,,,,2,2,1,3
17813_0,,,,2,2,1,3
C1(CC(C(C(C(C=O)=C)O)O1)=O)=O,,,5,1,2,0,2
17813_1,,,,2,2,1,3
17815_0,,,,2,2,1,3
C1(CC(C(C(C=CC)O)O1)=O)=O,,,5,1,2,0,2
17815_1,,,,2,2,1,3
17817_0,,,,2,2,1,3
C1(CC(C(C(CC=C)O)O1)=O)=O,,,5,1,2,0,2
17817_1,,,,2,2,1,3
17819_0,,,,2,2,1,3
C1(CC(C(C(C(C=C)O)O)O1)=O)=O,,,5,1,2,0,2
17819_1,,,,2,2,1,3
17821_0,,,,2,2,1,3
C1(CC(C(C(C=C)O)O1)=O)=O,,,5,1,2,0,2
17821_1,,,,2,2,1,3
17823_0,,,,2,2,1,3
C1(CC(C(C2(C=COC2)O)O1)=O)=O,,,5,1,2,0,2
17823_1,,,,2,2,1,3
17825_0,,,,2,2,1,3
C1(CC(C(C(C(CO)O)O)O1)=O)=O,,,5,1,2,0,2
17825_1,,,,2,2,1,3
17827_0,,,,2,2,1,3
C1(CC(C(C(C=O)O)O1)=O)=O,,,5,1,3,0,3
17827_1,,,,2,2,1,3
17829_0,,,,2,2,1,3
C1(CC(C(C(CO)(CO)O)O1)=O)=O,,,5,1,2,0,2
17829_1,,,,2,2,1,3
17831_0,,,,2,2,1,3
C(C(C)(C1C(CC(O1)=O)=O)O)=O,,,5,1,3,0,3
17831_1,,,,2,2,1,3
17833_0,,,,2,2,1,3
C1(CC(C(C(C(C)=O)O)O1)=O)=O,,,5,1,3,0,3
17833_1,,,,2,2,1,3
17835_0,,,,2,2,1,3
C(CC(C1C(CC(O1)=O)=O)O)=O,,,5,1,3,0,3
17835_1,,,,2,2,1,3
17837_0,,,,2,2,1,3
C1(CC(C(C(C)O)O1)=O)=O,,,5,1,3,0,3
17837_1,,,,2,2,1,3
17839_0,,,,2,2,1,3
C1(CC(C(C(CC(C)O)O)O1)=O)=O,,,5,1,2,0,2
17839_1,,,,2,2,1,3
17841_0,,,,2,2,1,3
C1(CC(C(C(CCO)O)O1)=O)=O,,,5,1,3,0,3
17841_1,,,,2,2,1,3
17843_0,,,,2,2,1,3
C(C(CO)(C1C(CC(O1)=O)=O)O)=O,,,5,1,2,0,2
17843_1,,,,2,2,1,3
17845_0,,,,2,2,1,3
C1(CC(C(C(C(CO)=O)O)O1)=O)=O,,,5,1,2,0,2
17845_1,,,,2,2,1,3
17847_0,,,,2,2,1,3
C1(CC(C(C(C)(CO)O)O1)=O)=O,,,5,1,3,0,3
17847_1,,,,2,2,1,3
17849_0,,,,2,2,1,3
C1(CC(C(C(C(O)=O)O)O1)=O)=O,,,5,1,3,0,3
17849_1,,,,2,2,1,3
17851_0,,,,2,2,1,3
C(C(C)(C1C(CC(O1)=O)=O)O)(O)=O,,,5,1,2,0,2
17851_1,,,,2,2,1,3
17853_0,,,,2,2,1,3
C(CC(C1C(CC(O1)=O)=O)O)(O)=O,,,5,1,2,0,2
17853_1,,,,2,2,1,3
17855_0,,,,2,2,1,3
C(C(C=C)(C1C(CC(O1)=O)=O)O)=O,,,5,1,2,0,2
17855_1,,,,2,2,1,3
17857_0,,,,2,2,1,3
C1(CC(C(C(C(C=C)=O)O)O1)=O)=O,,,5,1,2,0,2
17857_1,,,,2,2,1,3
17859_0,,,,2,2,1,3
C1(CC(C(C(C=CC=O)O)O1)=O)=O,,,5,1,2,0,2
17859_1,,,,2,2,1,3
17860_0,,,,2,2,1,3
17860_1,,,,2,2,1,3
17861_0,,,,2,2,1,3
17861_1,,,,2,2,1,3
17863_0,,,,2,2,1,3
C1(C(CC(CO)O1)(CC=O)O)=O,,,5,1,2,0,2
17865_0,,,,2,2,1,3
C1(C(CC(CO)O1)(C(C=O)O)O)=O,,,5,1,2,0,2
17865_1,,,,2,2,1,3
17867_0,,,,2,2,1,3
C=CC(C1C(C(OC1CO)=O)=O)O,,,5,1,2,0,2
17867_1,,,,2,2,1,3
17869_0,,,,2,2,1,3
C(C(C1C(C(OC1CO)=O)=O)O)=O,,,5,1,2,0,2
17869_1,,,,2,2,1,3
17871_0,,,,2,2,1,3
C1(C(C(C(CO)O1)C(C)O)=O)=O,,,5,1,3,0,3
17871_1,,,,2,2,1,3
17873_0,,,,2,2,1,3
C1(C(C(CO)C(CO)O1)=O)=O,,,5,1,4,0,4
17873_1,,,,2,2,1,3
17875_0,,,,2,2,1,3
C1(C(C(C(CO)O1)C(CO)O)=O)=O,,,5,1,2,0,2
17875_1,,,,2,2,1,3
17877_0,,,,2,2,1,3
C1(CC(C(CO)O1)(CC=O)O)=O,,,5,1,2,0,2
17879_0,,,,2,2,1,3
C1(CC(C(CO)O1)(C(C=O)O)O)=O,,,5,1,2,0,2
17879_1,,,,2,2,1,3
17881_0,,,,2,2,1,3
C1(C(CO)OC(C1C(C=C)O)=O)=O,,,5,1,2,0,2
17881_1,,,,2,2,1,3
17883_0,,,,2,2,1,3
C1(C(CO)OC(C1C(C=O)O)=O)=O,,,5,1,2,0,2
17883_1,,,,2,2,1,3
17885_0,,,,2,2,1,3
C1(C(C(C(CO)O1)=O)C(C)O)=O,,,5,1,4,0,4
17885_1,,,,2,2,1,3
17887_0,,,,2,2,1,3
C1(C(C(C(CO)O1)=O)CO)=O,,,5,1,4,0,4
17887_1,,,,2,2,1,3
17889_0,,,,2,2,1,3
C1(C(C(C(CO)O1)=O)C(CO)O)=O,,,5,1,2,0,2
17889_1,,,,2,2,1,3
17891_0,,,,2,2,1,3
C1(C(C(CO)C(C(CO)O)O1)=O)=O,,,5,1,2,0,2
17891_1,,,,2,2,1,3
17893_0,,,,2,2,1,3
C1(C(C(C(C(CO)O)O1)=O)CO)=O,,,5,1,2,0,2
17893_1,,,,2,2,1,3
17895_0,,,,2,2,1,3
C(C(CO)C1C(C(C(O1)=O)O)O)=O,,,5,1,2,0,2
17895_1,,,,2,2,1,3
17897_0,,,,2,2,1,3
C1(C(C(C(C(CCO)=O)O1)O)O)=O,,,5,1,1,0,1
17899_0,,,,2,2,1,3
C1(C(CC(CO1)O)(CC=O)O)=O,,,5,1,2,0,2
17901_0,,,,2,2,1,3
C1(C(CC(CO1)O)(C(C=O)O)O)=O,,,5,1,2,0,2
17901_1,,,,2,2,1,3
17903_0,,,,2,2,1,3
C=CC(C1C(C(OCC1O)=O)=O)O,,,5,1,2,0,2
17903_1,,,,2,2,1,3
17905_0,,,,2,2,1,3
C(C(C1C(C(OCC1O)=O)=O)O)=O,,,5,1,2,0,2
17905_1,,,,2,2,1,3
17907_0,,,,2,2,1,3
C1(C(C(C(C)O)C(CO1)O)=O)=O,,,5,1,3,0,3
17907_1,,,,2,2,1,3
17909_0,,,,2,2,1,3
C1(C(C(CO)C(CO1)O)=O)=O,,,5,1,4,0,4
17909_1,,,,2,2,1,3
17911_0,,,,2,2,1,3
C1(C(C(C(CO)O)C(CO1)O)=O)=O,,,5,1,2,0,2
17911_1,,,,2,2,1,3
17913_0,,,,2,2,1,3
C(CC1(COC(C(C1)O)=O)O)=O,,,5,1,3,0,3
17915_0,,,,2,2,1,3
C1(C(CC(CO1)(C(C=O)O)O)O)=O,,,5,1,2,0,2
17915_1,,,,2,2,1,3
17917_0,,,,2,2,1,3
C1(C(C(C(CO1)=O)C(C=C)O)O)=O,,,5,1,2,0,2
17917_1,,,,2,2,1,3
17919_0,,,,2,2,1,3
C1(C(C(C(CO1)=O)C(C=O)O)O)=O,,,5,1,2,0,2
17919_1,,,,2,2,1,3
17921_0,,,,2,2,1,3
C1(COC(C(C1C(C)O)O)=O)=O,,,5,1,3,0,3
17921_1,,,,2,2,1,3
17923_0,,,,2,2,1,3
C1(COC(C(C1CO)O)=O)=O,,,5,1,4,0,4
17923_1,,,,2,2,1,3
17925_0,,,,2,2,1,3
C1(COC(C(C1C(CO)O)O)=O)=O,,,5,1,2,0,2
17925_1,,,,2,2,1,3
17927_0,,,,2,2,1,3
C1(C(CC(C(C(C=C)O)O1)=O)O)=O,,,5,1,2,0,2
17927_1,,,,2,2,1,3
17929_0,,,,2,2,1,3
C1(C(CC(C(C(C=O)O)O1)=O)O)=O,,,5,1,2,0,2
17929_1,,,,2,2,1,3
17931_0,,,,2,2,1,3
C1(CC(C(OC1C(C)O)=O)O)=O,,,5,1,3,0,3
17931_1,,,,2,2,1,3
17932_0,,,,2,2,1,3
17932_1,,,,2,2,1,3
17934_0,,,,2,2,1,3
C1(CC(C(OC1C(CO)O)=O)O)=O,,,5,1,2,0,2
17934_1,,,,2,2,1,3
17936_0,,,,2,2,1,3
C1(CC(C(CO1)O)(CC=O)O)=O,,,5,1,2,0,2
17938_0,,,,2,2,1,3
C1(CC(C(CO1)O)(C(C=O)O)O)=O,,,5,1,2,0,2
17938_1,,,,2,2,1,3
17940_0,,,,2,2,1,3
C1(C(COC(C1C(C=C)O)=O)O)=O,,,5,1,2,0,2
17940_1,,,,2,2,1,3
17942_0,,,,2,2,1,3
C1(C(COC(C1C(C=O)O)=O)O)=O,,,5,1,2,0,2
17942_1,,,,2,2,1,3
17944_0,,,,2,2,1,3
C1(C(C(C(CO1)O)=O)C(C)O)=O,,,5,1,4,0,4
17944_1,,,,2,2,1,3
17946_0,,,,2,2,1,3
C1(C(C(C(CO1)O)=O)CO)=O,,,5,1,4,0,4
17946_1,,,,2,2,1,3
17948_0,,,,2,2,1,3
C1(C(C(C(CO1)O)=O)C(CO)O)=O,,,5,1,2,0,2
17948_1,,,,2,2,1,3
17950_0,,,,2,2,1,3
C(CC1(CCOC(C1O)=O)O)=O,,,5,1,2,0,2
17952_0,,,,2,2,1,3
C1(C(C(CCO1)(C(C=O)O)O)O)=O,,,5,1,2,0,2
17952_1,,,,2,2,1,3
17954_0,,,,2,2,1,3
C1(C(COC(C1O)=O)C(C=C)O)=O,,,5,1,2,0,2
17954_1,,,,2,2,1,3
17956_0,,,,2,2,1,3
C1(C(COC(C1O)=O)C(C=O)O)=O,,,5,1,2,0,2
17956_1,,,,2,2,1,3
17958_0,,,,2,2,1,3
C1(C(C(C(CO1)C(C)O)=O)O)=O,,,5,1,3,0,3
17958_1,,,,2,2,1,3
17960_0,,,,2,2,1,3
C1(C(C(C(CO)CO1)=O)O)=O,,,5,1,4,0,4
17960_1,,,,2,2,1,3
17962_0,,,,2,2,1,3
C1(C(C(C(CO1)C(CO)O)=O)O)=O,,,5,1,2,0,2
17962_1,,,,2,2,1,3
17964_0,,,,2,2,1,3
C1(C(C(CO)C(C(CO)O1)O)=O)=O,,,5,1,2,0,2
17964_1,,,,2,2,1,3
17966_0,,,,2,2,1,3
C1(C(CO)OC(C(C1CO)O)=O)=O,,,5,1,2,0,2
17966_1,,,,2,2,1,3
17968_0,,,,2,2,1,3
C1(C(C(C(C(CO)O1)O)=O)CO)=O,,,5,1,2,0,2
17968_1,,,,2,2,1,3
17970_0,,,,2,2,1,3
C1(C(C(C(CO)C(CO)O1)=O)O)=O,,,5,1,2,0,2
17970_1,,,,2,2,1,3
17972_0,,,,2,2,1,3
C1(C(C(CO)C(C(CO1)O)O)=O)=O,,,5,1,2,0,2
17972_1,,,,2,2,1,3
17974_0,,,,2,2,1,3
C1(C(CO)C(C(OCC1O)=O)O)=O,,,5,1,2,0,2
17974_1,,,,2,2,1,3
17976_0,,,,2,2,1,3
C1(C(C(C(OCC1CO)=O)O)O)=O,,,5,1,2,0,2
17976_1,,,,2,2,1,3
17978_0,,,,2,2,1,3
C1(C(C(C(C(CO1)O)O)=O)CO)=O,,,5,1,2,0,2
17978_1,,,,2,2,1,3
17980_0,,,,2,2,1,3
C1(C(C(C(CO)C(CO1)O)=O)O)=O,,,5,1,2,0,2
17980_1,,,,2,2,1,3
17982_0,,,,2,2,1,3
C1(C(C(C(C(CO1)=O)CO)O)O)=O,,,5,1,2,0,2
17982_1,,,,2,2,1,3
17984_0,,,,2,2,1,3
C1(C(C(CC(C(CO)O1)=O)O)O)=O,,,5,1,2,0,2
17984_1,,,,2,2,1,3
17986_0,,,,2,2,1,3
C(C(C=C)C(C=O)(C=CC=O)O)=O,,,5,1,1,0,1
17988_0,,,,2,2,1,3
C(C(C=CC=O)(C1C(C=CO1)=O)O)=O,,,5,1,2,0,2
17988_1,,,,2,2,1,3
17990_0,,,,2,2,1,3
C(C(C=CC=O)(CC(C=O)=O)O)=O,,,5,1,1,0,1
17992_0,,,,2,2,1,3
C(C(C=O)C(C=O)(C=CC=O)O)=O,,,5,1,2,0,2
17992_1,,,,2,2,1,3
17993_0,,,,2,2,1,3
17995_0,,,,2,2,1,3
C(C(C=CC=O)(C(C=O)CO)O)=O,,,5,1,4,0,4
17995_1,,,,2,2,1,3
17997_0,,,,2,2,1,3
C(C(C=CC=O)(C(C(C)=O)O)O)=O,,,5,1,3,0,3
17997_1,,,,2,2,1,3
17999_0,,,,2,2,1,3
C(C(C=CC=O)(CC(CO)=O)O)=O,,,5,1,1,0,1
18001_0,,,,2,2,1,3
C(C(C=CC=O)(C(C=O)O)O)=O,,,5,1,5,0,5
18001_1,,,,2,2,1,3
18003_0,,,,2,2,1,3
C(C(C=C)C(C(C=CC=O)=O)O)=O,,,5,1,1,0,1
18005_0,,,,2,2,1,3
C1OC(C(C=1)=O)C(C(C=CC=O)=O)O,,,5,1,2,0,2
18005_1,,,,2,2,1,3
18007_0,,,,2,2,1,3
C(C(CC(C(C=CC=O)=O)O)=O)=O,,,5,1,1,0,1
18009_0,,,,2,2,1,3
C(C(C=O)C(C(C=CC=O)=O)O)=O,,,5,1,2,0,2
18009_1,,,,2,2,1,3
18011_0,,,,2,2,1,3
C(CC(C(C=CC=O)=O)O)=O,,,5,1,4,0,4
18013_0,,,,2,2,1,3
C(C(CO)C(C(C=CC=O)=O)O)=O,,,5,1,2,0,2
18013_1,,,,2,2,1,3
18015_0,,,,2,2,1,3
C(C)(C(C(C(C=CC=O)=O)O)O)=O,,,5,1,4,0,4
18015_1,,,,2,2,1,3
18017_0,,,,2,2,1,3
C(CO)(CC(C(C=CC=O)=O)O)=O,,,5,1,1,0,1
18019_0,,,,2,2,1,3
C(C(C(C(C=CC=O)=O)O)O)=O,,,5,1,5,0,5
18019_1,,,,2,2,1,3
18021_0,,,,2,2,1,3
C(C(C=C)C(C=CC(C=O)=O)O)=O,,,5,1,1,0,1
18023_0,,,,2,2,1,3
C1OC(C(C=1)=O)C(C=CC(C=O)=O)O,,,5,1,2,0,2
18023_1,,,,2,2,1,3
18025_0,,,,2,2,1,3
C(C(CC(C=O)=O)O)=CC(C=O)=O,,,5,1,1,0,1
18027_0,,,,2,2,1,3
C(C(C=O)C(C=CC(C=O)=O)O)=O,,,5,1,2,0,2
18027_1,,,,2,2,1,3
18028_0,,,,2,2,1,3
18030_0,,,,2,2,1,3
C(C(CO)C(C=CC(C=O)=O)O)=O,,,5,1,4,0,4
18030_1,,,,2,2,1,3
18032_0,,,,2,2,1,3
C(C)(C(C(C=CC(C=O)=O)O)O)=O,,,5,1,2,0,2
18032_1,,,,2,2,1,3
18034_0,,,,2,2,1,3
C(CO)(CC(C=CC(C=O)=O)O)=O,,,5,1,1,0,1
18036_0,,,,2,2,1,3
C(C(C(C=CC(C=O)=O)O)O)=O,,,5,1,3,0,3
18036_1,,,,2,2,1,3
18038_0,,,,2,2,1,3
C(C(C=C)C(C(C=O)=CC=O)O)=O,,,5,1,1,0,1
18040_0,,,,2,2,1,3
C1OC(C(C=1)=O)C(C(C=O)=CC=O)O,,,5,1,2,0,2
18040_1,,,,2,2,1,3
18042_0,,,,2,2,1,3
C(C(C(CC(C=O)=O)O)=CC=O)=O,,,5,1,1,0,1
18044_0,,,,2,2,1,3
C(C(C=O)C(C(C=O)=CC=O)O)=O,,,5,1,2,0,2
18044_1,,,,2,2,1,3
18045_0,,,,2,2,1,3
18047_0,,,,2,2,1,3
C(C(CO)C(C(C=O)=CC=O)O)=O,,,5,1,4,0,4
18047_1,,,,2,2,1,3
18049_0,,,,2,2,1,3
C(C)(C(C(C(C=O)=CC=O)O)O)=O,,,5,1,2,0,2
18049_1,,,,2,2,1,3
18051_0,,,,2,2,1,3
C(CO)(CC(C(C=O)=CC=O)O)=O,,,5,1,1,0,1
18053_0,,,,2,2,1,3
C(C(C(C(C=O)=CC=O)O)O)=O,,,5,1,3,0,3
18053_1,,,,2,2,1,3
18055_0,,,,2,2,1,3
C(C(C=C)C(C=C(C=O)C=O)O)=O,,,5,1,1,0,1
18057_0,,,,2,2,1,3
C1OC(C(C=1)=O)C(C=C(C=O)C=O)O,,,5,1,2,0,2
18057_1,,,,2,2,1,3
18059_0,,,,2,2,1,3
C(C(CC(C=O)=O)O)=C(C=O)C=O,,,5,1,1,0,1
18061_0,,,,2,2,1,3
C(C(C=O)C(C=C(C=O)C=O)O)=O,,,5,1,2,0,2
18061_1,,,,2,2,1,3
18062_0,,,,2,2,1,3
18064_0,,,,2,2,1,3
C(C(CO)C(C=C(C=O)C=O)O)=O,,,5,1,4,0,4
18064_1,,,,2,2,1,3
18066_0,,,,2,2,1,3
C(C)(C(C(C=C(C=O)C=O)O)O)=O,,,5,1,2,0,2
18066_1,,,,2,2,1,3
18068_0,,,,2,2,1,3
C(CO)(CC(C=C(C=O)C=O)O)=O,,,5,1,1,0,1
18070_0,,,,2,2,1,3
C(C(C(C=C(C=O)C=O)O)O)=O,,,5,1,3,0,3
18070_1,,,,2,2,1,3
18072_0,,,,2,2,1,3
C(C(C(C(C=O)O)=C)(CC=O)O)=O,,,5,1,1,0,1
18074_0,,,,2,2,1,3
C(C(C(C(C(CC=O)O)=O)=C)O)=O,,,5,1,1,0,1
18076_0,,,,2,2,1,3
C(CC(C(C(C(C=O)=O)=C)O)O)=O,,,5,1,1,0,1
18078_0,,,,2,2,1,3
C(C(C(CO)=CC=O)(CC=O)O)=O,,,5,1,1,0,1
18080_0,,,,2,2,1,3
C(CC(C(C(CO)=CC=O)=O)O)=O,,,5,1,1,0,1
18082_0,,,,2,2,1,3
C(CC(C=C(C(C=O)=O)CO)O)=O,,,5,1,1,0,1
18084_0,,,,2,2,1,3
C(C(C(C=O)=CC(CC=O)O)O)=O,,,5,1,1,0,1
18086_0,,,,2,2,1,3
C(C(C(C(CC=O)O)=CC=O)O)=O,,,5,1,1,0,1
18088_0,,,,2,2,1,3
C(CC(C(C(C=O)=CC=O)O)O)=O,,,5,1,1,0,1
18090_0,,,,2,2,1,3
C(CC(C(C(CO)=O)=CC=O)O)=O,,,5,1,1,0,1
18092_0,,,,2,2,1,3
C(CC(C(C=O)=CC=O)(CO)O)=O,,,5,1,1,0,1
18094_0,,,,2,2,1,3
C(CC(C=C(C=O)C(CO)=O)O)=O,,,5,1,1,0,1
18096_0,,,,2,2,1,3
C=CC(C(C(C(C=O)=CC=O)=O)O)O,,,5,1,2,0,2
18096_1,,,,2,2,1,3
18098_0,,,,2,2,1,3
C(C(C(C(C(C)O)O)=O)=CC=O)=O,,,5,1,2,0,2
18098_1,,,,2,2,1,3
18100_0,,,,2,2,1,3
C(C(C(C(CO)O)=O)=CC=O)=O,,,5,1,3,0,3
18100_1,,,,2,2,1,3
18102_0,,,,2,2,1,3
C(CC(C(C(C=CC=O)=O)O)O)=O,,,5,1,3,0,3
18104_0,,,,2,2,1,3
C(CC(C=CC=O)(C(C=O)O)O)=O,,,5,1,1,0,1
18106_0,,,,2,2,1,3
C(C(C(C=CC(CC=O)O)=O)O)=O,,,5,1,1,0,1
18108_0,,,,2,2,1,3
C(C(C=C(CO)CO)(CC=O)O)=O,,,5,1,1,0,1
18110_0,,,,2,2,1,3
C(CC(C(C=C(CO)CO)=O)O)=O,,,5,1,1,0,1
18112_0,,,,2,2,1,3
C(CC(C(C=O)=C(CO)CO)O)=O,,,5,1,1,0,1
18114_0,,,,2,2,1,3
C(C(C=C)C(C=C(CO)CO)O)=O,,,5,1,1,0,1
18116_0,,,,2,2,1,3
C(C(CC(C=O)=O)O)=C(CO)CO,,,5,1,1,0,1
18118_0,,,,2,2,1,3
C(C(C=O)C(C=C(CO)CO)O)=O,,,5,1,2,0,2
18118_1,,,,2,2,1,3
18120_0,,,,2,2,1,3
C(CC(C=C(CO)CO)O)=O,,,5,1,2,0,2
18122_0,,,,2,2,1,3
C(C(CO)C(C=C(CO)CO)O)=O,,,5,1,2,0,2
18122_1,,,,2,2,1,3
18124_0,,,,2,2,1,3
C(C)(C(C(C=C(CO)CO)O)O)=O,,,5,1,2,0,2
18124_1,,,,2,2,1,3
18126_0,,,,2,2,1,3
C(CO)(CC(C=C(CO)CO)O)=O,,,5,1,1,0,1
18128_0,,,,2,2,1,3
C(C(C(C=C(CO)CO)O)O)=O,,,5,1,3,0,3
18128_1,,,,2,2,1,3
18130_0,,,,2,2,1,3
C(CC(C(C(C(CO)=O)O)=C)O)=O,,,5,1,1,0,1
18132_0,,,,2,2,1,3
C(CC(CO)(C(C(C=O)=C)O)O)=O,,,5,1,1,0,1
18134_0,,,,2,2,1,3
C(C(C(C)O)O)(C(C(C=O)=C)O)=O,,,5,1,2,0,2
18134_1,,,,2,2,1,3
18135_0,,,,2,2,1,3
18135_1,,,,2,2,1,3
18137_0,,,,2,2,1,3
C(CC(C=CC(C(CO)=O)O)O)=O,,,5,1,1,0,1
18139_0,,,,2,2,1,3
C(CC(CO)(C(C=CC=O)O)O)=O,,,5,1,2,0,2
18141_0,,,,2,2,1,3
C(C(C(C)O)O)(C(C=CC=O)O)=O,,,5,1,2,0,2
18141_1,,,,2,2,1,3
18142_0,,,,2,2,1,3
18142_1,,,,2,2,1,3
18144_0,,,,2,2,1,3
C(C(C=C)C(CO)(C(C=C)O)O)=O,,,5,1,1,0,1
18146_0,,,,2,2,1,3
C=CC(C(CO)(CC(C=O)=O)O)O,,,5,1,1,0,1
18148_0,,,,2,2,1,3
C(C(C=O)C(CO)(C(C=C)O)O)=O,,,5,1,2,0,2
18148_1,,,,2,2,1,3
18150_0,,,,2,2,1,3
C(CC(CO)(C(C=C)O)O)=O,,,5,1,2,0,2
18152_0,,,,2,2,1,3
C(C(CO)C(CO)(C(C=C)O)O)=O,,,5,1,2,0,2
18152_1,,,,2,2,1,3
18154_0,,,,2,2,1,3
C(C)(C(C(CO)(C(C=C)O)O)O)=O,,,5,1,2,0,2
18154_1,,,,2,2,1,3
18156_0,,,,2,2,1,3
C(CO)(CC(CO)(C(C=C)O)O)=O,,,5,1,1,0,1
18158_0,,,,2,2,1,3
C(C(C(CO)(C(C=C)O)O)O)=O,,,5,1,3,0,3
18158_1,,,,2,2,1,3
18160_0,,,,2,2,1,3
C(C(C(C=CC)O)O)(C(C=C)O)=O,,,5,1,2,0,2
18160_1,,,,2,2,1,3
18162_0,,,,2,2,1,3
C(C(C(CC=C)O)O)(C(C=C)O)=O,,,5,1,2,0,2
18162_1,,,,2,2,1,3
18164_0,,,,2,2,1,3
C(C(C(C=C)O)O)(C(C=C)O)=O,,,5,1,2,0,2
18164_1,,,,2,2,1,3
18166_0,,,,2,2,1,3
C(C(C(C(C(C=C)O)=O)O)O)=O,,,5,1,3,0,3
18166_1,,,,2,2,1,3
18168_0,,,,2,2,1,3
C(C(C)(C(C(C(C=C)O)=O)O)O)=O,,,5,1,2,0,2
18168_1,,,,2,2,1,3
18170_0,,,,2,2,1,3
C(C(C(C(C)=O)O)O)(C(C=C)O)=O,,,5,1,2,0,2
18170_1,,,,2,2,1,3
18172_0,,,,2,2,1,3
C(CC(C(C(C(C=C)O)=O)O)O)=O,,,5,1,2,0,2
18172_1,,,,2,2,1,3
18174_0,,,,2,2,1,3
C(C(C(C)O)O)(C(C=C)O)=O,,,5,1,3,0,3
18174_1,,,,2,2,1,3
18176_0,,,,2,2,1,3
C(C(C(CCO)O)O)(C(C=C)O)=O,,,5,1,2,0,2
18176_1,,,,2,2,1,3
18178_0,,,,2,2,1,3
C(C(C(CO)(C)O)O)(C(C=C)O)=O,,,5,1,2,0,2
18178_1,,,,2,2,1,3
18180_0,,,,2,2,1,3
C(C(C(C(C(C=C)O)=O)O)O)(O)=O,,,5,1,2,0,2
18180_1,,,,2,2,1,3
18181_0,,,,2,2,1,3
18181_1,,,,2,2,1,3
18183_0,,,,2,2,1,3
C(C(C(CO)O)O)(C(C=C)O)=O,,,5,1,3,0,3
18183_1,,,,2,2,1,3
18185_0,,,,2,2,1,3
C(CC(C=C(CO)C(CO)O)O)=O,,,5,1,1,0,1
18187_0,,,,2,2,1,3
C(CC(C(CO)O)(C(C=C)O)O)=O,,,5,1,1,0,1
18189_0,,,,2,2,1,3
C(CC(C=CC(CO)(CO)O)O)=O,,,5,1,1,0,1
18191_0,,,,2,2,1,3
C(C(C=C)C(C=O)(C=C(C=O)C)O)=O,,,5,1,1,0,1
18193_0,,,,2,2,1,3
C(C(C=C(C=O)C)(CC(C=O)=O)O)=O,,,5,1,1,0,1
18195_0,,,,2,2,1,3
C(C(C=O)C(C=O)(C=C(C=O)C)O)=O,,,5,1,2,0,2
18195_1,,,,2,2,1,3
18197_0,,,,2,2,1,3
C(C(C=C(C=O)C)(CC=O)O)=O,,,5,1,2,0,2
18199_0,,,,2,2,1,3
C(C(C=C(C=O)C)(C(C=O)O)O)=O,,,5,1,2,0,2
18199_1,,,,2,2,1,3
18201_0,,,,2,2,1,3
C(C(C=C)C(C(C=C(C=O)C)=O)O)=O,,,5,1,1,0,1
18203_0,,,,2,2,1,3
C(C(C)=CC(C(CC(C=O)=O)O)=O)=O,,,5,1,1,0,1
18205_0,,,,2,2,1,3
C(C(C=O)C(C(C=C(C=O)C)=O)O)=O,,,5,1,2,0,2
18205_1,,,,2,2,1,3
18207_0,,,,2,2,1,3
C(CC(C(C=C(C=O)C)=O)O)=O,,,5,1,2,0,2
18209_0,,,,2,2,1,3
C(C(C(C(C=C(C=O)C)=O)O)O)=O,,,5,1,2,0,2
18209_1,,,,2,2,1,3
18211_0,,,,2,2,1,3
C(C(C=C)C(C(C)=CC(C=O)=O)O)=O,,,5,1,1,0,1
18213_0,,,,2,2,1,3
C(C)(C(CC(C=O)=O)O)=CC(C=O)=O,,,5,1,1,0,1
18215_0,,,,2,2,1,3
C(C(C=O)C(C(C)=CC(C=O)=O)O)=O,,,5,1,2,0,2
18215_1,,,,2,2,1,3
18217_0,,,,2,2,1,3
C(CC(C(C)=CC(C=O)=O)O)=O,,,5,1,2,0,2
18219_0,,,,2,2,1,3
C(C(C(C(C)=CC(C=O)=O)O)O)=O,,,5,1,2,0,2
18219_1,,,,2,2,1,3
18221_0,,,,2,2,1,3
C(C(C=C)C(C=O)(CC(C=O)=C)O)=O,,,5,1,1,0,1
18223_0,,,,2,2,1,3
C(C(CC(C=O)=O)(CC(C=O)=C)O)=O,,,5,1,1,0,1
18225_0,,,,2,2,1,3
C(C(C=O)C(C=O)(CC(C=O)=C)O)=O,,,5,1,2,0,2
18225_1,,,,2,2,1,3
18227_0,,,,2,2,1,3
C(CC(C=O)(CC(C=O)=C)O)=O,,,5,1,2,0,2
18229_0,,,,2,2,1,3
C(C(C(C=O)(CC(C=O)=C)O)O)=O,,,5,1,2,0,2
18229_1,,,,2,2,1,3
18231_0,,,,2,2,1,3
C(C(C=C)C(C(CC(C=O)=C)=O)O)=O,,,5,1,1,0,1
18233_0,,,,2,2,1,3
C(C(CC(C=O)=O)O)(CC(C=O)=C)=O,,,5,1,1,0,1
18235_0,,,,2,2,1,3
C(C(C=O)C(C(CC(C=O)=C)=O)O)=O,,,5,1,2,0,2
18235_1,,,,2,2,1,3
18237_0,,,,2,2,1,3
C(CC(C(CC(C=O)=C)=O)O)=O,,,5,1,2,0,2
18239_0,,,,2,2,1,3
C(C(C(C(CC(C=O)=C)=O)O)O)=O,,,5,1,2,0,2
18239_1,,,,2,2,1,3
18241_0,,,,2,2,1,3
C(C(C=C)C(C(CC(C=O)=O)=C)O)=O,,,5,1,1,0,1
18243_0,,,,2,2,1,3
C=C(C(CC(C=O)=O)O)CC(C=O)=O,,,5,1,1,0,1
18245_0,,,,2,2,1,3
C(C(C=O)C(C(CC(C=O)=O)=C)O)=O,,,5,1,2,0,2
18245_1,,,,2,2,1,3
18247_0,,,,2,2,1,3
C(CC(C(CC(C=O)=O)=C)O)=O,,,5,1,2,0,2
18249_0,,,,2,2,1,3
C(C(C(C(CC(C=O)=O)=C)O)O)=O,,,5,1,2,0,2
18249_1,,,,2,2,1,3
18251_0,,,,2,2,1,3
C=C(C=O)C(C(C=O)=O)C(C=CC)O,,,5,1,1,0,1
18253_0,,,,2,2,1,3
C=CCC(C(C(C=O)=O)C(C=O)=C)O,,,5,1,1,0,1
18255_0,,,,2,2,1,3
C=CC(C(C(C=O)=O)C(C=O)=C)O,,,5,1,1,0,1
18257_0,,,,2,2,1,3
C(C(C(C(C=O)=O)C(C=O)=C)O)=O,,,5,1,1,0,1
18259_0,,,,2,2,1,3
C(C(C)(C(C(C=O)=O)C(C=O)=C)O)=O,,,5,1,1,0,1
18261_0,,,,2,2,1,3
C(C)(C(C(C(C=O)=O)C(C=O)=C)O)=O,,,5,1,1,0,1
18263_0,,,,2,2,1,3
C(CC(C(C(C=O)=O)C(C=O)=C)O)=O,,,5,1,1,0,1
18265_0,,,,2,2,1,3
C=C(C=O)C(C(C=O)=O)C(C)O,,,5,1,2,0,2
18266_0,,,,2,2,1,3
18268_0,,,,2,2,1,3
C=C(C=O)C(C(C=O)=O)C(CO)O,,,5,1,1,0,1
18270_0,,,,2,2,1,3
C(C(C=C)C(C(C=O)=C(C=O)C)O)=O,,,5,1,1,0,1
18272_0,,,,2,2,1,3
C(C(CC(C(C=O)=C(C=O)C)O)=O)=O,,,5,1,1,0,1
18274_0,,,,2,2,1,3
C(C(C=O)C(C(C=O)=C(C=O)C)O)=O,,,5,1,2,0,2
18274_1,,,,2,2,1,3
18276_0,,,,2,2,1,3
C(CC(C(C=O)=C(C=O)C)O)=O,,,5,1,2,0,2
18278_0,,,,2,2,1,3
C(C(C(C(C=O)=C(C=O)C)O)O)=O,,,5,1,2,0,2
18278_1,,,,2,2,1,3
18280_0,,,,2,2,1,3
C(C(C=C)C(C(C)=C(C=O)C=O)O)=O,,,5,1,1,0,1
18282_0,,,,2,2,1,3
C(C)(C(CC(C=O)=O)O)=C(C=O)C=O,,,5,1,1,0,1
18284_0,,,,2,2,1,3
C(C(C=O)C(C(C)=C(C=O)C=O)O)=O,,,5,1,2,0,2
18284_1,,,,2,2,1,3
18286_0,,,,2,2,1,3
C(CC(C(C)=C(C=O)C=O)O)=O,,,5,1,2,0,2
18288_0,,,,2,2,1,3
C(C(C(C(C)=C(C=O)C=O)O)O)=O,,,5,1,2,0,2
18288_1,,,,2,2,1,3
18290_0,,,,2,2,1,3
C(C(C(C=O)=C)C(C(C=O)C=C)O)=O,,,5,1,2,0,2
18291_0,,,,2,2,1,3
18292_0,,,,2,2,1,3
18292_1,,,,2,2,1,3
18294_0,,,,2,2,1,3
C(C(C(C=O)=C)C(CC=O)O)=O,,,5,1,3,0,3
18295_0,,,,2,2,1,3
18295_1,,,,2,2,1,3
18297_0,,,,2,2,1,3
C(C(C=O)C(C(C(C=O)C=C)O)=C)=O,,,5,1,1,0,1
18299_0,,,,2,2,1,3
C(C(C=O)C(C(CC(C=O)=O)O)=C)=O,,,5,1,1,0,1
18301_0,,,,2,2,1,3
C(C(C=O)C(C(C(C=O)C=O)O)=C)=O,,,5,1,2,0,2
18301_1,,,,2,2,1,3
18303_0,,,,2,2,1,3
C(C(C=O)C(C(CC=O)O)=C)=O,,,5,1,2,0,2
18305_0,,,,2,2,1,3
C(C(C=O)C(C(C(C=O)O)O)=C)=O,,,5,1,2,0,2
18305_1,,,,2,2,1,3
18307_0,,,,2,2,1,3
C(C(C=O)=C(C=O)C)(C(CO)O)=O,,,5,1,2,0,2
18307_1,,,,2,2,1,3
18309_0,,,,2,2,1,3
C(C(C(C(CO)O)=O)C(C=O)=C)=O,,,5,1,2,0,2
18309_1,,,,2,2,1,3
18311_0,,,,2,2,1,3
C(C(C(C(C(C=O)=C)O)=O)CO)=O,,,5,1,2,0,2
18311_1,,,,2,2,1,3
18313_0,,,,2,2,1,3
C(C(C=O)O)(C(C(C=O)=C)CO)=O,,,5,1,1,0,1
18315_0,,,,2,2,1,3
C(C(C(C=O)=C)C(C=C(C=O)C)O)=O,,,5,1,1,0,1
18317_0,,,,2,2,1,3
C(C(CC(C=CC=O)=O)O)=C(C=O)C,,,5,1,1,0,1
18319_0,,,,2,2,1,3
C=CC(C(C=O)=O)C(C=C(C=O)C)O,,,5,1,1,0,1
18321_0,,,,2,2,1,3
C(C(C=CC=O)C(C=C(C=O)C)O)=O,,,5,1,1,0,1
18323_0,,,,2,2,1,3
C(C(C=C)C(C=C(C=O)C)O)=O,,,5,1,1,0,1
18325_0,,,,2,2,1,3
C1OC(C(C=1)=O)C(C=C(C=O)C)O,,,5,1,2,0,2
18325_1,,,,2,2,1,3
18327_0,,,,2,2,1,3
C(CO)(C(C(C=C(C=O)C)O)O)=O,,,5,1,2,0,2
18327_1,,,,2,2,1,3
18329_0,,,,2,2,1,3
C(C(CC(C=O)=O)O)=C(C=O)C,,,5,1,2,0,2
18331_0,,,,2,2,1,3
C(C(C=O)C(C=C(C=O)C)O)=O,,,5,1,3,0,3
18331_1,,,,2,2,1,3
18333_0,,,,2,2,1,3
C(CC(C=C(C=O)C)O)=O,,,5,1,2,0,2
18335_0,,,,2,2,1,3
C(C(C(C)O)C(C=C(C=O)C)O)=O,,,5,1,2,0,2
18335_1,,,,2,2,1,3
18337_0,,,,2,2,1,3
C(C(CO)C(C=C(C=O)C)O)=O,,,5,1,3,0,3
18337_1,,,,2,2,1,3
18339_0,,,,2,2,1,3
C(C(C(C(C=O)=O)O)O)=C(C=O)C,,,5,1,2,0,2
18339_1,,,,2,2,1,3
18341_0,,,,2,2,1,3
C(C)(C(C(C=C(C=O)C)O)O)=O,,,5,1,3,0,3
18341_1,,,,2,2,1,3
18343_0,,,,2,2,1,3
C(CO)(CC(C=C(C=O)C)O)=O,,,5,1,2,0,2
18345_0,,,,2,2,1,3
C(C(CC(C(O)=O)=O)O)=C(C=O)C,,,5,1,1,0,1
18347_0,,,,2,2,1,3
C(C(C=O)C(C=C(C=O)C)O)(O)=O,,,5,1,2,0,2
18347_1,,,,2,2,1,3
18349_0,,,,2,2,1,3
C(C(C(C=C(C=O)C)O)O)=O,,,5,1,3,0,3
18349_1,,,,2,2,1,3
18351_0,,,,2,2,1,3
C(C(C(C=O)=C)C(C(C)=CC=O)O)=O,,,5,1,1,0,1
18353_0,,,,2,2,1,3
C(C)(C(CC(C=CC=O)=O)O)=CC=O,,,5,1,1,0,1
18355_0,,,,2,2,1,3
C=CC(C(C=O)=O)C(C(C)=CC=O)O,,,5,1,1,0,1
18357_0,,,,2,2,1,3
C(C(C=CC=O)C(C(C)=CC=O)O)=O,,,5,1,1,0,1
18359_0,,,,2,2,1,3
C(C(C=C)C(C(C)=CC=O)O)=O,,,5,1,1,0,1
18361_0,,,,2,2,1,3
C1OC(C(C=1)=O)C(C(C)=CC=O)O,,,5,1,2,0,2
18361_1,,,,2,2,1,3
18363_0,,,,2,2,1,3
C(CO)(C(C(C(C)=CC=O)O)O)=O,,,5,1,2,0,2
18363_1,,,,2,2,1,3
18365_0,,,,2,2,1,3
C(C)(C(CC(C=O)=O)O)=CC=O,,,5,1,2,0,2
18367_0,,,,2,2,1,3
C(C(C=O)C(C(C)=CC=O)O)=O,,,5,1,3,0,3
18367_1,,,,2,2,1,3
18369_0,,,,2,2,1,3
C(CC(C(C)=CC=O)O)=O,,,5,1,2,0,2
18371_0,,,,2,2,1,3
C(C(C(C)O)C(C(C)=CC=O)O)=O,,,5,1,2,0,2
18371_1,,,,2,2,1,3
18373_0,,,,2,2,1,3
C(C(CO)C(C(C)=CC=O)O)=O,,,5,1,3,0,3
18373_1,,,,2,2,1,3
18375_0,,,,2,2,1,3
C(C)(C(C(C(C=O)=O)O)O)=CC=O,,,5,1,2,0,2
18375_1,,,,2,2,1,3
18377_0,,,,2,2,1,3
C(C)(C(C(C(C)=CC=O)O)O)=O,,,5,1,3,0,3
18377_1,,,,2,2,1,3
18379_0,,,,2,2,1,3
C(CO)(CC(C(C)=CC=O)O)=O,,,5,1,2,0,2
18381_0,,,,2,2,1,3
C(C)(C(CC(C(O)=O)=O)O)=CC=O,,,5,1,1,0,1
18383_0,,,,2,2,1,3
C(C(C=O)C(C(C)=CC=O)O)(O)=O,,,5,1,2,0,2
18383_1,,,,2,2,1,3
18385_0,,,,2,2,1,3
C(C(C(C(C)=CC=O)O)O)=O,,,5,1,3,0,3
18385_1,,,,2,2,1,3
18387_0,,,,2,2,1,3
C(C(C(C=O)=C)C(CC(C=O)=C)O)=O,,,5,1,1,0,1
18389_0,,,,2,2,1,3
C=C(C=O)CC(CC(C=CC=O)=O)O,,,5,1,1,0,1
18391_0,,,,2,2,1,3
C=CC(C(C=O)=O)C(CC(C=O)=C)O,,,5,1,1,0,1
18393_0,,,,2,2,1,3
C(C(C=CC=O)C(CC(C=O)=C)O)=O,,,5,1,1,0,1
18395_0,,,,2,2,1,3
C(C(C=C)C(CC(C=O)=C)O)=O,,,5,1,1,0,1
18397_0,,,,2,2,1,3
C1OC(C(C=1)=O)C(CC(C=O)=C)O,,,5,1,2,0,2
18397_1,,,,2,2,1,3
18399_0,,,,2,2,1,3
C(CO)(C(C(CC(C=O)=C)O)O)=O,,,5,1,2,0,2
18399_1,,,,2,2,1,3
18401_0,,,,2,2,1,3
C=C(C=O)CC(CC(C=O)=O)O,,,5,1,2,0,2
18403_0,,,,2,2,1,3
C(C(C=O)C(CC(C=O)=C)O)=O,,,5,1,3,0,3
18403_1,,,,2,2,1,3
18405_0,,,,2,2,1,3
C(CC(CC(C=O)=C)O)=O,,,5,1,2,0,2
18407_0,,,,2,2,1,3
C(C(C(CC(C=O)=C)O)C(C)O)=O,,,5,1,2,0,2
18407_1,,,,2,2,1,3
18409_0,,,,2,2,1,3
C(C(CO)C(CC(C=O)=C)O)=O,,,5,1,3,0,3
18409_1,,,,2,2,1,3
18411_0,,,,2,2,1,3
C=C(C=O)CC(C(C(C=O)=O)O)O,,,5,1,2,0,2
18411_1,,,,2,2,1,3
18413_0,,,,2,2,1,3
C(C)(C(C(CC(C=O)=C)O)O)=O,,,5,1,3,0,3
18413_1,,,,2,2,1,3
18415_0,,,,2,2,1,3
C(CO)(CC(CC(C=O)=C)O)=O,,,5,1,2,0,2
18417_0,,,,2,2,1,3
C=C(C=O)CC(CC(C(O)=O)=O)O,,,5,1,1,0,1
18419_0,,,,2,2,1,3
C(C(C=O)C(CC(C=O)=C)O)(O)=O,,,5,1,2,0,2
18419_1,,,,2,2,1,3
18421_0,,,,2,2,1,3
C(C(C(CC(C=O)=C)O)O)=O,,,5,1,3,0,3
18421_1,,,,2,2,1,3
18423_0,,,,2,2,1,3
C(C(C(C=O)=C)C(C(CC=O)=C)O)=O,,,5,1,1,0,1
18425_0,,,,2,2,1,3
C(CC(C(CC(C=CC=O)=O)O)=C)=O,,,5,1,1,0,1
18427_0,,,,2,2,1,3
C(CC(C(C(C=C)C(C=O)=O)O)=C)=O,,,5,1,1,0,1
18429_0,,,,2,2,1,3
C(C(C=CC=O)C(C(CC=O)=C)O)=O,,,5,1,1,0,1
18431_0,,,,2,2,1,3
C(C(C=C)C(C(CC=O)=C)O)=O,,,5,1,1,0,1
18433_0,,,,2,2,1,3
C(CC(C(C1C(C=CO1)=O)O)=C)=O,,,5,1,2,0,2
18433_1,,,,2,2,1,3
18435_0,,,,2,2,1,3
C(CC(C(C(C(CO)=O)O)O)=C)=O,,,5,1,2,0,2
18435_1,,,,2,2,1,3
18437_0,,,,2,2,1,3
C(CC(C(CC(C=O)=O)O)=C)=O,,,5,1,2,0,2
18439_0,,,,2,2,1,3
C(C(C=O)C(C(CC=O)=C)O)=O,,,5,1,3,0,3
18439_1,,,,2,2,1,3
18441_0,,,,2,2,1,3
C(CC(C(CC=O)O)=C)=O,,,5,1,2,0,2
18443_0,,,,2,2,1,3
C(C(C(C)O)C(C(CC=O)=C)O)=O,,,5,1,2,0,2
18443_1,,,,2,2,1,3
18445_0,,,,2,2,1,3
C(C(CO)C(C(CC=O)=C)O)=O,,,5,1,3,0,3
18445_1,,,,2,2,1,3
18447_0,,,,2,2,1,3
C(CC(C(C(C(C=O)=O)O)O)=C)=O,,,5,1,2,0,2
18447_1,,,,2,2,1,3
18449_0,,,,2,2,1,3
C(CC(C(C(C(C)=O)O)O)=C)=O,,,5,1,3,0,3
18449_1,,,,2,2,1,3
18451_0,,,,2,2,1,3
C(CC(C(CC(CO)=O)O)=C)=O,,,5,1,2,0,2
18453_0,,,,2,2,1,3
C(CC(C(CC(C(O)=O)=O)O)=C)=O,,,5,1,1,0,1
18455_0,,,,2,2,1,3
C(C(C=O)C(C(CC=O)=C)O)(O)=O,,,5,1,2,0,2
18455_1,,,,2,2,1,3
18457_0,,,,2,2,1,3
C(CC(C(C(C=O)O)O)=C)=O,,,5,1,3,0,3
18457_1,,,,2,2,1,3
18459_0,,,,2,2,1,3
C(C(C(C=O)=C)C(C=CC(C)=O)O)=O,,,5,1,1,0,1
18461_0,,,,2,2,1,3
C(C(C(C=O)=C)C(C=CC=O)(C)O)=O,,,5,1,1,0,1
18463_0,,,,2,2,1,3
C(C(C(C=O)=C)C(C=O)(CC=C)O)=O,,,5,1,1,0,1
18465_0,,,,2,2,1,3
C(C(C(C=O)=C)C(C(CC=C)=O)O)=O,,,5,1,1,0,1
18467_0,,,,2,2,1,3
C(C(C(C=O)=C)C(C=O)(C=CC)O)=O,,,5,1,1,0,1
18469_0,,,,2,2,1,3
C(C(C(C=O)=C)C(C(C=CC)=O)O)=O,,,5,1,1,0,1
18471_0,,,,2,2,1,3
C(C(C(C=O)=C)C(C=CCC=O)O)=O,,,5,1,1,0,1
18473_0,,,,2,2,1,3
C(C(C(C=O)=C)C(CC=CC=O)O)=O,,,5,1,1,0,1
18474_0,,,,2,2,1,3
18476_0,,,,2,2,1,3
C(C(C(C=O)=C)C(C(C=O)=CC)O)=O,,,5,1,1,0,1
18478_0,,,,2,2,1,3
C(C(C(C=O)=C)C(C(C=O)=C)O)=O,,,5,1,1,0,1
18480_0,,,,2,2,1,3
C(C(C(C=O)=C)C(C=CC)O)=O,,,5,1,1,0,1
18482_0,,,,2,2,1,3
C(C(C(C=O)=C)C(CC=C)O)=O,,,5,1,1,0,1
18484_0,,,,2,2,1,3
C(C(C(C=O)=C)C(C(C=C)O)O)=O,,,5,1,1,0,1
18486_0,,,,2,2,1,3
C(C(C(C=O)=C)C(C=C)O)=O,,,5,1,1,0,1
18488_0,,,,2,2,1,3
C(C(C(C=O)=C)C1(C=COC1)O)=O,,,5,1,1,0,1
18490_0,,,,2,2,1,3
C(C(C(C=O)=C)C(C(CO)O)O)=O,,,5,1,1,0,1
18491_0,,,,2,2,1,3
18493_0,,,,2,2,1,3
C(C(C(C=O)=C)C(CO)(CO)O)=O,,,5,1,1,0,1
18495_0,,,,2,2,1,3
C(C(C(C=O)=C)C(C=O)(C)O)=O,,,5,1,2,0,2
18497_0,,,,2,2,1,3
C(C(C(C=O)=C)C(C(C)=O)O)=O,,,5,1,2,0,2
18498_0,,,,2,2,1,3
18500_0,,,,2,2,1,3
C(C(C(C=O)=C)C(C)O)=O,,,5,1,2,0,2
18502_0,,,,2,2,1,3
C(C(C(C=O)=C)C(CC(C)O)O)=O,,,5,1,1,0,1
18504_0,,,,2,2,1,3
C(C(C(C=O)=C)C(CCO)O)=O,,,5,1,2,0,2
18506_0,,,,2,2,1,3
C(C(C(C=O)=C)C(C=O)(CO)O)=O,,,5,1,2,0,2
18508_0,,,,2,2,1,3
C(C(C(C=O)=C)C(C(CO)=O)O)=O,,,5,1,1,0,1
18510_0,,,,2,2,1,3
C(C(C(C=O)=C)C(C)(CO)O)=O,,,5,1,2,0,2
18512_0,,,,2,2,1,3
C(C(C(C=O)=C)C(C(O)=O)O)=O,,,5,1,3,0,3
18514_0,,,,2,2,1,3
C(C(C(C=O)=C)C(C(O)=O)(C)O)=O,,,5,1,1,0,1
18516_0,,,,2,2,1,3
C(C(C(C=O)=C)C(CC(O)=O)O)=O,,,5,1,1,0,1
18518_0,,,,2,2,1,3
C(C(C(C=O)=C)C(C=O)(C=C)O)=O,,,5,1,1,0,1
18520_0,,,,2,2,1,3
C(C(C(C=O)=C)C(C(C=C)=O)O)=O,,,5,1,1,0,1
18522_0,,,,2,2,1,3
C(C(C(C=O)=C)C(C=CC=O)O)=O,,,5,1,1,0,1
18524_0,,,,2,2,1,3
C(C(C(C=O)=C)CO)=O,,,5,1,3,0,3
18526_0,,,,2,2,1,3
C(C(C(C=O)=C)C(CO)O)=O,,,5,1,3,0,3
18528_0,,,,2,2,1,3
C(C(C=C)C(C(C(C=O)=C)O)O)=O,,,5,1,1,0,1
18530_0,,,,2,2,1,3
C1OC(C(C=1)=O)C(C(C(C=O)=C)O)O,,,5,1,2,0,2
18530_1,,,,2,2,1,3
18532_0,,,,2,2,1,3
C=C(C=O)C(C(CC(C=O)=O)O)O,,,5,1,1,0,1
18534_0,,,,2,2,1,3
C(C(C=O)C(C(C(C=O)=C)O)O)=O,,,5,1,2,0,2
18534_1,,,,2,2,1,3
18536_0,,,,2,2,1,3
C(CC(C(C(C=O)=C)O)O)=O,,,5,1,3,0,3
18538_0,,,,2,2,1,3
C(C(CO)C(C(C(C=O)=C)O)O)=O,,,5,1,2,0,2
18538_1,,,,2,2,1,3
18540_0,,,,2,2,1,3
C(C)(C(C(C(C(C=O)=C)O)O)O)=O,,,5,1,2,0,2
18540_1,,,,2,2,1,3
18542_0,,,,2,2,1,3
C(CO)(CC(C(C(C=O)=C)O)O)=O,,,5,1,1,0,1
18544_0,,,,2,2,1,3
C(C(C(C(C(C=O)=C)O)O)O)=O,,,5,1,6,0,6
18544_1,,,,2,2,1,3
18546_0,,,,2,2,1,3
C(C(C=C)C(C(C(C=O)O)=C)O)=O,,,5,1,1,0,1
18548_0,,,,2,2,1,3
C(C(C(C(C1C(C=CO1)=O)O)=C)O)=O,,,5,1,2,0,2
18548_1,,,,2,2,1,3
18550_0,,,,2,2,1,3
C(C(C(C(CC(C=O)=O)O)=C)O)=O,,,5,1,1,0,1
18552_0,,,,2,2,1,3
C(C(C=O)C(C(C(C=O)O)=C)O)=O,,,5,1,2,0,2
18552_1,,,,2,2,1,3
18554_0,,,,2,2,1,3
C(C(C(C(CC=O)O)=C)O)=O,,,5,1,3,0,3
18556_0,,,,2,2,1,3
C(C(CO)C(C(C(C=O)O)=C)O)=O,,,5,1,2,0,2
18556_1,,,,2,2,1,3
18558_0,,,,2,2,1,3
C(C(C(C(C(C(C)=O)O)O)=C)O)=O,,,5,1,2,0,2
18558_1,,,,2,2,1,3
18560_0,,,,2,2,1,3
C(C(C(C(CC(CO)=O)O)=C)O)=O,,,5,1,1,0,1
18562_0,,,,2,2,1,3
C(C(C(C(C(C=O)O)O)=C)O)=O,,,5,1,6,0,6
18562_1,,,,2,2,1,3
18564_0,,,,2,2,1,3
C(C(C=C)C(C=O)(C=CC(C)=O)O)=O,,,5,1,1,0,1
18566_0,,,,2,2,1,3
C(C(C=CC(C)=O)(CC(C=O)=O)O)=O,,,5,1,1,0,1
18568_0,,,,2,2,1,3
C(C(C=O)C(C=O)(C=CC(C)=O)O)=O,,,5,1,2,0,2
18568_1,,,,2,2,1,3
18570_0,,,,2,2,1,3
C(C(C=CC(C)=O)(CC=O)O)=O,,,5,1,2,0,2
18572_0,,,,2,2,1,3
C(C(C=CC(C)=O)(C(C=O)O)O)=O,,,5,1,2,0,2
18572_1,,,,2,2,1,3
18574_0,,,,2,2,1,3
C(C(C=C)C(C(C=CC(C)=O)=O)O)=O,,,5,1,1,0,1
18576_0,,,,2,2,1,3
C(C(CC(C(C=CC(C)=O)=O)O)=O)=O,,,5,1,1,0,1
18578_0,,,,2,2,1,3
C(C(C=O)C(C(C=CC(C)=O)=O)O)=O,,,5,1,2,0,2
18578_1,,,,2,2,1,3
18580_0,,,,2,2,1,3
C(CC(C(C=CC(C)=O)=O)O)=O,,,5,1,2,0,2
18582_0,,,,2,2,1,3
C(C(C(C(C=CC(C)=O)=O)O)O)=O,,,5,1,2,0,2
18582_1,,,,2,2,1,3
18584_0,,,,2,2,1,3
C(C(C=C)C(C=CC(C=O)=O)(C)O)=O,,,5,1,1,0,1
18586_0,,,,2,2,1,3
C(C(C)(CC(C=O)=O)O)=CC(C=O)=O,,,5,1,1,0,1
18588_0,,,,2,2,1,3
C(C(C=O)C(C=CC(C=O)=O)(C)O)=O,,,5,1,2,0,2
18588_1,,,,2,2,1,3
18590_0,,,,2,2,1,3
C(CC(C=CC(C=O)=O)(C)O)=O,,,5,1,2,0,2
18592_0,,,,2,2,1,3
C(C(C(C=CC(C=O)=O)(C)O)O)=O,,,5,1,2,0,2
18592_1,,,,2,2,1,3
18594_0,,,,2,2,1,3
C(C(CC(C=CC(C=O)=O)=O)O)=CC,,,5,1,1,0,1
18596_0,,,,2,2,1,3
C=CCC(CC(C=CC(C=O)=O)=O)O,,,5,1,1,0,1
18598_0,,,,2,2,1,3
C=CC(CC(C=CC(C=O)=O)=O)O,,,5,1,1,0,1
18600_0,,,,2,2,1,3
C(C(CC(C=CC(C=O)=O)=O)O)=O,,,5,1,1,0,1
18602_0,,,,2,2,1,3
C(C(C)(CC(C=CC(C=O)=O)=O)O)=O,,,5,1,1,0,1
18604_0,,,,2,2,1,3
C(C)(C(CC(C=CC(C=O)=O)=O)O)=O,,,5,1,1,0,1
18606_0,,,,2,2,1,3
C(CC(CC(C=CC(C=O)=O)=O)O)=O,,,5,1,1,0,1
18608_0,,,,2,2,1,3
C(C(C=CC(CC(C)O)=O)=O)=O,,,5,1,2,0,2
18609_0,,,,2,2,1,3
18611_0,,,,2,2,1,3
C(C(C=CC(CC(CO)O)=O)=O)=O,,,5,1,1,0,1
18613_0,,,,2,2,1,3
C(C(C=C)C(C(C=O)=CC(C)=O)O)=O,,,5,1,1,0,1
18615_0,,,,2,2,1,3
C(C(C(CC(C=O)=O)O)=CC(C)=O)=O,,,5,1,1,0,1
18617_0,,,,2,2,1,3
C(C(C=O)C(C(C=O)=CC(C)=O)O)=O,,,5,1,2,0,2
18617_1,,,,2,2,1,3
18619_0,,,,2,2,1,3
C(CC(C(C=O)=CC(C)=O)O)=O,,,5,1,2,0,2
18621_0,,,,2,2,1,3
C(C(C(C(C=O)=CC(C)=O)O)O)=O,,,5,1,2,0,2
18621_1,,,,2,2,1,3
18623_0,,,,2,2,1,3
C(C(C=C)C(C=C(C=O)C=O)(C)O)=O,,,5,1,1,0,1
18625_0,,,,2,2,1,3
C(C(C)(CC(C=O)=O)O)=C(C=O)C=O,,,5,1,1,0,1
18627_0,,,,2,2,1,3
C(C(C=O)C(C=C(C=O)C=O)(C)O)=O,,,5,1,2,0,2
18627_1,,,,2,2,1,3
18629_0,,,,2,2,1,3
C(CC(C=C(C=O)C=O)(C)O)=O,,,5,1,2,0,2
18631_0,,,,2,2,1,3
C(C(C(C=C(C=O)C=O)(C)O)O)=O,,,5,1,2,0,2
18631_1,,,,2,2,1,3
18633_0,,,,2,2,1,3
C(C(CC(C=C(C=O)C=O)=O)O)=CC,,,5,1,1,0,1
18635_0,,,,2,2,1,3
C=CCC(CC(C=C(C=O)C=O)=O)O,,,5,1,1,0,1
18637_0,,,,2,2,1,3
C=CC(CC(C=C(C=O)C=O)=O)O,,,5,1,1,0,1
18639_0,,,,2,2,1,3
C(C(CC(C=C(C=O)C=O)=O)O)=O,,,5,1,1,0,1
18641_0,,,,2,2,1,3
C(C(C)(CC(C=C(C=O)C=O)=O)O)=O,,,5,1,1,0,1
18643_0,,,,2,2,1,3
C(C)(C(CC(C=C(C=O)C=O)=O)O)=O,,,5,1,1,0,1
18645_0,,,,2,2,1,3
C(CC(CC(C=C(C=O)C=O)=O)O)=O,,,5,1,1,0,1
18647_0,,,,2,2,1,3
C(C(C=O)=CC(CC(C)O)=O)=O,,,5,1,2,0,2
18648_0,,,,2,2,1,3
18650_0,,,,2,2,1,3
C(C(C=O)=CC(CC(CO)O)=O)=O,,,5,1,1,0,1
18652_0,,,,2,2,1,3
C(CCO)(C(C(C(C=O)=O)=C)O)=O,,,5,1,1,0,1
18654_0,,,,2,2,1,3
C(C(C(CO)=CC(CCO)=O)=O)=O,,,5,1,1,0,1
18656_0,,,,2,2,1,3
C(CCO)(C(C(C=O)=CC=O)O)=O,,,5,1,1,0,1
18658_0,,,,2,2,1,3
C(C(C(C=O)=CC(CCO)=O)O)=O,,,5,1,1,0,1
18660_0,,,,2,2,1,3
C(C(C=O)=CC(C)=O)(C(CO)O)=O,,,5,1,2,0,2
18660_1,,,,2,2,1,3
18662_0,,,,2,2,1,3
C(C(C(CO)=O)=CC(CCO)=O)=O,,,5,1,1,0,1
18664_0,,,,2,2,1,3
C(C(C(C=CC(CCO)=O)=O)O)=O,,,5,1,1,0,1
18666_0,,,,2,2,1,3
C(C(CC(C=CC=O)=O)O)=CC(C)=O,,,5,1,1,0,1
18668_0,,,,2,2,1,3
C=CC(C(C=O)=O)C(C=CC(C)=O)O,,,5,1,1,0,1
18670_0,,,,2,2,1,3
C(C(C=CC=O)C(C=CC(C)=O)O)=O,,,5,1,1,0,1
18672_0,,,,2,2,1,3
C(C(C=C)C(C=CC(C)=O)O)=O,,,5,1,1,0,1
18674_0,,,,2,2,1,3
C1OC(C(C=1)=O)C(C=CC(C)=O)O,,,5,1,2,0,2
18674_1,,,,2,2,1,3
18676_0,,,,2,2,1,3
C(CO)(C(C(C=CC(C)=O)O)O)=O,,,5,1,2,0,2
18676_1,,,,2,2,1,3
18678_0,,,,2,2,1,3
C(C(CC(C=O)=O)O)=CC(C)=O,,,5,1,2,0,2
18680_0,,,,2,2,1,3
C(C(C=O)C(C=CC(C)=O)O)=O,,,5,1,3,0,3
18680_1,,,,2,2,1,3
18682_0,,,,2,2,1,3
C(CC(C=CC(C)=O)O)=O,,,5,1,2,0,2
18684_0,,,,2,2,1,3
C(C(C(C)O)C(C=CC(C)=O)O)=O,,,5,1,2,0,2
18684_1,,,,2,2,1,3
18686_0,,,,2,2,1,3
C(C(CO)C(C=CC(C)=O)O)=O,,,5,1,3,0,3
18686_1,,,,2,2,1,3
18688_0,,,,2,2,1,3
C(C(C(C(C=O)=O)O)O)=CC(C)=O,,,5,1,2,0,2
18688_1,,,,2,2,1,3
18690_0,,,,2,2,1,3
C(C)(C(C(C=CC(C)=O)O)O)=O,,,5,1,3,0,3
18690_1,,,,2,2,1,3
18692_0,,,,2,2,1,3
C(CO)(CC(C=CC(C)=O)O)=O,,,5,1,2,0,2
18694_0,,,,2,2,1,3
C(C(CC(C(O)=O)=O)O)=CC(C)=O,,,5,1,1,0,1
18696_0,,,,2,2,1,3
C(C(C=O)C(C=CC(C)=O)O)(O)=O,,,5,1,2,0,2
18696_1,,,,2,2,1,3
18698_0,,,,2,2,1,3
C(C(C(C=CC(C)=O)O)O)=O,,,5,1,3,0,3
18698_1,,,,2,2,1,3
18700_0,,,,2,2,1,3
C(C(C)(CC(C=CC=O)=O)O)=CC=O,,,5,1,1,0,1
18702_0,,,,2,2,1,3
C=CC(C(C=O)=O)C(C=CC=O)(C)O,,,5,1,1,0,1
18704_0,,,,2,2,1,3
C(C(C=CC=O)C(C=CC=O)(C)O)=O,,,5,1,1,0,1
18706_0,,,,2,2,1,3
C(C(C=C)C(C=CC=O)(C)O)=O,,,5,1,1,0,1
18708_0,,,,2,2,1,3
C(C(C)(C1C(C=CO1)=O)O)=CC=O,,,5,1,2,0,2
18708_1,,,,2,2,1,3
18710_0,,,,2,2,1,3
C(C(C(C=CC=O)(C)O)O)(CO)=O,,,5,1,2,0,2
18710_1,,,,2,2,1,3
18712_0,,,,2,2,1,3
C(C(C)(CC(C=O)=O)O)=CC=O,,,5,1,2,0,2
18714_0,,,,2,2,1,3
C(C(C=O)C(C=CC=O)(C)O)=O,,,5,1,3,0,3
18714_1,,,,2,2,1,3
18716_0,,,,2,2,1,3
C(CC(C=CC=O)(C)O)=O,,,5,1,2,0,2
18718_0,,,,2,2,1,3
C(C(C(C)O)C(C=CC=O)(C)O)=O,,,5,1,2,0,2
18718_1,,,,2,2,1,3
18720_0,,,,2,2,1,3
C(C(CO)C(C=CC=O)(C)O)=O,,,5,1,3,0,3
18720_1,,,,2,2,1,3
18722_0,,,,2,2,1,3
C(C(C)(C(C(C=O)=O)O)O)=CC=O,,,5,1,2,0,2
18722_1,,,,2,2,1,3
18724_0,,,,2,2,1,3
C(C(C(C=CC=O)(C)O)O)(C)=O,,,5,1,3,0,3
18724_1,,,,2,2,1,3
18726_0,,,,2,2,1,3
C(CC(C=CC=O)(C)O)(CO)=O,,,5,1,2,0,2
18728_0,,,,2,2,1,3
C(C(C)(CC(C(O)=O)=O)O)=CC=O,,,5,1,1,0,1
18730_0,,,,2,2,1,3
C(C(C=O)C(C=CC=O)(C)O)(O)=O,,,5,1,2,0,2
18730_1,,,,2,2,1,3
18732_0,,,,2,2,1,3
C(C(C(C=CC=O)(C)O)O)=O,,,5,1,3,0,3
18732_1,,,,2,2,1,3
18734_0,,,,2,2,1,3
C(C(CC(C=CC=O)=O)(CC=C)O)=O,,,5,1,1,0,1
18736_0,,,,2,2,1,3
C(C(CC(C=CC=O)=O)O)(CC=C)=O,,,5,1,1,0,1
18738_0,,,,2,2,1,3
C(C(C=CC)(CC(C=CC=O)=O)O)=O,,,5,1,1,0,1
18740_0,,,,2,2,1,3
C(C)=CC(C(CC(C=CC=O)=O)O)=O,,,5,1,1,0,1
18742_0,,,,2,2,1,3
C(CC=CC(CC(C=CC=O)=O)O)=O,,,5,1,1,0,1
18744_0,,,,2,2,1,3
C(CC(CC(C=CC=O)=O)O)=CC=O,,,5,1,1,0,1
18746_0,,,,2,2,1,3
C(C(C=C)C(CC(C=CC=O)=O)O)=O,,,5,1,1,0,1
18748_0,,,,2,2,1,3
C(C)=C(C=O)C(CC(C=CC=O)=O)O,,,5,1,1,0,1
18750_0,,,,2,2,1,3
C=C(C=O)C(CC(C=CC=O)=O)O,,,5,1,1,0,1
18752_0,,,,2,2,1,3
C(C(CC(C=CC=O)=O)O)=CC,,,5,1,1,0,1
18754_0,,,,2,2,1,3
C=CCC(CC(C=CC=O)=O)O,,,5,1,1,0,1
18756_0,,,,2,2,1,3
C=CC(C(CC(C=CC=O)=O)O)O,,,5,1,1,0,1
18758_0,,,,2,2,1,3
C=CC(CC(C=CC=O)=O)O,,,5,1,1,0,1
18760_0,,,,2,2,1,3
C1C(COC=1)(CC(C=CC=O)=O)O,,,5,1,1,0,1
18762_0,,,,2,2,1,3
C(C=CC(CC(C(CO)O)O)=O)=O,,,5,1,1,0,1
18764_0,,,,2,2,1,3
C(C(CC(C=CC=O)=O)O)=O,,,5,1,2,0,2
18766_0,,,,2,2,1,3
C(C=CC(CC(CO)(CO)O)=O)=O,,,5,1,1,0,1
18768_0,,,,2,2,1,3
C(C(C)(CC(C=CC=O)=O)O)=O,,,5,1,2,0,2
18770_0,,,,2,2,1,3
C(C)(C(CC(C=CC=O)=O)O)=O,,,5,1,2,0,2
18772_0,,,,2,2,1,3
C(CC(CC(C=CC=O)=O)O)=O,,,5,1,2,0,2
18774_0,,,,2,2,1,3
C(C=CC(CC(C)O)=O)=O,,,5,1,2,0,2
18776_0,,,,2,2,1,3
C(C=CC(CC(CC(C)O)O)=O)=O,,,5,1,1,0,1
18778_0,,,,2,2,1,3
C(C=CC(CC(CCO)O)=O)=O,,,5,1,2,0,2
18780_0,,,,2,2,1,3
C(C(CO)(CC(C=CC=O)=O)O)=O,,,5,1,1,0,1
18782_0,,,,2,2,1,3
C(CO)(C(CC(C=CC=O)=O)O)=O,,,5,1,1,0,1
18784_0,,,,2,2,1,3
C(C=CC(CC(C)(CO)O)=O)=O,,,5,1,2,0,2
18786_0,,,,2,2,1,3
C(C(CC(C=CC=O)=O)O)(O)=O,,,5,1,2,0,2
18788_0,,,,2,2,1,3
C(C(C)(CC(C=CC=O)=O)O)(O)=O,,,5,1,1,0,1
18790_0,,,,2,2,1,3
C(CC(CC(C=CC=O)=O)O)(O)=O,,,5,1,1,0,1
18792_0,,,,2,2,1,3
C(C(C=C)(CC(C=CC=O)=O)O)=O,,,5,1,1,0,1
18794_0,,,,2,2,1,3
C=CC(C(CC(C=CC=O)=O)O)=O,,,5,1,1,0,1
18796_0,,,,2,2,1,3
C(C(CC(C=CC=O)=O)O)=CC=O,,,5,1,1,0,1
18797_0,,,,2,2,1,3
18799_0,,,,2,2,1,3
C(C=CC(CC(CO)O)=O)=O,,,5,1,3,0,3
18801_0,,,,2,2,1,3
C(C(C=C)C(C=CCC(C=O)=O)O)=O,,,5,1,1,0,1
18803_0,,,,2,2,1,3
C(CC(C=O)=O)=CC(CC(C=O)=O)O,,,5,1,1,0,1
18805_0,,,,2,2,1,3
C(C(C=O)C(C=CCC(C=O)=O)O)=O,,,5,1,2,0,2
18805_1,,,,2,2,1,3
18807_0,,,,2,2,1,3
C(CC(C=CCC(C=O)=O)O)=O,,,5,1,3,0,3
18809_0,,,,2,2,1,3
C(C(C(C=CCC(C=O)=O)O)O)=O,,,5,1,2,0,2
18809_1,,,,2,2,1,3
18811_0,,,,2,2,1,3
C(C(C=C)C(C=O)(CC=CC=O)O)=O,,,5,1,1,0,1
18813_0,,,,2,2,1,3
C(C(CC(C=O)=O)(CC=CC=O)O)=O,,,5,1,1,0,1
18815_0,,,,2,2,1,3
C(C(C=O)C(C=O)(CC=CC=O)O)=O,,,5,1,2,0,2
18815_1,,,,2,2,1,3
18817_0,,,,2,2,1,3
C(CC(C=O)(CC=CC=O)O)=O,,,5,1,2,0,2
18819_0,,,,2,2,1,3
C(C(C(C=O)(CC=CC=O)O)O)=O,,,5,1,3,0,3
18819_1,,,,2,2,1,3
18821_0,,,,2,2,1,3
C(C(C=C)C(C(CC=CC=O)=O)O)=O,,,5,1,1,0,1
18823_0,,,,2,2,1,3
C(C(CC(C=O)=O)O)(CC=CC=O)=O,,,5,1,1,0,1
18825_0,,,,2,2,1,3
C(C(C=O)C(C(CC=CC=O)=O)O)=O,,,5,1,2,0,2
18825_1,,,,2,2,1,3
18827_0,,,,2,2,1,3
C(CC(C(CC=CC=O)=O)O)=O,,,5,1,2,0,2
18829_0,,,,2,2,1,3
C(C(C(C(CC=CC=O)=O)O)O)=O,,,5,1,4,0,4
18829_1,,,,2,2,1,3
18831_0,,,,2,2,1,3
C(C(C(C=O)=O)C(C=CC)O)=CC=O,,,5,1,1,0,1
18833_0,,,,2,2,1,3
C=CCC(C(C=CC=O)C(C=O)=O)O,,,5,1,1,0,1
18835_0,,,,2,2,1,3
C=CC(C(C=CC=O)C(C=O)=O)O,,,5,1,1,0,1
18837_0,,,,2,2,1,3
C(C(C(C=CC=O)C(C=O)=O)O)=O,,,5,1,1,0,1
18839_0,,,,2,2,1,3
C(C(C)(C(C=CC=O)C(C=O)=O)O)=O,,,5,1,1,0,1
18841_0,,,,2,2,1,3
C(C)(C(C(C=CC=O)C(C=O)=O)O)=O,,,5,1,1,0,1
18843_0,,,,2,2,1,3
C(CC(C(C=CC=O)C(C=O)=O)O)=O,,,5,1,1,0,1
18845_0,,,,2,2,1,3
C(C(C(C=O)=O)C(C)O)=CC=O,,,5,1,2,0,2
18846_0,,,,2,2,1,3
18848_0,,,,2,2,1,3
C(C(C(C=O)=O)C(CO)O)=CC=O,,,5,1,1,0,1
18850_0,,,,2,2,1,3
C(C(C=C)C(CC=CC(C=O)=O)O)=O,,,5,1,1,0,1
18852_0,,,,2,2,1,3
C(CC(CC(C=O)=O)O)=CC(C=O)=O,,,5,1,1,0,1
18854_0,,,,2,2,1,3
C(C(C=O)C(CC=CC(C=O)=O)O)=O,,,5,1,2,0,2
18854_1,,,,2,2,1,3
18856_0,,,,2,2,1,3
C(CC(CC=CC(C=O)=O)O)=O,,,5,1,2,0,2
18858_0,,,,2,2,1,3
C(C(C(CC=CC(C=O)=O)O)O)=O,,,5,1,2,0,2
18858_1,,,,2,2,1,3
18860_0,,,,2,2,1,3
C(C(C=C)C(C=O)(C=CCC=O)O)=O,,,5,1,1,0,1
18862_0,,,,2,2,1,3
C(C(C=CCC=O)(CC(C=O)=O)O)=O,,,5,1,1,0,1
18864_0,,,,2,2,1,3
C(C(C=O)C(C=O)(C=CCC=O)O)=O,,,5,1,2,0,2
18864_1,,,,2,2,1,3
18866_0,,,,2,2,1,3
C(C(C=CCC=O)(CC=O)O)=O,,,5,1,2,0,2
18868_0,,,,2,2,1,3
C(C(C=CCC=O)(C(C=O)O)O)=O,,,5,1,3,0,3
18868_1,,,,2,2,1,3
18870_0,,,,2,2,1,3
C(C(C=C)C(C(C=CCC=O)=O)O)=O,,,5,1,1,0,1
18872_0,,,,2,2,1,3
C(CC=CC(C(CC(C=O)=O)O)=O)=O,,,5,1,1,0,1
18874_0,,,,2,2,1,3
C(C(C=O)C(C(C=CCC=O)=O)O)=O,,,5,1,2,0,2
18874_1,,,,2,2,1,3
18876_0,,,,2,2,1,3
C(CC=CC(C(CC=O)O)=O)=O,,,5,1,2,0,2
18878_0,,,,2,2,1,3
C(CC=CC(C(C(C=O)O)O)=O)=O,,,5,1,4,0,4
18878_1,,,,2,2,1,3
18880_0,,,,2,2,1,3
C(C(C=CC(C=O)=O)C(C=CC)O)=O,,,5,1,1,0,1
18882_0,,,,2,2,1,3
C(C(C=CC(C=O)=O)C(CC=C)O)=O,,,5,1,1,0,1
18884_0,,,,2,2,1,3
C(C(C=CC(C=O)=O)C(C=C)O)=O,,,5,1,1,0,1
18886_0,,,,2,2,1,3
C(C(C=CC(C=O)=O)C(C=O)O)=O,,,5,1,1,0,1
18888_0,,,,2,2,1,3
C(C(C=CC(C=O)=O)C(C=O)(C)O)=O,,,5,1,1,0,1
18890_0,,,,2,2,1,3
C(C(C=CC(C=O)=O)C(C(C)=O)O)=O,,,5,1,1,0,1
18892_0,,,,2,2,1,3
C(C(C=CC(C=O)=O)C(CC=O)O)=O,,,5,1,1,0,1
18894_0,,,,2,2,1,3
C(C(C=CC(C=O)=O)C(C)O)=O,,,5,1,2,0,2
18896_0,,,,2,2,1,3
C(C(C=CC(C=O)=O)CO)=O,,,5,1,3,0,3
18898_0,,,,2,2,1,3
C(C(C=CC(C=O)=O)C(CO)O)=O,,,5,1,1,0,1
18900_0,,,,2,2,1,3
C(CO)=C(C=O)C(C(C=O)=O)CO,,,5,1,1,0,1
18902_0,,,,2,2,1,3
C(C(C=CC(C(CO)CO)=O)=O)=O,,,5,1,2,0,2
18902_1,,,,2,2,1,3
18903_0,,,,2,2,1,3
18903_1,,,,2,2,1,3
18905_0,,,,2,2,1,3
C(C(C=CC(C(C=O)=O)CO)O)=O,,,5,1,1,0,1
18907_0,,,,2,2,1,3
C(CC(C=O)=O)=CC(C(CO)O)=O,,,5,1,2,0,2
18907_1,,,,2,2,1,3
18909_0,,,,2,2,1,3
C(C(C(C=O)=O)CO)=CC(CO)=O,,,5,1,1,0,1
18911_0,,,,2,2,1,3
C(CO)(C(C=CC(C=O)=O)CO)=O,,,5,1,1,0,1
18913_0,,,,2,2,1,3
C(C(CO)O)(CC=CC(C=O)=O)=O,,,5,1,2,0,2
18913_1,,,,2,2,1,3
18915_0,,,,2,2,1,3
C(CO)(C(C(C=O)=O)CO)=CC=O,,,5,1,1,0,1
18917_0,,,,2,2,1,3
C(C(C(CO)=CC(C=O)=O)CO)=O,,,5,1,1,0,1
18919_0,,,,2,2,1,3
C(CCO)(C(C=CC(C=O)=O)O)=O,,,5,1,1,0,1
18921_0,,,,2,2,1,3
C(C(C(C(C(C=O)=O)CO)=C)O)=O,,,5,1,1,0,1
18923_0,,,,2,2,1,3
C(C(CC=C)(C(C=C)C(C=O)=O)O)=O,,,5,1,1,0,1
18925_0,,,,2,2,1,3
C(C(C=CC=O)C(C=O)(CC=C)O)=O,,,5,1,1,0,1
18927_0,,,,2,2,1,3
C(C(C=C)C(C=O)(CC=C)O)=O,,,5,1,1,0,1
18929_0,,,,2,2,1,3
C(C(CC=C)(C1C(C=CO1)=O)O)=O,,,5,1,2,0,2
18929_1,,,,2,2,1,3
18931_0,,,,2,2,1,3
C(C(CC=C)(C(C(CO)=O)O)O)=O,,,5,1,2,0,2
18931_1,,,,2,2,1,3
18933_0,,,,2,2,1,3
C(C(CC(C=O)=O)(CC=C)O)=O,,,5,1,2,0,2
18935_0,,,,2,2,1,3
C(C(C=O)C(C=O)(CC=C)O)=O,,,5,1,3,0,3
18935_1,,,,2,2,1,3
18937_0,,,,2,2,1,3
C(CC(C=O)(CC=C)O)=O,,,5,1,2,0,2
18939_0,,,,2,2,1,3
C(C(C(C)O)C(C=O)(CC=C)O)=O,,,5,1,2,0,2
18939_1,,,,2,2,1,3
18941_0,,,,2,2,1,3
C(C(CO)C(C=O)(CC=C)O)=O,,,5,1,3,0,3
18941_1,,,,2,2,1,3
18943_0,,,,2,2,1,3
C(C(CC=C)(C(C(C=O)=O)O)O)=O,,,5,1,2,0,2
18943_1,,,,2,2,1,3
18945_0,,,,2,2,1,3
C(C(CC=C)(C(C(C)=O)O)O)=O,,,5,1,3,0,3
18945_1,,,,2,2,1,3
18947_0,,,,2,2,1,3
C(C(CC=C)(CC(CO)=O)O)=O,,,5,1,2,0,2
18949_0,,,,2,2,1,3
C(C(CC(C(O)=O)=O)(CC=C)O)=O,,,5,1,1,0,1
18951_0,,,,2,2,1,3
C(C(C=O)C(C=O)(CC=C)O)(O)=O,,,5,1,2,0,2
18951_1,,,,2,2,1,3
18953_0,,,,2,2,1,3
C(C(C(C=O)(CC=C)O)O)=O,,,5,1,3,0,3
18953_1,,,,2,2,1,3
18955_0,,,,2,2,1,3
C(C(C(C=C)C(C=O)=O)O)(CC=C)=O,,,5,1,1,0,1
18957_0,,,,2,2,1,3
C(C(C=CC=O)C(C(CC=C)=O)O)=O,,,5,1,1,0,1
18959_0,,,,2,2,1,3
C(C(C=C)C(C(CC=C)=O)O)=O,,,5,1,1,0,1
18961_0,,,,2,2,1,3
C(C(C1C(C=CO1)=O)O)(CC=C)=O,,,5,1,2,0,2
18961_1,,,,2,2,1,3
18963_0,,,,2,2,1,3
C(C(C(C(CO)=O)O)O)(CC=C)=O,,,5,1,2,0,2
18963_1,,,,2,2,1,3
18965_0,,,,2,2,1,3
C(C(CC(C=O)=O)O)(CC=C)=O,,,5,1,2,0,2
18967_0,,,,2,2,1,3
C(C(C=O)C(C(CC=C)=O)O)=O,,,5,1,3,0,3
18967_1,,,,2,2,1,3
18969_0,,,,2,2,1,3
C(CC(C(CC=C)=O)O)=O,,,5,1,2,0,2
18971_0,,,,2,2,1,3
C(C(C(C)O)C(C(CC=C)=O)O)=O,,,5,1,2,0,2
18971_1,,,,2,2,1,3
18973_0,,,,2,2,1,3
C(C(CO)C(C(CC=C)=O)O)=O,,,5,1,3,0,3
18973_1,,,,2,2,1,3
18975_0,,,,2,2,1,3
C(C(C(C(C=O)=O)O)O)(CC=C)=O,,,5,1,2,0,2
18975_1,,,,2,2,1,3
18977_0,,,,2,2,1,3
C(C(C(C(C)=O)O)O)(CC=C)=O,,,5,1,3,0,3
18977_1,,,,2,2,1,3
18979_0,,,,2,2,1,3
C(C(CC(CO)=O)O)(CC=C)=O,,,5,1,2,0,2
18981_0,,,,2,2,1,3
C(C(CC(C(O)=O)=O)O)(CC=C)=O,,,5,1,1,0,1
18983_0,,,,2,2,1,3
C(C(C=O)C(C(CC=C)=O)O)(O)=O,,,5,1,2,0,2
18983_1,,,,2,2,1,3
18985_0,,,,2,2,1,3
C(C(C(C(CC=C)=O)O)O)=O,,,5,1,3,0,3
18985_1,,,,2,2,1,3
18987_0,,,,2,2,1,3
C(C(C=CC)(C(C=C)C(C=O)=O)O)=O,,,5,1,1,0,1
18989_0,,,,2,2,1,3
C=CC(C(C=O)=O)C(C(C=CC)=O)O,,,5,1,1,0,1
18991_0,,,,2,2,1,3
C(CC=CC(C(C=C)C(C=O)=O)O)=O,,,5,1,1,0,1
18993_0,,,,2,2,1,3
C=CC(C(C=O)=O)C(CC=CC=O)O,,,5,1,1,0,1
18995_0,,,,2,2,1,3
C(C(C=C)C(C(C=C)C(C=O)=O)O)=O,,,5,1,1,0,1
18997_0,,,,2,2,1,3
C=CC(C(C=O)=O)C(C(C=O)=CC)O,,,5,1,1,0,1
18999_0,,,,2,2,1,3
C=CC(C(C=O)=O)C(C(C=O)=C)O,,,5,1,1,0,1
19001_0,,,,2,2,1,3
C=CC(C(C=O)=O)C(C=CC)O,,,5,1,1,0,1
19003_0,,,,2,2,1,3
C=CC(C(C=O)=O)C(CC=C)O,,,5,1,1,0,1
19005_0,,,,2,2,1,3
C=CC(C(C=O)=O)C(C(C=C)O)O,,,5,1,1,0,1
19007_0,,,,2,2,1,3
C=CC(C(C=O)=O)C(C=C)O,,,5,1,1,0,1
19009_0,,,,2,2,1,3
C1OCC(C=1)(C(C=C)C(C=O)=O)O,,,5,1,1,0,1
19011_0,,,,2,2,1,3
C=CC(C(C=O)=O)C(C(CO)O)O,,,5,1,1,0,1
19013_0,,,,2,2,1,3
C(C(C(C=C)C(C=O)=O)O)=O,,,5,1,2,0,2
19015_0,,,,2,2,1,3
C=CC(C(C=O)=O)C(CO)(CO)O,,,5,1,1,0,1
19017_0,,,,2,2,1,3
C(C(C)(C(C=C)C(C=O)=O)O)=O,,,5,1,2,0,2
19019_0,,,,2,2,1,3
C(C)(C(C(C=C)C(C=O)=O)O)=O,,,5,1,2,0,2
19021_0,,,,2,2,1,3
C(CC(C(C=C)C(C=O)=O)O)=O,,,5,1,2,0,2
19023_0,,,,2,2,1,3
C=CC(C(C=O)=O)C(C)O,,,5,1,2,0,2
19025_0,,,,2,2,1,3
C=CC(C(C=O)=O)C(CC(C)O)O,,,5,1,1,0,1
19027_0,,,,2,2,1,3
C=CC(C(C=O)=O)C(CCO)O,,,5,1,2,0,2
19029_0,,,,2,2,1,3
C(C(CO)(C(C=C)C(C=O)=O)O)=O,,,5,1,1,0,1
19031_0,,,,2,2,1,3
C(CO)(C(C(C=C)C(C=O)=O)O)=O,,,5,1,1,0,1
19033_0,,,,2,2,1,3
C=CC(C(C=O)=O)C(C)(CO)O,,,5,1,2,0,2
19035_0,,,,2,2,1,3
C(C(C(C=C)C(C=O)=O)O)(O)=O,,,5,1,2,0,2
19037_0,,,,2,2,1,3
C(C(C)(C(C=C)C(C=O)=O)O)(O)=O,,,5,1,1,0,1
19039_0,,,,2,2,1,3
C(CC(C(C=C)C(C=O)=O)O)(O)=O,,,5,1,1,0,1
19041_0,,,,2,2,1,3
C(C(C=C)(C(C=C)C(C=O)=O)O)=O,,,5,1,1,0,1
19043_0,,,,2,2,1,3
C=CC(C(C=O)=O)C(C(C=C)=O)O,,,5,1,1,0,1
19045_0,,,,2,2,1,3
C=CC(C(C=O)=O)C(C=CC=O)O,,,5,1,1,0,1
19046_0,,,,2,2,1,3
19048_0,,,,2,2,1,3
C=CC(C(C=O)=O)C(CO)O,,,5,1,2,0,2
19050_0,,,,2,2,1,3
C(C(C=CC=O)C(C=O)(C=CC)O)=O,,,5,1,1,0,1
19052_0,,,,2,2,1,3
C(C(C=C)C(C=O)(C=CC)O)=O,,,5,1,1,0,1
19054_0,,,,2,2,1,3
C(C(C=CC)(C1C(C=CO1)=O)O)=O,,,5,1,2,0,2
19054_1,,,,2,2,1,3
19056_0,,,,2,2,1,3
C(C(C=CC)(C(C(CO)=O)O)O)=O,,,5,1,2,0,2
19056_1,,,,2,2,1,3
19058_0,,,,2,2,1,3
C(C(C=CC)(CC(C=O)=O)O)=O,,,5,1,2,0,2
19060_0,,,,2,2,1,3
C(C(C=O)C(C=O)(C=CC)O)=O,,,5,1,3,0,3
19060_1,,,,2,2,1,3
19062_0,,,,2,2,1,3
C(C(C=CC)(CC=O)O)=O,,,5,1,2,0,2
19064_0,,,,2,2,1,3
C(C(C(C)O)C(C=O)(C=CC)O)=O,,,5,1,2,0,2
19064_1,,,,2,2,1,3
19066_0,,,,2,2,1,3
C(C(CO)C(C=O)(C=CC)O)=O,,,5,1,3,0,3
19066_1,,,,2,2,1,3
19068_0,,,,2,2,1,3
C(C(C=CC)(C(C(C=O)=O)O)O)=O,,,5,1,2,0,2
19068_1,,,,2,2,1,3
19070_0,,,,2,2,1,3
C(C(C=CC)(C(C(C)=O)O)O)=O,,,5,1,3,0,3
19070_1,,,,2,2,1,3
19072_0,,,,2,2,1,3
C(C(C=CC)(CC(CO)=O)O)=O,,,5,1,2,0,2
19074_0,,,,2,2,1,3
C(C(C=CC)(CC(C(O)=O)=O)O)=O,,,5,1,1,0,1
19076_0,,,,2,2,1,3
C(C(C=O)C(C=O)(C=CC)O)(O)=O,,,5,1,2,0,2
19076_1,,,,2,2,1,3
19078_0,,,,2,2,1,3
C(C(C=CC)(C(C=O)O)O)=O,,,5,1,3,0,3
19078_1,,,,2,2,1,3
19080_0,,,,2,2,1,3
C(C(C=CC=O)C(C(C=CC)=O)O)=O,,,5,1,1,0,1
19082_0,,,,2,2,1,3
C(C(C=C)C(C(C=CC)=O)O)=O,,,5,1,1,0,1
19084_0,,,,2,2,1,3
C1OC(C(C=1)=O)C(C(C=CC)=O)O,,,5,1,2,0,2
19084_1,,,,2,2,1,3
19086_0,,,,2,2,1,3
C(CO)(C(C(C(C=CC)=O)O)O)=O,,,5,1,2,0,2
19086_1,,,,2,2,1,3
19088_0,,,,2,2,1,3
C(C)=CC(C(CC(C=O)=O)O)=O,,,5,1,2,0,2
19090_0,,,,2,2,1,3
C(C(C=O)C(C(C=CC)=O)O)=O,,,5,1,3,0,3
19090_1,,,,2,2,1,3
19092_0,,,,2,2,1,3
C(CC(C(C=CC)=O)O)=O,,,5,1,2,0,2
19094_0,,,,2,2,1,3
C(C(C(C)O)C(C(C=CC)=O)O)=O,,,5,1,2,0,2
19094_1,,,,2,2,1,3
19096_0,,,,2,2,1,3
C(C(CO)C(C(C=CC)=O)O)=O,,,5,1,3,0,3
19096_1,,,,2,2,1,3
19098_0,,,,2,2,1,3
C(C)=CC(C(C(C(C=O)=O)O)O)=O,,,5,1,2,0,2
19098_1,,,,2,2,1,3
19100_0,,,,2,2,1,3
C(C)(C(C(C(C=CC)=O)O)O)=O,,,5,1,3,0,3
19100_1,,,,2,2,1,3
19102_0,,,,2,2,1,3
C(CO)(CC(C(C=CC)=O)O)=O,,,5,1,2,0,2
19104_0,,,,2,2,1,3
C(C)=CC(C(CC(C(O)=O)=O)O)=O,,,5,1,1,0,1
19106_0,,,,2,2,1,3
C(C(C=O)C(C(C=CC)=O)O)(O)=O,,,5,1,2,0,2
19106_1,,,,2,2,1,3
19108_0,,,,2,2,1,3
C(C(C(C(C=CC)=O)O)O)=O,,,5,1,3,0,3
19108_1,,,,2,2,1,3
19110_0,,,,2,2,1,3
C(C(C=CC(CO)O)(CC=O)O)=O,,,5,1,1,0,1
19112_0,,,,2,2,1,3
C(CC(C(C=CC(CO)O)=O)O)=O,,,5,1,1,0,1
19114_0,,,,2,2,1,3
C(C(C=C)C(C=O)(C=CCO)O)=O,,,5,1,1,0,1
19116_0,,,,2,2,1,3
C(C(C=CCO)(C1C(C=CO1)=O)O)=O,,,5,1,2,0,2
19116_1,,,,2,2,1,3
19118_0,,,,2,2,1,3
C(C(C=CCO)(CC(C=O)=O)O)=O,,,5,1,1,0,1
19120_0,,,,2,2,1,3
C(C(C=O)C(C=O)(C=CCO)O)=O,,,5,1,2,0,2
19120_1,,,,2,2,1,3
19122_0,,,,2,2,1,3
C(C(C=CCO)(CC=O)O)=O,,,5,1,4,0,4
19124_0,,,,2,2,1,3
C(C(CO)C(C=O)(C=CCO)O)=O,,,5,1,2,0,2
19124_1,,,,2,2,1,3
19126_0,,,,2,2,1,3
C(C(C=CCO)(C(C(C)=O)O)O)=O,,,5,1,2,0,2
19126_1,,,,2,2,1,3
19128_0,,,,2,2,1,3
C(C(C=CCO)(CC(CO)=O)O)=O,,,5,1,1,0,1
19130_0,,,,2,2,1,3
C(C(C=CCO)(C(C=O)O)O)=O,,,5,1,4,0,4
19130_1,,,,2,2,1,3
19132_0,,,,2,2,1,3
C(C(C=C)C(C(C=CCO)=O)O)=O,,,5,1,1,0,1
19134_0,,,,2,2,1,3
C1OC(C(C=1)=O)C(C(C=CCO)=O)O,,,5,1,2,0,2
19134_1,,,,2,2,1,3
19136_0,,,,2,2,1,3
C(CO)=CC(C(CC(C=O)=O)O)=O,,,5,1,1,0,1
19138_0,,,,2,2,1,3
C(C(C=O)C(C(C=CCO)=O)O)=O,,,5,1,2,0,2
19138_1,,,,2,2,1,3
19140_0,,,,2,2,1,3
C(CC(C(C=CCO)=O)O)=O,,,5,1,2,0,2
19142_0,,,,2,2,1,3
C(C(CO)C(C(C=CCO)=O)O)=O,,,5,1,2,0,2
19142_1,,,,2,2,1,3
19144_0,,,,2,2,1,3
C(C)(C(C(C(C=CCO)=O)O)O)=O,,,5,1,2,0,2
19144_1,,,,2,2,1,3
19146_0,,,,2,2,1,3
C(CO)(CC(C(C=CCO)=O)O)=O,,,5,1,1,0,1
19148_0,,,,2,2,1,3
C(C(C(C(C=CCO)=O)O)O)=O,,,5,1,3,0,3
19148_1,,,,2,2,1,3
19150_0,,,,2,2,1,3
C(C(C=C)C(C(C=O)=CCC=O)O)=O,,,5,1,1,0,1
19152_0,,,,2,2,1,3
C(CC=C(C=O)C(CC(C=O)=O)O)=O,,,5,1,1,0,1
19154_0,,,,2,2,1,3
C(C(C=O)C(C(C=O)=CCC=O)O)=O,,,5,1,2,0,2
19154_1,,,,2,2,1,3
19156_0,,,,2,2,1,3
C(CC=C(C=O)C(CC=O)O)=O,,,5,1,2,0,2
19158_0,,,,2,2,1,3
C(CC=C(C=O)C(C(C=O)O)O)=O,,,5,1,2,0,2
19158_1,,,,2,2,1,3
19160_0,,,,2,2,1,3
C(C(C=C)C(CC=C(C=O)C=O)O)=O,,,5,1,1,0,1
19162_0,,,,2,2,1,3
C(CC(CC(C=O)=O)O)=C(C=O)C=O,,,5,1,1,0,1
19164_0,,,,2,2,1,3
C(C(C=O)C(CC=C(C=O)C=O)O)=O,,,5,1,2,0,2
19164_1,,,,2,2,1,3
19166_0,,,,2,2,1,3
C(CC(CC=C(C=O)C=O)O)=O,,,5,1,2,0,2
19168_0,,,,2,2,1,3
C(C(C(CC=C(C=O)C=O)O)O)=O,,,5,1,2,0,2
19168_1,,,,2,2,1,3
19170_0,,,,2,2,1,3
C(C(C=C(C=O)C=O)C(C=CC)O)=O,,,5,1,1,0,1
19172_0,,,,2,2,1,3
C(C(C=C(C=O)C=O)C(CC=C)O)=O,,,5,1,1,0,1
19174_0,,,,2,2,1,3
C(C(C=C(C=O)C=O)C(C=C)O)=O,,,5,1,1,0,1
19176_0,,,,2,2,1,3
C(C(C=C(C=O)C=O)C(C=O)O)=O,,,5,1,1,0,1
19178_0,,,,2,2,1,3
C(C(C=C(C=O)C=O)C(C=O)(C)O)=O,,,5,1,1,0,1
19180_0,,,,2,2,1,3
C(C(C=C(C=O)C=O)C(C(C)=O)O)=O,,,5,1,1,0,1
19182_0,,,,2,2,1,3
C(C(C=C(C=O)C=O)C(CC=O)O)=O,,,5,1,1,0,1
19184_0,,,,2,2,1,3
C(C(C=C(C=O)C=O)C(C)O)=O,,,5,1,2,0,2
19186_0,,,,2,2,1,3
C(C(C=C(C=O)C=O)CO)=O,,,5,1,3,0,3
19188_0,,,,2,2,1,3
C(C(C=C(C=O)C=O)C(CO)O)=O,,,5,1,1,0,1
19190_0,,,,2,2,1,3
C(C(C=C)C(C(C=O)C=CC=O)O)=O,,,5,1,2,0,2
19191_0,,,,2,2,1,3
19192_0,,,,2,2,1,3
19192_1,,,,2,2,1,3
19194_0,,,,2,2,1,3
C(C(C=CC=O)C(CC=O)O)=O,,,5,1,3,0,3
19195_0,,,,2,2,1,3
19195_1,,,,2,2,1,3
19197_0,,,,2,2,1,3
C(C(C=O)C=CC(C(C=O)C=C)O)=O,,,5,1,1,0,1
19199_0,,,,2,2,1,3
C(C(C=O)C=CC(CC(C=O)=O)O)=O,,,5,1,1,0,1
19201_0,,,,2,2,1,3
C(C(C=O)C=CC(C(C=O)C=O)O)=O,,,5,1,2,0,2
19201_1,,,,2,2,1,3
19203_0,,,,2,2,1,3
C(C(C=O)C=CC(CC=O)O)=O,,,5,1,2,0,2
19205_0,,,,2,2,1,3
C(C(C=O)C=CC(C(C=O)O)O)=O,,,5,1,2,0,2
19205_1,,,,2,2,1,3
19207_0,,,,2,2,1,3
C(C(CO)C(C(C(C=O)=O)=C)O)=O,,,5,1,2,0,2
19207_1,,,,2,2,1,3
19209_0,,,,2,2,1,3
C(C(C=C(C(C=O)=O)CO)CO)=O,,,5,1,1,0,1
19210_0,,,,2,2,1,3
19210_1,,,,2,2,1,3
19212_0,,,,2,2,1,3
C(C(C=C(C=O)C(C=O)O)CO)=O,,,5,1,1,0,1
19214_0,,,,2,2,1,3
C(CC=C(C=O)C(C(CO)O)=O)=O,,,5,1,2,0,2
19214_1,,,,2,2,1,3
19216_0,,,,2,2,1,3
C(C(C=C(C=O)C(CO)=O)CO)=O,,,5,1,1,0,1
19218_0,,,,2,2,1,3
C(C(C(C(CO)O)=O)C=CC=O)=O,,,5,1,2,0,2
19218_1,,,,2,2,1,3
19220_0,,,,2,2,1,3
C(C(C(C(C=CC=O)O)=O)CO)=O,,,5,1,2,0,2
19220_1,,,,2,2,1,3
19222_0,,,,2,2,1,3
C(C(C=CC(C(C=O)O)=O)CO)=O,,,5,1,1,0,1
19224_0,,,,2,2,1,3
C(C(C=O)O)(C(C=CC=O)CO)=O,,,5,1,1,0,1
19226_0,,,,2,2,1,3
C(C(C=CC=O)C(C=CCC=O)O)=O,,,5,1,1,0,1
19228_0,,,,2,2,1,3
C(C(C=C)C(C=CCC=O)O)=O,,,5,1,1,0,1
19230_0,,,,2,2,1,3
C(CC=CC(C1C(C=CO1)=O)O)=O,,,5,1,2,0,2
19230_1,,,,2,2,1,3
19232_0,,,,2,2,1,3
C(CC=CC(C(C(CO)=O)O)O)=O,,,5,1,2,0,2
19232_1,,,,2,2,1,3
19234_0,,,,2,2,1,3
C(CC=CC(CC(C=O)=O)O)=O,,,5,1,2,0,2
19236_0,,,,2,2,1,3
C(C(C=O)C(C=CCC=O)O)=O,,,5,1,3,0,3
19236_1,,,,2,2,1,3
19238_0,,,,2,2,1,3
C(CC=CC(CC=O)O)=O,,,5,1,2,0,2
19240_0,,,,2,2,1,3
C(C(C(C)O)C(C=CCC=O)O)=O,,,5,1,2,0,2
19240_1,,,,2,2,1,3
19242_0,,,,2,2,1,3
C(C(CO)C(C=CCC=O)O)=O,,,5,1,3,0,3
19242_1,,,,2,2,1,3
19244_0,,,,2,2,1,3
C(CC=CC(C(C(C=O)=O)O)O)=O,,,5,1,2,0,2
19244_1,,,,2,2,1,3
19246_0,,,,2,2,1,3
C(CC=CC(C(C(C)=O)O)O)=O,,,5,1,3,0,3
19246_1,,,,2,2,1,3
19248_0,,,,2,2,1,3
C(CC=CC(CC(CO)=O)O)=O,,,5,1,2,0,2
19250_0,,,,2,2,1,3
C(CC=CC(CC(C(O)=O)=O)O)=O,,,5,1,1,0,1
19252_0,,,,2,2,1,3
C(C(C=O)C(C=CCC=O)O)(O)=O,,,5,1,2,0,2
19252_1,,,,2,2,1,3
19254_0,,,,2,2,1,3
C(CC=CC(C(C=O)O)O)=O,,,5,1,3,0,3
19254_1,,,,2,2,1,3
19256_0,,,,2,2,1,3
C(C(C=CC=O)C(CC=CC=O)O)=O,,,5,1,1,0,1
19258_0,,,,2,2,1,3
C(C(C=C)C(CC=CC=O)O)=O,,,5,1,1,0,1
19260_0,,,,2,2,1,3
C(CC(C1C(C=CO1)=O)O)=CC=O,,,5,1,2,0,2
19260_1,,,,2,2,1,3
19262_0,,,,2,2,1,3
C(CO)(C(C(CC=CC=O)O)O)=O,,,5,1,2,0,2
19262_1,,,,2,2,1,3
19264_0,,,,2,2,1,3
C(CC(CC(C=O)=O)O)=CC=O,,,5,1,2,0,2
19266_0,,,,2,2,1,3
C(C(C=O)C(CC=CC=O)O)=O,,,5,1,3,0,3
19266_1,,,,2,2,1,3
19268_0,,,,2,2,1,3
C(CC(CC=CC=O)O)=O,,,5,1,2,0,2
19270_0,,,,2,2,1,3
C(C(C(CC=CC=O)O)C(C)O)=O,,,5,1,2,0,2
19270_1,,,,2,2,1,3
19272_0,,,,2,2,1,3
C(C(CO)C(CC=CC=O)O)=O,,,5,1,3,0,3
19272_1,,,,2,2,1,3
19274_0,,,,2,2,1,3
C(CC(C(C(C=O)=O)O)O)=CC=O,,,5,1,2,0,2
19274_1,,,,2,2,1,3
19276_0,,,,2,2,1,3
C(C)(C(C(CC=CC=O)O)O)=O,,,5,1,3,0,3
19276_1,,,,2,2,1,3
19278_0,,,,2,2,1,3
C(CO)(CC(CC=CC=O)O)=O,,,5,1,2,0,2
19280_0,,,,2,2,1,3
C(CC(CC(C(O)=O)=O)O)=CC=O,,,5,1,1,0,1
19282_0,,,,2,2,1,3
C(C(C=O)C(CC=CC=O)O)(O)=O,,,5,1,2,0,2
19282_1,,,,2,2,1,3
19284_0,,,,2,2,1,3
C(C(C(CC=CC=O)O)O)=O,,,5,1,3,0,3
19284_1,,,,2,2,1,3
19285_0,,,,2,2,1,3
19287_0,,,,2,2,1,3
C(C(C=CC=O)C(C(C=O)=CC)O)=O,,,5,1,1,0,1
19289_0,,,,2,2,1,3
C(C(C=CC=O)C(C(C=O)=C)O)=O,,,5,1,1,0,1
19291_0,,,,2,2,1,3
C(C(C=CC=O)C(C=CC)O)=O,,,5,1,1,0,1
19293_0,,,,2,2,1,3
C(C(C=CC=O)C(CC=C)O)=O,,,5,1,1,0,1
19295_0,,,,2,2,1,3
C(C(C=CC=O)C(C(C=C)O)O)=O,,,5,1,1,0,1
19297_0,,,,2,2,1,3
C(C(C=CC=O)C(C=C)O)=O,,,5,1,1,0,1
19299_0,,,,2,2,1,3
C(C(C=CC=O)C1(C=COC1)O)=O,,,5,1,1,0,1
19301_0,,,,2,2,1,3
C(C(C=CC=O)C(C(CO)O)O)=O,,,5,1,1,0,1
19302_0,,,,2,2,1,3
19304_0,,,,2,2,1,3
C(C(C=CC=O)C(CO)(CO)O)=O,,,5,1,1,0,1
19306_0,,,,2,2,1,3
C(C(C=CC=O)C(C=O)(C)O)=O,,,5,1,2,0,2
19308_0,,,,2,2,1,3
C(C(C=CC=O)C(C(C)=O)O)=O,,,5,1,2,0,2
19309_0,,,,2,2,1,3
19311_0,,,,2,2,1,3
C(C(C=CC=O)C(C)O)=O,,,5,1,2,0,2
19313_0,,,,2,2,1,3
C(C(C=CC=O)C(CC(C)O)O)=O,,,5,1,1,0,1
19315_0,,,,2,2,1,3
C(C(C=CC=O)C(CCO)O)=O,,,5,1,2,0,2
19317_0,,,,2,2,1,3
C(C(C=CC=O)C(C=O)(CO)O)=O,,,5,1,2,0,2
19319_0,,,,2,2,1,3
C(C(C=CC=O)C(C(CO)=O)O)=O,,,5,1,1,0,1
19321_0,,,,2,2,1,3
C(C(C=CC=O)C(C)(CO)O)=O,,,5,1,2,0,2
19323_0,,,,2,2,1,3
C(C(C=CC=O)C(C(O)=O)O)=O,,,5,1,3,0,3
19325_0,,,,2,2,1,3
C(C(C=CC=O)C(C(O)=O)(C)O)=O,,,5,1,1,0,1
19327_0,,,,2,2,1,3
C(C(C=CC=O)C(CC(O)=O)O)=O,,,5,1,1,0,1
19329_0,,,,2,2,1,3
C(C(C=CC=O)C(C=O)(C=C)O)=O,,,5,1,1,0,1
19331_0,,,,2,2,1,3
C(C(C=CC=O)C(C(C=C)=O)O)=O,,,5,1,1,0,1
19333_0,,,,2,2,1,3
C(C(C=CC=O)C(C=CC=O)O)=O,,,5,1,1,0,1
19335_0,,,,2,2,1,3
C(C(C=CC=O)CO)=O,,,5,1,4,0,4
19337_0,,,,2,2,1,3
C(C(C=CC=O)C(CO)O)=O,,,5,1,4,0,4
19339_0,,,,2,2,1,3
C(C(C=C)C(C(C=CC=O)O)O)=O,,,5,1,1,0,1
19341_0,,,,2,2,1,3
C(C(C(C1C(C=CO1)=O)O)O)=CC=O,,,5,1,2,0,2
19341_1,,,,2,2,1,3
19343_0,,,,2,2,1,3
C(C(C(CC(C=O)=O)O)O)=CC=O,,,5,1,1,0,1
19345_0,,,,2,2,1,3
C(C(C=O)C(C(C=CC=O)O)O)=O,,,5,1,2,0,2
19345_1,,,,2,2,1,3
19347_0,,,,2,2,1,3
C(CC(C(C=CC=O)O)O)=O,,,5,1,3,0,3
19349_0,,,,2,2,1,3
C(C(CO)C(C(C=CC=O)O)O)=O,,,5,1,2,0,2
19349_1,,,,2,2,1,3
19351_0,,,,2,2,1,3
C(C)(C(C(C(C=CC=O)O)O)O)=O,,,5,1,2,0,2
19351_1,,,,2,2,1,3
19353_0,,,,2,2,1,3
C(CO)(CC(C(C=CC=O)O)O)=O,,,5,1,1,0,1
19355_0,,,,2,2,1,3
C(C(C(C(C=CC=O)O)O)O)=O,,,5,1,8,0,8
19355_1,,,,2,2,1,3
19357_0,,,,2,2,1,3
C(C(C=C)C(C=CC(C=O)O)O)=O,,,5,1,1,0,1
19359_0,,,,2,2,1,3
C(C(C=CC(C1C(C=CO1)=O)O)O)=O,,,5,1,2,0,2
19359_1,,,,2,2,1,3
19361_0,,,,2,2,1,3
C(C(C=CC(CC(C=O)=O)O)O)=O,,,5,1,1,0,1
19363_0,,,,2,2,1,3
C(C(C=O)C(C=CC(C=O)O)O)=O,,,5,1,2,0,2
19363_1,,,,2,2,1,3
19365_0,,,,2,2,1,3
C(C(C=CC(CC=O)O)O)=O,,,5,1,2,0,2
19367_0,,,,2,2,1,3
C(C(CO)C(C=CC(C=O)O)O)=O,,,5,1,2,0,2
19367_1,,,,2,2,1,3
19369_0,,,,2,2,1,3
C(C(C=CC(C(C(C)=O)O)O)O)=O,,,5,1,2,0,2
19369_1,,,,2,2,1,3
19371_0,,,,2,2,1,3
C(C(C=CC(CC(CO)=O)O)O)=O,,,5,1,1,0,1
19373_0,,,,2,2,1,3
C(C(C=CC(C(C=O)O)O)O)=O,,,5,1,6,0,6
19373_1,,,,2,2,1,3
19375_0,,,,2,2,1,3
C(C(C=O)=CC(C(CO)CO)=O)=O,,,5,1,2,0,2
19375_1,,,,2,2,1,3
19376_0,,,,2,2,1,3
19376_1,,,,2,2,1,3
19378_0,,,,2,2,1,3
C(C(C=O)C=CC(C(CO)O)=O)=O,,,5,1,2,0,2
19378_1,,,,2,2,1,3
19380_0,,,,2,2,1,3
C(CO)(C(C=C(C=O)C=O)CO)=O,,,5,1,1,0,1
19382_0,,,,2,2,1,3
C(C(CO)O)(CC=C(C=O)C=O)=O,,,5,1,2,0,2
19382_1,,,,2,2,1,3
19384_0,,,,2,2,1,3
C(C(C(CO)=C(C=O)C=O)CO)=O,,,5,1,1,0,1
19386_0,,,,2,2,1,3
C(CCO)(C(C=C(C=O)C=O)O)=O,,,5,1,1,0,1
19388_0,,,,2,2,1,3
C(C(C=C)C(C(C=O)C=C)O)=O,,,5,1,1,0,1
19390_0,,,,2,2,1,3
C(C(C=C)C(C1C(C=CO1)=O)O)=O,,,5,1,2,0,2
19390_1,,,,2,2,1,3
19391_0,,,,2,2,1,3
19391_1,,,,2,2,1,3
19392_0,,,,2,2,1,3
19393_0,,,,2,2,1,3
19393_1,,,,2,2,1,3
19395_0,,,,2,2,1,3
C(C(C=C)C(CC=O)O)=O,,,5,1,3,0,3
19397_0,,,,2,2,1,3
C(C(C=C)C(C(C=O)C(C)O)O)=O,,,5,1,3,0,3
19397_1,,,,2,2,1,3
19399_0,,,,2,2,1,3
C(C(C=C)C(C(C=O)CO)O)=O,,,5,1,4,0,4
19399_1,,,,2,2,1,3
19400_0,,,,2,2,1,3
19400_1,,,,2,2,1,3
19402_0,,,,2,2,1,3
C(C(C=C)C(C(C(C)=O)O)O)=O,,,5,1,4,0,4
19402_1,,,,2,2,1,3
19404_0,,,,2,2,1,3
C(C(C=C)C(CC(CO)=O)O)=O,,,5,1,3,0,3
19405_0,,,,2,2,1,3
19407_0,,,,2,2,1,3
C(C(C=C)C(C(C(O)=O)C=O)O)=O,,,5,1,2,0,2
19407_1,,,,2,2,1,3
19408_0,,,,2,2,1,3
19408_1,,,,2,2,1,3
19410_0,,,,2,2,1,3
C(C(C=C)C(C(C=O)=CC)O)=O,,,5,1,1,0,1
19412_0,,,,2,2,1,3
C1OC(C(C=1)=O)C(C(C=O)=CC)O,,,5,1,2,0,2
19412_1,,,,2,2,1,3
19414_0,,,,2,2,1,3
C(CO)(C(C(C(C=O)=CC)O)O)=O,,,5,1,2,0,2
19414_1,,,,2,2,1,3
19416_0,,,,2,2,1,3
C(C)=C(C=O)C(CC(C=O)=O)O,,,5,1,2,0,2
19418_0,,,,2,2,1,3
C(C(C=O)C(C(C=O)=CC)O)=O,,,5,1,3,0,3
19418_1,,,,2,2,1,3
19420_0,,,,2,2,1,3
C(CC(C(C=O)=CC)O)=O,,,5,1,2,0,2
19422_0,,,,2,2,1,3
C(C(C(C)O)C(C(C=O)=CC)O)=O,,,5,1,2,0,2
19422_1,,,,2,2,1,3
19424_0,,,,2,2,1,3
C(C(CO)C(C(C=O)=CC)O)=O,,,5,1,3,0,3
19424_1,,,,2,2,1,3
19426_0,,,,2,2,1,3
C(C)=C(C=O)C(C(C(C=O)=O)O)O,,,5,1,2,0,2
19426_1,,,,2,2,1,3
19428_0,,,,2,2,1,3
C(C)(C(C(C(C=O)=CC)O)O)=O,,,5,1,3,0,3
19428_1,,,,2,2,1,3
19430_0,,,,2,2,1,3
C(CO)(CC(C(C=O)=CC)O)=O,,,5,1,2,0,2
19432_0,,,,2,2,1,3
C(C)=C(C=O)C(CC(C(O)=O)=O)O,,,5,1,1,0,1
19434_0,,,,2,2,1,3
C(C(C=O)C(C(C=O)=CC)O)(O)=O,,,5,1,2,0,2
19434_1,,,,2,2,1,3
19436_0,,,,2,2,1,3
C(C(C(C(C=O)=CC)O)O)=O,,,5,1,3,0,3
19436_1,,,,2,2,1,3
19438_0,,,,2,2,1,3
C(CC(C(C=O)=CC(CO)O)O)=O,,,5,1,1,0,1
19440_0,,,,2,2,1,3
C=C(C=O)C(C(C(C(C=O)=C)O)O)=O,,,5,1,2,0,2
19440_1,,,,2,2,1,3
19442_0,,,,2,2,1,3
C(C(C=C)C(C(C=O)=C)O)=O,,,5,1,1,0,1
19444_0,,,,2,2,1,3
C=C(C=O)C(C(C(C=CC=O)=O)O)O,,,5,1,2,0,2
19444_1,,,,2,2,1,3
19446_0,,,,2,2,1,3
C=C(C=O)C(C1C(C=CO1)=O)O,,,5,1,2,0,2
19446_1,,,,2,2,1,3
19448_0,,,,2,2,1,3
C(CO)(C(C(C(C=O)=C)O)O)=O,,,5,1,5,0,5
19448_1,,,,2,2,1,3
19450_0,,,,2,2,1,3
C=C(C=O)C(CC(C=O)=O)O,,,5,1,2,0,2
19452_0,,,,2,2,1,3
C(C(C=O)C(C(C=O)=C)O)=O,,,5,1,3,0,3
19452_1,,,,2,2,1,3
19454_0,,,,2,2,1,3
C=C(C=O)C(C(C(C=O)=O)CO)O,,,5,1,2,0,2
19454_1,,,,2,2,1,3
19456_0,,,,2,2,1,3
C(C(C(C=O)C(C(C=O)=C)O)O)=O,,,5,1,2,0,2
19456_1,,,,2,2,1,3
19458_0,,,,2,2,1,3
C(C(C(CO)=O)C(C(C=O)=C)O)=O,,,5,1,2,0,2
19458_1,,,,2,2,1,3
19460_0,,,,2,2,1,3
C(CC(C(C(C(C=O)=C)O)O)=O)=O,,,5,1,2,0,2
19460_1,,,,2,2,1,3
19462_0,,,,2,2,1,3
C(C(C(CC(C(C=O)=C)O)=O)O)=O,,,5,1,1,0,1
19464_0,,,,2,2,1,3
C(CC(C(C=O)=C)O)=O,,,5,1,2,0,2
19466_0,,,,2,2,1,3
C(C(C(C)O)C(C(C=O)=C)O)=O,,,5,1,3,0,3
19466_1,,,,2,2,1,3
19468_0,,,,2,2,1,3
C(C(CO)C(C(C=O)=C)O)=O,,,5,1,3,0,3
19468_1,,,,2,2,1,3
19470_0,,,,2,2,1,3
C(C(C(CO)O)C(C(C=O)=C)O)=O,,,5,1,2,0,2
19470_1,,,,2,2,1,3
19472_0,,,,2,2,1,3
C=C(C=O)C(C(C(C=O)=O)O)O,,,5,1,3,0,3
19472_1,,,,2,2,1,3
19474_0,,,,2,2,1,3
C=C(C=O)C(C(C(C(C)=O)=O)O)O,,,5,1,2,0,2
19474_1,,,,2,2,1,3
19476_0,,,,2,2,1,3
C=C(C=O)C(CC(C(CO)=O)=O)O,,,5,1,1,0,1
19478_0,,,,2,2,1,3
C(C)(C(C(C(C=O)=C)O)O)=O,,,5,1,3,0,3
19478_1,,,,2,2,1,3
19480_0,,,,2,2,1,3
C(CO)(CC(C(C=O)=C)O)=O,,,5,1,2,0,2
19482_0,,,,2,2,1,3
C(C(C(C(C=O)=C)O)O)(CCO)=O,,,5,1,2,0,2
19482_1,,,,2,2,1,3
19484_0,,,,2,2,1,3
C(CO)(C(CO)C(C(C=O)=C)O)=O,,,5,1,2,0,2
19484_1,,,,2,2,1,3
19486_0,,,,2,2,1,3
C(CC(C(C=O)=C)O)(C(CO)O)=O,,,5,1,1,0,1
19488_0,,,,2,2,1,3
C=C(C=O)C(CC(C(O)=O)=O)O,,,5,1,2,0,2
19490_0,,,,2,2,1,3
C(C(C=O)C(C(C=O)=C)O)(O)=O,,,5,1,3,0,3
19490_1,,,,2,2,1,3
19492_0,,,,2,2,1,3
C1(C(C(C(C=O)=C)O)OCC1O)=O,,,5,1,2,0,2
19492_1,,,,2,2,1,3
19494_0,,,,2,2,1,3
C1(C(O)OCC1C(C(C=O)=C)O)=O,,,5,1,2,0,2
19494_1,,,,2,2,1,3
19496_0,,,,2,2,1,3
C1(COC(C1C(C(C=O)=C)O)O)=O,,,5,1,2,0,2
19496_1,,,,2,2,1,3
19498_0,,,,2,2,1,3
C1(C(C(C(C=O)=C)O)OC(C1)O)=O,,,5,1,2,0,2
19498_1,,,,2,2,1,3
19500_0,,,,2,2,1,3
C(C(C(C(C=O)=C)O)O)=O,,,5,1,6,0,6
19500_1,,,,2,2,1,3
19502_0,,,,2,2,1,3
C(C(C=C)C(C(C=O)=CCO)O)=O,,,5,1,1,0,1
19504_0,,,,2,2,1,3
C1OC(C(C=1)=O)C(C(C=O)=CCO)O,,,5,1,2,0,2
19504_1,,,,2,2,1,3
19506_0,,,,2,2,1,3
C(CO)=C(C=O)C(CC(C=O)=O)O,,,5,1,1,0,1
19508_0,,,,2,2,1,3
C(C(C=O)C(C(C=O)=CCO)O)=O,,,5,1,2,0,2
19508_1,,,,2,2,1,3
19510_0,,,,2,2,1,3
C(CC(C(C=O)=CCO)O)=O,,,5,1,4,0,4
19512_0,,,,2,2,1,3
C(C(CO)C(C(C=O)=CCO)O)=O,,,5,1,2,0,2
19512_1,,,,2,2,1,3
19514_0,,,,2,2,1,3
C(C)(C(C(C(C=O)=CCO)O)O)=O,,,5,1,2,0,2
19514_1,,,,2,2,1,3
19516_0,,,,2,2,1,3
C(CO)(CC(C(C=O)=CCO)O)=O,,,5,1,1,0,1
19518_0,,,,2,2,1,3
C(C(C(C(C=O)=CCO)O)O)=O,,,5,1,6,0,6
19518_1,,,,2,2,1,3
19520_0,,,,2,2,1,3
C(C(C=C)C(C=C(C=O)CCO)O)=O,,,5,1,1,0,1
19522_0,,,,2,2,1,3
C(CC(C=C(C=O)CCO)O)=O,,,5,1,2,0,2
19524_0,,,,2,2,1,3
C(C(C(C=C(C=O)CCO)O)O)=O,,,5,1,2,0,2
19524_1,,,,2,2,1,3
19526_0,,,,2,2,1,3
C(C(C=C)C(C(CCO)=CC=O)O)=O,,,5,1,1,0,1
19528_0,,,,2,2,1,3
C(CC(C(CCO)=CC=O)O)=O,,,5,1,2,0,2
19530_0,,,,2,2,1,3
C(C(C(C(CCO)=CC=O)O)O)=O,,,5,1,2,0,2
19530_1,,,,2,2,1,3
19532_0,,,,2,2,1,3
C(C(C=C)C(CC(C=O)=CCO)O)=O,,,5,1,1,0,1
19534_0,,,,2,2,1,3
C(CC(CC(C=O)=CCO)O)=O,,,5,1,2,0,2
19536_0,,,,2,2,1,3
C(C(C(CC(C=O)=CCO)O)O)=O,,,5,1,2,0,2
19536_1,,,,2,2,1,3
19538_0,,,,2,2,1,3
C(C(C=C)C(C(CC=O)=CCO)O)=O,,,5,1,1,0,1
19540_0,,,,2,2,1,3
C(CC(C(CC=O)O)=CCO)=O,,,5,1,2,0,2
19542_0,,,,2,2,1,3
C(CC(C(C(C=O)O)O)=CCO)=O,,,5,1,2,0,2
19542_1,,,,2,2,1,3
19544_0,,,,2,2,1,3
C(C(C(C=O)=CCO)C(C=CC)O)=O,,,5,1,1,0,1
19546_0,,,,2,2,1,3
C(C(C(C=O)=CCO)C(CC=C)O)=O,,,5,1,1,0,1
19548_0,,,,2,2,1,3
C(C(C(C=O)=CCO)C(C=C)O)=O,,,5,1,1,0,1
19550_0,,,,2,2,1,3
C(C(C(C=O)=CCO)C(C=O)O)=O,,,5,1,1,0,1
19552_0,,,,2,2,1,3
C(C(C(C=O)=CCO)C(C)O)=O,,,5,1,2,0,2
19554_0,,,,2,2,1,3
C(C(C(C=O)=CCO)CO)=O,,,5,1,3,0,3
19556_0,,,,2,2,1,3
C(C(C(C=O)=CCO)C(CO)O)=O,,,5,1,1,0,1
19558_0,,,,2,2,1,3
C(CC(C(C(C=O)=CCO)O)O)=O,,,5,1,1,0,1
19560_0,,,,2,2,1,3
C(C(C(C(CC=O)O)=CCO)O)=O,,,5,1,1,0,1
19562_0,,,,2,2,1,3
C(C(C=C)C(C=CC(CCO)=O)O)=O,,,5,1,1,0,1
19564_0,,,,2,2,1,3
C(CC(C=CC(CCO)=O)O)=O,,,5,1,2,0,2
19566_0,,,,2,2,1,3
C(C(C(C=CC(CCO)=O)O)O)=O,,,5,1,2,0,2
19566_1,,,,2,2,1,3
19568_0,,,,2,2,1,3
C(C(C=C)C(C=CC=O)(CCO)O)=O,,,5,1,1,0,1
19570_0,,,,2,2,1,3
C(CC(C=CC=O)(CCO)O)=O,,,5,1,2,0,2
19572_0,,,,2,2,1,3
C(C(C(C=CC=O)(CCO)O)O)=O,,,5,1,2,0,2
19572_1,,,,2,2,1,3
19574_0,,,,2,2,1,3
C(C)=CC(C(C(C=CC=O)=O)CO)O,,,5,1,2,0,2
19574_1,,,,2,2,1,3
19576_0,,,,2,2,1,3
C=CCC(C(C(C=CC=O)=O)CO)O,,,5,1,2,0,2
19576_1,,,,2,2,1,3
19578_0,,,,2,2,1,3
C=CC(C(C(C=CC=O)=O)CO)O,,,5,1,2,0,2
19578_1,,,,2,2,1,3
19580_0,,,,2,2,1,3
C(C(C(C(C=CC=O)=O)CO)O)=O,,,5,1,2,0,2
19580_1,,,,2,2,1,3
19582_0,,,,2,2,1,3
C(C=CC(C(CO)C(C)O)=O)=O,,,5,1,3,0,3
19582_1,,,,2,2,1,3
19584_0,,,,2,2,1,3
C(C=CC(C(CO)CO)=O)=O,,,5,1,3,0,3
19584_1,,,,2,2,1,3
19586_0,,,,2,2,1,3
C(C=CC(C(CO)C(CO)O)=O)=O,,,5,1,2,0,2
19586_1,,,,2,2,1,3
19588_0,,,,2,2,1,3
C(C(C=C)C(C=O)(C(C=C)CO)O)=O,,,5,1,1,0,1
19590_0,,,,2,2,1,3
C(CC(C=O)(C(C=C)CO)O)=O,,,5,1,2,0,2
19592_0,,,,2,2,1,3
C(C(C(C=O)(C(C=C)CO)O)O)=O,,,5,1,2,0,2
19592_1,,,,2,2,1,3
19594_0,,,,2,2,1,3
C(C(C=C)C(C(C(C=C)CO)=O)O)=O,,,5,1,1,0,1
19596_0,,,,2,2,1,3
C(CC(C(C(C=C)CO)=O)O)=O,,,5,1,2,0,2
19598_0,,,,2,2,1,3
C(C(C(C(C(C=C)CO)=O)O)O)=O,,,5,1,2,0,2
19598_1,,,,2,2,1,3
19600_0,,,,2,2,1,3
C(C(C=C)C(C=O)(C(CO)=CC)O)=O,,,5,1,1,0,1
19602_0,,,,2,2,1,3
C(C(C(CO)=CC)(CC=O)O)=O,,,5,1,2,0,2
19604_0,,,,2,2,1,3
C(C(C(CO)=CC)(C(C=O)O)O)=O,,,5,1,2,0,2
19604_1,,,,2,2,1,3
19606_0,,,,2,2,1,3
C(C(C=C)C(C(C(CO)=CC)=O)O)=O,,,5,1,1,0,1
19608_0,,,,2,2,1,3
C(CC(C(C(CO)=CC)=O)O)=O,,,5,1,2,0,2
19610_0,,,,2,2,1,3
C(C(C(C(C(CO)=CC)=O)O)O)=O,,,5,1,2,0,2
19610_1,,,,2,2,1,3
19612_0,,,,2,2,1,3
C(C(C=C)C(C=O)(C(C(C)O)=C)O)=O,,,5,1,1,0,1
19614_0,,,,2,2,1,3
C(C(C(C(C)O)=C)(CC=O)O)=O,,,5,1,2,0,2
19616_0,,,,2,2,1,3
C(C(C(C(C)O)=C)(C(C=O)O)O)=O,,,5,1,2,0,2
19616_1,,,,2,2,1,3
19618_0,,,,2,2,1,3
C(C(C=C)C(C(C(C(C)O)=C)=O)O)=O,,,5,1,1,0,1
19620_0,,,,2,2,1,3
C(CC(C(C(C(C)O)=C)=O)O)=O,,,5,1,2,0,2
19622_0,,,,2,2,1,3
C(C(C(C(C(C(C)O)=C)=O)O)O)=O,,,5,1,2,0,2
19622_1,,,,2,2,1,3
19624_0,,,,2,2,1,3
C(C(C=C)C(C=O)(C(CO)=C)O)=O,,,5,1,1,0,1
19626_0,,,,2,2,1,3
C(C(C(CO)=C)(C1C(C=CO1)=O)O)=O,,,5,1,2,0,2
19626_1,,,,2,2,1,3
19628_0,,,,2,2,1,3
C(C(C(CO)=C)(CC(C=O)=O)O)=O,,,5,1,1,0,1
19630_0,,,,2,2,1,3
C(C(C=O)C(C=O)(C(CO)=C)O)=O,,,5,1,2,0,2
19630_1,,,,2,2,1,3
19632_0,,,,2,2,1,3
C(C(C(CO)=C)(CC=O)O)=O,,,5,1,4,0,4
19634_0,,,,2,2,1,3
C(C(CO)C(C=O)(C(CO)=C)O)=O,,,5,1,2,0,2
19634_1,,,,2,2,1,3
19636_0,,,,2,2,1,3
C(C(C(CO)=C)(C(C(C)=O)O)O)=O,,,5,1,2,0,2
19636_1,,,,2,2,1,3
19638_0,,,,2,2,1,3
C(C(C(CO)=C)(CC(CO)=O)O)=O,,,5,1,1,0,1
19640_0,,,,2,2,1,3
C(C(C(CO)=C)(C(C=O)O)O)=O,,,5,1,4,0,4
19640_1,,,,2,2,1,3
19642_0,,,,2,2,1,3
C(C(C=C)C(C(C(CO)=C)=O)O)=O,,,5,1,1,0,1
19644_0,,,,2,2,1,3
C=C(C(C(C1C(C=CO1)=O)O)=O)CO,,,5,1,2,0,2
19644_1,,,,2,2,1,3
19646_0,,,,2,2,1,3
C=C(C(C(CC(C=O)=O)O)=O)CO,,,5,1,1,0,1
19648_0,,,,2,2,1,3
C(C(C=O)C(C(C(CO)=C)=O)O)=O,,,5,1,2,0,2
19648_1,,,,2,2,1,3
19650_0,,,,2,2,1,3
C(CC(C(C(CO)=C)=O)O)=O,,,5,1,2,0,2
19652_0,,,,2,2,1,3
C(C(CO)C(C(C(CO)=C)=O)O)=O,,,5,1,2,0,2
19652_1,,,,2,2,1,3
19654_0,,,,2,2,1,3
C(C)(C(C(C(C(CO)=C)=O)O)O)=O,,,5,1,2,0,2
19654_1,,,,2,2,1,3
19656_0,,,,2,2,1,3
C(CO)(CC(C(C(CO)=C)=O)O)=O,,,5,1,1,0,1
19658_0,,,,2,2,1,3
C(C(C(C(C(CO)=C)=O)O)O)=O,,,5,1,3,0,3
19658_1,,,,2,2,1,3
19660_0,,,,2,2,1,3
C(C(C(CO)=CCO)(CC=O)O)=O,,,5,1,1,0,1
19662_0,,,,2,2,1,3
C(CC(C(C(CO)=CCO)=O)O)=O,,,5,1,1,0,1
19664_0,,,,2,2,1,3
C(C(C(C(CO)O)=C)(CC=O)O)=O,,,5,1,1,0,1
19666_0,,,,2,2,1,3
C(CC(C(C(C(CO)O)=C)=O)O)=O,,,5,1,1,0,1
19668_0,,,,2,2,1,3
C(C(C=C)C(C=CCC(C=O)O)O)=O,,,5,1,1,0,1
19670_0,,,,2,2,1,3
C(CC(C=CCC(C=O)O)O)=O,,,5,1,2,0,2
19672_0,,,,2,2,1,3
C(C(C(C=CCC(C=O)O)O)O)=O,,,5,1,2,0,2
19672_1,,,,2,2,1,3
19674_0,,,,2,2,1,3
C(C(C=C)C(C(CC=CC=O)O)O)=O,,,5,1,1,0,1
19676_0,,,,2,2,1,3
C(CC(C(CC=CC=O)O)O)=O,,,5,1,2,0,2
19678_0,,,,2,2,1,3
C(C(C(C(CC=CC=O)O)O)O)=O,,,5,1,2,0,2
19678_1,,,,2,2,1,3
19680_0,,,,2,2,1,3
C(C(C=C)C(CC=CC(C=O)O)O)=O,,,5,1,1,0,1
19682_0,,,,2,2,1,3
C(C(C=CCC(CC=O)O)O)=O,,,5,1,2,0,2
19684_0,,,,2,2,1,3
C(C(C=CCC(C(C=O)O)O)O)=O,,,5,1,2,0,2
19684_1,,,,2,2,1,3
19686_0,,,,2,2,1,3
C(C(C=C)C(C(C=CCC=O)O)O)=O,,,5,1,1,0,1
19688_0,,,,2,2,1,3
C(CC(C(C=CCC=O)O)O)=O,,,5,1,2,0,2
19690_0,,,,2,2,1,3
C(CC=CC(C(C(C=O)O)O)O)=O,,,5,1,2,0,2
19690_1,,,,2,2,1,3
19692_0,,,,2,2,1,3
C(C(C=CC(C=O)O)C(C=CC)O)=O,,,5,1,1,0,1
19694_0,,,,2,2,1,3
C(C(C=CC(C=O)O)C(CC=C)O)=O,,,5,1,1,0,1
19696_0,,,,2,2,1,3
C(C(C=CC(C=O)O)C(C=C)O)=O,,,5,1,1,0,1
19698_0,,,,2,2,1,3
C(C(C=CC(C=O)O)C(C=O)O)=O,,,5,1,1,0,1
19700_0,,,,2,2,1,3
C(C(C=CC(C=O)O)C(C)O)=O,,,5,1,2,0,2
19702_0,,,,2,2,1,3
C(C(C=CC(C=O)O)CO)=O,,,5,1,3,0,3
19704_0,,,,2,2,1,3
C(C(C=CC(C=O)O)C(CO)O)=O,,,5,1,1,0,1
19706_0,,,,2,2,1,3
C(CC(C(C=CC(C=O)O)O)O)=O,,,5,1,1,0,1
19708_0,,,,2,2,1,3
C(C(C=C)C(C(C(C=O)C=C)O)O)=O,,,5,1,1,0,1
19710_0,,,,2,2,1,3
C(C(C=C)C(C(CC=O)O)O)=O,,,5,1,3,0,3
19712_0,,,,2,2,1,3
C(C(C=C)C(C(C(C=O)O)O)O)=O,,,5,1,3,0,3
19712_1,,,,2,2,1,3
19714_0,,,,2,2,1,3
C(C(C=C)C(C(C=C)C(C=O)O)O)=O,,,5,1,1,0,1
19716_0,,,,2,2,1,3
C(CC(C(C=C)C(C=O)O)O)=O,,,5,1,2,0,2
19718_0,,,,2,2,1,3
C(C(C(C(C=C)C(C=O)O)O)O)=O,,,5,1,2,0,2
19718_1,,,,2,2,1,3
19720_0,,,,2,2,1,3
C(C(C=C)C(C(C(C=O)=CC)O)O)=O,,,5,1,1,0,1
19722_0,,,,2,2,1,3
C(CC(C(C(C=O)=CC)O)O)=O,,,5,1,2,0,2
19724_0,,,,2,2,1,3
C(C(C(C(C(C=O)=CC)O)O)O)=O,,,5,1,2,0,2
19724_1,,,,2,2,1,3
19726_0,,,,2,2,1,3
C(C(C=C)C(C(C(C=O)O)=CC)O)=O,,,5,1,1,0,1
19728_0,,,,2,2,1,3
C(C(C(C(CC=O)O)=CC)O)=O,,,5,1,2,0,2
19730_0,,,,2,2,1,3
C(C(C(C(C(C=O)O)O)=CC)O)=O,,,5,1,2,0,2
19730_1,,,,2,2,1,3
19732_0,,,,2,2,1,3
C(C(C=C)C(C=C(C=O)C(C)O)O)=O,,,5,1,1,0,1
19734_0,,,,2,2,1,3
C(CC(C=C(C=O)C(C)O)O)=O,,,5,1,3,0,3
19736_0,,,,2,2,1,3
C(C(C(C=C(C=O)C(C)O)O)O)=O,,,5,1,2,0,2
19736_1,,,,2,2,1,3
19738_0,,,,2,2,1,3
C(C(C=C)C(C(C(C)O)=CC=O)O)=O,,,5,1,1,0,1
19740_0,,,,2,2,1,3
C(CC(C(C(C)O)=CC=O)O)=O,,,5,1,3,0,3
19742_0,,,,2,2,1,3
C(C(C(C(C(C)O)=CC=O)O)O)=O,,,5,1,2,0,2
19742_1,,,,2,2,1,3
19744_0,,,,2,2,1,3
C(C(C=C)C(C=C(C=O)CO)O)=O,,,5,1,1,0,1
19746_0,,,,2,2,1,3
C1OC(C(C=1)=O)C(C=C(C=O)CO)O,,,5,1,2,0,2
19746_1,,,,2,2,1,3
19748_0,,,,2,2,1,3
C(C(CC(C=O)=O)O)=C(C=O)CO,,,5,1,1,0,1
19750_0,,,,2,2,1,3
C(C(C=O)C(C=C(C=O)CO)O)=O,,,5,1,2,0,2
19750_1,,,,2,2,1,3
19752_0,,,,2,2,1,3
C(CC(C=C(C=O)CO)O)=O,,,5,1,4,0,4
19754_0,,,,2,2,1,3
C(C(CO)C(C=C(C=O)CO)O)=O,,,5,1,2,0,2
19754_1,,,,2,2,1,3
19756_0,,,,2,2,1,3
C(C)(C(C(C=C(C=O)CO)O)O)=O,,,5,1,2,0,2
19756_1,,,,2,2,1,3
19758_0,,,,2,2,1,3
C(CO)(CC(C=C(C=O)CO)O)=O,,,5,1,1,0,1
19760_0,,,,2,2,1,3
C(C(C(C=C(C=O)CO)O)O)=O,,,5,1,4,0,4
19760_1,,,,2,2,1,3
19762_0,,,,2,2,1,3
C(C(C=C)C(C(CO)=CC=O)O)=O,,,5,1,1,0,1
19764_0,,,,2,2,1,3
C1OC(C(C=1)=O)C(C(CO)=CC=O)O,,,5,1,2,0,2
19764_1,,,,2,2,1,3
19766_0,,,,2,2,1,3
C(CO)(C(CC(C=O)=O)O)=CC=O,,,5,1,1,0,1
19768_0,,,,2,2,1,3
C(C(C=O)C(C(CO)=CC=O)O)=O,,,5,1,2,0,2
19768_1,,,,2,2,1,3
19770_0,,,,2,2,1,3
C(CC(C(CO)=CC=O)O)=O,,,5,1,4,0,4
19772_0,,,,2,2,1,3
C(C(CO)C(C(CO)=CC=O)O)=O,,,5,1,2,0,2
19772_1,,,,2,2,1,3
19774_0,,,,2,2,1,3
C(C)(C(C(C(CO)=CC=O)O)O)=O,,,5,1,2,0,2
19774_1,,,,2,2,1,3
19776_0,,,,2,2,1,3
C(CO)(CC(C(CO)=CC=O)O)=O,,,5,1,1,0,1
19778_0,,,,2,2,1,3
C(C(C(C(CO)=CC=O)O)O)=O,,,5,1,6,0,6
19778_1,,,,2,2,1,3
19780_0,,,,2,2,1,3
C(CC(C=C(C=O)C(CO)O)O)=O,,,5,1,1,0,1
19782_0,,,,2,2,1,3
C(CC(C(C(CO)O)=CC=O)O)=O,,,5,1,1,0,1
19784_0,,,,2,2,1,3
C(C(C=C)C(C=CCC(CO)=O)O)=O,,,5,1,1,0,1
19786_0,,,,2,2,1,3
C(CC(C=CCC(CO)=O)O)=O,,,5,1,2,0,2
19788_0,,,,2,2,1,3
C(C(C(C=CCC(CO)=O)O)O)=O,,,5,1,2,0,2
19788_1,,,,2,2,1,3
19790_0,,,,2,2,1,3
C(C(C=C)C(CO)(CC=CC=O)O)=O,,,5,1,1,0,1
19792_0,,,,2,2,1,3
C(CC(CO)(CC=CC=O)O)=O,,,5,1,2,0,2
19794_0,,,,2,2,1,3
C(C(C(CO)(CC=CC=O)O)O)=O,,,5,1,2,0,2
19794_1,,,,2,2,1,3
19796_0,,,,2,2,1,3
C(CO)(C(C=CC=O)C(C=CC)O)=O,,,5,1,1,0,1
19798_0,,,,2,2,1,3
C(CO)(C(C=CC=O)C(CC=C)O)=O,,,5,1,1,0,1
19800_0,,,,2,2,1,3
C(CO)(C(C=CC=O)C(C=C)O)=O,,,5,1,1,0,1
19802_0,,,,2,2,1,3
C(C(C(C(CO)=O)C=CC=O)O)=O,,,5,1,1,0,1
19804_0,,,,2,2,1,3
C(CO)(C(C=CC=O)C(C)O)=O,,,5,1,2,0,2
19806_0,,,,2,2,1,3
C(CO)(C(C=CC=O)CO)=O,,,5,1,5,0,5
19808_0,,,,2,2,1,3
C(CO)(C(C=CC=O)C(CO)O)=O,,,5,1,1,0,1
19810_0,,,,2,2,1,3
C(C(C(C=CC)O)O)(CC=CC=O)=O,,,5,1,2,0,2
19810_1,,,,2,2,1,3
19812_0,,,,2,2,1,3
C(C(C(CC=C)O)O)(CC=CC=O)=O,,,5,1,2,0,2
19812_1,,,,2,2,1,3
19814_0,,,,2,2,1,3
C(C(C(C=C)O)O)(CC=CC=O)=O,,,5,1,2,0,2
19814_1,,,,2,2,1,3
19815_0,,,,2,2,1,3
19815_1,,,,2,2,1,3
19817_0,,,,2,2,1,3
C(C(C(C)O)O)(CC=CC=O)=O,,,5,1,3,0,3
19817_1,,,,2,2,1,3
19819_0,,,,2,2,1,3
C(C(CO)O)(CC=CC=O)=O,,,5,1,5,0,5
19819_1,,,,2,2,1,3
19821_0,,,,2,2,1,3
C(C(C(CO)O)O)(CC=CC=O)=O,,,5,1,2,0,2
19821_1,,,,2,2,1,3
19823_0,,,,2,2,1,3
C(C(C=C)C(CC=CC(CO)=O)O)=O,,,5,1,1,0,1
19825_0,,,,2,2,1,3
C(CC(CC=CC(CO)=O)O)=O,,,5,1,2,0,2
19827_0,,,,2,2,1,3
C(C(C(CC=CC(CO)=O)O)O)=O,,,5,1,2,0,2
19827_1,,,,2,2,1,3
19829_0,,,,2,2,1,3
C(CC=CC(CO)(C(C=O)C=C)O)=O,,,5,1,1,0,1
19831_0,,,,2,2,1,3
C(CC=CC(CO)(CC=O)O)=O,,,5,1,2,0,2
19833_0,,,,2,2,1,3
C(CC=CC(CO)(C(C=O)O)O)=O,,,5,1,2,0,2
19833_1,,,,2,2,1,3
19835_0,,,,2,2,1,3
C(C(C=CC(CO)=O)C(C=CC)O)=O,,,5,1,1,0,1
19837_0,,,,2,2,1,3
C(C(C=CC(CO)=O)C(CC=C)O)=O,,,5,1,1,0,1
19839_0,,,,2,2,1,3
C(C(C=CC(CO)=O)C(C=C)O)=O,,,5,1,1,0,1
19841_0,,,,2,2,1,3
C(C(C=CC(CO)=O)C(C=O)O)=O,,,5,1,1,0,1
19843_0,,,,2,2,1,3
C(C(C=CC(CO)=O)C(C)O)=O,,,5,1,2,0,2
19845_0,,,,2,2,1,3
C(C(C=CC(CO)=O)CO)=O,,,5,1,3,0,3
19847_0,,,,2,2,1,3
C(C(C=CC(CO)=O)C(CO)O)=O,,,5,1,1,0,1
19849_0,,,,2,2,1,3
C(CC=CC(C(C(C=CC)O)O)=O)=O,,,5,1,2,0,2
19849_1,,,,2,2,1,3
19851_0,,,,2,2,1,3
C(CC=CC(C(C(CC=C)O)O)=O)=O,,,5,1,2,0,2
19851_1,,,,2,2,1,3
19853_0,,,,2,2,1,3
C(CC=CC(C(C(C=C)O)O)=O)=O,,,5,1,2,0,2
19853_1,,,,2,2,1,3
19854_0,,,,2,2,1,3
19854_1,,,,2,2,1,3
19856_0,,,,2,2,1,3
C(CC=CC(C(C(C)O)O)=O)=O,,,5,1,3,0,3
19856_1,,,,2,2,1,3
19858_0,,,,2,2,1,3
C(CC=CC(C(CO)O)=O)=O,,,5,1,4,0,4
19858_1,,,,2,2,1,3
19860_0,,,,2,2,1,3
C(CC=CC(C(C(CO)O)O)=O)=O,,,5,1,2,0,2
19860_1,,,,2,2,1,3
19862_0,,,,2,2,1,3
C(CC(C(C=CC(CO)=O)O)O)=O,,,5,1,1,0,1
19864_0,,,,2,2,1,3
C(C(C=CC(CO)(CC=O)O)O)=O,,,5,1,1,0,1
19866_0,,,,2,2,1,3
C(C(C=CC(C(C(C)O)O)=O)O)=O,,,5,1,2,0,2
19866_1,,,,2,2,1,3
19868_0,,,,2,2,1,3
C(C(C=CC(C(CO)O)=O)O)=O,,,5,1,5,0,5
19868_1,,,,2,2,1,3
19870_0,,,,2,2,1,3
C(C(C=C)C(C=C(CO)CC=O)O)=O,,,5,1,1,0,1
19872_0,,,,2,2,1,3
C(CC(CO)=CC(CC=O)O)=O,,,5,1,2,0,2
19874_0,,,,2,2,1,3
C(CC(CO)=CC(C(C=O)O)O)=O,,,5,1,2,0,2
19874_1,,,,2,2,1,3
19876_0,,,,2,2,1,3
C(C(C=C)C(CC(CO)=CC=O)O)=O,,,5,1,1,0,1
19878_0,,,,2,2,1,3
C(CC(CC(CO)=CC=O)O)=O,,,5,1,2,0,2
19880_0,,,,2,2,1,3
C(C(C(CC(CO)=CC=O)O)O)=O,,,5,1,2,0,2
19880_1,,,,2,2,1,3
19882_0,,,,2,2,1,3
C(C(C(CO)=CC=O)C(C=CC)O)=O,,,5,1,1,0,1
19884_0,,,,2,2,1,3
C(C(C(CO)=CC=O)C(CC=C)O)=O,,,5,1,1,0,1
19886_0,,,,2,2,1,3
C(C(C(CO)=CC=O)C(C=C)O)=O,,,5,1,1,0,1
19888_0,,,,2,2,1,3
C(C(C(CO)=CC=O)C(C=O)O)=O,,,5,1,1,0,1
19890_0,,,,2,2,1,3
C(C(C(CO)=CC=O)C(C)O)=O,,,5,1,2,0,2
19892_0,,,,2,2,1,3
C(C(C(CO)=CC=O)CO)=O,,,5,1,3,0,3
19894_0,,,,2,2,1,3
C(C(C(CO)=CC=O)C(CO)O)=O,,,5,1,1,0,1
19896_0,,,,2,2,1,3
C(CC(C(C(CO)=CC=O)O)O)=O,,,5,1,1,0,1
19898_0,,,,2,2,1,3
C(C(C(CO)=CC(CC=O)O)O)=O,,,5,1,1,0,1
19900_0,,,,2,2,1,3
C(C(C=C)C(C(C(CO)=O)C=C)O)=O,,,5,1,1,0,1
19902_0,,,,2,2,1,3
C(CC(C(C(CO)=O)C=C)O)=O,,,5,1,2,0,2
19904_0,,,,2,2,1,3
C(C(C(C(C(CO)=O)C=C)O)O)=O,,,5,1,2,0,2
19904_1,,,,2,2,1,3
19906_0,,,,2,2,1,3
C(C(C=C)C(CO)(C(C=O)C=C)O)=O,,,5,1,1,0,1
19908_0,,,,2,2,1,3
C(C(C=C)C(CO)(CC=O)O)=O,,,5,1,3,0,3
19909_0,,,,2,2,1,3
19909_1,,,,2,2,1,3
19911_0,,,,2,2,1,3
C(C(C(C(C(C=CC)O)O)=O)C=C)=O,,,5,1,2,0,2
19911_1,,,,2,2,1,3
19913_0,,,,2,2,1,3
C(C(C(C(C(CC=C)O)O)=O)C=C)=O,,,5,1,2,0,2
19913_1,,,,2,2,1,3
19915_0,,,,2,2,1,3
C(C(C(C(C(C=C)O)O)=O)C=C)=O,,,5,1,2,0,2
19915_1,,,,2,2,1,3
19917_0,,,,2,2,1,3
C(C(C(C(C(C=O)O)O)=O)C=C)=O,,,5,1,2,0,2
19917_1,,,,2,2,1,3
19919_0,,,,2,2,1,3
C(C(C(C(C(C)O)O)=O)C=C)=O,,,5,1,3,0,3
19919_1,,,,2,2,1,3
19921_0,,,,2,2,1,3
C(C(C(C(CO)O)=O)C=C)=O,,,5,1,4,0,4
19921_1,,,,2,2,1,3
19923_0,,,,2,2,1,3
C(C(C(C(C(CO)O)O)=O)C=C)=O,,,5,1,2,0,2
19923_1,,,,2,2,1,3
19925_0,,,,2,2,1,3
C(C(C=C)C(C(C(CO)=O)=CC)O)=O,,,5,1,1,0,1
19927_0,,,,2,2,1,3
C(CC(C(C(CO)=O)=CC)O)=O,,,5,1,2,0,2
19929_0,,,,2,2,1,3
C(C(C(C(C(CO)=O)=CC)O)O)=O,,,5,1,2,0,2
19929_1,,,,2,2,1,3
19931_0,,,,2,2,1,3
C(C(C=C)C(C(C=O)=CC)(CO)O)=O,,,5,1,1,0,1
19933_0,,,,2,2,1,3
C(CC(C(C=O)=CC)(CO)O)=O,,,5,1,2,0,2
19935_0,,,,2,2,1,3
C(C(C(C(C=O)=CC)(CO)O)O)=O,,,5,1,2,0,2
19935_1,,,,2,2,1,3
19937_0,,,,2,2,1,3
C(C)=CC(C(C(C(C=O)=CC)=O)O)O,,,5,1,2,0,2
19937_1,,,,2,2,1,3
19939_0,,,,2,2,1,3
C(CC(C(C(C(C=O)=CC)=O)O)O)=C,,,5,1,2,0,2
19939_1,,,,2,2,1,3
19941_0,,,,2,2,1,3
C=CC(C(C(C(C=O)=CC)=O)O)O,,,5,1,2,0,2
19941_1,,,,2,2,1,3
19943_0,,,,2,2,1,3
C(C(C(C(C(C=O)=CC)=O)O)O)=O,,,5,1,2,0,2
19943_1,,,,2,2,1,3
19945_0,,,,2,2,1,3
C(C)=C(C(C(C(C)O)O)=O)C=O,,,5,1,3,0,3
19945_1,,,,2,2,1,3
19947_0,,,,2,2,1,3
C(C)=C(C(C(CO)O)=O)C=O,,,5,1,3,0,3
19947_1,,,,2,2,1,3
19949_0,,,,2,2,1,3
C(C)=C(C(C(C(CO)O)O)=O)C=O,,,5,1,2,0,2
19949_1,,,,2,2,1,3
19951_0,,,,2,2,1,3
C(C(C=C)C(C(C(CO)=O)=C)O)=O,,,5,1,1,0,1
19953_0,,,,2,2,1,3
C=C(C(CO)=O)C(C1C(C=CO1)=O)O,,,5,1,2,0,2
19953_1,,,,2,2,1,3
19955_0,,,,2,2,1,3
C=C(C(CO)=O)C(CC(C=O)=O)O,,,5,1,1,0,1
19957_0,,,,2,2,1,3
C(C(C=O)C(C(C(CO)=O)=C)O)=O,,,5,1,2,0,2
19957_1,,,,2,2,1,3
19959_0,,,,2,2,1,3
C(CC(C(C(CO)=O)=C)O)=O,,,5,1,3,0,3
19961_0,,,,2,2,1,3
C(C(CO)C(C(C(CO)=O)=C)O)=O,,,5,1,2,0,2
19961_1,,,,2,2,1,3
19963_0,,,,2,2,1,3
C(C)(C(C(C(C(CO)=O)=C)O)O)=O,,,5,1,2,0,2
19963_1,,,,2,2,1,3
19965_0,,,,2,2,1,3
C(CO)(CC(C(C(CO)=O)=C)O)=O,,,5,1,1,0,1
19967_0,,,,2,2,1,3
C(C(C(C(C(CO)=O)=C)O)O)=O,,,5,1,3,0,3
19967_1,,,,2,2,1,3
19969_0,,,,2,2,1,3
C(C(C=C)C(C(C=O)=C)(CO)O)=O,,,5,1,1,0,1
19971_0,,,,2,2,1,3
C1OC(C(C=1)=O)C(C(C=O)=C)(CO)O,,,5,1,2,0,2
19971_1,,,,2,2,1,3
19973_0,,,,2,2,1,3
C=C(C=O)C(CO)(CC(C=O)=O)O,,,5,1,1,0,1
19975_0,,,,2,2,1,3
C(C(C=O)C(C(C=O)=C)(CO)O)=O,,,5,1,2,0,2
19975_1,,,,2,2,1,3
19977_0,,,,2,2,1,3
C(CC(C(C=O)=C)(CO)O)=O,,,5,1,4,0,4
19979_0,,,,2,2,1,3
C(C(CO)C(C(C=O)=C)(CO)O)=O,,,5,1,2,0,2
19979_1,,,,2,2,1,3
19981_0,,,,2,2,1,3
C(C(C(C(C=O)=C)(CO)O)O)(C)=O,,,5,1,2,0,2
19981_1,,,,2,2,1,3
19983_0,,,,2,2,1,3
C(CC(C(C=O)=C)(CO)O)(CO)=O,,,5,1,1,0,1
19985_0,,,,2,2,1,3
C(C(C(C(C=O)=C)(CO)O)O)=O,,,5,1,7,0,7
19985_1,,,,2,2,1,3
19987_0,,,,2,2,1,3
C=C(C=O)C(C(C(C=CC)O)O)=O,,,5,1,2,0,2
19987_1,,,,2,2,1,3
19989_0,,,,2,2,1,3
C(CC(C(C(C(C=O)=C)=O)O)O)=C,,,5,1,2,0,2
19989_1,,,,2,2,1,3
19991_0,,,,2,2,1,3
C=CC(C(C(C(C=O)=C)=O)O)O,,,5,1,2,0,2
19991_1,,,,2,2,1,3
19993_0,,,,2,2,1,3
C1C(COC=1)(C(C(C(C=O)=C)=O)O)O,,,5,1,2,0,2
19993_1,,,,2,2,1,3
19995_0,,,,2,2,1,3
C(C(C(C(C(C=O)=C)=O)O)O)=O,,,5,1,3,0,3
19995_1,,,,2,2,1,3
19997_0,,,,2,2,1,3
C(C(C)(C(C(C(C=O)=C)=O)O)O)=O,,,5,1,2,0,2
19997_1,,,,2,2,1,3
19999_0,,,,2,2,1,3
C(C)(C(C(C(C(C=O)=C)=O)O)O)=O,,,5,1,2,0,2
19999_1,,,,2,2,1,3
20001_0,,,,2,2,1,3
C(CC(C(C(C(C=O)=C)=O)O)O)=O,,,5,1,2,0,2
20001_1,,,,2,2,1,3
20003_0,,,,2,2,1,3
C=C(C=O)C(C(C(C)O)O)=O,,,5,1,3,0,3
20003_1,,,,2,2,1,3
20005_0,,,,2,2,1,3
C=C(C=O)C(C(C(CCO)O)O)=O,,,5,1,2,0,2
20005_1,,,,2,2,1,3
20007_0,,,,2,2,1,3
C=C(C=O)C(C(C(CO)(C)O)O)=O,,,5,1,2,0,2
20007_1,,,,2,2,1,3
20009_0,,,,2,2,1,3
C(C(C(C(C(C=O)=C)=O)O)O)(O)=O,,,5,1,2,0,2
20009_1,,,,2,2,1,3
20011_0,,,,2,2,1,3
C(C(C=C)(C(C(C(C=O)=C)=O)O)O)=O,,,5,1,2,0,2
20011_1,,,,2,2,1,3
20013_0,,,,2,2,1,3
C=C(C=O)C(C(C(C(C=C)=O)O)O)=O,,,5,1,2,0,2
20013_1,,,,2,2,1,3
20015_0,,,,2,2,1,3
C=C(C=O)C(C(C(C=CC=O)O)O)=O,,,5,1,2,0,2
20015_1,,,,2,2,1,3
20016_0,,,,2,2,1,3
20016_1,,,,2,2,1,3
20018_0,,,,2,2,1,3
C=C(C=O)C(C(C(CO)O)O)=O,,,5,1,5,0,5
20018_1,,,,2,2,1,3
20020_0,,,,2,2,1,3
C(CC(C(C(CO)=O)=CCO)O)=O,,,5,1,1,0,1
20022_0,,,,2,2,1,3
C(CC(C(C=O)=CCO)(CO)O)=O,,,5,1,1,0,1
20024_0,,,,2,2,1,3
C(CO)=C(C(C(C(C)O)O)=O)C=O,,,5,1,2,0,2
20024_1,,,,2,2,1,3
20026_0,,,,2,2,1,3
C(CO)=C(C(C(CO)O)=O)C=O,,,5,1,5,0,5
20026_1,,,,2,2,1,3
20028_0,,,,2,2,1,3
C(C(C=C)C(CC(C(C=C)O)=O)O)=O,,,5,1,1,0,1
20030_0,,,,2,2,1,3
C(CC(CC(C(C=C)O)=O)O)=O,,,5,1,2,0,2
20032_0,,,,2,2,1,3
C(CC(C(C=O)O)O)(C(C=C)O)=O,,,5,1,2,0,2
20032_1,,,,2,2,1,3
20034_0,,,,2,2,1,3
C(CC(C(C=C)O)(C(C=O)C=C)O)=O,,,5,1,1,0,1
20036_0,,,,2,2,1,3
C(CC(C(C=C)O)(CC=O)O)=O,,,5,1,2,0,2
20038_0,,,,2,2,1,3
C(CC(C(C=O)O)(C(C=C)O)O)=O,,,5,1,2,0,2
20038_1,,,,2,2,1,3
20040_0,,,,2,2,1,3
C(C(C(C(C=C)O)=O)C(C=CC)O)=O,,,5,1,2,0,2
20040_1,,,,2,2,1,3
20042_0,,,,2,2,1,3
C(C(C(C(C=C)O)=O)C(CC=C)O)=O,,,5,1,2,0,2
20042_1,,,,2,2,1,3
20044_0,,,,2,2,1,3
C(C(C(C(C=C)O)=O)C(C=C)O)=O,,,5,1,2,0,2
20044_1,,,,2,2,1,3
20046_0,,,,2,2,1,3
C(C(C(C(C=C)O)=O)C(C=O)O)=O,,,5,1,3,0,3
20046_1,,,,2,2,1,3
20048_0,,,,2,2,1,3
C(C(C(C(C=C)O)=O)C(C)O)=O,,,5,1,4,0,4
20048_1,,,,2,2,1,3
20050_0,,,,2,2,1,3
C(C(C(C(C=C)O)=O)CO)=O,,,5,1,4,0,4
20050_1,,,,2,2,1,3
20052_0,,,,2,2,1,3
C(C(C(C(C=C)O)=O)C(CO)O)=O,,,5,1,3,0,3
20052_1,,,,2,2,1,3
20054_0,,,,2,2,1,3
C(C(C=C)C(C=CC(C(C)=O)O)O)=O,,,5,1,1,0,1
20056_0,,,,2,2,1,3
C(CC(C=CC(C(C)=O)O)O)=O,,,5,1,2,0,2
20058_0,,,,2,2,1,3
C(C(C(C=CC(C(C)=O)O)O)O)=O,,,5,1,2,0,2
20058_1,,,,2,2,1,3
20060_0,,,,2,2,1,3
C(C(C=C)C(C)(C(C=CC=O)O)O)=O,,,5,1,1,0,1
20062_0,,,,2,2,1,3
C(CC(C)(C(C=CC=O)O)O)=O,,,5,1,2,0,2
20064_0,,,,2,2,1,3
C(C(C(C)(C(C=CC=O)O)O)O)=O,,,5,1,2,0,2
20064_1,,,,2,2,1,3
20066_0,,,,2,2,1,3
C(CC(C=CC)O)(C(C=CC=O)O)=O,,,5,1,1,0,1
20068_0,,,,2,2,1,3
C(CC(CC=C)O)(C(C=CC=O)O)=O,,,5,1,1,0,1
20070_0,,,,2,2,1,3
C(CC(C=C)O)(C(C=CC=O)O)=O,,,5,1,1,0,1
20072_0,,,,2,2,1,3
C(C(CC(C(C=CC=O)O)=O)O)=O,,,5,1,1,0,1
20074_0,,,,2,2,1,3
C(CC(C)O)(C(C=CC=O)O)=O,,,5,1,2,0,2
20076_0,,,,2,2,1,3
C(CCO)(C(C=CC=O)O)=O,,,5,1,4,0,4
20078_0,,,,2,2,1,3
C(CC(CO)O)(C(C=CC=O)O)=O,,,5,1,1,0,1
20080_0,,,,2,2,1,3
C(C(C=C)C(C=C(C)C(C=O)O)O)=O,,,5,1,1,0,1
20082_0,,,,2,2,1,3
C(C(C(C)=CC(CC=O)O)O)=O,,,5,1,2,0,2
20084_0,,,,2,2,1,3
C(C(C(C)=CC(C(C=O)O)O)O)=O,,,5,1,2,0,2
20084_1,,,,2,2,1,3
20086_0,,,,2,2,1,3
C(C(C=C)C(C(C(C)=CC=O)O)O)=O,,,5,1,1,0,1
20088_0,,,,2,2,1,3
C(CC(C(C(C)=CC=O)O)O)=O,,,5,1,2,0,2
20090_0,,,,2,2,1,3
C(C(C(C(C(C)=CC=O)O)O)O)=O,,,5,1,2,0,2
20090_1,,,,2,2,1,3
20092_0,,,,2,2,1,3
C(C(C=C)C(CC(C(C=O)O)=C)O)=O,,,5,1,1,0,1
20094_0,,,,2,2,1,3
C(C(C(CC(CC=O)O)=C)O)=O,,,5,1,2,0,2
20096_0,,,,2,2,1,3
C(C(C(CC(C(C=O)O)O)=C)O)=O,,,5,1,2,0,2
20096_1,,,,2,2,1,3
20098_0,,,,2,2,1,3
C(C(C=C)C(C(C(CC=O)=C)O)O)=O,,,5,1,1,0,1
20100_0,,,,2,2,1,3
C(CC(C(C(CC=O)=C)O)O)=O,,,5,1,2,0,2
20102_0,,,,2,2,1,3
C(CC(C(C(C(C=O)O)O)O)=C)=O,,,5,1,2,0,2
20102_1,,,,2,2,1,3
20104_0,,,,2,2,1,3
C(C(C(C(C=O)O)=C)C(C=CC)O)=O,,,5,1,1,0,1
20106_0,,,,2,2,1,3
C(C(C(C(C=O)O)=C)C(CC=C)O)=O,,,5,1,1,0,1
20108_0,,,,2,2,1,3
C(C(C(C(C=O)O)=C)C(C=C)O)=O,,,5,1,1,0,1
20110_0,,,,2,2,1,3
C(C(C(C(C=O)O)=C)C(C=O)O)=O,,,5,1,1,0,1
20112_0,,,,2,2,1,3
C(C(C(C(C=O)O)=C)C(C)O)=O,,,5,1,2,0,2
20114_0,,,,2,2,1,3
C(C(C(C(C=O)O)=C)CO)=O,,,5,1,3,0,3
20116_0,,,,2,2,1,3
C(C(C(C(C=O)O)=C)C(CO)O)=O,,,5,1,1,0,1
20118_0,,,,2,2,1,3
C(CC(C(C(C(C=O)O)=C)O)O)=O,,,5,1,1,0,1
20120_0,,,,2,2,1,3
C(C(C=C)C(C(C(CC=C)=O)O)O)=O,,,5,1,1,0,1
20122_0,,,,2,2,1,3
C(CC(C(C(CC=C)=O)O)O)=O,,,5,1,2,0,2
20124_0,,,,2,2,1,3
C(C(C(C(C(CC=C)=O)O)O)O)=O,,,5,1,2,0,2
20124_1,,,,2,2,1,3
20126_0,,,,2,2,1,3
C(C(C=C)C(C(C=O)O)(CC=C)O)=O,,,5,1,1,0,1
20128_0,,,,2,2,1,3
C(CC(C(C=O)O)(CC=C)O)=O,,,5,1,2,0,2
20130_0,,,,2,2,1,3
C(C(C(C(C=O)O)(CC=C)O)O)=O,,,5,1,2,0,2
20130_1,,,,2,2,1,3
20132_0,,,,2,2,1,3
C(C(C(C(C=C)C(C=CC)O)=O)O)=O,,,5,1,1,0,1
20134_0,,,,2,2,1,3
C(C(C(C(C=C)C(CC=C)O)=O)O)=O,,,5,1,1,0,1
20136_0,,,,2,2,1,3
C(C(C(C(C=C)C(C=C)O)=O)O)=O,,,5,1,1,0,1
20138_0,,,,2,2,1,3
C(C(C=O)O)(C(C=C)C(C=O)O)=O,,,5,1,1,0,1
20140_0,,,,2,2,1,3
C(C(C=O)O)(C(C=C)C(C)O)=O,,,5,1,2,0,2
20142_0,,,,2,2,1,3
C(C(C=O)O)(C(C=C)CO)=O,,,5,1,2,0,2
20144_0,,,,2,2,1,3
C(C(C=O)O)(C(C=C)C(CO)O)=O,,,5,1,1,0,1
20146_0,,,,2,2,1,3
C(C(C=C)C(C(C(C=CC)=O)O)O)=O,,,5,1,1,0,1
20148_0,,,,2,2,1,3
C(CC(C(C(C=CC)=O)O)O)=O,,,5,1,2,0,2
20150_0,,,,2,2,1,3
C(C(C(C(C(C=CC)=O)O)O)O)=O,,,5,1,2,0,2
20150_1,,,,2,2,1,3
20152_0,,,,2,2,1,3
C(C(C=C)C(C=CC)(C(C=O)O)O)=O,,,5,1,1,0,1
20154_0,,,,2,2,1,3
C(CC(C=CC)(C(C=O)O)O)=O,,,5,1,2,0,2
20156_0,,,,2,2,1,3
C(C(C(C=CC)(C(C=O)O)O)O)=O,,,5,1,2,0,2
20156_1,,,,2,2,1,3
20157_0,,,,2,2,1,3
20159_0,,,,2,2,1,3
C1OC(C(C=1)=O)C(C(C(C=C)=O)O)O,,,5,1,2,0,2
20159_1,,,,2,2,1,3
20160_0,,,,2,2,1,3
20161_0,,,,2,2,1,3
20161_1,,,,2,2,1,3
20162_0,,,,2,2,1,3
20163_0,,,,2,2,1,3
20163_1,,,,2,2,1,3
20164_0,,,,2,2,1,3
20164_1,,,,2,2,1,3
20165_0,,,,2,2,1,3
20166_0,,,,2,2,1,3
20166_1,,,,2,2,1,3
20168_0,,,,2,2,1,3
C(C(C=C)C(C=C)(C(C=O)O)O)=O,,,5,1,1,0,1
20170_0,,,,2,2,1,3
C(C(C(C=C)(C1C(C=CO1)=O)O)O)=O,,,5,1,2,0,2
20170_1,,,,2,2,1,3
20172_0,,,,2,2,1,3
C(C(C(C=C)(CC(C=O)=O)O)O)=O,,,5,1,1,0,1
20174_0,,,,2,2,1,3
C(C(C=O)C(C=C)(C(C=O)O)O)=O,,,5,1,2,0,2
20174_1,,,,2,2,1,3
20176_0,,,,2,2,1,3
C(CC(C=C)(C(C=O)O)O)=O,,,5,1,2,0,2
20178_0,,,,2,2,1,3
C(C(C(C=C)(C(C=O)CO)O)O)=O,,,5,1,2,0,2
20178_1,,,,2,2,1,3
20180_0,,,,2,2,1,3
C(C(C(C=C)(C(C(C)=O)O)O)O)=O,,,5,1,2,0,2
20180_1,,,,2,2,1,3
20182_0,,,,2,2,1,3
C(C(C(C=C)(CC(CO)=O)O)O)=O,,,5,1,1,0,1
20184_0,,,,2,2,1,3
C(C(C(C=C)(C(C=O)O)O)O)=O,,,5,1,3,0,3
20184_1,,,,2,2,1,3
20186_0,,,,2,2,1,3
C(CC(C(C(C=CCO)=O)O)O)=O,,,5,1,1,0,1
20188_0,,,,2,2,1,3
C(CC(C=CCO)(C(C=O)O)O)=O,,,5,1,1,0,1
20190_0,,,,2,2,1,3
C(C(C=C)C(C=CC)O)=O,,,5,1,1,0,1
20192_0,,,,2,2,1,3
C(C(C(CC(C=CC)O)=O)(C=C)O)=O,,,5,1,1,0,1
20194_0,,,,2,2,1,3
C(C(C(C(C=CC=O)=O)O)O)=CC,,,5,1,2,0,2
20194_1,,,,2,2,1,3
20196_0,,,,2,2,1,3
C1OC(C(C=1)=O)C(C=CC)O,,,5,1,2,0,2
20196_1,,,,2,2,1,3
20198_0,,,,2,2,1,3
C1(C(O)OC(C)C1C(C=CC)O)=O,,,5,1,2,0,2
20198_1,,,,2,2,1,3
20200_0,,,,2,2,1,3
C(C)=CC(C(C(C=O)=O)CCO)O,,,5,1,1,0,1
20202_0,,,,2,2,1,3
C(C(CCC(C=O)=O)C(C=CC)O)=O,,,5,1,1,0,1
20204_0,,,,2,2,1,3
C(CCC(C(C=O)=O)C(C=CC)O)=O,,,5,1,1,0,1
20206_0,,,,2,2,1,3
C(CO)(C(C(C=CC)O)O)=O,,,5,1,3,0,3
20206_1,,,,2,2,1,3
20208_0,,,,2,2,1,3
C(C(C(C=CC)O)O)(C(CO)O)=O,,,5,1,2,0,2
20208_1,,,,2,2,1,3
20210_0,,,,2,2,1,3
C(C(CC(C=O)=O)O)=CC,,,5,1,2,0,2
20212_0,,,,2,2,1,3
C(C(C=O)C(C=CC)O)=O,,,5,1,3,0,3
20212_1,,,,2,2,1,3
20214_0,,,,2,2,1,3
C(C)=CC(C(C(C=O)=O)CO)O,,,5,1,3,0,3
20214_1,,,,2,2,1,3
20216_0,,,,2,2,1,3
C(C(C(C=O)C(C=CC)O)O)=O,,,5,1,3,0,3
20216_1,,,,2,2,1,3
20218_0,,,,2,2,1,3
C(C(C(CO)=O)C(C=CC)O)=O,,,5,1,3,0,3
20218_1,,,,2,2,1,3
20220_0,,,,2,2,1,3
C(CC(C(C(C=CC)O)O)=O)=O,,,5,1,3,0,3
20220_1,,,,2,2,1,3
20222_0,,,,2,2,1,3
C(C(C(CC(C=CC)O)=O)O)=O,,,5,1,2,0,2
20224_0,,,,2,2,1,3
C(CC(C=CC)O)=O,,,5,1,2,0,2
20226_0,,,,2,2,1,3
C(C(C)(C(C=O)C(C=CC)O)O)=O,,,5,1,2,0,2
20226_1,,,,2,2,1,3
20228_0,,,,2,2,1,3
C(C(C(C(C)=O)O)C(C=CC)O)=O,,,5,1,2,0,2
20228_1,,,,2,2,1,3
20230_0,,,,2,2,1,3
C(CC(C(CC(C=CC)O)=O)O)=O,,,5,1,1,0,1
20232_0,,,,2,2,1,3
C(C)=CC(C(C(C=O)=O)C(C)O)O,,,5,1,2,0,2
20232_1,,,,2,2,1,3
20234_0,,,,2,2,1,3
C(CC(C(C=O)C(C=CC)O)O)=O,,,5,1,2,0,2
20234_1,,,,2,2,1,3
20236_0,,,,2,2,1,3
C(C(C(C)O)C(C=CC)O)=O,,,5,1,3,0,3
20236_1,,,,2,2,1,3
20238_0,,,,2,2,1,3
C(C(CO)C(C=CC)O)=O,,,5,1,3,0,3
20238_1,,,,2,2,1,3
20240_0,,,,2,2,1,3
C(C(C(CO)O)C(C=CC)O)=O,,,5,1,3,0,3
20240_1,,,,2,2,1,3
20242_0,,,,2,2,1,3
C(C(C(C(C=O)=O)O)O)=CC,,,5,1,3,0,3
20242_1,,,,2,2,1,3
20244_0,,,,2,2,1,3
C(C)=CC(C(C(C(C)=O)=O)O)O,,,5,1,3,0,3
20244_1,,,,2,2,1,3
20246_0,,,,2,2,1,3
C(C)=CC(CC(C(CO)=O)=O)O,,,5,1,2,0,2
20248_0,,,,2,2,1,3
C(C)(C(C(C=CC)O)O)=O,,,5,1,3,0,3
20248_1,,,,2,2,1,3
20250_0,,,,2,2,1,3
C(CO)(CC(C=CC)O)=O,,,5,1,2,0,2
20252_0,,,,2,2,1,3
C(C(C(C=CC)O)O)(CCO)=O,,,5,1,3,0,3
20252_1,,,,2,2,1,3
20254_0,,,,2,2,1,3
C(CO)(C(CO)C(C=CC)O)=O,,,5,1,3,0,3
20254_1,,,,2,2,1,3
20256_0,,,,2,2,1,3
C(CC(C=CC)O)(C(CO)O)=O,,,5,1,2,0,2
20258_0,,,,2,2,1,3
C(C(CC(C(O)=O)=O)O)=CC,,,5,1,2,0,2
20260_0,,,,2,2,1,3
C(C(C=O)C(C=CC)O)(O)=O,,,5,1,3,0,3
20260_1,,,,2,2,1,3
20262_0,,,,2,2,1,3
C(C)=CC(C(C(C(O)=O)=O)CO)O,,,5,1,2,0,2
20262_1,,,,2,2,1,3
20264_0,,,,2,2,1,3
C(C(C(C=O)C(C=CC)O)O)(O)=O,,,5,1,2,0,2
20264_1,,,,2,2,1,3
20266_0,,,,2,2,1,3
C(C(C(CO)=O)C(C=CC)O)(O)=O,,,5,1,2,0,2
20266_1,,,,2,2,1,3
20268_0,,,,2,2,1,3
C(CC(C(C(C=CC)O)O)=O)(O)=O,,,5,1,2,0,2
20268_1,,,,2,2,1,3
20270_0,,,,2,2,1,3
C(C(C(CC(C=CC)O)=O)O)(O)=O,,,5,1,1,0,1
20272_0,,,,2,2,1,3
C1(C(C(C=CC)O)OCC1O)=O,,,5,1,3,0,3
20272_1,,,,2,2,1,3
20274_0,,,,2,2,1,3
C1(C(O)OCC1C(C=CC)O)=O,,,5,1,3,0,3
20274_1,,,,2,2,1,3
20276_0,,,,2,2,1,3
C1(COC(C1C(C=CC)O)O)=O,,,5,1,3,0,3
20276_1,,,,2,2,1,3
20278_0,,,,2,2,1,3
C1(C(C(C=CC)O)OC(C1)O)=O,,,5,1,3,0,3
20278_1,,,,2,2,1,3
20280_0,,,,2,2,1,3
C(C(C(C=CC)O)O)=O,,,5,1,3,0,3
20280_1,,,,2,2,1,3
20282_0,,,,2,2,1,3
C(C(C=C)C(CC=C)O)=O,,,5,1,1,0,1
20284_0,,,,2,2,1,3
C(C(C(CC(CC=C)O)=O)(C=C)O)=O,,,5,1,1,0,1
20286_0,,,,2,2,1,3
C(CC(C(C(C=CC=O)=O)O)O)=C,,,5,1,2,0,2
20286_1,,,,2,2,1,3
20288_0,,,,2,2,1,3
C(CC(C1C(C=CO1)=O)O)=C,,,5,1,2,0,2
20288_1,,,,2,2,1,3
20290_0,,,,2,2,1,3
C1(C(O)OC(C)C1C(CC=C)O)=O,,,5,1,2,0,2
20290_1,,,,2,2,1,3
20292_0,,,,2,2,1,3
C=CCC(C(C(C=O)=O)CCO)O,,,5,1,1,0,1
20294_0,,,,2,2,1,3
C(C(CCC(C=O)=O)C(CC=C)O)=O,,,5,1,1,0,1
20296_0,,,,2,2,1,3
C(CCC(C(C=O)=O)C(CC=C)O)=O,,,5,1,1,0,1
20298_0,,,,2,2,1,3
C(CO)(C(C(CC=C)O)O)=O,,,5,1,3,0,3
20298_1,,,,2,2,1,3
20300_0,,,,2,2,1,3
C(C(C(CC=C)O)O)(C(CO)O)=O,,,5,1,2,0,2
20300_1,,,,2,2,1,3
20302_0,,,,2,2,1,3
C=CCC(CC(C=O)=O)O,,,5,1,2,0,2
20304_0,,,,2,2,1,3
C(C(C=O)C(CC=C)O)=O,,,5,1,3,0,3
20304_1,,,,2,2,1,3
20306_0,,,,2,2,1,3
C=CCC(C(C(C=O)=O)CO)O,,,5,1,3,0,3
20306_1,,,,2,2,1,3
20308_0,,,,2,2,1,3
C(C(C(CC=C)O)C(C=O)O)=O,,,5,1,3,0,3
20308_1,,,,2,2,1,3
20310_0,,,,2,2,1,3
C(C(C(CO)=O)C(CC=C)O)=O,,,5,1,3,0,3
20310_1,,,,2,2,1,3
20312_0,,,,2,2,1,3
C(CC(C(C(CC=C)O)O)=O)=O,,,5,1,3,0,3
20312_1,,,,2,2,1,3
20314_0,,,,2,2,1,3
C(C(C(CC(CC=C)O)=O)O)=O,,,5,1,2,0,2
20316_0,,,,2,2,1,3
C(CC(CC=C)O)=O,,,5,1,2,0,2
20318_0,,,,2,2,1,3
C(C(C(CC=C)O)C(C=O)(C)O)=O,,,5,1,2,0,2
20318_1,,,,2,2,1,3
20320_0,,,,2,2,1,3
C(C(C(CC=C)O)C(C(C)=O)O)=O,,,5,1,2,0,2
20320_1,,,,2,2,1,3
20322_0,,,,2,2,1,3
C(CC(C(CC(CC=C)O)=O)O)=O,,,5,1,1,0,1
20324_0,,,,2,2,1,3
C=CCC(C(C(C=O)=O)C(C)O)O,,,5,1,2,0,2
20324_1,,,,2,2,1,3
20326_0,,,,2,2,1,3
C(C(C(CC=C)O)C(CC=O)O)=O,,,5,1,2,0,2
20326_1,,,,2,2,1,3
20328_0,,,,2,2,1,3
C(C(C(CC=C)O)C(C)O)=O,,,5,1,3,0,3
20328_1,,,,2,2,1,3
20330_0,,,,2,2,1,3
C(C(CO)C(CC=C)O)=O,,,5,1,3,0,3
20330_1,,,,2,2,1,3
20332_0,,,,2,2,1,3
C(C(C(CC=C)O)C(CO)O)=O,,,5,1,3,0,3
20332_1,,,,2,2,1,3
20334_0,,,,2,2,1,3
C(CC(C(C(C=O)=O)O)O)=C,,,5,1,3,0,3
20334_1,,,,2,2,1,3
20336_0,,,,2,2,1,3
C(CC(C(C(C(C)=O)=O)O)O)=C,,,5,1,3,0,3
20336_1,,,,2,2,1,3
20338_0,,,,2,2,1,3
C(CC(CC(C(CO)=O)=O)O)=C,,,5,1,2,0,2
20340_0,,,,2,2,1,3
C(C)(C(C(CC=C)O)O)=O,,,5,1,3,0,3
20340_1,,,,2,2,1,3
20342_0,,,,2,2,1,3
C(CO)(CC(CC=C)O)=O,,,5,1,2,0,2
20344_0,,,,2,2,1,3
C(C(C(CC=C)O)O)(CCO)=O,,,5,1,3,0,3
20344_1,,,,2,2,1,3
20346_0,,,,2,2,1,3
C(CO)(C(CO)C(CC=C)O)=O,,,5,1,3,0,3
20346_1,,,,2,2,1,3
20348_0,,,,2,2,1,3
C(C(CO)O)(CC(CC=C)O)=O,,,5,1,2,0,2
20350_0,,,,2,2,1,3
C=CCC(CC(C(O)=O)=O)O,,,5,1,2,0,2
20352_0,,,,2,2,1,3
C(C(C=O)C(CC=C)O)(O)=O,,,5,1,3,0,3
20352_1,,,,2,2,1,3
20354_0,,,,2,2,1,3
C=CCC(C(C(C(O)=O)=O)CO)O,,,5,1,2,0,2
20354_1,,,,2,2,1,3
20356_0,,,,2,2,1,3
C(C(C(CC=C)O)C(C(O)=O)O)=O,,,5,1,2,0,2
20356_1,,,,2,2,1,3
20358_0,,,,2,2,1,3
C(C(C(CO)=O)C(CC=C)O)(O)=O,,,5,1,2,0,2
20358_1,,,,2,2,1,3
20360_0,,,,2,2,1,3
C(CC(C(C(CC=C)O)O)=O)(O)=O,,,5,1,2,0,2
20360_1,,,,2,2,1,3
20362_0,,,,2,2,1,3
C(C(C(CC(CC=C)O)=O)O)(O)=O,,,5,1,1,0,1
20364_0,,,,2,2,1,3
C1(C(C(CC=C)O)OCC1O)=O,,,5,1,3,0,3
20364_1,,,,2,2,1,3
20366_0,,,,2,2,1,3
C1(C(O)OCC1C(CC=C)O)=O,,,5,1,3,0,3
20366_1,,,,2,2,1,3
20368_0,,,,2,2,1,3
C1(COC(C1C(CC=C)O)O)=O,,,5,1,3,0,3
20368_1,,,,2,2,1,3
20370_0,,,,2,2,1,3
C1(C(C(CC=C)O)OC(C1)O)=O,,,5,1,3,0,3
20370_1,,,,2,2,1,3
20372_0,,,,2,2,1,3
C(C(C(CC=C)O)O)=O,,,5,1,3,0,3
20372_1,,,,2,2,1,3
20374_0,,,,2,2,1,3
C(C(C=C)C(C(C=C)O)O)=O,,,5,1,1,0,1
20376_0,,,,2,2,1,3
C(C(C=C)C(C=CC(CO)O)O)=O,,,5,1,1,0,1
20378_0,,,,2,2,1,3
C(C(C=C)C(C=C)O)=O,,,5,1,1,0,1
20380_0,,,,2,2,1,3
C(C(C=C)C(C(C(C)=O)(C=C)O)O)=O,,,5,1,1,0,1
20382_0,,,,2,2,1,3
C(C(C=C)C(C)(C(C=O)(C=C)O)O)=O,,,5,1,1,0,1
20384_0,,,,2,2,1,3
C(C(C=C)C(C(C=C)(CO)O)O)=O,,,5,1,1,0,1
20386_0,,,,2,2,1,3
C(C(C=C)C(C=CC(CO)=O)O)=O,,,5,1,1,0,1
20388_0,,,,2,2,1,3
C(C(C=C)C(C=CC=O)(CO)O)=O,,,5,1,1,0,1
20390_0,,,,2,2,1,3
C(C(C=C)C1(C=COC1)O)=O,,,5,1,1,0,1
20392_0,,,,2,2,1,3
C(C(C=C)C1(C(O)OC(C)C1)O)=O,,,5,1,1,0,1
20394_0,,,,2,2,1,3
C(C(C=C)C1(C(O)OCC1O)O)=O,,,5,1,1,0,1
20396_0,,,,2,2,1,3
C(C(C=C)C(C=O)(CCCO)O)=O,,,5,1,1,0,1
20398_0,,,,2,2,1,3
C(C(C=C)C(C(CCCO)=O)O)=O,,,5,1,1,0,1
20400_0,,,,2,2,1,3
C(C(C=C)C(CCCC(C=O)=O)O)=O,,,5,1,1,0,1
20402_0,,,,2,2,1,3
C(CCCC(C=O)(C(C=O)C=C)O)=O,,,5,1,1,0,1
20404_0,,,,2,2,1,3
C(CCCC(C(C(C=O)C=C)O)=O)=O,,,5,1,1,0,1
20406_0,,,,2,2,1,3
C(C(C=C)C(C(CO)O)O)=O,,,5,1,2,0,2
20408_0,,,,2,2,1,3
C(C(C=C)C(C(C(CO)O)O)O)=O,,,5,1,1,0,1
20409_0,,,,2,2,1,3
20411_0,,,,2,2,1,3
C(C(C=C)C(CO)(CO)O)=O,,,5,1,2,0,2
20413_0,,,,2,2,1,3
C(C(C=C)C(CO)(C(CO)O)O)=O,,,5,1,1,0,1
20415_0,,,,2,2,1,3
C(C(C=C)C(C(CO)(CO)O)O)=O,,,5,1,1,0,1
20417_0,,,,2,2,1,3
C(C(C=C)C(C=O)(C)O)=O,,,5,1,2,0,2
20419_0,,,,2,2,1,3
C(C(C=C)C(C(C)=O)O)=O,,,5,1,2,0,2
20420_0,,,,2,2,1,3
20422_0,,,,2,2,1,3
C(C(C=C)C(C=O)(CCO)O)=O,,,5,1,2,0,2
20424_0,,,,2,2,1,3
C(C(C=C)C(C(CCO)=O)O)=O,,,5,1,2,0,2
20425_0,,,,2,2,1,3
20427_0,,,,2,2,1,3
C(C(C=C)C(CC(C=O)O)O)=O,,,5,1,2,0,2
20428_0,,,,2,2,1,3
20429_0,,,,2,2,1,3
20430_0,,,,2,2,1,3
20432_0,,,,2,2,1,3
C(C(C=C)C(C)(C(C=O)O)O)=O,,,5,1,2,0,2
20434_0,,,,2,2,1,3
C(C(C=C)C(C)O)=O,,,5,1,2,0,2
20435_0,,,,2,2,1,3
20437_0,,,,2,2,1,3
C(C(C=C)C(CC(C=O)(C)O)O)=O,,,5,1,1,0,1
20439_0,,,,2,2,1,3
C(C(C=C)C(C(C)(CC=O)O)O)=O,,,5,1,1,0,1
20441_0,,,,2,2,1,3
C(C(C=C)C(CC(C(C)=O)O)O)=O,,,5,1,1,0,1
20443_0,,,,2,2,1,3
C(C(C=C)C(C)(C(CC=O)O)O)=O,,,5,1,1,0,1
20445_0,,,,2,2,1,3
C(C(C=C)C(C=O)(CC(C)O)O)=O,,,5,1,1,0,1
20447_0,,,,2,2,1,3
C(C(C=C)C(C(CC(C)O)=O)O)=O,,,5,1,1,0,1
20449_0,,,,2,2,1,3
C(C(C=C)C(CC(CC=O)O)O)=O,,,5,1,1,0,1
20450_0,,,,2,2,1,3
20451_0,,,,2,2,1,3
20453_0,,,,2,2,1,3
C(C(C=C)C(CC(C)O)O)=O,,,5,1,2,0,2
20455_0,,,,2,2,1,3
C(C(C=C)C(C(C(C)O)O)O)=O,,,5,1,2,0,2
20457_0,,,,2,2,1,3
C(C(C=C)C(CCO)O)=O,,,5,1,2,0,2
20459_0,,,,2,2,1,3
C(C(C=C)C(CC(CO)O)O)=O,,,5,1,2,0,2
20461_0,,,,2,2,1,3
C(C(C=C)C(C=O)(CO)O)=O,,,5,1,3,0,3
20463_0,,,,2,2,1,3
C(C(C=C)C(C(CO)=O)O)=O,,,5,1,2,0,2
20465_0,,,,2,2,1,3
C(C(C=C)C(C=O)(C(CO)O)O)=O,,,5,1,2,0,2
20467_0,,,,2,2,1,3
C(C(C=C)C(C(C(CO)O)=O)O)=O,,,5,1,1,0,1
20469_0,,,,2,2,1,3
C(C(C=C)C(C(C)=O)(CO)O)=O,,,5,1,2,0,2
20471_0,,,,2,2,1,3
C(C(C=C)C(C(CO)=O)(C)O)=O,,,5,1,2,0,2
20473_0,,,,2,2,1,3
C(C(C=C)C(C=O)(C(C)O)O)=O,,,5,1,3,0,3
20475_0,,,,2,2,1,3
C(C(C=C)C(C(C(C)O)=O)O)=O,,,5,1,2,0,2
20477_0,,,,2,2,1,3
C(C(C=C)C(C)(CO)O)=O,,,5,1,2,0,2
20479_0,,,,2,2,1,3
C(C(C=C)C(CO)(CCO)O)=O,,,5,1,2,0,2
20481_0,,,,2,2,1,3
C(C(C=C)C(C(CCO)O)O)=O,,,5,1,2,0,2
20483_0,,,,2,2,1,3
C(C(C=C)C(C)(C(CO)O)O)=O,,,5,1,2,0,2
20485_0,,,,2,2,1,3
C(C(C=C)C(C(O)=O)O)=O,,,5,1,3,0,3
20487_0,,,,2,2,1,3
C(C(C=C)C(C(O)=O)(C)O)=O,,,5,1,2,0,2
20489_0,,,,2,2,1,3
C(C(C=C)C(CC(O)=O)O)=O,,,5,1,2,0,2
20491_0,,,,2,2,1,3
C(C(C=C)C(C(O)=O)(CCO)O)=O,,,5,1,1,0,1
20493_0,,,,2,2,1,3
C(C(C=C)C(CC(C(O)=O)O)O)=O,,,5,1,1,0,1
20495_0,,,,2,2,1,3
C(C(C=C)C(C(CC(O)=O)O)O)=O,,,5,1,1,0,1
20497_0,,,,2,2,1,3
C(C(C=C)C(CO)(CC(O)=O)O)=O,,,5,1,1,0,1
20499_0,,,,2,2,1,3
C(C(C=C)C(C)(C(C(O)=O)O)O)=O,,,5,1,1,0,1
20501_0,,,,2,2,1,3
C(C(C=C)C1(COCC1O)O)=O,,,5,1,2,0,2
20503_0,,,,2,2,1,3
C(C(C=C)C1(C(O)OCC1)O)=O,,,5,1,2,0,2
20505_0,,,,2,2,1,3
C(C(C=C)C1(COC(C1)O)O)=O,,,5,1,2,0,2
20507_0,,,,2,2,1,3
C(C(C=C)C(C=O)(C=C)O)=O,,,5,1,2,0,2
20509_0,,,,2,2,1,3
C(C(C=C)C(C(C=C)=O)O)=O,,,5,1,2,0,2
20511_0,,,,2,2,1,3
C(C(C=C)C(C=CC=O)O)=O,,,5,1,2,0,2
20513_0,,,,2,2,1,3
C(C(C=C)CO)=O,,,5,1,3,0,3
20515_0,,,,2,2,1,3
C(C(C=C)C(CO)O)=O,,,5,1,3,0,3
20517_0,,,,2,2,1,3
C(C(C(C1C(C=CO1)=O)O)O)=C,,,5,1,2,0,2
20517_1,,,,2,2,1,3
20519_0,,,,2,2,1,3
C(CO)(C(C(C(C=C)O)O)O)=O,,,5,1,4,0,4
20519_1,,,,2,2,1,3
20521_0,,,,2,2,1,3
C=CC(C(CC(C=O)=O)O)O,,,5,1,3,0,3
20523_0,,,,2,2,1,3
C(C(C=O)C(C(C=C)O)O)=O,,,5,1,4,0,4
20523_1,,,,2,2,1,3
20525_0,,,,2,2,1,3
C=CC(C(C(C(C=O)=O)CO)O)O,,,5,1,2,0,2
20525_1,,,,2,2,1,3
20527_0,,,,2,2,1,3
C(C(C(C(C=C)O)O)C(C=O)O)=O,,,5,1,2,0,2
20527_1,,,,2,2,1,3
20529_0,,,,2,2,1,3
C(C(C(CO)=O)C(C(C=C)O)O)=O,,,5,1,2,0,2
20529_1,,,,2,2,1,3
20531_0,,,,2,2,1,3
C(CC(C(C(C(C=C)O)O)O)=O)=O,,,5,1,2,0,2
20531_1,,,,2,2,1,3
20533_0,,,,2,2,1,3
C(CC(C(C=C)O)O)(C(C=O)O)=O,,,5,1,1,0,1
20535_0,,,,2,2,1,3
C(CC(C(C=C)O)O)=O,,,5,1,3,0,3
20537_0,,,,2,2,1,3
C(C(C(C(C=C)O)O)C(C)O)=O,,,5,1,4,0,4
20537_1,,,,2,2,1,3
20539_0,,,,2,2,1,3
C(C(CO)C(C(C=C)O)O)=O,,,5,1,4,0,4
20539_1,,,,2,2,1,3
20541_0,,,,2,2,1,3
C(C(C(C(C=C)O)O)C(CO)O)=O,,,5,1,2,0,2
20541_1,,,,2,2,1,3
20543_0,,,,2,2,1,3
C=CC(C(C(C(C=O)=O)O)O)O,,,5,1,4,0,4
20543_1,,,,2,2,1,3
20545_0,,,,2,2,1,3
C(C(C(C(C(C(C)=O)=O)O)O)O)=C,,,5,1,2,0,2
20545_1,,,,2,2,1,3
20547_0,,,,2,2,1,3
C(C(C(CC(C(CO)=O)=O)O)O)=C,,,5,1,1,0,1
20549_0,,,,2,2,1,3
C(C)(C(C(C(C=C)O)O)O)=O,,,5,1,4,0,4
20549_1,,,,2,2,1,3
20551_0,,,,2,2,1,3
C(CO)(CC(C(C=C)O)O)=O,,,5,1,3,0,3
20553_0,,,,2,2,1,3
C(C(C(C(C=C)O)O)O)(CCO)=O,,,5,1,2,0,2
20553_1,,,,2,2,1,3
20555_0,,,,2,2,1,3
C(CO)(C(CO)C(C(C=C)O)O)=O,,,5,1,2,0,2
20555_1,,,,2,2,1,3
20557_0,,,,2,2,1,3
C(C(CO)O)(CC(C(C=C)O)O)=O,,,5,1,1,0,1
20559_0,,,,2,2,1,3
C=CC(C(CC(C(O)=O)=O)O)O,,,5,1,3,0,3
20561_0,,,,2,2,1,3
C(C(C=O)C(C(C=C)O)O)(O)=O,,,5,1,4,0,4
20561_1,,,,2,2,1,3
20563_0,,,,2,2,1,3
C1(C(C(C(C=C)O)O)OCC1O)=O,,,5,1,2,0,2
20563_1,,,,2,2,1,3
20565_0,,,,2,2,1,3
C1(C(O)OCC1C(C(C=C)O)O)=O,,,5,1,2,0,2
20565_1,,,,2,2,1,3
20567_0,,,,2,2,1,3
C1(COC(C1C(C(C=C)O)O)O)=O,,,5,1,2,0,2
20567_1,,,,2,2,1,3
20569_0,,,,2,2,1,3
C1(C(C(C(C=C)O)O)OC(C1)O)=O,,,5,1,2,0,2
20569_1,,,,2,2,1,3
20571_0,,,,2,2,1,3
C(C(C(C(C=C)O)O)O)=O,,,5,1,6,0,6
20571_1,,,,2,2,1,3
20573_0,,,,2,2,1,3
C(C(CO)O)=CC(CC(C=O)=O)O,,,5,1,1,0,1
20575_0,,,,2,2,1,3
C(C(C=O)C(C=CC(CO)O)O)=O,,,5,1,2,0,2
20575_1,,,,2,2,1,3
20577_0,,,,2,2,1,3
C(CC(C=CC(CO)O)O)=O,,,5,1,2,0,2
20579_0,,,,2,2,1,3
C(C(CO)C(C=CC(CO)O)O)=O,,,5,1,2,0,2
20579_1,,,,2,2,1,3
20581_0,,,,2,2,1,3
C(C(C(C=CC(CO)O)O)O)(C)=O,,,5,1,2,0,2
20581_1,,,,2,2,1,3
20583_0,,,,2,2,1,3
C(CC(C=CC(CO)O)O)(CO)=O,,,5,1,1,0,1
20585_0,,,,2,2,1,3
C(C(C(C=CC(CO)O)O)O)=O,,,5,1,3,0,3
20585_1,,,,2,2,1,3
20587_0,,,,2,2,1,3
C(CC(C=CC(C(CO)O)O)O)=O,,,5,1,1,0,1
20589_0,,,,2,2,1,3
C(C(C(CC(C=C)O)=O)(C=C)O)=O,,,5,1,1,0,1
20591_0,,,,2,2,1,3
C=CC(C(C(C=CC=O)=O)O)O,,,5,1,2,0,2
20591_1,,,,2,2,1,3
20593_0,,,,2,2,1,3
C=CC(C(C(C=CC(O)=O)=O)O)O,,,5,1,2,0,2
20593_1,,,,2,2,1,3
20595_0,,,,2,2,1,3
C=CC(C1C(C=CO1)=O)O,,,5,1,2,0,2
20595_1,,,,2,2,1,3
20597_0,,,,2,2,1,3
C(C1C(C(C(O)O1)=O)C(C=C)O)=O,,,5,1,2,0,2
20597_1,,,,2,2,1,3
20599_0,,,,2,2,1,3
C1(C(O)OC(C)C1C(C=C)O)=O,,,5,1,2,0,2
20599_1,,,,2,2,1,3
20601_0,,,,2,2,1,3
C=CC(C(C(C=O)=O)CC(C)O)O,,,5,1,1,0,1
20603_0,,,,2,2,1,3
C(C(C(C)O)C(C=O)C(C=C)O)=O,,,5,1,1,0,1
20605_0,,,,2,2,1,3
C=CC(C(C(C=O)=O)CCCO)O,,,5,1,1,0,1
20607_0,,,,2,2,1,3
C(C(CCO)C(C=O)C(C=C)O)=O,,,5,1,1,0,1
20609_0,,,,2,2,1,3
C=CC(C(C(C=O)=O)CCO)O,,,5,1,1,0,1
20611_0,,,,2,2,1,3
C(C(CCC(C=O)=O)C(C=C)O)=O,,,5,1,1,0,1
20613_0,,,,2,2,1,3
C(CCC(C(C=O)=O)C(C=C)O)=O,,,5,1,1,0,1
20615_0,,,,2,2,1,3
C(CO)(C(C(C=C)O)O)=O,,,5,1,5,0,5
20615_1,,,,2,2,1,3
20617_0,,,,2,2,1,3
C(C(C(C=C)O)O)(C(CO)O)=O,,,5,1,3,0,3
20617_1,,,,2,2,1,3
20619_0,,,,2,2,1,3
C=CC(CC(C=O)=O)O,,,5,1,2,0,2
20621_0,,,,2,2,1,3
C(C(C=O)C(C=C)O)=O,,,5,1,3,0,3
20621_1,,,,2,2,1,3
20623_0,,,,2,2,1,3
C=CC(C(C(C=O)=O)CO)O,,,5,1,3,0,3
20623_1,,,,2,2,1,3
20625_0,,,,2,2,1,3
C(C(C(C=O)C(C=C)O)O)=O,,,5,1,3,0,3
20625_1,,,,2,2,1,3
20627_0,,,,2,2,1,3
C(C(C(CO)=O)C(C=C)O)=O,,,5,1,3,0,3
20627_1,,,,2,2,1,3
20629_0,,,,2,2,1,3
C(CC(C(C(C=C)O)O)=O)=O,,,5,1,3,0,3
20629_1,,,,2,2,1,3
20631_0,,,,2,2,1,3
C(C(C(CC(C=C)O)=O)O)=O,,,5,1,2,0,2
20633_0,,,,2,2,1,3
C(CC(C=C)O)=O,,,5,1,2,0,2
20635_0,,,,2,2,1,3
C(C(C(C(C=O)=O)C(C=C)O)O)=O,,,5,1,2,0,2
20635_1,,,,2,2,1,3
20637_0,,,,2,2,1,3
C(C(C(CO)(CO)O)C(C=C)O)=O,,,5,1,2,0,2
20637_1,,,,2,2,1,3
20639_0,,,,2,2,1,3
C(C(C(C=C)O)O)(C(C(C)O)O)=O,,,5,1,2,0,2
20639_1,,,,2,2,1,3
20641_0,,,,2,2,1,3
C(C(C)(C(C=O)C(C=C)O)O)=O,,,5,1,3,0,3
20641_1,,,,2,2,1,3
20643_0,,,,2,2,1,3
C(C(C(C=C)O)C(C(C)=O)O)=O,,,5,1,3,0,3
20643_1,,,,2,2,1,3
20645_0,,,,2,2,1,3
C(CC(C(CC(C=C)O)=O)O)=O,,,5,1,2,0,2
20647_0,,,,2,2,1,3
C(C(C(C(CC(C=C)O)=O)O)O)=O,,,5,1,1,0,1
20649_0,,,,2,2,1,3
C=CC(C(C(C=O)=O)C(C)O)O,,,5,1,3,0,3
20649_1,,,,2,2,1,3
20651_0,,,,2,2,1,3
C=CC(C(C(C=O)=O)C(CO)O)O,,,5,1,2,0,2
20651_1,,,,2,2,1,3
20653_0,,,,2,2,1,3
C(CC(C(C=O)C(C=C)O)O)=O,,,5,1,3,0,3
20653_1,,,,2,2,1,3
20655_0,,,,2,2,1,3
C(C(C(C(C=O)C(C=C)O)O)O)=O,,,5,1,2,0,2
20655_1,,,,2,2,1,3
20657_0,,,,2,2,1,3
C(C(C(C(C(C=C)O)O)=O)CO)=O,,,5,1,2,0,2
20657_1,,,,2,2,1,3
20659_0,,,,2,2,1,3
C(C(CO)O)(C(C=O)C(C=C)O)=O,,,5,1,2,0,2
20659_1,,,,2,2,1,3
20661_0,,,,2,2,1,3
C(C(CO)C(C=C)O)(C(C=O)O)=O,,,5,1,2,0,2
20661_1,,,,2,2,1,3
20663_0,,,,2,2,1,3
C(C(C(C)O)C(C=C)O)=O,,,5,1,3,0,3
20663_1,,,,2,2,1,3
20665_0,,,,2,2,1,3
C(C(C(C(CO)O)O)C(C=C)O)=O,,,5,1,2,0,2
20665_1,,,,2,2,1,3
20667_0,,,,2,2,1,3
C(C(CO)C(C=C)O)=O,,,5,1,3,0,3
20667_1,,,,2,2,1,3
20669_0,,,,2,2,1,3
C(C(C(CO)O)C(C=C)O)=O,,,5,1,3,0,3
20669_1,,,,2,2,1,3
20671_0,,,,2,2,1,3
C=CC(C(C(C=O)=O)O)O,,,5,1,3,0,3
20671_1,,,,2,2,1,3
20673_0,,,,2,2,1,3
C=CC(C(C(C(C)=O)=O)O)O,,,5,1,3,0,3
20673_1,,,,2,2,1,3
20675_0,,,,2,2,1,3
C=CC(CC(C(CO)=O)=O)O,,,5,1,2,0,2
20677_0,,,,2,2,1,3
C(C)(C(C(C=C)O)O)=O,,,5,1,3,0,3
20677_1,,,,2,2,1,3
20679_0,,,,2,2,1,3
C(CO)(CC(C=C)O)=O,,,5,1,2,0,2
20681_0,,,,2,2,1,3
C(C(C(C=C)O)O)(CCO)=O,,,5,1,3,0,3
20681_1,,,,2,2,1,3
20683_0,,,,2,2,1,3
C(CO)(C(CO)C(C=C)O)=O,,,5,1,3,0,3
20683_1,,,,2,2,1,3
20685_0,,,,2,2,1,3
C(CC(C=C)O)(C(CO)O)=O,,,5,1,2,0,2
20687_0,,,,2,2,1,3
C=CC(CC(C(O)=O)=O)O,,,5,1,2,0,2
20689_0,,,,2,2,1,3
C(C(C=O)C(C=C)O)(O)=O,,,5,1,3,0,3
20689_1,,,,2,2,1,3
20691_0,,,,2,2,1,3
C=CC(C(C(C(O)=O)=O)CO)O,,,5,1,3,0,3
20691_1,,,,2,2,1,3
20693_0,,,,2,2,1,3
C(C(C(C=O)C(C=C)O)O)(O)=O,,,5,1,3,0,3
20693_1,,,,2,2,1,3
20695_0,,,,2,2,1,3
C(C(C(CO)=O)C(C=C)O)(O)=O,,,5,1,3,0,3
20695_1,,,,2,2,1,3
20697_0,,,,2,2,1,3
C(CC(C(C(C=C)O)O)=O)(O)=O,,,5,1,3,0,3
20697_1,,,,2,2,1,3
20699_0,,,,2,2,1,3
C(C(C(CC(C=C)O)=O)O)(O)=O,,,5,1,2,0,2
20701_0,,,,2,2,1,3
C(CC(C=C)O)(C(C=O)(CO)O)=O,,,5,1,1,0,1
20703_0,,,,2,2,1,3
C(C(CO)(C(C=O)C(C=C)O)O)=O,,,5,1,2,0,2
20703_1,,,,2,2,1,3
20705_0,,,,2,2,1,3
C(C(C(C(CO)=O)C(C=C)O)O)=O,,,5,1,2,0,2
20705_1,,,,2,2,1,3
20707_0,,,,2,2,1,3
C(C(CC(C(C(C=C)O)O)=O)O)=O,,,5,1,2,0,2
20707_1,,,,2,2,1,3
20709_0,,,,2,2,1,3
C1(C(C(C=C)O)OCC1O)=O,,,5,1,3,0,3
20709_1,,,,2,2,1,3
20711_0,,,,2,2,1,3
C1(C(O)OCC1C(C=C)O)=O,,,5,1,3,0,3
20711_1,,,,2,2,1,3
20713_0,,,,2,2,1,3
C1(COC(C1C(C=C)O)O)=O,,,5,1,3,0,3
20713_1,,,,2,2,1,3
20715_0,,,,2,2,1,3
C1(C(C(C=C)O)OC(C1)O)=O,,,5,1,3,0,3
20715_1,,,,2,2,1,3
20717_0,,,,2,2,1,3
C(C(C(C=C)O)O)=O,,,5,1,6,0,6
20717_1,,,,2,2,1,3
20719_0,,,,2,2,1,3
C(CC(CO)(C(C=C)(CO)O)O)=O,,,5,1,1,0,1
20721_0,,,,2,2,1,3
C(C(C(C)O)O)(C(C=C)(CO)O)=O,,,5,1,2,0,2
20721_1,,,,2,2,1,3
20723_0,,,,2,2,1,3
C(C(CO)O)(C(C=C)(CO)O)=O,,,5,1,4,0,4
20723_1,,,,2,2,1,3
20725_0,,,,2,2,1,3
C(C(C(CCO)=O)(C(C=O)=C)O)=O,,,5,1,1,0,1
20727_0,,,,2,2,1,3
C(CC(C(C(C=O)=C)(CO)O)O)=O,,,5,1,1,0,1
20729_0,,,,2,2,1,3
C(CC(C(C(C=O)(CO)O)=C)O)=O,,,5,1,1,0,1
20731_0,,,,2,2,1,3
C(C(C(CCO)=O)(C=CC=O)O)=O,,,5,1,1,0,1
20733_0,,,,2,2,1,3
C(CC(C(C=CC=O)(CO)O)O)=O,,,5,1,1,0,1
20735_0,,,,2,2,1,3
C(CC(C=CC(C=O)(CO)O)O)=O,,,5,1,1,0,1
20737_0,,,,2,2,1,3
C(CC(C(C(C)=O)(C=C)O)O)=O,,,5,1,2,0,2
20739_0,,,,2,2,1,3
C(C(C(C(C(C)=O)(C=C)O)O)O)=O,,,5,1,2,0,2
20739_1,,,,2,2,1,3
20741_0,,,,2,2,1,3
C(C(C=C)(C(C)(CC=O)O)O)=O,,,5,1,3,0,3
20743_0,,,,2,2,1,3
C(C(C=C)(C(C)(C(C=O)O)O)O)=O,,,5,1,3,0,3
20743_1,,,,2,2,1,3
20745_0,,,,2,2,1,3
C(C(C(CC(C=O)O)=O)(C=C)O)=O,,,5,1,1,0,1
20747_0,,,,2,2,1,3
C(C(C(CC(C)O)=O)(C=C)O)=O,,,5,1,2,0,2
20749_0,,,,2,2,1,3
C(C(C(CCO)=O)(C=C)O)=O,,,5,1,3,0,3
20751_0,,,,2,2,1,3
C(C(C(CC(CO)O)=O)(C=C)O)=O,,,5,1,1,0,1
20753_0,,,,2,2,1,3
C(C(CO)(C(CC(C=O)=O)O)O)=C,,,5,1,1,0,1
20755_0,,,,2,2,1,3
C(C(C=O)C(C(C=C)(CO)O)O)=O,,,5,1,2,0,2
20755_1,,,,2,2,1,3
20757_0,,,,2,2,1,3
C(CC(C(C=C)(CO)O)O)=O,,,5,1,2,0,2
20759_0,,,,2,2,1,3
C(C(CO)C(C(C=C)(CO)O)O)=O,,,5,1,2,0,2
20759_1,,,,2,2,1,3
20761_0,,,,2,2,1,3
C(C)(C(C(C(C=C)(CO)O)O)O)=O,,,5,1,2,0,2
20761_1,,,,2,2,1,3
20763_0,,,,2,2,1,3
C(CO)(CC(C(C=C)(CO)O)O)=O,,,5,1,1,0,1
20765_0,,,,2,2,1,3
C(C(C(C(C=C)(CO)O)O)O)=O,,,5,1,3,0,3
20765_1,,,,2,2,1,3
20767_0,,,,2,2,1,3
C(CC(C(C=C)(C(CO)O)O)O)=O,,,5,1,1,0,1
20769_0,,,,2,2,1,3
C(C(C(C=O)=C)(C(C=O)CO)O)=O,,,5,1,2,0,2
20769_1,,,,2,2,1,3
20771_0,,,,2,2,1,3
C(C(C(C(CC=O)O)=C)O)(O)=O,,,5,1,5,0,5
20773_0,,,,2,2,1,3
C(C(C(C(C(C=O)O)O)=C)O)(O)=O,,,5,1,2,0,2
20773_1,,,,2,2,1,3
20774_0,,,,2,2,1,3
20774_1,,,,2,2,1,3
20776_0,,,,2,2,1,3
C(C(C=CC(CC=O)O)O)(O)=O,,,5,1,5,0,5
20778_0,,,,2,2,1,3
C(C(C=CC(C(C=O)O)O)O)(O)=O,,,5,1,2,0,2
20778_1,,,,2,2,1,3
20780_0,,,,2,2,1,3
C(C(C=CC(C(CO)O)=O)O)(O)=O,,,5,1,2,0,2
20780_1,,,,2,2,1,3
20782_0,,,,2,2,1,3
C1OC(C(C=1)=O)C(C=CC(CO)=O)O,,,5,1,2,0,2
20782_1,,,,2,2,1,3
20784_0,,,,2,2,1,3
C(C(CC(C=O)=O)O)=CC(CO)=O,,,5,1,1,0,1
20786_0,,,,2,2,1,3
C(C(C=O)C(C=CC(CO)=O)O)=O,,,5,1,2,0,2
20786_1,,,,2,2,1,3
20788_0,,,,2,2,1,3
C(CC(C=CC(CO)=O)O)=O,,,5,1,3,0,3
20790_0,,,,2,2,1,3
C(C(CO)C(C=CC(CO)=O)O)=O,,,5,1,2,0,2
20790_1,,,,2,2,1,3
20792_0,,,,2,2,1,3
C(C)(C(C(C=CC(CO)=O)O)O)=O,,,5,1,2,0,2
20792_1,,,,2,2,1,3
20794_0,,,,2,2,1,3
C(CO)(CC(C=CC(CO)=O)O)=O,,,5,1,1,0,1
20796_0,,,,2,2,1,3
C(C(C(C=CC(CO)=O)O)O)=O,,,5,1,5,0,5
20796_1,,,,2,2,1,3
20798_0,,,,2,2,1,3
C(C(CO)(C1C(C=CO1)=O)O)=CC=O,,,5,1,2,0,2
20798_1,,,,2,2,1,3
20800_0,,,,2,2,1,3
C(C(CO)(CC(C=O)=O)O)=CC=O,,,5,1,1,0,1
20802_0,,,,2,2,1,3
C(C(C=O)C(C=CC=O)(CO)O)=O,,,5,1,2,0,2
20802_1,,,,2,2,1,3
20804_0,,,,2,2,1,3
C(CC(C=CC=O)(CO)O)=O,,,5,1,5,0,5
20806_0,,,,2,2,1,3
C(C(CO)C(C=CC=O)(CO)O)=O,,,5,1,2,0,2
20806_1,,,,2,2,1,3
20808_0,,,,2,2,1,3
C(C(C(C=CC=O)(CO)O)O)(C)=O,,,5,1,2,0,2
20808_1,,,,2,2,1,3
20810_0,,,,2,2,1,3
C(CC(C=CC=O)(CO)O)(CO)=O,,,5,1,1,0,1
20812_0,,,,2,2,1,3
C(C(C(C=CC=O)(CO)O)O)=O,,,5,1,7,0,7
20812_1,,,,2,2,1,3
20814_0,,,,2,2,1,3
C1C(COC=1)(C(C(C=CC=O)=O)O)O,,,5,1,2,0,2
20814_1,,,,2,2,1,3
20815_0,,,,2,2,1,3
20815_1,,,,2,2,1,3
20817_0,,,,2,2,1,3
C(C(C)(C(C(C=CC=O)=O)O)O)=O,,,5,1,3,0,3
20817_1,,,,2,2,1,3
20818_0,,,,2,2,1,3
20818_1,,,,2,2,1,3
20819_0,,,,2,2,1,3
20819_1,,,,2,2,1,3
20821_0,,,,2,2,1,3
C(C=CC(C(C(C)O)O)=O)=O,,,5,1,3,0,3
20821_1,,,,2,2,1,3
20823_0,,,,2,2,1,3
C(C=CC(C(C(CCO)O)O)=O)=O,,,5,1,2,0,2
20823_1,,,,2,2,1,3
20825_0,,,,2,2,1,3
C(C=CC(C(C(CO)(C)O)O)=O)=O,,,5,1,2,0,2
20825_1,,,,2,2,1,3
20827_0,,,,2,2,1,3
C(C(C(C(C=CC=O)=O)O)O)(O)=O,,,5,1,3,0,3
20827_1,,,,2,2,1,3
20829_0,,,,2,2,1,3
C(C(C=C)(C(C(C=CC=O)=O)O)O)=O,,,5,1,3,0,3
20829_1,,,,2,2,1,3
20830_0,,,,2,2,1,3
20830_1,,,,2,2,1,3
20832_0,,,,2,2,1,3
C(C(C(C(C=CC=O)=O)O)O)=CC=O,,,5,1,2,0,2
20832_1,,,,2,2,1,3
20833_0,,,,2,2,1,3
20833_1,,,,2,2,1,3
20835_0,,,,2,2,1,3
C(C=CC(C(C(CO)O)O)=O)=O,,,5,1,5,0,5
20835_1,,,,2,2,1,3
20837_0,,,,2,2,1,3
C(CC(C=CC(C(CO)O)=O)O)=O,,,5,1,1,0,1
20839_0,,,,2,2,1,3
C(CC(C=CC=O)(C(CO)O)O)=O,,,5,1,1,0,1
20841_0,,,,2,2,1,3
C(CC(C=C(C=O)CO)(CO)O)=O,,,5,1,1,0,1
20843_0,,,,2,2,1,3
C(CC(C(CO)=CC(CO)=O)O)=O,,,5,1,1,0,1
20845_0,,,,2,2,1,3
C(C=C(C=O)CO)(C(C(C)O)O)=O,,,5,1,2,0,2
20845_1,,,,2,2,1,3
20847_0,,,,2,2,1,3
C(C=C(C=O)CO)(C(CO)O)=O,,,5,1,4,0,4
20847_1,,,,2,2,1,3
20849_0,,,,2,2,1,3
C(CC(C=C)(C(C=O)(CO)O)O)=O,,,5,1,1,0,1
20851_0,,,,2,2,1,3
C(CC(C(C(C=C)=O)(CO)O)O)=O,,,5,1,1,0,1
20853_0,,,,2,2,1,3
C(CC(C(C=O)=C)(C(CO)O)O)=O,,,5,1,1,0,1
20855_0,,,,2,2,1,3
C(CC(C(C(C(CO)O)=O)=C)O)=O,,,5,1,1,0,1
20857_0,,,,2,2,1,3
C(C(C=CCO)(CC=O)O)(O)=O,,,5,1,3,0,3
20859_0,,,,2,2,1,3
C(C(C=CCO)(C(C=O)O)O)(O)=O,,,5,1,2,0,2
20859_1,,,,2,2,1,3
20861_0,,,,2,2,1,3
C(CC(C=CC(O)=O)(CO)O)=O,,,5,1,2,0,2
20863_0,,,,2,2,1,3
C(C(C(C=CC(O)=O)(CO)O)O)=O,,,5,1,2,0,2
20863_1,,,,2,2,1,3
20865_0,,,,2,2,1,3
C(C(C(C(C=CC(O)=O)=O)O)O)=O,,,5,1,2,0,2
20865_1,,,,2,2,1,3
20867_0,,,,2,2,1,3
C(C=CC(C(C(C)O)O)=O)(O)=O,,,5,1,3,0,3
20867_1,,,,2,2,1,3
20868_0,,,,2,2,1,3
20868_1,,,,2,2,1,3
20870_0,,,,2,2,1,3
C(C=CC(C(C(CO)O)O)=O)(O)=O,,,5,1,2,0,2
20870_1,,,,2,2,1,3
20872_0,,,,2,2,1,3
C(C(C(C=C)(CC=O)O)O)(O)=O,,,5,1,2,0,2
20874_0,,,,2,2,1,3
C(C(C(C=C)(C(C=O)O)O)O)(O)=O,,,5,1,3,0,3
20874_1,,,,2,2,1,3
20876_0,,,,2,2,1,3
C1OCC(C=1)(C2C(C=CO2)=O)O,,,5,1,2,0,2
20876_1,,,,2,2,1,3
20878_0,,,,2,2,1,3
C(C(C1(C=COC1)O)O)(CO)=O,,,5,1,3,0,3
20878_1,,,,2,2,1,3
20880_0,,,,2,2,1,3
C1C(COC=1)(CC(C=O)=O)O,,,5,1,2,0,2
20882_0,,,,2,2,1,3
C(C(C=O)C1(C=COC1)O)=O,,,5,1,3,0,3
20882_1,,,,2,2,1,3
20884_0,,,,2,2,1,3
C1OCC(C=1)(C(C(C=O)=O)CO)O,,,5,1,2,0,2
20884_1,,,,2,2,1,3
20886_0,,,,2,2,1,3
C(C(C(C=O)C1(C=COC1)O)O)=O,,,5,1,2,0,2
20886_1,,,,2,2,1,3
20888_0,,,,2,2,1,3
C(C(C(CO)=O)C1(C=COC1)O)=O,,,5,1,2,0,2
20888_1,,,,2,2,1,3
20890_0,,,,2,2,1,3
C(CC(C(C1(C=COC1)O)O)=O)=O,,,5,1,2,0,2
20890_1,,,,2,2,1,3
20892_0,,,,2,2,1,3
C(C(C(CC1(C=COC1)O)=O)O)=O,,,5,1,1,0,1
20894_0,,,,2,2,1,3
C(CC1(C=COC1)O)=O,,,5,1,2,0,2
20896_0,,,,2,2,1,3
C(C(C(C)O)C1(C=COC1)O)=O,,,5,1,3,0,3
20896_1,,,,2,2,1,3
20898_0,,,,2,2,1,3
C(C(CO)C1(C=COC1)O)=O,,,5,1,3,0,3
20898_1,,,,2,2,1,3
20900_0,,,,2,2,1,3
C(C(C(CO)O)C1(C=COC1)O)=O,,,5,1,2,0,2
20900_1,,,,2,2,1,3
20902_0,,,,2,2,1,3
C1C(COC=1)(C(C(C=O)=O)O)O,,,5,1,3,0,3
20902_1,,,,2,2,1,3
20904_0,,,,2,2,1,3
C1C(COC=1)(C(C(C(C)=O)=O)O)O,,,5,1,2,0,2
20904_1,,,,2,2,1,3
20906_0,,,,2,2,1,3
C1C(COC=1)(CC(C(CO)=O)=O)O,,,5,1,1,0,1
20908_0,,,,2,2,1,3
C(C(C1(C=COC1)O)O)(C)=O,,,5,1,3,0,3
20908_1,,,,2,2,1,3
20910_0,,,,2,2,1,3
C(CC1(C=COC1)O)(CO)=O,,,5,1,2,0,2
20912_0,,,,2,2,1,3
C(C(C1(C=COC1)O)O)(CCO)=O,,,5,1,2,0,2
20912_1,,,,2,2,1,3
20914_0,,,,2,2,1,3
C(CO)(C(CO)C1(C=COC1)O)=O,,,5,1,2,0,2
20914_1,,,,2,2,1,3
20916_0,,,,2,2,1,3
C(CC1(C=COC1)O)(C(CO)O)=O,,,5,1,1,0,1
20918_0,,,,2,2,1,3
C1OCC(C=1)(CC(C(O)=O)=O)O,,,5,1,2,0,2
20920_0,,,,2,2,1,3
C(C(C=O)C1(C=COC1)O)(O)=O,,,5,1,3,0,3
20920_1,,,,2,2,1,3
20922_0,,,,2,2,1,3
C1(C(C2(C=COC2)O)OCC1O)=O,,,5,1,2,0,2
20922_1,,,,2,2,1,3
20924_0,,,,2,2,1,3
C1(C(O)OCC1C2(C=COC2)O)=O,,,5,1,2,0,2
20924_1,,,,2,2,1,3
20926_0,,,,2,2,1,3
C1(COC(C1C2(C=COC2)O)O)=O,,,5,1,2,0,2
20926_1,,,,2,2,1,3
20928_0,,,,2,2,1,3
C1(C(C2(C=COC2)O)OC(C1)O)=O,,,5,1,2,0,2
20928_1,,,,2,2,1,3
20930_0,,,,2,2,1,3
C(C(C1(C=COC1)O)O)=O,,,5,1,3,0,3
20930_1,,,,2,2,1,3
20932_0,,,,2,2,1,3
C1OC(C(C=1)=O)C(C(CO)O)O,,,5,1,3,0,3
20932_1,,,,2,2,1,3
20934_0,,,,2,2,1,3
C(C(C1C(C=CO1)=O)O)=O,,,5,1,3,0,3
20934_1,,,,2,2,1,3
20936_0,,,,2,2,1,3
C1OC(C(C=1)=O)C(CO)(CO)O,,,5,1,3,0,3
20936_1,,,,2,2,1,3
20938_0,,,,2,2,1,3
C(C(C)(C1C(C=CO1)=O)O)=O,,,5,1,3,0,3
20938_1,,,,2,2,1,3
20940_0,,,,2,2,1,3
C(C)(C(C1C(C=CO1)=O)O)=O,,,5,1,3,0,3
20940_1,,,,2,2,1,3
20942_0,,,,2,2,1,3
C(CC(C1C(C=CO1)=O)O)=O,,,5,1,3,0,3
20942_1,,,,2,2,1,3
20944_0,,,,2,2,1,3
C(C(CCO)(C1C(C=CO1)=O)O)=O,,,5,1,2,0,2
20944_1,,,,2,2,1,3
20946_0,,,,2,2,1,3
C(C(C1C(C=CO1)=O)O)(CCO)=O,,,5,1,2,0,2
20946_1,,,,2,2,1,3
20948_0,,,,2,2,1,3
C(CC(C(C1C(C=CO1)=O)O)O)=O,,,5,1,2,0,2
20948_1,,,,2,2,1,3
20950_0,,,,2,2,1,3
C(C(CC(C1C(C=CO1)=O)O)O)=O,,,5,1,2,0,2
20950_1,,,,2,2,1,3
20952_0,,,,2,2,1,3
C(CO)(CC(C1C(C=CO1)=O)O)=O,,,5,1,2,0,2
20952_1,,,,2,2,1,3
20954_0,,,,2,2,1,3
C(CC(CO)(C1C(C=CO1)=O)O)=O,,,5,1,2,0,2
20954_1,,,,2,2,1,3
20956_0,,,,2,2,1,3
C(C)(C(C(C1C(C=CO1)=O)O)O)=O,,,5,1,2,0,2
20956_1,,,,2,2,1,3
20958_0,,,,2,2,1,3
C(C(C(C)(C1C(C=CO1)=O)O)O)=O,,,5,1,2,0,2
20958_1,,,,2,2,1,3
20960_0,,,,2,2,1,3
C1OC(C(C=1)=O)C(C)O,,,5,1,3,0,3
20960_1,,,,2,2,1,3
20962_0,,,,2,2,1,3
C(C(CO)C(C1C(C=CO1)=O)O)=O,,,5,1,2,0,2
20962_1,,,,2,2,1,3
20964_0,,,,2,2,1,3
C1OC(C(C=1)=O)C(CC(C)O)O,,,5,1,3,0,3
20964_1,,,,2,2,1,3
20966_0,,,,2,2,1,3
C1OC(C(C=1)=O)C(C(C(C)O)O)O,,,5,1,2,0,2
20966_1,,,,2,2,1,3
20968_0,,,,2,2,1,3
C1OC(C(C=1)=O)C(CCO)O,,,5,1,3,0,3
20968_1,,,,2,2,1,3
20970_0,,,,2,2,1,3
C1OC(C(C=1)=O)C(CC(CO)O)O,,,5,1,2,0,2
20970_1,,,,2,2,1,3
20972_0,,,,2,2,1,3
C(C(CO)(C1C(C=CO1)=O)O)=O,,,5,1,3,0,3
20972_1,,,,2,2,1,3
20974_0,,,,2,2,1,3
C(CO)(C(C1C(C=CO1)=O)O)=O,,,5,1,3,0,3
20974_1,,,,2,2,1,3
20976_0,,,,2,2,1,3
C(C)(C(CO)(C1C(C=CO1)=O)O)=O,,,5,1,2,0,2
20976_1,,,,2,2,1,3
20978_0,,,,2,2,1,3
C(CO)(C(C)(C1C(C=CO1)=O)O)=O,,,5,1,2,0,2
20978_1,,,,2,2,1,3
20980_0,,,,2,2,1,3
C(C(C(C)O)(C1C(C=CO1)=O)O)=O,,,5,1,2,0,2
20980_1,,,,2,2,1,3
20982_0,,,,2,2,1,3
C(C(C1C(C=CO1)=O)O)(C(C)O)=O,,,5,1,2,0,2
20982_1,,,,2,2,1,3
20984_0,,,,2,2,1,3
C1OC(C(C=1)=O)C(C)(CO)O,,,5,1,3,0,3
20984_1,,,,2,2,1,3
20986_0,,,,2,2,1,3
C1OC(C(C=1)=O)C(CO)(CCO)O,,,5,1,2,0,2
20986_1,,,,2,2,1,3
20988_0,,,,2,2,1,3
C1OC(C(C=1)=O)C(C(CCO)O)O,,,5,1,2,0,2
20988_1,,,,2,2,1,3
20990_0,,,,2,2,1,3
C1OC(C(C=1)=O)C(C)(C(CO)O)O,,,5,1,2,0,2
20990_1,,,,2,2,1,3
20992_0,,,,2,2,1,3
C(C(C1C(C=CO1)=O)O)(O)=O,,,5,1,3,0,3
20992_1,,,,2,2,1,3
20994_0,,,,2,2,1,3
C(C(C)(C1C(C=CO1)=O)O)(O)=O,,,5,1,3,0,3
20994_1,,,,2,2,1,3
20996_0,,,,2,2,1,3
C(CC(C1C(C=CO1)=O)O)(O)=O,,,5,1,3,0,3
20996_1,,,,2,2,1,3
20998_0,,,,2,2,1,3
C1OC(C(C=1)=O)C2(COCC2O)O,,,5,1,2,0,2
20998_1,,,,2,2,1,3
21000_0,,,,2,2,1,3
C1OC(C(C=1)=O)C2(C(O)OCC2)O,,,5,1,2,0,2
21000_1,,,,2,2,1,3
21002_0,,,,2,2,1,3
C1OC(C(C=1)=O)C2(COC(C2)O)O,,,5,1,2,0,2
21002_1,,,,2,2,1,3
21004_0,,,,2,2,1,3
C(C(C=C)(C1C(C=CO1)=O)O)=O,,,5,1,3,0,3
21004_1,,,,2,2,1,3
21006_0,,,,2,2,1,3
C1OC(C(C=1)=O)C(C(C=C)=O)O,,,5,1,3,0,3
21006_1,,,,2,2,1,3
21008_0,,,,2,2,1,3
C1OC(C(C=1)=O)C(C=CC=O)O,,,5,1,3,0,3
21008_1,,,,2,2,1,3
21010_0,,,,2,2,1,3
C1OC(C(C=1)=O)CO,,,5,1,3,0,3
21010_1,,,,2,2,1,3
21012_0,,,,2,2,1,3
C1OC(C(C=1)=O)C(CO)O,,,5,1,3,0,3
21012_1,,,,2,2,1,3
21014_0,,,,2,2,1,3
C(CC1(CC(C=O)OC1O)O)=O,,,5,1,2,0,2
21016_0,,,,2,2,1,3
C(C(C1(C(OC(C=O)C1)O)O)O)=O,,,5,1,3,0,3
21016_1,,,,2,2,1,3
21017_0,,,,2,2,1,3
21019_0,,,,2,2,1,3
C(C(C(C1CC(C(O)O1)=O)O)O)=O,,,5,1,3,0,3
21019_1,,,,2,2,1,3
21021_0,,,,2,2,1,3
C(C1C(C(C(O)O1)=O)C(C=O)O)=O,,,5,1,3,0,3
21021_1,,,,2,2,1,3
21023_0,,,,2,2,1,3
C1(C(OC(C=O)C1C(C)O)O)=O,,,5,1,3,0,3
21023_1,,,,2,2,1,3
21024_0,,,,2,2,1,3
21024_1,,,,2,2,1,3
21026_0,,,,2,2,1,3
C1(C(OC(C=O)C1C(CO)O)O)=O,,,5,1,3,0,3
21026_1,,,,2,2,1,3
21027_0,,,,2,2,1,3
21027_1,,,,2,2,1,3
21028_0,,,,2,2,1,3
21028_1,,,,2,2,1,3
21030_0,,,,2,2,1,3
C(C1(C)CC(C(O1)O)(CC=O)O)=O,,,5,1,2,0,2
21032_0,,,,2,2,1,3
C(CC(C1(C)CC(C(O)O1)=O)O)=O,,,5,1,2,0,2
21034_0,,,,2,2,1,3
C(C1(C)C(C(C(O1)O)=O)C(C)O)=O,,,5,1,3,0,3
21034_1,,,,2,2,1,3
21035_0,,,,2,2,1,3
21035_1,,,,2,2,1,3
21037_0,,,,2,2,1,3
C(CC1(CC(C(C)=O)OC1O)O)=O,,,5,1,2,0,2
21039_0,,,,2,2,1,3
C(CC(C)(C1CC(C(O)O1)=O)O)=O,,,5,1,2,0,2
21041_0,,,,2,2,1,3
C(C1C(C(C(O1)O)=O)C(C)O)(C)=O,,,5,1,3,0,3
21041_1,,,,2,2,1,3
21042_0,,,,2,2,1,3
21042_1,,,,2,2,1,3
21044_0,,,,2,2,1,3
C1(C(OC(C(CC(C)O)=O)C1)O)=O,,,5,1,2,0,2
21045_0,,,,2,2,1,3
21047_0,,,,2,2,1,3
C(CC(CC1CC(C(O)O1)=O)O)=O,,,5,1,2,0,2
21049_0,,,,2,2,1,3
C(CC1CC(C(O)O1)(CC=O)O)=O,,,5,1,2,0,2
21051_0,,,,2,2,1,3
C(C(C1CC(C(O)O1)=O)C(C)O)=O,,,5,1,3,0,3
21051_1,,,,2,2,1,3
21053_0,,,,2,2,1,3
C(C(CO)C1CC(C(O)O1)=O)=O,,,5,1,4,0,4
21053_1,,,,2,2,1,3
21055_0,,,,2,2,1,3
C(CC1C(C(C(O)O1)=O)C(C)O)=O,,,5,1,3,0,3
21055_1,,,,2,2,1,3
21056_0,,,,2,2,1,3
21056_1,,,,2,2,1,3
21058_0,,,,2,2,1,3
C(C(CC1(C(O)OC(C)C1)O)=O)=O,,,5,1,2,0,2
21060_0,,,,2,2,1,3
C(C(C=O)C1(C(O)OC(C)C1)O)=O,,,5,1,3,0,3
21060_1,,,,2,2,1,3
21062_0,,,,2,2,1,3
C(CC1(C(O)OC(C)C1)O)=O,,,5,1,2,0,2
21064_0,,,,2,2,1,3
C(C(CO)C1(C(O)OC(C)C1)O)=O,,,5,1,3,0,3
21064_1,,,,2,2,1,3
21066_0,,,,2,2,1,3
C(C)(C(C1(C(O)OC(C)C1)O)O)=O,,,5,1,3,0,3
21066_1,,,,2,2,1,3
21068_0,,,,2,2,1,3
C(CO)(CC1(C(O)OC(C)C1)O)=O,,,5,1,2,0,2
21070_0,,,,2,2,1,3
C(C(C1(C(O)OC(C)C1)O)O)=O,,,5,1,3,0,3
21070_1,,,,2,2,1,3
21072_0,,,,2,2,1,3
C1(C(O)OC(C)C1C(C=O)O)=O,,,5,1,3,0,3
21072_1,,,,2,2,1,3
21074_0,,,,2,2,1,3
C(C(C)(C1C(C(O)OC1C)=O)O)=O,,,5,1,3,0,3
21074_1,,,,2,2,1,3
21076_0,,,,2,2,1,3
C(C(C1C(C(O)OC1C)=O)O)(C)=O,,,5,1,3,0,3
21076_1,,,,2,2,1,3
21078_0,,,,2,2,1,3
C(CC(C1C(C(O)OC1C)=O)O)=O,,,5,1,3,0,3
21078_1,,,,2,2,1,3
21080_0,,,,2,2,1,3
C1(C(O)OC(C)C1C(C)O)=O,,,5,1,3,0,3
21080_1,,,,2,2,1,3
21082_0,,,,2,2,1,3
C1(C(O)OC(C)C1C(CCO)O)=O,,,5,1,3,0,3
21082_1,,,,2,2,1,3
21084_0,,,,2,2,1,3
C1(C(O)OC(C)C1C(CO)(C)O)=O,,,5,1,3,0,3
21084_1,,,,2,2,1,3
21086_0,,,,2,2,1,3
C1(C(O)OC(C)C1C(C(O)=O)O)=O,,,5,1,3,0,3
21086_1,,,,2,2,1,3
21087_0,,,,2,2,1,3
21087_1,,,,2,2,1,3
21089_0,,,,2,2,1,3
C1(C(O)OC(C)C1C(CO)O)=O,,,5,1,3,0,3
21089_1,,,,2,2,1,3
21091_0,,,,2,2,1,3
C(CC(C1(CC(CO1)O)O)O)=O,,,5,1,2,0,2
21093_0,,,,2,2,1,3
C(C(C(C1(CC(CO1)O)O)O)O)=O,,,5,1,3,0,3
21093_1,,,,2,2,1,3
21095_0,,,,2,2,1,3
C(CC(C1C(CC(O)O1)O)O)=O,,,5,1,3,0,3
21097_0,,,,2,2,1,3
C(C(C(C1C(CC(O)O1)O)O)O)=O,,,5,1,6,0,6
21097_1,,,,2,2,1,3
21099_0,,,,2,2,1,3
C(CC1(C(O)OC(C)C1CO)O)=O,,,5,1,2,0,2
21101_0,,,,2,2,1,3
C(CC(CC1C(CC(O)O1)O)O)=O,,,5,1,2,0,2
21103_0,,,,2,2,1,3
C(C(C1C(CC(O)O1)O)C(C)O)=O,,,5,1,3,0,3
21103_1,,,,2,2,1,3
21105_0,,,,2,2,1,3
C(C(CO)C1C(CC(O)O1)O)=O,,,5,1,4,0,4
21105_1,,,,2,2,1,3
21107_0,,,,2,2,1,3
C(CC(CC1CC(C(O)O1)O)O)=O,,,5,1,2,0,2
21109_0,,,,2,2,1,3
C(C(C1CC(C(O)O1)O)C(C)O)=O,,,5,1,3,0,3
21109_1,,,,2,2,1,3
21111_0,,,,2,2,1,3
C(C(CO)C1CC(C(O)O1)O)=O,,,5,1,4,0,4
21111_1,,,,2,2,1,3
21113_0,,,,2,2,1,3
C(CC(C1C(C)OC(C1O)O)O)=O,,,5,1,2,0,2
21115_0,,,,2,2,1,3
C(CC(C1COC(C1O)O)O)=O,,,5,1,2,0,2
21117_0,,,,2,2,1,3
C(C(C(C1COC(C1O)O)O)O)=O,,,5,1,3,0,3
21117_1,,,,2,2,1,3
21119_0,,,,2,2,1,3
C(C(CO)C1(COC(C1O)O)O)=O,,,5,1,3,0,3
21119_1,,,,2,2,1,3
21121_0,,,,2,2,1,3
C(C(CO)C1(C(C(CO1)O)O)O)=O,,,5,1,3,0,3
21121_1,,,,2,2,1,3
21123_0,,,,2,2,1,3
C(CC(C)(C1C(CC(O)O1)O)O)=O,,,5,1,2,0,2
21125_0,,,,2,2,1,3
C(C1C(CC(O1)O)O)(CC(C)O)=O,,,5,1,2,0,2
21127_0,,,,2,2,1,3
C(C1C(CC(O1)O)O)(CCO)=O,,,5,1,4,0,4
21129_0,,,,2,2,1,3
C(CC(C1C(C)(CC(O)O1)O)O)=O,,,5,1,2,0,2
21131_0,,,,2,2,1,3
C(C(CC1(C(O)OCC1O)O)=O)=O,,,5,1,2,0,2
21133_0,,,,2,2,1,3
C(C(C=O)C1(C(O)OCC1O)O)=O,,,5,1,3,0,3
21133_1,,,,2,2,1,3
21134_0,,,,2,2,1,3
21135_0,,,,2,2,1,3
21135_1,,,,2,2,1,3
21136_0,,,,2,2,1,3
21136_1,,,,2,2,1,3
21138_0,,,,2,2,1,3
C(CO)(CC1(C(O)OCC1O)O)=O,,,5,1,2,0,2
21139_0,,,,2,2,1,3
21139_1,,,,2,2,1,3
21140_0,,,,2,2,1,3
21142_0,,,,2,2,1,3
C(CC(C1(C(C(CO1)O)O)O)O)=O,,,5,1,3,0,3
21144_0,,,,2,2,1,3
C(CC(C1(COC(C1O)O)O)O)=O,,,5,1,3,0,3
21146_0,,,,2,2,1,3
C(CC(C1(CC(O)OC1C)O)O)=O,,,5,1,2,0,2
21148_0,,,,2,2,1,3
C(CC(C1(COC(C1)O)O)O)=O,,,5,1,2,0,2
21150_0,,,,2,2,1,3
C(C(C(C1(COC(C1)O)O)O)O)=O,,,5,1,5,0,5
21150_1,,,,2,2,1,3
21152_0,,,,2,2,1,3
C(CC1(COC(C(C1O)O)O)O)=O,,,5,1,3,0,3
21154_0,,,,2,2,1,3
C1(C(C(C)O)OC(C(C1O)O)O)=O,,,5,1,3,0,3
21154_1,,,,2,2,1,3
21155_0,,,,2,2,1,3
21155_1,,,,2,2,1,3
21157_0,,,,2,2,1,3
C(C1C(C(CO)OC(C1O)O)=O)=O,,,5,1,3,0,3
21157_1,,,,2,2,1,3
21159_0,,,,2,2,1,3
C1(C(C(C=O)OC(C1CO)O)O)=O,,,5,1,3,0,3
21159_1,,,,2,2,1,3
21161_0,,,,2,2,1,3
C(C1C(C(CO)C(C(O1)O)O)=O)=O,,,5,1,3,0,3
21161_1,,,,2,2,1,3
21163_0,,,,2,2,1,3
C1(C(CO)C(C=O)OC(C1O)O)=O,,,5,1,3,0,3
21163_1,,,,2,2,1,3
21164_0,,,,2,2,1,3
21164_1,,,,2,2,1,3
21165_0,,,,2,2,1,3
21165_1,,,,2,2,1,3
21166_0,,,,2,2,1,3
21166_1,,,,2,2,1,3
21168_0,,,,2,2,1,3
C(CC(C1(CC(O)OCC1)O)O)=O,,,5,1,2,0,2
21170_0,,,,2,2,1,3
C(CC(C1CC(CC(O)O1)O)O)=O,,,5,1,2,0,2
21172_0,,,,2,2,1,3
C(CC1(CC(O)OC(C)C1O)O)=O,,,5,1,2,0,2
21174_0,,,,2,2,1,3
C1(C(C(C)OC(C1C(C)O)O)O)=O,,,5,1,3,0,3
21174_1,,,,2,2,1,3
21176_0,,,,2,2,1,3
C1(C(C(C)OC(C1CO)O)O)=O,,,5,1,3,0,3
21176_1,,,,2,2,1,3
21178_0,,,,2,2,1,3
C(CC1(CC(C)OC(C1O)O)O)=O,,,5,1,2,0,2
21180_0,,,,2,2,1,3
C1(C(C(O)OC(C)C1C(C)O)O)=O,,,5,1,3,0,3
21180_1,,,,2,2,1,3
21182_0,,,,2,2,1,3
C1(C(C(O)OC(C)C1CO)O)=O,,,5,1,3,0,3
21182_1,,,,2,2,1,3
21183_0,,,,2,2,1,3
21184_0,,,,2,2,1,3
21184_1,,,,2,2,1,3
21186_0,,,,2,2,1,3
C(CC1(CCOC(CC1O)O)O)=O,,,5,1,2,0,2
21188_0,,,,2,2,1,3
C1(C(CC(O)OCC1C(C)O)O)=O,,,5,1,3,0,3
21188_1,,,,2,2,1,3
21190_0,,,,2,2,1,3
C1(C(CC(O)OCC1CO)O)=O,,,5,1,3,0,3
21190_1,,,,2,2,1,3
21192_0,,,,2,2,1,3
C(CC1(COC(CC(C1)O)O)O)=O,,,5,1,2,0,2
21194_0,,,,2,2,1,3
C1(COC(CC(C1C(C)O)O)O)=O,,,5,1,3,0,3
21194_1,,,,2,2,1,3
21196_0,,,,2,2,1,3
C1(COC(CC(C1CO)O)O)=O,,,5,1,5,0,5
21196_1,,,,2,2,1,3
21198_0,,,,2,2,1,3
C1(C(C(C)O)OC(CC(C1)O)O)=O,,,5,1,3,0,3
21198_1,,,,2,2,1,3
21200_0,,,,2,2,1,3
C1(C(CO)OC(CC(C1)O)O)=O,,,5,1,5,0,5
21200_1,,,,2,2,1,3
21202_0,,,,2,2,1,3
C(C(CO)C1(COC(C1O)=O)O)=O,,,5,1,2,0,2
21202_1,,,,2,2,1,3
21203_0,,,,2,2,1,3
21204_0,,,,2,2,1,3
21204_1,,,,2,2,1,3
21205_0,,,,2,2,1,3
21206_0,,,,2,2,1,3
21206_1,,,,2,2,1,3
21208_0,,,,2,2,1,3
C(C(CC(C(C=O)=O)CO)CO)=O,,,5,1,2,0,2
21210_0,,,,2,2,1,3
C(C(CO)C(C=O)C(C=O)CO)=O,,,5,1,2,0,2
21212_0,,,,2,2,1,3
C(C)(C(CC(C(C=O)=O)CO)O)=O,,,5,1,2,0,2
21213_0,,,,2,2,1,3
21214_0,,,,2,2,1,3
21215_0,,,,2,2,1,3
21217_0,,,,2,2,1,3
C(CO)(CCC(C(C=O)=O)CO)=O,,,5,1,4,0,4
21218_0,,,,2,2,1,3
21218_1,,,,2,2,1,3
21219_0,,,,2,2,1,3
21221_0,,,,2,2,1,3
C(CC(C=O)C(C=O)CO)(CO)=O,,,5,1,3,0,3
21222_0,,,,2,2,1,3
21222_1,,,,2,2,1,3
21223_0,,,,2,2,1,3
21225_0,,,,2,2,1,3
C(C(CCC(C)O)(CC=O)O)=O,,,5,1,1,0,1
21227_0,,,,2,2,1,3
C(C(CCC(C)O)(C(C=O)O)O)=O,,,5,1,2,0,2
21227_1,,,,2,2,1,3
21229_0,,,,2,2,1,3
C(CC(C(CCC(C)O)=O)O)=O,,,5,1,2,0,2
21231_0,,,,2,2,1,3
C(C(C(C=O)O)O)(CCC(C)O)=O,,,5,1,3,0,3
21231_1,,,,2,2,1,3
21233_0,,,,2,2,1,3
C(C(C(C(C=O)=O)CC(C)O)O)=O,,,5,1,2,0,2
21235_0,,,,2,2,1,3
C(C(C(CC(C)O)C(C)O)=O)=O,,,5,1,2,0,2
21237_0,,,,2,2,1,3
C(C(C(CO)CC(C)O)=O)=O,,,5,1,2,0,2
21239_0,,,,2,2,1,3
C(C(C(CC(C)O)C(CO)O)=O)=O,,,5,1,2,0,2
21241_0,,,,2,2,1,3
C(CC(C(C(C)O)CC=O)O)=O,,,5,1,2,0,2
21243_0,,,,2,2,1,3
C(CC(C(C(C=O)O)O)C(C)O)=O,,,5,1,3,0,3
21243_1,,,,2,2,1,3
21245_0,,,,2,2,1,3
C(C(CC(CC=O)O)C(C)O)=O,,,5,1,1,0,1
21247_0,,,,2,2,1,3
C(C(C(C)O)CC(C(C=O)O)O)=O,,,5,1,3,0,3
21247_1,,,,2,2,1,3
21248_0,,,,2,2,1,3
21250_0,,,,2,2,1,3
C(C(C(C)O)C(C=O)C(C)O)=O,,,5,1,2,0,2
21251_0,,,,2,2,1,3
21252_0,,,,2,2,1,3
21254_0,,,,2,2,1,3
C(C(CCCCO)(CC=O)O)=O,,,5,1,1,0,1
21256_0,,,,2,2,1,3
C(C(CCCCO)(C(C=O)O)O)=O,,,5,1,2,0,2
21256_1,,,,2,2,1,3
21258_0,,,,2,2,1,3
C(CC(C(CCCCO)=O)O)=O,,,5,1,2,0,2
21260_0,,,,2,2,1,3
C(C(C(C=O)O)O)(CCCCO)=O,,,5,1,3,0,3
21260_1,,,,2,2,1,3
21262_0,,,,2,2,1,3
C(C(C(C(C=O)=O)CCCO)O)=O,,,5,1,2,0,2
21264_0,,,,2,2,1,3
C(C(C(CCCO)C(C)O)=O)=O,,,5,1,2,0,2
21266_0,,,,2,2,1,3
C(C(C(CO)CCCO)=O)=O,,,5,1,2,0,2
21268_0,,,,2,2,1,3
C(C(C(CCCO)C(CO)O)=O)=O,,,5,1,2,0,2
21270_0,,,,2,2,1,3
C(CC(C(CC=O)O)CCO)=O,,,5,1,2,0,2
21272_0,,,,2,2,1,3
C(CC(C(C(C=O)O)O)CCO)=O,,,5,1,3,0,3
21272_1,,,,2,2,1,3
21274_0,,,,2,2,1,3
C(C(CC(CC=O)O)CCO)=O,,,5,1,2,0,2
21276_0,,,,2,2,1,3
C(C(CCO)CC(C(C=O)O)O)=O,,,5,1,3,0,3
21276_1,,,,2,2,1,3
21278_0,,,,2,2,1,3
C(C(C(C=O)C(C=O)CCO)O)=O,,,5,1,5,0,5
21280_0,,,,2,2,1,3
C(C(C(C)O)C(C=O)CCO)=O,,,5,1,5,0,5
21282_0,,,,2,2,1,3
C(C(CCO)C(C=O)CO)=O,,,5,1,5,0,5
21284_0,,,,2,2,1,3
C(C(C(CO)O)C(C=O)CCO)=O,,,5,1,4,0,4
21286_0,,,,2,2,1,3
C(CCCC(C=O)(CC=O)O)(O)=O,,,5,1,2,0,2
21288_0,,,,2,2,1,3
C(CCCC(C(CC=O)O)=O)(O)=O,,,5,1,3,0,3
21290_0,,,,2,2,1,3
C(CCC(C(C=O)=O)C(C)O)(O)=O,,,5,1,3,0,3
21292_0,,,,2,2,1,3
C(CCC(C(C=O)=O)CO)(O)=O,,,5,1,3,0,3
21294_0,,,,2,2,1,3
C(CC(C(CC=O)O)CC=O)(O)=O,,,5,1,2,0,2
21296_0,,,,2,2,1,3
C(CC(CC(C=O)CC(O)=O)O)=O,,,5,1,3,0,3
21298_0,,,,2,2,1,3
C(CC(C=O)C(C=O)C(C)O)(O)=O,,,5,1,4,0,4
21300_0,,,,2,2,1,3
C(CC(C=O)C(C=O)CO)(O)=O,,,5,1,5,0,5
21302_0,,,,2,2,1,3
C(C(CCCO)(CC(C=O)=O)O)=O,,,5,1,1,0,1
21304_0,,,,2,2,1,3
C(C(C=O)C(C=O)(CCCO)O)=O,,,5,1,2,0,2
21304_1,,,,2,2,1,3
21306_0,,,,2,2,1,3
C(C(CCCO)(CC=O)O)=O,,,5,1,1,0,1
21308_0,,,,2,2,1,3
C(C(CO)C(C=O)(CCCO)O)=O,,,5,1,2,0,2
21308_1,,,,2,2,1,3
21310_0,,,,2,2,1,3
C(C(CCCO)(C(C(C)=O)O)O)=O,,,5,1,2,0,2
21310_1,,,,2,2,1,3
21312_0,,,,2,2,1,3
C(C(CCCO)(CC(CO)=O)O)=O,,,5,1,1,0,1
21314_0,,,,2,2,1,3
C(C(CCCO)(C(C=O)O)O)=O,,,5,1,2,0,2
21314_1,,,,2,2,1,3
21316_0,,,,2,2,1,3
C(C(CC(C=O)=O)O)(CCCO)=O,,,5,1,2,0,2
21318_0,,,,2,2,1,3
C(C(C=O)C(C(CCCO)=O)O)=O,,,5,1,3,0,3
21318_1,,,,2,2,1,3
21320_0,,,,2,2,1,3
C(CC(C(CCCO)=O)O)=O,,,5,1,2,0,2
21322_0,,,,2,2,1,3
C(C(CO)C(C(CCCO)=O)O)=O,,,5,1,3,0,3
21322_1,,,,2,2,1,3
21324_0,,,,2,2,1,3
C(C(C(C(CCCO)=O)O)O)(C)=O,,,5,1,3,0,3
21324_1,,,,2,2,1,3
21326_0,,,,2,2,1,3
C(CC(C(CCCO)=O)O)(CO)=O,,,5,1,2,0,2
21328_0,,,,2,2,1,3
C(C(C(C=O)O)O)(CCCO)=O,,,5,1,3,0,3
21328_1,,,,2,2,1,3
21330_0,,,,2,2,1,3
C(C(C(C(C=O)=O)CCO)O)=O,,,5,1,3,0,3
21332_0,,,,2,2,1,3
C(C(C)(C(C(C=O)=O)CCO)O)=O,,,5,1,2,0,2
21334_0,,,,2,2,1,3
C(C(C(C(C=O)=O)CCO)O)(C)=O,,,5,1,2,0,2
21335_0,,,,2,2,1,3
21337_0,,,,2,2,1,3
C(C(C(CCO)C(C)O)=O)=O,,,5,1,2,0,2
21339_0,,,,2,2,1,3
C(C(C(CCO)C(CCO)O)=O)=O,,,5,1,1,0,1
21341_0,,,,2,2,1,3
C(C(C(CCO)C(C)(CO)O)=O)=O,,,5,1,1,0,1
21343_0,,,,2,2,1,3
C(C(C(C(C=O)=O)CCO)O)(O)=O,,,5,1,1,0,1
21345_0,,,,2,2,1,3
C(C(C(CO)CCO)=O)=O,,,5,1,6,0,6
21347_0,,,,2,2,1,3
C(C(C(CCO)C(CO)O)=O)=O,,,5,1,2,0,2
21349_0,,,,2,2,1,3
C(C(CCC(CO)O)(CC=O)O)=O,,,5,1,1,0,1
21351_0,,,,2,2,1,3
C(CC(C(CCC(CO)O)=O)O)=O,,,5,1,2,0,2
21353_0,,,,2,2,1,3
C(C(C(CC(CO)O)C(C)O)=O)=O,,,5,1,2,0,2
21355_0,,,,2,2,1,3
C(C(C(CO)CC(CO)O)=O)=O,,,5,1,2,0,2
21357_0,,,,2,2,1,3
C(C(CC(C(C=O)=O)CO)O)(O)=O,,,5,1,2,0,2
21358_0,,,,2,2,1,3
21360_0,,,,2,2,1,3
C(C(C=O)CC(C(C=O)=O)CO)=O,,,5,1,3,0,3
21361_0,,,,2,2,1,3
21362_0,,,,2,2,1,3
21362_1,,,,2,2,1,3
21364_0,,,,2,2,1,3
C(CCCC(C=O)(CC=O)O)=O,,,5,1,2,0,2
21366_0,,,,2,2,1,3
C(CCCC(C=O)(C(C=O)O)O)=O,,,5,1,3,0,3
21366_1,,,,2,2,1,3
21368_0,,,,2,2,1,3
C(CC(C(CCCC=O)=O)O)=O,,,5,1,3,0,3
21370_0,,,,2,2,1,3
C(CCCC(C(C(C=O)O)O)=O)=O,,,5,1,4,0,4
21370_1,,,,2,2,1,3
21371_0,,,,2,2,1,3
21372_0,,,,2,2,1,3
21373_0,,,,2,2,1,3
21374_0,,,,2,2,1,3
21376_0,,,,2,2,1,3
C(CCC(C(C=O)=O)C(C=O)O)=O,,,5,1,3,0,3
21378_0,,,,2,2,1,3
C(CCC(C(C=O)=O)C(C)O)=O,,,5,1,3,0,3
21380_0,,,,2,2,1,3
C(CCC(C(C=O)=O)CO)=O,,,5,1,3,0,3
21382_0,,,,2,2,1,3
C(CCC(C(C=O)=O)C(CO)O)=O,,,5,1,3,0,3
21384_0,,,,2,2,1,3
C(C(C1C(C(CC1O)O)O)O)(O)=O,,,5,1,2,0,2
21384_1,,,,2,2,1,3
21386_0,,,,2,2,1,3
C(C(C(C(C)O)C(C=O)O)O)(O)=O,,,5,1,3,0,3
21386_1,,,,2,2,1,3
21387_0,,,,2,2,1,3
21387_1,,,,2,2,1,3
21389_0,,,,2,2,1,3
C(C(C(C(C)O)C(C)O)O)(O)=O,,,5,1,2,0,2
21389_1,,,,2,2,1,3
21391_0,,,,2,2,1,3
C(C(C(C(CO)O)C(C)O)O)(O)=O,,,5,1,2,0,2
21391_1,,,,2,2,1,3
21393_0,,,,2,2,1,3
C(C(C(C(CC(C)O)O)O)O)(O)=O,,,5,1,3,0,3
21393_1,,,,2,2,1,3
21395_0,,,,2,2,1,3
C(C(CC(CC(C)O)O)O)(O)=O,,,5,1,2,0,2
21395_1,,,,2,2,1,3
21397_0,,,,2,2,1,3
C(C(CC(C(C(C)O)O)O)O)(O)=O,,,5,1,2,0,2
21397_1,,,,2,2,1,3
21398_0,,,,2,2,1,3
21398_1,,,,2,2,1,3
21399_0,,,,2,2,1,3
21401_0,,,,2,2,1,3
C(C(CO)(CC(CCO)O)O)(O)=O,,,5,1,1,0,1
21403_0,,,,2,2,1,3
C(C(CC(CCO)O)O)(O)=O,,,5,1,4,0,4
21403_1,,,,2,2,1,3
21405_0,,,,2,2,1,3
C(C(C(CO)C(CCO)O)O)(O)=O,,,5,1,4,0,4
21405_1,,,,2,2,1,3
21407_0,,,,2,2,1,3
C(C(CC(CC(CO)O)O)O)(O)=O,,,5,1,3,0,3
21407_1,,,,2,2,1,3
21409_0,,,,2,2,1,3
C(C(CO)(C(C(C(O)=O)O)O)O)=O,,,5,1,6,0,6
21409_1,,,,2,2,1,3
21411_0,,,,2,2,1,3
C(C(CO)(CC(C(O)=O)O)O)=O,,,5,1,4,0,4
21411_1,,,,2,2,1,3
21412_0,,,,2,2,1,3
21412_1,,,,2,2,1,3
21413_0,,,,2,2,1,3
21413_1,,,,2,2,1,3
21415_0,,,,2,2,1,3
C(C(C(C(CO)(C)O)O)O)(O)=O,,,5,1,3,0,3
21415_1,,,,2,2,1,3
21417_0,,,,2,2,1,3
C(C(C(C(C(O)=O)O)O)O)(O)=O,,,5,1,4,0,4
21417_1,,,,2,2,1,3
21419_0,,,,2,2,1,3
C(C(C)(C(C(C(O)=O)O)O)O)(O)=O,,,5,1,5,0,5
21419_1,,,,2,2,1,3
21420_0,,,,2,2,1,3
21420_1,,,,2,2,1,3
21422_0,,,,2,2,1,3
C(C(C=C)(C(C(C(O)=O)O)O)O)=O,,,5,1,4,0,4
21422_1,,,,2,2,1,3
21423_0,,,,2,2,1,3
21423_1,,,,2,2,1,3
21425_0,,,,2,2,1,3
C(C(C(C(C=CC=O)O)O)O)(O)=O,,,5,1,4,0,4
21425_1,,,,2,2,1,3
21426_0,,,,2,2,1,3
21426_1,,,,2,2,1,3
21427_0,,,,2,2,1,3
21427_1,,,,2,2,1,3
21429_0,,,,2,2,1,3
C(C(C)(C(C(C(O)=O)O)O)O)=O,,,5,1,5,0,5
21429_1,,,,2,2,1,3
21430_0,,,,2,2,1,3
21430_1,,,,2,2,1,3
21431_0,,,,2,2,1,3
21431_1,,,,2,2,1,3
21433_0,,,,2,2,1,3
C(C(C(C(C)O)O)O)(O)=O,,,5,1,5,0,5
21433_1,,,,2,2,1,3
21435_0,,,,2,2,1,3
C(C(CC(C(C)=O)(CO)O)O)(O)=O,,,5,1,3,0,3
21435_1,,,,2,2,1,3
21437_0,,,,2,2,1,3
C(C(CC(C(CO)=O)(C)O)O)(O)=O,,,5,1,3,0,3
21437_1,,,,2,2,1,3
21439_0,,,,2,2,1,3
C(C(C)(C(C(CO)(C)O)O)O)(O)=O,,,5,1,1,0,1
21440_0,,,,2,2,1,3
21442_0,,,,2,2,1,3
C(C(C)(C(C(C=O)O)O)O)(O)=O,,,5,1,5,0,5
21444_0,,,,2,2,1,3
C(C(C)(C(C(C=O)(C)O)O)O)(O)=O,,,5,1,1,0,1
21445_0,,,,2,2,1,3
21446_0,,,,2,2,1,3
21448_0,,,,2,2,1,3
C(C(C)(C(C(C)O)O)O)(O)=O,,,5,1,2,0,2
21449_0,,,,2,2,1,3
21450_0,,,,2,2,1,3
21452_0,,,,2,2,1,3
C(C(CO)(CC(CO)(C)O)O)(O)=O,,,5,1,1,0,1
21454_0,,,,2,2,1,3
C(C(CO)(CC(C(O)=O)O)O)(O)=O,,,5,1,1,0,1
21456_0,,,,2,2,1,3
C(C(CO)(CC(C=O)O)O)(O)=O,,,5,1,5,0,5
21458_0,,,,2,2,1,3
C(C(CO)(CC(C=O)(C)O)O)(O)=O,,,5,1,2,0,2
21460_0,,,,2,2,1,3
C(C(CO)(CC(C(C)=O)O)O)(O)=O,,,5,1,2,0,2
21461_0,,,,2,2,1,3
21463_0,,,,2,2,1,3
C(C(CO)(CC(C)O)O)(O)=O,,,5,1,2,0,2
21464_0,,,,2,2,1,3
21466_0,,,,2,2,1,3
C(C(CO)(CC(CO)O)O)(O)=O,,,5,1,2,0,2
21468_0,,,,2,2,1,3
C(C(CC(C(O)=O)O)(C(C)O)O)=O,,,5,1,3,0,3
21468_1,,,,2,2,1,3
21470_0,,,,2,2,1,3
C(C(CC(C(C(C)O)=O)O)O)(O)=O,,,5,1,4,0,4
21470_1,,,,2,2,1,3
21472_0,,,,2,2,1,3
C(C(CC(CO)(C)O)O)(O)=O,,,5,1,3,0,3
21472_1,,,,2,2,1,3
21474_0,,,,2,2,1,3
C(C(C(CO)C(CO)(C)O)O)(O)=O,,,5,1,4,0,4
21474_1,,,,2,2,1,3
21476_0,,,,2,2,1,3
C(C(CC(CO)(CCO)O)O)(O)=O,,,5,1,4,0,4
21476_1,,,,2,2,1,3
21478_0,,,,2,2,1,3
C(C(CC(C(CCO)O)O)O)(O)=O,,,5,1,3,0,3
21478_1,,,,2,2,1,3
21480_0,,,,2,2,1,3
C(C(CC(C)(C(CO)O)O)O)(O)=O,,,5,1,3,0,3
21480_1,,,,2,2,1,3
21482_0,,,,2,2,1,3
C(C(CC(C(O)=O)O)O)(O)=O,,,5,1,3,0,3
21482_1,,,,2,2,1,3
21484_0,,,,2,2,1,3
C(C(C(CO)C(C(O)=O)O)O)(O)=O,,,5,1,4,0,4
21484_1,,,,2,2,1,3
21486_0,,,,2,2,1,3
C(C(C)(CC(C(O)=O)O)O)(O)=O,,,5,1,4,0,4
21486_1,,,,2,2,1,3
21488_0,,,,2,2,1,3
C(CC(CC(C(O)=O)O)O)(O)=O,,,5,1,4,0,4
21488_1,,,,2,2,1,3
21490_0,,,,2,2,1,3
C(C(CC1(COCC1O)O)O)(O)=O,,,5,1,2,0,2
21490_1,,,,2,2,1,3
21492_0,,,,2,2,1,3
C(C(CC1(C(O)OCC1)O)O)(O)=O,,,5,1,3,0,3
21492_1,,,,2,2,1,3
21494_0,,,,2,2,1,3
C(C(CC1(COC(C1)O)O)O)(O)=O,,,5,1,3,0,3
21494_1,,,,2,2,1,3
21496_0,,,,2,2,1,3
C(C(C=C)(CC(C(O)=O)O)O)=O,,,5,1,3,0,3
21496_1,,,,2,2,1,3
21498_0,,,,2,2,1,3
C(C(CC(C(C=C)=O)O)O)(O)=O,,,5,1,3,0,3
21498_1,,,,2,2,1,3
21500_0,,,,2,2,1,3
C(C(CC(C=CC=O)O)O)(O)=O,,,5,1,4,0,4
21500_1,,,,2,2,1,3
21501_0,,,,2,2,1,3
21502_0,,,,2,2,1,3
21503_0,,,,2,2,1,3
21504_0,,,,2,2,1,3
21505_0,,,,2,2,1,3
21505_1,,,,2,2,1,3
21506_0,,,,2,2,1,3
21506_1,,,,2,2,1,3
21508_0,,,,2,2,1,3
C(C(C=O)(C)O)(O)=O,,,5,1,10,0,10
21509_0,,,,2,2,1,3
21510_0,,,,2,2,1,3
21511_0,,,,2,2,1,3
21512_0,,,,2,2,1,3
21513_0,,,,2,2,1,3
21514_0,,,,2,2,1,3
21515_0,,,,2,2,1,3
21516_0,,,,2,2,1,3
21517_0,,,,2,2,1,3
21517_1,,,,2,2,1,3
21518_0,,,,2,2,1,3
21518_1,,,,2,2,1,3
21519_0,,,,2,2,1,3
21519_1,,,,2,2,1,3
21520_0,,,,2,2,1,3
21520_1,,,,2,2,1,3
21521_0,,,,2,2,1,3
21521_1,,,,2,2,1,3
21522_0,,,,2,2,1,3
21522_1,,,,2,2,1,3
21523_0,,,,2,2,1,3
21523_1,,,,2,2,1,3
21524_0,,,,2,2,1,3
21524_1,,,,2,2,1,3
21525_0,,,,2,2,1,3
21525_1,,,,2,2,1,3
21526_0,,,,2,2,1,3
21526_1,,,,2,2,1,3
21527_0,,,,2,2,1,3
21527_1,,,,2,2,1,3
21528_0,,,,2,2,1,3
21528_1,,,,2,2,1,3
21529_0,,,,2,2,1,3
21529_1,,,,2,2,1,3
21530_0,,,,2,2,1,3
21530_1,,,,2,2,1,3
21532_0,,,,2,2,1,3
C(C(C=O)(CCO)O)(O)=O,,,5,1,3,0,3
21533_0,,,,2,2,1,3
21533_1,,,,2,2,1,3
21534_0,,,,2,2,1,3
21534_1,,,,2,2,1,3
21536_0,,,,2,2,1,3
C(C(C=O)(CC(CO)O)O)(O)=O,,,5,1,1,0,1
21538_0,,,,2,2,1,3
C(C(CC(C)=O)O)(O)=O,,,5,1,5,0,5
21538_1,,,,2,2,1,3
21539_0,,,,2,2,1,3
21539_1,,,,2,2,1,3
21540_0,,,,2,2,1,3
21540_1,,,,2,2,1,3
21541_0,,,,2,2,1,3
21541_1,,,,2,2,1,3
21543_0,,,,2,2,1,3
C(CC(C(O)=O)O)(C(C)O)=O,,,5,1,4,0,4
21543_1,,,,2,2,1,3
21545_0,,,,2,2,1,3
C(C(CO)C(C(O)=O)O)(C(C)O)=O,,,5,1,3,0,3
21545_1,,,,2,2,1,3
21546_0,,,,2,2,1,3
21546_1,,,,2,2,1,3
21547_0,,,,2,2,1,3
21547_1,,,,2,2,1,3
21548_0,,,,2,2,1,3
21548_1,,,,2,2,1,3
21549_0,,,,2,2,1,3
21549_1,,,,2,2,1,3
21550_0,,,,2,2,1,3
21550_1,,,,2,2,1,3
21551_0,,,,2,2,1,3
21551_1,,,,2,2,1,3
21553_0,,,,2,2,1,3
C(C(C(CO)(CO)C(C)O)O)(O)=O,,,5,1,2,0,2
21553_1,,,,2,2,1,3
21555_0,,,,2,2,1,3
C(C(C(CO)(CO)CO)O)(O)=O,,,5,1,2,0,2
21555_1,,,,2,2,1,3
21556_0,,,,2,2,1,3
21556_1,,,,2,2,1,3
21558_0,,,,2,2,1,3
C(C(C(CO)(C(C)O)O)O)(O)=O,,,5,1,7,0,7
21558_1,,,,2,2,1,3
21560_0,,,,2,2,1,3
C(C(C(C)(C(CCO)O)O)O)(O)=O,,,5,1,4,0,4
21560_1,,,,2,2,1,3
21562_0,,,,2,2,1,3
C(C(C(C)(C(CO)(C)O)O)O)(O)=O,,,5,1,2,0,2
21562_1,,,,2,2,1,3
21563_0,,,,2,2,1,3
21563_1,,,,2,2,1,3
21565_0,,,,2,2,1,3
C(C(C)(C(C)(C(C(O)=O)O)O)O)=O,,,5,1,3,0,3
21565_1,,,,2,2,1,3
21566_0,,,,2,2,1,3
21566_1,,,,2,2,1,3
21567_0,,,,2,2,1,3
21567_1,,,,2,2,1,3
21569_0,,,,2,2,1,3
C(C(C(C)(C(C)O)O)O)(O)=O,,,5,1,2,0,2
21569_1,,,,2,2,1,3
21570_0,,,,2,2,1,3
21570_1,,,,2,2,1,3
21571_0,,,,2,2,1,3
21571_1,,,,2,2,1,3
21572_0,,,,2,2,1,3
21573_0,,,,2,2,1,3
21574_0,,,,2,2,1,3
21575_0,,,,2,2,1,3
21575_1,,,,2,2,1,3
21577_0,,,,2,2,1,3
C(C(CO)(C(CO)CO)O)(O)=O,,,5,1,3,0,3
21579_0,,,,2,2,1,3
C(C(CO)CC(C(O)=O)O)=O,,,5,1,3,0,3
21579_1,,,,2,2,1,3
21581_0,,,,2,2,1,3
C(C(CO)C(CO)C(C(O)=O)O)=O,,,5,1,2,0,2
21581_1,,,,2,2,1,3
21582_0,,,,2,2,1,3
21584_0,,,,2,2,1,3
C(C(C)C(C(O)=O)(CO)O)=O,,,5,1,2,0,2
21585_0,,,,2,2,1,3
21587_0,,,,2,2,1,3
C(C(CO)(CC(C)=O)O)(O)=O,,,5,1,1,0,1
21589_0,,,,2,2,1,3
C(C(CO)(CCC=O)O)(O)=O,,,5,1,2,0,2
21591_0,,,,2,2,1,3
C(C(CCO)C(C(O)=O)(CO)O)=O,,,5,1,3,0,3
21592_0,,,,2,2,1,3
21594_0,,,,2,2,1,3
C(C(CO)(CC(CCO)=O)O)(O)=O,,,5,1,1,0,1
21596_0,,,,2,2,1,3
C(C(CO)(CCC(C=O)O)O)(O)=O,,,5,1,1,0,1
21598_0,,,,2,2,1,3
C(C(CO)(CCC(CO)=O)O)(O)=O,,,5,1,3,0,3
21600_0,,,,2,2,1,3
C(C(CO)(C(CO)CC=O)O)(O)=O,,,5,1,4,0,4
21602_0,,,,2,2,1,3
C(C(C)(CC(C(CO)=O)O)O)(O)=O,,,5,1,2,0,2
21604_0,,,,2,2,1,3
C(C(C(C)C(C(CO)=O)O)O)(O)=O,,,5,1,2,0,2
21604_1,,,,2,2,1,3
21606_0,,,,2,2,1,3
C(C(CO)(C(C)C(C=O)O)O)(O)=O,,,5,1,1,0,1
21608_0,,,,2,2,1,3
C(C(CO)(CC)O)(O)=O,,,5,1,1,0,1
21610_0,,,,2,2,1,3
C(C(CC(C(O)=O)O)C(CO)O)=O,,,5,1,3,0,3
21610_1,,,,2,2,1,3
21612_0,,,,2,2,1,3
C(C(CC(C(CO)=O)CO)O)(O)=O,,,5,1,2,0,2
21612_1,,,,2,2,1,3
21614_0,,,,2,2,1,3
C(C(C)C(C(O)=O)(C(CO)O)O)=O,,,5,1,1,0,1
21615_0,,,,2,2,1,3
21617_0,,,,2,2,1,3
C(C(C(CO)O)(CC(C)=O)O)(O)=O,,,5,1,1,0,1
21619_0,,,,2,2,1,3
C(C(CCC=O)(C(CO)O)O)(O)=O,,,5,1,2,0,2
21621_0,,,,2,2,1,3
C(C(C(CO)O)(CC)O)(O)=O,,,5,1,1,0,1
21622_0,,,,2,2,1,3
21624_0,,,,2,2,1,3
C(CC(C(O)=O)O)(C(CO)CO)=O,,,5,1,2,0,2
21624_1,,,,2,2,1,3
21625_0,,,,2,2,1,3
21627_0,,,,2,2,1,3
C(C(C)C(C(O)=O)O)=O,,,5,1,3,0,3
21627_1,,,,2,2,1,3
21628_0,,,,2,2,1,3
21629_0,,,,2,2,1,3
21630_0,,,,2,2,1,3
21632_0,,,,2,2,1,3
C(CCC(C(O)=O)O)(CC=O)=O,,,5,1,3,0,3
21632_1,,,,2,2,1,3
21634_0,,,,2,2,1,3
C(C(CC(CCC=O)=O)O)(O)=O,,,5,1,3,0,3
21634_1,,,,2,2,1,3
21635_0,,,,2,2,1,3
21635_1,,,,2,2,1,3
21636_0,,,,2,2,1,3
21638_0,,,,2,2,1,3
C(C(CCC(C(C)=O)=O)O)(O)=O,,,5,1,3,0,3
21638_1,,,,2,2,1,3
21640_0,,,,2,2,1,3
C(C(CC(CC(C)=O)=O)O)(O)=O,,,5,1,4,0,4
21640_1,,,,2,2,1,3
21642_0,,,,2,2,1,3
C(C(C(C)CC(C=O)=O)O)(O)=O,,,5,1,3,0,3
21642_1,,,,2,2,1,3
21644_0,,,,2,2,1,3
C(C(CC(C(C=O)=O)C)O)(O)=O,,,5,1,3,0,3
21644_1,,,,2,2,1,3
21646_0,,,,2,2,1,3
C(C(CCC(CO)=O)O)(O)=O,,,5,1,5,0,5
21646_1,,,,2,2,1,3
21648_0,,,,2,2,1,3
C(CC(C(O)=O)O)(CCO)=O,,,5,1,5,0,5
21648_1,,,,2,2,1,3
21650_0,,,,2,2,1,3
C(C(CO)O)(CCC(C(O)=O)O)=O,,,5,1,2,0,2
21650_1,,,,2,2,1,3
21652_0,,,,2,2,1,3
C(CC(C(O)=O)O)(CC(CO)O)=O,,,5,1,2,0,2
21652_1,,,,2,2,1,3
21654_0,,,,2,2,1,3
C(CCC(C(O)=O)O)=O,,,5,1,4,0,4
21654_1,,,,2,2,1,3
21655_0,,,,2,2,1,3
21657_0,,,,2,2,1,3
C(C(C=O)CC(C(O)=O)(C)O)=O,,,5,1,2,0,2
21659_0,,,,2,2,1,3
C(C(C=O)C(C)C(C(O)=O)O)=O,,,5,1,3,0,3
21659_1,,,,2,2,1,3
21661_0,,,,2,2,1,3
C(C(CCO)C(C(O)=O)O)=O,,,5,1,5,0,5
21661_1,,,,2,2,1,3
21662_0,,,,2,2,1,3
21664_0,,,,2,2,1,3
C(C(C(CO)CC(CO)=O)O)(O)=O,,,5,1,3,0,3
21664_1,,,,2,2,1,3
21666_0,,,,2,2,1,3
C(C(CO)C(C(O)=O)O)(CCO)=O,,,5,1,2,0,2
21666_1,,,,2,2,1,3
21668_0,,,,2,2,1,3
C(CC(CO)C(C(O)=O)O)=O,,,5,1,6,0,6
21668_1,,,,2,2,1,3
21670_0,,,,2,2,1,3
C(C)(C(CO)C(C(O)=O)O)=O,,,5,1,3,0,3
21670_1,,,,2,2,1,3
21672_0,,,,2,2,1,3
C(C(CCC(C=O)O)O)(O)=O,,,5,1,2,0,2
21672_1,,,,2,2,1,3
21673_0,,,,2,2,1,3
21674_0,,,,2,2,1,3
21676_0,,,,2,2,1,3
C(C(C)(CCC=O)O)(O)=O,,,5,1,2,0,2
21678_0,,,,2,2,1,3
C(C(C)(CC(C=O)O)O)(O)=O,,,5,1,2,0,2
21680_0,,,,2,2,1,3
C(CC(C)C(C(O)=O)O)=O,,,5,1,3,0,3
21680_1,,,,2,2,1,3
21682_0,,,,2,2,1,3
C(C(C(C)C(C=O)O)O)(O)=O,,,5,1,2,0,2
21682_1,,,,2,2,1,3
21684_0,,,,2,2,1,3
C(C(CC)O)(O)=O,,,5,1,2,0,2
21684_1,,,,2,2,1,3
21686_0,,,,2,2,1,3
C(C(C)(C)O)(O)=O,,,5,1,1,0,1
21688_0,,,,2,2,1,3
C(C(CO)C(C(O)=O)O)(O)=O,,,5,1,7,0,7
21688_1,,,,2,2,1,3
21690_0,,,,2,2,1,3
C(C(C(CO)O)C(C(O)=O)O)(O)=O,,,5,1,7,0,7
21690_1,,,,2,2,1,3
21691_0,,,,2,2,1,3
21691_1,,,,2,2,1,3
21692_0,,,,2,2,1,3
21692_1,,,,2,2,1,3
21693_0,,,,2,2,1,3
21695_0,,,,2,2,1,3
C(C(CO)C(C(O)=O)(C)O)(O)=O,,,5,1,4,0,4
21696_0,,,,2,2,1,3
21697_0,,,,2,2,1,3
21698_0,,,,2,2,1,3
21699_0,,,,2,2,1,3
21701_0,,,,2,2,1,3
C(C(C)(CC(C=O)(CO)O)O)(O)=O,,,5,1,1,0,1
21703_0,,,,2,2,1,3
C(C(CO)(C(C)C(C(O)=O)O)O)=O,,,5,1,2,0,2
21703_1,,,,2,2,1,3
21704_0,,,,2,2,1,3
21704_1,,,,2,2,1,3
21705_0,,,,2,2,1,3
21705_1,,,,2,2,1,3
21706_0,,,,2,2,1,3
21708_0,,,,2,2,1,3
C(C(C)(CC(O)=O)O)(O)=O,,,5,1,3,0,3
21710_0,,,,2,2,1,3
C(C(CCO)(CC(O)=O)O)(O)=O,,,5,1,3,0,3
21711_0,,,,2,2,1,3
21713_0,,,,2,2,1,3
C(C(C(C)C(C(O)=O)O)O)(O)=O,,,5,1,2,0,2
21713_1,,,,2,2,1,3
21714_0,,,,2,2,1,3
21714_1,,,,2,2,1,3
21715_0,,,,2,2,1,3
21715_1,,,,2,2,1,3
21716_0,,,,2,2,1,3
21716_1,,,,2,2,1,3
21718_0,,,,2,2,1,3
C(C(C=C(CO)CO)O)(O)=O,,,5,1,3,0,3
21718_1,,,,2,2,1,3
21720_0,,,,2,2,1,3
C(C(C(C(CO)(CO)O)=C)O)(O)=O,,,5,1,2,0,2
21720_1,,,,2,2,1,3
21722_0,,,,2,2,1,3
C(C(C(CO)=C(CO)CO)O)(O)=O,,,5,1,2,0,2
21722_1,,,,2,2,1,3
21724_0,,,,2,2,1,3
C(C(C=C(CO)C(CO)O)O)(O)=O,,,5,1,2,0,2
21724_1,,,,2,2,1,3
21726_0,,,,2,2,1,3
C(C(C=CC(CO)(CO)O)O)(O)=O,,,5,1,2,0,2
21726_1,,,,2,2,1,3
21728_0,,,,2,2,1,3
C(C(C=C(C=O)C)O)(O)=O,,,5,1,3,0,3
21728_1,,,,2,2,1,3
21730_0,,,,2,2,1,3
C(C(CC(C=O)=C)O)(O)=O,,,5,1,3,0,3
21730_1,,,,2,2,1,3
21732_0,,,,2,2,1,3
C(C(C(C(C(O)=O)O)=C)(C)O)=O,,,5,1,3,0,3
21732_1,,,,2,2,1,3
21734_0,,,,2,2,1,3
C(C(C(CO)=C(C=O)C)O)(O)=O,,,5,1,3,0,3
21734_1,,,,2,2,1,3
21736_0,,,,2,2,1,3
C(C(C(C(C=O)=C)CO)O)(O)=O,,,5,1,3,0,3
21736_1,,,,2,2,1,3
21738_0,,,,2,2,1,3
C(C(C=CC(C)=O)O)(O)=O,,,5,1,3,0,3
21738_1,,,,2,2,1,3
21740_0,,,,2,2,1,3
C(C(C(C(C(C)=O)O)=C)O)(O)=O,,,5,1,4,0,4
21740_1,,,,2,2,1,3
21742_0,,,,2,2,1,3
C(C(C(CO)=CC(C)=O)O)(O)=O,,,5,1,3,0,3
21742_1,,,,2,2,1,3
21744_0,,,,2,2,1,3
C(C(CC=CC=O)O)(O)=O,,,5,1,4,0,4
21744_1,,,,2,2,1,3
21746_0,,,,2,2,1,3
C(C(C=CCC=O)O)(O)=O,,,5,1,4,0,4
21746_1,,,,2,2,1,3
21748_0,,,,2,2,1,3
C(C(CC(C=O)=CCO)O)(O)=O,,,5,1,3,0,3
21748_1,,,,2,2,1,3
21750_0,,,,2,2,1,3
C(C(C=C(C=O)CCO)O)(O)=O,,,5,1,3,0,3
21750_1,,,,2,2,1,3
21752_0,,,,2,2,1,3
C(C(C=CC(CCO)=O)O)(O)=O,,,5,1,3,0,3
21752_1,,,,2,2,1,3
21753_0,,,,2,2,1,3
21753_1,,,,2,2,1,3
21755_0,,,,2,2,1,3
C(C(C=CCC(C(O)=O)O)O)=O,,,5,1,3,0,3
21755_1,,,,2,2,1,3
21757_0,,,,2,2,1,3
C(C(C=CCC(C=O)O)O)(O)=O,,,5,1,3,0,3
21757_1,,,,2,2,1,3
21759_0,,,,2,2,1,3
C(C(CC=CC(CO)=O)O)(O)=O,,,5,1,3,0,3
21759_1,,,,2,2,1,3
21761_0,,,,2,2,1,3
C(C(C=CCC(CO)=O)O)(O)=O,,,5,1,3,0,3
21761_1,,,,2,2,1,3
21763_0,,,,2,2,1,3
C(C(CC(CO)=CC=O)O)(O)=O,,,5,1,3,0,3
21763_1,,,,2,2,1,3
21765_0,,,,2,2,1,3
C(CC(CO)=CC(C(O)=O)O)=O,,,5,1,3,0,3
21765_1,,,,2,2,1,3
21767_0,,,,2,2,1,3
C(C(C=CC(C(C)=O)O)O)(O)=O,,,5,1,4,0,4
21767_1,,,,2,2,1,3
21769_0,,,,2,2,1,3
C(C(C(CC(C(O)=O)O)=C)O)=O,,,5,1,3,0,3
21769_1,,,,2,2,1,3
21771_0,,,,2,2,1,3
C(C(C=C(C)C(C=O)O)O)(O)=O,,,5,1,3,0,3
21771_1,,,,2,2,1,3
21773_0,,,,2,2,1,3
C(C(CC=C)O)(O)=O,,,5,1,3,0,3
21773_1,,,,2,2,1,3
21775_0,,,,2,2,1,3
C(C(C=CC)O)(O)=O,,,5,1,3,0,3
21775_1,,,,2,2,1,3
21777_0,,,,2,2,1,3
C(C(C=CC(CO)O)O)(O)=O,,,5,1,5,0,5
21777_1,,,,2,2,1,3
21779_0,,,,2,2,1,3
C(C(C=CC(C(CO)O)O)O)(O)=O,,,5,1,2,0,2
21779_1,,,,2,2,1,3
21781_0,,,,2,2,1,3
C(C(C=CCO)O)(O)=O,,,5,1,5,0,5
21781_1,,,,2,2,1,3
21782_0,,,,2,2,1,3
21782_1,,,,2,2,1,3
21784_0,,,,2,2,1,3
C(CC=C(CO)C(C(O)=O)O)=O,,,5,1,3,0,3
21784_1,,,,2,2,1,3
21786_0,,,,2,2,1,3
C(C(C(C=CC=O)CO)O)(O)=O,,,5,1,3,0,3
21786_1,,,,2,2,1,3
21788_0,,,,2,2,1,3
C(C(C(C=C)CO)O)(O)=O,,,5,1,3,0,3
21788_1,,,,2,2,1,3
21790_0,,,,2,2,1,3
C(C(C(CO)=CC)O)(O)=O,,,5,1,3,0,3
21790_1,,,,2,2,1,3
21792_0,,,,2,2,1,3
C(C(C(C(C)O)=C)O)(O)=O,,,5,1,3,0,3
21792_1,,,,2,2,1,3
21794_0,,,,2,2,1,3
C(C(C(CO)=CC(CO)O)O)(O)=O,,,5,1,2,0,2
21794_1,,,,2,2,1,3
21796_0,,,,2,2,1,3
C(C(C(C(C(CO)O)O)=C)O)(O)=O,,,5,1,2,0,2
21796_1,,,,2,2,1,3
21798_0,,,,2,2,1,3
C(C(C(CO)=C)O)(O)=O,,,5,1,5,0,5
21798_1,,,,2,2,1,3
21800_0,,,,2,2,1,3
C(C(C(CO)=CCO)O)(O)=O,,,5,1,6,0,6
21800_1,,,,2,2,1,3
21802_0,,,,2,2,1,3
C(C(C(C(CO)O)=C)O)(O)=O,,,5,1,5,0,5
21802_1,,,,2,2,1,3
21804_0,,,,2,2,1,3
C(C(C1COC(C1O)O)O)(O)=O,,,5,1,3,0,3
21804_1,,,,2,2,1,3
21806_0,,,,2,2,1,3
C(C(C1COC(C1(C)O)O)O)(O)=O,,,5,1,3,0,3
21806_1,,,,2,2,1,3
21808_0,,,,2,2,1,3
C(C(C1COC(C)(C1O)O)O)(O)=O,,,5,1,3,0,3
21808_1,,,,2,2,1,3
21810_0,,,,2,2,1,3
C(C(CC1C(CC(O)O1)O)O)(O)=O,,,5,1,3,0,3
21810_1,,,,2,2,1,3
21812_0,,,,2,2,1,3
C(C(CC1CC(C(O)O1)O)O)(O)=O,,,5,1,3,0,3
21812_1,,,,2,2,1,3
21814_0,,,,2,2,1,3
C(C(C1COC(CC1O)O)O)(O)=O,,,5,1,3,0,3
21814_1,,,,2,2,1,3
21816_0,,,,2,2,1,3
C(C(C(C)O)CCC(C(O)=O)O)=O,,,5,1,2,0,2
21816_1,,,,2,2,1,3
21818_0,,,,2,2,1,3
C(CC(C)(CCC(C(O)=O)O)O)=O,,,5,1,2,0,2
21818_1,,,,2,2,1,3
21820_0,,,,2,2,1,3
C(CC(CCCC(C(O)=O)O)O)=O,,,5,1,2,0,2
21820_1,,,,2,2,1,3
21822_0,,,,2,2,1,3
C(CC(CCC(C(O)=O)O)O)=O,,,5,1,2,0,2
21822_1,,,,2,2,1,3
21824_0,,,,2,2,1,3
C(C(CO)CCC(C(O)=O)O)=O,,,5,1,2,0,2
21824_1,,,,2,2,1,3
21826_0,,,,2,2,1,3
C(C(C)(CCC(C(O)=O)O)O)(O)=O,,,5,1,2,0,2
21826_1,,,,2,2,1,3
21828_0,,,,2,2,1,3
C(C(CCCC(C(O)=O)O)O)(O)=O,,,5,1,2,0,2
21828_1,,,,2,2,1,3
21830_0,,,,2,2,1,3
C(C(CCC(C(C=O)=O)O)O)(O)=O,,,5,1,2,0,2
21830_1,,,,2,2,1,3
21831_0,,,,2,2,1,3
21831_1,,,,2,2,1,3
21832_0,,,,2,2,1,3
21832_1,,,,2,2,1,3
21834_0,,,,2,2,1,3
C(C(CCC(C(C)=O)O)O)(O)=O,,,5,1,2,0,2
21834_1,,,,2,2,1,3
21836_0,,,,2,2,1,3
C(C(CCCC(CO)=O)O)(O)=O,,,5,1,4,0,4
21836_1,,,,2,2,1,3
21838_0,,,,2,2,1,3
C(C(CCC(C)O)O)(O)=O,,,5,1,2,0,2
21838_1,,,,2,2,1,3
21840_0,,,,2,2,1,3
C(C(CCCCO)O)(O)=O,,,5,1,2,0,2
21840_1,,,,2,2,1,3
21842_0,,,,2,2,1,3
C(C(CCCC(C(O)=O)=O)O)(O)=O,,,5,1,4,0,4
21842_1,,,,2,2,1,3
21844_0,,,,2,2,1,3
C(C(C=O)CCC(C(O)=O)O)(O)=O,,,5,1,2,0,2
21844_1,,,,2,2,1,3
21846_0,,,,2,2,1,3
C(CCCC(C(O)=O)O)(O)=O,,,5,1,3,0,3
21846_1,,,,2,2,1,3
21848_0,,,,2,2,1,3
C(C(CO)(CCC(C(O)=O)O)O)=O,,,5,1,2,0,2
21848_1,,,,2,2,1,3
21850_0,,,,2,2,1,3
C(C(CCC(C(C=O)O)O)O)(O)=O,,,5,1,3,0,3
21850_1,,,,2,2,1,3
21852_0,,,,2,2,1,3
C(C(CCCO)O)(O)=O,,,5,1,2,0,2
21852_1,,,,2,2,1,3
21854_0,,,,2,2,1,3
C(C(CCC(CO)O)O)(O)=O,,,5,1,2,0,2
21854_1,,,,2,2,1,3
21856_0,,,,2,2,1,3
C(C(CCC(C(O)=O)O)O)(O)=O,,,5,1,2,0,2
21856_1,,,,2,2,1,3
21858_0,,,,2,2,1,3
C(C(CCC(C(CO)=O)O)O)(O)=O,,,5,1,2,0,2
21858_1,,,,2,2,1,3
21860_0,,,,2,2,1,3
C(C(CCC(CO)(CO)O)O)(O)=O,,,5,1,2,0,2
21860_1,,,,2,2,1,3
21862_0,,,,2,2,1,3
C(C(CCC(C(CO)O)O)O)(O)=O,,,5,1,2,0,2
21862_1,,,,2,2,1,3
21863_0,,,,2,2,1,3
21863_1,,,,2,2,1,3
21865_0,,,,2,2,1,3
C(C(C=O)CCC(C(O)=O)O)=O,,,5,1,3,0,3
21865_1,,,,2,2,1,3
21867_0,,,,2,2,1,3
C(CCCC(C(O)=O)O)=O,,,5,1,3,0,3
21867_1,,,,2,2,1,3
21868_0,,,,2,1,2,3
21869_0,,,,2,1,2,3
21871_0,,,,2,1,2,3
C(CC(C(CC(C=O)=O)=O)O)=O,,,5,1,2,0,2
21873_0,,,,2,1,2,3
C(C(C(C(C=O)=O)C(C)O)=O)=O,,,5,1,1,0,1
21874_0,,,,2,1,2,3
21875_0,,,,2,1,2,3
21876_0,,,,2,1,2,3
21877_0,,,,2,1,2,3
21878_0,,,,2,1,2,3
21879_0,,,,2,1,2,3
21880_0,,,,2,1,2,3
21881_0,,,,2,1,2,3
21882_0,,,,2,1,2,3
21883_0,,,,2,1,2,3
21884_0,,,,2,1,2,3
21885_0,,,,2,1,2,3
21887_0,,,,2,1,2,3
C(C(C(C(C=O)=O)O)=O)=O,,,5,1,1,0,1
21889_0,,,,2,1,2,3
C(C(C(C(C(C)=O)=O)O)=O)=O,,,5,1,2,0,2
21890_0,,,,2,1,2,3
21892_0,,,,2,1,2,3
C(C(C)=O)(C(C(C(C)=O)=O)O)=O,,,5,1,1,0,1
21894_0,,,,2,1,2,3
C(C(CC(C(CO)=O)=O)=O)=O,,,5,1,2,0,2
21896_0,,,,2,1,2,3
C(C(C)=O)(CC(C(CO)=O)=O)=O,,,5,1,2,0,2
21897_0,,,,2,1,2,3
21898_0,,,,2,1,2,3
21900_0,,,,2,1,2,3
C(C)(C(C(C(C)=O)=O)O)=O,,,5,1,4,0,4
21902_0,,,,2,1,2,3
C(C)(C(C(C(CCO)=O)=O)O)=O,,,5,1,3,0,3
21903_0,,,,2,1,2,3
21904_0,,,,2,1,2,3
21905_0,,,,2,1,2,3
21906_0,,,,2,1,2,3
21907_0,,,,2,1,2,3
21908_0,,,,2,1,2,3
21910_0,,,,2,1,2,3
C(CCO)(C(C(C(C)=O)=O)O)=O,,,5,1,3,0,3
21911_0,,,,2,1,2,3
21912_0,,,,2,1,2,3
21913_0,,,,2,1,2,3
21915_0,,,,2,1,2,3
C(C(CC(C(O)=O)=O)=O)=O,,,5,1,2,0,2
21916_0,,,,2,1,2,3
21918_0,,,,2,1,2,3
C(C(C(C(C=O)=O)CO)=O)(O)=O,,,5,1,2,0,2
21919_0,,,,2,1,2,3
21920_0,,,,2,1,2,3
21921_0,,,,2,1,2,3
21922_0,,,,2,1,2,3
21923_0,,,,2,1,2,3
21925_0,,,,2,1,2,3
C1(C(COC1C(C=O)=O)O)=O,,,5,1,1,0,1
21927_0,,,,2,1,2,3
C1(C(O)OCC1C(C=O)=O)=O,,,5,1,1,0,1
21929_0,,,,2,1,2,3
C1(COC(C1C(C=O)=O)O)=O,,,5,1,1,0,1
21931_0,,,,2,1,2,3
C1(CC(OC1C(C=O)=O)O)=O,,,5,1,1,0,1
21933_0,,,,2,1,2,3
C(CO)(C(C(C=O)=O)O)=O,,,5,1,5,0,5
21935_0,,,,2,1,2,3
C(C(CO)O)(C(C(C=O)=O)O)=O,,,5,1,3,0,3
21937_0,,,,2,1,2,3
C(C(CC(C=O)=O)=O)=O,,,5,1,4,0,4
21939_0,,,,2,1,2,3
C(C(C=O)C(C=O)=O)=O,,,5,1,3,0,3
21941_0,,,,2,1,2,3
C(C(C(C(C=O)=O)CO)=O)=O,,,5,1,2,0,2
21942_0,,,,2,1,2,3
21944_0,,,,2,1,2,3
C(C(C(CO)=O)C(C=O)=O)=O,,,5,1,1,0,1
21946_0,,,,2,1,2,3
C(CC(C(C(C=O)=O)O)=O)=O,,,5,1,1,0,1
21948_0,,,,2,1,2,3
C(C(C(CC(C=O)=O)=O)O)=O,,,5,1,1,0,1
21950_0,,,,2,1,2,3
C(C(O)=O)(CC(C(C)=O)=O)=O,,,5,1,2,0,2
21951_0,,,,2,1,2,3
21953_0,,,,2,1,2,3
C1(C(COC1C(C(C)=O)=O)O)=O,,,5,1,1,0,1
21955_0,,,,2,1,2,3
C1(C(O)OCC1C(C(C)=O)=O)=O,,,5,1,1,0,1
21957_0,,,,2,1,2,3
C1(COC(C1C(C(C)=O)=O)O)=O,,,5,1,1,0,1
21959_0,,,,2,1,2,3
C1(CC(OC1C(C(C)=O)=O)O)=O,,,5,1,1,0,1
21961_0,,,,2,1,2,3
C(CO)(C(C(C(C)=O)=O)O)=O,,,5,1,4,0,4
21963_0,,,,2,1,2,3
C(C(CC(C(C)=O)=O)=O)=O,,,5,1,5,0,5
21965_0,,,,2,1,2,3
C(C(C=O)C(C(C)=O)=O)=O,,,5,1,1,0,1
21967_0,,,,2,1,2,3
C(C(C(C(C(C)=O)=O)CO)=O)=O,,,5,1,2,0,2
21968_0,,,,2,1,2,3
21970_0,,,,2,1,2,3
C(C(C(CO)=O)C(C(C)=O)=O)=O,,,5,1,1,0,1
21972_0,,,,2,1,2,3
C(CC(C(C(C(C)=O)=O)O)=O)=O,,,5,1,1,0,1
21974_0,,,,2,1,2,3
C(C(C=O)O)(CC(C(C)=O)=O)=O,,,5,1,1,0,1
21975_0,,,,2,1,2,3
21977_0,,,,2,1,2,3
C(C(C(C(C)=O)=O)O)=O,,,5,1,7,0,7
21979_0,,,,2,1,2,3
C(C(CC(C(CCO)=O)=O)=O)=O,,,5,1,2,0,2
21981_0,,,,2,1,2,3
C(C(C=O)C(C(CCO)=O)=O)=O,,,5,1,1,0,1
21982_0,,,,2,1,2,3
21984_0,,,,2,1,2,3
C(C(C(C(CCO)=O)=O)O)=O,,,5,1,4,0,4
21985_0,,,,2,1,2,3
21986_0,,,,2,1,2,3
21987_0,,,,2,1,2,3
21988_0,,,,2,1,2,3
21989_0,,,,2,1,2,3
21990_0,,,,2,1,2,3
21991_0,,,,2,1,2,3
21992_0,,,,2,1,2,3
21993_0,,,,2,1,2,3
21994_0,,,,2,1,2,3
21995_0,,,,2,1,2,3
21996_0,,,,2,1,2,3
21997_0,,,,2,1,2,3
21998_0,,,,2,1,2,3
21999_0,,,,2,1,2,3
22000_0,,,,2,1,2,3
22001_0,,,,2,1,2,3
22002_0,,,,2,1,2,3
22003_0,,,,2,1,2,3
22004_0,,,,2,1,2,3
22005_0,,,,2,1,2,3
22006_0,,,,2,1,2,3
22007_0,,,,2,1,2,3
22008_0,,,,2,1,2,3
22009_0,,,,2,1,2,3
22010_0,,,,2,1,2,3
22011_0,,,,2,1,2,3
22012_0,,,,2,1,2,3
22013_0,,,,2,1,2,3
22014_0,,,,2,1,2,3
22015_0,,,,2,1,2,3
22016_0,,,,2,1,2,3
22017_0,,,,2,1,2,3
22018_0,,,,2,1,2,3
22019_0,,,,2,1,2,3
22020_0,,,,2,1,2,3
22021_0,,,,2,1,2,3
22022_0,,,,2,1,2,3
22023_0,,,,2,1,2,3
22024_0,,,,2,1,2,3
22025_0,,,,2,1,2,3
22026_0,,,,2,1,2,3
22027_0,,,,2,1,2,3
22028_0,,,,2,1,2,3
22029_0,,,,2,1,2,3
22030_0,,,,2,1,2,3
22031_0,,,,2,1,2,3
22033_0,,,,2,1,2,3
C(C(C(CO)=O)=O)=O,,,5,1,13,0,13
22035_0,,,,2,1,2,3
C(C(C=O)=O)=O,,,5,1,36,0,36
22036_0,,,,2,1,2,3
22038_0,,,,2,1,2,3
C(C(C(CO)=O)=O)(CO)=O,,,5,1,2,0,2
22040_0,,,,2,1,2,3
C(C(C(CO)=O)=O)(C(CO)O)=O,,,5,1,2,0,2
22042_0,,,,2,1,2,3
C(C(C(CO)=O)=O)(C(C)O)=O,,,5,1,2,0,2
22044_0,,,,2,1,2,3
C(C(C(C(C)O)=O)=O)=O,,,5,1,3,0,3
22046_0,,,,2,1,2,3
C(C(C(C(CCO)O)=O)=O)=O,,,5,1,2,0,2
22048_0,,,,2,1,2,3
C(C(C)O)(C(C(C=O)=O)O)=O,,,5,1,2,0,2
22050_0,,,,2,1,2,3
C(CO)(C(C(C=O)=O)(C)O)=O,,,5,1,2,0,2
22051_0,,,,2,1,2,3
22053_0,,,,2,1,2,3
C(C(CO)=O)(C(CO)(C)O)=O,,,5,1,4,0,4
22055_0,,,,2,1,2,3
C(C(CO)=O)(C(CCO)O)=O,,,5,1,4,0,4
22056_0,,,,2,1,2,3
22057_0,,,,2,1,2,3
22059_0,,,,2,1,2,3
C(C(C(CO)(CCO)O)=O)=O,,,5,1,6,0,6
22060_0,,,,2,1,2,3
22061_0,,,,2,1,2,3
22062_0,,,,2,1,2,3
22063_0,,,,2,1,2,3
22065_0,,,,2,1,2,3
C(CO)(C(C(C=O)=O)(CO)O)=O,,,5,1,2,0,2
22066_0,,,,2,1,2,3
22068_0,,,,2,1,2,3
C(C(C(C=O)=O)(CO)O)(O)=O,,,5,1,3,0,3
22070_0,,,,2,1,2,3
C(C(C(C(C(C)=O)=O)=O)O)=O,,,5,1,2,0,2
22072_0,,,,2,1,2,3
C(C(C(C)=O)(C(C=O)=O)O)=O,,,5,1,1,0,1
22074_0,,,,2,1,2,3
C(C(C(C=O)=O)(CO)O)=O,,,5,1,5,0,5
22076_0,,,,2,1,2,3
C(C(C(C=O)=O)(C(CO)O)O)=O,,,5,1,3,0,3
22078_0,,,,2,1,2,3
C(C(C(C(C)=O)=O)(CO)O)(O)=O,,,5,1,3,0,3
22080_0,,,,2,1,2,3
C(C(C(C(CO)=O)=O)(C)O)(O)=O,,,5,1,3,0,3
22082_0,,,,2,1,2,3
C(CC(C(C(CO)=O)=O)O)(O)=O,,,5,1,2,0,2
22084_0,,,,2,1,2,3
C(C(C(C(C(C)=O)=O)=O)(C)O)=O,,,5,1,1,0,1
22086_0,,,,2,1,2,3
C(C(C(C)=O)(C(C(C)=O)=O)O)=O,,,5,1,1,0,1
22088_0,,,,2,1,2,3
C(C(C(C(C)=O)=O)(CO)O)=O,,,5,1,1,0,1
22090_0,,,,2,1,2,3
C(C)(C(C(C(C(C)=O)=O)=O)O)=O,,,5,1,1,0,1
22092_0,,,,2,1,2,3
C(CC(C(C(C(C)=O)=O)=O)O)=O,,,5,1,1,0,1
22094_0,,,,2,1,2,3
C(C(C(C)=O)=O)(C(C)O)=O,,,5,1,2,0,2
22096_0,,,,2,1,2,3
C(C(C(CO)=O)=O)(C)=O,,,5,1,2,0,2
22098_0,,,,2,1,2,3
C(C(C(C)=O)=O)(C(CO)O)=O,,,5,1,2,0,2
22100_0,,,,2,1,2,3
C(CC(C(C(C=O)O)=O)=O)=O,,,5,1,2,0,2
22102_0,,,,2,1,2,3
C(C(C(C=O)=O)(CC=O)O)=O,,,5,1,1,0,1
22103_0,,,,2,1,2,3
22105_0,,,,2,1,2,3
C(C(C(C(CC=O)=O)=O)(C)O)=O,,,5,1,1,0,1
22107_0,,,,2,1,2,3
C(C(C(C(C)=O)=O)(CC=O)O)=O,,,5,1,1,0,1
22109_0,,,,2,1,2,3
C(C(C(C=O)=O)(C)O)(O)=O,,,5,1,4,0,4
22110_0,,,,2,1,2,3
22112_0,,,,2,1,2,3
C(CC(C(C(C(C)=O)O)=O)=O)=O,,,5,1,1,0,1
22114_0,,,,2,1,2,3
C(CC(C(C(CC=O)O)=O)=O)=O,,,5,1,1,0,1
22116_0,,,,2,1,2,3
C(CC(C(C=O)=O)O)(O)=O,,,5,1,3,0,3
22118_0,,,,2,1,2,3
C(C(C(C=O)=O)(CCO)O)(O)=O,,,5,1,3,0,3
22119_0,,,,2,1,2,3
22121_0,,,,2,1,2,3
C(CC(C(C(C)O)=O)=O)=O,,,5,1,4,0,4
22122_0,,,,2,1,2,3
22123_0,,,,2,1,2,3
22124_0,,,,2,1,2,3
22126_0,,,,2,1,2,3
C(C(CC(C(C=O)=O)O)O)(O)=O,,,5,1,3,0,3
22127_0,,,,2,1,2,3
22129_0,,,,2,1,2,3
C(CC(C(C=O)=O)(CO)O)(O)=O,,,5,1,2,0,2
22130_0,,,,2,1,2,3
22132_0,,,,2,1,2,3
C(CO)(CC(C(CO)=O)=O)=O,,,5,1,5,0,5
22134_0,,,,2,1,2,3
C(C(C(CO)=O)=O)(CCO)=O,,,5,1,2,0,2
22135_0,,,,2,1,2,3
22137_0,,,,2,1,2,3
C(C(C(C=O)=O)(C(C=O)O)O)=O,,,5,1,3,0,3
22139_0,,,,2,1,2,3
C(C(C=O)(C(C=O)=O)C(C)O)=O,,,5,1,1,0,1
22141_0,,,,2,1,2,3
C(C(C=O)(C(C=O)=O)CO)=O,,,5,1,1,0,1
22143_0,,,,2,1,2,3
C(C(C=O)(C(C(C)=O)=O)CO)=O,,,5,1,1,0,1
22145_0,,,,2,1,2,3
C(C(CO)=O)(C(CC(C)O)O)=O,,,5,1,1,0,1
22147_0,,,,2,1,2,3
C(C(C(C=O)=O)(C(C)O)O)=O,,,5,1,4,0,4
22149_0,,,,2,1,2,3
C(C(C(C(C)=O)=O)(C(C)O)O)=O,,,5,1,2,0,2
22151_0,,,,2,1,2,3
C(C(C(C)=O)=O)(C(CCO)O)=O,,,5,1,1,0,1
22153_0,,,,2,1,2,3
C(C(C(C)O)=O)(C(CCO)O)=O,,,5,1,1,0,1
22155_0,,,,2,1,2,3
C(C(C(C(CO)=O)=O)(CO)O)=O,,,5,1,3,0,3
22157_0,,,,2,1,2,3
C(CO)(C(C(C(CO)=O)=O)O)=O,,,5,1,1,0,1
22159_0,,,,2,1,2,3
C(C(C(C(C=O)=O)(CO)O)=O)=O,,,5,1,1,0,1
22161_0,,,,2,1,2,3
C(C(C(C)=O)=O)(C(CO)(C)O)=O,,,5,1,1,0,1
22163_0,,,,2,1,2,3
C(C(C(C)O)=O)(C(CO)(C)O)=O,,,5,1,1,0,1
22165_0,,,,2,1,2,3
C(C)(C(C(C=O)=O)(CO)O)=O,,,5,1,5,0,5
22167_0,,,,2,1,2,3
C(C)(C(C(C(C)=O)=O)(CO)O)=O,,,5,1,2,0,2
22168_0,,,,2,1,2,3
22170_0,,,,2,1,2,3
C(C(C(C(C(C)=O)=O)=O)O)(O)=O,,,5,1,1,0,1
22172_0,,,,2,1,2,3
C(C(C(C)=O)(C(C=O)=O)O)(O)=O,,,5,1,3,0,3
22173_0,,,,2,1,2,3
22175_0,,,,2,1,2,3
C(C(C(C=O)=O)(C(C)O)O)(O)=O,,,5,1,3,0,3
22177_0,,,,2,1,2,3
C1(COCC1(C(C=O)=O)O)=O,,,5,1,1,0,1
22179_0,,,,2,1,2,3
C1(C(C(C=O)=O)C(CO1)O)=O,,,5,1,3,0,3
22181_0,,,,2,1,2,3
C1(C(C(C=O)=O)(C(CO1)O)O)=O,,,5,1,1,0,1
22183_0,,,,2,1,2,3
C1(COCC1(C(C(C)=O)=O)O)=O,,,5,1,1,0,1
22185_0,,,,2,1,2,3
C1(C(C(C(C)=O)=O)C(CO1)O)=O,,,5,1,2,0,2
22187_0,,,,2,1,2,3
C(C(C(C(C(C=O)O)=O)=O)O)=O,,,5,1,1,0,1
22189_0,,,,2,1,2,3
C(C(C(C(C(C)O)=O)=O)O)=O,,,5,1,1,0,1
22191_0,,,,2,1,2,3
C(C(C(C(C(C)O)=O)=O)(C)O)=O,,,5,1,1,0,1
22193_0,,,,2,1,2,3
C(C)(C(C(C(C(C)O)=O)=O)O)=O,,,5,1,1,0,1
22195_0,,,,2,1,2,3
C(C)(C(C(C=O)=O)(C(C)O)O)=O,,,5,1,4,0,4
22197_0,,,,2,1,2,3
C(CC(C(C(C(C)O)=O)=O)O)=O,,,5,1,3,0,3
22199_0,,,,2,1,2,3
C(C(C(C)O)=O)(C(C)O)=O,,,5,1,1,0,1
22201_0,,,,2,1,2,3
C(C(C(C(C)O)=O)=O)(CCO)=O,,,5,1,1,0,1
22203_0,,,,2,1,2,3
C(C(C=C)(C(C(CO)=O)=O)O)=O,,,5,1,1,0,1
22205_0,,,,2,1,2,3
C=CC(C(C(C(CO)=O)=O)O)=O,,,5,1,1,0,1
22207_0,,,,2,1,2,3
C(C(C(C(CO)=O)=O)O)=CC=O,,,5,1,1,0,1
22208_0,,,,2,1,2,3
22210_0,,,,2,1,2,3
C(CC(C(C)=O)(C(C=O)=O)O)=O,,,5,1,1,0,1
22211_0,,,,2,1,2,3
22213_0,,,,2,1,2,3
C(C(C(C=O)=O)(CC(C)O)O)=O,,,5,1,1,0,1
22214_0,,,,2,1,2,3
22216_0,,,,2,1,2,3
C(C(C)=O)(C(CC(C)O)O)=O,,,5,1,1,0,1
22217_0,,,,2,1,2,3
22218_0,,,,2,1,2,3
22219_0,,,,2,1,2,3
22221_0,,,,2,1,2,3
C(C(C)=O)(C(CCO)O)=O,,,5,1,2,0,2
22223_0,,,,2,1,2,3
C(C(C(CCO)O)=O)(CCO)=O,,,5,1,2,0,2
22225_0,,,,2,1,2,3
C(CC(C(C(CCO)O)=O)=O)=O,,,5,1,2,0,2
22227_0,,,,2,1,2,3
C(C(C)=O)(C(CC(CO)O)O)=O,,,5,1,1,0,1
22229_0,,,,2,1,2,3
C(CO)(C(C(C(C)=O)=O)(C)O)=O,,,5,1,1,0,1
22231_0,,,,2,1,2,3
C(C(C)O)(C(C(C(C)=O)=O)O)=O,,,5,1,3,0,3
22233_0,,,,2,1,2,3
C(C(C)=O)(C(CO)(C)O)=O,,,5,1,2,0,2
22235_0,,,,2,1,2,3
C(C(C)=O)(C(CO)(CCO)O)=O,,,5,1,1,0,1
22236_0,,,,2,1,2,3
22238_0,,,,2,1,2,3
C(C(C)=O)(C(C)(C(CO)O)O)=O,,,5,1,1,0,1
22240_0,,,,2,1,2,3
C(C(C(C(C)=O)=O)(C)O)(O)=O,,,5,1,1,0,1
22242_0,,,,2,1,2,3
C(CC(C(C(C)=O)=O)O)(O)=O,,,5,1,3,0,3
22244_0,,,,2,1,2,3
C(C(C)=O)(C1(COCC1O)O)=O,,,5,1,1,0,1
22246_0,,,,2,1,2,3
C(C(C)=O)(C1(C(O)OCC1)O)=O,,,5,1,1,0,1
22248_0,,,,2,1,2,3
C(C(C)=O)(C1(COC(C1)O)O)=O,,,5,1,1,0,1
22250_0,,,,2,1,2,3
C(C(C=C)(C(C(C)=O)=O)O)=O,,,5,1,1,0,1
22252_0,,,,2,1,2,3
C=CC(C(C(C(C)=O)=O)O)=O,,,5,1,1,0,1
22254_0,,,,2,1,2,3
C(C(C(C(C)=O)=O)O)=CC=O,,,5,1,3,0,3
22255_0,,,,2,1,2,3
22257_0,,,,2,1,2,3
C(C(C)=O)(C(CO)(CO)O)=O,,,5,1,5,0,5
22259_0,,,,2,1,2,3
C(C(C(C(C)=O)=O)(C)O)=O,,,5,1,3,0,3
22260_0,,,,2,1,2,3
22262_0,,,,2,1,2,3
C(C(C(C(C)=O)=O)(CCO)O)=O,,,5,1,2,0,2
22263_0,,,,2,1,2,3
22265_0,,,,2,1,2,3
C(C(CC(C(C(C)=O)=O)O)O)=O,,,5,1,2,0,2
22266_0,,,,2,1,2,3
22268_0,,,,2,1,2,3
C(CC(C(C(C)=O)=O)(CO)O)=O,,,5,1,3,0,3
22269_0,,,,2,1,2,3
22271_0,,,,2,1,2,3
C(C(C(C(C(C)=O)=O)(C)O)O)=O,,,5,1,2,0,2
22273_0,,,,2,1,2,3
C(C(C)=O)(C(C)O)=O,,,5,1,9,0,9
22274_0,,,,2,1,2,3
22276_0,,,,2,1,2,3
C(C(CCO)=O)(C(CO)(C)O)=O,,,5,1,2,0,2
22278_0,,,,2,1,2,3
C(C(C(C(CCO)=O)=O)(C)O)=O,,,5,1,3,0,3
22279_0,,,,2,1,2,3
22281_0,,,,2,1,2,3
C(C(C(C)O)=O)(CCO)=O,,,5,1,4,0,4
22282_0,,,,2,1,2,3
22283_0,,,,2,1,2,3
22285_0,,,,2,1,2,3
C(C(C(C(C=O)=O)(C)O)=O)=O,,,5,1,1,0,1
22287_0,,,,2,1,2,3
C(C(C(C(C(C)=O)=O)(C)O)=O)=O,,,5,1,1,0,1
22289_0,,,,2,1,2,3
C(CC(C(C(CO)(C)O)=O)=O)=O,,,5,1,2,0,2
22290_0,,,,2,1,2,3
22292_0,,,,2,1,2,3
C(C(C(C=O)=O)(CC=O)O)(O)=O,,,5,1,2,0,2
22294_0,,,,2,1,2,3
C(C(C(C=O)=O)(CC(O)=O)O)=O,,,5,1,1,0,1
22296_0,,,,2,1,2,3
C1(CCOC1(C(C=O)=O)O)=O,,,5,1,1,0,1
22298_0,,,,2,1,2,3
C1(CCOC1(C(C(C)=O)=O)O)=O,,,5,1,1,0,1
22300_0,,,,2,1,2,3
C(CO)(CC(C(C(C)O)=O)=O)=O,,,5,1,3,0,3
22302_0,,,,2,1,2,3
C(C(C1(COCC1O)O)=O)=O,,,5,1,1,0,1
22304_0,,,,2,1,2,3
C(C(C1(C(O)OCC1)O)=O)=O,,,5,1,2,0,2
22306_0,,,,2,1,2,3
C(C(C1(COC(C1)O)O)=O)=O,,,5,1,2,0,2
22308_0,,,,2,1,2,3
C(C(C=C)(C(C=O)=O)O)=O,,,5,1,3,0,3
22310_0,,,,2,1,2,3
C=CC(C(C(C=O)=O)O)=O,,,5,1,3,0,3
22312_0,,,,2,1,2,3
C(C(C(C=O)=O)O)=CC=O,,,5,1,5,0,5
22313_0,,,,2,1,2,3
22314_0,,,,2,1,2,3
22316_0,,,,2,1,2,3
C(CCC(C(C=O)=O)=O)=O,,,5,1,3,0,3
22317_0,,,,2,1,2,3
22318_0,,,,2,1,2,3
22320_0,,,,2,1,2,3
C(C)(CC(C(C=O)=O)=O)=O,,,5,1,3,0,3
22322_0,,,,2,1,2,3
C(C(C(C(C=O)=O)C)=O)=O,,,5,1,2,0,2
22324_0,,,,2,1,2,3
C=C(C=O)C(C(CO)=O)=O,,,5,1,3,0,3
22326_0,,,,2,1,2,3
C(C=CC(C(CO)=O)=O)=O,,,5,1,6,0,6
22328_0,,,,2,1,2,3
C=CC(C(CO)=O)=O,,,5,1,6,0,6
22330_0,,,,2,1,2,3
C=CC(C(C(CO)O)=O)=O,,,5,1,3,0,3
22332_0,,,,2,1,2,3
C=C(C=O)C(C=O)=O,,,5,1,6,0,6
22333_0,,,,2,1,2,3
22335_0,,,,2,1,2,3
C(CO)=C(C=O)C(C=O)=O,,,5,1,3,0,3
22337_0,,,,2,1,2,3
C(C(C=CC(C=O)=O)O)=O,,,5,1,2,0,2
22339_0,,,,2,1,2,3
C(C(C=CC(CO)=O)=O)=O,,,5,1,5,0,5
22340_0,,,,2,1,2,3
22341_0,,,,2,1,2,3
22343_0,,,,2,1,2,3
C=CC(C(C=O)=O)=O,,,5,1,2,0,2
22345_0,,,,2,1,2,3
C(CO)=CC(C(C=O)=O)=O,,,5,1,2,0,2
22347_0,,,,2,1,2,3
C1(C(COC(C1O)O)=O)=O,,,5,1,2,0,2
22349_0,,,,2,1,2,3
C1(C(C(CO)OC(C1O)O)=O)=O,,,5,1,2,0,2
22351_0,,,,2,1,2,3
C1(C(COC(C1(C)O)O)=O)=O,,,5,1,2,0,2
22353_0,,,,2,1,2,3
C1(C(COC(C)(C1O)O)=O)=O,,,5,1,2,0,2
22355_0,,,,2,1,2,3
C(C(C1C(CC(O1)O)O)=O)=O,,,5,1,2,0,2
22357_0,,,,2,1,2,3
C(C(C1CC(C(O1)O)O)=O)=O,,,5,1,2,0,2
22358_0,,,,2,1,2,3
22359_0,,,,2,1,2,3
22361_0,,,,2,1,2,3
C(C(C1(CC(CO1)O)O)=O)=O,,,5,1,2,0,2
22363_0,,,,2,1,2,3
C1(C(C(COC(C1O)O)O)=O)=O,,,5,1,2,0,2
22365_0,,,,2,1,2,3
C1(C(COC(CC1O)O)=O)=O,,,5,1,2,0,2
22366_0,,,,2,1,2,3
22367_0,,,,2,1,2,3
22368_0,,,,2,1,2,3
22369_0,,,,2,1,2,3
22370_0,,,,2,1,2,3
22372_0,,,,2,1,2,3
C(C(CCC(C=O)=O)=O)=O,,,5,1,2,0,2
22374_0,,,,2,1,2,3
C(C(CCC(C(CO)=O)=O)=O)=O,,,5,1,1,0,1
22375_0,,,,2,1,2,3
22377_0,,,,2,1,2,3
C(C(C(C(CO)=O)=O)CC=O)=O,,,5,1,2,0,2
22378_0,,,,2,1,2,3
22379_0,,,,2,1,1,2
22379_1,,,,2,1,1,2
22380_0,,,,2,1,1,2
22380_1,,,,2,1,1,2
22381_0,,,,2,1,1,2
22381_1,,,,2,1,1,2
22382_0,,,,2,1,1,2
22382_1,,,,2,1,1,2
22383_0,,,,2,1,1,2
22383_1,,,,2,1,1,2
22384_0,,,,2,1,1,2
22384_1,,,,2,1,1,2
22385_0,,,,2,1,1,2
22386_0,,,,2,1,1,2
22386_1,,,,2,1,1,2
22387_0,,,,2,1,1,2
22387_1,,,,2,1,1,2
22388_0,,,,2,1,1,2
22388_1,,,,2,1,1,2
22389_0,,,,2,1,1,2
22389_1,,,,2,1,1,2
22390_0,,,,2,1,2,3
22390_1,,,,2,1,2,3
22391_0,,,,2,1,1,2
22391_1,,,,2,1,1,2
22392_0,,,,2,1,1,2
22392_1,,,,2,1,1,2
22393_0,,,,2,1,1,2
22393_1,,,,2,1,1,2
22394_0,,,,2,1,1,2
22394_1,,,,2,1,1,2
22395_0,,,,2,1,1,2
22395_1,,,,2,1,1,2
22396_0,,,,2,1,1,2
22396_1,,,,2,1,1,2
22397_0,,,,2,1,1,2
22397_1,,,,2,1,1,2
22398_0,,,,2,1,1,2
22399_0,,,,2,1,1,2
22399_1,,,,2,1,1,2
22400_0,,,,2,1,1,2
22400_1,,,,2,1,1,2
22401_0,,,,2,1,1,2
22401_1,,,,2,1,1,2
22402_0,,,,2,1,1,2
22402_1,,,,2,1,1,2
22403_0,,,,2,1,1,2
22404_0,,,,2,1,1,2
22404_1,,,,2,1,1,2
22405_0,,,,2,1,1,2
22406_0,,,,2,1,1,2
22406_1,,,,2,1,1,2
22407_0,,,,2,1,1,2
22407_1,,,,2,1,1,2
22408_0,,,,2,1,1,2
22408_1,,,,2,1,1,2
22409_0,,,,2,1,1,2
22409_1,,,,2,1,1,2
22410_0,,,,2,1,1,2
22411_0,,,,2,1,1,2
22412_0,,,,2,1,1,2
22412_1,,,,2,1,1,2
22413_0,,,,2,1,1,2
22413_1,,,,2,1,1,2
22414_0,,,,2,1,1,2
22415_0,,,,2,1,1,2
22416_0,,,,2,1,2,3
22416_1,,,,2,1,2,3
22417_0,,,,2,1,1,2
22417_1,,,,2,1,1,2
22418_0,,,,2,1,1,2
22419_0,,,,2,1,1,2
22419_1,,,,2,1,1,2
22420_0,,,,2,1,1,2
22420_1,,,,2,1,1,2
22421_0,,,,2,1,1,2
22422_0,,,,2,1,1,2
22423_0,,,,2,1,1,2
22423_1,,,,2,1,1,2
22424_0,,,,2,1,1,2
22424_1,,,,2,1,1,2
22425_0,,,,2,1,1,2
22426_0,,,,2,1,1,2
22426_1,,,,2,1,1,2
22427_0,,,,2,1,1,2
22427_1,,,,2,1,1,2
22428_0,,,,2,1,1,2
22429_0,,,,2,1,1,2
22430_0,,,,2,1,1,2
22430_1,,,,2,1,1,2
22431_0,,,,2,1,2,3
22432_0,,,,2,1,1,2
22432_1,,,,2,1,1,2
22433_0,,,,2,1,1,2
22434_0,,,,2,1,1,2
22434_1,,,,2,1,1,2
22435_0,,,,2,1,1,2
22436_0,,,,2,1,1,2
22437_0,,,,2,1,2,3
22437_1,,,,2,1,2,3
22438_0,,,,2,1,1,2
22439_0,,,,2,1,1,2
22440_0,,,,2,1,1,2
22440_1,,,,2,1,1,2
22441_0,,,,2,1,1,2
22442_0,,,,2,1,2,3
22442_1,,,,2,1,2,3
22443_0,,,,2,1,1,2
22443_1,,,,2,1,1,2
22444_0,,,,2,1,1,2
22444_1,,,,2,1,1,2
22445_0,,,,2,1,1,2
22445_1,,,,2,1,1,2
22446_0,,,,2,1,1,2
22446_1,,,,2,1,1,2
22447_0,,,,2,1,1,2
22447_1,,,,2,1,1,2
22448_0,,,,2,1,1,2
22449_0,,,,2,1,1,2
22449_1,,,,2,1,1,2
22450_0,,,,2,1,1,2
22450_1,,,,2,1,1,2
22451_0,,,,2,1,1,2
22451_1,,,,2,1,1,2
22452_0,,,,2,1,1,2
22453_0,,,,2,1,2,3
22453_1,,,,2,1,2,3
22454_0,,,,2,1,1,2
22454_1,,,,2,1,1,2
22455_0,,,,2,1,1,2
22455_1,,,,2,1,1,2
22456_0,,,,2,1,1,2
22456_1,,,,2,1,1,2
22457_0,,,,2,1,1,2
22457_1,,,,2,1,1,2
22458_0,,,,2,1,1,2
22458_1,,,,2,1,1,2
22459_0,,,,2,1,1,2
22459_1,,,,2,1,1,2
22460_0,,,,2,1,1,2
22460_1,,,,2,1,1,2
22461_0,,,,2,1,1,2
22462_0,,,,2,1,1,2
22462_1,,,,2,1,1,2
22463_0,,,,2,1,1,2
22463_1,,,,2,1,1,2
22464_0,,,,2,1,1,2
22464_1,,,,2,1,1,2
22465_0,,,,2,1,1,2
22465_1,,,,2,1,1,2
22466_0,,,,2,1,2,3
22466_1,,,,2,1,2,3
22467_0,,,,2,1,1,2
22467_1,,,,2,1,1,2
22468_0,,,,2,1,1,2
22468_1,,,,2,1,1,2
22469_0,,,,2,1,2,3
22469_1,,,,2,1,2,3
22470_0,,,,2,1,1,2
22470_1,,,,2,1,1,2
22471_0,,,,2,1,1,2
22471_1,,,,2,1,1,2
22472_0,,,,2,1,1,2
22472_1,,,,2,1,1,2
22473_0,,,,2,1,1,2
22474_0,,,,2,1,1,2
22474_1,,,,2,1,1,2
22475_0,,,,2,1,1,2
22476_0,,,,2,1,1,2
22476_1,,,,2,1,1,2
22477_0,,,,2,1,1,2
22477_1,,,,2,1,1,2
22478_0,,,,2,1,2,3
22478_1,,,,2,1,2,3
22478_2,,,,2,1,2,3
22479_0,,,,2,1,1,2
22479_1,,,,2,1,1,2
22479_2,,,,2,1,1,2
22480_0,,,,2,1,1,2
22480_1,,,,2,1,1,2
22480_2,,,,2,1,1,2
22481_0,,,,2,1,1,2
22482_0,,,,2,1,1,2
22482_1,,,,2,1,1,2
22483_0,,,,2,1,1,2
22483_1,,,,2,1,1,2
22483_2,,,,2,1,1,2
22484_0,,,,2,1,2,3
22484_1,,,,2,1,2,3
22484_2,,,,2,1,2,3
22485_0,,,,2,1,1,2
22485_1,,,,2,1,1,2
22486_0,,,,2,1,1,2
22486_1,,,,2,1,1,2
22486_2,,,,2,1,1,2
22487_0,,,,2,1,2,3
22487_1,,,,2,1,2,3
22487_2,,,,2,1,2,3
22488_0,,,,2,1,1,2
22488_1,,,,2,1,1,2
22489_0,,,,2,1,1,2
22490_0,,,,2,1,1,2
22490_1,,,,2,1,1,2
22491_0,,,,2,1,1,2
22491_1,,,,2,1,1,2
22491_2,,,,2,1,1,2
22492_0,,,,2,1,2,3
22492_1,,,,2,1,2,3
22492_2,,,,2,1,2,3
22493_0,,,,2,1,1,2
22493_1,,,,2,1,1,2
22493_2,,,,2,1,1,2
22494_0,,,,2,1,1,2
22495_0,,,,2,1,1,2
22495_1,,,,2,1,1,2
22495_2,,,,2,1,1,2
22496_0,,,,2,1,1,2
22496_1,,,,2,1,1,2
22496_2,,,,2,1,1,2
22497_0,,,,2,1,1,2
22497_1,,,,2,1,1,2
22498_0,,,,2,1,1,2
22499_0,,,,2,1,1,2
22499_1,,,,2,1,1,2
22499_2,,,,2,1,1,2
22500_0,,,,2,1,1,2
22500_1,,,,2,1,1,2
22500_2,,,,2,1,1,2
22501_0,,,,2,1,1,2
22501_1,,,,2,1,1,2
22502_0,,,,2,1,1,2
22503_0,,,,2,1,1,2
22503_1,,,,2,1,1,2
22503_2,,,,2,1,1,2
22504_0,,,,2,1,1,2
22505_0,,,,2,1,1,2
22505_1,,,,2,1,1,2
22506_0,,,,2,1,1,2
22507_0,,,,2,1,1,2
22507_1,,,,2,1,1,2
22508_0,,,,2,1,1,2
22509_0,,,,2,1,1,2
22509_1,,,,2,1,1,2
22509_2,,,,2,1,1,2
22510_0,,,,2,1,1,2
22511_0,,,,2,1,1,2
22511_1,,,,2,1,1,2
22512_0,,,,2,1,1,2
22512_1,,,,2,1,1,2
22513_0,,,,2,1,2,3
22513_1,,,,2,1,2,3
22514_0,,,,2,1,1,2
22514_1,,,,2,1,1,2
22515_0,,,,2,1,1,2
22515_1,,,,2,1,1,2
22516_0,,,,2,1,1,2
22517_0,,,,2,1,1,2
22517_1,,,,2,1,1,2
22518_0,,,,2,1,2,3
22519_0,,,,2,1,1,2
22519_1,,,,2,1,1,2
22520_0,,,,2,1,1,2
22521_0,,,,2,1,1,2
22521_1,,,,2,1,1,2
22522_0,,,,2,1,1,2
22522_1,,,,2,1,1,2
22523_0,,,,2,1,1,2
22523_1,,,,2,1,1,2
22524_0,,,,2,1,1,2
22524_1,,,,2,1,1,2
22525_0,,,,2,1,1,2
22525_1,,,,2,1,1,2
22526_0,,,,2,1,1,2
22526_1,,,,2,1,1,2
22527_0,,,,2,1,2,3
22528_0,,,,2,1,2,3
22528_1,,,,2,1,2,3
22529_0,,,,2,1,2,3
22529_1,,,,2,1,2,3
22530_0,,,,2,1,2,3
22530_1,,,,2,1,2,3
22531_0,,,,2,1,2,3
22531_1,,,,2,1,2,3
22532_0,,,,2,1,2,3
22533_0,,,,2,1,2,3
22533_1,,,,2,1,2,3
22534_0,,,,2,1,2,3
22534_1,,,,2,1,2,3
22535_0,,,,2,1,2,3
22536_0,,,,2,1,2,3
22537_0,,,,2,1,2,3
22537_1,,,,2,1,2,3
22538_0,,,,2,1,2,3
22538_1,,,,2,1,2,3
22539_0,,,,2,1,2,3
22540_0,,,,2,1,2,3
22540_1,,,,2,1,2,3
22541_0,,,,2,1,2,3
22542_0,,,,2,1,2,3
22542_1,,,,2,1,2,3
22543_0,,,,2,1,2,3
22543_1,,,,2,1,2,3
22544_0,,,,2,1,2,3
22544_1,,,,2,1,2,3
22545_0,,,,2,1,2,3
22545_1,,,,2,1,2,3
22546_0,,,,2,1,2,3
22546_1,,,,2,1,2,3
22547_0,,,,2,1,2,3
22547_1,,,,2,1,2,3
22548_0,,,,2,1,2,3
22548_1,,,,2,1,2,3
22549_0,,,,2,1,2,3
22549_1,,,,2,1,2,3
22550_0,,,,2,1,2,3
22550_1,,,,2,1,2,3
22551_0,,,,2,1,2,3
22551_1,,,,2,1,2,3
22552_0,,,,2,1,2,3
22552_1,,,,2,1,2,3
22553_0,,,,2,1,2,3
22553_1,,,,2,1,2,3
22554_0,,,,2,1,2,3
22554_1,,,,2,1,2,3
22555_0,,,,2,1,2,3
22555_1,,,,2,1,2,3
22556_0,,,,2,1,2,3
22556_1,,,,2,1,2,3
22557_0,,,,2,1,2,3
22557_1,,,,2,1,2,3
22558_0,,,,2,1,2,3
22558_1,,,,2,1,2,3
22559_0,,,,2,1,2,3
22559_1,,,,2,1,2,3
22560_0,,,,2,1,2,3
22560_1,,,,2,1,2,3
22561_0,,,,2,1,2,3
22561_1,,,,2,1,2,3
22562_0,,,,2,1,2,3
22562_1,,,,2,1,2,3
22563_0,,,,2,1,2,3
22563_1,,,,2,1,2,3
22564_0,,,,2,1,2,3
22565_0,,,,2,1,2,3
22565_1,,,,2,1,2,3
22566_0,,,,2,1,2,3
22566_1,,,,2,1,2,3
22567_0,,,,2,1,2,3
22568_0,,,,2,1,2,3
22568_1,,,,2,1,2,3
22569_0,,,,2,1,2,3
22569_1,,,,2,1,2,3
22570_0,,,,2,1,2,3
22570_1,,,,2,1,2,3
22571_0,,,,2,1,2,3
22571_1,,,,2,1,2,3
22572_0,,,,2,1,2,3
22572_1,,,,2,1,2,3
22573_0,,,,2,1,2,3
22573_1,,,,2,1,2,3
22574_0,,,,2,1,2,3
22574_1,,,,2,1,2,3
22575_0,,,,2,1,2,3
22576_0,,,,2,1,2,3
22576_1,,,,2,1,2,3
22577_0,,,,2,1,2,3
22577_1,,,,2,1,2,3
22578_0,,,,2,1,2,3
22578_1,,,,2,1,2,3
22579_0,,,,2,1,2,3
22580_0,,,,2,1,2,3
22580_1,,,,2,1,2,3
22581_0,,,,2,1,2,3
22581_1,,,,2,1,2,3
22582_0,,,,2,1,2,3
22582_1,,,,2,1,2,3
22583_0,,,,2,1,2,3
22583_1,,,,2,1,2,3
22584_0,,,,2,1,2,3
22585_0,,,,2,1,2,3
22585_1,,,,2,1,2,3
22586_0,,,,2,1,2,3
22586_1,,,,2,1,2,3
22587_0,,,,2,1,2,3
22588_0,,,,2,1,2,3
22588_1,,,,2,1,2,3
22589_0,,,,2,1,2,3
22589_1,,,,2,1,2,3
22590_0,,,,2,1,2,3
22591_0,,,,2,1,2,3
22592_0,,,,2,1,2,3
22593_0,,,,2,1,2,3
22594_0,,,,2,1,2,3
22595_0,,,,2,1,2,3
22595_1,,,,2,1,2,3
22596_0,,,,2,1,2,3
22596_1,,,,2,1,2,3
22597_0,,,,2,1,2,3
22598_0,,,,2,1,2,3
22598_1,,,,2,1,2,3
22599_0,,,,2,1,2,3
22599_1,,,,2,1,2,3
22600_0,,,,2,1,2,3
22601_0,,,,2,1,2,3
22601_1,,,,2,1,2,3
22602_0,,,,2,1,2,3
22602_1,,,,2,1,2,3
22603_0,,,,2,1,2,3
22603_1,,,,2,1,2,3
22604_0,,,,2,1,2,3
22604_1,,,,2,1,2,3
22605_0,,,,2,1,2,3
22606_0,,,,2,1,2,3
22607_0,,,,2,1,2,3
22607_1,,,,2,1,2,3
22608_0,,,,2,1,2,3
22609_0,,,,2,1,2,3
22609_1,,,,2,1,2,3
22610_0,,,,2,1,2,3
22610_1,,,,2,1,2,3
22611_0,,,,2,1,2,3
22611_1,,,,2,1,2,3
22612_0,,,,2,1,2,3
22613_0,,,,2,1,2,3
22613_1,,,,2,1,2,3
22614_0,,,,2,1,2,3
22615_0,,,,2,1,2,3
22616_0,,,,2,1,2,3
22617_0,,,,2,1,2,3
22618_0,,,,2,1,2,3
22619_0,,,,2,1,2,3
22619_1,,,,2,1,2,3
22620_0,,,,2,1,2,3
22621_0,,,,2,1,2,3
22622_0,,,,2,1,2,3
22623_0,,,,2,1,2,3
22623_1,,,,2,1,2,3
22624_0,,,,2,1,2,3
22625_0,,,,2,1,2,3
22625_1,,,,2,1,2,3
22626_0,,,,2,1,2,3
22626_1,,,,2,1,2,3
22627_0,,,,2,1,2,3
22627_1,,,,2,1,2,3
22628_0,,,,2,1,2,3
22628_1,,,,2,1,2,3
22629_0,,,,2,1,2,3
22629_1,,,,2,1,2,3
22630_0,,,,2,1,2,3
22630_1,,,,2,1,2,3
22631_0,,,,2,1,2,3
22631_1,,,,2,1,2,3
22632_0,,,,2,1,2,3
22632_1,,,,2,1,2,3
22633_0,,,,2,1,2,3
22633_1,,,,2,1,2,3
22634_0,,,,2,1,2,3
22634_1,,,,2,1,2,3
22635_0,,,,2,1,2,3
22635_1,,,,2,1,2,3
22636_0,,,,2,1,2,3
22636_1,,,,2,1,2,3
22637_0,,,,2,1,2,3
22637_1,,,,2,1,2,3
22638_0,,,,2,1,2,3
22638_1,,,,2,1,2,3
22639_0,,,,2,1,2,3
22639_1,,,,2,1,2,3
22640_0,,,,2,1,2,3
22641_0,,,,2,1,2,3
22641_1,,,,2,1,2,3
22642_0,,,,2,1,2,3
22642_1,,,,2,1,2,3
22643_0,,,,2,1,2,3
22643_1,,,,2,1,2,3
22644_0,,,,2,1,2,3
22645_0,,,,2,1,2,3
22645_1,,,,2,1,2,3
22646_0,,,,2,1,2,3
22646_1,,,,2,1,2,3
22647_0,,,,2,1,2,3
22647_1,,,,2,1,2,3
22648_0,,,,2,1,2,3
22649_0,,,,2,1,2,3
22650_0,,,,2,1,2,3
22651_0,,,,2,1,2,3
22651_1,,,,2,1,2,3
22652_0,,,,2,1,2,3
22652_1,,,,2,1,2,3
22653_0,,,,2,1,2,3
22654_0,,,,2,1,2,3
22655_0,,,,2,1,2,3
22656_0,,,,2,1,2,3
22656_1,,,,2,1,2,3
22657_0,,,,2,1,2,3
22657_1,,,,2,1,2,3
22658_0,,,,2,1,2,3
22658_1,,,,2,1,2,3
22659_0,,,,2,1,2,3
22660_0,,,,2,1,2,3
22660_1,,,,2,1,2,3
22661_0,,,,2,1,2,3
22661_1,,,,2,1,2,3
22662_0,,,,2,1,2,3
22662_1,,,,2,1,2,3
22663_0,,,,2,1,2,3
22664_0,,,,2,1,2,3
22665_0,,,,2,1,2,3
22665_1,,,,2,1,2,3
22666_0,,,,2,1,2,3
22667_0,,,,2,1,2,3
22667_1,,,,2,1,2,3
22668_0,,,,2,1,2,3
22668_1,,,,2,1,2,3
22669_0,,,,2,1,2,3
22669_1,,,,2,1,2,3
22670_0,,,,2,1,2,3
22671_0,,,,2,1,2,3
22671_1,,,,2,1,2,3
22672_0,,,,2,1,2,3
22673_0,,,,2,1,2,3
22674_0,,,,2,1,2,3
22675_0,,,,2,1,2,3
22675_1,,,,2,1,2,3
22676_0,,,,2,1,2,3
22676_1,,,,2,1,2,3
22677_0,,,,2,1,2,3
22677_1,,,,2,1,2,3
22678_0,,,,2,1,2,3
22678_1,,,,2,1,2,3
22679_0,,,,2,1,2,3
22679_1,,,,2,1,2,3
22680_0,,,,2,1,2,3
22680_1,,,,2,1,2,3
22681_0,,,,2,1,2,3
22681_1,,,,2,1,2,3
22682_0,,,,2,1,2,3
22682_1,,,,2,1,2,3
22683_0,,,,2,1,2,3
22683_1,,,,2,1,2,3
22684_0,,,,2,1,2,3
22684_1,,,,2,1,2,3
22685_0,,,,2,1,2,3
22685_1,,,,2,1,2,3
22686_0,,,,2,1,2,3
22686_1,,,,2,1,2,3
22687_0,,,,2,1,2,3
22687_1,,,,2,1,2,3
22688_0,,,,2,1,2,3
22689_0,,,,2,1,2,3
22690_0,,,,2,1,2,3
22691_0,,,,2,1,2,3
22692_0,,,,2,1,2,3
22693_0,,,,2,1,2,3
22694_0,,,,2,1,2,3
22695_0,,,,2,1,2,3
22696_0,,,,2,1,2,3
22697_0,,,,2,1,2,3
22698_0,,,,2,1,2,3
22699_0,,,,2,1,2,3
22700_0,,,,2,1,2,3
22701_0,,,,2,1,2,3
22702_0,,,,2,1,2,3
22702_1,,,,2,1,2,3
22703_0,,,,2,1,2,3
22703_1,,,,2,1,2,3
22704_0,,,,2,1,2,3
22704_1,,,,2,1,2,3
22705_0,,,,2,1,2,3
22706_0,,,,2,1,2,3
22706_1,,,,2,1,2,3
22707_0,,,,2,1,2,3
22707_1,,,,2,1,2,3
22708_0,,,,2,1,2,3
22709_0,,,,2,1,2,3
22710_0,,,,2,1,2,3
22711_0,,,,2,1,2,3
22712_0,,,,2,1,2,3
22713_0,,,,2,1,2,3
22713_1,,,,2,1,2,3
22714_0,,,,2,1,2,3
22714_1,,,,2,1,2,3
22715_0,,,,2,1,2,3
22716_0,,,,2,1,2,3
22716_1,,,,2,1,2,3
22717_0,,,,2,1,2,3
22717_1,,,,2,1,2,3
22718_0,,,,2,1,2,3
22719_0,,,,2,1,2,3
22720_0,,,,2,1,2,3
22720_1,,,,2,1,2,3
22721_0,,,,2,1,2,3
22721_1,,,,2,1,2,3
22722_0,,,,2,1,2,3
22722_1,,,,2,1,2,3
22723_0,,,,2,1,2,3
22723_1,,,,2,1,2,3
22724_0,,,,2,1,2,3
22724_1,,,,2,1,2,3
22726_0,,,,2,1,2,3
C(C(CC(C)O)O)=O,,,5,1,9,0,9
22726_1,,,,2,1,2,3
22727_0,,,,2,1,2,3
22728_0,,,,2,1,2,3
22729_0,,,,2,1,2,3
22729_1,,,,2,1,2,3
22730_0,,,,2,1,2,3
22731_0,,,,2,1,2,3
22731_1,,,,2,1,2,3
22732_0,,,,2,1,2,3
22732_1,,,,2,1,2,3
22733_0,,,,2,1,2,3
22733_1,,,,2,1,2,3
22734_0,,,,2,1,2,3
22734_1,,,,2,1,2,3
22735_0,,,,2,1,2,3
22736_0,,,,2,1,2,3
22736_1,,,,2,1,2,3
22737_0,,,,2,1,2,3
22737_1,,,,2,1,2,3
22738_0,,,,2,1,2,3
22739_0,,,,2,1,2,3
22740_0,,,,2,1,2,3
22741_0,,,,2,1,2,3
22741_1,,,,2,1,2,3
22742_0,,,,2,1,2,3
22742_1,,,,2,1,2,3
22743_0,,,,2,1,2,3
22743_1,,,,2,1,2,3
22744_0,,,,2,1,2,3
22744_1,,,,2,1,2,3
22745_0,,,,2,1,2,3
22745_1,,,,2,1,2,3
22746_0,,,,2,1,2,3
22746_1,,,,2,1,2,3
22747_0,,,,2,1,2,3
22747_1,,,,2,1,2,3
22748_0,,,,2,1,2,3
22748_1,,,,2,1,2,3
22749_0,,,,2,1,2,3
22749_1,,,,2,1,2,3
22750_0,,,,2,1,2,3
22751_0,,,,2,1,2,3
22751_1,,,,2,1,2,3
22753_0,,,,2,1,2,3
C(C(CC(CO)O)O)=O,,,5,1,7,0,7
22753_1,,,,2,1,2,3
22754_0,,,,2,1,2,3
22754_1,,,,2,1,2,3
22755_0,,,,2,1,2,3
22756_0,,,,2,1,2,3
22756_1,,,,2,1,2,3
22757_0,,,,2,1,2,3
22758_0,,,,2,1,2,3
22758_1,,,,2,1,2,3
22759_0,,,,2,1,2,3
22759_1,,,,2,1,2,3
22760_0,,,,2,1,2,3
22760_1,,,,2,1,2,3
22761_0,,,,2,1,2,3
22761_1,,,,2,1,2,3
22762_0,,,,2,1,2,3
22762_1,,,,2,1,2,3
22763_0,,,,2,1,2,3
22763_1,,,,2,1,2,3
22764_0,,,,2,1,2,3
22764_1,,,,2,1,2,3
22765_0,,,,2,1,2,3
22765_1,,,,2,1,2,3
22766_0,,,,2,1,2,3
22766_1,,,,2,1,2,3
22767_0,,,,2,1,2,3
22768_0,,,,2,1,2,3
22768_1,,,,2,1,2,3
22769_0,,,,2,1,2,3
22770_0,,,,2,1,2,3
22771_0,,,,2,1,2,3
22772_0,,,,2,1,2,3
22773_0,,,,2,1,2,3
22773_1,,,,2,1,2,3
22774_0,,,,2,1,2,3
22775_0,,,,2,1,2,3
22775_1,,,,2,1,2,3
22776_0,,,,2,1,2,3
22776_1,,,,2,1,2,3
22777_0,,,,2,1,2,3
22778_0,,,,2,1,2,3
22778_1,,,,2,1,2,3
22779_0,,,,2,1,2,3
22779_1,,,,2,1,2,3
22780_0,,,,2,1,2,3
22781_0,,,,2,1,2,3
22781_1,,,,2,1,2,3
22782_0,,,,2,1,2,3
22782_1,,,,2,1,2,3
22783_0,,,,2,1,2,3
22784_0,,,,2,1,2,3
22784_1,,,,2,1,2,3
22785_0,,,,2,1,2,3
22785_1,,,,2,1,2,3
22786_0,,,,2,1,2,3
22787_0,,,,2,1,2,3
22787_1,,,,2,1,2,3
22788_0,,,,2,1,2,3
22788_1,,,,2,1,2,3
22789_0,,,,2,1,2,3
22790_0,,,,2,1,2,3
22790_1,,,,2,1,2,3
22791_0,,,,2,1,2,3
22791_1,,,,2,1,2,3
22792_0,,,,2,1,2,3
22793_0,,,,2,1,2,3
22794_0,,,,2,1,2,3
22794_1,,,,2,1,2,3
22795_0,,,,2,1,2,3
22796_0,,,,2,1,2,3
22796_1,,,,2,1,2,3
22797_0,,,,2,1,2,3
22797_1,,,,2,1,2,3
22798_0,,,,2,1,2,3
22798_1,,,,2,1,2,3
22799_0,,,,2,1,2,3
22799_1,,,,2,1,2,3
22800_0,,,,2,1,2,3
22800_1,,,,2,1,2,3
22801_0,,,,2,1,2,3
22801_1,,,,2,1,2,3
22802_0,,,,2,1,2,3
22802_1,,,,2,1,2,3
22803_0,,,,2,1,2,3
22803_1,,,,2,1,2,3
22804_0,,,,2,1,2,3
22804_1,,,,2,1,2,3
22805_0,,,,2,1,2,3
22805_1,,,,2,1,2,3
22806_0,,,,2,1,2,3
22806_1,,,,2,1,2,3
22807_0,,,,2,1,2,3
22807_1,,,,2,1,2,3
22808_0,,,,2,1,2,3
22808_1,,,,2,1,2,3
22809_0,,,,2,1,2,3
22809_1,,,,2,1,2,3
22810_0,,,,2,1,2,3
22810_1,,,,2,1,2,3
22811_0,,,,2,1,2,3
22811_1,,,,2,1,2,3
22812_0,,,,2,1,2,3
22812_1,,,,2,1,2,3
22813_0,,,,2,1,2,3
22814_0,,,,2,1,2,3
22814_1,,,,2,1,2,3
22815_0,,,,2,1,2,3
22815_1,,,,2,1,2,3
22816_0,,,,2,1,2,3
22816_1,,,,2,1,2,3
22817_0,,,,2,1,2,3
22817_1,,,,2,1,2,3
22818_0,,,,2,1,2,3
22818_1,,,,2,1,2,3
22819_0,,,,2,1,2,3
22820_0,,,,2,1,2,3
22820_1,,,,2,1,2,3
22821_0,,,,2,1,2,3
22821_1,,,,2,1,2,3
22822_0,,,,2,1,2,3
22822_1,,,,2,1,2,3
22823_0,,,,2,1,2,3
22823_1,,,,2,1,2,3
22824_0,,,,2,1,2,3
22824_1,,,,2,1,2,3
22825_0,,,,2,1,2,3
22826_0,,,,2,1,2,3
22826_1,,,,2,1,2,3
22827_0,,,,2,1,2,3
22827_1,,,,2,1,2,3
22828_0,,,,2,1,2,3
22829_0,,,,2,1,2,3
22829_1,,,,2,1,2,3
22830_0,,,,2,1,2,3
22830_1,,,,2,1,2,3
22831_0,,,,2,1,2,3
22831_1,,,,2,1,2,3
22832_0,,,,2,1,2,3
22832_1,,,,2,1,2,3
22833_0,,,,2,1,2,3
22833_1,,,,2,1,2,3
22834_0,,,,2,1,2,3
22834_1,,,,2,1,2,3
22835_0,,,,2,1,2,3
22836_0,,,,2,1,2,3
22837_0,,,,2,1,2,3
22838_0,,,,2,1,2,3
22838_1,,,,2,1,2,3
22839_0,,,,2,1,2,3
22839_1,,,,2,1,2,3
22840_0,,,,2,1,2,3
22840_1,,,,2,1,2,3
22841_0,,,,2,1,2,3
22841_1,,,,2,1,2,3
22842_0,,,,2,1,2,3
22843_0,,,,2,1,2,3
22844_0,,,,2,1,2,3
22844_1,,,,2,1,2,3
22845_0,,,,2,1,2,3
22845_1,,,,2,1,2,3
22846_0,,,,2,1,2,3
22847_0,,,,2,1,2,3
22847_1,,,,2,1,2,3
22848_0,,,,2,1,2,3
22848_1,,,,2,1,2,3
22849_0,,,,2,1,2,3
22850_0,,,,2,1,2,3
22851_0,,,,2,1,2,3
22851_1,,,,2,1,2,3
22852_0,,,,2,1,2,3
22852_1,,,,2,1,2,3
22853_0,,,,2,1,2,3
22854_0,,,,2,1,2,3
22854_1,,,,2,1,2,3
22855_0,,,,2,1,2,3
22855_1,,,,2,1,2,3
22856_0,,,,2,1,2,3
22856_1,,,,2,1,2,3
22857_0,,,,2,1,2,3
22857_1,,,,2,1,2,3
22858_0,,,,2,1,2,3
22859_0,,,,2,1,2,3
22860_0,,,,2,1,2,3
22860_1,,,,2,1,2,3
22861_0,,,,2,1,2,3
22861_1,,,,2,1,2,3
22862_0,,,,2,1,2,3
22863_0,,,,2,1,2,3
22864_0,,,,2,1,2,3
22864_1,,,,2,1,2,3
22865_0,,,,2,1,2,3
22865_1,,,,2,1,2,3
22866_0,,,,2,1,2,3
22867_0,,,,2,1,2,3
22867_1,,,,2,1,2,3
22868_0,,,,2,1,2,3
22868_1,,,,2,1,2,3
22869_0,,,,2,1,2,3
22870_0,,,,2,1,2,3
22871_0,,,,2,1,2,3
22871_1,,,,2,1,2,3
22872_0,,,,2,1,2,3
22872_1,,,,2,1,2,3
22873_0,,,,2,1,2,3
22873_1,,,,2,1,2,3
22874_0,,,,2,1,2,3
22874_1,,,,2,1,2,3
22875_0,,,,2,1,2,3
22876_0,,,,2,1,2,3
22877_0,,,,2,1,2,3
22877_1,,,,2,1,2,3
22878_0,,,,2,1,2,3
22879_0,,,,2,1,2,3
22880_0,,,,2,1,2,3
22881_0,,,,2,1,2,3
22881_1,,,,2,1,2,3
22882_0,,,,2,1,2,3
22882_1,,,,2,1,2,3
22883_0,,,,2,1,2,3
22884_0,,,,2,1,2,3
22884_1,,,,2,1,2,3
22885_0,,,,2,1,2,3
22885_1,,,,2,1,2,3
22886_0,,,,2,1,2,3
22887_0,,,,2,1,2,3
22888_0,,,,2,1,2,3
22888_1,,,,2,1,2,3
22889_0,,,,2,1,2,3
22890_0,,,,2,1,2,3
22891_0,,,,2,1,2,3
22891_1,,,,2,1,2,3
22892_0,,,,2,1,2,3
22892_1,,,,2,1,2,3
22893_0,,,,2,1,2,3
22893_1,,,,2,1,2,3
22894_0,,,,2,1,2,3
22894_1,,,,2,1,2,3
22895_0,,,,2,1,2,3
22895_1,,,,2,1,2,3
22896_0,,,,2,1,2,3
22897_0,,,,2,1,2,3
22897_1,,,,2,1,2,3
22898_0,,,,2,1,2,3
22898_1,,,,2,1,2,3
22899_0,,,,2,1,2,3
22899_1,,,,2,1,2,3
22900_0,,,,2,1,2,3
22901_0,,,,2,1,2,3
22901_1,,,,2,1,2,3
22902_0,,,,2,1,2,3
22902_1,,,,2,1,2,3
22903_0,,,,2,1,2,3
22904_0,,,,2,1,2,3
22904_1,,,,2,1,2,3
22905_0,,,,2,1,2,3
22905_1,,,,2,1,2,3
22906_0,,,,2,1,2,3
22906_1,,,,2,1,2,3
22907_0,,,,2,1,2,3
22907_1,,,,2,1,2,3
22908_0,,,,2,1,2,3
22908_1,,,,2,1,2,3
22909_0,,,,2,1,2,3
22909_1,,,,2,1,2,3
22910_0,,,,2,1,2,3
22910_1,,,,2,1,2,3
22911_0,,,,2,1,2,3
22911_1,,,,2,1,2,3
22912_0,,,,2,1,2,3
22912_1,,,,2,1,2,3
22913_0,,,,2,1,2,3
22913_1,,,,2,1,2,3
22914_0,,,,2,1,2,3
22914_1,,,,2,1,2,3
22915_0,,,,2,1,2,3
22915_1,,,,2,1,2,3
22916_0,,,,2,1,2,3
22916_1,,,,2,1,2,3
22917_0,,,,2,1,2,3
22918_0,,,,2,1,2,3
22919_0,,,,2,1,2,3
22919_1,,,,2,1,2,3
22920_0,,,,2,1,2,3
22921_0,,,,2,1,2,3
22922_0,,,,2,1,2,3
22923_0,,,,2,1,2,3
22924_0,,,,2,1,2,3
22924_1,,,,2,1,2,3
22925_0,,,,2,1,2,3
22926_0,,,,2,1,2,3
22927_0,,,,2,1,2,3
22927_1,,,,2,1,2,3
22928_0,,,,2,1,2,3
22929_0,,,,2,1,2,3
22929_1,,,,2,1,2,3
22930_0,,,,2,1,2,3
22930_1,,,,2,1,2,3
22931_0,,,,2,1,2,3
22932_0,,,,2,1,2,3
22933_0,,,,2,1,2,3
22933_1,,,,2,1,2,3
22934_0,,,,2,1,2,3
22934_1,,,,2,1,2,3
22935_0,,,,2,1,2,3
22935_1,,,,2,1,2,3
22936_0,,,,2,1,2,3
22936_1,,,,2,1,2,3
22937_0,,,,2,1,2,3
22937_1,,,,2,1,2,3
22938_0,,,,2,1,2,3
22938_1,,,,2,1,2,3
22939_0,,,,2,1,2,3
22939_1,,,,2,1,2,3
22940_0,,,,2,1,2,3
22941_0,,,,2,1,2,3
22941_1,,,,2,1,2,3
22942_0,,,,2,1,2,3
22942_1,,,,2,1,2,3
22943_0,,,,2,1,2,3
22943_1,,,,2,1,2,3
22944_0,,,,2,1,2,3
22944_1,,,,2,1,2,3
22945_0,,,,2,1,2,3
22946_0,,,,2,1,2,3
22946_1,,,,2,1,2,3
22947_0,,,,2,1,2,3
22947_1,,,,2,1,2,3
22948_0,,,,2,1,2,3
22948_1,,,,2,1,2,3
22949_0,,,,2,1,2,3
22949_1,,,,2,1,2,3
22950_0,,,,2,1,2,3
22950_1,,,,2,1,2,3
22951_0,,,,2,1,2,3
22951_1,,,,2,1,2,3
22952_0,,,,2,1,2,3
22952_1,,,,2,1,2,3
22953_0,,,,2,1,2,3
22953_1,,,,2,1,2,3
22954_0,,,,2,1,2,3
22954_1,,,,2,1,2,3
22955_0,,,,2,1,2,3
22955_1,,,,2,1,2,3
22956_0,,,,2,1,2,3
22956_1,,,,2,1,2,3
22957_0,,,,2,1,2,3
22957_1,,,,2,1,2,3
22958_0,,,,2,1,2,3
22959_0,,,,2,1,2,3
22959_1,,,,2,1,2,3
22960_0,,,,2,1,2,3
22961_0,,,,2,1,2,3
22962_0,,,,2,1,2,3
22963_0,,,,2,1,2,3
22963_1,,,,2,1,2,3
22964_0,,,,2,1,2,3
22965_0,,,,2,1,2,3
22965_1,,,,2,1,2,3
22966_0,,,,2,1,2,3
22967_0,,,,2,1,2,3
22967_1,,,,2,1,2,3
22968_0,,,,2,1,2,3
22968_1,,,,2,1,2,3
22969_0,,,,2,1,2,3
22969_1,,,,2,1,2,3
22970_0,,,,2,1,2,3
22971_0,,,,2,1,2,3
22972_0,,,,2,1,2,3
22972_1,,,,2,1,2,3
22973_0,,,,2,1,2,3
22973_1,,,,2,1,2,3
22974_0,,,,2,1,2,3
22974_1,,,,2,1,2,3
22975_0,,,,2,1,2,3
22975_1,,,,2,1,2,3
22976_0,,,,2,1,1,2
22976_1,,,,2,1,1,2
22977_0,,,,2,1,2,3
22977_1,,,,2,1,2,3
22978_0,,,,2,1,1,2
22979_0,,,,2,1,2,3
22979_1,,,,2,1,2,3
22980_0,,,,2,1,2,3
22980_1,,,,2,1,2,3
22981_0,,,,2,1,2,3
22982_0,,,,2,1,2,3
22982_1,,,,2,1,2,3
22983_0,,,,2,1,2,3
22983_1,,,,2,1,2,3
22984_0,,,,2,1,2,3
22984_1,,,,2,1,2,3
22985_0,,,,2,1,2,3
22985_1,,,,2,1,2,3
22986_0,,,,2,1,2,3
22986_1,,,,2,1,2,3
22987_0,,,,2,1,2,3
22987_1,,,,2,1,2,3
22988_0,,,,2,1,2,3
22988_1,,,,2,1,2,3
22989_0,,,,2,1,2,3
22990_0,,,,2,1,2,3
22991_0,,,,2,1,2,3
22991_1,,,,2,1,2,3
22992_0,,,,2,1,2,3
22992_1,,,,2,1,2,3
22993_0,,,,2,1,2,3
22993_1,,,,2,1,2,3
22994_0,,,,2,1,2,3
22994_1,,,,2,1,2,3
22995_0,,,,2,1,2,3
22995_1,,,,2,1,2,3
22996_0,,,,2,1,2,3
22996_1,,,,2,1,2,3
22997_0,,,,2,1,2,3
22997_1,,,,2,1,2,3
22998_0,,,,2,1,2,3
22998_1,,,,2,1,2,3
22999_0,,,,2,1,2,3
22999_1,,,,2,1,2,3
23000_0,,,,2,1,2,3
23000_1,,,,2,1,2,3
23001_0,,,,2,1,2,3
23001_1,,,,2,1,2,3
23002_0,,,,2,1,2,3
23002_1,,,,2,1,2,3
23003_0,,,,2,1,2,3
23003_1,,,,2,1,2,3
23004_0,,,,2,1,2,3
23004_1,,,,2,1,2,3
23005_0,,,,2,1,2,3
23005_1,,,,2,1,2,3
23006_0,,,,2,1,2,3
23006_1,,,,2,1,2,3
23007_0,,,,2,1,2,3
23007_1,,,,2,1,2,3
23008_0,,,,2,1,2,3
23008_1,,,,2,1,2,3
23009_0,,,,2,1,2,3
23009_1,,,,2,1,2,3
23010_0,,,,2,1,2,3
23010_1,,,,2,1,2,3
23011_0,,,,2,1,2,3
23011_1,,,,2,1,2,3
23012_0,,,,2,1,2,3
23012_1,,,,2,1,2,3
23013_0,,,,2,1,2,3
23013_1,,,,2,1,2,3
23014_0,,,,2,1,2,3
23014_1,,,,2,1,2,3
23015_0,,,,2,1,2,3
23015_1,,,,2,1,2,3
23016_0,,,,2,1,2,3
23016_1,,,,2,1,2,3
23017_0,,,,2,1,2,3
23017_1,,,,2,1,2,3
23018_0,,,,2,1,2,3
23018_1,,,,2,1,2,3
23019_0,,,,2,1,2,3
23019_1,,,,2,1,2,3
23020_0,,,,2,1,2,3
23020_1,,,,2,1,2,3
23021_0,,,,2,1,2,3
23021_1,,,,2,1,2,3
23022_0,,,,2,1,2,3
23022_1,,,,2,1,2,3
23023_0,,,,2,1,2,3
23023_1,,,,2,1,2,3
23024_0,,,,2,1,2,3
23024_1,,,,2,1,2,3
23025_0,,,,2,1,2,3
23025_1,,,,2,1,2,3
23026_0,,,,2,1,2,3
23026_1,,,,2,1,2,3
23027_0,,,,2,1,2,3
23027_1,,,,2,1,2,3
23028_0,,,,2,1,2,3
23028_1,,,,2,1,2,3
23029_0,,,,2,1,2,3
23029_1,,,,2,1,2,3
23030_0,,,,2,1,2,3
23030_1,,,,2,1,2,3
23031_0,,,,2,1,2,3
23031_1,,,,2,1,2,3
23032_0,,,,2,1,2,3
23032_1,,,,2,1,2,3
23033_0,,,,2,1,2,3
23033_1,,,,2,1,2,3
23034_0,,,,2,1,2,3
23034_1,,,,2,1,2,3
23035_0,,,,2,1,2,3
23035_1,,,,2,1,2,3
23036_0,,,,2,1,2,3
23036_1,,,,2,1,2,3
23037_0,,,,2,1,2,3
23037_1,,,,2,1,2,3
23038_0,,,,2,1,2,3
23038_1,,,,2,1,2,3
23039_0,,,,2,1,2,3
23039_1,,,,2,1,2,3
23040_0,,,,2,1,2,3
23040_1,,,,2,1,2,3
23041_0,,,,2,1,2,3
23041_1,,,,2,1,2,3
23042_0,,,,2,1,2,3
23042_1,,,,2,1,2,3
23043_0,,,,2,1,2,3
23043_1,,,,2,1,2,3
23044_0,,,,2,1,2,3
23044_1,,,,2,1,2,3
23045_0,,,,2,1,2,3
23045_1,,,,2,1,2,3
23046_0,,,,2,1,2,3
23046_1,,,,2,1,2,3
23047_0,,,,2,1,2,3
23047_1,,,,2,1,2,3
23048_0,,,,2,1,2,3
23048_1,,,,2,1,2,3
23049_0,,,,2,1,2,3
23050_0,,,,2,1,2,3
23050_1,,,,2,1,2,3
23051_0,,,,2,1,2,3
23052_0,,,,2,1,2,3
23053_0,,,,2,1,2,3
23053_1,,,,2,1,2,3
23054_0,,,,2,1,2,3
23054_1,,,,2,1,2,3
23055_0,,,,2,1,2,3
23055_1,,,,2,1,2,3
23056_0,,,,2,1,2,3
23057_0,,,,2,1,2,3
23057_1,,,,2,1,2,3
23058_0,,,,2,1,2,3
23059_0,,,,2,1,2,3
23059_1,,,,2,1,2,3
23060_0,,,,2,1,2,3
23061_0,,,,2,1,2,3
23061_1,,,,2,1,2,3
23062_0,,,,2,1,2,3
23062_1,,,,2,1,2,3
23063_0,,,,2,1,2,3
23063_1,,,,2,1,2,3
23064_0,,,,2,1,2,3
23064_1,,,,2,1,2,3
23065_0,,,,2,1,2,3
23065_1,,,,2,1,2,3
23066_0,,,,2,1,2,3
23066_1,,,,2,1,2,3
23067_0,,,,2,1,2,3
23067_1,,,,2,1,2,3
23068_0,,,,2,1,2,3
23068_1,,,,2,1,2,3
23069_0,,,,2,1,2,3
23069_1,,,,2,1,2,3
23070_0,,,,2,1,2,3
23070_1,,,,2,1,2,3
23071_0,,,,2,1,2,3
23071_1,,,,2,1,2,3
23072_0,,,,2,1,2,3
23072_1,,,,2,1,2,3
23073_0,,,,2,1,2,3
23074_0,,,,2,1,2,3
23074_1,,,,2,1,2,3
23075_0,,,,2,1,2,3
23076_0,,,,2,1,2,3
23077_0,,,,2,1,2,3
23078_0,,,,2,1,2,3
23078_1,,,,2,1,2,3
23079_0,,,,2,1,2,3
23080_0,,,,2,1,2,3
23080_1,,,,2,1,2,3
23081_0,,,,2,1,2,3
23082_0,,,,2,1,2,3
23082_1,,,,2,1,2,3
23083_0,,,,2,1,2,3
23083_1,,,,2,1,2,3
23084_0,,,,2,1,2,3
23084_1,,,,2,1,2,3
23085_0,,,,2,1,2,3
23086_0,,,,2,1,2,3
23087_0,,,,2,1,2,3
23087_1,,,,2,1,2,3
23088_0,,,,2,1,2,3
23088_1,,,,2,1,2,3
23089_0,,,,2,1,2,3
23089_1,,,,2,1,2,3
23090_0,,,,2,1,2,3
23090_1,,,,2,1,2,3
23091_0,,,,2,1,2,3
23091_1,,,,2,1,2,3
23092_0,,,,2,1,2,3
23092_1,,,,2,1,2,3
23093_0,,,,2,1,2,3
23093_1,,,,2,1,2,3
23094_0,,,,2,1,2,3
23094_1,,,,2,1,2,3
23095_0,,,,2,1,2,3
23095_1,,,,2,1,2,3
23096_0,,,,2,1,2,3
23096_1,,,,2,1,2,3
23097_0,,,,2,1,2,3
23097_1,,,,2,1,2,3
23098_0,,,,2,1,2,3
23099_0,,,,2,1,2,3
23099_1,,,,2,1,2,3
23100_0,,,,2,1,2,3
23100_1,,,,2,1,2,3
23101_0,,,,2,1,1,2
23101_1,,,,2,1,1,2
23102_0,,,,2,1,2,3
23102_1,,,,2,1,2,3
23103_0,,,,2,1,1,2
23104_0,,,,2,1,2,3
23104_1,,,,2,1,2,3
23105_0,,,,2,1,2,3
23105_1,,,,2,1,2,3
23106_0,,,,2,1,2,3
23106_1,,,,2,1,2,3
23107_0,,,,2,1,2,3
23107_1,,,,2,1,2,3
23108_0,,,,2,1,2,3
23109_0,,,,2,1,2,3
23109_1,,,,2,1,2,3
23110_0,,,,2,1,2,3
23110_1,,,,2,1,2,3
23111_0,,,,2,1,2,3
23111_1,,,,2,1,2,3
23112_0,,,,2,1,2,3
23112_1,,,,2,1,2,3
23113_0,,,,2,1,2,3
23113_1,,,,2,1,2,3
23114_0,,,,2,1,2,3
23114_1,,,,2,1,2,3
23115_0,,,,2,1,2,3
23115_1,,,,2,1,2,3
23116_0,,,,2,1,2,3
23117_0,,,,2,1,2,3
23118_0,,,,2,1,2,3
23118_1,,,,2,1,2,3
23119_0,,,,2,1,2,3
23119_1,,,,2,1,2,3
23120_0,,,,2,1,2,3
23120_1,,,,2,1,2,3
23121_0,,,,2,1,2,3
23121_1,,,,2,1,2,3
23122_0,,,,2,1,2,3
23122_1,,,,2,1,2,3
23123_0,,,,2,1,2,3
23123_1,,,,2,1,2,3
23124_0,,,,2,1,2,3
23124_1,,,,2,1,2,3
23125_0,,,,2,1,2,3
23125_1,,,,2,1,2,3
23126_0,,,,2,1,2,3
23126_1,,,,2,1,2,3
23127_0,,,,2,1,2,3
23127_1,,,,2,1,2,3
23128_0,,,,2,1,2,3
23128_1,,,,2,1,2,3
23129_0,,,,2,1,2,3
23129_1,,,,2,1,2,3
23130_0,,,,2,1,2,3
23130_1,,,,2,1,2,3
23131_0,,,,2,1,2,3
23131_1,,,,2,1,2,3
23132_0,,,,2,1,2,3
23132_1,,,,2,1,2,3
23133_0,,,,2,1,2,3
23133_1,,,,2,1,2,3
23134_0,,,,2,1,2,3
23134_1,,,,2,1,2,3
23135_0,,,,2,1,2,3
23135_1,,,,2,1,2,3
23136_0,,,,2,1,2,3
23136_1,,,,2,1,2,3
23137_0,,,,2,1,2,3
23137_1,,,,2,1,2,3
23138_0,,,,2,1,2,3
23138_1,,,,2,1,2,3
23139_0,,,,2,1,2,3
23139_1,,,,2,1,2,3
23140_0,,,,2,1,2,3
23140_1,,,,2,1,2,3
23141_0,,,,2,1,2,3
23141_1,,,,2,1,2,3
23142_0,,,,2,1,2,3
23142_1,,,,2,1,2,3
23143_0,,,,2,1,2,3
23143_1,,,,2,1,2,3
23144_0,,,,2,1,2,3
23144_1,,,,2,1,2,3
23145_0,,,,2,1,2,3
23145_1,,,,2,1,2,3
23146_0,,,,2,1,2,3
23146_1,,,,2,1,2,3
23147_0,,,,2,1,2,3
23147_1,,,,2,1,2,3
23148_0,,,,2,1,2,3
23148_1,,,,2,1,2,3
23149_0,,,,2,1,2,3
23149_1,,,,2,1,2,3
23150_0,,,,2,1,2,3
23150_1,,,,2,1,2,3
23151_0,,,,2,1,2,3
23151_1,,,,2,1,2,3
23152_0,,,,2,1,2,3
23152_1,,,,2,1,2,3
23153_0,,,,2,1,2,3
23153_1,,,,2,1,2,3
23154_0,,,,2,1,2,3
23154_1,,,,2,1,2,3
23155_0,,,,2,1,2,3
23155_1,,,,2,1,2,3
23156_0,,,,2,1,2,3
23156_1,,,,2,1,2,3
23157_0,,,,2,1,2,3
23157_1,,,,2,1,2,3
23158_0,,,,2,1,2,3
23158_1,,,,2,1,2,3
23159_0,,,,2,1,2,3
23159_1,,,,2,1,2,3
23160_0,,,,2,1,2,3
23160_1,,,,2,1,2,3
23161_0,,,,2,1,2,3
23161_1,,,,2,1,2,3
23162_0,,,,2,1,2,3
23162_1,,,,2,1,2,3
23163_0,,,,2,1,2,3
23163_1,,,,2,1,2,3
23164_0,,,,2,1,2,3
23164_1,,,,2,1,2,3
23165_0,,,,2,1,2,3
23165_1,,,,2,1,2,3
23166_0,,,,2,1,2,3
23166_1,,,,2,1,2,3
23167_0,,,,2,1,2,3
23167_1,,,,2,1,2,3
23168_0,,,,2,1,2,3
23168_1,,,,2,1,2,3
23169_0,,,,2,1,2,3
23169_1,,,,2,1,2,3
23170_0,,,,2,1,2,3
23170_1,,,,2,1,2,3
23171_0,,,,2,1,2,3
23171_1,,,,2,1,2,3
23172_0,,,,2,1,2,3
23172_1,,,,2,1,2,3
23173_0,,,,2,1,2,3
23173_1,,,,2,1,2,3
23174_0,,,,2,1,2,3
23174_1,,,,2,1,2,3
23175_0,,,,2,1,2,3
23175_1,,,,2,1,2,3
23176_0,,,,2,1,2,3
23176_1,,,,2,1,2,3
23177_0,,,,2,1,2,3
23177_1,,,,2,1,2,3
23178_0,,,,2,1,2,3
23178_1,,,,2,1,2,3
23179_0,,,,2,1,2,3
23179_1,,,,2,1,2,3
23180_0,,,,2,1,2,3
23180_1,,,,2,1,2,3
23181_0,,,,2,1,2,3
23181_1,,,,2,1,2,3
23182_0,,,,2,1,2,3
23183_0,,,,2,1,2,3
23183_1,,,,2,1,2,3
23184_0,,,,2,1,2,3
23185_0,,,,2,1,2,3
23186_0,,,,2,1,2,3
23186_1,,,,2,1,2,3
23187_0,,,,2,1,2,3
23187_1,,,,2,1,2,3
23188_0,,,,2,1,2,3
23188_1,,,,2,1,2,3
23189_0,,,,2,1,2,3
23190_0,,,,2,1,2,3
23190_1,,,,2,1,2,3
23191_0,,,,2,1,2,3
23192_0,,,,2,1,2,3
23192_1,,,,2,1,2,3
23193_0,,,,2,1,2,3
23193_1,,,,2,1,2,3
23194_0,,,,2,1,2,3
23194_1,,,,2,1,2,3
23195_0,,,,2,1,2,3
23195_1,,,,2,1,2,3
23196_0,,,,2,1,2,3
23196_1,,,,2,1,2,3
23197_0,,,,2,1,2,3
23197_1,,,,2,1,2,3
23198_0,,,,2,1,2,3
23198_1,,,,2,1,2,3
23199_0,,,,2,1,2,3
23199_1,,,,2,1,2,3
23200_0,,,,2,1,2,3
23200_1,,,,2,1,2,3
23201_0,,,,2,1,2,3
23201_1,,,,2,1,2,3
23202_0,,,,2,1,2,3
23202_1,,,,2,1,2,3
23203_0,,,,2,1,2,3
23203_1,,,,2,1,2,3
23204_0,,,,2,1,2,3
23204_1,,,,2,1,2,3
23205_0,,,,2,1,2,3
23205_1,,,,2,1,2,3
23206_0,,,,2,1,2,3
23206_1,,,,2,1,2,3
23207_0,,,,2,1,2,3
23207_1,,,,2,1,2,3
23208_0,,,,2,1,2,3
23208_1,,,,2,1,2,3
23209_0,,,,2,1,2,3
23209_1,,,,2,1,2,3
23210_0,,,,2,1,2,3
23210_1,,,,2,1,2,3
23211_0,,,,2,1,2,3
23211_1,,,,2,1,2,3
23212_0,,,,2,1,2,3
23212_1,,,,2,1,2,3
23213_0,,,,2,1,2,3
23213_1,,,,2,1,2,3
23214_0,,,,2,1,2,3
23215_0,,,,2,1,2,3
23215_1,,,,2,1,2,3
23215_2,,,,2,1,2,3
23216_0,,,,2,1,2,3
23216_1,,,,2,1,2,3
23216_2,,,,2,1,2,3
23217_0,,,,2,1,2,3
23217_1,,,,2,1,2,3
23218_0,,,,2,1,2,3
23219_0,,,,2,1,2,3
23219_1,,,,2,1,2,3
23219_2,,,,2,1,2,3
23220_0,,,,2,1,2,3
23220_1,,,,2,1,2,3
23220_2,,,,2,1,2,3
23221_0,,,,2,1,2,3
23222_0,,,,2,1,2,3
23223_0,,,,2,1,2,3
23223_1,,,,2,1,2,3
23224_0,,,,2,1,2,3
23224_1,,,,2,1,2,3
23225_0,,,,2,1,2,3
23225_1,,,,2,1,2,3
23226_0,,,,2,1,2,3
23226_1,,,,2,1,2,3
23227_0,,,,2,1,2,3
23227_1,,,,2,1,2,3
23228_0,,,,2,1,2,3
23229_0,,,,2,1,2,3
23229_1,,,,2,1,2,3
23230_0,,,,2,1,2,3
23231_0,,,,2,1,2,3
23231_1,,,,2,1,2,3
23232_0,,,,2,1,2,3
23232_1,,,,2,1,2,3
23233_0,,,,2,1,2,3
23233_1,,,,2,1,2,3
23234_0,,,,2,1,2,3
23234_1,,,,2,1,2,3
23235_0,,,,2,1,2,3
23235_1,,,,2,1,2,3
23236_0,,,,2,1,2,3
23236_1,,,,2,1,2,3
23236_2,,,,2,1,2,3
23237_0,,,,2,1,2,3
23237_1,,,,2,1,2,3
23238_0,,,,2,1,2,3
23238_1,,,,2,1,2,3
23239_0,,,,2,1,1,2
23239_1,,,,2,1,1,2
23240_0,,,,2,1,2,3
23240_1,,,,2,1,2,3
23241_0,,,,2,1,2,3
23241_1,,,,2,1,2,3
23242_0,,,,2,1,1,2
23243_0,,,,2,1,2,3
23243_1,,,,2,1,2,3
23244_0,,,,2,1,2,3
23244_1,,,,2,1,2,3
23244_2,,,,2,1,2,3
23245_0,,,,2,1,2,3
23245_1,,,,2,1,2,3
23246_0,,,,2,1,2,3
23246_1,,,,2,1,2,3
23246_2,,,,2,1,2,3
23247_0,,,,2,1,2,3
23247_1,,,,2,1,2,3
23247_2,,,,2,1,2,3
23248_0,,,,2,1,2,3
23249_0,,,,2,1,2,3
23249_1,,,,2,1,2,3
23250_0,,,,2,1,2,3
23250_1,,,,2,1,2,3
23251_0,,,,2,1,2,3
23251_1,,,,2,1,2,3
23252_0,,,,2,1,2,3
23252_1,,,,2,1,2,3
23253_0,,,,2,1,2,3
23253_1,,,,2,1,2,3
23254_0,,,,2,1,2,3
23254_1,,,,2,1,2,3
23255_0,,,,2,1,2,3
23255_1,,,,2,1,2,3
23256_0,,,,2,1,2,3
23256_1,,,,2,1,2,3
23257_0,,,,2,1,2,3
23257_1,,,,2,1,2,3
23258_0,,,,2,1,2,3
23258_1,,,,2,1,2,3
23259_0,,,,2,1,2,3
23259_1,,,,2,1,2,3
23260_0,,,,2,1,2,3
23260_1,,,,2,1,2,3
23261_0,,,,2,1,2,3
23261_1,,,,2,1,2,3
23261_2,,,,2,1,2,3
23262_0,,,,2,1,2,3
23262_1,,,,2,1,2,3
23262_2,,,,2,1,2,3
23263_0,,,,2,1,2,3
23264_0,,,,2,1,2,3
23264_1,,,,2,1,2,3
23265_0,,,,2,1,2,3
23265_1,,,,2,1,2,3
23266_0,,,,2,1,2,3
23267_0,,,,2,1,2,3
23267_1,,,,2,1,2,3
23268_0,,,,2,1,2,3
23268_1,,,,2,1,2,3
23269_0,,,,2,1,2,3
23270_0,,,,2,1,2,3
23270_1,,,,2,1,2,3
23271_0,,,,2,1,2,3
23272_0,,,,2,1,2,3
23273_0,,,,2,1,2,3
23274_0,,,,2,1,2,3
23274_1,,,,2,1,2,3
23275_0,,,,2,1,2,3
23275_1,,,,2,1,2,3
23276_0,,,,2,1,2,3
23276_1,,,,2,1,2,3
23277_0,,,,2,1,2,3
23278_0,,,,2,1,2,3
23279_0,,,,2,1,2,3
23279_1,,,,2,1,2,3
23280_0,,,,2,1,2,3
23280_1,,,,2,1,2,3
23281_0,,,,2,1,2,3
23281_1,,,,2,1,2,3
23282_0,,,,2,1,2,3
23282_1,,,,2,1,2,3
23283_0,,,,2,1,1,2
23283_1,,,,2,1,1,2
23284_0,,,,2,1,2,3
23284_1,,,,2,1,2,3
23285_0,,,,2,1,1,2
23286_0,,,,2,1,2,3
23286_1,,,,2,1,2,3
23287_0,,,,2,1,2,3
23287_1,,,,2,1,2,3
23288_0,,,,2,1,2,3
23289_0,,,,2,1,2,3
23289_1,,,,2,1,2,3
23290_0,,,,2,1,2,3
23290_1,,,,2,1,2,3
23291_0,,,,2,1,2,3
23291_1,,,,2,1,2,3
23292_0,,,,2,1,2,3
23292_1,,,,2,1,2,3
23293_0,,,,2,1,2,3
23293_1,,,,2,1,2,3
23294_0,,,,2,1,2,3
23294_1,,,,2,1,2,3
23295_0,,,,2,1,2,3
23295_1,,,,2,1,2,3
23296_0,,,,2,1,2,3
23296_1,,,,2,1,2,3
23297_0,,,,2,1,2,3
23298_0,,,,2,1,2,3
23299_0,,,,2,1,2,3
23299_1,,,,2,1,2,3
23299_2,,,,2,1,2,3
23300_0,,,,2,1,2,3
23300_1,,,,2,1,2,3
23300_2,,,,2,1,2,3
23301_0,,,,2,1,2,3
23301_1,,,,2,1,2,3
23302_0,,,,2,1,2,3
23303_0,,,,2,1,2,3
23303_1,,,,2,1,2,3
23304_0,,,,2,1,2,3
23304_1,,,,2,1,2,3
23305_0,,,,2,1,2,3
23306_0,,,,2,1,2,3
23306_1,,,,2,1,2,3
23306_2,,,,2,1,2,3
23307_0,,,,2,1,2,3
23307_1,,,,2,1,2,3
23307_2,,,,2,1,2,3
23308_0,,,,2,1,2,3
23308_1,,,,2,1,2,3
23310_0,,,,2,1,2,3
C(C(C=O)(C(C)O)O)=O,,,5,1,5,0,5
23311_0,,,,2,1,2,3
23311_1,,,,2,1,2,3
23312_0,,,,2,1,2,3
23312_1,,,,2,1,2,3
23313_0,,,,2,1,2,3
23314_0,,,,2,1,2,3
23314_1,,,,2,1,2,3
23316_0,,,,2,1,2,3
C(C(CO)(C)O)=O,,,5,1,3,0,3
23317_0,,,,2,1,2,3
23317_1,,,,2,1,2,3
23318_0,,,,2,1,2,3
23319_0,,,,2,1,2,3
23319_1,,,,2,1,2,3
23320_0,,,,2,1,2,3
23321_0,,,,2,1,2,3
23321_1,,,,2,1,2,3
23322_0,,,,2,1,2,3
23323_0,,,,2,1,2,3
23323_1,,,,2,1,2,3
23324_0,,,,2,1,2,3
23325_0,,,,2,1,2,3
23325_1,,,,2,1,2,3
23326_0,,,,2,1,2,3
23327_0,,,,2,1,2,3
23327_1,,,,2,1,2,3
23328_0,,,,2,1,2,3
23329_0,,,,2,1,2,3
23329_1,,,,2,1,2,3
23331_0,,,,2,1,2,3
C(C1(COCC1O)O)=O,,,5,1,1,0,1
23332_0,,,,2,1,2,3
23332_1,,,,2,1,2,3
23334_0,,,,2,1,2,3
C(C1(C(O)OCC1)O)=O,,,5,1,1,0,1
23335_0,,,,2,1,2,3
23335_1,,,,2,1,2,3
23336_0,,,,2,1,2,3
23337_0,,,,2,1,2,3
23337_1,,,,2,1,2,3
23338_0,,,,2,1,2,3
23338_1,,,,2,1,2,3
23340_0,,,,2,1,2,3
C(C(C=O)(C=C)O)=O,,,5,1,2,0,2
23341_0,,,,2,1,2,3
23341_1,,,,2,1,2,3
23342_0,,,,2,1,2,3
23342_1,,,,2,1,2,3
23343_0,,,,2,1,2,3
23344_0,,,,2,1,2,3
23344_1,,,,2,1,2,3
23345_0,,,,2,1,2,3
23346_0,,,,2,1,2,3
23346_1,,,,2,1,2,3
23347_0,,,,2,1,2,3
23347_1,,,,2,1,2,3
23348_0,,,,2,1,2,3
23349_0,,,,2,1,2,3
23349_1,,,,2,1,2,3
23350_0,,,,2,1,2,3
23351_0,,,,2,1,2,3
23351_1,,,,2,1,2,3
23352_0,,,,2,1,2,3
23352_1,,,,2,1,2,3
23354_0,,,,2,1,2,3
C(C(C=O)(C)O)=O,,,5,1,7,0,7
23355_0,,,,2,1,2,3
23355_1,,,,2,1,2,3
23356_0,,,,2,1,2,3
23356_1,,,,2,1,2,3
23357_0,,,,2,1,2,3
23358_0,,,,2,1,2,3
23359_0,,,,2,1,2,3
23359_1,,,,2,1,2,3
23360_0,,,,2,1,2,3
23361_0,,,,2,1,2,3
23361_1,,,,2,1,2,3
23362_0,,,,2,1,2,3
23362_1,,,,2,1,2,3
23364_0,,,,2,1,2,3
C(C(C=O)(CCO)O)=O,,,5,1,6,0,6
23365_0,,,,2,1,2,3
23365_1,,,,2,1,2,3
23366_0,,,,2,1,2,3
23367_0,,,,2,1,2,3
23367_1,,,,2,1,2,3
23368_0,,,,2,1,2,3
23369_0,,,,2,1,2,3
23370_0,,,,2,1,2,3
23370_1,,,,2,1,2,3
23371_0,,,,2,1,2,3
23372_0,,,,2,1,2,3
23372_1,,,,2,1,2,3
23373_0,,,,2,1,2,3
23374_0,,,,2,1,2,3
23375_0,,,,2,1,2,3
23375_1,,,,2,1,2,3
23376_0,,,,2,1,2,3
23377_0,,,,2,1,2,3
23378_0,,,,2,1,2,3
23378_1,,,,2,1,2,3
23379_0,,,,2,1,2,3
23380_0,,,,2,1,2,3
23380_1,,,,2,1,2,3
23381_0,,,,2,1,2,3
23381_1,,,,2,1,2,3
23382_0,,,,2,1,2,3
23383_0,,,,2,1,2,3
23383_1,,,,2,1,2,3
23384_0,,,,2,1,2,3
23384_1,,,,2,1,2,3
23385_0,,,,2,1,2,3
23386_0,,,,2,1,2,3
23386_1,,,,2,1,2,3
23387_0,,,,2,1,2,3
23388_0,,,,2,1,2,3
23389_0,,,,2,1,2,3
23389_1,,,,2,1,2,3
23390_0,,,,2,1,2,3
23391_0,,,,2,1,2,3
23391_1,,,,2,1,2,3
23392_0,,,,2,1,2,3
23392_1,,,,2,1,2,3
23393_0,,,,2,1,2,3
23393_1,,,,2,1,2,3
23394_0,,,,2,1,2,3
23395_0,,,,2,1,2,3
23395_1,,,,2,1,2,3
23396_0,,,,2,1,2,3
23397_0,,,,2,1,2,3
23397_1,,,,2,1,2,3
23398_0,,,,2,1,2,3
23398_1,,,,2,1,2,3
23399_0,,,,2,1,2,3
23399_1,,,,2,1,2,3
23400_0,,,,2,1,2,3
23401_0,,,,2,1,2,3
23401_1,,,,2,1,2,3
23402_0,,,,2,1,2,3
23403_0,,,,2,1,2,3
23403_1,,,,2,1,2,3
23404_0,,,,2,1,2,3
23404_1,,,,2,1,2,3
23405_0,,,,2,1,2,3
23405_1,,,,2,1,2,3
23405_2,,,,2,1,2,3
23406_0,,,,2,1,2,3
23406_1,,,,2,1,2,3
23406_2,,,,2,1,2,3
23407_0,,,,2,1,2,3
23408_0,,,,2,1,2,3
23408_1,,,,2,1,2,3
23409_0,,,,2,1,2,3
23410_0,,,,2,1,2,3
23410_1,,,,2,1,2,3
23411_0,,,,2,1,2,3
23411_1,,,,2,1,2,3
23412_0,,,,2,1,2,3
23412_1,,,,2,1,2,3
23413_0,,,,2,1,2,3
23413_1,,,,2,1,2,3
23414_0,,,,2,1,2,3
23414_1,,,,2,1,2,3
23415_0,,,,2,1,2,3
23415_1,,,,2,1,2,3
23415_2,,,,2,1,2,3
23416_0,,,,2,1,2,3
23416_1,,,,2,1,2,3
23416_2,,,,2,1,2,3
23417_0,,,,2,1,2,3
23418_0,,,,2,1,2,3
23418_1,,,,2,1,2,3
23419_0,,,,2,1,2,3
23419_1,,,,2,1,2,3
23420_0,,,,2,1,2,3
23420_1,,,,2,1,2,3
23421_0,,,,2,1,2,3
23422_0,,,,2,1,2,3
23422_1,,,,2,1,2,3
23423_0,,,,2,1,2,3
23423_1,,,,2,1,2,3
23424_0,,,,2,1,2,3
23424_1,,,,2,1,2,3
23424_2,,,,2,1,2,3
23425_0,,,,2,1,2,3
23425_1,,,,2,1,2,3
23425_2,,,,2,1,2,3
23426_0,,,,2,1,2,3
23426_1,,,,2,1,2,3
23427_0,,,,2,1,2,3
23427_1,,,,2,1,2,3
23428_0,,,,2,1,2,3
23429_0,,,,2,1,2,3
23430_0,,,,2,1,2,3
23430_1,,,,2,1,2,3
23431_0,,,,2,1,2,3
23431_1,,,,2,1,2,3
23432_0,,,,2,1,2,3
23432_1,,,,2,1,2,3
23433_0,,,,2,1,2,3
23433_1,,,,2,1,2,3
23434_0,,,,2,1,2,3
23435_0,,,,2,1,2,3
23435_1,,,,2,1,2,3
23436_0,,,,2,1,2,3
23437_0,,,,2,1,2,3
23437_1,,,,2,1,2,3
23438_0,,,,2,1,2,3
23438_1,,,,2,1,2,3
23439_0,,,,2,1,2,3
23439_1,,,,2,1,2,3
23440_0,,,,2,1,2,3
23441_0,,,,2,1,2,3
23441_1,,,,2,1,2,3
23442_0,,,,2,1,2,3
23443_0,,,,2,1,2,3
23443_1,,,,2,1,2,3
23444_0,,,,2,1,2,3
23445_0,,,,2,1,2,3
23445_1,,,,2,1,2,3
23446_0,,,,2,1,2,3
23447_0,,,,2,1,2,3
23447_1,,,,2,1,2,3
23448_0,,,,2,1,2,3
23448_1,,,,2,1,2,3
23449_0,,,,2,1,2,3
23450_0,,,,2,1,2,3
23450_1,,,,2,1,2,3
23451_0,,,,2,1,2,3
23451_1,,,,2,1,2,3
23452_0,,,,2,1,2,3
23453_0,,,,2,1,2,3
23453_1,,,,2,1,2,3
23454_0,,,,2,1,2,3
23455_0,,,,2,1,2,3
23455_1,,,,2,1,2,3
23456_0,,,,2,1,2,3
23457_0,,,,2,1,2,3
23457_1,,,,2,1,2,3
23458_0,,,,2,1,2,3
23458_1,,,,2,1,2,3
23459_0,,,,2,1,2,3
23460_0,,,,2,1,2,3
23460_1,,,,2,1,2,3
23461_0,,,,2,1,2,3
23462_0,,,,2,1,2,3
23462_1,,,,2,1,2,3
23463_0,,,,2,1,2,3
23463_1,,,,2,1,2,3
23464_0,,,,2,1,2,3
23465_0,,,,2,1,2,3
23465_1,,,,2,1,2,3
23466_0,,,,2,1,2,3
23466_1,,,,2,1,2,3
23467_0,,,,2,1,2,3
23468_0,,,,2,1,2,3
23469_0,,,,2,1,2,3
23469_1,,,,2,1,2,3
23470_0,,,,2,1,2,3
23471_0,,,,2,1,2,3
23471_1,,,,2,1,2,3
23472_0,,,,2,1,2,3
23473_0,,,,2,1,2,3
23473_1,,,,2,1,2,3
23474_0,,,,2,1,2,3
23475_0,,,,2,1,2,3
23475_1,,,,2,1,2,3
23476_0,,,,2,1,2,3
23477_0,,,,2,1,2,3
23478_0,,,,2,1,2,3
23479_0,,,,2,1,2,3
23480_0,,,,2,1,2,3
23481_0,,,,2,1,2,3
23482_0,,,,2,1,2,3
23483_0,,,,2,1,2,3
23484_0,,,,2,1,2,3
23485_0,,,,2,1,2,3
23486_0,,,,2,1,2,3
23487_0,,,,2,1,2,3
23488_0,,,,2,1,2,3
23489_0,,,,2,1,2,3
23490_0,,,,2,1,2,3
23491_0,,,,2,1,2,3
23492_0,,,,2,1,2,3
23493_0,,,,2,1,2,3
23494_0,,,,2,1,2,3
23495_0,,,,2,1,2,3
23496_0,,,,2,1,2,3
23497_0,,,,2,1,2,3
23498_0,,,,2,1,2,3
23499_0,,,,2,1,2,3
23500_0,,,,2,1,2,3
23501_0,,,,2,1,2,3
23502_0,,,,2,1,2,3
23503_0,,,,2,1,2,3
23504_0,,,,2,1,2,3
23505_0,,,,2,1,2,3
23506_0,,,,2,1,2,3
23507_0,,,,2,1,2,3
23508_0,,,,2,1,2,3
23509_0,,,,2,1,2,3
23510_0,,,,2,1,2,3
23510_1,,,,2,1,2,3
23511_0,,,,2,1,2,3
23511_1,,,,2,1,2,3
23511_2,,,,2,1,2,3
23512_0,,,,2,1,2,3
23512_1,,,,2,1,2,3
23512_2,,,,2,1,2,3
23513_0,,,,2,1,2,3
23514_0,,,,2,1,2,3
23514_1,,,,2,1,2,3
23515_0,,,,2,1,2,3
23516_0,,,,2,1,2,3
23516_1,,,,2,1,2,3
23517_0,,,,2,1,2,3
23517_1,,,,2,1,2,3
23518_0,,,,2,1,2,3
23518_1,,,,2,1,2,3
23519_0,,,,2,1,2,3
23519_1,,,,2,1,2,3
23520_0,,,,2,1,2,3
23520_1,,,,2,1,2,3
23521_0,,,,2,1,2,3
23521_1,,,,2,1,2,3
23521_2,,,,2,1,2,3
23522_0,,,,2,1,2,3
23522_1,,,,2,1,2,3
23522_2,,,,2,1,2,3
23523_0,,,,2,1,2,3
23524_0,,,,2,1,2,3
23524_1,,,,2,1,2,3
23525_0,,,,2,1,2,3
23525_1,,,,2,1,2,3
23526_0,,,,2,1,2,3
23526_1,,,,2,1,2,3
23527_0,,,,2,1,2,3
23527_1,,,,2,1,2,3
23528_0,,,,2,1,2,3
23528_1,,,,2,1,2,3
23528_2,,,,2,1,2,3
23529_0,,,,2,1,2,3
23529_1,,,,2,1,2,3
23529_2,,,,2,1,2,3
23530_0,,,,2,1,2,3
23530_1,,,,2,1,2,3
23531_0,,,,2,1,2,3
23531_1,,,,2,1,2,3
23532_0,,,,2,1,2,3
23533_0,,,,2,1,2,3
23534_0,,,,2,1,2,3
23534_1,,,,2,1,2,3
23535_0,,,,2,1,2,3
23535_1,,,,2,1,2,3
23536_0,,,,2,1,2,3
23536_1,,,,2,1,2,3
23537_0,,,,2,1,2,3
23537_1,,,,2,1,2,3
23538_0,,,,2,1,2,3
23539_0,,,,2,1,2,3
23539_1,,,,2,1,2,3
23540_0,,,,2,1,2,3
23541_0,,,,2,1,2,3
23541_1,,,,2,1,2,3
23542_0,,,,2,1,2,3
23542_1,,,,2,1,2,3
23543_0,,,,2,1,2,3
23543_1,,,,2,1,2,3
23544_0,,,,2,1,2,3
23545_0,,,,2,1,2,3
23545_1,,,,2,1,2,3
23546_0,,,,2,1,2,3
23547_0,,,,2,1,2,3
23547_1,,,,2,1,2,3
23548_0,,,,2,1,2,3
23548_1,,,,2,1,2,3
23549_0,,,,2,1,2,3
23549_1,,,,2,1,2,3
23550_0,,,,2,1,2,3
23551_0,,,,2,1,2,3
23552_0,,,,2,1,2,3
23552_1,,,,2,1,2,3
23553_0,,,,2,1,2,3
23553_1,,,,2,1,2,3
23554_0,,,,2,1,2,3
23554_1,,,,2,1,2,3
23555_0,,,,2,1,2,3
23555_1,,,,2,1,2,3
23556_0,,,,2,1,2,3
23556_1,,,,2,1,2,3
23557_0,,,,2,1,2,3
23557_1,,,,2,1,2,3
23558_0,,,,2,1,2,3
23558_1,,,,2,1,2,3
23559_0,,,,2,1,2,3
23559_1,,,,2,1,2,3
23560_0,,,,2,1,2,3
23560_1,,,,2,1,2,3
23561_0,,,,2,1,2,3
23561_1,,,,2,1,2,3
23562_0,,,,2,1,2,3
23562_1,,,,2,1,2,3
23563_0,,,,2,1,2,3
23564_0,,,,2,1,2,3
23564_1,,,,2,1,2,3
23565_0,,,,2,1,2,3
23565_1,,,,2,1,2,3
23566_0,,,,2,1,1,2
23566_1,,,,2,1,1,2
23567_0,,,,2,1,2,3
23567_1,,,,2,1,2,3
23568_0,,,,2,1,1,2
23569_0,,,,2,1,2,3
23569_1,,,,2,1,2,3
23570_0,,,,2,1,2,3
23570_1,,,,2,1,2,3
23571_0,,,,2,1,2,3
23571_1,,,,2,1,2,3
23572_0,,,,2,1,2,3
23572_1,,,,2,1,2,3
23573_0,,,,2,1,2,3
23574_0,,,,2,1,2,3
23574_1,,,,2,1,2,3
23575_0,,,,2,1,2,3
23575_1,,,,2,1,2,3
23576_0,,,,2,1,2,3
23576_1,,,,2,1,2,3
23577_0,,,,2,1,2,3
23577_1,,,,2,1,2,3
23578_0,,,,2,1,2,3
23578_1,,,,2,1,2,3
23579_0,,,,2,1,2,3
23579_1,,,,2,1,2,3
23580_0,,,,2,1,2,3
23580_1,,,,2,1,2,3
23581_0,,,,2,1,2,3
23582_0,,,,2,1,2,3
23583_0,,,,2,1,2,3
23583_1,,,,2,1,2,3
23584_0,,,,2,1,2,3
23584_1,,,,2,1,2,3
23585_0,,,,2,1,2,3
23585_1,,,,2,1,2,3
23586_0,,,,2,1,2,3
23586_1,,,,2,1,2,3
23587_0,,,,2,1,2,3
23587_1,,,,2,1,2,3
23588_0,,,,2,1,2,3
23588_1,,,,2,1,2,3
23589_0,,,,2,1,2,3
23589_1,,,,2,1,2,3
23590_0,,,,2,1,2,3
23590_1,,,,2,1,2,3
23591_0,,,,2,1,2,3
23591_1,,,,2,1,2,3
23592_0,,,,2,1,2,3
23592_1,,,,2,1,2,3
23593_0,,,,2,1,2,3
23593_1,,,,2,1,2,3
23594_0,,,,2,1,2,3
23594_1,,,,2,1,2,3
23595_0,,,,2,1,2,3
23595_1,,,,2,1,2,3
23596_0,,,,2,1,2,3
23596_1,,,,2,1,2,3
23597_0,,,,2,1,2,3
23597_1,,,,2,1,2,3
23598_0,,,,2,1,2,3
23598_1,,,,2,1,2,3
23599_0,,,,2,1,2,3
23599_1,,,,2,1,2,3
23600_0,,,,2,1,2,3
23600_1,,,,2,1,2,3
23601_0,,,,2,1,2,3
23601_1,,,,2,1,2,3
23602_0,,,,2,1,2,3
23602_1,,,,2,1,2,3
23603_0,,,,2,1,2,3
23603_1,,,,2,1,2,3
23604_0,,,,2,1,2,3
23604_1,,,,2,1,2,3
23605_0,,,,2,1,2,3
23605_1,,,,2,1,2,3
23606_0,,,,2,1,2,3
23606_1,,,,2,1,2,3
23607_0,,,,2,1,2,3
23607_1,,,,2,1,2,3
23608_0,,,,2,1,2,3
23608_1,,,,2,1,2,3
23609_0,,,,2,1,2,3
23609_1,,,,2,1,2,3
23610_0,,,,2,1,2,3
23610_1,,,,2,1,2,3
23611_0,,,,2,1,2,3
23611_1,,,,2,1,2,3
23612_0,,,,2,1,2,3
23612_1,,,,2,1,2,3
23613_0,,,,2,1,2,3
23614_0,,,,2,1,2,3
23614_1,,,,2,1,2,3
23615_0,,,,2,1,2,3
23615_1,,,,2,1,2,3
23616_0,,,,2,1,2,3
23617_0,,,,2,1,2,3
23617_1,,,,2,1,2,3
23618_0,,,,2,1,2,3
23619_0,,,,2,1,2,3
23619_1,,,,2,1,2,3
23620_0,,,,2,1,2,3
23620_1,,,,2,1,2,3
23622_0,,,,2,1,2,3
C(C)(C(C(C)=O)O)=O,,,5,1,7,0,7
23622_1,,,,2,1,2,3
23623_0,,,,2,1,2,3
23623_1,,,,2,1,2,3
23624_0,,,,2,1,2,3
23624_1,,,,2,1,2,3
23625_0,,,,2,1,2,3
23625_1,,,,2,1,2,3
23626_0,,,,2,1,2,3
23627_0,,,,2,1,2,3
23628_0,,,,2,1,2,3
23629_0,,,,2,1,2,3
23630_0,,,,2,1,2,3
23631_0,,,,2,1,2,3
23632_0,,,,2,1,2,3
23633_0,,,,2,1,2,3
23634_0,,,,2,1,2,3
23635_0,,,,2,1,2,3
23636_0,,,,2,1,2,3
23637_0,,,,2,1,2,3
23638_0,,,,2,1,2,3
23639_0,,,,2,1,2,3
23640_0,,,,2,1,2,3
23641_0,,,,2,1,2,3
23642_0,,,,2,1,2,3
23643_0,,,,2,1,2,3
23644_0,,,,2,1,2,3
23645_0,,,,2,1,2,3
23646_0,,,,2,1,2,3
23647_0,,,,2,1,2,3
23648_0,,,,2,1,2,3
23649_0,,,,2,1,2,3
23650_0,,,,2,1,2,3
23651_0,,,,2,1,2,3
23652_0,,,,2,1,2,3
23653_0,,,,2,1,2,3
23654_0,,,,2,1,2,3
23655_0,,,,2,1,2,3
23656_0,,,,2,1,2,3
23657_0,,,,2,1,2,3
23658_0,,,,2,1,2,3
23658_1,,,,2,1,2,3
23659_0,,,,2,1,2,3
23660_0,,,,2,1,2,3
23661_0,,,,2,1,2,3
23662_0,,,,2,1,2,3
23663_0,,,,2,1,2,3
23663_1,,,,2,1,2,3
23664_0,,,,2,1,2,3
23664_1,,,,2,1,2,3
23665_0,,,,2,1,2,3
23665_1,,,,2,1,2,3
23666_0,,,,2,1,2,3
23667_0,,,,2,1,2,3
23667_1,,,,2,1,2,3
23668_0,,,,2,1,2,3
23669_0,,,,2,1,2,3
23669_1,,,,2,1,2,3
23670_0,,,,2,1,2,3
23670_1,,,,2,1,2,3
23671_0,,,,2,1,2,3
23672_0,,,,2,1,2,3
23672_1,,,,2,1,2,3
23673_0,,,,2,1,2,3
23674_0,,,,2,1,2,3
23674_1,,,,2,1,2,3
23675_0,,,,2,1,2,3
23675_1,,,,2,1,2,3
23676_0,,,,2,1,2,3
23677_0,,,,2,1,2,3
23677_1,,,,2,1,2,3
23678_0,,,,2,1,2,3
23678_1,,,,2,1,2,3
23679_0,,,,2,1,2,3
23680_0,,,,2,1,2,3
23680_1,,,,2,1,2,3
23681_0,,,,2,1,2,3
23682_0,,,,2,1,2,3
23682_1,,,,2,1,2,3
23683_0,,,,2,1,2,3
23684_0,,,,2,1,2,3
23684_1,,,,2,1,2,3
23685_0,,,,2,1,2,3
23686_0,,,,2,1,2,3
23686_1,,,,2,1,2,3
23687_0,,,,2,1,2,3
23687_1,,,,2,1,2,3
23688_0,,,,2,1,2,3
23689_0,,,,2,1,2,3
23689_1,,,,2,1,2,3
23690_0,,,,2,1,2,3
23691_0,,,,2,1,2,3
23691_1,,,,2,1,2,3
23692_0,,,,2,1,2,3
23693_0,,,,2,1,2,3
23693_1,,,,2,1,2,3
23694_0,,,,2,1,2,3
23695_0,,,,2,1,2,3
23695_1,,,,2,1,2,3
23696_0,,,,2,1,2,3
23696_1,,,,2,1,2,3
23697_0,,,,2,1,2,3
23697_1,,,,2,1,2,3
23698_0,,,,2,1,2,3
23698_1,,,,2,1,2,3
23699_0,,,,2,1,2,3
23699_1,,,,2,1,2,3
23700_0,,,,2,1,2,3
23700_1,,,,2,1,2,3
23701_0,,,,2,1,2,3
23701_1,,,,2,1,2,3
23702_0,,,,2,1,2,3
23702_1,,,,2,1,2,3
23703_0,,,,2,1,2,3
23703_1,,,,2,1,2,3
23704_0,,,,2,1,2,3
23704_1,,,,2,1,2,3
23705_0,,,,2,1,2,3
23705_1,,,,2,1,2,3
23706_0,,,,2,1,2,3
23706_1,,,,2,1,2,3
23707_0,,,,2,1,2,3
23707_1,,,,2,1,2,3
23708_0,,,,2,1,2,3
23708_1,,,,2,1,2,3
23709_0,,,,2,1,2,3
23709_1,,,,2,1,2,3
23710_0,,,,2,1,2,3
23710_1,,,,2,1,2,3
23711_0,,,,2,1,2,3
23711_1,,,,2,1,2,3
23712_0,,,,2,1,2,3
23712_1,,,,2,1,2,3
23713_0,,,,2,1,2,3
23713_1,,,,2,1,2,3
23714_0,,,,2,1,2,3
23714_1,,,,2,1,2,3
23715_0,,,,2,1,2,3
23715_1,,,,2,1,2,3
23716_0,,,,2,1,2,3
23716_1,,,,2,1,2,3
23717_0,,,,2,1,2,3
23717_1,,,,2,1,2,3
23718_0,,,,2,1,2,3
23718_1,,,,2,1,2,3
23719_0,,,,2,1,2,3
23719_1,,,,2,1,2,3
23720_0,,,,2,1,2,3
23720_1,,,,2,1,2,3
23721_0,,,,2,1,2,3
23721_1,,,,2,1,2,3
23722_0,,,,2,1,2,3
23723_0,,,,2,1,2,3
23723_1,,,,2,1,2,3
23724_0,,,,2,1,2,3
23724_1,,,,2,1,2,3
23725_0,,,,2,1,2,3
23725_1,,,,2,1,2,3
23726_0,,,,2,1,2,3
23727_0,,,,2,1,2,3
23727_1,,,,2,1,2,3
23728_0,,,,2,1,2,3
23729_0,,,,2,1,2,3
23729_1,,,,2,1,2,3
23730_0,,,,2,1,2,3
23731_0,,,,2,1,2,3
23731_1,,,,2,1,2,3
23732_0,,,,2,1,2,3
23732_1,,,,2,1,2,3
23733_0,,,,2,1,2,3
23733_1,,,,2,1,2,3
23734_0,,,,2,1,2,3
23735_0,,,,2,1,2,3
23735_1,,,,2,1,2,3
23736_0,,,,2,1,2,3
23737_0,,,,2,1,2,3
23737_1,,,,2,1,2,3
23738_0,,,,2,1,2,3
23738_1,,,,2,1,2,3
23739_0,,,,2,1,2,3
23740_0,,,,2,1,2,3
23740_1,,,,2,1,2,3
23741_0,,,,2,1,2,3
23742_0,,,,2,1,2,3
23742_1,,,,2,1,2,3
23743_0,,,,2,1,2,3
23744_0,,,,2,1,2,3
23744_1,,,,2,1,2,3
23745_0,,,,2,1,2,3
23746_0,,,,2,1,2,3
23746_1,,,,2,1,2,3
23747_0,,,,2,1,2,3
23748_0,,,,2,1,2,3
23748_1,,,,2,1,2,3
23749_0,,,,2,1,2,3
23750_0,,,,2,1,2,3
23750_1,,,,2,1,2,3
23751_0,,,,2,1,2,3
23752_0,,,,2,1,2,3
23752_1,,,,2,1,2,3
23753_0,,,,2,1,2,3
23754_0,,,,2,1,2,3
23754_1,,,,2,1,2,3
23755_0,,,,2,1,2,3
23756_0,,,,2,1,2,3
23756_1,,,,2,1,2,3
23757_0,,,,2,1,2,3
23758_0,,,,2,1,2,3
23758_1,,,,2,1,2,3
23759_0,,,,2,1,2,3
23760_0,,,,2,1,2,3
23761_0,,,,2,1,2,3
23761_1,,,,2,1,2,3
23762_0,,,,2,1,2,3
23762_1,,,,2,1,2,3
23763_0,,,,2,1,2,3
23763_1,,,,2,1,2,3
23764_0,,,,2,1,2,3
23764_1,,,,2,1,2,3
23765_0,,,,2,1,2,3
23765_1,,,,2,1,2,3
23766_0,,,,2,1,2,3
23766_1,,,,2,1,2,3
23767_0,,,,2,1,2,3
23767_1,,,,2,1,2,3
23768_0,,,,2,1,2,3
23768_1,,,,2,1,2,3
23769_0,,,,2,1,2,3
23769_1,,,,2,1,2,3
23770_0,,,,2,1,2,3
23770_1,,,,2,1,2,3
23771_0,,,,2,1,2,3
23772_0,,,,2,1,2,3
23772_1,,,,2,1,2,3
23773_0,,,,2,1,2,3
23773_1,,,,2,1,2,3
23774_0,,,,2,1,1,2
23774_1,,,,2,1,1,2
23775_0,,,,2,1,2,3
23775_1,,,,2,1,2,3
23776_0,,,,2,1,1,2
23777_0,,,,2,1,2,3
23777_1,,,,2,1,2,3
23778_0,,,,2,1,2,3
23778_1,,,,2,1,2,3
23779_0,,,,2,1,2,3
23779_1,,,,2,1,2,3
23780_0,,,,2,1,2,3
23780_1,,,,2,1,2,3
23781_0,,,,2,1,2,3
23782_0,,,,2,1,2,3
23782_1,,,,2,1,2,3
23783_0,,,,2,1,2,3
23783_1,,,,2,1,2,3
23784_0,,,,2,1,2,3
23784_1,,,,2,1,2,3
23785_0,,,,2,1,2,3
23785_1,,,,2,1,2,3
23786_0,,,,2,1,2,3
23786_1,,,,2,1,2,3
23787_0,,,,2,1,2,3
23787_1,,,,2,1,2,3
23788_0,,,,2,1,2,3
23788_1,,,,2,1,2,3
23789_0,,,,2,1,2,3
23790_0,,,,2,1,2,3
23791_0,,,,2,1,2,3
23791_1,,,,2,1,2,3
23792_0,,,,2,1,2,3
23792_1,,,,2,1,2,3
23793_0,,,,2,1,2,3
23793_1,,,,2,1,2,3
23794_0,,,,2,1,2,3
23794_1,,,,2,1,2,3
23795_0,,,,2,1,1,2
23795_1,,,,2,1,1,2
23796_0,,,,2,1,2,3
23796_1,,,,2,1,2,3
23797_0,,,,2,1,1,2
23798_0,,,,2,1,2,3
23798_1,,,,2,1,2,3
23799_0,,,,2,1,2,3
23799_1,,,,2,1,2,3
23800_0,,,,2,1,2,3
23801_0,,,,2,1,2,3
23801_1,,,,2,1,2,3
23802_0,,,,2,1,2,3
23802_1,,,,2,1,2,3
23803_0,,,,2,1,2,3
23803_1,,,,2,1,2,3
23804_0,,,,2,1,2,3
23804_1,,,,2,1,2,3
23805_0,,,,2,1,2,3
23805_1,,,,2,1,2,3
23806_0,,,,2,1,2,3
23806_1,,,,2,1,2,3
23807_0,,,,2,1,2,3
23807_1,,,,2,1,2,3
23808_0,,,,2,1,2,3
23809_0,,,,2,1,2,3
23810_0,,,,2,1,2,3
23810_1,,,,2,1,2,3
23811_0,,,,2,1,2,3
23812_0,,,,2,1,2,3
23813_0,,,,2,1,2,3
23814_0,,,,2,1,2,3
23815_0,,,,2,1,2,3
23816_0,,,,2,1,2,3
23817_0,,,,2,1,2,3
23818_0,,,,2,1,2,3
23819_0,,,,2,1,2,3
23820_0,,,,2,1,2,3
23821_0,,,,2,1,2,3
23822_0,,,,2,1,2,3
23823_0,,,,2,1,2,3
23824_0,,,,2,1,2,3
23825_0,,,,2,1,2,3
23826_0,,,,2,1,2,3
23827_0,,,,2,1,2,3
23828_0,,,,2,1,2,3
23829_0,,,,2,1,2,3
23830_0,,,,2,1,2,3
23831_0,,,,2,1,2,3
23833_0,,,,2,1,2,3
C(CO)(CC(C(O)=O)=O)=O,,,5,1,5,0,5
23834_0,,,,2,1,2,3
23835_0,,,,2,1,2,3
23835_1,,,,2,1,2,3
23836_0,,,,2,1,2,3
23837_0,,,,2,1,2,3
23837_1,,,,2,1,2,3
23838_0,,,,2,1,2,3
23839_0,,,,2,1,2,3
23840_0,,,,2,1,2,3
23840_1,,,,2,1,2,3
23841_0,,,,2,1,2,3
23841_1,,,,2,1,2,3
23842_0,,,,2,1,2,3
23842_1,,,,2,1,2,3
23843_0,,,,2,1,2,3
23843_1,,,,2,1,2,3
23844_0,,,,2,1,1,2
23844_1,,,,2,1,1,2
23845_0,,,,2,1,2,3
23845_1,,,,2,1,2,3
23846_0,,,,2,1,1,2
23847_0,,,,2,1,2,3
23847_1,,,,2,1,2,3
23848_0,,,,2,1,2,3
23848_1,,,,2,1,2,3
23849_0,,,,2,1,2,3
23850_0,,,,2,1,2,3
23850_1,,,,2,1,2,3
23851_0,,,,2,1,2,3
23851_1,,,,2,1,2,3
23852_0,,,,2,1,2,3
23852_1,,,,2,1,2,3
23853_0,,,,2,1,2,3
23853_1,,,,2,1,2,3
23854_0,,,,2,1,2,3
23854_1,,,,2,1,2,3
23855_0,,,,2,1,2,3
23855_1,,,,2,1,2,3
23856_0,,,,2,1,2,3
23856_1,,,,2,1,2,3
23857_0,,,,2,1,2,3
23858_0,,,,2,1,2,3
23859_0,,,,2,1,2,3
23859_1,,,,2,1,2,3
23860_0,,,,2,1,2,3
23860_1,,,,2,1,2,3
23861_0,,,,2,1,2,3
23861_1,,,,2,1,2,3
23862_0,,,,2,1,2,3
23862_1,,,,2,1,2,3
23863_0,,,,2,1,2,3
23863_1,,,,2,1,2,3
23864_0,,,,2,1,2,3
23864_1,,,,2,1,2,3
23865_0,,,,2,1,2,3
23865_1,,,,2,1,2,3
23866_0,,,,2,1,2,3
23866_1,,,,2,1,2,3
23867_0,,,,2,1,2,3
23867_1,,,,2,1,2,3
23868_0,,,,2,1,2,3
23868_1,,,,2,1,2,3
23869_0,,,,2,1,2,3
23869_1,,,,2,1,2,3
23870_0,,,,2,1,2,3
23870_1,,,,2,1,2,3
23871_0,,,,2,1,2,3
23871_1,,,,2,1,2,3
23872_0,,,,2,1,2,3
23872_1,,,,2,1,2,3
23873_0,,,,2,1,2,3
23873_1,,,,2,1,2,3
23874_0,,,,2,1,2,3
23874_1,,,,2,1,2,3
23875_0,,,,2,1,2,3
23875_1,,,,2,1,2,3
23876_0,,,,2,1,2,3
23876_1,,,,2,1,2,3
23877_0,,,,2,1,2,3
23877_1,,,,2,1,2,3
23878_0,,,,2,1,2,3
23878_1,,,,2,1,2,3
23879_0,,,,2,1,2,3
23879_1,,,,2,1,2,3
23880_0,,,,2,1,2,3
23880_1,,,,2,1,2,3
23881_0,,,,2,1,2,3
23881_1,,,,2,1,2,3
23882_0,,,,2,1,2,3
23883_0,,,,2,1,2,3
23883_1,,,,2,1,2,3
23884_0,,,,2,1,2,3
23884_1,,,,2,1,2,3
23885_0,,,,2,1,2,3
23885_1,,,,2,1,2,3
23886_0,,,,2,1,2,3
23886_1,,,,2,1,2,3
23887_0,,,,2,1,2,3
23888_0,,,,2,1,2,3
23888_1,,,,2,1,2,3
23889_0,,,,2,1,2,3
23889_1,,,,2,1,2,3
23890_0,,,,2,1,2,3
23891_0,,,,2,1,2,3
23891_1,,,,2,1,2,3
23892_0,,,,2,1,2,3
23892_1,,,,2,1,2,3
23893_0,,,,2,1,2,3
23893_1,,,,2,1,2,3
23894_0,,,,2,1,2,3
23894_1,,,,2,1,2,3
23895_0,,,,2,1,2,3
23896_0,,,,2,1,2,3
23896_1,,,,2,1,2,3
23897_0,,,,2,1,2,3
23897_1,,,,2,1,2,3
23898_0,,,,2,1,2,3
23899_0,,,,2,1,2,3
23899_1,,,,2,1,2,3
23900_0,,,,2,1,2,3
23900_1,,,,2,1,2,3
23901_0,,,,2,1,2,3
23901_1,,,,2,1,2,3
23902_0,,,,2,1,2,3
23902_1,,,,2,1,2,3
23903_0,,,,2,1,2,3
23903_1,,,,2,1,2,3
23904_0,,,,2,1,2,3
23904_1,,,,2,1,2,3
23905_0,,,,2,1,2,3
23905_1,,,,2,1,2,3
23906_0,,,,2,1,2,3
23906_1,,,,2,1,2,3
23907_0,,,,2,1,2,3
23907_1,,,,2,1,2,3
23908_0,,,,2,1,2,3
23908_1,,,,2,1,2,3
23909_0,,,,2,1,2,3
23909_1,,,,2,1,2,3
23910_0,,,,2,1,2,3
23910_1,,,,2,1,2,3
23911_0,,,,2,1,2,3
23911_1,,,,2,1,2,3
23912_0,,,,2,1,2,3
23912_1,,,,2,1,2,3
23913_0,,,,2,1,2,3
23914_0,,,,2,1,2,3
23914_1,,,,2,1,2,3
23915_0,,,,2,1,2,3
23916_0,,,,2,1,2,3
23916_1,,,,2,1,2,3
23917_0,,,,2,1,2,3
23917_1,,,,2,1,2,3
23918_0,,,,2,1,2,3
23918_1,,,,2,1,2,3
23919_0,,,,2,1,2,3
23919_1,,,,2,1,2,3
23920_0,,,,2,1,2,3
23920_1,,,,2,1,2,3
23921_0,,,,2,1,2,3
23921_1,,,,2,1,2,3
23922_0,,,,2,1,2,3
23922_1,,,,2,1,2,3
23923_0,,,,2,1,2,3
23924_0,,,,2,1,2,3
23924_1,,,,2,1,2,3
23925_0,,,,2,1,2,3
23925_1,,,,2,1,2,3
23926_0,,,,2,1,2,3
23926_1,,,,2,1,2,3
23927_0,,,,2,1,2,3
23927_1,,,,2,1,2,3
23928_0,,,,2,1,2,3
23928_1,,,,2,1,2,3
23929_0,,,,2,1,2,3
23929_1,,,,2,1,2,3
23930_0,,,,2,1,2,3
23930_1,,,,2,1,2,3
23931_0,,,,2,1,2,3
23932_0,,,,2,1,2,3
23932_1,,,,2,1,2,3
23933_0,,,,2,1,2,3
23934_0,,,,2,1,2,3
23934_1,,,,2,1,2,3
23935_0,,,,2,1,2,3
23936_0,,,,2,1,2,3
23936_1,,,,2,1,2,3
23937_0,,,,2,1,2,3
23938_0,,,,2,1,2,3
23938_1,,,,2,1,2,3
23939_0,,,,2,1,2,3
23940_0,,,,2,1,2,3
23940_1,,,,2,1,2,3
23941_0,,,,2,1,2,3
23942_0,,,,2,1,2,3
23942_1,,,,2,1,2,3
23943_0,,,,2,1,2,3
23943_1,,,,2,1,2,3
23944_0,,,,2,1,2,3
23944_1,,,,2,1,2,3
23945_0,,,,2,1,2,3
23945_1,,,,2,1,2,3
23946_0,,,,2,1,2,3
23946_1,,,,2,1,2,3
23947_0,,,,2,1,2,3
23947_1,,,,2,1,2,3
23948_0,,,,2,1,2,3
23948_1,,,,2,1,2,3
23949_0,,,,2,1,2,3
23950_0,,,,2,1,2,3
23950_1,,,,2,1,2,3
23951_0,,,,2,1,2,3
23951_1,,,,2,1,2,3
23952_0,,,,2,1,2,3
23952_1,,,,2,1,2,3
23953_0,,,,2,1,2,3
23953_1,,,,2,1,2,3
23954_0,,,,2,1,2,3
23954_1,,,,2,1,2,3
23955_0,,,,2,1,2,3
23955_1,,,,2,1,2,3
23956_0,,,,2,1,2,3
23956_1,,,,2,1,2,3
23957_0,,,,2,1,2,3
23957_1,,,,2,1,2,3
23958_0,,,,2,1,2,3
23958_1,,,,2,1,2,3
23959_0,,,,2,1,2,3
23959_1,,,,2,1,2,3
23960_0,,,,2,1,2,3
23960_1,,,,2,1,2,3
23961_0,,,,2,1,2,3
23961_1,,,,2,1,2,3
23962_0,,,,2,1,2,3
23962_1,,,,2,1,2,3
23963_0,,,,2,1,2,3
23963_1,,,,2,1,2,3
23964_0,,,,2,1,2,3
23964_1,,,,2,1,2,3
23965_0,,,,2,1,2,3
23965_1,,,,2,1,2,3
23966_0,,,,2,1,2,3
23966_1,,,,2,1,2,3
23967_0,,,,2,1,2,3
23968_0,,,,2,1,2,3
23968_1,,,,2,1,2,3
23969_0,,,,2,1,2,3
23969_1,,,,2,1,2,3
23970_0,,,,2,1,2,3
23970_1,,,,2,1,2,3
23971_0,,,,2,1,2,3
23971_1,,,,2,1,2,3
23972_0,,,,2,1,2,3
23973_0,,,,2,1,2,3
23973_1,,,,2,1,2,3
23974_0,,,,2,1,2,3
23975_0,,,,2,1,2,3
23975_1,,,,2,1,2,3
23976_0,,,,2,1,2,3
23977_0,,,,2,1,2,3
23977_1,,,,2,1,2,3
23978_0,,,,2,1,2,3
23979_0,,,,2,1,2,3
23979_1,,,,2,1,2,3
23980_0,,,,2,1,2,3
23981_0,,,,2,1,2,3
23982_0,,,,2,1,2,3
23982_1,,,,2,1,2,3
23983_0,,,,2,1,2,3
23984_0,,,,2,1,2,3
23984_1,,,,2,1,2,3
23985_0,,,,2,1,2,3
23986_0,,,,2,1,2,3
23986_1,,,,2,1,2,3
23986_2,,,,2,1,2,3
23987_0,,,,2,1,2,3
23988_0,,,,2,1,2,3
23988_1,,,,2,1,2,3
23989_0,,,,2,1,2,3
23990_0,,,,2,1,2,3
23990_1,,,,2,1,2,3
23991_0,,,,2,1,2,3
23991_1,,,,2,1,2,3
23992_0,,,,2,1,2,3
23992_1,,,,2,1,2,3
23992_2,,,,2,1,2,3
23993_0,,,,2,1,2,3
23993_1,,,,2,1,2,3
23993_2,,,,2,1,2,3
23994_0,,,,2,1,2,3
23995_0,,,,2,1,2,3
23995_1,,,,2,1,2,3
23996_0,,,,2,1,2,3
23996_1,,,,2,1,2,3
23996_2,,,,2,1,2,3
23997_0,,,,2,1,2,3
23997_1,,,,2,1,2,3
23998_0,,,,2,1,2,3
23998_1,,,,2,1,2,3
23998_2,,,,2,1,2,3
23999_0,,,,2,1,2,3
23999_1,,,,2,1,2,3
23999_2,,,,2,1,2,3
24000_0,,,,2,1,2,3
24000_1,,,,2,1,2,3
24000_2,,,,2,1,2,3
24001_0,,,,2,1,2,3
24001_1,,,,2,1,2,3
24002_0,,,,2,1,2,3
24002_1,,,,2,1,2,3
24003_0,,,,2,1,2,3
24004_0,,,,2,1,2,3
24004_1,,,,2,1,2,3
24004_2,,,,2,1,2,3
24005_0,,,,2,1,2,3
24005_1,,,,2,1,2,3
24005_2,,,,2,1,2,3
24006_0,,,,2,1,2,3
24007_0,,,,2,1,2,3
24007_1,,,,2,1,2,3
24007_2,,,,2,1,2,3
24008_0,,,,2,1,2,3
24008_1,,,,2,1,2,3
24008_2,,,,2,1,2,3
24009_0,,,,2,1,2,3
24009_1,,,,2,1,2,3
24009_2,,,,2,1,2,3
24010_0,,,,2,1,2,3
24011_0,,,,2,1,2,3
24011_1,,,,2,1,2,3
24011_2,,,,2,1,2,3
24012_0,,,,2,1,2,3
24013_0,,,,2,1,2,3
24014_0,,,,2,1,2,3
24014_1,,,,2,1,2,3
24014_2,,,,2,1,2,3
24015_0,,,,2,1,2,3
24015_1,,,,2,1,2,3
24015_2,,,,2,1,2,3
24016_0,,,,2,1,2,3
24016_1,,,,2,1,2,3
24017_0,,,,2,1,2,3
24017_1,,,,2,1,2,3
24017_2,,,,2,1,2,3
24018_0,,,,2,1,2,3
24018_1,,,,2,1,2,3
24018_2,,,,2,1,2,3
24019_0,,,,2,1,2,3
24020_0,,,,2,1,2,3
24020_1,,,,2,1,2,3
24020_2,,,,2,1,2,3
24021_0,,,,2,1,2,3
24021_1,,,,2,1,2,3
24021_2,,,,2,1,2,3
24022_0,,,,2,1,2,3
24022_1,,,,2,1,2,3
24022_2,,,,2,1,2,3
24023_0,,,,2,1,2,3
24024_0,,,,2,1,2,3
24024_1,,,,2,1,2,3
24024_2,,,,2,1,2,3
24025_0,,,,2,1,2,3
24026_0,,,,2,1,2,3
24026_1,,,,2,1,2,3
24026_2,,,,2,1,2,3
24027_0,,,,2,1,2,3
24028_0,,,,2,1,2,3
24028_1,,,,2,1,2,3
24028_2,,,,2,1,2,3
24029_0,,,,2,1,2,3
24030_0,,,,2,1,2,3
24031_0,,,,2,1,2,3
24031_1,,,,2,1,2,3
24032_0,,,,2,1,2,3
24032_1,,,,2,1,2,3
24033_0,,,,2,1,2,3
24033_1,,,,2,1,2,3
24034_0,,,,2,1,2,3
24034_1,,,,2,1,2,3
24035_0,,,,2,1,2,3
24035_1,,,,2,1,2,3
24036_0,,,,2,1,2,3
24036_1,,,,2,1,2,3
24037_0,,,,2,1,2,3
24038_0,,,,2,1,2,3
24039_0,,,,2,1,2,3
24039_1,,,,2,1,2,3
24040_0,,,,2,1,2,3
24041_0,,,,2,1,2,3
24042_0,,,,2,1,2,3
24042_1,,,,2,1,2,3
24043_0,,,,2,1,2,3
24043_1,,,,2,1,2,3
24044_0,,,,2,1,2,3
24044_1,,,,2,1,2,3
24045_0,,,,2,1,2,3
24045_1,,,,2,1,2,3
24046_0,,,,2,1,2,3
24047_0,,,,2,1,2,3
24048_0,,,,2,1,2,3
24049_0,,,,2,1,2,3
24049_1,,,,2,1,2,3
24050_0,,,,2,1,2,3
24051_0,,,,2,1,2,3
24052_0,,,,2,1,2,3
24053_0,,,,2,1,2,3
24053_1,,,,2,1,2,3
24054_0,,,,2,1,2,3
24054_1,,,,2,1,2,3
24055_0,,,,2,1,2,3
24055_1,,,,2,1,2,3
24056_0,,,,2,1,2,3
24057_0,,,,2,1,2,3
24057_1,,,,2,1,2,3
24058_0,,,,2,1,2,3
24058_1,,,,2,1,2,3
24059_0,,,,2,1,2,3
24059_1,,,,2,1,2,3
24060_0,,,,2,1,2,3
24060_1,,,,2,1,2,3
24061_0,,,,2,1,2,3
24061_1,,,,2,1,2,3
24062_0,,,,2,1,2,3
24062_1,,,,2,1,2,3
24063_0,,,,2,1,2,3
24064_0,,,,2,1,2,3
24064_1,,,,2,1,2,3
24065_0,,,,2,1,2,3
24066_0,,,,2,1,2,3
24066_1,,,,2,1,2,3
24067_0,,,,2,1,2,3
24067_1,,,,2,1,2,3
24068_0,,,,2,1,2,3
24068_1,,,,2,1,2,3
24069_0,,,,2,1,2,3
24069_1,,,,2,1,2,3
24070_0,,,,2,1,2,3
24070_1,,,,2,1,2,3
24071_0,,,,2,1,2,3
24071_1,,,,2,1,2,3
24071_2,,,,2,1,2,3
24072_0,,,,2,1,2,3
24073_0,,,,2,1,2,3
24073_1,,,,2,1,2,3
24074_0,,,,2,1,2,3
24074_1,,,,2,1,2,3
24075_0,,,,2,1,2,3
24076_0,,,,2,1,2,3
24076_1,,,,2,1,2,3
24077_0,,,,2,1,2,3
24077_1,,,,2,1,2,3
24078_0,,,,2,1,2,3
24079_0,,,,2,1,2,3
24079_1,,,,2,1,2,3
24080_0,,,,2,1,2,3
24081_0,,,,2,1,2,3
24081_1,,,,2,1,2,3
24082_0,,,,2,1,2,3
24082_1,,,,2,1,2,3
24083_0,,,,2,1,2,3
24083_1,,,,2,1,2,3
24084_0,,,,2,1,2,3
24084_1,,,,2,1,2,3
24085_0,,,,2,1,2,3
24085_1,,,,2,1,2,3
24086_0,,,,2,1,2,3
24086_1,,,,2,1,2,3
24087_0,,,,2,1,2,3
24088_0,,,,2,1,2,3
24088_1,,,,2,1,2,3
24089_0,,,,2,1,2,3
24089_1,,,,2,1,2,3
24090_0,,,,2,1,2,3
24090_1,,,,2,1,2,3
24091_0,,,,2,1,2,3
24091_1,,,,2,1,2,3
24092_0,,,,2,1,2,3
24092_1,,,,2,1,2,3
24093_0,,,,2,1,2,3
24093_1,,,,2,1,2,3
24094_0,,,,2,1,2,3
24095_0,,,,2,1,2,3
24095_1,,,,2,1,2,3
24096_0,,,,2,1,2,3
24097_0,,,,2,1,2,3
24097_1,,,,2,1,2,3
24098_0,,,,2,1,2,3
24098_1,,,,2,1,2,3
24099_0,,,,2,1,2,3
24099_1,,,,2,1,2,3
24100_0,,,,2,1,2,3
24100_1,,,,2,1,2,3
24101_0,,,,2,1,2,3
24101_1,,,,2,1,2,3
24102_0,,,,2,1,2,3
24102_1,,,,2,1,2,3
24103_0,,,,2,1,2,3
24103_1,,,,2,1,2,3
24104_0,,,,2,1,2,3
24104_1,,,,2,1,2,3
24105_0,,,,2,1,2,3
24105_1,,,,2,1,2,3
24107_0,,,,2,1,2,3
C(C1C(C(CO1)O)=O)=O,,,5,1,2,0,2
24108_0,,,,2,1,2,3
24108_1,,,,2,1,2,3
24109_0,,,,2,1,2,3
24109_1,,,,2,1,2,3
24110_0,,,,2,1,2,3
24110_1,,,,2,1,2,3
24111_0,,,,2,1,2,3
24111_1,,,,2,1,2,3
24112_0,,,,2,1,2,3
24112_1,,,,2,1,2,3
24113_0,,,,2,1,2,3
24114_0,,,,2,1,2,3
24114_1,,,,2,1,2,3
24115_0,,,,2,1,2,3
24116_0,,,,2,1,2,3
24116_1,,,,2,1,2,3
24117_0,,,,2,1,2,3
24117_1,,,,2,1,2,3
24118_0,,,,2,1,2,3
24118_1,,,,2,1,2,3
24119_0,,,,2,1,2,3
24119_1,,,,2,1,2,3
24120_0,,,,2,1,2,3
24120_1,,,,2,1,2,3
24121_0,,,,2,1,2,3
24121_1,,,,2,1,2,3
24122_0,,,,2,1,2,3
24122_1,,,,2,1,2,3
24123_0,,,,2,1,2,3
24123_1,,,,2,1,2,3
24124_0,,,,2,1,2,3
24124_1,,,,2,1,2,3
24126_0,,,,2,1,2,3
C(C1C(C(O)OC1)=O)=O,,,5,1,3,0,3
24127_0,,,,2,1,2,3
24127_1,,,,2,1,2,3
24128_0,,,,2,1,2,3
24128_1,,,,2,1,2,3
24129_0,,,,2,1,2,3
24129_1,,,,2,1,2,3
24130_0,,,,2,1,2,3
24130_1,,,,2,1,2,3
24131_0,,,,2,1,2,3
24131_1,,,,2,1,2,3
24132_0,,,,2,1,2,3
24133_0,,,,2,1,2,3
24133_1,,,,2,1,2,3
24134_0,,,,2,1,2,3
24135_0,,,,2,1,2,3
24135_1,,,,2,1,2,3
24136_0,,,,2,1,2,3
24136_1,,,,2,1,2,3
24137_0,,,,2,1,1,2
24137_1,,,,2,1,1,2
24138_0,,,,2,1,2,3
24138_1,,,,2,1,2,3
24139_0,,,,2,1,1,2
24139_1,,,,2,1,1,2
24140_0,,,,2,1,2,3
24140_1,,,,2,1,2,3
24141_0,,,,2,1,1,2
24141_1,,,,2,1,1,2
24142_0,,,,2,1,2,3
24142_1,,,,2,1,2,3
24143_0,,,,2,1,1,2
24143_1,,,,2,1,1,2
24144_0,,,,2,1,2,3
24144_1,,,,2,1,2,3
24145_0,,,,2,1,1,2
24145_1,,,,2,1,1,2
24146_0,,,,2,1,2,3
24146_1,,,,2,1,2,3
24147_0,,,,2,1,1,2
24147_1,,,,2,1,1,2
24148_0,,,,2,1,2,3
24148_1,,,,2,1,2,3
24149_0,,,,2,1,1,2
24149_1,,,,2,1,1,2
24150_0,,,,2,1,2,3
24150_1,,,,2,1,2,3
24151_0,,,,2,1,1,2
24151_1,,,,2,1,1,2
24153_0,,,,2,1,2,3
C(C1C(COC1O)=O)=O,,,5,1,3,0,3
24154_0,,,,2,1,2,3
24154_1,,,,2,1,2,3
24155_0,,,,2,1,1,2
24155_1,,,,2,1,1,2
24156_0,,,,2,1,2,3
24156_1,,,,2,1,2,3
24157_0,,,,2,1,1,2
24157_1,,,,2,1,1,2
24158_0,,,,2,1,2,3
24158_1,,,,2,1,2,3
24159_0,,,,2,1,1,2
24159_1,,,,2,1,1,2
24160_0,,,,2,1,2,3
24160_1,,,,2,1,2,3
24161_0,,,,2,1,1,2
24161_1,,,,2,1,1,2
24162_0,,,,2,1,1,2
24163_0,,,,2,1,2,3
24163_1,,,,2,1,2,3
24164_0,,,,2,1,1,2
24165_0,,,,2,1,2,3
24165_1,,,,2,1,2,3
24166_0,,,,2,1,1,2
24167_0,,,,2,1,2,3
24167_1,,,,2,1,2,3
24168_0,,,,2,1,1,2
24169_0,,,,2,1,2,3
24169_1,,,,2,1,2,3
24170_0,,,,2,1,1,2
24171_0,,,,2,1,2,3
24171_1,,,,2,1,2,3
24172_0,,,,2,1,1,2
24173_0,,,,2,1,2,3
24173_1,,,,2,1,2,3
24174_0,,,,2,1,1,2
24175_0,,,,2,1,2,3
24175_1,,,,2,1,2,3
24176_0,,,,2,1,1,2
24177_0,,,,2,1,2,3
24177_1,,,,2,1,2,3
24179_0,,,,2,1,2,3
C(C1C(CC(O1)O)=O)=O,,,5,1,2,0,2
24180_0,,,,2,1,1,2
24181_0,,,,2,1,2,3
24181_1,,,,2,1,2,3
24182_0,,,,2,1,1,2
24183_0,,,,2,1,2,3
24183_1,,,,2,1,2,3
24184_0,,,,2,1,1,2
24185_0,,,,2,1,2,3
24185_1,,,,2,1,2,3
24186_0,,,,2,1,1,2
24187_0,,,,2,1,2,3
24187_1,,,,2,1,2,3
24188_0,,,,2,1,2,3
24188_1,,,,2,1,2,3
24189_0,,,,2,1,2,3
24189_1,,,,2,1,2,3
24190_0,,,,2,1,2,3
24191_0,,,,2,1,2,3
24191_1,,,,2,1,2,3
24192_0,,,,2,1,2,3
24192_1,,,,2,1,2,3
24193_0,,,,2,1,2,3
24193_1,,,,2,1,2,3
24194_0,,,,2,1,2,3
24194_1,,,,2,1,2,3
24195_0,,,,2,1,2,3
24195_1,,,,2,1,2,3
24196_0,,,,2,1,2,3
24196_1,,,,2,1,2,3
24197_0,,,,2,1,2,3
24197_1,,,,2,1,2,3
24198_0,,,,2,1,2,3
24198_1,,,,2,1,2,3
24199_0,,,,2,1,2,3
24200_0,,,,2,1,2,3
24201_0,,,,2,1,2,3
24201_1,,,,2,1,2,3
24202_0,,,,2,1,2,3
24202_1,,,,2,1,2,3
24203_0,,,,2,1,2,3
24203_1,,,,2,1,2,3
24204_0,,,,2,1,2,3
24204_1,,,,2,1,2,3
24205_0,,,,2,1,2,3
24206_0,,,,2,1,2,3
24206_1,,,,2,1,2,3
24207_0,,,,2,1,2,3
24207_1,,,,2,1,2,3
24208_0,,,,2,1,2,3
24208_1,,,,2,1,2,3
24209_0,,,,2,1,2,3
24209_1,,,,2,1,2,3
24210_0,,,,2,1,2,3
24210_1,,,,2,1,2,3
24211_0,,,,2,1,2,3
24211_1,,,,2,1,2,3
24212_0,,,,2,1,2,3
24212_1,,,,2,1,2,3
24213_0,,,,2,1,2,3
24213_1,,,,2,1,2,3
24214_0,,,,2,1,2,3
24215_0,,,,2,1,2,3
24216_0,,,,2,1,2,3
24216_1,,,,2,1,2,3
24217_0,,,,2,1,2,3
24217_1,,,,2,1,2,3
24218_0,,,,2,1,2,3
24218_1,,,,2,1,2,3
24219_0,,,,2,1,2,3
24220_0,,,,2,1,2,3
24220_1,,,,2,1,2,3
24221_0,,,,2,1,2,3
24221_1,,,,2,1,2,3
24222_0,,,,2,1,2,3
24222_1,,,,2,1,2,3
24223_0,,,,2,1,2,3
24223_1,,,,2,1,2,3
24224_0,,,,2,1,2,3
24224_1,,,,2,1,2,3
24225_0,,,,2,1,2,3
24225_1,,,,2,1,2,3
24226_0,,,,2,1,2,3
24226_1,,,,2,1,2,3
24227_0,,,,2,1,2,3
24228_0,,,,2,1,2,3
24229_0,,,,2,1,2,3
24229_1,,,,2,1,2,3
24230_0,,,,2,1,2,3
24231_0,,,,2,1,2,3
24232_0,,,,2,1,2,3
24232_1,,,,2,1,2,3
24233_0,,,,2,1,2,3
24234_0,,,,2,1,2,3
24235_0,,,,2,1,2,3
24235_1,,,,2,1,2,3
24236_0,,,,2,1,2,3
24237_0,,,,2,1,2,3
24238_0,,,,2,1,2,3
24239_0,,,,2,1,2,3
24239_1,,,,2,1,2,3
24240_0,,,,2,1,2,3
24241_0,,,,2,1,2,3
24242_0,,,,2,1,2,3
24242_1,,,,2,1,2,3
24243_0,,,,2,1,2,3
24244_0,,,,2,1,2,3
24245_0,,,,2,1,2,3
24246_0,,,,2,1,2,3
24247_0,,,,2,1,2,3
24247_1,,,,2,1,2,3
24248_0,,,,2,1,2,3
24249_0,,,,2,1,2,3
24249_1,,,,2,1,2,3
24249_2,,,,2,1,2,3
24250_0,,,,2,1,2,3
24251_0,,,,2,1,2,3
24252_0,,,,2,1,2,3
24253_0,,,,2,1,2,3
24254_0,,,,2,1,2,3
24255_0,,,,2,1,2,3
24256_0,,,,2,1,2,3
24257_0,,,,2,1,2,3
24258_0,,,,2,1,2,3
24259_0,,,,2,1,2,3
24260_0,,,,2,1,2,3
24261_0,,,,2,1,2,3
24261_1,,,,2,1,2,3
24262_0,,,,2,1,2,3
24263_0,,,,2,1,2,3
24264_0,,,,2,1,2,3
24264_1,,,,2,1,2,3
24264_2,,,,2,1,2,3
24265_0,,,,2,1,2,3
24266_0,,,,2,1,2,3
24266_1,,,,2,1,2,3
24266_2,,,,2,1,2,3
24267_0,,,,2,1,2,3
24267_1,,,,2,1,2,3
24267_2,,,,2,1,2,3
24268_0,,,,2,1,2,3
24269_0,,,,2,1,2,3
24270_0,,,,2,1,2,3
24271_0,,,,2,1,2,3
24272_0,,,,2,1,2,3
24273_0,,,,2,1,2,3
24274_0,,,,2,1,2,3
24275_0,,,,2,1,2,3
24276_0,,,,2,1,2,3
24277_0,,,,2,1,2,3
24278_0,,,,2,1,2,3
24279_0,,,,2,1,2,3
24279_1,,,,2,1,2,3
24280_0,,,,2,1,2,3
24281_0,,,,2,1,2,3
24282_0,,,,2,1,2,3
24282_1,,,,2,1,2,3
24283_0,,,,2,1,2,3
24284_0,,,,2,1,2,3
24284_1,,,,2,1,2,3
24285_0,,,,2,1,2,3
24286_0,,,,2,1,2,3
24286_1,,,,2,1,2,3
24287_0,,,,2,1,2,3
24288_0,,,,2,1,2,3
24288_1,,,,2,1,2,3
24289_0,,,,2,1,2,3
24289_1,,,,2,1,2,3
24290_0,,,,2,1,2,3
24290_1,,,,2,1,2,3
24291_0,,,,2,1,2,3
24291_1,,,,2,1,2,3
24291_2,,,,2,1,2,3
24292_0,,,,2,1,2,3
24293_0,,,,2,1,2,3
24293_1,,,,2,1,2,3
24293_2,,,,2,1,2,3
24294_0,,,,2,1,2,3
24294_1,,,,2,1,2,3
24294_2,,,,2,1,2,3
24295_0,,,,2,1,2,3
24295_1,,,,2,1,2,3
24295_2,,,,2,1,2,3
24296_0,,,,2,1,2,3
24297_0,,,,2,1,2,3
24297_1,,,,2,1,2,3
24298_0,,,,2,1,2,3
24298_1,,,,2,1,2,3
24299_0,,,,2,1,2,3
24299_1,,,,2,1,2,3
24300_0,,,,2,1,2,3
24300_1,,,,2,1,2,3
24301_0,,,,2,1,2,3
24301_1,,,,2,1,2,3
24302_0,,,,2,1,2,3
24302_1,,,,2,1,2,3
24303_0,,,,2,1,2,3
24303_1,,,,2,1,2,3
24304_0,,,,2,1,2,3
24304_1,,,,2,1,2,3
24305_0,,,,2,1,2,3
24306_0,,,,2,1,2,3
24307_0,,,,2,1,2,3
24307_1,,,,2,1,2,3
24307_2,,,,2,1,2,3
24308_0,,,,2,1,2,3
24309_0,,,,2,1,2,3
24309_1,,,,2,1,2,3
24310_0,,,,2,1,2,3
24310_1,,,,2,1,2,3
24311_0,,,,2,1,2,3
24311_1,,,,2,1,2,3
24312_0,,,,2,1,2,3
24312_1,,,,2,1,2,3
24313_0,,,,2,1,2,3
24313_1,,,,2,1,2,3
24314_0,,,,2,1,2,3
24314_1,,,,2,1,2,3
24315_0,,,,2,1,2,3
24315_1,,,,2,1,2,3
24316_0,,,,2,1,2,3
24317_0,,,,2,1,2,3
24317_1,,,,2,1,2,3
24318_0,,,,2,1,2,3
24318_1,,,,2,1,2,3
24319_0,,,,2,1,2,3
24319_1,,,,2,1,2,3
24320_0,,,,2,1,2,3
24321_0,,,,2,1,2,3
24321_1,,,,2,1,2,3
24322_0,,,,2,1,2,3
24322_1,,,,2,1,2,3
24323_0,,,,2,1,2,3
24323_1,,,,2,1,2,3
24324_0,,,,2,1,2,3
24324_1,,,,2,1,2,3
24325_0,,,,2,1,2,3
24325_1,,,,2,1,2,3
24326_0,,,,2,1,2,3
24326_1,,,,2,1,2,3
24327_0,,,,2,1,2,3
24327_1,,,,2,1,2,3
24328_0,,,,2,1,2,3
24328_1,,,,2,1,2,3
24329_0,,,,2,1,2,3
24329_1,,,,2,1,2,3
24330_0,,,,2,1,2,3
24330_1,,,,2,1,2,3
24331_0,,,,2,1,2,3
24331_1,,,,2,1,2,3
24332_0,,,,2,1,2,3
24332_1,,,,2,1,2,3
24333_0,,,,2,1,2,3
24333_1,,,,2,1,2,3
24334_0,,,,2,1,2,3
24334_1,,,,2,1,2,3
24335_0,,,,2,1,2,3
24336_0,,,,2,1,2,3
24337_0,,,,2,1,2,3
24337_1,,,,2,1,2,3
24338_0,,,,2,1,2,3
24338_1,,,,2,1,2,3
24339_0,,,,2,1,2,3
24340_0,,,,2,1,2,3
24341_0,,,,2,1,2,3
24342_0,,,,2,1,2,3
24343_0,,,,2,1,2,3
24344_0,,,,2,1,2,3
24345_0,,,,2,1,2,3
24345_1,,,,2,1,2,3
24346_0,,,,2,1,2,3
24347_0,,,,2,1,2,3
24348_0,,,,2,1,2,3
24349_0,,,,2,1,2,3
24350_0,,,,2,1,2,3
24351_0,,,,2,1,2,3
24351_1,,,,2,1,2,3
24352_0,,,,2,1,2,3
24352_1,,,,2,1,2,3
24352_2,,,,2,1,2,3
24353_0,,,,2,1,2,3
24354_0,,,,2,1,2,3
24354_1,,,,2,1,2,3
24354_2,,,,2,1,2,3
24355_0,,,,2,1,2,3
24356_0,,,,2,1,2,3
24356_1,,,,2,1,2,3
24356_2,,,,2,1,2,3
24357_0,,,,2,1,2,3
24357_1,,,,2,1,2,3
24357_2,,,,2,1,2,3
24358_0,,,,2,1,2,3
24358_1,,,,2,1,2,3
24359_0,,,,2,1,2,3
24359_1,,,,2,1,2,3
24360_0,,,,2,1,2,3
24360_1,,,,2,1,2,3
24360_2,,,,2,1,2,3
24361_0,,,,2,1,2,3
24361_1,,,,2,1,2,3
24362_0,,,,2,1,2,3
24362_1,,,,2,1,2,3
24363_0,,,,2,1,2,3
24363_1,,,,2,1,2,3
24364_0,,,,2,1,2,3
24365_0,,,,2,1,2,3
24365_1,,,,2,1,2,3
24365_2,,,,2,1,2,3
24366_0,,,,2,1,2,3
24366_1,,,,2,1,2,3
24366_2,,,,2,1,2,3
24367_0,,,,2,1,2,3
24367_1,,,,2,1,2,3
24367_2,,,,2,1,2,3
24368_0,,,,2,1,2,3
24368_1,,,,2,1,2,3
24368_2,,,,2,1,2,3
24369_0,,,,2,1,2,3
24369_1,,,,2,1,2,3
24369_2,,,,2,1,2,3
24370_0,,,,2,1,2,3
24370_1,,,,2,1,2,3
24370_2,,,,2,1,2,3
24371_0,,,,2,1,2,3
24371_1,,,,2,1,2,3
24372_0,,,,2,1,2,3
24372_1,,,,2,1,2,3
24372_2,,,,2,1,2,3
24373_0,,,,2,1,2,3
24373_1,,,,2,1,2,3
24373_2,,,,2,1,2,3
24374_0,,,,2,1,2,3
24374_1,,,,2,1,2,3
24375_0,,,,2,1,2,3
24376_0,,,,2,1,2,3
24377_0,,,,2,1,2,3
24377_1,,,,2,1,2,3
24379_0,,,,2,1,2,3
C(CO)(C(CCO)O)=O,,,5,1,8,0,8
24379_1,,,,2,1,2,3
24380_0,,,,2,1,2,3
24380_1,,,,2,1,2,3
24381_0,,,,2,1,2,3
24381_1,,,,2,1,2,3
24382_0,,,,2,1,2,3
24382_1,,,,2,1,2,3
24383_0,,,,2,1,2,3
24383_1,,,,2,1,2,3
24384_0,,,,2,1,2,3
24384_1,,,,2,1,2,3
24385_0,,,,2,1,2,3
24385_1,,,,2,1,2,3
24386_0,,,,2,1,2,3
24386_1,,,,2,1,2,3
24387_0,,,,2,1,2,3
24389_0,,,,2,1,2,3
C(C)(CCO)=O,,,5,1,7,0,7
24389_1,,,,2,1,2,3
24390_0,,,,2,1,2,3
24390_1,,,,2,1,2,3
24390_2,,,,2,1,2,3
24391_0,,,,2,1,2,3
24391_1,,,,2,1,2,3
24391_2,,,,2,1,2,3
24392_0,,,,2,1,2,3
24392_1,,,,2,1,2,3
24392_2,,,,2,1,2,3
24393_0,,,,2,1,2,3
24393_1,,,,2,1,2,3
24393_2,,,,2,1,2,3
24394_0,,,,2,1,2,3
24394_1,,,,2,1,2,3
24394_2,,,,2,1,2,3
24395_0,,,,2,1,2,3
24395_1,,,,2,1,2,3
24395_2,,,,2,1,2,3
24396_0,,,,2,1,2,3
24396_1,,,,2,1,2,3
24396_2,,,,2,1,2,3
24397_0,,,,2,1,2,3
24397_1,,,,2,1,2,3
24397_2,,,,2,1,2,3
24398_0,,,,2,1,2,3
24398_1,,,,2,1,2,3
24399_0,,,,2,1,2,3
24399_1,,,,2,1,2,3
24399_2,,,,2,1,2,3
24400_0,,,,2,1,2,3
24400_1,,,,2,1,2,3
24401_0,,,,2,1,2,3
24401_1,,,,2,1,2,3
24401_2,,,,2,1,2,3
24402_0,,,,2,1,2,3
24402_1,,,,2,1,2,3
24402_2,,,,2,1,2,3
24403_0,,,,2,1,2,3
24403_1,,,,2,1,2,3
24404_0,,,,2,1,2,3
24404_1,,,,2,1,2,3
24404_2,,,,2,1,2,3
24405_0,,,,2,1,2,3
24405_1,,,,2,1,2,3
24405_2,,,,2,1,2,3
24406_0,,,,2,1,2,3
24406_1,,,,2,1,2,3
24406_2,,,,2,1,2,3
24407_0,,,,2,1,2,3
24407_1,,,,2,1,2,3
24407_2,,,,2,1,2,3
24408_0,,,,2,1,2,3
24408_1,,,,2,1,2,3
24408_2,,,,2,1,2,3
24409_0,,,,2,1,2,3
24409_1,,,,2,1,2,3
24409_2,,,,2,1,2,3
24410_0,,,,2,1,2,3
24410_1,,,,2,1,2,3
24410_2,,,,2,1,2,3
24411_0,,,,2,1,2,3
24411_1,,,,2,1,2,3
24412_0,,,,2,1,2,3
24412_1,,,,2,1,2,3
24412_2,,,,2,1,2,3
24413_0,,,,2,1,2,3
24413_1,,,,2,1,2,3
24413_2,,,,2,1,2,3
24414_0,,,,2,1,2,3
24414_1,,,,2,1,2,3
24414_2,,,,2,1,2,3
24415_0,,,,2,1,2,3
24415_1,,,,2,1,2,3
24415_2,,,,2,1,2,3
24416_0,,,,2,1,2,3
24416_1,,,,2,1,2,3
24416_2,,,,2,1,2,3
24417_0,,,,2,1,2,3
24417_1,,,,2,1,2,3
24417_2,,,,2,1,2,3
24418_0,,,,2,1,2,3
24418_1,,,,2,1,2,3
24418_2,,,,2,1,2,3
24419_0,,,,2,1,2,3
24419_1,,,,2,1,2,3
24419_2,,,,2,1,2,3
24420_0,,,,2,1,2,3
24420_1,,,,2,1,2,3
24420_2,,,,2,1,2,3
24421_0,,,,2,1,2,3
24421_1,,,,2,1,2,3
24421_2,,,,2,1,2,3
24422_0,,,,2,1,2,3
24422_1,,,,2,1,2,3
24422_2,,,,2,1,2,3
24423_0,,,,2,1,2,3
24423_1,,,,2,1,2,3
24423_2,,,,2,1,2,3
24424_0,,,,2,1,2,3
24424_1,,,,2,1,2,3
24424_2,,,,2,1,2,3
24425_0,,,,2,1,2,3
24425_1,,,,2,1,2,3
24426_0,,,,2,1,2,3
24426_1,,,,2,1,2,3
24426_2,,,,2,1,2,3
24427_0,,,,2,1,2,3
24427_1,,,,2,1,2,3
24427_2,,,,2,1,2,3
24428_0,,,,2,1,2,3
24429_0,,,,2,1,2,3
24429_1,,,,2,1,2,3
24430_0,,,,2,1,2,3
24430_1,,,,2,1,2,3
24431_0,,,,2,1,2,3
24431_1,,,,2,1,2,3
24432_0,,,,2,1,2,3
24432_1,,,,2,1,2,3
24433_0,,,,2,1,2,3
24434_0,,,,2,1,2,3
24434_1,,,,2,1,2,3
24435_0,,,,2,1,2,3
24436_0,,,,2,1,2,3
24436_1,,,,2,1,2,3
24437_0,,,,2,1,2,3
24438_0,,,,2,1,2,3
24439_0,,,,2,1,2,3
24439_1,,,,2,1,2,3
24440_0,,,,2,1,2,3
24440_1,,,,2,1,2,3
24441_0,,,,2,1,2,3
24441_1,,,,2,1,2,3
24442_0,,,,2,1,2,3
24443_0,,,,2,1,2,3
24443_1,,,,2,1,2,3
24443_2,,,,2,1,2,3
24444_0,,,,2,1,2,3
24444_1,,,,2,1,2,3
24445_0,,,,2,1,2,3
24445_1,,,,2,1,2,3
24446_0,,,,2,1,2,3
24447_0,,,,2,1,2,3
24448_0,,,,2,1,2,3
24448_1,,,,2,1,2,3
24449_0,,,,2,1,2,3
24449_1,,,,2,1,2,3
24450_0,,,,2,1,2,3
24450_1,,,,2,1,2,3
24451_0,,,,2,1,2,3
24451_1,,,,2,1,2,3
24451_2,,,,2,1,2,3
24452_0,,,,2,1,2,3
24452_1,,,,2,1,2,3
24452_2,,,,2,1,2,3
24453_0,,,,2,1,2,3
24454_0,,,,2,1,2,3
24454_1,,,,2,1,2,3
24454_2,,,,2,1,2,3
24456_0,,,,2,1,2,3
C(C(C(C)=O)=O)(O)=O,,,5,1,9,0,9
24456_1,,,,2,1,2,3
24457_0,,,,2,1,2,3
24457_1,,,,2,1,2,3
24457_2,,,,2,1,2,3
24458_0,,,,2,1,2,3
24458_1,,,,2,1,2,3
24458_2,,,,2,1,2,3
24459_0,,,,2,1,2,3
24459_1,,,,2,1,2,3
24459_2,,,,2,1,2,3
24460_0,,,,2,1,2,3
24460_1,,,,2,1,2,3
24460_2,,,,2,1,2,3
24461_0,,,,2,1,2,3
24461_1,,,,2,1,2,3
24461_2,,,,2,1,2,3
24462_0,,,,2,1,2,3
24463_0,,,,2,1,2,3
24463_1,,,,2,1,2,3
24463_2,,,,2,1,2,3
24464_0,,,,2,1,2,3
24464_1,,,,2,1,2,3
24465_0,,,,2,1,2,3
24465_1,,,,2,1,2,3
24465_2,,,,2,1,2,3
24466_0,,,,2,1,2,3
24466_1,,,,2,1,2,3
24466_2,,,,2,1,2,3
24467_0,,,,2,1,2,3
24467_1,,,,2,1,2,3
24467_2,,,,2,1,2,3
24468_0,,,,2,1,2,3
24469_0,,,,2,1,2,3
24469_1,,,,2,1,2,3
24469_2,,,,2,1,2,3
24470_0,,,,2,1,2,3
24470_1,,,,2,1,2,3
24471_0,,,,2,1,2,3
24472_0,,,,2,1,2,3
24472_1,,,,2,1,2,3
24472_2,,,,2,1,2,3
24474_0,,,,2,1,2,3
C(C(C=O)(C(C)=O)O)(O)=O,,,5,1,4,0,4
24475_0,,,,2,1,2,3
24475_1,,,,2,1,2,3
24475_2,,,,2,1,2,3
24476_0,,,,2,1,2,3
24476_1,,,,2,1,2,3
24476_2,,,,2,1,2,3
24477_0,,,,2,1,2,3
24477_1,,,,2,1,2,3
24477_2,,,,2,1,2,3
24478_0,,,,2,1,2,3
24478_1,,,,2,1,2,3
24478_2,,,,2,1,2,3
24479_0,,,,2,1,2,3
24480_0,,,,2,1,2,3
24480_1,,,,2,1,2,3
24480_2,,,,2,1,2,3
24481_0,,,,2,1,2,3
24482_0,,,,2,1,2,3
24482_1,,,,2,1,2,3
24482_2,,,,2,1,2,3
24483_0,,,,2,1,2,3
24485_0,,,,2,1,2,3
C(C(C(C(O)=O)=O)O)=O,,,5,1,4,0,4
24486_0,,,,2,1,2,3
24486_1,,,,2,1,2,3
24487_0,,,,2,1,2,3
24487_1,,,,2,1,2,3
24488_0,,,,2,1,2,3
24488_1,,,,2,1,2,3
24489_0,,,,2,1,2,3
24489_1,,,,2,1,2,3
24490_0,,,,2,1,2,3
24492_0,,,,2,1,2,3
C(C(C(C(O)=O)=O)(C)O)=O,,,5,1,2,0,2
24493_0,,,,2,1,2,3
24493_1,,,,2,1,2,3
24494_0,,,,2,1,2,3
24494_1,,,,2,1,2,3
24495_0,,,,2,1,2,3
24495_1,,,,2,1,2,3
24496_0,,,,2,1,2,3
24496_1,,,,2,1,2,3
24497_0,,,,2,1,2,3
24499_0,,,,2,1,2,3
C(C)(C(C(C(O)=O)=O)O)=O,,,5,1,3,0,3
24500_0,,,,2,1,2,3
24500_1,,,,2,1,2,3
24501_0,,,,2,1,2,3
24501_1,,,,2,1,2,3
24502_0,,,,2,1,2,3
24502_1,,,,2,1,2,3
24504_0,,,,2,1,2,3
C(CC(C(C(O)=O)=O)O)=O,,,5,1,3,0,3
24506_0,,,,2,1,2,3
C(C(C=O)(CC=O)O)(O)=O,,,5,1,3,0,3
24507_0,,,,2,1,2,3
24507_1,,,,2,1,2,3
24509_0,,,,2,1,2,3
C(C(C=O)(CC(O)=O)O)=O,,,5,1,2,0,2
24510_0,,,,2,1,2,3
24510_1,,,,2,1,2,3
24511_0,,,,2,1,2,3
24512_0,,,,2,1,2,3
24513_0,,,,2,1,2,3
24513_1,,,,2,1,2,3
24514_0,,,,2,1,2,3
24515_0,,,,2,1,2,3
24515_1,,,,2,1,2,3
24516_0,,,,2,1,2,3
24517_0,,,,2,1,2,3
24517_1,,,,2,1,2,3
24518_0,,,,2,1,2,3
24519_0,,,,2,1,2,3
24520_0,,,,2,1,2,3
24521_0,,,,2,1,2,3
24521_1,,,,2,1,2,3
24521_2,,,,2,1,2,3
24523_0,,,,2,1,1,2
C(C(C=O)(C(C(C)=O)O)O)=O,,,5,1,3,0,3
24524_0,,,,2,1,1,2
24524_1,,,,2,1,1,2
24525_0,,,,2,1,1,2
24525_1,,,,2,1,1,2
24525_2,,,,2,1,1,2
24526_0,,,,2,1,1,2
24526_1,,,,2,1,1,2
24526_2,,,,2,1,1,2
24527_0,,,,2,1,1,2
24527_1,,,,2,1,1,2
24527_2,,,,2,1,1,2
24528_0,,,,2,1,1,2
24528_1,,,,2,1,1,2
24528_2,,,,2,1,1,2
24529_0,,,,2,1,1,2
24529_1,,,,2,1,1,2
24530_0,,,,2,1,1,2
24530_1,,,,2,1,1,2
24531_0,,,,2,1,1,2
24531_1,,,,2,1,1,2
24531_2,,,,2,1,1,2
24532_0,,,,2,1,1,2
24532_1,,,,2,1,1,2
24532_2,,,,2,1,1,2
24533_0,,,,2,1,1,2
24534_0,,,,2,1,1,2
24534_1,,,,2,1,1,2
24534_2,,,,2,1,1,2
24535_0,,,,2,1,2,3
24535_1,,,,2,1,2,3
24535_2,,,,2,1,2,3
24536_0,,,,2,1,2,3
24536_1,,,,2,1,2,3
24536_2,,,,2,1,2,3
24537_0,,,,2,1,2,3
24537_1,,,,2,1,2,3
24537_2,,,,2,1,2,3
24538_0,,,,2,1,2,3
24538_1,,,,2,1,2,3
24539_0,,,,2,1,2,3
24539_1,,,,2,1,2,3
24540_0,,,,2,1,2,3
24540_1,,,,2,1,2,3
24541_0,,,,2,1,2,3
24541_1,,,,2,1,2,3
24542_0,,,,2,1,2,3
24542_1,,,,2,1,2,3
24543_0,,,,2,1,2,3
24543_1,,,,2,1,2,3
24544_0,,,,2,1,2,3
24544_1,,,,2,1,2,3
24545_0,,,,2,1,2,3
24545_1,,,,2,1,2,3
24546_0,,,,2,1,2,3
24546_1,,,,2,1,2,3
24547_0,,,,2,1,2,3
24547_1,,,,2,1,2,3
24548_0,,,,2,1,2,3
24548_1,,,,2,1,2,3
24549_0,,,,2,1,2,3
24549_1,,,,2,1,2,3
24550_0,,,,2,1,2,3
24550_1,,,,2,1,2,3
24551_0,,,,2,1,2,3
24551_1,,,,2,1,2,3
24552_0,,,,2,1,2,3
24552_1,,,,2,1,2,3
24552_2,,,,2,1,2,3
24553_0,,,,2,1,2,3
24553_1,,,,2,1,2,3
24553_2,,,,2,1,2,3
24554_0,,,,2,1,2,3
24554_1,,,,2,1,2,3
24555_0,,,,2,1,2,3
24555_1,,,,2,1,2,3
24555_2,,,,2,1,2,3
24556_0,,,,2,1,2,3
24556_1,,,,2,1,2,3
24556_2,,,,2,1,2,3
24557_0,,,,2,1,2,3
24557_1,,,,2,1,2,3
24558_0,,,,2,1,2,3
24558_1,,,,2,1,2,3
24558_2,,,,2,1,2,3
24559_0,,,,2,1,2,3
24559_1,,,,2,1,2,3
24559_2,,,,2,1,2,3
24560_0,,,,2,1,2,3
24560_1,,,,2,1,2,3
24561_0,,,,2,1,2,3
24561_1,,,,2,1,2,3
24561_2,,,,2,1,2,3
24562_0,,,,2,1,2,3
24562_1,,,,2,1,2,3
24562_2,,,,2,1,2,3
24563_0,,,,2,1,2,3
24563_1,,,,2,1,2,3
24564_0,,,,2,1,2,3
24564_1,,,,2,1,2,3
24565_0,,,,2,1,2,3
24565_1,,,,2,1,2,3
24565_2,,,,2,1,2,3
24566_0,,,,2,1,2,3
24566_1,,,,2,1,2,3
24567_0,,,,2,1,2,3
24567_1,,,,2,1,2,3
24567_2,,,,2,1,2,3
24568_0,,,,2,1,2,3
24568_1,,,,2,1,2,3
24568_2,,,,2,1,2,3
24569_0,,,,2,1,2,3
24569_1,,,,2,1,2,3
24570_0,,,,2,1,2,3
24570_1,,,,2,1,2,3
24571_0,,,,2,1,2,3
24571_1,,,,2,1,2,3
24571_2,,,,2,1,2,3
24572_0,,,,2,1,2,3
24572_1,,,,2,1,2,3
24572_2,,,,2,1,2,3
24573_0,,,,2,1,2,3
24573_1,,,,2,1,2,3
24575_0,,,,2,1,2,3
C(C(C=O)(C(C=O)O)O)=O,,,5,1,3,0,3
24576_0,,,,2,1,2,3
24576_1,,,,2,1,2,3
24576_2,,,,2,1,2,3
24577_0,,,,2,1,2,3
24577_1,,,,2,1,2,3
24577_2,,,,2,1,2,3
24578_0,,,,2,1,2,3
24578_1,,,,2,1,2,3
24579_0,,,,2,1,2,3
24579_1,,,,2,1,2,3
24580_0,,,,2,1,2,3
24580_1,,,,2,1,2,3
24581_0,,,,2,1,2,3
24581_1,,,,2,1,2,3
24581_2,,,,2,1,2,3
24582_0,,,,2,1,2,3
24582_1,,,,2,1,2,3
24582_2,,,,2,1,2,3
24583_0,,,,2,1,2,3
24583_1,,,,2,1,2,3
24583_2,,,,2,1,2,3
24584_0,,,,2,1,2,3
24584_1,,,,2,1,2,3
24584_2,,,,2,1,2,3
24585_0,,,,2,1,2,3
24585_1,,,,2,1,2,3
24585_2,,,,2,1,2,3
24586_0,,,,2,1,2,3
24586_1,,,,2,1,2,3
24587_0,,,,2,1,2,3
24587_1,,,,2,1,2,3
24588_0,,,,2,1,2,3
24588_1,,,,2,1,2,3
24589_0,,,,2,1,2,3
24589_1,,,,2,1,2,3
24590_0,,,,2,1,2,3
24590_1,,,,2,1,2,3
24590_2,,,,2,1,2,3
24591_0,,,,2,1,2,3
24591_1,,,,2,1,2,3
24591_2,,,,2,1,2,3
24592_0,,,,2,1,2,3
24592_1,,,,2,1,2,3
24593_0,,,,2,1,2,3
24593_1,,,,2,1,2,3
24594_0,,,,2,1,2,3
24594_1,,,,2,1,2,3
24595_0,,,,2,1,2,3
24595_1,,,,2,1,2,3
24596_0,,,,2,1,2,3
24596_1,,,,2,1,2,3
24597_0,,,,2,1,2,3
24597_1,,,,2,1,2,3
24598_0,,,,2,1,2,3
24598_1,,,,2,1,2,3
24598_2,,,,2,1,2,3
24599_0,,,,2,1,2,3
24599_1,,,,2,1,2,3
24600_0,,,,2,1,2,3
24600_1,,,,2,1,2,3
24600_2,,,,2,1,2,3
24601_0,,,,2,1,2,3
24601_1,,,,2,1,2,3
24601_2,,,,2,1,2,3
24602_0,,,,2,1,2,3
24602_1,,,,2,1,2,3
24603_0,,,,2,1,2,3
24603_1,,,,2,1,2,3
24603_2,,,,2,1,2,3
24604_0,,,,2,1,2,3
24604_1,,,,2,1,2,3
24604_2,,,,2,1,2,3
24605_0,,,,2,1,2,3
24605_1,,,,2,1,2,3
24606_0,,,,2,1,2,3
24606_1,,,,2,1,2,3
24608_0,,,,2,1,2,3
C(C(C=O)(C=O)C(C)O)=O,,,5,1,2,0,2
24609_0,,,,2,1,2,3
24609_1,,,,2,1,2,3
24610_0,,,,2,1,2,3
24610_1,,,,2,1,2,3
24612_0,,,,2,1,2,3
C(C(C=O)(C=O)CO)=O,,,5,1,2,0,2
24613_0,,,,2,1,2,3
24613_1,,,,2,1,2,3
24613_2,,,,2,1,2,3
24614_0,,,,2,1,2,3
24614_1,,,,2,1,2,3
24614_2,,,,2,1,2,3
24615_0,,,,2,1,2,3
24616_0,,,,2,1,2,3
24616_1,,,,2,1,2,3
24617_0,,,,2,1,2,3
24617_1,,,,2,1,2,3
24618_0,,,,2,1,2,3
24618_1,,,,2,1,2,3
24619_0,,,,2,1,2,3
24619_1,,,,2,1,2,3
24620_0,,,,2,1,2,3
24620_1,,,,2,1,2,3
24621_0,,,,2,1,2,3
24621_1,,,,2,1,2,3
24622_0,,,,2,1,2,3
24622_1,,,,2,1,2,3
24623_0,,,,2,1,2,3
24623_1,,,,2,1,2,3
24624_0,,,,2,1,2,3
24624_1,,,,2,1,2,3
24625_0,,,,2,1,2,3
24625_1,,,,2,1,2,3
24626_0,,,,2,1,2,3
24626_1,,,,2,1,2,3
24627_0,,,,2,1,2,3
24627_1,,,,2,1,2,3
24628_0,,,,2,1,2,3
24628_1,,,,2,1,2,3
24629_0,,,,2,1,2,3
24629_1,,,,2,1,2,3
24630_0,,,,2,1,2,3
24630_1,,,,2,1,2,3
24631_0,,,,2,1,2,3
24631_1,,,,2,1,2,3
24632_0,,,,2,1,2,3
24632_1,,,,2,1,2,3
24633_0,,,,2,1,2,3
24633_1,,,,2,1,2,3
24634_0,,,,2,1,2,3
24634_1,,,,2,1,2,3
24635_0,,,,2,1,2,3
24635_1,,,,2,1,2,3
24636_0,,,,2,1,2,3
24636_1,,,,2,1,2,3
24637_0,,,,2,1,2,3
24637_1,,,,2,1,2,3
24638_0,,,,2,1,2,3
24638_1,,,,2,1,2,3
24639_0,,,,2,1,2,3
24639_1,,,,2,1,2,3
24640_0,,,,2,1,2,3
24640_1,,,,2,1,2,3
24641_0,,,,2,1,2,3
24641_1,,,,2,1,2,3
24642_0,,,,2,1,2,3
24642_1,,,,2,1,2,3
24643_0,,,,2,1,2,3
24643_1,,,,2,1,2,3
24644_0,,,,2,1,2,3
24644_1,,,,2,1,2,3
24645_0,,,,2,1,2,3
24645_1,,,,2,1,2,3
24646_0,,,,2,1,2,3
24646_1,,,,2,1,2,3
24647_0,,,,2,1,2,3
24647_1,,,,2,1,2,3
24648_0,,,,2,1,2,3
24648_1,,,,2,1,2,3
24649_0,,,,2,1,2,3
24649_1,,,,2,1,2,3
24650_0,,,,2,1,2,3
24650_1,,,,2,1,2,3
24651_0,,,,2,1,2,3
24651_1,,,,2,1,2,3
24652_0,,,,2,1,2,3
24652_1,,,,2,1,2,3
24653_0,,,,2,1,2,3
24653_1,,,,2,1,2,3
24654_0,,,,2,1,2,3
24654_1,,,,2,1,2,3
24655_0,,,,2,1,2,3
24655_1,,,,2,1,2,3
24656_0,,,,2,1,2,3
24656_1,,,,2,1,2,3
24657_0,,,,2,1,2,3
24657_1,,,,2,1,2,3
24657_2,,,,2,1,2,3
24658_0,,,,2,1,2,3
24658_1,,,,2,1,2,3
24658_2,,,,2,1,2,3
24659_0,,,,2,1,2,3
24660_0,,,,2,1,2,3
24660_1,,,,2,1,2,3
24661_0,,,,2,1,2,3
24661_1,,,,2,1,2,3
24662_0,,,,2,1,2,3
24662_1,,,,2,1,2,3
24663_0,,,,2,1,2,3
24663_1,,,,2,1,2,3
24664_0,,,,2,1,2,3
24664_1,,,,2,1,2,3
24665_0,,,,2,1,2,3
24665_1,,,,2,1,2,3
24666_0,,,,2,1,2,3
24666_1,,,,2,1,2,3
24667_0,,,,2,1,2,3
24667_1,,,,2,1,2,3
24668_0,,,,2,1,2,3
24668_1,,,,2,1,2,3
24669_0,,,,2,1,2,3
24669_1,,,,2,1,2,3
24670_0,,,,2,1,2,3
24670_1,,,,2,1,2,3
24671_0,,,,2,1,2,3
24671_1,,,,2,1,2,3
24672_0,,,,2,1,2,3
24672_1,,,,2,1,2,3
24673_0,,,,2,1,2,3
24673_1,,,,2,1,2,3
24674_0,,,,2,1,2,3
24674_1,,,,2,1,2,3
24675_0,,,,2,1,2,3
24675_1,,,,2,1,2,3
24676_0,,,,2,1,2,3
24676_1,,,,2,1,2,3
24677_0,,,,2,1,2,3
24677_1,,,,2,1,2,3
24678_0,,,,2,1,2,3
24678_1,,,,2,1,2,3
24679_0,,,,2,1,2,3
24679_1,,,,2,1,2,3
24680_0,,,,2,1,2,3
24680_1,,,,2,1,2,3
24681_0,,,,2,1,2,3
24681_1,,,,2,1,2,3
24682_0,,,,2,1,2,3
24682_1,,,,2,1,2,3
24683_0,,,,2,1,2,3
24683_1,,,,2,1,2,3
24683_2,,,,2,1,2,3
24684_0,,,,2,1,2,3
24684_1,,,,2,1,2,3
24684_2,,,,2,1,2,3
24685_0,,,,2,1,2,3
24685_1,,,,2,1,2,3
24685_2,,,,2,1,2,3
24686_0,,,,2,1,2,3
24686_1,,,,2,1,2,3
24686_2,,,,2,1,2,3
24687_0,,,,2,1,2,3
24687_1,,,,2,1,2,3
24687_2,,,,2,1,2,3
24688_0,,,,2,1,2,3
24688_1,,,,2,1,2,3
24688_2,,,,2,1,2,3
24689_0,,,,2,1,2,3
24689_1,,,,2,1,2,3
24689_2,,,,2,1,2,3
24690_0,,,,2,1,2,3
24690_1,,,,2,1,2,3
24690_2,,,,2,1,2,3
24691_0,,,,2,1,2,3
24691_1,,,,2,1,2,3
24691_2,,,,2,1,2,3
24692_0,,,,2,1,2,3
24692_1,,,,2,1,2,3
24692_2,,,,2,1,2,3
24693_0,,,,2,1,2,3
24693_1,,,,2,1,2,3
24693_2,,,,2,1,2,3
24694_0,,,,2,1,2,3
24694_1,,,,2,1,2,3
24694_2,,,,2,1,2,3
24695_0,,,,2,1,2,3
24695_1,,,,2,1,2,3
24695_2,,,,2,1,2,3
24696_0,,,,2,1,2,3
24696_1,,,,2,1,2,3
24696_2,,,,2,1,2,3
24697_0,,,,2,1,2,3
24697_1,,,,2,1,2,3
24697_2,,,,2,1,2,3
24698_0,,,,2,1,2,3
24698_1,,,,2,1,2,3
24698_2,,,,2,1,2,3
24699_0,,,,2,1,2,3
24699_1,,,,2,1,2,3
24699_2,,,,2,1,2,3
24700_0,,,,2,1,2,3
24700_1,,,,2,1,2,3
24700_2,,,,2,1,2,3
24701_0,,,,2,1,2,3
24701_1,,,,2,1,2,3
24701_2,,,,2,1,2,3
24702_0,,,,2,1,2,3
24702_1,,,,2,1,2,3
24702_2,,,,2,1,2,3
24703_0,,,,2,1,2,3
24703_1,,,,2,1,2,3
24703_2,,,,2,1,2,3
24704_0,,,,2,1,2,3
24704_1,,,,2,1,2,3
24704_2,,,,2,1,2,3
24705_0,,,,2,1,2,3
24705_1,,,,2,1,2,3
24705_2,,,,2,1,2,3
24706_0,,,,2,1,2,3
24706_1,,,,2,1,2,3
24706_2,,,,2,1,2,3
24707_0,,,,2,1,2,3
24707_1,,,,2,1,2,3
24707_2,,,,2,1,2,3
24708_0,,,,2,1,2,3
24708_1,,,,2,1,2,3
24708_2,,,,2,1,2,3
24709_0,,,,2,1,2,3
24709_1,,,,2,1,2,3
24709_2,,,,2,1,2,3
24710_0,,,,2,1,2,3
24710_1,,,,2,1,2,3
24710_2,,,,2,1,2,3
24711_0,,,,2,1,2,3
24711_1,,,,2,1,2,3
24712_0,,,,2,1,2,3
24712_1,,,,2,1,2,3
24712_2,,,,2,1,2,3
24713_0,,,,2,1,2,3
24713_1,,,,2,1,2,3
24713_2,,,,2,1,2,3
24714_0,,,,2,1,2,3
24714_1,,,,2,1,2,3
24715_0,,,,2,1,2,3
24715_1,,,,2,1,2,3
24715_2,,,,2,1,2,3
24716_0,,,,2,1,2,3
24716_1,,,,2,1,2,3
24716_2,,,,2,1,2,3
24717_0,,,,2,1,2,3
24717_1,,,,2,1,2,3
24717_2,,,,2,1,2,3
24718_0,,,,2,1,2,3
24718_1,,,,2,1,2,3
24718_2,,,,2,1,2,3
24719_0,,,,2,1,2,3
24719_1,,,,2,1,2,3
24719_2,,,,2,1,2,3
24720_0,,,,2,1,2,3
24720_1,,,,2,1,2,3
24720_2,,,,2,1,2,3
24721_0,,,,2,1,2,3
24721_1,,,,2,1,2,3
24721_2,,,,2,1,2,3
24722_0,,,,2,1,2,3
24722_1,,,,2,1,2,3
24722_2,,,,2,1,2,3
24723_0,,,,2,1,2,3
24723_1,,,,2,1,2,3
24723_2,,,,2,1,2,3
24724_0,,,,2,1,2,3
24725_0,,,,2,1,2,3
24725_1,,,,2,1,2,3
24725_2,,,,2,1,2,3
24726_0,,,,2,1,2,3
24726_1,,,,2,1,2,3
24726_2,,,,2,1,2,3
24727_0,,,,2,1,2,3
24728_0,,,,2,1,2,3
24728_1,,,,2,1,2,3
24728_2,,,,2,1,2,3
24729_0,,,,2,1,2,3
24729_1,,,,2,1,2,3
24729_2,,,,2,1,2,3
24730_0,,,,2,1,2,3
24730_1,,,,2,1,2,3
24730_2,,,,2,1,2,3
24731_0,,,,2,1,2,3
24731_1,,,,2,1,2,3
24731_2,,,,2,1,2,3
24732_0,,,,2,1,2,3
24732_1,,,,2,1,2,3
24732_2,,,,2,1,2,3
24733_0,,,,2,1,2,3
24733_1,,,,2,1,2,3
24733_2,,,,2,1,2,3
24734_0,,,,2,1,2,3
24734_1,,,,2,1,2,3
24734_2,,,,2,1,2,3
24736_0,,,,2,1,2,3
C1(C(COC1)=O)=O,,,5,1,18,0,18
24736_1,,,,2,1,2,3
24736_2,,,,2,1,2,3
24737_0,,,,2,1,2,3
24737_1,,,,2,1,2,3
24737_2,,,,2,1,2,3
24738_0,,,,2,1,2,3
24738_1,,,,2,1,2,3
24739_0,,,,2,1,2,3
24739_1,,,,2,1,2,3
24739_2,,,,2,1,2,3
24740_0,,,,2,1,2,3
24740_1,,,,2,1,2,3
24740_2,,,,2,1,2,3
24741_0,,,,2,1,2,3
24741_1,,,,2,1,2,3
24741_2,,,,2,1,2,3
24742_0,,,,2,1,2,3
24742_1,,,,2,1,2,3
24742_2,,,,2,1,2,3
24743_0,,,,2,1,2,3
24743_1,,,,2,1,2,3
24743_2,,,,2,1,2,3
24744_0,,,,2,1,2,3
24744_1,,,,2,1,2,3
24744_2,,,,2,1,2,3
24745_0,,,,2,1,2,3
24745_1,,,,2,1,2,3
24745_2,,,,2,1,2,3
24746_0,,,,2,1,2,3
24746_1,,,,2,1,2,3
24746_2,,,,2,1,2,3
24747_0,,,,2,1,2,3
24747_1,,,,2,1,2,3
24748_0,,,,2,1,2,3
24748_1,,,,2,1,2,3
24749_0,,,,2,1,2,3
24749_1,,,,2,1,2,3
24749_2,,,,2,1,2,3
24750_0,,,,2,1,2,3
24750_1,,,,2,1,2,3
24751_0,,,,2,1,2,3
24751_1,,,,2,1,2,3
24751_2,,,,2,1,2,3
24752_0,,,,2,1,2,3
24752_1,,,,2,1,2,3
24752_2,,,,2,1,2,3
24754_0,,,,2,1,2,3
C(CO)(C(CO)(C)O)=O,,,5,1,5,0,5
24755_0,,,,2,1,2,3
24755_1,,,,2,1,2,3
24755_2,,,,2,1,2,3
24756_0,,,,2,1,2,3
24756_1,,,,2,1,2,3
24756_2,,,,2,1,2,3
24757_0,,,,2,1,2,3
24758_0,,,,2,1,2,3
24758_1,,,,2,1,2,3
24759_0,,,,2,1,2,3
24759_1,,,,2,1,2,3
24759_2,,,,2,1,2,3
24760_0,,,,2,1,2,3
24760_1,,,,2,1,2,3
24760_2,,,,2,1,2,3
24761_0,,,,2,1,2,3
24762_0,,,,2,1,2,3
24762_1,,,,2,1,2,3
24763_0,,,,2,1,2,3
24763_1,,,,2,1,2,3
24763_2,,,,2,1,2,3
24764_0,,,,2,1,2,3
24764_1,,,,2,1,2,3
24764_2,,,,2,1,2,3
24765_0,,,,2,1,2,3
24766_0,,,,2,1,2,3
24766_1,,,,2,1,2,3
24767_0,,,,2,1,2,3
24767_1,,,,2,1,2,3
24767_2,,,,2,1,2,3
24768_0,,,,2,1,2,3
24768_1,,,,2,1,2,3
24768_2,,,,2,1,2,3
24769_0,,,,2,1,2,3
24770_0,,,,2,1,2,3
24771_0,,,,2,1,2,3
24771_1,,,,2,1,2,3
24771_2,,,,2,1,2,3
24772_0,,,,2,1,2,3
24772_1,,,,2,1,2,3
24772_2,,,,2,1,2,3
24773_0,,,,2,1,2,3
24774_0,,,,2,1,2,3
24774_1,,,,2,1,2,3
24774_2,,,,2,1,2,3
24775_0,,,,2,1,2,3
24775_1,,,,2,1,2,3
24775_2,,,,2,1,2,3
24776_0,,,,2,1,2,3
24777_0,,,,2,1,2,3
24777_1,,,,2,1,2,3
24777_2,,,,2,1,2,3
24778_0,,,,2,1,2,3
24778_1,,,,2,1,2,3
24778_2,,,,2,1,2,3
24779_0,,,,2,1,2,3
24780_0,,,,2,1,2,3
24780_1,,,,2,1,2,3
24780_2,,,,2,1,2,3
24781_0,,,,2,1,2,3
24781_1,,,,2,1,2,3
24781_2,,,,2,1,2,3
24782_0,,,,2,1,2,3
24783_0,,,,2,1,2,3
24783_1,,,,2,1,2,3
24783_2,,,,2,1,2,3
24784_0,,,,2,1,2,3
24784_1,,,,2,1,2,3
24784_2,,,,2,1,2,3
24785_0,,,,2,1,2,3
24785_1,,,,2,1,2,3
24785_2,,,,2,1,2,3
24786_0,,,,2,1,2,3
24786_1,,,,2,1,2,3
24786_2,,,,2,1,2,3
24787_0,,,,2,1,2,3
24787_1,,,,2,1,2,3
24787_2,,,,2,1,2,3
24788_0,,,,2,1,2,3
24788_1,,,,2,1,2,3
24788_2,,,,2,1,2,3
24789_0,,,,2,1,2,3
24789_1,,,,2,1,2,3
24789_2,,,,2,1,2,3
24790_0,,,,2,1,2,3
24790_1,,,,2,1,2,3
24790_2,,,,2,1,2,3
24791_0,,,,2,1,2,3
24791_1,,,,2,1,2,3
24792_0,,,,2,1,2,3
24792_1,,,,2,1,2,3
24792_2,,,,2,1,2,3
24793_0,,,,2,1,2,3
24793_1,,,,2,1,2,3
24793_2,,,,2,1,2,3
24794_0,,,,2,1,2,3
24794_1,,,,2,1,2,3
24795_0,,,,2,1,2,3
24795_1,,,,2,1,2,3
24795_2,,,,2,1,2,3
24796_0,,,,2,1,2,3
24796_1,,,,2,1,2,3
24796_2,,,,2,1,2,3
24797_0,,,,2,1,2,3
24797_1,,,,2,1,2,3
24797_2,,,,2,1,2,3
24798_0,,,,2,1,2,3
24798_1,,,,2,1,2,3
24798_2,,,,2,1,2,3
24799_0,,,,2,1,2,3
24800_0,,,,2,1,2,3
24800_1,,,,2,1,2,3
24800_2,,,,2,1,2,3
24801_0,,,,2,1,2,3
24801_1,,,,2,1,2,3
24801_2,,,,2,1,2,3
24802_0,,,,2,1,2,3
24802_1,,,,2,1,2,3
24802_2,,,,2,1,2,3
24803_0,,,,2,1,2,3
24803_1,,,,2,1,2,3
24803_2,,,,2,1,2,3
24804_0,,,,2,1,2,3
24804_1,,,,2,1,2,3
24805_0,,,,2,1,2,3
24806_0,,,,2,1,2,3
24806_1,,,,2,1,2,3
24806_2,,,,2,1,2,3
24807_0,,,,2,1,2,3
24807_1,,,,2,1,2,3
24807_2,,,,2,1,2,3
24808_0,,,,2,1,2,3
24808_1,,,,2,1,2,3
24809_0,,,,2,1,2,3
24809_1,,,,2,1,2,3
24810_0,,,,2,1,2,3
24810_1,,,,2,1,2,3
24811_0,,,,2,1,2,3
24811_1,,,,2,1,2,3
24812_0,,,,2,1,2,3
24812_1,,,,2,1,2,3
24812_2,,,,2,1,2,3
24813_0,,,,2,1,2,3
24813_1,,,,2,1,2,3
24813_2,,,,2,1,2,3
24815_0,,,,2,1,2,3
C(C(C=O)(C(C)O)O)(O)=O,,,5,1,5,0,5
24816_0,,,,2,1,2,3
24817_0,,,,2,1,2,3
24817_1,,,,2,1,2,3
24817_2,,,,2,1,2,3
24818_0,,,,2,1,2,3
24818_1,,,,2,1,2,3
24818_2,,,,2,1,2,3
24819_0,,,,2,1,2,3
24819_1,,,,2,1,2,3
24820_0,,,,2,1,2,3
24820_1,,,,2,1,2,3
24821_0,,,,2,1,2,3
24821_1,,,,2,1,2,3
24822_0,,,,2,1,2,3
24822_1,,,,2,1,2,3
24823_0,,,,2,1,2,3
24823_1,,,,2,1,2,3
24823_2,,,,2,1,2,3
24824_0,,,,2,1,2,3
24824_1,,,,2,1,2,3
24824_2,,,,2,1,2,3
24825_0,,,,2,1,2,3
24825_1,,,,2,1,2,3
24826_0,,,,2,1,2,3
24826_1,,,,2,1,2,3
24826_2,,,,2,1,2,3
24827_0,,,,2,1,2,3
24827_1,,,,2,1,2,3
24827_2,,,,2,1,2,3
24828_0,,,,2,1,2,3
24829_0,,,,2,1,2,3
24830_0,,,,2,1,2,3
24830_1,,,,2,1,2,3
24831_0,,,,2,1,2,3
24831_1,,,,2,1,2,3
24831_2,,,,2,1,2,3
24832_0,,,,2,1,2,3
24832_1,,,,2,1,2,3
24833_0,,,,2,1,2,3
24833_1,,,,2,1,2,3
24833_2,,,,2,1,2,3
24834_0,,,,2,1,2,3
24834_1,,,,2,1,2,3
24834_2,,,,2,1,2,3
24835_0,,,,2,1,2,3
24835_1,,,,2,1,2,3
24835_2,,,,2,1,2,3
24836_0,,,,2,1,2,3
24836_1,,,,2,1,2,3
24837_0,,,,2,1,2,3
24837_1,,,,2,1,2,3
24837_2,,,,2,1,2,3
24838_0,,,,2,1,2,3
24838_1,,,,2,1,2,3
24838_2,,,,2,1,2,3
24839_0,,,,2,1,2,3
24839_1,,,,2,1,2,3
24840_0,,,,2,1,2,3
24840_1,,,,2,1,2,3
24840_2,,,,2,1,2,3
24841_0,,,,2,1,2,3
24841_1,,,,2,1,2,3
24842_0,,,,2,1,2,3
24842_1,,,,2,1,2,3
24842_2,,,,2,1,2,3
24844_0,,,,2,1,2,3
C(C1(C(COC1)=O)O)=O,,,5,1,2,0,2
24845_0,,,,2,1,2,3
24845_1,,,,2,1,2,3
24845_2,,,,2,1,2,3
24846_0,,,,2,1,2,3
24846_1,,,,2,1,2,3
24846_2,,,,2,1,2,3
24847_0,,,,2,1,2,3
24847_1,,,,2,1,2,3
24847_2,,,,2,1,2,3
24848_0,,,,2,1,2,3
24848_1,,,,2,1,2,3
24848_2,,,,2,1,2,3
24849_0,,,,2,1,2,3
24849_1,,,,2,1,2,3
24849_2,,,,2,1,2,3
24850_0,,,,2,1,2,3
24850_1,,,,2,1,2,3
24850_2,,,,2,1,2,3
24851_0,,,,2,1,2,3
24851_1,,,,2,1,2,3
24851_2,,,,2,1,2,3
24852_0,,,,2,1,2,3
24852_1,,,,2,1,2,3
24852_2,,,,2,1,2,3
24854_0,,,,2,1,2,3
C1(C(C=O)C(CO1)O)=O,,,5,1,3,0,3
24855_0,,,,2,1,2,3
24855_1,,,,2,1,2,3
24855_2,,,,2,1,2,3
24856_0,,,,2,1,2,3
24856_1,,,,2,1,2,3
24856_2,,,,2,1,2,3
24857_0,,,,2,1,2,3
24857_1,,,,2,1,2,3
24857_2,,,,2,1,2,3
24858_0,,,,2,1,2,3
24858_1,,,,2,1,2,3
24858_2,,,,2,1,2,3
24859_0,,,,2,1,2,3
24859_1,,,,2,1,2,3
24860_0,,,,2,1,2,3
24860_1,,,,2,1,2,3
24861_0,,,,2,1,2,3
24861_1,,,,2,1,2,3
24861_2,,,,2,1,2,3
24862_0,,,,2,1,2,3
24862_1,,,,2,1,2,3
24863_0,,,,2,1,2,3
24863_1,,,,2,1,2,3
24863_2,,,,2,1,2,3
24864_0,,,,2,1,2,3
24864_1,,,,2,1,2,3
24864_2,,,,2,1,2,3
24865_0,,,,2,1,2,3
24865_1,,,,2,1,2,3
24866_0,,,,2,1,2,3
24866_1,,,,2,1,2,3
24867_0,,,,2,1,2,3
24867_1,,,,2,1,2,3
24867_2,,,,2,1,2,3
24868_0,,,,2,1,2,3
24868_1,,,,2,1,2,3
24869_0,,,,2,1,2,3
24869_1,,,,2,1,2,3
24869_2,,,,2,1,2,3
24870_0,,,,2,1,2,3
24870_1,,,,2,1,2,3
24870_2,,,,2,1,2,3
24871_0,,,,2,1,2,3
24871_1,,,,2,1,2,3
24871_2,,,,2,1,2,3
24873_0,,,,2,1,2,3
C1(C(C(CO1)O)=O)=O,,,5,1,8,0,8
24873_1,,,,2,1,2,3
24874_0,,,,2,1,2,3
24874_1,,,,2,1,2,3
24875_0,,,,2,1,2,3
24875_1,,,,2,1,2,3
24877_0,,,,2,1,2,3
C1(C(C=O)(C(CO1)O)O)=O,,,5,1,1,0,1
24879_0,,,,2,1,1,2
C(C(C=O)(CC(CO)=O)O)=O,,,5,1,2,0,2
24879_1,,,,2,1,1,2
24880_0,,,,2,1,1,2
24881_0,,,,2,1,1,2
24881_1,,,,2,1,1,2
24882_0,,,,2,1,1,2
24882_1,,,,2,1,1,2
24883_0,,,,2,1,1,2
24883_1,,,,2,1,1,2
24884_0,,,,2,1,1,2
24885_0,,,,2,1,1,2
24885_1,,,,2,1,1,2
24886_0,,,,2,1,1,2
24886_1,,,,2,1,1,2
24887_0,,,,2,1,1,2
24887_1,,,,2,1,1,2
24888_0,,,,2,1,1,2
24888_1,,,,2,1,1,2
24889_0,,,,2,1,1,2
24889_1,,,,2,1,1,2
24890_0,,,,2,1,2,3
24890_1,,,,2,1,2,3
24891_0,,,,2,1,2,3
24892_0,,,,2,1,2,3
24892_1,,,,2,1,2,3
24893_0,,,,2,1,2,3
24893_1,,,,2,1,2,3
24894_0,,,,2,1,2,3
24894_1,,,,2,1,2,3
24895_0,,,,2,1,2,3
24895_1,,,,2,1,2,3
24896_0,,,,2,1,2,3
24897_0,,,,2,1,2,3
24897_1,,,,2,1,2,3
24898_0,,,,2,1,2,3
24898_1,,,,2,1,2,3
24899_0,,,,2,1,2,3
24899_1,,,,2,1,2,3
24900_0,,,,2,1,2,3
24901_0,,,,2,1,2,3
24901_1,,,,2,1,2,3
24902_0,,,,2,1,2,3
24903_0,,,,2,1,2,3
24903_1,,,,2,1,2,3
24904_0,,,,2,1,2,3
24905_0,,,,2,1,2,3
24905_1,,,,2,1,2,3
24906_0,,,,2,1,2,3
24906_1,,,,2,1,2,3
24907_0,,,,2,1,2,3
24908_0,,,,2,1,2,3
24908_1,,,,2,1,2,3
24909_0,,,,2,1,2,3
24909_1,,,,2,1,2,3
24910_0,,,,2,1,2,3
24911_0,,,,2,1,2,3
24911_1,,,,2,1,2,3
24912_0,,,,2,1,2,3
24912_1,,,,2,1,2,3
24913_0,,,,2,1,2,3
24914_0,,,,2,1,2,3
24914_1,,,,2,1,2,3
24915_0,,,,2,1,2,3
24916_0,,,,2,1,2,3
24917_0,,,,2,1,2,3
24917_1,,,,2,1,2,3
24918_0,,,,2,1,2,3
24919_0,,,,2,1,2,3
24919_1,,,,2,1,2,3
24920_0,,,,2,1,2,3
24921_0,,,,2,1,2,3
24921_1,,,,2,1,2,3
24922_0,,,,2,1,2,3
24922_1,,,,2,1,2,3
24923_0,,,,2,1,2,3
24923_1,,,,2,1,2,3
24924_0,,,,2,1,2,3
24924_1,,,,2,1,2,3
24925_0,,,,2,1,2,3
24926_0,,,,2,1,2,3
24926_1,,,,2,1,2,3
24927_0,,,,2,1,2,3
24928_0,,,,2,1,2,3
24929_0,,,,2,1,2,3
24929_1,,,,2,1,2,3
24930_0,,,,2,1,2,3
24932_0,,,,2,1,2,3
C(C)(C(CC(C)O)O)=O,,,5,1,1,0,1
24933_0,,,,2,1,2,3
24933_1,,,,2,1,2,3
24934_0,,,,2,1,2,3
24934_1,,,,2,1,2,3
24935_0,,,,2,1,2,3
24935_1,,,,2,1,2,3
24936_0,,,,2,1,2,3
24936_1,,,,2,1,2,3
24937_0,,,,2,1,2,3
24938_0,,,,2,1,2,3
24939_0,,,,2,1,2,3
24939_1,,,,2,1,2,3
24940_0,,,,2,1,2,3
24940_1,,,,2,1,2,3
24941_0,,,,2,1,2,3
24942_0,,,,2,1,2,3
24942_1,,,,2,1,2,3
24943_0,,,,2,1,2,3
24943_1,,,,2,1,2,3
24944_0,,,,2,1,2,3
24944_1,,,,2,1,2,3
24945_0,,,,2,1,2,3
24945_1,,,,2,1,2,3
24946_0,,,,2,1,2,3
24946_1,,,,2,1,2,3
24947_0,,,,2,1,2,3
24947_1,,,,2,1,2,3
24948_0,,,,2,1,2,3
24948_1,,,,2,1,2,3
24949_0,,,,2,1,2,3
24950_0,,,,2,1,2,3
24950_1,,,,2,1,2,3
24951_0,,,,2,1,2,3
24952_0,,,,2,1,2,3
24954_0,,,,2,1,2,3
C(C(C(CO)=O)(C)O)(O)=O,,,5,1,4,0,4
24955_0,,,,2,1,2,3
24955_1,,,,2,1,2,3
24957_0,,,,2,1,2,3
C(C(C(C)=O)(C)O)(O)=O,,,5,1,4,0,4
24957_1,,,,2,1,2,3
24958_0,,,,2,1,2,3
24958_1,,,,2,1,2,3
24959_0,,,,2,1,2,3
24960_0,,,,2,1,2,3
24961_0,,,,2,1,2,3
24961_1,,,,2,1,2,3
24962_0,,,,2,1,2,3
24962_1,,,,2,1,2,3
24962_2,,,,2,1,2,3
24963_0,,,,2,1,2,3
24963_1,,,,2,1,2,3
24963_2,,,,2,1,2,3
24964_0,,,,2,1,2,3
24964_1,,,,2,1,2,3
24965_0,,,,2,1,2,3
24965_1,,,,2,1,2,3
24965_2,,,,2,1,2,3
24966_0,,,,2,1,2,3
24966_1,,,,2,1,2,3
24966_2,,,,2,1,2,3
24967_0,,,,2,1,2,3
24968_0,,,,2,1,2,3
24968_1,,,,2,1,2,3
24969_0,,,,2,1,2,3
24969_1,,,,2,1,2,3
24970_0,,,,2,1,2,3
24970_1,,,,2,1,2,3
24971_0,,,,2,1,2,3
24971_1,,,,2,1,2,3
24972_0,,,,2,1,2,3
24972_1,,,,2,1,2,3
24973_0,,,,2,1,2,3
24974_0,,,,2,1,2,3
24974_1,,,,2,1,2,3
24976_0,,,,2,1,2,3
C(C)(C(CO)(C)O)=O,,,5,1,1,0,1
24977_0,,,,2,1,2,3
24977_1,,,,2,1,2,3
24978_0,,,,2,1,2,3
24979_0,,,,2,1,2,3
24979_1,,,,2,1,2,3
24980_0,,,,2,1,2,3
24981_0,,,,2,1,2,3
24981_1,,,,2,1,2,3
24982_0,,,,2,1,2,3
24983_0,,,,2,1,2,3
24983_1,,,,2,1,2,3
24984_0,,,,2,1,2,3
24984_1,,,,2,1,2,3
24985_0,,,,2,1,2,3
24986_0,,,,2,1,2,3
24986_1,,,,2,1,2,3
24987_0,,,,2,1,2,3
24987_1,,,,2,1,2,3
24989_0,,,,2,1,2,3
C(C)(C(C(C=C)=O)O)=O,,,5,1,1,0,1
24990_0,,,,2,1,2,3
24990_1,,,,2,1,2,3
24991_0,,,,2,1,2,3
24992_0,,,,2,1,2,3
24992_1,,,,2,1,2,3
24993_0,,,,2,1,2,3
24994_0,,,,2,1,2,3
24994_1,,,,2,1,2,3
24995_0,,,,2,1,2,3
24996_0,,,,2,1,2,3
24996_1,,,,2,1,2,3
24997_0,,,,2,1,2,3
24997_1,,,,2,1,2,3
24999_0,,,,2,1,2,3
C(C(C(C)=O)(C)O)=O,,,5,1,2,0,2
25000_0,,,,2,1,2,3
25000_1,,,,2,1,2,3
25001_0,,,,2,1,2,3
25001_1,,,,2,1,2,3
25002_0,,,,2,1,2,3
25003_0,,,,2,1,2,3
25003_1,,,,2,1,2,3
25004_0,,,,2,1,2,3
25005_0,,,,2,1,2,3
25006_0,,,,2,1,2,3
25006_1,,,,2,1,2,3
25008_0,,,,2,1,2,3
C(C)(C(C)O)=O,,,5,1,2,0,2
25009_0,,,,2,1,2,3
25009_1,,,,2,1,2,3
25010_0,,,,2,1,2,3
25011_0,,,,2,1,2,3
25011_1,,,,2,1,2,3
25012_0,,,,2,1,2,3
25013_0,,,,2,1,2,3
25013_1,,,,2,1,2,3
25014_0,,,,2,1,2,3
25014_1,,,,2,1,2,3
25016_0,,,,2,1,2,3
C(C(C(CO)(C)O)=O)(O)=O,,,5,1,4,0,4
25017_0,,,,2,1,2,3
25017_1,,,,2,1,2,3
25018_0,,,,2,1,2,3
25018_1,,,,2,1,2,3
25019_0,,,,2,1,2,3
25019_1,,,,2,1,2,3
25020_0,,,,2,1,2,3
25020_1,,,,2,1,2,3
25021_0,,,,2,1,2,3
25021_1,,,,2,1,2,3
25022_0,,,,2,1,2,3
25022_1,,,,2,1,2,3
25023_0,,,,2,1,2,3
25023_1,,,,2,1,2,3
25024_0,,,,2,1,2,3
25024_1,,,,2,1,2,3
25025_0,,,,2,1,2,3
25026_0,,,,2,1,2,3
25026_1,,,,2,1,2,3
25027_0,,,,2,1,2,3
25027_1,,,,2,1,2,3
25028_0,,,,2,1,2,3
25028_1,,,,2,1,2,3
25029_0,,,,2,1,2,3
25029_1,,,,2,1,2,3
25030_0,,,,2,1,2,3
25030_1,,,,2,1,2,3
25031_0,,,,2,1,2,3
25031_1,,,,2,1,2,3
25032_0,,,,2,1,2,3
25033_0,,,,2,1,2,3
25034_0,,,,2,1,2,3
25034_1,,,,2,1,2,3
25035_0,,,,2,1,2,3
25035_1,,,,2,1,2,3
25036_0,,,,2,1,2,3
25036_1,,,,2,1,2,3
25037_0,,,,2,1,2,3
25037_1,,,,2,1,2,3
25038_0,,,,2,1,2,3
25038_1,,,,2,1,2,3
25039_0,,,,2,1,2,3
25039_1,,,,2,1,2,3
25040_0,,,,2,1,2,3
25040_1,,,,2,1,2,3
25041_0,,,,2,1,2,3
25041_1,,,,2,1,2,3
25042_0,,,,2,1,2,3
25042_1,,,,2,1,2,3
25043_0,,,,2,1,2,3
25043_1,,,,2,1,2,3
25044_0,,,,2,1,2,3
25044_1,,,,2,1,2,3
25045_0,,,,2,1,2,3
25045_1,,,,2,1,2,3
25046_0,,,,2,1,2,3
25046_1,,,,2,1,2,3
25048_0,,,,2,1,2,3
C(C1(C(CCO1)=O)O)=O,,,5,1,3,0,3
25049_0,,,,2,1,2,3
25049_1,,,,2,1,2,3
25050_0,,,,2,1,2,3
25050_1,,,,2,1,2,3
25051_0,,,,2,1,2,3
25051_1,,,,2,1,2,3
25052_0,,,,2,1,2,3
25052_1,,,,2,1,2,3
25053_0,,,,2,1,2,3
25053_1,,,,2,1,2,3
25054_0,,,,2,1,2,3
25054_1,,,,2,1,2,3
25055_0,,,,2,1,2,3
25056_0,,,,2,1,2,3
25056_1,,,,2,1,2,3
25057_0,,,,2,1,2,3
25057_1,,,,2,1,2,3
25058_0,,,,2,1,2,3
25058_1,,,,2,1,2,3
25059_0,,,,2,1,2,3
25060_0,,,,2,1,2,3
25060_1,,,,2,1,2,3
25061_0,,,,2,1,2,3
25061_1,,,,2,1,2,3
25062_0,,,,2,1,2,3
25063_0,,,,2,1,2,3
25063_1,,,,2,1,2,3
25064_0,,,,2,1,2,3
25064_1,,,,2,1,2,3
25065_0,,,,2,1,2,3
25065_1,,,,2,1,2,3
25066_0,,,,2,1,2,3
25066_1,,,,2,1,2,3
25067_0,,,,2,1,2,3
25068_0,,,,2,1,2,3
25069_0,,,,2,1,2,3
25070_0,,,,2,1,2,3
25070_1,,,,2,1,2,3
25071_0,,,,2,1,2,3
25072_0,,,,2,1,2,3
25072_1,,,,2,1,2,3
25073_0,,,,2,1,2,3
25074_0,,,,2,1,2,3
25075_0,,,,2,1,2,3
25076_0,,,,2,1,2,3
25077_0,,,,2,1,2,3
25078_0,,,,2,1,2,3
25079_0,,,,2,1,2,3
25080_0,,,,2,1,2,3
25080_1,,,,2,1,2,3
25081_0,,,,2,1,2,3
25081_1,,,,2,1,2,3
25082_0,,,,2,1,2,3
25082_1,,,,2,1,2,3
25083_0,,,,2,1,2,3
25084_0,,,,2,1,2,3
25085_0,,,,2,1,2,3
25086_0,,,,2,1,2,3
25087_0,,,,2,1,2,3
25088_0,,,,2,1,2,3
25089_0,,,,2,1,2,3
25090_0,,,,2,1,2,3
25091_0,,,,2,1,2,3
25092_0,,,,2,1,2,3
25093_0,,,,2,1,2,3
25094_0,,,,2,1,2,3
25095_0,,,,2,1,2,3
25096_0,,,,2,1,2,3
25097_0,,,,2,1,2,3
25098_0,,,,2,1,2,3
25099_0,,,,2,1,2,3
25100_0,,,,2,1,2,3
25101_0,,,,2,1,2,3
25102_0,,,,2,1,2,3
25103_0,,,,2,1,2,3
25104_0,,,,2,1,2,3
25105_0,,,,2,1,2,3
25106_0,,,,2,1,2,3
25107_0,,,,2,1,2,3
25108_0,,,,2,1,2,3
25109_0,,,,2,1,2,3
25110_0,,,,2,1,2,3
25111_0,,,,2,1,2,3
25112_0,,,,2,1,2,3
25112_1,,,,2,1,2,3
25113_0,,,,2,1,2,3
25113_1,,,,2,1,2,3
25114_0,,,,2,1,2,3
25115_0,,,,2,1,2,3
25115_1,,,,2,1,2,3
25116_0,,,,2,1,2,3
25116_1,,,,2,1,2,3
25117_0,,,,2,1,2,3
25118_0,,,,2,1,2,3
25118_1,,,,2,1,2,3
25119_0,,,,2,1,2,3
25119_1,,,,2,1,2,3
25120_0,,,,2,1,2,3
25121_0,,,,2,1,2,3
25121_1,,,,2,1,2,3
25122_0,,,,2,1,2,3
25123_0,,,,2,1,2,3
25124_0,,,,2,1,2,3
25124_1,,,,2,1,2,3
25125_0,,,,2,1,2,3
25125_1,,,,2,1,2,3
25126_0,,,,2,1,2,3
25126_1,,,,2,1,2,3
25127_0,,,,2,1,2,3
25127_1,,,,2,1,2,3
25128_0,,,,2,1,2,3
25128_1,,,,2,1,2,3
25129_0,,,,2,1,2,3
25129_1,,,,2,1,2,3
25130_0,,,,2,1,2,3
25131_0,,,,2,1,2,3
25131_1,,,,2,1,2,3
25132_0,,,,2,1,2,3
25133_0,,,,2,1,2,3
25134_0,,,,2,1,2,3
25134_1,,,,2,1,2,3
25135_0,,,,2,1,2,3
25136_0,,,,2,1,2,3
25137_0,,,,2,1,2,3
25138_0,,,,2,1,2,3
25139_0,,,,2,1,2,3
25139_1,,,,2,1,2,3
25140_0,,,,2,1,2,3
25141_0,,,,2,1,2,3
25141_1,,,,2,1,2,3
25142_0,,,,2,1,2,3
25143_0,,,,2,1,2,3
25144_0,,,,2,1,2,3
25145_0,,,,2,1,2,3
25146_0,,,,2,1,2,3
25146_1,,,,2,1,2,3
25147_0,,,,2,1,2,3
25148_0,,,,2,1,2,3
25148_1,,,,2,1,2,3
25149_0,,,,2,1,2,3
25150_0,,,,2,1,2,3
25151_0,,,,2,1,2,3
25152_0,,,,2,1,2,3
25153_0,,,,2,1,2,3
25154_0,,,,2,1,2,3
25155_0,,,,2,1,2,3
25156_0,,,,2,1,2,3
25157_0,,,,2,1,2,3
25157_1,,,,2,1,2,3
25158_0,,,,2,1,2,3
25159_0,,,,2,1,2,3
25159_1,,,,2,1,2,3
25160_0,,,,2,1,2,3
25160_1,,,,2,1,2,3
25161_0,,,,2,1,2,3
25161_1,,,,2,1,2,3
25162_0,,,,2,1,2,3
25162_1,,,,2,1,2,3
25163_0,,,,2,1,2,3
25163_1,,,,2,1,2,3
25164_0,,,,2,1,2,3
25164_1,,,,2,1,2,3
25165_0,,,,2,1,2,3
25165_1,,,,2,1,2,3
25166_0,,,,2,1,2,3
25166_1,,,,2,1,2,3
25167_0,,,,2,1,2,3
25167_1,,,,2,1,2,3
25168_0,,,,2,1,2,3
25168_1,,,,2,1,2,3
25169_0,,,,2,1,2,3
25169_1,,,,2,1,2,3
25170_0,,,,2,1,2,3
25170_1,,,,2,1,2,3
25171_0,,,,2,1,2,3
25171_1,,,,2,1,2,3
25172_0,,,,2,1,2,3
25172_1,,,,2,1,2,3
25172_2,,,,2,1,2,3
25173_0,,,,2,1,2,3
25173_1,,,,2,1,2,3
25174_0,,,,2,1,2,3
25174_1,,,,2,1,2,3
25175_0,,,,2,1,2,3
25175_1,,,,2,1,2,3
25176_0,,,,2,1,2,3
25176_1,,,,2,1,2,3
25177_0,,,,2,1,2,3
25177_1,,,,2,1,2,3
25178_0,,,,2,1,2,3
25178_1,,,,2,1,2,3
25179_0,,,,2,1,2,3
25179_1,,,,2,1,2,3
25181_0,,,,2,1,2,3
C(C)(CC(CO)O)=O,,,5,1,2,0,2
25181_1,,,,2,1,2,3
25182_0,,,,2,1,2,3
25182_1,,,,2,1,2,3
25183_0,,,,2,1,2,3
25183_1,,,,2,1,2,3
25184_0,,,,2,1,2,3
25184_1,,,,2,1,2,3
25185_0,,,,2,1,2,3
25185_1,,,,2,1,2,3
25186_0,,,,2,1,2,3
25186_1,,,,2,1,2,3
25187_0,,,,2,1,2,3
25187_1,,,,2,1,2,3
25188_0,,,,2,1,2,3
25189_0,,,,2,1,2,3
25189_1,,,,2,1,2,3
25190_0,,,,2,1,2,3
25191_0,,,,2,1,2,3
25191_1,,,,2,1,2,3
25192_0,,,,2,1,2,3
25193_0,,,,2,1,2,3
25193_1,,,,2,1,2,3
25193_2,,,,2,1,2,3
25194_0,,,,2,1,2,3
25194_1,,,,2,1,2,3
25195_0,,,,2,1,2,3
25196_0,,,,2,1,2,3
25196_1,,,,2,1,2,3
25197_0,,,,2,1,2,3
25197_1,,,,2,1,2,3
25198_0,,,,2,1,2,3
25199_0,,,,2,1,2,3
25200_0,,,,2,1,2,3
25201_0,,,,2,1,2,3
25201_1,,,,2,1,2,3
25202_0,,,,2,1,2,3
25203_0,,,,2,1,2,3
25203_1,,,,2,1,2,3
25204_0,,,,2,1,2,3
25205_0,,,,2,1,2,3
25205_1,,,,2,1,2,3
25206_0,,,,2,1,2,3
25206_1,,,,2,1,2,3
25206_2,,,,2,1,2,3
25207_0,,,,2,1,2,3
25207_1,,,,2,1,2,3
25208_0,,,,2,1,2,3
25209_0,,,,2,1,2,3
25209_1,,,,2,1,2,3
25210_0,,,,2,1,2,3
25210_1,,,,2,1,2,3
25211_0,,,,2,1,2,3
25211_1,,,,2,1,2,3
25212_0,,,,2,1,2,3
25213_0,,,,2,1,2,3
25213_1,,,,2,1,2,3
25214_0,,,,2,1,2,3
25214_1,,,,2,1,2,3
25215_0,,,,2,1,2,3
25215_1,,,,2,1,2,3
25216_0,,,,2,1,2,3
25216_1,,,,2,1,2,3
25217_0,,,,2,1,2,3
25218_0,,,,2,1,2,3
25219_0,,,,2,1,2,3
25219_1,,,,2,1,2,3
25220_0,,,,2,1,2,3
25221_0,,,,2,1,2,3
25222_0,,,,2,1,2,3
25223_0,,,,2,1,2,3
25224_0,,,,2,1,2,3
25224_1,,,,2,1,2,3
25225_0,,,,2,1,2,3
25226_0,,,,2,1,2,3
25227_0,,,,2,1,2,3
25227_1,,,,2,1,2,3
25228_0,,,,2,1,2,3
25229_0,,,,2,1,2,3
25229_1,,,,2,1,2,3
25231_0,,,,2,1,2,3
C(C(CC(C)=O)O)=O,,,5,1,5,0,5
25231_1,,,,2,1,2,3
25232_0,,,,2,1,2,3
25233_0,,,,2,1,2,3
25233_1,,,,2,1,2,3
25234_0,,,,2,1,2,3
25235_0,,,,2,1,2,3
25236_0,,,,2,1,2,3
25237_0,,,,2,1,2,3
25237_1,,,,2,1,2,3
25238_0,,,,2,1,2,3
25238_1,,,,2,1,2,3
25239_0,,,,2,1,2,3
25240_0,,,,2,1,2,3
25242_0,,,,2,1,2,3
C(C)(C)=O,,,5,1,2,0,2
25242_1,,,,2,1,2,3
25244_0,,,,2,1,1,2
C(C(C(OCC(C)=O)O)O)=O,,,5,1,3,0,3
25244_1,,,,2,1,1,2
25245_0,,,,2,1,2,3
25245_1,,,,2,1,2,3
25247_0,,,,2,1,1,2
C(OC(C(CCO)=O)CO)=O,,,5,1,2,0,2
25247_1,,,,2,1,1,2
25248_0,,,,2,1,2,3
25248_1,,,,2,1,2,3
25250_0,,,,2,1,1,2
C(CC(OC(C=O)CO)O)=O,,,5,1,5,0,5
25250_1,,,,2,1,1,2
25252_0,,,,2,1,1,2
C(OC(CO)C(CC=O)O)=O,,,5,1,2,0,2
25252_1,,,,2,1,1,2
25254_0,,,,2,1,1,2
C(CC(OCC=O)O)=O,,,5,1,4,0,4
25254_1,,,,2,1,1,2
25256_0,,,,2,1,1,2
C(OCC(CC=O)O)=O,,,5,1,2,0,2
25256_1,,,,2,1,1,2
25257_0,,,,2,1,2,3
25259_0,,,,2,1,1,2
C(CO)(CC(OCC=O)O)=O,,,5,1,6,0,6
25259_1,,,,2,1,1,2
25261_0,,,,2,1,1,2
C(OCC(CC(CO)=O)O)=O,,,5,1,4,0,4
25261_1,,,,2,1,1,2
25263_0,,,,2,1,1,2
C(C)(C(C(OCC=O)O)O)=O,,,5,1,6,0,6
25263_1,,,,2,1,1,2
25263_2,,,,2,1,1,2
25265_0,,,,2,1,1,2
C(OCC(C(C(C)=O)O)O)=O,,,5,1,4,0,4
25265_1,,,,2,1,1,2
25265_2,,,,2,1,1,2
25267_0,,,,2,1,1,2
C(COCC(CO)=O)=O,,,5,1,2,0,2
25267_1,,,,2,1,1,2
25269_0,,,,2,1,1,2
C(COC(C(C)=O)O)=O,,,5,1,1,0,1
25271_0,,,,2,1,1,2
C(C(O)OCC(C)=O)=O,,,5,1,1,0,1
25273_0,,,,2,1,1,2
C(OCC(C(C)=O)O)=O,,,5,1,1,0,1
25275_0,,,,2,1,1,2
C(OCCC(CO)=O)=O,,,5,1,2,0,2
25275_1,,,,2,1,1,2
25277_0,,,,2,1,1,2
C(C(CO)OCC(CO)=O)=O,,,5,1,2,0,2
25277_1,,,,2,1,1,2
25279_0,,,,2,1,1,2
C(C(CO)OC(C(C)=O)O)=O,,,5,1,1,0,1
25281_0,,,,2,1,1,2
C(C)(C(CO)OC(C=O)O)=O,,,5,1,1,0,1
25282_0,,,,2,1,2,3
25282_1,,,,2,1,2,3
25284_0,,,,2,1,1,2
C(OC(CO)C(C(C)=O)O)=O,,,5,1,1,0,1
25286_0,,,,2,1,1,2
C(OC(CO)CC(CO)=O)=O,,,5,1,2,0,2
25286_1,,,,2,1,1,2
25288_0,,,,2,1,1,2
C(COC(C(CO)=O)O)(C)=O,,,5,1,1,0,1
25290_0,,,,2,1,1,2
C(OCCC(C(CO)O)=O)=O,,,5,1,3,0,3
25290_1,,,,2,1,1,2
25290_2,,,,2,1,1,2
25291_0,,,,2,1,2,3
25291_1,,,,2,1,2,3
25291_2,,,,2,1,2,3
25293_0,,,,2,1,1,2
C(OCC(C(CCO)=O)O)=O,,,5,1,2,0,2
25293_1,,,,2,1,1,2
25294_0,,,,2,1,2,3
25294_1,,,,2,1,2,3
25296_0,,,,2,1,1,2
C(CC(O)OCC(C=O)O)=O,,,5,1,5,0,5
25296_1,,,,2,1,1,2
25298_0,,,,2,1,1,2
C(OCC(C(CC=O)O)O)=O,,,5,1,2,0,2
25298_1,,,,2,1,1,2
25300_0,,,,2,1,1,2
C(C(COCC(CO)=O)O)=O,,,5,1,2,0,2
25300_1,,,,2,1,1,2
25302_0,,,,2,1,1,2
C(C(COC(C(C)=O)O)O)=O,,,5,1,4,0,4
25304_0,,,,2,1,1,2
C(C)(C(COC(C=O)O)O)=O,,,5,1,1,0,1
25306_0,,,,2,1,1,2
C(CO)(CCOC(C=O)O)=O,,,5,1,2,0,2
25306_1,,,,2,1,1,2
25307_0,,,,2,1,1,2
25308_0,,,,2,1,1,2
25308_1,,,,2,1,1,2
25309_0,,,,2,1,1,2
25309_1,,,,2,1,1,2
25310_0,,,,2,1,1,2
25311_0,,,,2,1,1,2
25312_0,,,,2,1,2,3
25312_1,,,,2,1,2,3
25313_0,,,,2,1,2,3
25313_1,,,,2,1,2,3
25315_0,,,,2,1,1,2
C(C(C=O)O)(OCC(C)=O)=O,,,5,1,3,0,3
25315_1,,,,2,1,1,2
25317_0,,,,2,1,1,2
C(COC(C(C)=O)=O)=O,,,5,1,1,0,1
25319_0,,,,2,1,1,2
C(COC(C=O)=O)(C)=O,,,5,1,1,0,1
25321_0,,,,2,1,1,2
C(C(CO)OC(C(C)=O)=O)=O,,,5,1,1,0,1
25323_0,,,,2,1,1,2
C(C)(C(CO)OC(C=O)=O)=O,,,5,1,1,0,1
25324_0,,,,2,1,2,3
25324_1,,,,2,1,2,3
25326_0,,,,2,1,1,2
C(C(COC(C(C)=O)=O)O)=O,,,5,1,1,0,1
25328_0,,,,2,1,1,2
C(C)(C(COC(C=O)=O)O)=O,,,5,1,1,0,1
25330_0,,,,2,1,1,2
C(CO)(CCOC(C=O)=O)=O,,,5,1,2,0,2
25330_1,,,,2,1,1,2
25332_0,,,,2,1,1,2
C(CC(CO)=O)(OCC=O)=O,,,5,1,2,0,2
25332_1,,,,2,1,1,2
25334_0,,,,2,1,1,2
C(C(C(C)=O)O)(OCC=O)=O,,,5,1,3,0,3
25335_0,,,,2,1,1,2
25336_0,,,,2,1,2,3
25337_0,,,,2,1,2,3
25338_0,,,,2,1,2,3
25339_0,,,,2,1,2,3
25340_0,,,,2,1,2,3
25341_0,,,,2,1,2,3
25342_0,,,,2,1,2,3
25343_0,,,,2,1,2,3
25344_0,,,,2,1,2,3
25345_0,,,,2,1,2,3
25346_0,,,,2,1,2,3
25346_1,,,,2,1,2,3
25347_0,,,,2,1,2,3
25347_1,,,,2,1,2,3
25348_0,,,,2,1,2,3
25348_1,,,,2,1,2,3
25349_0,,,,2,1,2,3
25350_0,,,,2,1,2,3
25351_0,,,,2,1,2,3
25352_0,,,,2,1,2,3
25353_0,,,,2,1,2,3
25354_0,,,,2,1,2,3
25355_0,,,,2,1,2,3
25356_0,,,,2,1,2,3
25357_0,,,,2,1,2,3
25358_0,,,,2,1,2,3
25359_0,,,,2,1,2,3
25360_0,,,,2,1,2,3
25361_0,,,,2,1,2,3
25362_0,,,,2,1,2,3
25363_0,,,,2,1,2,3
25364_0,,,,2,1,2,3
25365_0,,,,2,1,2,3
25366_0,,,,2,1,2,3
25367_0,,,,2,1,2,3
25368_0,,,,2,1,2,3
25369_0,,,,2,1,2,3
25370_0,,,,2,1,2,3
25371_0,,,,2,1,2,3
25372_0,,,,2,1,2,3
25373_0,,,,2,1,2,3
25374_0,,,,2,1,2,3
25375_0,,,,2,1,2,3
25376_0,,,,2,1,2,3
25377_0,,,,2,1,2,3
25378_0,,,,2,1,2,3
25379_0,,,,2,1,2,3
25380_0,,,,2,1,2,3
25381_0,,,,2,1,2,3
25382_0,,,,2,1,2,3
25383_0,,,,2,1,2,3
25384_0,,,,2,1,2,3
25385_0,,,,2,1,2,3
25386_0,,,,2,1,2,3
25387_0,,,,2,1,2,3
25388_0,,,,2,1,2,3
25389_0,,,,2,1,2,3
25390_0,,,,2,1,2,3
25390_1,,,,2,1,2,3
25391_0,,,,2,1,2,3
25392_0,,,,2,1,2,3
25392_1,,,,2,1,2,3
25393_0,,,,2,1,2,3
25393_1,,,,2,1,2,3
25394_0,,,,2,1,2,3
25394_1,,,,2,1,2,3
25395_0,,,,2,1,2,3
25396_0,,,,2,1,2,3
25397_0,,,,2,1,2,3
25397_1,,,,2,1,2,3
25398_0,,,,2,1,2,3
25399_0,,,,2,1,2,3
25399_1,,,,2,1,2,3
25400_0,,,,2,1,2,3
25401_0,,,,2,1,2,3
25401_1,,,,2,1,2,3
25402_0,,,,2,1,2,3
25402_1,,,,2,1,2,3
25403_0,,,,2,1,2,3
25403_1,,,,2,1,2,3
25404_0,,,,2,1,2,3
25405_0,,,,2,1,2,3
25405_1,,,,2,1,2,3
25406_0,,,,2,1,2,3
25406_1,,,,2,1,2,3
25407_0,,,,2,1,2,3
25407_1,,,,2,1,2,3
25408_0,,,,2,1,2,3
25408_1,,,,2,1,2,3
25409_0,,,,2,1,2,3
25409_1,,,,2,1,2,3
25410_0,,,,2,1,2,3
25410_1,,,,2,1,2,3
25411_0,,,,2,1,2,3
25412_0,,,,2,1,2,3
25413_0,,,,2,1,2,3
25414_0,,,,2,1,2,3
25415_0,,,,2,1,2,3
25416_0,,,,2,1,2,3
25416_1,,,,2,1,2,3
25417_0,,,,2,1,2,3
25418_0,,,,2,1,2,3
25418_1,,,,2,1,2,3
25418_2,,,,2,1,2,3
25419_0,,,,2,1,2,3
25419_1,,,,2,1,2,3
25420_0,,,,2,1,2,3
25420_1,,,,2,1,2,3
25421_0,,,,2,1,2,3
25421_1,,,,2,1,2,3
25423_0,,,,2,1,2,3
C(CO)=CC(CO)=O,,,5,1,6,0,6
25423_1,,,,2,1,2,3
25424_0,,,,2,1,2,3
25424_1,,,,2,1,2,3
25426_0,,,,2,1,1,2
C(C(O)OCCC(C=O)=O)=O,,,5,1,2,0,2
25426_1,,,,2,1,1,2
25428_0,,,,2,1,1,2
C(C(CC=O)OC(C=O)O)=O,,,5,1,2,0,2
25428_1,,,,2,1,1,2
25430_0,,,,2,1,1,2
C(OCC(CO)(CC=O)O)=O,,,5,1,2,0,2
25430_1,,,,2,1,1,2
25432_0,,,,2,1,1,2
C(CC(OCC(CO)=O)O)=O,,,5,1,6,0,6
25432_1,,,,2,1,1,2
25433_0,,,,2,1,2,3
25433_1,,,,2,1,2,3
25435_0,,,,2,1,1,2
C(CC(CO)(CO)OC(C=O)O)=O,,,5,1,2,0,2
25435_1,,,,2,1,1,2
25437_0,,,,2,1,1,2
C(OCC(CO)(CC(CO)=O)O)=O,,,5,1,4,0,4
25437_1,,,,2,1,1,2
25439_0,,,,2,1,1,2
C(CO)(CC(OCC(CO)=O)O)=O,,,5,1,8,0,8
25439_1,,,,2,1,1,2
25441_0,,,,2,1,1,2
C(CC(CO)(COC(CO)=O)O)=O,,,5,1,2,0,2
25441_1,,,,2,1,1,2
25443_0,,,,2,1,1,2
C(CC(CO)(OCC(CO)=O)O)=O,,,5,1,6,0,6
25443_1,,,,2,1,1,2
25444_0,,,,2,1,2,3
25446_0,,,,2,1,2,3
C1(CC(CO1)(CO)O)=O,,,5,1,4,0,4
25446_1,,,,2,1,2,3
25447_0,,,,2,1,1,2
25447_1,,,,2,1,1,2
25448_0,,,,2,1,1,2
25448_1,,,,2,1,1,2
25450_0,,,,2,1,2,3
C1(COC(CO)(C1O)O)=O,,,5,1,2,0,2
25451_0,,,,2,1,1,2
25451_1,,,,2,1,1,2
25453_0,,,,2,1,1,2
C(C(C(CO)(OCC(C)=O)O)O)=O,,,5,1,3,0,3
25453_1,,,,2,1,1,2
25455_0,,,,2,1,1,2
C(C(C(C)(OCC(CO)=O)O)O)=O,,,5,1,7,0,7
25455_1,,,,2,1,1,2
25457_0,,,,2,1,1,2
C(C)(C(C(CO)(OCC=O)O)O)=O,,,5,1,2,0,2
25457_1,,,,2,1,1,2
25459_0,,,,2,1,1,2
C(C)(C(C(OCC(CO)=O)O)O)=O,,,5,1,8,0,8
25459_1,,,,2,1,1,2
25461_0,,,,2,1,1,2
C(OCC(C(CO)O)(CC=O)O)=O,,,5,1,2,0,2
25461_1,,,,2,1,1,2
25463_0,,,,2,1,1,2
C(CC(OCC(C(CO)O)=O)O)=O,,,5,1,7,0,7
25463_1,,,,2,1,1,2
25465_0,,,,2,1,1,2
C(OC(CO)C(CO)(CC=O)O)=O,,,5,1,2,0,2
25465_1,,,,2,1,1,2
25467_0,,,,2,1,1,2
C(CC(OC(C(CO)=O)CO)O)=O,,,5,1,7,0,7
25467_1,,,,2,1,1,2
25468_0,,,,2,1,1,2
25468_1,,,,2,1,1,2
25469_0,,,,2,1,2,3
25469_1,,,,2,1,2,3
25471_0,,,,2,1,1,2
C(OC(CO)(CO)C(CC=O)O)=O,,,5,1,2,0,2
25471_1,,,,2,1,1,2
25473_0,,,,2,1,1,2
C(C(CO)(CO)OC(CC=O)O)=O,,,5,1,2,0,2
25473_1,,,,2,1,1,2
25474_0,,,,2,1,2,3
25474_1,,,,2,1,2,3
25476_0,,,,2,1,1,2
C(C(O)OCCC(C=O)=O)(C)=O,,,5,1,3,0,3
25476_1,,,,2,1,1,2
25478_0,,,,2,1,1,2
C(CC(C=O)OC(C(C)=O)O)=O,,,5,1,4,0,4
25478_1,,,,2,1,1,2
25480_0,,,,2,1,1,2
C(CC(C=O)(C)OC(C=O)O)=O,,,5,1,2,0,2
25480_1,,,,2,1,1,2
25481_0,,,,2,1,2,3
25481_1,,,,2,1,2,3
25483_0,,,,2,1,1,2
C(C(C)(O)OCCC(C=O)=O)=O,,,5,1,2,0,2
25483_1,,,,2,1,1,2
25485_0,,,,2,1,1,2
C(CC(C=O)OC(C=O)(C)O)=O,,,5,1,2,0,2
25485_1,,,,2,1,1,2
25487_0,,,,2,1,1,2
C(C(O)OC(C(C)=O)CC=O)=O,,,5,1,2,0,2
25487_1,,,,2,1,1,2
25488_0,,,,2,1,2,3
25489_0,,,,2,1,2,3
25491_0,,,,2,1,2,3
C(C1(CC(CO1)=O)O)=O,,,5,1,3,0,3
25493_0,,,,2,1,1,2
C(C(CC=O)(O)OCC(C)=O)=O,,,5,1,3,0,3
25493_1,,,,2,1,1,2
25495_0,,,,2,1,1,2
C(COC(C=O)(CC(C)=O)O)=O,,,5,1,2,0,2
25495_1,,,,2,1,1,2
25496_0,,,,2,1,2,3
25496_1,,,,2,1,2,3
25498_0,,,,2,1,1,2
C(CC(CC=O)OC(C=O)O)=O,,,5,1,2,0,2
25498_1,,,,2,1,1,2
25500_0,,,,2,1,1,2
C(CC(OCC(CC=O)=O)O)=O,,,5,1,8,0,8
25500_1,,,,2,1,1,2
25501_0,,,,2,1,1,2
25501_1,,,,2,1,1,2
25503_0,,,,2,1,1,2
C(CC(C=O)OC(CC=O)O)=O,,,5,1,8,0,8
25503_1,,,,2,1,1,2
25505_0,,,,2,1,1,2
C(OC(C(CC=O)O)CC=O)=O,,,5,1,2,0,2
25505_1,,,,2,1,1,2
25506_0,,,,2,1,2,3
25507_0,,,,2,1,1,2
25507_1,,,,2,1,1,2
25509_0,,,,2,1,1,2
C(OCC(CC=O)(CC=O)O)=O,,,5,1,2,0,2
25509_1,,,,2,1,1,2
25511_0,,,,2,1,1,2
C(C(C=O)C(OCC(C)=O)O)=O,,,5,1,3,0,3
25511_1,,,,2,1,1,2
25513_0,,,,2,1,1,2
C(CC(OC(C=O)C(C)=O)O)=O,,,5,1,8,0,8
25513_1,,,,2,1,1,2
25514_0,,,,2,1,1,2
25514_1,,,,2,1,1,2
25516_0,,,,2,1,1,2
C(C)(C(C=O)C(OCC=O)O)=O,,,5,1,2,0,2
25516_1,,,,2,1,1,2
25517_0,,,,2,1,1,2
25517_1,,,,2,1,1,2
25519_0,,,,2,1,1,2
C(CC(C)(C(C=O)OC=O)O)=O,,,5,1,2,0,2
25519_1,,,,2,1,1,2
25521_0,,,,2,1,1,2
C(CC(OC(C=O)C(CO)O)O)=O,,,5,1,5,0,5
25521_1,,,,2,1,1,2
25523_0,,,,2,1,1,2
C(OC(C(CC=O)O)C(CO)O)=O,,,5,1,2,0,2
25523_1,,,,2,1,1,2
25524_0,,,,2,1,2,3
25524_1,,,,2,1,2,3
25525_0,,,,2,1,2,3
25525_1,,,,2,1,2,3
25526_0,,,,2,1,2,3
25526_1,,,,2,1,2,3
25528_0,,,,2,1,1,2
C(CC(C)OC(C=O)O)=O,,,5,1,2,0,2
25528_1,,,,2,1,1,2
25530_0,,,,2,1,1,2
C(CC(C(CO)O)OC(C=O)O)=O,,,5,1,2,0,2
25530_1,,,,2,1,1,2
25532_0,,,,2,1,1,2
C(CCOC(C=O)O)=O,,,5,1,2,0,2
25532_1,,,,2,1,1,2
25534_0,,,,2,1,1,2
C(CC(CO)OC(C=O)O)=O,,,5,1,2,0,2
25534_1,,,,2,1,1,2
25536_0,,,,2,1,1,2
C(CC(CO)(OCC=O)O)=O,,,5,1,4,0,4
25536_1,,,,2,1,1,2
25537_0,,,,2,1,1,2
25537_1,,,,2,1,1,2
25539_0,,,,2,1,2,3
C1(COC(C1O)O)=O,,,5,1,3,0,3
25541_0,,,,2,1,1,2
C(C(CO)OC(CC(CO)=O)O)=O,,,5,1,7,0,7
25541_1,,,,2,1,1,2
25543_0,,,,2,1,1,2
C(OC(CO)C(CC(CO)=O)O)=O,,,5,1,4,0,4
25543_1,,,,2,1,1,2
25545_0,,,,2,1,1,2
C(CC(CO)(OC(C=O)CO)O)=O,,,5,1,5,0,5
25545_1,,,,2,1,1,2
25546_0,,,,2,1,1,2
25546_1,,,,2,1,1,2
25547_0,,,,2,1,1,2
25547_1,,,,2,1,1,2
25548_0,,,,2,1,1,2
25548_1,,,,2,1,1,2
25549_0,,,,2,1,2,3
25550_0,,,,2,1,2,3
25552_0,,,,2,1,1,2
C(CC(OCC(C)=O)O)=O,,,5,1,3,0,3
25552_1,,,,2,1,1,2
25554_0,,,,2,1,1,2
C(C(C(C)(OCC=O)O)O)=O,,,5,1,5,0,5
25554_1,,,,2,1,1,2
25556_0,,,,2,1,1,2
C(C)(CC(OCC=O)O)=O,,,5,1,2,0,2
25556_1,,,,2,1,1,2
25557_0,,,,2,1,1,2
25557_1,,,,2,1,1,2
25558_0,,,,2,1,2,3
25558_1,,,,2,1,2,3
25559_0,,,,2,1,2,3
25559_1,,,,2,1,2,3
25561_0,,,,2,1,1,2
C(C(COC(C=O)O)O)=O,,,5,1,5,0,5
25561_1,,,,2,1,1,2
25563_0,,,,2,1,1,2
C(C(C(CO)OC(C=O)O)O)=O,,,5,1,5,0,5
25563_1,,,,2,1,1,2
25565_0,,,,2,1,1,2
C(CO)(C(COC(C=O)O)O)=O,,,5,1,5,0,5
25565_1,,,,2,1,1,2
25565_2,,,,2,1,1,2
25566_0,,,,2,1,1,2
25566_1,,,,2,1,1,2
25566_2,,,,2,1,1,2
25567_0,,,,2,1,1,2
25567_1,,,,2,1,1,2
25567_2,,,,2,1,1,2
25568_0,,,,2,1,2,3
25568_1,,,,2,1,2,3
25570_0,,,,2,1,1,2
C(OCC(CO)(C(C(C)=O)O)O)=O,,,5,1,4,0,4
25570_1,,,,2,1,1,2
25570_2,,,,2,1,1,2
25571_0,,,,2,1,1,2
25571_1,,,,2,1,1,2
25571_2,,,,2,1,1,2
25573_0,,,,2,1,1,2
C(C(C(CO)(COC(C)=O)O)O)=O,,,5,1,3,0,3
25573_1,,,,2,1,1,2
25573_2,,,,2,1,1,2
25574_0,,,,2,1,1,2
25574_1,,,,2,1,1,2
25574_2,,,,2,1,1,2
25576_0,,,,2,1,1,2
C(CO)(C(COC(C(C)=O)O)O)=O,,,5,1,6,0,6
25576_1,,,,2,1,1,2
25576_2,,,,2,1,1,2
25578_0,,,,2,1,1,2
C(C(C)(O)OCC(C(CO)=O)O)=O,,,5,1,5,0,5
25578_1,,,,2,1,1,2
25578_2,,,,2,1,1,2
25579_0,,,,2,1,1,2
25579_1,,,,2,1,1,2
25579_2,,,,2,1,1,2
25580_0,,,,2,1,2,3
25580_1,,,,2,1,2,3
25580_2,,,,2,1,2,3
25581_0,,,,2,1,1,2
25581_1,,,,2,1,1,2
25581_2,,,,2,1,1,2
25583_0,,,,2,1,1,2
C(C(C(CO)OC(C(C)=O)O)O)=O,,,5,1,4,0,4
25583_1,,,,2,1,1,2
25583_2,,,,2,1,1,2
25584_0,,,,2,1,2,3
25584_1,,,,2,1,2,3
25586_0,,,,2,1,1,2
C(C(COC(C=O)(C)O)O)=O,,,5,1,3,0,3
25586_1,,,,2,1,1,2
25586_2,,,,2,1,1,2
25588_0,,,,2,1,1,2
C(C(C(CO)OC(C=O)(C)O)O)=O,,,5,1,3,0,3
25588_1,,,,2,1,1,2
25588_2,,,,2,1,1,2
25589_0,,,,2,1,2,3
25589_1,,,,2,1,2,3
25590_0,,,,2,1,1,2
25590_1,,,,2,1,1,2
25590_2,,,,2,1,1,2
25591_0,,,,2,1,2,3
25591_1,,,,2,1,2,3
25591_2,,,,2,1,2,3
25592_0,,,,2,1,1,2
25592_1,,,,2,1,1,2
25592_2,,,,2,1,1,2
25593_0,,,,2,1,2,3
25593_1,,,,2,1,2,3
25593_2,,,,2,1,2,3
25594_0,,,,2,1,1,2
25594_1,,,,2,1,1,2
25594_2,,,,2,1,1,2
25596_0,,,,2,1,2,3
C(C1(C(O)OCC1O)O)=O,,,5,1,2,0,2
25598_0,,,,2,1,1,2
C(C(COC(C(CCO)=O)O)O)=O,,,5,1,5,0,5
25598_1,,,,2,1,1,2
25598_2,,,,2,1,1,2
25600_0,,,,2,1,1,2
C(C(COC(C=O)(CCO)O)O)=O,,,5,1,3,0,3
25600_1,,,,2,1,1,2
25600_2,,,,2,1,1,2
25601_0,,,,2,1,2,3
25601_1,,,,2,1,2,3
25601_2,,,,2,1,2,3
25602_0,,,,2,1,2,3
25602_1,,,,2,1,2,3
25602_2,,,,2,1,2,3
25603_0,,,,2,1,2,3
25603_1,,,,2,1,2,3
25603_2,,,,2,1,2,3
25604_0,,,,2,1,1,2
25604_1,,,,2,1,1,2
25604_2,,,,2,1,1,2
25605_0,,,,2,1,2,3
25605_1,,,,2,1,2,3
25605_2,,,,2,1,2,3
25606_0,,,,2,1,1,2
25606_1,,,,2,1,1,2
25606_2,,,,2,1,1,2
25608_0,,,,2,1,2,3
C1(COC(C1(CO)O)O)=O,,,5,1,2,0,2
25610_0,,,,2,1,1,2
C(C(CO)OC(C(C(C)=O)O)O)=O,,,5,1,7,0,7
25610_1,,,,2,1,1,2
25610_2,,,,2,1,1,2
25612_0,,,,2,1,1,2
C(OC(CO)C(C(C(C)=O)O)O)=O,,,5,1,4,0,4
25612_1,,,,2,1,1,2
25612_2,,,,2,1,1,2
25614_0,,,,2,1,1,2
C(C(C(C)(OC(C=O)CO)O)O)=O,,,5,1,6,0,6
25614_1,,,,2,1,1,2
25614_2,,,,2,1,1,2
25616_0,,,,2,1,1,2
C(C(C(C(CO)OC(C)=O)O)O)=O,,,5,1,3,0,3
25616_1,,,,2,1,1,2
25616_2,,,,2,1,1,2
25617_0,,,,2,1,1,2
25617_1,,,,2,1,1,2
25617_2,,,,2,1,1,2
25619_0,,,,2,1,1,2
C(C(C(COC(C)=O)O)O)=O,,,5,1,3,0,3
25619_1,,,,2,1,1,2
25619_2,,,,2,1,1,2
25620_0,,,,2,1,2,3
25620_1,,,,2,1,2,3
25620_2,,,,2,1,2,3
25621_0,,,,2,1,1,2
25621_1,,,,2,1,1,2
25621_2,,,,2,1,1,2
25623_0,,,,2,1,1,2
C(C(C(OCC(C)=O)O)(CO)O)=O,,,5,1,3,0,3
25623_1,,,,2,1,1,2
25624_0,,,,2,1,2,3
25624_1,,,,2,1,2,3
25624_2,,,,2,1,2,3
25625_0,,,,2,1,1,2
25625_1,,,,2,1,1,2
25625_2,,,,2,1,1,2
25627_0,,,,2,1,1,2
C(C)(C(C(OCC=O)O)(CO)O)=O,,,5,1,2,0,2
25627_1,,,,2,1,1,2
25629_0,,,,2,1,1,2
C(COC(CC(C=O)=O)O)=O,,,5,1,4,0,4
25629_1,,,,2,1,1,2
25631_0,,,,2,1,2,3
C1(C(O)OCC1(CO)O)=O,,,5,1,4,0,4
25633_0,,,,2,1,1,2
C(C(C)OC(CC(C=O)=O)O)=O,,,5,1,4,0,4
25633_1,,,,2,1,1,2
25635_0,,,,2,1,1,2
C(COC(CC(C=O)=O)O)(C)=O,,,5,1,4,0,4
25635_1,,,,2,1,1,2
25636_0,,,,2,1,1,2
25636_1,,,,2,1,1,2
25637_0,,,,2,1,2,3
25639_0,,,,2,1,1,2
C(C(O)OCC(CO)=O)=O,,,5,1,2,0,2
25639_1,,,,2,1,1,2
25641_0,,,,2,1,1,2
C(CO)(C(CO)OC(C=O)O)=O,,,5,1,2,0,2
25641_1,,,,2,1,1,2
25642_0,,,,2,1,2,3
25642_1,,,,2,1,2,3
25644_0,,,,2,1,1,2
C(CC(COC(C=O)O)=O)=O,,,5,1,2,0,2
25644_1,,,,2,1,1,2
25646_0,,,,2,1,1,2
C(OC(C=O)C(C(C)=O)O)=O,,,5,1,1,0,1
25647_0,,,,2,1,1,2
25647_1,,,,2,1,1,2
25649_0,,,,2,1,1,2
C(C(C(C)=O)OC(C=O)O)=O,,,5,1,1,0,1
25651_0,,,,2,1,1,2
C(OC(C=O)CC(CO)=O)=O,,,5,1,2,0,2
25651_1,,,,2,1,1,2
25653_0,,,,2,1,1,2
C(COC(C(C)=O)O)(CO)=O,,,5,1,3,0,3
25654_0,,,,2,1,2,3
25654_1,,,,2,1,2,3
25656_0,,,,2,1,1,2
C(CO)(COC(C(CCO)=O)O)=O,,,5,1,4,0,4
25656_1,,,,2,1,1,2
25658_0,,,,2,1,1,2
C(CC(CO)(COC(C=O)O)O)=O,,,5,1,2,0,2
25658_1,,,,2,1,1,2
25660_0,,,,2,1,1,2
C(CC(C(OCC(CO)=O)O)O)=O,,,5,1,4,0,4
25660_1,,,,2,1,1,2
25662_0,,,,2,1,1,2
C(OC(CO)(CO)C(C(C)=O)O)=O,,,5,1,1,0,1
25664_0,,,,2,1,1,2
C(OC(CO)(CO)CC(CO)=O)=O,,,5,1,2,0,2
25664_1,,,,2,1,1,2
25665_0,,,,2,1,1,2
25665_1,,,,2,1,1,2
25667_0,,,,2,1,1,2
C(C(C)(OCC(CO)=O)O)=O,,,5,1,2,0,2
25667_1,,,,2,1,1,2
25669_0,,,,2,1,1,2
C(C(CCOC(C=O)(CO)O)O)=O,,,5,1,2,0,2
25669_1,,,,2,1,1,2
25670_0,,,,2,1,1,2
25670_1,,,,2,1,1,2
25672_0,,,,2,1,1,2
C(C(CCO)(OCC(CO)=O)O)=O,,,5,1,2,0,2
25672_1,,,,2,1,1,2
25674_0,,,,2,1,1,2
C(C(CC(OCC(CO)=O)O)O)=O,,,5,1,4,0,4
25674_1,,,,2,1,1,2
25675_0,,,,2,1,1,2
25675_1,,,,2,1,1,2
25677_0,,,,2,1,1,2
C(COC(C(C)=O)O)(C(CO)O)=O,,,5,1,4,0,4
25679_0,,,,2,1,1,2
C(CO)(C(CO)OC(C(C)=O)O)=O,,,5,1,3,0,3
25681_0,,,,2,1,1,2
C(OCC(C(CO)(CC=O)O)O)=O,,,5,1,2,0,2
25681_1,,,,2,1,1,2
25683_0,,,,2,1,1,2
C(CC(O)OCC(C(CO)=O)O)=O,,,5,1,5,0,5
25683_1,,,,2,1,1,2
25684_0,,,,2,1,1,2
25684_1,,,,2,1,1,2
25685_0,,,,2,1,2,3
25685_1,,,,2,1,2,3
25687_0,,,,2,1,1,2
C(C(C)(OC(C(CO)=O)CO)O)=O,,,5,1,2,0,2
25687_1,,,,2,1,1,2
25688_0,,,,2,1,2,3
25688_1,,,,2,1,2,3
25690_0,,,,2,1,1,2
C(C(CO)(CO)OC(C(C)=O)O)=O,,,5,1,1,0,1
25692_0,,,,2,1,1,2
C(OCC(CO)(C(CC=O)O)O)=O,,,5,1,2,0,2
25692_1,,,,2,1,1,2
25694_0,,,,2,1,1,2
C(C(COC(CC=O)O)(CO)O)=O,,,5,1,2,0,2
25694_1,,,,2,1,1,2
25696_0,,,,2,1,1,2
C(CC(COC(C(C)=O)O)=O)=O,,,5,1,3,0,3
25696_1,,,,2,1,1,2
25698_0,,,,2,1,1,2
C(C(C)(C(C(C)=O)O)OC=O)=O,,,5,1,1,0,1
25699_0,,,,2,1,1,2
25699_1,,,,2,1,1,2
25701_0,,,,2,1,1,2
C(C(C(C)=O)OC(C(C)=O)O)=O,,,5,1,3,0,3
25703_0,,,,2,1,1,2
C(C(C)(CC(CO)=O)OC=O)=O,,,5,1,2,0,2
25703_1,,,,2,1,1,2
25705_0,,,,2,1,1,2
C(C(C)(OCC(CC=O)=O)O)=O,,,5,1,2,0,2
25705_1,,,,2,1,1,2
25706_0,,,,2,1,1,2
25707_0,,,,2,1,1,2
25707_1,,,,2,1,1,2
25709_0,,,,2,1,1,2
C(C(C)(OC(C=O)C(C)=O)O)=O,,,5,1,1,0,1
25711_0,,,,2,1,1,2
C(OC(C(C)=O)CC(CO)=O)=O,,,5,1,2,0,2
25711_1,,,,2,1,1,2
25712_0,,,,2,1,1,2
25714_0,,,,2,1,2,3
C1(COC(C(C1)=O)O)=O,,,5,1,4,0,4
25715_0,,,,2,1,1,2
25717_0,,,,2,1,1,2
C(CC(C(O)OCC(C)=O)=O)=O,,,5,1,2,0,2
25717_1,,,,2,1,1,2
25718_0,,,,2,1,1,2
25720_0,,,,2,1,1,2
C(COC(C(CC(C)=O)=O)O)=O,,,5,1,2,0,2
25720_1,,,,2,1,1,2
25721_0,,,,2,1,1,2
25723_0,,,,2,1,1,2
C(C(C(CO)O)OC(C(C)=O)O)=O,,,5,1,1,0,1
25725_0,,,,2,1,1,2
C(CC(O)OCCC(C=O)=O)=O,,,5,1,6,0,6
25725_1,,,,2,1,1,2
25726_0,,,,2,1,1,2
25726_1,,,,2,1,1,2
25728_0,,,,2,1,1,2
C(CC(C(C(C)=O)O)OC=O)=O,,,5,1,1,0,1
25730_0,,,,2,1,1,2
C(CC(CC(CO)=O)OC=O)=O,,,5,1,2,0,2
25730_1,,,,2,1,1,2
25731_0,,,,2,1,1,2
25731_1,,,,2,1,1,2
25733_0,,,,2,1,1,2
C(C(CCOC=O)(CC=O)O)=O,,,5,1,2,0,2
25733_1,,,,2,1,1,2
25734_0,,,,2,1,1,2
25734_1,,,,2,1,1,2
25736_0,,,,2,1,1,2
C(CC(CC(C=O)OC=O)O)=O,,,5,1,2,0,2
25736_1,,,,2,1,1,2
25738_0,,,,2,1,1,2
C(CC(O)OC(CO)C(C=O)O)=O,,,5,1,5,0,5
25738_1,,,,2,1,1,2
25740_0,,,,2,1,1,2
C(OC(CO)C(C(CC=O)O)O)=O,,,5,1,2,0,2
25740_1,,,,2,1,1,2
25742_0,,,,2,1,1,2
C(C(CCOC(C=O)O)O)=O,,,5,1,2,0,2
25742_1,,,,2,1,1,2
25744_0,,,,2,1,1,2
C(C(CO)OC(C(CCO)=O)O)=O,,,5,1,2,0,2
25744_1,,,,2,1,1,2
25745_0,,,,2,1,2,3
25745_1,,,,2,1,2,3
25747_0,,,,2,1,1,2
C(COC(C(CCO)=O)O)=O,,,5,1,2,0,2
25747_1,,,,2,1,1,2
25748_0,,,,2,1,2,3
25748_1,,,,2,1,2,3
25750_0,,,,2,1,1,2
C(C(CC(OCC=O)O)O)=O,,,5,1,4,0,4
25750_1,,,,2,1,1,2
25752_0,,,,2,1,1,2
C(CC(C(OCC=O)O)O)=O,,,5,1,4,0,4
25752_1,,,,2,1,1,2
25754_0,,,,2,1,1,2
C(CC(C(OC(C=O)CO)O)O)=O,,,5,1,5,0,5
25754_1,,,,2,1,1,2
25756_0,,,,2,1,1,2
C(CC(C(CO)OC(C=O)O)O)=O,,,5,1,2,0,2
25756_1,,,,2,1,1,2
25757_0,,,,2,1,1,2
25757_1,,,,2,1,1,2
25759_0,,,,2,1,1,2
C(CC(COC(C=O)O)O)=O,,,5,1,2,0,2
25759_1,,,,2,1,1,2
25761_0,,,,2,1,1,2
C(C(COC(CC(CO)=O)O)O)=O,,,5,1,5,0,5
25761_1,,,,2,1,1,2
25763_0,,,,2,1,1,2
C(OCC(C(CC(CO)=O)O)O)=O,,,5,1,2,0,2
25763_1,,,,2,1,1,2
25765_0,,,,2,1,1,2
C(CC(CO)(O)OCC(C=O)O)=O,,,5,1,5,0,5
25765_1,,,,2,1,1,2
25766_0,,,,2,1,1,2
25766_1,,,,2,1,1,2
25768_0,,,,2,1,1,2
C(OC(C)C(C(C)=O)O)=O,,,5,1,1,0,1
25769_0,,,,2,1,2,3
25771_0,,,,2,1,1,2
C(OC(C(CO)O)C(C(C)=O)O)=O,,,5,1,1,0,1
25773_0,,,,2,1,1,2
C(OC(C)CC(CO)=O)=O,,,5,1,2,0,2
25773_1,,,,2,1,1,2
25774_0,,,,2,1,2,3
25774_1,,,,2,1,2,3
25776_0,,,,2,1,1,2
C(OC(C(CO)O)CC(CO)=O)=O,,,5,1,2,0,2
25776_1,,,,2,1,1,2
25778_0,,,,2,1,1,2
C(COC(C(CO)=O)O)=O,,,5,1,2,0,2
25778_1,,,,2,1,1,2
25780_0,,,,2,1,1,2
C(C(CO)OC(C(CO)=O)O)=O,,,5,1,2,0,2
25780_1,,,,2,1,1,2
25782_0,,,,2,1,1,2
C(C(C(COC(C=O)O)O)O)=O,,,5,1,5,0,5
25782_1,,,,2,1,1,2
25783_0,,,,2,1,2,3
25783_1,,,,2,1,2,3
25783_2,,,,2,1,2,3
25785_0,,,,2,1,1,2
C(COC(C=O)O)(C(CO)O)=O,,,5,1,3,0,3
25785_1,,,,2,1,1,2
25785_2,,,,2,1,1,2
25787_0,,,,2,1,1,2
C(C(C(C(OCC=O)O)O)O)=O,,,5,1,3,0,3
25787_1,,,,2,1,1,2
25787_2,,,,2,1,1,2
25788_0,,,,2,1,1,2
25788_1,,,,2,1,1,2
25788_2,,,,2,1,1,2
25789_0,,,,2,1,1,2
25789_1,,,,2,1,1,2
25789_2,,,,2,1,1,2
25790_0,,,,2,1,2,3
25790_1,,,,2,1,2,3
25790_2,,,,2,1,2,3
25792_0,,,,2,1,1,2
C(C(C)(OCC(C(CO)O)=O)O)=O,,,5,1,3,0,3
25792_1,,,,2,1,1,2
25792_2,,,,2,1,1,2
25793_0,,,,2,1,2,3
25793_1,,,,2,1,2,3
25793_2,,,,2,1,2,3
25794_0,,,,2,1,1,2
25794_1,,,,2,1,1,2
25794_2,,,,2,1,1,2
25796_0,,,,2,1,1,2
C(C(C(C(OCC=O)O)(C)O)O)=O,,,5,1,3,0,3
25796_1,,,,2,1,1,2
25796_2,,,,2,1,1,2
25798_0,,,,2,1,1,2
C(C(C(COC(C(C)=O)O)O)O)=O,,,5,1,3,0,3
25798_1,,,,2,1,1,2
25798_2,,,,2,1,1,2
25800_0,,,,2,1,1,2
C(C(C(C(C)(OCC=O)O)O)O)=O,,,5,1,3,0,3
25800_1,,,,2,1,1,2
25800_2,,,,2,1,1,2
25802_0,,,,2,1,1,2
C(C(C(COC(C=O)(C)O)O)O)=O,,,5,1,3,0,3
25802_1,,,,2,1,1,2
25802_2,,,,2,1,1,2
25803_0,,,,2,1,1,2
25803_1,,,,2,1,1,2
25803_2,,,,2,1,1,2
25804_0,,,,2,1,1,2
25804_1,,,,2,1,1,2
25804_2,,,,2,1,1,2
25806_0,,,,2,1,1,2
C(C(CCOC(C(CO)=O)O)O)=O,,,5,1,2,0,2
25806_1,,,,2,1,1,2
25807_0,,,,2,1,2,3
25807_1,,,,2,1,2,3
25807_2,,,,2,1,2,3
25809_0,,,,2,1,1,2
C(C(CC(OC(C=O)CO)O)O)=O,,,5,1,5,0,5
25809_1,,,,2,1,1,2
25809_2,,,,2,1,1,2
25810_0,,,,2,1,2,3
25810_1,,,,2,1,2,3
25810_2,,,,2,1,2,3
25811_0,,,,2,1,1,2
25811_1,,,,2,1,1,2
25811_2,,,,2,1,1,2
25812_0,,,,2,1,1,2
25812_1,,,,2,1,1,2
25812_2,,,,2,1,1,2
25813_0,,,,2,1,1,2
25813_1,,,,2,1,1,2
25813_2,,,,2,1,1,2
25815_0,,,,2,1,1,2
C(C(COC(C(C(C)=O)O)O)O)=O,,,5,1,6,0,6
25815_1,,,,2,1,1,2
25815_2,,,,2,1,1,2
25817_0,,,,2,1,1,2
C(OCC(C(C(C(C)=O)O)O)O)=O,,,5,1,3,0,3
25817_1,,,,2,1,1,2
25817_2,,,,2,1,1,2
25819_0,,,,2,1,1,2
C(C(C(C)(O)OCC(C=O)O)O)=O,,,5,1,6,0,6
25819_1,,,,2,1,1,2
25819_2,,,,2,1,1,2
25821_0,,,,2,1,1,2
C(C(C(C(COC(C)=O)O)O)O)=O,,,5,1,3,0,3
25821_1,,,,2,1,1,2
25821_2,,,,2,1,1,2
25822_0,,,,2,1,1,2
25822_1,,,,2,1,1,2
25822_2,,,,2,1,1,2
25823_0,,,,2,1,1,2
25823_1,,,,2,1,1,2
25823_2,,,,2,1,1,2
25824_0,,,,2,1,1,2
25824_1,,,,2,1,1,2
25825_0,,,,2,1,1,2
25825_1,,,,2,1,1,2
25826_0,,,,2,1,2,3
25827_0,,,,2,1,1,2
25827_1,,,,2,1,1,2
25828_0,,,,2,1,1,2
25828_1,,,,2,1,1,2
25829_0,,,,2,1,1,2
25830_0,,,,2,1,1,2
25830_1,,,,2,1,1,2
25831_0,,,,2,1,1,2
25831_1,,,,2,1,1,2
25832_0,,,,2,1,1,2
25833_0,,,,2,1,1,2
25833_1,,,,2,1,1,2
25835_0,,,,2,1,1,2
C(C(CO)(O)OCCC(CO)=O)=O,,,5,1,2,0,2
25835_1,,,,2,1,1,2
25836_0,,,,2,1,1,2
25837_0,,,,2,1,1,2
25837_1,,,,2,1,1,2
25838_0,,,,2,1,1,2
25838_1,,,,2,1,1,2
25839_0,,,,2,1,1,2
25839_1,,,,2,1,1,2
25840_0,,,,2,1,1,2
25840_1,,,,2,1,1,2
25841_0,,,,2,1,1,2
25842_0,,,,2,1,1,2
25842_1,,,,2,1,1,2
25843_0,,,,2,1,1,2
25843_1,,,,2,1,1,2
25844_0,,,,2,1,1,2
25844_1,,,,2,1,1,2
25845_0,,,,2,1,2,3
25845_1,,,,2,1,2,3
25847_0,,,,2,1,1,2
C(C(CO)(COC(C(C)=O)O)O)=O,,,5,1,1,0,1
25848_0,,,,2,1,1,2
25849_0,,,,2,1,1,2
25850_0,,,,2,1,1,2
25851_0,,,,2,1,1,2
25852_0,,,,2,1,1,2
25852_1,,,,2,1,1,2
25853_0,,,,2,1,1,2
25854_0,,,,2,1,1,2
25854_1,,,,2,1,1,2
25856_0,,,,2,1,1,2
C(CC(C(CCOC=O)=O)O)=O,,,5,1,2,0,2
25856_1,,,,2,1,1,2
25857_0,,,,2,1,1,2
25858_0,,,,2,1,1,2
25858_1,,,,2,1,1,2
25859_0,,,,2,1,1,2
25859_1,,,,2,1,1,2
25861_0,,,,2,1,1,2
C(CC(O)OCC(C(C=O)O)O)=O,,,5,1,5,0,5
25861_1,,,,2,1,1,2
25863_0,,,,2,1,1,2
C(OCC(C(C(CC=O)O)O)O)=O,,,5,1,2,0,2
25863_1,,,,2,1,1,2
25864_0,,,,2,1,1,2
25864_1,,,,2,1,1,2
25865_0,,,,2,1,2,3
25865_1,,,,2,1,2,3
25867_0,,,,2,1,1,2
C(CC(C(O)OCC(C=O)O)O)=O,,,5,1,5,0,5
25867_1,,,,2,1,1,2
25869_0,,,,2,1,1,2
C(CC(C(COC(C=O)O)O)O)=O,,,5,1,2,0,2
25869_1,,,,2,1,1,2
25870_0,,,,2,1,1,2
25871_0,,,,2,1,1,2
25872_0,,,,2,1,1,2
25872_1,,,,2,1,1,2
25873_0,,,,2,1,1,2
25873_1,,,,2,1,1,2
25874_0,,,,2,1,1,2
25876_0,,,,2,1,1,2
C(C(COC(C(CO)=O)O)O)=O,,,5,1,2,0,2
25876_1,,,,2,1,1,2
25877_0,,,,2,1,1,2
25877_1,,,,2,1,1,2
25877_2,,,,2,1,1,2
25878_0,,,,2,1,2,3
25878_1,,,,2,1,2,3
25878_2,,,,2,1,2,3
25880_0,,,,2,1,1,2
C(C(C(CC(OCC=O)O)O)O)=O,,,5,1,3,0,3
25880_1,,,,2,1,1,2
25880_2,,,,2,1,1,2
25881_0,,,,2,1,1,2
25881_1,,,,2,1,1,2
25881_2,,,,2,1,1,2
25883_0,,,,2,1,1,2
C(CO)(CCOC(C(CO)=O)O)=O,,,5,1,2,0,2
25883_1,,,,2,1,1,2
25885_0,,,,2,1,1,2
C(C(CC(O)OCC(C=O)O)O)=O,,,5,1,5,0,5
25885_1,,,,2,1,1,2
25885_2,,,,2,1,1,2
25886_0,,,,2,1,1,2
25886_1,,,,2,1,1,2
25886_2,,,,2,1,1,2
25887_0,,,,2,1,1,2
25888_0,,,,2,1,1,2
25888_1,,,,2,1,1,2
25890_0,,,,2,1,2,3
C1(C(C(CO1)=O)O)=O,,,5,1,3,0,3
25891_0,,,,2,1,1,2
25891_1,,,,2,1,1,2
25893_0,,,,2,1,1,2
C(C(CCOC(C=O)=O)O)=O,,,5,1,2,0,2
25893_1,,,,2,1,1,2
25894_0,,,,2,1,2,3
25894_1,,,,2,1,2,3
25895_0,,,,2,1,2,3
25896_0,,,,2,1,2,3
25896_1,,,,2,1,2,3
25897_0,,,,2,1,2,3
25897_1,,,,2,1,2,3
25898_0,,,,2,1,2,3
25898_1,,,,2,1,2,3
25899_0,,,,2,1,2,3
25900_0,,,,2,1,2,3
25902_0,,,,2,1,2,3
C(C)(CCC(C=O)=O)=O,,,5,1,5,0,5
25903_0,,,,2,1,2,3
25904_0,,,,2,1,2,3
25905_0,,,,2,1,2,3
25906_0,,,,2,1,2,3
25907_0,,,,2,1,2,3
25907_1,,,,2,1,2,3
25908_0,,,,2,1,2,3
25909_0,,,,2,1,2,3
25909_1,,,,2,1,2,3
25910_0,,,,2,1,2,3
25910_1,,,,2,1,2,3
25911_0,,,,2,1,2,3
25912_0,,,,2,1,2,3
25912_1,,,,2,1,2,3
25913_0,,,,2,1,2,3
25913_1,,,,2,1,2,3
25914_0,,,,2,1,2,3
25914_1,,,,2,1,2,3
25915_0,,,,2,1,2,3
25916_0,,,,2,1,2,3
25917_0,,,,2,1,2,3
25918_0,,,,2,1,2,3
25919_0,,,,2,1,2,3
25920_0,,,,2,1,2,3
25921_0,,,,2,1,2,3
25922_0,,,,2,1,2,3
25923_0,,,,2,1,2,3
25924_0,,,,2,1,2,3
25925_0,,,,2,1,2,3
25926_0,,,,2,1,2,3
25927_0,,,,2,1,2,3
25928_0,,,,2,1,2,3
25929_0,,,,2,1,2,3
25930_0,,,,2,1,2,3
25931_0,,,,2,1,2,3
25932_0,,,,2,1,2,3
25933_0,,,,2,1,2,3
25934_0,,,,2,1,2,3
25935_0,,,,2,1,2,3
25936_0,,,,2,1,2,3
25937_0,,,,2,1,2,3
25938_0,,,,2,1,2,3
25939_0,,,,2,1,2,3
25940_0,,,,2,1,2,3
25941_0,,,,2,1,2,3
25942_0,,,,2,1,2,3
25943_0,,,,2,1,2,3
25944_0,,,,2,1,2,3
25945_0,,,,2,1,2,3
25946_0,,,,2,1,2,3
25947_0,,,,2,1,2,3
25948_0,,,,2,1,2,3
25949_0,,,,2,1,2,3
25950_0,,,,2,1,2,3
25951_0,,,,2,1,2,3
25952_0,,,,2,1,2,3
25953_0,,,,2,1,2,3
25953_1,,,,2,1,2,3
25954_0,,,,2,1,2,3
25955_0,,,,2,1,2,3
25955_1,,,,2,1,2,3
25956_0,,,,2,1,2,3
25956_1,,,,2,1,2,3
25957_0,,,,2,1,2,3
25958_0,,,,2,1,2,3
25958_1,,,,2,1,2,3
25959_0,,,,2,1,2,3
25959_1,,,,2,1,2,3
25960_0,,,,2,1,2,3
25960_1,,,,2,1,2,3
25961_0,,,,2,1,2,3
25962_0,,,,2,1,2,3
25962_1,,,,2,1,2,3
25963_0,,,,2,1,2,3
25963_1,,,,2,1,2,3
25964_0,,,,2,1,2,3
25965_0,,,,2,1,2,3
25966_0,,,,2,1,2,3
25968_0,,,,2,1,1,2
C(COC=O)(CCCC(C=O)=O)=O,,,5,1,2,0,2
25970_0,,,,2,1,1,2
C(OCC(CC(C=O)CC=O)=O)=O,,,5,1,2,0,2
25972_0,,,,2,1,1,2
C(CCC(C=O)=O)(OCC(C)=O)=O,,,5,1,1,0,1
25973_0,,,,2,1,2,3
25975_0,,,,2,1,1,2
C(C(C(OCC(C)=O)=O)CC=O)=O,,,5,1,1,0,1
25977_0,,,,2,1,1,2
C(C)(C(CCC(C=O)=O)OC=O)=O,,,5,1,2,0,2
25979_0,,,,2,1,1,2
C(OC(C(C)=O)C(C=O)CC=O)=O,,,5,1,2,0,2
25980_0,,,,2,1,2,3
25980_1,,,,2,1,2,3
25981_0,,,,2,1,2,3
25981_1,,,,2,1,2,3
25982_0,,,,2,1,2,3
25983_0,,,,2,1,2,3
25984_0,,,,2,1,2,3
25985_0,,,,2,1,2,3
25986_0,,,,2,1,2,3
25986_1,,,,2,1,2,3
25987_0,,,,2,1,2,3
25988_0,,,,2,1,2,3
25989_0,,,,2,1,2,3
25990_0,,,,2,1,2,3
25991_0,,,,2,1,2,3
25992_0,,,,2,1,2,3
25993_0,,,,2,1,2,3
25994_0,,,,2,1,2,3
25995_0,,,,2,1,2,3
25996_0,,,,2,1,2,3
25997_0,,,,2,1,2,3
25998_0,,,,2,1,2,3
25999_0,,,,2,1,2,3
26000_0,,,,2,1,1,2
26001_0,,,,2,1,1,2
26002_0,,,,2,1,1,2
26003_0,,,,2,1,1,2
26004_0,,,,2,1,1,2
26005_0,,,,2,1,1,2
26007_0,,,,2,1,1,2
C1(C(C(C(C1(CCO)O)O)O)O)=O,,,5,1,1,0,1
26008_0,,,,2,1,1,2
26009_0,,,,2,1,1,2
26010_0,,,,2,1,1,2
26012_0,,,,2,1,1,2
C1(C(C(C(C(CC1O)O)O)O)O)=O,,,5,1,1,0,1
26014_0,,,,2,1,1,2
C1(C(C(C(CO)(CC1O)O)O)O)=O,,,5,1,2,0,2
26016_0,,,,2,1,1,2
C1(C(C(C(CC1(CO)O)O)O)O)=O,,,5,1,1,0,1
26018_0,,,,2,1,1,2
C1(C(CC(C(C1(CO)O)O)O)O)=O,,,5,1,3,0,3
26019_0,,,,2,1,1,2
26021_0,,,,2,1,1,2
C1(C(C(C(C(C1(C)O)O)O)O)O)=O,,,5,1,1,0,1
26022_0,,,,2,1,1,2
26023_0,,,,2,1,1,2
26024_0,,,,2,1,1,2
26025_0,,,,2,1,1,2
26026_0,,,,2,1,1,2
26028_0,,,,2,1,1,2
C1(C(CC(C(C1)=O)O)O)=O,,,5,1,1,0,1
26029_0,,,,2,1,1,2
26030_0,,,,2,1,1,2
26032_0,,,,2,1,1,2
C1(C(C(CO)C(C(C1)=O)O)O)=O,,,5,1,1,0,1
26034_0,,,,2,1,1,2
C1(C(CC(C(C1CO)=O)O)O)=O,,,5,1,1,0,1
26036_0,,,,2,1,1,2
C(C1C(C(CC(C1O)O)O)=O)=O,,,5,1,1,0,1
26037_0,,,,2,1,1,2
26038_0,,,,2,1,1,2
26039_0,,,,2,1,1,2
26040_0,,,,2,1,1,2
26041_0,,,,2,1,1,2
26042_0,,,,2,1,1,2
26043_0,,,,2,1,1,2
26044_0,,,,2,1,1,2
26045_0,,,,2,1,1,2
26046_0,,,,2,1,1,2
26047_0,,,,2,1,1,2
26048_0,,,,2,1,1,2
26049_0,,,,2,1,1,2
26050_0,,,,2,1,1,2
26052_0,,,,2,1,1,2
C(C1(C(C(CC(C1)O)O)=O)O)=O,,,5,1,1,0,1
26054_0,,,,2,1,1,2
C(C1(CC(C(C(C1)O)=O)O)O)=O,,,5,1,1,0,1
26055_0,,,,2,1,1,2
26056_0,,,,2,1,1,2
26057_0,,,,2,1,1,2
26058_0,,,,2,1,1,2
26059_0,,,,2,1,1,2
26061_0,,,,2,1,1,2
C1(C(CC(CC1O)O)O)=O,,,5,1,1,0,1
26062_0,,,,2,1,1,2
26063_0,,,,2,1,1,2
26064_0,,,,2,1,1,2
26065_0,,,,2,1,1,2
26067_0,,,,2,1,1,2
C1(C(CC(CO)(C1(CO)O)O)O)=O,,,5,1,3,0,3
26069_0,,,,2,1,1,2
C1(C(C(CO)(C(CC1O)O)O)O)=O,,,5,1,2,0,2
26071_0,,,,2,1,1,2
C1(C(CC(C1(C(C)=O)O)O)O)=O,,,5,1,3,0,3
26073_0,,,,2,1,1,2
C(C1(C(C(CC1(C)O)O)=O)O)=O,,,5,1,1,0,1
26075_0,,,,2,1,1,2
C1(C(CC(C1(CO)O)O)O)=O,,,5,1,3,0,3
26077_0,,,,2,1,1,2
C1(C(CC(C1(C(CO)O)O)O)O)=O,,,5,1,3,0,3
26079_0,,,,2,1,1,2
C1(C(C(CO)C(C1(CO)O)O)O)=O,,,5,1,3,0,3
26080_0,,,,2,1,1,2
26082_0,,,,2,1,1,2
C1(C(C(CC1O)O)(CC=O)O)=O,,,5,1,2,0,2
26083_0,,,,2,1,1,2
26084_0,,,,2,1,1,2
26085_0,,,,2,1,1,2
26086_0,,,,2,1,1,2
26087_0,,,,2,1,1,2
26089_0,,,,2,1,1,2
C(C(CC(C=O)(C(CO)=O)O)O)=O,,,5,1,1,0,1
26090_0,,,,2,1,1,2
26092_0,,,,2,1,1,2
C(CC(C(CC(C=O)O)O)=O)=O,,,5,1,5,0,5
26093_0,,,,2,1,1,2
26094_0,,,,2,1,1,2
26096_0,,,,2,1,1,2
C(C(C(C(CC(C=O)O)O)=O)O)=O,,,5,1,2,0,2
26097_0,,,,2,1,1,2
26098_0,,,,2,1,1,2
26099_0,,,,2,1,1,2
26100_0,,,,2,1,1,2
26101_0,,,,2,1,1,2
26102_0,,,,2,1,1,2
26103_0,,,,2,1,1,2
26104_0,,,,2,1,1,2
26105_0,,,,2,1,1,2
26106_0,,,,2,1,1,2
26107_0,,,,2,1,1,2
26108_0,,,,2,1,1,2
26109_0,,,,2,1,1,2
26111_0,,,,2,1,1,2
C(C(C(CO)C(C(C=O)=O)O)O)=O,,,5,1,1,0,1
26112_0,,,,2,1,1,2
26113_0,,,,2,1,1,2
26114_0,,,,2,1,1,2
26115_0,,,,2,1,1,2
26116_0,,,,2,1,1,2
26117_0,,,,2,1,1,2
26118_0,,,,2,1,1,2
26120_0,,,,2,1,1,2
C(CO)(C(CC(CO)(CO)O)O)=O,,,5,1,3,0,3
26121_0,,,,2,1,1,2
26122_0,,,,2,1,1,2
26124_0,,,,2,1,1,2
C(CO)(C(CO)(C(C(C)O)O)O)=O,,,5,1,5,0,5
26125_0,,,,2,1,1,2
26126_0,,,,2,1,1,2
26127_0,,,,2,1,1,2
26129_0,,,,2,1,1,2
C(C(C)(CC(C(CC=O)=O)O)O)=O,,,5,1,1,0,1
26131_0,,,,2,1,1,2
C(C(C)(CC(C(C(C)O)=O)O)O)=O,,,5,1,1,0,1
26133_0,,,,2,1,1,2
C(C(C)(CC(CC(C=O)O)O)O)=O,,,5,1,1,0,1
26135_0,,,,2,1,1,2
C(C(C)(CC(C(CO)=O)O)O)=O,,,5,1,3,0,3
26136_0,,,,2,1,1,2
26138_0,,,,2,1,1,2
C(CC(C)(C(CC(C=O)O)O)O)=O,,,5,1,1,0,1
26139_0,,,,2,1,1,2
26140_0,,,,2,1,1,2
26141_0,,,,2,1,1,2
26142_0,,,,2,1,1,2
26143_0,,,,2,1,1,2
26144_0,,,,2,1,1,2
26145_0,,,,2,1,1,2
26147_0,,,,2,1,1,2
C(C(CC(C(C)=O)O)O)(CC=O)=O,,,5,1,1,0,1
26148_0,,,,2,1,1,2
26149_0,,,,2,1,1,2
26151_0,,,,2,1,1,2
C(C(CC(C)O)O)(CC(C=O)=O)=O,,,5,1,1,0,1
26152_0,,,,2,1,1,2
26154_0,,,,2,1,1,2
C(C(C=O)C(C(CC(C)O)O)=O)=O,,,5,1,1,0,1
26155_0,,,,2,1,1,2
26157_0,,,,2,1,1,2
C(C(C)O)(C(CC(C(C)=O)O)O)=O,,,5,1,1,0,1
26158_0,,,,2,1,1,2
26160_0,,,,2,1,1,2
C(C(CC(CC(C(C)=O)O)O)O)=O,,,5,1,1,0,1
26161_0,,,,2,1,1,2
26162_0,,,,2,1,1,2
26163_0,,,,2,1,1,2
26164_0,,,,2,1,1,2
26166_0,,,,2,1,1,2
C(C)(C(CC(C(CO)=O)O)O)=O,,,5,1,3,0,3
26167_0,,,,2,1,1,2
26169_0,,,,2,1,1,2
C(CC(C(C(C(C)O)=O)(C)O)O)=O,,,5,1,1,0,1
26171_0,,,,2,1,1,2
C(CC(C(C)(CC(C=O)O)O)O)=O,,,5,1,1,0,1
26172_0,,,,2,1,1,2
26173_0,,,,2,1,1,2
26174_0,,,,2,1,1,2
26175_0,,,,2,1,1,2
26176_0,,,,2,1,1,2
26177_0,,,,2,1,1,2
26178_0,,,,2,1,1,2
26180_0,,,,2,1,1,2
C(CC(C(CC(CCO)O)O)=O)=O,,,5,1,1,0,1
26182_0,,,,2,1,1,2
C(CC(C(CC(CO)(C)O)O)=O)=O,,,5,1,1,0,1
26184_0,,,,2,1,1,2
C(CC(C(CC(C(O)=O)O)O)=O)=O,,,5,1,1,0,1
26185_0,,,,2,1,1,2
26187_0,,,,2,1,1,2
C(CC(C(CC(C)O)O)=O)=O,,,5,1,1,0,1
26189_0,,,,2,1,1,2
C(CC(C(CC(CO)O)O)=O)=O,,,5,1,1,0,1
26190_0,,,,2,1,1,2
26191_0,,,,2,1,1,2
26193_0,,,,2,1,1,2
C(C(C(C(CC(C)O)O)=O)O)=O,,,5,1,2,0,2
26194_0,,,,2,1,1,2
26196_0,,,,2,1,1,2
C(C(C(C(CC(CO)O)O)=O)O)=O,,,5,1,3,0,3
26198_0,,,,2,1,1,2
C(C(C(C(C)O)=O)(CC(C)O)O)=O,,,5,1,1,0,1
26200_0,,,,2,1,1,2
C(C(CC(C=O)O)(CC(C)O)O)=O,,,5,1,1,0,1
26202_0,,,,2,1,1,2
C(C(C(CO)=O)(CC(C)O)O)=O,,,5,1,1,0,1
26204_0,,,,2,1,1,2
C(C(C(C(CC(C)O)O)=O)CO)=O,,,5,1,1,0,1
26206_0,,,,2,1,1,2
C(CC(C)O)(C(C(C(C)O)=O)O)=O,,,5,1,1,0,1
26208_0,,,,2,1,1,2
C(C(CC(C)O)O)(C(C(C)=O)O)=O,,,5,1,2,0,2
26210_0,,,,2,1,1,2
C(C(CC(C=O)O)O)(CC(C)O)=O,,,5,1,1,0,1
26212_0,,,,2,1,1,2
C(C(CC(C)O)O)(CC(CO)=O)=O,,,5,1,1,0,1
26214_0,,,,2,1,1,2
C(C(C(CO)=O)(CC(CO)O)O)=O,,,5,1,2,0,2
26215_0,,,,2,1,1,2
26216_0,,,,2,1,1,2
26217_0,,,,2,1,1,2
26218_0,,,,2,1,1,2
26219_0,,,,2,1,1,2
26220_0,,,,2,1,1,2
26221_0,,,,2,1,1,2
26222_0,,,,2,1,1,2
26223_0,,,,2,1,1,2
26224_0,,,,2,1,1,2
26225_0,,,,2,1,1,2
26226_0,,,,2,1,1,2
26227_0,,,,2,1,1,2
26228_0,,,,2,1,1,2
26229_0,,,,2,1,1,2
26230_0,,,,2,1,1,2
26232_0,,,,2,1,1,2
C(CC(C(C(CO)C(C)O)O)=O)=O,,,5,1,1,0,1
26234_0,,,,2,1,1,2
C(CC(C(C(CO)CO)O)=O)=O,,,5,1,2,0,2
26235_0,,,,2,1,1,2
26237_0,,,,2,1,1,2
C(C(C(C(C(CO)CO)O)=O)O)=O,,,5,1,2,0,2
26239_0,,,,2,1,1,2
C(C(C(CO)=O)(C(CO)CO)O)=O,,,5,1,2,0,2
26240_0,,,,2,1,1,2
26241_0,,,,2,1,1,2
26242_0,,,,2,1,1,2
26243_0,,,,2,1,1,2
26244_0,,,,2,1,1,2
26246_0,,,,2,1,1,2
C(C(C(CO)C(C(CO)=O)O)O)=O,,,5,1,6,0,6
26247_0,,,,2,1,1,2
26248_0,,,,2,1,1,2
26249_0,,,,2,1,1,2
26250_0,,,,2,1,1,2
26251_0,,,,2,1,1,2
26252_0,,,,2,1,1,2
26253_0,,,,2,1,1,2
26254_0,,,,2,1,1,2
26255_0,,,,2,1,1,2
26256_0,,,,2,1,1,2
26257_0,,,,2,1,1,2
26258_0,,,,2,1,1,2
26259_0,,,,2,1,1,2
26260_0,,,,2,1,1,2
26261_0,,,,2,1,1,2
26262_0,,,,2,1,1,2
26263_0,,,,2,1,1,2
26264_0,,,,2,1,1,2
26265_0,,,,2,1,1,2
26266_0,,,,2,1,1,2
26267_0,,,,2,1,1,2
26268_0,,,,2,1,1,2
26269_0,,,,2,1,1,2
26270_0,,,,2,1,1,2
26271_0,,,,2,1,1,2
26273_0,,,,2,1,1,2
C(C(C(C(C(C)O)C(C)O)O)=O)=O,,,5,1,1,0,1
26274_0,,,,2,1,1,2
26276_0,,,,2,1,1,2
C(C(C(C(CO)C(C)O)O)=O)=O,,,5,1,1,0,1
26277_0,,,,2,1,1,2
26278_0,,,,2,1,1,2
26279_0,,,,2,1,1,2
26281_0,,,,2,1,1,2
C(C(C(C(CO)CO)O)=O)=O,,,5,1,2,0,2
26282_0,,,,2,1,1,2
26284_0,,,,2,1,1,2
C(C(C(C(CO)C(CO)O)O)=O)=O,,,5,1,2,0,2
26285_0,,,,2,1,1,2
26286_0,,,,2,1,1,2
26287_0,,,,2,1,1,2
26289_0,,,,2,1,1,2
C(C(CC(C)O)O)(C(C)O)=O,,,5,1,1,0,1
26291_0,,,,2,1,1,2
C(C(CC(CC(C)O)O)O)=O,,,5,1,1,0,1
26293_0,,,,2,1,1,2
C(C(CC(C)O)O)(C(CCO)O)=O,,,5,1,1,0,1
26295_0,,,,2,1,1,2
C(C(C(CO)C(CC(C)O)O)O)=O,,,5,1,2,0,2
26297_0,,,,2,1,1,2
C(CO)(C(CC(CC(C)O)O)O)=O,,,5,1,1,0,1
26299_0,,,,2,1,1,2
C1(COC(C(CC(C)O)O)C1O)=O,,,5,1,1,0,1
26301_0,,,,2,1,1,2
C1(C(C(CO1)C(CC(C)O)O)O)=O,,,5,1,1,0,1
26303_0,,,,2,1,1,2
C(C(CC(C)O)O)(C(CO)O)=O,,,5,1,1,0,1
26305_0,,,,2,1,1,2
C(C(C(C(CC(C)O)O)O)O)=O,,,5,1,2,0,2
26306_0,,,,2,1,1,2
26307_0,,,,2,1,1,2
26308_0,,,,2,1,1,2
26309_0,,,,2,1,1,2
26311_0,,,,2,1,1,2
C(C(C(CC(CC(C)O)O)O)=O)=O,,,5,1,1,0,1
26313_0,,,,2,1,1,2
C(CO)(C(CC(C)O)O)=O,,,5,1,3,0,3
26314_0,,,,2,1,1,2
26315_0,,,,2,1,1,2
26316_0,,,,2,1,1,2
26317_0,,,,2,1,1,2
26318_0,,,,2,1,1,2
26319_0,,,,2,1,1,2
26320_0,,,,2,1,1,2
26321_0,,,,2,1,1,2
26323_0,,,,2,1,1,2
C(C(CC(C(C(C)O)O)O)O)=O,,,5,1,1,0,1
26324_0,,,,2,1,1,2
26325_0,,,,2,1,1,2
26326_0,,,,2,1,1,2
26328_0,,,,2,1,1,2
C(CO)(C(CC(C(CO)O)O)O)=O,,,5,1,3,0,3
26329_0,,,,2,1,1,2
26331_0,,,,2,1,1,2
C(C(CCO)O)(C(C(C)=O)O)=O,,,5,1,3,0,3
26332_0,,,,2,1,1,2
26334_0,,,,2,1,1,2
C(C(CCO)O)(C(C)O)=O,,,5,1,3,0,3
26335_0,,,,2,1,1,2
26337_0,,,,2,1,1,2
C(C(CCO)O)(C(CCO)O)=O,,,5,1,1,0,1
26339_0,,,,2,1,1,2
C(C(C(CO)C(CCO)O)O)=O,,,5,1,3,0,3
26341_0,,,,2,1,1,2
C(CO)(C(CC(CCO)O)O)=O,,,5,1,1,0,1
26342_0,,,,2,1,1,2
26344_0,,,,2,1,1,2
C(CC(C(C(CCO)O)=O)O)(O)=O,,,5,1,2,0,2
26346_0,,,,2,1,1,2
C(C(C(CC(CCO)O)O)=O)(O)=O,,,5,1,1,0,1
26348_0,,,,2,1,1,2
C1(COC(C(CCO)O)C1O)=O,,,5,1,1,0,1
26350_0,,,,2,1,1,2
C1(C(C(CO1)C(CCO)O)O)=O,,,5,1,1,0,1
26352_0,,,,2,1,1,2
C(C(CCO)O)(C(CO)O)=O,,,5,1,6,0,6
26353_0,,,,2,1,1,2
26355_0,,,,2,1,1,2
C(C(CCO)O)(C(C(CO)O)O)=O,,,5,1,3,0,3
26356_0,,,,2,1,1,2
26357_0,,,,2,1,1,2
26358_0,,,,2,1,1,2
26359_0,,,,2,1,1,2
26360_0,,,,2,1,1,2
26362_0,,,,2,1,1,2
C(C(C(CC(CCO)O)O)=O)=O,,,5,1,2,0,2
26363_0,,,,2,1,1,2
26364_0,,,,2,1,1,2
26365_0,,,,2,1,1,2
26366_0,,,,2,1,1,2
26367_0,,,,2,1,1,2
26368_0,,,,2,1,1,2
26369_0,,,,2,1,1,2
26370_0,,,,2,1,1,2
26371_0,,,,2,1,1,2
26372_0,,,,2,1,1,2
26374_0,,,,2,1,1,2
C(C(CC(CO)O)O)(C(C)O)=O,,,5,1,1,0,1
26376_0,,,,2,1,1,2
C(C(CC(CC(CO)O)O)O)=O,,,5,1,1,0,1
26378_0,,,,2,1,1,2
C(C(CC(CO)O)O)(C(CO)O)=O,,,5,1,2,0,2
26380_0,,,,2,1,1,2
C(C(C(C(CC(CO)O)O)O)O)=O,,,5,1,3,0,3
26382_0,,,,2,1,1,2
C(CO)(C(CC(CO)O)O)=O,,,5,1,4,0,4
26383_0,,,,2,1,1,2
26384_0,,,,2,1,1,2
26385_0,,,,2,1,1,2
26387_0,,,,2,1,1,2
C(C(C(C(C=O)O)=O)(CO)O)=O,,,5,1,1,0,1
26389_0,,,,2,1,1,2
C(C(C(C(C(C)=O)O)=O)(CO)O)=O,,,5,1,1,0,1
26390_0,,,,2,1,1,2
26392_0,,,,2,1,1,2
C(C(CO)(C(CO)C(C=O)O)O)=O,,,5,1,5,0,5
26394_0,,,,2,1,1,2
C(C(CO)(CC(C(CO)=O)O)O)=O,,,5,1,4,0,4
26396_0,,,,2,1,1,2
C(C(CO)(C1C(C(CO1)=O)O)O)=O,,,5,1,1,0,1
26398_0,,,,2,1,1,2
C(C(CO)(C1COC(C1O)=O)O)=O,,,5,1,1,0,1
26399_0,,,,2,1,1,2
26400_0,,,,2,1,1,2
26401_0,,,,2,1,1,2
26402_0,,,,2,1,1,2
26404_0,,,,2,1,1,2
C(CC(C(C(C=O)(CO)O)=O)O)=O,,,5,1,3,0,3
26405_0,,,,2,1,1,2
26407_0,,,,2,1,1,2
C(C(CO)(CC(C(C=O)=O)O)O)=O,,,5,1,2,0,2
26409_0,,,,2,1,1,2
C(C(C(C(C(CO)=O)O)=O)O)=O,,,5,1,2,0,2
26410_0,,,,2,1,1,2
26411_0,,,,2,1,1,2
26413_0,,,,2,1,1,2
C(C(C(CO)=O)O)(C(C(C)=O)O)=O,,,5,1,1,0,1
26415_0,,,,2,1,1,2
C(C(CO)O)(C(C(C(C)=O)=O)O)=O,,,5,1,1,0,1
26416_0,,,,2,1,1,2
26417_0,,,,2,1,1,2
26419_0,,,,2,1,1,2
C(C(CO)O)(CC(C(CO)=O)=O)=O,,,5,1,1,0,1
26420_0,,,,2,1,1,2
26421_0,,,,2,1,1,2
26422_0,,,,2,1,1,2
26423_0,,,,2,1,1,2
26424_0,,,,2,1,1,2
26425_0,,,,2,1,1,2
26426_0,,,,2,1,1,2
26428_0,,,,2,1,1,2
C(CO)(C(CC(C(CO)=O)O)O)=O,,,5,1,2,0,2
26429_0,,,,2,1,1,2
26430_0,,,,2,1,1,2
26432_0,,,,2,1,1,2
C(C(CO)O)(CC(C(O)=O)=O)=O,,,5,1,4,0,4
26433_0,,,,2,1,1,2
26434_0,,,,2,1,1,2
26435_0,,,,2,1,1,2
26437_0,,,,2,1,1,2
C(CO)(C(C1C(C(CO1)=O)O)O)=O,,,5,1,1,0,1
26439_0,,,,2,1,1,2
C(C(CO)O)(C1C(C(CO1)O)=O)=O,,,5,1,1,0,1
26440_0,,,,2,1,1,2
26442_0,,,,2,1,1,2
C1(C(C(CO1)C(C(CO)=O)O)O)=O,,,5,1,1,0,1
26444_0,,,,2,1,1,2
C(C(CO)O)(C1C(C(O)OC1)=O)=O,,,5,1,1,0,1
26445_0,,,,2,1,1,2
26447_0,,,,2,1,1,2
C(C(CO)O)(C1C(COC1O)=O)=O,,,5,1,1,0,1
26448_0,,,,2,1,1,2
26450_0,,,,2,1,1,2
C1(CC(OC1C(C(CO)O)=O)O)=O,,,5,1,1,0,1
26451_0,,,,2,1,1,2
26452_0,,,,2,1,1,2
26453_0,,,,2,1,1,2
26454_0,,,,2,1,1,2
26455_0,,,,2,1,1,2
26456_0,,,,2,1,1,2
26457_0,,,,2,1,1,2
26458_0,,,,2,1,1,2
26459_0,,,,2,1,1,2
26460_0,,,,2,1,1,2
26461_0,,,,2,1,1,2
26462_0,,,,2,1,1,2
26463_0,,,,2,1,1,2
26464_0,,,,2,1,1,2
26465_0,,,,2,1,1,2
26467_0,,,,2,1,1,2
C(CC(C(C(C(CO)=O)O)=O)O)=O,,,5,1,1,0,1
26468_0,,,,2,1,1,2
26469_0,,,,2,1,1,2
26470_0,,,,2,1,1,2
26472_0,,,,2,1,1,2
C(CO)(C(CC(C(C=O)=O)O)O)=O,,,5,1,1,0,1
26473_0,,,,2,1,1,2
26474_0,,,,2,1,1,2
26475_0,,,,2,1,1,2
26476_0,,,,2,1,1,2
26478_0,,,,2,1,1,2
C(C(C=O)O)(C(C(C)=O)(CO)O)=O,,,5,1,1,0,1
26479_0,,,,2,1,1,2
26481_0,,,,2,1,1,2
C(C(C=O)O)(C(C(CO)=O)(C)O)=O,,,5,1,1,0,1
26483_0,,,,2,1,1,2
C(C(C(C(C=O)O)=O)(C(C)O)O)=O,,,5,1,1,0,1
26485_0,,,,2,1,1,2
C(C(C(C)O)O)(C(C(C=O)=O)O)=O,,,5,1,1,0,1
26486_0,,,,2,1,1,2
26488_0,,,,2,1,1,2
C(C(C(C(C(C(C)O)=O)O)=O)O)=O,,,5,1,1,0,1
26490_0,,,,2,1,1,2
C(C(C(C(CO)(C)O)=O)O)=O,,,5,1,2,0,2
26492_0,,,,2,1,1,2
C(C(C(C(CO)(CCO)O)=O)O)=O,,,5,1,2,0,2
26493_0,,,,2,1,1,2
26495_0,,,,2,1,1,2
C(C(C(C(C)(C(CO)O)O)=O)O)=O,,,5,1,2,0,2
26496_0,,,,2,1,1,2
26498_0,,,,2,1,1,2
C(C(C(C(C=O)O)=O)(C)O)(O)=O,,,5,1,2,0,2
26500_0,,,,2,1,1,2
C(C(C(C(CC(O)=O)O)=O)O)=O,,,5,1,3,0,3
26502_0,,,,2,1,1,2
C(C(C(C1(COCC1O)O)=O)O)=O,,,5,1,1,0,1
26504_0,,,,2,1,1,2
C(C(C(C1(C(O)OCC1)O)=O)O)=O,,,5,1,1,0,1
26506_0,,,,2,1,1,2
C(C(C(C1(COC(C1)O)O)=O)O)=O,,,5,1,1,0,1
26508_0,,,,2,1,1,2
C(C(C(C(C=O)O)=O)(C=C)O)=O,,,5,1,1,0,1
26510_0,,,,2,1,1,2
C(C(C(C=O)=O)O)(C(C=C)O)=O,,,5,1,1,0,1
26512_0,,,,2,1,1,2
C(C(C(C(C(C=C)=O)O)=O)O)=O,,,5,1,1,0,1
26514_0,,,,2,1,1,2
C(C(C(C(C=CC=O)O)=O)O)=O,,,5,1,1,0,1
26515_0,,,,2,1,1,2
26517_0,,,,2,1,1,2
C(C(C(C(C=O)O)=O)O)=O,,,5,1,2,0,2
26519_0,,,,2,1,1,2
C(C(C(C(CO)(CO)O)=O)O)=O,,,5,1,4,0,4
26521_0,,,,2,1,1,2
C(C(C(C(C=O)O)=O)(C)O)=O,,,5,1,2,0,2
26522_0,,,,2,1,1,2
26524_0,,,,2,1,1,2
C(C(C(C(C(C)=O)O)=O)O)=O,,,5,1,4,0,4
26525_0,,,,2,1,1,2
26527_0,,,,2,1,1,2
C(C(C(C(C=O)O)=O)(CCO)O)=O,,,5,1,1,0,1
26529_0,,,,2,1,1,2
C(C(CCO)O)(C(C(C=O)=O)O)=O,,,5,1,1,0,1
26531_0,,,,2,1,1,2
C(C(C(C(C(CCO)=O)O)=O)O)=O,,,5,1,1,0,1
26532_0,,,,2,1,1,2
26533_0,,,,2,1,1,2
26534_0,,,,2,1,1,2
26535_0,,,,2,1,1,2
26536_0,,,,2,1,1,2
26537_0,,,,2,1,1,2
26538_0,,,,2,1,1,2
26539_0,,,,2,1,1,2
26540_0,,,,2,1,1,2
26542_0,,,,2,1,1,2
C(C(C)(C(C=O)O)O)(C(C=O)O)=O,,,5,1,2,0,2
26543_0,,,,2,1,1,2
26545_0,,,,2,1,1,2
C(C(CC(C=O)O)(C(CO)O)O)=O,,,5,1,5,0,5
26546_0,,,,2,1,1,2
26547_0,,,,2,1,1,2
26548_0,,,,2,1,1,2
26549_0,,,,2,1,1,2
26550_0,,,,2,1,1,2
26551_0,,,,2,1,1,2
26552_0,,,,2,1,1,2
26553_0,,,,2,1,1,2
26554_0,,,,2,1,1,2
26555_0,,,,2,1,1,2
26556_0,,,,2,1,1,2
26558_0,,,,2,1,1,2
C(C(C)O)(C(C(C)=O)(CO)O)=O,,,5,1,2,0,2
26560_0,,,,2,1,1,2
C(C(CC(C(C)=O)(CO)O)O)=O,,,5,1,1,0,1
26561_0,,,,2,1,1,2
26562_0,,,,2,1,1,2
26563_0,,,,2,1,1,2
26565_0,,,,2,1,1,2
C(C(C)O)(C(C(CO)=O)(C)O)=O,,,5,1,1,0,1
26566_0,,,,2,1,1,2
26568_0,,,,2,1,1,2
C(C(CC(C(CO)=O)(C)O)O)=O,,,5,1,1,0,1
26569_0,,,,2,1,1,2
26570_0,,,,2,1,1,2
26571_0,,,,2,1,1,2
26573_0,,,,2,1,1,2
C(C(CO)O)(C(C(CO)=O)(C)O)=O,,,5,1,2,0,2
26574_0,,,,2,1,1,2
26575_0,,,,2,1,1,2
26576_0,,,,2,1,1,2
26577_0,,,,2,1,1,2
26578_0,,,,2,1,1,2
26580_0,,,,2,1,1,2
C(CO)(C(C(CO)=O)(C)O)=O,,,5,1,1,0,1
26581_0,,,,2,1,1,2
26583_0,,,,2,1,1,2
C(C(CO)(C)O)(C(C(C)=O)O)=O,,,5,1,1,0,1
26584_0,,,,2,1,1,2
26586_0,,,,2,1,1,2
C(C(C(C(C(C)=O)O)=O)(C)O)(O)=O,,,5,1,1,0,1
26588_0,,,,2,1,1,2
C(CC(C(C(C(C)=O)O)=O)O)(O)=O,,,5,1,3,0,3
26590_0,,,,2,1,1,2
C(C(C(C(C(C)=O)O)=O)(C=C)O)=O,,,5,1,1,0,1
26592_0,,,,2,1,1,2
C(C(C=C)O)(C(C(C(C)=O)=O)O)=O,,,5,1,1,0,1
26594_0,,,,2,1,1,2
C(C(C(C)=O)O)(C(C(C=C)=O)O)=O,,,5,1,1,0,1
26596_0,,,,2,1,1,2
C(C(C(C)=O)O)(C(C=CC=O)O)=O,,,5,1,1,0,1
26597_0,,,,2,1,1,2
26598_0,,,,2,1,1,2
26599_0,,,,2,1,1,2
26601_0,,,,2,1,1,2
C(C(CO)(CO)O)(C(C(C)=O)O)=O,,,5,1,4,0,4
26603_0,,,,2,1,1,2
C(C(C(C(C(C)=O)O)=O)(C)O)=O,,,5,1,2,0,2
26604_0,,,,2,1,1,2
26606_0,,,,2,1,1,2
C(C(C(C)=O)O)(C(C(C)=O)O)=O,,,5,1,2,0,2
26607_0,,,,2,1,1,2
26609_0,,,,2,1,1,2
C(C(C)O)(C(C(C)=O)O)=O,,,5,1,3,0,3
26610_0,,,,2,1,1,2
26611_0,,,,2,1,1,2
26612_0,,,,2,1,1,2
26613_0,,,,2,1,1,2
26614_0,,,,2,1,1,2
26615_0,,,,2,1,1,2
26616_0,,,,2,1,1,2
26618_0,,,,2,1,1,2
C(C(C=C)O)(CC(C(CO)=O)=O)=O,,,5,1,1,0,1
26619_0,,,,2,1,1,2
26620_0,,,,2,1,1,2
26621_0,,,,2,1,1,2
26622_0,,,,2,1,1,2
26623_0,,,,2,1,1,2
26624_0,,,,2,1,1,2
26625_0,,,,2,1,1,2
26627_0,,,,2,1,1,2
C(C(C)O)(CC(C(CO)=O)=O)=O,,,5,1,3,0,3
26628_0,,,,2,1,1,2
26629_0,,,,2,1,1,2
26630_0,,,,2,1,1,2
26631_0,,,,2,1,1,2
26632_0,,,,2,1,1,2
26634_0,,,,2,1,1,2
C(C(C(C(C)O)=O)(C(C)O)O)=O,,,5,1,3,0,3
26636_0,,,,2,1,1,2
C(C(CC(C=O)O)(C(C)O)O)=O,,,5,1,2,0,2
26638_0,,,,2,1,1,2
C(C(C(C(CO)O)=O)(C(C)O)O)=O,,,5,1,4,0,4
26640_0,,,,2,1,1,2
C(C(C(C(C=O)O)O)(C(C)O)O)=O,,,5,1,6,0,6
26642_0,,,,2,1,1,2
C(C(C(CO)=O)(C(C)O)O)=O,,,5,1,4,0,4
26644_0,,,,2,1,1,2
C(C(C)O)(C(C(C(C)O)=O)O)=O,,,5,1,1,0,1
26645_0,,,,2,1,1,2
26646_0,,,,2,1,1,2
26648_0,,,,2,1,1,2
C(C(CC(C(C(C)O)=O)O)O)=O,,,5,1,3,0,3
26649_0,,,,2,1,1,2
26650_0,,,,2,1,1,2
26652_0,,,,2,1,1,2
C(C(C(C)O)O)(CC(C(O)=O)=O)=O,,,5,1,1,0,1
26653_0,,,,2,1,1,2
26654_0,,,,2,1,1,2
26655_0,,,,2,1,1,2
26656_0,,,,2,1,1,2
26657_0,,,,2,1,1,2
26658_0,,,,2,1,1,2
26659_0,,,,2,1,1,2
26660_0,,,,2,1,1,2
26661_0,,,,2,1,1,2
26662_0,,,,2,1,1,2
26663_0,,,,2,1,1,2
26664_0,,,,2,1,1,2
26665_0,,,,2,1,1,2
26666_0,,,,2,1,1,2
26667_0,,,,2,1,1,2
26668_0,,,,2,1,1,2
26670_0,,,,2,1,1,2
C(C(C)O)(C(CO)(C)O)=O,,,5,1,1,0,1
26672_0,,,,2,1,1,2
C(C(CC(CO)(C)O)O)=O,,,5,1,1,0,1
26674_0,,,,2,1,1,2
C(C(CCO)O)(C(CO)(C)O)=O,,,5,1,1,0,1
26676_0,,,,2,1,1,2
C(C(C(CO)C(CO)(C)O)O)=O,,,5,1,3,0,3
26678_0,,,,2,1,1,2
C(CO)(C(CC(CO)(C)O)O)=O,,,5,1,1,0,1
26679_0,,,,2,1,1,2
26681_0,,,,2,1,1,2
C(CC(C(C(CO)(C)O)=O)O)(O)=O,,,5,1,1,0,1
26683_0,,,,2,1,1,2
C(C(C(CC(CO)(C)O)O)=O)(O)=O,,,5,1,1,0,1
26685_0,,,,2,1,1,2
C1(COC(C(CO)(C)O)C1O)=O,,,5,1,1,0,1
26687_0,,,,2,1,1,2
C1(C(C(CO1)C(CO)(C)O)O)=O,,,5,1,1,0,1
26689_0,,,,2,1,1,2
C(C(CO)O)(C(CO)(C)O)=O,,,5,1,3,0,3
26691_0,,,,2,1,1,2
C(C(C(C(CO)(C)O)O)O)=O,,,5,1,3,0,3
26693_0,,,,2,1,1,2
C(C(C(CO)O)O)(C(CO)(C)O)=O,,,5,1,3,0,3
26695_0,,,,2,1,1,2
C(CO)(C(C(C(CO)(C)O)O)O)=O,,,5,1,3,0,3
26696_0,,,,2,1,1,2
26697_0,,,,2,1,1,2
26698_0,,,,2,1,1,2
26699_0,,,,2,1,1,2
26701_0,,,,2,1,1,2
C(C(C(CC(CO)(C)O)O)=O)=O,,,5,1,2,0,2
26702_0,,,,2,1,1,2
26704_0,,,,2,1,1,2
C(C(C)O)(C(CO)(CCO)O)=O,,,5,1,1,0,1
26705_0,,,,2,1,1,2
26707_0,,,,2,1,1,2
C(C(C)O)(C(C)(C(CO)O)O)=O,,,5,1,1,0,1
26709_0,,,,2,1,1,2
C(C(C(C(C)O)=O)(C)O)(O)=O,,,5,1,1,0,1
26711_0,,,,2,1,1,2
C(CC(C(C(C)O)=O)O)(O)=O,,,5,1,3,0,3
26713_0,,,,2,1,1,2
C(C(C(C(C)O)=O)(CCO)O)(O)=O,,,5,1,1,0,1
26714_0,,,,2,1,1,2
26715_0,,,,2,1,1,2
26717_0,,,,2,1,1,2
C(C(CO)(CC(O)=O)O)(C(C)O)=O,,,5,1,1,0,1
26719_0,,,,2,1,1,2
C(C(C)(C(C(O)=O)O)O)(C(C)O)=O,,,5,1,1,0,1
26721_0,,,,2,1,1,2
C(C(C)O)(C1(COCC1O)O)=O,,,5,1,1,0,1
26723_0,,,,2,1,1,2
C(C(C)O)(C1(C(O)OCC1)O)=O,,,5,1,1,0,1
26725_0,,,,2,1,1,2
C(C(C)O)(C1(COC(C1)O)O)=O,,,5,1,1,0,1
26727_0,,,,2,1,1,2
C(C(C(C(C)O)=O)(C=C)O)=O,,,5,1,1,0,1
26729_0,,,,2,1,1,2
C(C(C(C)=O)O)(C(C=C)O)=O,,,5,1,1,0,1
26731_0,,,,2,1,1,2
C(C(C)O)(C(C(C=C)=O)O)=O,,,5,1,1,0,1
26733_0,,,,2,1,1,2
C(C(C)O)(C(C=CC=O)O)=O,,,5,1,1,0,1
26734_0,,,,2,1,1,2
26735_0,,,,2,1,1,2
26737_0,,,,2,1,1,2
C(C(C)O)(C(CO)(CO)O)=O,,,5,1,4,0,4
26739_0,,,,2,1,1,2
C(C(C)O)(C(CO)(C(CO)O)O)=O,,,5,1,6,0,6
26740_0,,,,2,1,1,2
26742_0,,,,2,1,1,2
C(C(C(C(C)O)=O)(C)O)=O,,,5,1,1,0,1
26743_0,,,,2,1,1,2
26745_0,,,,2,1,1,2
C(C(C(C(C)O)=O)(CCO)O)=O,,,5,1,2,0,2
26746_0,,,,2,1,1,2
26748_0,,,,2,1,1,2
C(CCO)(C(C(C(C)O)=O)O)=O,,,5,1,2,0,2
26749_0,,,,2,1,1,2
26750_0,,,,2,1,1,2
26751_0,,,,2,1,1,2
26752_0,,,,2,1,1,2
26753_0,,,,2,1,1,2
26754_0,,,,2,1,1,2
26755_0,,,,2,1,1,2
26757_0,,,,2,1,1,2
C(C(C)(C(C=O)O)O)(C(C)O)=O,,,5,1,1,0,1
26759_0,,,,2,1,1,2
C(C(C)O)(C(C)O)=O,,,5,1,1,0,1
26760_0,,,,2,1,1,2
26762_0,,,,2,1,1,2
C(C(CC(CO)(CCO)O)O)=O,,,5,1,2,0,2
26764_0,,,,2,1,1,2
C(C(CC(C(CCO)O)O)O)=O,,,5,1,1,0,1
26766_0,,,,2,1,1,2
C(C(CC(C)(C(CO)O)O)O)=O,,,5,1,1,0,1
26767_0,,,,2,1,1,2
26768_0,,,,2,1,1,2
26770_0,,,,2,1,1,2
C(C(CC(C=O)O)(CCO)O)(O)=O,,,5,1,1,0,1
26771_0,,,,2,1,1,2
26773_0,,,,2,1,1,2
C(CC(C(CC(C=O)O)O)O)(O)=O,,,5,1,1,0,1
26775_0,,,,2,1,1,2
C(CC(CO)(CC(C=O)O)O)(O)=O,,,5,1,2,0,2
26777_0,,,,2,1,1,2
C(C(C(C)(CC(C=O)O)O)O)(O)=O,,,5,1,1,0,1
26779_0,,,,2,1,1,2
C(C(CC1(COCC1O)O)O)=O,,,5,1,1,0,1
26781_0,,,,2,1,1,2
C(C(CC1(C(O)OCC1)O)O)=O,,,5,1,1,0,1
26783_0,,,,2,1,1,2
C(C(CC1(COC(C1)O)O)O)=O,,,5,1,2,0,2
26785_0,,,,2,1,1,2
C(C(C=C)(CC(C=O)O)O)=O,,,5,1,1,0,1
26787_0,,,,2,1,1,2
C(C(C=C)O)(CC(CO)=O)=O,,,5,1,1,0,1
26789_0,,,,2,1,1,2
C(C(CC(C(C=C)=O)O)O)=O,,,5,1,1,0,1
26791_0,,,,2,1,1,2
C(C(CC(C=CC=O)O)O)=O,,,5,1,1,0,1
26792_0,,,,2,1,1,2
26794_0,,,,2,1,1,2
C(C(CC(C(C(CO)O)O)O)O)=O,,,5,1,5,0,5
26796_0,,,,2,1,1,2
C(C(CC(CO)(CO)O)O)=O,,,5,1,3,0,3
26798_0,,,,2,1,1,2
C(C(CC(CO)(C(CO)O)O)O)=O,,,5,1,4,0,4
26799_0,,,,2,1,1,2
26801_0,,,,2,1,1,2
C(C(C)(CC(C=O)O)O)=O,,,5,1,1,0,1
26803_0,,,,2,1,1,2
C(C(C)O)(CC(CO)=O)=O,,,5,1,4,0,4
26805_0,,,,2,1,1,2
C(C(CC(C(C)=O)O)O)=O,,,5,1,3,0,3
26807_0,,,,2,1,1,2
C(C(CC(C=O)O)(CCO)O)=O,,,5,1,2,0,2
26809_0,,,,2,1,1,2
C(C(CCO)O)(CC(CO)=O)=O,,,5,1,4,0,4
26811_0,,,,2,1,1,2
C(C(CC(C=O)O)O)(CCO)=O,,,5,1,1,0,1
26812_0,,,,2,1,1,2
26813_0,,,,2,1,1,2
26815_0,,,,2,1,1,2
C(C(CC(CC(C=O)O)O)O)=O,,,5,1,1,0,1
26816_0,,,,2,1,1,2
26817_0,,,,2,1,1,2
26818_0,,,,2,1,1,2
26820_0,,,,2,1,1,2
C(C(CC(C)(C(C=O)O)O)O)=O,,,5,1,1,0,1
26821_0,,,,2,1,1,2
26822_0,,,,2,1,1,2
26824_0,,,,2,1,1,2
C(C(CO)O)(C(CO)(CCO)O)=O,,,5,1,3,0,3
26825_0,,,,2,1,1,2
26827_0,,,,2,1,1,2
C(CO)(C(CO)(CCO)O)=O,,,5,1,4,0,4
26829_0,,,,2,1,1,2
C(C(C(C(CCO)O)=O)(C)O)(O)=O,,,5,1,1,0,1
26830_0,,,,2,1,1,2
26832_0,,,,2,1,1,2
C(C(C(C(CCO)O)=O)(C=C)O)=O,,,5,1,1,0,1
26834_0,,,,2,1,1,2
C(C(C(CCO)=O)O)(C(C=C)O)=O,,,5,1,1,0,1
26836_0,,,,2,1,1,2
C(C(CCO)O)(C(C(C=C)=O)O)=O,,,5,1,1,0,1
26838_0,,,,2,1,1,2
C(C(CCO)O)(C(C=CC=O)O)=O,,,5,1,1,0,1
26839_0,,,,2,1,1,2
26841_0,,,,2,1,1,2
C(C(CCO)O)(C(CO)(CO)O)=O,,,5,1,3,0,3
26843_0,,,,2,1,1,2
C(C(C(C(CCO)O)=O)(C)O)=O,,,5,1,2,0,2
26844_0,,,,2,1,1,2
26845_0,,,,2,1,1,2
26846_0,,,,2,1,1,2
26847_0,,,,2,1,1,2
26849_0,,,,2,1,1,2
C(C(C)(C(CO)C(C=O)O)O)(O)=O,,,5,1,3,0,3
26851_0,,,,2,1,1,2
C(CC(C(CO)C(C=O)O)O)(O)=O,,,5,1,3,0,3
26853_0,,,,2,1,1,2
C(C(C=C)(C(CO)C(C=O)O)O)=O,,,5,1,2,0,2
26855_0,,,,2,1,1,2
C(C(C=C)O)(C(C(CO)=O)CO)=O,,,5,1,1,0,1
26857_0,,,,2,1,1,2
C(C(C(CO)C(C(C=C)=O)O)O)=O,,,5,1,2,0,2
26859_0,,,,2,1,1,2
C(C(C(CO)C(C=CC=O)O)O)=O,,,5,1,2,0,2
26860_0,,,,2,1,1,2
26861_0,,,,2,1,1,2
26862_0,,,,2,1,1,2
26863_0,,,,2,1,1,2
26864_0,,,,2,1,1,2
26866_0,,,,2,1,1,2
C(C(C)O)(C(C(CO)=O)CO)=O,,,5,1,3,0,3
26867_0,,,,2,1,1,2
26868_0,,,,2,1,1,2
26869_0,,,,2,1,1,2
26870_0,,,,2,1,1,2
26871_0,,,,2,1,1,2
26872_0,,,,2,1,1,2
26873_0,,,,2,1,1,2
26875_0,,,,2,1,1,2
C(C(CO)O)(C(C)(C(CO)O)O)=O,,,5,1,3,0,3
26876_0,,,,2,1,1,2
26878_0,,,,2,1,1,2
C(CO)(C(C)(C(CO)O)O)=O,,,5,1,5,0,5
26879_0,,,,2,1,1,2
26881_0,,,,2,1,1,2
C(CC(CC(C(CO)=O)O)O)(O)=O,,,5,1,1,0,1
26883_0,,,,2,1,1,2
C(C(C=C)(CC(C(CO)=O)O)O)=O,,,5,1,1,0,1
26885_0,,,,2,1,1,2
C(C(C=C)O)(CC(C(CO)O)=O)=O,,,5,1,1,0,1
26887_0,,,,2,1,1,2
C(CO)(C(CC(C(C=C)=O)O)O)=O,,,5,1,1,0,1
26889_0,,,,2,1,1,2
C(CO)(C(CC(C=CC=O)O)O)=O,,,5,1,1,0,1
26890_0,,,,2,1,1,2
26891_0,,,,2,1,1,2
26892_0,,,,2,1,1,2
26894_0,,,,2,1,1,2
C(C(CO)O)(CC(C(C)O)=O)=O,,,5,1,2,0,2
26895_0,,,,2,1,1,2
26896_0,,,,2,1,1,2
26897_0,,,,2,1,1,2
26898_0,,,,2,1,1,2
26899_0,,,,2,1,1,2
26901_0,,,,2,1,1,2
C(C(CC(C(C(O)=O)=O)O)O)(O)=O,,,5,1,1,0,1
26903_0,,,,2,1,1,2
C(C(C1C(C(CO1)=O)O)O)(O)=O,,,5,1,1,0,1
26905_0,,,,2,1,1,2
C1(C(C(CO1)C(C(O)=O)O)O)=O,,,5,1,1,0,1
26906_0,,,,2,1,1,2
26907_0,,,,2,1,1,2
26908_0,,,,2,1,1,2
26909_0,,,,2,1,1,2
26910_0,,,,2,1,1,2
26911_0,,,,2,1,1,2
26912_0,,,,2,1,1,2
26913_0,,,,2,1,1,2
26914_0,,,,2,1,1,2
26916_0,,,,2,1,1,2
C(C(C)(C1C(C(CO1)=O)O)O)(O)=O,,,5,1,1,0,1
26918_0,,,,2,1,1,2
C(C(C)(C1COC(C1O)=O)O)(O)=O,,,5,1,1,0,1
26920_0,,,,2,1,1,2
C(C(C(C(CO)O)=O)(C)O)(O)=O,,,5,1,3,0,3
26921_0,,,,2,1,1,2
26922_0,,,,2,1,1,2
26923_0,,,,2,1,1,2
26925_0,,,,2,1,1,2
C(CC(C(C(C(O)=O)(C)O)=O)O)=O,,,5,1,3,0,3
26926_0,,,,2,1,1,2
26928_0,,,,2,1,1,2
C(C(C)(CC(C(C=O)=O)O)O)(O)=O,,,5,1,2,0,2
26929_0,,,,2,1,1,2
26931_0,,,,2,1,1,2
C(CC(C(O)=O)=O)(C(C=C)O)=O,,,5,1,1,0,1
26932_0,,,,2,1,1,2
26934_0,,,,2,1,1,2
C(C(C)O)(CC(C(O)=O)=O)=O,,,5,1,3,0,3
26936_0,,,,2,1,1,2
C(C(CCO)O)(CC(C(O)=O)=O)=O,,,5,1,2,0,2
26937_0,,,,2,1,1,2
26938_0,,,,2,1,1,2
26939_0,,,,2,1,1,2
26940_0,,,,2,1,1,2
26942_0,,,,2,1,1,2
C(CC(C1C(C(CO1)=O)O)O)(O)=O,,,5,1,1,0,1
26944_0,,,,2,1,1,2
C(CC(C1COC(C1O)=O)O)(O)=O,,,5,1,1,0,1
26945_0,,,,2,1,1,2
26946_0,,,,2,1,1,2
26947_0,,,,2,1,1,2
26948_0,,,,2,1,1,2
26950_0,,,,2,1,1,2
C(CC(C(C(CC=O)O)=O)O)(O)=O,,,5,1,3,0,3
26951_0,,,,2,1,1,2
26953_0,,,,2,1,1,2
C(CC(CC(C(C=O)=O)O)O)(O)=O,,,5,1,2,0,2
26954_0,,,,2,1,1,2
26955_0,,,,2,1,1,2
26956_0,,,,2,1,1,2
26957_0,,,,2,1,1,2
26958_0,,,,2,1,1,2
26959_0,,,,2,1,1,2
26960_0,,,,2,1,1,2
26961_0,,,,2,1,1,2
26962_0,,,,2,1,1,2
26964_0,,,,2,1,1,2
C(C(C(CO)=O)(CCO)O)(O)=O,,,5,1,2,0,2
26966_0,,,,2,1,1,2
C(CO)(C(C(C(O)=O)=O)CO)=O,,,5,1,3,0,3
26968_0,,,,2,1,1,2
C(C(C)O)(C(C(C(O)=O)=O)CO)=O,,,5,1,2,0,2
26969_0,,,,2,1,1,2
26970_0,,,,2,1,1,2
26972_0,,,,2,1,1,2
C(CO)(C(CO)(CC(O)=O)O)=O,,,5,1,3,0,3
26973_0,,,,2,1,1,2
26974_0,,,,2,1,1,2
26975_0,,,,2,1,1,2
26977_0,,,,2,1,1,2
C(C(C)O)(C(C(O)=O)C(CO)=O)=O,,,5,1,2,0,2
26978_0,,,,2,1,1,2
26979_0,,,,2,1,1,2
26980_0,,,,2,1,1,2
26981_0,,,,2,1,1,2
26982_0,,,,2,1,1,2
26983_0,,,,2,1,1,2
26984_0,,,,2,1,1,2
26986_0,,,,2,1,1,2
C(CC(C(C(C=O)(C)O)=O)O)(O)=O,,,5,1,2,0,2
26988_0,,,,2,1,1,2
C(CC(C(C(C(C)O)=O)O)=O)(O)=O,,,5,1,2,0,2
26989_0,,,,2,1,1,2
26990_0,,,,2,1,1,2
26991_0,,,,2,1,1,2
26992_0,,,,2,1,1,2
26994_0,,,,2,1,1,2
C(C(CC(C(C(O)=O)=O)O)O)=O,,,5,1,2,0,2
26996_0,,,,2,1,1,2
C(C(C)(CC(C(C(O)=O)=O)O)O)=O,,,5,1,2,0,2
26998_0,,,,2,1,1,2
C(C(C(O)=O)O)(CC(C(C)O)=O)=O,,,5,1,2,0,2
27000_0,,,,2,1,1,2
C(C)(C(CC(C(C(O)=O)=O)O)O)=O,,,5,1,2,0,2
27002_0,,,,2,1,1,2
C(CC(CC(C(C(O)=O)=O)O)O)=O,,,5,1,2,0,2
27004_0,,,,2,1,1,2
C(C(C(CC(C)O)O)=O)(O)=O,,,5,1,2,0,2
27005_0,,,,2,1,1,2
27006_0,,,,2,1,1,2
27007_0,,,,2,1,1,2
27008_0,,,,2,1,1,2
27009_0,,,,2,1,1,2
27010_0,,,,2,1,1,2
27012_0,,,,2,1,1,2
C(C(C(CC(CO)=O)=O)(CO)O)=O,,,5,1,3,0,3
27013_0,,,,2,1,1,2
27014_0,,,,2,1,1,2
27015_0,,,,2,1,1,2
27017_0,,,,2,1,1,2
C(C(C(C(CC(C)O)O)=O)O)(O)=O,,,5,1,1,0,1
27018_0,,,,2,1,1,2
27019_0,,,,2,1,1,2
27021_0,,,,2,1,1,2
C(C(CC(C(CO)=O)(CO)O)O)=O,,,5,1,3,0,3
27022_0,,,,2,1,1,2
27023_0,,,,2,1,1,2
27025_0,,,,2,1,1,2
C(C(C(C(C=O)O)C(C=O)O)O)=O,,,5,1,1,0,1
27026_0,,,,2,1,1,2
27028_0,,,,2,1,1,2
C(C(C(C(C)O)C(C=O)O)O)=O,,,5,1,1,0,1
27029_0,,,,2,1,1,2
27031_0,,,,2,1,1,2
C(C(C(C(CO)O)C(C=O)O)O)=O,,,5,1,1,0,1
27032_0,,,,2,1,1,2
27033_0,,,,2,1,1,2
27034_0,,,,2,1,1,2
27035_0,,,,2,1,1,2
27036_0,,,,2,1,1,2
27037_0,,,,2,1,1,2
27038_0,,,,2,1,1,2
27039_0,,,,2,1,1,2
27041_0,,,,2,1,1,2
C(C(C(C)O)C(C(CO)=O)O)(O)=O,,,5,1,4,0,4
27043_0,,,,2,1,1,2
C(C(CO)C(C(CO)=O)O)(O)=O,,,5,1,5,0,5
27045_0,,,,2,1,1,2
C(C(C(C(CO)C(C)O)O)=O)(O)=O,,,5,1,1,0,1
27047_0,,,,2,1,1,2
C(C(C(C(CO)CO)O)=O)(O)=O,,,5,1,1,0,1
27049_0,,,,2,1,1,2
C(C(CO)O)(C1(COCC1O)O)=O,,,5,1,1,0,1
27051_0,,,,2,1,1,2
C(C(C(C1(COCC1O)O)O)O)=O,,,5,1,2,0,2
27053_0,,,,2,1,1,2
C(CO)(C1(COCC1O)O)=O,,,5,1,1,0,1
27055_0,,,,2,1,1,2
C(C(C=C)(C1C(C(CO1)=O)O)O)=O,,,5,1,1,0,1
27057_0,,,,2,1,1,2
C(C1C(C(CO1)O)=O)(C(C=C)O)=O,,,5,1,1,0,1
27059_0,,,,2,1,1,2
C1(COC(C1O)C(C(C=C)=O)O)=O,,,5,1,1,0,1
27061_0,,,,2,1,1,2
C1(COC(C1O)C(C=CC=O)O)=O,,,5,1,1,0,1
27063_0,,,,2,1,1,2
C1(COC(C(C(CO)O)O)C1O)=O,,,5,1,1,0,1
27065_0,,,,2,1,1,2
C1(C(COC1C(CO)=O)O)=O,,,5,1,1,0,1
27067_0,,,,2,1,1,2
C(C(C1C(C(CO1)=O)O)O)=O,,,5,1,1,0,1
27069_0,,,,2,1,1,2
C1(COC(C(CO)(CO)O)C1O)=O,,,5,1,1,0,1
27071_0,,,,2,1,1,2
C(C(C)(C1C(C(CO1)=O)O)O)=O,,,5,1,1,0,1
27073_0,,,,2,1,1,2
C1(C(COC1C(C(C)O)=O)O)=O,,,5,1,1,0,1
27075_0,,,,2,1,1,2
C(C)(C(C1C(C(CO1)=O)O)O)=O,,,5,1,1,0,1
27077_0,,,,2,1,1,2
C(CC(C1C(C(CO1)=O)O)O)=O,,,5,1,1,0,1
27079_0,,,,2,1,1,2
C1(COC(C(C)O)C1O)=O,,,5,1,1,0,1
27080_0,,,,2,1,1,2
27081_0,,,,2,1,1,2
27083_0,,,,2,1,1,2
C(C(CO)O)(C1(C(O)OCC1)O)=O,,,5,1,2,0,2
27085_0,,,,2,1,1,2
C(C(C(C1(C(O)OCC1)O)O)O)=O,,,5,1,3,0,3
27087_0,,,,2,1,1,2
C(CO)(C1(C(O)OCC1)O)=O,,,5,1,2,0,2
27089_0,,,,2,1,1,2
C(C(C=C)(C1COC(C1O)=O)O)=O,,,5,1,1,0,1
27091_0,,,,2,1,1,2
C(C(C=C)O)(C1C(C(O)OC1)=O)=O,,,5,1,1,0,1
27093_0,,,,2,1,1,2
C1(C(C(CO1)C(C(C=C)=O)O)O)=O,,,5,1,1,0,1
27095_0,,,,2,1,1,2
C1(C(C(CO1)C(C=CC=O)O)O)=O,,,5,1,1,0,1
27097_0,,,,2,1,1,2
C1(C(C(CO1)C(C(CO)O)O)O)=O,,,5,1,1,0,1
27099_0,,,,2,1,1,2
C(CO)(C1C(C(O)OC1)=O)=O,,,5,1,3,0,3
27101_0,,,,2,1,1,2
C1(C(C(CO1)C(C=O)O)O)=O,,,5,1,2,0,2
27103_0,,,,2,1,1,2
C1(C(C(CO1)C(CO)(CO)O)O)=O,,,5,1,1,0,1
27105_0,,,,2,1,1,2
C(C(C)(C1COC(C1O)=O)O)=O,,,5,1,2,0,2
27107_0,,,,2,1,1,2
C(C(C)O)(C1C(C(O)OC1)=O)=O,,,5,1,2,0,2
27109_0,,,,2,1,1,2
C1(C(C(CO1)C(C(C)=O)O)O)=O,,,5,1,2,0,2
27111_0,,,,2,1,1,2
C(CC(C1COC(C1O)=O)O)=O,,,5,1,2,0,2
27113_0,,,,2,1,1,2
C1(C(C(CO1)C(C)O)O)=O,,,5,1,2,0,2
27115_0,,,,2,1,1,2
C1(C(C(CO)CO1)O)=O,,,5,1,2,0,2
27117_0,,,,2,1,1,2
C1(C(C(CO1)C(CO)O)O)=O,,,5,1,2,0,2
27119_0,,,,2,1,1,2
C(C(CO)O)(C1(COC(C1)O)O)=O,,,5,1,2,0,2
27120_0,,,,2,1,1,2
27122_0,,,,2,1,1,2
C(CO)(C1(COC(C1)O)O)=O,,,5,1,2,0,2
27124_0,,,,2,1,1,2
C(C(C=C)O)(C1C(COC1O)=O)=O,,,5,1,1,0,1
27126_0,,,,2,1,1,2
C(CO)(C1C(COC1O)=O)=O,,,5,1,2,0,2
27128_0,,,,2,1,1,2
C(C(C)O)(C1C(COC1O)=O)=O,,,5,1,2,0,2
27130_0,,,,2,1,1,2
C(C1C(CC(O1)O)=O)(C(C=C)O)=O,,,5,1,1,0,1
27132_0,,,,2,1,1,2
C1(CC(OC1C(CO)=O)O)=O,,,5,1,2,0,2
27134_0,,,,2,1,1,2
C1(CC(OC1C(C(C)O)=O)O)=O,,,5,1,2,0,2
27136_0,,,,2,1,1,2
C(C(C(C(CO)O)=O)(C=C)O)=O,,,5,1,2,0,2
27138_0,,,,2,1,1,2
C(C(C=C)(C(C(C=O)O)O)O)=O,,,5,1,4,0,4
27139_0,,,,2,1,1,2
27140_0,,,,2,1,1,2
27142_0,,,,2,1,1,2
C(C(C(C(CC=O)O)=O)(C=C)O)=O,,,5,1,1,0,1
27143_0,,,,2,1,1,2
27145_0,,,,2,1,1,2
C(C(C=C)(CC(C(C=O)=O)O)O)=O,,,5,1,1,0,1
27147_0,,,,2,1,1,2
C(C(C(CO)=O)(C=C)O)=O,,,5,1,2,0,2
27149_0,,,,2,1,1,2
C(C(CO)O)(C(C(C=C)=O)O)=O,,,5,1,3,0,3
27150_0,,,,2,1,1,2
27152_0,,,,2,1,1,2
C(C(C(CO)=O)O)(C(C=C)O)=O,,,5,1,2,0,2
27154_0,,,,2,1,1,2
C(CC(C=O)=O)(C(C=C)O)=O,,,5,1,2,0,2
27156_0,,,,2,1,1,2
C(C(C=O)C(C(C=C)O)=O)=O,,,5,1,2,0,2
27158_0,,,,2,1,1,2
C(C(C=C)O)(C(C(C=O)=O)CO)=O,,,5,1,1,0,1
27159_0,,,,2,1,1,2
27160_0,,,,2,1,1,2
27161_0,,,,2,1,1,2
27163_0,,,,2,1,1,2
C(C(C(C(C=C)O)=O)C(CO)=O)=O,,,5,1,1,0,1
27165_0,,,,2,1,1,2
C(CC(C(C(C(C=C)=O)O)=O)O)=O,,,5,1,1,0,1
27167_0,,,,2,1,1,2
C(CC(C(C(C(C=C)O)=O)O)=O)=O,,,5,1,1,0,1
27168_0,,,,2,1,1,2
27170_0,,,,2,1,1,2
C=CC(C(CC(C(C=O)=O)O)O)=O,,,5,1,1,0,1
27172_0,,,,2,1,1,2
C(C(C(CC(C(C=C)O)=O)=O)O)=O,,,5,1,1,0,1
27173_0,,,,2,1,1,2
27175_0,,,,2,1,1,2
C(CO)(C(C(C=C)=O)O)=O,,,5,1,3,0,3
27177_0,,,,2,1,1,2
C(C(C(C(C=C)O)=O)O)=O,,,5,1,2,0,2
27178_0,,,,2,1,1,2
27179_0,,,,2,1,1,2
27180_0,,,,2,1,1,2
27181_0,,,,2,1,1,2
27183_0,,,,2,1,1,2
C(CC(C(C(C=CC=O)O)=O)O)=O,,,5,1,1,0,1
27184_0,,,,2,1,1,2
27186_0,,,,2,1,1,2
C(C(CC(C(C=O)=O)O)O)=CC=O,,,5,1,1,0,1
27187_0,,,,2,1,1,2
27188_0,,,,2,1,1,2
27189_0,,,,2,1,1,2
27190_0,,,,2,1,1,2
27191_0,,,,2,1,1,2
27192_0,,,,2,1,1,2
27193_0,,,,2,1,1,2
27194_0,,,,2,1,1,2
27195_0,,,,2,1,1,2
27196_0,,,,2,1,1,2
27197_0,,,,2,1,1,2
27198_0,,,,2,1,1,2
27199_0,,,,2,1,1,2
27200_0,,,,2,1,1,2
27201_0,,,,2,1,1,2
27202_0,,,,2,1,1,2
27203_0,,,,2,1,1,2
27204_0,,,,2,1,1,2
27205_0,,,,2,1,1,2
27206_0,,,,2,1,1,2
27207_0,,,,2,1,1,2
27208_0,,,,2,1,1,2
27209_0,,,,2,1,1,2
27210_0,,,,2,1,1,2
27211_0,,,,2,1,1,2
27212_0,,,,2,1,1,2
27213_0,,,,2,1,1,2
27214_0,,,,2,1,1,2
27215_0,,,,2,1,1,2
27216_0,,,,2,1,1,2
27217_0,,,,2,1,1,2
27218_0,,,,2,1,1,2
27219_0,,,,2,1,1,2
27220_0,,,,2,1,1,2
27221_0,,,,2,1,1,2
27222_0,,,,2,1,1,2
27223_0,,,,2,1,1,2
27224_0,,,,2,1,1,2
27225_0,,,,2,1,1,2
27226_0,,,,2,1,1,2
27227_0,,,,2,1,1,2
27228_0,,,,2,1,1,2
27229_0,,,,2,1,1,2
27230_0,,,,2,1,1,2
27231_0,,,,2,1,1,2
27232_0,,,,2,1,1,2
27233_0,,,,2,1,1,2
27234_0,,,,2,1,1,2
27235_0,,,,2,1,1,2
27236_0,,,,2,1,1,2
27237_0,,,,2,1,1,2
27238_0,,,,2,1,1,2
27239_0,,,,2,1,1,2
27240_0,,,,2,1,1,2
27241_0,,,,2,1,1,2
27242_0,,,,2,1,1,2
27243_0,,,,2,1,1,2
27244_0,,,,2,1,1,2
27245_0,,,,2,1,1,2
27246_0,,,,2,1,1,2
27247_0,,,,2,1,1,2
27248_0,,,,2,1,1,2
27249_0,,,,2,1,1,2
27250_0,,,,2,1,1,2
27251_0,,,,2,1,1,2
27252_0,,,,2,1,1,2
27253_0,,,,2,1,1,2
27254_0,,,,2,1,1,2
27255_0,,,,2,1,1,2
27256_0,,,,2,1,1,2
27257_0,,,,2,1,1,2
27258_0,,,,2,1,1,2
27259_0,,,,2,1,1,2
27260_0,,,,2,1,1,2
27261_0,,,,2,1,1,2
27262_0,,,,2,1,1,2
27263_0,,,,2,1,1,2
27264_0,,,,2,1,1,2
27265_0,,,,2,1,1,2
27266_0,,,,2,1,1,2
27267_0,,,,2,1,1,2
27268_0,,,,2,1,1,2
27269_0,,,,2,1,1,2
27270_0,,,,2,1,1,2
27271_0,,,,2,1,1,2
27272_0,,,,2,1,1,2
27273_0,,,,2,1,1,2
27274_0,,,,2,1,1,2
27275_0,,,,2,1,1,2
27276_0,,,,2,1,1,2
27277_0,,,,2,1,1,2
27278_0,,,,2,1,1,2
27279_0,,,,2,1,1,2
27280_0,,,,2,1,1,2
27281_0,,,,2,1,1,2
27282_0,,,,2,1,1,2
27283_0,,,,2,1,1,2
27284_0,,,,2,1,1,2
27285_0,,,,2,1,1,2
27286_0,,,,2,1,1,2
27287_0,,,,2,1,1,2
27288_0,,,,2,1,1,2
27289_0,,,,2,1,1,2
27290_0,,,,2,1,1,2
27292_0,,,,2,1,1,2
C(C(C(CO)O)=O)(C(CCO)O)=O,,,5,1,2,0,2
27293_0,,,,2,1,1,2
27294_0,,,,2,1,1,2
27295_0,,,,2,1,1,2
27296_0,,,,2,1,1,2
27297_0,,,,2,1,1,2
27298_0,,,,2,1,1,2
27299_0,,,,2,1,1,2
27300_0,,,,2,1,1,2
27301_0,,,,2,1,1,2
27302_0,,,,2,1,1,2
27303_0,,,,2,1,1,2
27304_0,,,,2,1,1,2
27305_0,,,,2,1,1,2
27306_0,,,,2,1,1,2
27307_0,,,,2,1,1,2
27308_0,,,,2,1,1,2
27309_0,,,,2,1,1,2
27310_0,,,,2,1,1,2
27311_0,,,,2,1,1,2
27312_0,,,,2,1,1,2
27313_0,,,,2,1,1,2
27314_0,,,,2,1,1,2
27315_0,,,,2,1,1,2
27316_0,,,,2,1,1,2
27317_0,,,,2,1,1,2
27318_0,,,,2,1,1,2
27319_0,,,,2,1,1,2
27320_0,,,,2,1,1,2
27321_0,,,,2,1,1,2
27322_0,,,,2,1,1,2
27323_0,,,,2,1,1,2
27324_0,,,,2,1,1,2
27325_0,,,,2,1,1,2
27326_0,,,,2,1,1,2
27327_0,,,,2,1,1,2
27328_0,,,,2,1,1,2
27329_0,,,,2,1,1,2
27330_0,,,,2,1,1,2
27331_0,,,,2,1,1,2
27332_0,,,,2,1,1,2
27333_0,,,,2,1,1,2
27334_0,,,,2,1,1,2
27335_0,,,,2,1,1,2
27336_0,,,,2,1,1,2
27337_0,,,,2,1,1,2
27338_0,,,,2,1,1,2
27340_0,,,,2,1,1,2
C(CC(C(C=O)=O)O)(C(C)O)=O,,,5,1,3,0,3
27341_0,,,,2,1,1,2
27342_0,,,,2,1,1,2
27343_0,,,,2,1,1,2
27344_0,,,,2,1,1,2
27345_0,,,,2,1,1,2
27346_0,,,,2,1,1,2
27347_0,,,,2,1,1,2
27348_0,,,,2,1,1,2
27349_0,,,,2,1,1,2
27350_0,,,,2,1,1,2
27351_0,,,,2,1,1,2
27352_0,,,,2,1,1,2
27353_0,,,,2,1,1,2
27354_0,,,,2,1,1,2
27355_0,,,,2,1,1,2
27356_0,,,,2,1,1,2
27357_0,,,,2,1,1,2
27358_0,,,,2,1,1,2
27359_0,,,,2,1,1,2
27360_0,,,,2,1,1,2
27361_0,,,,2,1,1,2
27362_0,,,,2,1,1,2
27363_0,,,,2,1,1,2
27364_0,,,,2,1,1,2
27365_0,,,,2,1,1,2
27366_0,,,,2,1,1,2
27367_0,,,,2,1,1,2
27368_0,,,,2,1,1,2
27369_0,,,,2,1,1,2
27370_0,,,,2,1,1,2
27371_0,,,,2,1,1,2
27372_0,,,,2,1,1,2
27373_0,,,,2,1,1,2
27374_0,,,,2,1,1,2
27375_0,,,,2,1,1,2
27376_0,,,,2,1,1,2
27377_0,,,,2,1,1,2
27378_0,,,,2,1,1,2
27379_0,,,,2,1,1,2
27380_0,,,,2,1,1,2
27381_0,,,,2,1,1,2
27382_0,,,,2,1,1,2
27383_0,,,,2,1,1,2
27384_0,,,,2,1,1,2
27385_0,,,,2,1,1,2
27386_0,,,,2,1,1,2
27387_0,,,,2,1,1,2
27388_0,,,,2,1,1,2
27389_0,,,,2,1,1,2
27390_0,,,,2,1,1,2
27391_0,,,,2,1,1,2
27392_0,,,,2,1,1,2
27393_0,,,,2,1,1,2
27394_0,,,,2,1,1,2
27395_0,,,,2,1,1,2
27396_0,,,,2,1,1,2
27397_0,,,,2,1,1,2
27398_0,,,,2,1,1,2
27399_0,,,,2,1,1,2
27400_0,,,,2,1,1,2
27401_0,,,,2,1,1,2
27402_0,,,,2,1,1,2
27403_0,,,,2,1,1,2
27404_0,,,,2,1,1,2
27405_0,,,,2,1,1,2
27406_0,,,,2,1,1,2
27407_0,,,,2,1,1,2
27408_0,,,,2,1,1,2
27409_0,,,,2,1,1,2
27410_0,,,,2,1,1,2
27411_0,,,,2,1,1,2
27412_0,,,,2,1,1,2
27413_0,,,,2,1,1,2
27414_0,,,,2,1,1,2
27415_0,,,,2,1,1,2
27416_0,,,,2,1,1,2
27418_0,,,,2,1,1,2
C(C(CO)C(C=O)O)(C(C)O)=O,,,5,1,3,0,3
27420_0,,,,2,1,1,2
C(C(C)O)(CCO)=O,,,5,1,2,0,2
27421_0,,,,2,1,1,2
27422_0,,,,2,1,1,2
27423_0,,,,2,1,1,2
27424_0,,,,2,1,1,2
27425_0,,,,2,1,1,2
27426_0,,,,2,1,1,2
27427_0,,,,2,1,1,2
27429_0,,,,2,1,1,2
C(CO)(C(C)(CCO)O)=O,,,5,1,2,0,2
27431_0,,,,2,1,1,2
C(C(C(CO)(C(CO)(C)O)O)O)=O,,,5,1,5,0,5
27433_0,,,,2,1,1,2
C(C(C(CO)(C(CCO)O)O)O)=O,,,5,1,5,0,5
27434_0,,,,2,1,1,2
27436_0,,,,2,1,1,2
C(CO)(C(C)(C(CO)(CO)O)O)=O,,,5,1,5,0,5
27438_0,,,,2,1,1,2
C(CO)(C(C(CO)CO)O)=O,,,5,1,2,0,2
27439_0,,,,2,1,1,2
27440_0,,,,2,1,1,2
27441_0,,,,2,1,1,2
27442_0,,,,2,1,1,2
27444_0,,,,2,1,1,2
C(C(C)O)(C(C(O)=O)C(C=O)O)=O,,,5,1,2,0,2
27446_0,,,,2,1,1,2
C(CC(C(C)O)=O)(O)=O,,,5,1,2,0,2
27447_0,,,,2,1,1,2
27448_0,,,,2,1,1,2
27449_0,,,,2,1,1,2
27450_0,,,,2,1,1,2
27451_0,,,,2,1,1,2
27452_0,,,,2,1,1,2
27454_0,,,,2,1,1,2
C(CO)(C(C)(CC(O)=O)O)=O,,,5,1,2,0,2
27455_0,,,,2,1,1,2
27456_0,,,,2,1,1,2
27457_0,,,,2,1,1,2
27459_0,,,,2,1,1,2
C(C(C(CO)=O)(C(C)=O)O)(O)=O,,,5,1,5,0,5
27461_0,,,,2,1,1,2
C(C(C)O)(C(C(O)=O)(C(C)=O)O)=O,,,5,1,2,0,2
27463_0,,,,2,1,1,2
C(C(C(CO)=O)(CC=O)O)(O)=O,,,5,1,4,0,4
27465_0,,,,2,1,1,2
C(C(C(CO)=O)(CC(O)=O)O)=O,,,5,1,2,0,2
27467_0,,,,2,1,1,2
C(C(C)O)(C(C(O)=O)(CC=O)O)=O,,,5,1,3,0,3
27469_0,,,,2,1,1,2
C(C(C)O)(C(C=O)(CC(O)=O)O)=O,,,5,1,2,0,2
27470_0,,,,2,1,1,2
27472_0,,,,2,1,1,2
C(C1(C(C(CC1O)O)=O)O)=O,,,5,1,3,0,3
27474_0,,,,2,1,1,2
C(C(C1(C(C(CC1O)O)O)O)O)=O,,,5,1,2,0,2
27475_0,,,,2,1,1,2
27477_0,,,,2,1,1,2
C(CO)(C(C(CO)=O)(C(C)O)O)=O,,,5,1,3,0,3
27479_0,,,,2,1,1,2
C(C(C=O)(C(CO)=O)C(C=O)O)=O,,,5,1,2,0,2
27481_0,,,,2,1,1,2
C(C(C=O)(C(CO)=O)C(C)O)=O,,,5,1,2,0,2
27483_0,,,,2,1,1,2
C(C(C=O)(C(CO)=O)CO)=O,,,5,1,2,0,2
27485_0,,,,2,1,1,2
C(C(C=O)(C(CO)=O)C(CO)O)=O,,,5,1,2,0,2
27487_0,,,,2,1,1,2
C(CO)(C(C(C=O)=O)(CO)CO)=O,,,5,1,2,0,2
27488_0,,,,2,1,1,2
27489_0,,,,2,1,1,2
27491_0,,,,2,1,1,2
C(C(C(CO)=O)(C(CO)=O)CO)=O,,,5,1,2,0,2
27493_0,,,,2,1,1,2
C(CC=O)(C(C(CO)=O)(CO)O)=O,,,5,1,3,0,3
27495_0,,,,2,1,1,2
C(C(C(CO)=O)(C(CCO)O)O)=O,,,5,1,4,0,4
27497_0,,,,2,1,1,2
C(C(C(CO)=O)(C(CO)(C)O)O)=O,,,5,1,3,0,3
27499_0,,,,2,1,1,2
C(C(C(CO)=O)(C(C(O)=O)O)O)=O,,,5,1,3,0,3
27501_0,,,,2,1,1,2
C(C(C(CO)=O)(C(C=O)O)O)=O,,,5,1,3,0,3
27503_0,,,,2,1,1,2
C(C(C)(C(C=O)(C(CO)=O)O)O)=O,,,5,1,3,0,3
27505_0,,,,2,1,1,2
C(C(C)O)(C(C=O)(C(C=O)O)O)=O,,,5,1,3,0,3
27507_0,,,,2,1,1,2
C(C(C(CO)=O)(C(C(C)=O)O)O)=O,,,5,1,3,0,3
27509_0,,,,2,1,1,2
C(CC(C(C=O)(C(CO)=O)O)O)=O,,,5,1,3,0,3
27511_0,,,,2,1,1,2
C(C(C(C(C)O)(C(C)O)O)O)=O,,,5,1,2,0,2
27512_0,,,,2,1,1,2
27514_0,,,,2,1,1,2
C(C(C=O)(C(C(C)O)=O)C(C)O)=O,,,5,1,2,0,2
27516_0,,,,2,1,1,2
C(C(C=O)(C(C(C)O)=O)CO)=O,,,5,1,2,0,2
27518_0,,,,2,1,1,2
C(C(C(C(CO)=O)(C(C)=O)O)O)=O,,,5,1,3,0,3
27520_0,,,,2,1,1,2
C(C)(C(C(CO)=O)(C(C)O)O)=O,,,5,1,4,0,4
27522_0,,,,2,1,1,2
C(C)(C(C(CO)=O)(C(CO)O)O)=O,,,5,1,3,0,3
27524_0,,,,2,1,1,2
C(C(C=O)(C(C(CO)O)=O)CO)=O,,,5,1,1,0,1
27526_0,,,,2,1,1,2
C(C(C=O)(CO)C(C(C=O)O)O)=O,,,5,1,2,0,2
27528_0,,,,2,1,1,2
C(C(C=O)(C(C(C=C)O)=O)CO)=O,,,5,1,1,0,1
27529_0,,,,2,1,1,2
27530_0,,,,2,1,1,2
27531_0,,,,2,1,1,2
27532_0,,,,2,1,1,2
27533_0,,,,2,1,1,2
27534_0,,,,2,1,1,2
27535_0,,,,2,1,1,2
27536_0,,,,2,1,1,2
27537_0,,,,2,1,1,2
27539_0,,,,2,1,1,2
C(C(C(C(C=C)O)=O)(C(C)O)O)=O,,,5,1,1,0,1
27540_0,,,,2,1,1,2
27542_0,,,,2,1,1,2
C(C(CO)O)(C1(C(COC1)=O)O)=O,,,5,1,1,0,1
27544_0,,,,2,1,1,2
C(C(C(C1(C(COC1)=O)O)O)O)=O,,,5,1,3,0,3
27546_0,,,,2,1,1,2
C1(C(C(C(CO)O)=O)C(CO1)O)=O,,,5,1,1,0,1
27548_0,,,,2,1,1,2
C1(C(C(C(C=O)O)O)C(CO1)O)=O,,,5,1,2,0,2
27549_0,,,,2,1,1,2
27550_0,,,,2,1,1,2
27551_0,,,,2,1,1,2
27552_0,,,,2,1,1,2
27553_0,,,,2,1,1,2
27555_0,,,,2,1,1,2
C(C(C)O)(C(C(C=O)=O)(CO)O)=O,,,5,1,1,0,1
27556_0,,,,2,1,1,2
27558_0,,,,2,1,1,2
C(C(C=C)O)(C(C(C)=O)(CO)O)=O,,,5,1,1,0,1
27559_0,,,,2,1,1,2
27561_0,,,,2,1,1,2
C(C(C(CO)=O)(C(C=O)O)O)(O)=O,,,5,1,5,0,5
27563_0,,,,2,1,1,2
C(C(C(CO)=O)(C(C)O)O)(O)=O,,,5,1,5,0,5
27565_0,,,,2,1,1,2
C(C(C(C(C)O)=O)(C(C)O)O)(O)=O,,,5,1,3,0,3
27567_0,,,,2,1,1,2
C(C(CO)(CO)O)(CC(CO)=O)=O,,,5,1,4,0,4
27569_0,,,,2,1,1,2
C(C(CO)(CO)C(C(CO)=O)O)=O,,,5,1,4,0,4
27571_0,,,,2,1,1,2
C(C(C=C)O)(C1(C(COC1)=O)O)=O,,,5,1,1,0,1
27573_0,,,,2,1,1,2
C(CO)(C1(C(COC1)=O)O)=O,,,5,1,2,0,2
27575_0,,,,2,1,1,2
C(C(C)O)(C1(C(COC1)=O)O)=O,,,5,1,1,0,1
27577_0,,,,2,1,1,2
C1(C(C(C(C=C)O)=O)C(CO1)O)=O,,,5,1,1,0,1
27579_0,,,,2,1,1,2
C1(C(C(CO)=O)C(CO1)O)=O,,,5,1,3,0,3
27581_0,,,,2,1,1,2
C1(C(C(C(C)O)=O)C(CO1)O)=O,,,5,1,1,0,1
27583_0,,,,2,1,1,2
C(C(C(C(C=C)O)=O)(CO)O)=O,,,5,1,2,0,2
27585_0,,,,2,1,1,2
C(C(C(C(C=C)O)=O)(CO)O)(O)=O,,,5,1,3,0,3
27587_0,,,,2,1,1,2
C(C(C(C(C=C)O)=O)(C(C)=O)O)=O,,,5,1,1,0,1
27589_0,,,,2,1,1,2
C1(C(C(CO)=O)(C(CO1)O)O)=O,,,5,1,2,0,2
27591_0,,,,2,1,1,2
C1(C(C(C(C)O)=O)(C(CO1)O)O)=O,,,5,1,1,0,1
27592_0,,,,2,1,1,2
27593_0,,,,2,1,1,2
27595_0,,,,2,1,1,2
C(C(C(CO)=O)(CC(C=O)=O)O)=O,,,5,1,1,0,1
27597_0,,,,2,1,1,2
C(C(C=O)C(C=O)(C(CO)=O)O)=O,,,5,1,1,0,1
27599_0,,,,2,1,1,2
C(CC(C(CO)=O)(C(C)=O)O)=O,,,5,1,1,0,1
27601_0,,,,2,1,1,2
C(C)(C(C(C(C)O)=O)(CC=O)O)=O,,,5,1,1,0,1
27603_0,,,,2,1,1,2
C(C(C)O)(CC(C(C(O)=O)O)O)=O,,,5,1,2,0,2
27604_0,,,,2,1,1,2
27606_0,,,,2,1,1,2
C(C(C(C(C(C)O)O)=O)(C)O)(O)=O,,,5,1,1,0,1
27607_0,,,,2,1,1,2
27609_0,,,,2,1,1,2
C(C(C(C(C=C)O)=O)(C)O)(O)=O,,,5,1,1,0,1
27610_0,,,,2,1,1,2
27611_0,,,,2,1,1,2
27612_0,,,,2,1,1,2
27613_0,,,,2,1,1,2
27615_0,,,,2,1,1,2
C(C(CO)O)(C(C(C=O)=O)(C)O)=O,,,5,1,1,0,1
27616_0,,,,2,1,1,2
27618_0,,,,2,1,1,2
C1(CCOC1(C(C(CO)O)=O)O)=O,,,5,1,1,0,1
27620_0,,,,2,1,1,2
C(C(C(C1(C(CCO1)=O)O)O)O)=O,,,5,1,2,0,2
27621_0,,,,2,1,1,2
27622_0,,,,2,1,1,2
27624_0,,,,2,1,1,2
C(C(C=C)O)(C(C(C=O)=O)(C)O)=O,,,5,1,1,0,1
27626_0,,,,2,1,1,2
C(C(C)O)(C(C(C=O)=O)(C)O)=O,,,5,1,1,0,1
27628_0,,,,2,1,1,2
C(C(C(C(C=C)O)=O)(CCO)O)=O,,,5,1,1,0,1
27630_0,,,,2,1,1,2
C(C(C(CO)=O)(CC(CO)=O)O)=O,,,5,1,1,0,1
27631_0,,,,2,1,1,2
27633_0,,,,2,1,1,2
C(C(CC(C=O)O)(C(C)O)O)(O)=O,,,5,1,2,0,2
27635_0,,,,2,1,1,2
C(C1(C(CCO1)=O)O)(C(C=C)O)=O,,,5,1,1,0,1
27637_0,,,,2,1,1,2
C1(CCOC1(C(CO)=O)O)=O,,,5,1,1,0,1
27639_0,,,,2,1,1,2
C1(CCOC1(C(C(C)O)=O)O)=O,,,5,1,1,0,1
27640_0,,,,2,1,1,2
27642_0,,,,2,1,1,2
C(C(C(C(C=C)O)=O)(CC=O)O)=O,,,5,1,1,0,1
27644_0,,,,2,1,1,2
C(CO)(OCC(CO)=O)=O,,,5,1,2,0,2
27646_0,,,,2,1,1,2
C(CO)(C(CO)OC(CO)=O)=O,,,5,1,2,0,2
27648_0,,,,2,1,1,2
C(CO)(C(COC(CO)=O)O)=O,,,5,1,2,0,2
27650_0,,,,2,1,1,2
C(CCC(C(C(CO)O)=O)O)=O,,,5,1,2,0,2
27651_0,,,,2,1,1,2
27652_0,,,,2,1,1,2
27653_0,,,,2,1,1,2
27654_0,,,,2,1,1,2
27655_0,,,,2,1,1,2
27656_0,,,,2,1,1,2
27657_0,,,,2,1,1,2
27659_0,,,,2,1,1,2
C(C(CO)CC(C(C=O)=O)O)=O,,,5,1,2,0,2
27661_0,,,,2,1,1,2
C(C(C(C(C=O)O)=O)C)=O,,,5,1,2,0,2
27662_0,,,,2,1,1,2
27663_0,,,,2,1,1,2
27664_0,,,,2,1,1,2
27665_0,,,,2,1,1,2
27667_0,,,,2,1,1,2
C(C(C(C(C=O)O)=O)CCO)=O,,,5,1,2,0,2
27668_0,,,,2,1,1,2
27669_0,,,,2,1,1,2
27670_0,,,,2,1,1,2
27671_0,,,,2,1,1,2
27673_0,,,,2,1,1,2
C(CCC(C(C(CO)=O)=O)O)=O,,,5,1,2,0,2
27674_0,,,,2,1,1,2
27675_0,,,,2,1,1,2
27676_0,,,,2,1,1,2
27677_0,,,,2,1,1,2
27678_0,,,,2,1,1,2
27680_0,,,,2,1,1,2
C(C(CC(CC(C=O)O)=O)O)=O,,,5,1,2,0,2
27681_0,,,,2,1,1,2
27683_0,,,,2,1,1,2
C(CCC(C=O)O)(C(C=O)O)=O,,,5,1,5,0,5
27684_0,,,,2,1,1,2
27685_0,,,,2,1,1,2
27686_0,,,,2,1,1,2
27687_0,,,,2,1,1,2
27688_0,,,,2,1,1,2
27689_0,,,,2,1,1,2
27690_0,,,,2,1,1,2
27691_0,,,,2,1,1,2
27693_0,,,,2,1,1,2
C(C)(CC(C(C(CO)=O)=O)O)=O,,,5,1,1,0,1
27694_0,,,,2,1,1,2
27695_0,,,,2,1,1,2
27696_0,,,,2,1,1,2
27697_0,,,,2,1,1,2
27699_0,,,,2,1,1,2
C(C(CC(C(C(C)=O)O)=O)O)=O,,,5,1,3,0,3
27701_0,,,,2,1,1,2
C(C(CO)O)(C(C(C=O)=O)C)=O,,,5,1,3,0,3
27702_0,,,,2,1,1,2
27704_0,,,,2,1,1,2
C(CO)(C(C(C(CO)=O)=O)C)=O,,,5,1,2,0,2
27706_0,,,,2,1,1,2
C(C(C)C(C=O)O)(C(C=O)O)=O,,,5,1,2,0,2
27707_0,,,,2,1,1,2
27709_0,,,,2,1,1,2
C(C(C(CC)=O)O)=O,,,5,1,2,0,2
27711_0,,,,2,1,1,2
C(C(C(CO)CC(C=O)=O)O)=O,,,5,1,5,0,5
27713_0,,,,2,1,1,2
C(C(C=O)C(CO)C(C=O)O)=O,,,5,1,4,0,4
27715_0,,,,2,1,1,2
C(CC(CO)C(C=O)O)=O,,,5,1,7,0,7
27717_0,,,,2,1,1,2
C(C(C(C(C(CO)=O)O)=O)C)=O,,,5,1,2,0,2
27718_0,,,,2,1,1,2
27719_0,,,,2,1,1,2
27720_0,,,,2,1,1,2
27721_0,,,,2,1,1,2
27723_0,,,,2,1,1,2
C(CO)(C(CC(C)=O)O)=O,,,5,1,2,0,2
27725_0,,,,2,1,1,2
C(CC)(C(C(CO)=O)O)=O,,,5,1,2,0,2
27726_0,,,,2,1,1,2
27727_0,,,,2,1,1,2
27728_0,,,,2,1,1,2
27730_0,,,,2,1,1,2
C(C(C=O)CC(C=O)O)=O,,,5,1,4,0,4
27732_0,,,,2,1,1,2
C(C(C=O)CC(C(CO)=O)O)=O,,,5,1,3,0,3
27733_0,,,,2,1,1,2
27734_0,,,,2,1,1,2
27735_0,,,,2,1,1,2
27736_0,,,,2,1,1,2
27738_0,,,,2,1,1,2
C(CCC(C(C=O)=O)O)=O,,,5,1,4,0,4
27739_0,,,,2,1,1,2
27741_0,,,,2,1,1,2
C(C(CC(C=O)C(C=O)O)O)=O,,,5,1,4,0,4
27742_0,,,,2,1,1,2
27743_0,,,,2,1,1,2
27744_0,,,,2,1,1,2
27745_0,,,,2,1,1,2
27747_0,,,,2,1,1,2
C(C(CC(C=O)C(CO)=O)O)=O,,,5,1,3,0,3
27748_0,,,,2,1,1,2
27749_0,,,,2,1,1,2
27750_0,,,,2,1,1,2
27751_0,,,,2,1,1,2
27752_0,,,,2,1,1,2
27753_0,,,,2,1,1,2
27754_0,,,,2,1,1,2
27755_0,,,,2,1,1,2
27756_0,,,,2,1,1,2
27757_0,,,,2,1,1,2
27758_0,,,,2,1,1,2
27759_0,,,,2,1,1,2
27761_0,,,,2,1,1,2
C(C)(CC(C(C=O)=O)O)=O,,,5,1,3,0,3
27763_0,,,,2,1,1,2
C(CO)(C(C(C=O)=O)C)=O,,,5,1,3,0,3
27764_0,,,,2,1,1,2
27765_0,,,,2,1,1,2
27767_0,,,,2,1,1,2
C(CO)(CCC(C(C=O)=O)O)=O,,,5,1,5,0,5
27768_0,,,,2,1,1,2
27770_0,,,,2,1,1,2
C(CC(C(C=O)=O)O)(CCO)=O,,,5,1,4,0,4
27772_0,,,,2,1,1,2
C(CCC(C=O)O)=O,,,5,1,4,0,4
27774_0,,,,2,1,1,2
C(CCC(C(CO)=O)O)=O,,,5,1,3,0,3
27775_0,,,,2,1,1,2
27776_0,,,,2,1,1,2
27778_0,,,,2,1,1,2
C(C)(C(CO)C(C=O)O)=O,,,5,1,4,0,4
27779_0,,,,2,1,1,2
27780_0,,,,2,1,1,2
27781_0,,,,2,1,1,2
27782_0,,,,2,1,1,2
27783_0,,,,2,1,1,2
27785_0,,,,2,1,1,2
C(C(CC(C=O)(C(C)=O)O)O)=O,,,5,1,2,0,2
27786_0,,,,2,1,1,2
27787_0,,,,2,1,1,2
27789_0,,,,2,1,1,2
C(C(C(C(C(C)O)=O)=O)CO)=O,,,5,1,2,0,2
27790_0,,,,2,1,1,2
27791_0,,,,2,1,1,2
27793_0,,,,2,1,1,2
C(CC(C(CC(O)=O)O)=O)=O,,,5,1,4,0,4
27795_0,,,,2,1,1,2
C(CCC(C(C(O)=O)=O)O)=O,,,5,1,3,0,3
27796_0,,,,2,1,1,2
27797_0,,,,2,1,1,2
27798_0,,,,2,1,1,2
27799_0,,,,2,1,1,2
27800_0,,,,2,1,1,2
27802_0,,,,2,1,1,2
C(CC(C(C(C)O)=O)=O)(O)=O,,,5,1,2,0,2
27804_0,,,,2,1,1,2
C(C)(CC(C(C(O)=O)=O)O)=O,,,5,1,2,0,2
27806_0,,,,2,1,1,2
C(CO)(C(C(C(O)=O)=O)C)=O,,,5,1,2,0,2
27807_0,,,,2,1,1,2
27809_0,,,,2,1,1,2
C1(C(CC(CO)O1)O)=O,,,5,1,2,0,2
27810_0,,,,2,1,1,2
27812_0,,,,2,1,1,2
C1(C(CC(C(CO)O)O1)O)=O,,,5,1,2,0,2
27813_0,,,,2,1,1,2
27815_0,,,,2,1,1,2
C1(C(COCC1O)O)=O,,,5,1,1,0,1
27817_0,,,,2,1,1,2
C1(C(CC(CO1)O)O)=O,,,5,1,2,0,2
27819_0,,,,2,1,1,2
C1(COC(CC1O)O)=O,,,5,1,2,0,2
27821_0,,,,2,1,1,2
C1(C(O)OCCC1O)=O,,,5,1,2,0,2
27823_0,,,,2,1,1,2
C1(C(C(CO)OCC1O)O)=O,,,5,1,1,0,1
27825_0,,,,2,1,1,2
C1(C(CC(C(CO)O1)O)O)=O,,,5,1,2,0,2
27827_0,,,,2,1,1,2
C1(C(CO)OC(CC1O)O)=O,,,5,1,2,0,2
27829_0,,,,2,1,1,2
C1(C(O)OC(CO)CC1O)=O,,,5,1,2,0,2
27831_0,,,,2,1,1,2
C1(COC(C(CO)C1O)O)=O,,,5,1,2,0,2
27833_0,,,,2,1,1,2
C1(C(C(COCC1O)O)O)=O,,,5,1,1,0,1
27835_0,,,,2,1,1,2
C1(C(CC(C(CO1)O)O)O)=O,,,5,1,2,0,2
27837_0,,,,2,1,1,2
C1(COC(C(CC1O)O)O)=O,,,5,1,2,0,2
27839_0,,,,2,1,1,2
C1(C(CCOC(C1O)O)O)=O,,,5,1,2,0,2
27841_0,,,,2,1,1,2
C1(C(CC(O)OCC1O)O)=O,,,5,1,3,0,3
27843_0,,,,2,1,1,2
C1(C(O)OCC(CC1O)O)=O,,,5,1,2,0,2
27845_0,,,,2,1,1,2
C1(CC(C(CO1)=O)O)=O,,,5,1,3,0,3
27847_0,,,,2,1,1,2
C1(C(C(CCO1)O)=O)=O,,,5,1,2,0,2
27849_0,,,,2,1,1,2
C1(CC(C(C(CO)O1)=O)O)=O,,,5,1,3,0,3
27851_0,,,,2,1,1,2
C1(C(C(CC(CO)O1)O)=O)=O,,,5,1,2,0,2
27853_0,,,,2,1,1,2
C1(C(CC(C(CO1)=O)O)O)=O,,,5,1,2,0,2
27855_0,,,,2,1,1,2
C1(C(C(C(CCO1)O)=O)O)=O,,,5,1,2,0,2
27857_0,,,,2,1,1,2
C1(CC(C(C(CO1)O)=O)O)=O,,,5,1,3,0,3
27859_0,,,,2,1,1,2
C1(C(C(CC(CO1)O)O)=O)=O,,,5,1,2,0,2
27861_0,,,,2,1,1,2
C=C(C(CO)=O)C(C=O)=O,,,5,1,2,0,2
27862_0,,,,2,1,1,2
27863_0,,,,2,1,1,2
27864_0,,,,2,1,1,2
27865_0,,,,2,1,1,2
27866_0,,,,2,1,1,2
27867_0,,,,2,1,1,2
27869_0,,,,2,1,1,2
C(CO)(CO)=CC(C(CO)=O)=O,,,5,1,2,0,2
27871_0,,,,2,1,1,2
C(C(C(C=O)=O)O)=C(CO)CO,,,5,1,2,0,2
27872_0,,,,2,1,1,2
27873_0,,,,2,1,1,2
27874_0,,,,2,1,1,2
27875_0,,,,2,1,1,2
27876_0,,,,2,1,1,2
27877_0,,,,2,1,1,2
27878_0,,,,2,1,1,2
27879_0,,,,2,1,1,2
27880_0,,,,2,1,1,2
27881_0,,,,2,1,1,2
27883_0,,,,2,1,1,2
C(C=CC(CO)=O)(C(CO)O)=O,,,5,1,3,0,3
27884_0,,,,2,1,1,2
27886_0,,,,2,1,1,2
C(C(CO)=CC=O)(C(CO)O)=O,,,5,1,3,0,3
27887_0,,,,2,1,1,2
27889_0,,,,2,1,1,2
C(CO)(C(C(C(CO)=O)=C)O)=O,,,5,1,3,0,3
27891_0,,,,2,1,1,2
C(C(C(C(C(CO)O)=O)=C)O)=O,,,5,1,3,0,3
27892_0,,,,2,1,1,2
27893_0,,,,2,1,1,2
27894_0,,,,2,1,1,2
27895_0,,,,2,1,1,2
27896_0,,,,2,1,1,2
27897_0,,,,2,1,1,2
27898_0,,,,2,1,1,2
27899_0,,,,2,1,1,2
27900_0,,,,2,1,1,2
27901_0,,,,2,1,1,2
27902_0,,,,2,1,1,2
27903_0,,,,2,1,1,2
27904_0,,,,2,1,1,2
27906_0,,,,2,1,1,2
C(CC(C(C(C=O)=C)=O)O)=O,,,5,1,3,0,3
27908_0,,,,2,1,1,2
C(C(C)=CC(C(CO)=O)=O)=O,,,5,1,2,0,2
27910_0,,,,2,1,1,2
C(C(C(C=O)=O)O)=C(C=O)C,,,5,1,2,0,2
27912_0,,,,2,1,1,2
C=C(C=O)CC(C(CO)=O)=O,,,5,1,2,0,2
27914_0,,,,2,1,1,2
C=C(C=O)CC(C(C=O)=O)O,,,5,1,2,0,2
27915_0,,,,2,1,1,2
27917_0,,,,2,1,1,2
C=C(C(C(C)O)=O)C(C=O)=O,,,5,1,2,0,2
27919_0,,,,2,1,1,2
C(C(C(C(C)O)=O)=CC=O)=O,,,5,1,3,0,3
27920_0,,,,2,1,1,2
27921_0,,,,2,1,1,2
27923_0,,,,2,1,1,2
C(C(C=CC(C)=O)=O)(CO)=O,,,5,1,2,0,2
27925_0,,,,2,1,1,2
C(C(C(C=O)=O)O)=CC(C)=O,,,5,1,2,0,2
27926_0,,,,2,1,1,2
27927_0,,,,2,1,1,2
27928_0,,,,2,1,1,2
27929_0,,,,2,1,1,2
27931_0,,,,2,1,1,2
C(C(C=CC(C(C)O)=O)=O)=O,,,5,1,2,0,2
27933_0,,,,2,1,1,2
C=C(C(CO)=O)CC(C=O)=O,,,5,1,3,0,3
27935_0,,,,2,1,1,2
C(C(C=C(C(CO)=O)C)=O)=O,,,5,1,2,0,2
27936_0,,,,2,1,1,2
27937_0,,,,2,1,1,2
27938_0,,,,2,1,1,2
27939_0,,,,2,1,1,2
27940_0,,,,2,1,1,2
27942_0,,,,2,1,1,2
C(CC=CC(C(CO)=O)=O)=O,,,5,1,2,0,2
27944_0,,,,2,1,1,2
C(CC=CC(C(C=O)=O)O)=O,,,5,1,2,0,2
27946_0,,,,2,1,1,2
C(CC(C(CO)=O)=O)=CC=O,,,5,1,4,0,4
27948_0,,,,2,1,1,2
C(CC(C(C=O)=O)O)=CC=O,,,5,1,2,0,2
27949_0,,,,2,1,1,2
27950_0,,,,2,1,1,2
27951_0,,,,2,1,1,2
27952_0,,,,2,1,1,2
27953_0,,,,2,1,1,2
27955_0,,,,2,1,1,2
C(C(C=O)=CC(C(C)O)=O)=O,,,5,1,2,0,2
27957_0,,,,2,1,1,2
C(C(C=O)C(C(CO)=O)=C)=O,,,5,1,3,0,3
27959_0,,,,2,1,1,2
C(C(C=O)=C(C(CO)=O)C)=O,,,5,1,2,0,2
27960_0,,,,2,1,1,2
27961_0,,,,2,1,1,2
27962_0,,,,2,1,1,2
27963_0,,,,2,1,1,2
27964_0,,,,2,1,1,2
27965_0,,,,2,1,1,2
27966_0,,,,2,1,1,2
27967_0,,,,2,1,1,2
27968_0,,,,2,1,1,2
27970_0,,,,2,1,1,2
C(C=CC(CO)=O)(CO)=O,,,5,1,2,0,2
27971_0,,,,2,1,1,2
27973_0,,,,2,1,1,2
C(C=C(C(CO)=O)CO)=O,,,5,1,6,0,6
27974_0,,,,2,1,1,2
27975_0,,,,2,1,1,2
27976_0,,,,2,1,1,2
27977_0,,,,2,1,1,2
27978_0,,,,2,1,1,2
27979_0,,,,2,1,1,2
27981_0,,,,2,1,1,2
C(C=CC(C(C)O)=O)=O,,,5,1,2,0,2
27983_0,,,,2,1,1,2
C(C=C(C(CO)=O)C)=O,,,5,1,2,0,2
27985_0,,,,2,1,1,2
C(CC(C(CO)=O)=C)=O,,,5,1,3,0,3
27987_0,,,,2,1,1,2
C(C(C(C(CO)=O)=C)O)=O,,,5,1,4,0,4
27989_0,,,,2,1,1,2
C=CCC(C(CO)=O)=O,,,5,1,2,0,2
27991_0,,,,2,1,1,2
C=CCC(C(C=O)=O)O,,,5,1,2,0,2
27993_0,,,,2,1,1,2
C(C)=CC(C(CO)=O)=O,,,5,1,2,0,2
27995_0,,,,2,1,1,2
C(C(C(C=O)=O)O)=CC,,,5,1,2,0,2
27997_0,,,,2,1,1,2
C(C(CO)O)=CC(C(CO)=O)=O,,,5,1,2,0,2
27999_0,,,,2,1,1,2
C(C(C(C=O)=O)O)=CC(CO)O,,,5,1,3,0,3
28000_0,,,,2,1,1,2
28002_0,,,,2,1,1,2
C=CC(C(C=O)=O)O,,,5,1,3,0,3
28004_0,,,,2,1,1,2
C(CO)=CC(C(CO)=O)=O,,,5,1,2,0,2
28006_0,,,,2,1,1,2
C(C(C(C=O)=O)O)=CCO,,,5,1,3,0,3
28007_0,,,,2,1,1,2
28008_0,,,,2,1,1,2
28009_0,,,,2,1,1,2
28010_0,,,,2,1,1,2
28011_0,,,,2,1,1,2
28012_0,,,,2,1,1,2
28014_0,,,,2,1,1,2
C(C(C(C(CO)=O)=C)(CO)O)=O,,,5,1,3,0,3
28015_0,,,,2,1,1,2
28016_0,,,,2,1,1,2
28018_0,,,,2,1,1,2
C(C(C(C(CO)=O)=C)O)(O)=O,,,5,1,3,0,3
28019_0,,,,2,1,1,2
28020_0,,,,2,1,1,2
28022_0,,,,2,1,1,2
C(C(C=C(C=O)CO)O)=O,,,5,1,3,0,3
28023_0,,,,2,1,1,2
28025_0,,,,2,1,1,2
C(C(C=CC(O)=O)O)=O,,,5,1,4,0,4
28027_0,,,,2,1,1,2
C=CC(C(C(O)=O)=O)O,,,5,1,2,0,2
28029_0,,,,2,1,1,2
C(CO)(C(C=CC(O)=O)O)=O,,,5,1,4,0,4
28031_0,,,,2,1,1,2
C(C(C(C(O)=O)=O)O)=CCO,,,5,1,2,0,2
28033_0,,,,2,1,1,2
C1(C(CC(C=O)O1)O)=O,,,5,1,3,0,3
28035_0,,,,2,1,1,2
C1(C(C(CO)C(C=O)O1)O)=O,,,5,1,2,0,2
28037_0,,,,2,1,1,2
C1(C(CC(CO)(CO)O1)O)=O,,,5,1,2,0,2
28039_0,,,,2,1,1,2
C1(C(C(CO)C(CO)(CO)O1)O)=O,,,5,1,1,0,1
28040_0,,,,2,1,1,2
28041_0,,,,2,1,1,2
28043_0,,,,2,1,1,2
C(CO)(C1(CC(CO)(CO1)O)O)=O,,,5,1,2,0,2
28044_0,,,,2,1,1,2
28045_0,,,,2,1,1,2
28046_0,,,,2,1,1,2
28048_0,,,,2,1,1,2
C(C1CC(C(O1)O)O)(C(CO)O)=O,,,5,1,2,0,2
28050_0,,,,2,1,1,2
C(C(C(C1CC(C(O)O1)O)O)O)=O,,,5,1,3,0,3
28052_0,,,,2,1,1,2
C(C(C1C(CC(CO)(O)O1)O)O)=O,,,5,1,2,0,2
28054_0,,,,2,1,1,2
C(C(C1C(CO)(CC(O)O1)O)O)=O,,,5,1,2,0,2
28056_0,,,,2,1,1,2
C(C(C1C(C(C(C)(O)O1)O)O)O)=O,,,5,1,2,0,2
28058_0,,,,2,1,1,2
C(C(C1C(C)(C(C(O)O1)O)O)O)=O,,,5,1,2,0,2
28060_0,,,,2,1,1,2
C1(C(CC(CO)(C(CO)O)O1)O)=O,,,5,1,1,0,1
28061_0,,,,2,1,1,2
28063_0,,,,2,1,1,2
C1(C(CC(C(CO)(CO)O)O1)O)=O,,,5,1,1,0,1
28065_0,,,,2,1,1,2
C(C1(C)CC(C(O1)=O)O)=O,,,5,1,2,0,2
28067_0,,,,2,1,1,2
C(C1(C)C(CO)C(C(O1)=O)O)=O,,,5,1,2,0,2
28069_0,,,,2,1,1,2
C1(C(CC(C(C)=O)O1)O)=O,,,5,1,2,0,2
28071_0,,,,2,1,1,2
C1(C(C(CO)C(C(C)=O)O1)O)=O,,,5,1,2,0,2
28073_0,,,,2,1,1,2
C(CC1CC(C(O1)=O)O)=O,,,5,1,2,0,2
28075_0,,,,2,1,1,2
C(C1(CC(C(O1)=O)O)CCO)=O,,,5,1,2,0,2
28077_0,,,,2,1,1,2
C1(C(CC(C(CCO)=O)O1)O)=O,,,5,1,2,0,2
28079_0,,,,2,1,1,2
C(CC(C1CC(C(O1)=O)O)O)=O,,,5,1,2,0,2
28080_0,,,,2,1,1,2
28082_0,,,,2,1,1,2
C1(C(CC(CC(C=O)O)O1)O)=O,,,5,1,2,0,2
28083_0,,,,2,1,1,2
28085_0,,,,2,1,1,2
C1(C(CC(CC(CO)=O)O1)O)=O,,,5,1,2,0,2
28087_0,,,,2,1,1,2
C(CC1(CO)CC(C(O1)=O)O)=O,,,5,1,2,0,2
28089_0,,,,2,1,1,2
C1(C(OC(C(C(C)O)=O)C1)O)=O,,,5,1,2,0,2
28091_0,,,,2,1,1,2
C1(C(CC(C(C(C)=O)O)O1)O)=O,,,5,1,2,0,2
28093_0,,,,2,1,1,2
C(CO)(C1(C)CC(C(O1)O)=O)=O,,,5,1,2,0,2
28095_0,,,,2,1,1,2
C1(C(CC(C)(C(C=O)O)O1)O)=O,,,5,1,2,0,2
28097_0,,,,2,1,1,2
C1(C(CC(C)O1)O)=O,,,5,1,2,0,2
28099_0,,,,2,1,1,2
C1(C(CC(C(C(CO)O)O)O1)O)=O,,,5,1,1,0,1
28101_0,,,,2,1,1,2
C(CC1C(CO)C(C(O1)=O)O)=O,,,5,1,2,0,2
28103_0,,,,2,1,1,2
C1(C(C(CO)C(C)O1)O)=O,,,5,1,2,0,2
28105_0,,,,2,1,1,2
C1(C(C(CO)C(C(CO)O)O1)O)=O,,,5,1,1,0,1
28107_0,,,,2,1,1,2
C1(C(C(CO)C(CO)O1)O)=O,,,5,1,2,0,2
28108_0,,,,2,1,1,2
28110_0,,,,2,1,1,2
C(CO)(C1CC(C(O1)O)O)=O,,,5,1,2,0,2
28111_0,,,,2,1,1,2
28112_0,,,,2,1,1,2
28113_0,,,,2,1,1,2
28115_0,,,,2,1,1,2
C(CO)(C1(CC(C(CO)O1)O)O)=O,,,5,1,2,0,2
28117_0,,,,2,1,1,2
C(CO)(C1(CC(CO1)O)O)=O,,,5,1,2,0,2
28118_0,,,,2,1,1,2
28119_0,,,,2,1,1,2
28120_0,,,,2,1,1,2
28122_0,,,,2,1,1,2
C1(C(CO)OC(C1O)O)=O,,,5,1,2,0,2
28123_0,,,,2,1,1,2
28125_0,,,,2,1,1,2
C1(C(C(CO)O)OC(C1O)O)=O,,,5,1,2,0,2
28127_0,,,,2,1,1,2
C(C(C1(COC(C1O)O)O)O)=O,,,5,1,4,0,4
28129_0,,,,2,1,1,2
C(CO)(C1(C(O)OCC1O)O)=O,,,5,1,2,0,2
28131_0,,,,2,1,1,2
C(C(C1(COC(C1(C)O)O)O)O)=O,,,5,1,3,0,3
28133_0,,,,2,1,1,2
C(C(C1(COC(C)(C1O)O)O)O)=O,,,5,1,3,0,3
28135_0,,,,2,1,1,2
C(C(C1(CO)C(CC(O)O1)O)O)=O,,,5,1,2,0,2
28137_0,,,,2,1,1,2
C(C(C)O)(C1(C(O)OCC1O)O)=O,,,5,1,2,0,2
28139_0,,,,2,1,1,2
C1(C(C(O)OCC1O)O)=O,,,5,1,3,0,3
28141_0,,,,2,1,1,2
C1(C(C(CO)OC(C1O)O)O)=O,,,5,1,3,0,3
28143_0,,,,2,1,1,2
C(C1C(C(CC(O1)O)O)=O)=O,,,5,1,2,0,2
28145_0,,,,2,1,1,2
C(C1CC(C(C(O1)O)=O)O)=O,,,5,1,2,0,2
28147_0,,,,2,1,1,2
C1(C(CC(CO)(CO1)O)O)=O,,,5,1,2,0,2
28149_0,,,,2,1,1,2
C1(C(C(CO)C(CO)(CO1)O)O)=O,,,5,1,1,0,1
28151_0,,,,2,1,1,2
C1(C(CC(OC1(CO)CO)O)O)=O,,,5,1,2,0,2
28153_0,,,,2,1,1,2
C1(C(O)OC(CO)(CO)CC1O)=O,,,5,1,2,0,2
28155_0,,,,2,1,1,2
C1(C(COC(C1(C)O)O)O)=O,,,5,1,2,0,2
28157_0,,,,2,1,1,2
C1(C(C(C)(O)OCC1O)O)=O,,,5,1,2,0,2
28159_0,,,,2,1,1,2
C1(C(COC(C1(CCO)O)O)O)=O,,,5,1,2,0,2
28161_0,,,,2,1,1,2
C1(C(C(CCO)(O)OCC1O)O)=O,,,5,1,2,0,2
28163_0,,,,2,1,1,2
C(C(C1C(C(CC(O)O1)O)O)O)=O,,,5,1,2,0,2
28165_0,,,,2,1,1,2
C(C(C1C(CC(C(O)O1)O)O)O)=O,,,5,1,2,0,2
28167_0,,,,2,1,1,2
C1(C(CC(CO1)(C(CO)O)O)O)=O,,,5,1,1,0,1
28169_0,,,,2,1,1,2
C1(C(CC(CO)(C(CO)O1)O)O)=O,,,5,1,1,0,1
28171_0,,,,2,1,1,2
C1(C(C(CO)OC(C1(C)O)O)O)=O,,,5,1,2,0,2
28173_0,,,,2,1,1,2
C1(C(C(CO)OC(C)(C1O)O)O)=O,,,5,1,2,0,2
28175_0,,,,2,1,1,2
C1(C(CC(C(CO)(CO)O1)O)O)=O,,,5,1,1,0,1
28177_0,,,,2,1,1,2
C(C1(C(C(CC(O1)O)O)=O)C)=O,,,5,1,2,0,2
28179_0,,,,2,1,1,2
C(C1(C)CC(C(C(O1)O)=O)O)=O,,,5,1,2,0,2
28181_0,,,,2,1,1,2
C1(C(CC(OC1C(C)=O)O)O)=O,,,5,1,2,0,2
28183_0,,,,2,1,1,2
C(C)(C1CC(C(C(O1)O)=O)O)=O,,,5,1,2,0,2
28185_0,,,,2,1,1,2
C(CC1C(CC(C(O1)=O)O)O)=O,,,5,1,2,0,2
28186_0,,,,2,1,1,2
28188_0,,,,2,1,1,2
C1(C(CC(C(C(C)=O)O1)O)O)=O,,,5,1,2,0,2
28190_0,,,,2,1,1,2
C1(C(CC(C)(C(C=O)O1)O)O)=O,,,5,1,2,0,2
28192_0,,,,2,1,1,2
C1(C(CC(C(C(CO)O)O1)O)O)=O,,,5,1,1,0,1
28194_0,,,,2,1,1,2
C(CC1C(C(CC(O1)O)O)=O)=O,,,5,1,2,0,2
28196_0,,,,2,1,1,2
C(CC1CC(C(C(O)O1)=O)O)=O,,,5,1,2,0,2
28198_0,,,,2,1,1,2
C1(C(C(CO)C(C(CO)O1)O)O)=O,,,5,1,1,0,1
28200_0,,,,2,1,1,2
C1(C(C(CO)C(CO1)O)O)=O,,,5,1,2,0,2
28201_0,,,,2,1,1,2
28202_0,,,,2,1,1,2
28204_0,,,,2,1,1,2
C1(C(C)OC(CC1O)O)=O,,,5,1,2,0,2
28206_0,,,,2,1,1,2
C1(C(C(CO)O)OC(CC1O)O)=O,,,5,1,2,0,2
28208_0,,,,2,1,1,2
C1(C(O)OC(C)CC1O)=O,,,5,1,2,0,2
28210_0,,,,2,1,1,2
C(CO)(C1(CC(C(CO1)O)O)O)=O,,,5,1,2,0,2
28212_0,,,,2,1,1,2
C1(C(O)OC(CC1O)C(CO)O)=O,,,5,1,2,0,2
28213_0,,,,2,1,1,2
28214_0,,,,2,1,1,2
28215_0,,,,2,1,1,2
28216_0,,,,2,1,1,2
28218_0,,,,2,1,1,2
C(C(C1(COC(CC1O)O)O)O)=O,,,5,1,3,0,3
28220_0,,,,2,1,1,2
C1(C(C(COC(C1O)O)O)O)=O,,,5,1,3,0,3
28222_0,,,,2,1,1,2
C1(COC(C(C(C1O)O)O)O)=O,,,5,1,2,0,2
28224_0,,,,2,1,1,2
C1(C(CC(O)OCC1(CO)O)O)=O,,,5,1,2,0,2
28226_0,,,,2,1,1,2
C1(C(O)OCC(CO)(CC1O)O)=O,,,5,1,2,0,2
28227_0,,,,2,1,1,2
28229_0,,,,2,1,1,2
C1(C(CCOC(CO)(C1O)O)O)=O,,,5,1,2,0,2
28231_0,,,,2,1,1,2
C1(C(CC(CO)(O)OCC1O)O)=O,,,5,1,2,0,2
28233_0,,,,2,1,1,2
C1(C(COC(CC1(CO)O)O)O)=O,,,5,1,2,0,2
28234_0,,,,2,1,1,2
28236_0,,,,2,1,1,2
C1(C(COC(C(C1(C)O)O)O)O)=O,,,5,1,2,0,2
28238_0,,,,2,1,1,2
C1(C(CC(CO)(C(CO1)O)O)O)=O,,,5,1,1,0,1
28240_0,,,,2,1,1,2
C1(C(C(COC(C1(C)O)O)O)O)=O,,,5,1,2,0,2
28242_0,,,,2,1,1,2
C1(COC(C(C)(C(C1O)O)O)O)=O,,,5,1,2,0,2
28244_0,,,,2,1,1,2
C1(C(C(COC(C)(C1O)O)O)O)=O,,,5,1,2,0,2
28245_0,,,,2,1,1,2
28247_0,,,,2,1,1,2
C1(C(CC(O)OC(CO)C1O)O)=O,,,5,1,3,0,3
28249_0,,,,2,1,1,2
C1(C(CC(C(CO)(CO1)O)O)O)=O,,,5,1,1,0,1
28251_0,,,,2,1,1,2
C(C1(CC(C(OCC1)=O)O)O)=O,,,5,1,2,0,2
28253_0,,,,2,1,1,2
C1(CC(C=O)(O)OCCC1O)=O,,,5,1,2,0,2
28255_0,,,,2,1,1,2
C1(C(CC(CC(C=O)O1)O)O)=O,,,5,1,2,0,2
28257_0,,,,2,1,1,2
C1(C(CC(C(C(CO)O1)O)O)O)=O,,,5,1,1,0,1
28259_0,,,,2,1,1,2
C(C1C(C(CCOC1O)O)=O)=O,,,5,1,2,0,2
28261_0,,,,2,1,1,2
C1(C(CCOC(C1)O)O)=O,,,5,1,2,0,2
28263_0,,,,2,1,1,2
C1(C(C(CO)C(C(CO1)O)O)O)=O,,,5,1,1,0,1
28264_0,,,,2,1,1,2
28266_0,,,,2,1,1,2
C1(C(O)OC(CO)C(CC1O)O)=O,,,5,1,2,0,2
28267_0,,,,2,1,1,2
28268_0,,,,2,1,1,2
28270_0,,,,2,1,1,2
C1(C(CCOC(C1(CO)O)O)O)=O,,,5,1,2,0,2
28272_0,,,,2,1,1,2
C(CO)(C(C)(CCC(C=O)=O)O)=O,,,5,1,3,0,3
28273_0,,,,2,1,1,2
28275_0,,,,2,1,1,2
C(CO)(C(CCCC(C=O)=O)O)=O,,,5,1,4,0,4
28277_0,,,,2,1,1,2
C(CO)(C(CC(C=O)CC=O)O)=O,,,5,1,5,0,5
28279_0,,,,2,1,1,2
C(C(C(CCC(C=O)=O)=O)O)=O,,,5,1,2,0,2
28281_0,,,,2,1,1,2
C(C(C(C(C=O)O)=O)CC=O)=O,,,5,1,1,0,1
28283_0,,,,2,1,1,2
C(CCC(C=O)=O)(C(C(C)=O)O)=O,,,5,1,1,0,1
28285_0,,,,2,1,1,2
C(C(C(C(C(C)=O)O)=O)CC=O)=O,,,5,1,1,0,1
28286_0,,,,2,1,1,2
28287_0,,,,2,1,1,2
28288_0,,,,2,1,1,2
28289_0,,,,2,1,1,2
28291_0,,,,2,1,1,2
C(CCC(C=O)=O)(C(C)O)=O,,,5,1,2,0,2
28293_0,,,,2,1,1,2
C(C(C)O)(C(C=O)CC=O)=O,,,5,1,1,0,1
28295_0,,,,2,1,1,2
C(C(CCCC(C=O)=O)O)=O,,,5,1,2,0,2
28297_0,,,,2,1,1,2
C(C(CC(C=O)CC=O)O)=O,,,5,1,4,0,4
28299_0,,,,2,1,1,2
C(CCC(C=O)=O)(C(CCO)O)=O,,,5,1,1,0,1
28301_0,,,,2,1,1,2
C(C(CCO)O)(C(C=O)CC=O)=O,,,5,1,1,0,1
28302_0,,,,2,1,1,2
28303_0,,,,2,1,1,2
28304_0,,,,2,1,1,2
28305_0,,,,2,1,1,2
28306_0,,,,2,1,1,2
28307_0,,,,2,1,1,2
28308_0,,,,2,1,1,2
28309_0,,,,2,1,1,2
28311_0,,,,2,1,1,2
C(C(CCC(C=O)=O)O)(C(C)O)=O,,,5,1,2,0,2
28312_0,,,,2,1,1,2
28313_0,,,,2,1,1,2
28314_0,,,,2,1,1,2
28315_0,,,,2,1,1,2
28316_0,,,,2,1,1,2
28317_0,,,,2,1,1,2
28318_0,,,,2,1,1,2
28320_0,,,,2,1,1,2
C1(C(CC(CCC(C=O)=O)O1)O)=O,,,5,1,2,0,2
28322_0,,,,2,1,1,2
C1(C(CC(C(C=O)CC=O)O1)O)=O,,,5,1,2,0,2
28324_0,,,,2,1,1,2
C1(C(C(CCC(C=O)=O)CO1)O)=O,,,5,1,2,0,2
28326_0,,,,2,1,1,2
C1(C(C(CO1)C(C=O)CC=O)O)=O,,,5,1,2,0,2
28327_0,,,,2,1,1,2
28328_0,,,,2,1,1,2
28329_0,,,,2,1,1,2
28330_0,,,,2,1,1,2
28331_0,,,,2,1,1,2
28333_0,,,,2,1,1,2
C(CC(C(CCC(C=O)=O)=O)O)=O,,,5,1,1,0,1
28334_0,,,,2,1,1,2
28335_0,,,,2,1,1,2
28336_0,,,,2,1,1,2
28337_0,,,,2,1,1,2
28338_0,,,,2,1,1,2
28339_0,,,,2,1,1,2
28340_0,,,,2,1,1,2
28341_0,,,,2,1,1,2
28342_0,,,,2,3,2,5
28344_0,,,,2,3,2,5
C(C1(C(C(C(C1CO)O)O)O)O)O,,,5,1,1,0,1
28345_0,,,,2,3,2,5
28346_0,,,,2,3,2,5
28347_0,,,,2,3,2,5
28348_0,,,,2,3,2,5
28349_0,,,,2,3,2,5
28350_0,,,,2,3,2,5
28351_0,,,,2,3,2,5
28352_0,,,,2,3,2,5
28353_0,,,,2,3,2,5
28354_0,,,,2,3,2,5
28355_0,,,,2,3,2,5
28356_0,,,,2,3,2,5
28358_0,,,,2,3,2,5
C(C1(CC(C(C1CO)O)O)O)=O,,,5,1,1,0,1
28359_0,,,,2,3,2,5
28360_0,,,,2,3,2,5
28361_0,,,,2,3,2,5
28362_0,,,,2,3,2,5
28363_0,,,,2,3,2,5
28364_0,,,,2,3,2,5
28365_0,,,,2,3,2,5
28367_0,,,,2,3,2,5
C(C1C(C(CC1O)O)O)O,,,5,1,1,0,1
28369_0,,,,2,3,2,5
C(C1C(C(C(C1O)O)O)O)O,,,5,1,1,0,1
28370_0,,,,2,3,2,5
28371_0,,,,2,3,2,5
28372_0,,,,2,3,2,5
28373_0,,,,2,3,2,5
28374_0,,,,2,3,2,5
28376_0,,,,2,3,2,5
C(C1(C(C(C(CO)C1O)O)O)O)O,,,5,1,1,0,1
28377_0,,,,2,3,2,5
28378_0,,,,2,3,2,5
28380_0,,,,2,3,2,5
C(C1(C(C(CO)C(C1)O)O)O)=O,,,5,1,2,0,2
28381_0,,,,2,3,2,5
28383_0,,,,2,3,2,5
C(C1(C(CC(C1CO)O)O)O)=O,,,5,1,2,0,2
28384_0,,,,2,3,2,5
28385_0,,,,2,3,2,5
28386_0,,,,2,3,2,5
28387_0,,,,2,3,2,5
28388_0,,,,2,3,2,5
28389_0,,,,2,3,2,5
28390_0,,,,2,3,2,5
28391_0,,,,2,3,2,5
28392_0,,,,2,3,2,5
28393_0,,,,2,3,2,5
28394_0,,,,2,3,2,5
28395_0,,,,2,3,2,5
28396_0,,,,2,3,2,5
28397_0,,,,2,3,2,5
28398_0,,,,2,3,2,5
28399_0,,,,2,3,2,5
28400_0,,,,2,3,2,5
28401_0,,,,2,3,2,5
28402_0,,,,2,3,2,5
28403_0,,,,2,3,2,5
28404_0,,,,2,3,2,5
28405_0,,,,2,3,2,5
28406_0,,,,2,3,2,5
28407_0,,,,2,3,2,5
28408_0,,,,2,3,2,5
28409_0,,,,2,3,2,5
28410_0,,,,2,3,2,5
28411_0,,,,2,3,2,5
28412_0,,,,2,3,2,5
28413_0,,,,2,3,2,5
28414_0,,,,2,3,2,5
28415_0,,,,2,3,2,5
28416_0,,,,2,3,2,5
28417_0,,,,2,3,2,5
28418_0,,,,2,3,2,5
28419_0,,,,2,3,2,5
28420_0,,,,2,3,2,5
28422_0,,,,2,3,2,5
C(C(CO)(CC(CCO)O)O)O,,,5,1,1,0,1
28424_0,,,,2,3,2,5
C(C(C(CC(CO)(CO)O)O)O)O,,,5,1,2,0,2
28426_0,,,,2,3,2,5
CC(C(CO)C(CO)(CO)O)O,,,5,1,1,0,1
28428_0,,,,2,3,2,5
C(C(CO)(C(CO)CO)O)O,,,5,1,1,0,1
28430_0,,,,2,3,2,5
C(C(CO)(C(CO)C(CO)O)O)O,,,5,1,2,0,2
28432_0,,,,2,3,2,5
C(C(CO)(C(C(CCO)O)O)O)O,,,5,1,3,0,3
28433_0,,,,2,3,2,5
28435_0,,,,2,3,2,5
CC(C(C(CO)(CCO)O)O)O,,,5,1,1,0,1
28437_0,,,,2,3,2,5
CC(C(C(CO)(C(CO)O)O)O)O,,,5,1,2,0,2
28439_0,,,,2,3,2,5
C(C(C(C(CO)(CCO)O)O)O)O,,,5,1,4,0,4
28441_0,,,,2,3,2,5
C(C(C(CO)O)(C(CO)CO)O)O,,,5,1,1,0,1
28443_0,,,,2,3,2,5
C(C(C(CCO)(C(CO)O)O)O)O,,,5,1,1,0,1
28445_0,,,,2,3,2,5
C(C(CO)(C(C(CO)CO)O)O)O,,,5,1,1,0,1
28447_0,,,,2,3,2,5
C(C(C)(CC(C=O)(CCO)O)O)=O,,,5,1,1,0,1
28448_0,,,,2,3,2,5
28449_0,,,,2,3,2,5
28450_0,,,,2,3,2,5
28451_0,,,,2,3,2,5
28452_0,,,,2,3,2,5
28453_0,,,,2,3,2,5
28454_0,,,,2,3,2,5
28455_0,,,,2,3,2,5
28456_0,,,,2,3,2,5
28457_0,,,,2,3,2,5
28458_0,,,,2,3,2,5
28459_0,,,,2,3,2,5
28460_0,,,,2,3,2,5
28462_0,,,,2,3,2,5
C(C(C)(CC(C(CO)CO)O)O)=O,,,5,1,1,0,1
28463_0,,,,2,3,2,5
28464_0,,,,2,3,2,5
28465_0,,,,2,3,2,5
28466_0,,,,2,3,2,5
28467_0,,,,2,3,2,5
28468_0,,,,2,3,2,5
28469_0,,,,2,3,2,5
28471_0,,,,2,3,2,5
C(C(C)(CC(CCO)O)O)=O,,,5,1,1,0,1
28472_0,,,,2,3,2,5
28474_0,,,,2,3,2,5
C(C(C)(CC(C(CO)O)O)O)=O,,,5,1,2,0,2
28475_0,,,,2,3,2,5
28477_0,,,,2,3,2,5
C(CC(C)(C(C(CO)CO)O)O)=O,,,5,1,1,0,1
28478_0,,,,2,3,2,5
28479_0,,,,2,3,2,5
28480_0,,,,2,3,2,5
28481_0,,,,2,3,2,5
28482_0,,,,2,3,2,5
28483_0,,,,2,3,2,5
28484_0,,,,2,3,2,5
28485_0,,,,2,3,2,5
28486_0,,,,2,3,2,5
28487_0,,,,2,3,2,5
28488_0,,,,2,3,2,5
28490_0,,,,2,3,2,5
C(C(C)(C(CO)C(CCO)O)O)=O,,,5,1,1,0,1
28491_0,,,,2,3,2,5
28493_0,,,,2,3,2,5
C(C(C)(C(CO)C(CO)(C)O)O)=O,,,5,1,1,0,1
28494_0,,,,2,3,2,5
28495_0,,,,2,3,2,5
28496_0,,,,2,3,2,5
28497_0,,,,2,3,2,5
28499_0,,,,2,3,2,5
C(C(C)(C(CO)C(C=O)(C)O)O)=O,,,5,1,1,0,1
28501_0,,,,2,3,2,5
C(C(C)(C(CO)C(C(C)=O)O)O)=O,,,5,1,1,0,1
28502_0,,,,2,3,2,5
28504_0,,,,2,3,2,5
C(C(C)(C(CO)C(C)O)O)=O,,,5,1,1,0,1
28505_0,,,,2,3,2,5
28507_0,,,,2,3,2,5
C(C(C)(C(CO)CO)O)=O,,,5,1,1,0,1
28508_0,,,,2,3,2,5
28510_0,,,,2,3,2,5
C(C(C)(C(CO)C(CO)O)O)=O,,,5,1,2,0,2
28511_0,,,,2,3,2,5
28513_0,,,,2,3,2,5
C(C(C)(C(C(CCO)O)O)O)=O,,,5,1,2,0,2
28514_0,,,,2,3,2,5
28516_0,,,,2,3,2,5
C(C(C)(C(C(C(CO)O)O)O)O)=O,,,5,1,5,0,5
28517_0,,,,2,3,2,5
28518_0,,,,2,3,2,5
28519_0,,,,2,3,2,5
28520_0,,,,2,3,2,5
28521_0,,,,2,3,2,5
28523_0,,,,2,3,2,5
C(C(CC(C(C)=O)O)(CCO)O)=O,,,5,1,1,0,1
28524_0,,,,2,3,2,5
28525_0,,,,2,3,2,5
28526_0,,,,2,3,2,5
28527_0,,,,2,3,2,5
28528_0,,,,2,3,2,5
28529_0,,,,2,3,2,5
28530_0,,,,2,3,2,5
28532_0,,,,2,3,2,5
C(C)(C(CC(C(CO)CO)O)O)=O,,,5,1,1,0,1
28533_0,,,,2,3,2,5
28534_0,,,,2,3,2,5
28536_0,,,,2,3,2,5
C(C)(C(CC(CCO)O)O)=O,,,5,1,1,0,1
28538_0,,,,2,3,2,5
C(C)(C(CC(C(CO)O)O)O)=O,,,5,1,2,0,2
28540_0,,,,2,3,2,5
C(CC(C(C)(C(CO)CO)O)O)=O,,,5,1,1,0,1
28541_0,,,,2,3,2,5
28542_0,,,,2,3,2,5
28543_0,,,,2,3,2,5
28545_0,,,,2,3,2,5
C(C)(C(C(CO)C(CCO)O)O)=O,,,5,1,1,0,1
28547_0,,,,2,3,2,5
C(C)(C(C(CO)C(CO)(C)O)O)=O,,,5,1,1,0,1
28548_0,,,,2,3,2,5
28550_0,,,,2,3,2,5
C(C)(C(C(CO)C(C(C)=O)O)O)=O,,,5,1,1,0,1
28552_0,,,,2,3,2,5
C(C)(C(C(CO)C(C)O)O)=O,,,5,1,1,0,1
28554_0,,,,2,3,2,5
C(C)(C(C(CO)CO)O)=O,,,5,1,1,0,1
28556_0,,,,2,3,2,5
C(C)(C(C(CO)C(CO)O)O)=O,,,5,1,2,0,2
28557_0,,,,2,3,2,5
28558_0,,,,2,3,2,5
28559_0,,,,2,3,2,5
28560_0,,,,2,3,2,5
28561_0,,,,2,3,2,5
28562_0,,,,2,3,2,5
28563_0,,,,2,3,2,5
28564_0,,,,2,3,2,5
28565_0,,,,2,3,2,5
28566_0,,,,2,3,2,5
28567_0,,,,2,3,2,5
28568_0,,,,2,3,2,5
28569_0,,,,2,3,2,5
28570_0,,,,2,3,2,5
28571_0,,,,2,3,2,5
28572_0,,,,2,3,2,5
28573_0,,,,2,3,2,5
28574_0,,,,2,3,2,5
28575_0,,,,2,3,2,5
28576_0,,,,2,3,2,5
28577_0,,,,2,3,2,5
28579_0,,,,2,3,2,5
C(C(CC(C)O)(C(CO)CO)O)=O,,,5,1,1,0,1
28580_0,,,,2,3,2,5
28581_0,,,,2,3,2,5
28582_0,,,,2,3,2,5
28583_0,,,,2,3,2,5
28584_0,,,,2,3,2,5
28585_0,,,,2,3,2,5
28586_0,,,,2,3,2,5
28588_0,,,,2,3,2,5
C(C(CCO)(CC(C)O)O)=O,,,5,1,1,0,1
28589_0,,,,2,3,2,5
28591_0,,,,2,3,2,5
C(C(C(CO)O)(CC(C)O)O)=O,,,5,1,2,0,2
28592_0,,,,2,3,2,5
28594_0,,,,2,3,2,5
C(C(C(CO)CO)O)(CC(C)O)=O,,,5,1,1,0,1
28595_0,,,,2,3,2,5
28596_0,,,,2,3,2,5
28597_0,,,,2,3,2,5
28598_0,,,,2,3,2,5
28599_0,,,,2,3,2,5
28601_0,,,,2,3,2,5
C(C(CCO)(CC(CO)O)O)=O,,,5,1,1,0,1
28602_0,,,,2,3,2,5
28604_0,,,,2,3,2,5
C(C(C(CO)O)(CC(CO)O)O)=O,,,5,1,2,0,2
28605_0,,,,2,3,2,5
28606_0,,,,2,3,2,5
28607_0,,,,2,3,2,5
28608_0,,,,2,3,2,5
28609_0,,,,2,3,2,5
28610_0,,,,2,3,2,5
28611_0,,,,2,3,2,5
28612_0,,,,2,3,2,5
28613_0,,,,2,3,2,5
28614_0,,,,2,3,2,5
28616_0,,,,2,3,2,5
C(CC(CC(C(CO)CO)O)O)=O,,,5,1,1,0,1
28617_0,,,,2,3,2,5
28618_0,,,,2,3,2,5
28619_0,,,,2,3,2,5
28620_0,,,,2,3,2,5
28621_0,,,,2,3,2,5
28622_0,,,,2,3,2,5
28623_0,,,,2,3,2,5
28624_0,,,,2,3,2,5
28625_0,,,,2,3,2,5
28626_0,,,,2,3,2,5
28627_0,,,,2,3,2,5
28628_0,,,,2,3,2,5
28629_0,,,,2,3,2,5
28630_0,,,,2,3,2,5
28631_0,,,,2,3,2,5
28632_0,,,,2,3,2,5
28633_0,,,,2,3,2,5
28634_0,,,,2,3,2,5
28635_0,,,,2,3,2,5
28636_0,,,,2,3,2,5
28637_0,,,,2,3,2,5
28638_0,,,,2,3,2,5
28639_0,,,,2,3,2,5
28640_0,,,,2,3,2,5
28641_0,,,,2,3,2,5
28642_0,,,,2,3,2,5
28643_0,,,,2,3,2,5
28644_0,,,,2,3,2,5
28645_0,,,,2,3,2,5
28646_0,,,,2,3,2,5
28647_0,,,,2,3,2,5
28648_0,,,,2,3,2,5
28649_0,,,,2,3,2,5
28650_0,,,,2,3,2,5
28651_0,,,,2,3,2,5
28652_0,,,,2,3,2,5
28653_0,,,,2,3,2,5
28654_0,,,,2,3,2,5
28655_0,,,,2,3,2,5
28656_0,,,,2,3,2,5
28658_0,,,,2,3,2,5
C(C(CCO)(CC(CCO)O)O)=O,,,5,1,1,0,1
28659_0,,,,2,3,2,5
28660_0,,,,2,3,2,5
28661_0,,,,2,3,2,5
28663_0,,,,2,3,2,5
C(C(CCO)(C(CO)C(C)O)O)=O,,,5,1,2,0,2
28664_0,,,,2,3,2,5
28666_0,,,,2,3,2,5
C(C(CCO)(C(CO)CO)O)=O,,,5,1,2,0,2
28667_0,,,,2,3,2,5
28669_0,,,,2,3,2,5
C(C(CC(CCO)O)O)(CCO)=O,,,5,1,1,0,1
28671_0,,,,2,3,2,5
C(C(C(CO)C(C)O)O)(CCO)=O,,,5,1,1,0,1
28673_0,,,,2,3,2,5
C(C(C(CO)CO)O)(CCO)=O,,,5,1,1,0,1
28674_0,,,,2,3,2,5
28675_0,,,,2,3,2,5
28676_0,,,,2,3,2,5
28677_0,,,,2,3,2,5
28678_0,,,,2,3,2,5
28679_0,,,,2,3,2,5
28680_0,,,,2,3,2,5
28682_0,,,,2,3,2,5
C(C(C(CO)O)(C(CO)CO)O)=O,,,5,1,4,0,4
28683_0,,,,2,3,2,5
28684_0,,,,2,3,2,5
28685_0,,,,2,3,2,5
28686_0,,,,2,3,2,5
28687_0,,,,2,3,2,5
28688_0,,,,2,3,2,5
28689_0,,,,2,3,2,5
28691_0,,,,2,3,2,5
C(C(CC(CC(CCO)O)O)O)=O,,,5,1,1,0,1
28692_0,,,,2,3,2,5
28694_0,,,,2,3,2,5
C(C(CC(C(CO)C(C)O)O)O)=O,,,5,1,1,0,1
28695_0,,,,2,3,2,5
28697_0,,,,2,3,2,5
C(C(CC(C(CO)CO)O)O)=O,,,5,1,1,0,1
28698_0,,,,2,3,2,5
28700_0,,,,2,3,2,5
C(C(C(C(CCO)O)C(C)O)O)=O,,,5,1,1,0,1
28701_0,,,,2,3,2,5
28702_0,,,,2,3,2,5
28703_0,,,,2,3,2,5
28704_0,,,,2,3,2,5
28705_0,,,,2,3,2,5
28706_0,,,,2,3,2,5
28707_0,,,,2,3,2,5
28708_0,,,,2,3,2,5
28709_0,,,,2,3,2,5
28710_0,,,,2,3,2,5
28711_0,,,,2,3,2,5
28712_0,,,,2,3,2,5
28713_0,,,,2,3,2,5
28714_0,,,,2,3,2,5
28715_0,,,,2,3,2,5
28716_0,,,,2,3,2,5
28717_0,,,,2,3,2,5
28718_0,,,,2,3,2,5
28719_0,,,,2,3,2,5
28720_0,,,,2,3,2,5
28721_0,,,,2,3,2,5
28722_0,,,,2,3,2,5
28723_0,,,,2,3,2,5
28724_0,,,,2,3,2,5
28725_0,,,,2,3,2,5
28726_0,,,,2,3,2,5
28727_0,,,,2,3,2,5
28728_0,,,,2,3,2,5
28729_0,,,,2,3,2,5
28730_0,,,,2,3,2,5
28731_0,,,,2,3,2,5
28732_0,,,,2,3,2,5
28733_0,,,,2,3,2,5
28735_0,,,,2,3,2,5
C(C(C(C)(CC(CCO)O)O)O)=O,,,5,1,1,0,1
28736_0,,,,2,3,2,5
28738_0,,,,2,3,2,5
C(C(C(C)(C(CO)C(C)O)O)O)=O,,,5,1,1,0,1
28739_0,,,,2,3,2,5
28741_0,,,,2,3,2,5
C(C(C(C)(C(CO)CO)O)O)=O,,,5,1,1,0,1
28742_0,,,,2,3,2,5
28744_0,,,,2,3,2,5
C(C(C(CC(C)O)(CCO)O)O)=O,,,5,1,1,0,1
28745_0,,,,2,3,2,5
28746_0,,,,2,3,2,5
28747_0,,,,2,3,2,5
28749_0,,,,2,3,2,5
C(C(C(CCO)(CCO)O)O)=O,,,5,1,1,0,1
28750_0,,,,2,3,2,5
28751_0,,,,2,3,2,5
28752_0,,,,2,3,2,5
28753_0,,,,2,3,2,5
28755_0,,,,2,3,2,5
CC(CC(C(CO)C(C)O)O)O,,,5,1,1,0,1
28757_0,,,,2,3,2,5
CC(CC(C(CO)CO)O)O,,,5,1,1,0,1
28759_0,,,,2,3,2,5
CC(CC(C(CO)C(CO)O)O)O,,,5,1,1,0,1
28760_0,,,,2,3,2,5
28762_0,,,,2,3,2,5
C(C(CO)C(CC(C)O)O)(O)=O,,,5,1,3,0,3
28763_0,,,,2,3,2,5
28764_0,,,,2,3,2,5
28765_0,,,,2,3,2,5
28766_0,,,,2,3,2,5
28767_0,,,,2,3,2,5
28768_0,,,,2,3,2,5
28769_0,,,,2,3,2,5
28770_0,,,,2,3,2,5
28772_0,,,,2,3,2,5
CC(CC(CCO)O)O,,,5,1,1,0,1
28774_0,,,,2,3,2,5
CC(CC(C(CO)O)O)O,,,5,1,2,0,2
28776_0,,,,2,3,2,5
CC(C(CO)C(C(C(C)O)O)O)O,,,5,1,1,0,1
28778_0,,,,2,3,2,5
CC(C(CO)C(CCO)O)O,,,5,1,1,0,1
28780_0,,,,2,3,2,5
CC(C(CO)C(CC(CO)O)O)O,,,5,1,1,0,1
28781_0,,,,2,3,2,5
28783_0,,,,2,3,2,5
C(C(CO)(C(CO)C(C)O)O)=O,,,5,1,2,0,2
28785_0,,,,2,3,2,5
C(CO)(C(C(CO)C(C)O)O)=O,,,5,1,1,0,1
28787_0,,,,2,3,2,5
C(C)(C(CO)(C(CO)C(C)O)O)=O,,,5,1,1,0,1
28789_0,,,,2,3,2,5
C(CO)(C(C)(C(CO)C(C)O)O)=O,,,5,1,1,0,1
28790_0,,,,2,3,2,5
28792_0,,,,2,3,2,5
C(C(C(C)O)(C(CO)C(C)O)O)=O,,,5,1,2,0,2
28794_0,,,,2,3,2,5
C(C(C(CO)C(C)O)O)(C(C)O)=O,,,5,1,1,0,1
28796_0,,,,2,3,2,5
CC(CO)(C(CO)C(C)O)O,,,5,1,1,0,1
28798_0,,,,2,3,2,5
CC(C(CO)C(CO)(CCO)O)O,,,5,1,1,0,1
28800_0,,,,2,3,2,5
CC(C(CO)C(C(CCO)O)O)O,,,5,1,1,0,1
28802_0,,,,2,3,2,5
CC(C(CO)O)(C(CO)C(C)O)O,,,5,1,1,0,1
28803_0,,,,2,3,2,5
28805_0,,,,2,3,2,5
C(C(C)(C(CO)C(C)O)O)(O)=O,,,5,1,1,0,1
28807_0,,,,2,3,2,5
C(CC(C(CO)C(C)O)O)(O)=O,,,5,1,1,0,1
28809_0,,,,2,3,2,5
C1C(C(CO1)O)(C(CO)C(C)O)O,,,5,1,1,0,1
28811_0,,,,2,3,2,5
CC(C(CO)C1(C(O)OCC1)O)O,,,5,1,1,0,1
28813_0,,,,2,3,2,5
C1C(CC(O)O1)(C(CO)C(C)O)O,,,5,1,1,0,1
28814_0,,,,2,3,2,5
28816_0,,,,2,3,2,5
C(C(C=C)(C(CO)C(C)O)O)=O,,,5,1,1,0,1
28818_0,,,,2,3,2,5
C=CC(C(C(CO)C(C)O)O)=O,,,5,1,1,0,1
28819_0,,,,2,3,2,5
28821_0,,,,2,3,2,5
C(C(C(CO)C(C)O)O)=CC=O,,,5,1,1,0,1
28823_0,,,,2,3,2,5
CC(C(CO)C(C(CO)O)O)O,,,5,1,1,0,1
28825_0,,,,2,3,2,5
CC(C(CO)C(C)O)O,,,5,1,1,0,1
28827_0,,,,2,3,2,5
CC(C(CO)CO)O,,,5,1,1,0,1
28829_0,,,,2,3,2,5
CC(C(CO)C(CO)O)O,,,5,1,2,0,2
28831_0,,,,2,3,2,5
CC(C(C(C(CO)CO)O)O)O,,,5,1,1,0,1
28832_0,,,,2,3,2,5
28834_0,,,,2,3,2,5
C(C(CO)C(C(C(C)O)O)O)(O)=O,,,5,1,3,0,3
28835_0,,,,2,3,2,5
28836_0,,,,2,3,2,5
28838_0,,,,2,3,2,5
CC(C(C(CCO)O)O)O,,,5,1,1,0,1
28840_0,,,,2,3,2,5
CC(C(C(C(CO)O)O)O)O,,,5,1,4,0,4
28842_0,,,,2,3,2,5
C(C(C(CC(CCO)O)O)O)O,,,5,1,1,0,1
28844_0,,,,2,3,2,5
C(C(C(CC(C(CO)O)O)O)O)O,,,5,1,2,0,2
28846_0,,,,2,3,2,5
C(C(CO)C(C(CO)O)O)O,,,5,1,1,0,1
28848_0,,,,2,3,2,5
C(C(C(CO)O)C(C(CO)O)O)O,,,5,1,2,0,2
28850_0,,,,2,3,2,5
C(C(CO)C(C(C(CO)O)O)O)O,,,5,1,1,0,1
28852_0,,,,2,3,2,5
C(C(CO)C(CCO)O)O,,,5,1,1,0,1
28854_0,,,,2,3,2,5
C(C(C(CO)C(CCO)O)O)O,,,5,1,1,0,1
28855_0,,,,2,3,2,5
28857_0,,,,2,3,2,5
C(C(CO)C(CCO)O)(O)=O,,,5,1,3,0,3
28858_0,,,,2,3,2,5
28859_0,,,,2,3,2,5
28860_0,,,,2,3,2,5
28861_0,,,,2,3,2,5
28862_0,,,,2,3,2,5
28863_0,,,,2,3,2,5
28864_0,,,,2,3,2,5
28865_0,,,,2,3,2,5
28866_0,,,,2,3,2,5
28868_0,,,,2,3,2,5
C(CC(CCO)O)O,,,5,1,1,0,1
28869_0,,,,2,3,2,5
28871_0,,,,2,3,2,5
C(C(CC(C(CO)CO)O)O)O,,,5,1,1,0,1
28872_0,,,,2,3,2,5
28874_0,,,,2,3,2,5
C(C(CO)(C(CO)CO)O)=O,,,5,1,2,0,2
28875_0,,,,2,3,2,5
28876_0,,,,2,3,2,5
28877_0,,,,2,3,2,5
28879_0,,,,2,3,2,5
C(C(C(CO)CO)O)(C(CO)O)=O,,,5,1,1,0,1
28881_0,,,,2,3,2,5
C(C)(C(CO)(C(CO)CO)O)=O,,,5,1,1,0,1
28883_0,,,,2,3,2,5
C(CO)(C(C)(C(CO)CO)O)=O,,,5,1,1,0,1
28884_0,,,,2,3,2,5
28886_0,,,,2,3,2,5
C(C(C(C)O)(C(CO)CO)O)=O,,,5,1,2,0,2
28888_0,,,,2,3,2,5
C(C(C(CO)CO)O)(C(C)O)=O,,,5,1,1,0,1
28890_0,,,,2,3,2,5
CC(CO)(C(CO)CO)O,,,5,1,1,0,1
28892_0,,,,2,3,2,5
C(C(CCO)(C(CO)CO)O)O,,,5,1,1,0,1
28894_0,,,,2,3,2,5
C(C(CO)C(C(CCO)O)O)O,,,5,1,1,0,1
28896_0,,,,2,3,2,5
CC(C(CO)O)(C(CO)CO)O,,,5,1,1,0,1
28897_0,,,,2,3,2,5
28899_0,,,,2,3,2,5
C(C(C)(C(CO)CO)O)(O)=O,,,5,1,1,0,1
28901_0,,,,2,3,2,5
C(CC(C(CO)CO)O)(O)=O,,,5,1,1,0,1
28903_0,,,,2,3,2,5
C(C(CCO)(C(CO)CO)O)(O)=O,,,5,1,1,0,1
28905_0,,,,2,3,2,5
C(C(CC(C(CO)CO)O)O)(O)=O,,,5,1,1,0,1
28907_0,,,,2,3,2,5
C(CC(C(C(CO)CO)O)O)(O)=O,,,5,1,1,0,1
28909_0,,,,2,3,2,5
C(CC(CO)(C(CO)CO)O)(O)=O,,,5,1,1,0,1
28911_0,,,,2,3,2,5
C(C(C(C)(C(CO)CO)O)O)(O)=O,,,5,1,1,0,1
28913_0,,,,2,3,2,5
C1C(C(CO1)O)(C(CO)CO)O,,,5,1,1,0,1
28915_0,,,,2,3,2,5
C1CC(C(O)O1)(C(CO)CO)O,,,5,1,1,0,1
28917_0,,,,2,3,2,5
C1C(CC(O)O1)(C(CO)CO)O,,,5,1,1,0,1
28918_0,,,,2,3,2,5
28920_0,,,,2,3,2,5
C(C(C=C)(C(CO)CO)O)=O,,,5,1,1,0,1
28922_0,,,,2,3,2,5
C=CC(C(C(CO)CO)O)=O,,,5,1,1,0,1
28923_0,,,,2,3,2,5
28925_0,,,,2,3,2,5
C(C(C(CO)CO)O)=CC=O,,,5,1,1,0,1
28927_0,,,,2,3,2,5
C(C(CO)CO)O,,,5,1,1,0,1
28929_0,,,,2,3,2,5
C(C(CO)C(CO)O)O,,,5,1,2,0,2
28930_0,,,,2,3,2,5
28932_0,,,,2,3,2,5
C(C(CO)C(CC(CO)O)O)(O)=O,,,5,1,3,0,3
28933_0,,,,2,3,2,5
28934_0,,,,2,3,2,5
28936_0,,,,2,3,2,5
C(C(CC(CCO)O)O)O,,,5,1,2,0,2
28938_0,,,,2,3,2,5
C(C(C(CC(CO)O)O)O)O,,,5,1,3,0,3
28939_0,,,,2,3,2,5
28941_0,,,,2,3,2,5
C(C(CO)(C(CO)C(CO)O)O)=O,,,5,1,2,0,2
28943_0,,,,2,3,2,5
C(CO)(C(C(CO)C(CO)O)O)=O,,,5,1,1,0,1
28945_0,,,,2,3,2,5
CC(CO)(C(CO)C(CO)O)O,,,5,1,1,0,1
28946_0,,,,2,3,2,5
28948_0,,,,2,3,2,5
C(C(C)(C(CO)C(CO)O)O)(O)=O,,,5,1,1,0,1
28950_0,,,,2,3,2,5
C(CC(C(CO)C(CO)O)O)(O)=O,,,5,1,1,0,1
28951_0,,,,2,3,2,5
28953_0,,,,2,3,2,5
C(C(C=C)(C(CO)C(CO)O)O)=O,,,5,1,1,0,1
28955_0,,,,2,3,2,5
C=CC(C(C(CO)C(CO)O)O)=O,,,5,1,1,0,1
28956_0,,,,2,3,2,5
28958_0,,,,2,3,2,5
C(C(C(CO)C(CO)O)O)=CC=O,,,5,1,1,0,1
28960_0,,,,2,3,2,5
C(C(C(CO)O)C(CO)O)O,,,5,1,2,0,2
28961_0,,,,2,3,2,5
28962_0,,,,2,3,2,5
28963_0,,,,2,3,2,5
28964_0,,,,2,3,2,5
28965_0,,,,2,3,2,5
28966_0,,,,2,3,2,5
28967_0,,,,2,3,2,5
28969_0,,,,2,3,2,5
C(C(CO)C(C=O)(CO)O)(O)=O,,,5,1,5,0,5
28970_0,,,,2,3,2,5
28971_0,,,,2,3,2,5
28972_0,,,,2,3,2,5
28973_0,,,,2,3,2,5
28974_0,,,,2,3,2,5
28975_0,,,,2,3,2,5
28976_0,,,,2,3,2,5
28977_0,,,,2,3,2,5
28978_0,,,,2,3,2,5
28979_0,,,,2,3,2,5
28980_0,,,,2,3,2,5
28981_0,,,,2,3,2,5
28982_0,,,,2,3,2,5
28983_0,,,,2,3,2,5
28984_0,,,,2,3,2,5
28985_0,,,,2,3,2,5
28986_0,,,,2,3,2,5
28987_0,,,,2,3,2,5
28988_0,,,,2,3,2,5
28989_0,,,,2,3,2,5
28990_0,,,,2,3,2,5
28991_0,,,,2,3,2,5
28992_0,,,,2,3,2,5
28993_0,,,,2,3,2,5
28994_0,,,,2,3,2,5
28995_0,,,,2,3,2,5
28996_0,,,,2,3,2,5
28997_0,,,,2,3,2,5
28998_0,,,,2,3,2,5
28999_0,,,,2,3,2,5
29000_0,,,,2,3,2,5
29001_0,,,,2,3,2,5
29002_0,,,,2,3,2,5
29003_0,,,,2,3,2,5
29004_0,,,,2,3,2,5
29005_0,,,,2,3,2,5
29006_0,,,,2,3,2,5
29007_0,,,,2,3,2,5
29008_0,,,,2,3,2,5
29009_0,,,,2,3,2,5
29010_0,,,,2,3,2,5
29011_0,,,,2,3,2,5
29012_0,,,,2,3,2,5
29013_0,,,,2,3,2,5
29014_0,,,,2,3,2,5
29015_0,,,,2,3,2,5
29016_0,,,,2,3,2,5
29017_0,,,,2,3,2,5
29018_0,,,,2,3,2,5
29019_0,,,,2,3,2,5
29020_0,,,,2,3,2,5
29021_0,,,,2,3,2,5
29022_0,,,,2,3,2,5
29023_0,,,,2,3,2,5
29024_0,,,,2,3,2,5
29025_0,,,,2,3,2,5
29026_0,,,,2,3,2,5
29027_0,,,,2,3,2,5
29028_0,,,,2,3,2,5
29029_0,,,,2,3,2,5
29030_0,,,,2,3,2,5
29031_0,,,,2,3,2,5
29032_0,,,,2,3,2,5
29033_0,,,,2,3,2,5
29034_0,,,,2,3,2,5
29035_0,,,,2,3,2,5
29036_0,,,,2,3,2,5
29037_0,,,,2,3,2,5
29038_0,,,,2,3,2,5
29039_0,,,,2,3,2,5
29040_0,,,,2,3,2,5
29041_0,,,,2,3,2,5
29042_0,,,,2,3,2,5
29043_0,,,,2,3,2,5
29044_0,,,,2,3,2,5
29045_0,,,,2,3,2,5
29046_0,,,,2,3,2,5
29047_0,,,,2,3,2,5
29048_0,,,,2,3,2,5
29049_0,,,,2,3,2,5
29050_0,,,,2,3,2,5
29051_0,,,,2,3,2,5
29052_0,,,,2,3,2,5
29054_0,,,,2,3,2,5
C(C(CO)C(C(C)=O)(CO)O)(O)=O,,,5,1,3,0,3
29055_0,,,,2,3,2,5
29056_0,,,,2,3,2,5
29058_0,,,,2,3,2,5
C(C)(C(CO)(CCO)O)=O,,,5,1,3,0,3
29059_0,,,,2,3,2,5
29061_0,,,,2,3,2,5
C(C(CO)C(C(CO)=O)(C)O)(O)=O,,,5,1,3,0,3
29062_0,,,,2,3,2,5
29063_0,,,,2,3,2,5
29064_0,,,,2,3,2,5
29065_0,,,,2,3,2,5
29066_0,,,,2,3,2,5
29067_0,,,,2,3,2,5
29068_0,,,,2,3,2,5
29069_0,,,,2,3,2,5
29070_0,,,,2,3,2,5
29071_0,,,,2,3,2,5
29072_0,,,,2,3,2,5
29073_0,,,,2,3,2,5
29074_0,,,,2,3,2,5
29075_0,,,,2,3,2,5
29076_0,,,,2,3,2,5
29077_0,,,,2,3,2,5
29078_0,,,,2,3,2,5
29080_0,,,,2,3,2,5
C(C(CO)C(C=O)(C(C)O)O)(O)=O,,,5,1,5,0,5
29081_0,,,,2,3,2,5
29082_0,,,,2,3,2,5
29083_0,,,,2,3,2,5
29084_0,,,,2,3,2,5
29085_0,,,,2,3,2,5
29086_0,,,,2,3,2,5
29087_0,,,,2,3,2,5
29088_0,,,,2,3,2,5
29090_0,,,,2,3,2,5
C(C(CO)C(C(C(C)O)=O)O)(O)=O,,,5,1,3,0,3
29091_0,,,,2,3,2,5
29092_0,,,,2,3,2,5
29093_0,,,,2,3,2,5
29094_0,,,,2,3,2,5
29096_0,,,,2,3,2,5
C(C(CO)C(C)(CO)O)(O)=O,,,5,1,3,0,3
29097_0,,,,2,3,2,5
29098_0,,,,2,3,2,5
29099_0,,,,2,3,2,5
29100_0,,,,2,3,2,5
29101_0,,,,2,3,2,5
29102_0,,,,2,3,2,5
29103_0,,,,2,3,2,5
29104_0,,,,2,3,2,5
29105_0,,,,2,3,2,5
29107_0,,,,2,3,2,5
CC(CO)(CCO)O,,,5,1,2,0,2
29109_0,,,,2,3,2,5
CC(CO)(C(CO)O)O,,,5,1,3,0,3
29110_0,,,,2,3,2,5
29111_0,,,,2,3,2,5
29112_0,,,,2,3,2,5
29113_0,,,,2,3,2,5
29114_0,,,,2,3,2,5
29115_0,,,,2,3,2,5
29116_0,,,,2,3,2,5
29117_0,,,,2,3,2,5
29118_0,,,,2,3,2,5
29119_0,,,,2,3,2,5
29120_0,,,,2,3,2,5
29121_0,,,,2,3,2,5
29122_0,,,,2,3,2,5
29123_0,,,,2,3,2,5
29124_0,,,,2,3,2,5
29126_0,,,,2,3,2,5
C(C(CO)C(CO)(CCO)O)(O)=O,,,5,1,3,0,3
29127_0,,,,2,3,2,5
29128_0,,,,2,3,2,5
29130_0,,,,2,3,2,5
C(C(CCO)(CCO)O)O,,,5,1,2,0,2
29131_0,,,,2,3,2,5
29132_0,,,,2,3,2,5
29133_0,,,,2,3,2,5
29134_0,,,,2,3,2,5
29135_0,,,,2,3,2,5
29136_0,,,,2,3,2,5
29137_0,,,,2,3,2,5
29138_0,,,,2,3,2,5
29140_0,,,,2,3,2,5
C(C(CO)C(C(CCO)O)O)(O)=O,,,5,1,3,0,3
29141_0,,,,2,3,2,5
29142_0,,,,2,3,2,5
29144_0,,,,2,3,2,5
C(CC(C(CCO)O)O)O,,,5,1,1,0,1
29145_0,,,,2,3,2,5
29147_0,,,,2,3,2,5
C(C(CO)C(C)(C(CO)O)O)(O)=O,,,5,1,3,0,3
29148_0,,,,2,3,2,5
29149_0,,,,2,3,2,5
29151_0,,,,2,3,2,5
CC(CCO)(C(CO)O)O,,,5,1,2,0,2
29153_0,,,,2,3,2,5
CC(C(CO)O)(C(CO)O)O,,,5,1,2,0,2
29154_0,,,,2,3,2,5
29155_0,,,,2,3,2,5
29156_0,,,,2,3,2,5
29157_0,,,,2,3,2,5
29158_0,,,,2,3,2,5
29159_0,,,,2,3,2,5
29160_0,,,,2,3,2,5
29161_0,,,,2,3,2,5
29162_0,,,,2,3,2,5
29163_0,,,,2,3,2,5
29164_0,,,,2,3,2,5
29165_0,,,,2,3,2,5
29166_0,,,,2,3,2,5
29167_0,,,,2,3,2,5
29168_0,,,,2,3,2,5
29169_0,,,,2,3,2,5
29170_0,,,,2,3,2,5
29171_0,,,,2,3,2,5
29172_0,,,,2,3,2,5
29173_0,,,,2,3,2,5
29174_0,,,,2,3,2,5
29175_0,,,,2,3,2,5
29177_0,,,,2,3,2,5
C(C(C)(CCO)O)(O)=O,,,5,1,2,0,2
29178_0,,,,2,3,2,5
29179_0,,,,2,3,2,5
29180_0,,,,2,3,2,5
29181_0,,,,2,3,2,5
29182_0,,,,2,3,2,5
29183_0,,,,2,3,2,5
29184_0,,,,2,3,2,5
29185_0,,,,2,3,2,5
29186_0,,,,2,3,2,5
29187_0,,,,2,3,2,5
29188_0,,,,2,3,2,5
29190_0,,,,2,3,2,5
C(C(CO)C(CC(O)=O)O)(O)=O,,,5,1,3,0,3
29191_0,,,,2,3,2,5
29192_0,,,,2,3,2,5
29193_0,,,,2,3,2,5
29194_0,,,,2,3,2,5
29195_0,,,,2,3,2,5
29196_0,,,,2,3,2,5
29197_0,,,,2,3,2,5
29198_0,,,,2,3,2,5
29200_0,,,,2,3,2,5
C(CC(CCO)O)(O)=O,,,5,1,3,0,3
29201_0,,,,2,3,2,5
29203_0,,,,2,3,2,5
C(C(CO)C1(COCC1O)O)(O)=O,,,5,1,3,0,3
29205_0,,,,2,3,2,5
C(C(CO)C1(C(O)OCC1)O)(O)=O,,,5,1,3,0,3
29207_0,,,,2,3,2,5
C(C(CO)C1(COC(C1)O)O)(O)=O,,,5,1,3,0,3
29208_0,,,,2,3,2,5
29210_0,,,,2,3,2,5
C(C(C=C)(C(C(O)=O)CO)O)=O,,,5,1,3,0,3
29212_0,,,,2,3,2,5
C(C(CO)C(C(C=C)=O)O)(O)=O,,,5,1,3,0,3
29213_0,,,,2,3,2,5
29215_0,,,,2,3,2,5
C(C(CO)C(C=CC=O)O)(O)=O,,,5,1,3,0,3
29217_0,,,,2,3,2,5
C(C(CO)C(C(CO)O)O)(O)=O,,,5,1,4,0,4
29218_0,,,,2,3,2,5
29219_0,,,,2,3,2,5
29221_0,,,,2,3,2,5
C(C(CO)C(CO)(CO)O)(O)=O,,,5,1,4,0,4
29222_0,,,,2,3,2,5
29224_0,,,,2,3,2,5
C(C(CO)C(C=O)(C)O)(O)=O,,,5,1,4,0,4
29226_0,,,,2,3,2,5
C(C(CO)C(C(C)=O)O)(O)=O,,,5,1,4,0,4
29227_0,,,,2,3,2,5
29228_0,,,,2,3,2,5
29229_0,,,,2,3,2,5
29231_0,,,,2,3,2,5
C(C(CO)C(C=O)(CCO)O)(O)=O,,,5,1,4,0,4
29233_0,,,,2,3,2,5
C(C(CO)C(C(CCO)=O)O)(O)=O,,,5,1,4,0,4
29234_0,,,,2,3,2,5
29235_0,,,,2,3,2,5
29236_0,,,,2,3,2,5
29238_0,,,,2,3,2,5
C(C(CO)C(CC(C=O)O)O)(O)=O,,,5,1,4,0,4
29239_0,,,,2,3,2,5
29240_0,,,,2,3,2,5
29241_0,,,,2,3,2,5
29242_0,,,,2,3,2,5
29243_0,,,,2,3,2,5
29244_0,,,,2,3,2,5
29246_0,,,,2,3,2,5
C(C(CO)C(C)O)(O)=O,,,5,1,4,0,4
29248_0,,,,2,3,2,5
C(C(CO)CO)(O)=O,,,5,1,3,0,3
29250_0,,,,2,3,2,5
C(C(CO)C(CO)O)(O)=O,,,5,1,6,0,6
29251_0,,,,2,3,2,5
29252_0,,,,2,3,2,5
29254_0,,,,2,3,2,5
C(C(CCO)(CCO)O)(O)=O,,,5,1,2,0,2
29255_0,,,,2,3,2,5
29256_0,,,,2,3,2,5
29257_0,,,,2,3,2,5
29258_0,,,,2,3,2,5
29259_0,,,,2,3,2,5
29260_0,,,,2,3,2,5
29261_0,,,,2,3,2,5
29262_0,,,,2,3,2,5
29263_0,,,,2,3,2,5
29264_0,,,,2,3,2,5
29266_0,,,,2,3,2,5
C(CC(C(CCO)O)O)(O)=O,,,5,1,2,0,2
29267_0,,,,2,3,2,5
29268_0,,,,2,3,2,5
29269_0,,,,2,3,2,5
29271_0,,,,2,3,2,5
C(CC(CO)(CCO)O)(O)=O,,,5,1,3,0,3
29272_0,,,,2,3,2,5
29273_0,,,,2,3,2,5
29274_0,,,,2,3,2,5
29275_0,,,,2,3,2,5
29276_0,,,,2,3,2,5
29277_0,,,,2,3,2,5
29278_0,,,,2,3,2,5
29279_0,,,,2,3,2,5
29280_0,,,,2,3,2,5
29282_0,,,,2,3,2,5
C(C(C(C)(CCO)O)O)(O)=O,,,5,1,2,0,2
29283_0,,,,2,3,2,5
29284_0,,,,2,3,2,5
29285_0,,,,2,3,2,5
29286_0,,,,2,3,2,5
29287_0,,,,2,3,2,5
29288_0,,,,2,3,2,5
29289_0,,,,2,3,2,5
29291_0,,,,2,3,2,5
C(C(CCO)(C(CO)(CO)O)O)O,,,5,1,4,0,4
29292_0,,,,2,3,2,5
29294_0,,,,2,3,2,5
C(C(CO)(C(C(CO)CO)O)O)=O,,,5,1,3,0,3
29296_0,,,,2,3,2,5
C(C)(C(C(C)O)(C(CCO)O)O)=O,,,5,1,5,0,5
29298_0,,,,2,3,2,5
C(C(C(C)O)(C(C)(CCO)O)O)=O,,,5,1,3,0,3
29299_0,,,,2,3,2,5
29300_0,,,,2,3,2,5
29301_0,,,,2,3,2,5
29302_0,,,,2,3,2,5
29303_0,,,,2,3,2,5
29305_0,,,,2,3,2,5
C(C(CO)(C(C)(CCO)O)O)=O,,,5,1,3,0,3
29306_0,,,,2,3,2,5
29307_0,,,,2,3,2,5
29308_0,,,,2,3,2,5
29309_0,,,,2,3,2,5
29310_0,,,,2,3,2,5
29311_0,,,,2,3,2,5
29313_0,,,,2,3,2,5
CC(C(CO)(C(CCO)O)O)O,,,5,1,3,0,3
29314_0,,,,2,3,2,5
29315_0,,,,2,3,2,5
29316_0,,,,2,3,2,5
29317_0,,,,2,3,2,5
29318_0,,,,2,3,2,5
29319_0,,,,2,3,2,5
29321_0,,,,2,3,2,5
C(C(C(C(C)(CCO)O)O)O)(O)=O,,,5,1,2,0,2
29323_0,,,,2,3,2,5
C(C(C(CC(CCO)O)O)O)(O)=O,,,5,1,2,0,2
29325_0,,,,2,3,2,5
C(C(C(C(CO)C(C)O)O)O)(O)=O,,,5,1,2,0,2
29327_0,,,,2,3,2,5
C(C(C(C(CO)CO)O)O)(O)=O,,,5,1,2,0,2
29329_0,,,,2,3,2,5
C(CC(C(CCO)O)(C(C)O)O)=O,,,5,1,1,0,1
29330_0,,,,2,3,2,5
29332_0,,,,2,3,2,5
C(C(C(C)O)(CC(CCO)O)O)=O,,,5,1,2,0,2
29333_0,,,,2,3,2,5
29335_0,,,,2,3,2,5
C(CC(CO)(C(CCO)O)O)=O,,,5,1,3,0,3
29336_0,,,,2,3,2,5
29338_0,,,,2,3,2,5
C(C(CO)(CC(CCO)O)O)=O,,,5,1,2,0,2
29339_0,,,,2,3,2,5
29341_0,,,,2,3,2,5
C(C(CO)(CC(C(CO)O)O)O)=O,,,5,1,3,0,3
29342_0,,,,2,3,2,5
29343_0,,,,2,3,2,5
29344_0,,,,2,3,2,5
29345_0,,,,2,3,2,5
29346_0,,,,2,3,2,5
29347_0,,,,2,3,2,5
29348_0,,,,2,3,2,5
29349_0,,,,2,3,2,5
29350_0,,,,2,3,2,5
29351_0,,,,2,3,2,5
29352_0,,,,2,3,2,5
29353_0,,,,2,3,2,5
29355_0,,,,2,3,2,5
C(C(CCO)(CC(CO)O)O)(O)=O,,,5,1,1,0,1
29356_0,,,,2,3,2,5
29358_0,,,,2,3,2,5
C(CC(CCO)(C(CO)O)O)(O)=O,,,5,1,1,0,1
29360_0,,,,2,3,2,5
C(C(C(CCO)(CCO)O)O)(O)=O,,,5,1,1,0,1
29361_0,,,,2,3,2,5
29362_0,,,,2,3,2,5
29364_0,,,,2,3,2,5
C1C(C(CO1)(CCO)O)O,,,5,1,1,0,1
29366_0,,,,2,3,2,5
C1C(C(CO1)O)(C(CO)O)O,,,5,1,2,0,2
29367_0,,,,2,3,2,5
29368_0,,,,2,3,2,5
29369_0,,,,2,3,2,5
29370_0,,,,2,3,2,5
29371_0,,,,2,3,2,5
29372_0,,,,2,3,2,5
29373_0,,,,2,3,2,5
29375_0,,,,2,3,2,5
C1CC(C(O)O1)(CCO)O,,,5,1,2,0,2
29377_0,,,,2,3,2,5
C1CC(C(O)O1)(C(CO)O)O,,,5,1,3,0,3
29378_0,,,,2,3,2,5
29379_0,,,,2,3,2,5
29380_0,,,,2,3,2,5
29381_0,,,,2,3,2,5
29382_0,,,,2,3,2,5
29383_0,,,,2,3,2,5
29384_0,,,,2,3,2,5
29386_0,,,,2,3,2,5
C1C(CC(O)O1)(CCO)O,,,5,1,2,0,2
29387_0,,,,2,3,2,5
29388_0,,,,2,3,2,5
29389_0,,,,2,3,2,5
29390_0,,,,2,3,2,5
29391_0,,,,2,3,2,5
29392_0,,,,2,3,2,5
29393_0,,,,2,3,2,5
29394_0,,,,2,3,2,5
29395_0,,,,2,3,2,5
29396_0,,,,2,3,2,5
29397_0,,,,2,3,2,5
29398_0,,,,2,3,2,5
29399_0,,,,2,3,2,5
29400_0,,,,2,3,2,5
29401_0,,,,2,3,2,5
29402_0,,,,2,3,2,5
29403_0,,,,2,3,2,5
29404_0,,,,2,3,2,5
29405_0,,,,2,3,2,5
29406_0,,,,2,3,2,5
29407_0,,,,2,3,2,5
29408_0,,,,2,3,2,5
29409_0,,,,2,3,2,5
29410_0,,,,2,3,2,5
29411_0,,,,2,3,2,5
29412_0,,,,2,3,2,5
29413_0,,,,2,3,2,5
29415_0,,,,2,3,2,5
C(C(C=C)(CCO)O)=O,,,5,1,3,0,3
29416_0,,,,2,3,2,5
29417_0,,,,2,3,2,5
29418_0,,,,2,3,2,5
29419_0,,,,2,3,2,5
29420_0,,,,2,3,2,5
29421_0,,,,2,3,2,5
29422_0,,,,2,3,2,5
29423_0,,,,2,3,2,5
29424_0,,,,2,3,2,5
29425_0,,,,2,3,2,5
29426_0,,,,2,3,2,5
29428_0,,,,2,3,2,5
C=CC(C(CCO)O)=O,,,5,1,2,0,2
29429_0,,,,2,3,2,5
29430_0,,,,2,3,2,5
29431_0,,,,2,3,2,5
29432_0,,,,2,3,2,5
29433_0,,,,2,3,2,5
29434_0,,,,2,3,2,5
29435_0,,,,2,3,2,5
29436_0,,,,2,3,2,5
29437_0,,,,2,3,2,5
29438_0,,,,2,3,2,5
29439_0,,,,2,3,2,5
29440_0,,,,2,3,2,5
29441_0,,,,2,3,2,5
29442_0,,,,2,3,2,5
29443_0,,,,2,3,2,5
29444_0,,,,2,3,2,5
29445_0,,,,2,3,2,5
29447_0,,,,2,3,2,5
C(C(CCO)O)=CC=O,,,5,1,3,0,3
29448_0,,,,2,3,2,5
29449_0,,,,2,3,2,5
29450_0,,,,2,3,2,5
29451_0,,,,2,3,2,5
29452_0,,,,2,3,2,5
29453_0,,,,2,3,2,5
29454_0,,,,2,3,2,5
29455_0,,,,2,3,2,5
29456_0,,,,2,3,2,5
29457_0,,,,2,3,2,5
29458_0,,,,2,3,2,5
29459_0,,,,2,3,2,5
29460_0,,,,2,3,2,5
29461_0,,,,2,3,2,5
29462_0,,,,2,3,2,5
29463_0,,,,2,3,2,5
29464_0,,,,2,3,2,5
29465_0,,,,2,3,2,5
29466_0,,,,2,3,2,5
29467_0,,,,2,3,2,5
29468_0,,,,2,3,2,5
29469_0,,,,2,3,2,5
29470_0,,,,2,3,2,5
29471_0,,,,2,3,2,5
29472_0,,,,2,3,2,5
29473_0,,,,2,3,2,5
29474_0,,,,2,3,2,5
29475_0,,,,2,3,2,5
29476_0,,,,2,3,2,5
29477_0,,,,2,3,2,5
29478_0,,,,2,3,2,5
29479_0,,,,2,3,2,5
29480_0,,,,2,3,2,5
29481_0,,,,2,3,2,5
29482_0,,,,2,3,2,5
29483_0,,,,2,3,2,5
29484_0,,,,2,3,2,5
29485_0,,,,2,3,2,5
29486_0,,,,2,3,2,5
29487_0,,,,2,3,2,5
29488_0,,,,2,3,2,5
29489_0,,,,2,3,2,5
29491_0,,,,2,3,2,5
CC(CO)O,,,5,1,1,0,1
29492_0,,,,2,3,2,5
29493_0,,,,2,3,2,5
29494_0,,,,2,3,2,5
29495_0,,,,2,3,2,5
29496_0,,,,2,3,2,5
29497_0,,,,2,3,2,5
29498_0,,,,2,3,2,5
29499_0,,,,2,3,2,5
29500_0,,,,2,3,2,5
29501_0,,,,2,3,2,5
29502_0,,,,2,3,2,5
29503_0,,,,2,3,2,5
29504_0,,,,2,3,2,5
29505_0,,,,2,3,2,5
29506_0,,,,2,3,2,5
29507_0,,,,2,3,2,5
29508_0,,,,2,3,2,5
29509_0,,,,2,3,2,5
29510_0,,,,2,3,2,5
29511_0,,,,2,3,2,5
29512_0,,,,2,3,2,5
29513_0,,,,2,3,2,5
29514_0,,,,2,3,2,5
29515_0,,,,2,3,2,5
29516_0,,,,2,3,2,5
29517_0,,,,2,3,2,5
29518_0,,,,2,3,2,5
29519_0,,,,2,3,2,5
29520_0,,,,2,3,2,5
29521_0,,,,2,3,2,5
29522_0,,,,2,3,2,5
29523_0,,,,2,3,2,5
29524_0,,,,2,3,2,5
29526_0,,,,2,3,2,5
C(C(C)(C(C(CO)O)O)O)=O,,,5,1,4,0,4
29527_0,,,,2,3,2,5
29528_0,,,,2,3,2,5
29529_0,,,,2,3,2,5
29530_0,,,,2,3,2,5
29531_0,,,,2,3,2,5
29532_0,,,,2,3,2,5
29533_0,,,,2,3,2,5
29534_0,,,,2,3,2,5
29536_0,,,,2,3,2,5
CC(C(C(CO)O)O)O,,,5,1,3,0,3
29537_0,,,,2,3,2,5
29538_0,,,,2,3,2,5
29539_0,,,,2,3,2,5
29540_0,,,,2,3,2,5
29541_0,,,,2,3,2,5
29542_0,,,,2,3,2,5
29543_0,,,,2,3,2,5
29544_0,,,,2,3,2,5
29545_0,,,,2,3,2,5
29546_0,,,,2,3,2,5
29547_0,,,,2,3,2,5
29548_0,,,,2,3,2,5
29549_0,,,,2,3,2,5
29550_0,,,,2,3,2,5
29551_0,,,,2,3,2,5
29552_0,,,,2,3,2,5
29553_0,,,,2,3,2,5
29554_0,,,,2,3,2,5
29555_0,,,,2,3,2,5
29556_0,,,,2,3,2,5
29557_0,,,,2,3,2,5
29558_0,,,,2,3,2,5
29559_0,,,,2,3,2,5
29560_0,,,,2,3,2,5
29561_0,,,,2,3,2,5
29562_0,,,,2,3,2,5
29563_0,,,,2,3,2,5
29564_0,,,,2,3,2,5
29565_0,,,,2,3,2,5
29566_0,,,,2,3,2,5
29567_0,,,,2,3,2,5
29568_0,,,,2,3,2,5
29569_0,,,,2,3,2,5
29570_0,,,,2,3,2,5
29571_0,,,,2,3,2,5
29572_0,,,,2,3,2,5
29573_0,,,,2,3,2,5
29574_0,,,,2,3,2,5
29575_0,,,,2,3,2,5
29576_0,,,,2,3,2,5
29577_0,,,,2,3,2,5
29578_0,,,,2,3,2,5
29579_0,,,,2,3,2,5
29580_0,,,,2,3,2,5
29581_0,,,,2,3,2,5
29582_0,,,,2,3,2,5
29583_0,,,,2,3,2,5
29584_0,,,,2,3,2,5
29585_0,,,,2,3,2,5
29586_0,,,,2,3,2,5
29587_0,,,,2,3,2,5
29589_0,,,,2,3,2,5
C(C(CO)(CC(CO)O)O)=O,,,5,1,1,0,1
29590_0,,,,2,3,2,5
29591_0,,,,2,3,2,5
29592_0,,,,2,3,2,5
29593_0,,,,2,3,2,5
29594_0,,,,2,3,2,5
29595_0,,,,2,3,2,5
29596_0,,,,2,3,2,5
29597_0,,,,2,3,2,5
29598_0,,,,2,3,2,5
29599_0,,,,2,3,2,5
29600_0,,,,2,3,2,5
29601_0,,,,2,3,2,5
29602_0,,,,2,3,2,5
29603_0,,,,2,3,2,5
29604_0,,,,2,3,2,5
29605_0,,,,2,3,2,5
29606_0,,,,2,3,2,5
29607_0,,,,2,3,2,5
29608_0,,,,2,3,2,5
29610_0,,,,2,3,2,5
CC(CO)(C(CO)(CO)O)O,,,5,1,3,0,3
29611_0,,,,2,3,2,5
29613_0,,,,2,3,2,5
CC(CO)(C(CO)(C(CO)O)O)O,,,5,1,5,0,5
29614_0,,,,2,3,2,5
29615_0,,,,2,3,2,5
29616_0,,,,2,3,2,5
29617_0,,,,2,3,2,5
29618_0,,,,2,3,2,5
29619_0,,,,2,3,2,5
29620_0,,,,2,3,2,5
29622_0,,,,2,3,2,5
C(C(CC(C(CO)(CO)O)O)O)O,,,5,1,3,0,3
29623_0,,,,2,3,2,5
29625_0,,,,2,3,2,5
CC(C(CO)O)(C(CO)(CO)O)O,,,5,1,3,0,3
29626_0,,,,2,3,2,5
29628_0,,,,2,3,2,5
C(C(C)(C(CO)(CCO)O)O)=O,,,5,1,3,0,3
29630_0,,,,2,3,2,5
C(CC(CO)(C(C)(CO)O)O)=O,,,5,1,2,0,2
29631_0,,,,2,3,2,5
29632_0,,,,2,3,2,5
29633_0,,,,2,3,2,5
29634_0,,,,2,3,2,5
29635_0,,,,2,3,2,5
29636_0,,,,2,3,2,5
29637_0,,,,2,3,2,5
29638_0,,,,2,3,2,5
29640_0,,,,2,3,2,5
CC(C(CO)(CCO)O)O,,,5,1,2,0,2
29641_0,,,,2,3,2,5
29642_0,,,,2,3,2,5
29643_0,,,,2,3,2,5
29645_0,,,,2,3,2,5
C(CO)=CCO,,,5,1,2,0,2
29646_0,,,,2,3,2,5
29648_0,,,,2,3,2,5
C(C(C(CO)O)C(C=O)(C)O)(O)=O,,,5,1,4,0,4
29649_0,,,,2,3,2,5
29651_0,,,,2,3,2,5
C(CC(C)(CO)O)(O)=O,,,5,1,3,0,3
29653_0,,,,2,3,2,5
C(C(C(CO)O)C(C(C)=O)O)(O)=O,,,5,1,4,0,4
29654_0,,,,2,3,2,5
29655_0,,,,2,3,2,5
29656_0,,,,2,3,2,5
29658_0,,,,2,3,2,5
C(CC(CC(CO)O)O)(O)=O,,,5,1,2,0,2
29660_0,,,,2,3,2,5
C(C(C(CO)O)C(C)O)(O)=O,,,5,1,4,0,4
29661_0,,,,2,3,2,5
29663_0,,,,2,3,2,5
C(C(C(CO)O)C(CO)O)(O)=O,,,5,1,4,0,4
29665_0,,,,2,3,2,5
C(CC(C)(C(CO)O)O)(O)=O,,,5,1,2,0,2
29666_0,,,,2,3,2,5
29667_0,,,,2,3,2,5
29668_0,,,,2,3,2,5
29669_0,,,,2,3,2,5
29670_0,,,,2,3,2,5
29671_0,,,,2,3,2,5
29672_0,,,,2,3,2,5
29673_0,,,,2,3,2,5
29674_0,,,,2,3,2,5
29675_0,,,,2,3,2,5
29676_0,,,,2,3,2,5
29677_0,,,,2,3,2,5
29678_0,,,,2,3,2,5
29679_0,,,,2,3,2,5
29680_0,,,,2,3,2,5
29681_0,,,,2,3,2,5
29682_0,,,,2,3,2,5
29683_0,,,,2,3,2,5
29685_0,,,,2,3,2,5
C(C(C)(C(CO)(CC(O)=O)O)O)=O,,,5,1,3,0,3
29686_0,,,,2,3,2,5
29687_0,,,,2,3,2,5
29688_0,,,,2,3,2,5
29689_0,,,,2,3,2,5
29690_0,,,,2,3,2,5
29691_0,,,,2,3,2,5
29692_0,,,,2,3,2,5
29693_0,,,,2,3,2,5
29694_0,,,,2,3,2,5
29695_0,,,,2,3,2,5
29696_0,,,,2,3,2,5
29697_0,,,,2,3,2,5
29699_0,,,,2,3,2,5
C(CC(CO)(C(C)O)O)(O)=O,,,5,1,2,0,2
29700_0,,,,2,3,2,5
29701_0,,,,2,3,2,5
29702_0,,,,2,3,2,5
29703_0,,,,2,3,2,5
29704_0,,,,2,3,2,5
29705_0,,,,2,3,2,5
29707_0,,,,2,3,2,5
C(C1(CO)C(C(CC1O)O)O)=O,,,5,1,4,0,4
29709_0,,,,2,3,2,5
C(C1(C(C(CC1O)O)O)O)O,,,5,1,3,0,3
29710_0,,,,2,3,2,5
29711_0,,,,2,3,2,5
29712_0,,,,2,3,2,5
29713_0,,,,2,3,2,5
29714_0,,,,2,3,2,5
29715_0,,,,2,3,2,5
29716_0,,,,2,3,2,5
29717_0,,,,2,3,2,5
29718_0,,,,2,3,2,5
29720_0,,,,2,3,2,5
C(CO)(C(CO)(CO)C(C=O)O)=O,,,5,1,4,0,4
29721_0,,,,2,3,2,5
29722_0,,,,2,3,2,5
29724_0,,,,2,3,2,5
C(C(C(CO)(CO)C(C=O)O)O)=O,,,5,1,1,0,1
29725_0,,,,2,3,2,5
29726_0,,,,2,3,2,5
29727_0,,,,2,3,2,5
29728_0,,,,2,3,2,5
29729_0,,,,2,3,2,5
29730_0,,,,2,3,2,5
29731_0,,,,2,3,2,5
29732_0,,,,2,3,2,5
29733_0,,,,2,3,2,5
29734_0,,,,2,3,2,5
29735_0,,,,2,3,2,5
29736_0,,,,2,3,2,5
29737_0,,,,2,3,2,5
29738_0,,,,2,3,2,5
29739_0,,,,2,3,2,5
29740_0,,,,2,3,2,5
29741_0,,,,2,3,2,5
29742_0,,,,2,3,2,5
29743_0,,,,2,3,2,5
29744_0,,,,2,3,2,5
29746_0,,,,2,3,2,5
C(C(CO)(CO)C(CO)(CO)O)=O,,,5,1,3,0,3
29748_0,,,,2,3,2,5
CC(C(CO)(C(CO)(CO)O)O)O,,,5,1,2,0,2
29750_0,,,,2,3,2,5
C(C(CO)(C(C)O)C(C=O)(C)O)=O,,,5,1,4,0,4
29751_0,,,,2,3,2,5
29753_0,,,,2,3,2,5
C(C(CO)(CO)C(C=O)(C)O)=O,,,5,1,3,0,3
29754_0,,,,2,3,2,5
29756_0,,,,2,3,2,5
C(C(C)(C(CO)(C(C)O)O)O)=O,,,5,1,3,0,3
29757_0,,,,2,3,2,5
29759_0,,,,2,3,2,5
C(C(CO)(C(C)O)C(C(C)=O)O)=O,,,5,1,4,0,4
29761_0,,,,2,3,2,5
C(C(CO)(CO)C(C(C)=O)O)=O,,,5,1,3,0,3
29762_0,,,,2,3,2,5
29764_0,,,,2,3,2,5
C(C)(C(C(CO)O)(C(C)O)O)=O,,,5,1,6,0,6
29766_0,,,,2,3,2,5
C(C)(C(C(CO)O)(C(CO)O)O)=O,,,5,1,4,0,4
29767_0,,,,2,3,2,5
29768_0,,,,2,3,2,5
29769_0,,,,2,3,2,5
29770_0,,,,2,3,2,5
29771_0,,,,2,3,2,5
29772_0,,,,2,3,2,5
29774_0,,,,2,3,2,5
C(C(CO)(C(C)O)C(CCO)O)=O,,,5,1,4,0,4
29776_0,,,,2,3,2,5
C(C(CO)(C(C)O)C(C)(CO)O)=O,,,5,1,4,0,4
29778_0,,,,2,3,2,5
C(C(CO)(C(C)O)C(C(O)=O)O)=O,,,5,1,5,0,5
29780_0,,,,2,3,2,5
C(C(CO)(C(C)O)C(C)O)=O,,,5,1,3,0,3
29782_0,,,,2,3,2,5
C(C(CO)(CO)C(C)O)=O,,,5,1,3,0,3
29784_0,,,,2,3,2,5
C(C(CO)(C(CO)O)C(C)O)=O,,,5,1,5,0,5
29786_0,,,,2,3,2,5
C(C(CO)(CO)C(C(CO)O)O)=O,,,5,1,3,0,3
29788_0,,,,2,3,2,5
C(C(CO)(CO)C(CC(C)O)O)=O,,,5,1,3,0,3
29790_0,,,,2,3,2,5
C(C(CO)(CO)C(CCO)O)=O,,,5,1,3,0,3
29791_0,,,,2,3,2,5
29793_0,,,,2,3,2,5
C(C(CO)(CO)C(C=O)(CO)O)=O,,,5,1,4,0,4
29794_0,,,,2,3,2,5
29796_0,,,,2,3,2,5
C(C(CO)(CO)C(C)(CO)O)=O,,,5,1,3,0,3
29798_0,,,,2,3,2,5
C(C(CO)(CO)C(C(O)=O)O)=O,,,5,1,4,0,4
29800_0,,,,2,3,2,5
C(C(CO)(CO)C(C(O)=O)(C)O)=O,,,5,1,3,0,3
29802_0,,,,2,3,2,5
C(C(CO)(CO)C(CC(O)=O)O)=O,,,5,1,3,0,3
29804_0,,,,2,3,2,5
C(C(C=O)(CO)C(C=C)(CO)O)=O,,,5,1,2,0,2
29806_0,,,,2,3,2,5
C(C(C=C)(C(C=O)(CO)CO)O)=O,,,5,1,3,0,3
29808_0,,,,2,3,2,5
C(C(CO)(CO)C(C(C=C)=O)O)=O,,,5,1,3,0,3
29810_0,,,,2,3,2,5
C(C(C=O)(CO)C(C=CCO)O)=O,,,5,1,2,0,2
29812_0,,,,2,3,2,5
C(C(CO)(CO)C(C=CC=O)O)=O,,,5,1,3,0,3
29814_0,,,,2,3,2,5
C(C(CO)(CO)CO)=O,,,5,1,2,0,2
29816_0,,,,2,3,2,5
C(C(CO)(CO)C(CO)O)=O,,,5,1,4,0,4
29818_0,,,,2,3,2,5
C(C(CO)(C(CO)O)C(CO)O)=O,,,5,1,4,0,4
29819_0,,,,2,3,2,5
29821_0,,,,2,3,2,5
C(CO)(C(CO)(C(C)O)C(C)O)=O,,,5,1,3,0,3
29823_0,,,,2,3,2,5
C(CO)(C(CO)(CO)C(C)O)=O,,,5,1,4,0,4
29825_0,,,,2,3,2,5
C(CO)(C(CO)(CO)CO)=O,,,5,1,3,0,3
29827_0,,,,2,3,2,5
C(CO)(C(CO)(CO)C(CO)O)=O,,,5,1,4,0,4
29829_0,,,,2,3,2,5
C(C(C(CO)O)(C(C)O)C(C)O)=O,,,5,1,3,0,3
29831_0,,,,2,3,2,5
C(C(C(CO)(C(C)O)C(C)O)O)=O,,,5,1,1,0,1
29832_0,,,,2,3,2,5
29834_0,,,,2,3,2,5
C(C(C(CO)(CO)C(C)O)O)=O,,,5,1,1,0,1
29835_0,,,,2,3,2,5
29837_0,,,,2,3,2,5
C(C(C(CO)(CO)CO)O)=O,,,5,1,1,0,1
29838_0,,,,2,3,2,5
29840_0,,,,2,3,2,5
C(C(C(CO)(CO)C(CO)O)O)=O,,,5,1,1,0,1
29841_0,,,,2,3,2,5
29842_0,,,,2,3,2,5
29843_0,,,,2,3,2,5
29844_0,,,,2,3,2,5
29846_0,,,,2,3,2,5
C(CCO)(C(C(C)O)(C(C)O)O)=O,,,5,1,3,0,3
29847_0,,,,2,3,2,5
29848_0,,,,2,3,2,5
29849_0,,,,2,3,2,5
29851_0,,,,2,3,2,5
CC(CC(C(CO)(C(C)O)O)O)O,,,5,1,2,0,2
29853_0,,,,2,3,2,5
CC(CC(C(CO)(CO)O)O)O,,,5,1,2,0,2
29854_0,,,,2,3,2,5
29855_0,,,,2,3,2,5
29856_0,,,,2,3,2,5
29858_0,,,,2,3,2,5
C(C(CO)(C(CO)(C(C)O)O)O)=O,,,5,1,6,0,6
29860_0,,,,2,3,2,5
CC(CO)(C(CO)(C(C)O)O)O,,,5,1,2,0,2
29861_0,,,,2,3,2,5
29863_0,,,,2,3,2,5
C(C(C)(C(CO)(C(C)O)O)O)(O)=O,,,5,1,3,0,3
29865_0,,,,2,3,2,5
C(CC(C(CO)(C(C)O)O)O)(O)=O,,,5,1,3,0,3
29867_0,,,,2,3,2,5
C(C(C(C)O)(C(C=C)(CO)O)O)=O,,,5,1,3,0,3
29869_0,,,,2,3,2,5
C(C(C=C)(C(CO)(C(C)O)O)O)=O,,,5,1,3,0,3
29870_0,,,,2,3,2,5
29872_0,,,,2,3,2,5
C(C(C(C)O)(C(C=CCO)O)O)=O,,,5,1,3,0,3
29874_0,,,,2,3,2,5
C(C(C(CO)(C(C)O)O)O)=CC=O,,,5,1,2,0,2
29876_0,,,,2,3,2,5
CC(C(CO)(C(C)O)O)O,,,5,1,2,0,2
29878_0,,,,2,3,2,5
CC(C(C(C(CO)(CO)O)O)O)O,,,5,1,2,0,2
29879_0,,,,2,3,2,5
29881_0,,,,2,3,2,5
C(C(C(CO)O)C(CCO)O)(O)=O,,,5,1,3,0,3
29882_0,,,,2,3,2,5
29883_0,,,,2,3,2,5
29884_0,,,,2,3,2,5
29885_0,,,,2,3,2,5
29886_0,,,,2,3,2,5
29887_0,,,,2,3,2,5
29888_0,,,,2,3,2,5
29889_0,,,,2,3,2,5
29890_0,,,,2,3,2,5
29891_0,,,,2,3,2,5
29892_0,,,,2,3,2,5
29893_0,,,,2,3,2,5
29894_0,,,,2,3,2,5
29895_0,,,,2,3,2,5
29896_0,,,,2,3,2,5
29897_0,,,,2,3,2,5
29898_0,,,,2,3,2,5
29899_0,,,,2,3,2,5
29900_0,,,,2,3,2,5
29902_0,,,,2,3,2,5
C(C(C(CO)O)C(C)(CO)O)(O)=O,,,5,1,3,0,3
29904_0,,,,2,3,2,5
C(C)(C(CO)(C(C=C)(CO)O)O)=O,,,5,1,3,0,3
29906_0,,,,2,3,2,5
C(C)(C(CO)(C(C=CCO)O)O)=O,,,5,1,3,0,3
29907_0,,,,2,3,2,5
29908_0,,,,2,3,2,5
29909_0,,,,2,3,2,5
29910_0,,,,2,3,2,5
29911_0,,,,2,3,2,5
29912_0,,,,2,3,2,5
29913_0,,,,2,3,2,5
29914_0,,,,2,3,2,5
29915_0,,,,2,3,2,5
29916_0,,,,2,3,2,5
29918_0,,,,2,3,2,5
C(C(CO)O)(C(CO)(CO)CO)=O,,,5,1,2,0,2
29920_0,,,,2,3,2,5
C1(COCC1(C(C=C)(CO)O)O)=O,,,5,1,3,0,3
29922_0,,,,2,3,2,5
C1(COCC1(C(C=CCO)O)O)=O,,,5,1,3,0,3
29923_0,,,,2,3,2,5
29924_0,,,,2,3,2,5
29925_0,,,,2,3,2,5
29927_0,,,,2,3,2,5
C1C(C(CO1)O)(C(CO)(CO)O)O,,,5,1,2,0,2
29929_0,,,,2,3,2,5
C1CC(C(O)O1)(C(CO)(CO)O)O,,,5,1,3,0,3
29931_0,,,,2,3,2,5
C1(C(C(CO1)O)C(C=C)(CO)O)=O,,,5,1,2,0,2
29933_0,,,,2,3,2,5
C1(C(C(CO1)O)C(C=CCO)O)=O,,,5,1,2,0,2
29934_0,,,,2,3,2,5
29935_0,,,,2,3,2,5
29936_0,,,,2,3,2,5
29938_0,,,,2,3,2,5
C1C(CC(O)O1)(C(CO)(CO)O)O,,,5,1,3,0,3
29940_0,,,,2,3,2,5
C(C(C=C)(C(CO)(CO)O)O)=O,,,5,1,5,0,5
29942_0,,,,2,3,2,5
C(C(CO)(C(C=C)(CO)O)O)=O,,,5,1,4,0,4
29944_0,,,,2,3,2,5
C(C(CO)(C(C=C)(CO)O)O)(O)=O,,,5,1,3,0,3
29945_0,,,,2,3,2,5
29947_0,,,,2,3,2,5
C(C(C(C)=O)(C(C=C)(CO)O)O)=O,,,5,1,3,0,3
29948_0,,,,2,3,2,5
29949_0,,,,2,3,2,5
29951_0,,,,2,3,2,5
C(C(C(CO)(CO)O)O)=CC=O,,,5,1,4,0,4
29953_0,,,,2,3,2,5
C(C(CO)(C(C=CCO)O)O)=O,,,5,1,5,0,5
29955_0,,,,2,3,2,5
C(C(CO)(C(C=CCO)O)O)(O)=O,,,5,1,3,0,3
29956_0,,,,2,3,2,5
29958_0,,,,2,3,2,5
C(C(C(C)=O)(C(C=CCO)O)O)=O,,,5,1,3,0,3
29959_0,,,,2,3,2,5
29960_0,,,,2,3,2,5
29961_0,,,,2,3,2,5
29962_0,,,,2,3,2,5
29964_0,,,,2,3,2,5
C(C1(C(C(CC1(CO)O)O)O)O)O,,,5,1,1,0,1
29966_0,,,,2,3,2,5
C(C1(CC(CC1(CO)O)O)O)=O,,,5,1,2,0,2
29968_0,,,,2,3,2,5
C(C1(CC(CC1O)O)O)O,,,5,1,1,0,1
29970_0,,,,2,3,2,5
C(C1(CC(C(C1O)O)O)O)O,,,5,1,1,0,1
29972_0,,,,2,3,2,5
C(C1(C(CC(CO)(C1O)O)O)O)O,,,5,1,1,0,1
29973_0,,,,2,3,2,5
29974_0,,,,2,3,2,5
29975_0,,,,2,3,2,5
29976_0,,,,2,3,2,5
29977_0,,,,2,3,2,5
29978_0,,,,2,3,2,5
29980_0,,,,2,3,2,5
C(C(C(CC(CO)(C)O)O)O)(O)=O,,,5,1,2,0,2
29982_0,,,,2,3,2,5
C(C)(C(C(C)O)(CC(CO)=O)O)=O,,,5,1,2,0,2
29983_0,,,,2,3,2,5
29985_0,,,,2,3,2,5
C(C)(C(CCO)(C(CCO)O)O)=O,,,5,1,2,0,2
29987_0,,,,2,3,2,5
C(C)(C(CCO)(C(CO)(C)O)O)=O,,,5,1,2,0,2
29989_0,,,,2,3,2,5
C(C)(C(CCO)(C(C(O)=O)O)O)=O,,,5,1,2,0,2
29990_0,,,,2,3,2,5
29992_0,,,,2,3,2,5
C(C)(C(CCO)(C(C=O)O)O)=O,,,5,1,2,0,2
29993_0,,,,2,3,2,5
29995_0,,,,2,3,2,5
C(C(C)(C(C(C)=O)(CCO)O)O)=O,,,5,1,2,0,2
29997_0,,,,2,3,2,5
C(C)(C(CCO)(C(C(C)=O)O)O)=O,,,5,1,2,0,2
29998_0,,,,2,3,2,5
30000_0,,,,2,3,2,5
C(CC(C(C(C)=O)(CCO)O)O)=O,,,5,1,2,0,2
30002_0,,,,2,3,2,5
C(C)(C(C(C)O)(CCO)O)=O,,,5,1,2,0,2
30004_0,,,,2,3,2,5
C(C)(C(C(CO)O)(CCO)O)=O,,,5,1,2,0,2
30006_0,,,,2,3,2,5
C(C(C(CO)(CC(C)O)O)O)(O)=O,,,5,1,2,0,2
30008_0,,,,2,3,2,5
C(C(C)(C(C(CO)CO)O)O)(O)=O,,,5,1,2,0,2
30010_0,,,,2,3,2,5
C(CCO)(C(C(C)O)(CCO)O)=O,,,5,1,2,0,2
30012_0,,,,2,3,2,5
C(CCO)(C(CO)(CCO)O)=O,,,5,1,2,0,2
30014_0,,,,2,3,2,5
C(CO)(C(C)(C(CC(C)O)O)O)=O,,,5,1,2,0,2
30016_0,,,,2,3,2,5
CC(CC(C(CO)(CCO)O)O)O,,,5,1,1,0,1
30018_0,,,,2,3,2,5
C(CC(CO)(C(CC(C)O)O)O)=O,,,5,1,1,0,1
30019_0,,,,2,3,2,5
30021_0,,,,2,3,2,5
C(CO)(C(C)(C(CCO)O)O)=O,,,5,1,2,0,2
30023_0,,,,2,3,2,5
C(C(CCO)(C(CCO)O)O)O,,,5,1,1,0,1
30024_0,,,,2,3,2,5
30026_0,,,,2,3,2,5
C(CC(CO)(C(CCO)O)O)(O)=O,,,5,1,1,0,1
30028_0,,,,2,3,2,5
C(C(C)(C(C=C)(CO)O)O)(O)=O,,,5,1,3,0,3
30030_0,,,,2,3,2,5
C(C(C)(C(C=CCO)O)O)(O)=O,,,5,1,4,0,4
30031_0,,,,2,3,2,5
30032_0,,,,2,3,2,5
30033_0,,,,2,3,2,5
30034_0,,,,2,3,2,5
30035_0,,,,2,3,2,5
30036_0,,,,2,3,2,5
30037_0,,,,2,3,2,5
30038_0,,,,2,3,2,5
30039_0,,,,2,3,2,5
30040_0,,,,2,3,2,5
30041_0,,,,2,3,2,5
30042_0,,,,2,3,2,5
30043_0,,,,2,3,2,5
30044_0,,,,2,3,2,5
30045_0,,,,2,3,2,5
30047_0,,,,2,3,2,5
C(CO)(C(C)(C(CO)(C)O)O)=O,,,5,1,2,0,2
30048_0,,,,2,3,2,5
30049_0,,,,2,3,2,5
30051_0,,,,2,3,2,5
C(CC(C(C(CO)=O)(C)O)O)(O)=O,,,5,1,2,0,2
30053_0,,,,2,3,2,5
C=CC(CO)(C(C(C=O)=O)(C)O)O,,,5,1,2,0,2
30055_0,,,,2,3,2,5
C(C(C=C)(C(C(CO)=O)(C)O)O)=O,,,5,1,3,0,3
30056_0,,,,2,3,2,5
30058_0,,,,2,3,2,5
C(CO)=CC(C(C(C=O)=O)(C)O)O,,,5,1,2,0,2
30060_0,,,,2,3,2,5
C(CO)(C(C)(C(C=CC=O)O)O)=O,,,5,1,2,0,2
30062_0,,,,2,3,2,5
C(CO)(C(C)(C(C(CO)O)O)O)=O,,,5,1,4,0,4
30063_0,,,,2,3,2,5
30064_0,,,,2,3,2,5
30066_0,,,,2,3,2,5
C(C(C)(C(C(CO)=O)(C)O)O)=O,,,5,1,3,0,3
30067_0,,,,2,3,2,5
30068_0,,,,2,3,2,5
30069_0,,,,2,3,2,5
30071_0,,,,2,3,2,5
C(CO)(C(C)(C(C)O)O)=O,,,5,1,2,0,2
30072_0,,,,2,3,2,5
30073_0,,,,2,3,2,5
30075_0,,,,2,3,2,5
CC(CO)(C(CO)(CCO)O)O,,,5,1,1,0,1
30076_0,,,,2,3,2,5
30078_0,,,,2,3,2,5
C(CC(CO)(C(C)(CO)O)O)(O)=O,,,5,1,1,0,1
30080_0,,,,2,3,2,5
C(CC(C(CO)(CCO)O)O)(O)=O,,,5,1,1,0,1
30082_0,,,,2,3,2,5
C(C(CCO)(C(C=C)(CO)O)O)=O,,,5,1,2,0,2
30084_0,,,,2,3,2,5
C(C(C=C)(C(CO)(CCO)O)O)=O,,,5,1,2,0,2
30085_0,,,,2,3,2,5
30087_0,,,,2,3,2,5
C(C(CCO)(C(C=CCO)O)O)=O,,,5,1,2,0,2
30089_0,,,,2,3,2,5
C(C(C(CO)(CCO)O)O)=CC=O,,,5,1,1,0,1
30090_0,,,,2,3,2,5
30091_0,,,,2,3,2,5
30092_0,,,,2,3,2,5
30093_0,,,,2,3,2,5
30095_0,,,,2,3,2,5
C1(C(C(C=C)(CO)O)(O)OCC1)=O,,,5,1,2,0,2
30097_0,,,,2,3,2,5
C1(C(C(C=CCO)O)(O)OCC1)=O,,,5,1,2,0,2
30098_0,,,,2,3,2,5
30099_0,,,,2,3,2,5
30100_0,,,,2,3,2,5
30102_0,,,,2,3,2,5
C(C(C(C=C)(CO)O)O)(O)=O,,,5,1,3,0,3
30104_0,,,,2,3,2,5
C(C(C=C)(C(CO)(CC=O)O)O)=O,,,5,1,2,0,2
30105_0,,,,2,3,2,5
30107_0,,,,2,3,2,5
C(CC(C=O)(C(C=C)(CO)O)O)=O,,,5,1,2,0,2
30108_0,,,,2,3,2,5
30109_0,,,,2,3,2,5
30111_0,,,,2,3,2,5
C(C(C(C=CCO)O)O)(O)=O,,,5,1,4,0,4
30112_0,,,,2,3,2,5
30113_0,,,,2,3,2,5
30115_0,,,,2,3,2,5
C(CC(C=O)(C(C=CCO)O)O)=O,,,5,1,2,0,2
30117_0,,,,2,3,2,5
C(CO)(OCCO)=O,,,5,1,1,0,1
30119_0,,,,2,3,2,5
C(CO)(OC(CO)CO)=O,,,5,1,1,0,1
30121_0,,,,2,3,2,5
C(CO)(OC(CO)C(CO)O)=O,,,5,1,2,0,2
30123_0,,,,2,3,2,5
C(CO)(OCC(CO)O)=O,,,5,1,1,0,1
30124_0,,,,2,3,2,5
30126_0,,,,2,3,2,5
C(CO)(OCC(C(CO)O)O)=O,,,5,1,1,0,1
30128_0,,,,2,3,2,5
C(C(C(CO)O)O)(CCCO)=O,,,5,1,2,0,2
30130_0,,,,2,3,2,5
C(CC(C(CO)O)O)(CCO)=O,,,5,1,2,0,2
30131_0,,,,2,3,2,5
30132_0,,,,2,3,2,5
30133_0,,,,2,3,2,5
30134_0,,,,2,3,2,5
30135_0,,,,2,3,2,5
30136_0,,,,2,3,2,5
30138_0,,,,2,3,2,5
C(C(CC(CO)CO)=O)=O,,,5,1,2,0,2
30139_0,,,,2,3,2,5
30141_0,,,,2,3,2,5
C(C(C=O)C(CO)CO)=O,,,5,1,2,0,2
30142_0,,,,2,3,2,5
30144_0,,,,2,3,2,5
C(C(C(CO)C(CO)CO)=O)=O,,,5,1,2,0,2
30145_0,,,,2,3,2,5
30147_0,,,,2,3,2,5
C(C(CO)C(CO)C(C=O)O)=O,,,5,1,2,0,2
30149_0,,,,2,3,2,5
C(C(C(CO)CO)C(C=O)O)=O,,,5,1,2,0,2
30150_0,,,,2,3,2,5
30152_0,,,,2,3,2,5
C(C(C(CO)=O)C(CO)CO)=O,,,5,1,2,0,2
30154_0,,,,2,3,2,5
C(C(CCO)=O)(C(CO)CO)=O,,,5,1,3,0,3
30155_0,,,,2,3,2,5
30156_0,,,,2,3,2,5
30157_0,,,,2,3,2,5
30159_0,,,,2,3,2,5
C(C(C(CC(CO)CO)=O)O)=O,,,5,1,2,0,2
30161_0,,,,2,3,2,5
C(C(CO)CCO)=O,,,5,1,2,0,2
30163_0,,,,2,3,2,5
C(CC(CO)CO)=O,,,5,1,2,0,2
30164_0,,,,2,3,2,5
30165_0,,,,2,3,2,5
30167_0,,,,2,3,2,5
C(C(CO)=O)(CCCO)=O,,,5,1,2,0,2
30169_0,,,,2,3,2,5
C(C(CO)=O)(C(CO)CCO)=O,,,5,1,3,0,3
30171_0,,,,2,3,2,5
C(CC(C(CO)=O)O)(CCO)=O,,,5,1,2,0,2
30173_0,,,,2,3,2,5
C(CCCO)(C(C(CO)=O)O)=O,,,5,1,2,0,2
30174_0,,,,2,3,2,5
30175_0,,,,2,3,2,5
30177_0,,,,2,3,2,5
C(C(CO)=O)(CCC(CO)O)=O,,,5,1,2,0,2
30179_0,,,,2,3,2,5
C(C(CCO)C(C(CO)=O)O)=O,,,5,1,3,0,3
30181_0,,,,2,3,2,5
C(CC(CO)C(C(CO)=O)O)=O,,,5,1,3,0,3
30182_0,,,,2,3,2,5
30184_0,,,,2,3,2,5
C(CO)(C(C)C(C(CO)=O)O)=O,,,5,1,2,0,2
30185_0,,,,2,3,2,5
30186_0,,,,2,3,2,5
30188_0,,,,2,3,2,5
C(C(CC(CO)C(CO)O)=O)=O,,,5,1,3,0,3
30190_0,,,,2,3,2,5
C(CO)(C(CO)CC(CO)=O)=O,,,5,1,5,0,5
30191_0,,,,2,3,2,5
30193_0,,,,2,3,2,5
C(C(C=O)C(CO)C(CO)O)=O,,,5,1,3,0,3
30194_0,,,,2,3,2,5
30196_0,,,,2,3,2,5
C(C(CCO)C(CO)O)=O,,,5,1,3,0,3
30198_0,,,,2,3,2,5
C(CC(CO)C(CO)O)=O,,,5,1,3,0,3
30200_0,,,,2,3,2,5
C(CO)(C(CO)CCO)=O,,,5,1,2,0,2
30201_0,,,,2,3,2,5
30202_0,,,,2,3,2,5
30204_0,,,,2,3,2,5
C(C(C(CO)O)=O)(CCCO)=O,,,5,1,2,0,2
30206_0,,,,2,3,2,5
C(C(CO)CO)(CC(CO)=O)=O,,,5,1,3,0,3
30207_0,,,,2,3,2,5
30209_0,,,,2,3,2,5
C(CCO)(C(CO)CO)=O,,,5,1,2,0,2
30211_0,,,,2,3,2,5
C(CCO)(C(CO)C(CO)O)=O,,,5,1,2,0,2
30213_0,,,,2,3,2,5
C(C(C(C(CCO)=O)=O)C)=O,,,5,1,2,0,2
30214_0,,,,2,3,2,5
30216_0,,,,2,3,2,5
C(C(C(CO)=O)C)=O,,,5,1,2,0,2
30217_0,,,,2,3,2,5
30219_0,,,,2,3,2,5
C(C)(CC(C(CCO)=O)=O)=O,,,5,1,2,0,2
30221_0,,,,2,3,2,5
C(CCO)(CC(C(C)=O)=O)=O,,,5,1,3,0,3
30222_0,,,,2,3,2,5
30224_0,,,,2,3,2,5
C(CCC(C=O)=O)(CCO)=O,,,5,1,3,0,3
30226_0,,,,2,3,2,5
C(CC(CCC(CO)=O)=O)=O,,,5,1,3,0,3
30228_0,,,,2,3,2,5
C(CCCO)(CC(C=O)=O)=O,,,5,1,2,0,2
30230_0,,,,2,3,2,5
C(CCC(CC(CO)=O)=O)=O,,,5,1,3,0,3
30232_0,,,,2,3,2,5
C(C(CCO)CC(C=O)=O)=O,,,5,1,4,0,4
30234_0,,,,2,3,2,5
C(CC(CO)CC(C=O)=O)=O,,,5,1,5,0,5
30235_0,,,,2,3,2,5
30237_0,,,,2,3,2,5
C(CO)(CCC(C(C)=O)=O)=O,,,5,1,2,0,2
30239_0,,,,2,3,2,5
C(CC(C)=O)(CC(CO)=O)=O,,,5,1,2,0,2
30241_0,,,,2,3,2,5
C(CO)(C(C)CC(C=O)=O)=O,,,5,1,2,0,2
30243_0,,,,2,3,2,5
C(CC(C(C=O)=O)C)(CO)=O,,,5,1,2,0,2
30245_0,,,,2,3,2,5
C(CO)(CCC(CO)=O)=O,,,5,1,2,0,2
30246_0,,,,2,3,2,5
30248_0,,,,2,3,2,5
C(CCC(C(CO)O)=O)(CO)=O,,,5,1,4,0,4
30249_0,,,,2,3,2,5
30250_0,,,,2,3,2,5
30251_0,,,,2,3,2,5
30252_0,,,,2,3,2,5
30254_0,,,,2,3,2,5
C(CC(C(CCCO)=O)=O)=O,,,5,1,2,0,2
30255_0,,,,2,3,2,5
30256_0,,,,2,3,2,5
30258_0,,,,2,3,2,5
C(C(C=O)CC(CCO)=O)=O,,,5,1,2,0,2
30259_0,,,,2,3,2,5
30261_0,,,,2,3,2,5
C(C(C=O)C(CCCO)=O)=O,,,5,1,2,0,2
30262_0,,,,2,3,2,5
30264_0,,,,2,3,2,5
C(C(C=O)C(C=O)CCO)=O,,,5,1,4,0,4
30266_0,,,,2,3,2,5
C(C(C=O)C(CO)CC=O)=O,,,5,1,5,0,5
30267_0,,,,2,3,2,5
30268_0,,,,2,3,2,5
30269_0,,,,2,3,2,5
30271_0,,,,2,3,2,5
C(C(C=O)C(C(CO)=O)C)=O,,,5,1,2,0,2
30272_0,,,,2,3,2,5
30273_0,,,,2,3,2,5
30274_0,,,,2,3,2,5
30275_0,,,,2,3,2,5
30276_0,,,,2,3,2,5
30278_0,,,,2,3,2,5
C(C(C=O)CCO)=O,,,5,1,5,0,5
30279_0,,,,2,3,2,5
30281_0,,,,2,3,2,5
C(C(C(CO)=O)CCO)=O,,,5,1,5,0,5
30282_0,,,,2,3,2,5
30284_0,,,,2,3,2,5
C(C(CCO)=O)(CCO)=O,,,5,1,2,0,2
30285_0,,,,2,3,2,5
30286_0,,,,2,3,2,5
30287_0,,,,2,3,2,5
30288_0,,,,2,3,2,5
30289_0,,,,2,3,2,5
30291_0,,,,2,3,2,5
C(CC(CCCO)=O)=O,,,5,1,2,0,2
30293_0,,,,2,3,2,5
C(CCC=O)(CCO)=O,,,5,1,2,0,2
30294_0,,,,2,3,2,5
30296_0,,,,2,3,2,5
C(CC(C=O)O)(CCO)=O,,,5,1,4,0,4
30297_0,,,,2,3,2,5
30298_0,,,,2,3,2,5
30299_0,,,,2,3,2,5
30301_0,,,,2,3,2,5
C(C(C(CCCO)=O)O)=O,,,5,1,4,0,4
30303_0,,,,2,3,2,5
C(C(CCC(CO)=O)O)=O,,,5,1,4,0,4
30304_0,,,,2,3,2,5
30305_0,,,,2,3,2,5
30307_0,,,,2,3,2,5
C(C(C(CO)CC(CO)=O)O)=O,,,5,1,3,0,3
30308_0,,,,2,3,2,5
30310_0,,,,2,3,2,5
C(C(CO)C(C=O)O)(CCO)=O,,,5,1,2,0,2
30312_0,,,,2,3,2,5
C(C(CCO)C(C=O)O)=O,,,5,1,5,0,5
30313_0,,,,2,3,2,5
30314_0,,,,2,3,2,5
30315_0,,,,2,3,2,5
30316_0,,,,2,3,2,5
30317_0,,,,2,3,2,5
30319_0,,,,2,3,2,5
C(CC(CO)CC=O)=O,,,5,1,3,0,3
30320_0,,,,2,3,2,5
30321_0,,,,2,3,2,5
30322_0,,,,2,3,2,5
30323_0,,,,2,3,2,5
30324_0,,,,2,3,2,5
30326_0,,,,2,3,2,5
C(CCO)(CC(C)=O)=O,,,5,1,3,0,3
30328_0,,,,2,3,2,5
C(C(CCO)=O)(CC)=O,,,5,1,2,0,2
30329_0,,,,2,3,2,5
30331_0,,,,2,3,2,5
C(CCO)(C(C(CCO)=O)O)=O,,,5,1,2,0,2
30333_0,,,,2,3,2,5
C(C(CCO)=O)(CC(CO)O)=O,,,5,1,2,0,2
30335_0,,,,2,3,2,5
C(CCO)(C(C(C)=O)O)=O,,,5,1,3,0,3
30337_0,,,,2,3,2,5
C(C(C)=O)(CCCO)=O,,,5,1,2,0,2
30338_0,,,,2,3,2,5
30339_0,,,,2,3,2,5
30341_0,,,,2,3,2,5
C(C(C(C)CCO)=O)=O,,,5,1,2,0,2
30343_0,,,,2,3,2,5
C(CO)(C(C)CC=O)=O,,,5,1,2,0,2
30345_0,,,,2,3,2,5
C(CO)(C(C)C(C=O)O)=O,,,5,1,2,0,2
30346_0,,,,2,3,2,5
30347_0,,,,2,3,2,5
30348_0,,,,2,3,2,5
30350_0,,,,2,3,2,5
C(CO)(CC)=O,,,5,1,2,0,2
30352_0,,,,2,3,2,5
C(CO)(CCCO)=O,,,5,1,4,0,4
30354_0,,,,2,3,2,5
C(CCO)(CCO)=O,,,5,1,2,0,2
30356_0,,,,2,3,2,5
C(C(CO)O)(CCCO)=O,,,5,1,2,0,2
30358_0,,,,2,3,2,5
C(CC(CO)O)(CCO)=O,,,5,1,2,0,2
30360_0,,,,2,3,2,5
C(CCCO)=O,,,5,1,4,0,4
30362_0,,,,2,3,2,5
C(C)(C(CO)C(C(CO)O)O)=O,,,5,1,2,0,2
30363_0,,,,2,3,2,5
30364_0,,,,2,3,2,5
30365_0,,,,2,3,2,5
30366_0,,,,2,3,2,5
30367_0,,,,2,3,2,5
30368_0,,,,2,3,2,5
30369_0,,,,2,3,2,5
30370_0,,,,2,3,2,5
30372_0,,,,2,3,2,5
C(C(C(C)=O)(C(CO)CO)O)=O,,,5,1,1,0,1
30373_0,,,,2,3,2,5
30374_0,,,,2,3,2,5
30376_0,,,,2,3,2,5
C(C)(C(C(C(C)=O)=O)CO)=O,,,5,1,2,0,2
30378_0,,,,2,3,2,5
C(C(C)=O)(C(CO)CO)=O,,,5,1,3,0,3
30380_0,,,,2,3,2,5
C(C(C)=O)(C(CO)C(CO)O)=O,,,5,1,2,0,2
30381_0,,,,2,3,2,5
30382_0,,,,2,3,2,5
30383_0,,,,2,3,2,5
30384_0,,,,2,3,2,5
30385_0,,,,2,3,2,5
30386_0,,,,2,3,2,5
30387_0,,,,2,3,2,5
30388_0,,,,2,3,2,5
30390_0,,,,2,3,2,5
C(C(CO)(CC(CCO)=O)O)=O,,,5,1,2,0,2
30391_0,,,,2,3,2,5
30392_0,,,,2,3,2,5
30394_0,,,,2,3,2,5
C(CCC=O)(C(CO)(CO)O)=O,,,5,1,4,0,4
30396_0,,,,2,3,2,5
C(C(C(CCCO)=O)(CO)O)=O,,,5,1,3,0,3
30398_0,,,,2,3,2,5
C(CC(C=O)O)(C(CO)CO)=O,,,5,1,2,0,2
30399_0,,,,2,3,2,5
30400_0,,,,2,3,2,5
30401_0,,,,2,3,2,5
30403_0,,,,2,3,2,5
C(C(CCO)C(C=O)(CO)O)=O,,,5,1,3,0,3
30405_0,,,,2,3,2,5
C(C(CO)(C(CO)CC=O)O)=O,,,5,1,3,0,3
30407_0,,,,2,3,2,5
C(C)(C(C(C)=O)CO)=O,,,5,1,2,0,2
30408_0,,,,2,3,2,5
30410_0,,,,2,3,2,5
C(CCO)(C(C(C)=O)(CO)O)=O,,,5,1,2,0,2
30411_0,,,,2,3,2,5
30413_0,,,,2,3,2,5
C(C(C(C)=O)(CCO)O)=O,,,5,1,3,0,3
30414_0,,,,2,3,2,5
30416_0,,,,2,3,2,5
C(C)(C(C(C)=O)(CO)O)=O,,,5,1,3,0,3
30417_0,,,,2,3,2,5
30419_0,,,,2,3,2,5
C(C(CO)CO)(C(C(C)=O)O)=O,,,5,1,2,0,2
30421_0,,,,2,3,2,5
C(C(CO)(CO)O)(CC(C)=O)=O,,,5,1,5,0,5
30422_0,,,,2,3,2,5
30424_0,,,,2,3,2,5
C(C(CO)(C(C(CO)=O)C)O)=O,,,5,1,2,0,2
30426_0,,,,2,3,2,5
C(C)(C(CO)CO)=O,,,5,1,2,0,2
30428_0,,,,2,3,2,5
C(C)(C(CO)C(CO)O)=O,,,5,1,2,0,2
30429_0,,,,2,3,2,5
30430_0,,,,2,3,2,5
30431_0,,,,2,3,2,5
30432_0,,,,2,3,2,5
30433_0,,,,2,3,2,5
30434_0,,,,2,3,2,5
30435_0,,,,2,3,2,5
30436_0,,,,2,3,2,5
30437_0,,,,2,3,2,5
30438_0,,,,2,3,2,5
30440_0,,,,2,3,2,5
C(C(C(C(C)=O)=O)CCO)=O,,,5,1,2,0,2
30441_0,,,,2,3,2,5
30443_0,,,,2,3,2,5
C(C(C(CC=O)=O)CCO)=O,,,5,1,2,0,2
30444_0,,,,2,3,2,5
30446_0,,,,2,3,2,5
C(C(CCCO)=O)(O)=O,,,5,1,4,0,4
30447_0,,,,2,3,2,5
30449_0,,,,2,3,2,5
C(C(C(CO)CCO)=O)(O)=O,,,5,1,3,0,3
30451_0,,,,2,3,2,5
C(C)(C(CO)CC=O)=O,,,5,1,3,0,3
30453_0,,,,2,3,2,5
C(C(C(C)=O)CCO)=O,,,5,1,2,0,2
30454_0,,,,2,3,2,5
30455_0,,,,2,3,2,5
30456_0,,,,2,3,2,5
30458_0,,,,2,3,2,5
C(C(C(CCO)=O)(CCO)O)=O,,,5,1,2,0,2
30459_0,,,,2,3,2,5
30461_0,,,,2,3,2,5
C(C(C(C(CO)O)=O)CCO)=O,,,5,1,3,0,3
30462_0,,,,2,3,2,5
30463_0,,,,2,3,2,5
30464_0,,,,2,3,2,5
30465_0,,,,2,3,2,5
30467_0,,,,2,3,2,5
C(C(C(CCCO)=O)O)(O)=O,,,5,1,3,0,3
30469_0,,,,2,3,2,5
C(C(CCC(CO)O)=O)(O)=O,,,5,1,4,0,4
30470_0,,,,2,3,2,5
30471_0,,,,2,3,2,5
30472_0,,,,2,3,2,5
30473_0,,,,2,3,2,5
30474_0,,,,2,3,2,5
30476_0,,,,2,3,2,5
C(CO)(C(C)C(C(O)=O)O)=O,,,5,1,2,0,2
30478_0,,,,2,3,2,5
C(CC1C(C(C(O)O1)O)O)O,,,5,1,2,0,2
30480_0,,,,2,3,2,5
C1(C(CO)C(C(CO)O1)O)O,,,5,1,2,0,2
30482_0,,,,2,3,2,5
C1C(C(C(O)O1)CO)O,,,5,1,2,0,2
30484_0,,,,2,3,2,5
C1C(C(C(O)O1)(CCO)O)O,,,5,1,2,0,2
30486_0,,,,2,3,2,5
C1C(C(C(C(O)O1)CO)O)O,,,5,1,2,0,2
30488_0,,,,2,3,2,5
C1(C(C(C(CCO)O1)O)O)=O,,,5,1,2,0,2
30490_0,,,,2,3,2,5
C(C(C(C(CO)O)O)O)=CCO,,,5,1,2,0,2
30491_0,,,,2,3,2,5
30492_0,,,,2,3,2,5
30493_0,,,,2,3,2,5
30494_0,,,,2,3,2,5
30495_0,,,,2,3,2,5
30496_0,,,,2,3,2,5
30497_0,,,,2,3,2,5
30498_0,,,,2,3,2,5
30499_0,,,,2,3,2,5
30500_0,,,,2,3,2,5
30501_0,,,,2,3,2,5
30502_0,,,,2,3,2,5
30503_0,,,,2,3,2,5
30504_0,,,,2,3,2,5
30505_0,,,,2,3,2,5
30507_0,,,,2,3,2,5
C(CO)(CO)=CC(CO)=O,,,5,1,3,0,3
30509_0,,,,2,3,2,5
C(CO)(CO)=C(C=O)CO,,,5,1,2,0,2
30511_0,,,,2,3,2,5
C=C(C(CO)=O)C(CO)(CO)O,,,5,1,2,0,2
30513_0,,,,2,3,2,5
C(CO)(CO)=C(C(CO)=O)CO,,,5,1,3,0,3
30515_0,,,,2,3,2,5
C(CO)=C(C=O)C(CO)(CO)O,,,5,1,4,0,4
30517_0,,,,2,3,2,5
C(CO)(C(CO)(CO)O)=CC=O,,,5,1,4,0,4
30519_0,,,,2,3,2,5
C(CO)(CO)=C(C=O)C(CO)O,,,5,1,2,0,2
30521_0,,,,2,3,2,5
C(C(C(CO)=C(CO)CO)O)=O,,,5,1,2,0,2
30522_0,,,,2,3,2,5
30524_0,,,,2,3,2,5
C(CO)(CO)=CC(C(CO)O)=O,,,5,1,2,0,2
30526_0,,,,2,3,2,5
C(CO)=C(CO)CO,,,5,1,2,0,2
30528_0,,,,2,3,2,5
C(CO)(C(C(CO)=C)O)=O,,,5,1,2,0,2
30530_0,,,,2,3,2,5
C(CO)(C(C=CCO)O)=O,,,5,1,2,0,2
30532_0,,,,2,3,2,5
C(CO)(C(C(CO)=CCO)O)=O,,,5,1,3,0,3
30534_0,,,,2,3,2,5
C(CO)(C(C=CC(CO)O)O)=O,,,5,1,2,0,2
30535_0,,,,2,3,2,5
30537_0,,,,2,3,2,5
C(CO)(C(C(C(CO)O)=C)O)=O,,,5,1,2,0,2
30539_0,,,,2,3,2,5
C(CO)(C(CO)O)=CC(CO)=O,,,5,1,2,0,2
30541_0,,,,2,3,2,5
C(CO)(C(CO)O)=C(C=O)CO,,,5,1,2,0,2
30543_0,,,,2,3,2,5
C(CO)(C(CO)O)=CCO,,,5,1,2,0,2
30545_0,,,,2,3,2,5
C(C(CO)O)(C(C(CO)=C)O)=O,,,5,1,2,0,2
30547_0,,,,2,3,2,5
C(C(CO)O)(C(C=CCO)O)=O,,,5,1,2,0,2
30549_0,,,,2,3,2,5
C(C(CO)(CO)O)=CC(CO)=O,,,5,1,3,0,3
30551_0,,,,2,3,2,5
C(C(CO)(CO)O)=C(C=O)CO,,,5,1,2,0,2
30553_0,,,,2,3,2,5
C(C(CO)(CO)O)=CCO,,,5,1,2,0,2
30555_0,,,,2,3,2,5
C(C(CO)(C(CO)O)O)=CCO,,,5,1,2,0,2
30557_0,,,,2,3,2,5
C(C(C)=CC(CO)=O)=O,,,5,1,2,0,2
30559_0,,,,2,3,2,5
C(C)(CO)=CC(C=O)=O,,,5,1,2,0,2
30561_0,,,,2,3,2,5
C(CO)(CC(C=O)=C)=O,,,5,1,2,0,2
30563_0,,,,2,3,2,5
C=C(CO)CC(C=O)=O,,,5,1,2,0,2
30565_0,,,,2,3,2,5
C(C(C)=C(C=O)CO)=O,,,5,1,2,0,2
30567_0,,,,2,3,2,5
C(C)(CO)=C(C=O)C=O,,,5,1,2,0,2
30568_0,,,,2,3,2,5
30570_0,,,,2,3,2,5
C(C(C=O)C(CO)=C)=O,,,5,1,2,0,2
30572_0,,,,2,3,2,5
C(C(C(C(CO)=O)=C)(C)O)=O,,,5,1,2,0,2
30574_0,,,,2,3,2,5
C=C(C(C=O)=O)C(CO)(C)O,,,5,1,3,0,3
30576_0,,,,2,3,2,5
C(C(C)=C(C(CO)=O)CO)=O,,,5,1,3,0,3
30578_0,,,,2,3,2,5
C(C)(CO)=C(C(C=O)=O)CO,,,5,1,2,0,2
30580_0,,,,2,3,2,5
C(CO)(C(C(C=O)=C)CO)=O,,,5,1,3,0,3
30582_0,,,,2,3,2,5
C=C(CO)C(C(C=O)=O)CO,,,5,1,2,0,2
30584_0,,,,2,3,2,5
C(C(C(C=O)=CCO)(C)O)=O,,,5,1,3,0,3
30586_0,,,,2,3,2,5
C(C(C(CO)=CC=O)(C)O)=O,,,5,1,3,0,3
30588_0,,,,2,3,2,5
C(C=C(C=O)C(CO)(C)O)=O,,,5,1,3,0,3
30590_0,,,,2,3,2,5
C(C(C(CO)O)=C(C=O)C)=O,,,5,1,2,0,2
30592_0,,,,2,3,2,5
C(C(C(CO)=C(C=O)C)O)=O,,,5,1,2,0,2
30594_0,,,,2,3,2,5
C(C(C(C=O)=C(CO)C)O)=O,,,5,1,2,0,2
30595_0,,,,2,3,2,5
30597_0,,,,2,3,2,5
C(C(C(C(C=O)=C)CO)O)=O,,,5,1,2,0,2
30599_0,,,,2,3,2,5
C(C(C(CO)=C)C(C=O)O)=O,,,5,1,2,0,2
30600_0,,,,2,3,2,5
30602_0,,,,2,3,2,5
C(C)(CO)=C(C=O)C(CO)=O,,,5,1,2,0,2
30603_0,,,,2,3,2,5
30605_0,,,,2,3,2,5
C(C(C(CO)=O)C(CO)=C)=O,,,5,1,2,0,2
30607_0,,,,2,3,2,5
C(CCO)(C(C(C=O)=C)O)=O,,,5,1,3,0,3
30609_0,,,,2,3,2,5
C(CC(C(C(CO)=C)O)=O)=O,,,5,1,2,0,2
30611_0,,,,2,3,2,5
C(C=C(C=O)C)(C(CO)O)=O,,,5,1,2,0,2
30613_0,,,,2,3,2,5
C(C(C(C=C(CO)C)=O)O)=O,,,5,1,2,0,2
30615_0,,,,2,3,2,5
C(C(CO)O)(CC(C=O)=C)=O,,,5,1,2,0,2
30617_0,,,,2,3,2,5
C(C(C=O)O)(CC(CO)=C)=O,,,5,1,2,0,2
30619_0,,,,2,3,2,5
C(CO)=C(C=O)C,,,5,1,2,0,2
30621_0,,,,2,3,2,5
C(C)(CO)=CC=O,,,5,1,2,0,2
30623_0,,,,2,3,2,5
C=C(C=O)CCO,,,5,1,2,0,2
30625_0,,,,2,3,2,5
C(CC(CO)=C)=O,,,5,1,2,0,2
30627_0,,,,2,3,2,5
C=C(C=O)C(CO)O,,,5,1,6,0,6
30629_0,,,,2,3,2,5
C(C(C(CO)=C)O)=O,,,5,1,4,0,4
30631_0,,,,2,3,2,5
C(C=CC(CO)=O)(C)=O,,,5,1,2,0,2
30633_0,,,,2,3,2,5
C(C(CO)=CC(C)=O)=O,,,5,1,2,0,2
30635_0,,,,2,3,2,5
C(C)(C(C(C(CO)=O)=C)O)=O,,,5,1,3,0,3
30637_0,,,,2,3,2,5
C(C(CO)=CC(C)=O)(CO)=O,,,5,1,3,0,3
30639_0,,,,2,3,2,5
C(C)(C(C(C=O)=CCO)O)=O,,,5,1,3,0,3
30641_0,,,,2,3,2,5
C(C)(C(C(CO)=CC=O)O)=O,,,5,1,3,0,3
30643_0,,,,2,3,2,5
C(C(C(CO)O)=CC(C)=O)=O,,,5,1,2,0,2
30645_0,,,,2,3,2,5
C(C(C(CO)=CC(C)=O)O)=O,,,5,1,2,0,2
30646_0,,,,2,3,2,5
30648_0,,,,2,3,2,5
C(C=CC(C)=O)(C(CO)O)=O,,,5,1,2,0,2
30650_0,,,,2,3,2,5
C(CO)=CC(C)=O,,,5,1,2,0,2
30652_0,,,,2,3,2,5
C(CC(C=O)=O)=CCO,,,5,1,3,0,3
30653_0,,,,2,3,2,5
30655_0,,,,2,3,2,5
C(CCO)=CC(C=O)=O,,,5,1,2,0,2
30656_0,,,,2,3,2,5
30658_0,,,,2,3,2,5
C(CO)=C(CO)CC(C=O)=O,,,5,1,3,0,3
30660_0,,,,2,3,2,5
C(CO)(CC(C=O)=CCO)=O,,,5,1,2,0,2
30662_0,,,,2,3,2,5
C(CO)(CCO)=CC(C=O)=O,,,5,1,3,0,3
30664_0,,,,2,3,2,5
C(C(CCO)=CC(CO)=O)=O,,,5,1,2,0,2
30666_0,,,,2,3,2,5
C(C=CC(CO)=O)(CCO)=O,,,5,1,2,0,2
30668_0,,,,2,3,2,5
C(C(CCO)O)=CC(C=O)=O,,,5,1,2,0,2
30669_0,,,,2,3,2,5
30671_0,,,,2,3,2,5
C(CC(C=O)=O)=CC(CO)O,,,5,1,3,0,3
30673_0,,,,2,3,2,5
C(C(C=CCC(CO)=O)O)=O,,,5,1,2,0,2
30675_0,,,,2,3,2,5
C(CC(CO)O)=CC(C=O)=O,,,5,1,2,0,2
30677_0,,,,2,3,2,5
C(C(CC=CC(CO)=O)O)=O,,,5,1,2,0,2
30679_0,,,,2,3,2,5
C(CO)(CC=CC(CO)=O)=O,,,5,1,3,0,3
30680_0,,,,2,3,2,5
30681_0,,,,2,3,2,5
30683_0,,,,2,3,2,5
C(CO)(CC(CO)=CC=O)=O,,,5,1,2,0,2
30684_0,,,,2,3,2,5
30686_0,,,,2,3,2,5
C(CC(CO)=CC(CO)=O)=O,,,5,1,2,0,2
30688_0,,,,2,3,2,5
C(C)(C(C=CC(CO)=O)O)=O,,,5,1,2,0,2
30690_0,,,,2,3,2,5
C=C(C(CO)O)CC(C=O)=O,,,5,1,2,0,2
30692_0,,,,2,3,2,5
C(C(C(CC(CO)=O)=C)O)=O,,,5,1,2,0,2
30694_0,,,,2,3,2,5
C(C)(C(CO)O)=CC(C=O)=O,,,5,1,2,0,2
30696_0,,,,2,3,2,5
C(C(C(C)=CC(CO)=O)O)=O,,,5,1,2,0,2
30698_0,,,,2,3,2,5
C(CO)(CC=C)=O,,,5,1,2,0,2
30700_0,,,,2,3,2,5
C(C)=CC(CO)=O,,,5,1,2,0,2
30702_0,,,,2,3,2,5
C(C(CO)O)=CC(CO)=O,,,5,1,4,0,4
30704_0,,,,2,3,2,5
C(C(C(CO)O)O)=CC(CO)=O,,,5,1,2,0,2
30705_0,,,,2,3,2,5
30707_0,,,,2,3,2,5
C(CC=C(C=O)CO)=O,,,5,1,2,0,2
30709_0,,,,2,3,2,5
C(CCO)=C(C=O)C=O,,,5,1,2,0,2
30710_0,,,,2,3,2,5
30712_0,,,,2,3,2,5
C(C(C=O)C=CCO)=O,,,5,1,2,0,2
30713_0,,,,2,3,2,5
30715_0,,,,2,3,2,5
C=C(C(C=O)=O)C(CCO)O,,,5,1,3,0,3
30717_0,,,,2,3,2,5
C(CC=C(C(CO)=O)CO)=O,,,5,1,3,0,3
30719_0,,,,2,3,2,5
C(CCO)=C(C(C=O)=O)CO,,,5,1,2,0,2
30720_0,,,,2,3,2,5
30722_0,,,,2,3,2,5
C(C(C(C=O)=O)CO)=CCO,,,5,1,2,0,2
30723_0,,,,2,3,2,5
30724_0,,,,2,3,2,5
30726_0,,,,2,3,2,5
C(C=C(C=O)C(CCO)O)=O,,,5,1,3,0,3
30728_0,,,,2,3,2,5
C(CC=C(C=O)C(CO)O)=O,,,5,1,2,0,2
30730_0,,,,2,3,2,5
C(CC=C(CO)C(C=O)O)=O,,,5,1,2,0,2
30732_0,,,,2,3,2,5
C(C(C(C=O)=CCCO)O)=O,,,5,1,2,0,2
30733_0,,,,2,3,2,5
30735_0,,,,2,3,2,5
C(C(C(C=CC=O)CO)O)=O,,,5,1,2,0,2
30737_0,,,,2,3,2,5
C(C(C=CCO)C(C=O)O)=O,,,5,1,2,0,2
30738_0,,,,2,3,2,5
30740_0,,,,2,3,2,5
C(CCO)=C(C=O)C(CO)=O,,,5,1,2,0,2
30741_0,,,,2,3,2,5
30743_0,,,,2,3,2,5
C(C(C(CO)=O)C=CCO)=O,,,5,1,2,0,2
30744_0,,,,2,3,2,5
30746_0,,,,2,3,2,5
C(CC(C(C=CCO)O)=O)=O,,,5,1,2,0,2
30747_0,,,,2,3,2,5
30749_0,,,,2,3,2,5
C(C(C(C=CCCO)=O)O)=O,,,5,1,2,0,2
30750_0,,,,2,3,2,5
30752_0,,,,2,3,2,5
C(C(C=O)O)(CC=CCO)=O,,,5,1,2,0,2
30754_0,,,,2,3,2,5
C(CC=CCO)=O,,,5,1,2,0,2
30756_0,,,,2,3,2,5
C(CCO)=CC=O,,,5,1,2,0,2
30757_0,,,,2,3,2,5
30759_0,,,,2,3,2,5
C(C(C=CCO)O)=O,,,5,1,3,0,3
30761_0,,,,2,3,2,5
C(C(C=O)C(CO)=CCO)=O,,,5,1,3,0,3
30762_0,,,,2,3,2,5
30764_0,,,,2,3,2,5
C(CO)(CCO)=C(C=O)C=O,,,5,1,3,0,3
30766_0,,,,2,3,2,5
C(C(CCO)=C(C=O)CO)=O,,,5,1,2,0,2
30768_0,,,,2,3,2,5
C(C=C(C=O)CO)(CCO)=O,,,5,1,2,0,2
30770_0,,,,2,3,2,5
C(C(CCO)O)=C(C=O)C=O,,,5,1,2,0,2
30771_0,,,,2,3,2,5
30773_0,,,,2,3,2,5
C(C(C=O)C=CC(CO)O)=O,,,5,1,2,0,2
30774_0,,,,2,3,2,5
30776_0,,,,2,3,2,5
C(CC(CO)O)=C(C=O)C=O,,,5,1,2,0,2
30778_0,,,,2,3,2,5
C(C(CC=C(C=O)CO)O)=O,,,5,1,2,0,2
30779_0,,,,2,3,2,5
30781_0,,,,2,3,2,5
C(CO)(CC=C(C=O)CO)=O,,,5,1,2,0,2
30782_0,,,,2,3,2,5
30783_0,,,,2,3,2,5
30784_0,,,,2,3,2,5
30786_0,,,,2,3,2,5
C(CC(CO)=C(C=O)CO)=O,,,5,1,2,0,2
30788_0,,,,2,3,2,5
C(C)(C(C=C(C=O)CO)O)=O,,,5,1,2,0,2
30790_0,,,,2,3,2,5
C(C(C=O)C(C(CO)O)=C)=O,,,5,1,2,0,2
30791_0,,,,2,3,2,5
30793_0,,,,2,3,2,5
C(C)(C(CO)O)=C(C=O)C=O,,,5,1,2,0,2
30795_0,,,,2,3,2,5
C(C(C(C)=C(C=O)CO)O)=O,,,5,1,2,0,2
30796_0,,,,2,3,2,5
30798_0,,,,2,3,2,5
C(C)=C(C=O)CO,,,5,1,2,0,2
30800_0,,,,2,3,2,5
C(C(CO)O)=C(C=O)CO,,,5,1,2,0,2
30802_0,,,,2,3,2,5
C(C(C(CO)O)O)=C(C=O)CO,,,5,1,2,0,2
30804_0,,,,2,3,2,5
C=C(C=O)CO,,,5,1,4,0,4
30806_0,,,,2,3,2,5
C(CO)=C(C=O)CO,,,5,1,5,0,5
30808_0,,,,2,3,2,5
C(CO)=C(C=O)CCO,,,5,1,3,0,3
30810_0,,,,2,3,2,5
C(CO)(CCO)=CC=O,,,5,1,3,0,3
30811_0,,,,2,3,2,5
30813_0,,,,2,3,2,5
C(CC(CO)=CCO)=O,,,5,1,3,0,3
30815_0,,,,2,3,2,5
C(CO)=C(C=O)C(CO)O,,,5,1,5,0,5
30817_0,,,,2,3,2,5
C(C(C(CO)=CCO)O)=O,,,5,1,4,0,4
30819_0,,,,2,3,2,5
C(CO)=CC(CCO)=O,,,5,1,2,0,2
30821_0,,,,2,3,2,5
C(CO)(C(C=C)CO)=O,,,5,1,3,0,3
30823_0,,,,2,3,2,5
C(C)=C(C(CO)=O)CO,,,5,1,3,0,3
30825_0,,,,2,3,2,5
C=C(C(CO)=O)C(C)O,,,5,1,2,0,2
30827_0,,,,2,3,2,5
C(C(CO)O)=C(C(CO)=O)CO,,,5,1,3,0,3
30829_0,,,,2,3,2,5
C=C(C(CO)=O)C(C(CO)O)O,,,5,1,2,0,2
30831_0,,,,2,3,2,5
C=C(C(CO)=O)CO,,,5,1,4,0,4
30833_0,,,,2,3,2,5
C(CO)=C(C(CO)=O)CO,,,5,1,3,0,3
30835_0,,,,2,3,2,5
C=C(C(CO)=O)C(CO)O,,,5,1,2,0,2
30837_0,,,,2,3,2,5
C(C(CC=CCO)O)=O,,,5,1,2,0,2
30839_0,,,,2,3,2,5
C(CC(CO)O)=CC=O,,,5,1,2,0,2
30841_0,,,,2,3,2,5
C(C(C=CCCO)O)=O,,,5,1,2,0,2
30843_0,,,,2,3,2,5
C(CC=CC(CO)O)=O,,,5,1,2,0,2
30845_0,,,,2,3,2,5
C(C(C=CC(CO)O)O)=O,,,5,1,4,0,4
30846_0,,,,2,3,2,5
30848_0,,,,2,3,2,5
C(C(C(C=C)CO)O)=O,,,5,1,2,0,2
30850_0,,,,2,3,2,5
C(C)=C(C=O)C(CO)O,,,5,1,2,0,2
30852_0,,,,2,3,2,5
C(C(C(CO)=CC)O)=O,,,5,1,2,0,2
30854_0,,,,2,3,2,5
C(CO)=C(C=O)C(C)O,,,5,1,3,0,3
30856_0,,,,2,3,2,5
C(CO)(C(C)O)=CC=O,,,5,1,3,0,3
30858_0,,,,2,3,2,5
C(C(CO)O)=C(C=O)C(CO)O,,,5,1,2,0,2
30860_0,,,,2,3,2,5
C(C(C(CO)=CC(CO)O)O)=O,,,5,1,2,0,2
30862_0,,,,2,3,2,5
C(CO)=C(C=O)C(C(CO)O)O,,,5,1,3,0,3
30864_0,,,,2,3,2,5
C(CO)(C(C(CO)O)O)=CC=O,,,5,1,3,0,3
30865_0,,,,2,3,2,5
30866_0,,,,2,3,2,5
30867_0,,,,2,3,2,5
30868_0,,,,2,3,2,5
30870_0,,,,2,3,2,5
C(CO)(CC=CCO)=O,,,5,1,2,0,2
30872_0,,,,2,3,2,5
C(CCO)=CC(CO)=O,,,5,1,2,0,2
30873_0,,,,2,3,2,5
30874_0,,,,2,3,2,5
30875_0,,,,2,3,2,5
30876_0,,,,2,3,2,5
30877_0,,,,2,3,2,5
30878_0,,,,2,3,2,5
30879_0,,,,2,3,2,5
30880_0,,,,2,3,2,5
30881_0,,,,2,3,2,5
30882_0,,,,2,3,2,5
30884_0,,,,2,3,2,5
C(CCO)(C(C=C)O)=O,,,5,1,3,0,3
30886_0,,,,2,3,2,5
C(C)(C(C=CCO)O)=O,,,5,1,2,0,2
30888_0,,,,2,3,2,5
C(C(C(C)=CCO)O)=O,,,5,1,2,0,2
30890_0,,,,2,3,2,5
C(C)(C(CO)O)=CC=O,,,5,1,2,0,2
30892_0,,,,2,3,2,5
C(C(C(CCO)=C)O)=O,,,5,1,2,0,2
30894_0,,,,2,3,2,5
C(CC(C(CO)O)=C)=O,,,5,1,2,0,2
30896_0,,,,2,3,2,5
C(C(C(C(CO)O)=C)O)=O,,,5,1,4,0,4
30898_0,,,,2,3,2,5
C(C(CO)O)(CC=C)=O,,,5,1,2,0,2
30900_0,,,,2,3,2,5
C(C)=CC(C(CO)O)=O,,,5,1,2,0,2
30902_0,,,,2,3,2,5
C(C(CO)O)=CC(C(CO)O)=O,,,5,1,2,0,2
30903_0,,,,2,3,2,5
30905_0,,,,2,3,2,5
C(CO)=CC(C(CO)O)=O,,,5,1,3,0,3
30907_0,,,,2,3,2,5
C(C)=CCO,,,5,1,2,0,2
30909_0,,,,2,3,2,5
C=CCCO,,,5,1,2,0,2
30911_0,,,,2,3,2,5
C=CC(CO)O,,,5,1,5,0,5
30913_0,,,,2,3,2,5
C(C(CO)O)=CCO,,,5,1,2,0,2
30915_0,,,,2,3,2,5
C(C(C(CO)O)O)=CCO,,,5,1,2,0,2
30917_0,,,,2,3,2,5
C=CCO,,,5,1,4,0,4
30919_0,,,,2,3,2,5
C=CC(CO)(C(C(CO)O)O)O,,,5,1,2,0,2
30921_0,,,,2,3,2,5
C(CO)(C(C(CO)=C)(CO)O)=O,,,5,1,2,0,2
30923_0,,,,2,3,2,5
C(CO)(C(C=CCO)(CO)O)=O,,,5,1,2,0,2
30925_0,,,,2,3,2,5
C(C(C(CO)=C)(CO)O)(O)=O,,,5,1,2,0,2
30927_0,,,,2,3,2,5
C(C(C=CCO)(CO)O)(O)=O,,,5,1,2,0,2
30929_0,,,,2,3,2,5
C(C)(C(C(C=O)=C)(CO)O)=O,,,5,1,3,0,3
30931_0,,,,2,3,2,5
C(C(C(C)=O)(C(CO)=C)O)=O,,,5,1,2,0,2
30933_0,,,,2,3,2,5
C=C(C=O)C(CO)(CO)O,,,5,1,3,0,3
30935_0,,,,2,3,2,5
C(C(C(CO)=C)(CO)O)=O,,,5,1,2,0,2
30937_0,,,,2,3,2,5
C=C(C=O)C(CO)(C(CO)O)O,,,5,1,3,0,3
30939_0,,,,2,3,2,5
C(C(C(CO)=C)(C(CO)O)O)=O,,,5,1,2,0,2
30941_0,,,,2,3,2,5
C(C)(C(C=CC=O)(CO)O)=O,,,5,1,4,0,4
30943_0,,,,2,3,2,5
C(C(C(C)=O)(C=CCO)O)=O,,,5,1,2,0,2
30944_0,,,,2,3,2,5
30946_0,,,,2,3,2,5
C(C(C=CCO)(CO)O)=O,,,5,1,2,0,2
30947_0,,,,2,3,2,5
30949_0,,,,2,3,2,5
C(C(C=CCO)(C(CO)O)O)=O,,,5,1,2,0,2
30950_0,,,,2,3,2,5
30952_0,,,,2,3,2,5
C(C(C(CO)=CCO)(CO)O)=O,,,5,1,3,0,3
30954_0,,,,2,3,2,5
C(C(C=CC(CO)(CO)O)O)=O,,,5,1,3,0,3
30956_0,,,,2,3,2,5
C(C(C=CC(CO)O)(CO)O)=O,,,5,1,2,0,2
30957_0,,,,2,3,2,5
30958_0,,,,2,3,2,5
30959_0,,,,2,3,2,5
30961_0,,,,2,3,2,5
C(C)(C(C=C)(CO)O)=O,,,5,1,2,0,2
30963_0,,,,2,3,2,5
C(C(C(C(CO)(CO)O)=C)O)=O,,,5,1,3,0,3
30965_0,,,,2,3,2,5
C(C(C(C(CO)O)=C)(CO)O)=O,,,5,1,2,0,2
30967_0,,,,2,3,2,5
C=CC(CO)(CO)O,,,5,1,3,0,3
30969_0,,,,2,3,2,5
C=CC(CO)(C(CO)O)O,,,5,1,3,0,3
30970_0,,,,2,3,2,5
30972_0,,,,2,3,2,5
C(C(C(C=O)=C)(CCO)O)=O,,,5,1,3,0,3
30973_0,,,,2,3,2,5
30974_0,,,,2,3,2,5
30975_0,,,,2,3,2,5
30977_0,,,,2,3,2,5
C(C(C=CC=O)(CCO)O)=O,,,5,1,2,0,2
30978_0,,,,2,3,2,5
30979_0,,,,2,3,2,5
30980_0,,,,2,3,2,5
30981_0,,,,2,3,2,5
30982_0,,,,2,3,2,5
30983_0,,,,2,3,2,5
30984_0,,,,2,3,2,5
30985_0,,,,2,3,2,5
30986_0,,,,2,3,2,5
30988_0,,,,2,3,2,5
C=CC(C(CO)(CO)O)=O,,,5,1,2,0,2
30990_0,,,,2,3,2,5
C=C(C(C(CO)O)=O)CO,,,5,1,2,0,2
30991_0,,,,2,3,2,5
30992_0,,,,2,3,2,5
30994_0,,,,2,3,2,5
C(CO)(C1COC(C1O)O)=O,,,5,1,3,0,3
30995_0,,,,2,3,2,5
30997_0,,,,2,3,2,5
C(C1C(CO)C(C(O1)O)O)=O,,,5,1,2,0,2
30999_0,,,,2,3,2,5
C1C(CO)(CC(CO)(O)O1)O,,,5,1,3,0,3
31001_0,,,,2,3,2,5
C1C(CO)(C(C(O)O1)CO)O,,,5,1,2,0,2
31003_0,,,,2,3,2,5
C1C(CO)(C(CO)C(CO)(O)O1)O,,,5,1,3,0,3
31005_0,,,,2,3,2,5
C(C1C(C(O)OC1(CO)CO)O)O,,,5,1,2,0,2
31007_0,,,,2,3,2,5
C1C(CO)(C(C(O)O1)C(CO)O)O,,,5,1,2,0,2
31008_0,,,,2,3,2,5
31010_0,,,,2,3,2,5
C1C(CO)(C(C(CCO)(O)O1)O)O,,,5,1,3,0,3
31012_0,,,,2,3,2,5
C1C(CO)(CC(C(CO)O)(O)O1)O,,,5,1,2,0,2
31014_0,,,,2,3,2,5
C(C1(C(C(C(CCO)O1)O)O)O)O,,,5,1,2,0,2
31016_0,,,,2,3,2,5
C1C(CCO)(C(C(CO)(O)O1)O)O,,,5,1,2,0,2
31018_0,,,,2,3,2,5
CC1(C(CO)OC(CO)(C1O)O)O,,,5,1,2,0,2
31020_0,,,,2,3,2,5
C1C(CC(CO)(O)O1)(C(CO)O)O,,,5,1,2,0,2
31022_0,,,,2,3,2,5
C(C1(CC(CO)(C(CO)O1)O)O)O,,,5,1,2,0,2
31024_0,,,,2,3,2,5
C1C(C(CO)O)(C(C(O)O1)CO)O,,,5,1,2,0,2
31026_0,,,,2,3,2,5
C(C1(C(CO)OC(C1CO)O)O)O,,,5,1,2,0,2
31028_0,,,,2,3,2,5
C(C1(CC(C(CO)(CO)O1)O)O)O,,,5,1,3,0,3
31030_0,,,,2,3,2,5
C1(C(CO)C(C(CO)(CO)O1)O)O,,,5,1,2,0,2
31032_0,,,,2,3,2,5
C1(C(O)OC(CO)(C)C1)=O,,,5,1,2,0,2
31034_0,,,,2,3,2,5
C1(C(O)OC(CO)(C)C1CO)=O,,,5,1,2,0,2
31036_0,,,,2,3,2,5
C(CO)(C1COC(C1(C)O)O)=O,,,5,1,2,0,2
31038_0,,,,2,3,2,5
C(C1C(CO)OC(C1(C)O)O)=O,,,5,1,2,0,2
31040_0,,,,2,3,2,5
C(C1C(CO)C(C)(C(O1)O)O)=O,,,5,1,2,0,2
31042_0,,,,2,3,2,5
C(C1(C)C(CO)C(C(O1)O)O)=O,,,5,1,2,0,2
31044_0,,,,2,3,2,5
C(C1C(C(O)OC1(C)CO)O)=O,,,5,1,2,0,2
31046_0,,,,2,3,2,5
C(CO)(C1COC(C)(C1O)O)=O,,,5,1,2,0,2
31048_0,,,,2,3,2,5
C(C1C(CO)OC(C)(C1O)O)=O,,,5,1,2,0,2
31050_0,,,,2,3,2,5
C(C1C(CO)C(C(C)(O1)O)O)=O,,,5,1,2,0,2
31052_0,,,,2,3,2,5
C(C)(C1C(CO)C(C(O1)O)O)=O,,,5,1,2,0,2
31054_0,,,,2,3,2,5
C1(C(O)OC(CCO)C1)=O,,,5,1,2,0,2
31056_0,,,,2,3,2,5
C1(C(O)OC(CO)(CCO)C1)=O,,,5,1,3,0,3
31058_0,,,,2,3,2,5
C(C1(CC(C(CCO)O1)O)O)=O,,,5,1,2,0,2
31060_0,,,,2,3,2,5
C(CC1C(CC(CO)(O)O1)O)=O,,,5,1,2,0,2
31062_0,,,,2,3,2,5
C(CO)(CC1C(CC(O)O1)O)=O,,,5,1,3,0,3
31064_0,,,,2,3,2,5
C1(C(O)OC(C(CCO)O)C1)=O,,,5,1,2,0,2
31066_0,,,,2,3,2,5
C(CO)(CC1CC(C(O)O1)O)=O,,,5,1,2,0,2
31068_0,,,,2,3,2,5
C1(C(O)OC(CC(CO)O)C1)=O,,,5,1,2,0,2
31070_0,,,,2,3,2,5
C(C1(CC(CO1)(CCO)O)O)=O,,,5,1,2,0,2
31072_0,,,,2,3,2,5
C(CC1(COC(CO)(C1)O)O)=O,,,5,1,2,0,2
31073_0,,,,2,3,2,5
31075_0,,,,2,3,2,5
C(C)(C1C(CC(CO)(O1)O)O)=O,,,5,1,2,0,2
31077_0,,,,2,3,2,5
C(C1(CC(C)(C(CO)O1)O)O)=O,,,5,1,2,0,2
31079_0,,,,2,3,2,5
C(C1C(C)(CC(CO)(O1)O)O)=O,,,5,1,2,0,2
31081_0,,,,2,3,2,5
C1(C(O)OC(C)(C(CO)O)C1)=O,,,5,1,2,0,2
31083_0,,,,2,3,2,5
C(C1(CC(C(CO)O1)O)O)O,,,5,1,3,0,3
31085_0,,,,2,3,2,5
C(C1(CC(C(C(CO)O)O1)O)O)O,,,5,1,2,0,2
31087_0,,,,2,3,2,5
C1C(CC(CO)(O)O1)O,,,5,1,2,0,2
31089_0,,,,2,3,2,5
C1(C(O)OC(CCO)C1CO)=O,,,5,1,2,0,2
31091_0,,,,2,3,2,5
C(CC1C(CO)C(C(O)O1)O)=O,,,5,1,2,0,2
31093_0,,,,2,3,2,5
C(C1C(CCO)OC(C1O)O)=O,,,5,1,2,0,2
31094_0,,,,2,3,2,5
31095_0,,,,2,3,2,5
31097_0,,,,2,3,2,5
C(C1C(O)OC(C1O)CCO)=O,,,5,1,2,0,2
31099_0,,,,2,3,2,5
C(CC1C(C(C(O)O1)CO)O)=O,,,5,1,2,0,2
31100_0,,,,2,3,2,5
31101_0,,,,2,3,2,5
31103_0,,,,2,3,2,5
C(C1C(O)OCC1(CCO)O)=O,,,5,1,2,0,2
31104_0,,,,2,3,2,5
31106_0,,,,2,3,2,5
C(C)(C1C(C(CO)C(O1)O)O)=O,,,5,1,2,0,2
31108_0,,,,2,3,2,5
C(C1C(O)OC(CO)C1(C)O)=O,,,5,1,2,0,2
31110_0,,,,2,3,2,5
C(C1C(C)(C(CO)C(O1)O)O)=O,,,5,1,2,0,2
31112_0,,,,2,3,2,5
C(C(C1C(C(C(O)O1)CO)O)O)O,,,5,1,2,0,2
31114_0,,,,2,3,2,5
C(C1(C(CO)C(C(CO)O1)O)O)O,,,5,1,3,0,3
31116_0,,,,2,3,2,5
C1C(C(CO)C(CO)(O)O1)O,,,5,1,3,0,3
31118_0,,,,2,3,2,5
C(CC1C(CC(O)O1)O)O,,,5,1,2,0,2
31119_0,,,,2,3,2,5
31121_0,,,,2,3,2,5
C(CC1CC(C(O)O1)O)O,,,5,1,2,0,2
31123_0,,,,2,3,2,5
C(C(C1CC(C(O)O1)O)O)O,,,5,1,3,0,3
31125_0,,,,2,3,2,5
CC1C(CO)C(C(O)O1)O,,,5,1,2,0,2
31127_0,,,,2,3,2,5
C(C(C1C(O)OC(CO)C1O)O)O,,,5,1,2,0,2
31129_0,,,,2,3,2,5
C1(C(C(CO)C(C(CO)O)O1)O)O,,,5,1,2,0,2
31131_0,,,,2,3,2,5
C1C(CO)C(C(O)O1)O,,,5,1,2,0,2
31133_0,,,,2,3,2,5
C1C(C(C(O)O1)C(CO)O)O,,,5,1,2,0,2
31135_0,,,,2,3,2,5
C1(C(C(CO)C(CO)O1)O)O,,,5,1,2,0,2
31136_0,,,,2,3,2,5
31137_0,,,,2,3,2,5
31139_0,,,,2,3,2,5
C1C(CCO)(C(C(O)O1)O)O,,,5,1,2,0,2
31140_0,,,,2,3,2,5
31141_0,,,,2,3,2,5
31143_0,,,,2,3,2,5
C(CC1(C(C(C(CO)O1)O)O)O)O,,,5,1,2,0,2
31145_0,,,,2,3,2,5
C1C(C(C(CCO)(O)O1)O)O,,,5,1,2,0,2
31147_0,,,,2,3,2,5
CC1(C(C(C(CO)O1)O)O)O,,,5,1,2,0,2
31149_0,,,,2,3,2,5
CC1(CC(O)OC1CO)O,,,5,1,2,0,2
31151_0,,,,2,3,2,5
CC1(C(CO)OC(C1O)O)O,,,5,1,2,0,2
31153_0,,,,2,3,2,5
C(C(C1(CC(C(CO)O1)O)O)O)O,,,5,1,2,0,2
31155_0,,,,2,3,2,5
C1C(CC(C(CO)O)(O)O1)O,,,5,1,2,0,2
31156_0,,,,2,3,2,5
31157_0,,,,2,3,2,5
31158_0,,,,2,3,2,5
31159_0,,,,2,3,2,5
31160_0,,,,2,3,2,5
31162_0,,,,2,3,2,5
C1C(CO)(C(CO)(C(C)(O)O1)O)O,,,5,1,2,0,2
31164_0,,,,2,3,2,5
C1C(CO)(C(C)(C(O)O1)O)O,,,5,1,2,0,2
31166_0,,,,2,3,2,5
CC1(C(O)OC(CO)C1(CO)O)O,,,5,1,2,0,2
31168_0,,,,2,3,2,5
CC(CO)(C1(C(O)OCC1O)O)O,,,5,1,3,0,3
31170_0,,,,2,3,2,5
C1C(CO)(C(C(C)(O)O1)O)O,,,5,1,2,0,2
31172_0,,,,2,3,2,5
CC1(C(C(CO)(C(CO)O1)O)O)O,,,5,1,2,0,2
31174_0,,,,2,3,2,5
C(C)(C1(CO)C(CC(O1)O)O)=O,,,5,1,5,0,5
31175_0,,,,2,3,2,5
31176_0,,,,2,3,2,5
31178_0,,,,2,3,2,5
C1C(C(C(O)O1)(C(CCO)O)O)O,,,5,1,3,0,3
31180_0,,,,2,3,2,5
C1C(CO)(C(C(O)O1)(CCO)O)O,,,5,1,3,0,3
31181_0,,,,2,3,2,5
31183_0,,,,2,3,2,5
C(C(CO)(C1C(CC(O)O1)O)O)O,,,5,1,2,0,2
31185_0,,,,2,3,2,5
C1(C(CO)(C(C(CCO)O1)O)O)O,,,5,1,2,0,2
31187_0,,,,2,3,2,5
C1(C(CC(C(CO)(CO)O)O1)O)O,,,5,1,2,0,2
31188_0,,,,2,3,2,5
31190_0,,,,2,3,2,5
C(C1(CC(O)OC1(CO)CO)O)O,,,5,1,3,0,3
31192_0,,,,2,3,2,5
C1C(CCO)(C(C(O)O1)(CO)O)O,,,5,1,2,0,2
31194_0,,,,2,3,2,5
CC1(C(CO)(C(C(CO)O1)O)O)O,,,5,1,2,0,2
31196_0,,,,2,3,2,5
C1C(C(CO)(C(C)(O)O1)O)O,,,5,1,2,0,2
31198_0,,,,2,3,2,5
CC1(C(C(C(CO)(CO)O1)O)O)O,,,5,1,2,0,2
31200_0,,,,2,3,2,5
CC1(C(C(O)OC1(CO)CO)O)O,,,5,1,2,0,2
31202_0,,,,2,3,2,5
CC1(C(CO)OC(C1(CO)O)O)O,,,5,1,2,0,2
31203_0,,,,2,3,2,5
31204_0,,,,2,3,2,5
31205_0,,,,2,3,2,5
31206_0,,,,2,3,2,5
31208_0,,,,2,3,2,5
C(C1(C)C(CO)(CC(O1)O)O)=O,,,5,1,2,0,2
31210_0,,,,2,3,2,5
C(C1(CC(O)OC1(CO)C)O)=O,,,5,1,2,0,2
31212_0,,,,2,3,2,5
C(C)(C1C(CO)(CC(O1)O)O)=O,,,5,1,2,0,2
31214_0,,,,2,3,2,5
C(CC1(CO)C(CC(O)O1)O)=O,,,5,1,3,0,3
31216_0,,,,2,3,2,5
C(C1(CCO)C(CC(O1)O)O)=O,,,5,1,2,0,2
31218_0,,,,2,3,2,5
C(CC1C(CO)(CC(O)O1)O)=O,,,5,1,2,0,2
31220_0,,,,2,3,2,5
C(C1(CC(O)OC1CCO)O)=O,,,5,1,2,0,2
31222_0,,,,2,3,2,5
CC1C(CO)(CC(O)O1)O,,,5,1,2,0,2
31224_0,,,,2,3,2,5
C1(C(CCO)(C(C(CO)O1)O)O)O,,,5,1,2,0,2
31226_0,,,,2,3,2,5
C(C(C1C(CO)(CC(O)O1)O)O)O,,,5,1,2,0,2
31227_0,,,,2,3,2,5
31228_0,,,,2,3,2,5
31229_0,,,,2,3,2,5
31230_0,,,,2,3,2,5
31231_0,,,,2,3,2,5
31232_0,,,,2,3,2,5
31233_0,,,,2,3,2,5
31235_0,,,,2,3,2,5
C1C(CO)(C(CO)C(C(O)O1)O)O,,,5,1,2,0,2
31237_0,,,,2,3,2,5
C1CC(CO)(C(C(CO)(O)O1)O)O,,,5,1,2,0,2
31239_0,,,,2,3,2,5
C(C1(C(C(CC(CO)O1)O)O)O)O,,,5,1,2,0,2
31241_0,,,,2,3,2,5
C1C(C(CO)(CC(CO)(O)O1)O)O,,,5,1,2,0,2
31243_0,,,,2,3,2,5
C1C(C(CO)(C(C(O)O1)CO)O)O,,,5,1,2,0,2
31245_0,,,,2,3,2,5
C1C(CO)(C(CC(CO)(O)O1)O)O,,,5,1,3,0,3
31247_0,,,,2,3,2,5
C1C(CO)(C(C(C(O)O1)CO)O)O,,,5,1,2,0,2
31249_0,,,,2,3,2,5
C1(COC(C(C)(C1CO)O)O)=O,,,5,1,2,0,2
31251_0,,,,2,3,2,5
C1(C(C(CO)(C)OC(C1)O)O)=O,,,5,1,2,0,2
31253_0,,,,2,3,2,5
C1(C(CO)OC(C(C)(C1)O)O)=O,,,5,1,2,0,2
31255_0,,,,2,3,2,5
C1(C(C(O)OC(CO)(C)C1)O)=O,,,5,1,2,0,2
31257_0,,,,2,3,2,5
C1(COC(C)(C(C1CO)O)O)=O,,,5,1,2,0,2
31259_0,,,,2,3,2,5
C1(C(CO)OC(C(C1)O)(C)O)=O,,,5,1,2,0,2
31261_0,,,,2,3,2,5
C(C1(CC(CO)(CCO1)O)O)=O,,,5,1,2,0,2
31263_0,,,,2,3,2,5
C(C1(CCOC(CO)(C1)O)O)=O,,,5,1,2,0,2
31265_0,,,,2,3,2,5
C1(C(O)OC(C(C1)O)CCO)=O,,,5,1,2,0,2
31267_0,,,,2,3,2,5
C(C1(CC(CC(CO)O1)O)O)=O,,,5,1,2,0,2
31269_0,,,,2,3,2,5
C(C1CC(CC(CO)(O1)O)O)=O,,,5,1,2,0,2
31271_0,,,,2,3,2,5
C1(C(O)OCC(CCO)(C1)O)=O,,,5,1,2,0,2
31273_0,,,,2,3,2,5
C1(C(O)OC(CO)C(C)(C1)O)=O,,,5,1,2,0,2
31275_0,,,,2,3,2,5
C1C(C(CC(CO)(O)O1)O)O,,,5,1,2,0,2
31277_0,,,,2,3,2,5
C(C1(CC(C(C(CO)O1)O)O)O)O,,,5,1,2,0,2
31279_0,,,,2,3,2,5
C(CO)(C1COC(CC1O)O)=O,,,5,1,3,0,3
31281_0,,,,2,3,2,5
C(C1C(CO)OC(CC1O)O)=O,,,5,1,3,0,3
31283_0,,,,2,3,2,5
C(C1C(CO)C(CC(O1)O)O)=O,,,5,1,2,0,2
31285_0,,,,2,3,2,5
C1(C(C(CCO)OC(C1)O)O)=O,,,5,1,2,0,2
31287_0,,,,2,3,2,5
C1(C(C(O)OC(CCO)C1)O)=O,,,5,1,2,0,2
31289_0,,,,2,3,2,5
C(C1C(O)OCCC1(CO)O)=O,,,5,1,2,0,2
31291_0,,,,2,3,2,5
C(C1(CCOC(C1CO)O)O)=O,,,5,1,2,0,2
31293_0,,,,2,3,2,5
C(C1C(O)OC(CO)CC1O)=O,,,5,1,2,0,2
31295_0,,,,2,3,2,5
C(C1CC(C(CO)C(O1)O)O)=O,,,5,1,2,0,2
31297_0,,,,2,3,2,5
C1(C(CO)C(C(C(CO)O1)O)O)O,,,5,1,2,0,2
31299_0,,,,2,3,2,5
C1CC(CO)(CC(O)O1)O,,,5,1,2,0,2
31301_0,,,,2,3,2,5
C1CC(CO)(C(C(O)O1)O)O,,,5,1,2,0,2
31303_0,,,,2,3,2,5
C1C(C(C(CO)C(CO)(O)O1)O)O,,,5,1,3,0,3
31304_0,,,,2,3,2,5
31306_0,,,,2,3,2,5
C(C1CC(CC(O)O1)O)O,,,5,1,2,0,2
31308_0,,,,2,3,2,5
C(C1C(CC(C(O)O1)O)O)O,,,5,1,2,0,2
31310_0,,,,2,3,2,5
C(C1CC(C(C(O)O1)O)O)O,,,5,1,2,0,2
31312_0,,,,2,3,2,5
C1(C(C(CO)C(C(CO)O1)O)O)O,,,5,1,2,0,2
31314_0,,,,2,3,2,5
C1C(C(C(C(O)O1)C(CO)O)O)O,,,5,1,2,0,2
31316_0,,,,2,3,2,5
C1C(C(CO)C(C(O)O1)O)O,,,5,1,2,0,2
31317_0,,,,2,3,2,5
31319_0,,,,2,3,2,5
C1C(C(C(C(CCO)(O)O1)O)O)O,,,5,1,2,0,2
31321_0,,,,2,3,2,5
C1C(C(CC(C(CO)O)(O)O1)O)O,,,5,1,2,0,2
31322_0,,,,2,3,2,5
31323_0,,,,2,3,2,5
31325_0,,,,2,3,2,5
CC1(C(O)OCC(C1(CO)O)O)O,,,5,1,2,0,2
31327_0,,,,2,3,2,5
C1C(C(CO)(C(C(C)(O)O1)O)O)O,,,5,1,2,0,2
31328_0,,,,2,3,2,5
31329_0,,,,2,3,2,5
31331_0,,,,2,3,2,5
C1CC(CO)(C(C(O)O1)(CO)O)O,,,5,1,2,0,2
31333_0,,,,2,3,2,5
C(C1(CO)C(C(CC(O)O1)O)O)O,,,5,1,2,0,2
31335_0,,,,2,3,2,5
C1(C(CC(C(CO)(CO)O1)O)O)O,,,5,1,2,0,2
31337_0,,,,2,3,2,5
C1(C(CO)(C(CC(CO)O1)O)O)O,,,5,1,2,0,2
31338_0,,,,2,3,2,5
31340_0,,,,2,3,2,5
C1C(CO)(C(CO)(CC(O)O1)O)O,,,5,1,3,0,3
31342_0,,,,2,3,2,5
C1C(C(C(CO)(C(C)(O)O1)O)O)O,,,5,1,2,0,2
31344_0,,,,2,3,2,5
C1C(CO)(C(C(C(C)(O)O1)O)O)O,,,5,1,2,0,2
31346_0,,,,2,3,2,5
CC1(C(C(O)OCC1(CO)O)O)O,,,5,1,2,0,2
31347_0,,,,2,3,2,5
31349_0,,,,2,3,2,5
C(C1(CC(O)OC(CO)C1O)O)O,,,5,1,2,0,2
31351_0,,,,2,3,2,5
C1C(C(C(C(O)O1)(CCO)O)O)O,,,5,1,2,0,2
31352_0,,,,2,3,2,5
31354_0,,,,2,3,2,5
C1(C(O)OCCC(CO)(C1)O)=O,,,5,1,2,0,2
31356_0,,,,2,3,2,5
C1(C(CC(CO)(O)OCC1)O)=O,,,5,1,2,0,2
31358_0,,,,2,3,2,5
C1(C(O)OC(CO)CC(C1)O)=O,,,5,1,2,0,2
31360_0,,,,2,3,2,5
C1(COC(CO)(CC(C1)O)O)=O,,,5,1,2,0,2
31362_0,,,,2,3,2,5
C1C(C(C(CC(CO)(O)O1)O)O)O,,,5,1,2,0,2
31363_0,,,,2,3,2,5
31364_0,,,,2,3,2,5
31366_0,,,,2,3,2,5
C1(C(C(C(O)OCC1)CO)O)=O,,,5,1,2,0,2
31368_0,,,,2,3,2,5
C1(COC(C(CO)C(C1)O)O)=O,,,5,1,2,0,2
31370_0,,,,2,3,2,5
C1C(C(C(C(C(O)O1)CO)O)O)O,,,5,1,2,0,2
31372_0,,,,2,3,2,5
C1C(C(C(CO)C(C(O)O1)O)O)O,,,5,1,2,0,2
31373_0,,,,2,3,2,5
31375_0,,,,2,3,2,5
C1C(CO)(C(C(CC(O)O1)O)O)O,,,5,1,2,0,2
31377_0,,,,2,3,2,5
C1C(CO)(C(CC(C(O)O1)O)O)O,,,5,1,2,0,2
31379_0,,,,2,3,2,5
C1C(C(C(CO)(CC(O)O1)O)O)O,,,5,1,2,0,2
31381_0,,,,2,3,2,5
C1(C(C(CO1)(CCO)O)O)=O,,,5,1,2,0,2
31383_0,,,,2,3,2,5
C1(C(C(C)(C(CO)O1)O)O)=O,,,5,1,2,0,2
31385_0,,,,2,3,2,5
C1(C(C(CO)(CCO1)O)O)=O,,,5,1,2,0,2
31387_0,,,,2,3,2,5
C1(C(C(CC(CO)O1)O)O)=O,,,5,1,2,0,2
31388_0,,,,2,3,2,5
31389_0,,,,2,3,2,5
31390_0,,,,2,3,2,5
31392_0,,,,2,3,2,5
C(C(C=O)C(C(C=O)CCO)O)=O,,,5,1,1,0,1
31393_0,,,,2,3,2,5
31395_0,,,,2,3,2,5
C(C(C=O)(CO)CCC(CO)=O)=O,,,5,1,2,0,2
31397_0,,,,2,3,2,5
C(C(CCC(C=O)=O)(CO)CO)=O,,,5,1,3,0,3
31399_0,,,,2,3,2,5
C(C(C=O)(CO)C(CO)CC=O)=O,,,5,1,2,0,2
31401_0,,,,2,3,2,5
C(C(C=O)(CO)C(C=O)CCO)=O,,,5,1,2,0,2
31403_0,,,,2,3,2,5
C(CC(C=O)C(C=O)(CO)CO)=O,,,5,1,3,0,3
31405_0,,,,2,3,2,5
C(C(CCC(CO)=O)C(C)O)=O,,,5,1,2,0,2
31407_0,,,,2,3,2,5
C(C(CCC(CO)C(C)O)=O)=O,,,5,1,2,0,2
31409_0,,,,2,3,2,5
C(C(C(CO)CC=O)C(C)O)=O,,,5,1,2,0,2
31410_0,,,,2,3,2,5
31412_0,,,,2,3,2,5
C(C(C(CO)C(C)O)CC=O)=O,,,5,1,3,0,3
31414_0,,,,2,3,2,5
C(CC(C)(CCC(CO)=O)O)=O,,,5,1,2,0,2
31416_0,,,,2,3,2,5
C(C(CCC(C)(CCO)O)=O)=O,,,5,1,2,0,2
31418_0,,,,2,3,2,5
C(CC(C)(C(CO)CC=O)O)=O,,,5,1,2,0,2
31420_0,,,,2,3,2,5
C(C(CCO)C(C)(CC=O)O)=O,,,5,1,1,0,1
31422_0,,,,2,3,2,5
C(C(C(C)(CCO)O)CC=O)=O,,,5,1,2,0,2
31424_0,,,,2,3,2,5
C(CC(CCCC(CO)=O)O)=O,,,5,1,2,0,2
31426_0,,,,2,3,2,5
C(C(CCCC(CCO)O)=O)=O,,,5,1,2,0,2
31428_0,,,,2,3,2,5
C(CC(CO)CC(CC=O)O)=O,,,5,1,2,0,2
31429_0,,,,2,3,2,5
31431_0,,,,2,3,2,5
C(C(CC(CCO)O)CC=O)=O,,,5,1,3,0,3
31433_0,,,,2,3,2,5
C(C(CCC(CO)=O)(C(C)O)O)=O,,,5,1,2,0,2
31435_0,,,,2,3,2,5
C(C(CCC(CO)(C(C)O)O)=O)=O,,,5,1,3,0,3
31437_0,,,,2,3,2,5
C(C(C(C)O)(C(CO)CC=O)O)=O,,,5,1,2,0,2
31439_0,,,,2,3,2,5
C(C(CCO)C(C=O)(C(C)O)O)=O,,,5,1,1,0,1
31440_0,,,,2,3,2,5
31442_0,,,,2,3,2,5
C(C(C(CCC(CO)=O)(C)O)O)=O,,,5,1,2,0,2
31444_0,,,,2,3,2,5
C(C(CCC(C)(C(CO)O)O)=O)=O,,,5,1,3,0,3
31446_0,,,,2,3,2,5
C(CC(CO)C(C)(C(C=O)O)O)=O,,,5,1,2,0,2
31448_0,,,,2,3,2,5
C(C(CCO)C(C)(C(C=O)O)O)=O,,,5,1,1,0,1
31449_0,,,,2,3,2,5
31451_0,,,,2,3,2,5
C(C(C(CCCC(CO)=O)O)O)=O,,,5,1,2,0,2
31453_0,,,,2,3,2,5
C(C(CCCC(C(CO)O)O)=O)=O,,,5,1,3,0,3
31455_0,,,,2,3,2,5
C(CC(CO)CC(C(C=O)O)O)=O,,,5,1,2,0,2
31456_0,,,,2,3,2,5
31458_0,,,,2,3,2,5
C(C(CC(C(CO)O)O)CC=O)=O,,,5,1,4,0,4
31459_0,,,,2,3,2,5
31461_0,,,,2,3,2,5
C(C(CCC(CCO)O)=O)=O,,,5,1,2,0,2
31462_0,,,,2,3,2,5
31464_0,,,,2,3,2,5
C(C(C(CC=O)O)CCO)=O,,,5,1,1,0,1
31465_0,,,,2,3,2,5
31467_0,,,,2,3,2,5
C(C(CO)CCC(CO)=O)=O,,,5,1,2,0,2
31469_0,,,,2,3,2,5
C(C(CCC(CO)CO)=O)=O,,,5,1,2,0,2
31471_0,,,,2,3,2,5
C(C(CO)C(CO)CC=O)=O,,,5,1,2,0,2
31472_0,,,,2,3,2,5
31474_0,,,,2,3,2,5
C(C(C(CO)CO)CC=O)=O,,,5,1,3,0,3
31476_0,,,,2,3,2,5
C(CC(C(CCC(CO)=O)O)O)=O,,,5,1,2,0,2
31478_0,,,,2,3,2,5
C(C(CCC(C(CCO)O)O)=O)=O,,,5,1,2,0,2
31480_0,,,,2,3,2,5
C(CC(C(C(CO)CC=O)O)O)=O,,,5,1,2,0,2
31482_0,,,,2,3,2,5
C(C(CCO)C(C(CC=O)O)O)=O,,,5,1,1,0,1
31483_0,,,,2,3,2,5
31485_0,,,,2,3,2,5
C(CC(CO)(CCC(CO)=O)O)=O,,,5,1,2,0,2
31487_0,,,,2,3,2,5
C(C(CCC(CO)(CCO)O)=O)=O,,,5,1,3,0,3
31488_0,,,,2,3,2,5
31490_0,,,,2,3,2,5
C(C(CCO)C(CO)(CC=O)O)=O,,,5,1,1,0,1
31491_0,,,,2,3,2,5
31493_0,,,,2,3,2,5
C(C(CCC(CO)=O)C(CO)O)=O,,,5,1,2,0,2
31495_0,,,,2,3,2,5
C(C(CCC(CO)C(CO)O)=O)=O,,,5,1,3,0,3
31497_0,,,,2,3,2,5
C(C(C(CO)CC=O)C(CO)O)=O,,,5,1,2,0,2
31498_0,,,,2,3,2,5
31500_0,,,,2,3,2,5
C(C(C(CO)C(CO)O)CC=O)=O,,,5,1,4,0,4
31502_0,,,,2,3,2,5
C(C(C)(CCC(CO)=O)O)(O)=O,,,5,1,2,0,2
31504_0,,,,2,3,2,5
C(C(C)(C(CO)CC=O)O)(O)=O,,,5,1,2,0,2
31506_0,,,,2,3,2,5
C(C(CCO)C(C(O)=O)(C)O)=O,,,5,1,2,0,2
31507_0,,,,2,3,2,5
31509_0,,,,2,3,2,5
C(CC(CO)CC(C(O)=O)O)=O,,,5,1,2,0,2
31511_0,,,,2,3,2,5
C(C(CC(C(O)=O)O)CCO)=O,,,5,1,1,0,1
31512_0,,,,2,3,2,5
31513_0,,,,2,3,2,5
31515_0,,,,2,3,2,5
C(CC(CO)C(C(C=O)=O)O)=O,,,5,1,3,0,3
31517_0,,,,2,3,2,5
C(C(CCO)C(C(C=O)=O)O)=O,,,5,1,3,0,3
31518_0,,,,2,3,2,5
31520_0,,,,2,3,2,5
C(CO)(CCC(C(C(C)=O)=O)O)=O,,,5,1,2,0,2
31522_0,,,,2,3,2,5
C(CC(CO)C(C(C(C)=O)=O)O)=O,,,5,1,2,0,2
31524_0,,,,2,3,2,5
C(C(CCO)C(C(C(C)=O)=O)O)=O,,,5,1,1,0,1
31526_0,,,,2,3,2,5
C(CO)(CCCC(C(CO)=O)=O)=O,,,5,1,2,0,2
31528_0,,,,2,3,2,5
C(CC(CO)CC(C(CO)=O)=O)=O,,,5,1,2,0,2
31530_0,,,,2,3,2,5
C(C(CCO)CC(C(CO)=O)=O)=O,,,5,1,1,0,1
31532_0,,,,2,3,2,5
C(CO)(CCCC(C(C=O)=O)O)=O,,,5,1,2,0,2
31533_0,,,,2,3,2,5
31535_0,,,,2,3,2,5
C(CC(CO)CC(C(C=O)=O)O)=O,,,5,1,2,0,2
31537_0,,,,2,3,2,5
C(C(CC(C(C=O)=O)O)CCO)=O,,,5,1,1,0,1
31538_0,,,,2,3,2,5
31540_0,,,,2,3,2,5
C(CO)(CCC(C(C=O)=O)(C)O)=O,,,5,1,2,0,2
31541_0,,,,2,3,2,5
31543_0,,,,2,3,2,5
C(CC(CO)C(C(C=O)=O)(C)O)=O,,,5,1,2,0,2
31545_0,,,,2,3,2,5
C(C(CCO)C(C(C=O)=O)(C)O)=O,,,5,1,1,0,1
31546_0,,,,2,3,2,5
31548_0,,,,2,3,2,5
C(C)(C(CCC(CO)=O)O)=O,,,5,1,2,0,2
31550_0,,,,2,3,2,5
C(CC(CO)C(C(C)=O)O)=O,,,5,1,3,0,3
31552_0,,,,2,3,2,5
C(C(CCO)C(C(C)=O)O)=O,,,5,1,2,0,2
31554_0,,,,2,3,2,5
C(CO)(CCCC(CO)=O)=O,,,5,1,2,0,2
31556_0,,,,2,3,2,5
C(CC(CO)CC(CO)=O)=O,,,5,1,4,0,4
31558_0,,,,2,3,2,5
C(C(CCO)CC(CO)=O)=O,,,5,1,3,0,3
31560_0,,,,2,3,2,5
C(C(CCC(CO)=O)O)(CCO)=O,,,5,1,2,0,2
31562_0,,,,2,3,2,5
C(CC(CO)C(C(CCO)=O)O)=O,,,5,1,2,0,2
31564_0,,,,2,3,2,5
C(C(CCO)C(C(CCO)=O)O)=O,,,5,1,1,0,1
31565_0,,,,2,3,2,5
31566_0,,,,2,3,2,5
31568_0,,,,2,3,2,5
C(C(C(CC(CO)=O)O)CCO)=O,,,5,1,1,0,1
31570_0,,,,2,3,2,5
C(CO)(C(CO)CCC(CO)=O)=O,,,5,1,2,0,2
31572_0,,,,2,3,2,5
C(CC(CO)C(C(CO)=O)CO)=O,,,5,1,2,0,2
31574_0,,,,2,3,2,5
C(C(CCO)C(C(CO)=O)CO)=O,,,5,1,1,0,1
31576_0,,,,2,3,2,5
C(C(CCC(CO)=O)(CCO)O)=O,,,5,1,2,0,2
31577_0,,,,2,3,2,5
31579_0,,,,2,3,2,5
C(C(CCO)(C(CO)CC=O)O)=O,,,5,1,2,0,2
31581_0,,,,2,3,2,5
C(C(CCO)C(C=O)(CCO)O)=O,,,5,1,1,0,1
31582_0,,,,2,3,2,5
31584_0,,,,2,3,2,5
C(C(CC(CCC(CO)=O)O)O)=O,,,5,1,2,0,2
31586_0,,,,2,3,2,5
C(C(CCC(CC(CO)O)O)=O)=O,,,5,1,2,0,2
31588_0,,,,2,3,2,5
C(CC(CO)C(CC(C=O)O)O)=O,,,5,1,2,0,2
31590_0,,,,2,3,2,5
C(C(C(CC(C=O)O)O)CCO)=O,,,5,1,1,0,1
31591_0,,,,2,3,2,5
31593_0,,,,2,3,2,5
C(C(C(CCC(CO)=O)CO)O)=O,,,5,1,2,0,2
31594_0,,,,2,3,2,5
31596_0,,,,2,3,2,5
C(CC(CO)C(CO)C(C=O)O)=O,,,5,1,2,0,2
31598_0,,,,2,3,2,5
C(C(CCO)C(CO)C(C=O)O)=O,,,5,1,1,0,1
31599_0,,,,2,3,2,5
31601_0,,,,2,3,2,5
C(C)(C(CO)(CCC(CO)=O)O)=O,,,5,1,2,0,2
31603_0,,,,2,3,2,5
C(CC(CO)C(C(C)=O)(CO)O)=O,,,5,1,2,0,2
31605_0,,,,2,3,2,5
C(C(CCO)C(C(C)=O)(CO)O)=O,,,5,1,1,0,1
31606_0,,,,2,3,2,5
31607_0,,,,2,3,2,5
31609_0,,,,2,3,2,5
C(C(C(C(C(C)=O)O)O)CCO)=O,,,5,1,1,0,1
31611_0,,,,2,3,2,5
C(C(CO)O)(CCCC(CO)=O)=O,,,5,1,2,0,2
31613_0,,,,2,3,2,5
C(CC(CO)CC(C(CO)O)=O)=O,,,5,1,2,0,2
31615_0,,,,2,3,2,5
C(C(CCO)CC(C(CO)O)=O)=O,,,5,1,2,0,2
31617_0,,,,2,3,2,5
C(CO)(CCC(C)O)=O,,,5,1,2,0,2
31619_0,,,,2,3,2,5
C(CC(CO)C(C)O)=O,,,5,1,2,0,2
31621_0,,,,2,3,2,5
C(C(CCO)C(C)O)=O,,,5,1,1,0,1
31623_0,,,,2,3,2,5
C(CO)(CCCCO)=O,,,5,1,2,0,2
31625_0,,,,2,3,2,5
C(CC(CO)CCO)=O,,,5,1,2,0,2
31627_0,,,,2,3,2,5
C(C(CCO)CCO)=O,,,5,1,1,0,1
31629_0,,,,2,3,2,5
C(CO)(CCCC(C(O)=O)=O)=O,,,5,1,4,0,4
31631_0,,,,2,3,2,5
C(CC(CO)CC(C(O)=O)=O)=O,,,5,1,3,0,3
31633_0,,,,2,3,2,5
C(C(CCO)CC(C(O)=O)=O)=O,,,5,1,2,0,2
31635_0,,,,2,3,2,5
C(C(C=O)CCC(CO)=O)(O)=O,,,5,1,2,0,2
31637_0,,,,2,3,2,5
C(C(CCC(C=O)=O)CO)(O)=O,,,5,1,3,0,3
31639_0,,,,2,3,2,5
C(C(C=O)C(CO)CC=O)(O)=O,,,5,1,2,0,2
31640_0,,,,2,3,2,5
31642_0,,,,2,3,2,5
C(C(CO)C(C=O)CC=O)(O)=O,,,5,1,3,0,3
31644_0,,,,2,3,2,5
C(CCCC(CO)=O)(O)=O,,,5,1,3,0,3
31646_0,,,,2,3,2,5
C(CC(CO)CC=O)(O)=O,,,5,1,3,0,3
31648_0,,,,2,3,2,5
C(C(CCO)CC(O)=O)=O,,,5,1,3,0,3
31650_0,,,,2,3,2,5
C1(C(CCC(CO)=O)OCC1O)=O,,,5,1,2,0,2
31652_0,,,,2,3,2,5
C(CC(CO)C1C(C(CO1)O)=O)=O,,,5,1,2,0,2
31654_0,,,,2,3,2,5
C(C(CCO)C1C(C(CO1)O)=O)=O,,,5,1,1,0,1
31656_0,,,,2,3,2,5
C(CO)(CCC1C(C(CO1)=O)O)=O,,,5,1,2,0,2
31658_0,,,,2,3,2,5
C(CC(CO)C1C(C(CO1)=O)O)=O,,,5,1,2,0,2
31660_0,,,,2,3,2,5
C(C(C1C(C(CO1)=O)O)CCO)=O,,,5,1,1,0,1
31662_0,,,,2,3,2,5
C(CO)(CCC1(C(COC1)=O)O)=O,,,5,1,2,0,2
31664_0,,,,2,3,2,5
C(CC(CO)C1(C(COC1)=O)O)=O,,,5,1,2,0,2
31666_0,,,,2,3,2,5
C(C(CCO)C1(C(COC1)=O)O)=O,,,5,1,1,0,1
31668_0,,,,2,3,2,5
C1(C(CCC(CO)=O)(O)OCC1)=O,,,5,1,2,0,2
31670_0,,,,2,3,2,5
C(CC(CO)C1(C(CCO1)=O)O)=O,,,5,1,2,0,2
31672_0,,,,2,3,2,5
C(C(CCO)C1(C(CCO1)=O)O)=O,,,5,1,1,0,1
31674_0,,,,2,3,2,5
C(CO)(CCC1CC(C(O)O1)=O)=O,,,5,1,2,0,2
31676_0,,,,2,3,2,5
C(CC(CO)C1CC(C(O)O1)=O)=O,,,5,1,2,0,2
31678_0,,,,2,3,2,5
C(C(C1CC(C(O)O1)=O)CCO)=O,,,5,1,1,0,1
31680_0,,,,2,3,2,5
C(CO)(CCC1C(C(O)OC1)=O)=O,,,5,1,2,0,2
31682_0,,,,2,3,2,5
C(CC(CO)C1C(C(O)OC1)=O)=O,,,5,1,2,0,2
31684_0,,,,2,3,2,5
C(C(CCO)C1C(C(O)OC1)=O)=O,,,5,1,1,0,1
31686_0,,,,2,3,2,5
C1(C(CCC(CO)=O)C(CO1)O)=O,,,5,1,2,0,2
31688_0,,,,2,3,2,5
C1(C(C(CO)CC=O)C(CO1)O)=O,,,5,1,2,0,2
31690_0,,,,2,3,2,5
C1(C(C(CO1)O)C(C=O)CCO)=O,,,5,1,1,0,1
31692_0,,,,2,3,2,5
C1(CC(C(CCC(CO)=O)O1)O)=O,,,5,1,2,0,2
31694_0,,,,2,3,2,5
C1(CC(C(C(CO)CC=O)O1)O)=O,,,5,1,2,0,2
31696_0,,,,2,3,2,5
C(C(CCO)C1C(CC(O1)=O)O)=O,,,5,1,1,0,1
31698_0,,,,2,3,2,5
C1(CC(CCC(CO)=O)(CO1)O)=O,,,5,1,2,0,2
31700_0,,,,2,3,2,5
C1(CC(CO1)(C(CO)CC=O)O)=O,,,5,1,2,0,2
31702_0,,,,2,3,2,5
C(C(CCO)C1(COC(C1)=O)O)=O,,,5,1,1,0,1
31704_0,,,,2,3,2,5
C(CO)(CCC1C(COC1O)=O)=O,,,5,1,2,0,2
31706_0,,,,2,3,2,5
C(CC(CO)C1C(COC1O)=O)=O,,,5,1,2,0,2
31708_0,,,,2,3,2,5
C(C(CCO)C1C(COC1O)=O)=O,,,5,1,1,0,1
31710_0,,,,2,3,2,5
C(CO)(CCC1(CC(CO1)=O)O)=O,,,5,1,2,0,2
31712_0,,,,2,3,2,5
C(CC(CO)C1(CC(CO1)=O)O)=O,,,5,1,2,0,2
31714_0,,,,2,3,2,5
C(C(C1(CC(CO1)=O)O)CCO)=O,,,5,1,1,0,1
31716_0,,,,2,3,2,5
C1(C(CCC(CO)=O)OC(C1)O)=O,,,5,1,2,0,2
31718_0,,,,2,3,2,5
C(CC(CO)C1C(CC(O1)O)=O)=O,,,5,1,2,0,2
31720_0,,,,2,3,2,5
C(C(CCO)C1C(CC(O1)O)=O)=O,,,5,1,1,0,1
31721_0,,,,2,3,2,5
31723_0,,,,2,3,2,5
C(C(CO)(CCC(CO)=O)O)=O,,,5,1,2,0,2
31724_0,,,,2,3,2,5
31725_0,,,,2,3,2,5
31726_0,,,,2,3,2,5
31728_0,,,,2,3,2,5
C(CO)(CCC(CO)O)=O,,,5,1,2,0,2
31729_0,,,,2,3,2,5
31731_0,,,,2,3,2,5
C(CO)(CCC(C(CO)=O)O)=O,,,5,1,2,0,2
31733_0,,,,2,3,2,5
C(CO)(CCC(CO)(CO)O)=O,,,5,1,2,0,2
31735_0,,,,2,3,2,5
C(CO)(CCC(C(CO)O)O)=O,,,5,1,2,0,2
31736_0,,,,2,3,2,5
31738_0,,,,2,3,2,5
C(C(C(CCC(CO)=O)O)O)(O)=O,,,5,1,3,0,3
31739_0,,,,2,3,2,5
31740_0,,,,2,3,2,5
31742_0,,,,2,3,2,5
C(C(C=O)CCC(CO)=O)=O,,,5,1,3,0,3
31743_0,,,,2,3,2,5
31744_0,,,,2,3,2,5
31745_0,,,,2,3,2,5
31746_0,,,,2,3,2,5
31747_0,,,,2,3,2,5
31748_0,,,,2,3,2,5
31749_0,,,,2,3,2,5
31750_0,,,,2,3,2,5
31751_0,,,,2,3,2,5
31753_0,,,,2,3,2,5
C(CO)(CCC(C=O)C(C=O)O)=O,,,5,1,3,0,3
31754_0,,,,2,3,2,5
31756_0,,,,2,3,2,5
C(C(C(CO)=O)CCC(CO)=O)=O,,,5,1,3,0,3
31757_0,,,,2,3,2,5
31759_0,,,,2,3,2,5
C(C(CCC(CO)=O)O)(CC=O)=O,,,5,1,2,0,2
31760_0,,,,2,3,2,5
31762_0,,,,2,3,2,5
C(C)(C(C=O)(CCC(CO)=O)O)=O,,,5,1,2,0,2
31763_0,,,,2,3,2,5
31765_0,,,,2,3,2,5
C(CCCC(CO)=O)(C(C=O)O)=O,,,5,1,3,0,3
31766_0,,,,2,3,2,5
31768_0,,,,2,3,2,5
C(CCCC(CO)=O)=O,,,5,1,3,0,3
31769_0,,,,2,3,2,5
31770_0,,,,2,3,2,5
31772_0,,,,2,3,2,5
C(C(C(C(C=O)O)O)CCO)=O,,,5,1,1,0,1
31774_0,,,,2,3,2,5
C(CC(CO)C(CO)(CO)O)=O,,,5,1,3,0,3
31776_0,,,,2,3,2,5
C(C(CCO)C(CO)(CO)O)=O,,,5,1,1,0,1
31778_0,,,,2,3,2,5
C(CC(CO)C(C(CO)O)O)=O,,,5,1,3,0,3
31780_0,,,,2,3,2,5
C(C(CCO)C(C(CO)O)O)=O,,,5,1,1,0,1
31781_0,,,,2,3,2,5
31782_0,,,,2,3,2,5
31784_0,,,,2,3,2,5
C(CC(CO)C(C(C(O)=O)O)O)=O,,,5,1,4,0,4
31786_0,,,,2,3,2,5
C(C(C(C(C(O)=O)O)O)CCO)=O,,,5,1,1,0,1
31787_0,,,,2,3,2,5
31788_0,,,,2,3,2,5
31790_0,,,,2,3,2,5
C(C(C(CC(C=O)=O)O)CCO)=O,,,5,1,1,0,1
31791_0,,,,2,3,2,5
31793_0,,,,2,3,2,5
C(CC(CO)C(C(C=O)=O)CO)=O,,,5,1,5,0,5
31795_0,,,,2,3,2,5
C(C(CCO)C(C(C=O)=O)CO)=O,,,5,1,4,0,4
31796_0,,,,2,3,2,5
31797_0,,,,2,3,2,5
31798_0,,,,2,3,2,5
31799_0,,,,2,3,2,5
31800_0,,,,2,3,2,5
31801_0,,,,2,3,2,5
31803_0,,,,2,3,2,5
C(CC(CO)C(C=O)C(C=O)O)=O,,,5,1,5,0,5
31804_0,,,,2,3,2,5
31805_0,,,,2,3,2,5
31807_0,,,,2,3,2,5
C(CC(CO)C(C=O)C(CO)=O)=O,,,5,1,5,0,5
31809_0,,,,2,3,2,5
C(C(CCO)C(C=O)C(CO)=O)=O,,,5,1,3,0,3
31810_0,,,,2,3,2,5
31812_0,,,,2,3,2,5
C(CC(CO)C(C(CC=O)=O)O)=O,,,5,1,3,0,3
31814_0,,,,2,3,2,5
C(C(CCO)C(C(CC=O)=O)O)=O,,,5,1,2,0,2
31815_0,,,,2,3,2,5
31817_0,,,,2,3,2,5
C(CC(CO)C(C=O)(C(C)=O)O)=O,,,5,1,3,0,3
31819_0,,,,2,3,2,5
C(C(CCO)C(C=O)(C(C)=O)O)=O,,,5,1,2,0,2
31820_0,,,,2,3,2,5
31822_0,,,,2,3,2,5
C(C(C(CC(CO)CC=O)=O)O)=O,,,5,1,5,0,5
31824_0,,,,2,3,2,5
C(C(CCO)CC(C(C=O)O)=O)=O,,,5,1,3,0,3
31825_0,,,,2,3,2,5
31826_0,,,,2,3,2,5
31827_0,,,,2,3,2,5
31828_0,,,,2,3,2,5
31829_0,,,,2,3,2,5
31830_0,,,,2,3,2,5
31831_0,,,,2,3,2,5
31832_0,,,,2,3,2,5
31833_0,,,,2,3,2,5
31834_0,,,,2,3,2,5
31835_0,,,,2,3,2,5
31836_0,,,,2,3,2,5
31837_0,,,,2,3,2,5
31839_0,,,,2,3,2,5
C(C1C(C(CC1(C=O)O)O)O)(O)=O,,,5,1,2,0,2
31840_0,,,,2,3,2,5
31841_0,,,,2,3,2,5
31842_0,,,,2,3,2,5
31843_0,,,,2,3,2,5
31844_0,,,,2,3,2,5
31845_0,,,,2,3,2,5
31846_0,,,,2,3,2,5
31848_0,,,,2,3,2,5
C(C1C(C(CC1O)O)O)(O)=O,,,5,1,3,0,3
31850_0,,,,2,3,2,5
C(C1C(C(C(C1O)O)O)O)(O)=O,,,5,1,2,0,2
31851_0,,,,2,3,2,5
31852_0,,,,2,3,2,5
31853_0,,,,2,3,2,5
31854_0,,,,2,3,2,5
31855_0,,,,2,3,2,5
31856_0,,,,2,3,2,5
31857_0,,,,2,3,2,5
31859_0,,,,2,3,2,5
C(C1C(C(C=O)(CC1O)O)O)(O)=O,,,5,1,3,0,3
31860_0,,,,2,3,2,5
31862_0,,,,2,3,2,5
C(C1C(CC(C1(C=O)O)O)O)(O)=O,,,5,1,3,0,3
31864_0,,,,2,3,2,5
C(C(CC(C=O)(CC(O)=O)O)O)=O,,,5,1,1,0,1
31865_0,,,,2,3,2,5
31866_0,,,,2,3,2,5
31867_0,,,,2,3,2,5
31868_0,,,,2,3,2,5
31869_0,,,,2,3,2,5
31870_0,,,,2,3,2,5
31871_0,,,,2,3,2,5
31873_0,,,,2,3,2,5
C(CC(CC(CO)(CO)O)O)(O)=O,,,5,1,1,0,1
31875_0,,,,2,3,2,5
C(C(C(C)O)C(CO)(CO)O)(O)=O,,,5,1,3,0,3
31876_0,,,,2,3,2,5
31878_0,,,,2,3,2,5
C(CC(CO)(C(C(C)O)O)O)(O)=O,,,5,1,1,0,1
31880_0,,,,2,3,2,5
C(C(C)(CC(CC(O)=O)O)O)=O,,,5,1,1,0,1
31881_0,,,,2,3,2,5
31882_0,,,,2,3,2,5
31883_0,,,,2,3,2,5
31884_0,,,,2,3,2,5
31885_0,,,,2,3,2,5
31886_0,,,,2,3,2,5
31887_0,,,,2,3,2,5
31889_0,,,,2,3,2,5
C(C(C(C)O)C(C=O)(C)O)(O)=O,,,5,1,3,0,3
31890_0,,,,2,3,2,5
31891_0,,,,2,3,2,5
31892_0,,,,2,3,2,5
31893_0,,,,2,3,2,5
31894_0,,,,2,3,2,5
31896_0,,,,2,3,2,5
C(C(C)(C(C(CC(O)=O)O)O)O)=O,,,5,1,2,0,2
31897_0,,,,2,3,2,5
31898_0,,,,2,3,2,5
31899_0,,,,2,3,2,5
31901_0,,,,2,3,2,5
C(CC(CC(C(C)=O)O)O)(O)=O,,,5,1,1,0,1
31902_0,,,,2,3,2,5
31904_0,,,,2,3,2,5
C(C(C(C)O)C(C(C)=O)O)(O)=O,,,5,1,3,0,3
31905_0,,,,2,3,2,5
31906_0,,,,2,3,2,5
31907_0,,,,2,3,2,5
31908_0,,,,2,3,2,5
31909_0,,,,2,3,2,5
31910_0,,,,2,3,2,5
31911_0,,,,2,3,2,5
31912_0,,,,2,3,2,5
31914_0,,,,2,3,2,5
C(C(CC(C)O)(CC(O)=O)O)=O,,,5,1,1,0,1
31915_0,,,,2,3,2,5
31916_0,,,,2,3,2,5
31917_0,,,,2,3,2,5
31918_0,,,,2,3,2,5
31919_0,,,,2,3,2,5
31921_0,,,,2,3,2,5
C(C(CC(CO)O)(CC(O)=O)O)=O,,,5,1,1,0,1
31922_0,,,,2,3,2,5
31923_0,,,,2,3,2,5
31924_0,,,,2,3,2,5
31925_0,,,,2,3,2,5
31926_0,,,,2,3,2,5
31927_0,,,,2,3,2,5
31928_0,,,,2,3,2,5
31929_0,,,,2,3,2,5
31930_0,,,,2,3,2,5
31931_0,,,,2,3,2,5
31932_0,,,,2,3,2,5
31933_0,,,,2,3,2,5
31934_0,,,,2,3,2,5
31935_0,,,,2,3,2,5
31936_0,,,,2,3,2,5
31937_0,,,,2,3,2,5
31938_0,,,,2,3,2,5
31939_0,,,,2,3,2,5
31940_0,,,,2,3,2,5
31941_0,,,,2,3,2,5
31942_0,,,,2,3,2,5
31943_0,,,,2,3,2,5
31944_0,,,,2,3,2,5
31945_0,,,,2,3,2,5
31947_0,,,,2,3,2,5
C(C(C(CO)CO)(CC(O)=O)O)=O,,,5,1,1,0,1
31948_0,,,,2,3,2,5
31949_0,,,,2,3,2,5
31950_0,,,,2,3,2,5
31951_0,,,,2,3,2,5
31952_0,,,,2,3,2,5
31953_0,,,,2,3,2,5
31954_0,,,,2,3,2,5
31955_0,,,,2,3,2,5
31956_0,,,,2,3,2,5
31957_0,,,,2,3,2,5
31958_0,,,,2,3,2,5
31959_0,,,,2,3,2,5
31960_0,,,,2,3,2,5
31961_0,,,,2,3,2,5
31962_0,,,,2,3,2,5
31963_0,,,,2,3,2,5
31964_0,,,,2,3,2,5
31965_0,,,,2,3,2,5
31967_0,,,,2,3,2,5
C(CC(CCO)(C(C=O)O)O)(O)=O,,,5,1,1,0,1
31968_0,,,,2,3,2,5
31969_0,,,,2,3,2,5
31971_0,,,,2,3,2,5
C(C(C(C)O)C(CC(C)O)O)(O)=O,,,5,1,2,0,2
31972_0,,,,2,3,2,5
31973_0,,,,2,3,2,5
31975_0,,,,2,3,2,5
C(C(C(O)=O)C(CC(C)O)O)(O)=O,,,5,1,2,0,2
31976_0,,,,2,3,2,5
31977_0,,,,2,3,2,5
31979_0,,,,2,3,2,5
C(CC(CC(C)O)O)(O)=O,,,5,1,1,0,1
31980_0,,,,2,3,2,5
31982_0,,,,2,3,2,5
C(C(C(C)O)C(CCO)O)(O)=O,,,5,1,2,0,2
31983_0,,,,2,3,2,5
31985_0,,,,2,3,2,5
C(C(C(C)O)C(C=O)(CO)O)(O)=O,,,5,1,4,0,4
31986_0,,,,2,3,2,5
31988_0,,,,2,3,2,5
C(C(C(C)O)C(C)(CO)O)(O)=O,,,5,1,2,0,2
31990_0,,,,2,3,2,5
C(C(C(C)O)C(C(O)=O)O)(O)=O,,,5,1,4,0,4
31992_0,,,,2,3,2,5
C(C(C(C)O)C(C(O)=O)(C)O)(O)=O,,,5,1,2,0,2
31994_0,,,,2,3,2,5
C(C(C(CC(O)=O)O)C(C)O)(O)=O,,,5,1,2,0,2
31995_0,,,,2,3,2,5
31997_0,,,,2,3,2,5
C(C(C=C)(C(C(O)=O)C(C)O)O)=O,,,5,1,2,0,2
31999_0,,,,2,3,2,5
C(C(C(C)O)C(C(C=C)=O)O)(O)=O,,,5,1,2,0,2
32000_0,,,,2,3,2,5
32002_0,,,,2,3,2,5
C(C(C(C)O)C(C=CC=O)O)(O)=O,,,5,1,2,0,2
32004_0,,,,2,3,2,5
C(C(C(C)O)C(C(CO)O)O)(O)=O,,,5,1,3,0,3
32006_0,,,,2,3,2,5
C(C(C(C)O)C(C)O)(O)=O,,,5,1,2,0,2
32007_0,,,,2,3,2,5
32008_0,,,,2,3,2,5
32009_0,,,,2,3,2,5
32010_0,,,,2,3,2,5
32011_0,,,,2,3,2,5
32013_0,,,,2,3,2,5
C(CC(C(C(C)O)O)O)(O)=O,,,5,1,1,0,1
32014_0,,,,2,3,2,5
32016_0,,,,2,3,2,5
C(CC(CC(C(CO)O)O)O)(O)=O,,,5,1,1,0,1
32017_0,,,,2,3,2,5
32018_0,,,,2,3,2,5
32019_0,,,,2,3,2,5
32020_0,,,,2,3,2,5
32022_0,,,,2,3,2,5
C(C(C(O)=O)C(CCO)O)(O)=O,,,5,1,2,0,2
32023_0,,,,2,3,2,5
32024_0,,,,2,3,2,5
32025_0,,,,2,3,2,5
32026_0,,,,2,3,2,5
32027_0,,,,2,3,2,5
32028_0,,,,2,3,2,5
32029_0,,,,2,3,2,5
32030_0,,,,2,3,2,5
32031_0,,,,2,3,2,5
32032_0,,,,2,3,2,5
32033_0,,,,2,3,2,5
32034_0,,,,2,3,2,5
32035_0,,,,2,3,2,5
32036_0,,,,2,3,2,5
32037_0,,,,2,3,2,5
32038_0,,,,2,3,2,5
32039_0,,,,2,3,2,5
32040_0,,,,2,3,2,5
32041_0,,,,2,3,2,5
32042_0,,,,2,3,2,5
32043_0,,,,2,3,2,5
32044_0,,,,2,3,2,5
32045_0,,,,2,3,2,5
32046_0,,,,2,3,2,5
32047_0,,,,2,3,2,5
32048_0,,,,2,3,2,5
32049_0,,,,2,3,2,5
32050_0,,,,2,3,2,5
32051_0,,,,2,3,2,5
32052_0,,,,2,3,2,5
32053_0,,,,2,3,2,5
32054_0,,,,2,3,2,5
32055_0,,,,2,3,2,5
32056_0,,,,2,3,2,5
32057_0,,,,2,3,2,5
32058_0,,,,2,3,2,5
32059_0,,,,2,3,2,5
32060_0,,,,2,3,2,5
32061_0,,,,2,3,2,5
32062_0,,,,2,3,2,5
32063_0,,,,2,3,2,5
32064_0,,,,2,3,2,5
32065_0,,,,2,3,2,5
32066_0,,,,2,3,2,5
32067_0,,,,2,3,2,5
32068_0,,,,2,3,2,5
32070_0,,,,2,3,2,5
C(C(C(O)=O)C(C=O)(CO)O)(O)=O,,,5,1,3,0,3
32071_0,,,,2,3,2,5
32072_0,,,,2,3,2,5
32073_0,,,,2,3,2,5
32074_0,,,,2,3,2,5
32075_0,,,,2,3,2,5
32076_0,,,,2,3,2,5
32077_0,,,,2,3,2,5
32079_0,,,,2,3,2,5
C(C(C(O)=O)C(C(CO)=O)O)(O)=O,,,5,1,3,0,3
32080_0,,,,2,3,2,5
32081_0,,,,2,3,2,5
32082_0,,,,2,3,2,5
32083_0,,,,2,3,2,5
32084_0,,,,2,3,2,5
32085_0,,,,2,3,2,5
32086_0,,,,2,3,2,5
32087_0,,,,2,3,2,5
32088_0,,,,2,3,2,5
32089_0,,,,2,3,2,5
32090_0,,,,2,3,2,5
32091_0,,,,2,3,2,5
32092_0,,,,2,3,2,5
32093_0,,,,2,3,2,5
32094_0,,,,2,3,2,5
32095_0,,,,2,3,2,5
32096_0,,,,2,3,2,5
32097_0,,,,2,3,2,5
32098_0,,,,2,3,2,5
32099_0,,,,2,3,2,5
32100_0,,,,2,3,2,5
32101_0,,,,2,3,2,5
32102_0,,,,2,3,2,5
32103_0,,,,2,3,2,5
32105_0,,,,2,3,2,5
C(C)(C(CO)(CC(O)=O)O)=O,,,5,1,3,0,3
32106_0,,,,2,3,2,5
32107_0,,,,2,3,2,5
32108_0,,,,2,3,2,5
32109_0,,,,2,3,2,5
32110_0,,,,2,3,2,5
32111_0,,,,2,3,2,5
32112_0,,,,2,3,2,5
32113_0,,,,2,3,2,5
32114_0,,,,2,3,2,5
32115_0,,,,2,3,2,5
32116_0,,,,2,3,2,5
32117_0,,,,2,3,2,5
32118_0,,,,2,3,2,5
32119_0,,,,2,3,2,5
32120_0,,,,2,3,2,5
32121_0,,,,2,3,2,5
32122_0,,,,2,3,2,5
32123_0,,,,2,3,2,5
32124_0,,,,2,3,2,5
32125_0,,,,2,3,2,5
32126_0,,,,2,3,2,5
32127_0,,,,2,3,2,5
32128_0,,,,2,3,2,5
32130_0,,,,2,3,2,5
C(C(C(O)=O)C(C)(CO)O)(O)=O,,,5,1,2,0,2
32131_0,,,,2,3,2,5
32132_0,,,,2,3,2,5
32133_0,,,,2,3,2,5
32134_0,,,,2,3,2,5
32135_0,,,,2,3,2,5
32136_0,,,,2,3,2,5
32137_0,,,,2,3,2,5
32138_0,,,,2,3,2,5
32139_0,,,,2,3,2,5
32140_0,,,,2,3,2,5
32141_0,,,,2,3,2,5
32142_0,,,,2,3,2,5
32143_0,,,,2,3,2,5
32144_0,,,,2,3,2,5
32145_0,,,,2,3,2,5
32146_0,,,,2,3,2,5
32147_0,,,,2,3,2,5
32148_0,,,,2,3,2,5
32149_0,,,,2,3,2,5
32150_0,,,,2,3,2,5
32151_0,,,,2,3,2,5
32152_0,,,,2,3,2,5
32153_0,,,,2,3,2,5
32154_0,,,,2,3,2,5
32155_0,,,,2,3,2,5
32156_0,,,,2,3,2,5
32157_0,,,,2,3,2,5
32158_0,,,,2,3,2,5
32159_0,,,,2,3,2,5
32160_0,,,,2,3,2,5
32161_0,,,,2,3,2,5
32162_0,,,,2,3,2,5
32163_0,,,,2,3,2,5
32164_0,,,,2,3,2,5
32165_0,,,,2,3,2,5
32166_0,,,,2,3,2,5
32167_0,,,,2,3,2,5
32168_0,,,,2,3,2,5
32169_0,,,,2,3,2,5
32170_0,,,,2,3,2,5
32171_0,,,,2,3,2,5
32173_0,,,,2,3,2,5
C(C(C(O)=O)C(C(O)=O)O)(O)=O,,,5,1,3,0,3
32174_0,,,,2,3,2,5
32175_0,,,,2,3,2,5
32176_0,,,,2,3,2,5
32177_0,,,,2,3,2,5
32178_0,,,,2,3,2,5
32179_0,,,,2,3,2,5
32180_0,,,,2,3,2,5
32181_0,,,,2,3,2,5
32183_0,,,,2,3,2,5
C(C(C(O)=O)C(C(O)=O)(C)O)(O)=O,,,5,1,2,0,2
32184_0,,,,2,3,2,5
32185_0,,,,2,3,2,5
32186_0,,,,2,3,2,5
32187_0,,,,2,3,2,5
32188_0,,,,2,3,2,5
32189_0,,,,2,3,2,5
32190_0,,,,2,3,2,5
32191_0,,,,2,3,2,5
32192_0,,,,2,3,2,5
32194_0,,,,2,3,2,5
C(C(C(O)=O)C(CC(O)=O)O)(O)=O,,,5,1,2,0,2
32195_0,,,,2,3,2,5
32196_0,,,,2,3,2,5
32198_0,,,,2,3,2,5
C(CC(CC(O)=O)O)(O)=O,,,5,1,1,0,1
32199_0,,,,2,3,2,5
32200_0,,,,2,3,2,5
32202_0,,,,2,3,2,5
C(C(C(O)=O)C(C=O)(C=C)O)(O)=O,,,5,1,2,0,2
32204_0,,,,2,3,2,5
C(C(C(O)=O)C(C(C=C)=O)O)(O)=O,,,5,1,2,0,2
32205_0,,,,2,3,2,5
32207_0,,,,2,3,2,5
C(C(C(O)=O)C(C=CC=O)O)(O)=O,,,5,1,2,0,2
32209_0,,,,2,3,2,5
C(C(C(O)=O)C(C(CO)O)O)(O)=O,,,5,1,3,0,3
32210_0,,,,2,3,2,5
32212_0,,,,2,3,2,5
C(C(C(O)=O)C(C=O)O)(O)=O,,,5,1,3,0,3
32214_0,,,,2,3,2,5
C(C(C(O)=O)C(CO)(CO)O)(O)=O,,,5,1,3,0,3
32215_0,,,,2,3,2,5
32217_0,,,,2,3,2,5
C(C(C(O)=O)C(C=O)(C)O)(O)=O,,,5,1,3,0,3
32219_0,,,,2,3,2,5
C(C(C(O)=O)C(C(C)=O)O)(O)=O,,,5,1,3,0,3
32220_0,,,,2,3,2,5
32222_0,,,,2,3,2,5
C(C(C(O)=O)C(CC=O)O)(O)=O,,,5,1,3,0,3
32224_0,,,,2,3,2,5
C(C(C(O)=O)C(C)O)(O)=O,,,5,1,3,0,3
32226_0,,,,2,3,2,5
C(C(C(O)=O)CO)(O)=O,,,5,1,3,0,3
32228_0,,,,2,3,2,5
C(C(C(O)=O)C(CO)O)(O)=O,,,5,1,3,0,3
32229_0,,,,2,3,2,5
32230_0,,,,2,3,2,5
32231_0,,,,2,3,2,5
32232_0,,,,2,3,2,5
32233_0,,,,2,3,2,5
32235_0,,,,2,3,2,5
C(CC(C(CC(O)=O)O)O)(O)=O,,,5,1,1,0,1
32236_0,,,,2,3,2,5
32238_0,,,,2,3,2,5
C(CC(CO)(CC(O)=O)O)(O)=O,,,5,1,1,0,1
32239_0,,,,2,3,2,5
32240_0,,,,2,3,2,5
32241_0,,,,2,3,2,5
32243_0,,,,2,3,2,5
C(CC(C)(C(C(O)=O)O)O)(O)=O,,,5,1,3,0,3
32244_0,,,,2,3,2,5
32245_0,,,,2,3,2,5
32246_0,,,,2,3,2,5
32248_0,,,,2,3,2,5
C(C(CO)(C(C)(CC(O)=O)O)O)=O,,,5,1,5,0,5
32249_0,,,,2,3,2,5
32250_0,,,,2,3,2,5
32251_0,,,,2,3,2,5
32253_0,,,,2,3,2,5
C(C(CO)C(C(C(O)=O)O)O)(O)=O,,,5,1,4,0,4
32254_0,,,,2,3,2,5
32255_0,,,,2,3,2,5
32257_0,,,,2,3,2,5
C(C(CO)(CC(CC(O)=O)O)O)=O,,,5,1,2,0,2
32258_0,,,,2,3,2,5
32259_0,,,,2,3,2,5
32260_0,,,,2,3,2,5
32261_0,,,,2,3,2,5
32262_0,,,,2,3,2,5
32263_0,,,,2,3,2,5
32264_0,,,,2,3,2,5
32266_0,,,,2,3,2,5
C(CC1(COCC1O)O)(O)=O,,,5,1,1,0,1
32267_0,,,,2,3,2,5
32268_0,,,,2,3,2,5
32269_0,,,,2,3,2,5
32270_0,,,,2,3,2,5
32271_0,,,,2,3,2,5
32272_0,,,,2,3,2,5
32274_0,,,,2,3,2,5
C(CC1(C(O)OCC1)O)(O)=O,,,5,1,2,0,2
32275_0,,,,2,3,2,5
32276_0,,,,2,3,2,5
32277_0,,,,2,3,2,5
32278_0,,,,2,3,2,5
32279_0,,,,2,3,2,5
32280_0,,,,2,3,2,5
32282_0,,,,2,3,2,5
C(CC1(COC(C1)O)O)(O)=O,,,5,1,2,0,2
32283_0,,,,2,3,2,5
32284_0,,,,2,3,2,5
32285_0,,,,2,3,2,5
32286_0,,,,2,3,2,5
32287_0,,,,2,3,2,5
32288_0,,,,2,3,2,5
32289_0,,,,2,3,2,5
32290_0,,,,2,3,2,5
32291_0,,,,2,3,2,5
32292_0,,,,2,3,2,5
32293_0,,,,2,3,2,5
32294_0,,,,2,3,2,5
32296_0,,,,2,3,2,5
C(C(C=C)(CC(O)=O)O)=O,,,5,1,3,0,3
32297_0,,,,2,3,2,5
32298_0,,,,2,3,2,5
32299_0,,,,2,3,2,5
32300_0,,,,2,3,2,5
32301_0,,,,2,3,2,5
32303_0,,,,2,3,2,5
C(CC(C(C=C)=O)O)(O)=O,,,5,1,2,0,2
32304_0,,,,2,3,2,5
32305_0,,,,2,3,2,5
32306_0,,,,2,3,2,5
32307_0,,,,2,3,2,5
32308_0,,,,2,3,2,5
32309_0,,,,2,3,2,5
32311_0,,,,2,3,2,5
C(CC(C=CC=O)O)(O)=O,,,5,1,3,0,3
32312_0,,,,2,3,2,5
32313_0,,,,2,3,2,5
32314_0,,,,2,3,2,5
32315_0,,,,2,3,2,5
32316_0,,,,2,3,2,5
32317_0,,,,2,3,2,5
32318_0,,,,2,3,2,5
32319_0,,,,2,3,2,5
32320_0,,,,2,3,2,5
32321_0,,,,2,3,2,5
32322_0,,,,2,3,2,5
32323_0,,,,2,3,2,5
32324_0,,,,2,3,2,5
32325_0,,,,2,3,2,5
32326_0,,,,2,3,2,5
32328_0,,,,2,3,2,5
C(C(C(CO)(CO)O)=O)(O)=O,,,5,1,3,0,3
32330_0,,,,2,3,2,5
C(C(C(CO)(C(CO)O)O)=O)(O)=O,,,5,1,5,0,5
32331_0,,,,2,3,2,5
32332_0,,,,2,3,2,5
32333_0,,,,2,3,2,5
32334_0,,,,2,3,2,5
32335_0,,,,2,3,2,5
32337_0,,,,2,3,2,5
C(C(C(C(O)=O)=O)(CCO)O)=O,,,5,1,1,0,1
32338_0,,,,2,3,2,5
32340_0,,,,2,3,2,5
C(CCO)(C(C(C(O)=O)=O)O)=O,,,5,1,2,0,2
32341_0,,,,2,3,2,5
32342_0,,,,2,3,2,5
32344_0,,,,2,3,2,5
C(CO)(CC(C(C(O)=O)=O)O)=O,,,5,1,2,0,2
32346_0,,,,2,3,2,5
C(CC(C(C(O)=O)=O)(CO)O)=O,,,5,1,1,0,1
32347_0,,,,2,3,2,5
32349_0,,,,2,3,2,5
C(C(C(C(C(O)=O)=O)(C)O)O)=O,,,5,1,2,0,2
32350_0,,,,2,3,2,5
32351_0,,,,2,3,2,5
32353_0,,,,2,3,2,5
C(C(C(CCO)=O)=O)(O)=O,,,5,1,2,0,2
32354_0,,,,2,3,2,5
32356_0,,,,2,3,2,5
C(C(C(CC(CO)O)=O)=O)(O)=O,,,5,1,2,0,2
32357_0,,,,2,3,2,5
32358_0,,,,2,3,2,5
32359_0,,,,2,3,2,5
32360_0,,,,2,3,2,5
32361_0,,,,2,3,2,5
32362_0,,,,2,3,2,5
32363_0,,,,2,3,2,5
32364_0,,,,2,3,2,5
32365_0,,,,2,3,2,5
32366_0,,,,2,3,2,5
32367_0,,,,2,3,2,5
32368_0,,,,2,3,2,5
32369_0,,,,2,3,2,5
32370_0,,,,2,3,2,5
32372_0,,,,2,3,2,5
C(C(C(O)=O)(CO)O)(O)=O,,,5,1,3,0,3
32373_0,,,,2,3,2,5
32374_0,,,,2,3,2,5
32376_0,,,,2,3,2,5
C(C(C=O)(C(CO)O)O)(O)=O,,,5,1,5,0,5
32377_0,,,,2,3,2,5
32378_0,,,,2,3,2,5
32380_0,,,,2,3,2,5
C(C(C(O)=O)O)(O)=O,,,5,1,2,0,2
32381_0,,,,2,3,2,5
32382_0,,,,2,3,2,5
32383_0,,,,2,3,2,5
32384_0,,,,2,3,2,5
32385_0,,,,2,3,2,5
32386_0,,,,2,3,2,5
32387_0,,,,2,3,2,5
32388_0,,,,2,3,2,5
32389_0,,,,2,3,2,5
32390_0,,,,2,3,2,5
32391_0,,,,2,3,2,5
32392_0,,,,2,3,2,5
32393_0,,,,2,3,2,5
32394_0,,,,2,3,2,5
32395_0,,,,2,3,2,5
32396_0,,,,2,3,2,5
32397_0,,,,2,3,2,5
32398_0,,,,2,3,2,5
32399_0,,,,2,3,2,5
32400_0,,,,2,3,2,5
32401_0,,,,2,3,2,5
32402_0,,,,2,3,2,5
32403_0,,,,2,3,2,5
32404_0,,,,2,3,2,5
32405_0,,,,2,3,2,5
32406_0,,,,2,3,2,5
32407_0,,,,2,3,2,5
32408_0,,,,2,3,2,5
32409_0,,,,2,3,2,5
32410_0,,,,2,3,2,5
32411_0,,,,2,3,2,5
32412_0,,,,2,3,2,5
32413_0,,,,2,3,2,5
32414_0,,,,2,3,2,5
32415_0,,,,2,3,2,5
32416_0,,,,2,3,2,5
32417_0,,,,2,3,2,5
32418_0,,,,2,3,2,5
32419_0,,,,2,3,2,5
32420_0,,,,2,3,2,5
32421_0,,,,2,3,2,5
32422_0,,,,2,3,2,5
32423_0,,,,2,3,2,5
32424_0,,,,2,3,2,5
32425_0,,,,2,3,2,5
32426_0,,,,2,3,2,5
32427_0,,,,2,3,2,5
32428_0,,,,2,3,2,5
32429_0,,,,2,3,2,5
32430_0,,,,2,3,2,5
32431_0,,,,2,3,2,5
32432_0,,,,2,3,2,5
32433_0,,,,2,3,2,5
32434_0,,,,2,3,2,5
32435_0,,,,2,3,2,5
32436_0,,,,2,3,2,5
32437_0,,,,2,3,2,5
32438_0,,,,2,3,2,5
32439_0,,,,2,3,2,5
32440_0,,,,2,3,2,5
32441_0,,,,2,3,2,5
32442_0,,,,2,3,2,5
32443_0,,,,2,3,2,5
32444_0,,,,2,3,2,5
32445_0,,,,2,3,2,5
32446_0,,,,2,3,2,5
32447_0,,,,2,3,2,5
32448_0,,,,2,3,2,5
32449_0,,,,2,3,2,5
32450_0,,,,2,3,2,5
32451_0,,,,2,3,2,5
32452_0,,,,2,3,2,5
32453_0,,,,2,3,2,5
32454_0,,,,2,3,2,5
32455_0,,,,2,3,2,5
32456_0,,,,2,3,2,5
32457_0,,,,2,3,2,5
32458_0,,,,2,3,2,5
32459_0,,,,2,3,2,5
32460_0,,,,2,3,2,5
32461_0,,,,2,3,2,5
32462_0,,,,2,3,2,5
32463_0,,,,2,3,2,5
32464_0,,,,2,3,2,5
32465_0,,,,2,3,2,5
32466_0,,,,2,3,2,5
32467_0,,,,2,3,2,5
32468_0,,,,2,3,2,5
32469_0,,,,2,3,2,5
32470_0,,,,2,3,2,5
32471_0,,,,2,3,2,5
32472_0,,,,2,3,2,5
32473_0,,,,2,3,2,5
32474_0,,,,2,3,2,5
32475_0,,,,2,3,2,5
32476_0,,,,2,3,2,5
32477_0,,,,2,3,2,5
32478_0,,,,2,3,2,5
32479_0,,,,2,3,2,5
32480_0,,,,2,3,2,5
32481_0,,,,2,3,2,5
32482_0,,,,2,3,2,5
32483_0,,,,2,3,2,5
32485_0,,,,2,3,2,5
C(CC(C(O)=O)(C(C=O)O)O)(O)=O,,,5,1,3,0,3
32486_0,,,,2,3,2,5
32487_0,,,,2,3,2,5
32488_0,,,,2,3,2,5
32489_0,,,,2,3,2,5
32490_0,,,,2,3,2,5
32492_0,,,,2,3,2,5
C(C(C(C)O)(CC(O)=O)O)(O)=O,,,5,1,3,0,3
32493_0,,,,2,3,2,5
32495_0,,,,2,3,2,5
C(C(CO)(CC(O)=O)O)(O)=O,,,5,1,3,0,3
32496_0,,,,2,3,2,5
32498_0,,,,2,3,2,5
C(C(C(CO)O)(CC(O)=O)O)(O)=O,,,5,1,3,0,3
32499_0,,,,2,3,2,5
32501_0,,,,2,3,2,5
C(C=CC(O)=O)(O)=O,,,5,1,2,0,2
32503_0,,,,2,3,2,5
C(C1(C(CC(C1O)=O)O)O)(O)=O,,,5,1,3,0,3
32505_0,,,,2,3,2,5
C(C1(C=O)C(C(CC1O)O)O)(O)=O,,,5,1,4,0,4
32506_0,,,,2,3,2,5
32508_0,,,,2,3,2,5
C(C(C=O)(C(C)O)C(C=O)O)(O)=O,,,5,1,4,0,4
32509_0,,,,2,3,2,5
32511_0,,,,2,3,2,5
C(C(C=O)(CO)C(C=O)O)(O)=O,,,5,1,4,0,4
32512_0,,,,2,3,2,5
32513_0,,,,2,3,2,5
32514_0,,,,2,3,2,5
32516_0,,,,2,3,2,5
C(C(C=O)(CO)C(C=O)(C)O)(O)=O,,,5,1,4,0,4
32517_0,,,,2,3,2,5
32518_0,,,,2,3,2,5
32519_0,,,,2,3,2,5
32521_0,,,,2,3,2,5
C(C(C=O)(CO)C(C(C)=O)O)(O)=O,,,5,1,4,0,4
32522_0,,,,2,3,2,5
32524_0,,,,2,3,2,5
C(C(C=O)(CO)C(CC=O)O)(O)=O,,,5,1,4,0,4
32525_0,,,,2,3,2,5
32526_0,,,,2,3,2,5
32527_0,,,,2,3,2,5
32529_0,,,,2,3,2,5
C(C(C=O)(C(C)O)C(C)O)(O)=O,,,5,1,3,0,3
32531_0,,,,2,3,2,5
C(C(C=O)(CO)C(C)O)(O)=O,,,5,1,4,0,4
32533_0,,,,2,3,2,5
C(C(C=O)(C(CO)O)C(C)O)(O)=O,,,5,1,4,0,4
32535_0,,,,2,3,2,5
C(C(C=O)(CO)C(CCO)O)(O)=O,,,5,1,4,0,4
32537_0,,,,2,3,2,5
C(C(C=O)(CO)C(C)(CO)O)(O)=O,,,5,1,4,0,4
32539_0,,,,2,3,2,5
C(C(C=O)(CO)C(C(O)=O)O)(O)=O,,,5,1,4,0,4
32541_0,,,,2,3,2,5
C(C(C=O)(CO)CO)(O)=O,,,5,1,3,0,3
32543_0,,,,2,3,2,5
C(C(C=O)(CO)C(CO)O)(O)=O,,,5,1,4,0,4
32545_0,,,,2,3,2,5
C(C(C(CO)(CO)C(C)O)=O)(O)=O,,,5,1,3,0,3
32547_0,,,,2,3,2,5
C(C(C(CO)(CO)CO)=O)(O)=O,,,5,1,2,0,2
32548_0,,,,2,3,2,5
32550_0,,,,2,3,2,5
C(C(CO)(C(C)O)C(C=O)O)(O)=O,,,5,1,3,0,3
32551_0,,,,2,3,2,5
32553_0,,,,2,3,2,5
C(C(CO)(CO)C(C=O)O)(O)=O,,,5,1,2,0,2
32555_0,,,,2,3,2,5
C(C(C(CO)=O)(CO)C(C)O)(O)=O,,,5,1,4,0,4
32557_0,,,,2,3,2,5
C(C(C(CO)=O)(CO)CO)(O)=O,,,5,1,3,0,3
32558_0,,,,2,3,2,5
32559_0,,,,2,3,2,5
32560_0,,,,2,3,2,5
32561_0,,,,2,3,2,5
32562_0,,,,2,3,2,5
32563_0,,,,2,3,2,5
32564_0,,,,2,3,2,5
32565_0,,,,2,3,2,5
32566_0,,,,2,3,2,5
32568_0,,,,2,3,2,5
C(C(C(C(C(O)=O)=O)(CO)O)O)=O,,,5,1,3,0,3
32570_0,,,,2,3,2,5
C(C(C(CO)(C(C)O)O)=O)(O)=O,,,5,1,3,0,3
32571_0,,,,2,3,2,5
32572_0,,,,2,3,2,5
32573_0,,,,2,3,2,5
32574_0,,,,2,3,2,5
32575_0,,,,2,3,2,5
32576_0,,,,2,3,2,5
32577_0,,,,2,3,2,5
32578_0,,,,2,3,2,5
32580_0,,,,2,3,2,5
C(C(C=C)(C(C=O)(CO)O)O)(O)=O,,,5,1,4,0,4
32581_0,,,,2,3,2,5
32582_0,,,,2,3,2,5
32584_0,,,,2,3,2,5
C(C(CO)(C(C=CC(O)=O)O)O)=O,,,5,1,3,0,3
32585_0,,,,2,3,2,5
32587_0,,,,2,3,2,5
C(C1(C(C(C(C1)=O)O)O)O)(O)=O,,,5,1,2,0,2
32589_0,,,,2,3,2,5
C(C1(CC(CC1(C=O)O)O)O)(O)=O,,,5,1,3,0,3
32591_0,,,,2,3,2,5
C(C1(C(CC(C1)O)O)O)(O)=O,,,5,1,2,0,2
32593_0,,,,2,3,2,5
C(C1(C(C(C(C1)O)O)O)O)(O)=O,,,5,1,2,0,2
32594_0,,,,2,3,2,5
32595_0,,,,2,3,2,5
32597_0,,,,2,3,2,5
C(C)(C(C(C)O)(CC(O)=O)O)=O,,,5,1,2,0,2
32599_0,,,,2,3,2,5
C(C)(C(C(CO)O)(CC(O)=O)O)=O,,,5,1,2,0,2
32601_0,,,,2,3,2,5
C(C(CO)(CC(O)=O)O)(CCO)=O,,,5,1,2,0,2
32603_0,,,,2,3,2,5
C(C(C(C)(C(CCO)O)O)=O)(O)=O,,,5,1,2,0,2
32604_0,,,,2,3,2,5
32606_0,,,,2,3,2,5
C(C(C=C)(C(C(O)=O)(C)O)O)(O)=O,,,5,1,3,0,3
32608_0,,,,2,3,2,5
C(C(C)(C(C=CC(O)=O)O)O)(O)=O,,,5,1,2,0,2
32609_0,,,,2,3,2,5
32610_0,,,,2,3,2,5
32612_0,,,,2,3,2,5
C(C(C(C)(C(CO)(C)O)O)=O)(O)=O,,,5,1,2,0,2
32614_0,,,,2,3,2,5
C(C(C(C(C(O)=O)=O)(C)O)O)(O)=O,,,5,1,2,0,2
32615_0,,,,2,3,2,5
32617_0,,,,2,3,2,5
C(C(C)(C(C(C(O)=O)=O)(C)O)O)=O,,,5,1,2,0,2
32619_0,,,,2,3,2,5
C(C(C(C(C(O)=O)=O)(C)O)O)(C)=O,,,5,1,2,0,2
32620_0,,,,2,3,2,5
32622_0,,,,2,3,2,5
C(CC(C(C(C(O)=O)=O)(C)O)O)=O,,,5,1,2,0,2
32624_0,,,,2,3,2,5
C(C(C(C)(C(C)O)O)=O)(O)=O,,,5,1,2,0,2
32625_0,,,,2,3,2,5
32627_0,,,,2,3,2,5
C(C(C(C)(C(CO)O)O)=O)(O)=O,,,5,1,2,0,2
32628_0,,,,2,3,2,5
32629_0,,,,2,3,2,5
32630_0,,,,2,3,2,5
32631_0,,,,2,3,2,5
32633_0,,,,2,3,2,5
C(C(C=C)(C(C(O)=O)O)O)(O)=O,,,5,1,5,0,5
32635_0,,,,2,3,2,5
C(C(C(C=CC(O)=O)O)O)(O)=O,,,5,1,4,0,4
32637_0,,,,2,3,2,5
C(CO)(OCC(O)=O)=O,,,5,1,1,0,1
32639_0,,,,2,3,2,5
C(C(CO)OC(CO)=O)(O)=O,,,5,1,1,0,1
32641_0,,,,2,3,2,5
C(C(C(CO)O)OC(CO)=O)(O)=O,,,5,1,1,0,1
32643_0,,,,2,3,2,5
C(C(COC(CO)=O)O)(O)=O,,,5,1,1,0,1
32645_0,,,,2,3,2,5
C(C(C(CO)OC(CO)=O)O)(O)=O,,,5,1,1,0,1
32647_0,,,,2,3,2,5
C(C(C(COC(CO)=O)O)O)(O)=O,,,5,1,2,0,2
32649_0,,,,2,3,2,5
C(CCC(O)=O)(C(C(CO)O)O)=O,,,5,1,1,0,1
32650_0,,,,2,3,2,5
32651_0,,,,2,3,2,5
32652_0,,,,2,3,2,5
32653_0,,,,2,3,2,5
32654_0,,,,2,3,2,5
32656_0,,,,2,3,2,5
C(CC(CC(C(O)=O)=O)=O)=O,,,5,1,2,0,2
32657_0,,,,2,3,2,5
32659_0,,,,2,3,2,5
C(C(CO)CC(C=O)=O)(O)=O,,,5,1,1,0,1
32660_0,,,,2,3,2,5
32662_0,,,,2,3,2,5
C(C(C=O)C(C(O)=O)CO)=O,,,5,1,1,0,1
32663_0,,,,2,3,2,5
32665_0,,,,2,3,2,5
C(C(CO)C(C(C=O)=O)CO)(O)=O,,,5,1,1,0,1
32666_0,,,,2,3,2,5
32668_0,,,,2,3,2,5
C(C(C(C(O)=O)C(C=O)CO)O)=O,,,5,1,1,0,1
32670_0,,,,2,3,2,5
C(C(CO)C(C=O)C(C=O)O)(O)=O,,,5,1,1,0,1
32672_0,,,,2,3,2,5
C(C(CO)C(C(O)=O)C(CO)=O)=O,,,5,1,1,0,1
32674_0,,,,2,3,2,5
C(C(CO)C(C=O)C(CO)=O)(O)=O,,,5,1,1,0,1
32675_0,,,,2,3,2,5
32676_0,,,,2,3,2,5
32678_0,,,,2,3,2,5
C(C(CO)C(C(CC=O)=O)O)(O)=O,,,5,1,2,0,2
32679_0,,,,2,3,2,5
32681_0,,,,2,3,2,5
C(C(CO)CC(C(C=O)O)=O)(O)=O,,,5,1,1,0,1
32683_0,,,,2,3,2,5
C(C(CO)CC(O)=O)=O,,,5,1,3,0,3
32685_0,,,,2,3,2,5
C(C(CO)CC=O)(O)=O,,,5,1,2,0,2
32686_0,,,,2,3,2,5
32687_0,,,,2,3,2,5
32689_0,,,,2,3,2,5
C(CCC(C(CO)=O)=O)(O)=O,,,5,1,2,0,2
32691_0,,,,2,3,2,5
C(C(C(C(CO)=O)=O)CCO)(O)=O,,,5,1,1,0,1
32692_0,,,,2,3,2,5
32694_0,,,,2,3,2,5
C(CCC(C(C(CO)=O)O)=O)(O)=O,,,5,1,1,0,1
32696_0,,,,2,3,2,5
C(CC(C(CC(CO)=O)=O)O)(O)=O,,,5,1,1,0,1
32697_0,,,,2,3,2,5
32699_0,,,,2,3,2,5
C(C(CCC(C(CO)=O)=O)O)(O)=O,,,5,1,1,0,1
32701_0,,,,2,3,2,5
C(CC(C=O)C(C(CO)=O)O)(O)=O,,,5,1,2,0,2
32703_0,,,,2,3,2,5
C(C(CC=O)C(C(CO)=O)O)(O)=O,,,5,1,2,0,2
32705_0,,,,2,3,2,5
C(CC(C(C(CO)=O)=O)CO)(O)=O,,,5,1,1,0,1
32706_0,,,,2,3,2,5
32707_0,,,,2,3,2,5
32708_0,,,,2,3,2,5
32710_0,,,,2,3,2,5
C(C(C(CO)O)CC(C=O)=O)(O)=O,,,5,1,1,0,1
32711_0,,,,2,3,2,5
32712_0,,,,2,3,2,5
32714_0,,,,2,3,2,5
C(C(C=O)C(C(O)=O)C(CO)O)=O,,,5,1,1,0,1
32715_0,,,,2,3,2,5
32717_0,,,,2,3,2,5
C(C(C(CO)O)CC(O)=O)=O,,,5,1,4,0,4
32719_0,,,,2,3,2,5
C(C(C(CO)O)CC=O)(O)=O,,,5,1,2,0,2
32721_0,,,,2,3,2,5
C(CO)(C(CO)CC(O)=O)=O,,,5,1,3,0,3
32722_0,,,,2,3,2,5
32723_0,,,,2,3,2,5
32725_0,,,,2,3,2,5
C(CCC(C(C(CO)O)=O)=O)(O)=O,,,5,1,1,0,1
32726_0,,,,2,3,2,5
32727_0,,,,2,3,2,5
32729_0,,,,2,3,2,5
C(CC(C(CO)CO)=O)(O)=O,,,5,1,2,0,2
32731_0,,,,2,3,2,5
C(CC(C(CO)C(CO)O)=O)(O)=O,,,5,1,1,0,1
32733_0,,,,2,3,2,5
C(C(C(C(CC(O)=O)=O)=O)C)=O,,,5,1,2,0,2
32734_0,,,,2,3,2,5
32735_0,,,,2,3,2,5
32736_0,,,,2,3,2,5
32738_0,,,,2,3,2,5
C(CC(C(CC(C)=O)=O)=O)(O)=O,,,5,1,2,0,2
32740_0,,,,2,3,2,5
C(CC(O)=O)(CC(C(C)=O)=O)=O,,,5,1,3,0,3
32741_0,,,,2,3,2,5
32743_0,,,,2,3,2,5
C(CC(CCC(C=O)=O)=O)(O)=O,,,5,1,3,0,3
32745_0,,,,2,3,2,5
C(CC(CCC(C(O)=O)=O)=O)=O,,,5,1,2,0,2
32747_0,,,,2,3,2,5
C(CCC(O)=O)(CC(C=O)=O)=O,,,5,1,2,0,2
32749_0,,,,2,3,2,5
C(CCC(CC(C(O)=O)=O)=O)=O,,,5,1,2,0,2
32751_0,,,,2,3,2,5
C(C(CC(O)=O)CC(C=O)=O)=O,,,5,1,4,0,4
32753_0,,,,2,3,2,5
C(CC(C(O)=O)CC(C=O)=O)=O,,,5,1,2,0,2
32754_0,,,,2,3,2,5
32756_0,,,,2,3,2,5
C(C(CCC(C(C)=O)=O)=O)(O)=O,,,5,1,2,0,2
32758_0,,,,2,3,2,5
C(CC(C)=O)(CC(C(O)=O)=O)=O,,,5,1,2,0,2
32760_0,,,,2,3,2,5
C(C(O)=O)(C(C)CC(C=O)=O)=O,,,5,1,2,0,2
32762_0,,,,2,3,2,5
C(C=O)(C(C)CC(C(O)=O)=O)=O,,,5,1,2,0,2
32763_0,,,,2,3,2,5
32764_0,,,,2,3,2,5
32765_0,,,,2,3,2,5
32766_0,,,,2,3,2,5
32768_0,,,,2,3,2,5
C(CCC(C=O)=O)(O)=O,,,5,1,2,0,2
32769_0,,,,2,3,2,5
32770_0,,,,2,3,2,5
32772_0,,,,2,3,2,5
C(CC(C(CCC(O)=O)=O)=O)=O,,,5,1,2,0,2
32773_0,,,,2,3,2,5
32774_0,,,,2,3,2,5
32776_0,,,,2,3,2,5
C(C(C=O)CC(CC(O)=O)=O)=O,,,5,1,2,0,2
32777_0,,,,2,3,2,5
32779_0,,,,2,3,2,5
C(C(C=O)C(CCC(O)=O)=O)=O,,,5,1,2,0,2
32780_0,,,,2,3,2,5
32782_0,,,,2,3,2,5
C(C(C=O)C(C=O)CC(O)=O)=O,,,5,1,4,0,4
32784_0,,,,2,3,2,5
C(C(C=O)C(C(O)=O)CC=O)=O,,,5,1,2,0,2
32785_0,,,,2,3,2,5
32786_0,,,,2,3,2,5
32787_0,,,,2,3,2,5
32789_0,,,,2,3,2,5
C(C(C=O)C(C(C(O)=O)=O)C)=O,,,5,1,2,0,2
32790_0,,,,2,3,2,5
32791_0,,,,2,3,2,5
32792_0,,,,2,3,2,5
32793_0,,,,2,3,2,5
32794_0,,,,2,3,2,5
32796_0,,,,2,3,2,5
C(C(C=O)CC(O)=O)=O,,,5,1,2,0,2
32797_0,,,,2,3,2,5
32798_0,,,,2,3,2,5
32799_0,,,,2,3,2,5
32800_0,,,,2,3,2,5
32801_0,,,,2,3,2,5
32802_0,,,,2,3,2,5
32804_0,,,,2,3,2,5
C(CC(C(C=O)=O)CO)(O)=O,,,5,1,2,0,2
32805_0,,,,2,3,2,5
32806_0,,,,2,3,2,5
32808_0,,,,2,3,2,5
C(CC(CCC(O)=O)=O)=O,,,5,1,2,0,2
32810_0,,,,2,3,2,5
C(CC(CCC=O)=O)(O)=O,,,5,1,2,0,2
32811_0,,,,2,3,2,5
32812_0,,,,2,3,2,5
32813_0,,,,2,3,2,5
32814_0,,,,2,3,2,5
32815_0,,,,2,3,2,5
32817_0,,,,2,3,2,5
C(C(C(CCC(O)=O)=O)O)=O,,,5,1,2,0,2
32818_0,,,,2,3,2,5
32819_0,,,,2,3,2,5
32820_0,,,,2,3,2,5
32822_0,,,,2,3,2,5
C(C(CC(CO)=O)C(C=O)O)(O)=O,,,5,1,2,0,2
32823_0,,,,2,3,2,5
32825_0,,,,2,3,2,5
C(CCO)(C(C(O)=O)C(C=O)O)=O,,,5,1,1,0,1
32827_0,,,,2,3,2,5
C(CC(C=O)C(C=O)O)(O)=O,,,5,1,3,0,3
32828_0,,,,2,3,2,5
32830_0,,,,2,3,2,5
C(C(CC=O)C(C=O)O)(O)=O,,,5,1,3,0,3
32831_0,,,,2,3,2,5
32832_0,,,,2,3,2,5
32833_0,,,,2,3,2,5
32835_0,,,,2,3,2,5
C(CC(C(O)=O)CC=O)=O,,,5,1,2,0,2
32837_0,,,,2,3,2,5
C(C(C(CO)=O)CC(CO)=O)(O)=O,,,5,1,1,0,1
32839_0,,,,2,3,2,5
C(CCO)(C(C(O)=O)C(CO)=O)=O,,,5,1,1,0,1
32841_0,,,,2,3,2,5
C(C(C(CO)=O)CC(O)=O)=O,,,5,1,2,0,2
32842_0,,,,2,3,2,5
32843_0,,,,2,3,2,5
32845_0,,,,2,3,2,5
C(CC(O)=O)(CC(C)=O)=O,,,5,1,3,0,3
32847_0,,,,2,3,2,5
C(CC(C(CC)=O)=O)(O)=O,,,5,1,2,0,2
32848_0,,,,2,3,2,5
32849_0,,,,2,3,2,5
32850_0,,,,2,3,2,5
32851_0,,,,2,3,2,5
32853_0,,,,2,3,2,5
C(CCC(C(C)=O)=O)(O)=O,,,5,1,2,0,2
32854_0,,,,2,3,2,5
32855_0,,,,2,3,2,5
32857_0,,,,2,3,2,5
C(CC(C(C=O)=O)C)(O)=O,,,5,1,2,0,2
32859_0,,,,2,3,2,5
C(CC(C(C(O)=O)=O)C)=O,,,5,1,2,0,2
32860_0,,,,2,3,2,5
32861_0,,,,2,3,2,5
32863_0,,,,2,3,2,5
C(C(C(CCC(CO)=O)=O)O)(O)=O,,,5,1,1,0,1
32864_0,,,,2,3,2,5
32865_0,,,,2,3,2,5
32867_0,,,,2,3,2,5
C(CCC(CO)=O)(O)=O,,,5,1,2,0,2
32868_0,,,,2,3,2,5
32870_0,,,,2,3,2,5
C(CCC(O)=O)(C(CO)O)=O,,,5,1,2,0,2
32871_0,,,,2,3,2,5
32873_0,,,,2,3,2,5
C(CCC(O)=O)=O,,,5,1,2,0,2
32874_0,,,,2,3,2,5
32875_0,,,,2,3,2,5
32876_0,,,,2,3,2,5
32877_0,,,,2,3,2,5
32879_0,,,,2,3,2,5
C(C(C(C)=O)C(C(O)=O)=O)=O,,,5,1,2,0,2
32880_0,,,,2,3,2,5
32881_0,,,,2,3,2,5
32883_0,,,,2,3,2,5
C(C(CO)C(C(O)=O)(CO)O)(O)=O,,,5,1,2,0,2
32885_0,,,,2,3,2,5
C(C(CO)C(C(O)=O)(C(C)=O)O)=O,,,5,1,2,0,2
32887_0,,,,2,3,2,5
C(C(CO)C(C=O)(C(C)=O)O)(O)=O,,,5,1,2,0,2
32888_0,,,,2,3,2,5
32889_0,,,,2,3,2,5
32891_0,,,,2,3,2,5
C(C(C(C)=O)C(C(C)=O)=O)(O)=O,,,5,1,2,0,2
32892_0,,,,2,3,2,5
32893_0,,,,2,3,2,5
32894_0,,,,2,3,2,5
32895_0,,,,2,3,2,5
32896_0,,,,2,3,2,5
32897_0,,,,2,3,2,5
32898_0,,,,2,3,2,5
32899_0,,,,2,3,2,5
32900_0,,,,2,3,2,5
32901_0,,,,2,3,2,5
32902_0,,,,2,3,2,5
32903_0,,,,2,3,2,5
32905_0,,,,2,3,2,5
C(CC(C(C(C=O)CO)=O)O)(O)=O,,,5,1,1,0,1
32907_0,,,,2,3,2,5
C(C(C(CCC=O)=O)(CO)O)(O)=O,,,5,1,5,0,5
32909_0,,,,2,3,2,5
C(C(C(CCC(O)=O)=O)(CO)O)=O,,,5,1,1,0,1
32910_0,,,,2,3,2,5
32911_0,,,,2,3,2,5
32912_0,,,,2,3,2,5
32913_0,,,,2,3,2,5
32915_0,,,,2,3,2,5
C(CC(C=O)C(C=O)(CO)O)(O)=O,,,5,1,2,0,2
32917_0,,,,2,3,2,5
C(CC(C(O)=O)C(C=O)(CO)O)=O,,,5,1,2,0,2
32919_0,,,,2,3,2,5
C(C(C(C)=O)C(C)=O)(O)=O,,,5,1,3,0,3
32921_0,,,,2,3,2,5
C(C(C(C)=O)(CC(CO)=O)O)(O)=O,,,5,1,2,0,2
32923_0,,,,2,3,2,5
C(CCO)(C(C(O)=O)(C(C)=O)O)=O,,,5,1,1,0,1
32924_0,,,,2,3,2,5
32926_0,,,,2,3,2,5
C(C(C(C)=O)(CC(O)=O)O)=O,,,5,1,2,0,2
32928_0,,,,2,3,2,5
C(C(C(C)=O)(CC=O)O)(O)=O,,,5,1,4,0,4
32930_0,,,,2,3,2,5
C(C(C(C)=O)(C(C)=O)O)(O)=O,,,5,1,2,0,2
32931_0,,,,2,3,2,5
32932_0,,,,2,3,2,5
32934_0,,,,2,3,2,5
C(C(C(CC(C)=O)=O)(CO)O)(O)=O,,,5,1,5,0,5
32935_0,,,,2,3,2,5
32936_0,,,,2,3,2,5
32937_0,,,,2,3,2,5
32938_0,,,,2,3,2,5
32939_0,,,,2,3,2,5
32941_0,,,,2,3,2,5
C(C(C(C=O)=O)CC(O)=O)=O,,,5,1,2,0,2
32943_0,,,,2,3,2,5
C(C(C(C(O)=O)=O)CC=O)=O,,,5,1,2,0,2
32944_0,,,,2,3,2,5
32945_0,,,,2,3,2,5
32946_0,,,,2,3,2,5
32947_0,,,,2,3,2,5
32948_0,,,,2,3,2,5
32949_0,,,,2,3,2,5
32950_0,,,,2,3,2,5
32952_0,,,,2,3,2,5
C(C(C(C(C)=O)=O)CC(O)=O)=O,,,5,1,2,0,2
32953_0,,,,2,3,2,5
32955_0,,,,2,3,2,5
C(C(C(CC=O)=O)CC(O)=O)=O,,,5,1,2,0,2
32956_0,,,,2,3,2,5
32958_0,,,,2,3,2,5
C(CCC(C(O)=O)=O)(O)=O,,,5,1,2,0,2
32959_0,,,,2,3,2,5
32961_0,,,,2,3,2,5
C(C(C(C(O)=O)=O)CCO)(O)=O,,,5,1,2,0,2
32963_0,,,,2,3,2,5
C(C(C(C)=O)CC=O)(O)=O,,,5,1,3,0,3
32965_0,,,,2,3,2,5
C(C(C(C)=O)CC(O)=O)=O,,,5,1,2,0,2
32966_0,,,,2,3,2,5
32967_0,,,,2,3,2,5
32969_0,,,,2,3,2,5
C(CCO)(C(C(O)=O)(CC=O)O)=O,,,5,1,2,0,2
32971_0,,,,2,3,2,5
C(CCO)(C(C=O)(CC(O)=O)O)=O,,,5,1,1,0,1
32972_0,,,,2,3,2,5
32974_0,,,,2,3,2,5
C(C(CO)O)(C(C=O)CC(O)=O)=O,,,5,1,1,0,1
32975_0,,,,2,3,2,5
32976_0,,,,2,3,2,5
32977_0,,,,2,3,2,5
32978_0,,,,2,3,2,5
32980_0,,,,2,3,2,5
C(C(C(CCC(O)=O)=O)O)(O)=O,,,5,1,2,0,2
32982_0,,,,2,3,2,5
C(C(CCC(C(O)=O)=O)O)(O)=O,,,5,1,4,0,4
32983_0,,,,2,3,2,5
32985_0,,,,2,3,2,5
C(CC(C(C(O)=O)=O)CO)(O)=O,,,5,1,2,0,2
32987_0,,,,2,3,2,5
C(CC(C=O)C(C(O)=O)O)(O)=O,,,5,1,3,0,3
32989_0,,,,2,3,2,5
C(C(C(C(O)=O)CC=O)O)(O)=O,,,5,1,2,0,2
32990_0,,,,2,3,2,5
32991_0,,,,2,3,2,5
32993_0,,,,2,3,2,5
C(CC1C(C(C(O)O1)O)O)(O)=O,,,5,1,2,0,2
32995_0,,,,2,3,2,5
C(C1C(O)OC(CO)C1O)(O)=O,,,5,1,2,0,2
32997_0,,,,2,3,2,5
C(C1C(O)OCC1O)(O)=O,,,5,1,2,0,2
32999_0,,,,2,3,2,5
C(CC1(C(O)OCC1O)O)(O)=O,,,5,1,2,0,2
33001_0,,,,2,3,2,5
C(C1C(O)OCC(C1O)O)(O)=O,,,5,1,2,0,2
33003_0,,,,2,3,2,5
C(CC1C(C(C(O1)=O)O)O)(O)=O,,,5,1,2,0,2
33005_0,,,,2,3,2,5
C(C(C(C(CO)O)O)O)=CC(O)=O,,,5,1,1,0,1
33007_0,,,,2,3,2,5
C(C=CC(C(O)=O)=O)=O,,,5,1,4,0,4
33009_0,,,,2,3,2,5
C(C(C=CC(O)=O)=O)=O,,,5,1,2,0,2
33011_0,,,,2,3,2,5
C(C(C(O)=O)=CC=O)=O,,,5,1,3,0,3
33013_0,,,,2,3,2,5
C(C(C=O)=CC(O)=O)=O,,,5,1,2,0,2
33015_0,,,,2,3,2,5
C(C(C(C(C(O)=O)=O)=C)O)=O,,,5,1,2,0,2
33017_0,,,,2,3,2,5
C(C(C(C(C=O)=O)=C)O)(O)=O,,,5,1,3,0,3
33019_0,,,,2,3,2,5
C(C(C(CO)=CC=O)=O)(O)=O,,,5,1,2,0,2
33021_0,,,,2,3,2,5
C(C(C(CO)=CC(O)=O)=O)=O,,,5,1,2,0,2
33023_0,,,,2,3,2,5
C(C(C(C=O)=CC(O)=O)O)=O,,,5,1,3,0,3
33025_0,,,,2,3,2,5
C(C(C(C(O)=O)=CC=O)O)=O,,,5,1,3,0,3
33027_0,,,,2,3,2,5
C(C(C(C=O)=CC=O)O)(O)=O,,,5,1,3,0,3
33029_0,,,,2,3,2,5
C(C(C(CO)=O)=CC=O)(O)=O,,,5,1,2,0,2
33031_0,,,,2,3,2,5
C(C(C(CO)=O)=CC(O)=O)=O,,,5,1,2,0,2
33032_0,,,,2,3,2,5
33034_0,,,,2,3,2,5
C(C(C(C=CC(O)=O)=O)O)=O,,,5,1,2,0,2
33036_0,,,,2,3,2,5
C(CO)(CO)=CC(C(O)=O)=O,,,5,1,2,0,2
33038_0,,,,2,3,2,5
C(CO)(CO)=C(C(O)=O)C=O,,,5,1,2,0,2
33040_0,,,,2,3,2,5
C=C(C(C(O)=O)=O)C(CO)(CO)O,,,5,1,1,0,1
33042_0,,,,2,3,2,5
C(CO)(CO)=C(C(C(O)=O)=O)CO,,,5,1,1,0,1
33044_0,,,,2,3,2,5
C(C=C(C=O)C(CO)(CO)O)(O)=O,,,5,1,1,0,1
33046_0,,,,2,3,2,5
C(C(C(CO)(CO)O)=CC=O)(O)=O,,,5,1,1,0,1
33048_0,,,,2,3,2,5
C(C(C(C=O)=C(CO)CO)O)(O)=O,,,5,1,1,0,1
33050_0,,,,2,3,2,5
C(C(C(C(O)=O)=C(CO)CO)O)=O,,,5,1,1,0,1
33052_0,,,,2,3,2,5
C(CO)(CO)=C(C(O)=O)C(CO)=O,,,5,1,1,0,1
33054_0,,,,2,3,2,5
C(C(C(C=C(CO)CO)=O)O)(O)=O,,,5,1,1,0,1
33056_0,,,,2,3,2,5
C(CO)(CO)=CC(O)=O,,,5,1,3,0,3
33058_0,,,,2,3,2,5
C(CO)(C(C(C(O)=O)=C)O)=O,,,5,1,2,0,2
33059_0,,,,2,3,2,5
33061_0,,,,2,3,2,5
C(CO)(C(C(C(O)=O)=CCO)O)=O,,,5,1,1,0,1
33063_0,,,,2,3,2,5
C(C(C=CC(C(CO)=O)O)O)(O)=O,,,5,1,1,0,1
33065_0,,,,2,3,2,5
C(CO)(C(C(CO)=CC(O)=O)O)=O,,,5,1,1,0,1
33067_0,,,,2,3,2,5
C(C(C(C(C(CO)=O)O)=C)O)(O)=O,,,5,1,1,0,1
33069_0,,,,2,3,2,5
C(CO)(C(CO)O)=CC(C(O)=O)=O,,,5,1,1,0,1
33071_0,,,,2,3,2,5
C(CO)(C(CO)O)=C(C(O)=O)C=O,,,5,1,1,0,1
33073_0,,,,2,3,2,5
C(CO)(C(CO)O)=CC(O)=O,,,5,1,3,0,3
33075_0,,,,2,3,2,5
C(C(CO)O)(C(C(C(O)=O)=C)O)=O,,,5,1,1,0,1
33077_0,,,,2,3,2,5
C(C(CO)O)(C(C=CC(O)=O)O)=O,,,5,1,1,0,1
33079_0,,,,2,3,2,5
C(C(CO)(CO)O)=CC(C(O)=O)=O,,,5,1,1,0,1
33081_0,,,,2,3,2,5
C(C(CO)(CO)O)=C(C(O)=O)C=O,,,5,1,1,0,1
33083_0,,,,2,3,2,5
C(C(CO)(CO)O)=CC(O)=O,,,5,1,3,0,3
33085_0,,,,2,3,2,5
C(C(CO)(C(CO)O)O)=CC(O)=O,,,5,1,1,0,1
33087_0,,,,2,3,2,5
C(C(C)=CC(C(O)=O)=O)=O,,,5,1,2,0,2
33089_0,,,,2,3,2,5
C(C(C=C(C(O)=O)C)=O)=O,,,5,1,2,0,2
33091_0,,,,2,3,2,5
C=C(C=O)CC(C(O)=O)=O,,,5,1,2,0,2
33093_0,,,,2,3,2,5
C=C(C(O)=O)CC(C=O)=O,,,5,1,2,0,2
33095_0,,,,2,3,2,5
C(C(C(O)=O)=C(C=O)C)=O,,,5,1,2,0,2
33097_0,,,,2,3,2,5
C(C(C=O)=C(C(O)=O)C)=O,,,5,1,2,0,2
33098_0,,,,2,3,2,5
33100_0,,,,2,3,2,5
C(C(C=O)C(C(O)=O)=C)=O,,,5,1,2,0,2
33102_0,,,,2,3,2,5
C(C(C(C(C(O)=O)=O)=C)(C)O)=O,,,5,1,2,0,2
33104_0,,,,2,3,2,5
C(C(C(C(C=O)=O)=C)(C)O)(O)=O,,,5,1,3,0,3
33106_0,,,,2,3,2,5
C(C(C(CO)=C(C=O)C)=O)(O)=O,,,5,1,2,0,2
33108_0,,,,2,3,2,5
C(C(C(CO)=C(C(O)=O)C)=O)=O,,,5,1,2,0,2
33110_0,,,,2,3,2,5
C=C(C=O)C(C(C(O)=O)=O)CO,,,5,1,2,0,2
33112_0,,,,2,3,2,5
C=C(C(O)=O)C(C(C=O)=O)CO,,,5,1,2,0,2
33114_0,,,,2,3,2,5
C(C(C(C=O)=CC(O)=O)(C)O)=O,,,5,1,3,0,3
33116_0,,,,2,3,2,5
C(C(C(C(O)=O)=CC=O)(C)O)=O,,,5,1,3,0,3
33118_0,,,,2,3,2,5
C(C(C(C=O)=CC=O)(C)O)(O)=O,,,5,1,3,0,3
33120_0,,,,2,3,2,5
C(C(C(C=O)=C(C=O)C)O)(O)=O,,,5,1,2,0,2
33122_0,,,,2,3,2,5
C(C(C(C(O)=O)=C(C=O)C)O)=O,,,5,1,2,0,2
33124_0,,,,2,3,2,5
C(C(C(C=O)=C(C(O)=O)C)O)=O,,,5,1,2,0,2
33125_0,,,,2,3,2,5
33127_0,,,,2,3,2,5
C(C(C(C=O)=C)C(C=O)O)(O)=O,,,5,1,2,0,2
33129_0,,,,2,3,2,5
C(C(C(C(O)=O)=C)C(C=O)O)=O,,,5,1,2,0,2
33131_0,,,,2,3,2,5
C(C(C(CO)=O)=C(C=O)C)(O)=O,,,5,1,2,0,2
33133_0,,,,2,3,2,5
C(C(C(CO)=O)=C(C(O)=O)C)=O,,,5,1,2,0,2
33135_0,,,,2,3,2,5
C(C(C(CO)=O)C(C=O)=C)(O)=O,,,5,1,2,0,2
33137_0,,,,2,3,2,5
C(C(C(CO)=O)C(C(O)=O)=C)=O,,,5,1,2,0,2
33139_0,,,,2,3,2,5
C(CC(C(C(C=O)=C)O)=O)(O)=O,,,5,1,2,0,2
33141_0,,,,2,3,2,5
C(CC(C(C(C(O)=O)=C)O)=O)=O,,,5,1,2,0,2
33143_0,,,,2,3,2,5
C(C(C(C=C(C=O)C)=O)O)(O)=O,,,5,1,2,0,2
33145_0,,,,2,3,2,5
C(C(C(C=C(C(O)=O)C)=O)O)=O,,,5,1,2,0,2
33147_0,,,,2,3,2,5
C(C(C(CC(C=O)=C)=O)O)(O)=O,,,5,1,2,0,2
33149_0,,,,2,3,2,5
C(C(C(CC(C(O)=O)=C)=O)O)=O,,,5,1,2,0,2
33151_0,,,,2,3,2,5
C(C(C)=CC(O)=O)=O,,,5,1,2,0,2
33153_0,,,,2,3,2,5
C(C=C(C(O)=O)C)=O,,,5,1,2,0,2
33155_0,,,,2,3,2,5
C(CC(C=O)=C)(O)=O,,,5,1,2,0,2
33157_0,,,,2,3,2,5
C(CC(C(O)=O)=C)=O,,,5,1,2,0,2
33158_0,,,,2,3,2,5
33160_0,,,,2,3,2,5
C(C(C(C(O)=O)=C)O)=O,,,5,1,3,0,3
33162_0,,,,2,3,2,5
C(C(C=CC(C)=O)=O)(O)=O,,,5,1,3,0,3
33164_0,,,,2,3,2,5
C(C(C(O)=O)=CC(C)=O)=O,,,5,1,2,0,2
33166_0,,,,2,3,2,5
C(C)(C(C(C(C(O)=O)=O)=C)O)=O,,,5,1,2,0,2
33168_0,,,,2,3,2,5
C(C(C(CO)=CC(C)=O)=O)(O)=O,,,5,1,2,0,2
33170_0,,,,2,3,2,5
C(C)(C(C(C=O)=CC(O)=O)O)=O,,,5,1,3,0,3
33172_0,,,,2,3,2,5
C(C)(C(C(C(O)=O)=CC=O)O)=O,,,5,1,3,0,3
33174_0,,,,2,3,2,5
C(C(C(C=O)=CC(C)=O)O)(O)=O,,,5,1,2,0,2
33176_0,,,,2,3,2,5
C(C(C(C(O)=O)=CC(C)=O)O)=O,,,5,1,2,0,2
33178_0,,,,2,3,2,5
C(C(C(CO)=O)=CC(C)=O)(O)=O,,,5,1,2,0,2
33180_0,,,,2,3,2,5
C(C(C(C=CC(C)=O)=O)O)(O)=O,,,5,1,2,0,2
33182_0,,,,2,3,2,5
C(C=CC(C)=O)(O)=O,,,5,1,2,0,2
33184_0,,,,2,3,2,5
C(CC(C=O)=O)=CC(O)=O,,,5,1,3,0,3
33186_0,,,,2,3,2,5
C(CC(C(O)=O)=O)=CC=O,,,5,1,4,0,4
33188_0,,,,2,3,2,5
C(CC=CC(C=O)=O)(O)=O,,,5,1,2,0,2
33190_0,,,,2,3,2,5
C(CC=CC(C(O)=O)=O)=O,,,5,1,3,0,3
33192_0,,,,2,3,2,5
C(CO)=C(C(O)=O)CC(C=O)=O,,,5,1,2,0,2
33194_0,,,,2,3,2,5
C(CO)=C(C=O)CC(C(O)=O)=O,,,5,1,2,0,2
33196_0,,,,2,3,2,5
C(C(C=C(C(O)=O)CCO)=O)=O,,,5,1,2,0,2
33198_0,,,,2,3,2,5
C(C(C=C(C=O)CCO)=O)(O)=O,,,5,1,2,0,2
33200_0,,,,2,3,2,5
C(C(C=CC(CCO)=O)=O)(O)=O,,,5,1,2,0,2
33202_0,,,,2,3,2,5
C(CC(C=CC(C=O)=O)O)(O)=O,,,5,1,2,0,2
33204_0,,,,2,3,2,5
C(CC(C=CC(C(O)=O)=O)O)=O,,,5,1,2,0,2
33206_0,,,,2,3,2,5
C(C(C=CCC(C=O)=O)O)(O)=O,,,5,1,3,0,3
33208_0,,,,2,3,2,5
C(C(C=CCC(C(O)=O)=O)O)=O,,,5,1,2,0,2
33210_0,,,,2,3,2,5
C(C(CC=CC(C=O)=O)O)(O)=O,,,5,1,2,0,2
33212_0,,,,2,3,2,5
C(C(CC=CC(C(O)=O)=O)O)=O,,,5,1,2,0,2
33214_0,,,,2,3,2,5
C(CC(C(O)=O)=O)=CC(CO)=O,,,5,1,2,0,2
33216_0,,,,2,3,2,5
C(CO)(CC=CC(C(O)=O)=O)=O,,,5,1,2,0,2
33218_0,,,,2,3,2,5
C(CO)(CC(C=O)=O)=CC(O)=O,,,5,1,2,0,2
33220_0,,,,2,3,2,5
C(CO)(CC(C(O)=O)=O)=CC=O,,,5,1,2,0,2
33222_0,,,,2,3,2,5
C(CC(CO)=CC(C=O)=O)(O)=O,,,5,1,2,0,2
33224_0,,,,2,3,2,5
C(CC(CO)=CC(C(O)=O)=O)=O,,,5,1,2,0,2
33226_0,,,,2,3,2,5
C(C)(C(C=CC(C(O)=O)=O)O)=O,,,5,1,2,0,2
33228_0,,,,2,3,2,5
C(C(C(CC(C=O)=O)=C)O)(O)=O,,,5,1,2,0,2
33230_0,,,,2,3,2,5
C(C(C(CC(C(O)=O)=O)=C)O)=O,,,5,1,2,0,2
33232_0,,,,2,3,2,5
C(C(C(C)=CC(C=O)=O)O)(O)=O,,,5,1,2,0,2
33234_0,,,,2,3,2,5
C(C(C(C)=CC(C(O)=O)=O)O)=O,,,5,1,2,0,2
33236_0,,,,2,3,2,5
C=CCC(C(O)=O)=O,,,5,1,2,0,2
33238_0,,,,2,3,2,5
C(C)=CC(C(O)=O)=O,,,5,1,2,0,2
33239_0,,,,2,3,2,5
33241_0,,,,2,3,2,5
C(C(C(CO)O)O)=CC(C(O)=O)=O,,,5,1,1,0,1
33242_0,,,,2,3,2,5
33244_0,,,,2,3,2,5
C(CC=C(C=O)C(O)=O)=O,,,5,1,2,0,2
33246_0,,,,2,3,2,5
C(CC=C(C=O)C=O)(O)=O,,,5,1,2,0,2
33247_0,,,,2,3,2,5
33249_0,,,,2,3,2,5
C(C(C=O)C=CC(O)=O)=O,,,5,1,2,0,2
33251_0,,,,2,3,2,5
C(CC(C(C(C(O)=O)=O)=C)O)=O,,,5,1,2,0,2
33253_0,,,,2,3,2,5
C(CC(C(C(C=O)=O)=C)O)(O)=O,,,5,1,3,0,3
33255_0,,,,2,3,2,5
C(CC=C(C(C(O)=O)=O)CO)=O,,,5,1,2,0,2
33257_0,,,,2,3,2,5
C(CC=C(C(C=O)=O)CO)(O)=O,,,5,1,2,0,2
33259_0,,,,2,3,2,5
C(C(C(C(O)=O)=O)CO)=CC=O,,,5,1,2,0,2
33261_0,,,,2,3,2,5
C(C(C(C=O)=O)CO)=CC(O)=O,,,5,1,2,0,2
33263_0,,,,2,3,2,5
C(CC(C(C=O)=CC(O)=O)O)=O,,,5,1,3,0,3
33265_0,,,,2,3,2,5
C(CC(C(C(O)=O)=CC=O)O)=O,,,5,1,3,0,3
33267_0,,,,2,3,2,5
C(CC(C(C=O)=CC=O)O)(O)=O,,,5,1,3,0,3
33269_0,,,,2,3,2,5
C(C(C(C=O)=CCC=O)O)(O)=O,,,5,1,2,0,2
33271_0,,,,2,3,2,5
C(CC=C(C(O)=O)C(C=O)O)=O,,,5,1,2,0,2
33273_0,,,,2,3,2,5
C(CC=C(C=O)C(C=O)O)(O)=O,,,5,1,2,0,2
33274_0,,,,2,3,2,5
33276_0,,,,2,3,2,5
C(C(C=CC=O)C(C=O)O)(O)=O,,,5,1,2,0,2
33278_0,,,,2,3,2,5
C(C(C=CC(O)=O)C(C=O)O)=O,,,5,1,2,0,2
33280_0,,,,2,3,2,5
C(CC=C(C(O)=O)C(CO)=O)=O,,,5,1,2,0,2
33282_0,,,,2,3,2,5
C(CC=C(C=O)C(CO)=O)(O)=O,,,5,1,2,0,2
33283_0,,,,2,3,2,5
33285_0,,,,2,3,2,5
C(C(C(CO)=O)C=CC(O)=O)=O,,,5,1,2,0,2
33286_0,,,,2,3,2,5
33288_0,,,,2,3,2,5
C(CC(C(C=CC(O)=O)O)=O)=O,,,5,1,2,0,2
33289_0,,,,2,3,2,5
33291_0,,,,2,3,2,5
C(CC=CC(C(C=O)O)=O)(O)=O,,,5,1,2,0,2
33292_0,,,,2,3,2,5
33294_0,,,,2,3,2,5
C(C(C(CC=CC(O)=O)=O)O)=O,,,5,1,2,0,2
33296_0,,,,2,3,2,5
C(CC=CC(O)=O)=O,,,5,1,2,0,2
33298_0,,,,2,3,2,5
C(CC=CC=O)(O)=O,,,5,1,2,0,2
33299_0,,,,2,3,2,5
33300_0,,,,2,3,2,5
33302_0,,,,2,3,2,5
C(C(C=O)C(C(O)=O)=CCO)=O,,,5,1,2,0,2
33303_0,,,,2,3,2,5
33305_0,,,,2,3,2,5
C(C(C=O)=C(C(O)=O)CCO)=O,,,5,1,2,0,2
33307_0,,,,2,3,2,5
C(C(C=O)=C(C=O)CCO)(O)=O,,,5,1,2,0,2
33309_0,,,,2,3,2,5
C(C(C=O)=CC(CCO)=O)(O)=O,,,5,1,2,0,2
33311_0,,,,2,3,2,5
C(CC(C=C(C=O)C=O)O)(O)=O,,,5,1,2,0,2
33313_0,,,,2,3,2,5
C(CC(C=C(C(O)=O)C=O)O)=O,,,5,1,2,0,2
33315_0,,,,2,3,2,5
C(C(C=O)C=CC(C(O)=O)O)=O,,,5,1,2,0,2
33316_0,,,,2,3,2,5
33318_0,,,,2,3,2,5
C(C(CC=C(C=O)C=O)O)(O)=O,,,5,1,2,0,2
33320_0,,,,2,3,2,5
C(C(CC=C(C(O)=O)C=O)O)=O,,,5,1,2,0,2
33321_0,,,,2,3,2,5
33323_0,,,,2,3,2,5
C(CO)(CC=C(C(O)=O)C=O)=O,,,5,1,2,0,2
33325_0,,,,2,3,2,5
C(C(C=O)C(CO)=CC(O)=O)=O,,,5,1,2,0,2
33326_0,,,,2,3,2,5
33328_0,,,,2,3,2,5
C(CC(CO)=C(C=O)C=O)(O)=O,,,5,1,2,0,2
33330_0,,,,2,3,2,5
C(CC(CO)=C(C(O)=O)C=O)=O,,,5,1,2,0,2
33332_0,,,,2,3,2,5
C(C)(C(C=C(C(O)=O)C=O)O)=O,,,5,1,2,0,2
33334_0,,,,2,3,2,5
C(C(C=O)C(C(C(O)=O)O)=C)=O,,,5,1,2,0,2
33335_0,,,,2,3,2,5
33337_0,,,,2,3,2,5
C(C(C(C)=C(C=O)C=O)O)(O)=O,,,5,1,2,0,2
33339_0,,,,2,3,2,5
C(C(C(C)=C(C(O)=O)C=O)O)=O,,,5,1,2,0,2
33340_0,,,,2,3,2,5
33342_0,,,,2,3,2,5
C(C)=C(C=O)C(O)=O,,,5,1,2,0,2
33344_0,,,,2,3,2,5
C(C(CO)O)=C(C(O)=O)C=O,,,5,1,2,0,2
33346_0,,,,2,3,2,5
C(C(C(CO)O)O)=C(C(O)=O)C=O,,,5,1,1,0,1
33348_0,,,,2,3,2,5
C=C(C=O)C(O)=O,,,5,1,3,0,3
33350_0,,,,2,3,2,5
C(CO)=C(C(O)=O)C=O,,,5,1,2,0,2
33352_0,,,,2,3,2,5
C(C=C(C=O)CCO)(O)=O,,,5,1,2,0,2
33354_0,,,,2,3,2,5
C(C(CCO)=CC=O)(O)=O,,,5,1,2,0,2
33356_0,,,,2,3,2,5
C(CC(C=O)=CCO)(O)=O,,,5,1,2,0,2
33358_0,,,,2,3,2,5
C(CC(C(O)=O)=CCO)=O,,,5,1,2,0,2
33359_0,,,,2,3,2,5
33361_0,,,,2,3,2,5
C(C(C(C(O)=O)=CCO)O)=O,,,5,1,3,0,3
33363_0,,,,2,3,2,5
C(C=CC(CCO)=O)(O)=O,,,5,1,2,0,2
33365_0,,,,2,3,2,5
C=CC(C(C(O)=O)=O)CO,,,5,1,2,0,2
33367_0,,,,2,3,2,5
C(C)=C(C(C(O)=O)=O)CO,,,5,1,2,0,2
33369_0,,,,2,3,2,5
C=C(C(C(O)=O)=O)C(C)O,,,5,1,2,0,2
33371_0,,,,2,3,2,5
C(C(CO)O)=C(C(C(O)=O)=O)CO,,,5,1,1,0,1
33373_0,,,,2,3,2,5
C=C(C(C(O)=O)=O)C(C(CO)O)O,,,5,1,1,0,1
33375_0,,,,2,3,2,5
C=C(C(C(O)=O)=O)CO,,,5,1,2,0,2
33377_0,,,,2,3,2,5
C(CO)=C(C(C(O)=O)=O)CO,,,5,1,2,0,2
33379_0,,,,2,3,2,5
C=C(C(C(O)=O)=O)C(CO)O,,,5,1,2,0,2
33381_0,,,,2,3,2,5
C(C(CC=CC(O)=O)O)=O,,,5,1,2,0,2
33382_0,,,,2,3,2,5
33384_0,,,,2,3,2,5
C(CC=CC(C=O)O)(O)=O,,,5,1,2,0,2
33385_0,,,,2,3,2,5
33386_0,,,,2,3,2,5
33387_0,,,,2,3,2,5
33389_0,,,,2,3,2,5
C(C(C=C)C(C=O)O)(O)=O,,,5,1,2,0,2
33391_0,,,,2,3,2,5
C(C(C(C=O)=CC)O)(O)=O,,,5,1,2,0,2
33393_0,,,,2,3,2,5
C(C(C(C(O)=O)=CC)O)=O,,,5,1,2,0,2
33395_0,,,,2,3,2,5
C(C=C(C=O)C(C)O)(O)=O,,,5,1,3,0,3
33397_0,,,,2,3,2,5
C(C(C(C)O)=CC=O)(O)=O,,,5,1,3,0,3
33399_0,,,,2,3,2,5
C(C(C(C=O)=CC(CO)O)O)(O)=O,,,5,1,1,0,1
33401_0,,,,2,3,2,5
C(C(C(C(O)=O)=CC(CO)O)O)=O,,,5,1,1,0,1
33403_0,,,,2,3,2,5
C(C=C(C=O)C(C(CO)O)O)(O)=O,,,5,1,1,0,1
33405_0,,,,2,3,2,5
C(C(C(C(CO)O)O)=CC=O)(O)=O,,,5,1,1,0,1
33407_0,,,,2,3,2,5
C(C(CO)=CC(O)=O)=O,,,5,1,3,0,3
33409_0,,,,2,3,2,5
C(C(CO)=CC=O)(O)=O,,,5,1,3,0,3
33411_0,,,,2,3,2,5
C(C=C(C=O)C(CO)O)(O)=O,,,5,1,3,0,3
33413_0,,,,2,3,2,5
C(C(C(CO)O)=CC=O)(O)=O,,,5,1,3,0,3
33415_0,,,,2,3,2,5
C(CO)(CC=CC(O)=O)=O,,,5,1,2,0,2
33417_0,,,,2,3,2,5
C(CC=CC(CO)=O)(O)=O,,,5,1,2,0,2
33418_0,,,,2,3,2,5
33420_0,,,,2,3,2,5
C(CC(CO)=CC(O)=O)=O,,,5,1,2,0,2
33422_0,,,,2,3,2,5
C(CC(CO)=CC=O)(O)=O,,,5,1,2,0,2
33423_0,,,,2,3,2,5
33425_0,,,,2,3,2,5
C(C(C(CO)=CC(O)=O)O)=O,,,5,1,3,0,3
33427_0,,,,2,3,2,5
C(C(C(CO)=O)C=C)(O)=O,,,5,1,3,0,3
33429_0,,,,2,3,2,5
C(C)=C(C(O)=O)C(CO)=O,,,5,1,2,0,2
33431_0,,,,2,3,2,5
C(C(CO)O)=C(C(O)=O)C(CO)=O,,,5,1,1,0,1
33433_0,,,,2,3,2,5
C=C(C(O)=O)C(CO)=O,,,5,1,2,0,2
33435_0,,,,2,3,2,5
C(CO)=C(C(O)=O)C(CO)=O,,,5,1,2,0,2
33437_0,,,,2,3,2,5
C(CC(C(C=C)O)=O)(O)=O,,,5,1,2,0,2
33439_0,,,,2,3,2,5
C(C)(C(C=CC(O)=O)O)=O,,,5,1,3,0,3
33441_0,,,,2,3,2,5
C(C(C(C)=CC(O)=O)O)=O,,,5,1,2,0,2
33443_0,,,,2,3,2,5
C(C(C(C)=CC=O)O)(O)=O,,,5,1,2,0,2
33445_0,,,,2,3,2,5
C(CC(C(C=O)O)=C)(O)=O,,,5,1,2,0,2
33447_0,,,,2,3,2,5
C(C(C(CC=O)=C)O)(O)=O,,,5,1,2,0,2
33448_0,,,,2,3,2,5
33450_0,,,,2,3,2,5
C(C(C(CC=C)=O)O)(O)=O,,,5,1,2,0,2
33452_0,,,,2,3,2,5
C(C(C(C=CC)=O)O)(O)=O,,,5,1,2,0,2
33454_0,,,,2,3,2,5
C(C(C(C=CC(CO)O)=O)O)(O)=O,,,5,1,1,0,1
33455_0,,,,2,3,2,5
33456_0,,,,2,3,2,5
33458_0,,,,2,3,2,5
C(C)=CC(O)=O,,,5,1,2,0,2
33460_0,,,,2,3,2,5
C(CC=C)(O)=O,,,5,1,2,0,2
33461_0,,,,2,3,2,5
33463_0,,,,2,3,2,5
C(C(CO)O)=CC(O)=O,,,5,1,3,0,3
33465_0,,,,2,3,2,5
C(C(C(CO)O)O)=CC(O)=O,,,5,1,3,0,3
33466_0,,,,2,3,2,5
33468_0,,,,2,3,2,5
C(C(C=C)(C(C(CO)O)O)O)(O)=O,,,5,1,2,0,2
33470_0,,,,2,3,2,5
C(CO)(C(C(C(O)=O)=C)(CO)O)=O,,,5,1,1,0,1
33472_0,,,,2,3,2,5
C(CO)(C(C=CC(O)=O)(CO)O)=O,,,5,1,1,0,1
33474_0,,,,2,3,2,5
C(C(C(C(O)=O)=C)(CO)O)(O)=O,,,5,1,2,0,2
33476_0,,,,2,3,2,5
C(C(C=CC(O)=O)(CO)O)(O)=O,,,5,1,2,0,2
33478_0,,,,2,3,2,5
C(C(C(C)=O)(C(C=O)=C)O)(O)=O,,,5,1,2,0,2
33480_0,,,,2,3,2,5
C(C(C(C)=O)(C(C(O)=O)=C)O)=O,,,5,1,2,0,2
33481_0,,,,2,3,2,5
33483_0,,,,2,3,2,5
C(C(C(C(O)=O)=C)(CO)O)=O,,,5,1,2,0,2
33485_0,,,,2,3,2,5
C(C(C(C=O)=C)(C(CO)O)O)(O)=O,,,5,1,2,0,2
33487_0,,,,2,3,2,5
C(C(C(C(O)=O)=C)(C(CO)O)O)=O,,,5,1,1,0,1
33489_0,,,,2,3,2,5
C(C(C(C)=O)(C=CC=O)O)(O)=O,,,5,1,3,0,3
33491_0,,,,2,3,2,5
C(C(C(C)=O)(C=CC(O)=O)O)=O,,,5,1,2,0,2
33492_0,,,,2,3,2,5
33494_0,,,,2,3,2,5
C(C(C=CC(O)=O)(CO)O)=O,,,5,1,2,0,2
33496_0,,,,2,3,2,5
C(C(C=CC=O)(C(CO)O)O)(O)=O,,,5,1,2,0,2
33498_0,,,,2,3,2,5
C(C(C=CC(O)=O)(C(CO)O)O)=O,,,5,1,1,0,1
33500_0,,,,2,3,2,5
C(C(C(C=O)=CCO)(CO)O)(O)=O,,,5,1,2,0,2
33502_0,,,,2,3,2,5
C(C(C(C(O)=O)=CCO)(CO)O)=O,,,5,1,1,0,1
33504_0,,,,2,3,2,5
C(C(C=CC(C=O)O)(CO)O)(O)=O,,,5,1,2,0,2
33506_0,,,,2,3,2,5
C(C(C=CC(C(O)=O)O)(CO)O)=O,,,5,1,2,0,2
33508_0,,,,2,3,2,5
C(C(C=CC(CO)=O)(CO)O)(O)=O,,,5,1,2,0,2
33510_0,,,,2,3,2,5
C(C(C(CO)=CC=O)(CO)O)(O)=O,,,5,1,2,0,2
33512_0,,,,2,3,2,5
C(C(C(CO)=CC(O)=O)(CO)O)=O,,,5,1,1,0,1
33514_0,,,,2,3,2,5
C(C(C(C)=O)(C=C)O)(O)=O,,,5,1,3,0,3
33516_0,,,,2,3,2,5
C(C(C(C(C=O)O)=C)(CO)O)(O)=O,,,5,1,2,0,2
33518_0,,,,2,3,2,5
C(C(C(C(C(O)=O)O)=C)(CO)O)=O,,,5,1,2,0,2
33519_0,,,,2,3,2,5
33520_0,,,,2,3,2,5
33522_0,,,,2,3,2,5
C(C(C(C=O)=C)(CC=O)O)(O)=O,,,5,1,2,0,2
33524_0,,,,2,3,2,5
C(C(C(C=O)=C)(CC(O)=O)O)=O,,,5,1,2,0,2
33526_0,,,,2,3,2,5
C(C(C(C(O)=O)=C)(CC=O)O)=O,,,5,1,2,0,2
33528_0,,,,2,3,2,5
C(C(C(C(O)=O)=C)O)(O)=O,,,5,1,2,0,2
33530_0,,,,2,3,2,5
C(C(C=CC=O)(CC=O)O)(O)=O,,,5,1,2,0,2
33532_0,,,,2,3,2,5
C(C(C=CC=O)(CC(O)=O)O)=O,,,5,1,2,0,2
33534_0,,,,2,3,2,5
C(C(C=CC(O)=O)(CC=O)O)=O,,,5,1,2,0,2
33536_0,,,,2,3,2,5
C(C(C=CC(O)=O)O)(O)=O,,,5,1,2,0,2
33538_0,,,,2,3,2,5
C(C(C(C(O)=O)=CCO)O)(O)=O,,,5,1,2,0,2
33540_0,,,,2,3,2,5
C(C(C=CC(C(O)=O)O)O)(O)=O,,,5,1,2,0,2
33542_0,,,,2,3,2,5
C(C(C(CO)=CC(O)=O)O)(O)=O,,,5,1,2,0,2
33544_0,,,,2,3,2,5
C(C(C(C(C(O)=O)O)=C)O)(O)=O,,,5,1,2,0,2
33545_0,,,,2,3,2,5
33546_0,,,,2,3,2,5
33548_0,,,,2,3,2,5
C(C(CO)=CC(CO)=O)(O)=O,,,5,1,2,0,2
33550_0,,,,2,3,2,5
C(C(C(C=C)=O)(CO)O)(O)=O,,,5,1,5,0,5
33552_0,,,,2,3,2,5
C=C(C(O)=O)C(C(CO)O)=O,,,5,1,2,0,2
33554_0,,,,2,3,2,5
C(C1CC(C(O)O1)=O)(O)=O,,,5,1,2,0,2
33556_0,,,,2,3,2,5
C1(C(OC(C(O)=O)C1CO)O)=O,,,5,1,2,0,2
33558_0,,,,2,3,2,5
C(C(C1COC(C1O)O)=O)(O)=O,,,5,1,2,0,2
33560_0,,,,2,3,2,5
C(C1C(C(OC1C(O)=O)O)O)=O,,,5,1,2,0,2
33562_0,,,,2,3,2,5
C(C1C(C(OC1C=O)O)O)(O)=O,,,5,1,2,0,2
33564_0,,,,2,3,2,5
C(C1(CC(CO)(CO1)O)O)(O)=O,,,5,1,2,0,2
33566_0,,,,2,3,2,5
C(C1C(O)OCC1(CO)O)(O)=O,,,5,1,2,0,2
33568_0,,,,2,3,2,5
C(C1(C)CC(C(O1)O)=O)(O)=O,,,5,1,2,0,2
33570_0,,,,2,3,2,5
C(C1(C)C(C(C(O1)O)=O)CO)(O)=O,,,5,1,2,0,2
33572_0,,,,2,3,2,5
C(C(C1COC(C1(C)O)O)=O)(O)=O,,,5,1,2,0,2
33574_0,,,,2,3,2,5
C(C1C(C)(C(OC1C(O)=O)O)O)=O,,,5,1,2,0,2
33576_0,,,,2,3,2,5
C(C1C(C)(C(OC1C=O)O)O)(O)=O,,,5,1,2,0,2
33578_0,,,,2,3,2,5
C(C1C(C(OC1(C=O)C)O)O)(O)=O,,,5,1,2,0,2
33580_0,,,,2,3,2,5
C(C1C(C(OC1(C(O)=O)C)O)O)=O,,,5,1,2,0,2
33582_0,,,,2,3,2,5
C(C(C1COC(C)(C1O)O)=O)(O)=O,,,5,1,2,0,2
33584_0,,,,2,3,2,5
C(C1C(C(C)(OC1C(O)=O)O)O)=O,,,5,1,2,0,2
33586_0,,,,2,3,2,5
C(C1C(C(C)(OC1C=O)O)O)(O)=O,,,5,1,2,0,2
33588_0,,,,2,3,2,5
C(C1C(C(OC1C(C)=O)O)O)(O)=O,,,5,1,2,0,2
33590_0,,,,2,3,2,5
C(CC1CC(C(O)O1)=O)(O)=O,,,5,1,2,0,2
33592_0,,,,2,3,2,5
C(C1(CCO)CC(C(O1)O)=O)(O)=O,,,5,1,2,0,2
33594_0,,,,2,3,2,5
C(CC1C(CC(C=O)(O)O1)O)(O)=O,,,5,1,2,0,2
33596_0,,,,2,3,2,5
C(CC1C(CC(C(O)=O)(O)O1)O)=O,,,5,1,2,0,2
33598_0,,,,2,3,2,5
C(C(CC1C(CC(O)O1)O)=O)(O)=O,,,5,1,2,0,2
33600_0,,,,2,3,2,5
C(CC(C1CC(C(O)O1)=O)O)(O)=O,,,5,1,2,0,2
33602_0,,,,2,3,2,5
C(C(CC1CC(C(O)O1)O)=O)(O)=O,,,5,1,2,0,2
33604_0,,,,2,3,2,5
C(C(CC1CC(C(O)O1)=O)O)(O)=O,,,5,1,2,0,2
33606_0,,,,2,3,2,5
C(CC1(COC(C=O)(C1)O)O)(O)=O,,,5,1,2,0,2
33608_0,,,,2,3,2,5
C(CC1(COC(C(O)=O)(C1)O)O)=O,,,5,1,2,0,2
33610_0,,,,2,3,2,5
C(CC1(CO)CC(C(O)O1)=O)(O)=O,,,5,1,2,0,2
33612_0,,,,2,3,2,5
C(C1(CC(C(C(C)=O)O1)O)O)(O)=O,,,5,1,2,0,2
33614_0,,,,2,3,2,5
C(C1C(C)(CC(C=O)(O1)O)O)(O)=O,,,5,1,2,0,2
33616_0,,,,2,3,2,5
C(C1C(C)(CC(C(O)=O)(O1)O)O)=O,,,5,1,2,0,2
33618_0,,,,2,3,2,5
C(C(C1(C)CC(C(O)O1)=O)O)(O)=O,,,5,1,2,0,2
33619_0,,,,2,3,2,5
33620_0,,,,2,3,2,5
33622_0,,,,2,3,2,5
C(CC1C(C(C(O)O1)=O)CO)(O)=O,,,5,1,2,0,2
33624_0,,,,2,3,2,5
C(C1C(CC=O)OC(C1O)O)(O)=O,,,5,1,2,0,2
33626_0,,,,2,3,2,5
C(C1C(CC(O)=O)OC(C1O)O)=O,,,5,1,2,0,2
33627_0,,,,2,3,2,5
33628_0,,,,2,3,2,5
33630_0,,,,2,3,2,5
C(C1C(O)OC(C1O)CC(O)=O)=O,,,5,1,2,0,2
33632_0,,,,2,3,2,5
C(C1C(O)OC(C1O)CC=O)(O)=O,,,5,1,2,0,2
33633_0,,,,2,3,2,5
33634_0,,,,2,3,2,5
33636_0,,,,2,3,2,5
C(C1C(O)OCC1(CC(O)=O)O)=O,,,5,1,2,0,2
33638_0,,,,2,3,2,5
C(C1C(O)OCC1(CC=O)O)(O)=O,,,5,1,2,0,2
33640_0,,,,2,3,2,5
C(C1C(C(C(C)=O)OC1O)O)(O)=O,,,5,1,2,0,2
33642_0,,,,2,3,2,5
C(C1C(OC(C(O)=O)C1(C)O)O)=O,,,5,1,2,0,2
33644_0,,,,2,3,2,5
C(C1C(OC(C=O)C1(C)O)O)(O)=O,,,5,1,2,0,2
33646_0,,,,2,3,2,5
C(C1(C(CO)C(CO1)O)O)(O)=O,,,5,1,2,0,2
33648_0,,,,2,3,2,5
C(CC1C(CC(O)O1)O)(O)=O,,,5,1,2,0,2
33649_0,,,,2,3,2,5
33651_0,,,,2,3,2,5
C(CC1CC(C(O)O1)O)(O)=O,,,5,1,2,0,2
33652_0,,,,2,3,2,5
33654_0,,,,2,3,2,5
C(C1C(C)OC(C1O)O)(O)=O,,,5,1,2,0,2
33656_0,,,,2,3,2,5
C(C1COC(C1O)O)(O)=O,,,5,1,2,0,2
33658_0,,,,2,3,2,5
C(C(C1C(O)OCC1O)O)(O)=O,,,5,1,2,0,2
33660_0,,,,2,3,2,5
C(C1C(CO)OC(C1O)O)(O)=O,,,5,1,2,0,2
33661_0,,,,2,3,2,5
33662_0,,,,2,3,2,5
33664_0,,,,2,3,2,5
C(CC1(COC(C1O)O)O)(O)=O,,,5,1,2,0,2
33666_0,,,,2,3,2,5
C(C1C(CO)(O)OCC1O)(O)=O,,,5,1,2,0,2
33667_0,,,,2,3,2,5
33668_0,,,,2,3,2,5
33670_0,,,,2,3,2,5
C(C1C(C)(CC(O1)O)O)(O)=O,,,5,1,2,0,2
33671_0,,,,2,3,2,5
33672_0,,,,2,3,2,5
33674_0,,,,2,3,2,5
C(C1(C(C(CO1)O)O)O)(O)=O,,,5,1,2,0,2
33676_0,,,,2,3,2,5
C(C1(C(C(C(CO)O1)O)O)O)(O)=O,,,5,1,2,0,2
33677_0,,,,2,3,2,5
33678_0,,,,2,3,2,5
33680_0,,,,2,3,2,5
C(C(C1(C(O)OCC1O)O)O)(O)=O,,,5,1,4,0,4
33681_0,,,,2,3,2,5
33682_0,,,,2,3,2,5
33684_0,,,,2,3,2,5
C(C1(C(C)=O)C(CC(O1)O)O)(O)=O,,,5,1,4,0,4
33685_0,,,,2,3,2,5
33687_0,,,,2,3,2,5
C(C1(C(C)(O)OCC1O)O)(O)=O,,,5,1,2,0,2
33689_0,,,,2,3,2,5
C(C1(CC(OC1C=O)O)O)(O)=O,,,5,1,2,0,2
33691_0,,,,2,3,2,5
C(C1(CC(OC1C(O)=O)O)O)=O,,,5,1,2,0,2
33693_0,,,,2,3,2,5
C(C1(CC(OC1(C=O)C)O)O)(O)=O,,,5,1,2,0,2
33695_0,,,,2,3,2,5
C(C1(CC(OC1(C(O)=O)C)O)O)=O,,,5,1,2,0,2
33697_0,,,,2,3,2,5
C(C1(CC(OC1C(C)=O)O)O)(O)=O,,,5,1,2,0,2
33699_0,,,,2,3,2,5
C(C1(C(CC(O1)O)O)CC=O)(O)=O,,,5,1,2,0,2
33701_0,,,,2,3,2,5
C(C1(C(CC(O1)O)O)CC(O)=O)=O,,,5,1,2,0,2
33703_0,,,,2,3,2,5
C(C1(C(CC=O)OC(C1)O)O)(O)=O,,,5,1,2,0,2
33705_0,,,,2,3,2,5
C(C1(C(CC(O)=O)OC(C1)O)O)=O,,,5,1,2,0,2
33707_0,,,,2,3,2,5
C(C1(C(C)OC(C1)O)O)(O)=O,,,5,1,2,0,2
33709_0,,,,2,3,2,5
C(C1(COC(C1)O)O)(O)=O,,,5,1,2,0,2
33711_0,,,,2,3,2,5
C(C1(C(CO)OC(C1)O)O)(O)=O,,,5,1,2,0,2
33713_0,,,,2,3,2,5
C(C1(COC(CO)(C1)O)O)(O)=O,,,5,1,2,0,2
33714_0,,,,2,3,2,5
33716_0,,,,2,3,2,5
C1(C(C(C(O)=O)OC(C1)O)O)=O,,,5,1,2,0,2
33717_0,,,,2,3,2,5
33719_0,,,,2,3,2,5
C1(CC(C(O)=O)OC(C1O)O)=O,,,5,1,2,0,2
33721_0,,,,2,3,2,5
C(C1C(COC(C1(C)O)O)=O)(O)=O,,,5,1,2,0,2
33723_0,,,,2,3,2,5
C(C1(C)C(C(CC(O1)O)=O)O)(O)=O,,,5,1,2,0,2
33725_0,,,,2,3,2,5
C(C1C(CC(C)(C(O1)O)O)=O)(O)=O,,,5,1,2,0,2
33727_0,,,,2,3,2,5
C(C1(C)CC(C(C(O1)O)O)=O)(O)=O,,,5,1,2,0,2
33729_0,,,,2,3,2,5
C(C1C(COC(C)(C1O)O)=O)(O)=O,,,5,1,2,0,2
33731_0,,,,2,3,2,5
C(C1C(CC(C(C)(O1)O)O)=O)(O)=O,,,5,1,2,0,2
33733_0,,,,2,3,2,5
C(C1(CC(C=O)(O)OCC1)O)(O)=O,,,5,1,2,0,2
33735_0,,,,2,3,2,5
C(C1(CC(C(O)=O)(O)OCC1)O)=O,,,5,1,2,0,2
33737_0,,,,2,3,2,5
C(CC1C(CC(C(O)O1)=O)O)(O)=O,,,5,1,2,0,2
33739_0,,,,2,3,2,5
C(C1CC(CC(C=O)(O1)O)O)(O)=O,,,5,1,2,0,2
33741_0,,,,2,3,2,5
C(C1CC(CC(C(O)=O)(O1)O)O)=O,,,5,1,2,0,2
33743_0,,,,2,3,2,5
C(CC1(COC(C(C1)=O)O)O)(O)=O,,,5,1,2,0,2
33745_0,,,,2,3,2,5
C(C1C(C)(CC(C(O1)O)=O)O)(O)=O,,,5,1,2,0,2
33746_0,,,,2,3,2,5
33748_0,,,,2,3,2,5
C(C(C1COC(CC1O)O)=O)(O)=O,,,5,1,2,0,2
33750_0,,,,2,3,2,5
C(C1C(CC(OC1C(O)=O)O)O)=O,,,5,1,2,0,2
33752_0,,,,2,3,2,5
C(C1C(CC(OC1C=O)O)O)(O)=O,,,5,1,2,0,2
33754_0,,,,2,3,2,5
C(CC1C(C(CC(O)O1)=O)O)(O)=O,,,5,1,2,0,2
33756_0,,,,2,3,2,5
C(CC1CC(C(C(O)O1)O)=O)(O)=O,,,5,1,2,0,2
33758_0,,,,2,3,2,5
C(C1C(O)OCCC1(C(O)=O)O)=O,,,5,1,2,0,2
33760_0,,,,2,3,2,5
C(C1C(O)OCCC1(C=O)O)(O)=O,,,5,1,2,0,2
33762_0,,,,2,3,2,5
C(C1C(OC(C(O)=O)CC1O)O)=O,,,5,1,2,0,2
33764_0,,,,2,3,2,5
C(C1C(OC(C=O)CC1O)O)(O)=O,,,5,1,2,0,2
33766_0,,,,2,3,2,5
C(C1(CC(O)OCC1)O)(O)=O,,,5,1,2,0,2
33768_0,,,,2,3,2,5
C(C1(C(C(O)OCC1)O)O)(O)=O,,,5,1,2,0,2
33769_0,,,,2,3,2,5
33771_0,,,,2,3,2,5
C(C1CC(CC(O1)O)O)(O)=O,,,5,1,2,0,2
33772_0,,,,2,3,2,5
33774_0,,,,2,3,2,5
C(C1CC(C(C(O1)O)O)O)(O)=O,,,5,1,2,0,2
33776_0,,,,2,3,2,5
C(C1C(C(O)OCC1O)O)(O)=O,,,5,1,2,0,2
33778_0,,,,2,3,2,5
C(C1(C(C(C(CO1)O)O)O)O)(O)=O,,,5,1,2,0,2
33779_0,,,,2,3,2,5
33780_0,,,,2,3,2,5
33782_0,,,,2,3,2,5
C(C1(C(COC(C1)O)O)O)(O)=O,,,5,1,2,0,2
33784_0,,,,2,3,2,5
C(C1(CCOC(C(C1)=O)O)O)(O)=O,,,5,1,2,0,2
33786_0,,,,2,3,2,5
C1(C(CC(C(O)=O)(O)OCC1)O)=O,,,5,1,2,0,2
33788_0,,,,2,3,2,5
C(C1CC(CC(C(O1)O)=O)O)(O)=O,,,5,1,2,0,2
33790_0,,,,2,3,2,5
C(C1(CC(CC(CO1)=O)O)O)(O)=O,,,5,1,2,0,2
33791_0,,,,2,3,2,5
33792_0,,,,2,3,2,5
33794_0,,,,2,3,2,5
C(C1C(O)OCCC(C1O)=O)(O)=O,,,5,1,2,0,2
33796_0,,,,2,3,2,5
C(C1C(CC(COC1O)=O)O)(O)=O,,,5,1,2,0,2
33798_0,,,,2,3,2,5
C(CC1(COC(C1O)=O)O)(O)=O,,,5,1,2,0,2
33800_0,,,,2,3,2,5
C1(C(C(C)(C(C(O)=O)O1)O)O)=O,,,5,1,2,0,2
33802_0,,,,2,3,2,5
C(C1(CCOC(C1O)=O)O)(O)=O,,,5,1,2,0,2
33804_0,,,,2,3,2,5
C1(C(C(CC(C(O)=O)O1)O)O)=O,,,5,1,2,0,2
33806_0,,,,2,3,2,5
C(C(CCC(C(O)=O)=O)C(C)O)=O,,,5,1,2,0,2
33808_0,,,,2,3,2,5
C(C(CCC(C=O)=O)C(C)O)(O)=O,,,5,1,2,0,2
33810_0,,,,2,3,2,5
C(CC(C(O)=O)C(C=O)C(C)O)=O,,,5,1,2,0,2
33811_0,,,,2,3,2,5
33813_0,,,,2,3,2,5
C(C(C(C)O)C(C=O)CC=O)(O)=O,,,5,1,2,0,2
33815_0,,,,2,3,2,5
C(CC(C)(CCC(C(O)=O)=O)O)=O,,,5,1,2,0,2
33817_0,,,,2,3,2,5
C(CC(C)(CCC(C=O)=O)O)(O)=O,,,5,1,2,0,2
33819_0,,,,2,3,2,5
C(C(C(C)(CC=O)O)CC=O)(O)=O,,,5,1,2,0,2
33821_0,,,,2,3,2,5
C(CC(C)(C(C=O)CC(O)=O)O)=O,,,5,1,2,0,2
33822_0,,,,2,3,2,5
33824_0,,,,2,3,2,5
C(CC(CCCC(C(O)=O)=O)O)=O,,,5,1,2,0,2
33826_0,,,,2,3,2,5
C(CC(CCCC(C=O)=O)O)(O)=O,,,5,1,2,0,2
33828_0,,,,2,3,2,5
C(C(CC(CC=O)O)CC=O)(O)=O,,,5,1,2,0,2
33829_0,,,,2,3,2,5
33831_0,,,,2,3,2,5
C(CC(CC(C=O)CC=O)O)(O)=O,,,5,1,3,0,3
33832_0,,,,2,3,2,5
33834_0,,,,2,3,2,5
C(CC(CCC(C=O)=O)O)(O)=O,,,5,1,2,0,2
33836_0,,,,2,3,2,5
C(C(C(CC=O)O)CC=O)(O)=O,,,5,1,2,0,2
33838_0,,,,2,3,2,5
C(CC(C(C=O)CC(O)=O)O)=O,,,5,1,2,0,2
33839_0,,,,2,3,2,5
33841_0,,,,2,3,2,5
C(C(CCC(C(O)=O)=O)CO)=O,,,5,1,2,0,2
33842_0,,,,2,3,2,5
33844_0,,,,2,3,2,5
C(CC(C(O)=O)C(C=O)CO)=O,,,5,1,2,0,2
33845_0,,,,2,3,2,5
33846_0,,,,2,3,2,5
33848_0,,,,2,3,2,5
C(C(C)(CCC(C(O)=O)=O)O)(O)=O,,,5,1,2,0,2
33850_0,,,,2,3,2,5
C(C(C)(C(C(O)=O)CC=O)O)(O)=O,,,5,1,2,0,2
33852_0,,,,2,3,2,5
C(CC(C=O)C(C(O)=O)(C)O)(O)=O,,,5,1,2,0,2
33853_0,,,,2,3,2,5
33855_0,,,,2,3,2,5
C(C(CC(C(O)=O)CC=O)O)(O)=O,,,5,1,2,0,2
33857_0,,,,2,3,2,5
C(C(CC(C=O)CC(O)=O)O)(O)=O,,,5,1,2,0,2
33859_0,,,,2,3,2,5
C(C(O)=O)(CCC(C(C=O)=O)O)=O,,,5,1,2,0,2
33861_0,,,,2,3,2,5
C(C=O)(CCC(C(C(O)=O)=O)O)=O,,,5,1,2,0,2
33863_0,,,,2,3,2,5
C(C(CC=O)C(C(C=O)=O)O)(O)=O,,,5,1,2,0,2
33865_0,,,,2,3,2,5
C(CC(C=O)C(C(C=O)=O)O)(O)=O,,,5,1,2,0,2
33867_0,,,,2,3,2,5
C(CC(C=O)C(C(C(O)=O)=O)O)=O,,,5,1,2,0,2
33869_0,,,,2,3,2,5
C(C)(C(CCC(C(O)=O)=O)O)=O,,,5,1,3,0,3
33871_0,,,,2,3,2,5
C(C(CC=O)C(C(C)=O)O)(O)=O,,,5,1,2,0,2
33873_0,,,,2,3,2,5
C(CC(C=O)C(C(C)=O)O)(O)=O,,,5,1,3,0,3
33874_0,,,,2,3,2,5
33876_0,,,,2,3,2,5
C(C(CC=O)CC(CO)=O)(O)=O,,,5,1,3,0,3
33878_0,,,,2,3,2,5
C(CC(C=O)CC(CO)=O)(O)=O,,,5,1,4,0,4
33880_0,,,,2,3,2,5
C(C(CCC(C)O)=O)(O)=O,,,5,1,3,0,3
33882_0,,,,2,3,2,5
C(C(C(C)O)CC=O)(O)=O,,,5,1,2,0,2
33884_0,,,,2,3,2,5
C(C(C(C)O)CC(O)=O)=O,,,5,1,2,0,2
33886_0,,,,2,3,2,5
C(C(CCCCO)=O)(O)=O,,,5,1,2,0,2
33888_0,,,,2,3,2,5
C(C(CCO)CC=O)(O)=O,,,5,1,2,0,2
33889_0,,,,2,3,2,5
33891_0,,,,2,3,2,5
C(C(O)=O)(CCCC(C(O)=O)=O)=O,,,5,1,2,0,2
33893_0,,,,2,3,2,5
C(CC(C(O)=O)CC(C(O)=O)=O)=O,,,5,1,2,0,2
33895_0,,,,2,3,2,5
C(C(CC(O)=O)CC(C(O)=O)=O)=O,,,5,1,2,0,2
33897_0,,,,2,3,2,5
C(C(C(O)=O)CCC(C(O)=O)=O)=O,,,5,1,2,0,2
33899_0,,,,2,3,2,5
C(C(C(O)=O)CCC(C=O)=O)(O)=O,,,5,1,2,0,2
33901_0,,,,2,3,2,5
C(C(C(O)=O)C(C(O)=O)CC=O)=O,,,5,1,2,0,2
33902_0,,,,2,3,2,5
33904_0,,,,2,3,2,5
C(C(C(O)=O)C(C=O)CC=O)(O)=O,,,5,1,2,0,2
33906_0,,,,2,3,2,5
C(CCCC(C(O)=O)=O)(O)=O,,,5,1,3,0,3
33908_0,,,,2,3,2,5
C(CC(C(O)=O)CC(O)=O)=O,,,5,1,2,0,2
33910_0,,,,2,3,2,5
C(C(CC(O)=O)CC(O)=O)=O,,,5,1,2,0,2
33911_0,,,,2,3,2,5
33913_0,,,,2,3,2,5
C(C(CO)(CCC(C(O)=O)=O)O)=O,,,5,1,3,0,3
33914_0,,,,2,3,2,5
33915_0,,,,2,3,2,5
33916_0,,,,2,3,2,5
33917_0,,,,2,3,2,5
33918_0,,,,2,3,2,5
33920_0,,,,2,3,2,5
C(CO)(C(CCC(C(O)=O)=O)O)=O,,,5,1,2,0,2
33922_0,,,,2,3,2,5
C(C(CCC(CO)(CO)O)=O)(O)=O,,,5,1,2,0,2
33924_0,,,,2,3,2,5
C(C(CCC(C(CO)O)O)=O)(O)=O,,,5,1,2,0,2
33925_0,,,,2,3,2,5
33926_0,,,,2,3,2,5
33928_0,,,,2,3,2,5
C(C(C=O)CCC(C(O)=O)=O)=O,,,5,1,3,0,3
33929_0,,,,2,3,2,5
33931_0,,,,2,3,2,5
C(CCCC(C(O)=O)=O)=O,,,5,1,3,0,3
33932_0,,,,2,3,2,5
33934_0,,,,2,3,2,5
C(C(C(C(C=O)O)O)CC=O)(O)=O,,,5,1,2,0,2
33936_0,,,,2,3,2,5
C(C(C(C(C=O)CC(O)=O)O)O)=O,,,5,1,2,0,2
33938_0,,,,2,3,2,5
C(C(C(CO)(CO)O)CC=O)(O)=O,,,5,1,2,0,2
33940_0,,,,2,3,2,5
C(C(C(CO)(CO)O)CC(O)=O)=O,,,5,1,2,0,2
33942_0,,,,2,3,2,5
C(C(C(C(CO)O)O)CC=O)(O)=O,,,5,1,2,0,2
33944_0,,,,2,3,2,5
C(C(C(C(CO)O)O)CC(O)=O)=O,,,5,1,2,0,2
33945_0,,,,2,1,1,2
33945_1,,,,2,1,1,2
33946_0,,,,2,1,1,2
33946_1,,,,2,1,1,2
33948_0,,,,2,1,1,2
C(C1(C(C(CO)(CC1O)O)O)O)=O,,,5,1,4,0,4
33948_1,,,,2,1,1,2
33949_0,,,,2,1,1,2
33949_1,,,,2,1,1,2
33951_0,,,,2,1,1,2
C(C1(C(C(CC1(C=O)O)O)O)O)=O,,,5,1,5,0,5
33951_1,,,,2,1,1,2
33952_0,,,,2,1,1,2
33952_1,,,,2,1,1,2
33953_0,,,,2,1,1,2
33953_1,,,,2,1,1,2
33954_0,,,,2,1,1,2
33954_1,,,,2,1,1,2
33955_0,,,,2,1,1,2
33955_1,,,,2,1,1,2
33956_0,,,,2,1,1,2
33956_1,,,,2,1,1,2
33957_0,,,,2,1,1,2
33957_1,,,,2,1,1,2
33959_0,,,,2,1,1,2
C(C1(C=O)C(C(C(C1O)O)O)O)=O,,,5,1,1,0,1
33960_0,,,,2,1,1,2
33960_1,,,,2,1,1,2
33961_0,,,,2,1,1,2
33962_0,,,,2,1,1,2
33962_1,,,,2,1,1,2
33963_0,,,,2,1,1,2
33963_1,,,,2,1,1,2
33965_0,,,,2,1,1,2
C(C1(CO)C(C(C(C1O)O)O)O)=O,,,5,1,2,0,2
33967_0,,,,2,1,1,2
C(C1(C(C(CO)C(C1O)O)O)O)=O,,,5,1,4,0,4
33967_1,,,,2,1,1,2
33969_0,,,,2,1,1,2
C(C)(C1(C(C(C(C1O)O)O)O)O)=O,,,5,1,4,0,4
33969_1,,,,2,1,1,2
33971_0,,,,2,1,1,2
C(C1(C(C(C(C1(C)O)O)O)O)O)=O,,,5,1,7,0,7
33971_1,,,,2,1,1,2
33973_0,,,,2,1,1,2
C(C1(C(C(CC1(CO)O)O)O)O)=O,,,5,1,4,0,4
33973_1,,,,2,1,1,2
33975_0,,,,2,1,1,2
C(C1(C(C(C(C1O)O)O)O)O)=O,,,5,1,6,0,6
33975_1,,,,2,1,1,2
33977_0,,,,2,1,1,2
C(C1(C=O)C(CC(C1(C)O)O)O)=O,,,5,1,2,0,2
33979_0,,,,2,1,1,2
C(C1(CO)C(C(C)(CC1O)O)O)=O,,,5,1,2,0,2
33981_0,,,,2,1,1,2
C(C)(C1(C(C(C)(CC1O)O)O)O)=O,,,5,1,4,0,4
33981_1,,,,2,1,1,2
33983_0,,,,2,1,1,2
C(C1(C=O)C(C(C)(CC1O)O)O)=O,,,5,1,2,0,2
33985_0,,,,2,1,1,2
C(C1(C(C(C)(CC1O)O)O)O)=O,,,5,1,4,0,4
33985_1,,,,2,1,1,2
33986_0,,,,2,1,1,2
33987_0,,,,2,1,1,2
33987_1,,,,2,1,1,2
33988_0,,,,2,1,1,2
33989_0,,,,2,1,1,2
33989_1,,,,2,1,1,2
33991_0,,,,2,1,1,2
C(C1(C(C(C)(C(C1O)O)O)O)O)=O,,,5,1,6,0,6
33991_1,,,,2,1,1,2
33993_0,,,,2,1,1,2
C(C1(C(CC(C1(C)O)O)O)O)=O,,,5,1,4,0,4
33993_1,,,,2,1,1,2
33994_0,,,,2,1,1,2
33994_1,,,,2,1,1,2
33995_0,,,,2,1,1,2
33995_1,,,,2,1,1,2
33997_0,,,,2,1,1,2
C(C1(CO)C(CC(C1(C)O)O)O)=O,,,5,1,2,0,2
33999_0,,,,2,1,1,2
C(C)(C1(C(CC(C1(C)O)O)O)O)=O,,,5,1,4,0,4
33999_1,,,,2,1,1,2
34000_0,,,,2,1,1,2
34001_0,,,,2,1,1,2
34001_1,,,,2,1,1,2
34002_0,,,,2,1,1,2
34003_0,,,,2,1,1,2
34003_1,,,,2,1,1,2
34005_0,,,,2,1,1,2
C(C)(C1(C(C(CC1O)O)O)O)=O,,,5,1,4,0,4
34005_1,,,,2,1,1,2
34006_0,,,,2,1,1,2
34007_0,,,,2,1,1,2
34009_0,,,,2,1,1,2
C(C1(C=O)C(CC(CC1O)O)O)=O,,,5,1,1,0,1
34011_0,,,,2,1,1,2
C(C1(CO)C(CC(CC1O)O)O)=O,,,5,1,1,0,1
34013_0,,,,2,1,1,2
C(C)(C1(C(CC(CC1O)O)O)O)=O,,,5,1,2,0,2
34013_1,,,,2,1,1,2
34015_0,,,,2,1,1,2
C(C1(C(CC(CC1O)O)O)O)=O,,,5,1,2,0,2
34015_1,,,,2,1,1,2
34017_0,,,,2,1,1,2
C(C1(C(C(C(CC1O)O)O)O)O)=O,,,5,1,6,0,6
34017_1,,,,2,1,1,2
34018_0,,,,2,1,1,2
34018_1,,,,2,1,1,2
34019_0,,,,2,1,1,2
34021_0,,,,2,1,1,2
C1(C(CC(C1(CO)C(C)O)O)O)=O,,,5,1,2,0,2
34023_0,,,,2,1,1,2
C1(C(CC(C1(CO)CO)O)O)=O,,,5,1,2,0,2
34025_0,,,,2,1,1,2
C1(C(C(C(C1(CO)CO)O)O)O)=O,,,5,1,2,0,2
34027_0,,,,2,1,1,2
C(C1(C(C(CC1O)O)O)C(C)O)=O,,,5,1,3,0,3
34028_0,,,,2,1,1,2
34029_0,,,,2,1,1,2
34030_0,,,,2,1,1,2
34031_0,,,,2,1,1,2
34031_1,,,,2,1,1,2
34032_0,,,,2,1,1,2
34032_1,,,,2,1,1,2
34033_0,,,,2,1,1,2
34033_1,,,,2,1,1,2
34034_0,,,,2,1,1,2
34034_1,,,,2,1,1,2
34036_0,,,,2,1,1,2
C(C1(C(CC(CC1(C)O)O)O)O)=O,,,5,1,2,0,2
34036_1,,,,2,1,1,2
34038_0,,,,2,1,1,2
C(C1(C(C)O)C(C=CC1O)O)=O,,,5,1,1,0,1
34039_0,,,,2,1,1,2
34039_1,,,,2,1,1,2
34041_0,,,,2,1,1,2
C(C1C(C(CO)C(C1O)O)O)(O)=O,,,5,1,1,0,1
34043_0,,,,2,1,1,2
C(C1(CO)C(C=CC1O)O)=O,,,5,1,1,0,1
34045_0,,,,2,1,1,2
C(C1(C(CO)O)C(C=CC1O)O)=O,,,5,1,1,0,1
34046_0,,,,2,1,1,2
34046_1,,,,2,1,1,2
34047_0,,,,2,1,1,2
34047_1,,,,2,1,1,2
34048_0,,,,2,1,1,2
34048_1,,,,2,1,1,2
34049_0,,,,2,1,1,2
34049_1,,,,2,1,1,2
34050_0,,,,2,1,1,2
34050_1,,,,2,1,1,2
34052_0,,,,2,1,1,2
C(CO)(C1(C(CC(C1O)=O)O)O)=O,,,5,1,2,0,2
34052_1,,,,2,1,1,2
34053_0,,,,2,1,1,2
34053_1,,,,2,1,1,2
34054_0,,,,2,1,1,2
34056_0,,,,2,1,1,2
C1C(C(C(C=O)=O)(C(C=1)O)O)O,,,5,1,2,0,2
34056_1,,,,2,1,1,2
34058_0,,,,2,1,1,2
C(C(C1(C(C(CC1O)O)O)O)=O)=O,,,5,1,4,0,4
34058_1,,,,2,1,1,2
34059_0,,,,2,1,1,2
34059_1,,,,2,1,1,2
34060_0,,,,2,1,1,2
34060_1,,,,2,1,1,2
34061_0,,,,2,1,1,2
34061_1,,,,2,1,1,2
34062_0,,,,2,1,1,2
34062_1,,,,2,1,1,2
34064_0,,,,2,1,1,2
C1(C(CO)(C(C=O)(CC1O)O)O)=O,,,5,1,2,0,2
34064_1,,,,2,1,1,2
34065_0,,,,2,1,1,2
34065_1,,,,2,1,1,2
34066_0,,,,2,1,1,2
34066_1,,,,2,1,1,2
34067_0,,,,2,1,1,2
34067_1,,,,2,1,1,2
34068_0,,,,2,1,1,2
34068_1,,,,2,1,1,2
34069_0,,,,2,1,1,2
34071_0,,,,2,1,1,2
C1C(C(C(C(C)=O)=O)(C(C=1)O)O)O,,,5,1,2,0,2
34071_1,,,,2,1,1,2
34072_0,,,,2,1,1,2
34074_0,,,,2,1,1,2
C(C1C(C(C(C1(C)O)O)O)O)(O)=O,,,5,1,1,0,1
34076_0,,,,2,1,1,2
C(C)(C1(C(C=CC1O)O)O)=O,,,5,1,2,0,2
34076_1,,,,2,1,1,2
34077_0,,,,2,1,1,2
34077_1,,,,2,1,1,2
34079_0,,,,2,1,1,2
C(C1C(C(CC1(CO)O)O)O)(O)=O,,,5,1,1,0,1
34081_0,,,,2,1,1,2
C(C1(C(C=CC1O)O)O)(CCO)=O,,,5,1,2,0,2
34081_1,,,,2,1,1,2
34083_0,,,,2,1,1,2
C(CO)(C1(CO)C(C=CC1O)O)=O,,,5,1,1,0,1
34084_0,,,,2,1,1,2
34084_1,,,,2,1,1,2
34085_0,,,,2,1,1,2
34085_1,,,,2,1,1,2
34086_0,,,,2,1,1,2
34086_1,,,,2,1,1,2
34087_0,,,,2,1,1,2
34087_1,,,,2,1,1,2
34088_0,,,,2,1,1,2
34088_1,,,,2,1,1,2
34089_0,,,,2,1,1,2
34089_1,,,,2,1,1,2
34090_0,,,,2,1,1,2
34091_0,,,,2,1,1,2
34092_0,,,,2,1,1,2
34093_0,,,,2,1,1,2
34094_0,,,,2,1,1,2
34096_0,,,,2,1,1,2
C(C1(C=O)C(C=CC1O)O)(O)=O,,,5,1,1,0,1
34097_0,,,,2,1,1,2
34098_0,,,,2,1,1,2
34099_0,,,,2,1,1,2
34100_0,,,,2,1,1,2
34101_0,,,,2,1,1,2
34102_0,,,,2,1,1,2
34103_0,,,,2,1,1,2
34104_0,,,,2,1,1,2
34105_0,,,,2,1,1,2
34105_1,,,,2,1,1,2
34106_0,,,,2,1,1,2
34106_1,,,,2,1,1,2
34107_0,,,,2,1,1,2
34107_1,,,,2,1,1,2
34108_0,,,,2,1,1,2
34108_1,,,,2,1,1,2
34109_0,,,,2,1,1,2
34109_1,,,,2,1,1,2
34111_0,,,,2,1,1,2
C(C1(C(CC(C1(CO)O)O)O)O)=O,,,5,1,3,0,3
34111_1,,,,2,1,1,2
34113_0,,,,2,1,1,2
C(C1(C(C(C(C1O)O)O)O)O)(O)=O,,,5,1,2,0,2
34113_1,,,,2,1,1,2
34115_0,,,,2,1,1,2
C(C1(C(CC(C1(C)O)O)O)O)(O)=O,,,5,1,4,0,4
34115_1,,,,2,1,1,2
34117_0,,,,2,1,1,2
C(C1(C(C(C)(CC1O)O)O)O)(O)=O,,,5,1,4,0,4
34117_1,,,,2,1,1,2
34119_0,,,,2,1,1,2
C(C1(C(CC(CC1O)O)O)O)(O)=O,,,5,1,2,0,2
34119_1,,,,2,1,1,2
34120_0,,,,2,1,1,2
34120_1,,,,2,1,1,2
34121_0,,,,2,1,1,2
34121_1,,,,2,1,1,2
34122_0,,,,2,1,1,2
34122_1,,,,2,1,1,2
34123_0,,,,2,1,1,2
34123_1,,,,2,1,1,2
34124_0,,,,2,1,1,2
34124_1,,,,2,1,1,2
34125_0,,,,2,1,1,2
34125_1,,,,2,1,1,2
34126_0,,,,2,1,1,2
34126_1,,,,2,1,1,2
34128_0,,,,2,1,1,2
C1(C2(C(C=CC2O)O)OCC1O)=O,,,5,1,2,0,2
34128_1,,,,2,1,1,2
34129_0,,,,2,1,1,2
34129_1,,,,2,1,1,2
34130_0,,,,2,1,1,2
34130_1,,,,2,1,1,2
34131_0,,,,2,1,1,2
34131_1,,,,2,1,1,2
34132_0,,,,2,1,1,2
34132_1,,,,2,1,1,2
34133_0,,,,2,1,1,2
34133_1,,,,2,1,1,2
34135_0,,,,2,1,1,2
C1(C(O)OCC21C(C=CC2O)O)=O,,,5,1,1,0,1
34137_0,,,,2,1,1,2
C1(COC(C21C(C=CC2O)O)O)=O,,,5,1,1,0,1
34139_0,,,,2,1,1,2
C1(C2(C(C=CC2O)O)OC(C1)O)=O,,,5,1,2,0,2
34139_1,,,,2,1,1,2
34140_0,,,,2,1,1,2
34140_1,,,,2,1,1,2
34142_0,,,,2,1,1,2
C1(C(C(C(C=C)=O)(C(C1)O)O)O)=O,,,5,1,2,0,2
34142_1,,,,2,1,1,2
34143_0,,,,2,1,1,2
34143_1,,,,2,1,1,2
34145_0,,,,2,1,1,2
C(CO)(C1(C(C=CC1O)O)O)=O,,,5,1,3,0,3
34145_1,,,,2,1,1,2
34147_0,,,,2,1,1,2
C(C1(C=O)C(C=CC1O)O)=O,,,5,1,2,0,2
34149_0,,,,2,1,1,2
C1C(C(C(C=O)=O)(CO)C(C=1)O)O,,,5,1,1,0,1
34151_0,,,,2,1,1,2
C(C(C1(C=O)C(C=CC1O)O)O)=O,,,5,1,1,0,1
34153_0,,,,2,1,1,2
C(C1(C(CO)=O)C(C=CC1O)O)=O,,,5,1,1,0,1
34155_0,,,,2,1,1,2
C(CC(C1(C(C=CC1O)O)O)=O)=O,,,5,1,2,0,2
34155_1,,,,2,1,1,2
34156_0,,,,2,1,1,2
34156_1,,,,2,1,1,2
34158_0,,,,2,1,1,2
C(C1(C(C=CC1O)O)O)=O,,,5,1,3,0,3
34158_1,,,,2,1,1,2
34160_0,,,,2,1,1,2
C1(C(C(C(C1(CO)O)O)O)=O)=O,,,5,1,2,0,2
34160_1,,,,2,1,1,2
34162_0,,,,2,1,1,2
C1(C(CO)(C(C(C1)=O)O)O)=O,,,5,1,3,0,3
34162_1,,,,2,1,1,2
34163_0,,,,2,1,1,2
34163_1,,,,2,1,1,2
34164_0,,,,2,1,1,2
34164_1,,,,2,1,1,2
34166_0,,,,2,1,1,2
C(C1(C(C(CC(C1O)O)O)O)O)=O,,,5,1,2,0,2
34166_1,,,,2,1,1,2
34168_0,,,,2,1,1,2
C1(C(CO)(C(CC1(CO)O)O)O)=O,,,5,1,2,0,2
34168_1,,,,2,1,1,2
34170_0,,,,2,1,1,2
C1(C(CO)(C(C(C1(C)O)O)O)O)=O,,,5,1,2,0,2
34170_1,,,,2,1,1,2
34171_0,,,,2,1,1,2
34171_1,,,,2,1,1,2
34172_0,,,,2,1,1,2
34173_0,,,,2,1,1,2
34174_0,,,,2,1,1,2
34176_0,,,,2,1,1,2
C1(C(CO)(C(C=O)(C(C1)O)O)O)=O,,,5,1,4,0,4
34176_1,,,,2,1,1,2
34178_0,,,,2,1,1,2
C(C1(C(CC(C1(C=O)O)O)O)O)=O,,,5,1,2,0,2
34178_1,,,,2,1,1,2
34180_0,,,,2,1,1,2
C1(C2(C(CO1)O)C(C=CC2O)O)=O,,,5,1,1,0,1
34182_0,,,,2,1,1,2
C(C1(CC(C(C1(C=O)O)O)=O)O)=O,,,5,1,2,0,2
34182_1,,,,2,1,1,2
34183_0,,,,2,1,1,2
34183_1,,,,2,1,1,2
34184_0,,,,2,1,1,2
34184_1,,,,2,1,1,2
34186_0,,,,2,1,1,2
C(C1C(C(C(C1O)=O)(C)O)O)(O)=O,,,5,1,2,0,2
34188_0,,,,2,1,1,2
C(C1(C(C=CC1O)O)O)(O)=O,,,5,1,3,0,3
34188_1,,,,2,1,1,2
34190_0,,,,2,1,1,2
C1(CCC(C1(C(CO)O)O)O)=O,,,5,1,2,0,2
34190_1,,,,2,1,1,2
34192_0,,,,2,1,1,2
C1(C(CC(C1(CO)O)O)=O)=O,,,5,1,3,0,3
34192_1,,,,2,1,1,2
34194_0,,,,2,1,1,2
C1(C(CC(C1(CO)CO)O)=O)=O,,,5,1,1,0,1
34195_0,,,,2,1,1,2
34197_0,,,,2,1,1,2
C(C1(C(CC(CO)C1O)=O)O)=O,,,5,1,2,0,2
34197_1,,,,2,1,1,2
34199_0,,,,2,1,1,2
C(C1(CO)C(C(C(C1)=O)O)O)=O,,,5,1,1,0,1
34201_0,,,,2,1,1,2
C1(CCC(C1(C(CO)=O)O)O)=O,,,5,1,3,0,3
34201_1,,,,2,1,1,2
34203_0,,,,2,1,1,2
C1(C(C(C(C1C)O)(CO)O)=O)=O,,,5,1,3,0,3
34203_1,,,,2,1,1,2
34205_0,,,,2,1,1,2
C1(C(CO)(C(C(C1)=O)(C)O)O)=O,,,5,1,3,0,3
34205_1,,,,2,1,1,2
34207_0,,,,2,1,1,2
C1(C(CC(C)(C1(CO)O)O)=O)=O,,,5,1,3,0,3
34207_1,,,,2,1,1,2
34208_0,,,,2,1,1,2
34208_1,,,,2,1,1,2
34210_0,,,,2,1,1,2
C1(C(CCC(C1(CO)O)O)=O)=O,,,5,1,3,0,3
34210_1,,,,2,1,1,2
34212_0,,,,2,1,1,2
C1(C(CO)(CO)C(C(C1)=O)O)=O,,,5,1,1,0,1
34214_0,,,,2,1,1,2
C(C1(C(C(CC1O)=O)=O)C)=O,,,5,1,1,0,1
34216_0,,,,2,1,1,2
C1(C(CO)(C(C=O)(CC1)O)O)=O,,,5,1,4,0,4
34216_1,,,,2,1,1,2
34217_0,,,,2,1,1,2
34217_1,,,,2,1,1,2
34219_0,,,,2,1,1,2
C(C1(C=O)C(CC(C1)=O)O)=O,,,5,1,3,0,3
34221_0,,,,2,1,1,2
C(C1(C=O)C(CCC1O)=O)=O,,,5,1,2,0,2
34222_0,,,,2,1,1,2
34222_1,,,,2,1,1,2
34224_0,,,,2,1,1,2
C(C1(C(CCC1O)=O)O)=O,,,5,1,4,0,4
34224_1,,,,2,1,1,2
34226_0,,,,2,1,1,2
C(C1(C(CCC1(CO)O)=O)O)=O,,,5,1,2,0,2
34226_1,,,,2,1,1,2
34228_0,,,,2,1,1,2
C1(CCC(C1(CO)O)O)=O,,,5,1,2,0,2
34228_1,,,,2,1,1,2
34230_0,,,,2,1,1,2
C(C1(C(C(CC1O)O)=O)CO)=O,,,5,1,1,0,1
34232_0,,,,2,1,1,2
C(C1(C(CC(C1O)O)=O)CO)=O,,,5,1,1,0,1
34234_0,,,,2,1,1,2
C(C1C(C(CO)(C(C1)O)O)=O)=O,,,5,1,3,0,3
34234_1,,,,2,1,1,2
34236_0,,,,2,1,1,2
C(C1(C(CCC1O)=O)O)(O)=O,,,5,1,3,0,3
34236_1,,,,2,1,1,2
34238_0,,,,2,1,1,2
C1(C2(C(C(CC2O)O1)O)O)=O,,,5,1,6,0,6
34238_1,,,,2,1,1,2
34240_0,,,,2,1,1,2
C(C1(C(C=CC1O)=O)O)=O,,,5,1,3,0,3
34240_1,,,,2,1,1,2
34242_0,,,,2,1,1,2
C1(C(CO)(C(C(C1O)=C)O)O)=O,,,5,1,3,0,3
34242_1,,,,2,1,1,2
34244_0,,,,2,1,1,2
C1(C(CO)(C(C=CC1O)O)O)=O,,,5,1,3,0,3
34244_1,,,,2,1,1,2
34246_0,,,,2,1,1,2
C(C1(C(C=C(C)C1O)=O)O)=O,,,5,1,3,0,3
34246_1,,,,2,1,1,2
34248_0,,,,2,1,1,2
C(C1(C(CC(C1O)=C)=O)O)=O,,,5,1,3,0,3
34248_1,,,,2,1,1,2
34250_0,,,,2,1,1,2
C(C1(C(C=CC1(C)O)=O)O)=O,,,5,1,3,0,3
34250_1,,,,2,1,1,2
34252_0,,,,2,1,1,2
C(C1(C(C=CCC1O)=O)O)=O,,,5,1,3,0,3
34252_1,,,,2,1,1,2
34254_0,,,,2,1,1,2
C(C1(C(CC=CC1O)=O)O)=O,,,5,1,3,0,3
34254_1,,,,2,1,1,2
34256_0,,,,2,1,1,2
C(C1(C=O)C=CC(C1O)O)=O,,,5,1,2,0,2
34258_0,,,,2,1,1,2
C1C(C(C(C=1)=O)(CO)O)O,,,5,1,3,0,3
34258_1,,,,2,1,1,2
34260_0,,,,2,1,1,2
C(C12C(O)OC(C1O)CC2O)=O,,,5,1,4,0,4
34262_0,,,,2,1,1,2
C1(CC2C(C1(C(O)O2)O)O)=O,,,5,1,4,0,4
34262_1,,,,2,1,1,2
34264_0,,,,2,1,1,2
C1(CC2(C)C(C1(C(O)O2)O)O)=O,,,5,1,4,0,4
34264_1,,,,2,1,1,2
34266_0,,,,2,1,1,2
C1(CC2C(C)(C1(C(O)O2)O)O)=O,,,5,1,4,0,4
34266_1,,,,2,1,1,2
34268_0,,,,2,1,1,2
C1(CC2CC(C1(C(O)O2)O)O)=O,,,5,1,3,0,3
34268_1,,,,2,1,1,2
34269_0,,,,2,1,1,2
34270_0,,,,2,1,1,2
34270_1,,,,2,1,1,2
34272_0,,,,2,1,1,2
C(C1(C=O)C(CCC1(C=O)O)O)=O,,,5,1,1,0,1
34274_0,,,,2,1,1,2
C(C1(C=O)C(CCC(C1O)=O)O)=O,,,5,1,2,0,2
34276_0,,,,2,1,1,2
C(C1(C=O)C(C(C=O)CC1O)O)=O,,,5,1,1,0,1
34278_0,,,,2,1,1,2
C(C1(CCC(C1O)=O)C(C)O)=O,,,5,1,2,0,2
34280_0,,,,2,1,1,2
C(C1(C(C)(CCC1(C=O)O)O)O)=O,,,5,1,2,0,2
34280_1,,,,2,1,1,2
34282_0,,,,2,1,1,2
C(C1(C(CCC(C1O)=O)(C)O)O)=O,,,5,1,3,0,3
34282_1,,,,2,1,1,2
34284_0,,,,2,1,1,2
C(C1CC(C(C=O)(C1(C)O)O)O)=O,,,5,1,2,0,2
34284_1,,,,2,1,1,2
34286_0,,,,2,1,1,2
C(C1(C(CCCC1(C=O)O)O)O)=O,,,5,1,2,0,2
34286_1,,,,2,1,1,2
34288_0,,,,2,1,1,2
C(C1(C(CCCC(C1O)=O)O)O)=O,,,5,1,3,0,3
34288_1,,,,2,1,1,2
34290_0,,,,2,1,1,2
C(C1(C(C(CC1O)CC=O)O)O)=O,,,5,1,3,0,3
34290_1,,,,2,1,1,2
34292_0,,,,2,1,1,2
C(C1CC(C(C=O)(C(C1)O)O)O)=O,,,5,1,2,0,2
34292_1,,,,2,1,1,2
34294_0,,,,2,1,1,2
C(C1(CO)CCC(C1O)=O)=O,,,5,1,2,0,2
34296_0,,,,2,1,1,2
C(C1(C(C(CC1O)O)O)CC=O)=O,,,5,1,2,0,2
34298_0,,,,2,1,1,2
C(C1(CCC(C1O)=O)C(CO)O)=O,,,5,1,2,0,2
34300_0,,,,2,1,1,2
C(CO)(C1(CO)CCC(C1O)=O)=O,,,5,1,2,0,2
34301_0,,,,2,1,1,2
34303_0,,,,2,1,1,2
C(C1(CCC(C1(C(C)=O)O)O)O)=O,,,5,1,2,0,2
34303_1,,,,2,1,1,2
34305_0,,,,2,1,1,2
C(C)(C1(C(CCC(C1O)=O)O)O)=O,,,5,1,3,0,3
34305_1,,,,2,1,1,2
34307_0,,,,2,1,1,2
C(C1C(C(C(C)=O)(C(C1)O)O)O)=O,,,5,1,2,0,2
34307_1,,,,2,1,1,2
34309_0,,,,2,1,1,2
C1(C(CO)(C(C=O)(CCC1)O)O)=O,,,5,1,2,0,2
34309_1,,,,2,1,1,2
34311_0,,,,2,1,1,2
C1(C(CO)(C(C(CCC1)=O)O)O)=O,,,5,1,3,0,3
34311_1,,,,2,1,1,2
34313_0,,,,2,1,1,2
C1(CC(C(C1(CO)O)O)CC=O)=O,,,5,1,3,0,3
34313_1,,,,2,1,1,2
34315_0,,,,2,1,1,2
C(C1CC(C(C(C1)=O)(CO)O)O)=O,,,5,1,2,0,2
34315_1,,,,2,1,1,2
34317_0,,,,2,1,1,2
C(C1(C=O)CCC(C1O)=O)(O)=O,,,5,1,2,0,2
34319_0,,,,2,1,1,2
C1(C2(COC1CCC2(C=O)O)O)=O,,,5,1,2,0,2
34319_1,,,,2,1,1,2
34321_0,,,,2,1,1,2
C1(C2(COC1CCC(C2O)=O)O)=O,,,5,1,3,0,3
34321_1,,,,2,1,1,2
34323_0,,,,2,1,1,2
C(CC1C(C2(C(C1OC2)=O)O)O)=O,,,5,1,3,0,3
34323_1,,,,2,1,1,2
34325_0,,,,2,1,1,2
C(C1CC(C2(C(C1OC2)=O)O)O)=O,,,5,1,2,0,2
34325_1,,,,2,1,1,2
34327_0,,,,2,1,1,2
C(C1(CCC2C1(C(CO2)=O)O)O)=O,,,5,1,2,0,2
34327_1,,,,2,1,1,2
34329_0,,,,2,1,1,2
C1(COC2CCC(C(C12O)O)=O)=O,,,5,1,3,0,3
34329_1,,,,2,1,1,2
34331_0,,,,2,1,1,2
C(C1C2C(C(CO2)=O)(C(C1)O)O)=O,,,5,1,2,0,2
34331_1,,,,2,1,1,2
34333_0,,,,2,1,1,2
C1(C(O)OCC21CCC(C2O)=O)=O,,,5,1,2,0,2
34335_0,,,,2,1,1,2
C1(C2(CCC(C2O)=O)C(CO1)O)=O,,,5,1,2,0,2
34337_0,,,,2,1,1,2
C1(C2C(C(CCC2(C=O)O)O1)O)=O,,,5,1,1,0,1
34339_0,,,,2,1,1,2
C1(C2C(C(CCC(C2O)=O)O1)O)=O,,,5,1,2,0,2
34341_0,,,,2,1,1,2
C1(C2C(C(C(C2O)O1)CC=O)O)=O,,,5,1,2,0,2
34343_0,,,,2,1,1,2
C1(C2C(CC(C=O)C(C2O)O1)O)=O,,,5,1,1,0,1
34345_0,,,,2,1,1,2
C1(C2C(CO1)(CCC2(C=O)O)O)=O,,,5,1,1,0,1
34347_0,,,,2,1,1,2
C1(C2C(CCC(C2O)=O)(CO1)O)=O,,,5,1,2,0,2
34349_0,,,,2,1,1,2
C1(C2C(CC(C=O)C2(CO1)O)O)=O,,,5,1,1,0,1
34351_0,,,,2,1,1,2
C1(COC(C21CCC(C2O)=O)O)=O,,,5,1,2,0,2
34353_0,,,,2,1,1,2
C(C1(C(CCC1(C=O)O)O)O)=O,,,5,1,2,0,2
34353_1,,,,2,1,1,2
34355_0,,,,2,1,1,2
C(C1(C(CCC(C1O)=O)O)O)=O,,,5,1,3,0,3
34355_1,,,,2,1,1,2
34357_0,,,,2,1,1,2
C(C1(C(CCC1(C=O)O)O)O)(O)=O,,,5,1,2,0,2
34357_1,,,,2,1,1,2
34359_0,,,,2,1,1,2
C(C1(C(CCC(C1O)=O)O)O)(O)=O,,,5,1,3,0,3
34359_1,,,,2,1,1,2
34361_0,,,,2,1,1,2
C(C1(C=O)CCC(C1O)=O)=O,,,5,1,2,0,2
34363_0,,,,2,1,1,2
C1(C(C(C(C=O)=O)(CO)CC1)O)=O,,,5,1,2,0,2
34365_0,,,,2,1,1,2
C(C1(CCC(C1O)=O)C(C=O)O)=O,,,5,1,2,0,2
34367_0,,,,2,1,1,2
C(CO)(C1(C=O)CCC(C1O)=O)=O,,,5,1,2,0,2
34369_0,,,,2,1,1,2
C1(CCCC(C=O)(C1(C=O)O)O)=O,,,5,1,2,0,2
34369_1,,,,2,1,1,2
34371_0,,,,2,1,1,2
C1(CCCC(C(C1(C=O)O)O)=O)=O,,,5,1,3,0,3
34371_1,,,,2,1,1,2
34373_0,,,,2,1,1,2
C(C1C(C(C=O)(C(C1)O)O)O)=O,,,5,1,2,0,2
34373_1,,,,2,1,1,2
34375_0,,,,2,1,1,2
C(C1C(C(C(O)=O)(C(C1)O)O)O)=O,,,5,1,2,0,2
34375_1,,,,2,1,1,2
34377_0,,,,2,1,1,2
C(CC1(C=O)C(CC(C1O)=O)O)=O,,,5,1,2,0,2
34378_0,,,,2,1,1,2
34380_0,,,,2,1,1,2
C(C1(C(CC(C1O)CC=O)=O)O)=O,,,5,1,3,0,3
34380_1,,,,2,1,1,2
34382_0,,,,2,1,1,2
C(C1CC(C(C=O)(C(C1)=O)O)O)=O,,,5,1,2,0,2
34382_1,,,,2,1,1,2
34384_0,,,,2,2,1,3
C(C1(C(C(C(C1O)O)O)=O)O)(O)=O,,,5,1,2,0,2
34384_1,,,,2,2,1,3
34385_0,,,,2,2,1,3
34385_1,,,,2,2,1,3
34386_0,,,,2,2,1,3
34386_1,,,,2,2,1,3
34387_0,,,,2,2,1,3
34388_0,,,,2,2,1,3
34388_1,,,,2,2,1,3
34389_0,,,,2,2,1,3
34389_1,,,,2,2,1,3
34390_0,,,,2,2,1,3
34390_1,,,,2,2,1,3
34391_0,,,,2,2,1,3
34391_1,,,,2,2,1,3
34392_0,,,,2,2,1,3
34392_1,,,,2,2,1,3
34394_0,,,,2,2,1,3
C(C1(C=O)C(CC(C1O)=O)O)(O)=O,,,5,1,1,0,1
34395_0,,,,2,2,1,3
34396_0,,,,2,2,1,3
34397_0,,,,2,2,1,3
34397_1,,,,2,2,1,3
34399_0,,,,2,2,1,3
C1(C(C(C(C1)O)O)(C(C=C)O)O)=O,,,5,1,2,0,2
34399_1,,,,2,2,1,3
34400_0,,,,2,2,1,3
34400_1,,,,2,2,1,3
34401_0,,,,2,2,1,3
34401_1,,,,2,2,1,3
34402_0,,,,2,2,1,3
34402_1,,,,2,2,1,3
34403_0,,,,2,2,1,3
34403_1,,,,2,2,1,3
34405_0,,,,2,2,1,3
C(C1(C(C(CC1O)O)=O)CO)(O)=O,,,5,1,1,0,1
34406_0,,,,2,2,1,3
34407_0,,,,2,2,1,3
34408_0,,,,2,2,1,3
34408_1,,,,2,2,1,3
34409_0,,,,2,2,1,3
34410_0,,,,2,2,1,3
34411_0,,,,2,2,1,3
34412_0,,,,2,2,1,3
34413_0,,,,2,2,1,3
34414_0,,,,2,2,1,3
34414_1,,,,2,2,1,3
34415_0,,,,2,2,1,3
34415_1,,,,2,2,1,3
34416_0,,,,2,2,1,3
34416_1,,,,2,2,1,3
34417_0,,,,2,2,1,3
34417_1,,,,2,2,1,3
34418_0,,,,2,2,1,3
34418_1,,,,2,2,1,3
34419_0,,,,2,2,1,3
34420_0,,,,2,2,1,3
34421_0,,,,2,2,1,3
34422_0,,,,2,2,1,3
34423_0,,,,2,2,1,3
34424_0,,,,2,2,1,3
34425_0,,,,2,2,1,3
34426_0,,,,2,2,1,3
34427_0,,,,2,2,1,3
34428_0,,,,2,2,1,3
34429_0,,,,2,2,1,3
34430_0,,,,2,2,1,3
34431_0,,,,2,2,1,3
34432_0,,,,2,2,1,3
34433_0,,,,2,2,1,3
34433_1,,,,2,2,1,3
34434_0,,,,2,2,1,3
34435_0,,,,2,2,1,3
34435_1,,,,2,2,1,3
34437_0,,,,2,2,1,3
C(C(C(C(CO)(CO)CO)=O)O)=O,,,5,1,1,0,1
34438_0,,,,2,2,1,3
34439_0,,,,2,2,1,3
34439_1,,,,2,2,1,3
34440_0,,,,2,2,1,3
34442_0,,,,2,2,1,3
C(C(C=O)(C(CC(C)O)O)O)(O)=O,,,5,1,4,0,4
34442_1,,,,2,2,1,3
34443_0,,,,2,2,1,3
34443_1,,,,2,2,1,3
34444_0,,,,2,2,1,3
34444_1,,,,2,2,1,3
34445_0,,,,2,2,1,3
34446_0,,,,2,2,1,3
34447_0,,,,2,2,1,3
34448_0,,,,2,2,1,3
34450_0,,,,2,2,1,3
C(C(C(C)O)(C(C)O)C(C=C)O)=O,,,5,1,1,0,1
34451_0,,,,2,2,1,3
34453_0,,,,2,2,1,3
C(C(C(C)O)(C(C)O)C(C)O)=O,,,5,1,1,0,1
34454_0,,,,2,2,1,3
34455_0,,,,2,2,1,3
34457_0,,,,2,2,1,3
C(C(CO)(C(C)O)C(C(C)O)O)=O,,,5,1,1,0,1
34458_0,,,,2,2,1,3
34460_0,,,,2,2,1,3
C(C(CO)(C(C)O)C(C=CC)O)=O,,,5,1,1,0,1
34462_0,,,,2,2,1,3
C(C(CO)(C(CC=C)O)C(C)O)=O,,,5,1,1,0,1
34464_0,,,,2,2,1,3
C(C(CO)(C(C)O)C(C=C)O)=O,,,5,1,1,0,1
34465_0,,,,2,2,1,3
34466_0,,,,2,2,1,3
34467_0,,,,2,2,1,3
34468_0,,,,2,2,1,3
34469_0,,,,2,2,1,3
34470_0,,,,2,2,1,3
34471_0,,,,2,2,1,3
34472_0,,,,2,2,1,3
34473_0,,,,2,2,1,3
34474_0,,,,2,2,1,3
34475_0,,,,2,2,1,3
34476_0,,,,2,2,1,3
34477_0,,,,2,2,1,3
34478_0,,,,2,2,1,3
34478_1,,,,2,2,1,3
34479_0,,,,2,2,1,3
34480_0,,,,2,2,1,3
34481_0,,,,2,2,1,3
34482_0,,,,2,2,1,3
34483_0,,,,2,2,1,3
34483_1,,,,2,2,1,3
34484_0,,,,2,2,1,3
34484_1,,,,2,2,1,3
34485_0,,,,2,2,1,3
34485_1,,,,2,2,1,3
34486_0,,,,2,2,1,3
34486_1,,,,2,2,1,3
34487_0,,,,2,2,1,3
34488_0,,,,2,2,1,3
34488_1,,,,2,2,1,3
34490_0,,,,2,2,1,3
C(C(C=O)(C=O)C(CCO)O)(O)=O,,,5,1,1,0,1
34491_0,,,,2,2,1,3
34492_0,,,,2,2,1,3
34494_0,,,,2,2,1,3
C(C(C=O)(C(CCO)O)O)(O)=O,,,5,1,4,0,4
34494_1,,,,2,2,1,3
34496_0,,,,2,2,1,3
C(C(C(CCO)O)(C(C=C)O)O)=O,,,5,1,2,0,2
34496_1,,,,2,2,1,3
34497_0,,,,2,2,1,3
34497_1,,,,2,2,1,3
34498_0,,,,2,2,1,3
34498_1,,,,2,2,1,3
34499_0,,,,2,2,1,3
34499_1,,,,2,2,1,3
34500_0,,,,2,2,1,3
34500_1,,,,2,2,1,3
34501_0,,,,2,2,1,3
34502_0,,,,2,2,1,3
34503_0,,,,2,2,1,3
34504_0,,,,2,2,1,3
34505_0,,,,2,2,1,3
34506_0,,,,2,2,1,3
34507_0,,,,2,2,1,3
34508_0,,,,2,2,1,3
34509_0,,,,2,2,1,3
34510_0,,,,2,2,1,3
34511_0,,,,2,2,1,3
34512_0,,,,2,2,1,3
34513_0,,,,2,2,1,3
34514_0,,,,2,2,1,3
34516_0,,,,2,2,1,3
C(C(CO)(CO)C(C(C)O)O)=O,,,5,1,1,0,1
34517_0,,,,2,2,1,3
34519_0,,,,2,2,1,3
C(C(CO)(CO)C(CC(C)=O)O)=O,,,5,1,1,0,1
34521_0,,,,2,2,1,3
C(C(CO)(CO)C(C)(CC=O)O)=O,,,5,1,1,0,1
34522_0,,,,2,2,1,3
34524_0,,,,2,2,1,3
C(C(CO)(CO)C(C=C)(CO)O)=O,,,5,1,1,0,1
34526_0,,,,2,2,1,3
C(C(CO)(CO)C(C=CCO)O)=O,,,5,1,1,0,1
34528_0,,,,2,2,1,3
C(C(CO)(CO)C(C=O)(CC)O)=O,,,5,1,1,0,1
34530_0,,,,2,2,1,3
C(C(CO)(CO)C(C(CC)=O)O)=O,,,5,1,1,0,1
34532_0,,,,2,2,1,3
C(C(CO)(CO)C(CCC=O)O)=O,,,5,1,1,0,1
34534_0,,,,2,2,1,3
C(C(CO)(CO)C(C(C)=O)(C)O)=O,,,5,1,1,0,1
34536_0,,,,2,2,1,3
C(C(CO)(CO)C(C(C=O)=C)O)=O,,,5,1,1,0,1
34538_0,,,,2,2,1,3
C(C(CO)(CO)C(C=CC)O)=O,,,5,1,1,0,1
34540_0,,,,2,2,1,3
C(C(CO)(CO)C(CC=C)O)=O,,,5,1,1,0,1
34542_0,,,,2,2,1,3
C(C(CO)(CO)C(C(C=C)O)O)=O,,,5,1,1,0,1
34544_0,,,,2,2,1,3
C(C(CO)(CO)C(C=C)O)=O,,,5,1,1,0,1
34546_0,,,,2,2,1,3
C(C(CO)(CO)C1(C=COC1)O)=O,,,5,1,1,0,1
34547_0,,,,2,2,1,3
34548_0,,,,2,2,1,3
34549_0,,,,2,2,1,3
34550_0,,,,2,2,1,3
34551_0,,,,2,2,1,3
34552_0,,,,2,2,1,3
34553_0,,,,2,2,1,3
34554_0,,,,2,2,1,3
34555_0,,,,2,2,1,3
34556_0,,,,2,2,1,3
34557_0,,,,2,2,1,3
34558_0,,,,2,2,1,3
34559_0,,,,2,2,1,3
34560_0,,,,2,2,1,3
34561_0,,,,2,2,1,3
34562_0,,,,2,2,1,3
34563_0,,,,2,2,1,3
34564_0,,,,2,2,1,3
34565_0,,,,2,2,1,3
34566_0,,,,2,2,1,3
34568_0,,,,2,2,1,3
C(C(C=O)(C(C(CO)CO)O)O)=O,,,5,1,3,0,3
34568_1,,,,2,2,1,3
34570_0,,,,2,2,1,3
C(C(CO)C(C(CO)CO)O)(O)=O,,,5,1,1,0,1
34571_0,,,,2,2,1,3
34571_1,,,,2,2,1,3
34572_0,,,,2,2,1,3
34574_0,,,,2,2,1,3
C(C(CO)(C(CO)O)C(C=C)O)=O,,,5,1,1,0,1
34575_0,,,,2,2,1,3
34576_0,,,,2,2,1,3
34577_0,,,,2,2,1,3
34578_0,,,,2,2,1,3
34579_0,,,,2,2,1,3
34579_1,,,,2,2,1,3
34580_0,,,,2,2,1,3
34581_0,,,,2,2,1,3
34582_0,,,,2,2,1,3
34583_0,,,,2,2,1,3
34583_1,,,,2,2,1,3
34584_0,,,,2,2,1,3
34584_1,,,,2,2,1,3
34585_0,,,,2,2,1,3
34585_1,,,,2,2,1,3
34587_0,,,,2,2,1,3
C(C(C=O)(C(C(C=O)=O)O)O)(O)=O,,,5,1,2,0,2
34587_1,,,,2,2,1,3
34588_0,,,,2,2,1,3
34588_1,,,,2,2,1,3
34589_0,,,,2,2,1,3
34589_1,,,,2,2,1,3
34591_0,,,,2,2,1,3
C(C(C(C=O)=O)(C(C=O)O)O)(O)=O,,,5,1,2,0,2
34591_1,,,,2,2,1,3
34593_0,,,,2,2,1,3
C(C(C(C(C=O)=O)(C(C)O)O)O)=O,,,5,1,4,0,4
34593_1,,,,2,2,1,3
34594_0,,,,2,2,1,3
34594_1,,,,2,2,1,3
34595_0,,,,2,2,1,3
34595_1,,,,2,2,1,3
34596_0,,,,2,2,1,3
34596_1,,,,2,2,1,3
34597_0,,,,2,2,1,3
34597_1,,,,2,2,1,3
34598_0,,,,2,2,1,3
34598_1,,,,2,2,1,3
34599_0,,,,2,2,1,3
34599_1,,,,2,2,1,3
34601_0,,,,2,2,1,3
C=CC(C(C(C=O)=O)(C(C)O)O)O,,,5,1,2,0,2
34601_1,,,,2,2,1,3
34602_0,,,,2,2,1,3
34602_1,,,,2,2,1,3
34604_0,,,,2,2,1,3
C(C(C(C(C)O)(C(C)O)O)=O)=O,,,5,1,2,0,2
34604_1,,,,2,2,1,3
34605_0,,,,2,2,1,3
34605_1,,,,2,2,1,3
34606_0,,,,2,2,1,3
34606_1,,,,2,2,1,3
34607_0,,,,2,2,1,3
34607_1,,,,2,2,1,3
34608_0,,,,2,2,1,3
34608_1,,,,2,2,1,3
34609_0,,,,2,2,1,3
34609_1,,,,2,2,1,3
34610_0,,,,2,2,1,3
34610_1,,,,2,2,1,3
34612_0,,,,2,2,1,3
C(C(C(C(C(C)=O)=O)(CO)O)O)=O,,,5,1,4,0,4
34612_1,,,,2,2,1,3
34614_0,,,,2,2,1,3
C(C(C(C(C)=O)=O)(C(C)O)O)(O)=O,,,5,1,2,0,2
34614_1,,,,2,2,1,3
34616_0,,,,2,2,1,3
C(C(C)=O)(C(C(C)O)(C(C)O)O)=O,,,5,1,2,0,2
34616_1,,,,2,2,1,3
34618_0,,,,2,2,1,3
C(C(C)=O)(C(CO)(C(C)O)O)=O,,,5,1,5,0,5
34618_1,,,,2,2,1,3
34619_0,,,,2,2,1,3
34619_1,,,,2,2,1,3
34621_0,,,,2,2,1,3
C=CC(C(C(C(C)=O)=O)(CO)O)O,,,5,1,2,0,2
34621_1,,,,2,2,1,3
34622_0,,,,2,2,1,3
34622_1,,,,2,2,1,3
34623_0,,,,2,2,1,3
34623_1,,,,2,2,1,3
34624_0,,,,2,2,1,3
34624_1,,,,2,2,1,3
34626_0,,,,2,2,1,3
C(C(C)=O)(C(CO)(C(CO)O)O)=O,,,5,1,6,0,6
34626_1,,,,2,2,1,3
34627_0,,,,2,2,1,3
34627_1,,,,2,2,1,3
34628_0,,,,2,2,1,3
34628_1,,,,2,2,1,3
34629_0,,,,2,2,1,3
34629_1,,,,2,2,1,3
34630_0,,,,2,2,1,3
34630_1,,,,2,2,1,3
34631_0,,,,2,2,1,3
34631_1,,,,2,2,1,3
34633_0,,,,2,2,1,3
C(C)(C(C(C)O)(C(CO)(C)O)O)=O,,,5,1,4,0,4
34633_1,,,,2,2,1,3
34634_0,,,,2,2,1,3
34634_1,,,,2,2,1,3
34635_0,,,,2,2,1,3
34636_0,,,,2,2,1,3
34636_1,,,,2,2,1,3
34638_0,,,,2,2,1,3
C(C(C=O)(C=O)C(C)(CO)O)(O)=O,,,5,1,1,0,1
34639_0,,,,2,2,1,3
34640_0,,,,2,2,1,3
34642_0,,,,2,2,1,3
C(C(C=O)(C(CO)(C)O)O)(O)=O,,,5,1,4,0,4
34642_1,,,,2,2,1,3
34644_0,,,,2,2,1,3
C(C(C(CO)(C)O)(C(C=C)O)O)=O,,,5,1,2,0,2
34644_1,,,,2,2,1,3
34645_0,,,,2,2,1,3
34645_1,,,,2,2,1,3
34646_0,,,,2,2,1,3
34646_1,,,,2,2,1,3
34647_0,,,,2,2,1,3
34647_1,,,,2,2,1,3
34648_0,,,,2,2,1,3
34648_1,,,,2,2,1,3
34649_0,,,,2,2,1,3
34649_1,,,,2,2,1,3
34650_0,,,,2,2,1,3
34651_0,,,,2,2,1,3
34651_1,,,,2,2,1,3
34652_0,,,,2,2,1,3
34652_1,,,,2,2,1,3
34654_0,,,,2,2,1,3
C(C(C(C(C=C)=O)(CO)O)O)(C)=O,,,5,1,2,0,2
34654_1,,,,2,2,1,3
34655_0,,,,2,2,1,3
34655_1,,,,2,2,1,3
34656_0,,,,2,2,1,3
34656_1,,,,2,2,1,3
34657_0,,,,2,2,1,3
34657_1,,,,2,2,1,3
34658_0,,,,2,2,1,3
34658_1,,,,2,2,1,3
34659_0,,,,2,2,1,3
34659_1,,,,2,2,1,3
34661_0,,,,2,2,1,3
C(C(C)(C(C(C)=O)(C(C)O)O)O)=O,,,5,1,4,0,4
34661_1,,,,2,2,1,3
34662_0,,,,2,2,1,3
34662_1,,,,2,2,1,3
34663_0,,,,2,2,1,3
34663_1,,,,2,2,1,3
34665_0,,,,2,2,1,3
C(C)(C(C(C)O)(C(C(C)=O)O)O)=O,,,5,1,4,0,4
34665_1,,,,2,2,1,3
34666_0,,,,2,2,1,3
34666_1,,,,2,2,1,3
34668_0,,,,2,2,1,3
C(C)(C(C(C)O)(C(C(C)O)O)O)=O,,,5,1,2,0,2
34668_1,,,,2,2,1,3
34669_0,,,,2,2,1,3
34669_1,,,,2,2,1,3
34671_0,,,,2,2,1,3
C(C)(C(C(C)O)(C(C=CC)O)O)=O,,,5,1,2,0,2
34671_1,,,,2,2,1,3
34673_0,,,,2,2,1,3
C(C)(C(C(CC=C)O)(C(C)O)O)=O,,,5,1,2,0,2
34673_1,,,,2,2,1,3
34675_0,,,,2,2,1,3
C(C)(C(C(C)O)(C(C=C)O)O)=O,,,5,1,2,0,2
34675_1,,,,2,2,1,3
34676_0,,,,2,2,1,3
34676_1,,,,2,2,1,3
34677_0,,,,2,2,1,3
34677_1,,,,2,2,1,3
34678_0,,,,2,2,1,3
34678_1,,,,2,2,1,3
34679_0,,,,2,2,1,3
34679_1,,,,2,2,1,3
34681_0,,,,2,2,1,3
C(C)(C(C(C)O)(C(C)O)O)=O,,,5,1,2,0,2
34681_1,,,,2,2,1,3
34682_0,,,,2,2,1,3
34682_1,,,,2,2,1,3
34683_0,,,,2,2,1,3
34683_1,,,,2,2,1,3
34684_0,,,,2,2,1,3
34684_1,,,,2,2,1,3
34685_0,,,,2,2,1,3
34685_1,,,,2,2,1,3
34686_0,,,,2,2,1,3
34686_1,,,,2,2,1,3
34687_0,,,,2,2,1,3
34687_1,,,,2,2,1,3
34689_0,,,,2,2,1,3
C(C)(C(C(CO)O)(C(C=C)O)O)=O,,,5,1,2,0,2
34689_1,,,,2,2,1,3
34690_0,,,,2,2,1,3
34690_1,,,,2,2,1,3
34691_0,,,,2,2,1,3
34691_1,,,,2,2,1,3
34692_0,,,,2,2,1,3
34692_1,,,,2,2,1,3
34693_0,,,,2,2,1,3
34693_1,,,,2,2,1,3
34694_0,,,,2,2,1,3
34695_0,,,,2,2,1,3
34695_1,,,,2,2,1,3
34696_0,,,,2,2,1,3
34696_1,,,,2,2,1,3
34697_0,,,,2,2,1,3
34697_1,,,,2,2,1,3
34698_0,,,,2,2,1,3
34698_1,,,,2,2,1,3
34699_0,,,,2,2,1,3
34699_1,,,,2,2,1,3
34701_0,,,,2,2,1,3
C(C(CO)(C(C=C)O)O)(CCO)=O,,,5,1,2,0,2
34701_1,,,,2,2,1,3
34702_0,,,,2,2,1,3
34702_1,,,,2,2,1,3
34703_0,,,,2,2,1,3
34703_1,,,,2,2,1,3
34704_0,,,,2,2,1,3
34704_1,,,,2,2,1,3
34705_0,,,,2,2,1,3
34705_1,,,,2,2,1,3
34706_0,,,,2,2,1,3
34706_1,,,,2,2,1,3
34707_0,,,,2,2,1,3
34708_0,,,,2,2,1,3
34709_0,,,,2,2,1,3
34710_0,,,,2,2,1,3
34711_0,,,,2,2,1,3
34713_0,,,,2,2,1,3
C(CO)(C(CO)(CO)C(C=C)O)=O,,,5,1,1,0,1
34714_0,,,,2,2,1,3
34715_0,,,,2,2,1,3
34716_0,,,,2,2,1,3
34717_0,,,,2,2,1,3
34718_0,,,,2,2,1,3
34719_0,,,,2,2,1,3
34719_1,,,,2,2,1,3
34720_0,,,,2,2,1,3
34720_1,,,,2,2,1,3
34721_0,,,,2,2,1,3
34721_1,,,,2,2,1,3
34722_0,,,,2,2,1,3
34722_1,,,,2,2,1,3
34723_0,,,,2,2,1,3
34723_1,,,,2,2,1,3
34724_0,,,,2,2,1,3
34724_1,,,,2,2,1,3
34725_0,,,,2,2,1,3
34726_0,,,,2,2,1,3
34726_1,,,,2,2,1,3
34727_0,,,,2,2,1,3
34727_1,,,,2,2,1,3
34729_0,,,,2,2,1,3
C(C(C=O)(C=O)C(C(O)=O)O)(O)=O,,,5,1,1,0,1
34730_0,,,,2,2,1,3
34731_0,,,,2,2,1,3
34732_0,,,,2,2,1,3
34734_0,,,,2,2,1,3
C(C(C=O)(C(C(O)=O)(C)O)O)(O)=O,,,5,1,4,0,4
34734_1,,,,2,2,1,3
34735_0,,,,2,2,1,3
34735_1,,,,2,2,1,3
34736_0,,,,2,2,1,3
34736_1,,,,2,2,1,3
34737_0,,,,2,2,1,3
34738_0,,,,2,2,1,3
34739_0,,,,2,2,1,3
34740_0,,,,2,2,1,3
34742_0,,,,2,2,1,3
C(C(C(CC=O)O)C(C=C)O)(O)=O,,,5,1,1,0,1
34743_0,,,,2,2,1,3
34744_0,,,,2,2,1,3
34745_0,,,,2,2,1,3
34746_0,,,,2,2,1,3
34748_0,,,,2,2,1,3
C(C(C=O)(C(CC(O)=O)O)O)(O)=O,,,5,1,4,0,4
34748_1,,,,2,2,1,3
34749_0,,,,2,2,1,3
34749_1,,,,2,2,1,3
34750_0,,,,2,2,1,3
34750_1,,,,2,2,1,3
34752_0,,,,2,2,1,3
C(C(C(O)=O)C(C(C=O)O)O)(O)=O,,,5,1,2,0,2
34753_0,,,,2,2,1,3
34754_0,,,,2,2,1,3
34756_0,,,,2,2,1,3
C(C(C(O)=O)(C=O)C(C=O)O)(O)=O,,,5,1,1,0,1
34757_0,,,,2,2,1,3
34758_0,,,,2,2,1,3
34759_0,,,,2,2,1,3
34760_0,,,,2,2,1,3
34761_0,,,,2,2,1,3
34763_0,,,,2,2,1,3
C(C(C(O)=O)(C=O)C(C)O)(O)=O,,,5,1,1,0,1
34765_0,,,,2,2,1,3
C(C(C=O)(C(C)O)C(C=C)O)(O)=O,,,5,1,1,0,1
34766_0,,,,2,2,1,3
34767_0,,,,2,2,1,3
34768_0,,,,2,2,1,3
34769_0,,,,2,2,1,3
34771_0,,,,2,2,1,3
C(C(C=O)(CO)C(C(C)O)O)(O)=O,,,5,1,1,0,1
34773_0,,,,2,2,1,3
C(C(C(O)=O)(C=O)CO)(O)=O,,,5,1,1,0,1
34775_0,,,,2,2,1,3
C(C(C=O)(CO)C(C=CC)O)(O)=O,,,5,1,1,0,1
34777_0,,,,2,2,1,3
C(C(C=O)(CO)C(CC=C)O)(O)=O,,,5,1,1,0,1
34779_0,,,,2,2,1,3
C(C(C=O)(CO)C(C=C)O)(O)=O,,,5,1,1,0,1
34780_0,,,,2,2,1,3
34781_0,,,,2,2,1,3
34782_0,,,,2,2,1,3
34783_0,,,,2,2,1,3
34784_0,,,,2,2,1,3
34785_0,,,,2,2,1,3
34786_0,,,,2,2,1,3
34787_0,,,,2,2,1,3
34788_0,,,,2,2,1,3
34789_0,,,,2,2,1,3
34791_0,,,,2,2,1,3
C(C(C(O)=O)(C=O)C(CO)O)(O)=O,,,5,1,1,0,1
34792_0,,,,2,2,1,3
34793_0,,,,2,2,1,3
34794_0,,,,2,2,1,3
34796_0,,,,2,2,1,3
C(C(C(C(O)=O)=O)(CO)CO)(O)=O,,,5,1,1,0,1
34797_0,,,,2,2,1,3
34798_0,,,,2,2,1,3
34799_0,,,,2,2,1,3
34800_0,,,,2,2,1,3
34801_0,,,,2,2,1,3
34803_0,,,,2,2,1,3
C(C(C(O)=O)(C(CO)=O)CO)(O)=O,,,5,1,1,0,1
34804_0,,,,2,2,1,3
34805_0,,,,2,2,1,3
34806_0,,,,2,2,1,3
34806_1,,,,2,2,1,3
34807_0,,,,2,2,1,3
34807_1,,,,2,2,1,3
34808_0,,,,2,2,1,3
34808_1,,,,2,2,1,3
34809_0,,,,2,2,1,3
34809_1,,,,2,2,1,3
34810_0,,,,2,2,1,3
34810_1,,,,2,2,1,3
34812_0,,,,2,2,1,3
C1(C(CO)(C(C=O)O)OCC1O)=O,,,5,1,4,0,4
34812_1,,,,2,2,1,3
34813_0,,,,2,2,1,3
34813_1,,,,2,2,1,3
34815_0,,,,2,2,1,3
C(C1(C(C(CO1)O)=O)C(C)O)(O)=O,,,5,1,2,0,2
34815_1,,,,2,2,1,3
34817_0,,,,2,2,1,3
C1(C(COC1(C(C)O)C(C)O)O)=O,,,5,1,2,0,2
34817_1,,,,2,2,1,3
34819_0,,,,2,2,1,3
C1(C(COC1(CO)C(C)O)O)=O,,,5,1,4,0,4
34819_1,,,,2,2,1,3
34821_0,,,,2,2,1,3
C(C1(C(C(C(C)O)OC1)=O)O)(O)=O,,,5,1,2,0,2
34821_1,,,,2,2,1,3
34822_0,,,,2,2,1,3
34822_1,,,,2,2,1,3
34823_0,,,,2,2,1,3
34823_1,,,,2,2,1,3
34825_0,,,,2,2,1,3
C(C1(C(C(CO1)O)=O)CO)(O)=O,,,5,1,2,0,2
34825_1,,,,2,2,1,3
34827_0,,,,2,2,1,3
C1(C(CO)(C(C=C)O)OCC1O)=O,,,5,1,2,0,2
34827_1,,,,2,2,1,3
34828_0,,,,2,2,1,3
34828_1,,,,2,2,1,3
34829_0,,,,2,2,1,3
34829_1,,,,2,2,1,3
34831_0,,,,2,2,1,3
C1(C(COC1(CO)CO)O)=O,,,5,1,2,0,2
34831_1,,,,2,2,1,3
34833_0,,,,2,2,1,3
C1(C(COC1(CO)C(CO)O)O)=O,,,5,1,4,0,4
34833_1,,,,2,2,1,3
34835_0,,,,2,2,1,3
C(C1(C(C(CO)OC1)=O)O)(O)=O,,,5,1,2,0,2
34835_1,,,,2,2,1,3
34837_0,,,,2,2,1,3
C1(C(COC1CO)(C(C=C)O)O)=O,,,5,1,2,0,2
34837_1,,,,2,2,1,3
34838_0,,,,2,2,1,3
34838_1,,,,2,2,1,3
34839_0,,,,2,2,1,3
34839_1,,,,2,2,1,3
34840_0,,,,2,2,1,3
34840_1,,,,2,2,1,3
34841_0,,,,2,2,1,3
34841_1,,,,2,2,1,3
34842_0,,,,2,2,1,3
34842_1,,,,2,2,1,3
34843_0,,,,2,2,1,3
34843_1,,,,2,2,1,3
34844_0,,,,2,2,1,3
34844_1,,,,2,2,1,3
34846_0,,,,2,2,1,3
C1(C(O)OCC1(CO)C(C=O)O)=O,,,5,1,3,0,3
34848_0,,,,2,2,1,3
C(C1(C(C(O)OC1)=O)C(C)O)(O)=O,,,5,1,1,0,1
34850_0,,,,2,2,1,3
C1(C(O)OCC1(C(C)O)C(C)O)=O,,,5,1,2,0,2
34852_0,,,,2,2,1,3
C1(C(O)OCC1(CO)C(C)O)=O,,,5,1,3,0,3
34854_0,,,,2,2,1,3
C(C1(C(C(O)OC1)=O)CO)(O)=O,,,5,1,1,0,1
34856_0,,,,2,2,1,3
C1(C(O)OCC1(CO)C(C=C)O)=O,,,5,1,1,0,1
34857_0,,,,2,2,1,3
34858_0,,,,2,2,1,3
34860_0,,,,2,2,1,3
C1(C(O)OCC1(CO)CO)=O,,,5,1,2,0,2
34862_0,,,,2,2,1,3
C1(C(O)OCC1(CO)C(CO)O)=O,,,5,1,3,0,3
34863_0,,,,2,2,1,3
34864_0,,,,2,2,1,3
34864_1,,,,2,2,1,3
34866_0,,,,2,2,1,3
C1(COC(C1(CO)C(C=O)O)O)=O,,,5,1,3,0,3
34868_0,,,,2,2,1,3
C(C1(C(COC1O)=O)C(C)O)(O)=O,,,5,1,1,0,1
34870_0,,,,2,2,1,3
C1(COC(C1(C(C)O)C(C)O)O)=O,,,5,1,2,0,2
34872_0,,,,2,2,1,3
C1(COC(C1(CO)C(C)O)O)=O,,,5,1,3,0,3
34874_0,,,,2,2,1,3
C(C1(C(COC1O)=O)CO)(O)=O,,,5,1,1,0,1
34876_0,,,,2,2,1,3
C1(COC(C1(CO)C(C=C)O)O)=O,,,5,1,1,0,1
34877_0,,,,2,2,1,3
34878_0,,,,2,2,1,3
34880_0,,,,2,2,1,3
C1(COC(C1(CO)CO)O)=O,,,5,1,2,0,2
34882_0,,,,2,2,1,3
C1(COC(C1(CO)C(CO)O)O)=O,,,5,1,3,0,3
34883_0,,,,2,2,1,3
34884_0,,,,2,2,1,3
34884_1,,,,2,2,1,3
34886_0,,,,2,2,1,3
C1(C(CO)(C(C=O)O)OC(C1)O)=O,,,5,1,5,0,5
34886_1,,,,2,2,1,3
34888_0,,,,2,2,1,3
C(C1(C(CC(O1)O)=O)C(C)O)(O)=O,,,5,1,2,0,2
34888_1,,,,2,2,1,3
34890_0,,,,2,2,1,3
C1(CC(OC1(C(C)O)C(C)O)O)=O,,,5,1,3,0,3
34890_1,,,,2,2,1,3
34892_0,,,,2,2,1,3
C1(CC(OC1(CO)C(C)O)O)=O,,,5,1,5,0,5
34892_1,,,,2,2,1,3
34894_0,,,,2,2,1,3
C(C1(C(CC(O1)O)=O)CO)(O)=O,,,5,1,2,0,2
34894_1,,,,2,2,1,3
34896_0,,,,2,2,1,3
C1(C(CO)(C(C=C)O)OC(C1)O)=O,,,5,1,2,0,2
34896_1,,,,2,2,1,3
34897_0,,,,2,2,1,3
34897_1,,,,2,2,1,3
34898_0,,,,2,2,1,3
34898_1,,,,2,2,1,3
34900_0,,,,2,2,1,3
C1(CC(OC1(CO)CO)O)=O,,,5,1,4,0,4
34900_1,,,,2,2,1,3
34902_0,,,,2,2,1,3
C1(CC(OC1(CO)C(CO)O)O)=O,,,5,1,5,0,5
34902_1,,,,2,2,1,3
34903_0,,,,2,2,1,3
34903_1,,,,2,2,1,3
34904_0,,,,2,2,1,3
34906_0,,,,2,2,1,3
C(C(C=O)(C(C=O)(C=C)O)O)(O)=O,,,5,1,4,0,4
34906_1,,,,2,2,1,3
34907_0,,,,2,2,1,3
34907_1,,,,2,2,1,3
34908_0,,,,2,2,1,3
34908_1,,,,2,2,1,3
34909_0,,,,2,2,1,3
34911_0,,,,2,2,1,3
C(C(C=O)(C(C(C=C)=O)O)O)(O)=O,,,5,1,4,0,4
34911_1,,,,2,2,1,3
34912_0,,,,2,2,1,3
34912_1,,,,2,2,1,3
34913_0,,,,2,2,1,3
34913_1,,,,2,2,1,3
34915_0,,,,2,2,1,3
C(C(C(C=C)=O)(C(C=O)O)O)(O)=O,,,5,1,4,0,4
34915_1,,,,2,2,1,3
34917_0,,,,2,2,1,3
C(C(C(C(C=C)=O)(C(C)O)O)O)=O,,,5,1,2,0,2
34917_1,,,,2,2,1,3
34919_0,,,,2,2,1,3
C(C(C(C(C=C)=O)(CO)O)O)=O,,,5,1,3,0,3
34919_1,,,,2,2,1,3
34920_0,,,,2,2,1,3
34922_0,,,,2,2,1,3
C(C(C=O)(C(C=CC=O)O)O)(O)=O,,,5,1,4,0,4
34922_1,,,,2,2,1,3
34923_0,,,,2,2,1,3
34923_1,,,,2,2,1,3
34924_0,,,,2,2,1,3
34924_1,,,,2,2,1,3
34926_0,,,,2,2,1,3
C(C(C(C(CO)=O)=O)(CO)O)(O)=O,,,5,1,2,0,2
34926_1,,,,2,2,1,3
34928_0,,,,2,2,1,3
C(C(CO)=O)(C(CO)(C(C)O)O)=O,,,5,1,2,0,2
34928_1,,,,2,2,1,3
34929_0,,,,2,2,1,3
34929_1,,,,2,2,1,3
34931_0,,,,2,2,1,3
C(C(C=O)(C(C=O)(CC=O)O)O)=O,,,5,1,2,0,2
34931_1,,,,2,2,1,3
34932_0,,,,2,2,1,3
34934_0,,,,2,2,1,3
C(C(C=O)(C=C)C(C=O)(CC=O)O)=O,,,5,1,1,0,1
34935_0,,,,2,2,1,3
34935_1,,,,2,2,1,3
34937_0,,,,2,2,1,3
C(C(C=O)(C(C(CC=O)=O)O)O)=O,,,5,1,2,0,2
34937_1,,,,2,2,1,3
34938_0,,,,2,2,1,3
34940_0,,,,2,2,1,3
C(C(C=O)(C=C)C(C(CC=O)=O)O)=O,,,5,1,1,0,1
34941_0,,,,2,2,1,3
34941_1,,,,2,2,1,3
34943_0,,,,2,2,1,3
C(C(C=O)(C(CC(C=O)=O)O)O)=O,,,5,1,2,0,2
34943_1,,,,2,2,1,3
34944_0,,,,2,2,1,3
34946_0,,,,2,2,1,3
C(C(C=O)(C=C)C(CC(C=O)=O)O)=O,,,5,1,1,0,1
34947_0,,,,2,2,1,3
34947_1,,,,2,2,1,3
34949_0,,,,2,2,1,3
C(C(C=O)(C(C=O)(C(C)=O)O)O)=O,,,5,1,2,0,2
34949_1,,,,2,2,1,3
34950_0,,,,2,2,1,3
34952_0,,,,2,2,1,3
C(C(C=O)(C=C)C(C=O)(C(C)=O)O)=O,,,5,1,1,0,1
34953_0,,,,2,2,1,3
34953_1,,,,2,2,1,3
34955_0,,,,2,2,1,3
C(C(C=O)(C(C(C(C)=O)=O)O)O)=O,,,5,1,2,0,2
34955_1,,,,2,2,1,3
34957_0,,,,2,2,1,3
C(C(CO)C(C(C(C)=O)=O)O)(O)=O,,,5,1,1,0,1
34959_0,,,,2,2,1,3
C(C(C=O)(C=C)C(C(C(C)=O)=O)O)=O,,,5,1,1,0,1
34960_0,,,,2,2,1,3
34960_1,,,,2,2,1,3
34962_0,,,,2,2,1,3
C(C(C=O)(C(C(C=O)=O)(C)O)O)=O,,,5,1,2,0,2
34962_1,,,,2,2,1,3
34964_0,,,,2,2,1,3
C(C(CO)C(C(C=O)=O)(C)O)(O)=O,,,5,1,1,0,1
34966_0,,,,2,2,1,3
C(C(C=O)(C=C)C(C(C=O)=O)(C)O)=O,,,5,1,1,0,1
34967_0,,,,2,2,1,3
34967_1,,,,2,2,1,3
34969_0,,,,2,2,1,3
C(C(C=O)(C(C(CO)=O)=O)O)(O)=O,,,5,1,2,0,2
34969_1,,,,2,2,1,3
34971_0,,,,2,2,1,3
C(C(C(C(CO)=O)=O)(C(C)O)O)=O,,,5,1,2,0,2
34971_1,,,,2,2,1,3
34972_0,,,,2,2,1,3
34972_1,,,,2,2,1,3
34974_0,,,,2,2,1,3
C(C)(C(C(C(CO)=O)=O)(CO)O)=O,,,5,1,2,0,2
34974_1,,,,2,2,1,3
34976_0,,,,2,2,1,3
C(C(C(C)O)=O)(C(CO)(CO)O)=O,,,5,1,2,0,2
34976_1,,,,2,2,1,3
34978_0,,,,2,2,1,3
C(C(C(C=O)=O)(C(C(C)O)O)O)=O,,,5,1,2,0,2
34978_1,,,,2,2,1,3
34980_0,,,,2,2,1,3
C(C(C=O)(C(C=O)=O)O)(O)=O,,,5,1,2,0,2
34980_1,,,,2,2,1,3
34982_0,,,,2,2,1,3
C(C(C(C=O)=O)(C(C=CC)O)O)=O,,,5,1,2,0,2
34982_1,,,,2,2,1,3
34984_0,,,,2,2,1,3
C(C(C(C=O)=O)(C(CC=C)O)O)=O,,,5,1,2,0,2
34984_1,,,,2,2,1,3
34986_0,,,,2,2,1,3
C(C(C(C=O)=O)(C(C=C)O)O)=O,,,5,1,2,0,2
34986_1,,,,2,2,1,3
34987_0,,,,2,2,1,3
34987_1,,,,2,2,1,3
34989_0,,,,2,2,1,3
C(C(C(C=O)=O)(C(C=O)(C)O)O)=O,,,5,1,2,0,2
34989_1,,,,2,2,1,3
34991_0,,,,2,2,1,3
C(C(C(C=O)=O)(C(C(C)=O)O)O)=O,,,5,1,2,0,2
34991_1,,,,2,2,1,3
34993_0,,,,2,2,1,3
C(C(C(C=O)=O)(C(CC=O)O)O)=O,,,5,1,2,0,2
34993_1,,,,2,2,1,3
34994_0,,,,2,2,1,3
34994_1,,,,2,2,1,3
34996_0,,,,2,2,1,3
C(C(C(C=O)=O)(C(CCO)O)O)=O,,,5,1,2,0,2
34996_1,,,,2,2,1,3
34998_0,,,,2,2,1,3
C(C(C(C=O)=O)(C(CO)(C)O)O)=O,,,5,1,2,0,2
34998_1,,,,2,2,1,3
35000_0,,,,2,2,1,3
C(C(C(C=O)=O)(C(C(O)=O)O)O)=O,,,5,1,2,0,2
35000_1,,,,2,2,1,3
35001_0,,,,2,2,1,3
35001_1,,,,2,2,1,3
35002_0,,,,2,2,1,3
35002_1,,,,2,2,1,3
35003_0,,,,2,2,1,3
35003_1,,,,2,2,1,3
35005_0,,,,2,2,1,3
C(C)(C(C(C=O)=O)(C(C=C)O)O)=O,,,5,1,2,0,2
35005_1,,,,2,2,1,3
35007_0,,,,2,2,1,3
C(C(C(C(C)=O)(C(C=O)=O)O)O)=O,,,5,1,2,0,2
35007_1,,,,2,2,1,3
35008_0,,,,2,2,1,3
35008_1,,,,2,2,1,3
35009_0,,,,2,2,1,3
35009_1,,,,2,2,1,3
35011_0,,,,2,2,1,3
C(C)(C(C(C=O)=O)(C(CO)O)O)=O,,,5,1,2,0,2
35011_1,,,,2,2,1,3
35013_0,,,,2,2,1,3
C(CCO)(C(C(C=O)=O)(CO)O)=O,,,5,1,2,0,2
35013_1,,,,2,2,1,3
35014_0,,,,2,2,1,3
35014_1,,,,2,2,1,3
35016_0,,,,2,2,1,3
C(C(CO)(CO)O)(CC(C=O)=O)=O,,,5,1,2,0,2
35016_1,,,,2,2,1,3
35018_0,,,,2,2,1,3
C(C(C(CO)=O)(C(C(C)O)O)O)=O,,,5,1,3,0,3
35018_1,,,,2,2,1,3
35020_0,,,,2,2,1,3
C(C(C=O)(C=O)C(C(C)O)O)=O,,,5,1,1,0,1
35022_0,,,,2,2,1,3
C(C(C=O)(C(C(C)O)O)O)=O,,,5,1,3,0,3
35022_1,,,,2,2,1,3
35024_0,,,,2,2,1,3
C(C(C=O)(C(C)=O)C(C(C)O)O)=O,,,5,1,1,0,1
35026_0,,,,2,2,1,3
C(C(C=O)(C(C(C)O)O)O)(O)=O,,,5,1,4,0,4
35026_1,,,,2,2,1,3
35028_0,,,,2,2,1,3
C(C(CO)C(C(C)O)O)(O)=O,,,5,1,1,0,1
35030_0,,,,2,2,1,3
C(C(C(CO)O)C(C(C)O)O)(O)=O,,,5,1,1,0,1
35032_0,,,,2,2,1,3
C(C(C(C)O)C(C(C)O)O)(O)=O,,,5,1,1,0,1
35034_0,,,,2,2,1,3
C(C(C(O)=O)C(C(C)O)O)(O)=O,,,5,1,1,0,1
35036_0,,,,2,2,1,3
C(C(CO)(C(C(C)O)O)CC=O)=O,,,5,1,1,0,1
35038_0,,,,2,2,1,3
C(C(C(C=O)=O)(C)C(C(C)O)O)=O,,,5,1,1,0,1
35040_0,,,,2,2,1,3
C(C(C=O)(C(C(C)O)O)CC=O)=O,,,5,1,1,0,1
35042_0,,,,2,2,1,3
C(C(C(C)=O)(CO)C(C(C)O)O)=O,,,5,1,1,0,1
35044_0,,,,2,2,1,3
C(C(C=O)(C=C)C(C(C)O)O)=O,,,5,1,1,0,1
35046_0,,,,2,2,1,3
C(C(C(C=C)=O)(C(C(C)O)O)O)=O,,,5,1,2,0,2
35046_1,,,,2,2,1,3
35048_0,,,,2,2,1,3
C1(C(O)OCC1(C(C(C)O)O)O)=O,,,5,1,2,0,2
35048_1,,,,2,2,1,3
35050_0,,,,2,2,1,3
C1(C(C(C(O)O1)O)C(C(C)O)O)=O,,,5,1,1,0,1
35052_0,,,,2,2,1,3
C(C(CO)(C(C(C)O)O)O)=O,,,5,1,4,0,4
35052_1,,,,2,2,1,3
35054_0,,,,2,2,1,3
C(C(C(CO)O)(C(C(C)O)O)O)=O,,,5,1,4,0,4
35054_1,,,,2,2,1,3
35055_0,,,,2,2,1,3
35055_1,,,,2,2,1,3
35057_0,,,,2,2,1,3
C(C(CO)(C(C(C)O)O)O)(O)=O,,,5,1,2,0,2
35057_1,,,,2,2,1,3
35059_0,,,,2,2,1,3
C(C(C(C)=O)(C(C(C)O)O)O)=O,,,5,1,2,0,2
35059_1,,,,2,2,1,3
35060_0,,,,2,2,1,3
35060_1,,,,2,2,1,3
35062_0,,,,2,2,1,3
C(C(C=O)(C(C)O)C(C(C)O)O)=O,,,5,1,1,0,1
35064_0,,,,2,2,1,3
C(C(C=O)(CO)C(C(C)O)O)=O,,,5,1,1,0,1
35066_0,,,,2,2,1,3
C(C(C(C)O)(C(C(C)O)O)O)=O,,,5,1,4,0,4
35066_1,,,,2,2,1,3
35068_0,,,,2,2,1,3
C(C(C(CO)(C(C(C)O)O)O)=O)=O,,,5,1,3,0,3
35068_1,,,,2,2,1,3
35070_0,,,,2,2,1,3
C(C)(C(CO)(C(C(C)O)O)O)=O,,,5,1,2,0,2
35070_1,,,,2,2,1,3
35072_0,,,,2,2,1,3
C(C(C(C(C)O)O)C(C=O)O)(O)=O,,,5,1,1,0,1
35074_0,,,,2,2,1,3
C(C(C(C)=O)(C(C(C)O)O)O)(O)=O,,,5,1,2,0,2
35074_1,,,,2,2,1,3
35076_0,,,,2,2,1,3
C(C(C(C)O)(C(C(C)O)O)O)(O)=O,,,5,1,2,0,2
35076_1,,,,2,2,1,3
35078_0,,,,2,2,1,3
C1(COCC1(C(C(C)O)O)O)=O,,,5,1,2,0,2
35078_1,,,,2,2,1,3
35080_0,,,,2,2,1,3
C1(C(C(CO1)O)C(C(C)O)O)=O,,,5,1,1,0,1
35082_0,,,,2,2,1,3
C1(C(C(CO1)O)(C(C(C)O)O)O)=O,,,5,1,2,0,2
35082_1,,,,2,2,1,3
35084_0,,,,2,2,1,3
C(C(C=O)(C(CO)=O)O)(O)=O,,,5,1,2,0,2
35084_1,,,,2,2,1,3
35086_0,,,,2,2,1,3
C(C(C(CO)=O)(C(C=CC)O)O)=O,,,5,1,2,0,2
35086_1,,,,2,2,1,3
35088_0,,,,2,2,1,3
C(C(C(CO)=O)(C(CC=C)O)O)=O,,,5,1,2,0,2
35088_1,,,,2,2,1,3
35090_0,,,,2,2,1,3
C(C(C(CO)=O)(C(C=C)O)O)=O,,,5,1,2,0,2
35090_1,,,,2,2,1,3
35091_0,,,,2,2,1,3
35091_1,,,,2,2,1,3
35092_0,,,,2,2,1,3
35092_1,,,,2,2,1,3
35093_0,,,,2,2,1,3
35093_1,,,,2,2,1,3
35094_0,,,,2,2,1,3
35094_1,,,,2,2,1,3
35095_0,,,,2,2,1,3
35095_1,,,,2,2,1,3
35096_0,,,,2,2,1,3
35096_1,,,,2,2,1,3
35097_0,,,,2,2,1,3
35097_1,,,,2,2,1,3
35098_0,,,,2,2,1,3
35098_1,,,,2,2,1,3
35099_0,,,,2,2,1,3
35099_1,,,,2,2,1,3
35100_0,,,,2,2,1,3
35100_1,,,,2,2,1,3
35102_0,,,,2,2,1,3
C(C(C(CO)=O)(C(CO)=O)O)(O)=O,,,5,1,2,0,2
35102_1,,,,2,2,1,3
35103_0,,,,2,2,1,3
35103_1,,,,2,2,1,3
35104_0,,,,2,2,1,3
35104_1,,,,2,2,1,3
35105_0,,,,2,2,1,3
35105_1,,,,2,2,1,3
35107_0,,,,2,2,1,3
C(CO)(C(C(C)=O)(C(C=C)O)O)=O,,,5,1,2,0,2
35107_1,,,,2,2,1,3
35108_0,,,,2,2,1,3
35108_1,,,,2,2,1,3
35109_0,,,,2,2,1,3
35109_1,,,,2,2,1,3
35110_0,,,,2,2,1,3
35110_1,,,,2,2,1,3
35111_0,,,,2,2,1,3
35111_1,,,,2,2,1,3
35113_0,,,,2,2,1,3
C(C(C=O)(C(C(CO)O)=O)O)(O)=O,,,5,1,2,0,2
35113_1,,,,2,2,1,3
35114_0,,,,2,2,1,3
35114_1,,,,2,2,1,3
35115_0,,,,2,2,1,3
35115_1,,,,2,2,1,3
35117_0,,,,2,2,1,3
C(C(C(C(C=O)O)=O)(CO)O)(O)=O,,,5,1,2,0,2
35117_1,,,,2,2,1,3
35119_0,,,,2,2,1,3
C(C(C(C(CO)(C(C)O)O)=O)O)=O,,,5,1,2,0,2
35119_1,,,,2,2,1,3
35120_0,,,,2,2,1,3
35120_1,,,,2,2,1,3
35122_0,,,,2,2,1,3
C(C(C=O)(C=O)C(C(C=O)O)O)=O,,,5,1,1,0,1
35124_0,,,,2,2,1,3
C(C(C=O)(C=O)C(CC(C)=O)O)=O,,,5,1,1,0,1
35126_0,,,,2,2,1,3
C(C(C=O)(C=O)C(C)(CC=O)O)=O,,,5,1,1,0,1
35128_0,,,,2,2,1,3
C(C(C=O)(C=O)C(O)=O)=O,,,5,1,1,0,1
35130_0,,,,2,2,1,3
C(C(C=O)(C=O)C(C=C)(CO)O)=O,,,5,1,1,0,1
35132_0,,,,2,2,1,3
C(C(C=O)(C=O)C(C=CCO)O)=O,,,5,1,1,0,1
35134_0,,,,2,2,1,3
C(C(C=O)(C=O)C(C=O)(CC)O)=O,,,5,1,1,0,1
35136_0,,,,2,2,1,3
C(C(C=O)(C=O)C(C(CC)=O)O)=O,,,5,1,1,0,1
35138_0,,,,2,2,1,3
C(C(C=O)(C=O)C(CCC=O)O)=O,,,5,1,1,0,1
35140_0,,,,2,2,1,3
C(C(C=O)(C=O)C(C(C)=O)(C)O)=O,,,5,1,1,0,1
35142_0,,,,2,2,1,3
C(C(C=O)(C=O)C(C=C(C=O)C)O)=O,,,5,1,1,0,1
35144_0,,,,2,2,1,3
C(C(C=O)(C=O)C(C(C)=CC=O)O)=O,,,5,1,1,0,1
35146_0,,,,2,2,1,3
C(C(C=O)(C=O)C(CC(C=O)=C)O)=O,,,5,1,1,0,1
35148_0,,,,2,2,1,3
C(C(C=O)(C=O)C(C(CC=O)=C)O)=O,,,5,1,1,0,1
35150_0,,,,2,2,1,3
C(C(C=O)(C=O)C(C=CC(C)=O)O)=O,,,5,1,1,0,1
35152_0,,,,2,2,1,3
C(C(C=O)(C=O)C(C=CC=O)(C)O)=O,,,5,1,1,0,1
35154_0,,,,2,2,1,3
C(C(C=O)(C=O)C(C=O)(CC=C)O)=O,,,5,1,1,0,1
35156_0,,,,2,2,1,3
C(C(C=O)(C=O)C(C(CC=C)=O)O)=O,,,5,1,1,0,1
35158_0,,,,2,2,1,3
C(C(C=O)(C=O)C(C=O)(C=CC)O)=O,,,5,1,1,0,1
35160_0,,,,2,2,1,3
C(C(C=O)(C=O)C(C(C=CC)=O)O)=O,,,5,1,1,0,1
35162_0,,,,2,2,1,3
C(C(C=O)(C=O)C(C=CCC=O)O)=O,,,5,1,1,0,1
35164_0,,,,2,2,1,3
C(C(C=O)(C=O)C(CC=CC=O)O)=O,,,5,1,1,0,1
35166_0,,,,2,2,1,3
C(C(C=O)(C=O)C(C(C=O)C=C)O)=O,,,5,1,1,0,1
35168_0,,,,2,2,1,3
C(C(C=O)(C=O)C(C(C=O)=CC)O)=O,,,5,1,1,0,1
35170_0,,,,2,2,1,3
C(C(C=O)(C=O)C(C(C=O)=C)O)=O,,,5,1,1,0,1
35172_0,,,,2,2,1,3
C(C(C=O)(C=O)C(C=CC)O)=O,,,5,1,1,0,1
35174_0,,,,2,2,1,3
C(C(C=O)(C=O)C(CC=C)O)=O,,,5,1,1,0,1
35176_0,,,,2,2,1,3
C(C(C=O)(C=O)C(C(C=C)O)O)=O,,,5,1,1,0,1
35178_0,,,,2,2,1,3
C(C(C=O)(C=O)C(C=C)O)=O,,,5,1,1,0,1
35180_0,,,,2,2,1,3
C(C(C=O)(C=O)C1(C=COC1)O)=O,,,5,1,1,0,1
35182_0,,,,2,2,1,3
C(C(C=O)(C=O)C(C(CO)O)O)=O,,,5,1,1,0,1
35184_0,,,,2,2,1,3
C(C(C=O)(C=O)C(C=O)O)=O,,,5,1,1,0,1
35186_0,,,,2,2,1,3
C(C(C=O)(C=O)C(CO)(CO)O)=O,,,5,1,1,0,1
35188_0,,,,2,2,1,3
C(C(C=O)(C=O)C(C=O)(C)O)=O,,,5,1,1,0,1
35190_0,,,,2,2,1,3
C(C(C=O)(C=O)C(C(C)=O)O)=O,,,5,1,1,0,1
35192_0,,,,2,2,1,3
C(C(C=O)(C=O)C(CC=O)O)=O,,,5,1,1,0,1
35193_0,,,,2,2,1,3
35195_0,,,,2,2,1,3
C(C(C=O)(C=O)C(CC(C)O)O)=O,,,5,1,1,0,1
35197_0,,,,2,2,1,3
C(C(C=O)(C=O)C(CCO)O)=O,,,5,1,1,0,1
35199_0,,,,2,2,1,3
C(C(C=O)(C=O)C(C=O)(CO)O)=O,,,5,1,1,0,1
35201_0,,,,2,2,1,3
C(C(C=O)(C=O)C(C(CO)=O)O)=O,,,5,1,1,0,1
35203_0,,,,2,2,1,3
C(C(C=O)(C=O)C(C)(CO)O)=O,,,5,1,1,0,1
35205_0,,,,2,2,1,3
C(C(C=O)(C=O)C(C(O)=O)O)=O,,,5,1,1,0,1
35207_0,,,,2,2,1,3
C(C(C=O)(C=O)C(C(O)=O)(C)O)=O,,,5,1,1,0,1
35209_0,,,,2,2,1,3
C(C(C=O)(C=O)C(CC(O)=O)O)=O,,,5,1,1,0,1
35211_0,,,,2,2,1,3
C(C(C=O)(C=O)C(C=O)(C=C)O)=O,,,5,1,1,0,1
35213_0,,,,2,2,1,3
C(C(C=O)(C=O)C(C(C=C)=O)O)=O,,,5,1,1,0,1
35215_0,,,,2,2,1,3
C(C(C=O)(C=O)C(C=CC=O)O)=O,,,5,1,1,0,1
35216_0,,,,2,2,1,3
35218_0,,,,2,2,1,3
C(C(C=O)(C=O)C(CO)O)=O,,,5,1,1,0,1
35220_0,,,,2,2,1,3
C(C(C=O)C(C(C=O)(C=O)O)O)=O,,,5,1,2,0,2
35220_1,,,,2,2,1,3
35221_0,,,,2,2,1,3
35223_0,,,,2,2,1,3
C(C(C=O)(C=C)C(C(C=O)C=O)O)=O,,,5,1,1,0,1
35224_0,,,,2,2,1,3
35224_1,,,,2,2,1,3
35226_0,,,,2,2,1,3
C(C(C=O)(C(C=O)=O)CO)(O)=O,,,5,1,1,0,1
35228_0,,,,2,2,1,3
C(C(C(C=O)=O)(CO)C(C=C)O)=O,,,5,1,1,0,1
35230_0,,,,2,2,1,3
C(C(C(C=O)=O)(CO)C(C=O)O)=O,,,5,1,1,0,1
35232_0,,,,2,2,1,3
C(C(C(C=O)=O)(CO)C(C)O)=O,,,5,1,1,0,1
35234_0,,,,2,2,1,3
C(C(C(C=O)=O)(CO)CO)=O,,,5,1,1,0,1
35236_0,,,,2,2,1,3
C(C(C(C=O)=O)(CO)C(CO)O)=O,,,5,1,2,0,2
35238_0,,,,2,2,1,3
C(C(C=O)(C=O)C(CO)=O)(O)=O,,,5,1,1,0,1
35240_0,,,,2,2,1,3
C(C(C=O)(C(CO)=O)C(C=C)O)=O,,,5,1,1,0,1
35241_0,,,,2,2,1,3
35242_0,,,,2,2,1,3
35243_0,,,,2,2,1,3
35244_0,,,,2,2,1,3
35246_0,,,,2,2,1,3
C(C(C=O)(C(CC=O)=O)O)(O)=O,,,5,1,2,0,2
35246_1,,,,2,2,1,3
35248_0,,,,2,2,1,3
C(C(C(CC=O)=O)(C(C=C)O)O)=O,,,5,1,2,0,2
35248_1,,,,2,2,1,3
35250_0,,,,2,2,1,3
C(C(C(CC=O)=O)(C(C=O)O)O)=O,,,5,1,2,0,2
35250_1,,,,2,2,1,3
35252_0,,,,2,2,1,3
C(C(C(CC=O)=O)(C(C)O)O)=O,,,5,1,3,0,3
35252_1,,,,2,2,1,3
35254_0,,,,2,2,1,3
C(C(C(CC=O)=O)(CO)O)=O,,,5,1,2,0,2
35254_1,,,,2,2,1,3
35256_0,,,,2,2,1,3
C(C(C(CC=O)=O)(C(CO)O)O)=O,,,5,1,2,0,2
35256_1,,,,2,2,1,3
35258_0,,,,2,2,1,3
C(C(C=O)(C(C(C=O)O)O)O)=O,,,5,1,2,0,2
35258_1,,,,2,2,1,3
35260_0,,,,2,2,1,3
C(C(C=O)(C(CC(C)=O)O)O)=O,,,5,1,3,0,3
35260_1,,,,2,2,1,3
35261_0,,,,2,2,1,3
35261_1,,,,2,2,1,3
35263_0,,,,2,2,1,3
C(C(C=O)(C=O)O)(O)=O,,,5,1,2,0,2
35263_1,,,,2,2,1,3
35265_0,,,,2,2,1,3
C(C(C=O)(C(C(O)=O)(CO)O)O)=O,,,5,1,2,0,2
35265_1,,,,2,2,1,3
35267_0,,,,2,2,1,3
C(C(C=O)(C(C(C(O)=O)O)O)O)=O,,,5,1,2,0,2
35267_1,,,,2,2,1,3
35269_0,,,,2,2,1,3
C(OCC(C)(C(C=O)(C=O)O)O)=O,,,5,1,2,0,2
35269_1,,,,2,2,1,3
35271_0,,,,2,2,1,3
C(C(C=O)(C(CO)(C(C)O)O)O)=O,,,5,1,2,0,2
35271_1,,,,2,2,1,3
35273_0,,,,2,2,1,3
C(C(C=O)(C(C=C)(CO)O)O)=O,,,5,1,2,0,2
35273_1,,,,2,2,1,3
35275_0,,,,2,2,1,3
C(C(C=O)(C(C=CCO)O)O)=O,,,5,1,2,0,2
35275_1,,,,2,2,1,3
35277_0,,,,2,2,1,3
C(C(C=C)(C(C=O)(C=O)O)O)(O)=O,,,5,1,2,0,2
35277_1,,,,2,2,1,3
35279_0,,,,2,2,1,3
C(C(C=O)(C(C=CC(O)=O)O)O)=O,,,5,1,2,0,2
35279_1,,,,2,2,1,3
35281_0,,,,2,2,1,3
C(C(C=O)(C(C=O)(CC)O)O)=O,,,5,1,2,0,2
35281_1,,,,2,2,1,3
35283_0,,,,2,2,1,3
C(C(C=O)(C(C(CC)=O)O)O)=O,,,5,1,2,0,2
35283_1,,,,2,2,1,3
35285_0,,,,2,2,1,3
C(C(C=O)(C(CCC=O)O)O)=O,,,5,1,4,0,4
35285_1,,,,2,2,1,3
35287_0,,,,2,2,1,3
C(C(C=O)(C(C(C)=O)(C)O)O)=O,,,5,1,2,0,2
35287_1,,,,2,2,1,3
35289_0,,,,2,2,1,3
C(C(C=O)(C(C(O)=O)(CC)O)O)=O,,,5,1,2,0,2
35289_1,,,,2,2,1,3
35291_0,,,,2,2,1,3
C(C(C=O)(C(C)(CC(O)=O)O)O)=O,,,5,1,2,0,2
35291_1,,,,2,2,1,3
35293_0,,,,2,2,1,3
C(C(C=O)(C1(C(OCC1)=O)O)O)=O,,,5,1,2,0,2
35293_1,,,,2,2,1,3
35295_0,,,,2,2,1,3
C(C(C=O)(C1(COC(C1)=O)O)O)=O,,,5,1,2,0,2
35295_1,,,,2,2,1,3
35297_0,,,,2,2,1,3
C(C(C=O)(C(C=C(C=O)C)O)O)=O,,,5,1,2,0,2
35297_1,,,,2,2,1,3
35299_0,,,,2,2,1,3
C(C(C=O)(C(C(C)=CC=O)O)O)=O,,,5,1,2,0,2
35299_1,,,,2,2,1,3
35301_0,,,,2,2,1,3
C(C(C=O)(C(CC(C=O)=C)O)O)=O,,,5,1,2,0,2
35301_1,,,,2,2,1,3
35303_0,,,,2,2,1,3
C(C(C=O)(C(C(CC=O)=C)O)O)=O,,,5,1,2,0,2
35303_1,,,,2,2,1,3
35305_0,,,,2,2,1,3
C(C(C=O)(C(C=CC(C)=O)O)O)=O,,,5,1,2,0,2
35305_1,,,,2,2,1,3
35307_0,,,,2,2,1,3
C(C(C=O)(C(C=CC=O)(C)O)O)=O,,,5,1,2,0,2
35307_1,,,,2,2,1,3
35309_0,,,,2,2,1,3
C(C(C=O)(C(C=O)(CC=C)O)O)=O,,,5,1,2,0,2
35309_1,,,,2,2,1,3
35311_0,,,,2,2,1,3
C(C(C=O)(C(C(CC=C)=O)O)O)=O,,,5,1,2,0,2
35311_1,,,,2,2,1,3
35313_0,,,,2,2,1,3
C(C(C=CC)(C(C=O)(C=O)O)O)=O,,,5,1,2,0,2
35313_1,,,,2,2,1,3
35315_0,,,,2,2,1,3
C(C(C=O)(C(C(C=CC)=O)O)O)=O,,,5,1,2,0,2
35315_1,,,,2,2,1,3
35317_0,,,,2,2,1,3
C(C(C=O)(C(C=CCC=O)O)O)=O,,,5,1,2,0,2
35317_1,,,,2,2,1,3
35319_0,,,,2,2,1,3
C(C(C=O)(C(CC=CC=O)O)O)=O,,,5,1,2,0,2
35319_1,,,,2,2,1,3
35321_0,,,,2,2,1,3
C(C(C=C)C(C(C=O)(C=O)O)O)=O,,,5,1,2,0,2
35321_1,,,,2,2,1,3
35323_0,,,,2,2,1,3
C(C(C=O)(C(C(C=O)=CC)O)O)=O,,,5,1,2,0,2
35323_1,,,,2,2,1,3
35325_0,,,,2,2,1,3
C(C(C=O)(C(C(C=O)=C)O)O)=O,,,5,1,2,0,2
35325_1,,,,2,2,1,3
35327_0,,,,2,2,1,3
C(C(C=O)(C(C=CC)O)O)=O,,,5,1,2,0,2
35327_1,,,,2,2,1,3
35329_0,,,,2,2,1,3
C(C(C=O)(C(CC=C)O)O)=O,,,5,1,2,0,2
35329_1,,,,2,2,1,3
35331_0,,,,2,2,1,3
C(C(C=O)(C(C(C=C)O)O)O)=O,,,5,1,2,0,2
35331_1,,,,2,2,1,3
35333_0,,,,2,2,1,3
C(C(C=O)(C(C=C)O)O)=O,,,5,1,2,0,2
35333_1,,,,2,2,1,3
35335_0,,,,2,2,1,3
C(C(C=O)(C1(C=COC1)O)O)=O,,,5,1,2,0,2
35335_1,,,,2,2,1,3
35337_0,,,,2,2,1,3
C(C(C=O)(C(C(CO)O)O)O)=O,,,5,1,2,0,2
35337_1,,,,2,2,1,3
35338_0,,,,2,2,1,3
35338_1,,,,2,2,1,3
35340_0,,,,2,2,1,3
C(C(C=O)(C(CO)(CO)O)O)=O,,,5,1,2,0,2
35340_1,,,,2,2,1,3
35342_0,,,,2,2,1,3
C(C(C=O)(C(C=O)(C)O)O)=O,,,5,1,2,0,2
35342_1,,,,2,2,1,3
35343_0,,,,2,2,1,3
35343_1,,,,2,2,1,3
35345_0,,,,2,2,1,3
C(C(C=O)(C(CC=O)O)O)=O,,,5,1,2,0,2
35345_1,,,,2,2,1,3
35347_0,,,,2,2,1,3
C(C(C=O)(C(C=O)(CCO)O)O)=O,,,5,1,2,0,2
35347_1,,,,2,2,1,3
35349_0,,,,2,2,1,3
C(C(C=O)(C(C(CCO)=O)O)O)=O,,,5,1,2,0,2
35349_1,,,,2,2,1,3
35351_0,,,,2,2,1,3
C(C(C=O)(C(C(CC=O)O)O)O)=O,,,5,1,2,0,2
35351_1,,,,2,2,1,3
35353_0,,,,2,2,1,3
C(C(C=O)(C(CC(C=O)O)O)O)=O,,,5,1,2,0,2
35353_1,,,,2,2,1,3
35355_0,,,,2,2,1,3
C(C(C=O)(C(CC(CO)=O)O)O)=O,,,5,1,2,0,2
35355_1,,,,2,2,1,3
35357_0,,,,2,2,1,3
C(C(C=O)(C(CO)(CC=O)O)O)=O,,,5,1,2,0,2
35357_1,,,,2,2,1,3
35359_0,,,,2,2,1,3
C(C(C=O)(C(C(C(C)=O)O)O)O)=O,,,5,1,2,0,2
35359_1,,,,2,2,1,3
35360_0,,,,2,2,1,3
35360_1,,,,2,2,1,3
35361_0,,,,2,2,1,3
35361_1,,,,2,2,1,3
35363_0,,,,2,2,1,3
C(C(C=O)(C(C(C=O)CO)O)O)=O,,,5,1,2,0,2
35363_1,,,,2,2,1,3
35365_0,,,,2,2,1,3
C(C(C=O)(C(CC(C)O)O)O)=O,,,5,1,2,0,2
35365_1,,,,2,2,1,3
35367_0,,,,2,2,1,3
C(C(C=O)(C(C(C(C)O)O)O)O)=O,,,5,1,2,0,2
35367_1,,,,2,2,1,3
35369_0,,,,2,2,1,3
C(C(C=O)(C(CCO)O)O)=O,,,5,1,3,0,3
35369_1,,,,2,2,1,3
35371_0,,,,2,2,1,3
C(C(C=O)(C(CC(CO)O)O)O)=O,,,5,1,3,0,3
35371_1,,,,2,2,1,3
35373_0,,,,2,2,1,3
C(C(C=O)(C(C=O)(CO)O)O)=O,,,5,1,2,0,2
35373_1,,,,2,2,1,3
35375_0,,,,2,2,1,3
C(C(C=O)(C(C(CO)=O)O)O)=O,,,5,1,2,0,2
35375_1,,,,2,2,1,3
35377_0,,,,2,2,1,3
C(C(C=O)(C(C(C)=O)(CO)O)O)=O,,,5,1,2,0,2
35377_1,,,,2,2,1,3
35379_0,,,,2,2,1,3
C(C(C=O)(C(C(CO)=O)(C)O)O)=O,,,5,1,2,0,2
35379_1,,,,2,2,1,3
35381_0,,,,2,2,1,3
C(C(C=O)(C(C=O)(C(C)O)O)O)=O,,,5,1,2,0,2
35381_1,,,,2,2,1,3
35383_0,,,,2,2,1,3
C(C(C=O)(C(C(C(C)O)=O)O)O)=O,,,5,1,2,0,2
35383_1,,,,2,2,1,3
35385_0,,,,2,2,1,3
C(C(C=O)(C(CO)(C)O)O)=O,,,5,1,2,0,2
35385_1,,,,2,2,1,3
35387_0,,,,2,2,1,3
C(C(C=O)(C(CO)(CCO)O)O)=O,,,5,1,2,0,2
35387_1,,,,2,2,1,3
35389_0,,,,2,2,1,3
C(C(C=O)(C(C(CCO)O)O)O)=O,,,5,1,3,0,3
35389_1,,,,2,2,1,3
35391_0,,,,2,2,1,3
C(C(C=O)(C(C)(C(CO)O)O)O)=O,,,5,1,2,0,2
35391_1,,,,2,2,1,3
35393_0,,,,2,2,1,3
C(C(C=O)(C(C(O)=O)O)O)=O,,,5,1,2,0,2
35393_1,,,,2,2,1,3
35395_0,,,,2,2,1,3
C(C(C=O)(C(C(O)=O)(C)O)O)=O,,,5,1,2,0,2
35395_1,,,,2,2,1,3
35397_0,,,,2,2,1,3
C(C(C=O)(C(CC(O)=O)O)O)=O,,,5,1,2,0,2
35397_1,,,,2,2,1,3
35399_0,,,,2,2,1,3
C(C(C=O)(C1(COCC1O)O)O)=O,,,5,1,2,0,2
35399_1,,,,2,2,1,3
35401_0,,,,2,2,1,3
C(C(C=O)(C1(C(O)OCC1)O)O)=O,,,5,1,2,0,2
35401_1,,,,2,2,1,3
35403_0,,,,2,2,1,3
C(C(C=O)(C1(COC(C1)O)O)O)=O,,,5,1,2,0,2
35403_1,,,,2,2,1,3
35405_0,,,,2,2,1,3
C(C(C=O)(C(C=O)(C=C)O)O)=O,,,5,1,2,0,2
35405_1,,,,2,2,1,3
35407_0,,,,2,2,1,3
C(C(C=O)(C(C(C=C)=O)O)O)=O,,,5,1,2,0,2
35407_1,,,,2,2,1,3
35409_0,,,,2,2,1,3
C(C(C=O)(C(C=CC=O)O)O)=O,,,5,1,2,0,2
35409_1,,,,2,2,1,3
35410_0,,,,2,2,1,3
35410_1,,,,2,2,1,3
35411_0,,,,2,2,1,3
35411_1,,,,2,2,1,3
35413_0,,,,2,2,1,3
C(C(C=O)(C(C(C=O)O)O)O)(O)=O,,,5,1,4,0,4
35413_1,,,,2,2,1,3
35414_0,,,,2,2,1,3
35415_0,,,,2,2,1,3
35416_0,,,,2,2,1,3
35418_0,,,,2,2,1,3
C(C(C=O)(C=C)C(C(C=O)O)O)=O,,,5,1,1,0,1
35419_0,,,,2,2,1,3
35419_1,,,,2,2,1,3
35420_0,,,,2,2,1,3
35420_1,,,,2,2,1,3
35421_0,,,,2,2,1,3
35421_1,,,,2,2,1,3
35422_0,,,,2,2,1,3
35423_0,,,,2,2,1,3
35423_1,,,,2,2,1,3
35424_0,,,,2,2,1,3
35424_1,,,,2,2,1,3
35425_0,,,,2,2,1,3
35425_1,,,,2,2,1,3
35426_0,,,,2,2,1,3
35428_0,,,,2,2,1,3
C(C(C=O)(C(O)=O)C(C)=O)=O,,,5,1,1,0,1
35430_0,,,,2,2,1,3
C(C(C=O)(C(C)=O)C(C(C=O)=C)O)=O,,,5,1,1,0,1
35432_0,,,,2,2,1,3
C(C(C=O)(C(C)=O)C(C=CC)O)=O,,,5,1,1,0,1
35434_0,,,,2,2,1,3
C(C(C=O)(C(C)=O)C(CC=C)O)=O,,,5,1,1,0,1
35436_0,,,,2,2,1,3
C(C(C=O)(C(C)=O)C(C=C)O)=O,,,5,1,1,0,1
35438_0,,,,2,2,1,3
C(C(C=O)(C(C)=O)C1(C=COC1)O)=O,,,5,1,1,0,1
35440_0,,,,2,2,1,3
C(C(C=O)(C(C)=O)C(C=O)O)=O,,,5,1,2,0,2
35442_0,,,,2,2,1,3
C(C(C)(C(C=O)(C=O)C(C)=O)O)=O,,,5,1,1,0,1
35444_0,,,,2,2,1,3
C(C(C=O)(C(C)=O)C(C(C)=O)O)=O,,,5,1,1,0,1
35446_0,,,,2,2,1,3
C(CC(C(C=O)(C=O)C(C)=O)O)=O,,,5,1,1,0,1
35448_0,,,,2,2,1,3
C(C(C=O)(C(C)=O)C(C)O)=O,,,5,1,2,0,2
35450_0,,,,2,2,1,3
C(C(C=O)(C(C)=O)C(CCO)O)=O,,,5,1,1,0,1
35452_0,,,,2,2,1,3
C(C(C=O)(C(C)=O)C(C)(CO)O)=O,,,5,1,1,0,1
35454_0,,,,2,2,1,3
C(C(C=O)(C(C)=O)C(C(O)=O)O)=O,,,5,1,1,0,1
35456_0,,,,2,2,1,3
C(C(C=O)(C(C)=O)C(C=O)(C=C)O)=O,,,5,1,1,0,1
35458_0,,,,2,2,1,3
C(C(C=O)(C(C)=O)C(C(C=C)=O)O)=O,,,5,1,1,0,1
35460_0,,,,2,2,1,3
C(C(C=O)(C(C)=O)C(C=CC=O)O)=O,,,5,1,1,0,1
35462_0,,,,2,2,1,3
C(C(C=O)(C(C)=O)CO)=O,,,5,1,2,0,2
35464_0,,,,2,2,1,3
C(C(C=O)(C(C)=O)C(CO)O)=O,,,5,1,2,0,2
35466_0,,,,2,2,1,3
C(C(C=O)(C(CC(C)=O)O)O)(O)=O,,,5,1,2,0,2
35466_1,,,,2,2,1,3
35468_0,,,,2,2,1,3
C(C(CO)C(CC(C)=O)O)(O)=O,,,5,1,1,0,1
35470_0,,,,2,2,1,3
C(C(C(CC(C)=O)O)C(C)O)(O)=O,,,5,1,1,0,1
35472_0,,,,2,2,1,3
C(C(C(O)=O)C(CC(C)=O)O)(O)=O,,,5,1,1,0,1
35474_0,,,,2,2,1,3
C(C(C=O)(C=C)C(CC(C)=O)O)=O,,,5,1,1,0,1
35476_0,,,,2,2,1,3
C(C(CO)(C(CC(C)=O)O)O)=O,,,5,1,4,0,4
35476_1,,,,2,2,1,3
35478_0,,,,2,2,1,3
C(C(CO)(C(CC(C)=O)O)O)(O)=O,,,5,1,2,0,2
35478_1,,,,2,2,1,3
35480_0,,,,2,2,1,3
C(C(C(C)=O)(C(CC(C)=O)O)O)=O,,,5,1,2,0,2
35480_1,,,,2,2,1,3
35482_0,,,,2,2,1,3
C(C(C=O)(CO)C(CC(C)=O)O)=O,,,5,1,1,0,1
35484_0,,,,2,2,1,3
C(C(C(CC(C)=O)O)(C(C)O)O)=O,,,5,1,2,0,2
35484_1,,,,2,2,1,3
35486_0,,,,2,2,1,3
C(C)(C(CO)(C(CC(C)=O)O)O)=O,,,5,1,2,0,2
35486_1,,,,2,2,1,3
35488_0,,,,2,2,1,3
C(C)(CC(C1(C(COC1)=O)O)O)=O,,,5,1,2,0,2
35488_1,,,,2,2,1,3
35490_0,,,,2,2,1,3
C1(C(C(CC(C)=O)O)C(CO1)O)=O,,,5,1,1,0,1
35492_0,,,,2,2,1,3
C(C(C=O)(C(C)(CC=O)O)O)(O)=O,,,5,1,4,0,4
35492_1,,,,2,2,1,3
35493_0,,,,2,2,1,3
35495_0,,,,2,2,1,3
C(C(C(C)O)C(C)(CC=O)O)(O)=O,,,5,1,1,0,1
35497_0,,,,2,2,1,3
C(C(C(O)=O)C(C)(CC=O)O)(O)=O,,,5,1,1,0,1
35499_0,,,,2,2,1,3
C(C(C=O)(C=C)C(C)(CC=O)O)=O,,,5,1,1,0,1
35500_0,,,,2,2,1,3
35500_1,,,,2,2,1,3
35501_0,,,,2,2,1,3
35501_1,,,,2,2,1,3
35502_0,,,,2,2,1,3
35502_1,,,,2,2,1,3
35504_0,,,,2,2,1,3
C(C(C=O)(CO)C(C)(CC=O)O)=O,,,5,1,1,0,1
35505_0,,,,2,2,1,3
35505_1,,,,2,2,1,3
35507_0,,,,2,2,1,3
C(CC(C)(C(C(C)=O)(CO)O)O)=O,,,5,1,2,0,2
35507_1,,,,2,2,1,3
35509_0,,,,2,2,1,3
C(CC(C)(C1(C(COC1)=O)O)O)=O,,,5,1,2,0,2
35509_1,,,,2,2,1,3
35511_0,,,,2,2,1,3
C1(C(C(CO1)O)C(C)(CC=O)O)=O,,,5,1,1,0,1
35513_0,,,,2,2,1,3
C(C(C(C(O)=O)=O)(CO)O)(O)=O,,,5,1,2,0,2
35513_1,,,,2,2,1,3
35515_0,,,,2,2,1,3
C(C(C(O)=O)(C=O)O)(O)=O,,,5,1,2,0,2
35515_1,,,,2,2,1,3
35517_0,,,,2,2,1,3
C(C(C(O)=O)(C(CO)=O)O)(O)=O,,,5,1,2,0,2
35517_1,,,,2,2,1,3
35518_0,,,,2,2,1,3
35518_1,,,,2,2,1,3
35519_0,,,,2,2,1,3
35519_1,,,,2,2,1,3
35520_0,,,,2,2,1,3
35520_1,,,,2,2,1,3
35522_0,,,,2,2,1,3
C(C(C=O)(C=O)C(C(C)O)=O)(O)=O,,,5,1,1,0,1
35524_0,,,,2,2,1,3
C(C(C=O)(C(C(C)O)=O)O)(O)=O,,,5,1,2,0,2
35524_1,,,,2,2,1,3
35526_0,,,,2,2,1,3
C(C(C(O)=O)(C(C(C)O)=O)O)(O)=O,,,5,1,2,0,2
35526_1,,,,2,2,1,3
35527_0,,,,2,2,1,3
35529_0,,,,2,2,1,3
C(C(C=O)(C(C)(CCO)O)O)(O)=O,,,5,1,2,0,2
35529_1,,,,2,2,1,3
35530_0,,,,2,2,1,3
35531_0,,,,2,2,1,3
35533_0,,,,2,2,1,3
C(C(C(O)=O)(C(CO)(C)O)O)(O)=O,,,5,1,2,0,2
35533_1,,,,2,2,1,3
35535_0,,,,2,2,1,3
C(C(C(O)=O)(C(CCO)O)O)(O)=O,,,5,1,2,0,2
35535_1,,,,2,2,1,3
35536_0,,,,2,2,1,3
35537_0,,,,2,2,1,3
35538_0,,,,2,2,1,3
35540_0,,,,2,2,1,3
C(C(C(O)=O)(CO)C(C=O)O)(O)=O,,,5,1,1,0,1
35541_0,,,,2,2,1,3
35542_0,,,,2,2,1,3
35544_0,,,,2,2,1,3
C(C(C(O)=O)C(O)=O)(O)=O,,,5,1,1,0,1
35545_0,,,,2,2,1,3
35547_0,,,,2,2,1,3
C(C(C(O)=O)(C(C(O)=O)O)O)(O)=O,,,5,1,2,0,2
35547_1,,,,2,2,1,3
35548_0,,,,2,2,1,3
35550_0,,,,2,2,1,3
C1(C(C(O)=O)(C(CO1)O)C(C)O)=O,,,5,1,1,0,1
35552_0,,,,2,2,1,3
C1(C(C(O)=O)(CO)C(CO1)O)=O,,,5,1,1,0,1
35554_0,,,,2,2,1,3
C(C(C=O)(CO)OC(CO)=O)(O)=O,,,5,1,2,0,2
35554_1,,,,2,2,1,3
35556_0,,,,2,2,1,3
C(C(C=O)(COC(CO)=O)O)(O)=O,,,5,1,2,0,2
35556_1,,,,2,2,1,3
35558_0,,,,2,2,1,3
C(C(C=O)(CO)CC(C=O)=O)(O)=O,,,5,1,1,0,1
35560_0,,,,2,2,1,3
C(C(C=O)(C=O)C(C=O)CO)(O)=O,,,5,1,1,0,1
35562_0,,,,2,2,1,3
C(C(C=O)(CO)C(C=O)C=O)(O)=O,,,5,1,1,0,1
35564_0,,,,2,2,1,3
C(C(C=O)(CO)CC=O)(O)=O,,,5,1,1,0,1
35566_0,,,,2,2,1,3
C(C(C=O)(C(C(CO)=O)=O)C)(O)=O,,,5,1,1,0,1
35568_0,,,,2,2,1,3
C(C(C=O)(C(CO)O)CC=O)(O)=O,,,5,1,1,0,1
35570_0,,,,2,2,1,3
C(CO)(C(C(O)=O)(CO)CC=O)=O,,,5,1,1,0,1
35571_0,,,,2,2,1,3
35571_1,,,,2,2,1,3
35573_0,,,,2,2,1,3
C(C(C(C(CC)=O)=O)(CO)O)(O)=O,,,5,1,2,0,2
35573_1,,,,2,2,1,3
35575_0,,,,2,2,1,3
C(C(C(CC=O)=O)(CO)CO)(O)=O,,,5,1,2,0,2
35577_0,,,,2,2,1,3
C(C(C(O)=O)(C(C=O)=O)C)=O,,,5,1,1,0,1
35579_0,,,,2,2,1,3
C(C(C=O)(C=O)CC(CO)=O)(O)=O,,,5,1,1,0,1
35581_0,,,,2,2,1,3
C(C(C=O)(C=O)C(CCO)=O)(O)=O,,,5,1,1,0,1
35583_0,,,,2,2,1,3
C(C(C=O)(C(O)=O)CC=O)=O,,,5,1,1,0,1
35585_0,,,,2,2,1,3
C(C(C=O)(C(C=O)=O)CCO)(O)=O,,,5,1,1,0,1
35587_0,,,,2,2,1,3
C(C(C(C=O)=O)(CO)CC=O)(O)=O,,,5,1,1,0,1
35589_0,,,,2,2,1,3
C(C(C(C)=O)(C(C=O)=O)CO)(O)=O,,,5,1,1,0,1
35591_0,,,,2,2,1,3
C(C(C=O)(C(CCC=O)=O)O)(O)=O,,,5,1,2,0,2
35591_1,,,,2,2,1,3
35593_0,,,,2,2,1,3
C(C(C=O)(CC=O)C(C=O)O)(O)=O,,,5,1,1,0,1
35595_0,,,,2,2,1,3
C(C(C=O)(C(C)=O)C(C=O)O)(O)=O,,,5,1,1,0,1
35597_0,,,,2,2,1,3
C(C(C=O)(C(CO)=O)CC=O)(O)=O,,,5,1,1,0,1
35599_0,,,,2,2,1,3
C(C(C=O)(C(C)=O)C(CO)=O)(O)=O,,,5,1,1,0,1
35601_0,,,,2,2,1,3
C(C(C(CC=O)=O)(C(C)=O)O)(O)=O,,,5,1,2,0,2
35601_1,,,,2,2,1,3
35603_0,,,,2,2,1,3
C(C(C=O)(C(CC(C)=O)=O)O)(O)=O,,,5,1,2,0,2
35603_1,,,,2,2,1,3
35605_0,,,,2,2,1,3
C(C(C(C=O)=O)(C)C(C=O)O)(O)=O,,,5,1,1,0,1
35606_0,,,,2,2,1,3
35606_1,,,,2,2,1,3
35608_0,,,,2,2,1,3
C(C(C(O)=O)(C(C=O)=O)CO)(O)=O,,,5,1,1,0,1
35610_0,,,,2,2,1,3
C(C(C(O)=O)(C(C)=O)C(C=O)=O)=O,,,5,1,1,0,1
35612_0,,,,2,2,1,3
C(C)(C(C(O)=O)(C(CO)=O)CO)=O,,,5,1,1,0,1
35614_0,,,,2,2,1,3
C(C(C(O)=O)(C(C)=O)CO)(O)=O,,,5,1,1,0,1
35616_0,,,,2,2,1,3
C(C(C=O)(C(C(C)=O)=O)CO)(O)=O,,,5,1,1,0,1
35618_0,,,,2,2,1,3
C(C(C=O)(C(CC=O)=O)CO)(O)=O,,,5,1,1,0,1
35620_0,,,,2,2,1,3
C(C(C(O)=O)(C(C)=O)C(C)=O)=O,,,5,1,1,0,1
35622_0,,,,2,2,1,3
C(C(C=O)(C(C)=O)CO)(O)=O,,,5,1,1,0,1
35624_0,,,,2,2,1,3
C(C(C=O)(C(C)=O)C(CO)O)(O)=O,,,5,1,1,0,1
35626_0,,,,2,2,1,3
C(C(C(O)=O)(C(C=O)=O)CC=O)=O,,,5,1,1,0,1
35628_0,,,,2,2,1,3
C(C(C(O)=O)(C(C(O)=O)=O)C)=O,,,5,1,1,0,1
35630_0,,,,2,2,1,3
C(C(C(O)=O)(C(C)=O)CC=O)=O,,,5,1,1,0,1
35632_0,,,,2,2,1,3
C(C1(C(COC1CO)=O)O)(O)=O,,,5,1,3,0,3
35632_1,,,,2,2,1,3
35634_0,,,,2,2,1,3
C1(C(C(O)=O)C(C(CO)O1)O)=O,,,5,1,1,0,1
35636_0,,,,2,2,1,3
C(C1(C=O)C(O)OCC1O)(O)=O,,,5,1,1,0,1
35638_0,,,,2,2,1,3
C(C1(C(COCC1O)=O)O)(O)=O,,,5,1,3,0,3
35638_1,,,,2,2,1,3
35640_0,,,,2,2,1,3
C1(C(C(O)=O)C(C(CO1)O)O)=O,,,5,1,1,0,1
35642_0,,,,2,2,1,3
C(C1(C(CC(O)OC1)=O)O)(O)=O,,,5,1,2,0,2
35642_1,,,,2,2,1,3
35644_0,,,,2,2,1,3
C(C1(C(CCOC1O)=O)O)(O)=O,,,5,1,2,0,2
35644_1,,,,2,2,1,3
35646_0,,,,2,2,1,3
C(C1(C(CC(O1)=O)=O)CO)(O)=O,,,5,1,2,0,2
35646_1,,,,2,2,1,3
35648_0,,,,2,2,1,3
C(C1(C(CC(OC1)=O)=O)O)(O)=O,,,5,1,2,0,2
35648_1,,,,2,2,1,3
35650_0,,,,2,2,1,3
C1(C(C(O)=O)(C(CCO1)=O)O)=O,,,5,1,2,0,2
35650_1,,,,2,2,1,3
35652_0,,,,2,2,1,3
C(C(C=O)(C(C=CC=O)=O)O)(O)=O,,,5,1,2,0,2
35652_1,,,,2,2,1,3
35653_0,,,,2,2,1,3
35653_1,,,,2,2,1,3
35655_0,,,,2,2,1,3
C(C(C=O)(C(O)=O)C(C=O)=C)=O,,,5,1,1,0,1
35657_0,,,,2,2,1,3
C(C(C=O)(C(O)=O)C=CC=O)=O,,,5,1,1,0,1
35659_0,,,,2,2,1,3
C(C(C=O)(C(O)=O)C=C)=O,,,5,1,1,0,1
35661_0,,,,2,2,1,3
C(C(C=C)(C(C=O)=O)CO)(O)=O,,,5,1,1,0,1
35663_0,,,,2,2,1,3
C(C(C=O)(C=C)C(C=O)O)(O)=O,,,5,1,1,0,1
35665_0,,,,2,2,1,3
C(C(C=O)(C(CO)=O)C=C)(O)=O,,,5,1,1,0,1
35667_0,,,,2,2,1,3
C(C(C=O)(C(CC=C)=O)O)(O)=O,,,5,1,2,0,2
35667_1,,,,2,2,1,3
35669_0,,,,2,2,1,3
C(C(C=O)(C(C=CC)=O)O)(O)=O,,,5,1,2,0,2
35669_1,,,,2,2,1,3
35671_0,,,,2,2,1,3
C(C(C=O)(C(C=C)=O)O)(O)=O,,,5,1,2,0,2
35671_1,,,,2,2,1,3
35673_0,,,,2,2,1,3
C(C(C=O)(C(C=CCO)=O)O)(O)=O,,,5,1,2,0,2
35673_1,,,,2,2,1,3
35675_0,,,,2,2,1,3
C(C(C(C=CC=O)=O)(CO)O)(O)=O,,,5,1,2,0,2
35675_1,,,,2,2,1,3
35677_0,,,,2,2,1,3
C(C(C(C(C=O)=C)=O)(CO)O)(O)=O,,,5,1,2,0,2
35677_1,,,,2,2,1,3
35679_0,,,,2,2,1,3
C(C(C(O)=O)(C(C=C)=O)O)(O)=O,,,5,1,2,0,2
35679_1,,,,2,2,1,3
35681_0,,,,2,2,1,3
C(C1(C=O)C(CC(O1)O)O)(O)=O,,,5,1,2,0,2
35681_1,,,,2,2,1,3
35683_0,,,,2,2,1,3
C(C1(C(C(O)OC1C)=O)CO)(O)=O,,,5,1,1,0,1
35685_0,,,,2,2,1,3
C(C1(C=O)C(C)OC(C1O)O)(O)=O,,,5,1,1,0,1
35687_0,,,,2,2,1,3
C(C1(C=O)COC(C1O)O)(O)=O,,,5,1,1,0,1
35688_0,,,,2,2,1,3
35688_1,,,,2,2,1,3
35690_0,,,,2,2,1,3
C(C1(C=O)C(C)(CC(O1)O)O)(O)=O,,,5,1,2,0,2
35690_1,,,,2,2,1,3
35692_0,,,,2,2,1,3
C(C1(C(C(O)OC1)=O)O)(O)=O,,,5,1,2,0,2
35692_1,,,,2,2,1,3
35694_0,,,,2,2,1,3
C(C1(C(C(O)OC1CO)=O)O)(O)=O,,,5,1,2,0,2
35694_1,,,,2,2,1,3
35696_0,,,,2,2,1,3
C1(C(C(O)=O)C(C(O)O1)O)=O,,,5,1,1,0,1
35698_0,,,,2,2,1,3
C1(C(C(O)=O)(C(C(O)O1)O)O)=O,,,5,1,2,0,2
35698_1,,,,2,2,1,3
35700_0,,,,2,2,1,3
C1(C(C(O)=O)(C(C(O)O1)(C)O)O)=O,,,5,1,2,0,2
35700_1,,,,2,2,1,3
35702_0,,,,2,2,1,3
C1(C(C(O)=O)(C(C(C)(O)O1)O)O)=O,,,5,1,2,0,2
35702_1,,,,2,2,1,3
35704_0,,,,2,2,1,3
C(C1(C(O)=O)C(CC(O1)O)O)(O)=O,,,5,1,2,0,2
35704_1,,,,2,2,1,3
35706_0,,,,2,2,1,3
C(C1(C(COC(C1O)O)=O)O)(O)=O,,,5,1,2,0,2
35706_1,,,,2,2,1,3
35708_0,,,,2,2,1,3
C(C1(C(CC(O)OC1C)=O)O)(O)=O,,,5,1,2,0,2
35708_1,,,,2,2,1,3
35710_0,,,,2,2,1,3
C(C1(C(CC(C)OC1O)=O)O)(O)=O,,,5,1,2,0,2
35710_1,,,,2,2,1,3
35712_0,,,,2,2,1,3
C(C1(C(C(O)OCC1O)=O)O)(O)=O,,,5,1,2,0,2
35712_1,,,,2,2,1,3
35714_0,,,,2,2,1,3
C1(C(C(O)=O)(C(CC(O)O1)O)O)=O,,,5,1,2,0,2
35714_1,,,,2,2,1,3
35716_0,,,,2,2,1,3
C1(C(C(O)=O)(C(CO1)(CO)O)O)=O,,,5,1,2,0,2
35716_1,,,,2,2,1,3
35718_0,,,,2,2,1,3
C(C(C=O)(C(C)O)CC=O)(O)=O,,,5,1,1,0,1
35719_0,,,,2,2,1,3
35719_1,,,,2,2,1,3
35720_0,,,,2,2,1,3
35720_1,,,,2,2,1,3
35722_0,,,,2,2,1,3
C(C(C=O)(C(C(CO)O)O)O)(O)=O,,,5,1,4,0,4
35722_1,,,,2,2,1,3
35723_0,,,,2,2,1,3
35723_1,,,,2,2,1,3
35724_0,,,,2,2,1,3
35724_1,,,,2,2,1,3
35726_0,,,,2,2,1,3
C(C(C(O)=O)(C(CO)O)O)(O)=O,,,5,1,2,0,2
35726_1,,,,2,2,1,3
35727_0,,,,2,2,1,3
35727_1,,,,2,2,1,3
35728_0,,,,2,2,1,3
35728_1,,,,2,2,1,3
35730_0,,,,2,2,1,3
C(C(C=O)(C(C(CO)=O)O)O)(O)=O,,,5,1,4,0,4
35730_1,,,,2,2,1,3
35732_0,,,,2,2,1,3
C(C(C=O)(C=O)C(C=O)O)(O)=O,,,5,1,1,0,1
35734_0,,,,2,2,1,3
C(C(C=O)(C(C=O)O)O)(O)=O,,,5,1,4,0,4
35734_1,,,,2,2,1,3
35736_0,,,,2,2,1,3
C(C(C=O)(C(CO)(CO)O)O)(O)=O,,,5,1,4,0,4
35736_1,,,,2,2,1,3
35737_0,,,,2,2,1,3
35737_1,,,,2,2,1,3
35738_0,,,,2,2,1,3
35738_1,,,,2,2,1,3
35739_0,,,,2,2,1,3
35739_1,,,,2,2,1,3
35741_0,,,,2,2,1,3
C(C(C=O)(C=O)C(C=O)(C)O)(O)=O,,,5,1,1,0,1
35743_0,,,,2,2,1,3
C(C(C=O)(C(C=O)(C)O)O)(O)=O,,,5,1,4,0,4
35743_1,,,,2,2,1,3
35745_0,,,,2,2,1,3
C(C(C=O)(C=O)C(C(C)=O)O)(O)=O,,,5,1,1,0,1
35747_0,,,,2,2,1,3
C(C(C=O)(C(C(C)=O)O)O)(O)=O,,,5,1,4,0,4
35747_1,,,,2,2,1,3
35748_0,,,,2,2,1,3
35748_1,,,,2,2,1,3
35750_0,,,,2,2,1,3
C(C(C=O)(C=O)C(CC=O)O)(O)=O,,,5,1,1,0,1
35752_0,,,,2,2,1,3
C(C(C=O)(C(CC=O)O)O)(O)=O,,,5,1,4,0,4
35752_1,,,,2,2,1,3
35754_0,,,,2,2,1,3
C(C(C=O)(C=O)C(C)O)(O)=O,,,5,1,1,0,1
35756_0,,,,2,2,1,3
C(C(C=O)(C=O)CO)(O)=O,,,5,1,1,0,1
35758_0,,,,2,2,1,3
C(C(C=O)(C=O)C(CO)O)(O)=O,,,5,1,1,0,1
35760_0,,,,2,2,1,3
C(C(C(C=O)=O)(CO)C(C)O)(O)=O,,,5,1,2,0,2
35762_0,,,,2,2,1,3
C(C(C(C=O)=O)(CO)CO)(O)=O,,,5,1,2,0,2
35763_0,,,,2,2,1,3
35764_0,,,,2,2,1,3
35766_0,,,,2,2,1,3
C(C(C=O)(C(CO)=O)C(C)O)(O)=O,,,5,1,1,0,1
35768_0,,,,2,2,1,3
C(C(C=O)(C(CO)=O)CO)(O)=O,,,5,1,1,0,1
35770_0,,,,2,2,1,3
C(C(C(CC=O)=O)(C(C)O)O)(O)=O,,,5,1,2,0,2
35770_1,,,,2,2,1,3
35772_0,,,,2,2,1,3
C(C(C(CC=O)=O)(CO)O)(O)=O,,,5,1,2,0,2
35772_1,,,,2,2,1,3
35773_0,,,,2,2,1,3
35773_1,,,,2,2,1,3
35774_0,,,,2,2,1,3
35774_1,,,,2,2,1,3
35776_0,,,,2,2,1,3
C(C(C=O)(C(CC(C)O)=O)O)(O)=O,,,5,1,2,0,2
35776_1,,,,2,2,1,3
35778_0,,,,2,2,1,3
C(C(C=O)(C(CCO)=O)O)(O)=O,,,5,1,2,0,2
35778_1,,,,2,2,1,3
35779_0,,,,2,2,1,3
35779_1,,,,2,2,1,3
35780_0,,,,2,2,1,3
35780_1,,,,2,2,1,3
35782_0,,,,2,2,1,3
C(C(C(C=O)=O)(C(CO)O)O)(O)=O,,,5,1,2,0,2
35782_1,,,,2,2,1,3
35783_0,,,,2,2,1,3
35783_1,,,,2,2,1,3
35784_0,,,,2,2,1,3
35786_0,,,,2,2,1,3
C(C(C(O)=O)(C(C)=O)O)(O)=O,,,5,1,2,0,2
35786_1,,,,2,2,1,3
35788_0,,,,2,2,1,3
C(C(C=O)(C(C=O)(CO)O)O)(O)=O,,,5,1,4,0,4
35788_1,,,,2,2,1,3
35790_0,,,,2,2,1,3
C(C(C(O)=O)(C(C=O)O)O)(O)=O,,,5,1,2,0,2
35790_1,,,,2,2,1,3
35792_0,,,,2,2,1,3
C(C(C=O)(C(C(O)=O)O)O)(O)=O,,,5,1,4,0,4
35792_1,,,,2,2,1,3
35794_0,,,,2,2,1,3
C(C(C(O)=O)(C(C=O)(C)O)O)(O)=O,,,5,1,2,0,2
35794_1,,,,2,2,1,3
35796_0,,,,2,2,1,3
C(C(C(O)=O)(C(C(C)=O)O)O)(O)=O,,,5,1,2,0,2
35796_1,,,,2,2,1,3
35797_0,,,,2,2,1,3
35797_1,,,,2,2,1,3
35799_0,,,,2,2,1,3
C(C(C(O)=O)(C(CC=O)O)O)(O)=O,,,5,1,2,0,2
35799_1,,,,2,2,1,3
35801_0,,,,2,2,1,3
C(C(C(O)=O)(C(C)O)O)(O)=O,,,5,1,2,0,2
35801_1,,,,2,2,1,3
35802_0,,,,2,2,1,3
35802_1,,,,2,2,1,3
35804_0,,,,2,2,1,3
C(C(C(O)=O)(C(CCO)=O)O)(O)=O,,,5,1,2,0,2
35804_1,,,,2,2,1,3
35806_0,,,,2,2,1,3
C(C1(C(COC1)=O)O)(O)=O,,,5,1,3,0,3
35806_1,,,,2,2,1,3
35808_0,,,,2,2,1,3
C1(C(C(O)=O)C(CO1)O)=O,,,5,1,1,0,1
35810_0,,,,2,2,1,3
C1(C(C(O)=O)(C(CO1)O)O)=O,,,5,1,2,0,2
35810_1,,,,2,2,1,3
35812_0,,,,2,2,1,3
C1(C(C(O)=O)(C(C(CO)O1)O)O)=O,,,5,1,2,0,2
35812_1,,,,2,2,1,3
35814_0,,,,2,2,1,3
C1(C(C(O)=O)(C(C(CO1)O)O)O)=O,,,5,1,2,0,2
35814_1,,,,2,2,1,3
35815_0,,,,2,2,1,3
35816_0,,,,2,2,1,3
35816_1,,,,2,2,1,3
35818_0,,,,2,2,1,3
C=CC(C(C(C(O)=O)=O)(CO)O)O,,,5,1,2,0,2
35818_1,,,,2,2,1,3
35819_0,,,,2,2,1,3
35819_1,,,,2,2,1,3
35820_0,,,,2,2,1,3
35820_1,,,,2,2,1,3
35821_0,,,,2,2,1,3
35821_1,,,,2,2,1,3
35822_0,,,,2,2,1,3
35822_1,,,,2,2,1,3
35824_0,,,,2,2,1,3
C(C(C=O)(C(C=C)(CO)O)O)(O)=O,,,5,1,2,0,2
35824_1,,,,2,2,1,3
35826_0,,,,2,2,1,3
C(C(C=O)(C(C=CCO)O)O)(O)=O,,,5,1,2,0,2
35826_1,,,,2,2,1,3
35828_0,,,,2,2,1,3
C(C(C=O)(C(C=O)(CC)O)O)(O)=O,,,5,1,2,0,2
35828_1,,,,2,2,1,3
35830_0,,,,2,2,1,3
C(C(C=O)(C(C(CC)=O)O)O)(O)=O,,,5,1,2,0,2
35830_1,,,,2,2,1,3
35832_0,,,,2,2,1,3
C(C(C=O)(C(CCC=O)O)O)(O)=O,,,5,1,3,0,3
35832_1,,,,2,2,1,3
35834_0,,,,2,2,1,3
C(C(C=O)(C(C(C)=O)(C)O)O)(O)=O,,,5,1,2,0,2
35834_1,,,,2,2,1,3
35836_0,,,,2,2,1,3
C(C(C=O)(C(C(C=O)=C)O)O)(O)=O,,,5,1,2,0,2
35836_1,,,,2,2,1,3
35838_0,,,,2,2,1,3
C(C(C=O)(C(C=CC)O)O)(O)=O,,,5,1,2,0,2
35838_1,,,,2,2,1,3
35840_0,,,,2,2,1,3
C(C(C=O)(C(CC=C)O)O)(O)=O,,,5,1,2,0,2
35840_1,,,,2,2,1,3
35842_0,,,,2,2,1,3
C(C(C=O)(C(C(C=C)O)O)O)(O)=O,,,5,1,2,0,2
35842_1,,,,2,2,1,3
35844_0,,,,2,2,1,3
C(C(C=O)(C(C=C)O)O)(O)=O,,,5,1,2,0,2
35844_1,,,,2,2,1,3
35846_0,,,,2,2,1,3
C(C(C=O)(C1(C=COC1)O)O)(O)=O,,,5,1,2,0,2
35846_1,,,,2,2,1,3
35847_0,,,,2,2,1,3
35847_1,,,,2,2,1,3
35848_0,,,,2,2,1,3
35848_1,,,,2,2,1,3
35849_0,,,,2,2,1,3
35849_1,,,,2,2,1,3
35850_0,,,,2,2,1,3
35850_1,,,,2,2,1,3
35851_0,,,,2,2,1,3
35851_1,,,,2,2,1,3
35852_0,,,,2,2,1,3
35852_1,,,,2,2,1,3
35853_0,,,,2,2,1,3
35853_1,,,,2,2,1,3
35854_0,,,,2,2,1,3
35854_1,,,,2,2,1,3
35855_0,,,,2,2,1,3
35855_1,,,,2,2,1,3
35856_0,,,,2,2,1,3
35856_1,,,,2,2,1,3
35857_0,,,,2,2,1,3
35857_1,,,,2,2,1,3
35858_0,,,,2,2,1,3
35858_1,,,,2,2,1,3
35859_0,,,,2,2,1,3
35859_1,,,,2,2,1,3
35860_0,,,,2,2,1,3
35860_1,,,,2,2,1,3
35861_0,,,,2,2,1,3
35861_1,,,,2,2,1,3
35862_0,,,,2,2,1,3
35862_1,,,,2,2,1,3
35863_0,,,,2,2,1,3
35863_1,,,,2,2,1,3
35864_0,,,,2,2,1,3
35864_1,,,,2,2,1,3
35865_0,,,,2,2,1,3
35865_1,,,,2,2,1,3
35866_0,,,,2,2,1,3
35866_1,,,,2,2,1,3
35867_0,,,,2,2,1,3
35868_0,,,,2,2,1,3
35868_1,,,,2,2,1,3
35870_0,,,,2,2,1,3
C(C(C(CO)=O)(C(C=C)O)O)(O)=O,,,5,1,2,0,2
35870_1,,,,2,2,1,3
35871_0,,,,2,2,1,3
35871_1,,,,2,2,1,3
35872_0,,,,2,2,1,3
35872_1,,,,2,2,1,3
35873_0,,,,2,2,1,3
35873_1,,,,2,2,1,3
35874_0,,,,2,2,1,3
35874_1,,,,2,2,1,3
35876_0,,,,2,2,1,3
C(OCC(C)(C(C(O)=O)CO)O)=O,,,5,1,1,0,1
35878_0,,,,2,2,1,3
C(OCC(C)(C(C=O)(CO)O)O)=O,,,5,1,2,0,2
35878_1,,,,2,2,1,3
35879_0,,,,2,2,1,3
35879_1,,,,2,2,1,3
35880_0,,,,2,2,1,3
35880_1,,,,2,2,1,3
35881_0,,,,2,2,1,3
35882_0,,,,2,2,1,3
35883_0,,,,2,2,1,3
35883_1,,,,2,2,1,3
35884_0,,,,2,2,1,3
35884_1,,,,2,2,1,3
35885_0,,,,2,2,1,3
35885_1,,,,2,2,1,3
35887_0,,,,2,2,1,3
C(C(C(C(CO)(CO)O)=O)(C)O)=O,,,5,1,2,0,2
35887_1,,,,2,2,1,3
35889_0,,,,2,2,1,3
C(C(CO)(C(C(C=O)(C)O)O)O)=O,,,5,1,3,0,3
35889_1,,,,2,2,1,3
35890_0,,,,2,2,1,3
35890_1,,,,2,2,1,3
35891_0,,,,2,2,1,3
35891_1,,,,2,2,1,3
35892_0,,,,2,2,1,3
35892_1,,,,2,2,1,3
35894_0,,,,2,2,1,3
C(C(CO)(C(C=C)O)O)(C(C)O)=O,,,5,1,2,0,2
35894_1,,,,2,2,1,3
35895_0,,,,2,2,1,3
35895_1,,,,2,2,1,3
35897_0,,,,2,2,1,3
C(C(C)O)(C(CO)(C(C)O)O)=O,,,5,1,2,0,2
35897_1,,,,2,2,1,3
35898_0,,,,2,2,1,3
35898_1,,,,2,2,1,3
35899_0,,,,2,2,1,3
35899_1,,,,2,2,1,3
35901_0,,,,2,2,1,3
C(C(C(C(C)O)O)(C(C=C)O)O)=O,,,5,1,2,0,2
35901_1,,,,2,2,1,3
35902_0,,,,2,2,1,3
35902_1,,,,2,2,1,3
35903_0,,,,2,2,1,3
35903_1,,,,2,2,1,3
35904_0,,,,2,2,1,3
35904_1,,,,2,2,1,3
35905_0,,,,2,2,1,3
35905_1,,,,2,2,1,3
35906_0,,,,2,2,1,3
35906_1,,,,2,2,1,3
35907_0,,,,2,2,1,3
35907_1,,,,2,2,1,3
35908_0,,,,2,2,1,3
35909_0,,,,2,2,1,3
35911_0,,,,2,2,1,3
C(C(C)O)(C(C=O)(C(C=C)O)O)=O,,,5,1,2,0,2
35911_1,,,,2,2,1,3
35912_0,,,,2,2,1,3
35912_1,,,,2,2,1,3
35913_0,,,,2,2,1,3
35913_1,,,,2,2,1,3
35914_0,,,,2,2,1,3
35914_1,,,,2,2,1,3
35915_0,,,,2,2,1,3
35915_1,,,,2,2,1,3
35916_0,,,,2,2,1,3
35916_1,,,,2,2,1,3
35917_0,,,,2,2,1,3
35917_1,,,,2,2,1,3
35919_0,,,,2,2,1,3
C(C(CO)C(CO)(C(C)O)O)(O)=O,,,5,1,1,0,1
35920_0,,,,2,2,1,3
35920_1,,,,2,2,1,3
35921_0,,,,2,2,1,3
35921_1,,,,2,2,1,3
35922_0,,,,2,2,1,3
35922_1,,,,2,2,1,3
35923_0,,,,2,2,1,3
35923_1,,,,2,2,1,3
35924_0,,,,2,2,1,3
35924_1,,,,2,2,1,3
35925_0,,,,2,2,1,3
35926_0,,,,2,2,1,3
35927_0,,,,2,2,1,3
35927_1,,,,2,2,1,3
35928_0,,,,2,2,1,3
35928_1,,,,2,2,1,3
35930_0,,,,2,2,1,3
C(C(CO)C(C=C)(CO)O)(O)=O,,,5,1,1,0,1
35932_0,,,,2,2,1,3
C(C(CO)C(C=CCO)O)(O)=O,,,5,1,1,0,1
35934_0,,,,2,2,1,3
C(C(C=C)(C(C(O)=O)CO)O)(O)=O,,,5,1,1,0,1
35936_0,,,,2,2,1,3
C(C(CO)C(C=CC(O)=O)O)(O)=O,,,5,1,1,0,1
35938_0,,,,2,2,1,3
C(C(CO)C(C=O)(CC)O)(O)=O,,,5,1,1,0,1
35940_0,,,,2,2,1,3
C(C(CO)C(C(CC)=O)O)(O)=O,,,5,1,1,0,1
35942_0,,,,2,2,1,3
C(C(CO)C(CCC=O)O)(O)=O,,,5,1,1,0,1
35944_0,,,,2,2,1,3
C(C(CO)C(C(C)=O)(C)O)(O)=O,,,5,1,1,0,1
35946_0,,,,2,2,1,3
C(C(CO)C(C(O)=O)(CC)O)(O)=O,,,5,1,1,0,1
35948_0,,,,2,2,1,3
C(C(CO)C(C)(CC(O)=O)O)(O)=O,,,5,1,1,0,1
35950_0,,,,2,2,1,3
C(C(CO)C1(C(OCC1)=O)O)(O)=O,,,5,1,1,0,1
35952_0,,,,2,2,1,3
C(C(CO)C1(COC(C1)=O)O)(O)=O,,,5,1,1,0,1
35954_0,,,,2,2,1,3
C(C(CO)C(C=C(C=O)C)O)(O)=O,,,5,1,1,0,1
35956_0,,,,2,2,1,3
C(C(CO)C(C(C)=CC=O)O)(O)=O,,,5,1,1,0,1
35958_0,,,,2,2,1,3
C(C(CO)C(CC(C=O)=C)O)(O)=O,,,5,1,1,0,1
35960_0,,,,2,2,1,3
C(C(CO)C(C(CC=O)=C)O)(O)=O,,,5,1,1,0,1
35962_0,,,,2,2,1,3
C(C(CO)C(C=CC(C)=O)O)(O)=O,,,5,1,1,0,1
35964_0,,,,2,2,1,3
C(C(CO)C(C=CC=O)(C)O)(O)=O,,,5,1,1,0,1
35966_0,,,,2,2,1,3
C(C(CO)C(C=O)(CC=C)O)(O)=O,,,5,1,1,0,1
35968_0,,,,2,2,1,3
C(C(CO)C(C(CC=C)=O)O)(O)=O,,,5,1,1,0,1
35970_0,,,,2,2,1,3
C(C(CO)C(C=O)(C=CC)O)(O)=O,,,5,1,1,0,1
35972_0,,,,2,2,1,3
C(C(CO)C(C(C=CC)=O)O)(O)=O,,,5,1,1,0,1
35974_0,,,,2,2,1,3
C(C(CO)C(C=CCC=O)O)(O)=O,,,5,1,1,0,1
35976_0,,,,2,2,1,3
C(C(CO)C(CC=CC=O)O)(O)=O,,,5,1,1,0,1
35977_0,,,,2,2,1,3
35979_0,,,,2,2,1,3
C(C(CO)C(C(C=O)=CC)O)(O)=O,,,5,1,1,0,1
35981_0,,,,2,2,1,3
C(C(CO)C(C(C=O)=C)O)(O)=O,,,5,1,1,0,1
35983_0,,,,2,2,1,3
C(C(CO)C(C=CC)O)(O)=O,,,5,1,1,0,1
35985_0,,,,2,2,1,3
C(C(CO)C(CC=C)O)(O)=O,,,5,1,1,0,1
35987_0,,,,2,2,1,3
C(C(CO)C(C(C=C)O)O)(O)=O,,,5,1,1,0,1
35989_0,,,,2,2,1,3
C(C(CO)C(C=C)O)(O)=O,,,5,1,1,0,1
35991_0,,,,2,2,1,3
C(C(CO)C1(C=COC1)O)(O)=O,,,5,1,1,0,1
35992_0,,,,2,2,1,3
35993_0,,,,2,2,1,3
35994_0,,,,2,2,1,3
35995_0,,,,2,2,1,3
35996_0,,,,2,2,1,3
35997_0,,,,2,2,1,3
35998_0,,,,2,2,1,3
35999_0,,,,2,2,1,3
36000_0,,,,2,2,1,3
36001_0,,,,2,2,1,3
36002_0,,,,2,2,1,3
36003_0,,,,2,2,1,3
36004_0,,,,2,2,1,3
36005_0,,,,2,2,1,3
36006_0,,,,2,2,1,3
36007_0,,,,2,2,1,3
36008_0,,,,2,2,1,3
36009_0,,,,2,2,1,3
36010_0,,,,2,2,1,3
36011_0,,,,2,2,1,3
36012_0,,,,2,2,1,3
36013_0,,,,2,2,1,3
36014_0,,,,2,2,1,3
36015_0,,,,2,2,1,3
36016_0,,,,2,2,1,3
36017_0,,,,2,2,1,3
36018_0,,,,2,2,1,3
36019_0,,,,2,2,1,3
36020_0,,,,2,2,1,3
36021_0,,,,2,2,1,3
36022_0,,,,2,2,1,3
36023_0,,,,2,2,1,3
36024_0,,,,2,2,1,3
36025_0,,,,2,2,1,3
36026_0,,,,2,2,1,3
36027_0,,,,2,2,1,3
36028_0,,,,2,2,1,3
36029_0,,,,2,2,1,3
36030_0,,,,2,2,1,3
36031_0,,,,2,2,1,3
36032_0,,,,2,2,1,3
36034_0,,,,2,2,1,3
C(C(C(CO)O)C(C=CC)O)(O)=O,,,5,1,1,0,1
36036_0,,,,2,2,1,3
C(C(C(CC=C)O)C(CO)O)(O)=O,,,5,1,1,0,1
36038_0,,,,2,2,1,3
C(C(C(CO)O)C(C=C)O)(O)=O,,,5,1,1,0,1
36039_0,,,,2,2,1,3
36040_0,,,,2,2,1,3
36041_0,,,,2,2,1,3
36042_0,,,,2,2,1,3
36043_0,,,,2,2,1,3
36044_0,,,,2,2,1,3
36045_0,,,,2,2,1,3
36046_0,,,,2,2,1,3
36047_0,,,,2,2,1,3
36048_0,,,,2,2,1,3
36049_0,,,,2,2,1,3
36049_1,,,,2,2,1,3
36050_0,,,,2,2,1,3
36050_1,,,,2,2,1,3
36051_0,,,,2,2,1,3
36051_1,,,,2,2,1,3
36052_0,,,,2,2,1,3
36052_1,,,,2,2,1,3
36053_0,,,,2,2,1,3
36053_1,,,,2,2,1,3
36054_0,,,,2,2,1,3
36056_0,,,,2,2,1,3
C(C(C(C)O)C(C=C)(CO)O)(O)=O,,,5,1,1,0,1
36058_0,,,,2,2,1,3
C(C(C(O)=O)C(C=C)(CO)O)(O)=O,,,5,1,1,0,1
36060_0,,,,2,2,1,3
C(C(C=O)(C=C)C(C=C)(CO)O)=O,,,5,1,1,0,1
36061_0,,,,2,2,1,3
36061_1,,,,2,2,1,3
36062_0,,,,2,2,1,3
36062_1,,,,2,2,1,3
36063_0,,,,2,2,1,3
36063_1,,,,2,2,1,3
36064_0,,,,2,2,1,3
36065_0,,,,2,2,1,3
36065_1,,,,2,2,1,3
36066_0,,,,2,2,1,3
36066_1,,,,2,2,1,3
36067_0,,,,2,2,1,3
36067_1,,,,2,2,1,3
36068_0,,,,2,2,1,3
36070_0,,,,2,2,1,3
C(C(C(C)O)C(C=CCO)O)(O)=O,,,5,1,1,0,1
36072_0,,,,2,2,1,3
C(C(C(O)=O)C(C=CCO)O)(O)=O,,,5,1,1,0,1
36074_0,,,,2,2,1,3
C(C(C=O)(C=C)C(C=CCO)O)=O,,,5,1,1,0,1
36075_0,,,,2,2,1,3
36075_1,,,,2,2,1,3
36076_0,,,,2,2,1,3
36076_1,,,,2,2,1,3
36077_0,,,,2,2,1,3
36077_1,,,,2,2,1,3
36078_0,,,,2,2,1,3
36079_0,,,,2,2,1,3
36079_1,,,,2,2,1,3
36080_0,,,,2,2,1,3
36080_1,,,,2,2,1,3
36081_0,,,,2,2,1,3
36081_1,,,,2,2,1,3
36082_0,,,,2,2,1,3
36083_0,,,,2,2,1,3
36084_0,,,,2,2,1,3
36086_0,,,,2,2,1,3
C(C(C)(C(C(O)=O)C(C=C)O)O)=O,,,5,1,1,0,1
36087_0,,,,2,2,1,3
36088_0,,,,2,2,1,3
36089_0,,,,2,2,1,3
36090_0,,,,2,2,1,3
36092_0,,,,2,2,1,3
C(C(C(C=C)O)C(C(C)=O)O)(O)=O,,,5,1,1,0,1
36093_0,,,,2,2,1,3
36094_0,,,,2,2,1,3
36095_0,,,,2,2,1,3
36096_0,,,,2,2,1,3
36097_0,,,,2,2,1,3
36098_0,,,,2,2,1,3
36099_0,,,,2,2,1,3
36100_0,,,,2,2,1,3
36101_0,,,,2,2,1,3
36102_0,,,,2,2,1,3
36103_0,,,,2,2,1,3
36104_0,,,,2,2,1,3
36104_1,,,,2,2,1,3
36106_0,,,,2,2,1,3
C(C(C(C)O)C(C=O)(CC)O)(O)=O,,,5,1,1,0,1
36108_0,,,,2,2,1,3
C(C(C(C)O)C(C(CC)=O)O)(O)=O,,,5,1,1,0,1
36110_0,,,,2,2,1,3
C(C(C(C)O)C(CCC=O)O)(O)=O,,,5,1,1,0,1
36112_0,,,,2,2,1,3
C(C(C(C)O)C(C(C)=O)(C)O)(O)=O,,,5,1,1,0,1
36114_0,,,,2,2,1,3
C(C(C(C)O)C(C(C=O)=C)O)(O)=O,,,5,1,1,0,1
36116_0,,,,2,2,1,3
C(C(C(C)O)C(C=CC)O)(O)=O,,,5,1,1,0,1
36118_0,,,,2,2,1,3
C(C(C(CC=C)O)C(C)O)(O)=O,,,5,1,1,0,1
36120_0,,,,2,2,1,3
C(C(C(C(C=C)O)O)C(C)O)(O)=O,,,5,1,1,0,1
36122_0,,,,2,2,1,3
C(C(C(C)O)C(C=C)O)(O)=O,,,5,1,1,0,1
36124_0,,,,2,2,1,3
C(C(C(C)O)C1(C=COC1)O)(O)=O,,,5,1,1,0,1
36125_0,,,,2,2,1,3
36126_0,,,,2,2,1,3
36127_0,,,,2,2,1,3
36128_0,,,,2,2,1,3
36129_0,,,,2,2,1,3
36130_0,,,,2,2,1,3
36131_0,,,,2,2,1,3
36132_0,,,,2,2,1,3
36133_0,,,,2,2,1,3
36134_0,,,,2,2,1,3
36135_0,,,,2,2,1,3
36136_0,,,,2,2,1,3
36137_0,,,,2,2,1,3
36138_0,,,,2,2,1,3
36139_0,,,,2,2,1,3
36140_0,,,,2,2,1,3
36141_0,,,,2,2,1,3
36142_0,,,,2,2,1,3
36143_0,,,,2,2,1,3
36144_0,,,,2,2,1,3
36145_0,,,,2,2,1,3
36146_0,,,,2,2,1,3
36147_0,,,,2,2,1,3
36147_1,,,,2,2,1,3
36149_0,,,,2,2,1,3
C(C(C(O)=O)C(C=O)(CC)O)(O)=O,,,5,1,1,0,1
36151_0,,,,2,2,1,3
C(C(C(O)=O)C(C(CC)=O)O)(O)=O,,,5,1,1,0,1
36153_0,,,,2,2,1,3
C(C(C(O)=O)C(CCC=O)O)(O)=O,,,5,1,1,0,1
36155_0,,,,2,2,1,3
C(C(C(O)=O)C(C(C)=O)(C)O)(O)=O,,,5,1,1,0,1
36157_0,,,,2,2,1,3
C(C(C(O)=O)C(C(C=O)=C)O)(O)=O,,,5,1,1,0,1
36159_0,,,,2,2,1,3
C(C(C(O)=O)C(C=CC)O)(O)=O,,,5,1,1,0,1
36161_0,,,,2,2,1,3
C(C(C(O)=O)C(CC=C)O)(O)=O,,,5,1,1,0,1
36163_0,,,,2,2,1,3
C(C(C(O)=O)C(C(C=C)O)O)(O)=O,,,5,1,1,0,1
36165_0,,,,2,2,1,3
C(C(C(O)=O)C(C=C)O)(O)=O,,,5,1,1,0,1
36167_0,,,,2,2,1,3
C(C(C(O)=O)C1(C=COC1)O)(O)=O,,,5,1,1,0,1
36168_0,,,,2,2,1,3
36169_0,,,,2,2,1,3
36170_0,,,,2,2,1,3
36171_0,,,,2,2,1,3
36172_0,,,,2,2,1,3
36173_0,,,,2,2,1,3
36174_0,,,,2,2,1,3
36175_0,,,,2,2,1,3
36176_0,,,,2,2,1,3
36177_0,,,,2,2,1,3
36178_0,,,,2,2,1,3
36179_0,,,,2,2,1,3
36180_0,,,,2,2,1,3
36181_0,,,,2,2,1,3
36182_0,,,,2,2,1,3
36183_0,,,,2,2,1,3
36184_0,,,,2,2,1,3
36185_0,,,,2,2,1,3
36186_0,,,,2,2,1,3
36187_0,,,,2,2,1,3
36189_0,,,,2,2,1,3
C(C(C(C(O)=O)C(C=C)O)O)(O)=O,,,5,1,1,0,1
36190_0,,,,2,2,1,3
36191_0,,,,2,2,1,3
36192_0,,,,2,2,1,3
36193_0,,,,2,2,1,3
36194_0,,,,2,2,1,3
36194_1,,,,2,2,1,3
36195_0,,,,2,2,1,3
36195_1,,,,2,2,1,3
36196_0,,,,2,2,1,3
36196_1,,,,2,2,1,3
36197_0,,,,2,2,1,3
36197_1,,,,2,2,1,3
36198_0,,,,2,2,1,3
36198_1,,,,2,2,1,3
36199_0,,,,2,2,1,3
36200_0,,,,2,2,1,3
36201_0,,,,2,2,1,3
36202_0,,,,2,2,1,3
36204_0,,,,2,2,1,3
C(C(C=O)(C=C)C(C(O)=O)(C=C)O)=O,,,5,1,1,0,1
36205_0,,,,2,2,1,3
36205_1,,,,2,2,1,3
36207_0,,,,2,2,1,3
C(C(C=O)(C=C)C(C=CC(O)=O)O)=O,,,5,1,1,0,1
36208_0,,,,2,2,1,3
36208_1,,,,2,2,1,3
36209_0,,,,2,2,1,3
36209_1,,,,2,2,1,3
36210_0,,,,2,2,1,3
36210_1,,,,2,2,1,3
36212_0,,,,2,2,1,3
C1(C(CO)(C(CO1)O)C(C=O)O)=O,,,5,1,2,0,2
36214_0,,,,2,2,1,3
C1(C(C(C)O)(C(C)O)C(CO1)O)=O,,,5,1,1,0,1
36216_0,,,,2,2,1,3
C1(C(CO)(C(C)O)C(CO1)O)=O,,,5,1,2,0,2
36218_0,,,,2,2,1,3
C1(C(CO)(C(CO1)O)C(C=C)O)=O,,,5,1,1,0,1
36219_0,,,,2,2,1,3
36220_0,,,,2,2,1,3
36222_0,,,,2,2,1,3
C1(C(CO)(CO)C(CO1)O)=O,,,5,1,1,0,1
36224_0,,,,2,2,1,3
C1(C(CO)(C(CO)O)C(CO1)O)=O,,,5,1,2,0,2
36225_0,,,,2,2,1,3
36226_0,,,,2,2,1,3
36226_1,,,,2,2,1,3
36227_0,,,,2,2,1,3
36227_1,,,,2,2,1,3
36228_0,,,,2,2,1,3
36228_1,,,,2,2,1,3
36229_0,,,,2,2,1,3
36229_1,,,,2,2,1,3
36230_0,,,,2,2,1,3
36230_1,,,,2,2,1,3
36232_0,,,,2,2,1,3
C(C(C(C(C=C)=O)(CO)O)O)(O)=O,,,5,1,2,0,2
36232_1,,,,2,2,1,3
36233_0,,,,2,2,1,3
36233_1,,,,2,2,1,3
36235_0,,,,2,2,1,3
C(C(CO)(C(C)O)OC(CO)=O)=O,,,5,1,2,0,2
36235_1,,,,2,2,1,3
36237_0,,,,2,2,1,3
C(C(CO)(CO)OC(CO)=O)=O,,,5,1,3,0,3
36237_1,,,,2,2,1,3
36239_0,,,,2,2,1,3
C(C(COC(CO)=O)(C(C)O)O)=O,,,5,1,2,0,2
36239_1,,,,2,2,1,3
36241_0,,,,2,2,1,3
C(C(CO)(COC(CO)=O)O)=O,,,5,1,3,0,3
36241_1,,,,2,2,1,3
36243_0,,,,2,2,1,3
C(CC(C(C(CO)(CO)O)=O)=O)=O,,,5,1,2,0,2
36243_1,,,,2,2,1,3
36245_0,,,,2,2,1,3
C(C(CO)=O)(C(CO)(CO)CO)=O,,,5,1,1,0,1
36247_0,,,,2,2,1,3
C(C(CO)(C(C)O)CC(C=O)=O)=O,,,5,1,1,0,1
36249_0,,,,2,2,1,3
C(C(CO)(CO)CC(C=O)=O)=O,,,5,1,1,0,1
36251_0,,,,2,2,1,3
C(C(C=O)(C(C)O)C(C=O)CO)=O,,,5,1,1,0,1
36253_0,,,,2,2,1,3
C(C(C=O)(CO)C(C=O)CO)=O,,,5,1,2,0,2
36255_0,,,,2,2,1,3
C(C(C=O)C(C=O)(CO)C(C)O)=O,,,5,1,1,0,1
36257_0,,,,2,2,1,3
C(C(C=O)C(C=O)(CO)CO)=O,,,5,1,1,0,1
36259_0,,,,2,2,1,3
C(CC(C=O)(CO)C(C=CC)O)=O,,,5,1,1,0,1
36261_0,,,,2,2,1,3
C(C(CO)(C(CC=C)O)CC=O)=O,,,5,1,1,0,1
36263_0,,,,2,2,1,3
C(CC(C=O)(CO)C(C=C)O)=O,,,5,1,1,0,1
36265_0,,,,2,2,1,3
C(CC(C=O)(CO)C(C=O)O)=O,,,5,1,5,0,5
36267_0,,,,2,2,1,3
C(C(C)(C(C=O)(CO)CC=O)O)=O,,,5,1,3,0,3
36269_0,,,,2,2,1,3
C(CC(C=O)(CO)C(C(C)=O)O)=O,,,5,1,4,0,4
36271_0,,,,2,2,1,3
C(C(CO)(C(CC=O)O)CC=O)=O,,,5,1,4,0,4
36273_0,,,,2,2,1,3
C(C(CO)(C(C)O)CC=O)=O,,,5,1,4,0,4
36275_0,,,,2,2,1,3
C(C(CO)(C(CCO)O)CC=O)=O,,,5,1,2,0,2
36277_0,,,,2,2,1,3
C(C(CO)(C(C)(CO)O)CC=O)=O,,,5,1,1,0,1
36279_0,,,,2,2,1,3
C(CC(C=O)(CO)C(C(O)=O)O)=O,,,5,1,3,0,3
36281_0,,,,2,2,1,3
C(C(CO)(CO)CC=O)=O,,,5,1,2,0,2
36283_0,,,,2,2,1,3
C(C(CO)(C(CO)O)CC=O)=O,,,5,1,4,0,4
36285_0,,,,2,2,1,3
C(C(C(C(CO)=O)=O)(C)C(C)O)=O,,,5,1,1,0,1
36287_0,,,,2,2,1,3
C(C(C(C(CO)=O)=O)(CO)C)=O,,,5,1,1,0,1
36289_0,,,,2,2,1,3
C(C(C(CO)O)(C(C)O)CC=O)=O,,,5,1,4,0,4
36290_0,,,,2,2,1,3
36292_0,,,,2,2,1,3
C(CO)(C(CO)(C(C)O)CC=O)=O,,,5,1,1,0,1
36294_0,,,,2,2,1,3
C(CO)(C(CO)(CO)CC=O)=O,,,5,1,1,0,1
36296_0,,,,2,2,1,3
C(C(CO)(C(C)O)O)(CC(C)=O)=O,,,5,1,2,0,2
36296_1,,,,2,2,1,3
36297_0,,,,2,2,1,3
36297_1,,,,2,2,1,3
36299_0,,,,2,2,1,3
C(C(CC)=O)(C(CO)(C(C)O)O)=O,,,5,1,2,0,2
36299_1,,,,2,2,1,3
36301_0,,,,2,2,1,3
C(C(CC)=O)(C(CO)(CO)O)=O,,,5,1,3,0,3
36301_1,,,,2,2,1,3
36303_0,,,,2,2,1,3
C(C(CCO)=O)(C(CO)(CO)O)=O,,,5,1,4,0,4
36303_1,,,,2,2,1,3
36305_0,,,,2,2,1,3
C(CC(C(CO)(CO)C(C)O)=O)=O,,,5,1,1,0,1
36307_0,,,,2,2,1,3
C(CC(C(CO)(CO)CO)=O)=O,,,5,1,1,0,1
36309_0,,,,2,2,1,3
C(C(C(C(CC=O)=O)=O)(C)CO)=O,,,5,1,1,0,1
36311_0,,,,2,2,1,3
C(C(C(C=O)=O)(C)C(C(C=O)=C)O)=O,,,5,1,1,0,1
36313_0,,,,2,2,1,3
C(C(C(C=O)=O)(C)C(C=CC)O)=O,,,5,1,1,0,1
36315_0,,,,2,2,1,3
C(C(C(C=O)=O)(C)C(CC=C)O)=O,,,5,1,1,0,1
36317_0,,,,2,2,1,3
C(C(C(C=O)=O)(C)C(C=C)O)=O,,,5,1,1,0,1
36319_0,,,,2,2,1,3
C(C(C(C=O)=O)(C)C1(C=COC1)O)=O,,,5,1,1,0,1
36321_0,,,,2,2,1,3
C(C(C(C=O)=O)(C)C(C=O)O)=O,,,5,1,1,0,1
36323_0,,,,2,2,1,3
C(C(C(C=O)=O)(C)C(C=O)(C)O)=O,,,5,1,1,0,1
36325_0,,,,2,2,1,3
C(C(C(C=O)=O)(C)C(C(C)=O)O)=O,,,5,1,1,0,1
36327_0,,,,2,2,1,3
C(C(C(C=O)=O)(C)C(CC=O)O)=O,,,5,1,1,0,1
36329_0,,,,2,2,1,3
C(C(C(C=O)=O)(C)C(C)O)=O,,,5,1,1,0,1
36331_0,,,,2,2,1,3
C(C(C(C=O)=O)(C)C(CCO)O)=O,,,5,1,1,0,1
36333_0,,,,2,2,1,3
C(C(C(C=O)=O)(C)C(C)(CO)O)=O,,,5,1,1,0,1
36335_0,,,,2,2,1,3
C(C(C(C=O)=O)(C)C(C(O)=O)O)=O,,,5,1,1,0,1
36337_0,,,,2,2,1,3
C(C(C(C=O)=O)(C)C(C=O)(C=C)O)=O,,,5,1,1,0,1
36339_0,,,,2,2,1,3
C(C(C(C=O)=O)(C)C(C(C=C)=O)O)=O,,,5,1,1,0,1
36341_0,,,,2,2,1,3
C(C(C(C=O)=O)(C)C(C=CC=O)O)=O,,,5,1,1,0,1
36343_0,,,,2,2,1,3
C(C(C(C=O)=O)(C)CO)=O,,,5,1,1,0,1
36345_0,,,,2,2,1,3
C(C(C(C=O)=O)(C)C(CO)O)=O,,,5,1,1,0,1
36347_0,,,,2,2,1,3
C(C(C=O)(CO)CC(CC=O)=O)=O,,,5,1,1,0,1
36349_0,,,,2,2,1,3
C(C(C=O)(C(CCC=O)=O)CO)=O,,,5,1,1,0,1
36350_0,,,,2,2,1,3
36352_0,,,,2,2,1,3
C(C(C=O)(CO)CC(C(C)=O)=O)=O,,,5,1,1,0,1
36354_0,,,,2,2,1,3
C(C(C=O)(C(CC(C)=O)=O)CO)=O,,,5,1,1,0,1
36356_0,,,,2,2,1,3
C(C(C=O)(CO)C(C(C=O)=O)C)=O,,,5,1,1,0,1
36358_0,,,,2,2,1,3
C(C(C=O)(C(C)O)CC(CO)=O)=O,,,5,1,1,0,1
36360_0,,,,2,2,1,3
C(C(C=O)(CO)CC(CO)=O)=O,,,5,1,2,0,2
36362_0,,,,2,2,1,3
C(C(C=O)(C(CCO)=O)C(C)O)=O,,,5,1,1,0,1
36364_0,,,,2,2,1,3
C(C(C=O)(C(CCO)=O)CO)=O,,,5,1,2,0,2
36366_0,,,,2,2,1,3
C(C(C=O)(CC=O)C(C(C=O)=C)O)=O,,,5,1,1,0,1
36368_0,,,,2,2,1,3
C(C(C=O)(CC=O)C(C=CC)O)=O,,,5,1,1,0,1
36370_0,,,,2,2,1,3
C(C(C=O)(C(CC=C)O)CC=O)=O,,,5,1,1,0,1
36372_0,,,,2,2,1,3
C(C(C=O)(CC=O)C(C=C)O)=O,,,5,1,1,0,1
36374_0,,,,2,2,1,3
C(C(C=O)(CC=O)C1(C=COC1)O)=O,,,5,1,1,0,1
36376_0,,,,2,2,1,3
C(C(C=O)(CC=O)C(C=O)O)=O,,,5,1,3,0,3
36378_0,,,,2,2,1,3
C(C(C)(C(C=O)(C=O)CC=O)O)=O,,,5,1,2,0,2
36380_0,,,,2,2,1,3
C(C(C=O)(CC=O)C(C(C)=O)O)=O,,,5,1,2,0,2
36382_0,,,,2,2,1,3
C(CC(C(C=O)(C=O)CC=O)O)=O,,,5,1,2,0,2
36384_0,,,,2,2,1,3
C(C(C=O)(C(C)O)CC=O)=O,,,5,1,3,0,3
36386_0,,,,2,2,1,3
C(C(C=O)(C(CCO)O)CC=O)=O,,,5,1,2,0,2
36388_0,,,,2,2,1,3
C(C(C=O)(C(C)(CO)O)CC=O)=O,,,5,1,1,0,1
36390_0,,,,2,2,1,3
C(C(C=O)(CC=O)C(C(O)=O)O)=O,,,5,1,2,0,2
36392_0,,,,2,2,1,3
C(C(C=O)(CC=O)C(C=O)(C=C)O)=O,,,5,1,2,0,2
36394_0,,,,2,2,1,3
C(C(C=O)(CC=O)C(C(C=C)=O)O)=O,,,5,1,2,0,2
36396_0,,,,2,2,1,3
C(C(C=O)(CC=O)C(C=CC=O)O)=O,,,5,1,2,0,2
36398_0,,,,2,2,1,3
C(C(C=O)(CO)CC=O)=O,,,5,1,3,0,3
36400_0,,,,2,2,1,3
C(C(C=O)(C(CO)O)CC=O)=O,,,5,1,3,0,3
36402_0,,,,2,2,1,3
C(C(C(C=O)=O)(CCO)C(C)O)=O,,,5,1,1,0,1
36404_0,,,,2,2,1,3
C(C(C(C=O)=O)(CO)CCO)=O,,,5,1,1,0,1
36406_0,,,,2,2,1,3
C(CC(C(C=O)=O)(CO)C(C)O)=O,,,5,1,2,0,2
36408_0,,,,2,2,1,3
C(CC(C(C=O)=O)(CO)CO)=O,,,5,1,3,0,3
36410_0,,,,2,2,1,3
C(C)(C(C(C=O)=O)(CO)C(C)O)=O,,,5,1,1,0,1
36412_0,,,,2,2,1,3
C(C)(C(C(C=O)=O)(CO)CO)=O,,,5,1,2,0,2
36414_0,,,,2,2,1,3
C(C(C(CCC=O)=O)(C(C)O)O)=O,,,5,1,2,0,2
36414_1,,,,2,2,1,3
36415_0,,,,2,2,1,3
36415_1,,,,2,2,1,3
36417_0,,,,2,2,1,3
C(CC(C=O)(C(C)O)C(C=O)O)=O,,,5,1,4,0,4
36418_0,,,,2,2,1,3
36420_0,,,,2,2,1,3
C(C)(C(C=O)(C(C)O)C(C=O)O)=O,,,5,1,1,0,1
36422_0,,,,2,2,1,3
C(C)(C(C=O)(CO)C(C=O)O)=O,,,5,1,3,0,3
36424_0,,,,2,2,1,3
C(CO)(C(C=O)(C(C)O)CC=O)=O,,,5,1,2,0,2
36426_0,,,,2,2,1,3
C(CO)(C(C=O)(CO)CC=O)=O,,,5,1,3,0,3
36428_0,,,,2,2,1,3
C(C)(C(C=O)(C(CO)=O)C(C)O)=O,,,5,1,1,0,1
36430_0,,,,2,2,1,3
C(C)(C(C=O)(C(CO)=O)CO)=O,,,5,1,2,0,2
36432_0,,,,2,2,1,3
C(CC=O)(C(C(C)=O)(C(C)O)O)=O,,,5,1,2,0,2
36432_1,,,,2,2,1,3
36434_0,,,,2,2,1,3
C(CC=O)(C(C(C)=O)(CO)O)=O,,,5,1,5,0,5
36434_1,,,,2,2,1,3
36436_0,,,,2,2,1,3
C(C(C(CC(C)=O)=O)(C(C)O)O)=O,,,5,1,2,0,2
36436_1,,,,2,2,1,3
36437_0,,,,2,2,1,3
36437_1,,,,2,2,1,3
36439_0,,,,2,2,1,3
C(C(C(C(C=O)=O)(C)C(C)O)O)=O,,,5,1,1,0,1
36441_0,,,,2,2,1,3
C(C(C(C(C=O)=O)(CO)C)O)=O,,,5,1,1,0,1
36443_0,,,,2,2,1,3
C(C(C=O)(C=C)C(C=O)(CC)O)=O,,,5,1,1,0,1
36445_0,,,,2,2,1,3
C(C(CC)(C(C=O)(CO)O)O)=O,,,5,1,2,0,2
36445_1,,,,2,2,1,3
36447_0,,,,2,2,1,3
C(C(CO)(C(C=O)(CC)O)O)(O)=O,,,5,1,2,0,2
36447_1,,,,2,2,1,3
36449_0,,,,2,2,1,3
C(C(CC)(C(C=O)(C(C)=O)O)O)=O,,,5,1,2,0,2
36449_1,,,,2,2,1,3
36451_0,,,,2,2,1,3
C(C(C=O)(CO)C(C=O)(CC)O)=O,,,5,1,1,0,1
36453_0,,,,2,2,1,3
C(C(CC)(C(C=O)(C(C)O)O)O)=O,,,5,1,2,0,2
36453_1,,,,2,2,1,3
36455_0,,,,2,2,1,3
C(C(CC)(C(C(C)=O)(CO)O)O)=O,,,5,1,2,0,2
36455_1,,,,2,2,1,3
36457_0,,,,2,2,1,3
C(C(CC)(C1(C(COC1)=O)O)O)=O,,,5,1,2,0,2
36457_1,,,,2,2,1,3
36459_0,,,,2,2,1,3
C1(C(C(CO1)O)C(C=O)(CC)O)=O,,,5,1,1,0,1
36461_0,,,,2,2,1,3
C(C(C=O)(C=C)C(C(CC)=O)O)=O,,,5,1,1,0,1
36463_0,,,,2,2,1,3
C(C(CO)(C(C(CC)=O)O)O)=O,,,5,1,3,0,3
36463_1,,,,2,2,1,3
36465_0,,,,2,2,1,3
C(C(CO)(C(C(CC)=O)O)O)(O)=O,,,5,1,2,0,2
36465_1,,,,2,2,1,3
36467_0,,,,2,2,1,3
C(C)(C(C=O)(C(C(CC)=O)O)O)=O,,,5,1,2,0,2
36467_1,,,,2,2,1,3
36469_0,,,,2,2,1,3
C(C(C=O)(CO)C(C(CC)=O)O)=O,,,5,1,1,0,1
36471_0,,,,2,2,1,3
C(C(C(C)O)(C(C(CC)=O)O)O)=O,,,5,1,2,0,2
36471_1,,,,2,2,1,3
36473_0,,,,2,2,1,3
C(C)(C(CO)(C(C(CC)=O)O)O)=O,,,5,1,2,0,2
36473_1,,,,2,2,1,3
36475_0,,,,2,2,1,3
C1(COCC1(C(C(CC)=O)O)O)=O,,,5,1,2,0,2
36475_1,,,,2,2,1,3
36477_0,,,,2,2,1,3
C1(C(C(CO1)O)C(C(CC)=O)O)=O,,,5,1,1,0,1
36479_0,,,,2,2,1,3
C(CCC=O)(C(CO)(C(C)O)O)=O,,,5,1,2,0,2
36479_1,,,,2,2,1,3
36480_0,,,,2,2,1,3
36480_1,,,,2,2,1,3
36482_0,,,,2,2,1,3
C(C(C=O)(C=C)C(CCC=O)O)=O,,,5,1,1,0,1
36484_0,,,,2,2,1,3
C(C(CO)(C(CCC=O)O)O)=O,,,5,1,4,0,4
36484_1,,,,2,2,1,3
36486_0,,,,2,2,1,3
C(C(CO)(C(CCC=O)O)O)(O)=O,,,5,1,3,0,3
36486_1,,,,2,2,1,3
36488_0,,,,2,2,1,3
C(CCC(C(C=O)(C(C)=O)O)O)=O,,,5,1,3,0,3
36488_1,,,,2,2,1,3
36490_0,,,,2,2,1,3
C(C(C=O)(CO)C(CCC=O)O)=O,,,5,1,2,0,2
36492_0,,,,2,2,1,3
C(C(C(C)O)(C(CCC=O)O)O)=O,,,5,1,3,0,3
36492_1,,,,2,2,1,3
36494_0,,,,2,2,1,3
C(CCC(C(C(C)=O)(CO)O)O)=O,,,5,1,3,0,3
36494_1,,,,2,2,1,3
36496_0,,,,2,2,1,3
C(CCC(C1(C(COC1)=O)O)O)=O,,,5,1,3,0,3
36496_1,,,,2,2,1,3
36498_0,,,,2,2,1,3
C1(C(C(CO1)O)C(CCC=O)O)=O,,,5,1,2,0,2
36500_0,,,,2,2,1,3
C(C(C=O)(C=C)C(C(C)=O)(C)O)=O,,,5,1,1,0,1
36502_0,,,,2,2,1,3
C(C(CO)(C(C(C)=O)(C)O)O)=O,,,5,1,3,0,3
36502_1,,,,2,2,1,3
36504_0,,,,2,2,1,3
C(C(CO)(C(C(C)=O)(C)O)O)(O)=O,,,5,1,2,0,2
36504_1,,,,2,2,1,3
36506_0,,,,2,2,1,3
C(C(C(C)=O)(C(C(C)=O)(C)O)O)=O,,,5,1,2,0,2
36506_1,,,,2,2,1,3
36508_0,,,,2,2,1,3
C(C(C=O)(CO)C(C(C)=O)(C)O)=O,,,5,1,1,0,1
36510_0,,,,2,2,1,3
C(C(C(C)O)(C(C(C)=O)(C)O)O)=O,,,5,1,2,0,2
36510_1,,,,2,2,1,3
36512_0,,,,2,2,1,3
C(C)(C(CO)(C(C(C)=O)(C)O)O)=O,,,5,1,2,0,2
36512_1,,,,2,2,1,3
36514_0,,,,2,2,1,3
C(C)(C(C)(C1(C(COC1)=O)O)O)=O,,,5,1,2,0,2
36514_1,,,,2,2,1,3
36516_0,,,,2,2,1,3
C1(C(C(CO1)O)C(C(C)=O)(C)O)=O,,,5,1,1,0,1
36517_0,,,,2,2,1,3
36518_0,,,,2,2,1,3
36520_0,,,,2,2,1,3
C(C(C(C)=O)(C(C=O)=O)C(C=C)O)=O,,,5,1,1,0,1
36522_0,,,,2,2,1,3
C(C(C(C)=O)(C(C=O)=O)C(C)O)=O,,,5,1,1,0,1
36524_0,,,,2,2,1,3
C(C(C(C)=O)(C(C=O)=O)CO)=O,,,5,1,1,0,1
36525_0,,,,2,2,1,3
36527_0,,,,2,2,1,3
C(C)(C(C(CO)=O)(CO)C(C)O)=O,,,5,1,1,0,1
36529_0,,,,2,2,1,3
C(C)(C(C(CO)=O)(CO)CO)=O,,,5,1,1,0,1
36531_0,,,,2,2,1,3
C(CO)(C(C(CO)=O)(CO)CO)=O,,,5,1,1,0,1
36533_0,,,,2,2,1,3
C(C(C(C(C)=O)=O)(CO)CO)(O)=O,,,5,1,1,0,1
36534_0,,,,2,2,1,3
36536_0,,,,2,2,1,3
C(C)(C(C(O)=O)(CO)C(C=C)O)=O,,,5,1,1,0,1
36538_0,,,,2,2,1,3
C(C)(C(C(O)=O)(CO)C(C=O)O)=O,,,5,1,1,0,1
36540_0,,,,2,2,1,3
C(C(C(C)=O)(CO)C(C)O)(O)=O,,,5,1,1,0,1
36542_0,,,,2,2,1,3
C(C(C(C)=O)(CO)CO)(O)=O,,,5,1,1,0,1
36544_0,,,,2,2,1,3
C(C(C(C)=O)(CO)C(CO)O)(O)=O,,,5,1,2,0,2
36545_0,,,,2,2,1,3
36547_0,,,,2,2,1,3
C(C(C(C)=O)(C(C(C)=O)=O)CO)=O,,,5,1,1,0,1
36549_0,,,,2,2,1,3
C(C(C(C(C)=O)=O)(CO)C(C)O)=O,,,5,1,1,0,1
36551_0,,,,2,2,1,3
C(C(C(C(C)=O)=O)(CO)CO)=O,,,5,1,2,0,2
36553_0,,,,2,2,1,3
C(C(C(CC=O)=O)(C(C)=O)CO)=O,,,5,1,1,0,1
36555_0,,,,2,2,1,3
C(C(C(CC=O)=O)(CO)C(C)O)=O,,,5,1,1,0,1
36557_0,,,,2,2,1,3
C(C(C(CC=O)=O)(CO)CO)=O,,,5,1,2,0,2
36559_0,,,,2,2,1,3
C(C(C(C)=O)(C(C)=O)C(C=CC)O)=O,,,5,1,1,0,1
36561_0,,,,2,2,1,3
C(C(C(C)=O)(C(C)=O)C(CC=C)O)=O,,,5,1,1,0,1
36563_0,,,,2,2,1,3
C(C(C(C)=O)(C(C)=O)C(C=C)O)=O,,,5,1,1,0,1
36565_0,,,,2,2,1,3
C(C(C(C)=O)(C(C)=O)C(C=O)O)=O,,,5,1,1,0,1
36567_0,,,,2,2,1,3
C(C(C(C)=O)(C(C)=O)C(C)O)=O,,,5,1,1,0,1
36569_0,,,,2,2,1,3
C(C(C(C)=O)(C(C)=O)CO)=O,,,5,1,1,0,1
36571_0,,,,2,2,1,3
C(C(C(C)=O)(C(C)=O)C(CO)O)=O,,,5,1,1,0,1
36573_0,,,,2,2,1,3
C(C)(C(C=O)(CO)C(C=CC)O)=O,,,5,1,1,0,1
36575_0,,,,2,2,1,3
C(C(C(C)=O)(CO)C(CC=C)O)=O,,,5,1,1,0,1
36577_0,,,,2,2,1,3
C(C)(C(C=O)(CO)C(C=C)O)=O,,,5,1,1,0,1
36578_0,,,,2,2,1,3
36580_0,,,,2,2,1,3
C(C(C)(C(C=O)(C(C)=O)CO)O)=O,,,5,1,1,0,1
36582_0,,,,2,2,1,3
C(C)(C(C=O)(CO)C(C(C)=O)O)=O,,,5,1,1,0,1
36584_0,,,,2,2,1,3
C(CC(C(C=O)(C(C)=O)CO)O)=O,,,5,1,1,0,1
36586_0,,,,2,2,1,3
C(C(C(C)=O)(CO)C(C)O)=O,,,5,1,1,0,1
36588_0,,,,2,2,1,3
C(C(C(C)=O)(CO)C(CCO)O)=O,,,5,1,1,0,1
36590_0,,,,2,2,1,3
C(C(C(C)=O)(CO)C(C)(CO)O)=O,,,5,1,1,0,1
36592_0,,,,2,2,1,3
C(C)(C(C=O)(CO)C(C(O)=O)O)=O,,,5,1,1,0,1
36594_0,,,,2,2,1,3
C(C(C(C)=O)(CO)CO)=O,,,5,1,1,0,1
36596_0,,,,2,2,1,3
C(C(C(C)=O)(CO)C(CO)O)=O,,,5,1,2,0,2
36598_0,,,,2,2,1,3
C(C(C(C)=O)(C(CO)O)C(C)O)=O,,,5,1,1,0,1
36599_0,,,,2,2,1,3
36601_0,,,,2,2,1,3
C(C(C(C=O)=O)(CC=O)C(C=C)O)=O,,,5,1,1,0,1
36603_0,,,,2,2,1,3
C(C(C(C=O)=O)(C(C)O)CC=O)=O,,,5,1,1,0,1
36605_0,,,,2,2,1,3
C(C(C(C=O)=O)(CO)CC=O)=O,,,5,1,1,0,1
36607_0,,,,2,2,1,3
C(C(C(C(O)=O)=O)(C)C(C=C)O)=O,,,5,1,1,0,1
36609_0,,,,2,2,1,3
C(C(C(C(O)=O)=O)(C)C(C=O)O)=O,,,5,1,1,0,1
36611_0,,,,2,2,1,3
C(C(C(C(O)=O)=O)(C)C(C)O)=O,,,5,1,1,0,1
36613_0,,,,2,2,1,3
C(C(C(C(O)=O)=O)(C)CO)=O,,,5,1,1,0,1
36615_0,,,,2,2,1,3
C(C(C(C(O)=O)=O)(C)C(CO)O)=O,,,5,1,1,0,1
36617_0,,,,2,2,1,3
C(C(C(C(C)=O)=O)(CO)CC=O)=O,,,5,1,1,0,1
36619_0,,,,2,2,1,3
C(C(C(CC=O)=O)(CO)CC=O)=O,,,5,1,1,0,1
36621_0,,,,2,2,1,3
C(C(C(C(O)=O)=O)(CO)CCO)=O,,,5,1,1,0,1
36623_0,,,,2,2,1,3
C(C(C(C)=O)(CC=O)C(C=CC)O)=O,,,5,1,1,0,1
36625_0,,,,2,2,1,3
C(C)(C(C=O)(C(CC=C)O)CC=O)=O,,,5,1,1,0,1
36627_0,,,,2,2,1,3
C(C(C(C)=O)(CC=O)C(C=C)O)=O,,,5,1,1,0,1
36629_0,,,,2,2,1,3
C(C(C(C)=O)(CC=O)C(C=O)O)=O,,,5,1,1,0,1
36631_0,,,,2,2,1,3
C(C)(C(C=O)(C(C)O)CC=O)=O,,,5,1,1,0,1
36633_0,,,,2,2,1,3
C(C)(C(C=O)(CO)CC=O)=O,,,5,1,1,0,1
36635_0,,,,2,2,1,3
C(C)(C(C=O)(C(CO)O)CC=O)=O,,,5,1,1,0,1
36636_0,,,,2,2,1,3
36636_1,,,,2,2,1,3
36638_0,,,,2,2,1,3
C(CC(C(C(O)=O)=O)(CO)CO)=O,,,5,1,1,0,1
36639_0,,,,2,2,1,3
36641_0,,,,2,2,1,3
C(CC(O)=O)(C(C(C)=O)(CO)O)=O,,,5,1,2,0,2
36641_1,,,,2,2,1,3
36642_0,,,,2,2,1,3
36642_1,,,,2,2,1,3
36644_0,,,,2,2,1,3
C(C(C(C(C(O)=O)=O)(CO)C)O)=O,,,5,1,1,0,1
36646_0,,,,2,2,1,3
C(C(C(C(C=O)=O)(CO)C)O)(O)=O,,,5,1,1,0,1
36648_0,,,,2,2,1,3
C(C(CC)(C(C=O)(CO)O)O)(O)=O,,,5,1,2,0,2
36648_1,,,,2,2,1,3
36649_0,,,,2,2,1,3
36649_1,,,,2,2,1,3
36651_0,,,,2,2,1,3
C1(COC(CO)C1(C(C=C)O)O)=O,,,5,1,2,0,2
36651_1,,,,2,2,1,3
36653_0,,,,2,2,1,3
C1(COC(CO)C1(C(C=O)O)O)=O,,,5,1,2,0,2
36653_1,,,,2,2,1,3
36655_0,,,,2,2,1,3
C1(COC(CO)C1(C(C)O)O)=O,,,5,1,2,0,2
36655_1,,,,2,2,1,3
36657_0,,,,2,2,1,3
C1(COC(CO)C1(CO)O)=O,,,5,1,3,0,3
36657_1,,,,2,2,1,3
36659_0,,,,2,2,1,3
C1(COC(CO)C1(C(CO)O)O)=O,,,5,1,2,0,2
36659_1,,,,2,2,1,3
36661_0,,,,2,2,1,3
C1(C(C(C(CO)O1)O)C(C=C)O)=O,,,5,1,1,0,1
36663_0,,,,2,2,1,3
C1(C(C(C(CO)O1)O)C(C=O)O)=O,,,5,1,1,0,1
36665_0,,,,2,2,1,3
C1(C(C(C)O)C(C(CO)O1)O)=O,,,5,1,2,0,2
36666_0,,,,2,2,1,3
36668_0,,,,2,2,1,3
C1(C(C(CO)O)C(C(CO)O1)O)=O,,,5,1,2,0,2
36670_0,,,,2,2,1,3
C1(COC(C(CO)O)C1(CO)O)=O,,,5,1,2,0,2
36670_1,,,,2,2,1,3
36672_0,,,,2,2,1,3
C1(C(CO)C(C(C(CO)O)O1)O)=O,,,5,1,1,0,1
36674_0,,,,2,2,1,3
C(C)(C1(CO)C(C(C(O1)O)O)O)=O,,,5,1,3,0,3
36674_1,,,,2,2,1,3
36676_0,,,,2,2,1,3
C1(C(CO)(CO)OC(C1CO)O)=O,,,5,1,3,0,3
36676_1,,,,2,2,1,3
36678_0,,,,2,2,1,3
C1(C(CO)OC(C1(CO)CO)O)=O,,,5,1,2,0,2
36680_0,,,,2,2,1,3
C1(C(CO)(CO)C(C(CO)O1)O)=O,,,5,1,1,0,1
36682_0,,,,2,2,1,3
C(C1(C(O)OC(CO)C1O)CO)=O,,,5,1,2,0,2
36684_0,,,,2,2,1,3
C(C1(C(O)OCC1O)C(C=C)O)=O,,,5,1,1,0,1
36686_0,,,,2,2,1,3
C(C1(C(O)OCC1O)C(C=O)O)=O,,,5,1,2,0,2
36688_0,,,,2,2,1,3
C(C1(C(O)OCC1O)C(C)O)=O,,,5,1,2,0,2
36690_0,,,,2,2,1,3
C(C1(C(O)OCC1O)CO)=O,,,5,1,2,0,2
36692_0,,,,2,2,1,3
C(C1(C(O)OCC1O)C(CO)O)=O,,,5,1,2,0,2
36694_0,,,,2,2,1,3
C(CO)(C1(C(O)OCC1O)CO)=O,,,5,1,2,0,2
36696_0,,,,2,2,1,3
C1(COCC(C1(C(C=C)O)O)O)=O,,,5,1,2,0,2
36696_1,,,,2,2,1,3
36698_0,,,,2,2,1,3
C1(COCC(C1(C(C=O)O)O)O)=O,,,5,1,2,0,2
36698_1,,,,2,2,1,3
36700_0,,,,2,2,1,3
C1(COCC(C1(C(C)O)O)O)=O,,,5,1,2,0,2
36700_1,,,,2,2,1,3
36702_0,,,,2,2,1,3
C1(COCC(C1(CO)O)O)=O,,,5,1,3,0,3
36702_1,,,,2,2,1,3
36704_0,,,,2,2,1,3
C1(COCC(C1(C(CO)O)O)O)=O,,,5,1,2,0,2
36704_1,,,,2,2,1,3
36706_0,,,,2,2,1,3
C1(C(C(C(CO1)O)O)C(C=C)O)=O,,,5,1,1,0,1
36708_0,,,,2,2,1,3
C1(C(C(C(CO1)O)O)C(C=O)O)=O,,,5,1,1,0,1
36710_0,,,,2,2,1,3
C1(C(C(C)O)C(C(CO1)O)O)=O,,,5,1,2,0,2
36711_0,,,,2,2,1,3
36713_0,,,,2,2,1,3
C1(C(C(CO)O)C(C(CO1)O)O)=O,,,5,1,2,0,2
36715_0,,,,2,2,1,3
C1(C(COC(C1)O)(C(C=C)O)O)=O,,,5,1,2,0,2
36715_1,,,,2,2,1,3
36717_0,,,,2,2,1,3
C1(C(COC(C1)O)(C(C=O)O)O)=O,,,5,1,3,0,3
36717_1,,,,2,2,1,3
36719_0,,,,2,2,1,3
C1(CC(O)OCC1(C(C)O)O)=O,,,5,1,3,0,3
36719_1,,,,2,2,1,3
36721_0,,,,2,2,1,3
C1(CC(O)OCC1(CO)O)=O,,,5,1,4,0,4
36721_1,,,,2,2,1,3
36723_0,,,,2,2,1,3
C1(CC(O)OCC1(C(CO)O)O)=O,,,5,1,3,0,3
36723_1,,,,2,2,1,3
36725_0,,,,2,2,1,3
C1(C(C(O)OCC1)(C(C=C)O)O)=O,,,5,1,2,0,2
36725_1,,,,2,2,1,3
36727_0,,,,2,2,1,3
C1(C(C(O)OCC1)(C(C=O)O)O)=O,,,5,1,3,0,3
36727_1,,,,2,2,1,3
36729_0,,,,2,2,1,3
C1(CCOC(C1(C(C)O)O)O)=O,,,5,1,4,0,4
36729_1,,,,2,2,1,3
36730_0,,,,2,2,1,3
36730_1,,,,2,2,1,3
36732_0,,,,2,2,1,3
C1(CCOC(C1(C(CO)O)O)O)=O,,,5,1,3,0,3
36732_1,,,,2,2,1,3
36734_0,,,,2,2,1,3
C1(COC(CO)C(C1(CO)O)O)=O,,,5,1,2,0,2
36734_1,,,,2,2,1,3
36736_0,,,,2,2,1,3
C1(C(CO)C(C(C(CO)O1)O)O)=O,,,5,1,1,0,1
36738_0,,,,2,2,1,3
C1(CC(C(OC1(CO)CO)O)O)=O,,,5,1,3,0,3
36738_1,,,,2,2,1,3
36740_0,,,,2,2,1,3
C1(CC(O)OC(CO)C1(CO)O)=O,,,5,1,3,0,3
36740_1,,,,2,2,1,3
36742_0,,,,2,2,1,3
C1(CC(CO)OC(C1(CO)O)O)=O,,,5,1,3,0,3
36742_1,,,,2,2,1,3
36744_0,,,,2,2,1,3
C1(C(COC(C1CO)O)(CO)O)=O,,,5,1,3,0,3
36744_1,,,,2,2,1,3
36746_0,,,,2,2,1,3
C1(C(COC(C1(CO)CO)O)O)=O,,,5,1,2,0,2
36748_0,,,,2,2,1,3
C1(C(CO)(CO)C(C(CO1)O)O)=O,,,5,1,1,0,1
36750_0,,,,2,2,1,3
C(C1(C(O)OCC(C1O)O)CO)=O,,,5,1,2,0,2
36752_0,,,,2,2,1,3
C1(COCC(C(C1(CO)O)O)O)=O,,,5,1,2,0,2
36752_1,,,,2,2,1,3
36754_0,,,,2,2,1,3
C1(C(CO)C(C(C(CO1)O)O)O)=O,,,5,1,1,0,1
36756_0,,,,2,2,1,3
C1(CC(C(O)OCC1(CO)O)O)=O,,,5,1,3,0,3
36756_1,,,,2,2,1,3
36758_0,,,,2,2,1,3
C1(CCOC(C(C1(CO)O)O)O)=O,,,5,1,3,0,3
36758_1,,,,2,2,1,3
36760_0,,,,2,2,1,3
C1(CC(O)OCC(C1(CO)O)O)=O,,,5,1,3,0,3
36760_1,,,,2,2,1,3
36762_0,,,,2,2,1,3
C1(CC(COC(C1(CO)O)O)O)=O,,,5,1,3,0,3
36762_1,,,,2,2,1,3
36764_0,,,,2,2,1,3
C(C(C=O)(C=C)C1(C(OCC1)=O)O)=O,,,5,1,1,0,1
36766_0,,,,2,2,1,3
C1(C(CCO1)(C(C=O)(CO)O)O)=O,,,5,1,3,0,3
36766_1,,,,2,2,1,3
36768_0,,,,2,2,1,3
C(C(C=O)(C=C)C1(COC(C1)=O)O)=O,,,5,1,1,0,1
36770_0,,,,2,2,1,3
C(C(CO)(C1(COC(C1)=O)O)O)=O,,,5,1,2,0,2
36770_1,,,,2,2,1,3
36772_0,,,,2,2,1,3
C1(C(CO)(C(C=C)O)OC(C1)=O)=O,,,5,1,2,0,2
36772_1,,,,2,2,1,3
36774_0,,,,2,2,1,3
C1(C(CO)(C(C=O)O)OC(C1)=O)=O,,,5,1,2,0,2
36774_1,,,,2,2,1,3
36776_0,,,,2,2,1,3
C1(CC(C(CO)(C(C)O)O1)=O)=O,,,5,1,3,0,3
36776_1,,,,2,2,1,3
36778_0,,,,2,2,1,3
C1(CC(C(CO)(CO)O1)=O)=O,,,5,1,4,0,4
36778_1,,,,2,2,1,3
36780_0,,,,2,2,1,3
C1(CC(C(CO)(C(CO)O)O1)=O)=O,,,5,1,4,0,4
36780_1,,,,2,2,1,3
36781_0,,,,2,2,1,3
36781_1,,,,2,2,1,3
36783_0,,,,2,2,1,3
C1(C(CO)(C(C(CC=O)O1)O)O)=O,,,5,1,2,0,2
36783_1,,,,2,2,1,3
36785_0,,,,2,2,1,3
C1(C(CO)(C(C(C(C)=O)O1)O)O)=O,,,5,1,2,0,2
36785_1,,,,2,2,1,3
36787_0,,,,2,2,1,3
C1(C(C(C(C(C)=O)(CO)O1)O)O)=O,,,5,1,2,0,2
36787_1,,,,2,2,1,3
36789_0,,,,2,2,1,3
C1(C(COC(C1)=O)(C(C=C)O)O)=O,,,5,1,2,0,2
36789_1,,,,2,2,1,3
36791_0,,,,2,2,1,3
C1(C(COC(C1)=O)(C(C=O)O)O)=O,,,5,1,2,0,2
36791_1,,,,2,2,1,3
36793_0,,,,2,2,1,3
C1(CC(C(CO1)(C(C)O)O)=O)=O,,,5,1,3,0,3
36793_1,,,,2,2,1,3
36795_0,,,,2,2,1,3
C1(CC(C(CO)(CO1)O)=O)=O,,,5,1,4,0,4
36795_1,,,,2,2,1,3
36797_0,,,,2,2,1,3
C1(CC(C(CO1)(C(CO)O)O)=O)=O,,,5,1,2,0,2
36797_1,,,,2,2,1,3
36799_0,,,,2,2,1,3
C1(CCOC(C1(C(C=C)O)O)=O)=O,,,5,1,2,0,2
36799_1,,,,2,2,1,3
36801_0,,,,2,2,1,3
C1(CCOC(C1(C(C=O)O)O)=O)=O,,,5,1,2,0,2
36801_1,,,,2,2,1,3
36803_0,,,,2,2,1,3
C1(C(C(CCO1)=O)(C(C)O)O)=O,,,5,1,4,0,4
36803_1,,,,2,2,1,3
36805_0,,,,2,2,1,3
C1(C(C(CCO1)=O)(CO)O)=O,,,5,1,4,0,4
36805_1,,,,2,2,1,3
36807_0,,,,2,2,1,3
C1(C(C(CCO1)=O)(C(CO)O)O)=O,,,5,1,2,0,2
36807_1,,,,2,2,1,3
36809_0,,,,2,2,1,3
C1(CC(C(OC1(CO)CO)=O)O)=O,,,5,1,2,0,2
36809_1,,,,2,2,1,3
36811_0,,,,2,2,1,3
C1(CC(C(CO)(C(CO)O1)O)=O)=O,,,5,1,2,0,2
36811_1,,,,2,2,1,3
36813_0,,,,2,2,1,3
C1(C(C(CC(CO)O1)=O)(CO)O)=O,,,5,1,2,0,2
36813_1,,,,2,2,1,3
36815_0,,,,2,2,1,3
C1(CC(C(OCC1(CO)O)=O)O)=O,,,5,1,2,0,2
36815_1,,,,2,2,1,3
36817_0,,,,2,2,1,3
C1(C(CO)(C(C(CCO1)=O)O)O)=O,,,5,1,2,0,2
36817_1,,,,2,2,1,3
36819_0,,,,2,2,1,3
C1(C(CO)(C(C(OCC1)=O)O)O)=O,,,5,1,2,0,2
36819_1,,,,2,2,1,3
36821_0,,,,2,2,1,3
C1(CC(C(CO)(C(CO1)O)O)=O)=O,,,5,1,2,0,2
36821_1,,,,2,2,1,3
36823_0,,,,2,2,1,3
C1(C(C(CC(CO1)O)=O)(CO)O)=O,,,5,1,2,0,2
36823_1,,,,2,2,1,3
36825_0,,,,2,2,1,3
C1(C(CO)(C(CC(CO1)=O)O)O)=O,,,5,1,2,0,2
36825_1,,,,2,2,1,3
36827_0,,,,2,2,1,3
C(C(C(C=CC=O)=O)(C(C=C)O)O)=O,,,5,1,2,0,2
36827_1,,,,2,2,1,3
36829_0,,,,2,2,1,3
C(C(C(C=CC=O)=O)(C(C)O)O)=O,,,5,1,2,0,2
36829_1,,,,2,2,1,3
36831_0,,,,2,2,1,3
C(C(C(C=CC=O)=O)(CO)O)=O,,,5,1,3,0,3
36831_1,,,,2,2,1,3
36833_0,,,,2,2,1,3
C(C(CO)(C(C)O)O)(C(C=C)O)=O,,,5,1,2,0,2
36833_1,,,,2,2,1,3
36835_0,,,,2,2,1,3
C(C(CO)(CO)O)(C(C=C)O)=O,,,5,1,3,0,3
36835_1,,,,2,2,1,3
36837_0,,,,2,2,1,3
C(C(C=O)(C(C=O)=C)C(C=CC)O)=O,,,5,1,1,0,1
36839_0,,,,2,2,1,3
C(C(C=O)(C(C=O)=C)C(CC=C)O)=O,,,5,1,1,0,1
36841_0,,,,2,2,1,3
C(C(C=O)(C(C=O)=C)C(C=C)O)=O,,,5,1,1,0,1
36843_0,,,,2,2,1,3
C(C(C=O)(C(C=O)=C)C(C=O)O)=O,,,5,1,1,0,1
36845_0,,,,2,2,1,3
C(C(C=O)(C(C=O)=C)C(C=O)(C)O)=O,,,5,1,1,0,1
36847_0,,,,2,2,1,3
C(C(C=O)(C(C=O)=C)C(C(C)=O)O)=O,,,5,1,1,0,1
36849_0,,,,2,2,1,3
C(C(C=O)(C(C=O)=C)C(CC=O)O)=O,,,5,1,1,0,1
36851_0,,,,2,2,1,3
C(C(C=O)(C(C=O)=C)C(C)O)=O,,,5,1,2,0,2
36853_0,,,,2,2,1,3
C(C(C=O)(C(C=O)=C)CO)=O,,,5,1,2,0,2
36855_0,,,,2,2,1,3
C(C(C=O)(C(C=O)=C)C(CO)O)=O,,,5,1,1,0,1
36857_0,,,,2,2,1,3
C=C(C=O)C(C(C=O)=O)(CO)CO,,,5,1,1,0,1
36859_0,,,,2,2,1,3
C(C(C(C=O)=C)(CO)C(C=O)O)=O,,,5,1,1,0,1
36861_0,,,,2,2,1,3
C(C(C(CO)=O)(C(C=O)=C)CO)=O,,,5,1,1,0,1
36863_0,,,,2,2,1,3
C(C(C(C=C(C=O)C)=O)(CO)O)=O,,,5,1,2,0,2
36863_1,,,,2,2,1,3
36865_0,,,,2,2,1,3
C(C(C(CC(C=O)=C)=O)(CO)O)=O,,,5,1,2,0,2
36865_1,,,,2,2,1,3
36867_0,,,,2,2,1,3
C(C(C=O)(C=C)C(C=C(C=O)C)O)=O,,,5,1,1,0,1
36869_0,,,,2,2,1,3
C(C(CO)(C(C=C(C=O)C)O)O)=O,,,5,1,2,0,2
36869_1,,,,2,2,1,3
36871_0,,,,2,2,1,3
C(C(C=O)(C=C)C(C(C)=CC=O)O)=O,,,5,1,1,0,1
36873_0,,,,2,2,1,3
C(C(CO)(C(C(C)=CC=O)O)O)=O,,,5,1,2,0,2
36873_1,,,,2,2,1,3
36875_0,,,,2,2,1,3
C(C(C=O)(C=C)C(CC(C=O)=C)O)=O,,,5,1,1,0,1
36877_0,,,,2,2,1,3
C(C(CO)(C(CC(C=O)=C)O)O)=O,,,5,1,2,0,2
36877_1,,,,2,2,1,3
36879_0,,,,2,2,1,3
C(C(C=O)(C=C)C(C(CC=O)=C)O)=O,,,5,1,1,0,1
36881_0,,,,2,2,1,3
C(C(CO)(C(C(CC=O)=C)O)O)=O,,,5,1,2,0,2
36881_1,,,,2,2,1,3
36883_0,,,,2,2,1,3
C(C(C(C=CC(C)=O)=O)(CO)O)=O,,,5,1,2,0,2
36883_1,,,,2,2,1,3
36885_0,,,,2,2,1,3
C(C(C=O)(C=C)C(C=CC(C)=O)O)=O,,,5,1,1,0,1
36887_0,,,,2,2,1,3
C(C(CO)(C(C=CC(C)=O)O)O)=O,,,5,1,2,0,2
36887_1,,,,2,2,1,3
36889_0,,,,2,2,1,3
C(C(C=O)(C=C)C(C=CC=O)(C)O)=O,,,5,1,1,0,1
36891_0,,,,2,2,1,3
C(C(CO)(C(C=CC=O)(C)O)O)=O,,,5,1,2,0,2
36891_1,,,,2,2,1,3
36893_0,,,,2,2,1,3
C(C(C=O)(C=C)C(C=O)(CC=C)O)=O,,,5,1,1,0,1
36895_0,,,,2,2,1,3
C(C(CO)(C(C=O)(CC=C)O)O)=O,,,5,1,2,0,2
36895_1,,,,2,2,1,3
36897_0,,,,2,2,1,3
C(C(C=O)(C=C)C(C(CC=C)=O)O)=O,,,5,1,1,0,1
36899_0,,,,2,2,1,3
C(C(CO)(C(C(CC=C)=O)O)O)=O,,,5,1,2,0,2
36899_1,,,,2,2,1,3
36901_0,,,,2,2,1,3
C(C(C=O)(C=C)C(C=O)(C=CC)O)=O,,,5,1,1,0,1
36903_0,,,,2,2,1,3
C(C(CO)(C(C=O)(C=CC)O)O)=O,,,5,1,2,0,2
36903_1,,,,2,2,1,3
36905_0,,,,2,2,1,3
C(C(C=O)(C=C)C(C(C=CC)=O)O)=O,,,5,1,1,0,1
36907_0,,,,2,2,1,3
C(C(CO)(C(C(C=CC)=O)O)O)=O,,,5,1,2,0,2
36907_1,,,,2,2,1,3
36909_0,,,,2,2,1,3
C(C(C=O)(C=CC=O)C(C=CC)O)=O,,,5,1,1,0,1
36911_0,,,,2,2,1,3
C(C(C=O)(C=CC=O)C(CC=C)O)=O,,,5,1,1,0,1
36913_0,,,,2,2,1,3
C(C(C=O)(C=CC=O)C(C=C)O)=O,,,5,1,1,0,1
36915_0,,,,2,2,1,3
C(C(C=O)(C=CC=O)C(C=O)O)=O,,,5,1,1,0,1
36917_0,,,,2,2,1,3
C(C(C=O)(C=CC=O)C(C=O)(C)O)=O,,,5,1,1,0,1
36919_0,,,,2,2,1,3
C(C(C=O)(C=CC=O)C(C(C)=O)O)=O,,,5,1,1,0,1
36921_0,,,,2,2,1,3
C(C(C=O)(C=CC=O)C(CC=O)O)=O,,,5,1,1,0,1
36923_0,,,,2,2,1,3
C(C(C=O)(C=CC=O)C(C)O)=O,,,5,1,2,0,2
36925_0,,,,2,2,1,3
C(C(C=O)(C=CC=O)CO)=O,,,5,1,2,0,2
36927_0,,,,2,2,1,3
C(C(C=O)(C=CC=O)C(CO)O)=O,,,5,1,1,0,1
36929_0,,,,2,2,1,3
C(C(C(C=O)=O)(CO)CO)=CC=O,,,5,1,1,0,1
36931_0,,,,2,2,1,3
C(C(C=CC=O)(CO)C(C=O)O)=O,,,5,1,1,0,1
36933_0,,,,2,2,1,3
C(C(C(CO)=O)(C=CC=O)CO)=O,,,5,1,1,0,1
36935_0,,,,2,2,1,3
C(C(C(C=CCC=O)=O)(CO)O)=O,,,5,1,2,0,2
36935_1,,,,2,2,1,3
36937_0,,,,2,2,1,3
C(C(C(CC=CC=O)=O)(CO)O)=O,,,5,1,2,0,2
36937_1,,,,2,2,1,3
36939_0,,,,2,2,1,3
C(C(C=O)(C=C)C(C=CCC=O)O)=O,,,5,1,1,0,1
36941_0,,,,2,2,1,3
C(C(CO)(C(C=CCC=O)O)O)=O,,,5,1,2,0,2
36941_1,,,,2,2,1,3
36943_0,,,,2,2,1,3
C(C(C=O)(C=C)C(CC=CC=O)O)=O,,,5,1,1,0,1
36945_0,,,,2,2,1,3
C(C(CO)(C(CC=CC=O)O)O)=O,,,5,1,2,0,2
36945_1,,,,2,2,1,3
36947_0,,,,2,2,1,3
C(C(C=O)(C(C=O)=CCO)CO)=O,,,5,1,1,0,1
36949_0,,,,2,2,1,3
C(C(C=O)(C=CC(C=O)O)CO)=O,,,5,1,1,0,1
36951_0,,,,2,2,1,3
C(C(C=O)(C=CC(CO)=O)CO)=O,,,5,1,1,0,1
36953_0,,,,2,2,1,3
C(C(C=O)(C(CO)=CC=O)CO)=O,,,5,1,1,0,1
36955_0,,,,2,2,1,3
C(C(C=O)(C(C(C=O)O)=C)CO)=O,,,5,1,1,0,1
36957_0,,,,2,2,1,3
C(C(C=O)(C=C)C(C(C=O)C=C)O)=O,,,5,1,1,0,1
36959_0,,,,2,2,1,3
C(C(C=O)(C=C)C(C(C=O)=CC)O)=O,,,5,1,1,0,1
36961_0,,,,2,2,1,3
C(C(C=O)(C=C)C(C(C=O)=C)O)=O,,,5,1,1,0,1
36963_0,,,,2,2,1,3
C(C(C=O)(C=C)C(C=CC)O)=O,,,5,1,1,0,1
36965_0,,,,2,2,1,3
C(C(C=O)(C=C)C(CC=C)O)=O,,,5,1,1,0,1
36967_0,,,,2,2,1,3
C(C(C=O)(C=C)C(C(C=C)O)O)=O,,,5,1,1,0,1
36969_0,,,,2,2,1,3
C(C(C=O)(C=C)C(C=C)O)=O,,,5,1,1,0,1
36971_0,,,,2,2,1,3
C(C(C=O)(C=C)C1(C=COC1)O)=O,,,5,1,1,0,1
36973_0,,,,2,2,1,3
C(C(C=O)(C=C)C(C(CO)O)O)=O,,,5,1,1,0,1
36975_0,,,,2,2,1,3
C(C(C=O)(C=C)C(C=O)O)=O,,,5,1,2,0,2
36977_0,,,,2,2,1,3
C(C(C=O)(C=C)C(CO)(CO)O)=O,,,5,1,1,0,1
36979_0,,,,2,2,1,3
C(C(C=O)(C=C)C(C=O)(C)O)=O,,,5,1,2,0,2
36981_0,,,,2,2,1,3
C(C(C=O)(C=C)C(C(C)=O)O)=O,,,5,1,2,0,2
36983_0,,,,2,2,1,3
C(C(C=O)(C=C)C(CC=O)O)=O,,,5,1,2,0,2
36985_0,,,,2,2,1,3
C(C(C=O)(C=C)C(C)O)=O,,,5,1,2,0,2
36987_0,,,,2,2,1,3
C(C(C=O)(C=C)C(CC(C)O)O)=O,,,5,1,1,0,1
36989_0,,,,2,2,1,3
C(C(C=O)(C=C)C(CCO)O)=O,,,5,1,2,0,2
36991_0,,,,2,2,1,3
C(C(C=O)(C=C)C(C=O)(CO)O)=O,,,5,1,1,0,1
36993_0,,,,2,2,1,3
C(C(C=O)(C=C)C(C(CO)=O)O)=O,,,5,1,1,0,1
36995_0,,,,2,2,1,3
C(C(C=O)(C=C)C(C)(CO)O)=O,,,5,1,2,0,2
36997_0,,,,2,2,1,3
C(C(C=O)(C=C)C(C(O)=O)O)=O,,,5,1,2,0,2
36999_0,,,,2,2,1,3
C(C(C=O)(C=C)C(C(O)=O)(C)O)=O,,,5,1,1,0,1
37001_0,,,,2,2,1,3
C(C(C=O)(C=C)C(CC(O)=O)O)=O,,,5,1,1,0,1
37003_0,,,,2,2,1,3
C(C(C=O)(C=C)C(C=O)(C=C)O)=O,,,5,1,1,0,1
37005_0,,,,2,2,1,3
C(C(C=O)(C=C)C(C(C=C)=O)O)=O,,,5,1,1,0,1
37007_0,,,,2,2,1,3
C(C(C=O)(C=C)C(C=CC=O)O)=O,,,5,1,1,0,1
37009_0,,,,2,2,1,3
C(C(C=O)(C=C)CO)=O,,,5,1,2,0,2
37011_0,,,,2,2,1,3
C(C(C=O)(C=C)C(CO)O)=O,,,5,1,2,0,2
37012_0,,,,2,2,1,3
37012_1,,,,2,2,1,3
37014_0,,,,2,2,1,3
C(C(CO)(C(C(C=O)=CC)O)O)=O,,,5,1,2,0,2
37014_1,,,,2,2,1,3
37016_0,,,,2,2,1,3
C(C(C(C=C)=O)(C(C(C=O)=C)O)O)=O,,,5,1,2,0,2
37016_1,,,,2,2,1,3
37018_0,,,,2,2,1,3
C(C(CO)(C(C(C=O)=C)O)O)=O,,,5,1,3,0,3
37018_1,,,,2,2,1,3
37020_0,,,,2,2,1,3
C(C(CO)(C(C(C=O)=C)O)O)(O)=O,,,5,1,2,0,2
37020_1,,,,2,2,1,3
37022_0,,,,2,2,1,3
C(C(C(C)=O)(C(C(C=O)=C)O)O)=O,,,5,1,2,0,2
37022_1,,,,2,2,1,3
37024_0,,,,2,2,1,3
C(C(C=O)(CO)C(C(C=O)=C)O)=O,,,5,1,1,0,1
37026_0,,,,2,2,1,3
C(C(C(C)O)(C(C(C=O)=C)O)O)=O,,,5,1,2,0,2
37026_1,,,,2,2,1,3
37028_0,,,,2,2,1,3
C(C)(C(CO)(C(C(C=O)=C)O)O)=O,,,5,1,2,0,2
37028_1,,,,2,2,1,3
37030_0,,,,2,2,1,3
C1(COCC1(C(C(C=O)=C)O)O)=O,,,5,1,2,0,2
37030_1,,,,2,2,1,3
37032_0,,,,2,2,1,3
C1(C(C(CO1)O)C(C(C=O)=C)O)=O,,,5,1,1,0,1
37034_0,,,,2,2,1,3
C(C)=CC(C(C=C)(C(C=O)=O)CO)O,,,5,1,1,0,1
37036_0,,,,2,2,1,3
C=CC(C(C=O)=O)(CO)C(CC=C)O,,,5,1,1,0,1
37038_0,,,,2,2,1,3
C=CC(C(C=O)=O)(CO)C(C=C)O,,,5,1,1,0,1
37040_0,,,,2,2,1,3
C(C(C(C=C)(C(C=O)=O)CO)O)=O,,,5,1,1,0,1
37042_0,,,,2,2,1,3
C=CC(C(C=O)=O)(CO)C(C)O,,,5,1,2,0,2
37044_0,,,,2,2,1,3
C=CC(C(C=O)=O)(CO)CO,,,5,1,2,0,2
37046_0,,,,2,2,1,3
C=CC(C(C=O)=O)(CO)C(CO)O,,,5,1,1,0,1
37048_0,,,,2,2,1,3
C(C(C=C)(C(C=CC)O)C(C=O)O)=O,,,5,1,1,0,1
37050_0,,,,2,2,1,3
C(C(C=C)(C(CC=C)O)C(C=O)O)=O,,,5,1,1,0,1
37052_0,,,,2,2,1,3
C(C(C=C)(C(C=C)O)C(C=O)O)=O,,,5,1,1,0,1
37054_0,,,,2,2,1,3
C(C(C=C)(C(C=O)O)C(C=O)O)=O,,,5,1,1,0,1
37056_0,,,,2,2,1,3
C(C(C=C)(C(C)O)C(C=O)O)=O,,,5,1,2,0,2
37058_0,,,,2,2,1,3
C(C(C=C)(CO)C(C=O)O)=O,,,5,1,2,0,2
37060_0,,,,2,2,1,3
C(C(C=C)(C(CO)O)C(C=O)O)=O,,,5,1,1,0,1
37062_0,,,,2,2,1,3
C(C(C(CO)=O)(C=C)C(C=CC)O)=O,,,5,1,1,0,1
37064_0,,,,2,2,1,3
C(C(C(CO)=O)(C=C)C(CC=C)O)=O,,,5,1,1,0,1
37066_0,,,,2,2,1,3
C(C(C(CO)=O)(C=C)C(C=C)O)=O,,,5,1,1,0,1
37068_0,,,,2,2,1,3
C(C(C(CO)=O)(C=C)C(C=O)O)=O,,,5,1,1,0,1
37070_0,,,,2,2,1,3
C(C(C(CO)=O)(C=C)C(C)O)=O,,,5,1,2,0,2
37072_0,,,,2,2,1,3
C(C(C(CO)=O)(C=C)CO)=O,,,5,1,2,0,2
37074_0,,,,2,2,1,3
C(C(C(CO)=O)(C=C)C(CO)O)=O,,,5,1,1,0,1
37076_0,,,,2,2,1,3
C(C(C(CC=C)=O)(C(C=CC)O)O)=O,,,5,1,2,0,2
37076_1,,,,2,2,1,3
37078_0,,,,2,2,1,3
C(C(C(CC=C)=O)(C(CC=C)O)O)=O,,,5,1,2,0,2
37078_1,,,,2,2,1,3
37080_0,,,,2,2,1,3
C(C(C(CC=C)=O)(C(C=C)O)O)=O,,,5,1,2,0,2
37080_1,,,,2,2,1,3
37082_0,,,,2,2,1,3
C(C(C(CC=C)=O)(C(C=O)O)O)=O,,,5,1,2,0,2
37082_1,,,,2,2,1,3
37084_0,,,,2,2,1,3
C(C(C(CC=C)=O)(C(C)O)O)=O,,,5,1,3,0,3
37084_1,,,,2,2,1,3
37086_0,,,,2,2,1,3
C(C(C(CC=C)=O)(CO)O)=O,,,5,1,3,0,3
37086_1,,,,2,2,1,3
37088_0,,,,2,2,1,3
C(C(C(CC=C)=O)(C(CO)O)O)=O,,,5,1,2,0,2
37088_1,,,,2,2,1,3
37090_0,,,,2,2,1,3
C(C(C(C=CC)=O)(C(C=CC)O)O)=O,,,5,1,2,0,2
37090_1,,,,2,2,1,3
37092_0,,,,2,2,1,3
C(C(C(C=CC)=O)(C(CC=C)O)O)=O,,,5,1,2,0,2
37092_1,,,,2,2,1,3
37094_0,,,,2,2,1,3
C(C(C(C=CC)=O)(C(C=C)O)O)=O,,,5,1,2,0,2
37094_1,,,,2,2,1,3
37096_0,,,,2,2,1,3
C(C(C(C=CC)=O)(C(C=O)O)O)=O,,,5,1,2,0,2
37096_1,,,,2,2,1,3
37098_0,,,,2,2,1,3
C(C(C(C=CC)=O)(C(C)O)O)=O,,,5,1,3,0,3
37098_1,,,,2,2,1,3
37100_0,,,,2,2,1,3
C(C(C(C=CC)=O)(CO)O)=O,,,5,1,3,0,3
37100_1,,,,2,2,1,3
37102_0,,,,2,2,1,3
C(C(C(C=CC)=O)(C(CO)O)O)=O,,,5,1,2,0,2
37102_1,,,,2,2,1,3
37104_0,,,,2,2,1,3
C(C(C(C=C)=O)(C(C=CC)O)O)=O,,,5,1,2,0,2
37104_1,,,,2,2,1,3
37106_0,,,,2,2,1,3
C(C(C(C=C)=O)(C(CC=C)O)O)=O,,,5,1,2,0,2
37106_1,,,,2,2,1,3
37108_0,,,,2,2,1,3
C(C(C(C=C)=O)(C(C=C)O)O)=O,,,5,1,2,0,2
37108_1,,,,2,2,1,3
37110_0,,,,2,2,1,3
C(C(C(C=C)=O)(C1(C=COC1)O)O)=O,,,5,1,2,0,2
37110_1,,,,2,2,1,3
37112_0,,,,2,2,1,3
C(C(C(C=C)=O)(C(C=O)O)O)=O,,,5,1,3,0,3
37112_1,,,,2,2,1,3
37114_0,,,,2,2,1,3
C(C(C(C=C)=O)(C(C=O)(C)O)O)=O,,,5,1,2,0,2
37114_1,,,,2,2,1,3
37116_0,,,,2,2,1,3
C(C(C(C=C)=O)(C(C(C)=O)O)O)=O,,,5,1,2,0,2
37116_1,,,,2,2,1,3
37118_0,,,,2,2,1,3
C(C(C(C=C)=O)(C(CC=O)O)O)=O,,,5,1,2,0,2
37118_1,,,,2,2,1,3
37120_0,,,,2,2,1,3
C(C(C(C=C)=O)(C(C)O)O)=O,,,5,1,3,0,3
37120_1,,,,2,2,1,3
37122_0,,,,2,2,1,3
C(C(C(C=C)=O)(C(CCO)O)O)=O,,,5,1,2,0,2
37122_1,,,,2,2,1,3
37124_0,,,,2,2,1,3
C(C(C(C=C)=O)(C(CO)(C)O)O)=O,,,5,1,2,0,2
37124_1,,,,2,2,1,3
37126_0,,,,2,2,1,3
C(C(C(C=C)=O)(C(C(O)=O)O)O)=O,,,5,1,2,0,2
37126_1,,,,2,2,1,3
37128_0,,,,2,2,1,3
C(C(C=C)(C(C=O)(C(C=C)=O)O)O)=O,,,5,1,2,0,2
37128_1,,,,2,2,1,3
37130_0,,,,2,2,1,3
C(C(C(C=C)=O)(C(C(C=C)=O)O)O)=O,,,5,1,2,0,2
37130_1,,,,2,2,1,3
37132_0,,,,2,2,1,3
C(C(C(C=C)=O)(C(C=CC=O)O)O)=O,,,5,1,2,0,2
37132_1,,,,2,2,1,3
37133_0,,,,2,2,1,3
37133_1,,,,2,2,1,3
37135_0,,,,2,2,1,3
C(C(C(C=C)=O)(C(CO)O)O)=O,,,5,1,4,0,4
37135_1,,,,2,2,1,3
37137_0,,,,2,2,1,3
C(C(C(C=CCO)=O)(C(C)O)O)=O,,,5,1,2,0,2
37137_1,,,,2,2,1,3
37139_0,,,,2,2,1,3
C(C(C(C=CCO)=O)(CO)O)=O,,,5,1,4,0,4
37139_1,,,,2,2,1,3
37141_0,,,,2,2,1,3
C1(C(O)OCC1(C(C=CC)O)O)=O,,,5,1,2,0,2
37141_1,,,,2,2,1,3
37143_0,,,,2,2,1,3
C1(C(C(C(O)O1)O)C(C=CC)O)=O,,,5,1,1,0,1
37145_0,,,,2,2,1,3
C(C(CO)(C(C=CC)O)O)=O,,,5,1,3,0,3
37145_1,,,,2,2,1,3
37147_0,,,,2,2,1,3
C(C(C(CO)O)(C(C=CC)O)O)=O,,,5,1,2,0,2
37147_1,,,,2,2,1,3
37149_0,,,,2,2,1,3
C(CO)(C(CO)(C(C=CC)O)O)=O,,,5,1,2,0,2
37149_1,,,,2,2,1,3
37151_0,,,,2,2,1,3
C(C(CO)(C(C=CC)O)O)(O)=O,,,5,1,3,0,3
37151_1,,,,2,2,1,3
37153_0,,,,2,2,1,3
C(C(C(C)=O)(C(C=CC)O)O)=O,,,5,1,3,0,3
37153_1,,,,2,2,1,3
37155_0,,,,2,2,1,3
C(C(C(C=O)(C(C=CC)O)O)O)=O,,,5,1,2,0,2
37155_1,,,,2,2,1,3
37157_0,,,,2,2,1,3
C(C(C=O)(C(C)O)C(C=CC)O)=O,,,5,1,1,0,1
37159_0,,,,2,2,1,3
C(C(C=O)(CO)C(C=CC)O)=O,,,5,1,2,0,2
37161_0,,,,2,2,1,3
C(C(C(C)O)(C(C=CC)O)O)=O,,,5,1,3,0,3
37161_1,,,,2,2,1,3
37163_0,,,,2,2,1,3
C(C)=CC(C(C(C=O)=O)(CO)O)O,,,5,1,2,0,2
37163_1,,,,2,2,1,3
37165_0,,,,2,2,1,3
C(C)(C(CO)(C(C=CC)O)O)=O,,,5,1,3,0,3
37165_1,,,,2,2,1,3
37167_0,,,,2,2,1,3
C(C(C(C=O)O)C(C=CC)O)(O)=O,,,5,1,1,0,1
37169_0,,,,2,2,1,3
C(C(C(C)=O)(C(C=CC)O)O)(O)=O,,,5,1,2,0,2
37169_1,,,,2,2,1,3
37171_0,,,,2,2,1,3
C(C(C(C)O)(C(C=CC)O)O)(O)=O,,,5,1,2,0,2
37171_1,,,,2,2,1,3
37173_0,,,,2,2,1,3
C1(COCC1(C(C=CC)O)O)=O,,,5,1,3,0,3
37173_1,,,,2,2,1,3
37175_0,,,,2,2,1,3
C1(C(C(CO1)O)C(C=CC)O)=O,,,5,1,2,0,2
37177_0,,,,2,2,1,3
C1(C(C(CO1)O)(C(C=CC)O)O)=O,,,5,1,2,0,2
37177_1,,,,2,2,1,3
37179_0,,,,2,2,1,3
C1(C(O)OCC1(C(CC=C)O)O)=O,,,5,1,2,0,2
37179_1,,,,2,2,1,3
37181_0,,,,2,2,1,3
C1(C(C(CC=C)O)C(C(O)O1)O)=O,,,5,1,1,0,1
37183_0,,,,2,2,1,3
C(C(CO)(C(CC=C)O)O)=O,,,5,1,3,0,3
37183_1,,,,2,2,1,3
37185_0,,,,2,2,1,3
C(C(C(CC=C)O)(C(CO)O)O)=O,,,5,1,2,0,2
37185_1,,,,2,2,1,3
37187_0,,,,2,2,1,3
C(CO)(C(CO)(C(CC=C)O)O)=O,,,5,1,2,0,2
37187_1,,,,2,2,1,3
37189_0,,,,2,2,1,3
C(C(CO)(C(CC=C)O)O)(O)=O,,,5,1,3,0,3
37189_1,,,,2,2,1,3
37191_0,,,,2,2,1,3
C(C(C(C)=O)(C(CC=C)O)O)=O,,,5,1,3,0,3
37191_1,,,,2,2,1,3
37193_0,,,,2,2,1,3
C(C(C(CC=C)O)(C(C=O)O)O)=O,,,5,1,2,0,2
37193_1,,,,2,2,1,3
37195_0,,,,2,2,1,3
C(C(C=O)(C(CC=C)O)C(C)O)=O,,,5,1,1,0,1
37197_0,,,,2,2,1,3
C(C(C=O)(CO)C(CC=C)O)=O,,,5,1,2,0,2
37199_0,,,,2,2,1,3
C(C(C(CC=C)O)(C(C)O)O)=O,,,5,1,3,0,3
37199_1,,,,2,2,1,3
37201_0,,,,2,2,1,3
C=CCC(C(C(C=O)=O)(CO)O)O,,,5,1,2,0,2
37201_1,,,,2,2,1,3
37203_0,,,,2,2,1,3
C(C)(C(CO)(C(CC=C)O)O)=O,,,5,1,3,0,3
37203_1,,,,2,2,1,3
37205_0,,,,2,2,1,3
C(C(C(CC=C)O)C(C=O)O)(O)=O,,,5,1,1,0,1
37207_0,,,,2,2,1,3
C(C(C(C)=O)(C(CC=C)O)O)(O)=O,,,5,1,2,0,2
37207_1,,,,2,2,1,3
37209_0,,,,2,2,1,3
C(C(C(CC=C)O)(C(C)O)O)(O)=O,,,5,1,2,0,2
37209_1,,,,2,2,1,3
37211_0,,,,2,2,1,3
C1(COCC1(C(CC=C)O)O)=O,,,5,1,3,0,3
37211_1,,,,2,2,1,3
37213_0,,,,2,2,1,3
C1(C(C(CC=C)O)C(CO1)O)=O,,,5,1,2,0,2
37215_0,,,,2,2,1,3
C1(C(C(CC=C)O)(C(CO1)O)O)=O,,,5,1,2,0,2
37215_1,,,,2,2,1,3
37217_0,,,,2,2,1,3
C(C(CO)(C(C(C=C)O)O)O)=O,,,5,1,4,0,4
37217_1,,,,2,2,1,3
37219_0,,,,2,2,1,3
C(C(CO)(C(C(C=C)O)O)O)(O)=O,,,5,1,2,0,2
37219_1,,,,2,2,1,3
37221_0,,,,2,2,1,3
C(C(C(C)=O)(C(C(C=C)O)O)O)=O,,,5,1,2,0,2
37221_1,,,,2,2,1,3
37223_0,,,,2,2,1,3
C(C(C=O)(CO)C(C(C=C)O)O)=O,,,5,1,1,0,1
37225_0,,,,2,2,1,3
C(C(C(C(C=C)O)O)(C(C)O)O)=O,,,5,1,2,0,2
37225_1,,,,2,2,1,3
37227_0,,,,2,2,1,3
C(C)(C(CO)(C(C(C=C)O)O)O)=O,,,5,1,2,0,2
37227_1,,,,2,2,1,3
37229_0,,,,2,2,1,3
C1(COCC1(C(C(C=C)O)O)O)=O,,,5,1,2,0,2
37229_1,,,,2,2,1,3
37231_0,,,,2,2,1,3
C1(C(C(C(C=C)O)O)C(CO1)O)=O,,,5,1,1,0,1
37233_0,,,,2,2,1,3
C(C(C(C=C)=O)(C(C=C)O)O)(O)=O,,,5,1,2,0,2
37233_1,,,,2,2,1,3
37235_0,,,,2,2,1,3
C(C1(C(CC(O1)O)O)C(C=C)O)=O,,,5,1,2,0,2
37235_1,,,,2,2,1,3
37237_0,,,,2,2,1,3
C(C1(COC(C1O)O)C(C=C)O)=O,,,5,1,1,0,1
37239_0,,,,2,2,1,3
C1(C(O)OCC1(C(C=C)O)O)=O,,,5,1,2,0,2
37239_1,,,,2,2,1,3
37241_0,,,,2,2,1,3
C1(C(C(C(O)O1)O)C(C=C)O)=O,,,5,1,1,0,1
37243_0,,,,2,2,1,3
C1(C(C(C(O)O1)O)(C(C=C)O)O)=O,,,5,1,2,0,2
37243_1,,,,2,2,1,3
37245_0,,,,2,2,1,3
C(CC(C=O)(C(C)O)C(C=C)O)=O,,,5,1,1,0,1
37247_0,,,,2,2,1,3
C(C(CO)(C(C=C)O)O)=O,,,5,1,3,0,3
37247_1,,,,2,2,1,3
37249_0,,,,2,2,1,3
C(C(C(CO)O)(C(C=C)O)O)=O,,,5,1,3,0,3
37249_1,,,,2,2,1,3
37251_0,,,,2,2,1,3
C(CO)(C(CO)(C(C=C)O)O)=O,,,5,1,3,0,3
37251_1,,,,2,2,1,3
37253_0,,,,2,2,1,3
C(C(CO)(C(C=C)O)O)(O)=O,,,5,1,3,0,3
37253_1,,,,2,2,1,3
37255_0,,,,2,2,1,3
C(C(C(CO)O)(C(C=C)O)O)(O)=O,,,5,1,2,0,2
37255_1,,,,2,2,1,3
37257_0,,,,2,2,1,3
C(C(C(C)=O)(C(C=C)O)O)=O,,,5,1,3,0,3
37257_1,,,,2,2,1,3
37259_0,,,,2,2,1,3
C(C(C=O)(C(C=C)O)C(C=O)O)=O,,,5,1,1,0,1
37261_0,,,,2,2,1,3
C(C(C(C=O)(C(C=C)O)O)O)=O,,,5,1,3,0,3
37261_1,,,,2,2,1,3
37263_0,,,,2,2,1,3
C(CO)(C(C(C)O)(C(C=C)O)O)=O,,,5,1,2,0,2
37263_1,,,,2,2,1,3
37265_0,,,,2,2,1,3
C(C(C)(C(C=O)(C(C=C)O)O)O)=O,,,5,1,2,0,2
37265_1,,,,2,2,1,3
37267_0,,,,2,2,1,3
C(C(C(C=C)O)(C(C(C)=O)O)O)=O,,,5,1,2,0,2
37267_1,,,,2,2,1,3
37269_0,,,,2,2,1,3
C(C(C(C(C)=O)(C(C=C)O)O)O)=O,,,5,1,2,0,2
37269_1,,,,2,2,1,3
37271_0,,,,2,2,1,3
C(CC(C(C=O)(C(C=C)O)O)O)=O,,,5,1,2,0,2
37271_1,,,,2,2,1,3
37273_0,,,,2,2,1,3
C(C(C=O)(C(C)O)C(C=C)O)=O,,,5,1,2,0,2
37275_0,,,,2,2,1,3
C(C(C=O)(CO)C(C=C)O)=O,,,5,1,2,0,2
37277_0,,,,2,2,1,3
C(C(C=O)(C(CO)O)C(C=C)O)=O,,,5,1,1,0,1
37279_0,,,,2,2,1,3
C=CC(C(C(C=O)=O)(CO)CO)O,,,5,1,1,0,1
37281_0,,,,2,2,1,3
C(C(CO)(C(C=O)O)C(C=C)O)=O,,,5,1,1,0,1
37283_0,,,,2,2,1,3
C(CO)(C(C=O)(CO)C(C=C)O)=O,,,5,1,1,0,1
37285_0,,,,2,2,1,3
C(C(CO)(C(C=C)O)O)(CC=O)=O,,,5,1,2,0,2
37285_1,,,,2,2,1,3
37287_0,,,,2,2,1,3
C(CCO)(C(C=O)(C(C=C)O)O)=O,,,5,1,2,0,2
37287_1,,,,2,2,1,3
37289_0,,,,2,2,1,3
C(C(C(C)O)(C(C=C)O)O)=O,,,5,1,3,0,3
37289_1,,,,2,2,1,3
37291_0,,,,2,2,1,3
C=CC(C(C(C=O)=O)(CO)O)O,,,5,1,3,0,3
37291_1,,,,2,2,1,3
37293_0,,,,2,2,1,3
C(C)(C(CO)(C(C=C)O)O)=O,,,5,1,3,0,3
37293_1,,,,2,2,1,3
37295_0,,,,2,2,1,3
C(C(C(C=O)O)C(C=C)O)(O)=O,,,5,1,2,0,2
37297_0,,,,2,2,1,3
C(C(C(C)=O)(C(C=C)O)O)(O)=O,,,5,1,3,0,3
37297_1,,,,2,2,1,3
37299_0,,,,2,2,1,3
C(C(C(C=O)O)(C(C=C)O)O)(O)=O,,,5,1,2,0,2
37299_1,,,,2,2,1,3
37301_0,,,,2,2,1,3
C(C(C(C=O)(C(C=C)O)O)O)(O)=O,,,5,1,2,0,2
37301_1,,,,2,2,1,3
37303_0,,,,2,2,1,3
C(C(C(C)O)(C(C=C)O)O)(O)=O,,,5,1,3,0,3
37303_1,,,,2,2,1,3
37305_0,,,,2,2,1,3
C1(COCC1(C(C=C)O)O)=O,,,5,1,3,0,3
37305_1,,,,2,2,1,3
37307_0,,,,2,2,1,3
C1(C(C(CO1)O)C(C=C)O)=O,,,5,1,2,0,2
37309_0,,,,2,2,1,3
C1(C(C(CO1)O)(C(C=C)O)O)=O,,,5,1,3,0,3
37309_1,,,,2,2,1,3
37311_0,,,,2,2,1,3
C(C=CC(C(CO)(C(C)O)O)=O)=O,,,5,1,2,0,2
37311_1,,,,2,2,1,3
37313_0,,,,2,2,1,3
C(C=CC(C(CO)(CO)O)=O)=O,,,5,1,4,0,4
37313_1,,,,2,2,1,3
37315_0,,,,2,2,1,3
C=C(C=O)C(C(CO)(C(C)O)O)=O,,,5,1,2,0,2
37315_1,,,,2,2,1,3
37317_0,,,,2,2,1,3
C=C(C=O)C(C(CO)(CO)O)=O,,,5,1,3,0,3
37317_1,,,,2,2,1,3
37318_0,,,,2,2,1,3
37318_1,,,,2,2,1,3
37320_0,,,,2,2,1,3
C(C(C(C=C)=O)(C(C)O)O)(O)=O,,,5,1,3,0,3
37320_1,,,,2,2,1,3
37321_0,,,,2,2,1,3
37321_1,,,,2,2,1,3
37323_0,,,,2,2,1,3
C(C(C(C=C)=O)(C(CO)O)O)(O)=O,,,5,1,2,0,2
37323_1,,,,2,2,1,3
37325_0,,,,2,2,1,3
C(C=CC(C(CO)(CO)O)=O)(O)=O,,,5,1,2,0,2
37325_1,,,,2,2,1,3
37327_0,,,,2,2,1,3
C(C(C(C=CCO)=O)(CO)O)(O)=O,,,5,1,2,0,2
37327_1,,,,2,2,1,3
37329_0,,,,2,2,1,3
C(C(CO)(C1(C=COC1)O)O)=O,,,5,1,3,0,3
37329_1,,,,2,2,1,3
37331_0,,,,2,2,1,3
C(C(CO)(C1(C=COC1)O)O)(O)=O,,,5,1,2,0,2
37331_1,,,,2,2,1,3
37333_0,,,,2,2,1,3
C(C(C(C)=O)(C1(C=COC1)O)O)=O,,,5,1,2,0,2
37333_1,,,,2,2,1,3
37335_0,,,,2,2,1,3
C(C(C=O)(CO)C1(C=COC1)O)=O,,,5,1,1,0,1
37337_0,,,,2,2,1,3
C(C(C(C)O)(C1(C=COC1)O)O)=O,,,5,1,2,0,2
37337_1,,,,2,2,1,3
37339_0,,,,2,2,1,3
C(C)(C(CO)(C1(C=COC1)O)O)=O,,,5,1,2,0,2
37339_1,,,,2,2,1,3
37341_0,,,,2,2,1,3
C1(COCC1(C2(C=COC2)O)O)=O,,,5,1,2,0,2
37341_1,,,,2,2,1,3
37343_0,,,,2,2,1,3
C1(C(C(CO1)O)C2(C=COC2)O)=O,,,5,1,1,0,1
37345_0,,,,2,2,1,3
C1(C(OC(C=O)C1(CO)CO)O)=O,,,5,1,2,0,2
37347_0,,,,2,2,1,3
C(C(C1(COC(C1O)O)CO)=O)=O,,,5,1,2,0,2
37349_0,,,,2,2,1,3
C(C1(CO)C(C(OC1C=O)O)O)=O,,,5,1,2,0,2
37351_0,,,,2,2,1,3
C(C1(C(O)OCC1(CO)O)CO)=O,,,5,1,2,0,2
37352_0,,,,2,2,1,3
37352_1,,,,2,2,1,3
37354_0,,,,2,2,1,3
C(C1(C(CC(O1)O)O)C(C=O)O)=O,,,5,1,3,0,3
37354_1,,,,2,2,1,3
37356_0,,,,2,2,1,3
C(C1(C(C)O)C(CC(O1)O)O)=O,,,5,1,3,0,3
37356_1,,,,2,2,1,3
37357_0,,,,2,2,1,3
37357_1,,,,2,2,1,3
37358_0,,,,2,2,1,3
37358_1,,,,2,2,1,3
37360_0,,,,2,2,1,3
C1(C(O)OC(C)C1(CO)C(C)O)=O,,,5,1,2,0,2
37362_0,,,,2,2,1,3
C1(C(O)OC(C)C1(CO)CO)=O,,,5,1,2,0,2
37364_0,,,,2,2,1,3
C1(C(O)OC(CO)C1(CO)CO)=O,,,5,1,2,0,2
37365_0,,,,2,2,1,3
37365_1,,,,2,2,1,3
37366_0,,,,2,2,1,3
37366_1,,,,2,2,1,3
37368_0,,,,2,2,1,3
C(C1(C(C)OC(C1O)O)C(C)O)=O,,,5,1,2,0,2
37370_0,,,,2,2,1,3
C(C1(CO)C(C)OC(C1O)O)=O,,,5,1,2,0,2
37372_0,,,,2,2,1,3
C(C1(COC(C1O)O)C(C=O)O)=O,,,5,1,2,0,2
37374_0,,,,2,2,1,3
C(C1(COC(C1O)O)C(C)O)=O,,,5,1,2,0,2
37376_0,,,,2,2,1,3
C(C1(COC(C1O)O)CO)=O,,,5,1,2,0,2
37378_0,,,,2,2,1,3
C(C1(COC(C1O)O)C(CO)O)=O,,,5,1,2,0,2
37380_0,,,,2,2,1,3
C(C1(CO)C(CO)OC(C1O)O)=O,,,5,1,2,0,2
37381_0,,,,2,2,1,3
37381_1,,,,2,2,1,3
37382_0,,,,2,2,1,3
37382_1,,,,2,2,1,3
37384_0,,,,2,2,1,3
C(C1(CO)C(CO)(O)OCC1O)=O,,,5,1,2,0,2
37386_0,,,,2,2,1,3
C(C)(C1(C(C)O)C(CC(O1)O)O)=O,,,5,1,3,0,3
37386_1,,,,2,2,1,3
37387_0,,,,2,2,1,3
37387_1,,,,2,2,1,3
37388_0,,,,2,2,1,3
37388_1,,,,2,2,1,3
37390_0,,,,2,2,1,3
C(C1(C(C)O)C(C)(CC(O1)O)O)=O,,,5,1,3,0,3
37390_1,,,,2,2,1,3
37392_0,,,,2,2,1,3
C(C1(CO)C(C)(CC(O1)O)O)=O,,,5,1,3,0,3
37392_1,,,,2,2,1,3
37393_0,,,,2,2,1,3
37393_1,,,,2,2,1,3
37395_0,,,,2,2,1,3
C(C(CO)(C1(CC(CO1)O)O)O)=O,,,5,1,3,0,3
37395_1,,,,2,2,1,3
37397_0,,,,2,2,1,3
C1(C(O)OCC1(C(C=O)O)O)=O,,,5,1,3,0,3
37397_1,,,,2,2,1,3
37399_0,,,,2,2,1,3
C(C(C)(C1(C(C(O)OC1)=O)O)O)=O,,,5,1,3,0,3
37399_1,,,,2,2,1,3
37401_0,,,,2,2,1,3
C(C(C1(C(C(O)OC1)=O)O)O)(C)=O,,,5,1,3,0,3
37401_1,,,,2,2,1,3
37403_0,,,,2,2,1,3
C(CC(C1(C(C(O)OC1)=O)O)O)=O,,,5,1,3,0,3
37403_1,,,,2,2,1,3
37405_0,,,,2,2,1,3
C1(C(O)OCC1(C(C)O)O)=O,,,5,1,3,0,3
37405_1,,,,2,2,1,3
37407_0,,,,2,2,1,3
C1(C(O)OCC1(C(CCO)O)O)=O,,,5,1,3,0,3
37407_1,,,,2,2,1,3
37409_0,,,,2,2,1,3
C1(C(O)OCC1(C(CO)(C)O)O)=O,,,5,1,3,0,3
37409_1,,,,2,2,1,3
37411_0,,,,2,2,1,3
C1(C(O)OCC1(C(C(O)=O)O)O)=O,,,5,1,3,0,3
37411_1,,,,2,2,1,3
37412_0,,,,2,2,1,3
37412_1,,,,2,2,1,3
37414_0,,,,2,2,1,3
C1(C(O)OCC1(C(CO)O)O)=O,,,5,1,3,0,3
37414_1,,,,2,2,1,3
37416_0,,,,2,2,1,3
C1(C(O)OC(CO)C1(C(C)O)O)=O,,,5,1,3,0,3
37416_1,,,,2,2,1,3
37418_0,,,,2,2,1,3
C1(C(O)OC(CO)C1(CO)O)=O,,,5,1,3,0,3
37418_1,,,,2,2,1,3
37420_0,,,,2,2,1,3
C1(C(C(C(O)O1)O)C(C=O)O)=O,,,5,1,2,0,2
37422_0,,,,2,2,1,3
C1(C(C(C(O)O1)O)C(C=O)(C)O)=O,,,5,1,2,0,2
37424_0,,,,2,2,1,3
C1(C(C(C(O)O1)O)C(C(C)=O)O)=O,,,5,1,2,0,2
37426_0,,,,2,2,1,3
C1(C(C(CC=O)O)C(C(O)O1)O)=O,,,5,1,2,0,2
37428_0,,,,2,2,1,3
C1(C(C(C(O)O1)O)C(C)O)=O,,,5,1,2,0,2
37430_0,,,,2,2,1,3
C1(C(C(C(O)O1)O)C(CCO)O)=O,,,5,1,2,0,2
37432_0,,,,2,2,1,3
C1(C(C(C(O)O1)O)C(C)(CO)O)=O,,,5,1,2,0,2
37434_0,,,,2,2,1,3
C1(C(C(C(O)O1)O)C(C(O)=O)O)=O,,,5,1,2,0,2
37436_0,,,,2,2,1,3
C1(C(CO)C(C(O)O1)O)=O,,,5,1,2,0,2
37438_0,,,,2,2,1,3
C1(C(C(CO)O)C(C(O)O1)O)=O,,,5,1,2,0,2
37440_0,,,,2,2,1,3
C(C1(CC(OC1(C=O)CO)O)O)=O,,,5,1,3,0,3
37440_1,,,,2,2,1,3
37442_0,,,,2,2,1,3
C1(C(C(C(O)O1)O)(C(C=O)O)O)=O,,,5,1,3,0,3
37442_1,,,,2,2,1,3
37444_0,,,,2,2,1,3
C1(C(C(C)O)(C(C(O)O1)O)O)=O,,,5,1,3,0,3
37444_1,,,,2,2,1,3
37445_0,,,,2,2,1,3
37445_1,,,,2,2,1,3
37446_0,,,,2,2,1,3
37446_1,,,,2,2,1,3
37448_0,,,,2,2,1,3
C1(C(C(C)O)(C(C)(C(O)O1)O)O)=O,,,5,1,3,0,3
37448_1,,,,2,2,1,3
37449_0,,,,2,2,1,3
37449_1,,,,2,2,1,3
37451_0,,,,2,2,1,3
C1(C(C(C)O)(C(C(C)(O)O1)O)O)=O,,,5,1,3,0,3
37451_1,,,,2,2,1,3
37452_0,,,,2,2,1,3
37452_1,,,,2,2,1,3
37454_0,,,,2,2,1,3
C(C1(C(C)O)C(CC(O1)O)O)(O)=O,,,5,1,3,0,3
37454_1,,,,2,2,1,3
37455_0,,,,2,2,1,3
37455_1,,,,2,2,1,3
37457_0,,,,2,2,1,3
C1(COC(C(C1(C(C)O)O)O)O)=O,,,5,1,3,0,3
37457_1,,,,2,2,1,3
37458_0,,,,2,2,1,3
37458_1,,,,2,2,1,3
37460_0,,,,2,2,1,3
C(C1(C(COC(C1O)O)=O)CO)=O,,,5,1,2,0,2
37462_0,,,,2,2,1,3
C1(C(CO)(C(C=O)OC(C1)O)O)=O,,,5,1,3,0,3
37462_1,,,,2,2,1,3
37464_0,,,,2,2,1,3
C(C1(CO)C(C(CC(O1)O)=O)O)=O,,,5,1,3,0,3
37464_1,,,,2,2,1,3
37466_0,,,,2,2,1,3
C(C1(C(CC(C(O1)O)O)=O)CO)=O,,,5,1,3,0,3
37466_1,,,,2,2,1,3
37468_0,,,,2,2,1,3
C1(CC(C=O)OC(C1(CO)O)O)=O,,,5,1,3,0,3
37468_1,,,,2,2,1,3
37469_0,,,,2,2,1,3
37469_1,,,,2,2,1,3
37470_0,,,,2,2,1,3
37470_1,,,,2,2,1,3
37472_0,,,,2,2,1,3
C1(C(O)OCC(C1(CO)CO)O)=O,,,5,1,2,0,2
37473_0,,,,2,2,1,3
37473_1,,,,2,2,1,3
37474_0,,,,2,2,1,3
37474_1,,,,2,2,1,3
37476_0,,,,2,2,1,3
C(C1(CO)C(C(O)OCC1O)O)=O,,,5,1,2,0,2
37478_0,,,,2,2,1,3
C1(CC(O)OC(C)C1(C(C)O)O)=O,,,5,1,3,0,3
37478_1,,,,2,2,1,3
37480_0,,,,2,2,1,3
C1(CC(O)OC(C)C1(CO)O)=O,,,5,1,3,0,3
37480_1,,,,2,2,1,3
37482_0,,,,2,2,1,3
C1(CC(C)OC(C1(C(C)O)O)O)=O,,,5,1,3,0,3
37482_1,,,,2,2,1,3
37484_0,,,,2,2,1,3
C1(CC(C)OC(C1(CO)O)O)=O,,,5,1,3,0,3
37484_1,,,,2,2,1,3
37486_0,,,,2,2,1,3
C1(C(O)OCC(C1(C(C)O)O)O)=O,,,5,1,3,0,3
37486_1,,,,2,2,1,3
37488_0,,,,2,2,1,3
C1(C(O)OCC(C1(CO)O)O)=O,,,5,1,3,0,3
37488_1,,,,2,2,1,3
37490_0,,,,2,2,1,3
C1(C(C(C)O)(C(CC(O)O1)O)O)=O,,,5,1,3,0,3
37490_1,,,,2,2,1,3
37491_0,,,,2,2,1,3
37491_1,,,,2,2,1,3
37492_0,,,,2,2,1,3
37492_1,,,,2,2,1,3
37494_0,,,,2,2,1,3
C1(C(C(C)O)(C(CO)(CO1)O)O)=O,,,5,1,2,0,2
37494_1,,,,2,2,1,3
37495_0,,,,2,2,1,3
37495_1,,,,2,2,1,3
37497_0,,,,2,2,1,3
C1(C(CO)(C(CO1)(CC=O)O)O)=O,,,5,1,2,0,2
37497_1,,,,2,2,1,3
37499_0,,,,2,2,1,3
C1(C(CO)(C(C)(C(C=O)O1)O)O)=O,,,5,1,2,0,2
37499_1,,,,2,2,1,3
37501_0,,,,2,2,1,3
C(C1(CO)C(C)(C(C(O1)=O)O)O)=O,,,5,1,2,0,2
37501_1,,,,2,2,1,3
37503_0,,,,2,2,1,3
C1(C(CO)(C(C=O)(CCO1)O)O)=O,,,5,1,2,0,2
37503_1,,,,2,2,1,3
37505_0,,,,2,2,1,3
C1(C(CO)(C(CC(C=O)O1)O)O)=O,,,5,1,2,0,2
37505_1,,,,2,2,1,3
37506_0,,,,2,2,1,3
37507_0,,,,2,2,1,3
37508_0,,,,2,2,1,3
37509_0,,,,2,2,1,3
37510_0,,,,2,2,1,3
37512_0,,,,2,2,1,3
C(C(C(C)O)(C(C)O)CC=O)=O,,,5,1,2,0,2
37513_0,,,,2,2,1,3
37514_0,,,,2,2,1,3
37515_0,,,,2,2,1,3
37516_0,,,,2,1,1,2
37518_0,,,,2,1,1,2
C(C1(CC(C=O)(CC1O)O)O)=O,,,5,1,1,0,1
37520_0,,,,2,1,1,2
C(C1(CC(C=O)(C(C1O)O)O)O)=O,,,5,1,1,0,1
37521_0,,,,2,1,1,2
37522_0,,,,2,1,1,2
37523_0,,,,2,1,1,2
37524_0,,,,2,1,1,2
37525_0,,,,2,1,1,2
37526_0,,,,2,1,1,2
37528_0,,,,2,1,1,2
C(C1(CC(C(C)=O)(C(C1)O)O)O)=O,,,5,1,1,0,1
37529_0,,,,2,1,1,2
37531_0,,,,2,1,1,2
C(C)(C1(C(CC(C(C1)=O)O)O)O)=O,,,5,1,1,0,1
37532_0,,,,2,1,1,2
37534_0,,,,2,1,1,2
C(C)(C1(C(C(CO)C(C1)O)O)O)=O,,,5,1,1,0,1
37536_0,,,,2,1,1,2
C(C)(C1(CC(C(C1(C)O)O)O)O)=O,,,5,1,1,0,1
37538_0,,,,2,1,1,2
C(C)(C1(CC(CC1(CO)O)O)O)=O,,,5,1,1,0,1
37540_0,,,,2,1,1,2
C(C1(CC(CC1(C(C)=O)O)O)O)=O,,,5,1,1,0,1
37541_0,,,,2,1,1,2
37542_0,,,,2,1,1,2
37544_0,,,,2,1,1,2
C(C)(C1(C(CC(C1)O)O)O)=O,,,5,1,1,0,1
37546_0,,,,2,1,1,2
C(C)(C1(C(C(C(C1)O)O)O)O)=O,,,5,1,1,0,1
37548_0,,,,2,1,1,2
C(C1(C(CC(C(C1)=O)O)O)O)(O)=O,,,5,1,1,0,1
37549_0,,,,2,1,1,2
37550_0,,,,2,1,1,2
37552_0,,,,2,1,1,2
C(CCO)(C1(C(CC(C1)O)O)O)=O,,,5,1,1,0,1
37554_0,,,,2,1,1,2
C(C1(C(CC(CC(C1)O)O)O)O)=O,,,5,1,1,0,1
37556_0,,,,2,1,1,2
C(C1(C(C(C(C1)O)C(C)O)O)O)=O,,,5,1,1,0,1
37557_0,,,,2,1,1,2
37559_0,,,,2,1,1,2
C(C1(C(CC(C1C(C)O)O)O)O)=O,,,5,1,1,0,1
37560_0,,,,2,1,1,2
37562_0,,,,2,1,1,2
C(C1(C(C(C(C1CO)O)O)O)O)=O,,,5,1,2,0,2
37564_0,,,,2,1,1,2
C1(C(C(C(C1(C)O)O)C(C)O)O)=O,,,5,1,1,0,1
37566_0,,,,2,1,1,2
C1(C(C(CO)C(C1(C)O)O)O)=O,,,5,1,1,0,1
37568_0,,,,2,1,1,2
C(C1(C(C(CO)C(C1)O)O)O)(O)=O,,,5,1,1,0,1
37569_0,,,,2,1,1,2
37570_0,,,,2,1,1,2
37572_0,,,,2,1,1,2
C(CO)(C1(C(C(C(C1)=O)O)O)O)=O,,,5,1,1,0,1
37574_0,,,,2,1,1,2
C1(C(C)(C(C=O)(C(C1O)O)O)O)=O,,,5,1,1,0,1
37575_0,,,,2,1,1,2
37576_0,,,,2,1,1,2
37577_0,,,,2,1,1,2
37579_0,,,,2,1,1,2
C1(C(C(C(C)(C1(C)O)O)O)O)=O,,,5,1,1,0,1
37581_0,,,,2,1,1,2
C1(C(CC(CO)(C1(C)O)O)O)=O,,,5,1,1,0,1
37583_0,,,,2,1,1,2
C1(C(C)(C(C(O)=O)(CC1O)O)O)=O,,,5,1,1,0,1
37584_0,,,,2,1,1,2
37585_0,,,,2,1,1,2
37587_0,,,,2,1,1,2
C1(C(C)(C(C=O)(CC1O)O)O)=O,,,5,1,1,0,1
37588_0,,,,2,1,1,2
37589_0,,,,2,1,1,2
37591_0,,,,2,1,1,2
C1(C(CC(C1(C)O)O)O)=O,,,5,1,1,0,1
37592_0,,,,2,1,1,2
37594_0,,,,2,1,1,2
C(C1(CC(C(C1(C)O)O)O)O)(O)=O,,,5,1,1,0,1
37596_0,,,,2,1,1,2
C(C1(CC(C(C1(C)O)O)O)O)=O,,,5,1,1,0,1
37598_0,,,,2,1,1,2
C(C1(CC(CC1(CO)O)O)O)(O)=O,,,5,1,1,0,1
37599_0,,,,2,1,1,2
37600_0,,,,2,1,1,2
37601_0,,,,2,1,1,2
37602_0,,,,2,1,1,2
37603_0,,,,2,1,1,2
37604_0,,,,2,1,1,2
37605_0,,,,2,1,1,2
37606_0,,,,2,1,1,2
37607_0,,,,2,1,1,2
37608_0,,,,2,1,1,2
37610_0,,,,2,1,1,2
C(C1(CC(CO)(CC1O)O)O)=O,,,5,1,1,0,1
37612_0,,,,2,1,1,2
C(C1(CC(CO)(C(C1O)O)O)O)=O,,,5,1,1,0,1
37614_0,,,,2,1,1,2
C(C1(CC(CO)(CC1O)O)O)(O)=O,,,5,1,1,0,1
37615_0,,,,2,1,1,2
37616_0,,,,2,1,1,2
37617_0,,,,2,1,1,2
37618_0,,,,2,1,1,2
37619_0,,,,2,1,1,2
37620_0,,,,2,1,1,2
37621_0,,,,2,1,1,2
37623_0,,,,2,1,1,2
C1(CC(C(C=C)=O)(C(C1O)O)O)=O,,,5,1,1,0,1
37624_0,,,,2,1,1,2
37626_0,,,,2,1,1,2
C(C1(C(CC(C(C1)O)O)O)O)(O)=O,,,5,1,1,0,1
37628_0,,,,2,1,1,2
C(C1(C(C(CC(C1)O)O)O)O)(O)=O,,,5,1,1,0,1
37630_0,,,,2,1,1,2
C(C1(CC(C)(C(C1O)O)O)O)(O)=O,,,5,1,1,0,1
37632_0,,,,2,1,1,2
C(C1(C(CC(C1CO)O)O)O)(O)=O,,,5,1,1,0,1
37633_0,,,,2,1,1,2
37635_0,,,,2,1,1,2
C(C1(C(C(C(C(C1)O)O)O)O)O)=O,,,5,1,3,0,3
37636_0,,,,2,1,1,2
37637_0,,,,2,1,1,2
37639_0,,,,2,1,1,2
C(C1C(C(C)(C(C1O)O)O)=O)=O,,,5,1,1,0,1
37641_0,,,,2,1,1,2
C1(C(C)(C(CC(C1O)=O)O)O)=O,,,5,1,1,0,1
37642_0,,,,2,1,1,2
37644_0,,,,2,1,1,2
C1(C(C)(C(C(C(C1)=O)O)O)O)=O,,,5,1,1,0,1
37645_0,,,,2,1,1,2
37646_0,,,,2,1,1,2
37648_0,,,,2,1,1,2
C(C(C1(C(CC(C1)O)O)O)=O)=O,,,5,1,1,0,1
37649_0,,,,2,1,1,2
37651_0,,,,2,1,1,2
C(C1(C(C(C)(C(C1)O)O)=O)O)=O,,,5,1,1,0,1
37652_0,,,,2,1,1,2
37653_0,,,,2,1,1,2
37654_0,,,,2,1,1,2
37655_0,,,,2,1,1,2
37656_0,,,,2,1,1,2
37657_0,,,,2,1,1,2
37658_0,,,,2,1,1,2
37660_0,,,,2,1,1,2
C(CO)(C1(C(CC(C1)=O)O)O)=O,,,5,1,2,0,2
37662_0,,,,2,1,1,2
C(C1(C(CO)(CC(C1)=O)O)O)=O,,,5,1,2,0,2
37663_0,,,,2,1,1,2
37665_0,,,,2,1,1,2
C(C1(C(CC(C1)=O)O)O)=O,,,5,1,3,0,3
37666_0,,,,2,1,1,2
37668_0,,,,2,1,1,2
C(C1(C(C(C(C1)=O)CO)O)O)=O,,,5,1,2,0,2
37670_0,,,,2,1,1,2
C(C1(C(CC(C1)=O)O)O)(O)=O,,,5,1,2,0,2
37672_0,,,,2,1,1,2
C(C1(C=CC(C1(CO)O)O)O)=O,,,5,1,2,0,2
37674_0,,,,2,1,1,2
C(CO)(C1(C=CC(C1O)O)O)=O,,,5,1,2,0,2
37676_0,,,,2,1,1,2
C(C1(C=CCC1(C=O)O)O)=O,,,5,1,3,0,3
37677_0,,,,2,1,1,2
37678_0,,,,2,1,1,2
37679_0,,,,2,1,1,2
37681_0,,,,2,1,1,2
C(C)(C1(C=CC(C1O)=O)O)=O,,,5,1,2,0,2
37683_0,,,,2,1,1,2
C(C1(C(CC(C1O)=O)=C)O)=O,,,5,1,2,0,2
37685_0,,,,2,1,1,2
C(C1(C(C)=CC(C1O)=O)O)=O,,,5,1,2,0,2
37687_0,,,,2,1,1,2
C(C1(C(C=O)=CCC1O)O)=O,,,5,1,2,0,2
37689_0,,,,2,1,1,2
C(C1C=CC(C1(C=O)O)O)=O,,,5,1,2,0,2
37691_0,,,,2,1,1,2
C(C1C=CC(C=O)(C1O)O)=O,,,5,1,2,0,2
37693_0,,,,2,1,1,2
C(C1(CC=C(C=O)C1O)O)=O,,,5,1,2,0,2
37695_0,,,,2,1,1,2
C(C1(CC=CC1O)O)=O,,,5,1,2,0,2
37697_0,,,,2,1,1,2
C(C1(C=CCC1O)O)=O,,,5,1,2,0,2
37699_0,,,,2,1,1,2
C(C1(C=CC(C1O)O)O)=O,,,5,1,3,0,3
37701_0,,,,2,1,1,2
C(C1(C=CC(CO)(C1O)O)O)=O,,,5,1,2,0,2
37703_0,,,,2,1,1,2
C(C1(C=CC(C1O)O)O)(O)=O,,,5,1,2,0,2
37705_0,,,,2,1,1,2
C1(C2(C(CC(C1)O2)O)O)=O,,,5,1,1,0,1
37707_0,,,,2,1,1,2
C1(C2(C(CC(C(C1)O2)O)O)O)=O,,,5,1,1,0,1
37709_0,,,,2,1,1,2
C(C1(CC2CC1(C(O)O2)O)O)=O,,,5,1,3,0,3
37711_0,,,,2,1,1,2
C1(C2(C(C(CC(C1)O2)O)O)O)=O,,,5,1,1,0,1
37713_0,,,,2,1,1,2
C1(C2(C(CO)(CC(C1)O2)O)O)=O,,,5,1,1,0,1
37715_0,,,,2,1,1,2
C1(C2(C(CC(CO)(C1)O2)O)O)=O,,,5,1,1,0,1
37717_0,,,,2,1,1,2
C1(C2(C(C)(C(C(C1)O2)O)O)O)=O,,,5,1,1,0,1
37719_0,,,,2,1,1,2
C1(C2(C(C(C(C)(C1)O2)O)O)O)=O,,,5,1,1,0,1
37721_0,,,,2,1,1,2
C1(C2(C(CC(C1CO)O2)O)O)=O,,,5,1,1,0,1
37723_0,,,,2,1,1,2
C1(C2(C(CC(C(C1)O)O2)O)O)=O,,,5,1,1,0,1
37725_0,,,,2,1,1,2
C1(C2(C(CC(CO2)(C1)O)O)O)=O,,,5,1,1,0,1
37727_0,,,,2,1,1,2
C(C12C(C(C(O1)O)C(C2)O)O)=O,,,5,1,3,0,3
37729_0,,,,2,1,1,2
C1(C2(C(C(CCO2)(C1)O)O)O)=O,,,5,1,1,0,1
37731_0,,,,2,1,1,2
C(C1(CCCC1(C=O)O)O)(O)=O,,,5,1,1,0,1
37733_0,,,,2,1,1,2
C(C1(CCCC(C1O)=O)O)(O)=O,,,5,1,2,0,2
37735_0,,,,2,1,1,2
C(C1CC(C(O)=O)(C(C1)O)O)=O,,,5,1,1,0,1
37737_0,,,,2,1,1,2
C1(C(C(C(C=O)=O)(CC1)O)O)=O,,,5,1,2,0,2
37739_0,,,,2,1,1,2
C1(C(C(C(C(C)=O)=O)(CC1)O)O)=O,,,5,1,2,0,2
37741_0,,,,2,1,1,2
C(C1(CCCC1(C(C=O)=O)O)O)=O,,,5,1,1,0,1
37743_0,,,,2,1,1,2
C1(C(C(C(C=O)=O)(CCC1)O)O)=O,,,5,1,2,0,2
37745_0,,,,2,1,1,2
C(C1CC(C(C=O)=O)(C(C1)O)O)=O,,,5,1,1,0,1
37747_0,,,,2,1,1,2
C(C)(C1(CCC(C1O)=O)O)=O,,,5,1,2,0,2
37749_0,,,,2,1,1,2
C(C1(CCC(C1O)=O)O)(CCO)=O,,,5,1,2,0,2
37751_0,,,,2,1,1,2
C(C1(CCC(CC1(C=O)O)O)O)=O,,,5,1,1,0,1
37753_0,,,,2,1,1,2
C(C1(CC(CCC(C1O)=O)O)O)=O,,,5,1,2,0,2
37755_0,,,,2,1,1,2
C(C1(C(C(C(C1)O)CC=O)O)O)=O,,,5,1,2,0,2
37757_0,,,,2,1,1,2
C(C1C(CC(C=O)(C(C1)O)O)O)=O,,,5,1,1,0,1
37759_0,,,,2,1,1,2
C(C1(C(CO)CCC1(C=O)O)O)=O,,,5,1,1,0,1
37761_0,,,,2,1,1,2
C(C1(C(CCC(C1O)=O)CO)O)=O,,,5,1,2,0,2
37763_0,,,,2,1,1,2
C(C1CC(C(C=O)(C1CO)O)O)=O,,,5,1,1,0,1
37765_0,,,,2,1,1,2
C1(C2(CCC(C2O)=O)OCC1O)=O,,,5,1,2,0,2
37767_0,,,,2,1,1,2
C(C1(CCC2CC(C1(O)O2)=O)O)=O,,,5,1,1,0,1
37769_0,,,,2,1,1,2
C1(C(C2(C(CC(CC1)O2)=O)O)O)=O,,,5,1,2,0,2
37771_0,,,,2,1,1,2
C(CC1C2CC(C(C1O)(O)O2)=O)=O,,,5,1,2,0,2
37773_0,,,,2,1,1,2
C(C1C2CC(C(C(C1)O)(O)O2)=O)=O,,,5,1,1,0,1
37775_0,,,,2,1,1,2
C(C1(CCC2C(C1(O)OC2)=O)O)=O,,,5,1,1,0,1
37777_0,,,,2,1,1,2
C1(C(C2(C(C(CO2)CC1)=O)O)O)=O,,,5,1,2,0,2
37779_0,,,,2,1,1,2
C(CC1C(C2(C(C1CO2)=O)O)O)=O,,,5,1,2,0,2
37781_0,,,,2,1,1,2
C(C1CC(C2(C(C1CO2)=O)O)O)=O,,,5,1,1,0,1
37783_0,,,,2,1,1,2
C1(C2(CCC(C2O)=O)OC(C1)O)=O,,,5,1,2,0,2
37784_0,,,,2,1,1,2
37785_0,,,,2,1,1,2
37787_0,,,,2,1,1,2
C(C1CCC(C=O)(C1(C=O)O)O)=O,,,5,1,1,0,1
37789_0,,,,2,1,1,2
C1(C(C(C=O)(C(C=O)CC1)O)O)=O,,,5,1,2,0,2
37791_0,,,,2,1,1,2
C(C1(CCC(C1O)=O)O)(CC=O)=O,,,5,1,2,0,2
37792_0,,,,2,1,1,2
37794_0,,,,2,2,1,3
C(C1(CC(C(O)=O)(C(C1)=O)O)O)=O,,,5,1,1,0,1
37795_0,,,,2,2,1,3
37796_0,,,,2,2,1,3
37798_0,,,,2,2,1,3
C(C1(C(CC(C(C1)=O)O)=O)O)(O)=O,,,5,1,1,0,1
37799_0,,,,2,2,1,3
37800_0,,,,2,2,1,3
37802_0,,,,2,2,1,3
C1(CC(C(C=O)C1(C(O)=O)O)O)=O,,,5,1,1,0,1
37803_0,,,,2,2,1,3
37804_0,,,,2,2,1,3
37806_0,,,,2,2,1,3
C1(CC(CC1(C(C(C)O)O)O)O)=O,,,5,1,1,0,1
37808_0,,,,2,2,1,3
C(C1(C(CC(C1)O)=O)O)(O)=O,,,5,1,1,0,1
37810_0,,,,2,2,1,3
C1(C(CC(C1)O)(C(C=CC)O)O)=O,,,5,1,1,0,1
37812_0,,,,2,2,1,3
C1(CC(CC1(C(CC=C)O)O)O)=O,,,5,1,1,0,1
37814_0,,,,2,2,1,3
C1(C(CC(C1)O)(C(C=C)O)O)=O,,,5,1,1,0,1
37815_0,,,,2,2,1,3
37816_0,,,,2,2,1,3
37817_0,,,,2,2,1,3
37818_0,,,,2,2,1,3
37819_0,,,,2,2,1,3
37820_0,,,,2,2,1,3
37821_0,,,,2,2,1,3
37822_0,,,,2,2,1,3
37823_0,,,,2,2,1,3
37824_0,,,,2,2,1,3
37826_0,,,,2,2,1,3
C(C(C)(C1(C(CC(C1)O)O)O)O)=O,,,5,1,1,0,1
37828_0,,,,2,2,1,3
C(C(C1(C(CC(C1)O)O)O)O)(O)=O,,,5,1,1,0,1
37830_0,,,,2,2,1,3
C(C1(C(C(CO)C(C1)O)=O)O)(O)=O,,,5,1,1,0,1
37831_0,,,,2,2,1,3
37832_0,,,,2,2,1,3
37833_0,,,,2,2,1,3
37834_0,,,,2,2,1,3
37835_0,,,,2,2,1,3
37836_0,,,,2,2,1,3
37837_0,,,,2,2,1,3
37838_0,,,,2,2,1,3
37839_0,,,,2,2,1,3
37841_0,,,,2,2,1,3
C(C(C)(C(C(CO)C(C)O)O)O)=O,,,5,1,1,0,1
37842_0,,,,2,2,1,3
37844_0,,,,2,2,1,3
C(C(C)(C(CC(CCO)O)O)O)=O,,,5,1,1,0,1
37845_0,,,,2,2,1,3
37846_0,,,,2,2,1,3
37848_0,,,,2,2,1,3
C(C(C(O)=O)(C(C=O)CO)O)(O)=O,,,5,1,1,0,1
37849_0,,,,2,2,1,3
37850_0,,,,2,2,1,3
37852_0,,,,2,2,1,3
C(C(CO)C(C(C=C)=O)(CO)O)=O,,,5,1,1,0,1
37854_0,,,,2,2,1,3
C(C(C)(C(C(CO)CO)O)O)=O,,,5,1,1,0,1
37856_0,,,,2,2,1,3
C(C(C=C)(C(C(CO)CO)O)O)=O,,,5,1,1,0,1
37857_0,,,,2,2,1,3
37858_0,,,,2,2,1,3
37859_0,,,,2,2,1,3
37860_0,,,,2,2,1,3
37861_0,,,,2,2,1,3
37862_0,,,,2,2,1,3
37864_0,,,,2,2,1,3
C(CC(C(CO)=O)(C(C=C)O)O)=O,,,5,1,1,0,1
37865_0,,,,2,2,1,3
37866_0,,,,2,2,1,3
37867_0,,,,2,2,1,3
37868_0,,,,2,2,1,3
37869_0,,,,2,2,1,3
37870_0,,,,2,2,1,3
37871_0,,,,2,2,1,3
37873_0,,,,2,2,1,3
C(C(C(C)O)(CC=O)O)(C(C)O)=O,,,5,1,1,0,1
37874_0,,,,2,2,1,3
37875_0,,,,2,2,1,3
37876_0,,,,2,2,1,3
37877_0,,,,2,2,1,3
37878_0,,,,2,2,1,3
37880_0,,,,2,2,1,3
C(C(C)(C(CC(CO)(C)O)O)O)=O,,,5,1,1,0,1
37881_0,,,,2,2,1,3
37883_0,,,,2,2,1,3
C(C(C)(C(C)(C(C(C)O)O)O)O)=O,,,5,1,1,0,1
37885_0,,,,2,2,1,3
C(C(C(C)(C(C(C)O)O)O)O)(O)=O,,,5,1,1,0,1
37887_0,,,,2,2,1,3
C(CC(C(C=C)=O)(CO)O)(CO)=O,,,5,1,1,0,1
37888_0,,,,2,2,1,3
37889_0,,,,2,2,1,3
37890_0,,,,2,2,1,3
37892_0,,,,2,2,1,3
C(C(C)(C(CO)(CC(C)O)O)O)=O,,,5,1,1,0,1
37893_0,,,,2,2,1,3
37894_0,,,,2,2,1,3
37895_0,,,,2,2,1,3
37896_0,,,,2,2,1,3
37898_0,,,,2,2,1,3
C(C(C(O)=O)(CC(C=O)=O)O)(O)=O,,,5,1,1,0,1
37899_0,,,,2,2,1,3
37900_0,,,,2,2,1,3
37902_0,,,,2,2,1,3
C(C(C(O)=O)(C(C=O)C=O)O)(O)=O,,,5,1,1,0,1
37903_0,,,,2,2,1,3
37904_0,,,,2,2,1,3
37906_0,,,,2,2,1,3
C(C(C=O)(CC(C(O)=O)=O)O)(O)=O,,,5,1,1,0,1
37907_0,,,,2,2,1,3
37908_0,,,,2,2,1,3
37909_0,,,,2,2,1,3
37911_0,,,,2,2,1,3
C(C(C=O)C(C(O)=O)(C=O)O)(O)=O,,,5,1,1,0,1
37912_0,,,,2,2,1,3
37913_0,,,,2,2,1,3
37914_0,,,,2,2,1,3
37916_0,,,,2,2,1,3
C(C(CO)C(C(C=O)(C)O)O)(O)=O,,,5,1,1,0,1
37917_0,,,,2,2,1,3
37918_0,,,,2,2,1,3
37919_0,,,,2,2,1,3
37920_0,,,,2,2,1,3
37922_0,,,,2,2,1,3
C(C1(C(C(CO1)C(C)O)=O)O)(O)=O,,,5,1,1,0,1
37923_0,,,,2,2,1,3
37924_0,,,,2,2,1,3
37926_0,,,,2,2,1,3
C(C1(C(C(CO)CO1)=O)O)(O)=O,,,5,1,1,0,1
37928_0,,,,2,2,1,3
C1(C(C(C=C)O)(O)OCC1CO)=O,,,5,1,1,0,1
37929_0,,,,2,2,1,3
37930_0,,,,2,2,1,3
37931_0,,,,2,2,1,3
37932_0,,,,2,2,1,3
37933_0,,,,2,2,1,3
37934_0,,,,2,2,1,3
37936_0,,,,2,2,1,3
C=CC(C(CO)(CC(C=O)=O)O)=O,,,5,1,1,0,1
37938_0,,,,2,2,1,3
C(C(C=O)C(C(C=C)=O)(CO)O)=O,,,5,1,1,0,1
37940_0,,,,2,2,1,3
C(C(C(C=C)=O)(CC=O)O)(O)=O,,,5,1,1,0,1
37942_0,,,,2,2,1,3
C(CC(C(C=C)=O)(C(C=CC)O)O)=O,,,5,1,1,0,1
37944_0,,,,2,2,1,3
C(CC(C(C=C)=O)(C(CC=C)O)O)=O,,,5,1,1,0,1
37946_0,,,,2,2,1,3
C(CC(C(C=C)=O)(C(C=C)O)O)=O,,,5,1,1,0,1
37948_0,,,,2,2,1,3
C(CC(C(C=C)=O)(C(C=O)O)O)=O,,,5,1,1,0,1
37950_0,,,,2,2,1,3
C(CC(C(C=C)=O)(C(C)O)O)=O,,,5,1,2,0,2
37952_0,,,,2,2,1,3
C(CC(C(C=C)=O)(CO)O)=O,,,5,1,2,0,2
37954_0,,,,2,2,1,3
C(CC(C(C=C)=O)(C(CO)O)O)=O,,,5,1,1,0,1
37956_0,,,,2,2,1,3
C(C(C(O)=O)(CC(C=O)O)O)(O)=O,,,5,1,1,0,1
37957_0,,,,2,2,1,3
37958_0,,,,2,2,1,3
37960_0,,,,2,2,1,3
C(C(C=O)(CC(C(O)=O)O)O)(O)=O,,,5,1,1,0,1
37961_0,,,,2,2,1,3
37962_0,,,,2,2,1,3
37963_0,,,,2,2,1,3
37964_0,,,,2,2,1,3
37965_0,,,,2,2,1,3
37967_0,,,,2,2,1,3
C(C(C(O)=O)(CC(C)O)O)(O)=O,,,5,1,1,0,1
37969_0,,,,2,2,1,3
C(C(CC(C)O)(C(C=C)O)O)(O)=O,,,5,1,1,0,1
37970_0,,,,2,2,1,3
37972_0,,,,2,2,1,3
C(C(C(C)O)(CC(C)O)O)(O)=O,,,5,1,1,0,1
37973_0,,,,2,2,1,3
37975_0,,,,2,2,1,3
C(C(C(CO)O)(CC(C)O)O)(O)=O,,,5,1,1,0,1
37977_0,,,,2,2,1,3
C(C(C(O)=O)(CC(CO)O)O)(O)=O,,,5,1,1,0,1
37979_0,,,,2,2,1,3
C(C(C(C)O)(CC(CO)O)O)(O)=O,,,5,1,1,0,1
37980_0,,,,2,2,1,3
37982_0,,,,2,2,1,3
C(C(CO)(C(CO)C(C)O)O)(O)=O,,,5,1,1,0,1
37984_0,,,,2,2,1,3
C(C(C(O)=O)(C(CO)CO)O)(O)=O,,,5,1,1,0,1
37986_0,,,,2,2,1,3
C(C(C(C)O)(C(CO)CO)O)(O)=O,,,5,1,1,0,1
37987_0,,,,2,2,1,3
37989_0,,,,2,2,1,3
C(C(C=C)(C(C(C)O)O)O)(O)=O,,,5,1,1,0,1
37991_0,,,,2,2,1,3
C(C(C=C)(C(C(C=O)O)O)O)(O)=O,,,5,1,1,0,1
37993_0,,,,2,2,1,3
C(C(C=C)(C(CC(C)=O)O)O)(O)=O,,,5,1,1,0,1
37995_0,,,,2,2,1,3
C(C(C=C)(C(C)(CC=O)O)O)(O)=O,,,5,1,1,0,1
37997_0,,,,2,2,1,3
C(C(C(O)=O)(C=C)O)(O)=O,,,5,1,1,0,1
37999_0,,,,2,2,1,3
C(C(C=C)(C(C=C)(CO)O)O)(O)=O,,,5,1,1,0,1
38001_0,,,,2,2,1,3
C(C(C=C)(C(C=CCO)O)O)(O)=O,,,5,1,1,0,1
38003_0,,,,2,2,1,3
C(C(C=C)(C(C=O)(CC)O)O)(O)=O,,,5,1,1,0,1
38005_0,,,,2,2,1,3
C(C(C=C)(C(C(CC)=O)O)O)(O)=O,,,5,1,1,0,1
38007_0,,,,2,2,1,3
C(C(C=C)(C(CCC=O)O)O)(O)=O,,,5,1,2,0,2
38009_0,,,,2,2,1,3
C(C(C=C)(C(C(C)=O)(C)O)O)(O)=O,,,5,1,1,0,1
38011_0,,,,2,2,1,3
C(C(C=C)(C(C(C=O)=C)O)O)(O)=O,,,5,1,1,0,1
38013_0,,,,2,2,1,3
C(C(C=C)(C(C=CC)O)O)(O)=O,,,5,1,1,0,1
38015_0,,,,2,2,1,3
C(C(C=C)(C(CC=C)O)O)(O)=O,,,5,1,1,0,1
38017_0,,,,2,2,1,3
C(C(C=C)(C(C(C=C)O)O)O)(O)=O,,,5,1,1,0,1
38019_0,,,,2,2,1,3
C(C(C=C)(C(C=C)O)O)(O)=O,,,5,1,1,0,1
38021_0,,,,2,2,1,3
C(C(C=C)(C1(C=COC1)O)O)(O)=O,,,5,1,1,0,1
38022_0,,,,2,2,1,3
38023_0,,,,2,2,1,3
38025_0,,,,2,2,1,3
C(C(C=C)(C(CO)(CO)O)O)(O)=O,,,5,1,1,0,1
38027_0,,,,2,2,1,3
C(C(C=C)(C(C=O)(C)O)O)(O)=O,,,5,1,4,0,4
38028_0,,,,2,2,1,3
38030_0,,,,2,2,1,3
C(C(C=C)(C(CC=O)O)O)(O)=O,,,5,1,3,0,3
38032_0,,,,2,2,1,3
C(C(C=C)(C(C)O)O)(O)=O,,,5,1,3,0,3
38034_0,,,,2,2,1,3
C(C(C=C)(C(CC(C)O)O)O)(O)=O,,,5,1,1,0,1
38036_0,,,,2,2,1,3
C(C(C=C)(C(CCO)O)O)(O)=O,,,5,1,3,0,3
38037_0,,,,2,2,1,3
38038_0,,,,2,2,1,3
38040_0,,,,2,2,1,3
C(C(C=C)(C(CO)(C)O)O)(O)=O,,,5,1,3,0,3
38041_0,,,,2,2,1,3
38042_0,,,,2,2,1,3
38044_0,,,,2,2,1,3
C(C(C=C)(C(CC(O)=O)O)O)(O)=O,,,5,1,1,0,1
38046_0,,,,2,2,1,3
C(C(C=C)(C(C(O)=O)(C=C)O)O)=O,,,5,1,2,0,2
38047_0,,,,2,2,1,3
38049_0,,,,2,2,1,3
C(C(C=C)(C(C=CC=O)O)O)(O)=O,,,5,1,1,0,1
38050_0,,,,2,2,1,3
38051_0,,,,2,2,1,3
38052_0,,,,2,2,1,3
38053_0,,,,2,2,1,3
38054_0,,,,2,2,1,3
38055_0,,,,2,2,1,3
38056_0,,,,2,2,1,3
38057_0,,,,2,2,1,3
38058_0,,,,2,2,1,3
38059_0,,,,2,2,1,3
38060_0,,,,2,2,1,3
38061_0,,,,2,2,1,3
38063_0,,,,2,2,1,3
C(C(C)(C(CC(C=O)=O)O)O)=O,,,5,1,2,0,2
38065_0,,,,2,2,1,3
C(C(C=C)(C(CC(C=O)=O)O)O)=O,,,5,1,1,0,1
38066_0,,,,2,2,1,3
38068_0,,,,2,2,1,3
C(C(C)(C(CC(C=O)=O)O)O)(O)=O,,,5,1,1,0,1
38069_0,,,,2,2,1,3
38070_0,,,,2,2,1,3
38071_0,,,,2,2,1,3
38072_0,,,,2,2,1,3
38073_0,,,,2,2,1,3
38074_0,,,,2,2,1,3
38075_0,,,,2,2,1,3
38076_0,,,,2,2,1,3
38077_0,,,,2,2,1,3
38078_0,,,,2,2,1,3
38079_0,,,,2,2,1,3
38080_0,,,,2,2,1,3
38082_0,,,,2,2,1,3
C(CC(C(C(CO)=O)=O)(CO)O)=O,,,5,1,1,0,1
38083_0,,,,2,2,1,3
38085_0,,,,2,2,1,3
C=CC(C(C(C(CO)=O)=O)(C)O)O,,,5,1,1,0,1
38087_0,,,,2,2,1,3
C(C(C(C(C(CO)=O)=O)(C)O)O)=O,,,5,1,1,0,1
38089_0,,,,2,2,1,3
C(C(CO)=O)(C(C)(C(C)O)O)=O,,,5,1,1,0,1
38090_0,,,,2,2,1,3
38092_0,,,,2,2,1,3
C(C(CO)=O)(C(C)(C(CO)O)O)=O,,,5,1,1,0,1
38094_0,,,,2,2,1,3
C(C(C(CO)O)=O)(C(CO)(C)O)=O,,,5,1,2,0,2
38095_0,,,,2,2,1,3
38096_0,,,,2,2,1,3
38097_0,,,,2,2,1,3
38098_0,,,,2,2,1,3
38100_0,,,,2,2,1,3
C(C(C)(C(C(C(C=O)=O)O)O)O)=O,,,5,1,1,0,1
38101_0,,,,2,2,1,3
38102_0,,,,2,2,1,3
38104_0,,,,2,2,1,3
C(CC(C(C=O)=O)(C(C=C)O)O)=O,,,5,1,1,0,1
38106_0,,,,2,2,1,3
C(CC(C(C=O)=O)(C(C=O)O)O)=O,,,5,1,1,0,1
38108_0,,,,2,2,1,3
C(CC(C(C=O)=O)(C(C)O)O)=O,,,5,1,2,0,2
38109_0,,,,2,2,1,3
38111_0,,,,2,2,1,3
C(CC(C(C=O)=O)(C(CO)O)O)=O,,,5,1,1,0,1
38112_0,,,,2,2,1,3
38114_0,,,,2,2,1,3
C(C(CC(C(C=O)=O)(CO)O)O)=O,,,5,1,1,0,1
38116_0,,,,2,2,1,3
C(CC(C(C=O)=O)(CO)O)(CO)=O,,,5,1,1,0,1
38118_0,,,,2,2,1,3
C(C(C)(C(C(C)O)O)O)=O,,,5,1,1,0,1
38119_0,,,,2,2,1,3
38120_0,,,,2,2,1,3
38122_0,,,,2,2,1,3
C(C(C)(C(C)(CC(C=O)=O)O)O)=O,,,5,1,1,0,1
38124_0,,,,2,2,1,3
C(CC(C=O)(C(C=O)(C)O)O)(C)=O,,,5,1,1,0,1
38125_0,,,,2,2,1,3
38127_0,,,,2,2,1,3
C(C(C=O)C(C(C=O)(C)O)O)=O,,,5,1,1,0,1
38128_0,,,,2,2,1,3
38130_0,,,,2,2,1,3
C(C(C=O)C(C)(C(C=O)(C)O)O)=O,,,5,1,1,0,1
38132_0,,,,2,2,1,3
C(C(C)(C(C(C=O)C(C)=O)O)O)=O,,,5,1,1,0,1
38134_0,,,,2,2,1,3
C(C(C)(C(CC(C)=O)O)O)=O,,,5,1,1,0,1
38136_0,,,,2,2,1,3
C(C(C)(C(C)(CC=O)O)O)=O,,,5,1,1,0,1
38137_0,,,,2,2,1,3
38138_0,,,,2,2,1,3
38139_0,,,,2,2,1,3
38140_0,,,,2,2,1,3
38142_0,,,,2,2,1,3
C(OCC(C)(C(C=O)(C)O)O)=O,,,5,1,1,0,1
38144_0,,,,2,2,1,3
C(C(C(CC(C(C)O)=O)O)(C)O)=O,,,5,1,1,0,1
38146_0,,,,2,2,1,3
C(C(C)(C(C(C)O)(CC=O)O)O)=O,,,5,1,1,0,1
38147_0,,,,2,2,1,3
38148_0,,,,2,2,1,3
38150_0,,,,2,2,1,3
C(C(C)(C(C(C)(CCO)O)O)O)=O,,,5,1,1,0,1
38152_0,,,,2,2,1,3
C(C(C)(C(C)(C(CCO)O)O)O)=O,,,5,1,1,0,1
38154_0,,,,2,2,1,3
C(C(C)(C(C=C)(CO)O)O)=O,,,5,1,1,0,1
38156_0,,,,2,2,1,3
C(C(C)(C(C=CCO)O)O)=O,,,5,1,1,0,1
38157_0,,,,2,2,1,3
38159_0,,,,2,2,1,3
C(C(C)(C(C=CC(O)=O)O)O)=O,,,5,1,1,0,1
38161_0,,,,2,2,1,3
C(C(C)(C(COC(CO)=O)O)O)=O,,,5,1,1,0,1
38163_0,,,,2,2,1,3
C(C(CO)CC(C(C=O)(C)O)O)=O,,,5,1,1,0,1
38165_0,,,,2,2,1,3
C(C(C)(C(C(CO)CC=O)O)O)=O,,,5,1,1,0,1
38167_0,,,,2,2,1,3
C(C(C)(C(C)(CC(CO)=O)O)O)=O,,,5,1,1,0,1
38169_0,,,,2,2,1,3
C(C(C)(C(CO)(CC(C)=O)O)O)=O,,,5,1,1,0,1
38171_0,,,,2,2,1,3
C(C(CO)(C(C=O)(C)O)O)(CC)=O,,,5,1,1,0,1
38173_0,,,,2,2,1,3
C(C(C)(C(C(CO)=O)(CC)O)O)=O,,,5,1,1,0,1
38175_0,,,,2,2,1,3
C(C(C)C(C=O)(C(C=O)(C)O)O)=O,,,5,1,1,0,1
38177_0,,,,2,2,1,3
C(C(C)(C(C(C(C=O)C)=O)O)O)=O,,,5,1,1,0,1
38179_0,,,,2,2,1,3
C(C(C(C(C(C=O)=O)C)O)(C)O)=O,,,5,1,1,0,1
38181_0,,,,2,2,1,3
C(C(C)(C(CC(C(C)=O)=O)O)O)=O,,,5,1,1,0,1
38183_0,,,,2,2,1,3
C(CC(C(C)(C(C=O)(C)O)O)=O)=O,,,5,1,2,0,2
38184_0,,,,2,2,1,3
38186_0,,,,2,2,1,3
C(C(C)(C(CCC(C=O)=O)O)O)=O,,,5,1,1,0,1
38188_0,,,,2,2,1,3
C(CCC(C=O)(C(C=O)(C)O)O)=O,,,5,1,2,0,2
38189_0,,,,2,2,1,3
38191_0,,,,2,2,1,3
C(C(C)(C(CC(CC=O)=O)O)O)=O,,,5,1,1,0,1
38193_0,,,,2,2,1,3
C(C(C)(C(CC=O)(CC=O)O)O)=O,,,5,1,1,0,1
38195_0,,,,2,2,1,3
C(C(C=O)CC(C(C=O)(C)O)O)=O,,,5,1,1,0,1
38197_0,,,,2,2,1,3
C(C(C)(C(C(C=O)CC=O)O)O)=O,,,5,1,1,0,1
38199_0,,,,2,2,1,3
C(C(CC)(C(C=O)(C)O)O)=O,,,5,1,1,0,1
38201_0,,,,2,2,1,3
C(C(C)(C(C(CC)=O)O)O)=O,,,5,1,1,0,1
38203_0,,,,2,2,1,3
C(C(C)(C(CO)(CCC=O)O)O)=O,,,5,1,2,0,2
38205_0,,,,2,2,1,3
C(C(C)(C(CCC(CO)=O)O)O)=O,,,5,1,1,0,1
38207_0,,,,2,2,1,3
C(C(C)(C(CCO)(CC=O)O)O)=O,,,5,1,1,0,1
38209_0,,,,2,2,1,3
C(C(C)(C(CC(CCO)=O)O)O)=O,,,5,1,1,0,1
38211_0,,,,2,2,1,3
C(C(C)(C(CCC=O)O)O)=O,,,5,1,1,0,1
38213_0,,,,2,2,1,3
C(C(C)(C(C(C)=O)(C)O)O)=O,,,5,1,1,0,1
38215_0,,,,2,2,1,3
C(C(C(C(C(C)=O)CO)O)(C)O)=O,,,5,1,1,0,1
38217_0,,,,2,2,1,3
C(C(CO)C(C)(C(C=O)(C)O)O)=O,,,5,1,1,0,1
38218_0,,,,2,2,1,3
38220_0,,,,2,2,1,3
C(C(C)(C(CC(C(O)=O)=O)O)O)=O,,,5,1,1,0,1
38221_0,,,,2,2,1,3
38222_0,,,,2,2,1,3
38224_0,,,,2,2,1,3
C(C(CC)(C(C=O)(C)O)O)(O)=O,,,5,1,1,0,1
38226_0,,,,2,2,1,3
C(C(C)(C(C)(CC(O)=O)O)O)=O,,,5,1,1,0,1
38228_0,,,,2,2,1,3
C1(C(CCO1)(C(C=O)(C)O)O)=O,,,5,1,3,0,3
38230_0,,,,2,2,1,3
C(C(C)(C1(COC(C1)=O)O)O)=O,,,5,1,1,0,1
38232_0,,,,2,2,1,3
C(C(C=CC=O)(C(C=O)(C)O)O)=O,,,5,1,2,0,2
38233_0,,,,2,2,1,3
38235_0,,,,2,2,1,3
C(C(C)(C(C=CC(C=O)=O)O)O)=O,,,5,1,1,0,1
38237_0,,,,2,2,1,3
C(C(C)(C(C(C=O)=CC=O)O)O)=O,,,5,1,1,0,1
38239_0,,,,2,2,1,3
C(C(C)(C(C=C(C=O)C=O)O)O)=O,,,5,1,1,0,1
38241_0,,,,2,2,1,3
C(C(C)(C(C=C(CO)CO)O)O)=O,,,5,1,1,0,1
38243_0,,,,2,2,1,3
C(C(C)(C(CO)(C(C=C)O)O)O)=O,,,5,1,1,0,1
38245_0,,,,2,2,1,3
C(C(C)(C(C=C(C=O)C)O)O)=O,,,5,1,1,0,1
38247_0,,,,2,2,1,3
C(C(C)(C(C(C)=CC=O)O)O)=O,,,5,1,1,0,1
38249_0,,,,2,2,1,3
C(C(C)(C(CC(C=O)=C)O)O)=O,,,5,1,1,0,1
38251_0,,,,2,2,1,3
C(C(C)(C(C(CC=O)=C)O)O)=O,,,5,1,1,0,1
38253_0,,,,2,2,1,3
C(C(C)(C(C(C(C=O)=C)O)O)O)=O,,,5,1,1,0,1
38255_0,,,,2,2,1,3
C(C(C)(C(C(C(C=O)O)=C)O)O)=O,,,5,1,1,0,1
38257_0,,,,2,2,1,3
C(C(C)(C(C=CC(C)=O)O)O)=O,,,5,1,1,0,1
38259_0,,,,2,2,1,3
C(C(C)(C(C=CC=O)(C)O)O)=O,,,5,1,1,0,1
38261_0,,,,2,2,1,3
C(C(C)(C(C=O)(CC=C)O)O)=O,,,5,1,1,0,1
38263_0,,,,2,2,1,3
C(C(C)(C(C(CC=C)=O)O)O)=O,,,5,1,1,0,1
38265_0,,,,2,2,1,3
C(C(C)(C(C=O)(C=CC)O)O)=O,,,5,1,1,0,1
38267_0,,,,2,2,1,3
C(C(C)(C(C(C=CC)=O)O)O)=O,,,5,1,1,0,1
38269_0,,,,2,2,1,3
C(C(C)(C(C=O)(C=CCO)O)O)=O,,,5,1,1,0,1
38271_0,,,,2,2,1,3
C(C(C)(C(C(C=CCO)=O)O)O)=O,,,5,1,1,0,1
38273_0,,,,2,2,1,3
C(C(C)(C(C=CCC=O)O)O)=O,,,5,1,1,0,1
38275_0,,,,2,2,1,3
C(C(C)(C(CC=CC=O)O)O)=O,,,5,1,1,0,1
38277_0,,,,2,2,1,3
C(C(C)(C(C(C=CC=O)O)O)O)=O,,,5,1,1,0,1
38279_0,,,,2,2,1,3
C(C(C)(C(C=CC(C=O)O)O)O)=O,,,5,1,1,0,1
38281_0,,,,2,2,1,3
C(C(C=C)C(C(C=O)(C)O)O)=O,,,5,1,1,0,1
38283_0,,,,2,2,1,3
C(C(C)(C(C(C=O)=CC)O)O)=O,,,5,1,1,0,1
38285_0,,,,2,2,1,3
C(C(C)(C(C(C=O)=C)O)O)=O,,,5,1,1,0,1
38287_0,,,,2,2,1,3
C(C(C)(C(C(C=O)=CCO)O)O)=O,,,5,1,1,0,1
38289_0,,,,2,2,1,3
C(C(C)(C(C=O)(C(CO)=C)O)O)=O,,,5,1,1,0,1
38291_0,,,,2,2,1,3
C(C(C)(C(C(C(CO)=C)=O)O)O)=O,,,5,1,1,0,1
38293_0,,,,2,2,1,3
C(C(C)(C(C=C(C=O)CO)O)O)=O,,,5,1,1,0,1
38295_0,,,,2,2,1,3
C(C(C)(C(C(CO)=CC=O)O)O)=O,,,5,1,1,0,1
38297_0,,,,2,2,1,3
C(C(C)(C(C(C(CO)=O)=C)O)O)=O,,,5,1,1,0,1
38299_0,,,,2,2,1,3
C(C(C)(C(C(C=O)=C)(CO)O)O)=O,,,5,1,1,0,1
38301_0,,,,2,2,1,3
C(C(C)(C(C(C(C=C)=O)O)O)O)=O,,,5,1,1,0,1
38303_0,,,,2,2,1,3
C(C(C(C=C)(C(C=O)(C)O)O)O)=O,,,5,1,1,0,1
38305_0,,,,2,2,1,3
C(C(C)(C(C=CC)O)O)=O,,,5,1,1,0,1
38307_0,,,,2,2,1,3
C(C(C)(C(CC=C)O)O)=O,,,5,1,1,0,1
38309_0,,,,2,2,1,3
C(C(C)(C(C(C=C)O)O)O)=O,,,5,1,1,0,1
38311_0,,,,2,2,1,3
C(C(C)(C(C=CC(CO)O)O)O)=O,,,5,1,1,0,1
38313_0,,,,2,2,1,3
C(C(C)(C(C=C)O)O)=O,,,5,1,1,0,1
38315_0,,,,2,2,1,3
C(C(C)(C(C(C=C)(CO)O)O)O)=O,,,5,1,1,0,1
38317_0,,,,2,2,1,3
C(C(C)(C(C=CC(CO)=O)O)O)=O,,,5,1,1,0,1
38319_0,,,,2,2,1,3
C(C(C)(C(C=CC=O)(CO)O)O)=O,,,5,1,1,0,1
38321_0,,,,2,2,1,3
C(C(C)(C1(C=COC1)O)O)=O,,,5,1,1,0,1
38323_0,,,,2,2,1,3
C(C(C)(C1(C(O)OC(C)C1)O)O)=O,,,5,1,1,0,1
38324_0,,,,2,2,1,3
38326_0,,,,2,2,1,3
C(C(CCCO)(C(C=O)(C)O)O)=O,,,5,1,1,0,1
38328_0,,,,2,2,1,3
C(C(C)(C(C(CCCO)=O)O)O)=O,,,5,1,1,0,1
38329_0,,,,2,2,1,3
38330_0,,,,2,2,1,3
38331_0,,,,2,2,1,3
38332_0,,,,2,2,1,3
38333_0,,,,2,2,1,3
38335_0,,,,2,2,1,3
C(C(C)(C(C(CO)(CO)O)O)O)=O,,,5,1,1,0,1
38337_0,,,,2,2,1,3
C(C(C)(C(C=O)(C)O)O)=O,,,5,1,1,0,1
38338_0,,,,2,2,1,3
38340_0,,,,2,2,1,3
C(C(C)(C(CC=O)O)O)=O,,,5,1,1,0,1
38341_0,,,,2,2,1,3
38342_0,,,,2,2,1,3
38343_0,,,,2,2,1,3
38345_0,,,,2,2,1,3
C(C(C)(C(CC(C=O)O)O)O)=O,,,5,1,1,0,1
38347_0,,,,2,2,1,3
C(C(C)(C(CC(CO)=O)O)O)=O,,,5,1,1,0,1
38348_0,,,,2,2,1,3
38350_0,,,,2,2,1,3
C(C(C)(C(C(C(C)=O)O)O)O)=O,,,5,1,1,0,1
38352_0,,,,2,2,1,3
C(C(C)(C(C)(C(C=O)O)O)O)=O,,,5,1,1,0,1
38354_0,,,,2,2,1,3
C(C(C)(C(C)O)O)=O,,,5,1,1,0,1
38355_0,,,,2,2,1,3
38357_0,,,,2,2,1,3
C(C(C)(CC(C(C=O)(C)O)O)O)=O,,,5,1,1,0,1
38358_0,,,,2,2,1,3
38360_0,,,,2,2,1,3
C(C(C)(C(CC(C(C)=O)O)O)O)=O,,,5,1,1,0,1
38362_0,,,,2,2,1,3
C(C(C)(C(C)(C(CC=O)O)O)O)=O,,,5,1,1,0,1
38364_0,,,,2,2,1,3
C(C(CC(C)O)(C(C=O)(C)O)O)=O,,,5,1,1,0,1
38365_0,,,,2,2,1,3
38367_0,,,,2,2,1,3
C(C(C)(C(CC(CC=O)O)O)O)=O,,,5,1,1,0,1
38369_0,,,,2,2,1,3
C(C(C(C(C=O)(C)O)O)C(C)O)=O,,,5,1,1,0,1
38371_0,,,,2,2,1,3
C(C(CO)C(C(C=O)(C)O)O)=O,,,5,1,1,0,1
38373_0,,,,2,2,1,3
C(C(C)(C(CC(C)O)O)O)=O,,,5,1,1,0,1
38375_0,,,,2,2,1,3
C(C(C)(C(C(C(C)O)O)O)O)=O,,,5,1,1,0,1
38377_0,,,,2,2,1,3
C(C(C)(C(CCO)O)O)=O,,,5,1,1,0,1
38379_0,,,,2,2,1,3
C(C(C)(C(CC(CO)O)O)O)=O,,,5,1,1,0,1
38380_0,,,,2,2,1,3
38381_0,,,,2,2,1,3
38382_0,,,,2,2,1,3
38383_0,,,,2,2,1,3
38384_0,,,,2,2,1,3
38385_0,,,,2,2,1,3
38386_0,,,,2,2,1,3
38387_0,,,,2,2,1,3
38389_0,,,,2,2,1,3
C(C(C)(C(CO)(C)O)O)=O,,,5,1,1,0,1
38390_0,,,,2,2,1,3
38391_0,,,,2,2,1,3
38393_0,,,,2,2,1,3
C(C(C)(C(C)(C(CO)O)O)O)=O,,,5,1,1,0,1
38394_0,,,,2,2,1,3
38395_0,,,,2,2,1,3
38397_0,,,,2,2,1,3
C(C(C)(C(CC(O)=O)O)O)=O,,,5,1,1,0,1
38398_0,,,,2,2,1,3
38400_0,,,,2,2,1,3
C(C(C)(C(CC(C(O)=O)O)O)O)=O,,,5,1,1,0,1
38401_0,,,,2,2,1,3
38402_0,,,,2,2,1,3
38403_0,,,,2,2,1,3
38405_0,,,,2,2,1,3
C(C(C)(C1(COCC1O)O)O)=O,,,5,1,1,0,1
38407_0,,,,2,2,1,3
C(C(C)(C1(C(O)OCC1)O)O)=O,,,5,1,2,0,2
38409_0,,,,2,2,1,3
C(C(C)(C1(COC(C1)O)O)O)=O,,,5,1,2,0,2
38411_0,,,,2,2,1,3
C(C(C=C)(C(C=O)(C)O)O)=O,,,5,1,4,0,4
38412_0,,,,2,2,1,3
38414_0,,,,2,2,1,3
C(C(C)(C(C=CC=O)O)O)=O,,,5,1,2,0,2
38415_0,,,,2,2,1,3
38416_0,,,,2,2,1,3
38418_0,,,,2,2,1,3
C(CC(C(C)(C(C(C)O)O)O)=O)=O,,,5,1,1,0,1
38420_0,,,,2,2,1,3
C(CO)(C(C)(C(C(C)O)O)O)=O,,,5,1,1,0,1
38422_0,,,,2,2,1,3
C(C(C(C)(C(C(C)O)O)O)=O)(O)=O,,,5,1,1,0,1
38424_0,,,,2,2,1,3
C1(C(CCO1)(C(C(C)O)O)O)=O,,,5,1,1,0,1
38426_0,,,,2,2,1,3
C(C)(C(CCO)(C(C(C)O)O)O)=O,,,5,1,1,0,1
38428_0,,,,2,2,1,3
C(C(C(C(C)O)O)O)(OCC=O)=O,,,5,1,1,0,1
38430_0,,,,2,2,1,3
C(CO)(C(C=C)(C(C(C)O)O)O)=O,,,5,1,1,0,1
38432_0,,,,2,2,1,3
C(C(C(C=O)=C)(C(C(C)O)O)O)=O,,,5,1,1,0,1
38434_0,,,,2,2,1,3
C(C(C=CC=O)(C(C(C)O)O)O)=O,,,5,1,1,0,1
38436_0,,,,2,2,1,3
C(C(C=C)(C(C(C)O)O)O)=O,,,5,1,1,0,1
38438_0,,,,2,2,1,3
C1(C(C(C(C)O)O)(O)OC(C)C1)=O,,,5,1,1,0,1
38440_0,,,,2,2,1,3
C1(C(C(C(C)O)O)(O)OCC1O)=O,,,5,1,1,0,1
38442_0,,,,2,2,1,3
C1(C(CC(O)O1)(C(C(C)O)O)O)=O,,,5,1,1,0,1
38443_0,,,,2,2,1,3
38444_0,,,,2,2,1,3
38445_0,,,,2,2,1,3
38446_0,,,,2,2,1,3
38448_0,,,,2,2,1,3
C(C(CCO)(C(C(C)O)O)O)(O)=O,,,5,1,1,0,1
38450_0,,,,2,2,1,3
C(C(C(C)(C(C(C)O)O)O)=O)=O,,,5,1,1,0,1
38452_0,,,,2,2,1,3
C(C(CCO)(C(C(C)O)O)O)=O,,,5,1,1,0,1
38454_0,,,,2,2,1,3
C(C(C(C(C)O)O)(CC=O)O)(O)=O,,,5,1,1,0,1
38456_0,,,,2,2,1,3
C(C(C(C(C)O)O)(CC(O)=O)O)=O,,,5,1,1,0,1
38458_0,,,,2,2,1,3
C1(C(C(C(C)O)O)(O)OCC1)=O,,,5,1,1,0,1
38459_0,,,,2,2,1,3
38460_0,,,,2,2,1,3
38461_0,,,,2,2,1,3
38463_0,,,,2,2,1,3
C(C(C(C=O)(CC(C)=O)O)O)(O)=O,,,5,1,1,0,1
38464_0,,,,2,2,1,3
38466_0,,,,2,2,1,3
C(C(C=O)C(C(C=O)(C=C)O)O)=O,,,5,1,1,0,1
38467_0,,,,2,2,1,3
38469_0,,,,2,2,1,3
C(C(C=O)C(C(C(O)=O)(C)O)O)=O,,,5,1,1,0,1
38470_0,,,,2,2,1,3
38472_0,,,,2,2,1,3
C1(C(C(C(C=O)O)O)(CCO1)O)=O,,,5,1,1,0,1
38473_0,,,,2,2,1,3
38474_0,,,,2,2,1,3
38475_0,,,,2,2,1,3
38476_0,,,,2,2,1,3
38477_0,,,,2,2,1,3
38478_0,,,,2,2,1,3
38479_0,,,,2,2,1,3
38480_0,,,,2,2,1,3
38481_0,,,,2,2,1,3
38483_0,,,,2,2,1,3
C(C)(CC(C(C(CO)=O)(C)O)O)=O,,,5,1,1,0,1
38485_0,,,,2,2,1,3
C1(C(C(CC(C)=O)O)(CCO1)O)=O,,,5,1,1,0,1
38487_0,,,,2,2,1,3
C(C(C=C)(C(CC(C)=O)O)O)=O,,,5,1,1,0,1
38489_0,,,,2,2,1,3
C(C(C(CC(C)=O)O)O)(O)=O,,,5,1,3,0,3
38491_0,,,,2,2,1,3
C(C)(CC(C(C=O)(CC=O)O)O)=O,,,5,1,1,0,1
38493_0,,,,2,2,1,3
C(C(C)(C(CC(C)=O)O)O)(O)=O,,,5,1,3,0,3
38495_0,,,,2,2,1,3
C(C)(CC(C(C(C=O)=O)(C)O)O)=O,,,5,1,1,0,1
38497_0,,,,2,2,1,3
C(C(C(CC(C)=O)O)(CCO)O)=O,,,5,1,1,0,1
38499_0,,,,2,2,1,3
C1(C(C(CC(C)=O)O)(O)OCC1)=O,,,5,1,1,0,1
38501_0,,,,2,2,1,3
C(CC(C)(C(C(CO)=O)(C)O)O)=O,,,5,1,1,0,1
38503_0,,,,2,2,1,3
C1(C(CCO1)(C(C)(CC=O)O)O)=O,,,5,1,1,0,1
38504_0,,,,2,2,1,3
38505_0,,,,2,2,1,3
38506_0,,,,2,2,1,3
38508_0,,,,2,2,1,3
C(C(C)(C(C)(CC=O)O)O)(O)=O,,,5,1,2,0,2
38510_0,,,,2,2,1,3
C(CC(C)(C(C(C=O)=O)(C)O)O)=O,,,5,1,1,0,1
38512_0,,,,2,2,1,3
C(C(CCO)(C(C)(CC=O)O)O)=O,,,5,1,1,0,1
38514_0,,,,2,2,1,3
C(CC(C)(C1(C(CCO1)=O)O)O)=O,,,5,1,1,0,1
38515_0,,,,2,2,1,3
38517_0,,,,2,2,1,3
C(C(C(CC(C=O)=O)=O)(C)O)(O)=O,,,5,1,1,0,1
38519_0,,,,2,2,1,3
C(C(C=O)C(C(C(O)=O)(C)O)=O)=O,,,5,1,1,0,1
38521_0,,,,2,2,1,3
C(C(C(CC=O)=O)(C)O)(O)=O,,,5,1,1,0,1
38522_0,,,,2,2,1,3
38524_0,,,,2,2,1,3
C(C(C(CC=O)=O)(CCO)O)(O)=O,,,5,1,1,0,1
38526_0,,,,2,2,1,3
C(C(C(C=O)=O)(CC(C)O)O)(O)=O,,,5,1,1,0,1
38527_0,,,,2,2,1,3
38528_0,,,,2,2,1,3
38530_0,,,,2,2,1,3
C(C(C(C(O)=O)=O)(C)O)(O)=O,,,5,1,1,0,1
38532_0,,,,2,2,1,3
C(C(C(C(C(O)=O)O)=O)(C)O)(O)=O,,,5,1,1,0,1
38534_0,,,,2,2,1,3
C(C(C=O)(CC(C=O)O)O)(O)=O,,,5,1,1,0,1
38536_0,,,,2,2,1,3
C(C(C(CO)=O)(CC(O)=O)O)(O)=O,,,5,1,1,0,1
38538_0,,,,2,2,1,3
C(C(C(C(O)=O)=O)(CCO)O)(O)=O,,,5,1,1,0,1
38540_0,,,,2,2,1,3
C1(C(C(O)=O)(CCO1)O)=O,,,5,1,1,0,1
38542_0,,,,2,2,1,3
C(C(C(C)=O)(CCO)O)(O)=O,,,5,1,2,0,2
38544_0,,,,2,2,1,3
C(C(C(CCO)=O)(CCO)O)(O)=O,,,5,1,1,0,1
38546_0,,,,2,2,1,3
C(C(C=O)(CC(CCO)O)O)(O)=O,,,5,1,1,0,1
38548_0,,,,2,2,1,3
C(C(C=O)(C(CO)C(C)O)O)(O)=O,,,5,1,1,0,1
38550_0,,,,2,2,1,3
C(C(C=O)(C(CO)CO)O)(O)=O,,,5,1,1,0,1
38552_0,,,,2,2,1,3
C(C(C(C)=O)(CC(O)=O)O)(O)=O,,,5,1,1,0,1
38554_0,,,,2,2,1,3
C(C(C=O)(C(C(O)=O)CO)O)(O)=O,,,5,1,1,0,1
38556_0,,,,2,2,1,3
C(C(C(O)=O)(CC(O)=O)O)(O)=O,,,5,1,1,0,1
38558_0,,,,2,2,1,3
C(C(C(O)=O)O)(OCC=O)=O,,,5,1,1,0,1
38560_0,,,,2,2,1,3
C(C(C(OC(C=O)CO)=O)O)(O)=O,,,5,1,1,0,1
38562_0,,,,2,2,1,3
C(C(C(O)=O)O)(OCC(C=O)O)=O,,,5,1,1,0,1
38564_0,,,,2,2,1,3
C(C(C=O)(CC(CC=O)=O)O)(O)=O,,,5,1,1,0,1
38566_0,,,,2,2,1,3
C(C(C(CC=O)=O)(CC=O)O)(O)=O,,,5,1,1,0,1
38568_0,,,,2,2,1,3
C(C(C=O)(CCC(C=O)=O)O)(O)=O,,,5,1,2,0,2
38570_0,,,,2,2,1,3
C(C(C=O)(C(C=O)CC=O)O)(O)=O,,,5,1,2,0,2
38572_0,,,,2,2,1,3
C(C(C(C)=O)C(C(O)=O)(C=O)O)=O,,,5,1,1,0,1
38574_0,,,,2,2,1,3
C(C(C=O)(CC(C(C)=O)=O)O)(O)=O,,,5,1,1,0,1
38576_0,,,,2,2,1,3
C(C(C=O)(C(C(C=O)=O)C)O)(O)=O,,,5,1,1,0,1
38578_0,,,,2,2,1,3
C(C1(C(CC(CO)O1)=O)O)(O)=O,,,5,1,1,0,1
38580_0,,,,2,2,1,3
C(C1(C(CC(CO1)O)=O)O)(O)=O,,,5,1,1,0,1
38582_0,,,,2,2,1,3
C1(C(C(O)=O)(CC(CO1)=O)O)=O,,,5,1,1,0,1
38584_0,,,,2,2,1,3
C(C(C=O)(C(C(C=O)=O)=C)O)(O)=O,,,5,1,1,0,1
38586_0,,,,2,2,1,3
C(C(C=O)(C(C=O)=CC=O)O)(O)=O,,,5,1,1,0,1
38588_0,,,,2,2,1,3
C(C(C(CO)=O)(C(C=O)=C)O)(O)=O,,,5,1,1,0,1
38590_0,,,,2,2,1,3
C(C(C(CO)=O)(C=CC=O)O)(O)=O,,,5,1,1,0,1
38592_0,,,,2,2,1,3
C(C(C(CO)=O)(C=C)O)(O)=O,,,5,1,1,0,1
38594_0,,,,2,2,1,3
C(C(C(C(CO)O)=O)(C=C)O)(O)=O,,,5,1,1,0,1
38596_0,,,,2,2,1,3
C(C(C=O)(C(C=O)=C)O)(O)=O,,,5,1,1,0,1
38598_0,,,,2,2,1,3
C(C(C=O)(C=CC=O)O)(O)=O,,,5,1,1,0,1
38600_0,,,,2,2,1,3
C(C(C=O)(C(C=O)=CCO)O)(O)=O,,,5,1,1,0,1
38602_0,,,,2,2,1,3
C(C(C=O)(CC=CC=O)O)(O)=O,,,5,1,1,0,1
38604_0,,,,2,2,1,3
C(C(C=O)(C=CCC=O)O)(O)=O,,,5,1,1,0,1
38606_0,,,,2,2,1,3
C(C(C=O)(C=CC(C=O)O)O)(O)=O,,,5,1,1,0,1
38608_0,,,,2,2,1,3
C(C(C=O)(C(C=O)C=C)O)(O)=O,,,5,1,1,0,1
38610_0,,,,2,2,1,3
C(C(C=O)(C(C=O)=CC)O)(O)=O,,,5,1,1,0,1
38612_0,,,,2,2,1,3
C(C(C=O)(C=CC(CO)=O)O)(O)=O,,,5,1,1,0,1
38614_0,,,,2,2,1,3
C(C(C=O)(C(CO)=CC=O)O)(O)=O,,,5,1,1,0,1
38616_0,,,,2,2,1,3
C(C(C(CC=O)=O)(C=C)O)(O)=O,,,5,1,1,0,1
38617_0,,,,2,2,1,3
38619_0,,,,2,2,1,3
C(C(C=O)(C(C)=CC=O)O)(O)=O,,,5,1,1,0,1
38621_0,,,,2,2,1,3
C(C(C=O)(C(CC=O)=C)O)(O)=O,,,5,1,1,0,1
38623_0,,,,2,2,1,3
C(C(C=O)(C(C(C=O)O)=C)O)(O)=O,,,5,1,1,0,1
38625_0,,,,2,2,1,3
C(C(C=O)(C=C)O)(O)=O,,,5,1,1,0,1
38627_0,,,,2,2,1,3
C(C(C(O)=O)(C(C=O)=C)O)(O)=O,,,5,1,1,0,1
38629_0,,,,2,2,1,3
C(C(C(O)=O)(C=CC=O)O)(O)=O,,,5,1,1,0,1
38631_0,,,,2,2,1,3
C(C1(C(CC(C=O)O1)=O)O)(O)=O,,,5,1,1,0,1
38633_0,,,,2,2,1,3
C(C1(C=O)CC(C(O1)O)=O)(O)=O,,,5,1,1,0,1
38635_0,,,,2,2,1,3
C(C1(C)CC(C(C(O)=O)(O1)O)=O)=O,,,5,1,1,0,1
38637_0,,,,2,2,1,3
C(C1(C(CC(C(C)=O)O1)=O)O)(O)=O,,,5,1,1,0,1
38639_0,,,,2,2,1,3
C(C1(C(C)=O)CC(C(O1)O)=O)(O)=O,,,5,1,1,0,1
38641_0,,,,2,2,1,3
C(C1(C(CC(CC=O)O1)=O)O)(O)=O,,,5,1,1,0,1
38643_0,,,,2,2,1,3
C(C1(C(CC(C)O1)=O)O)(O)=O,,,5,1,1,0,1
38645_0,,,,2,2,1,3
C(C1(C(C(CO)C(C)O1)=O)O)(O)=O,,,5,1,1,0,1
38647_0,,,,2,2,1,3
C(C1(C(C(CO1)O)=O)O)(O)=O,,,5,1,1,0,1
38649_0,,,,2,2,1,3
C(C1(C(C(C(CO)O1)O)=O)O)(O)=O,,,5,1,1,0,1
38651_0,,,,2,2,1,3
C1(C(C(O)=O)(CC(O)O1)O)=O,,,5,1,1,0,1
38653_0,,,,2,2,1,3
C1(C(C(O)=O)(CC(CO)(O)O1)O)=O,,,5,1,1,0,1
38655_0,,,,2,2,1,3
C(C1(C=O)CC(CC(O1)O)O)(O)=O,,,5,1,1,0,1
38657_0,,,,2,2,1,3
C(C1(C(C(C(CO1)O)O)=O)O)(O)=O,,,5,1,1,0,1
38659_0,,,,2,2,1,3
C(C1(C(CCOC(C1)O)=O)O)(O)=O,,,5,1,1,0,1
38660_0,,,,2,2,1,3
38661_0,,,,2,2,1,3
38663_0,,,,2,2,1,3
C(C(C=O)(CC(C=O)=O)O)(O)=O,,,5,1,1,0,1
38665_0,,,,2,2,1,3
C(C(C=O)(C(C=O)C=O)O)(O)=O,,,5,1,1,0,1
38667_0,,,,2,2,1,3
C(C(C(C)=O)(CC(C=O)=O)O)(O)=O,,,5,1,1,0,1
38669_0,,,,2,2,1,3
C(C(C=O)C(C(O)=O)(C(C)=O)O)=O,,,5,1,1,0,1
38670_0,,,,2,2,1,3
38671_0,,,,2,2,1,3
38673_0,,,,2,2,1,3
C(C(C=O)(CC(CC=O)O)O)(O)=O,,,5,1,1,0,1
38675_0,,,,2,2,1,3
C(C(C=O)(C(C=O)C(C)O)O)(O)=O,,,5,1,1,0,1
38677_0,,,,2,2,1,3
C(C(C=O)(C(C=O)CO)O)(O)=O,,,5,1,1,0,1
38679_0,,,,2,2,1,3
C(C(C(O)=O)(C)O)(O)=O,,,5,1,1,0,1
38681_0,,,,2,2,1,3
C(C(C(O)=O)(CCO)O)(O)=O,,,5,1,1,0,1
38682_0,,,,2,2,1,3
38683_0,,,,2,2,1,3
38685_0,,,,2,2,1,3
C(C(C(O)=O)(CC=O)O)(O)=O,,,5,1,1,0,1
38687_0,,,,2,2,1,3
C(C(C=O)(CC(O)=O)O)(O)=O,,,5,1,1,0,1
38689_0,,,,2,2,1,3
C(C(C=O)(CC(CO)=O)O)(O)=O,,,5,1,1,0,1
38691_0,,,,2,2,1,3
C(C(C(O)=O)(CC(CO)=O)O)(O)=O,,,5,1,1,0,1
38693_0,,,,2,2,1,3
C(C1(C(CCO1)=O)O)(O)=O,,,5,1,1,0,1
38694_0,,,,2,2,1,3
38695_0,,,,2,2,1,3
38696_0,,,,2,2,1,3
38697_0,,,,2,2,1,3
38698_0,,,,2,2,1,3
38699_0,,,,2,2,1,3
38700_0,,,,2,2,1,3
38702_0,,,,2,2,1,3
C(OCC(C)(C(C=O)(C=C)O)O)=O,,,5,1,1,0,1
38704_0,,,,2,2,1,3
C(OCC(C)(C(C(O)=O)O)O)=O,,,5,1,1,0,1
38706_0,,,,2,2,1,3
C(OCC(C)(C(C(O)=O)(C)O)O)=O,,,5,1,1,0,1
38707_0,,,,2,2,1,3
38709_0,,,,2,2,1,3
C(C(CO)(C)O)(C(C(CO)=O)O)=O,,,5,1,1,0,1
38711_0,,,,2,2,1,3
C(C(C)(C(C=C)O)O)(C(CO)O)=O,,,5,1,1,0,1
38712_0,,,,2,2,1,3
38714_0,,,,2,2,1,3
C(C(CO)O)(C(C)(C(C)O)O)=O,,,5,1,1,0,1
38715_0,,,,2,2,1,3
38716_0,,,,2,2,1,3
38717_0,,,,2,2,1,3
38719_0,,,,2,2,1,3
C(C(C)(C(C)O)O)(CC(C=O)=O)=O,,,5,1,1,0,1
38721_0,,,,2,2,1,3
C(C(CO)(C)O)(CC(C=O)=O)=O,,,5,1,1,0,1
38723_0,,,,2,2,1,3
C(C(C=O)C(C(C)(C(C)O)O)=O)=O,,,5,1,1,0,1
38725_0,,,,2,2,1,3
C(C(C=O)C(C(CO)(C)O)=O)=O,,,5,1,1,0,1
38727_0,,,,2,2,1,3
C(C(C)(C(C=CC)O)O)(CC=O)=O,,,5,1,1,0,1
38729_0,,,,2,2,1,3
C(C(C)(C(CC=C)O)O)(CC=O)=O,,,5,1,1,0,1
38731_0,,,,2,2,1,3
C(C(C)(C(C=C)O)O)(CC=O)=O,,,5,1,1,0,1
38732_0,,,,2,2,1,3
38733_0,,,,2,2,1,3
38734_0,,,,2,2,1,3
38736_0,,,,2,2,1,3
C(C(C)(C(CC=O)O)O)(CC=O)=O,,,5,1,1,0,1
38738_0,,,,2,2,1,3
C(CC(C(C)(C(C)O)O)=O)=O,,,5,1,1,0,1
38740_0,,,,2,2,1,3
C(CC(C(C)(C(CCO)O)O)=O)=O,,,5,1,1,0,1
38742_0,,,,2,2,1,3
C(CC(C(C)(C(CO)(C)O)O)=O)=O,,,5,1,1,0,1
38744_0,,,,2,2,1,3
C(C(C)(C(C(O)=O)O)O)(CC=O)=O,,,5,1,2,0,2
38746_0,,,,2,2,1,3
C(CC(C(CO)(C)O)=O)=O,,,5,1,1,0,1
38748_0,,,,2,2,1,3
C(CC(C(C)(C(CO)O)O)=O)=O,,,5,1,1,0,1
38749_0,,,,2,2,1,3
38750_0,,,,2,2,1,3
38752_0,,,,2,2,1,3
C(C(C)(C(C=C)O)O)(C(C=O)O)=O,,,5,1,1,0,1
38753_0,,,,2,2,1,3
38755_0,,,,2,2,1,3
C(C(C(C(C)(C(C)O)O)=O)O)=O,,,5,1,1,0,1
38756_0,,,,2,2,1,3
38757_0,,,,2,2,1,3
38759_0,,,,2,2,1,3
C(CC(C(C(C)O)(CCO)O)=O)=O,,,5,1,1,0,1
38761_0,,,,2,2,1,3
C(CC(C(CO)(CCO)O)=O)=O,,,5,1,1,0,1
38762_0,,,,2,2,1,3
38763_0,,,,2,2,1,3
38764_0,,,,2,2,1,3
38766_0,,,,2,2,1,3
C(C(C(C(C)O)(CC(C)O)O)=O)=O,,,5,1,1,0,1
38768_0,,,,2,2,1,3
C(C(C(CO)(CC(C)O)O)=O)=O,,,5,1,1,0,1
38770_0,,,,2,2,1,3
C=CC(C(C(C=O)=O)(CCO)O)O,,,5,1,1,0,1
38771_0,,,,2,2,1,3
38773_0,,,,2,2,1,3
C(C(C(C(C)O)(CCO)O)=O)=O,,,5,1,1,0,1
38774_0,,,,2,2,1,3
38776_0,,,,2,2,1,3
C(C(C(C(CO)O)(CCO)O)=O)=O,,,5,1,1,0,1
38778_0,,,,2,2,1,3
C(C(C(CO)(CC(CO)O)O)=O)=O,,,5,1,2,0,2
38780_0,,,,2,2,1,3
C(CO)(C(C)(C(C=C)(CO)O)O)=O,,,5,1,1,0,1
38782_0,,,,2,2,1,3
C(CO)(C(C)(C(C=CCO)O)O)=O,,,5,1,1,0,1
38784_0,,,,2,2,1,3
C(C(CC)(C(C(CO)=O)(C)O)O)=O,,,5,1,1,0,1
38786_0,,,,2,2,1,3
C(CO)(C(C)(C(C(CC)=O)O)O)=O,,,5,1,1,0,1
38788_0,,,,2,2,1,3
C(CCC(C(C(CO)=O)(C)O)O)=O,,,5,1,1,0,1
38790_0,,,,2,2,1,3
C(C)(C(C)(C(C(CO)=O)(C)O)O)=O,,,5,1,1,0,1
38792_0,,,,2,2,1,3
C(CO)(C(C)(C(C(C=O)=C)O)O)=O,,,5,1,1,0,1
38794_0,,,,2,2,1,3
C(CO)(C(C)(C(C=CC)O)O)=O,,,5,1,1,0,1
38796_0,,,,2,2,1,3
C(CO)(C(C)(C(CC=C)O)O)=O,,,5,1,1,0,1
38798_0,,,,2,2,1,3
C(CO)(C(C)(C(C(C=C)O)O)O)=O,,,5,1,1,0,1
38800_0,,,,2,2,1,3
C(CO)(C(C)(C(C=C)O)O)=O,,,5,1,1,0,1
38802_0,,,,2,2,1,3
C(CO)(C(C)(C1(C=COC1)O)O)=O,,,5,1,1,0,1
38803_0,,,,2,2,1,3
38804_0,,,,2,2,1,3
38805_0,,,,2,2,1,3
38806_0,,,,2,2,1,3
38807_0,,,,2,2,1,3
38808_0,,,,2,2,1,3
38809_0,,,,2,2,1,3
38810_0,,,,2,2,1,3
38811_0,,,,2,2,1,3
38812_0,,,,2,2,1,3
38813_0,,,,2,2,1,3
38814_0,,,,2,2,1,3
38815_0,,,,2,2,1,3
38816_0,,,,2,2,1,3
38817_0,,,,2,2,1,3
38818_0,,,,2,2,1,3
38819_0,,,,2,2,1,3
38820_0,,,,2,2,1,3
38821_0,,,,2,2,1,3
38822_0,,,,2,2,1,3
38823_0,,,,2,2,1,3
38824_0,,,,2,2,1,3
38825_0,,,,2,2,1,3
38827_0,,,,2,2,1,3
C(C)=CC(C(C(C(O)=O)=O)(C)O)O,,,5,1,1,0,1
38829_0,,,,2,2,1,3
C=CCC(C(C(C(O)=O)=O)(C)O)O,,,5,1,1,0,1
38831_0,,,,2,2,1,3
C=CC(C(C(C(O)=O)=O)(C)O)O,,,5,1,1,0,1
38832_0,,,,2,2,1,3
38833_0,,,,2,2,1,3
38834_0,,,,2,2,1,3
38835_0,,,,2,2,1,3
38836_0,,,,2,2,1,3
38837_0,,,,2,2,1,3
38838_0,,,,2,2,1,3
38839_0,,,,2,2,1,3
38840_0,,,,2,2,1,3
38841_0,,,,2,2,1,3
38842_0,,,,2,2,1,3
38844_0,,,,2,2,1,3
C(C(C(C(CO)(C)O)=O)(CO)O)=O,,,5,1,1,0,1
38846_0,,,,2,2,1,3
C(C(C(C(C)(C(C)O)O)=O)O)(O)=O,,,5,1,1,0,1
38848_0,,,,2,2,1,3
C(C(C(C(CO)(C)O)=O)O)(O)=O,,,5,1,1,0,1
38850_0,,,,2,2,1,3
C(C(CC(C=O)(C(C=C)O)O)O)=O,,,5,1,1,0,1
38851_0,,,,2,2,1,3
38852_0,,,,2,2,1,3
38853_0,,,,2,2,1,3
38854_0,,,,2,2,1,3
38856_0,,,,2,2,1,3
C(C(CO)(CC(C=O)(CO)O)O)=O,,,5,1,1,0,1
38858_0,,,,2,2,1,3
C(CO)(C(C(C)O)(CC(O)=O)O)=O,,,5,1,1,0,1
38859_0,,,,2,2,1,3
38861_0,,,,2,2,1,3
C(C(C(C(C)O)(CCO)O)=O)(O)=O,,,5,1,1,0,1
38863_0,,,,2,2,1,3
C(C(C(CO)(CCO)O)=O)(O)=O,,,5,1,2,0,2
38865_0,,,,2,2,1,3
C1(C(CCO1)(C(C=C)(CO)O)O)=O,,,5,1,1,0,1
38867_0,,,,2,2,1,3
C1(C(CCO1)(C(C=CCO)O)O)=O,,,5,1,1,0,1
38869_0,,,,2,2,1,3
C1(C(CCO1)(C(C=O)(CC)O)O)=O,,,5,1,1,0,1
38871_0,,,,2,2,1,3
C1(C(CCO1)(C(C(CC)=O)O)O)=O,,,5,1,1,0,1
38873_0,,,,2,2,1,3
C1(C(C(CCC=O)O)(CCO1)O)=O,,,5,1,1,0,1
38875_0,,,,2,2,1,3
C1(C(CCO1)(C(C(C)=O)(C)O)O)=O,,,5,1,1,0,1
38877_0,,,,2,2,1,3
C1(C(CCO1)(C(C(C=O)=C)O)O)=O,,,5,1,1,0,1
38879_0,,,,2,2,1,3
C1(C(CCO1)(C(C=CC)O)O)=O,,,5,1,1,0,1
38881_0,,,,2,2,1,3
C1(C(C(CC=C)O)(CCO1)O)=O,,,5,1,1,0,1
38883_0,,,,2,2,1,3
C1(C(C(C(C=C)O)O)(CCO1)O)=O,,,5,1,1,0,1
38885_0,,,,2,2,1,3
C1(C(CCO1)(C(C=C)O)O)=O,,,5,1,1,0,1
38887_0,,,,2,2,1,3
C1(C(CCO1)(C2(C=COC2)O)O)=O,,,5,1,1,0,1
38889_0,,,,2,2,1,3
C1(C(CCO1)(C(C(CO)O)O)O)=O,,,5,1,1,0,1
38890_0,,,,2,2,1,3
38892_0,,,,2,2,1,3
C1(C(CCO1)(C(CO)(CO)O)O)=O,,,5,1,1,0,1
38893_0,,,,2,2,1,3
38894_0,,,,2,2,1,3
38896_0,,,,2,2,1,3
C1(C(C(CC=O)O)(CCO1)O)=O,,,5,1,2,0,2
38898_0,,,,2,2,1,3
C1(C(C(C)O)(CCO1)O)=O,,,5,1,2,0,2
38900_0,,,,2,2,1,3
C1(C(CCO1)(C(CC(C)O)O)O)=O,,,5,1,1,0,1
38902_0,,,,2,2,1,3
C1(C(CCO1)(C(CCO)O)O)=O,,,5,1,2,0,2
38903_0,,,,2,2,1,3
38904_0,,,,2,2,1,3
38906_0,,,,2,2,1,3
C1(C(CCO1)(C(CO)(C)O)O)=O,,,5,1,2,0,2
38908_0,,,,2,2,1,3
C1(C(CCO1)(C(C(O)=O)O)O)=O,,,5,1,3,0,3
38910_0,,,,2,2,1,3
C1(C(CCO1)(C(C(O)=O)(C)O)O)=O,,,5,1,2,0,2
38912_0,,,,2,2,1,3
C1(C(C(CC(O)=O)O)(CCO1)O)=O,,,5,1,1,0,1
38914_0,,,,2,2,1,3
C(C(C=C)(C1(C(OCC1)=O)O)O)=O,,,5,1,2,0,2
38915_0,,,,2,2,1,3
38917_0,,,,2,2,1,3
C1(C(CCO1)(C(C=CC=O)O)O)=O,,,5,1,1,0,1
38919_0,,,,2,2,1,3
C1(C(CO)(CCO1)O)=O,,,5,1,2,0,2
38921_0,,,,2,2,1,3
C1(C(C(CO)O)(CCO1)O)=O,,,5,1,2,0,2
38922_0,,,,2,2,1,3
38923_0,,,,2,2,1,3
38925_0,,,,2,2,1,3
C(C)(C(CCO)(C(C=CC)O)O)=O,,,5,1,1,0,1
38927_0,,,,2,2,1,3
C(C)(C(C(CC=C)O)(CCO)O)=O,,,5,1,1,0,1
38929_0,,,,2,2,1,3
C(C)(C(CCO)(C(C=C)O)O)=O,,,5,1,1,0,1
38930_0,,,,2,2,1,3
38931_0,,,,2,2,1,3
38932_0,,,,2,2,1,3
38933_0,,,,2,2,1,3
38934_0,,,,2,2,1,3
38935_0,,,,2,2,1,3
38936_0,,,,2,2,1,3
38937_0,,,,2,2,1,3
38938_0,,,,2,2,1,3
38939_0,,,,2,2,1,3
38940_0,,,,2,2,1,3
38941_0,,,,2,2,1,3
38942_0,,,,2,2,1,3
38943_0,,,,2,2,1,3
38944_0,,,,2,2,1,3
38945_0,,,,2,2,1,3
38946_0,,,,2,2,1,3
38947_0,,,,2,2,1,3
38949_0,,,,2,2,1,3
C(C(C(CO)CO)(C(C=C)O)O)=O,,,5,1,1,0,1
38950_0,,,,2,2,1,3
38951_0,,,,2,2,1,3
38952_0,,,,2,2,1,3
38953_0,,,,2,2,1,3
38954_0,,,,2,2,1,3
38956_0,,,,2,2,1,3
C(C(C=C)(C(C=C)(CO)O)O)=O,,,5,1,1,0,1
38957_0,,,,2,2,1,3
38958_0,,,,2,2,1,3
38959_0,,,,2,2,1,3
38960_0,,,,2,2,1,3
38961_0,,,,2,2,1,3
38962_0,,,,2,2,1,3
38964_0,,,,2,2,1,3
C(C(C=C)(C(C=CCO)O)O)=O,,,5,1,1,0,1
38965_0,,,,2,2,1,3
38966_0,,,,2,2,1,3
38967_0,,,,2,2,1,3
38968_0,,,,2,2,1,3
38969_0,,,,2,2,1,3
38970_0,,,,2,2,1,3
38972_0,,,,2,2,1,3
C(CC(C(C)=O)(C(C=C)O)O)(O)=O,,,5,1,1,0,1
38973_0,,,,2,2,1,3
38974_0,,,,2,2,1,3
38975_0,,,,2,2,1,3
38976_0,,,,2,2,1,3
38977_0,,,,2,2,1,3
38978_0,,,,2,2,1,3
38979_0,,,,2,2,1,3
38980_0,,,,2,2,1,3
38981_0,,,,2,2,1,3
38983_0,,,,2,2,1,3
C(CC(C(O)=O)(C(C=C)O)O)(O)=O,,,5,1,1,0,1
38984_0,,,,2,2,1,3
38985_0,,,,2,2,1,3
38986_0,,,,2,2,1,3
38987_0,,,,2,2,1,3
38988_0,,,,2,2,1,3
38989_0,,,,2,2,1,3
38990_0,,,,2,2,1,3
38992_0,,,,2,2,1,3
C(C(C=C)(C(C=CC(O)=O)O)O)=O,,,5,1,1,0,1
38993_0,,,,2,2,1,3
38994_0,,,,2,2,1,3
38995_0,,,,2,2,1,3
38996_0,,,,2,2,1,3
38997_0,,,,2,2,1,3
38999_0,,,,2,2,1,3
C(C(C(C=CC)O)O)(OCC=O)=O,,,5,1,1,0,1
39001_0,,,,2,2,1,3
C(C(C(CC=C)O)O)(OCC=O)=O,,,5,1,1,0,1
39003_0,,,,2,2,1,3
C(C(C(C=C)O)O)(OCC=O)=O,,,5,1,1,0,1
39005_0,,,,2,2,1,3
C(C(C(C=O)O)O)(OCC=O)=O,,,5,1,3,0,3
39007_0,,,,2,2,1,3
C(COC(C(C(C=O)(C)O)O)=O)=O,,,5,1,3,0,3
39009_0,,,,2,2,1,3
C(C(C(C(C)=O)O)O)(OCC=O)=O,,,5,1,3,0,3
39011_0,,,,2,2,1,3
C(C(C(CC=O)O)O)(OCC=O)=O,,,5,1,3,0,3
39013_0,,,,2,2,1,3
C(C(C(C)O)O)(OCC=O)=O,,,5,1,3,0,3
39015_0,,,,2,2,1,3
C(C(C(CCO)O)O)(OCC=O)=O,,,5,1,3,0,3
39017_0,,,,2,2,1,3
C(C(C(CO)(C)O)O)(OCC=O)=O,,,5,1,3,0,3
39019_0,,,,2,2,1,3
C(C(C(C(O)=O)O)O)(OCC=O)=O,,,5,1,3,0,3
39021_0,,,,2,2,1,3
C(C(CO)O)(OCC=O)=O,,,5,1,3,0,3
39023_0,,,,2,2,1,3
C(C(C(CO)O)O)(OCC=O)=O,,,5,1,3,0,3
39024_0,,,,2,2,1,3
39026_0,,,,2,2,1,3
C(C(C(C)O)O)(OC(C=O)CO)=O,,,5,1,3,0,3
39028_0,,,,2,2,1,3
C(C(CO)O)(OC(C=O)CO)=O,,,5,1,3,0,3
39030_0,,,,2,2,1,3
C(C(C(C)O)O)(OCC(C=O)O)=O,,,5,1,3,0,3
39032_0,,,,2,2,1,3
C(C(CO)O)(OCC(C=O)O)=O,,,5,1,3,0,3
39034_0,,,,2,2,1,3
C(C(CO)CC(C(C(O)=O)O)O)=O,,,5,1,1,0,1
39035_0,,,,2,2,1,3
39036_0,,,,2,2,1,3
39038_0,,,,2,2,1,3
C(C(C(CO)(CC(C)=O)O)O)(O)=O,,,5,1,1,0,1
39040_0,,,,2,2,1,3
C(C(CO)(C(C(O)=O)O)O)(CC)=O,,,5,1,1,0,1
39042_0,,,,2,2,1,3
C(CO)(C(CC)(C(C(O)=O)O)O)=O,,,5,1,1,0,1
39044_0,,,,2,2,1,3
C(C(C(C=O)(C(C=O)C)O)O)(O)=O,,,5,1,1,0,1
39046_0,,,,2,2,1,3
C(C(C(C(C(C(O)=O)O)O)=O)C)=O,,,5,1,1,0,1
39047_0,,,,2,2,1,3
39048_0,,,,2,2,1,3
39049_0,,,,2,2,1,3
39050_0,,,,2,2,1,3
39051_0,,,,2,2,1,3
39053_0,,,,2,2,1,3
C(CCC(C=O)(C(C(O)=O)O)O)=O,,,5,1,2,0,2
39054_0,,,,2,2,1,3
39055_0,,,,2,2,1,3
39057_0,,,,2,2,1,3
C(CC(C(C(O)=O)O)(CC=O)O)=O,,,5,1,1,0,1
39059_0,,,,2,2,1,3
C(C(C=O)CC(C(C(O)=O)O)O)=O,,,5,1,2,0,2
39060_0,,,,2,2,1,3
39061_0,,,,2,2,1,3
39062_0,,,,2,2,1,3
39064_0,,,,2,2,1,3
C(C(C(C)O)(CC=O)O)(CC=O)=O,,,5,1,1,0,1
39065_0,,,,2,2,1,3
39066_0,,,,2,2,1,3
39067_0,,,,2,2,1,3
39068_0,,,,2,2,1,3
39069_0,,,,2,2,1,3
39070_0,,,,2,2,1,3
39071_0,,,,2,2,1,3
39072_0,,,,2,2,1,3
39073_0,,,,2,2,1,3
39074_0,,,,2,2,1,3
39075_0,,,,2,2,1,3
39077_0,,,,2,2,1,3
C(C(C=C)(C(C=O)(CC)O)O)=O,,,5,1,1,0,1
39079_0,,,,2,2,1,3
C(C(CC)(C(C(O)=O)O)O)=O,,,5,1,1,0,1
39081_0,,,,2,2,1,3
C(CC(C=O)(C(C=O)(CC)O)O)=O,,,5,1,1,0,1
39083_0,,,,2,2,1,3
C(C(C)(C(C=O)(CC)O)O)(O)=O,,,5,1,1,0,1
39085_0,,,,2,2,1,3
C(C(CC)(C(C(C=O)=O)(C)O)O)=O,,,5,1,1,0,1
39087_0,,,,2,2,1,3
C(C(CCO)(C(C=O)(CC)O)O)=O,,,5,1,1,0,1
39089_0,,,,2,2,1,3
C(C(CC)(C1(C(CCO1)=O)O)O)=O,,,5,1,1,0,1
39091_0,,,,2,2,1,3
C(C(C=C)(C(C(CC)=O)O)O)=O,,,5,1,1,0,1
39093_0,,,,2,2,1,3
C(C(C(C(O)=O)O)O)(CC)=O,,,5,1,2,0,2
39095_0,,,,2,2,1,3
C(C(C(C=O)(CC=O)O)O)(CC)=O,,,5,1,1,0,1
39097_0,,,,2,2,1,3
C(C(C)(C(C(CC)=O)O)O)(O)=O,,,5,1,2,0,2
39099_0,,,,2,2,1,3
C(C(C(C(C=O)=O)(C)O)O)(CC)=O,,,5,1,1,0,1
39101_0,,,,2,2,1,3
C(C(CCO)(C(C(CC)=O)O)O)=O,,,5,1,1,0,1
39103_0,,,,2,2,1,3
C(C(C1(C(CCO1)=O)O)O)(CC)=O,,,5,1,1,0,1
39105_0,,,,2,2,1,3
C(CCC(CO)(C(C(O)=O)O)O)=O,,,5,1,2,0,2
39106_0,,,,2,2,1,3
39107_0,,,,2,2,1,3
39109_0,,,,2,2,1,3
C(CCO)(CC(C(C(O)=O)O)O)=O,,,5,1,1,0,1
39111_0,,,,2,2,1,3
C(C(C=C)(C(CCC=O)O)O)=O,,,5,1,2,0,2
39113_0,,,,2,2,1,3
C(CCC(C(C(O)=O)O)O)=O,,,5,1,3,0,3
39115_0,,,,2,2,1,3
C(CCC(C(C=O)(CC=O)O)O)=O,,,5,1,2,0,2
39117_0,,,,2,2,1,3
C(C(C)(C(CCC=O)O)O)(O)=O,,,5,1,3,0,3
39119_0,,,,2,2,1,3
C(CCC(C(C(C=O)=O)(C)O)O)=O,,,5,1,2,0,2
39121_0,,,,2,2,1,3
C(C(C(CCC=O)O)(CCO)O)=O,,,5,1,2,0,2
39123_0,,,,2,2,1,3
C(CCC(C1(C(CCO1)=O)O)O)=O,,,5,1,2,0,2
39125_0,,,,2,2,1,3
C(C(C=C)(C(C(C)=O)(C)O)O)=O,,,5,1,1,0,1
39127_0,,,,2,2,1,3
C(C)(C(C)(C(C(O)=O)O)O)=O,,,5,1,2,0,2
39129_0,,,,2,2,1,3
C(C)(C(C)(C(C=O)(CC=O)O)O)=O,,,5,1,1,0,1
39131_0,,,,2,2,1,3
C(C(C)(C(C(C)=O)(C)O)O)(O)=O,,,5,1,2,0,2
39133_0,,,,2,2,1,3
C(C)(C(C)(C(C(C=O)=O)(C)O)O)=O,,,5,1,1,0,1
39135_0,,,,2,2,1,3
C(C(CCO)(C(C(C)=O)(C)O)O)=O,,,5,1,1,0,1
39137_0,,,,2,2,1,3
C(C)(C(C)(C1(C(CCO1)=O)O)O)=O,,,5,1,1,0,1
39139_0,,,,2,2,1,3
C(C(C(C(C(C)=O)CO)O)O)(O)=O,,,5,1,1,0,1
39140_0,,,,2,2,1,3
39141_0,,,,2,2,1,3
39142_0,,,,2,2,1,3
39143_0,,,,2,2,1,3
39144_0,,,,2,2,1,3
39145_0,,,,2,2,1,3
39146_0,,,,2,2,1,3
39147_0,,,,2,2,1,3
39148_0,,,,2,2,1,3
39149_0,,,,2,2,1,3
39150_0,,,,2,2,1,3
39151_0,,,,2,2,1,3
39152_0,,,,2,2,1,3
39154_0,,,,2,2,1,3
C(C(C=C)(C(C(O)=O)(CC)O)O)=O,,,5,1,1,0,1
39156_0,,,,2,2,1,3
C(C(CC)(C(C(O)=O)O)O)(O)=O,,,5,1,1,0,1
39158_0,,,,2,2,1,3
C(C(CC)(C(C(O)=O)(C)O)O)(O)=O,,,5,1,1,0,1
39160_0,,,,2,2,1,3
C(C(C=C)(C(C)(CC(O)=O)O)O)=O,,,5,1,1,0,1
39161_0,,,,2,2,1,3
39163_0,,,,2,2,1,3
C(C(C)(C(C)(CC(O)=O)O)O)(O)=O,,,5,1,1,0,1
39165_0,,,,2,2,1,3
C1(C(C(C=C)O)(O)OC(CO)C1)=O,,,5,1,1,0,1
39167_0,,,,2,2,1,3
C(C(C1(C(CC(CO)O1)=O)O)O)=O,,,5,1,1,0,1
39169_0,,,,2,2,1,3
C1(C(C(C)O)(O)OC(CO)C1)=O,,,5,1,1,0,1
39171_0,,,,2,2,1,3
C1(C(CO)(O)OC(CO)C1)=O,,,5,1,3,0,3
39173_0,,,,2,2,1,3
C1(C(C(CO)O)(O)OC(CO)C1)=O,,,5,1,1,0,1
39175_0,,,,2,2,1,3
C1(C(CO)(O)OC(C(CO)O)C1)=O,,,5,1,2,0,2
39177_0,,,,2,2,1,3
C1(C(C(C=C)O)(O)OCC(C1)O)=O,,,5,1,1,0,1
39179_0,,,,2,2,1,3
C(C(C1(C(CC(CO1)O)=O)O)O)=O,,,5,1,1,0,1
39181_0,,,,2,2,1,3
C1(C(C(C)O)(O)OCC(C1)O)=O,,,5,1,1,0,1
39183_0,,,,2,2,1,3
C1(C(CO)(O)OCC(C1)O)=O,,,5,1,3,0,3
39185_0,,,,2,2,1,3
C1(C(C(CO)O)(O)OCC(C1)O)=O,,,5,1,1,0,1
39187_0,,,,2,2,1,3
C1(C(CO)(O)OC(C(C1)O)CO)=O,,,5,1,2,0,2
39189_0,,,,2,2,1,3
C1(C(CO)(O)OCC(C(C1)O)O)=O,,,5,1,2,0,2
39190_0,,,,2,2,1,3
39191_0,,,,2,2,1,3
39192_0,,,,2,2,1,3
39194_0,,,,2,2,1,3
C(C(C=C)(C1(COC(C1)=O)O)O)=O,,,5,1,1,0,1
39196_0,,,,2,2,1,3
C1(CC(CO1)(C(C(O)=O)O)O)=O,,,5,1,2,0,2
39198_0,,,,2,2,1,3
C(C(C)(C1(COC(C1)=O)O)O)(O)=O,,,5,1,1,0,1
39200_0,,,,2,2,1,3
C1(C(CC(CO1)=O)(C(C=C)O)O)=O,,,5,1,1,0,1
39202_0,,,,2,2,1,3
C1(C(CC(CO1)=O)(C(C=O)O)O)=O,,,5,1,1,0,1
39204_0,,,,2,2,1,3
C1(C(C(C)O)(CC(CO1)=O)O)=O,,,5,1,3,0,3
39206_0,,,,2,2,1,3
C1(C(CO)(CC(CO1)=O)O)=O,,,5,1,3,0,3
39208_0,,,,2,2,1,3
C1(C(C(CO)O)(CC(CO1)=O)O)=O,,,5,1,1,0,1
39210_0,,,,2,2,1,3
C1(C(CO)(CC(C(CO)O1)=O)O)=O,,,5,1,1,0,1
39212_0,,,,2,2,1,3
C1(C(CO)(CC(C(CO1)O)=O)O)=O,,,5,1,1,0,1
39214_0,,,,2,2,1,3
C(C(C=C)(C(C=O)(C=CC=O)O)O)=O,,,5,1,2,0,2
39216_0,,,,2,2,1,3
C(C(C=CC=O)(C(C(O)=O)O)O)=O,,,5,1,2,0,2
39217_0,,,,2,2,1,3
39218_0,,,,2,2,1,3
39220_0,,,,2,2,1,3
C(C(C=C)(C(C=CC(C=O)=O)O)O)=O,,,5,1,1,0,1
39222_0,,,,2,2,1,3
C(C(C(C=CC(C=O)=O)O)O)(O)=O,,,5,1,1,0,1
39224_0,,,,2,2,1,3
C(C(C=C)(C(C(C=O)=CC=O)O)O)=O,,,5,1,1,0,1
39226_0,,,,2,2,1,3
C(C(C(C(C=O)=CC=O)O)O)(O)=O,,,5,1,1,0,1
39228_0,,,,2,2,1,3
C(C(C=C)(C(C=C(C=O)C=O)O)O)=O,,,5,1,1,0,1
39230_0,,,,2,2,1,3
C(C(C(C=C(C=O)C=O)O)O)(O)=O,,,5,1,1,0,1
39232_0,,,,2,2,1,3
C(C(C(C(C=O)=O)=C)(C(C=C)O)O)=O,,,5,1,1,0,1
39234_0,,,,2,2,1,3
C(C(C(C(C=O)=O)=C)(C(C)O)O)=O,,,5,1,1,0,1
39236_0,,,,2,2,1,3
C(C(C(C(C=O)=O)=C)(CO)O)=O,,,5,1,3,0,3
39238_0,,,,2,2,1,3
C(C(C(C=O)=CC=O)(C(C=C)O)O)=O,,,5,1,1,0,1
39240_0,,,,2,2,1,3
C(C(C(C=O)=CC=O)(C(C)O)O)=O,,,5,1,1,0,1
39242_0,,,,2,2,1,3
C(C(C(C=O)=CC=O)(CO)O)=O,,,5,1,3,0,3
39244_0,,,,2,2,1,3
C(C(C(C=C(CO)CO)O)O)(O)=O,,,5,1,1,0,1
39246_0,,,,2,2,1,3
C(CO)(C(C(C=O)=C)(C(C)O)O)=O,,,5,1,1,0,1
39247_0,,,,2,2,1,3
39249_0,,,,2,2,1,3
C(CO)(C(C=CC=O)(C(C)O)O)=O,,,5,1,1,0,1
39250_0,,,,2,2,1,3
39252_0,,,,2,2,1,3
C(CO)(C(C=C)(C(C=CC)O)O)=O,,,5,1,1,0,1
39254_0,,,,2,2,1,3
C(CO)(C(C=C)(C(CC=C)O)O)=O,,,5,1,1,0,1
39256_0,,,,2,2,1,3
C(CO)(C(C=C)(C(C=C)O)O)=O,,,5,1,1,0,1
39258_0,,,,2,2,1,3
C(C(C(C(CO)=O)(C=C)O)O)=O,,,5,1,2,0,2
39260_0,,,,2,2,1,3
C(C(C)(C(C(CO)=O)(C=C)O)O)=O,,,5,1,1,0,1
39262_0,,,,2,2,1,3
C(CO)(C(C=C)(C(C(C)=O)O)O)=O,,,5,1,1,0,1
39264_0,,,,2,2,1,3
C(CC(C(C(CO)=O)(C=C)O)O)=O,,,5,1,1,0,1
39266_0,,,,2,2,1,3
C(CO)(C(C=C)(C(C)O)O)=O,,,5,1,2,0,2
39268_0,,,,2,2,1,3
C(CO)(C(C=C)(C(CCO)O)O)=O,,,5,1,1,0,1
39270_0,,,,2,2,1,3
C(CO)(C(C=C)(C(CO)(C)O)O)=O,,,5,1,1,0,1
39272_0,,,,2,2,1,3
C(C(C(C(CO)=O)(C=C)O)O)(O)=O,,,5,1,1,0,1
39273_0,,,,2,2,1,3
39275_0,,,,2,2,1,3
C(CO)(C(C=C)(C(CO)O)O)=O,,,5,1,2,0,2
39277_0,,,,2,2,1,3
C(C(C(CO)(C(C=C)O)O)O)(O)=O,,,5,1,1,0,1
39279_0,,,,2,2,1,3
C(C(CO)O)(C(C=C)(C(C)O)O)=O,,,5,1,1,0,1
39280_0,,,,2,2,1,3
39282_0,,,,2,2,1,3
C(C(C(C=O)=C(C=O)C)(CO)O)=O,,,5,1,1,0,1
39283_0,,,,2,2,1,3
39285_0,,,,2,2,1,3
C(CC=O)(C(C(C=O)=C)(CO)O)=O,,,5,1,1,0,1
39287_0,,,,2,2,1,3
C(C(C=C)(C(C=C(C=O)C)O)O)=O,,,5,1,1,0,1
39289_0,,,,2,2,1,3
C(C(C(C=C(C=O)C)O)O)(O)=O,,,5,1,2,0,2
39291_0,,,,2,2,1,3
C(C(C)(C(C=C(C=O)C)O)O)(O)=O,,,5,1,1,0,1
39293_0,,,,2,2,1,3
C(C(C=C)(C(C(C)=CC=O)O)O)=O,,,5,1,1,0,1
39295_0,,,,2,2,1,3
C(C(C(C(C)=CC=O)O)O)(O)=O,,,5,1,2,0,2
39297_0,,,,2,2,1,3
C(C(C)(C(C(C)=CC=O)O)O)(O)=O,,,5,1,1,0,1
39299_0,,,,2,2,1,3
C(C(C=C)(C(CC(C=O)=C)O)O)=O,,,5,1,1,0,1
39301_0,,,,2,2,1,3
C(C(C(CC(C=O)=C)O)O)(O)=O,,,5,1,2,0,2
39303_0,,,,2,2,1,3
C(C(C)(C(CC(C=O)=C)O)O)(O)=O,,,5,1,1,0,1
39305_0,,,,2,2,1,3
C(C(C=C)(C(C(CC=O)=C)O)O)=O,,,5,1,1,0,1
39307_0,,,,2,2,1,3
C(CC(C(C(C(O)=O)O)O)=C)=O,,,5,1,2,0,2
39309_0,,,,2,2,1,3
C(C(C)(C(C(CC=O)=C)O)O)(O)=O,,,5,1,1,0,1
39311_0,,,,2,2,1,3
C(C(C(C=O)=C)(C(C(C=O)=C)O)O)=O,,,5,1,1,0,1
39313_0,,,,2,2,1,3
C(C(C(C=O)=C)(C(C=CC)O)O)=O,,,5,1,1,0,1
39315_0,,,,2,2,1,3
C(C(C(C=O)=C)(C(CC=C)O)O)=O,,,5,1,1,0,1
39317_0,,,,2,2,1,3
C(C(C(C=O)=C)(C(C=C)O)O)=O,,,5,1,1,0,1
39319_0,,,,2,2,1,3
C(C(C(C=O)=C)(C1(C=COC1)O)O)=O,,,5,1,1,0,1
39321_0,,,,2,2,1,3
C(C(C(C=O)=C)(C(C=O)O)O)=O,,,5,1,3,0,3
39323_0,,,,2,2,1,3
C(C(C(C=O)=C)(C(C=O)(C)O)O)=O,,,5,1,1,0,1
39325_0,,,,2,2,1,3
C(C(C(C=O)=C)(C(C(C)=O)O)O)=O,,,5,1,1,0,1
39327_0,,,,2,2,1,3
C(C(C(C=O)=C)(C(CC=O)O)O)=O,,,5,1,1,0,1
39329_0,,,,2,2,1,3
C(C(C(C=O)=C)(C(C)O)O)=O,,,5,1,3,0,3
39331_0,,,,2,2,1,3
C(C(C(C=O)=C)(C(CCO)O)O)=O,,,5,1,1,0,1
39333_0,,,,2,2,1,3
C(C(C(C=O)=C)(C(CO)(C)O)O)=O,,,5,1,1,0,1
39335_0,,,,2,2,1,3
C(C(C(C=O)=C)(C(C(O)=O)O)O)=O,,,5,1,1,0,1
39337_0,,,,2,2,1,3
C(C(C=C)(C(C=O)(C(C=O)=C)O)O)=O,,,5,1,1,0,1
39339_0,,,,2,2,1,3
C(C(C(C=O)=C)(C(C(C=C)=O)O)O)=O,,,5,1,1,0,1
39341_0,,,,2,2,1,3
C(C(C(C=O)=C)(C(C=CC=O)O)O)=O,,,5,1,1,0,1
39342_0,,,,2,2,1,3
39343_0,,,,2,2,1,3
39345_0,,,,2,2,1,3
C(C(C(C(C(C=O)=C)O)O)O)(O)=O,,,5,1,1,0,1
39347_0,,,,2,2,1,3
C(C(C(C(C(C(O)=O)O)O)=C)O)=O,,,5,1,1,0,1
39349_0,,,,2,2,1,3
C(C)(C(C(C(C=O)=O)=C)(CO)O)=O,,,5,1,1,0,1
39351_0,,,,2,2,1,3
C(C)(C(C(C=O)=CC=O)(CO)O)=O,,,5,1,1,0,1
39353_0,,,,2,2,1,3
C(C(C(C=O)=CC(C)=O)(CO)O)=O,,,5,1,1,0,1
39355_0,,,,2,2,1,3
C(C(C=C)(C(C=CC(C)=O)O)O)=O,,,5,1,1,0,1
39357_0,,,,2,2,1,3
C(C(C(C=CC(C)=O)O)O)(O)=O,,,5,1,2,0,2
39359_0,,,,2,2,1,3
C(C(C)(C(C=CC(C)=O)O)O)(O)=O,,,5,1,1,0,1
39361_0,,,,2,2,1,3
C(C(C=C)(C(C=CC=O)(C)O)O)=O,,,5,1,1,0,1
39363_0,,,,2,2,1,3
C(C(C(C=CC=O)(C)O)O)(O)=O,,,5,1,2,0,2
39365_0,,,,2,2,1,3
C(C(C)(C(C=CC=O)(C)O)O)(O)=O,,,5,1,1,0,1
39367_0,,,,2,2,1,3
C(C(C=CCC(C=O)=O)(CO)O)=O,,,5,1,1,0,1
39369_0,,,,2,2,1,3
C(C(CO)(CC=CC(C=O)=O)O)=O,,,5,1,1,0,1
39371_0,,,,2,2,1,3
C(C)(C(C=CC(C=O)=O)(CO)O)=O,,,5,1,1,0,1
39373_0,,,,2,2,1,3
C(C(C(CC(C=O)=O)=C)(CO)O)=O,,,5,1,1,0,1
39375_0,,,,2,2,1,3
C(C(C(C)=CC(C=O)=O)(CO)O)=O,,,5,1,1,0,1
39377_0,,,,2,2,1,3
C(C(C=C)(C(C=O)(CC=C)O)O)=O,,,5,1,1,0,1
39379_0,,,,2,2,1,3
C(C(C(C=O)(CC=C)O)O)(O)=O,,,5,1,2,0,2
39381_0,,,,2,2,1,3
C(C(C)(C(C=O)(CC=C)O)O)(O)=O,,,5,1,1,0,1
39383_0,,,,2,2,1,3
C(C(C=C)(C(C(CC=C)=O)O)O)=O,,,5,1,1,0,1
39385_0,,,,2,2,1,3
C(C(C(C(CC=C)=O)O)O)(O)=O,,,5,1,2,0,2
39387_0,,,,2,2,1,3
C(C(C)(C(C(CC=C)=O)O)O)(O)=O,,,5,1,1,0,1
39389_0,,,,2,2,1,3
C(C(C=C)(C(C=O)(C=CC)O)O)=O,,,5,1,1,0,1
39391_0,,,,2,2,1,3
C(C(C=CC)(C(C(O)=O)O)O)=O,,,5,1,2,0,2
39393_0,,,,2,2,1,3
C(C(C)(C(C=O)(C=CC)O)O)(O)=O,,,5,1,1,0,1
39395_0,,,,2,2,1,3
C(C(C=C)(C(C(C=CC)=O)O)O)=O,,,5,1,1,0,1
39397_0,,,,2,2,1,3
C(C(C(C(C=CC)=O)O)O)(O)=O,,,5,1,2,0,2
39399_0,,,,2,2,1,3
C(C(C)(C(C(C=CC)=O)O)O)(O)=O,,,5,1,1,0,1
39401_0,,,,2,2,1,3
C(C(C=CCO)(C(C(O)=O)O)O)=O,,,5,1,1,0,1
39403_0,,,,2,2,1,3
C(C(C(C(C=CCO)=O)O)O)(O)=O,,,5,1,1,0,1
39405_0,,,,2,2,1,3
C(C(C(C=O)=CCC=O)(CO)O)=O,,,5,1,1,0,1
39406_0,,,,2,2,1,3
39408_0,,,,2,2,1,3
C(CC=O)(C(C=CC=O)(CO)O)=O,,,5,1,1,0,1
39410_0,,,,2,2,1,3
C(C(C=C)(C(C=CCC=O)O)O)=O,,,5,1,1,0,1
39412_0,,,,2,2,1,3
C(CC=CC(C(C(O)=O)O)O)=O,,,5,1,2,0,2
39414_0,,,,2,2,1,3
C(C(C)(C(C=CCC=O)O)O)(O)=O,,,5,1,1,0,1
39416_0,,,,2,2,1,3
C(C(C=C)(C(CC=CC=O)O)O)=O,,,5,1,1,0,1
39418_0,,,,2,2,1,3
C(C(C(CC=CC=O)O)O)(O)=O,,,5,1,2,0,2
39420_0,,,,2,2,1,3
C(C(C)(C(CC=CC=O)O)O)(O)=O,,,5,1,1,0,1
39422_0,,,,2,2,1,3
C(C(C=CC=O)(C(C(C=O)=C)O)O)=O,,,5,1,1,0,1
39424_0,,,,2,2,1,3
C(C(C=CC=O)(C(C=CC)O)O)=O,,,5,1,1,0,1
39426_0,,,,2,2,1,3
C(C(C=CC=O)(C(CC=C)O)O)=O,,,5,1,1,0,1
39428_0,,,,2,2,1,3
C(C(C=CC=O)(C(C=C)O)O)=O,,,5,1,1,0,1
39430_0,,,,2,2,1,3
C(C(C=CC=O)(C1(C=COC1)O)O)=O,,,5,1,1,0,1
39431_0,,,,2,2,1,3
39432_0,,,,2,2,1,3
39433_0,,,,2,2,1,3
39435_0,,,,2,2,1,3
C(C(C=CC=O)(C(CC=O)O)O)=O,,,5,1,1,0,1
39437_0,,,,2,2,1,3
C(C(C=CC=O)(C(C)O)O)=O,,,5,1,2,0,2
39439_0,,,,2,2,1,3
C(C(C=CC=O)(C(CCO)O)O)=O,,,5,1,1,0,1
39441_0,,,,2,2,1,3
C(C(C=CC=O)(C(CO)(C)O)O)=O,,,5,1,1,0,1
39442_0,,,,2,2,1,3
39443_0,,,,2,2,1,3
39444_0,,,,2,2,1,3
39446_0,,,,2,2,1,3
C(C(C=CC=O)(C(C=CC=O)O)O)=O,,,5,1,1,0,1
39447_0,,,,2,2,1,3
39448_0,,,,2,2,1,3
39449_0,,,,2,2,1,3
39451_0,,,,2,2,1,3
C(C(C=CC(C(C(O)=O)O)O)O)=O,,,5,1,1,0,1
39453_0,,,,2,2,1,3
C(C(C=O)C=CC(C=O)(CO)O)=O,,,5,1,1,0,1
39455_0,,,,2,2,1,3
C(C(CO)(CC=C(C=O)C=O)O)=O,,,5,1,1,0,1
39457_0,,,,2,2,1,3
C(C)(C(C=C(C=O)C=O)(CO)O)=O,,,5,1,1,0,1
39459_0,,,,2,2,1,3
C(C(C=O)C(C(C=O)(CO)O)=C)=O,,,5,1,1,0,1
39461_0,,,,2,2,1,3
C(C(C(C)=C(C=O)C=O)(CO)O)=O,,,5,1,1,0,1
39463_0,,,,2,2,1,3
C(C(C=C)C(C(C=O)(C=C)O)O)=O,,,5,1,1,0,1
39464_0,,,,2,2,1,3
39466_0,,,,2,2,1,3
C(C(C=C)C(C(C(O)=O)(C)O)O)=O,,,5,1,1,0,1
39468_0,,,,2,2,1,3
C(C(C=C)(C(C(C=O)=CC)O)O)=O,,,5,1,1,0,1
39470_0,,,,2,2,1,3
C(C(C(C(C=O)=CC)O)O)(O)=O,,,5,1,2,0,2
39472_0,,,,2,2,1,3
C(C(C)(C(C(C=O)=CC)O)O)(O)=O,,,5,1,1,0,1
39474_0,,,,2,2,1,3
C(C(C=C)(C(C(C=O)=C)O)O)=O,,,5,1,1,0,1
39476_0,,,,2,2,1,3
C(C(C(C(C=O)=C)O)O)(O)=O,,,5,1,2,0,2
39478_0,,,,2,2,1,3
C(CC(C=O)(C(C(C=O)=C)O)O)=O,,,5,1,1,0,1
39480_0,,,,2,2,1,3
C(C(C)(C(C(C=O)=C)O)O)(O)=O,,,5,1,2,0,2
39482_0,,,,2,2,1,3
C=C(C=O)C(C(C(C=O)=O)(C)O)O,,,5,1,1,0,1
39484_0,,,,2,2,1,3
C(C(CCO)(C(C(C=O)=C)O)O)=O,,,5,1,1,0,1
39486_0,,,,2,2,1,3
C1(C(C(C(C=O)=C)O)(O)OCC1)=O,,,5,1,1,0,1
39488_0,,,,2,2,1,3
C(C(C(C(C=O)=CCO)O)O)(O)=O,,,5,1,1,0,1
39490_0,,,,2,2,1,3
C(C(C(C=O)=CCO)(C(C)O)O)=O,,,5,1,1,0,1
39491_0,,,,2,2,1,3
39493_0,,,,2,2,1,3
C(C(C(CO)=C)(C(C(O)=O)O)O)=O,,,5,1,1,0,1
39495_0,,,,2,2,1,3
C(C(C(C(C(CO)=C)=O)O)O)(O)=O,,,5,1,1,0,1
39497_0,,,,2,2,1,3
C(C(CC=CC=O)(C(C=CC)O)O)=O,,,5,1,1,0,1
39499_0,,,,2,2,1,3
C(C(C(CC=C)O)(CC=CC=O)O)=O,,,5,1,1,0,1
39501_0,,,,2,2,1,3
C(C(CC=CC=O)(C(C=C)O)O)=O,,,5,1,1,0,1
39502_0,,,,2,2,1,3
39504_0,,,,2,2,1,3
C(C(C(C)O)(CC=CC=O)O)=O,,,5,1,2,0,2
39506_0,,,,2,2,1,3
C(C(CO)(CC=CC=O)O)=O,,,5,1,2,0,2
39508_0,,,,2,2,1,3
C(C(C(CO)O)(CC=CC=O)O)=O,,,5,1,1,0,1
39510_0,,,,2,2,1,3
C(C(C=CCC=O)(C(C=CC)O)O)=O,,,5,1,1,0,1
39512_0,,,,2,2,1,3
C(C(C=CCC=O)(C(CC=C)O)O)=O,,,5,1,1,0,1
39514_0,,,,2,2,1,3
C(C(C=CCC=O)(C(C=C)O)O)=O,,,5,1,1,0,1
39515_0,,,,2,2,1,3
39517_0,,,,2,2,1,3
C(C(C=CCC=O)(C(C)O)O)=O,,,5,1,2,0,2
39519_0,,,,2,2,1,3
C(C(C=CCC=O)(CO)O)=O,,,5,1,2,0,2
39521_0,,,,2,2,1,3
C(C(C=CCC=O)(C(CO)O)O)=O,,,5,1,1,0,1
39523_0,,,,2,2,1,3
C(C(C=CC(C=O)O)(C(C)O)O)=O,,,5,1,1,0,1
39524_0,,,,2,2,1,3
39526_0,,,,2,2,1,3
C(C(C=C)C(C=O)(C(C=CC)O)O)=O,,,5,1,1,0,1
39528_0,,,,2,2,1,3
C(C(C=C)C(C=O)(C(CC=C)O)O)=O,,,5,1,1,0,1
39530_0,,,,2,2,1,3
C(C(C=C)C(C=O)(C(C=C)O)O)=O,,,5,1,1,0,1
39531_0,,,,2,2,1,3
39532_0,,,,2,2,1,3
39533_0,,,,2,2,1,3
39534_0,,,,2,2,1,3
39536_0,,,,2,2,1,3
C(C(C(C=O)=CC)(C(C=CC)O)O)=O,,,5,1,1,0,1
39538_0,,,,2,2,1,3
C(C(C(C=O)=CC)(C(CC=C)O)O)=O,,,5,1,1,0,1
39540_0,,,,2,2,1,3
C(C(C(C=O)=CC)(C(C=C)O)O)=O,,,5,1,1,0,1
39542_0,,,,2,2,1,3
C(C(C(C=O)=CC)(C(C=O)O)O)=O,,,5,1,1,0,1
39544_0,,,,2,2,1,3
C(C(C(C=O)=CC)(C(C)O)O)=O,,,5,1,2,0,2
39546_0,,,,2,2,1,3
C(C(C(C=O)=CC)(CO)O)=O,,,5,1,2,0,2
39548_0,,,,2,2,1,3
C(C(C(C=O)=CC)(C(CO)O)O)=O,,,5,1,1,0,1
39550_0,,,,2,2,1,3
C(C(C(C=C(C=O)CO)O)O)(O)=O,,,5,1,1,0,1
39552_0,,,,2,2,1,3
C(C(C(C(CO)=CC=O)O)O)(O)=O,,,5,1,1,0,1
39554_0,,,,2,2,1,3
C(C(C=CC(CO)=O)(C(C)O)O)=O,,,5,1,1,0,1
39555_0,,,,2,2,1,3
39557_0,,,,2,2,1,3
C(C(C(CO)=CC=O)(C(C)O)O)=O,,,5,1,1,0,1
39558_0,,,,2,2,1,3
39560_0,,,,2,2,1,3
C(C(C(C(C(CO)=O)=C)O)O)(O)=O,,,5,1,1,0,1
39562_0,,,,2,2,1,3
C(C(C(C(C=O)=C)(CO)O)O)(O)=O,,,5,1,1,0,1
39564_0,,,,2,2,1,3
C(CC(C(C=C)(C(C=CC)O)O)=O)=O,,,5,1,1,0,1
39566_0,,,,2,2,1,3
C(CC(C(C=C)(C(CC=C)O)O)=O)=O,,,5,1,1,0,1
39568_0,,,,2,2,1,3
C(CC(C(C=C)(C(C=C)O)O)=O)=O,,,5,1,1,0,1
39570_0,,,,2,2,1,3
C(CC=O)(C(C=C)(C(C=O)O)O)=O,,,5,1,1,0,1
39572_0,,,,2,2,1,3
C(CC=O)(C(C=C)(C(C)O)O)=O,,,5,1,2,0,2
39574_0,,,,2,2,1,3
C(CC=O)(C(C=C)(CO)O)=O,,,5,1,2,0,2
39576_0,,,,2,2,1,3
C(CC=O)(C(C=C)(C(CO)O)O)=O,,,5,1,1,0,1
39578_0,,,,2,2,1,3
C(C)(C(C=CC=O)(C(C=CC)O)O)=O,,,5,1,1,0,1
39580_0,,,,2,2,1,3
C(C)(C(C=CC=O)(C(CC=C)O)O)=O,,,5,1,1,0,1
39582_0,,,,2,2,1,3
C(C)(C(C=CC=O)(C(C=C)O)O)=O,,,5,1,1,0,1
39584_0,,,,2,2,1,3
C(C(C(C(C)=O)(C=CC=O)O)O)=O,,,5,1,1,0,1
39586_0,,,,2,2,1,3
C(C)(C(C=CC=O)(C(C)O)O)=O,,,5,1,2,0,2
39587_0,,,,2,2,1,3
39589_0,,,,2,2,1,3
C(C)(C(C=CC=O)(C(CO)O)O)=O,,,5,1,1,0,1
39591_0,,,,2,2,1,3
C(C(C(C)=CC=O)(C(C=CC)O)O)=O,,,5,1,1,0,1
39593_0,,,,2,2,1,3
C(C(C(C)=CC=O)(C(CC=C)O)O)=O,,,5,1,1,0,1
39595_0,,,,2,2,1,3
C(C(C(C)=CC=O)(C(C=C)O)O)=O,,,5,1,1,0,1
39597_0,,,,2,2,1,3
C(C(C(C)=CC=O)(C(C=O)O)O)=O,,,5,1,1,0,1
39599_0,,,,2,2,1,3
C(C(C(C)=CC=O)(C(C)O)O)=O,,,5,1,2,0,2
39601_0,,,,2,2,1,3
C(C(C(C)=CC=O)(CO)O)=O,,,5,1,2,0,2
39603_0,,,,2,2,1,3
C(C(C(C)=CC=O)(C(CO)O)O)=O,,,5,1,1,0,1
39605_0,,,,2,2,1,3
C(C(C(CC=O)=C)(C(C=CC)O)O)=O,,,5,1,1,0,1
39607_0,,,,2,2,1,3
C(C(C(CC=O)=C)(C(CC=C)O)O)=O,,,5,1,1,0,1
39609_0,,,,2,2,1,3
C(C(C(CC=O)=C)(C(C=C)O)O)=O,,,5,1,1,0,1
39611_0,,,,2,2,1,3
C(C(C(CC=O)=C)(C(C=O)O)O)=O,,,5,1,1,0,1
39613_0,,,,2,2,1,3
C(C(C(CC=O)=C)(C(C)O)O)=O,,,5,1,2,0,2
39615_0,,,,2,2,1,3
C(C(C(CC=O)=C)(CO)O)=O,,,5,1,2,0,2
39617_0,,,,2,2,1,3
C(C(C(CC=O)=C)(C(CO)O)O)=O,,,5,1,1,0,1
39619_0,,,,2,2,1,3
C(C(C(C(C=O)O)=C)(C(C)O)O)=O,,,5,1,1,0,1
39620_0,,,,2,2,1,3
39621_0,,,,2,2,1,3
39622_0,,,,2,2,1,3
39624_0,,,,2,2,1,3
C(C(C=C)(C(C=CC)O)O)=O,,,5,1,1,0,1
39626_0,,,,2,2,1,3
C1(C(C(C=CC)O)(O)OC(C)C1)=O,,,5,1,1,0,1
39628_0,,,,2,2,1,3
C1(C(C(C=CC)O)(O)OCC1O)=O,,,5,1,1,0,1
39630_0,,,,2,2,1,3
C1(C(CC(O)O1)(C(C=CC)O)O)=O,,,5,1,1,0,1
39632_0,,,,2,2,1,3
C(C(C(C=CC)O)O)(O)=O,,,5,1,2,0,2
39634_0,,,,2,2,1,3
C(CC(C=O)(C(C=CC)O)O)=O,,,5,1,2,0,2
39636_0,,,,2,2,1,3
C(CC(C(C)=O)(C(C=CC)O)O)=O,,,5,1,1,0,1
39638_0,,,,2,2,1,3
C(C(C)(C(C=CC)O)O)(O)=O,,,5,1,2,0,2
39640_0,,,,2,2,1,3
C(C(CCO)(C(C=CC)O)O)(O)=O,,,5,1,1,0,1
39642_0,,,,2,2,1,3
C(C)=CC(C(C(C=O)=O)(C)O)O,,,5,1,2,0,2
39644_0,,,,2,2,1,3
C(C(CCO)(C(C=CC)O)O)=O,,,5,1,2,0,2
39646_0,,,,2,2,1,3
C(C(CC=O)(C(C=CC)O)O)(O)=O,,,5,1,1,0,1
39648_0,,,,2,2,1,3
C(CC(C=O)(C(C=CC)O)O)(O)=O,,,5,1,1,0,1
39650_0,,,,2,2,1,3
C1(C(C(C=CC)O)(O)OCC1)=O,,,5,1,2,0,2
39652_0,,,,2,2,1,3
C(C(C=C)(C(CC=C)O)O)=O,,,5,1,1,0,1
39654_0,,,,2,2,1,3
C1(C(C(CC=C)O)(O)OC(C)C1)=O,,,5,1,1,0,1
39656_0,,,,2,2,1,3
C1(C(C(CC=C)O)(O)OCC1O)=O,,,5,1,1,0,1
39658_0,,,,2,2,1,3
C1(C(C(CC=C)O)(CC(O)O1)O)=O,,,5,1,1,0,1
39660_0,,,,2,2,1,3
C(C(C(CC=C)O)O)(O)=O,,,5,1,2,0,2
39662_0,,,,2,2,1,3
C(C(C(CC=C)O)(CC=O)O)=O,,,5,1,2,0,2
39664_0,,,,2,2,1,3
C(C)(C(C(CC=C)O)(CC=O)O)=O,,,5,1,1,0,1
39666_0,,,,2,2,1,3
C(C(C)(C(CC=C)O)O)(O)=O,,,5,1,2,0,2
39668_0,,,,2,2,1,3
C(C(C(CC=C)O)(CCO)O)(O)=O,,,5,1,1,0,1
39670_0,,,,2,2,1,3
C=CCC(C(C(C=O)=O)(C)O)O,,,5,1,2,0,2
39672_0,,,,2,2,1,3
C(C(C(CC=C)O)(CCO)O)=O,,,5,1,2,0,2
39674_0,,,,2,2,1,3
C(C(C(CC=C)O)(CC=O)O)(O)=O,,,5,1,1,0,1
39676_0,,,,2,2,1,3
C(C(C(CC=C)O)(CC(O)=O)O)=O,,,5,1,1,0,1
39678_0,,,,2,2,1,3
C1(C(C(CC=C)O)(O)OCC1)=O,,,5,1,2,0,2
39680_0,,,,2,2,1,3
C(C(C=C)(C(C(C=C)O)O)O)=O,,,5,1,1,0,1
39682_0,,,,2,2,1,3
C(C(C=C)(C(C=C)O)O)=O,,,5,1,1,0,1
39684_0,,,,2,2,1,3
C(C(C=C)(C1(C=COC1)O)O)=O,,,5,1,1,0,1
39685_0,,,,2,2,1,3
39686_0,,,,2,2,1,3
39687_0,,,,2,2,1,3
39688_0,,,,2,2,1,3
39689_0,,,,2,2,1,3
39691_0,,,,2,2,1,3
C(C(C=C)(C(CC=O)O)O)=O,,,5,1,4,0,4
39692_0,,,,2,2,1,3
39693_0,,,,2,2,1,3
39694_0,,,,2,2,1,3
39696_0,,,,2,2,1,3
C(C(C=C)(C(CC(C=O)O)O)O)=O,,,5,1,1,0,1
39698_0,,,,2,2,1,3
C(C(C=C)(C(CC(CO)=O)O)O)=O,,,5,1,1,0,1
39699_0,,,,2,2,1,3
39701_0,,,,2,2,1,3
C(C(C=C)(C(C(C(C)=O)O)O)O)=O,,,5,1,1,0,1
39702_0,,,,2,2,1,3
39704_0,,,,2,2,1,3
C(C(C=C)(C(C)O)O)=O,,,5,1,3,0,3
39706_0,,,,2,2,1,3
C(C(C=C)(C(C(C=O)CO)O)O)=O,,,5,1,1,0,1
39708_0,,,,2,2,1,3
C(C(C=C)(C(CC(C)O)O)O)=O,,,5,1,3,0,3
39710_0,,,,2,2,1,3
C(C(C=C)(C(C(C(C)O)O)O)O)=O,,,5,1,1,0,1
39712_0,,,,2,2,1,3
C(C(C=C)(C(CCO)O)O)=O,,,5,1,3,0,3
39714_0,,,,2,2,1,3
C(C(C=C)(C(CC(CO)O)O)O)=O,,,5,1,1,0,1
39715_0,,,,2,2,1,3
39716_0,,,,2,2,1,3
39717_0,,,,2,2,1,3
39718_0,,,,2,2,1,3
39719_0,,,,2,2,1,3
39720_0,,,,2,2,1,3
39722_0,,,,2,2,1,3
C(C(C=C)(C(CO)(C)O)O)=O,,,5,1,3,0,3
39723_0,,,,2,2,1,3
39725_0,,,,2,2,1,3
C(C(C=C)(C(C(CCO)O)O)O)=O,,,5,1,1,0,1
39727_0,,,,2,2,1,3
C(C(C=C)(C(C)(C(CO)O)O)O)=O,,,5,1,1,0,1
39728_0,,,,2,2,1,3
39729_0,,,,2,2,1,3
39731_0,,,,2,2,1,3
C(C(C=C)(C(CC(O)=O)O)O)=O,,,5,1,3,0,3
39733_0,,,,2,2,1,3
C(C(C=C)(C1(COCC1O)O)O)=O,,,5,1,1,0,1
39735_0,,,,2,2,1,3
C(C(C=C)(C1(C(O)OCC1)O)O)=O,,,5,1,2,0,2
39737_0,,,,2,2,1,3
C(C(C=C)(C1(COC(C1)O)O)O)=O,,,5,1,1,0,1
39739_0,,,,2,2,1,3
C(C(C=C)(C(C=O)(C=C)O)O)=O,,,5,1,3,0,3
39740_0,,,,2,2,1,3
39742_0,,,,2,2,1,3
C(C(C=C)(C(C=CC=O)O)O)=O,,,5,1,3,0,3
39743_0,,,,2,2,1,3
39744_0,,,,2,2,1,3
39746_0,,,,2,2,1,3
C(C(C(C(C=C)O)O)O)(O)=O,,,5,1,3,0,3
39748_0,,,,2,2,1,3
C(C(C(C(C=C)O)O)(CC=O)O)=O,,,5,1,1,0,1
39750_0,,,,2,2,1,3
C(C(C)(C(C(C=C)O)O)O)(O)=O,,,5,1,3,0,3
39752_0,,,,2,2,1,3
C=CC(C(C(C(C=O)=O)(C)O)O)O,,,5,1,1,0,1
39754_0,,,,2,2,1,3
C(C(C(C(C=C)O)O)(CCO)O)=O,,,5,1,1,0,1
39756_0,,,,2,2,1,3
C1(C(C(C(C=C)O)O)(O)OCC1)=O,,,5,1,1,0,1
39758_0,,,,2,2,1,3
C(C(C(C=CC(CO)O)O)O)(O)=O,,,5,1,1,0,1
39760_0,,,,2,2,1,3
C(C(C(C=O)=C)(C(C=C)O)O)(O)=O,,,5,1,1,0,1
39762_0,,,,2,2,1,3
C(C(C=CC=O)(C(C=C)O)O)(O)=O,,,5,1,1,0,1
39764_0,,,,2,2,1,3
C(C1CC(C(C(C=C)O)(O)O1)=O)=O,,,5,1,1,0,1
39766_0,,,,2,2,1,3
C(C1(CC(C(O)O1)=O)C(C=C)O)=O,,,5,1,1,0,1
39768_0,,,,2,2,1,3
C1(C(C(C=C)O)(O)OC(C)C1)=O,,,5,1,1,0,1
39770_0,,,,2,2,1,3
C1(C(C(C=C)O)(O)OCC1O)=O,,,5,1,1,0,1
39772_0,,,,2,2,1,3
C1(C(CC(O)O1)(C(C=C)O)O)=O,,,5,1,1,0,1
39774_0,,,,2,2,1,3
C(C(C(C=C)O)O)(O)=O,,,5,1,2,0,2
39776_0,,,,2,2,1,3
C(CC(C=O)(C(C=C)O)O)=O,,,5,1,2,0,2
39778_0,,,,2,2,1,3
C(C(CC(C=O)=O)(C(C=C)O)O)=O,,,5,1,1,0,1
39780_0,,,,2,2,1,3
C(C(C=O)C(C=O)(C(C=C)O)O)=O,,,5,1,1,0,1
39782_0,,,,2,2,1,3
C(CC(C(C)=O)(C(C=C)O)O)=O,,,5,1,2,0,2
39784_0,,,,2,2,1,3
C(C(CO)C(C=O)(C(C=C)O)O)=O,,,5,1,1,0,1
39786_0,,,,2,2,1,3
C(C(C)(C(C=C)O)O)(O)=O,,,5,1,2,0,2
39788_0,,,,2,2,1,3
C(C(CCO)(C(C=C)O)O)(O)=O,,,5,1,2,0,2
39790_0,,,,2,2,1,3
C=CC(C(C(C=O)=O)(C)O)O,,,5,1,2,0,2
39792_0,,,,2,2,1,3
C(C(CCO)(C(C=C)O)O)=O,,,5,1,2,0,2
39794_0,,,,2,2,1,3
C(C(CC=O)(C(C=C)O)O)(O)=O,,,5,1,2,0,2
39796_0,,,,2,2,1,3
C(CC(C=O)(C(C=C)O)O)(O)=O,,,5,1,2,0,2
39798_0,,,,2,2,1,3
C(C(CC(CO)=O)(C(C=C)O)O)=O,,,5,1,1,0,1
39800_0,,,,2,2,1,3
C1(C(C(C=C)O)(O)OCC1)=O,,,5,1,2,0,2
39802_0,,,,2,2,1,3
C(C(C(C(C=C)(CO)O)O)O)(O)=O,,,5,1,1,0,1
39804_0,,,,2,2,1,3
C(C(C(C=O)=C)(C(C=O)O)O)(O)=O,,,5,1,1,0,1
39806_0,,,,2,2,1,3
C(C(C(C=O)=C)(C(C)O)O)(O)=O,,,5,1,2,0,2
39807_0,,,,2,2,1,3
39808_0,,,,2,2,1,3
39810_0,,,,2,2,1,3
C(C(C=CC=O)(C(C=O)O)O)(O)=O,,,5,1,1,0,1
39812_0,,,,2,2,1,3
C(C(C=CC=O)(C(C)O)O)(O)=O,,,5,1,2,0,2
39813_0,,,,2,2,1,3
39814_0,,,,2,2,1,3
39815_0,,,,2,2,1,3
39816_0,,,,2,2,1,3
39817_0,,,,2,2,1,3
39818_0,,,,2,2,1,3
39819_0,,,,2,2,1,3
39820_0,,,,2,2,1,3
39821_0,,,,2,2,1,3
39823_0,,,,2,2,1,3
C(C(C(C=CC(CO)=O)O)O)(O)=O,,,5,1,1,0,1
39825_0,,,,2,2,1,3
C(C(C(C=CC=O)(CO)O)O)(O)=O,,,5,1,1,0,1
39827_0,,,,2,2,1,3
C(C(C1(C=COC1)O)O)(O)=O,,,5,1,2,0,2
39829_0,,,,2,2,1,3
C(CC(C=O)(C1(C=COC1)O)O)=O,,,5,1,1,0,1
39831_0,,,,2,2,1,3
C(C(C)(C1(C=COC1)O)O)(O)=O,,,5,1,2,0,2
39833_0,,,,2,2,1,3
C1OCC(C=1)(C(C(C=O)=O)(C)O)O,,,5,1,1,0,1
39835_0,,,,2,2,1,3
C(C(CCO)(C1(C=COC1)O)O)=O,,,5,1,1,0,1
39837_0,,,,2,2,1,3
C1(C(C2(C=COC2)O)(O)OCC1)=O,,,5,1,1,0,1
39839_0,,,,2,2,1,3
C(C1CC(C(C(C=O)O)(O)O1)=O)=O,,,5,1,1,0,1
39841_0,,,,2,2,1,3
C1(CC(C=O)OC1(C(C)O)O)=O,,,5,1,1,0,1
39843_0,,,,2,2,1,3
C1(CC(C=O)OC1(CO)O)=O,,,5,1,2,0,2
39845_0,,,,2,2,1,3
C1(CC(C=O)OC1(C(CO)O)O)=O,,,5,1,1,0,1
39847_0,,,,2,2,1,3
C(C(C1(C=O)CC(C(O)O1)=O)O)=O,,,5,1,2,0,2
39849_0,,,,2,2,1,3
C(C1(C(C)O)CC(C(O1)O)=O)=O,,,5,1,2,0,2
39851_0,,,,2,2,1,3
C(C1(CO)CC(C(O1)O)=O)=O,,,5,1,2,0,2
39853_0,,,,2,2,1,3
C(C1(C(CO)O)CC(C(O1)O)=O)=O,,,5,1,2,0,2
39855_0,,,,2,2,1,3
C1(C(CO)(OC(C=O)C1CO)O)=O,,,5,1,1,0,1
39857_0,,,,2,2,1,3
C(C1(CO)C(C(C(O1)O)=O)CO)=O,,,5,1,2,0,2
39859_0,,,,2,2,1,3
C(C1C(C(OC1(C=O)CO)O)O)=O,,,5,1,2,0,2
39861_0,,,,2,2,1,3
C1(C(CO)(O)OC(CO)(CO)C1)=O,,,5,1,2,0,2
39863_0,,,,2,2,1,3
C(C1(C)CC(C(C(C)O)(O1)O)=O)=O,,,5,1,1,0,1
39865_0,,,,2,2,1,3
C(C1(C)CC(C(CO)(O1)O)=O)=O,,,5,1,2,0,2
39867_0,,,,2,2,1,3
C1(CC(C(C)=O)OC1(C(C)O)O)=O,,,5,1,1,0,1
39869_0,,,,2,2,1,3
C1(CC(C(C)=O)OC1(CO)O)=O,,,5,1,3,0,3
39871_0,,,,2,2,1,3
C(C)(C1(C(C)O)CC(C(O1)O)=O)=O,,,5,1,2,0,2
39873_0,,,,2,2,1,3
C(C)(C1(CO)CC(C(O1)O)=O)=O,,,5,1,3,0,3
39875_0,,,,2,2,1,3
C(CC1CC(C(C(C)O)(O)O1)=O)=O,,,5,1,1,0,1
39877_0,,,,2,2,1,3
C(CC1CC(C(CO)(O)O1)=O)=O,,,5,1,3,0,3
39879_0,,,,2,2,1,3
C(C(C1(C(CC(C)O1)=O)O)O)=O,,,5,1,1,0,1
39881_0,,,,2,2,1,3
C(C(C)(C1(C(CC(C)O1)=O)O)O)=O,,,5,1,1,0,1
39883_0,,,,2,2,1,3
C(C(C1(C(CC(C)O1)=O)O)O)(C)=O,,,5,1,1,0,1
39885_0,,,,2,2,1,3
C(CC(C1(C(CC(C)O1)=O)O)O)=O,,,5,1,1,0,1
39887_0,,,,2,2,1,3
C1(C(C(C)O)(O)OC(C)C1)=O,,,5,1,1,0,1
39889_0,,,,2,2,1,3
C1(C(C(CCO)O)(O)OC(C)C1)=O,,,5,1,1,0,1
39891_0,,,,2,2,1,3
C1(C(C(CO)(C)O)(O)OC(C)C1)=O,,,5,1,1,0,1
39893_0,,,,2,2,1,3
C(C(C1(C(CC(C)O1)=O)O)O)(O)=O,,,5,1,1,0,1
39895_0,,,,2,2,1,3
C1(C(CO)(O)OC(C)C1)=O,,,5,1,2,0,2
39897_0,,,,2,2,1,3
C1(C(C(CO)O)(O)OC(C)C1)=O,,,5,1,1,0,1
39899_0,,,,2,2,1,3
C(C(C1(C(O)OC(C)C1)O)O)(O)=O,,,5,1,2,0,2
39901_0,,,,2,2,1,3
C1(C(C(C)O)(O)OC(C)C1CO)=O,,,5,1,1,0,1
39903_0,,,,2,2,1,3
C1(C(CO)(O)OC(C)C1CO)=O,,,5,1,1,0,1
39905_0,,,,2,2,1,3
C1(C(CO)(O)OC(CO)C1CO)=O,,,5,1,1,0,1
39907_0,,,,2,2,1,3
C(C(CO)(C1C(O)OCC1O)O)=O,,,5,1,2,0,2
39909_0,,,,2,2,1,3
C(C(C1(C(C(CO1)O)=O)O)O)=O,,,5,1,2,0,2
39911_0,,,,2,2,1,3
C(C(C)(C1(C(C(CO1)O)=O)O)O)=O,,,5,1,1,0,1
39913_0,,,,2,2,1,3
C(C(C1(C(C(CO1)O)=O)O)O)(C)=O,,,5,1,1,0,1
39915_0,,,,2,2,1,3
C(CC(C1(C(C(CO1)O)=O)O)O)=O,,,5,1,1,0,1
39917_0,,,,2,2,1,3
C1(C(C(C)O)(O)OCC1O)=O,,,5,1,2,0,2
39919_0,,,,2,2,1,3
C1(C(C(CCO)O)(O)OCC1O)=O,,,5,1,1,0,1
39921_0,,,,2,2,1,3
C1(C(C(CO)(C)O)(O)OCC1O)=O,,,5,1,1,0,1
39923_0,,,,2,2,1,3
C(C(C1(C(C(CO1)O)=O)O)O)(O)=O,,,5,1,1,0,1
39925_0,,,,2,2,1,3
C1(C(CO)(O)OCC1O)=O,,,5,1,2,0,2
39927_0,,,,2,2,1,3
C1(C(C(CO)O)(O)OCC1O)=O,,,5,1,2,0,2
39928_0,,,,2,2,1,3
39930_0,,,,2,2,1,3
C1(C(C(C)O)(O)OC(CO)C1O)=O,,,5,1,1,0,1
39932_0,,,,2,2,1,3
C1(C(CO)(O)OC(CO)C1O)=O,,,5,1,2,0,2
39934_0,,,,2,2,1,3
C1(C(CC(O)O1)(C(C=O)O)O)=O,,,5,1,2,0,2
39936_0,,,,2,2,1,3
C1(C(CC(O)O1)(C(C=O)(C)O)O)=O,,,5,1,2,0,2
39938_0,,,,2,2,1,3
C1(C(CC(O)O1)(C(C(C)=O)O)O)=O,,,5,1,2,0,2
39940_0,,,,2,2,1,3
C1(C(C(CC=O)O)(CC(O)O1)O)=O,,,5,1,2,0,2
39942_0,,,,2,2,1,3
C1(C(C(C)O)(CC(O)O1)O)=O,,,5,1,2,0,2
39944_0,,,,2,2,1,3
C1(C(CC(O)O1)(C(CCO)O)O)=O,,,5,1,2,0,2
39946_0,,,,2,2,1,3
C1(C(CC(O)O1)(C(CO)(C)O)O)=O,,,5,1,2,0,2
39948_0,,,,2,2,1,3
C1(C(CC(O)O1)(C(C(O)=O)O)O)=O,,,5,1,2,0,2
39950_0,,,,2,2,1,3
C1(C(CO)(CC(O)O1)O)=O,,,5,1,2,0,2
39952_0,,,,2,2,1,3
C1(C(C(CO)O)(CC(O)O1)O)=O,,,5,1,2,0,2
39954_0,,,,2,2,1,3
C1(C(C(C)O)(CC(CO)(O)O1)O)=O,,,5,1,2,0,2
39956_0,,,,2,2,1,3
C1(C(CO)(CC(CO)(O)O1)O)=O,,,5,1,2,0,2
39958_0,,,,2,2,1,3
C(C1(CO)CC(C(C(O1)O)O)=O)=O,,,5,1,2,0,2
39960_0,,,,2,2,1,3
C1(C(CO)(O)OCC(CO)(C1)O)=O,,,5,1,2,0,2
39962_0,,,,2,2,1,3
C1(C(CO)(O)OCC(C1CO)O)=O,,,5,1,1,0,1
39964_0,,,,2,2,1,3
C(C1(C(C)O)CC(CC(O1)O)O)=O,,,5,1,2,0,2
39966_0,,,,2,2,1,3
C(C1(CO)CC(CC(O1)O)O)=O,,,5,1,2,0,2
39968_0,,,,2,2,1,3
C(C1(CO)CC(C(C(O1)O)O)O)=O,,,5,1,2,0,2
39970_0,,,,2,2,1,3
C1(C(C(C)O)(O)OCC(C1O)O)=O,,,5,1,1,0,1
39972_0,,,,2,2,1,3
C1(C(CO)(O)OCC(C1O)O)=O,,,5,1,2,0,2
39974_0,,,,2,2,1,3
C1(CCOC(CC1(C(C)O)O)O)=O,,,5,1,2,0,2
39976_0,,,,2,2,1,3
C1(CCOC(CC1(CO)O)O)=O,,,5,1,2,0,2
39978_0,,,,2,2,1,3
C(C1(CO)CC(C(C(O1)=O)O)O)=O,,,5,1,1,0,1
39979_0,,,,2,2,1,3
39980_0,,,,2,2,1,3
39982_0,,,,2,2,1,3
C(C(CCCO)(C(C(O)=O)O)O)=O,,,5,1,1,0,1
39984_0,,,,2,2,1,3
C(C(C(C(O)=O)O)O)(CCCO)=O,,,5,1,2,0,2
39985_0,,,,2,2,1,3
39986_0,,,,2,1,2,3
39986_1,,,,2,1,2,3
39987_0,,,,2,1,2,3
39987_1,,,,2,1,2,3
39988_0,,,,2,1,2,3
39988_1,,,,2,1,2,3
39989_0,,,,2,1,2,3
39989_1,,,,2,1,2,3
39990_0,,,,2,1,2,3
39991_0,,,,2,1,2,3
39992_0,,,,2,1,2,3
39993_0,,,,2,1,2,3
39994_0,,,,2,1,2,3
39995_0,,,,2,1,2,3
39996_0,,,,2,1,2,3
39997_0,,,,2,1,2,3
39998_0,,,,2,1,2,3
39999_0,,,,2,1,2,3
40000_0,,,,2,1,2,3
40001_0,,,,2,1,2,3
40002_0,,,,2,1,2,3
40003_0,,,,2,1,2,3
40003_1,,,,2,1,2,3
40004_0,,,,2,1,2,3
40004_1,,,,2,1,2,3
40005_0,,,,2,1,2,3
40005_1,,,,2,1,2,3
40006_0,,,,2,1,2,3
40006_1,,,,2,1,2,3
40007_0,,,,2,1,2,3
40007_1,,,,2,1,2,3
40008_0,,,,2,1,2,3
40008_1,,,,2,1,2,3
40009_0,,,,2,1,1,2
40009_1,,,,2,1,1,2
40010_0,,,,2,1,1,2
40010_1,,,,2,1,1,2
40012_0,,,,2,1,1,2
C(CC(CC(C)O)O)(OCC=O)=O,,,5,1,1,0,1
40013_0,,,,2,1,2,3
40014_0,,,,2,1,2,3
40014_1,,,,2,1,2,3
40015_0,,,,2,1,2,3
40015_1,,,,2,1,2,3
40016_0,,,,2,1,2,3
40017_0,,,,2,1,2,3
40018_0,,,,2,1,2,3
40018_1,,,,2,1,2,3
40019_0,,,,2,1,2,3
40019_1,,,,2,1,2,3
40021_0,,,,2,1,1,2
C(CC(CCO)O)(OCC=O)=O,,,5,1,1,0,1
40022_0,,,,2,1,2,3
40023_0,,,,2,1,1,2
40023_1,,,,2,1,1,2
40024_0,,,,2,1,2,3
40024_1,,,,2,1,2,3
40026_0,,,,2,1,1,2
C(C(CO)(CC(OCC=O)=O)O)=O,,,5,1,1,0,1
40027_0,,,,2,1,2,3
40028_0,,,,2,1,2,3
40028_1,,,,2,1,2,3
40029_0,,,,2,1,2,3
40029_1,,,,2,1,2,3
40031_0,,,,2,1,1,2
C(CC(C(CO)=O)O)(OCC=O)=O,,,5,1,1,0,1
40032_0,,,,2,1,2,3
40033_0,,,,2,1,2,3
40033_1,,,,2,1,2,3
40034_0,,,,2,1,2,3
40034_1,,,,2,1,2,3
40035_0,,,,2,1,2,3
40036_0,,,,2,1,2,3
40037_0,,,,2,1,2,3
40037_1,,,,2,1,2,3
40038_0,,,,2,1,2,3
40038_1,,,,2,1,2,3
40040_0,,,,2,1,1,2
C(CC(C)(CO)O)(OCC=O)=O,,,5,1,1,0,1
40041_0,,,,2,1,2,3
40042_0,,,,2,1,1,2
40042_1,,,,2,1,1,2
40043_0,,,,2,1,2,3
40043_1,,,,2,1,2,3
40044_0,,,,2,1,2,3
40045_0,,,,2,1,2,3
40046_0,,,,2,1,2,3
40046_1,,,,2,1,2,3
40047_0,,,,2,1,2,3
40047_1,,,,2,1,2,3
40049_0,,,,2,1,1,2
C(CC(C(O)=O)O)(OCC=O)=O,,,5,1,1,0,1
40050_0,,,,2,1,2,3
40051_0,,,,2,1,1,2
40051_1,,,,2,1,1,2
40052_0,,,,2,1,2,3
40052_1,,,,2,1,2,3
40054_0,,,,2,1,1,2
C(C(C)(CC(OCC=O)=O)O)(O)=O,,,5,1,1,0,1
40055_0,,,,2,1,2,3
40057_0,,,,2,1,1,2
C(CC(CC(OCC=O)=O)O)(O)=O,,,5,1,1,0,1
40058_0,,,,2,1,2,3
40059_0,,,,2,1,2,3
40059_1,,,,2,1,2,3
40060_0,,,,2,1,2,3
40060_1,,,,2,1,2,3
40061_0,,,,2,1,2,3
40061_1,,,,2,1,2,3
40062_0,,,,2,1,2,3
40062_1,,,,2,1,2,3
40063_0,,,,2,1,2,3
40063_1,,,,2,1,2,3
40064_0,,,,2,1,2,3
40064_1,,,,2,1,2,3
40065_0,,,,2,1,2,3
40065_1,,,,2,1,2,3
40066_0,,,,2,1,2,3
40066_1,,,,2,1,2,3
40067_0,,,,2,1,2,3
40067_1,,,,2,1,2,3
40068_0,,,,2,1,2,3
40068_1,,,,2,1,2,3
40069_0,,,,2,1,2,3
40071_0,,,,2,1,1,2
C(C(C=C)(CC(OCC=O)=O)O)=O,,,5,1,1,0,1
40072_0,,,,2,1,2,3
40074_0,,,,2,1,1,2
C(CC(C(C=C)=O)O)(OCC=O)=O,,,5,1,1,0,1
40075_0,,,,2,1,2,3
40077_0,,,,2,1,1,2
C(CC(C=CC=O)O)(OCC=O)=O,,,5,1,1,0,1
40078_0,,,,2,1,2,3
40080_0,,,,2,1,1,2
C(CC(C(CO)O)O)(OCC=O)=O,,,5,1,1,0,1
40081_0,,,,2,1,2,3
40083_0,,,,2,1,1,2
C(CC(C=O)O)(OCC=O)=O,,,5,1,1,0,1
40084_0,,,,2,1,2,3
40086_0,,,,2,1,1,2
C(CC(CO)(CO)O)(OCC=O)=O,,,5,1,1,0,1
40087_0,,,,2,1,2,3
40089_0,,,,2,1,1,2
C(C(C)(CC(OCC=O)=O)O)=O,,,5,1,1,0,1
40090_0,,,,2,1,2,3
40092_0,,,,2,1,1,2
C(CC(C(C)=O)O)(OCC=O)=O,,,5,1,1,0,1
40093_0,,,,2,1,2,3
40095_0,,,,2,1,1,2
C(CC(CC=O)O)(OCC=O)=O,,,5,1,1,0,1
40096_0,,,,2,1,2,3
40098_0,,,,2,1,1,2
C(CC(C)O)(OCC=O)=O,,,5,1,1,0,1
40099_0,,,,2,1,2,3
40101_0,,,,2,1,1,2
C(CCO)(OCC=O)=O,,,5,1,1,0,1
40102_0,,,,2,1,2,3
40104_0,,,,2,1,1,2
C(CC(CO)O)(OCC=O)=O,,,5,1,1,0,1
40105_0,,,,2,1,2,3
40105_1,,,,2,1,2,3
40106_0,,,,2,1,2,3
40106_1,,,,2,1,2,3
40107_0,,,,2,1,2,3
40107_1,,,,2,1,2,3
40108_0,,,,2,1,2,3
40108_1,,,,2,1,2,3
40109_0,,,,2,1,2,3
40109_1,,,,2,1,2,3
40110_0,,,,2,1,2,3
40110_1,,,,2,1,2,3
40111_0,,,,2,1,2,3
40111_1,,,,2,1,2,3
40112_0,,,,2,1,1,2
40112_1,,,,2,1,1,2
40113_0,,,,2,1,2,3
40113_1,,,,2,1,2,3
40114_0,,,,2,1,1,2
40114_1,,,,2,1,1,2
40115_0,,,,2,1,2,3
40115_1,,,,2,1,2,3
40116_0,,,,2,1,1,2
40116_1,,,,2,1,1,2
40117_0,,,,2,1,2,3
40117_1,,,,2,1,2,3
40118_0,,,,2,1,1,2
40118_1,,,,2,1,1,2
40119_0,,,,2,1,2,3
40119_1,,,,2,1,2,3
40120_0,,,,2,1,1,2
40120_1,,,,2,1,1,2
40121_0,,,,2,1,2,3
40121_1,,,,2,1,2,3
40122_0,,,,2,1,1,2
40122_1,,,,2,1,1,2
40123_0,,,,2,1,2,3
40123_1,,,,2,1,2,3
40124_0,,,,2,1,1,2
40124_1,,,,2,1,1,2
40125_0,,,,2,1,2,3
40125_1,,,,2,1,2,3
40126_0,,,,2,1,1,2
40126_1,,,,2,1,1,2
40127_0,,,,2,1,2,3
40127_1,,,,2,1,2,3
40128_0,,,,2,1,1,2
40128_1,,,,2,1,1,2
40129_0,,,,2,1,2,3
40129_1,,,,2,1,2,3
40130_0,,,,2,1,1,2
40130_1,,,,2,1,1,2
40131_0,,,,2,1,2,3
40131_1,,,,2,1,2,3
40132_0,,,,2,1,1,2
40132_1,,,,2,1,1,2
40134_0,,,,2,1,1,2
C(CCO)(OC(C=O)CO)=O,,,5,1,1,0,1
40135_0,,,,2,1,2,3
40137_0,,,,2,1,1,2
C(CCO)(OCC(C=O)O)=O,,,5,1,1,0,1
40138_0,,,,2,1,2,3
40139_0,,,,2,1,2,3
40139_1,,,,2,1,2,3
40141_0,,,,2,1,1,2
C(C(CO)O)(OC(C=O)O)=O,,,5,1,2,0,2
40141_1,,,,2,1,1,2
40143_0,,,,2,1,1,2
C(C(COC(C=O)O)O)(O)=O,,,5,1,2,0,2
40143_1,,,,2,1,1,2
40144_0,,,,2,1,2,3
40144_1,,,,2,1,2,3
40146_0,,,,2,1,1,2
C(C(C(CO)O)O)(OC(C=O)O)=O,,,5,1,2,0,2
40146_1,,,,2,1,1,2
40148_0,,,,2,1,1,2
C(C(C(CO)OC(C=O)O)O)(O)=O,,,5,1,2,0,2
40148_1,,,,2,1,1,2
40150_0,,,,2,1,1,2
C(C(CO)O)(OC(C(C)=O)O)=O,,,5,1,2,0,2
40150_1,,,,2,1,1,2
40151_0,,,,2,1,2,3
40151_1,,,,2,1,2,3
40153_0,,,,2,1,1,2
C(C(COC(C(C)=O)O)O)(O)=O,,,5,1,2,0,2
40153_1,,,,2,1,1,2
40155_0,,,,2,1,1,2
C(C(CO)O)(OC(C=O)(C)O)=O,,,5,1,2,0,2
40155_1,,,,2,1,1,2
40156_0,,,,2,1,2,3
40156_1,,,,2,1,2,3
40158_0,,,,2,1,1,2
C(C(COC(C=O)(C)O)O)(O)=O,,,5,1,2,0,2
40158_1,,,,2,1,1,2
40160_0,,,,2,1,1,2
C(CC(OC(C(O)=O)CO)O)=O,,,5,1,2,0,2
40160_1,,,,2,1,1,2
40161_0,,,,2,1,2,3
40161_1,,,,2,1,2,3
40163_0,,,,2,1,1,2
C(C(C(C(OCC=O)O)O)O)(O)=O,,,5,1,2,0,2
40163_1,,,,2,1,1,2
40165_0,,,,2,1,1,2
C(C(C(COC(C=O)O)O)O)(O)=O,,,5,1,2,0,2
40165_1,,,,2,1,1,2
40167_0,,,,2,1,1,2
C(CC(O)OC(C(CO)O)=O)=O,,,5,1,2,0,2
40167_1,,,,2,1,1,2
40168_0,,,,2,1,2,3
40168_1,,,,2,1,2,3
40170_0,,,,2,1,1,2
C(CC(O)OCC(C(O)=O)O)=O,,,5,1,2,0,2
40170_1,,,,2,1,1,2
40171_0,,,,2,1,2,3
40171_1,,,,2,1,2,3
40173_0,,,,2,1,1,2
C(C(CO)O)(OCC(CO)=O)=O,,,5,1,2,0,2
40173_1,,,,2,1,1,2
40174_0,,,,2,1,2,3
40175_0,,,,2,1,2,3
40176_0,,,,2,1,2,3
40177_0,,,,2,1,2,3
40178_0,,,,2,1,2,3
40179_0,,,,2,1,2,3
40180_0,,,,2,1,2,3
40181_0,,,,2,1,2,3
40182_0,,,,2,1,2,3
40183_0,,,,2,1,2,3
40184_0,,,,2,1,2,3
40185_0,,,,2,1,2,3
40186_0,,,,2,1,2,3
40187_0,,,,2,1,2,3
40188_0,,,,2,1,2,3
40189_0,,,,2,1,2,3
40190_0,,,,2,1,2,3
40191_0,,,,2,1,2,3
40192_0,,,,2,1,2,3
40193_0,,,,2,1,2,3
40194_0,,,,2,1,2,3
40195_0,,,,2,1,2,3
40196_0,,,,2,1,2,3
40197_0,,,,2,1,2,3
40198_0,,,,2,1,2,3
40199_0,,,,2,1,2,3
40200_0,,,,2,1,2,3
40201_0,,,,2,1,2,3
40202_0,,,,2,1,2,3
40203_0,,,,2,1,2,3
40204_0,,,,2,1,2,3
40205_0,,,,2,1,2,3
40206_0,,,,2,1,2,3
40207_0,,,,2,1,2,3
40208_0,,,,2,1,2,3
40209_0,,,,2,1,2,3
40210_0,,,,2,1,2,3
40211_0,,,,2,1,2,3
40212_0,,,,2,1,2,3
40213_0,,,,2,1,2,3
40214_0,,,,2,1,2,3
40215_0,,,,2,1,2,3
40216_0,,,,2,1,2,3
40217_0,,,,2,1,2,3
40218_0,,,,2,1,2,3
40219_0,,,,2,1,2,3
40220_0,,,,2,1,2,3
40221_0,,,,2,1,2,3
40222_0,,,,2,1,2,3
40223_0,,,,2,1,2,3
40224_0,,,,2,1,2,3
40225_0,,,,2,1,2,3
40226_0,,,,2,1,2,3
40227_0,,,,2,1,2,3
40228_0,,,,2,1,2,3
40229_0,,,,2,1,2,3
40230_0,,,,2,1,2,3
40231_0,,,,2,1,2,3
40232_0,,,,2,1,2,3
40233_0,,,,2,1,2,3
40234_0,,,,2,1,2,3
40235_0,,,,2,1,2,3
40236_0,,,,2,1,2,3
40237_0,,,,2,1,2,3
40238_0,,,,2,1,2,3
40239_0,,,,2,1,2,3
40240_0,,,,2,1,2,3
40241_0,,,,2,1,2,3
40242_0,,,,2,1,2,3
40243_0,,,,2,1,2,3
40244_0,,,,2,1,2,3
40245_0,,,,2,1,2,3
40246_0,,,,2,1,2,3
40247_0,,,,2,1,2,3
40248_0,,,,2,1,2,3
40249_0,,,,2,1,2,3
40250_0,,,,2,1,2,3
40251_0,,,,2,1,2,3
40252_0,,,,2,1,2,3
40253_0,,,,2,1,2,3
40254_0,,,,2,1,2,3
40255_0,,,,2,1,2,3
40256_0,,,,2,1,2,3
40257_0,,,,2,1,2,3
40258_0,,,,2,1,2,3
40259_0,,,,2,1,2,3
40260_0,,,,2,1,2,3
40261_0,,,,2,1,2,3
40262_0,,,,2,1,2,3
40263_0,,,,2,1,2,3
40264_0,,,,2,1,2,3
40265_0,,,,2,1,2,3
40266_0,,,,2,1,2,3
40267_0,,,,2,1,2,3
40268_0,,,,2,1,2,3
40269_0,,,,2,1,2,3
40270_0,,,,2,1,2,3
40271_0,,,,2,1,2,3
40272_0,,,,2,1,2,3
40273_0,,,,2,1,2,3
40274_0,,,,2,1,2,3
40275_0,,,,2,1,2,3
40276_0,,,,2,1,2,3
40277_0,,,,2,1,2,3
40278_0,,,,2,1,2,3
40279_0,,,,2,1,2,3
40280_0,,,,2,1,2,3
40281_0,,,,2,1,2,3
40282_0,,,,2,1,2,3
40283_0,,,,2,1,2,3
40284_0,,,,2,1,2,3
40285_0,,,,2,1,2,3
40286_0,,,,2,1,2,3
40287_0,,,,2,1,2,3
40288_0,,,,2,1,2,3
40289_0,,,,2,1,2,3
40290_0,,,,2,1,2,3
40291_0,,,,2,1,2,3
40292_0,,,,2,1,2,3
40293_0,,,,2,1,2,3
40294_0,,,,2,1,2,3
40295_0,,,,2,1,2,3
40296_0,,,,2,1,2,3
40297_0,,,,2,1,2,3
40298_0,,,,2,1,2,3
40299_0,,,,2,1,2,3
40300_0,,,,2,1,2,3
40301_0,,,,2,1,2,3
40302_0,,,,2,1,2,3
40303_0,,,,2,1,2,3
40304_0,,,,2,1,2,3
40305_0,,,,2,1,2,3
40306_0,,,,2,1,2,3
40307_0,,,,2,1,2,3
40308_0,,,,2,1,2,3
40309_0,,,,2,1,2,3
40310_0,,,,2,1,2,3
40311_0,,,,2,1,2,3
40312_0,,,,2,1,2,3
40313_0,,,,2,1,2,3
40315_0,,,,2,1,1,2
C(CO)(OC(C=O)CC=O)=O,,,5,1,3,0,3
40317_0,,,,2,1,1,2
C(C(C(C)=O)OC(CO)=O)=O,,,5,1,3,0,3
40319_0,,,,2,1,1,2
C(CO)(OCCC(C=O)=O)=O,,,5,1,3,0,3
40321_0,,,,2,1,1,2
C(CC(COC(CO)=O)=O)=O,,,5,1,3,0,3
40322_0,,,,2,1,2,3
40323_0,,,,2,1,2,3
40324_0,,,,2,1,2,3
40325_0,,,,2,1,2,3
40327_0,,,,2,1,1,2
C(CO)(OC(C=O)O)=O,,,5,1,1,0,1
40329_0,,,,2,1,1,2
C(CO)(OC(C(C)=O)O)=O,,,5,1,1,0,1
40331_0,,,,2,1,1,2
C(C(C)(O)OC(CO)=O)=O,,,5,1,1,0,1
40333_0,,,,2,1,1,2
C(CC(OCC(O)=O)O)=O,,,5,1,1,0,1
40335_0,,,,2,1,1,2
C(CO)(OC(C(CCO)=O)O)=O,,,5,1,1,0,1
40337_0,,,,2,1,1,2
C(C(CCO)(O)OC(CO)=O)=O,,,5,1,1,0,1
40339_0,,,,2,1,1,2
C(CC(CO)(OCC(O)=O)O)=O,,,5,1,1,0,1
40341_0,,,,2,1,1,2
C(CO)(CC(OCC(O)=O)O)=O,,,5,1,1,0,1
40343_0,,,,2,1,1,2
C(C(C(C)(OCC(O)=O)O)O)=O,,,5,1,1,0,1
40345_0,,,,2,1,1,2
C(C)(C(C(OCC(O)=O)O)O)=O,,,5,1,1,0,1
40346_0,,,,2,1,2,3
40348_0,,,,2,1,1,2
C(CC(O)OC(CO)=O)=O,,,5,1,1,0,1
40350_0,,,,2,1,1,2
C(C(CC(OCC(O)=O)O)O)=O,,,5,1,1,0,1
40352_0,,,,2,1,1,2
C(CC(C(OCC(O)=O)O)O)=O,,,5,1,1,0,1
40354_0,,,,2,1,1,2
C(CC(CO)(O)OC(CO)=O)=O,,,5,1,1,0,1
40356_0,,,,2,1,1,2
C(CO)(CC(O)OC(CO)=O)=O,,,5,1,1,0,1
40358_0,,,,2,1,1,2
C(C(C(C)(O)OC(CO)=O)O)=O,,,5,1,1,0,1
40360_0,,,,2,1,1,2
C(C)(C(C(O)OC(CO)=O)O)=O,,,5,1,1,0,1
40362_0,,,,2,1,1,2
C(C(CC(O)OC(CO)=O)O)=O,,,5,1,1,0,1
40364_0,,,,2,1,1,2
C(CC(C(O)OC(CO)=O)O)=O,,,5,1,1,0,1
40365_0,,,,2,1,1,2
40367_0,,,,2,1,1,2
C(CO)(OCC(C(CO)O)=O)=O,,,5,1,1,0,1
40368_0,,,,2,1,1,2
40369_0,,,,2,1,1,2
40370_0,,,,2,1,1,2
40371_0,,,,2,1,1,2
40372_0,,,,2,1,1,2
40373_0,,,,2,1,1,2
40374_0,,,,2,1,1,2
40375_0,,,,2,1,1,2
40376_0,,,,2,1,2,3
40377_0,,,,2,1,2,3
40378_0,,,,2,1,2,3
40379_0,,,,2,1,2,3
40380_0,,,,2,1,2,3
40381_0,,,,2,1,2,3
40382_0,,,,2,1,2,3
40383_0,,,,2,1,2,3
40384_0,,,,2,1,2,3
40385_0,,,,2,1,2,3
40387_0,,,,2,1,2,3
C(C1C(C(C(C1)=O)O)=O)=O,,,5,1,2,0,2
40389_0,,,,2,1,2,3
C1(C(C)C(C(C1O)=O)O)=O,,,5,1,1,0,1
40390_0,,,,2,1,2,3
40391_0,,,,2,1,2,3
40392_0,,,,2,1,2,3
40393_0,,,,2,1,2,3
40394_0,,,,2,1,2,3
40396_0,,,,2,1,2,3
C1(C(CO)CC(C1O)=O)=O,,,5,1,2,0,2
40397_0,,,,2,1,2,3
40398_0,,,,2,1,2,3
40399_0,,,,2,1,2,3
40401_0,,,,2,1,2,3
C1(C(CCO)C(C(C1O)=O)O)=O,,,5,1,1,0,1
40402_0,,,,2,1,2,3
40403_0,,,,2,1,2,3
40404_0,,,,2,1,2,3
40405_0,,,,2,1,2,3
40406_0,,,,2,1,2,3
40408_0,,,,2,1,2,3
C1(C(CO)C(C(C1O)=O)CO)=O,,,5,1,1,0,1
40409_0,,,,2,1,2,3
40410_0,,,,2,1,2,3
40411_0,,,,2,1,2,3
40412_0,,,,2,1,2,3
40413_0,,,,2,1,2,3
40414_0,,,,2,1,2,3
40415_0,,,,2,1,2,3
40416_0,,,,2,1,2,3
40417_0,,,,2,1,2,3
40418_0,,,,2,1,2,3
40419_0,,,,2,1,2,3
40420_0,,,,2,1,2,3
40421_0,,,,2,1,2,3
40422_0,,,,2,1,2,3
40423_0,,,,2,1,2,3
40424_0,,,,2,1,2,3
40425_0,,,,2,1,2,3
40426_0,,,,2,1,2,3
40428_0,,,,2,1,2,3
C1(C(CC(C(C1CO)O)O)=O)=O,,,5,1,1,0,1
40429_0,,,,2,1,2,3
40430_0,,,,2,1,2,3
40431_0,,,,2,1,2,3
40432_0,,,,2,1,2,3
40433_0,,,,2,1,2,3
40434_0,,,,2,1,2,3
40435_0,,,,2,1,2,3
40436_0,,,,2,1,2,3
40437_0,,,,2,1,2,3
40438_0,,,,2,1,2,3
40439_0,,,,2,1,2,3
40440_0,,,,2,1,2,3
40441_0,,,,2,1,2,3
40442_0,,,,2,1,2,3
40443_0,,,,2,1,2,3
40444_0,,,,2,1,2,3
40445_0,,,,2,1,2,3
40447_0,,,,2,1,2,3
C1(C(C(CO)O)CC(C1O)=O)=O,,,5,1,1,0,1
40448_0,,,,2,1,2,3
40449_0,,,,2,1,2,3
40450_0,,,,2,1,2,3
40451_0,,,,2,1,2,3
40452_0,,,,2,1,2,3
40454_0,,,,2,1,2,3
C1(C(C=O)C(C(C1O)=O)C)=O,,,5,1,1,0,1
40455_0,,,,2,1,2,3
40457_0,,,,2,1,2,3
C1(C(C)C(C(C1C=O)=O)O)=O,,,5,1,1,0,1
40458_0,,,,2,1,2,3
40459_0,,,,2,1,2,3
40460_0,,,,2,1,2,3
40461_0,,,,2,1,2,3
40463_0,,,,2,1,2,3
C(CC1C(C(C(C1)=O)O)=O)=O,,,5,1,1,0,1
40464_0,,,,2,1,2,3
40465_0,,,,2,1,2,3
40466_0,,,,2,1,2,3
40467_0,,,,2,1,2,3
40469_0,,,,2,1,2,3
C1(CC(C(C=O)=O)CC1O)=O,,,5,1,1,0,1
40471_0,,,,2,1,2,3
C1(CCC(C1O)=O)=O,,,5,1,1,0,1
40472_0,,,,2,1,2,3
40473_0,,,,2,1,2,3
40474_0,,,,2,1,2,3
40475_0,,,,2,1,2,3
40476_0,,,,2,1,2,3
40477_0,,,,2,1,2,3
40478_0,,,,2,1,2,3
40479_0,,,,2,1,2,3
40480_0,,,,2,1,2,3
40481_0,,,,2,1,2,3
40482_0,,,,2,1,2,3
40483_0,,,,2,1,2,3
40484_0,,,,2,1,2,3
40485_0,,,,2,1,2,3
40486_0,,,,2,1,2,3
40487_0,,,,2,1,2,3
40488_0,,,,2,1,2,3
40489_0,,,,2,1,2,3
40490_0,,,,2,1,2,3
40491_0,,,,2,1,2,3
40492_0,,,,2,1,2,3
40493_0,,,,2,1,2,3
40494_0,,,,2,1,2,3
40495_0,,,,2,1,2,3
40496_0,,,,2,1,2,3
40497_0,,,,2,1,2,3
40498_0,,,,2,1,2,3
40499_0,,,,2,1,2,3
40500_0,,,,2,1,2,3
40501_0,,,,2,1,2,3
40502_0,,,,2,1,2,3
40503_0,,,,2,1,2,3
40504_0,,,,2,1,2,3
40506_0,,,,2,1,2,3
C1(CC(C(C1(CO)O)=O)O)=O,,,5,1,1,0,1
40507_0,,,,2,1,2,3
40508_0,,,,2,1,2,3
40509_0,,,,2,1,2,3
40511_0,,,,2,1,2,3
C(C1(C(CCC1=O)=O)O)=O,,,5,1,1,0,1
40513_0,,,,2,1,2,3
C(C1(C(CC(C1)=O)=O)O)=O,,,5,1,2,0,2
40515_0,,,,2,1,2,3
C1(C(C)C(C(C1O)=O)(CO)O)=O,,,5,1,1,0,1
40516_0,,,,2,1,2,3
40517_0,,,,2,1,2,3
40518_0,,,,2,1,2,3
40520_0,,,,2,1,2,3
C1(C(C)C(C(C1(CO)O)=O)O)=O,,,5,1,1,0,1
40521_0,,,,2,1,2,3
40522_0,,,,2,1,2,3
40523_0,,,,2,1,2,3
40524_0,,,,2,1,2,3
40525_0,,,,2,1,2,3
40526_0,,,,2,1,2,3
40527_0,,,,2,1,2,3
40528_0,,,,2,1,2,3
40529_0,,,,2,1,2,3
40530_0,,,,2,1,2,3
40532_0,,,,2,1,2,3
C1(C(C=O)(C(C(C1)=O)C)O)=O,,,5,1,1,0,1
40533_0,,,,2,1,2,3
40534_0,,,,2,1,2,3
40535_0,,,,2,1,2,3
40536_0,,,,2,1,2,3
40538_0,,,,2,1,2,3
C1(C(C)CC(C1(C=O)O)=O)=O,,,5,1,1,0,1
40539_0,,,,2,1,2,3
40540_0,,,,2,1,2,3
40541_0,,,,2,1,2,3
40542_0,,,,2,1,2,3
40543_0,,,,2,1,2,3
40544_0,,,,2,1,2,3
40545_0,,,,2,1,2,3
40546_0,,,,2,1,2,3
40547_0,,,,2,1,2,3
40548_0,,,,2,1,2,3
40549_0,,,,2,1,2,3
40550_0,,,,2,1,2,3
40551_0,,,,2,1,2,3
40552_0,,,,2,1,2,3
40553_0,,,,2,1,2,3
40554_0,,,,2,1,2,3
40555_0,,,,2,1,2,3
40556_0,,,,2,1,2,3
40557_0,,,,2,1,2,3
40558_0,,,,2,1,2,3
40559_0,,,,2,1,2,3
40560_0,,,,2,1,2,3
40561_0,,,,2,1,2,3
40562_0,,,,2,1,2,3
40563_0,,,,2,1,2,3
40564_0,,,,2,1,2,3
40565_0,,,,2,1,2,3
40566_0,,,,2,1,2,3
40567_0,,,,2,1,2,3
40568_0,,,,2,1,2,3
40569_0,,,,2,1,2,3
40570_0,,,,2,1,2,3
40571_0,,,,2,1,2,3
40572_0,,,,2,1,2,3
40574_0,,,,2,1,2,3
C(C(C(C=O)=O)CC(C=O)O)=O,,,5,1,1,0,1
40575_0,,,,2,1,2,3
40576_0,,,,2,1,2,3
40577_0,,,,2,1,2,3
40578_0,,,,2,1,2,3
40579_0,,,,2,1,2,3
40580_0,,,,2,1,2,3
40581_0,,,,2,1,2,3
40582_0,,,,2,1,2,3
40583_0,,,,2,1,2,3
40584_0,,,,2,1,2,3
40585_0,,,,2,1,2,3
40586_0,,,,2,1,2,3
40587_0,,,,2,1,2,3
40589_0,,,,2,1,2,3
C(C(C=O)CC(C(C=O)O)=O)=O,,,5,1,2,0,2
40590_0,,,,2,1,2,3
40591_0,,,,2,1,2,3
40592_0,,,,2,1,2,3
40593_0,,,,2,1,2,3
40594_0,,,,2,1,2,3
40595_0,,,,2,1,2,3
40596_0,,,,2,1,2,3
40597_0,,,,2,1,2,3
40598_0,,,,2,1,2,3
40599_0,,,,2,1,2,3
40600_0,,,,2,1,2,3
40601_0,,,,2,1,2,3
40602_0,,,,2,1,2,3
40603_0,,,,2,1,2,3
40604_0,,,,2,1,2,3
40605_0,,,,2,1,2,3
40606_0,,,,2,1,2,3
40607_0,,,,2,1,2,3
40608_0,,,,2,1,2,3
40609_0,,,,2,1,2,3
40610_0,,,,2,1,2,3
40611_0,,,,2,1,2,3
40612_0,,,,2,1,2,3
40613_0,,,,2,1,2,3
40614_0,,,,2,1,2,3
40615_0,,,,2,1,2,3
40616_0,,,,2,1,2,3
40617_0,,,,2,1,2,3
40618_0,,,,2,1,2,3
40619_0,,,,2,1,2,3
40620_0,,,,2,1,2,3
40621_0,,,,2,1,2,3
40622_0,,,,2,1,2,3
40623_0,,,,2,1,2,3
40624_0,,,,2,1,2,3
40625_0,,,,2,1,2,3
40626_0,,,,2,1,2,3
40627_0,,,,2,1,2,3
40629_0,,,,2,1,2,3
C(C(CO)CC=O)(C(C)O)=O,,,5,1,1,0,1
40630_0,,,,2,1,2,3
40631_0,,,,2,1,2,3
40632_0,,,,2,1,2,3
40633_0,,,,2,1,2,3
40634_0,,,,2,1,2,3
40635_0,,,,2,1,2,3
40636_0,,,,2,1,2,3
40637_0,,,,2,1,2,3
40638_0,,,,2,1,2,3
40639_0,,,,2,1,2,3
40640_0,,,,2,1,2,3
40641_0,,,,2,1,2,3
40642_0,,,,2,1,2,3
40643_0,,,,2,1,2,3
40644_0,,,,2,1,2,3
40645_0,,,,2,1,2,3
40646_0,,,,2,1,2,3
40647_0,,,,2,1,2,3
40648_0,,,,2,1,2,3
40649_0,,,,2,1,2,3
40650_0,,,,2,1,2,3
40651_0,,,,2,1,2,3
40652_0,,,,2,1,2,3
40653_0,,,,2,1,2,3
40654_0,,,,2,1,2,3
40655_0,,,,2,1,2,3
40656_0,,,,2,1,2,3
40657_0,,,,2,1,2,3
40658_0,,,,2,1,2,3
40660_0,,,,2,1,2,3
C(C(C)CC(C=O)=O)(CC=O)=O,,,5,1,1,0,1
40662_0,,,,2,1,2,3
C(CC(C(C)C(C=O)C=O)=O)=O,,,5,1,1,0,1
40664_0,,,,2,1,2,3
C(C(C)(CCC(C(C)=O)=O)O)=O,,,5,1,1,0,1
40666_0,,,,2,1,2,3
C(C(C)(CC(CC(C)=O)=O)O)=O,,,5,1,1,0,1
40668_0,,,,2,1,2,3
C(C(C)(CCC(C=O)=O)O)=O,,,5,1,2,0,2
40669_0,,,,2,1,2,3
40671_0,,,,2,1,2,3
C(C(C)CC=O)(C(C=O)CO)=O,,,5,1,1,0,1
40672_0,,,,2,1,2,3
40674_0,,,,2,1,2,3
C(C)(CC(C(C)(CC=O)O)=O)=O,,,5,1,1,0,1
40676_0,,,,2,1,2,3
C(C)(C(C(C(C)CC=O)=O)O)=O,,,5,1,1,0,1
40678_0,,,,2,1,2,3
C(CO)(CC(C(C)CC=O)=O)=O,,,5,1,1,0,1
40680_0,,,,2,1,2,3
C(C(C)CC=O)(CC(C=O)=O)=O,,,5,1,1,0,1
40682_0,,,,2,1,2,3
C(C(C)CC=O)(C(C=O)C=O)=O,,,5,1,1,0,1
40684_0,,,,2,1,2,3
C(C(C)CC=O)(CC=O)=O,,,5,1,1,0,1
40685_0,,,,2,1,2,3
40686_0,,,,2,1,2,3
40688_0,,,,2,1,2,3
C(C(C)CC=O)(C(C=O)O)=O,,,5,1,1,0,1
40690_0,,,,2,1,2,3
C(C(C)C(C=O)C(C=O)(C)O)=O,,,5,1,2,0,2
40691_0,,,,2,1,2,3
40692_0,,,,2,1,2,3
40694_0,,,,2,1,2,3
C(C(C(CCC=O)=O)(C)O)=O,,,5,1,1,0,1
40695_0,,,,2,1,2,3
40696_0,,,,2,1,2,3
40697_0,,,,2,1,2,3
40699_0,,,,2,1,2,3
C(CC(C=O)O)(C(C=O)(C)O)=O,,,5,1,1,0,1
40700_0,,,,2,1,2,3
40701_0,,,,2,1,2,3
40702_0,,,,2,1,2,3
40703_0,,,,2,1,2,3
40705_0,,,,2,1,2,3
C(C(C)C(C=O)O)(CC=O)=O,,,5,1,1,0,1
40706_0,,,,2,1,2,3
40707_0,,,,2,1,2,3
40708_0,,,,2,1,2,3
40709_0,,,,2,1,2,3
40711_0,,,,2,1,2,3
C(C)(C(CCC(C(C)=O)=O)O)=O,,,5,1,1,0,1
40713_0,,,,2,1,2,3
C(C)(CC(CC(C(C)=O)O)=O)=O,,,5,1,1,0,1
40714_0,,,,2,1,2,3
40715_0,,,,2,1,2,3
40717_0,,,,2,1,2,3
C(CC(C(C)C(C=O)CO)=O)=O,,,5,1,1,0,1
40719_0,,,,2,1,2,3
C(CC(C(C(C(C)=O)=O)C)O)=O,,,5,1,1,0,1
40721_0,,,,2,1,2,3
C(C(C)C(C(C)=O)O)(CC=O)=O,,,5,1,1,0,1
40723_0,,,,2,1,2,3
C(C(C)CC(CO)=O)(CC=O)=O,,,5,1,1,0,1
40725_0,,,,2,1,2,3
C(C(C(C=O)C(C=O)C)O)(C)=O,,,5,1,2,0,2
40726_0,,,,2,1,2,3
40727_0,,,,2,1,2,3
40729_0,,,,2,1,2,3
C(CC(C(CC(C=O)C)=O)O)=O,,,5,1,1,0,1
40730_0,,,,2,1,2,3
40731_0,,,,2,1,2,3
40733_0,,,,2,1,2,3
C(CCC(C(C(C)=O)O)=O)=O,,,5,1,2,0,2
40734_0,,,,2,1,2,3
40735_0,,,,2,1,2,3
40736_0,,,,2,1,2,3
40737_0,,,,2,1,2,3
40738_0,,,,2,1,2,3
40739_0,,,,2,1,2,3
40740_0,,,,2,1,2,3
40741_0,,,,2,1,2,3
40742_0,,,,2,1,2,3
40744_0,,,,2,1,2,3
C(C(C(C(C)=O)=O)CC(C)O)=O,,,5,1,1,0,1
40746_0,,,,2,1,2,3
C(C(C(C=O)=O)CC(C)O)=O,,,5,1,1,0,1
40748_0,,,,2,1,2,3
C(CC(C)O)(CC(C(C)=O)=O)=O,,,5,1,2,0,2
40750_0,,,,2,1,2,3
C(C)(CC(C(CC(C)O)=O)=O)=O,,,5,1,1,0,1
40752_0,,,,2,1,2,3
C(C(C)C(C(C=O)=O)C(C)O)=O,,,5,1,2,0,2
40753_0,,,,2,1,2,3
40754_0,,,,2,1,2,3
40755_0,,,,2,1,2,3
40756_0,,,,2,1,2,3
40758_0,,,,2,1,2,3
C(C(C(C=O)=O)CC(CO)O)=O,,,5,1,1,0,1
40759_0,,,,2,1,2,3
40760_0,,,,2,1,2,3
40761_0,,,,2,1,2,3
40762_0,,,,2,1,2,3
40763_0,,,,2,1,2,3
40764_0,,,,2,1,2,3
40765_0,,,,2,1,2,3
40766_0,,,,2,1,2,3
40768_0,,,,2,1,2,3
C(CC(C(C=O)C(C=O)C)O)=O,,,5,1,2,0,2
40769_0,,,,2,1,2,3
40770_0,,,,2,1,2,3
40771_0,,,,2,1,2,3
40772_0,,,,2,1,2,3
40773_0,,,,2,1,2,3
40774_0,,,,2,1,2,3
40775_0,,,,2,1,2,3
40776_0,,,,2,1,2,3
40777_0,,,,2,1,2,3
40778_0,,,,2,1,2,3
40779_0,,,,2,1,2,3
40780_0,,,,2,1,2,3
40781_0,,,,2,1,2,3
40782_0,,,,2,1,2,3
40783_0,,,,2,1,2,3
40784_0,,,,2,1,2,3
40785_0,,,,2,1,2,3
40786_0,,,,2,1,2,3
40787_0,,,,2,1,2,3
40788_0,,,,2,1,2,3
40789_0,,,,2,1,2,3
40790_0,,,,2,1,2,3
40792_0,,,,2,1,2,3
C(C(CO)CC(C(C=O)=O)=O)=O,,,5,1,1,0,1
40793_0,,,,2,1,2,3
40794_0,,,,2,1,2,3
40795_0,,,,2,1,2,3
40797_0,,,,2,1,2,3
C(C(CCO)CC=O)(CC=O)=O,,,5,1,1,0,1
40798_0,,,,2,1,2,3
40799_0,,,,2,1,2,3
40801_0,,,,2,1,2,3
C(C(C(C=O)=O)C(CO)CO)=O,,,5,1,1,0,1
40802_0,,,,2,1,2,3
40803_0,,,,2,1,2,3
40804_0,,,,2,1,2,3
40805_0,,,,2,1,2,3
40806_0,,,,2,1,2,3
40807_0,,,,2,1,2,3
40808_0,,,,2,1,2,3
40809_0,,,,2,1,2,3
40810_0,,,,2,1,2,3
40811_0,,,,2,1,2,3
40812_0,,,,2,1,2,3
40813_0,,,,2,1,2,3
40814_0,,,,2,1,2,3
40815_0,,,,2,1,2,3
40816_0,,,,2,1,2,3
40817_0,,,,2,1,2,3
40818_0,,,,2,1,2,3
40819_0,,,,2,1,2,3
40820_0,,,,2,1,2,3
40821_0,,,,2,1,2,3
40822_0,,,,2,1,2,3
40823_0,,,,2,1,2,3
40824_0,,,,2,1,2,3
40825_0,,,,2,1,2,3
40826_0,,,,2,1,2,3
40827_0,,,,2,1,2,3
40828_0,,,,2,1,2,3
40829_0,,,,2,1,2,3
40830_0,,,,2,1,2,3
40831_0,,,,2,1,2,3
40832_0,,,,2,1,2,3
40833_0,,,,2,1,2,3
40834_0,,,,2,1,2,3
40835_0,,,,2,1,2,3
40836_0,,,,2,1,2,3
40837_0,,,,2,1,2,3
40838_0,,,,2,1,2,3
40839_0,,,,2,1,2,3
40840_0,,,,2,1,2,3
40842_0,,,,2,1,2,3
C(CC(C(C(C)O)=O)CC=O)=O,,,5,1,1,0,1
40843_0,,,,2,1,2,3
40844_0,,,,2,1,2,3
40846_0,,,,2,1,2,3
C(CC(C(CO)=O)CC=O)=O,,,5,1,2,0,2
40847_0,,,,2,1,2,3
40848_0,,,,2,1,2,3
40849_0,,,,2,1,2,3
40850_0,,,,2,1,2,3
40851_0,,,,2,1,2,3
40852_0,,,,2,1,2,3
40853_0,,,,2,1,2,3
40854_0,,,,2,1,2,3
40855_0,,,,2,1,2,3
40856_0,,,,2,1,2,3
40857_0,,,,2,1,2,3
40858_0,,,,2,1,2,3
40859_0,,,,2,1,2,3
40860_0,,,,2,1,2,3
40861_0,,,,2,1,2,3
40862_0,,,,2,1,2,3
40863_0,,,,2,1,2,3
40864_0,,,,2,1,2,3
40866_0,,,,2,1,2,3
C(CC(C(C=O)=O)CC(C)O)=O,,,5,1,1,0,1
40868_0,,,,2,1,2,3
C(CC(C(C=O)=O)CCO)=O,,,5,1,2,0,2
40869_0,,,,2,1,2,3
40870_0,,,,2,1,2,3
40871_0,,,,2,1,2,3
40872_0,,,,2,1,2,3
40873_0,,,,2,1,2,3
40875_0,,,,2,1,2,3
C(C(C(CCC(C)O)=O)=O)=O,,,5,1,1,0,1
40876_0,,,,2,1,2,3
40878_0,,,,2,1,2,3
C(C(C(C)=O)=O)(CCC(C)O)=O,,,5,1,1,0,1
40879_0,,,,2,1,2,3
40881_0,,,,2,1,2,3
C(C(C)=O)(CCC(C)O)=O,,,5,1,1,0,1
40883_0,,,,2,1,2,3
C(CC(C)O)(CC(C)=O)=O,,,5,1,1,0,1
40885_0,,,,2,1,2,3
C(C(CCO)=O)(CCC(C)O)=O,,,5,1,1,0,1
40887_0,,,,2,1,2,3
C(CC(C)O)(CC(CCO)=O)=O,,,5,1,1,0,1
40888_0,,,,2,1,2,3
40889_0,,,,2,1,2,3
40891_0,,,,2,1,2,3
C(C(CO)=O)(CCC(C)O)=O,,,5,1,1,0,1
40892_0,,,,2,1,2,3
40894_0,,,,2,1,2,3
C(CC(C(CCC(C)O)=O)=O)=O,,,5,1,1,0,1
40895_0,,,,2,1,2,3
40896_0,,,,2,1,2,3
40897_0,,,,2,1,2,3
40899_0,,,,2,1,2,3
C(C(C(C)O)CC(C(C)O)=O)=O,,,5,1,1,0,1
40900_0,,,,2,1,2,3
40902_0,,,,2,1,2,3
C(C(C(CC(C)O)=O)C(C)O)=O,,,5,1,2,0,2
40903_0,,,,2,1,2,3
40904_0,,,,2,1,2,3
40905_0,,,,2,1,2,3
40906_0,,,,2,1,2,3
40907_0,,,,2,1,2,3
40908_0,,,,2,1,2,3
40910_0,,,,2,1,2,3
C(C(C(C)O)C(C=O)C)=O,,,5,1,2,0,2
40911_0,,,,2,1,2,3
40913_0,,,,2,1,2,3
C(C(C(C)O)CC(CCO)=O)=O,,,5,1,2,0,2
40915_0,,,,2,1,2,3
C(C(C(CCCO)=O)C(C)O)=O,,,5,1,1,0,1
40916_0,,,,2,1,2,3
40918_0,,,,2,1,2,3
C(C(C(C)O)C(C(CO)=O)C)=O,,,5,1,1,0,1
40919_0,,,,2,1,2,3
40921_0,,,,2,1,2,3
C(C(C(C)O)C1C(COC1)=O)=O,,,5,1,1,0,1
40923_0,,,,2,1,2,3
C1(C(CCO1)C(C=O)C(C)O)=O,,,5,1,1,0,1
40924_0,,,,2,1,2,3
40925_0,,,,2,1,2,3
40926_0,,,,2,1,2,3
40927_0,,,,2,1,2,3
40928_0,,,,2,1,2,3
40929_0,,,,2,1,2,3
40931_0,,,,2,1,2,3
C(C(CO)CC(C(C)O)=O)=O,,,5,1,1,0,1
40932_0,,,,2,1,2,3
40933_0,,,,2,1,2,3
40934_0,,,,2,1,2,3
40935_0,,,,2,1,2,3
40936_0,,,,2,1,2,3
40937_0,,,,2,1,2,3
40938_0,,,,2,1,2,3
40939_0,,,,2,1,2,3
40940_0,,,,2,1,2,3
40941_0,,,,2,1,2,3
40943_0,,,,2,1,2,3
C(CC(C(C)=O)O)(C(C)O)=O,,,5,1,1,0,1
40944_0,,,,2,1,2,3
40945_0,,,,2,1,2,3
40947_0,,,,2,1,2,3
C(CC(C)O)(C(C(C)=O)O)=O,,,5,1,1,0,1
40948_0,,,,2,1,2,3
40950_0,,,,2,1,2,3
C(CCC(C(C)O)=O)(CO)=O,,,5,1,1,0,1
40951_0,,,,2,1,2,3
40952_0,,,,2,1,2,3
40953_0,,,,2,1,2,3
40955_0,,,,2,1,2,3
C(CCC(C(O)=O)=O)(C(C)O)=O,,,5,1,1,0,1
40956_0,,,,2,1,2,3
40957_0,,,,2,1,2,3
40958_0,,,,2,1,2,3
40960_0,,,,2,1,2,3
C(C(C=O)CC(C(C)O)=O)(O)=O,,,5,1,1,0,1
40961_0,,,,2,1,2,3
40963_0,,,,2,1,2,3
C(C(C=O)C(CC(C)O)=O)(O)=O,,,5,1,1,0,1
40964_0,,,,2,1,2,3
40965_0,,,,2,1,2,3
40967_0,,,,2,1,2,3
C(CC(C(CO)=O)O)(C(C)O)=O,,,5,1,1,0,1
40968_0,,,,2,1,2,3
40969_0,,,,2,1,2,3
40970_0,,,,2,1,2,3
40971_0,,,,2,1,2,3
40972_0,,,,2,1,2,3
40973_0,,,,2,1,2,3
40974_0,,,,2,1,2,3
40975_0,,,,2,1,2,3
40977_0,,,,2,1,2,3
C(C(C=O)CC(C(C)O)=O)=O,,,5,1,1,0,1
40978_0,,,,2,1,2,3
40979_0,,,,2,1,2,3
40980_0,,,,2,1,2,3
40982_0,,,,2,1,2,3
C(CCC=O)(C(C)O)=O,,,5,1,1,0,1
40983_0,,,,2,1,2,3
40984_0,,,,2,1,2,3
40985_0,,,,2,1,2,3
40986_0,,,,2,1,2,3
40988_0,,,,2,1,2,3
C(CC(C=O)O)(C(C)O)=O,,,5,1,1,0,1
40989_0,,,,2,1,2,3
40990_0,,,,2,1,2,3
40991_0,,,,2,1,2,3
40992_0,,,,2,1,2,3
40993_0,,,,2,1,2,3
40994_0,,,,2,1,2,3
40995_0,,,,2,1,2,3
40996_0,,,,2,1,2,3
40997_0,,,,2,1,2,3
40998_0,,,,2,1,2,3
40999_0,,,,2,1,2,3
41000_0,,,,2,1,2,3
41001_0,,,,2,1,2,3
41002_0,,,,2,1,2,3
41003_0,,,,2,1,2,3
41004_0,,,,2,1,2,3
41005_0,,,,2,1,2,3
41006_0,,,,2,1,2,3
41007_0,,,,2,1,2,3
41008_0,,,,2,1,2,3
41009_0,,,,2,1,2,3
41010_0,,,,2,1,2,3
41011_0,,,,2,1,2,3
41012_0,,,,2,1,2,3
41013_0,,,,2,1,2,3
41014_0,,,,2,1,2,3
41015_0,,,,2,1,2,3
41016_0,,,,2,1,2,3
41017_0,,,,2,1,2,3
41018_0,,,,2,1,2,3
41019_0,,,,2,1,2,3
41020_0,,,,2,1,2,3
41022_0,,,,2,1,2,3
C(C(C(CCCO)=O)=O)=O,,,5,1,1,0,1
41023_0,,,,2,1,2,3
41025_0,,,,2,1,2,3
C(C(C(C)=O)=O)(CCCO)=O,,,5,1,1,0,1
41026_0,,,,2,1,2,3
41027_0,,,,2,1,2,3
41028_0,,,,2,1,2,3
41030_0,,,,2,1,2,3
C(C(CCO)=O)(CCCO)=O,,,5,1,1,0,1
41032_0,,,,2,1,2,3
C(CCO)(CC(CCO)=O)=O,,,5,1,1,0,1
41033_0,,,,2,1,2,3
41034_0,,,,2,1,2,3
41036_0,,,,2,1,2,3
C(CC(C(CCCO)=O)=O)(O)=O,,,5,1,1,0,1
41038_0,,,,2,1,2,3
C(CC(CC(CCO)=O)=O)(O)=O,,,5,1,2,0,2
41039_0,,,,2,1,2,3
41040_0,,,,2,1,2,3
41041_0,,,,2,1,2,3
41042_0,,,,2,1,2,3
41043_0,,,,2,1,2,3
41044_0,,,,2,1,2,3
41045_0,,,,2,1,2,3
41046_0,,,,2,1,2,3
41047_0,,,,2,1,2,3
41048_0,,,,2,1,2,3
41049_0,,,,2,1,2,3
41050_0,,,,2,1,2,3
41051_0,,,,2,1,2,3
41052_0,,,,2,1,2,3
41053_0,,,,2,1,2,3
41054_0,,,,2,1,2,3
41055_0,,,,2,1,2,3
41056_0,,,,2,1,2,3
41057_0,,,,2,1,2,3
41058_0,,,,2,1,2,3
41060_0,,,,2,1,2,3
C(C(C)C(C=O)CO)=O,,,5,1,2,0,2
41061_0,,,,2,1,2,3
41063_0,,,,2,1,2,3
C(C(CO)CC(CCO)=O)=O,,,5,1,2,0,2
41065_0,,,,2,1,2,3
C(C(C(CCCO)=O)CO)=O,,,5,1,1,0,1
41066_0,,,,2,1,2,3
41068_0,,,,2,1,2,3
C(C(CO)C(C(CO)=O)C)=O,,,5,1,1,0,1
41069_0,,,,2,1,2,3
41071_0,,,,2,1,2,3
C(C(CO)CC(CC(O)=O)=O)=O,,,5,1,1,0,1
41073_0,,,,2,1,2,3
C(C(C(CCC(O)=O)=O)CO)=O,,,5,1,1,0,1
41074_0,,,,2,1,2,3
41076_0,,,,2,1,2,3
C(C(CO)C(C(C(O)=O)=O)C)=O,,,5,1,1,0,1
41078_0,,,,2,1,2,3
C(C(CO)C1C(COC1)=O)=O,,,5,1,1,0,1
41080_0,,,,2,1,2,3
C1(C(CCO1)C(C=O)CO)=O,,,5,1,1,0,1
41081_0,,,,2,1,2,3
41082_0,,,,2,1,2,3
41084_0,,,,2,1,2,3
C(C(C(CCC(CO)O)=O)=O)=O,,,5,1,1,0,1
41085_0,,,,2,1,2,3
41086_0,,,,2,1,2,3
41087_0,,,,2,1,2,3
41089_0,,,,2,1,2,3
C(C(C)=O)(CCC(CO)O)=O,,,5,1,1,0,1
41090_0,,,,2,1,2,3
41091_0,,,,2,1,2,3
41093_0,,,,2,1,2,3
C(CC(CO)O)(CC(C)=O)=O,,,5,1,1,0,1
41094_0,,,,2,1,2,3
41095_0,,,,2,1,2,3
41096_0,,,,2,1,2,3
41097_0,,,,2,1,2,3
41098_0,,,,2,1,2,3
41099_0,,,,2,1,2,3
41100_0,,,,2,1,2,3
41101_0,,,,2,1,2,3
41102_0,,,,2,1,2,3
41103_0,,,,2,1,2,3
41104_0,,,,2,1,2,3
41105_0,,,,2,1,2,3
41106_0,,,,2,1,2,3
41107_0,,,,2,1,2,3
41108_0,,,,2,1,2,3
41109_0,,,,2,1,2,3
41110_0,,,,2,1,2,3
41111_0,,,,2,1,2,3
41112_0,,,,2,1,2,3
41113_0,,,,2,1,2,3
41114_0,,,,2,1,2,3
41115_0,,,,2,1,2,3
41116_0,,,,2,1,2,3
41117_0,,,,2,1,2,3
41118_0,,,,2,1,2,3
41120_0,,,,2,1,2,3
C(C(C(CO)O)C(C=O)C)=O,,,5,1,2,0,2
41121_0,,,,2,1,2,3
41122_0,,,,2,1,2,3
41123_0,,,,2,1,2,3
41124_0,,,,2,1,2,3
41125_0,,,,2,1,2,3
41126_0,,,,2,1,2,3
41127_0,,,,2,1,2,3
41128_0,,,,2,1,2,3
41129_0,,,,2,1,2,3
41130_0,,,,2,1,2,3
41131_0,,,,2,1,2,3
41132_0,,,,2,1,2,3
41133_0,,,,2,1,2,3
41134_0,,,,2,1,2,3
41135_0,,,,2,1,2,3
41136_0,,,,2,1,2,3
41138_0,,,,2,1,2,3
C(C(C(C(C=O)=O)=O)CO)=O,,,5,1,1,0,1
41140_0,,,,2,1,2,3
C(C(C=O)C(C(C=O)=O)O)=O,,,5,1,1,0,1
41142_0,,,,2,1,2,3
C(C(C(C(C(C)=O)=O)=O)CO)=O,,,5,1,1,0,1
41143_0,,,,2,1,2,3
41145_0,,,,2,1,2,3
C(C(C=O)CC(C(CO)=O)=O)=O,,,5,1,1,0,1
41146_0,,,,2,1,2,3
41147_0,,,,2,1,2,3
41148_0,,,,2,1,2,3
41149_0,,,,2,1,2,3
41151_0,,,,2,1,2,3
C(C(C=O)CC(C(O)=O)=O)=O,,,5,1,1,0,1
41152_0,,,,2,1,2,3
41154_0,,,,2,1,2,3
C(C(C=O)C1C(C(CO1)O)=O)=O,,,5,1,1,0,1
41156_0,,,,2,1,2,3
C(C(C=O)C1C(C(O)OC1)=O)=O,,,5,1,1,0,1
41158_0,,,,2,1,2,3
C(C(C=O)C1C(COC1O)=O)=O,,,5,1,1,0,1
41160_0,,,,2,1,2,3
C(C(C=O)C1C(CC(O1)O)=O)=O,,,5,1,1,0,1
41161_0,,,,2,1,2,3
41162_0,,,,2,1,2,3
41164_0,,,,2,1,2,3
C(C(C=O)CC(C=O)=O)=O,,,5,1,1,0,1
41166_0,,,,2,1,2,3
C(C(C=O)C(C=O)C=O)=O,,,5,1,1,0,1
41168_0,,,,2,1,2,3
C(C(C=O)C(C(C=O)=O)CO)=O,,,5,1,1,0,1
41169_0,,,,2,1,2,3
41171_0,,,,2,1,2,3
C(C(C=O)C(C=O)C(CO)=O)=O,,,5,1,2,0,2
41172_0,,,,2,1,2,3
41173_0,,,,2,1,2,3
41174_0,,,,2,1,2,3
41176_0,,,,2,1,2,3
C(CO)(CC(C(C=O)=O)=O)=O,,,5,1,1,0,1
41177_0,,,,2,1,2,3
41179_0,,,,2,1,2,3
C(CO)(CC(C(C(C)=O)=O)=O)=O,,,5,1,1,0,1
41180_0,,,,2,1,2,3
41181_0,,,,2,1,2,3
41182_0,,,,2,1,2,3
41183_0,,,,2,1,2,3
41185_0,,,,2,1,2,3
C(CC(C(CC(CO)=O)=O)=O)=O,,,5,1,1,0,1
41187_0,,,,2,1,2,3
C(CC=O)(CC(C(CO)=O)=O)=O,,,5,1,1,0,1
41189_0,,,,2,1,2,3
C(C(C(C)=O)C(C(C=O)=O)O)=O,,,5,1,2,0,2
41191_0,,,,2,1,2,3
C(C)(C(C(C(C=O)=O)=O)CO)=O,,,5,1,1,0,1
41193_0,,,,2,1,2,3
C(CO)(C(C(C(C=O)=O)=O)C)=O,,,5,1,1,0,1
41194_0,,,,2,1,2,3
41196_0,,,,2,1,2,3
C(C(C(C(C=O)=O)=O)C(C)O)=O,,,5,1,1,0,1
41198_0,,,,2,1,2,3
C(C(CC(C(C(C)O)=O)=O)=O)=O,,,5,1,1,0,1
41200_0,,,,2,1,2,3
C(C(C)O)(CC(C(C=O)=O)=O)=O,,,5,1,1,0,1
41202_0,,,,2,1,2,3
C(C(C)C(C(C=O)=O)O)=O,,,5,1,2,0,2
41204_0,,,,2,1,2,3
C(C(C(C(C)CO)=O)=O)=O,,,5,1,1,0,1
41205_0,,,,2,1,2,3
41207_0,,,,2,1,2,3
C(C(C(C(CO)CCO)=O)=O)=O,,,5,1,1,0,1
41208_0,,,,2,1,2,3
41210_0,,,,2,1,2,3
C(CCCO)(C(C(C=O)=O)O)=O,,,5,1,1,0,1
41211_0,,,,2,1,2,3
41212_0,,,,2,1,2,3
41213_0,,,,2,1,2,3
41215_0,,,,2,1,2,3
C(CO)(C(C)C(C(C=O)=O)O)=O,,,5,1,1,0,1
41216_0,,,,2,1,2,3
41218_0,,,,2,1,2,3
C(C(C(C(C)C(CO)O)=O)=O)=O,,,5,1,1,0,1
41219_0,,,,2,1,2,3
41220_0,,,,2,1,2,3
41222_0,,,,2,1,2,3
C(C(C(C(C=O)=O)=O)C)(O)=O,,,5,1,1,0,1
41223_0,,,,2,1,2,3
41225_0,,,,2,1,2,3
C(CCC(C(C=O)=O)=O)(O)=O,,,5,1,1,0,1
41227_0,,,,2,1,2,3
C1(COCC1C(C(C=O)=O)O)=O,,,5,1,1,0,1
41229_0,,,,2,1,2,3
C(C(C(C1COCC1O)=O)=O)=O,,,5,1,1,0,1
41231_0,,,,2,1,2,3
C1(C(CCO1)C(C(C=O)=O)O)=O,,,5,1,1,0,1
41233_0,,,,2,1,2,3
C(C(C(C1C(O)OCC1)=O)=O)=O,,,5,1,1,0,1
41235_0,,,,2,1,2,3
C(C(C(C1COC(C1)O)=O)=O)=O,,,5,1,1,0,1
41237_0,,,,2,1,2,3
C(C(C=C)C(C(C=O)=O)=O)=O,,,5,1,1,0,1
41239_0,,,,2,1,2,3
C=CC(C(CC(C=O)=O)=O)=O,,,5,1,1,0,1
41241_0,,,,2,1,2,3
C=CC(CC(C(C=O)=O)=O)=O,,,5,1,1,0,1
41243_0,,,,2,1,2,3
C(C(CC(C=CC=O)=O)=O)=O,,,5,1,1,0,1
41245_0,,,,2,1,2,3
C(CC(C(C=O)=O)=O)=CC=O,,,5,1,1,0,1
41246_0,,,,2,1,2,3
41248_0,,,,2,1,2,3
C(CC(C(C=O)=O)=O)=O,,,5,1,1,0,1
41249_0,,,,2,1,2,3
41250_0,,,,2,1,2,3
41252_0,,,,2,1,2,3
C(C(C(C(C=O)=O)=O)C)=O,,,5,1,1,0,1
41253_0,,,,2,1,2,3
41254_0,,,,2,1,2,3
41255_0,,,,2,1,2,3
41256_0,,,,2,1,2,3
41258_0,,,,2,1,2,3
C(C(C(C(C=O)=O)=O)CCO)=O,,,5,1,1,0,1
41259_0,,,,2,1,2,3
41261_0,,,,2,1,2,3
C(CCO)(CC(C(C=O)=O)=O)=O,,,5,1,1,0,1
41263_0,,,,2,1,2,3
C(CC(CC(C(C=O)=O)O)=O)=O,,,5,1,1,0,1
41265_0,,,,2,1,2,3
C(CCC(C(C(C=O)=O)O)=O)=O,,,5,1,1,0,1
41266_0,,,,2,1,2,3
41267_0,,,,2,1,2,3
41268_0,,,,2,1,2,3
41270_0,,,,2,1,2,3
C(C(CCC(C(C=O)=O)=O)O)=O,,,5,1,1,0,1
41272_0,,,,2,1,2,3
C(CC(CO)=O)(CC(C=O)=O)=O,,,5,1,1,0,1
41274_0,,,,2,1,2,3
C(CO)(CCC(C(C=O)=O)=O)=O,,,5,1,1,0,1
41275_0,,,,2,1,2,3
41277_0,,,,2,1,2,3
C(CC(C(C(C=O)=O)=O)CO)=O,,,5,1,1,0,1
41279_0,,,,2,1,2,3
C(C(C(CC(C(C)=O)=O)O)=O)=O,,,5,1,1,0,1
41281_0,,,,2,1,2,3
C(C(C(C=O)=O)O)(CC(C)=O)=O,,,5,1,1,0,1
41283_0,,,,2,1,2,3
C(C(C(C)=O)O)(CC(C=O)=O)=O,,,5,1,1,0,1
41284_0,,,,2,1,2,3
41286_0,,,,2,1,2,3
C(C=O)(C(C)C(C(C=O)=O)O)=O,,,5,1,1,0,1
41288_0,,,,2,1,2,3
C(C(C(C(C(C=O)=O)=O)C)O)=O,,,5,1,1,0,1
41289_0,,,,2,1,2,3
41291_0,,,,2,1,2,3
C(C(C(CC)=O)=O)=O,,,5,1,1,0,1
41292_0,,,,2,1,2,3
41293_0,,,,2,1,2,3
41294_0,,,,2,1,2,3
41295_0,,,,2,1,2,3
41297_0,,,,2,1,2,3
C(C(C(CO)=O)CC(C=O)=O)=O,,,5,1,1,0,1
41298_0,,,,2,1,2,3
41299_0,,,,2,1,2,3
41300_0,,,,2,1,2,3
41301_0,,,,2,1,2,3
41302_0,,,,2,1,2,3
41303_0,,,,2,1,2,3
41304_0,,,,2,1,2,3
41305_0,,,,2,1,2,3
41306_0,,,,2,1,2,3
41307_0,,,,2,1,2,3
41308_0,,,,2,1,2,3
41309_0,,,,2,1,2,3
41310_0,,,,2,1,2,3
41311_0,,,,2,1,2,3
41312_0,,,,2,1,2,3
41313_0,,,,2,1,2,3
41314_0,,,,2,1,2,3
41315_0,,,,2,1,2,3
41317_0,,,,2,1,2,3
C(C(C(C)=O)CC(CO)=O)=O,,,5,1,3,0,3
41319_0,,,,2,1,2,3
C(C(C(C)=O)CC(C(O)=O)=O)=O,,,5,1,2,0,2
41320_0,,,,2,1,2,3
41321_0,,,,2,1,2,3
41322_0,,,,2,1,2,3
41324_0,,,,2,1,2,3
C(C(C(C)=O)CC(C=O)=O)=O,,,5,1,3,0,3
41326_0,,,,2,1,2,3
C(C(C=O)C(C=O)C(C)=O)=O,,,5,1,3,0,3
41327_0,,,,2,1,2,3
41328_0,,,,2,1,2,3
41329_0,,,,2,1,2,3
41331_0,,,,2,1,2,3
C(CO)(C(C(C(C)=O)=O)C)=O,,,5,1,1,0,1
41332_0,,,,2,1,2,3
41333_0,,,,2,1,2,3
41335_0,,,,2,1,2,3
C(C(C)C(C(C(C)=O)=O)O)=O,,,5,1,1,0,1
41337_0,,,,2,1,2,3
C(C(C(C)=O)=O)(C(C)CO)=O,,,5,1,1,0,1
41338_0,,,,2,1,2,3
41340_0,,,,2,1,2,3
C(CC(C(C(C)=O)=O)=O)(O)=O,,,5,1,1,0,1
41342_0,,,,2,1,2,3
C(C(C(C(C(C)=O)=O)=O)C)(O)=O,,,5,1,1,0,1
41343_0,,,,2,1,2,3
41345_0,,,,2,1,2,3
C(CCC(C(C(C)=O)=O)=O)(O)=O,,,5,1,1,0,1
41347_0,,,,2,1,2,3
C(C(C=C)C(C(C(C)=O)=O)=O)=O,,,5,1,1,0,1
41349_0,,,,2,1,2,3
C=CC(C(CC(C(C)=O)=O)=O)=O,,,5,1,1,0,1
41351_0,,,,2,1,2,3
C=CC(CC(C(C(C)=O)=O)=O)=O,,,5,1,1,0,1
41353_0,,,,2,1,2,3
C(C(C)=O)(CC(C=CC=O)=O)=O,,,5,1,1,0,1
41355_0,,,,2,1,2,3
C(CC(C(C(C)=O)=O)=O)=CC=O,,,5,1,1,0,1
41356_0,,,,2,1,2,3
41357_0,,,,2,1,2,3
41358_0,,,,2,1,2,3
41359_0,,,,2,1,2,3
41360_0,,,,2,1,2,3
41362_0,,,,2,1,2,3
C(C(C(C)=O)=O)(CC(CO)O)=O,,,5,1,1,0,1
41363_0,,,,2,1,2,3
41365_0,,,,2,1,2,3
C(CC(C(C(C)=O)=O)=O)=O,,,5,1,2,0,2
41366_0,,,,2,1,2,3
41368_0,,,,2,1,2,3
C(C(C(C)=O)=O)(C(CO)CO)=O,,,5,1,1,0,1
41370_0,,,,2,1,2,3
C(C(C(C(C(C)=O)=O)=O)C)=O,,,5,1,2,0,2
41372_0,,,,2,1,2,3
C(C(C)=O)(CC(C(C)=O)=O)=O,,,5,1,2,0,2
41374_0,,,,2,1,2,3
C(C)(CC(C(C(C)=O)=O)=O)=O,,,5,1,2,0,2
41375_0,,,,2,1,2,3
41377_0,,,,2,1,2,3
C(CCC(C(C(C)=O)=O)=O)=O,,,5,1,2,0,2
41379_0,,,,2,1,2,3
C(C)(CC(C(C)=O)=O)=O,,,5,1,3,0,3
41381_0,,,,2,1,2,3
C(C(C(C)=O)=O)(CC)=O,,,5,1,2,0,2
41382_0,,,,2,1,2,3
41384_0,,,,2,1,2,3
C(C(C(C)=O)=O)(C)=O,,,5,1,1,0,1
41385_0,,,,2,1,2,3
41386_0,,,,2,1,2,3
41387_0,,,,2,1,2,3
41389_0,,,,2,1,2,3
C(C(C(C)=O)=O)(CCO)=O,,,5,1,2,0,2
41391_0,,,,2,1,2,3
C(C(C)CC(C(CO)=O)=O)=O,,,5,1,1,0,1
41392_0,,,,2,1,2,3
41393_0,,,,2,1,2,3
41394_0,,,,2,1,2,3
41395_0,,,,2,1,2,3
41396_0,,,,2,1,2,3
41397_0,,,,2,1,2,3
41398_0,,,,2,1,2,3
41399_0,,,,2,1,2,3
41400_0,,,,2,1,2,3
41401_0,,,,2,1,2,3
41402_0,,,,2,1,2,3
41403_0,,,,2,1,2,3
41404_0,,,,2,1,2,3
41405_0,,,,2,1,2,3
41406_0,,,,2,1,2,3
41407_0,,,,2,1,2,3
41408_0,,,,2,1,2,3
41409_0,,,,2,1,2,3
41411_0,,,,2,1,2,3
C(C(C)O)(CC(C(C)=O)=O)=O,,,5,1,1,0,1
41413_0,,,,2,1,2,3
C(C)(CC(C(C(C)O)=O)=O)=O,,,5,1,1,0,1
41414_0,,,,2,1,2,3
41415_0,,,,2,1,2,3
41416_0,,,,2,1,2,3
41417_0,,,,2,1,2,3
41419_0,,,,2,1,2,3
C(C(C)=O)(C(C)CO)=O,,,5,1,1,0,1
41421_0,,,,2,1,2,3
C(C(C)C(C(C)=O)O)=O,,,5,1,1,0,1
41423_0,,,,2,1,2,3
C(C(C)CC(CO)=O)=O,,,5,1,1,0,1
41425_0,,,,2,1,2,3
C(C(CCO)=O)(C(C)CO)=O,,,5,1,1,0,1
41427_0,,,,2,1,2,3
C(C(C)C(C(CCO)=O)O)=O,,,5,1,1,0,1
41429_0,,,,2,1,2,3
C(C(C)C(C(CO)=O)CO)=O,,,5,1,1,0,1
41430_0,,,,2,1,2,3
41431_0,,,,2,1,2,3
41433_0,,,,2,1,2,3
C(C(C)CC(C(CO)O)=O)=O,,,5,1,1,0,1
41435_0,,,,2,1,2,3
C(C(C)CC(C(O)=O)=O)=O,,,5,1,1,0,1
41437_0,,,,2,1,2,3
C(C(C(O)=O)C(C=O)C)=O,,,5,1,1,0,1
41439_0,,,,2,1,2,3
C(C(C)C(C(C(O)=O)=O)CO)=O,,,5,1,1,0,1
41441_0,,,,2,1,2,3
C(C(C(C=O)C(C=O)C)O)(O)=O,,,5,1,2,0,2
41443_0,,,,2,1,2,3
C(C(C)C(C(O)=O)C(CO)=O)=O,,,5,1,1,0,1
41445_0,,,,2,1,2,3
C(CC(C(C(C)CO)=O)=O)(O)=O,,,5,1,1,0,1
41447_0,,,,2,1,2,3
C(C(C)C(C(CC(O)=O)=O)O)=O,,,5,1,1,0,1
41449_0,,,,2,1,2,3
C(C(C)CC(C(C(O)=O)O)=O)=O,,,5,1,1,0,1
41451_0,,,,2,1,2,3
C(C(C)C1C(C(CO1)O)=O)=O,,,5,1,1,0,1
41453_0,,,,2,1,2,3
C(C(C)C1C(C(O)OC1)=O)=O,,,5,1,1,0,1
41455_0,,,,2,1,2,3
C(C(C)C1C(COC1O)=O)=O,,,5,1,1,0,1
41457_0,,,,2,1,2,3
C(C(C)C1C(CC(O1)O)=O)=O,,,5,1,1,0,1
41458_0,,,,2,1,2,3
41460_0,,,,2,1,2,3
C(C(C)C(C(CO)=O)O)=O,,,5,1,1,0,1
41461_0,,,,2,1,2,3
41462_0,,,,2,1,2,3
41463_0,,,,2,1,2,3
41465_0,,,,2,1,2,3
C(C(C)C(C(C(CO)O)=O)O)=O,,,5,1,1,0,1
41467_0,,,,2,1,2,3
C(C(C)CC(C=O)=O)=O,,,5,1,1,0,1
41469_0,,,,2,1,2,3
C(C(C=O)C(C=O)C)=O,,,5,1,1,0,1
41471_0,,,,2,1,2,3
C(C(C)C(C(C=O)=O)CO)=O,,,5,1,2,0,2
41473_0,,,,2,1,2,3
C(C(C(C=O)C(C=O)C)O)=O,,,5,1,2,0,2
41475_0,,,,2,1,2,3
C(C(C)C(C=O)C(CO)=O)=O,,,5,1,1,0,1
41476_0,,,,2,1,2,3
41478_0,,,,2,1,2,3
C(C(C)C(C(CC=O)=O)O)=O,,,5,1,1,0,1
41480_0,,,,2,1,2,3
C(C(C)CC(C(C=O)O)=O)=O,,,5,1,1,0,1
41482_0,,,,2,1,2,3
C(C(C)CC=O)=O,,,5,1,1,0,1
41483_0,,,,2,1,2,3
41485_0,,,,2,1,2,3
C(C(C)C(C=O)O)=O,,,5,1,3,0,3
41486_0,,,,2,1,2,3
41488_0,,,,2,1,2,3
C(C(C)=O)(C(CO)CCO)=O,,,5,1,1,0,1
41490_0,,,,2,1,2,3
C(CC(C(C)=O)O)(CCO)=O,,,5,1,1,0,1
41492_0,,,,2,1,2,3
C(CCCO)(C(C(C)=O)O)=O,,,5,1,1,0,1
41494_0,,,,2,1,2,3
C(C(CCO)O)(CC(C)=O)=O,,,5,1,1,0,1
41495_0,,,,2,1,2,3
41496_0,,,,2,1,2,3
41498_0,,,,2,1,2,3
C(CO)(C(C)C(C(C)=O)O)=O,,,5,1,1,0,1
41499_0,,,,2,1,2,3
41501_0,,,,2,1,2,3
C(C(C)=O)(C(C)C(CO)O)=O,,,5,1,1,0,1
41503_0,,,,2,1,2,3
C(C(C(C(C)=O)=O)C)(O)=O,,,5,1,1,0,1
41504_0,,,,2,1,2,3
41505_0,,,,2,1,2,3
41507_0,,,,2,1,2,3
C(C(C(C(C)=O)=O)CCO)(O)=O,,,5,1,1,0,1
41508_0,,,,2,1,2,3
41509_0,,,,2,1,2,3
41510_0,,,,2,1,2,3
41512_0,,,,2,1,2,3
C(CCC(C(C(C)=O)O)=O)(O)=O,,,5,1,1,0,1
41514_0,,,,2,1,2,3
C(CC(C(CC(C)=O)=O)O)(O)=O,,,5,1,1,0,1
41515_0,,,,2,1,2,3
41516_0,,,,2,1,2,3
41518_0,,,,2,1,2,3
C(CC(C(C(C)=O)=O)CO)(O)=O,,,5,1,1,0,1
41519_0,,,,2,1,2,3
41521_0,,,,2,1,2,3
C(C(C(C(C(C)=O)=O)C)O)(O)=O,,,5,1,1,0,1
41523_0,,,,2,1,2,3
C1(COCC1C(C(C)=O)O)=O,,,5,1,1,0,1
41525_0,,,,2,1,2,3
C(C(C)=O)(C1COCC1O)=O,,,5,1,1,0,1
41527_0,,,,2,1,2,3
C1(C(CCO1)C(C(C)=O)O)=O,,,5,1,1,0,1
41529_0,,,,2,1,2,3
C(C(C)=O)(C1C(O)OCC1)=O,,,5,1,1,0,1
41531_0,,,,2,1,2,3
C(C(C)=O)(C1COC(C1)O)=O,,,5,1,1,0,1
41533_0,,,,2,1,2,3
C(C(C=C)C(C(C)=O)=O)=O,,,5,1,1,0,1
41535_0,,,,2,1,2,3
C(C)(CC(C(C=C)=O)=O)=O,,,5,1,1,0,1
41537_0,,,,2,1,2,3
C=CC(CC(C(C)=O)=O)=O,,,5,1,1,0,1
41539_0,,,,2,1,2,3
C(C)(CC(C=CC=O)=O)=O,,,5,1,1,0,1
41541_0,,,,2,1,2,3
C(CC(C(C)=O)=O)=CC=O,,,5,1,1,0,1
41542_0,,,,2,1,2,3
41543_0,,,,2,1,2,3
41544_0,,,,2,1,2,3
41545_0,,,,2,1,2,3
41546_0,,,,2,1,2,3
41547_0,,,,2,1,2,3
41548_0,,,,2,1,2,3
41549_0,,,,2,1,2,3
41551_0,,,,2,1,2,3
C(CC(CO)O)(C(C(C)=O)O)=O,,,5,1,1,0,1
41552_0,,,,2,1,2,3
41553_0,,,,2,1,2,3
41554_0,,,,2,1,2,3
41555_0,,,,2,1,2,3
41556_0,,,,2,1,2,3
41557_0,,,,2,1,2,3
41558_0,,,,2,1,2,3
41559_0,,,,2,1,2,3
41560_0,,,,2,1,2,3
41561_0,,,,2,1,2,3
41562_0,,,,2,1,2,3
41563_0,,,,2,1,2,3
41564_0,,,,2,1,2,3
41565_0,,,,2,1,2,3
41566_0,,,,2,1,2,3
41567_0,,,,2,1,2,3
41569_0,,,,2,1,2,3
C(C(C(C(C)=O)=O)C)=O,,,5,1,1,0,1
41570_0,,,,2,1,2,3
41571_0,,,,2,1,2,3
41572_0,,,,2,1,2,3
41573_0,,,,2,1,2,3
41575_0,,,,2,1,2,3
C(C(CC(CC(C)=O)=O)O)=O,,,5,1,2,0,2
41577_0,,,,2,1,2,3
C(C(CCC(C(C)=O)=O)O)=O,,,5,1,1,0,1
41578_0,,,,2,1,2,3
41579_0,,,,2,1,2,3
41580_0,,,,2,1,2,3
41581_0,,,,2,1,2,3
41582_0,,,,2,1,2,3
41584_0,,,,2,1,2,3
C(C(C(C)=O)O)(CC(C)=O)=O,,,5,1,1,0,1
41585_0,,,,2,1,2,3
41587_0,,,,2,1,2,3
C(C(C(C(C(C)=O)=O)C)O)=O,,,5,1,1,0,1
41589_0,,,,2,1,2,3
C(C)(CC(C)=O)=O,,,5,1,1,0,1
41591_0,,,,2,1,2,3
C(C(C)=O)(CC)=O,,,5,1,1,0,1
41592_0,,,,2,1,2,3
41593_0,,,,2,1,2,3
41594_0,,,,2,1,2,3
41595_0,,,,2,1,2,3
41596_0,,,,2,1,2,3
41598_0,,,,2,1,2,3
C(CCC(CCO)=O)(CO)=O,,,5,1,1,0,1
41600_0,,,,2,1,2,3
C(CCCO)(CC(CO)=O)=O,,,5,1,1,0,1
41601_0,,,,2,1,2,3
41603_0,,,,2,1,2,3
C(CO)(C(C)CC(CO)=O)=O,,,5,1,1,0,1
41604_0,,,,2,1,2,3
41606_0,,,,2,1,2,3
C(CC(CCC(CO)=O)=O)(O)=O,,,5,1,1,0,1
41608_0,,,,2,1,2,3
C(CCC(CC(CO)=O)=O)(O)=O,,,5,1,1,0,1
41609_0,,,,2,1,2,3
41611_0,,,,2,1,2,3
C(CC(C(C(O)=O)=O)C)(CO)=O,,,5,1,1,0,1
41613_0,,,,2,1,2,3
C(CC1C(COC1)=O)(CO)=O,,,5,1,1,0,1
41615_0,,,,2,1,2,3
C1(C(CCO1)CC(CO)=O)=O,,,5,1,1,0,1
41616_0,,,,2,1,2,3
41617_0,,,,2,1,2,3
41618_0,,,,2,1,2,3
41619_0,,,,2,1,2,3
41620_0,,,,2,1,2,3
41621_0,,,,2,1,2,3
41622_0,,,,2,1,2,3
41623_0,,,,2,1,2,3
41624_0,,,,2,1,2,3
41625_0,,,,2,1,2,3
41626_0,,,,2,1,2,3
41627_0,,,,2,1,2,3
41628_0,,,,2,1,2,3
41629_0,,,,2,1,2,3
41630_0,,,,2,1,2,3
41631_0,,,,2,1,2,3
41632_0,,,,2,1,2,3
41633_0,,,,2,1,2,3
41634_0,,,,2,1,2,3
41635_0,,,,2,1,2,3
41636_0,,,,2,1,2,3
41637_0,,,,2,1,2,3
41638_0,,,,2,1,2,3
41639_0,,,,2,1,2,3
41640_0,,,,2,1,2,3
41641_0,,,,2,1,2,3
41642_0,,,,2,1,2,3
41643_0,,,,2,1,2,3
41644_0,,,,2,1,2,3
41645_0,,,,2,1,2,3
41646_0,,,,2,1,2,3
41647_0,,,,2,1,2,3
41649_0,,,,2,1,2,3
C(C(C(C(CCO)=O)=O)C)(O)=O,,,5,1,1,0,1
41650_0,,,,2,1,2,3
41652_0,,,,2,1,2,3
C(CCC(C(CCO)=O)=O)(O)=O,,,5,1,1,0,1
41654_0,,,,2,1,2,3
C(C(C=C)C(C(CCO)=O)=O)=O,,,5,1,1,0,1
41656_0,,,,2,1,2,3
C(CCO)(CC(C(C=C)=O)=O)=O,,,5,1,1,0,1
41658_0,,,,2,1,2,3
C=CC(CC(C(CCO)=O)=O)=O,,,5,1,1,0,1
41660_0,,,,2,1,2,3
C(CCO)(CC(C=CC=O)=O)=O,,,5,1,1,0,1
41662_0,,,,2,1,2,3
C(CC(C(CCO)=O)=O)=CC=O,,,5,1,1,0,1
41663_0,,,,2,1,2,3
41664_0,,,,2,1,2,3
41665_0,,,,2,1,2,3
41666_0,,,,2,1,2,3
41667_0,,,,2,1,2,3
41668_0,,,,2,1,2,3
41669_0,,,,2,1,2,3
41670_0,,,,2,1,2,3
41671_0,,,,2,1,2,3
41672_0,,,,2,1,2,3
41673_0,,,,2,1,2,3
41674_0,,,,2,1,2,3
41675_0,,,,2,1,2,3
41676_0,,,,2,1,2,3
41677_0,,,,2,1,2,3
41678_0,,,,2,1,2,3
41679_0,,,,2,1,2,3
41680_0,,,,2,1,2,3
41681_0,,,,2,1,2,3
41682_0,,,,2,1,2,3
41683_0,,,,2,1,2,3
41684_0,,,,2,1,2,3
41685_0,,,,2,1,2,3
41686_0,,,,2,1,2,3
41688_0,,,,2,1,2,3
C(CCC(C(O)=O)=O)(CCO)=O,,,5,1,1,0,1
41690_0,,,,2,1,2,3
C(CCCO)(CC(C(O)=O)=O)=O,,,5,1,1,0,1
41692_0,,,,2,1,2,3
C(C(C=O)CC(CCO)=O)(O)=O,,,5,1,1,0,1
41694_0,,,,2,1,2,3
C(C(C=O)C(CCCO)=O)(O)=O,,,5,1,1,0,1
41695_0,,,,2,1,2,3
41696_0,,,,2,1,2,3
41697_0,,,,2,1,2,3
41698_0,,,,2,1,2,3
41699_0,,,,2,1,2,3
41700_0,,,,2,1,2,3
41701_0,,,,2,1,2,3
41702_0,,,,2,1,2,3
41703_0,,,,2,1,2,3
41704_0,,,,2,1,2,3
41705_0,,,,2,1,2,3
41706_0,,,,2,1,2,3
41707_0,,,,2,1,2,3
41708_0,,,,2,1,2,3
41709_0,,,,2,1,2,3
41711_0,,,,2,1,2,3
C(CO)(C(C)CC(C(O)=O)=O)=O,,,5,1,1,0,1
41712_0,,,,2,1,2,3
41713_0,,,,2,1,2,3
41715_0,,,,2,1,2,3
C(C(C=O)C(C(CO)=O)C)(O)=O,,,5,1,1,0,1
41716_0,,,,2,1,2,3
41717_0,,,,2,1,2,3
41718_0,,,,2,1,2,3
41719_0,,,,2,1,2,3
41720_0,,,,2,1,2,3
41721_0,,,,2,1,2,3
41722_0,,,,2,1,2,3
41723_0,,,,2,1,2,3
41724_0,,,,2,1,2,3
41725_0,,,,2,1,2,3
41726_0,,,,2,1,2,3
41727_0,,,,2,1,2,3
41728_0,,,,2,1,2,3
41729_0,,,,2,1,2,3
41730_0,,,,2,1,2,3
41731_0,,,,2,1,2,3
41732_0,,,,2,1,2,3
41733_0,,,,2,1,2,3
41734_0,,,,2,1,2,3
41735_0,,,,2,1,2,3
41736_0,,,,2,1,2,3
41737_0,,,,2,1,2,3
41738_0,,,,2,1,2,3
41739_0,,,,2,1,2,3
41740_0,,,,2,1,2,3
41741_0,,,,2,1,2,3
41742_0,,,,2,1,2,3
41743_0,,,,2,1,2,3
41744_0,,,,2,1,2,3
41745_0,,,,2,1,2,3
41746_0,,,,2,1,2,3
41747_0,,,,2,1,2,3
41748_0,,,,2,1,2,3
41749_0,,,,2,1,2,3
41750_0,,,,2,1,2,3
41751_0,,,,2,1,2,3
41752_0,,,,2,1,2,3
41753_0,,,,2,1,2,3
41754_0,,,,2,1,2,3
41755_0,,,,2,1,2,3
41756_0,,,,2,1,2,3
41757_0,,,,2,1,2,3
41758_0,,,,2,1,2,3
41759_0,,,,2,1,2,3
41760_0,,,,2,1,2,3
41761_0,,,,2,1,2,3
41762_0,,,,2,1,2,3
41763_0,,,,2,1,2,3
41764_0,,,,2,1,2,3
41765_0,,,,2,1,2,3
41766_0,,,,2,1,2,3
41767_0,,,,2,1,2,3
41768_0,,,,2,1,2,3
41769_0,,,,2,1,2,3
41770_0,,,,2,1,2,3
41771_0,,,,2,1,2,3
41772_0,,,,2,1,2,3
41773_0,,,,2,1,2,3
41774_0,,,,2,1,2,3
41775_0,,,,2,1,2,3
41777_0,,,,2,1,2,3
C1(COCC1CC(C(O)=O)=O)=O,,,5,1,1,0,1
41779_0,,,,2,1,2,3
C1(C(CCO1)CC(C(O)=O)=O)=O,,,5,1,1,0,1
41780_0,,,,2,1,2,3
41781_0,,,,2,1,2,3
41782_0,,,,2,1,2,3
41783_0,,,,2,1,2,3
41784_0,,,,2,1,2,3
41785_0,,,,2,1,2,3
41786_0,,,,2,1,2,3
41787_0,,,,2,1,2,3
41788_0,,,,2,1,2,3
41789_0,,,,2,1,2,3
41790_0,,,,2,1,2,3
41791_0,,,,2,1,2,3
41792_0,,,,2,1,2,3
41794_0,,,,2,1,2,3
C(C(C=O)C1C(COC1)=O)(O)=O,,,5,1,1,0,1
41796_0,,,,2,1,2,3
C(C(C(O)=O)C1C(OCC1)=O)=O,,,5,1,1,0,1
41797_0,,,,2,1,2,3
41798_0,,,,2,1,2,3
41799_0,,,,2,1,2,3
41800_0,,,,2,1,2,3
41801_0,,,,2,1,2,3
41802_0,,,,2,1,2,3
41803_0,,,,2,1,2,3
41804_0,,,,2,1,2,3
41805_0,,,,2,1,2,3
41806_0,,,,2,1,2,3
41807_0,,,,2,1,2,3
41808_0,,,,2,1,2,3
41809_0,,,,2,1,2,3
41810_0,,,,2,1,2,3
41811_0,,,,2,1,2,3
41812_0,,,,2,1,2,3
41813_0,,,,2,1,2,3
41814_0,,,,2,1,2,3
41815_0,,,,2,1,2,3
41816_0,,,,2,1,2,3
41817_0,,,,2,1,2,3
41818_0,,,,2,1,2,3
41819_0,,,,2,1,2,3
41820_0,,,,2,1,2,3
41821_0,,,,2,1,2,3
41822_0,,,,2,1,2,3
41823_0,,,,2,1,2,3
41824_0,,,,2,1,2,3
41825_0,,,,2,1,2,3
41826_0,,,,2,1,2,3
41827_0,,,,2,1,2,3
41828_0,,,,2,1,2,3
41829_0,,,,2,1,2,3
41830_0,,,,2,1,2,3
41831_0,,,,2,1,2,3
41832_0,,,,2,1,2,3
41833_0,,,,2,1,2,3
41834_0,,,,2,1,2,3
41835_0,,,,2,1,2,3
41836_0,,,,2,1,2,3
41837_0,,,,2,1,2,3
41838_0,,,,2,1,2,3
41839_0,,,,2,1,2,3
41840_0,,,,2,1,2,3
41841_0,,,,2,1,2,3
41842_0,,,,2,1,2,3
41843_0,,,,2,1,2,3
41844_0,,,,2,1,2,3
41845_0,,,,2,1,2,3
41846_0,,,,2,1,2,3
41847_0,,,,2,1,2,3
41848_0,,,,2,1,2,3
41849_0,,,,2,1,2,3
41850_0,,,,2,1,2,3
41851_0,,,,2,1,2,3
41852_0,,,,2,1,2,3
41853_0,,,,2,1,2,3
41854_0,,,,2,1,2,3
41855_0,,,,2,1,2,3
41856_0,,,,2,1,2,3
41857_0,,,,2,1,2,3
41858_0,,,,2,1,2,3
41859_0,,,,2,1,2,3
41860_0,,,,2,1,2,3
41861_0,,,,2,1,2,3
41862_0,,,,2,1,2,3
41863_0,,,,2,1,2,3
41864_0,,,,2,1,2,3
41865_0,,,,2,1,2,3
41866_0,,,,2,1,2,3
41867_0,,,,2,1,2,3
41868_0,,,,2,1,2,3
41869_0,,,,2,1,2,3
41870_0,,,,2,1,2,3
41871_0,,,,2,1,2,3
41872_0,,,,2,1,2,3
41873_0,,,,2,1,2,3
41874_0,,,,2,1,2,3
41875_0,,,,2,1,2,3
41876_0,,,,2,1,2,3
41877_0,,,,2,1,2,3
41878_0,,,,2,1,2,3
41879_0,,,,2,1,2,3
41880_0,,,,2,1,2,3
41881_0,,,,2,1,2,3
41882_0,,,,2,1,2,3
41883_0,,,,2,1,2,3
41884_0,,,,2,1,2,3
41885_0,,,,2,1,2,3
41886_0,,,,2,1,2,3
41887_0,,,,2,1,2,3
41888_0,,,,2,1,2,3
41889_0,,,,2,1,2,3
41890_0,,,,2,1,2,3
41891_0,,,,2,1,2,3
41892_0,,,,2,1,2,3
41893_0,,,,2,1,2,3
41894_0,,,,2,1,2,3
41895_0,,,,2,1,2,3
41896_0,,,,2,1,2,3
41897_0,,,,2,1,2,3
41899_0,,,,2,1,2,3
C(C(C)C(C(O)=O)O)(CC=O)=O,,,5,1,1,0,1
41900_0,,,,2,1,2,3
41901_0,,,,2,1,2,3
41903_0,,,,2,1,2,3
C(C(C)CC=O)(C(C(O)=O)O)=O,,,5,1,1,0,1
41904_0,,,,2,1,2,3
41905_0,,,,2,1,2,3
41906_0,,,,2,1,2,3
41907_0,,,,2,1,2,3
41908_0,,,,2,1,2,3
41909_0,,,,2,1,2,3
41910_0,,,,2,1,2,3
41911_0,,,,2,1,2,3
41912_0,,,,2,1,2,3
41913_0,,,,2,1,2,3
41914_0,,,,2,1,2,3
41915_0,,,,2,1,2,3
41916_0,,,,2,1,2,3
41917_0,,,,2,1,2,3
41918_0,,,,2,1,2,3
41919_0,,,,2,1,2,3
41920_0,,,,2,1,2,3
41921_0,,,,2,1,2,3
41922_0,,,,2,1,2,3
41923_0,,,,2,1,2,3
41924_0,,,,2,1,2,3
41925_0,,,,2,1,2,3
41926_0,,,,2,1,2,3
41928_0,,,,2,1,2,3
C(C(CC(C(CC)=O)=O)O)=O,,,5,1,1,0,1
41929_0,,,,2,1,2,3
41930_0,,,,2,1,2,3
41931_0,,,,2,1,2,3
41932_0,,,,2,1,2,3
41933_0,,,,2,1,2,3
41934_0,,,,2,1,2,3
41935_0,,,,2,1,2,3
41936_0,,,,2,1,2,3
41937_0,,,,2,1,2,3
41938_0,,,,2,1,2,3
41939_0,,,,2,1,2,3
41940_0,,,,2,1,2,3
41941_0,,,,2,1,2,3
41943_0,,,,2,1,2,3
C(C(CC(C(CC)=O)=O)O)(O)=O,,,5,1,1,0,1
41945_0,,,,2,1,2,3
C(CC(C(CO)=O)CC=O)(O)=O,,,5,1,3,0,3
41946_0,,,,2,1,2,3
41947_0,,,,2,1,2,3
41948_0,,,,2,1,2,3
41949_0,,,,2,1,2,3
41950_0,,,,2,1,2,3
41951_0,,,,2,1,2,3
41953_0,,,,2,1,2,3
C(CC(C(C(O)=O)=O)CCO)=O,,,5,1,1,0,1
41955_0,,,,2,1,2,3
C(C(CO)=O)(C1COCC1O)=O,,,5,1,1,0,1
41957_0,,,,2,1,2,3
C1(COCC1C(C(CO)=O)O)=O,,,5,1,1,0,1
41959_0,,,,2,1,2,3
C1(COCC1CC(C=O)=O)=O,,,5,1,1,0,1
41961_0,,,,2,1,2,3
C(C(C=O)C1C(COC1)=O)=O,,,5,1,1,0,1
41963_0,,,,2,1,2,3
C1(COCC1CC=O)=O,,,5,1,1,0,1
41965_0,,,,2,1,2,3
C(C(C1COCC1O)=O)=O,,,5,1,1,0,1
41967_0,,,,2,1,2,3
C1(COCC1C(C=O)O)=O,,,5,1,1,0,1
41969_0,,,,2,1,2,3
C(CC1C(C(CO1)O)=O)(CO)=O,,,5,1,1,0,1
41970_0,,,,2,1,2,3
41972_0,,,,2,1,2,3
C(CCO)(C1C(C(CO1)O)=O)=O,,,5,1,1,0,1
41973_0,,,,2,1,2,3
41975_0,,,,2,1,2,3
C(C(CO)C1C(C(CO1)O)=O)=O,,,5,1,1,0,1
41977_0,,,,2,1,2,3
C(CC1C(C(CO1)O)=O)=O,,,5,1,2,0,2
41979_0,,,,2,1,2,3
C1(C(COC1C(C)=O)O)=O,,,5,1,1,0,1
41981_0,,,,2,1,2,3
C(C(CO)=O)(C1C(O)OCC1)=O,,,5,1,2,0,2
41983_0,,,,2,1,2,3
C1(C(CCO1)C(C(CO)=O)O)=O,,,5,1,1,0,1
41985_0,,,,2,1,2,3
C1(C(CCO1)CC(C=O)=O)=O,,,5,1,1,0,1
41987_0,,,,2,1,2,3
C(C(C=O)C1C(OCC1)=O)=O,,,5,1,1,0,1
41989_0,,,,2,1,2,3
C(CC1C(OCC1)=O)=O,,,5,1,1,0,1
41991_0,,,,2,1,2,3
C(C(C1C(O)OCC1)=O)=O,,,5,1,2,0,2
41993_0,,,,2,1,2,3
C1(C(CCO1)C(C=O)O)=O,,,5,1,1,0,1
41995_0,,,,2,1,2,3
C(CC1C(C(O)OC1)=O)(CO)=O,,,5,1,2,0,2
41996_0,,,,2,1,2,3
41998_0,,,,2,1,2,3
C(CCO)(C1C(C(O)OC1)=O)=O,,,5,1,2,0,2
41999_0,,,,2,1,2,3
42001_0,,,,2,1,2,3
C(C(CO)C1C(C(O)OC1)=O)=O,,,5,1,2,0,2
42003_0,,,,2,1,2,3
C(CC1C(C(O)OC1)=O)=O,,,5,1,3,0,3
42005_0,,,,2,1,2,3
C(C)(C1C(C(O)OC1)=O)=O,,,5,1,2,0,2
42007_0,,,,2,1,2,3
C(C(CO)=O)(C1COC(C1)O)=O,,,5,1,2,0,2
42009_0,,,,2,1,2,3
C(C(C1COC(C1)O)=O)=O,,,5,1,2,0,2
42011_0,,,,2,1,2,3
C(CC1C(COC1O)=O)(CO)=O,,,5,1,2,0,2
42012_0,,,,2,1,2,3
42014_0,,,,2,1,2,3
C(CCO)(C1C(COC1O)=O)=O,,,5,1,2,0,2
42015_0,,,,2,1,2,3
42017_0,,,,2,1,2,3
C(C(CO)C1C(COC1O)=O)=O,,,5,1,2,0,2
42019_0,,,,2,1,2,3
C1(COC(C1CC=O)O)=O,,,5,1,3,0,3
42021_0,,,,2,1,2,3
C(C)(C1C(COC1O)=O)=O,,,5,1,3,0,3
42023_0,,,,2,1,2,3
C(CC1C(CC(O1)O)=O)(CO)=O,,,5,1,2,0,2
42024_0,,,,2,1,2,3
42026_0,,,,2,1,2,3
C(CCO)(C1C(CC(O1)O)=O)=O,,,5,1,2,0,2
42027_0,,,,2,1,2,3
42029_0,,,,2,1,2,3
C(C(CO)C1C(CC(O1)O)=O)=O,,,5,1,2,0,2
42031_0,,,,2,1,2,3
C(CC1C(CC(O1)O)=O)=O,,,5,1,3,0,3
42033_0,,,,2,1,2,3
C1(CC(OC1C(C)=O)O)=O,,,5,1,3,0,3
42035_0,,,,2,1,2,3
C(C(C=C)C(C(CO)=O)=O)=O,,,5,1,2,0,2
42037_0,,,,2,1,2,3
C(C(C=C)C(C(CC=O)=O)=O)=O,,,5,1,1,0,1
42039_0,,,,2,1,2,3
C(C(C=C)C(C=O)=O)=O,,,5,1,2,0,2
42041_0,,,,2,1,2,3
C=CC(CC(C(CO)=O)=O)=O,,,5,1,2,0,2
42043_0,,,,2,1,2,3
C(CO)(CC(C(C=C)=O)=O)=O,,,5,1,2,0,2
42045_0,,,,2,1,2,3
C(CC(C(CC(C=C)=O)=O)=O)=O,,,5,1,1,0,1
42047_0,,,,2,1,2,3
C(CC(CC(C(C=C)=O)=O)=O)=O,,,5,1,1,0,1
42049_0,,,,2,1,2,3
C=CC(CC(C=O)=O)=O,,,5,1,3,0,3
42051_0,,,,2,1,2,3
C(CC(C(C=C)=O)=O)=O,,,5,1,2,0,2
42052_0,,,,2,1,2,3
42054_0,,,,2,1,2,3
C(CO)(CC(C=CC=O)=O)=O,,,5,1,3,0,3
42056_0,,,,2,1,2,3
C(CC(C(CC=CC=O)=O)=O)=O,,,5,1,1,0,1
42058_0,,,,2,1,2,3
C(CC(CC(C=CC=O)=O)=O)=O,,,5,1,1,0,1
42059_0,,,,2,1,2,3
42061_0,,,,2,1,2,3
C(CC(C=CC=O)=O)=O,,,5,1,4,0,4
42062_0,,,,2,1,2,3
42063_0,,,,2,1,2,3
42064_0,,,,2,1,2,3
42065_0,,,,2,1,2,3
42066_0,,,,2,1,2,3
42067_0,,,,2,1,2,3
42068_0,,,,2,1,2,3
42069_0,,,,2,1,2,3
42070_0,,,,2,1,2,3
42071_0,,,,2,1,2,3
42072_0,,,,2,1,2,3
42073_0,,,,2,1,2,3
42075_0,,,,2,1,2,3
C(C(C(O)=O)C)=O,,,5,1,1,0,1
42076_0,,,,2,1,2,3
42077_0,,,,2,1,2,3
42078_0,,,,2,1,2,3
42079_0,,,,2,1,2,3
42080_0,,,,2,1,2,3
42081_0,,,,2,1,2,3
42082_0,,,,2,1,2,3
42083_0,,,,2,1,2,3
42084_0,,,,2,1,2,3
42085_0,,,,2,1,2,3
42086_0,,,,2,1,2,3
42087_0,,,,2,1,2,3
42088_0,,,,2,1,2,3
42089_0,,,,2,1,2,3
42090_0,,,,2,1,2,3
42091_0,,,,2,1,2,3
42092_0,,,,2,1,2,3
42093_0,,,,2,1,2,3
42094_0,,,,2,1,2,3
42095_0,,,,2,1,2,3
42096_0,,,,2,1,2,3
42097_0,,,,2,1,2,3
42098_0,,,,2,1,2,3
42099_0,,,,2,1,2,3
42100_0,,,,2,1,2,3
42101_0,,,,2,1,2,3
42102_0,,,,2,1,2,3
42103_0,,,,2,1,2,3
42104_0,,,,2,1,2,3
42105_0,,,,2,1,2,3
42106_0,,,,2,1,2,3
42107_0,,,,2,1,2,3
42108_0,,,,2,1,2,3
42109_0,,,,2,1,2,3
42110_0,,,,2,1,2,3
42111_0,,,,2,1,2,3
42112_0,,,,2,1,2,3
42113_0,,,,2,1,2,3
42114_0,,,,2,1,2,3
42115_0,,,,2,1,2,3
42116_0,,,,2,1,2,3
42117_0,,,,2,1,2,3
42118_0,,,,2,1,2,3
42119_0,,,,2,1,2,3
42120_0,,,,2,1,2,3
42121_0,,,,2,1,2,3
42122_0,,,,2,1,2,3
42123_0,,,,2,1,2,3
42124_0,,,,2,1,2,3
42126_0,,,,2,1,2,3
C(C(C(CC=O)=O)(C)O)=O,,,5,1,2,0,2
42127_0,,,,2,1,2,3
42128_0,,,,2,1,2,3
42129_0,,,,2,1,2,3
42130_0,,,,2,1,2,3
42131_0,,,,2,1,2,3
42132_0,,,,2,1,2,3
42134_0,,,,2,1,2,3
C(C(C(CC=O)=O)(CCO)O)=O,,,5,1,2,0,2
42135_0,,,,2,1,2,3
42136_0,,,,2,1,2,3
42137_0,,,,2,1,2,3
42138_0,,,,2,1,2,3
42139_0,,,,2,1,2,3
42140_0,,,,2,1,2,3
42141_0,,,,2,1,2,3
42142_0,,,,2,1,2,3
42143_0,,,,2,1,2,3
42144_0,,,,2,1,2,3
42145_0,,,,2,1,2,3
42146_0,,,,2,1,2,3
42147_0,,,,2,1,2,3
42148_0,,,,2,1,2,3
42149_0,,,,2,1,2,3
42150_0,,,,2,1,2,3
42151_0,,,,2,1,2,3
42152_0,,,,2,1,2,3
42153_0,,,,2,1,2,3
42154_0,,,,2,1,2,3
42155_0,,,,2,1,2,3
42156_0,,,,2,1,2,3
42157_0,,,,2,1,2,3
42158_0,,,,2,1,2,3
42159_0,,,,2,1,2,3
42161_0,,,,2,1,2,3
C(C(C(CC(CO)=O)=O)(C)O)=O,,,5,1,2,0,2
42162_0,,,,2,1,2,3
42163_0,,,,2,1,2,3
42164_0,,,,2,1,2,3
42165_0,,,,2,1,2,3
42166_0,,,,2,1,2,3
42167_0,,,,2,1,2,3
42168_0,,,,2,1,2,3
42169_0,,,,2,1,2,3
42170_0,,,,2,1,2,3
42171_0,,,,2,1,2,3
42172_0,,,,2,1,2,3
42173_0,,,,2,1,2,3
42174_0,,,,2,1,2,3
42175_0,,,,2,1,2,3
42176_0,,,,2,1,2,3
42177_0,,,,2,1,2,3
42178_0,,,,2,1,2,3
42179_0,,,,2,1,2,3
42180_0,,,,2,1,2,3
42181_0,,,,2,1,2,3
42182_0,,,,2,1,2,3
42183_0,,,,2,1,2,3
42184_0,,,,2,1,2,3
42185_0,,,,2,1,2,3
42186_0,,,,2,1,2,3
42187_0,,,,2,1,2,3
42188_0,,,,2,1,2,3
42189_0,,,,2,1,2,3
42190_0,,,,2,1,2,3
42191_0,,,,2,1,2,3
42192_0,,,,2,1,2,3
42193_0,,,,2,1,2,3
42194_0,,,,2,1,2,3
42195_0,,,,2,1,2,3
42196_0,,,,2,1,2,3
42197_0,,,,2,1,2,3
42198_0,,,,2,1,2,3
42199_0,,,,2,1,2,3
42200_0,,,,2,1,2,3
42201_0,,,,2,1,2,3
42202_0,,,,2,1,2,3
42203_0,,,,2,1,2,3
42204_0,,,,2,1,2,3
42205_0,,,,2,1,2,3
42206_0,,,,2,1,2,3
42207_0,,,,2,1,2,3
42208_0,,,,2,1,2,3
42209_0,,,,2,1,2,3
42210_0,,,,2,1,2,3
42211_0,,,,2,1,2,3
42212_0,,,,2,1,2,3
42213_0,,,,2,1,2,3
42214_0,,,,2,1,2,3
42215_0,,,,2,1,2,3
42216_0,,,,2,1,2,3
42217_0,,,,2,1,2,3
42218_0,,,,2,1,2,3
42219_0,,,,2,1,2,3
42220_0,,,,2,1,2,3
42221_0,,,,2,1,2,3
42222_0,,,,2,1,2,3
42223_0,,,,2,1,2,3
42224_0,,,,2,1,2,3
42225_0,,,,2,1,2,3
42226_0,,,,2,1,2,3
42227_0,,,,2,1,2,3
42228_0,,,,2,1,2,3
42229_0,,,,2,1,2,3
42230_0,,,,2,1,2,3
42231_0,,,,2,1,2,3
42232_0,,,,2,1,2,3
42233_0,,,,2,1,2,3
42234_0,,,,2,1,2,3
42235_0,,,,2,1,2,3
42236_0,,,,2,1,2,3
42237_0,,,,2,1,2,3
42238_0,,,,2,1,2,3
42239_0,,,,2,1,2,3
42240_0,,,,2,1,2,3
42241_0,,,,2,1,2,3
42242_0,,,,2,1,2,3
42243_0,,,,2,1,2,3
42244_0,,,,2,1,2,3
42245_0,,,,2,1,2,3
42246_0,,,,2,1,2,3
42247_0,,,,2,1,2,3
42248_0,,,,2,1,2,3
42249_0,,,,2,1,2,3
42250_0,,,,2,1,2,3
42251_0,,,,2,1,2,3
42252_0,,,,2,1,2,3
42253_0,,,,2,1,2,3
42254_0,,,,2,1,2,3
42255_0,,,,2,1,2,3
42256_0,,,,2,1,2,3
42257_0,,,,2,1,2,3
42258_0,,,,2,1,2,3
42259_0,,,,2,1,2,3
42260_0,,,,2,1,2,3
42261_0,,,,2,1,2,3
42262_0,,,,2,1,2,3
42263_0,,,,2,1,2,3
42264_0,,,,2,1,2,3
42265_0,,,,2,1,2,3
42266_0,,,,2,1,2,3
42267_0,,,,2,1,2,3
42268_0,,,,2,1,2,3
42269_0,,,,2,1,2,3
42270_0,,,,2,1,2,3
42271_0,,,,2,1,2,3
42272_0,,,,2,1,2,3
42273_0,,,,2,1,2,3
42274_0,,,,2,1,2,3
42275_0,,,,2,1,2,3
42276_0,,,,2,1,2,3
42277_0,,,,2,1,2,3
42278_0,,,,2,1,2,3
42279_0,,,,2,1,2,3
42280_0,,,,2,1,2,3
42281_0,,,,2,1,2,3
42282_0,,,,2,1,2,3
42283_0,,,,2,1,2,3
42284_0,,,,2,1,2,3
42285_0,,,,2,1,2,3
42286_0,,,,2,1,2,3
42287_0,,,,2,1,2,3
42288_0,,,,2,1,2,3
42289_0,,,,2,1,2,3
42290_0,,,,2,1,2,3
42292_0,,,,2,1,2,3
C(C(C)C(C(CO)=O)(CO)O)=O,,,5,1,1,0,1
42293_0,,,,2,1,2,3
42294_0,,,,2,1,2,3
42295_0,,,,2,1,2,3
42296_0,,,,2,1,2,3
42297_0,,,,2,1,2,3
42298_0,,,,2,1,2,3
42299_0,,,,2,1,2,3
42300_0,,,,2,1,2,3
42302_0,,,,2,1,2,3
C(C(C)C(C=O)(C(C)=O)O)=O,,,5,1,1,0,1
42303_0,,,,2,1,2,3
42304_0,,,,2,1,2,3
42306_0,,,,2,1,2,3
C(C(C)C(C=O)(CO)O)=O,,,5,1,1,0,1
42307_0,,,,2,1,2,3
42308_0,,,,2,1,2,3
42309_0,,,,2,1,2,3
42310_0,,,,2,1,2,3
42311_0,,,,2,1,2,3
42312_0,,,,2,1,2,3
42313_0,,,,2,1,2,3
42315_0,,,,2,1,2,3
C(C(C)C(C=O)(C(CO)O)O)=O,,,5,1,1,0,1
42316_0,,,,2,1,2,3
42317_0,,,,2,1,2,3
42318_0,,,,2,1,2,3
42319_0,,,,2,1,2,3
42320_0,,,,2,1,2,3
42321_0,,,,2,1,2,3
42322_0,,,,2,1,2,3
42323_0,,,,2,1,2,3
42324_0,,,,2,1,2,3
42325_0,,,,2,1,2,3
42326_0,,,,2,1,2,3
42327_0,,,,2,1,2,3
42328_0,,,,2,1,2,3
42329_0,,,,2,1,2,3
42330_0,,,,2,1,2,3
42331_0,,,,2,1,2,3
42332_0,,,,2,1,2,3
42333_0,,,,2,1,2,3
42334_0,,,,2,1,2,3
42335_0,,,,2,1,2,3
42336_0,,,,2,1,2,3
42337_0,,,,2,1,2,3
42338_0,,,,2,1,2,3
42339_0,,,,2,1,2,3
42340_0,,,,2,1,2,3
42341_0,,,,2,1,2,3
42342_0,,,,2,1,2,3
42343_0,,,,2,1,2,3
42344_0,,,,2,1,2,3
42345_0,,,,2,1,2,3
42346_0,,,,2,1,2,3
42347_0,,,,2,1,2,3
42348_0,,,,2,1,2,3
42349_0,,,,2,1,2,3
42350_0,,,,2,1,2,3
42351_0,,,,2,1,2,3
42352_0,,,,2,1,2,3
42353_0,,,,2,1,2,3
42354_0,,,,2,1,2,3
42355_0,,,,2,1,2,3
42356_0,,,,2,1,2,3
42357_0,,,,2,1,2,3
42358_0,,,,2,1,2,3
42359_0,,,,2,1,2,3
42360_0,,,,2,1,2,3
42361_0,,,,2,1,2,3
42362_0,,,,2,1,2,3
42363_0,,,,2,1,2,3
42364_0,,,,2,1,2,3
42365_0,,,,2,1,2,3
42366_0,,,,2,1,2,3
42367_0,,,,2,1,2,3
42368_0,,,,2,1,2,3
42369_0,,,,2,1,2,3
42370_0,,,,2,1,2,3
42371_0,,,,2,1,2,3
42372_0,,,,2,1,2,3
42373_0,,,,2,1,2,3
42374_0,,,,2,1,2,3
42375_0,,,,2,1,2,3
42376_0,,,,2,1,2,3
42377_0,,,,2,1,2,3
42378_0,,,,2,1,2,3
42379_0,,,,2,1,2,3
42380_0,,,,2,1,2,3
42381_0,,,,2,1,2,3
42382_0,,,,2,1,2,3
42383_0,,,,2,1,2,3
42384_0,,,,2,1,2,3
42385_0,,,,2,1,2,3
42386_0,,,,2,1,2,3
42387_0,,,,2,1,2,3
42388_0,,,,2,1,2,3
42389_0,,,,2,1,2,3
42390_0,,,,2,1,2,3
42391_0,,,,2,1,2,3
42392_0,,,,2,1,2,3
42393_0,,,,2,1,2,3
42394_0,,,,2,1,2,3
42395_0,,,,2,1,2,3
42396_0,,,,2,1,2,3
42397_0,,,,2,1,2,3
42398_0,,,,2,1,2,3
42399_0,,,,2,1,2,3
42400_0,,,,2,1,2,3
42401_0,,,,2,1,2,3
42402_0,,,,2,1,2,3
42403_0,,,,2,1,2,3
42404_0,,,,2,1,2,3
42405_0,,,,2,1,2,3
42406_0,,,,2,1,2,3
42407_0,,,,2,1,2,3
42408_0,,,,2,1,2,3
42409_0,,,,2,1,2,3
42410_0,,,,2,1,2,3
42411_0,,,,2,1,2,3
42412_0,,,,2,1,2,3
42413_0,,,,2,1,2,3
42414_0,,,,2,1,2,3
42415_0,,,,2,1,2,3
42416_0,,,,2,1,2,3
42417_0,,,,2,1,2,3
42418_0,,,,2,1,2,3
42419_0,,,,2,1,2,3
42420_0,,,,2,1,2,3
42421_0,,,,2,1,2,3
42422_0,,,,2,1,2,3
42423_0,,,,2,1,2,3
42424_0,,,,2,1,2,3
42425_0,,,,2,1,2,3
42426_0,,,,2,1,2,3
42427_0,,,,2,1,2,3
42428_0,,,,2,1,2,3
42429_0,,,,2,1,2,3
42430_0,,,,2,1,2,3
42431_0,,,,2,1,2,3
42432_0,,,,2,1,2,3
42433_0,,,,2,1,2,3
42434_0,,,,2,1,2,3
42435_0,,,,2,1,2,3
42436_0,,,,2,1,2,3
42437_0,,,,2,1,2,3
42438_0,,,,2,1,2,3
42439_0,,,,2,1,2,3
42440_0,,,,2,1,2,3
42441_0,,,,2,1,2,3
42442_0,,,,2,1,2,3
42443_0,,,,2,1,2,3
42444_0,,,,2,1,2,3
42445_0,,,,2,1,2,3
42446_0,,,,2,1,2,3
42447_0,,,,2,1,2,3
42448_0,,,,2,1,2,3
42449_0,,,,2,1,2,3
42450_0,,,,2,1,2,3
42451_0,,,,2,1,2,3
42452_0,,,,2,1,2,3
42453_0,,,,2,1,2,3
42454_0,,,,2,1,2,3
42455_0,,,,2,1,2,3
42456_0,,,,2,1,2,3
42457_0,,,,2,1,2,3
42458_0,,,,2,1,2,3
42459_0,,,,2,1,2,3
42460_0,,,,2,1,2,3
42461_0,,,,2,1,2,3
42462_0,,,,2,1,2,3
42463_0,,,,2,1,2,3
42464_0,,,,2,1,2,3
42465_0,,,,2,1,2,3
42466_0,,,,2,1,2,3
42467_0,,,,2,1,2,3
42468_0,,,,2,1,2,3
42469_0,,,,2,1,2,3
42470_0,,,,2,1,2,3
42471_0,,,,2,1,2,3
42472_0,,,,2,1,2,3
42473_0,,,,2,1,2,3
42474_0,,,,2,1,2,3
42475_0,,,,2,1,2,3
42476_0,,,,2,1,2,3
42477_0,,,,2,1,2,3
42478_0,,,,2,1,2,3
42479_0,,,,2,1,2,3
42480_0,,,,2,1,2,3
42481_0,,,,2,1,2,3
42482_0,,,,2,1,2,3
42483_0,,,,2,1,2,3
42484_0,,,,2,1,2,3
42485_0,,,,2,1,2,3
42486_0,,,,2,1,2,3
42487_0,,,,2,1,2,3
42488_0,,,,2,1,2,3
42489_0,,,,2,1,2,3
42490_0,,,,2,1,2,3
42491_0,,,,2,1,2,3
42492_0,,,,2,1,2,3
42493_0,,,,2,1,2,3
42494_0,,,,2,1,2,3
42495_0,,,,2,1,2,3
42496_0,,,,2,1,2,3
42497_0,,,,2,1,2,3
42498_0,,,,2,1,2,3
42499_0,,,,2,1,2,3
42500_0,,,,2,1,2,3
42501_0,,,,2,1,2,3
42502_0,,,,2,1,2,3
42504_0,,,,2,1,2,3
C1(CCC(C1(CO)O)=O)=O,,,5,1,1,0,1
42505_0,,,,2,1,2,3
42506_0,,,,2,1,2,3
42507_0,,,,2,1,2,3
42508_0,,,,2,1,2,3
42509_0,,,,2,1,2,3
42510_0,,,,2,1,2,3
42511_0,,,,2,1,2,3
42512_0,,,,2,1,2,3
42513_0,,,,2,1,2,3
42514_0,,,,2,1,2,3
42515_0,,,,2,1,2,3
42516_0,,,,2,1,2,3
42517_0,,,,2,1,2,3
42518_0,,,,2,1,2,3
42519_0,,,,2,1,2,3
42520_0,,,,2,1,2,3
42521_0,,,,2,1,2,3
42522_0,,,,2,1,2,3
42523_0,,,,2,1,2,3
42524_0,,,,2,1,2,3
42525_0,,,,2,1,2,3
42526_0,,,,2,1,2,3
42527_0,,,,2,1,2,3
42528_0,,,,2,1,2,3
42529_0,,,,2,1,2,3
42530_0,,,,2,1,2,3
42531_0,,,,2,1,2,3
42532_0,,,,2,1,2,3
42533_0,,,,2,1,2,3
42534_0,,,,2,1,2,3
42536_0,,,,2,1,2,3
C(C(C(C(C)=O)C(C)=O)O)=O,,,5,1,1,0,1
42537_0,,,,2,1,2,3
42538_0,,,,2,1,2,3
42540_0,,,,2,1,2,3
C(C(C(C(C)=O)(C(C)=O)O)O)=O,,,5,1,1,0,1
42541_0,,,,2,1,2,3
42542_0,,,,2,1,2,3
42543_0,,,,2,1,2,3
42544_0,,,,2,1,2,3
42546_0,,,,2,1,2,3
C(C(C=O)(C(C)O)C(C=O)C)=O,,,5,1,2,0,2
42547_0,,,,2,1,2,3
42548_0,,,,2,1,2,3
42549_0,,,,2,1,2,3
42550_0,,,,2,1,2,3
42551_0,,,,2,1,2,3
42552_0,,,,2,1,2,3
42554_0,,,,2,1,2,3
C(C(C=O)(CO)C(C=O)C=O)=O,,,5,1,1,0,1
42556_0,,,,2,1,2,3
C(C(C=O)(CO)C(C=O)C)=O,,,5,1,2,0,2
42557_0,,,,2,1,2,3
42558_0,,,,2,1,2,3
42559_0,,,,2,1,2,3
42560_0,,,,2,1,2,3
42561_0,,,,2,1,2,3
42562_0,,,,2,1,2,3
42563_0,,,,2,1,2,3
42564_0,,,,2,1,2,3
42565_0,,,,2,1,2,3
42566_0,,,,2,1,2,3
42567_0,,,,2,1,2,3
42568_0,,,,2,1,2,3
42569_0,,,,2,1,2,3
42570_0,,,,2,1,2,3
42571_0,,,,2,1,2,3
42572_0,,,,2,1,2,3
42573_0,,,,2,1,2,3
42574_0,,,,2,1,2,3
42575_0,,,,2,1,2,3
42576_0,,,,2,1,2,3
42577_0,,,,2,1,2,3
42578_0,,,,2,1,2,3
42579_0,,,,2,1,2,3
42581_0,,,,2,1,2,3
C(CC(C)O)(C(C(C)=O)CO)=O,,,5,1,1,0,1
42583_0,,,,2,1,2,3
C(CC(C)O)(C1C(COC1)=O)=O,,,5,1,1,0,1
42584_0,,,,2,1,2,3
42585_0,,,,2,1,2,3
42586_0,,,,2,1,2,3
42587_0,,,,2,1,2,3
42588_0,,,,2,1,2,3
42589_0,,,,2,1,2,3
42590_0,,,,2,1,2,3
42591_0,,,,2,1,2,3
42592_0,,,,2,1,2,3
42594_0,,,,2,1,2,3
C(C(C)C(C=O)(C(C)O)O)=O,,,5,1,1,0,1
42595_0,,,,2,1,2,3
42596_0,,,,2,1,2,3
42597_0,,,,2,1,2,3
42598_0,,,,2,1,2,3
42599_0,,,,2,1,2,3
42600_0,,,,2,1,2,3
42601_0,,,,2,1,2,3
42603_0,,,,2,1,2,3
C(C(C(C(C=C)=O)=O)C(C)O)=O,,,5,1,1,0,1
42604_0,,,,2,1,2,3
42606_0,,,,2,1,2,3
C(C(C(C=CC=O)=O)C(C)O)=O,,,5,1,1,0,1
42607_0,,,,2,1,2,3
42608_0,,,,2,1,2,3
42609_0,,,,2,1,2,3
42611_0,,,,2,1,2,3
C(C(CO)(CC(C(C)O)=O)O)=O,,,5,1,1,0,1
42612_0,,,,2,1,2,3
42613_0,,,,2,1,2,3
42614_0,,,,2,1,2,3
42615_0,,,,2,1,2,3
42616_0,,,,2,1,2,3
42617_0,,,,2,1,2,3
42618_0,,,,2,1,2,3
42620_0,,,,2,1,2,3
C(CCO)(C(C(C)=O)CO)=O,,,5,1,1,0,1
42622_0,,,,2,1,2,3
C(CCO)(C(C(O)=O)C(C)=O)=O,,,5,1,2,0,2
42623_0,,,,2,1,2,3
42625_0,,,,2,1,2,3
C(C(C(CCO)=O)C(C)O)(O)=O,,,5,1,1,0,1
42627_0,,,,2,1,2,3
C(CCO)(C1C(COC1)=O)=O,,,5,1,1,0,1
42628_0,,,,2,1,2,3
42630_0,,,,2,1,2,3
C1(C(C(CCO)=O)C(CO1)O)=O,,,5,1,2,0,2
42631_0,,,,2,1,2,3
42632_0,,,,2,1,2,3
42634_0,,,,2,1,2,3
C(C(C=O)C1(C(COC1)=O)O)=O,,,5,1,1,0,1
42636_0,,,,2,1,2,3
C(C(C=O)C1C(OCC1O)=O)=O,,,5,1,1,0,1
42637_0,,,,2,1,2,3
42638_0,,,,2,1,2,3
42639_0,,,,2,1,2,3
42640_0,,,,2,1,2,3
42642_0,,,,2,1,2,3
C1(COCC1C(C(CO)=O)=O)=O,,,5,1,1,0,1
42643_0,,,,2,1,2,3
42644_0,,,,2,1,2,3
42646_0,,,,2,1,2,3
C(C(C(C)=O)C(C(CO)=O)=O)=O,,,5,1,1,0,1
42648_0,,,,2,1,2,3
C(C(C)C(C(C=O)=O)(CO)O)=O,,,5,1,2,0,2
42649_0,,,,2,1,2,3
42650_0,,,,2,1,2,3
42651_0,,,,2,1,2,3
42652_0,,,,2,1,2,3
42653_0,,,,2,1,2,3
42654_0,,,,2,1,2,3
42655_0,,,,2,1,2,3
42656_0,,,,2,1,2,3
42657_0,,,,2,1,2,3
42658_0,,,,2,1,2,3
42659_0,,,,2,1,2,3
42660_0,,,,2,1,2,3
42661_0,,,,2,1,2,3
42662_0,,,,2,1,2,3
42663_0,,,,2,1,2,3
42664_0,,,,2,1,2,3
42665_0,,,,2,1,2,3
42667_0,,,,2,1,2,3
C(C(C)C(C(C)=O)(CO)O)=O,,,5,1,1,0,1
42669_0,,,,2,1,2,3
C(C(C(C(O)=O)C(C=O)C)O)=O,,,5,1,1,0,1
42671_0,,,,2,1,2,3
C(C(C)C(C(O)=O)(C(C)=O)O)=O,,,5,1,1,0,1
42672_0,,,,2,1,2,3
42674_0,,,,2,1,2,3
C(C(C)C(C(O)=O)(C(C)O)O)=O,,,5,1,1,0,1
42676_0,,,,2,1,2,3
C(C(C)C1(C(COC1)=O)O)=O,,,5,1,1,0,1
42678_0,,,,2,1,2,3
C1(C(C(CO1)O)C(C=O)C)=O,,,5,1,1,0,1
42679_0,,,,2,1,2,3
42681_0,,,,2,1,2,3
C(C(C)C1(C(OCC1O)=O)O)=O,,,5,1,1,0,1
42682_0,,,,2,1,2,3
42683_0,,,,2,1,2,3
42684_0,,,,2,1,2,3
42686_0,,,,2,1,2,3
C(CC(O)=O)(C(C(C)=O)CO)=O,,,5,1,2,0,2
42687_0,,,,2,1,2,3
42688_0,,,,2,1,2,3
42690_0,,,,2,1,2,3
C(C)(C(C(C(C=C)=O)=O)CO)=O,,,5,1,1,0,1
42691_0,,,,2,1,2,3
42693_0,,,,2,1,2,3
C(C)(C(C(C=CC=O)=O)CO)=O,,,5,1,1,0,1
42694_0,,,,2,1,2,3
42695_0,,,,2,1,2,3
42696_0,,,,2,1,2,3
42697_0,,,,2,1,2,3
42699_0,,,,2,1,2,3
C1(COCC1C(C(O)=O)=O)=O,,,5,1,1,0,1
42700_0,,,,2,1,2,3
42702_0,,,,2,1,2,3
C1(C(C(C(O)=O)=O)C(CO1)O)=O,,,5,1,1,0,1
42704_0,,,,2,1,2,3
C(CC(O)=O)(C1C(COC1)=O)=O,,,5,1,1,0,1
42705_0,,,,2,1,2,3
42706_0,,,,2,1,2,3
42707_0,,,,2,1,2,3
42708_0,,,,2,1,2,3
42709_0,,,,2,1,2,3
42710_0,,,,2,1,2,3
42711_0,,,,2,1,2,3
42713_0,,,,2,1,2,3
C(C(C(C(C)=O)C(C)=O)O)(O)=O,,,5,1,1,0,1
42714_0,,,,2,1,2,3
42715_0,,,,2,1,2,3
42716_0,,,,2,1,2,3
42717_0,,,,2,1,2,3
42718_0,,,,2,1,2,3
42719_0,,,,2,1,2,3
42720_0,,,,2,1,2,3
42721_0,,,,2,1,2,3
42722_0,,,,2,1,2,3
42723_0,,,,2,1,2,3
42724_0,,,,2,1,2,3
42725_0,,,,2,1,2,3
42727_0,,,,2,1,2,3
C1(COCC1C(C(C=C)=O)=O)=O,,,5,1,1,0,1
42729_0,,,,2,1,2,3
C1(COCC1C(C=CC=O)=O)=O,,,5,1,1,0,1
42731_0,,,,2,1,2,3
C(CC1(C(COC1)=O)O)(CO)=O,,,5,1,1,0,1
42732_0,,,,2,1,2,3
42734_0,,,,2,1,2,3
C(CCO)(C1(C(COC1)=O)O)=O,,,5,1,1,0,1
42736_0,,,,2,1,2,3
C(C(CO)O)(C1C(COC1)=O)=O,,,5,1,1,0,1
42737_0,,,,2,1,2,3
42739_0,,,,2,1,2,3
C1(COCC1C(C=O)=O)=O,,,5,1,2,0,2
42741_0,,,,2,1,2,3
C(C(CO)C1(C(COC1)=O)O)=O,,,5,1,1,0,1
42743_0,,,,2,1,2,3
C1(COCC1C(C(C)=O)=O)=O,,,5,1,1,0,1
42745_0,,,,2,1,2,3
C(CC=O)(C1C(COC1)=O)=O,,,5,1,1,0,1
42747_0,,,,2,1,2,3
C(C)(C1C(COC1)=O)=O,,,5,1,1,0,1
42749_0,,,,2,1,2,3
C(C1C(COC1)=O)=O,,,5,1,2,0,2
42751_0,,,,2,1,2,3
C1(COCC1(CC=O)O)=O,,,5,1,2,0,2
42753_0,,,,2,1,2,3
C(C)(C1(C(COC1)=O)O)=O,,,5,1,1,0,1
42755_0,,,,2,1,2,3
C(CO)(C1C(COC1)=O)=O,,,5,1,1,0,1
42756_0,,,,2,1,2,3
42758_0,,,,2,1,2,3
C(C(CO)(C1C(COC1)=O)O)=O,,,5,1,1,0,1
42759_0,,,,2,1,2,3
42761_0,,,,2,1,2,3
C1(C(CCO1)C(C=O)(CO)O)=O,,,5,1,1,0,1
42763_0,,,,2,1,2,3
C1(C(C(CO1)O)CC(CO)=O)=O,,,5,1,1,0,1
42764_0,,,,2,1,2,3
42765_0,,,,2,1,2,3
42766_0,,,,2,1,2,3
42768_0,,,,2,1,2,3
C1(C(C(CO1)O)C(C=O)CO)=O,,,5,1,1,0,1
42770_0,,,,2,1,2,3
C1(C(C(CO1)O)CC=O)=O,,,5,1,2,0,2
42772_0,,,,2,1,2,3
C1(C(C(C)=O)C(CO1)O)=O,,,5,1,4,0,4
42773_0,,,,2,1,2,3
42774_0,,,,2,1,2,3
42775_0,,,,2,1,2,3
42776_0,,,,2,1,2,3
42778_0,,,,2,1,2,3
C(C(C(C(C=C)=O)=O)CO)=O,,,5,1,2,0,2
42779_0,,,,2,1,2,3
42781_0,,,,2,1,2,3
C(C(C(C(C=C)=O)=O)CO)(O)=O,,,5,1,1,0,1
42783_0,,,,2,1,2,3
C(C(C(C)=O)C(C(C=C)=O)=O)=O,,,5,1,1,0,1
42784_0,,,,2,1,2,3
42786_0,,,,2,1,2,3
C(C(C(C=CC=O)=O)CO)=O,,,5,1,3,0,3
42787_0,,,,2,1,2,3
42788_0,,,,2,1,2,3
42790_0,,,,2,1,2,3
C(C(C(C)=O)C(C=CC=O)=O)=O,,,5,1,1,0,1
42791_0,,,,2,1,2,3
42792_0,,,,2,1,2,3
42793_0,,,,2,1,2,3
42794_0,,,,2,1,2,3
42795_0,,,,2,1,2,3
42797_0,,,,2,1,2,3
C1(C(C(CC=O)=O)C(CO1)O)=O,,,5,1,1,0,1
42798_0,,,,2,1,2,3
42799_0,,,,2,1,2,3
42800_0,,,,2,1,2,3
42801_0,,,,2,1,2,3
42802_0,,,,2,1,2,3
42804_0,,,,2,1,2,3
C1(C(C(CO1)O)(CC=O)O)=O,,,5,1,2,0,2
42806_0,,,,2,1,2,3
C1(C(C(C)=O)(C(CO1)O)O)=O,,,5,1,2,0,2
42807_0,,,,2,1,2,3
42808_0,,,,2,1,2,3
42810_0,,,,2,1,2,3
C1(C(C(C)=O)C(C(CO)O1)O)=O,,,5,1,2,0,2
42811_0,,,,2,1,2,3
42813_0,,,,2,1,2,3
C1(C(C=O)C(C(CO)O1)O)=O,,,5,1,2,0,2
42814_0,,,,2,1,2,3
42816_0,,,,2,1,2,3
C1(C(C(C)=O)C(C(CO1)O)O)=O,,,5,1,2,0,2
42817_0,,,,2,1,2,3
42818_0,,,,2,1,2,3
42819_0,,,,2,1,2,3
42821_0,,,,2,1,2,3
C1(C(C=O)C(C(CO1)O)O)=O,,,5,1,2,0,2
42822_0,,,,2,1,2,3
42823_0,,,,2,1,2,3
42824_0,,,,2,1,2,3
42826_0,,,,2,1,2,3
C(C1(CC(C(C1)=O)=O)O)=O,,,5,1,1,0,1
42827_0,,,,2,1,2,3
42828_0,,,,2,1,2,3
42829_0,,,,2,1,2,3
42830_0,,,,2,1,2,3
42831_0,,,,2,1,2,3
42832_0,,,,2,1,2,3
42834_0,,,,2,1,2,3
C(C)(C1(CC(C(C1)=O)=O)O)=O,,,5,1,1,0,1
42836_0,,,,2,1,2,3
C1(CC(CC1(C(C)=O)O)=O)=O,,,5,1,1,0,1
42838_0,,,,2,1,2,3
C1(C(C(CC1C(C)=O)=O)O)=O,,,5,1,1,0,1
42839_0,,,,2,1,2,3
42840_0,,,,2,1,2,3
42841_0,,,,2,1,2,3
42842_0,,,,2,1,2,3
42843_0,,,,2,1,2,3
42844_0,,,,2,1,2,3
42845_0,,,,2,1,2,3
42846_0,,,,2,1,2,3
42847_0,,,,2,1,2,3
42848_0,,,,2,1,2,3
42850_0,,,,2,1,2,3
C(C(C(C=O)=O)CC(C=O)=O)=O,,,5,1,1,0,1
42852_0,,,,2,1,2,3
C(C(C=O)C(C=O)C(C=O)=O)=O,,,5,1,1,0,1
42854_0,,,,2,1,2,3
C(C(C)(CCC(C(O)=O)=O)O)=O,,,5,1,2,0,2
42855_0,,,,2,1,2,3
42857_0,,,,2,1,2,3
C(C)(C(C(C)=O)CC(C=O)=O)=O,,,5,1,1,0,1
42859_0,,,,2,1,2,3
C(C(C=O)C(C(C)=O)C(C)=O)=O,,,5,1,1,0,1
42861_0,,,,2,1,2,3
C(C)(C(C(CCO)=O)CC=O)=O,,,5,1,2,0,2
42863_0,,,,2,1,2,3
C(CC(C(C)=O)(C(C=O)C)O)=O,,,5,1,1,0,1
42865_0,,,,2,1,2,3
C(CC(C(C)=O)C(C(O)=O)=O)=O,,,5,1,1,0,1
42867_0,,,,2,1,2,3
C(CC(C(C)=O)C(C=O)=O)=O,,,5,1,1,0,1
42869_0,,,,2,1,2,3
C(CC(C(C)=O)C(C(C)=O)=O)=O,,,5,1,1,0,1
42871_0,,,,2,1,2,3
C(CC=O)(C(C(C)=O)CC=O)=O,,,5,1,1,0,1
42873_0,,,,2,1,2,3
C(CC(C(C)=O)C(C)=O)=O,,,5,1,1,0,1
42874_0,,,,2,1,2,3
42876_0,,,,2,1,2,3
C(CC(C(C)=O)(C(C)=O)O)=O,,,5,1,1,0,1
42878_0,,,,2,1,2,3
C(CC(C(C)=O)C(CO)=O)=O,,,5,1,1,0,1
42879_0,,,,2,1,2,3
42880_0,,,,2,1,2,3
42882_0,,,,2,1,2,3
C(C(C(C(O)=O)=O)CC(C)O)=O,,,5,1,1,0,1
42884_0,,,,2,1,2,3
C(C(C(C(C=O)CO)=O)C)(O)=O,,,5,1,1,0,1
42885_0,,,,2,1,2,3
42886_0,,,,2,1,2,3
42888_0,,,,2,1,2,3
C(C(C(CC(C)O)=O)C)(O)=O,,,5,1,1,0,1
42890_0,,,,2,1,2,3
C(CC(C)O)(C(C(C=O)=O)C)=O,,,5,1,1,0,1
42892_0,,,,2,1,2,3
C(C(C(CC(C)O)=O)CCO)=O,,,5,1,1,0,1
42894_0,,,,2,1,2,3
C(CC(C)O)(C1C(CCO1)=O)=O,,,5,1,1,0,1
42895_0,,,,2,1,2,3
42896_0,,,,2,1,2,3
42897_0,,,,2,1,2,3
42899_0,,,,2,1,2,3
C(C(C)(CC(C(C)O)=O)O)(O)=O,,,5,1,1,0,1
42900_0,,,,2,1,2,3
42902_0,,,,2,1,2,3
C(C(C(C(C(C)O)O)=O)C)(O)=O,,,5,1,1,0,1
42904_0,,,,2,1,2,3
C(C(C(CC(C)O)=O)(C)O)(O)=O,,,5,1,1,0,1
42905_0,,,,2,1,2,3
42906_0,,,,2,1,2,3
42907_0,,,,2,1,2,3
42908_0,,,,2,1,2,3
42909_0,,,,2,1,2,3
42910_0,,,,2,1,2,3
42911_0,,,,2,1,2,3
42913_0,,,,2,1,2,3
C(C(C(CCO)=O)C)(O)=O,,,5,1,1,0,1
42915_0,,,,2,1,2,3
C(C(C(CCO)=O)CCO)(O)=O,,,5,1,1,0,1
42917_0,,,,2,1,2,3
C(CCO)(C(C(C=O)=O)C)=O,,,5,1,1,0,1
42919_0,,,,2,1,2,3
C(C(C(CCO)=O)CCO)=O,,,5,1,1,0,1
42921_0,,,,2,1,2,3
C(CCO)(C(C(O)=O)CC=O)=O,,,5,1,1,0,1
42923_0,,,,2,1,2,3
C(CCO)(C(C=O)CC(O)=O)=O,,,5,1,1,0,1
42925_0,,,,2,1,2,3
C(CCO)(C1C(CCO1)=O)=O,,,5,1,1,0,1
42926_0,,,,2,1,2,3
42927_0,,,,2,1,2,3
42929_0,,,,2,1,2,3
C(C(C(CC(CO)O)=O)C)(O)=O,,,5,1,1,0,1
42931_0,,,,2,1,2,3
C(C(C(C(C(C)O)=O)=O)C)(O)=O,,,5,1,1,0,1
42933_0,,,,2,1,2,3
C(C(C)C(C(O)=O)(C)O)=O,,,5,1,1,0,1
42934_0,,,,2,1,2,3
42936_0,,,,2,1,2,3
C(C(C)(CC(CCO)=O)O)(O)=O,,,5,1,1,0,1
42938_0,,,,2,1,2,3
C(C(C(CCCO)=O)(C)O)(O)=O,,,5,1,1,0,1
42940_0,,,,2,1,2,3
C(C(C(C(CCO)O)=O)C)(O)=O,,,5,1,1,0,1
42941_0,,,,2,1,2,3
42943_0,,,,2,1,2,3
C(C(C)(C(C(CO)=O)C)O)(O)=O,,,5,1,1,0,1
42944_0,,,,2,1,2,3
42946_0,,,,2,1,2,3
C(CC(O)=O)(C(C(O)=O)C)=O,,,5,1,1,0,1
42948_0,,,,2,1,2,3
C(C(C)(C1C(COC1)=O)O)(O)=O,,,5,1,1,0,1
42950_0,,,,2,1,2,3
C1(C(CCO1)C(C(O)=O)(C)O)=O,,,5,1,1,0,1
42952_0,,,,2,1,2,3
C(C(C(C(C=C)=O)=O)C)(O)=O,,,5,1,1,0,1
42954_0,,,,2,1,2,3
C(C(C(C=CC=O)=O)C)(O)=O,,,5,1,1,0,1
42955_0,,,,2,1,2,3
42956_0,,,,2,1,2,3
42958_0,,,,2,1,2,3
C(C(C(CCO)=O)(C)O)(O)=O,,,5,1,1,0,1
42960_0,,,,2,1,2,3
C(C(C(C(CO)O)=O)C)(O)=O,,,5,1,1,0,1
42961_0,,,,2,1,2,3
42962_0,,,,2,1,2,3
42964_0,,,,2,1,2,3
C(CC=O)(C(C(O)=O)C)=O,,,5,1,1,0,1
42965_0,,,,2,1,2,3
42967_0,,,,2,1,2,3
C(C(C(CCC=O)=O)(C)O)(O)=O,,,5,1,1,0,1
42969_0,,,,2,1,2,3
C(CC(C(C(C(O)=O)C)=O)O)=O,,,5,1,1,0,1
42971_0,,,,2,1,2,3
C(CC(C=O)O)(C(C(O)=O)C)=O,,,5,1,1,0,1
42973_0,,,,2,1,2,3
C(C(C(CC(CO)=O)=O)C)(O)=O,,,5,1,1,0,1
42974_0,,,,2,1,2,3
42975_0,,,,2,1,2,3
42977_0,,,,2,1,2,3
C(C(C(CC(C)=O)=O)(C)O)(O)=O,,,5,1,1,0,1
42979_0,,,,2,1,2,3
C(C(C(C(C(C)=O)O)=O)C)(O)=O,,,5,1,1,0,1
42980_0,,,,2,1,2,3
42982_0,,,,2,1,2,3
C(C)(C(C(O)=O)C)=O,,,5,1,1,0,1
42983_0,,,,2,1,2,3
42984_0,,,,2,1,2,3
42986_0,,,,2,1,2,3
C(C(C(CO)=O)C)(O)=O,,,5,1,1,0,1
42988_0,,,,2,1,2,3
C(C(C)C(C(O)=O)(CCO)O)=O,,,5,1,1,0,1
42990_0,,,,2,1,2,3
C(C(C(CC=O)=O)CCO)(O)=O,,,5,1,1,0,1
42992_0,,,,2,1,2,3
C(C(C(C)=O)CCO)(O)=O,,,5,1,1,0,1
42994_0,,,,2,1,2,3
C(C(C=O)CCO)(O)=O,,,5,1,1,0,1
42995_0,,,,2,1,2,3
42996_0,,,,2,1,2,3
42998_0,,,,2,1,2,3
C(C(C(CO)=O)CCO)(O)=O,,,5,1,1,0,1
42999_0,,,,2,1,2,3
43001_0,,,,2,1,2,3
C(C(C=O)C1(C(CCO1)=O)O)=O,,,5,1,1,0,1
43003_0,,,,2,1,2,3
C(C(C(C(C(CO)=O)=O)C)=O)=O,,,5,1,1,0,1
43005_0,,,,2,1,2,3
C1(CCOC1C(C(CO)=O)=O)=O,,,5,1,1,0,1
43006_0,,,,2,1,2,3
43008_0,,,,2,1,2,3
C(C(C)C(C(C=O)=O)(C)O)=O,,,5,1,1,0,1
43010_0,,,,2,1,2,3
C(C(C(C(C(O)=O)=O)C)=O)=O,,,5,1,1,0,1
43012_0,,,,2,1,2,3
C(CC(O)=O)(C(C(C=O)=O)C)=O,,,5,1,1,0,1
43014_0,,,,2,1,2,3
C=CC(C(C(C(C=O)=O)C)=O)=O,,,5,1,1,0,1
43016_0,,,,2,1,2,3
C(C(C(C(C=CC=O)=O)C)=O)=O,,,5,1,1,0,1
43017_0,,,,2,1,2,3
43018_0,,,,2,1,2,3
43020_0,,,,2,1,2,3
C(CCO)(C(C(C=O)=O)(C)O)=O,,,5,1,1,0,1
43021_0,,,,2,1,2,3
43022_0,,,,2,1,2,3
43023_0,,,,2,1,2,3
43025_0,,,,2,1,2,3
C(C(C(C(C(C)=O)=O)C)=O)=O,,,5,1,1,0,1
43027_0,,,,2,1,2,3
C(CC=O)(C(C(C=O)=O)C)=O,,,5,1,1,0,1
43029_0,,,,2,1,2,3
C(C)(C(C(C=O)=O)C)=O,,,5,1,1,0,1
43030_0,,,,2,1,2,3
43031_0,,,,2,1,2,3
43033_0,,,,2,1,2,3
C(C)(C(C(C=O)=O)(C)O)=O,,,5,1,1,0,1
43034_0,,,,2,1,2,3
43036_0,,,,2,1,2,3
C(C(C)C(C=O)(CCO)O)=O,,,5,1,1,0,1
43037_0,,,,2,1,2,3
43039_0,,,,2,1,2,3
C(CC(C=O)(C(C=O)C)O)(O)=O,,,5,1,1,0,1
43041_0,,,,2,1,2,3
C(C(C)C1(C(CCO1)=O)O)=O,,,5,1,1,0,1
43043_0,,,,2,1,2,3
C(C(C(CC(O)=O)=O)CCO)=O,,,5,1,1,0,1
43045_0,,,,2,1,2,3
C(C(C(C(C=C)=O)=O)CCO)=O,,,5,1,1,0,1
43047_0,,,,2,1,2,3
C(C(C(C=CC=O)=O)CCO)=O,,,5,1,1,0,1
43048_0,,,,2,1,2,3
43050_0,,,,2,1,2,3
C(C(C(C(O)=O)=O)CC(O)=O)=O,,,5,1,1,0,1
43052_0,,,,2,1,2,3
C1(CCOC1C(C(O)=O)=O)=O,,,5,1,1,0,1
43054_0,,,,2,1,2,3
C(CC(C1C(CCO1)=O)=O)(O)=O,,,5,1,1,0,1
43056_0,,,,2,1,2,3
C(C(C(C=O)=O)CC(CO)=O)=O,,,5,1,1,0,1
43058_0,,,,2,1,2,3
C(C(C(C)=O)CC(CO)=O)(O)=O,,,5,1,1,0,1
43060_0,,,,2,1,2,3
C(C(C1COCC1O)=O)(O)=O,,,5,1,1,0,1
43062_0,,,,2,1,2,3
C1(COCC1C(C(O)=O)O)=O,,,5,1,1,0,1
43064_0,,,,2,1,2,3
C1(CCOC1C(C(C=C)=O)=O)=O,,,5,1,1,0,1
43066_0,,,,2,1,2,3
C1(CCOC1C(C=CC=O)=O)=O,,,5,1,1,0,1
43068_0,,,,2,1,2,3
C(CC1(C(CCO1)=O)O)(CO)=O,,,5,1,2,0,2
43069_0,,,,2,1,2,3
43071_0,,,,2,1,2,3
C(CCO)(C1(C(CCO1)=O)O)=O,,,5,1,1,0,1
43073_0,,,,2,1,2,3
C1(CCOC1C(C(CO)O)=O)=O,,,5,1,1,0,1
43074_0,,,,2,1,2,3
43076_0,,,,2,1,2,3
C1(CCOC1C(C=O)=O)=O,,,5,1,1,0,1
43078_0,,,,2,1,2,3
C(C(CO)C1(C(CCO1)=O)O)=O,,,5,1,2,0,2
43080_0,,,,2,1,2,3
C1(CCOC1C(C(C)=O)=O)=O,,,5,1,1,0,1
43082_0,,,,2,1,2,3
C(CC(C1C(CCO1)=O)=O)=O,,,5,1,1,0,1
43084_0,,,,2,1,2,3
C1(CCOC1C(C)=O)=O,,,5,1,1,0,1
43086_0,,,,2,1,2,3
C(C1C(CCO1)=O)=O,,,5,1,1,0,1
43088_0,,,,2,1,2,3
C(CC1(C(CCO1)=O)O)=O,,,5,1,3,0,3
43090_0,,,,2,1,2,3
C1(CCOC1(C(C)=O)O)=O,,,5,1,1,0,1
43092_0,,,,2,1,2,3
C1(CCOC1C(CO)=O)=O,,,5,1,1,0,1
43094_0,,,,2,1,2,3
C(C(C1C(O)OCC1)=O)(O)=O,,,5,1,2,0,2
43096_0,,,,2,1,2,3
C1(C(CCO1)C(C(O)=O)O)=O,,,5,1,1,0,1
43098_0,,,,2,1,2,3
C(C(C1COC(C1)O)=O)(O)=O,,,5,1,2,0,2
43100_0,,,,2,1,2,3
C(C(C=C)C(C(O)=O)=O)=O,,,5,1,2,0,2
43102_0,,,,2,1,2,3
C=CC(CC(C(O)=O)=O)=O,,,5,1,2,0,2
43104_0,,,,2,1,2,3
C(CC(C(C=C)=O)=O)(O)=O,,,5,1,2,0,2
43106_0,,,,2,1,2,3
C(C(C(C(C=C)=O)=O)CC=O)=O,,,5,1,1,0,1
43107_0,,,,2,1,2,3
43108_0,,,,2,1,2,3
43110_0,,,,2,1,2,3
C(C(C(C=CC=O)=O)CC=O)=O,,,5,1,1,0,1
43111_0,,,,2,1,2,3
43112_0,,,,2,1,2,3
43113_0,,,,2,1,2,3
43114_0,,,,2,1,2,3
43115_0,,,,2,1,2,3
43116_0,,,,2,1,2,3
43117_0,,,,2,1,2,3
43118_0,,,,2,1,2,3
43119_0,,,,2,1,2,3
43120_0,,,,2,1,2,3
43121_0,,,,2,1,2,3
43122_0,,,,2,1,2,3
43123_0,,,,2,1,2,3
43124_0,,,,2,1,2,3
43125_0,,,,2,1,2,3
43126_0,,,,2,1,2,3
43127_0,,,,2,1,2,3
43128_0,,,,2,1,2,3
43129_0,,,,2,1,2,3
43130_0,,,,2,1,2,3
43131_0,,,,2,1,2,3
43132_0,,,,2,1,2,3
43133_0,,,,2,1,2,3
43134_0,,,,2,1,2,3
43135_0,,,,2,1,2,3
43136_0,,,,2,1,2,3
43137_0,,,,2,1,2,3
43138_0,,,,2,1,2,3
43139_0,,,,2,1,2,3
43140_0,,,,2,1,2,3
43141_0,,,,2,1,2,3
43142_0,,,,2,1,2,3
43143_0,,,,2,1,2,3
43144_0,,,,2,1,2,3
43145_0,,,,2,1,2,3
43146_0,,,,2,1,2,3
43147_0,,,,2,1,2,3
43148_0,,,,2,1,2,3
43149_0,,,,2,1,2,3
43150_0,,,,2,1,2,3
43151_0,,,,2,1,2,3
43152_0,,,,2,1,2,3
43153_0,,,,2,1,2,3
43154_0,,,,2,1,2,3
43155_0,,,,2,1,2,3
43156_0,,,,2,1,2,3
43157_0,,,,2,1,2,3
43158_0,,,,2,1,2,3
43159_0,,,,2,1,2,3
43160_0,,,,2,1,2,3
43161_0,,,,2,1,2,3
43162_0,,,,2,1,2,3
43163_0,,,,2,1,2,3
43164_0,,,,2,1,2,3
43165_0,,,,2,1,2,3
43166_0,,,,2,1,2,3
43167_0,,,,2,1,2,3
43168_0,,,,2,1,2,3
43169_0,,,,2,1,2,3
43170_0,,,,2,1,2,3
43171_0,,,,2,1,2,3
43172_0,,,,2,1,2,3
43173_0,,,,2,1,2,3
43174_0,,,,2,1,2,3
43175_0,,,,2,1,2,3
43176_0,,,,2,1,2,3
43177_0,,,,2,1,2,3
43178_0,,,,2,1,2,3
43179_0,,,,2,1,2,3
43180_0,,,,2,1,2,3
43181_0,,,,2,1,2,3
43182_0,,,,2,1,2,3
43183_0,,,,2,1,2,3
43184_0,,,,2,1,2,3
43185_0,,,,2,1,2,3
43186_0,,,,2,1,2,3
43187_0,,,,2,1,2,3
43188_0,,,,2,1,2,3
43189_0,,,,2,1,2,3
43190_0,,,,2,1,2,3
43192_0,,,,2,1,2,3
C(CC1C(C(CO1)=O)O)=O,,,5,1,2,0,2
43194_0,,,,2,1,2,3
C1(COC(C(C)=O)C1O)=O,,,5,1,2,0,2
43195_0,,,,2,1,2,3
43196_0,,,,2,1,2,3
43198_0,,,,2,1,2,3
C1(CC(C(CC=O)O1)O)=O,,,5,1,3,0,3
43200_0,,,,2,1,2,3
C1(CC(C(C(C)=O)O1)O)=O,,,5,1,3,0,3
43201_0,,,,2,1,2,3
43202_0,,,,2,1,2,3
43203_0,,,,2,1,2,3
43204_0,,,,2,1,2,3
43205_0,,,,2,1,2,3
43206_0,,,,2,1,2,3
43207_0,,,,2,1,2,3
43208_0,,,,2,1,2,3
43209_0,,,,2,1,2,3
43210_0,,,,2,1,2,3
43211_0,,,,2,1,2,3
43212_0,,,,2,1,2,3
43214_0,,,,2,1,2,3
C1(COCC(C1)=O)=O,,,5,1,2,0,2
43216_0,,,,2,1,2,3
C1(C(COCC1)=O)=O,,,5,1,2,0,2
43218_0,,,,2,1,2,3
C1(CCC(CO1)=O)=O,,,5,1,2,0,2
43220_0,,,,2,1,2,3
C1(CCOC(C1)=O)=O,,,5,1,2,0,2
43221_0,,,,2,1,2,3
43222_0,,,,2,1,2,3
43223_0,,,,2,1,2,3
43224_0,,,,2,1,2,3
43226_0,,,,2,1,2,3
C1(C(CO)OCC(C1)=O)=O,,,5,1,2,0,2
43228_0,,,,2,1,2,3
C1(C(COC(CO)C1)=O)=O,,,5,1,2,0,2
43230_0,,,,2,1,2,3
C1(CCC(OC1CO)=O)=O,,,5,1,2,0,2
43232_0,,,,2,1,2,3
C1(CC(CC(CO)O1)=O)=O,,,5,1,2,0,2
43233_0,,,,2,1,2,3
43234_0,,,,2,1,2,3
43235_0,,,,2,1,2,3
43236_0,,,,2,1,2,3
43238_0,,,,2,1,2,3
C1(C(CO)CC(CO1)=O)=O,,,5,1,2,0,2
43240_0,,,,2,1,2,3
C(C1C(OCC(C1)=O)O)=O,,,5,1,3,0,3
43242_0,,,,2,1,2,3
C1(C(C(CCO1)=O)CO)=O,,,5,1,2,0,2
43244_0,,,,2,1,2,3
C(C1C(CCOC1O)=O)=O,,,5,1,3,0,3
43245_0,,,,2,1,2,3
43246_0,,,,2,1,2,3
43247_0,,,,2,1,2,3
43248_0,,,,2,1,2,3
43250_0,,,,2,1,2,3
C1(C(COCC(C1)=O)O)=O,,,5,1,2,0,2
43252_0,,,,2,1,2,3
C1(CCOCC(C1O)=O)=O,,,5,1,2,0,2
43254_0,,,,2,1,2,3
C1(C(COCC(C1)O)=O)=O,,,5,1,2,0,2
43256_0,,,,2,1,2,3
C1(COCC(CC1O)=O)=O,,,5,1,2,0,2
43258_0,,,,2,1,2,3
C1(CCOC(C(C1)=O)O)=O,,,5,1,3,0,3
43260_0,,,,2,1,2,3
C1(COC(C(CC1)=O)O)=O,,,5,1,3,0,3
43262_0,,,,2,1,2,3
C1(CCC(OCC1O)=O)=O,,,5,1,2,0,2
43264_0,,,,2,1,2,3
C1(CC(C(CCO1)=O)O)=O,,,5,1,3,0,3
43266_0,,,,2,1,2,3
C1(CC(CC(CO1)O)=O)=O,,,5,1,2,0,2
43268_0,,,,2,1,2,3
C1(CC(CC(CO1)=O)O)=O,,,5,1,3,0,3
43269_0,,,,2,1,2,3
43270_0,,,,2,1,2,3
43271_0,,,,2,1,2,3
43272_0,,,,2,1,2,3
43273_0,,,,2,1,2,3
43275_0,,,,2,1,2,3
C1(C(CC(O)OCC1)=O)=O,,,5,1,3,0,3
43276_0,,,,2,1,2,3
43278_0,,,,2,1,2,3
C1(CC(OCC(C1)=O)O)=O,,,5,1,4,0,4
43279_0,,,,2,1,2,3
43280_0,,,,2,1,2,3
43281_0,,,,2,1,2,3
43282_0,,,,2,1,2,3
43283_0,,,,2,1,2,3
43284_0,,,,2,1,2,3
43286_0,,,,2,1,2,3
C(CC1CC(C(O1)=O)=O)=O,,,5,1,3,0,3
43288_0,,,,2,1,2,3
C(C)(C1CC(C(O1)=O)=O)=O,,,5,1,3,0,3
43290_0,,,,2,1,2,3
C1(CC(C(CC=O)O1)=O)=O,,,5,1,3,0,3
43292_0,,,,2,1,2,3
C1(C(C(C)=O)OC(C1)=O)=O,,,5,1,3,0,3
43293_0,,,,2,1,2,3
43294_0,,,,2,1,2,3
43295_0,,,,2,1,2,3
43296_0,,,,2,1,2,3
43298_0,,,,2,1,2,3
C1(CCOC(C(C1)=O)=O)=O,,,5,1,3,0,3
43300_0,,,,2,1,2,3
C1(COC(C(CC1)=O)=O)=O,,,5,1,3,0,3
43301_0,,,,2,1,2,3
43303_0,,,,2,1,2,3
C1(CC(C(CCO1)=O)=O)=O,,,5,1,3,0,3
43304_0,,,,2,1,2,3
43306_0,,,,2,1,2,3
C1(CC(OCC(C1)=O)=O)=O,,,5,1,3,0,3
43307_0,,,,2,1,2,3
43308_0,,,,2,1,2,3
43309_0,,,,2,1,2,3
43310_0,,,,2,1,2,3
43311_0,,,,2,1,2,3
43312_0,,,,2,1,2,3
43313_0,,,,2,1,2,3
43314_0,,,,2,1,2,3
43316_0,,,,2,1,2,3
C(C(C(C(C=O)=O)=C)CO)=O,,,5,1,2,0,2
43318_0,,,,2,1,2,3
C(C(C(C=O)=CC=O)CO)=O,,,5,1,3,0,3
43319_0,,,,2,1,2,3
43321_0,,,,2,1,2,3
C(C(C=C(C(C)=O)CO)=O)=O,,,5,1,2,0,2
43322_0,,,,2,1,2,3
43324_0,,,,2,1,2,3
C(C(C=O)=C(C(C)=O)CO)=O,,,5,1,2,0,2
43325_0,,,,2,1,2,3
43327_0,,,,2,1,2,3
C(C=C(C(C)=O)CO)=O,,,5,1,2,0,2
43328_0,,,,2,1,2,3
43330_0,,,,2,1,2,3
C=C(C=O)C(C(C(C)=O)=O)O,,,5,1,2,0,2
43331_0,,,,2,1,2,3
43332_0,,,,2,1,2,3
43333_0,,,,2,1,2,3
43335_0,,,,2,1,2,3
C=CC(C(C(C)=O)=O)O,,,5,1,2,0,2
43336_0,,,,2,1,2,3
43337_0,,,,2,1,2,3
43338_0,,,,2,1,2,3
43339_0,,,,2,1,2,3
43340_0,,,,2,1,2,3
43341_0,,,,2,1,2,3
43342_0,,,,2,1,2,3
43343_0,,,,2,1,2,3
43344_0,,,,2,1,2,3
43345_0,,,,2,1,2,3
43346_0,,,,2,1,2,3
43347_0,,,,2,1,2,3
43348_0,,,,2,1,2,3
43349_0,,,,2,1,2,3
43350_0,,,,2,1,2,3
43351_0,,,,2,1,2,3
43352_0,,,,2,1,2,3
43353_0,,,,2,1,2,3
43354_0,,,,2,1,2,3
43355_0,,,,2,1,2,3
43356_0,,,,2,1,2,3
43358_0,,,,2,1,2,3
C(CO)(CC(C(C=O)=O)=C)=O,,,5,1,2,0,2
43359_0,,,,2,1,2,3
43361_0,,,,2,1,2,3
C=C(C(CCO)=O)C(C=O)=O,,,5,1,2,0,2
43362_0,,,,2,1,2,3
43364_0,,,,2,1,2,3
C(CC(C(C=O)=O)=C)=O,,,5,1,2,0,2
43366_0,,,,2,1,2,3
C=C(C(C)=O)C(C=O)=O,,,5,1,2,0,2
43367_0,,,,2,1,2,3
43368_0,,,,2,1,2,3
43370_0,,,,2,1,2,3
C(CO)(CC(C=O)=CC=O)=O,,,5,1,3,0,3
43371_0,,,,2,1,2,3
43373_0,,,,2,1,2,3
C(C(C(CCO)=O)=CC=O)=O,,,5,1,3,0,3
43374_0,,,,2,1,2,3
43376_0,,,,2,1,2,3
C(CC(C=O)=CC=O)=O,,,5,1,7,0,7
43378_0,,,,2,1,2,3
C(C(C(C)=O)=CC=O)=O,,,5,1,3,0,3
43379_0,,,,2,1,2,3
43380_0,,,,2,1,2,3
43381_0,,,,2,1,2,3
43382_0,,,,2,1,2,3
43383_0,,,,2,1,2,3
43384_0,,,,2,1,2,3
43385_0,,,,2,1,2,3
43386_0,,,,2,1,2,3
43387_0,,,,2,1,2,3
43388_0,,,,2,1,2,3
43389_0,,,,2,1,2,3
43390_0,,,,2,1,2,3
43391_0,,,,2,1,2,3
43392_0,,,,2,1,2,3
43393_0,,,,2,1,2,3
43394_0,,,,2,1,2,3
43395_0,,,,2,1,2,3
43396_0,,,,2,1,2,3
43397_0,,,,2,1,2,3
43398_0,,,,2,1,2,3
43399_0,,,,2,1,2,3
43400_0,,,,2,1,2,3
43401_0,,,,2,1,2,3
43402_0,,,,2,1,2,3
43403_0,,,,2,1,2,3
43404_0,,,,2,1,2,3
43405_0,,,,2,1,2,3
43406_0,,,,2,1,2,3
43407_0,,,,2,1,2,3
43408_0,,,,2,1,2,3
43409_0,,,,2,1,2,3
43410_0,,,,2,1,2,3
43411_0,,,,2,1,2,3
43412_0,,,,2,1,2,3
43413_0,,,,2,1,2,3
43414_0,,,,2,1,2,3
43415_0,,,,2,1,2,3
43416_0,,,,2,1,2,3
43417_0,,,,2,1,2,3
43418_0,,,,2,1,2,3
43419_0,,,,2,1,2,3
43420_0,,,,2,1,2,3
43422_0,,,,2,1,2,3
C(C=CC(C(C)=O)=O)=O,,,5,1,2,0,2
43424_0,,,,2,1,2,3
C(C(C=O)C(C=C)=O)=O,,,5,1,3,0,3
43426_0,,,,2,1,2,3
C=C(C=O)C(C(C)=O)=O,,,5,1,2,0,2
43428_0,,,,2,1,2,3
C(CC(C(C=O)=C)=O)=O,,,5,1,2,0,2
43429_0,,,,2,1,2,3
43430_0,,,,2,1,2,3
43432_0,,,,2,1,2,3
C(CC(C=CC(O)=O)=O)=O,,,5,1,2,0,2
43434_0,,,,2,1,2,3
C(C=CC(C(C)=O)=O)(O)=O,,,5,1,2,0,2
43435_0,,,,2,1,2,3
43437_0,,,,2,1,2,3
C(C)(C(C1C(CC(O)O1)O)O)=O,,,5,1,2,0,2
43438_0,,,,2,1,2,3
43439_0,,,,2,1,2,3
43440_0,,,,2,1,2,3
43442_0,,,,2,1,2,3
C1(CC(C(C=O)=O)CO1)=O,,,5,1,1,0,1
43444_0,,,,2,1,2,3
C(C1C(COC1C=O)=O)=O,,,5,1,1,0,1
43446_0,,,,2,1,2,3
C(C1C(C=O)CC(O1)=O)=O,,,5,1,1,0,1
43447_0,,,,2,1,2,3
43448_0,,,,2,1,2,3
43450_0,,,,2,1,2,3
C(C1C(C(CO)(CO1)O)O)=O,,,5,1,1,0,1
43452_0,,,,2,1,2,3
C(C1COC(CO)(C1O)O)=O,,,5,1,2,0,2
43454_0,,,,2,1,2,3
C(C1COC(C=O)(C1)O)=O,,,5,1,2,0,2
43456_0,,,,2,1,2,3
C(C1COC(C1C=O)O)=O,,,5,1,2,0,2
43458_0,,,,2,1,2,3
C(C1COC(C=O)(C1CO)O)=O,,,5,1,2,0,2
43460_0,,,,2,1,2,3
C(C1C(COC1(CO)CO)=O)=O,,,5,1,1,0,1
43462_0,,,,2,1,2,3
C(C1C(CO)(CO)OC(C1)=O)=O,,,5,1,1,0,1
43464_0,,,,2,1,2,3
C(C1COC(C1C(C=O)O)O)=O,,,5,1,2,0,2
43466_0,,,,2,1,2,3
C(C1COC(C1C(CO)=O)O)=O,,,5,1,2,0,2
43468_0,,,,2,1,2,3
C(C1C(CO)(COC1C=O)O)=O,,,5,1,1,0,1
43470_0,,,,2,1,2,3
C(C1C(CO)(O)OCC1C=O)=O,,,5,1,2,0,2
43472_0,,,,2,1,2,3
C(CC1C(C(CO)(CO1)O)=O)=O,,,5,1,1,0,1
43474_0,,,,2,1,2,3
C(CC1(C(C(CO)CO1)=O)O)=O,,,5,1,2,0,2
43476_0,,,,2,1,2,3
C(C1COC(C1O)(CC=O)O)=O,,,5,1,2,0,2
43478_0,,,,2,1,2,3
C(C(C1CC(CO)(CO1)O)=O)=O,,,5,1,1,0,1
43480_0,,,,2,1,2,3
C(C1COC(C1)(C(C=O)O)O)=O,,,5,1,2,0,2
43482_0,,,,2,1,2,3
C(C1COC(C1)O)=O,,,5,1,2,0,2
43483_0,,,,2,1,2,3
43484_0,,,,2,1,2,3
43485_0,,,,2,1,2,3
43486_0,,,,2,1,2,3
43488_0,,,,2,1,2,3
C(CC1C(CC(CO)(O1)O)=O)=O,,,5,1,2,0,2
43489_0,,,,2,1,2,3
43491_0,,,,2,1,2,3
C(CC1C(C(C(CO)O1)=O)O)=O,,,5,1,1,0,1
43493_0,,,,2,1,2,3
C(CC1C(C(C(C=O)O1)O)O)=O,,,5,1,1,0,1
43495_0,,,,2,1,2,3
C(CO)(C(C1CC(CO1)=O)O)=O,,,5,1,1,0,1
43497_0,,,,2,1,2,3
C1(CCC(C(C(CO)=O)O)O1)=O,,,5,1,1,0,1
43499_0,,,,2,1,2,3
C(C1CC(C(C(CO)=O)O1)O)=O,,,5,1,1,0,1
43501_0,,,,2,1,2,3
C1(C(CO)(O)OCC1CC=O)=O,,,5,1,2,0,2
43503_0,,,,2,1,2,3
C1(C(COC1CO)(CC=O)O)=O,,,5,1,1,0,1
43505_0,,,,2,1,2,3
C(CC1(C(C(C=O)OC1)O)O)=O,,,5,1,1,0,1
43507_0,,,,2,1,2,3
C(C1CC(OC1C(CO)=O)O)=O,,,5,1,2,0,2
43509_0,,,,2,1,2,3
C1(CC(CO)(OC1C(C)=O)O)=O,,,5,1,2,0,2
43510_0,,,,2,1,2,3
43512_0,,,,2,1,2,3
C(C1C(C(C(CO)O1)=O)O)(C)=O,,,5,1,1,0,1
43514_0,,,,2,1,2,3
C(C1C(C(C(C(C)=O)O1)O)O)=O,,,5,1,1,0,1
43516_0,,,,2,1,2,3
C1(CC(C(CO)=O)OC1(C)O)=O,,,5,1,2,0,2
43518_0,,,,2,1,2,3
C(C1C(C(C(C)O1)=O)O)(CO)=O,,,5,1,1,0,1
43520_0,,,,2,1,2,3
C1(CC(C)(OC1C(CO)=O)O)=O,,,5,1,2,0,2
43522_0,,,,2,1,2,3
C1(C(CO)(OC(C=O)C1C)O)=O,,,5,1,2,0,2
43524_0,,,,2,1,2,3
C1(C(C)(C(C=O)OC1CO)O)=O,,,5,1,1,0,1
43526_0,,,,2,1,2,3
C(C1C(C(C)(C(C=O)O1)O)O)=O,,,5,1,1,0,1
43528_0,,,,2,1,2,3
C1(COC(C(CO)=O)C1(C)O)=O,,,5,1,1,0,1
43530_0,,,,2,1,2,3
C(C1C(C(C(O1)O)=O)C)(CO)=O,,,5,1,2,0,2
43532_0,,,,2,1,2,3
C1(CC(C)(C(C(CO)=O)O1)O)=O,,,5,1,1,0,1
43534_0,,,,2,1,2,3
C1(C(CO)OC(CO)(C1)O)=O,,,5,1,2,0,2
43535_0,,,,2,1,2,3
43536_0,,,,2,1,2,3
43538_0,,,,2,1,2,3
C(C1C(C(C(CO)O1)O)O)=O,,,5,1,1,0,1
43540_0,,,,2,1,2,3
C1(COC(CO)(C1)O)=O,,,5,1,2,0,2
43541_0,,,,2,1,2,3
43542_0,,,,2,1,2,3
43544_0,,,,2,1,2,3
C(C1C(C(CO1)O)O)=O,,,5,1,1,0,1
43545_0,,,,2,1,2,3
43546_0,,,,2,1,2,3
43547_0,,,,2,1,2,3
43549_0,,,,2,1,2,3
C(C1(CC(C(CO)=O)CO1)O)=O,,,5,1,2,0,2
43551_0,,,,2,1,2,3
C(C1(CC(C(C)=O)(CO1)O)O)=O,,,5,1,2,0,2
43553_0,,,,2,1,2,3
C(C1CC(C=O)(O)OC1CO)=O,,,5,1,2,0,2
43554_0,,,,2,1,2,3
43556_0,,,,2,1,2,3
C(C1C(O)OCC1C(CO)=O)=O,,,5,1,2,0,2
43558_0,,,,2,1,2,3
C(C1C(O)OCC1(C(C)=O)O)=O,,,5,1,2,0,2
43560_0,,,,2,1,2,3
C(C1C(CO)OC(C1C=O)O)=O,,,5,1,2,0,2
43561_0,,,,2,1,2,3
43563_0,,,,2,1,2,3
C(CO)(C1COC(C1)O)=O,,,5,1,2,0,2
43565_0,,,,2,1,2,3
C(C)(C1(COC(C1)O)O)=O,,,5,1,2,0,2
43567_0,,,,2,1,2,3
C(C1C(CO)OC(C1)O)=O,,,5,1,2,0,2
43568_0,,,,2,1,2,3
43569_0,,,,2,1,2,3
43571_0,,,,2,1,2,3
C1(CC(CO1)(C(CO)O)O)=O,,,5,1,2,0,2
43572_0,,,,2,1,2,3
43573_0,,,,2,1,2,3
43575_0,,,,2,1,2,3
C(C)(C1(COC(C1O)O)O)=O,,,5,1,2,0,2
43576_0,,,,2,1,2,3
43577_0,,,,2,1,2,3
43579_0,,,,2,1,2,3
C1(CC(CO)(C(CO)O1)O)=O,,,5,1,2,0,2
43580_0,,,,2,1,2,3
43581_0,,,,2,1,2,3
43583_0,,,,2,1,2,3
C(C(C)=O)(C1C(CC(O1)O)O)=O,,,5,1,2,0,2
43585_0,,,,2,1,2,3
C1(COC(C(CO)O)(C1)O)=O,,,5,1,2,0,2
43586_0,,,,2,1,2,3
43587_0,,,,2,1,2,3
43588_0,,,,2,1,2,3
43590_0,,,,2,1,2,3
C(CO)(C1C(C(CO1)O)O)=O,,,5,1,1,0,1
43592_0,,,,2,1,2,3
C(C)(C1(C(C(CO1)O)O)O)=O,,,5,1,2,0,2
43593_0,,,,2,1,2,3
43595_0,,,,2,1,2,3
C1(COC(CO)(CO)C1O)=O,,,5,1,1,0,1
43596_0,,,,2,1,2,3
43598_0,,,,2,1,2,3
C1(CC(C(CO)(CO)O1)O)=O,,,5,1,2,0,2
43599_0,,,,2,1,2,3
43600_0,,,,2,1,2,3
43601_0,,,,2,1,2,3
43603_0,,,,2,1,2,3
C1(C(C)C(C(C=O)=O)CO1)=O,,,5,1,1,0,1
43605_0,,,,2,1,2,3
C(C1C(C=O)C(C(O1)=O)C)=O,,,5,1,1,0,1
43607_0,,,,2,1,2,3
C(C1(C)C(C=O)C(CO1)=O)=O,,,5,1,1,0,1
43609_0,,,,2,1,2,3
C(C1(C)C(C=O)CC(O1)=O)=O,,,5,1,1,0,1
43611_0,,,,2,1,2,3
C1(C(C)OCC1C(C=O)=O)=O,,,5,1,1,0,1
43613_0,,,,2,1,2,3
C1(C(C)OC(C=O)C1C=O)=O,,,5,1,1,0,1
43615_0,,,,2,1,2,3
C(C1C(COC1C(C)=O)=O)=O,,,5,1,1,0,1
43617_0,,,,2,1,2,3
C(C1C(C(C)=O)OC(C1)=O)=O,,,5,1,1,0,1
43619_0,,,,2,1,2,3
C1(COC(CC(C=O)=O)C1)=O,,,5,1,1,0,1
43621_0,,,,2,1,2,3
C1(CCC(CC(C=O)=O)O1)=O,,,5,1,1,0,1
43622_0,,,,2,1,2,3
43623_0,,,,2,1,2,3
43624_0,,,,2,1,2,3
43625_0,,,,2,1,2,3
43626_0,,,,2,1,2,3
43627_0,,,,2,1,2,3
43629_0,,,,2,1,2,3
C(CC1C(C=O)C(CO1)=O)=O,,,5,1,1,0,1
43631_0,,,,2,1,2,3
C(CC1C(C=O)CC(O1)=O)=O,,,5,1,1,0,1
43633_0,,,,2,1,2,3
C(C(C=O)C1CC(CO1)=O)=O,,,5,1,1,0,1
43635_0,,,,2,1,2,3
C(C(C=O)C1CCC(O1)=O)=O,,,5,1,1,0,1
43636_0,,,,2,1,2,3
43637_0,,,,2,1,2,3
43638_0,,,,2,1,2,3
43639_0,,,,2,1,2,3
43641_0,,,,2,1,2,3
C(CC1CC(CO1)=O)=O,,,5,1,1,0,1
43643_0,,,,2,1,2,3
C(CC1CCC(O1)=O)=O,,,5,1,1,0,1
43645_0,,,,2,1,2,3
C(C(C1CC(CO1)=O)O)=O,,,5,1,1,0,1
43647_0,,,,2,1,2,3
C1(CCC(C(C=O)O)O1)=O,,,5,1,1,0,1
43649_0,,,,2,1,2,3
C(C1C(COC1C)=O)=O,,,5,1,1,0,1
43651_0,,,,2,1,2,3
C(C1C(C)OC(C1)=O)=O,,,5,1,1,0,1
43652_0,,,,2,1,2,3
43653_0,,,,2,1,2,3
43655_0,,,,2,1,2,3
C(C1C(COC1C(CO)O)=O)=O,,,5,1,1,0,1
43657_0,,,,2,1,2,3
C(C1C(C(CO)O)OC(C1)=O)=O,,,5,1,1,0,1
43658_0,,,,2,1,2,3
43660_0,,,,2,1,2,3
C(C1COC(C1)=O)=O,,,5,1,1,0,1
43662_0,,,,2,1,2,3
C(C1C(COC1CO)=O)=O,,,5,1,1,0,1
43664_0,,,,2,1,2,3
C(C1C(CO)OC(C1)=O)=O,,,5,1,1,0,1
43666_0,,,,2,1,2,3
C(C1C(CC(C=O)O1)O)=O,,,5,1,1,0,1
43668_0,,,,2,1,2,3
C(C1CC(OC1C=O)O)=O,,,5,1,2,0,2
43669_0,,,,2,1,2,3
43670_0,,,,2,1,2,3
43671_0,,,,2,1,2,3
43673_0,,,,2,1,2,3
C(C1C(C(CO)OC1C=O)O)=O,,,5,1,1,0,1
43675_0,,,,2,1,2,3
C(C1C(COC1C=O)O)=O,,,5,1,1,0,1
43677_0,,,,2,1,2,3
C(CC1(CC(C(CO)O1)=O)O)=O,,,5,1,2,0,2
43679_0,,,,2,1,2,3
C(CC1(C(CC(CO)O1)=O)O)=O,,,5,1,2,0,2
43681_0,,,,2,1,2,3
C(CC1C(C(C(CO)O1)O)=O)=O,,,5,1,1,0,1
43683_0,,,,2,1,2,3
C(CC1(CC(CO1)=O)O)=O,,,5,1,2,0,2
43684_0,,,,2,1,2,3
43685_0,,,,2,1,2,3
43687_0,,,,2,1,2,3
C1(CC(C=O)OC1(C)O)=O,,,5,1,2,0,2
43689_0,,,,2,1,2,3
C(C1C(C(C(C)O1)=O)O)=O,,,5,1,1,0,1
43691_0,,,,2,1,2,3
C(C1C(CC(C)(O1)O)=O)=O,,,5,1,2,0,2
43693_0,,,,2,1,2,3
C1(COC(C=O)C1(C)O)=O,,,5,1,1,0,1
43695_0,,,,2,1,2,3
C1(C(OC(C=O)C1C)O)=O,,,5,1,2,0,2
43697_0,,,,2,1,2,3
C1(CC(C)(C(C=O)O1)O)=O,,,5,1,2,0,2
43699_0,,,,2,1,2,3
C(C(C1CC(C(CO)O1)O)=O)=O,,,5,1,1,0,1
43701_0,,,,2,1,2,3
C(C(C1CC(CO1)O)=O)=O,,,5,1,1,0,1
43702_0,,,,2,1,2,3
43703_0,,,,2,1,2,3
43704_0,,,,2,1,2,3
43705_0,,,,2,1,2,3
43706_0,,,,2,1,2,3
43708_0,,,,2,1,2,3
C(CC1C(C(C(O)O1)=O)O)=O,,,5,1,2,0,2
43710_0,,,,2,1,2,3
C1(C(O)OC(C(C)=O)C1O)=O,,,5,1,2,0,2
43712_0,,,,2,1,2,3
C1(CC(C=O)(OC1CO)O)=O,,,5,1,2,0,2
43714_0,,,,2,1,2,3
C(C1C(C(C(CO)O1)O)=O)=O,,,5,1,1,0,1
43716_0,,,,2,1,2,3
C(C1(C(CC(CO)O1)=O)O)=O,,,5,1,2,0,2
43718_0,,,,2,1,2,3
C1(COCC1)=O,,,5,1,1,0,1
43720_0,,,,2,1,2,3
C1(CCCO1)=O,,,5,1,1,0,1
43721_0,,,,2,1,2,3
43723_0,,,,2,1,2,3
C1(CCC(O1)=O)=O,,,5,1,1,0,1
43725_0,,,,2,1,2,3
C(C)(C1C(O)OC(CO)C1O)=O,,,5,1,2,0,2
43726_0,,,,2,1,2,3
43727_0,,,,2,1,2,3
43728_0,,,,2,1,2,3
43729_0,,,,2,1,2,3
43731_0,,,,2,1,2,3
C(CO)(C1(COC(C1)=O)O)=O,,,5,1,1,0,1
43733_0,,,,2,1,2,3
C1(C(C=O)C(C(O)O1)O)=O,,,5,1,2,0,2
43735_0,,,,2,1,2,3
C1(C(C(C(O)O1)=O)CO)=O,,,5,1,2,0,2
43737_0,,,,2,1,2,3
C1(C(C(CO1)=O)(CO)O)=O,,,5,1,2,0,2
43739_0,,,,2,1,2,3
C1(C(CO)(CC(O1)=O)O)=O,,,5,1,1,0,1
43740_0,,,,2,1,2,3
43741_0,,,,2,1,2,3
43743_0,,,,2,1,2,3
C(C1(COC(C1)=O)O)(O)=O,,,5,1,1,0,1
43745_0,,,,2,1,2,3
C1(C(C(C(O)O1)O)(CC=O)O)=O,,,5,1,2,0,2
43747_0,,,,2,1,2,3
C1(C(C(CO)=O)C(C(O)O1)O)=O,,,5,1,2,0,2
43749_0,,,,2,1,2,3
C1(C(C(C)=O)(C(C(O)O1)O)O)=O,,,5,1,2,0,2
43751_0,,,,2,1,2,3
C1(C(C(C(O)O1)=O)C(CO)O)=O,,,5,1,2,0,2
43753_0,,,,2,1,2,3
C1(C(C(CO1)=O)(C(CO)O)O)=O,,,5,1,2,0,2
43755_0,,,,2,1,2,3
C1(C(C(CO)O)(CC(O1)=O)O)=O,,,5,1,1,0,1
43756_0,,,,2,1,2,3
43757_0,,,,2,1,2,3
43759_0,,,,2,1,2,3
C(C1(C(CO)OC(C1)=O)O)(O)=O,,,5,1,1,0,1
43760_0,,,,2,1,2,3
43761_0,,,,2,1,2,3
43763_0,,,,2,1,2,3
C(C1(COC(C1)=O)O)=O,,,5,1,2,0,2
43765_0,,,,2,1,2,3
C(C1C(C(O)OC1CO)=O)=O,,,5,1,2,0,2
43767_0,,,,2,1,2,3
C(C1(C(COC1CO)=O)O)=O,,,5,1,1,0,1
43769_0,,,,2,1,2,3
C(C1(C(CO)OC(C1)=O)O)=O,,,5,1,2,0,2
43770_0,,,,2,1,2,3
43771_0,,,,2,1,2,3
43773_0,,,,2,1,2,3
C(C(C1C(O)OCC1O)=O)=O,,,5,1,2,0,2
43775_0,,,,2,1,2,3
C1(C(C(C)=O)C(CO1)(CO)O)=O,,,5,1,1,0,1
43777_0,,,,2,1,2,3
C(C1COC(C1(C(C)=O)O)O)=O,,,5,1,2,0,2
43779_0,,,,2,1,2,3
C(C1COC(C)(C1(C=O)O)O)=O,,,5,1,2,0,2
43781_0,,,,2,1,2,3
C1(C(CO)C(CO1)(CO)O)=O,,,5,1,1,0,1
43782_0,,,,2,1,2,3
43784_0,,,,2,1,2,3
C(C1COC(C1(CO)O)O)=O,,,5,1,2,0,2
43786_0,,,,2,1,2,3
C1(C(C)C(C(CO)=O)(CO1)O)=O,,,5,1,1,0,1
43788_0,,,,2,1,2,3
C1(C(C)OCC1(C(CO)=O)O)=O,,,5,1,1,0,1
43790_0,,,,2,1,2,3
C1(C(C)(O)OCC1C(CO)=O)=O,,,5,1,2,0,2
43792_0,,,,2,1,2,3
C1(COC(CO)(C1CO)O)=O,,,5,1,2,0,2
43794_0,,,,2,1,2,3
C(C1C(CO)(C(CO1)O)O)=O,,,5,1,1,0,1
43795_0,,,,2,1,2,3
43797_0,,,,2,1,2,3
C1(C(C)C(C(O1)=O)(CO)O)=O,,,5,1,1,0,1
43799_0,,,,2,1,2,3
C1(C(C=O)C(C)(C(O)O1)O)=O,,,5,1,2,0,2
43801_0,,,,2,1,2,3
C1(C(C)C(C(O)=O)(CO1)O)=O,,,5,1,1,0,1
43803_0,,,,2,1,2,3
C1(C(C(C(C)O1)=O)(CO)O)=O,,,5,1,2,0,2
43805_0,,,,2,1,2,3
C1(C(C(C(C)(O)O1)=O)CO)=O,,,5,1,2,0,2
43807_0,,,,2,1,2,3
C1(C(C=O)C(C(C)(O)O1)O)=O,,,5,1,2,0,2
43809_0,,,,2,1,2,3
C(C1(C(C(C)OC1)=O)O)(O)=O,,,5,1,1,0,1
43811_0,,,,2,1,2,3
C(C1C(C(C)(O)OC1)=O)(O)=O,,,5,1,2,0,2
43813_0,,,,2,1,2,3
C1(C(C)C(C=O)(CO1)O)=O,,,5,1,1,0,1
43815_0,,,,2,1,2,3
C1(C(C)C(C=O)(C(CO)O1)O)=O,,,5,1,1,0,1
43816_0,,,,2,1,2,3
43817_0,,,,2,1,2,3
43819_0,,,,2,1,2,3
C(C1C(C(C)(O)OC1)=O)=O,,,5,1,2,0,2
43821_0,,,,2,1,2,3
C(C1(C(C(C)OC1)=O)O)=O,,,5,1,1,0,1
43823_0,,,,2,1,2,3
C(C1C(C(C)(O)OC1CO)=O)=O,,,5,1,2,0,2
43825_0,,,,2,1,2,3
C(C1(C(C(C)OC1CO)=O)O)=O,,,5,1,1,0,1
43826_0,,,,2,1,2,3
43827_0,,,,2,1,2,3
43829_0,,,,2,1,2,3
C(C(C)=O)(C1C(O)OCC1O)=O,,,5,1,2,0,2
43830_0,,,,2,1,2,3
43831_0,,,,2,1,2,3
43832_0,,,,2,1,2,3
43833_0,,,,2,1,2,3
43835_0,,,,2,1,2,3
C(CC(C1C(O)OCC1O)=O)=O,,,5,1,2,0,2
43837_0,,,,2,1,2,3
C1(C(CCO)C(C=O)(CO1)O)=O,,,5,1,1,0,1
43839_0,,,,2,1,2,3
C(C1C(C(CCO)(O)OC1)=O)=O,,,5,1,2,0,2
43841_0,,,,2,1,2,3
C(C1(C(C(CCO)OC1)=O)O)=O,,,5,1,1,0,1
43842_0,,,,2,1,2,3
43844_0,,,,2,1,2,3
C1(C(CO)C(C(CC=O)O1)O)=O,,,5,1,1,0,1
43845_0,,,,2,1,2,3
43847_0,,,,2,1,2,3
C(CC1C(C(CO)C(O1)O)=O)=O,,,5,1,2,0,2
43848_0,,,,2,1,2,3
43850_0,,,,2,1,2,3
C(C(CO)(C1CC(CO1)=O)O)=O,,,5,1,1,0,1
43852_0,,,,2,1,2,3
C(C(CO)(C1CCC(O1)=O)O)=O,,,5,1,1,0,1
43854_0,,,,2,1,2,3
C(C1(CO)C(CC(C=O)O1)O)=O,,,5,1,1,0,1
43856_0,,,,2,1,2,3
C(C1CC(OC1(C=O)CO)O)=O,,,5,1,2,0,2
43858_0,,,,2,1,2,3
C1(C(CO)C(CO1)(CC=O)O)=O,,,5,1,1,0,1
43859_0,,,,2,1,2,3
43861_0,,,,2,1,2,3
C1(C(CO)OC(C1C(C)=O)O)=O,,,5,1,2,0,2
43862_0,,,,2,1,2,3
43864_0,,,,2,1,2,3
C(C1C(C(CO)OC1(C)O)=O)=O,,,5,1,2,0,2
43866_0,,,,2,1,2,3
C(C1C(COC1(C)O)=O)=O,,,5,1,2,0,2
43868_0,,,,2,1,2,3
C(C1(CO)CC(C(C)(O1)O)=O)=O,,,5,1,2,0,2
43870_0,,,,2,1,2,3
C(C1(CO)C(C(C(C)O1)=O)O)=O,,,5,1,1,0,1
43872_0,,,,2,1,2,3
C(C1(C(CC(C)(O1)O)=O)CO)=O,,,5,1,2,0,2
43874_0,,,,2,1,2,3
C1(C(CO)C(C(C(C)=O)O1)O)=O,,,5,1,1,0,1
43875_0,,,,2,1,2,3
43877_0,,,,2,1,2,3
C1(C(CO)C(OC1C(C)=O)O)=O,,,5,1,2,0,2
43879_0,,,,2,1,2,3
C(C1(CO)C(C(CO1)=O)(C)O)=O,,,5,1,1,0,1
43881_0,,,,2,1,2,3
C(C1(CO)C(C(C(O1)O)=O)C)=O,,,5,1,2,0,2
43883_0,,,,2,1,2,3
C(C1(CO)C(C)(CC(O1)=O)O)=O,,,5,1,1,0,1
43885_0,,,,2,1,2,3
C1(C(CO)C(C)(C(C=O)O1)O)=O,,,5,1,1,0,1
43886_0,,,,2,1,2,3
43887_0,,,,2,1,2,3
43888_0,,,,2,1,2,3
43890_0,,,,2,1,2,3
C(C)(C1C(O)OCC1O)=O,,,5,1,2,0,2
43892_0,,,,2,1,2,3
C1(C(CC(O)O1)=O)=O,,,5,1,2,0,2
43894_0,,,,2,1,2,3
C1(CC(C(O)O1)=O)=O,,,5,1,2,0,2
43895_0,,,,2,1,2,3
43897_0,,,,2,1,2,3
C1(CC(C(O1)=O)O)=O,,,5,1,2,0,2
43899_0,,,,2,1,2,3
C1(C(C(CO1)(CO)O)CC=O)=O,,,5,1,1,0,1
43901_0,,,,2,1,2,3
C(C1COC(C1(CC=O)O)O)=O,,,5,1,2,0,2
43903_0,,,,2,1,2,3
C1(C(C(C)C(O)O1)=O)=O,,,5,1,2,0,2
43905_0,,,,2,1,2,3
C1(C(C)C(C(O1)=O)O)=O,,,5,1,1,0,1
43907_0,,,,2,1,2,3
C1(C(CC(C)(O)O1)=O)=O,,,5,1,2,0,2
43909_0,,,,2,1,2,3
C1(CC(C(C)(O)O1)=O)=O,,,5,1,2,0,2
43911_0,,,,2,1,2,3
C1(C(C(C(C)O1)=O)O)=O,,,5,1,2,0,2
43913_0,,,,2,1,2,3
C1(C(C(C(O)O1)CCO)=O)=O,,,5,1,2,0,2
43915_0,,,,2,1,2,3
C1(C(CCO)C(C(O1)=O)O)=O,,,5,1,1,0,1
43917_0,,,,2,1,2,3
C1(C(CC(CCO)(O)O1)=O)=O,,,5,1,2,0,2
43919_0,,,,2,1,2,3
C1(CC(C(CCO)(O)O1)=O)=O,,,5,1,2,0,2
43921_0,,,,2,1,2,3
C1(C(C(C(CCO)O1)=O)O)=O,,,5,1,2,0,2
43923_0,,,,2,1,2,3
C1(C(C(OC1CO)O)CC=O)=O,,,5,1,2,0,2
43925_0,,,,2,1,2,3
C1(C(C(C(CO)O1)O)CC=O)=O,,,5,1,1,0,1
43926_0,,,,2,1,2,3
43927_0,,,,2,1,2,3
43929_0,,,,2,1,2,3
C(C(C1CC(CO1)=O)O)(O)=O,,,5,1,1,0,1
43931_0,,,,2,1,2,3
C1(CCC(C(C(O)=O)O)O1)=O,,,5,1,1,0,1
43933_0,,,,2,1,2,3
C(C1C(CC(C=O)O1)O)(O)=O,,,5,1,1,0,1
43935_0,,,,2,1,2,3
C(C1CC(OC1C(O)=O)O)=O,,,5,1,2,0,2
43937_0,,,,2,1,2,3
C1(CC(C(O)=O)OC1(C)O)=O,,,5,1,2,0,2
43939_0,,,,2,1,2,3
C(C1C(C(C(C)O1)=O)O)(O)=O,,,5,1,1,0,1
43941_0,,,,2,1,2,3
C(C1C(CC(C)(O1)O)=O)(O)=O,,,5,1,2,0,2
43943_0,,,,2,1,2,3
C1(COC(C(O)=O)C1(C)O)=O,,,5,1,1,0,1
43945_0,,,,2,1,2,3
C1(C(OC(C(O)=O)C1C)O)=O,,,5,1,2,0,2
43947_0,,,,2,1,2,3
C1(CC(C)(C(C(O)=O)O1)O)=O,,,5,1,1,0,1
43949_0,,,,2,1,2,3
C(C1(COC(C=O)C1)O)=O,,,5,1,1,0,1
43950_0,,,,2,1,2,3
43952_0,,,,2,1,2,3
C(CC1(CC(C(O1)=O)O)O)=O,,,5,1,2,0,2
43954_0,,,,2,1,2,3
C1(C(CC(C(CO)=O)O1)O)=O,,,5,1,2,0,2
43956_0,,,,2,1,2,3
C1(C(CC(C(C)=O)(O)O1)O)=O,,,5,1,2,0,2
43958_0,,,,2,1,2,3
C(CC1C(C(CO1)O)=O)(O)=O,,,5,1,1,0,1
43960_0,,,,2,1,2,3
C(CC1(C(CCO1)=O)O)(O)=O,,,5,1,2,0,2
43962_0,,,,2,1,2,3
C(CC1(CC(CO1)=O)O)(O)=O,,,5,1,2,0,2
43964_0,,,,2,1,2,3
C(C(C1CC(CO1)O)=O)(O)=O,,,5,1,1,0,1
43966_0,,,,2,1,2,3
C1(C(C(CO)O)OC(CC1)O)=O,,,5,1,2,0,2
43968_0,,,,2,1,2,3
C1(CC(C(CO)O)OC(C1)O)=O,,,5,1,2,0,2
43970_0,,,,2,1,2,3
C(C)(C1C(C(CC(O1)O)O)O)=O,,,5,1,2,0,2
43972_0,,,,2,1,2,3
C(CC1C(C(CC(O)O1)O)O)=O,,,5,1,2,0,2
43974_0,,,,2,1,2,3
C1(C(COC(C1)O)=O)=O,,,5,1,2,0,2
43975_0,,,,2,1,2,3
43977_0,,,,2,1,2,3
C1(COCC(C1O)=O)=O,,,5,1,1,0,1
43978_0,,,,2,1,2,3
43980_0,,,,2,1,2,3
C1(C(C(CO)OC(C1)O)=O)=O,,,5,1,2,0,2
43982_0,,,,2,1,2,3
C1(C(CO)OC(C(C1)=O)O)=O,,,5,1,3,0,3
43984_0,,,,2,1,2,3
C1(C(CO)OCC(C1O)=O)=O,,,5,1,1,0,1
43985_0,,,,2,1,2,3
43987_0,,,,2,1,2,3
C(C1C(COCC1=O)=O)=O,,,5,1,1,0,1
43989_0,,,,2,1,2,3
C(C1C(COC(C1)=O)=O)=O,,,5,1,1,0,1
43991_0,,,,2,1,2,3
C1(C(C=O)OCC(C1)=O)=O,,,5,1,1,0,1
43993_0,,,,2,1,2,3
C(C1C(CCC(O1)=O)=O)=O,,,5,1,1,0,1
43995_0,,,,2,1,2,3
C(C1CC(C(CO1)=O)=O)=O,,,5,1,1,0,1
43997_0,,,,2,1,2,3
C1(CC(CC(C=O)O1)=O)=O,,,5,1,3,0,3
43999_0,,,,2,1,2,3
C(C1COC(C(C1)=O)O)=O,,,5,1,2,0,2
44001_0,,,,2,1,2,3
C(C1COC(C(C1CO)=O)O)=O,,,5,1,2,0,2
44003_0,,,,2,1,2,3
C(C1C(COCC1(CO)O)=O)=O,,,5,1,1,0,1
44005_0,,,,2,1,2,3
C(C1C(COC(C1)=O)(CO)O)=O,,,5,1,1,0,1
44007_0,,,,2,1,2,3
C(C1C(C(O)OCC1C=O)O)=O,,,5,1,2,0,2
44009_0,,,,2,1,2,3
C1(C(COC(CO)(CO)C1)=O)=O,,,5,1,1,0,1
44011_0,,,,2,1,2,3
C1(CC(CC(CO)(CO)O1)=O)=O,,,5,1,1,0,1
44013_0,,,,2,1,2,3
C1(C(C)C(C(CO1)=O)O)=O,,,5,1,1,0,1
44015_0,,,,2,1,2,3
C1(C(COC(C1C)O)=O)=O,,,5,1,2,0,2
44017_0,,,,2,1,2,3
C1(C(C)OCC(C1O)=O)=O,,,5,1,1,0,1
44019_0,,,,2,1,2,3
C1(C(C)(OCC(C1)=O)O)=O,,,5,1,2,0,2
44021_0,,,,2,1,2,3
C1(C(COC(C)(C1)O)=O)=O,,,5,1,2,0,2
44023_0,,,,2,1,2,3
C(C1C(C(CO)(O)OCC1)=O)=O,,,5,1,2,0,2
44025_0,,,,2,1,2,3
C(C1(C(C(CO)OCC1)=O)O)=O,,,5,1,1,0,1
44027_0,,,,2,1,2,3
C(C1(C(C(C=O)OCC1)O)O)=O,,,5,1,1,0,1
44029_0,,,,2,1,2,3
C1(C(CCO)C(C(CO1)=O)O)=O,,,5,1,1,0,1
44031_0,,,,2,1,2,3
C1(C(COC(C1CCO)O)=O)=O,,,5,1,2,0,2
44033_0,,,,2,1,2,3
C1(C(CCO)OCC(C1O)=O)=O,,,5,1,1,0,1
44035_0,,,,2,1,2,3
C1(C(CCO)(OCC(C1)=O)O)=O,,,5,1,2,0,2
44037_0,,,,2,1,2,3
C1(C(COC(CCO)(C1)O)=O)=O,,,5,1,2,0,2
44039_0,,,,2,1,2,3
C1(CC(C(CO)=O)OC(C1)O)=O,,,5,1,2,0,2
44041_0,,,,2,1,2,3
C1(CCC(OC1C(CO)=O)O)=O,,,5,1,2,0,2
44043_0,,,,2,1,2,3
C1(CC(C=O)OC(CO)(C1)O)=O,,,5,1,2,0,2
44045_0,,,,2,1,2,3
C(C1CCC(C(CO)(O1)O)=O)=O,,,5,1,2,0,2
44047_0,,,,2,1,2,3
C(C1CC(C(C(CO)O1)=O)O)=O,,,5,1,1,0,1
44049_0,,,,2,1,2,3
C(C1C(C(CC(C=O)O1)O)O)=O,,,5,1,1,0,1
44051_0,,,,2,1,2,3
C1(COC(C(CO)=O)C(C1)O)=O,,,5,1,1,0,1
44053_0,,,,2,1,2,3
C1(CCC(C(C(CO)=O)O1)O)=O,,,5,1,1,0,1
44055_0,,,,2,1,2,3
C1(COC(CO)(C(C1)O)O)=O,,,5,1,2,0,2
44057_0,,,,2,1,2,3
C1(C(C(CO)(O)OCC1)O)=O,,,5,1,2,0,2
44059_0,,,,2,1,2,3
C1(C(COC(CO)(C1)O)O)=O,,,5,1,2,0,2
44060_0,,,,2,1,2,3
44061_0,,,,2,1,2,3
44063_0,,,,2,1,2,3
C(C1C(C(C(CO1)O)O)O)=O,,,5,1,1,0,1
44064_0,,,,2,1,2,3
44066_0,,,,2,1,2,3
C(CO)(C1COC(C(C1)=O)O)=O,,,5,1,2,0,2
44068_0,,,,2,1,2,3
C(C)(C1(COC(C(C1)=O)O)O)=O,,,5,1,2,0,2
44070_0,,,,2,1,2,3
C(C1C(CO)OC(C(C1)=O)O)=O,,,5,1,2,0,2
44072_0,,,,2,1,2,3
C(C1CC(C=O)(O)OCC1O)=O,,,5,1,2,0,2
44074_0,,,,2,1,2,3
C(C1(CC(C(CO1)=O)CO)O)=O,,,5,1,2,0,2
44076_0,,,,2,1,2,3
C(C1C(COC(C1C=O)O)O)=O,,,5,1,2,0,2
44078_0,,,,2,1,2,3
C(C1C(OCC(C1CO)=O)O)=O,,,5,1,2,0,2
44080_0,,,,2,1,2,3
C(C1CC(O)OCC1O)=O,,,5,1,2,0,2
44082_0,,,,2,1,2,3
C1(COC(CC1CO)O)=O,,,5,1,2,0,2
44083_0,,,,2,1,2,3
44084_0,,,,2,1,2,3
44086_0,,,,2,1,2,3
C1(CC(CO)(C(CO1)O)O)=O,,,5,1,2,0,2
44087_0,,,,2,1,2,3
44088_0,,,,2,1,2,3
44090_0,,,,2,1,2,3
C1(C(C)C(C(C(CO)O1)=O)O)=O,,,5,1,1,0,1
44092_0,,,,2,1,2,3
C1(C(C(CO)OC(C1C)O)=O)=O,,,5,1,2,0,2
44094_0,,,,2,1,2,3
C1(C(CO)OC(C(C1O)=O)C)=O,,,5,1,1,0,1
44096_0,,,,2,1,2,3
C1(C(CO)OC(C(C1)=O)(C)O)=O,,,5,1,2,0,2
44098_0,,,,2,1,2,3
C1(C(C(CO)OC(C)(C1)O)=O)=O,,,5,1,2,0,2
44100_0,,,,2,1,2,3
C(C1COC(C=O)(CC1O)O)=O,,,5,1,2,0,2
44102_0,,,,2,1,2,3
C1(CC(C=O)(O)OCC1CO)=O,,,5,1,2,0,2
44104_0,,,,2,1,2,3
C(C1C(O)OCC(C=O)C1O)=O,,,5,1,2,0,2
44106_0,,,,2,1,2,3
C(C1C(C(COC1O)CO)=O)=O,,,5,1,2,0,2
44108_0,,,,2,1,2,3
C(C1COC(CC1O)O)=O,,,5,1,2,0,2
44110_0,,,,2,1,2,3
C1(CC(O)OCC1CO)=O,,,5,1,2,0,2
44112_0,,,,2,1,2,3
C1(COCC(CO)(C1O)O)=O,,,5,1,1,0,1
44113_0,,,,2,1,2,3
44115_0,,,,2,1,2,3
C1(CC(C(CO1)(CO)O)O)=O,,,5,1,2,0,2
44117_0,,,,2,1,2,3
C(C1COC(C(C1O)O)O)=O,,,5,1,2,0,2
44118_0,,,,2,1,2,3
44119_0,,,,2,1,2,3
44121_0,,,,2,1,2,3
C(CC1(COC(CC1O)O)O)=O,,,5,1,2,0,2
44123_0,,,,2,1,2,3
C(C)(C1(COC(CC1O)O)O)=O,,,5,1,2,0,2
44124_0,,,,2,1,2,3
44126_0,,,,2,1,2,3
C1(CC(O)OCC1C(CO)O)=O,,,5,1,2,0,2
44128_0,,,,2,1,2,3
C1(CC(O)OC(CO)C1CO)=O,,,5,1,2,0,2
44129_0,,,,2,1,2,3
44131_0,,,,2,1,2,3
C(C1C(COC(C1C)=O)=O)=O,,,5,1,1,0,1
44133_0,,,,2,1,2,3
C(C1C(CC(C(O1)=O)C)=O)=O,,,5,1,1,0,1
44135_0,,,,2,1,2,3
C(C1(C)CC(C(CO1)=O)=O)=O,,,5,1,1,0,1
44137_0,,,,2,1,2,3
C(C1(C)CC(CC(O1)=O)=O)=O,,,5,1,1,0,1
44139_0,,,,2,1,2,3
C1(C(C)OCC(C1C=O)=O)=O,,,5,1,1,0,1
44141_0,,,,2,1,2,3
C1(C(C=O)OC(C(C1)=O)C)=O,,,5,1,1,0,1
44143_0,,,,2,1,2,3
C(C)(C1CC(C(CO1)=O)=O)=O,,,5,1,1,0,1
44145_0,,,,2,1,2,3
C1(CC(CC(C(C)=O)O1)=O)=O,,,5,1,1,0,1
44147_0,,,,2,1,2,3
C(C1(CCC(CO1)=O)O)=O,,,5,1,2,0,2
44149_0,,,,2,1,2,3
C1(CC(C=O)(O)OCC1)=O,,,5,1,2,0,2
44150_0,,,,2,1,2,3
44151_0,,,,2,1,2,3
44153_0,,,,2,1,2,3
C1(C(CO)OC(C=O)(CC1)O)=O,,,5,1,2,0,2
44155_0,,,,2,1,2,3
C1(CC(C=O)(O)OC(CO)C1)=O,,,5,1,2,0,2
44157_0,,,,2,1,2,3
C(CC1CC(C(CO1)=O)=O)=O,,,5,1,1,0,1
44159_0,,,,2,1,2,3
C(CC1CC(CC(O1)=O)=O)=O,,,5,1,1,0,1
44161_0,,,,2,1,2,3
C(C1C(OC(C(C1)=O)CO)O)=O,,,5,1,2,0,2
44163_0,,,,2,1,2,3
C(C1C(CC(CO)OC1O)=O)=O,,,5,1,2,0,2
44165_0,,,,2,1,2,3
C(C1(C(COCC1)=O)O)=O,,,5,1,1,0,1
44167_0,,,,2,1,2,3
C(C1C(C(O)OCC1)=O)=O,,,5,1,2,0,2
44169_0,,,,2,1,2,3
C(C1(CCOC(C1)=O)O)=O,,,5,1,2,0,2
44171_0,,,,2,1,2,3
C(C1(C(CO)CC(CO1)=O)O)=O,,,5,1,2,0,2
44173_0,,,,2,1,2,3
C1(C(CO)C(C=O)(O)OCC1)=O,,,5,1,2,0,2
44175_0,,,,2,1,2,3
C1(CC(C=O)OC(C1)O)=O,,,5,1,3,0,3
44177_0,,,,2,1,2,3
C(C1C(CCC(O1)O)=O)=O,,,5,1,2,0,2
44179_0,,,,2,1,2,3
C(C1C(CC(CO1)=O)O)=O,,,5,1,1,0,1
44181_0,,,,2,1,2,3
C1(CCC(C(C=O)O1)O)=O,,,5,1,1,0,1
44183_0,,,,2,1,2,3
C(C1CC(C(CO1)=O)O)=O,,,5,1,1,0,1
44185_0,,,,2,1,2,3
C(C1CCC(C(O1)O)=O)=O,,,5,1,2,0,2
44187_0,,,,2,1,2,3
C1(CC(CC(C=O)O1)O)=O,,,5,1,2,0,2
44188_0,,,,2,1,2,3
44190_0,,,,2,1,2,3
C(C1C(COC(CO)C1O)=O)=O,,,5,1,1,0,1
44192_0,,,,2,1,2,3
C(C1C(C(CO)OC(C1)=O)O)=O,,,5,1,1,0,1
44194_0,,,,2,1,2,3
C(C(C1C(OCC(C1)=O)O)O)=O,,,5,1,2,0,2
44196_0,,,,2,1,2,3
C1(C(C(O)OCC1)C(C=O)O)=O,,,5,1,2,0,2
44198_0,,,,2,1,2,3
C(C1C(COCC1O)=O)=O,,,5,1,1,0,1
44200_0,,,,2,1,2,3
C(C1C(COC(C1)=O)O)=O,,,5,1,1,0,1
44202_0,,,,2,1,2,3
C(CO)(C1C(OCC(C1)=O)O)=O,,,5,1,2,0,2
44204_0,,,,2,1,2,3
C1(CCOC(C1C(CO)=O)O)=O,,,5,1,2,0,2
44206_0,,,,2,1,2,3
C(C1C(CO)(OCC(C1)=O)O)=O,,,5,1,2,0,2
44208_0,,,,2,1,2,3
C(C1C(CCOC1(CO)O)=O)=O,,,5,1,2,0,2
44210_0,,,,2,1,2,3
C(C1C(C(COC1C=O)O)O)=O,,,5,1,1,0,1
44212_0,,,,2,1,2,3
C(CC1(C(CC(CO1)=O)O)O)=O,,,5,1,2,0,2
44214_0,,,,2,1,2,3
C(CC1(C(C(CCO1)=O)O)O)=O,,,5,1,2,0,2
44216_0,,,,2,1,2,3
C(CC1(CC(C(CO1)O)=O)O)=O,,,5,1,2,0,2
44218_0,,,,2,1,2,3
C(CC1(C(CC(CO1)O)=O)O)=O,,,5,1,2,0,2
44220_0,,,,2,1,2,3
C(CC1C(C(C(CO1)O)O)=O)=O,,,5,1,1,0,1
44221_0,,,,2,1,2,3
44222_0,,,,2,1,2,3
44224_0,,,,2,1,2,3
C1(C(COC(C)C1)=O)=O,,,5,1,1,0,1
44226_0,,,,2,1,2,3
C1(CC(C)OC(C1)=O)=O,,,5,1,1,0,1
44228_0,,,,2,1,2,3
C(C(C1(CCC(CO1)=O)O)O)=O,,,5,1,2,0,2
44230_0,,,,2,1,2,3
C1(CCOC(C(C=O)O)(C1)O)=O,,,5,1,2,0,2
44232_0,,,,2,1,2,3
C(C(C1CC(C(CO1)O)O)=O)=O,,,5,1,1,0,1
44233_0,,,,2,1,2,3
44234_0,,,,2,1,2,3
44236_0,,,,2,1,2,3
C1(C(COC(C(CO)O)C1)=O)=O,,,5,1,1,0,1
44238_0,,,,2,1,2,3
C1(CC(CC(C(CO)O)O1)=O)=O,,,5,1,1,0,1
44240_0,,,,2,1,2,3
C1(COC(CC1)O)=O,,,5,1,2,0,2
44242_0,,,,2,1,2,3
C1(CCOC(C1)O)=O,,,5,1,2,0,2
44244_0,,,,2,1,2,3
C1(C(CO)OC(CC1)O)=O,,,5,1,2,0,2
44246_0,,,,2,1,2,3
C1(CC(CO)OC(C1)O)=O,,,5,1,2,0,2
44247_0,,,,2,1,2,3
44249_0,,,,2,1,2,3
C1(C(C(O)OCC1)=O)=O,,,5,1,2,0,2
44250_0,,,,2,1,2,3
44252_0,,,,2,1,2,3
C1(C(C(O)OC(CO)C1)=O)=O,,,5,1,2,0,2
44254_0,,,,2,1,2,3
C1(CC(C=O)(O)OCC1O)=O,,,5,1,2,0,2
44256_0,,,,2,1,2,3
C1(C(C(C=O)(O)OCC1)O)=O,,,5,1,2,0,2
44258_0,,,,2,1,2,3
C(C1C(C(C(CO1)O)O)=O)=O,,,5,1,1,0,1
44260_0,,,,2,1,2,3
C(C1(C(CC(CO1)O)=O)O)=O,,,5,1,2,0,2
44262_0,,,,2,1,2,3
C(C1(C(CC(CO1)=O)O)O)=O,,,5,1,2,0,2
44264_0,,,,2,1,2,3
C(C)(C1C(O)OCC(C1O)O)=O,,,5,1,2,0,2
44265_0,,,,2,1,2,3
44267_0,,,,2,1,2,3
C1(COC(C(C(C)O)(C1)O)O)=O,,,5,1,2,0,2
44268_0,,,,2,1,2,3
44269_0,,,,2,1,2,3
44270_0,,,,2,1,2,3
44272_0,,,,2,1,2,3
C1(COC(C(C1CO)=O)O)=O,,,5,1,2,0,2
44274_0,,,,2,1,2,3
C1(COCC(C1(CO)O)=O)=O,,,5,1,1,0,1
44276_0,,,,2,1,2,3
C1(COC(CC1(CO)O)=O)=O,,,5,1,1,0,1
44277_0,,,,2,1,2,3
44278_0,,,,2,1,2,3
44279_0,,,,2,1,2,3
44281_0,,,,2,1,2,3
C(C1(C(COC(C1)=O)O)O)(O)=O,,,5,1,1,0,1
44282_0,,,,2,1,2,3
44284_0,,,,2,1,2,3
C(C1C(C(O)OCC1O)=O)=O,,,5,1,2,0,2
44286_0,,,,2,1,2,3
C(C1(C(COCC1O)=O)O)=O,,,5,1,1,0,1
44288_0,,,,2,1,2,3
C(C1(C(COC(C1)=O)O)O)=O,,,5,1,2,0,2
44290_0,,,,2,1,2,3
C1(C(C)C(C(CO1)=O)(CO)O)=O,,,5,1,1,0,1
44291_0,,,,2,1,2,3
44293_0,,,,2,1,2,3
C1(C(C)OCC(C1(CO)O)=O)=O,,,5,1,1,0,1
44295_0,,,,2,1,2,3
C1(C(C)(OCC(C1CO)=O)O)=O,,,5,1,2,0,2
44296_0,,,,2,1,2,3
44298_0,,,,2,1,2,3
C1(CC(O)OCC1C(CO)=O)=O,,,5,1,2,0,2
44300_0,,,,2,1,2,3
C1(C(C(CC(O)O1)=O)CO)=O,,,5,1,2,0,2
44302_0,,,,2,1,2,3
C1(C(C=O)C(CC(O)O1)O)=O,,,5,1,2,0,2
44304_0,,,,2,1,2,3
C(C1C(CC(O)OC1)=O)(O)=O,,,5,1,2,0,2
44305_0,,,,2,1,2,3
44307_0,,,,2,1,2,3
C1(C(C)C(C=O)(C(CO1)O)O)=O,,,5,1,1,0,1
44308_0,,,,2,1,2,3
44310_0,,,,2,1,2,3
C(C1C(C(C)(O)OCC1O)=O)=O,,,5,1,2,0,2
44312_0,,,,2,1,2,3
C(C1(C(C(C)OCC1O)=O)O)=O,,,5,1,1,0,1
44314_0,,,,2,1,2,3
C(C1C(CC(O)OC1)=O)=O,,,5,1,2,0,2
44316_0,,,,2,1,2,3
C(C1C(CC(O)OC1CO)=O)=O,,,5,1,2,0,2
44318_0,,,,2,1,2,3
C1(C(CO)C(C=O)(CCO1)O)=O,,,5,1,1,0,1
44319_0,,,,2,1,2,3
44321_0,,,,2,1,2,3
C(C1(CO)CC(CC(O1)O)=O)=O,,,5,1,2,0,2
44323_0,,,,2,1,2,3
C(C1(C(CCC(O1)O)=O)CO)=O,,,5,1,2,0,2
44325_0,,,,2,1,2,3
C(C1(CO)C(CC(CO1)=O)O)=O,,,5,1,1,0,1
44327_0,,,,2,1,2,3
C(C1(CO)C(CCC(O1)=O)O)=O,,,5,1,1,0,1
44329_0,,,,2,1,2,3
C1(C(CO)C(CC(C=O)O1)O)=O,,,5,1,1,0,1
44330_0,,,,2,1,2,3
44332_0,,,,2,1,2,3
C1(CC(C=O)OC(C1CO)O)=O,,,5,1,2,0,2
44334_0,,,,2,1,2,3
C(C1C(CC(CO)(O)OC1)=O)=O,,,5,1,2,0,2
44336_0,,,,2,1,2,3
C(C1(COC(C=O)CC1O)O)=O,,,5,1,1,0,1
44338_0,,,,2,1,2,3
C(C1CC(O)OCC1(C=O)O)=O,,,5,1,2,0,2
44340_0,,,,2,1,2,3
C(C)(C1(C(OCC(C1)=O)O)O)=O,,,5,1,2,0,2
44342_0,,,,2,1,2,3
C1(CCOC(C1(C(C)=O)O)O)=O,,,5,1,2,0,2
44344_0,,,,2,1,2,3
C1(C(COC(C1C(C)=O)O)O)=O,,,5,1,2,0,2
44345_0,,,,2,1,2,3
44347_0,,,,2,1,2,3
C(C1(C(C)(OCC(C1)=O)O)O)=O,,,5,1,2,0,2
44349_0,,,,2,1,2,3
C(C1(C(CCOC1(C)O)=O)O)=O,,,5,1,2,0,2
44351_0,,,,2,1,2,3
C(C1C(C(COC1(C)O)O)=O)=O,,,5,1,2,0,2
44353_0,,,,2,1,2,3
C(C1(COC(C(C1)=O)(C)O)O)=O,,,5,1,2,0,2
44355_0,,,,2,1,2,3
C(C1(COC(C(C1O)=O)C)O)=O,,,5,1,1,0,1
44357_0,,,,2,1,2,3
C(C1C(C(C(C)(O)OC1)O)=O)=O,,,5,1,2,0,2
44359_0,,,,2,1,2,3
C(C1(C(CC(C)(O)OC1)=O)O)=O,,,5,1,2,0,2
44361_0,,,,2,1,2,3
C(C1(COCC(C1(C)O)=O)O)=O,,,5,1,1,0,1
44363_0,,,,2,1,2,3
C(C1(COC(C(C1C)=O)O)O)=O,,,5,1,2,0,2
44365_0,,,,2,1,2,3
C(C1(COC(CC1(C)O)=O)O)=O,,,5,1,1,0,1
44367_0,,,,2,1,2,3
C(C1COC(CC1(C=O)O)O)=O,,,5,1,2,0,2
44369_0,,,,2,1,2,3
C1(C(CCC(O)O1)=O)=O,,,5,1,2,0,2
44371_0,,,,2,1,2,3
C1(CC(CC(O)O1)=O)=O,,,5,1,2,0,2
44373_0,,,,2,1,2,3
C(C1C(C(CO)OC(C1)O)=O)=O,,,5,1,2,0,2
44375_0,,,,2,1,2,3
C(CC1(C(OCC(C1)=O)O)O)=O,,,5,1,2,0,2
44377_0,,,,2,1,2,3
C1(C(C(O)OCC1)(CC=O)O)=O,,,5,1,2,0,2
44379_0,,,,2,1,2,3
C1(C(C(O)OCC1O)CC=O)=O,,,5,1,2,0,2
44381_0,,,,2,1,2,3
C1(C(C(C(CO1)O)O)CC=O)=O,,,5,1,1,0,1
44383_0,,,,2,1,2,3
C(C1C(COC(C1)O)=O)=O,,,5,1,2,0,2
44385_0,,,,2,1,2,3
C1(CC(C(O)=O)OC(C1)O)=O,,,5,1,2,0,2
44387_0,,,,2,1,2,3
C(C1C(CCC(O1)O)=O)(O)=O,,,5,1,2,0,2
44389_0,,,,2,1,2,3
C(C1C(CC(CO1)=O)O)(O)=O,,,5,1,1,0,1
44391_0,,,,2,1,2,3
C1(CCC(C(C(O)=O)O1)O)=O,,,5,1,1,0,1
44393_0,,,,2,1,2,3
C1(C(CCC(CO)(O)O1)=O)=O,,,5,1,2,0,2
44395_0,,,,2,1,2,3
C1(CC(CC(CO)(O)O1)=O)=O,,,5,1,2,0,2
44396_0,,,,2,1,2,3
44398_0,,,,2,1,2,3
C1(C(C(CO)CC(O)O1)=O)=O,,,5,1,2,0,2
44400_0,,,,2,1,2,3
C(C1CC(O)OC(C1O)=O)=O,,,5,1,2,0,2
44402_0,,,,2,1,2,3
C1(C(CC(C(C)(O)O1)O)=O)=O,,,5,1,2,0,2
44404_0,,,,2,1,2,3
C1(CC(C(OC1(C)O)=O)O)=O,,,5,1,2,0,2
44406_0,,,,2,1,2,3
C1(C(C(C(OC1C)=O)O)O)=O,,,5,1,2,0,2
44408_0,,,,2,1,2,3
C1(CC(C(C(C)(O)O1)O)=O)=O,,,5,1,2,0,2
44410_0,,,,2,1,2,3
C1(C(C(CC(C)(O)O1)=O)O)=O,,,5,1,2,0,2
44412_0,,,,2,1,2,3
C1(C(C(C)C(C(O)O1)O)=O)=O,,,5,1,2,0,2
44414_0,,,,2,1,2,3
C1(COC(C(C1(C)O)O)=O)=O,,,5,1,2,0,2
44416_0,,,,2,1,2,3
C1(C(O)OC(C(C1C)O)=O)=O,,,5,1,2,0,2
44418_0,,,,2,1,2,3
C1(CC(C)(C(C(O1)=O)O)O)=O,,,5,1,1,0,1
44420_0,,,,2,1,2,3
C1(CC(C(O)=O)(O)OCC1)=O,,,5,1,2,0,2
44422_0,,,,2,1,2,3
C(C1(CCC(CO1)=O)O)(O)=O,,,5,1,2,0,2
44424_0,,,,2,1,2,3
C1(C(C(CO)OC(CC1)O)O)=O,,,5,1,2,0,2
44426_0,,,,2,1,2,3
C1(C(CC(O)OC(CO)C1)O)=O,,,5,1,2,0,2
44428_0,,,,2,1,2,3
C1(CC(C(CO)OC(C1)O)O)=O,,,5,1,2,0,2
44429_0,,,,2,1,2,3
44431_0,,,,2,1,2,3
C1(C(C(COC(C1)O)O)=O)=O,,,5,1,2,0,2
44433_0,,,,2,1,2,3
C1(C(COC(C(C1)=O)O)O)=O,,,5,1,3,0,3
44435_0,,,,2,1,2,3
C1(C(COCC(C1O)=O)O)=O,,,5,1,1,0,1
44436_0,,,,2,1,2,3
44438_0,,,,2,1,2,3
C1(C(CC(O)OCC1CO)=O)=O,,,5,1,2,0,2
44440_0,,,,2,1,2,3
C(C1COC(CC(C1O)=O)O)=O,,,5,1,2,0,2
44442_0,,,,2,1,2,3
C1(C(COCC(CO)(C1)O)=O)=O,,,5,1,1,0,1
44444_0,,,,2,1,2,3
C1(CC(CC(CO1)(CO)O)=O)=O,,,5,1,1,0,1
44446_0,,,,2,1,2,3
C(C1COC(C(C(C1)=O)O)O)=O,,,5,1,2,0,2
44447_0,,,,2,1,2,3
44449_0,,,,2,1,2,3
C1(C(COC(CC1)O)=O)=O,,,5,1,2,0,2
44451_0,,,,2,1,2,3
C1(C(CCOC(CO)(C1)O)=O)=O,,,5,1,2,0,2
44453_0,,,,2,1,2,3
C1(CCOC(C(C1)=O)(CO)O)=O,,,5,1,2,0,2
44455_0,,,,2,1,2,3
C1(CCOC(C(C1O)=O)CO)=O,,,5,1,1,0,1
44457_0,,,,2,1,2,3
C1(C(C(C(C=O)OCC1)O)O)=O,,,5,1,1,0,1
44459_0,,,,2,1,2,3
C1(CC(CO)(OCC(C1)=O)O)=O,,,5,1,3,0,3
44461_0,,,,2,1,2,3
C1(CCC(C(CO)(OC1)O)=O)=O,,,5,1,2,0,2
44463_0,,,,2,1,2,3
C1(CC(C(C(CO)OC1)=O)O)=O,,,5,1,1,0,1
44465_0,,,,2,1,2,3
C(C1C(C(CC(CO1)=O)O)O)=O,,,5,1,1,0,1
44466_0,,,,2,1,2,3
44468_0,,,,2,1,2,3
C(C1CC(C(C(CO1)=O)O)O)=O,,,5,1,1,0,1
44470_0,,,,2,1,2,3
C1(C(COC(CO)(CC1)O)=O)=O,,,5,1,2,0,2
44472_0,,,,2,1,2,3
C(C1CC(OCC(C1O)=O)O)=O,,,5,1,2,0,2
44474_0,,,,2,1,2,3
C1(C(COC(CC1CO)O)=O)=O,,,5,1,2,0,2
44476_0,,,,2,1,2,3
C1(CC(C(COC1(C)O)=O)O)=O,,,5,1,2,0,2
44478_0,,,,2,1,2,3
C1(C(C(C(C(C)OC1)=O)O)O)=O,,,5,1,1,0,1
44480_0,,,,2,1,2,3
C1(CC(C)(OCC(C1O)=O)O)=O,,,5,1,2,0,2
44482_0,,,,2,1,2,3
C1(C(C(C)(OCC(C1)=O)O)O)=O,,,5,1,2,0,2
44484_0,,,,2,1,2,3
C1(C(COC(C)(C(C1)O)O)=O)=O,,,5,1,2,0,2
44486_0,,,,2,1,2,3
C1(COCC(C(C1(C)O)O)=O)=O,,,5,1,1,0,1
44488_0,,,,2,1,2,3
C1(C(OCC(C(C1C)O)=O)O)=O,,,5,1,2,0,2
44490_0,,,,2,1,2,3
C1(CC(C)(C(C(CO1)=O)O)O)=O,,,5,1,1,0,1
44492_0,,,,2,1,2,3
C1(C(COC(C(C1C)O)O)=O)=O,,,5,1,2,0,2
44494_0,,,,2,1,2,3
C(C1C(COC(C(C1)=O)O)O)=O,,,5,1,2,0,2
44496_0,,,,2,1,2,3
C1(COC(C(CC1CO)=O)O)=O,,,5,1,2,0,2
44498_0,,,,2,1,2,3
C1(C(C)C(C(C(CO1)O)=O)O)=O,,,5,1,1,0,1
44500_0,,,,2,1,2,3
C1(C(C(COC(C1C)O)O)=O)=O,,,5,1,2,0,2
44502_0,,,,2,1,2,3
C1(C(COC(C(C1O)=O)C)O)=O,,,5,1,1,0,1
44504_0,,,,2,1,2,3
C1(C(COC(C(C1)=O)(C)O)O)=O,,,5,1,2,0,2
44506_0,,,,2,1,2,3
C1(C(C(COC(C)(C1)O)O)=O)=O,,,5,1,2,0,2
44508_0,,,,2,1,2,3
C1(CC(OC(C(C1)=O)CO)O)=O,,,5,1,3,0,3
44510_0,,,,2,1,2,3
C1(C(C(CO)OC(CC1)O)=O)=O,,,5,1,2,0,2
44512_0,,,,2,1,2,3
C(C1COC(C(CC1O)=O)O)=O,,,5,1,2,0,2
44514_0,,,,2,1,2,3
C1(C(CO)COC(C(C1)=O)O)=O,,,5,1,2,0,2
44515_0,,,,2,1,2,3
44517_0,,,,2,1,2,3
C1(CC(O)OCC(C1CO)O)=O,,,5,1,2,0,2
44519_0,,,,2,1,2,3
C(C1C(COC(CC1O)O)O)=O,,,5,1,2,0,2
44521_0,,,,2,1,2,3
C1(CCC(C(OC1CO)O)=O)=O,,,5,1,2,0,2
44523_0,,,,2,1,2,3
C1(CC(CO)OC(C(C1)=O)O)=O,,,5,1,2,0,2
44525_0,,,,2,1,2,3
C1(C(COC(C=O)(CC1)O)O)=O,,,5,1,2,0,2
44526_0,,,,2,1,2,3
44528_0,,,,2,1,2,3
C1(CC(C=O)(O)OCC(C1)O)=O,,,5,1,2,0,2
44529_0,,,,2,1,2,3
44531_0,,,,2,1,2,3
C(C1C(O)OCC(C(C1)=O)O)=O,,,5,1,2,0,2
44532_0,,,,2,1,2,3
44534_0,,,,2,1,2,3
C(C1C(CC(COC1O)O)=O)=O,,,5,1,2,0,2
44535_0,,,,2,1,2,3
44537_0,,,,2,1,2,3
C1(CC(C(C(OC1)O)=O)CO)=O,,,5,1,2,0,2
44539_0,,,,2,1,2,3
C1(CCOC(C(C1CO)=O)O)=O,,,5,1,2,0,2
44541_0,,,,2,1,2,3
C(C1C(C(OCC(C1)=O)O)O)=O,,,5,1,2,0,2
44543_0,,,,2,1,2,3
C(C1C(CCOC(C1O)O)=O)=O,,,5,1,2,0,2
44545_0,,,,2,1,2,3
C(C1C(COCC(C1O)O)=O)=O,,,5,1,1,0,1
44547_0,,,,2,1,2,3
C(C1C(C(COC(C1)=O)O)O)=O,,,5,1,1,0,1
44548_0,,,,2,1,2,3
44550_0,,,,2,1,2,3
C1(C(CC(O)OC(CO)C1)=O)=O,,,5,1,2,0,2
44552_0,,,,2,1,2,3
C1(C(COC(CO)C(C1)O)=O)=O,,,5,1,1,0,1
44554_0,,,,2,1,2,3
C1(CC(CC(C(CO)O1)O)=O)=O,,,5,1,1,0,1
44556_0,,,,2,1,2,3
C1(C(COC(CC1)O)O)=O,,,5,1,2,0,2
44557_0,,,,2,1,2,3
44559_0,,,,2,1,2,3
C1(CC(COC(C1)O)O)=O,,,5,1,2,0,2
44560_0,,,,2,1,2,3
44561_0,,,,2,1,2,3
44563_0,,,,2,1,2,3
C1(CCOC(C(C1O)=O)O)=O,,,5,1,2,0,2
44565_0,,,,2,1,2,3
C1(C(C(O)OCC(C1)O)=O)=O,,,5,1,2,0,2
44567_0,,,,2,1,2,3
C1(C(O)OCC(CC1O)=O)=O,,,5,1,2,0,2
44569_0,,,,2,1,2,3
C1(CC(OCC(C1CO)=O)O)=O,,,5,1,2,0,2
44570_0,,,,2,1,2,3
44571_0,,,,2,1,2,3
44573_0,,,,2,1,2,3
C(C1C(CC(O)OCC1O)=O)=O,,,5,1,2,0,2
44575_0,,,,2,1,2,3
C1(C(CO)C(C(CCO1)=O)O)=O,,,5,1,1,0,1
44576_0,,,,2,1,2,3
44578_0,,,,2,1,2,3
C1(C(CCOC(C1CO)O)=O)=O,,,5,1,2,0,2
44580_0,,,,2,1,2,3
C(C1(COC(CC(C1)=O)O)O)=O,,,5,1,2,0,2
44582_0,,,,2,1,2,3
C(C1C(C(CC(O)OC1)O)=O)=O,,,5,1,2,0,2
44584_0,,,,2,1,2,3
C(C1(C(CCC(O)OC1)=O)O)=O,,,5,1,2,0,2
44586_0,,,,2,1,2,3
C(C1(COCC(CC1O)=O)O)=O,,,5,1,1,0,1
44588_0,,,,2,1,2,3
C(C1(COC(CCC1O)=O)O)=O,,,5,1,1,0,1
44590_0,,,,2,1,2,3
C(C1C(CC(C(O)OC1)O)=O)=O,,,5,1,2,0,2
44592_0,,,,2,1,2,3
C1(C(CO)C(CC(CO1)=O)O)=O,,,5,1,1,0,1
44593_0,,,,2,1,2,3
44595_0,,,,2,1,2,3
C1(C(CO)C(OCC(C1)=O)O)=O,,,5,1,2,0,2
44597_0,,,,2,1,2,3
C(C1(CC(OCC(C1)=O)O)O)=O,,,5,1,2,0,2
44599_0,,,,2,1,2,3
C(C1(C(CCOC(C1)O)=O)O)=O,,,5,1,2,0,2
44601_0,,,,2,1,2,3
C(C1C(C(COC(C1)O)O)=O)=O,,,5,1,2,0,2
44603_0,,,,2,1,2,3
C1(C(CC(CC(O)O1)O)=O)=O,,,5,1,2,0,2
44605_0,,,,2,1,2,3
C1(CC(C(OC(C1)O)=O)O)=O,,,5,1,2,0,2
44607_0,,,,2,1,2,3
C1(CC(C(CC(O)O1)O)=O)=O,,,5,1,2,0,2
44609_0,,,,2,1,2,3
C1(C(C(CCC(O)O1)=O)O)=O,,,5,1,2,0,2
44611_0,,,,2,1,2,3
C1(C(CCC(C(O)O1)O)=O)=O,,,5,1,2,0,2
44612_0,,,,2,1,2,3
44614_0,,,,2,1,2,3
C1(CCC(C(C(O1)=O)O)O)=O,,,5,1,1,0,1
44616_0,,,,2,1,2,3
C1(CC(CC(C(O)O1)O)=O)=O,,,5,1,2,0,2
44618_0,,,,2,1,2,3
C1(C(C=O)C(CO1)(CO)O)=O,,,5,1,2,0,2
44620_0,,,,2,1,2,3
C(C1COC(C1(CO)O)=O)=O,,,5,1,2,0,2
44621_0,,,,2,1,2,3
44623_0,,,,2,1,2,3
C(C1COC(C1O)=O)=O,,,5,1,2,0,2
44624_0,,,,2,1,2,3
44625_0,,,,2,1,2,3
44627_0,,,,2,1,2,3
C(CO)(C1COC(C1O)=O)=O,,,5,1,2,0,2
44629_0,,,,2,1,2,3
C(C)(C1(COC(C1O)=O)O)=O,,,5,1,2,0,2
44630_0,,,,2,1,2,3
44632_0,,,,2,1,2,3
C(C1C(CO)OC(C1O)=O)=O,,,5,1,2,0,2
44634_0,,,,2,1,2,3
C1(C(CC(CO)(CO)O1)=O)=O,,,5,1,2,0,2
44635_0,,,,2,1,2,3
44637_0,,,,2,1,2,3
C(CC1C(C(OC1)=O)=O)=O,,,5,1,2,0,2
44639_0,,,,2,1,2,3
C(C1C(C(C(O1)=O)=O)C)=O,,,5,1,2,0,2
44640_0,,,,2,1,2,3
44642_0,,,,2,1,2,3
C(C1C(COC(C1O)=O)O)=O,,,5,1,2,0,2
44643_0,,,,2,1,2,3
44645_0,,,,2,1,2,3
C1(C(CC(CO1)(CO)O)=O)=O,,,5,1,2,0,2
44646_0,,,,2,1,2,3
44647_0,,,,2,1,2,3
44649_0,,,,2,1,2,3
C(C1COC(C(C1O)O)=O)=O,,,5,1,2,0,2
44651_0,,,,2,1,2,3
C(C1C(C(OCC1)=O)=O)=O,,,5,1,2,0,2
44653_0,,,,2,1,2,3
C(C1CCC(C(O1)=O)=O)=O,,,5,1,2,0,2
44654_0,,,,2,1,2,3
44656_0,,,,2,1,2,3
C(C(C(C)=O)CCC(C=O)=O)=O,,,5,1,4,0,4
44658_0,,,,2,1,2,3
C(C(C(C)=O)C(C=O)CC=O)=O,,,5,1,4,0,4
44660_0,,,,2,1,2,3
C(C=O)(C(C)CCC(C=O)=O)=O,,,5,1,2,0,2
44662_0,,,,2,1,2,3
C(CC(C=O)C(C(C=O)=O)C)=O,,,5,1,2,0,2
44664_0,,,,2,1,2,3
C(C(CCCCC(C=O)=O)=O)=O,,,5,1,2,0,2
44666_0,,,,2,1,2,3
C(CC(CCCC(C=O)=O)=O)=O,,,5,1,4,0,4
44668_0,,,,2,1,2,3
C(C(CCC(C=O)=O)CC=O)=O,,,5,1,6,0,6
44670_0,,,,2,1,2,3
C(CC(CC(C=O)CC=O)=O)=O,,,5,1,4,0,4
44672_0,,,,2,1,2,3
C(CCC(CCC(C=O)=O)=O)=O,,,5,1,1,0,1
44673_0,,,,2,1,2,3
44675_0,,,,2,1,2,3
C(C(C(CCC=O)=O)CC=O)=O,,,5,1,1,0,1
44676_0,,,,2,1,2,3
44677_0,,,,2,1,2,3
44679_0,,,,2,1,2,3
C(CC(C=O)C(C=O)CC=O)=O,,,5,1,3,0,3
44680_0,,,,2,1,2,3
44681_0,,,,2,1,2,3
44682_0,,,,2,1,2,3
44683_0,,,,2,1,2,3
44684_0,,,,2,1,2,3
44685_0,,,,2,1,2,3
44687_0,,,,2,1,2,3
C(C=O)(CCCC(C(C)=O)=O)=O,,,5,1,3,0,3
44689_0,,,,2,1,2,3
C(CCC(C=O)=O)(CC(C)=O)=O,,,5,1,1,0,1
44691_0,,,,2,1,2,3
C(CC(C=O)CC(C(C)=O)=O)=O,,,5,1,3,0,3
44693_0,,,,2,1,2,3
C(C(C(CC(C)=O)=O)CC=O)=O,,,5,1,1,0,1
44694_0,,,,2,1,2,3
44695_0,,,,2,1,2,3
44696_0,,,,2,1,2,3
44697_0,,,,2,1,2,3
44698_0,,,,2,1,2,3
44699_0,,,,2,1,2,3
44700_0,,,,2,1,2,3
44701_0,,,,2,1,2,3
44702_0,,,,2,1,2,3
44703_0,,,,2,1,2,3
44704_0,,,,2,1,2,3
44705_0,,,,2,1,2,3
44706_0,,,,2,1,2,3
44707_0,,,,2,1,2,3
44708_0,,,,2,1,2,3
44709_0,,,,2,1,2,3
44710_0,,,,2,1,2,3
44711_0,,,,2,1,2,3
44712_0,,,,2,1,2,3
44713_0,,,,2,1,2,3
44714_0,,,,2,1,2,3
44715_0,,,,2,1,2,3
44716_0,,,,2,1,2,3
44717_0,,,,2,1,2,3
44718_0,,,,2,1,2,3
44719_0,,,,2,1,2,3
44720_0,,,,2,1,2,3
44721_0,,,,2,1,2,3
44722_0,,,,2,1,2,3
44723_0,,,,2,1,2,3
44724_0,,,,2,1,2,3
44725_0,,,,2,1,2,3
44726_0,,,,2,1,2,3
44728_0,,,,2,1,2,3
C=C1C(C(C(C1(CO)O)O)O)=O,,,5,1,1,0,1
44730_0,,,,2,1,2,3
C1(CO)C(C(C(C=1CO)=O)O)O,,,5,1,1,0,1
44731_0,,,,2,1,2,3
44732_0,,,,2,1,2,3
44734_0,,,,2,1,2,3
C1C(C(C(C=1C=O)(CO)O)O)O,,,5,1,2,0,2
44736_0,,,,2,1,2,3
C1(CO)C(C(C(C=1C=O)O)O)O,,,5,1,1,0,1
44737_0,,,,2,1,2,3
44738_0,,,,2,1,2,3
44739_0,,,,2,1,2,3
44740_0,,,,2,1,2,3
44742_0,,,,2,1,2,3
C1(CO)C(C(C(C(C=1)=O)O)O)O,,,5,1,1,0,1
44744_0,,,,2,1,2,3
C1(C(C(C(C=1)=O)O)O)C(CO)O,,,5,1,1,0,1
44745_0,,,,2,1,2,3
44746_0,,,,2,1,2,3
44747_0,,,,2,1,2,3
44748_0,,,,2,1,2,3
44750_0,,,,2,1,2,3
C1(CC(C=O)=CC1O)=O,,,5,1,1,0,1
44751_0,,,,2,1,2,3
44753_0,,,,2,1,2,3
C(C1CC(C(C=1)=O)O)=O,,,5,1,1,0,1
44754_0,,,,2,1,2,3
44756_0,,,,2,1,2,3
C1(CC=C(C=O)C1O)=O,,,5,1,1,0,1
44757_0,,,,2,1,2,3
44758_0,,,,2,1,2,3
44760_0,,,,2,1,2,3
C1(C(C(CO)=C(C=O)C1)O)=O,,,5,1,1,0,1
44761_0,,,,2,1,2,3
44762_0,,,,2,1,2,3
44764_0,,,,2,1,2,3
C(C1C(CO)C(C(C=1)=O)O)=O,,,5,1,1,0,1
44765_0,,,,2,1,2,3
44766_0,,,,2,1,2,3
44767_0,,,,2,1,2,3
44768_0,,,,2,1,2,3
44769_0,,,,2,1,2,3
44770_0,,,,2,1,2,3
44771_0,,,,2,1,2,3
44773_0,,,,2,1,2,3
C(C(C1C(C(CC=1)=O)O)O)=O,,,5,1,1,0,1
44774_0,,,,2,1,2,3
44776_0,,,,2,1,2,3
C(C(C1C=CC(C1O)=O)O)=O,,,5,1,1,0,1
44778_0,,,,2,1,2,3
C1(C(C(C(CO)=O)=CC1)O)=O,,,5,1,1,0,1
44779_0,,,,2,1,2,3
44780_0,,,,2,1,2,3
44782_0,,,,2,1,2,3
C1(C(C(C=O)=C(CO)C1)O)=O,,,5,1,1,0,1
44783_0,,,,2,1,2,3
44784_0,,,,2,1,2,3
44785_0,,,,2,1,2,3
44787_0,,,,2,1,2,3
C1(C(C(C(C1)=CC=O)O)O)=O,,,5,1,1,0,1
44789_0,,,,2,1,2,3
C(CC1C(C(C(C=1)=O)O)O)=O,,,5,1,1,0,1
44790_0,,,,2,1,2,3
44791_0,,,,2,1,2,3
44793_0,,,,2,1,2,3
C(C(C1CC(C(C=1)O)=O)O)=O,,,5,1,1,0,1
44794_0,,,,2,1,2,3
44796_0,,,,2,1,2,3
C(C(C1CC(C(C=1)=O)O)O)=O,,,5,1,1,0,1
44798_0,,,,2,1,2,3
C1(CC=CC1O)=O,,,5,1,1,0,1
44799_0,,,,2,1,2,3
44801_0,,,,2,1,2,3
C1CC(C(C=1)=O)O,,,5,1,1,0,1
44802_0,,,,2,1,2,3
44804_0,,,,2,1,2,3
C(C1(C(C(C(C1)O)=O)=C)O)=O,,,5,1,1,0,1
44806_0,,,,2,1,2,3
C(C1CC(C(C=1CO)=O)O)=O,,,5,1,1,0,1
44807_0,,,,2,1,2,3
44809_0,,,,2,1,2,3
C1(C(C=C(C=O)C1CO)O)=O,,,5,1,1,0,1
44810_0,,,,2,1,2,3
44811_0,,,,2,1,2,3
44813_0,,,,2,1,2,3
C1C(CC(C=1C(C=O)=O)O)O,,,5,1,1,0,1
44815_0,,,,2,1,2,3
C1CC(C(C=1C(C=O)=O)O)O,,,5,1,1,0,1
44817_0,,,,2,1,2,3
C(C1(C(C=O)=CC(C1)O)O)=O,,,5,1,2,0,2
44819_0,,,,2,1,2,3
C(C1CC(C(C=1C=O)O)O)=O,,,5,1,1,0,1
44820_0,,,,2,1,2,3
44822_0,,,,2,1,2,3
C(C1C(C=O)=CC(C1O)O)=O,,,5,1,1,0,1
44823_0,,,,2,1,2,3
44824_0,,,,2,1,2,3
44825_0,,,,2,1,2,3
44827_0,,,,2,1,2,3
C(C1CC(C(C(C=1)=O)O)O)=O,,,5,1,1,0,1
44828_0,,,,2,1,2,3
44830_0,,,,2,1,2,3
C1(C(C(C=C(C=O)C1)O)O)=O,,,5,1,1,0,1
44831_0,,,,2,1,2,3
44832_0,,,,2,1,2,3
44833_0,,,,2,1,2,3
44835_0,,,,2,1,2,3
C1(C(C(C=O)=CC1CO)O)=O,,,5,1,1,0,1
44836_0,,,,2,1,2,3
44837_0,,,,2,1,2,3
44838_0,,,,2,1,2,3
44839_0,,,,2,1,2,3
44840_0,,,,2,1,2,3
44841_0,,,,2,1,2,3
44842_0,,,,2,1,2,3
44843_0,,,,2,1,2,3
44845_0,,,,2,1,2,3
C1(C(C=CC1CO)O)=O,,,5,1,1,0,1
44846_0,,,,2,1,2,3
44848_0,,,,2,1,2,3
C1CC(C(C=1CO)=O)O,,,5,1,1,0,1
44850_0,,,,2,1,2,3
C=C1C(C(CC1O)O)=O,,,5,1,1,0,1
44852_0,,,,2,1,2,3
C1C(C(C(C=1CO)=O)O)O,,,5,1,1,0,1
44854_0,,,,2,1,2,3
C=C1C(C(C(C1O)O)O)=O,,,5,1,1,0,1
44855_0,,,,2,1,2,3
44856_0,,,,2,1,2,3
44858_0,,,,2,1,2,3
C1CC(C(C=1C=O)O)O,,,5,1,1,0,1
44860_0,,,,2,1,2,3
C1C(CC(C=1C=O)O)O,,,5,1,2,0,2
44862_0,,,,2,1,2,3
C1C(C(C(C=1C=O)O)O)O,,,5,1,2,0,2
44863_0,,,,2,1,2,3
44864_0,,,,2,1,2,3
44865_0,,,,2,1,2,3
44866_0,,,,2,1,2,3
44867_0,,,,2,1,2,3
44868_0,,,,2,1,2,3
44869_0,,,,2,1,2,3
44871_0,,,,2,1,2,3
C1(CO)C(CO)(C(C(C=1)=O)O)O,,,5,1,1,0,1
44872_0,,,,2,1,2,3
44873_0,,,,2,1,2,3
44874_0,,,,2,1,2,3
44875_0,,,,2,1,2,3
44876_0,,,,2,1,2,3
44877_0,,,,2,1,2,3
44878_0,,,,2,1,2,3
44879_0,,,,2,1,2,3
44880_0,,,,2,1,2,3
44882_0,,,,2,1,2,3
C1C(CO)(C(C(C=1)=O)O)O,,,5,1,1,0,1
44884_0,,,,2,1,2,3
C1C(C(CO)O)(C(C(C=1)=O)O)O,,,5,1,1,0,1
44885_0,,,,2,1,2,3
44886_0,,,,2,1,2,3
44887_0,,,,2,1,2,3
44889_0,,,,2,1,2,3
C1C(CO)(C(C(C=1CO)=O)O)O,,,5,1,1,0,1
44891_0,,,,2,1,2,3
C=C1C(C(C(CO)(C1O)O)O)=O,,,5,1,1,0,1
44893_0,,,,2,1,2,3
C1C(CO)(C(C(C=1C=O)O)O)O,,,5,1,1,0,1
44895_0,,,,2,1,2,3
C1C(C(CO)(C(C=1C=O)O)O)O,,,5,1,2,0,2
44896_0,,,,2,1,2,3
44897_0,,,,2,1,2,3
44899_0,,,,2,1,2,3
C(CC1(C=CC(C1O)=O)O)=O,,,5,1,1,0,1
44900_0,,,,2,1,2,3
44901_0,,,,2,1,2,3
44902_0,,,,2,1,2,3
44904_0,,,,2,1,2,3
C(C1(C=C(C=O)C(C1)O)O)=O,,,5,1,1,0,1
44906_0,,,,2,1,2,3
C(C1C(CC(C=1C=O)O)O)=O,,,5,1,1,0,1
44907_0,,,,2,1,2,3
44908_0,,,,2,1,2,3
44909_0,,,,2,1,2,3
44910_0,,,,2,1,2,3
44911_0,,,,2,1,2,3
44913_0,,,,2,1,2,3
C(C(CC(C=O)=CC=O)O)=O,,,5,1,1,0,1
44915_0,,,,2,1,2,3
C(CC(C=O)=CC(C=O)O)=O,,,5,1,3,0,3
44916_0,,,,2,1,2,3
44918_0,,,,2,1,2,3
C(C(C(C=O)=CC(C=O)O)O)=O,,,5,1,2,0,2
44919_0,,,,2,1,2,3
44920_0,,,,2,1,2,3
44921_0,,,,2,1,2,3
44922_0,,,,2,1,2,3
44923_0,,,,2,1,2,3
44925_0,,,,2,1,2,3
C(C(C(C(C=O)=O)=CC=O)O)=O,,,5,1,1,0,1
44926_0,,,,2,1,2,3
44928_0,,,,2,1,2,3
C(C(C(C(C=O)=O)=CC)O)=O,,,5,1,1,0,1
44930_0,,,,2,1,2,3
C(C(C(C(C)O)=CC=O)=O)=O,,,5,1,1,0,1
44932_0,,,,2,1,2,3
C(C(C(C(C=O)=O)=CCO)O)=O,,,5,1,1,0,1
44934_0,,,,2,1,2,3
C(C(C(C(CO)O)=CC=O)=O)=O,,,5,1,1,0,1
44935_0,,,,2,1,2,3
44936_0,,,,2,1,2,3
44937_0,,,,2,1,2,3
44938_0,,,,2,1,2,3
44939_0,,,,2,1,2,3
44941_0,,,,2,1,2,3
C(C(C(C(C(C=O)O)=O)=C)O)=O,,,5,1,1,0,1
44943_0,,,,2,1,2,3
C(C(C(C(CO)=CC=O)=O)O)=O,,,5,1,1,0,1
44944_0,,,,2,1,2,3
44945_0,,,,2,1,2,3
44946_0,,,,2,1,2,3
44948_0,,,,2,1,2,3
C(CC(CO)(CO)O)=CC=O,,,5,1,1,0,1
44950_0,,,,2,1,2,3
C(CC=CC(CO)(CO)O)=O,,,5,1,1,0,1
44951_0,,,,2,1,2,3
44952_0,,,,2,1,2,3
44953_0,,,,2,1,2,3
44954_0,,,,2,1,2,3
44956_0,,,,2,1,2,3
C(C)=C(C=O)C(CO)(CO)O,,,5,1,1,0,1
44958_0,,,,2,1,2,3
C(CO)(CO)=C(C=O)C(C)O,,,5,1,1,0,1
44959_0,,,,2,1,2,3
44960_0,,,,2,1,2,3
44961_0,,,,2,1,2,3
44962_0,,,,2,1,2,3
44963_0,,,,2,1,2,3
44964_0,,,,2,1,2,3
44966_0,,,,2,1,2,3
C(CO)(C(C=C(C=O)CO)O)=O,,,5,1,1,0,1
44968_0,,,,2,1,2,3
C(CO)(C(C(C)O)O)=CC=O,,,5,1,1,0,1
44969_0,,,,2,1,2,3
44970_0,,,,2,1,2,3
44971_0,,,,2,1,2,3
44972_0,,,,2,1,2,3
44973_0,,,,2,1,2,3
44974_0,,,,2,1,2,3
44975_0,,,,2,1,2,3
44977_0,,,,2,1,2,3
C(C(CO)O)(C(CO)O)=CC=O,,,5,1,1,0,1
44979_0,,,,2,1,2,3
C=C(C=O)C(C(CO)(CO)O)O,,,5,1,1,0,1
44980_0,,,,2,1,2,3
44982_0,,,,2,1,2,3
C(C(C)(CC(C=O)=CC=O)O)=O,,,5,1,1,0,1
44984_0,,,,2,1,2,3
C(C(C=C(C=O)CC=O)(C)O)=O,,,5,1,1,0,1
44985_0,,,,2,1,2,3
44986_0,,,,2,1,2,3
44987_0,,,,2,1,2,3
44988_0,,,,2,1,2,3
44989_0,,,,2,1,2,3
44990_0,,,,2,1,2,3
44991_0,,,,2,1,2,3
44992_0,,,,2,1,2,3
44993_0,,,,2,1,2,3
44995_0,,,,2,1,2,3
C(C(C(C(C=O)=O)=CC)(C)O)=O,,,5,1,1,0,1
44997_0,,,,2,1,2,3
C(C(C(C(C)O)=C(C=O)C)=O)=O,,,5,1,1,0,1
44998_0,,,,2,1,2,3
44999_0,,,,2,1,2,3
45001_0,,,,2,1,2,3
C(C(C(C=O)=CCC=O)(C)O)=O,,,5,1,1,0,1
45002_0,,,,2,1,2,3
45003_0,,,,2,1,2,3
45004_0,,,,2,1,2,3
45005_0,,,,2,1,2,3
45006_0,,,,2,1,2,3
45008_0,,,,2,1,2,3
C(C(C)(CC(C(C=O)=C)O)O)=O,,,5,1,1,0,1
45010_0,,,,2,1,2,3
C(C(C)(CC=C(C=O)CO)O)=O,,,5,1,1,0,1
45012_0,,,,2,1,2,3
C(C(C=CC(C=O)(C)O)CO)=O,,,5,1,1,0,1
45013_0,,,,2,1,2,3
45014_0,,,,2,1,2,3
45016_0,,,,2,1,2,3
C(C(C=CC(C(C)=O)O)(C)O)=O,,,5,1,1,0,1
45017_0,,,,2,1,2,3
45018_0,,,,2,1,2,3
45020_0,,,,2,1,2,3
C(C(C)(CC=CC(CO)=O)O)=O,,,5,1,1,0,1
45022_0,,,,2,1,2,3
C(C(C=CCC(CO)=O)(C)O)=O,,,5,1,1,0,1
45023_0,,,,2,1,2,3
45024_0,,,,2,1,2,3
45026_0,,,,2,1,2,3
C(C(C)(CC=CC(C=O)=O)O)=O,,,5,1,1,0,1
45028_0,,,,2,1,2,3
C(C(C=CCC(C=O)=O)(C)O)=O,,,5,1,1,0,1
45029_0,,,,2,1,2,3
45030_0,,,,2,1,2,3
45032_0,,,,2,1,2,3
C(C(C)(CC=C(C=O)C=O)O)=O,,,5,1,1,0,1
45034_0,,,,2,1,2,3
C(C(C=O)C=CC(C=O)(C)O)=O,,,5,1,1,0,1
45035_0,,,,2,1,2,3
45036_0,,,,2,1,2,3
45038_0,,,,2,1,2,3
C(C(C)(CC=CC=O)O)=O,,,5,1,1,0,1
45040_0,,,,2,1,2,3
C(C(C=CCC=O)(C)O)=O,,,5,1,1,0,1
45041_0,,,,2,1,2,3
45042_0,,,,2,1,2,3
45044_0,,,,2,1,2,3
C(C(C=CC(C=O)O)(C)O)=O,,,5,1,1,0,1
45045_0,,,,2,1,2,3
45046_0,,,,2,1,2,3
45048_0,,,,2,1,2,3
C(CC(C)(C(C(C=O)=C)O)O)=O,,,5,1,1,0,1
45050_0,,,,2,1,2,3
C(CC(C=C(C=O)CO)(C)O)=O,,,5,1,1,0,1
45051_0,,,,2,1,2,3
45052_0,,,,2,1,2,3
45053_0,,,,2,1,2,3
45054_0,,,,2,1,2,3
45056_0,,,,2,1,2,3
C(CC(C=CC(CO)=O)(C)O)=O,,,5,1,1,0,1
45057_0,,,,2,1,2,3
45058_0,,,,2,1,2,3
45059_0,,,,2,1,2,3
45060_0,,,,2,1,2,3
45061_0,,,,2,1,2,3
45062_0,,,,2,1,2,3
45063_0,,,,2,1,2,3
45064_0,,,,2,1,2,3
45065_0,,,,2,1,2,3
45066_0,,,,2,1,2,3
45067_0,,,,2,1,2,3
45068_0,,,,2,1,2,3
45069_0,,,,2,1,2,3
45070_0,,,,2,1,2,3
45072_0,,,,2,1,2,3
C(C(C)(C(C=O)C=CCO)O)=O,,,5,1,1,0,1
45074_0,,,,2,1,2,3
C(C(C(C=O)=CCCO)(C)O)=O,,,5,1,1,0,1
45076_0,,,,2,1,2,3
C(C(C(CCO)O)=C(C=O)C)=O,,,5,1,1,0,1
45077_0,,,,2,1,2,3
45079_0,,,,2,1,2,3
C(C(C)(C(C=O)C(CO)=C)O)=O,,,5,1,1,0,1
45081_0,,,,2,1,2,3
C(C(C(C=O)=C(CO)C)(C)O)=O,,,5,1,1,0,1
45083_0,,,,2,1,2,3
C(C(C(CO)(C)O)=C(C=O)C)=O,,,5,1,1,0,1
45084_0,,,,2,1,2,3
45085_0,,,,2,1,2,3
45086_0,,,,2,1,2,3
45087_0,,,,2,1,2,3
45088_0,,,,2,1,2,3
45090_0,,,,2,1,2,3
C(C(C(C=O)=C(C=O)C)(C)O)=O,,,5,1,1,0,1
45092_0,,,,2,1,2,3
C(C(C(C=O)=CC(C)=O)(C)O)=O,,,5,1,1,0,1
45094_0,,,,2,1,2,3
C(C)(C(C(C=O)=C(C=O)C)O)=O,,,5,1,1,0,1
45095_0,,,,2,1,2,3
45096_0,,,,2,1,2,3
45098_0,,,,2,1,2,3
C(C(C(C=O)=CC)(C)O)=O,,,5,1,1,0,1
45100_0,,,,2,1,2,3
C(C(C(C)O)=C(C=O)C)=O,,,5,1,1,0,1
45101_0,,,,2,1,2,3
45103_0,,,,2,1,2,3
C(C(C(C=O)=C)(C)O)=O,,,5,1,1,0,1
45104_0,,,,2,1,2,3
45105_0,,,,2,1,2,3
45106_0,,,,2,1,2,3
45107_0,,,,2,1,2,3
45108_0,,,,2,1,2,3
45109_0,,,,2,1,2,3
45110_0,,,,2,1,2,3
45111_0,,,,2,1,2,3
45112_0,,,,2,1,2,3
45113_0,,,,2,1,2,3
45114_0,,,,2,1,2,3
45116_0,,,,2,1,2,3
C(C)(C(CC(C=O)=CC=O)O)=O,,,5,1,1,0,1
45118_0,,,,2,1,2,3
C(CC(C=O)=CC(C(C)=O)O)=O,,,5,1,2,0,2
45119_0,,,,2,1,2,3
45120_0,,,,2,1,2,3
45121_0,,,,2,1,2,3
45122_0,,,,2,1,2,3
45124_0,,,,2,1,2,3
C(C)(C(C(C(C=O)=O)=CC)O)=O,,,5,1,1,0,1
45126_0,,,,2,1,2,3
C(C(C(C(C)O)=CC(C)=O)=O)=O,,,5,1,1,0,1
45127_0,,,,2,1,2,3
45128_0,,,,2,1,2,3
45129_0,,,,2,1,2,3
45130_0,,,,2,1,2,3
45132_0,,,,2,1,2,3
C(CC=C(C=O)C(C(C)=O)O)=O,,,5,1,1,0,1
45133_0,,,,2,1,2,3
45134_0,,,,2,1,2,3
45135_0,,,,2,1,2,3
45136_0,,,,2,1,2,3
45138_0,,,,2,1,2,3
C(C)(C(CC(C(C=O)=C)O)O)=O,,,5,1,1,0,1
45140_0,,,,2,1,2,3
C(C)(C(CC=C(C=O)CO)O)=O,,,5,1,1,0,1
45142_0,,,,2,1,2,3
C(C(C=CC(C(C)=O)O)CO)=O,,,5,1,1,0,1
45143_0,,,,2,1,2,3
45145_0,,,,2,1,2,3
C(C)(C(C=CC(C(C)=O)O)O)=O,,,5,1,1,0,1
45146_0,,,,2,1,2,3
45148_0,,,,2,1,2,3
C(C)(C(CC=CC(CO)=O)O)=O,,,5,1,1,0,1
45150_0,,,,2,1,2,3
C(CO)(CC=CC(C(C)=O)O)=O,,,5,1,1,0,1
45151_0,,,,2,1,2,3
45153_0,,,,2,1,2,3
C(C)(C(CC=CC(C=O)=O)O)=O,,,5,1,1,0,1
45155_0,,,,2,1,2,3
C(C)(C(C=CCC(C=O)=O)O)=O,,,5,1,2,0,2
45156_0,,,,2,1,2,3
45158_0,,,,2,1,2,3
C(C)(C(CC=C(C=O)C=O)O)=O,,,5,1,1,0,1
45160_0,,,,2,1,2,3
C(C(C=O)C=CC(C(C)=O)O)=O,,,5,1,1,0,1
45161_0,,,,2,1,2,3
45163_0,,,,2,1,2,3
C(C)(C(CC=CC=O)O)=O,,,5,1,1,0,1
45165_0,,,,2,1,2,3
C(CC=CC(C(C)=O)O)=O,,,5,1,1,0,1
45166_0,,,,2,1,2,3
45168_0,,,,2,1,2,3
C(C(C=CC(C(C)=O)O)O)=O,,,5,1,2,0,2
45169_0,,,,2,1,2,3
45171_0,,,,2,1,2,3
C(CC(C(C(C=O)=C)(C)O)O)=O,,,5,1,1,0,1
45173_0,,,,2,1,2,3
C(CC(C(C)=C(C=O)CO)O)=O,,,5,1,1,0,1
45174_0,,,,2,1,2,3
45176_0,,,,2,1,2,3
C(CC(C(C(C=O)CO)=C)O)=O,,,5,1,1,0,1
45177_0,,,,2,1,2,3
45179_0,,,,2,1,2,3
C(CC(C(C(C(C)=O)O)=C)O)=O,,,5,1,1,0,1
45181_0,,,,2,1,2,3
C(CC(C(C)=CC(CO)=O)O)=O,,,5,1,1,0,1
45182_0,,,,2,1,2,3
45184_0,,,,2,1,2,3
C(CC(C(CC(CO)=O)=C)O)=O,,,5,1,1,0,1
45185_0,,,,2,1,2,3
45187_0,,,,2,1,2,3
C(C(C=CCO)C(C(C)=O)O)=O,,,5,1,1,0,1
45189_0,,,,2,1,2,3
C(C)(C(C(C=O)=CCCO)O)=O,,,5,1,1,0,1
45191_0,,,,2,1,2,3
C(C(C(CCO)O)=CC(C)=O)=O,,,5,1,1,0,1
45193_0,,,,2,1,2,3
C(C(C(CO)=C)C(C(C)=O)O)=O,,,5,1,1,0,1
45195_0,,,,2,1,2,3
C(C)(C(C(C=O)=C(CO)C)O)=O,,,5,1,1,0,1
45197_0,,,,2,1,2,3
C(C(C(CO)(C)O)=CC(C)=O)=O,,,5,1,1,0,1
45198_0,,,,2,1,2,3
45199_0,,,,2,1,2,3
45201_0,,,,2,1,2,3
C(C)(C(C(C=O)=CC(C)=O)O)=O,,,5,1,1,0,1
45202_0,,,,2,1,2,3
45204_0,,,,2,1,2,3
C(C)(C(C(C=O)=CC)O)=O,,,5,1,1,0,1
45206_0,,,,2,1,2,3
C(C(C(C)O)=CC(C)=O)=O,,,5,1,1,0,1
45208_0,,,,2,1,2,3
C(C)(C(C(C=O)=C)O)=O,,,5,1,2,0,2
45209_0,,,,2,1,2,3
45210_0,,,,2,1,2,3
45211_0,,,,2,1,2,3
45212_0,,,,2,1,2,3
45214_0,,,,2,1,2,3
C(CC(C(CC=CCO)=O)O)=O,,,5,1,1,0,1
45215_0,,,,2,1,2,3
45217_0,,,,2,1,2,3
C(CC(C(C=CCCO)=O)O)=O,,,5,1,1,0,1
45219_0,,,,2,1,2,3
C(CC(C(CC(CO)=C)=O)O)=O,,,5,1,1,0,1
45220_0,,,,2,1,2,3
45222_0,,,,2,1,2,3
C(CC(C(C=C(C)CO)=O)O)=O,,,5,1,1,0,1
45223_0,,,,2,1,2,3
45225_0,,,,2,1,2,3
C(CC(C(C=CC(O)=O)=O)O)=O,,,5,1,1,0,1
45226_0,,,,2,1,2,3
45227_0,,,,2,1,2,3
45228_0,,,,2,1,2,3
45229_0,,,,2,1,2,3
45230_0,,,,2,1,2,3
45231_0,,,,2,1,2,3
45232_0,,,,2,1,2,3
45233_0,,,,2,1,2,3
45234_0,,,,2,1,2,3
45235_0,,,,2,1,2,3
45236_0,,,,2,1,2,3
45237_0,,,,2,1,2,3
45238_0,,,,2,1,2,3
45239_0,,,,2,1,2,3
45240_0,,,,2,1,2,3
45241_0,,,,2,1,2,3
45243_0,,,,2,1,2,3
C(CC(CC(C=O)=CC=O)O)=O,,,5,1,1,0,1
45244_0,,,,2,1,2,3
45245_0,,,,2,1,2,3
45247_0,,,,2,1,2,3
C(CC(C=O)=CC(CC=O)O)=O,,,5,1,2,0,2
45248_0,,,,2,1,2,3
45249_0,,,,2,1,2,3
45251_0,,,,2,1,2,3
C(CC(C=O)=O)=C(C=O)C(C)O,,,5,1,2,0,2
45252_0,,,,2,1,2,3
45253_0,,,,2,1,2,3
45255_0,,,,2,1,2,3
C(CC(C=O)=O)=C(C=O)CO,,,5,1,2,0,2
45256_0,,,,2,1,2,3
45257_0,,,,2,1,2,3
45258_0,,,,2,1,2,3
45260_0,,,,2,1,2,3
C(CC(C(C(C=O)=O)=CC)O)=O,,,5,1,1,0,1
45262_0,,,,2,1,2,3
C(CC=C(C(C=O)=O)C(C)O)=O,,,5,1,1,0,1
45264_0,,,,2,1,2,3
C(C(C(C=O)=C)(CC(C)O)O)=O,,,5,1,1,0,1
45266_0,,,,2,1,2,3
C(C(CC(C)O)=C(C=O)CO)=O,,,5,1,1,0,1
45267_0,,,,2,1,2,3
45268_0,,,,2,1,2,3
45270_0,,,,2,1,2,3
C(C(C(C=O)=CC(C)O)CO)=O,,,5,1,1,0,1
45271_0,,,,2,1,2,3
45272_0,,,,2,1,2,3
45274_0,,,,2,1,2,3
C(C)(C(C(C=O)=CC(C)O)O)=O,,,5,1,1,0,1
45276_0,,,,2,1,2,3
C(C(CC(C)O)=CC(CO)=O)=O,,,5,1,1,0,1
45277_0,,,,2,1,2,3
45278_0,,,,2,1,2,3
45280_0,,,,2,1,2,3
C(CO)(CC(C=O)=CC(C)O)=O,,,5,1,1,0,1
45282_0,,,,2,1,2,3
C(C(C=C(C=O)CC(C)O)=O)=O,,,5,1,1,0,1
45283_0,,,,2,1,2,3
45284_0,,,,2,1,2,3
45286_0,,,,2,1,2,3
C(C(C)O)=C(C=O)CC(C=O)=O,,,5,1,1,0,1
45288_0,,,,2,1,2,3
C(C(C=O)=C(C=O)CC(C)O)=O,,,5,1,1,0,1
45289_0,,,,2,1,2,3
45290_0,,,,2,1,2,3
45292_0,,,,2,1,2,3
C(C(C=O)C(C=O)=CC(C)O)=O,,,5,1,1,0,1
45294_0,,,,2,1,2,3
C(C=C(C=O)CC(C)O)=O,,,5,1,1,0,1
45295_0,,,,2,1,2,3
45296_0,,,,2,1,2,3
45298_0,,,,2,1,2,3
C(CC(C=O)=CC(C)O)=O,,,5,1,1,0,1
45299_0,,,,2,1,2,3
45300_0,,,,2,1,2,3
45302_0,,,,2,1,2,3
C(C(C(C=O)=CC(C)O)O)=O,,,5,1,1,0,1
45304_0,,,,2,1,2,3
C(CC(C)O)(C(C(C=O)=C)O)=O,,,5,1,1,0,1
45306_0,,,,2,1,2,3
C(C=C(C=O)CO)(CC(C)O)=O,,,5,1,1,0,1
45307_0,,,,2,1,2,3
45308_0,,,,2,1,2,3
45309_0,,,,2,1,2,3
45310_0,,,,2,1,2,3
45312_0,,,,2,1,2,3
C(C=CC(CO)=O)(CC(C)O)=O,,,5,1,1,0,1
45313_0,,,,2,1,2,3
45314_0,,,,2,1,2,3
45315_0,,,,2,1,2,3
45317_0,,,,2,1,2,3
C(C(C(C=O)=O)C(C)O)=CCO,,,5,1,1,0,1
45318_0,,,,2,1,2,3
45320_0,,,,2,1,2,3
C(CCO)=C(C(C=O)=O)C(C)O,,,5,1,1,0,1
45322_0,,,,2,1,2,3
C(C)=C(C(C=O)=O)C(CCO)O,,,5,1,1,0,1
45324_0,,,,2,1,2,3
C=C(CO)C(C(C=O)=O)C(C)O,,,5,1,1,0,1
45325_0,,,,2,1,2,3
45327_0,,,,2,1,2,3
C(CO)(C)=C(C(C=O)=O)C(C)O,,,5,1,1,0,1
45329_0,,,,2,1,2,3
C(C)=C(C(C=O)=O)C(CO)(C)O,,,5,1,1,0,1
45330_0,,,,2,1,2,3
45332_0,,,,2,1,2,3
C(C(C(C(C)O)=CC(O)=O)=O)=O,,,5,1,1,0,1
45334_0,,,,2,1,2,3
C(C(C(C(C=O)=O)=CC)O)(O)=O,,,5,1,1,0,1
45335_0,,,,2,1,2,3
45337_0,,,,2,1,2,3
C(C)=C(C(C=O)=O)C(C)O,,,5,1,1,0,1
45338_0,,,,2,1,2,3
45340_0,,,,2,1,2,3
C(CO)=C(C(C=O)=O)C(C)O,,,5,1,1,0,1
45342_0,,,,2,1,2,3
C(C)=C(C(C=O)=O)C(CO)O,,,5,1,1,0,1
45344_0,,,,2,1,2,3
C(C=C(C=O)CC(CO)O)=O,,,5,1,1,0,1
45345_0,,,,2,1,2,3
45347_0,,,,2,1,2,3
C(CC(C=O)=CC(CO)O)=O,,,5,1,2,0,2
45348_0,,,,2,1,2,3
45349_0,,,,2,1,2,3
45351_0,,,,2,1,2,3
C(CO)=C(C(C=O)=O)C(CO)O,,,5,1,1,0,1
45352_0,,,,2,1,2,3
45353_0,,,,2,1,2,3
45354_0,,,,2,1,2,3
45355_0,,,,2,1,2,3
45356_0,,,,2,1,2,3
45357_0,,,,2,1,2,3
45358_0,,,,2,1,2,3
45359_0,,,,2,1,2,3
45360_0,,,,2,1,2,3
45362_0,,,,2,1,2,3
C(C(C=O)C=C(C=O)C(C)O)=O,,,5,1,1,0,1
45363_0,,,,2,1,2,3
45364_0,,,,2,1,2,3
45366_0,,,,2,1,2,3
C(C(C=O)C=C(C=O)CO)=O,,,5,1,1,0,1
45368_0,,,,2,1,2,3
C(CC(CC(C(C=O)=C)O)O)=O,,,5,1,1,0,1
45370_0,,,,2,1,2,3
C(CC(CC=C(C=O)CO)O)=O,,,5,1,1,0,1
45372_0,,,,2,1,2,3
C(CC(C=CC(C=O)CO)O)=O,,,5,1,1,0,1
45373_0,,,,2,1,2,3
45374_0,,,,2,1,2,3
45375_0,,,,2,1,2,3
45376_0,,,,2,1,2,3
45377_0,,,,2,1,2,3
45378_0,,,,2,1,2,3
45379_0,,,,2,1,2,3
45380_0,,,,2,1,2,3
45381_0,,,,2,1,2,3
45382_0,,,,2,1,2,3
45383_0,,,,2,1,2,3
45384_0,,,,2,1,2,3
45385_0,,,,2,1,2,3
45386_0,,,,2,1,2,3
45387_0,,,,2,1,2,3
45389_0,,,,2,1,2,3
C(CC(C(C=O)C=CCO)O)=O,,,5,1,1,0,1
45391_0,,,,2,1,2,3
C(CC(C(C=O)=CCCO)O)=O,,,5,1,1,0,1
45393_0,,,,2,1,2,3
C(CC=C(C=O)C(CCO)O)=O,,,5,1,1,0,1
45394_0,,,,2,1,2,3
45396_0,,,,2,1,2,3
C(CC(C(C=O)C(CO)=C)O)=O,,,5,1,1,0,1
45398_0,,,,2,1,2,3
C(CC(C(C=O)=C(C)CO)O)=O,,,5,1,1,0,1
45400_0,,,,2,1,2,3
C(CC=C(C=O)C(CO)(C)O)=O,,,5,1,1,0,1
45401_0,,,,2,1,2,3
45402_0,,,,2,1,2,3
45403_0,,,,2,1,2,3
45404_0,,,,2,1,2,3
45405_0,,,,2,1,2,3
45406_0,,,,2,1,2,3
45408_0,,,,2,1,2,3
C(CC=C(C=O)C(C)O)=O,,,5,1,1,0,1
45409_0,,,,2,1,2,3
45410_0,,,,2,1,2,3
45411_0,,,,2,1,2,3
45412_0,,,,2,1,2,3
45413_0,,,,2,1,2,3
45414_0,,,,2,1,2,3
45415_0,,,,2,1,2,3
45416_0,,,,2,1,2,3
45417_0,,,,2,1,2,3
45418_0,,,,2,1,2,3
45419_0,,,,2,1,2,3
45420_0,,,,2,1,2,3
45422_0,,,,2,1,2,3
C(C(C=C(C=O)C(C)O)O)=O,,,5,1,1,0,1
45423_0,,,,2,1,2,3
45424_0,,,,2,1,2,3
45425_0,,,,2,1,2,3
45427_0,,,,2,1,2,3
C(C(C=C(C=O)C(CO)O)O)=O,,,5,1,1,0,1
45428_0,,,,2,1,2,3
45430_0,,,,2,1,2,3
C(C(C=C(C=O)CO)C(C)O)=O,,,5,1,1,0,1
45431_0,,,,2,1,2,3
45432_0,,,,2,1,2,3
45434_0,,,,2,1,2,3
C(C(C=C(C=O)C(C)O)CO)=O,,,5,1,1,0,1
45435_0,,,,2,1,2,3
45436_0,,,,2,1,2,3
45438_0,,,,2,1,2,3
C(C)(C(C=C(C=O)C(C)O)O)=O,,,5,1,1,0,1
45439_0,,,,2,1,2,3
45440_0,,,,2,1,2,3
45441_0,,,,2,1,2,3
45443_0,,,,2,1,2,3
C(CO)(CC=C(C=O)C(C)O)=O,,,5,1,1,0,1
45444_0,,,,2,1,2,3
45446_0,,,,2,1,2,3
C(C(C=C(C=O)CO)CO)=O,,,5,1,1,0,1
45447_0,,,,2,1,2,3
45449_0,,,,2,1,2,3
C(C(C(C=O)=O)O)=C(C=O)CO,,,5,1,1,0,1
45450_0,,,,2,1,2,3
45451_0,,,,2,1,2,3
45452_0,,,,2,1,2,3
45453_0,,,,2,1,2,3
45454_0,,,,2,1,2,3
45456_0,,,,2,1,2,3
C(C(C=CC(C(O)=O)=O)CO)=O,,,5,1,1,0,1
45457_0,,,,2,1,2,3
45459_0,,,,2,1,2,3
C(CC(C(O)=O)=O)=C(C=O)CO,,,5,1,1,0,1
45461_0,,,,2,1,2,3
C(C(C=C(C(O)=O)C=O)CO)=O,,,5,1,1,0,1
45462_0,,,,2,1,2,3
45464_0,,,,2,1,2,3
C(C(C=O)C=C(C=O)CO)(O)=O,,,5,1,1,0,1
45466_0,,,,2,1,2,3
C(C(CCO)(CC=CC=O)O)=O,,,5,1,1,0,1
45468_0,,,,2,1,2,3
C(C(C=CCC=O)(CCO)O)=O,,,5,1,1,0,1
45469_0,,,,2,1,2,3
45470_0,,,,2,1,2,3
45471_0,,,,2,1,2,3
45472_0,,,,2,1,2,3
45473_0,,,,2,1,2,3
45474_0,,,,2,1,2,3
45475_0,,,,2,1,2,3
45476_0,,,,2,1,2,3
45478_0,,,,2,1,2,3
C(C(C(C=O)=CC)(CCO)O)=O,,,5,1,1,0,1
45480_0,,,,2,1,2,3
C(C(CCO)=C(C=O)C(C)O)=O,,,5,1,1,0,1
45481_0,,,,2,1,2,3
45482_0,,,,2,1,2,3
45483_0,,,,2,1,2,3
45484_0,,,,2,1,2,3
45485_0,,,,2,1,2,3
45486_0,,,,2,1,2,3
45488_0,,,,2,1,2,3
C(C(CC=CC=O)O)(CCO)=O,,,5,1,1,0,1
45490_0,,,,2,1,2,3
C(CC=CC(C(CCO)=O)O)=O,,,5,1,1,0,1
45491_0,,,,2,1,2,3
45492_0,,,,2,1,2,3
45493_0,,,,2,1,2,3
45495_0,,,,2,1,2,3
C(CCO)(C(C(C=O)=CC)O)=O,,,5,1,1,0,1
45497_0,,,,2,1,2,3
C(C=C(C=O)C(C)O)(CCO)=O,,,5,1,1,0,1
45498_0,,,,2,1,2,3
45499_0,,,,2,1,2,3
45500_0,,,,2,1,2,3
45501_0,,,,2,1,2,3
45502_0,,,,2,1,2,3
45503_0,,,,2,1,2,3
45504_0,,,,2,1,2,3
45505_0,,,,2,1,2,3
45506_0,,,,2,1,2,3
45507_0,,,,2,1,2,3
45508_0,,,,2,1,2,3
45510_0,,,,2,1,2,3
C(C=C(C=O)C(CO)C(C)O)=O,,,5,1,1,0,1
45511_0,,,,2,1,2,3
45512_0,,,,2,1,2,3
45514_0,,,,2,1,2,3
C(CC(C=O)=C(CO)C(C)O)=O,,,5,1,1,0,1
45515_0,,,,2,1,2,3
45517_0,,,,2,1,2,3
C(C=C(C=O)C(CO)CO)=O,,,5,1,1,0,1
45518_0,,,,2,1,2,3
45520_0,,,,2,1,2,3
C(CC(C=O)=C(CO)CO)=O,,,5,1,2,0,2
45521_0,,,,2,1,2,3
45522_0,,,,2,1,2,3
45523_0,,,,2,1,2,3
45524_0,,,,2,1,2,3
45525_0,,,,2,1,2,3
45526_0,,,,2,1,2,3
45527_0,,,,2,1,2,3
45528_0,,,,2,1,2,3
45529_0,,,,2,1,2,3
45530_0,,,,2,1,2,3
45531_0,,,,2,1,2,3
45532_0,,,,2,1,2,3
45533_0,,,,2,1,2,3
45535_0,,,,2,1,2,3
C(C(CC(CC=CC=O)O)O)=O,,,5,1,1,0,1
45537_0,,,,2,1,2,3
C(CC=CC(CC(C=O)O)O)=O,,,5,1,1,0,1
45538_0,,,,2,1,2,3
45539_0,,,,2,1,2,3
45540_0,,,,2,1,2,3
45541_0,,,,2,1,2,3
45543_0,,,,2,1,2,3
C(C(CC(C(C=O)=CC)O)O)=O,,,5,1,1,0,1
45545_0,,,,2,1,2,3
C(C(CC=C(C=O)C(C)O)O)=O,,,5,1,1,0,1
45546_0,,,,2,1,2,3
45547_0,,,,2,1,2,3
45549_0,,,,2,1,2,3
C(C(CC(C(C=O)=C)O)O)=O,,,5,1,1,0,1
45550_0,,,,2,1,2,3
45551_0,,,,2,1,2,3
45552_0,,,,2,1,2,3
45554_0,,,,2,1,2,3
C(C(C(C=CC=O)C(C)O)O)=O,,,5,1,1,0,1
45555_0,,,,2,1,2,3
45556_0,,,,2,1,2,3
45557_0,,,,2,1,2,3
45559_0,,,,2,1,2,3
C(CC=C(C(C)O)C(C=O)O)=O,,,5,1,1,0,1
45560_0,,,,2,1,2,3
45561_0,,,,2,1,2,3
45562_0,,,,2,1,2,3
45563_0,,,,2,1,2,3
45564_0,,,,2,1,2,3
45565_0,,,,2,1,2,3
45567_0,,,,2,1,2,3
C(C(C=C(CO)C(C=O)O)O)=O,,,5,1,2,0,2
45568_0,,,,2,1,2,3
45569_0,,,,2,1,2,3
45570_0,,,,2,1,2,3
45571_0,,,,2,1,2,3
45572_0,,,,2,1,2,3
45573_0,,,,2,1,2,3
45574_0,,,,2,1,2,3
45576_0,,,,2,1,2,3
C(CC=C(C(CO)=O)C(C)O)=O,,,5,1,1,0,1
45577_0,,,,2,1,2,3
45578_0,,,,2,1,2,3
45579_0,,,,2,1,2,3
45580_0,,,,2,1,2,3
45581_0,,,,2,1,2,3
45582_0,,,,2,1,2,3
45583_0,,,,2,1,2,3
45584_0,,,,2,1,2,3
45585_0,,,,2,1,2,3
45587_0,,,,2,1,2,3
C(C(C=C(C(CO)=O)CO)O)=O,,,5,1,1,0,1
45588_0,,,,2,1,2,3
45589_0,,,,2,1,2,3
45590_0,,,,2,1,2,3
45592_0,,,,2,1,2,3
C(CC(CO)=C(C=O)C(C)O)=O,,,5,1,1,0,1
45593_0,,,,2,1,2,3
45594_0,,,,2,1,2,3
45595_0,,,,2,1,2,3
45596_0,,,,2,1,2,3
45597_0,,,,2,1,2,3
45599_0,,,,2,1,2,3
C(C(C(CO)=C(C=O)CO)O)=O,,,5,1,1,0,1
45600_0,,,,2,1,2,3
45601_0,,,,2,1,2,3
45602_0,,,,2,1,2,3
45603_0,,,,2,1,2,3
45604_0,,,,2,1,2,3
45605_0,,,,2,1,2,3
45606_0,,,,2,1,2,3
45607_0,,,,2,1,2,3
45608_0,,,,2,1,2,3
45610_0,,,,2,1,2,3
C(CC(C(C(C)O)O)=CC=O)=O,,,5,1,1,0,1
45611_0,,,,2,1,2,3
45613_0,,,,2,1,2,3
C(CC(C(CO)O)=CC=O)=O,,,5,1,1,0,1
45615_0,,,,2,1,2,3
C(C(C(C(CO)O)=CC=O)O)=O,,,5,1,1,0,1
45616_0,,,,2,1,2,3
45617_0,,,,2,1,2,3
45618_0,,,,2,1,2,3
45619_0,,,,2,1,2,3
45620_0,,,,2,1,2,3
45621_0,,,,2,1,2,3
45622_0,,,,2,1,2,3
45623_0,,,,2,1,2,3
45624_0,,,,2,1,2,3
45626_0,,,,2,1,2,3
C(C(C(C)(CC=CC=O)O)O)=O,,,5,1,1,0,1
45628_0,,,,2,1,2,3
C(CC=CC(C)(C(C=O)O)O)=O,,,5,1,1,0,1
45629_0,,,,2,1,2,3
45630_0,,,,2,1,2,3
45631_0,,,,2,1,2,3
45633_0,,,,2,1,2,3
C(C(C(C(C=O)=CC)(C)O)O)=O,,,5,1,1,0,1
45635_0,,,,2,1,2,3
C(C(C(C)=C(C=O)C(C)O)O)=O,,,5,1,1,0,1
45636_0,,,,2,1,2,3
45638_0,,,,2,1,2,3
C(C(C(C(C=O)=C)(C)O)O)=O,,,5,1,1,0,1
45639_0,,,,2,1,2,3
45640_0,,,,2,1,2,3
45642_0,,,,2,1,2,3
C(C(C(CC(C)O)=CC=O)O)=O,,,5,1,1,0,1
45643_0,,,,2,1,2,3
45644_0,,,,2,1,2,3
45646_0,,,,2,1,2,3
C(CC(C(C=O)O)=CC(C)O)=O,,,5,1,1,0,1
45647_0,,,,2,1,2,3
45649_0,,,,2,1,2,3
C(C(C(C(C(C)O)=CC)=O)O)=O,,,5,1,1,0,1
45650_0,,,,2,1,2,3
45652_0,,,,2,1,2,3
C(C(C(C(C(C)O)=C)=O)O)=O,,,5,1,1,0,1
45654_0,,,,2,1,2,3
C(C(C(C(CO)=CC)=O)O)=O,,,5,1,1,0,1
45656_0,,,,2,1,2,3
C(C(C(CCO)=CC=O)O)=O,,,5,1,1,0,1
45657_0,,,,2,1,2,3
45659_0,,,,2,1,2,3
C(CC(C(C=O)O)=CCO)=O,,,5,1,1,0,1
45660_0,,,,2,1,2,3
45662_0,,,,2,1,2,3
C(C(C(C(C=O)O)=CCO)O)=O,,,5,1,1,0,1
45664_0,,,,2,1,2,3
C(C(C(C(CO)=C)=O)O)=O,,,5,1,1,0,1
45666_0,,,,2,1,2,3
C(C(C(C(CO)=CCO)=O)O)=O,,,5,1,1,0,1
45668_0,,,,2,1,2,3
C(C(C(C(C(CO)O)=C)=O)O)=O,,,5,1,1,0,1
45670_0,,,,2,1,2,3
C(C)=C(C=O)C(CC(C)O)O,,,5,1,1,0,1
45672_0,,,,2,1,2,3
C(CC(C)O)=C(C=O)C(C)O,,,5,1,1,0,1
45673_0,,,,2,1,2,3
45675_0,,,,2,1,2,3
C(C(C=CC(C)O)C(C)O)=O,,,5,1,1,0,1
45676_0,,,,2,1,2,3
45677_0,,,,2,1,2,3
45679_0,,,,2,1,2,3
C=C(C=O)C(CC(C)O)O,,,5,1,1,0,1
45681_0,,,,2,1,2,3
C(CC(C)O)=C(C=O)CO,,,5,1,1,0,1
45683_0,,,,2,1,2,3
C(C(C=CC(C)O)CO)=O,,,5,1,1,0,1
45684_0,,,,2,1,2,3
45685_0,,,,2,1,2,3
45687_0,,,,2,1,2,3
C(CO)=C(C=O)C(CC(C)O)O,,,5,1,2,0,2
45689_0,,,,2,1,2,3
C(CC(C)O)=C(C=O)C(CO)O,,,5,1,1,0,1
45691_0,,,,2,1,2,3
C(C(C=CC(C)O)C(CO)O)=O,,,5,1,1,0,1
45692_0,,,,2,1,2,3
45693_0,,,,2,1,2,3
45695_0,,,,2,1,2,3
C(C(C(C=O)=O)O)=CC(C)O,,,5,1,1,0,1
45696_0,,,,2,1,2,3
45697_0,,,,2,1,2,3
45699_0,,,,2,1,2,3
C(C(C)O)=CC(C(C(C)=O)=O)O,,,5,1,1,0,1
45700_0,,,,2,1,2,3
45701_0,,,,2,1,2,3
45703_0,,,,2,1,2,3
C(CC(C)O)=CC(C(CO)=O)=O,,,5,1,1,0,1
45705_0,,,,2,1,2,3
C(C(C)O)=CCC(C(CO)=O)=O,,,5,1,1,0,1
45706_0,,,,2,1,2,3
45707_0,,,,2,1,2,3
45709_0,,,,2,1,2,3
C(C)(C(C=CC(C)O)O)=O,,,5,1,1,0,1
45710_0,,,,2,1,2,3
45711_0,,,,2,1,2,3
45713_0,,,,2,1,2,3
C(CC(C)O)=CC(CO)=O,,,5,1,1,0,1
45715_0,,,,2,1,2,3
C(CO)(CC=CC(C)O)=O,,,5,1,1,0,1
45716_0,,,,2,1,2,3
45717_0,,,,2,1,2,3
45718_0,,,,2,1,2,3
45720_0,,,,2,1,2,3
C(CCO)(C(C=CC(C)O)O)=O,,,5,1,1,0,1
45721_0,,,,2,1,2,3
45722_0,,,,2,1,2,3
45724_0,,,,2,1,2,3
C=C(C(CO)=O)C(CC(C)O)O,,,5,1,1,0,1
45726_0,,,,2,1,2,3
C(CC(C)O)=C(C(CO)=O)CO,,,5,1,1,0,1
45728_0,,,,2,1,2,3
C(CO)(C(C=CC(C)O)CO)=O,,,5,1,1,0,1
45729_0,,,,2,1,2,3
45730_0,,,,2,1,2,3
45732_0,,,,2,1,2,3
C(CC(C)O)=CC(C(CO)O)=O,,,5,1,1,0,1
45734_0,,,,2,1,2,3
C(C(CO)O)(CC=CC(C)O)=O,,,5,1,1,0,1
45735_0,,,,2,1,2,3
45736_0,,,,2,1,2,3
45738_0,,,,2,1,2,3
C(CC(C)O)=CC(C(O)=O)=O,,,5,1,1,0,1
45740_0,,,,2,1,2,3
C(CC(C(O)=O)=O)=CC(C)O,,,5,1,1,0,1
45741_0,,,,2,1,2,3
45742_0,,,,2,1,2,3
45744_0,,,,2,1,2,3
C(CC(C)O)=C(C(O)=O)C=O,,,5,1,1,0,1
45746_0,,,,2,1,2,3
C(C(C=O)C=CC(C)O)(O)=O,,,5,1,1,0,1
45747_0,,,,2,1,2,3
45748_0,,,,2,1,2,3
45750_0,,,,2,1,2,3
C1(C(COC1C=CC(C)O)O)=O,,,5,1,1,0,1
45751_0,,,,2,1,2,3
45752_0,,,,2,1,2,3
45754_0,,,,2,1,2,3
C(CC(C)O)=C1C(C(OC1)O)=O,,,5,1,1,0,1
45756_0,,,,2,1,2,3
C1(C(O)OCC1C=CC(C)O)=O,,,5,1,1,0,1
45757_0,,,,2,1,2,3
45758_0,,,,2,1,2,3
45760_0,,,,2,1,2,3
C1OCC(C=1C(CC(C)O)O)=O,,,5,1,1,0,1
45762_0,,,,2,1,2,3
C(CC(C)O)=C1C(COC1O)=O,,,5,1,1,0,1
45764_0,,,,2,1,2,3
C1(COC(C1C=CC(C)O)O)=O,,,5,1,1,0,1
45765_0,,,,2,1,2,3
45766_0,,,,2,1,2,3
45767_0,,,,2,1,2,3
45769_0,,,,2,1,2,3
C1(CC(OC1C=CC(C)O)O)=O,,,5,1,1,0,1
45770_0,,,,2,1,2,3
45771_0,,,,2,1,2,3
45773_0,,,,2,1,2,3
C(CO)(C(C=CC(C)O)O)=O,,,5,1,1,0,1
45774_0,,,,2,1,2,3
45775_0,,,,2,1,2,3
45777_0,,,,2,1,2,3
C(CC(C)O)=CC(C=O)=O,,,5,1,1,0,1
45779_0,,,,2,1,2,3
C(CC(C=O)=O)=CC(C)O,,,5,1,1,0,1
45780_0,,,,2,1,2,3
45781_0,,,,2,1,2,3
45783_0,,,,2,1,2,3
C(CC(C)O)=C(C=O)C=O,,,5,1,1,0,1
45785_0,,,,2,1,2,3
C(C(C=O)C=CC(C)O)=O,,,5,1,1,0,1
45786_0,,,,2,1,2,3
45787_0,,,,2,1,2,3
45789_0,,,,2,1,2,3
C=C(C(C=O)=O)C(CC(C)O)O,,,5,1,2,0,2
45791_0,,,,2,1,2,3
C(CC(C)O)=C(C(C=O)=O)CO,,,5,1,1,0,1
45793_0,,,,2,1,2,3
C(C(C(C=O)=O)CO)=CC(C)O,,,5,1,1,0,1
45794_0,,,,2,1,2,3
45795_0,,,,2,1,2,3
45797_0,,,,2,1,2,3
C(C=C(C=O)C(CC(C)O)O)=O,,,5,1,2,0,2
45799_0,,,,2,1,2,3
C(C(C(C=O)=CCC(C)O)O)=O,,,5,1,1,0,1
45801_0,,,,2,1,2,3
C(C(C=CC(C)O)C(C=O)O)=O,,,5,1,1,0,1
45802_0,,,,2,1,2,3
45803_0,,,,2,1,2,3
45805_0,,,,2,1,2,3
C(CC(C)O)=C(C=O)C(CO)=O,,,5,1,1,0,1
45807_0,,,,2,1,2,3
C(C(C(CO)=O)C=CC(C)O)=O,,,5,1,1,0,1
45808_0,,,,2,1,2,3
45809_0,,,,2,1,2,3
45811_0,,,,2,1,2,3
C(CC(C(C=CC(C)O)O)=O)=O,,,5,1,1,0,1
45812_0,,,,2,1,2,3
45813_0,,,,2,1,2,3
45815_0,,,,2,1,2,3
C(C(C(C=CCC(C)O)=O)O)=O,,,5,1,1,0,1
45817_0,,,,2,1,2,3
C(C(C=O)O)(CC=CC(C)O)=O,,,5,1,1,0,1
45818_0,,,,2,1,2,3
45819_0,,,,2,1,2,3
45821_0,,,,2,1,2,3
C(CC(C)O)=CC=O,,,5,1,1,0,1
45823_0,,,,2,1,2,3
C(CC=CC(C)O)=O,,,5,1,1,0,1
45824_0,,,,2,1,2,3
45825_0,,,,2,1,2,3
45827_0,,,,2,1,2,3
C(C(C=CC(C)O)O)=O,,,5,1,1,0,1
45828_0,,,,2,1,2,3
45829_0,,,,2,1,2,3
45830_0,,,,2,1,2,3
45832_0,,,,2,1,2,3
C(C(C(C)O)O)=C(C=O)C(C)O,,,5,1,1,0,1
45834_0,,,,2,1,2,3
C(C)=C(C=O)C(C(C(C)O)O)O,,,5,1,1,0,1
45835_0,,,,2,1,2,3
45836_0,,,,2,1,2,3
45838_0,,,,2,1,2,3
C(C(C=CCO)C(C)O)=O,,,5,1,1,0,1
45840_0,,,,2,1,2,3
C(CCO)=C(C=O)C(C)O,,,5,1,1,0,1
45842_0,,,,2,1,2,3
C(C)=C(C=O)C(CCO)O,,,5,1,1,0,1
45843_0,,,,2,1,2,3
45844_0,,,,2,1,2,3
45846_0,,,,2,1,2,3
C(C(C=CC(CO)O)C(C)O)=O,,,5,1,1,0,1
45848_0,,,,2,1,2,3
C(CC(CO)O)=C(C=O)C(C)O,,,5,1,1,0,1
45850_0,,,,2,1,2,3
C(C)=C(C=O)C(CC(CO)O)O,,,5,1,1,0,1
45851_0,,,,2,1,2,3
45853_0,,,,2,1,2,3
C(C(C(C)O)=C(C=O)CO)=O,,,5,1,2,0,2
45854_0,,,,2,1,2,3
45855_0,,,,2,1,2,3
45857_0,,,,2,1,2,3
C(C(C(C)O)=CC(CO)=O)=O,,,5,1,2,0,2
45859_0,,,,2,1,2,3
C(CO)(C(C(C=O)=CC)O)=O,,,5,1,1,0,1
45860_0,,,,2,1,2,3
45862_0,,,,2,1,2,3
C(C(CO)=C(C=O)C(C)O)(C)=O,,,5,1,1,0,1
45864_0,,,,2,1,2,3
C(C)(C(C(C=O)=CC)(CO)O)=O,,,5,1,1,0,1
45865_0,,,,2,1,2,3
45867_0,,,,2,1,2,3
C(C(C(C(CO)=O)=C)C(C)O)=O,,,5,1,1,0,1
45869_0,,,,2,1,2,3
C(C(C(C)O)=C(C(CO)=O)C)=O,,,5,1,1,0,1
45871_0,,,,2,1,2,3
C(CO)(C(C(C=O)=CC)(C)O)=O,,,5,1,1,0,1
45872_0,,,,2,1,2,3
45873_0,,,,2,1,2,3
45875_0,,,,2,1,2,3
C(C(C(C)O)=C(C=O)C(C)O)=O,,,5,1,1,0,1
45876_0,,,,2,1,2,3
45877_0,,,,2,1,2,3
45878_0,,,,2,1,2,3
45880_0,,,,2,1,2,3
C(C(C(C)O)=CC(C(C)O)=O)=O,,,5,1,1,0,1
45882_0,,,,2,1,2,3
C(C(C)O)(C(C(C=O)=CC)O)=O,,,5,1,1,0,1
45883_0,,,,2,1,2,3
45885_0,,,,2,1,2,3
C(C(C(CO)=C)C(C)O)=O,,,5,1,1,0,1
45887_0,,,,2,1,2,3
C(CO)(C)=C(C=O)C(C)O,,,5,1,1,0,1
45889_0,,,,2,1,2,3
C(C)=C(C=O)C(CO)(C)O,,,5,1,1,0,1
45890_0,,,,2,1,2,3
45892_0,,,,2,1,2,3
C(C(C(CO)=CCO)C(C)O)=O,,,5,1,1,0,1
45893_0,,,,2,1,2,3
45895_0,,,,2,1,2,3
C(CO)(CCO)=C(C=O)C(C)O,,,5,1,1,0,1
45897_0,,,,2,1,2,3
C(C)=C(C=O)C(CO)(CCO)O,,,5,1,1,0,1
45898_0,,,,2,1,2,3
45899_0,,,,2,1,2,3
45900_0,,,,2,1,2,3
45902_0,,,,2,1,2,3
C(C(CCO)O)=C(C=O)C(C)O,,,5,1,1,0,1
45904_0,,,,2,1,2,3
C(C)=C(C=O)C(C(CCO)O)O,,,5,1,1,0,1
45905_0,,,,2,1,2,3
45907_0,,,,2,1,2,3
C(C(C(C(CO)O)=C)C(C)O)=O,,,5,1,1,0,1
45909_0,,,,2,1,2,3
C(C)(C(CO)O)=C(C=O)C(C)O,,,5,1,1,0,1
45911_0,,,,2,1,2,3
C(C)=C(C=O)C(C)(C(CO)O)O,,,5,1,1,0,1
45912_0,,,,2,1,2,3
45913_0,,,,2,1,2,3
45914_0,,,,2,1,2,3
45915_0,,,,2,1,2,3
45917_0,,,,2,1,2,3
C(C(C(C(O)=O)=C)C(C)O)=O,,,5,1,1,0,1
45919_0,,,,2,1,2,3
C(C(C)=C(C=O)C(C)O)(O)=O,,,5,1,1,0,1
45921_0,,,,2,1,2,3
C(C(C(C=O)=CC)(C)O)(O)=O,,,5,1,1,0,1
45922_0,,,,2,1,2,3
45924_0,,,,2,1,2,3
C(C(C=CC(O)=O)C(C)O)=O,,,5,1,1,0,1
45926_0,,,,2,1,2,3
C(CC=C(C=O)C(C)O)(O)=O,,,5,1,1,0,1
45928_0,,,,2,1,2,3
C(CC(C(C=O)=CC)O)(O)=O,,,5,1,1,0,1
45929_0,,,,2,1,2,3
45931_0,,,,2,1,2,3
C1(COCC1O)=C(C=O)C(C)O,,,5,1,1,0,1
45933_0,,,,2,1,2,3
C(C)=C(C=O)C1(COCC1O)O,,,5,1,1,0,1
45934_0,,,,2,1,2,3
45936_0,,,,2,1,2,3
C(C(C1C(OCC=1)O)C(C)O)=O,,,5,1,1,0,1
45938_0,,,,2,1,2,3
C1(C(O)OCC1)=C(C=O)C(C)O,,,5,1,1,0,1
45940_0,,,,2,1,2,3
C(C)=C(C=O)C1(C(O)OCC1)O,,,5,1,1,0,1
45941_0,,,,2,1,2,3
45942_0,,,,2,1,2,3
45944_0,,,,2,1,2,3
C(C(C1COC(C=1)O)C(C)O)=O,,,5,1,1,0,1
45946_0,,,,2,1,2,3
C1(COC(C1)O)=C(C=O)C(C)O,,,5,1,1,0,1
45948_0,,,,2,1,2,3
C(C)=C(C=O)C1(COC(C1)O)O,,,5,1,1,0,1
45949_0,,,,2,1,2,3
45951_0,,,,2,1,2,3
C=CC(C=O)=C(C=O)C(C)O,,,5,1,1,0,1
45953_0,,,,2,1,2,3
C(C(C=C)(C(C=O)=CC)O)=O,,,5,1,1,0,1
45954_0,,,,2,1,2,3
45956_0,,,,2,1,2,3
C=CC(C=C(C=O)C(C)O)=O,,,5,1,1,0,1
45958_0,,,,2,1,2,3
C=CC(C(C(C=O)=CC)O)=O,,,5,1,1,0,1
45959_0,,,,2,1,2,3
45961_0,,,,2,1,2,3
C(C(C(C)O)=CC=CC=O)=O,,,5,1,1,0,1
45963_0,,,,2,1,2,3
C(C(C(C=O)=CC)O)=CC=O,,,5,1,1,0,1
45964_0,,,,2,1,2,3
45966_0,,,,2,1,2,3
C(C(CO)O)=C(C=O)C(C)O,,,5,1,1,0,1
45968_0,,,,2,1,2,3
C(C)=C(C=O)C(C(CO)O)O,,,5,1,1,0,1
45969_0,,,,2,1,2,3
45970_0,,,,2,1,2,3
45972_0,,,,2,1,2,3
C(C)=C(C=O)C(C)O,,,5,1,1,0,1
45974_0,,,,2,1,2,3
C=C(C=O)C(C)O,,,5,1,2,0,2
45975_0,,,,2,1,2,3
45976_0,,,,2,1,2,3
45977_0,,,,2,1,2,3
45978_0,,,,2,1,2,3
45979_0,,,,2,1,2,3
45981_0,,,,2,1,2,3
C=C(C=O)C(C(C(C)O)O)O,,,5,1,1,0,1
45983_0,,,,2,1,2,3
C(C(C(C)O)O)=C(C=O)CO,,,5,1,1,0,1
45984_0,,,,2,1,2,3
45985_0,,,,2,1,2,3
45986_0,,,,2,1,2,3
45988_0,,,,2,1,2,3
C(C(C(C)O)O)=CC(CO)=O,,,5,1,1,0,1
45989_0,,,,2,1,2,3
45991_0,,,,2,1,2,3
C(C(C(C)O)O)=CC(C(O)=O)=O,,,5,1,1,0,1
45992_0,,,,2,1,2,3
45994_0,,,,2,1,2,3
C(C(C(C)O)O)=C(C(O)=O)C=O,,,5,1,1,0,1
45995_0,,,,2,1,2,3
45996_0,,,,2,1,2,3
45998_0,,,,2,1,2,3
C(C(C(C)O)O)=CC(C=O)=O,,,5,1,1,0,1
45999_0,,,,2,1,2,3
46001_0,,,,2,1,2,3
C(C(C(C)O)O)=C(C=O)C=O,,,5,1,1,0,1
46002_0,,,,2,1,2,3
46004_0,,,,2,1,2,3
C(C(C(C)O)O)=CC=O,,,5,1,1,0,1
46005_0,,,,2,1,2,3
46006_0,,,,2,1,2,3
46008_0,,,,2,1,2,3
C(CC(C(CO)O)O)=CC=O,,,5,1,1,0,1
46009_0,,,,2,1,2,3
46011_0,,,,2,1,2,3
C(CC=CC(C(CO)O)O)=O,,,5,1,1,0,1
46012_0,,,,2,1,2,3
46014_0,,,,2,1,2,3
C(C(C=CC(C(CO)O)O)O)=O,,,5,1,1,0,1
46016_0,,,,2,1,2,3
C=C(C=O)C(C(CO)O)O,,,5,1,1,0,1
46017_0,,,,2,1,2,3
46018_0,,,,2,1,2,3
46019_0,,,,2,1,2,3
46021_0,,,,2,1,2,3
C=C(C=O)C(C(C(CO)O)O)O,,,5,1,1,0,1
46022_0,,,,2,1,2,3
46024_0,,,,2,1,2,3
C=C(C=O)C(CCO)O,,,5,1,1,0,1
46026_0,,,,2,1,2,3
C(CCO)=C(C=O)CO,,,5,1,1,0,1
46027_0,,,,2,1,2,3
46029_0,,,,2,1,2,3
C(C(C=CCO)CO)=O,,,5,1,1,0,1
46031_0,,,,2,1,2,3
C(CO)=C(C=O)C(CCO)O,,,5,1,2,0,2
46033_0,,,,2,1,2,3
C(CCO)=C(C=O)C(CO)O,,,5,1,1,0,1
46034_0,,,,2,1,2,3
46036_0,,,,2,1,2,3
C(C(C=CCO)C(CO)O)=O,,,5,1,1,0,1
46037_0,,,,2,1,2,3
46038_0,,,,2,1,2,3
46039_0,,,,2,1,2,3
46041_0,,,,2,1,2,3
C(C(C(C(C)=O)=O)O)=CCO,,,5,1,1,0,1
46043_0,,,,2,1,2,3
C(CCO)=CC(C(CO)=O)=O,,,5,1,1,0,1
46044_0,,,,2,1,2,3
46046_0,,,,2,1,2,3
C(CC(C(CO)=O)=O)=CCO,,,5,1,1,0,1
46047_0,,,,2,1,2,3
46048_0,,,,2,1,2,3
46049_0,,,,2,1,2,3
46050_0,,,,2,1,2,3
46051_0,,,,2,1,2,3
46052_0,,,,2,1,2,3
46053_0,,,,2,1,2,3
46055_0,,,,2,1,2,3
C(CCO)(C(C=CCO)O)=O,,,5,1,1,0,1
46057_0,,,,2,1,2,3
C=C(C(CO)=O)C(CCO)O,,,5,1,1,0,1
46059_0,,,,2,1,2,3
C(CCO)=C(C(CO)=O)CO,,,5,1,1,0,1
46060_0,,,,2,1,2,3
46062_0,,,,2,1,2,3
C(CO)(C(C=CCO)CO)=O,,,5,1,1,0,1
46064_0,,,,2,1,2,3
C(CCO)=CC(C(CO)O)=O,,,5,1,1,0,1
46065_0,,,,2,1,2,3
46067_0,,,,2,1,2,3
C(C(CO)O)(CC=CCO)=O,,,5,1,1,0,1
46069_0,,,,2,1,2,3
C(CCO)=CC(C(O)=O)=O,,,5,1,1,0,1
46070_0,,,,2,1,2,3
46072_0,,,,2,1,2,3
C(CC(C(O)=O)=O)=CCO,,,5,1,1,0,1
46074_0,,,,2,1,2,3
C(CCO)=C(C(O)=O)C=O,,,5,1,1,0,1
46075_0,,,,2,1,2,3
46077_0,,,,2,1,2,3
C(C(C=O)C=CCO)(O)=O,,,5,1,1,0,1
46079_0,,,,2,1,2,3
C=C(C(C(O)=O)=O)C(CCO)O,,,5,1,1,0,1
46081_0,,,,2,1,2,3
C(CCO)=C(C(C(O)=O)=O)CO,,,5,1,1,0,1
46082_0,,,,2,1,2,3
46084_0,,,,2,1,2,3
C(C(C(C(O)=O)=O)CO)=CCO,,,5,1,1,0,1
46086_0,,,,2,1,2,3
C(C=C(C=O)C(CCO)O)(O)=O,,,5,1,2,0,2
46088_0,,,,2,1,2,3
C(C(C(C=O)=CCCO)O)(O)=O,,,5,1,1,0,1
46089_0,,,,2,1,2,3
46091_0,,,,2,1,2,3
C(C(C=CCO)C(C(O)=O)O)=O,,,5,1,1,0,1
46093_0,,,,2,1,2,3
C(CCO)=C(C(O)=O)C(CO)=O,,,5,1,1,0,1
46094_0,,,,2,1,2,3
46096_0,,,,2,1,2,3
C(C(C(CO)=O)C=CCO)(O)=O,,,5,1,1,0,1
46097_0,,,,2,1,2,3
46099_0,,,,2,1,2,3
C(CC(C(C=CCO)O)=O)(O)=O,,,5,1,1,0,1
46101_0,,,,2,1,2,3
C(C(C(C=CCCO)=O)O)(O)=O,,,5,1,1,0,1
46102_0,,,,2,1,2,3
46104_0,,,,2,1,2,3
C(C(C(O)=O)O)(CC=CCO)=O,,,5,1,1,0,1
46105_0,,,,2,1,2,3
46107_0,,,,2,1,2,3
C1(C(COC1C=CCO)O)=O,,,5,1,1,0,1
46109_0,,,,2,1,2,3
C(CCO)=C1C(C(OC1)O)=O,,,5,1,1,0,1
46110_0,,,,2,1,2,3
46112_0,,,,2,1,2,3
C1(C(O)OCC1C=CCO)=O,,,5,1,1,0,1
46114_0,,,,2,1,2,3
C1OCC(C=1C(CCO)O)=O,,,5,1,1,0,1
46116_0,,,,2,1,2,3
C(CCO)=C1C(COC1O)=O,,,5,1,1,0,1
46117_0,,,,2,1,2,3
46119_0,,,,2,1,2,3
C1(COC(C1C=CCO)O)=O,,,5,1,1,0,1
46120_0,,,,2,1,2,3
46121_0,,,,2,1,2,3
46123_0,,,,2,1,2,3
C1(CC(OC1C=CCO)O)=O,,,5,1,1,0,1
46124_0,,,,2,1,2,3
46125_0,,,,2,1,2,3
46126_0,,,,2,1,2,3
46127_0,,,,2,1,2,3
46128_0,,,,2,1,2,3
46129_0,,,,2,1,2,3
46130_0,,,,2,1,2,3
46131_0,,,,2,1,2,3
46132_0,,,,2,1,2,3
46133_0,,,,2,1,2,3
46134_0,,,,2,1,2,3
46135_0,,,,2,1,2,3
46136_0,,,,2,1,2,3
46137_0,,,,2,1,2,3
46138_0,,,,2,1,2,3
46139_0,,,,2,1,2,3
46140_0,,,,2,1,2,3
46141_0,,,,2,1,2,3
46142_0,,,,2,1,2,3
46143_0,,,,2,1,2,3
46144_0,,,,2,1,2,3
46145_0,,,,2,1,2,3
46146_0,,,,2,1,2,3
46147_0,,,,2,1,2,3
46148_0,,,,2,1,2,3
46149_0,,,,2,1,2,3
46150_0,,,,2,1,2,3
46151_0,,,,2,1,2,3
46152_0,,,,2,1,2,3
46153_0,,,,2,1,2,3
46154_0,,,,2,1,2,3
46155_0,,,,2,1,2,3
46157_0,,,,2,1,2,3
C(C(C=CC(CO)O)CO)=O,,,5,1,1,0,1
46159_0,,,,2,1,2,3
C(CC(CO)O)=C(C=O)CO,,,5,1,1,0,1
46161_0,,,,2,1,2,3
C=C(C=O)C(CC(CO)O)O,,,5,1,1,0,1
46163_0,,,,2,1,2,3
C(C(CO)=C(C=O)CO)=O,,,5,1,1,0,1
46164_0,,,,2,1,2,3
46165_0,,,,2,1,2,3
46166_0,,,,2,1,2,3
46168_0,,,,2,1,2,3
C(C(C(CO)O)=C(C=O)CO)=O,,,5,1,2,0,2
46169_0,,,,2,1,2,3
46170_0,,,,2,1,2,3
46171_0,,,,2,1,2,3
46173_0,,,,2,1,2,3
C(C(CO)=C(C(C)=O)CO)=O,,,5,1,1,0,1
46174_0,,,,2,1,2,3
46176_0,,,,2,1,2,3
C(C(C(C(CO)=O)=C)CO)=O,,,5,1,1,0,1
46178_0,,,,2,1,2,3
C(C(CO)=C(C(CO)=O)C)=O,,,5,1,1,0,1
46180_0,,,,2,1,2,3
C(CO)(C(C(C=O)=C)(C)O)=O,,,5,1,1,0,1
46181_0,,,,2,1,2,3
46182_0,,,,2,1,2,3
46183_0,,,,2,1,2,3
46184_0,,,,2,1,2,3
46186_0,,,,2,1,2,3
C(C=C(C=O)CO)(C(C)O)=O,,,5,1,1,0,1
46188_0,,,,2,1,2,3
C(C(C)O)(C(C(C=O)=C)O)=O,,,5,1,1,0,1
46190_0,,,,2,1,2,3
C(C(C(CO)=C)CO)=O,,,5,1,1,0,1
46192_0,,,,2,1,2,3
C(C)(CO)=C(C=O)CO,,,5,1,1,0,1
46194_0,,,,2,1,2,3
C=C(C=O)C(CO)(C)O,,,5,1,1,0,1
46196_0,,,,2,1,2,3
C(C(C(CO)=CCO)CO)=O,,,5,1,1,0,1
46197_0,,,,2,1,2,3
46199_0,,,,2,1,2,3
C(CO)(CCO)=C(C=O)CO,,,5,1,1,0,1
46201_0,,,,2,1,2,3
C=C(C=O)C(CO)(CCO)O,,,5,1,1,0,1
46202_0,,,,2,1,2,3
46203_0,,,,2,1,2,3
46205_0,,,,2,1,2,3
C(C(CCO)O)=C(C=O)CO,,,5,1,1,0,1
46207_0,,,,2,1,2,3
C=C(C=O)C(C(CCO)O)O,,,5,1,1,0,1
46209_0,,,,2,1,2,3
C(C(C(C(CO)O)=C)CO)=O,,,5,1,1,0,1
46211_0,,,,2,1,2,3
C(C)(C(CO)O)=C(C=O)CO,,,5,1,1,0,1
46213_0,,,,2,1,2,3
C=C(C=O)C(C)(C(CO)O)O,,,5,1,1,0,1
46214_0,,,,2,1,2,3
46215_0,,,,2,1,2,3
46217_0,,,,2,1,2,3
C(C(C(C(O)=O)=C)CO)=O,,,5,1,1,0,1
46219_0,,,,2,1,2,3
C(C(C)=C(C=O)CO)(O)=O,,,5,1,1,0,1
46221_0,,,,2,1,2,3
C(C(C(C=O)=C)(C)O)(O)=O,,,5,1,2,0,2
46223_0,,,,2,1,2,3
C(C(C=CC(O)=O)CO)=O,,,5,1,1,0,1
46225_0,,,,2,1,2,3
C(CC=C(C=O)CO)(O)=O,,,5,1,1,0,1
46227_0,,,,2,1,2,3
C(CC(C(C=O)=C)O)(O)=O,,,5,1,1,0,1
46229_0,,,,2,1,2,3
C(C(C(C(O)=O)=CCO)CO)=O,,,5,1,1,0,1
46230_0,,,,2,1,2,3
46232_0,,,,2,1,2,3
C(C(CCO)=C(C=O)CO)(O)=O,,,5,1,1,0,1
46234_0,,,,2,1,2,3
C(C(C(C=O)=C)(CCO)O)(O)=O,,,5,1,2,0,2
46235_0,,,,2,1,2,3
46237_0,,,,2,1,2,3
C(C(C=CC(C(O)=O)O)CO)=O,,,5,1,1,0,1
46239_0,,,,2,1,2,3
C(C(CC=C(C=O)CO)O)(O)=O,,,5,1,1,0,1
46241_0,,,,2,1,2,3
C(C(CC(C(C=O)=C)O)O)(O)=O,,,5,1,1,0,1
46242_0,,,,2,1,2,3
46244_0,,,,2,1,2,3
C(CC(C=C(C=O)CO)O)(O)=O,,,5,1,1,0,1
46246_0,,,,2,1,2,3
C(CC(C(C(C=O)=C)O)O)(O)=O,,,5,1,1,0,1
46248_0,,,,2,1,2,3
C(C(C(CO)=CC(O)=O)CO)=O,,,5,1,1,0,1
46250_0,,,,2,1,2,3
C(CC(CO)=C(C=O)CO)(O)=O,,,5,1,1,0,1
46252_0,,,,2,1,2,3
C(CC(C(C=O)=C)(CO)O)(O)=O,,,5,1,1,0,1
46254_0,,,,2,1,2,3
C(C(C(C(C(O)=O)O)=C)CO)=O,,,5,1,1,0,1
46256_0,,,,2,1,2,3
C(C(C(C)=C(C=O)CO)O)(O)=O,,,5,1,1,0,1
46258_0,,,,2,1,2,3
C(C(C(C(C=O)=C)(C)O)O)(O)=O,,,5,1,1,0,1
46260_0,,,,2,1,2,3
C1(COCC1O)=C(C=O)CO,,,5,1,1,0,1
46262_0,,,,2,1,2,3
C=C(C=O)C1(COCC1O)O,,,5,1,1,0,1
46264_0,,,,2,1,2,3
C(C(C1C(OCC=1)O)CO)=O,,,5,1,1,0,1
46266_0,,,,2,1,2,3
C1(C(O)OCC1)=C(C=O)CO,,,5,1,1,0,1
46268_0,,,,2,1,2,3
C=C(C=O)C1(C(O)OCC1)O,,,5,1,1,0,1
46269_0,,,,2,1,2,3
46271_0,,,,2,1,2,3
C(C(C1COC(C=1)O)CO)=O,,,5,1,1,0,1
46273_0,,,,2,1,2,3
C1(COC(C1)O)=C(C=O)CO,,,5,1,1,0,1
46275_0,,,,2,1,2,3
C=C(C=O)C1(COC(C1)O)O,,,5,1,1,0,1
46277_0,,,,2,1,2,3
C=CC(C=O)=C(C=O)CO,,,5,1,1,0,1
46279_0,,,,2,1,2,3
C(C(C=C)(C(C=O)=C)O)=O,,,5,1,1,0,1
46281_0,,,,2,1,2,3
C=CC(C=C(C=O)CO)=O,,,5,1,1,0,1
46283_0,,,,2,1,2,3
C=C(C=O)C(C(C=C)=O)O,,,5,1,1,0,1
46285_0,,,,2,1,2,3
C(C=CC=C(C=O)CO)=O,,,5,1,1,0,1
46287_0,,,,2,1,2,3
C=C(C=O)C(C=CC=O)O,,,5,1,1,0,1
46288_0,,,,2,1,2,3
46289_0,,,,2,1,2,3
46290_0,,,,2,1,2,3
46291_0,,,,2,1,2,3
46292_0,,,,2,1,2,3
46293_0,,,,2,1,2,3
46295_0,,,,2,1,2,3
C(C)(C(C=CC(CO)O)O)=O,,,5,1,1,0,1
46297_0,,,,2,1,2,3
C(CC(CO)O)=CC(CO)=O,,,5,1,1,0,1
46298_0,,,,2,1,2,3
46300_0,,,,2,1,2,3
C(CO)(CC=CC(CO)O)=O,,,5,1,1,0,1
46302_0,,,,2,1,2,3
C(CC(CO)O)=CC(C(O)=O)=O,,,5,1,1,0,1
46303_0,,,,2,1,2,3
46305_0,,,,2,1,2,3
C(CC(C(O)=O)=O)=CC(CO)O,,,5,1,1,0,1
46307_0,,,,2,1,2,3
C(CC(CO)O)=C(C(O)=O)C=O,,,5,1,1,0,1
46308_0,,,,2,1,2,3
46310_0,,,,2,1,2,3
C(C(C=O)C=CC(CO)O)(O)=O,,,5,1,1,0,1
46311_0,,,,2,1,2,3
46312_0,,,,2,1,2,3
46313_0,,,,2,1,2,3
46314_0,,,,2,1,2,3
46315_0,,,,2,1,2,3
46316_0,,,,2,1,2,3
46317_0,,,,2,1,2,3
46318_0,,,,2,1,2,3
46319_0,,,,2,1,2,3
46320_0,,,,2,1,2,3
46321_0,,,,2,1,2,3
46322_0,,,,2,1,2,3
46323_0,,,,2,1,2,3
46324_0,,,,2,1,2,3
46325_0,,,,2,1,2,3
46327_0,,,,2,1,2,3
C(C(C(CO)O)=CC(CO)=O)=O,,,5,1,2,0,2
46328_0,,,,2,1,2,3
46330_0,,,,2,1,2,3
C(C(C(CO)=C)C(CO)O)=O,,,5,1,1,0,1
46332_0,,,,2,1,2,3
C(CO)(C)=C(C=O)C(CO)O,,,5,1,1,0,1
46334_0,,,,2,1,2,3
C(CO)=C(C=O)C(CO)(C)O,,,5,1,2,0,2
46335_0,,,,2,1,2,3
46336_0,,,,2,1,2,3
46338_0,,,,2,1,2,3
C(C(C(C(O)=O)=C)C(CO)O)=O,,,5,1,1,0,1
46340_0,,,,2,1,2,3
C(C(C)=C(C=O)C(CO)O)(O)=O,,,5,1,1,0,1
46342_0,,,,2,1,2,3
C(C(C(C=O)=CCO)(C)O)(O)=O,,,5,1,2,0,2
46344_0,,,,2,1,2,3
C(C(C=CC(O)=O)C(CO)O)=O,,,5,1,1,0,1
46346_0,,,,2,1,2,3
C(CC=C(C=O)C(CO)O)(O)=O,,,5,1,1,0,1
46348_0,,,,2,1,2,3
C(CC(C(C=O)=CCO)O)(O)=O,,,5,1,2,0,2
46350_0,,,,2,1,2,3
C=CC(C=O)=C(C=O)C(CO)O,,,5,1,1,0,1
46352_0,,,,2,1,2,3
C(C(C=C)(C(C=O)=CCO)O)=O,,,5,1,2,0,2
46354_0,,,,2,1,2,3
C=CC(C=C(C=O)C(CO)O)=O,,,5,1,1,0,1
46356_0,,,,2,1,2,3
C=CC(C(C(C=O)=CCO)O)=O,,,5,1,2,0,2
46358_0,,,,2,1,2,3
C(C(C(CO)O)=CC=CC=O)=O,,,5,1,1,0,1
46360_0,,,,2,1,2,3
C(C(C(C=O)=CCO)O)=CC=O,,,5,1,2,0,2
46361_0,,,,2,1,2,3
46363_0,,,,2,1,2,3
C(C(CO)=CC(C(CO)=O)=O)=O,,,5,1,1,0,1
46364_0,,,,2,1,2,3
46366_0,,,,2,1,2,3
C(C(CO)=C(C(CO)=O)CO)=O,,,5,1,1,0,1
46367_0,,,,2,1,2,3
46369_0,,,,2,1,2,3
C(C(CO)=CC(C(O)=O)=O)=O,,,5,1,1,0,1
46371_0,,,,2,1,2,3
C(C(C=O)=C(C=O)CO)(O)=O,,,5,1,1,0,1
46373_0,,,,2,1,2,3
C(C(CO)=C1C(C(O)OC1)=O)=O,,,5,1,1,0,1
46375_0,,,,2,1,2,3
C(C(C1C(COC=1)=O)(CO)O)=O,,,5,1,1,0,1
46377_0,,,,2,1,2,3
C(C(CO)=C1C(COC1O)=O)=O,,,5,1,1,0,1
46378_0,,,,2,1,2,3
46380_0,,,,2,1,2,3
C(C(CO)=CC(C=O)=O)=O,,,5,1,2,0,2
46382_0,,,,2,1,2,3
C(C(C=O)=C(C=O)CO)=O,,,5,1,1,0,1
46383_0,,,,2,1,2,3
46385_0,,,,2,1,2,3
C(C(C(CO)=C(C=O)CO)=O)=O,,,5,1,1,0,1
46386_0,,,,2,1,2,3
46388_0,,,,2,1,2,3
C(C(C(C=O)=C(C=O)CO)O)=O,,,5,1,2,0,2
46390_0,,,,2,1,2,3
C(C(C(CO)=O)=C(C=O)CO)=O,,,5,1,1,0,1
46392_0,,,,2,1,2,3
C(C(C(C=C(C=O)CO)=O)O)=O,,,5,1,1,0,1
46394_0,,,,2,1,2,3
C(C(C=CC(CO)=O)=O)(CO)=O,,,5,1,1,0,1
46395_0,,,,2,1,2,3
46396_0,,,,2,1,2,3
46398_0,,,,2,1,2,3
C(C(CO)=CC(CO)=O)(CO)=O,,,5,1,1,0,1
46399_0,,,,2,1,2,3
46401_0,,,,2,1,2,3
C(C(C=CC(CO)=O)=O)(O)=O,,,5,1,1,0,1
46403_0,,,,2,1,2,3
C(C(C=O)=CC(CO)=O)(O)=O,,,5,1,1,0,1
46405_0,,,,2,1,2,3
C1(C(COC1O)=CC(CO)=O)=O,,,5,1,1,0,1
46407_0,,,,2,1,2,3
C(CO)(C(C1C(COC=1)=O)O)=O,,,5,1,1,0,1
46409_0,,,,2,1,2,3
C1(C(C(O)OC1)=CC(CO)=O)=O,,,5,1,1,0,1
46410_0,,,,2,1,2,3
46411_0,,,,2,1,2,3
46413_0,,,,2,1,2,3
C(C(C=O)=CC(CO)=O)=O,,,5,1,2,0,2
46415_0,,,,2,1,2,3
C(CO)(C(C(C(C=O)=O)=C)O)=O,,,5,1,2,0,2
46417_0,,,,2,1,2,3
C(C(C(CO)=CC(CO)=O)=O)=O,,,5,1,1,0,1
46419_0,,,,2,1,2,3
C(CO)(C(C(C=O)=CC=O)O)=O,,,5,1,2,0,2
46421_0,,,,2,1,2,3
C(C(C(C=O)=CC(CO)=O)O)=O,,,5,1,2,0,2
46423_0,,,,2,1,2,3
C(C(C(CO)=O)=CC(CO)=O)=O,,,5,1,1,0,1
46425_0,,,,2,1,2,3
C(C(C(C=CC(CO)=O)=O)O)=O,,,5,1,1,0,1
46426_0,,,,2,1,2,3
46428_0,,,,2,1,2,3
C=C(C(CO)=O)C(C(C=O)=O)O,,,5,1,1,0,1
46429_0,,,,2,1,2,3
46430_0,,,,2,1,2,3
46432_0,,,,2,1,2,3
C=C(CO)C(C(C=O)=O)O,,,5,1,1,0,1
46434_0,,,,2,1,2,3
C(CO)=C(CO)C(C(C=O)=O)O,,,5,1,1,0,1
46435_0,,,,2,1,2,3
46436_0,,,,2,1,2,3
46437_0,,,,2,1,2,3
46439_0,,,,2,1,2,3
C=C(C(CO)O)C(C(C=O)=O)O,,,5,1,1,0,1
46441_0,,,,2,1,2,3
C=C(C(O)=O)C(C(C=O)=O)O,,,5,1,1,0,1
46443_0,,,,2,1,2,3
C(C(C(C=O)=O)O)=CC(O)=O,,,5,1,1,0,1
46445_0,,,,2,1,2,3
C1COC(C=1C(C(C=O)=O)O)O,,,5,1,1,0,1
46446_0,,,,2,1,2,3
46448_0,,,,2,1,2,3
C1C(O)OCC=1C(C(C=O)=O)O,,,5,1,1,0,1
46450_0,,,,2,1,2,3
C=C(C=O)C(C(C=O)=O)O,,,5,1,1,0,1
46451_0,,,,2,1,2,3
46453_0,,,,2,1,2,3
C(CO)=C(C=O)C(C(C=O)=O)O,,,5,1,1,0,1
46454_0,,,,2,1,2,3
46455_0,,,,2,1,2,3
46456_0,,,,2,1,2,3
46457_0,,,,2,1,2,3
46459_0,,,,2,1,2,3
C(C(C=CC(C(C=O)=O)O)O)=O,,,5,1,1,0,1
46461_0,,,,2,1,2,3
C(C(C(C=O)=O)O)=CC(CO)=O,,,5,1,1,0,1
46463_0,,,,2,1,2,3
C(CO)(C(C(C=O)=O)O)=CC=O,,,5,1,1,0,1
46465_0,,,,2,1,2,3
C(C(C(C(C(C=O)=O)O)=C)O)=O,,,5,1,1,0,1
46466_0,,,,2,1,2,3
46467_0,,,,2,1,2,3
46469_0,,,,2,1,2,3
C(C(C=C(C=O)C(CO)O)=O)=O,,,5,1,1,0,1
46471_0,,,,2,1,2,3
C(C(C=O)=C(C=O)C(CO)O)=O,,,5,1,1,0,1
46472_0,,,,2,1,2,3
46474_0,,,,2,1,2,3
C(C(C=CC(C(CO)O)=O)=O)=O,,,5,1,1,0,1
46476_0,,,,2,1,2,3
C(C(C=O)=CC(C(CO)O)=O)=O,,,5,1,1,0,1
46477_0,,,,2,1,2,3
46478_0,,,,2,1,2,3
46480_0,,,,2,1,2,3
C(C(CO)=CC(CO)=O)(C)=O,,,5,1,1,0,1
46482_0,,,,2,1,2,3
C(C(C=C(C(C)=O)CO)=O)(O)=O,,,5,1,1,0,1
46484_0,,,,2,1,2,3
C(C(C=O)=C(C(C)=O)CO)(O)=O,,,5,1,1,0,1
46485_0,,,,2,1,2,3
46486_0,,,,2,1,2,3
46487_0,,,,2,1,2,3
46488_0,,,,2,1,2,3
46490_0,,,,2,1,2,3
C(C(C)=CC(CO)=O)(CO)=O,,,5,1,1,0,1
46492_0,,,,2,1,2,3
C(CO)(CC(C(CO)=O)=C)=O,,,5,1,1,0,1
46494_0,,,,2,1,2,3
C(C(C=C(C(CO)=O)C)=O)(O)=O,,,5,1,1,0,1
46496_0,,,,2,1,2,3
C=C(C(CO)=O)CC(C(O)=O)=O,,,5,1,1,0,1
46498_0,,,,2,1,2,3
C(C(C=O)=C(C(CO)=O)C)(O)=O,,,5,1,1,0,1
46500_0,,,,2,1,2,3
C(C(C=O)C(C(CO)=O)=C)(O)=O,,,5,1,1,0,1
46501_0,,,,2,1,2,3
46502_0,,,,2,1,2,3
46503_0,,,,2,1,2,3
46504_0,,,,2,1,2,3
46505_0,,,,2,1,2,3
46506_0,,,,2,1,2,3
46507_0,,,,2,1,2,3
46508_0,,,,2,1,2,3
46510_0,,,,2,1,2,3
C=C(CO)C(C(C(C)=O)=O)O,,,5,1,1,0,1
46512_0,,,,2,1,2,3
C=C(C(O)=O)C(C(C(C)=O)=O)O,,,5,1,1,0,1
46514_0,,,,2,1,2,3
C(C(C(C(C)=O)=O)O)=CC(O)=O,,,5,1,1,0,1
46515_0,,,,2,1,2,3
46516_0,,,,2,1,2,3
46517_0,,,,2,1,2,3
46519_0,,,,2,1,2,3
C=C(CO)CC(C(CO)=O)=O,,,5,1,1,0,1
46521_0,,,,2,1,2,3
C(C)(CO)=CC(C(CO)=O)=O,,,5,1,1,0,1
46523_0,,,,2,1,2,3
C(C=CC(C(CO)=O)=O)(O)=O,,,5,1,1,0,1
46525_0,,,,2,1,2,3
C=C(C(O)=O)CC(C(CO)=O)=O,,,5,1,1,0,1
46527_0,,,,2,1,2,3
C(C(C)=CC(C(CO)=O)=O)(O)=O,,,5,1,1,0,1
46529_0,,,,2,1,2,3
C(CC(C(CO)=O)=O)=CC(O)=O,,,5,1,1,0,1
46531_0,,,,2,1,2,3
C(CC=CC(C(CO)=O)=O)(O)=O,,,5,1,1,0,1
46533_0,,,,2,1,2,3
C=CC(C=O)=CC(C(CO)=O)=O,,,5,1,1,0,1
46535_0,,,,2,1,2,3
C=CC(C=CC(C(CO)=O)=O)=O,,,5,1,1,0,1
46537_0,,,,2,1,2,3
C(C=CC=CC(C(CO)=O)=O)=O,,,5,1,1,0,1
46538_0,,,,2,1,2,3
46539_0,,,,2,1,2,3
46540_0,,,,2,1,2,3
46541_0,,,,2,1,2,3
46542_0,,,,2,1,2,3
46543_0,,,,2,1,2,3
46544_0,,,,2,1,2,3
46545_0,,,,2,1,2,3
46546_0,,,,2,1,2,3
46547_0,,,,2,1,2,3
46548_0,,,,2,1,2,3
46549_0,,,,2,1,2,3
46550_0,,,,2,1,2,3
46551_0,,,,2,1,2,3
46552_0,,,,2,1,2,3
46554_0,,,,2,1,2,3
C(C(C=C(C=O)C(C)O)=O)(O)=O,,,5,1,1,0,1
46555_0,,,,2,1,2,3
46557_0,,,,2,1,2,3
C(C(C=O)=C(C=O)C(C)O)(O)=O,,,5,1,1,0,1
46558_0,,,,2,1,2,3
46559_0,,,,2,1,2,3
46561_0,,,,2,1,2,3
C(C(C=C(C=O)C(C)O)=O)=O,,,5,1,1,0,1
46562_0,,,,2,1,2,3
46564_0,,,,2,1,2,3
C(C(C=O)=C(C=O)C(C)O)=O,,,5,1,1,0,1
46565_0,,,,2,1,2,3
46566_0,,,,2,1,2,3
46567_0,,,,2,1,2,3
46569_0,,,,2,1,2,3
C(C=CC(CO)=O)(C(C)O)=O,,,5,1,1,0,1
46570_0,,,,2,1,2,3
46572_0,,,,2,1,2,3
C(C(C=CC(C(C)O)=O)=O)(O)=O,,,5,1,1,0,1
46573_0,,,,2,1,2,3
46575_0,,,,2,1,2,3
C(C(C=O)=CC(C(C)O)=O)(O)=O,,,5,1,1,0,1
46576_0,,,,2,1,2,3
46577_0,,,,2,1,2,3
46578_0,,,,2,1,2,3
46579_0,,,,2,1,2,3
46580_0,,,,2,1,2,3
46581_0,,,,2,1,2,3
46582_0,,,,2,1,2,3
46583_0,,,,2,1,2,3
46584_0,,,,2,1,2,3
46586_0,,,,2,1,2,3
C(C)(C(C(CO)=C)O)=O,,,5,1,1,0,1
46588_0,,,,2,1,2,3
C(C)(CO)=CC(CO)=O,,,5,1,1,0,1
46590_0,,,,2,1,2,3
C(CO)(CC(CO)=C)=O,,,5,1,1,0,1
46591_0,,,,2,1,2,3
46593_0,,,,2,1,2,3
C(CCO)(C(C(CO)=C)O)=O,,,5,1,1,0,1
46595_0,,,,2,1,2,3
C=C(C(CO)=O)C(CO)(C)O,,,5,1,1,0,1
46597_0,,,,2,1,2,3
C(C)(CO)=C(C(CO)=O)CO,,,5,1,1,0,1
46599_0,,,,2,1,2,3
C(CO)(C(C(CO)=C)CO)=O,,,5,1,1,0,1
46601_0,,,,2,1,2,3
C(CO)(C)=CC(C(CO)O)=O,,,5,1,1,0,1
46603_0,,,,2,1,2,3
C(C(CO)O)(CC(CO)=C)=O,,,5,1,1,0,1
46605_0,,,,2,1,2,3
C(C)(CO)=CC(C(O)=O)=O,,,5,1,1,0,1
46607_0,,,,2,1,2,3
C=C(CO)CC(C(O)=O)=O,,,5,1,1,0,1
46609_0,,,,2,1,2,3
C(C)(CO)=C(C(O)=O)C=O,,,5,1,1,0,1
46611_0,,,,2,1,2,3
C(C(C=O)C(CO)=C)(O)=O,,,5,1,1,0,1
46613_0,,,,2,1,2,3
C=C(C(C(O)=O)=O)C(CO)(C)O,,,5,1,1,0,1
46615_0,,,,2,1,2,3
C(C)(CO)=C(C(C(O)=O)=O)CO,,,5,1,1,0,1
46617_0,,,,2,1,2,3
C=C(CO)C(C(C(O)=O)=O)CO,,,5,1,1,0,1
46619_0,,,,2,1,2,3
C(C=C(C=O)C(CO)(C)O)(O)=O,,,5,1,2,0,2
46621_0,,,,2,1,2,3
C(C(C(C=O)=C(CO)C)O)(O)=O,,,5,1,1,0,1
46623_0,,,,2,1,2,3
C(C(C(CO)=C)C(C(O)=O)O)=O,,,5,1,1,0,1
46625_0,,,,2,1,2,3
C(C)(CO)=C(C(O)=O)C(CO)=O,,,5,1,1,0,1
46627_0,,,,2,1,2,3
C(C(C(CO)=O)C(CO)=C)(O)=O,,,5,1,1,0,1
46629_0,,,,2,1,2,3
C(CC(C(C(CO)=C)O)=O)(O)=O,,,5,1,1,0,1
46631_0,,,,2,1,2,3
C(C(C(C=C(CO)C)=O)O)(O)=O,,,5,1,1,0,1
46633_0,,,,2,1,2,3
C(C(C(O)=O)O)(CC(CO)=C)=O,,,5,1,1,0,1
46635_0,,,,2,1,2,3
C1(C(COC1C(CO)=C)O)=O,,,5,1,1,0,1
46637_0,,,,2,1,2,3
C(C)(CO)=C1C(C(O)OC1)=O,,,5,1,1,0,1
46639_0,,,,2,1,2,3
C1(C(O)OCC1C(CO)=C)=O,,,5,1,1,0,1
46641_0,,,,2,1,2,3
C1OCC(C=1C(CO)(C)O)=O,,,5,1,1,0,1
46643_0,,,,2,1,2,3
C(C)(CO)=C1C(COC1O)=O,,,5,1,1,0,1
46645_0,,,,2,1,2,3
C1(COC(C1C(CO)=C)O)=O,,,5,1,1,0,1
46646_0,,,,2,1,2,3
46648_0,,,,2,1,2,3
C1(CC(OC1C(CO)=C)O)=O,,,5,1,1,0,1
46649_0,,,,2,1,2,3
46650_0,,,,2,1,2,3
46651_0,,,,2,1,2,3
46652_0,,,,2,1,2,3
46653_0,,,,2,1,2,3
46654_0,,,,2,1,2,3
46655_0,,,,2,1,2,3
46656_0,,,,2,1,2,3
46657_0,,,,2,1,2,3
46658_0,,,,2,1,2,3
46659_0,,,,2,1,2,3
46660_0,,,,2,1,2,3
46661_0,,,,2,1,2,3
46662_0,,,,2,1,2,3
46663_0,,,,2,1,2,3
46664_0,,,,2,1,2,3
46665_0,,,,2,1,2,3
46666_0,,,,2,1,2,3
46667_0,,,,2,1,2,3
46668_0,,,,2,1,2,3
46670_0,,,,2,1,2,3
C(C)(C(C(CO)=CCO)O)=O,,,5,1,1,0,1
46671_0,,,,2,1,2,3
46672_0,,,,2,1,2,3
46673_0,,,,2,1,2,3
46675_0,,,,2,1,2,3
C(C)(C(C(C(CO)O)=C)O)=O,,,5,1,1,0,1
46677_0,,,,2,1,2,3
C(C)(C(C(C(O)=O)=C)O)=O,,,5,1,1,0,1
46678_0,,,,2,1,2,3
46680_0,,,,2,1,2,3
C(C)(C(C(C(O)=O)=CCO)O)=O,,,5,1,1,0,1
46681_0,,,,2,1,2,3
46682_0,,,,2,1,2,3
46683_0,,,,2,1,2,3
46684_0,,,,2,1,2,3
46686_0,,,,2,1,2,3
C(C)(C(C(CO)=CC(O)=O)O)=O,,,5,1,2,0,2
46687_0,,,,2,1,2,3
46689_0,,,,2,1,2,3
C(C)(C(C1C(O)OCC=1)O)=O,,,5,1,1,0,1
46690_0,,,,2,1,2,3
46692_0,,,,2,1,2,3
C(C)(C(C1COC(C=1)O)O)=O,,,5,1,1,0,1
46693_0,,,,2,1,2,3
46694_0,,,,2,1,2,3
46695_0,,,,2,1,2,3
46696_0,,,,2,1,2,3
46697_0,,,,2,1,2,3
46698_0,,,,2,1,2,3
46699_0,,,,2,1,2,3
46700_0,,,,2,1,2,3
46702_0,,,,2,1,2,3
C(C(C(C(C(C)=O)O)=C)O)=O,,,5,1,2,0,2
46704_0,,,,2,1,2,3
C(C)(C(C=C)O)=O,,,5,1,2,0,2
46706_0,,,,2,1,2,3
C(CO)(CC(CO)=CCO)=O,,,5,1,1,0,1
46707_0,,,,2,1,2,3
46709_0,,,,2,1,2,3
C(CO)(CCO)=CC(CO)=O,,,5,1,1,0,1
46710_0,,,,2,1,2,3
46711_0,,,,2,1,2,3
46713_0,,,,2,1,2,3
C(C(CCO)O)=CC(CO)=O,,,5,1,1,0,1
46715_0,,,,2,1,2,3
C(CO)(CC(C(CO)O)=C)=O,,,5,1,1,0,1
46717_0,,,,2,1,2,3
C(C)(C(CO)O)=CC(CO)=O,,,5,1,1,0,1
46719_0,,,,2,1,2,3
C(CO)(CC(C(O)=O)=C)=O,,,5,1,1,0,1
46721_0,,,,2,1,2,3
C(C(C)=CC(CO)=O)(O)=O,,,5,1,1,0,1
46722_0,,,,2,1,2,3
46723_0,,,,2,1,2,3
46725_0,,,,2,1,2,3
C(CO)(CC(C(O)=O)=CCO)=O,,,5,1,1,0,1
46726_0,,,,2,1,2,3
46728_0,,,,2,1,2,3
C(C(CCO)=CC(CO)=O)(O)=O,,,5,1,1,0,1
46729_0,,,,2,1,2,3
46730_0,,,,2,1,2,3
46731_0,,,,2,1,2,3
46732_0,,,,2,1,2,3
46734_0,,,,2,1,2,3
C(CC(C=CC(CO)=O)O)(O)=O,,,5,1,1,0,1
46736_0,,,,2,1,2,3
C(CO)(CC(CO)=CC(O)=O)=O,,,5,1,1,0,1
46738_0,,,,2,1,2,3
C(CC(CO)=CC(CO)=O)(O)=O,,,5,1,1,0,1
46740_0,,,,2,1,2,3
C(C(C(CC(CO)=O)=C)O)(O)=O,,,5,1,1,0,1
46742_0,,,,2,1,2,3
C(C(C(C)=CC(CO)=O)O)(O)=O,,,5,1,1,0,1
46744_0,,,,2,1,2,3
C1(COCC1O)=CC(CO)=O,,,5,1,1,0,1
46746_0,,,,2,1,2,3
C(CO)(CC1C(O)OCC=1)=O,,,5,1,1,0,1
46748_0,,,,2,1,2,3
C1(C(O)OCC1)=CC(CO)=O,,,5,1,1,0,1
46749_0,,,,2,1,2,3
46751_0,,,,2,1,2,3
C(CO)(CC1COC(C=1)O)=O,,,5,1,1,0,1
46753_0,,,,2,1,2,3
C1(COC(C1)O)=CC(CO)=O,,,5,1,1,0,1
46755_0,,,,2,1,2,3
C=CC(C=O)=CC(CO)=O,,,5,1,1,0,1
46757_0,,,,2,1,2,3
C=CC(C=CC(CO)=O)=O,,,5,1,1,0,1
46759_0,,,,2,1,2,3
C(C=CC=CC(CO)=O)=O,,,5,1,1,0,1
46760_0,,,,2,1,2,3
46761_0,,,,2,1,2,3
46762_0,,,,2,1,2,3
46763_0,,,,2,1,2,3
46764_0,,,,2,1,2,3
46765_0,,,,2,1,2,3
46766_0,,,,2,1,2,3
46767_0,,,,2,1,2,3
46768_0,,,,2,1,2,3
46769_0,,,,2,1,2,3
46770_0,,,,2,1,2,3
46771_0,,,,2,1,2,3
46772_0,,,,2,1,2,3
46773_0,,,,2,1,2,3
46774_0,,,,2,1,2,3
46775_0,,,,2,1,2,3
46776_0,,,,2,1,2,3
46777_0,,,,2,1,2,3
46778_0,,,,2,1,2,3
46779_0,,,,2,1,2,3
46780_0,,,,2,1,2,3
46781_0,,,,2,1,2,3
46782_0,,,,2,1,2,3
46783_0,,,,2,1,2,3
46784_0,,,,2,1,2,3
46785_0,,,,2,1,2,3
46787_0,,,,2,1,2,3
C(CO)(CCO)=CC(C(O)=O)=O,,,5,1,1,0,1
46789_0,,,,2,1,2,3
C(CO)=C(CO)CC(C(O)=O)=O,,,5,1,1,0,1
46790_0,,,,2,1,2,3
46792_0,,,,2,1,2,3
C(CO)(CCO)=C(C(O)=O)C=O,,,5,1,1,0,1
46794_0,,,,2,1,2,3
C(C(C=O)C(CO)=CCO)(O)=O,,,5,1,1,0,1
46795_0,,,,2,1,2,3
46796_0,,,,2,1,2,3
46797_0,,,,2,1,2,3
46798_0,,,,2,1,2,3
46799_0,,,,2,1,2,3
46800_0,,,,2,1,2,3
46801_0,,,,2,1,2,3
46802_0,,,,2,1,2,3
46803_0,,,,2,1,2,3
46804_0,,,,2,1,2,3
46805_0,,,,2,1,2,3
46806_0,,,,2,1,2,3
46807_0,,,,2,1,2,3
46808_0,,,,2,1,2,3
46810_0,,,,2,1,2,3
C(CCO)(C(C(C(O)=O)=C)O)=O,,,5,1,1,0,1
46811_0,,,,2,1,2,3
46813_0,,,,2,1,2,3
C(CCO)(C(C=CC(O)=O)O)=O,,,5,1,2,0,2
46814_0,,,,2,1,2,3
46815_0,,,,2,1,2,3
46816_0,,,,2,1,2,3
46817_0,,,,2,1,2,3
46818_0,,,,2,1,2,3
46819_0,,,,2,1,2,3
46820_0,,,,2,1,2,3
46821_0,,,,2,1,2,3
46822_0,,,,2,1,2,3
46823_0,,,,2,1,2,3
46824_0,,,,2,1,2,3
46825_0,,,,2,1,2,3
46827_0,,,,2,1,2,3
C(C=C(C(CO)=O)CO)(O)=O,,,5,1,1,0,1
46828_0,,,,2,1,2,3
46830_0,,,,2,1,2,3
C(CO)(C(C(C(O)=O)=C)CO)=O,,,5,1,1,0,1
46832_0,,,,2,1,2,3
C(C(C)=C(C(CO)=O)CO)(O)=O,,,5,1,1,0,1
46834_0,,,,2,1,2,3
C(C(C(C(CO)=O)=C)(C)O)(O)=O,,,5,1,2,0,2
46836_0,,,,2,1,2,3
C(CO)(C(C=CC(O)=O)CO)=O,,,5,1,1,0,1
46838_0,,,,2,1,2,3
C(CC=C(C(CO)=O)CO)(O)=O,,,5,1,1,0,1
46840_0,,,,2,1,2,3
C(CC(C(C(CO)=O)=C)O)(O)=O,,,5,1,1,0,1
46842_0,,,,2,1,2,3
C=CC(C=O)=C(C(CO)=O)CO,,,5,1,1,0,1
46844_0,,,,2,1,2,3
C(C(C=C)(C(C(CO)=O)=C)O)=O,,,5,1,1,0,1
46846_0,,,,2,1,2,3
C=CC(C=C(C(CO)=O)CO)=O,,,5,1,1,0,1
46848_0,,,,2,1,2,3
C=CC(C(C(C(CO)=O)=C)O)=O,,,5,1,1,0,1
46850_0,,,,2,1,2,3
C(C=CC=C(C(CO)=O)CO)=O,,,5,1,1,0,1
46852_0,,,,2,1,2,3
C(C(C(C(CO)=O)=C)O)=CC=O,,,5,1,1,0,1
46853_0,,,,2,1,2,3
46854_0,,,,2,1,2,3
46855_0,,,,2,1,2,3
46856_0,,,,2,1,2,3
46857_0,,,,2,1,2,3
46858_0,,,,2,1,2,3
46859_0,,,,2,1,2,3
46860_0,,,,2,1,2,3
46861_0,,,,2,1,2,3
46862_0,,,,2,1,2,3
46863_0,,,,2,1,2,3
46864_0,,,,2,1,2,3
46865_0,,,,2,1,2,3
46866_0,,,,2,1,2,3
46867_0,,,,2,1,2,3
46868_0,,,,2,1,2,3
46869_0,,,,2,1,2,3
46871_0,,,,2,1,2,3
C(C(CCO)O)=CC(C(O)=O)=O,,,5,1,1,0,1
46872_0,,,,2,1,2,3
46873_0,,,,2,1,2,3
46875_0,,,,2,1,2,3
C(C(CCO)O)=C(C(O)=O)C=O,,,5,1,1,0,1
46876_0,,,,2,1,2,3
46877_0,,,,2,1,2,3
46878_0,,,,2,1,2,3
46879_0,,,,2,1,2,3
46880_0,,,,2,1,2,3
46881_0,,,,2,1,2,3
46882_0,,,,2,1,2,3
46883_0,,,,2,1,2,3
46884_0,,,,2,1,2,3
46885_0,,,,2,1,2,3
46886_0,,,,2,1,2,3
46887_0,,,,2,1,2,3
46888_0,,,,2,1,2,3
46889_0,,,,2,1,2,3
46890_0,,,,2,1,2,3
46892_0,,,,2,1,2,3
C(C)(C(CO)O)=CC(C(O)=O)=O,,,5,1,1,0,1
46894_0,,,,2,1,2,3
C=C(C(CO)O)CC(C(O)=O)=O,,,5,1,1,0,1
46896_0,,,,2,1,2,3
C(C)(C(CO)O)=C(C(O)=O)C=O,,,5,1,1,0,1
46898_0,,,,2,1,2,3
C(C(C=O)C(C(CO)O)=C)(O)=O,,,5,1,1,0,1
46899_0,,,,2,1,2,3
46900_0,,,,2,1,2,3
46901_0,,,,2,1,2,3
46902_0,,,,2,1,2,3
46903_0,,,,2,1,2,3
46904_0,,,,2,1,2,3
46905_0,,,,2,1,2,3
46906_0,,,,2,1,2,3
46908_0,,,,2,1,2,3
C(C(CO)O)(CC(C(O)=O)=C)=O,,,5,1,1,0,1
46910_0,,,,2,1,2,3
C(C=C(C(O)=O)C)(C(CO)O)=O,,,5,1,1,0,1
46912_0,,,,2,1,2,3
C(C(CO)O)(CC=CC(O)=O)=O,,,5,1,1,0,1
46914_0,,,,2,1,2,3
C(CC=CC(C(CO)O)=O)(O)=O,,,5,1,1,0,1
46916_0,,,,2,1,2,3
C=CC(C=O)=CC(C(CO)O)=O,,,5,1,1,0,1
46918_0,,,,2,1,2,3
C=CC(C=CC(C(CO)O)=O)=O,,,5,1,1,0,1
46920_0,,,,2,1,2,3
C(C=CC=CC(C(CO)O)=O)=O,,,5,1,1,0,1
46921_0,,,,2,1,2,3
46922_0,,,,2,1,2,3
46923_0,,,,2,1,2,3
46924_0,,,,2,1,2,3
46925_0,,,,2,1,2,3
46926_0,,,,2,1,2,3
46927_0,,,,2,1,2,3
46928_0,,,,2,1,2,3
46930_0,,,,2,1,2,3
C(C(C=CC(O)=O)=O)(O)=O,,,5,1,1,0,1
46932_0,,,,2,1,2,3
C(C(C(O)=O)=CC(O)=O)=O,,,5,1,1,0,1
46934_0,,,,2,1,2,3
C(C(C(C(C(O)=O)=O)=C)O)(O)=O,,,5,1,1,0,1
46936_0,,,,2,1,2,3
C(C(C(CO)=CC(O)=O)=O)(O)=O,,,5,1,1,0,1
46938_0,,,,2,1,2,3
C(C(C(C=O)=CC(O)=O)O)(O)=O,,,5,1,2,0,2
46940_0,,,,2,1,2,3
C(C(C(CO)=O)=CC(O)=O)(O)=O,,,5,1,1,0,1
46941_0,,,,2,1,2,3
46943_0,,,,2,1,2,3
C(C=C1C(C(O)OC1)=O)(O)=O,,,5,1,1,0,1
46945_0,,,,2,1,2,3
C(C(C1C(COC=1)=O)O)(O)=O,,,5,1,1,0,1
46947_0,,,,2,1,2,3
C(C=C1C(COC1O)=O)(O)=O,,,5,1,1,0,1
46948_0,,,,2,1,2,3
46949_0,,,,2,1,2,3
46950_0,,,,2,1,2,3
46951_0,,,,2,1,2,3
46952_0,,,,2,1,2,3
46953_0,,,,2,1,2,3
46954_0,,,,2,1,2,3
46955_0,,,,2,1,2,3
46956_0,,,,2,1,2,3
46958_0,,,,2,1,2,3
C(C(C)=CC(C(O)=O)=O)(O)=O,,,5,1,1,0,1
46960_0,,,,2,1,2,3
C=C(C(O)=O)CC(C(O)=O)=O,,,5,1,1,0,1
46962_0,,,,2,1,2,3
C(C(C(O)=O)=C(C(O)=O)C)=O,,,5,1,1,0,1
46964_0,,,,2,1,2,3
C(C(C(O)=O)C(C(O)=O)=C)=O,,,5,1,1,0,1
46966_0,,,,2,1,2,3
C1(C(COC1C(C(O)=O)=C)O)=O,,,5,1,1,0,1
46968_0,,,,2,1,2,3
C(C(C)=C1C(C(O)OC1)=O)(O)=O,,,5,1,1,0,1
46970_0,,,,2,1,2,3
C1(C(O)OCC1C(C(O)=O)=C)=O,,,5,1,1,0,1
46972_0,,,,2,1,2,3
C(C(C1C(COC=1)=O)(C)O)(O)=O,,,5,1,1,0,1
46974_0,,,,2,1,2,3
C(C(C)=C1C(COC1O)=O)(O)=O,,,5,1,1,0,1
46976_0,,,,2,1,2,3
C1(COC(C1C(C(O)=O)=C)O)=O,,,5,1,1,0,1
46977_0,,,,2,1,2,3
46979_0,,,,2,1,2,3
C1(CC(OC1C(C(O)=O)=C)O)=O,,,5,1,1,0,1
46980_0,,,,2,1,2,3
46981_0,,,,2,1,2,3
46982_0,,,,2,1,2,3
46983_0,,,,2,1,2,3
46984_0,,,,2,1,2,3
46985_0,,,,2,1,2,3
46986_0,,,,2,1,2,3
46987_0,,,,2,1,2,3
46988_0,,,,2,1,2,3
46989_0,,,,2,1,2,3
46990_0,,,,2,1,2,3
46991_0,,,,2,1,2,3
46992_0,,,,2,1,2,3
46993_0,,,,2,1,2,3
46994_0,,,,2,1,2,3
46995_0,,,,2,1,2,3
46996_0,,,,2,1,2,3
46997_0,,,,2,1,2,3
46998_0,,,,2,1,2,3
47000_0,,,,2,1,2,3
C(CC(C(O)=O)=O)=CC(O)=O,,,5,1,1,0,1
47002_0,,,,2,1,2,3
C(CC=CC(C(O)=O)=O)(O)=O,,,5,1,1,0,1
47004_0,,,,2,1,2,3
C1(COCC1O)=CC(C(O)=O)=O,,,5,1,1,0,1
47006_0,,,,2,1,2,3
C1COC(C=1CC(C(O)=O)=O)O,,,5,1,1,0,1
47008_0,,,,2,1,2,3
C1(C(O)OCC1)=CC(C(O)=O)=O,,,5,1,1,0,1
47009_0,,,,2,1,2,3
47011_0,,,,2,1,2,3
C1C(O)OCC=1CC(C(O)=O)=O,,,5,1,1,0,1
47013_0,,,,2,1,2,3
C1(COC(C1)O)=CC(C(O)=O)=O,,,5,1,1,0,1
47015_0,,,,2,1,2,3
C=CC(C=O)=CC(C(O)=O)=O,,,5,1,1,0,1
47017_0,,,,2,1,2,3
C=CC(C=CC(C(O)=O)=O)=O,,,5,1,1,0,1
47019_0,,,,2,1,2,3
C(C=CC=CC(C(O)=O)=O)=O,,,5,1,1,0,1
47020_0,,,,2,1,2,3
47021_0,,,,2,1,2,3
47022_0,,,,2,1,2,3
47023_0,,,,2,1,2,3
47024_0,,,,2,1,2,3
47025_0,,,,2,1,2,3
47026_0,,,,2,1,2,3
47027_0,,,,2,1,2,3
47028_0,,,,2,1,2,3
47029_0,,,,2,1,2,3
47030_0,,,,2,1,2,3
47031_0,,,,2,1,2,3
47032_0,,,,2,1,2,3
47033_0,,,,2,1,2,3
47034_0,,,,2,1,2,3
47035_0,,,,2,1,2,3
47036_0,,,,2,1,2,3
47037_0,,,,2,1,2,3
47038_0,,,,2,1,2,3
47039_0,,,,2,1,2,3
47040_0,,,,2,1,2,3
47041_0,,,,2,1,2,3
47042_0,,,,2,1,2,3
47043_0,,,,2,1,2,3
47044_0,,,,2,1,2,3
47045_0,,,,2,1,2,3
47047_0,,,,2,1,2,3
C(CC=C(C=O)C(O)=O)(O)=O,,,5,1,1,0,1
47049_0,,,,2,1,2,3
C(C(C(O)=O)C=CC(O)=O)=O,,,5,1,1,0,1
47051_0,,,,2,1,2,3
C1(C(COC1C=CC(O)=O)O)=O,,,5,1,1,0,1
47053_0,,,,2,1,2,3
C(CC=C1C(C(O)OC1)=O)(O)=O,,,5,1,1,0,1
47055_0,,,,2,1,2,3
C1(C(O)OCC1C=CC(O)=O)=O,,,5,1,1,0,1
47057_0,,,,2,1,2,3
C(CC(C1C(COC=1)=O)O)(O)=O,,,5,1,1,0,1
47059_0,,,,2,1,2,3
C(CC=C1C(COC1O)=O)(O)=O,,,5,1,1,0,1
47061_0,,,,2,1,2,3
C1(COC(C1C=CC(O)=O)O)=O,,,5,1,1,0,1
47062_0,,,,2,1,2,3
47064_0,,,,2,1,2,3
C1(CC(OC1C=CC(O)=O)O)=O,,,5,1,1,0,1
47065_0,,,,2,1,2,3
47066_0,,,,2,1,2,3
47067_0,,,,2,1,2,3
47068_0,,,,2,1,2,3
47069_0,,,,2,1,2,3
47070_0,,,,2,1,2,3
47071_0,,,,2,1,2,3
47072_0,,,,2,1,2,3
47073_0,,,,2,1,2,3
47074_0,,,,2,1,2,3
47075_0,,,,2,1,2,3
47076_0,,,,2,1,2,3
47077_0,,,,2,1,2,3
47078_0,,,,2,1,2,3
47079_0,,,,2,1,2,3
47080_0,,,,2,1,2,3
47081_0,,,,2,1,2,3
47082_0,,,,2,1,2,3
47083_0,,,,2,1,2,3
47085_0,,,,2,1,2,3
C1(COCC1O)=C(C(O)=O)C=O,,,5,1,1,0,1
47087_0,,,,2,1,2,3
C(C(C=O)C1C(O)OCC=1)(O)=O,,,5,1,1,0,1
47089_0,,,,2,1,2,3
C1(C(O)OCC1)=C(C(O)=O)C=O,,,5,1,1,0,1
47090_0,,,,2,1,2,3
47092_0,,,,2,1,2,3
C(C(C=O)C1COC(C=1)O)(O)=O,,,5,1,1,0,1
47094_0,,,,2,1,2,3
C1(COC(C1)O)=C(C(O)=O)C=O,,,5,1,1,0,1
47096_0,,,,2,1,2,3
C=CC(C=O)=C(C=O)C(O)=O,,,5,1,1,0,1
47098_0,,,,2,1,2,3
C=CC(C=C(C=O)C(O)=O)=O,,,5,1,1,0,1
47100_0,,,,2,1,2,3
C(C(C(O)=O)=CC=CC=O)=O,,,5,1,1,0,1
47101_0,,,,2,1,2,3
47102_0,,,,2,1,2,3
47103_0,,,,2,1,2,3
47104_0,,,,2,1,2,3
47105_0,,,,2,1,2,3
47106_0,,,,2,1,2,3
47107_0,,,,2,1,2,3
47108_0,,,,2,1,2,3
47109_0,,,,2,1,2,3
47110_0,,,,2,1,2,3
47111_0,,,,2,1,2,3
47112_0,,,,2,1,2,3
47113_0,,,,2,1,2,3
47114_0,,,,2,1,2,3
47115_0,,,,2,1,2,3
47116_0,,,,2,1,2,3
47117_0,,,,2,1,2,3
47118_0,,,,2,1,2,3
47119_0,,,,2,1,2,3
47120_0,,,,2,1,2,3
47121_0,,,,2,1,2,3
47122_0,,,,2,1,2,3
47123_0,,,,2,1,2,3
47124_0,,,,2,1,2,3
47125_0,,,,2,1,2,3
47126_0,,,,2,1,2,3
47127_0,,,,2,1,2,3
47128_0,,,,2,1,2,3
47129_0,,,,2,1,2,3
47130_0,,,,2,1,2,3
47131_0,,,,2,1,2,3
47132_0,,,,2,1,2,3
47133_0,,,,2,1,2,3
47134_0,,,,2,1,2,3
47135_0,,,,2,1,2,3
47136_0,,,,2,1,2,3
47137_0,,,,2,1,2,3
47138_0,,,,2,1,2,3
47139_0,,,,2,1,2,3
47140_0,,,,2,1,2,3
47141_0,,,,2,1,2,3
47142_0,,,,2,1,2,3
47143_0,,,,2,1,2,3
47144_0,,,,2,1,2,3
47145_0,,,,2,1,2,3
47146_0,,,,2,1,2,3
47147_0,,,,2,1,2,3
47148_0,,,,2,1,2,3
47149_0,,,,2,1,2,3
47150_0,,,,2,1,2,3
47151_0,,,,2,1,2,3
47152_0,,,,2,1,2,3
47153_0,,,,2,1,2,3
47154_0,,,,2,1,2,3
47155_0,,,,2,1,2,3
47156_0,,,,2,1,2,3
47157_0,,,,2,1,2,3
47158_0,,,,2,1,2,3
47159_0,,,,2,1,2,3
47160_0,,,,2,1,2,3
47161_0,,,,2,1,2,3
47162_0,,,,2,1,2,3
47163_0,,,,2,1,2,3
47164_0,,,,2,1,2,3
47165_0,,,,2,1,2,3
47166_0,,,,2,1,2,3
47167_0,,,,2,1,2,3
47168_0,,,,2,1,2,3
47169_0,,,,2,1,2,3
47170_0,,,,2,1,2,3
47171_0,,,,2,1,2,3
47172_0,,,,2,1,2,3
47173_0,,,,2,1,2,3
47174_0,,,,2,1,2,3
47175_0,,,,2,1,2,3
47176_0,,,,2,1,2,3
47177_0,,,,2,1,2,3
47178_0,,,,2,1,2,3
47179_0,,,,2,1,2,3
47180_0,,,,2,1,2,3
47181_0,,,,2,1,2,3
47182_0,,,,2,1,2,3
47183_0,,,,2,1,2,3
47184_0,,,,2,1,2,3
47185_0,,,,2,1,2,3
47186_0,,,,2,1,2,3
47187_0,,,,2,1,2,3
47188_0,,,,2,1,2,3
47189_0,,,,2,1,2,3
47190_0,,,,2,1,2,3
47191_0,,,,2,1,2,3
47192_0,,,,2,1,2,3
47193_0,,,,2,1,2,3
47194_0,,,,2,1,2,3
47195_0,,,,2,1,2,3
47196_0,,,,2,1,2,3
47197_0,,,,2,1,2,3
47198_0,,,,2,1,2,3
47199_0,,,,2,1,2,3
47200_0,,,,2,1,2,3
47201_0,,,,2,1,2,3
47202_0,,,,2,1,2,3
47203_0,,,,2,1,2,3
47204_0,,,,2,1,2,3
47205_0,,,,2,1,2,3
47206_0,,,,2,1,2,3
47207_0,,,,2,1,2,3
47208_0,,,,2,1,2,3
47209_0,,,,2,1,2,3
47210_0,,,,2,1,2,3
47211_0,,,,2,1,2,3
47212_0,,,,2,1,2,3
47213_0,,,,2,1,2,3
47214_0,,,,2,1,2,3
47216_0,,,,2,1,2,3
C(C(C=C(C=O)CO)(CO)O)=O,,,5,1,1,0,1
47217_0,,,,2,1,2,3
47218_0,,,,2,1,2,3
47219_0,,,,2,1,2,3
47220_0,,,,2,1,2,3
47221_0,,,,2,1,2,3
47222_0,,,,2,1,2,3
47223_0,,,,2,1,2,3
47224_0,,,,2,1,2,3
47225_0,,,,2,1,2,3
47226_0,,,,2,1,2,3
47227_0,,,,2,1,2,3
47228_0,,,,2,1,2,3
47229_0,,,,2,1,2,3
47230_0,,,,2,1,2,3
47231_0,,,,2,1,2,3
47232_0,,,,2,1,2,3
47233_0,,,,2,1,2,3
47234_0,,,,2,1,2,3
47236_0,,,,2,1,2,3
C(C(CO)(C(C)O)O)=CC=O,,,5,1,1,0,1
47237_0,,,,2,1,2,3
47238_0,,,,2,1,2,3
47239_0,,,,2,1,2,3
47240_0,,,,2,1,2,3
47241_0,,,,2,1,2,3
47242_0,,,,2,1,2,3
47243_0,,,,2,1,2,3
47244_0,,,,2,1,2,3
47245_0,,,,2,1,2,3
47246_0,,,,2,1,2,3
47247_0,,,,2,1,2,3
47248_0,,,,2,1,2,3
47249_0,,,,2,1,2,3
47250_0,,,,2,1,2,3
47251_0,,,,2,1,2,3
47253_0,,,,2,1,2,3
C(C(C=C(C=O)C(C)O)O)(O)=O,,,5,1,1,0,1
47254_0,,,,2,1,2,3
47256_0,,,,2,1,2,3
C(C(C=C(C=O)CO)O)(O)=O,,,5,1,1,0,1
47258_0,,,,2,1,2,3
C(CC(C=CC=O)(C(C)O)O)=O,,,5,1,1,0,1
47259_0,,,,2,1,2,3
47260_0,,,,2,1,2,3
47261_0,,,,2,1,2,3
47262_0,,,,2,1,2,3
47263_0,,,,2,1,2,3
47264_0,,,,2,1,2,3
47265_0,,,,2,1,2,3
47266_0,,,,2,1,2,3
47267_0,,,,2,1,2,3
47268_0,,,,2,1,2,3
47269_0,,,,2,1,2,3
47270_0,,,,2,1,2,3
47271_0,,,,2,1,2,3
47273_0,,,,2,1,2,3
C(C(CC(CO)=CC=O)O)=O,,,5,1,1,0,1
47274_0,,,,2,1,2,3
47276_0,,,,2,1,2,3
C(CC(CO)=CC(C=O)O)=O,,,5,1,1,0,1
47277_0,,,,2,1,2,3
47278_0,,,,2,1,2,3
47280_0,,,,2,1,2,3
C(C(C(C(CO)=O)=CC=O)O)=O,,,5,1,1,0,1
47282_0,,,,2,1,2,3
C(C(C(C(CO)=O)C=C)O)=O,,,5,1,1,0,1
47284_0,,,,2,1,2,3
C(C(C(C(CO)=O)=CC)O)=O,,,5,1,1,0,1
47286_0,,,,2,1,2,3
C(C=C(C(CO)=O)C(C)O)=O,,,5,1,1,0,1
47288_0,,,,2,1,2,3
C(C(C(C(CO)=O)=CCO)O)=O,,,5,1,1,0,1
47290_0,,,,2,1,2,3
C(C=C(C(CO)=O)C(CO)O)=O,,,5,1,1,0,1
47292_0,,,,2,1,2,3
C(C(CC(C(C=C)O)=O)O)=O,,,5,1,1,0,1
47293_0,,,,2,1,2,3
47294_0,,,,2,1,2,3
47295_0,,,,2,1,2,3
47296_0,,,,2,1,2,3
47298_0,,,,2,1,2,3
C(C(C(C(CO)=C)=O)(CO)O)=O,,,5,1,1,0,1
47300_0,,,,2,1,2,3
C(C(CC(CO)O)=CC=O)(O)=O,,,5,1,1,0,1
47302_0,,,,2,1,2,3
C(CC(C(O)=O)=CC(CO)O)=O,,,5,1,1,0,1
47303_0,,,,2,1,2,3
47305_0,,,,2,1,2,3
C=CC(C(C(O)=O)=O)C(CO)O,,,5,1,1,0,1
47307_0,,,,2,1,2,3
C(C)=C(C(C(O)=O)=O)C(CO)O,,,5,1,1,0,1
47309_0,,,,2,1,2,3
C(CO)=C(C(C(O)=O)=O)C(C)O,,,5,1,1,0,1
47310_0,,,,2,1,2,3
47311_0,,,,2,1,2,3
47312_0,,,,2,1,2,3
47314_0,,,,2,1,2,3
C(C(C(C(CO)=O)C=C)O)(O)=O,,,5,1,1,0,1
47316_0,,,,2,1,2,3
C(C(C(C(CO)=O)=CC)O)(O)=O,,,5,1,1,0,1
47318_0,,,,2,1,2,3
C(C=C(C(CO)=O)C(C)O)(O)=O,,,5,1,1,0,1
47320_0,,,,2,1,2,3
C(C(CC(C(C=C)O)=O)O)(O)=O,,,5,1,1,0,1
47321_0,,,,2,1,2,3
47323_0,,,,2,1,2,3
C(CC(C(CO)O)=CC=O)(O)=O,,,5,1,1,0,1
47325_0,,,,2,1,2,3
C(CC(C(CO)O)=CC(O)=O)=O,,,5,1,1,0,1
47327_0,,,,2,1,2,3
C(C(C(C(CO)O)=O)C=C)(O)=O,,,5,1,1,0,1
47329_0,,,,2,1,2,3
C(C)=C(C(C(CO)O)=O)C(O)=O,,,5,1,1,0,1
47330_0,,,,2,1,2,3
47332_0,,,,2,1,2,3
C(C(C(CCO)=CC=O)O)(O)=O,,,5,1,1,0,1
47334_0,,,,2,1,2,3
C(CC(C(C(O)=O)O)=CCO)=O,,,5,1,1,0,1
47335_0,,,,2,1,2,3
47337_0,,,,2,1,2,3
C(C(C(O)=O)O)(C(C=C)CO)=O,,,5,1,1,0,1
47339_0,,,,2,1,2,3
C(C(C(C(CO)=CC)=O)O)(O)=O,,,5,1,1,0,1
47341_0,,,,2,1,2,3
C(C(C(C(C(C)O)=C)=O)O)(O)=O,,,5,1,1,0,1
47343_0,,,,2,1,2,3
C(C(C(C(CO)=C)=O)O)(O)=O,,,5,1,1,0,1
47345_0,,,,2,1,2,3
C1(COCC1O)=CC(C=O)=O,,,5,1,1,0,1
47347_0,,,,2,1,2,3
C1(COCC1O)=C(C=O)C=O,,,5,1,1,0,1
47349_0,,,,2,1,2,3
C1(COCC1O)=CC=O,,,5,1,1,0,1
47351_0,,,,2,1,2,3
C1(C(COC1C(C=O)=C)O)=O,,,5,1,1,0,1
47353_0,,,,2,1,2,3
C1(C(COC1C=CC=O)O)=O,,,5,1,1,0,1
47355_0,,,,2,1,2,3
C1(C(COC1C=C)O)=O,,,5,1,1,0,1
47357_0,,,,2,1,2,3
C(CO)(C(C1C(O)OCC=1)O)=O,,,5,1,1,0,1
47359_0,,,,2,1,2,3
C1(C(O)OCC1)=CC(C=O)=O,,,5,1,2,0,2
47361_0,,,,2,1,2,3
C1COC(C=1CC(C=O)=O)O,,,5,1,1,0,1
47363_0,,,,2,1,2,3
C1(C(O)OCC1)=C(C=O)C=O,,,5,1,2,0,2
47365_0,,,,2,1,2,3
C(C(C=O)C1C(O)OCC=1)=O,,,5,1,1,0,1
47367_0,,,,2,1,2,3
C1(C(O)OCC1)=CC=O,,,5,1,2,0,2
47369_0,,,,2,1,2,3
C(CC1C(O)OCC=1)=O,,,5,1,1,0,1
47371_0,,,,2,1,2,3
C(C(C1C(O)OCC=1)O)=O,,,5,1,2,0,2
47373_0,,,,2,1,2,3
C=CC(C=O)=C1C(C(O)OC1)=O,,,5,1,1,0,1
47375_0,,,,2,1,2,3
C=CC(C=C1C(C(O)OC1)=O)=O,,,5,1,1,0,1
47377_0,,,,2,1,2,3
C(C=CC=C1C(C(O)OC1)=O)=O,,,5,1,1,0,1
47379_0,,,,2,1,2,3
C(C(CO)O)=C1C(C(OC1)O)=O,,,5,1,2,0,2
47381_0,,,,2,1,2,3
C(C=C1C(C(O)OC1)=O)=O,,,5,1,3,0,3
47383_0,,,,2,1,2,3
C(CO)(CO)=C1C(C(O)OC1)=O,,,5,1,2,0,2
47385_0,,,,2,1,2,3
C1(C(O)OCC1C(C=O)=C)=O,,,5,1,2,0,2
47387_0,,,,2,1,2,3
C(C(C)=C1C(C(O)OC1)=O)=O,,,5,1,2,0,2
47389_0,,,,2,1,2,3
C1(C(COC1O)=CC(C)=O)=O,,,5,1,2,0,2
47391_0,,,,2,1,2,3
C1(C(O)OCC1C=CC=O)=O,,,5,1,2,0,2
47393_0,,,,2,1,2,3
C(CC=C1C(C(O)OC1)=O)=O,,,5,1,2,0,2
47395_0,,,,2,1,2,3
C1(C(O)OCC1C=C)=O,,,5,1,2,0,2
47397_0,,,,2,1,2,3
C(C)=C1C(C(O)OC1)=O,,,5,1,2,0,2
47399_0,,,,2,1,2,3
C=C1C(C(O)OC1)=O,,,5,1,3,0,3
47401_0,,,,2,1,2,3
C(CO)=C1C(C(O)OC1)=O,,,5,1,2,0,2
47402_0,,,,2,1,2,3
47404_0,,,,2,1,2,3
C(CO)(C(C1COC(C=1)O)O)=O,,,5,1,1,0,1
47406_0,,,,2,1,2,3
C1(COC(C1)O)=CC(C=O)=O,,,5,1,2,0,2
47407_0,,,,2,1,2,3
47409_0,,,,2,1,2,3
C1C(O)OCC=1CC(C=O)=O,,,5,1,1,0,1
47411_0,,,,2,1,2,3
C1(COC(C1)O)=C(C=O)C=O,,,5,1,2,0,2
47412_0,,,,2,1,2,3
47414_0,,,,2,1,2,3
C(C(C=O)C1COC(C=1)O)=O,,,5,1,1,0,1
47416_0,,,,2,1,2,3
C1(COC(C1)O)=CC=O,,,5,1,2,0,2
47417_0,,,,2,1,2,3
47419_0,,,,2,1,2,3
C(CC1COC(C=1)O)=O,,,5,1,1,0,1
47420_0,,,,2,1,2,3
47422_0,,,,2,1,2,3
C(C(C1COC(C=1)O)O)=O,,,5,1,1,0,1
47424_0,,,,2,1,2,3
C=CC(C=O)=C1C(COC1O)=O,,,5,1,1,0,1
47426_0,,,,2,1,2,3
C(C(C=C)(C1C(COC=1)=O)O)=O,,,5,1,1,0,1
47428_0,,,,2,1,2,3
C=CC(C=C1C(COC1O)=O)=O,,,5,1,1,0,1
47430_0,,,,2,1,2,3
C=CC(C(C1C(COC=1)=O)O)=O,,,5,1,1,0,1
47432_0,,,,2,1,2,3
C(C=CC=C1C(COC1O)=O)=O,,,5,1,1,0,1
47434_0,,,,2,1,2,3
C(C(C1C(COC=1)=O)O)=CC=O,,,5,1,1,0,1
47436_0,,,,2,1,2,3
C(C(CO)O)=C1C(COC1O)=O,,,5,1,2,0,2
47438_0,,,,2,1,2,3
C1OCC(C=1C(C(CO)O)O)=O,,,5,1,1,0,1
47440_0,,,,2,1,2,3
C(C=C1C(COC1O)=O)=O,,,5,1,3,0,3
47442_0,,,,2,1,2,3
C(C(C1C(COC=1)=O)O)=O,,,5,1,1,0,1
47444_0,,,,2,1,2,3
C(CO)(CO)=C1C(COC1O)=O,,,5,1,2,0,2
47446_0,,,,2,1,2,3
C1OCC(C=1C(CO)(CO)O)=O,,,5,1,1,0,1
47448_0,,,,2,1,2,3
C1(COC(C1C(C=O)=C)O)=O,,,5,1,2,0,2
47450_0,,,,2,1,2,3
C(C(C)=C1C(COC1O)=O)=O,,,5,1,2,0,2
47452_0,,,,2,1,2,3
C(C(C1C(COC=1)=O)(C)O)=O,,,5,1,1,0,1
47454_0,,,,2,1,2,3
C1(C(C(O)OC1)=CC(C)=O)=O,,,5,1,2,0,2
47456_0,,,,2,1,2,3
C(C)(C(C1C(COC=1)=O)O)=O,,,5,1,1,0,1
47458_0,,,,2,1,2,3
C1(COC(C1C=CC=O)O)=O,,,5,1,2,0,2
47460_0,,,,2,1,2,3
C(CC=C1C(COC1O)=O)=O,,,5,1,2,0,2
47462_0,,,,2,1,2,3
C(CC(C1C(COC=1)=O)O)=O,,,5,1,1,0,1
47464_0,,,,2,1,2,3
C1(COC(C1C=C)O)=O,,,5,1,2,0,2
47466_0,,,,2,1,2,3
C(C)=C1C(COC1O)=O,,,5,1,2,0,2
47468_0,,,,2,1,2,3
C1OCC(C=1C(C)O)=O,,,5,1,1,0,1
47470_0,,,,2,1,2,3
C=C1C(COC1O)=O,,,5,1,3,0,3
47472_0,,,,2,1,2,3
C1OCC(C=1CO)=O,,,5,1,1,0,1
47474_0,,,,2,1,2,3
C(CO)=C1C(COC1O)=O,,,5,1,2,0,2
47476_0,,,,2,1,2,3
C1OCC(C=1C(CO)O)=O,,,5,1,1,0,1
47477_0,,,,2,1,2,3
47478_0,,,,2,1,2,3
47479_0,,,,2,1,2,3
47480_0,,,,2,1,2,3
47481_0,,,,2,1,2,3
47482_0,,,,2,1,2,3
47484_0,,,,2,1,2,3
C1(CC(OC1C(C=O)=C)O)=O,,,5,1,2,0,2
47485_0,,,,2,1,2,3
47486_0,,,,2,1,2,3
47488_0,,,,2,1,2,3
C1(CC(OC1C=CC=O)O)=O,,,5,1,2,0,2
47489_0,,,,2,1,2,3
47491_0,,,,2,1,2,3
C1(CC(OC1C=C)O)=O,,,5,1,2,0,2
47492_0,,,,2,1,2,3
47493_0,,,,2,1,2,3
47494_0,,,,2,1,2,3
47496_0,,,,2,1,2,3
C=CC(C=O)=CC(C=O)=O,,,5,1,2,0,2
47498_0,,,,2,1,2,3
C=CC(C=O)=C(C=O)C=O,,,5,1,2,0,2
47500_0,,,,2,1,2,3
C(C(C=C)(C(C(C=O)=O)=C)O)=O,,,5,1,2,0,2
47502_0,,,,2,1,2,3
C=CC(C=O)=C(C(C=O)=O)CO,,,5,1,1,0,1
47504_0,,,,2,1,2,3
C(C(C=C)(C(C=O)=CC=O)O)=O,,,5,1,2,0,2
47506_0,,,,2,1,2,3
C(C(C(C=O)=C(C=O)C=C)O)=O,,,5,1,1,0,1
47508_0,,,,2,1,2,3
C=CC(C=O)=C(C=O)C(CO)=O,,,5,1,1,0,1
47510_0,,,,2,1,2,3
C(C(C(C=C(C=O)C=C)=O)O)=O,,,5,1,1,0,1
47512_0,,,,2,1,2,3
C=CC(C=O)=CC=O,,,5,1,4,0,4
47514_0,,,,2,1,2,3
C=CC(C=CC(C=O)=O)=O,,,5,1,2,0,2
47516_0,,,,2,1,2,3
C=CC(C=C(C=O)C=O)=O,,,5,1,2,0,2
47518_0,,,,2,1,2,3
C=C(C(C=O)=O)C(C(C=C)=O)O,,,5,1,2,0,2
47520_0,,,,2,1,2,3
C=CC(C=C(C(C=O)=O)CO)=O,,,5,1,1,0,1
47522_0,,,,2,1,2,3
C=CC(C(C(C=O)=CC=O)O)=O,,,5,1,2,0,2
47524_0,,,,2,1,2,3
C(C(C(C=O)=CC(C=C)=O)O)=O,,,5,1,1,0,1
47526_0,,,,2,1,2,3
C=CC(C=C(C=O)C(CO)=O)=O,,,5,1,1,0,1
47528_0,,,,2,1,2,3
C(C(C(C=CC(C=C)=O)=O)O)=O,,,5,1,1,0,1
47530_0,,,,2,1,2,3
C=CC(C=CC=O)=O,,,5,1,2,0,2
47532_0,,,,2,1,2,3
C(C=CC=CC(C=O)=O)=O,,,5,1,3,0,3
47534_0,,,,2,1,2,3
C(C(C=O)=CC=CC=O)=O,,,5,1,3,0,3
47536_0,,,,2,1,2,3
C=C(C(C=O)=O)C(C=CC=O)O,,,5,1,2,0,2
47538_0,,,,2,1,2,3
C(C=CC=C(C(C=O)=O)CO)=O,,,5,1,1,0,1
47540_0,,,,2,1,2,3
C(C(C(C=O)=CC=O)O)=CC=O,,,5,1,2,0,2
47542_0,,,,2,1,2,3
C(C(C(C=O)=CC=CC=O)O)=O,,,5,1,1,0,1
47544_0,,,,2,1,2,3
C(C(C(CO)=O)=CC=CC=O)=O,,,5,1,1,0,1
47546_0,,,,2,1,2,3
C(C(C(C=CC=CC=O)=O)O)=O,,,5,1,1,0,1
47548_0,,,,2,1,2,3
C(C=CC=CC=O)=O,,,5,1,2,0,2
47549_0,,,,2,1,2,3
47550_0,,,,2,1,2,3
47551_0,,,,2,1,2,3
47552_0,,,,2,1,2,3
47553_0,,,,2,1,2,3
47554_0,,,,2,1,2,3
47555_0,,,,2,1,2,3
47557_0,,,,2,1,2,3
C(C(C=CC(O)=O)(C)O)=O,,,5,1,1,0,1
47558_0,,,,2,1,2,3
47559_0,,,,2,1,2,3
47561_0,,,,2,1,2,3
C(C(C(CO)=CC(O)=O)(C)O)=O,,,5,1,1,0,1
47562_0,,,,2,1,2,3
47563_0,,,,2,1,2,3
47564_0,,,,2,1,2,3
47565_0,,,,2,1,2,3
47566_0,,,,2,1,2,3
47567_0,,,,2,1,2,3
47568_0,,,,2,1,2,3
47569_0,,,,2,1,2,3
47570_0,,,,2,1,2,3
47571_0,,,,2,1,2,3
47572_0,,,,2,1,2,3
47574_0,,,,2,1,2,3
C(C(C=CC(O)=O)(CCO)O)=O,,,5,1,2,0,2
47575_0,,,,2,1,2,3
47576_0,,,,2,1,2,3
47577_0,,,,2,1,2,3
47578_0,,,,2,1,2,3
47579_0,,,,2,1,2,3
47581_0,,,,2,1,2,3
C(CC(C(C=CC(O)=O)O)O)=O,,,5,1,1,0,1
47582_0,,,,2,1,2,3
47583_0,,,,2,1,2,3
47584_0,,,,2,1,2,3
47586_0,,,,2,1,2,3
C(C(CC(C=CC(O)=O)O)O)=O,,,5,1,1,0,1
47587_0,,,,2,1,2,3
47588_0,,,,2,1,2,3
47590_0,,,,2,1,2,3
C(C(C(C=CC(O)=O)(C)O)O)=O,,,5,1,1,0,1
47591_0,,,,2,1,2,3
47592_0,,,,2,1,2,3
47594_0,,,,2,1,2,3
C(C(C)O)=CC(O)=O,,,5,1,1,0,1
47595_0,,,,2,1,2,3
47596_0,,,,2,1,2,3
47597_0,,,,2,1,2,3
47598_0,,,,2,1,2,3
47600_0,,,,2,1,2,3
C(CC(C(CO)=CC(O)=O)O)=O,,,5,1,1,0,1
47601_0,,,,2,1,2,3
47602_0,,,,2,1,2,3
47603_0,,,,2,1,2,3
47604_0,,,,2,1,2,3
47605_0,,,,2,1,2,3
47607_0,,,,2,1,2,3
C(CO)(C(C)O)=CC(O)=O,,,5,1,1,0,1
47608_0,,,,2,1,2,3
47609_0,,,,2,1,2,3
47610_0,,,,2,1,2,3
47611_0,,,,2,1,2,3
47612_0,,,,2,1,2,3
47613_0,,,,2,1,2,3
47615_0,,,,2,1,2,3
C=C(C(O)=O)CO,,,5,1,1,0,1
47616_0,,,,2,1,2,3
47617_0,,,,2,1,2,3
47618_0,,,,2,1,2,3
47619_0,,,,2,1,2,3
47620_0,,,,2,1,2,3
47621_0,,,,2,1,2,3
47622_0,,,,2,1,2,3
47623_0,,,,2,1,2,3
47624_0,,,,2,1,2,3
47625_0,,,,2,1,2,3
47626_0,,,,2,1,2,3
47627_0,,,,2,1,2,3
47628_0,,,,2,1,2,3
47629_0,,,,2,1,2,3
47630_0,,,,2,1,2,3
47631_0,,,,2,1,2,3
47632_0,,,,2,1,2,3
47633_0,,,,2,1,2,3
47634_0,,,,2,1,2,3
47635_0,,,,2,1,2,3
47636_0,,,,2,1,2,3
47637_0,,,,2,1,2,3
47638_0,,,,2,1,2,3
47639_0,,,,2,1,2,3
47640_0,,,,2,1,2,3
47641_0,,,,2,1,2,3
47642_0,,,,2,1,2,3
47643_0,,,,2,1,2,3
47644_0,,,,2,1,2,3
47645_0,,,,2,1,2,3
47646_0,,,,2,1,2,3
47648_0,,,,2,1,2,3
C(CO)(C(C(C=CCO)=O)O)=O,,,5,1,1,0,1
47649_0,,,,2,1,2,3
47650_0,,,,2,1,2,3
47651_0,,,,2,1,2,3
47652_0,,,,2,1,2,3
47653_0,,,,2,1,2,3
47654_0,,,,2,1,2,3
47655_0,,,,2,1,2,3
47656_0,,,,2,1,2,3
47657_0,,,,2,1,2,3
47658_0,,,,2,1,2,3
47659_0,,,,2,1,2,3
47660_0,,,,2,1,2,3
47661_0,,,,2,1,2,3
47662_0,,,,2,1,2,3
47663_0,,,,2,1,2,3
47665_0,,,,2,1,2,3
C(C(C(C=CC=O)=O)(C)O)=O,,,5,1,1,0,1
47666_0,,,,2,1,2,3
47668_0,,,,2,1,2,3
C(C(C=CC(C=O)=O)(C)O)=O,,,5,1,1,0,1
47669_0,,,,2,1,2,3
47670_0,,,,2,1,2,3
47671_0,,,,2,1,2,3
47672_0,,,,2,1,2,3
47673_0,,,,2,1,2,3
47674_0,,,,2,1,2,3
47676_0,,,,2,1,2,3
C=CC(C(C(C=O)=O)CO)=O,,,5,1,2,0,2
47677_0,,,,2,1,2,3
47679_0,,,,2,1,2,3
C(C(C(C=C)=O)C(C=O)O)=O,,,5,1,2,0,2
47681_0,,,,2,1,2,3
C(C(C(CO)=O)C(C=C)=O)=O,,,5,1,2,0,2
47683_0,,,,2,1,2,3
C(C)(C(C(C=CC=O)=O)O)=O,,,5,1,1,0,1
47685_0,,,,2,1,2,3
C(CC(C(C(C=C)=O)O)=O)=O,,,5,1,2,0,2
47686_0,,,,2,1,2,3
47687_0,,,,2,1,2,3
47689_0,,,,2,1,2,3
C(C(C(CC(C=C)=O)=O)O)=O,,,5,1,2,0,2
47691_0,,,,2,1,2,3
C(CC(C=C)=O)=O,,,5,1,2,0,2
47692_0,,,,2,1,2,3
47694_0,,,,2,1,2,3
C(CO)=CC(CC(C=O)=O)=O,,,5,1,2,0,2
47695_0,,,,2,1,2,3
47696_0,,,,2,1,2,3
47697_0,,,,2,1,2,3
47698_0,,,,2,1,2,3
47699_0,,,,2,1,2,3
47701_0,,,,2,1,2,3
C(C(C=O)C(C=CCO)=O)=O,,,5,1,2,0,2
47702_0,,,,2,1,2,3
47703_0,,,,2,1,2,3
47704_0,,,,2,1,2,3
47706_0,,,,2,1,2,3
C(CC(C=CCO)=O)=O,,,5,1,2,0,2
47707_0,,,,2,1,2,3
47708_0,,,,2,1,2,3
47709_0,,,,2,1,2,3
47710_0,,,,2,1,2,3
47711_0,,,,2,1,2,3
47712_0,,,,2,1,2,3
47713_0,,,,2,1,2,3
47714_0,,,,2,1,2,3
47715_0,,,,2,1,2,3
47717_0,,,,2,1,2,3
C(C(C)O)=CC(C=O)=O,,,5,1,1,0,1
47718_0,,,,2,1,2,3
47719_0,,,,2,1,2,3
47720_0,,,,2,1,2,3
47721_0,,,,2,1,2,3
47722_0,,,,2,1,2,3
47723_0,,,,2,1,2,3
47724_0,,,,2,1,2,3
47725_0,,,,2,1,2,3
47726_0,,,,2,1,2,3
47728_0,,,,2,1,2,3
C(CO)(C(C(C=C)=O)(CO)O)=O,,,5,1,1,0,1
47729_0,,,,2,1,2,3
47730_0,,,,2,1,2,3
47732_0,,,,2,1,2,3
C(C(C(C)=O)(C(C=C)=O)O)=O,,,5,1,2,0,2
47733_0,,,,2,1,2,3
47734_0,,,,2,1,2,3
47735_0,,,,2,1,2,3
47736_0,,,,2,1,2,3
47737_0,,,,2,1,2,3
47738_0,,,,2,1,2,3
47739_0,,,,2,1,2,3
47740_0,,,,2,1,2,3
47742_0,,,,2,1,2,3
C(C(C(C=C)=O)(CC=O)O)=O,,,5,1,2,0,2
47743_0,,,,2,1,2,3
47744_0,,,,2,1,2,3
47745_0,,,,2,1,2,3
47746_0,,,,2,1,2,3
47747_0,,,,2,1,2,3
47748_0,,,,2,1,2,3
47749_0,,,,2,1,2,3
47750_0,,,,2,1,2,3
47751_0,,,,2,1,2,3
47752_0,,,,2,1,2,3
47753_0,,,,2,1,2,3
47754_0,,,,2,1,2,3
47755_0,,,,2,1,2,3
47756_0,,,,2,1,2,3
47757_0,,,,2,1,2,3
47758_0,,,,2,1,2,3
47759_0,,,,2,1,2,3
47761_0,,,,2,1,2,3
C=CC(C(C(C(CO)O)O)O)O,,,5,1,1,0,1
47762_0,,,,2,1,2,3
47763_0,,,,2,1,2,3
47764_0,,,,2,1,2,3
47765_0,,,,2,1,2,3
47766_0,,,,2,1,2,3
47767_0,,,,2,1,2,3
47768_0,,,,2,1,2,3
47769_0,,,,2,1,2,3
47770_0,,,,2,1,2,3
47771_0,,,,2,1,2,3
47773_0,,,,2,1,2,3
C=CC(C(CO)(CO)O)O,,,5,1,1,0,1
47774_0,,,,2,1,2,3
47776_0,,,,2,1,2,3
C=CC(C(CO)(C(CO)O)O)O,,,5,1,1,0,1
47777_0,,,,2,1,2,3
47778_0,,,,2,1,2,3
47780_0,,,,2,1,2,3
C(C(C(C(C=O)O)=C)(C)O)=O,,,5,1,1,0,1
47781_0,,,,2,1,2,3
47782_0,,,,2,1,2,3
47784_0,,,,2,1,2,3
C(C(C=C)(C)O)=O,,,5,1,1,0,1
47785_0,,,,2,1,2,3
47786_0,,,,2,1,2,3
47787_0,,,,2,1,2,3
47788_0,,,,2,1,2,3
47789_0,,,,2,1,2,3
47790_0,,,,2,1,2,3
47791_0,,,,2,1,2,3
47792_0,,,,2,1,2,3
47793_0,,,,2,1,2,3
47794_0,,,,2,1,2,3
47795_0,,,,2,1,2,3
47796_0,,,,2,1,2,3
47797_0,,,,2,1,2,3
47798_0,,,,2,1,2,3
47799_0,,,,2,1,2,3
47801_0,,,,2,1,2,3
C(C(CC(C=C)O)O)=O,,,5,1,1,0,1
47802_0,,,,2,1,2,3
47803_0,,,,2,1,2,3
47804_0,,,,2,1,2,3
47805_0,,,,2,1,2,3
47806_0,,,,2,1,2,3
47807_0,,,,2,1,2,3
47808_0,,,,2,1,2,3
47809_0,,,,2,1,2,3
47811_0,,,,2,1,2,3
C(C(C(C(C)O)=C)O)=O,,,5,1,1,0,1
47812_0,,,,2,1,2,3
47813_0,,,,2,1,2,3
47815_0,,,,2,1,2,3
C(C(C(C(C(CO)O)O)=C)O)=O,,,5,1,1,0,1
47816_0,,,,2,1,2,3
47817_0,,,,2,1,2,3
47818_0,,,,2,1,2,3
47819_0,,,,2,1,2,3
47820_0,,,,2,1,2,3
47822_0,,,,2,1,2,3
C(C(C(C=C)(C)O)O)=O,,,5,1,1,0,1
47823_0,,,,2,1,2,3
47824_0,,,,2,1,2,3
47826_0,,,,2,1,2,3
C=CC(C)O,,,5,1,1,0,1
47827_0,,,,2,1,2,3
47828_0,,,,2,1,2,3
47829_0,,,,2,1,2,3
47830_0,,,,2,1,2,3
47832_0,,,,2,1,2,3
C=CC(C(CO)O)O,,,5,1,2,0,2
47833_0,,,,2,1,2,3
47835_0,,,,2,1,2,3
C=CC(C(C(CO)O)O)O,,,5,1,1,0,1
47836_0,,,,2,1,2,3
47837_0,,,,2,1,2,3
47838_0,,,,2,1,2,3
47839_0,,,,2,1,2,3
47840_0,,,,2,1,2,3
47841_0,,,,2,1,2,3
47842_0,,,,2,1,2,3
47843_0,,,,2,1,2,3
47844_0,,,,2,1,2,3
47845_0,,,,2,1,2,3
47846_0,,,,2,1,2,3
47847_0,,,,2,1,2,3
47848_0,,,,2,1,2,3
47849_0,,,,2,1,2,3
47850_0,,,,2,1,2,3
47851_0,,,,2,1,2,3
47852_0,,,,2,1,2,3
47853_0,,,,2,1,2,3
47854_0,,,,2,1,2,3
47855_0,,,,2,1,2,3
47856_0,,,,2,1,2,3
47857_0,,,,2,1,2,3
47858_0,,,,2,1,2,3
47859_0,,,,2,1,2,3
47860_0,,,,2,1,2,3
47861_0,,,,2,1,2,3
47862_0,,,,2,1,2,3
47863_0,,,,2,1,2,3
47864_0,,,,2,1,2,3
47865_0,,,,2,1,2,3
47866_0,,,,2,1,2,3
47867_0,,,,2,1,2,3
47868_0,,,,2,1,2,3
47869_0,,,,2,1,2,3
47870_0,,,,2,1,2,3
47871_0,,,,2,1,2,3
47872_0,,,,2,1,2,3
47873_0,,,,2,1,2,3
47874_0,,,,2,1,2,3
47875_0,,,,2,1,2,3
47876_0,,,,2,1,2,3
47877_0,,,,2,1,2,3
47878_0,,,,2,1,2,3
47879_0,,,,2,1,2,3
47880_0,,,,2,1,2,3
47881_0,,,,2,1,2,3
47882_0,,,,2,1,2,3
47883_0,,,,2,1,2,3
47884_0,,,,2,1,2,3
47885_0,,,,2,1,2,3
47886_0,,,,2,1,2,3
47887_0,,,,2,1,2,3
47888_0,,,,2,1,2,3
47889_0,,,,2,1,2,3
47890_0,,,,2,1,2,3
47891_0,,,,2,1,2,3
47892_0,,,,2,1,2,3
47893_0,,,,2,1,2,3
47894_0,,,,2,1,2,3
47895_0,,,,2,1,2,3
47896_0,,,,2,1,2,3
47897_0,,,,2,1,2,3
47898_0,,,,2,1,2,3
47899_0,,,,2,1,2,3
47900_0,,,,2,1,2,3
47901_0,,,,2,1,2,3
47902_0,,,,2,1,2,3
47903_0,,,,2,1,2,3
47904_0,,,,2,1,2,3
47905_0,,,,2,1,2,3
47906_0,,,,2,1,2,3
47907_0,,,,2,1,2,3
47908_0,,,,2,1,2,3
47909_0,,,,2,1,2,3
47910_0,,,,2,1,2,3
47911_0,,,,2,1,2,3
47912_0,,,,2,1,2,3
47913_0,,,,2,1,2,3
47914_0,,,,2,1,2,3
47915_0,,,,2,1,2,3
47916_0,,,,2,1,2,3
47917_0,,,,2,1,2,3
47918_0,,,,2,1,2,3
47919_0,,,,2,1,2,3
47920_0,,,,2,1,2,3
47921_0,,,,2,1,2,3
47922_0,,,,2,1,2,3
47923_0,,,,2,1,2,3
47924_0,,,,2,1,2,3
47925_0,,,,2,1,2,3
47926_0,,,,2,1,2,3
47927_0,,,,2,1,2,3
47928_0,,,,2,1,2,3
47929_0,,,,2,1,2,3
47930_0,,,,2,1,2,3
47931_0,,,,2,1,2,3
47932_0,,,,2,1,2,3
47933_0,,,,2,1,2,3
47934_0,,,,2,1,2,3
47935_0,,,,2,1,2,3
47936_0,,,,2,1,2,3
47937_0,,,,2,1,2,3
47938_0,,,,2,1,2,3
47939_0,,,,2,1,2,3
47940_0,,,,2,1,2,3
47941_0,,,,2,1,2,3
47942_0,,,,2,1,2,3
47943_0,,,,2,1,2,3
47944_0,,,,2,1,2,3
47945_0,,,,2,1,2,3
47946_0,,,,2,1,2,3
47947_0,,,,2,1,2,3
47948_0,,,,2,1,2,3
47949_0,,,,2,1,2,3
47950_0,,,,2,1,2,3
47951_0,,,,2,1,2,3
47952_0,,,,2,1,2,3
47953_0,,,,2,1,2,3
47954_0,,,,2,1,2,3
47955_0,,,,2,1,2,3
47956_0,,,,2,1,2,3
47957_0,,,,2,1,2,3
47958_0,,,,2,1,2,3
47959_0,,,,2,1,2,3
47960_0,,,,2,1,2,3
47961_0,,,,2,1,2,3
47962_0,,,,2,1,2,3
47963_0,,,,2,1,2,3
47964_0,,,,2,1,2,3
47965_0,,,,2,1,2,3
47966_0,,,,2,1,2,3
47967_0,,,,2,1,2,3
47968_0,,,,2,1,2,3
47969_0,,,,2,1,2,3
47970_0,,,,2,1,2,3
47971_0,,,,2,1,2,3
47972_0,,,,2,1,2,3
47973_0,,,,2,1,2,3
47974_0,,,,2,1,2,3
47975_0,,,,2,1,2,3
47976_0,,,,2,1,2,3
47977_0,,,,2,1,2,3
47978_0,,,,2,1,2,3
47979_0,,,,2,1,2,3
47980_0,,,,2,1,2,3
47981_0,,,,2,1,2,3
47982_0,,,,2,1,2,3
47983_0,,,,2,1,2,3
47984_0,,,,2,1,2,3
47985_0,,,,2,1,2,3
47986_0,,,,2,1,2,3
47987_0,,,,2,1,2,3
47988_0,,,,2,1,2,3
47989_0,,,,2,1,2,3
47990_0,,,,2,1,2,3
47992_0,,,,2,1,2,3
C(C1(C=CC(C1O)=O)O)=O,,,5,1,1,0,1
47993_0,,,,2,1,2,3
47994_0,,,,2,1,2,3
47995_0,,,,2,1,2,3
47996_0,,,,2,1,2,3
47997_0,,,,2,1,2,3
47998_0,,,,2,1,2,3
47999_0,,,,2,1,2,3
48000_0,,,,2,1,2,3
48001_0,,,,2,1,2,3
48002_0,,,,2,1,2,3
48003_0,,,,2,1,2,3
48004_0,,,,2,1,2,3
48005_0,,,,2,1,2,3
48006_0,,,,2,1,2,3
48007_0,,,,2,1,2,3
48008_0,,,,2,1,2,3
48009_0,,,,2,1,2,3
48010_0,,,,2,1,2,3
48011_0,,,,2,1,2,3
48012_0,,,,2,1,2,3
48013_0,,,,2,1,2,3
48014_0,,,,2,1,2,3
48015_0,,,,2,1,2,3
48016_0,,,,2,1,2,3
48017_0,,,,2,1,2,3
48019_0,,,,2,1,2,3
C(C(C(C(C)=O)(C=C)O)O)=O,,,5,1,1,0,1
48020_0,,,,2,1,2,3
48021_0,,,,2,1,2,3
48022_0,,,,2,1,2,3
48023_0,,,,2,1,2,3
48024_0,,,,2,1,2,3
48025_0,,,,2,1,2,3
48027_0,,,,2,1,2,3
C(C(C=O)(C=CCO)C(C)O)=O,,,5,1,1,0,1
48028_0,,,,2,1,2,3
48030_0,,,,2,1,2,3
C(C(C=O)(C(CO)=C)C(C)O)=O,,,5,1,1,0,1
48031_0,,,,2,1,2,3
48032_0,,,,2,1,2,3
48033_0,,,,2,1,2,3
48034_0,,,,2,1,2,3
48035_0,,,,2,1,2,3
48037_0,,,,2,1,2,3
C(C(C=O)(C=CC(C)O)CO)=O,,,5,1,1,0,1
48038_0,,,,2,1,2,3
48039_0,,,,2,1,2,3
48040_0,,,,2,1,2,3
48042_0,,,,2,1,2,3
C(C(C=O)(C=CCO)CO)=O,,,5,1,1,0,1
48044_0,,,,2,1,2,3
C(C(C=O)(C(CO)=C)CO)=O,,,5,1,1,0,1
48046_0,,,,2,1,2,3
C(C(C=O)(C(C(O)=O)=C)CO)=O,,,5,1,1,0,1
48048_0,,,,2,1,2,3
C(C(C=O)(C=CC(O)=O)CO)=O,,,5,1,1,0,1
48049_0,,,,2,1,2,3
48050_0,,,,2,1,2,3
48051_0,,,,2,1,2,3
48052_0,,,,2,1,2,3
48053_0,,,,2,1,2,3
48054_0,,,,2,1,2,3
48055_0,,,,2,1,2,3
48056_0,,,,2,1,2,3
48057_0,,,,2,1,2,3
48058_0,,,,2,1,2,3
48060_0,,,,2,1,2,3
C(C(C=CC(C)O)(C(C)O)O)=O,,,5,1,1,0,1
48061_0,,,,2,1,2,3
48062_0,,,,2,1,2,3
48064_0,,,,2,1,2,3
C(C)(C(C=CC(C)O)(CO)O)=O,,,5,1,1,0,1
48065_0,,,,2,1,2,3
48066_0,,,,2,1,2,3
48068_0,,,,2,1,2,3
C1(COCC1(C=CC(C)O)O)=O,,,5,1,1,0,1
48069_0,,,,2,1,2,3
48070_0,,,,2,1,2,3
48072_0,,,,2,1,2,3
C1COC(C=1C(CC(C)O)O)=O,,,5,1,1,0,1
48074_0,,,,2,1,2,3
C(CC(C)O)=C1C(OCC1O)=O,,,5,1,1,0,1
48076_0,,,,2,1,2,3
C1(C(C=CC(C)O)C(CO1)O)=O,,,5,1,1,0,1
48077_0,,,,2,1,2,3
48078_0,,,,2,1,2,3
48080_0,,,,2,1,2,3
C(C(C=CC(C)O)(CO)O)=O,,,5,1,1,0,1
48081_0,,,,2,1,2,3
48082_0,,,,2,1,2,3
48084_0,,,,2,1,2,3
C(C(C=CC(C)O)(CO)O)(O)=O,,,5,1,1,0,1
48085_0,,,,2,1,2,3
48086_0,,,,2,1,2,3
48088_0,,,,2,1,2,3
C(C(C(C)=O)(C=CC(C)O)O)=O,,,5,1,1,0,1
48089_0,,,,2,1,2,3
48090_0,,,,2,1,2,3
48091_0,,,,2,1,2,3
48093_0,,,,2,1,2,3
C(C(C=CCO)(C(C)O)O)=O,,,5,1,1,0,1
48094_0,,,,2,1,2,3
48095_0,,,,2,1,2,3
48097_0,,,,2,1,2,3
C(C(C(CO)=C)(C(C)O)O)=O,,,5,1,1,0,1
48098_0,,,,2,1,2,3
48099_0,,,,2,1,2,3
48101_0,,,,2,1,2,3
C(C(C(C(O)=O)=C)(C(C)O)O)=O,,,5,1,1,0,1
48102_0,,,,2,1,2,3
48104_0,,,,2,1,2,3
C(C(C=CC(O)=O)(C(C)O)O)=O,,,5,1,1,0,1
48105_0,,,,2,1,2,3
48106_0,,,,2,1,2,3
48107_0,,,,2,1,2,3
48108_0,,,,2,1,2,3
48109_0,,,,2,1,2,3
48110_0,,,,2,1,2,3
48111_0,,,,2,1,2,3
48113_0,,,,2,1,2,3
C(C(C(C=O)=O)(CO)O)=CCO,,,5,1,1,0,1
48114_0,,,,2,1,2,3
48116_0,,,,2,1,2,3
C(C)(C(C=CCO)(CO)O)=O,,,5,1,1,0,1
48118_0,,,,2,1,2,3
C(C(C(CCO)O)=CC=O)(O)=O,,,5,1,2,0,2
48120_0,,,,2,1,2,3
C(C(C(C(O)=O)=CCCO)O)=O,,,5,1,1,0,1
48121_0,,,,2,1,2,3
48123_0,,,,2,1,2,3
C(C(C=CCO)C(C=O)O)(O)=O,,,5,1,1,0,1
48124_0,,,,2,1,2,3
48126_0,,,,2,1,2,3
C(C(C(C)=O)(C=CCO)O)(O)=O,,,5,1,1,0,1
48127_0,,,,2,1,2,3
48128_0,,,,2,1,2,3
48130_0,,,,2,1,2,3
C(C(C=CCO)(C(C)O)O)(O)=O,,,5,1,1,0,1
48131_0,,,,2,1,2,3
48133_0,,,,2,1,2,3
C1(COCC1(C=CCO)O)=O,,,5,1,1,0,1
48135_0,,,,2,1,2,3
C1COC(C=1C(CCO)O)=O,,,5,1,1,0,1
48137_0,,,,2,1,2,3
C(CCO)=C1C(OCC1O)=O,,,5,1,1,0,1
48138_0,,,,2,1,2,3
48140_0,,,,2,1,2,3
C1(C(C=CCO)C(CO1)O)=O,,,5,1,1,0,1
48141_0,,,,2,1,2,3
48143_0,,,,2,1,2,3
C1(C(C=CCO)(C(CO1)O)O)=O,,,5,1,1,0,1
48145_0,,,,2,1,2,3
C(C(C1C(OCC=1)=O)(CO)O)=O,,,5,1,1,0,1
48147_0,,,,2,1,2,3
C1(C(C(CO1)O)=C(C=O)CO)=O,,,5,1,1,0,1
48149_0,,,,2,1,2,3
C(CO)(C(C1C(OCC=1)=O)O)=O,,,5,1,1,0,1
48151_0,,,,2,1,2,3
C1(C(C(CO1)O)=CC(CO)=O)=O,,,5,1,1,0,1
48153_0,,,,2,1,2,3
C=C(CO)C(C(C=O)=O)(CO)O,,,5,1,1,0,1
48155_0,,,,2,1,2,3
C=C(C=O)C(C(C=O)=O)(CO)O,,,5,1,1,0,1
48157_0,,,,2,1,2,3
C(C(C(C=O)=O)(CO)O)=CC=O,,,5,1,1,0,1
48159_0,,,,2,1,2,3
C=CC(C(C=O)=O)(CO)O,,,5,1,1,0,1
48161_0,,,,2,1,2,3
C=CC(C(C=O)=O)(C(CO)O)O,,,5,1,1,0,1
48163_0,,,,2,1,2,3
C(C)(C(C(CO)=C)(CO)O)=O,,,5,1,1,0,1
48165_0,,,,2,1,2,3
C(C(C(CO)(C)O)=CC=O)(O)=O,,,5,1,2,0,2
48167_0,,,,2,1,2,3
C(C(C(C(O)=O)=C(CO)C)O)=O,,,5,1,1,0,1
48169_0,,,,2,1,2,3
C(C(C(CO)=C)C(C=O)O)(O)=O,,,5,1,1,0,1
48171_0,,,,2,1,2,3
C(C(C(C)=O)(C(CO)=C)O)(O)=O,,,5,1,1,0,1
48172_0,,,,2,1,2,3
48174_0,,,,2,1,2,3
C(C(C(CO)=C)(C(C)O)O)(O)=O,,,5,1,1,0,1
48176_0,,,,2,1,2,3
C1(COCC1(C(CO)=C)O)=O,,,5,1,1,0,1
48178_0,,,,2,1,2,3
C1COC(C=1C(CO)(C)O)=O,,,5,1,1,0,1
48180_0,,,,2,1,2,3
C(CO)(C)=C1C(OCC1O)=O,,,5,1,1,0,1
48182_0,,,,2,1,2,3
C1(C(C(CO)=C)C(CO1)O)=O,,,5,1,1,0,1
48184_0,,,,2,1,2,3
C1(C(C(CO)=C)(C(CO1)O)O)=O,,,5,1,1,0,1
48186_0,,,,2,1,2,3
C(C)(C(C(C(O)=O)=C)(CO)O)=O,,,5,1,1,0,1
48188_0,,,,2,1,2,3
C(C)(C(C=CC(O)=O)(CO)O)=O,,,5,1,1,0,1
48190_0,,,,2,1,2,3
C(C(C(C(O)=O)=CC=O)O)(O)=O,,,5,1,2,0,2
48192_0,,,,2,1,2,3
C(C(C(C(O)=O)=CC(O)=O)O)=O,,,5,1,1,0,1
48193_0,,,,2,1,2,3
48195_0,,,,2,1,2,3
C(C(C1C(OCC=1)=O)O)(O)=O,,,5,1,1,0,1
48197_0,,,,2,1,2,3
C1(C(C(CO1)O)=CC(O)=O)=O,,,5,1,1,0,1
48199_0,,,,2,1,2,3
C1(COCC1(C(C(O)=O)=C)O)=O,,,5,1,1,0,1
48201_0,,,,2,1,2,3
C(C(C1C(OCC=1)=O)(C)O)(O)=O,,,5,1,1,0,1
48203_0,,,,2,1,2,3
C1(C(C(CO1)O)=C(C(O)=O)C)=O,,,5,1,1,0,1
48205_0,,,,2,1,2,3
C1(C(C(C(O)=O)=C)C(CO1)O)=O,,,5,1,1,0,1
48207_0,,,,2,1,2,3
C1(COCC1(C=CC(O)=O)O)=O,,,5,1,1,0,1
48209_0,,,,2,1,2,3
C(CC(C1C(OCC=1)=O)O)(O)=O,,,5,1,1,0,1
48211_0,,,,2,1,2,3
C(CC=C1C(OCC1O)=O)(O)=O,,,5,1,1,0,1
48213_0,,,,2,1,2,3
C1(C(C=CC(O)=O)C(CO1)O)=O,,,5,1,1,0,1
48214_0,,,,2,1,2,3
48215_0,,,,2,1,2,3
48216_0,,,,2,1,2,3
48217_0,,,,2,1,2,3
48218_0,,,,2,1,2,3
48220_0,,,,2,1,2,3
C(C(C(C(C)=O)(C=C)O)O)(O)=O,,,5,1,1,0,1
48221_0,,,,2,1,2,3
48222_0,,,,2,1,2,3
48223_0,,,,2,1,2,3
48224_0,,,,2,1,2,3
48225_0,,,,2,1,2,3
48227_0,,,,2,1,2,3
C(CC(O)=O)(C(C=C)(CO)O)=O,,,5,1,1,0,1
48229_0,,,,2,1,2,3
C(C(C(CCO)=O)(C=C)O)(O)=O,,,5,1,1,0,1
48230_0,,,,2,1,2,3
48232_0,,,,2,1,2,3
C1(COCC1(C(C=O)=C)O)=O,,,5,1,1,0,1
48234_0,,,,2,1,2,3
C1(COCC1(C=CC=O)O)=O,,,5,1,1,0,1
48236_0,,,,2,1,2,3
C1(COCC1(C=C)O)=O,,,5,1,1,0,1
48238_0,,,,2,1,2,3
C(C(C1C(OCC=1)O)(CO)O)=O,,,5,1,1,0,1
48240_0,,,,2,1,2,3
C=CC(C=O)=C1C(OCC1O)=O,,,5,1,1,0,1
48242_0,,,,2,1,2,3
C(C(C=C)(C1C(OCC=1)=O)O)=O,,,5,1,1,0,1
48244_0,,,,2,1,2,3
C=CC(C=C1C(OCC1O)=O)=O,,,5,1,1,0,1
48246_0,,,,2,1,2,3
C=CC(C(C1C(OCC=1)=O)O)=O,,,5,1,1,0,1
48248_0,,,,2,1,2,3
C(C=CC=C1C(OCC1O)=O)=O,,,5,1,1,0,1
48250_0,,,,2,1,2,3
C(C(C1C(OCC=1)=O)O)=CC=O,,,5,1,1,0,1
48252_0,,,,2,1,2,3
C(C(CO)O)=C1C(OCC1O)=O,,,5,1,1,0,1
48254_0,,,,2,1,2,3
C1COC(C=1C(C(CO)O)O)=O,,,5,1,1,0,1
48256_0,,,,2,1,2,3
C1(C(C(CO1)O)=CC=O)=O,,,5,1,2,0,2
48258_0,,,,2,1,2,3
C(C(C1C(OCC=1)=O)O)=O,,,5,1,1,0,1
48260_0,,,,2,1,2,3
C(CO)(CO)=C1C(OCC1O)=O,,,5,1,1,0,1
48262_0,,,,2,1,2,3
C1COC(C=1C(CO)(CO)O)=O,,,5,1,1,0,1
48264_0,,,,2,1,2,3
C1(C(C(C=O)=C)C(CO1)O)=O,,,5,1,1,0,1
48266_0,,,,2,1,2,3
C1(C(C(CO1)O)=C(C=O)C)=O,,,5,1,1,0,1
48268_0,,,,2,1,2,3
C(C(C1C(OCC=1)=O)(C)O)=O,,,5,1,1,0,1
48270_0,,,,2,1,2,3
C1(C(C(CO1)O)=CC(C)=O)=O,,,5,1,1,0,1
48272_0,,,,2,1,2,3
C(C)(C(C1C(OCC=1)=O)O)=O,,,5,1,1,0,1
48274_0,,,,2,1,2,3
C1(C(C=CC=O)C(CO1)O)=O,,,5,1,1,0,1
48276_0,,,,2,1,2,3
C(CC=C1C(OCC1O)=O)=O,,,5,1,1,0,1
48278_0,,,,2,1,2,3
C(CC(C1C(OCC=1)=O)O)=O,,,5,1,1,0,1
48280_0,,,,2,1,2,3
C1(C(C=C)C(CO1)O)=O,,,5,1,1,0,1
48282_0,,,,2,1,2,3
C(C)=C1C(OCC1O)=O,,,5,1,1,0,1
48284_0,,,,2,1,2,3
C1COC(C=1C(C)O)=O,,,5,1,1,0,1
48286_0,,,,2,1,2,3
C=C1C(OCC1O)=O,,,5,1,2,0,2
48288_0,,,,2,1,2,3
C1COC(C=1CO)=O,,,5,1,1,0,1
48290_0,,,,2,1,2,3
C(CO)=C1C(OCC1O)=O,,,5,1,1,0,1
48292_0,,,,2,1,2,3
C1COC(C=1C(CO)O)=O,,,5,1,1,0,1
48293_0,,,,2,1,2,3
48295_0,,,,2,1,2,3
C(C(C1COC(C=1)O)(CO)O)=O,,,5,1,1,0,1
48297_0,,,,2,1,2,3
C1(C(C(C=O)=C)(C(CO1)O)O)=O,,,5,1,1,0,1
48299_0,,,,2,1,2,3
C1(C(C=CC=O)(C(CO1)O)O)=O,,,5,1,1,0,1
48301_0,,,,2,1,2,3
C1(C(C=C)(C(CO1)O)O)=O,,,5,1,2,0,2
48303_0,,,,2,1,2,3
C1(C(C=C)(C(C(CO)O1)O)O)=O,,,5,1,1,0,1
48305_0,,,,2,1,2,3
C1(C(C=C)(C(C(CO1)O)O)O)=O,,,5,1,1,0,1
48307_0,,,,2,1,2,3
C(C1C(C(C(C=1)=O)O)O)=O,,,5,1,1,0,1
48308_0,,,,2,1,2,3
48309_0,,,,2,1,2,3
48311_0,,,,2,1,2,3
C(C1C(C(C(C=1)=O)O)O)(C)=O,,,5,1,1,0,1
48312_0,,,,2,1,2,3
48313_0,,,,2,1,2,3
48315_0,,,,2,1,2,3
C(C1(C=CC(C1)O)O)=O,,,5,1,1,0,1
48316_0,,,,2,1,2,3
48317_0,,,,2,1,2,3
48318_0,,,,2,1,2,3
48319_0,,,,2,1,2,3
48320_0,,,,2,1,2,3
48321_0,,,,2,1,2,3
48322_0,,,,2,1,2,3
48324_0,,,,2,1,2,3
C(C(C(C=O)=CC(C=O)=O)O)=O,,,5,1,1,0,1
48326_0,,,,2,1,2,3
C(C(C(C=O)=C(C=O)C=O)O)=O,,,5,1,1,0,1
48328_0,,,,2,1,2,3
C(C(C=CC(C(O)=O)O)(C)O)=O,,,5,1,1,0,1
48329_0,,,,2,1,2,3
48330_0,,,,2,1,2,3
48332_0,,,,2,1,2,3
C(C)(C(C=C)(CC(C=O)=O)O)=O,,,5,1,1,0,1
48334_0,,,,2,1,2,3
C(C(C=C(C(C)=O)C(C)O)=O)=O,,,5,1,1,0,1
48336_0,,,,2,1,2,3
C(C(C=O)C(C(C)=O)(C=C)O)=O,,,5,1,1,0,1
48338_0,,,,2,1,2,3
C(C(C=O)=C(C(C)=O)C(C)O)=O,,,5,1,1,0,1
48339_0,,,,2,1,2,3
48341_0,,,,2,1,2,3
C(CC(C(C)=O)(C=CCO)O)=O,,,5,1,1,0,1
48343_0,,,,2,1,2,3
C(C=C(C(C)=O)C(CCO)O)=O,,,5,1,1,0,1
48345_0,,,,2,1,2,3
C(CC(C(C)=O)(C(CO)=C)O)=O,,,5,1,1,0,1
48347_0,,,,2,1,2,3
C(C=C(C(C)=O)C(CO)(C)O)=O,,,5,1,1,0,1
48349_0,,,,2,1,2,3
C(C(C(C(C)=O)=CC=O)O)(O)=O,,,5,1,1,0,1
48351_0,,,,2,1,2,3
C(C(C(C(C)=O)=CC=O)O)=O,,,5,1,1,0,1
48353_0,,,,2,1,2,3
C(CC(C(C)=O)(C(C=O)=C)O)=O,,,5,1,1,0,1
48355_0,,,,2,1,2,3
C(C(C(C(C)=O)=CC=O)(C)O)=O,,,5,1,1,0,1
48357_0,,,,2,1,2,3
C(C)(C(C(C(C)=O)=CC=O)O)=O,,,5,1,1,0,1
48359_0,,,,2,1,2,3
C(CC(C(C)=O)(C=CC=O)O)=O,,,5,1,1,0,1
48361_0,,,,2,1,2,3
C(CC(C(C(C)=O)=CC=O)O)=O,,,5,1,1,0,1
48363_0,,,,2,1,2,3
C(CC(C(C)=O)(C=C)O)=O,,,5,1,1,0,1
48365_0,,,,2,1,2,3
C(C=C(C(C)=O)C(C)O)=O,,,5,1,1,0,1
48367_0,,,,2,1,2,3
C(C=C(C(C)=O)C(CO)O)=O,,,5,1,1,0,1
48368_0,,,,2,1,2,3
48369_0,,,,2,1,2,3
48370_0,,,,2,1,2,3
48371_0,,,,2,1,2,3
48373_0,,,,2,1,2,3
C(C(C(C=O)=CC(C)O)O)(O)=O,,,5,1,1,0,1
48375_0,,,,2,1,2,3
C(C(CO)C(C(C(O)=O)=C)O)=O,,,5,1,1,0,1
48376_0,,,,2,1,2,3
48378_0,,,,2,1,2,3
C(C(C=C(C=O)CO)(C)O)(O)=O,,,5,1,1,0,1
48380_0,,,,2,1,2,3
C(CCO)(C(C=C)(CC=O)O)=O,,,5,1,1,0,1
48382_0,,,,2,1,2,3
C(C(C(C)O)=CC=O)(CCO)=O,,,5,1,1,0,1
48383_0,,,,2,1,2,3
48385_0,,,,2,1,2,3
C(C(CO)=CC=O)(CCO)=O,,,5,1,1,0,1
48386_0,,,,2,1,2,3
48388_0,,,,2,1,2,3
C=C(C(O)=O)C(CC(C)O)O,,,5,1,1,0,1
48390_0,,,,2,1,2,3
C(C(C=CC(C)O)(C)O)(O)=O,,,5,1,1,0,1
48391_0,,,,2,1,2,3
48392_0,,,,2,1,2,3
48393_0,,,,2,1,2,3
48395_0,,,,2,1,2,3
C(C(C(C=O)=O)(C)O)=CC(C)O,,,5,1,1,0,1
48396_0,,,,2,1,2,3
48397_0,,,,2,1,2,3
48398_0,,,,2,1,2,3
48399_0,,,,2,1,2,3
48401_0,,,,2,1,2,3
C(C(C=CC(C)O)(CCO)O)=O,,,5,1,1,0,1
48402_0,,,,2,1,2,3
48403_0,,,,2,1,2,3
48405_0,,,,2,1,2,3
C1(CCOC1(C=CC(C)O)O)=O,,,5,1,1,0,1
48406_0,,,,2,1,2,3
48407_0,,,,2,1,2,3
48409_0,,,,2,1,2,3
C(C(C=CC(C)O)O)(O)=O,,,5,1,1,0,1
48410_0,,,,2,1,2,3
48411_0,,,,2,1,2,3
48412_0,,,,2,1,2,3
48414_0,,,,2,1,2,3
C(C(C=CC(C)O)(CC=O)O)=O,,,5,1,1,0,1
48415_0,,,,2,1,2,3
48416_0,,,,2,1,2,3
48418_0,,,,2,1,2,3
C=C(C(O)=O)C(C(C(C)O)O)O,,,5,1,1,0,1
48419_0,,,,2,1,2,3
48420_0,,,,2,1,2,3
48422_0,,,,2,1,2,3
C=C(C(O)=O)C(CCO)O,,,5,1,1,0,1
48423_0,,,,2,1,2,3
48425_0,,,,2,1,2,3
C(C(C=CCO)(C)O)(O)=O,,,5,1,1,0,1
48427_0,,,,2,1,2,3
C(CO)=C(C(O)=O)C(CCO)O,,,5,1,1,0,1
48428_0,,,,2,1,2,3
48429_0,,,,2,1,2,3
48431_0,,,,2,1,2,3
C(C(C=CCO)(CCO)O)(O)=O,,,5,1,1,0,1
48432_0,,,,2,1,2,3
48433_0,,,,2,1,2,3
48435_0,,,,2,1,2,3
C(C(C(C=O)=O)(C)O)=CCO,,,5,1,1,0,1
48436_0,,,,2,1,2,3
48437_0,,,,2,1,2,3
48438_0,,,,2,1,2,3
48440_0,,,,2,1,2,3
C(C(C=CCO)(CCO)O)=O,,,5,1,1,0,1
48441_0,,,,2,1,2,3
48442_0,,,,2,1,2,3
48443_0,,,,2,1,2,3
48444_0,,,,2,1,2,3
48445_0,,,,2,1,2,3
48447_0,,,,2,1,2,3
C(C(C=CCO)(CC(O)=O)O)=O,,,5,1,1,0,1
48448_0,,,,2,1,2,3
48450_0,,,,2,1,2,3
C1(CCOC1(C=CCO)O)=O,,,5,1,1,0,1
48452_0,,,,2,1,2,3
C=C(C(O)=O)C(CC(CO)O)O,,,5,1,1,0,1
48453_0,,,,2,1,2,3
48455_0,,,,2,1,2,3
C(C(C=CC(CO)O)(C)O)(O)=O,,,5,1,1,0,1
48456_0,,,,2,1,2,3
48458_0,,,,2,1,2,3
C(CO)(C(C(C(O)=O)=C)(C)O)=O,,,5,1,1,0,1
48459_0,,,,2,1,2,3
48461_0,,,,2,1,2,3
C(C(C)O)(C(C(C(O)=O)=C)O)=O,,,5,1,1,0,1
48463_0,,,,2,1,2,3
C(C(C(CO)=C)(C)O)(O)=O,,,5,1,1,0,1
48465_0,,,,2,1,2,3
C=C(C(O)=O)C(CO)(C)O,,,5,1,1,0,1
48467_0,,,,2,1,2,3
C(C(C(CO)=CCO)(C)O)(O)=O,,,5,1,1,0,1
48468_0,,,,2,1,2,3
48470_0,,,,2,1,2,3
C=C(C(O)=O)C(CO)(CCO)O,,,5,1,1,0,1
48471_0,,,,2,1,2,3
48472_0,,,,2,1,2,3
48474_0,,,,2,1,2,3
C=C(C(O)=O)C(C(CCO)O)O,,,5,1,1,0,1
48476_0,,,,2,1,2,3
C(C(C(C(CO)O)=C)(C)O)(O)=O,,,5,1,1,0,1
48478_0,,,,2,1,2,3
C=C(C(O)=O)C(C)(C(CO)O)O,,,5,1,1,0,1
48480_0,,,,2,1,2,3
C(C(C(C(O)=O)=C)(C)O)(O)=O,,,5,1,1,0,1
48482_0,,,,2,1,2,3
C(C(C=CC(O)=O)(C)O)(O)=O,,,5,1,1,0,1
48484_0,,,,2,1,2,3
C(CC(C(C(O)=O)=C)O)(O)=O,,,5,1,1,0,1
48486_0,,,,2,1,2,3
C=C(C(O)=O)C1(COCC1O)O,,,5,1,1,0,1
48488_0,,,,2,1,2,3
C(C(C1C(OCC=1)O)(C)O)(O)=O,,,5,1,1,0,1
48490_0,,,,2,1,2,3
C=C(C(O)=O)C1(C(O)OCC1)O,,,5,1,1,0,1
48491_0,,,,2,1,2,3
48493_0,,,,2,1,2,3
C(C(C1COC(C=1)O)(C)O)(O)=O,,,5,1,1,0,1
48495_0,,,,2,1,2,3
C=C(C(O)=O)C1(COC(C1)O)O,,,5,1,1,0,1
48497_0,,,,2,1,2,3
C(C(C=C)(C(C(O)=O)=C)O)=O,,,5,1,1,0,1
48499_0,,,,2,1,2,3
C=C(C(O)=O)C(C(C=C)=O)O,,,5,1,1,0,1
48501_0,,,,2,1,2,3
C=C(C(O)=O)C(C=CC=O)O,,,5,1,1,0,1
48503_0,,,,2,1,2,3
C=C(C(O)=O)C(C(CO)O)O,,,5,1,1,0,1
48505_0,,,,2,1,2,3
C=C(C(O)=O)C(CO)(CO)O,,,5,1,1,0,1
48506_0,,,,2,1,2,3
48508_0,,,,2,1,2,3
C(C(C(C(O)=O)=C)(C)O)=O,,,5,1,1,0,1
48510_0,,,,2,1,2,3
C(C(C=CC=O)(C)O)(O)=O,,,5,1,1,0,1
48512_0,,,,2,1,2,3
C(CC(C(C(O)=O)=C)O)=O,,,5,1,1,0,1
48513_0,,,,2,1,2,3
48514_0,,,,2,1,2,3
48516_0,,,,2,1,2,3
C(C(C(C(O)=O)=C)(CCO)O)=O,,,5,1,1,0,1
48517_0,,,,2,1,2,3
48519_0,,,,2,1,2,3
C(CC(C(C(C(O)=O)=C)O)O)=O,,,5,1,1,0,1
48520_0,,,,2,1,2,3
48522_0,,,,2,1,2,3
C(C(C=CC(C=O)O)(C)O)(O)=O,,,5,1,1,0,1
48524_0,,,,2,1,2,3
C(C(CC(C(C(O)=O)=C)O)O)=O,,,5,1,1,0,1
48526_0,,,,2,1,2,3
C(C(C=CC(CO)=O)(C)O)(O)=O,,,5,1,1,0,1
48528_0,,,,2,1,2,3
C(CO)(CC(C(C(O)=O)=C)O)=O,,,5,1,1,0,1
48530_0,,,,2,1,2,3
C(C(C(CO)=CC=O)(C)O)(O)=O,,,5,1,1,0,1
48532_0,,,,2,1,2,3
C(CC(C(C(O)=O)=C)(CO)O)=O,,,5,1,1,0,1
48534_0,,,,2,1,2,3
C(C)(C(C(C(C(O)=O)=C)O)O)=O,,,5,1,1,0,1
48536_0,,,,2,1,2,3
C(C(C(C(C=O)O)=C)(C)O)(O)=O,,,5,1,1,0,1
48538_0,,,,2,1,2,3
C(C(C(C(C(O)=O)=C)(C)O)O)=O,,,5,1,1,0,1
48540_0,,,,2,1,2,3
C(C(C=C)(C)O)(O)=O,,,5,1,1,0,1
48542_0,,,,2,1,2,3
C=C(C(O)=O)C(C)O,,,5,1,1,0,1
48544_0,,,,2,1,2,3
C=C(C(O)=O)C(CO)O,,,5,1,1,0,1
48546_0,,,,2,1,2,3
C(C(C(CO)=C)(CCO)O)(O)=O,,,5,1,1,0,1
48548_0,,,,2,1,2,3
C(CO)=C(C(O)=O)C(CO)(C)O,,,5,1,1,0,1
48549_0,,,,2,1,2,3
48550_0,,,,2,1,2,3
48552_0,,,,2,1,2,3
C(C(C(C(O)=O)=CCO)(C)O)=O,,,5,1,1,0,1
48553_0,,,,2,1,2,3
48555_0,,,,2,1,2,3
C(C(C=CC=O)(CCO)O)(O)=O,,,5,1,1,0,1
48557_0,,,,2,1,2,3
C(CC(C(C(O)=O)=CCO)O)=O,,,5,1,1,0,1
48558_0,,,,2,1,2,3
48560_0,,,,2,1,2,3
C(C(C=C)(CCO)O)(O)=O,,,5,1,1,0,1
48562_0,,,,2,1,2,3
C(CO)=C(C(O)=O)C(C)O,,,5,1,1,0,1
48563_0,,,,2,1,2,3
48565_0,,,,2,1,2,3
C(CO)=C(C(O)=O)CO,,,5,1,1,0,1
48566_0,,,,2,1,2,3
48568_0,,,,2,1,2,3
C(CO)=C(C(O)=O)C(CO)O,,,5,1,1,0,1
48569_0,,,,2,1,2,3
48570_0,,,,2,1,2,3
48571_0,,,,2,1,2,3
48572_0,,,,2,1,2,3
48574_0,,,,2,1,2,3
C=C(CO)C(C(C=O)=O)(C)O,,,5,1,1,0,1
48575_0,,,,2,1,2,3
48576_0,,,,2,1,2,3
48578_0,,,,2,1,2,3
C=C(C(O)=O)C(C(C=O)=O)(C)O,,,5,1,1,0,1
48579_0,,,,2,1,2,3
48581_0,,,,2,1,2,3
C(C(C(C=O)=O)(C)O)=CC(O)=O,,,5,1,1,0,1
48582_0,,,,2,1,2,3
48583_0,,,,2,1,2,3
48584_0,,,,2,1,2,3
48585_0,,,,2,1,2,3
48586_0,,,,2,1,2,3
48587_0,,,,2,1,2,3
48589_0,,,,2,1,2,3
C=C(C=O)C(C(C=O)=O)(C)O,,,5,1,1,0,1
48590_0,,,,2,1,2,3
48591_0,,,,2,1,2,3
48593_0,,,,2,1,2,3
C(C(C(C=O)=O)(C)O)=CC=O,,,5,1,1,0,1
48594_0,,,,2,1,2,3
48596_0,,,,2,1,2,3
C=CC(C(C=O)=O)(C)O,,,5,1,1,0,1
48597_0,,,,2,1,2,3
48598_0,,,,2,1,2,3
48599_0,,,,2,1,2,3
48600_0,,,,2,1,2,3
48601_0,,,,2,1,2,3
48603_0,,,,2,1,2,3
C(C(C(CO)=C)(CCO)O)=O,,,5,1,1,0,1
48604_0,,,,2,1,2,3
48606_0,,,,2,1,2,3
C(C(C(CO)=C)(CC=O)O)(O)=O,,,5,1,1,0,1
48607_0,,,,2,1,2,3
48609_0,,,,2,1,2,3
C(C(C(CO)=C)(CC(O)=O)O)=O,,,5,1,1,0,1
48611_0,,,,2,1,2,3
C1(CCOC1(C(CO)=C)O)=O,,,5,1,1,0,1
48612_0,,,,2,1,2,3
48613_0,,,,2,1,2,3
48614_0,,,,2,1,2,3
48615_0,,,,2,1,2,3
48616_0,,,,2,1,2,3
48617_0,,,,2,1,2,3
48618_0,,,,2,1,2,3
48619_0,,,,2,1,2,3
48620_0,,,,2,1,2,3
48621_0,,,,2,1,2,3
48622_0,,,,2,1,2,3
48624_0,,,,2,1,2,3
C1(CCOC1(C(C(O)=O)=C)O)=O,,,5,1,1,0,1
48626_0,,,,2,1,2,3
C1(CCOC1(C=CC(O)=O)O)=O,,,5,1,1,0,1
48627_0,,,,2,1,2,3
48628_0,,,,2,1,2,3
48630_0,,,,2,1,2,3
C(C(C(C)O)=CC(CO)=O)(O)=O,,,5,1,1,0,1
48632_0,,,,2,1,2,3
C1(CCOC1(C(C=O)=C)O)=O,,,5,1,1,0,1
48634_0,,,,2,1,2,3
C1(CCOC1(C=CC=O)O)=O,,,5,1,1,0,1
48636_0,,,,2,1,2,3
C1(CCOC1(C=C)O)=O,,,5,1,1,0,1
48638_0,,,,2,1,2,3
C(C(C1C(O)OCC=1)O)(O)=O,,,5,1,1,0,1
48639_0,,,,2,1,2,3
48641_0,,,,2,1,2,3
C(C(C1COC(C=1)O)O)(O)=O,,,5,1,1,0,1
48642_0,,,,2,1,2,3
48643_0,,,,2,1,2,3
48644_0,,,,2,1,2,3
48646_0,,,,2,1,2,3
C(CC(C=CC(CO)O)=O)=O,,,5,1,1,0,1
48648_0,,,,2,1,2,3
C=C(C(C(CO)=O)=O)CO,,,5,1,1,0,1
48649_0,,,,2,1,2,3
48650_0,,,,2,1,2,3
48651_0,,,,2,1,2,3
48652_0,,,,2,1,2,3
48653_0,,,,2,1,2,3
48654_0,,,,2,1,2,3
48655_0,,,,2,1,2,3
48657_0,,,,2,1,2,3
C(CC(C(C(CO)=C)=O)=O)=O,,,5,1,1,0,1
48659_0,,,,2,1,2,3
C(CC(C=C(C=O)CO)=O)=O,,,5,1,2,0,2
48660_0,,,,2,1,2,3
48661_0,,,,2,1,2,3
48662_0,,,,2,1,2,3
48663_0,,,,2,1,2,3
48664_0,,,,2,1,2,3
48665_0,,,,2,1,2,3
48667_0,,,,2,1,2,3
C(CC(C=CC(CO)=O)=O)=O,,,5,1,2,0,2
48668_0,,,,2,1,2,3
48669_0,,,,2,1,2,3
48670_0,,,,2,1,2,3
48672_0,,,,2,1,2,3
C(CC(C=O)=CC(CO)=O)=O,,,5,1,3,0,3
48674_0,,,,2,1,2,3
C(CC(C(C(CO)=O)=O)=C)=O,,,5,1,1,0,1
48676_0,,,,2,1,2,3
C(C(C=CC(CO)=O)=O)(C)=O,,,5,1,1,0,1
48678_0,,,,2,1,2,3
C(C(C(C)=CC(CO)=O)=O)=O,,,5,1,1,0,1
48680_0,,,,2,1,2,3
C(C=C(C(C(CO)=O)=O)C)=O,,,5,1,1,0,1
48681_0,,,,2,1,2,3
48682_0,,,,2,1,2,3
48683_0,,,,2,1,2,3
48684_0,,,,2,1,2,3
48685_0,,,,2,1,2,3
48686_0,,,,2,1,2,3
48687_0,,,,2,1,2,3
48689_0,,,,2,1,2,3
C=C(C(CC(C=O)=O)=O)CO,,,5,1,1,0,1
48691_0,,,,2,1,2,3
C(C(C=O)C(C(CO)=C)=O)=O,,,5,1,1,0,1
48693_0,,,,2,1,2,3
C(CC(C(CO)=C)=O)=O,,,5,1,1,0,1
48695_0,,,,2,1,2,3
C(CC(C(CO)=CCO)=O)=O,,,5,1,1,0,1
48697_0,,,,2,1,2,3
C(CC(C(C(CO)O)=C)=O)=O,,,5,1,1,0,1
48698_0,,,,2,1,2,3
48699_0,,,,2,1,2,3
48700_0,,,,2,1,2,3
48701_0,,,,2,1,2,3
48702_0,,,,2,1,2,3
48703_0,,,,2,1,2,3
48704_0,,,,2,1,2,3
48705_0,,,,2,1,2,3
48706_0,,,,2,1,2,3
48707_0,,,,2,1,2,3
48708_0,,,,2,1,2,3
48709_0,,,,2,1,2,3
48710_0,,,,2,1,2,3
48711_0,,,,2,1,2,3
48712_0,,,,2,1,2,3
48713_0,,,,2,1,2,3
48714_0,,,,2,1,2,3
48715_0,,,,2,1,2,3
48716_0,,,,2,1,2,3
48717_0,,,,2,1,2,3
48718_0,,,,2,1,2,3
48719_0,,,,2,1,2,3
48721_0,,,,2,1,2,3
C(CC(C(C=CCO)=O)=O)=O,,,5,1,1,0,1
48722_0,,,,2,1,2,3
48724_0,,,,2,1,2,3
C(C(C(C)=CC=O)=O)=O,,,5,1,1,0,1
48725_0,,,,2,1,2,3
48726_0,,,,2,1,2,3
48727_0,,,,2,1,2,3
48729_0,,,,2,1,2,3
C(C(CO)O)=C(C=O)C(C)=O,,,5,1,1,0,1
48731_0,,,,2,1,2,3
C=C(C(O)=O)C(C=O)=O,,,5,1,1,0,1
48733_0,,,,2,1,2,3
C(CO)=C(C(O)=O)C(C=O)=O,,,5,1,1,0,1
48734_0,,,,2,1,2,3
48736_0,,,,2,1,2,3
C(C(CO)=C(C=O)CO)(O)=O,,,5,1,1,0,1
48737_0,,,,2,1,2,3
48739_0,,,,2,1,2,3
C(C(C(C)=O)=C(C=O)CO)=O,,,5,1,1,0,1
48740_0,,,,2,1,2,3
48742_0,,,,2,1,2,3
C=C(C(CO)=O)C(C(C)=O)=O,,,5,1,1,0,1
48744_0,,,,2,1,2,3
C(CC(C(C(CO)=O)=C)=O)=O,,,5,1,1,0,1
48746_0,,,,2,1,2,3
C=C(C(C)=O)C(CO)=O,,,5,1,1,0,1
48748_0,,,,2,1,2,3
C=C(C(CO)=O)C(CO)=O,,,5,1,1,0,1
48750_0,,,,2,1,2,3
C=C(C(O)=O)C(C(C)=O)=O,,,5,1,1,0,1
48752_0,,,,2,1,2,3
C(CC(C(C(O)=O)=C)=O)=O,,,5,1,1,0,1
48754_0,,,,2,1,2,3
C=C(C(O)=O)C(C)=O,,,5,1,1,0,1
48756_0,,,,2,1,2,3
C(CO)=C(C(O)=O)C(C)=O,,,5,1,1,0,1
48757_0,,,,2,1,2,3
48759_0,,,,2,1,2,3
C(CO)=C(C=O)C(C(C)=O)=O,,,5,1,1,0,1
48760_0,,,,2,1,2,3
48762_0,,,,2,1,2,3
C(CC(C(C=O)=CCO)=O)=O,,,5,1,1,0,1
48763_0,,,,2,1,2,3
48765_0,,,,2,1,2,3
C=C(C=O)C(C(CCO)=O)=O,,,5,1,1,0,1
48766_0,,,,2,1,2,3
48767_0,,,,2,1,2,3
48768_0,,,,2,1,2,3
48769_0,,,,2,1,2,3
48771_0,,,,2,1,2,3
C(C(CC(C(C=O)=C)=O)O)=O,,,5,1,1,0,1
48773_0,,,,2,1,2,3
C(CO)(CC(C(C=O)=C)=O)=O,,,5,1,1,0,1
48775_0,,,,2,1,2,3
C(CC(C=O)=C(C=O)CO)=O,,,5,1,2,0,2
48777_0,,,,2,1,2,3
C(C(C(C)=O)=CC(CO)=O)=O,,,5,1,1,0,1
48778_0,,,,2,1,2,3
48779_0,,,,2,1,2,3
48781_0,,,,2,1,2,3
C(C(CO)=CC(C(C)=O)=O)=O,,,5,1,1,0,1
48783_0,,,,2,1,2,3
C(C)(C(C(C(C=O)=C)=O)O)=O,,,5,1,1,0,1
48785_0,,,,2,1,2,3
C(C(C(C)=C(C=O)CO)=O)=O,,,5,1,1,0,1
48787_0,,,,2,1,2,3
C=C(C=O)C(C)=O,,,5,1,1,0,1
48789_0,,,,2,1,2,3
C(CO)=C(C=O)C(C)=O,,,5,1,1,0,1
48790_0,,,,2,1,2,3
48791_0,,,,2,1,2,3
48792_0,,,,2,1,2,3
48793_0,,,,2,1,2,3
48794_0,,,,2,1,2,3
48795_0,,,,2,1,2,3
48796_0,,,,2,1,2,3
48797_0,,,,2,1,2,3
48798_0,,,,2,1,2,3
48799_0,,,,2,1,2,3
48800_0,,,,2,1,2,3
48801_0,,,,2,1,2,3
48802_0,,,,2,1,2,3
48803_0,,,,2,1,2,3
48804_0,,,,2,1,2,3
48806_0,,,,2,1,2,3
C(CC(C(C(O)=O)=O)=C)=O,,,5,1,1,0,1
48808_0,,,,2,1,2,3
C(CC(C=O)=CC(O)=O)=O,,,5,1,1,0,1
48809_0,,,,2,1,2,3
48811_0,,,,2,1,2,3
C(C=C(C(C(O)=O)=O)C)=O,,,5,1,1,0,1
48813_0,,,,2,1,2,3
C(C(C(C)=CC(O)=O)=O)=O,,,5,1,1,0,1
48815_0,,,,2,1,2,3
C1C(CO)OC(C=1)=O,,,5,1,1,0,1
48817_0,,,,2,1,2,3
C1C(C(CO)O)OC(C=1)=O,,,5,1,1,0,1
48819_0,,,,2,1,2,3
C1OC(C(C=1CO)=O)CO,,,5,1,1,0,1
48821_0,,,,2,1,2,3
C=C1C(C(CO)OC1O)=O,,,5,1,2,0,2
48823_0,,,,2,1,2,3
C1C(CO)OC(C=1CO)=O,,,5,1,1,0,1
48825_0,,,,2,1,2,3
C=C1C(OC(CO)C1O)=O,,,5,1,1,0,1
48827_0,,,,2,1,2,3
C1C(CO)OC(C=1C=O)O,,,5,1,1,0,1
48829_0,,,,2,1,2,3
C1OC(CO)C(C=1C=O)O,,,5,1,1,0,1
48831_0,,,,2,1,2,3
C1COC(C=1C=O)O,,,5,1,1,0,1
48833_0,,,,2,1,2,3
C1OCC(C=1C=O)O,,,5,1,1,0,1
48835_0,,,,2,1,2,3
C1(C(O)OCC1O)=CC=O,,,5,1,3,0,3
48837_0,,,,2,1,2,3
C1COC(C=1C(CO)=O)O,,,5,1,1,0,1
48839_0,,,,2,1,2,3
C1OCC(C=1C(CO)=O)O,,,5,1,1,0,1
48841_0,,,,2,1,2,3
C1COC(C(C=1)=O)O,,,5,1,1,0,1
48843_0,,,,2,1,2,3
C1C(COC(C=1)=O)O,,,5,1,1,0,1
48845_0,,,,2,1,2,3
C1C(O)OCC(C=1)=O,,,5,1,1,0,1
48847_0,,,,2,1,2,3
C1OCC(C(C=1)=O)O,,,5,1,1,0,1
48849_0,,,,2,1,2,3
C1C(CO)OC(C(C=1)=O)O,,,5,1,1,0,1
48851_0,,,,2,1,2,3
C1C(C(CO)OC(C=1)=O)O,,,5,1,1,0,1
48853_0,,,,2,1,2,3
C1C(OC(C(C=1)=O)CO)O,,,5,1,1,0,1
48855_0,,,,2,1,2,3
C1OC(CO)C(C(C=1)=O)O,,,5,1,1,0,1
48857_0,,,,2,1,2,3
C1(C(O)OCC(C=1)=O)CO,,,5,1,1,0,1
48859_0,,,,2,1,2,3
C1OCC(C(C=1CO)=O)O,,,5,1,1,0,1
48861_0,,,,2,1,2,3
C=C1C(C(COC1O)O)=O,,,5,1,2,0,2
48863_0,,,,2,1,2,3
C1C(COC(C=1CO)=O)O,,,5,1,1,0,1
48865_0,,,,2,1,2,3
C=C1C(OCC(C1O)O)=O,,,5,1,1,0,1
48867_0,,,,2,1,2,3
C1C(COC(C=1C=O)O)O,,,5,1,1,0,1
48869_0,,,,2,1,2,3
C1OCC(C(C=1C=O)O)O,,,5,1,1,0,1
48871_0,,,,2,1,2,3
C1C(COC(C(C=1)=O)O)O,,,5,1,1,0,1
48873_0,,,,2,1,2,3
C1C(C(COC(C=1)=O)O)O,,,5,1,1,0,1
48875_0,,,,2,1,2,3
C1C(O)OCC(C(C=1)=O)O,,,5,1,1,0,1
48877_0,,,,2,1,2,3
C1OCC(C(C(C=1)=O)O)O,,,5,1,1,0,1
48879_0,,,,2,1,2,3
C1COC(C(C(C=1)=O)O)O,,,5,1,1,0,1
48881_0,,,,2,1,2,3
C1C(C(OCC(C=1)=O)O)O,,,5,1,1,0,1
48883_0,,,,2,1,2,3
C1COC(C(C=1)=O)=O,,,5,1,1,0,1
48885_0,,,,2,1,2,3
C1(C=CC(CO1)=O)=O,,,5,1,1,0,1
48887_0,,,,2,1,2,3
C1C(CO)OC(C(C=1)=O)=O,,,5,1,1,0,1
48889_0,,,,2,1,2,3
C1(C=CC(C(CO)O1)=O)=O,,,5,1,1,0,1
48891_0,,,,2,1,2,3
C1C(COC(C(C=1)=O)=O)O,,,5,1,1,0,1
48893_0,,,,2,1,2,3
C1(C=CC(C(CO1)O)=O)=O,,,5,1,1,0,1
48895_0,,,,2,1,2,3
C1(C(C(C=CCO1)=O)O)=O,,,5,1,1,0,1
48897_0,,,,2,1,2,3
C1(C(C=CC(CO1)=O)O)=O,,,5,1,1,0,1
48899_0,,,,2,1,2,3
C=C(C=O)C(C(C=O)=O)=C,,,5,1,2,0,2
48900_0,,,,2,1,2,3
48902_0,,,,2,1,2,3
C=C(C=O)C(C=O)=CC=O,,,5,1,3,0,3
48903_0,,,,2,1,2,3
48904_0,,,,2,1,2,3
48905_0,,,,2,1,2,3
48906_0,,,,2,1,2,3
48907_0,,,,2,1,2,3
48909_0,,,,2,1,2,3
C=C(C=CC=O)C(C=O)=O,,,5,1,2,0,2
48910_0,,,,2,1,2,3
48912_0,,,,2,1,2,3
C(C(C=CC=O)=CC=O)=O,,,5,1,3,0,3
48913_0,,,,2,1,2,3
48914_0,,,,2,1,2,3
48915_0,,,,2,1,2,3
48916_0,,,,2,1,2,3
48917_0,,,,2,1,2,3
48918_0,,,,2,1,2,3
48919_0,,,,2,1,2,3
48921_0,,,,2,1,2,3
C=C(C=C)C(C=O)=O,,,5,1,2,0,2
48922_0,,,,2,1,2,3
48923_0,,,,2,1,2,3
48924_0,,,,2,1,2,3
48925_0,,,,2,1,2,3
48926_0,,,,2,1,2,3
48927_0,,,,2,1,2,3
48929_0,,,,2,1,2,3
C1OC(C(C(CO)O)O)C(C=1)O,,,5,1,1,0,1
48931_0,,,,2,1,2,3
C1C(C(C(CO)O)O)OC(C=1)O,,,5,1,1,0,1
48933_0,,,,2,1,2,3
C(C1C(C(C(O1)O)=O)=C)=O,,,5,1,2,0,2
48935_0,,,,2,1,2,3
C1C(O)OCC=1C(C=O)=O,,,5,1,1,0,1
48937_0,,,,2,1,2,3
C(C1C(C=O)=CC(O1)O)=O,,,5,1,2,0,2
48939_0,,,,2,1,2,3
C1C(CO)(COC=1C=O)O,,,5,1,1,0,1
48941_0,,,,2,1,2,3
C(C1(C=C(CO)CO1)O)=O,,,5,1,1,0,1
48943_0,,,,2,1,2,3
C1OCC(C=1C=O)(CO)O,,,5,1,1,0,1
48945_0,,,,2,1,2,3
C1(COC(C=1C=O)O)CO,,,5,1,1,0,1
48947_0,,,,2,1,2,3
C=C1C(C(OC1(CO)CO)O)=O,,,5,1,2,0,2
48949_0,,,,2,1,2,3
C1(CO)C(CO)(COC=1C=O)O,,,5,1,1,0,1
48951_0,,,,2,1,2,3
C(C1(C(C(CO)(CO1)O)=C)O)=O,,,5,1,2,0,2
48953_0,,,,2,1,2,3
C(C1(C(CO)=C(CO)CO1)O)=O,,,5,1,1,0,1
48955_0,,,,2,1,2,3
C1C(OC(C=1C=O)(CO)CO)O,,,5,1,2,0,2
48957_0,,,,2,1,2,3
C1(C(O)OCC1(CO)O)=CC=O,,,5,1,3,0,3
48959_0,,,,2,1,2,3
C(C(C1C(CO)(COC=1)O)O)=O,,,5,1,1,0,1
48961_0,,,,2,1,2,3
C(C(C1C(O)OCC=1CO)O)=O,,,5,1,1,0,1
48963_0,,,,2,1,2,3
C1OCC(C=1C(CO)=O)(CO)O,,,5,1,1,0,1
48965_0,,,,2,1,2,3
C1(COC(C=1C(CO)=O)O)CO,,,5,1,1,0,1
48967_0,,,,2,1,2,3
C1(CO)OCC(C=1C=O)(CO)O,,,5,1,1,0,1
48969_0,,,,2,1,2,3
C1(CO)COC(C=1C=O)(CO)O,,,5,1,1,0,1
48971_0,,,,2,1,2,3
C1(C(C(CO)(CO1)O)O)=CC=O,,,5,1,1,0,1
48973_0,,,,2,1,2,3
C(C(C1OCC(C=1)(CO)O)O)=O,,,5,1,1,0,1
48975_0,,,,2,1,2,3
C(C(C1(C=C(CO1)CO)O)O)=O,,,5,1,1,0,1
48977_0,,,,2,1,2,3
C1OCC(C=1)(CO)O,,,5,1,1,0,1
48979_0,,,,2,1,2,3
C1C(O)OCC=1CO,,,5,1,1,0,1
48981_0,,,,2,1,2,3
C(CO)(C1C=CC(O1)O)=O,,,5,1,1,0,1
48983_0,,,,2,1,2,3
C(CO)(C1C(C=CO1)O)=O,,,5,1,1,0,1
48985_0,,,,2,1,2,3
C(CO)(C(C1C=CC(O)O1)O)=O,,,5,1,2,0,2
48987_0,,,,2,1,2,3
C(CO)(C(C1C(C=CO1)O)O)=O,,,5,1,1,0,1
48988_0,,,,2,1,2,3
48990_0,,,,2,1,2,3
C(CO)(C1C=CC(CO)(O1)O)=O,,,5,1,1,0,1
48992_0,,,,2,1,2,3
C(CO)(C1C(C=C(CO)O1)O)=O,,,5,1,1,0,1
48994_0,,,,2,1,2,3
C1(COC(CO)(C1O)O)=CC=O,,,5,1,2,0,2
48996_0,,,,2,1,2,3
C(C1C(C=CO1)(CO)O)(CO)=O,,,5,1,1,0,1
48998_0,,,,2,1,2,3
C(CO)(C1C(CO)=CC(O1)O)=O,,,5,1,1,0,1
49000_0,,,,2,1,2,3
C(CO)(C1C(C(C(O1)=C)O)O)=O,,,5,1,1,0,1
49002_0,,,,2,1,2,3
C(C1C(C(C(CO)(O1)O)O)=C)=O,,,5,1,2,0,2
49004_0,,,,2,1,2,3
C(CO)(C1C(C(C(O1)O)O)=C)=O,,,5,1,2,0,2
49006_0,,,,2,1,2,3
C1C(COC=1C=O)(C(CO)O)O,,,5,1,1,0,1
49008_0,,,,2,1,2,3
C(C1(C=C(CO1)C(CO)O)O)=O,,,5,1,1,0,1
49010_0,,,,2,1,2,3
C1C(CO)(C(CO)OC=1C=O)O,,,5,1,1,0,1
49012_0,,,,2,1,2,3
C(C1(C=C(CO)C(CO)O1)O)=O,,,5,1,1,0,1
49014_0,,,,2,1,2,3
C1OCC(C=1C=O)(C(CO)O)O,,,5,1,1,0,1
49016_0,,,,2,1,2,3
C1(COC(C=1C=O)O)C(CO)O,,,5,1,1,0,1
49018_0,,,,2,1,2,3
C1OC(CO)C(C=1C=O)(CO)O,,,5,1,1,0,1
49020_0,,,,2,1,2,3
C1(CO)C(CO)OC(C=1C=O)O,,,5,1,1,0,1
49022_0,,,,2,1,2,3
C1OCC(C=1)(C(CO)O)O,,,5,1,1,0,1
49024_0,,,,2,1,2,3
C1(COC(C=1)O)C(CO)O,,,5,1,1,0,1
49026_0,,,,2,1,2,3
C1OC(CO)C(C=1)(CO)O,,,5,1,1,0,1
49028_0,,,,2,1,2,3
C1(CO)C(CO)OC(C=1)O,,,5,1,1,0,1
49030_0,,,,2,1,2,3
C(C(CO)O)(C1C=CC(O1)O)=O,,,5,1,1,0,1
49032_0,,,,2,1,2,3
C(C1C(C=CO1)O)(C(CO)O)=O,,,5,1,1,0,1
49034_0,,,,2,1,2,3
C1C(C(CO)(CO)OC=1C=O)O,,,5,1,1,0,1
49036_0,,,,2,1,2,3
C(C1(C=CC(CO)(CO)O1)O)=O,,,5,1,1,0,1
49038_0,,,,2,1,2,3
C1OC(CO)(CO)C(C=1C=O)O,,,5,1,1,0,1
49040_0,,,,2,1,2,3
C1C(CO)(CO)OC(C=1C=O)O,,,5,1,1,0,1
49042_0,,,,2,1,2,3
C1OC(CO)(CO)C(C=1)O,,,5,1,1,0,1
49044_0,,,,2,1,2,3
C1C(CO)(CO)OC(C=1)O,,,5,1,1,0,1
49046_0,,,,2,1,2,3
C1OC(CO)(C(CO)O)C(C=1)O,,,5,1,1,0,1
49048_0,,,,2,1,2,3
C1C(CO)(C(CO)O)OC(C=1)O,,,5,1,1,0,1
49050_0,,,,2,1,2,3
C(C1(C(C(C(O1)O)=O)=C)C)=O,,,5,1,2,0,2
49052_0,,,,2,1,2,3
C1(C)C(O)OCC=1C(C=O)=O,,,5,1,1,0,1
49054_0,,,,2,1,2,3
C=C1C(O)OCC1C(C=O)=O,,,5,1,2,0,2
49056_0,,,,2,1,2,3
C(C1C(C=O)=C(C)C(O1)O)=O,,,5,1,1,0,1
49058_0,,,,2,1,2,3
C(C1C(C(O)OC1C=O)=C)=O,,,5,1,2,0,2
49060_0,,,,2,1,2,3
C(C1(C(C=O)=CC(O1)O)C)=O,,,5,1,2,0,2
49062_0,,,,2,1,2,3
C(C)(C1C(C(C(O1)O)=O)=C)=O,,,5,1,2,0,2
49064_0,,,,2,1,2,3
C1C(C)(OCC=1C(C=O)=O)O,,,5,1,1,0,1
49066_0,,,,2,1,2,3
C=C1C(C(C(C=O)=O)CO1)O,,,5,1,1,0,1
49068_0,,,,2,1,2,3
C(C1C(C=O)=CC(C)(O1)O)=O,,,5,1,1,0,1
49070_0,,,,2,1,2,3
C(C1C(C=O)C(C(O1)=C)O)=O,,,5,1,1,0,1
49072_0,,,,2,1,2,3
C(C)(C1C(C=O)=CC(O1)O)=O,,,5,1,2,0,2
49074_0,,,,2,1,2,3
C(C1(C=C)CC(C(O1)O)=O)=O,,,5,1,2,0,2
49076_0,,,,2,1,2,3
C1(C(O)OC(C(C=C)=O)C1)=O,,,5,1,2,0,2
49078_0,,,,2,1,2,3
C(C1(C=CC(CC=O)O1)O)=O,,,5,1,1,0,1
49080_0,,,,2,1,2,3
C(CC1C(C=C(C=O)O1)O)=O,,,5,1,1,0,1
49082_0,,,,2,1,2,3
C1C(CC(C=O)=O)OC(C=1)O,,,5,1,2,0,2
49084_0,,,,2,1,2,3
C1OC(C(C=1)O)CC(C=O)=O,,,5,1,1,0,1
49086_0,,,,2,1,2,3
C1(C(O)OC(C=CC=O)C1)=O,,,5,1,3,0,3
49087_0,,,,2,1,2,3
49088_0,,,,2,1,2,3
49090_0,,,,2,1,2,3
C(C1(CC(CO1)=CC=O)O)=O,,,5,1,2,0,2
49092_0,,,,2,1,2,3
C(CC1COC(C=O)(C=1)O)=O,,,5,1,1,0,1
49094_0,,,,2,1,2,3
C(CC1(C=C(C=O)OC1)O)=O,,,5,1,1,0,1
49096_0,,,,2,1,2,3
C(C1(C=CC(C(C)=O)O1)O)=O,,,5,1,1,0,1
49098_0,,,,2,1,2,3
C(C)(C1C(C=C(C=O)O1)O)=O,,,5,1,1,0,1
49100_0,,,,2,1,2,3
C(C1C(CC(C=O)(O1)O)=C)=O,,,5,1,2,0,2
49102_0,,,,2,1,2,3
C(C1C(C)=CC(C=O)(O1)O)=O,,,5,1,1,0,1
49104_0,,,,2,1,2,3
C(C1C(C=C(C=O)O1)(C)O)=O,,,5,1,1,0,1
49106_0,,,,2,1,2,3
C(C1(C=CC(CO)O1)O)=O,,,5,1,1,0,1
49108_0,,,,2,1,2,3
C1C(C(CO)OC=1C=O)O,,,5,1,1,0,1
49110_0,,,,2,1,2,3
C(C1(C=CC(C(CO)O)O1)O)=O,,,5,1,1,0,1
49112_0,,,,2,1,2,3
C1C(C(C(CO)O)OC=1C=O)O,,,5,1,1,0,1
49114_0,,,,2,1,2,3
C(C1(C=CCO1)O)=O,,,5,1,1,0,1
49116_0,,,,2,1,2,3
C1C(COC=1C=O)O,,,5,1,1,0,1
49118_0,,,,2,1,2,3
C(CC1C(C(C(O)O1)=O)=C)=O,,,5,1,2,0,2
49120_0,,,,2,1,2,3
C(CC1C(C=O)=CC(O)O1)=O,,,5,1,2,0,2
49122_0,,,,2,1,2,3
C(CC(C1C=CC(O1)O)=O)=O,,,5,1,1,0,1
49124_0,,,,2,1,2,3
C(CC(C1C(C=CO1)O)=O)=O,,,5,1,1,0,1
49126_0,,,,2,1,2,3
C(C1C=CC(O1)O)=O,,,5,1,1,0,1
49128_0,,,,2,1,2,3
C(C1C(C=CO1)O)=O,,,5,1,1,0,1
49130_0,,,,2,1,2,3
C(CC1C=C(C=O)C(O)O1)=O,,,5,1,1,0,1
49132_0,,,,2,1,2,3
C(CC1C(C(C=O)=CO1)O)=O,,,5,1,1,0,1
49134_0,,,,2,1,2,3
C(C(C=O)C1C=CC(O)O1)=O,,,5,1,2,0,2
49136_0,,,,2,1,2,3
C(C(C=O)C1C(C=CO1)O)=O,,,5,1,1,0,1
49137_0,,,,2,1,2,3
49139_0,,,,2,1,2,3
C(C1C(COC1O)=CC=O)=O,,,5,1,2,0,2
49141_0,,,,2,1,2,3
C(CC1COC(C=1C=O)O)=O,,,5,1,1,0,1
49143_0,,,,2,1,2,3
C(CC1(C(C=O)=COC1)O)=O,,,5,1,1,0,1
49145_0,,,,2,1,2,3
C(C)(C1C=C(C=O)C(O1)O)=O,,,5,1,1,0,1
49147_0,,,,2,1,2,3
C(C)(C1C(C(C=O)=CO1)O)=O,,,5,1,1,0,1
49149_0,,,,2,1,2,3
C(C1C(C(C=O)OC1O)=C)=O,,,5,1,2,0,2
49151_0,,,,2,1,2,3
C(C1C(C)=C(C=O)C(O1)O)=O,,,5,1,1,0,1
49153_0,,,,2,1,2,3
C(C1C(C(C=O)=CO1)(C)O)=O,,,5,1,1,0,1
49155_0,,,,2,1,2,3
C1C(C(CO)O)OC(C=1C=O)O,,,5,1,1,0,1
49157_0,,,,2,1,2,3
C1OC(C(CO)O)C(C=1C=O)O,,,5,1,1,0,1
49159_0,,,,2,1,2,3
C=C1C(C(OC1C)O)=O,,,5,1,2,0,2
49161_0,,,,2,1,2,3
C(C1(C(CO)=CC(CO)O1)O)=O,,,5,1,1,0,1
49163_0,,,,2,1,2,3
C1(CO)C(C(CO)OC=1C=O)O,,,5,1,1,0,1
49165_0,,,,2,1,2,3
C(C1(C(C(C(CO)O1)O)=C)O)=O,,,5,1,2,0,2
49167_0,,,,2,1,2,3
C=C1C(C(OC1C(CO)O)O)=O,,,5,1,2,0,2
49169_0,,,,2,1,2,3
C(C1(C(CO)=CCO1)O)=O,,,5,1,1,0,1
49171_0,,,,2,1,2,3
C1(CO)C(COC=1C=O)O,,,5,1,1,0,1
49173_0,,,,2,1,2,3
C(C1(C(C(CO1)O)=C)O)=O,,,5,1,2,0,2
49175_0,,,,2,1,2,3
C=C1C(C(OC1CO)O)=O,,,5,1,2,0,2
49177_0,,,,2,1,2,3
C(CC1C=CC(O)O1)=O,,,5,1,2,0,2
49179_0,,,,2,1,2,3
C(CC1C(C=CO1)O)=O,,,5,1,1,0,1
49181_0,,,,2,1,2,3
C(C(C1C=CC(O)O1)O)=O,,,5,1,2,0,2
49183_0,,,,2,1,2,3
C(C(C1C(C=CO1)O)O)=O,,,5,1,1,0,1
49184_0,,,,2,1,2,3
49185_0,,,,2,1,2,3
49187_0,,,,2,1,2,3
C1C(OC(C=1C=O)C)O,,,5,1,2,0,2
49189_0,,,,2,1,2,3
C(C(C1C(OC(C=1)CO)O)O)=O,,,5,1,1,0,1
49191_0,,,,2,1,2,3
C1(C(O)OC(CO)C1O)=CC=O,,,5,1,3,0,3
49193_0,,,,2,1,2,3
C(C(C1C(C(CO)OC=1)O)O)=O,,,5,1,1,0,1
49195_0,,,,2,1,2,3
C1C(OC(C=1C=O)C(CO)O)O,,,5,1,2,0,2
49197_0,,,,2,1,2,3
C1C(O)OCC=1C=O,,,5,1,2,0,2
49198_0,,,,2,1,2,3
49199_0,,,,2,1,2,3
49201_0,,,,2,1,2,3
C(C(C1C(COC=1)O)O)=O,,,5,1,1,0,1
49203_0,,,,2,1,2,3
C1C(OC(C=1C=O)CO)O,,,5,1,2,0,2
49205_0,,,,2,1,2,3
C(C1C=CC(CO)(O1)O)=O,,,5,1,1,0,1
49207_0,,,,2,1,2,3
C(C1C(C=C(CO)O1)O)=O,,,5,1,1,0,1
49209_0,,,,2,1,2,3
C(C1C(C=CO1)(CO)O)=O,,,5,1,1,0,1
49211_0,,,,2,1,2,3
C(C1C(CO)=CC(O1)O)=O,,,5,1,1,0,1
49213_0,,,,2,1,2,3
C1(COC(C1O)O)=CC=O,,,5,1,2,0,2
49215_0,,,,2,1,2,3
C1C(CO)OC(C=1C(CO)=O)O,,,5,1,1,0,1
49217_0,,,,2,1,2,3
C1OC(CO)C(C=1C(CO)=O)O,,,5,1,1,0,1
49219_0,,,,2,1,2,3
C1C(CO)OC(C=1C=O)(CO)O,,,5,1,1,0,1
49221_0,,,,2,1,2,3
C1(CO)OC(CO)C(C=1C=O)O,,,5,1,1,0,1
49223_0,,,,2,1,2,3
C1COC(C=1C=O)(CO)O,,,5,1,1,0,1
49225_0,,,,2,1,2,3
C1(CO)OCC(C=1C=O)O,,,5,1,1,0,1
49227_0,,,,2,1,2,3
C1(C(C(C(CO)O1)O)O)=CC=O,,,5,1,1,0,1
49229_0,,,,2,1,2,3
C1(C(C(CO1)O)O)=CC=O,,,5,1,1,0,1
49231_0,,,,2,1,2,3
C(C)(C1C(C=CO1)O)=O,,,5,1,1,0,1
49233_0,,,,2,1,2,3
C(C)(C1C=CC(O1)O)=O,,,5,1,1,0,1
49235_0,,,,2,1,2,3
C(C1C(C(C(O1)=C)O)O)=O,,,5,1,1,0,1
49237_0,,,,2,1,2,3
C(C1C(C=CO1)(C)O)=O,,,5,1,1,0,1
49239_0,,,,2,1,2,3
C(C1C(C)=CC(O1)O)=O,,,5,1,1,0,1
49241_0,,,,2,1,2,3
C(C1C(CC(O1)O)=C)=O,,,5,1,2,0,2
49243_0,,,,2,1,2,3
C(C1C(C(C(O1)O)O)=C)=O,,,5,1,2,0,2
49245_0,,,,2,1,2,3
C(C(C1(C=CC(CO)O1)O)O)=O,,,5,1,1,0,1
49247_0,,,,2,1,2,3
C(C(C1OC(CO)C(C=1)O)O)=O,,,5,1,1,0,1
49249_0,,,,2,1,2,3
C(C(C1(C=CCO1)O)O)=O,,,5,1,1,0,1
49251_0,,,,2,1,2,3
C(C(C1OCC(C=1)O)O)=O,,,5,1,1,0,1
49253_0,,,,2,1,2,3
C1C(CO)OC(C=1)O,,,5,1,1,0,1
49255_0,,,,2,1,2,3
C1OC(CO)C(C=1)O,,,5,1,1,0,1
49257_0,,,,2,1,2,3
C1C(C(CO)O)OC(C=1)O,,,5,1,1,0,1
49259_0,,,,2,1,2,3
C1OC(C(CO)O)C(C=1)O,,,5,1,1,0,1
49261_0,,,,2,1,2,3
C1COC(C=1)O,,,5,1,2,0,2
49263_0,,,,2,1,2,3
C1OCC(C=1)O,,,5,1,1,0,1
49264_0,,,,2,1,2,3
49266_0,,,,2,1,2,3
C1C(O)OC(C=1)=O,,,5,1,2,0,2
49268_0,,,,2,1,2,3
C1(C(C=CO1)O)=O,,,5,1,1,0,1
49269_0,,,,2,1,2,3
49271_0,,,,2,1,2,3
C=CC1(C(O)OC(CO)C1O)O,,,5,1,2,0,2
49273_0,,,,2,1,2,3
C(C1(C(OCC1(CO)O)=C)O)=O,,,5,1,1,0,1
49275_0,,,,2,1,2,3
C(CO)(C1(C(C(O)OC1)=C)O)=O,,,5,1,2,0,2
49277_0,,,,2,1,2,3
C(CO)(C1(COC(C1O)=C)O)=O,,,5,1,1,0,1
49279_0,,,,2,1,2,3
C(CO)(C1(C=CC(O1)O)CO)=O,,,5,1,1,0,1
49281_0,,,,2,1,2,3
C(CO)(C1(CO)C(C=CO1)O)=O,,,5,1,1,0,1
49283_0,,,,2,1,2,3
C1(C(C(C(O)O1)=C)(CO)O)=O,,,5,1,2,0,2
49285_0,,,,2,1,2,3
C(C1(C(C(O)OC1)=C)O)(O)=O,,,5,1,2,0,2
49287_0,,,,2,1,2,3
C1(C(CO)(C(C(O1)=C)O)O)=O,,,5,1,1,0,1
49289_0,,,,2,1,2,3
C(C1(COC(C1O)=C)O)(O)=O,,,5,1,1,0,1
49291_0,,,,2,1,2,3
C(C1(C=CC(O1)O)CO)(O)=O,,,5,1,1,0,1
49293_0,,,,2,1,2,3
C(C1(CO)C(C=CO1)O)(O)=O,,,5,1,1,0,1
49295_0,,,,2,1,2,3
C(C1(C(C(O)OC1)=C)O)=O,,,5,1,2,0,2
49297_0,,,,2,1,2,3
C(C1(C(C(O)OC1CO)=C)O)=O,,,5,1,2,0,2
49299_0,,,,2,1,2,3
C=C(C=O)C1(C(O)OCC1O)O,,,5,1,2,0,2
49301_0,,,,2,1,2,3
C(C1(COC(C1O)=C)O)=O,,,5,1,1,0,1
49303_0,,,,2,1,2,3
C(C1(C(CO)OC(C1O)=C)O)=O,,,5,1,1,0,1
49305_0,,,,2,1,2,3
C(C1(C(C)=O)C=CC(O1)O)=O,,,5,1,1,0,1
49307_0,,,,2,1,2,3
C(C1(C(C)=O)C(C=CO1)O)=O,,,5,1,1,0,1
49309_0,,,,2,1,2,3
C(C1(C=CC(O1)O)CO)=O,,,5,1,1,0,1
49311_0,,,,2,1,2,3
C(C1(CO)C(C=CO1)O)=O,,,5,1,1,0,1
49313_0,,,,2,1,2,3
C(C1(C=CC(O1)O)C(CO)O)=O,,,5,1,1,0,1
49315_0,,,,2,1,2,3
C(C1(C(CO)O)C(C=CO1)O)=O,,,5,1,1,0,1
49317_0,,,,2,1,2,3
C(C1(C(O)OCC1O)O)=CC=O,,,5,1,2,0,2
49319_0,,,,2,1,2,3
C(C1(C(C(O)OC1)=CCO)O)=O,,,5,1,2,0,2
49321_0,,,,2,1,2,3
C(C1(COC(C1(C=C)O)O)O)=O,,,5,1,2,0,2
49323_0,,,,2,1,2,3
C(C1(COC(C1O)=CCO)O)=O,,,5,1,1,0,1
49325_0,,,,2,1,2,3
C(C1(COC(C=C)(C1O)O)O)=O,,,5,1,2,0,2
49327_0,,,,2,1,2,3
C(C(CO)(C1C=CC(O1)O)O)=O,,,5,1,2,0,2
49329_0,,,,2,1,2,3
C(C(CO)(C1C(C=CO1)O)O)=O,,,5,1,1,0,1
49330_0,,,,2,1,2,3
49332_0,,,,2,1,2,3
C(C1(C=CC(CO)(O1)O)CO)=O,,,5,1,1,0,1
49334_0,,,,2,1,2,3
C(C1(CO)C(C=C(CO)O1)O)=O,,,5,1,1,0,1
49336_0,,,,2,1,2,3
C(C1(CO)C(C=CO1)(CO)O)=O,,,5,1,1,0,1
49338_0,,,,2,1,2,3
C(C1(C(CO)=CC(O1)O)CO)=O,,,5,1,1,0,1
49340_0,,,,2,1,2,3
C1(COC(C1(CO)O)O)=CC=O,,,5,1,2,0,2
49342_0,,,,2,1,2,3
C(C1(C(OC(CO)C1O)=C)O)=O,,,5,1,1,0,1
49344_0,,,,2,1,2,3
C(C1(C(OCC1O)=C)O)=O,,,5,1,1,0,1
49346_0,,,,2,1,2,3
C(C1(CO)C(C(C(O1)=C)O)O)=O,,,5,1,1,0,1
49348_0,,,,2,1,2,3
C(C1(C(C(C(O1)O)O)=C)CO)=O,,,5,1,2,0,2
49350_0,,,,2,1,2,3
C(C1C(C(C(O1)O)(CO)O)=C)=O,,,5,1,2,0,2
49352_0,,,,2,1,2,3
C=CC1(C(O)OCC1O)O,,,5,1,2,0,2
49353_0,,,,2,1,2,3
49355_0,,,,2,1,2,3
C(C1(C=COC1C=O)O)=O,,,5,1,1,0,1
49356_0,,,,2,1,2,3
49358_0,,,,2,1,2,3
C(C1(C=COC1(CO)CO)O)=O,,,5,1,1,0,1
49359_0,,,,2,1,2,3
49360_0,,,,2,1,2,3
49362_0,,,,2,1,2,3
C(C1(C=COC1(C=O)C)O)=O,,,5,1,1,0,1
49364_0,,,,2,1,2,3
C1(C(C(C(O)O1)=C)O)=O,,,5,1,2,0,2
49365_0,,,,2,1,2,3
49367_0,,,,2,1,2,3
C(C1(C=COC1C(C)=O)O)=O,,,5,1,1,0,1
49369_0,,,,2,1,2,3
C1(C(C(C(O1)=C)O)O)=O,,,5,1,1,0,1
49371_0,,,,2,1,2,3
C(C1(C=CC(O1)O)CC=O)=O,,,5,1,1,0,1
49373_0,,,,2,1,2,3
C(CC1(C=O)C(C=CO1)O)=O,,,5,1,1,0,1
49374_0,,,,2,1,2,3
49376_0,,,,2,1,2,3
C(C1(C=COC1CC=O)O)=O,,,5,1,1,0,1
49378_0,,,,2,1,2,3
C(C1C=CC(O1)O)(O)=O,,,5,1,1,0,1
49380_0,,,,2,1,2,3
C(C1C(C=CO1)O)(O)=O,,,5,1,1,0,1
49382_0,,,,2,1,2,3
C1(C(C(C(O)O1)=CCO)O)=O,,,5,1,2,0,2
49384_0,,,,2,1,2,3
C1(C(C(C=C)(C(O)O1)O)O)=O,,,5,1,2,0,2
49386_0,,,,2,1,2,3
C1(C(C(C(O1)=CCO)O)O)=O,,,5,1,1,0,1
49388_0,,,,2,1,2,3
C1(C(C(C(C=C)(O)O1)O)O)=O,,,5,1,2,0,2
49389_0,,,,2,1,2,3
49391_0,,,,2,1,2,3
C(C1(C=COC1C)O)=O,,,5,1,1,0,1
49392_0,,,,2,1,2,3
49393_0,,,,2,1,2,3
49395_0,,,,2,1,2,3
C(C1(C=COC1C(CO)O)O)=O,,,5,1,1,0,1
49396_0,,,,2,1,2,3
49398_0,,,,2,1,2,3
C(C1(C=COC1)O)=O,,,5,1,1,0,1
49399_0,,,,2,1,2,3
49401_0,,,,2,1,2,3
C(C1(C=COC1CO)O)=O,,,5,1,1,0,1
49403_0,,,,2,1,2,3
C(C(C1C=CC(O)O1)O)(O)=O,,,5,1,2,0,2
49405_0,,,,2,1,2,3
C(C(C1C(C=CO1)O)O)(O)=O,,,5,1,1,0,1
49406_0,,,,2,1,2,3
49408_0,,,,2,1,2,3
C(C1C=CC(CO)(O1)O)(O)=O,,,5,1,1,0,1
49410_0,,,,2,1,2,3
C(C1C(C=C(CO)O1)O)(O)=O,,,5,1,1,0,1
49412_0,,,,2,1,2,3
C(C1C(C=CO1)(CO)O)(O)=O,,,5,1,1,0,1
49414_0,,,,2,1,2,3
C(C1C(CO)=CC(O1)O)(O)=O,,,5,1,1,0,1
49416_0,,,,2,1,2,3
C(C1C(C(C(O1)=C)O)O)(O)=O,,,5,1,1,0,1
49418_0,,,,2,1,2,3
C(C1C(C(C(O1)O)O)=C)(O)=O,,,5,1,2,0,2
49420_0,,,,2,1,2,3
C(C1(C=C(CO)OC1)O)=O,,,5,1,1,0,1
49422_0,,,,2,1,2,3
C1C(CO)(OCC=1C=O)O,,,5,1,1,0,1
49424_0,,,,2,1,2,3
C1C(COC=1C(O)=O)O,,,5,1,1,0,1
49426_0,,,,2,1,2,3
C(C1(C=CCO1)O)(O)=O,,,5,1,1,0,1
49428_0,,,,2,1,2,3
C1C(CO)(O)OC(C=1)=O,,,5,1,1,0,1
49430_0,,,,2,1,2,3
C1(C(C=C(CO)O1)O)=O,,,5,1,1,0,1
49432_0,,,,2,1,2,3
C1C(C(CO)OC=1C(O)=O)O,,,5,1,1,0,1
49434_0,,,,2,1,2,3
C(C1(C=CC(CO)O1)O)(O)=O,,,5,1,1,0,1
49436_0,,,,2,1,2,3
C1C(C(CO)O)(O)OC(C=1)=O,,,5,1,1,0,1
49438_0,,,,2,1,2,3
C1(C(C=C(C(CO)O)O1)O)=O,,,5,1,1,0,1
49440_0,,,,2,1,2,3
C1(C(C(CO1)O)O)=CC(O)=O,,,5,1,1,0,1
49442_0,,,,2,1,2,3
C(C(C1OCC(C=1)O)O)(O)=O,,,5,1,1,0,1
49444_0,,,,2,1,2,3
C(C(C1(C=CCO1)O)O)(O)=O,,,5,1,1,0,1
49446_0,,,,2,1,2,3
C1OC(C(C(C=1)O)O)C(CO)O,,,5,1,1,0,1
49448_0,,,,2,1,2,3
C1C(C(C(CO)O)OC(C=1)O)O,,,5,1,1,0,1
49450_0,,,,2,1,2,3
C1C(O)OCC(C=1C=O)=O,,,5,1,1,0,1
49452_0,,,,2,1,2,3
C(C1C(C(C=CO1)=O)O)=O,,,5,1,1,0,1
49454_0,,,,2,1,2,3
C(C1C(C=CC(O1)O)=O)=O,,,5,1,1,0,1
49456_0,,,,2,1,2,3
C1(COC(C(C=1)=O)O)CO,,,5,1,1,0,1
49458_0,,,,2,1,2,3
C=C1C(C(O)OCC1(CO)O)=O,,,5,1,2,0,2
49460_0,,,,2,1,2,3
C1(COC(C(C=1CO)=O)O)CO,,,5,1,1,0,1
49462_0,,,,2,1,2,3
C1C(O)OCC(C=1C=O)(CO)O,,,5,1,2,0,2
49464_0,,,,2,1,2,3
C1(COC(C(C=1C=O)O)O)CO,,,5,1,1,0,1
49466_0,,,,2,1,2,3
C1OC(CO)(CO)C(C(C=1)=O)O,,,5,1,1,0,1
49468_0,,,,2,1,2,3
C1(COC(C(C1O)=C)O)=O,,,5,1,2,0,2
49470_0,,,,2,1,2,3
C1(COC(C(C1O)O)=C)=O,,,5,1,1,0,1
49472_0,,,,2,1,2,3
C1COC(CO)(C(C=1C=O)O)O,,,5,1,1,0,1
49474_0,,,,2,1,2,3
C1(COC(C(C1O)=CCO)O)=O,,,5,1,2,0,2
49476_0,,,,2,1,2,3
C1(C(C(C=C)(C(OC1)O)O)O)=O,,,5,1,2,0,2
49478_0,,,,2,1,2,3
C1(COC(C(C1O)O)=CCO)=O,,,5,1,1,0,1
49480_0,,,,2,1,2,3
C1(COC(C=C)(C(C1O)O)O)=O,,,5,1,2,0,2
49482_0,,,,2,1,2,3
C(CO)(C1C(C=CC(O)O1)O)=O,,,5,1,2,0,2
49484_0,,,,2,1,2,3
C(CO)(C1C(C(C=CO1)O)O)=O,,,5,1,1,0,1
49486_0,,,,2,1,2,3
C(C1C=CC(C(CO)(O1)O)O)=O,,,5,1,1,0,1
49487_0,,,,2,1,2,3
49489_0,,,,2,1,2,3
C(CO)(C1C=CC(C(O1)O)O)=O,,,5,1,1,0,1
49491_0,,,,2,1,2,3
C1(COC(C(C=1)=O)O)C(CO)O,,,5,1,1,0,1
49493_0,,,,2,1,2,3
C1(CO)C(CO)OC(C(C=1)=O)O,,,5,1,1,0,1
49495_0,,,,2,1,2,3
C1C(CO)(C(COC=1C=O)O)O,,,5,1,1,0,1
49497_0,,,,2,1,2,3
C(C1(C=C(CO)C(CO1)O)O)=O,,,5,1,1,0,1
49499_0,,,,2,1,2,3
C1OCC(C(C=1C=O)(CO)O)O,,,5,1,1,0,1
49501_0,,,,2,1,2,3
C1(CO)C(COC(C=1C=O)O)O,,,5,1,1,0,1
49503_0,,,,2,1,2,3
C1OCC(C(C=1)(CO)O)O,,,5,1,1,0,1
49505_0,,,,2,1,2,3
C1(CO)C(COC(C=1)O)O,,,5,1,1,0,1
49507_0,,,,2,1,2,3
C1(C(CO)OC(C(C1O)=C)O)=O,,,5,1,2,0,2
49509_0,,,,2,1,2,3
C1(C(C(C(OC1CO)=C)O)O)=O,,,5,1,1,0,1
49511_0,,,,2,1,2,3
C1C(CO)(CO)OC(C(C=1)=O)O,,,5,1,1,0,1
49513_0,,,,2,1,2,3
C1C(C(CO)(COC=1C=O)O)O,,,5,1,1,0,1
49515_0,,,,2,1,2,3
C(C1(C=CC(CO)(CO1)O)O)=O,,,5,1,1,0,1
49517_0,,,,2,1,2,3
C1OCC(CO)(C(C=1C=O)O)O,,,5,1,1,0,1
49519_0,,,,2,1,2,3
C1C(CO)(COC(C=1C=O)O)O,,,5,1,1,0,1
49521_0,,,,2,1,2,3
C1OCC(CO)(C(C=1)O)O,,,5,1,1,0,1
49523_0,,,,2,1,2,3
C1C(CO)(COC(C=1)O)O,,,5,1,1,0,1
49525_0,,,,2,1,2,3
C1OCC(C(CO)O)(C(C=1)O)O,,,5,1,1,0,1
49527_0,,,,2,1,2,3
C1C(COC(C=1)O)(C(CO)O)O,,,5,1,1,0,1
49529_0,,,,2,1,2,3
C1OC(CO)C(CO)(C(C=1)O)O,,,5,1,1,0,1
49531_0,,,,2,1,2,3
C1C(CO)(C(CO)OC(C=1)O)O,,,5,1,1,0,1
49533_0,,,,2,1,2,3
C1(C)C(O)OCC(C=1C=O)=O,,,5,1,1,0,1
49535_0,,,,2,1,2,3
C(C1C(COC(C1=C)O)=O)=O,,,5,1,2,0,2
49537_0,,,,2,1,2,3
C(C1(C)C(C(C=CO1)=O)O)=O,,,5,1,1,0,1
49539_0,,,,2,1,2,3
C(C1C(C=C(C)C(O1)O)=O)=O,,,5,1,1,0,1
49541_0,,,,2,1,2,3
C1(C(C=O)OC(C(C1)=C)O)=O,,,5,1,2,0,2
49543_0,,,,2,1,2,3
C1C(C)(OCC(C=1C=O)=O)O,,,5,1,1,0,1
49545_0,,,,2,1,2,3
C(C1C(COC(C1O)=C)=O)=O,,,5,1,1,0,1
49547_0,,,,2,1,2,3
C(C)(C1C(C(C=CO1)=O)O)=O,,,5,1,1,0,1
49549_0,,,,2,1,2,3
C(C1C(C=CC(C)(O1)O)=O)=O,,,5,1,1,0,1
49551_0,,,,2,1,2,3
C(C1C(CC(C(O1)=C)O)=O)=O,,,5,1,1,0,1
49553_0,,,,2,1,2,3
C(C1(CC(C=O)=CCO1)O)=O,,,5,1,1,0,1
49555_0,,,,2,1,2,3
C(C1(C=C(C=O)CCO1)O)=O,,,5,1,1,0,1
49557_0,,,,2,1,2,3
C(C1(C=C(C=O)OCC1)O)=O,,,5,1,1,0,1
49559_0,,,,2,1,2,3
C(CC1C=CC(C(O)O1)=O)=O,,,5,1,1,0,1
49561_0,,,,2,1,2,3
C(C1C=CCC(C=O)(O1)O)=O,,,5,1,1,0,1
49563_0,,,,2,1,2,3
C(C1(C=CCC(C=O)O1)O)=O,,,5,1,1,0,1
49565_0,,,,2,1,2,3
C(C1CC(C=C(C=O)O1)O)=O,,,5,1,1,0,1
49567_0,,,,2,1,2,3
C1(C(O)OCC(C1)=CC=O)=O,,,5,1,2,0,2
49569_0,,,,2,1,2,3
C(CC1COC(C(C=1)=O)O)=O,,,5,1,1,0,1
49571_0,,,,2,1,2,3
C(C)(C1C=CC(C(O1)O)=O)=O,,,5,1,1,0,1
49573_0,,,,2,1,2,3
C(C1C(CC(C(O1)O)=O)=C)=O,,,5,1,2,0,2
49575_0,,,,2,1,2,3
C(C1C(C)=CC(C(O1)O)=O)=O,,,5,1,1,0,1
49577_0,,,,2,1,2,3
C(C1(C=CC(CO1)O)O)=O,,,5,1,1,0,1
49579_0,,,,2,1,2,3
C1C(C(COC=1C=O)O)O,,,5,1,1,0,1
49581_0,,,,2,1,2,3
C1C(C(CO)O)OC(C(C=1)=O)O,,,5,1,1,0,1
49583_0,,,,2,1,2,3
C(C1(C=CC(C(CO)O1)O)O)=O,,,5,1,1,0,1
49585_0,,,,2,1,2,3
C1C(C(C(CO)OC=1C=O)O)O,,,5,1,1,0,1
49587_0,,,,2,1,2,3
C1CC(OCC=1C(C=O)=O)O,,,5,1,1,0,1
49589_0,,,,2,1,2,3
C1C(C(C=O)=O)COC(C=1)O,,,5,1,1,0,1
49591_0,,,,2,1,2,3
C1OCC(C(C=O)=O)C(C=1)O,,,5,1,1,0,1
49593_0,,,,2,1,2,3
C(C1C(C=O)=CCC(O1)O)=O,,,5,1,1,0,1
49595_0,,,,2,1,2,3
C(C1C=CC(O)OC1C=O)=O,,,5,1,1,0,1
49597_0,,,,2,1,2,3
C(C1C(C=O)C(C=CO1)O)=O,,,5,1,1,0,1
49599_0,,,,2,1,2,3
C(CC1C(C(C=CO1)=O)O)=O,,,5,1,1,0,1
49601_0,,,,2,1,2,3
C(C1C(C=O)=CCOC1O)=O,,,5,1,1,0,1
49603_0,,,,2,1,2,3
C(C1CCOC(C=1C=O)O)=O,,,5,1,1,0,1
49605_0,,,,2,1,2,3
C(C1(C(C=O)=COCC1)O)=O,,,5,1,1,0,1
49607_0,,,,2,1,2,3
C(C1C=CC(C=O)OC1O)=O,,,5,1,1,0,1
49609_0,,,,2,1,2,3
C(C1CC=C(C=O)C(O)O1)=O,,,5,1,1,0,1
49611_0,,,,2,1,2,3
C(C1CC(C(C=O)=CO1)O)=O,,,5,1,1,0,1
49613_0,,,,2,1,2,3
C1C(C(CO)OC(C=1C=O)O)O,,,5,1,1,0,1
49615_0,,,,2,1,2,3
C1OC(CO)C(C(C=1C=O)O)O,,,5,1,1,0,1
49617_0,,,,2,1,2,3
C(C1(C=COCC1)O)=O,,,5,1,1,0,1
49619_0,,,,2,1,2,3
C1C(O)OCCC=1C=O,,,5,1,1,0,1
49621_0,,,,2,1,2,3
C1COC(CC=1C=O)O,,,5,1,1,0,1
49623_0,,,,2,1,2,3
C1COC(C(C=1C=O)O)O,,,5,1,2,0,2
49625_0,,,,2,1,2,3
C1C(CO)OC(C(C=1CO)=O)O,,,5,1,1,0,1
49627_0,,,,2,1,2,3
C=C1C(C(O)OC(CO)C1O)=O,,,5,1,2,0,2
49629_0,,,,2,1,2,3
C(C1(C(CO)=CC(CO1)O)O)=O,,,5,1,1,0,1
49631_0,,,,2,1,2,3
C1(CO)C(C(COC=1C=O)O)O,,,5,1,1,0,1
49633_0,,,,2,1,2,3
C(C1(C(C(C(CO1)O)O)=C)O)=O,,,5,1,2,0,2
49635_0,,,,2,1,2,3
C1COC(C(C=1CO)=O)O,,,5,1,1,0,1
49637_0,,,,2,1,2,3
C=C1C(C(O)OCC1O)=O,,,5,1,2,0,2
49639_0,,,,2,1,2,3
C(C1C(C=CC(O)O1)O)=O,,,5,1,2,0,2
49641_0,,,,2,1,2,3
C(C1C(C(C=CO1)O)O)=O,,,5,1,1,0,1
49643_0,,,,2,1,2,3
C(C1CC(C=CO1)O)=O,,,5,1,1,0,1
49645_0,,,,2,1,2,3
C(C1CC=CC(O)O1)=O,,,5,1,1,0,1
49647_0,,,,2,1,2,3
C(C1C=CCC(O1)O)=O,,,5,1,1,0,1
49648_0,,,,2,1,2,3
49650_0,,,,2,1,2,3
C(C1C=CC(C(O1)O)O)=O,,,5,1,2,0,2
49651_0,,,,2,1,2,3
49653_0,,,,2,1,2,3
C1C(CO)OC(C(C=1C=O)O)O,,,5,1,1,0,1
49655_0,,,,2,1,2,3
C1C(O)OC(CO)C(C=1C=O)O,,,5,1,2,0,2
49657_0,,,,2,1,2,3
C(C(C1C(O)OCC(C=1)O)O)=O,,,5,1,1,0,1
49659_0,,,,2,1,2,3
C1(C(O)OCC(C1O)O)=CC=O,,,5,1,3,0,3
49661_0,,,,2,1,2,3
C(C(C1C(C(COC=1)O)O)O)=O,,,5,1,1,0,1
49662_0,,,,2,1,2,3
49664_0,,,,2,1,2,3
C1C(O)OCC(C=1C=O)O,,,5,1,2,0,2
49666_0,,,,2,1,2,3
C1C(COC(C=1C(CO)=O)O)O,,,5,1,1,0,1
49668_0,,,,2,1,2,3
C1OCC(C(C=1C(CO)=O)O)O,,,5,1,1,0,1
49670_0,,,,2,1,2,3
C1C(COC(C=1C=O)(CO)O)O,,,5,1,1,0,1
49672_0,,,,2,1,2,3
C1(CO)OCC(C(C=1C=O)O)O,,,5,1,1,0,1
49674_0,,,,2,1,2,3
C1OC(C)C(C(C=1)=O)O,,,5,1,1,0,1
49676_0,,,,2,1,2,3
C1(C(C(C(CO1)O)O)O)=CC=O,,,5,1,1,0,1
49678_0,,,,2,1,2,3
C1OC(C(CO)O)C(C(C=1)=O)O,,,5,1,1,0,1
49680_0,,,,2,1,2,3
C(C(C1(C=CC(CO1)O)O)O)=O,,,5,1,1,0,1
49682_0,,,,2,1,2,3
C(C(C1OCC(C(C=1)O)O)O)=O,,,5,1,1,0,1
49684_0,,,,2,1,2,3
C1C(COC(C=1)O)O,,,5,1,1,0,1
49686_0,,,,2,1,2,3
C1OCC(C(C=1)O)O,,,5,1,1,0,1
49688_0,,,,2,1,2,3
C1C(C(CO)OC(C=1)O)O,,,5,1,1,0,1
49690_0,,,,2,1,2,3
C1OC(CO)C(C(C=1)O)O,,,5,1,1,0,1
49692_0,,,,2,1,2,3
C=CC1(C(O)OCC(C1O)O)O,,,5,1,2,0,2
49694_0,,,,2,1,2,3
C1(COC(C(C1(CO)O)=C)O)=O,,,5,1,2,0,2
49696_0,,,,2,1,2,3
C1(COC(C(C1(CO)O)O)=C)=O,,,5,1,1,0,1
49698_0,,,,2,1,2,3
C(CO)(C1(C=CC(O)OC1)O)=O,,,5,1,1,0,1
49700_0,,,,2,1,2,3
C(CO)(C1(COC=CC1O)O)=O,,,5,1,1,0,1
49702_0,,,,2,1,2,3
C1(C(C=CC(O)O1)(CO)O)=O,,,5,1,1,0,1
49704_0,,,,2,1,2,3
C1(C(CO)(C(C=CO1)O)O)=O,,,5,1,1,0,1
49706_0,,,,2,1,2,3
C(C1(C=CC(O)OC1)O)(O)=O,,,5,1,1,0,1
49708_0,,,,2,1,2,3
C(C1(COC=CC1O)O)(O)=O,,,5,1,1,0,1
49710_0,,,,2,1,2,3
C(C1(C(C(O)OCC1O)=C)O)=O,,,5,1,2,0,2
49712_0,,,,2,1,2,3
C(C1(C(COC(C1O)=C)O)O)=O,,,5,1,1,0,1
49714_0,,,,2,1,2,3
C(C1(C=CC(O)OC1)O)=O,,,5,1,1,0,1
49716_0,,,,2,1,2,3
C(C1(COC=CC1O)O)=O,,,5,1,1,0,1
49718_0,,,,2,1,2,3
C(C1(C=CC(O)OC1CO)O)=O,,,5,1,1,0,1
49720_0,,,,2,1,2,3
C(C1(C(CO)OC=CC1O)O)=O,,,5,1,1,0,1
49722_0,,,,2,1,2,3
C1COC(C(C=1C=O)(CO)O)O,,,5,1,1,0,1
49724_0,,,,2,1,2,3
C(C1(CO)C(C=CC(O1)O)O)=O,,,5,1,2,0,2
49726_0,,,,2,1,2,3
C(C1(CO)C(C(C=CO1)O)O)=O,,,5,1,1,0,1
49727_0,,,,2,1,2,3
49729_0,,,,2,1,2,3
C(C1(C=CC(C(O1)O)O)CO)=O,,,5,1,1,0,1
49731_0,,,,2,1,2,3
C(C1C=CC(C(O1)O)(CO)O)=O,,,5,1,1,0,1
49733_0,,,,2,1,2,3
C(C1(C=CC(CO)(O)OC1)O)=O,,,5,1,1,0,1
49735_0,,,,2,1,2,3
C(C1(COC(CO)=CC1O)O)=O,,,5,1,1,0,1
49737_0,,,,2,1,2,3
C(C1(COC=CC1(CO)O)O)=O,,,5,1,1,0,1
49739_0,,,,2,1,2,3
C(C1(C(CO)=CC(O)OC1)O)=O,,,5,1,1,0,1
49741_0,,,,2,1,2,3
C(C1(C(OCC(C1O)O)=C)O)=O,,,5,1,1,0,1
49743_0,,,,2,1,2,3
C(C1(COC(C(C1O)O)=C)O)=O,,,5,1,1,0,1
49745_0,,,,2,1,2,3
C(C1(C(C(C(O)OC1)O)=C)O)=O,,,5,1,2,0,2
49746_0,,,,2,1,2,3
49748_0,,,,2,1,2,3
C(C1(C=COCC1(CO)O)O)=O,,,5,1,1,0,1
49750_0,,,,2,1,2,3
C1(C(C=CC(O)O1)O)=O,,,5,1,1,0,1
49752_0,,,,2,1,2,3
C1(C(C(C=CO1)O)O)=O,,,5,1,1,0,1
49753_0,,,,2,1,2,3
49755_0,,,,2,1,2,3
C(C1(C=COC(CO)C1O)O)=O,,,5,1,1,0,1
49756_0,,,,2,1,2,3
49757_0,,,,2,1,2,3
49759_0,,,,2,1,2,3
C(C1(C=COCC1O)O)=O,,,5,1,1,0,1
49761_0,,,,2,1,2,3
C(C1C(C=CC(O)O1)O)(O)=O,,,5,1,2,0,2
49763_0,,,,2,1,2,3
C(C1C(C(C=CO1)O)O)(O)=O,,,5,1,1,0,1
49764_0,,,,2,1,2,3
49766_0,,,,2,1,2,3
C(C1C=CC(C(O1)O)O)(O)=O,,,5,1,1,0,1
49768_0,,,,2,1,2,3
C1(C(C=CC(CO)(O)O1)O)=O,,,5,1,1,0,1
49770_0,,,,2,1,2,3
C1(C(C(C=C(CO)O1)O)O)=O,,,5,1,1,0,1
49772_0,,,,2,1,2,3
C1(C(C(C=CO1)(CO)O)O)=O,,,5,1,1,0,1
49774_0,,,,2,1,2,3
C1(C(C(CO)=CC(O)O1)O)=O,,,5,1,1,0,1
49776_0,,,,2,1,2,3
C1(C(C(C(C(O1)=C)O)O)O)=O,,,5,1,1,0,1
49778_0,,,,2,1,2,3
C1(C(C(C(C(O)O1)O)=C)O)=O,,,5,1,2,0,2
49780_0,,,,2,1,2,3
C1C(C(COC=1C(O)=O)O)O,,,5,1,1,0,1
49782_0,,,,2,1,2,3
C(C1(C=CC(CO1)O)O)(O)=O,,,5,1,1,0,1
49784_0,,,,2,1,2,3
C1OC(CO)C(C(C(C=1)O)O)O,,,5,1,1,0,1
49786_0,,,,2,1,2,3
C1C(C(C(CO)OC(C=1)O)O)O,,,5,1,1,0,1
49788_0,,,,2,1,2,3
C1OCC(CO)(C(C(C=1)=O)O)O,,,5,1,1,0,1
49790_0,,,,2,1,2,3
C1(COC(C(C(C=1)=O)O)O)CO,,,5,1,1,0,1
49792_0,,,,2,1,2,3
C1(COC(C=CC1O)O)=O,,,5,1,1,0,1
49794_0,,,,2,1,2,3
C1(COC=CC(C1O)O)=O,,,5,1,1,0,1
49796_0,,,,2,1,2,3
C1C(C(CO)(OCC(C=1)=O)O)O,,,5,1,1,0,1
49798_0,,,,2,1,2,3
C1(COC(C=CC1O)(CO)O)=O,,,5,1,1,0,1
49800_0,,,,2,1,2,3
C1(COC(CO)=CC(C1O)O)=O,,,5,1,1,0,1
49802_0,,,,2,1,2,3
C1(C(C(C=COC1)(CO)O)O)=O,,,5,1,1,0,1
49804_0,,,,2,1,2,3
C1(COC(C=C(CO)C1O)O)=O,,,5,1,1,0,1
49806_0,,,,2,1,2,3
C1(COC(C(C(C1O)O)O)=C)=O,,,5,1,1,0,1
49808_0,,,,2,1,2,3
C1(COC(C(C(C1O)=C)O)O)=O,,,5,1,2,0,2
49810_0,,,,2,1,2,3
C1(CO)C(COC(C(C=1)=O)O)O,,,5,1,1,0,1
49812_0,,,,2,1,2,3
C1(C(COC(C(C1O)=C)O)O)=O,,,5,1,2,0,2
49814_0,,,,2,1,2,3
C1(C(C(C(OCC1O)=C)O)O)=O,,,5,1,1,0,1
49816_0,,,,2,1,2,3
C1(C(CO)OC(C=CC1O)O)=O,,,5,1,1,0,1
49818_0,,,,2,1,2,3
C1(C(C(C=COC1CO)O)O)=O,,,5,1,1,0,1
49820_0,,,,2,1,2,3
C1C(CO)(COC(C(C=1)=O)O)O,,,5,1,1,0,1
49822_0,,,,2,1,2,3
C1OCC(C(CO)(C(C=1)O)O)O,,,5,1,1,0,1
49824_0,,,,2,1,2,3
C1C(CO)(C(COC(C=1)O)O)O,,,5,1,1,0,1
49826_0,,,,2,1,2,3
C1(C(O)OCC=C(C=O)C1)=O,,,5,1,1,0,1
49828_0,,,,2,1,2,3
C(C1CCOC(C(C=1)=O)O)=O,,,5,1,1,0,1
49830_0,,,,2,1,2,3
C(C1(C=CC(CCO1)=O)O)=O,,,5,1,1,0,1
49832_0,,,,2,1,2,3
C1(CCOC(C=O)=CC1O)=O,,,5,1,1,0,1
49834_0,,,,2,1,2,3
C(C1C=CCC(C(O1)O)=O)=O,,,5,1,1,0,1
49836_0,,,,2,1,2,3
C(C1CC=CC(C(O)O1)=O)=O,,,5,1,1,0,1
49838_0,,,,2,1,2,3
C(C1(CC=CC(CO1)=O)O)=O,,,5,1,1,0,1
49840_0,,,,2,1,2,3
C(C1(C=CCC(CO1)=O)O)=O,,,5,1,1,0,1
49842_0,,,,2,1,2,3
C1(COC(C=O)=CC(C1)O)=O,,,5,1,1,0,1
49844_0,,,,2,1,2,3
C1C(C(CO)OC(C(C=1)=O)O)O,,,5,1,1,0,1
49846_0,,,,2,1,2,3
C(C1(C=CC(C(CO1)O)O)O)=O,,,5,1,1,0,1
49848_0,,,,2,1,2,3
C1C(C(C(COC=1C=O)O)O)O,,,5,1,1,0,1
49850_0,,,,2,1,2,3
C1CC(OCC(C=1C=O)=O)O,,,5,1,1,0,1
49852_0,,,,2,1,2,3
C(C1C(COC(C=C1)O)=O)=O,,,5,1,1,0,1
49854_0,,,,2,1,2,3
C(C1C(COC=CC1O)=O)=O,,,5,1,1,0,1
49856_0,,,,2,1,2,3
C(C1C(C=CCC(O1)O)=O)=O,,,5,1,1,0,1
49858_0,,,,2,1,2,3
C1(C(C=O)OC(C=CC1)O)=O,,,5,1,1,0,1
49860_0,,,,2,1,2,3
C(C1C(CC(C=CO1)O)=O)=O,,,5,1,1,0,1
49862_0,,,,2,1,2,3
C1(C=C(C=O)C(O)OCC1)=O,,,5,1,1,0,1
49864_0,,,,2,1,2,3
C1(CCOC=C(C=O)C1O)=O,,,5,1,1,0,1
49866_0,,,,2,1,2,3
C(C1C=CC(COC1O)=O)=O,,,5,1,1,0,1
49868_0,,,,2,1,2,3
C1(COC(C(C=O)=CC1)O)=O,,,5,1,1,0,1
49870_0,,,,2,1,2,3
C1(COC=C(C=O)C(C1)O)=O,,,5,1,1,0,1
49872_0,,,,2,1,2,3
C1C(C(COC(C=1C=O)O)O)O,,,5,1,1,0,1
49874_0,,,,2,1,2,3
C1OCC(C(C(C=1C=O)O)O)O,,,5,1,1,0,1
49876_0,,,,2,1,2,3
C1(CCOC=CC1O)=O,,,5,1,1,0,1
49878_0,,,,2,1,2,3
C1C(O)OCCC(C=1)=O,,,5,1,1,0,1
49880_0,,,,2,1,2,3
C1C(COC(C(C=1CO)=O)O)O,,,5,1,1,0,1
49882_0,,,,2,1,2,3
C=C1C(C(O)OCC(C1O)O)=O,,,5,1,2,0,2
49884_0,,,,2,1,2,3
C1C(COC(C(C=1C=O)O)O)O,,,5,1,1,0,1
49886_0,,,,2,1,2,3
C1C(O)OCC(C(C=1C=O)O)O,,,5,1,2,0,2
49888_0,,,,2,1,2,3
C1(COC=CC(C1)O)=O,,,5,1,1,0,1
49890_0,,,,2,1,2,3
C1(COC(C=CC1)O)=O,,,5,1,1,0,1
49892_0,,,,2,1,2,3
C1CC(OCC(C=1)=O)O,,,5,1,1,0,1
49894_0,,,,2,1,2,3
C1OC(CO)C(C(C(C=1)=O)O)O,,,5,1,1,0,1
49896_0,,,,2,1,2,3
C1C(CO)OC(C(C(C=1)=O)O)O,,,5,1,1,0,1
49898_0,,,,2,1,2,3
C1C(C(COC(C=1)O)O)O,,,5,1,1,0,1
49900_0,,,,2,1,2,3
C1OCC(C(C(C=1)O)O)O,,,5,1,1,0,1
49902_0,,,,2,1,2,3
C1(COC(C=CC1(CO)O)O)=O,,,5,1,1,0,1
49904_0,,,,2,1,2,3
C1(COC=CC(C1(CO)O)O)=O,,,5,1,1,0,1
49906_0,,,,2,1,2,3
C(C1(C=CC(O)OCC1O)O)=O,,,5,1,1,0,1
49908_0,,,,2,1,2,3
C(C1(C(COC=CC1O)O)O)=O,,,5,1,1,0,1
49910_0,,,,2,1,2,3
C(C1(COC(C=CC1O)O)O)=O,,,5,1,2,0,2
49912_0,,,,2,1,2,3
C(C1(COC=CC(C1O)O)O)=O,,,5,1,1,0,1
49913_0,,,,2,1,2,3
49915_0,,,,2,1,2,3
C(C1(C=CC(C(O)OC1)O)O)=O,,,5,1,1,0,1
49917_0,,,,2,1,2,3
C1C(C(OCC(C=1)=O)O)(CO)O,,,5,1,1,0,1
49918_0,,,,2,1,2,3
49920_0,,,,2,1,2,3
C(C1(C=COCC(C1O)O)O)=O,,,5,1,1,0,1
49922_0,,,,2,1,2,3
C1(C(C(C=CC(O)O1)O)O)=O,,,5,1,2,0,2
49924_0,,,,2,1,2,3
C1(C(C(C(C=CO1)O)O)O)=O,,,5,1,1,0,1
49925_0,,,,2,1,2,3
49927_0,,,,2,1,2,3
C1(C(C=CC(C(O)O1)O)O)=O,,,5,1,1,0,1
49929_0,,,,2,1,2,3
C1(C(C(CO1)=CC=O)O)=O,,,5,1,2,0,2
49931_0,,,,2,1,2,3
C1(C(C(C(C=O)O1)=C)O)=O,,,5,1,2,0,2
49933_0,,,,2,1,2,3
C1(C(C(C=O)=CCO1)O)=O,,,5,1,1,0,1
49935_0,,,,2,1,2,3
C1(C(C=CC(C=O)O1)O)=O,,,5,1,1,0,1
49937_0,,,,2,1,2,3
C(C(C=O)C=CCC(C=O)=O)=O,,,5,1,1,0,1
49939_0,,,,2,1,2,3
C(CCC(C=O)=O)=C(C=O)C=O,,,5,1,1,0,1
49941_0,,,,2,1,2,3
C(C(C=O)C=C(C=O)CC=O)=O,,,5,1,1,0,1
49943_0,,,,2,1,2,3
C(C(C=C(C=O)C=O)CC=O)=O,,,5,1,1,0,1
49945_0,,,,2,1,2,3
C(C)=C(C=O)CCC(C=O)=O,,,5,1,1,0,1
49947_0,,,,2,1,2,3
C(C(C=C)CCC(C=O)=O)=O,,,5,1,2,0,2
49949_0,,,,2,1,2,3
C(C(C(C=O)=CC)CC=O)=O,,,5,1,1,0,1
49951_0,,,,2,1,2,3
C(C(C=C)C(C=O)CC=O)=O,,,5,1,2,0,2
49953_0,,,,2,1,2,3
C(CC(C)=CCC(C=O)=O)=O,,,5,1,1,0,1
49955_0,,,,2,1,2,3
C(C)(CCC(C=O)=O)=CC=O,,,5,1,1,0,1
49957_0,,,,2,1,2,3
C(CC(CCC(C=O)=O)=C)=O,,,5,1,1,0,1
49959_0,,,,2,1,2,3
C(CC(C)=C(C=O)CC=O)=O,,,5,1,1,0,1
49961_0,,,,2,1,2,3
C(C(C(C)=CC=O)CC=O)=O,,,5,1,1,0,1
49963_0,,,,2,1,2,3
C(C(C(CC=O)=C)CC=O)=O,,,5,1,1,0,1
49965_0,,,,2,1,2,3
C(CCCC(C=O)=O)=CC=O,,,5,1,2,0,2
49967_0,,,,2,1,2,3
C(CC=CCCC(C=O)=O)=O,,,5,1,1,0,1
49969_0,,,,2,1,2,3
C(CC(C=O)CC=CC=O)=O,,,5,1,2,0,2
49971_0,,,,2,1,2,3
C(C(C=CCC=O)CC=O)=O,,,5,1,1,0,1
49972_0,,,,2,1,2,3
49974_0,,,,2,1,2,3
C(C(C=C)(CCC(C=O)=O)O)=O,,,5,1,3,0,3
49976_0,,,,2,1,2,3
C(CC(C=O)=C(C=O)C(C)O)=O,,,5,1,1,0,1
49977_0,,,,2,1,2,3
49979_0,,,,2,1,2,3
C(C(C(C)=CCC(C=O)=O)O)=O,,,5,1,1,0,1
49981_0,,,,2,1,2,3
C(C(C(CCC(C=O)=O)=C)O)=O,,,5,1,2,0,2
49983_0,,,,2,1,2,3
C(CC(C=O)=C(C)C(C=O)O)=O,,,5,1,1,0,1
49985_0,,,,2,1,2,3
C(C(C(C(C=O)O)=C)CC=O)=O,,,5,1,2,0,2
49987_0,,,,2,1,2,3
C(C(C=CCCC(C=O)=O)O)=O,,,5,1,2,0,2
49989_0,,,,2,1,2,3
C(C(C=CC(C=O)O)CC=O)=O,,,5,1,2,0,2
49991_0,,,,2,1,2,3
C(CC=CCC(C=O)=O)=O,,,5,1,1,0,1
49993_0,,,,2,1,2,3
C(CCC(C=O)=O)=CC=O,,,5,1,1,0,1
49995_0,,,,2,1,2,3
C(CC(C=O)=CCC=O)=O,,,5,1,1,0,1
49997_0,,,,2,1,2,3
C(C(C=CC=O)CC=O)=O,,,5,1,1,0,1
49999_0,,,,2,1,2,3
C=C(C=O)CCC(C=O)=O,,,5,1,1,0,1
50001_0,,,,2,1,2,3
C(C(C(C=O)=C)CC=O)=O,,,5,1,1,0,1
50002_0,,,,2,1,2,3
50004_0,,,,2,1,2,3
C(C(CCC(C=O)=O)O)=CC=O,,,5,1,3,0,3
50005_0,,,,2,1,2,3
50006_0,,,,2,1,2,3
50008_0,,,,2,1,2,3
C(CC(CO)=CCC(C=O)=O)=O,,,5,1,1,0,1
50010_0,,,,2,1,2,3
C(CO)(CCC(C=O)=O)=CC=O,,,5,1,2,0,2
50012_0,,,,2,1,2,3
C(CC(CO)=C(C=O)CC=O)=O,,,5,1,1,0,1
50014_0,,,,2,1,2,3
C(C(C(CO)=CC=O)CC=O)=O,,,5,1,2,0,2
50016_0,,,,2,1,2,3
C(CO)=C(C=O)CCC(C=O)=O,,,5,1,2,0,2
50018_0,,,,2,1,2,3
C(C(C(C=O)=CCO)CC=O)=O,,,5,1,2,0,2
50020_0,,,,2,1,2,3
C(CC(C=O)=O)=C(C(O)=O)C,,,5,1,1,0,1
50022_0,,,,2,1,2,3
C=C(C(O)=O)CCC(C=O)=O,,,5,1,1,0,1
50024_0,,,,2,1,2,3
C(CC(C=O)=C(C(O)=O)C)=O,,,5,1,1,0,1
50026_0,,,,2,1,2,3
C(C(C(C(O)=O)=C)CC=O)=O,,,5,1,1,0,1
50028_0,,,,2,1,2,3
C(CCC(C=O)=O)=CC(O)=O,,,5,1,1,0,1
50030_0,,,,2,1,2,3
C(C(C=CC(O)=O)CC=O)=O,,,5,1,1,0,1
50032_0,,,,2,1,2,3
C(CC(C=O)=O)=CC(C=O)=O,,,5,1,1,0,1
50034_0,,,,2,1,2,3
C(CC(C=O)=CC(C=O)=O)=O,,,5,1,2,0,2
50036_0,,,,2,1,2,3
C(CC(C=O)=O)=CC(C(C)=O)=O,,,5,1,1,0,1
50038_0,,,,2,1,2,3
C(CC(C=O)=CC(C(C)=O)=O)=O,,,5,1,1,0,1
50040_0,,,,2,1,2,3
C(CCC(C=O)=O)=CC(C=O)=O,,,5,1,2,0,2
50042_0,,,,2,1,2,3
C(C(C=CC(C=O)=O)CC=O)=O,,,5,1,2,0,2
50044_0,,,,2,1,2,3
C(CC(C=O)=O)=C(C(C=O)=O)C,,,5,1,1,0,1
50046_0,,,,2,1,2,3
C=C(C(C=O)=O)CCC(C=O)=O,,,5,1,2,0,2
50048_0,,,,2,1,2,3
C(CC(C=O)=C(C(C=O)=O)C)=O,,,5,1,1,0,1
50050_0,,,,2,1,2,3
C(C(C(C(C=O)=O)=C)CC=O)=O,,,5,1,2,0,2
50052_0,,,,2,1,2,3
C(CC(C=O)=O)=CC(C)=O,,,5,1,1,0,1
50054_0,,,,2,1,2,3
C(CC(C=O)=CC(C)=O)=O,,,5,1,1,0,1
50056_0,,,,2,1,2,3
C(CC(C=O)=O)=CC(CCO)=O,,,5,1,1,0,1
50058_0,,,,2,1,2,3
C=CC(C(CCC(C=O)=O)O)=O,,,5,1,2,0,2
50060_0,,,,2,1,2,3
C(CC(C=O)=CC(CCO)=O)=O,,,5,1,1,0,1
50061_0,,,,2,1,2,3
50063_0,,,,2,1,2,3
C(CO)(CC=CCC(C=O)=O)=O,,,5,1,1,0,1
50065_0,,,,2,1,2,3
C(CCC(C=O)=O)=CC(CO)=O,,,5,1,1,0,1
50067_0,,,,2,1,2,3
C(CC(C=O)=CCC(CO)=O)=O,,,5,1,1,0,1
50069_0,,,,2,1,2,3
C(C(C=CC(CO)=O)CC=O)=O,,,5,1,1,0,1
50071_0,,,,2,1,2,3
C=C(C(CO)=O)CCC(C=O)=O,,,5,1,1,0,1
50073_0,,,,2,1,2,3
C(C(C(C(CO)=O)=C)CC=O)=O,,,5,1,1,0,1
50075_0,,,,2,1,2,3
C(CC(C=O)=O)=C(C=O)CCO,,,5,1,1,0,1
50076_0,,,,2,1,2,3
50077_0,,,,2,1,2,3
50079_0,,,,2,1,2,3
C(CC(C=O)=C(C=O)CCO)=O,,,5,1,1,0,1
50080_0,,,,2,1,2,3
50081_0,,,,2,1,2,3
50083_0,,,,2,1,2,3
C(C(CC=CCC(C=O)=O)O)=O,,,5,1,1,0,1
50084_0,,,,2,1,2,3
50085_0,,,,2,1,2,3
50087_0,,,,2,1,2,3
C(CC(C=O)=CCC(C=O)O)=O,,,5,1,1,0,1
50088_0,,,,2,1,2,3
50089_0,,,,2,1,2,3
50090_0,,,,2,1,2,3
50091_0,,,,2,1,2,3
50092_0,,,,2,1,2,3
50093_0,,,,2,1,2,3
50095_0,,,,2,1,2,3
C(CC(C=O)=O)=C(C(C)=O)CO,,,5,1,1,0,1
50097_0,,,,2,1,2,3
C(CC(C=O)=C(C(C)=O)CO)=O,,,5,1,1,0,1
50098_0,,,,2,1,2,3
50099_0,,,,2,1,2,3
50101_0,,,,2,1,2,3
C(CC(C=O)=O)=CC,,,5,1,1,0,1
50103_0,,,,2,1,2,3
C=CCCC(C=O)=O,,,5,1,2,0,2
50105_0,,,,2,1,2,3
C(CC(C=O)=CC)=O,,,5,1,1,0,1
50107_0,,,,2,1,2,3
C(C(C=C)CC=O)=O,,,5,1,2,0,2
50108_0,,,,2,1,2,3
50109_0,,,,2,1,2,3
50111_0,,,,2,1,2,3
C(CC(C=O)=O)=C1C(COC1)=O,,,5,1,1,0,1
50113_0,,,,2,1,2,3
C(CC(C=O)=C1C(COC1)=O)=O,,,5,1,1,0,1
50115_0,,,,2,1,2,3
C(CC(C=O)=O)=C1C(CCO1)=O,,,5,1,1,0,1
50117_0,,,,2,1,2,3
C(CC(C=O)=C1C(CCO1)=O)=O,,,5,1,1,0,1
50119_0,,,,2,1,2,3
C1COC(C=1CCC(C=O)=O)=O,,,5,1,1,0,1
50121_0,,,,2,1,2,3
C(C(C1C(OCC=1)=O)CC=O)=O,,,5,1,1,0,1
50123_0,,,,2,1,2,3
C1C(CCC(C=O)=O)OC(C=1)=O,,,5,1,2,0,2
50125_0,,,,2,1,2,3
C(CC(C=O)C1C=CC(O1)=O)=O,,,5,1,2,0,2
50127_0,,,,2,1,2,3
C1(CC(CO1)=CCC(C=O)=O)=O,,,5,1,1,0,1
50129_0,,,,2,1,2,3
C1(COC(C=1)=O)CCC(C=O)=O,,,5,1,1,0,1
50131_0,,,,2,1,2,3
C(CC(C=O)=C1COC(C1)=O)=O,,,5,1,1,0,1
50133_0,,,,2,1,2,3
C(C(C1COC(C=1)=O)CC=O)=O,,,5,1,1,0,1
50135_0,,,,2,1,2,3
C1OCC(C=1CCC(C=O)=O)=O,,,5,1,1,0,1
50137_0,,,,2,1,2,3
C(C(C1C(COC=1)=O)CC=O)=O,,,5,1,1,0,1
50139_0,,,,2,1,2,3
C1(COC(C1)=CCC(C=O)=O)=O,,,5,1,1,0,1
50141_0,,,,2,1,2,3
C1(CCC(C=O)=O)OCC(C=1)=O,,,5,1,1,0,1
50143_0,,,,2,1,2,3
C(CC(C=O)=C1CC(CO1)=O)=O,,,5,1,1,0,1
50145_0,,,,2,1,2,3
C(C(C1OCC(C=1)=O)CC=O)=O,,,5,1,1,0,1
50147_0,,,,2,1,2,3
C1OC(C(C=1)=O)CCC(C=O)=O,,,5,1,2,0,2
50149_0,,,,2,1,2,3
C(CC(C=O)C1C(C=CO1)=O)=O,,,5,1,2,0,2
50150_0,,,,2,1,2,3
50151_0,,,,2,1,2,3
50152_0,,,,2,1,2,3
50153_0,,,,2,1,2,3
50154_0,,,,2,1,2,3
50155_0,,,,2,1,2,3
50157_0,,,,2,1,2,3
C(CC(C=O)=O)=C(CO)CO,,,5,1,1,0,1
50158_0,,,,2,1,2,3
50160_0,,,,2,1,2,3
C(CC(C=O)=O)=C(C(O)=O)CO,,,5,1,1,0,1
50161_0,,,,2,1,2,3
50162_0,,,,2,1,2,3
50164_0,,,,2,1,2,3
C(CC(C=O)=O)=CCC(C=O)=O,,,5,1,1,0,1
50165_0,,,,2,1,2,3
50167_0,,,,2,1,2,3
C(C(CCC(C=O)=O)=CC=O)=O,,,5,1,2,0,2
50169_0,,,,2,1,2,3
C(CC(C=O)=CCC(C=O)=O)=O,,,5,1,2,0,2
50170_0,,,,2,1,2,3
50172_0,,,,2,1,2,3
C(CC(C=CCC(C=O)=O)=O)=O,,,5,1,1,0,1
50174_0,,,,2,1,2,3
C(CC(C=O)=O)=C(C=O)C(C)=O,,,5,1,1,0,1
50175_0,,,,2,1,2,3
50176_0,,,,2,1,2,3
50177_0,,,,2,1,2,3
50179_0,,,,2,1,2,3
C(CC(C=O)=C(C(O)=O)CO)=O,,,5,1,1,0,1
50181_0,,,,2,1,2,3
C(C(C=C(C=O)CC=O)O)(O)=O,,,5,1,1,0,1
50182_0,,,,2,1,2,3
50183_0,,,,2,1,2,3
50184_0,,,,2,1,2,3
50186_0,,,,2,1,2,3
C(C(C(C=O)=CC=O)CC=O)=O,,,5,1,2,0,2
50188_0,,,,2,1,2,3
C(CC(C=O)=C(C=O)CC=O)=O,,,5,1,1,0,1
50189_0,,,,2,1,2,3
50191_0,,,,2,1,2,3
C(CC(C=O)=CC(CC=O)=O)=O,,,5,1,1,0,1
50193_0,,,,2,1,2,3
C(CC(C=O)=C(C=O)C(C)=O)=O,,,5,1,1,0,1
50194_0,,,,2,2,1,3
50195_0,,,,2,2,1,3
50197_0,,,,2,2,1,3
C(C1(C(C(C(C1O)O)O)O)O)O,,,5,1,5,0,5
50198_0,,,,2,2,1,3
50199_0,,,,2,2,1,3
50200_0,,,,2,2,1,3
50201_0,,,,2,2,1,3
50202_0,,,,2,2,1,3
50203_0,,,,2,2,1,3
50204_0,,,,2,2,1,3
50205_0,,,,2,2,1,3
50206_0,,,,2,2,1,3
50207_0,,,,2,2,1,3
50208_0,,,,2,2,1,3
50209_0,,,,2,2,1,3
50210_0,,,,2,2,1,3
50212_0,,,,2,2,1,3
C(C(C1C(C(C(C1O)O)O)O)O)=O,,,5,1,1,0,1
50213_0,,,,2,2,1,3
50214_0,,,,2,2,1,3
50215_0,,,,2,2,1,3
50216_0,,,,2,2,1,3
50217_0,,,,2,2,1,3
50218_0,,,,2,2,1,3
50219_0,,,,2,2,1,3
50220_0,,,,2,2,1,3
50221_0,,,,2,2,1,3
50223_0,,,,2,2,1,3
C1C(C(C(C1O)O)O)O,,,5,1,1,0,1
50225_0,,,,2,2,1,3
C1(C(C(C(C1O)O)O)O)O,,,5,1,1,0,1
50226_0,,,,2,2,1,3
50227_0,,,,2,2,1,3
50228_0,,,,2,2,1,3
50229_0,,,,2,2,1,3
50230_0,,,,2,2,1,3
50231_0,,,,2,2,1,3
50232_0,,,,2,2,1,3
50233_0,,,,2,2,1,3
50234_0,,,,2,2,1,3
50235_0,,,,2,2,1,3
50236_0,,,,2,2,1,3
50237_0,,,,2,2,1,3
50238_0,,,,2,2,1,3
50239_0,,,,2,2,1,3
50240_0,,,,2,2,1,3
50241_0,,,,2,2,1,3
50243_0,,,,2,2,1,3
C1C(C(C(C(C1O)O)O)O)O,,,5,1,1,0,1
50245_0,,,,2,2,1,3
C1(C(C(C(C(C1O)O)O)O)O)O,,,5,1,1,0,1
50246_0,,,,2,2,1,3
50247_0,,,,2,2,1,3
50248_0,,,,2,2,1,3
50249_0,,,,2,2,1,3
50250_0,,,,2,2,1,3
50251_0,,,,2,2,1,3
50252_0,,,,2,2,1,3
50253_0,,,,2,2,1,3
50254_0,,,,2,2,1,3
50255_0,,,,2,2,1,3
50256_0,,,,2,2,1,3
50257_0,,,,2,2,1,3
50258_0,,,,2,2,1,3
50259_0,,,,2,2,1,3
50260_0,,,,2,2,1,3
50261_0,,,,2,2,1,3
50262_0,,,,2,2,1,3
50263_0,,,,2,2,1,3
50264_0,,,,2,2,1,3
50265_0,,,,2,2,1,3
50266_0,,,,2,2,1,3
50267_0,,,,2,2,1,3
50268_0,,,,2,2,1,3
50269_0,,,,2,2,1,3
50270_0,,,,2,2,1,3
50271_0,,,,2,2,1,3
50272_0,,,,2,2,1,3
50273_0,,,,2,2,1,3
50274_0,,,,2,2,1,3
50275_0,,,,2,2,1,3
50276_0,,,,2,2,1,3
50277_0,,,,2,2,1,3
50278_0,,,,2,2,1,3
50279_0,,,,2,2,1,3
50280_0,,,,2,2,1,3
50281_0,,,,2,2,1,3
50282_0,,,,2,2,1,3
50283_0,,,,2,2,1,3
50284_0,,,,2,2,1,3
50285_0,,,,2,2,1,3
50286_0,,,,2,2,1,3
50287_0,,,,2,2,1,3
50288_0,,,,2,2,1,3
50289_0,,,,2,2,1,3
50290_0,,,,2,2,1,3
50291_0,,,,2,2,1,3
50292_0,,,,2,2,1,3
50293_0,,,,2,2,1,3
50294_0,,,,2,2,1,3
50295_0,,,,2,2,1,3
50296_0,,,,2,2,1,3
50297_0,,,,2,2,1,3
50298_0,,,,2,2,1,3
50299_0,,,,2,2,1,3
50300_0,,,,2,2,1,3
50301_0,,,,2,2,1,3
50302_0,,,,2,2,1,3
50303_0,,,,2,2,1,3
50304_0,,,,2,2,1,3
50305_0,,,,2,2,1,3
50306_0,,,,2,2,1,3
50307_0,,,,2,2,1,3
50308_0,,,,2,2,1,3
50309_0,,,,2,2,1,3
50310_0,,,,2,2,1,3
50311_0,,,,2,2,1,3
50312_0,,,,2,2,1,3
50313_0,,,,2,2,1,3
50314_0,,,,2,2,1,3
50315_0,,,,2,2,1,3
50316_0,,,,2,2,1,3
50317_0,,,,2,2,1,3
50318_0,,,,2,2,1,3
50319_0,,,,2,2,1,3
50320_0,,,,2,2,1,3
50321_0,,,,2,2,1,3
50322_0,,,,2,2,1,3
50323_0,,,,2,2,1,3
50324_0,,,,2,2,1,3
50325_0,,,,2,2,1,3
50326_0,,,,2,2,1,3
50327_0,,,,2,2,1,3
50328_0,,,,2,2,1,3
50329_0,,,,2,2,1,3
50330_0,,,,2,2,1,3
50331_0,,,,2,2,1,3
50332_0,,,,2,2,1,3
50333_0,,,,2,2,1,3
50334_0,,,,2,2,1,3
50335_0,,,,2,2,1,3
50336_0,,,,2,2,1,3
50337_0,,,,2,2,1,3
50338_0,,,,2,2,1,3
50339_0,,,,2,2,1,3
50340_0,,,,2,2,1,3
50341_0,,,,2,2,1,3
50342_0,,,,2,2,1,3
50343_0,,,,2,2,1,3
50345_0,,,,2,2,1,3
CC(CC(C(C(CO)O)O)O)O,,,5,1,2,0,2
50346_0,,,,2,2,1,3
50347_0,,,,2,2,1,3
50348_0,,,,2,2,1,3
50349_0,,,,2,2,1,3
50350_0,,,,2,2,1,3
50351_0,,,,2,2,1,3
50352_0,,,,2,2,1,3
50353_0,,,,2,2,1,3
50354_0,,,,2,2,1,3
50355_0,,,,2,2,1,3
50356_0,,,,2,2,1,3
50357_0,,,,2,2,1,3
50358_0,,,,2,2,1,3
50359_0,,,,2,2,1,3
50360_0,,,,2,2,1,3
50361_0,,,,2,2,1,3
50362_0,,,,2,2,1,3
50363_0,,,,2,2,1,3
50364_0,,,,2,2,1,3
50365_0,,,,2,2,1,3
50366_0,,,,2,2,1,3
50368_0,,,,2,2,1,3
CC(C(C(C(C(CO)O)O)O)O)O,,,5,1,2,0,2
50369_0,,,,2,2,1,3
50370_0,,,,2,2,1,3
50371_0,,,,2,2,1,3
50372_0,,,,2,2,1,3
50373_0,,,,2,2,1,3
50374_0,,,,2,2,1,3
50375_0,,,,2,2,1,3
50376_0,,,,2,2,1,3
50377_0,,,,2,2,1,3
50378_0,,,,2,2,1,3
50379_0,,,,2,2,1,3
50380_0,,,,2,2,1,3
50381_0,,,,2,2,1,3
50382_0,,,,2,2,1,3
50383_0,,,,2,2,1,3
50384_0,,,,2,2,1,3
50385_0,,,,2,2,1,3
50387_0,,,,2,2,1,3
C1C(C(C(O)O1)O)(C(CCO)O)O,,,5,1,1,0,1
50388_0,,,,2,2,1,3
50390_0,,,,2,2,1,3
C(CC(C1C(C(C(O)O1)O)O)O)O,,,5,1,1,0,1
50391_0,,,,2,2,1,3
50392_0,,,,2,2,1,3
50393_0,,,,2,2,1,3
50394_0,,,,2,2,1,3
50395_0,,,,2,2,1,3
50396_0,,,,2,2,1,3
50397_0,,,,2,2,1,3
50398_0,,,,2,2,1,3
50399_0,,,,2,2,1,3
50400_0,,,,2,2,1,3
50401_0,,,,2,2,1,3
50402_0,,,,2,2,1,3
50403_0,,,,2,2,1,3
50404_0,,,,2,2,1,3
50405_0,,,,2,2,1,3
50406_0,,,,2,2,1,3
50407_0,,,,2,2,1,3
50408_0,,,,2,2,1,3
50409_0,,,,2,2,1,3
50410_0,,,,2,2,1,3
50411_0,,,,2,2,1,3
50412_0,,,,2,2,1,3
50413_0,,,,2,2,1,3
50414_0,,,,2,2,1,3
50415_0,,,,2,2,1,3
50416_0,,,,2,2,1,3
50417_0,,,,2,2,1,3
50418_0,,,,2,2,1,3
50419_0,,,,2,2,1,3
50420_0,,,,2,2,1,3
50421_0,,,,2,2,1,3
50422_0,,,,2,2,1,3
50423_0,,,,2,2,1,3
50425_0,,,,2,2,1,3
C(C(CC(C(C(CO)O)O)O)O)O,,,5,1,2,0,2
50426_0,,,,2,2,1,3
50427_0,,,,2,2,1,3
50428_0,,,,2,2,1,3
50429_0,,,,2,2,1,3
50430_0,,,,2,2,1,3
50431_0,,,,2,2,1,3
50432_0,,,,2,2,1,3
50433_0,,,,2,2,1,3
50434_0,,,,2,2,1,3
50435_0,,,,2,2,1,3
50436_0,,,,2,2,1,3
50437_0,,,,2,2,1,3
50438_0,,,,2,2,1,3
50439_0,,,,2,2,1,3
50440_0,,,,2,2,1,3
50441_0,,,,2,2,1,3
50442_0,,,,2,2,1,3
50443_0,,,,2,2,1,3
50444_0,,,,2,2,1,3
50445_0,,,,2,2,1,3
50446_0,,,,2,2,1,3
50447_0,,,,2,2,1,3
50448_0,,,,2,2,1,3
50449_0,,,,2,2,1,3
50450_0,,,,2,2,1,3
50451_0,,,,2,2,1,3
50452_0,,,,2,2,1,3
50453_0,,,,2,2,1,3
50454_0,,,,2,2,1,3
50455_0,,,,2,2,1,3
50456_0,,,,2,2,1,3
50457_0,,,,2,2,1,3
50458_0,,,,2,2,1,3
50459_0,,,,2,2,1,3
50460_0,,,,2,2,1,3
50461_0,,,,2,2,1,3
50462_0,,,,2,2,1,3
50463_0,,,,2,2,1,3
50464_0,,,,2,2,1,3
50465_0,,,,2,2,1,3
50466_0,,,,2,2,1,3
50467_0,,,,2,2,1,3
50468_0,,,,2,2,1,3
50469_0,,,,2,2,1,3
50470_0,,,,2,2,1,3
50471_0,,,,2,2,1,3
50472_0,,,,2,2,1,3
50473_0,,,,2,2,1,3
50474_0,,,,2,2,1,3
50475_0,,,,2,2,1,3
50476_0,,,,2,2,1,3
50477_0,,,,2,2,1,3
50478_0,,,,2,2,1,3
50479_0,,,,2,2,1,3
50480_0,,,,2,2,1,3
50481_0,,,,2,2,1,3
50482_0,,,,2,2,1,3
50483_0,,,,2,2,1,3
50484_0,,,,2,2,1,3
50485_0,,,,2,2,1,3
50486_0,,,,2,2,1,3
50487_0,,,,2,2,1,3
50488_0,,,,2,2,1,3
50489_0,,,,2,2,1,3
50490_0,,,,2,2,1,3
50491_0,,,,2,2,1,3
50492_0,,,,2,2,1,3
50494_0,,,,2,2,1,3
CC(CO)(C(C(CO)O)O)O,,,5,1,2,0,2
50495_0,,,,2,2,1,3
50497_0,,,,2,2,1,3
CC(CO)(C(C(C(CO)O)O)O)O,,,5,1,2,0,2
50498_0,,,,2,2,1,3
50499_0,,,,2,2,1,3
50500_0,,,,2,2,1,3
50501_0,,,,2,2,1,3
50503_0,,,,2,2,1,3
C1C(C(C(O)O1)O)(C(C)(CO)O)O,,,5,1,1,0,1
50504_0,,,,2,2,1,3
50506_0,,,,2,2,1,3
CC(CO)(C1C(C(C(O)O1)O)O)O,,,5,1,1,0,1
50507_0,,,,2,2,1,3
50508_0,,,,2,2,1,3
50509_0,,,,2,2,1,3
50510_0,,,,2,2,1,3
50511_0,,,,2,2,1,3
50512_0,,,,2,2,1,3
50513_0,,,,2,2,1,3
50514_0,,,,2,2,1,3
50515_0,,,,2,2,1,3
50516_0,,,,2,2,1,3
50517_0,,,,2,2,1,3
50518_0,,,,2,2,1,3
50520_0,,,,2,2,1,3
CC(C(CO)O)(C(C(CO)O)O)O,,,5,1,2,0,2
50521_0,,,,2,2,1,3
50522_0,,,,2,2,1,3
50524_0,,,,2,2,1,3
C1C(C(CO1)O)(C(C(CO)O)O)O,,,5,1,2,0,2
50526_0,,,,2,2,1,3
C1CC(C(O)O1)(C(C(CO)O)O)O,,,5,1,3,0,3
50528_0,,,,2,2,1,3
C1C(CC(O)O1)(C(C(CO)O)O)O,,,5,1,3,0,3
50529_0,,,,2,2,1,3
50530_0,,,,2,2,1,3
50531_0,,,,2,2,1,3
50532_0,,,,2,2,1,3
50533_0,,,,2,2,1,3
50534_0,,,,2,2,1,3
50535_0,,,,2,2,1,3
50536_0,,,,2,2,1,3
50537_0,,,,2,2,1,3
50538_0,,,,2,2,1,3
50539_0,,,,2,2,1,3
50540_0,,,,2,2,1,3
50541_0,,,,2,2,1,3
50542_0,,,,2,2,1,3
50543_0,,,,2,2,1,3
50544_0,,,,2,2,1,3
50545_0,,,,2,2,1,3
50546_0,,,,2,2,1,3
50547_0,,,,2,2,1,3
50548_0,,,,2,2,1,3
50549_0,,,,2,2,1,3
50550_0,,,,2,2,1,3
50551_0,,,,2,2,1,3
50552_0,,,,2,2,1,3
50553_0,,,,2,2,1,3
50554_0,,,,2,2,1,3
50555_0,,,,2,2,1,3
50556_0,,,,2,2,1,3
50557_0,,,,2,2,1,3
50558_0,,,,2,2,1,3
50559_0,,,,2,2,1,3
50560_0,,,,2,2,1,3
50561_0,,,,2,2,1,3
50562_0,,,,2,2,1,3
50563_0,,,,2,2,1,3
50564_0,,,,2,2,1,3
50565_0,,,,2,2,1,3
50566_0,,,,2,2,1,3
50567_0,,,,2,2,1,3
50568_0,,,,2,2,1,3
50569_0,,,,2,2,1,3
50570_0,,,,2,2,1,3
50571_0,,,,2,2,1,3
50572_0,,,,2,2,1,3
50573_0,,,,2,2,1,3
50574_0,,,,2,2,1,3
50575_0,,,,2,2,1,3
50576_0,,,,2,2,1,3
50577_0,,,,2,2,1,3
50578_0,,,,2,2,1,3
50579_0,,,,2,2,1,3
50580_0,,,,2,2,1,3
50581_0,,,,2,2,1,3
50582_0,,,,2,2,1,3
50583_0,,,,2,2,1,3
50584_0,,,,2,2,1,3
50585_0,,,,2,2,1,3
50586_0,,,,2,2,1,3
50587_0,,,,2,2,1,3
50588_0,,,,2,2,1,3
50589_0,,,,2,2,1,3
50590_0,,,,2,2,1,3
50591_0,,,,2,2,1,3
50592_0,,,,2,2,1,3
50593_0,,,,2,2,1,3
50594_0,,,,2,2,1,3
50595_0,,,,2,2,1,3
50596_0,,,,2,2,1,3
50597_0,,,,2,2,1,3
50598_0,,,,2,2,1,3
50599_0,,,,2,2,1,3
50600_0,,,,2,2,1,3
50601_0,,,,2,2,1,3
50602_0,,,,2,2,1,3
50603_0,,,,2,2,1,3
50605_0,,,,2,2,1,3
C(C(C1(COC(C1O)O)O)O)(O)=O,,,5,1,1,0,1
50606_0,,,,2,2,1,3
50608_0,,,,2,2,1,3
C(C(C1C(C(C(O)O1)O)O)O)(O)=O,,,5,1,2,0,2
50609_0,,,,2,2,1,3
50610_0,,,,2,2,1,3
50611_0,,,,2,2,1,3
50612_0,,,,2,2,1,3
50613_0,,,,2,2,1,3
50614_0,,,,2,2,1,3
50615_0,,,,2,2,1,3
50616_0,,,,2,2,1,3
50617_0,,,,2,2,1,3
50618_0,,,,2,2,1,3
50619_0,,,,2,2,1,3
50620_0,,,,2,2,1,3
50621_0,,,,2,2,1,3
50622_0,,,,2,2,1,3
50623_0,,,,2,2,1,3
50624_0,,,,2,2,1,3
50625_0,,,,2,2,1,3
50626_0,,,,2,2,1,3
50627_0,,,,2,2,1,3
50628_0,,,,2,2,1,3
50629_0,,,,2,2,1,3
50630_0,,,,2,2,1,3
50631_0,,,,2,2,1,3
50632_0,,,,2,2,1,3
50633_0,,,,2,2,1,3
50634_0,,,,2,2,1,3
50635_0,,,,2,2,1,3
50636_0,,,,2,2,1,3
50637_0,,,,2,2,1,3
50638_0,,,,2,2,1,3
50639_0,,,,2,2,1,3
50640_0,,,,2,2,1,3
50641_0,,,,2,2,1,3
50642_0,,,,2,2,1,3
50643_0,,,,2,2,1,3
50644_0,,,,2,2,1,3
50645_0,,,,2,2,1,3
50646_0,,,,2,2,1,3
50647_0,,,,2,2,1,3
50648_0,,,,2,2,1,3
50649_0,,,,2,2,1,3
50650_0,,,,2,2,1,3
50651_0,,,,2,2,1,3
50652_0,,,,2,2,1,3
50653_0,,,,2,2,1,3
50654_0,,,,2,2,1,3
50655_0,,,,2,2,1,3
50656_0,,,,2,2,1,3
50657_0,,,,2,2,1,3
50658_0,,,,2,2,1,3
50659_0,,,,2,2,1,3
50660_0,,,,2,2,1,3
50661_0,,,,2,2,1,3
50662_0,,,,2,2,1,3
50663_0,,,,2,2,1,3
50664_0,,,,2,2,1,3
50665_0,,,,2,2,1,3
50666_0,,,,2,2,1,3
50667_0,,,,2,2,1,3
50668_0,,,,2,2,1,3
50669_0,,,,2,2,1,3
50670_0,,,,2,2,1,3
50671_0,,,,2,2,1,3
50672_0,,,,2,2,1,3
50673_0,,,,2,2,1,3
50674_0,,,,2,2,1,3
50675_0,,,,2,2,1,3
50676_0,,,,2,2,1,3
50677_0,,,,2,2,1,3
50678_0,,,,2,2,1,3
50679_0,,,,2,2,1,3
50680_0,,,,2,2,1,3
50681_0,,,,2,2,1,3
50682_0,,,,2,2,1,3
50683_0,,,,2,2,1,3
50684_0,,,,2,2,1,3
50685_0,,,,2,2,1,3
50686_0,,,,2,2,1,3
50687_0,,,,2,2,1,3
50688_0,,,,2,2,1,3
50689_0,,,,2,2,1,3
50690_0,,,,2,2,1,3
50691_0,,,,2,2,1,3
50692_0,,,,2,2,1,3
50693_0,,,,2,2,1,3
50695_0,,,,2,2,1,3
C(C(C)(C1(COC(C1O)O)O)O)=O,,,5,1,2,0,2
50696_0,,,,2,2,1,3
50698_0,,,,2,2,1,3
C(C)(C(C1(COC(C1O)O)O)O)=O,,,5,1,2,0,2
50699_0,,,,2,2,1,3
50700_0,,,,2,2,1,3
50702_0,,,,2,2,1,3
C1C(C(C)O)(C(C(O)O1)O)O,,,5,1,2,0,2
50703_0,,,,2,2,1,3
50704_0,,,,2,2,1,3
50705_0,,,,2,2,1,3
50706_0,,,,2,2,1,3
50707_0,,,,2,2,1,3
50708_0,,,,2,2,1,3
50709_0,,,,2,2,1,3
50710_0,,,,2,2,1,3
50711_0,,,,2,2,1,3
50712_0,,,,2,2,1,3
50713_0,,,,2,2,1,3
50714_0,,,,2,2,1,3
50715_0,,,,2,2,1,3
50716_0,,,,2,2,1,3
50718_0,,,,2,2,1,3
C(C(C1C(C(C(O)O1)O)O)O)=O,,,5,1,2,0,2
50720_0,,,,2,2,1,3
C(C(C)(C1C(C(C(O)O1)O)O)O)=O,,,5,1,2,0,2
50721_0,,,,2,2,1,3
50723_0,,,,2,2,1,3
C(C)(C(C1C(C(C(O)O1)O)O)O)=O,,,5,1,3,0,3
50724_0,,,,2,2,1,3
50726_0,,,,2,2,1,3
C(CC(C1C(C(C(O)O1)O)O)O)=O,,,5,1,3,0,3
50728_0,,,,2,2,1,3
CC(C1C(C(C(O)O1)O)O)O,,,5,1,2,0,2
50729_0,,,,2,2,1,3
50730_0,,,,2,2,1,3
50731_0,,,,2,2,1,3
50732_0,,,,2,2,1,3
50733_0,,,,2,2,1,3
50734_0,,,,2,2,1,3
50735_0,,,,2,2,1,3
50736_0,,,,2,2,1,3
50737_0,,,,2,2,1,3
50738_0,,,,2,2,1,3
50739_0,,,,2,2,1,3
50740_0,,,,2,2,1,3
50741_0,,,,2,2,1,3
50742_0,,,,2,2,1,3
50743_0,,,,2,2,1,3
50744_0,,,,2,2,1,3
50745_0,,,,2,2,1,3
50746_0,,,,2,2,1,3
50747_0,,,,2,2,1,3
50748_0,,,,2,2,1,3
50749_0,,,,2,2,1,3
50750_0,,,,2,2,1,3
50751_0,,,,2,2,1,3
50752_0,,,,2,2,1,3
50753_0,,,,2,2,1,3
50754_0,,,,2,2,1,3
50755_0,,,,2,2,1,3
50756_0,,,,2,2,1,3
50757_0,,,,2,2,1,3
50758_0,,,,2,2,1,3
50759_0,,,,2,2,1,3
50760_0,,,,2,2,1,3
50761_0,,,,2,2,1,3
50762_0,,,,2,2,1,3
50763_0,,,,2,2,1,3
50764_0,,,,2,2,1,3
50765_0,,,,2,2,1,3
50766_0,,,,2,2,1,3
50767_0,,,,2,2,1,3
50768_0,,,,2,2,1,3
50769_0,,,,2,2,1,3
50770_0,,,,2,2,1,3
50771_0,,,,2,2,1,3
50772_0,,,,2,2,1,3
50773_0,,,,2,2,1,3
50774_0,,,,2,2,1,3
50775_0,,,,2,2,1,3
50777_0,,,,2,2,1,3
C(OCC(CO)O)=O,,,5,1,1,0,1
50778_0,,,,2,2,1,3
50779_0,,,,2,2,1,3
50780_0,,,,2,2,1,3
50781_0,,,,2,2,1,3
50782_0,,,,2,2,1,3
50783_0,,,,2,2,1,3
50784_0,,,,2,2,1,3
50785_0,,,,2,2,1,3
50786_0,,,,2,2,1,3
50787_0,,,,2,2,1,3
50788_0,,,,2,2,1,3
50789_0,,,,2,2,1,3
50790_0,,,,2,2,1,3
50791_0,,,,2,2,1,3
50792_0,,,,2,2,1,3
50793_0,,,,2,2,1,3
50794_0,,,,2,2,1,3
50795_0,,,,2,2,1,3
50796_0,,,,2,2,1,3
50797_0,,,,2,2,1,3
50798_0,,,,2,2,1,3
50799_0,,,,2,2,1,3
50800_0,,,,2,2,1,3
50801_0,,,,2,2,1,3
50802_0,,,,2,2,1,3
50803_0,,,,2,2,1,3
50804_0,,,,2,2,1,3
50805_0,,,,2,2,1,3
50806_0,,,,2,2,1,3
50807_0,,,,2,2,1,3
50808_0,,,,2,2,1,3
50809_0,,,,2,2,1,3
50810_0,,,,2,2,1,3
50811_0,,,,2,2,1,3
50812_0,,,,2,2,1,3
50813_0,,,,2,2,1,3
50814_0,,,,2,2,1,3
50815_0,,,,2,2,1,3
50816_0,,,,2,2,1,3
50817_0,,,,2,2,1,3
50818_0,,,,2,2,1,3
50819_0,,,,2,2,1,3
50820_0,,,,2,2,1,3
50821_0,,,,2,2,1,3
50822_0,,,,2,2,1,3
50823_0,,,,2,2,1,3
50824_0,,,,2,2,1,3
50825_0,,,,2,2,1,3
50826_0,,,,2,2,1,3
50827_0,,,,2,2,1,3
50828_0,,,,2,2,1,3
50829_0,,,,2,2,1,3
50830_0,,,,2,2,1,3
50831_0,,,,2,2,1,3
50832_0,,,,2,2,1,3
50833_0,,,,2,2,1,3
50834_0,,,,2,2,1,3
50835_0,,,,2,2,1,3
50836_0,,,,2,2,1,3
50837_0,,,,2,2,1,3
50838_0,,,,2,2,1,3
50839_0,,,,2,2,1,3
50840_0,,,,2,2,1,3
50841_0,,,,2,2,1,3
50842_0,,,,2,2,1,3
50843_0,,,,2,2,1,3
50844_0,,,,2,2,1,3
50845_0,,,,2,2,1,3
50846_0,,,,2,2,1,3
50847_0,,,,2,2,1,3
50848_0,,,,2,2,1,3
50849_0,,,,2,2,1,3
50850_0,,,,2,2,1,3
50851_0,,,,2,2,1,3
50852_0,,,,2,2,1,3
50853_0,,,,2,2,1,3
50854_0,,,,2,2,1,3
50855_0,,,,2,2,1,3
50856_0,,,,2,2,1,3
50857_0,,,,2,2,1,3
50858_0,,,,2,2,1,3
50859_0,,,,2,2,1,3
50860_0,,,,2,2,1,3
50861_0,,,,2,2,1,3
50862_0,,,,2,2,1,3
50863_0,,,,2,2,1,3
50864_0,,,,2,2,1,3
50865_0,,,,2,2,1,3
50866_0,,,,2,2,1,3
50867_0,,,,2,2,1,3
50868_0,,,,2,2,1,3
50869_0,,,,2,2,1,3
50870_0,,,,2,2,1,3
50871_0,,,,2,2,1,3
50872_0,,,,2,2,1,3
50873_0,,,,2,2,1,3
50874_0,,,,2,2,1,3
50875_0,,,,2,2,1,3
50876_0,,,,2,2,1,3
50877_0,,,,2,2,1,3
50878_0,,,,2,2,1,3
50879_0,,,,2,2,1,3
50880_0,,,,2,2,1,3
50881_0,,,,2,2,1,3
50882_0,,,,2,2,1,3
50883_0,,,,2,2,1,3
50884_0,,,,2,2,1,3
50886_0,,,,2,2,1,3
C1C(C(C(C(CCO)O)(O)O1)O)O,,,5,1,1,0,1
50887_0,,,,2,2,1,3
50888_0,,,,2,2,1,3
50889_0,,,,2,2,1,3
50891_0,,,,2,2,1,3
CC(CO)(C1(C(C(CO1)O)O)O)O,,,5,1,1,0,1
50893_0,,,,2,2,1,3
C(C(C1(C(C(CO1)O)O)O)O)(O)=O,,,5,1,1,0,1
50895_0,,,,2,2,1,3
C(C(C1(C(C(CO1)O)O)O)O)=O,,,5,1,2,0,2
50897_0,,,,2,2,1,3
C(C(C)(C1(C(C(CO1)O)O)O)O)=O,,,5,1,2,0,2
50898_0,,,,2,2,1,3
50900_0,,,,2,2,1,3
C(C)(C(C1(C(C(CO1)O)O)O)O)=O,,,5,1,2,0,2
50901_0,,,,2,2,1,3
50902_0,,,,2,2,1,3
50904_0,,,,2,2,1,3
CC(C1(C(C(CO1)O)O)O)O,,,5,1,2,0,2
50905_0,,,,2,2,1,3
50906_0,,,,2,2,1,3
50907_0,,,,2,2,1,3
50908_0,,,,2,2,1,3
50909_0,,,,2,2,1,3
50910_0,,,,2,2,1,3
50911_0,,,,2,2,1,3
50912_0,,,,2,2,1,3
50913_0,,,,2,2,1,3
50914_0,,,,2,2,1,3
50915_0,,,,2,2,1,3
50916_0,,,,2,2,1,3
50917_0,,,,2,2,1,3
50918_0,,,,2,2,1,3
50919_0,,,,2,2,1,3
50920_0,,,,2,2,1,3
50921_0,,,,2,2,1,3
50922_0,,,,2,2,1,3
50923_0,,,,2,2,1,3
50924_0,,,,2,2,1,3
50925_0,,,,2,2,1,3
50926_0,,,,2,2,1,3
50927_0,,,,2,2,1,3
50928_0,,,,2,2,1,3
50929_0,,,,2,2,1,3
50930_0,,,,2,2,1,3
50931_0,,,,2,2,1,3
50932_0,,,,2,2,1,3
50933_0,,,,2,2,1,3
50934_0,,,,2,2,1,3
50935_0,,,,2,2,1,3
50936_0,,,,2,2,1,3
50937_0,,,,2,2,1,3
50938_0,,,,2,2,1,3
50939_0,,,,2,2,1,3
50940_0,,,,2,2,1,3
50941_0,,,,2,2,1,3
50942_0,,,,2,2,1,3
50943_0,,,,2,2,1,3
50944_0,,,,2,2,1,3
50945_0,,,,2,2,1,3
50946_0,,,,2,2,1,3
50947_0,,,,2,2,1,3
50948_0,,,,2,2,1,3
50949_0,,,,2,2,1,3
50950_0,,,,2,2,1,3
50951_0,,,,2,2,1,3
50952_0,,,,2,2,1,3
50953_0,,,,2,2,1,3
50954_0,,,,2,2,1,3
50955_0,,,,2,2,1,3
50956_0,,,,2,2,1,3
50957_0,,,,2,2,1,3
50959_0,,,,2,2,1,3
C(C(CO)=O)(C(CO)(CCO)O)=O,,,5,1,1,0,1
50960_0,,,,2,2,1,3
50961_0,,,,2,2,1,3
50962_0,,,,2,2,1,3
50963_0,,,,2,2,1,3
50964_0,,,,2,2,1,3
50965_0,,,,2,2,1,3
50966_0,,,,2,2,1,3
50967_0,,,,2,2,1,3
50968_0,,,,2,2,1,3
50969_0,,,,2,2,1,3
50970_0,,,,2,2,1,3
50971_0,,,,2,2,1,3
50972_0,,,,2,2,1,3
50973_0,,,,2,2,1,3
50974_0,,,,2,2,1,3
50975_0,,,,2,2,1,3
50976_0,,,,2,2,1,3
50977_0,,,,2,2,1,3
50978_0,,,,2,2,1,3
50979_0,,,,2,2,1,3
50980_0,,,,2,2,1,3
50981_0,,,,2,2,1,3
50982_0,,,,2,2,1,3
50983_0,,,,2,2,1,3
50984_0,,,,2,2,1,3
50985_0,,,,2,2,1,3
50986_0,,,,2,2,1,3
50987_0,,,,2,2,1,3
50988_0,,,,2,2,1,3
50989_0,,,,2,2,1,3
50990_0,,,,2,2,1,3
50991_0,,,,2,2,1,3
50992_0,,,,2,2,1,3
50993_0,,,,2,2,1,3
50994_0,,,,2,2,1,3
50995_0,,,,2,2,1,3
50996_0,,,,2,2,1,3
50997_0,,,,2,2,1,3
50998_0,,,,2,2,1,3
50999_0,,,,2,2,1,3
51000_0,,,,2,2,1,3
51001_0,,,,2,2,1,3
51002_0,,,,2,2,1,3
51003_0,,,,2,2,1,3
51004_0,,,,2,2,1,3
51005_0,,,,2,2,1,3
51006_0,,,,2,2,1,3
51007_0,,,,2,2,1,3
51008_0,,,,2,2,1,3
51009_0,,,,2,2,1,3
51010_0,,,,2,2,1,3
51011_0,,,,2,2,1,3
51012_0,,,,2,2,1,3
51013_0,,,,2,2,1,3
51014_0,,,,2,2,1,3
51015_0,,,,2,2,1,3
51016_0,,,,2,2,1,3
51017_0,,,,2,2,1,3
51018_0,,,,2,2,1,3
51019_0,,,,2,2,1,3
51020_0,,,,2,2,1,3
51021_0,,,,2,2,1,3
51022_0,,,,2,2,1,3
51023_0,,,,2,2,1,3
51024_0,,,,2,2,1,3
51025_0,,,,2,2,1,3
51026_0,,,,2,2,1,3
51027_0,,,,2,2,1,3
51028_0,,,,2,2,1,3
51029_0,,,,2,2,1,3
51030_0,,,,2,2,1,3
51031_0,,,,2,2,1,3
51032_0,,,,2,2,1,3
51033_0,,,,2,2,1,3
51034_0,,,,2,2,1,3
51035_0,,,,2,2,1,3
51036_0,,,,2,2,1,3
51037_0,,,,2,2,1,3
51038_0,,,,2,2,1,3
51039_0,,,,2,2,1,3
51040_0,,,,2,2,1,3
51041_0,,,,2,2,1,3
51042_0,,,,2,2,1,3
51043_0,,,,2,2,1,3
51044_0,,,,2,2,1,3
51045_0,,,,2,2,1,3
51046_0,,,,2,2,1,3
51047_0,,,,2,2,1,3
51048_0,,,,2,2,1,3
51049_0,,,,2,2,1,3
51050_0,,,,2,2,1,3
51051_0,,,,2,2,1,3
51052_0,,,,2,2,1,3
51053_0,,,,2,2,1,3
51054_0,,,,2,2,1,3
51055_0,,,,2,2,1,3
51056_0,,,,2,2,1,3
51057_0,,,,2,2,1,3
51058_0,,,,2,2,1,3
51059_0,,,,2,2,1,3
51060_0,,,,2,2,1,3
51061_0,,,,2,2,1,3
51062_0,,,,2,2,1,3
51063_0,,,,2,2,1,3
51064_0,,,,2,2,1,3
51065_0,,,,2,2,1,3
51066_0,,,,2,2,1,3
51067_0,,,,2,2,1,3
51068_0,,,,2,2,1,3
51069_0,,,,2,2,1,3
51070_0,,,,2,2,1,3
51071_0,,,,2,2,1,3
51072_0,,,,2,2,1,3
51073_0,,,,2,2,1,3
51074_0,,,,2,2,1,3
51075_0,,,,2,2,1,3
51076_0,,,,2,2,1,3
51077_0,,,,2,2,1,3
51078_0,,,,2,2,1,3
51079_0,,,,2,2,1,3
51080_0,,,,2,2,1,3
51081_0,,,,2,2,1,3
51082_0,,,,2,2,1,3
51083_0,,,,2,2,1,3
51084_0,,,,2,2,1,3
51085_0,,,,2,2,1,3
51086_0,,,,2,2,1,3
51087_0,,,,2,2,1,3
51088_0,,,,2,2,1,3
51089_0,,,,2,2,1,3
51090_0,,,,2,2,1,3
51091_0,,,,2,2,1,3
51092_0,,,,2,2,1,3
51093_0,,,,2,2,1,3
51094_0,,,,2,2,1,3
51095_0,,,,2,2,1,3
51096_0,,,,2,2,1,3
51097_0,,,,2,2,1,3
51098_0,,,,2,2,1,3
51099_0,,,,2,2,1,3
51100_0,,,,2,2,1,3
51101_0,,,,2,2,1,3
51102_0,,,,2,2,1,3
51103_0,,,,2,2,1,3
51104_0,,,,2,2,1,3
51105_0,,,,2,2,1,3
51106_0,,,,2,2,1,3
51107_0,,,,2,2,1,3
51108_0,,,,2,2,1,3
51109_0,,,,2,2,1,3
51110_0,,,,2,2,1,3
51111_0,,,,2,2,1,3
51112_0,,,,2,2,1,3
51113_0,,,,2,2,1,3
51114_0,,,,2,2,1,3
51115_0,,,,2,2,1,3
51116_0,,,,2,2,1,3
51117_0,,,,2,2,1,3
51118_0,,,,2,2,1,3
51119_0,,,,2,2,1,3
51120_0,,,,2,2,1,3
51121_0,,,,2,2,1,3
51122_0,,,,2,2,1,3
51123_0,,,,2,2,1,3
51124_0,,,,2,2,1,3
51125_0,,,,2,2,1,3
51126_0,,,,2,2,1,3
51127_0,,,,2,2,1,3
51128_0,,,,2,2,1,3
51129_0,,,,2,2,1,3
51130_0,,,,2,2,1,3
51131_0,,,,2,2,1,3
51132_0,,,,2,2,1,3
51133_0,,,,2,2,1,3
51134_0,,,,2,2,1,3
51135_0,,,,2,2,1,3
51136_0,,,,2,2,1,3
51137_0,,,,2,2,1,3
51138_0,,,,2,2,1,3
51139_0,,,,2,2,1,3
51140_0,,,,2,2,1,3
51141_0,,,,2,2,1,3
51142_0,,,,2,2,1,3
51143_0,,,,2,2,1,3
51144_0,,,,2,2,1,3
51145_0,,,,2,2,1,3
51146_0,,,,2,2,1,3
51147_0,,,,2,2,1,3
51148_0,,,,2,2,1,3
51149_0,,,,2,2,1,3
51150_0,,,,2,2,1,3
51151_0,,,,2,2,1,3
51152_0,,,,2,2,1,3
51153_0,,,,2,2,1,3
51154_0,,,,2,2,1,3
51155_0,,,,2,2,1,3
51156_0,,,,2,2,1,3
51157_0,,,,2,2,1,3
51158_0,,,,2,2,1,3
51159_0,,,,2,2,1,3
51160_0,,,,2,2,1,3
51161_0,,,,2,2,1,3
51162_0,,,,2,2,1,3
51163_0,,,,2,2,1,3
51164_0,,,,2,2,1,3
51165_0,,,,2,2,1,3
51166_0,,,,2,2,1,3
51167_0,,,,2,2,1,3
51168_0,,,,2,2,1,3
51169_0,,,,2,2,1,3
51170_0,,,,2,2,1,3
51171_0,,,,2,2,1,3
51172_0,,,,2,2,1,3
51173_0,,,,2,2,1,3
51174_0,,,,2,2,1,3
51175_0,,,,2,2,1,3
51176_0,,,,2,2,1,3
51177_0,,,,2,2,1,3
51178_0,,,,2,2,1,3
51179_0,,,,2,2,1,3
51180_0,,,,2,2,1,3
51181_0,,,,2,2,1,3
51182_0,,,,2,2,1,3
51183_0,,,,2,2,1,3
51184_0,,,,2,2,1,3
51185_0,,,,2,2,1,3
51186_0,,,,2,2,1,3
51187_0,,,,2,2,1,3
51188_0,,,,2,2,1,3
51189_0,,,,2,2,1,3
51190_0,,,,2,2,1,3
51191_0,,,,2,2,1,3
51192_0,,,,2,2,1,3
51193_0,,,,2,2,1,3
51194_0,,,,2,2,1,3
51195_0,,,,2,2,1,3
51196_0,,,,2,2,1,3
51197_0,,,,2,2,1,3
51198_0,,,,2,2,1,3
51199_0,,,,2,2,1,3
51200_0,,,,2,2,1,3
51201_0,,,,2,2,1,3
51202_0,,,,2,2,1,3
51203_0,,,,2,2,1,3
51204_0,,,,2,2,1,3
51205_0,,,,2,2,1,3
51206_0,,,,2,2,1,3
51207_0,,,,2,2,1,3
51208_0,,,,2,2,1,3
51209_0,,,,2,2,1,3
51210_0,,,,2,2,1,3
51211_0,,,,2,2,1,3
51212_0,,,,2,2,1,3
51213_0,,,,2,2,1,3
51214_0,,,,2,2,1,3
51215_0,,,,2,2,1,3
51216_0,,,,2,2,1,3
51217_0,,,,2,2,1,3
51218_0,,,,2,2,1,3
51219_0,,,,2,2,1,3
51220_0,,,,2,2,1,3
51221_0,,,,2,2,1,3
51222_0,,,,2,2,1,3
51223_0,,,,2,2,1,3
51224_0,,,,2,2,1,3
51225_0,,,,2,2,1,3
51226_0,,,,2,2,1,3
51227_0,,,,2,2,1,3
51228_0,,,,2,2,1,3
51229_0,,,,2,2,1,3
51230_0,,,,2,2,1,3
51231_0,,,,2,2,1,3
51232_0,,,,2,2,1,3
51233_0,,,,2,2,1,3
51234_0,,,,2,2,1,3
51235_0,,,,2,2,1,3
51236_0,,,,2,2,1,3
51237_0,,,,2,2,1,3
51238_0,,,,2,2,1,3
51239_0,,,,2,2,1,3
51240_0,,,,2,2,1,3
51241_0,,,,2,2,1,3
51242_0,,,,2,2,1,3
51243_0,,,,2,2,1,3
51244_0,,,,2,2,1,3
51245_0,,,,2,2,1,3
51246_0,,,,2,2,1,3
51247_0,,,,2,2,1,3
51248_0,,,,2,2,1,3
51249_0,,,,2,2,1,3
51250_0,,,,2,2,1,3
51251_0,,,,2,2,1,3
51252_0,,,,2,2,1,3
51253_0,,,,2,2,1,3
51254_0,,,,2,2,1,3
51255_0,,,,2,2,1,3
51256_0,,,,2,2,1,3
51257_0,,,,2,2,1,3
51258_0,,,,2,2,1,3
51259_0,,,,2,2,1,3
51260_0,,,,2,2,1,3
51261_0,,,,2,2,1,3
51262_0,,,,2,2,1,3
51263_0,,,,2,2,1,3
51264_0,,,,2,2,1,3
51265_0,,,,2,2,1,3
51266_0,,,,2,2,1,3
51267_0,,,,2,2,1,3
51268_0,,,,2,2,1,3
51269_0,,,,2,2,1,3
51270_0,,,,2,2,1,3
51271_0,,,,2,2,1,3
51272_0,,,,2,2,1,3
51273_0,,,,2,2,1,3
51274_0,,,,2,2,1,3
51275_0,,,,2,2,1,3
51276_0,,,,2,2,1,3
51277_0,,,,2,2,1,3
51278_0,,,,2,2,1,3
51279_0,,,,2,2,1,3
51280_0,,,,2,2,1,3
51281_0,,,,2,2,1,3
51282_0,,,,2,2,1,3
51283_0,,,,2,2,1,3
51284_0,,,,2,2,1,3
51285_0,,,,2,2,1,3
51286_0,,,,2,2,1,3
51287_0,,,,2,2,1,3
51288_0,,,,2,2,1,3
51289_0,,,,2,2,1,3
51290_0,,,,2,2,1,3
51291_0,,,,2,2,1,3
51292_0,,,,2,2,1,3
51293_0,,,,2,2,1,3
51294_0,,,,2,2,1,3
51295_0,,,,2,2,1,3
51296_0,,,,2,2,1,3
51297_0,,,,2,2,1,3
51298_0,,,,2,2,1,3
51299_0,,,,2,2,1,3
51300_0,,,,2,2,1,3
51301_0,,,,2,2,1,3
51302_0,,,,2,2,1,3
51303_0,,,,2,2,1,3
51304_0,,,,2,2,1,3
51305_0,,,,2,2,1,3
51306_0,,,,2,2,1,3
51307_0,,,,2,2,1,3
51308_0,,,,2,2,1,3
51309_0,,,,2,2,1,3
51310_0,,,,2,2,1,3
51311_0,,,,2,2,1,3
51312_0,,,,2,2,1,3
51313_0,,,,2,2,1,3
51314_0,,,,2,2,1,3
51315_0,,,,2,2,1,3
51316_0,,,,2,2,1,3
51317_0,,,,2,2,1,3
51318_0,,,,2,2,1,3
51319_0,,,,2,2,1,3
51320_0,,,,2,2,1,3
51321_0,,,,2,2,1,3
51322_0,,,,2,2,1,3
51323_0,,,,2,2,1,3
51324_0,,,,2,2,1,3
51325_0,,,,2,2,1,3
51326_0,,,,2,2,1,3
51327_0,,,,2,2,1,3
51328_0,,,,2,2,1,3
51329_0,,,,2,2,1,3
51330_0,,,,2,2,1,3
51331_0,,,,2,2,1,3
51332_0,,,,2,2,1,3
51333_0,,,,2,2,1,3
51334_0,,,,2,2,1,3
51335_0,,,,2,2,1,3
51336_0,,,,2,2,1,3
51337_0,,,,2,2,1,3
51338_0,,,,2,2,1,3
51339_0,,,,2,2,1,3
51340_0,,,,2,2,1,3
51341_0,,,,2,2,1,3
51342_0,,,,2,2,1,3
51343_0,,,,2,2,1,3
51344_0,,,,2,2,1,3
51345_0,,,,2,2,1,3
51346_0,,,,2,2,1,3
51347_0,,,,2,2,1,3
51348_0,,,,2,2,1,3
51349_0,,,,2,2,1,3
51350_0,,,,2,2,1,3
51351_0,,,,2,2,1,3
51352_0,,,,2,2,1,3
51353_0,,,,2,2,1,3
51354_0,,,,2,2,1,3
51355_0,,,,2,2,1,3
51356_0,,,,2,2,1,3
51357_0,,,,2,2,1,3
51358_0,,,,2,2,1,3
51359_0,,,,2,2,1,3
51360_0,,,,2,2,1,3
51361_0,,,,2,2,1,3
51362_0,,,,2,2,1,3
51363_0,,,,2,2,1,3
51364_0,,,,2,2,1,3
51365_0,,,,2,2,1,3
51366_0,,,,2,2,1,3
51367_0,,,,2,2,1,3
51368_0,,,,2,2,1,3
51369_0,,,,2,2,1,3
51370_0,,,,2,2,1,3
51371_0,,,,2,2,1,3
51372_0,,,,2,2,1,3
51373_0,,,,2,2,1,3
51374_0,,,,2,2,1,3
51375_0,,,,2,2,1,3
51376_0,,,,2,2,1,3
51377_0,,,,2,2,1,3
51378_0,,,,2,2,1,3
51379_0,,,,2,2,1,3
51380_0,,,,2,2,1,3
51381_0,,,,2,2,1,3
51382_0,,,,2,2,1,3
51383_0,,,,2,2,1,3
51384_0,,,,2,2,1,3
51385_0,,,,2,2,1,3
51386_0,,,,2,2,1,3
51387_0,,,,2,2,1,3
51388_0,,,,2,2,1,3
51389_0,,,,2,2,1,3
51390_0,,,,2,2,1,3
51391_0,,,,2,2,1,3
51392_0,,,,2,2,1,3
51393_0,,,,2,2,1,3
51394_0,,,,2,2,1,3
51395_0,,,,2,2,1,3
51396_0,,,,2,2,1,3
51397_0,,,,2,2,1,3
51398_0,,,,2,2,1,3
51399_0,,,,2,2,1,3
51400_0,,,,2,2,1,3
51401_0,,,,2,2,1,3
51402_0,,,,2,2,1,3
51403_0,,,,2,2,1,3
51404_0,,,,2,2,1,3
51405_0,,,,2,2,1,3
51406_0,,,,2,2,1,3
51407_0,,,,2,2,1,3
51408_0,,,,2,2,1,3
51409_0,,,,2,2,1,3
51410_0,,,,2,2,1,3
51411_0,,,,2,2,1,3
51412_0,,,,2,2,1,3
51413_0,,,,2,2,1,3
51414_0,,,,2,2,1,3
51415_0,,,,2,2,1,3
51416_0,,,,2,2,1,3
51417_0,,,,2,2,1,3
51418_0,,,,2,2,1,3
51419_0,,,,2,2,1,3
51420_0,,,,2,2,1,3
51421_0,,,,2,2,1,3
51422_0,,,,2,2,1,3
51423_0,,,,2,2,1,3
51424_0,,,,2,2,1,3
51425_0,,,,2,2,1,3
51426_0,,,,2,2,1,3
51427_0,,,,2,2,1,3
51428_0,,,,2,2,1,3
51429_0,,,,2,2,1,3
51430_0,,,,2,2,1,3
51431_0,,,,2,2,1,3
51432_0,,,,2,2,1,3
51433_0,,,,2,2,1,3
51434_0,,,,2,2,1,3
51435_0,,,,2,2,1,3
51436_0,,,,2,2,1,3
51437_0,,,,2,2,1,3
51438_0,,,,2,2,1,3
51439_0,,,,2,2,1,3
51440_0,,,,2,2,1,3
51441_0,,,,2,2,1,3
51442_0,,,,2,2,1,3
51443_0,,,,2,2,1,3
51444_0,,,,2,2,1,3
51445_0,,,,2,2,1,3
51446_0,,,,2,2,1,3
51447_0,,,,2,2,1,3
51448_0,,,,2,2,1,3
51449_0,,,,2,2,1,3
51450_0,,,,2,2,1,3
51451_0,,,,2,2,1,3
51452_0,,,,2,2,1,3
51453_0,,,,2,2,1,3
51454_0,,,,2,2,1,3
51455_0,,,,2,2,1,3
51456_0,,,,2,2,1,3
51457_0,,,,2,2,1,3
51458_0,,,,2,2,1,3
51459_0,,,,2,2,1,3
51460_0,,,,2,2,1,3
51461_0,,,,2,2,1,3
51462_0,,,,2,2,1,3
51463_0,,,,2,2,1,3
51464_0,,,,2,2,1,3
51465_0,,,,2,2,1,3
51466_0,,,,2,2,1,3
51467_0,,,,2,2,1,3
51468_0,,,,2,2,1,3
51469_0,,,,2,2,1,3
51470_0,,,,2,2,1,3
51471_0,,,,2,2,1,3
51472_0,,,,2,2,1,3
51473_0,,,,2,2,1,3
51474_0,,,,2,2,1,3
51475_0,,,,2,2,1,3
51476_0,,,,2,2,1,3
51477_0,,,,2,2,1,3
51478_0,,,,2,2,1,3
51479_0,,,,2,2,1,3
51480_0,,,,2,2,1,3
51481_0,,,,2,2,1,3
51482_0,,,,2,2,1,3
51483_0,,,,2,2,1,3
51484_0,,,,2,2,1,3
51485_0,,,,2,2,1,3
51486_0,,,,2,2,1,3
51487_0,,,,2,2,1,3
51488_0,,,,2,2,1,3
51489_0,,,,2,2,1,3
51490_0,,,,2,2,1,3
51491_0,,,,2,2,1,3
51492_0,,,,2,2,1,3
51493_0,,,,2,2,1,3
51494_0,,,,2,2,1,3
51495_0,,,,2,2,1,3
51496_0,,,,2,2,1,3
51497_0,,,,2,2,1,3
51498_0,,,,2,2,1,3
51499_0,,,,2,2,1,3
51500_0,,,,2,2,1,3
51501_0,,,,2,2,1,3
51502_0,,,,2,2,1,3
51503_0,,,,2,2,1,3
51504_0,,,,2,2,1,3
51505_0,,,,2,2,1,3
51506_0,,,,2,2,1,3
51507_0,,,,2,2,1,3
51508_0,,,,2,2,1,3
51509_0,,,,2,2,1,3
51510_0,,,,2,2,1,3
51511_0,,,,2,2,1,3
51512_0,,,,2,2,1,3
51513_0,,,,2,2,1,3
51514_0,,,,2,2,1,3
51515_0,,,,2,2,1,3
51516_0,,,,2,2,1,3
51517_0,,,,2,2,1,3
51518_0,,,,2,2,1,3
51519_0,,,,2,2,1,3
51520_0,,,,2,2,1,3
51521_0,,,,2,2,1,3
51522_0,,,,2,2,1,3
51523_0,,,,2,2,1,3
51524_0,,,,2,2,1,3
51525_0,,,,2,2,1,3
51526_0,,,,2,2,1,3
51527_0,,,,2,2,1,3
51528_0,,,,2,2,1,3
51529_0,,,,2,2,1,3
51530_0,,,,2,2,1,3
51531_0,,,,2,2,1,3
51532_0,,,,2,2,1,3
51533_0,,,,2,2,1,3
51534_0,,,,2,2,1,3
51535_0,,,,2,2,1,3
51536_0,,,,2,2,1,3
51537_0,,,,2,2,1,3
51538_0,,,,2,2,1,3
51539_0,,,,2,2,1,3
51540_0,,,,2,2,1,3
51541_0,,,,2,2,1,3
51542_0,,,,2,2,1,3
51543_0,,,,2,2,1,3
51544_0,,,,2,2,1,3
51545_0,,,,2,2,1,3
51546_0,,,,2,2,1,3
51547_0,,,,2,2,1,3
51548_0,,,,2,2,1,3
51549_0,,,,2,2,1,3
51550_0,,,,2,2,1,3
51551_0,,,,2,2,1,3
51552_0,,,,2,2,1,3
51553_0,,,,2,2,1,3
51554_0,,,,2,2,1,3
51555_0,,,,2,2,1,3
51556_0,,,,2,2,1,3
51557_0,,,,2,2,1,3
51558_0,,,,2,2,1,3
51560_0,,,,2,2,1,3
C(C1C(C(C(O1)O)O)O)=O,,,5,1,2,0,2
51562_0,,,,2,2,1,3
C(C1C(CO)(C(C(O1)O)O)O)=O,,,5,1,3,0,3
51563_0,,,,2,2,1,3
51564_0,,,,2,2,1,3
51565_0,,,,2,2,1,3
51566_0,,,,2,2,1,3
51568_0,,,,2,2,1,3
C(C1(C)C(C(C(O1)O)O)O)=O,,,5,1,2,0,2
51570_0,,,,2,2,1,3
C(C1(C)C(CO)(C(C(O1)O)O)O)=O,,,5,1,3,0,3
51571_0,,,,2,2,1,3
51573_0,,,,2,2,1,3
C(C1C(CO)(C(C)(C(O1)O)O)O)=O,,,5,1,2,0,2
51574_0,,,,2,2,1,3
51575_0,,,,2,2,1,3
51576_0,,,,2,2,1,3
51578_0,,,,2,2,1,3
C(C)(C1C(CO)(C(C(O1)O)O)O)=O,,,5,1,3,0,3
51579_0,,,,2,2,1,3
51580_0,,,,2,2,1,3
51582_0,,,,2,2,1,3
C(C1C(CO)(C(C(C)(O1)O)O)O)=O,,,5,1,2,0,2
51583_0,,,,2,2,1,3
51584_0,,,,2,2,1,3
51585_0,,,,2,2,1,3
51586_0,,,,2,2,1,3
51588_0,,,,2,2,1,3
C(C1(CCO)C(C(C(O1)O)O)O)=O,,,5,1,2,0,2
51589_0,,,,2,2,1,3
51590_0,,,,2,2,1,3
51591_0,,,,2,2,1,3
51592_0,,,,2,2,1,3
51593_0,,,,2,2,1,3
51594_0,,,,2,2,1,3
51595_0,,,,2,2,1,3
51597_0,,,,2,2,1,3
C(C(CC1C(C(C(O)O1)O)O)O)=O,,,5,1,2,0,2
51598_0,,,,2,2,1,3
51600_0,,,,2,2,1,3
C(CO)(CC1C(C(C(O)O1)O)O)=O,,,5,1,2,0,2
51601_0,,,,2,2,1,3
51602_0,,,,2,2,1,3
51604_0,,,,2,2,1,3
C(CC1(CO)C(C(C(O)O1)O)O)=O,,,5,1,2,0,2
51605_0,,,,2,2,1,3
51606_0,,,,2,2,1,3
51607_0,,,,2,2,1,3
51609_0,,,,2,2,1,3
C(C(C1(C)C(C(C(O)O1)O)O)O)=O,,,5,1,2,0,2
51611_0,,,,2,2,1,3
CC1C(C(C(O)O1)O)O,,,5,1,2,0,2
51613_0,,,,2,2,1,3
C(CC1C(CO)(C(C(O)O1)O)O)=O,,,5,1,3,0,3
51614_0,,,,2,2,1,3
51615_0,,,,2,2,1,3
51616_0,,,,2,2,1,3
51617_0,,,,2,2,1,3
51618_0,,,,2,2,1,3
51619_0,,,,2,2,1,3
51620_0,,,,2,2,1,3
51621_0,,,,2,2,1,3
51622_0,,,,2,2,1,3
51623_0,,,,2,2,1,3
51624_0,,,,2,2,1,3
51625_0,,,,2,2,1,3
51626_0,,,,2,2,1,3
51627_0,,,,2,2,1,3
51629_0,,,,2,2,1,3
CC1C(CO)(C(C(O)O1)O)O,,,5,1,3,0,3
51630_0,,,,2,2,1,3
51631_0,,,,2,2,1,3
51632_0,,,,2,2,1,3
51633_0,,,,2,2,1,3
51634_0,,,,2,2,1,3
51635_0,,,,2,2,1,3
51636_0,,,,2,2,1,3
51637_0,,,,2,2,1,3
51638_0,,,,2,2,1,3
51639_0,,,,2,2,1,3
51640_0,,,,2,2,1,3
51641_0,,,,2,2,1,3
51642_0,,,,2,2,1,3
51643_0,,,,2,2,1,3
51644_0,,,,2,2,1,3
51645_0,,,,2,2,1,3
51647_0,,,,2,2,1,3
C(C1C(C(C(C(O1)O)O)O)O)=O,,,5,1,4,0,4
51648_0,,,,2,2,1,3
51649_0,,,,2,2,1,3
51650_0,,,,2,2,1,3
51651_0,,,,2,2,1,3
51652_0,,,,2,2,1,3
51654_0,,,,2,2,1,3
C(C1(C)C(C(C(C(O1)O)O)O)O)=O,,,5,1,3,0,3
51656_0,,,,2,2,1,3
C(C1C(C(C(C)(C(O1)O)O)O)O)=O,,,5,1,2,0,2
51657_0,,,,2,2,1,3
51658_0,,,,2,2,1,3
51659_0,,,,2,2,1,3
51661_0,,,,2,2,1,3
C(C)(C1C(C(C(C(O1)O)O)O)O)=O,,,5,1,4,0,4
51662_0,,,,2,2,1,3
51664_0,,,,2,2,1,3
C(C1C(C(C(C(C)(O1)O)O)O)O)=O,,,5,1,2,0,2
51665_0,,,,2,2,1,3
51666_0,,,,2,2,1,3
51667_0,,,,2,2,1,3
51669_0,,,,2,2,1,3
C(CC1C(C(C(C(O)O1)O)O)O)=O,,,5,1,4,0,4
51670_0,,,,2,2,1,3
51671_0,,,,2,2,1,3
51672_0,,,,2,2,1,3
51673_0,,,,2,2,1,3
51675_0,,,,2,2,1,3
C(C1C(C)(C(C(C(O1)O)O)O)O)=O,,,5,1,2,0,2
51676_0,,,,2,2,1,3
51678_0,,,,2,2,1,3
C(C1C(CO)(C(CC(O1)O)O)O)=O,,,5,1,2,0,2
51679_0,,,,2,2,1,3
51680_0,,,,2,2,1,3
51681_0,,,,2,2,1,3
51682_0,,,,2,2,1,3
51683_0,,,,2,2,1,3
51684_0,,,,2,2,1,3
51685_0,,,,2,2,1,3
51686_0,,,,2,2,1,3
51688_0,,,,2,2,1,3
CC1C(C(C(C(O)O1)O)O)O,,,5,1,3,0,3
51689_0,,,,2,2,1,3
51691_0,,,,2,2,1,3
C(C1(CCOC(C(C1O)O)O)O)=O,,,5,1,2,0,2
51692_0,,,,2,2,1,3
51694_0,,,,2,2,1,3
C(C1CC(C(C(C(O1)O)O)O)O)=O,,,5,1,2,0,2
51695_0,,,,2,2,1,3
51696_0,,,,2,2,1,3
51697_0,,,,2,2,1,3
51699_0,,,,2,2,1,3
C(C1C(C(C(CC(O1)O)O)O)O)=O,,,5,1,2,0,2
51700_0,,,,2,2,1,3
51701_0,,,,2,2,1,3
51702_0,,,,2,2,1,3
51703_0,,,,2,2,1,3
51704_0,,,,2,2,1,3
51705_0,,,,2,2,1,3
51706_0,,,,2,2,1,3
51707_0,,,,2,2,1,3
51708_0,,,,2,2,1,3
51709_0,,,,2,2,1,3
51710_0,,,,2,2,1,3
51711_0,,,,2,2,1,3
51713_0,,,,2,2,1,3
C(CC(C)(CC(C(C=O)O)O)O)=O,,,5,1,1,0,1
51714_0,,,,2,2,1,3
51715_0,,,,2,2,1,3
51716_0,,,,2,2,1,3
51717_0,,,,2,2,1,3
51719_0,,,,2,2,1,3
C(CC(CCC(C(C=O)O)O)O)=O,,,5,1,1,0,1
51720_0,,,,2,2,1,3
51721_0,,,,2,2,1,3
51722_0,,,,2,2,1,3
51723_0,,,,2,2,1,3
51724_0,,,,2,2,1,3
51725_0,,,,2,2,1,3
51726_0,,,,2,2,1,3
51727_0,,,,2,2,1,3
51728_0,,,,2,2,1,3
51729_0,,,,2,2,1,3
51730_0,,,,2,2,1,3
51731_0,,,,2,2,1,3
51732_0,,,,2,2,1,3
51733_0,,,,2,2,1,3
51734_0,,,,2,2,1,3
51735_0,,,,2,2,1,3
51736_0,,,,2,2,1,3
51737_0,,,,2,2,1,3
51738_0,,,,2,2,1,3
51739_0,,,,2,2,1,3
51740_0,,,,2,2,1,3
51741_0,,,,2,2,1,3
51742_0,,,,2,2,1,3
51743_0,,,,2,2,1,3
51744_0,,,,2,2,1,3
51745_0,,,,2,2,1,3
51746_0,,,,2,2,1,3
51747_0,,,,2,2,1,3
51748_0,,,,2,2,1,3
51749_0,,,,2,2,1,3
51750_0,,,,2,2,1,3
51751_0,,,,2,2,1,3
51752_0,,,,2,2,1,3
51753_0,,,,2,2,1,3
51754_0,,,,2,2,1,3
51755_0,,,,2,2,1,3
51757_0,,,,2,2,1,3
C(C(C(CCCO)O)O)=O,,,5,1,1,0,1
51758_0,,,,2,2,1,3
51759_0,,,,2,2,1,3
51760_0,,,,2,2,1,3
51761_0,,,,2,2,1,3
51762_0,,,,2,2,1,3
51763_0,,,,2,2,1,3
51764_0,,,,2,2,1,3
51766_0,,,,2,2,1,3
C(C(C=O)CC(C(C=O)O)O)(O)=O,,,5,1,1,0,1
51767_0,,,,2,2,1,3
51768_0,,,,2,2,1,3
51769_0,,,,2,2,1,3
51770_0,,,,2,2,1,3
51772_0,,,,2,2,1,3
C(CCC(C(C=O)O)O)(O)=O,,,5,1,2,0,2
51773_0,,,,2,2,1,3
51774_0,,,,2,2,1,3
51775_0,,,,2,2,1,3
51776_0,,,,2,2,1,3
51777_0,,,,2,2,1,3
51778_0,,,,2,2,1,3
51779_0,,,,2,2,1,3
51780_0,,,,2,2,1,3
51781_0,,,,2,2,1,3
51782_0,,,,2,2,1,3
51783_0,,,,2,2,1,3
51784_0,,,,2,2,1,3
51785_0,,,,2,2,1,3
51786_0,,,,2,2,1,3
51787_0,,,,2,2,1,3
51788_0,,,,2,2,1,3
51789_0,,,,2,2,1,3
51790_0,,,,2,2,1,3
51791_0,,,,2,2,1,3
51792_0,,,,2,2,1,3
51793_0,,,,2,2,1,3
51794_0,,,,2,2,1,3
51795_0,,,,2,2,1,3
51796_0,,,,2,2,1,3
51797_0,,,,2,2,1,3
51798_0,,,,2,2,1,3
51799_0,,,,2,2,1,3
51800_0,,,,2,2,1,3
51801_0,,,,2,2,1,3
51802_0,,,,2,2,1,3
51803_0,,,,2,2,1,3
51804_0,,,,2,2,1,3
51805_0,,,,2,2,1,3
51806_0,,,,2,2,1,3
51807_0,,,,2,2,1,3
51808_0,,,,2,2,1,3
51809_0,,,,2,2,1,3
51810_0,,,,2,2,1,3
51811_0,,,,2,2,1,3
51812_0,,,,2,2,1,3
51813_0,,,,2,2,1,3
51814_0,,,,2,2,1,3
51815_0,,,,2,2,1,3
51816_0,,,,2,2,1,3
51817_0,,,,2,2,1,3
51818_0,,,,2,2,1,3
51819_0,,,,2,2,1,3
51820_0,,,,2,2,1,3
51821_0,,,,2,2,1,3
51822_0,,,,2,2,1,3
51823_0,,,,2,2,1,3
51824_0,,,,2,2,1,3
51825_0,,,,2,2,1,3
51826_0,,,,2,2,1,3
51827_0,,,,2,2,1,3
51828_0,,,,2,2,1,3
51829_0,,,,2,2,1,3
51830_0,,,,2,2,1,3
51831_0,,,,2,2,1,3
51832_0,,,,2,2,1,3
51833_0,,,,2,2,1,3
51834_0,,,,2,2,1,3
51835_0,,,,2,2,1,3
51836_0,,,,2,2,1,3
51837_0,,,,2,2,1,3
51838_0,,,,2,2,1,3
51839_0,,,,2,2,1,3
51840_0,,,,2,2,1,3
51841_0,,,,2,2,1,3
51842_0,,,,2,2,1,3
51843_0,,,,2,2,1,3
51844_0,,,,2,2,1,3
51845_0,,,,2,2,1,3
51846_0,,,,2,2,1,3
51847_0,,,,2,2,1,3
51848_0,,,,2,2,1,3
51849_0,,,,2,2,1,3
51850_0,,,,2,2,1,3
51851_0,,,,2,2,1,3
51852_0,,,,2,2,1,3
51853_0,,,,2,2,1,3
51854_0,,,,2,2,1,3
51855_0,,,,2,2,1,3
51856_0,,,,2,2,1,3
51857_0,,,,2,2,1,3
51858_0,,,,2,2,1,3
51859_0,,,,2,2,1,3
51860_0,,,,2,2,1,3
51861_0,,,,2,2,1,3
51862_0,,,,2,2,1,3
51863_0,,,,2,2,1,3
51864_0,,,,2,2,1,3
51865_0,,,,2,2,1,3
51866_0,,,,2,2,1,3
51867_0,,,,2,2,1,3
51868_0,,,,2,2,1,3
51869_0,,,,2,2,1,3
51870_0,,,,2,2,1,3
51871_0,,,,2,2,1,3
51872_0,,,,2,2,1,3
51873_0,,,,2,2,1,3
51874_0,,,,2,2,1,3
51875_0,,,,2,2,1,3
51876_0,,,,2,2,1,3
51877_0,,,,2,2,1,3
51878_0,,,,2,2,1,3
51879_0,,,,2,2,1,3
51880_0,,,,2,2,1,3
51881_0,,,,2,2,1,3
51882_0,,,,2,2,1,3
51883_0,,,,2,2,1,3
51884_0,,,,2,2,1,3
51885_0,,,,2,2,1,3
51886_0,,,,2,2,1,3
51887_0,,,,2,2,1,3
51888_0,,,,2,2,1,3
51889_0,,,,2,2,1,3
51890_0,,,,2,2,1,3
51891_0,,,,2,2,1,3
51892_0,,,,2,2,1,3
51893_0,,,,2,2,1,3
51894_0,,,,2,2,1,3
51895_0,,,,2,2,1,3
51896_0,,,,2,2,1,3
51897_0,,,,2,2,1,3
51898_0,,,,2,2,1,3
51899_0,,,,2,2,1,3
51900_0,,,,2,2,1,3
51901_0,,,,2,2,1,3
51902_0,,,,2,2,1,3
51903_0,,,,2,2,1,3
51904_0,,,,2,2,1,3
51905_0,,,,2,2,1,3
51906_0,,,,2,2,1,3
51907_0,,,,2,2,1,3
51908_0,,,,2,2,1,3
51909_0,,,,2,2,1,3
51910_0,,,,2,2,1,3
51911_0,,,,2,2,1,3
51912_0,,,,2,2,1,3
51914_0,,,,2,2,1,3
C(C(C=O)(C(CO)CO)O)=O,,,5,1,1,0,1
51915_0,,,,2,2,1,3
51916_0,,,,2,2,1,3
51917_0,,,,2,2,1,3
51919_0,,,,2,2,1,3
C(C(C(CO)(C(CO)CO)O)=O)=O,,,5,1,1,0,1
51920_0,,,,2,2,1,3
51921_0,,,,2,2,1,3
51922_0,,,,2,2,1,3
51923_0,,,,2,2,1,3
51924_0,,,,2,2,1,3
51925_0,,,,2,2,1,3
51926_0,,,,2,2,1,3
51927_0,,,,2,2,1,3
51928_0,,,,2,2,1,3
51929_0,,,,2,2,1,3
51930_0,,,,2,2,1,3
51931_0,,,,2,2,1,3
51932_0,,,,2,2,1,3
51933_0,,,,2,2,1,3
51934_0,,,,2,2,1,3
51935_0,,,,2,2,1,3
51936_0,,,,2,2,1,3
51937_0,,,,2,2,1,3
51938_0,,,,2,2,1,3
51939_0,,,,2,2,1,3
51940_0,,,,2,2,1,3
51941_0,,,,2,2,1,3
51942_0,,,,2,2,1,3
51943_0,,,,2,2,1,3
51944_0,,,,2,2,1,3
51945_0,,,,2,2,1,3
51946_0,,,,2,2,1,3
51947_0,,,,2,2,1,3
51948_0,,,,2,2,1,3
51950_0,,,,2,2,1,3
C(C(C=O)(C(CO)C(CO)O)O)=O,,,5,1,1,0,1
51951_0,,,,2,2,1,3
51952_0,,,,2,2,1,3
51953_0,,,,2,2,1,3
51954_0,,,,2,2,1,3
51955_0,,,,2,2,1,3
51956_0,,,,2,2,1,3
51957_0,,,,2,2,1,3
51958_0,,,,2,2,1,3
51959_0,,,,2,2,1,3
51960_0,,,,2,2,1,3
51961_0,,,,2,2,1,3
51963_0,,,,2,2,1,3
C(C(C=O)(CC(CO)(CO)O)O)=O,,,5,1,1,0,1
51964_0,,,,2,2,1,3
51965_0,,,,2,2,1,3
51966_0,,,,2,2,1,3
51967_0,,,,2,2,1,3
51968_0,,,,2,2,1,3
51969_0,,,,2,2,1,3
51970_0,,,,2,2,1,3
51971_0,,,,2,2,1,3
51972_0,,,,2,2,1,3
51974_0,,,,2,2,1,3
C(C(C=O)(C(C=O)C)O)=O,,,5,1,1,0,1
51975_0,,,,2,2,1,3
51976_0,,,,2,2,1,3
51977_0,,,,2,2,1,3
51978_0,,,,2,2,1,3
51979_0,,,,2,2,1,3
51980_0,,,,2,2,1,3
51981_0,,,,2,2,1,3
51982_0,,,,2,2,1,3
51983_0,,,,2,2,1,3
51984_0,,,,2,2,1,3
51985_0,,,,2,2,1,3
51986_0,,,,2,2,1,3
51987_0,,,,2,2,1,3
51988_0,,,,2,2,1,3
51989_0,,,,2,2,1,3
51991_0,,,,2,2,1,3
C(C(C)C(C=O)(C(CO)=O)O)=O,,,5,1,1,0,1
51992_0,,,,2,2,1,3
51993_0,,,,2,2,1,3
51994_0,,,,2,2,1,3
51995_0,,,,2,2,1,3
51996_0,,,,2,2,1,3
51998_0,,,,2,2,1,3
C(C(C)C(C(C(C=O)O)=O)O)=O,,,5,1,1,0,1
51999_0,,,,2,2,1,3
52000_0,,,,2,2,1,3
52001_0,,,,2,2,1,3
52002_0,,,,2,2,1,3
52003_0,,,,2,2,1,3
52004_0,,,,2,2,1,3
52005_0,,,,2,2,1,3
52006_0,,,,2,2,1,3
52007_0,,,,2,2,1,3
52008_0,,,,2,2,1,3
52009_0,,,,2,2,1,3
52011_0,,,,2,2,1,3
C(C(C=O)(CC(C)=O)O)=O,,,5,1,1,0,1
52012_0,,,,2,2,1,3
52013_0,,,,2,2,1,3
52014_0,,,,2,2,1,3
52016_0,,,,2,2,1,3
C(CC(C(C=O)=O)(CO)O)(C)=O,,,5,1,1,0,1
52017_0,,,,2,2,1,3
52018_0,,,,2,2,1,3
52019_0,,,,2,2,1,3
52020_0,,,,2,2,1,3
52021_0,,,,2,2,1,3
52023_0,,,,2,2,1,3
C(C(C(CO)=O)(CC(C)=O)O)=O,,,5,1,1,0,1
52024_0,,,,2,2,1,3
52026_0,,,,2,2,1,3
C(C(C(C(CC(C)=O)O)=O)O)=O,,,5,1,1,0,1
52027_0,,,,2,2,1,3
52028_0,,,,2,2,1,3
52029_0,,,,2,2,1,3
52030_0,,,,2,2,1,3
52031_0,,,,2,2,1,3
52032_0,,,,2,2,1,3
52033_0,,,,2,2,1,3
52034_0,,,,2,2,1,3
52035_0,,,,2,2,1,3
52036_0,,,,2,2,1,3
52037_0,,,,2,2,1,3
52038_0,,,,2,2,1,3
52039_0,,,,2,2,1,3
52040_0,,,,2,2,1,3
52041_0,,,,2,2,1,3
52042_0,,,,2,2,1,3
52044_0,,,,2,2,1,3
C(C(CCC(C(C=O)=O)O)O)=O,,,5,1,1,0,1
52045_0,,,,2,2,1,3
52046_0,,,,2,2,1,3
52047_0,,,,2,2,1,3
52048_0,,,,2,2,1,3
52049_0,,,,2,2,1,3
52050_0,,,,2,2,1,3
52051_0,,,,2,2,1,3
52052_0,,,,2,2,1,3
52053_0,,,,2,2,1,3
52054_0,,,,2,2,1,3
52055_0,,,,2,2,1,3
52056_0,,,,2,2,1,3
52057_0,,,,2,2,1,3
52059_0,,,,2,2,1,3
C(C(C(C)C(C(C=O)=O)O)O)=O,,,5,1,1,0,1
52060_0,,,,2,2,1,3
52061_0,,,,2,2,1,3
52062_0,,,,2,2,1,3
52064_0,,,,2,2,1,3
C(C(C(CC)O)=O)=O,,,5,1,1,0,1
52065_0,,,,2,2,1,3
52066_0,,,,2,2,1,3
52067_0,,,,2,2,1,3
52068_0,,,,2,2,1,3
52069_0,,,,2,2,1,3
52070_0,,,,2,2,1,3
52071_0,,,,2,2,1,3
52072_0,,,,2,2,1,3
52074_0,,,,2,2,1,3
C(C(C=O)(CCC=O)O)=O,,,5,1,2,0,2
52075_0,,,,2,2,1,3
52076_0,,,,2,2,1,3
52077_0,,,,2,2,1,3
52078_0,,,,2,2,1,3
52079_0,,,,2,2,1,3
52081_0,,,,2,2,1,3
C(CCC(C(C=O)=O)(CO)O)=O,,,5,1,2,0,2
52082_0,,,,2,2,1,3
52083_0,,,,2,2,1,3
52084_0,,,,2,2,1,3
52085_0,,,,2,2,1,3
52086_0,,,,2,2,1,3
52087_0,,,,2,2,1,3
52088_0,,,,2,2,1,3
52089_0,,,,2,2,1,3
52090_0,,,,2,2,1,3
52092_0,,,,2,2,1,3
C(CCC(C=O)(C(CO)=O)O)=O,,,5,1,2,0,2
52093_0,,,,2,2,1,3
52094_0,,,,2,2,1,3
52095_0,,,,2,2,1,3
52096_0,,,,2,2,1,3
52097_0,,,,2,2,1,3
52099_0,,,,2,2,1,3
C(CCC(C(C(C=O)O)=O)O)=O,,,5,1,2,0,2
52100_0,,,,2,2,1,3
52101_0,,,,2,2,1,3
52102_0,,,,2,2,1,3
52103_0,,,,2,2,1,3
52104_0,,,,2,2,1,3
52105_0,,,,2,2,1,3
52106_0,,,,2,2,1,3
52107_0,,,,2,2,1,3
52109_0,,,,2,2,1,3
C(C(C=O)(C(C=O)CCO)O)=O,,,5,1,1,0,1
52110_0,,,,2,2,1,3
52112_0,,,,2,2,1,3
C(C(C=O)(CC(CCO)=O)O)=O,,,5,1,1,0,1
52113_0,,,,2,2,1,3
52114_0,,,,2,2,1,3
52115_0,,,,2,2,1,3
52116_0,,,,2,2,1,3
52117_0,,,,2,2,1,3
52119_0,,,,2,2,1,3
C(C(C=O)(CCC(C=O)O)O)=O,,,5,1,1,0,1
52120_0,,,,2,2,1,3
52121_0,,,,2,2,1,3
52122_0,,,,2,2,1,3
52124_0,,,,2,2,1,3
C(C(C=O)(CCC(CO)=O)O)=O,,,5,1,2,0,2
52125_0,,,,2,2,1,3
52126_0,,,,2,2,1,3
52127_0,,,,2,2,1,3
52129_0,,,,2,2,1,3
C(C(C=O)(C(CO)CC=O)O)=O,,,5,1,2,0,2
52130_0,,,,2,2,1,3
52132_0,,,,2,2,1,3
C(C(C=O)(CC(C(C)=O)O)O)=O,,,5,1,1,0,1
52133_0,,,,2,2,1,3
52134_0,,,,2,2,1,3
52135_0,,,,2,2,1,3
52137_0,,,,2,2,1,3
C(C(C=O)(C(C)C(C=O)O)O)=O,,,5,1,1,0,1
52138_0,,,,2,2,1,3
52139_0,,,,2,2,1,3
52140_0,,,,2,2,1,3
52142_0,,,,2,2,1,3
C(C(C=O)(CC)O)=O,,,5,1,1,0,1
52143_0,,,,2,2,1,3
52145_0,,,,2,2,1,3
C(C(C=O)(CC(CO)O)O)=O,,,5,1,1,0,1
52146_0,,,,2,2,1,3
52148_0,,,,2,2,1,3
C(C(C=O)(CC(C(CO)O)O)O)=O,,,5,1,1,0,1
52149_0,,,,2,2,1,3
52150_0,,,,2,2,1,3
52151_0,,,,2,2,1,3
52152_0,,,,2,2,1,3
52153_0,,,,2,2,1,3
52154_0,,,,2,2,1,3
52155_0,,,,2,2,1,3
52156_0,,,,2,2,1,3
52157_0,,,,2,2,1,3
52158_0,,,,2,2,1,3
52159_0,,,,2,2,1,3
52160_0,,,,2,2,1,3
52161_0,,,,2,2,1,3
52162_0,,,,2,2,1,3
52163_0,,,,2,2,1,3
52165_0,,,,2,2,1,3
C(C(C(CO)(CC)O)=O)=O,,,5,1,1,0,1
52166_0,,,,2,2,1,3
52167_0,,,,2,2,1,3
52168_0,,,,2,2,1,3
52169_0,,,,2,2,1,3
52170_0,,,,2,2,1,3
52171_0,,,,2,2,1,3
52172_0,,,,2,2,1,3
52173_0,,,,2,2,1,3
52174_0,,,,2,2,1,3
52175_0,,,,2,2,1,3
52176_0,,,,2,2,1,3
52177_0,,,,2,2,1,3
52178_0,,,,2,2,1,3
52179_0,,,,2,2,1,3
52181_0,,,,2,2,1,3
C(C(CCC(C=O)O)O)=O,,,5,1,1,0,1
52182_0,,,,2,2,1,3
52183_0,,,,2,2,1,3
52184_0,,,,2,2,1,3
52185_0,,,,2,2,1,3
52186_0,,,,2,2,1,3
52187_0,,,,2,2,1,3
52188_0,,,,2,2,1,3
52189_0,,,,2,2,1,3
52190_0,,,,2,2,1,3
52191_0,,,,2,2,1,3
52192_0,,,,2,2,1,3
52193_0,,,,2,2,1,3
52194_0,,,,2,2,1,3
52195_0,,,,2,2,1,3
52196_0,,,,2,2,1,3
52197_0,,,,2,2,1,3
52198_0,,,,2,2,1,3
52199_0,,,,2,2,1,3
52200_0,,,,2,2,1,3
52201_0,,,,2,2,1,3
52202_0,,,,2,2,1,3
52203_0,,,,2,2,1,3
52204_0,,,,2,2,1,3
52205_0,,,,2,2,1,3
52206_0,,,,2,2,1,3
52207_0,,,,2,2,1,3
52208_0,,,,2,2,1,3
52209_0,,,,2,2,1,3
52210_0,,,,2,2,1,3
52212_0,,,,2,2,1,3
C(C(C(CO)=O)(CC)O)=O,,,5,1,1,0,1
52213_0,,,,2,2,1,3
52214_0,,,,2,2,1,3
52215_0,,,,2,2,1,3
52216_0,,,,2,2,1,3
52217_0,,,,2,2,1,3
52218_0,,,,2,2,1,3
52219_0,,,,2,2,1,3
52220_0,,,,2,2,1,3
52221_0,,,,2,2,1,3
52222_0,,,,2,2,1,3
52223_0,,,,2,2,1,3
52224_0,,,,2,2,1,3
52226_0,,,,2,2,1,3
C(C(C(C)C(C=O)O)O)=O,,,5,1,1,0,1
52227_0,,,,2,2,1,3
52228_0,,,,2,2,1,3
52229_0,,,,2,2,1,3
52230_0,,,,2,2,1,3
52231_0,,,,2,2,1,3
52232_0,,,,2,2,1,3
52234_0,,,,2,2,1,3
C(C(C(C(CC)O)=O)O)=O,,,5,1,1,0,1
52235_0,,,,2,2,1,3
52236_0,,,,2,2,1,3
52237_0,,,,2,2,1,3
52238_0,,,,2,2,1,3
52239_0,,,,2,2,1,3
52240_0,,,,2,2,1,3
52241_0,,,,2,2,1,3
52242_0,,,,2,2,1,3
52244_0,,,,2,2,1,3
C(C(CC)O)=O,,,5,1,1,0,1
52245_0,,,,2,2,1,3
52246_0,,,,2,2,1,3
52247_0,,,,2,2,1,3
52248_0,,,,2,2,1,3
52249_0,,,,2,2,1,3
52250_0,,,,2,2,1,3
52251_0,,,,2,2,1,3
52252_0,,,,2,2,1,3
52253_0,,,,2,2,1,3
52254_0,,,,2,2,1,3
52255_0,,,,2,2,1,3
52256_0,,,,2,2,1,3
52257_0,,,,2,2,1,3
52258_0,,,,2,2,1,3
52259_0,,,,2,2,1,3
52260_0,,,,2,2,1,3
52261_0,,,,2,2,1,3
52262_0,,,,2,2,1,3
52263_0,,,,2,2,1,3
52264_0,,,,2,2,1,3
52265_0,,,,2,2,1,3
52266_0,,,,2,2,1,3
52267_0,,,,2,2,1,3
52268_0,,,,2,2,1,3
52269_0,,,,2,2,1,3
52270_0,,,,2,2,1,3
52271_0,,,,2,2,1,3
52272_0,,,,2,2,1,3
52273_0,,,,2,2,1,3
52274_0,,,,2,2,1,3
52275_0,,,,2,2,1,3
52276_0,,,,2,2,1,3
52277_0,,,,2,2,1,3
52278_0,,,,2,2,1,3
52279_0,,,,2,2,1,3
52280_0,,,,2,2,1,3
52281_0,,,,2,2,1,3
52282_0,,,,2,2,1,3
52283_0,,,,2,2,1,3
52284_0,,,,2,2,1,3
52285_0,,,,2,2,1,3
52286_0,,,,2,2,1,3
52287_0,,,,2,2,1,3
52288_0,,,,2,2,1,3
52289_0,,,,2,2,1,3
52290_0,,,,2,2,1,3
52291_0,,,,2,2,1,3
52292_0,,,,2,2,1,3
52293_0,,,,2,2,1,3
52294_0,,,,2,2,1,3
52295_0,,,,2,2,1,3
52296_0,,,,2,2,1,3
52297_0,,,,2,2,1,3
52298_0,,,,2,2,1,3
52299_0,,,,2,2,1,3
52300_0,,,,2,2,1,3
52301_0,,,,2,2,1,3
52302_0,,,,2,2,1,3
52303_0,,,,2,2,1,3
52304_0,,,,2,2,1,3
52305_0,,,,2,2,1,3
52306_0,,,,2,2,1,3
52307_0,,,,2,2,1,3
52308_0,,,,2,2,1,3
52309_0,,,,2,2,1,3
52310_0,,,,2,2,1,3
52311_0,,,,2,2,1,3
52312_0,,,,2,2,1,3
52313_0,,,,2,2,1,3
52314_0,,,,2,2,1,3
52315_0,,,,2,2,1,3
52316_0,,,,2,2,1,3
52317_0,,,,2,2,1,3
52318_0,,,,2,2,1,3
52319_0,,,,2,2,1,3
52320_0,,,,2,2,1,3
52321_0,,,,2,2,1,3
52322_0,,,,2,2,1,3
52323_0,,,,2,2,1,3
52324_0,,,,2,2,1,3
52325_0,,,,2,2,1,3
52326_0,,,,2,2,1,3
52327_0,,,,2,2,1,3
52328_0,,,,2,2,1,3
52329_0,,,,2,2,1,3
52330_0,,,,2,2,1,3
52331_0,,,,2,2,1,3
52332_0,,,,2,2,1,3
52333_0,,,,2,2,1,3
52334_0,,,,2,2,1,3
52335_0,,,,2,2,1,3
52336_0,,,,2,2,1,3
52337_0,,,,2,2,1,3
52338_0,,,,2,2,1,3
52339_0,,,,2,2,1,3
52340_0,,,,2,2,1,3
52341_0,,,,2,2,1,3
52342_0,,,,2,2,1,3
52343_0,,,,2,2,1,3
52344_0,,,,2,2,1,3
52345_0,,,,2,2,1,3
52346_0,,,,2,2,1,3
52347_0,,,,2,1,2,3
52348_0,,,,2,1,2,3
52349_0,,,,2,1,2,3
52350_0,,,,2,1,2,3
52351_0,,,,2,1,2,3
52352_0,,,,2,1,2,3
52353_0,,,,2,1,2,3
52354_0,,,,2,1,2,3
52355_0,,,,2,1,2,3
52356_0,,,,2,1,2,3
52357_0,,,,2,1,2,3
52358_0,,,,2,1,2,3
52359_0,,,,2,1,2,3
52360_0,,,,2,1,2,3
52361_0,,,,2,1,2,3
52362_0,,,,2,1,2,3
52363_0,,,,2,1,2,3
52364_0,,,,2,1,1,2
52364_1,,,,2,1,1,2
52365_0,,,,2,1,1,2
52365_1,,,,2,1,1,2
52367_0,,,,2,1,1,2
C1C2(CC(C(C2O)O)(O)O1)O,,,5,1,2,0,2
52367_1,,,,2,1,1,2
52369_0,,,,2,1,1,2
C1C2(C(C(C(C2CO)(O)O1)O)O)O,,,5,1,2,0,2
52369_1,,,,2,1,1,2
52371_0,,,,2,1,1,2
C12CC(C(C(C(C1O)O)(O)O2)O)O,,,5,1,2,0,2
52371_1,,,,2,1,1,2
52373_0,,,,2,1,1,2
C(C1(C2C(C(C1C(O)O2)O)O)O)O,,,5,1,2,0,2
52373_1,,,,2,1,1,2
52375_0,,,,2,1,1,2
C1C2(C(C(C(C2C(O)O1)O)O)O)O,,,5,1,1,0,1
52377_0,,,,2,1,1,2
C(C1(C(C2C(C1C(O)O2)O)O)O)O,,,5,1,2,0,2
52377_1,,,,2,1,1,2
52379_0,,,,2,1,1,2
C1C2(CC(C(C(C2O)(O)O1)O)O)O,,,5,1,2,0,2
52379_1,,,,2,1,1,2
52381_0,,,,2,1,1,2
C(C1(C2C(CC(C1O)(O)O2)O)O)O,,,5,1,1,0,1
52383_0,,,,2,1,1,2
C1C2(C(C(CC(C2O)O)(O)O1)O)O,,,5,1,2,0,2
52383_1,,,,2,1,1,2
52385_0,,,,2,1,1,2
CC1(C2C(C(C(C1O)(O)O2)O)O)O,,,5,1,1,0,1
52387_0,,,,2,1,1,2
C(C1(C2C(C(C(C1)(O)O2)O)O)O)O,,,5,1,1,0,1
52389_0,,,,2,1,1,2
C1C2(CC(C(C(C2O)O)O)(O)O1)O,,,5,1,2,0,2
52389_1,,,,2,1,1,2
52391_0,,,,2,1,1,2
C(C1C2(CC(C(C2O)O)(O)O1)O)O,,,5,1,2,0,2
52391_1,,,,2,1,1,2
52392_0,,,,2,1,1,2
52392_1,,,,2,1,1,2
52393_0,,,,2,1,1,2
52393_1,,,,2,1,1,2
52394_0,,,,2,1,1,2
52394_1,,,,2,1,1,2
52395_0,,,,2,1,1,2
52395_1,,,,2,1,1,2
52396_0,,,,2,1,1,2
52396_1,,,,2,1,1,2
52397_0,,,,2,1,1,2
52397_1,,,,2,1,1,2
52398_0,,,,2,1,1,2
52400_0,,,,2,1,1,2
C(C1(CC2(C(C1CO2)O)O)O)=O,,,5,1,2,0,2
52400_1,,,,2,1,1,2
52401_0,,,,2,1,1,2
52401_1,,,,2,1,1,2
52402_0,,,,2,1,1,2
52404_0,,,,2,1,1,2
C1(C(C2C(O)OC(C2O)C1)O)=O,,,5,1,2,0,2
52404_1,,,,2,1,1,2
52406_0,,,,2,1,1,2
C(C1C2C(CC(C2O)(O1)O)O)=O,,,5,1,2,0,2
52406_1,,,,2,1,1,2
52407_0,,,,2,1,1,2
52409_0,,,,2,1,1,2
C1(C(C2C(C1)OC(C2O)O)O)=O,,,5,1,1,0,1
52410_0,,,,2,1,1,2
52411_0,,,,2,1,1,2
52411_1,,,,2,1,1,2
52412_0,,,,2,1,1,2
52413_0,,,,2,1,1,2
52413_1,,,,2,1,1,2
52415_0,,,,2,1,1,2
C(C1C2(CC(C(C2)(O1)O)O)O)=O,,,5,1,2,0,2
52415_1,,,,2,1,1,2
52417_0,,,,2,1,1,2
C1(C(CC2(C(O)OCC12)O)O)=O,,,5,1,1,0,1
52418_0,,,,2,1,1,2
52418_1,,,,2,1,1,2
52420_0,,,,2,1,1,2
C(C1(C2C(C(CC2O)O1)O)O)=O,,,5,1,2,0,2
52420_1,,,,2,1,1,2
52421_0,,,,2,1,1,2
52422_0,,,,2,1,1,2
52423_0,,,,2,1,1,2
52423_1,,,,2,1,1,2
52425_0,,,,2,1,1,2
C(C1(CC2C(C1C(O)O2)O)O)=O,,,5,1,2,0,2
52425_1,,,,2,1,1,2
52426_0,,,,2,1,1,2
52426_1,,,,2,1,1,2
52427_0,,,,2,1,1,2
52427_1,,,,2,1,1,2
52428_0,,,,2,1,1,2
52428_1,,,,2,1,1,2
52429_0,,,,2,1,1,2
52429_1,,,,2,1,1,2
52430_0,,,,2,1,1,2
52430_1,,,,2,1,1,2
52431_0,,,,2,1,1,2
52431_1,,,,2,1,1,2
52433_0,,,,2,1,1,2
C1(C2C(C(CC2O)O1)O)O,,,5,1,2,0,2
52433_1,,,,2,1,1,2
52435_0,,,,2,1,1,2
C1(C2C(C(C(C2O)O1)O)O)O,,,5,1,2,0,2
52435_1,,,,2,1,1,2
52437_0,,,,2,1,1,2
C12C(C(C(CC1O)(O)O2)O)O,,,5,1,1,0,1
52438_0,,,,2,1,1,2
52438_1,,,,2,1,1,2
52440_0,,,,2,1,1,2
C1C2(CC(C(C2(CO)O)O)(O)O1)O,,,5,1,2,0,2
52440_1,,,,2,1,1,2
52442_0,,,,2,1,1,2
C1C2(C(C(CC2(CO)O)(O)O1)O)O,,,5,1,2,0,2
52442_1,,,,2,1,1,2
52443_0,,,,2,1,1,2
52443_1,,,,2,1,1,2
52444_0,,,,2,1,1,2
52444_1,,,,2,1,1,2
52446_0,,,,2,1,1,2
C1C2(C(C(CC2O)(O)O1)O)O,,,5,1,2,0,2
52446_1,,,,2,1,1,2
52448_0,,,,2,1,1,2
C(C1C2(C(C(CC2O)(O)O1)O)O)O,,,5,1,2,0,2
52448_1,,,,2,1,1,2
52450_0,,,,2,1,1,2
C1C2(C(C(C(CO)C2O)(O)O1)O)O,,,5,1,2,0,2
52450_1,,,,2,1,1,2
52452_0,,,,2,1,1,2
C(C12C(C(C(C(O)O1)C2O)O)O)O,,,5,1,2,0,2
52452_1,,,,2,1,1,2
52454_0,,,,2,1,1,2
C(C1(C2C(C(C(O)O2)C1O)O)O)O,,,5,1,2,0,2
52454_1,,,,2,1,1,2
52456_0,,,,2,1,1,2
C(C12C(C(C(CC1O)(O)O2)O)O)O,,,5,1,1,0,1
52457_0,,,,2,1,1,2
52459_0,,,,2,1,1,2
C1(C(C2(C(C1)OC(C2)O)O)O)=O,,,5,1,1,0,1
52460_0,,,,2,1,1,2
52460_1,,,,2,1,1,2
52462_0,,,,2,1,1,2
C(C1C2CC(C(O)O2)(C1O)O)=O,,,5,1,2,0,2
52462_1,,,,2,1,1,2
52464_0,,,,2,1,1,2
C(C1(C2CC(C1C(O)O2)O)O)=O,,,5,1,2,0,2
52464_1,,,,2,1,1,2
52466_0,,,,2,1,1,2
C(C1C2CC(C1(C(O)O2)O)O)=O,,,5,1,2,0,2
52466_1,,,,2,1,1,2
52467_0,,,,2,1,1,2
52468_0,,,,2,1,1,2
52469_0,,,,2,1,1,2
52471_0,,,,2,1,1,2
C(C1(CC(C(O1)O)O)CC=O)=O,,,5,1,1,0,1
52472_0,,,,2,1,1,2
52474_0,,,,2,1,1,2
C(C1(CC(C(O1)O)O)C(C=O)O)=O,,,5,1,1,0,1
52475_0,,,,2,1,1,2
52477_0,,,,2,1,1,2
C(C(C1C(CC(C=O)(O)O1)O)O)=O,,,5,1,1,0,1
52478_0,,,,2,1,1,2
52480_0,,,,2,1,1,2
C(C(CC1C(C(C(O)O1)O)O)=O)=O,,,5,1,1,0,1
52482_0,,,,2,1,1,2
C(C1C(C(C=O)=O)C(C(O1)O)O)=O,,,5,1,1,0,1
52483_0,,,,2,1,1,2
52484_0,,,,2,1,1,2
52485_0,,,,2,1,1,2
52487_0,,,,2,1,1,2
C(C(C1C(C)OC(C1O)O)=O)=O,,,5,1,1,0,1
52489_0,,,,2,1,1,2
C(C(C1C(COC1(C=O)O)O)O)=O,,,5,1,1,0,1
52490_0,,,,2,1,1,2
52491_0,,,,2,1,1,2
52493_0,,,,2,1,1,2
C(C(C1C(CO)OC(C1O)O)=O)=O,,,5,1,1,0,1
52495_0,,,,2,1,1,2
C(C(C1C(OC(C=O)C1O)O)O)=O,,,5,1,1,0,1
52497_0,,,,2,1,1,2
C(C1C(C(C=O)O)OC(C1O)O)=O,,,5,1,1,0,1
52499_0,,,,2,1,1,2
C(C1C(O)OC(C1O)C(C=O)O)=O,,,5,1,1,0,1
52501_0,,,,2,1,1,2
C(C(C=O)C1C(C(C(O)O1)O)O)=O,,,5,1,1,0,1
52502_0,,,,2,1,1,2
52503_0,,,,2,1,1,2
52505_0,,,,2,1,1,2
C(C(C(C1COC(C1O)O)=O)O)=O,,,5,1,1,0,1
52506_0,,,,2,1,1,2
52508_0,,,,2,1,1,2
C(C(C1C(C(C(O)O1)CO)O)O)=O,,,5,1,1,0,1
52509_0,,,,2,1,1,2
52510_0,,,,2,1,1,2
52511_0,,,,2,1,1,2
52512_0,,,,2,1,1,2
52513_0,,,,2,1,1,2
52515_0,,,,2,1,1,2
C1C(CO)(C(C(O)O1)C(C)O)O,,,5,1,1,0,1
52516_0,,,,2,1,1,2
52518_0,,,,2,1,1,2
C1C(C(C(O)O1)C(CO)(CO)O)O,,,5,1,1,0,1
52519_0,,,,2,1,1,2
52520_0,,,,2,1,1,2
52522_0,,,,2,1,1,2
C(CO)(C1C(C(C(O1)O)CO)O)=O,,,5,1,1,0,1
52524_0,,,,2,1,1,2
CC(C1C(CO)(CC(O)O1)O)O,,,5,1,1,0,1
52526_0,,,,2,1,1,2
CC(C(C1(COC(C1)O)O)O)O,,,5,1,1,0,1
52528_0,,,,2,1,1,2
CC(C1C(CO)(C(C(O)O1)O)O)O,,,5,1,1,0,1
52530_0,,,,2,1,1,2
C1C(C(C(O)O1)O)(C(C(C)O)O)O,,,5,1,1,0,1
52532_0,,,,2,1,1,2
CC(C(C1(C(C(CO1)O)O)O)O)O,,,5,1,1,0,1
52533_0,,,,2,1,1,2
52534_0,,,,2,1,1,2
52535_0,,,,2,1,1,2
52536_0,,,,2,1,1,2
52538_0,,,,2,1,1,2
C(C(C1(CC(O)OC1CO)O)O)O,,,5,1,1,0,1
52539_0,,,,2,1,1,2
52541_0,,,,2,1,1,2
C(C1(CC(C)(C(O1)O)O)CC=O)=O,,,5,1,1,0,1
52542_0,,,,2,1,1,2
52544_0,,,,2,1,1,2
C(CC1C(C)(CC(C=O)(O)O1)O)=O,,,5,1,1,0,1
52545_0,,,,2,1,1,2
52547_0,,,,2,1,1,2
C(C(CC1(C)C(CC(O)O1)O)=O)=O,,,5,1,1,0,1
52548_0,,,,2,1,1,2
52549_0,,,,2,1,1,2
52551_0,,,,2,1,1,2
C(C(C1C(C)OC(C1(C)O)O)=O)=O,,,5,1,1,0,1
52553_0,,,,2,1,1,2
C(C1C(CC=O)OC(C1(C)O)O)=O,,,5,1,1,0,1
52555_0,,,,2,1,1,2
C(C1C(O)OC(C1(C)O)CC=O)=O,,,5,1,1,0,1
52557_0,,,,2,1,1,2
C(C(C=O)C1(C)C(CC(O)O1)O)=O,,,5,1,1,0,1
52559_0,,,,2,1,1,2
C(C(CO)C1CC(C)(C(O)O1)O)=O,,,5,1,1,0,1
52561_0,,,,2,1,1,2
C(C)(C(C1CC(C(O)O1)(C)O)O)=O,,,5,1,1,0,1
52563_0,,,,2,1,1,2
C(CO)(CC1CC(C(O)O1)(C)O)=O,,,5,1,1,0,1
52565_0,,,,2,1,1,2
C(C(C)(CC1CC(C(O)O1)=O)O)=O,,,5,1,1,0,1
52567_0,,,,2,1,1,2
C(C(CC1CC(C)(C(O)O1)O)=O)=O,,,5,1,1,0,1
52569_0,,,,2,1,1,2
C(C(C=O)C1CC(C)(C(O)O1)O)=O,,,5,1,1,0,1
52571_0,,,,2,1,1,2
C(CC1CC(C)(C(O)O1)O)=O,,,5,1,1,0,1
52573_0,,,,2,1,1,2
C(C(C1CC(C(O)O1)(C)O)O)=O,,,5,1,1,0,1
52575_0,,,,2,1,1,2
C(C(CO)C1C(C)(CC(O)O1)O)=O,,,5,1,1,0,1
52577_0,,,,2,1,1,2
C(CC1(C)C(C(C(O)O1)CO)O)=O,,,5,1,1,0,1
52579_0,,,,2,1,1,2
C(C)(C(C1C(C)(CC(O)O1)O)O)=O,,,5,1,1,0,1
52581_0,,,,2,1,1,2
C(CC1(C)C(C(C(C)(O)O1)O)O)=O,,,5,1,1,0,1
52583_0,,,,2,1,1,2
C(CO)(CC1C(C)(CC(O)O1)O)=O,,,5,1,1,0,1
52585_0,,,,2,1,1,2
C(CC1(C)C(CC(CO)(O)O1)O)=O,,,5,1,1,0,1
52586_0,,,,2,1,1,2
52588_0,,,,2,1,1,2
C(C(CC1C(C)(CC(O)O1)O)=O)=O,,,5,1,1,0,1
52590_0,,,,2,1,1,2
C(CC1(C)C(CC(C=O)(O)O1)O)=O,,,5,1,1,0,1
52592_0,,,,2,1,1,2
C(C(C=O)C1C(C)(CC(O)O1)O)=O,,,5,1,1,0,1
52594_0,,,,2,1,1,2
C(C1C(O)OC(C)(C1O)CC=O)=O,,,5,1,1,0,1
52596_0,,,,2,1,1,2
C(CC1C(C)(CC(O)O1)O)=O,,,5,1,1,0,1
52598_0,,,,2,1,1,2
C(CC1(C)C(CC(O)O1)O)=O,,,5,1,1,0,1
52600_0,,,,2,1,1,2
C(C(C1C(C)(CC(O)O1)O)O)=O,,,5,1,1,0,1
52602_0,,,,2,1,1,2
C(CC1(C)C(C(C(O)O1)O)O)=O,,,5,1,1,0,1
52604_0,,,,2,1,1,2
C(C1C(CCO)OC(C1(C)O)O)=O,,,5,1,1,0,1
52606_0,,,,2,1,1,2
C(C(C)(C1C(O)OCC1(C)O)O)=O,,,5,1,1,0,1
52608_0,,,,2,1,1,2
C(C1C(C)(CO)OC(C1(C)O)O)=O,,,5,1,1,0,1
52610_0,,,,2,1,1,2
C(C(C)(C1C(O)OC(C1O)=O)O)=O,,,5,1,1,0,1
52611_0,,,,2,1,1,2
52613_0,,,,2,1,1,2
C(C1C(C)(C(OC1(C=O)C)O)O)=O,,,5,1,1,0,1
52615_0,,,,2,1,1,2
C(C1C(C(C)(OC1(C=O)C)O)O)=O,,,5,1,1,0,1
52617_0,,,,2,1,1,2
C(C1C(C)(C(OC1C(C)=O)O)O)=O,,,5,1,1,0,1
52619_0,,,,2,1,1,2
C(C1C(C)OC(C1(C)O)O)=O,,,5,1,1,0,1
52621_0,,,,2,1,1,2
C(C1COC(C1(C)O)O)=O,,,5,1,1,0,1
52623_0,,,,2,1,1,2
C(C(C)(C1C(O)OCC1O)O)=O,,,5,1,1,0,1
52624_0,,,,2,1,1,2
52626_0,,,,2,1,1,2
C(CC1C(C(C)(C(O)O1)O)O)=O,,,5,1,1,0,1
52628_0,,,,2,1,1,2
C(C(C)(C1C(CC(O)O1)O)O)=O,,,5,1,1,0,1
52630_0,,,,2,1,1,2
C(C(C1C(C(C(O)O1)(C)O)O)O)=O,,,5,1,1,0,1
52631_0,,,,2,1,1,2
52633_0,,,,2,1,1,2
C(CC1C(C)(C(C(O)O1)O)O)=O,,,5,1,1,0,1
52635_0,,,,2,1,1,2
C(C(C1(C)C(CC(O)O1)O)O)=O,,,5,1,1,0,1
52636_0,,,,2,1,1,2
52637_0,,,,2,1,1,2
52639_0,,,,2,1,1,2
C(C1(CC(C(C)(O1)O)O)CC=O)=O,,,5,1,1,0,1
52640_0,,,,2,1,1,2
52641_0,,,,2,1,1,2
52642_0,,,,2,1,1,2
52644_0,,,,2,1,1,2
C(C(C1C(C)OC(C)(C1O)O)=O)=O,,,5,1,1,0,1
52645_0,,,,2,1,1,2
52647_0,,,,2,1,1,2
C(C1C(CC=O)OC(C)(C1O)O)=O,,,5,1,1,0,1
52649_0,,,,2,1,1,2
C(C(CO)C1CC(C(C)(O)O1)O)=O,,,5,1,1,0,1
52651_0,,,,2,1,1,2
C(C)(C(C1CC(C(C)(O)O1)O)O)=O,,,5,1,1,0,1
52653_0,,,,2,1,1,2
C(CO)(CC1CC(C(C)(O)O1)O)=O,,,5,1,1,0,1
52655_0,,,,2,1,1,2
C(C)(C(CC1CC(C(O)O1)=O)O)=O,,,5,1,1,0,1
52657_0,,,,2,1,1,2
C(C(CC1CC(C(C)(O)O1)O)=O)=O,,,5,1,1,0,1
52659_0,,,,2,1,1,2
C(C(C=O)C1CC(C(C)(O)O1)O)=O,,,5,1,1,0,1
52661_0,,,,2,1,1,2
C(CC1CC(C(C)(O)O1)O)=O,,,5,1,1,0,1
52663_0,,,,2,1,1,2
C(C(C1CC(C(C)(O)O1)O)O)=O,,,5,1,1,0,1
52665_0,,,,2,1,1,2
C(C(CO)C1(C)C(CC(O)O1)O)=O,,,5,1,1,0,1
52667_0,,,,2,1,1,2
C(CC1C(C)(C(C(O)O1)CO)O)=O,,,5,1,1,0,1
52669_0,,,,2,1,1,2
C(C)(C(C1(C)C(CC(O)O1)O)O)=O,,,5,1,1,0,1
52671_0,,,,2,1,1,2
C(CC1C(C)(C(C(C)(O)O1)O)O)=O,,,5,1,1,0,1
52673_0,,,,2,1,1,2
C(CO)(CC1(C)C(CC(O)O1)O)=O,,,5,1,1,0,1
52675_0,,,,2,1,1,2
C(CC1C(C)(CC(CO)(O)O1)O)=O,,,5,1,1,0,1
52677_0,,,,2,1,1,2
C(C1C(CCO)OC(C)(C1O)O)=O,,,5,1,1,0,1
52679_0,,,,2,1,1,2
C(C)(C(C1C(O)OCC1(C)O)O)=O,,,5,1,1,0,1
52681_0,,,,2,1,1,2
C(C1C(C(C)(O)OC1(C)CO)O)=O,,,5,1,1,0,1
52683_0,,,,2,1,1,2
C1(C(C(C(O)O1)C(C(C)=O)O)O)=O,,,5,1,1,0,1
52684_0,,,,2,1,1,2
52686_0,,,,2,1,1,2
C(C1C(C(C)(OC1C(C)=O)O)O)=O,,,5,1,1,0,1
52688_0,,,,2,1,1,2
C(C1C(C)OC(C)(C1O)O)=O,,,5,1,1,0,1
52690_0,,,,2,1,1,2
C(C1COC(C)(C1O)O)=O,,,5,1,1,0,1
52692_0,,,,2,1,1,2
C(C)(C(C1C(O)OCC1O)O)=O,,,5,1,1,0,1
52693_0,,,,2,1,1,2
52695_0,,,,2,1,1,2
C(CC(C1(CC(CO1)(C)O)O)O)=O,,,5,1,1,0,1
52697_0,,,,2,1,1,2
C(CC(C1(CC(C(O1)=O)O)O)O)=O,,,5,1,1,0,1
52698_0,,,,2,1,1,2
52700_0,,,,2,1,1,2
C(CC1C(C(C(C)(O)O1)O)O)=O,,,5,1,1,0,1
52701_0,,,,2,1,1,2
52702_0,,,,2,1,1,2
52703_0,,,,2,1,1,2
52704_0,,,,2,1,1,2
52705_0,,,,2,1,1,2
52706_0,,,,2,1,1,2
52707_0,,,,2,1,1,2
52708_0,,,,2,1,1,2
52710_0,,,,2,1,1,2
C(C1COC(C1(CC(C)O)O)O)=O,,,5,1,1,0,1
52711_0,,,,2,1,1,2
52712_0,,,,2,1,1,2
52713_0,,,,2,1,1,2
52715_0,,,,2,1,1,2
C(C1(CC(C)O)CC(C(O1)O)=O)=O,,,5,1,1,0,1
52716_0,,,,2,1,1,2
52717_0,,,,2,1,1,2
52718_0,,,,2,1,1,2
52719_0,,,,2,1,1,2
52721_0,,,,2,1,1,2
C(C1COC(C1O)(CC(C)O)O)=O,,,5,1,1,0,1
52722_0,,,,2,1,1,2
52724_0,,,,2,1,1,2
C1(C(O)OC(CCO)C1C(C)O)=O,,,5,1,1,0,1
52726_0,,,,2,1,1,2
C(C1(C(C(C)O)C(CO1)(C)O)O)=O,,,5,1,1,0,1
52727_0,,,,2,1,1,2
52729_0,,,,2,1,1,2
C1(C(O)OC(CO)(C)C1C(C)O)=O,,,5,1,1,0,1
52731_0,,,,2,1,1,2
C1(C(C(C(C)O)C(C=O)(O)O1)O)=O,,,5,1,1,0,1
52732_0,,,,2,1,1,2
52734_0,,,,2,1,1,2
C1(C(OC(C(O)=O)C1C(C)O)O)=O,,,5,1,1,0,1
52735_0,,,,2,1,1,2
52737_0,,,,2,1,1,2
C(C1(C(C(C)O)C(CO1)O)O)=O,,,5,1,1,0,1
52738_0,,,,2,1,1,2
52739_0,,,,2,1,1,2
52740_0,,,,2,1,1,2
52741_0,,,,2,1,1,2
52743_0,,,,2,1,1,2
C(C1(C(C(CO)O)C(CO1)O)O)=O,,,5,1,1,0,1
52744_0,,,,2,1,1,2
52746_0,,,,2,1,1,2
C(CC(C1C(O)OCC1(C)O)O)=O,,,5,1,1,0,1
52748_0,,,,2,1,1,2
C(CC(C1C(O)OC(C1O)=O)O)=O,,,5,1,1,0,1
52749_0,,,,2,1,1,2
52750_0,,,,2,1,1,2
52751_0,,,,2,1,1,2
52752_0,,,,2,1,1,2
52754_0,,,,2,1,1,2
C(C1C(C(C(O1)O)C(C)O)O)=O,,,5,1,1,0,1
52756_0,,,,2,1,1,2
C(C1C(C(CO)C(O1)O)O)=O,,,5,1,1,0,1
52757_0,,,,2,1,1,2
52759_0,,,,2,1,1,2
C(C1C(C(C(O1)O)C(CO)O)O)=O,,,5,1,1,0,1
52761_0,,,,2,1,1,2
C(C)(C1C(C(C(O1)O)C(C)O)O)=O,,,5,1,1,0,1
52763_0,,,,2,1,1,2
C(C(C1C(C(CO)C(O1)O)O)=O)=O,,,5,1,1,0,1
52765_0,,,,2,1,1,2
C(C(CO)C1C(C(C(O)O1)=O)O)=O,,,5,1,1,0,1
52766_0,,,,2,1,1,2
52768_0,,,,2,1,1,2
C(CC1CC(C(O)O1)(CCO)O)=O,,,5,1,1,0,1
52769_0,,,,2,1,1,2
52771_0,,,,2,1,1,2
C(CC1C(CC(O)O1)(CCO)O)=O,,,5,1,1,0,1
52773_0,,,,2,1,1,2
C(CC1(CCO)C(CC(O)O1)O)=O,,,5,1,1,0,1
52775_0,,,,2,1,1,2
C(C1C(C)OC(C1(CCO)O)O)=O,,,5,1,1,0,1
52776_0,,,,2,1,1,2
52778_0,,,,2,1,1,2
C(C1COC(C1(CCO)O)O)=O,,,5,1,1,0,1
52779_0,,,,2,1,1,2
52781_0,,,,2,1,1,2
C(CC1CC(C(CCO)(O)O1)O)=O,,,5,1,1,0,1
52783_0,,,,2,1,1,2
C(C1C(C)OC(C1O)(CCO)O)=O,,,5,1,1,0,1
52785_0,,,,2,1,1,2
C(C1COC(C1O)(CCO)O)=O,,,5,1,1,0,1
52786_0,,,,2,1,1,2
52787_0,,,,2,1,1,2
52788_0,,,,2,1,1,2
52789_0,,,,2,1,1,2
52790_0,,,,2,1,1,2
52791_0,,,,2,1,1,2
52793_0,,,,2,1,1,2
C(CC1C(C(C(O)O1)C(C)O)O)=O,,,5,1,1,0,1
52794_0,,,,2,1,1,2
52795_0,,,,2,1,1,2
52796_0,,,,2,1,1,2
52797_0,,,,2,1,1,2
52798_0,,,,2,1,1,2
52800_0,,,,2,1,1,2
C(CC1C(C(C)O)C(C(O)O1)O)=O,,,5,1,1,0,1
52801_0,,,,2,1,1,2
52802_0,,,,2,1,1,2
52803_0,,,,2,1,1,2
52805_0,,,,2,1,1,2
C(C(C1C(CO)C(C(O)O1)O)O)=O,,,5,1,1,0,1
52806_0,,,,2,1,1,2
52807_0,,,,2,1,1,2
52809_0,,,,2,1,1,2
C(C1C(C(CO)C(CO)(O1)O)O)=O,,,5,1,1,0,1
52811_0,,,,2,1,1,2
C(C1C(CC(C(CO)O)(O1)O)O)=O,,,5,1,1,0,1
52812_0,,,,2,1,1,2
52813_0,,,,2,1,1,2
52814_0,,,,2,1,1,2
52815_0,,,,2,1,1,2
52817_0,,,,2,1,1,2
C(C1C(CO)(C(CO)C(O1)O)O)=O,,,5,1,1,0,1
52818_0,,,,2,1,1,2
52819_0,,,,2,1,1,2
52820_0,,,,2,1,1,2
52821_0,,,,2,1,1,2
52822_0,,,,2,1,1,2
52823_0,,,,2,1,1,2
52824_0,,,,2,1,1,2
52825_0,,,,2,1,1,2
52827_0,,,,2,1,1,2
C(C1C(COC1(C(CO)O)O)O)=O,,,5,1,1,0,1
52828_0,,,,2,1,1,2
52829_0,,,,2,1,1,2
52830_0,,,,2,1,1,2
52832_0,,,,2,1,1,2
C(C1C(CC(O1)O)(C(CO)O)O)=O,,,5,1,1,0,1
52834_0,,,,2,1,1,2
C(CC1(C(CO)OC(C1O)O)O)=O,,,5,1,1,0,1
52835_0,,,,2,1,1,2
52836_0,,,,2,1,1,2
52837_0,,,,2,1,1,2
52838_0,,,,2,1,1,2
52839_0,,,,2,1,1,2
52841_0,,,,2,1,1,2
C(C1C(C(C(CCO)(O1)O)O)O)=O,,,5,1,1,0,1
52842_0,,,,2,1,1,2
52844_0,,,,2,1,1,2
C(C1C(C)(C(C(O1)O)C(C)O)O)=O,,,5,1,1,0,1
52845_0,,,,2,1,1,2
52847_0,,,,2,1,1,2
C(C1C(CC(C)O)(CC(O1)O)O)=O,,,5,1,1,0,1
52849_0,,,,2,1,1,2
C(C1C(CC(O1)O)(CCO)O)=O,,,5,1,1,0,1
52851_0,,,,2,1,1,2
C(C1C(C(C(O1)O)O)(CCO)O)=O,,,5,1,1,0,1
52853_0,,,,2,1,1,2
C(C(C1(C(CO)C(CO1)O)O)O)=O,,,5,1,1,0,1
52855_0,,,,2,1,1,2
CC(CC(C1C(O)OCC1O)O)O,,,5,1,1,0,1
52857_0,,,,2,1,1,2
C1(C(O)OC(CC(C)O)C1O)=O,,,5,1,1,0,1
52859_0,,,,2,1,1,2
C1(C(C)(O)OC(CC(C)O)C1O)=O,,,5,1,1,0,1
52861_0,,,,2,1,1,2
C1(C(CO)(O)OC(CC(C)O)C1)=O,,,5,1,1,0,1
52863_0,,,,2,1,1,2
C1(C(O)OC(CC(C)O)C1)=O,,,5,1,1,0,1
52865_0,,,,2,1,1,2
C1(C(O)OC(CC(C)O)C1CO)=O,,,5,1,1,0,1
52866_0,,,,2,1,1,2
52868_0,,,,2,1,1,2
C(C1C(CC(C)O)OC(C1O)O)=O,,,5,1,1,0,1
52869_0,,,,2,1,1,2
52870_0,,,,2,1,1,2
52872_0,,,,2,1,1,2
CC(C1C(C(C(O)O1)C(C)O)O)O,,,5,1,1,0,1
52874_0,,,,2,1,1,2
C(C1(COC(C1C(C)O)O)O)=O,,,5,1,1,0,1
52876_0,,,,2,1,1,2
C(C1C(C)OC(C1(CO)O)O)=O,,,5,1,1,0,1
52878_0,,,,2,1,1,2
C(C1C(C)OC(CO)(C1O)O)=O,,,5,1,1,0,1
52880_0,,,,2,1,1,2
C(C)(C1(COC(C1C(C)O)O)O)=O,,,5,1,1,0,1
52882_0,,,,2,1,1,2
C(C1C(C)OC(C)(C1(CO)O)O)=O,,,5,1,1,0,1
52884_0,,,,2,1,1,2
C(C1C(C)OC(CO)(C1(C)O)O)=O,,,5,1,1,0,1
52886_0,,,,2,1,1,2
C(C1(C(C)OC(C1C(C)O)O)O)=O,,,5,1,1,0,1
52888_0,,,,2,1,1,2
C(C1C(C)OC(C1(C(C)O)O)O)=O,,,5,1,1,0,1
52890_0,,,,2,1,1,2
C(C1C(C)OC(C1O)(C(C)O)O)=O,,,5,1,1,0,1
52892_0,,,,2,1,1,2
C1C(C)(C(C(O)O1)C(C)O)O,,,5,1,1,0,1
52894_0,,,,2,1,1,2
C1C(CCO)(C(C(O)O1)C(C)O)O,,,5,1,1,0,1
52896_0,,,,2,1,1,2
CC(C1C(O)OC(CCO)C1O)O,,,5,1,1,0,1
52898_0,,,,2,1,1,2
CC1(C(CO)OC(C1C(C)O)O)O,,,5,1,1,0,1
52900_0,,,,2,1,1,2
C1(C(C(C(O)O1)C(C)O)O)=O,,,5,1,1,0,1
52902_0,,,,2,1,1,2
C1(C(C)(C(C(O)O1)C(C)O)O)=O,,,5,1,1,0,1
52904_0,,,,2,1,1,2
C1C2(C(CO1)OC(C2C(C)O)O)O,,,5,1,1,0,1
52906_0,,,,2,1,1,2
C12C(CCO1)(C(C(O)O2)C(C)O)O,,,5,1,1,0,1
52908_0,,,,2,1,1,2
C(C1C(C)OC(C1(C=C)O)O)=O,,,5,1,1,0,1
52910_0,,,,2,1,1,2
C(C1C(C(C=C)(O)OC1C)O)=O,,,5,1,1,0,1
52912_0,,,,2,1,1,2
CC(C1C(O)OC(CO)C1O)O,,,5,1,1,0,1
52914_0,,,,2,1,1,2
C1C(C(C(O)O1)C(C)O)O,,,5,1,1,0,1
52916_0,,,,2,1,1,2
CC(C1C(C(C(O)O1)CO)O)O,,,5,1,1,0,1
52918_0,,,,2,1,1,2
C1(C(O)OC(C(C(C)O)O)C1O)=O,,,5,1,1,0,1
52920_0,,,,2,1,1,2
C(C1(C(C(C(C(C)O)O1)O)O)O)=O,,,5,1,1,0,1
52922_0,,,,2,1,1,2
CC(C1C(C(C(C)(O)O1)O)O)O,,,5,1,1,0,1
52924_0,,,,2,1,1,2
CC(C1C(CC(CO)(O)O1)O)O,,,5,1,1,0,1
52926_0,,,,2,1,1,2
C(C1(CC(C(C(C)O)O1)O)O)(O)=O,,,5,1,1,0,1
52928_0,,,,2,1,1,2
C(C1C(O)OC(C1O)C(C)O)(O)=O,,,5,1,1,0,1
52930_0,,,,2,1,1,2
CC(C1C(C(C(CO)(O)O1)O)O)O,,,5,1,1,0,1
52932_0,,,,2,1,1,2
C1(C(O)OC(C(C(C)O)O)C1)=O,,,5,1,1,0,1
52934_0,,,,2,1,1,2
C(C1(CC(C(C(C)O)O1)O)O)=O,,,5,1,1,0,1
52936_0,,,,2,1,1,2
C(C1C(O)OC(C1O)C(C)O)=O,,,5,1,1,0,1
52938_0,,,,2,1,1,2
CC(C1C(CC(O)O1)O)O,,,5,1,1,0,1
52939_0,,,,2,1,1,2
52940_0,,,,2,1,1,2
52942_0,,,,2,1,1,2
C1C(C(C(O)O1)C(C(CO)O)O)O,,,5,1,1,0,1
52943_0,,,,2,1,1,2
52944_0,,,,2,1,1,2
52946_0,,,,2,1,1,2
C1C(C(C(O)O1)C(CCO)O)O,,,5,1,1,0,1
52948_0,,,,2,1,1,2
C1(C(O)OC(CCO)C1O)=O,,,5,1,1,0,1
52950_0,,,,2,1,1,2
C1(C(C)(O)OC(CCO)C1O)=O,,,5,1,1,0,1
52952_0,,,,2,1,1,2
C1(C(CO)(O)OC(CCO)C1)=O,,,5,1,1,0,1
52954_0,,,,2,1,1,2
C1(C(C(C(O)O1)C(CCO)O)O)=O,,,5,1,1,0,1
52955_0,,,,2,1,1,2
52956_0,,,,2,1,1,2
52957_0,,,,2,1,1,2
52958_0,,,,2,1,1,2
52959_0,,,,2,1,1,2
52960_0,,,,2,1,1,2
52962_0,,,,2,1,1,2
C(C1(COC(C1CO)O)O)=O,,,5,1,1,0,1
52963_0,,,,2,1,1,2
52964_0,,,,2,1,1,2
52966_0,,,,2,1,1,2
C(C1(C(CO)OC(C1CO)O)O)=O,,,5,1,1,0,1
52967_0,,,,2,1,1,2
52969_0,,,,2,1,1,2
C(C1COC(C1(C(CO)O)O)O)=O,,,5,1,1,0,1
52971_0,,,,2,1,1,2
C(C1COC(C1O)(C(CO)O)O)=O,,,5,1,1,0,1
52973_0,,,,2,1,1,2
C(C)(C1(COC(C1CO)O)O)=O,,,5,1,1,0,1
52975_0,,,,2,1,1,2
C(C1COC(C)(C1(CO)O)O)=O,,,5,1,1,0,1
52977_0,,,,2,1,1,2
C(C1COC(CO)(C1(C)O)O)=O,,,5,1,1,0,1
52979_0,,,,2,1,1,2
C(C1(C(C)OC(C1CO)O)O)=O,,,5,1,1,0,1
52981_0,,,,2,1,1,2
C(C1COC(C1(C(C)O)O)O)=O,,,5,1,1,0,1
52983_0,,,,2,1,1,2
C(C1COC(C1O)(C(C)O)O)=O,,,5,1,1,0,1
52985_0,,,,2,1,1,2
C1C(C)(C(C(O)O1)CO)O,,,5,1,1,0,1
52987_0,,,,2,1,1,2
C1C(CCO)(C(C(O)O1)CO)O,,,5,1,1,0,1
52989_0,,,,2,1,1,2
C1(C(CO)C(C(CCO)O1)O)O,,,5,1,1,0,1
52991_0,,,,2,1,1,2
CC1(C(CO)OC(C1CO)O)O,,,5,1,1,0,1
52993_0,,,,2,1,1,2
C1(C(C(CO)C(O)O1)O)=O,,,5,1,1,0,1
52995_0,,,,2,1,1,2
C1(C(C)(C(CO)C(O)O1)O)=O,,,5,1,1,0,1
52997_0,,,,2,1,1,2
C1(C(CCO)(C(CO)C(O)O1)O)=O,,,5,1,1,0,1
52999_0,,,,2,1,1,2
C(CC1C(C(C(O)O1)CO)O)(O)=O,,,5,1,1,0,1
53001_0,,,,2,1,1,2
C(CC1(COC(C1CO)O)O)(O)=O,,,5,1,1,0,1
53003_0,,,,2,1,1,2
C(C1C(C)(C(CO)C(O1)O)O)(O)=O,,,5,1,1,0,1
53005_0,,,,2,1,1,2
C1C2(C(CO1)OC(C2CO)O)O,,,5,1,1,0,1
53007_0,,,,2,1,1,2
C12C(CCO1)(C(C(O)O2)CO)O,,,5,1,1,0,1
53009_0,,,,2,1,1,2
C(C1COC(C1(C=C)O)O)=O,,,5,1,1,0,1
53011_0,,,,2,1,1,2
C(C1COC(C=C)(C1O)O)=O,,,5,1,1,0,1
53012_0,,,,2,1,1,2
53014_0,,,,2,1,1,2
C1(C(O)OC(CC(CO)O)C1O)=O,,,5,1,1,0,1
53015_0,,,,2,1,1,2
53017_0,,,,2,1,1,2
C(C1(COC(C1C(CO)O)O)O)=O,,,5,1,1,0,1
53018_0,,,,2,1,1,2
53020_0,,,,2,1,1,2
C(C1C(CO)OC(C1(CO)O)O)=O,,,5,1,1,0,1
53022_0,,,,2,1,1,2
C(CO)(C(C1C(O)OCC1O)O)=O,,,5,1,1,0,1
53024_0,,,,2,1,1,2
C(C1C(CO)OC(CO)(C1O)O)=O,,,5,1,1,0,1
53026_0,,,,2,1,1,2
C1C(C)(C(C(O)O1)C(CO)O)O,,,5,1,1,0,1
53028_0,,,,2,1,1,2
CC(CO)(C1C(O)OCC1O)O,,,5,1,1,0,1
53030_0,,,,2,1,1,2
C1(C(C(C(O)O1)C(CO)O)O)=O,,,5,1,1,0,1
53031_0,,,,2,1,1,2
53033_0,,,,2,1,1,2
C1(C(C)(C(C(O)O1)C(CO)O)O)=O,,,5,1,1,0,1
53035_0,,,,2,1,1,2
C(C(C)(C1C(O)OCC1O)O)(O)=O,,,5,1,1,0,1
53037_0,,,,2,1,1,2
C(CC(C1C(O)OCC1O)O)(O)=O,,,5,1,1,0,1
53039_0,,,,2,1,1,2
C(C(C=C)(C1C(O)OCC1O)O)=O,,,5,1,1,0,1
53041_0,,,,2,1,1,2
C(C1C(CO)OC(C1(C=C)O)O)=O,,,5,1,1,0,1
53043_0,,,,2,1,1,2
C=CC(C(C1C(O)OCC1O)O)=O,,,5,1,1,0,1
53045_0,,,,2,1,1,2
C(C1C(C(C=C)(O)OC1CO)O)=O,,,5,1,1,0,1
53047_0,,,,2,1,1,2
C(C(C1C(O)OCC1O)O)=CC=O,,,5,1,1,0,1
53048_0,,,,2,1,1,2
53050_0,,,,2,1,1,2
C(C1(CO)C(C(C(O1)O)=O)O)=O,,,5,1,1,0,1
53052_0,,,,2,1,1,2
C(C1(COC(C=O)(C1O)O)O)=O,,,5,1,1,0,1
53054_0,,,,2,1,1,2
C(C1(CO)C(C(C(C)(O1)O)=O)O)=O,,,5,1,1,0,1
53056_0,,,,2,1,1,2
C(C1(COC(C(C)=O)(C1O)O)O)=O,,,5,1,1,0,1
53058_0,,,,2,1,1,2
C(C1(CO)CC(C(CO)(O1)O)=O)=O,,,5,1,1,0,1
53060_0,,,,2,1,1,2
C(C1(COC(C(CO)=O)(C1)O)O)=O,,,5,1,1,0,1
53062_0,,,,2,1,1,2
C(CO)(C1COC(C1(CO)O)O)=O,,,5,1,1,0,1
53064_0,,,,2,1,1,2
C(C1(COC(CO)(C1CO)O)O)=O,,,5,1,1,0,1
53066_0,,,,2,1,1,2
C(C1(COC(C1)(C(CO)O)O)O)=O,,,5,1,1,0,1
53068_0,,,,2,1,1,2
C(C1(COC(C(O)=O)(C1)O)O)=O,,,5,1,1,0,1
53070_0,,,,2,1,1,2
C1(C(C=O)C(CO)(C(O)O1)O)=O,,,5,1,1,0,1
53072_0,,,,2,1,1,2
C(C1C(O)OCC1(C=O)O)(O)=O,,,5,1,1,0,1
53074_0,,,,2,1,1,2
C(C1(COC2(C1OCC2O)O)O)=O,,,5,1,1,0,1
53076_0,,,,2,1,1,2
C(C1(COC2(C(O)OCC21)O)O)=O,,,5,1,1,0,1
53078_0,,,,2,1,1,2
C1(COC2C1C(C(O)O2)(CO)O)=O,,,5,1,1,0,1
53080_0,,,,2,1,1,2
C(C1(COC2(COC(C21)O)O)O)=O,,,5,1,1,0,1
53082_0,,,,2,1,1,2
C(C1(COC2(C1OC(C2)O)O)O)=O,,,5,1,1,0,1
53084_0,,,,2,1,1,2
C(C1(COC(CO)(C1O)O)O)=O,,,5,1,1,0,1
53085_0,,,,2,1,1,2
53087_0,,,,2,1,1,2
C(C1(COC(C=O)(C1)O)O)=O,,,5,1,1,0,1
53089_0,,,,2,1,1,2
C(C1C(O)OCC1(C=O)O)=O,,,5,1,1,0,1
53090_0,,,,2,1,1,2
53091_0,,,,2,1,1,2
53093_0,,,,2,1,1,2
C(C(C1COC(C1(CO)O)O)=O)=O,,,5,1,1,0,1
53095_0,,,,2,1,1,2
C(C1(COC(C=O)(C1CO)O)O)=O,,,5,1,1,0,1
53097_0,,,,2,1,1,2
C(C1C(CO)(C(OC1C=O)O)O)=O,,,5,1,1,0,1
53098_0,,,,2,1,1,2
53100_0,,,,2,1,1,2
C(C1(COC(C1C(C=O)O)O)O)=O,,,5,1,1,0,1
53101_0,,,,2,1,1,2
53103_0,,,,2,1,1,2
C(C1(COC(C1C(CO)=O)O)O)=O,,,5,1,1,0,1
53105_0,,,,2,1,1,2
C(C1C(CO)(O)OCC1(C=O)O)=O,,,5,1,1,0,1
53106_0,,,,2,1,1,2
53108_0,,,,2,1,1,2
C(C1(COC(C1O)(CC=O)O)O)=O,,,5,1,1,0,1
53110_0,,,,2,1,1,2
C(C1(COC(C1)(C(C=O)O)O)O)=O,,,5,1,1,0,1
53112_0,,,,2,1,1,2
C1(C(O)OC(C(CO)=O)C1O)=O,,,5,1,1,0,1
53114_0,,,,2,1,1,2
C(C1C(C(C(C)(O1)O)=O)O)(CO)=O,,,5,1,1,0,1
53116_0,,,,2,1,1,2
C1(CC(C(CO)=O)OC1(CO)O)=O,,,5,1,1,0,1
53118_0,,,,2,1,1,2
C(CO)(C1COC(CO)(C1O)O)=O,,,5,1,1,0,1
53120_0,,,,2,1,1,2
C1(C(C=O)C(C(CO)(O)O1)O)=O,,,5,1,1,0,1
53122_0,,,,2,1,1,2
C1(COC2C1C(C(CO)(O)O2)O)=O,,,5,1,1,0,1
53124_0,,,,2,1,1,2
C1(C(O)OC(C(CO)=O)C1)=O,,,5,1,1,0,1
53126_0,,,,2,1,1,2
C(C1C(C(C(O1)O)=O)CO)(CO)=O,,,5,1,1,0,1
53127_0,,,,2,1,1,2
53129_0,,,,2,1,1,2
C(C(C1COC(CO)(C1O)O)=O)=O,,,5,1,1,0,1
53131_0,,,,2,1,1,2
C(C1C(C(CO)(OC1C=O)O)O)=O,,,5,1,1,0,1
53133_0,,,,2,1,1,2
C(C1C(C(OC1C(CO)=O)O)O)=O,,,5,1,1,0,1
53134_0,,,,2,1,1,2
53135_0,,,,2,1,1,2
53137_0,,,,2,1,1,2
C(C1(C(C(C(C)=O)(CO1)O)O)O)=O,,,5,1,1,0,1
53139_0,,,,2,1,1,2
C(C)(C1(CO)C(C(C(O1)O)=O)O)=O,,,5,1,1,0,1
53141_0,,,,2,1,1,2
C(CO)(C1(C)C(C(C(O1)O)=O)O)=O,,,5,1,1,0,1
53143_0,,,,2,1,1,2
C(C1(C(C(C=O)(O)OC1C)O)O)=O,,,5,1,1,0,1
53145_0,,,,2,1,1,2
C(C1(C(C)O)C(C(C(O1)O)=O)O)=O,,,5,1,1,0,1
53147_0,,,,2,1,1,2
C(C1C(C(C(O1)O)=O)O)(C(C)O)=O,,,5,1,1,0,1
53149_0,,,,2,1,1,2
C(C1(C(C(CO1)(C)O)O)O)=O,,,5,1,1,0,1
53151_0,,,,2,1,1,2
C1(C(O)OC(CO)(C)C1O)=O,,,5,1,1,0,1
53153_0,,,,2,1,1,2
C(C1(C(C(CO1)(CCO)O)O)O)=O,,,5,1,1,0,1
53155_0,,,,2,1,1,2
C1(C(O)OC(CO)(CCO)C1O)=O,,,5,1,1,0,1
53157_0,,,,2,1,1,2
C(C1(C(C(C(CCO)O1)O)O)O)=O,,,5,1,1,0,1
53159_0,,,,2,1,1,2
C1(C(O)OC(C(CCO)O)C1O)=O,,,5,1,1,0,1
53161_0,,,,2,1,1,2
C(C1(C(C(C)(C(CO)O1)O)O)O)=O,,,5,1,1,0,1
53163_0,,,,2,1,1,2
C1(C(O)OC(C)(C(CO)O)C1O)=O,,,5,1,1,0,1
53165_0,,,,2,1,1,2
C1(C(C(C(C=O)(O)O1)O)O)=O,,,5,1,1,0,1
53167_0,,,,2,1,1,2
C(C1C(C(C(O)O1)=O)O)(O)=O,,,5,1,1,0,1
53169_0,,,,2,1,1,2
C1(C(C)(C(C(C=O)(O)O1)O)O)=O,,,5,1,1,0,1
53171_0,,,,2,1,1,2
C(C1(C)C(C(C(O1)O)=O)O)(O)=O,,,5,1,1,0,1
53173_0,,,,2,1,1,2
C(CC1C(C(C(O)O1)=O)O)(O)=O,,,5,1,1,0,1
53175_0,,,,2,1,1,2
C(C1(C(C2(COCC2O1)O)O)O)=O,,,5,1,1,0,1
53177_0,,,,2,1,1,2
C1(C(O)OC2(COCC2O)C1O)=O,,,5,1,1,0,1
53179_0,,,,2,1,1,2
C(C1(C(C2(C(O1)OCC2)O)O)O)=O,,,5,1,1,0,1
53181_0,,,,2,1,1,2
C1(C(O)OC2(C(O)OCC2)C1O)=O,,,5,1,1,0,1
53183_0,,,,2,1,1,2
C1(C(O)OC2(COC(C2)O)C1O)=O,,,5,1,1,0,1
53185_0,,,,2,1,1,2
C(C1(C=C)C(C(C(O1)O)=O)O)=O,,,5,1,1,0,1
53187_0,,,,2,1,1,2
C1(C(O)OC(C(C=C)=O)C1O)=O,,,5,1,1,0,1
53189_0,,,,2,1,1,2
C1(C(O)OC(C=CC=O)C1O)=O,,,5,1,1,0,1
53191_0,,,,2,1,1,2
C(C1C(C(C(O)O1)=O)O)=O,,,5,1,1,0,1
53193_0,,,,2,1,1,2
C(C1(C(C(CO)(CO1)O)O)O)=O,,,5,1,1,0,1
53195_0,,,,2,1,1,2
C1(C(O)OC(CO)(CO)C1O)=O,,,5,1,1,0,1
53197_0,,,,2,1,1,2
C(C1(C)C(C(C(O1)O)=O)O)=O,,,5,1,1,0,1
53198_0,,,,2,1,1,2
53199_0,,,,2,1,1,2
53200_0,,,,2,1,1,2
53201_0,,,,2,1,1,2
53203_0,,,,2,1,1,2
C(C1(CCO)C(C(C(O1)O)=O)O)=O,,,5,1,1,0,1
53205_0,,,,2,1,1,2
C(C1C(C(C(O1)O)=O)O)(CCO)=O,,,5,1,1,0,1
53207_0,,,,2,1,1,2
C(CC1C(C(C(C=O)(O)O1)O)O)=O,,,5,1,1,0,1
53209_0,,,,2,1,1,2
C(C(C(C1C(CC(O)O1)O)O)=O)=O,,,5,1,1,0,1
53211_0,,,,2,1,1,2
C(CC(C1C(C(C(O)O1)=O)O)O)=O,,,5,1,1,0,1
53213_0,,,,2,1,1,2
C(C(C(C1CC(C(O)O1)O)O)=O)=O,,,5,1,1,0,1
53215_0,,,,2,1,1,2
C(C(CC1C(C(C(O)O1)=O)O)O)=O,,,5,1,1,0,1
53217_0,,,,2,1,1,2
C(C(C1C(CC(CO)(O1)O)O)=O)=O,,,5,1,1,0,1
53219_0,,,,2,1,1,2
C(CO)(CC1C(C(C(O)O1)=O)O)=O,,,5,1,1,0,1
53220_0,,,,2,1,1,2
53222_0,,,,2,1,1,2
C(CC1(COC(C=O)(C1O)O)O)=O,,,5,1,1,0,1
53224_0,,,,2,1,1,2
C(C(C1C(CO)(CC(O1)O)O)=O)=O,,,5,1,1,0,1
53226_0,,,,2,1,1,2
C(CC1(CO)C(C(C(O)O1)=O)O)=O,,,5,1,1,0,1
53228_0,,,,2,1,1,2
C(C1(C(C(C(C(C)=O)O1)O)O)O)=O,,,5,1,1,0,1
53230_0,,,,2,1,1,2
C(C(C1C(C(C(C)(O1)O)O)O)=O)=O,,,5,1,1,0,1
53232_0,,,,2,1,1,2
C(C)(C(C1C(C(C(O)O1)=O)O)O)=O,,,5,1,1,0,1
53234_0,,,,2,1,1,2
C(C1C(C)(C(C(C=O)(O1)O)O)O)=O,,,5,1,1,0,1
53236_0,,,,2,1,1,2
C(C(C1C(C)(C(C(O1)O)O)O)=O)=O,,,5,1,1,0,1
53238_0,,,,2,1,1,2
C(C(C1(C)C(C(C(O)O1)=O)O)O)=O,,,5,1,1,0,1
53240_0,,,,2,1,1,2
C1(C(O)OC(C)C1O)=O,,,5,1,1,0,1
53242_0,,,,2,1,1,2
C(C1(C(CO)OC(CO)(C1)O)O)=O,,,5,1,1,0,1
53243_0,,,,2,1,1,2
53244_0,,,,2,1,1,2
53246_0,,,,2,1,1,2
C(C1(CC(C=O)(O)OC1CO)O)=O,,,5,1,1,0,1
53247_0,,,,2,1,1,2
53249_0,,,,2,1,1,2
C(C1C(O)OC(CO)C1(C=O)O)=O,,,5,1,1,0,1
53250_0,,,,2,1,1,2
53252_0,,,,2,1,1,2
C1(C(OC(C(C(CO)O)=O)C1)O)=O,,,5,1,1,0,1
53253_0,,,,2,1,1,2
53255_0,,,,2,1,1,2
C(C)(C1(COC(C)(C1O)O)O)=O,,,5,1,1,0,1
53257_0,,,,2,1,1,2
C(C)(C1(COC(CO)(C1)O)O)=O,,,5,1,1,0,1
53259_0,,,,2,1,1,2
C(C1(CC(C(C)=O)(CO1)O)O)(O)=O,,,5,1,1,0,1
53261_0,,,,2,1,1,2
C1(C(C=O)C(CO)(C(C)(O)O1)O)=O,,,5,1,1,0,1
53263_0,,,,2,1,1,2
C(C1C(O)OCC1(C(C)=O)O)(O)=O,,,5,1,1,0,1
53265_0,,,,2,1,1,2
C(C)(C1(COC(CO)(C1O)O)O)=O,,,5,1,1,0,1
53266_0,,,,2,1,1,2
53267_0,,,,2,1,1,2
53268_0,,,,2,1,1,2
53269_0,,,,2,1,1,2
53270_0,,,,2,1,1,2
53272_0,,,,2,1,1,2
C1(C(C=O)C(C)(C(CO)(O)O1)O)=O,,,5,1,1,0,1
53273_0,,,,2,1,1,2
53275_0,,,,2,1,1,2
C(C)(C1(C(C(CO1)(C)O)O)O)=O,,,5,1,1,0,1
53277_0,,,,2,1,1,2
C1(C(C)(O)OC(CO)(C)C1O)=O,,,5,1,1,0,1
53279_0,,,,2,1,1,2
C1(C(C(C(C(C)=O)(O)O1)O)O)=O,,,5,1,1,0,1
53281_0,,,,2,1,1,2
C(C1C(C(C(C)(O1)O)=O)O)(O)=O,,,5,1,1,0,1
53283_0,,,,2,1,1,2
C1(C(C)(C(C(C(C)=O)(O)O1)O)O)=O,,,5,1,1,0,1
53285_0,,,,2,1,1,2
C(C1(C)C(C(C(C)(O1)O)=O)O)(O)=O,,,5,1,1,0,1
53287_0,,,,2,1,1,2
C(CC1C(C(C(C)(O)O1)=O)O)(O)=O,,,5,1,1,0,1
53289_0,,,,2,1,1,2
C(C1(C=C)C(C(C(C)(O1)O)=O)O)=O,,,5,1,1,0,1
53291_0,,,,2,1,1,2
C1(C(C(C(C=C)=O)OC1(C)O)O)=O,,,5,1,1,0,1
53293_0,,,,2,1,1,2
C1(C(C(C=CC=O)OC1(C)O)O)=O,,,5,1,1,0,1
53295_0,,,,2,1,1,2
C(C)(C1(C(C(C(CO)O1)O)O)O)=O,,,5,1,1,0,1
53297_0,,,,2,1,1,2
C1(C(C)(O)OC(C(CO)O)C1O)=O,,,5,1,1,0,1
53299_0,,,,2,1,1,2
C(C1C(C(C(C)(O1)O)=O)O)=O,,,5,1,1,0,1
53301_0,,,,2,1,1,2
C(C)(C1(C(C(CO)(CO1)O)O)O)=O,,,5,1,1,0,1
53303_0,,,,2,1,1,2
C1(C(C)(O)OC(CO)(CO)C1O)=O,,,5,1,1,0,1
53305_0,,,,2,1,1,2
C(C1(C)C(C(C(C)(O1)O)=O)O)=O,,,5,1,1,0,1
53307_0,,,,2,1,1,2
C(C1C(C(C(C)(O1)O)=O)O)(C)=O,,,5,1,1,0,1
53308_0,,,,2,1,1,2
53310_0,,,,2,1,1,2
C(CC1C(C(C(C)(O)O1)=O)O)=O,,,5,1,1,0,1
53312_0,,,,2,1,1,2
C1(C(C)(O)OC(C)C1O)=O,,,5,1,1,0,1
53314_0,,,,2,1,1,2
C1(C(C)(O)OCC1O)=O,,,5,1,1,0,1
53315_0,,,,2,1,1,2
53317_0,,,,2,1,1,2
C1(C(C)(O)OC(CO)C1O)=O,,,5,1,1,0,1
53319_0,,,,2,1,1,2
C(CO)(C1(CC(CO1)(C)O)O)=O,,,5,1,1,0,1
53321_0,,,,2,1,1,2
C1(C(CO)(O)OC(CO)(C)C1)=O,,,5,1,1,0,1
53323_0,,,,2,1,1,2
C1(C(CC(C(CO)=O)(O)O1)O)=O,,,5,1,1,0,1
53325_0,,,,2,1,1,2
C1(CC(C(O)=O)OC1(CO)O)=O,,,5,1,1,0,1
53327_0,,,,2,1,1,2
C1(C(C)(CC(C(CO)=O)(O)O1)O)=O,,,5,1,1,0,1
53329_0,,,,2,1,1,2
C(C1(C)CC(C(CO)(O1)O)=O)(O)=O,,,5,1,1,0,1
53331_0,,,,2,1,1,2
C(CC1CC(C(CO)(O)O1)=O)(O)=O,,,5,1,1,0,1
53333_0,,,,2,1,1,2
C(C1(C=C)CC(C(CO)(O1)O)=O)=O,,,5,1,1,0,1
53335_0,,,,2,1,1,2
C1(CC(C(C=C)=O)OC1(CO)O)=O,,,5,1,1,0,1
53337_0,,,,2,1,1,2
C1(CC(C=CC=O)OC1(CO)O)=O,,,5,1,1,0,1
53338_0,,,,2,1,1,2
53339_0,,,,2,1,1,2
53340_0,,,,2,1,1,2
53341_0,,,,2,1,1,2
53342_0,,,,2,1,1,2
53343_0,,,,2,1,1,2
53344_0,,,,2,1,1,2
53345_0,,,,2,1,1,2
53346_0,,,,2,1,1,2
53347_0,,,,2,1,1,2
53348_0,,,,2,1,1,2
53349_0,,,,2,1,1,2
53351_0,,,,2,1,1,2
C(C1(C(C)OC(C)(C1O)O)O)=O,,,5,1,1,0,1
53353_0,,,,2,1,1,2
C(C1(C(C)OC(CO)(C1)O)O)=O,,,5,1,1,0,1
53355_0,,,,2,1,1,2
C(C1(CC(C(O)=O)(O)OC1C)O)=O,,,5,1,1,0,1
53357_0,,,,2,1,1,2
C1(C(C=O)C(C(O)O1)(C(C)O)O)=O,,,5,1,1,0,1
53359_0,,,,2,1,1,2
C(C1C(O)OC(C)C1(C=O)O)(O)=O,,,5,1,1,0,1
53361_0,,,,2,1,1,2
C(C1(C(C)OC(CO)(C1O)O)O)=O,,,5,1,1,0,1
53362_0,,,,2,1,1,2
53364_0,,,,2,1,1,2
C(C1(CC(C=O)(O)OC1C)O)=O,,,5,1,1,0,1
53366_0,,,,2,1,1,2
C(C1C(O)OC(C)C1(C=O)O)=O,,,5,1,1,0,1
53368_0,,,,2,1,1,2
C(C1(C(C)OC(C1O)O)O)=O,,,5,1,1,0,1
53370_0,,,,2,1,1,2
C1(C(C=O)C(C(C(C)O)(O)O1)O)=O,,,5,1,1,0,1
53371_0,,,,2,1,1,2
53373_0,,,,2,1,1,2
C1C(C)(C(C(C)(O)O1)O)O,,,5,1,1,0,1
53375_0,,,,2,1,1,2
C1C(C)(CC(CO)(O)O1)O,,,5,1,1,0,1
53377_0,,,,2,1,1,2
C1C(C)(C(C(CCO)(O)O1)O)O,,,5,1,1,0,1
53379_0,,,,2,1,1,2
C1C(C)(C(CO)C(CO)(O)O1)O,,,5,1,1,0,1
53381_0,,,,2,1,1,2
C1C(C)(CC(C(CO)O)(O)O1)O,,,5,1,1,0,1
53383_0,,,,2,1,1,2
C(C1(CC(CO1)(C)O)O)(O)=O,,,5,1,1,0,1
53385_0,,,,2,1,1,2
C(C1C(O)OCC1(C)O)(O)=O,,,5,1,1,0,1
53387_0,,,,2,1,1,2
C(C1(C(CO)C(CO1)(C)O)O)(O)=O,,,5,1,1,0,1
53389_0,,,,2,1,1,2
C1(C(C(C(O)O1)C(CO)(C)O)O)=O,,,5,1,1,0,1
53391_0,,,,2,1,1,2
C(C(C1C(O)OCC1(C)O)O)(O)=O,,,5,1,1,0,1
53393_0,,,,2,1,1,2
C(C1C(CO)(O)OCC1(C)O)(O)=O,,,5,1,1,0,1
53395_0,,,,2,1,1,2
C(CC1(C(C(CO1)(C)O)O)O)(O)=O,,,5,1,1,0,1
53397_0,,,,2,1,1,2
C(C(C1(CC(CO1)(C)O)O)O)(O)=O,,,5,1,1,0,1
53399_0,,,,2,1,1,2
C1C(C2(C(C(CO2)(C)O)O1)O)O,,,5,1,1,0,1
53401_0,,,,2,1,1,2
C1C(C)(C2COC(C2(O)O1)O)O,,,5,1,1,0,1
53403_0,,,,2,1,1,2
C1C(C)(C2C(O)OCC2(O)O1)O,,,5,1,1,0,1
53405_0,,,,2,1,1,2
C1C(C)(C2C(CC(O)O2)(O)O1)O,,,5,1,1,0,1
53407_0,,,,2,1,1,2
C1C(C)(C(C(CO)(O)O1)O)O,,,5,1,1,0,1
53409_0,,,,2,1,1,2
C1C(C)(C(C(C(CO)O)(O)O1)O)O,,,5,1,1,0,1
53410_0,,,,2,1,1,2
53412_0,,,,2,1,1,2
C(C1(CC(CO1)(C)O)O)=O,,,5,1,1,0,1
53414_0,,,,2,1,1,2
C(C1C(O)OCC1(C)O)=O,,,5,1,1,0,1
53415_0,,,,2,1,1,2
53416_0,,,,2,1,1,2
53418_0,,,,2,1,1,2
C(C1(C(CO)C(CO1)(C)O)O)=O,,,5,1,1,0,1
53419_0,,,,2,1,1,2
53421_0,,,,2,1,1,2
C(C(C1C(O)OCC1(C)O)O)=O,,,5,1,1,0,1
53422_0,,,,2,1,1,2
53424_0,,,,2,1,1,2
C(CO)(C1C(O)OCC1(C)O)=O,,,5,1,1,0,1
53426_0,,,,2,1,1,2
C(C1C(CO)(O)OCC1(C)O)=O,,,5,1,1,0,1
53427_0,,,,2,1,1,2
53429_0,,,,2,1,1,2
C(CC1(C(C(CO1)(C)O)O)O)=O,,,5,1,1,0,1
53431_0,,,,2,1,1,2
C(C(C1(CC(CO1)(C)O)O)O)=O,,,5,1,1,0,1
53433_0,,,,2,1,1,2
C1C(C)(CC(O)O1)O,,,5,1,1,0,1
53435_0,,,,2,1,1,2
C1C(C)(C(C(O)O1)O)O,,,5,1,1,0,1
53437_0,,,,2,1,1,2
CC1(C(C(CO1)(CCO)O)O)O,,,5,1,1,0,1
53439_0,,,,2,1,1,2
CC1(C(C(C(CCO)O1)O)O)O,,,5,1,1,0,1
53441_0,,,,2,1,1,2
CC1(C(C(C)(C(CO)O1)O)O)O,,,5,1,1,0,1
53443_0,,,,2,1,1,2
C1(C(C)(C(C(C)(O)O1)O)O)=O,,,5,1,1,0,1
53445_0,,,,2,1,1,2
C1(C(CCO)(C(C(C)(O)O1)O)O)=O,,,5,1,1,0,1
53447_0,,,,2,1,1,2
C(CC1C(C(C(C)(O)O1)O)O)(O)=O,,,5,1,1,0,1
53449_0,,,,2,1,1,2
C(CC1(COC(C)(C1O)O)O)(O)=O,,,5,1,1,0,1
53451_0,,,,2,1,1,2
C(C1C(C)(C(C(C)(O1)O)O)O)(O)=O,,,5,1,1,0,1
53453_0,,,,2,1,1,2
CC1(C(C2(COCC2O1)O)O)O,,,5,1,1,0,1
53455_0,,,,2,1,1,2
CC1(C(C2(C(OCC2)O1)O)O)O,,,5,1,1,0,1
53456_0,,,,2,1,1,2
53458_0,,,,2,1,1,2
CC1(C(C(C(C(CO)O)O1)O)O)O,,,5,1,1,0,1
53459_0,,,,2,1,1,2
53461_0,,,,2,1,1,2
C1C(C(CO)O)(C(C(C)(O)O1)O)O,,,5,1,1,0,1
53462_0,,,,2,1,1,2
53463_0,,,,2,1,1,2
53464_0,,,,2,1,1,2
53466_0,,,,2,1,1,2
C(C)(C(C1CC(C(O)O1)O)O)=O,,,5,1,1,0,1
53467_0,,,,2,1,1,2
53468_0,,,,2,1,1,2
53470_0,,,,2,1,1,2
C(CC1(COC(C)(C1O)O)O)=O,,,5,1,1,0,1
53471_0,,,,2,1,1,2
53473_0,,,,2,1,1,2
C(C)(C1C(C(C(C)(O1)O)O)O)=O,,,5,1,1,0,1
53475_0,,,,2,1,1,2
C(C1C(C)(C(C(C)(O1)O)O)O)=O,,,5,1,1,0,1
53477_0,,,,2,1,1,2
C(C)(C1C(C)(C(C(O1)O)O)O)=O,,,5,1,1,0,1
53479_0,,,,2,1,1,2
CC1(C(C(CO1)O)O)O,,,5,1,1,0,1
53481_0,,,,2,1,1,2
C1C(CCO)(CC(CO)(O)O1)O,,,5,1,1,0,1
53483_0,,,,2,1,1,2
C(C1(CC(C(CCO)O1)O)O)O,,,5,1,1,0,1
53485_0,,,,2,1,1,2
CC1(CC(CO)(O)OC1CO)O,,,5,1,1,0,1
53487_0,,,,2,1,1,2
C1(C(C)(CC(CO)(O)O1)O)=O,,,5,1,1,0,1
53489_0,,,,2,1,1,2
C1(C(CCO)(CC(CO)(O)O1)O)=O,,,5,1,1,0,1
53491_0,,,,2,1,1,2
C(CC1C(CC(CO)(O)O1)O)(O)=O,,,5,1,1,0,1
53493_0,,,,2,1,1,2
C(CC1(COC(CO)(C1)O)O)(O)=O,,,5,1,1,0,1
53495_0,,,,2,1,1,2
C(C1C(C)(CC(CO)(O1)O)O)(O)=O,,,5,1,1,0,1
53497_0,,,,2,1,1,2
C1C2(C(CO1)OC(CO)(C2)O)O,,,5,1,1,0,1
53499_0,,,,2,1,1,2
C12C(CCO1)(CC(CO)(O)O2)O,,,5,1,1,0,1
53500_0,,,,2,1,1,2
53501_0,,,,2,1,1,2
53502_0,,,,2,1,1,2
53503_0,,,,2,1,1,2
53504_0,,,,2,1,1,2
53505_0,,,,2,1,1,2
53506_0,,,,2,1,1,2
53507_0,,,,2,1,1,2
53508_0,,,,2,1,1,2
53509_0,,,,2,1,1,2
53510_0,,,,2,1,1,2
53511_0,,,,2,1,1,2
53512_0,,,,2,1,1,2
53513_0,,,,2,1,1,2
53515_0,,,,2,1,1,2
C(C1(CC(CO1)(CCO)O)O)(O)=O,,,5,1,1,0,1
53517_0,,,,2,1,1,2
C(C1C(O)OCC1(CCO)O)(O)=O,,,5,1,1,0,1
53518_0,,,,2,1,1,2
53519_0,,,,2,1,1,2
53520_0,,,,2,1,1,2
53521_0,,,,2,1,1,2
53522_0,,,,2,1,1,2
53523_0,,,,2,1,1,2
53525_0,,,,2,1,1,2
C1(C(C)(C(C(CCO)(O)O1)O)O)=O,,,5,1,1,0,1
53526_0,,,,2,1,1,2
53527_0,,,,2,1,1,2
53528_0,,,,2,1,1,2
53530_0,,,,2,1,1,2
C1(C(C(CO)C(CO)(O)O1)O)=O,,,5,1,1,0,1
53532_0,,,,2,1,1,2
C1(C(C)(C(CO)C(CO)(O)O1)O)=O,,,5,1,1,0,1
53534_0,,,,2,1,1,2
C(CO)(C1COC(C1(C=C)O)O)=O,,,5,1,1,0,1
53536_0,,,,2,1,1,2
C(CO)(C1COC(C=C)(C1O)O)=O,,,5,1,1,0,1
53537_0,,,,2,1,1,2
53538_0,,,,2,1,1,2
53539_0,,,,2,1,1,2
53540_0,,,,2,1,1,2
53541_0,,,,2,1,1,2
53542_0,,,,2,1,1,2
53544_0,,,,2,1,1,2
C(C1(CC(C(CCO)O1)O)O)(O)=O,,,5,1,1,0,1
53546_0,,,,2,1,1,2
C(C1C(O)OC(C1O)CCO)(O)=O,,,5,1,1,0,1
53547_0,,,,2,1,1,2
53548_0,,,,2,1,1,2
53549_0,,,,2,1,1,2
53550_0,,,,2,1,1,2
53551_0,,,,2,1,1,2
53552_0,,,,2,1,1,2
53554_0,,,,2,1,1,2
C(C1(CC(C)(C(CO)O1)O)O)(O)=O,,,5,1,1,0,1
53556_0,,,,2,1,1,2
C(C1C(O)OC(CO)C1(C)O)(O)=O,,,5,1,1,0,1
53557_0,,,,2,1,1,2
53558_0,,,,2,1,1,2
53559_0,,,,2,1,1,2
53560_0,,,,2,1,1,2
53561_0,,,,2,1,1,2
53562_0,,,,2,1,1,2
53564_0,,,,2,1,1,2
C1(C(C)(CC(C(CO)O)(O)O1)O)=O,,,5,1,1,0,1
53565_0,,,,2,1,1,2
53566_0,,,,2,1,1,2
53567_0,,,,2,1,1,2
53569_0,,,,2,1,1,2
C1(C(CC(C(O)=O)(O)O1)O)=O,,,5,1,1,0,1
53571_0,,,,2,1,1,2
C(C1C(O)OC(C1O)=O)(O)=O,,,5,1,1,0,1
53573_0,,,,2,1,1,2
C1(C(C(CO)C(C(O)=O)(O)O1)O)=O,,,5,1,1,0,1
53575_0,,,,2,1,1,2
C1(C(C(C(O)O1)C(C(O)=O)O)O)=O,,,5,1,1,0,1
53577_0,,,,2,1,1,2
C(C1C(CO)(O)OC(C1O)=O)(O)=O,,,5,1,1,0,1
53579_0,,,,2,1,1,2
C(CC1(C(C(C(O1)=O)O)O)O)(O)=O,,,5,1,1,0,1
53581_0,,,,2,1,1,2
C1(C(CC(C(C(O)=O)O)(O)O1)O)=O,,,5,1,1,0,1
53583_0,,,,2,1,1,2
C1(C(C2C(C(CO2)O)(O)O1)O)=O,,,5,1,1,0,1
53585_0,,,,2,1,1,2
C1(C(C2COC(C2(O)O1)O)O)=O,,,5,1,1,0,1
53587_0,,,,2,1,1,2
C1(C(C2C(O)OCC2(O)O1)O)=O,,,5,1,1,0,1
53589_0,,,,2,1,1,2
C1(C(C2C(CC(O)O2)(O)O1)O)=O,,,5,1,1,0,1
53591_0,,,,2,1,1,2
C1(C(C(C(CO)(O)O1)O)O)=O,,,5,1,1,0,1
53593_0,,,,2,1,1,2
C1(C(C(C(C(CO)O)(O)O1)O)O)=O,,,5,1,1,0,1
53594_0,,,,2,1,1,2
53596_0,,,,2,1,1,2
C1(C(CC(C=O)(O)O1)O)=O,,,5,1,1,0,1
53598_0,,,,2,1,1,2
C(C1C(O)OC(C1O)=O)=O,,,5,1,1,0,1
53599_0,,,,2,1,1,2
53600_0,,,,2,1,1,2
53602_0,,,,2,1,1,2
C1(C(C(CO)C(C=O)(O)O1)O)=O,,,5,1,1,0,1
53603_0,,,,2,1,1,2
53605_0,,,,2,1,1,2
C1(C(C(C(O)O1)C(C=O)O)O)=O,,,5,1,1,0,1
53606_0,,,,2,1,1,2
53608_0,,,,2,1,1,2
C(CO)(C1C(O)OC(C1O)=O)=O,,,5,1,1,0,1
53610_0,,,,2,1,1,2
C(C1C(CO)(O)OC(C1O)=O)=O,,,5,1,1,0,1
53611_0,,,,2,1,1,2
53613_0,,,,2,1,1,2
C(CC1(C(C(C(O1)=O)O)O)O)=O,,,5,1,1,0,1
53615_0,,,,2,1,1,2
C1(C(CC(C(C=O)O)(O)O1)O)=O,,,5,1,1,0,1
53617_0,,,,2,1,1,2
C1(C(C)(CC(C(O)=O)(O)O1)O)=O,,,5,1,1,0,1
53619_0,,,,2,1,1,2
C(C1C(O)OC(C1(C)O)=O)(O)=O,,,5,1,1,0,1
53621_0,,,,2,1,1,2
C1(C(C)(C2C(C(CO2)O)(O)O1)O)=O,,,5,1,1,0,1
53623_0,,,,2,1,1,2
C1(C(C)(C2COC(C2(O)O1)O)O)=O,,,5,1,1,0,1
53625_0,,,,2,1,1,2
C1(C(C)(C2C(O)OCC2(O)O1)O)=O,,,5,1,1,0,1
53627_0,,,,2,1,1,2
C1(C(C)(C2C(CC(O)O2)(O)O1)O)=O,,,5,1,1,0,1
53629_0,,,,2,1,1,2
C1(C(C)(C(C(CO)(O)O1)O)O)=O,,,5,1,1,0,1
53630_0,,,,2,1,1,2
53632_0,,,,2,1,1,2
C1(C(C)(CC(C=O)(O)O1)O)=O,,,5,1,1,0,1
53634_0,,,,2,1,1,2
C(C1C(O)OC(C1(C)O)=O)=O,,,5,1,1,0,1
53635_0,,,,2,1,1,2
53636_0,,,,2,1,1,2
53638_0,,,,2,1,1,2
C1(C(C)(C(CO)C(C=O)(O)O1)O)=O,,,5,1,1,0,1
53639_0,,,,2,1,1,2
53641_0,,,,2,1,1,2
C1(C(C)(C(C(O)O1)C(C=O)O)O)=O,,,5,1,1,0,1
53642_0,,,,2,1,1,2
53644_0,,,,2,1,1,2
C1(C(C)(C(C(CO)=O)C(O)O1)O)=O,,,5,1,1,0,1
53646_0,,,,2,1,1,2
C(C1C(CO)(O)OC(C1(C)O)=O)=O,,,5,1,1,0,1
53647_0,,,,2,1,1,2
53649_0,,,,2,1,1,2
C1(C(C)(C(C(CC=O)(O)O1)O)O)=O,,,5,1,1,0,1
53651_0,,,,2,1,1,2
C1(C(C)(CC(C(C=O)O)(O)O1)O)=O,,,5,1,1,0,1
53653_0,,,,2,1,1,2
C1(C(C)(CC(O)O1)O)=O,,,5,1,1,0,1
53655_0,,,,2,1,1,2
C1(C(C)(C(C(O)O1)O)O)=O,,,5,1,1,0,1
53657_0,,,,2,1,1,2
C(C1(CC2(COCC2O1)O)O)(O)=O,,,5,1,1,0,1
53659_0,,,,2,1,1,2
C(C1(CC2(C(O1)OCC2)O)O)(O)=O,,,5,1,1,0,1
53660_0,,,,2,1,1,2
53661_0,,,,2,1,1,2
53662_0,,,,2,1,1,2
53663_0,,,,2,1,1,2
53664_0,,,,2,1,1,2
53665_0,,,,2,1,1,2
53666_0,,,,2,1,1,2
53667_0,,,,2,1,1,2
53668_0,,,,2,1,1,2
53669_0,,,,2,1,1,2
53670_0,,,,2,1,1,2
53671_0,,,,2,1,1,2
53672_0,,,,2,1,1,2
53673_0,,,,2,1,1,2
53674_0,,,,2,1,1,2
53676_0,,,,2,1,1,2
C(C1C(O)OC2COCC21O)(O)=O,,,5,1,1,0,1
53678_0,,,,2,1,1,2
C(C1C(O)OC2C1(CCO2)O)(O)=O,,,5,1,1,0,1
53680_0,,,,2,1,1,2
C1(C(C=O)C(C=C)(C(O)O1)O)=O,,,5,1,1,0,1
53682_0,,,,2,1,1,2
C1(C(C=O)C(C(C=C)(O)O1)O)=O,,,5,1,1,0,1
53683_0,,,,2,1,1,2
53684_0,,,,2,1,1,2
53685_0,,,,2,1,1,2
53686_0,,,,2,1,1,2
53687_0,,,,2,1,1,2
53688_0,,,,2,1,1,2
53690_0,,,,2,1,1,2
C1(C(C=O)C(C(O)O1)(CCO)O)=O,,,5,1,1,0,1
53692_0,,,,2,1,1,2
C1(C(C=O)C(C(CCO)(O)O1)O)=O,,,5,1,1,0,1
53693_0,,,,2,1,1,2
53694_0,,,,2,1,1,2
53695_0,,,,2,1,1,2
53696_0,,,,2,1,1,2
53697_0,,,,2,1,1,2
53698_0,,,,2,1,1,2
53699_0,,,,2,1,1,2
53700_0,,,,2,1,1,2
53701_0,,,,2,1,1,2
53703_0,,,,2,1,1,2
C1(C(CC(C=O)(O)O1)(CCO)O)=O,,,5,1,1,0,1
53705_0,,,,2,1,1,2
C(C1C(O)OC(C1(CCO)O)=O)=O,,,5,1,1,0,1
53707_0,,,,2,1,1,2
C1(C(CCO)(CC(O)O1)O)=O,,,5,1,1,0,1
53709_0,,,,2,1,1,2
C1(C(C(C(O)O1)O)(CCO)O)=O,,,5,1,1,0,1
53710_0,,,,2,1,1,2
53711_0,,,,2,1,1,2
53712_0,,,,2,1,1,2
53713_0,,,,2,1,1,2
53714_0,,,,2,1,1,2
53715_0,,,,2,1,1,2
53716_0,,,,2,1,1,2
53717_0,,,,2,1,1,2
53718_0,,,,2,1,1,2
53719_0,,,,2,1,1,2
53720_0,,,,2,1,1,2
53721_0,,,,2,1,1,2
53722_0,,,,2,1,1,2
53723_0,,,,2,1,1,2
53724_0,,,,2,1,1,2
53725_0,,,,2,1,1,2
53727_0,,,,2,1,1,2
C1(C(C(CO)=O)C(C)(C(O)O1)O)=O,,,5,1,1,0,1
53729_0,,,,2,1,1,2
C1(C(C(CO)=O)C(C(C)(O)O1)O)=O,,,5,1,1,0,1
53730_0,,,,2,1,1,2
53731_0,,,,2,1,1,2
53732_0,,,,2,1,1,2
53733_0,,,,2,1,1,2
53734_0,,,,2,1,1,2
53735_0,,,,2,1,1,2
53736_0,,,,2,1,1,2
53737_0,,,,2,1,1,2
53738_0,,,,2,1,1,2
53739_0,,,,2,1,1,2
53740_0,,,,2,1,1,2
53742_0,,,,2,1,1,2
C(C1(CO)C(C(CO)C(O1)O)O)=O,,,5,1,1,0,1
53743_0,,,,2,1,1,2
53744_0,,,,2,1,1,2
53745_0,,,,2,1,1,2
53747_0,,,,2,1,1,2
C(C1C(C(CO)(C(C)(O1)O)O)O)=O,,,5,1,1,0,1
53748_0,,,,2,1,1,2
53749_0,,,,2,1,1,2
53750_0,,,,2,1,1,2
53751_0,,,,2,1,1,2
53753_0,,,,2,1,1,2
C(C1(C(COC1(CCO)O)O)O)=O,,,5,1,1,0,1
53755_0,,,,2,1,1,2
CC(C1(CO)C(CC(O)O1)O)O,,,5,1,1,0,1
53757_0,,,,2,1,1,2
CC(C1(CO)C(C(C(O)O1)O)O)O,,,5,1,1,0,1
53759_0,,,,2,1,1,2
C(C1(C(C(OC1C=O)O)CO)O)=O,,,5,1,1,0,1
53761_0,,,,2,1,1,2
C(C1COC(C1(C(C=O)O)O)O)=O,,,5,1,1,0,1
53762_0,,,,2,1,1,2
53764_0,,,,2,1,1,2
C(C(C1(C)C(CC(O)O1)O)O)(O)=O,,,5,1,1,0,1
53766_0,,,,2,1,1,2
C(C(C1C(C)(CC(O)O1)O)O)(O)=O,,,5,1,1,0,1
53768_0,,,,2,1,1,2
C1(C(C(C(CC(C)O)(O)O1)O)O)=O,,,5,1,1,0,1
53770_0,,,,2,1,1,2
C(C1C(C(C(O1)O)C(C)O)O)(O)=O,,,5,1,1,0,1
53772_0,,,,2,1,1,2
C(C1C(C(CO)C(O1)O)O)(O)=O,,,5,1,1,0,1
53774_0,,,,2,1,1,2
C(CC1C(CC(O)O1)(C(C)O)O)=O,,,5,1,1,0,1
53776_0,,,,2,1,1,2
C(CC1(C(CC(O)O1)O)C(C)O)=O,,,5,1,1,0,1
53777_0,,,,2,1,1,2
53779_0,,,,2,1,1,2
C(CC1CC(C(O)O1)(C(C)O)O)=O,,,5,1,1,0,1
53780_0,,,,2,1,1,2
53781_0,,,,2,1,1,2
53782_0,,,,2,1,1,2
53784_0,,,,2,1,1,2
C(CC1CC(C(O)O1)(CO)O)=O,,,5,1,1,0,1
53786_0,,,,2,1,1,2
C(C(C1CC(C(O)O1)(CO)O)O)=O,,,5,1,1,0,1
53788_0,,,,2,1,1,2
C(CC1(CO)CC(C(O)O1)O)=O,,,5,1,1,0,1
53789_0,,,,2,1,1,2
53791_0,,,,2,1,1,2
C(C(C1(CO)CC(C(O)O1)O)O)=O,,,5,1,1,0,1
53793_0,,,,2,1,1,2
C(C(CC1(COC(C1O)O)O)O)=O,,,5,1,1,0,1
53795_0,,,,2,1,1,2
C(CO)(C1C(C(OC1C=O)O)O)=O,,,5,1,1,0,1
53797_0,,,,2,1,1,2
C(CO)(C1C(C)OC(C1O)O)=O,,,5,1,1,0,1
53799_0,,,,2,1,1,2
C(C(C1C(CO)(O)OCC1O)O)=O,,,5,1,1,0,1
53801_0,,,,2,1,1,2
C(CO)(C1C(CO)OC(C1O)O)=O,,,5,1,1,0,1
53803_0,,,,2,1,1,2
C(C(CC1(C(C(CO1)O)O)O)O)=O,,,5,1,1,0,1
53805_0,,,,2,1,1,2
C(C(CO)O)(C1COC(C1O)O)=O,,,5,1,1,0,1
53807_0,,,,2,1,1,2
C1(C(CC(O)O1)(CC(CO)O)O)=O,,,5,1,1,0,1
53809_0,,,,2,1,1,2
C(C1(C(C(C)O)C(CO1)O)O)(O)=O,,,5,1,1,0,1
53810_0,,,,2,1,1,2
53812_0,,,,2,1,1,2
C1(C(C(C(C)O)C(CO)(O)O1)O)=O,,,5,1,1,0,1
53814_0,,,,2,1,1,2
C1(C(CC(C(C(C)O)O)(O)O1)O)=O,,,5,1,1,0,1
53816_0,,,,2,1,1,2
C(CC1(C(CO)OC(C1)O)O)(O)=O,,,5,1,1,0,1
53818_0,,,,2,1,1,2
C(C1C(CC(O1)O)(CCO)O)(O)=O,,,5,1,1,0,1
53820_0,,,,2,1,1,2
C1C2(C(CO1)OC(CO)(C2O)O)O,,,5,1,1,0,1
53822_0,,,,2,1,1,2
C1(C(O)OC2(COCC2O)C1)=O,,,5,1,1,0,1
53824_0,,,,2,1,1,2
C(C1(CC2(COCC2O1)O)O)=O,,,5,1,1,0,1
53826_0,,,,2,1,1,2
C(C1C(O)OC2COCC21O)=O,,,5,1,1,0,1
53828_0,,,,2,1,1,2
C1C2(C(CO1)OC(C2)O)O,,,5,1,1,0,1
53830_0,,,,2,1,1,2
C1C2(C(CO1)OC(C2O)O)O,,,5,1,1,0,1
53832_0,,,,2,1,1,2
C1C(C2(C(C(C(CO)O2)O)O1)O)O,,,5,1,1,0,1
53834_0,,,,2,1,1,2
C1C(C2(C(C(CO2)(CO)O)O1)O)O,,,5,1,1,0,1
53836_0,,,,2,1,1,2
C1C(C2(C(C(CO2)O)O1)O)O,,,5,1,1,0,1
53838_0,,,,2,1,1,2
C12C(CCO1)(C(C(CO)(O)O2)O)O,,,5,1,1,0,1
53840_0,,,,2,1,1,2
C1(C(O)OC2(C(O)OCC2)C1)=O,,,5,1,2,0,2
53842_0,,,,2,1,1,2
C(C1(CC2(C(O1)OCC2)O)O)=O,,,5,1,1,0,1
53844_0,,,,2,1,1,2
C(C1C(O)OC2C1(CCO2)O)=O,,,5,1,1,0,1
53846_0,,,,2,1,1,2
C12C(CCO1)(CC(O)O2)O,,,5,1,1,0,1
53848_0,,,,2,1,1,2
C12C(CCO1)(C(C(O)O2)O)O,,,5,1,1,0,1
53850_0,,,,2,1,1,2
C1C2C(C(O)O1)(O)OC(CO)C2O,,,5,1,2,0,2
53852_0,,,,2,1,1,2
C1C(CO)(C2COC(C2(O)O1)O)O,,,5,1,2,0,2
53854_0,,,,2,1,1,2
C1C2C(COC2(C(O)O1)O)O,,,5,1,2,0,2
53856_0,,,,2,1,1,2
C1(C(O)OC2(COC(C2)O)C1)=O,,,5,1,2,0,2
53858_0,,,,2,1,1,2
C1(COC2C1C(C=C)(C(O)O2)O)=O,,,5,1,1,0,1
53860_0,,,,2,1,1,2
C1(COC2C1C(C(C=C)(O)O2)O)=O,,,5,1,1,0,1
53862_0,,,,2,1,1,2
C1C2(C(C(O)O1)C(C(CO)O2)O)O,,,5,1,2,0,2
53864_0,,,,2,1,1,2
C1(COC2C1C(C(O)O2)O)=O,,,5,1,1,0,1
53866_0,,,,2,1,1,2
C1C(CO)(C2C(O)OCC2(O)O1)O,,,5,1,2,0,2
53868_0,,,,2,1,1,2
C1(COC2C1C(C(O)O2)(C)O)=O,,,5,1,1,0,1
53870_0,,,,2,1,1,2
C1(COC2C1C(C(C)(O)O2)O)=O,,,5,1,1,0,1
53872_0,,,,2,1,1,2
C1C(C2C(O)OCC2(O)O1)O,,,5,1,2,0,2
53874_0,,,,2,1,1,2
C1(CC2(C(C(C(CO)O2)O)O1)O)O,,,5,1,2,0,2
53876_0,,,,2,1,1,2
C1C(CO)(C2C(CC(O)O2)(O)O1)O,,,5,1,2,0,2
53878_0,,,,2,1,1,2
C1C(C2C(CC(O)O2)(O)O1)O,,,5,1,2,0,2
53879_0,,,,2,1,1,2
53881_0,,,,2,1,1,2
C(C1(C=C)C(C(C(O1)O)=O)CO)=O,,,5,1,1,0,1
53882_0,,,,2,1,1,2
53884_0,,,,2,1,1,2
C=CC1(C(O)OCC1C(C=O)=O)O,,,5,1,1,0,1
53886_0,,,,2,1,1,2
C(C1C(C=O)C(C=C)(C(O1)O)O)=O,,,5,1,1,0,1
53888_0,,,,2,1,1,2
C(C1(C=C)C(C=O)C(C(O1)O)O)=O,,,5,1,1,0,1
53889_0,,,,2,1,1,2
53890_0,,,,2,1,1,2
53891_0,,,,2,1,1,2
53893_0,,,,2,1,1,2
C1(C(OC(C(C=C)=O)C1CO)O)=O,,,5,1,1,0,1
53894_0,,,,2,1,1,2
53896_0,,,,2,1,1,2
C=CC1(C(C(C(C=O)=O)CO1)O)O,,,5,1,1,0,1
53898_0,,,,2,1,1,2
C(C1C(C(C=C)(OC1C=O)O)O)=O,,,5,1,1,0,1
53900_0,,,,2,1,1,2
C(C1C(C(OC1C(C=C)=O)O)O)=O,,,5,1,1,0,1
53901_0,,,,2,1,1,2
53902_0,,,,2,1,1,2
53903_0,,,,2,1,1,2
53905_0,,,,2,1,1,2
C1(C(OC(C=CC=O)C1CO)O)=O,,,5,1,1,0,1
53906_0,,,,2,1,1,2
53908_0,,,,2,1,1,2
C(C1C(C(OC1C=CC=O)O)O)=O,,,5,1,1,0,1
53909_0,,,,2,1,1,2
53910_0,,,,2,1,1,2
53912_0,,,,2,1,1,2
C(C1CC(C(O1)O)O)(O)=O,,,5,1,1,0,1
53914_0,,,,2,1,1,2
C(C1C(CO)C(C(O1)O)O)(O)=O,,,5,1,1,0,1
53915_0,,,,2,1,1,2
53917_0,,,,2,1,1,2
C(C1CC(C)(C(O1)O)O)(O)=O,,,5,1,1,0,1
53919_0,,,,2,1,1,2
C(C1C(CO)C(C)(C(O1)O)O)(O)=O,,,5,1,1,0,1
53920_0,,,,2,1,1,2
53922_0,,,,2,1,1,2
C(C1CC(C(C)(O1)O)O)(O)=O,,,5,1,1,0,1
53924_0,,,,2,1,1,2
C(C1C(CO)C(C(C)(O1)O)O)(O)=O,,,5,1,1,0,1
53925_0,,,,2,1,1,2
53927_0,,,,2,1,1,2
C(C1CC(C(O1)O)(CCO)O)(O)=O,,,5,1,1,0,1
53928_0,,,,2,1,1,2
53930_0,,,,2,1,1,2
C(C1CC(C(CCO)(O1)O)O)(O)=O,,,5,1,1,0,1
53931_0,,,,2,1,1,2
53932_0,,,,2,1,1,2
53933_0,,,,2,1,1,2
53935_0,,,,2,1,1,2
C(CO)(C1(C(C(CO1)O)O)O)=O,,,5,1,1,0,1
53936_0,,,,2,1,1,2
53937_0,,,,2,1,1,2
53938_0,,,,2,1,1,2
53940_0,,,,2,1,1,2
C1(C(CO)(O)OCC1(CO)O)=O,,,5,1,1,0,1
53941_0,,,,2,1,1,2
53942_0,,,,2,1,1,2
53943_0,,,,2,1,1,2
53944_0,,,,2,1,1,2
53946_0,,,,2,1,1,2
C(C1(C(CO)(C(CO1)O)O)O)=O,,,5,1,1,0,1
53948_0,,,,2,1,1,2
C(C1(CCOC1(C=O)O)O)=O,,,5,1,1,0,1
53949_0,,,,2,1,1,2
53950_0,,,,2,1,1,2
53952_0,,,,2,1,1,2
C(C1CC(C(C=O)(O1)O)O)=O,,,5,1,1,0,1
53954_0,,,,2,1,1,2
C(CC1(C(C(O)OC1)=O)O)=O,,,5,1,1,0,1
53955_0,,,,2,1,1,2
53957_0,,,,2,1,1,2
C1(C(OC(C=O)C1(C)O)O)=O,,,5,1,1,0,1
53958_0,,,,2,1,1,2
53959_0,,,,2,1,1,2
53960_0,,,,2,1,1,2
53961_0,,,,2,1,1,2
53962_0,,,,2,1,1,2
53963_0,,,,2,1,1,2
53964_0,,,,2,1,1,2
53966_0,,,,2,1,1,2
C1(COC(C)(C1O)O)=O,,,5,1,1,0,1
53967_0,,,,2,1,1,2
53968_0,,,,2,1,1,2
53969_0,,,,2,1,1,2
53970_0,,,,2,1,1,2
53971_0,,,,2,1,1,2
53972_0,,,,2,1,1,2
53973_0,,,,2,1,1,2
53974_0,,,,2,1,1,2
53975_0,,,,2,1,1,2
53977_0,,,,2,1,1,2
C(CO)(C1C(C(C(O1)O)O)O)=O,,,5,1,1,0,1
53979_0,,,,2,1,1,2
C(C1C(C(C(CO)(O1)O)O)O)=O,,,5,1,1,0,1
53981_0,,,,2,1,1,2
C1(C(CO)OC(CO)(C1O)O)=O,,,5,1,1,0,1
53983_0,,,,2,1,1,2
C1(COC(C(CO)O)(C1O)O)=O,,,5,1,1,0,1
53985_0,,,,2,1,1,2
C1(COC(C=O)(C1CO)O)=O,,,5,1,1,0,1
53986_0,,,,2,1,1,2
53987_0,,,,2,1,1,2
53989_0,,,,2,1,1,2
C(C1C(COC1(CO)O)=O)=O,,,5,1,1,0,1
53991_0,,,,2,1,1,2
C(CC1C(C(C(O1)O)O)=O)=O,,,5,1,1,0,1
53992_0,,,,2,1,1,2
53994_0,,,,2,1,1,2
C(CC1(C(C(CO1)=O)O)O)=O,,,5,1,1,0,1
53996_0,,,,2,1,1,2
C(C1C(CC(CO)(O1)O)=O)=O,,,5,1,1,0,1
53998_0,,,,2,1,1,2
C(C(C1(CC(CO1)=O)O)O)=O,,,5,1,1,0,1
54000_0,,,,2,1,1,2
C(C1(C(CC(CO)(CO)O1)O)O)=O,,,5,1,1,0,1
54002_0,,,,2,1,1,2
C1(C(CO)OC(C1(C)O)O)=O,,,5,1,1,0,1
54004_0,,,,2,1,1,2
C(C1C(C(C)(C(O1)O)O)O)=O,,,5,1,1,0,1
54005_0,,,,2,1,1,2
54007_0,,,,2,1,1,2
C1(COC(C(C)O)(C1O)O)=O,,,5,1,1,0,1
54009_0,,,,2,1,1,2
C1(C(C)OC(CO)(C1O)O)=O,,,5,1,1,0,1
54011_0,,,,2,1,1,2
C1(C(CO)OC(C)(C1O)O)=O,,,5,1,1,0,1
54012_0,,,,2,1,1,2
54014_0,,,,2,1,1,2
C(C1(CCOC1(C(CO)O)O)O)=O,,,5,1,1,0,1
54016_0,,,,2,1,1,2
C1(C(CO)OC(C1(CCO)O)O)=O,,,5,1,1,0,1
54017_0,,,,2,1,1,2
54019_0,,,,2,1,1,2
C(C1C(C(C(O1)O)(CCO)O)O)=O,,,5,1,1,0,1
54020_0,,,,2,1,1,2
54022_0,,,,2,1,1,2
C(CO)(C(C1(C(CCO1)O)O)O)=O,,,5,1,1,0,1
54024_0,,,,2,1,1,2
C1(COC(C(CCO)O)(C1O)O)=O,,,5,1,1,0,1
54026_0,,,,2,1,1,2
C1(C(CCO)OC(CO)(C1O)O)=O,,,5,1,1,0,1
54028_0,,,,2,1,1,2
C1(C(CO)OC(CCO)(C1O)O)=O,,,5,1,1,0,1
54030_0,,,,2,1,1,2
C(C1CC(C(C(CO)O)(O1)O)O)=O,,,5,1,1,0,1
54031_0,,,,2,1,1,2
54032_0,,,,2,1,1,2
54033_0,,,,2,1,1,2
54034_0,,,,2,1,1,2
54035_0,,,,2,1,1,2
54037_0,,,,2,1,1,2
C1(C(C(CO)O)OC(C1(C)O)O)=O,,,5,1,1,0,1
54038_0,,,,2,1,1,2
54040_0,,,,2,1,1,2
C(CO)(C1C(C(C(O1)O)(C)O)O)=O,,,5,1,1,0,1
54042_0,,,,2,1,1,2
C(C1(C)C(C(C(CO)(O1)O)O)O)=O,,,5,1,1,0,1
54044_0,,,,2,1,1,2
C1(C(CO)OC(C(C)O)(C1O)O)=O,,,5,1,1,0,1
54046_0,,,,2,1,1,2
C1(C(C)OC(C(CO)O)(C1O)O)=O,,,5,1,1,0,1
54048_0,,,,2,1,1,2
C1(C(C(CO)O)OC(C)(C1O)O)=O,,,5,1,1,0,1
54049_0,,,,2,1,1,2
54050_0,,,,2,1,1,2
54052_0,,,,2,1,1,2
CC1C(C(C(CO)(O)O1)O)O,,,5,1,1,0,1
54054_0,,,,2,1,1,2
C(CC1C(C(C(O1)O)(C)O)=O)=O,,,5,1,1,0,1
54056_0,,,,2,1,1,2
C(C(C1CC(C)(C(O1)O)O)=O)=O,,,5,1,1,0,1
54058_0,,,,2,1,1,2
C(C1(C)CC(C(C=O)(O1)O)O)=O,,,5,1,1,0,1
54060_0,,,,2,1,1,2
C1(COC(C1(C)O)O)=O,,,5,1,1,0,1
54062_0,,,,2,1,1,2
C1(CC(C=O)(OC1C)O)=O,,,5,1,1,0,1
54064_0,,,,2,1,1,2
C(C1C(C(C)OC1O)=O)=O,,,5,1,1,0,1
54066_0,,,,2,1,1,2
C1(C(CO)C(C=O)(OC1C)O)=O,,,5,1,1,0,1
54067_0,,,,2,1,1,2
54069_0,,,,2,1,1,2
C1(C(C)OC(C1C(C=O)O)O)=O,,,5,1,1,0,1
54071_0,,,,2,1,1,2
C1(C(C)OC(C1C(CO)=O)O)=O,,,5,1,1,0,1
54073_0,,,,2,1,1,2
C(C1C(C(C)OC1(CO)O)=O)=O,,,5,1,1,0,1
54074_0,,,,2,1,1,2
54076_0,,,,2,1,1,2
C(C1C(COC1(C(C)O)O)=O)=O,,,5,1,1,0,1
54078_0,,,,2,1,1,2
C(CC1C(C(C(C)(O1)O)O)=O)=O,,,5,1,1,0,1
54079_0,,,,2,1,1,2
54081_0,,,,2,1,1,2
C(CC1(C(C(C(C)O1)=O)O)O)=O,,,5,1,1,0,1
54083_0,,,,2,1,1,2
C(C(C1CC(C(C)(O1)O)O)=O)=O,,,5,1,1,0,1
54085_0,,,,2,1,1,2
C(C1(C(CC(C(C)=O)O1)O)O)=O,,,5,1,1,0,1
54087_0,,,,2,1,1,2
C(C1C(CC(C(C)O)(O1)O)=O)=O,,,5,1,1,0,1
54089_0,,,,2,1,1,2
C(C(C1(CC(C(C)O1)=O)O)O)=O,,,5,1,1,0,1
54091_0,,,,2,1,1,2
C1(C(C)OC(C1)O)=O,,,5,1,1,0,1
54093_0,,,,2,1,1,2
C1(C(C)OC(C1O)O)=O,,,5,1,1,0,1
54095_0,,,,2,1,1,2
C(C(CC1(C(CCO1)O)O)=O)=O,,,5,1,1,0,1
54097_0,,,,2,1,1,2
C1(CC(C=O)(OC1CCO)O)=O,,,5,1,1,0,1
54099_0,,,,2,1,1,2
C(CC1CC(C(C=O)(O)O1)O)=O,,,5,1,1,0,1
54101_0,,,,2,1,1,2
C(C(C=O)C1(C(CCO1)O)O)=O,,,5,1,1,0,1
54103_0,,,,2,1,1,2
C(C1C(C(CCO)OC1O)=O)=O,,,5,1,1,0,1
54105_0,,,,2,1,1,2
C1(COC(C1(CCO)O)O)=O,,,5,1,1,0,1
54107_0,,,,2,1,1,2
C(C1(C(CO)(O)OCC1)O)=O,,,5,1,1,0,1
54108_0,,,,2,1,1,2
54110_0,,,,2,1,1,2
C1(C(CCO)OC(C1)O)=O,,,5,1,1,0,1
54112_0,,,,2,1,1,2
C(CC1(C(CCO1)O)O)=O,,,5,1,1,0,1
54114_0,,,,2,1,1,2
C1(COC(CCO)(C1O)O)=O,,,5,1,1,0,1
54116_0,,,,2,1,1,2
C1(C(CCO)OC(C1O)O)=O,,,5,1,1,0,1
54118_0,,,,2,1,1,2
C(C(C1(C(CCO1)O)O)O)=O,,,5,1,1,0,1
54119_0,,,,2,1,1,2
54121_0,,,,2,1,1,2
C(C1CC(C(CO)(O1)O)O)=O,,,5,1,1,0,1
54122_0,,,,2,1,1,2
54124_0,,,,2,1,1,2
C(C1(C(CC(C)O1)O)O)=O,,,5,1,1,0,1
54126_0,,,,2,1,1,2
C(C1(C(CC(C(CO)O)O1)O)O)=O,,,5,1,1,0,1
54128_0,,,,2,1,1,2
C(C1(C(CCO1)O)O)=O,,,5,1,1,0,1
54130_0,,,,2,1,1,2
C(C1(C(CC(CO)O1)O)O)=O,,,5,1,1,0,1
54131_0,,,,2,1,1,2
54132_0,,,,2,1,1,2
54134_0,,,,2,1,1,2
C1(COC(CO)(C1(CO)O)O)=O,,,5,1,1,0,1
54136_0,,,,2,1,1,2
C(C1(C(CO)(O)OCC1O)O)(O)=O,,,5,1,1,0,1
54138_0,,,,2,1,1,2
C(C)(C1(C(COC1O)=O)O)=O,,,5,1,1,0,1
54140_0,,,,2,1,1,2
C(C1(C(COC1(C)O)=O)O)=O,,,5,1,1,0,1
54142_0,,,,2,1,1,2
C1(COC(C1(C(CO)O)O)O)=O,,,5,1,1,0,1
54143_0,,,,2,1,1,2
54145_0,,,,2,1,1,2
C(C1(C(CO)(O)OCC1O)O)=O,,,5,1,1,0,1
54146_0,,,,2,1,1,2
54147_0,,,,2,1,1,2
54148_0,,,,2,1,1,2
54149_0,,,,2,1,1,2
54151_0,,,,2,1,1,2
C1(COC(C(C)O)(C1(CO)O)O)=O,,,5,1,1,0,1
54153_0,,,,2,1,1,2
C1(C(C)OC(CO)(C1(CO)O)O)=O,,,5,1,1,0,1
54154_0,,,,2,1,1,2
54155_0,,,,2,1,1,2
54156_0,,,,2,1,1,2
54157_0,,,,2,1,1,2
54158_0,,,,2,1,1,2
54159_0,,,,2,1,1,2
54161_0,,,,2,1,1,2
C1(C(C)OC(C1(C(C)=O)O)O)=O,,,5,1,1,0,1
54163_0,,,,2,1,1,2
C(C1(C(C(C)OC1(C)O)=O)O)=O,,,5,1,1,0,1
54165_0,,,,2,1,1,2
C1(C(C)OC(C1(CO)O)O)=O,,,5,1,1,0,1
54167_0,,,,2,1,1,2
C1(C(C)OC(C1(C(CO)O)O)O)=O,,,5,1,1,0,1
54168_0,,,,2,1,1,2
54170_0,,,,2,1,1,2
C(C1(C(COC1(C(C)O)O)O)O)=O,,,5,1,1,0,1
54172_0,,,,2,1,1,2
C1(C(CCO)OC(C1(CO)O)O)=O,,,5,1,1,0,1
54174_0,,,,2,1,1,2
C(C(CO)(C1(C(CCO1)O)O)O)=O,,,5,1,1,0,1
54176_0,,,,2,1,1,2
C(C1(COC(C1O)(C(C)O)O)O)=O,,,5,1,1,0,1
54178_0,,,,2,1,1,2
C(C1(COC(CO)(C1(C)O)O)O)=O,,,5,1,1,0,1
54180_0,,,,2,1,1,2
C1(COC(C1(CC=O)O)O)=O,,,5,1,1,0,1
54182_0,,,,2,1,1,2
C1(C(C(OC1C)O)(CC=O)O)=O,,,5,1,1,0,1
54184_0,,,,2,1,1,2
C(C(C1(C(CCO1)O)O)O)(O)=O,,,5,1,1,0,1
54186_0,,,,2,1,1,2
C1(C(C(C(C(C)O)(O)O1)O)O)=O,,,5,1,1,0,1
54188_0,,,,2,1,1,2
C1(C(C(C)(C(CO)(O)O1)O)O)=O,,,5,1,1,0,1
54189_0,,,,2,1,1,2
54191_0,,,,2,1,1,2
C(C1CC(C(O1)O)O)=O,,,5,1,1,0,1
54192_0,,,,2,1,1,2
54193_0,,,,2,1,1,2
54195_0,,,,2,1,1,2
C(C1CC(CO)(C(O1)O)O)=O,,,5,1,1,0,1
54197_0,,,,2,1,1,2
C(C1(CO)CC(C(O1)O)O)=O,,,5,1,1,0,1
54199_0,,,,2,1,1,2
C1(CC(C(CO)(O)O1)O)=O,,,5,1,1,0,1
54201_0,,,,2,1,1,2
C(C1(C(CCO1)O)O)(O)=O,,,5,1,1,0,1
54203_0,,,,2,1,1,2
C(C1CC(C(CO)(O1)O)O)(O)=O,,,5,1,1,0,1
54205_0,,,,2,1,1,2
C1(CC(C(C(CO)O)(O)O1)O)=O,,,5,1,1,0,1
54207_0,,,,2,1,1,2
C(C1(C(CC(CO)O1)O)O)(O)=O,,,5,1,1,0,1
54209_0,,,,2,1,1,2
C(C(C1COC(C1O)O)O)=O,,,5,1,1,0,1
54210_0,,,,2,1,1,2
54212_0,,,,2,1,1,2
C1C(C(C(O)O1)O)C(CO)(CO)O,,,5,1,1,0,1
54213_0,,,,2,1,1,2
54215_0,,,,2,1,1,2
C(C(C)(C1COC(C1O)O)O)=O,,,5,1,1,0,1
54217_0,,,,2,1,1,2
C(C(C1COC(C1(C)O)O)O)=O,,,5,1,1,0,1
54218_0,,,,2,1,1,2
54219_0,,,,2,1,1,2
54221_0,,,,2,1,1,2
CC1(C(O)OCC1)O,,,5,1,1,0,1
54223_0,,,,2,1,1,2
CC1(C(O)OCC1O)O,,,5,1,1,0,1
54225_0,,,,2,1,1,2
C(C)(C(C1COC(C1O)O)O)=O,,,5,1,1,0,1
54227_0,,,,2,1,1,2
C(C(C1COC(C)(C1O)O)O)=O,,,5,1,1,0,1
54228_0,,,,2,1,1,2
54229_0,,,,2,1,1,2
54231_0,,,,2,1,1,2
CC1(C(CCO1)O)O,,,5,1,1,0,1
54232_0,,,,2,1,1,2
54233_0,,,,2,1,1,2
54234_0,,,,2,1,1,2
54236_0,,,,2,1,1,2
C1CC(C(CCO)(O)O1)O,,,5,1,1,0,1
54237_0,,,,2,1,1,2
54238_0,,,,2,1,1,2
54240_0,,,,2,1,1,2
C1C(C(C)O)C(C(O)O1)O,,,5,1,1,0,1
54241_0,,,,2,1,1,2
54243_0,,,,2,1,1,2
C1C(C(C(O)O1)O)C(C(CO)O)O,,,5,1,1,0,1
54244_0,,,,2,1,1,2
54245_0,,,,2,1,1,2
54247_0,,,,2,1,1,2
C1C(C(C(O)O1)O)C(CO)O,,,5,1,1,0,1
54248_0,,,,2,1,1,2
54249_0,,,,2,1,1,2
54251_0,,,,2,1,1,2
C1C(C)(C(CO)(C(CO)(O)O1)O)O,,,5,1,1,0,1
54253_0,,,,2,1,1,2
C(C)(C1(COC(C1(C)O)O)O)=O,,,5,1,1,0,1
54255_0,,,,2,1,1,2
C(C)(C1(C(O)OCC1(C)O)O)=O,,,5,1,1,0,1
54257_0,,,,2,1,1,2
C(C1(C(C)(O)OCC1(C)O)O)=O,,,5,1,1,0,1
54258_0,,,,2,1,1,2
54260_0,,,,2,1,1,2
C1C(C)(C(C(O)O1)(CO)O)O,,,5,1,1,0,1
54262_0,,,,2,1,1,2
C1C(C(CO)O)(C(C)(C(O)O1)O)O,,,5,1,1,0,1
54263_0,,,,2,1,1,2
54265_0,,,,2,1,1,2
C1C(C)(C(C(O)O1)(C(CO)O)O)O,,,5,1,1,0,1
54266_0,,,,2,1,1,2
54267_0,,,,2,1,1,2
54268_0,,,,2,1,1,2
54269_0,,,,2,1,1,2
54270_0,,,,2,1,1,2
54271_0,,,,2,1,1,2
54272_0,,,,2,1,1,2
54273_0,,,,2,1,1,2
54274_0,,,,2,1,1,2
54275_0,,,,2,1,1,2
54276_0,,,,2,1,1,2
54277_0,,,,2,1,1,2
54279_0,,,,2,1,1,2
C(CC1(COC(C1(C)O)O)O)=O,,,5,1,1,0,1
54280_0,,,,2,1,1,2
54281_0,,,,2,1,1,2
54283_0,,,,2,1,1,2
C(CC1(C(O)OCC1(C)O)O)=O,,,5,1,1,0,1
54284_0,,,,2,1,1,2
54286_0,,,,2,1,1,2
C(CC(C1(C(O)OCC1)O)O)=O,,,5,1,1,0,1
54287_0,,,,2,1,1,2
54288_0,,,,2,1,1,2
54290_0,,,,2,1,1,2
CC(C1(COC(C1)O)O)O,,,5,1,1,0,1
54291_0,,,,2,1,1,2
54293_0,,,,2,1,1,2
CC(C1(C(O)OCC1)O)O,,,5,1,1,0,1
54294_0,,,,2,1,1,2
54295_0,,,,2,1,1,2
54297_0,,,,2,1,1,2
C1CC(C(O)O1)(CO)O,,,5,1,1,0,1
54298_0,,,,2,1,1,2
54299_0,,,,2,1,1,2
54300_0,,,,2,1,1,2
54302_0,,,,2,1,1,2
C1(C(C(C)(C(O)O1)O)C(C=O)O)=O,,,5,1,1,0,1
54303_0,,,,2,1,1,2
54304_0,,,,2,1,1,2
54306_0,,,,2,1,1,2
C1(CC(C)(C(O)O1)O)=O,,,5,1,1,0,1
54307_0,,,,2,1,1,2
54309_0,,,,2,1,1,2
C1(C(C(C(C)(O)O1)O)C(C=O)O)=O,,,5,1,1,0,1
54310_0,,,,2,1,1,2
54311_0,,,,2,1,1,2
54313_0,,,,2,1,1,2
C1(CC(C(C)(O)O1)O)=O,,,5,1,1,0,1
54314_0,,,,2,1,1,2
54315_0,,,,2,1,1,2
54317_0,,,,2,1,1,2
C1(CC(C(O)O1)(CCO)O)=O,,,5,1,1,0,1
54318_0,,,,2,1,1,2
54320_0,,,,2,1,1,2
C1(CC(C(CCO)(O)O1)O)=O,,,5,1,1,0,1
54321_0,,,,2,1,1,2
54322_0,,,,2,1,1,2
54323_0,,,,2,1,1,2
54324_0,,,,2,1,1,2
54325_0,,,,2,1,1,2
54326_0,,,,2,1,1,2
54327_0,,,,2,1,1,2
54328_0,,,,2,1,1,2
54329_0,,,,2,1,1,2
54331_0,,,,2,1,1,2
C1(C(C(CO)(C(CO)(O)O1)O)O)=O,,,5,1,1,0,1
54332_0,,,,2,1,1,2
54334_0,,,,2,1,1,2
C(C)(C1(C(O)OC(C1O)=O)O)=O,,,5,1,1,0,1
54336_0,,,,2,1,1,2
C(C1(C(C)(O)OC(C1O)=O)O)=O,,,5,1,1,0,1
54338_0,,,,2,1,1,2
C1(C(C(CO)(C(O)O1)O)O)=O,,,5,1,1,0,1
54340_0,,,,2,1,1,2
C1(C(C(C(O)O1)(C(CO)O)O)O)=O,,,5,1,1,0,1
54341_0,,,,2,1,1,2
54343_0,,,,2,1,1,2
C1(C(C(C)=O)(C(C)(C(O)O1)O)O)=O,,,5,1,1,0,1
54345_0,,,,2,1,1,2
C1(C(C)(C(C(C)=O)(C(O)O1)O)O)=O,,,5,1,1,0,1
54347_0,,,,2,1,1,2
C1(C(C)(C(C=O)(C(C)(O)O1)O)O)=O,,,5,1,1,0,1
54349_0,,,,2,1,1,2
C1(C(C)(C(CO)(C(O)O1)O)O)=O,,,5,1,1,0,1
54351_0,,,,2,1,1,2
C1(C(C(C)=O)(C(C(C)(O)O1)O)O)=O,,,5,1,1,0,1
54352_0,,,,2,1,1,2
54353_0,,,,2,1,1,2
54354_0,,,,2,1,1,2
54355_0,,,,2,1,1,2
54356_0,,,,2,1,1,2
54358_0,,,,2,1,1,2
C1(CC(C(O)O1)(C(C=O)O)O)=O,,,5,1,1,0,1
54360_0,,,,2,1,1,2
C(CC1(C(O)OC(C1O)=O)O)=O,,,5,1,1,0,1
54361_0,,,,2,1,1,2
54362_0,,,,2,1,1,2
54364_0,,,,2,1,1,2
C1(C(C(C)(C(O)O1)O)(CC=O)O)=O,,,5,1,1,0,1
54365_0,,,,2,1,1,2
54367_0,,,,2,1,1,2
C(C(C)(C1(C(O)OC(C1)=O)O)O)=O,,,5,1,1,0,1
54369_0,,,,2,1,1,2
C1(C(C)(C(C(O)O1)(CC=O)O)O)=O,,,5,1,1,0,1
54370_0,,,,2,1,1,2
54371_0,,,,2,1,1,2
54373_0,,,,2,1,1,2
C1(C(C(C(C)(O)O1)O)(CC=O)O)=O,,,5,1,1,0,1
54374_0,,,,2,1,1,2
54376_0,,,,2,1,1,2
C1(CC(C(O)O1)(C(C(C)=O)O)O)=O,,,5,1,1,0,1
54377_0,,,,2,1,1,2
54378_0,,,,2,1,1,2
54379_0,,,,2,1,1,2
54381_0,,,,2,1,1,2
C1(CC(C(O)O1)(C(CC=O)O)O)=O,,,5,1,1,0,1
54382_0,,,,2,1,1,2
54383_0,,,,2,1,1,2
54384_0,,,,2,1,1,2
54385_0,,,,2,1,1,2
54387_0,,,,2,1,1,2
C1(CC(C(O)O1)(C(C)O)O)=O,,,5,1,1,0,1
54388_0,,,,2,1,1,2
54389_0,,,,2,1,1,2
54391_0,,,,2,1,1,2
C1(CC(CO)(C(O)O1)O)=O,,,5,1,1,0,1
54392_0,,,,2,1,1,2
54393_0,,,,2,1,1,2
54395_0,,,,2,1,1,2
C1(CC(C(O)O1)(C(CO)O)O)=O,,,5,1,1,0,1
54396_0,,,,2,1,1,2
54397_0,,,,2,1,1,2
54398_0,,,,2,1,1,2
54400_0,,,,2,1,1,2
C(C1(C2(C(CC(C2O)O1)O)O)O)O,,,5,1,2,0,2
54400_1,,,,2,1,1,2
54401_0,,,,2,1,1,2
54401_1,,,,2,1,1,2
54403_0,,,,2,1,1,2
C1(C2(C(C(CC2O)O1)O)O)O,,,5,1,2,0,2
54403_1,,,,2,1,1,2
54405_0,,,,2,1,1,2
C(CO)(C1(C(C)OC(C1O)O)O)=O,,,5,1,1,0,1
54407_0,,,,2,1,1,2
C(C1(C=O)C(C(OC1C=O)O)O)=O,,,5,1,1,0,1
54409_0,,,,2,1,1,2
C(C1(C=O)C(C)OC(C1O)O)=O,,,5,1,1,0,1
54411_0,,,,2,1,1,2
C(C1(C=O)COC(C1O)O)=O,,,5,1,1,0,1
54412_0,,,,2,1,1,2
54414_0,,,,2,1,1,2
C(C1(C=O)C(CO)OC(C1O)O)=O,,,5,1,1,0,1
54415_0,,,,2,1,1,2
54416_0,,,,2,1,1,2
54417_0,,,,2,1,1,2
54418_0,,,,2,1,1,2
54419_0,,,,2,1,1,2
54420_0,,,,2,1,1,2
54422_0,,,,2,1,1,2
C(C1(C(CO)=O)COC(C1O)O)=O,,,5,1,1,0,1
54423_0,,,,2,1,1,2
54425_0,,,,2,1,1,2
C(CC(C1(COC(C1O)O)O)=O)=O,,,5,1,1,0,1
54427_0,,,,2,1,1,2
C(C1(C(C(O)OC1CCO)O)O)=O,,,5,1,1,0,1
54429_0,,,,2,1,1,2
C(C(C1(C(O)OCC1(C)O)O)O)=O,,,5,1,1,0,1
54431_0,,,,2,1,1,2
C(C1(C(C(O)OC1(CO)C)O)O)=O,,,5,1,1,0,1
54433_0,,,,2,1,1,2
C1(C(C(C(O)O1)(C(C=O)O)O)O)=O,,,5,1,1,0,1
54435_0,,,,2,1,1,2
C(C1(C(C(OC1C(O)=O)O)O)O)=O,,,5,1,1,0,1
54437_0,,,,2,1,1,2
C(C1(C(C(OC1C=O)O)O)O)=O,,,5,1,1,0,1
54439_0,,,,2,1,1,2
C(C1(C(C(OC1C=O)O)(C)O)O)=O,,,5,1,1,0,1
54441_0,,,,2,1,1,2
C(C1(C(C(OC1(C=O)C)O)O)O)=O,,,5,1,1,0,1
54443_0,,,,2,1,1,2
C(C1(C(C(C)(OC1C=O)O)O)O)=O,,,5,1,1,0,1
54445_0,,,,2,1,1,2
C(C1(C(C(OC1C(C)=O)O)O)O)=O,,,5,1,1,0,1
54446_0,,,,2,1,1,2
54448_0,,,,2,1,1,2
C(C1(C(CC=O)OC(C1O)O)O)=O,,,5,1,1,0,1
54449_0,,,,2,1,1,2
54451_0,,,,2,1,1,2
C1C(CO)(C(C(O)O1)(C(C)O)O)O,,,5,1,1,0,1
54453_0,,,,2,1,1,2
C1C(C(C(C)O)(C(CO)(O)O1)O)O,,,5,1,1,0,1
54455_0,,,,2,1,1,2
C(C1(C=O)C(C)OC(C1(C)O)O)=O,,,5,1,1,0,1
54457_0,,,,2,1,1,2
C(C1(C=O)COC(C1(C)O)O)=O,,,5,1,1,0,1
54459_0,,,,2,1,1,2
C(C1(C(C)OC(C1(C)O)O)O)=O,,,5,1,1,0,1
54461_0,,,,2,1,1,2
C(C1(C=O)C(C)OC(C)(C1O)O)=O,,,5,1,1,0,1
54463_0,,,,2,1,1,2
C(C1(C=O)COC(C)(C1O)O)=O,,,5,1,1,0,1
54465_0,,,,2,1,1,2
C(C)(C1(C(C(OC1C=O)O)O)O)=O,,,5,1,1,0,1
54467_0,,,,2,1,1,2
C(C)(C1(C(C)OC(C1O)O)O)=O,,,5,1,1,0,1
54469_0,,,,2,1,1,2
C(C(C1(C(C)(O)OCC1O)O)O)=O,,,5,1,1,0,1
54471_0,,,,2,1,1,2
C(C)(C1(C(CO)OC(C1O)O)O)=O,,,5,1,1,0,1
54472_0,,,,2,1,1,2
54474_0,,,,2,1,1,2
C(C1(C(O)OCC1(C)O)C(C)O)=O,,,5,1,1,0,1
54476_0,,,,2,1,1,2
C(C1(C(O)OC(C1O)=O)C(C)O)=O,,,5,1,1,0,1
54477_0,,,,2,1,1,2
54478_0,,,,2,1,1,2
54480_0,,,,2,1,1,2
C(C1(C(O)OCC1(C=O)O)CO)=O,,,5,1,1,0,1
54482_0,,,,2,1,1,2
C(C1(C=O)COC(C1(CO)O)O)=O,,,5,1,1,0,1
54484_0,,,,2,1,1,2
C(C1(C=O)COC(CO)(C1O)O)=O,,,5,1,1,0,1
54486_0,,,,2,1,1,2
C(C1(C(O)OCC1(C)O)CO)=O,,,5,1,1,0,1
54488_0,,,,2,1,1,2
C(C1(CO)C(O)OC(C1O)=O)=O,,,5,1,1,0,1
54490_0,,,,2,1,1,2
C(C1(CO)C(O)OC(C1(C)O)=O)=O,,,5,1,1,0,1
54492_0,,,,2,1,1,2
C(C1(C=O)COC(C1(C=C)O)O)=O,,,5,1,1,0,1
54494_0,,,,2,1,1,2
C(C1(C=O)COC(C=C)(C1O)O)=O,,,5,1,1,0,1
54495_0,,,,2,1,1,2
54496_0,,,,2,1,1,2
54498_0,,,,2,1,1,2
C(CCO)(C1(COC(C1O)O)O)=O,,,5,1,1,0,1
54499_0,,,,2,1,1,2
54500_0,,,,2,1,1,2
54501_0,,,,2,1,1,2
54502_0,,,,2,1,1,2
54503_0,,,,2,1,1,2
54505_0,,,,2,1,1,2
C(C1(C(CO)(CO)C(CO1)O)O)=O,,,5,1,1,0,1
54506_0,,,,2,1,1,2
54507_0,,,,2,1,1,2
54508_0,,,,2,1,1,2
54509_0,,,,2,1,1,2
54510_0,,,,2,1,1,2
54511_0,,,,2,1,1,2
54513_0,,,,2,1,1,2
C(C(C1(C(O)OCC1O)CO)O)=O,,,5,1,1,0,1
54514_0,,,,2,1,1,2
54515_0,,,,2,1,1,2
54516_0,,,,2,1,1,2
54517_0,,,,2,1,1,2
54518_0,,,,2,1,1,2
54519_0,,,,2,1,1,2
54520_0,,,,2,1,1,2
54521_0,,,,2,1,1,2
54522_0,,,,2,1,1,2
54523_0,,,,2,1,1,2
54524_0,,,,2,1,1,2
54526_0,,,,2,1,1,2
C(CC1(C(CO)(C(CO1)O)O)O)=O,,,5,1,1,0,1
54527_0,,,,2,1,1,2
54529_0,,,,2,1,1,2
C(C1(COC(C1(C(C)O)O)O)O)=O,,,5,1,1,0,1
54531_0,,,,2,1,1,2
C(C1(C(C)OC(C1(CO)O)O)O)=O,,,5,1,1,0,1
54533_0,,,,2,1,1,2
C1C(C)(C(C(O)O1)(C(C)O)O)O,,,5,1,1,0,1
54535_0,,,,2,1,1,2
C1(C(C(C(O)O1)(C(C)O)O)O)=O,,,5,1,1,0,1
54537_0,,,,2,1,1,2
C1(C(C)(C(C(O)O1)(C(C)O)O)O)=O,,,5,1,1,0,1
54539_0,,,,2,1,1,2
C(C1(C(C)OC(C1(C=C)O)O)O)=O,,,5,1,1,0,1
54541_0,,,,2,1,1,2
C(C1(C(C(C=C)(O)OC1C)O)O)=O,,,5,1,1,0,1
54543_0,,,,2,1,1,2
CC(C1C(C(C(O)O1)(CO)O)O)O,,,5,1,1,0,1
54544_0,,,,2,1,1,2
54546_0,,,,2,1,1,2
C1(C(O)OC(CCO)C1(CO)O)=O,,,5,1,1,0,1
54547_0,,,,2,1,1,2
54549_0,,,,2,1,1,2
C(C1C(CCO)OC(C1O)O)(O)=O,,,5,1,1,0,1
54551_0,,,,2,1,1,2
C(C)(C1(COC(C1(CO)O)O)O)=O,,,5,1,1,0,1
54553_0,,,,2,1,1,2
C(C1(COC(C)(C1(CO)O)O)O)=O,,,5,1,1,0,1
54555_0,,,,2,1,1,2
C(C1(COC2(COCC21O)O)O)=O,,,5,1,1,0,1
54557_0,,,,2,1,1,2
C1(C2C(CO1)OC(C2(CO)O)O)=O,,,5,1,1,0,1
54559_0,,,,2,1,1,2
C(C1(COC(C1(CO)O)O)O)=O,,,5,1,1,0,1
54561_0,,,,2,1,1,2
C1(C(CO)(C(CO)(C(O)O1)O)O)=O,,,5,1,1,0,1
54563_0,,,,2,1,1,2
C(C1(COC(C1(CO)O)O)O)(O)=O,,,5,1,1,0,1
54565_0,,,,2,1,1,2
C(C1(COC(C1(C(C)=O)O)O)O)=O,,,5,1,1,0,1
54567_0,,,,2,1,1,2
C(C1(C(C)(O)OCC1(C=O)O)O)=O,,,5,1,1,0,1
54569_0,,,,2,1,1,2
C1(C2C(CO1)OC(CO)(C2O)O)=O,,,5,1,1,0,1
54571_0,,,,2,1,1,2
C1(C(CO)(C(C(CO)(O)O1)O)O)=O,,,5,1,1,0,1
54573_0,,,,2,1,1,2
C(C1(COC(CO)(C1O)O)O)(O)=O,,,5,1,1,0,1
54575_0,,,,2,1,1,2
C(C1(C(CO)(C(CO1)(C)O)O)O)=O,,,5,1,1,0,1
54576_0,,,,2,1,1,2
54578_0,,,,2,1,1,2
C1(C(O)OC(CO)(C)C1(CO)O)=O,,,5,1,1,0,1
54580_0,,,,2,1,1,2
C1(C(C(CO)(C(C=O)(O)O1)O)O)=O,,,5,1,1,0,1
54581_0,,,,2,1,1,2
54583_0,,,,2,1,1,2
C1(C(OC(C(O)=O)C1(CO)O)O)=O,,,5,1,1,0,1
54585_0,,,,2,1,1,2
C(C(C1(COC(C1O)O)O)=O)=O,,,5,1,1,0,1
54586_0,,,,2,1,1,2
54588_0,,,,2,1,1,2
C1(C(OC(C=O)C1(CO)O)O)=O,,,5,1,1,0,1
54590_0,,,,2,1,1,2
C(C(C1(COC(C1(C)O)O)O)=O)=O,,,5,1,1,0,1
54591_0,,,,2,1,1,2
54593_0,,,,2,1,1,2
C(C1(C)C(C(C(O1)O)=O)(CO)O)=O,,,5,1,1,0,1
54595_0,,,,2,1,1,2
C(C(C1(COC(C)(C1O)O)O)=O)=O,,,5,1,1,0,1
54596_0,,,,2,1,1,2
54598_0,,,,2,1,1,2
C(C1C(C(C(O1)O)=O)(CO)O)(C)=O,,,5,1,1,0,1
54600_0,,,,2,1,1,2
C(C(C1(CO)C(CC(O1)O)O)=O)=O,,,5,1,1,0,1
54601_0,,,,2,1,1,2
54603_0,,,,2,1,1,2
C(CC1C(C(C(O)O1)=O)(CO)O)=O,,,5,1,1,0,1
54604_0,,,,2,1,1,2
54606_0,,,,2,1,1,2
C1(C(O)OC(C)C1(CO)O)=O,,,5,1,1,0,1
54607_0,,,,2,1,1,2
54609_0,,,,2,1,1,2
C(C1(C(C(C)O)(C(CO1)O)O)O)=O,,,5,1,1,0,1
54611_0,,,,2,1,1,2
C1(C(O)OC(C)C1(C(CO)O)O)=O,,,5,1,1,0,1
54613_0,,,,2,1,1,2
C1C(C)(C(CO)(C(C)(O)O1)O)O,,,5,1,1,0,1
54614_0,,,,2,1,1,2
54616_0,,,,2,1,1,2
C(C1C(C(O)OC1(C)CO)O)(O)=O,,,5,1,1,0,1
54618_0,,,,2,1,1,2
C(C1(C(C)(O)OCC1(C)O)O)(O)=O,,,5,1,1,0,1
54620_0,,,,2,1,1,2
C1C2(C(CO1)(O)OCC2(C)O)O,,,5,1,1,0,1
54622_0,,,,2,1,1,2
C1(C(C(CO)(C(C)(O)O1)O)O)=O,,,5,1,1,0,1
54624_0,,,,2,1,1,2
C1(C(C)(C(CO)(C(C)(O)O1)O)O)=O,,,5,1,1,0,1
54626_0,,,,2,1,1,2
C(C)(C1(COC(C1(C=C)O)O)O)=O,,,5,1,1,0,1
54628_0,,,,2,1,1,2
C(C)(C1(COC(C=C)(C1O)O)O)=O,,,5,1,1,0,1
54629_0,,,,2,1,1,2
54631_0,,,,2,1,1,2
C(C1C(C(OC1C(O)=O)O)O)(O)=O,,,5,1,1,0,1
54633_0,,,,2,1,1,2
C(C1(C(C)(O)OC(C1O)=O)O)(O)=O,,,5,1,1,0,1
54635_0,,,,2,1,1,2
C1(C(C2(COCC2(O)O1)O)O)=O,,,5,1,1,0,1
54637_0,,,,2,1,1,2
C1(C(C)(C2(COCC2(O)O1)O)O)=O,,,5,1,1,0,1
54638_0,,,,2,1,1,2
54640_0,,,,2,1,1,2
C(C1(COC(C1(CC=O)O)O)O)=O,,,5,1,1,0,1
54641_0,,,,2,1,1,2
54643_0,,,,2,1,1,2
C(C1(C(C(OC1C=O)O)O)O)(O)=O,,,5,1,1,0,1
54644_0,,,,2,1,1,2
54646_0,,,,2,1,1,2
C(C1(C(C)OC(C1O)O)O)(O)=O,,,5,1,1,0,1
54647_0,,,,2,1,1,2
54649_0,,,,2,1,1,2
C(C1(C(C)OC(C1(C)O)O)O)(O)=O,,,5,1,1,0,1
54650_0,,,,2,1,1,2
54652_0,,,,2,1,1,2
C(C1(C(C)OC(C)(C1O)O)O)(O)=O,,,5,1,1,0,1
54654_0,,,,2,1,1,2
C1(C(C(C(C)O)(C(C)(O)O1)O)O)=O,,,5,1,1,0,1
54655_0,,,,2,1,1,2
54656_0,,,,2,1,1,2
54657_0,,,,2,1,1,2
54659_0,,,,2,1,1,2
C1C2(C(CO1)(C(C(CO)O2)O)O)O,,,5,1,1,0,1
54661_0,,,,2,1,1,2
C1C2(C(CO1)(O)OCC2(CO)O)O,,,5,1,1,0,1
54663_0,,,,2,1,1,2
C1(COCC21C(CC(O2)O)O)=O,,,5,1,1,0,1
54665_0,,,,2,1,1,2
C1C2(C(CO1)(O)OCC2O)O,,,5,1,1,0,1
54667_0,,,,2,1,1,2
C1C2(C(CO1)OC(C2(CO)O)O)O,,,5,1,1,0,1
54669_0,,,,2,1,1,2
C12C(CCO1)(C(C(O)O2)(CO)O)O,,,5,1,1,0,1
54671_0,,,,2,1,1,2
C1(C2C(CO1)OC(C2(C=C)O)O)=O,,,5,1,1,0,1
54673_0,,,,2,1,1,2
C1(C2C(C(C=C)(O)OC2CO1)O)=O,,,5,1,1,0,1
54675_0,,,,2,1,1,2
C1(C2C(CO1)OC(C2O)O)=O,,,5,1,1,0,1
54677_0,,,,2,1,1,2
C1(C2C(CO1)OC(C2(C)O)O)=O,,,5,1,1,0,1
54679_0,,,,2,1,1,2
C1(C2C(CO1)OC(C)(C2O)O)=O,,,5,1,1,0,1
54680_0,,,,2,1,1,2
54682_0,,,,2,1,1,2
C1(C(CO)(C(C=C)(C(O)O1)O)O)=O,,,5,1,1,0,1
54684_0,,,,2,1,1,2
C(C1(COC(C1(C=C)O)O)O)(O)=O,,,5,1,1,0,1
54685_0,,,,2,1,1,2
54687_0,,,,2,1,1,2
C1(C(CO)(C(C(C=C)(O)O1)O)O)=O,,,5,1,1,0,1
54689_0,,,,2,1,1,2
C(C1(COC(C=C)(C1O)O)O)(O)=O,,,5,1,1,0,1
54691_0,,,,2,1,1,2
C1(C2(C(CO1)OC(C2O)O)O)=O,,,5,1,2,0,2
54693_0,,,,2,1,1,2
C1(C2(C(CO1)OC(C2(C)O)O)O)=O,,,5,1,1,0,1
54695_0,,,,2,1,1,2
C1(C2(C(CO1)OC(C)(C2O)O)O)=O,,,5,1,1,0,1
54697_0,,,,2,1,1,2
C1(C2(C(CO1)O)C(CC(O2)O)O)=O,,,5,1,1,0,1
54699_0,,,,2,1,1,2
C1(C2C(C(C(O2)O)(C1)O)O)=O,,,5,1,2,0,2
54699_1,,,,2,1,1,2
54701_0,,,,2,1,1,2
C(C1(C2C(CC1(C(O)O2)O)O)O)O,,,5,1,2,0,2
54701_1,,,,2,1,1,2
54703_0,,,,2,1,1,2
C1C2(C(C(CC2(C(O)O1)O)O)O)O,,,5,1,1,0,1
54705_0,,,,2,1,1,2
C(C1(C(C2CC1(C(O)O2)O)O)O)O,,,5,1,2,0,2
54705_1,,,,2,1,1,2
54707_0,,,,2,1,1,2
C1(C2C(C(C(C)(O2)O)(C1)O)O)=O,,,5,1,2,0,2
54707_1,,,,2,1,1,2
54708_0,,,,2,1,1,2
54708_1,,,,2,1,1,2
54710_0,,,,2,1,1,2
C1(C2(CC(CC2O)O1)O)O,,,5,1,2,0,2
54710_1,,,,2,1,1,2
54712_0,,,,2,1,1,2
C1(C2(CC(C(C2O)O1)O)O)O,,,5,1,2,0,2
54712_1,,,,2,1,1,2
54714_0,,,,2,1,1,2
C1(C2(CC(C(C2O)O)O1)O)O,,,5,1,2,0,2
54714_1,,,,2,1,1,2
54716_0,,,,2,1,1,2
C1(C2(CC(C(CO)(C2O)O1)O)O)O,,,5,1,2,0,2
54716_1,,,,2,1,1,2
54718_0,,,,2,1,1,2
C(C1(C2CC(C(O)O2)(C1O)O)O)O,,,5,1,2,0,2
54718_1,,,,2,1,1,2
54719_0,,,,2,1,1,2
54721_0,,,,2,1,1,2
C(C1(CC(C=O)(C(C=O)O1)O)O)=O,,,5,1,1,0,1
54723_0,,,,2,1,1,2
C(C1C(C=O)(C(C=O)C(O1)O)O)=O,,,5,1,1,0,1
54725_0,,,,2,1,1,2
C(C(C1CC(C(O)O1)(C)O)O)(O)=O,,,5,1,1,0,1
54726_0,,,,2,1,1,2
54728_0,,,,2,1,1,2
C(C1(CC(C(C)=O)(C(C)O1)O)O)=O,,,5,1,1,0,1
54730_0,,,,2,1,1,2
C(C1C(O)OC(C)C1(C(C)=O)O)=O,,,5,1,1,0,1
54732_0,,,,2,1,1,2
C(C)(C1(CC(O)OC1CCO)O)=O,,,5,1,1,0,1
54734_0,,,,2,1,1,2
C(CC1(C(C)(O)OCC1(C)O)O)=O,,,5,1,1,0,1
54736_0,,,,2,1,1,2
C(C)(C1(CC(O)OC1(CO)C)O)=O,,,5,1,1,0,1
54738_0,,,,2,1,1,2
C(CC1(C(C)(O)OC(C1O)=O)O)=O,,,5,1,1,0,1
54740_0,,,,2,1,1,2
C(C)(C1(CC(OC1C(O)=O)O)O)=O,,,5,1,1,0,1
54742_0,,,,2,1,1,2
C(C)(C1(CC(OC1C=O)O)O)=O,,,5,1,1,0,1
54744_0,,,,2,1,1,2
C(C1(C)C(C(C)=O)(CC(O1)O)O)=O,,,5,1,1,0,1
54746_0,,,,2,1,1,2
C(C)(C1(CC(OC1C(C)=O)O)O)=O,,,5,1,1,0,1
54748_0,,,,2,1,1,2
C(C)(C1(C(CC(O1)O)O)CC=O)=O,,,5,1,1,0,1
54750_0,,,,2,1,1,2
C(CC1C(C(C)=O)(CC(O)O1)O)=O,,,5,1,1,0,1
54752_0,,,,2,1,1,2
C(C)(C1(C(C)OC(C1)O)O)=O,,,5,1,1,0,1
54754_0,,,,2,1,1,2
C(CC1(C(C)(O)OCC1O)O)=O,,,5,1,1,0,1
54756_0,,,,2,1,1,2
C(C)(C1(C(CO)OC(C1)O)O)=O,,,5,1,1,0,1
54758_0,,,,2,1,1,2
C(C(C1CC(C(C)(O)O1)O)O)(O)=O,,,5,1,1,0,1
54760_0,,,,2,1,1,2
C1(C(C(C(O)O1)(CC(C)O)O)O)=O,,,5,1,1,0,1
54761_0,,,,2,1,1,2
54763_0,,,,2,1,1,2
C(C1(C)C(C(CO)C(O1)O)O)(O)=O,,,5,1,1,0,1
54765_0,,,,2,1,1,2
C(CCO)(C1(C(C)OC(C1)O)O)=O,,,5,1,1,0,1
54767_0,,,,2,1,1,2
C(CCO)(C1(COC(C1)O)O)=O,,,5,1,1,0,1
54769_0,,,,2,1,1,2
C1(C(O)OC(CC(C)O)C1(C)O)=O,,,5,1,1,0,1
54771_0,,,,2,1,1,2
CC(CC(C1(C(O)OCC1)O)O)O,,,5,1,1,0,1
54773_0,,,,2,1,1,2
C(C1(CC(O)OC1CC(C)O)O)=O,,,5,1,1,0,1
54775_0,,,,2,1,1,2
C1(C(O)OC(CCO)C1(C)O)=O,,,5,1,1,0,1
54777_0,,,,2,1,1,2
C1CC(C(O)O1)(C(CCO)O)O,,,5,1,1,0,1
54778_0,,,,2,1,1,2
54780_0,,,,2,1,1,2
C(C1(CC(O)OC1CCO)O)(O)=O,,,5,1,1,0,1
54782_0,,,,2,1,1,2
C1(CC(C(O)O1)(C(CCO)O)O)=O,,,5,1,1,0,1
54784_0,,,,2,1,1,2
C1(C(C)(C(C)(C(CO)(O)O1)O)O)=O,,,5,1,1,0,1
54786_0,,,,2,1,1,2
C1(C(C)(C(C(C(C)O)(O)O1)O)O)=O,,,5,1,1,0,1
54788_0,,,,2,1,1,2
C1(C(C)(C(C=C)(C(O)O1)O)O)=O,,,5,1,1,0,1
54790_0,,,,2,1,1,2
C1(C(C)(C(C(C=C)(O)O1)O)O)=O,,,5,1,1,0,1
54792_0,,,,2,1,1,2
C1(C(C)(C(C)(C(O)O1)O)O)=O,,,5,1,1,0,1
54794_0,,,,2,1,1,2
C(C1(C)C(CC(O1)O)O)(O)=O,,,5,1,1,0,1
54795_0,,,,2,1,1,2
54797_0,,,,2,1,1,2
C1(C(C)(C(C(O)O1)(CCO)O)O)=O,,,5,1,1,0,1
54799_0,,,,2,1,1,2
C(C(C)(C1C(CC(O)O1)O)O)(O)=O,,,5,1,1,0,1
54801_0,,,,2,1,1,2
C(C(C)(C1CC(C(O)O1)O)O)(O)=O,,,5,1,1,0,1
54803_0,,,,2,1,1,2
C(C1(C)C(CC(CO)(O1)O)O)(O)=O,,,5,1,1,0,1
54804_0,,,,2,1,1,2
54806_0,,,,2,1,1,2
C(C1(C)C(CO)(CC(O1)O)O)(O)=O,,,5,1,1,0,1
54808_0,,,,2,1,1,2
C(C1(C)C(C(C(C)(O1)O)O)O)(O)=O,,,5,1,1,0,1
54810_0,,,,2,1,1,2
C(C1(C)C(C)(C(C(O1)O)O)O)(O)=O,,,5,1,1,0,1
54812_0,,,,2,1,1,2
C1(C(CCO)(C(C)(C(O)O1)O)O)=O,,,5,1,1,0,1
54814_0,,,,2,1,1,2
C(C1(CCO)C(CC(O1)O)O)(O)=O,,,5,1,1,0,1
54816_0,,,,2,1,1,2
C(C1(CO)C(C(C(O1)O)=O)(C)O)=O,,,5,1,1,0,1
54818_0,,,,2,1,1,2
C(C1(COC(C=O)(C1(C)O)O)O)=O,,,5,1,1,0,1
54820_0,,,,2,1,1,2
C(C1(COC2(C1(O)OCC2)O)O)=O,,,5,1,1,0,1
54822_0,,,,2,1,1,2
C(C1C(C(C(O1)O)=O)(C)O)(CO)=O,,,5,1,1,0,1
54824_0,,,,2,1,1,2
C(C1(CC(OC1C(CO)=O)O)O)=O,,,5,1,1,0,1
54826_0,,,,2,1,1,2
C(C1(C(C)(C(CO1)(C)O)O)O)=O,,,5,1,1,0,1
54828_0,,,,2,1,1,2
C1(C(O)OC(CO)(C)C1(C)O)=O,,,5,1,1,0,1
54830_0,,,,2,1,1,2
C1(C(C(C)(C(C=O)(O)O1)O)O)=O,,,5,1,1,0,1
54832_0,,,,2,1,1,2
C1(C(OC(C(O)=O)C1(C)O)O)=O,,,5,1,1,0,1
54834_0,,,,2,1,1,2
C1(C(C)(C(C)(C(C=O)(O)O1)O)O)=O,,,5,1,1,0,1
54836_0,,,,2,1,1,2
C(C1(C)C(C(C(O1)O)=O)(C)O)(O)=O,,,5,1,1,0,1
54838_0,,,,2,1,1,2
C(CC1C(C(C(O)O1)=O)(C)O)(O)=O,,,5,1,1,0,1
54840_0,,,,2,1,1,2
C(C1(C=C)C(C(C(O1)O)=O)(C)O)=O,,,5,1,1,0,1
54842_0,,,,2,1,1,2
C1(C(OC(C(C=C)=O)C1(C)O)O)=O,,,5,1,1,0,1
54844_0,,,,2,1,1,2
C1(C(OC(C=CC=O)C1(C)O)O)=O,,,5,1,1,0,1
54846_0,,,,2,1,1,2
C(C1(C(C)(C(C(CO)O1)O)O)O)=O,,,5,1,1,0,1
54848_0,,,,2,1,1,2
C1(C(O)OC(C(CO)O)C1(C)O)=O,,,5,1,1,0,1
54850_0,,,,2,1,1,2
C(C1(C(C)(C(CO)(CO1)O)O)O)=O,,,5,1,1,0,1
54852_0,,,,2,1,1,2
C1(C(O)OC(CO)(CO)C1(C)O)=O,,,5,1,1,0,1
54854_0,,,,2,1,1,2
C(C1(C)C(C(C(O1)O)=O)(C)O)=O,,,5,1,1,0,1
54856_0,,,,2,1,1,2
C(C1C(C(C(O1)O)=O)(C)O)(C)=O,,,5,1,1,0,1
54858_0,,,,2,1,1,2
C(C(C1(C)C(CC(O1)O)O)=O)=O,,,5,1,1,0,1
54860_0,,,,2,1,1,2
C(CC1C(C(C(O)O1)=O)(C)O)=O,,,5,1,1,0,1
54862_0,,,,2,1,1,2
C1(C(O)OC(C)C1(C)O)=O,,,5,1,1,0,1
54864_0,,,,2,1,1,2
C1(C(O)OCC1(C)O)=O,,,5,1,1,0,1
54866_0,,,,2,1,1,2
C(C1(C(C)(C(CO1)O)O)O)=O,,,5,1,1,0,1
54868_0,,,,2,1,1,2
C1(C(O)OC(CO)C1(C)O)=O,,,5,1,1,0,1
54870_0,,,,2,1,1,2
CC(CO)(C1(C(O)OCC1)O)O,,,5,1,1,0,1
54872_0,,,,2,1,1,2
C1C(C)(C(C(O)O1)(CCO)O)O,,,5,1,1,0,1
54873_0,,,,2,1,1,2
54875_0,,,,2,1,1,2
C(C1(CC(O)OC1(CO)C)O)(O)=O,,,5,1,1,0,1
54877_0,,,,2,1,1,2
C1(CC(C(O)O1)(C(C)(CO)O)O)=O,,,5,1,1,0,1
54879_0,,,,2,1,1,2
C(CC1(C(O)OCC1(C)O)O)(O)=O,,,5,1,1,0,1
54881_0,,,,2,1,1,2
C1C(C)(C2(C(CCO2)(O)O1)O)O,,,5,1,1,0,1
54883_0,,,,2,1,1,2
C(CC(C1(C(O)OCC1)O)O)(O)=O,,,5,1,1,0,1
54884_0,,,,2,1,1,2
54885_0,,,,2,1,1,2
54887_0,,,,2,1,1,2
C(C(C1(C(O)OCC1)O)O)=CC=O,,,5,1,1,0,1
54888_0,,,,2,1,1,2
54890_0,,,,2,1,1,2
C(C1(CC(OC1C(O)=O)O)O)(O)=O,,,5,1,1,0,1
54892_0,,,,2,1,1,2
C1(CC(C(O)O1)(C(C(O)=O)O)O)=O,,,5,1,1,0,1
54894_0,,,,2,1,1,2
C(CC1(C(O)OC(C1O)=O)O)(O)=O,,,5,1,1,0,1
54896_0,,,,2,1,1,2
C1(C(C2(C(CCO2)(O)O1)O)O)=O,,,5,1,1,0,1
54898_0,,,,2,1,1,2
C1(C(C)(C2(C(CCO2)(O)O1)O)O)=O,,,5,1,1,0,1
54900_0,,,,2,1,1,2
C(C1(CC(CO)(OC1C=O)O)O)=O,,,5,1,1,0,1
54901_0,,,,2,1,1,2
54903_0,,,,2,1,1,2
C(C1(C(C)OC(CO)(C1)O)O)(O)=O,,,5,1,1,0,1
54905_0,,,,2,1,1,2
C1CC2(C(C(C(CO)O2)O)(O)O1)O,,,5,1,1,0,1
54907_0,,,,2,1,1,2
C1C(CO)(C2(C(CCO2)(O)O1)O)O,,,5,1,1,0,1
54909_0,,,,2,1,1,2
C1(C2(C(CC(O2)O)O)OCC1)=O,,,5,1,1,0,1
54911_0,,,,2,1,1,2
C1C(C2(C(CCO2)(O)O1)O)O,,,5,1,1,0,1
54912_0,,,,2,1,1,2
54914_0,,,,2,1,1,2
C(C1(C=C)C(C=O)(CC(O1)O)O)=O,,,5,1,1,0,1
54915_0,,,,2,1,1,2
54917_0,,,,2,1,1,2
C(C1(CC(OC1C(C=C)=O)O)O)=O,,,5,1,1,0,1
54919_0,,,,2,1,1,2
C(C1(CC(OC1C=CC=O)O)O)=O,,,5,1,1,0,1
54921_0,,,,2,1,1,2
C(CO)(OC1C(O)OCC1O)=O,,,5,1,1,0,1
54923_0,,,,2,1,1,2
C(CO)(OC1COC(C1O)O)=O,,,5,1,1,0,1
54925_0,,,,2,1,1,2
C(CCC1(C(C(CO1)O)O)O)=O,,,5,1,2,0,2
54927_0,,,,2,1,1,2
C(CC1(CC(C(CO)O1)O)O)=O,,,5,1,1,0,1
54929_0,,,,2,1,1,2
C(CC1(C(C(CO1)O)=O)O)=O,,,5,1,1,0,1
54930_0,,,,2,1,1,2
54931_0,,,,2,1,1,2
54932_0,,,,2,1,1,2
54933_0,,,,2,1,1,2
54935_0,,,,2,1,1,2
C(C(C1COC(C1CO)O)=O)=O,,,5,1,1,0,1
54936_0,,,,2,1,1,2
54938_0,,,,2,1,1,2
C(C1C(CO)C(OC1C=O)O)=O,,,5,1,1,0,1
54939_0,,,,2,1,1,2
54940_0,,,,2,1,1,2
54941_0,,,,2,1,1,2
54942_0,,,,2,1,1,2
54943_0,,,,2,1,1,2
54944_0,,,,2,1,1,2
54945_0,,,,2,1,1,2
54946_0,,,,2,1,1,2
54947_0,,,,2,1,1,2
54949_0,,,,2,1,1,2
C(C)(C1(CC(CO1)=O)O)=O,,,5,1,1,0,1
54950_0,,,,2,1,1,2
54951_0,,,,2,1,1,2
54953_0,,,,2,1,1,2
C(C1CCOC1(C(CO)=O)O)=O,,,5,1,1,0,1
54954_0,,,,2,1,1,2
54956_0,,,,2,1,1,2
C1(CC(C(CCO)=O)(OC1)O)=O,,,5,1,1,0,1
54958_0,,,,2,1,1,2
C(CCC1(C(C(CO1)=O)O)O)=O,,,5,1,1,0,1
54959_0,,,,2,1,1,2
54961_0,,,,2,1,1,2
C(CC(C1(CC(CO1)=O)O)O)=O,,,5,1,1,0,1
54963_0,,,,2,1,1,2
C(C(CC1(CC(CO1)=O)O)O)=O,,,5,1,1,0,1
54965_0,,,,2,1,1,2
C(C1CCC(C(CO)=O)(O1)O)=O,,,5,1,1,0,1
54967_0,,,,2,1,1,2
C(CO)(CC1(CC(CO1)=O)O)=O,,,5,1,1,0,1
54968_0,,,,2,1,1,2
54969_0,,,,2,1,1,2
54970_0,,,,2,1,1,2
54971_0,,,,2,1,1,2
54972_0,,,,2,1,1,2
54974_0,,,,2,1,1,2
C(C)(CC1(C(C(CO1)=O)O)O)=O,,,5,1,1,0,1
54975_0,,,,2,1,1,2
54977_0,,,,2,1,1,2
C(C)(C(C1(CC(CO1)=O)O)O)=O,,,5,1,1,0,1
54978_0,,,,2,1,1,2
54979_0,,,,2,1,1,2
54981_0,,,,2,1,1,2
C1(COC(C)(C1)O)=O,,,5,1,1,0,1
54982_0,,,,2,1,1,2
54984_0,,,,2,1,1,2
C(C(CC1C(O)OCC1O)=O)=O,,,5,1,1,0,1
54985_0,,,,2,1,1,2
54986_0,,,,2,1,1,2
54988_0,,,,2,1,1,2
C(C(C=O)C1C(O)OCC1O)=O,,,5,1,1,0,1
54989_0,,,,2,1,1,2
54990_0,,,,2,1,1,2
54992_0,,,,2,1,1,2
C(CC1C(O)OCC1O)=O,,,5,1,1,0,1
54993_0,,,,2,1,1,2
54995_0,,,,2,1,1,2
C(C(C)C1(C(C(CO1)O)=O)O)=O,,,5,1,1,0,1
54997_0,,,,2,1,1,2
C1(CC(C(C)=O)(OC1CO)O)=O,,,5,1,1,0,1
54999_0,,,,2,1,1,2
C(CC1(C(C(CO1)O)=O)O)(C)=O,,,5,1,1,0,1
55000_0,,,,2,1,1,2
55002_0,,,,2,1,1,2
C(CCC1(C(C(CO1)O)=O)O)=O,,,5,1,2,0,2
55004_0,,,,2,1,1,2
C1(C(CO)OC(C)(C1)O)=O,,,5,1,1,0,1
55006_0,,,,2,1,1,2
C1(C(CC)(O)OCC1O)=O,,,5,1,1,0,1
55007_0,,,,2,1,1,2
55009_0,,,,2,1,1,2
C1(C(CCO)(O)OCC1O)=O,,,5,1,1,0,1
55011_0,,,,2,1,1,2
C(CC1(C(CO)C(CO1)O)O)=O,,,5,1,1,0,1
55013_0,,,,2,1,1,2
C(C(CC1(CC(CO1)O)O)=O)=O,,,5,1,1,0,1
55015_0,,,,2,1,1,2
C(C(C=O)C1(CC(CO1)O)O)=O,,,5,1,1,0,1
55017_0,,,,2,1,1,2
C(C1CCOC1(C=O)O)=O,,,5,1,1,0,1
55018_0,,,,2,1,1,2
55019_0,,,,2,1,1,2
55021_0,,,,2,1,1,2
C(C(C1COC(C1)(CO)O)=O)=O,,,5,1,1,0,1
55022_0,,,,2,1,1,2
55023_0,,,,2,1,1,2
55024_0,,,,2,1,1,2
55025_0,,,,2,1,1,2
55026_0,,,,2,1,1,2
55027_0,,,,2,1,1,2
55029_0,,,,2,1,1,2
C(C1CCC(C=O)(O1)O)=O,,,5,1,1,0,1
55031_0,,,,2,1,1,2
C(C1CC(CO)(OC1C=O)O)=O,,,5,1,1,0,1
55032_0,,,,2,1,1,2
55033_0,,,,2,1,1,2
55035_0,,,,2,1,1,2
C(C1C(COC1(CCO)O)=O)=O,,,5,1,1,0,1
55036_0,,,,2,1,1,2
55037_0,,,,2,1,1,2
55038_0,,,,2,1,1,2
55039_0,,,,2,1,1,2
55040_0,,,,2,1,1,2
55041_0,,,,2,1,1,2
55042_0,,,,2,1,1,2
55044_0,,,,2,1,1,2
C(CC(C1(CC(CO1)O)O)=O)=O,,,5,1,1,0,1
55045_0,,,,2,1,1,2
55046_0,,,,2,1,1,2
55047_0,,,,2,1,1,2
55048_0,,,,2,1,1,2
55050_0,,,,2,1,1,2
C(C1C(CC(CCO)(O1)O)=O)=O,,,5,1,1,0,1
55052_0,,,,2,1,1,2
C(CC1(CC(CO1)O)O)=O,,,5,1,1,0,1
55054_0,,,,2,1,1,2
C(C1C(C)(O)OC(CO)C1O)=O,,,5,1,1,0,1
55055_0,,,,2,1,1,2
55056_0,,,,2,1,1,2
55057_0,,,,2,1,1,2
55058_0,,,,2,1,1,2
55059_0,,,,2,1,1,2
55061_0,,,,2,1,1,2
C(C1C(COC1(C=O)O)O)(O)=O,,,5,1,1,0,1
55062_0,,,,2,1,1,2
55063_0,,,,2,1,1,2
55065_0,,,,2,1,1,2
C(C1C(COC1(C=O)O)O)=O,,,5,1,1,0,1
55067_0,,,,2,1,1,2
C1(C(CO)(C(CO)C(O)O1)O)=O,,,5,1,1,0,1
55069_0,,,,2,1,1,2
C(C1(COC(C1CO)O)O)(O)=O,,,5,1,1,0,1
55070_0,,,,2,1,1,2
55071_0,,,,2,1,1,2
55073_0,,,,2,1,1,2
C1(COC(C(C)=O)(C1CO)O)=O,,,5,1,1,0,1
55074_0,,,,2,1,1,2
55076_0,,,,2,1,1,2
C(CC1(C(C(CO1)=O)CO)O)=O,,,5,1,1,0,1
55078_0,,,,2,1,1,2
C1(COC(C)(C1CO)O)=O,,,5,1,1,0,1
55080_0,,,,2,1,1,2
C1(COC(C)(C1(CO)O)O)=O,,,5,1,1,0,1
55081_0,,,,2,1,1,2
55082_0,,,,2,1,1,2
55083_0,,,,2,1,1,2
55085_0,,,,2,1,1,2
C(C1C(C)(O)OCC1O)(O)=O,,,5,1,1,0,1
55086_0,,,,2,1,1,2
55087_0,,,,2,1,1,2
55088_0,,,,2,1,1,2
55090_0,,,,2,1,1,2
C(C1C(COC1(C(C)=O)O)O)=O,,,5,1,1,0,1
55091_0,,,,2,1,1,2
55093_0,,,,2,1,1,2
C(C1C(CC=O)(O)OCC1O)=O,,,5,1,1,0,1
55094_0,,,,2,1,1,2
55095_0,,,,2,1,1,2
55097_0,,,,2,1,1,2
C(C1(COC(C1)(CC=O)O)O)=O,,,5,1,1,0,1
55098_0,,,,2,1,1,2
55100_0,,,,2,1,1,2
C(C(CO)C1(CC(CO1)=O)O)=O,,,5,1,1,0,1
55101_0,,,,2,1,1,2
55103_0,,,,2,1,1,2
C(C1(COC(C1CC=O)O)O)=O,,,5,1,1,0,1
55104_0,,,,2,1,1,2
55105_0,,,,2,1,1,2
55106_0,,,,2,1,1,2
55108_0,,,,2,1,1,2
C(C1(COC(C(C)=O)(C1)O)O)=O,,,5,1,1,0,1
55109_0,,,,2,1,1,2
55110_0,,,,2,1,1,2
55111_0,,,,2,1,1,2
55113_0,,,,2,1,1,2
C(C1(COC(C=O)(C1C)O)O)=O,,,5,1,1,0,1
55114_0,,,,2,1,1,2
55116_0,,,,2,1,1,2
C(C1C(C)(O)OCC1O)=O,,,5,1,1,0,1
55117_0,,,,2,1,1,2
55118_0,,,,2,1,1,2
55119_0,,,,2,1,1,2
55120_0,,,,2,1,1,2
55121_0,,,,2,1,1,2
55122_0,,,,2,1,1,2
55123_0,,,,2,1,1,2
55125_0,,,,2,1,1,2
C(C1CCOC1(C(O)=O)O)=O,,,5,1,1,0,1
55126_0,,,,2,1,1,2
55127_0,,,,2,1,1,2
55128_0,,,,2,1,1,2
55129_0,,,,2,1,1,2
55130_0,,,,2,1,1,2
55131_0,,,,2,1,1,2
55133_0,,,,2,1,1,2
C(C1CCC(C(O)=O)(O1)O)=O,,,5,1,1,0,1
55134_0,,,,2,1,1,2
55135_0,,,,2,1,1,2
55137_0,,,,2,1,1,2
C(CC1C(O)OC(C1O)=O)=O,,,5,1,1,0,1
55138_0,,,,2,1,1,2
55139_0,,,,2,1,1,2
55140_0,,,,2,1,1,2
55141_0,,,,2,1,1,2
55143_0,,,,2,1,1,2
C1(C(C(C)C(C=O)(O)O1)O)=O,,,5,1,1,0,1
55144_0,,,,2,1,1,2
55146_0,,,,2,1,1,2
C1C2(C(C(CO2)O1)O)O,,,5,1,1,0,1
55148_0,,,,2,1,1,2
C1C2CC(C(O)O2)(O)O1,,,5,1,2,0,2
55150_0,,,,2,1,1,2
C1C2(C(C(C(CO)O2)O1)O)O,,,5,1,1,0,1
55152_0,,,,2,1,1,2
C(C1C2CC(C(O)O2)(O)O1)O,,,5,1,2,0,2
55154_0,,,,2,1,1,2
C1(CC2C(C(C(O)O2)O)O1)O,,,5,1,2,0,2
55156_0,,,,2,1,1,2
CC1(C2C(C(C(O)O2)O1)O)O,,,5,1,2,0,2
55158_0,,,,2,1,1,2
C1C(C2(C(O1)OC(C2)O)O)O,,,5,1,1,0,1
55160_0,,,,2,1,1,2
C1C2C(C(O)O1)(CC(O)O2)O,,,5,1,2,0,2
55162_0,,,,2,1,1,2
C1C2C(C(CC(O)O2)(O)O1)O,,,5,1,2,0,2
55164_0,,,,2,1,1,2
C1C2CC(C(C(O)O2)O)(O)O1,,,5,1,2,0,2
55166_0,,,,2,1,1,2
C1C2(CC(CO2)(C(O)O1)O)O,,,5,1,2,0,2
55168_0,,,,2,1,1,2
C1C2C(C(C(O)O2)C(O)O1)O,,,5,1,2,0,2
55170_0,,,,2,1,1,2
C1C2(C(C(C(CO1)O2)O)O)O,,,5,1,1,0,1
55172_0,,,,2,1,1,2
C1C2C(CC(C(O)O1)(O)O2)O,,,5,1,2,0,2
55174_0,,,,2,1,1,2
C1C(C2(CC(C(O2)O1)O)O)O,,,5,1,1,0,1
55176_0,,,,2,1,1,2
C1CC2(C(C(C(O2)O1)O)O)O,,,5,1,1,0,1
55178_0,,,,2,1,1,2
C1C2(CC(C(C(O)O1)O2)O)O,,,5,1,2,0,2
55180_0,,,,2,1,1,2
C1(C2(CC(CO2)O1)O)=O,,,5,1,2,0,2
55182_0,,,,2,1,1,2
C1(C2(CC(C(CO)O2)O1)O)=O,,,5,1,2,0,2
55184_0,,,,2,1,1,2
C1(CC2(C(C(CO2)O)O1)O)=O,,,5,1,2,0,2
55186_0,,,,2,1,1,2
C1(C(C2C(CC(O)O2)O1)O)=O,,,5,1,2,0,2
55188_0,,,,2,1,1,2
C1(C2C(C(C(C)(O2)O)O1)O)=O,,,5,1,2,0,2
55190_0,,,,2,1,1,2
C1(CC2(C(C(CO2)O1)O)O)=O,,,5,1,2,0,2
55192_0,,,,2,1,1,2
C1(C(C2(CC(CO2)O1)O)O)=O,,,5,1,2,0,2
55194_0,,,,2,1,1,2
C1(C2(CC(C(CO1)O2)O)O)=O,,,5,1,2,0,2
55196_0,,,,2,1,1,2
C1(C2C(CC(CO1)(O2)O)O)=O,,,5,1,2,0,2
55197_0,,,,2,1,1,2
55198_0,,,,2,1,1,2
55199_0,,,,2,1,1,2
55200_0,,,,2,1,1,2
55201_0,,,,2,1,1,2
55202_0,,,,2,1,1,2
55203_0,,,,2,1,1,2
55204_0,,,,2,1,1,2
55205_0,,,,2,1,1,2
55206_0,,,,2,1,1,2
55207_0,,,,2,1,1,2
55208_0,,,,2,1,1,2
55209_0,,,,2,1,1,2
55210_0,,,,2,1,1,2
55211_0,,,,2,1,1,2
55212_0,,,,2,1,1,2
55213_0,,,,2,1,1,2
55214_0,,,,2,1,1,2
55215_0,,,,2,1,1,2
55216_0,,,,2,1,1,2
55217_0,,,,2,1,1,2
55218_0,,,,2,1,1,2
55219_0,,,,2,1,1,2
55220_0,,,,2,1,1,2
55221_0,,,,2,1,1,2
55222_0,,,,2,1,1,2
55223_0,,,,2,1,1,2
55224_0,,,,2,1,1,2
55225_0,,,,2,1,1,2
55226_0,,,,2,1,1,2
55227_0,,,,2,1,1,2
55228_0,,,,2,1,1,2
55229_0,,,,2,1,1,2
55230_0,,,,2,1,1,2
55231_0,,,,2,1,1,2
55232_0,,,,2,1,1,2
55233_0,,,,2,1,1,2
55234_0,,,,2,1,1,2
55235_0,,,,2,1,1,2
55236_0,,,,2,1,1,2
55237_0,,,,2,1,1,2
55238_0,,,,2,1,1,2
55239_0,,,,2,1,1,2
55240_0,,,,2,1,1,2
55241_0,,,,2,1,1,2
55242_0,,,,2,1,1,2
55243_0,,,,2,1,1,2
55244_0,,,,2,1,1,2
55245_0,,,,2,1,1,2
55246_0,,,,2,1,1,2
55247_0,,,,2,1,1,2
55248_0,,,,2,1,1,2
55249_0,,,,2,1,1,2
55250_0,,,,2,1,1,2
55251_0,,,,2,1,1,2
55252_0,,,,2,1,1,2
55253_0,,,,2,1,1,2
55254_0,,,,2,1,1,2
55255_0,,,,2,1,1,2
55256_0,,,,2,1,1,2
55257_0,,,,2,1,1,2
55258_0,,,,2,1,1,2
55259_0,,,,2,1,1,2
55260_0,,,,2,1,1,2
55261_0,,,,2,1,1,2
55262_0,,,,2,1,1,2
55263_0,,,,2,1,1,2
55264_0,,,,2,1,1,2
55265_0,,,,2,1,1,2
55266_0,,,,2,1,1,2
55267_0,,,,2,1,1,2
55268_0,,,,2,1,1,2
55269_0,,,,2,1,1,2
55270_0,,,,2,1,1,2
55271_0,,,,2,1,1,2
55272_0,,,,2,1,1,2
55274_0,,,,2,1,1,2
C1(C(O)OC2C(O)OCC12)=O,,,5,1,2,0,2
55275_0,,,,2,1,1,2
55277_0,,,,2,1,1,2
C(C1(C2COC(C2O)O1)O)=O,,,5,1,1,0,1
55279_0,,,,2,1,1,2
C(C1C2C(O)OC(C2O)O1)=O,,,5,1,1,0,1
55281_0,,,,2,1,1,2
C(C1C2C(O)OC1C(O)O2)=O,,,5,1,1,0,1
55283_0,,,,2,1,1,2
C1C2(CO)CC(C(O)O2)(O)O1,,,5,1,2,0,2
55284_0,,,,2,1,1,2
55286_0,,,,2,1,1,2
C1C2(COC(C2C(O)O1)O)O,,,5,1,1,0,1
55288_0,,,,2,1,1,2
C1C2(CO)C(CO)C(C(O)O2)(O)O1,,,5,1,2,0,2
55289_0,,,,2,1,1,2
55290_0,,,,2,1,1,2
55292_0,,,,2,1,1,2
C12C(C(C(O)O1)C(CO)(CO)O2)O,,,5,1,1,0,1
55294_0,,,,2,1,1,2
C1C2(CO)C(C(O)O1)C(C(O)O2)O,,,5,1,2,0,2
55295_0,,,,2,1,1,2
55297_0,,,,2,1,1,2
C1C(CO)(C2C(O1)OC(C2O)O)O,,,5,1,1,0,1
55299_0,,,,2,1,1,2
C1C2(COC(C2C(CO)(O)O1)O)O,,,5,1,2,0,2
55300_0,,,,2,1,1,2
55301_0,,,,2,1,1,2
55302_0,,,,2,1,1,2
55304_0,,,,2,1,1,2
C(C1(C(C2C(CC(O)O2)O1)O)O)O,,,5,1,2,0,2
55305_0,,,,2,1,1,2
55307_0,,,,2,1,1,2
C1C2(CC(O)OC2C(CO)(O)O1)O,,,5,1,2,0,2
55308_0,,,,2,1,1,2
55310_0,,,,2,1,1,2
CC1(C2C(C(C(CO)(O)O2)O1)O)O,,,5,1,2,0,2
55311_0,,,,2,1,1,2
55313_0,,,,2,1,1,2
CC1(C2C(O)OC1C(CO)(O)O2)O,,,5,1,2,0,2
55314_0,,,,2,1,1,2
55316_0,,,,2,1,1,2
C1C2(CC(C(O)O2)(O)O1)C(CO)O,,,5,1,2,0,2
55318_0,,,,2,1,1,2
C1(C2(CC(CO)(C(CO)O2)O1)O)O,,,5,1,2,0,2
55319_0,,,,2,1,1,2
55320_0,,,,2,1,1,2
55322_0,,,,2,1,1,2
C1C2(C(CO)OC(C2C(O)O1)O)O,,,5,1,2,0,2
55323_0,,,,2,1,1,2
55325_0,,,,2,1,1,2
C1(C2(CC(C(CO)(CO)O2)O1)O)O,,,5,1,2,0,2
55326_0,,,,2,1,1,2
55328_0,,,,2,1,1,2
C1(C(O)OC2(C(O)OCC12)C)=O,,,5,1,2,0,2
55329_0,,,,2,1,1,2
55331_0,,,,2,1,1,2
C(C1(C2COC(C2(C)O)O1)O)=O,,,5,1,1,0,1
55333_0,,,,2,1,1,2
C(C1C2C(O)OC(C2(C)O)O1)=O,,,5,1,1,0,1
55335_0,,,,2,1,1,2
C(C1C2C(O)OC1(C)C(O)O2)=O,,,5,1,2,0,2
55336_0,,,,2,1,1,2
55338_0,,,,2,1,1,2
C(C1(C)C2C(O)OC(C2O)O1)=O,,,5,1,1,0,1
55340_0,,,,2,1,1,2
C1(C(O)OC2C(C)(O)OCC12)=O,,,5,1,2,0,2
55341_0,,,,2,1,1,2
55343_0,,,,2,1,1,2
C(C1(C2COC(C)(C2O)O1)O)=O,,,5,1,1,0,1
55345_0,,,,2,1,1,2
C(C1C2C(O)OC(C)(C2O)O1)=O,,,5,1,1,0,1
55347_0,,,,2,1,1,2
C(C1C2C(O)OC1C(C)(O)O2)=O,,,5,1,2,0,2
55348_0,,,,2,1,1,2
55350_0,,,,2,1,1,2
C(C)(C1C2C(O)OC(C2O)O1)=O,,,5,1,1,0,1
55351_0,,,,2,1,1,2
55353_0,,,,2,1,1,2
C(C1(CC2C(CC(O)O2)O1)O)=O,,,5,1,2,0,2
55355_0,,,,2,1,1,2
C(CC1C2CC(C(O)O2)(O)O1)=O,,,5,1,2,0,2
55356_0,,,,2,1,1,2
55357_0,,,,2,1,1,2
55359_0,,,,2,1,1,2
C(CC12COC(C(O)O1)(C2)O)=O,,,5,1,2,0,2
55360_0,,,,2,1,1,2
55361_0,,,,2,1,1,2
55363_0,,,,2,1,1,2
C(C)(C1C2CC(C(O)O2)(O1)O)=O,,,5,1,2,0,2
55364_0,,,,2,1,1,2
55366_0,,,,2,1,1,2
C(C1C2(C)CC(C(O)O2)(O1)O)=O,,,5,1,2,0,2
55367_0,,,,2,1,1,2
55368_0,,,,2,1,1,2
55370_0,,,,2,1,1,2
C(C(C1C2CC(C(O)O2)(O)O1)O)O,,,5,1,2,0,2
55371_0,,,,2,1,1,2
55372_0,,,,2,1,1,2
55374_0,,,,2,1,1,2
C(CC1C2C(O)OC(C2O)O1)=O,,,5,1,1,0,1
55376_0,,,,2,1,1,2
C(C1C(O)OC2C1OC(C2)O)=O,,,5,1,2,0,2
55377_0,,,,2,1,1,2
55379_0,,,,2,1,1,2
C1(C2(C(CO)C(C(CO)O2)O1)O)O,,,5,1,2,0,2
55380_0,,,,2,1,1,2
55381_0,,,,2,1,1,2
55383_0,,,,2,1,1,2
C1C2C(CO)C(C(O)O2)(O)O1,,,5,1,2,0,2
55384_0,,,,2,1,1,2
55385_0,,,,2,1,1,2
55387_0,,,,2,1,1,2
C1(CC2C(CC(O)O2)O1)O,,,5,1,1,0,1
55388_0,,,,2,1,1,2
55390_0,,,,2,1,1,2
C12C(C(C(O)O1)C(C)O2)O,,,5,1,1,0,1
55392_0,,,,2,1,1,2
C12C(C(C(O)O1)O)C(C(CO)O2)O,,,5,1,1,0,1
55394_0,,,,2,1,1,2
C1(C(C2C(O)OC(CO)C2O1)O)O,,,5,1,2,0,2
55395_0,,,,2,1,1,2
55397_0,,,,2,1,1,2
C12C(C(C(O)O1)C(C(CO)O)O2)O,,,5,1,1,0,1
55399_0,,,,2,1,1,2
C1C2C(O)OC(C2O)O1,,,5,1,1,0,1
55401_0,,,,2,1,1,2
C12C(C(CO1)O)C(C(O)O2)O,,,5,1,1,0,1
55403_0,,,,2,1,1,2
C1C2C(C(O)O1)C(C(O)O2)O,,,5,1,2,0,2
55404_0,,,,2,1,1,2
55406_0,,,,2,1,1,2
C12C(C(C(O)O1)C(CO)O2)O,,,5,1,1,0,1
55408_0,,,,2,1,1,2
C1C2(C(C(O)O1)OC(C2)O)O,,,5,1,2,0,2
55409_0,,,,2,1,1,2
55410_0,,,,2,1,1,2
55411_0,,,,2,1,1,2
55412_0,,,,2,1,1,2
55413_0,,,,2,1,1,2
55414_0,,,,2,1,1,2
55416_0,,,,2,1,1,2
CC1(C2C(O)OC1C(O)O2)O,,,5,1,1,0,1
55418_0,,,,2,1,1,2
C1C2C(C(C(O)O2)(O)O1)O,,,5,1,2,0,2
55419_0,,,,2,1,1,2
55421_0,,,,2,1,1,2
C1(C2(C(C(C(CO)O2)O1)O)O)O,,,5,1,2,0,2
55422_0,,,,2,1,1,2
55424_0,,,,2,1,1,2
C1C2(C(C(O1)OC2(CO)O)O)O,,,5,1,1,0,1
55426_0,,,,2,1,1,2
C1C2(C(O)OC(C2O)O1)O,,,5,1,1,0,1
55428_0,,,,2,1,1,2
C12C(C(C(O)O1)(C(CO)O2)O)O,,,5,1,1,0,1
55430_0,,,,2,1,1,2
C1C2C(C(O)O1)(C(C(O)O2)O)O,,,5,1,2,0,2
55431_0,,,,2,1,1,2
55433_0,,,,2,1,1,2
C12C(C(CO1)O)(C(C(O)O2)O)O,,,5,1,1,0,1
55435_0,,,,2,1,1,2
C1C2(COC(C2(C(C)(O)O1)O)O)O,,,5,1,2,0,2
55436_0,,,,2,1,1,2
55438_0,,,,2,1,1,2
C1C2(C(CO)(O)OC(C2(C)O)O1)O,,,5,1,1,0,1
55440_0,,,,2,1,1,2
C1C2(C(CO)(O)OC(C)(C2O)O1)O,,,5,1,1,0,1
55442_0,,,,2,1,1,2
C12C(C)(C(CO1)(C(O)O2)O)O,,,5,1,1,0,1
55444_0,,,,2,1,1,2
C12C(C)(C(C(O)O1)(C(CO)O2)O)O,,,5,1,1,0,1
55446_0,,,,2,1,1,2
CC1(C(O)OC2COC(C21O)O)O,,,5,1,2,0,2
55447_0,,,,2,1,1,2
55449_0,,,,2,1,1,2
C12C(C(CO1)O)(C(C)(C(O)O2)O)O,,,5,1,1,0,1
55451_0,,,,2,1,1,2
C1C2(C(O)OC(C)(C2O)O1)O,,,5,1,1,0,1
55453_0,,,,2,1,1,2
CC12C(C(C(O)O1)(C(CO)O2)O)O,,,5,1,1,0,1
55455_0,,,,2,1,1,2
CC1(C(C2(C(O)OCC2O1)O)O)O,,,5,1,2,0,2
55456_0,,,,2,1,1,2
55458_0,,,,2,1,1,2
C12C(C(CO1)O)(C(C(C)(O)O2)O)O,,,5,1,1,0,1
55460_0,,,,2,1,1,2
C1C(C2(C(O)O1)C(CC(O)O2)O)O,,,5,1,2,0,2
55461_0,,,,2,1,1,2
55463_0,,,,2,1,1,2
C12C(CCO)(C(CO1)(C(O)O2)O)O,,,5,1,1,0,1
55465_0,,,,2,1,1,2
C1C2(C(O)OC(CCO)(C2O)O1)O,,,5,1,1,0,1
55467_0,,,,2,1,1,2
C1(C(CO)(C2C(CC(O)O2)O1)O)O,,,5,1,2,0,2
55468_0,,,,2,1,1,2
55470_0,,,,2,1,1,2
C1C2(CC(O)OC2(C(O)O1)CO)O,,,5,1,2,0,2
55471_0,,,,2,1,1,2
55473_0,,,,2,1,1,2
CC1(C2C(C(C(O)O2)(CO)O1)O)O,,,5,1,2,0,2
55474_0,,,,2,1,1,2
55476_0,,,,2,1,1,2
CC1(C2C(O)OC1(C(O)O2)CO)O,,,5,1,2,0,2
55477_0,,,,2,1,1,2
55479_0,,,,2,1,1,2
C(C1C2(C(O)OC(C2)O1)O)=O,,,5,1,1,0,1
55481_0,,,,2,1,1,2
C12CC(C(O)O1)(C(CO)(CO)O2)O,,,5,1,1,0,1
55483_0,,,,2,1,1,2
C1C2(CO)C(C(O)O1)(CC(O)O2)O,,,5,1,2,0,2
55484_0,,,,2,1,1,2
55486_0,,,,2,1,1,2
C12C(CC(O)O1)(C(CO2)(CO)O)O,,,5,1,1,0,1
55488_0,,,,2,1,1,2
C(C1(C)C2(C(O)OC(C2)O1)O)=O,,,5,1,1,0,1
55490_0,,,,2,1,1,2
C(C)(C1C2(C(O)OC(C2)O1)O)=O,,,5,1,1,0,1
55492_0,,,,2,1,1,2
C(C12CC(O)OC1CC(O2)O)=O,,,5,1,2,0,2
55493_0,,,,2,1,1,2
55495_0,,,,2,1,1,2
C(CC1C2(C(O)OC(C2)O1)O)=O,,,5,1,1,0,1
55497_0,,,,2,1,1,2
C12CC(C(O)O1)(C(C)O2)O,,,5,1,1,0,1
55499_0,,,,2,1,1,2
C12C(CC(O)O1)(C(C(CO)O2)O)O,,,5,1,1,0,1
55501_0,,,,2,1,1,2
C1(C2(CC(O)OC2C(CO)O1)O)O,,,5,1,2,0,2
55502_0,,,,2,1,1,2
55504_0,,,,2,1,1,2
C12CC(C(O)O1)(C(C(CO)O)O2)O,,,5,1,1,0,1
55506_0,,,,2,1,1,2
C1C2(C(O)OC(C2)O1)O,,,5,1,1,0,1
55507_0,,,,2,1,1,2
55509_0,,,,2,1,1,2
C12CC(C(O)O1)(C(CO)O2)O,,,5,1,1,0,1
55511_0,,,,2,1,1,2
C1C2(C(O)OC(CO)(C2)O1)O,,,5,1,1,0,1
55513_0,,,,2,1,1,2
C1(COC2C(C1C(O)O2)O)=O,,,5,1,1,0,1
55515_0,,,,2,1,1,2
C1C2(COC(C(C2)(O)O1)O)O,,,5,1,2,0,2
55517_0,,,,2,1,1,2
C1C2(COC(C(C2CO)(O)O1)O)O,,,5,1,2,0,2
55519_0,,,,2,1,1,2
C1C(CO)(C2C(O)OC(C2O)O1)O,,,5,1,1,0,1
55521_0,,,,2,1,1,2
C1C2(COC(C2C(C(O)O1)O)O)O,,,5,1,2,0,2
55523_0,,,,2,1,1,2
C1C2(CO)C(C(CC(O)O2)(O)O1)O,,,5,1,2,0,2
55525_0,,,,2,1,1,2
C1C2(CO)CC(C(C(O)O2)O)(O)O1,,,5,1,2,0,2
55527_0,,,,2,1,1,2
C1CC2(C(O)OC(CO)(C2O)O1)O,,,5,1,1,0,1
55529_0,,,,2,1,1,2
C(C1(C2C(C(CC(O)O2)O1)O)O)O,,,5,1,2,0,2
55531_0,,,,2,1,1,2
C(C1(C(C2CC(C(O)O2)O1)O)O)O,,,5,1,2,0,2
55533_0,,,,2,1,1,2
C1C2(C(CO)OC(C(O)O1)(C2)O)O,,,5,1,2,0,2
55535_0,,,,2,1,1,2
C1C2(C(CO)OC(C(C2)(O)O1)O)O,,,5,1,2,0,2
55537_0,,,,2,1,1,2
C1C(C2(CO)CC(C(O)O2)(O)O1)O,,,5,1,2,0,2
55539_0,,,,2,1,1,2
C1C2(C(COC(C2C(O)O1)O)O)O,,,5,1,2,0,2
55541_0,,,,2,1,1,2
C1C2C(CO)(C(C(O)O2)C(O)O1)O,,,5,1,2,0,2
55543_0,,,,2,1,1,2
C1C(CO)(C2CC(C(O)O2)(O)O1)O,,,5,1,2,0,2
55545_0,,,,2,1,1,2
C1C2(CO)C(C(C(O)O2)C(O)O1)O,,,5,1,2,0,2
55547_0,,,,2,1,1,2
C1(COC2C(C)(C1C(O)O2)O)=O,,,5,1,1,0,1
55549_0,,,,2,1,1,2
C1(COC2(C)C(C1C(O)O2)O)=O,,,5,1,1,0,1
55551_0,,,,2,1,1,2
C(C12CC(C(O1)O)(CCO2)O)=O,,,5,1,1,0,1
55553_0,,,,2,1,1,2
C(C12CCOC(C1)(C(O2)O)O)=O,,,5,1,2,0,2
55555_0,,,,2,1,1,2
C1(C(O)OC2C(C1)OC(C2)O)=O,,,5,1,2,0,2
55557_0,,,,2,1,1,2
C(C1(CC2CC(C(O)O2)O1)O)=O,,,5,1,2,0,2
55559_0,,,,2,1,1,2
C(C1CC2CC(C(O)O2)(O1)O)=O,,,5,1,2,0,2
55561_0,,,,2,1,1,2
C1C(C2CC(C(O)O2)(O)O1)O,,,5,1,2,0,2
55563_0,,,,2,1,1,2
C1(C2(CC(C(C(CO)O2)O)O1)O)O,,,5,1,2,0,2
55565_0,,,,2,1,1,2
C1(C(O)OC2CC(O)OCC12)=O,,,5,1,2,0,2
55567_0,,,,2,1,1,2
C(C1C2C(O)OC1CC(O)O2)=O,,,5,1,2,0,2
55569_0,,,,2,1,1,2
C1(C2C(CC(O2)O)OC(C1)O)=O,,,5,1,2,0,2
55571_0,,,,2,1,1,2
C(C1C2OCCC1(C(O)O2)O)=O,,,5,1,1,0,1
55573_0,,,,2,1,1,2
C(C1C(O)OC2C(O)OC1C2)=O,,,5,1,2,0,2
55575_0,,,,2,1,1,2
C1(C2C(O)OC(C(CO)O1)C2O)O,,,5,1,2,0,2
55577_0,,,,2,1,1,2
C12CC(C(O)O1)(CCO2)O,,,5,1,1,0,1
55579_0,,,,2,1,1,2
C12C(C(C(O)O1)(CCO2)O)O,,,5,1,1,0,1
55581_0,,,,2,1,1,2
C1C(C2C(CO)C(C(O)O2)(O)O1)O,,,5,1,2,0,2
55583_0,,,,2,1,1,2
C1C2C(C(O)O1)(O)OCC(C2O)O,,,5,1,2,0,2
55585_0,,,,2,1,1,2
C1(C2C(C(CC(O)O2)O1)O)O,,,5,1,2,0,2
55587_0,,,,2,1,1,2
C1(CC2CC(C(O)O2)O1)O,,,5,1,2,0,2
55589_0,,,,2,1,1,2
C1(C2CC(C(C(O)O2)O)O1)O,,,5,1,2,0,2
55591_0,,,,2,1,1,2
C12C(C(C(O)O1)C(C(CO)O2)O)O,,,5,1,1,0,1
55593_0,,,,2,1,1,2
C12C(C(C(O)O1)O)C(C(CO2)O)O,,,5,1,1,0,1
55595_0,,,,2,1,1,2
C1C(C2C(C(O)O1)C(C(O)O2)O)O,,,5,1,2,0,2
55597_0,,,,2,1,1,2
C12C(C(C(O)O1)C(CO2)O)O,,,5,1,1,0,1
55599_0,,,,2,1,1,2
C1C2C(C(C(O)O1)C(CO)(O)O2)O,,,5,1,2,0,2
55601_0,,,,2,1,1,2
C1C2C(C(C(O)O2)C(CO)(O)O1)O,,,5,1,2,0,2
55603_0,,,,2,1,1,2
C1C(C(C2C(O)OCC2(O)O1)O)O,,,5,1,2,0,2
55605_0,,,,2,1,1,2
C1C(C(C2C(CC(O)O2)(O)O1)O)O,,,5,1,2,0,2
55607_0,,,,2,1,1,2
C1(CC2(C(C(C(CO)O2)O1)O)O)O,,,5,1,2,0,2
55609_0,,,,2,1,1,2
C1(C(C2(CC(C(CO)O2)O1)O)O)O,,,5,1,2,0,2
55611_0,,,,2,1,1,2
C1C(C2C(C(C(O)O2)(O)O1)O)O,,,5,1,2,0,2
55613_0,,,,2,1,1,2
C12C(C(C(O)O1)(C(CO2)O)O)O,,,5,1,1,0,1
55615_0,,,,2,1,1,2
C12C(C)(C(C(O)O1)(C(CO2)O)O)O,,,5,1,1,0,1
55617_0,,,,2,1,1,2
C1C(C2(C(O)OC(C)(C2O)O1)O)O,,,5,1,1,0,1
55619_0,,,,2,1,1,2
C1C2C(C(O)O1)(C(CC(O)O2)O)O,,,5,1,2,0,2
55621_0,,,,2,1,1,2
C1C2(C(O)OCCC2(C(O)O1)O)O,,,5,1,2,0,2
55623_0,,,,2,1,1,2
C12C(CO)(C(C(O)O1)(CCO2)O)O,,,5,1,1,0,1
55625_0,,,,2,1,1,2
C1(C2(CO)C(C(CC(O)O2)O1)O)O,,,5,1,2,0,2
55627_0,,,,2,1,1,2
C1(C(CO)(C2CC(C(O)O2)O1)O)O,,,5,1,2,0,2
55629_0,,,,2,1,1,2
C1C2(CC(O)OCC2(C(O)O1)O)O,,,5,1,2,0,2
55631_0,,,,2,1,1,2
CC1(C2(C(O)OCC(C2O)O1)O)O,,,5,1,2,0,2
55633_0,,,,2,1,1,2
CC1(C2(C(O)OC(CO1)C2O)O)O,,,5,1,2,0,2
55635_0,,,,2,1,1,2
CC1(C2C(C(CO1)(C(O)O2)O)O)O,,,5,1,2,0,2
55637_0,,,,2,1,1,2
CC1(C2C(O)OCC1(C(O)O2)O)O,,,5,1,2,0,2
55639_0,,,,2,1,1,2
C1C(CO)(C2(C(O)OC(C2)O1)O)O,,,5,1,1,0,1
55641_0,,,,2,1,1,2
C1C2(COC(C2(CC(O)O1)O)O)O,,,5,1,2,0,2
55643_0,,,,2,1,1,2
C12CC(C(O)O1)(C(C(CO)O2)O)O,,,5,1,1,0,1
55645_0,,,,2,1,1,2
C1C(C(C2(C(O1)OC(C2)O)O)O)O,,,5,1,1,0,1
55647_0,,,,2,1,1,2
C1C(C2C(C(O)O1)(CC(O)O2)O)O,,,5,1,2,0,2
55649_0,,,,2,1,1,2
C1C(C2(C(O)OC(C2)O1)O)O,,,5,1,1,0,1
55651_0,,,,2,1,1,2
C1C(C2(C(C(C(O2)O1)O)O)O)O,,,5,1,1,0,1
55653_0,,,,2,1,1,2
C1C2(COC(CC(C2O)(O)O1)O)O,,,5,1,2,0,2
55655_0,,,,2,1,1,2
C1C2(COC(C(C(C2)(O)O1)O)O)O,,,5,1,2,0,2
55657_0,,,,2,1,1,2
C1CC2(C(C(C(CO)(O2)O1)O)O)O,,,5,1,1,0,1
55659_0,,,,2,1,1,2
C1C2(CC(C(C(CO)(O)O1)O2)O)O,,,5,1,2,0,2
55661_0,,,,2,1,1,2
C1C2(C(C(CO2)(CC(O)O1)O)O)O,,,5,1,2,0,2
55663_0,,,,2,1,1,2
C1C2(C(C(C(C(C)(O)O1)O2)O)O)O,,,5,1,2,0,2
55665_0,,,,2,1,1,2
C1C2(C(C(C)(C(C(O)O1)O2)O)O)O,,,5,1,2,0,2
55667_0,,,,2,1,1,2
C1C(C2(COC(C(O)O1)(C2)O)O)O,,,5,1,2,0,2
55669_0,,,,2,1,1,2
C1C2C(CO)(CC(C(O)O1)(O)O2)O,,,5,1,2,0,2
55671_0,,,,2,1,1,2
C12C(C)(C(C(C(CO1)O)(O)O2)O)O,,,5,1,1,0,1
55673_0,,,,2,1,1,2
C1C(C2(C(C(C(C)(O2)O1)O)O)O)O,,,5,1,1,0,1
55675_0,,,,2,1,1,2
C1C2(CO)C(CC(C(O)O1)(O)O2)O,,,5,1,2,0,2
55677_0,,,,2,1,1,2
C(C12CC(C(CCO1)(O2)O)O)=O,,,5,1,1,0,1
55679_0,,,,2,1,1,2
C1(C2CC(C(O2)O)(O)OCC1)=O,,,5,1,2,0,2
55681_0,,,,2,1,1,2
C1(C(O)OC2C(O)OC(C2)C1)=O,,,5,1,2,0,2
55683_0,,,,2,1,1,2
C1(COC2(C(O)OC(C2)C1)O)=O,,,5,1,2,0,2
55685_0,,,,2,1,1,2
C1(C2(CC(C(C(CO)O1)O2)O)O)O,,,5,1,2,0,2
55687_0,,,,2,1,1,2
C1C(C(C2CC(C(O)O2)(O)O1)O)O,,,5,1,2,0,2
55689_0,,,,2,1,1,2
C(C1C2OCCC(C1O)(O)O2)=O,,,5,1,1,0,1
55691_0,,,,2,1,1,2
C1C(C2C(C(C(O)O2)C(O)O1)O)O,,,5,1,2,0,2
55693_0,,,,2,1,1,2
C1CC2(C(CC(O2)O1)O)O,,,5,1,1,0,1
55695_0,,,,2,1,1,2
C1C2C(C(CO)C(C(O)O1)(O)O2)O,,,5,1,2,0,2
55697_0,,,,2,1,1,2
C1C2C(C(C(O)O2)C(C(O)O1)O)O,,,5,1,2,0,2
55699_0,,,,2,1,1,2
C12C(C(C(O)O1)C(C(CO2)O)O)O,,,5,1,1,0,1
55701_0,,,,2,1,1,2
C1C2C(C(C(C(O)O1)(O)O2)O)O,,,5,1,2,0,2
55703_0,,,,2,1,1,2
C1C2(C(O)OCCC(C2O)(O)O1)O,,,5,1,2,0,2
55705_0,,,,2,1,1,2
C12C(CO)(C(C(CCO1)(O)O2)O)O,,,5,1,1,0,1
55707_0,,,,2,1,1,2
C1C2(C(O)OC(CC(O)O1)C2O)O,,,5,1,2,0,2
55709_0,,,,2,1,1,2
C1C2(CC(C(C(O)O1)(CO)O2)O)O,,,5,1,2,0,2
55711_0,,,,2,1,1,2
C1C2C(C(C(O)O2)(CC(O)O1)O)O,,,5,1,2,0,2
55713_0,,,,2,1,1,2
C1C(C(C2(C(O)OC(C2)O1)O)O)O,,,5,1,1,0,1
55715_0,,,,2,1,1,2
C1(C2C(CO1)(CC(O2)O)O)=O,,,5,1,2,0,2
55717_0,,,,2,1,1,2
C1(C2C(C)(C(C(O2)O)O1)O)=O,,,5,1,2,0,2
55719_0,,,,2,1,1,2
C1(C(C2CC(C(O)O2)O1)O)=O,,,5,1,2,0,2
55721_0,,,,2,1,1,2
C(C(C=O)C1CCC(C=O)(O)O1)=O,,,5,1,1,0,1
55723_0,,,,2,1,1,2
C(C(C=O)C1C(C=O)CC(O)O1)=O,,,5,1,1,0,1
55725_0,,,,2,1,1,2
C(C1(C=O)COC(C1CC=O)O)=O,,,5,1,1,0,1
55727_0,,,,2,1,1,2
C(C1C(C)OC(C1CC=O)O)=O,,,5,1,1,0,1
55729_0,,,,2,1,1,2
C(CC1(C)CCC(C=O)(O)O1)=O,,,5,1,1,0,1
55731_0,,,,2,1,1,2
C(C1CC(O)OC1(C)CC=O)=O,,,5,1,1,0,1
55733_0,,,,2,1,1,2
C(CC1CC(C(O)O1)CC=O)=O,,,5,1,1,0,1
55735_0,,,,2,1,1,2
C(C1(C(C)O)CCC(C=O)(O1)O)=O,,,5,1,1,0,1
55737_0,,,,2,1,1,2
C(C1CC(OC1(C=O)C(C)O)O)=O,,,5,1,1,0,1
55739_0,,,,2,1,1,2
C(C1(C(C)OC(C1CC=O)O)O)=O,,,5,1,1,0,1
55741_0,,,,2,1,1,2
C(C(C1(C)CCC(C=O)(O)O1)O)=O,,,5,1,1,0,1
55743_0,,,,2,1,1,2
C(CC1C(OC(C=O)C1(C)O)O)=O,,,5,1,1,0,1
55745_0,,,,2,1,1,2
C(C1CC(O)OC1(C)C(C=O)O)=O,,,5,1,1,0,1
55747_0,,,,2,1,1,2
C(CC1C(O)OC(C1)C(C=O)O)=O,,,5,1,1,0,1
55749_0,,,,2,1,1,2
C(CC1CCC(C=O)(O)O1)=O,,,5,1,1,0,1
55751_0,,,,2,1,1,2
C(C1C(CC=O)OC(C1)O)=O,,,5,1,1,0,1
55753_0,,,,2,1,1,2
C(C1COC(C1CC=O)O)=O,,,5,1,1,0,1
55755_0,,,,2,1,1,2
C(CC(C1CCC(C=O)(O)O1)O)=O,,,5,1,1,0,1
55757_0,,,,2,1,1,2
C(C(CCC1C(CC(O)O1)O)=O)=O,,,5,1,2,0,2
55759_0,,,,2,1,1,2
C(C1C(C(CC=O)O)OC(C1)O)=O,,,5,1,1,0,1
55761_0,,,,2,1,1,2
C(C(C1C(CC(O)O1)O)CC=O)=O,,,5,1,2,0,2
55763_0,,,,2,1,1,2
C(CC1C(C(C(O)O1)CC=O)O)=O,,,5,1,1,0,1
55765_0,,,,2,1,1,2
C(C(CCC1(COC(C1)O)O)=O)=O,,,5,1,2,0,2
55767_0,,,,2,1,1,2
C(CC1(CO)CCC(C=O)(O)O1)=O,,,5,1,1,0,1
55769_0,,,,2,1,1,2
C(CC1(COC(C1CC=O)O)O)=O,,,5,1,1,0,1
55770_0,,,,2,1,1,2
55772_0,,,,2,1,1,2
C(C1CC(O)OC1(CO)CC=O)=O,,,5,1,1,0,1
55774_0,,,,2,1,1,2
C(C(CCC1C(O)OCC1O)=O)=O,,,5,1,2,0,2
55776_0,,,,2,1,1,2
C(C(C1C(O)OCC1O)CC=O)=O,,,5,1,2,0,2
55778_0,,,,2,1,1,2
C(C1C(CO)OC(C1CC=O)O)=O,,,5,1,1,0,1
55780_0,,,,2,1,1,2
C(C1(C)CCC(C=O)(O1)O)(O)=O,,,5,1,1,0,1
55782_0,,,,2,1,1,2
C1(C(C)(C(C(O)O1)CC=O)O)=O,,,5,1,1,0,1
55784_0,,,,2,1,1,2
C(C1CC(OC1(C(O)=O)C)O)=O,,,5,1,1,0,1
55786_0,,,,2,1,1,2
C(CC1CC(C(O)=O)OC1O)=O,,,5,1,1,0,1
55788_0,,,,2,1,1,2
C(C1(CCC(C(C=O)=O)O1)O)=O,,,5,1,1,0,1
55790_0,,,,2,1,1,2
C(C1CC(OC1C(C=O)=O)O)=O,,,5,1,1,0,1
55792_0,,,,2,1,1,2
C(C1(CCC(C(C(C)=O)=O)O1)O)=O,,,5,1,1,0,1
55794_0,,,,2,1,1,2
C(C1CC(OC1C(C(C)=O)=O)O)=O,,,5,1,1,0,1
55796_0,,,,2,1,1,2
C(CC1CC(C(C=O)=O)OC1O)=O,,,5,1,1,0,1
55798_0,,,,2,1,1,2
C(C1(CCC(C(C=O)=O)(C)O1)O)=O,,,5,1,1,0,1
55800_0,,,,2,1,1,2
C(C1CC(OC1(C(C=O)=O)C)O)=O,,,5,1,1,0,1
55802_0,,,,2,1,1,2
C(C1(CCC(C(C)=O)O1)O)=O,,,5,1,1,0,1
55804_0,,,,2,1,1,2
C(C1CC(OC1C(C)=O)O)=O,,,5,1,1,0,1
55806_0,,,,2,1,1,2
C(C1CCC(C=O)(O1)O)(CCO)=O,,,5,1,1,0,1
55808_0,,,,2,1,1,2
C(C1CC(OC1C(CCO)=O)O)=O,,,5,1,1,0,1
55810_0,,,,2,1,1,2
C(C1(CCC(CC(CO)=O)O1)O)=O,,,5,1,1,0,1
55812_0,,,,2,1,1,2
C(C1C(CC(CO)=O)OC(C1)O)=O,,,5,1,1,0,1
55814_0,,,,2,1,1,2
C(CC1C(O)OCC1C(CO)=O)=O,,,5,1,1,0,1
55816_0,,,,2,1,1,2
C(C(CCC1(C(O)OCC1)O)=O)=O,,,5,1,2,0,2
55818_0,,,,2,1,1,2
C(C1(CCO)CCC(C=O)(O1)O)=O,,,5,1,1,0,1
55819_0,,,,2,1,1,2
55821_0,,,,2,1,1,2
C(C1CC(OC1(C=O)CCO)O)=O,,,5,1,1,0,1
55823_0,,,,2,1,1,2
C(C(CC1CCC(C=O)(O)O1)O)=O,,,5,1,1,0,1
55825_0,,,,2,1,1,2
C(C(CCC1CC(C(O)O1)O)=O)=O,,,5,1,2,0,2
55827_0,,,,2,1,1,2
C(C1C(CC(C=O)O)OC(C1)O)=O,,,5,1,1,0,1
55829_0,,,,2,1,1,2
C(C(C1CC(C(O)O1)O)CC=O)=O,,,5,1,2,0,2
55831_0,,,,2,1,1,2
C(C(CCC1COC(C1O)O)=O)=O,,,5,1,2,0,2
55833_0,,,,2,1,1,2
C(CC1C(O)OCC1C(C=O)O)=O,,,5,1,1,0,1
55835_0,,,,2,1,1,2
C(C(C1COC(C1O)O)CC=O)=O,,,5,1,2,0,2
55837_0,,,,2,1,1,2
C(CC1C(OC(C=O)C1CO)O)=O,,,5,1,1,0,1
55839_0,,,,2,1,1,2
C(C1(CCC(C(C)=O)(CO)O1)O)=O,,,5,1,1,0,1
55841_0,,,,2,1,1,2
C(CC1C(O)OCC1(C(C)=O)O)=O,,,5,1,1,0,1
55843_0,,,,2,1,1,2
C(C1CC(OC1(C(C)=O)CO)O)=O,,,5,1,1,0,1
55845_0,,,,2,1,1,2
C(C1(CCC(C(C(C)=O)O)O1)O)=O,,,5,1,1,0,1
55847_0,,,,2,1,1,2
C(C1C(C(C(C)=O)O)OC(C1)O)=O,,,5,1,1,0,1
55849_0,,,,2,1,1,2
C(CC1C(C(C(C)=O)OC1O)O)=O,,,5,1,1,0,1
55851_0,,,,2,1,1,2
C(C1(CCC(C)O1)O)=O,,,5,1,1,0,1
55853_0,,,,2,1,1,2
C(C1C(C)OC(C1)O)=O,,,5,1,1,0,1
55855_0,,,,2,1,1,2
C(CC1C(O)OCC1)=O,,,5,1,1,0,1
55857_0,,,,2,1,1,2
C1(C(C=O)C(C(O)O1)CC=O)=O,,,5,1,1,0,1
55859_0,,,,2,1,1,2
C1(CC(C(O)O1)CC=O)=O,,,5,1,1,0,1
55861_0,,,,2,1,1,2
C(CC1C(OC2C(COC12)=O)O)=O,,,5,1,1,0,1
55863_0,,,,2,1,1,2
C(C1(CCC2(C(COC2)=O)O1)O)=O,,,5,1,1,0,1
55865_0,,,,2,1,1,2
C(C1CC(OC21C(COC2)=O)O)=O,,,5,1,1,0,1
55867_0,,,,2,1,1,2
C1(C2(CCC(C=O)(O2)O)OCC1)=O,,,5,1,1,0,1
55869_0,,,,2,1,1,2
C(C1CC(OC21C(CCO2)=O)O)=O,,,5,1,1,0,1
55871_0,,,,2,1,1,2
C1(C2C(CO1)OC(C2CC=O)O)=O,,,5,1,1,0,1
55873_0,,,,2,1,1,2
C1(CC2C(C(C(O)O2)CC=O)O1)=O,,,5,1,1,0,1
55875_0,,,,2,1,1,2
C1(CC2(CO1)CCC(C=O)(O)O2)=O,,,5,1,1,0,1
55877_0,,,,2,1,1,2
C(C1CC(O)OC21COC(C2)=O)=O,,,5,1,1,0,1
55879_0,,,,2,1,1,2
C(CC1C(O)OC2C1C(CO2)=O)=O,,,5,1,1,0,1
55881_0,,,,2,1,1,2
C(C1(CCC2(CC(CO2)=O)O1)O)=O,,,5,1,1,0,1
55883_0,,,,2,1,1,2
C(C1C2(CC(CO2)=O)OC(C1)O)=O,,,5,1,1,0,1
55885_0,,,,2,1,1,2
C(C1(CO)CCC(C=O)(O1)O)=O,,,5,1,1,0,1
55887_0,,,,2,1,1,2
C(C(C1CCC(C=O)(O)O1)O)=O,,,5,1,1,0,1
55889_0,,,,2,1,1,2
C(C1(CCCO1)O)=O,,,5,1,1,0,1
55891_0,,,,2,1,1,2
C(C1(CCC(CO)O1)O)=O,,,5,1,1,0,1
55893_0,,,,2,1,1,2
C(C1CCC(C=O)(O1)O)(O)=O,,,5,1,1,0,1
55895_0,,,,2,1,1,2
C(C1(CCC(C(CO)=O)O1)O)=O,,,5,1,1,0,1
55897_0,,,,2,1,1,2
C(C1(CCC(CO)(CO)O1)O)=O,,,5,1,1,0,1
55899_0,,,,2,1,1,2
C(C1(CCC(C(CO)O)O1)O)=O,,,5,1,1,0,1
55901_0,,,,2,1,1,2
C(C1(CO)CCC(C=O)(O1)O)(O)=O,,,5,1,1,0,1
55903_0,,,,2,1,1,2
C(C(C1CCC(C=O)(O)O1)O)(O)=O,,,5,1,1,0,1
55904_0,,,,2,1,1,2
55906_0,,,,2,1,1,2
C(C1(CCC(CC(C=O)=O)O1)O)=O,,,5,1,1,0,1
55907_0,,,,2,1,1,2
55909_0,,,,2,1,1,2
C(C1(CCC(C=O)(O1)O)CC=O)=O,,,5,1,1,0,1
55910_0,,,,2,1,1,2
55911_0,,,,2,1,1,2
55913_0,,,,2,1,1,2
C(C1CCC(C=O)(O1)O)(CC=O)=O,,,5,1,1,0,1
55915_0,,,,2,1,1,2
C(C1(CCC(C=O)(C(C)=O)O1)O)=O,,,5,1,1,0,1
55917_0,,,,2,1,1,2
C(CC1C(C(C=O)OC1O)O)=O,,,5,1,1,0,1
55919_0,,,,2,1,1,2
C(C1C(C(C=O)O)OC(C1)O)=O,,,5,1,1,0,1
55921_0,,,,2,1,1,2
C(CC1C(O)OCC1(CO)O)=O,,,5,1,1,0,1
55923_0,,,,2,1,1,2
C(C1CC(O)OC1(CO)CO)=O,,,5,1,1,0,1
55925_0,,,,2,1,1,2
C(C1CC(O)OC1C(CO)O)=O,,,5,1,1,0,1
55927_0,,,,2,1,1,2
C(CC1C(O)OC(CO)C1O)=O,,,5,1,1,0,1
55929_0,,,,2,1,1,2
C1(C(CO)(C(C(O)O1)CC=O)O)=O,,,5,1,1,0,1
55931_0,,,,2,1,1,2
C(C1CC(OC1(C(O)=O)CO)O)=O,,,5,1,1,0,1
55933_0,,,,2,1,1,2
C(C1(COC(C1CC=O)O)O)(O)=O,,,5,1,1,0,1
55935_0,,,,2,1,1,2
C(CC1C(C(C(O)=O)OC1O)O)=O,,,5,1,1,0,1
55937_0,,,,2,1,1,2
C(C1C(C(C(O)=O)O)OC(C1)O)=O,,,5,1,1,0,1
55938_0,,,,2,1,1,2
55940_0,,,,2,1,1,2
C(C1C(CC(C=O)=O)OC(C1)O)=O,,,5,1,1,0,1
55941_0,,,,2,1,1,2
55943_0,,,,2,1,1,2
C(CC1C(O)OCC1C(C=O)=O)=O,,,5,1,1,0,1
55945_0,,,,2,1,1,2
C(CC1(C=O)C(C=O)CC(O1)O)=O,,,5,1,1,0,1
55947_0,,,,2,1,1,2
C(CC1C(OC(C=O)C1C=O)O)=O,,,5,1,1,0,1
55948_0,,,,2,1,1,2
55949_0,,,,2,1,1,2
55951_0,,,,2,1,1,2
C(C1CC(OC1C(CC=O)=O)O)=O,,,5,1,1,0,1
55953_0,,,,2,1,1,2
C(C1CC(OC1(C=O)C(C)=O)O)=O,,,5,1,1,0,1
55955_0,,,,2,1,1,2
C1CC2(C(C(C(C2O)O)(O)O1)O)O,,,5,1,2,0,2
55955_1,,,,2,1,1,2
55957_0,,,,2,1,1,2
C1C(C2(CC(C(C2O)O)(O)O1)O)O,,,5,1,2,0,2
55957_1,,,,2,1,1,2
55958_0,,,,2,1,1,2
55958_1,,,,2,1,1,2
55959_0,,,,2,1,1,2
55959_1,,,,2,1,1,2
55960_0,,,,2,1,1,2
55960_1,,,,2,1,1,2
55961_0,,,,2,1,1,2
55961_1,,,,2,1,1,2
55962_0,,,,2,1,1,2
55963_0,,,,2,1,1,2
55963_1,,,,2,1,1,2
55964_0,,,,2,1,1,2
55966_0,,,,2,1,1,2
C1C(C2(C(C(CC2O)(O)O1)O)O)O,,,5,1,2,0,2
55966_1,,,,2,1,1,2
55967_0,,,,2,1,1,2
55969_0,,,,2,1,1,2
C1C2(C(C(C(C(O)O1)C2O)O)O)O,,,5,1,2,0,2
55969_1,,,,2,1,1,2
55971_0,,,,2,1,1,2
C1C2(C(C(C(CC2O)(O)O1)O)O)O,,,5,1,1,0,1
55972_0,,,,2,1,1,2
55974_0,,,,2,1,1,2
C(C1C(C(CO)(CC(O1)O)O)O)=O,,,5,1,1,0,1
55975_0,,,,2,1,1,2
55977_0,,,,2,1,1,2
C(C1(CC(C=O)OC(C1)O)O)=O,,,5,1,1,0,1
55979_0,,,,2,1,1,2
C(C1(CC(C(OC1C=O)O)O)O)=O,,,5,1,1,0,1
55981_0,,,,2,1,1,2
C(C1(CC(C=O)OC(C1O)O)O)=O,,,5,1,1,0,1
55983_0,,,,2,1,1,2
C(CC1C(CC(C(O1)O)O)=O)=O,,,5,1,1,0,1
55984_0,,,,2,1,1,2
55986_0,,,,2,1,1,2
C(C1C(C(CC(C=O)(O1)O)O)O)=O,,,5,1,1,0,1
55988_0,,,,2,1,1,2
C(C(C1C(CC(C(O)O1)=O)O)O)=O,,,5,1,1,0,1
55989_0,,,,2,1,1,2
55991_0,,,,2,1,1,2
C(C(C1C(C(O)OCC1O)O)=O)=O,,,5,1,1,0,1
55993_0,,,,2,1,1,2
C(C1C(C(C=O)OC(C1O)O)O)=O,,,5,1,1,0,1
55995_0,,,,2,1,1,2
C(C1C(C(C(OC1C=O)O)O)O)=O,,,5,1,1,0,1
55997_0,,,,2,1,1,2
C(C1C(OC(C=O)C(C1O)O)O)=O,,,5,1,1,0,1
55998_0,,,,2,1,1,2
55999_0,,,,2,1,1,2
56000_0,,,,2,1,1,2
56001_0,,,,2,1,1,2
56002_0,,,,2,1,1,2
56003_0,,,,2,1,1,2
56005_0,,,,2,1,1,2
C(C1C(C(C(CO)C(O1)O)O)O)=O,,,5,1,1,0,1
56006_0,,,,2,1,1,2
56007_0,,,,2,1,1,2
56009_0,,,,2,1,1,2
C(C1C(C(CC(CO)(O1)O)O)O)=O,,,5,1,1,0,1
56010_0,,,,2,1,1,2
56012_0,,,,2,1,1,2
C(C1(CO)CC(CC(O)O1)O)O,,,5,1,1,0,1
56014_0,,,,2,1,1,2
C1(C(C(CC(CO)(CO)O1)O)O)O,,,5,1,1,0,1
56015_0,,,,2,1,1,2
56017_0,,,,2,1,1,2
C(C1COC(CO)(C(C1O)O)O)=O,,,5,1,1,0,1
56019_0,,,,2,1,1,2
CC1C(C(CO)(CC(O)O1)O)O,,,5,1,1,0,1
56021_0,,,,2,1,1,2
CC1C(C(CO)(C(C(O)O1)O)O)O,,,5,1,1,0,1
56022_0,,,,2,1,1,2
56023_0,,,,2,1,1,2
56025_0,,,,2,1,1,2
C1C(C(CC(O)O1)(C(CO)O)O)O,,,5,1,1,0,1
56026_0,,,,2,1,1,2
56028_0,,,,2,1,1,2
C(C1(CC(C=O)(C)OC(C1)O)O)=O,,,5,1,1,0,1
56030_0,,,,2,1,1,2
C(CC1C(CC(C)(C(O1)O)O)=O)=O,,,5,1,1,0,1
56032_0,,,,2,1,1,2
C(CC1C(C)(CC(C(O)O1)=O)O)=O,,,5,1,1,0,1
56034_0,,,,2,1,1,2
C(C1C(CC(OC1(C=O)C)O)O)=O,,,5,1,1,0,1
56036_0,,,,2,1,1,2
C(C1(C)CC(C(CO)C(O1)O)O)=O,,,5,1,1,0,1
56038_0,,,,2,1,1,2
C(C)(C1C(CC(C)(C(O1)O)O)O)=O,,,5,1,1,0,1
56040_0,,,,2,1,1,2
C(C1(C)CC(C(C(C)(O1)O)O)O)=O,,,5,1,1,0,1
56042_0,,,,2,1,1,2
C(C1(C)CC(CC(CO)(O1)O)O)=O,,,5,1,1,0,1
56044_0,,,,2,1,1,2
C(C1(C)CC(CC(C=O)(O1)O)O)=O,,,5,1,1,0,1
56046_0,,,,2,1,1,2
C(C1C(OC(C=O)(C)CC1O)O)=O,,,5,1,1,0,1
56048_0,,,,2,1,1,2
C(C1(C)CC(CC(O1)O)O)=O,,,5,1,1,0,1
56050_0,,,,2,1,1,2
C(C1C(CC(C)(C(O1)O)O)O)=O,,,5,1,1,0,1
56052_0,,,,2,1,1,2
C(C1(C)CC(C(C(O1)O)O)O)=O,,,5,1,1,0,1
56054_0,,,,2,1,1,2
C(C)(C1C(C(C)(CC(O1)O)O)O)=O,,,5,1,1,0,1
56056_0,,,,2,1,1,2
C(CC1(C)C(CC(C(O)O1)=O)O)=O,,,5,1,1,0,1
56058_0,,,,2,1,1,2
C(C1C(C(C)(CC(O1)O)O)O)=O,,,5,1,1,0,1
56060_0,,,,2,1,1,2
C(C(C)(C1C(O)OCCC1O)O)=O,,,5,1,1,0,1
56062_0,,,,2,1,1,2
C(C1C(COC(C1(C)O)O)(C)O)=O,,,5,1,1,0,1
56064_0,,,,2,1,1,2
C(C1C(C)(C(O)OC(C1O)=O)O)=O,,,5,1,1,0,1
56066_0,,,,2,1,1,2
C(C1C(COC(C1(C)O)O)O)=O,,,5,1,1,0,1
56068_0,,,,2,1,1,2
C(C1(C)C(C(CC(O1)O)O)O)=O,,,5,1,1,0,1
56069_0,,,,2,1,1,2
56070_0,,,,2,1,1,2
56072_0,,,,2,1,1,2
C(C1C(C)(C(CC(O1)O)O)O)=O,,,5,1,1,0,1
56074_0,,,,2,1,1,2
C(C1C(C(C)(C(C(O1)O)O)O)O)=O,,,5,1,1,0,1
56075_0,,,,2,1,1,2
56077_0,,,,2,1,1,2
C(C1(CC(C(C)=O)OC(C1)O)O)=O,,,5,1,1,0,1
56079_0,,,,2,1,1,2
C(CC1C(CC(C(C)(O1)O)O)=O)=O,,,5,1,1,0,1
56081_0,,,,2,1,1,2
C(C1C(CC(OC1C(C)=O)O)O)=O,,,5,1,1,0,1
56083_0,,,,2,1,1,2
C(C)(C1CC(C(CO)C(O1)O)O)=O,,,5,1,1,0,1
56085_0,,,,2,1,1,2
C(C)(C1C(CC(C(C)(O1)O)O)O)=O,,,5,1,1,0,1
56087_0,,,,2,1,1,2
C(C)(C1CC(C(C(C)(O1)O)O)O)=O,,,5,1,1,0,1
56089_0,,,,2,1,1,2
C(C)(C1CC(CC(CO)(O1)O)O)=O,,,5,1,1,0,1
56091_0,,,,2,1,1,2
C(C1(CC(CC(C(C)=O)O1)O)O)=O,,,5,1,1,0,1
56093_0,,,,2,1,1,2
C(C1C(OC(C(C)=O)CC1O)O)=O,,,5,1,1,0,1
56095_0,,,,2,1,1,2
C(C)(C1CC(CC(O1)O)O)=O,,,5,1,1,0,1
56097_0,,,,2,1,1,2
C(C1C(CC(C(C)(O1)O)O)O)=O,,,5,1,1,0,1
56099_0,,,,2,1,1,2
C(C)(C1CC(C(C(O1)O)O)O)=O,,,5,1,1,0,1
56101_0,,,,2,1,1,2
C(C)(C1C(C)(C(CC(O1)O)O)O)=O,,,5,1,1,0,1
56103_0,,,,2,1,1,2
C(C)(C(C1C(O)OCCC1O)O)=O,,,5,1,1,0,1
56105_0,,,,2,1,1,2
C(C1C(C(C)(O)OCC1(C)O)O)=O,,,5,1,1,0,1
56107_0,,,,2,1,1,2
C(C1C(C(C)(O)OC(C1O)=O)O)=O,,,5,1,1,0,1
56109_0,,,,2,1,1,2
C(C1C(COC(C)(C1O)O)O)=O,,,5,1,1,0,1
56111_0,,,,2,1,1,2
C(CC(C1(CC(CCO1)O)O)O)=O,,,5,1,1,0,1
56112_0,,,,2,1,1,2
56114_0,,,,2,1,1,2
C(CC1CC(CC(C=O)(O)O1)O)=O,,,5,1,1,0,1
56116_0,,,,2,1,1,2
C(C(CC1CC(CC(O)O1)O)=O)=O,,,5,1,1,0,1
56118_0,,,,2,1,1,2
C(C1(CC(CC(O1)O)O)CC=O)=O,,,5,1,1,0,1
56120_0,,,,2,1,1,2
C(C1(CC(O)OC(C1)CC=O)O)=O,,,5,1,1,0,1
56122_0,,,,2,1,1,2
C(C1C(CC(C=O)(O)OC1C)O)=O,,,5,1,1,0,1
56123_0,,,,2,1,1,2
56125_0,,,,2,1,1,2
C(C(C1C(C)OC(CC1O)O)=O)=O,,,5,1,1,0,1
56127_0,,,,2,1,1,2
C(C1(CC(C)OC(C1CO)O)O)=O,,,5,1,1,0,1
56129_0,,,,2,1,1,2
C(C1(C(C(C)(O)OC(C)C1)O)O)=O,,,5,1,1,0,1
56131_0,,,,2,1,1,2
C1(COC(C(CC(C)O)(C1)O)O)=O,,,5,1,1,0,1
56133_0,,,,2,1,1,2
C(C1(CC(CO)(O)OC(C)C1)O)=O,,,5,1,1,0,1
56135_0,,,,2,1,1,2
C(C1(CC(C=O)(O)OC(C)C1)O)=O,,,5,1,1,0,1
56137_0,,,,2,1,1,2
C(C1C(O)OC(C)CC1(C=O)O)=O,,,5,1,1,0,1
56139_0,,,,2,1,1,2
C(C1(CC(O)OC(C)C1)O)=O,,,5,1,1,0,1
56141_0,,,,2,1,1,2
C(C1(C(C(O)OC(C)C1)O)O)=O,,,5,1,1,0,1
56143_0,,,,2,1,1,2
C1(COC(C(C1)O)(CC(C)O)O)=O,,,5,1,1,0,1
56145_0,,,,2,1,1,2
C(C1(C(C(CCO1)O)C(C)O)O)=O,,,5,1,1,0,1
56147_0,,,,2,1,1,2
C1(C(O)OCC(C)(C1C(C)O)O)=O,,,5,1,1,0,1
56149_0,,,,2,1,1,2
C1(C(O)OC(C(C1C(C)O)O)=O)=O,,,5,1,1,0,1
56150_0,,,,2,1,1,2
56151_0,,,,2,1,1,2
56153_0,,,,2,1,1,2
C(C1(CC(O)OC(CO)C1)O)=O,,,5,1,1,0,1
56154_0,,,,2,1,1,2
56156_0,,,,2,1,1,2
C(C1(C(C(O)OC(CO)C1)O)O)=O,,,5,1,1,0,1
56157_0,,,,2,1,1,2
56159_0,,,,2,1,1,2
C(C1C(CC=O)OC(CC1O)O)=O,,,5,1,1,0,1
56161_0,,,,2,1,1,2
C(C1C(O)OC(CC1O)CC=O)=O,,,5,1,1,0,1
56163_0,,,,2,1,1,2
C(C(C=O)C1CC(CC(O)O1)O)=O,,,5,1,1,0,1
56165_0,,,,2,1,1,2
C(C1C(O)OC(C)C(C=O)C1O)=O,,,5,1,1,0,1
56166_0,,,,2,1,1,2
56168_0,,,,2,1,1,2
C(C(CO)C1CC(CC(O)O1)O)=O,,,5,1,1,0,1
56170_0,,,,2,1,1,2
C(CC1CC(C(C(O)O1)CO)O)=O,,,5,1,1,0,1
56172_0,,,,2,1,1,2
C(C)(C(C1CC(CC(O)O1)O)O)=O,,,5,1,1,0,1
56174_0,,,,2,1,1,2
C(CC1CC(C(C(C)(O)O1)O)O)=O,,,5,1,1,0,1
56176_0,,,,2,1,1,2
C(CO)(CC1CC(CC(O)O1)O)=O,,,5,1,1,0,1
56178_0,,,,2,1,1,2
C(CC1CC(CC(CO)(O)O1)O)=O,,,5,1,1,0,1
56180_0,,,,2,1,1,2
C(CC1CC(CC(O)O1)O)=O,,,5,1,1,0,1
56182_0,,,,2,1,1,2
C(C(C1CC(CC(O)O1)O)O)=O,,,5,1,1,0,1
56184_0,,,,2,1,1,2
C(CC1CC(C(C(O)O1)O)O)=O,,,5,1,1,0,1
56186_0,,,,2,1,1,2
C(CC(C1C(O)OCCC1O)O)=O,,,5,1,1,0,1
56188_0,,,,2,1,1,2
C(C1C(CCO)OC(CC1O)O)=O,,,5,1,1,0,1
56190_0,,,,2,1,1,2
C(C1C(CC(O)OC1(C)CO)O)=O,,,5,1,1,0,1
56191_0,,,,2,1,1,2
56193_0,,,,2,1,1,2
C(C1C(C)OC(CC1O)O)=O,,,5,1,1,0,1
56194_0,,,,2,1,1,2
56195_0,,,,2,1,1,2
56196_0,,,,2,1,1,2
56197_0,,,,2,1,1,2
56198_0,,,,2,1,1,2
56200_0,,,,2,1,1,2
C(C(C1CC(C(C(O)O1)O)O)O)=O,,,5,1,1,0,1
56202_0,,,,2,1,1,2
C(C1C(C)OC(C(C1O)O)O)=O,,,5,1,1,0,1
56203_0,,,,2,1,1,2
56205_0,,,,2,1,1,2
C(C1C(CO)OC(C(C1O)O)O)=O,,,5,1,1,0,1
56207_0,,,,2,1,1,2
C(C1COC(C(C1O)C(C)O)O)=O,,,5,1,1,0,1
56209_0,,,,2,1,1,2
C(C1C(C)OC(C(CO)C1O)O)=O,,,5,1,1,0,1
56211_0,,,,2,1,1,2
C(C1C(C)OC(C)(C(C1O)O)O)=O,,,5,1,1,0,1
56213_0,,,,2,1,1,2
C(C1C(C)OC(CO)(CC1O)O)=O,,,5,1,1,0,1
56215_0,,,,2,1,1,2
C(C1COC(C(CO)C1O)O)=O,,,5,1,1,0,1
56217_0,,,,2,1,1,2
C(C1COC(C=O)(C(C1O)O)O)=O,,,5,1,1,0,1
56219_0,,,,2,1,1,2
C(C1COC(C)(C(C1O)O)O)=O,,,5,1,1,0,1
56221_0,,,,2,1,1,2
C(C1COC(CO)(CC1O)O)=O,,,5,1,1,0,1
56223_0,,,,2,1,1,2
C(C1COC(C(O)=O)(CC1O)O)=O,,,5,1,1,0,1
56225_0,,,,2,1,1,2
C1(C(C=O)C(C(CO)C(O)O1)O)=O,,,5,1,1,0,1
56227_0,,,,2,1,1,2
C(C1C(O)OCC(C=O)C1O)(O)=O,,,5,1,1,0,1
56229_0,,,,2,1,1,2
C(C1(CCO)CC(CC(O1)O)O)=O,,,5,1,1,0,1
56230_0,,,,2,1,1,2
56232_0,,,,2,1,1,2
C(C1(CCOC(C1C(C)O)O)O)=O,,,5,1,1,0,1
56233_0,,,,2,1,1,2
56235_0,,,,2,1,1,2
C(C1CC(CC(O1)O)O)(CCO)=O,,,5,1,1,0,1
56237_0,,,,2,1,1,2
C(C1(CC(O)OC(C)C1CO)O)=O,,,5,1,1,0,1
56239_0,,,,2,1,1,2
C(C1(CC(O)OCC1C(C)O)O)=O,,,5,1,1,0,1
56241_0,,,,2,1,1,2
C(C1(CC(O)OCC1CO)O)=O,,,5,1,1,0,1
56243_0,,,,2,1,1,2
C(C1(C(C(O)OCC1CO)O)O)=O,,,5,1,1,0,1
56244_0,,,,2,1,1,2
56246_0,,,,2,1,1,2
C(C(CC1CC(CC(O)O1)O)O)=O,,,5,1,1,0,1
56248_0,,,,2,1,1,2
C(C1CC(C(C(O1)O)C(C)O)O)=O,,,5,1,1,0,1
56249_0,,,,2,1,1,2
56251_0,,,,2,1,1,2
C(C1C(C(CC(O1)O)O)C(C)O)=O,,,5,1,1,0,1
56253_0,,,,2,1,1,2
C(C(C1C(CC(O)OC1C)O)O)=O,,,5,1,1,0,1
56254_0,,,,2,1,1,2
56256_0,,,,2,1,1,2
C(C(C1COC(CC1O)O)O)=O,,,5,1,1,0,1
56258_0,,,,2,1,1,2
C(C1C(C(CO)C(C(O1)O)O)O)=O,,,5,1,1,0,1
56260_0,,,,2,1,1,2
C(C1C(CO)C(C(C(O1)O)O)O)=O,,,5,1,1,0,1
56262_0,,,,2,1,1,2
C(C(C1COC(C(C1O)O)O)O)=O,,,5,1,1,0,1
56264_0,,,,2,1,1,2
C(CC1(CO)CC(CC(O)O1)O)=O,,,5,1,1,0,1
56266_0,,,,2,1,1,2
C(CC1CC(CO)(CC(O)O1)O)=O,,,5,1,1,0,1
56268_0,,,,2,1,1,2
C(CO)(C1C(C)OC(CC1O)O)=O,,,5,1,1,0,1
56269_0,,,,2,1,1,2
56271_0,,,,2,1,1,2
C(CO)(C1COC(C(C1O)O)O)=O,,,5,1,1,0,1
56273_0,,,,2,1,1,2
C(C1C(C)OC(CC1(CO)O)O)=O,,,5,1,1,0,1
56275_0,,,,2,1,1,2
C(C1COC(CC1(CO)O)O)=O,,,5,1,1,0,1
56277_0,,,,2,1,1,2
C(C1COC(C(C1(CO)O)O)O)=O,,,5,1,1,0,1
56278_0,,,,2,1,1,2
56279_0,,,,2,1,1,2
56280_0,,,,2,1,1,2
56281_0,,,,2,1,1,2
56282_0,,,,2,1,1,2
56283_0,,,,2,1,1,2
56284_0,,,,2,1,1,2
56286_0,,,,2,1,1,2
C(CC1(C(C(O)OCC1O)O)O)=O,,,5,1,1,0,1
56287_0,,,,2,1,1,2
56289_0,,,,2,1,1,2
C(CC1(C)C(C(CC(O)O1)O)O)=O,,,5,1,1,0,1
56291_0,,,,2,1,1,2
C(CC1C(C(C)(CC(O)O1)O)O)=O,,,5,1,1,0,1
56293_0,,,,2,1,1,2
C(CC1CC(C)(C(C(O)O1)O)O)=O,,,5,1,1,0,1
56295_0,,,,2,1,1,2
C(C(C1(C)CC(CC(O)O1)O)O)=O,,,5,1,1,0,1
56297_0,,,,2,1,1,2
C(C1C(C)OC(C(C1(C)O)O)O)=O,,,5,1,1,0,1
56299_0,,,,2,1,1,2
C(C1COC(C(C1(C)O)O)O)=O,,,5,1,1,0,1
56301_0,,,,2,1,1,2
C(C(C1(CC(C)OC(C1)O)O)O)=O,,,5,1,1,0,1
56302_0,,,,2,1,1,2
56303_0,,,,2,1,1,2
56304_0,,,,2,1,1,2
56305_0,,,,2,1,1,2
56307_0,,,,2,1,1,2
C(C(C1(CC(O)OCC1)O)O)=O,,,5,1,1,0,1
56308_0,,,,2,1,1,2
56309_0,,,,2,1,1,2
56310_0,,,,2,1,1,2
56311_0,,,,2,1,1,2
56312_0,,,,2,1,1,2
56314_0,,,,2,1,1,2
CC(C1C(O)OC(C)CC1O)O,,,5,1,1,0,1
56316_0,,,,2,1,1,2
CC1CC(C(C(O)O1)CO)O,,,5,1,1,0,1
56318_0,,,,2,1,1,2
CC1CC(C(C(O)O1)C(CO)O)O,,,5,1,1,0,1
56320_0,,,,2,1,1,2
C(C1(C(C(CC(C)O1)O)O)O)=O,,,5,1,1,0,1
56322_0,,,,2,1,1,2
C(C)(C1(C(C(CC(C)O1)O)O)O)=O,,,5,1,1,0,1
56324_0,,,,2,1,1,2
C(CO)(C1(CC(CC(C)O1)O)O)=O,,,5,1,1,0,1
56326_0,,,,2,1,1,2
CC1(C(C(CC(C)O1)O)O)O,,,5,1,1,0,1
56328_0,,,,2,1,1,2
CC1CC(CC(CO)(O)O1)O,,,5,1,1,0,1
56330_0,,,,2,1,1,2
CC1CC(C(C(CCO)(O)O1)O)O,,,5,1,1,0,1
56332_0,,,,2,1,1,2
CC1CC(C(CO)C(CO)(O)O1)O,,,5,1,1,0,1
56334_0,,,,2,1,1,2
CC1CC(CC(C(CO)O)(O)O1)O,,,5,1,1,0,1
56336_0,,,,2,1,1,2
C(C1(CC(CC(C)O1)O)O)(O)=O,,,5,1,1,0,1
56338_0,,,,2,1,1,2
C(C1C(O)OC(C)CC1O)(O)=O,,,5,1,1,0,1
56340_0,,,,2,1,1,2
C1C(C2(C(C(CC(C)O2)O)O1)O)O,,,5,1,1,0,1
56342_0,,,,2,1,1,2
CC1CC(C2COC(C2(O)O1)O)O,,,5,1,1,0,1
56344_0,,,,2,1,1,2
C1C2(C(C(O)O1)C(CC(C)O2)O)O,,,5,1,1,0,1
56346_0,,,,2,1,1,2
CC1CC(C2C(CC(O)O2)(O)O1)O,,,5,1,1,0,1
56348_0,,,,2,1,1,2
CC1CC(C(C(CO)(O)O1)O)O,,,5,1,1,0,1
56350_0,,,,2,1,1,2
C(C1(CC(CC(C)O1)O)O)=O,,,5,1,1,0,1
56352_0,,,,2,1,1,2
C(C1C(O)OC(C)CC1O)=O,,,5,1,1,0,1
56354_0,,,,2,1,1,2
C(C1(C(CO)C(CC(C)O1)O)O)=O,,,5,1,1,0,1
56356_0,,,,2,1,1,2
C(C(C1C(O)OC(C)CC1O)O)=O,,,5,1,1,0,1
56358_0,,,,2,1,1,2
C(CO)(C1C(O)OC(C)CC1O)=O,,,5,1,1,0,1
56360_0,,,,2,1,1,2
C(C1C(CO)(O)OC(C)CC1O)=O,,,5,1,1,0,1
56362_0,,,,2,1,1,2
C1(C(C(CC(C)O)OC(C1)O)O)=O,,,5,1,1,0,1
56364_0,,,,2,1,1,2
C(CC1(C(C(CC(C)O1)O)O)O)=O,,,5,1,1,0,1
56366_0,,,,2,1,1,2
C1(C(C(O)OC(CC(C)O)C1)O)=O,,,5,1,1,0,1
56368_0,,,,2,1,1,2
C(C(C1(CC(CC(C)O1)O)O)O)=O,,,5,1,1,0,1
56370_0,,,,2,1,1,2
CC1CC(CC(O)O1)O,,,5,1,1,0,1
56372_0,,,,2,1,1,2
CC1CC(C(C(O)O1)O)O,,,5,1,1,0,1
56374_0,,,,2,1,1,2
CC(C1C(O)OC(C)C(C1O)O)O,,,5,1,1,0,1
56376_0,,,,2,1,1,2
CC(C1C(O)OCCC1O)O,,,5,1,1,0,1
56378_0,,,,2,1,1,2
CC(C1C(O)OC(CO)CC1O)O,,,5,1,1,0,1
56380_0,,,,2,1,1,2
C1(COC(C(C(C)O)C1O)O)=O,,,5,1,1,0,1
56382_0,,,,2,1,1,2
C1(COC(C(C(C)O)C1(C)O)O)=O,,,5,1,1,0,1
56384_0,,,,2,1,1,2
C1(C(C)OC(C(C(C)O)C1O)O)=O,,,5,1,1,0,1
56386_0,,,,2,1,1,2
CC(C1C(O)OCCC1(CO)O)O,,,5,1,1,0,1
56388_0,,,,2,1,1,2
CC1(C(COC(C1C(C)O)O)O)O,,,5,1,1,0,1
56390_0,,,,2,1,1,2
C1(CC(C(C(O)O1)C(C)O)O)=O,,,5,1,1,0,1
56392_0,,,,2,1,1,2
C1C2(CC(O1)OC(C2C(C)O)O)O,,,5,1,1,0,1
56394_0,,,,2,1,1,2
C1C(C(C(C(O)O1)C(C)O)O)O,,,5,1,1,0,1
56396_0,,,,2,1,1,2
CC1C(C(C(C(O)O1)CO)O)O,,,5,1,1,0,1
56398_0,,,,2,1,1,2
C1(C(O)OC(C(C1O)O)C(C)O)=O,,,5,1,1,0,1
56400_0,,,,2,1,1,2
C(C1(C(C(C(C(C)O1)O)O)O)O)=O,,,5,1,1,0,1
56402_0,,,,2,1,1,2
CC1(C(C(C(C(C)O1)O)O)O)O,,,5,1,1,0,1
56404_0,,,,2,1,1,2
CC1C(C(CC(CO)(O)O1)O)O,,,5,1,1,0,1
56406_0,,,,2,1,1,2
C(C1(CC(C(C(C)O1)O)O)O)(O)=O,,,5,1,1,0,1
56408_0,,,,2,1,1,2
C(C1C(O)OC(C)C(C1O)O)(O)=O,,,5,1,1,0,1
56410_0,,,,2,1,1,2
CC1C(C(C(C(CO)(O)O1)O)O)O,,,5,1,1,0,1
56412_0,,,,2,1,1,2
C1(C(O)OC(C(C1)O)C(C)O)=O,,,5,1,1,0,1
56414_0,,,,2,1,1,2
C(C1(CC(C(C(C)O1)O)O)O)=O,,,5,1,1,0,1
56416_0,,,,2,1,1,2
C(C1C(O)OC(C)C(C1O)O)=O,,,5,1,1,0,1
56418_0,,,,2,1,1,2
CC1C(C(CC(O)O1)O)O,,,5,1,1,0,1
56419_0,,,,2,1,1,2
56421_0,,,,2,1,1,2
C(C(C1CC(CC(O)O1)O)O)O,,,5,1,1,0,1
56423_0,,,,2,1,1,2
C(C(C1CC(C(C(O)O1)O)O)O)O,,,5,1,1,0,1
56424_0,,,,2,1,1,2
56425_0,,,,2,1,1,2
56426_0,,,,2,1,1,2
56428_0,,,,2,1,1,2
C1CC(C(C(O)O1)CO)O,,,5,1,1,0,1
56430_0,,,,2,1,1,2
C1CC(C(C(O)O1)C(CO)O)O,,,5,1,1,0,1
56432_0,,,,2,1,1,2
C(C1(C(C(CCO1)O)O)O)=O,,,5,1,1,0,1
56434_0,,,,2,1,1,2
C(C)(C1(C(C(CCO1)O)O)O)=O,,,5,1,1,0,1
56436_0,,,,2,1,1,2
C(CO)(C1(CC(CCO1)O)O)=O,,,5,1,1,0,1
56438_0,,,,2,1,1,2
CC1(C(C(CCO1)O)O)O,,,5,1,1,0,1
56440_0,,,,2,1,1,2
C1CC(CC(CO)(O)O1)O,,,5,1,1,0,1
56442_0,,,,2,1,1,2
C1CC(C(C(CCO)(O)O1)O)O,,,5,1,1,0,1
56444_0,,,,2,1,1,2
C1CC(C(CO)C(CO)(O)O1)O,,,5,1,1,0,1
56446_0,,,,2,1,1,2
C1CC(CC(C(CO)O)(O)O1)O,,,5,1,1,0,1
56448_0,,,,2,1,1,2
C(C1(CC(CCO1)O)O)(O)=O,,,5,1,1,0,1
56450_0,,,,2,1,1,2
C(C1C(O)OCCC1O)(O)=O,,,5,1,1,0,1
56452_0,,,,2,1,1,2
C(C1(C(CO)C(CCO1)O)O)(O)=O,,,5,1,1,0,1
56454_0,,,,2,1,1,2
C(C(C1C(O)OCCC1O)O)(O)=O,,,5,1,1,0,1
56456_0,,,,2,1,1,2
C(C1C(CO)(O)OCCC1O)(O)=O,,,5,1,1,0,1
56458_0,,,,2,1,1,2
C(CC1(C(C(CCO1)O)O)O)(O)=O,,,5,1,1,0,1
56460_0,,,,2,1,1,2
C(C(C1(CC(CCO1)O)O)O)(O)=O,,,5,1,1,0,1
56462_0,,,,2,1,1,2
C1C(C2(C(C(CCO2)O)O1)O)O,,,5,1,1,0,1
56464_0,,,,2,1,1,2
C1C2C(C(O)O1)(O)OCCC2O,,,5,1,1,0,1
56466_0,,,,2,1,1,2
C1C2(C(C(O)O1)C(CCO2)O)O,,,5,1,1,0,1
56468_0,,,,2,1,1,2
C1CC(C2C(CC(O)O2)(O)O1)O,,,5,1,1,0,1
56470_0,,,,2,1,1,2
C1CC(C(C(CO)(O)O1)O)O,,,5,1,1,0,1
56472_0,,,,2,1,1,2
C1CC(C(C(C(CO)O)(O)O1)O)O,,,5,1,1,0,1
56474_0,,,,2,1,1,2
C(C1(CC(CCO1)O)O)=O,,,5,1,1,0,1
56476_0,,,,2,1,1,2
C(C1C(O)OCCC1O)=O,,,5,1,1,0,1
56478_0,,,,2,1,1,2
C(C1(C(CO)C(CCO1)O)O)=O,,,5,1,1,0,1
56480_0,,,,2,1,1,2
C(C(C1C(O)OCCC1O)O)=O,,,5,1,1,0,1
56482_0,,,,2,1,1,2
C(CO)(C1C(O)OCCC1O)=O,,,5,1,1,0,1
56484_0,,,,2,1,1,2
C(C1C(CO)(O)OCCC1O)=O,,,5,1,1,0,1
56485_0,,,,2,1,1,2
56487_0,,,,2,1,1,2
C(CC1(C(C(CCO1)O)O)O)=O,,,5,1,1,0,1
56488_0,,,,2,1,1,2
56490_0,,,,2,1,1,2
C(C(C1(CC(CCO1)O)O)O)=O,,,5,1,1,0,1
56492_0,,,,2,1,1,2
C1CC(CC(O)O1)O,,,5,1,1,0,1
56494_0,,,,2,1,1,2
C1CC(C(C(O)O1)O)O,,,5,1,1,0,1
56496_0,,,,2,1,1,2
C1(C(CO)C(CC(CO)O1)O)O,,,5,1,1,0,1
56497_0,,,,2,1,1,2
56499_0,,,,2,1,1,2
C(C1(C(COC(C1CO)O)O)O)=O,,,5,1,1,0,1
56501_0,,,,2,1,1,2
C1(C(CO)OC(C(CO)C1O)O)=O,,,5,1,1,0,1
56503_0,,,,2,1,1,2
C1(COC(C(CO)C1(C)O)O)=O,,,5,1,1,0,1
56505_0,,,,2,1,1,2
C1(C(C)OC(C(CO)C1O)O)=O,,,5,1,1,0,1
56507_0,,,,2,1,1,2
C1CC(CO)(C(C(O)O1)CO)O,,,5,1,1,0,1
56509_0,,,,2,1,1,2
CC1(C(COC(C1CO)O)O)O,,,5,1,1,0,1
56511_0,,,,2,1,1,2
C1(CC(C(CO)C(O)O1)O)=O,,,5,1,1,0,1
56513_0,,,,2,1,1,2
C(C1(CCOC(C1CO)O)O)(O)=O,,,5,1,1,0,1
56515_0,,,,2,1,1,2
C(C1CC(C(CO)C(O1)O)O)(O)=O,,,5,1,1,0,1
56517_0,,,,2,1,1,2
C1(CC(CO)(C(CO)C(O)O1)O)=O,,,5,1,1,0,1
56519_0,,,,2,1,1,2
C1(C(C(C)(C(CO)C(O)O1)O)O)=O,,,5,1,1,0,1
56521_0,,,,2,1,1,2
C1C2(CC(O1)OC(C2CO)O)O,,,5,1,1,0,1
56523_0,,,,2,1,1,2
C(C1(C(C(CC(CO)O1)O)O)O)=O,,,5,1,1,0,1
56525_0,,,,2,1,1,2
CC1(C(C(CC(CO)O1)O)O)O,,,5,1,1,0,1
56527_0,,,,2,1,1,2
C(C1(CC(CC(CO)O1)O)O)O,,,5,1,1,0,1
56529_0,,,,2,1,1,2
C(C1(CC(CC(CO)O1)O)O)(O)=O,,,5,1,1,0,1
56531_0,,,,2,1,1,2
C(C1C(O)OC(CO)CC1O)(O)=O,,,5,1,1,0,1
56532_0,,,,2,1,1,2
56533_0,,,,2,1,1,2
56534_0,,,,2,1,1,2
56535_0,,,,2,1,1,2
56536_0,,,,2,1,1,2
56538_0,,,,2,1,1,2
C(C1C(COC(C1(CO)O)O)O)=O,,,5,1,1,0,1
56540_0,,,,2,1,1,2
C1(COC(C(C(CO)O)C1O)O)=O,,,5,1,1,0,1
56542_0,,,,2,1,1,2
C(C1C(COC(CO)(C1O)O)O)=O,,,5,1,1,0,1
56544_0,,,,2,1,1,2
C1(CC(C(C(O)O1)C(CO)O)O)=O,,,5,1,1,0,1
56546_0,,,,2,1,1,2
C(C1C(COC(C1(C=C)O)O)O)=O,,,5,1,1,0,1
56548_0,,,,2,1,1,2
C(C1C(C(C=C)(O)OCC1O)O)=O,,,5,1,1,0,1
56550_0,,,,2,1,1,2
C(C1(COC(C(C1O)=O)O)O)=O,,,5,1,1,0,1
56552_0,,,,2,1,1,2
C(C1(COC(C(C1O)=O)(C)O)O)=O,,,5,1,1,0,1
56554_0,,,,2,1,1,2
C(C1(COC(C(C1)=O)(CO)O)O)=O,,,5,1,1,0,1
56555_0,,,,2,1,1,2
56556_0,,,,2,1,1,2
56558_0,,,,2,1,1,2
C1(C(CC(CO)(C(O)O1)O)=O)=O,,,5,1,1,0,1
56560_0,,,,2,1,1,2
C1(C2C(CO)(C(OC1CO2)O)O)=O,,,5,1,1,0,1
56562_0,,,,2,1,1,2
C1(C2OC(C(CO)(C1CO2)O)O)=O,,,5,1,1,0,1
56564_0,,,,2,1,1,2
C1(COC(C(CO)(C1O)O)O)=O,,,5,1,1,0,1
56566_0,,,,2,1,1,2
C(C1(COC(C(C1)=O)O)O)=O,,,5,1,1,0,1
56568_0,,,,2,1,1,2
C(C1(COC(C(C1CO)=O)O)O)=O,,,5,1,1,0,1
56570_0,,,,2,1,1,2
C(C1C(C(O)OCC1(C=O)O)O)=O,,,5,1,1,0,1
56572_0,,,,2,1,1,2
C(C1C(COC(C1(CO)O)O)=O)=O,,,5,1,1,0,1
56573_0,,,,2,1,1,2
56575_0,,,,2,1,1,2
C(C1C(CC(CO)(C(O1)O)O)=O)=O,,,5,1,1,0,1
56576_0,,,,2,1,1,2
56578_0,,,,2,1,1,2
C(C1(C(C(C(CO1)=O)O)O)O)=O,,,5,1,1,0,1
56580_0,,,,2,1,1,2
C(C)(C1(C(C(C(CO1)=O)O)O)O)=O,,,5,1,1,0,1
56582_0,,,,2,1,1,2
C1(COC(C(CO)=O)(CC1O)O)=O,,,5,1,1,0,1
56583_0,,,,2,1,1,2
56585_0,,,,2,1,1,2
C1(COC(CO)(CC1O)O)=O,,,5,1,1,0,1
56587_0,,,,2,1,1,2
C1(COC(CO)(C(C1CO)O)O)=O,,,5,1,1,0,1
56589_0,,,,2,1,1,2
C1(COC(CO)(C(CO)C1O)O)=O,,,5,1,1,0,1
56591_0,,,,2,1,1,2
C1(C(CO)OC(C(C1)O)(CO)O)=O,,,5,1,1,0,1
56593_0,,,,2,1,1,2
C1(COC(CC1O)(C(CO)O)O)=O,,,5,1,1,0,1
56595_0,,,,2,1,1,2
C1(C(CC(C(CO)(O)O1)O)=O)=O,,,5,1,1,0,1
56597_0,,,,2,1,1,2
C(C1(CC(C(CO1)=O)O)O)(O)=O,,,5,1,1,0,1
56599_0,,,,2,1,1,2
C(C1C(OCC(C1O)=O)O)(O)=O,,,5,1,1,0,1
56601_0,,,,2,1,1,2
C1(C2C(C(CO)(OC1CO2)O)O)=O,,,5,1,1,0,1
56603_0,,,,2,1,1,2
C1(COC2(C(C1O)OCC2O)O)=O,,,5,1,1,0,1
56605_0,,,,2,1,1,2
C1(C2OC(CO)(C(C1CO2)O)O)=O,,,5,1,1,0,1
56607_0,,,,2,1,1,2
C1(COC2(C(O)OCC2C1O)O)=O,,,5,1,1,0,1
56609_0,,,,2,1,1,2
C1(COC2(COC(C2C1O)O)O)=O,,,5,1,1,0,1
56611_0,,,,2,1,1,2
C1(COC2(C(C1O)OC(C2)O)O)=O,,,5,1,1,0,1
56613_0,,,,2,1,1,2
C1(COC(CO)(C(C1O)O)O)=O,,,5,1,1,0,1
56615_0,,,,2,1,1,2
C(C1(CC(C(CO1)=O)O)O)=O,,,5,1,1,0,1
56617_0,,,,2,1,1,2
C(C1C(OCC(C1O)=O)O)=O,,,5,1,1,0,1
56619_0,,,,2,1,1,2
C(C1(C(CO)C(C(CO1)=O)O)O)=O,,,5,1,1,0,1
56621_0,,,,2,1,1,2
C(C(C1C(OCC(C1O)=O)O)O)=O,,,5,1,1,0,1
56623_0,,,,2,1,1,2
C(C1C(COC(CO)(C1O)O)=O)=O,,,5,1,1,0,1
56625_0,,,,2,1,1,2
C(CO)(C1C(OCC(C1O)=O)O)=O,,,5,1,1,0,1
56627_0,,,,2,1,1,2
C(C1C(CO)(OCC(C1O)=O)O)=O,,,5,1,1,0,1
56629_0,,,,2,1,1,2
C1(C(C(C(CO)=O)OC(C1)O)O)=O,,,5,1,1,0,1
56631_0,,,,2,1,1,2
C(CC1(C(C(C(CO1)=O)O)O)O)=O,,,5,1,1,0,1
56633_0,,,,2,1,1,2
C(C1C(CC(C(CO)(O1)O)O)=O)=O,,,5,1,1,0,1
56635_0,,,,2,1,1,2
C1(CC(C(CO)=O)OC(C1O)O)=O,,,5,1,1,0,1
56637_0,,,,2,1,1,2
C(C(C1(CC(C(CO1)=O)O)O)O)=O,,,5,1,1,0,1
56638_0,,,,2,1,1,2
56640_0,,,,2,1,1,2
C(C)(C1(COC(C(C1O)=O)O)O)=O,,,5,1,1,0,1
56642_0,,,,2,1,1,2
C(C1(C(C(C(CO1)=O)(C)O)O)O)=O,,,5,1,1,0,1
56644_0,,,,2,1,1,2
C(C1(C(C)OC(C(C1O)=O)O)O)=O,,,5,1,1,0,1
56646_0,,,,2,1,1,2
C1(C(C(C(C=O)(OC1C)O)O)O)=O,,,5,1,1,0,1
56648_0,,,,2,1,1,2
C1(C(O)OCC(C)(C1O)O)=O,,,5,1,1,0,1
56650_0,,,,2,1,1,2
C1(C(O)OCC(CCO)(C1O)O)=O,,,5,1,1,0,1
56652_0,,,,2,1,1,2
C(C1(C(C(CO)(CCO1)O)O)O)=O,,,5,1,1,0,1
56654_0,,,,2,1,1,2
C1(C(O)OC(C(C1O)O)CCO)=O,,,5,1,1,0,1
56656_0,,,,2,1,1,2
C(C1(C(C(C)(C(CO1)O)O)O)O)=O,,,5,1,1,0,1
56658_0,,,,2,1,1,2
C1(C(O)OC(CO)C(C)(C1O)O)=O,,,5,1,1,0,1
56660_0,,,,2,1,1,2
C1(C(C(C(C(O)O1)=O)O)O)=O,,,5,1,1,0,1
56662_0,,,,2,1,1,2
C1(C(C)(C(C(C(O)O1)=O)O)O)=O,,,5,1,1,0,1
56664_0,,,,2,1,1,2
C1(CC(C(C(C=O)(O)O1)O)O)=O,,,5,1,1,0,1
56666_0,,,,2,1,1,2
C1(C(O)OC2COCC2(C1O)O)=O,,,5,1,1,0,1
56668_0,,,,2,1,1,2
C1(C(O)OC2C(CCO2)(C1O)O)=O,,,5,1,1,0,1
56670_0,,,,2,1,1,2
C(C1(C(C2(COC(C2)O1)O)O)O)=O,,,5,1,1,0,1
56672_0,,,,2,1,1,2
C1(C(O)OCC(CO)(C1O)O)=O,,,5,1,1,0,1
56674_0,,,,2,1,1,2
C(C1(C(C(C=O)(O)OCC1)O)O)=O,,,5,1,1,0,1
56676_0,,,,2,1,1,2
C(CC1C(C(C(C(O)O1)=O)O)O)=O,,,5,1,1,0,1
56678_0,,,,2,1,1,2
C(C(C1C(C(CC(O1)O)O)O)=O)=O,,,5,1,1,0,1
56680_0,,,,2,1,1,2
C(C1CC(C(C(C=O)(O1)O)O)O)=O,,,5,1,1,0,1
56682_0,,,,2,1,1,2
C(C(C1C(CC(C(O1)O)O)O)=O)=O,,,5,1,1,0,1
56684_0,,,,2,1,1,2
C(CC1(COC(C(C1O)=O)O)O)=O,,,5,1,1,0,1
56686_0,,,,2,1,1,2
C(C)(C1C(C(C(C(O1)O)=O)O)O)=O,,,5,1,1,0,1
56688_0,,,,2,1,1,2
C(C1C(C)(C(C(C(O1)O)=O)O)O)=O,,,5,1,1,0,1
56690_0,,,,2,1,1,2
C1(COC(C(C(CO)O)(C1)O)O)=O,,,5,1,1,0,1
56692_0,,,,2,1,1,2
C(C1(C(COC(CO)(C1)O)O)O)=O,,,5,1,1,0,1
56694_0,,,,2,1,1,2
C(C1(C(CO)OC(C(C1)=O)O)O)=O,,,5,1,1,0,1
56696_0,,,,2,1,1,2
C(C1(CC(C=O)(O)OCC1O)O)=O,,,5,1,1,0,1
56698_0,,,,2,1,1,2
C(C1C(O)OCC(C1(C=O)O)O)=O,,,5,1,1,0,1
56700_0,,,,2,1,1,2
C1(COC(C(C1)O)(C(CO)O)O)=O,,,5,1,1,0,1
56702_0,,,,2,1,1,2
C1(C(CO)OC(CC1O)(CO)O)=O,,,5,1,1,0,1
56704_0,,,,2,1,1,2
C1(C(CC(C=O)(OC1CO)O)O)=O,,,5,1,1,0,1
56706_0,,,,2,1,1,2
C(C1C(OC(C(C1O)=O)CO)O)=O,,,5,1,1,0,1
56707_0,,,,2,1,1,2
56708_0,,,,2,1,1,2
56710_0,,,,2,1,1,2
C1(COC(C)(C(CO)(C1)O)O)=O,,,5,1,1,0,1
56712_0,,,,2,1,1,2
C1(C(CC(CO)(C(C)(O)O1)O)=O)=O,,,5,1,1,0,1
56714_0,,,,2,1,1,2
C1(COC(C)(C(CO)(C1O)O)O)=O,,,5,1,1,0,1
56715_0,,,,2,1,1,2
56717_0,,,,2,1,1,2
C1(COC(C)(C(C1(C)O)O)O)=O,,,5,1,1,0,1
56719_0,,,,2,1,1,2
C1(COC(CO)(C(C)(C1)O)O)=O,,,5,1,1,0,1
56721_0,,,,2,1,1,2
C1(COC(CO)(CC1(C)O)O)=O,,,5,1,1,0,1
56723_0,,,,2,1,1,2
C1(C(CC(C)(C(CO)(O)O1)O)=O)=O,,,5,1,1,0,1
56725_0,,,,2,1,1,2
C(C1(CC(C(CO1)=O)(C)O)O)(O)=O,,,5,1,1,0,1
56727_0,,,,2,1,1,2
C(C1C(OCC(C1(C)O)=O)O)(O)=O,,,5,1,1,0,1
56729_0,,,,2,1,1,2
C1(COC(CO)(C(C)(C1O)O)O)=O,,,5,1,1,0,1
56731_0,,,,2,1,1,2
C1(COC(CO)(C(C1(C)O)O)O)=O,,,5,1,1,0,1
56733_0,,,,2,1,1,2
C(C1(CC(C(CO1)=O)(C)O)O)=O,,,5,1,1,0,1
56735_0,,,,2,1,1,2
C(C1C(OCC(C1(C)O)=O)O)=O,,,5,1,1,0,1
56737_0,,,,2,1,1,2
C1(COC(CC1(C)O)O)=O,,,5,1,1,0,1
56739_0,,,,2,1,1,2
C1(COC(C(C1(C)O)O)O)=O,,,5,1,1,0,1
56741_0,,,,2,1,1,2
C1(C(C)(O)OCC(C)(C1O)O)=O,,,5,1,1,0,1
56743_0,,,,2,1,1,2
C1(C(C(C(OC1(C)O)=O)O)O)=O,,,5,1,1,0,1
56745_0,,,,2,1,1,2
C1(C(C)(C(C(C(C)(O)O1)=O)O)O)=O,,,5,1,1,0,1
56747_0,,,,2,1,1,2
C1(CC(C(C(C(C)=O)(O)O1)O)O)=O,,,5,1,1,0,1
56749_0,,,,2,1,1,2
C1(C(C)(O)OC(C(C1O)O)CO)=O,,,5,1,1,0,1
56751_0,,,,2,1,1,2
C(C)(C1(C(C(C(CO1)O)O)O)O)=O,,,5,1,1,0,1
56753_0,,,,2,1,1,2
C1(C(C)(O)OCC(CO)(C1O)O)=O,,,5,1,1,0,1
56755_0,,,,2,1,1,2
C1(C(C)(O)OCC(C1O)O)=O,,,5,1,1,0,1
56757_0,,,,2,1,1,2
C1(C(CO)(O)OCC(C)(C1)O)=O,,,5,1,1,0,1
56759_0,,,,2,1,1,2
C1(CC(C(OC1(CO)O)=O)O)=O,,,5,1,1,0,1
56761_0,,,,2,1,1,2
C1(C(C)(CC(C(CO)(O)O1)=O)O)=O,,,5,1,1,0,1
56763_0,,,,2,1,1,2
C1(CC(CC(C(CO)=O)(O)O1)O)=O,,,5,1,1,0,1
56764_0,,,,2,1,1,2
56765_0,,,,2,1,1,2
56766_0,,,,2,1,1,2
56767_0,,,,2,1,1,2
56768_0,,,,2,1,1,2
56770_0,,,,2,1,1,2
C1(C(CC(C(O)O1)(C(C)O)O)=O)=O,,,5,1,1,0,1
56772_0,,,,2,1,1,2
C1(COC(C(C(C)O)(C1O)O)O)=O,,,5,1,1,0,1
56774_0,,,,2,1,1,2
C(C1(C(C)OC(C(C1)=O)O)O)=O,,,5,1,1,0,1
56776_0,,,,2,1,1,2
C1(C(C)OC(C(C1O)O)(C)O)=O,,,5,1,1,0,1
56778_0,,,,2,1,1,2
C1(COC(C(C1)O)(C(C)O)O)=O,,,5,1,1,0,1
56780_0,,,,2,1,1,2
C1(C(C)OC(CC1O)(CO)O)=O,,,5,1,1,0,1
56782_0,,,,2,1,1,2
C1(C(CC(C(C(C)O)(O)O1)O)=O)=O,,,5,1,1,0,1
56784_0,,,,2,1,1,2
C1(C(CC(C(O)=O)(OC1C)O)O)=O,,,5,1,1,0,1
56786_0,,,,2,1,1,2
C(C1C(OC(C(C1O)=O)C)O)(O)=O,,,5,1,1,0,1
56788_0,,,,2,1,1,2
C1(COC(C(C1O)O)(C(C)O)O)=O,,,5,1,1,0,1
56790_0,,,,2,1,1,2
C1(C(C)OC(C(C1O)O)(CO)O)=O,,,5,1,1,0,1
56792_0,,,,2,1,1,2
C1(C(CC(C=O)(OC1C)O)O)=O,,,5,1,1,0,1
56794_0,,,,2,1,1,2
C(C1C(OC(C(C1O)=O)C)O)=O,,,5,1,1,0,1
56795_0,,,,2,1,1,2
56797_0,,,,2,1,1,2
C1(C(C)OC(C(C1O)O)O)=O,,,5,1,1,0,1
56799_0,,,,2,1,1,2
C1(C(O)OCC(C)(C1)O)=O,,,5,1,1,0,1
56801_0,,,,2,1,1,2
C1(C(O)OCC(C)(C1CO)O)=O,,,5,1,1,0,1
56803_0,,,,2,1,1,2
C(C1C(C(O)OCC1(C)O)O)=O,,,5,1,1,0,1
56804_0,,,,2,1,1,2
56805_0,,,,2,1,1,2
56807_0,,,,2,1,1,2
CC1(C(C(CO)(CCO1)O)O)O,,,5,1,1,0,1
56809_0,,,,2,1,1,2
CC1(C(COC(C)(C1O)O)O)O,,,5,1,1,0,1
56811_0,,,,2,1,1,2
C1(CC(C(C(C)(O)O1)O)O)=O,,,5,1,1,0,1
56813_0,,,,2,1,1,2
C(C1(CCOC(C)(C1O)O)O)(O)=O,,,5,1,1,0,1
56815_0,,,,2,1,1,2
C(C1CC(C(C(C)(O1)O)O)O)(O)=O,,,5,1,1,0,1
56817_0,,,,2,1,1,2
C1(CC(CO)(C(C(C)(O)O1)O)O)=O,,,5,1,1,0,1
56819_0,,,,2,1,1,2
C1(C(C(C)(C(C(C)(O)O1)O)O)O)=O,,,5,1,1,0,1
56821_0,,,,2,1,1,2
CC1(C(C2(COC(C2)O1)O)O)O,,,5,1,1,0,1
56823_0,,,,2,1,1,2
CC1(C(C(C(CO1)O)O)O)O,,,5,1,1,0,1
56825_0,,,,2,1,1,2
CC1(C(C(C(C(CO)O1)O)O)O)O,,,5,1,1,0,1
56826_0,,,,2,1,1,2
56827_0,,,,2,1,1,2
56829_0,,,,2,1,1,2
C(C1(CCOC(C)(C1O)O)O)=O,,,5,1,1,0,1
56831_0,,,,2,1,1,2
C(C1CC(C(C(C)(O1)O)O)O)=O,,,5,1,1,0,1
56833_0,,,,2,1,1,2
C(C)(C1C(CC(C(O1)O)O)O)=O,,,5,1,1,0,1
56835_0,,,,2,1,1,2
C1CC(CO)(CC(CO)(O)O1)O,,,5,1,1,0,1
56837_0,,,,2,1,1,2
C1C(C(C)(CC(CO)(O)O1)O)O,,,5,1,1,0,1
56839_0,,,,2,1,1,2
C1(CC(CC(CO)(O)O1)O)=O,,,5,1,1,0,1
56841_0,,,,2,1,1,2
C(C1(CCOC(CO)(C1)O)O)(O)=O,,,5,1,1,0,1
56843_0,,,,2,1,1,2
C(C1CC(CC(CO)(O1)O)O)(O)=O,,,5,1,1,0,1
56845_0,,,,2,1,1,2
C1(CC(CO)(CC(CO)(O)O1)O)=O,,,5,1,1,0,1
56847_0,,,,2,1,1,2
C1(C(C(C)(CC(CO)(O)O1)O)O)=O,,,5,1,1,0,1
56849_0,,,,2,1,1,2
C1C2(CC(O1)OC(CO)(C2)O)O,,,5,1,1,0,1
56851_0,,,,2,1,1,2
C1(COC(C(C=C)(C1)O)O)=O,,,5,1,1,0,1
56853_0,,,,2,1,1,2
C1(COC(C=C)(C(C1)O)O)=O,,,5,1,1,0,1
56854_0,,,,2,1,1,2
56855_0,,,,2,1,1,2
56856_0,,,,2,1,1,2
56857_0,,,,2,1,1,2
56859_0,,,,2,1,1,2
C1(COC(C(C)(C1)O)O)=O,,,5,1,1,0,1
56861_0,,,,2,1,1,2
C1(COC(C)(C(C1)O)O)=O,,,5,1,1,0,1
56862_0,,,,2,1,1,2
56864_0,,,,2,1,1,2
C1(COC(C(CCO)(C1)O)O)=O,,,5,1,1,0,1
56866_0,,,,2,1,1,2
C1(COC(C(C1)O)(CCO)O)=O,,,5,1,1,0,1
56867_0,,,,2,1,1,2
56869_0,,,,2,1,1,2
C(C1(CC(CO)(CCO1)O)O)(O)=O,,,5,1,1,0,1
56871_0,,,,2,1,1,2
C(C1C(O)OCCC1(CO)O)(O)=O,,,5,1,1,0,1
56872_0,,,,2,1,1,2
56873_0,,,,2,1,1,2
56874_0,,,,2,1,1,2
56875_0,,,,2,1,1,2
56876_0,,,,2,1,1,2
56877_0,,,,2,1,1,2
56879_0,,,,2,1,1,2
C1(CC(C(C(CCO)(O)O1)O)O)=O,,,5,1,1,0,1
56880_0,,,,2,1,1,2
56882_0,,,,2,1,1,2
C1(CC(C(CO)C(CO)(O)O1)O)=O,,,5,1,1,0,1
56884_0,,,,2,1,1,2
C1(COC(C(C=C)(C1CO)O)O)=O,,,5,1,1,0,1
56886_0,,,,2,1,1,2
C1(COC(C=C)(C(C1CO)O)O)=O,,,5,1,1,0,1
56887_0,,,,2,1,1,2
56888_0,,,,2,1,1,2
56889_0,,,,2,1,1,2
56890_0,,,,2,1,1,2
56891_0,,,,2,1,1,2
56893_0,,,,2,1,1,2
C(C1(CC(C)(C(CO1)O)O)O)(O)=O,,,5,1,1,0,1
56895_0,,,,2,1,1,2
C(C1C(O)OCC(C1(C)O)O)(O)=O,,,5,1,1,0,1
56897_0,,,,2,1,1,2
CC1(C(COC(CO)(C1O)O)O)O,,,5,1,1,0,1
56899_0,,,,2,1,1,2
C(C1(CC(C)(C(CO1)O)O)O)=O,,,5,1,1,0,1
56900_0,,,,2,1,1,2
56902_0,,,,2,1,1,2
C(C1C(O)OCC(C1(C)O)O)=O,,,5,1,1,0,1
56904_0,,,,2,1,1,2
C1C(C(C)(CC(O)O1)O)O,,,5,1,1,0,1
56906_0,,,,2,1,1,2
CC1(C(COC(C1O)O)O)O,,,5,1,1,0,1
56908_0,,,,2,1,1,2
C1(CC(CC(C(CO)O)(O)O1)O)=O,,,5,1,1,0,1
56910_0,,,,2,1,1,2
C1(CC(C=C)(C(OC1CO)O)O)=O,,,5,1,1,0,1
56912_0,,,,2,1,1,2
C1(C(CO)OC(C=C)(C(C1)O)O)=O,,,5,1,1,0,1
56913_0,,,,2,1,1,2
56914_0,,,,2,1,1,2
56915_0,,,,2,1,1,2
56917_0,,,,2,1,1,2
C1(C(CC(C(O)O1)=O)O)=O,,,5,1,1,0,1
56919_0,,,,2,1,1,2
C1(C(O)OC(C(C1CO)O)=O)=O,,,5,1,1,0,1
56921_0,,,,2,1,1,2
C(C1C(C(O)OC(C1O)=O)O)=O,,,5,1,1,0,1
56922_0,,,,2,1,1,2
56923_0,,,,2,1,1,2
56925_0,,,,2,1,1,2
C1(C(C)(CC(C(O)O1)=O)O)=O,,,5,1,1,0,1
56927_0,,,,2,1,1,2
C1(C(C)(C(C(C(O)O1)=O)CO)O)=O,,,5,1,1,0,1
56929_0,,,,2,1,1,2
C(C1C(C(O)OC(C1(C)O)=O)O)=O,,,5,1,1,0,1
56930_0,,,,2,1,1,2
56931_0,,,,2,1,1,2
56933_0,,,,2,1,1,2
C1(CC(CC(C(O)=O)(O)O1)O)=O,,,5,1,1,0,1
56935_0,,,,2,1,1,2
C(C1(CC2(COC(C2)O1)O)O)(O)=O,,,5,1,1,0,1
56937_0,,,,2,1,1,2
C(C1(C(O)OC(C(C1)=O)=O)O)=C,,,5,1,1,0,1
56939_0,,,,2,1,1,2
C=CC1(C(CC(C(O1)=O)=O)O)O,,,5,1,1,0,1
56941_0,,,,2,1,1,2
C1(C(CC(C(O)O1)O)=O)=O,,,5,1,1,0,1
56943_0,,,,2,1,1,2
C1(C(CC(C)(C(O)O1)O)=O)=O,,,5,1,1,0,1
56944_0,,,,2,1,1,2
56945_0,,,,2,1,1,2
56947_0,,,,2,1,1,2
C1(C(CC(C(O)O1)(CCO)O)=O)=O,,,5,1,1,0,1
56949_0,,,,2,1,1,2
C1(C(CC(C(CCO)(O)O1)O)=O)=O,,,5,1,1,0,1
56950_0,,,,2,1,1,2
56952_0,,,,2,1,1,2
C(C1C(O)OC(CC1O)=O)(O)=O,,,5,1,1,0,1
56954_0,,,,2,1,1,2
C1(CC(C2C(C(CO2)O)(O)O1)O)=O,,,5,1,1,0,1
56956_0,,,,2,1,1,2
C1(CC(C2COC(C2(O)O1)O)O)=O,,,5,1,1,0,1
56958_0,,,,2,1,1,2
C1(CC(C2C(O)OCC2(O)O1)O)=O,,,5,1,1,0,1
56960_0,,,,2,1,1,2
C1(CC(C2C(CC(O)O2)(O)O1)O)=O,,,5,1,1,0,1
56962_0,,,,2,1,1,2
C1(CC(C(C(CO)(O)O1)O)O)=O,,,5,1,1,0,1
56964_0,,,,2,1,1,2
C1(CC(CC(C=O)(O)O1)O)=O,,,5,1,1,0,1
56966_0,,,,2,1,1,2
C(C1C(O)OC(CC1O)=O)=O,,,5,1,1,0,1
56968_0,,,,2,1,1,2
C1(CC(C(CO)C(C=O)(O)O1)O)=O,,,5,1,1,0,1
56970_0,,,,2,1,1,2
C1(CC(C(C(O)O1)C(C=O)O)O)=O,,,5,1,1,0,1
56972_0,,,,2,1,1,2
C1(CC(C(C(CO)=O)C(O)O1)O)=O,,,5,1,1,0,1
56974_0,,,,2,1,1,2
C(C1C(CC(OC1(CO)O)=O)O)=O,,,5,1,1,0,1
56975_0,,,,2,1,1,2
56977_0,,,,2,1,1,2
C1(CC(C(C(CC=O)(O)O1)O)O)=O,,,5,1,1,0,1
56978_0,,,,2,1,1,2
56980_0,,,,2,1,1,2
C1(CC(CC(C(C=O)O)(O)O1)O)=O,,,5,1,1,0,1
56982_0,,,,2,1,1,2
C1(CC(CC(O)O1)O)=O,,,5,1,1,0,1
56984_0,,,,2,1,1,2
C1(CC(C(C(O)O1)O)O)=O,,,5,1,1,0,1
56986_0,,,,2,1,1,2
C(C1C(O)OC2CC1(CO2)O)(O)=O,,,5,1,1,0,1
56987_0,,,,2,1,1,2
56988_0,,,,2,1,1,2
56989_0,,,,2,1,1,2
56990_0,,,,2,1,1,2
56992_0,,,,2,1,1,2
C1(C(C=O)C(CC(CO)(O)O1)O)=O,,,5,1,1,0,1
56994_0,,,,2,1,1,2
C1(C(C=O)C(CO)(CC(O)O1)O)=O,,,5,1,1,0,1
56996_0,,,,2,1,1,2
C1(C(C=O)C(C(C(C)(O)O1)O)O)=O,,,5,1,1,0,1
56998_0,,,,2,1,1,2
C1(C(C=O)C(C)(C(C(O)O1)O)O)=O,,,5,1,1,0,1
57000_0,,,,2,1,1,2
C1(C(CCO)(CC(C(O)O1)=O)O)=O,,,5,1,1,0,1
57001_0,,,,2,1,1,2
57002_0,,,,2,1,1,2
57003_0,,,,2,1,1,2
57004_0,,,,2,1,1,2
57006_0,,,,2,1,1,2
C1(C(C(CO)C(C(O)O1)O)=O)=O,,,5,1,1,0,1
57008_0,,,,2,1,1,2
C1(C(C(CO)C(C)(C(O)O1)O)=O)=O,,,5,1,1,0,1
57010_0,,,,2,1,1,2
C1(C(C(CO)C(C(C)(O)O1)O)=O)=O,,,5,1,1,0,1
57011_0,,,,2,1,1,2
57012_0,,,,2,1,1,2
57013_0,,,,2,1,1,2
57014_0,,,,2,1,1,2
57015_0,,,,2,1,1,2
57016_0,,,,2,1,1,2
57018_0,,,,2,1,1,2
C1(CC(CO)(CC(C=O)(O)O1)O)=O,,,5,1,1,0,1
57019_0,,,,2,1,1,2
57021_0,,,,2,1,1,2
C(C1C(O)OC(CC1(CO)O)=O)=O,,,5,1,1,0,1
57023_0,,,,2,1,1,2
C1(CC(CO)(CC(O)O1)O)=O,,,5,1,1,0,1
57025_0,,,,2,1,1,2
C1(CC(CO)(C(C(O)O1)O)O)=O,,,5,1,1,0,1
57026_0,,,,2,1,1,2
57027_0,,,,2,1,1,2
57028_0,,,,2,1,1,2
57030_0,,,,2,1,1,2
C1(C(C(CO)=O)C(CC(O)O1)O)=O,,,5,1,1,0,1
57032_0,,,,2,1,1,2
C1(C(C(C)(CC(C=O)(O)O1)O)O)=O,,,5,1,1,0,1
57033_0,,,,2,1,1,2
57035_0,,,,2,1,1,2
C(C1C(O)OC(C(C1(C)O)O)=O)=O,,,5,1,1,0,1
57037_0,,,,2,1,1,2
C1(C(C(C)(CC(O)O1)O)O)=O,,,5,1,1,0,1
57038_0,,,,2,1,1,2
57039_0,,,,2,1,1,2
57040_0,,,,2,1,1,2
57041_0,,,,2,1,1,2
57042_0,,,,2,1,1,2
57043_0,,,,2,1,1,2
57044_0,,,,2,1,1,2
57046_0,,,,2,1,1,2
C(C1(COC(C(CO)C1O)O)O)=O,,,5,1,1,0,1
57048_0,,,,2,1,1,2
C(C1COC(C(CO)(C1O)O)O)=O,,,5,1,1,0,1
57050_0,,,,2,1,1,2
C(C)(C1(C(C)OC(CC1O)O)O)=O,,,5,1,1,0,1
57052_0,,,,2,1,1,2
C(C1(C(C)OC(CC1(C)O)O)O)=O,,,5,1,1,0,1
57053_0,,,,2,1,1,2
57054_0,,,,2,1,1,2
57055_0,,,,2,1,1,2
57057_0,,,,2,1,1,2
C(C)(C1(COC(C(C1O)O)O)O)=O,,,5,1,1,0,1
57059_0,,,,2,1,1,2
C(C1(COC(CC1(C)O)O)O)=O,,,5,1,1,0,1
57060_0,,,,2,1,1,2
57061_0,,,,2,1,1,2
57062_0,,,,2,1,1,2
57063_0,,,,2,1,1,2
57064_0,,,,2,1,1,2
57066_0,,,,2,1,1,2
CC(C1(COC(CC1O)O)O)O,,,5,1,1,0,1
57068_0,,,,2,1,1,2
CC1C(CO)(C(CC(O)O1)O)O,,,5,1,1,0,1
57070_0,,,,2,1,1,2
C1C(C(C)O)(C(C(C(O)O1)O)O)O,,,5,1,1,0,1
57072_0,,,,2,1,1,2
CC1C(CO)(C(C(C(O)O1)O)O)O,,,5,1,1,0,1
57074_0,,,,2,1,1,2
C(C1COC(C(C1(C=O)O)O)O)=O,,,5,1,1,0,1
57076_0,,,,2,1,1,2
C(C1C(C(C(C(O1)O)O)O)O)(O)=O,,,5,1,1,0,1
57078_0,,,,2,1,1,2
C(C1C(C)(C(CC(O1)O)O)O)(O)=O,,,5,1,1,0,1
57080_0,,,,2,1,1,2
C(C1C(C(C)(CC(O1)O)O)O)(O)=O,,,5,1,1,0,1
57082_0,,,,2,1,1,2
C(C(C1CC(CC(O)O1)O)O)(O)=O,,,5,1,1,0,1
57084_0,,,,2,1,1,2
C1(C(C(C(C(O)O1)C(C)O)O)O)=O,,,5,1,1,0,1
57086_0,,,,2,1,1,2
C1(C(C(C(CO)C(O)O1)O)O)=O,,,5,1,1,0,1
57088_0,,,,2,1,1,2
C(CC1(C(C)OC(CC1O)O)O)=O,,,5,1,1,0,1
57089_0,,,,2,1,1,2
57090_0,,,,2,1,1,2
57091_0,,,,2,1,1,2
57093_0,,,,2,1,1,2
C(C1C(CC(CO)(C(O1)O)O)O)=O,,,5,1,1,0,1
57094_0,,,,2,1,1,2
57096_0,,,,2,1,1,2
C(C1CC(CO)(CC(O1)O)O)=O,,,5,1,1,0,1
57097_0,,,,2,1,1,2
57099_0,,,,2,1,1,2
C(C1C(CO)(CC(C(O1)O)O)O)=O,,,5,1,1,0,1
57101_0,,,,2,1,1,2
C(C1CC(CO)(C(C(O1)O)O)O)=O,,,5,1,1,0,1
57102_0,,,,2,1,1,2
57103_0,,,,2,1,1,2
57104_0,,,,2,1,1,2
57106_0,,,,2,1,1,2
C(CO)(C1C(C(O)OCC1O)O)=O,,,5,1,1,0,1
57107_0,,,,2,1,1,2
57108_0,,,,2,1,1,2
57109_0,,,,2,1,1,2
57110_0,,,,2,1,1,2
57111_0,,,,2,1,1,2
57113_0,,,,2,1,1,2
C(C1(CC(O)OC(CO)C1)O)(O)=O,,,5,1,1,0,1
57115_0,,,,2,1,1,2
C(C1CC(CO)(CC(O1)O)O)(O)=O,,,5,1,1,0,1
57117_0,,,,2,1,1,2
C1(CC(CC(O)O1)(C(CO)O)O)=O,,,5,1,1,0,1
57119_0,,,,2,1,1,2
C(CC1(CC(O)OCC1O)O)(O)=O,,,5,1,1,0,1
57121_0,,,,2,1,1,2
C1(C(C(CC(O)O1)(CCO)O)O)=O,,,5,1,1,0,1
57123_0,,,,2,1,1,2
C(C(C1(CC(O)OCC1)O)O)(O)=O,,,5,1,1,0,1
57125_0,,,,2,1,1,2
C1(C(O)OC2COCC2(C1)O)=O,,,5,1,1,0,1
57127_0,,,,2,1,1,2
C1(C2C(C=C)(C(OC1CO2)O)O)=O,,,5,1,1,0,1
57129_0,,,,2,1,1,2
C1(C2C(C(C=C)(OC1CO2)O)O)=O,,,5,1,1,0,1
57131_0,,,,2,1,1,2
C1C(C(C2C(C(CO2)O)(O)O1)O)O,,,5,1,1,0,1
57133_0,,,,2,1,1,2
C1(C2C(C(OC1CO2)O)O)=O,,,5,1,1,0,1
57135_0,,,,2,1,1,2
C1(C2C(C)(C(OC1CO2)O)O)=O,,,5,1,1,0,1
57137_0,,,,2,1,1,2
C1(C2C(C(C)(OC1CO2)O)O)=O,,,5,1,1,0,1
57139_0,,,,2,1,1,2
C1(C(O)OC2C(CCO2)(C1)O)=O,,,5,1,1,0,1
57141_0,,,,2,1,1,2
C1(C2OCC1C(C=C)(C(O2)O)O)=O,,,5,1,1,0,1
57143_0,,,,2,1,1,2
C1(C2OC(C=C)(C(C1CO2)O)O)=O,,,5,1,1,0,1
57144_0,,,,2,1,1,2
57146_0,,,,2,1,1,2
C1(C2OC(C(C1CO2)O)O)=O,,,5,1,1,0,1
57148_0,,,,2,1,1,2
C1(C2OC(C(C)(C1CO2)O)O)=O,,,5,1,1,0,1
57150_0,,,,2,1,1,2
C1(C2OC(C)(C(C1CO2)O)O)=O,,,5,1,1,0,1
57152_0,,,,2,1,1,2
C1C2(CC(O1)OC(CO)(C2O)O)O,,,5,1,1,0,1
57154_0,,,,2,1,1,2
C(C1(CC2(COC(C2)O1)O)O)=O,,,5,1,1,0,1
57156_0,,,,2,1,1,2
C(C1C(O)OC2CC1(CO2)O)=O,,,5,1,1,0,1
57158_0,,,,2,1,1,2
C1C2(CC(O1)OC(C2)O)O,,,5,1,1,0,1
57160_0,,,,2,1,1,2
C1C2(CC(O1)OC(C2O)O)O,,,5,1,1,0,1
57161_0,,,,2,1,1,2
57163_0,,,,2,1,1,2
C1(COC2C1C(CC(O)O2)O)=O,,,5,1,1,0,1
57164_0,,,,2,1,1,2
57165_0,,,,2,1,1,2
57167_0,,,,2,1,1,2
C(C1C(COC(C1(C=C)O)O)=O)=O,,,5,1,1,0,1
57169_0,,,,2,1,1,2
C(C1(C=C)C(C(CC(O1)O)=O)O)=O,,,5,1,1,0,1
57171_0,,,,2,1,1,2
C(C1C(CC(C=C)(C(O1)O)O)=O)=O,,,5,1,1,0,1
57173_0,,,,2,1,1,2
C(C1(C=C)CC(C(C(O1)O)O)=O)=O,,,5,1,1,0,1
57174_0,,,,2,1,1,2
57176_0,,,,2,1,1,2
C(C1C(COC(C=C)(C1O)O)=O)=O,,,5,1,1,0,1
57178_0,,,,2,1,1,2
C1(C(C(C(C=C)=O)OC(C1)O)O)=O,,,5,1,1,0,1
57180_0,,,,2,1,1,2
C1(CC(C(C=C)(OC1C=O)O)O)=O,,,5,1,1,0,1
57182_0,,,,2,1,1,2
C1(CC(C(C=C)=O)OC(C1O)O)=O,,,5,1,1,0,1
57184_0,,,,2,1,1,2
C1(C(C(C=CC=O)OC(C1)O)O)=O,,,5,1,1,0,1
57186_0,,,,2,1,1,2
C1(CC(C=CC=O)OC(C1O)O)=O,,,5,1,1,0,1
57188_0,,,,2,1,1,2
C1(C(CC(C(O)O1)O)O)=O,,,5,1,1,0,1
57190_0,,,,2,1,1,2
C1(C(C(CO)C(C(O)O1)O)O)=O,,,5,1,1,0,1
57192_0,,,,2,1,1,2
C1(C(CC(C)(C(O)O1)O)O)=O,,,5,1,1,0,1
57194_0,,,,2,1,1,2
C1(C(C(CO)C(C)(C(O)O1)O)O)=O,,,5,1,1,0,1
57196_0,,,,2,1,1,2
C1(C(CC(C(C)(O)O1)O)O)=O,,,5,1,1,0,1
57198_0,,,,2,1,1,2
C1(C(C(CO)C(C(C)(O)O1)O)O)=O,,,5,1,1,0,1
57200_0,,,,2,1,1,2
C1(C(CC(C(O)O1)(CCO)O)O)=O,,,5,1,1,0,1
57202_0,,,,2,1,1,2
C1(C(CC(C(CCO)(O)O1)O)O)=O,,,5,1,1,0,1
57204_0,,,,2,1,1,2
C(C1CC(C)(C(C(O1)O)O)O)(O)=O,,,5,1,1,0,1
57206_0,,,,2,1,1,2
C(C1C(CO)C(CC(O1)O)O)(O)=O,,,5,1,1,0,1
57207_0,,,,2,1,1,2
57208_0,,,,2,1,1,2
57209_0,,,,2,1,1,2
57210_0,,,,2,1,1,2
57211_0,,,,2,1,1,2
57212_0,,,,2,1,1,2
57213_0,,,,2,1,1,2
57215_0,,,,2,1,1,2
C(C1(C(C(O)OCC1)=O)O)=O,,,5,1,1,0,1
57216_0,,,,2,1,1,2
57217_0,,,,2,1,1,2
57218_0,,,,2,1,1,2
57219_0,,,,2,1,1,2
57220_0,,,,2,1,1,2
57221_0,,,,2,1,1,2
57222_0,,,,2,1,1,2
57223_0,,,,2,1,1,2
57224_0,,,,2,1,1,2
57225_0,,,,2,1,1,2
57226_0,,,,2,1,1,2
57228_0,,,,2,1,1,2
C1(C(C(CO)(O)OCC1O)O)=O,,,5,1,1,0,1
57229_0,,,,2,1,1,2
57230_0,,,,2,1,1,2
57231_0,,,,2,1,1,2
57232_0,,,,2,1,1,2
57234_0,,,,2,1,1,2
C(C1(C(CC(CO)(CO1)O)O)O)=O,,,5,1,1,0,1
57235_0,,,,2,1,1,2
57236_0,,,,2,1,1,2
57237_0,,,,2,1,1,2
57239_0,,,,2,1,1,2
C1(C(C(C(CO)O)(O)OCC1)O)=O,,,5,1,1,0,1
57240_0,,,,2,1,1,2
57241_0,,,,2,1,1,2
57243_0,,,,2,1,1,2
C1(C(CO)OC(CC1(CO)O)O)=O,,,5,1,1,0,1
57245_0,,,,2,1,1,2
C1(C(CO)OC(C(C1(C)O)O)O)=O,,,5,1,1,0,1
57246_0,,,,2,1,1,2
57248_0,,,,2,1,1,2
C1(C(C(C(C)O)(O)OCC1O)O)=O,,,5,1,1,0,1
57249_0,,,,2,1,1,2
57250_0,,,,2,1,1,2
57251_0,,,,2,1,1,2
57253_0,,,,2,1,1,2
C1(C(C)OC(C(C1)=O)O)=O,,,5,1,1,0,1
57255_0,,,,2,1,1,2
C1(C(C)OC(C(C1CO)=O)O)=O,,,5,1,1,0,1
57257_0,,,,2,1,1,2
C(C1C(C(C)OC(C1O)O)=O)=O,,,5,1,1,0,1
57258_0,,,,2,1,1,2
57259_0,,,,2,1,1,2
57261_0,,,,2,1,1,2
C1(C(CCO)OC(C(C1)=O)O)=O,,,5,1,1,0,1
57262_0,,,,2,1,1,2
57264_0,,,,2,1,1,2
C(C(C1CC(CC(O1)O)O)=O)=O,,,5,1,1,0,1
57265_0,,,,2,1,1,2
57266_0,,,,2,1,1,2
57268_0,,,,2,1,1,2
C1(COC(CC1(CO)O)O)=O,,,5,1,1,0,1
57269_0,,,,2,1,1,2
57271_0,,,,2,1,1,2
C(C1(C(CC(C(CO)O1)O)O)O)=O,,,5,1,1,0,1
57272_0,,,,2,1,1,2
57273_0,,,,2,1,1,2
57275_0,,,,2,1,1,2
C(C1(C(CC(CO1)O)O)O)=O,,,5,1,1,0,1
57276_0,,,,2,1,1,2
57278_0,,,,2,1,1,2
C1(C(C)OC(C(CO)(C1O)O)O)=O,,,5,1,1,0,1
57280_0,,,,2,1,1,2
C1(COC(C(CO)(C1(C)O)O)O)=O,,,5,1,1,0,1
57282_0,,,,2,1,1,2
C(C1(C(COC(C1)O)=O)O)=O,,,5,1,1,0,1
57284_0,,,,2,1,1,2
C(C1(C(C(C)OC(C1)O)=O)O)=O,,,5,1,1,0,1
57285_0,,,,2,1,1,2
57287_0,,,,2,1,1,2
C(C1(COC(C(C1)O)O)O)=O,,,5,1,1,0,1
57289_0,,,,2,1,1,2
C1(C(CC(C(CO)(O)O1)O)O)=O,,,5,1,1,0,1
57291_0,,,,2,1,1,2
C(C1(C(CC(CO1)O)O)O)(O)=O,,,5,1,1,0,1
57292_0,,,,2,1,1,2
57293_0,,,,2,1,1,2
57294_0,,,,2,1,1,2
57295_0,,,,2,1,1,2
57297_0,,,,2,1,1,2
CC1(CCOC(C1O)O)O,,,5,1,1,0,1
57299_0,,,,2,1,1,2
C1CC(C(CO)(C(CO)(O)O1)O)O,,,5,1,1,0,1
57300_0,,,,2,1,1,2
57302_0,,,,2,1,1,2
C(C)(C1(C(O)OCCC1O)O)=O,,,5,1,1,0,1
57304_0,,,,2,1,1,2
C(C1(C(C)(O)OCCC1O)O)=O,,,5,1,1,0,1
57306_0,,,,2,1,1,2
C1CC(C(C(O)O1)(CO)O)O,,,5,1,1,0,1
57308_0,,,,2,1,1,2
C1CC(C(C(O)O1)(C(CO)O)O)O,,,5,1,1,0,1
57309_0,,,,2,1,1,2
57310_0,,,,2,1,1,2
57311_0,,,,2,1,1,2
57312_0,,,,2,1,1,2
57313_0,,,,2,1,1,2
57315_0,,,,2,1,1,2
CC1(C(COC(C1(CO)O)O)O)O,,,5,1,1,0,1
57317_0,,,,2,1,1,2
C(C1(CCOC(C1(C)O)O)O)=O,,,5,1,1,0,1
57319_0,,,,2,1,1,2
C(C1(CC(O)OCC1(C)O)O)=O,,,5,1,1,0,1
57321_0,,,,2,1,1,2
C(CC1(C(O)OCCC1O)O)=O,,,5,1,1,0,1
57322_0,,,,2,1,1,2
57324_0,,,,2,1,1,2
C1(C(C(CC(O)O1)O)C(C=O)O)=O,,,5,1,1,0,1
57325_0,,,,2,1,1,2
57326_0,,,,2,1,1,2
57328_0,,,,2,1,1,2
C1(CC(C)(C(C(O)O1)O)O)=O,,,5,1,1,0,1
57329_0,,,,2,1,1,2
57331_0,,,,2,1,1,2
C1(C(C(C)=O)(C(CC(O)O1)O)O)=O,,,5,1,1,0,1
57333_0,,,,2,1,1,2
C1(CC(C(C(C)=O)(C(O)O1)O)O)=O,,,5,1,1,0,1
57335_0,,,,2,1,1,2
C(C1(C(CC(OC1(C)O)=O)O)O)=O,,,5,1,1,0,1
57337_0,,,,2,1,1,2
C1(CC(C(CO)(C(O)O1)O)O)=O,,,5,1,1,0,1
57339_0,,,,2,1,1,2
C(C1(C(C(O)OC(C1)=O)O)O)=O,,,5,1,1,0,1
57341_0,,,,2,1,1,2
C(C1(CC(O)OC(C1O)=O)O)=O,,,5,1,1,0,1
57343_0,,,,2,1,1,2
C(C1(C(C)(C(O)OC(C1)=O)O)O)=O,,,5,1,1,0,1
57345_0,,,,2,1,1,2
C1(C(C)(C(C=O)(CC(O)O1)O)O)=O,,,5,1,1,0,1
57347_0,,,,2,1,1,2
C(C1(C(C(C)(O)OC(C1)=O)O)O)=O,,,5,1,1,0,1
57349_0,,,,2,1,1,2
C1(C(C(CC(O)O1)O)(CC=O)O)=O,,,5,1,1,0,1
57351_0,,,,2,1,1,2
C1(CC(C(C(O)O1)(CC=O)O)O)=O,,,5,1,1,0,1
57352_0,,,,2,1,1,2
57353_0,,,,2,1,1,2
57355_0,,,,2,1,1,2
C(C1(C=O)C(C(O)OCC1O)O)=O,,,5,1,1,0,1
57356_0,,,,2,1,1,2
57357_0,,,,2,1,1,2
57358_0,,,,2,1,1,2
57360_0,,,,2,1,1,2
C(C(C1(C(O)OCCC1O)O)O)=O,,,5,1,1,0,1
57362_0,,,,2,1,1,2
C(C1(C(C(O)OCC1(C)O)O)O)=O,,,5,1,1,0,1
57364_0,,,,2,1,1,2
C(C1(C(C(O)OC(C1O)=O)O)O)=O,,,5,1,1,0,1
57366_0,,,,2,1,1,2
C(C1(C(CC(OC1C=O)O)O)O)=O,,,5,1,1,0,1
57368_0,,,,2,1,1,2
C(C)(C1(C(C(O)OCC1O)O)O)=O,,,5,1,1,0,1
57370_0,,,,2,1,1,2
C(C1(C=O)C(C)OC(CC1O)O)=O,,,5,1,1,0,1
57372_0,,,,2,1,1,2
C(C1(C=O)COC(CC1O)O)=O,,,5,1,1,0,1
57374_0,,,,2,1,1,2
C(C1(C(C)OC(CC1O)O)O)=O,,,5,1,1,0,1
57376_0,,,,2,1,1,2
C(C1(C(O)OCCC1O)C(C)O)=O,,,5,1,1,0,1
57377_0,,,,2,1,1,2
57379_0,,,,2,1,1,2
C(C1(C(O)OC(C)CC1O)CO)=O,,,5,1,1,0,1
57381_0,,,,2,1,1,2
C(C1(C(O)OCCC1O)CO)=O,,,5,1,1,0,1
57383_0,,,,2,1,1,2
C(C1(C(OCC(C1O)=O)O)CO)=O,,,5,1,1,0,1
57385_0,,,,2,1,1,2
C(C1(CO)C(O)OC(CC1O)=O)=O,,,5,1,1,0,1
57386_0,,,,2,1,1,2
57387_0,,,,2,1,1,2
57388_0,,,,2,1,1,2
57389_0,,,,2,1,1,2
57390_0,,,,2,1,1,2
57391_0,,,,2,1,1,2
57392_0,,,,2,1,1,2
57393_0,,,,2,1,1,2
57395_0,,,,2,1,1,2
CC(C1(C(O)OC(C)CC1O)O)O,,,5,1,1,0,1
57397_0,,,,2,1,1,2
CC1(C(CO)(C(CC(C)O1)O)O)O,,,5,1,1,0,1
57399_0,,,,2,1,1,2
C1C2(C(CO1)(C(CC(C)O2)O)O)O,,,5,1,1,0,1
57401_0,,,,2,1,1,2
CC1CC(C(C(O)O1)(CO)O)O,,,5,1,1,0,1
57403_0,,,,2,1,1,2
C(C)(C1(C(O)OC(C)CC1O)O)=O,,,5,1,1,0,1
57405_0,,,,2,1,1,2
C(C1(C(C)(O)OC(C)CC1O)O)=O,,,5,1,1,0,1
57407_0,,,,2,1,1,2
CC(C1(C(O)OCCC1O)O)O,,,5,1,1,0,1
57409_0,,,,2,1,1,2
C1(CC(C(C(O)O1)(C(C)O)O)O)=O,,,5,1,1,0,1
57411_0,,,,2,1,1,2
CC1C(C(C(C(O)O1)(CO)O)O)O,,,5,1,1,0,1
57413_0,,,,2,1,1,2
C(C1(C(CO)(C(CCO1)O)O)O)=O,,,5,1,1,0,1
57415_0,,,,2,1,1,2
CC1(C(CO)(C(CCO1)O)O)O,,,5,1,1,0,1
57417_0,,,,2,1,1,2
C(C1(C(C)(O)OCCC1O)O)(O)=O,,,5,1,1,0,1
57419_0,,,,2,1,1,2
C1C2(C(CO1)(C(CCO2)O)O)O,,,5,1,1,0,1
57421_0,,,,2,1,1,2
C1(COC2(COCC2(C1O)O)O)=O,,,5,1,1,0,1
57423_0,,,,2,1,1,2
C(C)(C1(C(OCC(C1O)=O)O)O)=O,,,5,1,1,0,1
57425_0,,,,2,1,1,2
C(C1(C(C)(OCC(C1O)=O)O)O)=O,,,5,1,1,0,1
57427_0,,,,2,1,1,2
C1(C(O)OCC(C)(C1(CO)O)O)=O,,,5,1,1,0,1
57429_0,,,,2,1,1,2
C1(C(O)OC(C(C1(CO)O)O)=O)=O,,,5,1,1,0,1
57431_0,,,,2,1,1,2
C(C(C1(COC(CC1O)O)O)=O)=O,,,5,1,1,0,1
57432_0,,,,2,1,1,2
57434_0,,,,2,1,1,2
C(C1C(C(O)OCC1(C)O)O)(O)=O,,,5,1,1,0,1
57436_0,,,,2,1,1,2
C1(CC(C(CO)(C(C)(O)O1)O)O)=O,,,5,1,1,0,1
57438_0,,,,2,1,1,2
C(C1C(C(O)OC(C1O)=O)O)(O)=O,,,5,1,1,0,1
57440_0,,,,2,1,1,2
C1(CC(C2(COCC2(O)O1)O)O)=O,,,5,1,1,0,1
57442_0,,,,2,1,1,2
C(C1(CC(O)OCC1(C=O)O)O)=O,,,5,1,1,0,1
57443_0,,,,2,1,1,2
57445_0,,,,2,1,1,2
C(C1(C(C)OC(CC1O)O)O)(O)=O,,,5,1,1,0,1
57446_0,,,,2,1,1,2
57447_0,,,,2,1,1,2
57448_0,,,,2,1,1,2
57450_0,,,,2,1,1,2
C1C2(C(CO1)(O)OCC(C2O)O)O,,,5,1,1,0,1
57452_0,,,,2,1,1,2
C1(C2C(CO1)OC(CC2O)O)=O,,,5,1,1,0,1
57454_0,,,,2,1,1,2
C1C2(CC(O1)OC(C2(CO)O)O)O,,,5,1,1,0,1
57456_0,,,,2,1,1,2
C1(C2(C(CO1)OC(CC2O)O)O)=O,,,5,1,1,0,1
57458_0,,,,2,1,1,2
C1C2(C(CC(C(O)O1)(C2O)O)O)O,,,5,1,2,0,2
57458_1,,,,2,1,1,2
57460_0,,,,2,1,1,2
C(C1C(C=O)(CC(C(O)O1)=O)O)=O,,,5,1,1,0,1
57462_0,,,,2,1,1,2
C(C1C(CC(C)(C(O1)O)O)O)(O)=O,,,5,1,1,0,1
57464_0,,,,2,1,1,2
C(C)(C1(C(C)OC(C(C1)=O)O)O)=O,,,5,1,1,0,1
57466_0,,,,2,1,1,2
C(CC1(C(CCOC1(C)O)O)O)=O,,,5,1,1,0,1
57468_0,,,,2,1,1,2
C(C)(C1(CC(O)OCC1(C)O)O)=O,,,5,1,1,0,1
57470_0,,,,2,1,1,2
C(C)(C1(CC(O)OC(C1O)=O)O)=O,,,5,1,1,0,1
57472_0,,,,2,1,1,2
C(C)(C1(C(COC(C1)O)O)O)=O,,,5,1,1,0,1
57474_0,,,,2,1,1,2
C(C1C(CC(C(C)(O1)O)O)O)(O)=O,,,5,1,1,0,1
57476_0,,,,2,1,1,2
C1(C(C)(C(C(CO)C(O)O1)O)O)=O,,,5,1,1,0,1
57478_0,,,,2,1,1,2
C(C1(C(C)(C(CC(C)O1)O)O)O)=O,,,5,1,1,0,1
57480_0,,,,2,1,1,2
CC1CC(C(C(O)O1)(CCO)O)O,,,5,1,1,0,1
57482_0,,,,2,1,1,2
C1CC2(C(C(CC(C)O2)O)(O)O1)O,,,5,1,1,0,1
57484_0,,,,2,1,1,2
C(CC1(C(O)OC(C)CC1O)O)=O,,,5,1,1,0,1
57486_0,,,,2,1,1,2
C(C1(C(C)(C(CCO1)O)O)O)=O,,,5,1,1,0,1
57488_0,,,,2,1,1,2
C1CC(C(C(O)O1)(CCO)O)O,,,5,1,1,0,1
57490_0,,,,2,1,1,2
C(CC1(C(O)OCCC1O)O)(O)=O,,,5,1,1,0,1
57492_0,,,,2,1,1,2
C1CC2(C(C(CCO2)O)(O)O1)O,,,5,1,1,0,1
57494_0,,,,2,1,1,2
C1(C(C)(C(CC(O)O1)O)O)=O,,,5,1,1,0,1
57496_0,,,,2,1,1,2
C(C1(C)C(C(CC(O1)O)O)O)(O)=O,,,5,1,1,0,1
57498_0,,,,2,1,1,2
C(C1(C)C(CC(C(O1)O)O)O)(O)=O,,,5,1,1,0,1
57500_0,,,,2,1,1,2
C1(C(C)(C(CC(CO)(O)O1)O)O)=O,,,5,1,1,0,1
57502_0,,,,2,1,1,2
C1(C(C)(C(CO)(CC(O)O1)O)O)=O,,,5,1,1,0,1
57504_0,,,,2,1,1,2
C1(C(C)(C(C(C(C)(O)O1)O)O)O)=O,,,5,1,1,0,1
57506_0,,,,2,1,1,2
C1(C(C)(C(C)(C(C(O)O1)O)O)O)=O,,,5,1,1,0,1
57508_0,,,,2,1,1,2
C(C1(CCOC(C1(C)O)O)O)(O)=O,,,5,1,1,0,1
57510_0,,,,2,1,1,2
C1(C(CCO)(C(CC(O)O1)O)O)=O,,,5,1,1,0,1
57512_0,,,,2,1,1,2
C(C1(COC(C(C1(C)O)=O)O)O)=O,,,5,1,1,0,1
57514_0,,,,2,1,1,2
C(C1(C(C)(C(C(CO1)=O)O)O)O)=O,,,5,1,1,0,1
57516_0,,,,2,1,1,2
C1(COC2(C(C1O)(O)OCC2)O)=O,,,5,1,1,0,1
57518_0,,,,2,1,1,2
C(CC1(C(OCC(C1O)=O)O)O)=O,,,5,1,1,0,1
57520_0,,,,2,1,1,2
C1(C(O)OCC(C)(C1(C)O)O)=O,,,5,1,1,0,1
57522_0,,,,2,1,1,2
C1(C(O)OC(C(C1(C)O)O)=O)=O,,,5,1,1,0,1
57524_0,,,,2,1,1,2
C1(C(C)(C(C(C(O)O1)=O)(C)O)O)=O,,,5,1,1,0,1
57526_0,,,,2,1,1,2
C1(CC(C(C)(C(C=O)(O)O1)O)O)=O,,,5,1,1,0,1
57528_0,,,,2,1,1,2
C1(C(O)OC(CO)C(C1(C)O)O)=O,,,5,1,1,0,1
57530_0,,,,2,1,1,2
C(C1(C(C)(C(C(CO1)O)O)O)O)=O,,,5,1,1,0,1
57532_0,,,,2,1,1,2
C1(C(O)OCC(CO)(C1(C)O)O)=O,,,5,1,1,0,1
57534_0,,,,2,1,1,2
C1(C(O)OCC(C1(C)O)O)=O,,,5,1,1,0,1
57536_0,,,,2,1,1,2
C(C1(CC(O)OCC1(C)O)O)(O)=O,,,5,1,1,0,1
57538_0,,,,2,1,1,2
C1(CC(C(C(O)O1)(CCO)O)O)=O,,,5,1,1,0,1
57540_0,,,,2,1,1,2
C(C1(CCOC(C1(C=C)O)O)O)=O,,,5,1,1,0,1
57542_0,,,,2,1,1,2
C(C1(C(C(C=C)(O)OCC1)O)O)=O,,,5,1,1,0,1
57544_0,,,,2,1,1,2
C(C1(CC(O)OC(C1O)=O)O)(O)=O,,,5,1,1,0,1
57546_0,,,,2,1,1,2
C1(CC(C2(C(CCO2)(O)O1)O)O)=O,,,5,1,1,0,1
57548_0,,,,2,1,1,2
C(C(C1(C(OCC(C1)=O)O)O)O)=O,,,5,1,1,0,1
57550_0,,,,2,1,1,2
C1C(C(C2(C(CCO2)(O)O1)O)O)O,,,5,1,1,0,1
57551_0,,,,2,1,1,2
57552_0,,,,2,1,1,2
57554_0,,,,2,1,1,2
C(CC1(CC(C(CO1)O)O)O)=O,,,5,1,1,0,1
57555_0,,,,2,1,1,2
57556_0,,,,2,1,1,2
57557_0,,,,2,1,1,2
57558_0,,,,2,1,1,2
57559_0,,,,2,1,1,2
57561_0,,,,2,1,1,2
C(C1C(COC(C1CO)O)=O)=O,,,5,1,1,0,1
57563_0,,,,2,1,1,2
C(C1C(CC(CO)C(O1)O)=O)=O,,,5,1,1,0,1
57564_0,,,,2,1,1,2
57565_0,,,,2,1,1,2
57566_0,,,,2,1,1,2
57567_0,,,,2,1,1,2
57568_0,,,,2,1,1,2
57569_0,,,,2,1,1,2
57571_0,,,,2,1,1,2
C1(CC(C(CO)=O)(O)OCC1)=O,,,5,1,1,0,1
57572_0,,,,2,1,1,2
57573_0,,,,2,1,1,2
57575_0,,,,2,1,1,2
C(CC1(CC(C(CO1)=O)O)O)=O,,,5,1,1,0,1
57576_0,,,,2,1,1,2
57577_0,,,,2,1,1,2
57578_0,,,,2,1,1,2
57580_0,,,,2,1,1,2
C1(COC(C(CO)=O)(CC1)O)=O,,,5,1,1,0,1
57582_0,,,,2,1,1,2
C(CC1C(OCC(C1O)=O)O)=O,,,5,1,1,0,1
57584_0,,,,2,1,1,2
C(C)(C1(CC(C(CO1)=O)O)O)=O,,,5,1,1,0,1
57586_0,,,,2,1,1,2
C(C1(C(C)C(C(CO1)=O)O)O)=O,,,5,1,1,0,1
57587_0,,,,2,1,1,2
57588_0,,,,2,1,1,2
57589_0,,,,2,1,1,2
57590_0,,,,2,1,1,2
57591_0,,,,2,1,1,2
57592_0,,,,2,1,1,2
57593_0,,,,2,1,1,2
57594_0,,,,2,1,1,2
57595_0,,,,2,1,1,2
57596_0,,,,2,1,1,2
57598_0,,,,2,1,1,2
C1(CC(C(C)=O)(O)OCC1O)=O,,,5,1,1,0,1
57599_0,,,,2,1,1,2
57600_0,,,,2,1,1,2
57602_0,,,,2,1,1,2
C1(C(COC(C)(C1)O)O)=O,,,5,1,1,0,1
57603_0,,,,2,1,1,2
57604_0,,,,2,1,1,2
57605_0,,,,2,1,1,2
57606_0,,,,2,1,1,2
57607_0,,,,2,1,1,2
57608_0,,,,2,1,1,2
57609_0,,,,2,1,1,2
57610_0,,,,2,1,1,2
57611_0,,,,2,1,1,2
57612_0,,,,2,1,1,2
57613_0,,,,2,1,1,2
57614_0,,,,2,1,1,2
57615_0,,,,2,1,1,2
57616_0,,,,2,1,1,2
57617_0,,,,2,1,1,2
57618_0,,,,2,1,1,2
57619_0,,,,2,1,1,2
57620_0,,,,2,1,1,2
57621_0,,,,2,1,1,2
57622_0,,,,2,1,1,2
57623_0,,,,2,1,1,2
57624_0,,,,2,1,1,2
57625_0,,,,2,1,1,2
57627_0,,,,2,1,1,2
C(C1C(COC(CO)(C1)O)=O)=O,,,5,1,1,0,1
57628_0,,,,2,1,1,2
57629_0,,,,2,1,1,2
57630_0,,,,2,1,1,2
57631_0,,,,2,1,1,2
57632_0,,,,2,1,1,2
57633_0,,,,2,1,1,2
57634_0,,,,2,1,1,2
57636_0,,,,2,1,1,2
C(C1C(CCC(CO)(O1)O)=O)=O,,,5,1,1,0,1
57637_0,,,,2,1,1,2
57638_0,,,,2,1,1,2
57639_0,,,,2,1,1,2
57640_0,,,,2,1,1,2
57641_0,,,,2,1,1,2
57643_0,,,,2,1,1,2
C(C1C(C)(O)OCC(C1O)O)=O,,,5,1,1,0,1
57644_0,,,,2,1,1,2
57645_0,,,,2,1,1,2
57646_0,,,,2,1,1,2
57647_0,,,,2,1,1,2
57648_0,,,,2,1,1,2
57649_0,,,,2,1,1,2
57650_0,,,,2,1,1,2
57651_0,,,,2,1,1,2
57652_0,,,,2,1,1,2
57653_0,,,,2,1,1,2
57654_0,,,,2,1,1,2
57655_0,,,,2,1,1,2
57656_0,,,,2,1,1,2
57657_0,,,,2,1,1,2
57658_0,,,,2,1,1,2
57659_0,,,,2,1,1,2
57660_0,,,,2,1,1,2
57661_0,,,,2,1,1,2
57662_0,,,,2,1,1,2
57663_0,,,,2,1,1,2
57664_0,,,,2,1,1,2
57665_0,,,,2,1,1,2
57666_0,,,,2,1,1,2
57667_0,,,,2,1,1,2
57668_0,,,,2,1,1,2
57669_0,,,,2,1,1,2
57670_0,,,,2,1,1,2
57671_0,,,,2,1,1,2
57672_0,,,,2,1,1,2
57673_0,,,,2,1,1,2
57674_0,,,,2,1,1,2
57675_0,,,,2,1,1,2
57676_0,,,,2,1,1,2
57677_0,,,,2,1,1,2
57678_0,,,,2,1,1,2
57679_0,,,,2,1,1,2
57680_0,,,,2,1,1,2
57681_0,,,,2,1,1,2
57682_0,,,,2,1,1,2
57683_0,,,,2,1,1,2
57684_0,,,,2,1,1,2
57685_0,,,,2,1,1,2
57686_0,,,,2,1,1,2
57687_0,,,,2,1,1,2
57688_0,,,,2,1,1,2
57690_0,,,,2,1,1,2
C1C2(C(C(C(CO2)O)O1)O)O,,,5,1,1,0,1
57691_0,,,,2,1,1,2
57692_0,,,,2,1,1,2
57693_0,,,,2,1,1,2
57695_0,,,,2,1,1,2
C1C2(C(C(C(CO2)O1)O)O)O,,,5,1,1,0,1
57697_0,,,,2,1,1,2
C1C2C(CC(C(O)O2)(O)O1)O,,,5,1,2,0,2
57699_0,,,,2,1,1,2
C1(C2(CC(C(CO2)O)O1)O)=O,,,5,1,2,0,2
57701_0,,,,2,1,1,2
C1(C2C(C(CC(O2)O)O1)O)=O,,,5,1,2,0,2
57703_0,,,,2,1,1,2
C1(C2(CC(C(CO2)O1)O)O)=O,,,5,1,2,0,2
57704_0,,,,2,1,1,2
57705_0,,,,2,1,1,2
57706_0,,,,2,1,1,2
57707_0,,,,2,1,1,2
57708_0,,,,2,1,1,2
57709_0,,,,2,1,1,2
57710_0,,,,2,1,1,2
57711_0,,,,2,1,1,2
57712_0,,,,2,1,1,2
57713_0,,,,2,1,1,2
57714_0,,,,2,1,1,2
57715_0,,,,2,1,1,2
57716_0,,,,2,1,1,2
57717_0,,,,2,1,1,2
57718_0,,,,2,1,1,2
57719_0,,,,2,1,1,2
57720_0,,,,2,1,1,2
57721_0,,,,2,1,1,2
57723_0,,,,2,1,1,2
C1(C(O)OC2C(C1CO2)O)=O,,,5,1,1,0,1
57724_0,,,,2,1,1,2
57725_0,,,,2,1,1,2
57726_0,,,,2,1,1,2
57727_0,,,,2,1,1,2
57728_0,,,,2,1,1,2
57729_0,,,,2,1,1,2
57730_0,,,,2,1,1,2
57732_0,,,,2,1,1,2
C1C2(CC(O)OC(CO)(C2O)O1)O,,,5,1,1,0,1
57733_0,,,,2,1,1,2
57734_0,,,,2,1,1,2
57735_0,,,,2,1,1,2
57736_0,,,,2,1,1,2
57737_0,,,,2,1,1,2
57738_0,,,,2,1,1,2
57739_0,,,,2,1,1,2
57741_0,,,,2,1,1,2
C1(C(O)OC2C(C)(C1CO2)O)=O,,,5,1,1,0,1
57743_0,,,,2,1,1,2
C1(C(O)OC2(C)C(C1CO2)O)=O,,,5,1,1,0,1
57744_0,,,,2,1,1,2
57745_0,,,,2,1,1,2
57746_0,,,,2,1,1,2
57747_0,,,,2,1,1,2
57749_0,,,,2,1,1,2
C(C12CC(CO1)(CC(O2)O)O)=O,,,5,1,1,0,1
57750_0,,,,2,1,1,2
57751_0,,,,2,1,1,2
57752_0,,,,2,1,1,2
57753_0,,,,2,1,1,2
57754_0,,,,2,1,1,2
57756_0,,,,2,1,1,2
C(C1C2OCC1(CC(O)O2)O)=O,,,5,1,1,0,1
57757_0,,,,2,1,1,2
57758_0,,,,2,1,1,2
57759_0,,,,2,1,1,2
57760_0,,,,2,1,1,2
57761_0,,,,2,1,1,2
57763_0,,,,2,1,1,2
C12C(C(CO1)(CC(O)O2)O)O,,,5,1,1,0,1
57764_0,,,,2,1,1,2
57765_0,,,,2,1,1,2
57766_0,,,,2,1,1,2
57767_0,,,,2,1,1,2
57768_0,,,,2,1,1,2
57769_0,,,,2,1,1,2
57770_0,,,,2,1,1,2
57771_0,,,,2,1,1,2
57773_0,,,,2,1,1,2
C1C(C2(C(O1)OC(CC2O)O)O)O,,,5,1,1,0,1
57774_0,,,,2,1,1,2
57775_0,,,,2,1,1,2
57776_0,,,,2,1,1,2
57777_0,,,,2,1,1,2
57779_0,,,,2,1,1,2
C1C2(CC(O)OC(C2(CO)O)O1)O,,,5,1,1,0,1
57780_0,,,,2,1,1,2
57781_0,,,,2,1,1,2
57782_0,,,,2,1,1,2
57783_0,,,,2,1,1,2
57784_0,,,,2,1,1,2
57785_0,,,,2,1,1,2
57786_0,,,,2,1,1,2
57788_0,,,,2,1,1,2
C1(C2C(O)OC(C(O2)O)C1)=O,,,5,1,2,0,2
57789_0,,,,2,1,1,2
57791_0,,,,2,1,1,2
C1C2(C(C(C(O)O1)(CCO2)O)O)O,,,5,1,2,0,2
57792_0,,,,2,1,1,2
57794_0,,,,2,1,1,2
C(C1(C2C(CC(C(O)O2)O1)O)O)O,,,5,1,2,0,2
57795_0,,,,2,1,1,2
57797_0,,,,2,1,1,2
C1C(C2(COC(C(C2)(O)O1)O)O)O,,,5,1,2,0,2
57799_0,,,,2,1,1,2
C1C2C(CO)(CC(C(O)O2)(O)O1)O,,,5,1,2,0,2
57800_0,,,,2,1,1,2
57801_0,,,,2,1,1,2
57803_0,,,,2,1,1,2
C1C2(CO)C(CC(C(O)O2)(O)O1)O,,,5,1,2,0,2
57804_0,,,,2,1,1,2
57806_0,,,,2,1,1,2
C1C2(COC(C(C(O)O1)C2O)O)O,,,5,1,1,0,1
57808_0,,,,2,1,1,2
C1(C2C(O)OC(C)(C(O2)O)C1)=O,,,5,1,2,0,2
57809_0,,,,2,1,1,2
57811_0,,,,2,1,1,2
C1(C2C(O)OC(C(C)(O2)O)C1)=O,,,5,1,2,0,2
57812_0,,,,2,1,1,2
57813_0,,,,2,1,1,2
57815_0,,,,2,1,1,2
C1(C2(CC(C(C(CO)O2)O1)O)O)O,,,5,1,2,0,2
57816_0,,,,2,1,1,2
57818_0,,,,2,1,1,2
C(C1(C2COC(CC2O)O1)O)=O,,,5,1,1,0,1
57820_0,,,,2,1,1,2
C(C1C2C(O)OC(CC2O)O1)=O,,,5,1,1,0,1
57822_0,,,,2,1,1,2
C1C2C(C(CO)C(C(O)O2)(O)O1)O,,,5,1,2,0,2
57823_0,,,,2,1,1,2
57825_0,,,,2,1,1,2
C1(C2CC(C(C(O)O2)O1)O)O,,,5,1,2,0,2
57826_0,,,,2,1,1,2
57828_0,,,,2,1,1,2
C1C2C(C(C(O)O1)C(C(O)O2)O)O,,,5,1,2,0,2
57829_0,,,,2,1,1,2
57831_0,,,,2,1,1,2
C1C(C2C(C(CC(O)O2)(O)O1)O)O,,,5,1,2,0,2
57832_0,,,,2,1,1,2
57834_0,,,,2,1,1,2
C1C(C2CC(C(C(O)O2)O)(O)O1)O,,,5,1,2,0,2
57835_0,,,,2,1,1,2
57837_0,,,,2,1,1,2
C1C2C(C(C(C(O)O2)(O)O1)O)O,,,5,1,2,0,2
57838_0,,,,2,1,1,2
57840_0,,,,2,1,1,2
C1C2(C(CO)(O)OC(CC2O)O1)O,,,5,1,1,0,1
57842_0,,,,2,1,1,2
C1C2(C(O)OC(CC2O)O1)O,,,5,1,1,0,1
57844_0,,,,2,1,1,2
C12CC(C(C(O)O1)(C(CO)O2)O)O,,,5,1,1,0,1
57846_0,,,,2,1,1,2
C1(C2(CO)C(CC(C(O)O2)O1)O)O,,,5,1,2,0,2
57847_0,,,,2,1,1,2
57849_0,,,,2,1,1,2
C1C2(C(O)OC(CO)(CC2O)O1)O,,,5,1,1,0,1
57851_0,,,,2,1,1,2
C1C2(C(O)OC(CC2(CO)O)O1)O,,,5,1,1,0,1
57853_0,,,,2,1,1,2
C1C2(C(O)OC(C)(C(C2O)O)O1)O,,,5,1,1,0,1
57855_0,,,,2,1,1,2
CC1(C(C2OCC1(C(O)O2)O)O)O,,,5,1,1,0,1
57857_0,,,,2,1,1,2
C1C2C(C(C(O)O1)(CC(O)O2)O)O,,,5,1,2,0,2
57858_0,,,,2,1,1,2
57860_0,,,,2,1,1,2
C1C2(C(C(C(CCO2)(O)O1)O)O)O,,,5,1,2,0,2
57862_0,,,,2,1,1,2
C1C2(COC(C(CC2O)(O)O1)O)O,,,5,1,2,0,2
57864_0,,,,2,1,1,2
C1(C2OC(C(CCO2)(C1)O)O)=O,,,5,1,1,0,1
57866_0,,,,2,1,1,2
C1C(C2C(CC(C(O)O2)(O)O1)O)O,,,5,1,2,0,2
57868_0,,,,2,1,1,2
C1(COC2CC(C1C(O)O2)O)=O,,,5,1,1,0,1
57870_0,,,,2,1,1,2
C1(C2C(O)OC(CC(O2)O)C1)=O,,,5,1,2,0,2
57872_0,,,,2,1,1,2
C1C2C(C(C(C(O)O2)C(O)O1)O)O,,,5,1,2,0,2
57874_0,,,,2,1,1,2
C1C2C(C(C(CC(O)O2)(O)O1)O)O,,,5,1,2,0,2
57876_0,,,,2,1,1,2
C1C2C(CC(C(C(O)O2)O)(O)O1)O,,,5,1,2,0,2
57878_0,,,,2,1,1,2
C1C(C2(C(O)OC(CC2O)O1)O)O,,,5,1,1,0,1
57880_0,,,,2,1,1,2
C1C2(C(O)OC(C(O)O1)CC2O)O,,,5,1,2,0,2
57882_0,,,,2,1,1,2
C1C2(CC(C(CO2)(C(O)O1)O)O)O,,,5,1,2,0,2
57884_0,,,,2,1,1,2
C1(C2C(CC(C(O2)O)O1)O)=O,,,5,1,2,0,2
57886_0,,,,2,1,1,2
C(C(C=O)C1CCC(C(O)O1)=O)=O,,,5,1,1,0,1
57888_0,,,,2,1,1,2
C(C1(C=O)COC(C=O)(CC1)O)=O,,,5,1,1,0,1
57890_0,,,,2,1,1,2
C(C1(C=O)COC(CC1C=O)O)=O,,,5,1,1,0,1
57892_0,,,,2,1,1,2
C(C1C(C)OC(C=O)(CC1)O)=O,,,5,1,1,0,1
57894_0,,,,2,1,1,2
C(C1C(C)OC(CC1C=O)O)=O,,,5,1,1,0,1
57896_0,,,,2,1,1,2
C(CC1(C)CCC(C(O)O1)=O)=O,,,5,1,1,0,1
57898_0,,,,2,1,1,2
C(CC1CCCC(C=O)(O)O1)=O,,,5,1,1,0,1
57900_0,,,,2,1,1,2
C(C1CC(CC=O)OC(C1)O)=O,,,5,1,1,0,1
57902_0,,,,2,1,1,2
C(C1(CCC(C(O1)O)=O)C(C)O)=O,,,5,1,1,0,1
57904_0,,,,2,1,1,2
C(C1(C(C)OC(C=O)(CC1)O)O)=O,,,5,1,1,0,1
57906_0,,,,2,1,1,2
C(C1CC(O)OC(C)C1(C=O)O)=O,,,5,1,1,0,1
57908_0,,,,2,1,1,2
C(C1C(C)(CCC(C=O)(O1)O)O)=O,,,5,1,1,0,1
57910_0,,,,2,1,1,2
C(C(C1(CCC(C(O)O1)=O)C)O)=O,,,5,1,1,0,1
57912_0,,,,2,1,1,2
C(C1CC(OC(C=O)C1(C)O)O)=O,,,5,1,1,0,1
57914_0,,,,2,1,1,2
C(C(C1CCCC(C=O)(O)O1)O)=O,,,5,1,1,0,1
57916_0,,,,2,1,1,2
C(CC1C(OC(C=O)C(C1)O)O)=O,,,5,1,1,0,1
57918_0,,,,2,1,1,2
C(C1CC(O)OC(C1)C(C=O)O)=O,,,5,1,1,0,1
57920_0,,,,2,1,1,2
C(CC1CCC(C(O)O1)=O)=O,,,5,1,1,0,1
57922_0,,,,2,1,1,2
C(C1COC(C=O)(CC1)O)=O,,,5,1,1,0,1
57924_0,,,,2,1,1,2
C(C1CC(O)OCC1C=O)=O,,,5,1,1,0,1
57926_0,,,,2,1,1,2
C(CC(C1CCC(C(O)O1)=O)O)=O,,,5,1,1,0,1
57928_0,,,,2,1,1,2
C(CC1C(CCC(C=O)(O)O1)O)=O,,,5,1,1,0,1
57930_0,,,,2,1,1,2
C(C1CC(O)OC(C1O)CC=O)=O,,,5,1,1,0,1
57932_0,,,,2,1,1,2
C(CC1(COC(C=O)(CC1)O)O)=O,,,5,1,1,0,1
57934_0,,,,2,1,1,2
C(CC1(CO)CCC(C(O)O1)=O)=O,,,5,1,1,0,1
57936_0,,,,2,1,1,2
C(C1CC(O)OCC1(CC=O)O)=O,,,5,1,1,0,1
57938_0,,,,2,1,1,2
C(C1C(CO)OC(C=O)(CC1)O)=O,,,5,1,1,0,1
57940_0,,,,2,1,1,2
C(C1C(C(O)OCC1O)CC=O)=O,,,5,1,1,0,1
57942_0,,,,2,1,1,2
C(C1C(CO)OC(CC1C=O)O)=O,,,5,1,1,0,1
57944_0,,,,2,1,1,2
C1(C(C)(CCC(C=O)(O)O1)O)=O,,,5,1,1,0,1
57946_0,,,,2,1,1,2
C(C1(C)CCC(C(O1)O)=O)(O)=O,,,5,1,1,0,1
57948_0,,,,2,1,1,2
C(C1CC(O)OC(C1(C)O)=O)=O,,,5,1,1,0,1
57950_0,,,,2,1,1,2
C(C1CCCC(C=O)(O1)O)(O)=O,,,5,1,1,0,1
57952_0,,,,2,1,1,2
C(CC1C(O)OC(C(C1)O)=O)=O,,,5,1,1,0,1
57954_0,,,,2,1,1,2
C(C1CC(C(O)=O)OC(C1)O)=O,,,5,1,1,0,1
57956_0,,,,2,1,1,2
C1(C(OC(C(C=O)=O)CC1)O)=O,,,5,1,1,0,1
57958_0,,,,2,1,1,2
C1(C(OC(C(C(C)=O)=O)CC1)O)=O,,,5,1,1,0,1
57960_0,,,,2,1,1,2
C(C1(CCCC(C(C=O)=O)O1)O)=O,,,5,1,1,0,1
57962_0,,,,2,1,1,2
C(C1CC(C(C=O)=O)OC(C1)O)=O,,,5,1,1,0,1
57964_0,,,,2,1,1,2
C1(C(OC(C(C=O)=O)(C)CC1)O)=O,,,5,1,1,0,1
57966_0,,,,2,1,1,2
C(C)(C1CCC(C(O1)O)=O)=O,,,5,1,1,0,1
57968_0,,,,2,1,1,2
C(CC1C(OCC(C1)=O)O)=O,,,5,1,1,0,1
57970_0,,,,2,1,1,2
C(C1CCC(C(O1)O)=O)(CCO)=O,,,5,1,1,0,1
57972_0,,,,2,1,1,2
C(CO)(CC1CCC(C(O)O1)=O)=O,,,5,1,1,0,1
57974_0,,,,2,1,1,2
C(C1(CCC(C(CO)=O)CO1)O)=O,,,5,1,1,0,1
57976_0,,,,2,1,1,2
C(CC1C(OCC(C1CO)=O)O)=O,,,5,1,1,0,1
57978_0,,,,2,1,1,2
C(C1CC(O)OCC1C(CO)=O)=O,,,5,1,1,0,1
57980_0,,,,2,1,1,2
C(C1(CCC(C(O1)O)=O)CCO)=O,,,5,1,1,0,1
57982_0,,,,2,1,1,2
C(C1(CCOC(C1CC=O)O)O)=O,,,5,1,1,0,1
57984_0,,,,2,1,1,2
C(C(CC1CCC(C(O)O1)=O)O)=O,,,5,1,1,0,1
57986_0,,,,2,1,1,2
C(CC1C(OC(C=O)CC1O)O)=O,,,5,1,1,0,1
57988_0,,,,2,1,1,2
C(C(C1COC(C=O)(CC1)O)O)=O,,,5,1,1,0,1
57990_0,,,,2,1,1,2
C(C1C(CO)CCC(C=O)(O1)O)=O,,,5,1,1,0,1
57992_0,,,,2,1,1,2
C(C1CC(O)OCC1C(C=O)O)=O,,,5,1,1,0,1
57994_0,,,,2,1,1,2
C(C1CC(OC(C=O)C1CO)O)=O,,,5,1,1,0,1
57996_0,,,,2,1,1,2
C(C1(CCC(C(C)=O)(CO1)O)O)=O,,,5,1,1,0,1
57998_0,,,,2,1,1,2
C(C)(C1(CO)CCC(C(O1)O)=O)=O,,,5,1,1,0,1
58000_0,,,,2,1,1,2
C(C1CC(O)OCC1(C(C)=O)O)=O,,,5,1,1,0,1
58002_0,,,,2,1,1,2
C(C)(C(C1CCC(C(O)O1)=O)O)=O,,,5,1,1,0,1
58004_0,,,,2,1,1,2
C(C1(CCC(C(C(C)=O)O1)O)O)=O,,,5,1,1,0,1
58006_0,,,,2,1,1,2
C(C1C(C(C(C)=O)OC(C1)O)O)=O,,,5,1,1,0,1
58008_0,,,,2,1,1,2
C(CC1C(OC(C(C1)=O)CO)O)=O,,,5,1,1,0,1
58010_0,,,,2,1,1,2
C1(C(O)OC(C)CC1)=O,,,5,1,1,0,1
58012_0,,,,2,1,1,2
C(C1(CCCCO1)O)=O,,,5,1,1,0,1
58014_0,,,,2,1,1,2
C(C1CCOC(C1)O)=O,,,5,1,1,0,1
58016_0,,,,2,1,1,2
C(CC1C(O)OC(C(C1)=O)=O)=O,,,5,1,1,0,1
58018_0,,,,2,1,1,2
C1(C(C=O)CCC(C=O)(O)O1)=O,,,5,1,1,0,1
58020_0,,,,2,1,1,2
C1(C(C=O)C(C=O)CC(O)O1)=O,,,5,1,1,0,1
58022_0,,,,2,1,1,2
C1(CCCC(C=O)(O)O1)=O,,,5,1,1,0,1
58024_0,,,,2,1,1,2
C(C1CC(O)OC(C1)=O)=O,,,5,1,1,0,1
58026_0,,,,2,1,1,2
C(CC1C(OC2C(C1OC2)=O)O)=O,,,5,1,1,0,1
58028_0,,,,2,1,1,2
C(C1(CCC2C(C(CO2)=O)O1)O)=O,,,5,1,1,0,1
58030_0,,,,2,1,1,2
C(C1C2C(C(CO2)=O)OC(C1)O)=O,,,5,1,1,0,1
58032_0,,,,2,1,1,2
C1(COCC21CCC(C(O2)O)=O)=O,,,5,1,1,0,1
58034_0,,,,2,1,1,2
C1(C2(CCC(C(O2)O)=O)OCC1)=O,,,5,1,1,0,1
58036_0,,,,2,1,1,2
C(CC1C(OC2C(C1CO2)=O)O)=O,,,5,1,1,0,1
58038_0,,,,2,1,1,2
C1(C2C(CO1)OC(C=O)(CC2)O)=O,,,5,1,1,0,1
58040_0,,,,2,1,1,2
C1(C2C(CO1)OC(CC2C=O)O)=O,,,5,1,1,0,1
58042_0,,,,2,1,1,2
C1(CC2C(CCC(C=O)(O)O2)O1)=O,,,5,1,1,0,1
58044_0,,,,2,1,1,2
C(C1CC(O)OC2C1OC(C2)=O)=O,,,5,1,1,0,1
58046_0,,,,2,1,1,2
C1(CC2(CCC(C(O)O2)=O)CO1)=O,,,5,1,1,0,1
58048_0,,,,2,1,1,2
C(C1(CCC2C(COC2O1)=O)O)=O,,,5,1,1,0,1
58050_0,,,,2,1,1,2
C(C1CC(O)OC2C1C(CO2)=O)=O,,,5,1,1,0,1
58052_0,,,,2,1,1,2
C1(COC2(CCC(C(O)O2)=O)C1)=O,,,5,1,1,0,1
58054_0,,,,2,1,1,2
C(C1(CO)CCC(C(O1)O)=O)=O,,,5,1,1,0,1
58056_0,,,,2,1,1,2
C(C1(COC(C=O)(CC1)O)O)=O,,,5,1,1,0,1
58058_0,,,,2,1,1,2
C(C1C(CCC(C=O)(O1)O)O)=O,,,5,1,1,0,1
58060_0,,,,2,1,1,2
C(C(C1CCC(C(O)O1)=O)O)=O,,,5,1,1,0,1
58062_0,,,,2,1,1,2
C1(C(O)OCCC1)=O,,,5,1,1,0,1
58064_0,,,,2,1,1,2
C1(C(O)OC(CO)CC1)=O,,,5,1,1,0,1
58066_0,,,,2,1,1,2
C(C1(CCC(CO1)O)O)=O,,,5,1,1,0,1
58068_0,,,,2,1,1,2
C1(C(CCC(C=O)(O)O1)O)=O,,,5,1,1,0,1
58070_0,,,,2,1,1,2
C(C1CCC(C(O1)O)=O)(O)=O,,,5,1,1,0,1
58072_0,,,,2,1,1,2
C(CO)(C1CCC(C(O1)O)=O)=O,,,5,1,1,0,1
58074_0,,,,2,1,1,2
C(C1(CCC(CO)(CO1)O)O)=O,,,5,1,1,0,1
58076_0,,,,2,1,1,2
C1(C(O)OC(CO)(CO)CC1)=O,,,5,1,1,0,1
58078_0,,,,2,1,1,2
C1(C(O)OC(CC1)C(CO)O)=O,,,5,1,1,0,1
58080_0,,,,2,1,1,2
C(C1(CCC(C(CO)O1)O)O)=O,,,5,1,1,0,1
58082_0,,,,2,1,1,2
C1(C(CO)(CCC(C=O)(O)O1)O)=O,,,5,1,1,0,1
58084_0,,,,2,1,1,2
C(C1(CO)CCC(C(O1)O)=O)(O)=O,,,5,1,1,0,1
58086_0,,,,2,1,1,2
C(C1(COC(C=O)(CC1)O)O)(O)=O,,,5,1,1,0,1
58088_0,,,,2,1,1,2
C(C1C(CCC(C=O)(O1)O)O)(O)=O,,,5,1,1,0,1
58090_0,,,,2,1,1,2
C(C(C1CCC(C(O)O1)=O)O)(O)=O,,,5,1,1,0,1
58092_0,,,,2,1,1,2
C1(C(O)OC(CC1)CC(C=O)=O)=O,,,5,1,1,0,1
58094_0,,,,2,1,1,2
C(C1(CCC(C(C=O)=O)CO1)O)=O,,,5,1,1,0,1
58096_0,,,,2,1,1,2
C(CC1(C=O)CCC(C(O1)O)=O)=O,,,5,1,1,0,1
58098_0,,,,2,1,1,2
C(C1CCC(C=O)(OC1C=O)O)=O,,,5,1,1,0,1
58100_0,,,,2,1,1,2
C(C1CCC(C(O1)O)=O)(CC=O)=O,,,5,1,1,0,1
58102_0,,,,2,1,1,2
C(C)(C1(C=O)CCC(C(O1)O)=O)=O,,,5,1,1,0,1
58104_0,,,,2,1,1,2
C(C1C(C(C=O)OC(C1)O)O)=O,,,5,1,1,0,1
58106_0,,,,2,1,1,2
C(C1CC(O)OCC1(CO)O)=O,,,5,1,1,0,1
58108_0,,,,2,1,1,2
C(C1CC(O)OC(CO)C1O)=O,,,5,1,1,0,1
58110_0,,,,2,1,1,2
C(CC1C(O)OCC(C1O)O)=O,,,5,1,1,0,1
58112_0,,,,2,1,1,2
C(C1CC(O)OC(C1(CO)O)=O)=O,,,5,1,1,0,1
58114_0,,,,2,1,1,2
C(C1CC(O)OCC1(C(O)=O)O)=O,,,5,1,1,0,1
58116_0,,,,2,1,1,2
C(CC1C(O)OC(C(C1O)O)=O)=O,,,5,1,1,0,1
58118_0,,,,2,1,1,2
C(C1C(C(C(O)=O)OC(C1)O)O)=O,,,5,1,1,0,1
58120_0,,,,2,1,1,2
C(C1CC(O)OCC1C(C=O)=O)=O,,,5,1,1,0,1
58122_0,,,,2,1,1,2
C(C1C(C=O)C(C=O)CC(O1)O)=O,,,5,1,1,0,1
58124_0,,,,2,1,1,2
C(CC1C(OCC(C1C=O)=O)O)=O,,,5,1,1,0,1
58126_0,,,,2,1,1,2
C(C1C(CC(C(O1)O)CC=O)=O)=O,,,5,1,1,0,1
58128_0,,,,2,1,1,2
C1(C(C(C(O)OC(C)C1O)O)O)=O,,,5,1,1,0,1
58130_0,,,,2,1,1,2
C1(CC(C=O)OC(CC1O)O)=O,,,5,1,1,0,1
58132_0,,,,2,1,1,2
C1(C(C(C=O)OC(C(C1)O)O)O)=O,,,5,1,1,0,1
58134_0,,,,2,1,1,2
C1(CC(C=O)OC(C(C1O)O)O)=O,,,5,1,1,0,1
58136_0,,,,2,1,1,2
C(C1C(C(CC(C(O1)O)=O)O)O)=O,,,5,1,1,0,1
58138_0,,,,2,1,1,2
C(C1C(C(COC(C1O)O)O)=O)=O,,,5,1,1,0,1
58140_0,,,,2,1,1,2
C(C1C(C(C(C(O)OC1)O)O)=O)=O,,,5,1,1,0,1
58142_0,,,,2,1,1,2
C(C1COC(C(C(C1O)O)O)O)=O,,,5,1,1,0,1
58144_0,,,,2,1,1,2
C1C(CO)(CC(CC(O)O1)O)O,,,5,1,1,0,1
58146_0,,,,2,1,1,2
C1C(CO)(CC(C(C(O)O1)O)O)O,,,5,1,1,0,1
58147_0,,,,2,1,1,2
58149_0,,,,2,1,1,2
C1(COC(C(CO)C(C1O)O)O)=O,,,5,1,1,0,1
58150_0,,,,2,1,1,2
58152_0,,,,2,1,1,2
C(C1(C)CC(C(CC(O1)O)O)=O)=O,,,5,1,1,0,1
58154_0,,,,2,1,1,2
C(C1COC(C(C)(CC1O)O)O)=O,,,5,1,1,0,1
58156_0,,,,2,1,1,2
C(C1(C)CC(CC(C(O1)O)=O)O)=O,,,5,1,1,0,1
58158_0,,,,2,1,1,2
C(C1COC(CC(C)(C1O)O)O)=O,,,5,1,1,0,1
58160_0,,,,2,1,1,2
C(C1C(CCOC(C1(C)O)O)O)=O,,,5,1,1,0,1
58162_0,,,,2,1,1,2
C1(CC(C(C)=O)OC(CC1O)O)=O,,,5,1,1,0,1
58164_0,,,,2,1,1,2
C1(C(CC(C=O)(O)OC(C)C1)O)=O,,,5,1,1,0,1
58166_0,,,,2,1,1,2
C(C1C(O)OC(C)CC(C1O)=O)=O,,,5,1,1,0,1
58168_0,,,,2,1,1,2
C(C1COC(C)(C(CC1O)O)O)=O,,,5,1,1,0,1
58170_0,,,,2,1,1,2
C(C)(C1CC(CC(C(O1)O)=O)O)=O,,,5,1,1,0,1
58172_0,,,,2,1,1,2
C(C1COC(CC(C1(C)O)O)O)=O,,,5,1,1,0,1
58174_0,,,,2,1,1,2
C(C1C(C(C)(O)OCCC1O)O)=O,,,5,1,1,0,1
58176_0,,,,2,1,1,2
C1(C(CC(O)OC(CCO)C1)O)=O,,,5,1,1,0,1
58178_0,,,,2,1,1,2
C1(C(CC(O)OC(CO)(C)C1)O)=O,,,5,1,1,0,1
58180_0,,,,2,1,1,2
C1(CC(C(O)=O)OC(CC1O)O)=O,,,5,1,1,0,1
58182_0,,,,2,1,1,2
C(CC1C(CC(CC(O1)O)O)=O)=O,,,5,1,1,0,1
58184_0,,,,2,1,1,2
C(CC1CC(C(CC(O)O1)O)=O)=O,,,5,1,1,0,1
58186_0,,,,2,1,1,2
C1(C(CC(O)OC(C)C1)O)=O,,,5,1,1,0,1
58187_0,,,,2,1,1,2
58189_0,,,,2,1,1,2
C1(C(C(C(O)OC(C)C1)O)O)=O,,,5,1,1,0,1
58191_0,,,,2,1,1,2
C1(C(C(C(O)OC(CO)C1)O)O)=O,,,5,1,1,0,1
58193_0,,,,2,1,1,2
C(CC1CC(CC(C(O)O1)=O)O)=O,,,5,1,1,0,1
58195_0,,,,2,1,1,2
C(C1C(CC(C(O)OC1C)=O)O)=O,,,5,1,1,0,1
58196_0,,,,2,1,1,2
58198_0,,,,2,1,1,2
C(C1(CC(C)OC(C(C1)=O)O)O)=O,,,5,1,1,0,1
58200_0,,,,2,1,1,2
C1(C(C(C(O)OC(C)C1)CO)O)=O,,,5,1,1,0,1
58202_0,,,,2,1,1,2
C1(C(C(C(C)(O)OC(C)C1)O)O)=O,,,5,1,1,0,1
58204_0,,,,2,1,1,2
C1(C(CC(CO)(O)OC(C)C1)O)=O,,,5,1,1,0,1
58206_0,,,,2,1,1,2
C1(C(O)OCCC(C1C(C)O)O)=O,,,5,1,1,0,1
58208_0,,,,2,1,1,2
C(C1(CC(O)OCC(C1)O)O)=O,,,5,1,1,0,1
58210_0,,,,2,1,1,2
C(C1(C(C(O)OCC(C1)O)O)O)=O,,,5,1,1,0,1
58212_0,,,,2,1,1,2
C(C)(C1C(CC(CC(O1)O)O)O)=O,,,5,1,1,0,1
58214_0,,,,2,1,1,2
C(C1C(CC(CC(O1)O)O)O)=O,,,5,1,1,0,1
58216_0,,,,2,1,1,2
C(C1C(CC(O)OCC1(C)O)O)=O,,,5,1,1,0,1
58218_0,,,,2,1,1,2
C(C1C(CC(O)OC(C1O)=O)O)=O,,,5,1,1,0,1
58219_0,,,,2,1,1,2
58220_0,,,,2,1,1,2
58222_0,,,,2,1,1,2
C(C1C(CC(C(C(O1)O)O)O)O)=O,,,5,1,1,0,1
58224_0,,,,2,1,1,2
C(C1C(COC(C(C1O)O)O)O)=O,,,5,1,1,0,1
58226_0,,,,2,1,1,2
C1(COC(C(C(C1)O)C(C)O)O)=O,,,5,1,1,0,1
58228_0,,,,2,1,1,2
C(C1COC(C(C(C1O)O)=O)O)=O,,,5,1,1,0,1
58229_0,,,,2,1,1,2
58231_0,,,,2,1,1,2
C1(C(CC(C(CO)C(O)O1)O)=O)=O,,,5,1,1,0,1
58232_0,,,,2,1,1,2
58234_0,,,,2,1,1,2
C1(C(C(C(O)OCC1)C(C)O)O)=O,,,5,1,1,0,1
58235_0,,,,2,1,1,2
58237_0,,,,2,1,1,2
C1(C(CC(O)OC(C)C1CO)O)=O,,,5,1,1,0,1
58238_0,,,,2,1,1,2
58239_0,,,,2,1,1,2
58240_0,,,,2,1,1,2
58242_0,,,,2,1,1,2
C(CC1CC(C(CC(O)O1)O)O)=O,,,5,1,1,0,1
58244_0,,,,2,1,1,2
C(CC1C(CC(CC(O)O1)O)O)=O,,,5,1,1,0,1
58246_0,,,,2,1,1,2
C(C1C(C)OC(CC(C1O)O)O)=O,,,5,1,1,0,1
58248_0,,,,2,1,1,2
C(C1COC(CC(C1O)O)O)=O,,,5,1,1,0,1
58250_0,,,,2,1,1,2
C(CC1CC(CC(C(O)O1)O)O)=O,,,5,1,1,0,1
58252_0,,,,2,1,1,2
C(C1C(C)OC(C(CC1O)O)O)=O,,,5,1,1,0,1
58254_0,,,,2,1,1,2
C(C1COC(C(CC1O)O)O)=O,,,5,1,1,0,1
58255_0,,,,2,1,1,2
58256_0,,,,2,1,1,2
58257_0,,,,2,1,1,2
58258_0,,,,2,1,1,2
58259_0,,,,2,1,1,2
58260_0,,,,2,1,1,2
58261_0,,,,2,1,1,2
58262_0,,,,2,1,1,2
58264_0,,,,2,1,1,2
C(C1C(C)(CC(CC(O1)O)O)O)=O,,,5,1,1,0,1
58265_0,,,,2,1,1,2
58267_0,,,,2,1,1,2
C1(C(O)OC(C)CC(C1O)O)=O,,,5,1,1,0,1
58269_0,,,,2,1,1,2
C1(C(C)(O)OC(C)CC(C1O)O)=O,,,5,1,1,0,1
58271_0,,,,2,1,1,2
C1(C(CO)(O)OC(C)CC(C1)O)=O,,,5,1,1,0,1
58273_0,,,,2,1,1,2
C1(C(O)OC(C)CC(C1)O)=O,,,5,1,1,0,1
58275_0,,,,2,1,1,2
C1(C(O)OC(C)CC(C1CO)O)=O,,,5,1,1,0,1
58277_0,,,,2,1,1,2
C(C1C(C(O)OC(C)CC1O)O)=O,,,5,1,1,0,1
58279_0,,,,2,1,1,2
CC(C1C(O)OCC(CC1O)O)O,,,5,1,1,0,1
58281_0,,,,2,1,1,2
CC(C1C(O)OCCC(C1O)O)O,,,5,1,1,0,1
58283_0,,,,2,1,1,2
C1(C(O)OC(C)C(C(C1O)O)O)=O,,,5,1,1,0,1
58285_0,,,,2,1,1,2
C1(C(O)OC(C)C(C(C1)O)O)=O,,,5,1,1,0,1
58287_0,,,,2,1,1,2
C(C1C(CC(CC(O)O1)O)O)O,,,5,1,1,0,1
58289_0,,,,2,1,1,2
C(C1C(CC(C(C(O)O1)O)O)O)O,,,5,1,1,0,1
58290_0,,,,2,1,1,2
58292_0,,,,2,1,1,2
C1(C(O)OCCC(C1O)O)=O,,,5,1,1,0,1
58294_0,,,,2,1,1,2
C1(C(C)(O)OCCC(C1O)O)=O,,,5,1,1,0,1
58296_0,,,,2,1,1,2
C1(C(CO)(O)OCCC(C1)O)=O,,,5,1,1,0,1
58298_0,,,,2,1,1,2
C1(C(O)OCCC(C1)O)=O,,,5,1,1,0,1
58300_0,,,,2,1,1,2
C1(C(O)OCCC(C1CO)O)=O,,,5,1,1,0,1
58302_0,,,,2,1,1,2
C(C1C(C(O)OCCC1O)O)=O,,,5,1,1,0,1
58304_0,,,,2,1,1,2
C1C(CC(C(C(O)O1)CO)O)O,,,5,1,1,0,1
58306_0,,,,2,1,1,2
C1(C(C(C(O)OCC1O)CO)O)=O,,,5,1,1,0,1
58308_0,,,,2,1,1,2
C1CC(C(C(C(O)O1)CO)O)O,,,5,1,1,0,1
58310_0,,,,2,1,1,2
C1(C(CC(C(CO)C(O)O1)O)O)=O,,,5,1,1,0,1
58312_0,,,,2,1,1,2
C1(CC(C(C(CO)C(O)O1)O)O)=O,,,5,1,1,0,1
58314_0,,,,2,1,1,2
C(C1(C(C(CC(CO1)O)O)O)O)=O,,,5,1,1,0,1
58316_0,,,,2,1,1,2
C1(C(O)OC(CO)CC(C1O)O)=O,,,5,1,1,0,1
58318_0,,,,2,1,1,2
CC1(C(C(CC(CO1)O)O)O)O,,,5,1,1,0,1
58320_0,,,,2,1,1,2
C1C(CC(CC(CO)(O)O1)O)O,,,5,1,1,0,1
58322_0,,,,2,1,1,2
C(C1(CC(CC(CO1)O)O)O)(O)=O,,,5,1,1,0,1
58324_0,,,,2,1,1,2
C(C1C(O)OCC(CC1O)O)(O)=O,,,5,1,1,0,1
58326_0,,,,2,1,1,2
C1C(CC(C(C(CO)(O)O1)O)O)O,,,5,1,1,0,1
58328_0,,,,2,1,1,2
C(C1(CC(CC(CO1)O)O)O)=O,,,5,1,1,0,1
58329_0,,,,2,1,1,2
58331_0,,,,2,1,1,2
C(C1C(O)OCC(CC1O)O)=O,,,5,1,1,0,1
58333_0,,,,2,1,1,2
C1C(CC(CC(O)O1)O)O,,,5,1,1,0,1
58335_0,,,,2,1,1,2
C1C(CC(C(C(O)O1)O)O)O,,,5,1,1,0,1
58337_0,,,,2,1,1,2
C1(C(COC(C(CO)(C1)O)O)=O)=O,,,5,1,1,0,1
58339_0,,,,2,1,1,2
C1(C(COC(C(CO)(C1)O)O)O)=O,,,5,1,1,0,1
58341_0,,,,2,1,1,2
C1(C2C(C(O)OC(C1)O2)(CO)O)=O,,,5,1,1,0,1
58343_0,,,,2,1,1,2
C(C1(COC(CC(C1O)=O)O)O)=O,,,5,1,1,0,1
58345_0,,,,2,1,1,2
C(C1(COC(C(C(C1)=O)O)O)O)=O,,,5,1,1,0,1
58347_0,,,,2,1,1,2
C1(COC(C(C(C1O)O)=O)O)=O,,,5,1,1,0,1
58349_0,,,,2,1,1,2
C1(C(C(C(C(C)(OC1)O)=O)O)O)=O,,,5,1,1,0,1
58351_0,,,,2,1,1,2
C1(C(COC(CO)(C(C1)O)O)=O)=O,,,5,1,1,0,1
58353_0,,,,2,1,1,2
C1(CC(C(COC1(CO)O)=O)O)=O,,,5,1,1,0,1
58355_0,,,,2,1,1,2
C1(C(COC(C(C1)O)(CO)O)O)=O,,,5,1,1,0,1
58357_0,,,,2,1,1,2
C1(C2C(C(CO)(O)OC(C1)O2)O)=O,,,5,1,1,0,1
58359_0,,,,2,1,1,2
C1(COC(C(CC1O)=O)O)=O,,,5,1,1,0,1
58361_0,,,,2,1,1,2
C1(C(OCC(C(C1CO)O)=O)O)=O,,,5,1,1,0,1
58363_0,,,,2,1,1,2
C(C1C(C(OCC(C1O)=O)O)O)=O,,,5,1,1,0,1
58365_0,,,,2,1,1,2
C1(COC(C(C(C1(C)O)O)=O)O)=O,,,5,1,1,0,1
58367_0,,,,2,1,1,2
C1(C(C(C(C(C)OC1O)=O)O)O)=O,,,5,1,1,0,1
58369_0,,,,2,1,1,2
C1(C(O)OCCC(CO)(C1O)O)=O,,,5,1,1,0,1
58371_0,,,,2,1,1,2
C(C1(C(C(C(CCO1)O)O)O)O)=O,,,5,1,1,0,1
58373_0,,,,2,1,1,2
C1(C(O)OCC(C(C)(C1O)O)O)=O,,,5,1,1,0,1
58375_0,,,,2,1,1,2
C1(CC(C(C(C(O)O1)=O)O)O)=O,,,5,1,1,0,1
58377_0,,,,2,1,1,2
C1(C(O)OC2CC(CO2)(C1O)O)=O,,,5,1,1,0,1
58379_0,,,,2,1,1,2
C(C1(CCOC(C(C1O)=O)O)O)=O,,,5,1,1,0,1
58381_0,,,,2,1,1,2
C1(C(C(C(C=O)(O)OCC1)O)O)=O,,,5,1,1,0,1
58383_0,,,,2,1,1,2
C(C1CC(C(C(C(O1)O)=O)O)O)=O,,,5,1,1,0,1
58385_0,,,,2,1,1,2
C(C1(C(C(CC(CO1)=O)O)O)O)=O,,,5,1,1,0,1
58387_0,,,,2,1,1,2
C(C1(C(COC(C(C1)=O)O)O)O)=O,,,5,1,1,0,1
58388_0,,,,2,1,1,2
58390_0,,,,2,1,1,2
C1(C(OC(C(C(C1)O)=O)CO)O)=O,,,5,1,1,0,1
58392_0,,,,2,1,1,2
C1(C(COC(C=O)(CC1O)O)O)=O,,,5,1,1,0,1
58394_0,,,,2,1,1,2
C(C1C(O)OCC(C(C1O)=O)O)=O,,,5,1,1,0,1
58395_0,,,,2,1,1,2
58396_0,,,,2,1,1,2
58398_0,,,,2,1,1,2
C1(COC(C(CC1(C)O)=O)O)=O,,,5,1,1,0,1
58400_0,,,,2,1,1,2
C1(CC(C(C(C(C)(O)O1)=O)O)O)=O,,,5,1,1,0,1
58402_0,,,,2,1,1,2
C1(C(C)(O)OCC(C(C1O)O)O)=O,,,5,1,1,0,1
58404_0,,,,2,1,1,2
C1(CC(CC(C(CO)(O)O1)=O)O)=O,,,5,1,1,0,1
58406_0,,,,2,1,1,2
C(C1(C(OCC(C(C1)=O)=O)O)O)=C,,,5,1,1,0,1
58408_0,,,,2,1,1,2
C(C1(C(CC(C(CO1)=O)=O)O)O)=C,,,5,1,1,0,1
58409_0,,,,2,1,1,2
58411_0,,,,2,1,1,2
C1(C(COC(C(C1)O)O)=O)=O,,,5,1,1,0,1
58413_0,,,,2,1,1,2
C1(C(COC(C(C)(C1)O)O)=O)=O,,,5,1,1,0,1
58414_0,,,,2,1,1,2
58416_0,,,,2,1,1,2
C1(C(OC(C(C(C1)O)=O)C)O)=O,,,5,1,1,0,1
58418_0,,,,2,1,1,2
C1(C(C(COC(C1)O)(C)O)O)=O,,,5,1,1,0,1
58420_0,,,,2,1,1,2
C1(C(C(O)OCC(C)(C1)O)O)=O,,,5,1,1,0,1
58422_0,,,,2,1,1,2
CC1(C(C(C(CCO1)O)O)O)O,,,5,1,1,0,1
58424_0,,,,2,1,1,2
C1(C(CC(C(C(C)(O)O1)O)O)O)=O,,,5,1,1,0,1
58426_0,,,,2,1,1,2
C1(CC(C(C(C(C)(O)O1)O)O)O)=O,,,5,1,1,0,1
58428_0,,,,2,1,1,2
CC1(C(C(C(C(CO1)O)O)O)O)O,,,5,1,1,0,1
58430_0,,,,2,1,1,2
C1(C(C(C(C)(O)OCC1)O)O)=O,,,5,1,1,0,1
58432_0,,,,2,1,1,2
C1(COC(C)(C(C(C1)O)O)O)=O,,,5,1,1,0,1
58434_0,,,,2,1,1,2
C1CC(C(CC(CO)(O)O1)O)O,,,5,1,1,0,1
58436_0,,,,2,1,1,2
C1(C(CC(CC(CO)(O)O1)O)O)=O,,,5,1,1,0,1
58438_0,,,,2,1,1,2
C1(CC(C(CC(CO)(O)O1)O)O)=O,,,5,1,1,0,1
58439_0,,,,2,1,1,2
58440_0,,,,2,1,1,2
58441_0,,,,2,1,1,2
58443_0,,,,2,1,1,2
C1(COC(CC(CO)(C1)O)O)=O,,,5,1,1,0,1
58445_0,,,,2,1,1,2
C1(COC(C(C(C)(C1)O)O)O)=O,,,5,1,1,0,1
58446_0,,,,2,1,1,2
58448_0,,,,2,1,1,2
C1(C(C(C=C)(C(O)OCC1)O)O)=O,,,5,1,1,0,1
58450_0,,,,2,1,1,2
C1(C(C(C(C=C)(O)OCC1)O)O)=O,,,5,1,1,0,1
58452_0,,,,2,1,1,2
C1(C(C(C(O)OCC1)(C)O)O)=O,,,5,1,1,0,1
58454_0,,,,2,1,1,2
C(C1(CC(C(CCO1)O)O)O)(O)=O,,,5,1,1,0,1
58456_0,,,,2,1,1,2
C(C1C(O)OCCC(C1O)O)(O)=O,,,5,1,1,0,1
58458_0,,,,2,1,1,2
C1CC(C(C(C(CO)(O)O1)O)O)O,,,5,1,1,0,1
58460_0,,,,2,1,1,2
C(C1(CC(C(CCO1)O)O)O)=O,,,5,1,1,0,1
58462_0,,,,2,1,1,2
C(C1C(O)OCCC(C1O)O)=O,,,5,1,1,0,1
58464_0,,,,2,1,1,2
C1CC(C(CC(O)O1)O)O,,,5,1,1,0,1
58466_0,,,,2,1,1,2
C1CC(C(C(C(O)O1)O)O)O,,,5,1,1,0,1
58468_0,,,,2,1,1,2
C1(C(O)OCC(C(C)(C1)O)O)=O,,,5,1,1,0,1
58470_0,,,,2,1,1,2
C1(CC(C=C)(C(O)OCC1O)O)=O,,,5,1,1,0,1
58472_0,,,,2,1,1,2
C1(C(COC(C=C)(C(C1)O)O)O)=O,,,5,1,1,0,1
58474_0,,,,2,1,1,2
C1(C(COC(C(C)(C1)O)O)O)=O,,,5,1,1,0,1
58476_0,,,,2,1,1,2
C1(C(COC(C(C1)O)(C)O)O)=O,,,5,1,1,0,1
58478_0,,,,2,1,1,2
C1(C(C(C(OC(C1)O)=O)O)O)=O,,,5,1,1,0,1
58480_0,,,,2,1,1,2
C1(CC(C(OC(C1O)O)=O)O)=O,,,5,1,1,0,1
58482_0,,,,2,1,1,2
C1(C(C)(C(C(CC(O)O1)=O)O)O)=O,,,5,1,1,0,1
58484_0,,,,2,1,1,2
C1(C(C)(CC(C(C(O)O1)O)=O)O)=O,,,5,1,1,0,1
58485_0,,,,2,1,1,2
58486_0,,,,2,1,1,2
58487_0,,,,2,1,1,2
58489_0,,,,2,1,1,2
C1(C(CC(CC(CO)(O)O1)O)=O)=O,,,5,1,1,0,1
58491_0,,,,2,1,1,2
C1(C(CC(CO)(CC(O)O1)O)=O)=O,,,5,1,1,0,1
58493_0,,,,2,1,1,2
C1(C(CC(C(C(C)(O)O1)O)O)=O)=O,,,5,1,1,0,1
58495_0,,,,2,1,1,2
C1(C(CC(C)(C(C(O)O1)O)O)=O)=O,,,5,1,1,0,1
58497_0,,,,2,1,1,2
C1(CC(CC(C(O)O1)=O)O)=O,,,5,1,1,0,1
58499_0,,,,2,1,1,2
C1(CC(C(C(C(O)O1)=O)CO)O)=O,,,5,1,1,0,1
58501_0,,,,2,1,1,2
C(C1C(CC(OC(C1O)O)=O)O)=O,,,5,1,1,0,1
58502_0,,,,2,1,1,2
58504_0,,,,2,1,1,2
C1(C(C=O)C(C(CC(O)O1)O)O)=O,,,5,1,1,0,1
58506_0,,,,2,1,1,2
C1(C(C=O)C(CC(C(O)O1)O)O)=O,,,5,1,1,0,1
58507_0,,,,2,1,1,2
58508_0,,,,2,1,1,2
58510_0,,,,2,1,1,2
C1(C(C(CO)C(CC(O)O1)O)=O)=O,,,5,1,1,0,1
58512_0,,,,2,1,1,2
C1(C(CC(CC(C=O)(O)O1)O)O)=O,,,5,1,1,0,1
58513_0,,,,2,1,1,2
58515_0,,,,2,1,1,2
C(C1C(O)OC(C(CC1O)O)=O)=O,,,5,1,1,0,1
58517_0,,,,2,1,1,2
C1(C(CC(CC(O)O1)O)O)=O,,,5,1,1,0,1
58519_0,,,,2,1,1,2
C1(C(CC(C(C(O)O1)O)O)O)=O,,,5,1,1,0,1
58521_0,,,,2,1,1,2
C1(CC(C(CC(C=O)(O)O1)O)O)=O,,,5,1,1,0,1
58523_0,,,,2,1,1,2
C(C1C(O)OC(CC(C1O)O)=O)=O,,,5,1,1,0,1
58525_0,,,,2,1,1,2
C1(CC(C(CC(O)O1)O)O)=O,,,5,1,1,0,1
58527_0,,,,2,1,1,2
C1(CC(C(C(C(O)O1)O)O)O)=O,,,5,1,1,0,1
58529_0,,,,2,1,1,2
C1(CC(CO)(CC(C(O)O1)=O)O)=O,,,5,1,1,0,1
58530_0,,,,2,1,1,2
58532_0,,,,2,1,1,2
C1(CC(C(C(C(O)O1)O)O)=O)=O,,,5,1,1,0,1
58534_0,,,,2,1,1,2
C1(CC(C(C(C)(C(O)O1)O)O)=O)=O,,,5,1,1,0,1
58536_0,,,,2,1,1,2
C1(CC(C(C(C(C)(O)O1)O)O)=O)=O,,,5,1,1,0,1
58538_0,,,,2,1,1,2
C1(C(C(C)(CC(C(O)O1)=O)O)O)=O,,,5,1,1,0,1
58540_0,,,,2,1,1,2
C1(C(C(CC(C(O)O1)O)=O)O)=O,,,5,1,1,0,1
58542_0,,,,2,1,1,2
C1(C(C(CC(C)(C(O)O1)O)=O)O)=O,,,5,1,1,0,1
58544_0,,,,2,1,1,2
C1(C(C(CC(C(C)(O)O1)O)=O)O)=O,,,5,1,1,0,1
58545_0,,,,2,1,1,2
58547_0,,,,2,1,1,2
C(C1(C(CCOC(C1O)O)=O)O)=O,,,5,1,1,0,1
58549_0,,,,2,1,1,2
C(C1(C(CC(C(O)OC1)O)=O)O)=O,,,5,1,1,0,1
58550_0,,,,2,1,1,2
58552_0,,,,2,1,1,2
C1(C(C(C(C(C(O)O1)O)O)O)O)=O,,,5,1,1,0,1
58554_0,,,,2,1,1,2
C1(C(C(C)(C(CC(O)O1)O)O)O)=O,,,5,1,1,0,1
58556_0,,,,2,1,1,2
C1(C(C(C(C)(CC(O)O1)O)O)O)=O,,,5,1,1,0,1
58558_0,,,,2,1,1,2
C(C1C(CC(CC(O1)O)O)O)(O)=O,,,5,1,1,0,1
58560_0,,,,2,1,1,2
C(C1(C(C)OC(CC(C1)O)O)O)=O,,,5,1,1,0,1
58562_0,,,,2,1,1,2
C(C1(COC(CC(C1)O)O)O)=O,,,5,1,1,0,1
58564_0,,,,2,1,1,2
C(C1(COC(C(C(C1)O)O)O)O)=O,,,5,1,1,0,1
58566_0,,,,2,1,1,2
C1(C(C(C)OC(C(C1)O)O)O)=O,,,5,1,1,0,1
58568_0,,,,2,1,1,2
C1(C(C(CO)OC(C(C1)O)O)O)=O,,,5,1,1,0,1
58569_0,,,,2,1,1,2
58571_0,,,,2,1,1,2
C(C1(CC(O)OCC(C1)O)O)(O)=O,,,5,1,1,0,1
58573_0,,,,2,1,1,2
C1(C(CC(CO)(CC(O)O1)O)O)=O,,,5,1,1,0,1
58575_0,,,,2,1,1,2
C1(C2C(CC(OC1CO2)O)O)=O,,,5,1,1,0,1
58577_0,,,,2,1,1,2
C1(C2OC(CC(C1CO2)O)O)=O,,,5,1,1,0,1
58579_0,,,,2,1,1,2
C1(C(O)OC2CC(CO2)(C1)O)=O,,,5,1,1,0,1
58581_0,,,,2,1,1,2
C1(C2C(C=C)(C(O)OC(C1)O2)O)=O,,,5,1,1,0,1
58583_0,,,,2,1,1,2
C1(C2C(C(C=C)(O)OC(C1)O2)O)=O,,,5,1,1,0,1
58585_0,,,,2,1,1,2
C1(C2C(C(O)OC(C1)O2)O)=O,,,5,1,1,0,1
58587_0,,,,2,1,1,2
C1(C2C(C(O)OC(C1)O2)(C)O)=O,,,5,1,1,0,1
58589_0,,,,2,1,1,2
C1(C2C(C(C)(O)OC(C1)O2)O)=O,,,5,1,1,0,1
58591_0,,,,2,1,1,2
C(C1CC(C(CC(O1)O)O)O)(O)=O,,,5,1,1,0,1
58593_0,,,,2,1,1,2
C(C1CC(CC(C(O1)O)O)O)(O)=O,,,5,1,1,0,1
58595_0,,,,2,1,1,2
C1(C(CC(C)(C(C(O)O1)O)O)O)=O,,,5,1,1,0,1
58597_0,,,,2,1,1,2
C1(C(C(CO)C(CC(O)O1)O)O)=O,,,5,1,1,0,1
58598_0,,,,2,1,1,2
58599_0,,,,2,1,1,2
58600_0,,,,2,1,1,2
58601_0,,,,2,1,1,2
58602_0,,,,2,1,1,2
58603_0,,,,2,1,1,2
58604_0,,,,2,1,1,2
58605_0,,,,2,1,1,2
58607_0,,,,2,1,1,2
C1(CC(OCC(C1O)=O)O)=O,,,5,1,1,0,1
58609_0,,,,2,1,1,2
C1(C(C(OCC(C1)=O)O)O)=O,,,5,1,1,0,1
58610_0,,,,2,1,1,2
58611_0,,,,2,1,1,2
58612_0,,,,2,1,1,2
58613_0,,,,2,1,1,2
58615_0,,,,2,1,1,2
C1(C(CO)OC(C(CC1O)O)O)=O,,,5,1,1,0,1
58616_0,,,,2,1,1,2
58618_0,,,,2,1,1,2
C(C1C(C(CC(C(O1)O)O)O)O)=O,,,5,1,1,0,1
58619_0,,,,2,1,1,2
58620_0,,,,2,1,1,2
58621_0,,,,2,1,1,2
58622_0,,,,2,1,1,2
58623_0,,,,2,1,1,2
58625_0,,,,2,1,1,2
C1(CC(OC(C(C1O)=O)C)O)=O,,,5,1,1,0,1
58627_0,,,,2,1,1,2
C1(C(C(OC(C(C1)=O)C)O)O)=O,,,5,1,1,0,1
58628_0,,,,2,1,1,2
58629_0,,,,2,1,1,2
58630_0,,,,2,1,1,2
58631_0,,,,2,1,1,2
58632_0,,,,2,1,1,2
58633_0,,,,2,1,1,2
58635_0,,,,2,1,1,2
C(C1(C(CC(C(CO1)O)O)O)O)=O,,,5,1,1,0,1
58636_0,,,,2,1,1,2
58637_0,,,,2,1,1,2
58639_0,,,,2,1,1,2
C1CC(CC(C(O)O1)O)O,,,5,1,1,0,1
58641_0,,,,2,1,1,2
C1C(C(CC(C(O)O1)O)O)O,,,5,1,1,0,1
58642_0,,,,2,1,1,2
58644_0,,,,2,1,1,2
C1CC(C(C(C(O)O1)(CO)O)O)O,,,5,1,1,0,1
58645_0,,,,2,1,1,2
58647_0,,,,2,1,1,2
C1C(CC(C(C(O)O1)(CO)O)O)O,,,5,1,1,0,1
58649_0,,,,2,1,1,2
C(C1(CCOC(CC1O)O)O)=O,,,5,1,1,0,1
58651_0,,,,2,1,1,2
C(C1(CC(O)OCCC1O)O)=O,,,5,1,1,0,1
58653_0,,,,2,1,1,2
C1(CC(CC(C(O)O1)O)O)=O,,,5,1,1,0,1
58655_0,,,,2,1,1,2
C(C1(C(CC(O)OC(C1)=O)O)O)=O,,,5,1,1,0,1
58657_0,,,,2,1,1,2
C(C1(C(CC(OC(C1)O)=O)O)O)=O,,,5,1,1,0,1
58659_0,,,,2,1,1,2
C(C1(C(C(O)OCCC1O)O)O)=O,,,5,1,1,0,1
58660_0,,,,2,1,1,2
58661_0,,,,2,1,1,2
58663_0,,,,2,1,1,2
C1(C(O)OCCC(C1(CO)O)O)=O,,,5,1,1,0,1
58665_0,,,,2,1,1,2
C(C1C(C(O)OCCC1O)O)(O)=O,,,5,1,1,0,1
58666_0,,,,2,1,1,2
58668_0,,,,2,1,1,2
C1(C(C(CC(C)(C(O)O1)O)O)O)=O,,,5,1,1,0,1
58670_0,,,,2,1,1,2
C(C)(C1(CC(O)OCCC1O)O)=O,,,5,1,1,0,1
58672_0,,,,2,1,1,2
C1(C(C(CC(C(C)(O)O1)O)O)O)=O,,,5,1,1,0,1
58673_0,,,,2,1,1,2
58674_0,,,,2,1,1,2
58676_0,,,,2,1,1,2
C1(C(O)OC(C)CC(C1(C)O)O)=O,,,5,1,1,0,1
58678_0,,,,2,1,1,2
C(C1(CC(O)OC(C)CC1O)O)=O,,,5,1,1,0,1
58680_0,,,,2,1,1,2
C1(C(O)OCCC(C1(C)O)O)=O,,,5,1,1,0,1
58682_0,,,,2,1,1,2
C(C1(CC(O)OCCC1O)O)(O)=O,,,5,1,1,0,1
58684_0,,,,2,1,1,2
C1(C(C)(C(C(CC(O)O1)O)O)O)=O,,,5,1,1,0,1
58686_0,,,,2,1,1,2
C1(C(C)(C(CC(C(O)O1)O)O)O)=O,,,5,1,1,0,1
58688_0,,,,2,1,1,2
C(C1(CCOC(CC1O)O)O)(O)=O,,,5,1,1,0,1
58690_0,,,,2,1,1,2
C1(C(OCC(C(C1(C)O)O)=O)O)=O,,,5,1,1,0,1
58692_0,,,,2,1,1,2
C(C1(CC(OCC(C1O)=O)O)O)=O,,,5,1,1,0,1
58694_0,,,,2,1,1,2
C1(CC(C(C(C(O)O1)=O)(C)O)O)=O,,,5,1,1,0,1
58696_0,,,,2,1,1,2
C1(C(O)OCC(C(C1(C)O)O)O)=O,,,5,1,1,0,1
58698_0,,,,2,1,1,2
C(C1(C(C(OCC(C1)=O)O)O)O)=O,,,5,1,1,0,1
58699_0,,,,2,1,1,2
58700_0,,,,2,1,1,2
58701_0,,,,2,1,1,2
58702_0,,,,2,1,1,2
58703_0,,,,2,1,1,2
58704_0,,,,2,1,1,2
58705_0,,,,2,1,1,2
58706_0,,,,2,1,1,2
58707_0,,,,2,1,1,2
58708_0,,,,2,1,1,2
58709_0,,,,2,1,1,2
58710_0,,,,2,1,1,2
58711_0,,,,2,1,1,2
58712_0,,,,2,1,1,2
58713_0,,,,2,1,1,2
58714_0,,,,2,1,1,2
58715_0,,,,2,1,1,2
58716_0,,,,2,1,1,2
58717_0,,,,2,1,1,2
58718_0,,,,2,1,1,2
58719_0,,,,2,1,1,2
58720_0,,,,2,1,1,2
58721_0,,,,2,1,1,2
58722_0,,,,2,1,1,2
58723_0,,,,2,1,1,2
58724_0,,,,2,1,1,2
58725_0,,,,2,1,1,2
58726_0,,,,2,1,1,2
58727_0,,,,2,1,1,2
58728_0,,,,2,1,1,2
58729_0,,,,2,1,1,2
58730_0,,,,2,1,1,2
58731_0,,,,2,1,1,2
58732_0,,,,2,1,1,2
58733_0,,,,2,1,1,2
58734_0,,,,2,1,1,2
58735_0,,,,2,1,1,2
58736_0,,,,2,1,1,2
58737_0,,,,2,1,1,2
58738_0,,,,2,1,1,2
58739_0,,,,2,1,1,2
58740_0,,,,2,1,1,2
58741_0,,,,2,1,1,2
58742_0,,,,2,1,1,2
58743_0,,,,2,1,1,2
58744_0,,,,2,1,1,2
58745_0,,,,2,1,1,2
58746_0,,,,2,1,1,2
58747_0,,,,2,1,1,2
58748_0,,,,2,1,1,2
58749_0,,,,2,1,1,2
58750_0,,,,2,1,1,2
58751_0,,,,2,1,1,2
58752_0,,,,2,1,1,2
58753_0,,,,2,1,1,2
58754_0,,,,2,1,1,2
58755_0,,,,2,1,1,2
58756_0,,,,2,1,1,2
58757_0,,,,2,1,1,2
58758_0,,,,2,1,1,2
58759_0,,,,2,1,1,2
58761_0,,,,2,1,1,2
C12C(C(C(CC(O)O1)O2)O)O,,,5,1,1,0,1
58762_0,,,,2,1,1,2
58763_0,,,,2,1,1,2
58764_0,,,,2,1,1,2
58765_0,,,,2,1,1,2
58766_0,,,,2,1,1,2
58768_0,,,,2,1,1,2
C1(CC2C(C(C(CO)(O2)O1)O)O)O,,,5,1,1,0,1
58770_0,,,,2,1,1,2
C12CC(C(C(C(CO)(O)O1)O)O2)O,,,5,1,1,0,1
58772_0,,,,2,1,1,2
C12C(CC(C(C(CO)(O)O1)O)O2)O,,,5,1,1,0,1
58773_0,,,,2,1,1,2
58774_0,,,,2,1,1,2
58775_0,,,,2,1,1,2
58776_0,,,,2,1,1,2
58777_0,,,,2,1,1,2
58778_0,,,,2,1,1,2
58779_0,,,,2,1,1,2
58781_0,,,,2,1,1,2
C1(C2OC(CC(C1)O2)O)=O,,,5,1,1,0,1
58782_0,,,,2,1,1,2
58784_0,,,,2,1,1,2
C(C12CC(C(CC(O1)O)O2)O)=O,,,5,1,1,0,1
58786_0,,,,2,1,1,2
C(C1(CC2C(CC(O1)O2)O)O)=O,,,5,1,1,0,1
58787_0,,,,2,1,1,2
58789_0,,,,2,1,1,2
C(C1(CC2CC(C(O1)O2)O)O)=O,,,5,1,1,0,1
58790_0,,,,2,1,1,2
58792_0,,,,2,1,1,2
C1(C2OC(CO)(CC(C1)O2)O)=O,,,5,1,1,0,1
58794_0,,,,2,1,1,2
C1(C2OC(CO)(CC(O2)O)C1)=O,,,5,1,1,0,1
58796_0,,,,2,1,1,2
C1(C2OC(C)(C(C(C1)O2)O)O)=O,,,5,1,1,0,1
58798_0,,,,2,1,1,2
C1(C2OC(C)(C(C(O2)O)O)C1)=O,,,5,1,1,0,1
58799_0,,,,2,1,1,2
58800_0,,,,2,1,1,2
58801_0,,,,2,1,1,2
58803_0,,,,2,1,1,2
C1(C2OC(CC(C1CO)O2)O)=O,,,5,1,1,0,1
58805_0,,,,2,1,1,2
C(C1C2CC(O)OC(C1O)O2)=O,,,5,1,1,0,1
58807_0,,,,2,1,1,2
C(C1C2OC(CC(C1O)O2)O)=O,,,5,1,1,0,1
58809_0,,,,2,1,1,2
C(C1C(O)OC2CC(C1O2)O)=O,,,5,1,1,0,1
58811_0,,,,2,1,1,2
C(C1C(O)OC2C(CC1O2)O)=O,,,5,1,1,0,1
58812_0,,,,2,1,1,2
58813_0,,,,2,1,1,2
58815_0,,,,2,1,1,2
C12CC(C(CC(O)O1)O2)O,,,5,1,1,0,1
58817_0,,,,2,1,1,2
C12CC(C(C(C(O)O1)O)O2)O,,,5,1,1,0,1
58819_0,,,,2,1,1,2
C12C(CC(CC(O)O1)O2)O,,,5,1,1,0,1
58821_0,,,,2,1,1,2
C12C(CC(C(C(O)O1)O)O2)O,,,5,1,1,0,1
58822_0,,,,2,1,1,2
58823_0,,,,2,1,1,2
58824_0,,,,2,1,1,2
58825_0,,,,2,1,1,2
58827_0,,,,2,1,1,2
C12CC(C(C(C(O)O1)(CO)O)O2)O,,,5,1,1,0,1
58828_0,,,,2,1,1,2
58830_0,,,,2,1,1,2
C12C(CO)(C(C(CC(O)O1)O2)O)O,,,5,1,1,0,1
58832_0,,,,2,1,1,2
C12C(CC(C(C(O)O1)(CO)O)O2)O,,,5,1,1,0,1
58833_0,,,,2,1,1,2
58835_0,,,,2,1,1,2
C(C12CC(O)OC(CC1O)O2)=O,,,5,1,1,0,1
58837_0,,,,2,1,1,2
C(C1(CC2OC1CC(O)O2)O)=O,,,5,1,1,0,1
58838_0,,,,2,1,1,2
58839_0,,,,2,1,1,2
58840_0,,,,2,1,1,2
58842_0,,,,2,1,1,2
C1(C2OC(CC(CO2)(C1)O)O)=O,,,5,1,1,0,1
58843_0,,,,2,1,1,2
58845_0,,,,2,1,1,2
C1(C(O)OC2CC(C1CO2)O)=O,,,5,1,1,0,1
58846_0,,,,2,1,1,2
58847_0,,,,2,1,1,2
58848_0,,,,2,1,1,2
58849_0,,,,2,1,1,2
58850_0,,,,2,1,1,2
58851_0,,,,2,1,1,2
58853_0,,,,2,1,1,2
C1C2(CC(C(C(CO2)(O)O1)O)O)O,,,5,1,2,0,2
58854_0,,,,2,1,1,2
58856_0,,,,2,1,1,2
C1C2C(C(CC(C(O)O2)(O)O1)O)O,,,5,1,2,0,2
58857_0,,,,2,1,1,2
58859_0,,,,2,1,1,2
C1C2(C(O)OC(CC(C2O)O)O1)O,,,5,1,1,0,1
58861_0,,,,2,1,1,2
C12C(CC(C(CO1)(C(O)O2)O)O)O,,,5,1,1,0,1
58863_0,,,,2,1,1,2
C(C1(C=O)COC(C(CC1)=O)O)=O,,,5,1,1,0,1
58865_0,,,,2,1,1,2
C(C1CCC(C(O)OC1C)=O)=O,,,5,1,1,0,1
58867_0,,,,2,1,1,2
C(CC1CCCC(C(O)O1)=O)=O,,,5,1,1,0,1
58869_0,,,,2,1,1,2
C(C1(CCC(C(O)OC1C)=O)O)=O,,,5,1,1,0,1
58871_0,,,,2,1,1,2
C(C1C(CCC(C(O1)O)=O)(C)O)=O,,,5,1,1,0,1
58873_0,,,,2,1,1,2
C(C1C(CCCC(C=O)(O1)O)O)=O,,,5,1,1,0,1
58875_0,,,,2,1,1,2
C(C(C1CCCC(C(O)O1)=O)O)=O,,,5,1,1,0,1
58877_0,,,,2,1,1,2
C(C1CC(C(C=O)OC(C1)O)O)=O,,,5,1,1,0,1
58879_0,,,,2,1,1,2
C(C1COC(C(CC1)=O)O)=O,,,5,1,1,0,1
58881_0,,,,2,1,1,2
C(CC1C(CCC(C(O)O1)=O)O)=O,,,5,1,1,0,1
58883_0,,,,2,1,1,2
C(CC1(COC(C(CC1)=O)O)O)=O,,,5,1,1,0,1
58885_0,,,,2,1,1,2
C(C1C(COC(C=O)(CC1)O)O)=O,,,5,1,1,0,1
58887_0,,,,2,1,1,2
C(C1CCC(C(O)OC1CO)=O)=O,,,5,1,1,0,1
58889_0,,,,2,1,1,2
C(C1C(COC(CC1C=O)O)O)=O,,,5,1,1,0,1
58891_0,,,,2,1,1,2
C1(C(C)(CCC(C(O)O1)=O)O)=O,,,5,1,1,0,1
58893_0,,,,2,1,1,2
C1(C(CCCC(C=O)(O)O1)O)=O,,,5,1,1,0,1
58895_0,,,,2,1,1,2
C(C1CCCC(C(O1)O)=O)(O)=O,,,5,1,1,0,1
58897_0,,,,2,1,1,2
C(C1CC(C(OC(C1)O)=O)O)=O,,,5,1,1,0,1
58899_0,,,,2,1,1,2
C(CC1C(OCC(C(C1)=O)=O)O)=O,,,5,1,1,0,1
58901_0,,,,2,1,1,2
C1(C(OC(C(C=O)=O)CCC1)O)=O,,,5,1,1,0,1
58903_0,,,,2,1,1,2
C(C1(CCCC(CO1)=O)O)=O,,,5,1,1,0,1
58905_0,,,,2,1,1,2
C(C1CC(OCC(C1)=O)O)=O,,,5,1,1,0,1
58907_0,,,,2,1,1,2
C(CC1C(O)OCCC(C1O)=O)=O,,,5,1,1,0,1
58909_0,,,,2,1,1,2
C(CC1C(CC(COC1O)=O)O)=O,,,5,1,1,0,1
58911_0,,,,2,1,1,2
C(C1(CCC(C(CO1)=O)CO)O)=O,,,5,1,1,0,1
58913_0,,,,2,1,1,2
C(CO)(C1COC(C(CC1)=O)O)=O,,,5,1,1,0,1
58915_0,,,,2,1,1,2
C(C1CC(OCC(C1CO)=O)O)=O,,,5,1,1,0,1
58917_0,,,,2,1,1,2
C(C1(CCOC(C=O)(CC1)O)O)=O,,,5,1,1,0,1
58919_0,,,,2,1,1,2
C(C1CC(O)OCCC1(C=O)O)=O,,,5,1,1,0,1
58921_0,,,,2,1,1,2
C(C1CC(CCC(C=O)(O1)O)O)=O,,,5,1,1,0,1
58923_0,,,,2,1,1,2
C(C1C(CC(C=O)OC(C1)O)O)=O,,,5,1,1,0,1
58925_0,,,,2,1,1,2
C(C(C1CCC(C(O)OC1)=O)O)=O,,,5,1,1,0,1
58927_0,,,,2,1,1,2
C(C1C(CCC(C(O1)O)=O)CO)=O,,,5,1,1,0,1
58929_0,,,,2,1,1,2
C(C)(C1(COC(C(CC1)=O)O)O)=O,,,5,1,1,0,1
58931_0,,,,2,1,1,2
C(C)(C1C(CCC(C(O1)O)=O)O)=O,,,5,1,1,0,1
58933_0,,,,2,1,1,2
C1(C(CO)OC(C=O)(CCC1)O)=O,,,5,1,1,0,1
58935_0,,,,2,1,1,2
C(CC1C(O)OCC(C(C1)=O)O)=O,,,5,1,1,0,1
58937_0,,,,2,1,1,2
C(C1CC(OC(C(C1)=O)CO)O)=O,,,5,1,1,0,1
58939_0,,,,2,1,1,2
C1(C(O)OCCCC1)=O,,,5,1,1,0,1
58941_0,,,,2,1,1,2
C(C1(CCCC(C(O1)=O)=O)O)=O,,,5,1,1,0,1
58943_0,,,,2,1,1,2
C(C1CC(O)OC(C(C1)=O)=O)=O,,,5,1,1,0,1
58945_0,,,,2,1,1,2
C1(C(C=O)CCC(C(O)O1)=O)=O,,,5,1,1,0,1
58947_0,,,,2,1,1,2
C1(CCCC(C(O)O1)=O)=O,,,5,1,1,0,1
58949_0,,,,2,1,1,2
C1(C2CCC(C=O)(OC1CO2)O)=O,,,5,1,1,0,1
58951_0,,,,2,1,1,2
C(C1CC(OC2C(C1OC2)=O)O)=O,,,5,1,1,0,1
58953_0,,,,2,1,1,2
C1(COC2CCC(C(OC12)O)=O)=O,,,5,1,1,0,1
58955_0,,,,2,1,1,2
C(CC1C(OC2C(CC1O2)=O)O)=O,,,5,1,1,0,1
58957_0,,,,2,1,1,2
C(C1(CCC2C(C(O1)OC2)=O)O)=O,,,5,1,1,0,1
58959_0,,,,2,1,1,2
C(C1CC(OC2C(C1CO2)=O)O)=O,,,5,1,1,0,1
58961_0,,,,2,1,1,2
C1(C2CCC(C(O)OC2CO1)=O)=O,,,5,1,1,0,1
58963_0,,,,2,1,1,2
C1(CC2C(CCC(C(O)O2)=O)O1)=O,,,5,1,1,0,1
58965_0,,,,2,1,1,2
C1(COC2C1CCC(C(O)O2)=O)=O,,,5,1,1,0,1
58967_0,,,,2,1,1,2
C(CC1C(O)OC2CC(C1O2)=O)=O,,,5,1,1,0,1
58969_0,,,,2,1,1,2
C(C1(COC(C(CC1)=O)O)O)=O,,,5,1,1,0,1
58971_0,,,,2,1,1,2
C(C1C(CCC(C(O1)O)=O)O)=O,,,5,1,1,0,1
58973_0,,,,2,1,1,2
C1(C(O)OCC(CC1)O)=O,,,5,1,1,0,1
58975_0,,,,2,1,1,2
C1(C(CCC(C(O)O1)=O)O)=O,,,5,1,1,0,1
58977_0,,,,2,1,1,2
C(C1(CCC(C(CO1)=O)O)O)=O,,,5,1,1,0,1
58979_0,,,,2,1,1,2
C1(C(O)OCC(CO)(CC1)O)=O,,,5,1,1,0,1
58981_0,,,,2,1,1,2
C1(C(O)OC(CO)C(CC1)O)=O,,,5,1,1,0,1
58983_0,,,,2,1,1,2
C(C1(CCC(C(CO1)O)O)O)=O,,,5,1,1,0,1
58985_0,,,,2,1,1,2
C1(C(CO)(CCC(C(O)O1)=O)O)=O,,,5,1,1,0,1
58987_0,,,,2,1,1,2
C(C1(COC(C(CC1)=O)O)O)(O)=O,,,5,1,1,0,1
58989_0,,,,2,1,1,2
C1(C(C(CCC(C=O)(O)O1)O)O)=O,,,5,1,1,0,1
58991_0,,,,2,1,1,2
C(C1C(CCC(C(O1)O)=O)O)(O)=O,,,5,1,1,0,1
58993_0,,,,2,1,1,2
C1(C(O)OCC(C(C=O)=O)CC1)=O,,,5,1,1,0,1
58995_0,,,,2,1,1,2
C(C1CCC(C(OC1C=O)O)=O)=O,,,5,1,1,0,1
58997_0,,,,2,1,1,2
C(C1(CCC(C=O)C(CO1)=O)O)=O,,,5,1,1,0,1
58999_0,,,,2,1,1,2
C1(CCCC(C=O)(OC1C=O)O)=O,,,5,1,1,0,1
59001_0,,,,2,1,1,2
C(C1CC(O)OCC(C1O)O)=O,,,5,1,1,0,1
59003_0,,,,2,1,1,2
C(C1C(C(C(OC(C1)O)=O)O)O)=O,,,5,1,1,0,1
59005_0,,,,2,1,1,2
C(C1CC(OCC(C1C=O)=O)O)=O,,,5,1,1,0,1
59007_0,,,,2,1,1,2
C(C1CC(OC(C=O)C(C1)=O)O)=O,,,5,1,1,0,1
59008_0,,,,2,1,1,2
59009_0,,,,2,1,1,2
59010_0,,,,2,1,1,2
59011_0,,,,2,1,1,2
59012_0,,,,2,1,1,2
59013_0,,,,2,1,1,2
59014_0,,,,2,1,1,2
59015_0,,,,2,1,1,2
59016_0,,,,2,1,1,2
59017_0,,,,2,1,1,2
59018_0,,,,2,1,1,2
59019_0,,,,2,1,1,2
59020_0,,,,2,1,1,2
59021_0,,,,2,1,1,2
59022_0,,,,2,1,1,2
59023_0,,,,2,1,1,2
59024_0,,,,2,1,1,2
59025_0,,,,2,1,1,2
59026_0,,,,2,1,1,2
59027_0,,,,2,1,1,2
59028_0,,,,2,1,1,2
59029_0,,,,2,1,1,2
59030_0,,,,2,1,1,2
59031_0,,,,2,1,1,2
59032_0,,,,2,1,1,2
59033_0,,,,2,1,1,2
59034_0,,,,2,1,1,2
59035_0,,,,2,1,1,2
59036_0,,,,2,1,1,2
59037_0,,,,2,1,1,2
59038_0,,,,2,1,1,2
59039_0,,,,2,1,1,2
59040_0,,,,2,1,1,2
59041_0,,,,2,1,1,2
59042_0,,,,2,1,1,2
59043_0,,,,2,1,1,2
59044_0,,,,2,1,1,2
59045_0,,,,2,1,1,2
59046_0,,,,2,1,1,2
59047_0,,,,2,1,1,2
59048_0,,,,2,1,1,2
59049_0,,,,2,1,1,2
59050_0,,,,2,1,1,2
59051_0,,,,2,1,1,2
59052_0,,,,2,1,1,2
59053_0,,,,2,1,1,2
59054_0,,,,2,1,1,2
59055_0,,,,2,1,1,2
59056_0,,,,2,1,1,2
59057_0,,,,2,1,1,2
59058_0,,,,2,1,1,2
59059_0,,,,2,1,1,2
59060_0,,,,2,1,1,2
59061_0,,,,2,1,1,2
59062_0,,,,2,1,1,2
59063_0,,,,2,1,1,2
59064_0,,,,2,1,1,2
59065_0,,,,2,1,1,2
59066_0,,,,2,1,1,2
59067_0,,,,2,1,1,2
59068_0,,,,2,1,1,2
59069_0,,,,2,1,1,2
59070_0,,,,2,1,1,2
59071_0,,,,2,1,1,2
59072_0,,,,2,1,1,2
59073_0,,,,2,1,1,2
59074_0,,,,2,1,1,2
59075_0,,,,2,1,1,2
59076_0,,,,2,1,1,2
59077_0,,,,2,1,1,2
59078_0,,,,2,1,1,2
59079_0,,,,2,1,1,2
59080_0,,,,2,1,1,2
59081_0,,,,2,1,1,2
59082_0,,,,2,1,1,2
59083_0,,,,2,1,1,2
59084_0,,,,2,1,1,2
59085_0,,,,2,1,1,2
59086_0,,,,2,1,1,2
59087_0,,,,2,1,1,2
59088_0,,,,2,1,1,2
59089_0,,,,2,1,1,2
59090_0,,,,2,1,1,2
59091_0,,,,2,1,1,2
59092_0,,,,2,1,1,2
59093_0,,,,2,1,1,2
59095_0,,,,2,1,1,2
C(C(C(CC(C)O)O)=O)(CCO)=O,,,5,1,1,0,1
59096_0,,,,2,1,1,2
59097_0,,,,2,1,1,2
59098_0,,,,2,1,1,2
59100_0,,,,2,1,1,2
C(C(C(C(CCO)=O)=O)(CO)O)=O,,,5,1,1,0,1
59102_0,,,,2,1,1,2
C(CO)(C(C(C(CCO)=O)=O)O)=O,,,5,1,1,0,1
59103_0,,,,2,1,1,2
59104_0,,,,2,1,1,2
59106_0,,,,2,1,1,2
C(C(C(C(CCO)=O)=O)(C)O)(O)=O,,,5,1,1,0,1
59108_0,,,,2,1,1,2
C(CC(C(C(CCO)=O)=O)O)(O)=O,,,5,1,1,0,1
59110_0,,,,2,1,1,2
C(C(C=C)(C(C(CCO)=O)=O)O)=O,,,5,1,1,0,1
59112_0,,,,2,1,1,2
C=CC(C(C(C(CCO)=O)=O)O)=O,,,5,1,1,0,1
59114_0,,,,2,1,1,2
C(C(C(C(CCO)=O)=O)O)=CC=O,,,5,1,1,0,1
59115_0,,,,2,1,1,2
59116_0,,,,2,1,1,2
59117_0,,,,2,1,1,2
59118_0,,,,2,1,1,2
59119_0,,,,2,1,1,2
59120_0,,,,2,1,1,2
59121_0,,,,2,1,1,2
59122_0,,,,2,1,1,2
59123_0,,,,2,1,1,2
59124_0,,,,2,1,1,2
59125_0,,,,2,1,1,2
59126_0,,,,2,1,1,2
59127_0,,,,2,1,1,2
59128_0,,,,2,1,1,2
59129_0,,,,2,1,1,2
59130_0,,,,2,1,1,2
59131_0,,,,2,1,1,2
59132_0,,,,2,1,1,2
59133_0,,,,2,1,1,2
59134_0,,,,2,1,1,2
59135_0,,,,2,1,1,2
59136_0,,,,2,1,1,2
59137_0,,,,2,1,1,2
59138_0,,,,2,1,1,2
59139_0,,,,2,1,1,2
59140_0,,,,2,1,1,2
59141_0,,,,2,1,1,2
59142_0,,,,2,1,1,2
59143_0,,,,2,1,1,2
59144_0,,,,2,1,1,2
59145_0,,,,2,1,1,2
59146_0,,,,2,1,1,2
59147_0,,,,2,1,1,2
59148_0,,,,2,1,1,2
59149_0,,,,2,1,1,2
59150_0,,,,2,1,1,2
59151_0,,,,2,1,1,2
59152_0,,,,2,1,1,2
59153_0,,,,2,1,1,2
59154_0,,,,2,1,1,2
59155_0,,,,2,1,1,2
59156_0,,,,2,1,1,2
59157_0,,,,2,1,1,2
59158_0,,,,2,1,1,2
59159_0,,,,2,1,1,2
59160_0,,,,2,1,1,2
59161_0,,,,2,1,1,2
59162_0,,,,2,1,1,2
59163_0,,,,2,1,1,2
59164_0,,,,2,1,1,2
59165_0,,,,2,1,1,2
59166_0,,,,2,1,1,2
59167_0,,,,2,1,1,2
59168_0,,,,2,1,1,2
59169_0,,,,2,1,1,2
59170_0,,,,2,1,1,2
59171_0,,,,2,1,1,2
59172_0,,,,2,1,1,2
59173_0,,,,2,1,1,2
59174_0,,,,2,1,1,2
59175_0,,,,2,1,1,2
59176_0,,,,2,1,1,2
59177_0,,,,2,1,1,2
59178_0,,,,2,1,1,2
59179_0,,,,2,1,1,2
59180_0,,,,2,1,1,2
59181_0,,,,2,1,1,2
59182_0,,,,2,1,1,2
59183_0,,,,2,1,1,2
59184_0,,,,2,1,1,2
59185_0,,,,2,1,1,2
59186_0,,,,2,1,1,2
59187_0,,,,2,1,1,2
59188_0,,,,2,1,1,2
59189_0,,,,2,1,1,2
59190_0,,,,2,1,1,2
59191_0,,,,2,1,1,2
59192_0,,,,2,1,1,2
59193_0,,,,2,1,1,2
59194_0,,,,2,1,1,2
59195_0,,,,2,1,1,2
59196_0,,,,2,1,1,2
59197_0,,,,2,1,1,2
59198_0,,,,2,1,1,2
59199_0,,,,2,1,1,2
59200_0,,,,2,1,1,2
59201_0,,,,2,1,1,2
59202_0,,,,2,1,1,2
59203_0,,,,2,1,1,2
59204_0,,,,2,1,1,2
59205_0,,,,2,1,1,2
59206_0,,,,2,1,1,2
59207_0,,,,2,1,1,2
59208_0,,,,2,1,1,2
59209_0,,,,2,1,1,2
59210_0,,,,2,1,1,2
59211_0,,,,2,1,1,2
59212_0,,,,2,1,1,2
59213_0,,,,2,1,1,2
59214_0,,,,2,1,1,2
59215_0,,,,2,1,1,2
59216_0,,,,2,1,1,2
59217_0,,,,2,1,1,2
59218_0,,,,2,1,1,2
59219_0,,,,2,1,1,2
59220_0,,,,2,1,1,2
59221_0,,,,2,1,1,2
59222_0,,,,2,1,1,2
59223_0,,,,2,1,1,2
59224_0,,,,2,1,1,2
59225_0,,,,2,1,1,2
59226_0,,,,2,1,1,2
59227_0,,,,2,1,1,2
59228_0,,,,2,1,1,2
59229_0,,,,2,1,1,2
59230_0,,,,2,1,1,2
59231_0,,,,2,1,1,2
59232_0,,,,2,1,1,2
59233_0,,,,2,1,1,2
59234_0,,,,2,1,1,2
59235_0,,,,2,1,1,2
59236_0,,,,2,1,1,2
59237_0,,,,2,1,1,2
59238_0,,,,2,1,1,2
59239_0,,,,2,1,1,2
59240_0,,,,2,1,1,2
59241_0,,,,2,1,1,2
59242_0,,,,2,1,1,2
59243_0,,,,2,1,1,2
59244_0,,,,2,1,1,2
59245_0,,,,2,1,1,2
59246_0,,,,2,1,1,2
59247_0,,,,2,1,1,2
59248_0,,,,2,1,1,2
59249_0,,,,2,1,1,2
59250_0,,,,2,1,1,2
59251_0,,,,2,1,1,2
59252_0,,,,2,1,1,2
59253_0,,,,2,1,1,2
59254_0,,,,2,1,1,2
59255_0,,,,2,1,1,2
59256_0,,,,2,1,1,2
59257_0,,,,2,1,1,2
59258_0,,,,2,1,1,2
59259_0,,,,2,1,1,2
59260_0,,,,2,1,1,2
59261_0,,,,2,1,1,2
59262_0,,,,2,1,1,2
59263_0,,,,2,1,1,2
59264_0,,,,2,1,1,2
59265_0,,,,2,1,1,2
59266_0,,,,2,1,1,2
59267_0,,,,2,1,1,2
59268_0,,,,2,1,1,2
59269_0,,,,2,1,1,2
59270_0,,,,2,1,1,2
59271_0,,,,2,1,1,2
59272_0,,,,2,1,1,2
59273_0,,,,2,1,1,2
59274_0,,,,2,1,1,2
59275_0,,,,2,1,1,2
59276_0,,,,2,1,1,2
59277_0,,,,2,1,1,2
59278_0,,,,2,1,1,2
59279_0,,,,2,1,1,2
59280_0,,,,2,1,1,2
59281_0,,,,2,1,1,2
59282_0,,,,2,1,1,2
59283_0,,,,2,1,1,2
59284_0,,,,2,1,1,2
59285_0,,,,2,1,1,2
59286_0,,,,2,1,1,2
59287_0,,,,2,1,1,2
59288_0,,,,2,1,1,2
59289_0,,,,2,1,1,2
59290_0,,,,2,1,1,2
59291_0,,,,2,1,1,2
59292_0,,,,2,1,1,2
59293_0,,,,2,1,1,2
59294_0,,,,2,1,1,2
59295_0,,,,2,1,1,2
59296_0,,,,2,1,1,2
59297_0,,,,2,1,1,2
59298_0,,,,2,1,1,2
59299_0,,,,2,1,1,2
59300_0,,,,2,1,1,2
59301_0,,,,2,1,1,2
59302_0,,,,2,1,1,2
59303_0,,,,2,1,1,2
59304_0,,,,2,1,1,2
59305_0,,,,2,1,1,2
59306_0,,,,2,1,1,2
59307_0,,,,2,1,1,2
59308_0,,,,2,1,1,2
59309_0,,,,2,1,1,2
59310_0,,,,2,1,1,2
59311_0,,,,2,1,1,2
59312_0,,,,2,1,1,2
59313_0,,,,2,1,1,2
59314_0,,,,2,1,1,2
59315_0,,,,2,1,1,2
59316_0,,,,2,1,1,2
59317_0,,,,2,1,1,2
59318_0,,,,2,1,1,2
59319_0,,,,2,1,1,2
59320_0,,,,2,1,1,2
59321_0,,,,2,1,1,2
59322_0,,,,2,1,1,2
59323_0,,,,2,1,1,2
59324_0,,,,2,1,1,2
59325_0,,,,2,1,1,2
59326_0,,,,2,1,1,2
59327_0,,,,2,1,1,2
59328_0,,,,2,1,1,2
59329_0,,,,2,1,1,2
59330_0,,,,2,1,1,2
59331_0,,,,2,1,1,2
59332_0,,,,2,1,1,2
59333_0,,,,2,1,1,2
59334_0,,,,2,1,1,2
59335_0,,,,2,1,1,2
59336_0,,,,2,1,1,2
59337_0,,,,2,1,1,2
59338_0,,,,2,1,1,2
59339_0,,,,2,1,1,2
59340_0,,,,2,1,1,2
59341_0,,,,2,1,1,2
59342_0,,,,2,1,1,2
59343_0,,,,2,1,1,2
59344_0,,,,2,1,1,2
59345_0,,,,2,1,1,2
59346_0,,,,2,1,1,2
59347_0,,,,2,1,1,2
59348_0,,,,2,1,1,2
59349_0,,,,2,1,1,2
59350_0,,,,2,1,1,2
59351_0,,,,2,1,1,2
59353_0,,,,2,1,1,2
C(CCC(C=O)=O)(CC(CO)=O)=O,,,5,1,1,0,1
59355_0,,,,2,1,1,2
C(C(C(CC(CO)=O)=O)CC=O)=O,,,5,1,1,0,1
59356_0,,,,2,1,1,2
59357_0,,,,2,1,1,2
59358_0,,,,2,1,1,2
59359_0,,,,2,1,1,2
59360_0,,,,2,1,1,2
59361_0,,,,2,1,1,2
59362_0,,,,2,1,1,2
59363_0,,,,2,1,1,2
59364_0,,,,2,1,1,2
59365_0,,,,2,1,1,2
59366_0,,,,2,1,1,2
59367_0,,,,2,1,1,2
59368_0,,,,2,1,1,2
59369_0,,,,2,1,1,2
59370_0,,,,2,1,1,2
59371_0,,,,2,1,1,2
59372_0,,,,2,1,1,2
59373_0,,,,2,1,1,2
59374_0,,,,2,1,1,2
59375_0,,,,2,1,1,2
59376_0,,,,2,1,1,2
59377_0,,,,2,1,1,2
59378_0,,,,2,1,1,2
59379_0,,,,2,1,1,2
59380_0,,,,2,1,1,2
59381_0,,,,2,1,1,2
59382_0,,,,2,1,1,2
59383_0,,,,2,1,1,2
59384_0,,,,2,1,1,2
59385_0,,,,2,1,1,2
59386_0,,,,2,1,1,2
59387_0,,,,2,1,1,2
59388_0,,,,2,1,1,2
59389_0,,,,2,1,1,2
59390_0,,,,2,1,1,2
59391_0,,,,2,1,1,2
59392_0,,,,2,1,1,2
59393_0,,,,2,1,1,2
59394_0,,,,2,1,1,2
59395_0,,,,2,1,1,2
59396_0,,,,2,1,1,2
59397_0,,,,2,1,1,2
59398_0,,,,2,1,1,2
59399_0,,,,2,1,1,2
59400_0,,,,2,1,1,2
59401_0,,,,2,1,1,2
59402_0,,,,2,1,1,2
59403_0,,,,2,1,1,2
59404_0,,,,2,1,1,2
59405_0,,,,2,1,1,2
59406_0,,,,2,1,1,2
59407_0,,,,2,1,1,2
59408_0,,,,2,1,1,2
59409_0,,,,2,1,1,2
59410_0,,,,2,1,1,2
59411_0,,,,2,1,1,2
59412_0,,,,2,1,1,2
59413_0,,,,2,1,1,2
59414_0,,,,2,1,1,2
59415_0,,,,2,1,1,2
59416_0,,,,2,1,1,2
59417_0,,,,2,1,1,2
59418_0,,,,2,1,1,2
59419_0,,,,2,1,1,2
59420_0,,,,2,1,1,2
59421_0,,,,2,1,1,2
59422_0,,,,2,1,1,2
59423_0,,,,2,1,1,2
59424_0,,,,2,1,1,2
59425_0,,,,2,1,1,2
59426_0,,,,2,1,1,2
59427_0,,,,2,1,1,2
59428_0,,,,2,1,1,2
59429_0,,,,2,1,1,2
59430_0,,,,2,1,1,2
59431_0,,,,2,1,1,2
59432_0,,,,2,1,1,2
59433_0,,,,2,1,1,2
59434_0,,,,2,1,1,2
59435_0,,,,2,1,1,2
59436_0,,,,2,1,1,2
59437_0,,,,2,1,1,2
59438_0,,,,2,1,1,2
59439_0,,,,2,1,1,2
59440_0,,,,2,1,1,2
59441_0,,,,2,1,1,2
59442_0,,,,2,1,1,2
59443_0,,,,2,1,1,2
59444_0,,,,2,1,1,2
59445_0,,,,2,1,1,2
59446_0,,,,2,1,1,2
59447_0,,,,2,1,1,2
59448_0,,,,2,1,1,2
59449_0,,,,2,1,1,2
59450_0,,,,2,1,1,2
59451_0,,,,2,1,1,2
59452_0,,,,2,1,1,2
59453_0,,,,2,1,1,2
59454_0,,,,2,1,1,2
59455_0,,,,2,1,1,2
59456_0,,,,2,1,1,2
59457_0,,,,2,1,1,2
59458_0,,,,2,1,1,2
59459_0,,,,2,1,1,2
59460_0,,,,2,1,1,2
59461_0,,,,2,1,1,2
59462_0,,,,2,1,1,2
59463_0,,,,2,1,1,2
59464_0,,,,2,1,1,2
59465_0,,,,2,1,1,2
59466_0,,,,2,1,1,2
59467_0,,,,2,1,1,2
59468_0,,,,2,1,1,2
59469_0,,,,2,1,1,2
59470_0,,,,2,1,1,2
59471_0,,,,2,1,1,2
59472_0,,,,2,1,1,2
59473_0,,,,2,1,1,2
59474_0,,,,2,1,1,2
59475_0,,,,2,1,1,2
59476_0,,,,2,1,1,2
59477_0,,,,2,1,1,2
59478_0,,,,2,1,1,2
59479_0,,,,2,1,1,2
59480_0,,,,2,1,1,2
59481_0,,,,2,1,1,2
59482_0,,,,2,1,1,2
59483_0,,,,2,1,1,2
59484_0,,,,2,1,1,2
59485_0,,,,2,1,1,2
59486_0,,,,2,1,1,2
59487_0,,,,2,1,1,2
59488_0,,,,2,1,1,2
59489_0,,,,2,1,1,2
59490_0,,,,2,1,1,2
59491_0,,,,2,1,1,2
59492_0,,,,2,1,1,2
59493_0,,,,2,1,1,2
59494_0,,,,2,1,1,2
59495_0,,,,2,1,1,2
59496_0,,,,2,1,1,2
59497_0,,,,2,1,1,2
59498_0,,,,2,1,1,2
59499_0,,,,2,1,1,2
59500_0,,,,2,1,1,2
59501_0,,,,2,1,1,2
59502_0,,,,2,1,1,2
59503_0,,,,2,1,1,2
59504_0,,,,2,1,1,2
59505_0,,,,2,1,1,2
59506_0,,,,2,1,1,2
59507_0,,,,2,1,1,2
59508_0,,,,2,1,1,2
59509_0,,,,2,1,1,2
59510_0,,,,2,1,1,2
59511_0,,,,2,1,1,2
59512_0,,,,2,1,1,2
59513_0,,,,2,1,1,2
59514_0,,,,2,1,1,2
59515_0,,,,2,1,1,2
59516_0,,,,2,1,1,2
59517_0,,,,2,1,1,2
59518_0,,,,2,1,1,2
59519_0,,,,2,1,1,2
59520_0,,,,2,1,1,2
59521_0,,,,2,1,1,2
59522_0,,,,2,1,1,2
59523_0,,,,2,1,1,2
59524_0,,,,2,1,1,2
59525_0,,,,2,1,1,2
59526_0,,,,2,1,1,2
59527_0,,,,2,1,1,2
59528_0,,,,2,1,1,2
59529_0,,,,2,1,1,2
59530_0,,,,2,1,1,2
59531_0,,,,2,1,1,2
59532_0,,,,2,1,1,2
59533_0,,,,2,1,1,2
59534_0,,,,2,1,1,2
59535_0,,,,2,1,1,2
59536_0,,,,2,1,1,2
59537_0,,,,2,1,1,2
59538_0,,,,2,1,1,2
59539_0,,,,2,1,1,2
59540_0,,,,2,1,1,2
59541_0,,,,2,1,2,3
59542_0,,,,2,1,2,3
59543_0,,,,2,1,2,3
59544_0,,,,2,1,2,3
59545_0,,,,2,1,2,3
59546_0,,,,2,1,2,3
59547_0,,,,2,1,2,3
59548_0,,,,2,1,2,3
59549_0,,,,2,1,2,3
59550_0,,,,2,1,2,3
59551_0,,,,2,1,2,3
59552_0,,,,2,1,2,3
59553_0,,,,2,1,2,3
59554_0,,,,2,1,2,3
59555_0,,,,2,1,2,3
59556_0,,,,2,1,2,3
59557_0,,,,2,1,2,3
59558_0,,,,2,1,2,3
59559_0,,,,2,1,2,3
59560_0,,,,2,1,2,3
59561_0,,,,2,1,2,3
59562_0,,,,2,1,2,3
59563_0,,,,2,1,2,3
59564_0,,,,2,1,2,3
59565_0,,,,2,1,2,3
59566_0,,,,2,1,2,3
59567_0,,,,2,1,2,3
59568_0,,,,2,1,2,3
59569_0,,,,2,1,2,3
59570_0,,,,2,1,2,3
59571_0,,,,2,1,2,3
59572_0,,,,2,1,2,3
59573_0,,,,2,1,2,3
59574_0,,,,2,1,2,3
59575_0,,,,2,1,2,3
59576_0,,,,2,1,2,3
59577_0,,,,2,1,2,3
59578_0,,,,2,1,2,3
59579_0,,,,2,1,2,3
59580_0,,,,2,1,2,3
59581_0,,,,2,1,2,3
59582_0,,,,2,1,2,3
59583_0,,,,2,1,2,3
59584_0,,,,2,1,2,3
59585_0,,,,2,1,2,3
59586_0,,,,2,1,2,3
59587_0,,,,2,1,2,3
59588_0,,,,2,1,2,3
59589_0,,,,2,1,2,3
59590_0,,,,2,1,2,3
59591_0,,,,2,1,2,3
59592_0,,,,2,1,2,3
59593_0,,,,2,1,2,3
59594_0,,,,2,1,2,3
59595_0,,,,2,1,2,3
59596_0,,,,2,1,2,3
59597_0,,,,2,1,2,3
59598_0,,,,2,1,2,3
59599_0,,,,2,1,2,3
59601_0,,,,2,1,2,3
C(C(C=O)C)=O,,,5,1,1,0,1
59602_0,,,,2,1,2,3
59603_0,,,,2,1,2,3
59604_0,,,,2,1,2,3
59605_0,,,,2,1,2,3
59606_0,,,,2,1,2,3
59607_0,,,,2,1,2,3
59608_0,,,,2,1,2,3
59609_0,,,,2,1,2,3
59611_0,,,,2,1,2,3
C(CC)=O,,,5,1,1,0,1
59612_0,,,,2,1,2,3
59613_0,,,,2,1,2,3
59614_0,,,,2,1,2,3
59615_0,,,,2,1,2,3
59616_0,,,,2,1,2,3
59618_0,,,,2,1,2,3
C1(C(C(C=O)C(C=O)(C)O1)O)=O,,,5,1,1,0,1
59620_0,,,,2,1,2,3
C1(C(C(C=O)C(C(C)=O)O1)O)=O,,,5,1,1,0,1
59622_0,,,,2,1,2,3
C1(C(C(C(C=O)=O)C(C)O1)O)=O,,,5,1,1,0,1
59624_0,,,,2,1,2,3
C(CC1C(C=O)C(C(O1)=O)O)=O,,,5,1,1,0,1
59626_0,,,,2,1,2,3
C(C(C1CC(C(O1)=O)=O)CO)=O,,,5,1,1,0,1
59628_0,,,,2,1,2,3
C1(C(CC(CC(C)O)O1)=O)=O,,,5,1,1,0,1
59630_0,,,,2,1,2,3
C(C1C(C)OC(C1O)=O)=O,,,5,1,1,0,1
59632_0,,,,2,1,2,3
C(C1C(C)OC(C1(C)O)=O)=O,,,5,1,1,0,1
59634_0,,,,2,1,2,3
C1(C(CC(C(C(C)O)O)O1)=O)=O,,,5,1,1,0,1
59636_0,,,,2,1,2,3
C1(C(C=O)C(C(C(C)O)O1)O)=O,,,5,1,1,0,1
59638_0,,,,2,1,2,3
C1(C(CC(CCO)O1)=O)=O,,,5,1,1,0,1
59639_0,,,,2,1,2,3
59641_0,,,,2,1,2,3
C1(C(C(CO)C(CCO)O1)=O)=O,,,5,1,1,0,1
59643_0,,,,2,1,2,3
C(C1C(CCO)OC(C1O)=O)=O,,,5,1,1,0,1
59644_0,,,,2,1,2,3
59645_0,,,,2,1,2,3
59646_0,,,,2,1,2,3
59648_0,,,,2,1,2,3
C(C1COC(C1(C)O)=O)=O,,,5,1,1,0,1
59649_0,,,,2,1,2,3
59651_0,,,,2,1,2,3
C(C1COC(C1(CCO)O)=O)=O,,,5,1,1,0,1
59653_0,,,,2,1,2,3
C(C(CO)C1CC(C(O1)=O)O)=O,,,5,1,1,0,1
59655_0,,,,2,1,2,3
C(C(CO)C1C(CC(O1)=O)O)=O,,,5,1,1,0,1
59656_0,,,,2,1,2,3
59658_0,,,,2,1,2,3
C1(C(CC(CC(CO)O)O1)=O)=O,,,5,1,1,0,1
59659_0,,,,2,1,2,3
59661_0,,,,2,1,2,3
C(C1C(CO)OC(C1(C)O)=O)=O,,,5,1,1,0,1
59663_0,,,,2,1,2,3
C(C1(CO)CC(C(O1)=O)=O)=O,,,5,1,1,0,1
59665_0,,,,2,1,2,3
C1(C(C=O)C(C=O)(CO1)O)=O,,,5,1,1,0,1
59667_0,,,,2,1,2,3
C(CO)(C1CC(C(O1)=O)=O)=O,,,5,1,1,0,1
59669_0,,,,2,1,2,3
C1(CC(C(C(C=O)=O)O1)O)=O,,,5,1,1,0,1
59671_0,,,,2,1,2,3
C(C)(C1(CO)CC(C(O1)=O)=O)=O,,,5,1,1,0,1
59673_0,,,,2,1,2,3
C1(C(C=O)C(C(C)=O)(CO1)O)=O,,,5,1,1,0,1
59675_0,,,,2,1,2,3
C(CO)(C1(C)CC(C(O1)=O)=O)=O,,,5,1,1,0,1
59677_0,,,,2,1,2,3
C1(CC(C(C(C(C)=O)=O)O1)O)=O,,,5,1,1,0,1
59679_0,,,,2,1,2,3
C(C1(C(C)O)CC(C(O1)=O)=O)=O,,,5,1,1,0,1
59681_0,,,,2,1,2,3
C1(C(C=O)C(C=O)(C(C)O1)O)=O,,,5,1,1,0,1
59683_0,,,,2,1,2,3
C(C1CC(C(O1)=O)=O)(C(C)O)=O,,,5,1,1,0,1
59685_0,,,,2,1,2,3
C1(C(CC(C)(CO)O1)=O)=O,,,5,1,1,0,1
59687_0,,,,2,1,2,3
C1(C(C=O)C(C)(CO1)O)=O,,,5,1,1,0,1
59688_0,,,,2,1,2,3
59690_0,,,,2,1,2,3
C1(C(C(CO)C(C)(CO)O1)=O)=O,,,5,1,1,0,1
59692_0,,,,2,1,2,3
C(C1C(CO)(C)OC(C1O)=O)=O,,,5,1,1,0,1
59693_0,,,,2,1,2,3
59695_0,,,,2,1,2,3
C1(C(C(CO)=O)C(C)(CO1)O)=O,,,5,1,1,0,1
59696_0,,,,2,1,2,3
59697_0,,,,2,1,2,3
59698_0,,,,2,1,2,3
59699_0,,,,2,1,2,3
59701_0,,,,2,1,2,3
C1(CC(C(C(C(C)=O)O)O1)O)=O,,,5,1,1,0,1
59702_0,,,,2,1,2,3
59704_0,,,,2,1,2,3
C1(CC(CO)(C(C(C)=O)O1)O)=O,,,5,1,1,0,1
59706_0,,,,2,1,2,3
C1(C(C(C)(C(C(C)=O)O1)O)O)=O,,,5,1,1,0,1
59707_0,,,,2,1,2,3
59708_0,,,,2,1,2,3
59710_0,,,,2,1,2,3
C1(CC(C(CC(CO)=O)O1)O)=O,,,5,1,1,0,1
59711_0,,,,2,1,2,3
59713_0,,,,2,1,2,3
C1(C(CC(CO)(CCO)O1)=O)=O,,,5,1,1,0,1
59715_0,,,,2,1,2,3
C1(C(C=O)C(CO1)(CCO)O)=O,,,5,1,1,0,1
59717_0,,,,2,1,2,3
C1(CC(C(C(CCO)=O)O1)O)=O,,,5,1,1,0,1
59718_0,,,,2,1,2,3
59720_0,,,,2,1,2,3
C1(C(C)(C(C(CO)=O)CO1)O)=O,,,5,1,1,0,1
59722_0,,,,2,1,2,3
C1(C(CC(C(CCO)O)O1)=O)=O,,,5,1,1,0,1
59724_0,,,,2,1,2,3
C1(C(C=O)C(C(CCO)O1)O)=O,,,5,1,1,0,1
59726_0,,,,2,1,2,3
C1(C(CC(C)(C(CO)O)O1)=O)=O,,,5,1,1,0,1
59728_0,,,,2,1,2,3
C1(C(C=O)C(C)(C(CO)O1)O)=O,,,5,1,1,0,1
59730_0,,,,2,1,2,3
C(C1CC(C(O1)=O)=O)(O)=O,,,5,1,1,0,1
59732_0,,,,2,1,2,3
C1(C(C=O)C(C(O1)=O)O)=O,,,5,1,1,0,1
59733_0,,,,2,1,2,3
59735_0,,,,2,1,2,3
C(C1C(C(C(O1)=O)=O)CO)(O)=O,,,5,1,1,0,1
59737_0,,,,2,1,2,3
C1(C(C(C(C(O)=O)=O)CO1)O)=O,,,5,1,1,0,1
59739_0,,,,2,1,2,3
C1(C(C(C=O)C(C(O)=O)O1)O)=O,,,5,1,1,0,1
59740_0,,,,2,1,2,3
59742_0,,,,2,1,2,3
C1(C(C(CO)=O)C(C(O1)=O)O)=O,,,5,1,1,0,1
59743_0,,,,2,1,2,3
59745_0,,,,2,1,2,3
C1(COC2C1C(C(O2)=O)O)=O,,,5,1,1,0,1
59747_0,,,,2,1,2,3
C1(C(C(C(C=O)=O)CO1)O)=O,,,5,1,1,0,1
59749_0,,,,2,1,2,3
C1(C(C(C=O)C(C=O)O1)O)=O,,,5,1,1,0,1
59751_0,,,,2,1,2,3
C(C1(C)CC(C(O1)=O)=O)(O)=O,,,5,1,1,0,1
59753_0,,,,2,1,2,3
C1(C(C=O)C(C(O1)=O)(C)O)=O,,,5,1,1,0,1
59755_0,,,,2,1,2,3
C1(C(C)(C2C(COC2O1)=O)O)=O,,,5,1,1,0,1
59757_0,,,,2,1,2,3
C1(C(C)(C(C(C=O)=O)CO1)O)=O,,,5,1,1,0,1
59759_0,,,,2,1,2,3
C1(C(C)(C(C=O)C(C=O)O1)O)=O,,,5,1,1,0,1
59761_0,,,,2,1,2,3
C(CC1CC(C(O1)=O)=O)(O)=O,,,5,1,1,0,1
59763_0,,,,2,1,2,3
C1(C(CC2(COCC2O)O1)=O)=O,,,5,1,1,0,1
59765_0,,,,2,1,2,3
C1(C(CC2(C(O)OCC2)O1)=O)=O,,,5,1,1,0,1
59767_0,,,,2,1,2,3
C1(C(CC2(COC(C2)O)O1)=O)=O,,,5,1,1,0,1
59769_0,,,,2,1,2,3
C(C1(C=C)CC(C(O1)=O)=O)=O,,,5,1,1,0,1
59771_0,,,,2,1,2,3
C=CC(C1CC(C(O1)=O)=O)=O,,,5,1,1,0,1
59773_0,,,,2,1,2,3
C(C1CC(C(O1)=O)=O)=CC=O,,,5,1,1,0,1
59775_0,,,,2,1,2,3
C(C1CC(C(O1)=O)=O)=O,,,5,1,1,0,1
59776_0,,,,2,1,2,3
59778_0,,,,2,1,2,3
C(C1(C)CC(C(O1)=O)=O)=O,,,5,1,1,0,1
59779_0,,,,2,1,2,3
59780_0,,,,2,1,2,3
59782_0,,,,2,1,2,3
C(C1(CCO)CC(C(O1)=O)=O)=O,,,5,1,1,0,1
59784_0,,,,2,1,2,3
C(C1CC(C(O1)=O)=O)(CCO)=O,,,5,1,1,0,1
59786_0,,,,2,1,2,3
C(CC(C1CC(C(O1)=O)=O)O)=O,,,5,1,1,0,1
59788_0,,,,2,1,2,3
C(C(CC1CC(C(O1)=O)=O)O)=O,,,5,1,1,0,1
59790_0,,,,2,1,2,3
C(CO)(CC1CC(C(O1)=O)=O)=O,,,5,1,1,0,1
59792_0,,,,2,1,2,3
C(CC1(CO)CC(C(O1)=O)=O)=O,,,5,1,1,0,1
59794_0,,,,2,1,2,3
C(C)(C(C1CC(C(O1)=O)=O)O)=O,,,5,1,1,0,1
59796_0,,,,2,1,2,3
C(C(C1(C)CC(C(O1)=O)=O)O)=O,,,5,1,1,0,1
59798_0,,,,2,1,2,3
C1(C(OC(C)C1)=O)=O,,,5,1,1,0,1
59800_0,,,,2,1,2,3
C1(CC(C(C(CO)=O)O1)O)=O,,,5,1,1,0,1
59802_0,,,,2,1,2,3
C1(CC(C(C(CC=O)=O)O1)O)=O,,,5,1,1,0,1
59804_0,,,,2,1,2,3
C1(CC(C(C=O)O1)O)=O,,,5,1,1,0,1
59806_0,,,,2,1,2,3
C1(C(C=O)C2(COCC2O1)O)=O,,,5,1,1,0,1
59808_0,,,,2,1,2,3
C1(C(C=O)C2(C(OCC2)O1)O)=O,,,5,1,1,0,1
59809_0,,,,2,1,2,3
59810_0,,,,2,1,2,3
59812_0,,,,2,1,2,3
C1(C(C=O)C(C(CC=O)O1)O)=O,,,5,1,1,0,1
59814_0,,,,2,1,2,3
C1(C(C=O)C(CO1)(CC=O)O)=O,,,5,1,1,0,1
59816_0,,,,2,1,2,3
C1(C(C=O)C(C(C(C)=O)O1)O)=O,,,5,1,1,0,1
59818_0,,,,2,1,2,3
C1(C(C=O)C(C)(C(C=O)O1)O)=O,,,5,1,1,0,1
59819_0,,,,2,1,2,3
59820_0,,,,2,1,2,3
59821_0,,,,2,1,2,3
59822_0,,,,2,1,2,3
59823_0,,,,2,1,2,3
59825_0,,,,2,1,2,3
C(C1C(C(C(O1)=O)=O)CO)=O,,,5,1,1,0,1
59826_0,,,,2,1,2,3
59828_0,,,,2,1,2,3
C(C1(C)C(C(C(O1)=O)=O)CO)=O,,,5,1,1,0,1
59829_0,,,,2,1,2,3
59831_0,,,,2,1,2,3
C(C1C(C(C(O1)=O)=O)CO)(C)=O,,,5,1,1,0,1
59832_0,,,,2,1,2,3
59834_0,,,,2,1,2,3
C(CC1C(C(C(O1)=O)=O)CO)=O,,,5,1,1,0,1
59835_0,,,,2,1,2,3
59837_0,,,,2,1,2,3
C1(C(C(CO)C(C)O1)=O)=O,,,5,1,1,0,1
59838_0,,,,2,1,2,3
59839_0,,,,2,1,2,3
59840_0,,,,2,1,2,3
59841_0,,,,2,1,2,3
59843_0,,,,2,1,2,3
C1(C(CC(CC(C=O)=O)O1)O)=O,,,5,1,1,0,1
59845_0,,,,2,1,2,3
C(C(C=O)C1CC(C(O1)=O)O)=O,,,5,1,1,0,1
59846_0,,,,2,1,2,3
59848_0,,,,2,1,2,3
C1(C(CC(C(C=O)O)O1)O)=O,,,5,1,1,0,1
59850_0,,,,2,1,2,3
C1(CC(C(CC(C=O)=O)O1)O)=O,,,5,1,1,0,1
59852_0,,,,2,1,2,3
C(C(C=O)C1C(CC(O1)=O)O)=O,,,5,1,1,0,1
59853_0,,,,2,1,2,3
59855_0,,,,2,1,2,3
C1(CC(C(C(C=O)O)O1)O)=O,,,5,1,1,0,1
59856_0,,,,2,1,2,3
59857_0,,,,2,1,2,3
59858_0,,,,2,1,2,3
59860_0,,,,2,1,2,3
C1(CC(CO)(C(C=O)O1)O)=O,,,5,1,1,0,1
59861_0,,,,2,1,2,3
59862_0,,,,2,1,2,3
59863_0,,,,2,1,2,3
59864_0,,,,2,1,2,3
59865_0,,,,2,1,2,3
59866_0,,,,2,1,2,3
59867_0,,,,2,1,2,3
59868_0,,,,2,1,2,3
59869_0,,,,2,1,2,3
59870_0,,,,2,1,2,3
59871_0,,,,2,1,2,3
59872_0,,,,2,1,2,3
59873_0,,,,2,1,2,3
59874_0,,,,2,1,2,3
59876_0,,,,2,1,2,3
C1(C(C(C(C(C=O)O)O1)O)O)=O,,,5,1,1,0,1
59878_0,,,,2,1,2,3
C(CC1C(C)(C(C(O1)=O)O)O)=O,,,5,1,1,0,1
59880_0,,,,2,1,2,3
C(CC1(C)C(C(C(O1)=O)O)O)=O,,,5,1,1,0,1
59881_0,,,,2,1,2,3
59883_0,,,,2,1,2,3
C1(C(C(C(C)O1)C(CO)O)=O)=O,,,5,1,1,0,1
59884_0,,,,2,1,2,3
59885_0,,,,2,1,2,3
59887_0,,,,2,1,2,3
C(CO)(C1C(C)OC(C1O)=O)=O,,,5,1,1,0,1
59888_0,,,,2,1,2,3
59889_0,,,,2,1,2,3
59890_0,,,,2,1,2,3
59891_0,,,,2,1,2,3
59892_0,,,,2,1,2,3
59893_0,,,,2,1,2,3
59894_0,,,,2,1,2,3
59895_0,,,,2,1,2,3
59896_0,,,,2,1,2,3
59897_0,,,,2,1,2,3
59898_0,,,,2,1,2,3
59899_0,,,,2,1,2,3
59900_0,,,,2,1,2,3
59901_0,,,,2,1,2,3
59902_0,,,,2,1,2,3
59903_0,,,,2,1,2,3
59904_0,,,,2,1,2,3
59905_0,,,,2,1,2,3
59906_0,,,,2,1,2,3
59907_0,,,,2,1,2,3
59908_0,,,,2,1,2,3
59909_0,,,,2,1,2,3
59910_0,,,,2,1,2,3
59911_0,,,,2,1,2,3
59912_0,,,,2,1,2,3
59913_0,,,,2,1,2,3
59914_0,,,,2,1,2,3
59915_0,,,,2,1,2,3
59916_0,,,,2,1,2,3
59917_0,,,,2,1,2,3
59918_0,,,,2,1,2,3
59919_0,,,,2,1,2,3
59920_0,,,,2,1,2,3
59921_0,,,,2,1,2,3
59922_0,,,,2,1,2,3
59923_0,,,,2,1,2,3
59924_0,,,,2,1,2,3
59925_0,,,,2,1,2,3
59927_0,,,,2,1,2,3
C1(C(CO)(C(C)(CO1)O)O)=O,,,5,1,1,0,1
59929_0,,,,2,1,2,3
C1(C(C(C)(CO1)O)O)=O,,,5,1,1,0,1
59930_0,,,,2,1,2,3
59931_0,,,,2,1,2,3
59932_0,,,,2,1,2,3
59933_0,,,,2,1,2,3
59934_0,,,,2,1,2,3
59935_0,,,,2,1,2,3
59936_0,,,,2,1,2,3
59937_0,,,,2,1,2,3
59938_0,,,,2,1,2,3
59939_0,,,,2,1,2,3
59940_0,,,,2,1,2,3
59942_0,,,,2,1,2,3
C1(C(C(C(CO)O1)O)=O)=O,,,5,1,1,0,1
59944_0,,,,2,1,2,3
C1(C(C(C(C(CO)O)O1)O)=O)=O,,,5,1,1,0,1
59945_0,,,,2,1,2,3
59947_0,,,,2,1,2,3
C(CO)(C1(COC(C1O)=O)O)=O,,,5,1,1,0,1
59949_0,,,,2,1,2,3
C1(C(CO)(C(C(O1)=O)O)O)=O,,,5,1,1,0,1
59951_0,,,,2,1,2,3
C(C1(COC(C1O)=O)O)(O)=O,,,5,1,1,0,1
59953_0,,,,2,1,2,3
C(C1(COC(C1O)=O)O)=O,,,5,1,1,0,1
59955_0,,,,2,1,2,3
C(C1(C(CO)OC(C1O)=O)O)=O,,,5,1,1,0,1
59957_0,,,,2,1,2,3
C1(C(CO)(C(C(O1)=O)(C)O)O)=O,,,5,1,1,0,1
59959_0,,,,2,1,2,3
C1(C(C)(C(C(O)=O)(CO1)O)O)=O,,,5,1,1,0,1
59961_0,,,,2,1,2,3
C(C1(CO)C(CC(O1)=O)O)(O)=O,,,5,1,1,0,1
59963_0,,,,2,1,2,3
C1(C(C)(C(C=O)(CO1)O)O)=O,,,5,1,1,0,1
59965_0,,,,2,1,2,3
C1(CC(C(C=O)(C(C)=O)O1)O)=O,,,5,1,1,0,1
59967_0,,,,2,1,2,3
C(C1(CO)C(CC(O1)=O)O)=O,,,5,1,1,0,1
59968_0,,,,2,1,2,3
59970_0,,,,2,1,2,3
C1(CC(C=O)(C(C=O)O1)O)=O,,,5,1,1,0,1
59972_0,,,,2,1,2,3
C1(C(C(C(O1)=O)O)O)=O,,,5,1,1,0,1
59974_0,,,,2,1,2,3
C1(CC(C=O)(C(C=O)(C)O1)O)=O,,,5,1,1,0,1
59976_0,,,,2,1,2,3
C1(C(C)(C(C(O1)=O)O)O)=O,,,5,1,1,0,1
59978_0,,,,2,1,2,3
C1(CC(C=O)(C(C(C)=O)O1)O)=O,,,5,1,1,0,1
59980_0,,,,2,1,2,3
C(CC1C(C=O)(CC(O1)=O)O)=O,,,5,1,1,0,1
59982_0,,,,2,1,2,3
C1(CC(C(C=O)(CC=O)O1)O)=O,,,5,1,1,0,1
59984_0,,,,2,1,2,3
C1(CC(C(C(O)=O)O1)O)=O,,,5,1,1,0,1
59986_0,,,,2,1,2,3
C1(C(CCO)(C(C(O1)=O)O)O)=O,,,5,1,1,0,1
59987_0,,,,2,1,2,3
59989_0,,,,2,1,2,3
C(C1(C(C)OC(C1)=O)O)=O,,,5,1,1,0,1
59990_0,,,,2,1,2,3
59991_0,,,,2,1,2,3
59992_0,,,,2,1,2,3
59993_0,,,,2,1,2,3
59995_0,,,,2,1,2,3
C1(CC(C(C(C(O)=O)O)O1)O)=O,,,5,1,1,0,1
59997_0,,,,2,1,2,3
C1(C(CC(C(C(O)=O)O)O1)O)=O,,,5,1,1,0,1
59998_0,,,,2,1,2,3
60000_0,,,,2,1,2,3
C1(CC(CO)(C(C(O)=O)O1)O)=O,,,5,1,1,0,1
60001_0,,,,2,1,2,3
60002_0,,,,2,1,2,3
60003_0,,,,2,1,2,3
60003_1,,,,2,1,2,3
60005_0,,,,2,1,2,3
C1(C(C(C=O)(C(C=O)O1)O)O)=O,,,5,1,1,0,1
60007_0,,,,2,1,2,3
C(C1(C=O)C(C)OC(C1O)=O)=O,,,5,1,1,0,1
60009_0,,,,2,1,2,3
C(C1(C=O)COC(C1O)=O)=O,,,5,1,1,0,1
60011_0,,,,2,1,2,3
C(C1(C=O)COC(C1(C)O)=O)=O,,,5,1,1,0,1
60013_0,,,,2,1,2,3
C(C1(C(C)OC(C1O)=O)O)=O,,,5,1,1,0,1
60015_0,,,,2,1,2,3
C1(C(C)(C(C=O)(C(C)O1)O)O)=O,,,5,1,1,0,1
60017_0,,,,2,1,2,3
C(C1(C(CC(O1)=O)O)C(C)O)=O,,,5,1,1,0,1
60019_0,,,,2,1,1,2
C1(C(C(CO)O)C(C=O)(CO1)O)=O,,,5,1,1,0,1
60021_0,,,,2,1,2,3
C1(C(CO)(C(C=O)(CO1)O)O)=O,,,5,1,1,0,1
60023_0,,,,2,1,2,3
C1(C(C(C(C=O)=O)(CO1)O)O)=O,,,5,1,1,0,1
60025_0,,,,2,1,2,3
C1(C(C(C)(CO1)O)C(C=O)O)=O,,,5,1,1,0,1
60027_0,,,,2,1,2,3
C1(C(C(C)=O)(C(C)(CO1)O)O)=O,,,5,1,1,0,1
60029_0,,,,2,1,2,3
C1(C(C(C)O)(C(C)(CO1)O)O)=O,,,5,1,1,0,1
60031_0,,,,2,1,1,2
C1(C(C(CO)O)C(C)(CO1)O)=O,,,5,1,1,0,1
60033_0,,,,2,1,1,2
C1(C(C(CO)O)(C(C)(CO1)O)O)=O,,,5,1,1,0,1
60034_0,,,,2,1,2,3
60036_0,,,,2,1,2,3
C1(C(C)(C(C(C)=O)(CO1)O)O)=O,,,5,1,1,0,1
60038_0,,,,2,1,2,3
C1(CC(C(C(C)=O)(CO)O1)O)=O,,,5,1,1,0,1
60040_0,,,,2,1,2,3
C1(C(C(C(O1)=O)C(C=O)O)O)=O,,,5,1,1,0,1
60042_0,,,,2,1,2,3
C1(C(C(C(O)=O)C(C=O)O1)O)=O,,,5,1,1,0,1
60044_0,,,,2,1,2,3
C1(C(C(C)=O)(C(C(O1)=O)O)O)=O,,,5,1,1,0,1
60046_0,,,,2,1,2,3
C1(C(C(C)O)(C(C(O1)=O)O)O)=O,,,5,1,1,0,1
60048_0,,,,2,1,2,3
C(C1(C(C)OC(C1O)=O)O)(O)=O,,,5,1,1,0,1
60050_0,,,,2,1,1,2
C1(C(C(CO)O)C(C(O1)=O)O)=O,,,5,1,1,0,1
60052_0,,,,2,1,2,3
C1(C2C(CO1)OC(C2O)=O)=O,,,5,1,1,0,1
60054_0,,,,2,1,1,2
C1(C(C(CO)O)(C(C(O1)=O)O)O)=O,,,5,1,1,0,1
60056_0,,,,2,1,2,3
C1(C2(C(CO1)OC(C2O)=O)O)=O,,,5,1,1,0,1
60058_0,,,,2,1,1,2
C1(C(C(CO)O)C(C(O1)=O)(C)O)=O,,,5,1,1,0,1
60060_0,,,,2,1,2,3
C1(C2C(CO1)OC(C2(C)O)=O)=O,,,5,1,1,0,1
60062_0,,,,2,1,2,3
C1(CC(C2(C(COC2)=O)O1)O)=O,,,5,1,1,0,1
60064_0,,,,2,1,2,3
C(C)(C1(C(C)OC(C1O)=O)O)=O,,,5,1,1,0,1
60065_0,,,,2,1,2,3
60066_0,,,,2,1,2,3
60067_0,,,,2,1,1,2
60069_0,,,,2,1,1,2
C1(C(C(CO)O)C(CO1)(CO)O)=O,,,5,1,1,0,1
60070_0,,,,2,1,1,2
60071_0,,,,2,1,1,2
60072_0,,,,2,1,1,2
60073_0,,,,2,1,1,2
60075_0,,,,2,1,2,3
C1(C(C)(C(C(C(C)O)O1)O)O)=O,,,5,1,1,0,1
60077_0,,,,2,1,2,3
C1(C(C(C(C(C)O)O1)O)O)=O,,,5,1,1,0,1
60078_0,,,,2,1,2,3
60080_0,,,,2,1,2,3
C(C1(C(CCO)OC(C1)=O)O)=O,,,5,1,1,0,1
60082_0,,,,2,1,2,3
C1(C(C)(C(C)(CO1)O)O)=O,,,5,1,1,0,1
60084_0,,,,2,1,2,3
C1(C(C)(C(CO1)(CCO)O)O)=O,,,5,1,1,0,1
60086_0,,,,2,1,2,3
C1(C(C)(C(C(CCO)O1)O)O)=O,,,5,1,1,0,1
60088_0,,,,2,1,2,3
C1(C(C)(C(C)(C(CO)O1)O)O)=O,,,5,1,1,0,1
60090_0,,,,2,1,2,3
C1(C(C)(C(C(O1)=O)(C)O)O)=O,,,5,1,1,0,1
60092_0,,,,2,1,2,3
C(C1(C)C(CC(O1)=O)O)(O)=O,,,5,1,1,0,1
60094_0,,,,2,1,2,3
C1(C(C)(C2(COCC2O1)O)O)=O,,,5,1,1,0,1
60096_0,,,,2,1,2,3
C1(C(C)(C2(C(OCC2)O1)O)O)=O,,,5,1,1,0,1
60098_0,,,,2,1,2,3
C1(C(C)(C(C(CO)O1)O)O)=O,,,5,1,1,0,1
60100_0,,,,2,1,2,3
C1(C(C)(C(CO)(CO1)O)O)=O,,,5,1,1,0,1
60102_0,,,,2,1,2,3
C1(C(C)(C(C(CC=O)O1)O)O)=O,,,5,1,1,0,1
60104_0,,,,2,1,2,3
C1(C(C)(C(CO1)(CC=O)O)O)=O,,,5,1,1,0,1
60106_0,,,,2,1,2,3
C1(C(C)(C(C(C(C)=O)O1)O)O)=O,,,5,1,1,0,1
60108_0,,,,2,1,2,3
C1(C(C)(C(C)(C(C=O)O1)O)O)=O,,,5,1,1,0,1
60110_0,,,,2,1,2,3
C1(C(C)(C(CO1)O)O)=O,,,5,1,1,0,1
60112_0,,,,2,1,2,3
C1(C(CCO)(C(C)(CO1)O)O)=O,,,5,1,1,0,1
60113_0,,,,2,1,2,3
60114_0,,,,2,1,2,3
60115_0,,,,2,1,2,3
60116_0,,,,2,1,2,3
60117_0,,,,2,1,2,3
60119_0,,,,2,1,2,3
C1(C(C(CO1)O)(CCO)O)=O,,,5,1,1,0,1
60120_0,,,,2,1,2,3
60122_0,,,,2,1,2,3
C1(CC(C(C(C=O)=O)(C)O1)O)=O,,,5,1,1,0,1
60124_0,,,,2,1,2,3
C1(C(C(C)(CO1)O)(CC=O)O)=O,,,5,1,1,0,1
60126_0,,,,2,1,2,3
C(C1(C(CO)(C)OC(C1)=O)O)=O,,,5,1,1,0,1
60128_0,,,,2,1,2,3
C(C1(C(CC(O1)=O)O)CCO)=O,,,5,1,1,0,1
60130_0,,,,2,1,2,3
C1(C(C(C(O1)=O)(CC=O)O)O)=O,,,5,1,1,0,1
60132_0,,,,2,1,2,3
C1(CC(C=O)(C(C(O)=O)O1)O)=O,,,5,1,1,0,1
60134_0,,,,2,1,2,3
C1(CC(C2(C(CCO2)=O)O1)O)=O,,,5,1,1,0,1
60136_0,,,,2,1,2,3
C1(C(C2(COCC2O1)O)O)=O,,,5,1,1,0,1
60138_0,,,,2,1,2,3
C1(C(C2(C(OCC2)O1)O)O)=O,,,5,1,1,0,1
60139_0,,,,2,1,2,3
60140_0,,,,2,1,2,3
60141_0,,,,2,1,2,3
60142_0,,,,2,1,2,3
60143_0,,,,2,1,2,3
60144_0,,,,2,1,2,3
60145_0,,,,2,1,2,3
60146_0,,,,2,1,1,2
60147_0,,,,2,1,1,2
60148_0,,,,2,1,1,2
60149_0,,,,2,1,1,2
60150_0,,,,2,1,1,2
60151_0,,,,2,1,1,2
60152_0,,,,2,1,1,2
60153_0,,,,2,1,1,2
60154_0,,,,2,1,1,2
60155_0,,,,2,1,1,2
60156_0,,,,2,1,2,3
60157_0,,,,2,1,2,3
60158_0,,,,2,1,2,3
60160_0,,,,2,1,2,3
C1(C2(COC(C2O)O1)O)=O,,,5,1,1,0,1
60161_0,,,,2,1,2,3
60163_0,,,,2,1,2,3
C1(C2(C(CO)OC(C2O)O1)O)=O,,,5,1,1,0,1
60165_0,,,,2,1,2,3
C1(C2(COC(C2(C)O)O1)O)=O,,,5,1,1,0,1
60167_0,,,,2,1,2,3
C1(C2(COC(C)(C2O)O1)O)=O,,,5,1,1,0,1
60168_0,,,,2,1,2,3
60169_0,,,,2,1,2,3
60170_0,,,,2,1,2,3
60171_0,,,,2,1,2,3
60172_0,,,,2,1,2,3
60173_0,,,,2,1,2,3
60174_0,,,,2,1,2,3
60176_0,,,,2,1,2,3
C1(C2(C(COC(C2O)O1)O)O)=O,,,5,1,1,0,1
60177_0,,,,2,1,2,3
60178_0,,,,2,1,2,3
60179_0,,,,2,1,1,2
60180_0,,,,2,1,1,2
60181_0,,,,2,1,1,2
60182_0,,,,2,1,1,2
60183_0,,,,2,1,1,2
60184_0,,,,2,1,1,2
60185_0,,,,2,1,1,2
60187_0,,,,2,1,2,3
C1(C(CC(C(CC=O)O1)=O)O)=O,,,5,1,1,0,1
60189_0,,,,2,1,2,3
C1(C(C=O)C(C(C=O)CO1)O)=O,,,5,1,1,0,1
60191_0,,,,2,1,2,3
C1(C(C=O)C(CC(C)O1)O)=O,,,5,1,1,0,1
60193_0,,,,2,1,2,3
C(C1C(CC(OC1C)=O)O)=O,,,5,1,1,0,1
60195_0,,,,2,1,2,3
C1(C(CC(C(C(C)O)O1)O)=O)=O,,,5,1,1,0,1
60197_0,,,,2,1,2,3
C1(C(C=O)C(C(C(C)O1)O)O)=O,,,5,1,1,0,1
60199_0,,,,2,1,2,3
C1(C(C=O)C(CCO1)O)=O,,,5,1,1,0,1
60201_0,,,,2,1,2,3
C1(C(C(CO)=O)C(CCO1)O)=O,,,5,1,1,0,1
60203_0,,,,2,1,2,3
C1(CC(C(C(CCO)O1)O)=O)=O,,,5,1,1,0,1
60205_0,,,,2,1,2,3
C1(C(C(CC(CCO)O1)=O)O)=O,,,5,1,1,0,1
60207_0,,,,2,1,2,3
C(C1COC(CC1O)=O)=O,,,5,1,1,0,1
60209_0,,,,2,1,2,3
C(C1COC(CC1(CO)O)=O)=O,,,5,1,1,0,1
60211_0,,,,2,1,2,3
C(C1COC(C(C1(C)O)O)=O)=O,,,5,1,1,0,1
60213_0,,,,2,1,2,3
C1(C(C=O)C(CC(CO)O1)O)=O,,,5,1,1,0,1
60214_0,,,,2,1,2,3
60216_0,,,,2,1,2,3
C(C1C(COC(C1(C)O)=O)O)=O,,,5,1,1,0,1
60218_0,,,,2,1,2,3
C(C1C(CC(OC1CO)=O)O)=O,,,5,1,1,0,1
60220_0,,,,2,1,2,3
C(C1(COC(C(C1)=O)=O)O)=O,,,5,1,1,0,1
60222_0,,,,2,1,2,3
C1(C(C=O)C(C(CO1)=O)O)=O,,,5,1,1,0,1
60224_0,,,,2,1,2,3
C(C)(C1(COC(C(C1)=O)=O)O)=O,,,5,1,1,0,1
60226_0,,,,2,1,2,3
C1(C(C=O)C(C(CO1)=O)(C)O)=O,,,5,1,1,0,1
60228_0,,,,2,1,2,3
C(C1(C(C)OC(C(C1)=O)=O)O)=O,,,5,1,1,0,1
60230_0,,,,2,1,2,3
C1(C(C=O)C(C(C(C)O1)=O)O)=O,,,5,1,1,0,1
60232_0,,,,2,1,2,3
C1(C(CC(C)(CO1)O)=O)=O,,,5,1,1,0,1
60234_0,,,,2,1,2,3
C1(C(C(CO)C(C)(CO1)O)=O)=O,,,5,1,1,0,1
60236_0,,,,2,1,2,3
C(C1C(C)(COC(C1O)=O)O)=O,,,5,1,1,0,1
60238_0,,,,2,1,2,3
C1(CC(C(C(CO)(C)O1)O)=O)=O,,,5,1,1,0,1
60240_0,,,,2,1,2,3
C1(C(C(CC(CO)(C)O1)=O)O)=O,,,5,1,1,0,1
60241_0,,,,2,1,2,3
60243_0,,,,2,1,2,3
C1(CC(C(C(C(C)=O)O1)O)O)=O,,,5,1,1,0,1
60245_0,,,,2,1,2,3
C1(C(C)(CC(CO1)=O)O)=O,,,5,1,1,0,1
60247_0,,,,2,1,2,3
C1(C(CCO)(CC(CO1)=O)O)=O,,,5,1,1,0,1
60249_0,,,,2,1,2,3
C1(C(CC(CO1)(CCO)O)=O)=O,,,5,1,1,0,1
60251_0,,,,2,1,2,3
C1(C(C=O)C(CO)(CCO1)O)=O,,,5,1,1,0,1
60252_0,,,,2,1,2,3
60254_0,,,,2,1,2,3
C1(C(C)(C(C(CO1)=O)CO)O)=O,,,5,1,1,0,1
60256_0,,,,2,1,2,3
C1(CC(C(C(CO)=O)CO1)O)=O,,,5,1,1,0,1
60258_0,,,,2,1,2,3
C1(C(CC(C(CCO)O1)O)=O)=O,,,5,1,1,0,1
60260_0,,,,2,1,2,3
C1(C(CC(C)(C(CO)O1)O)=O)=O,,,5,1,1,0,1
60262_0,,,,2,1,2,3
C1(C(C=O)C(C)(C(CO1)O)O)=O,,,5,1,1,0,1
60264_0,,,,2,1,2,3
C1(C(C)(CC(C(CO)O1)=O)O)=O,,,5,1,1,0,1
60266_0,,,,2,1,2,3
C1(C(CC(C(O1)=O)=O)O)=O,,,5,1,1,0,1
60268_0,,,,2,1,2,3
C1(C(C(C(C(O1)=O)=O)CO)O)=O,,,5,1,1,0,1
60270_0,,,,2,1,2,3
C1(C(C(C=O)C(C(O1)=O)O)O)=O,,,5,1,1,0,1
60271_0,,,,2,1,2,3
60273_0,,,,2,1,2,3
C1(CC(C(C(C(O)=O)O1)O)=O)=O,,,5,1,1,0,1
60275_0,,,,2,1,2,3
C1(C(C(CC(C(O)=O)O1)=O)O)=O,,,5,1,1,0,1
60276_0,,,,2,1,2,3
60278_0,,,,2,1,2,3
C1(C(C2C(C(CO2)O1)=O)O)=O,,,5,1,1,0,1
60280_0,,,,2,1,2,3
C1(C(C2C(C(OC2)O1)=O)O)=O,,,5,1,1,0,1
60282_0,,,,2,1,2,3
C1(C(C(C(CO1)=O)O)O)=O,,,5,1,1,0,1
60284_0,,,,2,1,2,3
C1(C(C(C(OC1CO)=O)O)O)=O,,,5,1,1,0,1
60286_0,,,,2,1,2,3
C(C1C(COC(C1O)=O)=O)=O,,,5,1,1,0,1
60288_0,,,,2,1,2,3
C(C1C(CC(C(O1)=O)O)=O)=O,,,5,1,1,0,1
60290_0,,,,2,1,2,3
C1(C(C)(CC(C(O1)=O)=O)O)=O,,,5,1,1,0,1
60292_0,,,,2,1,2,3
C1(C(C)(C2C(C(CO2)O1)=O)O)=O,,,5,1,1,0,1
60294_0,,,,2,1,2,3
C1(C(C)(C2C(C(OC2)O1)=O)O)=O,,,5,1,1,0,1
60296_0,,,,2,1,2,3
C1(C(C)(C(C(CO1)=O)O)O)=O,,,5,1,1,0,1
60298_0,,,,2,1,2,3
C1(C(C)(C(C=O)C(CO1)=O)O)=O,,,5,1,1,0,1
60300_0,,,,2,1,2,3
C1(C(C)(CC(C(C=O)O1)=O)O)=O,,,5,1,1,0,1
60302_0,,,,2,1,2,3
C1(C(CC2(COCC2O1)O)=O)=O,,,5,1,1,0,1
60304_0,,,,2,1,2,3
C1(C(CC2(C(OCC2)O1)O)=O)=O,,,5,1,1,0,1
60305_0,,,,2,1,2,3
60307_0,,,,2,1,2,3
C(CC1C(CC(C(O1)=O)=O)O)=O,,,5,1,1,0,1
60309_0,,,,2,1,2,3
C(CC1(COC(C(C1)=O)=O)O)=O,,,5,1,1,0,1
60311_0,,,,2,1,2,3
C(C)(C1C(CC(C(O1)=O)=O)O)=O,,,5,1,1,0,1
60313_0,,,,2,1,2,3
C(C1C(C)(CC(C(O1)=O)=O)O)=O,,,5,1,1,0,1
60315_0,,,,2,1,2,3
C1(C(C=O)C(CC(O1)=O)O)=O,,,5,1,1,0,1
60317_0,,,,2,1,2,3
C1(CC(C2C(COC2O1)=O)O)=O,,,5,1,1,0,1
60319_0,,,,2,1,2,3
C1(CC(C(C(C=O)=O)CO1)O)=O,,,5,1,1,0,1
60321_0,,,,2,1,2,3
C1(CC(C(C=O)C(C=O)O1)O)=O,,,5,1,1,0,1
60323_0,,,,2,1,2,3
C1(C(C=O)C2(COC(C2)O1)O)=O,,,5,1,1,0,1
60324_0,,,,2,1,2,3
60326_0,,,,2,1,2,3
C1(C(C=O)C(C=O)(CCO1)O)=O,,,5,1,1,0,1
60328_0,,,,2,1,2,3
C1(C(C=O)C(CC(C=O)O1)O)=O,,,5,1,1,0,1
60329_0,,,,2,1,2,3
60331_0,,,,2,1,2,3
C1(C(CC(C(C=O)O1)O)O)=O,,,5,1,1,0,1
60333_0,,,,2,1,2,3
C1(CC(C(C(C=O)O1)O)O)=O,,,5,1,1,0,1
60335_0,,,,2,1,2,3
C1(CC(C(C(C=O)O1)O)=O)=O,,,5,1,1,0,1
60337_0,,,,2,1,2,3
C(C1(C)C(C(CC(O1)=O)=O)O)=O,,,5,1,1,0,1
60339_0,,,,2,1,2,3
C1(CC(C(C(C(C)=O)O1)O)=O)=O,,,5,1,1,0,1
60341_0,,,,2,1,2,3
C(CC1C(C(CC(O1)=O)=O)O)=O,,,5,1,1,0,1
60343_0,,,,2,1,2,3
C1(CC(C(C(C)O1)O)=O)=O,,,5,1,1,0,1
60345_0,,,,2,1,2,3
C1(C(C(CC(C=O)O1)=O)O)=O,,,5,1,1,0,1
60347_0,,,,2,1,2,3
C(C1(C)CC(C(C(O1)=O)O)=O)=O,,,5,1,1,0,1
60349_0,,,,2,1,2,3
C1(C(C(CC(C(C)=O)O1)=O)O)=O,,,5,1,1,0,1
60351_0,,,,2,1,2,3
C1(C(C(CC(CC=O)O1)=O)O)=O,,,5,1,1,0,1
60353_0,,,,2,1,2,3
C1(C(C(CC(C)O1)=O)O)=O,,,5,1,1,0,1
60355_0,,,,2,1,2,3
C1(C(C(C(C(C=O)O1)O)O)O)=O,,,5,1,1,0,1
60357_0,,,,2,1,2,3
C(CC1CC(C(C(O1)=O)O)O)=O,,,5,1,1,0,1
60359_0,,,,2,1,2,3
C(C1C(C(C(OC1C)=O)O)O)=O,,,5,1,1,0,1
60360_0,,,,2,1,2,3
60361_0,,,,2,1,2,3
60362_0,,,,2,1,2,3
60363_0,,,,2,1,2,3
60364_0,,,,2,1,2,3
60365_0,,,,2,1,2,3
60366_0,,,,2,1,2,3
60367_0,,,,2,1,2,3
60368_0,,,,2,1,2,3
60369_0,,,,2,1,2,3
60371_0,,,,2,1,2,3
C1(C(C(C(CO)C(C)O1)=O)O)=O,,,5,1,1,0,1
60372_0,,,,2,1,2,3
60373_0,,,,2,1,2,3
60374_0,,,,2,1,2,3
60375_0,,,,2,1,2,3
60376_0,,,,2,1,2,3
60377_0,,,,2,1,2,3
60378_0,,,,2,1,2,3
60379_0,,,,2,1,2,3
60380_0,,,,2,1,2,3
60381_0,,,,2,1,2,3
60382_0,,,,2,1,2,3
60383_0,,,,2,1,2,3
60384_0,,,,2,1,2,3
60385_0,,,,2,1,2,3
60387_0,,,,2,1,2,3
C1(C(CO)(C(CCO1)O)O)=O,,,5,1,1,0,1
60389_0,,,,2,1,2,3
C1(C(C(CCO1)O)O)=O,,,5,1,1,0,1
60390_0,,,,2,1,2,3
60391_0,,,,2,1,2,3
60393_0,,,,2,1,2,3
C1(C(C(C)(C(CO1)O)O)O)=O,,,5,1,1,0,1
60394_0,,,,2,1,2,3
60395_0,,,,2,1,2,3
60396_0,,,,2,1,2,3
60397_0,,,,2,1,2,3
60398_0,,,,2,1,2,3
60399_0,,,,2,1,2,3
60401_0,,,,2,1,2,3
C1(C(C(C(CO1)O)O)=O)=O,,,5,1,1,0,1
60403_0,,,,2,1,2,3
C1(C(C(C(C(CO)O1)O)O)=O)=O,,,5,1,1,0,1
60405_0,,,,2,1,2,3
C1(COC(C(C1(CO)O)O)=O)=O,,,5,1,1,0,1
60407_0,,,,2,1,2,3
C(C1(C(COC(C1O)=O)O)O)=O,,,5,1,1,0,1
60409_0,,,,2,1,2,3
C1(C(CO)(C(CC(O1)=O)O)O)=O,,,5,1,1,0,1
60411_0,,,,2,1,2,3
C(C1(COC(CC1O)=O)O)(O)=O,,,5,1,1,0,1
60413_0,,,,2,1,2,3
C(C1(COC(CC1O)=O)O)=O,,,5,1,1,0,1
60415_0,,,,2,1,2,3
C1(CC(C(C(O1)=O)O)O)=O,,,5,1,1,0,1
60416_0,,,,2,1,2,3
60417_0,,,,2,1,2,3
60419_0,,,,2,1,2,3
C1(CC(C(C(C(O)=O)O1)O)O)=O,,,5,1,1,0,1
60420_0,,,,2,1,2,3
60422_0,,,,2,1,2,3
C1(C(CC(C(C(O)=O)O1)O)O)=O,,,5,1,1,0,1
60424_0,,,,2,1,2,3
C1(CC(CO)(C(C(O1)=O)O)O)=O,,,5,1,1,0,1
60426_0,,,,2,1,2,3
C1(C(C(C)(C(C(O1)=O)O)O)O)=O,,,5,1,1,0,1
60427_0,,,,2,1,2,3
60428_0,,,,2,1,2,3
60430_0,,,,2,1,2,3
C(C1(C=O)COC(CC1O)=O)=O,,,5,1,1,0,1
60432_0,,,,2,1,1,2
C1(C(C(CO)O)C(CC(C)O1)O)=O,,,5,1,1,0,1
60434_0,,,,2,1,2,3
C1(C(CO)(C(CC(C)O1)O)O)=O,,,5,1,1,0,1
60436_0,,,,2,1,2,3
C(C1(C(CC(OC1C)=O)O)O)=O,,,5,1,1,0,1
60438_0,,,,2,1,2,3
C1(C(C(CCO1)O)C(C=O)O)=O,,,5,1,1,0,1
60440_0,,,,2,1,2,3
C1(C(C(C)=O)(C(CCO1)O)O)=O,,,5,1,1,0,1
60442_0,,,,2,1,2,3
C1(C(C(C)O)(C(CCO1)O)O)=O,,,5,1,1,0,1
60444_0,,,,2,1,1,2
C1(C(C(CO)O)C(CCO1)O)=O,,,5,1,1,0,1
60446_0,,,,2,1,1,2
C1(C(C(CO)O)(C(CCO1)O)O)=O,,,5,1,1,0,1
60448_0,,,,2,1,1,2
C1(C(C(CO)O)C(C(CO1)=O)O)=O,,,5,1,1,0,1
60450_0,,,,2,1,2,3
C1(C(CO)(C(C(CO1)=O)O)O)=O,,,5,1,1,0,1
60452_0,,,,2,1,2,3
C1(CC(C(C(C)=O)(CO1)O)O)=O,,,5,1,1,0,1
60454_0,,,,2,1,1,2
C1(C(C(CC(O1)=O)O)C(CO)O)=O,,,5,1,1,0,1
60456_0,,,,2,1,2,3
C1(C2C(CC(OC2CO1)=O)O)=O,,,5,1,1,0,1
60458_0,,,,2,1,2,3
C1(CC(C(CO)(C(C)O1)O)=O)=O,,,5,1,1,0,1
60459_0,,,,2,1,2,3
60460_0,,,,2,1,2,3
60461_0,,,,2,1,2,3
60462_0,,,,2,1,1,2
60464_0,,,,2,1,2,3
C(C1(C)CC(C(C(O1)=O)O)O)=O,,,5,1,1,0,1
60466_0,,,,2,1,2,3
C1(C(C(CC(C(C)=O)O1)O)O)=O,,,5,1,1,0,1
60468_0,,,,2,1,2,3
C(C1(CC(C)OC(C1O)=O)O)=O,,,5,1,1,0,1
60470_0,,,,2,1,2,3
C(C1COC(C(C1O)(C)O)=O)=O,,,5,1,1,0,1
60472_0,,,,2,1,2,3
C1(C(C)(C(CC(C)O1)O)O)=O,,,5,1,1,0,1
60474_0,,,,2,1,2,3
C1(C(C(CC(C)O1)O)O)=O,,,5,1,1,0,1
60476_0,,,,2,1,2,3
C1(C(C)(C(C(C(C)O1)O)O)O)=O,,,5,1,1,0,1
60478_0,,,,2,1,2,3
C1(C(C(C(C(C)O1)O)O)O)=O,,,5,1,1,0,1
60480_0,,,,2,1,2,3
C1(C(C)(C(CCO1)O)O)=O,,,5,1,1,0,1
60482_0,,,,2,1,2,3
C1(C(CCO)(C(CCO1)O)O)=O,,,5,1,1,0,1
60484_0,,,,2,1,2,3
C1(C(C(CCO1)O)(CC=O)O)=O,,,5,1,1,0,1
60486_0,,,,2,1,2,3
C1(C(C)(C(CC(CO)O1)O)O)=O,,,5,1,1,0,1
60488_0,,,,2,1,2,3
C1(C(C)(C(C(CO1)=O)(C)O)O)=O,,,5,1,1,0,1
60490_0,,,,2,1,2,3
C1(C(C)(C(C(C(C)O1)=O)O)O)=O,,,5,1,1,0,1
60492_0,,,,2,1,2,3
C1(C(C)(C(CO)(CCO1)O)O)=O,,,5,1,1,0,1
60494_0,,,,2,1,2,3
C1(C(C)(C(C)(C(CO1)O)O)O)=O,,,5,1,1,0,1
60496_0,,,,2,1,2,3
C1(C(C)(C(CC(O1)=O)O)O)=O,,,5,1,1,0,1
60498_0,,,,2,1,2,3
C1(C(C)(C2(COC(C2)O1)O)O)=O,,,5,1,1,0,1
60500_0,,,,2,1,2,3
C1(C(C)(C(C(CO1)O)O)O)=O,,,5,1,1,0,1
60502_0,,,,2,1,2,3
C1(C(C)(C(C=O)(CCO1)O)O)=O,,,5,1,1,0,1
60504_0,,,,2,1,2,3
C1(C(C)(C(CC(C=O)O1)O)O)=O,,,5,1,1,0,1
60506_0,,,,2,1,2,3
C(C1(C(C)(COC(C1)=O)O)O)=O,,,5,1,1,0,1
60508_0,,,,2,1,2,3
C1(CC(C=O)(C(C(O1)=O)O)O)=O,,,5,1,1,0,1
60509_0,,,,2,1,2,3
60511_0,,,,2,1,2,3
C1(C(C2(COC(C2)O1)O)O)=O,,,5,1,1,0,1
60512_0,,,,2,1,2,3
60513_0,,,,2,1,2,3
60514_0,,,,2,1,2,3
60515_0,,,,2,1,1,2
60516_0,,,,2,1,1,2
60517_0,,,,2,1,1,2
60518_0,,,,2,1,1,2
60519_0,,,,2,1,1,2
60521_0,,,,2,1,2,3
C1(C2(CO)C(CC(O2)O1)O)=O,,,5,1,1,0,1
60523_0,,,,2,1,2,3
C1(C2C(CC(O2)O1)O)=O,,,5,1,1,0,1
60524_0,,,,2,1,2,3
60526_0,,,,2,1,2,3
C1(C2C(CC(CO)(O2)O1)O)=O,,,5,1,1,0,1
60528_0,,,,2,1,2,3
C1(C2C(CO)(CC(O2)O1)O)=O,,,5,1,1,0,1
60530_0,,,,2,1,2,3
C1(C2C(C(C(C)(O2)O1)O)O)=O,,,5,1,1,0,1
60532_0,,,,2,1,2,3
C1(C2C(C)(C(C(O2)O1)O)O)=O,,,5,1,1,0,1
60533_0,,,,2,1,2,3
60534_0,,,,2,1,2,3
60536_0,,,,2,1,2,3
C1(C2(COC(CC2O)O1)O)=O,,,5,1,1,0,1
60537_0,,,,2,1,2,3
60538_0,,,,2,1,2,3
60539_0,,,,2,1,1,2
60540_0,,,,2,1,1,2
60542_0,,,,2,1,2,3
C(C1COC(C(CC1O)=O)=O)=O,,,5,1,1,0,1
60544_0,,,,2,1,2,3
C1(C(CC(CC(C)O1)O)=O)=O,,,5,1,1,0,1
60546_0,,,,2,1,2,3
C1(C(CC(C(C(C)O1)O)O)=O)=O,,,5,1,1,0,1
60548_0,,,,2,1,2,3
C1(C(CC(CCO1)O)=O)=O,,,5,1,1,0,1
60550_0,,,,2,1,2,3
C1(C(C(CO)C(CCO1)O)=O)=O,,,5,1,1,0,1
60552_0,,,,2,1,2,3
C(C1C(CCOC(C1O)=O)O)=O,,,5,1,1,0,1
60554_0,,,,2,1,2,3
C(C1COC(C(CC1O)O)=O)=O,,,5,1,1,0,1
60556_0,,,,2,1,2,3
C(C1COC(CC(C1O)O)=O)=O,,,5,1,1,0,1
60558_0,,,,2,1,2,3
C1(C(CC(CC(CO)O1)O)=O)=O,,,5,1,1,0,1
60560_0,,,,2,1,2,3
C1(C(C=O)C(CC(CO1)O)O)=O,,,5,1,1,0,1
60562_0,,,,2,1,2,3
C(C1C(CC(OCC1O)=O)O)=O,,,5,1,1,0,1
60564_0,,,,2,1,2,3
C1(COC(C(CC1O)=O)=O)=O,,,5,1,1,0,1
60566_0,,,,2,1,2,3
C1(COC(C(CC1(C)O)=O)=O)=O,,,5,1,1,0,1
60568_0,,,,2,1,2,3
C1(C(CC(C(CO1)=O)=O)O)=O,,,5,1,1,0,1
60570_0,,,,2,1,2,3
C1(C(C)(CC(C(CO1)=O)=O)O)=O,,,5,1,1,0,1
60572_0,,,,2,1,2,3
C1(C(CC(C(OC1C)=O)=O)O)=O,,,5,1,1,0,1
60574_0,,,,2,1,2,3
C1(CC(C(C(C)(CO1)O)O)=O)=O,,,5,1,1,0,1
60576_0,,,,2,1,2,3
C1(C(C(CC(C)(CO1)O)=O)O)=O,,,5,1,1,0,1
60577_0,,,,2,1,2,3
60579_0,,,,2,1,2,3
C1(CC(CO)(CC(CO1)=O)O)=O,,,5,1,1,0,1
60581_0,,,,2,1,2,3
C1(C(C(C)(CC(CO1)=O)O)O)=O,,,5,1,1,0,1
60583_0,,,,2,1,2,3
C1(C(CC(CO)(CCO1)O)=O)=O,,,5,1,1,0,1
60585_0,,,,2,1,2,3
C1(C(C)(C(C(CCO1)=O)O)O)=O,,,5,1,1,0,1
60587_0,,,,2,1,2,3
C1(CC(C(C(CO1)=O)CO)O)=O,,,5,1,1,0,1
60589_0,,,,2,1,2,3
C1(C(C=O)C(C(CCO1)O)O)=O,,,5,1,1,0,1
60591_0,,,,2,1,2,3
C1(C(CC(C)(C(CO1)O)O)=O)=O,,,5,1,1,0,1
60593_0,,,,2,1,2,3
C1(C(C)(CC(C(CO1)O)=O)O)=O,,,5,1,1,0,1
60595_0,,,,2,1,2,3
C1(CC(CC(C(CO)O1)=O)O)=O,,,5,1,1,0,1
60597_0,,,,2,1,2,3
C1(CC(C(C(C(O1)=O)O)O)=O)=O,,,5,1,1,0,1
60599_0,,,,2,1,2,3
C1(C(C(CC(C(O1)=O)O)=O)O)=O,,,5,1,1,0,1
60601_0,,,,2,1,2,3
C1(C(C2C(CC(O2)O1)=O)O)=O,,,5,1,1,0,1
60603_0,,,,2,1,2,3
C1(C(C(C(OCC1O)=O)O)O)=O,,,5,1,1,0,1
60605_0,,,,2,1,2,3
C1(C(C)(C2C(CC(O2)O1)=O)O)=O,,,5,1,1,0,1
60607_0,,,,2,1,2,3
C1(CC(CC(C(O1)=O)=O)O)=O,,,5,1,1,0,1
60609_0,,,,2,1,2,3
C1(C(CC2(COC(C2)O1)O)=O)=O,,,5,1,1,0,1
60611_0,,,,2,1,2,3
C(C1(CCOC(C(C1)=O)=O)O)=O,,,5,1,1,0,1
60613_0,,,,2,1,2,3
C(C1CC(CC(C(O1)=O)=O)O)=O,,,5,1,1,0,1
60615_0,,,,2,1,2,3
C1(CC(C2C(C(CO2)O1)=O)O)=O,,,5,1,1,0,1
60617_0,,,,2,1,2,3
C1(CC(C2C(C(OC2)O1)=O)O)=O,,,5,1,1,0,1
60619_0,,,,2,1,2,3
C1(CC(C(C(CO1)=O)O)O)=O,,,5,1,1,0,1
60621_0,,,,2,1,2,3
C1(CC(C(C=O)C(CO1)=O)O)=O,,,5,1,1,0,1
60623_0,,,,2,1,2,3
C(C1C(CC(CC(O1)=O)O)=O)=O,,,5,1,1,0,1
60625_0,,,,2,1,2,3
C1(C(C=O)C(C(CCO1)=O)O)=O,,,5,1,1,0,1
60627_0,,,,2,1,2,3
C1(C(C=O)C(CC(CO1)=O)O)=O,,,5,1,1,0,1
60629_0,,,,2,1,2,3
C1(C(C(C(OC(C)C1)=O)O)O)=O,,,5,1,1,0,1
60631_0,,,,2,1,2,3
C1(CC(C(OC(C)C1O)=O)O)=O,,,5,1,1,0,1
60632_0,,,,2,1,2,3
60633_0,,,,2,1,2,3
60634_0,,,,2,1,2,3
60635_0,,,,2,1,2,3
60636_0,,,,2,1,2,3
60637_0,,,,2,1,2,3
60638_0,,,,2,1,2,3
60640_0,,,,2,1,2,3
C1(C(C(C(CCO1)O)O)O)=O,,,5,1,1,0,1
60642_0,,,,2,1,2,3
C1(C(C(CC(CO1)O)O)O)=O,,,5,1,1,0,1
60643_0,,,,2,1,2,3
60644_0,,,,2,1,2,3
60646_0,,,,2,1,2,3
C1(C(C(C(C(CO1)O)O)O)=O)=O,,,5,1,1,0,1
60648_0,,,,2,1,2,3
C1(CC(C(C(C(O1)=O)O)O)O)=O,,,5,1,1,0,1
60650_0,,,,2,1,2,3
C1(C(C(CC(C(O1)=O)O)O)O)=O,,,5,1,1,0,1
60652_0,,,,2,1,2,3
C(C1(C(CCOC(C1)=O)O)O)=O,,,5,1,1,0,1
60654_0,,,,2,1,2,3
C1(C(C)(C(CC(CO1)O)O)O)=O,,,5,1,1,0,1
60656_0,,,,2,1,2,3
C1(C(C)(C(C(CCO1)O)O)O)=O,,,5,1,1,0,1
60658_0,,,,2,1,2,3
C1(C(C)(C(CC(CO1)=O)O)O)=O,,,5,1,1,0,1
60660_0,,,,2,1,2,3
C(C1(C(CC(OCC1)=O)O)O)=O,,,5,1,1,0,1
60661_0,,,,2,1,2,3
60662_0,,,,2,1,2,3
60663_0,,,,2,1,2,3
60664_0,,,,2,1,2,3
60666_0,,,,2,1,2,3
C1(C(C2C(CC(O2)O1)O)O)=O,,,5,1,1,0,1
60668_0,,,,2,1,2,3
C1(C(C2CC(C(O2)O1)O)O)=O,,,5,1,1,0,1
60669_0,,,,2,1,2,3
60670_0,,,,2,1,2,3
60672_0,,,,2,1,2,3
C1(C2C(C(CC(O2)O1)O)O)=O,,,5,1,1,0,1
60674_0,,,,2,1,2,3
C1(C2C(CC(C(O2)O1)O)O)=O,,,5,1,1,0,1
60675_0,,,,2,1,1,2
60676_0,,,,2,1,1,2
60677_0,,,,2,1,1,2
60678_0,,,,2,1,1,2
60679_0,,,,2,1,1,2
60680_0,,,,2,1,1,2
60681_0,,,,2,1,1,2
60682_0,,,,2,1,1,2
60683_0,,,,2,1,1,2
60684_0,,,,2,1,1,2
60685_0,,,,2,1,1,2
60686_0,,,,2,1,1,2
60687_0,,,,2,1,1,2
60688_0,,,,2,1,1,2
60689_0,,,,2,1,1,2
60690_0,,,,2,1,1,2
60691_0,,,,2,1,1,2
60692_0,,,,2,1,1,2
60693_0,,,,2,1,1,2
60694_0,,,,2,1,1,2
60695_0,,,,2,1,1,2
60696_0,,,,2,1,1,2
60697_0,,,,2,1,1,2
60698_0,,,,2,1,1,2
60699_0,,,,2,1,1,2
60700_0,,,,2,1,1,2
60701_0,,,,2,1,1,2
60702_0,,,,2,1,1,2
60703_0,,,,2,1,1,2
60704_0,,,,2,1,1,2
60705_0,,,,2,1,1,2
60706_0,,,,2,1,1,2
60707_0,,,,2,1,1,2
60708_0,,,,2,1,1,2
60709_0,,,,2,1,1,2
60710_0,,,,2,1,1,2
60711_0,,,,2,1,1,2
60712_0,,,,2,1,1,2
60713_0,,,,2,1,1,2
60714_0,,,,2,1,1,2
60715_0,,,,2,1,1,2
60716_0,,,,2,1,1,2
60717_0,,,,2,1,1,2
60718_0,,,,2,1,1,2
60719_0,,,,2,1,1,2
60720_0,,,,2,1,1,2
60721_0,,,,2,1,1,2
60722_0,,,,2,1,1,2
60723_0,,,,2,1,1,2
60724_0,,,,2,1,1,2
60725_0,,,,2,1,1,2
60726_0,,,,2,1,1,2
60727_0,,,,2,1,1,2
60728_0,,,,2,1,1,2
60729_0,,,,2,1,1,2
60730_0,,,,2,1,1,2
60731_0,,,,2,1,1,2
60732_0,,,,2,1,1,2
60733_0,,,,2,1,1,2
60734_0,,,,2,1,1,2
60735_0,,,,2,1,1,2
60736_0,,,,2,1,1,2
60737_0,,,,2,1,1,2
60738_0,,,,2,1,1,2
60739_0,,,,2,1,1,2
60740_0,,,,2,1,1,2
60741_0,,,,2,1,1,2
60742_0,,,,2,1,1,2
60743_0,,,,2,1,1,2
60744_0,,,,2,1,1,2
60745_0,,,,2,1,1,2
60746_0,,,,2,1,1,2
60747_0,,,,2,1,1,2
60748_0,,,,2,1,1,2
60749_0,,,,2,1,1,2
60750_0,,,,2,1,1,2
60751_0,,,,2,1,1,2
60752_0,,,,2,1,1,2
60753_0,,,,2,1,1,2
60754_0,,,,2,1,1,2
60755_0,,,,2,1,1,2
60756_0,,,,2,1,1,2
60757_0,,,,2,1,1,2
60758_0,,,,2,1,1,2
60759_0,,,,2,1,1,2
60760_0,,,,2,1,1,2
60761_0,,,,2,1,1,2
60762_0,,,,2,1,1,2
60763_0,,,,2,1,1,2
60764_0,,,,2,1,1,2
60765_0,,,,2,1,1,2
60766_0,,,,2,1,1,2
60767_0,,,,2,1,1,2
60768_0,,,,2,1,1,2
60769_0,,,,2,1,1,2
60770_0,,,,2,1,1,2
60771_0,,,,2,1,1,2
60772_0,,,,2,1,1,2
60773_0,,,,2,1,1,2
60774_0,,,,2,1,1,2
60775_0,,,,2,1,1,2
60776_0,,,,2,1,1,2
60777_0,,,,2,1,1,2
60778_0,,,,2,1,1,2
60779_0,,,,2,1,1,2
60780_0,,,,2,1,1,2
60782_0,,,,2,1,1,2
C(CC1C(C(C(C1O)O)O)O)=O,,,5,1,1,0,1
60784_0,,,,2,1,1,2
C(C1CC(C(C1O)=O)O)=O,,,5,1,1,0,1
60786_0,,,,2,1,1,2
C(C1C(CO)C(C(C1O)=O)O)=O,,,5,1,1,0,1
60787_0,,,,2,1,1,2
60789_0,,,,2,1,1,2
C(C1CC(C(C1O)=O)(CO)O)=O,,,5,1,1,0,1
60790_0,,,,2,1,1,2
60792_0,,,,2,1,1,2
C1(C(CC(C=O)C1C=O)O)=O,,,5,1,1,0,1
60794_0,,,,2,1,1,2
C(C1CC(C=O)C(C1O)=O)=O,,,5,1,1,0,1
60796_0,,,,2,1,1,2
C(C1CC(C=O)(C(C1)=O)O)=O,,,5,1,1,0,1
60797_0,,,,2,1,1,2
60798_0,,,,2,1,1,2
60799_0,,,,2,1,1,2
60800_0,,,,2,1,1,2
60801_0,,,,2,1,1,2
60802_0,,,,2,1,1,2
60803_0,,,,2,1,1,2
60805_0,,,,2,1,1,2
C(C1CC(C(C1(CO)O)=O)O)=O,,,5,1,1,0,1
60807_0,,,,2,1,1,2
C1(CCC(C=O)C1(C=O)O)=O,,,5,1,1,0,1
60809_0,,,,2,1,1,2
C(C1CC(C(C1(C=O)O)O)O)=O,,,5,1,1,0,1
60810_0,,,,2,1,1,2
60811_0,,,,2,1,1,2
60812_0,,,,2,1,1,2
60814_0,,,,2,1,1,2
C(C1C(C(C(C1)=O)O)O)(O)=O,,,5,1,1,0,1
60816_0,,,,2,2,1,3
C(CC(C)C1(CC(C(C1)=O)O)O)=O,,,5,1,1,0,1
60818_0,,,,2,2,1,3
C(CCC1(CC(C(C1)=O)O)O)=O,,,5,1,1,0,1
60820_0,,,,2,2,1,3
C(CCC1(CC(C(C1)=O)O)O)(O)=O,,,5,1,1,0,1
60822_0,,,,2,2,1,3
C(CC(C)C1C(CC(C1O)=O)O)=O,,,5,1,1,0,1
60824_0,,,,2,2,1,3
C(CCC1C(CC(C1O)=O)O)=O,,,5,1,1,0,1
60826_0,,,,2,2,1,3
C(CCC1C(CC(C1O)=O)O)(O)=O,,,5,1,1,0,1
60828_0,,,,2,2,1,3
C1(CC(CC1(C(C)CC=O)O)O)=O,,,5,1,1,0,1
60830_0,,,,2,2,1,3
C1(CC(CC1(CCC=O)O)O)=O,,,5,1,1,0,1
60832_0,,,,2,2,1,3
C1(CC(CC1(CCC(O)=O)O)O)=O,,,5,1,1,0,1
60834_0,,,,2,2,1,3
C(CC(C)C1C(C(CC1O)O)=O)=O,,,5,1,1,0,1
60836_0,,,,2,2,1,3
C(CCC1C(C(CC1O)O)=O)=O,,,5,1,1,0,1
60838_0,,,,2,2,1,3
C(CCC1C(C(CC1O)O)=O)(O)=O,,,5,1,1,0,1
60840_0,,,,2,2,1,3
C(CCC1(C(CC(C1O)=O)O)O)=O,,,5,1,1,0,1
60842_0,,,,2,2,1,3
C(CCC1(C(C(C(C1)=O)O)O)O)=O,,,5,1,1,0,1
60844_0,,,,2,2,1,3
C1(CC(C(C1(CCC=O)O)O)O)=O,,,5,1,1,0,1
60846_0,,,,2,2,1,3
C(CCC1C(C(C(C1O)O)O)=O)=O,,,5,1,1,0,1
60848_0,,,,2,2,1,3
C(C(CCC=O)C(CC(C)O)O)=O,,,5,1,1,0,1
60850_0,,,,2,2,1,3
C(CC(CCC=O)(CC(C)O)O)=O,,,5,1,1,0,1
60852_0,,,,2,2,1,3
C(CCC(C(CC=O)O)C(C)O)=O,,,5,1,1,0,1
60854_0,,,,2,2,1,3
C(CCC(C)(CC(CC=O)O)O)=O,,,5,1,1,0,1
60856_0,,,,2,2,1,3
C(CC(CC(CCCC=O)O)O)=O,,,5,1,1,0,1
60858_0,,,,2,2,1,3
C(C(C(C)O)C(C)(CCC=O)O)=O,,,5,1,1,0,1
60860_0,,,,2,2,1,3
C(C(C(C)O)C(CCCC=O)O)=O,,,5,1,1,0,1
60862_0,,,,2,2,1,3
C(C(CCC=O)(C(C)O)C(C)O)=O,,,5,1,1,0,1
60864_0,,,,2,2,1,3
C(C(C(C)O)C(C(C)CC=O)O)=O,,,5,1,1,0,1
60865_0,,,,2,2,1,3
60867_0,,,,2,2,1,3
C(C(C(C)O)C(CCC(O)=O)O)=O,,,5,1,1,0,1
60869_0,,,,2,2,1,3
C(C(CO)(C(C)CC=O)C(C)O)=O,,,5,1,1,0,1
60871_0,,,,2,2,1,3
C(C(CCC=O)(CO)C(C)O)=O,,,5,1,1,0,1
60873_0,,,,2,2,1,3
C(C(CCC(O)=O)(CO)C(C)O)=O,,,5,1,1,0,1
60875_0,,,,2,2,1,3
C(C(CO)C(C)(C(C)CC=O)O)=O,,,5,1,1,0,1
60877_0,,,,2,2,1,3
C(C(CO)C(C)(CCC=O)O)=O,,,5,1,1,0,1
60879_0,,,,2,2,1,3
C(C(CO)C(C)(CCC(O)=O)O)=O,,,5,1,1,0,1
60881_0,,,,2,2,1,3
C(C(CO)C(CC(C)CC=O)O)=O,,,5,1,1,0,1
60883_0,,,,2,2,1,3
C(C(CO)C(CCCC=O)O)=O,,,5,1,1,0,1
60885_0,,,,2,2,1,3
C(C(CO)C(CCCC(O)=O)O)=O,,,5,1,1,0,1
60887_0,,,,2,2,1,3
C(C(C(C)CC=O)C(CCO)O)=O,,,5,1,1,0,1
60889_0,,,,2,2,1,3
C(C(CCC=O)C(CCO)O)=O,,,5,1,1,0,1
60891_0,,,,2,2,1,3
C(C(CCC(O)=O)C(CCO)O)=O,,,5,1,1,0,1
60893_0,,,,2,2,1,3
C(CC(C)C(CC(CC=O)O)O)=O,,,5,1,1,0,1
60895_0,,,,2,2,1,3
C(CCC(CC(CC=O)O)O)=O,,,5,1,1,0,1
60897_0,,,,2,2,1,3
C(CCC(CC(CC=O)O)O)(O)=O,,,5,1,1,0,1
60899_0,,,,2,2,1,3
C(CC(C)C(CCO)(CC=O)O)=O,,,5,1,1,0,1
60901_0,,,,2,2,1,3
C(CCC(CCO)(CC=O)O)=O,,,5,1,1,0,1
60903_0,,,,2,2,1,3
C(CCC(CCO)(CC=O)O)(O)=O,,,5,1,1,0,1
60905_0,,,,2,2,1,3
C(CC(C(CO)C(C)CC=O)O)=O,,,5,1,1,0,1
60907_0,,,,2,2,1,3
C(CC(C(CCC=O)CO)O)=O,,,5,1,1,0,1
60909_0,,,,2,2,1,3
C(CCC(CO)C(CC=O)O)(O)=O,,,5,1,1,0,1
60911_0,,,,2,2,1,3
C(C(CCC=O)(C(CCO)O)O)=O,,,5,1,1,0,1
60913_0,,,,2,2,1,3
C(CCC(CC(C(C=O)O)O)O)=O,,,5,1,1,0,1
60915_0,,,,2,2,1,3
C(CCC(CCO)(C(C=O)O)O)=O,,,5,1,1,0,1
60917_0,,,,2,2,1,3
C(CCC(CO)C(C(C=O)O)O)=O,,,5,1,1,0,1
60918_0,,,,2,2,1,3
60919_0,,,,2,2,1,3
60920_0,,,,2,2,1,3
60921_0,,,,2,2,1,3
60922_0,,,,2,2,1,3
60924_0,,,,2,2,1,3
C(C(CO)C(C(C)CC=O)O)=O,,,5,1,1,0,1
60925_0,,,,2,2,1,3
60927_0,,,,2,2,1,3
C(C(CO)C(CCC(O)=O)O)=O,,,5,1,1,0,1
60929_0,,,,2,2,1,3
C(C(CO)C(C1COC(C1)=O)O)=O,,,5,1,1,0,1
60930_0,,,,2,2,1,3
60931_0,,,,2,2,1,3
60933_0,,,,2,2,1,3
C(C(CO)(CO)CCC(CO)=O)=O,,,5,1,1,0,1
60935_0,,,,2,2,1,3
C(C(CO)(CO)C(CO)CC=O)=O,,,5,1,1,0,1
60937_0,,,,2,2,1,3
C(C(C=O)CC(C=O)(CO)CO)=O,,,5,1,1,0,1
60939_0,,,,2,2,1,3
C(C(CO)(CO)C(C)CC=O)=O,,,5,1,1,0,1
60941_0,,,,2,2,1,3
C(C(CCC=O)(CO)CO)=O,,,5,1,1,0,1
60943_0,,,,2,2,1,3
C(C(CCC(O)=O)(CO)CO)=O,,,5,1,1,0,1
60945_0,,,,2,2,1,3
C(C(CO)(CO)C1COC(C1)=O)=O,,,5,1,1,0,1
60946_0,,,,2,2,1,3
60947_0,,,,2,2,1,3
60949_0,,,,2,2,1,3
C(C(CO)C(C(CCC=O)O)O)=O,,,5,1,1,0,1
60950_0,,,,2,2,1,3
60951_0,,,,2,2,1,3
60953_0,,,,2,2,1,3
C(C(CCC=O)(CO)C(CO)O)=O,,,5,1,1,0,1
60955_0,,,,2,2,1,3
C(CCC(C=O)C(C(CO)=O)O)=O,,,5,1,2,0,2
60956_0,,,,2,2,1,3
60958_0,,,,2,2,1,3
C(CCC(C(C(CC=O)O)=O)O)=O,,,5,1,1,0,1
60960_0,,,,2,2,1,3
C(CCC(C)(C(C(C=O)=O)O)O)=O,,,5,1,1,0,1
60962_0,,,,2,2,1,3
C(CCCC(C(C(C=O)=O)O)O)=O,,,5,1,1,0,1
60964_0,,,,2,2,1,3
C(CCC(C(C=O)=O)(C(C)O)O)=O,,,5,1,1,0,1
60965_0,,,,2,2,1,3
60967_0,,,,2,2,1,3
C(CCC(C(C(C)=O)=O)(CO)O)=O,,,5,1,1,0,1
60969_0,,,,2,2,1,3
C(CCCC(C(C(CO)O)=O)=O)=O,,,5,1,1,0,1
60970_0,,,,2,2,1,3
60972_0,,,,2,2,1,3
C(CCC(C(C(CCO)=O)=O)O)=O,,,5,1,1,0,1
60974_0,,,,2,2,1,3
C(CCC(C(C(CO)=O)=O)CO)=O,,,5,1,1,0,1
60976_0,,,,2,2,1,3
C(C(C(C)CC=O)C(C)(CO)O)=O,,,5,1,1,0,1
60978_0,,,,2,2,1,3
C(C(CCC=O)C(C)(CO)O)=O,,,5,1,1,0,1
60980_0,,,,2,2,1,3
C(C(CCC(O)=O)C(C)(CO)O)=O,,,5,1,1,0,1
60982_0,,,,2,2,1,3
C(CC(C)(C(C(C)CC=O)O)O)=O,,,5,1,1,0,1
60984_0,,,,2,2,1,3
C(CC(C)(C(CCC=O)O)O)=O,,,5,1,1,0,1
60986_0,,,,2,2,1,3
C(CCC(C(C)(CC=O)O)O)(O)=O,,,5,1,1,0,1
60988_0,,,,2,2,1,3
C(CC(C)CC(CO)(CC=O)O)=O,,,5,1,1,0,1
60990_0,,,,2,2,1,3
C(CCCC(CO)(CC=O)O)=O,,,5,1,1,0,1
60992_0,,,,2,2,1,3
C(CCCC(CO)(CC=O)O)(O)=O,,,5,1,1,0,1
60994_0,,,,2,2,1,3
C(C(CCC=O)(C(CO)(C)O)O)=O,,,5,1,1,0,1
60996_0,,,,2,2,1,3
C(CCC(C(C)(C(C=O)O)O)O)=O,,,5,1,1,0,1
60998_0,,,,2,2,1,3
C(CCCC(CO)(C(C=O)O)O)=O,,,5,1,1,0,1
60999_0,,,,2,2,1,3
61000_0,,,,2,2,1,3
61002_0,,,,2,2,1,3
C(CC(C)C(C)(C(C(C)=O)O)O)=O,,,5,1,1,0,1
61004_0,,,,2,2,1,3
C(CCC(C)(C(C(C)=O)O)O)=O,,,5,1,1,0,1
61006_0,,,,2,2,1,3
C(CCC(C)(C(C(C)=O)O)O)(O)=O,,,5,1,1,0,1
61008_0,,,,2,2,1,3
C(CC(C)CC(C(C(C)=O)O)O)=O,,,5,1,1,0,1
61010_0,,,,2,2,1,3
C(CCCC(C(C(C)=O)O)O)=O,,,5,1,1,0,1
61012_0,,,,2,2,1,3
C(CCCC(C(C(C)=O)O)O)(O)=O,,,5,1,1,0,1
61014_0,,,,2,2,1,3
C(CC(C)C(C(C)=O)(C(C)O)O)=O,,,5,1,1,0,1
61016_0,,,,2,2,1,3
C(CCC(C(C)=O)(C(C)O)O)=O,,,5,1,1,0,1
61018_0,,,,2,2,1,3
C(CCC(C(C)=O)(C(C)O)O)(O)=O,,,5,1,1,0,1
61020_0,,,,2,2,1,3
C(CC(C)CC(C(C(C)O)O)=O)=O,,,5,1,1,0,1
61022_0,,,,2,2,1,3
C(CCCC(C(C(C)O)O)=O)=O,,,5,1,1,0,1
61024_0,,,,2,2,1,3
C(CCCC(C(C(C)O)O)=O)(O)=O,,,5,1,1,0,1
61026_0,,,,2,2,1,3
C(CCC(C(C(C(C)=O)O)O)O)=O,,,5,1,1,0,1
61027_0,,,,2,2,1,3
61029_0,,,,2,2,1,3
C(CCC(C(C)=O)(C(CO)O)O)=O,,,5,1,1,0,1
61031_0,,,,2,2,1,3
C(CCCC(C(C(CO)O)O)=O)=O,,,5,1,1,0,1
61032_0,,,,2,2,1,3
61033_0,,,,2,2,1,3
61035_0,,,,2,2,1,3
C(CC(C)C(C)(CC(CO)=O)O)=O,,,5,1,1,0,1
61037_0,,,,2,2,1,3
C(CCC(C)(CC(CO)=O)O)=O,,,5,1,1,0,1
61039_0,,,,2,2,1,3
C(CCC(C)(CC(CO)=O)O)(O)=O,,,5,1,1,0,1
61041_0,,,,2,2,1,3
C(CC(C)CC(CC(CO)=O)O)=O,,,5,1,1,0,1
61043_0,,,,2,2,1,3
C(CCCC(CC(CO)=O)O)=O,,,5,1,1,0,1
61045_0,,,,2,2,1,3
C(CCCC(CC(CO)=O)O)(O)=O,,,5,1,1,0,1
61047_0,,,,2,2,1,3
C(CC(C)C(C(CC(C)O)=O)O)=O,,,5,1,1,0,1
61049_0,,,,2,2,1,3
C(CCC(C(CC(C)O)=O)O)=O,,,5,1,1,0,1
61051_0,,,,2,2,1,3
C(CCC(C(CC(C)O)=O)O)(O)=O,,,5,1,1,0,1
61053_0,,,,2,2,1,3
C(CC(C)C(C(CO)=O)C(C)O)=O,,,5,1,1,0,1
61055_0,,,,2,2,1,3
C(CCC(C(CO)=O)C(C)O)=O,,,5,1,1,0,1
61057_0,,,,2,2,1,3
C(CCC(C(CO)=O)C(C)O)(O)=O,,,5,1,1,0,1
61059_0,,,,2,2,1,3
C(CCC(C(CC(CO)=O)O)O)=O,,,5,1,1,0,1
61060_0,,,,2,2,1,3
61062_0,,,,2,2,1,3
C(CCC(C(CC(CO)O)=O)O)=O,,,5,1,1,0,1
61064_0,,,,2,2,1,3
C(CCC(C(CO)=O)C(CO)O)=O,,,5,1,1,0,1
61065_0,,,,2,2,1,3
61067_0,,,,2,2,1,3
C(CCO)(C(CO)(CCC=O)O)=O,,,5,1,1,0,1
61068_0,,,,2,2,1,3
61070_0,,,,2,2,1,3
C(CCC(C(C(CO)O)=O)CO)=O,,,5,1,1,0,1
61071_0,,,,2,2,1,3
61073_0,,,,2,2,1,3
C(CCC(C(C(CO)CO)=O)O)=O,,,5,1,1,0,1
61075_0,,,,2,2,1,3
C(CCC(C(CO)=O)(CO)CO)=O,,,5,1,1,0,1
61077_0,,,,2,2,1,3
C(CCC(C=O)C(C(O)=O)(C)O)=O,,,5,1,1,0,1
61079_0,,,,2,2,1,3
C(C(CCCC=O)(CC=O)O)(O)=O,,,5,1,1,0,1
61081_0,,,,2,2,1,3
C(CCC(C)(CC(C(O)=O)=O)O)=O,,,5,1,1,0,1
61083_0,,,,2,2,1,3
C(CCCC(CC(C(O)=O)=O)O)=O,,,5,1,1,0,1
61085_0,,,,2,2,1,3
C(CCC(C(C(O)=O)=O)C(C)O)=O,,,5,1,1,0,1
61087_0,,,,2,2,1,3
C(C(CCC=O)C(CC(O)=O)O)=O,,,5,1,1,0,1
61089_0,,,,2,2,1,3
C(C(CCC=O)C(CC=O)O)(O)=O,,,5,1,1,0,1
61091_0,,,,2,2,1,3
C(CC(CCC=O)(CC=O)O)(O)=O,,,5,1,1,0,1
61093_0,,,,2,2,1,3
C(C(C=O)C(C)(CCC=O)O)(O)=O,,,5,1,1,0,1
61095_0,,,,2,2,1,3
C(C(C=O)C(CCCC=O)O)(O)=O,,,5,1,1,0,1
61097_0,,,,2,2,1,3
C(C(C=O)(CCC=O)C(C)O)(O)=O,,,5,1,1,0,1
61099_0,,,,2,2,1,3
C(C(C=O)C(C(C)CC=O)O)(O)=O,,,5,1,1,0,1
61100_0,,,,2,2,1,3
61102_0,,,,2,2,1,3
C(C(C=O)C(CCC(O)=O)O)(O)=O,,,5,1,1,0,1
61104_0,,,,2,2,1,3
C(C(C=O)(CO)C(C)CC=O)(O)=O,,,5,1,1,0,1
61106_0,,,,2,2,1,3
C(C(C=O)(CCC=O)CO)(O)=O,,,5,1,1,0,1
61108_0,,,,2,2,1,3
C(C(C=O)(CCC(O)=O)CO)(O)=O,,,5,1,1,0,1
61109_0,,,,2,2,1,3
61111_0,,,,2,2,1,3
C(CCC1(C(C(CO1)O)=O)CO)=O,,,5,1,1,0,1
61113_0,,,,2,2,1,3
C(CCC1C(C(C(CO)O1)=O)O)=O,,,5,1,1,0,1
61115_0,,,,2,2,1,3
C(CCC1(C(C(CO)OC1)=O)O)=O,,,5,1,1,0,1
61116_0,,,,2,2,1,3
61118_0,,,,2,2,1,3
C(CCC1(C(C(CO)CO1)=O)O)=O,,,5,1,1,0,1
61120_0,,,,2,2,1,3
C(CCC1C(C(C(O)O1)=O)CO)=O,,,5,1,1,0,1
61122_0,,,,2,2,1,3
C(CCC1(C(C(O)OC1)=O)CO)=O,,,5,1,1,0,1
61123_0,,,,2,2,1,3
61125_0,,,,2,2,1,3
C(CCC1(C(COC1O)=O)CO)=O,,,5,1,1,0,1
61127_0,,,,2,2,1,3
C(CCC1(C(C(CO1)=O)CO)O)=O,,,5,1,1,0,1
61129_0,,,,2,2,1,3
C(CCC1C(C(CO)C(O1)O)=O)=O,,,5,1,1,0,1
61130_0,,,,2,2,1,3
61132_0,,,,2,2,1,3
C(CCC1C(C(CO)OC1O)=O)=O,,,5,1,1,0,1
61134_0,,,,2,2,1,3
C(CCC1(CC(C(CO)O1)=O)O)=O,,,5,1,1,0,1
61136_0,,,,2,2,1,3
C1(CC(OC1(CO)CCC=O)O)=O,,,5,1,1,0,1
61138_0,,,,2,2,1,3
C(CC(C)C(C=O)C(C=O)(C=C)O)=O,,,5,1,1,0,1
61140_0,,,,2,2,1,3
C(CCC(C=O)C(C=O)(C=C)O)=O,,,5,1,1,0,1
61141_0,,,,2,2,1,3
61142_0,,,,2,2,1,3
61144_0,,,,2,2,1,3
C(CC(C)C(C=O)C(C(C=C)=O)O)=O,,,5,1,1,0,1
61146_0,,,,2,2,1,3
C(CCC(C=O)C(C(C=C)=O)O)=O,,,5,1,1,0,1
61148_0,,,,2,2,1,3
C(CC(C)C(C(C=C)=O)(CC=O)O)=O,,,5,1,1,0,1
61150_0,,,,2,2,1,3
C(CCC(C(C=C)=O)(CC=O)O)=O,,,5,1,1,0,1
61152_0,,,,2,2,1,3
C(CC(C(CCCC=CC=O)=O)O)=O,,,5,1,1,0,1
61154_0,,,,2,2,1,3
C(CC(C(CCC(C=O)C=C)=O)O)=O,,,5,1,1,0,1
61155_0,,,,2,2,1,3
61156_0,,,,2,2,1,3
61157_0,,,,2,2,1,3
61158_0,,,,2,2,1,3
61159_0,,,,2,2,1,3
61160_0,,,,2,2,1,3
61161_0,,,,2,2,1,3
61162_0,,,,2,2,1,3
61163_0,,,,2,2,1,3
61164_0,,,,2,2,1,3
61165_0,,,,2,2,1,3
61166_0,,,,2,2,1,3
61167_0,,,,2,2,1,3
61169_0,,,,2,2,1,3
C(CC(C)C(C=O)C(C=CC=O)O)=O,,,5,1,1,0,1
61171_0,,,,2,2,1,3
C(CCC(C=O)C(C=CC=O)O)=O,,,5,1,1,0,1
61173_0,,,,2,2,1,3
C(CC(C)C(C=CC=O)(CC=O)O)=O,,,5,1,1,0,1
61175_0,,,,2,2,1,3
C(CCC(C=CC=O)(CC=O)O)=O,,,5,1,1,0,1
61177_0,,,,2,2,1,3
C(CC(C(CC=O)O)CC=CC=O)=O,,,5,1,1,0,1
61179_0,,,,2,2,1,3
C(C(C=C)C(C(CC=O)O)CC=O)=O,,,5,1,1,0,1
61180_0,,,,2,2,1,3
61181_0,,,,2,2,1,3
61182_0,,,,2,2,1,3
61183_0,,,,2,2,1,3
61184_0,,,,2,2,1,3
61185_0,,,,2,2,1,3
61186_0,,,,2,2,1,3
61187_0,,,,2,2,1,3
61188_0,,,,2,2,1,3
61189_0,,,,2,2,1,3
61190_0,,,,2,2,1,3
61192_0,,,,2,2,1,3
C(CCC(C)(CC(C(O)=O)O)O)=O,,,5,1,1,0,1
61194_0,,,,2,2,1,3
C(CCCC(CC(C(O)=O)O)O)=O,,,5,1,1,0,1
61196_0,,,,2,2,1,3
C(C(CCC=O)(CC(C)O)O)(O)=O,,,5,1,1,0,1
61198_0,,,,2,2,1,3
C(CCC(C(C)O)C(C(O)=O)O)=O,,,5,1,1,0,1
61200_0,,,,2,2,1,3
C(C(C)(C(C(C)CC=O)O)O)(O)=O,,,5,1,1,0,1
61201_0,,,,2,2,1,3
61203_0,,,,2,2,1,3
C(C(C)(C(CCC(O)=O)O)O)(O)=O,,,5,1,1,0,1
61205_0,,,,2,2,1,3
C(C(CO)(CC(C)CC=O)O)(O)=O,,,5,1,1,0,1
61207_0,,,,2,2,1,3
C(C(CO)(CCCC=O)O)(O)=O,,,5,1,1,0,1
61209_0,,,,2,2,1,3
C(C(CO)(CCCC(O)=O)O)(O)=O,,,5,1,1,0,1
61211_0,,,,2,2,1,3
C(C(C=C)(CCC(CO)=O)O)(O)=O,,,5,1,1,0,1
61213_0,,,,2,2,1,3
C(C(C=C)(C(CO)CC=O)O)(O)=O,,,5,1,1,0,1
61215_0,,,,2,2,1,3
C(C(C=O)CC(C(O)=O)(C=C)O)=O,,,5,1,1,0,1
61217_0,,,,2,2,1,3
C(C(C=C)(C(C)CC=O)O)(O)=O,,,5,1,1,0,1
61219_0,,,,2,2,1,3
C(C(C=C)(CCC=O)O)(O)=O,,,5,1,1,0,1
61221_0,,,,2,2,1,3
C(C(C=C)(CCC(O)=O)O)(O)=O,,,5,1,1,0,1
61223_0,,,,2,2,1,3
C(C(C=C)(C1COC(C1)=O)O)(O)=O,,,5,1,1,0,1
61225_0,,,,2,2,1,3
C(C(C=C)(CCC(C=O)=O)O)(O)=O,,,5,1,1,0,1
61226_0,,,,2,2,1,3
61228_0,,,,2,2,1,3
C(CC(C)C(C(C(CO)=O)=O)O)=O,,,5,1,1,0,1
61229_0,,,,2,2,1,3
61231_0,,,,2,2,1,3
C(CCC(C(C(CO)=O)=O)O)(O)=O,,,5,1,1,0,1
61233_0,,,,2,2,1,3
C(C(C(C=O)=O)CCC(CO)=O)=O,,,5,1,1,0,1
61235_0,,,,2,2,1,3
C(C(C(C=O)=O)C(CO)CC=O)=O,,,5,1,1,0,1
61237_0,,,,2,2,1,3
C(C(C)C(C=O)C(C=O)C(C=O)=O)=O,,,5,1,1,0,1
61239_0,,,,2,2,1,3
C(C(C)(CC=O)C(C=O)C(C=O)=O)=O,,,5,1,1,0,1
61241_0,,,,2,2,1,3
C(C(CC(C=O)C(C=O)=O)CC=O)=O,,,5,1,2,0,2
61243_0,,,,2,2,1,3
C(C(C(C=O)=O)C(C=O)CC(C)=O)=O,,,5,1,1,0,1
61245_0,,,,2,2,1,3
C(C(C(C=O)=O)C(C(C)=O)CC=O)=O,,,5,1,1,0,1
61247_0,,,,2,2,1,3
C(C(C(C=O)=O)C(C)CC(C=O)=O)=O,,,5,1,1,0,1
61249_0,,,,2,2,1,3
C(C(C(C=O)=O)C(CC=O)CC=O)=O,,,5,1,1,0,1
61251_0,,,,2,2,1,3
C(C(C(C=O)=O)C(C)C(C=O)C=O)=O,,,5,1,1,0,1
61253_0,,,,2,2,1,3
C(C(C(C=O)=O)CC(C=O)C=O)=O,,,5,1,1,0,1
61255_0,,,,2,2,1,3
C(C(C(C=O)=O)C(C)CC=O)=O,,,5,1,1,0,1
61257_0,,,,2,2,1,3
C(C(C(C=O)=O)CCC=O)=O,,,5,1,1,0,1
61259_0,,,,2,2,1,3
C(C(C(C=O)=O)CCC(O)=O)=O,,,5,1,1,0,1
61261_0,,,,2,2,1,3
C(C(C(C=O)=O)C1COC(C1)=O)=O,,,5,1,1,0,1
61263_0,,,,2,2,1,3
C(C(C(C=O)=O)CCC(C=O)=O)=O,,,5,1,1,0,1
61265_0,,,,2,2,1,3
C(C(C(C=O)=O)C(C=O)CC=O)=O,,,5,1,1,0,1
61267_0,,,,2,2,1,3
C(CO)(CCCC(C(C=O)=O)=O)=O,,,5,1,1,0,1
61269_0,,,,2,2,1,3
C(CC(CO)CC(C(C=O)=O)=O)=O,,,5,1,1,0,1
61271_0,,,,2,2,1,3
C(C(C)C(C=O)CC(C(C=O)=O)=O)=O,,,5,1,1,0,1
61273_0,,,,2,2,1,3
C(C(C)(CC=O)CC(C(C=O)=O)=O)=O,,,5,1,1,0,1
61275_0,,,,2,2,1,3
C(C(CCC(C(C=O)=O)=O)CC=O)=O,,,5,1,1,0,1
61277_0,,,,2,2,1,3
C(C(CC(C(C=O)=O)=O)CC(C)=O)=O,,,5,1,1,0,1
61279_0,,,,2,2,1,3
C(CC(C(C)=O)CC(C(C=O)=O)=O)=O,,,5,1,1,0,1
61281_0,,,,2,2,1,3
C(C(CC(C)CC(C(C=O)=O)=O)=O)=O,,,5,1,1,0,1
61283_0,,,,2,2,1,3
C(CC(CC=O)CC(C(C=O)=O)=O)=O,,,5,1,1,0,1
61285_0,,,,2,2,1,3
C(C(C=O)C(C)CC(C(C=O)=O)=O)=O,,,5,1,1,0,1
61287_0,,,,2,2,1,3
C(C(C=O)CCC(C(C=O)=O)=O)=O,,,5,1,1,0,1
61289_0,,,,2,2,1,3
C(CC(C)CC(C(C=O)=O)=O)=O,,,5,1,1,0,1
61291_0,,,,2,2,1,3
C(CCCC(C(C=O)=O)=O)=O,,,5,1,1,0,1
61293_0,,,,2,2,1,3
C(CCCC(C(C=O)=O)=O)(O)=O,,,5,1,1,0,1
61295_0,,,,2,2,1,3
C1(CC(CO1)CC(C(C=O)=O)=O)=O,,,5,1,1,0,1
61297_0,,,,2,2,1,3
C(C(CCCC(C(C=O)=O)=O)=O)=O,,,5,1,1,0,1
61299_0,,,,2,2,1,3
C(CC(C=O)CC(C(C=O)=O)=O)=O,,,5,1,1,0,1
61301_0,,,,2,2,1,3
C(CCC(C(C(CO)=O)=O)(C)O)=O,,,5,1,1,0,1
61303_0,,,,2,2,1,3
C(CCCC(C(C(CO)=O)=O)O)=O,,,5,1,1,0,1
61305_0,,,,2,2,1,3
C(CCC(C(C(C(C)O)=O)=O)O)=O,,,5,1,1,0,1
61307_0,,,,2,2,1,3
C(C(C(C=O)=O)(C(C)CC=O)O)=O,,,5,1,1,0,1
61309_0,,,,2,2,1,3
C(C(C(C=O)=O)(CCC=O)O)=O,,,5,1,1,0,1
61311_0,,,,2,2,1,3
C(C(C(C=O)=O)(CCC(O)=O)O)=O,,,5,1,1,0,1
61313_0,,,,2,2,1,3
C(C(C(C=O)=O)(CCCC=O)O)=O,,,5,1,1,0,1
61315_0,,,,2,2,1,3
C(CCC(C(C)=O)(C(C=O)=O)O)=O,,,5,1,1,0,1
61317_0,,,,2,2,1,3
C(CCCC(C(C(C=O)=O)O)=O)=O,,,5,1,1,0,1
61319_0,,,,2,2,1,3
C(CCC(C=O)C(C(C=O)=O)O)=O,,,5,1,1,0,1
61321_0,,,,2,2,1,3
C(CCC(C(C=O)=O)(CC=O)O)=O,,,5,1,1,0,1
61323_0,,,,2,2,1,3
C(CCC(C(CO)=O)C(C=O)=O)=O,,,5,1,1,0,1
61325_0,,,,2,2,1,3
C(CCC(C(CC(C=O)=O)=O)O)=O,,,5,1,1,0,1
61327_0,,,,2,2,1,3
C(CCC(C(C(C=O)=O)=O)CO)=O,,,5,1,1,0,1
61328_0,,,,2,2,1,3
61330_0,,,,2,2,1,3
C(C(C)(CCC(CO)=O)O)=O,,,5,1,1,0,1
61332_0,,,,2,2,1,3
C(C(C)(C(CO)CC=O)O)=O,,,5,1,1,0,1
61333_0,,,,2,2,1,3
61335_0,,,,2,2,1,3
C(CC(C(O)=O)C(C=O)(C)O)=O,,,5,1,1,0,1
61337_0,,,,2,2,1,3
C(CC(C=O)C(C=O)(C)O)(O)=O,,,5,1,1,0,1
61338_0,,,,2,2,1,3
61339_0,,,,2,2,1,3
61340_0,,,,2,2,1,3
61341_0,,,,2,2,1,3
61343_0,,,,2,2,1,3
C(C(C)(C(CO)(CO)CC=O)O)=O,,,5,1,1,0,1
61344_0,,,,2,2,1,3
61346_0,,,,2,2,1,3
C(C(C)(C(C=O)(C)CC=O)O)=O,,,5,1,1,0,1
61348_0,,,,2,2,1,3
C(C(C)(CC(C=O)CC=O)O)=O,,,5,1,1,0,1
61350_0,,,,2,2,1,3
C(C(C)(CC(C=O)C(C=O)O)O)=O,,,5,1,1,0,1
61352_0,,,,2,2,1,3
C(CC(C=O)C(C=O)(C)O)(C)=O,,,5,1,1,0,1
61354_0,,,,2,2,1,3
C(CC(C(C)=O)C(C=O)(C)O)=O,,,5,1,1,0,1
61356_0,,,,2,2,1,3
C(C(C)(C(C)CC(C=O)=O)O)=O,,,5,1,1,0,1
61358_0,,,,2,2,1,3
C(C(C)(C(CO)CC(C=O)=O)O)=O,,,5,1,1,0,1
61360_0,,,,2,2,1,3
C(C(C)(C(CC=O)CC=O)O)=O,,,5,1,1,0,1
61362_0,,,,2,2,1,3
C(CC(C(C=O)O)C(C=O)(C)O)=O,,,5,1,1,0,1
61364_0,,,,2,2,1,3
C(C(C=O)C(C)C(C=O)(C)O)=O,,,5,1,1,0,1
61366_0,,,,2,2,1,3
C(C(C=O)CC(C=O)(C)O)=O,,,5,1,1,0,1
61368_0,,,,2,2,1,3
C(C(C=O)C(CO)C(C=O)(C)O)=O,,,5,1,1,0,1
61370_0,,,,2,2,1,3
C(C(CC(C(C=O)=O)CO)(C)O)=O,,,5,1,1,0,1
61371_0,,,,2,2,1,3
61372_0,,,,2,2,1,3
61374_0,,,,2,2,1,3
C(C(C)(CC(C=O)C(CO)=O)O)=O,,,5,1,1,0,1
61376_0,,,,2,2,1,3
C(C(C)(CCC(C(C=O)O)=O)O)=O,,,5,1,1,0,1
61378_0,,,,2,2,1,3
C(C(C)(C(C)CC=O)O)=O,,,5,1,1,0,1
61380_0,,,,2,2,1,3
C(C(C)(C(C(CO)O)CC=O)O)=O,,,5,1,1,0,1
61382_0,,,,2,2,1,3
C(C(C)(CCC=O)O)=O,,,5,1,1,0,1
61384_0,,,,2,2,1,3
C(C(C)(CCC(O)=O)O)=O,,,5,1,1,0,1
61386_0,,,,2,2,1,3
C(C(C)(C(CO)CC(O)=O)O)=O,,,5,1,1,0,1
61387_0,,,,2,2,1,3
61388_0,,,,2,2,1,3
61390_0,,,,2,2,1,3
C(C(C)(C1COC(C1)=O)O)=O,,,5,1,1,0,1
61391_0,,,,2,2,1,3
61392_0,,,,2,2,1,3
61394_0,,,,2,2,1,3
C(C(CCCC(CO)=O)O)=O,,,5,1,1,0,1
61396_0,,,,2,2,1,3
C(CC(CO)CC(C=O)O)=O,,,5,1,2,0,2
61398_0,,,,2,2,1,3
C(C(CCCC(C(O)=O)=O)O)=O,,,5,1,1,0,1
61400_0,,,,2,2,1,3
C(C(CC(C=O)O)CC=O)(O)=O,,,5,1,1,0,1
61402_0,,,,2,2,1,3
C(C(CC(C=O)CC(O)=O)O)=O,,,5,1,1,0,1
61404_0,,,,2,2,1,3
C(C(CC(C(C=O)=O)CC=O)O)=O,,,5,1,1,0,1
61406_0,,,,2,2,1,3
C(C(CC(C=O)CC(C=O)=O)O)=O,,,5,1,2,0,2
61408_0,,,,2,2,1,3
C(C(CC(C=O)(C=O)CC=O)O)=O,,,5,1,1,0,1
61410_0,,,,2,2,1,3
C(C(CC(C=O)C(C=O)C=O)O)=O,,,5,1,2,0,2
61412_0,,,,2,2,1,3
C(CC(CO)(CO)CC(C=O)O)=O,,,5,1,1,0,1
61414_0,,,,2,2,1,3
C(C(CC(C=O)C(C=O)C)O)=O,,,5,1,1,0,1
61416_0,,,,2,2,1,3
C(C(C)(CC(C=O)O)CC=O)=O,,,5,1,1,0,1
61418_0,,,,2,2,1,3
C(C(CCC(C=O)CC=O)O)=O,,,5,1,1,0,1
61420_0,,,,2,2,1,3
C(C(CCC(C=O)C(C=O)O)O)=O,,,5,1,1,0,1
61422_0,,,,2,2,1,3
C(C(CC(C=O)CC(C)=O)O)=O,,,5,1,1,0,1
61424_0,,,,2,2,1,3
C(C)(C(CC(C=O)O)CC=O)=O,,,5,1,1,0,1
61426_0,,,,2,2,1,3
C(C(CC(C)CC(C=O)=O)O)=O,,,5,1,1,0,1
61428_0,,,,2,2,1,3
C(C(CC(CO)CC(C=O)=O)O)=O,,,5,1,2,0,2
61430_0,,,,2,2,1,3
C(CC(CC(C=O)O)CC=O)=O,,,5,1,2,0,2
61432_0,,,,2,2,1,3
C(CC(CC(C=O)O)C(C=O)O)=O,,,5,1,2,0,2
61434_0,,,,2,2,1,3
C(C(C=O)C(C)CC(C=O)O)=O,,,5,1,1,0,1
61436_0,,,,2,2,1,3
C(C(C=O)CCC(C=O)O)=O,,,5,1,1,0,1
61438_0,,,,2,2,1,3
C(C(C=O)C(CO)CC(C=O)O)=O,,,5,1,2,0,2
61440_0,,,,2,2,1,3
C(C(CCC(C(C=O)=O)CO)O)=O,,,5,1,1,0,1
61442_0,,,,2,2,1,3
C(C(CC(C=O)C(C=O)CO)O)=O,,,5,1,1,0,1
61444_0,,,,2,2,1,3
C(C(CO)(CC(C=O)O)CC=O)=O,,,5,1,1,0,1
61446_0,,,,2,2,1,3
C(C(CCC(C=O)C(CO)=O)O)=O,,,5,1,1,0,1
61448_0,,,,2,2,1,3
C(CCCC(C=O)O)(C(C=O)O)=O,,,5,1,1,0,1
61450_0,,,,2,2,1,3
C(CC(C)CC(C=O)O)=O,,,5,1,1,0,1
61452_0,,,,2,2,1,3
C(CC(CC(C=O)O)C(CO)O)=O,,,5,1,2,0,2
61454_0,,,,2,2,1,3
C(CCCC(C=O)O)=O,,,5,1,1,0,1
61456_0,,,,2,2,1,3
C(CCCC(C=O)O)(O)=O,,,5,1,1,0,1
61458_0,,,,2,2,1,3
C(CC(CO)CC(C=O)O)(O)=O,,,5,1,1,0,1
61460_0,,,,2,2,1,3
C(C(CC(C=O)CC(CO)=O)O)=O,,,5,1,1,0,1
61462_0,,,,2,2,1,3
C(CO)(C(CC(C=O)O)CC=O)=O,,,5,1,1,0,1
61464_0,,,,2,2,1,3
C1(CC(CO1)CC(C=O)O)=O,,,5,1,1,0,1
61465_0,,,,2,2,1,3
61466_0,,,,2,2,1,3
61468_0,,,,2,2,1,3
C(CC(C)C(C=O)(C(CO)=O)O)=O,,,5,1,1,0,1
61469_0,,,,2,2,1,3
61471_0,,,,2,2,1,3
C(CCC(C=O)(C(CO)=O)O)(O)=O,,,5,1,1,0,1
61473_0,,,,2,2,1,3
C(CC(C)C(C(C(C=O)O)=O)O)=O,,,5,1,1,0,1
61474_0,,,,2,2,1,3
61476_0,,,,2,2,1,3
C(CCC(C(C(C=O)O)=O)O)(O)=O,,,5,1,1,0,1
61478_0,,,,2,2,1,3
C(CCCC(C(C(CO)=O)O)=O)=O,,,5,1,1,0,1
61480_0,,,,2,2,1,3
C(CCC(C(C)=O)(C(CO)=O)O)=O,,,5,1,1,0,1
61482_0,,,,2,2,1,3
C(CCC(C(C(C(C)=O)O)=O)O)=O,,,5,1,1,0,1
61484_0,,,,2,2,1,3
C(C(C=O)CCC(CC(C=O)=O)=O)=O,,,5,1,1,0,1
61486_0,,,,2,2,1,3
C(CC(C)CC(CC(C=O)=O)=O)=O,,,5,1,1,0,1
61488_0,,,,2,2,1,3
C(CCCC(CC(C=O)=O)=O)=O,,,5,1,1,0,1
61490_0,,,,2,2,1,3
C(CCCC(O)=O)(CC(C=O)=O)=O,,,5,1,1,0,1
61492_0,,,,2,2,1,3
C(CC1COC(C1)=O)(CC(C=O)=O)=O,,,5,1,1,0,1
61494_0,,,,2,2,1,3
C(CCCC(C=O)=O)(CC(C=O)=O)=O,,,5,1,1,0,1
61496_0,,,,2,2,1,3
C(CC(C=O)CC(CC(C=O)=O)=O)=O,,,5,1,1,0,1
61498_0,,,,2,2,1,3
C(C(C=O)CC(C(C)=O)C(C=O)=O)=O,,,5,1,1,0,1
61500_0,,,,2,2,1,3
C(CC(C)C(C(C)=O)C(C=O)=O)=O,,,5,1,1,0,1
61502_0,,,,2,2,1,3
C(CCC(C(C)=O)C(C=O)=O)=O,,,5,1,1,0,1
61504_0,,,,2,2,1,3
C(C)(C(C(C=O)=O)CCC(O)=O)=O,,,5,1,1,0,1
61506_0,,,,2,2,1,3
C(C)(C(C(C=O)=O)C1COC(C1)=O)=O,,,5,1,1,0,1
61508_0,,,,2,2,1,3
C(C)(C(C(C=O)=O)CCC(C=O)=O)=O,,,5,1,1,0,1
61510_0,,,,2,2,1,3
C(CC(C=O)C(C(C)=O)C(C=O)=O)=O,,,5,1,1,0,1
61511_0,,,,2,2,1,3
61513_0,,,,2,2,1,3
C(C(C(C=O)=O)(CCC=O)CO)=O,,,5,1,1,0,1
61515_0,,,,2,2,1,3
C(CCC(C(C(C=O)C=O)=O)O)=O,,,5,1,1,0,1
61517_0,,,,2,2,1,3
C(C(C(C(C=O)O)=O)CCC=O)=O,,,5,1,1,0,1
61519_0,,,,2,2,1,3
C(C(C(CC=O)=O)(CCC=O)O)=O,,,5,1,1,0,1
61520_0,,,,2,2,1,3
61521_0,,,,2,2,1,3
61523_0,,,,2,2,1,3
C(C(C=O)(CCC(C(O)=O)=O)O)=O,,,5,1,1,0,1
61525_0,,,,2,2,1,3
C(C(C=O)(C(C(O)=O)CC=O)O)=O,,,5,1,1,0,1
61527_0,,,,2,2,1,3
C(C(C=O)(C(C=O)CC(O)=O)O)=O,,,5,1,1,0,1
61529_0,,,,2,2,1,3
C(C(C)C(C=O)C(C=O)(C=O)O)=O,,,5,1,1,0,1
61531_0,,,,2,2,1,3
C(C(C)(CC=O)C(C=O)(C=O)O)=O,,,5,1,1,0,1
61533_0,,,,2,2,1,3
C(C(CC(C=O)(C=O)O)CC=O)=O,,,5,1,1,0,1
61535_0,,,,2,2,1,3
C(C(C=O)(C(C=O)CC(C)=O)O)=O,,,5,1,1,0,1
61537_0,,,,2,2,1,3
C(C(C=O)(C(C(C)=O)CC=O)O)=O,,,5,1,1,0,1
61539_0,,,,2,2,1,3
C(C(C=O)(C(C)CC(C=O)=O)O)=O,,,5,1,1,0,1
61541_0,,,,2,2,1,3
C(C(C=O)(C(CC=O)CC=O)O)=O,,,5,1,1,0,1
61543_0,,,,2,2,1,3
C(C(C=O)C(C)C(C=O)(C=O)O)=O,,,5,1,1,0,1
61545_0,,,,2,2,1,3
C(C(C=O)CC(C=O)(C=O)O)=O,,,5,1,1,0,1
61547_0,,,,2,2,1,3
C(C(C=O)(C(C)CC=O)O)=O,,,5,1,1,0,1
61548_0,,,,2,2,1,3
61550_0,,,,2,2,1,3
C(C(C=O)(CCC(O)=O)O)=O,,,5,1,1,0,1
61552_0,,,,2,2,1,3
C(C(C=O)(C(CO)CC(O)=O)O)=O,,,5,1,1,0,1
61554_0,,,,2,2,1,3
C(C(C=O)(C1COC(C1)=O)O)=O,,,5,1,1,0,1
61556_0,,,,2,2,1,3
C(C(C=O)(CCC(C=O)=O)O)=O,,,5,1,1,0,1
61558_0,,,,2,2,1,3
C(C(C=O)(C(C=O)CC=O)O)=O,,,5,1,1,0,1
61560_0,,,,2,2,1,3
C(C(C=O)C(CCC(C=O)C=O)=O)=O,,,5,1,1,0,1
61562_0,,,,2,2,1,3
C(C(C=O)C(CC(C)CC=O)=O)=O,,,5,1,1,0,1
61564_0,,,,2,2,1,3
C(C(C=O)C(CCCC=O)=O)=O,,,5,1,1,0,1
61566_0,,,,2,2,1,3
C(C(C=O)C(CCCC(O)=O)=O)=O,,,5,1,1,0,1
61568_0,,,,2,2,1,3
C(C(C=O)C(CC1COC(C1)=O)=O)=O,,,5,1,1,0,1
61570_0,,,,2,2,1,3
C(C(C=O)C(CCCC(C=O)=O)=O)=O,,,5,1,1,0,1
61572_0,,,,2,2,1,3
C(C(C=O)C(CC(C=O)CC=O)=O)=O,,,5,1,1,0,1
61574_0,,,,2,2,1,3
C(C)(C(C=O)CCC(CO)=O)=O,,,5,1,1,0,1
61576_0,,,,2,2,1,3
C(CC(CO)C(C=O)C(C)=O)=O,,,5,1,1,0,1
61578_0,,,,2,2,1,3
C(C(C(C)=O)CCC(C(O)=O)=O)=O,,,5,1,1,0,1
61580_0,,,,2,2,1,3
C(C(C(C)=O)C(C(O)=O)CC=O)=O,,,5,1,1,0,1
61582_0,,,,2,2,1,3
C(C(C(C)=O)C(C=O)CC(O)=O)=O,,,5,1,1,0,1
61584_0,,,,2,2,1,3
C(C(C(C)=O)C(C(C=O)=O)CC=O)=O,,,5,1,1,0,1
61586_0,,,,2,2,1,3
C(C(C(C)=O)C(C=O)CC(C=O)=O)=O,,,5,1,1,0,1
61588_0,,,,2,2,1,3
C(C(C=O)(CC=O)C(C=O)C(C)=O)=O,,,5,1,1,0,1
61590_0,,,,2,2,1,3
C(C(C=O)C(C=O)C(C=O)C(C)=O)=O,,,5,1,1,0,1
61592_0,,,,2,2,1,3
C(C(C)C(C=O)C(C(C)=O)C=O)=O,,,5,1,1,0,1
61594_0,,,,2,2,1,3
C(C(C)(CC=O)C(C(C)=O)C=O)=O,,,5,1,1,0,1
61596_0,,,,2,2,1,3
C(C(CC(C(C)=O)C=O)CC=O)=O,,,5,1,1,0,1
61598_0,,,,2,2,1,3
C(C(C(C)=O)C(C=O)CC(C)=O)=O,,,5,1,1,0,1
61600_0,,,,2,2,1,3
C(C(C(C)=O)C(C(C)=O)CC=O)=O,,,5,1,1,0,1
61602_0,,,,2,2,1,3
C(C(C(C)=O)C(C)CC(C=O)=O)=O,,,5,1,1,0,1
61604_0,,,,2,2,1,3
C(CC(CC=O)C(C=O)C(C)=O)=O,,,5,1,1,0,1
61606_0,,,,2,2,1,3
C(C(C=O)C(C)C(C=O)C(C)=O)=O,,,5,1,1,0,1
61608_0,,,,2,2,1,3
C(C(C=O)CC(C=O)C(C)=O)=O,,,5,1,1,0,1
61610_0,,,,2,2,1,3
C(CC(C)C(C=O)C(C)=O)=O,,,5,1,1,0,1
61612_0,,,,2,2,1,3
C(CCC(C=O)C(C)=O)=O,,,5,1,1,0,1
61614_0,,,,2,2,1,3
C(C(C(C)=O)CCC(O)=O)=O,,,5,1,1,0,1
61616_0,,,,2,2,1,3
C(CC(CO)C(C=O)C(C)=O)(O)=O,,,5,1,1,0,1
61618_0,,,,2,2,1,3
C(C(C(C)=O)C1COC(C1)=O)=O,,,5,1,1,0,1
61619_0,,,,2,2,1,3
61620_0,,,,2,2,1,3
61622_0,,,,2,2,1,3
C(CCCC(CO)=O)(CC=O)=O,,,5,1,1,0,1
61624_0,,,,2,2,1,3
C(CC(CC(CO)CC=O)=O)=O,,,5,1,1,0,1
61626_0,,,,2,2,1,3
C(CC(CCCC(C(O)=O)=O)=O)=O,,,5,1,1,0,1
61628_0,,,,2,2,1,3
C(CC(CC(C(O)=O)CC=O)=O)=O,,,5,1,1,0,1
61630_0,,,,2,2,1,3
C(CC(CC(C=O)CC(O)=O)=O)=O,,,5,1,1,0,1
61632_0,,,,2,2,1,3
C(CC(CC(C(C=O)=O)CC=O)=O)=O,,,5,1,1,0,1
61634_0,,,,2,2,1,3
C(CC(CC(C=O)CC(C=O)=O)=O)=O,,,5,1,1,0,1
61636_0,,,,2,2,1,3
C(C(C=O)(CC(CC=O)=O)CC=O)=O,,,5,1,1,0,1
61638_0,,,,2,2,1,3
C(C(C=O)C(C=O)CC(CC=O)=O)=O,,,5,1,1,0,1
61640_0,,,,2,2,1,3
C(C(C)C(C=O)CC(CC=O)=O)=O,,,5,1,1,0,1
61642_0,,,,2,2,1,3
C(C(C)(CC(CC=O)=O)CC=O)=O,,,5,1,1,0,1
61644_0,,,,2,2,1,3
C(C(CCC(CC=O)=O)CC=O)=O,,,5,1,1,0,1
61646_0,,,,2,2,1,3
C(CC(CC(C=O)CC(C)=O)=O)=O,,,5,1,1,0,1
61648_0,,,,2,2,1,3
C(CC(CC(C(C)=O)CC=O)=O)=O,,,5,1,1,0,1
61650_0,,,,2,2,1,3
C(CC(CC(C)CC(C=O)=O)=O)=O,,,5,1,1,0,1
61652_0,,,,2,2,1,3
C(CC(CC(CC=O)CC=O)=O)=O,,,5,1,1,0,1
61654_0,,,,2,2,1,3
C(C(C=O)C(C)CC(CC=O)=O)=O,,,5,1,1,0,1
61656_0,,,,2,2,1,3
C(C(C=O)CCC(CC=O)=O)=O,,,5,1,1,0,1
61658_0,,,,2,2,1,3
C(CC(CC(C)CC=O)=O)=O,,,5,1,1,0,1
61660_0,,,,2,2,1,3
C(CC(CCCC=O)=O)=O,,,5,1,1,0,1
61662_0,,,,2,2,1,3
C(CC(CCCC(O)=O)=O)=O,,,5,1,1,0,1
61664_0,,,,2,2,1,3
C(CC(CC(CO)CC(O)=O)=O)=O,,,5,1,1,0,1
61666_0,,,,2,2,1,3
C(CC(CC1COC(C1)=O)=O)=O,,,5,1,1,0,1
61667_0,,,,2,2,1,3
61668_0,,,,2,2,1,3
61670_0,,,,2,2,1,3
C(CO)(CCC(C(C(O)=O)=O)O)=O,,,5,1,1,0,1
61672_0,,,,2,2,1,3
C(CC(CO)C(C(C(O)=O)=O)O)=O,,,5,1,1,0,1
61674_0,,,,2,2,1,3
C(C(C=O)CC(C(C(O)=O)=O)O)=O,,,5,1,1,0,1
61676_0,,,,2,2,1,3
C(CC(C)C(C(C(O)=O)=O)O)=O,,,5,1,1,0,1
61677_0,,,,2,2,1,3
61679_0,,,,2,2,1,3
C(CCC(C(C(O)=O)=O)O)(O)=O,,,5,1,1,0,1
61681_0,,,,2,2,1,3
C1(CC(CO1)C(C(C(O)=O)=O)O)=O,,,5,1,1,0,1
61682_0,,,,2,2,1,3
61683_0,,,,2,2,1,3
61684_0,,,,2,2,1,3
61686_0,,,,2,2,1,3
C(CCC(C(C(O)=O)=O)(CO)O)=O,,,5,1,1,0,1
61687_0,,,,2,2,1,3
61689_0,,,,2,2,1,3
C(C(C=O)(C(CCCC=O)=O)O)=O,,,5,1,1,0,1
61691_0,,,,2,2,1,3
C(C(C=O)(C(C(C)CC=O)O)O)=O,,,5,1,1,0,1
61692_0,,,,2,2,1,3
61694_0,,,,2,2,1,3
C(C(C=O)(C(CCC(O)=O)O)O)=O,,,5,1,1,0,1
61696_0,,,,2,2,1,3
C(CCC(C=O)C(C=O)(C=O)O)=O,,,5,1,1,0,1
61698_0,,,,2,2,1,3
C(C(C=O)(CCC(CO)=O)O)(O)=O,,,5,1,1,0,1
61700_0,,,,2,2,1,3
C(C(C=O)(C(CO)CC=O)O)(O)=O,,,5,1,1,0,1
61702_0,,,,2,2,1,3
C(C(C=O)CC(C(O)=O)(C=O)O)=O,,,5,1,1,0,1
61704_0,,,,2,2,1,3
C(C(C=O)(C(C)CC=O)O)(O)=O,,,5,1,1,0,1
61706_0,,,,2,2,1,3
C(C(C=O)(CCC=O)O)(O)=O,,,5,1,1,0,1
61708_0,,,,2,2,1,3
C(C(C=O)(CCC(O)=O)O)(O)=O,,,5,1,1,0,1
61710_0,,,,2,2,1,3
C(C(C=O)(C1COC(C1)=O)O)(O)=O,,,5,1,1,0,1
61711_0,,,,2,2,1,3
61712_0,,,,2,2,1,3
61714_0,,,,2,2,1,3
C(CCC(C(O)=O)(C(CO)=O)O)=O,,,5,1,1,0,1
61716_0,,,,2,2,1,3
C(CCC(C(C(C(O)=O)O)=O)O)=O,,,5,1,1,0,1
61718_0,,,,2,2,1,3
C(CO)(CCCC(COC=O)=O)=O,,,5,1,1,0,1
61720_0,,,,2,2,1,3
C(CC(CO)CC(COC=O)=O)=O,,,5,1,1,0,1
61722_0,,,,2,2,1,3
C(C(C=O)CCC(COC=O)=O)=O,,,5,1,1,0,1
61724_0,,,,2,2,1,3
C(CC(C)CC(COC=O)=O)=O,,,5,1,1,0,1
61726_0,,,,2,2,1,3
C(CCCC(COC=O)=O)=O,,,5,1,1,0,1
61728_0,,,,2,2,1,3
C(CCCC(COC=O)=O)(O)=O,,,5,1,1,0,1
61730_0,,,,2,2,1,3
C1(CC(CO1)CC(COC=O)=O)=O,,,5,1,1,0,1
61731_0,,,,2,2,1,3
61732_0,,,,2,2,1,3
61734_0,,,,2,2,1,3
C(C)(C(CCC(CO)=O)OC=O)=O,,,5,1,1,0,1
61736_0,,,,2,2,1,3
C(CC(CO)C(C(C)=O)OC=O)=O,,,5,1,1,0,1
61738_0,,,,2,2,1,3
C(C(C=O)CC(C(C)=O)OC=O)=O,,,5,1,1,0,1
61740_0,,,,2,2,1,3
C(CC(C)C(C(C)=O)OC=O)=O,,,5,1,1,0,1
61742_0,,,,2,2,1,3
C(CCC(C(C)=O)OC=O)=O,,,5,1,1,0,1
61744_0,,,,2,2,1,3
C(CCC(C(C)=O)OC=O)(O)=O,,,5,1,1,0,1
61746_0,,,,2,2,1,3
C1(CC(CO1)C(C(C)=O)OC=O)=O,,,5,1,1,0,1
61747_0,,,,2,2,1,3
61748_0,,,,2,2,1,3
61750_0,,,,2,2,1,3
C(CCC(C(C(CO)O)=O)(C)O)=O,,,5,1,1,0,1
61752_0,,,,2,2,1,3
C(CCCC(C(C(CO)O)=O)O)=O,,,5,1,1,0,1
61754_0,,,,2,2,1,3
C(CCC(C(C(C)O)=O)(CO)O)=O,,,5,1,1,0,1
61755_0,,,,2,2,1,3
61757_0,,,,2,2,1,3
C(CCC(C)(C(C(C=O)O)O)O)=O,,,5,1,1,0,1
61759_0,,,,2,2,1,3
C(CCCC(C(C(C=O)O)O)O)=O,,,5,1,1,0,1
61761_0,,,,2,2,1,3
C(C(CCC=O)(C(C(C)O)O)O)=O,,,5,1,1,0,1
61763_0,,,,2,2,1,3
C(CCC(C(C)O)(C(C=O)O)O)=O,,,5,1,1,0,1
61765_0,,,,2,2,1,3
C(CCC(C(C(C=O)(C)O)=O)O)=O,,,5,1,1,0,1
61767_0,,,,2,2,1,3
C(CCCC(C=O)(C(CO)=O)O)=O,,,5,1,1,0,1
61769_0,,,,2,2,1,3
C(CC(C)C(C=O)C(C(C)O)=O)=O,,,5,1,1,0,1
61771_0,,,,2,2,1,3
C(CCC(C=O)C(C(C)O)=O)=O,,,5,1,1,0,1
61773_0,,,,2,2,1,3
C(CCC(C=O)C(C(C)O)=O)(O)=O,,,5,1,1,0,1
61775_0,,,,2,2,1,3
C(C(C)(C(C)CC=O)O)(CC=O)=O,,,5,1,1,0,1
61777_0,,,,2,2,1,3
C(C(C)(CCC=O)O)(CC=O)=O,,,5,1,1,0,1
61779_0,,,,2,2,1,3
C(C(C)(CCC(O)=O)O)(CC=O)=O,,,5,1,1,0,1
61781_0,,,,2,2,1,3
C(CC(C)CC(C(CC=O)=O)O)=O,,,5,1,1,0,1
61783_0,,,,2,2,1,3
C(CCCC(C(CC=O)=O)O)=O,,,5,1,1,0,1
61785_0,,,,2,2,1,3
C(CCCC(C(CC=O)=O)O)(O)=O,,,5,1,1,0,1
61787_0,,,,2,2,1,3
C(CCC(C=O)(C(C(C)O)=O)O)=O,,,5,1,1,0,1
61789_0,,,,2,2,1,3
C(C(C)(CCC=O)O)(C(C=O)O)=O,,,5,1,1,0,1
61791_0,,,,2,2,1,3
C(CCCC(C(C(C=O)O)=O)O)=O,,,5,1,1,0,1
61793_0,,,,2,2,1,3
C(CCC(CC(C(C=O)=O)O)O)=O,,,5,1,1,0,1
61795_0,,,,2,2,1,3
C(CCC(CO)C(C(C=O)=O)O)=O,,,5,1,1,0,1
61797_0,,,,2,2,1,3
C(CCC(C(C=O)=O)(CCO)O)=O,,,5,1,1,0,1
61799_0,,,,2,2,1,3
C(C(CCC(CO)=O)O)(C(C)O)=O,,,5,1,1,0,1
61801_0,,,,2,2,1,3
C(CC(CO)C(C(C(C)O)=O)O)=O,,,5,1,1,0,1
61803_0,,,,2,2,1,3
C(C(C=O)CC(C(C(C)O)=O)O)=O,,,5,1,1,0,1
61805_0,,,,2,2,1,3
C(CC(C)C(C(C(C)O)=O)O)=O,,,5,1,1,0,1
61807_0,,,,2,2,1,3
C(CCC(C(C(C)O)=O)O)=O,,,5,1,1,0,1
61809_0,,,,2,2,1,3
C(CCC(C(C(C)O)=O)O)(O)=O,,,5,1,1,0,1
61811_0,,,,2,2,1,3
C1(CC(CO1)C(C(C(C)O)=O)O)=O,,,5,1,1,0,1
61812_0,,,,2,2,1,3
61813_0,,,,2,2,1,3
61815_0,,,,2,2,1,3
C(CO)(C(C)(CCC(CO)=O)O)=O,,,5,1,1,0,1
61817_0,,,,2,2,1,3
C(CC(CO)C(C(CO)=O)(C)O)=O,,,5,1,1,0,1
61819_0,,,,2,2,1,3
C(C(C=O)CC(C(CO)=O)(C)O)=O,,,5,1,1,0,1
61821_0,,,,2,2,1,3
C(CC(C)C(C(CO)=O)(C)O)=O,,,5,1,1,0,1
61823_0,,,,2,2,1,3
C(CCC(C(CO)=O)(C)O)=O,,,5,1,1,0,1
61825_0,,,,2,2,1,3
C(CCC(C(CO)=O)(C)O)(O)=O,,,5,1,1,0,1
61827_0,,,,2,2,1,3
C1(CC(CO1)C(C(CO)=O)(C)O)=O,,,5,1,1,0,1
61828_0,,,,2,2,1,3
61829_0,,,,2,2,1,3
61831_0,,,,2,2,1,3
C(CO)(CCCC(C(CO)=O)O)=O,,,5,1,1,0,1
61833_0,,,,2,2,1,3
C(CC(CO)CC(C(CO)=O)O)=O,,,5,1,1,0,1
61835_0,,,,2,2,1,3
C(C(C=O)CCC(C(CO)=O)O)=O,,,5,1,1,0,1
61837_0,,,,2,2,1,3
C(CC(C)CC(C(CO)=O)O)=O,,,5,1,1,0,1
61839_0,,,,2,2,1,3
C(CCCC(C(CO)=O)O)=O,,,5,1,1,0,1
61841_0,,,,2,2,1,3
C(CCCC(C(CO)=O)O)(O)=O,,,5,1,1,0,1
61843_0,,,,2,2,1,3
C1(CC(CC(C(CO)=O)O)CO1)=O,,,5,1,1,0,1
61844_0,,,,2,2,1,3
61845_0,,,,2,2,1,3
61847_0,,,,2,2,1,3
C(CC(C)CC(C(C(O)=O)=O)O)=O,,,5,1,1,0,1
61849_0,,,,2,2,1,3
C(CCCC(C(C(O)=O)=O)O)=O,,,5,1,1,0,1
61851_0,,,,2,2,1,3
C(CCCC(C(C(O)=O)=O)O)(O)=O,,,5,1,1,0,1
61853_0,,,,2,2,1,3
C(CC(C)C(C(C(O)=O)=O)(C)O)=O,,,5,1,1,0,1
61855_0,,,,2,2,1,3
C(CCC(C(C(O)=O)=O)(C)O)=O,,,5,1,1,0,1
61857_0,,,,2,2,1,3
C(CCC(C(C(O)=O)=O)(C)O)(O)=O,,,5,1,1,0,1
61859_0,,,,2,2,1,3
C(CCC(C(CC(CO)=O)=O)O)=O,,,5,1,1,0,1
61861_0,,,,2,2,1,3
C(CCC(C(CO)=O)C(CO)=O)=O,,,5,1,1,0,1
61863_0,,,,2,2,1,3
C(CCC(C=O)(CC(C=O)O)O)=O,,,5,1,1,0,1
61865_0,,,,2,2,1,3
C(CCC(C(C=O)O)C(C=O)O)=O,,,5,1,1,0,1
61867_0,,,,2,2,1,3
C1(C(CCC(CO)=O)(CCO1)O)=O,,,5,1,1,0,1
61869_0,,,,2,2,1,3
C1(C(CCO1)(C(CO)CC=O)O)=O,,,5,1,1,0,1
61871_0,,,,2,2,1,3
C(C(C=O)CC1(C(OCC1)=O)O)=O,,,5,1,1,0,1
61873_0,,,,2,2,1,3
C1(C(CCO1)(C(C)CC=O)O)=O,,,5,1,1,0,1
61875_0,,,,2,2,1,3
C1(C(CCC=O)(CCO1)O)=O,,,5,1,1,0,1
61877_0,,,,2,2,1,3
C1(C(CCC(O)=O)(CCO1)O)=O,,,5,1,1,0,1
61879_0,,,,2,2,1,3
C1(C(CCO1)(C2COC(C2)=O)O)=O,,,5,1,1,0,1
61881_0,,,,2,2,1,3
C1(C(CCC(C=O)=O)(CCO1)O)=O,,,5,1,1,0,1
61882_0,,,,2,2,1,3
61884_0,,,,2,2,1,3
C1(C(CC(CCC(CO)=O)O1)O)=O,,,5,1,1,0,1
61886_0,,,,2,2,1,3
C(CC(CO)C1CC(C(O1)=O)O)=O,,,5,1,1,0,1
61888_0,,,,2,2,1,3
C(C(C=O)CC1CC(C(O1)=O)O)=O,,,5,1,1,0,1
61890_0,,,,2,2,1,3
C(CC(C)C1CC(C(O1)=O)O)=O,,,5,1,1,0,1
61892_0,,,,2,2,1,3
C(CCC1CC(C(O1)=O)O)=O,,,5,1,1,0,1
61894_0,,,,2,2,1,3
C(CCC1CC(C(O1)=O)O)(O)=O,,,5,1,1,0,1
61896_0,,,,2,2,1,3
C1(CC(CO1)C2CC(C(O2)=O)O)=O,,,5,1,1,0,1
61897_0,,,,2,2,1,3
61898_0,,,,2,2,1,3
61900_0,,,,2,2,1,3
C1(C(C(CCC(CO)=O)CO1)O)=O,,,5,1,1,0,1
61902_0,,,,2,2,1,3
C(CC(CO)C1COC(C1O)=O)=O,,,5,1,1,0,1
61904_0,,,,2,2,1,3
C(C(C=O)CC1COC(C1O)=O)=O,,,5,1,1,0,1
61906_0,,,,2,2,1,3
C(CC(C)C1COC(C1O)=O)=O,,,5,1,1,0,1
61908_0,,,,2,2,1,3
C(CCC1COC(C1O)=O)=O,,,5,1,1,0,1
61910_0,,,,2,2,1,3
C(CCC1COC(C1O)=O)(O)=O,,,5,1,1,0,1
61912_0,,,,2,2,1,3
C1(CC(CO1)C2COC(C2O)=O)=O,,,5,1,1,0,1
61913_0,,,,2,2,1,3
61914_0,,,,2,2,1,3
61916_0,,,,2,2,1,3
C(CCC(CC(CO)(CO)O)O)=O,,,5,1,1,0,1
61918_0,,,,2,2,1,3
C(CCC(CO)C(CO)(CO)O)=O,,,5,1,1,0,1
61920_0,,,,2,2,1,3
C(CCC(C(CO)(CCO)O)O)=O,,,5,1,1,0,1
61922_0,,,,2,2,1,3
C(C(C)(CC(C(C)CC=O)O)O)=O,,,5,1,1,0,1
61924_0,,,,2,2,1,3
C(C(C)(CC(CCC=O)O)O)=O,,,5,1,1,0,1
61926_0,,,,2,2,1,3
C(C(C)(CC(CCC(O)=O)O)O)=O,,,5,1,1,0,1
61928_0,,,,2,2,1,3
C(C(C)(C(CO)C(C)CC=O)O)=O,,,5,1,1,0,1
61930_0,,,,2,2,1,3
C(C(C)(C(CO)CCC=O)O)=O,,,5,1,1,0,1
61932_0,,,,2,2,1,3
C(C(C)(C(CO)CCC(O)=O)O)=O,,,5,1,1,0,1
61934_0,,,,2,2,1,3
C(C(CCO)(CC(C)CC=O)O)=O,,,5,1,1,0,1
61936_0,,,,2,2,1,3
C(C(CCO)(CCCC=O)O)=O,,,5,1,1,0,1
61938_0,,,,2,2,1,3
C(C(CCO)(CCCC(O)=O)O)=O,,,5,1,1,0,1
61939_0,,,,2,2,1,3
61941_0,,,,2,2,1,3
C(C(C)(C(C(CCC=O)O)O)O)=O,,,5,1,1,0,1
61943_0,,,,2,2,1,3
C(C(C(CO)O)(CCCC=O)O)=O,,,5,1,1,0,1
61945_0,,,,2,2,1,3
C(CC(C)C(CC(C(C)=O)O)O)=O,,,5,1,1,0,1
61947_0,,,,2,2,1,3
C(CCC(CC(C(C)=O)O)O)=O,,,5,1,1,0,1
61949_0,,,,2,2,1,3
C(CCC(CC(C(C)=O)O)O)(O)=O,,,5,1,1,0,1
61951_0,,,,2,2,1,3
C(CC(C)C(CO)C(C(C)=O)O)=O,,,5,1,1,0,1
61953_0,,,,2,2,1,3
C(CCC(CO)C(C(C)=O)O)=O,,,5,1,1,0,1
61955_0,,,,2,2,1,3
C(CCC(CO)C(C(C)=O)O)(O)=O,,,5,1,1,0,1
61957_0,,,,2,2,1,3
C(CC(C)C(C(C)=O)(CCO)O)=O,,,5,1,1,0,1
61959_0,,,,2,2,1,3
C(CCC(C(C)=O)(CCO)O)=O,,,5,1,1,0,1
61961_0,,,,2,2,1,3
C(CCC(C(C)=O)(CCO)O)(O)=O,,,5,1,1,0,1
61963_0,,,,2,2,1,3
C(CC(C)CC(C(CCO)O)=O)=O,,,5,1,1,0,1
61965_0,,,,2,2,1,3
C(CCCC(C(CCO)O)=O)=O,,,5,1,1,0,1
61967_0,,,,2,2,1,3
C(CCCC(C(CCO)O)=O)(O)=O,,,5,1,1,0,1
61969_0,,,,2,2,1,3
C(CCC(C(CO)C(C=O)O)O)=O,,,5,1,1,0,1
61971_0,,,,2,2,1,3
C(C(CCC=O)(C(CO)CO)O)=O,,,5,1,1,0,1
61973_0,,,,2,2,1,3
C(CCC(CO)(CO)C(C=O)O)=O,,,5,1,1,0,1
61975_0,,,,2,2,1,3
C(CO)(CCC(CC(C)O)O)=O,,,5,1,1,0,1
61977_0,,,,2,2,1,3
C(CC(CO)C(CC(C)O)O)=O,,,5,1,1,0,1
61979_0,,,,2,2,1,3
C(C(CCC(CC(C)O)O)=O)(O)=O,,,5,1,1,0,1
61981_0,,,,2,2,1,3
C(C(C(CC(C)O)O)CC=O)(O)=O,,,5,1,1,0,1
61983_0,,,,2,2,1,3
C(C(C(CC(C)O)O)CC(O)=O)=O,,,5,1,1,0,1
61985_0,,,,2,2,1,3
C(C(C(CC(C)O)O)C(C=O)C)=O,,,5,1,1,0,1
61987_0,,,,2,2,1,3
C(C(C)(C(CC(C)O)O)CC=O)=O,,,5,1,1,0,1
61989_0,,,,2,2,1,3
C(C(CC(CC(C)O)O)CC=O)=O,,,5,1,1,0,1
61991_0,,,,2,2,1,3
C(C(C(CC(C)O)O)CC(C)=O)=O,,,5,1,1,0,1
61993_0,,,,2,2,1,3
C(C)(C(C(CC(C)O)O)CC=O)=O,,,5,1,1,0,1
61995_0,,,,2,2,1,3
C(C(CC(C)C(CC(C)O)O)=O)=O,,,5,1,1,0,1
61997_0,,,,2,2,1,3
C(CC(C(CC(C)O)O)CC=O)=O,,,5,1,1,0,1
61999_0,,,,2,2,1,3
C(C(C=O)C(C)C(CC(C)O)O)=O,,,5,1,1,0,1
62001_0,,,,2,2,1,3
C(C(C=O)CC(CC(C)O)O)=O,,,5,1,1,0,1
62003_0,,,,2,2,1,3
C(CC(C)C(CC(C)O)O)=O,,,5,1,1,0,1
62005_0,,,,2,2,1,3
C(CCC(CC(C)O)O)=O,,,5,1,1,0,1
62007_0,,,,2,2,1,3
C(CCC(CC(C)O)O)(O)=O,,,5,1,1,0,1
62009_0,,,,2,2,1,3
C(CC(CO)C(CC(C)O)O)(O)=O,,,5,1,1,0,1
62011_0,,,,2,2,1,3
C1(CC(CO1)C(CC(C)O)O)=O,,,5,1,1,0,1
62013_0,,,,2,2,1,3
C(C(CCC(CC(C)O)O)=O)=O,,,5,1,1,0,1
62014_0,,,,2,2,1,3
62016_0,,,,2,2,1,3
C(CO)(CCC(CO)C(C)O)=O,,,5,1,1,0,1
62018_0,,,,2,2,1,3
C(CC(CO)C(CO)C(C)O)=O,,,5,1,1,0,1
62020_0,,,,2,2,1,3
C(C(CCC(CO)C(C)O)=O)(O)=O,,,5,1,1,0,1
62022_0,,,,2,2,1,3
C(C(C(CO)C(C)O)CC=O)(O)=O,,,5,1,1,0,1
62024_0,,,,2,2,1,3
C(C(C(CO)C(C)O)CC(O)=O)=O,,,5,1,1,0,1
62026_0,,,,2,2,1,3
C(C(C(CO)C(C)O)C(C=O)C)=O,,,5,1,1,0,1
62028_0,,,,2,2,1,3
C(C(C)(C(CO)C(C)O)CC=O)=O,,,5,1,1,0,1
62030_0,,,,2,2,1,3
C(C(CC(CO)C(C)O)CC=O)=O,,,5,1,1,0,1
62032_0,,,,2,2,1,3
C(C(C(CO)C(C)O)CC(C)=O)=O,,,5,1,1,0,1
62034_0,,,,2,2,1,3
C(C)(C(C(CO)C(C)O)CC=O)=O,,,5,1,1,0,1
62036_0,,,,2,2,1,3
C(C(CC(C)C(CO)C(C)O)=O)=O,,,5,1,1,0,1
62038_0,,,,2,2,1,3
C(CC(C(CO)C(C)O)CC=O)=O,,,5,1,1,0,1
62040_0,,,,2,2,1,3
C(C(C=O)C(C)C(CO)C(C)O)=O,,,5,1,1,0,1
62042_0,,,,2,2,1,3
C(C(C=O)CC(CO)C(C)O)=O,,,5,1,1,0,1
62044_0,,,,2,2,1,3
C(CC(C)C(CO)C(C)O)=O,,,5,1,1,0,1
62046_0,,,,2,2,1,3
C(CCC(CO)C(C)O)=O,,,5,1,1,0,1
62048_0,,,,2,2,1,3
C(CCC(CO)C(C)O)(O)=O,,,5,1,1,0,1
62050_0,,,,2,2,1,3
C(CC(CO)C(CO)C(C)O)(O)=O,,,5,1,1,0,1
62052_0,,,,2,2,1,3
C1(CC(CO1)C(CO)C(C)O)=O,,,5,1,1,0,1
62053_0,,,,2,2,1,3
62054_0,,,,2,2,1,3
62056_0,,,,2,2,1,3
C(CO)(CCC(C)(CCO)O)=O,,,5,1,1,0,1
62058_0,,,,2,2,1,3
C(CC(CO)C(C)(CCO)O)=O,,,5,1,1,0,1
62060_0,,,,2,2,1,3
C(C(CCC(C)(CCO)O)=O)(O)=O,,,5,1,1,0,1
62062_0,,,,2,2,1,3
C(C(C(C)(CCO)O)CC=O)(O)=O,,,5,1,1,0,1
62064_0,,,,2,2,1,3
C(C(C(C)(CCO)O)CC(O)=O)=O,,,5,1,1,0,1
62066_0,,,,2,2,1,3
C(C(C(C)(CCO)O)C(C=O)C)=O,,,5,1,1,0,1
62068_0,,,,2,2,1,3
C(C(C)(C(C)(CCO)O)CC=O)=O,,,5,1,1,0,1
62070_0,,,,2,2,1,3
C(C(CC(C)(CCO)O)CC=O)=O,,,5,1,1,0,1
62072_0,,,,2,2,1,3
C(C(C(C)(CCO)O)CC(C)=O)=O,,,5,1,1,0,1
62074_0,,,,2,2,1,3
C(C)(C(C(C)(CCO)O)CC=O)=O,,,5,1,1,0,1
62076_0,,,,2,2,1,3
C(C(CC(C)C(C)(CCO)O)=O)=O,,,5,1,1,0,1
62078_0,,,,2,2,1,3
C(CC(C(C)(CCO)O)CC=O)=O,,,5,1,1,0,1
62080_0,,,,2,2,1,3
C(C(C=O)C(C)C(C)(CCO)O)=O,,,5,1,1,0,1
62082_0,,,,2,2,1,3
C(C(C=O)CC(C)(CCO)O)=O,,,5,1,1,0,1
62084_0,,,,2,2,1,3
C(CC(C)C(C)(CCO)O)=O,,,5,1,1,0,1
62086_0,,,,2,2,1,3
C(CCC(C)(CCO)O)=O,,,5,1,1,0,1
62088_0,,,,2,2,1,3
C(CCC(C)(CCO)O)(O)=O,,,5,1,1,0,1
62090_0,,,,2,2,1,3
C(CC(CO)C(C)(CCO)O)(O)=O,,,5,1,1,0,1
62092_0,,,,2,2,1,3
C1(CC(CO1)C(C)(CCO)O)=O,,,5,1,1,0,1
62093_0,,,,2,2,1,3
62094_0,,,,2,2,1,3
62096_0,,,,2,2,1,3
C(CO)(CCCC(CCO)O)=O,,,5,1,1,0,1
62098_0,,,,2,2,1,3
C(CC(CO)CC(CCO)O)=O,,,5,1,1,0,1
62100_0,,,,2,2,1,3
C(C(CCCC(CCO)O)=O)(O)=O,,,5,1,1,0,1
62102_0,,,,2,2,1,3
C(C(CC(CCO)O)CC=O)(O)=O,,,5,1,1,0,1
62104_0,,,,2,2,1,3
C(C(CC(CCO)O)CC(O)=O)=O,,,5,1,1,0,1
62106_0,,,,2,2,1,3
C(C(CC(CCO)O)C(C=O)C)=O,,,5,1,1,0,1
62108_0,,,,2,2,1,3
C(C(C)(CC(CCO)O)CC=O)=O,,,5,1,1,0,1
62110_0,,,,2,2,1,3
C(C(CCC(CCO)O)CC=O)=O,,,5,1,1,0,1
62112_0,,,,2,2,1,3
C(C(CC(CCO)O)CC(C)=O)=O,,,5,1,1,0,1
62114_0,,,,2,2,1,3
C(C)(C(CC(CCO)O)CC=O)=O,,,5,1,1,0,1
62116_0,,,,2,2,1,3
C(C(CC(C)CC(CCO)O)=O)=O,,,5,1,1,0,1
62118_0,,,,2,2,1,3
C(CC(CC(CCO)O)CC=O)=O,,,5,1,1,0,1
62120_0,,,,2,2,1,3
C(C(C=O)C(C)CC(CCO)O)=O,,,5,1,1,0,1
62122_0,,,,2,2,1,3
C(C(C=O)CCC(CCO)O)=O,,,5,1,1,0,1
62124_0,,,,2,2,1,3
C(CC(C)CC(CCO)O)=O,,,5,1,1,0,1
62126_0,,,,2,2,1,3
C(CCCC(CCO)O)=O,,,5,1,1,0,1
62128_0,,,,2,2,1,3
C(CCCC(CCO)O)(O)=O,,,5,1,1,0,1
62130_0,,,,2,2,1,3
C(CC(CO)CC(CCO)O)(O)=O,,,5,1,1,0,1
62132_0,,,,2,2,1,3
C1(CC(CO1)CC(CCO)O)=O,,,5,1,1,0,1
62133_0,,,,2,2,1,3
62134_0,,,,2,2,1,3
62136_0,,,,2,2,1,3
C(CO)(CCC(CO)(C(C)O)O)=O,,,5,1,1,0,1
62138_0,,,,2,2,1,3
C(CC(CO)C(CO)(C(C)O)O)=O,,,5,1,1,0,1
62140_0,,,,2,2,1,3
C(C(C=O)CC(CO)(C(C)O)O)=O,,,5,1,1,0,1
62142_0,,,,2,2,1,3
C(CC(C)C(CO)(C(C)O)O)=O,,,5,1,1,0,1
62144_0,,,,2,2,1,3
C(CCC(CO)(C(C)O)O)=O,,,5,1,1,0,1
62146_0,,,,2,2,1,3
C(CCC(CO)(C(C)O)O)(O)=O,,,5,1,1,0,1
62148_0,,,,2,2,1,3
C1(CC(CO1)C(CO)(C(C)O)O)=O,,,5,1,1,0,1
62149_0,,,,2,2,1,3
62150_0,,,,2,2,1,3
62152_0,,,,2,2,1,3
C(CO)(CCC(C(C(C)O)O)O)=O,,,5,1,1,0,1
62154_0,,,,2,2,1,3
C(CC(CO)C(C(C(C)O)O)O)=O,,,5,1,1,0,1
62156_0,,,,2,2,1,3
C(C(C=O)CC(C(C(C)O)O)O)=O,,,5,1,1,0,1
62158_0,,,,2,2,1,3
C(CC(C)C(C(C(C)O)O)O)=O,,,5,1,1,0,1
62160_0,,,,2,2,1,3
C(CCC(C(C(C)O)O)O)=O,,,5,1,1,0,1
62162_0,,,,2,2,1,3
C(CCC(C(C(C)O)O)O)(O)=O,,,5,1,1,0,1
62164_0,,,,2,2,1,3
C1(CC(CO1)C(C(C(C)O)O)O)=O,,,5,1,1,0,1
62166_0,,,,2,2,1,3
C(C(CCC(C(C(C)O)O)O)=O)=O,,,5,1,1,0,1
62167_0,,,,2,2,1,3
62169_0,,,,2,2,1,3
C(CO)(CCC(C)(C(CO)O)O)=O,,,5,1,1,0,1
62171_0,,,,2,2,1,3
C(CC(CO)C(C)(C(CO)O)O)=O,,,5,1,1,0,1
62173_0,,,,2,2,1,3
C(C(C=O)CC(C)(C(CO)O)O)=O,,,5,1,1,0,1
62175_0,,,,2,2,1,3
C(CC(C)C(C)(C(CO)O)O)=O,,,5,1,1,0,1
62177_0,,,,2,2,1,3
C(CCC(C)(C(CO)O)O)=O,,,5,1,1,0,1
62179_0,,,,2,2,1,3
C(CCC(C)(C(CO)O)O)(O)=O,,,5,1,1,0,1
62181_0,,,,2,2,1,3
C1(CC(CO1)C(C)(C(CO)O)O)=O,,,5,1,1,0,1
62182_0,,,,2,2,1,3
62183_0,,,,2,2,1,3
62185_0,,,,2,2,1,3
C(CO)(CCCC(C(CO)O)O)=O,,,5,1,1,0,1
62187_0,,,,2,2,1,3
C(CC(CO)CC(C(CO)O)O)=O,,,5,1,1,0,1
62189_0,,,,2,2,1,3
C(C(C=O)CCC(C(CO)O)O)=O,,,5,1,1,0,1
62191_0,,,,2,2,1,3
C(CC(C)CC(C(CO)O)O)=O,,,5,1,1,0,1
62193_0,,,,2,2,1,3
C(CCCC(C(CO)O)O)=O,,,5,1,1,0,1
62195_0,,,,2,2,1,3
C(CCCC(C(CO)O)O)(O)=O,,,5,1,1,0,1
62197_0,,,,2,2,1,3
C1(CC(CO1)CC(C(CO)O)O)=O,,,5,1,1,0,1
62198_0,,,,2,2,1,3
62199_0,,,,2,2,1,3
62201_0,,,,2,2,1,3
C(CCC(CO)(C(CCO)O)O)=O,,,5,1,1,0,1
62203_0,,,,2,2,1,3
C(CCC(CCO)(C(CO)O)O)=O,,,5,1,1,0,1
62205_0,,,,2,2,1,3
C(CCC(C(C(CCO)O)O)O)=O,,,5,1,1,0,1
62207_0,,,,2,2,1,3
C(CCC(CC(C(CO)O)O)O)=O,,,5,1,1,0,1
62209_0,,,,2,2,1,3
C(CCC(CO)C(C(CO)O)O)=O,,,5,1,1,0,1
62211_0,,,,2,2,1,3
C(CO)(CCC(CCO)O)=O,,,5,1,1,0,1
62213_0,,,,2,2,1,3
C(CC(CO)C(CCO)O)=O,,,5,1,1,0,1
62215_0,,,,2,2,1,3
C(C(CCC(CCO)O)=O)(O)=O,,,5,1,1,0,1
62217_0,,,,2,2,1,3
C(C(C(CCO)O)CC=O)(O)=O,,,5,1,1,0,1
62219_0,,,,2,2,1,3
C(C(C(CCO)O)CC(O)=O)=O,,,5,1,1,0,1
62220_0,,,,2,2,1,3
62221_0,,,,2,2,1,3
62222_0,,,,2,2,1,3
62223_0,,,,2,2,1,3
62225_0,,,,2,2,1,3
C(CC(CO)(CO)C(CCO)O)=O,,,5,1,1,0,1
62227_0,,,,2,2,1,3
C(C(C(CCO)O)C(C=O)C)=O,,,5,1,1,0,1
62229_0,,,,2,2,1,3
C(C(C)(C(CCO)O)CC=O)=O,,,5,1,1,0,1
62230_0,,,,2,2,1,3
62232_0,,,,2,2,1,3
C(C(CC(CCO)O)C(C=O)O)=O,,,5,1,1,0,1
62234_0,,,,2,2,1,3
C(C(C(CCO)O)CC(C)=O)=O,,,5,1,1,0,1
62236_0,,,,2,2,1,3
C(C)(C(C(CCO)O)CC=O)=O,,,5,1,1,0,1
62238_0,,,,2,2,1,3
C(C(CC(C)C(CCO)O)=O)=O,,,5,1,1,0,1
62240_0,,,,2,2,1,3
C(C(CC(CO)C(CCO)O)=O)=O,,,5,1,1,0,1
62242_0,,,,2,2,1,3
C(CC(C(CCO)O)CC=O)=O,,,5,1,1,0,1
62244_0,,,,2,2,1,3
C(CC(C(CCO)O)C(C=O)O)=O,,,5,1,1,0,1
62246_0,,,,2,2,1,3
C(C(C=O)C(C)C(CCO)O)=O,,,5,1,1,0,1
62248_0,,,,2,2,1,3
C(C(C=O)CC(CCO)O)=O,,,5,1,1,0,1
62250_0,,,,2,2,1,3
C(C(C=O)C(CO)C(CCO)O)=O,,,5,1,1,0,1
62252_0,,,,2,2,1,3
C(C(C(CO)CC(CCO)O)=O)=O,,,5,1,1,0,1
62253_0,,,,2,2,1,3
62254_0,,,,2,2,1,3
62256_0,,,,2,2,1,3
C(C(C(CO)=O)CC(CCO)O)=O,,,5,1,1,0,1
62258_0,,,,2,2,1,3
C(C(C(CCC(CCO)O)=O)O)=O,,,5,1,1,0,1
62260_0,,,,2,2,1,3
C(CC(C)C(CCO)O)=O,,,5,1,1,0,1
62262_0,,,,2,2,1,3
C(CC(C(CCO)O)C(CO)O)=O,,,5,1,1,0,1
62264_0,,,,2,2,1,3
C(CCC(CCO)O)=O,,,5,1,1,0,1
62266_0,,,,2,2,1,3
C(CCC(CCO)O)(O)=O,,,5,1,1,0,1
62268_0,,,,2,2,1,3
C(CC(CO)C(CCO)O)(O)=O,,,5,1,1,0,1
62269_0,,,,2,2,1,3
62270_0,,,,2,2,1,3
62272_0,,,,2,2,1,3
C1(CC(CO1)C(CCO)O)=O,,,5,1,1,0,1
62273_0,,,,2,2,1,3
62274_0,,,,2,2,1,3
62276_0,,,,2,2,1,3
C(CO)(CCC(CO)CO)=O,,,5,1,1,0,1
62278_0,,,,2,2,1,3
C(CC(CO)C(CO)CO)=O,,,5,1,1,0,1
62280_0,,,,2,2,1,3
C(C(CCC(CO)CO)=O)(O)=O,,,5,1,1,0,1
62282_0,,,,2,2,1,3
C(C(C(CO)CO)CC=O)(O)=O,,,5,1,1,0,1
62284_0,,,,2,2,1,3
C(C(C(CO)CO)CC(O)=O)=O,,,5,1,1,0,1
62286_0,,,,2,2,1,3
C(CC(C(C=O)=O)C(CO)CO)=O,,,5,1,1,0,1
62288_0,,,,2,2,1,3
C(C(C(CO)CO)CC(C=O)=O)=O,,,5,1,2,0,2
62290_0,,,,2,2,1,3
C(C(C=O)(C(CO)CO)CC=O)=O,,,5,1,1,0,1
62292_0,,,,2,2,1,3
C(C(C=O)C(C=O)C(CO)CO)=O,,,5,1,2,0,2
62294_0,,,,2,2,1,3
C(CC(CO)(CO)C(CO)CO)=O,,,5,1,1,0,1
62296_0,,,,2,2,1,3
C(C(C(CO)CO)C(C=O)C)=O,,,5,1,1,0,1
62298_0,,,,2,2,1,3
C(C(C)(C(CO)CO)CC=O)=O,,,5,1,1,0,1
62300_0,,,,2,2,1,3
C(C(CC(CO)CO)CC=O)=O,,,5,1,1,0,1
62302_0,,,,2,2,1,3
C(C(CC(CO)CO)C(C=O)O)=O,,,5,1,1,0,1
62304_0,,,,2,2,1,3
C(C(C(CO)CO)CC(C)=O)=O,,,5,1,1,0,1
62306_0,,,,2,2,1,3
C(C)(C(C(CO)CO)CC=O)=O,,,5,1,1,0,1
62308_0,,,,2,2,1,3
C(C(CC(C)C(CO)CO)=O)=O,,,5,1,1,0,1
62310_0,,,,2,2,1,3
C(C(CC(CO)C(CO)CO)=O)=O,,,5,1,1,0,1
62312_0,,,,2,2,1,3
C(CC(C(CO)CO)CC=O)=O,,,5,1,1,0,1
62314_0,,,,2,2,1,3
C(CC(C(CO)CO)C(C=O)O)=O,,,5,1,1,0,1
62316_0,,,,2,2,1,3
C(C(C=O)C(C)C(CO)CO)=O,,,5,1,1,0,1
62318_0,,,,2,2,1,3
C(C(C=O)CC(CO)CO)=O,,,5,1,1,0,1
62320_0,,,,2,2,1,3
C(C(C=O)C(CO)C(CO)CO)=O,,,5,1,1,0,1
62322_0,,,,2,2,1,3
C(C(C(CO)CC(CO)CO)=O)=O,,,5,1,1,0,1
62324_0,,,,2,2,1,3
C(C(C(CO)CO)C(C=O)CO)=O,,,5,1,1,0,1
62326_0,,,,2,2,1,3
C(C(CO)(C(CO)CO)CC=O)=O,,,5,1,1,0,1
62328_0,,,,2,2,1,3
C(C(C(CO)=O)CC(CO)CO)=O,,,5,1,1,0,1
62330_0,,,,2,2,1,3
C(C(C(CCC(CO)CO)=O)O)=O,,,5,1,1,0,1
62332_0,,,,2,2,1,3
C(CC(C)C(CO)CO)=O,,,5,1,1,0,1
62334_0,,,,2,2,1,3
C(CC(C(CO)O)C(CO)CO)=O,,,5,1,1,0,1
62336_0,,,,2,2,1,3
C(CCC(CO)CO)=O,,,5,1,1,0,1
62338_0,,,,2,2,1,3
C(CCC(CO)CO)(O)=O,,,5,1,1,0,1
62340_0,,,,2,2,1,3
C(CC(CO)C(CO)CO)(O)=O,,,5,1,1,0,1
62342_0,,,,2,2,1,3
C(C(C(CO)CO)CC(CO)=O)=O,,,5,1,1,0,1
62344_0,,,,2,2,1,3
C(CO)(C(C(CO)CO)CC=O)=O,,,5,1,1,0,1
62346_0,,,,2,2,1,3
C1(CC(CO1)C(CO)CO)=O,,,5,1,1,0,1
62347_0,,,,2,2,1,3
62348_0,,,,2,2,1,3
62350_0,,,,2,2,1,3
C(CO)(CCC(C(CCO)O)O)=O,,,5,1,1,0,1
62352_0,,,,2,2,1,3
C(CC(CO)C(C(CCO)O)O)=O,,,5,1,1,0,1
62354_0,,,,2,2,1,3
C(C(C=O)CC(C(CCO)O)O)=O,,,5,1,1,0,1
62356_0,,,,2,2,1,3
C(CC(C)C(C(CCO)O)O)=O,,,5,1,1,0,1
62358_0,,,,2,2,1,3
C(CCC(C(CCO)O)O)=O,,,5,1,1,0,1
62360_0,,,,2,2,1,3
C(CCC(C(CCO)O)O)(O)=O,,,5,1,1,0,1
62362_0,,,,2,2,1,3
C1(CC(CO1)C(C(CCO)O)O)=O,,,5,1,1,0,1
62363_0,,,,2,2,1,3
62364_0,,,,2,2,1,3
62366_0,,,,2,2,1,3
C(CO)(CCC(CO)(CCO)O)=O,,,5,1,1,0,1
62368_0,,,,2,2,1,3
C(CC(CO)C(CO)(CCO)O)=O,,,5,1,1,0,1
62370_0,,,,2,2,1,3
C(C(C=O)CC(CO)(CCO)O)=O,,,5,1,1,0,1
62372_0,,,,2,2,1,3
C(CC(C)C(CO)(CCO)O)=O,,,5,1,1,0,1
62374_0,,,,2,2,1,3
C(CCC(CO)(CCO)O)=O,,,5,1,1,0,1
62376_0,,,,2,2,1,3
C(CCC(CO)(CCO)O)(O)=O,,,5,1,1,0,1
62378_0,,,,2,2,1,3
C1(CC(CO1)C(CO)(CCO)O)=O,,,5,1,1,0,1
62379_0,,,,2,2,1,3
62380_0,,,,2,2,1,3
62382_0,,,,2,2,1,3
C(CO)(CCC(CC(CO)O)O)=O,,,5,1,1,0,1
62384_0,,,,2,2,1,3
C(CC(CO)C(CC(CO)O)O)=O,,,5,1,1,0,1
62386_0,,,,2,2,1,3
C(C(C=O)CC(CC(CO)O)O)=O,,,5,1,1,0,1
62388_0,,,,2,2,1,3
C(CC(C)C(CC(CO)O)O)=O,,,5,1,1,0,1
62390_0,,,,2,2,1,3
C(CCC(CC(CO)O)O)=O,,,5,1,1,0,1
62392_0,,,,2,2,1,3
C(CCC(CC(CO)O)O)(O)=O,,,5,1,1,0,1
62394_0,,,,2,2,1,3
C1(CC(CO1)C(CC(CO)O)O)=O,,,5,1,1,0,1
62395_0,,,,2,2,1,3
62396_0,,,,2,2,1,3
62398_0,,,,2,2,1,3
C(CO)(CCC(CO)C(CO)O)=O,,,5,1,1,0,1
62400_0,,,,2,2,1,3
C(CC(CO)C(CO)C(CO)O)=O,,,5,1,1,0,1
62402_0,,,,2,2,1,3
C(C(C=O)CC(CO)C(CO)O)=O,,,5,1,1,0,1
62404_0,,,,2,2,1,3
C(CC(C)C(CO)C(CO)O)=O,,,5,1,1,0,1
62406_0,,,,2,2,1,3
C(CCC(CO)C(CO)O)=O,,,5,1,1,0,1
62408_0,,,,2,2,1,3
C(CCC(CO)C(CO)O)(O)=O,,,5,1,1,0,1
62410_0,,,,2,2,1,3
C1(CC(CO1)C(CO)C(CO)O)=O,,,5,1,1,0,1
62411_0,,,,2,2,1,3
62412_0,,,,2,2,1,3
62414_0,,,,2,2,1,3
C(C(CO)CCC(CO)=O)(O)=O,,,5,1,1,0,1
62416_0,,,,2,2,1,3
C(C(CO)C(CO)CC=O)(O)=O,,,5,1,1,0,1
62418_0,,,,2,2,1,3
C(C(CCC(C(O)=O)=O)CO)(O)=O,,,5,1,1,0,1
62420_0,,,,2,2,1,3
C(C(CO)C(C(O)=O)CC=O)(O)=O,,,5,1,1,0,1
62422_0,,,,2,2,1,3
C(CC(C=O)C(C(O)=O)CO)(O)=O,,,5,1,1,0,1
62424_0,,,,2,2,1,3
C(C(CO)C(C=O)C(C=O)C)(O)=O,,,5,1,1,0,1
62426_0,,,,2,2,1,3
C(C(CO)C(C=O)(C)CC=O)(O)=O,,,5,1,1,0,1
62428_0,,,,2,2,1,3
C(C(CC(C=O)CC=O)CO)(O)=O,,,5,1,1,0,1
62430_0,,,,2,2,1,3
C(CC(C=O)C(C(O)=O)CO)(C)=O,,,5,1,1,0,1
62432_0,,,,2,2,1,3
C(C(CO)C(C(C)=O)CC=O)(O)=O,,,5,1,1,0,1
62434_0,,,,2,2,1,3
C(C(CO)C(C)CC(C=O)=O)(O)=O,,,5,1,1,0,1
62436_0,,,,2,2,1,3
C(C(C(CC=O)CC=O)CO)(O)=O,,,5,1,1,0,1
62438_0,,,,2,2,1,3
C(C(C=O)C(C)C(C(O)=O)CO)=O,,,5,1,1,0,1
62440_0,,,,2,2,1,3
C(C(C=O)CC(C(O)=O)CO)=O,,,5,1,1,0,1
62442_0,,,,2,2,1,3
C(C(CO)C(C)CC=O)(O)=O,,,5,1,1,0,1
62444_0,,,,2,2,1,3
C(C(CCC=O)CO)(O)=O,,,5,1,1,0,1
62446_0,,,,2,2,1,3
C(C(CCC(O)=O)CO)(O)=O,,,5,1,1,0,1
62448_0,,,,2,2,1,3
C(C(CO)C(CO)CC(O)=O)(O)=O,,,5,1,1,0,1
62450_0,,,,2,2,1,3
C(C(CO)C1COC(C1)=O)(O)=O,,,5,1,1,0,1
62451_0,,,,2,2,1,3
62452_0,,,,2,2,1,3
62454_0,,,,2,2,1,3
C(CC(CCC(CO)=O)O)(O)=O,,,5,1,1,0,1
62456_0,,,,2,2,1,3
C(CC(C(CO)CC=O)O)(O)=O,,,5,1,1,0,1
62458_0,,,,2,2,1,3
C(CC(CCC(C(O)=O)=O)O)(O)=O,,,5,1,1,0,1
62460_0,,,,2,2,1,3
C(CC(C(C(O)=O)CC=O)O)(O)=O,,,5,1,1,0,1
62462_0,,,,2,2,1,3
C(CC(C(C=O)CC(O)=O)O)(O)=O,,,5,1,1,0,1
62464_0,,,,2,2,1,3
C(CC(C(C=O)C(C=O)C)O)(O)=O,,,5,1,1,0,1
62466_0,,,,2,2,1,3
C(CC(C(C=O)(C)CC=O)O)(O)=O,,,5,1,1,0,1
62467_0,,,,2,2,1,3
62469_0,,,,2,2,1,3
C(CC(C(C=O)CC(C)=O)O)(O)=O,,,5,1,1,0,1
62471_0,,,,2,2,1,3
C(C)(C(C(CC(O)=O)O)CC=O)=O,,,5,1,1,0,1
62473_0,,,,2,2,1,3
C(CC(C(C)CC(C=O)=O)O)(O)=O,,,5,1,1,0,1
62475_0,,,,2,2,1,3
C(CC(C(CC=O)CC=O)O)(O)=O,,,5,1,1,0,1
62477_0,,,,2,2,1,3
C(C(C=O)C(C)C(CC(O)=O)O)=O,,,5,1,1,0,1
62479_0,,,,2,2,1,3
C(C(C=O)CC(CC(O)=O)O)=O,,,5,1,1,0,1
62481_0,,,,2,2,1,3
C(CC(C(C)CC=O)O)(O)=O,,,5,1,1,0,1
62483_0,,,,2,2,1,3
C(CC(CCC=O)O)(O)=O,,,5,1,1,0,1
62485_0,,,,2,2,1,3
C(CCC(CC(O)=O)O)(O)=O,,,5,1,1,0,1
62487_0,,,,2,2,1,3
C(CC(C(CO)CC(O)=O)O)(O)=O,,,5,1,1,0,1
62489_0,,,,2,2,1,3
C1(CC(CO1)C(CC(O)=O)O)=O,,,5,1,1,0,1
62490_0,,,,2,2,1,3
62491_0,,,,2,2,1,3
62493_0,,,,2,2,1,3
C(CC(CO)(C(C)CC=O)O)(O)=O,,,5,1,1,0,1
62495_0,,,,2,2,1,3
C(CC(CCC=O)(CO)O)(O)=O,,,5,1,1,0,1
62497_0,,,,2,2,1,3
C(CCC(CO)(CC(O)=O)O)(O)=O,,,5,1,1,0,1
62499_0,,,,2,2,1,3
C(CC(C(C(C)CC=O)O)O)(O)=O,,,5,1,1,0,1
62501_0,,,,2,2,1,3
C(CC(C(CCC=O)O)O)(O)=O,,,5,1,1,0,1
62503_0,,,,2,2,1,3
C(CCC(C(CC(O)=O)O)O)(O)=O,,,5,1,1,0,1
62505_0,,,,2,2,1,3
C(C(C(C)CC=O)C(CO)O)(O)=O,,,5,1,1,0,1
62507_0,,,,2,2,1,3
C(C(CCC=O)C(CO)O)(O)=O,,,5,1,1,0,1
62509_0,,,,2,2,1,3
C(C(CCC(O)=O)C(CO)O)(O)=O,,,5,1,1,0,1
62510_0,,,,2,2,1,3
62512_0,,,,2,2,1,3
C(CCCC=O)(C(CO)(CO)O)=O,,,5,1,1,0,1
62514_0,,,,2,2,1,3
C(CCC(C(CO)(C(C)O)O)O)=O,,,5,1,1,0,1
62516_0,,,,2,2,1,3
C(CCC(C)(C(CO)(CO)O)O)=O,,,5,1,1,0,1
62518_0,,,,2,2,1,3
C(CCCC(C(CO)(CO)O)O)=O,,,5,1,1,0,1
62519_0,,,,2,2,1,3
62521_0,,,,2,2,1,3
C(C(CO)(CC(CCC=O)O)O)=O,,,5,1,1,0,1
62523_0,,,,2,2,1,3
C(C(CO)(C(CO)CCC=O)O)=O,,,5,1,1,0,1
62525_0,,,,2,2,1,3
C(CO)(CCC(C(C=C)=O)O)=O,,,5,1,1,0,1
62527_0,,,,2,2,1,3
C(CC(CO)C(C(C=C)=O)O)=O,,,5,1,1,0,1
62529_0,,,,2,2,1,3
C=CC(C(CCC(C(O)=O)=O)O)=O,,,5,1,1,0,1
62531_0,,,,2,2,1,3
C(C(CC=O)C(C(C=C)=O)O)(O)=O,,,5,1,1,0,1
62533_0,,,,2,2,1,3
C(CC(C=O)C(C(C=C)=O)O)(O)=O,,,5,1,1,0,1
62534_0,,,,2,2,1,3
62535_0,,,,2,2,1,3
62536_0,,,,2,2,1,3
62537_0,,,,2,2,1,3
62539_0,,,,2,2,1,3
C(C(C)C(C=O)C(C(C=C)=O)O)=O,,,5,1,1,0,1
62541_0,,,,2,2,1,3
C(CC(C=O)(C)C(C(C=C)=O)O)=O,,,5,1,1,0,1
62543_0,,,,2,2,1,3
C(C(CC(C(C=C)=O)O)CC=O)=O,,,5,1,1,0,1
62545_0,,,,2,2,1,3
C(C(CC(C)=O)C(C(C=C)=O)O)=O,,,5,1,1,0,1
62547_0,,,,2,2,1,3
C(CC(C(C)=O)C(C(C=C)=O)O)=O,,,5,1,1,0,1
62549_0,,,,2,2,1,3
C=CC(C(C(C)CC(C=O)=O)O)=O,,,5,1,1,0,1
62551_0,,,,2,2,1,3
C(CC(C(C(C=C)=O)O)CC=O)=O,,,5,1,1,0,1
62553_0,,,,2,2,1,3
C(C(C=O)C(C)C(C(C=C)=O)O)=O,,,5,1,1,0,1
62555_0,,,,2,2,1,3
C(C(C=O)CC(C(C=C)=O)O)=O,,,5,1,1,0,1
62557_0,,,,2,2,1,3
C(CC(C)C(C(C=C)=O)O)=O,,,5,1,1,0,1
62559_0,,,,2,2,1,3
C(CCC(C(C=C)=O)O)=O,,,5,1,1,0,1
62561_0,,,,2,2,1,3
C(CCC(C(C=C)=O)O)(O)=O,,,5,1,1,0,1
62563_0,,,,2,2,1,3
C(CC(CO)C(C(C=C)=O)O)(O)=O,,,5,1,1,0,1
62565_0,,,,2,2,1,3
C1(CC(CO1)C(C(C=C)=O)O)=O,,,5,1,1,0,1
62566_0,,,,2,2,1,3
62567_0,,,,2,2,1,3
62569_0,,,,2,2,1,3
C(CO)(CCC(C=CC=O)O)=O,,,5,1,1,0,1
62571_0,,,,2,2,1,3
C(C(CCC(CO)=O)C(C)O)(O)=O,,,5,1,1,0,1
62573_0,,,,2,2,1,3
C(CC(C)(CCC(CO)=O)O)(O)=O,,,5,1,1,0,1
62575_0,,,,2,2,1,3
C(CC(CCCC(CO)=O)O)(O)=O,,,5,1,1,0,1
62577_0,,,,2,2,1,3
C(C(C(O)=O)CCC(CO)=O)(O)=O,,,5,1,1,0,1
62579_0,,,,2,2,1,3
C(CO)(CCC(C(C=O)=O)C)=O,,,5,1,1,0,1
62581_0,,,,2,2,1,3
C(CO)(CCCCC(C=O)=O)=O,,,5,1,1,0,1
62583_0,,,,2,2,1,3
C(CO)(CCC(C=O)CC=O)=O,,,5,1,2,0,2
62585_0,,,,2,2,1,3
C(CO)(CCCC(C(C)=O)=O)=O,,,5,1,1,0,1
62587_0,,,,2,2,1,3
C(CO)(CCC(C(C(O)=O)=O)C)=O,,,5,1,1,0,1
62589_0,,,,2,2,1,3
C(CO)(CCCCC(C(O)=O)=O)=O,,,5,1,1,0,1
62591_0,,,,2,2,1,3
C(C)(C(C(O)=O)CCC(CO)=O)=O,,,5,1,1,0,1
62593_0,,,,2,2,1,3
C(CCCC(CO)=O)(CC(O)=O)=O,,,5,1,1,0,1
62595_0,,,,2,2,1,3
C(CO)(CCC1CC(C(O1)=O)=O)=O,,,5,1,1,0,1
62597_0,,,,2,2,1,3
C(CO)(CCC1C(C(OC1)=O)=O)=O,,,5,1,1,0,1
62599_0,,,,2,2,1,3
C(CO)(CCC1C(OCC1=O)=O)=O,,,5,1,1,0,1
62601_0,,,,2,2,1,3
C1(C(CCC(CO)=O)OC(C1)=O)=O,,,5,1,1,0,1
62603_0,,,,2,2,1,3
C(CO)(CCCC(C=O)=CC=O)=O,,,5,1,1,0,1
62605_0,,,,2,2,1,3
C(C(C(C=O)=C)CCC(CO)=O)=O,,,5,1,1,0,1
62607_0,,,,2,2,1,3
C(CO)(CCCC(C=CC=O)=O)=O,,,5,1,1,0,1
62609_0,,,,2,2,1,3
C(CO)(CCC(C=C)C(C=O)=O)=O,,,5,1,1,0,1
62611_0,,,,2,2,1,3
C(CO)(CCCC=CC(C=O)=O)=O,,,5,1,1,0,1
62613_0,,,,2,2,1,3
C(C(C=CC=O)CCC(CO)=O)=O,,,5,1,1,0,1
62615_0,,,,2,2,1,3
C(C(C=O)(C=C)CCC(CO)=O)=O,,,5,1,1,0,1
62617_0,,,,2,2,1,3
C(CO)(CCCC=C(C=O)C=O)=O,,,5,1,1,0,1
62619_0,,,,2,2,1,3
C(CO)(CCCC=CC=O)=O,,,5,1,1,0,1
62621_0,,,,2,2,1,3
C(C(C=C)CCC(CO)=O)=O,,,5,1,1,0,1
62623_0,,,,2,2,1,3
C(C(C=C)(CCC(CO)=O)O)=O,,,5,1,1,0,1
62625_0,,,,2,2,1,3
C(CO)(CCC(C=CC(O)=O)O)=O,,,5,1,1,0,1
62627_0,,,,2,2,1,3
C(CO)(CCC1C=CC(O1)=O)=O,,,5,1,1,0,1
62629_0,,,,2,2,1,3
C(CO)(CCC1C(C=CO1)=O)=O,,,5,1,1,0,1
62631_0,,,,2,2,1,3
C(CO)(CCC1C(CC(O)O1)O)=O,,,5,1,1,0,1
62633_0,,,,2,2,1,3
C(CO)(CCC1(COC(C1)O)O)=O,,,5,1,1,0,1
62635_0,,,,2,2,1,3
C(CO)(CCC1(CC(CO1)O)O)=O,,,5,1,1,0,1
62637_0,,,,2,2,1,3
C(CO)(CCC1C(O)OCC1O)=O,,,5,1,1,0,1
62639_0,,,,2,2,1,3
C(CO)(CCC1(C(O)OCC1)O)=O,,,5,1,1,0,1
62641_0,,,,2,2,1,3
C(CO)(CCC1(C(CCO1)O)O)=O,,,5,1,1,0,1
62643_0,,,,2,2,1,3
C(CO)(CCC1CC(C(O)O1)O)=O,,,5,1,1,0,1
62645_0,,,,2,2,1,3
C(CO)(CCC1COC(C1O)O)=O,,,5,1,1,0,1
62646_0,,,,2,2,1,3
62647_0,,,,2,2,1,3
62648_0,,,,2,2,1,3
62649_0,,,,2,2,1,3
62650_0,,,,2,2,1,3
62651_0,,,,2,2,1,3
62652_0,,,,2,2,1,3
62653_0,,,,2,2,1,3
62654_0,,,,2,2,1,3
62655_0,,,,2,2,1,3
62656_0,,,,2,2,1,3
62657_0,,,,2,2,1,3
62658_0,,,,2,2,1,3
62659_0,,,,2,2,1,3
62660_0,,,,2,2,1,3
62661_0,,,,2,2,1,3
62662_0,,,,2,2,1,3
62663_0,,,,2,2,1,3
62664_0,,,,2,2,1,3
62665_0,,,,2,2,1,3
62666_0,,,,2,2,1,3
62667_0,,,,2,2,1,3
62668_0,,,,2,2,1,3
62669_0,,,,2,2,1,3
62670_0,,,,2,2,1,3
62671_0,,,,2,2,1,3
62672_0,,,,2,2,1,3
62673_0,,,,2,2,1,3
62674_0,,,,2,2,1,3
62675_0,,,,2,2,1,3
62676_0,,,,2,2,1,3
62677_0,,,,2,2,1,3
62678_0,,,,2,2,1,3
62679_0,,,,2,2,1,3
62680_0,,,,2,2,1,3
62681_0,,,,2,2,1,3
62682_0,,,,2,2,1,3
62683_0,,,,2,2,1,3
62684_0,,,,2,2,1,3
62685_0,,,,2,2,1,3
62686_0,,,,2,2,1,3
62687_0,,,,2,2,1,3
62688_0,,,,2,2,1,3
62689_0,,,,2,2,1,3
62690_0,,,,2,2,1,3
62691_0,,,,2,2,1,3
62692_0,,,,2,2,1,3
62693_0,,,,2,2,1,3
62694_0,,,,2,2,1,3
62695_0,,,,2,2,1,3
62696_0,,,,2,2,1,3
62697_0,,,,2,2,1,3
62698_0,,,,2,2,1,3
62699_0,,,,2,2,1,3
62700_0,,,,2,2,1,3
62701_0,,,,2,2,1,3
62702_0,,,,2,2,1,3
62703_0,,,,2,2,1,3
62704_0,,,,2,2,1,3
62705_0,,,,2,2,1,3
62706_0,,,,2,2,1,3
62707_0,,,,2,2,1,3
62708_0,,,,2,2,1,3
62709_0,,,,2,2,1,3
62710_0,,,,2,2,1,3
62711_0,,,,2,2,1,3
62712_0,,,,2,2,1,3
62713_0,,,,2,2,1,3
62714_0,,,,2,2,1,3
62715_0,,,,2,2,1,3
62717_0,,,,2,2,1,3
C(CC(CO)C(C=CC=O)O)=O,,,5,1,1,0,1
62719_0,,,,2,2,1,3
C(C(CCC(C(O)=O)=O)O)=CC=O,,,5,1,1,0,1
62721_0,,,,2,2,1,3
C(C(CC=O)C(C=CC=O)O)(O)=O,,,5,1,1,0,1
62723_0,,,,2,2,1,3
C(CC(C=O)C(C=CC=O)O)(O)=O,,,5,1,1,0,1
62724_0,,,,2,2,1,3
62725_0,,,,2,2,1,3
62726_0,,,,2,2,1,3
62727_0,,,,2,2,1,3
62729_0,,,,2,2,1,3
C(C(C)C(C=O)C(C=CC=O)O)=O,,,5,1,1,0,1
62731_0,,,,2,2,1,3
C(CC(C=O)(C)C(C=CC=O)O)=O,,,5,1,1,0,1
62733_0,,,,2,2,1,3
C(C(CC(C=CC=O)O)CC=O)=O,,,5,1,1,0,1
62735_0,,,,2,2,1,3
C(C(CC(C)=O)C(C=CC=O)O)=O,,,5,1,1,0,1
62737_0,,,,2,2,1,3
C(CC(C(C)=O)C(C=CC=O)O)=O,,,5,1,1,0,1
62739_0,,,,2,2,1,3
C(C(C(C)CC(C=O)=O)O)=CC=O,,,5,1,1,0,1
62741_0,,,,2,2,1,3
C(CC(C(C=CC=O)O)CC=O)=O,,,5,1,1,0,1
62743_0,,,,2,2,1,3
C(C(C=O)C(C)C(C=CC=O)O)=O,,,5,1,1,0,1
62745_0,,,,2,2,1,3
C(C(C=O)CC(C=CC=O)O)=O,,,5,1,1,0,1
62747_0,,,,2,2,1,3
C(CC(C)C(C=CC=O)O)=O,,,5,1,1,0,1
62749_0,,,,2,2,1,3
C(CCC(C=CC=O)O)=O,,,5,1,1,0,1
62751_0,,,,2,2,1,3
C(CCC(C=CC=O)O)(O)=O,,,5,1,1,0,1
62753_0,,,,2,2,1,3
C(CC(CO)C(C=CC=O)O)(O)=O,,,5,1,1,0,1
62755_0,,,,2,2,1,3
C1(CC(CO1)C(C=CC=O)O)=O,,,5,1,1,0,1
62756_0,,,,2,2,1,3
62757_0,,,,2,2,1,3
62759_0,,,,2,2,1,3
C(C(C(CO)CC=O)C(C)O)(O)=O,,,5,1,1,0,1
62761_0,,,,2,2,1,3
C(CC(C)(C(CO)CC=O)O)(O)=O,,,5,1,1,0,1
62763_0,,,,2,2,1,3
C(CC(CC(CO)CC=O)O)(O)=O,,,5,1,1,0,1
62765_0,,,,2,2,1,3
C(C(C(O)=O)C(CO)CC=O)(O)=O,,,5,1,1,0,1
62767_0,,,,2,2,1,3
C(CC(CO)C(C(C=O)=O)C)=O,,,5,1,1,0,1
62769_0,,,,2,2,1,3
C(CC(CCC(C=O)=O)CO)=O,,,5,1,1,0,1
62771_0,,,,2,2,1,3
C(CC(CO)C(C=O)CC=O)=O,,,5,1,2,0,2
62773_0,,,,2,2,1,3
C(CC(CO)CC(C(C)=O)=O)=O,,,5,1,1,0,1
62775_0,,,,2,2,1,3
C(CC(CO)C(C(C(O)=O)=O)C)=O,,,5,1,1,0,1
62777_0,,,,2,2,1,3
C(CC(CCC(C(O)=O)=O)CO)=O,,,5,1,1,0,1
62779_0,,,,2,2,1,3
C(CC(CO)C(C(O)=O)C(C)=O)=O,,,5,1,1,0,1
62781_0,,,,2,2,1,3
C(CC(CC(CO)CC=O)=O)(O)=O,,,5,1,1,0,1
62783_0,,,,2,2,1,3
C(CC(C1CC(C(O1)=O)=O)CO)=O,,,5,1,1,0,1
62785_0,,,,2,2,1,3
C(CC(CO)C1C(C(OC1)=O)=O)=O,,,5,1,1,0,1
62787_0,,,,2,2,1,3
C(CC(CO)C1C(OCC1=O)=O)=O,,,5,1,1,0,1
62789_0,,,,2,2,1,3
C(CC(CO)C1C(CC(O1)=O)=O)=O,,,5,1,1,0,1
62791_0,,,,2,2,1,3
C(CC(CO)CC(C=O)=CC=O)=O,,,5,1,1,0,1
62793_0,,,,2,2,1,3
C(C(C(C=O)=C)C(CO)CC=O)=O,,,5,1,1,0,1
62795_0,,,,2,2,1,3
C(CC(CO)CC(C=CC=O)=O)=O,,,5,1,1,0,1
62797_0,,,,2,2,1,3
C(CC(CO)C(C=C)C(C=O)=O)=O,,,5,1,1,0,1
62799_0,,,,2,2,1,3
C(CC(CO)CC=CC(C=O)=O)=O,,,5,1,1,0,1
62801_0,,,,2,2,1,3
C(C(C=CC=O)C(CO)CC=O)=O,,,5,1,1,0,1
62803_0,,,,2,2,1,3
C(C(C=O)(C=C)C(CO)CC=O)=O,,,5,1,1,0,1
62805_0,,,,2,2,1,3
C(CC(CO)CC=C(C=O)C=O)=O,,,5,1,1,0,1
62807_0,,,,2,2,1,3
C(CC(CO)CC=CC=O)=O,,,5,1,1,0,1
62809_0,,,,2,2,1,3
C(C(C=C)C(CO)CC=O)=O,,,5,1,1,0,1
62811_0,,,,2,2,1,3
C(C(C=C)(C(CO)CC=O)O)=O,,,5,1,1,0,1
62813_0,,,,2,2,1,3
C(CC(CO)C(C=CC(O)=O)O)=O,,,5,1,1,0,1
62815_0,,,,2,2,1,3
C(CC(CO)C1C=CC(O1)=O)=O,,,5,1,1,0,1
62817_0,,,,2,2,1,3
C(CC(CO)C1C(C=CO1)=O)=O,,,5,1,1,0,1
62819_0,,,,2,2,1,3
C(CC(CO)C1C(CC(O)O1)O)=O,,,5,1,1,0,1
62821_0,,,,2,2,1,3
C(CC(CO)C1(COC(C1)O)O)=O,,,5,1,1,0,1
62823_0,,,,2,2,1,3
C(CC(CO)C1(CC(CO1)O)O)=O,,,5,1,1,0,1
62825_0,,,,2,2,1,3
C(CC(CO)C1C(O)OCC1O)=O,,,5,1,1,0,1
62827_0,,,,2,2,1,3
C(CC(CO)C1(C(O)OCC1)O)=O,,,5,1,1,0,1
62829_0,,,,2,2,1,3
C(CC(CO)C1(C(CCO1)O)O)=O,,,5,1,1,0,1
62831_0,,,,2,2,1,3
C(CC(CO)C1CC(C(O)O1)O)=O,,,5,1,1,0,1
62833_0,,,,2,2,1,3
C(CC(CO)C1COC(C1O)O)=O,,,5,1,1,0,1
62834_0,,,,2,2,1,3
62835_0,,,,2,2,1,3
62836_0,,,,2,2,1,3
62837_0,,,,2,2,1,3
62838_0,,,,2,2,1,3
62839_0,,,,2,2,1,3
62840_0,,,,2,2,1,3
62841_0,,,,2,2,1,3
62842_0,,,,2,2,1,3
62843_0,,,,2,2,1,3
62844_0,,,,2,2,1,3
62845_0,,,,2,2,1,3
62846_0,,,,2,2,1,3
62847_0,,,,2,2,1,3
62848_0,,,,2,2,1,3
62849_0,,,,2,2,1,3
62850_0,,,,2,2,1,3
62851_0,,,,2,2,1,3
62852_0,,,,2,2,1,3
62853_0,,,,2,2,1,3
62854_0,,,,2,2,1,3
62855_0,,,,2,2,1,3
62856_0,,,,2,2,1,3
62857_0,,,,2,2,1,3
62858_0,,,,2,2,1,3
62859_0,,,,2,2,1,3
62860_0,,,,2,2,1,3
62861_0,,,,2,2,1,3
62862_0,,,,2,2,1,3
62863_0,,,,2,2,1,3
62864_0,,,,2,2,1,3
62865_0,,,,2,2,1,3
62866_0,,,,2,2,1,3
62867_0,,,,2,2,1,3
62868_0,,,,2,2,1,3
62869_0,,,,2,2,1,3
62870_0,,,,2,2,1,3
62871_0,,,,2,2,1,3
62872_0,,,,2,2,1,3
62873_0,,,,2,2,1,3
62874_0,,,,2,2,1,3
62875_0,,,,2,2,1,3
62876_0,,,,2,2,1,3
62877_0,,,,2,2,1,3
62878_0,,,,2,2,1,3
62879_0,,,,2,2,1,3
62880_0,,,,2,2,1,3
62881_0,,,,2,2,1,3
62882_0,,,,2,2,1,3
62883_0,,,,2,2,1,3
62884_0,,,,2,2,1,3
62885_0,,,,2,2,1,3
62886_0,,,,2,2,1,3
62887_0,,,,2,2,1,3
62888_0,,,,2,2,1,3
62889_0,,,,2,2,1,3
62890_0,,,,2,2,1,3
62891_0,,,,2,2,1,3
62892_0,,,,2,2,1,3
62893_0,,,,2,2,1,3
62894_0,,,,2,2,1,3
62895_0,,,,2,2,1,3
62896_0,,,,2,2,1,3
62897_0,,,,2,2,1,3
62898_0,,,,2,2,1,3
62899_0,,,,2,2,1,3
62900_0,,,,2,2,1,3
62901_0,,,,2,2,1,3
62902_0,,,,2,2,1,3
62903_0,,,,2,2,1,3
62905_0,,,,2,2,1,3
C(C(CCC=O)C(C=O)(C)O)(O)=O,,,5,1,1,0,1
62907_0,,,,2,2,1,3
C(CCCC(C=O)(CC(O)=O)O)=O,,,5,1,1,0,1
62909_0,,,,2,2,1,3
C(C(CCC=O)C(C(C)=O)O)(O)=O,,,5,1,1,0,1
62911_0,,,,2,2,1,3
C(C)(C(CCC=O)(CC(O)=O)O)=O,,,5,1,1,0,1
62913_0,,,,2,2,1,3
C(CC(C(CCCC=O)=O)O)(O)=O,,,5,1,1,0,1
62915_0,,,,2,2,1,3
C(C(C=O)CC(C(O)=O)C(C)O)=O,,,5,1,1,0,1
62917_0,,,,2,2,1,3
C(C(C(C)CC=O)C(C)O)(O)=O,,,5,1,1,0,1
62919_0,,,,2,2,1,3
C(C(CCC=O)C(C)O)(O)=O,,,5,1,1,0,1
62921_0,,,,2,2,1,3
C(C(CCC(O)=O)C(C)O)(O)=O,,,5,1,1,0,1
62923_0,,,,2,2,1,3
C(C(C1COC(C1)=O)C(C)O)(O)=O,,,5,1,1,0,1
62924_0,,,,2,2,1,3
62925_0,,,,2,2,1,3
62927_0,,,,2,2,1,3
C(C(C=O)CC(C)(CC(O)=O)O)=O,,,5,1,1,0,1
62929_0,,,,2,2,1,3
C(CC(C)(C(C)CC=O)O)(O)=O,,,5,1,1,0,1
62931_0,,,,2,2,1,3
C(CC(C)(CCC=O)O)(O)=O,,,5,1,1,0,1
62933_0,,,,2,2,1,3
C(CCC(C)(CC(O)=O)O)(O)=O,,,5,1,1,0,1
62935_0,,,,2,2,1,3
C1(CC(CO1)C(C)(CC(O)=O)O)=O,,,5,1,1,0,1
62936_0,,,,2,2,1,3
62937_0,,,,2,2,1,3
62939_0,,,,2,2,1,3
C(C(C=O)CCC(CC(O)=O)O)=O,,,5,1,1,0,1
62941_0,,,,2,2,1,3
C(CC(CC(C)CC=O)O)(O)=O,,,5,1,1,0,1
62943_0,,,,2,2,1,3
C(CC(CCCC=O)O)(O)=O,,,5,1,1,0,1
62945_0,,,,2,2,1,3
C(CCCC(CC(O)=O)O)(O)=O,,,5,1,1,0,1
62947_0,,,,2,2,1,3
C1(CC(CO1)CC(CC(O)=O)O)=O,,,5,1,1,0,1
62948_0,,,,2,2,1,3
62949_0,,,,2,2,1,3
62951_0,,,,2,2,1,3
C(C(C=O)CC(C(O)=O)C(O)=O)=O,,,5,1,1,0,1
62953_0,,,,2,2,1,3
C(CC(C)C(C(O)=O)C(O)=O)=O,,,5,1,1,0,1
62955_0,,,,2,2,1,3
C(CCC(C(O)=O)C(O)=O)=O,,,5,1,1,0,1
62957_0,,,,2,2,1,3
C(C(C(O)=O)CCC(O)=O)(O)=O,,,5,1,1,0,1
62959_0,,,,2,2,1,3
C1(CC(CO1)C(C(O)=O)C(O)=O)=O,,,5,1,1,0,1
62960_0,,,,2,2,1,3
62961_0,,,,2,2,1,3
62963_0,,,,2,2,1,3
C(C(CCC=O)(CC(O)=O)O)(O)=O,,,5,1,1,0,1
62965_0,,,,2,2,1,3
C(C(CCC=O)C(C(O)=O)O)(O)=O,,,5,1,1,0,1
62967_0,,,,2,2,1,3
C(C=O)(C(C)CCC(C(O)=O)=O)=O,,,5,1,1,0,1
62969_0,,,,2,2,1,3
C(C(CCCCC(C(O)=O)=O)=O)=O,,,5,1,2,0,2
62971_0,,,,2,2,1,3
C(C(CCC(C(O)=O)=O)CC=O)=O,,,5,1,3,0,3
62973_0,,,,2,2,1,3
C(C(C)=O)(CCCC(C(O)=O)=O)=O,,,5,1,1,0,1
62975_0,,,,2,2,1,3
C(C(O)=O)(CCCC(C=O)=CC=O)=O,,,5,1,1,0,1
62977_0,,,,2,2,1,3
C(C(C(C=O)=C)CCC(C(O)=O)=O)=O,,,5,1,1,0,1
62979_0,,,,2,2,1,3
C(C(O)=O)(CCCC(C=CC=O)=O)=O,,,5,1,1,0,1
62981_0,,,,2,2,1,3
C=CC(C(C=O)=O)CCC(C(O)=O)=O,,,5,1,1,0,1
62983_0,,,,2,2,1,3
C(CCCC(C(O)=O)=O)=CC(C=O)=O,,,5,1,1,0,1
62985_0,,,,2,2,1,3
C(C(C=CC=O)CCC(C(O)=O)=O)=O,,,5,1,1,0,1
62987_0,,,,2,2,1,3
C(C(C=O)(C=C)CCC(C(O)=O)=O)=O,,,5,1,1,0,1
62989_0,,,,2,2,1,3
C(CCCC(C(O)=O)=O)=C(C=O)C=O,,,5,1,1,0,1
62991_0,,,,2,2,1,3
C(CCCC(C(O)=O)=O)=CC=O,,,5,1,1,0,1
62993_0,,,,2,2,1,3
C(C(C=C)CCC(C(O)=O)=O)=O,,,5,1,1,0,1
62995_0,,,,2,2,1,3
C(C(C=C)(CCC(C(O)=O)=O)O)=O,,,5,1,1,0,1
62997_0,,,,2,2,1,3
C1C(CCC(C(O)=O)=O)OC(C=1)=O,,,5,1,1,0,1
62999_0,,,,2,2,1,3
C1OC(C(C=1)=O)CCC(C(O)=O)=O,,,5,1,1,0,1
63000_0,,,,2,2,1,3
63001_0,,,,2,2,1,3
63002_0,,,,2,2,1,3
63003_0,,,,2,2,1,3
63004_0,,,,2,2,1,3
63005_0,,,,2,2,1,3
63006_0,,,,2,2,1,3
63007_0,,,,2,2,1,3
63008_0,,,,2,2,1,3
63009_0,,,,2,2,1,3
63010_0,,,,2,2,1,3
63011_0,,,,2,2,1,3
63012_0,,,,2,2,1,3
63013_0,,,,2,2,1,3
63014_0,,,,2,2,1,3
63015_0,,,,2,2,1,3
63016_0,,,,2,2,1,3
63017_0,,,,2,2,1,3
63018_0,,,,2,2,1,3
63019_0,,,,2,2,1,3
63020_0,,,,2,2,1,3
63021_0,,,,2,2,1,3
63022_0,,,,2,2,1,3
63023_0,,,,2,2,1,3
63024_0,,,,2,2,1,3
63025_0,,,,2,2,1,3
63026_0,,,,2,2,1,3
63028_0,,,,2,2,1,3
C(CC(C(O)=O)C(C(C=O)=O)C)=O,,,5,1,1,0,1
63030_0,,,,2,2,1,3
C(CC(C(O)=O)CCC(C=O)=O)=O,,,5,1,1,0,1
63032_0,,,,2,2,1,3
C(CC(C=O)C(C(O)=O)CC=O)=O,,,5,1,1,0,1
63034_0,,,,2,2,1,3
C(CC(C(O)=O)CC(C(C)=O)=O)=O,,,5,1,1,0,1
63036_0,,,,2,2,1,3
C(CC(C(O)=O)CC(C=O)=CC=O)=O,,,5,1,1,0,1
63038_0,,,,2,2,1,3
C(C(C(C=O)=C)C(C(O)=O)CC=O)=O,,,5,1,1,0,1
63040_0,,,,2,2,1,3
C(CC(C(O)=O)CC(C=CC=O)=O)=O,,,5,1,1,0,1
63042_0,,,,2,2,1,3
C(CC(C(O)=O)C(C=C)C(C=O)=O)=O,,,5,1,1,0,1
63044_0,,,,2,2,1,3
C(CC(C(O)=O)CC=CC(C=O)=O)=O,,,5,1,1,0,1
63046_0,,,,2,2,1,3
C(C(C=CC=O)C(C(O)=O)CC=O)=O,,,5,1,1,0,1
63048_0,,,,2,2,1,3
C(C(C=O)(C=C)C(C(O)=O)CC=O)=O,,,5,1,1,0,1
63050_0,,,,2,2,1,3
C(CC(C(O)=O)CC=C(C=O)C=O)=O,,,5,1,1,0,1
63052_0,,,,2,2,1,3
C(CC(C(O)=O)CC=CC=O)=O,,,5,1,1,0,1
63054_0,,,,2,2,1,3
C(C(C=C)C(C(O)=O)CC=O)=O,,,5,1,1,0,1
63056_0,,,,2,2,1,3
C(C(C=C)(C(C(O)=O)CC=O)O)=O,,,5,1,1,0,1
63058_0,,,,2,2,1,3
C(CC(C(O)=O)C1C=CC(O1)=O)=O,,,5,1,1,0,1
63060_0,,,,2,2,1,3
C(CC(C(O)=O)C1C(C=CO1)=O)=O,,,5,1,1,0,1
63061_0,,,,2,2,1,3
63062_0,,,,2,2,1,3
63063_0,,,,2,2,1,3
63064_0,,,,2,2,1,3
63065_0,,,,2,2,1,3
63066_0,,,,2,2,1,3
63067_0,,,,2,2,1,3
63068_0,,,,2,2,1,3
63069_0,,,,2,2,1,3
63070_0,,,,2,2,1,3
63071_0,,,,2,2,1,3
63072_0,,,,2,2,1,3
63073_0,,,,2,2,1,3
63074_0,,,,2,2,1,3
63075_0,,,,2,2,1,3
63076_0,,,,2,2,1,3
63077_0,,,,2,2,1,3
63078_0,,,,2,2,1,3
63079_0,,,,2,2,1,3
63080_0,,,,2,2,1,3
63081_0,,,,2,2,1,3
63082_0,,,,2,2,1,3
63083_0,,,,2,2,1,3
63084_0,,,,2,2,1,3
63085_0,,,,2,2,1,3
63086_0,,,,2,2,1,3
63087_0,,,,2,2,1,3
63089_0,,,,2,2,1,3
C(C(CC(O)=O)C(C(C=O)=O)C)=O,,,5,1,1,0,1
63091_0,,,,2,2,1,3
C(C(CCC(C=O)=O)CC(O)=O)=O,,,5,1,1,0,1
63093_0,,,,2,2,1,3
C(CC(C=O)C(C=O)CC(O)=O)=O,,,5,1,1,0,1
63095_0,,,,2,2,1,3
C(C(CC(O)=O)CC(C(C)=O)=O)=O,,,5,1,1,0,1
63097_0,,,,2,2,1,3
C(C(CC(O)=O)CC(C=O)=CC=O)=O,,,5,1,1,0,1
63099_0,,,,2,2,1,3
C(C(C(C=O)=C)C(C=O)CC(O)=O)=O,,,5,1,1,0,1
63101_0,,,,2,2,1,3
C(C(CC(O)=O)CC(C=CC=O)=O)=O,,,5,1,1,0,1
63103_0,,,,2,2,1,3
C(C(CC(O)=O)C(C=C)C(C=O)=O)=O,,,5,1,1,0,1
63105_0,,,,2,2,1,3
C(C(CC(O)=O)CC=CC(C=O)=O)=O,,,5,1,1,0,1
63107_0,,,,2,2,1,3
C(C(C=CC=O)C(C=O)CC(O)=O)=O,,,5,1,1,0,1
63109_0,,,,2,2,1,3
C(C(C=O)(C=C)C(C=O)CC(O)=O)=O,,,5,1,1,0,1
63111_0,,,,2,2,1,3
C(C(CC(O)=O)CC=C(C=O)C=O)=O,,,5,1,1,0,1
63113_0,,,,2,2,1,3
C(C(CC(O)=O)CC=CC=O)=O,,,5,1,1,0,1
63115_0,,,,2,2,1,3
C(C(C=C)C(C=O)CC(O)=O)=O,,,5,1,1,0,1
63117_0,,,,2,2,1,3
C(C(C=C)(C(C=O)CC(O)=O)O)=O,,,5,1,1,0,1
63119_0,,,,2,2,1,3
C(C(CC(O)=O)C1C=CC(O1)=O)=O,,,5,1,1,0,1
63121_0,,,,2,2,1,3
C(C(CC(O)=O)C1C(C=CO1)=O)=O,,,5,1,1,0,1
63122_0,,,,2,2,1,3
63123_0,,,,2,2,1,3
63124_0,,,,2,2,1,3
63125_0,,,,2,2,1,3
63126_0,,,,2,2,1,3
63127_0,,,,2,2,1,3
63128_0,,,,2,2,1,3
63129_0,,,,2,2,1,3
63130_0,,,,2,2,1,3
63131_0,,,,2,2,1,3
63132_0,,,,2,2,1,3
63133_0,,,,2,2,1,3
63134_0,,,,2,2,1,3
63135_0,,,,2,2,1,3
63136_0,,,,2,2,1,3
63137_0,,,,2,2,1,3
63138_0,,,,2,2,1,3
63139_0,,,,2,2,1,3
63140_0,,,,2,2,1,3
63141_0,,,,2,2,1,3
63142_0,,,,2,2,1,3
63143_0,,,,2,2,1,3
63144_0,,,,2,2,1,3
63145_0,,,,2,2,1,3
63146_0,,,,2,2,1,3
63147_0,,,,2,2,1,3
63148_0,,,,2,2,1,3
63149_0,,,,2,2,1,3
63150_0,,,,2,2,1,3
63152_0,,,,2,2,1,3
C(CCC1C(C(CO)(CO1)O)=O)=O,,,5,1,1,0,1
63154_0,,,,2,2,1,3
C(CCC1C(C(CO1)=O)(CO)O)=O,,,5,1,1,0,1
63155_0,,,,2,2,1,3
63157_0,,,,2,2,1,3
C1(C(CCC=O)(CO)C(CO1)O)=O,,,5,1,1,0,1
63159_0,,,,2,2,1,3
C1(C(CO)C(C(CCC=O)O1)O)=O,,,5,1,1,0,1
63161_0,,,,2,2,1,3
C1(C(CO)C(CO1)(CCC=O)O)=O,,,5,1,1,0,1
63163_0,,,,2,2,1,3
C(C(C)(C(C)(CCC=O)O)O)(O)=O,,,5,1,1,0,1
63165_0,,,,2,2,1,3
C(C(C)(C(CCCC=O)O)O)(O)=O,,,5,1,1,0,1
63167_0,,,,2,2,1,3
C(C(C(C)O)(CCCC=O)O)(O)=O,,,5,1,1,0,1
63168_0,,,,2,2,1,3
63170_0,,,,2,2,1,3
C(CCCC(C(C=O)=O)(CO)O)=O,,,5,1,1,0,1
63171_0,,,,2,2,1,3
63173_0,,,,2,2,1,3
C(CCC1CC(C(CO)(O)O1)=O)=O,,,5,1,1,0,1
63175_0,,,,2,2,1,3
C(CCC1C(C(CO)(O)OC1)=O)=O,,,5,1,1,0,1
63176_0,,,,2,2,1,3
63177_0,,,,2,2,1,3
63179_0,,,,2,2,1,3
C(C(C(C)CC=O)O)(OCC=O)=O,,,5,1,1,0,1
63181_0,,,,2,2,1,3
C(C(CCC=O)O)(OCC=O)=O,,,5,1,1,0,1
63183_0,,,,2,2,1,3
C(CCC(C(OCC=O)=O)O)(O)=O,,,5,1,1,0,1
63185_0,,,,2,2,1,3
C(CC(C)C(C=O)OC(CO)=O)=O,,,5,1,1,0,1
63187_0,,,,2,2,1,3
C(CCC(C=O)OC(CO)=O)=O,,,5,1,1,0,1
63189_0,,,,2,2,1,3
C(CCC(C=O)OC(CO)=O)(O)=O,,,5,1,1,0,1
63191_0,,,,2,2,1,3
C(CCC(C(C(CC=O)=O)=O)O)=O,,,5,1,1,0,1
63193_0,,,,2,2,1,3
C(CCC(C=O)C(C(CO)=O)=O)=O,,,5,1,1,0,1
63195_0,,,,2,2,1,3
C(C(C(C(CC=O)=O)=O)CCC=O)=O,,,5,1,1,0,1
63197_0,,,,2,2,1,3
C(C(C(CC(C=O)=O)=O)CCC=O)=O,,,5,1,1,0,1
63199_0,,,,2,2,1,3
C(CC=O)(C(C(C=O)=O)CCC=O)=O,,,5,1,1,0,1
63201_0,,,,2,2,1,3
C(CC(C)C(C=O)C(C=O)CO)=O,,,5,1,1,0,1
63203_0,,,,2,2,1,3
C(CCC(C=O)C(C=O)CO)=O,,,5,1,1,0,1
63205_0,,,,2,2,1,3
C(CCC(C=O)C(C=O)CO)(O)=O,,,5,1,1,0,1
63207_0,,,,2,2,1,3
C(C(CO)(C(C)CC=O)CC=O)=O,,,5,1,1,0,1
63209_0,,,,2,2,1,3
C(C(CCC=O)(CO)CC=O)=O,,,5,1,1,0,1
63211_0,,,,2,2,1,3
C(CCC(C=O)(CO)CC=O)(O)=O,,,5,1,1,0,1
63213_0,,,,2,2,1,3
C(CC(C)C(C(C=O)CC=O)O)=O,,,5,1,1,0,1
63214_0,,,,2,2,1,3
63216_0,,,,2,2,1,3
C(CCC(C(C=O)CC=O)O)(O)=O,,,5,1,1,0,1
63218_0,,,,2,2,1,3
C(CC(C)CC(CC(CO)=O)=O)=O,,,5,1,1,0,1
63220_0,,,,2,2,1,3
C(CCCC(CC(CO)=O)=O)=O,,,5,1,1,0,1
63222_0,,,,2,2,1,3
C(CCCC(CC(CO)=O)=O)(O)=O,,,5,1,1,0,1
63224_0,,,,2,2,1,3
C(CC(C)C(C(C)=O)C(CO)=O)=O,,,5,1,1,0,1
63226_0,,,,2,2,1,3
C(CCC(C(C)=O)C(CO)=O)=O,,,5,1,1,0,1
63228_0,,,,2,2,1,3
C(CCC(C(C)=O)C(CO)=O)(O)=O,,,5,1,1,0,1
63230_0,,,,2,2,1,3
C(CC(C)C(C(CC(C)=O)=O)O)=O,,,5,1,1,0,1
63232_0,,,,2,2,1,3
C(CCC(C(CC(C)=O)=O)O)=O,,,5,1,1,0,1
63234_0,,,,2,2,1,3
C(CCC(C(CC(C)=O)=O)O)(O)=O,,,5,1,1,0,1
63236_0,,,,2,2,1,3
C(CC(C)C(C(C(CO)=O)=O)C)=O,,,5,1,1,0,1
63238_0,,,,2,2,1,3
C(CCC(C(C(CO)=O)=O)C)=O,,,5,1,1,0,1
63240_0,,,,2,2,1,3
C(CCC(C(C(CO)=O)=O)C)(O)=O,,,5,1,1,0,1
63242_0,,,,2,2,1,3
C(CC(C)CCC(C(CO)=O)=O)=O,,,5,1,1,0,1
63244_0,,,,2,2,1,3
C(CCCCC(C(CO)=O)=O)=O,,,5,1,1,0,1
63246_0,,,,2,2,1,3
C(CCCCC(C(CO)=O)=O)(O)=O,,,5,1,1,0,1
63248_0,,,,2,2,1,3
C(CC(C)C(C(C(CC)=O)=O)O)=O,,,5,1,1,0,1
63250_0,,,,2,2,1,3
C(CCC(C(C(CC)=O)=O)O)=O,,,5,1,1,0,1
63252_0,,,,2,2,1,3
C(CCC(C(C(CC)=O)=O)O)(O)=O,,,5,1,1,0,1
63254_0,,,,2,2,1,3
C(C(C(C=O)=O)(C)CC(C=O)C=O)=O,,,5,1,1,0,1
63256_0,,,,2,2,1,3
C(C(C(C=O)=O)(C)C(C)CC=O)=O,,,5,1,1,0,1
63258_0,,,,2,2,1,3
C(C(C(C=O)=O)(C)CCC=O)=O,,,5,1,1,0,1
63260_0,,,,2,2,1,3
C(C(C(C=O)=O)(C)CCC(O)=O)=O,,,5,1,1,0,1
63262_0,,,,2,2,1,3
C(C(C(C=O)=O)(C)C1COC(C1)=O)=O,,,5,1,1,0,1
63264_0,,,,2,2,1,3
C(C(C(C=O)=O)(C)CCC(C=O)=O)=O,,,5,1,1,0,1
63266_0,,,,2,2,1,3
C(CC(C=O)C(C=O)(C(C=O)=O)C)=O,,,5,1,1,0,1
63268_0,,,,2,2,1,3
C(C(C(C=O)=O)CCC(C=O)C=O)=O,,,5,1,1,0,1
63270_0,,,,2,2,1,3
C(C(C(C=O)=O)CC(C)CC=O)=O,,,5,1,1,0,1
63272_0,,,,2,2,1,3
C(C(C(C=O)=O)CCCC=O)=O,,,5,1,1,0,1
63274_0,,,,2,2,1,3
C(C(C(C=O)=O)CCCC(O)=O)=O,,,5,1,1,0,1
63276_0,,,,2,2,1,3
C(C(C(C=O)=O)CC1COC(C1)=O)=O,,,5,1,1,0,1
63278_0,,,,2,2,1,3
C(C(C(C=O)=O)CCCC(C=O)=O)=O,,,5,1,1,0,1
63279_0,,,,2,2,1,3
63281_0,,,,2,2,1,3
C(C(C(C(C)=O)=O)CC(C=O)C=O)=O,,,5,1,1,0,1
63283_0,,,,2,2,1,3
C(CC(C)C(C=O)C(C(C)=O)=O)=O,,,5,1,1,0,1
63285_0,,,,2,2,1,3
C(CCC(C=O)C(C(C)=O)=O)=O,,,5,1,1,0,1
63287_0,,,,2,2,1,3
C(C(C(C(C)=O)=O)CCC(O)=O)=O,,,5,1,1,0,1
63289_0,,,,2,2,1,3
C(C(C(C(C)=O)=O)C1COC(C1)=O)=O,,,5,1,1,0,1
63291_0,,,,2,2,1,3
C(C(C(C(C)=O)=O)CCC(C=O)=O)=O,,,5,1,1,0,1
63293_0,,,,2,2,1,3
C(C(C(C(C)=O)=O)C(C=O)CC=O)=O,,,5,1,1,0,1
63295_0,,,,2,2,1,3
C(C(C=O)CCC(C(CC=O)=O)=O)=O,,,5,1,1,0,1
63297_0,,,,2,2,1,3
C(CC(C(CC(C)CC=O)=O)=O)=O,,,5,1,1,0,1
63299_0,,,,2,2,1,3
C(CC(C(CCCC=O)=O)=O)=O,,,5,1,1,0,1
63301_0,,,,2,2,1,3
C(CC(C(CCCC(O)=O)=O)=O)=O,,,5,1,1,0,1
63303_0,,,,2,2,1,3
C(CC(C(CC1COC(C1)=O)=O)=O)=O,,,5,1,1,0,1
63305_0,,,,2,2,1,3
C(CC(C(CCCC(C=O)=O)=O)=O)=O,,,5,1,1,0,1
63307_0,,,,2,2,1,3
C(CC(C(CC(C=O)CC=O)=O)=O)=O,,,5,1,1,0,1
63309_0,,,,2,2,1,3
C(C(CC(C=O)C=O)CC(C=O)=O)=O,,,5,1,2,0,2
63311_0,,,,2,2,1,3
C(CC(C)C(C=O)CC(C=O)=O)=O,,,5,1,1,0,1
63313_0,,,,2,2,1,3
C(CCC(C=O)CC(C=O)=O)=O,,,5,1,2,0,2
63315_0,,,,2,2,1,3
C(C(CCC(O)=O)CC(C=O)=O)=O,,,5,1,2,0,2
63317_0,,,,2,2,1,3
C(C(C1COC(C1)=O)CC(C=O)=O)=O,,,5,1,1,0,1
63319_0,,,,2,2,1,3
C(C(CCC(C=O)=O)CC(C=O)=O)=O,,,5,1,3,0,3
63321_0,,,,2,2,1,3
C(CC(C=O)C(C=O)CC(C=O)=O)=O,,,5,1,2,0,2
63323_0,,,,2,2,1,3
C(C(C=O)CC(C(C=O)=O)CC=O)=O,,,5,1,1,0,1
63325_0,,,,2,2,1,3
C(CC(C)C(C(C=O)=O)CC=O)=O,,,5,1,1,0,1
63327_0,,,,2,2,1,3
C(CCC(C(C=O)=O)CC=O)=O,,,5,1,1,0,1
63329_0,,,,2,2,1,3
C(CC(C(C=O)=O)CCC(O)=O)=O,,,5,1,1,0,1
63331_0,,,,2,2,1,3
C(CC(C(C=O)=O)C1COC(C1)=O)=O,,,5,1,1,0,1
63333_0,,,,2,2,1,3
C(CC(C(C=O)=O)CCC(C=O)=O)=O,,,5,1,2,0,2
63335_0,,,,2,2,1,3
C(CC(C(C=O)=O)C(C=O)CC=O)=O,,,5,1,2,0,2
63337_0,,,,2,2,1,3
C(C(C=O)CC(C=O)C(CC=O)=O)=O,,,5,1,1,0,1
63339_0,,,,2,2,1,3
C(C(C(CC=O)=O)C(C)CC=O)=O,,,5,1,1,0,1
63341_0,,,,2,2,1,3
C(C(C(CC=O)=O)CCC=O)=O,,,5,1,1,0,1
63343_0,,,,2,2,1,3
C(C(C(CC=O)=O)CCC(O)=O)=O,,,5,1,1,0,1
63345_0,,,,2,2,1,3
C(C(C(CC=O)=O)C1COC(C1)=O)=O,,,5,1,1,0,1
63347_0,,,,2,2,1,3
C(C(C(CC=O)=O)CCC(C=O)=O)=O,,,5,1,1,0,1
63349_0,,,,2,2,1,3
C(C(C(CC=O)=O)C(C=O)CC=O)=O,,,5,1,1,0,1
63351_0,,,,2,2,1,3
C(C(C=O)CC(C=O)C(C=O)C=O)=O,,,5,1,2,0,2
63353_0,,,,2,2,1,3
C(CC(C)C(C=O)C(C=O)C=O)=O,,,5,1,1,0,1
63355_0,,,,2,2,1,3
C(CCC(C=O)C(C=O)C=O)=O,,,5,1,2,0,2
63357_0,,,,2,2,1,3
C(C(C=O)C(C=O)CCC(O)=O)=O,,,5,1,2,0,2
63359_0,,,,2,2,1,3
C(C(C=O)C(C=O)C1COC(C1)=O)=O,,,5,1,1,0,1
63361_0,,,,2,2,1,3
C(C(C=O)C(C=O)CCC(C=O)=O)=O,,,5,1,3,0,3
63363_0,,,,2,2,1,3
C(C(C=O)C(C=O)C(C=O)CC=O)=O,,,5,1,2,0,2
63365_0,,,,2,2,1,3
C(C(C=O)CC(C=O)(C=O)CC=O)=O,,,5,1,1,0,1
63367_0,,,,2,2,1,3
C(CC(C)C(C=O)(C=O)CC=O)=O,,,5,1,1,0,1
63369_0,,,,2,2,1,3
C(CCC(C=O)(C=O)CC=O)=O,,,5,1,1,0,1
63371_0,,,,2,2,1,3
C(C(C=O)(CCC(O)=O)CC=O)=O,,,5,1,1,0,1
63373_0,,,,2,2,1,3
C(C(C=O)(C1COC(C1)=O)CC=O)=O,,,5,1,1,0,1
63375_0,,,,2,2,1,3
C(C(C=O)(CCC(C=O)=O)CC=O)=O,,,5,1,2,0,2
63377_0,,,,2,2,1,3
C(C(C=O)(CC=O)C(C=O)CC=O)=O,,,5,1,2,0,2
63379_0,,,,2,2,1,3
C(CC(C)C(C=O)CC(CC=O)=O)=O,,,5,1,1,0,1
63381_0,,,,2,2,1,3
C(CCC(C=O)CC(CC=O)=O)=O,,,5,1,1,0,1
63383_0,,,,2,2,1,3
C(CC(C)C(C(CC=O)=O)CC=O)=O,,,5,1,1,0,1
63385_0,,,,2,2,1,3
C(CCC(C(CC=O)=O)CC=O)=O,,,5,1,1,0,1
63387_0,,,,2,2,1,3
C(CC(C)C(C=O)C(CCC=O)=O)=O,,,5,1,1,0,1
63389_0,,,,2,2,1,3
C(CCC(C=O)C(CCC=O)=O)=O,,,5,1,1,0,1
63391_0,,,,2,2,1,3
C(CC(C)C(C=O)C(C=O)CC=O)=O,,,5,1,1,0,1
63393_0,,,,2,2,1,3
C(CCC(C=O)C(C=O)CC=O)=O,,,5,1,1,0,1
63395_0,,,,2,2,1,3
C(CC(C)C(C=O)(CC=O)CC=O)=O,,,5,1,1,0,1
63397_0,,,,2,2,1,3
C(CCC(C=O)(CC=O)CC=O)=O,,,5,1,1,0,1
63399_0,,,,2,2,1,3
C(CC(CC(CC(C)CC=O)=O)=O)=O,,,5,1,1,0,1
63401_0,,,,2,2,1,3
C(CC(CC(CCCC=O)=O)=O)=O,,,5,1,1,0,1
63403_0,,,,2,2,1,3
C(C(C(CC(C)=O)=O)C(C)CC=O)=O,,,5,1,1,0,1
63405_0,,,,2,2,1,3
C(C(C(CC(C)=O)=O)CCC=O)=O,,,5,1,1,0,1
63407_0,,,,2,2,1,3
C(CC(C)C(C(CC=O)=O)C(C)=O)=O,,,5,1,1,0,1
63409_0,,,,2,2,1,3
C(CCC(C(CC=O)=O)C(C)=O)=O,,,5,1,1,0,1
63411_0,,,,2,2,1,3
C(CC(C(C(C)C(C)CC=O)=O)=O)=O,,,5,1,1,0,1
63413_0,,,,2,2,1,3
C(CC(C(C(C)CCC=O)=O)=O)=O,,,5,1,1,0,1
63415_0,,,,2,2,1,3
C(CC(C(CCC(C)CC=O)=O)=O)=O,,,5,1,1,0,1
63417_0,,,,2,2,1,3
C(CC(C(CCCCC=O)=O)=O)=O,,,5,1,1,0,1
63419_0,,,,2,2,1,3
C(C(C(C(CC)=O)=O)C(C)CC=O)=O,,,5,1,1,0,1
63421_0,,,,2,2,1,3
C(C(C(C(CC)=O)=O)CCC=O)=O,,,5,1,1,0,1
63423_0,,,,2,2,1,3
C(CC(C)C(C=O)CC(C(C)=O)=O)=O,,,5,1,1,0,1
63425_0,,,,2,2,1,3
C(CCC(C=O)CC(C(C)=O)=O)=O,,,5,1,1,0,1
63427_0,,,,2,2,1,3
C(CC(C)C(C(C(C)=O)=O)CC=O)=O,,,5,1,1,0,1
63429_0,,,,2,2,1,3
C(CCC(C(C(C)=O)=O)CC=O)=O,,,5,1,1,0,1
63431_0,,,,2,2,1,3
C(CC(C)CC(C(CCC=O)=O)=O)=O,,,5,1,1,0,1
63433_0,,,,2,2,1,3
C(CCCC(C(CCC=O)=O)=O)=O,,,5,1,1,0,1
63435_0,,,,2,2,1,3
C(CC(C)C(C=O)C(C(C=O)=O)C)=O,,,5,1,1,0,1
63437_0,,,,2,2,1,3
C(CCC(C=O)C(C(C=O)=O)C)=O,,,5,1,1,0,1
63439_0,,,,2,2,1,3
C(CC(C)CC(C(C=O)=O)CC=O)=O,,,5,1,1,0,1
63441_0,,,,2,2,1,3
C(CCCC(C(C=O)=O)CC=O)=O,,,5,1,1,0,1
63443_0,,,,2,2,1,3
C(CC(C)C(C(C=O)=O)(C)CC=O)=O,,,5,1,1,0,1
63445_0,,,,2,2,1,3
C(CCC(C(C=O)=O)(C)CC=O)=O,,,5,1,1,0,1
63447_0,,,,2,2,1,3
C(CC(C(C=O)=O)C(C(C=O)=O)C)=O,,,5,1,1,0,1
63449_0,,,,2,2,1,3
C(C(CC(C=O)=O)C(C(C=O)=O)C)=O,,,5,1,1,0,1
63451_0,,,,2,2,1,3
C(C(C=O)(CC=O)C(C(C=O)=O)C)=O,,,5,1,1,0,1
63453_0,,,,2,2,1,3
C(C(C=O)C(C=O)C(C(C=O)=O)C)=O,,,5,1,1,0,1
63455_0,,,,2,2,1,3
C(C(C)C(C=O)C(C(C=O)=O)C)=O,,,5,1,1,0,1
63457_0,,,,2,2,1,3
C(C(C)(CC=O)C(C(C=O)=O)C)=O,,,5,1,1,0,1
63459_0,,,,2,2,1,3
C(C(CC(C(C=O)=O)C)CC=O)=O,,,5,1,1,0,1
63461_0,,,,2,2,1,3
C(CC(C=O)C(C(C=O)=O)C)(C)=O,,,5,1,1,0,1
63463_0,,,,2,2,1,3
C(CC(C(C)=O)C(C(C=O)=O)C)=O,,,5,1,1,0,1
63465_0,,,,2,2,1,3
C(C=O)(C(C)C(C)CC(C=O)=O)=O,,,5,1,1,0,1
63467_0,,,,2,2,1,3
C(CC(CC=O)C(C(C=O)=O)C)=O,,,5,1,1,0,1
63469_0,,,,2,2,1,3
C(C(C=O)C(C)C(C(C=O)=O)C)=O,,,5,1,1,0,1
63471_0,,,,2,2,1,3
C(C(C=O)CC(C(C=O)=O)C)=O,,,5,1,1,0,1
63473_0,,,,2,2,1,3
C(CC(C)C(C(C=O)=O)C)=O,,,5,1,1,0,1
63475_0,,,,2,2,1,3
C(CCC(C(C=O)=O)C)=O,,,5,1,1,0,1
63477_0,,,,2,2,1,3
C(CCC(C(C=O)=O)C)(O)=O,,,5,1,1,0,1
63479_0,,,,2,2,1,3
C(CC(CO)C(C(C=O)=O)C)(O)=O,,,5,1,1,0,1
63481_0,,,,2,2,1,3
C1(CC(CO1)C(C(C=O)=O)C)=O,,,5,1,1,0,1
63482_0,,,,2,2,1,3
63483_0,,,,2,2,1,3
63484_0,,,,2,2,1,3
63485_0,,,,2,2,1,3
63486_0,,,,2,2,1,3
63487_0,,,,2,2,1,3
63489_0,,,,2,2,1,3
C(C(CCC(C=O)=O)C(C=O)C)=O,,,5,1,1,0,1
63491_0,,,,2,2,1,3
C(C(C)(CCC(C=O)=O)CC=O)=O,,,5,1,1,0,1
63493_0,,,,2,2,1,3
C(C(CCCC(C=O)=O)CC=O)=O,,,5,1,1,0,1
63495_0,,,,2,2,1,3
C(C(CCC(C=O)=O)CC(C)=O)=O,,,5,1,1,0,1
63497_0,,,,2,2,1,3
C(C)(C(CCC(C=O)=O)CC=O)=O,,,5,1,1,0,1
63499_0,,,,2,2,1,3
C(C(CCC(C)CC(C=O)=O)=O)=O,,,5,1,1,0,1
63501_0,,,,2,2,1,3
C(CC(CCC(C=O)=O)CC=O)=O,,,5,1,1,0,1
63503_0,,,,2,2,1,3
C(C(C=O)C(C)CCC(C=O)=O)=O,,,5,1,1,0,1
63505_0,,,,2,2,1,3
C(C(C=O)CCCC(C=O)=O)=O,,,5,1,1,0,1
63507_0,,,,2,2,1,3
C(CC(C)CCC(C=O)=O)=O,,,5,1,1,0,1
63509_0,,,,2,2,1,3
C(CCCCC(C=O)=O)=O,,,5,1,1,0,1
63511_0,,,,2,2,1,3
C(CCCCC(C=O)=O)(O)=O,,,5,1,1,0,1
63513_0,,,,2,2,1,3
C(CC(CCC(C=O)=O)CO)(O)=O,,,5,1,1,0,1
63515_0,,,,2,2,1,3
C1(CC(CCC(C=O)=O)CO1)=O,,,5,1,1,0,1
63516_0,,,,2,2,1,3
63517_0,,,,2,2,1,3
63519_0,,,,2,2,1,3
C(CO)(C(C(C)CC=O)CC=O)=O,,,5,1,1,0,1
63521_0,,,,2,2,1,3
C(CO)(C(CCC=O)CC=O)=O,,,5,1,1,0,1
63523_0,,,,2,2,1,3
C(CO)(C(CCC(O)=O)CC=O)=O,,,5,1,1,0,1
63525_0,,,,2,2,1,3
C(CC(C)C(C(CCC=O)=O)O)=O,,,5,1,1,0,1
63527_0,,,,2,2,1,3
C(CCC(C(CCC=O)=O)O)=O,,,5,1,1,0,1
63529_0,,,,2,2,1,3
C(CCC(C(CCC=O)=O)O)(O)=O,,,5,1,1,0,1
63531_0,,,,2,2,1,3
C(CC(C)C(C=O)CC(CO)=O)=O,,,5,1,1,0,1
63533_0,,,,2,2,1,3
C(CCC(C=O)CC(CO)=O)=O,,,5,1,1,0,1
63535_0,,,,2,2,1,3
C(CCC(C=O)CC(CO)=O)(O)=O,,,5,1,1,0,1
63537_0,,,,2,2,1,3
C(C(CO)C(C)CC=O)(CC=O)=O,,,5,1,1,0,1
63539_0,,,,2,2,1,3
C(C(CCC=O)CO)(CC=O)=O,,,5,1,1,0,1
63541_0,,,,2,2,1,3
C(C(CCC(O)=O)CO)(CC=O)=O,,,5,1,1,0,1
63543_0,,,,2,2,1,3
C(CC(CC(C(C)CC=O)O)=O)=O,,,5,1,1,0,1
63544_0,,,,2,2,1,3
63546_0,,,,2,2,1,3
C(CC(CC(CCC(O)=O)O)=O)=O,,,5,1,1,0,1
63548_0,,,,2,2,1,3
C(C(C(CCO)=O)C(C)CC=O)=O,,,5,1,1,0,1
63550_0,,,,2,2,1,3
C(C(C(CCO)=O)CCC=O)=O,,,5,1,1,0,1
63552_0,,,,2,2,1,3
C(C(C(CCO)=O)CCC(O)=O)=O,,,5,1,1,0,1
63553_0,,,,2,2,1,3
63554_0,,,,2,2,1,3
63555_0,,,,2,2,1,3
63556_0,,,,2,2,1,3
63558_0,,,,2,2,1,3
C(CC(C=O)C(C=O)C(C=O)C)=O,,,5,1,1,0,1
63560_0,,,,2,2,1,3
C(CC(C=O)C(C=O)(C)CC=O)=O,,,5,1,1,0,1
63562_0,,,,2,2,1,3
C(C(CC(C=O)CC=O)CC=O)=O,,,5,1,1,0,1
63564_0,,,,2,2,1,3
C(CC(C=O)C(C=O)CC(C)=O)=O,,,5,1,1,0,1
63566_0,,,,2,2,1,3
C(CC(C(C)=O)C(C=O)CC=O)=O,,,5,1,1,0,1
63568_0,,,,2,2,1,3
C(C(C(C)CC(C=O)=O)CC=O)=O,,,5,1,1,0,1
63570_0,,,,2,2,1,3
C(CC(C(C=O)CC=O)CC=O)=O,,,5,1,1,0,1
63572_0,,,,2,2,1,3
C(C(C(C)C(C=O)C=O)CC=O)=O,,,5,1,1,0,1
63574_0,,,,2,2,1,3
C(C(CC(C=O)C=O)CC=O)=O,,,5,1,2,0,2
63576_0,,,,2,2,1,3
C(CC(C)C(C=O)CC=O)=O,,,5,1,1,0,1
63578_0,,,,2,2,1,3
C(CCC(C=O)CC=O)=O,,,5,1,2,0,2
63580_0,,,,2,2,1,3
C(C(CCC(O)=O)CC=O)=O,,,5,1,2,0,2
63582_0,,,,2,2,1,3
C(CC(CO)C(C=O)CC=O)(O)=O,,,5,1,2,0,2
63584_0,,,,2,2,1,3
C(C(C1COC(C1)=O)CC=O)=O,,,5,1,1,0,1
63585_0,,,,2,2,1,3
63586_0,,,,2,2,1,3
63588_0,,,,2,2,1,3
C(CC(C(C=O)=O)CC(C(C)=O)=O)=O,,,5,1,1,0,1
63590_0,,,,2,2,1,3
C(C(CC(C(C)=O)=O)CC(C=O)=O)=O,,,5,1,1,0,1
63592_0,,,,2,2,1,3
C(C(C=O)(CC=O)CC(C(C)=O)=O)=O,,,5,1,1,0,1
63594_0,,,,2,2,1,3
C(C(C=O)C(C=O)CC(C(C)=O)=O)=O,,,5,1,1,0,1
63596_0,,,,2,2,1,3
C(C(C)C(C=O)CC(C(C)=O)=O)=O,,,5,1,1,0,1
63598_0,,,,2,2,1,3
C(C(C)(CC=O)CC(C(C)=O)=O)=O,,,5,1,1,0,1
63600_0,,,,2,2,1,3
C(C(CCC(C(C)=O)=O)CC=O)=O,,,5,1,1,0,1
63602_0,,,,2,2,1,3
C(C(CC(C)=O)CC(C(C)=O)=O)=O,,,5,1,1,0,1
63604_0,,,,2,2,1,3
C(CC(C(C)=O)CC(C(C)=O)=O)=O,,,5,1,1,0,1
63606_0,,,,2,2,1,3
C(C=O)(CC(C)CC(C(C)=O)=O)=O,,,5,1,1,0,1
63608_0,,,,2,2,1,3
C(CC(CC=O)CC(C(C)=O)=O)=O,,,5,1,1,0,1
63610_0,,,,2,2,1,3
C(C(C=O)C(C)CC(C(C)=O)=O)=O,,,5,1,1,0,1
63612_0,,,,2,2,1,3
C(C(C=O)CCC(C(C)=O)=O)=O,,,5,1,1,0,1
63614_0,,,,2,2,1,3
C(CC(C)CC(C(C)=O)=O)=O,,,5,1,1,0,1
63616_0,,,,2,2,1,3
C(CCCC(C(C)=O)=O)=O,,,5,1,1,0,1
63618_0,,,,2,2,1,3
C(CCCC(C(C)=O)=O)(O)=O,,,5,1,1,0,1
63620_0,,,,2,2,1,3
C(CC(CO)CC(C(C)=O)=O)(O)=O,,,5,1,1,0,1
63622_0,,,,2,2,1,3
C1(CC(CO1)CC(C(C)=O)=O)=O,,,5,1,1,0,1
63623_0,,,,2,2,1,3
63624_0,,,,2,2,1,3
63626_0,,,,2,2,1,3
C(C(C(CCCC=O)=O)C(C=O)=O)=O,,,5,1,1,0,1
63628_0,,,,2,2,1,3
C(C(C(CCCC=O)=O)CO)(O)=O,,,5,1,1,0,1
63630_0,,,,2,2,1,3
C(CCC(C(O)=O)(C(C)=O)CO)=O,,,5,1,1,0,1
63631_0,,,,2,2,1,3
63633_0,,,,2,2,1,3
C(CC(C)CC(C(C=O)C(C)=O)=O)=O,,,5,1,1,0,1
63635_0,,,,2,2,1,3
C(CCCC(C(C=O)C(C)=O)=O)=O,,,5,1,1,0,1
63637_0,,,,2,2,1,3
C(CC(C)C(C=O)(C(C)=O)CO)=O,,,5,1,1,0,1
63639_0,,,,2,2,1,3
C(CCC(C=O)(C(C)=O)CO)=O,,,5,1,1,0,1
63641_0,,,,2,2,1,3
C(CCC(C=O)(C(C)=O)CO)(O)=O,,,5,1,1,0,1
63643_0,,,,2,2,1,3
C(CC(C)C(C(C=O)C(C)=O)O)=O,,,5,1,1,0,1
63644_0,,,,2,2,1,3
63646_0,,,,2,2,1,3
C(CCC(C(C=O)C(C)=O)O)(O)=O,,,5,1,1,0,1
63648_0,,,,2,2,1,3
C(C(C(CC(C)CC=O)=O)CO)=O,,,5,1,1,0,1
63650_0,,,,2,2,1,3
C(C(C(CCCC=O)=O)CO)=O,,,5,1,1,0,1
63652_0,,,,2,2,1,3
C(C(C(CCCC(O)=O)=O)CO)=O,,,5,1,1,0,1
63654_0,,,,2,2,1,3
C(CCC(C=O)(C(C=O)=O)CC=O)=O,,,5,1,1,0,1
63656_0,,,,2,2,1,3
C(CCC(C=O)C(C=O)C(C=O)=O)=O,,,5,1,1,0,1
63658_0,,,,2,2,1,3
C(C(C(C(O)=O)=O)C(C)CC=O)=O,,,5,1,1,0,1
63660_0,,,,2,2,1,3
C(C(C(C(O)=O)=O)CCC=O)=O,,,5,1,1,0,1
63662_0,,,,2,2,1,3
C(C(C(C(O)=O)=O)CCC(O)=O)=O,,,5,1,1,0,1
63664_0,,,,2,2,1,3
C(CC(C)C(C(O)=O)C(C=O)=O)=O,,,5,1,1,0,1
63665_0,,,,2,2,1,3
63666_0,,,,2,2,1,3
63668_0,,,,2,2,1,3
C(C(C(C(O)=O)=O)(C)CCC=O)=O,,,5,1,1,0,1
63670_0,,,,2,2,1,3
C(C(C(C(O)=O)=O)CCCC=O)=O,,,5,1,1,0,1
63672_0,,,,2,2,1,3
C(CCC(C(C)=O)C(C(O)=O)=O)=O,,,5,1,1,0,1
63674_0,,,,2,2,1,3
C(CCCC(CC(C(O)=O)=O)=O)=O,,,5,1,1,0,1
63676_0,,,,2,2,1,3
C(CCC(C(O)=O)C(C(C)=O)=O)=O,,,5,1,1,0,1
63678_0,,,,2,2,1,3
C(CCCC(C(CC(O)=O)=O)=O)=O,,,5,1,1,0,1
63680_0,,,,2,2,1,3
C(CCC(C=O)CC(C(O)=O)=O)=O,,,5,1,1,0,1
63682_0,,,,2,2,1,3
C(CCC(C(C(O)=O)=O)CC=O)=O,,,5,1,1,0,1
63684_0,,,,2,2,1,3
C(CC=O)(C(C(O)=O)CCC=O)=O,,,5,1,1,0,1
63686_0,,,,2,2,1,3
C(C(C(CC(O)=O)=O)CCC=O)=O,,,5,1,1,0,1
63688_0,,,,2,2,1,3
C(CC(C)CC(C(C=O)CC=O)=O)=O,,,5,1,1,0,1
63690_0,,,,2,2,1,3
C(CCCC(C(C=O)CC=O)=O)=O,,,5,1,1,0,1
63692_0,,,,2,2,1,3
C(CC(C)C(C(C)=O)(C=O)CC=O)=O,,,5,1,1,0,1
63694_0,,,,2,2,1,3
C(CCC(C(C)=O)(C=O)CC=O)=O,,,5,1,1,0,1
63696_0,,,,2,2,1,3
C(CC(C)C(C=O)C(C=O)C(C)=O)=O,,,5,1,1,0,1
63698_0,,,,2,2,1,3
C(CCC(C=O)C(C=O)C(C)=O)=O,,,5,1,1,0,1
63700_0,,,,2,2,1,3
C(C(C=O)CC(C(C(O)=O)=O)C)=O,,,5,1,1,0,1
63702_0,,,,2,2,1,3
C(CC(C)C(C(C(O)=O)=O)C)=O,,,5,1,1,0,1
63704_0,,,,2,2,1,3
C(CCC(C(C(O)=O)=O)C)=O,,,5,1,1,0,1
63706_0,,,,2,2,1,3
C(CCC(C(C(O)=O)=O)C)(O)=O,,,5,1,1,0,1
63708_0,,,,2,2,1,3
C1(CC(CO1)C(C(C(O)=O)=O)C)=O,,,5,1,1,0,1
63710_0,,,,2,2,1,3
C(C(O)=O)(C(C)CCC(C=O)=O)=O,,,5,1,1,0,1
63712_0,,,,2,2,1,3
C(CC(C=O)C(C(C(O)=O)=O)C)=O,,,5,1,1,0,1
63714_0,,,,2,2,1,3
C(C(C=O)CCCC(C(O)=O)=O)=O,,,5,1,1,0,1
63716_0,,,,2,2,1,3
C(CC(C)CCC(C(O)=O)=O)=O,,,5,1,1,0,1
63718_0,,,,2,2,1,3
C(CCCCC(C(O)=O)=O)=O,,,5,1,1,0,1
63720_0,,,,2,2,1,3
C(CCCCC(C(O)=O)=O)(O)=O,,,5,1,1,0,1
63722_0,,,,2,2,1,3
C1(CC(CO1)CCC(C(O)=O)=O)=O,,,5,1,1,0,1
63723_0,,,,2,2,1,3
63724_0,,,,2,2,1,3
63726_0,,,,2,2,1,3
C(C(C=O)CC(C(C)=O)C(O)=O)=O,,,5,1,1,0,1
63728_0,,,,2,2,1,3
C(CC(C)C(C(C)=O)C(O)=O)=O,,,5,1,1,0,1
63730_0,,,,2,2,1,3
C(CCC(C(C)=O)C(O)=O)=O,,,5,1,1,0,1
63732_0,,,,2,2,1,3
C(C)(C(C(O)=O)CCC(O)=O)=O,,,5,1,1,0,1
63734_0,,,,2,2,1,3
C1(CC(CO1)C(C(C)=O)C(O)=O)=O,,,5,1,1,0,1
63736_0,,,,2,2,1,3
C(C)(C(C(O)=O)CCC(C=O)=O)=O,,,5,1,1,0,1
63738_0,,,,2,2,1,3
C(C(C(C)=O)C(C=O)CC=O)(O)=O,,,5,1,1,0,1
63740_0,,,,2,2,1,3
C(C(C=O)CCC(CC(O)=O)=O)=O,,,5,1,1,0,1
63742_0,,,,2,2,1,3
C(CC(C)CC(CC(O)=O)=O)=O,,,5,1,1,0,1
63744_0,,,,2,2,1,3
C(CCCC(CC(O)=O)=O)=O,,,5,1,1,0,1
63746_0,,,,2,2,1,3
C(CCCC(O)=O)(CC(O)=O)=O,,,5,1,1,0,1
63748_0,,,,2,2,1,3
C1(CC(CO1)CC(CC(O)=O)=O)=O,,,5,1,1,0,1
63750_0,,,,2,2,1,3
C(CCCC(C=O)=O)(CC(O)=O)=O,,,5,1,1,0,1
63752_0,,,,2,2,1,3
C(CC(CC(C=O)CC=O)=O)(O)=O,,,5,1,1,0,1
63754_0,,,,2,2,1,3
C(CCC1C(C(C(CO)O1)O)=O)=O,,,5,1,1,0,1
63756_0,,,,2,2,1,3
C(CCC1(CO)C(C(CO1)=O)O)=O,,,5,1,1,0,1
63758_0,,,,2,2,1,3
C(CCC1(C(COC1CO)=O)O)=O,,,5,1,1,0,1
63760_0,,,,2,2,1,3
C(CCC(C1C(C(CO1)=O)O)O)=O,,,5,1,1,0,1
63762_0,,,,2,2,1,3
C(CCC1(C(CC(CO)O1)=O)O)=O,,,5,1,1,0,1
63764_0,,,,2,2,1,3
C(CCC1(CO)CC(C(O)O1)=O)=O,,,5,1,1,0,1
63766_0,,,,2,2,1,3
C(CCC1C(C(O)OC1CO)=O)=O,,,5,1,1,0,1
63768_0,,,,2,2,1,3
C(CCC(C1CC(C(O)O1)=O)O)=O,,,5,1,1,0,1
63770_0,,,,2,2,1,3
C1(C(CCC=O)C(C(CO)O1)O)=O,,,5,1,1,0,1
63772_0,,,,2,2,1,3
C1(CC(C(CCC=O)(CO)O1)O)=O,,,5,1,1,0,1
63774_0,,,,2,2,1,3
C1(CC(CCC=O)(C(CO)O1)O)=O,,,5,1,1,0,1
63776_0,,,,2,2,1,3
C1(CC(C(C(CCC=O)O)O1)O)=O,,,5,1,1,0,1
63778_0,,,,2,2,1,3
C(C1C(O)OC(CCC=O)C1O)=O,,,5,1,1,0,1
63780_0,,,,2,2,1,3
C(C1C(O)OCC1(CCC=O)O)=O,,,5,1,1,0,1
63782_0,,,,2,2,1,3
C(C1(CCC=O)C(O)OCC1O)=O,,,5,1,1,0,1
63784_0,,,,2,2,1,3
C(C1C(CCC=O)(O)OCC1O)=O,,,5,1,1,0,1
63786_0,,,,2,2,1,3
C(CCC1C(C(C(CO1)O)O)=O)=O,,,5,1,1,0,1
63788_0,,,,2,2,1,3
C(CCC1(COCC(C1O)=O)O)=O,,,5,1,1,0,1
63790_0,,,,2,2,1,3
C(CCC1(C(COCC1O)=O)O)=O,,,5,1,1,0,1
63792_0,,,,2,2,1,3
C(CCC1C(C(C(CO1)=O)O)O)=O,,,5,1,1,0,1
63794_0,,,,2,2,1,3
C(CCC1(C(CC(CO1)O)=O)O)=O,,,5,1,1,0,1
63796_0,,,,2,2,1,3
C(CCC1(COC(C(C1)=O)O)O)=O,,,5,1,1,0,1
63798_0,,,,2,2,1,3
C(CCC1C(C(O)OCC1O)=O)=O,,,5,1,1,0,1
63800_0,,,,2,2,1,3
C(CCC1C(CC(C(O)O1)=O)O)=O,,,5,1,1,0,1
63802_0,,,,2,2,1,3
C1(C(CCC=O)C(C(CO1)O)O)=O,,,5,1,1,0,1
63804_0,,,,2,2,1,3
C1(CC(C(CO1)(CCC=O)O)O)=O,,,5,1,1,0,1
63806_0,,,,2,2,1,3
C1(CC(CCC=O)(C(CO1)O)O)=O,,,5,1,1,0,1
63808_0,,,,2,2,1,3
C1(CC(C(C(CCC=O)O1)O)O)=O,,,5,1,1,0,1
63810_0,,,,2,2,1,3
C(CCC1(C(OCC(C1)=O)O)O)=O,,,5,1,1,0,1
63812_0,,,,2,2,1,3
C(CCC1(C(CC(CO1)=O)O)O)=O,,,5,1,1,0,1
63814_0,,,,2,2,1,3
C(CCC1C(COC(C1O)O)=O)=O,,,5,1,1,0,1
63816_0,,,,2,2,1,3
C(CCC1C(CC(C(O1)O)O)=O)=O,,,5,1,1,0,1
63818_0,,,,2,2,1,3
C(CCC1C(C(COC1O)O)=O)=O,,,5,1,1,0,1
63820_0,,,,2,2,1,3
C(CCC1(CC(C(CO1)O)=O)O)=O,,,5,1,1,0,1
63822_0,,,,2,2,1,3
C1(CC(O)OCC1(CCC=O)O)=O,,,5,1,1,0,1
63824_0,,,,2,2,1,3
C(CCC1C(C(CC(O)O1)=O)O)=O,,,5,1,1,0,1
63826_0,,,,2,2,1,3
C1(CCOC(C1(CCC=O)O)O)=O,,,5,1,1,0,1
63828_0,,,,2,2,1,3
C(CCC1(C(C(CCO1)=O)O)O)=O,,,5,1,1,0,1
63830_0,,,,2,2,1,3
C(CCC1C(C(C(O)OC1)O)=O)=O,,,5,1,1,0,1
63832_0,,,,2,2,1,3
C(CCC1CC(C(C(O)O1)O)=O)=O,,,5,1,1,0,1
63834_0,,,,2,2,1,3
C(C(C)C(C=O)C1CC(C(O1)=O)=O)=O,,,5,1,1,0,1
63836_0,,,,2,2,1,3
C(C(C)(C1CC(C(O1)=O)=O)CC=O)=O,,,5,1,1,0,1
63838_0,,,,2,2,1,3
C(C(CC1CC(C(O1)=O)=O)CC=O)=O,,,5,1,1,0,1
63840_0,,,,2,2,1,3
C(C(C1CC(C(O1)=O)=O)CC(C)=O)=O,,,5,1,1,0,1
63842_0,,,,2,2,1,3
C(C)(C(C1CC(C(O1)=O)=O)CC=O)=O,,,5,1,1,0,1
63844_0,,,,2,2,1,3
C(C(CC(C)C1CC(C(O1)=O)=O)=O)=O,,,5,1,1,0,1
63846_0,,,,2,2,1,3
C(CC(C1CC(C(O1)=O)=O)CC=O)=O,,,5,1,1,0,1
63848_0,,,,2,2,1,3
C(C(C=O)C(C)C1CC(C(O1)=O)=O)=O,,,5,1,1,0,1
63850_0,,,,2,2,1,3
C(C(C=O)CC1CC(C(O1)=O)=O)=O,,,5,1,1,0,1
63852_0,,,,2,2,1,3
C(CC(C)C1CC(C(O1)=O)=O)=O,,,5,1,1,0,1
63854_0,,,,2,2,1,3
C(CCC1CC(C(O1)=O)=O)=O,,,5,1,1,0,1
63856_0,,,,2,2,1,3
C(CCC1CC(C(O1)=O)=O)(O)=O,,,5,1,1,0,1
63858_0,,,,2,2,1,3
C1(CC(CO1)C2CC(C(O2)=O)=O)=O,,,5,1,1,0,1
63860_0,,,,2,2,1,3
C(C(CCC1CC(C(O1)=O)=O)=O)=O,,,5,1,1,0,1
63862_0,,,,2,2,1,3
C(C(C1CC(C(O1)=O)=O)CC=O)=O,,,5,1,1,0,1
63864_0,,,,2,2,1,3
C(C(C)C(C=O)C1C(C(OC1)=O)=O)=O,,,5,1,1,0,1
63866_0,,,,2,2,1,3
C(C(C)(CC=O)C1C(C(OC1)=O)=O)=O,,,5,1,1,0,1
63868_0,,,,2,2,1,3
C(C(CC1C(C(OC1)=O)=O)CC=O)=O,,,5,1,1,0,1
63870_0,,,,2,2,1,3
C(CC(C=O)C1C(C(OC1)=O)=O)(C)=O,,,5,1,1,0,1
63872_0,,,,2,2,1,3
C(CC(C(C)=O)C1C(C(OC1)=O)=O)=O,,,5,1,1,0,1
63874_0,,,,2,2,1,3
C1(C(OCC1C(C)CC(C=O)=O)=O)=O,,,5,1,1,0,1
63876_0,,,,2,2,1,3
C(CC(CC=O)C1C(C(OC1)=O)=O)=O,,,5,1,1,0,1
63878_0,,,,2,2,1,3
C(C(C=O)C(C)C1C(C(OC1)=O)=O)=O,,,5,1,1,0,1
63880_0,,,,2,2,1,3
C(C(C=O)CC1C(C(OC1)=O)=O)=O,,,5,1,1,0,1
63882_0,,,,2,2,1,3
C(CC(C)C1C(C(OC1)=O)=O)=O,,,5,1,1,0,1
63884_0,,,,2,2,1,3
C(CCC1C(C(OC1)=O)=O)=O,,,5,1,1,0,1
63886_0,,,,2,2,1,3
C(CCC1C(C(OC1)=O)=O)(O)=O,,,5,1,1,0,1
63888_0,,,,2,2,1,3
C1(CC(CO1)C2C(C(OC2)=O)=O)=O,,,5,1,1,0,1
63890_0,,,,2,2,1,3
C1(C(OCC1CCC(C=O)=O)=O)=O,,,5,1,1,0,1
63892_0,,,,2,2,1,3
C(CC(C=O)C1C(C(OC1)=O)=O)=O,,,5,1,1,0,1
63894_0,,,,2,2,1,3
C(C(C)C(C=O)C1C(COC1=O)=O)=O,,,5,1,1,0,1
63896_0,,,,2,2,1,3
C(C(C)(CC=O)C1C(COC1=O)=O)=O,,,5,1,1,0,1
63898_0,,,,2,2,1,3
C(C(CC1C(COC1=O)=O)CC=O)=O,,,5,1,1,0,1
63900_0,,,,2,2,1,3
C1(C(C(CO1)=O)C(C=O)CC(C)=O)=O,,,5,1,1,0,1
63902_0,,,,2,2,1,3
C1(C(C(CO1)=O)C(C(C)=O)CC=O)=O,,,5,1,1,0,1
63904_0,,,,2,2,1,3
C1(COC(C1C(C)CC(C=O)=O)=O)=O,,,5,1,1,0,1
63906_0,,,,2,2,1,3
C(CC(CC=O)C1C(COC1=O)=O)=O,,,5,1,1,0,1
63908_0,,,,2,2,1,3
C(C(C=O)C(C)C1C(COC1=O)=O)=O,,,5,1,1,0,1
63910_0,,,,2,2,1,3
C(C(C=O)CC1C(COC1=O)=O)=O,,,5,1,1,0,1
63912_0,,,,2,2,1,3
C(CC(C)C1C(COC1=O)=O)=O,,,5,1,1,0,1
63914_0,,,,2,2,1,3
C(CCC1C(COC1=O)=O)=O,,,5,1,1,0,1
63916_0,,,,2,2,1,3
C(CCC1C(COC1=O)=O)(O)=O,,,5,1,1,0,1
63918_0,,,,2,2,1,3
C1(CC(CO1)C2C(COC2=O)=O)=O,,,5,1,1,0,1
63920_0,,,,2,2,1,3
C1(COC(C1CCC(C=O)=O)=O)=O,,,5,1,1,0,1
63922_0,,,,2,2,1,3
C1(C(C(CO1)=O)C(C=O)CC=O)=O,,,5,1,1,0,1
63924_0,,,,2,2,1,3
C(C(C)C(C=O)C1C(CC(O1)=O)=O)=O,,,5,1,1,0,1
63926_0,,,,2,2,1,3
C(CC(C=O)(C)C1C(CC(O1)=O)=O)=O,,,5,1,1,0,1
63928_0,,,,2,2,1,3
C(C(CC1C(CC(O1)=O)=O)CC=O)=O,,,5,1,1,0,1
63930_0,,,,2,2,1,3
C1(CC(C(C(C=O)CC(C)=O)O1)=O)=O,,,5,1,1,0,1
63932_0,,,,2,2,1,3
C1(CC(C(C(C(C)=O)CC=O)O1)=O)=O,,,5,1,1,0,1
63934_0,,,,2,2,1,3
C1(C(C(C)CC(C=O)=O)OC(C1)=O)=O,,,5,1,1,0,1
63936_0,,,,2,2,1,3
C(CC(C1C(CC(O1)=O)=O)CC=O)=O,,,5,1,1,0,1
63938_0,,,,2,2,1,3
C(C(C=O)C(C)C1C(CC(O1)=O)=O)=O,,,5,1,1,0,1
63940_0,,,,2,2,1,3
C(C(C=O)CC1C(CC(O1)=O)=O)=O,,,5,1,1,0,1
63942_0,,,,2,2,1,3
C(CC(C)C1C(CC(O1)=O)=O)=O,,,5,1,1,0,1
63944_0,,,,2,2,1,3
C(CCC1C(CC(O1)=O)=O)=O,,,5,1,1,0,1
63946_0,,,,2,2,1,3
C(CCC1C(CC(O1)=O)=O)(O)=O,,,5,1,1,0,1
63948_0,,,,2,2,1,3
C1(CC(CO1)C2C(CC(O2)=O)=O)=O,,,5,1,1,0,1
63950_0,,,,2,2,1,3
C1(C(CCC(C=O)=O)OC(C1)=O)=O,,,5,1,1,0,1
63952_0,,,,2,2,1,3
C1(CC(C(C(C=O)CC=O)O1)=O)=O,,,5,1,1,0,1
63954_0,,,,2,2,1,3
C(CCC1(CO)CC(C(O1)=O)=O)=O,,,5,1,1,0,1
63956_0,,,,2,2,1,3
C(CCC1C(C(OC1CO)=O)=O)=O,,,5,1,1,0,1
63958_0,,,,2,2,1,3
C(CCC(C1CC(C(O1)=O)=O)O)=O,,,5,1,1,0,1
63960_0,,,,2,2,1,3
C(CCC1C(OC(C1=O)CO)=O)=O,,,5,1,1,0,1
63962_0,,,,2,2,1,3
C1(C(CCC=O)(CO)OC(C1)=O)=O,,,5,1,1,0,1
63963_0,,,,2,2,1,3
63965_0,,,,2,2,1,3
C(CCC1(COC(C(C1)=O)=O)O)=O,,,5,1,1,0,1
63967_0,,,,2,2,1,3
C(CCC1C(C(OCC1O)=O)=O)=O,,,5,1,1,0,1
63969_0,,,,2,2,1,3
C(CCC1C(CC(C(O1)=O)=O)O)=O,,,5,1,1,0,1
63971_0,,,,2,2,1,3
C1(C(CCC=O)(CC(CO1)=O)O)=O,,,5,1,1,0,1
63973_0,,,,2,2,1,3
C1(COC(C(C1CCC=O)O)=O)=O,,,5,1,1,0,1
63975_0,,,,2,2,1,3
C1(CC(C(OC1CCC=O)=O)O)=O,,,5,1,1,0,1
63977_0,,,,2,2,1,3
C(CCC1C(OCC(C1=O)O)=O)=O,,,5,1,1,0,1
63979_0,,,,2,2,1,3
C1(C(COC(C1)=O)(CCC=O)O)=O,,,5,1,1,0,1
63981_0,,,,2,2,1,3
C(CCC1C(C(CC(O1)=O)=O)O)=O,,,5,1,1,0,1
63983_0,,,,2,2,1,3
C1(C(C(CCO1)=O)(CCC=O)O)=O,,,5,1,1,0,1
63985_0,,,,2,2,1,3
C1(C(COC(C1O)=O)CCC=O)=O,,,5,1,1,0,1
63987_0,,,,2,2,1,3
C1(C(C(CC(CCC=O)O1)=O)O)=O,,,5,1,1,0,1
63989_0,,,,2,2,1,3
C(CC(C(C=O)=O)CC=CC=O)=O,,,5,1,1,0,1
63991_0,,,,2,2,1,3
C(C(C=C)C(C(C=O)=O)CC=O)=O,,,5,1,1,0,1
63992_0,,,,2,2,1,3
63994_0,,,,2,2,1,3
C(CC(C(C=O)=O)C1C=CC(O1)=O)=O,,,5,1,1,0,1
63996_0,,,,2,2,1,3
C(CC(C(C=O)=O)C1C(C=CO1)=O)=O,,,5,1,1,0,1
63997_0,,,,2,2,1,3
63998_0,,,,2,2,1,3
63999_0,,,,2,2,1,3
64001_0,,,,2,2,1,3
C(CC(C(C=O)=O)CC(C=O)=O)=O,,,5,1,1,0,1
64003_0,,,,2,2,1,3
C(C(C=O)C(C(C=O)=O)CC=O)=O,,,5,1,1,0,1
64005_0,,,,2,2,1,3
C(CC(C(C=O)=O)CC=O)=O,,,5,1,1,0,1
64006_0,,,,2,2,1,3
64008_0,,,,2,2,1,3
C(CC(C(C=O)=O)C(C=O)CO)=O,,,5,1,1,0,1
64009_0,,,,2,2,1,3
64011_0,,,,2,2,1,3
C(CC(C(C=O)=O)CC(CO)=O)=O,,,5,1,1,0,1
64012_0,,,,2,2,1,3
64013_0,,,,2,2,1,3
64015_0,,,,2,2,1,3
C(CC(C(C=O)=O)CC(O)=O)=O,,,5,1,1,0,1
64016_0,,,,2,2,1,3
64018_0,,,,2,2,1,3
C(C(CC(C=O)=O)CC=CC=O)=O,,,5,1,1,0,1
64020_0,,,,2,2,1,3
C(C(C=C)C(C=O)CC(C=O)=O)=O,,,5,1,1,0,1
64021_0,,,,2,2,1,3
64023_0,,,,2,2,1,3
C(C(C1C=CC(O1)=O)CC(C=O)=O)=O,,,5,1,1,0,1
64025_0,,,,2,2,1,3
C(C(C1C(C=CO1)=O)CC(C=O)=O)=O,,,5,1,1,0,1
64026_0,,,,2,2,1,3
64027_0,,,,2,2,1,3
64028_0,,,,2,2,1,3
64030_0,,,,2,2,1,3
C(C(CC(C=O)=O)CC(C=O)=O)=O,,,5,1,1,0,1
64032_0,,,,2,2,1,3
C(C(C=O)C(C=O)CC(C=O)=O)=O,,,5,1,2,0,2
64033_0,,,,2,2,1,3
64034_0,,,,2,2,1,3
64035_0,,,,2,2,1,3
64036_0,,,,2,2,1,3
64038_0,,,,2,2,1,3
C(C(CC(C=O)=O)CC(CO)=O)=O,,,5,1,2,0,2
64039_0,,,,2,2,1,3
64040_0,,,,2,2,1,3
64041_0,,,,2,2,1,3
64042_0,,,,2,2,1,3
64044_0,,,,2,2,1,3
C(C(C=O)(CC=O)CC=CC=O)=O,,,5,1,1,0,1
64046_0,,,,2,2,1,3
C(C(C=O)(CC=O)C(C=O)C=C)=O,,,5,1,1,0,1
64047_0,,,,2,2,1,3
64049_0,,,,2,2,1,3
C(C(C=O)(C1C=CC(O1)=O)CC=O)=O,,,5,1,1,0,1
64051_0,,,,2,2,1,3
C(C(C=O)(C1C(C=CO1)=O)CC=O)=O,,,5,1,1,0,1
64052_0,,,,2,2,1,3
64053_0,,,,2,2,1,3
64054_0,,,,2,2,1,3
64056_0,,,,2,2,1,3
C(C(C=O)(CC(C=O)=O)CC=O)=O,,,5,1,1,0,1
64058_0,,,,2,2,1,3
C(C(C=O)(CC=O)C(C=O)C=O)=O,,,5,1,1,0,1
64060_0,,,,2,2,1,3
C(C(C=O)(CC=O)CC=O)=O,,,5,1,1,0,1
64061_0,,,,2,2,1,3
64063_0,,,,2,2,1,3
C(C(CO)C(C=O)(C=O)CC=O)=O,,,5,1,1,0,1
64064_0,,,,2,2,1,3
64066_0,,,,2,2,1,3
C(C(C=O)(CC(CO)=O)CC=O)=O,,,5,1,1,0,1
64067_0,,,,2,2,1,3
64069_0,,,,2,2,1,3
C(C(C=O)(CCO)CC=O)=O,,,5,1,1,0,1
64071_0,,,,2,2,1,3
C(C(C=O)(CC(O)=O)CC=O)=O,,,5,1,1,0,1
64072_0,,,,2,2,1,3
64074_0,,,,2,2,1,3
C(C(C=O)C(C=O)CC=CC=O)=O,,,5,1,1,0,1
64076_0,,,,2,2,1,3
C(C(C=C)C(C=O)C(C=O)C=O)=O,,,5,1,1,0,1
64077_0,,,,2,2,1,3
64079_0,,,,2,2,1,3
C(C(C=O)C(C=O)C1C=CC(O1)=O)=O,,,5,1,1,0,1
64081_0,,,,2,2,1,3
C(C(C=O)C(C=O)C1C(C=CO1)=O)=O,,,5,1,1,0,1
64082_0,,,,2,2,1,3
64083_0,,,,2,2,1,3
64084_0,,,,2,2,1,3
64085_0,,,,2,2,1,3
64087_0,,,,2,2,1,3
C(C(C=O)C(C=O)C(C=O)C=O)=O,,,5,1,1,0,1
64088_0,,,,2,2,1,3
64089_0,,,,2,2,1,3
64090_0,,,,2,2,1,3
64091_0,,,,2,2,1,3
64093_0,,,,2,2,1,3
C(C(C=O)C(C=O)CC(CO)=O)=O,,,5,1,2,0,2
64094_0,,,,2,2,1,3
64095_0,,,,2,2,1,3
64096_0,,,,2,2,1,3
64097_0,,,,2,2,1,3
64099_0,,,,2,2,1,3
C(C(C(C(C=O)=O)=C)(CCC=O)O)=O,,,5,1,1,0,1
64100_0,,,,2,2,1,3
64101_0,,,,2,2,1,3
64102_0,,,,2,2,1,3
64103_0,,,,2,2,1,3
64105_0,,,,2,2,1,3
C(CCC(C(C(C=O)=O)=CC=O)O)=O,,,5,1,1,0,1
64106_0,,,,2,2,1,3
64108_0,,,,2,2,1,3
C(CC(C(C=O)=O)(CO)CC=O)=O,,,5,1,1,0,1
64109_0,,,,2,2,1,3
64111_0,,,,2,2,1,3
C(CC(C(C=O)=O)(CO)CCO)=O,,,5,1,1,0,1
64112_0,,,,2,2,1,3
64113_0,,,,2,2,1,3
64114_0,,,,2,2,1,3
64115_0,,,,2,2,1,3
64117_0,,,,2,2,1,3
C(C(C(C=O)=CC=O)(CCC=O)O)=O,,,5,1,1,0,1
64118_0,,,,2,2,1,3
64119_0,,,,2,2,1,3
64120_0,,,,2,2,1,3
64121_0,,,,2,2,1,3
64122_0,,,,2,2,1,3
64124_0,,,,2,2,1,3
C(CC(C=O)(CC=O)C(C=O)O)=O,,,5,1,1,0,1
64125_0,,,,2,2,1,3
64127_0,,,,2,2,1,3
C(CC(C=O)(CCO)C(C=O)O)=O,,,5,1,2,0,2
64129_0,,,,2,2,1,3
C(CCC(C(C(C=O)=CC=O)=O)O)=O,,,5,1,1,0,1
64130_0,,,,2,2,1,3
64132_0,,,,2,2,1,3
C(C(C(CO)=O)(CC=O)CC=O)=O,,,5,1,1,0,1
64133_0,,,,2,2,1,3
64135_0,,,,2,2,1,3
C(CO)(C(C=O)(CCO)CC=O)=O,,,5,1,1,0,1
64136_0,,,,2,2,1,3
64137_0,,,,2,2,1,3
64138_0,,,,2,2,1,3
64139_0,,,,2,2,1,3
64141_0,,,,2,2,1,3
C(C(C(C=CC=O)=O)(CCC=O)O)=O,,,5,1,1,0,1
64142_0,,,,2,2,1,3
64144_0,,,,2,2,1,3
C(C(C(C(CC=O)CC=O)=O)O)=O,,,5,1,1,0,1
64145_0,,,,2,2,1,3
64147_0,,,,2,2,1,3
C(C(CCO)CC=O)(C(C=O)O)=O,,,5,1,1,0,1
64148_0,,,,2,2,1,3
64149_0,,,,2,2,1,3
64150_0,,,,2,2,1,3
64151_0,,,,2,2,1,3
64153_0,,,,2,2,1,3
C(C(CC(CO)(CO)CO)=O)=O,,,5,1,1,0,1
64155_0,,,,2,2,1,3
C(CC(CO)(CO)CC(C=O)=O)=O,,,5,1,4,0,4
64157_0,,,,2,2,1,3
C(C(CC(CO)(CO)C(C)O)=O)=O,,,5,1,1,0,1
64159_0,,,,2,2,1,3
C(C(CC(CO)(CO)CCO)=O)=O,,,5,1,1,0,1
64161_0,,,,2,2,1,3
C(C(C=O)C(CO)(CO)CO)=O,,,5,1,1,0,1
64163_0,,,,2,2,1,3
C(C(C=O)C(CO)(CO)CC=O)=O,,,5,1,4,0,4
64165_0,,,,2,2,1,3
C(C(C=O)C(CO)(CO)C(C)O)=O,,,5,1,1,0,1
64167_0,,,,2,2,1,3
C(C(C=O)C(CO)(CO)CCO)=O,,,5,1,1,0,1
64169_0,,,,2,2,1,3
C(CC(C)C(C(CO)=CC=O)O)=O,,,5,1,1,0,1
64171_0,,,,2,2,1,3
C(CCC(C(CO)=CC=O)O)=O,,,5,1,1,0,1
64173_0,,,,2,2,1,3
C(CCC(C(CO)=CC=O)O)(O)=O,,,5,1,1,0,1
64175_0,,,,2,2,1,3
C(CC(CO)(CO)CC=CC=O)=O,,,5,1,1,0,1
64177_0,,,,2,2,1,3
C(C(C=C)C(CO)(CO)CC=O)=O,,,5,1,1,0,1
64179_0,,,,2,2,1,3
C(CC(CO)(CO)CO)=O,,,5,1,1,0,1
64181_0,,,,2,2,1,3
C(CC(CO)(CO)C(CO)O)=O,,,5,1,2,0,2
64183_0,,,,2,2,1,3
C(CC(CO)(CO)C(C(O)=O)O)=O,,,5,1,2,0,2
64184_0,,,,2,2,1,3
64185_0,,,,2,2,1,3
64187_0,,,,2,2,1,3
C(CC(CO)(CO)CC=O)=O,,,5,1,2,0,2
64189_0,,,,2,2,1,3
C(CC(C(CO)(CO)CC=O)O)=O,,,5,1,1,0,1
64191_0,,,,2,2,1,3
C(C(CO)C(CO)(CO)CC=O)=O,,,5,1,1,0,1
64193_0,,,,2,2,1,3
C(CC(CO)(CO)C(C(C)=O)O)=O,,,5,1,1,0,1
64195_0,,,,2,2,1,3
C(CC(CO)(CO)CC(CO)=O)=O,,,5,1,1,0,1
64197_0,,,,2,2,1,3
C(CC(CO)(CO)C(C)O)=O,,,5,1,1,0,1
64199_0,,,,2,2,1,3
C(CC(CO)(CO)CCO)=O,,,5,1,1,0,1
64201_0,,,,2,2,1,3
C(CC(CO)(CO)CC=O)(O)=O,,,5,1,1,0,1
64203_0,,,,2,2,1,3
C(CC(CO)(CO)C(C=O)O)=O,,,5,1,2,0,2
64204_0,,,,2,2,1,3
64205_0,,,,2,2,1,3
64207_0,,,,2,2,1,3
C(C(CC(C)O)C(C(CO)=O)O)=O,,,5,1,1,0,1
64209_0,,,,2,2,1,3
C(C(CCCO)C(C(CO)=O)O)=O,,,5,1,1,0,1
64210_0,,,,2,2,1,3
64212_0,,,,2,2,1,3
C(CC(C(C(CO)=O)O)CC=O)=O,,,5,1,2,0,2
64214_0,,,,2,2,1,3
C(CC(C(C)O)C(C(CO)=O)O)=O,,,5,1,1,0,1
64216_0,,,,2,2,1,3
C(CC(CCO)C(C(CO)=O)O)=O,,,5,1,1,0,1
64218_0,,,,2,2,1,3
C(CC(C)C(C(CO)=O)(C=C)O)=O,,,5,1,1,0,1
64220_0,,,,2,2,1,3
C(CCC(C(CO)=O)(C=C)O)=O,,,5,1,1,0,1
64222_0,,,,2,2,1,3
C(CCC(C(CO)=O)(C=C)O)(O)=O,,,5,1,1,0,1
64224_0,,,,2,2,1,3
C(CC(C)C(C(C(C=C)O)=O)O)=O,,,5,1,1,0,1
64226_0,,,,2,2,1,3
C(CCC(C(C(C=C)O)=O)O)=O,,,5,1,1,0,1
64228_0,,,,2,2,1,3
C(CCC(C(C(C=C)O)=O)O)(O)=O,,,5,1,1,0,1
64229_0,,,,2,2,1,3
64231_0,,,,2,2,1,3
C(CC(CO)(C(CO)O)CC=O)=O,,,5,1,2,0,2
64233_0,,,,2,2,1,3
C(CC(CO)(C(CO)O)C(C)O)=O,,,5,1,1,0,1
64235_0,,,,2,2,1,3
C(CC(CO)(CCO)C(CO)O)=O,,,5,1,1,0,1
64236_0,,,,2,2,1,3
64238_0,,,,2,2,1,3
C(CC(C(CO)(CO)O)CC=O)=O,,,5,1,2,0,2
64240_0,,,,2,2,1,3
C(CC(C(C)O)C(CO)(CO)O)=O,,,5,1,1,0,1
64242_0,,,,2,2,1,3
C(CC(CCO)C(CO)(CO)O)=O,,,5,1,1,0,1
64244_0,,,,2,2,1,3
C(CC(C)CC(C=O)=CC(C=O)=O)=O,,,5,1,1,0,1
64246_0,,,,2,2,1,3
C(CCCC(C=O)=CC(C=O)=O)=O,,,5,1,1,0,1
64248_0,,,,2,2,1,3
C(CCCC(C=O)=CC(C=O)=O)(O)=O,,,5,1,1,0,1
64250_0,,,,2,2,1,3
C(C(C)C(C(C=O)=O)CC=CC=O)=O,,,5,1,1,0,1
64252_0,,,,2,2,1,3
C(C(C)C(C(C=O)=O)C(C=O)C=C)=O,,,5,1,1,0,1
64253_0,,,,2,2,1,3
64255_0,,,,2,2,1,3
C(C(C)C(C(C=O)=O)C(CO)O)=O,,,5,1,1,0,1
64257_0,,,,2,2,1,3
C(C(C)C(C(C=O)=O)CC(C=O)=O)=O,,,5,1,1,0,1
64259_0,,,,2,2,1,3
C(C(C)C(C(C=O)=O)C(C=O)C=O)=O,,,5,1,1,0,1
64261_0,,,,2,2,1,3
C(CC(C(C=O)=O)C(C=O)C)=O,,,5,1,1,0,1
64262_0,,,,2,2,1,3
64264_0,,,,2,2,1,3
C(C(C)C(C(C=O)=O)CCO)=O,,,5,1,1,0,1
64266_0,,,,2,2,1,3
C(C(C)C(C(C=O)=O)CC(O)=O)=O,,,5,1,1,0,1
64268_0,,,,2,2,1,3
C(C(C(C(C=O)=O)C(C=O)C)O)=O,,,5,1,1,0,1
64270_0,,,,2,2,1,3
C(C(C)(CC(C=O)=O)CC=CC=O)=O,,,5,1,1,0,1
64272_0,,,,2,2,1,3
C(C(C)(CC(C=O)=O)C(C=O)C=C)=O,,,5,1,1,0,1
64274_0,,,,2,2,1,3
C(C(C)(CO)CC(C=O)=O)=O,,,5,1,1,0,1
64276_0,,,,2,2,1,3
C(C(C)(C(CO)O)CC(C=O)=O)=O,,,5,1,1,0,1
64278_0,,,,2,2,1,3
C(C(C)(CC(C=O)=O)CC(C=O)=O)=O,,,5,1,1,0,1
64280_0,,,,2,2,1,3
C(C(C)(CC(C=O)=O)C(C=O)C=O)=O,,,5,1,2,0,2
64282_0,,,,2,2,1,3
C(C(C)(CC=O)CC(C=O)=O)=O,,,5,1,2,0,2
64284_0,,,,2,2,1,3
C(C(C)(C(C)O)CC(C=O)=O)=O,,,5,1,1,0,1
64286_0,,,,2,2,1,3
C(C(C)(CCO)CC(C=O)=O)=O,,,5,1,1,0,1
64288_0,,,,2,2,1,3
C(C(C)(CC(O)=O)CC(C=O)=O)=O,,,5,1,1,0,1
64290_0,,,,2,2,1,3
C(C(C)(C(C=O)O)CC(C=O)=O)=O,,,5,1,1,0,1
64292_0,,,,2,2,1,3
C(CC(C)C(C(C=O)=O)C(C=O)=C)=O,,,5,1,1,0,1
64294_0,,,,2,2,1,3
C(CCC(C(C=O)=O)C(C=O)=C)=O,,,5,1,1,0,1
64296_0,,,,2,2,1,3
C(CCC(C(C=O)=O)C(C=O)=C)(O)=O,,,5,1,1,0,1
64298_0,,,,2,2,1,3
C(C(CCC=CC=O)CC(C=O)=O)=O,,,5,1,1,0,1
64300_0,,,,2,2,1,3
C(C(CC(C=O)C=C)CC(C=O)=O)=O,,,5,1,1,0,1
64301_0,,,,2,2,1,3
64303_0,,,,2,2,1,3
C(C(CC(CO)O)CC(C=O)=O)=O,,,5,1,1,0,1
64304_0,,,,2,2,1,3
64305_0,,,,2,2,1,3
64306_0,,,,2,2,1,3
64308_0,,,,2,2,1,3
C(C(CC(C)O)CC(C=O)=O)=O,,,5,1,1,0,1
64310_0,,,,2,2,1,3
C(C(CCCO)CC(C=O)=O)=O,,,5,1,1,0,1
64311_0,,,,2,2,1,3
64312_0,,,,2,2,1,3
64314_0,,,,2,2,1,3
C(CC(C)CC(C=O)=C(C=O)C=O)=O,,,5,1,1,0,1
64316_0,,,,2,2,1,3
C(CCCC(C=O)=C(C=O)C=O)=O,,,5,1,1,0,1
64318_0,,,,2,2,1,3
C(CCCC(C=O)=C(C=O)C=O)(O)=O,,,5,1,1,0,1
64320_0,,,,2,2,1,3
C(C(C)C(C=O)(C=O)CC=CC=O)=O,,,5,1,1,0,1
64322_0,,,,2,2,1,3
C(C(C=C)C(C=O)(C=O)C(C=O)C)=O,,,5,1,1,0,1
64323_0,,,,2,2,1,3
64325_0,,,,2,2,1,3
C(C(C=O)(C(CO)O)C(C=O)C)=O,,,5,1,1,0,1
64327_0,,,,2,2,1,3
C(C(C)C(C=O)(C=O)CC(C=O)=O)=O,,,5,1,1,0,1
64329_0,,,,2,2,1,3
C(C(C=O)C(C=O)(C=O)C(C=O)C)=O,,,5,1,1,0,1
64331_0,,,,2,2,1,3
C(C(C)C(C=O)(C=O)CC=O)=O,,,5,1,1,0,1
64332_0,,,,2,2,1,3
64334_0,,,,2,2,1,3
C(C(C=O)(CCO)C(C=O)C)=O,,,5,1,1,0,1
64336_0,,,,2,2,1,3
C(C(C)C(C=O)(C=O)CC(O)=O)=O,,,5,1,1,0,1
64338_0,,,,2,2,1,3
C(C(C)C(C=O)(C=O)C(C=O)O)=O,,,5,1,1,0,1
64340_0,,,,2,2,1,3
C(C(C)(CC=CC=O)C(C=O)C=O)=O,,,5,1,1,0,1
64342_0,,,,2,2,1,3
C(C(C=C)C(C=O)(C)C(C=O)C=O)=O,,,5,1,1,0,1
64344_0,,,,2,2,1,3
C(C(C=O)C(C=O)(C)CO)=O,,,5,1,1,0,1
64346_0,,,,2,2,1,3
C(C(C=O)C(C=O)(C)C(CO)O)=O,,,5,1,1,0,1
64347_0,,,,2,2,1,3
64349_0,,,,2,2,1,3
C(C(C=O)C(C=O)(C)C(C=O)C=O)=O,,,5,1,1,0,1
64351_0,,,,2,2,1,3
C(C(C)(CC=O)C(C=O)C=O)=O,,,5,1,2,0,2
64353_0,,,,2,2,1,3
C(C(C=O)C(C=O)(C)C(C)O)=O,,,5,1,1,0,1
64355_0,,,,2,2,1,3
C(C(C=O)C(C=O)(C)CCO)=O,,,5,1,1,0,1
64357_0,,,,2,2,1,3
C(C(C)(CC(O)=O)C(C=O)C=O)=O,,,5,1,1,0,1
64359_0,,,,2,2,1,3
C(C(C)(C(C=O)O)C(C=O)C=O)=O,,,5,1,1,0,1
64361_0,,,,2,2,1,3
C(C(C=O)(C(C=O)=C)C(C)CC=O)=O,,,5,1,1,0,1
64363_0,,,,2,2,1,3
C(C(C=O)(C(C=O)=C)CCC=O)=O,,,5,1,1,0,1
64365_0,,,,2,2,1,3
C(C(C=O)(C(C=O)=C)CCC(O)=O)=O,,,5,1,1,0,1
64367_0,,,,2,2,1,3
C(C(C=O)C(C=O)CCC=CC=O)=O,,,5,1,1,0,1
64369_0,,,,2,2,1,3
C(C(C=C)CC(C=O)C(C=O)C=O)=O,,,5,1,1,0,1
64370_0,,,,2,2,1,3
64372_0,,,,2,2,1,3
C(C(C=O)C(C=O)CC(CO)O)=O,,,5,1,1,0,1
64373_0,,,,2,2,1,3
64374_0,,,,2,2,1,3
64375_0,,,,2,2,1,3
64377_0,,,,2,2,1,3
C(C(C=O)C(C=O)CC(C)O)=O,,,5,1,1,0,1
64379_0,,,,2,2,1,3
C(C(C=O)C(C=O)CCCO)=O,,,5,1,1,0,1
64380_0,,,,2,2,1,3
64381_0,,,,2,2,1,3
64382_0,,,,2,2,1,3
64384_0,,,,2,2,1,3
C(C(C)C(C(C=O)=O)(CO)CO)=O,,,5,1,1,0,1
64386_0,,,,2,2,1,3
C(C(C)(CO)C(C(C=O)=O)CO)=O,,,5,1,1,0,1
64387_0,,,,2,2,1,3
64388_0,,,,2,2,1,3
64389_0,,,,2,2,1,3
64391_0,,,,2,2,1,3
C(C(C)C(C=O)(CO)C(C=O)O)=O,,,5,1,1,0,1
64393_0,,,,2,2,1,3
C(C(C(C=O)C(C=O)(CO)C)O)=O,,,5,1,1,0,1
64394_0,,,,2,2,1,3
64396_0,,,,2,2,1,3
C(C(C)C(C=O)(C(CO)=O)CO)=O,,,5,1,1,0,1
64398_0,,,,2,2,1,3
C(C(CO)(C)C(C=O)C(CO)=O)=O,,,5,1,1,0,1
64399_0,,,,2,2,1,3
64400_0,,,,2,2,1,3
64402_0,,,,2,2,1,3
C(C(C(C(CO)C(C=O)C)=O)O)=O,,,5,1,1,0,1
64404_0,,,,2,2,1,3
C(C(CO)(C)CC(C(C=O)O)=O)=O,,,5,1,1,0,1
64405_0,,,,2,2,1,3
64407_0,,,,2,2,1,3
C(C(C)C(C=O)CC(C=O)=CC=O)=O,,,5,1,1,0,1
64409_0,,,,2,2,1,3
C(C(C)(CC=O)CC(C=O)=CC=O)=O,,,5,1,1,0,1
64411_0,,,,2,2,1,3
C(C(CCC(C=O)=CC=O)CC=O)=O,,,5,1,1,0,1
64413_0,,,,2,2,1,3
C(C(CC(C=O)=CC=O)CC(C)=O)=O,,,5,1,1,0,1
64415_0,,,,2,2,1,3
C(CC(C(C)=O)CC(C=O)=CC=O)=O,,,5,1,1,0,1
64417_0,,,,2,2,1,3
C(C(CC(C)CC(C=O)=CC=O)=O)=O,,,5,1,1,0,1
64419_0,,,,2,2,1,3
C(CC(CC=O)CC(C=O)=CC=O)=O,,,5,1,1,0,1
64421_0,,,,2,2,1,3
C(C(C=O)C(C)CC(C=O)=CC=O)=O,,,5,1,1,0,1
64423_0,,,,2,2,1,3
C(C(C=O)CCC(C=O)=CC=O)=O,,,5,1,1,0,1
64425_0,,,,2,2,1,3
C(CC(C)CC(C=O)=CC=O)=O,,,5,1,1,0,1
64427_0,,,,2,2,1,3
C(CCCC(C=O)=CC=O)=O,,,5,1,1,0,1
64429_0,,,,2,2,1,3
C(CCCC(C=O)=CC=O)(O)=O,,,5,1,1,0,1
64431_0,,,,2,2,1,3
C1(CC(CO1)CC(C=O)=CC=O)=O,,,5,1,1,0,1
64433_0,,,,2,2,1,3
C(C(CCCC(C=O)=CC=O)=O)=O,,,5,1,1,0,1
64435_0,,,,2,2,1,3
C(CC(C=O)CC(C=O)=CC=O)=O,,,5,1,1,0,1
64437_0,,,,2,2,1,3
C(C(C)C(C=O)C(C=O)C(C=O)=C)=O,,,5,1,1,0,1
64439_0,,,,2,2,1,3
C(C(C)C(C=O)CC(C=CC=O)=O)=O,,,5,1,1,0,1
64441_0,,,,2,2,1,3
C(C(C)C(C=O)C(C=C)C(C=O)=O)=O,,,5,1,1,0,1
64443_0,,,,2,2,1,3
C(C(C)C(C=O)CC=CC(C=O)=O)=O,,,5,1,1,0,1
64445_0,,,,2,2,1,3
C(C(C)C(C=O)C(C=O)C=CC=O)=O,,,5,1,1,0,1
64447_0,,,,2,2,1,3
C(C(C)C(C=O)C(C=O)(C=O)C=C)=O,,,5,1,1,0,1
64449_0,,,,2,2,1,3
C(C(C)C(C=O)CC=C(C=O)C=O)=O,,,5,1,1,0,1
64451_0,,,,2,2,1,3
C(C(C)C(C=O)CC=CC=O)=O,,,5,1,1,0,1
64453_0,,,,2,2,1,3
C(C(C)C(C=O)C(C=O)C=C)=O,,,5,1,1,0,1
64455_0,,,,2,2,1,3
C(C(C)C(C=O)C(C=O)(C=C)O)=O,,,5,1,1,0,1
64457_0,,,,2,2,1,3
C(C(C)C(C=O)C1C=CC(O1)=O)=O,,,5,1,1,0,1
64459_0,,,,2,2,1,3
C(C(C)C(C=O)C1C(C=CO1)=O)=O,,,5,1,1,0,1
64461_0,,,,2,2,1,3
C(C(C)C(C=O)C(C=O)(CO)O)=O,,,5,1,1,0,1
64463_0,,,,2,2,1,3
C(C(C(C(C=O)C(C=O)C)O)O)=O,,,5,1,1,0,1
64464_0,,,,2,2,1,3
64465_0,,,,2,2,1,3
64466_0,,,,2,2,1,3
64468_0,,,,2,2,1,3
C(C(C(C=O)C(C=O)C)O)(CO)=O,,,5,1,1,0,1
64470_0,,,,2,2,1,3
C(C(C(CO)(CO)O)C(C=O)C)=O,,,5,1,1,0,1
64472_0,,,,2,2,1,3
C(C(C(C(CO)O)O)C(C=O)C)=O,,,5,1,1,0,1
64474_0,,,,2,2,1,3
C(C(C)C(C=O)CC(C=O)=O)=O,,,5,1,1,0,1
64476_0,,,,2,2,1,3
C(C(C)C(C=O)C(C=O)C=O)=O,,,5,1,1,0,1
64478_0,,,,2,2,1,3
C(CC(C=O)C(C=O)C)=O,,,5,1,1,0,1
64480_0,,,,2,2,1,3
C(C(C)C(C=O)C(C=O)C(C)O)=O,,,5,1,1,0,1
64482_0,,,,2,2,1,3
C(CC(C)(C(C=O)C(C=O)C)O)=O,,,5,1,1,0,1
64484_0,,,,2,2,1,3
C(CC(CC(C=O)C(C=O)C)O)=O,,,5,1,1,0,1
64485_0,,,,2,2,1,3
64487_0,,,,2,2,1,3
C(C(C)C(C=O)C(C=O)CO)=O,,,5,1,1,0,1
64489_0,,,,2,2,1,3
C(C(C)(C(C=O)C(C=O)C)O)(O)=O,,,5,1,1,0,1
64491_0,,,,2,2,1,3
C(C(CC(C=O)C(C=O)C)O)(O)=O,,,5,1,1,0,1
64493_0,,,,2,2,1,3
C(C(C)C(C=O)C(C(C=O)=O)O)=O,,,5,1,1,0,1
64494_0,,,,2,2,1,3
64496_0,,,,2,2,1,3
C(CC(C=O)C(C=O)C)(CO)=O,,,5,1,1,0,1
64497_0,,,,2,2,1,3
64499_0,,,,2,2,1,3
C(C(CCO)C(C=O)C)=O,,,5,1,1,0,1
64501_0,,,,2,2,1,3
C(C(C)C(C=O)CC(C(O)=O)=O)=O,,,5,1,1,0,1
64503_0,,,,2,2,1,3
C(C(C)C(C=O)C(C=O)C(O)=O)=O,,,5,1,1,0,1
64505_0,,,,2,2,1,3
C(C(C)C(C=O)CC(O)=O)=O,,,5,1,1,0,1
64506_0,,,,2,2,1,3
64508_0,,,,2,2,1,3
C(C(C)(CC=O)C(C=O)C(C=O)=C)=O,,,5,1,1,0,1
64510_0,,,,2,2,1,3
C(C(C)(CC=O)CC(C=CC=O)=O)=O,,,5,1,1,0,1
64512_0,,,,2,2,1,3
C(C(C)(CC=O)C(C=C)C(C=O)=O)=O,,,5,1,1,0,1
64514_0,,,,2,2,1,3
C(C(C)(CC=O)CC=CC(C=O)=O)=O,,,5,1,1,0,1
64516_0,,,,2,2,1,3
C(C(C)(CC=O)C(C=O)C=CC=O)=O,,,5,1,1,0,1
64518_0,,,,2,2,1,3
C(C(C)(CC=O)C(C=O)(C=O)C=C)=O,,,5,1,1,0,1
64520_0,,,,2,2,1,3
C(C(C)(CC=O)CC=C(C=O)C=O)=O,,,5,1,1,0,1
64522_0,,,,2,2,1,3
C(C(C)(CC=O)CC=CC=O)=O,,,5,1,1,0,1
64524_0,,,,2,2,1,3
C(C(C)(CC=O)C(C=O)C=C)=O,,,5,1,1,0,1
64526_0,,,,2,2,1,3
C(C(C)(CC=O)C(C=O)(C=C)O)=O,,,5,1,1,0,1
64528_0,,,,2,2,1,3
C(CC(C=O)(C)C1C=CC(O1)=O)=O,,,5,1,1,0,1
64530_0,,,,2,2,1,3
C(CC(C=O)(C)C1C(C=CO1)=O)=O,,,5,1,1,0,1
64532_0,,,,2,2,1,3
C(C(CO)(C(C=O)(C)CC=O)O)=O,,,5,1,1,0,1
64534_0,,,,2,2,1,3
C(C(C)(C(C(C=O)O)O)CC=O)=O,,,5,1,1,0,1
64536_0,,,,2,2,1,3
C(C(C)(CO)CC=O)=O,,,5,1,1,0,1
64538_0,,,,2,2,1,3
C(C(C)(C(CO)O)CC=O)=O,,,5,1,1,0,1
64540_0,,,,2,2,1,3
C(CC(C=O)(C)C(C(O)=O)O)=O,,,5,1,1,0,1
64542_0,,,,2,2,1,3
C(CC(C=O)(C)C(C(CO)=O)O)=O,,,5,1,1,0,1
64544_0,,,,2,2,1,3
C(C(C)(C(CO)(CO)O)CC=O)=O,,,5,1,1,0,1
64546_0,,,,2,2,1,3
C(C(C)(C(C(CO)O)O)CC=O)=O,,,5,1,1,0,1
64547_0,,,,2,2,1,3
64548_0,,,,2,2,1,3
64550_0,,,,2,2,1,3
C(C(C)(CC=O)CC=O)=O,,,5,1,1,0,1
64552_0,,,,2,2,1,3
C(C(C(C)O)C(C=O)(C)CC=O)=O,,,5,1,1,0,1
64554_0,,,,2,2,1,3
C(C(C)(C(C)(CC=O)O)CC=O)=O,,,5,1,1,0,1
64556_0,,,,2,2,1,3
C(C(C)(CC(CC=O)O)CC=O)=O,,,5,1,1,0,1
64558_0,,,,2,2,1,3
C(C(C)(C(CC=O)O)CC=O)=O,,,5,1,1,0,1
64560_0,,,,2,2,1,3
C(C(CO)C(C=O)(C)CC=O)=O,,,5,1,1,0,1
64562_0,,,,2,2,1,3
C(C(C)(C(C=O)(C)CC=O)O)(O)=O,,,5,1,1,0,1
64564_0,,,,2,2,1,3
C(C(CC(C=O)(C)CC=O)O)(O)=O,,,5,1,1,0,1
64566_0,,,,2,2,1,3
C(CC(C=O)(C)C(C(C=O)=O)O)=O,,,5,1,1,0,1
64568_0,,,,2,2,1,3
C(CC(C=O)(C)C(C(C)=O)O)=O,,,5,1,1,0,1
64570_0,,,,2,2,1,3
C(C(C)(CC(CO)=O)CC=O)=O,,,5,1,1,0,1
64572_0,,,,2,2,1,3
C(C(C)(C(C)O)CC=O)=O,,,5,1,1,0,1
64574_0,,,,2,2,1,3
C(C(C)(CCO)CC=O)=O,,,5,1,1,0,1
64576_0,,,,2,2,1,3
C(C(C)(CC=O)CC(C(O)=O)=O)=O,,,5,1,1,0,1
64578_0,,,,2,2,1,3
C(C(C)(CC=O)C(C=O)C(O)=O)=O,,,5,1,1,0,1
64580_0,,,,2,2,1,3
C(C(C)(CC=O)CC(O)=O)=O,,,5,1,1,0,1
64582_0,,,,2,2,1,3
C(CC(C=O)(C)C(C=O)O)=O,,,5,1,1,0,1
64584_0,,,,2,2,1,3
C(C(CC(C=O)C(C=O)=C)CC=O)=O,,,5,1,1,0,1
64586_0,,,,2,2,1,3
C(C(C(C=O)=C)C(C=O)CC(C)=O)=O,,,5,1,1,0,1
64588_0,,,,2,2,1,3
C(C(C(C=O)=C)C(C(C)=O)CC=O)=O,,,5,1,1,0,1
64590_0,,,,2,2,1,3
C(C(C(C=O)=C)C(C)CC(C=O)=O)=O,,,5,1,1,0,1
64592_0,,,,2,2,1,3
C(C(C(C=O)=C)C(CC=O)CC=O)=O,,,5,1,1,0,1
64594_0,,,,2,2,1,3
C(C(C(C=O)=C)C(C)C(C=O)C=O)=O,,,5,1,1,0,1
64596_0,,,,2,2,1,3
C(C(C(C=O)=C)CC(C=O)C=O)=O,,,5,1,1,0,1
64598_0,,,,2,2,1,3
C(C(C(C=O)=C)C(C)CC=O)=O,,,5,1,1,0,1
64600_0,,,,2,2,1,3
C(C(C(C=O)=C)CCC=O)=O,,,5,1,1,0,1
64602_0,,,,2,2,1,3
C(C(C(C=O)=C)CCC(O)=O)=O,,,5,1,1,0,1
64604_0,,,,2,2,1,3
C(C(C(C=O)=C)C1COC(C1)=O)=O,,,5,1,1,0,1
64606_0,,,,2,2,1,3
C(C(C(C=O)=C)CCC(C=O)=O)=O,,,5,1,1,0,1
64608_0,,,,2,2,1,3
C(C(C(C=O)=C)C(C=O)CC=O)=O,,,5,1,1,0,1
64610_0,,,,2,2,1,3
C(C(CCC(C=CC=O)=O)CC=O)=O,,,5,1,1,0,1
64612_0,,,,2,2,1,3
C(C(CC(C=C)C(C=O)=O)CC=O)=O,,,5,1,1,0,1
64614_0,,,,2,2,1,3
C(C(CCC=CC(C=O)=O)CC=O)=O,,,5,1,1,0,1
64616_0,,,,2,2,1,3
C(C(CC(C=O)C=CC=O)CC=O)=O,,,5,1,1,0,1
64618_0,,,,2,2,1,3
C(C(CC(C=O)(C=O)C=C)CC=O)=O,,,5,1,1,0,1
64620_0,,,,2,2,1,3
C(C(CCC=C(C=O)C=O)CC=O)=O,,,5,1,1,0,1
64622_0,,,,2,2,1,3
C(C(CCC=CC=O)CC=O)=O,,,5,1,1,0,1
64624_0,,,,2,2,1,3
C(C(CC(C=O)C=C)CC=O)=O,,,5,1,1,0,1
64626_0,,,,2,2,1,3
C(C(CC(C=O)(C=C)O)CC=O)=O,,,5,1,1,0,1
64628_0,,,,2,2,1,3
C(C(CC1C=CC(O1)=O)CC=O)=O,,,5,1,1,0,1
64630_0,,,,2,2,1,3
C(C(CC1C(C=CO1)=O)CC=O)=O,,,5,1,1,0,1
64632_0,,,,2,2,1,3
C(C(CO)(CC(C=O)CC=O)O)=O,,,5,1,1,0,1
64633_0,,,,2,2,1,3
64634_0,,,,2,2,1,3
64636_0,,,,2,2,1,3
C(C(CC(CO)O)CC=O)=O,,,5,1,1,0,1
64637_0,,,,2,2,1,3
64638_0,,,,2,2,1,3
64640_0,,,,2,2,1,3
C(C(CC(CO)(CO)O)CC=O)=O,,,5,1,1,0,1
64641_0,,,,2,2,1,3
64642_0,,,,2,2,1,3
64643_0,,,,2,2,1,3
64644_0,,,,2,2,1,3
64646_0,,,,2,2,1,3
C(C(CC(C=O)CC=O)C(C)O)=O,,,5,1,1,0,1
64648_0,,,,2,2,1,3
C(CC(C)(CC(C=O)CC=O)O)=O,,,5,1,1,0,1
64650_0,,,,2,2,1,3
C(CC(CCC(C=O)CC=O)O)=O,,,5,1,1,0,1
64651_0,,,,2,2,1,3
64653_0,,,,2,2,1,3
C(C(CC(C=O)CC=O)CO)=O,,,5,1,1,0,1
64655_0,,,,2,2,1,3
C(C(C)(CC(C=O)CC=O)O)(O)=O,,,5,1,1,0,1
64657_0,,,,2,2,1,3
C(C(CCC(C=O)CC=O)O)(O)=O,,,5,1,1,0,1
64658_0,,,,2,2,1,3
64660_0,,,,2,2,1,3
C(C)(C(CC(C=O)CC=O)O)=O,,,5,1,1,0,1
64661_0,,,,2,2,1,3
64663_0,,,,2,2,1,3
C(C(CC(C)O)CC=O)=O,,,5,1,1,0,1
64665_0,,,,2,2,1,3
C(C(CCCO)CC=O)=O,,,5,1,1,0,1
64666_0,,,,2,2,1,3
64668_0,,,,2,2,1,3
C(C(CC(C=O)C(O)=O)CC=O)=O,,,5,1,1,0,1
64669_0,,,,2,2,1,3
64670_0,,,,2,2,1,3
64672_0,,,,2,2,1,3
C(C(C=O)CC(C=O)(C(C=O)=C)O)=O,,,5,1,1,0,1
64674_0,,,,2,2,1,3
C(C(C(C=O)=C)(C(C)CC=O)O)=O,,,5,1,1,0,1
64676_0,,,,2,2,1,3
C(C(C(C=O)=C)(CCC=O)O)=O,,,5,1,1,0,1
64678_0,,,,2,2,1,3
C(C(C(C=O)=C)(CCC(O)=O)O)=O,,,5,1,1,0,1
64680_0,,,,2,2,1,3
C(C(C(C=O)=C)(C1COC(C1)=O)O)=O,,,5,1,1,0,1
64682_0,,,,2,2,1,3
C(C(C(C=O)=C)(CCC(C=O)=O)O)=O,,,5,1,1,0,1
64684_0,,,,2,2,1,3
C(C(C(C=O)=C)(C(C=O)CC=O)O)=O,,,5,1,1,0,1
64686_0,,,,2,2,1,3
C(C(CCC=CC=O)C(C=O)O)=O,,,5,1,1,0,1
64688_0,,,,2,2,1,3
C(C(CC(C=O)C=C)C(C=O)O)=O,,,5,1,1,0,1
64690_0,,,,2,2,1,3
C(C(CC1C=CC(O1)=O)C(C=O)O)=O,,,5,1,1,0,1
64692_0,,,,2,2,1,3
C(C(CC1C(C=CO1)=O)C(C=O)O)=O,,,5,1,1,0,1
64693_0,,,,2,2,1,3
64695_0,,,,2,2,1,3
C(C(CC(CO)O)C(C=O)O)=O,,,5,1,1,0,1
64697_0,,,,2,2,1,3
C(C(CC(C=O)C(C=O)O)O)(O)=O,,,5,1,1,0,1
64698_0,,,,2,2,1,3
64700_0,,,,2,2,1,3
C(C(CC(C=O)C=O)C(C=O)O)=O,,,5,1,2,0,2
64702_0,,,,2,2,1,3
C(CCC(C=O)C(C=O)O)=O,,,5,1,2,0,2
64703_0,,,,2,2,1,3
64705_0,,,,2,2,1,3
C(C(CO)CC(C=O)C(C=O)O)=O,,,5,1,1,0,1
64707_0,,,,2,2,1,3
C(C)(C(CC(C=O)C(C=O)O)O)=O,,,5,1,1,0,1
64708_0,,,,2,2,1,3
64710_0,,,,2,2,1,3
C(C(CC(C)O)C(C=O)O)=O,,,5,1,1,0,1
64712_0,,,,2,2,1,3
C(C(CCCO)C(C=O)O)=O,,,5,1,1,0,1
64714_0,,,,2,2,1,3
C(CCC(C=O)C(C=O)O)(O)=O,,,5,1,2,0,2
64715_0,,,,2,2,1,3
64717_0,,,,2,2,1,3
C(CC(C)CC(C=CC(C=O)=O)=O)=O,,,5,1,1,0,1
64719_0,,,,2,2,1,3
C(CCCC(C=CC(C=O)=O)=O)=O,,,5,1,1,0,1
64721_0,,,,2,2,1,3
C(CCCC(C=CC(C=O)=O)=O)(O)=O,,,5,1,1,0,1
64723_0,,,,2,2,1,3
C(C)(CC(C(C=O)=O)CC=CC=O)=O,,,5,1,1,0,1
64725_0,,,,2,2,1,3
C(C(C=C)C(C(C=O)=O)CC(C)=O)=O,,,5,1,1,0,1
64727_0,,,,2,2,1,3
C(CC(C(C=O)=O)CO)(C)=O,,,5,1,1,0,1
64729_0,,,,2,2,1,3
C(CC(C(C=O)=O)C(CO)O)(C)=O,,,5,1,1,0,1
64731_0,,,,2,2,1,3
C(C)(CC(C(C=O)=O)CC(C=O)=O)=O,,,5,1,1,0,1
64733_0,,,,2,2,1,3
C(C(C=O)C(C(C=O)=O)CC(C)=O)=O,,,5,1,1,0,1
64735_0,,,,2,2,1,3
C(CC(C(C=O)=O)CC(C)=O)=O,,,5,1,1,0,1
64737_0,,,,2,2,1,3
C(CC(C(C=O)=O)C(C)O)(C)=O,,,5,1,1,0,1
64739_0,,,,2,2,1,3
C(CC(C(C=O)=O)CCO)(C)=O,,,5,1,1,0,1
64741_0,,,,2,2,1,3
C(CC(C(C=O)=O)CC(C)=O)(O)=O,,,5,1,1,0,1
64743_0,,,,2,2,1,3
C(C(C(C(C=O)=O)CC(C)=O)O)=O,,,5,1,1,0,1
64745_0,,,,2,2,1,3
C(C)(C(CC(C=O)=O)CC=CC=O)=O,,,5,1,1,0,1
64747_0,,,,2,2,1,3
C(C(C=C)C(C(C)=O)CC(C=O)=O)=O,,,5,1,1,0,1
64749_0,,,,2,2,1,3
C(C)(C(CO)CC(C=O)=O)=O,,,5,1,1,0,1
64751_0,,,,2,2,1,3
C(C)(C(C(CO)O)CC(C=O)=O)=O,,,5,1,1,0,1
64753_0,,,,2,2,1,3
C(C)(C(CC(C=O)=O)CC(C=O)=O)=O,,,5,1,1,0,1
64755_0,,,,2,2,1,3
C(C(C=O)C(C(C)=O)CC(C=O)=O)=O,,,5,1,2,0,2
64757_0,,,,2,2,1,3
C(CC(C(C)=O)CC(C=O)=O)=O,,,5,1,2,0,2
64759_0,,,,2,2,1,3
C(C)(C(C(C)O)CC(C=O)=O)=O,,,5,1,1,0,1
64761_0,,,,2,2,1,3
C(C)(C(CCO)CC(C=O)=O)=O,,,5,1,1,0,1
64763_0,,,,2,2,1,3
C(CC(C(C)=O)CC(C=O)=O)(O)=O,,,5,1,1,0,1
64765_0,,,,2,2,1,3
C(C(C(C(C)=O)CC(C=O)=O)O)=O,,,5,1,1,0,1
64767_0,,,,2,2,1,3
C(CC(C)CC(C=C(C=O)C=O)=O)=O,,,5,1,1,0,1
64769_0,,,,2,2,1,3
C(CCCC(C=C(C=O)C=O)=O)=O,,,5,1,1,0,1
64771_0,,,,2,2,1,3
C(CCCC(C=C(C=O)C=O)=O)(O)=O,,,5,1,1,0,1
64773_0,,,,2,2,1,3
C(C(C=O)(CC(C)=O)CC=CC=O)=O,,,5,1,1,0,1
64775_0,,,,2,2,1,3
C(C(C=O)(CC(C)=O)C(C=O)C=C)=O,,,5,1,1,0,1
64777_0,,,,2,2,1,3
C(C(C=O)(CO)CC(C)=O)=O,,,5,1,1,0,1
64779_0,,,,2,2,1,3
C(C(C=O)(C(CO)O)CC(C)=O)=O,,,5,1,1,0,1
64781_0,,,,2,2,1,3
C(C(C=O)(CC(C=O)=O)CC(C)=O)=O,,,5,1,1,0,1
64783_0,,,,2,2,1,3
C(C(C=O)(CC(C)=O)C(C=O)C=O)=O,,,5,1,1,0,1
64785_0,,,,2,2,1,3
C(C(C=O)(CC(C)=O)CC=O)=O,,,5,1,1,0,1
64787_0,,,,2,2,1,3
C(C(C=O)(C(C)O)CC(C)=O)=O,,,5,1,1,0,1
64789_0,,,,2,2,1,3
C(C(C=O)(CCO)CC(C)=O)=O,,,5,1,1,0,1
64791_0,,,,2,2,1,3
C(C(C=O)(CC(C)=O)CC(O)=O)=O,,,5,1,1,0,1
64793_0,,,,2,2,1,3
C(C(C=O)(CC(C)=O)C(C=O)O)=O,,,5,1,1,0,1
64795_0,,,,2,2,1,3
C(C(C=O)C(C(C)=O)CC=CC=O)=O,,,5,1,1,0,1
64797_0,,,,2,2,1,3
C(C(C=C)C(C(C)=O)C(C=O)C=O)=O,,,5,1,1,0,1
64799_0,,,,2,2,1,3
C(C(C=O)C(C(C)=O)CO)=O,,,5,1,1,0,1
64801_0,,,,2,2,1,3
C(C(C=O)C(C(C)=O)C(CO)O)=O,,,5,1,1,0,1
64802_0,,,,2,2,1,3
64804_0,,,,2,2,1,3
C(C(C=O)C(C(C)=O)C(C=O)C=O)=O,,,5,1,1,0,1
64806_0,,,,2,2,1,3
C(C(C=O)C(C(C)=O)CC=O)=O,,,5,1,2,0,2
64808_0,,,,2,2,1,3
C(C(C=O)C(C(C)=O)C(C)O)=O,,,5,1,1,0,1
64810_0,,,,2,2,1,3
C(C(C=O)C(C(C)=O)CCO)=O,,,5,1,1,0,1
64812_0,,,,2,2,1,3
C(C(C=O)C(C(C)=O)CC(O)=O)=O,,,5,1,1,0,1
64814_0,,,,2,2,1,3
C(C(C=O)C(C(C)=O)C(C=O)O)=O,,,5,1,1,0,1
64815_0,,,,2,2,1,3
64817_0,,,,2,2,1,3
C(CC(C(C=O)=O)(CO)CO)(C)=O,,,5,1,1,0,1
64819_0,,,,2,2,1,3
C(C)(C(CO)C(C(C=O)=O)CO)=O,,,5,1,1,0,1
64820_0,,,,2,2,1,3
64821_0,,,,2,2,1,3
64823_0,,,,2,2,1,3
C(CC(C=O)(CO)C(C=O)O)(C)=O,,,5,1,1,0,1
64825_0,,,,2,2,1,3
C(C)(C(CO)C(C=O)C(C=O)O)=O,,,5,1,1,0,1
64827_0,,,,2,2,1,3
C(CO)(C(C=O)(CO)CC(C)=O)=O,,,5,1,1,0,1
64829_0,,,,2,2,1,3
C(C)(C(CO)C(C=O)C(CO)=O)=O,,,5,1,1,0,1
64831_0,,,,2,2,1,3
C(C(CO)CC(C)=O)(C(C=O)O)=O,,,5,1,1,0,1
64833_0,,,,2,2,1,3
C(C)(C(CO)CC(C(C=O)O)=O)=O,,,5,1,1,0,1
64835_0,,,,2,2,1,3
C(C(CC(C=CC=O)=O)CC(C)=O)=O,,,5,1,1,0,1
64837_0,,,,2,2,1,3
C(CC(C(C)=O)CC(C=CC=O)=O)=O,,,5,1,1,0,1
64839_0,,,,2,2,1,3
C(C(CC(C)CC(C=CC=O)=O)=O)=O,,,5,1,1,0,1
64841_0,,,,2,2,1,3
C(CC(CC=O)CC(C=CC=O)=O)=O,,,5,1,1,0,1
64843_0,,,,2,2,1,3
C(C(C=O)C(C)CC(C=CC=O)=O)=O,,,5,1,1,0,1
64845_0,,,,2,2,1,3
C(C(C=O)CCC(C=CC=O)=O)=O,,,5,1,1,0,1
64847_0,,,,2,2,1,3
C(CC(C)CC(C=CC=O)=O)=O,,,5,1,1,0,1
64849_0,,,,2,2,1,3
C(CCCC(C=CC=O)=O)=O,,,5,1,1,0,1
64851_0,,,,2,2,1,3
C(CCCC(C=CC=O)=O)(O)=O,,,5,1,1,0,1
64853_0,,,,2,2,1,3
C1(CC(CO1)CC(C=CC=O)=O)=O,,,5,1,1,0,1
64855_0,,,,2,2,1,3
C(C(CCCC(C=CC=O)=O)=O)=O,,,5,1,1,0,1
64857_0,,,,2,2,1,3
C(CC(C=O)CC(C=CC=O)=O)=O,,,5,1,1,0,1
64859_0,,,,2,2,1,3
C(C(CC(C)=O)C(C=C)C(C=O)=O)=O,,,5,1,1,0,1
64861_0,,,,2,2,1,3
C(C(CC(C)=O)CC=CC(C=O)=O)=O,,,5,1,1,0,1
64863_0,,,,2,2,1,3
C(C(C=CC=O)C(C=O)CC(C)=O)=O,,,5,1,1,0,1
64865_0,,,,2,2,1,3
C(C(C=O)(C=C)C(C=O)CC(C)=O)=O,,,5,1,1,0,1
64867_0,,,,2,2,1,3
C(C(CC(C)=O)CC=C(C=O)C=O)=O,,,5,1,1,0,1
64869_0,,,,2,2,1,3
C(C(CC(C)=O)CC=CC=O)=O,,,5,1,1,0,1
64871_0,,,,2,2,1,3
C(C(C=C)C(C=O)CC(C)=O)=O,,,5,1,1,0,1
64873_0,,,,2,2,1,3
C(C(C=C)(C(C=O)CC(C)=O)O)=O,,,5,1,1,0,1
64875_0,,,,2,2,1,3
C(C(C1C=CC(O1)=O)CC(C)=O)=O,,,5,1,1,0,1
64877_0,,,,2,2,1,3
C(C(C1C(C=CO1)=O)CC(C)=O)=O,,,5,1,1,0,1
64879_0,,,,2,2,1,3
C(CC(C=O)C(C=O)(CO)O)(C)=O,,,5,1,1,0,1
64881_0,,,,2,2,1,3
C(C(C(C(C=O)CC(C)=O)O)O)=O,,,5,1,1,0,1
64883_0,,,,2,2,1,3
C(C(CO)CC(C)=O)=O,,,5,1,1,0,1
64885_0,,,,2,2,1,3
C(C(C(CO)O)CC(C)=O)=O,,,5,1,1,0,1
64887_0,,,,2,2,1,3
C(C(C(C=O)CC(C)=O)O)(O)=O,,,5,1,1,0,1
64889_0,,,,2,2,1,3
C(C(CC(C)=O)C(C(CO)=O)O)=O,,,5,1,1,0,1
64891_0,,,,2,2,1,3
C(C(C(CO)(CO)O)CC(C)=O)=O,,,5,1,1,0,1
64893_0,,,,2,2,1,3
C(C(C(C(CO)O)O)CC(C)=O)=O,,,5,1,1,0,1
64895_0,,,,2,2,1,3
C(C(CC(C=O)=O)CC(C)=O)=O,,,5,1,1,0,1
64897_0,,,,2,2,1,3
C(C(C=O)C(C=O)CC(C)=O)=O,,,5,1,1,0,1
64899_0,,,,2,2,1,3
C(CC(C=O)CC(C)=O)=O,,,5,1,1,0,1
64901_0,,,,2,2,1,3
C(CC(C=O)C(C=O)C(C)O)(C)=O,,,5,1,1,0,1
64903_0,,,,2,2,1,3
C(CC(C)(C(C=O)CC(C)=O)O)=O,,,5,1,1,0,1
64905_0,,,,2,2,1,3
C(CC(CC(C=O)CC(C)=O)O)=O,,,5,1,1,0,1
64907_0,,,,2,2,1,3
C(CC(C(C=O)CC(C)=O)O)=O,,,5,1,1,0,1
64909_0,,,,2,2,1,3
C(CC(C=O)C(C=O)CO)(C)=O,,,5,1,1,0,1
64911_0,,,,2,2,1,3
C(CC(C=O)C(C(O)=O)(C)O)(C)=O,,,5,1,1,0,1
64913_0,,,,2,2,1,3
C(C(CC(C=O)CC(C)=O)O)(O)=O,,,5,1,1,0,1
64915_0,,,,2,2,1,3
C(C(CC(C)=O)C(C(C=O)=O)O)=O,,,5,1,1,0,1
64917_0,,,,2,2,1,3
C(C(CC(C)=O)C(C(C)=O)O)=O,,,5,1,1,0,1
64919_0,,,,2,2,1,3
C(C(CC(C)=O)CC(CO)=O)=O,,,5,1,1,0,1
64921_0,,,,2,2,1,3
C(C(C(C)O)CC(C)=O)=O,,,5,1,1,0,1
64923_0,,,,2,2,1,3
C(C(CCO)CC(C)=O)=O,,,5,1,1,0,1
64925_0,,,,2,2,1,3
C(C(CC(C(O)=O)=O)CC(C)=O)=O,,,5,1,1,0,1
64927_0,,,,2,2,1,3
C(C(C(O)=O)C(C=O)CC(C)=O)=O,,,5,1,1,0,1
64929_0,,,,2,2,1,3
C(C(CC(O)=O)CC(C)=O)=O,,,5,1,1,0,1
64931_0,,,,2,2,1,3
C(C(C(C=O)CC(C)=O)O)=O,,,5,1,1,0,1
64933_0,,,,2,2,1,3
C(CC(C(C)=O)C(C=C)C(C=O)=O)=O,,,5,1,1,0,1
64935_0,,,,2,2,1,3
C(CC(C(C)=O)CC=CC(C=O)=O)=O,,,5,1,1,0,1
64937_0,,,,2,2,1,3
C(C(C=CC=O)C(C(C)=O)CC=O)=O,,,5,1,1,0,1
64939_0,,,,2,2,1,3
C(C(C=O)(C=C)C(C(C)=O)CC=O)=O,,,5,1,1,0,1
64941_0,,,,2,2,1,3
C(CC(C(C)=O)CC=C(C=O)C=O)=O,,,5,1,1,0,1
64943_0,,,,2,2,1,3
C(CC(C(C)=O)CC=CC=O)=O,,,5,1,1,0,1
64945_0,,,,2,2,1,3
C(C(C=C)C(C(C)=O)CC=O)=O,,,5,1,1,0,1
64947_0,,,,2,2,1,3
C(C(C=C)(C(C(C)=O)CC=O)O)=O,,,5,1,1,0,1
64949_0,,,,2,2,1,3
C(CC(C(C)=O)C1C=CC(O1)=O)=O,,,5,1,1,0,1
64951_0,,,,2,2,1,3
C(CC(C(C)=O)C1C(C=CO1)=O)=O,,,5,1,1,0,1
64953_0,,,,2,2,1,3
C(CC(C(C)=O)C(C=O)(CO)O)=O,,,5,1,1,0,1
64954_0,,,,2,2,1,3
64955_0,,,,2,2,1,3
64957_0,,,,2,2,1,3
C(C)(C(C(CO)O)CC=O)=O,,,5,1,1,0,1
64959_0,,,,2,2,1,3
C(C(C(C(C)=O)CC=O)O)(O)=O,,,5,1,1,0,1
64961_0,,,,2,2,1,3
C(CC(C(C)=O)C(C(CO)=O)O)=O,,,5,1,1,0,1
64963_0,,,,2,2,1,3
C(C)(C(C(CO)(CO)O)CC=O)=O,,,5,1,1,0,1
64965_0,,,,2,2,1,3
C(C)(C(C(C(CO)O)O)CC=O)=O,,,5,1,1,0,1
64966_0,,,,2,2,1,3
64967_0,,,,2,2,1,3
64969_0,,,,2,2,1,3
C(CC(C(C)=O)CC=O)=O,,,5,1,1,0,1
64971_0,,,,2,2,1,3
C(CC(C(C)=O)C(C=O)C(C)O)=O,,,5,1,1,0,1
64973_0,,,,2,2,1,3
C(C)(C(C(C)(CC=O)O)CC=O)=O,,,5,1,1,0,1
64975_0,,,,2,2,1,3
C(C)(C(CC(CC=O)O)CC=O)=O,,,5,1,1,0,1
64976_0,,,,2,2,1,3
64978_0,,,,2,2,1,3
C(CC(C(C)=O)C(C=O)CO)=O,,,5,1,1,0,1
64980_0,,,,2,2,1,3
C(C(C)(C(C(C)=O)CC=O)O)(O)=O,,,5,1,1,0,1
64982_0,,,,2,2,1,3
C(C)(C(CC(C(O)=O)O)CC=O)=O,,,5,1,1,0,1
64984_0,,,,2,2,1,3
C(CC(C(C)=O)C(C(C=O)=O)O)=O,,,5,1,1,0,1
64986_0,,,,2,2,1,3
C(CC(C(C)=O)C(C(C)=O)O)=O,,,5,1,1,0,1
64988_0,,,,2,2,1,3
C(CC(C(C)=O)CC(CO)=O)=O,,,5,1,1,0,1
64990_0,,,,2,2,1,3
C(C)(C(C(C)O)CC=O)=O,,,5,1,1,0,1
64992_0,,,,2,2,1,3
C(C)(C(CCO)CC=O)=O,,,5,1,1,0,1
64994_0,,,,2,2,1,3
C(CC(C(C)=O)CC(C(O)=O)=O)=O,,,5,1,1,0,1
64996_0,,,,2,2,1,3
C(C(C(O)=O)C(C(C)=O)CC=O)=O,,,5,1,1,0,1
64998_0,,,,2,2,1,3
C(CC(C(C)=O)CC(O)=O)=O,,,5,1,1,0,1
65000_0,,,,2,2,1,3
C(CC(C(C)=O)C(C=O)O)=O,,,5,1,1,0,1
65002_0,,,,2,2,1,3
C(CC(C)C(C=CC=O)C(C=O)=O)=O,,,5,1,1,0,1
65004_0,,,,2,2,1,3
C(CCC(C=CC=O)C(C=O)=O)=O,,,5,1,1,0,1
65006_0,,,,2,2,1,3
C(CCC(C=CC=O)C(C=O)=O)(O)=O,,,5,1,1,0,1
65008_0,,,,2,2,1,3
C(CC(CC(C=O)=O)CC=CC=O)=O,,,5,1,2,0,2
65010_0,,,,2,2,1,3
C(C(C=C)C(CC=O)CC(C=O)=O)=O,,,5,1,2,0,2
65011_0,,,,2,2,1,3
65013_0,,,,2,2,1,3
C(CC(C(CO)O)CC(C=O)=O)=O,,,5,1,4,0,4
65015_0,,,,2,2,1,3
C(CC(CC(C=O)=O)CC(C=O)=O)=O,,,5,1,2,0,2
65017_0,,,,2,2,1,3
C(C(C=O)C(CC=O)CC(C=O)=O)=O,,,5,1,4,0,4
65019_0,,,,2,2,1,3
C(CC(CC=O)CC(C=O)=O)=O,,,5,1,3,0,3
65021_0,,,,2,2,1,3
C(CC(C(C)O)CC(C=O)=O)=O,,,5,1,2,0,2
65023_0,,,,2,2,1,3
C(CC(CCO)CC(C=O)=O)=O,,,5,1,2,0,2
65025_0,,,,2,2,1,3
C(CC(CC(O)=O)CC(C=O)=O)=O,,,5,1,2,0,2
65027_0,,,,2,2,1,3
C(CC(C(C=O)O)CC(C=O)=O)=O,,,5,1,3,0,3
65029_0,,,,2,2,1,3
C(C(C=CC(C=O)=O)C(C)CC=O)=O,,,5,1,1,0,1
65031_0,,,,2,2,1,3
C(C(C=CC(C=O)=O)CCC=O)=O,,,5,1,1,0,1
65033_0,,,,2,2,1,3
C(C(C=CC(C=O)=O)CCC(O)=O)=O,,,5,1,1,0,1
65034_0,,,,2,2,1,3
65035_0,,,,2,2,1,3
65036_0,,,,2,2,1,3
65037_0,,,,2,2,1,3
65038_0,,,,2,2,1,3
65039_0,,,,2,2,1,3
65040_0,,,,2,2,1,3
65041_0,,,,2,2,1,3
65042_0,,,,2,2,1,3
65043_0,,,,2,2,1,3
65044_0,,,,2,2,1,3
65045_0,,,,2,2,1,3
65047_0,,,,2,2,1,3
C(C(CO)(CCO)CC(C=O)=O)=O,,,5,1,1,0,1
65048_0,,,,2,2,1,3
65050_0,,,,2,2,1,3
C(C(CO)CC(C=O)=O)(CCO)=O,,,5,1,1,0,1
65052_0,,,,2,2,1,3
C(CC(C(C=O)=O)CO)(CCO)=O,,,5,1,1,0,1
65053_0,,,,2,2,1,3
65054_0,,,,2,2,1,3
65056_0,,,,2,2,1,3
C(CO)(CC(CO)CC(C=O)=O)=O,,,5,1,3,0,3
65057_0,,,,2,2,1,3
65058_0,,,,2,2,1,3
65059_0,,,,2,2,1,3
65061_0,,,,2,2,1,3
C(C)(C(C(CO)CC(C=O)=O)O)=O,,,5,1,2,0,2
65063_0,,,,2,2,1,3
C(C(C(CO)(C)CC(C=O)=O)O)=O,,,5,1,1,0,1
65065_0,,,,2,2,1,3
C=CC(C(C=O)=O)C(C)CC(C=O)=O,,,5,1,1,0,1
65067_0,,,,2,2,1,3
C(CC(CC=O)C(C=C)C(C=O)=O)=O,,,5,1,1,0,1
65069_0,,,,2,2,1,3
C(C(C=O)C(C)C(C=C)C(C=O)=O)=O,,,5,1,1,0,1
65071_0,,,,2,2,1,3
C(C(C=O)CC(C=C)C(C=O)=O)=O,,,5,1,1,0,1
65073_0,,,,2,2,1,3
C(CC(C)C(C=C)C(C=O)=O)=O,,,5,1,1,0,1
65075_0,,,,2,2,1,3
C(CCC(C=C)C(C=O)=O)=O,,,5,1,1,0,1
65077_0,,,,2,2,1,3
C(CCC(C=C)C(C=O)=O)(O)=O,,,5,1,1,0,1
65079_0,,,,2,2,1,3
C1(CC(CO1)C(C=C)C(C=O)=O)=O,,,5,1,1,0,1
65081_0,,,,2,2,1,3
C=CC(C(C=O)=O)CCC(C=O)=O,,,5,1,1,0,1
65083_0,,,,2,2,1,3
C(CC(C=O)C(C=C)C(C=O)=O)=O,,,5,1,1,0,1
65085_0,,,,2,2,1,3
C(CC(C)CC(C=O)=O)=CC(C=O)=O,,,5,1,1,0,1
65087_0,,,,2,2,1,3
C(CC(CC=O)CC=CC(C=O)=O)=O,,,5,1,1,0,1
65089_0,,,,2,2,1,3
C(C(C=O)C(C)CC=CC(C=O)=O)=O,,,5,1,1,0,1
65091_0,,,,2,2,1,3
C(C(C=O)CCC=CC(C=O)=O)=O,,,5,1,1,0,1
65093_0,,,,2,2,1,3
C(CC(C)CC=CC(C=O)=O)=O,,,5,1,1,0,1
65095_0,,,,2,2,1,3
C(CCCC=CC(C=O)=O)=O,,,5,1,1,0,1
65097_0,,,,2,2,1,3
C(CCCC=CC(C=O)=O)(O)=O,,,5,1,1,0,1
65099_0,,,,2,2,1,3
C1(CC(CO1)CC=CC(C=O)=O)=O,,,5,1,1,0,1
65101_0,,,,2,2,1,3
C(CCCC(C=O)=O)=CC(C=O)=O,,,5,1,1,0,1
65103_0,,,,2,2,1,3
C(CC(C=O)CC=CC(C=O)=O)=O,,,5,1,1,0,1
65105_0,,,,2,2,1,3
C(C(C=CC=O)C(C)CC(C=O)=O)=O,,,5,1,1,0,1
65107_0,,,,2,2,1,3
C(C(C=O)(C=C)C(C)CC(C=O)=O)=O,,,5,1,1,0,1
65109_0,,,,2,2,1,3
C(CC(C)CC(C=O)=O)=C(C=O)C=O,,,5,1,1,0,1
65111_0,,,,2,2,1,3
C(CC(C)CC(C=O)=O)=CC=O,,,5,1,1,0,1
65113_0,,,,2,2,1,3
C(C(C=C)C(C)CC(C=O)=O)=O,,,5,1,1,0,1
65115_0,,,,2,2,1,3
C(C(C=C)(C(C)CC(C=O)=O)O)=O,,,5,1,1,0,1
65117_0,,,,2,2,1,3
C1C(C(C)CC(C=O)=O)OC(C=1)=O,,,5,1,1,0,1
65119_0,,,,2,2,1,3
C1OC(C(C=1)=O)C(C)CC(C=O)=O,,,5,1,1,0,1
65121_0,,,,2,2,1,3
C(C(CO)(C(C)CC(C=O)=O)O)=O,,,5,1,1,0,1
65123_0,,,,2,2,1,3
C(C(C(C(C)CC(C=O)=O)O)O)=O,,,5,1,1,0,1
65125_0,,,,2,2,1,3
C(C(CC(C)CO)=O)=O,,,5,1,1,0,1
65127_0,,,,2,2,1,3
C(C(CC(C)C(CO)O)=O)=O,,,5,1,1,0,1
65128_0,,,,2,2,1,3
65130_0,,,,2,2,1,3
C(CO)(C(C(C)CC(C=O)=O)O)=O,,,5,1,1,0,1
65132_0,,,,2,2,1,3
C(C(CC(C)C(CO)(CO)O)=O)=O,,,5,1,1,0,1
65134_0,,,,2,2,1,3
C(C(CC(C)C(C(CO)O)O)=O)=O,,,5,1,1,0,1
65136_0,,,,2,2,1,3
C(C(CC(C)CC(C=O)=O)=O)=O,,,5,1,1,0,1
65138_0,,,,2,2,1,3
C(C(C=O)C(C)CC(C=O)=O)=O,,,5,1,2,0,2
65140_0,,,,2,2,1,3
C(CC(C)CC(C=O)=O)=O,,,5,1,2,0,2
65142_0,,,,2,2,1,3
C(C(C(C)CC(C=O)=O)C(C)O)=O,,,5,1,1,0,1
65144_0,,,,2,2,1,3
C(CC(C)(C(C)CC(C=O)=O)O)=O,,,5,1,1,0,1
65146_0,,,,2,2,1,3
C(CC(CC(C)CC(C=O)=O)O)=O,,,5,1,1,0,1
65148_0,,,,2,2,1,3
C(CC(C(C)CC(C=O)=O)O)=O,,,5,1,1,0,1
65150_0,,,,2,2,1,3
C(C(CO)C(C)CC(C=O)=O)=O,,,5,1,1,0,1
65152_0,,,,2,2,1,3
C(C(C)(C(C)CC(C=O)=O)O)(O)=O,,,5,1,1,0,1
65154_0,,,,2,2,1,3
C(C(CC(C)CC(C=O)=O)O)(O)=O,,,5,1,1,0,1
65156_0,,,,2,2,1,3
C(C=O)(CC(C)C(C(C=O)=O)O)=O,,,5,1,1,0,1
65158_0,,,,2,2,1,3
C(C)(C(C(C)CC(C=O)=O)O)=O,,,5,1,1,0,1
65160_0,,,,2,2,1,3
C(CO)(CC(C)CC(C=O)=O)=O,,,5,1,1,0,1
65162_0,,,,2,2,1,3
C(C(CC(C)C(C)O)=O)=O,,,5,1,1,0,1
65164_0,,,,2,2,1,3
C(C(CC(C)CCO)=O)=O,,,5,1,1,0,1
65166_0,,,,2,2,1,3
C(C(CC(C)CC(C(O)=O)=O)=O)=O,,,5,1,1,0,1
65168_0,,,,2,2,1,3
C(C(C(O)=O)C(C)CC(C=O)=O)=O,,,5,1,1,0,1
65170_0,,,,2,2,1,3
C(CC(C)CC(C=O)=O)(O)=O,,,5,1,1,0,1
65172_0,,,,2,2,1,3
C(C(C(C)CC(C=O)=O)O)=O,,,5,1,1,0,1
65173_0,,,,2,2,1,3
65174_0,,,,2,2,1,3
65176_0,,,,2,2,1,3
C(C(CC(C(CO)O)C(C)O)=O)=O,,,5,1,1,0,1
65178_0,,,,2,2,1,3
C(C(CC(CCO)C(CO)O)=O)=O,,,5,1,1,0,1
65180_0,,,,2,2,1,3
C(C(C=O)CC(C=CC(C=O)=O)O)=O,,,5,1,1,0,1
65182_0,,,,2,2,1,3
C(CC(C)C(C=CC(C=O)=O)O)=O,,,5,1,1,0,1
65184_0,,,,2,2,1,3
C(CCC(C=CC(C=O)=O)O)=O,,,5,1,1,0,1
65186_0,,,,2,2,1,3
C(CCC(C=CC(C=O)=O)O)(O)=O,,,5,1,1,0,1
65188_0,,,,2,2,1,3
C1(CC(CO1)C(C=CC(C=O)=O)O)=O,,,5,1,1,0,1
65190_0,,,,2,2,1,3
C(C(CCC(C=O)=O)O)=CC(C=O)=O,,,5,1,1,0,1
65191_0,,,,2,2,1,3
65193_0,,,,2,2,1,3
C(CC(CO)CC(C=O)=O)=CC=O,,,5,1,1,0,1
65195_0,,,,2,2,1,3
C(C(C=C)C(CO)CC(C=O)=O)=O,,,5,1,1,0,1
65197_0,,,,2,2,1,3
C1C(C(CO)CC(C=O)=O)OC(C=1)=O,,,5,1,1,0,1
65199_0,,,,2,2,1,3
C1OC(C(C=1)=O)C(CO)CC(C=O)=O,,,5,1,1,0,1
65200_0,,,,2,2,1,3
65201_0,,,,2,2,1,3
65203_0,,,,2,2,1,3
C(C(C(CO)CC(C=O)=O)O)(O)=O,,,5,1,1,0,1
65205_0,,,,2,2,1,3
C(C(CC(CO)CC(C=O)=O)=O)=O,,,5,1,1,0,1
65207_0,,,,2,2,1,3
C(C(C=O)C(CO)CC(C=O)=O)=O,,,5,1,2,0,2
65208_0,,,,2,2,1,3
65209_0,,,,2,2,1,3
65211_0,,,,2,2,1,3
C(C(CO)C(CO)CC(C=O)=O)=O,,,5,1,1,0,1
65212_0,,,,2,2,1,3
65213_0,,,,2,2,1,3
65215_0,,,,2,2,1,3
C(C(CC(CO)C(C)O)=O)=O,,,5,1,1,0,1
65217_0,,,,2,2,1,3
C(C(CC(CO)CCO)=O)=O,,,5,1,1,0,1
65219_0,,,,2,2,1,3
C(CC(CO)CC(C=O)=O)(O)=O,,,5,1,2,0,2
65220_0,,,,2,2,1,3
65222_0,,,,2,2,1,3
C(C(C=C(C=O)C=O)C(C)CC=O)=O,,,5,1,1,0,1
65224_0,,,,2,2,1,3
C(C(C=C(C=O)C=O)CCC=O)=O,,,5,1,1,0,1
65226_0,,,,2,2,1,3
C(C(C=C(C=O)C=O)CCC(O)=O)=O,,,5,1,1,0,1
65228_0,,,,2,2,1,3
C(C(C=O)C(CC=O)CC=CC=O)=O,,,5,1,2,0,2
65230_0,,,,2,2,1,3
C(C(C=C)C(CC=O)C(C=O)C=O)=O,,,5,1,2,0,2
65231_0,,,,2,2,1,3
65233_0,,,,2,2,1,3
C(C(C=O)C(C(CO)O)CC=O)=O,,,5,1,4,0,4
65234_0,,,,2,2,1,3
65236_0,,,,2,2,1,3
C(C(C=O)C(CC=O)C(C=O)C=O)=O,,,5,1,2,0,2
65238_0,,,,2,2,1,3
C(C(C=O)C(CC=O)CC=O)=O,,,5,1,3,0,3
65240_0,,,,2,2,1,3
C(C(C=O)C(C(C)O)CC=O)=O,,,5,1,2,0,2
65242_0,,,,2,2,1,3
C(C(C=O)C(CCO)CC=O)=O,,,5,1,2,0,2
65244_0,,,,2,2,1,3
C(C(C=O)C(CC=O)CC(O)=O)=O,,,5,1,2,0,2
65246_0,,,,2,2,1,3
C(CC(C(C=O)O)C(C=O)C=O)=O,,,5,1,3,0,3
65248_0,,,,2,2,1,3
C(C(C=O)(C=CC=O)C(C)CC=O)=O,,,5,1,1,0,1
65250_0,,,,2,2,1,3
C(C(C=O)(C=CC=O)CCC=O)=O,,,5,1,1,0,1
65252_0,,,,2,2,1,3
C(C(C=O)(C=CC=O)CCC(O)=O)=O,,,5,1,1,0,1
65253_0,,,,2,2,1,3
65254_0,,,,2,2,1,3
65255_0,,,,2,2,1,3
65256_0,,,,2,2,1,3
65257_0,,,,2,2,1,3
65258_0,,,,2,2,1,3
65259_0,,,,2,2,1,3
65260_0,,,,2,2,1,3
65261_0,,,,2,2,1,3
65262_0,,,,2,2,1,3
65263_0,,,,2,2,1,3
65264_0,,,,2,2,1,3
65265_0,,,,2,2,1,3
65266_0,,,,2,2,1,3
65267_0,,,,2,2,1,3
65268_0,,,,2,2,1,3
65269_0,,,,2,2,1,3
65270_0,,,,2,2,1,3
65271_0,,,,2,2,1,3
65272_0,,,,2,2,1,3
65273_0,,,,2,2,1,3
65274_0,,,,2,2,1,3
65275_0,,,,2,2,1,3
65277_0,,,,2,2,1,3
C(C(C=CC=O)C(CC=O)CC=O)=O,,,5,1,1,0,1
65279_0,,,,2,2,1,3
C(C(C=CC=O)C(C)C(C=O)C=O)=O,,,5,1,1,0,1
65281_0,,,,2,2,1,3
C(C(C=CC=O)CC(C=O)C=O)=O,,,5,1,1,0,1
65283_0,,,,2,2,1,3
C(C(C=CC=O)C(C)CC=O)=O,,,5,1,1,0,1
65285_0,,,,2,2,1,3
C(C(C=CC=O)CCC=O)=O,,,5,1,1,0,1
65287_0,,,,2,2,1,3
C(C(C=CC=O)CCC(O)=O)=O,,,5,1,1,0,1
65289_0,,,,2,2,1,3
C(C(C=CC=O)C1COC(C1)=O)=O,,,5,1,1,0,1
65291_0,,,,2,2,1,3
C(C(C=CC=O)CCC(C=O)=O)=O,,,5,1,1,0,1
65293_0,,,,2,2,1,3
C(C(C=CC=O)C(C=O)CC=O)=O,,,5,1,1,0,1
65295_0,,,,2,2,1,3
C(C(C=O)(C=C)C(CC=O)CC=O)=O,,,5,1,1,0,1
65297_0,,,,2,2,1,3
C(CC(CC=O)CC=C(C=O)C=O)=O,,,5,1,1,0,1
65299_0,,,,2,2,1,3
C(CC(CC=O)CC=CC=O)=O,,,5,1,1,0,1
65301_0,,,,2,2,1,3
C(C(C=C)C(CC=O)CC=O)=O,,,5,1,1,0,1
65303_0,,,,2,2,1,3
C(C(C=C)(C(CC=O)CC=O)O)=O,,,5,1,1,0,1
65305_0,,,,2,2,1,3
C(CC(C1C=CC(O1)=O)CC=O)=O,,,5,1,1,0,1
65307_0,,,,2,2,1,3
C(CC(C1C(C=CO1)=O)CC=O)=O,,,5,1,1,0,1
65309_0,,,,2,2,1,3
C(C(CO)(C(CC=O)CC=O)O)=O,,,5,1,2,0,2
65310_0,,,,2,2,1,3
65311_0,,,,2,2,1,3
65313_0,,,,2,2,1,3
C(CC(C(CO)O)CC=O)=O,,,5,1,2,0,2
65315_0,,,,2,2,1,3
C(CC(C(C(O)=O)O)CC=O)=O,,,5,1,2,0,2
65316_0,,,,2,2,1,3
65317_0,,,,2,2,1,3
65319_0,,,,2,2,1,3
C(CC(C(C(CO)O)O)CC=O)=O,,,5,1,2,0,2
65320_0,,,,2,2,1,3
65321_0,,,,2,2,1,3
65323_0,,,,2,2,1,3
C(CC(CC=O)CC=O)=O,,,5,1,1,0,1
65325_0,,,,2,2,1,3
C(C(C(CC=O)CC=O)C(C)O)=O,,,5,1,1,0,1
65327_0,,,,2,2,1,3
C(CC(C(C)(CC=O)O)CC=O)=O,,,5,1,1,0,1
65329_0,,,,2,2,1,3
C(CC(CC(CC=O)O)CC=O)=O,,,5,1,1,0,1
65330_0,,,,2,2,1,3
65332_0,,,,2,2,1,3
C(C(C(CC=O)CC=O)CO)=O,,,5,1,1,0,1
65334_0,,,,2,2,1,3
C(C(C)(C(CC=O)CC=O)O)(O)=O,,,5,1,1,0,1
65336_0,,,,2,2,1,3
C(CC(CC(C(O)=O)O)CC=O)=O,,,5,1,1,0,1
65338_0,,,,2,2,1,3
C(CC(C(C(C=O)=O)O)CC=O)=O,,,5,1,1,0,1
65340_0,,,,2,2,1,3
C(CC(C(C(C)=O)O)CC=O)=O,,,5,1,2,0,2
65342_0,,,,2,2,1,3
C(CC(CC=O)CC(CO)=O)=O,,,5,1,3,0,3
65344_0,,,,2,2,1,3
C(CC(C(C)O)CC=O)=O,,,5,1,1,0,1
65346_0,,,,2,2,1,3
C(CC(CCO)CC=O)=O,,,5,1,1,0,1
65348_0,,,,2,2,1,3
C(CC(CC=O)CC(C(O)=O)=O)=O,,,5,1,1,0,1
65350_0,,,,2,2,1,3
C(C(C(O)=O)C(CC=O)CC=O)=O,,,5,1,1,0,1
65352_0,,,,2,2,1,3
C(CC(CC=O)CC(O)=O)=O,,,5,1,1,0,1
65354_0,,,,2,2,1,3
C(CC(C(C=O)O)CC=O)=O,,,5,1,2,0,2
65356_0,,,,2,2,1,3
C(C(C=O)CC(C=O)(C=CC=O)O)=O,,,5,1,1,0,1
65358_0,,,,2,2,1,3
C(C(C=CC=O)(C(C)CC=O)O)=O,,,5,1,1,0,1
65360_0,,,,2,2,1,3
C(C(C=CC=O)(CCC=O)O)=O,,,5,1,1,0,1
65362_0,,,,2,2,1,3
C(C(C=CC=O)(CCC(O)=O)O)=O,,,5,1,1,0,1
65364_0,,,,2,2,1,3
C(C(C=CC=O)(C1COC(C1)=O)O)=O,,,5,1,1,0,1
65366_0,,,,2,2,1,3
C(C(C=CC=O)(CCC(C=O)=O)O)=O,,,5,1,1,0,1
65367_0,,,,2,2,1,3
65369_0,,,,2,2,1,3
C(CC(C(C=O)O)CC=CC=O)=O,,,5,1,1,0,1
65371_0,,,,2,2,1,3
C(CC(C(C=O)O)C(C=O)C=C)=O,,,5,1,1,0,1
65373_0,,,,2,2,1,3
C(C(C(C1C=CC(O1)=O)CC=O)O)=O,,,5,1,1,0,1
65375_0,,,,2,2,1,3
C(C(C(C1C(C=CO1)=O)CC=O)O)=O,,,5,1,1,0,1
65376_0,,,,2,2,1,3
65378_0,,,,2,2,1,3
C(CC(C(CO)O)C(C=O)O)=O,,,5,1,2,0,2
65380_0,,,,2,2,1,3
C(CC(C(C(O)=O)O)C(C=O)O)=O,,,5,1,2,0,2
65381_0,,,,2,2,1,3
65382_0,,,,2,2,1,3
65383_0,,,,2,2,1,3
65384_0,,,,2,2,1,3
65386_0,,,,2,2,1,3
C(CC(C(C=O)O)C(C=O)CO)=O,,,5,1,1,0,1
65388_0,,,,2,2,1,3
C(CC(C(C=O)O)C(C(C)=O)O)=O,,,5,1,2,0,2
65390_0,,,,2,2,1,3
C(CC(C(C=O)O)CC(CO)=O)=O,,,5,1,4,0,4
65392_0,,,,2,2,1,3
C(CC(C(C)O)C(C=O)O)=O,,,5,1,1,0,1
65394_0,,,,2,2,1,3
C(CC(CCO)C(C=O)O)=O,,,5,1,1,0,1
65396_0,,,,2,2,1,3
C(CC(C(C=O)O)CC=O)(O)=O,,,5,1,1,0,1
65398_0,,,,2,2,1,3
C(CC(C(C=O)O)C(C=O)O)=O,,,5,1,1,0,1
65399_0,,,,2,2,1,3
65401_0,,,,2,2,1,3
C(C(C=O)C(C=O)(CO)CCO)=O,,,5,1,1,0,1
65402_0,,,,2,2,1,3
65404_0,,,,2,2,1,3
C(C(C=O)C(C(CCO)=O)CO)=O,,,5,1,1,0,1
65406_0,,,,2,2,1,3
C(C(C=O)(CO)CC(CCO)=O)=O,,,5,1,1,0,1
65407_0,,,,2,2,1,3
65408_0,,,,2,2,1,3
65410_0,,,,2,2,1,3
C(C(C=O)C(CO)CC(CO)=O)=O,,,5,1,3,0,3
65411_0,,,,2,2,1,3
65412_0,,,,2,2,1,3
65413_0,,,,2,2,1,3
65415_0,,,,2,2,1,3
C(C(C=O)C(CO)C(C(C)=O)O)=O,,,5,1,2,0,2
65417_0,,,,2,2,1,3
C(C(C=O)C(CO)(C)C(C=O)O)=O,,,5,1,1,0,1
65419_0,,,,2,2,1,3
C(C(C=O)(C=C)C(C)C(C=O)C=O)=O,,,5,1,1,0,1
65421_0,,,,2,2,1,3
C(C(C=O)(C=C)CC(C=O)C=O)=O,,,5,1,1,0,1
65423_0,,,,2,2,1,3
C(C(C=O)(C=C)C(C)CC=O)=O,,,5,1,1,0,1
65425_0,,,,2,2,1,3
C(C(C=O)(C=C)CCC=O)=O,,,5,1,1,0,1
65427_0,,,,2,2,1,3
C(C(C=O)(C=C)CCC(O)=O)=O,,,5,1,1,0,1
65429_0,,,,2,2,1,3
C(C(C=O)(C=C)C1COC(C1)=O)=O,,,5,1,1,0,1
65431_0,,,,2,2,1,3
C(C(C=O)(C=C)CCC(C=O)=O)=O,,,5,1,1,0,1
65433_0,,,,2,2,1,3
C(C(C=O)(C=C)C(C=O)CC=O)=O,,,5,1,1,0,1
65435_0,,,,2,2,1,3
C(C(C=O)C(C)CC=C(C=O)C=O)=O,,,5,1,1,0,1
65437_0,,,,2,2,1,3
C(C(C=O)CCC=C(C=O)C=O)=O,,,5,1,1,0,1
65439_0,,,,2,2,1,3
C(CC(C)CC=C(C=O)C=O)=O,,,5,1,1,0,1
65441_0,,,,2,2,1,3
C(CCCC=C(C=O)C=O)=O,,,5,1,1,0,1
65443_0,,,,2,2,1,3
C(CCCC=C(C=O)C=O)(O)=O,,,5,1,1,0,1
65445_0,,,,2,2,1,3
C1(CC(CO1)CC=C(C=O)C=O)=O,,,5,1,1,0,1
65447_0,,,,2,2,1,3
C(CCCC(C=O)=O)=C(C=O)C=O,,,5,1,1,0,1
65449_0,,,,2,2,1,3
C(CC(C=O)CC=C(C=O)C=O)=O,,,5,1,1,0,1
65451_0,,,,2,2,1,3
C(C(C=O)C(C)CC=CC=O)=O,,,5,1,1,0,1
65453_0,,,,2,2,1,3
C(C(C=C)C(C)C(C=O)C=O)=O,,,5,1,1,0,1
65455_0,,,,2,2,1,3
C(C(C=O)C(C)C(C=O)(C=C)O)=O,,,5,1,1,0,1
65457_0,,,,2,2,1,3
C(C(C=O)C(C)C1C=CC(O1)=O)=O,,,5,1,1,0,1
65459_0,,,,2,2,1,3
C(C(C=O)C(C)C1C(C=CO1)=O)=O,,,5,1,1,0,1
65461_0,,,,2,2,1,3
C(C(C=O)C(C)C(C=O)(CO)O)=O,,,5,1,1,0,1
65463_0,,,,2,2,1,3
C(C(C=O)C(C)C(C(C=O)O)O)=O,,,5,1,1,0,1
65465_0,,,,2,2,1,3
C(C(C=O)C(C)CO)=O,,,5,1,1,0,1
65467_0,,,,2,2,1,3
C(C(C=O)C(C)C(CO)O)=O,,,5,1,1,0,1
65468_0,,,,2,2,1,3
65470_0,,,,2,2,1,3
C(C(C=O)C(C)C(C(CO)=O)O)=O,,,5,1,1,0,1
65472_0,,,,2,2,1,3
C(C(C=O)C(C)C(CO)(CO)O)=O,,,5,1,1,0,1
65474_0,,,,2,2,1,3
C(C(C=O)C(C)C(C(CO)O)O)=O,,,5,1,1,0,1
65475_0,,,,2,2,1,3
65477_0,,,,2,2,1,3
C(C(C=O)C(C)C(C=O)C=O)=O,,,5,1,1,0,1
65479_0,,,,2,2,1,3
C(C(C=O)C(C)CC=O)=O,,,5,1,2,0,2
65481_0,,,,2,2,1,3
C(C(C=O)C(C)C(C=O)C(C)O)=O,,,5,1,1,0,1
65483_0,,,,2,2,1,3
C(C(C=O)C(C)C(C)(CC=O)O)=O,,,5,1,1,0,1
65485_0,,,,2,2,1,3
C(C(C=O)C(C)CC(CC=O)O)=O,,,5,1,1,0,1
65487_0,,,,2,2,1,3
C(C(C=O)C(C)C(CC=O)O)=O,,,5,1,1,0,1
65489_0,,,,2,2,1,3
C(C(C=O)C(C)C(C=O)CO)=O,,,5,1,1,0,1
65491_0,,,,2,2,1,3
C(C(C=O)C(C)C(C(O)=O)(C)O)=O,,,5,1,1,0,1
65493_0,,,,2,2,1,3
C(C(C=O)C(C)CC(C(O)=O)O)=O,,,5,1,1,0,1
65495_0,,,,2,2,1,3
C(C(C=O)C(C)C(C(C=O)=O)O)=O,,,5,1,1,0,1
65497_0,,,,2,2,1,3
C(C(C=O)C(C)C(C(C)=O)O)=O,,,5,1,1,0,1
65499_0,,,,2,2,1,3
C(C(C=O)C(C)CC(CO)=O)=O,,,5,1,1,0,1
65501_0,,,,2,2,1,3
C(C(C=O)C(C)C(C)O)=O,,,5,1,1,0,1
65503_0,,,,2,2,1,3
C(C(C=O)C(C)CCO)=O,,,5,1,1,0,1
65505_0,,,,2,2,1,3
C(C(C=O)C(C)CC(C(O)=O)=O)=O,,,5,1,1,0,1
65507_0,,,,2,2,1,3
C(C(C=O)C(C)C(C=O)C(O)=O)=O,,,5,1,1,0,1
65509_0,,,,2,2,1,3
C(C(C=O)C(C)CC(O)=O)=O,,,5,1,1,0,1
65511_0,,,,2,2,1,3
C(C(C=O)C(C)C(C=O)O)=O,,,5,1,1,0,1
65512_0,,,,2,2,1,3
65513_0,,,,2,2,1,3
65515_0,,,,2,2,1,3
C(C(C=O)C(C(CO)O)C(C)O)=O,,,5,1,1,0,1
65517_0,,,,2,2,1,3
C(C(C=O)C(CCO)C(CO)O)=O,,,5,1,1,0,1
65519_0,,,,2,2,1,3
C(C(C=O)CC(C=C(C=O)C=O)O)=O,,,5,1,1,0,1
65521_0,,,,2,2,1,3
C(C(C=O)CC(C(C(C=O)=O)=C)O)=O,,,5,1,1,0,1
65523_0,,,,2,2,1,3
C(C(C=O)CC(C(C=O)=CC=O)O)=O,,,5,1,1,0,1
65525_0,,,,2,2,1,3
C(C(C=O)CC(C(C(C=O)=C)=O)O)=O,,,5,1,1,0,1
65527_0,,,,2,2,1,3
C(C(C=O)CC(C=O)(C(C=C)=O)O)=O,,,5,1,1,0,1
65529_0,,,,2,2,1,3
C(C(C=O)CCC=CC=O)=O,,,5,1,1,0,1
65531_0,,,,2,2,1,3
C(C(C=C)CC(C=O)C=O)=O,,,5,1,1,0,1
65533_0,,,,2,2,1,3
C(C(C=O)CC(C=O)(C=C)O)=O,,,5,1,1,0,1
65535_0,,,,2,2,1,3
C(C(C=O)CC(C=CC(O)=O)O)=O,,,5,1,1,0,1
65537_0,,,,2,2,1,3
C(C(C=O)CC(C(C=CC=O)=O)O)=O,,,5,1,1,0,1
65539_0,,,,2,2,1,3
C(C(C=O)CC1C=CC(O1)=O)=O,,,5,1,1,0,1
65541_0,,,,2,2,1,3
C(C(C=O)CC1C(C=CO1)=O)=O,,,5,1,1,0,1
65543_0,,,,2,2,1,3
C(C(C=O)CC1C(CC(O)O1)O)=O,,,5,1,1,0,1
65545_0,,,,2,2,1,3
C(C(C=O)CC1(COC(C1)O)O)=O,,,5,1,1,0,1
65547_0,,,,2,2,1,3
C(C(C=O)CC1(CC(CO1)O)O)=O,,,5,1,1,0,1
65549_0,,,,2,2,1,3
C(C(C=O)CC1C(O)OCC1O)=O,,,5,1,1,0,1
65551_0,,,,2,2,1,3
C(C(C=O)CC1(C(O)OCC1)O)=O,,,5,1,1,0,1
65553_0,,,,2,2,1,3
C(C(C=O)CC1(C(CCO1)O)O)=O,,,5,1,1,0,1
65555_0,,,,2,2,1,3
C(C(C=O)CC1CC(C(O)O1)O)=O,,,5,1,1,0,1
65557_0,,,,2,2,1,3
C(C(C=O)CC1COC(C1O)O)=O,,,5,1,1,0,1
65559_0,,,,2,2,1,3
C(C(C=O)CC(C=O)(CO)O)=O,,,5,1,1,0,1
65560_0,,,,2,2,1,3
65561_0,,,,2,2,1,3
65563_0,,,,2,2,1,3
C(C(C=O)CC(CO)O)=O,,,5,1,1,0,1
65565_0,,,,2,2,1,3
C(C(C=O)CC(C(O)=O)O)=O,,,5,1,1,0,1
65566_0,,,,2,2,1,3
65568_0,,,,2,2,1,3
C(C(C=O)CC(CO)(CO)O)=O,,,5,1,1,0,1
65570_0,,,,2,2,1,3
C(C(C=O)CC(C(CO)O)O)=O,,,5,1,1,0,1
65572_0,,,,2,2,1,3
C(C(C=O)CC(C(O)=O)(CO)O)=O,,,5,1,1,0,1
65573_0,,,,2,2,1,3
65574_0,,,,2,2,1,3
65576_0,,,,2,2,1,3
C(C(C=O)CC(C=O)C=O)=O,,,5,1,1,0,1
65577_0,,,,2,2,1,3
65578_0,,,,2,2,1,3
65580_0,,,,2,2,1,3
C(C(CC(C=O)C=O)(CC=O)O)=O,,,5,1,1,0,1
65581_0,,,,2,2,1,3
65583_0,,,,2,2,1,3
C(C(C=O)CC(C=O)C(CO)=O)=O,,,5,1,2,0,2
65585_0,,,,2,2,1,3
C(C(C=O)CC(C(CC=O)=O)O)=O,,,5,1,1,0,1
65587_0,,,,2,2,1,3
C(C(C=O)CC(C=O)(C(C)=O)O)=O,,,5,1,1,0,1
65589_0,,,,2,2,1,3
C(C(C=O)CCC(C(C=O)O)=O)=O,,,5,1,2,0,2
65591_0,,,,2,2,1,3
C(C(C=O)CCC=O)=O,,,5,1,2,0,2
65592_0,,,,2,2,1,3
65594_0,,,,2,2,1,3
C(C(C=O)(CC(C=O)C=O)CO)=O,,,5,1,1,0,1
65596_0,,,,2,2,1,3
C(C(C=O)CC(C=O)C(C)O)=O,,,5,1,1,0,1
65598_0,,,,2,2,1,3
C(C(C=O)CC(C)(CC=O)O)=O,,,5,1,1,0,1
65600_0,,,,2,2,1,3
C(C(C=O)CCC(CC=O)O)=O,,,5,1,1,0,1
65602_0,,,,2,2,1,3
C(C(C=O)CC(C=O)(C(C)O)O)=O,,,5,1,1,0,1
65604_0,,,,2,2,1,3
C(C(C=O)CC(C)(C(C=O)O)O)=O,,,5,1,1,0,1
65606_0,,,,2,2,1,3
C(C(C=O)CCC(C(C=O)O)O)=O,,,5,1,1,0,1
65607_0,,,,2,2,1,3
65609_0,,,,2,2,1,3
C(C(C=O)CC(C=O)CO)=O,,,5,1,1,0,1
65611_0,,,,2,2,1,3
C(C(C=O)CC(C(CC=O)O)O)=O,,,5,1,1,0,1
65612_0,,,,2,2,1,3
65614_0,,,,2,2,1,3
C(C(C=O)CC(C=O)C(CO)O)=O,,,5,1,1,0,1
65615_0,,,,2,2,1,3
65616_0,,,,2,2,1,3
65618_0,,,,2,2,1,3
C(C(C=O)CC(C(C=O)=O)O)=O,,,5,1,1,0,1
65620_0,,,,2,2,1,3
C(C(C=O)CC(C(C(C)=O)=O)O)=O,,,5,1,1,0,1
65622_0,,,,2,2,1,3
C(C(C=O)CCC(C(CO)=O)=O)=O,,,5,1,1,0,1
65624_0,,,,2,2,1,3
C(C(C=O)CCC(C(C=O)=O)O)=O,,,5,1,1,0,1
65626_0,,,,2,2,1,3
C(C(C=O)CC(C(C=O)=O)(C)O)=O,,,5,1,1,0,1
65628_0,,,,2,2,1,3
C(C(C=O)CC(C(C)=O)O)=O,,,5,1,1,0,1
65629_0,,,,2,2,1,3
65631_0,,,,2,2,1,3
C(C(C=O)CC(C(CCO)=O)O)=O,,,5,1,1,0,1
65632_0,,,,2,2,1,3
65634_0,,,,2,2,1,3
C(C(C=O)CC(C(CO)=O)CO)=O,,,5,1,1,0,1
65636_0,,,,2,2,1,3
C(C(C=O)CC(C=O)(CCO)O)=O,,,5,1,1,0,1
65638_0,,,,2,2,1,3
C(C(C=O)CC(CC(C=O)O)O)=O,,,5,1,1,0,1
65640_0,,,,2,2,1,3
C(C(C=O)CC(CO)C(C=O)O)=O,,,5,1,1,0,1
65642_0,,,,2,2,1,3
C(C(C=O)CC(C(C)=O)(CO)O)=O,,,5,1,1,0,1
65643_0,,,,2,2,1,3
65645_0,,,,2,2,1,3
C(C(C=O)CCC(C(CO)O)=O)=O,,,5,1,1,0,1
65647_0,,,,2,2,1,3
C(C(C=O)CC(C)O)=O,,,5,1,1,0,1
65649_0,,,,2,2,1,3
C(C(C=O)CCCO)=O,,,5,1,1,0,1
65650_0,,,,2,2,1,3
65652_0,,,,2,2,1,3
C(C(C=O)CC(C=O)C(O)=O)=O,,,5,1,1,0,1
65654_0,,,,2,2,1,3
C(C(C=O)CCC(O)=O)=O,,,5,1,2,0,2
65656_0,,,,2,2,1,3
C(C(C=O)CC1C(C(CO1)O)=O)=O,,,5,1,1,0,1
65658_0,,,,2,2,1,3
C(C(C=O)CC1C(C(CO1)=O)O)=O,,,5,1,1,0,1
65660_0,,,,2,2,1,3
C(C(C=O)CC1(C(COC1)=O)O)=O,,,5,1,1,0,1
65662_0,,,,2,2,1,3
C(C(C=O)CC1(C(CCO1)=O)O)=O,,,5,1,1,0,1
65664_0,,,,2,2,1,3
C(C(C=O)CC1CC(C(O)O1)=O)=O,,,5,1,1,0,1
65666_0,,,,2,2,1,3
C(C(C=O)CC1C(C(O)OC1)=O)=O,,,5,1,1,0,1
65668_0,,,,2,2,1,3
C(C(C=O)CC1C(OCC1O)=O)=O,,,5,1,1,0,1
65670_0,,,,2,2,1,3
C(C(C=O)CC1C(CC(O1)=O)O)=O,,,5,1,1,0,1
65672_0,,,,2,2,1,3
C(C(C=O)CC1(COC(C1)=O)O)=O,,,5,1,1,0,1
65674_0,,,,2,2,1,3
C(C(C=O)CC1C(COC1O)=O)=O,,,5,1,1,0,1
65676_0,,,,2,2,1,3
C(C(C=O)CC1(CC(CO1)=O)O)=O,,,5,1,1,0,1
65678_0,,,,2,2,1,3
C(C(C=O)CC1C(CC(O1)O)=O)=O,,,5,1,1,0,1
65679_0,,,,2,2,1,3
65681_0,,,,2,2,1,3
C(CC(C)C(C=C(C=O)C=O)O)=O,,,5,1,1,0,1
65683_0,,,,2,2,1,3
C(CCC(C=C(C=O)C=O)O)=O,,,5,1,1,0,1
65685_0,,,,2,2,1,3
C(CCC(C=C(C=O)C=O)O)(O)=O,,,5,1,1,0,1
65687_0,,,,2,2,1,3
C1(CC(CO1)C(C=C(C=O)C=O)O)=O,,,5,1,1,0,1
65689_0,,,,2,2,1,3
C(C(CCC(C=O)=O)O)=C(C=O)C=O,,,5,1,1,0,1
65690_0,,,,2,2,1,3
65692_0,,,,2,2,1,3
C(C(C=O)C(CO)CC=CC=O)=O,,,5,1,1,0,1
65694_0,,,,2,2,1,3
C(C(C=C)C(CO)C(C=O)C=O)=O,,,5,1,1,0,1
65696_0,,,,2,2,1,3
C(C(C=O)C(CO)C1C=CC(O1)=O)=O,,,5,1,1,0,1
65698_0,,,,2,2,1,3
C(C(C=O)C(CO)C1C(C=CO1)=O)=O,,,5,1,1,0,1
65699_0,,,,2,2,1,3
65700_0,,,,2,2,1,3
65702_0,,,,2,2,1,3
C(C(C=O)C(CO)C(C(O)=O)O)=O,,,5,1,1,0,1
65703_0,,,,2,2,1,3
65705_0,,,,2,2,1,3
C(C(C=O)C(CO)C(C=O)C=O)=O,,,5,1,1,0,1
65706_0,,,,2,2,1,3
65707_0,,,,2,2,1,3
65709_0,,,,2,2,1,3
C(C(C=O)C(CO)C(C=O)CO)=O,,,5,1,1,0,1
65710_0,,,,2,2,1,3
65711_0,,,,2,2,1,3
65713_0,,,,2,2,1,3
C(C(C=O)C(CO)C(C)O)=O,,,5,1,1,0,1
65715_0,,,,2,2,1,3
C(C(C=O)C(CO)CCO)=O,,,5,1,1,0,1
65717_0,,,,2,2,1,3
C(C(C=O)C(CO)CC(O)=O)=O,,,5,1,2,0,2
65718_0,,,,2,2,1,3
65720_0,,,,2,2,1,3
C(CC(C)C(CC(C=O)=CC=O)O)=O,,,5,1,1,0,1
65722_0,,,,2,2,1,3
C(CCC(CC(C=O)=CC=O)O)=O,,,5,1,1,0,1
65724_0,,,,2,2,1,3
C(CC(C)C(C(C=O)=CC=O)CO)=O,,,5,1,1,0,1
65726_0,,,,2,2,1,3
C(CCC(C(C=O)=CC=O)CO)=O,,,5,1,1,0,1
65728_0,,,,2,2,1,3
C(C(CCO)C(C=O)CC=CC=O)=O,,,5,1,1,0,1
65730_0,,,,2,2,1,3
C(C(CCO)C(C=O)C(C=O)C=C)=O,,,5,1,1,0,1
65731_0,,,,2,2,1,3
65732_0,,,,2,2,1,3
65734_0,,,,2,2,1,3
C(CC(C=O)C(C=O)CCO)=O,,,5,1,1,0,1
65735_0,,,,2,2,1,3
65737_0,,,,2,2,1,3
C(C(CCO)C(C=O)CCO)=O,,,5,1,1,0,1
65739_0,,,,2,2,1,3
C(CC(C=O)C(C=O)CCO)(O)=O,,,5,1,1,0,1
65740_0,,,,2,2,1,3
65742_0,,,,2,2,1,3
C(C(CCO)(CC=O)CC=CC=O)=O,,,5,1,1,0,1
65744_0,,,,2,2,1,3
C(C(CCO)(CC=O)C(C=O)C=C)=O,,,5,1,1,0,1
65746_0,,,,2,2,1,3
C(C(CO)(CCO)CC=O)=O,,,5,1,2,0,2
65748_0,,,,2,2,1,3
C(C(CCO)(C(CO)O)CC=O)=O,,,5,1,2,0,2
65750_0,,,,2,2,1,3
C(C(CCO)(CC=O)CC=O)=O,,,5,1,1,0,1
65752_0,,,,2,2,1,3
C(C(CCO)(C(C)O)CC=O)=O,,,5,1,2,0,2
65754_0,,,,2,2,1,3
C(C(CCO)(CCO)CC=O)=O,,,5,1,1,0,1
65756_0,,,,2,2,1,3
C(C(CCO)(CC(O)=O)CC=O)=O,,,5,1,1,0,1
65757_0,,,,2,2,1,3
65759_0,,,,2,2,1,3
C(CC(C)C(C=O)C(C=O)=CCO)=O,,,5,1,1,0,1
65761_0,,,,2,2,1,3
C(CCC(C=O)C(C=O)=CCO)=O,,,5,1,1,0,1
65763_0,,,,2,2,1,3
C(CC(C)C(C=C(C=O)CC=O)O)=O,,,5,1,1,0,1
65765_0,,,,2,2,1,3
C(CCC(C=C(C=O)CC=O)O)=O,,,5,1,1,0,1
65767_0,,,,2,2,1,3
C(C(C(CO)CC=CC=O)CC=O)=O,,,5,1,1,0,1
65769_0,,,,2,2,1,3
C(C(C(CO)C(C=O)C=C)CC=O)=O,,,5,1,1,0,1
65770_0,,,,2,2,1,3
65771_0,,,,2,2,1,3
65772_0,,,,2,2,1,3
65773_0,,,,2,2,1,3
65775_0,,,,2,2,1,3
C(C(C(CO)CCO)CC=O)=O,,,5,1,1,0,1
65776_0,,,,2,2,1,3
65777_0,,,,2,2,1,3
65778_0,,,,2,2,1,3
65779_0,,,,2,2,1,3
65781_0,,,,2,2,1,3
C(C(C(CO)C(C)O)C(C=O)O)=O,,,5,1,1,0,1
65783_0,,,,2,2,1,3
C(C(C(CO)CCO)C(C=O)O)=O,,,5,1,1,0,1
65785_0,,,,2,2,1,3
C(CC(C)C(CC(C=CC=O)=O)O)=O,,,5,1,1,0,1
65786_0,,,,2,2,1,3
65788_0,,,,2,2,1,3
C(CC(C)C(C(C=CC=O)=O)CO)=O,,,5,1,1,0,1
65790_0,,,,2,2,1,3
C(CCC(C(C=CC=O)=O)CO)=O,,,5,1,1,0,1
65792_0,,,,2,2,1,3
C(CC(C=O)CC=CC=O)(CCO)=O,,,5,1,1,0,1
65794_0,,,,2,2,1,3
C(CC(C=O)C(C=O)C=C)(CCO)=O,,,5,1,1,0,1
65795_0,,,,2,2,1,3
65797_0,,,,2,2,1,3
C(C(C(CO)O)CC(CCO)=O)=O,,,5,1,1,0,1
65799_0,,,,2,2,1,3
C(CC(C=O)CC=O)(CCO)=O,,,5,1,1,0,1
65800_0,,,,2,2,1,3
65802_0,,,,2,2,1,3
C(C(CCO)CC(CCO)=O)=O,,,5,1,1,0,1
65804_0,,,,2,2,1,3
C(CC(C=O)CC(O)=O)(CCO)=O,,,5,1,1,0,1
65806_0,,,,2,2,1,3
C(CC(C=O)C(C=O)O)(CCO)=O,,,5,1,1,0,1
65808_0,,,,2,2,1,3
C(CC(C(CCO)=O)CC=CC=O)=O,,,5,1,1,0,1
65810_0,,,,2,2,1,3
C(CC(C(CCO)=O)C(C=O)C=C)=O,,,5,1,1,0,1
65812_0,,,,2,2,1,3
C(C(CO)CC=O)(CCO)=O,,,5,1,1,0,1
65814_0,,,,2,2,1,3
C(C(C(CO)O)CC=O)(CCO)=O,,,5,1,1,0,1
65816_0,,,,2,2,1,3
C(CC(C(CCO)=O)CC=O)=O,,,5,1,1,0,1
65818_0,,,,2,2,1,3
C(C(C(C)O)CC=O)(CCO)=O,,,5,1,1,0,1
65820_0,,,,2,2,1,3
C(C(CCO)CC=O)(CCO)=O,,,5,1,1,0,1
65822_0,,,,2,2,1,3
C(CC(C(CCO)=O)CC=O)(O)=O,,,5,1,1,0,1
65824_0,,,,2,2,1,3
C(C(C(C(CCO)=O)CC=O)O)=O,,,5,1,1,0,1
65826_0,,,,2,2,1,3
C(CC(C)C(C(C=C)C(C=O)=O)O)=O,,,5,1,1,0,1
65827_0,,,,2,2,1,3
65829_0,,,,2,2,1,3
C(CC(C)C(C=C)(C(C=O)=O)CO)=O,,,5,1,1,0,1
65831_0,,,,2,2,1,3
C(CCC(C=C)(C(C=O)=O)CO)=O,,,5,1,1,0,1
65833_0,,,,2,2,1,3
C(CC(C)CC=C(C(C=O)=O)CO)=O,,,5,1,1,0,1
65835_0,,,,2,2,1,3
C(CCCC=C(C(C=O)=O)CO)=O,,,5,1,1,0,1
65837_0,,,,2,2,1,3
C(CC(C)C(C(C(C=O)=O)=CC)O)=O,,,5,1,1,0,1
65839_0,,,,2,2,1,3
C(CCC(C(C(C=O)=O)=CC)O)=O,,,5,1,1,0,1
65841_0,,,,2,2,1,3
C(CC(C)C(C(C=O)=O)CO)=CC=O,,,5,1,1,0,1
65843_0,,,,2,2,1,3
C(C(C=C)C(C)C(C(C=O)=O)CO)=O,,,5,1,1,0,1
65845_0,,,,2,2,1,3
C(C(C(CO)C(C)CO)=O)=O,,,5,1,1,0,1
65847_0,,,,2,2,1,3
C(C(C(CO)C(C)C(CO)O)=O)=O,,,5,1,1,0,1
65849_0,,,,2,2,1,3
C(CC(C)C(C(C=O)=O)CO)=O,,,5,1,2,0,2
65851_0,,,,2,2,1,3
C(C(C(CO)C(C)C(C)O)=O)=O,,,5,1,1,0,1
65853_0,,,,2,2,1,3
C(C(C(CO)C(C)CCO)=O)=O,,,5,1,1,0,1
65855_0,,,,2,2,1,3
C(CC(C)C(C(C=O)=O)CO)(O)=O,,,5,1,1,0,1
65857_0,,,,2,2,1,3
C(C(C(C)C(C(C=O)=O)CO)O)=O,,,5,1,1,0,1
65859_0,,,,2,2,1,3
C(CC(C)C(C(C(C=O)=O)=C)(C)O)=O,,,5,1,1,0,1
65861_0,,,,2,2,1,3
C(CCC(C(C(C=O)=O)=C)(C)O)=O,,,5,1,1,0,1
65863_0,,,,2,2,1,3
C(CC(C)CC(C(C(C=O)=O)=C)O)=O,,,5,1,1,0,1
65865_0,,,,2,2,1,3
C(CCCC(C(C(C=O)=O)=C)O)=O,,,5,1,1,0,1
65867_0,,,,2,2,1,3
C(CCC(C(C=O)=O)C(C)O)=CC=O,,,5,1,1,0,1
65869_0,,,,2,2,1,3
C(C(C=C)CC(C(C=O)=O)C(C)O)=O,,,5,1,1,0,1
65870_0,,,,2,2,1,3
65871_0,,,,2,2,1,3
65872_0,,,,2,2,1,3
65873_0,,,,2,2,1,3
65874_0,,,,2,2,1,3
65875_0,,,,2,2,1,3
65876_0,,,,2,2,1,3
65878_0,,,,2,2,1,3
C(CC(C)C(C(C(C=O)=O)=C)O)=O,,,5,1,1,0,1
65880_0,,,,2,2,1,3
C(CCC(C(C(C=O)=O)=C)O)=O,,,5,1,1,0,1
65882_0,,,,2,2,1,3
C(CCC(C(C(C=O)=O)=C)O)(O)=O,,,5,1,1,0,1
65884_0,,,,2,2,1,3
C1(CC(CO1)C(C(C(C=O)=O)=C)O)=O,,,5,1,1,0,1
65886_0,,,,2,2,1,3
C=C(C(C=O)=O)C(CCC(C=O)=O)O,,,5,1,1,0,1
65888_0,,,,2,2,1,3
C(CC(C=O)C(C(C(C=O)=O)=C)O)=O,,,5,1,1,0,1
65890_0,,,,2,2,1,3
C(CCC(C(C=O)=O)CO)=CC=O,,,5,1,1,0,1
65892_0,,,,2,2,1,3
C(C(C=C)CC(C(C=O)=O)CO)=O,,,5,1,1,0,1
65894_0,,,,2,2,1,3
C1C(CC(C(C=O)=O)CO)OC(C=1)=O,,,5,1,1,0,1
65896_0,,,,2,2,1,3
C1OC(C(C=1)=O)CC(C(C=O)=O)CO,,,5,1,1,0,1
65897_0,,,,2,2,1,3
65898_0,,,,2,2,1,3
65899_0,,,,2,2,1,3
65900_0,,,,2,2,1,3
65901_0,,,,2,2,1,3
65902_0,,,,2,2,1,3
65903_0,,,,2,2,1,3
65904_0,,,,2,2,1,3
65905_0,,,,2,2,1,3
65906_0,,,,2,2,1,3
65907_0,,,,2,2,1,3
65908_0,,,,2,2,1,3
65909_0,,,,2,2,1,3
65910_0,,,,2,2,1,3
65911_0,,,,2,2,1,3
65912_0,,,,2,2,1,3
65914_0,,,,2,2,1,3
C(C(C(CO)C(CO)C(C)O)=O)=O,,,5,1,1,0,1
65916_0,,,,2,2,1,3
C(C(C(CO)C(CO)CCO)=O)=O,,,5,1,1,0,1
65917_0,,,,2,2,1,3
65918_0,,,,2,2,1,3
65919_0,,,,2,2,1,3
65920_0,,,,2,2,1,3
65922_0,,,,2,2,1,3
C(CC(C)C(C=O)(CC=CC=O)O)=O,,,5,1,1,0,1
65924_0,,,,2,2,1,3
C(CCC(C=O)(CC=CC=O)O)=O,,,5,1,1,0,1
65926_0,,,,2,2,1,3
C(CC(C)C(C=CC=O)C(C=O)O)=O,,,5,1,1,0,1
65928_0,,,,2,2,1,3
C(CCC(C=CC=O)C(C=O)O)=O,,,5,1,1,0,1
65930_0,,,,2,2,1,3
C(CC(CC(C=O)O)CC=CC=O)=O,,,5,1,1,0,1
65932_0,,,,2,2,1,3
C(CC(CC(C=O)O)C(C=O)C=C)=O,,,5,1,1,0,1
65933_0,,,,2,2,1,3
65934_0,,,,2,2,1,3
65935_0,,,,2,2,1,3
65937_0,,,,2,2,1,3
C(CC(CC(C=O)O)C(C)O)=O,,,5,1,1,0,1
65939_0,,,,2,2,1,3
C(CC(CC(C=O)O)CCO)=O,,,5,1,1,0,1
65941_0,,,,2,2,1,3
C(CC(CC(C=O)O)CC=O)(O)=O,,,5,1,1,0,1
65942_0,,,,2,2,1,3
65944_0,,,,2,2,1,3
C(C(C=CC(C=O)O)C(C)CC=O)=O,,,5,1,1,0,1
65946_0,,,,2,2,1,3
C(C(C=CC(C=O)O)CCC=O)=O,,,5,1,1,0,1
65948_0,,,,2,2,1,3
C(C(C=CCC=O)(C(C)CC=O)O)=O,,,5,1,1,0,1
65950_0,,,,2,2,1,3
C(C(C=CCC=O)(CCC=O)O)=O,,,5,1,1,0,1
65951_0,,,,2,2,1,3
65952_0,,,,2,2,1,3
65954_0,,,,2,2,1,3
C(CC(C)C(C=O)(C=C)C(C=O)O)=O,,,5,1,1,0,1
65956_0,,,,2,2,1,3
C(CCC(C=O)(C=C)C(C=O)O)=O,,,5,1,1,0,1
65958_0,,,,2,2,1,3
C(C(C(C=O)=CCC(C)CC=O)O)=O,,,5,1,1,0,1
65960_0,,,,2,2,1,3
C(C(C(C=O)=CCCCC=O)O)=O,,,5,1,1,0,1
65962_0,,,,2,2,1,3
C(CC(C)C(C=O)(C(C=O)=CC)O)=O,,,5,1,1,0,1
65964_0,,,,2,2,1,3
C(CCC(C=O)(C(C=O)=CC)O)=O,,,5,1,1,0,1
65966_0,,,,2,2,1,3
C(C(C(C)CC=CC=O)C(C=O)O)=O,,,5,1,1,0,1
65968_0,,,,2,2,1,3
C(C(C(C)C(C=O)C=C)C(C=O)O)=O,,,5,1,1,0,1
65970_0,,,,2,2,1,3
C(C(C(CO)C)C(C=O)O)=O,,,5,1,1,0,1
65972_0,,,,2,2,1,3
C(C(C(C)C(CO)O)C(C=O)O)=O,,,5,1,1,0,1
65974_0,,,,2,2,1,3
C(CC(C)C(C=O)C(C=O)O)=O,,,5,1,2,0,2
65976_0,,,,2,2,1,3
C(C(C(C)C(C)O)C(C=O)O)=O,,,5,1,1,0,1
65978_0,,,,2,2,1,3
C(C(C(C)CCO)C(C=O)O)=O,,,5,1,1,0,1
65980_0,,,,2,2,1,3
C(CC(C)C(C=O)C(C=O)O)(O)=O,,,5,1,1,0,1
65982_0,,,,2,2,1,3
C(C(C(C)C(C=O)C(C=O)O)O)=O,,,5,1,1,0,1
65984_0,,,,2,2,1,3
C(CC(C)C(C(C=O)=CC=O)(C)O)=O,,,5,1,1,0,1
65986_0,,,,2,2,1,3
C(CCC(C(C=O)=CC=O)(C)O)=O,,,5,1,1,0,1
65988_0,,,,2,2,1,3
C(CC(C)CC(C(C=O)=CC=O)O)=O,,,5,1,1,0,1
65990_0,,,,2,2,1,3
C(CCCC(C(C=O)=CC=O)O)=O,,,5,1,1,0,1
65992_0,,,,2,2,1,3
C(C(C(C)O)C(C=O)CC=CC=O)=O,,,5,1,1,0,1
65994_0,,,,2,2,1,3
C(C(C(C)O)C(C=O)C(C=O)C=C)=O,,,5,1,1,0,1
65995_0,,,,2,2,1,3
65996_0,,,,2,2,1,3
65997_0,,,,2,2,1,3
65998_0,,,,2,2,1,3
65999_0,,,,2,2,1,3
66000_0,,,,2,2,1,3
66001_0,,,,2,2,1,3
66003_0,,,,2,2,1,3
C(C(C(C)O)(CC=O)CC=CC=O)=O,,,5,1,1,0,1
66005_0,,,,2,2,1,3
C(C(C(C)O)(CC=O)C(C=O)C=C)=O,,,5,1,1,0,1
66006_0,,,,2,2,1,3
66007_0,,,,2,2,1,3
66009_0,,,,2,2,1,3
C(C(C(C)O)(CC=O)CC=O)=O,,,5,1,1,0,1
66010_0,,,,2,2,1,3
66011_0,,,,2,2,1,3
66013_0,,,,2,2,1,3
C(C(C(C)O)(CC(O)=O)CC=O)=O,,,5,1,1,0,1
66014_0,,,,2,2,1,3
66016_0,,,,2,2,1,3
C(CC(C)C(C(C=O)=CC=O)O)=O,,,5,1,1,0,1
66018_0,,,,2,2,1,3
C(CCC(C(C=O)=CC=O)O)=O,,,5,1,1,0,1
66020_0,,,,2,2,1,3
C(CCC(C(C=O)=CC=O)O)(O)=O,,,5,1,1,0,1
66022_0,,,,2,2,1,3
C1(CC(CO1)C(C(C=O)=CC=O)O)=O,,,5,1,1,0,1
66024_0,,,,2,2,1,3
C(C=O)(CCC(C(C=O)=CC=O)O)=O,,,5,1,1,0,1
66025_0,,,,2,2,1,3
66027_0,,,,2,2,1,3
C(C(CO)C(C=O)CC=CC=O)=O,,,5,1,1,0,1
66029_0,,,,2,2,1,3
C(C(CO)C(C=O)C(C=O)C=C)=O,,,5,1,1,0,1
66031_0,,,,2,2,1,3
C(C(CO)C(C=O)C1C=CC(O1)=O)=O,,,5,1,1,0,1
66033_0,,,,2,2,1,3
C(C(CO)C(C=O)C1C(C=CO1)=O)=O,,,5,1,1,0,1
66034_0,,,,2,2,1,3
66035_0,,,,2,2,1,3
66036_0,,,,2,2,1,3
66037_0,,,,2,2,1,3
66038_0,,,,2,2,1,3
66039_0,,,,2,2,1,3
66040_0,,,,2,2,1,3
66041_0,,,,2,2,1,3
66042_0,,,,2,2,1,3
66043_0,,,,2,2,1,3
66044_0,,,,2,2,1,3
66045_0,,,,2,2,1,3
66046_0,,,,2,2,1,3
66047_0,,,,2,2,1,3
66049_0,,,,2,2,1,3
C(C(CO)(CC=O)CC=CC=O)=O,,,5,1,1,0,1
66051_0,,,,2,2,1,3
C(C(CO)(CC=O)C(C=O)C=C)=O,,,5,1,1,0,1
66053_0,,,,2,2,1,3
C(CC(C=O)(CO)C1C=CC(O1)=O)=O,,,5,1,1,0,1
66055_0,,,,2,2,1,3
C(CC(C=O)(CO)C1C(C=CO1)=O)=O,,,5,1,1,0,1
66056_0,,,,2,2,1,3
66057_0,,,,2,2,1,3
66058_0,,,,2,2,1,3
66060_0,,,,2,2,1,3
C(C(CO)(CC=O)CC(C=O)=O)=O,,,5,1,1,0,1
66062_0,,,,2,2,1,3
C(C(CO)(CC=O)C(C=O)C=O)=O,,,5,1,1,0,1
66064_0,,,,2,2,1,3
C(C(CO)(CC=O)CC=O)=O,,,5,1,1,0,1
66065_0,,,,2,2,1,3
66067_0,,,,2,2,1,3
C(C(CO)C(C=O)(CO)CC=O)=O,,,5,1,1,0,1
66068_0,,,,2,2,1,3
66070_0,,,,2,2,1,3
C(C(CO)(CC(CO)=O)CC=O)=O,,,5,1,2,0,2
66071_0,,,,2,2,1,3
66072_0,,,,2,2,1,3
66074_0,,,,2,2,1,3
C(C(CO)(CC(O)=O)CC=O)=O,,,5,1,1,0,1
66075_0,,,,2,2,1,3
66076_0,,,,2,2,1,3
66077_0,,,,2,2,1,3
66078_0,,,,2,2,1,3
66079_0,,,,2,2,1,3
66080_0,,,,2,2,1,3
66082_0,,,,2,2,1,3
C(C(C(CO)O)(CC=O)CC=O)=O,,,5,1,1,0,1
66083_0,,,,2,2,1,3
66084_0,,,,2,2,1,3
66086_0,,,,2,2,1,3
C(CC(C)C(C(CO)=O)C=CC=O)=O,,,5,1,1,0,1
66088_0,,,,2,2,1,3
C(CCC(C(CO)=O)C=CC=O)=O,,,5,1,1,0,1
66090_0,,,,2,2,1,3
C(CC(C)C(C(CC=CC=O)=O)O)=O,,,5,1,1,0,1
66092_0,,,,2,2,1,3
C(CCC(C(CC=CC=O)=O)O)=O,,,5,1,1,0,1
66094_0,,,,2,2,1,3
C(CC(CC(CO)=O)CC=CC=O)=O,,,5,1,2,0,2
66096_0,,,,2,2,1,3
C(CC(CC(CO)=O)C(C=O)C=C)=O,,,5,1,2,0,2
66097_0,,,,2,2,1,3
66099_0,,,,2,2,1,3
C(CC(C(CO)O)CC(CO)=O)=O,,,5,1,3,0,3
66100_0,,,,2,2,1,3
66102_0,,,,2,2,1,3
C(CC(C(C)O)CC(CO)=O)=O,,,5,1,2,0,2
66104_0,,,,2,2,1,3
C(CC(CCO)CC(CO)=O)=O,,,5,1,2,0,2
66106_0,,,,2,2,1,3
C(CC(CC=O)CC(CO)=O)(O)=O,,,5,1,2,0,2
66107_0,,,,2,2,1,3
66109_0,,,,2,2,1,3
C(CC(C)C(C=O)C=CC(CO)=O)=O,,,5,1,1,0,1
66111_0,,,,2,2,1,3
C(CCC(C=O)C=CC(CO)=O)=O,,,5,1,1,0,1
66113_0,,,,2,2,1,3
C(CC(C)C(C(C=CCC=O)=O)O)=O,,,5,1,1,0,1
66115_0,,,,2,2,1,3
C(CCC(C(C=CCC=O)=O)O)=O,,,5,1,1,0,1
66116_0,,,,2,2,1,3
66117_0,,,,2,2,1,3
66118_0,,,,2,2,1,3
66119_0,,,,2,2,1,3
66120_0,,,,2,2,1,3
66121_0,,,,2,2,1,3
66122_0,,,,2,2,1,3
66123_0,,,,2,2,1,3
66124_0,,,,2,2,1,3
66125_0,,,,2,2,1,3
66126_0,,,,2,2,1,3
66128_0,,,,2,2,1,3
C(C(C(C(C)O)CC(CO)=O)O)=O,,,5,1,1,0,1
66130_0,,,,2,2,1,3
C(C(C(CCO)CC(CO)=O)O)=O,,,5,1,1,0,1
66132_0,,,,2,2,1,3
C(CC(C)C(C=O)C(CO)=CC=O)=O,,,5,1,1,0,1
66134_0,,,,2,2,1,3
C(CCC(C=O)C(CO)=CC=O)=O,,,5,1,1,0,1
66136_0,,,,2,2,1,3
C(CC(C)C(C(CC=O)=CC=O)O)=O,,,5,1,1,0,1
66138_0,,,,2,2,1,3
C(CCC(C(CC=O)=CC=O)O)=O,,,5,1,1,0,1
66140_0,,,,2,2,1,3
C(CC(CO)(CC=O)CC=CC=O)=O,,,5,1,1,0,1
66142_0,,,,2,2,1,3
C(C(C=C)C(CO)(CC=O)CC=O)=O,,,5,1,1,0,1
66143_0,,,,2,2,1,3
66144_0,,,,2,2,1,3
66146_0,,,,2,2,1,3
C(CC(CO)(CC=O)CC=O)=O,,,5,1,1,0,1
66148_0,,,,2,2,1,3
C(CC(CO)(C(C)O)CC=O)=O,,,5,1,1,0,1
66150_0,,,,2,2,1,3
C(CC(CO)(CCO)CC=O)=O,,,5,1,1,0,1
66152_0,,,,2,2,1,3
C(CC(CO)(CC=O)CC=O)(O)=O,,,5,1,1,0,1
66154_0,,,,2,2,1,3
C(CC(CO)(C(C=O)O)CC=O)=O,,,5,1,2,0,2
66155_0,,,,2,2,1,3
66156_0,,,,2,2,1,3
66158_0,,,,2,2,1,3
C(CC(CO)(C(C)O)C(C=O)O)=O,,,5,1,1,0,1
66160_0,,,,2,2,1,3
C(CC(CO)(CCO)C(C=O)O)=O,,,5,1,1,0,1
66162_0,,,,2,2,1,3
C(CC(C)C(C=O)(C(CO)=O)C=C)=O,,,5,1,1,0,1
66164_0,,,,2,2,1,3
C(CCC(C=O)(C(CO)=O)C=C)=O,,,5,1,1,0,1
66166_0,,,,2,2,1,3
C(CC(C)C(C(C(C=O)C=C)=O)O)=O,,,5,1,1,0,1
66168_0,,,,2,2,1,3
C(CCC(C(C(C=O)C=C)=O)O)=O,,,5,1,1,0,1
66170_0,,,,2,2,1,3
C(CC(C)CC=C(C=O)C(CO)=O)=O,,,5,1,1,0,1
66172_0,,,,2,2,1,3
C(CCCC=C(C=O)C(CO)=O)=O,,,5,1,1,0,1
66174_0,,,,2,2,1,3
C(CC(C)C(C(C(C=O)=CC)=O)O)=O,,,5,1,1,0,1
66176_0,,,,2,2,1,3
C(CCC(C(C(C=O)=CC)=O)O)=O,,,5,1,1,0,1
66178_0,,,,2,2,1,3
C(C(C(CO)=O)C(C)CC=CC=O)=O,,,5,1,1,0,1
66180_0,,,,2,2,1,3
C(C(C=C)C(C)C(C=O)C(CO)=O)=O,,,5,1,1,0,1
66182_0,,,,2,2,1,3
C(C(C(CO)=O)C(CO)C)=O,,,5,1,1,0,1
66184_0,,,,2,2,1,3
C(C(C(CO)=O)C(C)C(CO)O)=O,,,5,1,1,0,1
66186_0,,,,2,2,1,3
C(CC(C)C(C=O)C(CO)=O)=O,,,5,1,2,0,2
66188_0,,,,2,2,1,3
C(C(C(CO)=O)C(C)C(C)O)=O,,,5,1,1,0,1
66190_0,,,,2,2,1,3
C(C(C(CO)=O)C(C)CCO)=O,,,5,1,1,0,1
66192_0,,,,2,2,1,3
C(CC(C)C(C=O)C(CO)=O)(O)=O,,,5,1,1,0,1
66194_0,,,,2,2,1,3
C(C(C(C)C(C=O)C(CO)=O)O)=O,,,5,1,1,0,1
66196_0,,,,2,2,1,3
C(CC(C)C(C(C(C=O)=C)=O)O)=O,,,5,1,1,0,1
66198_0,,,,2,2,1,3
C(CCC(C(C(C=O)=C)=O)O)=O,,,5,1,1,0,1
66200_0,,,,2,2,1,3
C(CCC(C(C(C=O)=C)=O)O)(O)=O,,,5,1,1,0,1
66202_0,,,,2,2,1,3
C1(CC(CO1)C(C(C(C=O)=C)=O)O)=O,,,5,1,1,0,1
66204_0,,,,2,2,1,3
C=C(C=O)C(C(CCC(C=O)=O)O)=O,,,5,1,1,0,1
66206_0,,,,2,2,1,3
C(CC(C=O)C(C(C(C=O)=C)=O)O)=O,,,5,1,1,0,1
66208_0,,,,2,2,1,3
C(C(C(CO)=O)CCC=CC=O)=O,,,5,1,1,0,1
66210_0,,,,2,2,1,3
C(C(C=C)CC(C=O)C(CO)=O)=O,,,5,1,1,0,1
66212_0,,,,2,2,1,3
C(C(C(CO)=O)CC1C=CC(O1)=O)=O,,,5,1,1,0,1
66214_0,,,,2,2,1,3
C(C(C(CO)=O)CC1C(C=CO1)=O)=O,,,5,1,1,0,1
66215_0,,,,2,2,1,3
66217_0,,,,2,2,1,3
C(C(C(CO)=O)CC(CO)O)=O,,,5,1,1,0,1
66219_0,,,,2,2,1,3
C(C(CC(C=O)C(CO)=O)O)(O)=O,,,5,1,1,0,1
66220_0,,,,2,2,1,3
66221_0,,,,2,2,1,3
66223_0,,,,2,2,1,3
C(CCC(C=O)C(CO)=O)=O,,,5,1,2,0,2
66224_0,,,,2,2,1,3
66226_0,,,,2,2,1,3
C(C(CO)CC(C=O)C(CO)=O)=O,,,5,1,1,0,1
66228_0,,,,2,2,1,3
C(C)(C(CC(C=O)C(CO)=O)O)=O,,,5,1,1,0,1
66229_0,,,,2,2,1,3
66231_0,,,,2,2,1,3
C(C(C(CO)=O)CC(C)O)=O,,,5,1,1,0,1
66233_0,,,,2,2,1,3
C(C(C(CO)=O)CCCO)=O,,,5,1,1,0,1
66235_0,,,,2,2,1,3
C(CCC(C=O)C(CO)=O)(O)=O,,,5,1,2,0,2
66236_0,,,,2,2,1,3
66237_0,,,,2,2,1,3
66238_0,,,,2,2,1,3
66240_0,,,,2,2,1,3
C(C(C(CO)=O)C(CO)C(C)O)=O,,,5,1,1,0,1
66242_0,,,,2,2,1,3
C(C(C(CO)=O)C(CO)CCO)=O,,,5,1,1,0,1
66244_0,,,,2,2,1,3
C(C(C(C(C=C)O)=O)C(C)CC=O)=O,,,5,1,1,0,1
66246_0,,,,2,2,1,3
C(C(C(C(C=C)O)=O)CCC=O)=O,,,5,1,1,0,1
66248_0,,,,2,2,1,3
C(CC=O)(C(C=C)(C(C)CC=O)O)=O,,,5,1,1,0,1
66250_0,,,,2,2,1,3
C(CC=O)(C(C=C)(CCC=O)O)=O,,,5,1,1,0,1
66252_0,,,,2,2,1,3
C(CC(C)C(C(C)=O)(C=CC=O)O)=O,,,5,1,1,0,1
66254_0,,,,2,2,1,3
C(CCC(C(C)=O)(C=CC=O)O)=O,,,5,1,1,0,1
66256_0,,,,2,2,1,3
C(CC(C)CC(C(C=CC=O)O)=O)=O,,,5,1,1,0,1
66258_0,,,,2,2,1,3
C(CCCC(C(C=CC=O)O)=O)=O,,,5,1,1,0,1
66260_0,,,,2,2,1,3
C(CC(C(C(C)=O)O)CC=CC=O)=O,,,5,1,1,0,1
66262_0,,,,2,2,1,3
C(CC(C(C(C)=O)O)C(C=O)C=C)=O,,,5,1,1,0,1
66263_0,,,,2,2,1,3
66265_0,,,,2,2,1,3
C(CC(C(CO)O)C(C(C)=O)O)=O,,,5,1,2,0,2
66266_0,,,,2,2,1,3
66268_0,,,,2,2,1,3
C(CC(C(C)O)C(C(C)=O)O)=O,,,5,1,1,0,1
66270_0,,,,2,2,1,3
C(CC(CCO)C(C(C)=O)O)=O,,,5,1,1,0,1
66272_0,,,,2,2,1,3
C(CC(C(C(C)=O)O)CC=O)(O)=O,,,5,1,1,0,1
66273_0,,,,2,2,1,3
66275_0,,,,2,2,1,3
C(CC(C)C(C=O)(C(C)=CC=O)O)=O,,,5,1,1,0,1
66277_0,,,,2,2,1,3
C(CCC(C=O)(C(C)=CC=O)O)=O,,,5,1,1,0,1
66279_0,,,,2,2,1,3
C(C(C(CC(C)CC=O)=CC=O)O)=O,,,5,1,1,0,1
66281_0,,,,2,2,1,3
C(C(C(CCCC=O)=CC=O)O)=O,,,5,1,1,0,1
66283_0,,,,2,2,1,3
C(CC(C)(C(C=O)O)CC=CC=O)=O,,,5,1,1,0,1
66285_0,,,,2,2,1,3
C(CC(C)(C(C=O)O)C(C=O)C=C)=O,,,5,1,1,0,1
66287_0,,,,2,2,1,3
C(CC(CO)(C)C(C=O)O)=O,,,5,1,1,0,1
66289_0,,,,2,2,1,3
C(CC(C)(C(CO)O)C(C=O)O)=O,,,5,1,1,0,1
66291_0,,,,2,2,1,3
C(CC(C)(C(C=O)O)CC=O)=O,,,5,1,1,0,1
66293_0,,,,2,2,1,3
C(CC(C)(C(C)O)C(C=O)O)=O,,,5,1,1,0,1
66295_0,,,,2,2,1,3
C(CC(C)(CCO)C(C=O)O)=O,,,5,1,1,0,1
66297_0,,,,2,2,1,3
C(CC(C)(C(C=O)O)CC=O)(O)=O,,,5,1,1,0,1
66299_0,,,,2,2,1,3
C(CC(C)(C(C=O)O)C(C=O)O)=O,,,5,1,1,0,1
66301_0,,,,2,2,1,3
C(C(C(C(C=O)O)=C)C(C)CC=O)=O,,,5,1,1,0,1
66303_0,,,,2,2,1,3
C(C(C(C(C=O)O)=C)CCC=O)=O,,,5,1,1,0,1
66305_0,,,,2,2,1,3
C(C(C(CC=O)=C)(C(C)CC=O)O)=O,,,5,1,1,0,1
66307_0,,,,2,2,1,3
C(C(C(CC=O)=C)(CCC=O)O)=O,,,5,1,1,0,1
66309_0,,,,2,2,1,3
C(C(C(CC=C)=O)(C(C)CC=O)O)=O,,,5,1,1,0,1
66311_0,,,,2,2,1,3
C(C(C(CC=C)=O)(CCC=O)O)=O,,,5,1,1,0,1
66313_0,,,,2,2,1,3
C(C(C=O)O)(C(C=C)C(C)CC=O)=O,,,5,1,1,0,1
66315_0,,,,2,2,1,3
C(C(C=O)O)(C(C=C)CCC=O)=O,,,5,1,1,0,1
66317_0,,,,2,2,1,3
C(C(C(C=CCC(C)CC=O)=O)O)=O,,,5,1,1,0,1
66319_0,,,,2,2,1,3
C(C(C(C=CCCCC=O)=O)O)=O,,,5,1,1,0,1
66321_0,,,,2,2,1,3
C(CC(C)C(C=O)(C(C=CC)=O)O)=O,,,5,1,1,0,1
66323_0,,,,2,2,1,3
C(CCC(C=O)(C(C=CC)=O)O)=O,,,5,1,1,0,1
66325_0,,,,2,2,1,3
C(C(C(CC(C)CC=CC=O)=O)O)=O,,,5,1,1,0,1
66327_0,,,,2,2,1,3
C(C(C=C)C(C)CC(C(C=O)O)=O)=O,,,5,1,1,0,1
66329_0,,,,2,2,1,3
C(C(C(CC(CO)C)=O)O)=O,,,5,1,1,0,1
66331_0,,,,2,2,1,3
C(C(C(CC(C)C(CO)O)=O)O)=O,,,5,1,1,0,1
66333_0,,,,2,2,1,3
C(C(C(CC(C)CC=O)=O)O)=O,,,5,1,2,0,2
66335_0,,,,2,2,1,3
C(C(C(CC(C)C(C)O)=O)O)=O,,,5,1,1,0,1
66337_0,,,,2,2,1,3
C(C(C(CC(C)CCO)=O)O)=O,,,5,1,1,0,1
66339_0,,,,2,2,1,3
C(C(C(CC(C)CC(O)=O)=O)O)=O,,,5,1,1,0,1
66341_0,,,,2,2,1,3
C(CC(C)C(C=O)O)(C(C=O)O)=O,,,5,1,1,0,1
66343_0,,,,2,2,1,3
C(C(C(C=C)=O)(C(C)CC=O)O)=O,,,5,1,1,0,1
66345_0,,,,2,2,1,3
C(C(C(C=C)=O)(CCC=O)O)=O,,,5,1,1,0,1
66347_0,,,,2,2,1,3
C(C(C(C=C)=O)(CCC(O)=O)O)=O,,,5,1,1,0,1
66349_0,,,,2,2,1,3
C(C(C(C=C)=O)(C1COC(C1)=O)O)=O,,,5,1,1,0,1
66351_0,,,,2,2,1,3
C(C(C(C=C)=O)(CCC(C=O)=O)O)=O,,,5,1,1,0,1
66353_0,,,,2,2,1,3
C(C(C(C=C)=O)(C(C=O)CC=O)O)=O,,,5,1,1,0,1
66355_0,,,,2,2,1,3
C(C(C(CCCC=CC=O)=O)O)=O,,,5,1,1,0,1
66357_0,,,,2,2,1,3
C(C(C=C)CCC(C(C=O)O)=O)=O,,,5,1,1,0,1
66359_0,,,,2,2,1,3
C(CCC1C=CC(O1)=O)(C(C=O)O)=O,,,5,1,1,0,1
66361_0,,,,2,2,1,3
C(CCC1C(C=CO1)=O)(C(C=O)O)=O,,,5,1,1,0,1
66362_0,,,,2,2,1,3
66364_0,,,,2,2,1,3
C(C(C(CCC(CO)O)=O)O)=O,,,5,1,1,0,1
66366_0,,,,2,2,1,3
C(CCC(C(O)=O)O)(C(C=O)O)=O,,,5,1,1,0,1
66367_0,,,,2,2,1,3
66368_0,,,,2,2,1,3
66370_0,,,,2,2,1,3
C(C(C(CCCC=O)=O)O)=O,,,5,1,2,0,2
66371_0,,,,2,2,1,3
66373_0,,,,2,2,1,3
C(C(CO)CCC(C(C=O)O)=O)=O,,,5,1,1,0,1
66375_0,,,,2,2,1,3
C(CCC(C(C)=O)O)(C(C=O)O)=O,,,5,1,1,0,1
66376_0,,,,2,2,1,3
66378_0,,,,2,2,1,3
C(C(C(CCC(C)O)=O)O)=O,,,5,1,1,0,1
66380_0,,,,2,2,1,3
C(C(C(CCCCO)=O)O)=O,,,5,1,1,0,1
66382_0,,,,2,2,1,3
C(C(C(CCCC(O)=O)=O)O)=O,,,5,1,2,0,2
66383_0,,,,2,2,1,3
66384_0,,,,2,2,1,3
66385_0,,,,2,2,1,3
66387_0,,,,2,2,1,3
C(C(C(CC(CO)C(C)O)=O)O)=O,,,5,1,1,0,1
66389_0,,,,2,2,1,3
C(C(C(CC(CO)CCO)=O)O)=O,,,5,1,1,0,1
66391_0,,,,2,2,1,3
C(CC(C)CC=CC=O)=O,,,5,1,1,0,1
66393_0,,,,2,2,1,3
C(CC(C(CO)O)CC=CC=O)=O,,,5,1,1,0,1
66395_0,,,,2,2,1,3
C(CCCC=CC=O)=O,,,5,1,1,0,1
66397_0,,,,2,2,1,3
C(CCCC=CC=O)(O)=O,,,5,1,1,0,1
66399_0,,,,2,2,1,3
C(CC(CO)CC=CC=O)(O)=O,,,5,1,1,0,1
66401_0,,,,2,2,1,3
C(C(CC(CO)=O)CC=CC=O)=O,,,5,1,1,0,1
66403_0,,,,2,2,1,3
C(CC(C(CO)=O)CC=CC=O)=O,,,5,1,1,0,1
66405_0,,,,2,2,1,3
C1(CC(CO1)CC=CC=O)=O,,,5,1,1,0,1
66406_0,,,,2,2,1,3
66407_0,,,,2,2,1,3
66409_0,,,,2,2,1,3
C(C(C=C)C(C)CC=O)=O,,,5,1,1,0,1
66411_0,,,,2,2,1,3
C(C(C=C)(C(C)CC=O)O)=O,,,5,1,1,0,1
66413_0,,,,2,2,1,3
C(CC(C)C(C=CC=O)(CO)O)=O,,,5,1,1,0,1
66415_0,,,,2,2,1,3
C(CC(C)C(C(C=CC=O)O)O)=O,,,5,1,1,0,1
66417_0,,,,2,2,1,3
C(CC(C)C(C=CC(O)=O)O)=O,,,5,1,1,0,1
66419_0,,,,2,2,1,3
C(C(C(CC(C)CC=O)=O)(C=C)O)=O,,,5,1,1,0,1
66421_0,,,,2,2,1,3
C(C(C=C)(C(C(C)CC=O)O)O)=O,,,5,1,1,0,1
66423_0,,,,2,2,1,3
C(CC(C)C(C(C=CC=O)=O)O)=O,,,5,1,1,0,1
66425_0,,,,2,2,1,3
C(CC(C)C1C=CC(O1)=O)=O,,,5,1,1,0,1
66427_0,,,,2,2,1,3
C(CC(C)C1C(C=CO1)=O)=O,,,5,1,1,0,1
66429_0,,,,2,2,1,3
C(CC(C)C1(C)CC(C(O)O1)=O)=O,,,5,1,1,0,1
66431_0,,,,2,2,1,3
C(CC(C)CC1CC(C(O)O1)=O)=O,,,5,1,1,0,1
66433_0,,,,2,2,1,3
C(CC(C)C1(C(CC(C)O1)=O)O)=O,,,5,1,1,0,1
66435_0,,,,2,2,1,3
C(CC(C)C1C(C(O)OC1C)=O)=O,,,5,1,1,0,1
66437_0,,,,2,2,1,3
C(CC(C)C1C(CC(O)O1)O)=O,,,5,1,1,0,1
66439_0,,,,2,2,1,3
C(CC(C)C1(COC(C1)O)O)=O,,,5,1,1,0,1
66441_0,,,,2,2,1,3
C(CC(C)C1(CC(CO1)O)O)=O,,,5,1,1,0,1
66443_0,,,,2,2,1,3
C(CC(C)C1C(O)OCC1O)=O,,,5,1,1,0,1
66445_0,,,,2,2,1,3
C(CC(C)C1(C(C(CO1)O)=O)O)=O,,,5,1,1,0,1
66447_0,,,,2,2,1,3
C(CC(C)C1C(C(C(O)O1)=O)O)=O,,,5,1,1,0,1
66449_0,,,,2,2,1,3
C(CC(C)C1(C(C(O)OC1)=O)O)=O,,,5,1,1,0,1
66451_0,,,,2,2,1,3
C(CC(C)C1(C(O)OCC1)O)=O,,,5,1,1,0,1
66453_0,,,,2,2,1,3
C(CC(C)C1(C(CCO1)O)O)=O,,,5,1,1,0,1
66455_0,,,,2,2,1,3
C(CC(C)C1CC(C(O)O1)O)=O,,,5,1,1,0,1
66457_0,,,,2,2,1,3
C(CC(C)C1COC(C1O)O)=O,,,5,1,1,0,1
66459_0,,,,2,2,1,3
C1(C(CC(O)O1)(C(C)CC=O)O)=O,,,5,1,1,0,1
66461_0,,,,2,2,1,3
C(CC(C)C1(CC(C(O1)=O)O)O)=O,,,5,1,1,0,1
66463_0,,,,2,2,1,3
C(CC(C)C1C(O)OC(C1O)=O)=O,,,5,1,1,0,1
66465_0,,,,2,2,1,3
C1(CC(C(O)O1)(C(C)CC=O)O)=O,,,5,1,1,0,1
66467_0,,,,2,2,1,3
C1(CC(C(C(C)CC=O)(O)O1)O)=O,,,5,1,1,0,1
66469_0,,,,2,2,1,3
C1(C(C(C)CC=O)C(C(O)O1)O)=O,,,5,1,1,0,1
66471_0,,,,2,2,1,3
C(CC(C)C(CCC(C=O)=O)O)=O,,,5,1,1,0,1
66473_0,,,,2,2,1,3
C(CC(C)C(CO)CC(C=O)=O)=O,,,5,1,1,0,1
66475_0,,,,2,2,1,3
C(CC(C)C(C(C=O)=O)CCO)=O,,,5,1,1,0,1
66477_0,,,,2,2,1,3
C(C(CCC(C=O)=O)C(C)CC=O)=O,,,5,1,1,0,1
66479_0,,,,2,2,1,3
C(CC(C(C)CC=O)CC(C=O)=O)=O,,,5,1,1,0,1
66481_0,,,,2,2,1,3
C(CC(C)C(C(C=O)=O)CCC=O)=O,,,5,1,1,0,1
66483_0,,,,2,2,1,3
C(C(CO)(C(C)CC=O)O)=O,,,5,1,1,0,1
66485_0,,,,2,2,1,3
C(CC(C)C(C(C=O)O)O)=O,,,5,1,1,0,1
66487_0,,,,2,2,1,3
C(C(C(CO)O)(C(C)CC=O)O)=O,,,5,1,1,0,1
66489_0,,,,2,2,1,3
C(CC(C)C(C(C(C=O)O)O)O)=O,,,5,1,1,0,1
66491_0,,,,2,2,1,3
C(CC(C)C(CO)(C(C=O)O)O)=O,,,5,1,1,0,1
66493_0,,,,2,2,1,3
C(CC(C)CO)=O,,,5,1,1,0,1
66495_0,,,,2,2,1,3
C(CC(C)C(CO)O)=O,,,5,1,1,0,1
66496_0,,,,2,2,1,3
66498_0,,,,2,2,1,3
C(CC(C)C(C(CO)=O)O)=O,,,5,1,1,0,1
66500_0,,,,2,2,1,3
C(CC(C)C(C(C(CO)O)=O)O)=O,,,5,1,1,0,1
66502_0,,,,2,2,1,3
C(CC(C)C(C(C(CO)=O)O)O)=O,,,5,1,1,0,1
66504_0,,,,2,2,1,3
C(CC(C)C(C(CO)=O)(CO)O)=O,,,5,1,1,0,1
66506_0,,,,2,2,1,3
C(CC(C)C(CO)(CO)O)=O,,,5,1,1,0,1
66508_0,,,,2,2,1,3
C(CC(C)C(C(CO)O)O)=O,,,5,1,1,0,1
66510_0,,,,2,2,1,3
C(CC(C)C(CO)(C(CO)O)O)=O,,,5,1,1,0,1
66512_0,,,,2,2,1,3
C(CC(C)C(C(C(CO)O)O)O)=O,,,5,1,1,0,1
66514_0,,,,2,2,1,3
C(C(CO)(C(C)CC=O)O)(O)=O,,,5,1,1,0,1
66516_0,,,,2,2,1,3
C(CC(C)C(C(C(O)=O)O)O)=O,,,5,1,1,0,1
66518_0,,,,2,2,1,3
C(C(CO)(C(C(C)CC=O)O)O)=O,,,5,1,1,0,1
66519_0,,,,2,2,1,3
66520_0,,,,2,2,1,3
66522_0,,,,2,2,1,3
C(CC(C)C(CC(C=O)=O)O)=O,,,5,1,1,0,1
66523_0,,,,2,2,1,3
66524_0,,,,2,2,1,3
66525_0,,,,2,2,1,3
66526_0,,,,2,2,1,3
66528_0,,,,2,2,1,3
C(CC(C)C(C(CC=O)=O)O)=O,,,5,1,1,0,1
66530_0,,,,2,2,1,3
C(CC(C)C(C=O)(C(C)=O)O)=O,,,5,1,1,0,1
66531_0,,,,2,2,1,3
66533_0,,,,2,2,1,3
C(CC(C)CC=O)=O,,,5,1,1,0,1
66535_0,,,,2,2,1,3
C(CC(C)C1(C(O)OCC1O)O)=O,,,5,1,1,0,1
66537_0,,,,2,2,1,3
C(CC(C)C1(C(C(CO1)O)O)O)=O,,,5,1,1,0,1
66539_0,,,,2,2,1,3
C(CC(C)C1C(C(C(O)O1)O)O)=O,,,5,1,1,0,1
66541_0,,,,2,2,1,3
C(CC(C)C1(COC(C1O)O)O)=O,,,5,1,1,0,1
66542_0,,,,2,2,1,3
66544_0,,,,2,2,1,3
C(CC(C)C(C=O)C(C=O)(C)O)=O,,,5,1,1,0,1
66546_0,,,,2,2,1,3
C(CC(C)CC(C=O)(CC=O)O)=O,,,5,1,1,0,1
66548_0,,,,2,2,1,3
C(CC(C)C(C=O)C(C(C)=O)O)=O,,,5,1,1,0,1
66550_0,,,,2,2,1,3
C(C)(C(C(C)CC=O)(CC=O)O)=O,,,5,1,1,0,1
66552_0,,,,2,2,1,3
C(CC(C(CC(C)CC=O)=O)O)=O,,,5,1,1,0,1
66554_0,,,,2,2,1,3
C(CC(C)C(C)(CC(C=O)=O)O)=O,,,5,1,1,0,1
66556_0,,,,2,2,1,3
C(CC(C)CC(CC(C=O)=O)O)=O,,,5,1,1,0,1
66558_0,,,,2,2,1,3
C(CC(C)C(C(C=O)=O)C(C)O)=O,,,5,1,1,0,1
66560_0,,,,2,2,1,3
C(C(C(CC=O)O)C(C)CC=O)=O,,,5,1,1,0,1
66562_0,,,,2,2,1,3
C(CC(C(C)CC=O)(CC=O)O)=O,,,5,1,1,0,1
66564_0,,,,2,2,1,3
C(C(C=O)C(C)(C(C)CC=O)O)=O,,,5,1,1,0,1
66566_0,,,,2,2,1,3
C(C(C=O)C(CC(C)CC=O)O)=O,,,5,1,1,0,1
66568_0,,,,2,2,1,3
C(C(C=O)(C(C)CC=O)C(C)O)=O,,,5,1,1,0,1
66570_0,,,,2,2,1,3
C(C(C=O)C(C(C)CC=O)O)=O,,,5,1,1,0,1
66572_0,,,,2,2,1,3
C(C(C=O)(CO)C(C)CC=O)=O,,,5,1,1,0,1
66574_0,,,,2,2,1,3
C(C(C(C)CC=O)C(C)O)=O,,,5,1,1,0,1
66576_0,,,,2,2,1,3
C(CC(C)(C(C)CC=O)O)=O,,,5,1,1,0,1
66578_0,,,,2,2,1,3
C(CC(C)CC(CC=O)O)=O,,,5,1,1,0,1
66580_0,,,,2,2,1,3
C(C(C(C)O)(C(C)CC=O)O)=O,,,5,1,1,0,1
66582_0,,,,2,2,1,3
C(CC(C)C(C)(C(C=O)O)O)=O,,,5,1,1,0,1
66584_0,,,,2,2,1,3
C(CC(C)CC(C(C=O)O)O)=O,,,5,1,1,0,1
66586_0,,,,2,2,1,3
C(CC(C(C)CC=O)O)=O,,,5,1,1,0,1
66588_0,,,,2,2,1,3
C(C(CO)C(C)CC=O)=O,,,5,1,1,0,1
66590_0,,,,2,2,1,3
C(CC(C(C(C)CC=O)O)O)=O,,,5,1,1,0,1
66592_0,,,,2,2,1,3
C(CC(CO)(C(C)CC=O)O)=O,,,5,1,1,0,1
66594_0,,,,2,2,1,3
C(C(C(C)CC=O)C(CO)O)=O,,,5,1,1,0,1
66596_0,,,,2,2,1,3
C(C(C)(C(C)CC=O)O)(O)=O,,,5,1,1,0,1
66598_0,,,,2,2,1,3
C(CC(C)CC(C(O)=O)O)=O,,,5,1,1,0,1
66600_0,,,,2,2,1,3
C(C(CCO)(C(C)CC=O)O)(O)=O,,,5,1,1,0,1
66602_0,,,,2,2,1,3
C(CC(C)C(CC(C(O)=O)O)O)=O,,,5,1,1,0,1
66604_0,,,,2,2,1,3
C(CC(C)C(CO)C(C(O)=O)O)=O,,,5,1,1,0,1
66606_0,,,,2,2,1,3
C(CC(C)C(C(C=O)=O)O)=O,,,5,1,1,0,1
66608_0,,,,2,2,1,3
C(CC(C)C(C(C(C=O)=O)O)O)=O,,,5,1,1,0,1
66610_0,,,,2,2,1,3
C(CC(C)C(C(C=O)=O)(CO)O)=O,,,5,1,1,0,1
66612_0,,,,2,2,1,3
C(CC(C)C(C(C(C)=O)=O)O)=O,,,5,1,1,0,1
66614_0,,,,2,2,1,3
C(CC(C)CC(C(CO)=O)=O)=O,,,5,1,1,0,1
66616_0,,,,2,2,1,3
C(CC(C)CC(C(C=O)=O)O)=O,,,5,1,1,0,1
66618_0,,,,2,2,1,3
C(CC(C)C(C(C=O)=O)(C)O)=O,,,5,1,1,0,1
66620_0,,,,2,2,1,3
C(CC(C)C(C(CO)(CO)O)O)=O,,,5,1,1,0,1
66622_0,,,,2,2,1,3
C(CC(C)C(C(C)=O)O)=O,,,5,1,1,0,1
66624_0,,,,2,2,1,3
C(CC(C)CC(CO)=O)=O,,,5,1,1,0,1
66626_0,,,,2,2,1,3
C(CC(C)C(C(CCO)=O)O)=O,,,5,1,1,0,1
66628_0,,,,2,2,1,3
C(CC(C)C(CC(CO)=O)O)=O,,,5,1,1,0,1
66630_0,,,,2,2,1,3
C(CC(C)C(C(CO)=O)CO)=O,,,5,1,1,0,1
66632_0,,,,2,2,1,3
C(C(CCO)(C(C)CC=O)O)=O,,,5,1,1,0,1
66634_0,,,,2,2,1,3
C(CC(C)C(CC(C=O)O)O)=O,,,5,1,1,0,1
66636_0,,,,2,2,1,3
C(CC(C)C(CO)C(C=O)O)=O,,,5,1,1,0,1
66638_0,,,,2,2,1,3
C(CC(C)C(C(C)=O)(CO)O)=O,,,5,1,1,0,1
66640_0,,,,2,2,1,3
C(CC(C)C(C(C(C)=O)O)O)=O,,,5,1,1,0,1
66642_0,,,,2,2,1,3
C(CC(C)CC(C(CO)O)=O)=O,,,5,1,1,0,1
66644_0,,,,2,2,1,3
C(CC(C)C(C)O)=O,,,5,1,1,0,1
66646_0,,,,2,2,1,3
C(CC(C)CCO)=O,,,5,1,1,0,1
66648_0,,,,2,2,1,3
C(CC(C)CC(C(O)=O)=O)=O,,,5,1,1,0,1
66650_0,,,,2,2,1,3
C(C(C(O)=O)C(C)CC=O)=O,,,5,1,1,0,1
66652_0,,,,2,2,1,3
C(CC(C)C(CC(C(O)=O)=O)O)=O,,,5,1,1,0,1
66654_0,,,,2,2,1,3
C(CC(C)C(C(C(O)=O)=O)CO)=O,,,5,1,1,0,1
66656_0,,,,2,2,1,3
C(C(C(C)CC=O)(CC=O)O)(O)=O,,,5,1,1,0,1
66658_0,,,,2,2,1,3
C(CC(C)C(C=O)C(C(O)=O)O)=O,,,5,1,1,0,1
66660_0,,,,2,2,1,3
C(CC(C)C(C=O)(CC(O)=O)O)=O,,,5,1,1,0,1
66662_0,,,,2,2,1,3
C(C(C(C)CC=O)C(C=O)O)(O)=O,,,5,1,1,0,1
66664_0,,,,2,2,1,3
C(CC(C)C(C(O)=O)C(CO)=O)=O,,,5,1,1,0,1
66666_0,,,,2,2,1,3
C(CC(C)C(C(CC(O)=O)=O)O)=O,,,5,1,1,0,1
66668_0,,,,2,2,1,3
C(CC(C)C(C(O)=O)(C(C)=O)O)=O,,,5,1,1,0,1
66670_0,,,,2,2,1,3
C(C(C(CC(C)CC=O)=O)O)(O)=O,,,5,1,1,0,1
66672_0,,,,2,2,1,3
C(CC(C)CC(O)=O)=O,,,5,1,1,0,1
66674_0,,,,2,2,1,3
C(C(C(C)O)(C(C)CC=O)O)(O)=O,,,5,1,1,0,1
66676_0,,,,2,2,1,3
C(CC(C)C(C)(C(C(O)=O)O)O)=O,,,5,1,1,0,1
66678_0,,,,2,2,1,3
C(CC(C)CC(C(C(O)=O)O)O)=O,,,5,1,1,0,1
66680_0,,,,2,2,1,3
C(CC(C)C1C(C(CO1)O)=O)=O,,,5,1,1,0,1
66682_0,,,,2,2,1,3
C(CC(C)C1C(C(CO1)=O)O)=O,,,5,1,1,0,1
66684_0,,,,2,2,1,3
C(CC(C)C1(C(COC1)=O)O)=O,,,5,1,1,0,1
66686_0,,,,2,2,1,3
C(CC(C)C1(C(CCO1)=O)O)=O,,,5,1,1,0,1
66688_0,,,,2,2,1,3
C(CC(C)C1CC(C(O)O1)=O)=O,,,5,1,1,0,1
66690_0,,,,2,2,1,3
C(CC(C)C1C(C(O)OC1)=O)=O,,,5,1,1,0,1
66692_0,,,,2,2,1,3
C1(C(C(C)CC=O)C(CO1)O)=O,,,5,1,1,0,1
66694_0,,,,2,2,1,3
C1(CC(C(C(C)CC=O)O1)O)=O,,,5,1,1,0,1
66696_0,,,,2,2,1,3
C1(CC(CO1)(C(C)CC=O)O)=O,,,5,1,1,0,1
66698_0,,,,2,2,1,3
C(CC(C)C1C(COC1O)=O)=O,,,5,1,1,0,1
66700_0,,,,2,2,1,3
C(CC(C)C1(CC(CO1)=O)O)=O,,,5,1,1,0,1
66702_0,,,,2,2,1,3
C(CC(C)C1C(CC(O1)O)=O)=O,,,5,1,1,0,1
66704_0,,,,2,2,1,3
C1(C(C(CO1)O)(C(C)CC=O)O)=O,,,5,1,1,0,1
66706_0,,,,2,2,1,3
C(CC(C)C1C(C(C(O1)=O)O)O)=O,,,5,1,1,0,1
66708_0,,,,2,2,1,3
C(CC(C)C1(COC(C1O)=O)O)=O,,,5,1,1,0,1
66710_0,,,,2,2,1,3
C(CC(C)C(C=O)O)=O,,,5,1,1,0,1
66712_0,,,,2,2,1,3
C(C(C=C)C(C(CO)O)CC=O)=O,,,5,1,1,0,1
66714_0,,,,2,2,1,3
C(C(C=C)CCC=O)=O,,,5,1,1,0,1
66716_0,,,,2,2,1,3
C(C(C=C)CCC(O)=O)=O,,,5,1,1,0,1
66718_0,,,,2,2,1,3
C(C(C=C)C(CO)CC(O)=O)=O,,,5,1,1,0,1
66720_0,,,,2,2,1,3
C(C(C=C)C(C=O)CC(CO)=O)=O,,,5,1,1,0,1
66722_0,,,,2,2,1,3
C(C(C=C)C(C(CO)=O)CC=O)=O,,,5,1,1,0,1
66724_0,,,,2,2,1,3
C(C(C=C)C1COC(C1)=O)=O,,,5,1,1,0,1
66725_0,,,,2,2,1,3
66726_0,,,,2,2,1,3
66728_0,,,,2,2,1,3
C(C(C=C)(CCC=O)O)=O,,,5,1,1,0,1
66730_0,,,,2,2,1,3
C(C(C=C)(CCC(O)=O)O)=O,,,5,1,1,0,1
66732_0,,,,2,2,1,3
C(C(C=C)(C(CO)CC(O)=O)O)=O,,,5,1,1,0,1
66734_0,,,,2,2,1,3
C(C(C=C)(C1COC(C1)=O)O)=O,,,5,1,1,0,1
66735_0,,,,2,2,1,3
66736_0,,,,2,2,1,3
66738_0,,,,2,2,1,3
C(CCC(C=CC=O)(CO)O)=O,,,5,1,1,0,1
66740_0,,,,2,2,1,3
C(CCC(C=CC=O)(CO)O)(O)=O,,,5,1,1,0,1
66742_0,,,,2,2,1,3
C(CCC(C(C=CC=O)O)O)=O,,,5,1,1,0,1
66744_0,,,,2,2,1,3
C(CCC(C(C=CC=O)O)O)(O)=O,,,5,1,1,0,1
66745_0,,,,2,2,1,3
66747_0,,,,2,2,1,3
C(CC(C(CO)O)C(CO)O)=O,,,5,1,1,0,1
66749_0,,,,2,2,1,3
C(CC(C(CO)O)C(C(O)=O)O)=O,,,5,1,2,0,2
66750_0,,,,2,2,1,3
66751_0,,,,2,2,1,3
66752_0,,,,2,2,1,3
66753_0,,,,2,2,1,3
66755_0,,,,2,2,1,3
C(C(CO)C(C(CO)O)CC=O)=O,,,5,1,1,0,1
66756_0,,,,2,2,1,3
66757_0,,,,2,2,1,3
66759_0,,,,2,2,1,3
C(CC(C(CO)O)C(C)O)=O,,,5,1,1,0,1
66761_0,,,,2,2,1,3
C(CC(CCO)C(CO)O)=O,,,5,1,1,0,1
66763_0,,,,2,2,1,3
C(CC(C(CO)O)CC=O)(O)=O,,,5,1,1,0,1
66764_0,,,,2,2,1,3
66765_0,,,,2,2,1,3
66766_0,,,,2,2,1,3
66768_0,,,,2,2,1,3
C(CC(C(C(CO)O)O)C(C)O)=O,,,5,1,1,0,1
66770_0,,,,2,2,1,3
C(CC(CCO)C(C(CO)O)O)=O,,,5,1,1,0,1
66772_0,,,,2,2,1,3
C(CCC(C=CC(O)=O)O)=O,,,5,1,1,0,1
66773_0,,,,2,2,1,3
66775_0,,,,2,2,1,3
C(C(C(CCCC=O)=O)(C=C)O)=O,,,5,1,1,0,1
66776_0,,,,2,2,1,3
66778_0,,,,2,2,1,3
C(C(C(C=O)=C)(CCC=O)O)(O)=O,,,5,1,1,0,1
66780_0,,,,2,2,1,3
C(C(C=CC=O)(CCC=O)O)(O)=O,,,5,1,1,0,1
66782_0,,,,2,2,1,3
C(CCC(C(C=CC=O)=O)O)=O,,,5,1,1,0,1
66784_0,,,,2,2,1,3
C(CCC(C=CC(C(O)=O)=O)O)=O,,,5,1,1,0,1
66786_0,,,,2,2,1,3
C(CCC(C(C=CC(O)=O)=O)O)=O,,,5,1,1,0,1
66788_0,,,,2,2,1,3
C(C(C(C=C)=O)(CCC=O)O)(O)=O,,,5,1,1,0,1
66790_0,,,,2,2,1,3
C(CCC1C=CC(O1)=O)=O,,,5,1,1,0,1
66792_0,,,,2,2,1,3
C(CCC1C(C=CO1)=O)=O,,,5,1,1,0,1
66794_0,,,,2,2,1,3
C1(CC(C=O)OC1(CCC=O)O)=O,,,5,1,1,0,1
66796_0,,,,2,2,1,3
C(CCC1C(C(OC1C=O)O)=O)=O,,,5,1,1,0,1
66798_0,,,,2,2,1,3
C(CCC1(C=O)CC(C(O1)O)=O)=O,,,5,1,1,0,1
66800_0,,,,2,2,1,3
C(CCC1(CC(CO1)(CO)O)O)=O,,,5,1,1,0,1
66802_0,,,,2,2,1,3
C(CCC1C(O)OCC1(CO)O)=O,,,5,1,1,0,1
66804_0,,,,2,2,1,3
C(CCC1C(CO)(CC(O)O1)O)=O,,,5,1,1,0,1
66806_0,,,,2,2,1,3
C(CCC(C1(COC(C1)O)O)O)=O,,,5,1,1,0,1
66808_0,,,,2,2,1,3
C(CCC1(C)CC(C(O)O1)=O)=O,,,5,1,1,0,1
66810_0,,,,2,2,1,3
C(CCCC1CC(C(O)O1)=O)=O,,,5,1,1,0,1
66812_0,,,,2,2,1,3
C(CCC1(C(CC(C)O1)=O)O)=O,,,5,1,1,0,1
66814_0,,,,2,2,1,3
C(CCC1C(C(O)OC1C)=O)=O,,,5,1,1,0,1
66816_0,,,,2,2,1,3
C(CCC1C(CC(C=O)(O)O1)O)=O,,,5,1,1,0,1
66818_0,,,,2,2,1,3
C(CCC1(COC(C=O)(C1)O)O)=O,,,5,1,1,0,1
66820_0,,,,2,2,1,3
C(CCC1C(COC1(C=O)O)O)=O,,,5,1,1,0,1
66822_0,,,,2,2,1,3
C(C1(CCC=O)C(CC(O1)O)O)=O,,,5,1,1,0,1
66824_0,,,,2,2,1,3
C(CCC1C(C(C=O)OC1O)O)=O,,,5,1,1,0,1
66826_0,,,,2,2,1,3
C(CCC1(CC(OC1C=O)O)O)=O,,,5,1,1,0,1
66828_0,,,,2,2,1,3
C(CCC1(CC(C(C=O)O1)O)O)=O,,,5,1,1,0,1
66830_0,,,,2,2,1,3
C(C1C(CCC=O)OC(C1O)O)=O,,,5,1,1,0,1
66832_0,,,,2,2,1,3
C(C1COC(C1(CCC=O)O)O)=O,,,5,1,1,0,1
66834_0,,,,2,2,1,3
C(C1COC(CCC=O)(C1O)O)=O,,,5,1,1,0,1
66836_0,,,,2,2,1,3
C(C1(COC(C1O)O)CCC=O)=O,,,5,1,1,0,1
66838_0,,,,2,2,1,3
C(CCC1(CO)C(CC(O)O1)O)=O,,,5,1,1,0,1
66840_0,,,,2,2,1,3
C(CCC1(CC(O)OC1CO)O)=O,,,5,1,1,0,1
66842_0,,,,2,2,1,3
C(CCC(C1C(CC(O)O1)O)O)=O,,,5,1,1,0,1
66844_0,,,,2,2,1,3
C(CCC1(CC(C(CO)O1)O)O)=O,,,5,1,1,0,1
66846_0,,,,2,2,1,3
C(CCC1C(O)OC(CO)C1O)=O,,,5,1,1,0,1
66848_0,,,,2,2,1,3
C(CCC1C(CC(O)O1)O)=O,,,5,1,1,0,1
66850_0,,,,2,2,1,3
C(CCC1(COC(C1)O)O)=O,,,5,1,1,0,1
66852_0,,,,2,2,1,3
C(CCC1(CC(CO1)O)O)=O,,,5,1,1,0,1
66854_0,,,,2,2,1,3
C(CCC1C(O)OCC1O)=O,,,5,1,1,0,1
66855_0,,,,2,2,1,3
66857_0,,,,2,2,1,3
C(CCC1C(C(C(O)O1)=O)O)=O,,,5,1,1,0,1
66859_0,,,,2,2,1,3
C(CCC1(C(C(O)OC1)=O)O)=O,,,5,1,1,0,1
66861_0,,,,2,2,1,3
C(CCC1(C(O)OCC1)O)=O,,,5,1,1,0,1
66863_0,,,,2,2,1,3
C(CCC1(C(CCO1)O)O)=O,,,5,1,1,0,1
66865_0,,,,2,2,1,3
C(CCC1CC(C(O)O1)O)=O,,,5,1,1,0,1
66867_0,,,,2,2,1,3
C(CCC1COC(C1O)O)=O,,,5,1,1,0,1
66869_0,,,,2,2,1,3
C1(C(CCC=O)(CC(O)O1)O)=O,,,5,1,1,0,1
66871_0,,,,2,2,1,3
C(CCC1(CC(C(O1)=O)O)O)=O,,,5,1,1,0,1
66873_0,,,,2,2,1,3
C(CCC1C(O)OC(C1O)=O)=O,,,5,1,1,0,1
66875_0,,,,2,2,1,3
C1(CC(CCC=O)(C(O)O1)O)=O,,,5,1,1,0,1
66877_0,,,,2,2,1,3
C1(CC(C(CCC=O)(O)O1)O)=O,,,5,1,1,0,1
66879_0,,,,2,2,1,3
C1(C(CCC=O)C(C(O)O1)O)=O,,,5,1,1,0,1
66881_0,,,,2,2,1,3
C1(C(CCC=O)(C(C(O)O1)O)O)=O,,,5,1,1,0,1
66883_0,,,,2,2,1,3
C(CCC1(C(O)OC(C1O)=O)O)=O,,,5,1,1,0,1
66885_0,,,,2,2,1,3
C(CCC1(C(C(C(O1)=O)O)O)O)=O,,,5,1,1,0,1
66887_0,,,,2,2,1,3
C(C1(C(CCC=O)OC(C1)O)O)=O,,,5,1,1,0,1
66889_0,,,,2,2,1,3
C(C1(COC(C1)(CCC=O)O)O)=O,,,5,1,1,0,1
66891_0,,,,2,2,1,3
C(C1(COC(C1CCC=O)O)O)=O,,,5,1,1,0,1
66893_0,,,,2,2,1,3
C(CCC1(COC(CC1O)O)O)=O,,,5,1,1,0,1
66895_0,,,,2,2,1,3
C(CCC1(CC(O)OCC1O)O)=O,,,5,1,1,0,1
66897_0,,,,2,2,1,3
C(CCC1C(C(CC(O)O1)O)O)=O,,,5,1,1,0,1
66899_0,,,,2,2,1,3
C(CCC1(CC(C(CO1)O)O)O)=O,,,5,1,1,0,1
66901_0,,,,2,2,1,3
C(CCC1C(O)OCC(C1O)O)=O,,,5,1,1,0,1
66903_0,,,,2,2,1,3
C(CCC(C(C)O)CC(C=O)=O)=O,,,5,1,1,0,1
66905_0,,,,2,2,1,3
C(CCC(C(C=O)=O)CC(C)O)=O,,,5,1,1,0,1
66907_0,,,,2,2,1,3
C(CCC(C)(CCC(C=O)=O)O)=O,,,5,1,1,0,1
66909_0,,,,2,2,1,3
C(CCCC(CCC(C=O)=O)O)=O,,,5,1,1,0,1
66911_0,,,,2,2,1,3
C(C(CCC=O)(C(C)O)CC=O)=O,,,5,1,1,0,1
66913_0,,,,2,2,1,3
C(CCC(C=O)C(C=O)C(C)O)=O,,,5,1,1,0,1
66915_0,,,,2,2,1,3
C(CCC(C)(C(C=O)CC=O)O)=O,,,5,1,1,0,1
66917_0,,,,2,2,1,3
C(CCCC(C(C=O)CC=O)O)=O,,,5,1,1,0,1
66919_0,,,,2,2,1,3
C(CCC(CCO)CC(C=O)=O)=O,,,5,1,1,0,1
66921_0,,,,2,2,1,3
C(CCC(C(C=O)=O)CCCO)=O,,,5,1,1,0,1
66923_0,,,,2,2,1,3
C(CCC(CCCC(C=O)=O)O)=O,,,5,1,1,0,1
66925_0,,,,2,2,1,3
C(CCC(CCC(C=O)=O)CO)=O,,,5,1,1,0,1
66927_0,,,,2,2,1,3
C(C(CCC=O)(CCO)CC=O)=O,,,5,1,1,0,1
66929_0,,,,2,2,1,3
C(CCC(C=O)C(C=O)CCO)=O,,,5,1,1,0,1
66931_0,,,,2,2,1,3
C(CCC(CC(C=O)CC=O)O)=O,,,5,1,1,0,1
66933_0,,,,2,2,1,3
C(CCC(CO)C(C=O)CC=O)=O,,,5,1,1,0,1
66935_0,,,,2,2,1,3
C(CCC(CCC(C=O)=O)O)=O,,,5,1,1,0,1
66937_0,,,,2,2,1,3
C(CCC(CO)CC(C=O)=O)=O,,,5,1,1,0,1
66939_0,,,,2,2,1,3
C(CCC(C(C=O)=O)CCO)=O,,,5,1,1,0,1
66941_0,,,,2,2,1,3
C(C(CCC(C=O)=O)CCC=O)=O,,,5,1,1,0,1
66943_0,,,,2,2,1,3
C(CC(CCC=O)CC(C=O)=O)=O,,,5,1,1,0,1
66945_0,,,,2,2,1,3
C(CCC(C(C=O)=O)CCC=O)=O,,,5,1,1,0,1
66947_0,,,,2,2,1,3
C(C(CO)(CCC=O)O)=O,,,5,1,1,0,1
66948_0,,,,2,2,1,3
66950_0,,,,2,2,1,3
C(C(CCC=O)(C(CO)O)O)=O,,,5,1,1,0,1
66952_0,,,,2,2,1,3
C(CCC(C(C(C=O)O)O)O)=O,,,5,1,1,0,1
66953_0,,,,2,2,1,3
66954_0,,,,2,2,1,3
66956_0,,,,2,2,1,3
C(CCC(CO)O)=O,,,5,1,1,0,1
66957_0,,,,2,2,1,3
66958_0,,,,2,2,1,3
66959_0,,,,2,2,1,3
66960_0,,,,2,2,1,3
66962_0,,,,2,2,1,3
C(CCC(C(CO)=O)(CO)O)=O,,,5,1,1,0,1
66964_0,,,,2,2,1,3
C(CCC(CO)(CO)O)=O,,,5,1,1,0,1
66966_0,,,,2,2,1,3
C(CCC(C(CO)O)O)=O,,,5,1,1,0,1
66968_0,,,,2,2,1,3
C(CCC(CO)(C(CO)O)O)=O,,,5,1,1,0,1
66970_0,,,,2,2,1,3
C(CCC(C(C(CO)O)O)O)=O,,,5,1,1,0,1
66971_0,,,,2,2,1,3
66972_0,,,,2,2,1,3
66973_0,,,,2,2,1,3
66975_0,,,,2,2,1,3
C(CCC(C(C(C(O)=O)O)O)O)=O,,,5,1,1,0,1
66976_0,,,,2,2,1,3
66977_0,,,,2,2,1,3
66978_0,,,,2,2,1,3
66979_0,,,,2,2,1,3
66980_0,,,,2,2,1,3
66981_0,,,,2,2,1,3
66982_0,,,,2,2,1,3
66983_0,,,,2,2,1,3
66984_0,,,,2,2,1,3
66986_0,,,,2,2,1,3
C(CCC(C(CC=O)=O)O)=O,,,5,1,1,0,1
66988_0,,,,2,2,1,3
C(CCC(C=O)(C(C)=O)O)=O,,,5,1,1,0,1
66989_0,,,,2,2,1,3
66991_0,,,,2,2,1,3
C(CCCC=O)=O,,,5,1,1,0,1
66993_0,,,,2,2,1,3
C(CCC1(C(O)OCC1O)O)=O,,,5,1,1,0,1
66994_0,,,,2,2,1,3
66996_0,,,,2,2,1,3
C(CCC1C(C(C(O)O1)O)O)=O,,,5,1,1,0,1
66998_0,,,,2,2,1,3
C(CCC1(COC(C1O)O)O)=O,,,5,1,1,0,1
66999_0,,,,2,2,1,3
67000_0,,,,2,2,1,3
67002_0,,,,2,2,1,3
C(CCC(C=O)(C=O)C(C=O)O)=O,,,5,1,1,0,1
67003_0,,,,2,2,1,3
67004_0,,,,2,2,1,3
67006_0,,,,2,2,1,3
C(C(CCC=O)C(CO)(CO)O)=O,,,5,1,1,0,1
67008_0,,,,2,2,1,3
C(CCC(C(CO)(CC=O)O)O)=O,,,5,1,1,0,1
67010_0,,,,2,2,1,3
C(CCC(C)(C(C(CO)=O)O)O)=O,,,5,1,1,0,1
67012_0,,,,2,2,1,3
C(CCCC(C(C(CO)=O)O)O)=O,,,5,1,1,0,1
67014_0,,,,2,2,1,3
C(CCC(C(CO)=O)(C(C)O)O)=O,,,5,1,1,0,1
67016_0,,,,2,2,1,3
C(CCC(C(C(C(C)O)O)=O)O)=O,,,5,1,1,0,1
67018_0,,,,2,2,1,3
C(CCC(C=O)C(C=O)(C)O)=O,,,5,1,1,0,1
67019_0,,,,2,2,1,3
67020_0,,,,2,2,1,3
67021_0,,,,2,2,1,3
67023_0,,,,2,2,1,3
C(CCC(C=O)C(C(C)=O)O)=O,,,5,1,1,0,1
67024_0,,,,2,2,1,3
67025_0,,,,2,2,1,3
67026_0,,,,2,2,1,3
67027_0,,,,2,2,1,3
67028_0,,,,2,2,1,3
67030_0,,,,2,2,1,3
C(CCC(C)(CC(C=O)=O)O)=O,,,5,1,1,0,1
67032_0,,,,2,2,1,3
C(CCCC(CC(C=O)=O)O)=O,,,5,1,1,0,1
67033_0,,,,2,2,1,3
67035_0,,,,2,2,1,3
C(CCC(C(CC(C=O)=O)O)O)=O,,,5,1,1,0,1
67036_0,,,,2,2,1,3
67037_0,,,,2,2,1,3
67039_0,,,,2,2,1,3
C(C(CCC=O)C(CC=O)O)=O,,,5,1,1,0,1
67040_0,,,,2,2,1,3
67042_0,,,,2,2,1,3
C(C(C(CC=O)O)(CCC=O)O)=O,,,5,1,1,0,1
67044_0,,,,2,2,1,3
C(CCC(C=O)C(C(C=O)O)O)=O,,,5,1,1,0,1
67045_0,,,,2,2,1,3
67047_0,,,,2,2,1,3
C(C(C=O)C(C)(CCC=O)O)=O,,,5,1,1,0,1
67049_0,,,,2,2,1,3
C(C(C=O)C(CCCC=O)O)=O,,,5,1,1,0,1
67051_0,,,,2,2,1,3
C(C(C=O)(CCC=O)C(C)O)=O,,,5,1,1,0,1
67052_0,,,,2,2,1,3
67054_0,,,,2,2,1,3
C(C(C=O)(CCC=O)CO)=O,,,5,1,1,0,1
67056_0,,,,2,2,1,3
C(C(C=O)C(C(CCC=O)O)O)=O,,,5,1,1,0,1
67057_0,,,,2,2,1,3
67059_0,,,,2,2,1,3
C(C(C=O)(CCC=O)C(CO)O)=O,,,5,1,1,0,1
67060_0,,,,2,2,1,3
67062_0,,,,2,2,1,3
C(CCC(C(C=O)=O)(CO)CO)=O,,,5,1,1,0,1
67063_0,,,,2,2,1,3
67064_0,,,,2,2,1,3
67066_0,,,,2,2,1,3
C(C(CO)(CCC=O)C(C=O)O)=O,,,5,1,1,0,1
67067_0,,,,2,2,1,3
67069_0,,,,2,2,1,3
C(CCC(C=O)(C(CO)=O)CO)=O,,,5,1,1,0,1
67071_0,,,,2,2,1,3
C(CCC(C(C(C=O)CO)=O)O)=O,,,5,1,1,0,1
67072_0,,,,2,2,1,3
67074_0,,,,2,2,1,3
C(CCC(C=O)C(C(CO)O)=O)=O,,,5,1,2,0,2
67076_0,,,,2,2,1,3
C(C(CO)(CCC=O)O)(CC=O)=O,,,5,1,1,0,1
67077_0,,,,2,2,1,3
67079_0,,,,2,2,1,3
C(C(C(CCO)=O)(CCC=O)O)=O,,,5,1,1,0,1
67081_0,,,,2,2,1,3
C(C(CO)CCC=O)(C(C=O)O)=O,,,5,1,1,0,1
67083_0,,,,2,2,1,3
C(C(CCC=O)C(C)O)=O,,,5,1,1,0,1
67085_0,,,,2,2,1,3
C(CCC(C)(CC=O)O)=O,,,5,1,1,0,1
67087_0,,,,2,2,1,3
C(CCCC(CC=O)O)=O,,,5,1,1,0,1
67089_0,,,,2,2,1,3
C(C(CCC=O)(C(C)O)O)=O,,,5,1,1,0,1
67091_0,,,,2,2,1,3
C(CCC(C)(C(C=O)O)O)=O,,,5,1,1,0,1
67093_0,,,,2,2,1,3
C(CCCC(C(C=O)O)O)=O,,,5,1,1,0,1
67095_0,,,,2,2,1,3
C(CC(C(CCC=O)(CO)O)O)=O,,,5,1,1,0,1
67096_0,,,,2,2,1,3
67098_0,,,,2,2,1,3
C(CCC(C(C(CC=O)O)O)O)=O,,,5,1,1,0,1
67100_0,,,,2,2,1,3
C(C(CCC=O)C(C(CO)O)O)=O,,,5,1,1,0,1
67101_0,,,,2,2,1,3
67103_0,,,,2,2,1,3
C(C(CCC=O)CO)=O,,,5,1,1,0,1
67105_0,,,,2,2,1,3
C(CCC(C(CC=O)O)O)=O,,,5,1,1,0,1
67106_0,,,,2,2,1,3
67108_0,,,,2,2,1,3
C(C(CCC=O)C(CO)O)=O,,,5,1,1,0,1
67109_0,,,,2,2,1,3
67110_0,,,,2,2,1,3
67112_0,,,,2,2,1,3
C(C(CCC=O)(CCO)O)(O)=O,,,5,1,1,0,1
67114_0,,,,2,2,1,3
C(CCC(CC(C(O)=O)O)O)=O,,,5,1,1,0,1
67116_0,,,,2,2,1,3
C(CCC(CO)C(C(O)=O)O)=O,,,5,1,1,0,1
67117_0,,,,2,2,1,3
67118_0,,,,2,2,1,3
67119_0,,,,2,2,1,3
67121_0,,,,2,2,1,3
C(CCC(C(C(C)=O)=O)O)=O,,,5,1,1,0,1
67123_0,,,,2,2,1,3
C(CCCC(C(CO)=O)=O)=O,,,5,1,1,0,1
67125_0,,,,2,2,1,3
C(CCCC(C(C=O)=O)O)=O,,,5,1,1,0,1
67127_0,,,,2,2,1,3
C(CCC(C(C=O)=O)(C)O)=O,,,5,1,1,0,1
67129_0,,,,2,2,1,3
C(CCC(C(CO)(CO)O)O)=O,,,5,1,1,0,1
67131_0,,,,2,2,1,3
C(CCC(C(C)=O)O)=O,,,5,1,1,0,1
67132_0,,,,2,2,1,3
67134_0,,,,2,2,1,3
C(CCC(C(CCO)=O)O)=O,,,5,1,1,0,1
67135_0,,,,2,2,1,3
67137_0,,,,2,2,1,3
C(CCC(C(CO)=O)CO)=O,,,5,1,1,0,1
67139_0,,,,2,2,1,3
C(C(CCC=O)(CCO)O)=O,,,5,1,1,0,1
67141_0,,,,2,2,1,3
C(CCC(CC(C=O)O)O)=O,,,5,1,1,0,1
67143_0,,,,2,2,1,3
C(CCC(CO)C(C=O)O)=O,,,5,1,1,0,1
67145_0,,,,2,2,1,3
C(CCC(C(C)=O)(CO)O)=O,,,5,1,1,0,1
67146_0,,,,2,2,1,3
67148_0,,,,2,2,1,3
C(CCCC(C(CO)O)=O)=O,,,5,1,1,0,1
67150_0,,,,2,2,1,3
C(CCC(C)O)=O,,,5,1,1,0,1
67152_0,,,,2,2,1,3
C(CCCCO)=O,,,5,1,1,0,1
67153_0,,,,2,2,1,3
67154_0,,,,2,2,1,3
67156_0,,,,2,2,1,3
C(C(C(O)=O)CCC=O)=O,,,5,1,1,0,1
67157_0,,,,2,2,1,3
67159_0,,,,2,2,1,3
C(CCC(C(C(O)=O)=O)CO)=O,,,5,1,1,0,1
67160_0,,,,2,2,1,3
67162_0,,,,2,2,1,3
C(CCC(C=O)C(C(O)=O)O)=O,,,5,1,2,0,2
67164_0,,,,2,2,1,3
C(CCC(C=O)(CC(O)=O)O)=O,,,5,1,1,0,1
67166_0,,,,2,2,1,3
C(C(CCC=O)C(C=O)O)(O)=O,,,5,1,1,0,1
67168_0,,,,2,2,1,3
C(CCC(C(O)=O)C(CO)=O)=O,,,5,1,1,0,1
67170_0,,,,2,2,1,3
C(CCC(C(CC(O)=O)=O)O)=O,,,5,1,1,0,1
67172_0,,,,2,2,1,3
C(CCC(C(O)=O)(C(C)=O)O)=O,,,5,1,1,0,1
67174_0,,,,2,2,1,3
C(C(C(CCCC=O)=O)O)(O)=O,,,5,1,2,0,2
67176_0,,,,2,2,1,3
C(CCCC(O)=O)=O,,,5,1,2,0,2
67177_0,,,,2,2,1,3
67179_0,,,,2,2,1,3
C(C(C(CCCC=O)=O)(CO)O)=O,,,5,1,2,0,2
67180_0,,,,2,2,1,3
67182_0,,,,2,2,1,3
C(C(CO)(C(C)(CCC=O)O)O)=O,,,5,1,1,0,1
67184_0,,,,2,2,1,3
C(C(CO)(C(CCCC=O)O)O)=O,,,5,1,1,0,1
67185_0,,,,2,2,1,3
67186_0,,,,2,2,1,3
67187_0,,,,2,2,1,3
67189_0,,,,2,2,1,3
C(CCC(C=O)C(C=O)(CO)O)=O,,,5,1,2,0,2
67191_0,,,,2,2,1,3
C(C(CCC=O)(C(C)O)O)(O)=O,,,5,1,1,0,1
67193_0,,,,2,2,1,3
C(CCC(C)(C(C(O)=O)O)O)=O,,,5,1,1,0,1
67195_0,,,,2,2,1,3
C(CCCC(C(C(O)=O)O)O)=O,,,5,1,1,0,1
67196_0,,,,2,2,1,3
67198_0,,,,2,2,1,3
C(CO)(C(CCC=O)C(C=O)O)=O,,,5,1,1,0,1
67200_0,,,,2,2,1,3
C(CC(C=O)O)(C(CCC=O)O)=O,,,5,1,1,0,1
67202_0,,,,2,2,1,3
C(CCC1C(C(CO1)O)=O)=O,,,5,1,1,0,1
67204_0,,,,2,2,1,3
C(CCC1C(C(CO1)=O)O)=O,,,5,1,1,0,1
67206_0,,,,2,2,1,3
C(CCC1(C(COC1)=O)O)=O,,,5,1,1,0,1
67208_0,,,,2,2,1,3
C(CCC1(C(CCO1)=O)O)=O,,,5,1,1,0,1
67210_0,,,,2,2,1,3
C(CCC1CC(C(O)O1)=O)=O,,,5,1,1,0,1
67212_0,,,,2,2,1,3
C(CCC1C(C(O)OC1)=O)=O,,,5,1,1,0,1
67214_0,,,,2,2,1,3
C1(C(CCC=O)C(CO1)O)=O,,,5,1,1,0,1
67216_0,,,,2,2,1,3
C1(CC(C(CCC=O)O1)O)=O,,,5,1,1,0,1
67218_0,,,,2,2,1,3
C1(CC(CO1)(CCC=O)O)=O,,,5,1,1,0,1
67220_0,,,,2,2,1,3
C(CCC1C(COC1O)=O)=O,,,5,1,1,0,1
67222_0,,,,2,2,1,3
C(CCC1(CC(CO1)=O)O)=O,,,5,1,1,0,1
67224_0,,,,2,2,1,3
C(CCC1C(CC(O1)O)=O)=O,,,5,1,1,0,1
67226_0,,,,2,2,1,3
C1(C(CCC=O)(C(CO1)O)O)=O,,,5,1,1,0,1
67228_0,,,,2,2,1,3
C(CCC1C(C(C(O1)=O)O)O)=O,,,5,1,1,0,1
67230_0,,,,2,2,1,3
C(CCC1(COC(C1O)=O)O)=O,,,5,1,1,0,1
67231_0,,,,2,2,1,3
67233_0,,,,2,2,1,3
C(CCC(C=CC(O)=O)O)(O)=O,,,5,1,1,0,1
67235_0,,,,2,2,1,3
C(C(C=C)(C(CCC(O)=O)O)O)=O,,,5,1,1,0,1
67237_0,,,,2,2,1,3
C(CCC(C(C=CC=O)=O)O)(O)=O,,,5,1,1,0,1
67239_0,,,,2,2,1,3
C(CCC1C=CC(O1)=O)(O)=O,,,5,1,1,0,1
67241_0,,,,2,2,1,3
C(CCC1C(C=CO1)=O)(O)=O,,,5,1,1,0,1
67243_0,,,,2,2,1,3
C(CCC1(C)CC(C(O)O1)=O)(O)=O,,,5,1,1,0,1
67245_0,,,,2,2,1,3
C(CCCC1CC(C(O)O1)=O)(O)=O,,,5,1,1,0,1
67247_0,,,,2,2,1,3
C(CCC1(C(CC(C)O1)=O)O)(O)=O,,,5,1,1,0,1
67249_0,,,,2,2,1,3
C(CCC1C(C(O)OC1C)=O)(O)=O,,,5,1,1,0,1
67251_0,,,,2,2,1,3
C(CCC1C(CC(O)O1)O)(O)=O,,,5,1,1,0,1
67253_0,,,,2,2,1,3
C(CCC1(COC(C1)O)O)(O)=O,,,5,1,1,0,1
67255_0,,,,2,2,1,3
C(CCC1(CC(CO1)O)O)(O)=O,,,5,1,1,0,1
67257_0,,,,2,2,1,3
C(CCC1C(O)OCC1O)(O)=O,,,5,1,1,0,1
67259_0,,,,2,2,1,3
C(CCC1(C(C(CO1)O)=O)O)(O)=O,,,5,1,1,0,1
67261_0,,,,2,2,1,3
C(CCC1C(C(C(O)O1)=O)O)(O)=O,,,5,1,1,0,1
67263_0,,,,2,2,1,3
C(CCC1(C(C(O)OC1)=O)O)(O)=O,,,5,1,1,0,1
67265_0,,,,2,2,1,3
C(CCC1(C(O)OCC1)O)(O)=O,,,5,1,1,0,1
67267_0,,,,2,2,1,3
C(CCC1(C(CCO1)O)O)(O)=O,,,5,1,1,0,1
67269_0,,,,2,2,1,3
C(CCC1CC(C(O)O1)O)(O)=O,,,5,1,1,0,1
67271_0,,,,2,2,1,3
C(CCC1COC(C1O)O)(O)=O,,,5,1,1,0,1
67273_0,,,,2,2,1,3
C1(C(CCC(O)=O)(CC(O)O1)O)=O,,,5,1,1,0,1
67275_0,,,,2,2,1,3
C(CCC1(CC(C(O1)=O)O)O)(O)=O,,,5,1,1,0,1
67277_0,,,,2,2,1,3
C(CCC1C(O)OC(C1O)=O)(O)=O,,,5,1,1,0,1
67279_0,,,,2,2,1,3
C1(CC(CCC(O)=O)(C(O)O1)O)=O,,,5,1,1,0,1
67281_0,,,,2,2,1,3
C1(CC(C(CCC(O)=O)(O)O1)O)=O,,,5,1,1,0,1
67283_0,,,,2,2,1,3
C1(C(CCC(O)=O)C(C(O)O1)O)=O,,,5,1,1,0,1
67285_0,,,,2,2,1,3
C(CCC(CCC(C=O)=O)O)(O)=O,,,5,1,1,0,1
67287_0,,,,2,2,1,3
C(CCC(CO)CC(C=O)=O)(O)=O,,,5,1,1,0,1
67289_0,,,,2,2,1,3
C(CCC(C(C=O)=O)CCO)(O)=O,,,5,1,1,0,1
67291_0,,,,2,2,1,3
C(C(CO)(CCC(O)=O)O)=O,,,5,1,1,0,1
67292_0,,,,2,2,1,3
67294_0,,,,2,2,1,3
C(C(CCC(O)=O)(C(CO)O)O)=O,,,5,1,1,0,1
67296_0,,,,2,2,1,3
C(CCC(C(C(C=O)O)O)O)(O)=O,,,5,1,1,0,1
67298_0,,,,2,2,1,3
C(CCC(CO)(C(C=O)O)O)(O)=O,,,5,1,1,0,1
67300_0,,,,2,2,1,3
C(CCCO)(O)=O,,,5,1,1,0,1
67302_0,,,,2,2,1,3
C(CCC(CO)O)(O)=O,,,5,1,1,0,1
67304_0,,,,2,2,1,3
C(CCC(C(O)=O)O)(O)=O,,,5,1,1,0,1
67306_0,,,,2,2,1,3
C(CCC(C(CO)=O)O)(O)=O,,,5,1,1,0,1
67308_0,,,,2,2,1,3
C(CCC(C(C(CO)O)=O)O)(O)=O,,,5,1,1,0,1
67310_0,,,,2,2,1,3
C(CCC(C(C(CO)=O)O)O)(O)=O,,,5,1,1,0,1
67312_0,,,,2,2,1,3
C(CCC(C(CO)=O)(CO)O)(O)=O,,,5,1,1,0,1
67314_0,,,,2,2,1,3
C(CCC(CO)(CO)O)(O)=O,,,5,1,1,0,1
67316_0,,,,2,2,1,3
C(CCC(C(CO)O)O)(O)=O,,,5,1,1,0,1
67318_0,,,,2,2,1,3
C(CCC(CO)(C(CO)O)O)(O)=O,,,5,1,1,0,1
67320_0,,,,2,2,1,3
C(CCC(C(C(CO)O)O)O)(O)=O,,,5,1,1,0,1
67322_0,,,,2,2,1,3
C(C(CO)(CCC(O)=O)O)(O)=O,,,5,1,1,0,1
67324_0,,,,2,2,1,3
C(CCC(C(C(O)=O)O)O)(O)=O,,,5,1,1,0,1
67326_0,,,,2,2,1,3
C(C(CO)(C(CCC(O)=O)O)O)=O,,,5,1,1,0,1
67327_0,,,,2,2,1,3
67328_0,,,,2,2,1,3
67330_0,,,,2,2,1,3
C(CCC(CC(C=O)=O)O)(O)=O,,,5,1,1,0,1
67331_0,,,,2,2,1,3
67333_0,,,,2,2,1,3
C(CCC(C=O)(CC=O)O)(O)=O,,,5,1,1,0,1
67334_0,,,,2,2,1,3
67335_0,,,,2,2,1,3
67337_0,,,,2,2,1,3
C(CCC(C(CC=O)=O)O)(O)=O,,,5,1,1,0,1
67339_0,,,,2,2,1,3
C(CCC(C=O)(C(C)=O)O)(O)=O,,,5,1,1,0,1
67340_0,,,,2,2,1,3
67341_0,,,,2,2,1,3
67343_0,,,,2,2,1,3
C(CCC1(C(O)OCC1O)O)(O)=O,,,5,1,1,0,1
67345_0,,,,2,2,1,3
C(CCC1(C(C(CO1)O)O)O)(O)=O,,,5,1,1,0,1
67347_0,,,,2,2,1,3
C(CCC1C(C(C(O)O1)O)O)(O)=O,,,5,1,1,0,1
67349_0,,,,2,2,1,3
C(CCC1(COC(C1O)O)O)(O)=O,,,5,1,1,0,1
67351_0,,,,2,2,1,3
C(CCC(C=O)(C(C=O)O)O)(O)=O,,,5,1,1,0,1
67353_0,,,,2,2,1,3
C(CCC(C=O)C(C=O)(C)O)(O)=O,,,5,1,1,0,1
67354_0,,,,2,2,1,3
67356_0,,,,2,2,1,3
C(CCC(C=O)C(C(C)=O)O)(O)=O,,,5,1,1,0,1
67358_0,,,,2,2,1,3
C(C)(C(CCC(O)=O)(CC=O)O)=O,,,5,1,1,0,1
67359_0,,,,2,2,1,3
67361_0,,,,2,2,1,3
C(CCC(C)(CC(C=O)=O)O)(O)=O,,,5,1,1,0,1
67363_0,,,,2,2,1,3
C(CCCC(CC(C=O)=O)O)(O)=O,,,5,1,1,0,1
67364_0,,,,2,2,1,3
67366_0,,,,2,2,1,3
C(C(CCC(O)=O)C(CC=O)O)=O,,,5,1,1,0,1
67368_0,,,,2,2,1,3
C(CCC(CC=O)(CC=O)O)(O)=O,,,5,1,1,0,1
67370_0,,,,2,2,1,3
C(C(C=O)C(C)(CCC(O)=O)O)=O,,,5,1,1,0,1
67372_0,,,,2,2,1,3
C(C(C=O)C(CCCC(O)=O)O)=O,,,5,1,1,0,1
67374_0,,,,2,2,1,3
C(C(C=O)(CCC(O)=O)C(C)O)=O,,,5,1,1,0,1
67376_0,,,,2,2,1,3
C(C(C=O)C(CCC(O)=O)O)=O,,,5,1,1,0,1
67378_0,,,,2,2,1,3
C(C(C=O)(CCC(O)=O)CO)=O,,,5,1,1,0,1
67380_0,,,,2,2,1,3
C(C(CCC(O)=O)C(C)O)=O,,,5,1,1,0,1
67382_0,,,,2,2,1,3
C(CCC(C)(CC=O)O)(O)=O,,,5,1,1,0,1
67384_0,,,,2,2,1,3
C(CCCC(CC=O)O)(O)=O,,,5,1,1,0,1
67386_0,,,,2,2,1,3
C(C(CCC(O)=O)(C(C)O)O)=O,,,5,1,1,0,1
67388_0,,,,2,2,1,3
C(CCC(C)(C(C=O)O)O)(O)=O,,,5,1,1,0,1
67390_0,,,,2,2,1,3
C(CCCC(C(C=O)O)O)(O)=O,,,5,1,1,0,1
67392_0,,,,2,2,1,3
C(CCC(CC=O)O)(O)=O,,,5,1,1,0,1
67394_0,,,,2,2,1,3
C(C(CCC(O)=O)CO)=O,,,5,1,1,0,1
67396_0,,,,2,2,1,3
C(CCC(C(CC=O)O)O)(O)=O,,,5,1,1,0,1
67398_0,,,,2,2,1,3
C(CCC(CO)(CC=O)O)(O)=O,,,5,1,1,0,1
67400_0,,,,2,2,1,3
C(C(CCC(O)=O)C(CO)O)=O,,,5,1,1,0,1
67402_0,,,,2,2,1,3
C(C(C)(CCC(O)=O)O)(O)=O,,,5,1,1,0,1
67403_0,,,,2,2,1,3
67405_0,,,,2,2,1,3
C(C(CCC(O)=O)(CCO)O)(O)=O,,,5,1,1,0,1
67407_0,,,,2,2,1,3
C(CCC(CC(C(O)=O)O)O)(O)=O,,,5,1,1,0,1
67409_0,,,,2,2,1,3
C(CCC(CO)C(C(O)=O)O)(O)=O,,,5,1,1,0,1
67411_0,,,,2,2,1,3
C(CCC(C(C=O)=O)O)(O)=O,,,5,1,1,0,1
67413_0,,,,2,2,1,3
C(CCC(C(C(C=O)=O)O)O)(O)=O,,,5,1,1,0,1
67415_0,,,,2,2,1,3
C(CCC(C(C=O)=O)(CO)O)(O)=O,,,5,1,1,0,1
67417_0,,,,2,2,1,3
C(CCC(C(C(C)=O)=O)O)(O)=O,,,5,1,1,0,1
67419_0,,,,2,2,1,3
C(CCCC(C(CO)=O)=O)(O)=O,,,5,1,1,0,1
67421_0,,,,2,2,1,3
C(CCCC(C(C=O)=O)O)(O)=O,,,5,1,1,0,1
67423_0,,,,2,2,1,3
C(CCC(C(C=O)=O)(C)O)(O)=O,,,5,1,1,0,1
67425_0,,,,2,2,1,3
C(CCC(C(CO)(CO)O)O)(O)=O,,,5,1,1,0,1
67427_0,,,,2,2,1,3
C(CCC(C(C)=O)O)(O)=O,,,5,1,1,0,1
67428_0,,,,2,2,1,3
67430_0,,,,2,2,1,3
C(CCC(C(CCO)=O)O)(O)=O,,,5,1,1,0,1
67432_0,,,,2,2,1,3
C(CCC(CC(CO)=O)O)(O)=O,,,5,1,1,0,1
67434_0,,,,2,2,1,3
C(CCC(C(CO)=O)CO)(O)=O,,,5,1,1,0,1
67436_0,,,,2,2,1,3
C(C(CCC(O)=O)(CCO)O)=O,,,5,1,1,0,1
67438_0,,,,2,2,1,3
C(CCC(CC(C=O)O)O)(O)=O,,,5,1,1,0,1
67440_0,,,,2,2,1,3
C(CCC(CO)C(C=O)O)(O)=O,,,5,1,1,0,1
67442_0,,,,2,2,1,3
C(CCC(C(C)=O)(CO)O)(O)=O,,,5,1,1,0,1
67444_0,,,,2,2,1,3
C(CCC(C(C(C)=O)O)O)(O)=O,,,5,1,1,0,1
67446_0,,,,2,2,1,3
C(CCCC(C(CO)O)=O)(O)=O,,,5,1,1,0,1
67448_0,,,,2,2,1,3
C(CCC(C)O)(O)=O,,,5,1,1,0,1
67450_0,,,,2,2,1,3
C(CCCCO)(O)=O,,,5,1,1,0,1
67451_0,,,,2,2,1,3
67453_0,,,,2,2,1,3
C(C(C(O)=O)CCC(O)=O)=O,,,5,1,1,0,1
67455_0,,,,2,2,1,3
C(CCC(CC(C(O)=O)=O)O)(O)=O,,,5,1,1,0,1
67457_0,,,,2,2,1,3
C(CCC(C(C(O)=O)=O)CO)(O)=O,,,5,1,1,0,1
67459_0,,,,2,2,1,3
C(CCC(C(O)=O)(CC=O)O)(O)=O,,,5,1,1,0,1
67461_0,,,,2,2,1,3
C(CCC(C=O)C(C(O)=O)O)(O)=O,,,5,1,2,0,2
67463_0,,,,2,2,1,3
C(CCC(C=O)(CC(O)=O)O)(O)=O,,,5,1,1,0,1
67465_0,,,,2,2,1,3
C(CCC(C(O)=O)C(C=O)O)(O)=O,,,5,1,1,0,1
67467_0,,,,2,2,1,3
C(CCC(C(O)=O)C(CO)=O)(O)=O,,,5,1,1,0,1
67469_0,,,,2,2,1,3
C(CCC(C(CC(O)=O)=O)O)(O)=O,,,5,1,1,0,1
67471_0,,,,2,2,1,3
C(CCC(C(O)=O)(C(C)=O)O)(O)=O,,,5,1,1,0,1
67473_0,,,,2,2,1,3
C(C(C(CCCC(O)=O)=O)O)(O)=O,,,5,1,2,0,2
67475_0,,,,2,2,1,3
C(CCCC(O)=O)(O)=O,,,5,1,1,0,1
67477_0,,,,2,2,1,3
C(C(CCC(O)=O)(C(C)O)O)(O)=O,,,5,1,1,0,1
67479_0,,,,2,2,1,3
C(CCC(C)(C(C(O)=O)O)O)(O)=O,,,5,1,1,0,1
67481_0,,,,2,2,1,3
C(CCCC(C(C(O)=O)O)O)(O)=O,,,5,1,1,0,1
67483_0,,,,2,2,1,3
C(CCC1C(C(CO1)O)=O)(O)=O,,,5,1,1,0,1
67485_0,,,,2,2,1,3
C(CCC1C(C(CO1)=O)O)(O)=O,,,5,1,1,0,1
67487_0,,,,2,2,1,3
C(CCC1(C(COC1)=O)O)(O)=O,,,5,1,1,0,1
67489_0,,,,2,2,1,3
C(CCC1(C(CCO1)=O)O)(O)=O,,,5,1,1,0,1
67491_0,,,,2,2,1,3
C(CCC1CC(C(O)O1)=O)(O)=O,,,5,1,1,0,1
67493_0,,,,2,2,1,3
C(CCC1C(C(O)OC1)=O)(O)=O,,,5,1,1,0,1
67495_0,,,,2,2,1,3
C1(C(CCC(O)=O)C(CO1)O)=O,,,5,1,1,0,1
67497_0,,,,2,2,1,3
C1(CC(C(CCC(O)=O)O1)O)=O,,,5,1,1,0,1
67499_0,,,,2,2,1,3
C1(CC(CO1)(CCC(O)=O)O)=O,,,5,1,1,0,1
67501_0,,,,2,2,1,3
C(CCC1C(COC1O)=O)(O)=O,,,5,1,1,0,1
67503_0,,,,2,2,1,3
C(CCC1(CC(CO1)=O)O)(O)=O,,,5,1,1,0,1
67505_0,,,,2,2,1,3
C(CCC1C(CC(O1)O)=O)(O)=O,,,5,1,1,0,1
67507_0,,,,2,2,1,3
C1(C(CCC(O)=O)(C(CO1)O)O)=O,,,5,1,1,0,1
67509_0,,,,2,2,1,3
C(CCC1C(C(C(O1)=O)O)O)(O)=O,,,5,1,1,0,1
67511_0,,,,2,2,1,3
C(CCC1(COC(C1O)=O)O)(O)=O,,,5,1,1,0,1
67513_0,,,,2,2,1,3
C(CCC(C=O)O)(O)=O,,,5,1,1,0,1
67515_0,,,,2,2,1,3
C1(CC(CO1)C(C=CC(O)=O)O)=O,,,5,1,1,0,1
67517_0,,,,2,2,1,3
C(C(CCC(C=O)=O)O)=CC(O)=O,,,5,1,1,0,1
67518_0,,,,2,2,1,3
67520_0,,,,2,2,1,3
C(CC(CO)C1C=CC(O1)=O)(O)=O,,,5,1,1,0,1
67522_0,,,,2,2,1,3
C(CC(CO)C1C(C=CO1)=O)(O)=O,,,5,1,1,0,1
67524_0,,,,2,2,1,3
C(C(CO)(C(CO)CC(O)=O)O)=O,,,5,1,1,0,1
67526_0,,,,2,2,1,3
C(CC(CO)C(C(C=O)O)O)(O)=O,,,5,1,1,0,1
67528_0,,,,2,2,1,3
C(CC(CO)CO)(O)=O,,,5,1,1,0,1
67530_0,,,,2,2,1,3
C(CC(CO)C(CO)O)(O)=O,,,5,1,1,0,1
67532_0,,,,2,2,1,3
C(CC(CO)C(C(O)=O)O)(O)=O,,,5,1,1,0,1
67534_0,,,,2,2,1,3
C(CC(CO)C(C(CO)=O)O)(O)=O,,,5,1,1,0,1
67536_0,,,,2,2,1,3
C(CC(CO)C(CO)(CO)O)(O)=O,,,5,1,1,0,1
67538_0,,,,2,2,1,3
C(CC(CO)C(C(CO)O)O)(O)=O,,,5,1,1,0,1
67539_0,,,,2,2,1,3
67540_0,,,,2,2,1,3
67541_0,,,,2,2,1,3
67543_0,,,,2,2,1,3
C(C(C(CO)CC(O)=O)C(C)O)=O,,,5,1,1,0,1
67545_0,,,,2,2,1,3
C(CC(CO)C(C)(CC=O)O)(O)=O,,,5,1,1,0,1
67547_0,,,,2,2,1,3
C(CC(CO)CC(CC=O)O)(O)=O,,,5,1,1,0,1
67549_0,,,,2,2,1,3
C(CC(CO)C(CC=O)O)(O)=O,,,5,1,1,0,1
67551_0,,,,2,2,1,3
C(C(CO)C(CO)CC(O)=O)=O,,,5,1,1,0,1
67553_0,,,,2,2,1,3
C(C(C)(C(CO)CC(O)=O)O)(O)=O,,,5,1,1,0,1
67555_0,,,,2,2,1,3
C(CC(CO)CC(C(O)=O)O)(O)=O,,,5,1,1,0,1
67557_0,,,,2,2,1,3
C(CC(CO)C(C(C=O)=O)O)(O)=O,,,5,1,1,0,1
67559_0,,,,2,2,1,3
C(CC(CO)C(C(C)=O)O)(O)=O,,,5,1,1,0,1
67561_0,,,,2,2,1,3
C(CC(CO)CC(CO)=O)(O)=O,,,5,1,1,0,1
67563_0,,,,2,2,1,3
C(CC(CO)C(C)O)(O)=O,,,5,1,1,0,1
67565_0,,,,2,2,1,3
C(CC(CO)CCO)(O)=O,,,5,1,1,0,1
67567_0,,,,2,2,1,3
C(CC(CO)CC(C(O)=O)=O)(O)=O,,,5,1,2,0,2
67569_0,,,,2,2,1,3
C(C(C=O)C(CO)CC(O)=O)(O)=O,,,5,1,1,0,1
67571_0,,,,2,2,1,3
C(CC(CO)CC(O)=O)(O)=O,,,5,1,1,0,1
67573_0,,,,2,2,1,3
C(CC(CO)C(C=O)O)(O)=O,,,5,1,1,0,1
67574_0,,,,2,2,1,3
67575_0,,,,2,2,1,3
67576_0,,,,2,2,1,3
67577_0,,,,2,2,1,3
67578_0,,,,2,2,1,3
67580_0,,,,2,2,1,3
C(C(CC(C)O)C(C=O)(CO)O)=O,,,5,1,1,0,1
67582_0,,,,2,2,1,3
C(C(CCCO)C(C=O)(CO)O)=O,,,5,1,1,0,1
67583_0,,,,2,2,1,3
67584_0,,,,2,2,1,3
67585_0,,,,2,2,1,3
67587_0,,,,2,2,1,3
C(C(CO)(C(C(C)O)CC=O)O)=O,,,5,1,1,0,1
67589_0,,,,2,2,1,3
C(C(CO)(C(CCO)CC=O)O)=O,,,5,1,1,0,1
67590_0,,,,2,2,1,3
67591_0,,,,2,2,1,3
67593_0,,,,2,2,1,3
C(C(CC(CO)O)C(C(O)=O)O)=O,,,5,1,1,0,1
67594_0,,,,2,2,1,3
67596_0,,,,2,2,1,3
C(C(CC(C)O)C(C(O)=O)O)=O,,,5,1,1,0,1
67598_0,,,,2,2,1,3
C(C(CCCO)C(C(O)=O)O)=O,,,5,1,1,0,1
67599_0,,,,2,2,1,3
67601_0,,,,2,2,1,3
C(C(CC(C=O)C(C(O)=O)O)O)=O,,,5,1,1,0,1
67602_0,,,,2,2,1,3
67603_0,,,,2,2,1,3
67604_0,,,,2,2,1,3
67605_0,,,,2,2,1,3
67607_0,,,,2,2,1,3
C(CC(C(C)O)C(C(O)=O)O)=O,,,5,1,1,0,1
67609_0,,,,2,2,1,3
C(CC(CCO)C(C(O)=O)O)=O,,,5,1,1,0,1
67611_0,,,,2,2,1,3
C(CC(C(C(O)=O)O)CC=O)(O)=O,,,5,1,1,0,1
67612_0,,,,2,2,1,3
67614_0,,,,2,2,1,3
C(C(C(CO)CO)C(C(O)=O)O)=O,,,5,1,1,0,1
67615_0,,,,2,2,1,3
67616_0,,,,2,2,1,3
67618_0,,,,2,2,1,3
C1(CC(CO1)C(C(C=CC=O)=O)O)=O,,,5,1,1,0,1
67620_0,,,,2,2,1,3
C(C=O)(CCC(C(C=CC=O)=O)O)=O,,,5,1,1,0,1
67621_0,,,,2,2,1,3
67623_0,,,,2,2,1,3
C(C(CC(CO)=O)C1C=CC(O1)=O)=O,,,5,1,1,0,1
67625_0,,,,2,2,1,3
C(C(CC(CO)=O)C1C(C=CO1)=O)=O,,,5,1,1,0,1
67626_0,,,,2,2,1,3
67627_0,,,,2,2,1,3
67628_0,,,,2,2,1,3
67629_0,,,,2,2,1,3
67630_0,,,,2,2,1,3
67631_0,,,,2,2,1,3
67632_0,,,,2,2,1,3
67633_0,,,,2,2,1,3
67634_0,,,,2,2,1,3
67636_0,,,,2,2,1,3
C(C(CC(CO)=O)CC(CO)=O)=O,,,5,1,1,0,1
67637_0,,,,2,2,1,3
67638_0,,,,2,2,1,3
67639_0,,,,2,2,1,3
67640_0,,,,2,2,1,3
67642_0,,,,2,2,1,3
C(CC(C(CO)=O)C1C=CC(O1)=O)=O,,,5,1,1,0,1
67644_0,,,,2,2,1,3
C(CC(C(CO)=O)C1C(C=CO1)=O)=O,,,5,1,1,0,1
67645_0,,,,2,2,1,3
67646_0,,,,2,2,1,3
67647_0,,,,2,2,1,3
67649_0,,,,2,2,1,3
C(CC(C(CO)=O)CC(C=O)=O)=O,,,5,1,1,0,1
67651_0,,,,2,2,1,3
C(C(C=O)C(C(CO)=O)CC=O)=O,,,5,1,1,0,1
67652_0,,,,2,2,1,3
67653_0,,,,2,2,1,3
67655_0,,,,2,2,1,3
C(CC(C(CO)=O)C(C=O)CO)=O,,,5,1,2,0,2
67656_0,,,,2,2,1,3
67658_0,,,,2,2,1,3
C(CC(C(CO)=O)CC(CO)=O)=O,,,5,1,1,0,1
67659_0,,,,2,2,1,3
67661_0,,,,2,2,1,3
C(CO)(C(CCO)CC=O)=O,,,5,1,1,0,1
67662_0,,,,2,2,1,3
67663_0,,,,2,2,1,3
67664_0,,,,2,2,1,3
67665_0,,,,2,2,1,3
67666_0,,,,2,2,1,3
67667_0,,,,2,2,1,3
67668_0,,,,2,2,1,3
67670_0,,,,2,2,1,3
C(CC(C(C(CO)O)=O)CC=O)=O,,,5,1,1,0,1
67671_0,,,,2,2,1,3
67673_0,,,,2,2,1,3
C(C(CCO)CC=O)(C(CO)O)=O,,,5,1,1,0,1
67674_0,,,,2,2,1,3
67675_0,,,,2,2,1,3
67677_0,,,,2,2,1,3
C(C(CO)C(C(CO)=O)C(C)O)=O,,,5,1,1,0,1
67679_0,,,,2,2,1,3
C(C(CO)C(C(CO)=O)CCO)=O,,,5,1,1,0,1
67681_0,,,,2,2,1,3
C(C(CO)(CO)CC(CO)=O)=O,,,5,1,1,0,1
67682_0,,,,2,2,1,3
67684_0,,,,2,2,1,3
C(C(CO)(C(C)O)CC(CO)=O)=O,,,5,1,1,0,1
67686_0,,,,2,2,1,3
C(C(CO)(CCO)CC(CO)=O)=O,,,5,1,1,0,1
67687_0,,,,2,2,1,3
67688_0,,,,2,2,1,3
67690_0,,,,2,2,1,3
C(C(C(CCC(C)O)=O)(CO)O)=O,,,5,1,1,0,1
67692_0,,,,2,2,1,3
C(C(C(CCCCO)=O)(CO)O)=O,,,5,1,1,0,1
67693_0,,,,2,2,1,3
67694_0,,,,2,2,1,3
67696_0,,,,2,2,1,3
C(C(C(C(CO)O)=O)CC(C)O)=O,,,5,1,1,0,1
67698_0,,,,2,2,1,3
C(C(C(C(CO)O)=O)CCCO)=O,,,5,1,1,0,1
67700_0,,,,2,2,1,3
C(C(CC(CO)CO)=O)(O)=O,,,5,1,1,0,1
67702_0,,,,2,2,1,3
C(C(CC(CO)C(CO)O)=O)(O)=O,,,5,1,2,0,2
67703_0,,,,2,2,1,3
67705_0,,,,2,2,1,3
C(C(CC(CO)C(C)O)=O)(O)=O,,,5,1,1,0,1
67707_0,,,,2,2,1,3
C(C(CC(CO)CCO)=O)(O)=O,,,5,1,1,0,1
67708_0,,,,2,2,1,3
67710_0,,,,2,2,1,3
C(C(C(CO)CC(C(O)=O)=O)O)=O,,,5,1,1,0,1
67712_0,,,,2,2,1,3
C(C(CO)CC(CO)=O)(O)=O,,,5,1,1,0,1
67714_0,,,,2,2,1,3
C(C(C(CO)O)CC(CO)=O)(O)=O,,,5,1,1,0,1
67715_0,,,,2,2,1,3
67717_0,,,,2,2,1,3
C(C(C(C)O)CC(CO)=O)(O)=O,,,5,1,1,0,1
67719_0,,,,2,2,1,3
C(C(CCO)CC(CO)=O)(O)=O,,,5,1,1,0,1
67721_0,,,,2,2,1,3
C(CC(C(O)=O)CC(CO)=O)(O)=O,,,5,1,1,0,1
67722_0,,,,2,2,1,3
67723_0,,,,2,2,1,3
67725_0,,,,2,2,1,3
C(CO)(C(C(CO)O)CC(O)=O)=O,,,5,1,1,0,1
67726_0,,,,2,2,1,3
67728_0,,,,2,2,1,3
C(CO)(C(C(C)O)CC(O)=O)=O,,,5,1,1,0,1
67730_0,,,,2,2,1,3
C(CO)(C(CCO)CC(O)=O)=O,,,5,1,1,0,1
67732_0,,,,2,2,1,3
C(CC(C(CO)=O)CC(O)=O)(O)=O,,,5,1,1,0,1
67734_0,,,,2,2,1,3
C(CC(C(CO)=O)C(C=O)O)(O)=O,,,5,1,1,0,1
67735_0,,,,2,2,1,3
67737_0,,,,2,2,1,3
C(C(C(CCC(CO)O)=O)O)(O)=O,,,5,1,1,0,1
67738_0,,,,2,2,1,3
67740_0,,,,2,2,1,3
C(C(C(CCC(C)O)=O)O)(O)=O,,,5,1,1,0,1
67742_0,,,,2,2,1,3
C(C(C(CCCCO)=O)O)(O)=O,,,5,1,1,0,1
67743_0,,,,2,2,1,3
67745_0,,,,2,2,1,3
C(CCC(C=O)O)(C(C(O)=O)O)=O,,,5,1,1,0,1
67746_0,,,,2,2,1,3
67748_0,,,,2,2,1,3
C(C(CO)CC(C(CO)O)=O)(O)=O,,,5,1,1,0,1
67750_0,,,,2,2,1,3
C(C(CO)CC(O)=O)(C(CO)O)=O,,,5,1,1,0,1
67752_0,,,,2,2,1,3
C(C(C(CC(CO)CO)=O)O)(O)=O,,,5,1,1,0,1
67754_0,,,,2,2,1,3
C1(CC(CO1)C2C=CC(O2)=O)=O,,,5,1,1,0,1
67755_0,,,,2,2,1,3
67756_0,,,,2,2,1,3
67758_0,,,,2,2,1,3
C1(CC(CO1)C2C(C=CO2)=O)=O,,,5,1,1,0,1
67760_0,,,,2,2,1,3
C1(CC(CO1)C2C(CC(O)O2)O)=O,,,5,1,1,0,1
67762_0,,,,2,2,1,3
C1(CC(CO1)C2(COC(C2)O)O)=O,,,5,1,1,0,1
67764_0,,,,2,2,1,3
C1(CC(CO1)C2(CC(CO2)O)O)=O,,,5,1,1,0,1
67766_0,,,,2,2,1,3
C1(CC(CO1)C2C(O)OCC2O)=O,,,5,1,1,0,1
67768_0,,,,2,2,1,3
C1(CC(CO1)C2(C(O)OCC2)O)=O,,,5,1,1,0,1
67770_0,,,,2,2,1,3
C1(CC(CO1)C2(C(CCO2)O)O)=O,,,5,1,1,0,1
67772_0,,,,2,2,1,3
C1(CC(CO1)C2CC(C(O)O2)O)=O,,,5,1,1,0,1
67774_0,,,,2,2,1,3
C1(CC(CO1)C2COC(C2O)O)=O,,,5,1,1,0,1
67776_0,,,,2,2,1,3
C(C(CO)(C1COC(C1)=O)O)=O,,,5,1,1,0,1
67778_0,,,,2,2,1,3
C1(CC(CO1)C(C(C=O)O)O)=O,,,5,1,1,0,1
67780_0,,,,2,2,1,3
C1(CC(CO1)CO)=O,,,5,1,1,0,1
67782_0,,,,2,2,1,3
C1(CC(CO1)C(CO)O)=O,,,5,1,1,0,1
67784_0,,,,2,2,1,3
C1(CC(CO1)C(C(O)=O)O)=O,,,5,1,1,0,1
67786_0,,,,2,2,1,3
C1(CC(CO1)C(C(CO)=O)O)=O,,,5,1,1,0,1
67788_0,,,,2,2,1,3
C1(CC(CO1)C(CO)(CO)O)=O,,,5,1,1,0,1
67790_0,,,,2,2,1,3
C1(CC(CO1)C(C(CO)O)O)=O,,,5,1,1,0,1
67792_0,,,,2,2,1,3
C(C(CO)(C1COC(C1)=O)O)(O)=O,,,5,1,1,0,1
67794_0,,,,2,2,1,3
C1(CC(CO1)C(C(C(O)=O)O)O)=O,,,5,1,1,0,1
67796_0,,,,2,2,1,3
C1(CC(CO1)CC(C=O)=O)=O,,,5,1,1,0,1
67798_0,,,,2,2,1,3
C(C(C=O)C1COC(C1)=O)=O,,,5,1,1,0,1
67800_0,,,,2,2,1,3
C1(CC(CO1)C(CC(C=O)=O)O)=O,,,5,1,1,0,1
67802_0,,,,2,2,1,3
C1(CC(CO1)C(C(C=O)=O)CO)=O,,,5,1,1,0,1
67804_0,,,,2,2,1,3
C1(CC(CO1)C(C=O)(CC=O)O)=O,,,5,1,1,0,1
67806_0,,,,2,2,1,3
C1(CC(CO1)C(C=O)C(C=O)O)=O,,,5,1,1,0,1
67808_0,,,,2,2,1,3
C1(CC(CO1)C(C=O)C(CO)=O)=O,,,5,1,1,0,1
67810_0,,,,2,2,1,3
C1(CC(CO1)C(C(CC=O)=O)O)=O,,,5,1,1,0,1
67812_0,,,,2,2,1,3
C1(CC(CO1)C(C=O)(C(C)=O)O)=O,,,5,1,1,0,1
67814_0,,,,2,2,1,3
C(C(C(CC1COC(C1)=O)=O)O)=O,,,5,1,1,0,1
67816_0,,,,2,2,1,3
C(CC1COC(C1)=O)=O,,,5,1,1,0,1
67818_0,,,,2,2,1,3
C(C(C=O)C(C1COC(C1)=O)O)=O,,,5,1,1,0,1
67820_0,,,,2,2,1,3
C(C(C=O)(CO)C1COC(C1)=O)=O,,,5,1,1,0,1
67822_0,,,,2,2,1,3
C(C(C1COC(C1)=O)C(C)O)=O,,,5,1,1,0,1
67824_0,,,,2,2,1,3
C1(CC(CO1)C(C)(CC=O)O)=O,,,5,1,1,0,1
67826_0,,,,2,2,1,3
C1(CC(CO1)CC(CC=O)O)=O,,,5,1,1,0,1
67828_0,,,,2,2,1,3
C(C(C(C)O)(C1COC(C1)=O)O)=O,,,5,1,1,0,1
67830_0,,,,2,2,1,3
C1(CC(CO1)C(C)(C(C=O)O)O)=O,,,5,1,1,0,1
67832_0,,,,2,2,1,3
C1(CC(CO1)CC(C(C=O)O)O)=O,,,5,1,1,0,1
67834_0,,,,2,2,1,3
C1(CC(CO1)C(CC=O)O)=O,,,5,1,1,0,1
67836_0,,,,2,2,1,3
C(C(CO)C1COC(C1)=O)=O,,,5,1,1,0,1
67838_0,,,,2,2,1,3
C1(CC(CO1)C(C(CC=O)O)O)=O,,,5,1,1,0,1
67840_0,,,,2,2,1,3
C1(CC(CO1)C(CO)(CC=O)O)=O,,,5,1,1,0,1
67842_0,,,,2,2,1,3
C(C(C1COC(C1)=O)C(CO)O)=O,,,5,1,1,0,1
67844_0,,,,2,2,1,3
C(C(C)(C1COC(C1)=O)O)(O)=O,,,5,1,1,0,1
67846_0,,,,2,2,1,3
C1(CC(CO1)CC(C(O)=O)O)=O,,,5,1,1,0,1
67848_0,,,,2,2,1,3
C1(CC(CO1)C(C(C=O)=O)O)=O,,,5,1,1,0,1
67850_0,,,,2,2,1,3
C1(CC(CO1)C(C(C(C)=O)=O)O)=O,,,5,1,1,0,1
67852_0,,,,2,2,1,3
C1(CC(CO1)CC(C(CO)=O)=O)=O,,,5,1,1,0,1
67854_0,,,,2,2,1,3
C1(CC(CO1)CC(C(C=O)=O)O)=O,,,5,1,1,0,1
67856_0,,,,2,2,1,3
C1(CC(CO1)C(C(C=O)=O)(C)O)=O,,,5,1,1,0,1
67858_0,,,,2,2,1,3
C1(CC(CO1)C(C(C)=O)O)=O,,,5,1,1,0,1
67860_0,,,,2,2,1,3
C1(CC(CO1)CC(CO)=O)=O,,,5,1,1,0,1
67862_0,,,,2,2,1,3
C1(CC(CO1)C(C(CCO)=O)O)=O,,,5,1,1,0,1
67864_0,,,,2,2,1,3
C1(CC(C(CC(CO)=O)O)CO1)=O,,,5,1,1,0,1
67866_0,,,,2,2,1,3
C1(CC(CO1)C(C(CO)=O)CO)=O,,,5,1,1,0,1
67868_0,,,,2,2,1,3
C(C(CCO)(C1COC(C1)=O)O)=O,,,5,1,1,0,1
67870_0,,,,2,2,1,3
C1(CC(CO1)C(CC(C=O)O)O)=O,,,5,1,1,0,1
67872_0,,,,2,2,1,3
C1(CC(CO1)C(CO)C(C=O)O)=O,,,5,1,1,0,1
67874_0,,,,2,2,1,3
C1(CC(CO1)C(C(C)=O)(CO)O)=O,,,5,1,1,0,1
67876_0,,,,2,2,1,3
C1(CC(C(C(C(C)=O)O)O)CO1)=O,,,5,1,1,0,1
67878_0,,,,2,2,1,3
C1(CC(CO1)CC(C(CO)O)=O)=O,,,5,1,1,0,1
67880_0,,,,2,2,1,3
C1(CC(CO1)C(C)O)=O,,,5,1,1,0,1
67882_0,,,,2,2,1,3
C1(CC(CO1)CCO)=O,,,5,1,1,0,1
67884_0,,,,2,2,1,3
C1(CC(CO1)CC(C(O)=O)=O)=O,,,5,1,1,0,1
67886_0,,,,2,2,1,3
C(C(C(O)=O)C1COC(C1)=O)=O,,,5,1,1,0,1
67888_0,,,,2,2,1,3
C1(CC(CO1)CC(O)=O)=O,,,5,1,1,0,1
67890_0,,,,2,2,1,3
C1(CC(CO1)C2C(C(CO2)O)=O)=O,,,5,1,1,0,1
67892_0,,,,2,2,1,3
C1(CC(C2C(C(CO2)=O)O)CO1)=O,,,5,1,1,0,1
67894_0,,,,2,2,1,3
C1(CC(CO1)C2(C(COC2)=O)O)=O,,,5,1,1,0,1
67896_0,,,,2,2,1,3
C1(CC(CO1)C2(C(CCO2)=O)O)=O,,,5,1,1,0,1
67898_0,,,,2,2,1,3
C1(CC(C2CC(C(O)O2)=O)CO1)=O,,,5,1,1,0,1
67900_0,,,,2,2,1,3
C1(CC(CO1)C2C(C(O)OC2)=O)=O,,,5,1,1,0,1
67902_0,,,,2,2,1,3
C1(C(C2COC(C2)=O)C(CO1)O)=O,,,5,1,1,0,1
67904_0,,,,2,2,1,3
C1(CC(CO1)C2C(CC(O2)=O)O)=O,,,5,1,1,0,1
67906_0,,,,2,2,1,3
C1(CC(CO1)(C2COC(C2)=O)O)=O,,,5,1,1,0,1
67908_0,,,,2,2,1,3
C1(CC(CO1)C2C(COC2O)=O)=O,,,5,1,1,0,1
67910_0,,,,2,2,1,3
C1(CC(CO1)C2(CC(CO2)=O)O)=O,,,5,1,1,0,1
67912_0,,,,2,2,1,3
C1(CC(CO1)C2C(CC(O2)O)=O)=O,,,5,1,1,0,1
67914_0,,,,2,2,1,3
C1(CC(CO1)C(C=O)O)=O,,,5,1,1,0,1
67915_0,,,,2,2,1,3
67916_0,,,,2,2,1,3
67917_0,,,,2,2,1,3
67918_0,,,,2,2,1,3
67919_0,,,,2,2,1,3
67920_0,,,,2,2,1,3
67922_0,,,,2,2,1,3
C(C(CCC1(CC(CO1)O)O)=O)=O,,,5,1,1,0,1
67924_0,,,,2,2,1,3
C(C(C1(CC(CO1)O)O)CC=O)=O,,,5,1,1,0,1
67925_0,,,,2,2,1,3
67926_0,,,,2,2,1,3
67927_0,,,,2,2,1,3
67928_0,,,,2,2,1,3
67930_0,,,,2,2,1,3
C(C(CCC1(C(CCO1)O)O)=O)=O,,,5,1,1,0,1
67932_0,,,,2,2,1,3
C(C(C1(C(CCO1)O)O)CC=O)=O,,,5,1,1,0,1
67933_0,,,,2,2,1,3
67934_0,,,,2,2,1,3
67935_0,,,,2,2,1,3
67936_0,,,,2,2,1,3
67937_0,,,,2,1,2,3
67938_0,,,,2,1,2,3
67939_0,,,,2,1,2,3
67940_0,,,,2,1,2,3
67941_0,,,,2,1,2,3
67942_0,,,,2,1,2,3
67943_0,,,,2,1,2,3
67944_0,,,,2,1,2,3
67945_0,,,,2,1,2,3
67946_0,,,,2,1,2,3
67947_0,,,,2,1,2,3
67948_0,,,,2,1,2,3
67949_0,,,,2,1,2,3
67950_0,,,,2,1,2,3
67951_0,,,,2,1,2,3
67952_0,,,,2,1,2,3
67953_0,,,,2,1,2,3
67954_0,,,,2,1,2,3
67955_0,,,,2,1,2,3
67956_0,,,,2,1,2,3
67957_0,,,,2,1,2,3
67960_0,,,,2,1,2,3
C(C(C=CC(C=O)=O)=O)=O,,,5,1,1,0,1
C,,,5,1,3,0,3
67961_0,,,,2,1,2,3
67962_0,,,,2,1,2,3
67964_0,,,,2,1,2,3
C(C(C=O)=CC(C=O)=O)=O,,,5,1,1,0,1
67965_0,,,,2,1,2,3
67966_0,,,,2,1,2,3
67967_0,,,,2,1,2,3
67968_0,,,,2,1,2,3
67969_0,,,,2,1,2,3
67970_0,,,,2,1,2,3
67971_0,,,,2,1,2,3
67972_0,,,,2,1,2,3
67973_0,,,,2,1,2,3
67975_0,,,,2,1,2,3
C=C(C=O)C(C(O)=O)=O,,,5,1,1,0,1
67976_0,,,,2,1,2,3
67977_0,,,,2,1,2,3
67978_0,,,,2,1,2,3
67979_0,,,,2,1,2,3
67980_0,,,,2,1,2,3
67981_0,,,,2,1,2,3
67982_0,,,,2,1,2,3
67984_0,,,,2,1,2,3
C(CC(C=O)=C(C=O)C=O)=O,,,5,1,1,0,1
67985_0,,,,2,1,2,3
67986_0,,,,2,1,2,3
67987_0,,,,2,1,2,3
67988_0,,,,2,1,2,3
67989_0,,,,2,1,2,3
67990_0,,,,2,1,2,3
67991_0,,,,2,1,2,3
67992_0,,,,2,1,2,3
67993_0,,,,2,1,2,3
67994_0,,,,2,1,2,3
67995_0,,,,2,1,2,3
67996_0,,,,2,1,2,3
67997_0,,,,2,1,2,3
67998_0,,,,2,1,2,3
67999_0,,,,2,1,2,3
68000_0,,,,2,1,2,3
68001_0,,,,2,1,2,3
68002_0,,,,2,1,2,3
68003_0,,,,2,1,2,3
68004_0,,,,2,1,2,3
68005_0,,,,2,1,2,3
68006_0,,,,2,1,2,3
68007_0,,,,2,1,2,3
68008_0,,,,2,1,2,3
68009_0,,,,2,1,2,3
68010_0,,,,2,1,2,3
68011_0,,,,2,1,2,3
68012_0,,,,2,1,2,3
68013_0,,,,2,1,2,3
68014_0,,,,2,1,2,3
68015_0,,,,2,1,2,3
68016_0,,,,2,1,2,3
68017_0,,,,2,1,2,3
68018_0,,,,2,1,2,3
68019_0,,,,2,1,2,3
68020_0,,,,2,1,2,3
68021_0,,,,2,1,2,3
68022_0,,,,2,1,2,3
68023_0,,,,2,1,2,3
68024_0,,,,2,1,2,3
68025_0,,,,2,1,2,3
68026_0,,,,2,1,2,3
68027_0,,,,2,1,2,3
68028_0,,,,2,1,2,3
68029_0,,,,2,1,2,3
68030_0,,,,2,1,2,3
68031_0,,,,2,1,2,3
68032_0,,,,2,1,2,3
68033_0,,,,2,1,2,3
68034_0,,,,2,1,2,3
68035_0,,,,2,1,2,3
68036_0,,,,2,1,2,3
68037_0,,,,2,1,2,3
68038_0,,,,2,1,2,3
68039_0,,,,2,1,2,3
68040_0,,,,2,1,2,3
68041_0,,,,2,1,2,3
68042_0,,,,2,1,2,3
68043_0,,,,2,1,2,3
68044_0,,,,2,1,2,3
68045_0,,,,2,1,2,3
68046_0,,,,2,1,2,3
68047_0,,,,2,1,2,3
68048_0,,,,2,1,2,3
68049_0,,,,2,1,2,3
68050_0,,,,2,1,2,3
68051_0,,,,2,1,2,3
68052_0,,,,2,1,2,3
68053_0,,,,2,1,2,3
68054_0,,,,2,1,2,3
68055_0,,,,2,1,2,3
68056_0,,,,2,1,2,3
68057_0,,,,2,1,2,3
68058_0,,,,2,1,2,3
68059_0,,,,2,1,2,3
68060_0,,,,2,1,2,3
68061_0,,,,2,1,2,3
68062_0,,,,2,1,2,3
68063_0,,,,2,1,2,3
68064_0,,,,2,1,2,3
68065_0,,,,2,1,2,3
68066_0,,,,2,1,2,3
68067_0,,,,2,1,2,3
68068_0,,,,2,1,2,3
68069_0,,,,2,1,2,3
68070_0,,,,2,1,2,3
68071_0,,,,2,1,2,3
68072_0,,,,2,1,2,3
68073_0,,,,2,1,2,3
68074_0,,,,2,1,2,3
68075_0,,,,2,1,2,3
68076_0,,,,2,1,2,3
68077_0,,,,2,1,2,3
68078_0,,,,2,1,2,3
68079_0,,,,2,1,2,3
68080_0,,,,2,1,2,3
68081_0,,,,2,1,2,3
68082_0,,,,2,1,2,3
68083_0,,,,2,1,2,3
68084_0,,,,2,1,2,3
68085_0,,,,2,1,2,3
68086_0,,,,2,1,2,3
68087_0,,,,2,1,2,3
68088_0,,,,2,1,2,3
68089_0,,,,2,1,2,3
68090_0,,,,2,1,2,3
68091_0,,,,2,1,2,3
68092_0,,,,2,1,2,3
68093_0,,,,2,1,2,3
68094_0,,,,2,1,2,3
68095_0,,,,2,1,2,3
68096_0,,,,2,1,2,3
68097_0,,,,2,1,2,3
68099_0,,,,2,1,1,2
C(CC(C=O)=CC(C(O)OC)=O)=O,,,5,1,1,0,1
68100_0,,,,2,1,2,3
68101_0,,,,2,1,2,3
68102_0,,,,2,1,2,3
68103_0,,,,2,1,2,3
68105_0,,,,2,1,1,2
C(CC(C=O)=CC(OCCO)=O)=O,,,5,1,1,0,1
68106_0,,,,2,1,2,3
68107_0,,,,2,1,2,3
68108_0,,,,2,1,2,3
68109_0,,,,2,1,2,3
68110_0,,,,2,1,2,3
68111_0,,,,2,1,2,3
68112_0,,,,2,1,2,3
68113_0,,,,2,1,2,3
68115_0,,,,2,1,1,2
C(CC(C=O)=CC(COCO)=O)=O,,,5,1,1,0,1
68116_0,,,,2,1,2,3
68117_0,,,,2,1,2,3
68118_0,,,,2,1,2,3
68119_0,,,,2,1,2,3
68120_0,,,,2,1,2,3
68121_0,,,,2,1,2,3
68122_0,,,,2,1,2,3
68123_0,,,,2,1,2,3
68124_0,,,,2,1,2,3
68125_0,,,,2,1,2,3
68126_0,,,,2,1,2,3
68127_0,,,,2,1,2,3
68128_0,,,,2,1,2,3
68129_0,,,,2,1,2,3
68130_0,,,,2,1,2,3
68131_0,,,,2,1,2,3
68132_0,,,,2,1,2,3
68133_0,,,,2,1,2,3
68134_0,,,,2,1,2,3
68135_0,,,,2,1,2,3
68136_0,,,,2,1,2,3
68137_0,,,,2,1,2,3
68138_0,,,,2,1,2,3
68139_0,,,,2,1,2,3
68140_0,,,,2,1,2,3
68141_0,,,,2,1,2,3
68142_0,,,,2,1,2,3
68143_0,,,,2,1,2,3
68144_0,,,,2,1,2,3
68145_0,,,,2,1,2,3
68146_0,,,,2,1,2,3
68147_0,,,,2,1,2,3
68148_0,,,,2,1,2,3
68149_0,,,,2,1,2,3
68150_0,,,,2,1,2,3
68151_0,,,,2,1,2,3
68152_0,,,,2,1,2,3
68153_0,,,,2,1,2,3
68154_0,,,,2,1,2,3
68155_0,,,,2,1,2,3
68156_0,,,,2,1,2,3
68157_0,,,,2,1,2,3
68158_0,,,,2,1,2,3
68159_0,,,,2,1,2,3
68160_0,,,,2,1,2,3
68161_0,,,,2,1,2,3
68162_0,,,,2,1,2,3
68163_0,,,,2,1,2,3
68164_0,,,,2,1,2,3
68165_0,,,,2,1,2,3
