Id,Label,timeset,gen,type,weighted indegree,weighted outdegree,Weighted Degree
8_0,,,,2,1,2,3
C(CO)=O,,,1,1,399,638,1037
C(C(C(CO)O)O)=O,,,1,1,46,50,96
8_1,,,,2,1,2,3
10_0,,,,2,1,1,2
C(CO)(C(C(C(CO)O)O)O)=O,,,1,1,14,12,26
13_0,,,,2,3,2,5
C(C(C(C(C(CO)O)O)O)O)(O)=O,,,1,1,954,14,968
C(C(C(C(C(CO)O)O)O)O)O,,,1,1,586,5,591
13_1,,,,2,3,2,5
15_0,,,,2,1,2,3
O,,,0,1,3543,2636,6179
C(C(CC(C(CO)O)O)=O)=O,,,1,1,17,19,36
17_0,,,,2,1,2,3
C(CC(C(C(CO)O)O)=O)=O,,,1,1,19,19,38
19_0,,,,2,1,2,3
C(C(C(CC(CO)O)=O)O)=O,,,1,1,16,17,33
21_0,,,,2,1,2,3
C(CC(C=O)O)(C(CO)O)=O,,,1,1,23,22,45
23_0,,,,2,1,2,3
C(C(C(C=O)O)O)(CCO)=O,,,1,1,24,25,49
25_0,,,,2,1,2,3
C(C(C(CC(CO)=O)O)O)=O,,,1,1,22,24,46
27_0,,,,2,1,2,3
C(C(C(C(C(C)=O)O)O)O)=O,,,1,1,22,24,46
29_0,,,,2,1,2,3
C(CC(C(C(C=O)O)O)O)=O,,,1,1,24,28,52
31_0,,,,2,1,1,2
C(C(C1C(C(C(O)O1)O)O)O)O,,,1,1,5,7,12
33_0,,,,2,1,1,2
C(C1C(C(C(C(O)O1)O)O)O)O,,,1,1,5,7,12
35_0,,,,2,1,1,2
C1C(C(C(C(C(O)O1)O)O)O)O,,,1,1,7,9,16
37_0,,,,2,2,2,4
[Fe+3],,,0,1,431,969,1400
C(C(CC(C(CO)O)O)O)(O)=O,,,1,1,13,11,24
39_0,,,,2,3,5,8
[H+],,,0,1,733,345,1078
[Fe+2],,,0,1,902,364,1266
C(C(C(C(C(CO)O)O)O)=O)=O,,,1,1,17,20,37
40_0,,,,2,4,4,8
42_0,,,,2,1,1,2
C1(C(C(C(C1CO)O)O)O)=O,,,2,1,19,17,36
42_1,,,,2,1,1,2
44_0,,,,2,1,1,2
C1(C(C(C(C(C1)O)O)O)O)=O,,,2,1,17,16,33
44_1,,,,2,1,1,2
45_0,,,,2,1,1,2
47_0,,,,2,1,1,2
C(C1C(C(C(C1O)O)O)O)=O,,,2,1,11,12,23
47_1,,,,2,1,1,2
48_0,,,,2,2,1,3
48_1,,,,2,2,1,3
49_0,,,,2,2,1,3
C(C(C(C(C(CO)O)O)O)O)=O,,,0,1,16,1538,1554
49_1,,,,2,2,1,3
50_0,,,,2,2,1,3
50_1,,,,2,2,1,3
51_0,,,,2,2,1,3
51_1,,,,2,2,1,3
52_0,,,,2,1,2,3
53_0,,,,2,1,2,3
54_0,,,,2,1,2,3
54_1,,,,2,1,2,3
57_0,,,,2,1,2,3
C(CO)(CO)=O,,,2,1,109,209,318
C(C(CO)O)=O,,,2,1,157,222,379
57_1,,,,2,1,2,3
59_0,,,,2,1,2,3
C(C(C)=O)=O,,,2,1,169,458,627
61_0,,,,2,1,2,3
C(CC(CO)=O)=O,,,2,1,93,196,289
61_1,,,,2,1,2,3
63_0,,,,2,1,2,3
C(C(C(C)=O)O)=O,,,2,1,90,167,257
66_0,,,,2,1,2,3
C(C=O)=O,,,2,1,224,276,500
C(C)(C(CO)O)=O,,,2,1,79,136,215
69_0,,,,2,1,2,3
C(C(CC(CO)=O)O)=O,,,2,1,42,43,85
C=O,,,2,1,814,1798,2612
69_1,,,,2,1,2,3
71_0,,,,2,1,2,3
C(C(CCO)=O)=O,,,2,1,74,141,215
71_1,,,,2,1,2,3
73_0,,,,2,1,2,3
C(CO)(CCO)=O,,,2,1,80,163,243
73_1,,,,2,1,2,3
75_0,,,,2,1,2,3
C(C(C(C(C)=O)O)O)=O,,,2,1,48,46,94
76_0,,,,2,1,2,3
76_1,,,,2,1,2,3
79_0,,,,2,1,2,3
C(C(C=O)O)=O,,,2,1,108,212,320
C(C)(CO)=O,,,2,1,207,444,651
80_0,,,,2,1,2,3
80_1,,,,2,1,2,3
81_0,,,,2,1,2,3
81_1,,,,2,1,2,3
83_0,,,,2,1,2,3
C(CC(C=O)O)=O,,,2,1,96,171,267
83_1,,,,2,1,2,3
86_0,,,,2,1,2,3
C(C(C(C=O)O)O)=O,,,2,1,37,46,83
C(C)=O,,,2,1,298,1489,1787
87_0,,,,2,1,2,3
89_0,,,,2,1,2,3
C(C(CO)=O)=O,,,2,1,155,303,458
89_1,,,,2,1,2,3
90_0,,,,2,1,1,2
92_0,,,,2,1,1,2
C(CO)(C(CO)O)=O,,,2,1,59,67,126
93_0,,,,2,1,1,2
95_0,,,,2,1,1,2
C(C(C(CO)O)O)(C(CO)O)=O,,,2,1,15,13,28
97_0,,,,2,1,1,2
C(CC(C(C(CO)O)=O)O)=O,,,2,1,22,20,42
99_0,,,,2,1,1,2
C(C(CO)=O)(CC(CO)O)=O,,,2,1,15,15,30
101_0,,,,2,1,1,2
C(C(C(CC(CO)O)O)=O)=O,,,2,1,14,16,30
103_0,,,,2,1,1,2
C(C(CO)O)(CC(CO)=O)=O,,,2,1,20,17,37
105_0,,,,2,1,1,2
C(C(CC(C(CO)=O)O)O)=O,,,2,1,18,18,36
107_0,,,,2,1,1,2
C(CCO)(C(C(CO)=O)O)=O,,,2,1,16,14,30
109_0,,,,2,1,1,2
C(C(C(C(CCO)O)=O)O)=O,,,2,1,14,14,28
111_0,,,,2,1,1,2
C(CO)(C(CC(CO)=O)O)=O,,,2,1,22,19,41
113_0,,,,2,1,1,2
C(C(C(CC(C=O)O)O)O)=O,,,2,1,23,26,49
115_0,,,,2,1,1,2
C(C)(C(C(C(CO)=O)O)O)=O,,,2,1,24,21,45
117_0,,,,2,1,1,2
C(C(C(C=O)O)O)(C(C)O)=O,,,2,1,22,22,44
119_0,,,,2,1,1,2
C(CC(C(C(CO)=O)O)O)=O,,,2,1,21,21,42
121_0,,,,2,1,1,2
C(C(C(C(C(CO)O)O)=O)O)=O,,,2,1,13,16,29
123_0,,,,2,3,2,5
C(CO)O,,,2,1,4,17,21
125_0,,,,2,3,2,5
C(C(C(CO)O)O)O,,,2,1,4,3,7
127_0,,,,2,3,2,5
C(CO)(CC(C(CO)O)O)=O,,,2,1,16,14,30
129_0,,,,2,3,2,5
C(C(C(CO)O)O)(CCO)=O,,,2,1,18,15,33
131_0,,,,2,3,2,5
C(C(CO)O)(CC(CO)O)=O,,,2,1,18,15,33
132_0,,,,2,3,2,5
133_0,,,,2,3,2,5
134_0,,,,2,3,2,5
136_0,,,,2,3,2,5
C(C)(C(C(C(CO)O)O)O)=O,,,2,1,17,15,32
138_0,,,,2,3,2,5
C(CC(C(C(CO)O)O)O)=O,,,2,1,15,16,31
140_0,,,,2,3,2,5
C(C(C(C(CCO)O)O)O)=O,,,2,1,16,18,34
141_0,,,,2,3,2,5
143_0,,,,2,3,2,5
C(CO)(O)=O,,,2,1,43,101,144
145_0,,,,2,3,2,5
C(C(C(CO)O)O)(O)=O,,,2,1,19,18,37
147_0,,,,2,3,2,5
C(C(CC(C(CO)O)O)=O)(O)=O,,,2,1,11,15,26
149_0,,,,2,3,2,5
C(CC(C(C(CO)O)O)=O)(O)=O,,,2,1,11,14,25
151_0,,,,2,3,2,5
C(C(C(CC(CO)O)=O)O)(O)=O,,,2,1,13,12,25
153_0,,,,2,3,2,5
C(CC(C(O)=O)O)(C(CO)O)=O,,,2,1,15,13,28
155_0,,,,2,3,2,5
C(C(C(C(O)=O)O)O)(CCO)=O,,,2,1,15,13,28
157_0,,,,2,3,2,5
C(C(C(CC(CO)=O)O)O)(O)=O,,,2,1,14,12,26
159_0,,,,2,3,2,5
C(C(C(C(C(C)=O)O)O)O)(O)=O,,,2,1,16,14,30
161_0,,,,2,3,2,5
C(CC(C(C(C(O)=O)O)O)O)=O,,,2,1,18,18,36
163_0,,,,2,3,2,5
C(CC(C(C(C=O)O)O)O)(O)=O,,,2,1,13,18,31
165_0,,,,2,3,2,5
C(C(C(C(C(CO)O)O)O)=O)(O)=O,,,2,1,13,17,30
167_0,,,,2,1,1,2
C1(CC(C(C1(CO)O)O)O)=O,,,2,1,13,15,28
167_1,,,,2,1,1,2
169_0,,,,2,1,1,2
C(C1(C(C(CC1O)O)O)O)=O,,,2,1,12,16,28
169_1,,,,2,1,1,2
171_0,,,,2,2,1,3
C(C(C(CO)O)(C(CO)O)O)=O,,,2,1,7,9,16
171_1,,,,2,2,1,3
172_0,,,,2,1,2,3
173_0,,,,2,1,2,3
174_0,,,,2,1,2,3
175_0,,,,2,1,2,3
176_0,,,,2,1,2,3
177_0,,,,2,1,2,3
178_0,,,,2,1,2,3
179_0,,,,2,1,2,3
180_0,,,,2,1,2,3
181_0,,,,2,1,2,3
182_0,,,,2,1,2,3
183_0,,,,2,1,2,3
184_0,,,,2,1,2,3
185_0,,,,2,1,2,3
186_0,,,,2,1,2,3
187_0,,,,2,1,2,3
188_0,,,,2,1,2,3
189_0,,,,2,1,2,3
190_0,,,,2,1,2,3
191_0,,,,2,1,2,3
192_0,,,,2,1,2,3
193_0,,,,2,1,2,3
194_0,,,,2,1,2,3
195_0,,,,2,1,2,3
197_0,,,,2,1,2,3
C(CCO)(CC(C=O)=O)=O,,,2,1,23,29,52
199_0,,,,2,1,2,3
C(CO)(CCC(C=O)=O)=O,,,2,1,22,29,51
201_0,,,,2,1,2,3
C(C)(C(CC(C=O)=O)O)=O,,,2,1,23,28,51
203_0,,,,2,1,2,3
C(CC(CC(C=O)=O)O)=O,,,2,1,22,31,53
205_0,,,,2,1,2,3
C(CC(C(CCO)=O)=O)=O,,,2,1,21,27,48
207_0,,,,2,1,2,3
C(CC(CC(CO)=O)=O)=O,,,2,1,25,32,57
209_0,,,,2,1,2,3
C(CC(C(C(C)=O)O)=O)=O,,,2,1,22,27,49
211_0,,,,2,1,2,3
C(CC(C(CC=O)O)=O)=O,,,2,1,26,33,59
213_0,,,,2,1,2,3
C(C(C=O)O)(CC(C)=O)=O,,,2,1,22,28,50
215_0,,,,2,1,2,3
C(C(C(CCC=O)=O)O)=O,,,2,1,22,28,50
217_0,,,,2,1,2,3
C(C(CC(C(C)=O)=O)O)=O,,,2,1,22,27,49
219_0,,,,2,1,2,3
C(CC(CC(C=O)O)=O)=O,,,2,1,27,34,61
220_0,,,,2,1,2,3
221_0,,,,2,1,2,3
222_0,,,,2,1,2,3
223_0,,,,2,1,2,3
224_0,,,,2,1,2,3
225_0,,,,2,1,2,3
226_0,,,,2,1,2,3
227_0,,,,2,1,2,3
228_0,,,,2,1,2,3
229_0,,,,2,1,2,3
230_0,,,,2,1,2,3
231_0,,,,2,1,2,3
233_0,,,,2,1,2,3
C1(CC(C(C(CO)O)O1)O)=O,,,2,1,9,4,13
235_0,,,,2,1,2,3
C1(COC(C(CO)O)C1O)=O,,,2,1,11,9,20
237_0,,,,2,1,2,3
C1(C(O)OC(C(CO)O)C1)=O,,,2,1,10,10,20
239_0,,,,2,1,2,3
C1(C(C(CO)O)OC(C1)O)=O,,,2,1,12,13,25
241_0,,,,2,1,2,3
C(C)(C1C(C(C(O1)O)O)O)=O,,,2,1,11,12,23
243_0,,,,2,1,2,3
C(CC1C(C(C(O)O1)O)O)=O,,,2,1,9,13,22
245_0,,,,2,1,2,3
C1(CC(C(C(CO)O1)O)O)=O,,,2,1,8,5,13
247_0,,,,2,1,2,3
C1(COC(CO)C(C1O)O)=O,,,2,1,12,10,22
249_0,,,,2,1,2,3
C1(C(O)OC(CO)C(C1)O)=O,,,2,1,9,9,18
251_0,,,,2,1,2,3
C1(C(C(CO)OC(C1)O)O)=O,,,2,1,9,10,19
253_0,,,,2,1,2,3
C1(C(C(O)OC(CO)C1)O)=O,,,2,1,9,12,21
255_0,,,,2,1,2,3
C1(C(CO)OC(C(C1)O)O)=O,,,2,1,11,12,23
257_0,,,,2,1,2,3
C1(CC(C(C(CO1)O)O)O)=O,,,2,1,8,8,16
259_0,,,,2,1,2,3
C1(COCC(C(C1O)O)O)=O,,,2,1,14,12,26
261_0,,,,2,1,2,3
C1(C(O)OCC(C(C1)O)O)=O,,,2,1,11,11,22
263_0,,,,2,1,2,3
C1(C(C(COC(C1)O)O)O)=O,,,2,1,12,13,25
265_0,,,,2,1,2,3
C1(C(C(O)OCC(C1)O)O)=O,,,2,1,10,13,23
267_0,,,,2,1,2,3
C1(C(COC(C(C1)O)O)O)=O,,,2,1,11,12,23
269_0,,,,2,1,2,3
C1(C(C(C(O)OCC1)O)O)=O,,,2,1,13,14,27
271_0,,,,2,1,2,3
C1(COC(C(C(C1)O)O)O)=O,,,2,1,11,13,24
273_0,,,,2,1,2,3
C(CC(C(O)=O)O)(CCO)=O,,,2,1,19,15,34
275_0,,,,2,1,2,3
C(C(CCC(CO)=O)O)(O)=O,,,2,1,16,13,29
277_0,,,,2,1,2,3
C(C(CC(C(C)=O)O)O)(O)=O,,,2,1,16,12,28
279_0,,,,2,1,2,3
C(CC(CC(C(O)=O)O)O)=O,,,2,1,17,16,33
281_0,,,,2,1,2,3
C(C(C(CC(CO)O)=O)=O)=O,,,2,1,14,17,31
283_0,,,,2,1,2,3
C(C(CO)O)(CC(C=O)=O)=O,,,2,1,21,22,43
285_0,,,,2,1,2,3
C(CCO)(C(C(C=O)=O)O)=O,,,2,1,16,19,35
287_0,,,,2,1,2,3
C(CO)(CC(C(C=O)=O)O)=O,,,2,1,19,22,41
289_0,,,,2,1,2,3
C(C)(C(C(C(C=O)=O)O)O)=O,,,2,1,21,23,44
291_0,,,,2,1,2,3
C(CC(C(C(C=O)=O)O)O)=O,,,2,1,19,24,43
293_0,,,,2,1,2,3
C(C(CO)O)=CC(C=O)=O,,,2,1,9,15,24
295_0,,,,2,1,2,3
C(C(C(C=CCO)=O)O)=O,,,2,1,13,19,32
297_0,,,,2,1,2,3
C(C=CC(C(CO)O)=O)=O,,,2,1,21,28,49
299_0,,,,2,1,2,3
C(C(C(C(C=C)=O)O)O)=O,,,2,1,28,34,62
301_0,,,,2,1,2,3
C(C(C=CC(CO)=O)O)=O,,,2,1,18,25,43
303_0,,,,2,1,2,3
C(C(C(C=CC=O)O)O)=O,,,2,1,21,28,49
305_0,,,,2,1,2,3
C(C(C(CO)O)O)=CC(O)=O,,,2,1,8,8,16
307_0,,,,2,1,2,3
C(C(C=CC(CO)O)O)(O)=O,,,2,1,10,8,18
308_0,,,,2,2,1,3
309_0,,,,2,2,1,3
310_0,,,,2,2,1,3
311_0,,,,2,2,1,3
312_0,,,,2,2,1,3
313_0,,,,2,2,1,3
314_0,,,,2,2,1,3
315_0,,,,2,2,1,3
316_0,,,,2,2,1,3
318_0,,,,2,1,1,2
C1C(C(C(O)O1)O)O,,,2,1,3,5,8
320_0,,,,2,1,1,2
C(C1(C(C(C(CO)O1)O)O)O)O,,,2,1,4,5,9
321_0,,,,2,1,1,2
323_0,,,,2,1,1,2
C(C1(CC(C(CO)O1)O)O)=O,,,2,1,4,7,11
324_0,,,,2,1,1,2
326_0,,,,2,1,1,2
C(CC1(C(C(CO1)O)O)O)=O,,,2,1,8,13,21
328_0,,,,2,1,1,2
C(C(C1(CC(CO1)O)O)O)=O,,,2,1,8,14,22
330_0,,,,2,1,1,2
C(C1C(CC(CO)(O1)O)O)=O,,,2,1,8,11,19
332_0,,,,2,1,1,2
C(C1C(C(C(C)(O1)O)O)O)=O,,,2,1,9,12,21
333_0,,,,2,1,1,2
335_0,,,,2,1,1,2
C(C(C1C(CC(O)O1)O)O)=O,,,2,1,9,12,21
336_0,,,,2,1,1,2
338_0,,,,2,1,1,2
C1(C(O)OC(C(CO)O)C1O)=O,,,2,1,6,7,13
340_0,,,,2,1,1,2
C(C1(C(C(C(CO)O1)O)O)O)=O,,,2,1,6,10,16
342_0,,,,2,1,1,2
C1C(C(C(C(CO)(O)O1)O)O)O,,,2,1,6,7,13
343_0,,,,2,1,1,2
345_0,,,,2,1,1,2
C(C1(CC(C(CO1)O)O)O)=O,,,2,1,6,9,15
346_0,,,,2,1,1,2
347_0,,,,2,1,1,2
348_0,,,,2,1,1,2
350_0,,,,2,1,1,2
C(C1C(C(CC(O1)O)O)O)=O,,,2,1,10,12,22
352_0,,,,2,1,1,2
C1(C(O)OC(CO)C(C1O)O)=O,,,2,1,7,8,15
354_0,,,,2,1,1,2
C(C1(C(C(C(CO1)O)O)O)O)=O,,,2,1,8,12,20
355_0,,,,2,1,1,2
356_0,,,,2,1,1,2
357_0,,,,2,1,1,2
358_0,,,,2,1,1,2
359_0,,,,2,1,1,2
360_0,,,,2,1,1,2
362_0,,,,2,1,1,2
C1(C(O)OCC(C(C1O)O)O)=O,,,2,1,9,10,19
363_0,,,,2,1,1,2
364_0,,,,2,1,1,2
365_0,,,,2,1,1,2
367_0,,,,2,1,2,3
C1(C(C(C(C(CO)O)O1)O)O)=O,,,2,1,9,5,14
369_0,,,,2,1,2,3
C1(C(CC(C(CO)O)O1)O)=O,,,2,1,8,4,12
371_0,,,,2,1,2,3
C1(C(C(C(C(CO)O1)O)O)O)=O,,,2,1,8,6,14
373_0,,,,2,1,2,3
C1(C(CC(C(CO)O1)O)O)=O,,,2,1,6,4,10
375_0,,,,2,1,2,3
C1(C(C(C(C(CO1)O)O)O)O)=O,,,2,1,9,9,18
377_0,,,,2,1,2,3
C1(C(CC(C(CO1)O)O)O)=O,,,2,1,7,7,14
378_0,,,,2,3,5,8
379_0,,,,2,3,5,8
381_0,,,,2,2,2,4
C(C(CCO)O)(O)=O,,,2,1,16,17,33
382_0,,,,2,2,2,4
383_0,,,,2,2,2,4
384_0,,,,2,2,2,4
385_0,,,,2,2,2,4
386_0,,,,2,3,5,8
388_0,,,,2,3,5,8
C(C(C(CO)O)=O)=O,,,2,1,55,62,117
389_0,,,,2,3,5,8
390_0,,,,2,3,5,8
391_0,,,,2,3,5,8
392_0,,,,2,3,5,8
393_0,,,,2,3,5,8
395_0,,,,2,5,3,8
C(C(CC(C(CO)O)O)O)=O,,,2,1,14,15,29
396_0,,,,2,5,3,8
397_0,,,,2,4,4,8
398_0,,,,2,4,4,8
399_0,,,,2,4,4,8
400_0,,,,2,4,4,8
401_0,,,,2,4,4,8
402_0,,,,2,4,4,8
403_0,,,,2,4,4,8
404_0,,,,2,4,4,8
406_0,,,,2,1,1,2
C1(C(C(C(C1)O)O)O)=O,,,3,1,8,32,40
406_1,,,,2,1,1,2
407_0,,,,2,1,1,2
409_0,,,,2,1,1,2
C1(C(C(C(CC1O)O)O)O)=O,,,3,1,5,14,19
409_1,,,,2,1,1,2
411_0,,,,2,1,1,2
C1(C(C(C(C1)O)(CO)O)O)=O,,,3,1,9,15,24
411_1,,,,2,1,1,2
413_0,,,,2,1,1,2
C1(C(CC(CO)(C1O)O)O)=O,,,3,1,3,13,16
413_1,,,,2,1,1,2
415_0,,,,2,1,1,2
C1(C(C(C(CO)(C1)O)O)O)=O,,,3,1,9,16,25
417_0,,,,2,1,1,2
C1(C(C(C(C)(C1O)O)O)O)=O,,,3,1,6,15,21
417_1,,,,2,1,1,2
419_0,,,,2,1,1,2
C1(C(C(CC(C1O)O)O)O)=O,,,3,1,4,8,12
419_1,,,,2,1,1,2
421_0,,,,2,1,1,2
C1(C(CO)C(C(C1)=O)O)=O,,,3,1,6,26,32
421_1,,,,2,1,1,2
423_0,,,,2,1,1,2
C1(CCC(C(C1O)O)=O)=O,,,3,1,3,15,18
423_1,,,,2,1,1,2
425_0,,,,2,1,1,2
C(C1(CCC(C1O)=O)O)=O,,,3,1,5,22,27
425_1,,,,2,1,1,2
427_0,,,,2,1,1,2
C1(CC(C(CC1O)=O)O)=O,,,3,1,2,14,16
429_0,,,,2,1,1,2
C(C1(CC(C(C1)=O)O)O)=O,,,3,1,3,21,24
431_0,,,,2,1,1,2
C(C1C(CC(C1O)=O)O)=O,,,3,1,7,27,34
431_1,,,,2,1,1,2
433_0,,,,2,1,1,2
C1(C(CC(C1CO)O)=O)=O,,,3,1,4,23,27
433_1,,,,2,1,1,2
435_0,,,,2,1,1,2
C1(CC(C(C(C1)=O)O)O)=O,,,3,1,5,30,35
435_1,,,,2,1,1,2
437_0,,,,2,1,1,2
C1(CC(CC(C1O)=O)O)=O,,,3,1,2,17,19
438_0,,,,2,1,1,2
438_1,,,,2,1,1,2
440_0,,,,2,1,1,2
C(C1C(C(CC1O)O)=O)=O,,,3,1,5,20,25
440_1,,,,2,1,1,2
441_0,,,,2,1,1,2
443_0,,,,2,1,1,2
C(C1C(C(C(C1)=O)O)O)=O,,,3,1,4,28,32
445_0,,,,2,1,1,2
C1(C(CC(C(C1)O)O)=O)=O,,,3,1,2,13,15
447_0,,,,2,1,1,2
C(C1C(CC(C1O)O)=O)=O,,,3,1,5,25,30
447_1,,,,2,1,1,2
449_0,,,,2,1,1,2
C1(C(CO)C(C(C1O)=O)O)=O,,,3,1,2,16,18
449_1,,,,2,1,1,2
451_0,,,,2,1,1,2
C1(C(C(C(CC1O)=O)O)O)=O,,,3,1,5,19,24
451_1,,,,2,1,1,2
453_0,,,,2,1,1,2
C(C1(C(CC(C1O)=O)O)O)=O,,,3,1,7,20,27
453_1,,,,2,1,1,2
454_0,,,,2,1,1,2
456_0,,,,2,1,1,2
C(C1(C(C(C(C1)=O)O)O)O)=O,,,3,1,2,19,21
458_0,,,,2,1,1,2
C(C1C(C(C(C1O)=O)O)O)=O,,,3,1,5,21,26
458_1,,,,2,1,1,2
460_0,,,,2,1,1,2
C1C(C(C(C(C=1)=O)O)O)O,,,3,1,4,21,25
460_1,,,,2,1,1,2
462_0,,,,2,2,1,3
C1(C(C(C(C(C1CO)O)O)O)O)=O,,,3,1,6,16,22
462_1,,,,2,2,1,3
464_0,,,,2,2,1,3
C(CO)(C(C(CO)(CO)O)O)=O,,,3,1,4,7,11
464_1,,,,2,2,1,3
465_0,,,,2,2,1,3
465_1,,,,2,2,1,3
466_0,,,,2,2,1,3
466_1,,,,2,2,1,3
468_0,,,,2,2,1,3
C(C(C)(C(C(CO)=O)O)O)=O,,,3,1,11,17,28
468_1,,,,2,2,1,3
470_0,,,,2,2,1,3
C(C(CC(CO)(CO)O)=O)=O,,,3,1,4,14,18
472_0,,,,2,2,1,3
C(CO)(CC(C(C(CO)=O)O)O)=O,,,3,1,7,16,23
472_1,,,,2,2,1,3
474_0,,,,2,2,1,3
C(CC(CO)(C(C(CO)=O)O)O)=O,,,3,1,5,15,20
474_1,,,,2,2,1,3
476_0,,,,2,2,1,3
C(C(C(CO)=O)C(CO)(CO)O)=O,,,3,1,4,9,13
476_1,,,,2,2,1,3
478_0,,,,2,2,1,3
C(CC(C(C(CO)(CO)O)O)=O)=O,,,3,1,6,10,16
478_1,,,,2,2,1,3
480_0,,,,2,2,1,3
C(C)(C(C(C(C(CO)=O)O)O)O)=O,,,3,1,7,17,24
480_1,,,,2,2,1,3
482_0,,,,2,2,1,3
C(C(C(C)(C(C(CO)=O)O)O)O)=O,,,3,1,6,17,23
482_1,,,,2,2,1,3
484_0,,,,2,2,1,3
C(C(C(CC(CO)(CO)O)=O)O)=O,,,3,1,3,9,12
486_0,,,,2,2,1,3
C(C(C(C(CO)=O)O)O)=O,,,3,1,16,37,53
486_1,,,,2,2,1,3
488_0,,,,2,2,1,3
C(CO)(C(C(C)(C(CO)O)O)O)=O,,,3,1,4,11,15
488_1,,,,2,2,1,3
490_0,,,,2,2,1,3
C(C(CO)O)(CC(CO)(CO)O)=O,,,3,1,5,9,14
491_0,,,,2,2,1,3
491_1,,,,2,2,1,3
493_0,,,,2,2,1,3
C(C(C(C(CCO)=O)O)O)(CO)=O,,,3,1,9,17,26
493_1,,,,2,2,1,3
495_0,,,,2,2,1,3
C(C(CCO)(C(C(CO)=O)O)O)=O,,,3,1,5,15,20
495_1,,,,2,2,1,3
497_0,,,,2,2,1,3
C(C(C(CO)C(CO)(CO)O)=O)=O,,,3,1,5,13,18
497_1,,,,2,2,1,3
499_0,,,,2,2,1,3
C(CO)(C(C(CO)(CCO)O)O)=O,,,3,1,5,10,15
499_1,,,,2,2,1,3
501_0,,,,2,2,1,3
C(C(C(CO)(CO)O)O)(CCO)=O,,,3,1,5,8,13
501_1,,,,2,2,1,3
503_0,,,,2,2,1,3
C(CO)(C(CO)C(CO)(CO)O)=O,,,3,1,7,9,16
503_1,,,,2,2,1,3
505_0,,,,2,2,1,3
C(C(C(C(C(CO)=O)O)O)O)=O,,,3,1,11,21,32
505_1,,,,2,2,1,3
507_0,,,,2,2,1,3
C(CO)(C(C(CO)(C)O)O)=O,,,3,1,9,12,21
507_1,,,,2,2,1,3
509_0,,,,2,2,1,3
C(CO)(CC(CO)(CO)O)=O,,,3,1,7,10,17
511_0,,,,2,2,1,3
C(C)(C(C(CO)(CO)O)O)=O,,,3,1,7,10,17
511_1,,,,2,2,1,3
513_0,,,,2,2,1,3
C(CC(C(C(C(CO)=O)O)O)O)=O,,,3,1,5,20,25
513_1,,,,2,2,1,3
515_0,,,,2,2,1,3
C(C(CC(C(C(CO)=O)O)O)O)=O,,,3,1,5,19,24
515_1,,,,2,2,1,3
517_0,,,,2,2,1,3
C(C(C(CO)(CO)O)C(C=O)O)=O,,,3,1,6,14,20
517_1,,,,2,2,1,3
519_0,,,,2,2,1,3
C(CO)(C(C(C)O)O)=O,,,3,1,8,30,38
519_1,,,,2,2,1,3
521_0,,,,2,2,1,3
C(CC(CO)(CO)O)=O,,,3,1,4,20,24
523_0,,,,2,2,1,3
C(CO)(C(C(C(CO)=O)O)O)=O,,,3,1,4,8,12
523_1,,,,2,2,1,3
525_0,,,,2,2,1,3
C(C(CO)(C(C(CO)=O)O)O)=O,,,3,1,9,18,27
525_1,,,,2,2,1,3
527_0,,,,2,2,1,3
C(C(C(C(CO)(CO)O)O)=O)=O,,,3,1,3,14,17
527_1,,,,2,2,1,3
528_0,,,,2,2,1,3
530_0,,,,2,2,1,3
C(C(C(CO)=O)C(C(CO)O)O)=O,,,3,1,5,14,19
530_1,,,,2,2,1,3
532_0,,,,2,2,1,3
C(CC(C(C(C(CO)O)O)O)=O)=O,,,3,1,6,15,21
532_1,,,,2,2,1,3
534_0,,,,2,2,1,3
C(C(C(CC(C(CO)O)O)=O)O)=O,,,3,1,4,13,17
536_0,,,,2,2,1,3
C(C(CO)O)(CC(C(CO)O)O)=O,,,3,1,6,13,19
538_0,,,,2,2,1,3
C(C(C(CO)C(C(CO)O)O)=O)=O,,,3,1,12,18,30
538_1,,,,2,2,1,3
540_0,,,,2,2,1,3
C(C(C(C(CO)O)O)O)(CCO)=O,,,3,1,7,13,20
540_1,,,,2,2,1,3
542_0,,,,2,2,1,3
C(CO)(C(CO)C(C(CO)O)O)=O,,,3,1,8,13,21
542_1,,,,2,2,1,3
543_0,,,,2,2,1,3
544_0,,,,2,2,1,3
544_1,,,,2,2,1,3
546_0,,,,2,2,1,3
C(C(C(C(CO)O)O)C(C=O)O)=O,,,3,1,7,19,26
546_1,,,,2,2,1,3
548_0,,,,2,2,1,3
C(CC(C(CO)O)O)=O,,,3,1,6,24,30
549_0,,,,2,2,1,3
549_1,,,,2,2,1,3
550_0,,,,2,2,1,3
552_0,,,,2,2,1,3
C(C(C)(CC(C=O)=O)O)=O,,,3,1,3,21,24
554_0,,,,2,2,1,3
C(CO)(CC(CC(C=O)=O)O)=O,,,3,1,6,20,26
556_0,,,,2,2,1,3
C(CC(CO)(CC(C=O)=O)O)=O,,,3,1,4,20,24
558_0,,,,2,2,1,3
C(C(C(CO)=O)C(C(C)=O)O)=O,,,3,1,6,16,22
558_1,,,,2,2,1,3
560_0,,,,2,2,1,3
C(C(C)(C(C=O)C(CO)=O)O)=O,,,3,1,5,15,20
560_1,,,,2,2,1,3
562_0,,,,2,2,1,3
C(CC(C(C(C(C)=O)O)O)=O)=O,,,3,1,7,21,28
562_1,,,,2,2,1,3
564_0,,,,2,2,1,3
C(C(C)(C(C(CC=O)=O)O)O)=O,,,3,1,4,17,21
564_1,,,,2,2,1,3
566_0,,,,2,2,1,3
C(C)(C(C(CC(C=O)=O)O)O)=O,,,3,1,6,21,27
568_0,,,,2,2,1,3
C(C(C(C)(CC(C=O)=O)O)O)=O,,,3,1,4,22,26
570_0,,,,2,2,1,3
C(C(C(CC(C(C)=O)O)=O)O)=O,,,3,1,3,17,20
572_0,,,,2,2,1,3
C(C(C)(CC(C(C=O)O)=O)O)=O,,,3,1,1,15,16
574_0,,,,2,2,1,3
C(C(CC(C=O)=O)O)=O,,,3,1,15,38,53
576_0,,,,2,2,1,3
C(C(CC(C)(C(CO)O)O)=O)=O,,,3,1,2,17,19
578_0,,,,2,2,1,3
C(CC(C(C)=O)O)(C(CO)O)=O,,,3,1,6,15,21
580_0,,,,2,2,1,3
C(C(C)(CC(C(CO)O)=O)O)=O,,,3,1,4,15,19
581_0,,,,2,2,1,3
583_0,,,,2,2,1,3
C(C(CC(C=O)=O)O)(CCO)=O,,,3,1,5,18,23
585_0,,,,2,2,1,3
C(C(CCO)(CC(C=O)=O)O)=O,,,3,1,1,16,17
587_0,,,,2,2,1,3
C(C(C(C(C=O)=O)CO)O)(C)=O,,,3,1,5,19,24
587_1,,,,2,2,1,3
589_0,,,,2,2,1,3
C(C(C)(C(C(C=O)=O)CO)O)=O,,,3,1,4,18,22
589_1,,,,2,2,1,3
591_0,,,,2,2,1,3
C(C(CC(CO)(CCO)O)=O)=O,,,3,1,3,16,19
593_0,,,,2,2,1,3
C(C(C(C(CCO)=O)O)O)(C)=O,,,3,1,8,16,24
593_1,,,,2,2,1,3
595_0,,,,2,2,1,3
C(C(C)(C(C(CCO)=O)O)O)=O,,,3,1,5,15,20
595_1,,,,2,2,1,3
597_0,,,,2,2,1,3
C(CO)(C(CO)C(C(C)=O)O)=O,,,3,1,8,15,23
597_1,,,,2,2,1,3
599_0,,,,2,2,1,3
C(C(C)(C(C(CO)=O)CO)O)=O,,,3,1,6,15,21
599_1,,,,2,2,1,3
601_0,,,,2,2,1,3
C(C(C(CC(C=O)=O)O)O)=O,,,3,1,13,27,40
603_0,,,,2,2,1,3
C(C(CC(C)(CO)O)=O)=O,,,3,1,4,21,25
605_0,,,,2,2,1,3
C(C)(C(CC(CO)=O)O)=O,,,3,1,10,30,40
607_0,,,,2,2,1,3
C(C(C)(CC(CO)=O)O)=O,,,3,1,6,24,30
609_0,,,,2,2,1,3
C(C)(C(C(C(C)=O)O)O)=O,,,3,1,7,16,23
609_1,,,,2,2,1,3
611_0,,,,2,2,1,3
C(C(C)(C(C(C)=O)O)O)=O,,,3,1,7,22,29
611_1,,,,2,2,1,3
613_0,,,,2,2,1,3
C(CC(C(CC(C=O)=O)O)O)=O,,,3,1,3,25,28
615_0,,,,2,2,1,3
C(C(CC(CC(C=O)=O)O)O)=O,,,3,1,2,23,25
617_0,,,,2,2,1,3
C(C(C(C=O)C(C(C)=O)O)O)=O,,,3,1,6,20,26
617_1,,,,2,2,1,3
619_0,,,,2,2,1,3
C(C(C(C=O)C(C=O)(C)O)O)=O,,,3,1,5,19,24
619_1,,,,2,2,1,3
621_0,,,,2,2,1,3
C(C(C(C(CC(C=O)=O)O)O)O)=O,,,3,1,3,26,29
623_0,,,,2,2,1,3
C(C(CC(C)O)=O)=O,,,3,1,10,60,70
625_0,,,,2,2,1,3
C(CC(C(C)=O)O)=O,,,3,1,11,82,93
627_0,,,,2,2,1,3
C(C(C)(CC=O)O)=O,,,3,1,6,58,64
629_0,,,,2,2,1,3
C(CO)(C(CC(C=O)=O)O)=O,,,3,1,13,22,35
631_0,,,,2,2,1,3
C(C(CO)(CC(C=O)=O)O)=O,,,3,1,5,18,23
632_0,,,,2,2,1,3
632_1,,,,2,2,1,3
634_0,,,,2,2,1,3
C(C(C)(C(C(C=O)=O)O)O)=O,,,3,1,6,18,24
634_1,,,,2,2,1,3
636_0,,,,2,2,1,3
C(C(CC(CO)(C(CO)O)O)=O)=O,,,3,1,5,15,20
638_0,,,,2,2,1,3
C(C(C(C(C(CO)O)=O)O)O)(C)=O,,,3,1,8,18,26
638_1,,,,2,2,1,3
640_0,,,,2,2,1,3
C(C(C)(C(C(C(CO)O)=O)O)O)=O,,,3,1,6,17,23
640_1,,,,2,2,1,3
642_0,,,,2,2,1,3
C(C(CC(C=O)=O)O)(C(CO)O)=O,,,3,1,4,18,22
644_0,,,,2,2,1,3
C(C(C(CO)O)(CC(C=O)=O)O)=O,,,3,1,2,16,18
646_0,,,,2,2,1,3
C(C(C(CO)=O)C(C=O)O)=O,,,3,1,7,21,28
646_1,,,,2,2,1,3
648_0,,,,2,2,1,3
C(CC(C(C(C=O)O)O)=O)=O,,,3,1,14,29,43
648_1,,,,2,2,1,3
650_0,,,,2,2,1,3
C(C(C(CO)=O)CO)=O,,,3,1,10,30,40
650_1,,,,2,2,1,3
652_0,,,,2,2,1,3
C(CC(C(CO)O)=O)=O,,,3,1,13,37,50
652_1,,,,2,2,1,3
654_0,,,,2,2,1,3
C(C(C(C(C=O)C(CO)=O)O)O)=O,,,3,1,4,19,23
654_1,,,,2,2,1,3
656_0,,,,2,2,1,3
C(CC(C(C(C(C=O)O)O)O)=O)=O,,,3,1,3,23,26
656_1,,,,2,2,1,3
658_0,,,,2,2,1,3
C(C(C(CO)=O)C(CO)(C)O)=O,,,3,1,6,13,19
658_1,,,,2,2,1,3
660_0,,,,2,2,1,3
C(CC(C(C(CO)(C)O)O)=O)=O,,,3,1,4,14,18
660_1,,,,2,2,1,3
662_0,,,,2,2,1,3
C(CO)(CC(CC(CO)=O)O)=O,,,3,1,4,7,11
664_0,,,,2,2,1,3
C(CC(CO)(CC(CO)=O)O)=O,,,3,1,5,15,20
666_0,,,,2,2,1,3
C(C)(C(C(CC(CO)=O)O)O)=O,,,3,1,7,15,22
666_1,,,,2,2,1,3
668_0,,,,2,2,1,3
C(CC(CO)(C(C(C)=O)O)O)=O,,,3,1,5,15,20
668_1,,,,2,2,1,3
670_0,,,,2,2,1,3
C(C(C(CO)=O)C(C)O)=O,,,3,1,5,21,26
670_1,,,,2,2,1,3
672_0,,,,2,2,1,3
C(CC(C(C(C)O)O)=O)=O,,,3,1,3,26,29
672_1,,,,2,2,1,3
674_0,,,,2,2,1,3
C(CC(CC(CO)=O)O)=O,,,3,1,6,32,38
676_0,,,,2,2,1,3
C(CC(CO)(CC=O)O)=O,,,3,1,2,14,16
678_0,,,,2,2,1,3
C(C(C(CO)=O)C(C(CO)=O)O)=O,,,3,1,4,17,21
678_1,,,,2,2,1,3
680_0,,,,2,2,1,3
C(CC(C(C(C(CO)=O)O)O)=O)=O,,,3,1,5,21,26
680_1,,,,2,2,1,3
682_0,,,,2,2,1,3
C(C(CO)(C(C=O)C(CO)=O)O)=O,,,3,1,4,15,19
682_1,,,,2,2,1,3
684_0,,,,2,2,1,3
C(C(CO)(C(C(CC=O)=O)O)O)=O,,,3,1,6,19,25
684_1,,,,2,2,1,3
686_0,,,,2,2,1,3
C(CO)(CC(C(C(C=O)=O)O)O)=O,,,3,1,5,20,25
686_1,,,,2,2,1,3
688_0,,,,2,2,1,3
C(CC(CO)(C(C(C=O)=O)O)O)=O,,,3,1,2,18,20
688_1,,,,2,2,1,3
690_0,,,,2,2,1,3
C(C(C(CC(C=O)O)=O)O)=O,,,3,1,8,23,31
692_0,,,,2,2,1,3
C(C(C(CCO)=O)O)=O,,,3,1,8,35,43
694_0,,,,2,2,1,3
C(CC(C(C=O)O)O)(C(C=O)O)=O,,,3,1,2,21,23
696_0,,,,2,2,1,3
C(C(C(CC(CO)(C)O)=O)O)=O,,,3,1,2,13,15
697_0,,,,2,2,1,3
699_0,,,,2,2,1,3
C(C(C(C)(CC(CO)=O)O)O)=O,,,3,1,2,17,19
701_0,,,,2,2,1,3
C(C)(C(C(C(C(C)=O)O)O)O)=O,,,3,1,3,8,11
701_1,,,,2,2,1,3
703_0,,,,2,2,1,3
C(C(C(C)(C(C(C)=O)O)O)O)=O,,,3,1,2,17,19
703_1,,,,2,2,1,3
705_0,,,,2,2,1,3
C(C(C(CC(C)O)=O)O)=O,,,3,1,1,24,25
707_0,,,,2,2,1,3
C(CC(C(C(C)=O)O)O)=O,,,3,1,5,30,35
709_0,,,,2,2,1,3
C(CC(C)(C(C=O)O)O)=O,,,3,1,4,29,33
711_0,,,,2,2,1,3
C(C(C(CC(C(CO)=O)O)=O)O)=O,,,3,1,2,17,19
713_0,,,,2,2,1,3
C(C(CO)(CC(C(C=O)O)=O)O)=O,,,3,1,2,15,17
715_0,,,,2,2,1,3
C(C)(C(C(C(C(C=O)=O)O)O)O)=O,,,3,1,5,21,26
715_1,,,,2,2,1,3
717_0,,,,2,2,1,3
C(C(C(C)(C(C(C=O)=O)O)O)O)=O,,,3,1,5,20,25
717_1,,,,2,2,1,3
718_0,,,,2,2,1,3
720_0,,,,2,2,1,3
C(C(C(C(CO)=O)C(C=O)O)O)=O,,,3,1,2,11,13
720_1,,,,2,2,1,3
722_0,,,,2,2,1,3
C(C(C(C(CC(C=O)O)=O)O)O)=O,,,3,1,5,26,31
722_1,,,,2,2,1,3
724_0,,,,2,2,1,3
C(C(C(C(C=O)=O)CO)O)=O,,,3,1,6,22,28
724_1,,,,2,2,1,3
725_0,,,,2,2,1,3
725_1,,,,2,2,1,3
727_0,,,,2,2,1,3
C(CO)(C(CO)C(C=O)O)=O,,,3,1,13,21,34
727_1,,,,2,2,1,3
728_0,,,,2,2,1,3
729_0,,,,2,2,1,3
730_0,,,,2,2,1,3
730_1,,,,2,2,1,3
732_0,,,,2,2,1,3
C(C(C(C=O)C(C=O)O)O)=O,,,3,1,5,14,19
732_1,,,,2,2,1,3
733_0,,,,2,2,1,3
735_0,,,,2,2,1,3
C(C(C(C(C=O)=O)O)O)=O,,,3,1,14,35,49
735_1,,,,2,2,1,3
737_0,,,,2,2,1,3
C(C(C(C=O)O)O)(C(CO)O)=O,,,3,1,10,22,32
737_1,,,,2,2,1,3
739_0,,,,2,2,1,3
C(C(CO)O)(CCO)=O,,,3,1,15,31,46
741_0,,,,2,2,1,3
C(C(CO)O)(CC(C(C=O)O)O)=O,,,3,1,15,19,34
743_0,,,,2,2,1,3
C(C(CO)O)(CC(CO)(C)O)=O,,,3,1,5,11,16
745_0,,,,2,2,1,3
C(CO)(CC(C)(C(CO)O)O)=O,,,3,1,3,10,13
747_0,,,,2,2,1,3
C(C)(C(C(C)(C(CO)O)O)O)=O,,,3,1,3,11,14
747_1,,,,2,2,1,3
749_0,,,,2,2,1,3
C(C(CO)O)(CC(C)O)=O,,,3,1,4,22,26
751_0,,,,2,2,1,3
C(CC(C)(C(CO)O)O)=O,,,3,1,2,18,20
753_0,,,,2,2,1,3
C(CC(C(CO)=O)O)(C(CO)O)=O,,,3,1,7,16,23
755_0,,,,2,2,1,3
C(C(CO)(CC(C(CO)O)=O)O)=O,,,3,1,8,16,24
757_0,,,,2,2,1,3
C(C(C(C(C)(C(CO)O)O)O)=O)=O,,,3,1,3,16,19
757_1,,,,2,2,1,3
758_0,,,,2,2,1,3
758_1,,,,2,2,1,3
759_0,,,,2,2,1,3
759_1,,,,2,2,1,3
761_0,,,,2,2,1,3
C(CO)(C(C(C)O)C(C=O)O)=O,,,3,1,4,18,22
761_1,,,,2,2,1,3
763_0,,,,2,2,1,3
C(CC(C=O)O)(C(C(C)O)O)=O,,,3,1,3,18,21
763_1,,,,2,2,1,3
765_0,,,,2,2,1,3
C(CC(C(CC(CO)=O)O)O)=O,,,3,1,4,19,23
767_0,,,,2,2,1,3
C(CC(CO)(CC(C=O)O)O)=O,,,3,1,3,20,23
769_0,,,,2,2,1,3
C(C(C(CO)CO)=O)=O,,,3,1,6,21,27
769_1,,,,2,2,1,3
770_0,,,,2,2,1,3
770_1,,,,2,2,1,3
772_0,,,,2,2,1,3
C(CO)(C(CO)CO)=O,,,3,1,8,23,31
772_1,,,,2,2,1,3
773_0,,,,2,2,1,3
774_0,,,,2,2,1,3
775_0,,,,2,2,1,3
775_1,,,,2,2,1,3
777_0,,,,2,2,1,3
C(C(CO)C(C=O)O)=O,,,3,1,9,31,40
777_1,,,,2,2,1,3
779_0,,,,2,2,1,3
C(CCO)=O,,,3,1,32,354,386
780_0,,,,2,2,1,3
780_1,,,,2,2,1,3
782_0,,,,2,2,1,3
C(C(CO)O)(C(CO)O)=O,,,3,1,4,12,16
782_1,,,,2,2,1,3
784_0,,,,2,2,1,3
C(C(CO)C(C(C(CO)O)=O)O)=O,,,3,1,7,18,25
784_1,,,,2,2,1,3
786_0,,,,2,2,1,3
C(C(C(CO)O)=O)(CC(CO)O)=O,,,3,1,2,14,16
786_1,,,,2,2,1,3
788_0,,,,2,2,1,3
C(C(CO)=O)(C(CO)C(CO)O)=O,,,3,1,4,14,18
788_1,,,,2,2,1,3
790_0,,,,2,2,1,3
C(C(CO)O)(CC(C(CO)O)=O)=O,,,3,1,4,7,11
790_1,,,,2,2,1,3
792_0,,,,2,2,1,3
C(C(CO)O)(C(C(CO)=O)CO)=O,,,3,1,6,12,18
792_1,,,,2,2,1,3
794_0,,,,2,2,1,3
C(C(CC(C(C(CO)O)=O)O)O)=O,,,3,1,7,16,23
794_1,,,,2,2,1,3
796_0,,,,2,2,1,3
C(CCO)(C(C(C(CO)O)=O)O)=O,,,3,1,5,12,17
796_1,,,,2,2,1,3
798_0,,,,2,2,1,3
C(C(CO)CO)(C(C(CO)=O)O)=O,,,3,1,4,8,12
798_1,,,,2,2,1,3
800_0,,,,2,2,1,3
C(CC(C(C(CO)O)=O)O)(CO)=O,,,3,1,6,16,22
800_1,,,,2,2,1,3
802_0,,,,2,2,1,3
C(CO)(C(CO)C(C(CO)=O)O)=O,,,3,1,9,16,25
802_1,,,,2,2,1,3
803_0,,,,2,2,1,3
803_1,,,,2,2,1,3
804_0,,,,2,2,1,3
804_1,,,,2,2,1,3
805_0,,,,2,2,1,3
807_0,,,,2,2,1,3
C(CC(C(C(C(CO)O)=O)O)O)=O,,,3,1,6,17,23
807_1,,,,2,2,1,3
809_0,,,,2,2,1,3
C(C(CO)C(C(C(CO)=O)O)O)=O,,,3,1,8,18,26
809_1,,,,2,2,1,3
810_0,,,,2,2,1,3
810_1,,,,2,2,1,3
811_0,,,,2,2,1,3
811_1,,,,2,2,1,3
813_0,,,,2,2,1,3
C(C(C(CO)O)O)(C(CO)CO)=O,,,3,1,6,11,17
813_1,,,,2,2,1,3
815_0,,,,2,2,1,3
C(C(CO)O)(C(CO)C(CO)O)=O,,,3,1,8,14,22
815_1,,,,2,2,1,3
816_0,,,,2,2,1,3
818_0,,,,2,2,1,3
C(C(CO)C(C(C(CO)O)O)O)=O,,,3,1,5,16,21
818_1,,,,2,2,1,3
820_0,,,,2,2,1,3
C1(C(CO)(C(C(C1CO)O)O)O)=O,,,3,1,8,16,24
820_1,,,,2,2,1,3
822_0,,,,2,2,1,3
C(CCO)(C(C(C=O)=O)CO)=O,,,3,1,5,18,23
822_1,,,,2,2,1,3
824_0,,,,2,2,1,3
C(C(CO)CO)(CC(C=O)=O)=O,,,3,1,4,14,18
824_1,,,,2,2,1,3
826_0,,,,2,2,1,3
C(CC(C(C=O)=O)CO)(CO)=O,,,3,1,3,19,22
828_0,,,,2,2,1,3
C(CO)(C(CO)CC(C=O)=O)=O,,,3,1,5,19,24
830_0,,,,2,2,1,3
C(CCC(C=O)=O)(C(CO)O)=O,,,3,1,5,19,24
830_1,,,,2,2,1,3
831_0,,,,2,2,1,3
831_1,,,,2,2,1,3
832_0,,,,2,2,1,3
834_0,,,,2,2,1,3
C(CC(C(C(C=O)=O)CO)O)=O,,,3,1,5,22,27
834_1,,,,2,2,1,3
836_0,,,,2,2,1,3
C(C(CO)C(CC(C=O)=O)O)=O,,,3,1,6,21,27
836_1,,,,2,2,1,3
838_0,,,,2,2,1,3
C(C(C(C(CCO)=O)=O)CO)=O,,,3,1,4,16,20
838_1,,,,2,2,1,3
840_0,,,,2,2,1,3
C(CC(C(C(CO)CO)=O)=O)=O,,,3,1,4,12,16
840_1,,,,2,2,1,3
842_0,,,,2,2,1,3
C(C(C(CC(CO)=O)=O)CO)=O,,,3,1,7,15,22
842_1,,,,2,2,1,3
844_0,,,,2,2,1,3
C(CC=O)(C(C(CO)=O)CO)=O,,,3,1,7,15,22
844_1,,,,2,2,1,3
846_0,,,,2,2,1,3
C(CC(CC(C(CO)O)=O)=O)=O,,,3,1,6,16,22
846_1,,,,2,2,1,3
848_0,,,,2,2,1,3
C(C(C(C(C(C)=O)O)=O)CO)=O,,,3,1,4,13,17
848_1,,,,2,2,1,3
850_0,,,,2,2,1,3
C(CC(C(C(CCO)=O)O)=O)=O,,,3,1,4,13,17
852_0,,,,2,2,1,3
C(CC(C(C(C=O)CO)=O)O)=O,,,3,1,6,18,24
852_1,,,,2,2,1,3
854_0,,,,2,2,1,3
C(C(CO)C(C(CC=O)=O)O)=O,,,3,1,8,20,28
854_1,,,,2,2,1,3
856_0,,,,2,2,1,3
C(C(C=O)O)(C(C(C)=O)CO)=O,,,3,1,4,14,18
856_1,,,,2,2,1,3
858_0,,,,2,2,1,3
C(C(C=O)O)(CC(CCO)=O)=O,,,3,1,3,14,17
860_0,,,,2,2,1,3
C(C(CO)CC=O)(C(C=O)O)=O,,,3,1,2,18,20
862_0,,,,2,2,1,3
C(C(CO)CC(C(C=O)O)=O)=O,,,3,1,3,18,21
864_0,,,,2,2,1,3
C(C(C(C(C(C)=O)=O)CO)O)=O,,,3,1,3,18,21
864_1,,,,2,2,1,3
866_0,,,,2,2,1,3
C(C(CC(C(CCO)=O)=O)O)=O,,,3,1,3,16,19
868_0,,,,2,2,1,3
C(C(CO)C(C=O)O)(CC=O)=O,,,3,1,4,22,26
868_1,,,,2,2,1,3
870_0,,,,2,2,1,3
C(CC(C=O)O)(C(C=O)CO)=O,,,3,1,6,19,25
870_1,,,,2,2,1,3
872_0,,,,2,2,1,3
C1(C(CO)OC(C(CO)O)C1O)=O,,,3,1,2,7,9
872_1,,,,2,2,1,3
874_0,,,,2,2,1,3
C1(C(O)OC(C(CO)O)C1CO)=O,,,3,1,3,9,12
874_1,,,,2,2,1,3
876_0,,,,2,2,1,3
C1(C(C(CO)O)OC(C1CO)O)=O,,,3,1,3,12,15
876_1,,,,2,2,1,3
878_0,,,,2,2,1,3
C(C1C(C(C(O1)O)O)O)(CCO)=O,,,3,1,2,10,12
880_0,,,,2,2,1,3
C(C(CO)C1C(C(C(O)O1)O)O)=O,,,3,1,3,12,15
880_1,,,,2,2,1,3
882_0,,,,2,2,1,3
C1(C(CO)OC(C(C1O)O)CO)=O,,,3,1,2,8,10
882_1,,,,2,2,1,3
884_0,,,,2,2,1,3
C1(C(O)OC(CO)C(C1CO)O)=O,,,3,1,3,9,12
884_1,,,,2,2,1,3
886_0,,,,2,2,1,3
C1(C(C(CO)OC(C1CO)O)O)=O,,,3,1,3,9,12
886_1,,,,2,2,1,3
888_0,,,,2,2,1,3
C1(C(C(O)OC(CO)C1CO)O)=O,,,3,1,3,10,13
888_1,,,,2,2,1,3
890_0,,,,2,2,1,3
C1(C(CO)OC(C(C1CO)O)O)=O,,,3,1,3,11,14
890_1,,,,2,2,1,3
892_0,,,,2,2,1,3
C1(C(CO)OCC(C(C1O)O)O)=O,,,3,1,2,10,12
892_1,,,,2,2,1,3
894_0,,,,2,2,1,3
C1(C(O)OCC(C(C1CO)O)O)=O,,,3,1,3,11,14
894_1,,,,2,2,1,3
896_0,,,,2,2,1,3
C1(C(C(COC(C1CO)O)O)O)=O,,,3,1,3,12,15
896_1,,,,2,2,1,3
898_0,,,,2,2,1,3
C1(C(C(O)OCC(C1CO)O)O)=O,,,3,1,3,12,15
898_1,,,,2,2,1,3
900_0,,,,2,2,1,3
C1(C(COC(C(C1CO)O)O)O)=O,,,3,1,3,11,14
900_1,,,,2,2,1,3
902_0,,,,2,2,1,3
C1(C(C(C(O)OCC1CO)O)O)=O,,,3,1,3,12,15
902_1,,,,2,2,1,3
904_0,,,,2,2,1,3
C1(COC(C(C(C1CO)O)O)O)=O,,,3,1,3,12,15
904_1,,,,2,2,1,3
906_0,,,,2,2,1,3
C1(C(CO)OC(C(C(C1)O)O)O)=O,,,3,1,3,10,13
906_1,,,,2,2,1,3
908_0,,,,2,2,1,3
C(C(CO)C(C(O)=O)O)(CCO)=O,,,3,1,4,13,17
908_1,,,,2,2,1,3
910_0,,,,2,2,1,3
C(CC(C(O)=O)O)(C(CO)CO)=O,,,3,1,5,9,14
910_1,,,,2,2,1,3
912_0,,,,2,2,1,3
C(C(CC(C(CO)=O)CO)O)(O)=O,,,3,1,4,11,15
914_0,,,,2,2,1,3
C(C(CO)O)(CCC(C(O)=O)O)=O,,,3,1,5,12,17
914_1,,,,2,2,1,3
916_0,,,,2,2,1,3
C(C(CC(C(O)=O)O)O)(CCO)=O,,,3,1,4,10,14
918_0,,,,2,2,1,3
C(C(CO)C(CC(C(O)=O)O)O)=O,,,3,1,7,16,23
918_1,,,,2,2,1,3
920_0,,,,2,2,1,3
C(C(C(C(CO)C(CO)O)=O)=O)=O,,,3,1,2,16,18
920_1,,,,2,2,1,3
922_0,,,,2,2,1,3
C(C(CO)O)(C(C(C=O)=O)CO)=O,,,3,1,4,17,21
922_1,,,,2,2,1,3
924_0,,,,2,2,1,3
C(C(CO)CO)(C(C(C=O)=O)O)=O,,,3,1,3,11,14
924_1,,,,2,2,1,3
926_0,,,,2,2,1,3
C(CO)(C(CO)C(C(C=O)=O)O)=O,,,3,1,5,19,24
926_1,,,,2,2,1,3
928_0,,,,2,2,1,3
C(CC(C(C=O)=O)O)(C(CO)O)=O,,,3,1,4,18,22
928_1,,,,2,2,1,3
930_0,,,,2,2,1,3
C(C(C(C(C=O)=O)O)O)(CCO)=O,,,3,1,6,19,25
932_0,,,,2,2,1,3
C(C(CO)C(C(C(C=O)=O)O)O)=O,,,3,1,5,20,25
932_1,,,,2,2,1,3
934_0,,,,2,2,1,3
C(C(C=CC(C(CO)O)=O)O)=O,,,3,1,4,15,19
934_1,,,,2,2,1,3
936_0,,,,2,2,1,3
C(C(CO)C1(C(C(CO1)O)O)O)=O,,,3,1,3,13,16
936_1,,,,2,2,1,3
938_0,,,,2,2,1,3
C(C(C(C(C(C=O)=O)CO)O)O)=O,,,3,1,5,23,28
938_1,,,,2,2,1,3
940_0,,,,2,2,1,3
C(C(C(CO)C(C)(CO)O)=O)=O,,,3,1,5,18,23
940_1,,,,2,2,1,3
942_0,,,,2,2,1,3
C(CC(C(CCO)=O)O)(CO)=O,,,3,1,5,14,19
944_0,,,,2,2,1,3
C(C(CCO)(CC(CO)=O)O)=O,,,3,1,2,13,15
945_0,,,,2,2,1,3
945_1,,,,2,2,1,3
947_0,,,,2,2,1,3
C(C(CCO)(C(C(C)=O)O)O)=O,,,3,1,4,14,18
947_1,,,,2,2,1,3
949_0,,,,2,2,1,3
C(C(C(CO)C(C)O)=O)=O,,,3,1,4,20,24
949_1,,,,2,2,1,3
951_0,,,,2,2,1,3
C(CC(C(CCO)=O)O)=O,,,3,1,6,29,35
953_0,,,,2,2,1,3
C(C(CCO)(CC=O)O)=O,,,3,1,1,19,20
955_0,,,,2,2,1,3
C(C(C(C(C=O)=O)CO)O)(CO)=O,,,3,1,6,19,25
955_1,,,,2,2,1,3
957_0,,,,2,2,1,3
C(C(CO)(C(C(C=O)=O)CO)O)=O,,,3,1,5,17,22
957_1,,,,2,2,1,3
958_0,,,,2,2,1,3
958_1,,,,2,2,1,3
960_0,,,,2,2,1,3
C(C(CCO)(C(C(C=O)=O)O)O)=O,,,3,1,3,16,19
960_1,,,,2,2,1,3
962_0,,,,2,2,1,3
C(C(C(C(C=O)O)O)O)(CCO)=O,,,3,1,15,19,34
962_1,,,,2,2,1,3
964_0,,,,2,2,1,3
C(C(C(C(C(CO)=O)CO)O)O)=O,,,3,1,15,20,35
964_1,,,,2,2,1,3
966_0,,,,2,2,1,3
C(C(C(CO)(C)O)O)(CCO)=O,,,3,1,5,10,15
966_1,,,,2,2,1,3
968_0,,,,2,2,1,3
C(CO)(C(CO)C(CO)(C)O)=O,,,3,1,7,11,18
968_1,,,,2,2,1,3
970_0,,,,2,2,1,3
C(CO)(CC(CO)(CCO)O)=O,,,3,1,4,9,13
972_0,,,,2,2,1,3
C(C)(C(C(CO)(CCO)O)O)=O,,,3,1,4,10,14
972_1,,,,2,2,1,3
974_0,,,,2,2,1,3
C(C(C(C)O)O)(CCO)=O,,,3,1,4,22,26
974_1,,,,2,2,1,3
976_0,,,,2,2,1,3
C(CO)(C(CO)C(C)O)=O,,,3,1,6,19,25
976_1,,,,2,2,1,3
978_0,,,,2,2,1,3
C(CC(CO)(CCO)O)=O,,,3,1,3,17,20
979_0,,,,2,2,1,3
979_1,,,,2,2,1,3
980_0,,,,2,2,1,3
980_1,,,,2,2,1,3
982_0,,,,2,2,1,3
C(C(CO)(C(C(CCO)=O)O)O)=O,,,3,1,12,18,30
982_1,,,,2,2,1,3
984_0,,,,2,2,1,3
C(C(CO)(C(C(CO)=O)CO)O)=O,,,3,1,7,16,23
984_1,,,,2,2,1,3
986_0,,,,2,2,1,3
C(C(C(C(CO)(CCO)O)O)=O)=O,,,3,1,5,15,20
986_1,,,,2,2,1,3
988_0,,,,2,2,1,3
C(C(C(C=O)O)O)(CC(C)O)=O,,,3,1,5,20,25
990_0,,,,2,2,1,3
C(CC(C(C(C(C)=O)O)O)O)=O,,,3,1,4,21,25
992_0,,,,2,2,1,3
C(CC(C)(C(C(C=O)O)O)O)=O,,,3,1,3,24,27
993_0,,,,2,2,1,3
994_0,,,,2,2,1,3
994_1,,,,2,2,1,3
996_0,,,,2,2,1,3
C(C(C(C(C=O)C(C=O)O)O)O)=O,,,3,1,6,25,31
996_1,,,,2,2,1,3
998_0,,,,2,2,1,3
C(CC(C(C=O)O)O)=O,,,3,1,10,42,52
1000_0,,,,2,2,1,3
C(C(C(C(C(C=O)=O)O)O)O)=O,,,3,1,7,27,34
1000_1,,,,2,2,1,3
1002_0,,,,2,2,1,3
C(CO)(CC(CO)(C)O)=O,,,3,1,7,20,27
1004_0,,,,2,2,1,3
C(C)(C(C(CO)(C)O)O)=O,,,3,1,7,18,25
1004_1,,,,2,2,1,3
1005_0,,,,2,2,1,3
1006_0,,,,2,2,1,3
1006_1,,,,2,2,1,3
1008_0,,,,2,2,1,3
C(C(CC(CC(CO)=O)O)O)=O,,,3,1,4,18,22
1010_0,,,,2,2,1,3
C(C(CC(C(C(C)=O)O)O)O)=O,,,3,1,4,20,24
1010_1,,,,2,2,1,3
1012_0,,,,2,2,1,3
C(C(C(CO)(C)O)C(C=O)O)=O,,,3,1,6,19,25
1012_1,,,,2,2,1,3
1014_0,,,,2,2,1,3
C(C(C(C(CC(CO)=O)O)O)O)=O,,,3,1,7,22,29
1016_0,,,,2,2,1,3
C(C(C(C(C(C(C)=O)O)O)O)O)=O,,,3,1,9,24,33
1016_1,,,,2,2,1,3
1018_0,,,,2,2,1,3
C(CO)(CC(C)O)=O,,,3,1,10,66,76
1020_0,,,,2,2,1,3
C(C)(C(C(C)O)O)=O,,,3,1,10,56,66
1020_1,,,,2,2,1,3
1022_0,,,,2,2,1,3
C(CC(C)(CO)O)=O,,,3,1,4,45,49
1023_0,,,,2,2,1,3
1024_0,,,,2,2,1,3
1024_1,,,,2,2,1,3
1026_0,,,,2,2,1,3
C(C(CO)(CC(CO)=O)O)=O,,,3,1,10,17,27
1028_0,,,,2,2,1,3
C(C(CO)(C(C(C)=O)O)O)=O,,,3,1,13,19,32
1028_1,,,,2,2,1,3
1030_0,,,,2,2,1,3
C(C(C(C(CO)(C)O)O)=O)=O,,,3,1,6,17,23
1030_1,,,,2,2,1,3
1032_0,,,,2,2,1,3
C(CO)(CC(CO)(C(CO)O)O)=O,,,3,1,4,10,14
1034_0,,,,2,2,1,3
C(C)(C(C(CO)(C(CO)O)O)O)=O,,,3,1,6,11,17
1034_1,,,,2,2,1,3
1036_0,,,,2,2,1,3
C(C(C(CO)(C)O)O)(C(CO)O)=O,,,3,1,6,12,18
1036_1,,,,2,2,1,3
1037_0,,,,2,2,1,3
1038_0,,,,2,2,1,3
1038_1,,,,2,2,1,3
1040_0,,,,2,2,1,3
C(C(C(CO)O)(CC(CO)=O)O)=O,,,3,1,4,15,19
1042_0,,,,2,2,1,3
C(C(C(CO)O)(C(C(C)=O)O)O)=O,,,3,1,10,18,28
1042_1,,,,2,2,1,3
1044_0,,,,2,2,1,3
C(C(C(C)O)C(C=O)O)=O,,,3,1,5,24,29
1044_1,,,,2,2,1,3
1046_0,,,,2,2,1,3
C(CC(C(CC=O)O)O)=O,,,3,1,2,16,18
1048_0,,,,2,2,1,3
C(CC(CC(C=O)O)O)=O,,,3,1,4,28,32
1050_0,,,,2,2,1,3
C(C(C(C=O)C(C(CO)=O)O)O)=O,,,3,1,6,20,26
1050_1,,,,2,2,1,3
1052_0,,,,2,2,1,3
C(C(C(C=O)C(C=O)(CO)O)O)=O,,,3,1,6,18,24
1052_1,,,,2,2,1,3
1054_0,,,,2,2,1,3
C(CC(C(C(C(C=O)=O)O)O)O)=O,,,3,1,3,24,27
1054_1,,,,2,2,1,3
1056_0,,,,2,2,1,3
C(C(CC(C(C(C=O)=O)O)O)O)=O,,,3,1,3,22,25
1056_1,,,,2,2,1,3
1057_0,,,,2,2,1,3
1059_0,,,,2,2,1,3
C(CC(C)O)=O,,,3,1,7,222,229
1061_0,,,,2,2,1,3
C(CC(C(CO)=O)O)=O,,,3,1,10,41,51
1063_0,,,,2,2,1,3
C(C(CO)(CC=O)O)=O,,,3,1,8,27,35
1065_0,,,,2,2,1,3
C(C(C(C(C)O)O)=O)=O,,,3,1,7,29,36
1065_1,,,,2,2,1,3
1067_0,,,,2,2,1,3
C(CC(CO)(C(CO)O)O)=O,,,3,1,5,14,19
1069_0,,,,2,2,1,3
C(C(C(C)O)O)(C(CO)O)=O,,,3,1,8,15,23
1069_1,,,,2,2,1,3
1071_0,,,,2,2,1,3
C(CC(C(CC(CCO)=O)=O)O)=O,,,3,1,1,14,15
1073_0,,,,2,2,1,3
C(CC(C=O)(CC=O)O)(CCO)=O,,,3,1,2,13,15
1075_0,,,,2,2,1,3
C(CC(CCO)(CC(C=O)=O)O)=O,,,3,1,1,15,16
1077_0,,,,2,2,1,3
C(CCO)(C(C(C=O)=O)C(C)O)=O,,,3,1,2,13,15
1077_1,,,,2,2,1,3
1079_0,,,,2,2,1,3
C(C(CO)C(C)O)(CC(C=O)=O)=O,,,3,1,2,14,16
1079_1,,,,2,2,1,3
1081_0,,,,2,2,1,3
C(CC(C(CCC(CO)=O)=O)O)=O,,,3,1,1,16,17
1083_0,,,,2,2,1,3
C(CO)(CCC(C=O)(CC=O)O)=O,,,3,1,2,16,18
1085_0,,,,2,2,1,3
C(CC(CCC(C=O)=O)(CO)O)=O,,,3,1,2,18,20
1087_0,,,,2,2,1,3
C(CC(C(C=O)=O)C(C)O)(CO)=O,,,3,1,2,15,17
1089_0,,,,2,2,1,3
C(CO)(C(C(C)O)CC(C=O)=O)=O,,,3,1,2,15,17
1091_0,,,,2,2,1,3
C(CCC(C=O)=O)(C(C(C)O)O)=O,,,3,1,2,15,17
1091_1,,,,2,2,1,3
1093_0,,,,2,2,1,3
C(CC(C(CC(C(C)=O)O)=O)O)=O,,,3,1,2,17,19
1095_0,,,,2,2,1,3
C(C)(C(CC(C=O)(CC=O)O)O)=O,,,3,1,1,15,16
1097_0,,,,2,2,1,3
C(CC(C)(C(CC(C=O)=O)O)O)=O,,,3,1,2,19,21
1099_0,,,,2,2,1,3
C(C(C(C(C=O)=O)C(C)O)O)(C)=O,,,3,1,4,15,19
1099_1,,,,2,2,1,3
1101_0,,,,2,2,1,3
C(C(CC(C=O)=O)O)(CC(C)O)=O,,,3,1,2,14,16
1103_0,,,,2,2,1,3
C(CC(C(CC(CC=O)O)=O)O)=O,,,3,1,4,18,22
1105_0,,,,2,2,1,3
C(CC(CC(C=O)(CC=O)O)O)=O,,,3,1,1,18,19
1107_0,,,,2,2,1,3
C(CC(CC(CC(C=O)=O)O)O)=O,,,3,1,1,19,20
1109_0,,,,2,2,1,3
C(CC(C(C(C=O)=O)C(C)O)O)=O,,,3,1,4,17,21
1109_1,,,,2,2,1,3
1111_0,,,,2,2,1,3
C(C(C(CC(C=O)=O)O)C(C)O)=O,,,3,1,4,16,20
1111_1,,,,2,2,1,3
1113_0,,,,2,2,1,3
C(CC(CC(C(CCO)=O)=O)O)=O,,,3,1,1,13,14
1115_0,,,,2,2,1,3
C(CC(C(CCO)=O)(CC=O)O)=O,,,3,1,1,8,9
1117_0,,,,2,2,1,3
C(C(CCO)(CC=O)O)(CC=O)=O,,,3,1,1,14,15
1119_0,,,,2,2,1,3
C(C(C(C(CCO)=O)=O)C(C)O)=O,,,3,1,2,12,14
1119_1,,,,2,2,1,3
1121_0,,,,2,2,1,3
C(CC(C(C(CO)C(C)O)=O)=O)=O,,,3,1,2,13,15
1121_1,,,,2,2,1,3
1123_0,,,,2,2,1,3
C(CC(CC(CC(CO)=O)=O)O)=O,,,3,1,2,14,16
1125_0,,,,2,2,1,3
C(CC(CC=O)(CC(CO)=O)O)=O,,,3,1,2,9,11
1127_0,,,,2,2,1,3
C(CC(CC(CO)(CC=O)O)=O)=O,,,3,1,2,15,17
1129_0,,,,2,2,1,3
C(C(C(CC(CO)=O)=O)C(C)O)=O,,,3,1,3,11,14
1129_1,,,,2,2,1,3
1131_0,,,,2,2,1,3
C(CC=O)(C(C(CO)=O)C(C)O)=O,,,3,1,3,11,14
1131_1,,,,2,2,1,3
1133_0,,,,2,2,1,3
C(CC(CC(C(C(C)O)O)=O)=O)=O,,,3,1,2,12,14
1133_1,,,,2,2,1,3
1135_0,,,,2,2,1,3
C(CC(CC(C(C(C)=O)O)=O)O)=O,,,3,1,1,14,15
1137_0,,,,2,2,1,3
C(CC(C(C(C)=O)O)(CC=O)O)=O,,,3,1,1,9,10
1139_0,,,,2,2,1,3
C(CC(C)(C(C(CC=O)=O)O)O)=O,,,3,1,3,16,19
1141_0,,,,2,2,1,3
C(C(C(C(C(C)=O)O)=O)C(C)O)=O,,,3,1,2,10,12
1141_1,,,,2,2,1,3
1143_0,,,,2,2,1,3
C(CC(C(C(CC(C)O)=O)O)=O)=O,,,3,1,1,10,11
1144_0,,,,2,2,1,3
1146_0,,,,2,2,1,3
C(CC(C(CC=O)O)(CC=O)O)=O,,,3,1,1,13,14
1148_0,,,,2,2,1,3
C(CC(CC(C(CC=O)=O)O)O)=O,,,3,1,2,18,20
1150_0,,,,2,2,1,3
C(CC(C(C(C=O)C(C)O)=O)O)=O,,,3,1,3,14,17
1150_1,,,,2,2,1,3
1152_0,,,,2,2,1,3
C(C(C(C)O)C(C(CC=O)=O)O)=O,,,3,1,5,16,21
1152_1,,,,2,2,1,3
1154_0,,,,2,2,1,3
C(CC(C(C(CC(C)=O)=O)O)O)=O,,,3,1,1,16,17
1156_0,,,,2,2,1,3
C(CC(C(C=O)O)(CC(C)=O)O)=O,,,3,1,1,15,16
1158_0,,,,2,2,1,3
C(C(C(CC(C)(CC=O)O)=O)O)=O,,,3,1,2,15,17
1160_0,,,,2,2,1,3
C(C(C=O)O)(C(C(C)=O)C(C)O)=O,,,3,1,2,10,12
1160_1,,,,2,2,1,3
1162_0,,,,2,2,1,3
C(C(C=O)O)(CC(CC(C)O)=O)=O,,,3,1,1,10,11
1164_0,,,,2,2,1,3
C(CC(C(C(CCC=O)=O)O)O)=O,,,3,1,1,18,19
1166_0,,,,2,2,1,3
C(CCC(C(C=O)O)(CC=O)O)=O,,,3,1,1,21,22
1168_0,,,,2,2,1,3
C(C(C(CCC(CC=O)O)=O)O)=O,,,3,1,1,17,18
1170_0,,,,2,2,1,3
C(C(C(C)O)CC=O)(C(C=O)O)=O,,,3,1,1,14,15
1172_0,,,,2,2,1,3
C(C(C(C)O)CC(C(C=O)O)=O)=O,,,3,1,1,14,15
1174_0,,,,2,2,1,3
C(CC(C(CC(C(C)=O)=O)O)O)=O,,,3,1,2,18,20
1176_0,,,,2,2,1,3
C(C)(C(CC(C=O)O)(CC=O)O)=O,,,3,1,1,16,17
1178_0,,,,2,2,1,3
C(CC(C=O)O)(C(C)(CC=O)O)=O,,,3,1,1,16,17
1180_0,,,,2,2,1,3
C(C(C(C(C(C)=O)=O)C(C)O)O)=O,,,3,1,2,14,16
1180_1,,,,2,2,1,3
1182_0,,,,2,2,1,3
C(C(CC(C(CC(C)O)=O)=O)O)=O,,,3,1,1,12,13
1184_0,,,,2,2,1,3
C(CC(CC(C(CC=O)O)O)=O)=O,,,3,1,2,20,22
1186_0,,,,2,2,1,3
C(CC(CC(C=O)O)(CC=O)O)=O,,,3,1,2,13,15
1188_0,,,,2,2,1,3
C(CC(C=O)O)(CC(CC=O)O)=O,,,3,1,2,18,20
1190_0,,,,2,2,1,3
C(C(C(C)O)C(C=O)O)(CC=O)=O,,,3,1,3,17,20
1190_1,,,,2,2,1,3
1192_0,,,,2,2,1,3
C(CC(C=O)O)(C(C=O)C(C)O)=O,,,3,1,3,14,17
1192_1,,,,2,2,1,3
1194_0,,,,2,2,1,3
C(CC(C(C=CC(CO)O)=O)O)=O,,,3,1,1,7,8
1196_0,,,,2,2,1,3
C(C(C=CC(CO)O)(CC=O)O)=O,,,3,1,1,6,7
1198_0,,,,2,2,1,3
C(CC(C(C(C=CCO)=O)O)O)=O,,,3,1,1,11,12
1200_0,,,,2,2,1,3
C(CC(C=CCO)(C(C=O)O)O)=O,,,3,1,1,10,11
1202_0,,,,2,2,1,3
C(CC(C=CC(C(CO)O)=O)O)=O,,,3,1,1,13,14
1204_0,,,,2,2,1,3
C(CC(C=CC=O)(C(CO)O)O)=O,,,3,1,1,11,12
1206_0,,,,2,2,1,3
C(CC(C(C(C(C=C)=O)O)O)O)=O,,,3,1,3,20,23
1208_0,,,,2,2,1,3
C(C(C(C(C=C)(CC=O)O)O)O)=O,,,3,1,1,19,20
1210_0,,,,2,2,1,3
C(CC(C(C=CC(CO)=O)O)O)=O,,,3,1,1,11,12
1212_0,,,,2,2,1,3
C(C(C=CC(CO)(CC=O)O)O)=O,,,3,1,1,11,12
1214_0,,,,2,2,1,3
C(C(C=CC(C(C(C)O)O)=O)O)=O,,,3,1,2,13,15
1214_1,,,,2,2,1,3
1216_0,,,,2,2,1,3
C(CC(C(C(C=CC=O)O)O)O)=O,,,3,1,1,13,14
1218_0,,,,2,2,1,3
C(C(C(C=CC(CC=O)O)O)O)=O,,,3,1,1,15,16
1219_0,,,,2,2,1,3
1221_0,,,,2,2,1,3
C(C(C(CO)O)(CC=O)O)=O,,,3,1,4,17,21
1223_0,,,,2,2,1,3
C(CO)(C(C(C(C=O)=O)O)O)=O,,,3,1,6,22,28
1223_1,,,,2,2,1,3
1225_0,,,,2,2,1,3
C(C(CO)(C(C(C=O)=O)O)O)=O,,,3,1,7,22,29
1225_1,,,,2,2,1,3
1227_0,,,,2,2,1,3
C(C(C(CO)(CO)O)O)=O,,,3,1,10,17,27
1227_1,,,,2,2,1,3
1229_0,,,,2,2,1,3
C(CO)(C(C(CO)O)O)=O,,,3,1,16,22,38
1229_1,,,,2,2,1,3
1231_0,,,,2,2,1,3
C(C(C(C(CO)O)O)O)=O,,,3,1,15,23,38
1231_1,,,,2,2,1,3
1232_0,,,,2,2,1,3
1232_1,,,,2,2,1,3
1234_0,,,,2,2,1,3
C(C(C)(C(C=O)O)O)=O,,,3,1,15,29,44
1234_1,,,,2,2,1,3
1236_0,,,,2,2,1,3
C(C(CC(CO)O)=O)=O,,,3,1,12,29,41
1237_0,,,,2,2,1,3
1237_1,,,,2,2,1,3
1239_0,,,,2,2,1,3
C(CC(CO)(C(C=O)O)O)=O,,,3,1,8,21,29
1239_1,,,,2,2,1,3
1241_0,,,,2,2,1,3
C(C(C(CO)=O)C(CO)O)=O,,,3,1,6,16,22
1241_1,,,,2,2,1,3
1242_0,,,,2,2,1,3
1242_1,,,,2,2,1,3
1243_0,,,,2,2,1,3
1243_1,,,,2,2,1,3
1245_0,,,,2,2,1,3
C(C(C(C)(C(C=O)O)O)O)=O,,,3,1,5,12,17
1245_1,,,,2,2,1,3
1246_0,,,,2,2,1,3
1247_0,,,,2,2,1,3
1247_1,,,,2,2,1,3
1249_0,,,,2,2,1,3
C(C(C(C)(C(CO)O)O)O)=O,,,3,1,7,16,23
1249_1,,,,2,2,1,3
1250_0,,,,2,2,1,3
1251_0,,,,2,2,1,3
1251_1,,,,2,2,1,3
1253_0,,,,2,2,1,3
C(C(CC(CO)(C(C=O)O)O)O)=O,,,3,1,3,20,23
1253_1,,,,2,2,1,3
1255_0,,,,2,2,1,3
C(CO)(C(C(CO)O)C(C=O)O)=O,,,3,1,5,18,23
1255_1,,,,2,2,1,3
1257_0,,,,2,2,1,3
C(CC(C=O)O)(C(C(CO)O)O)=O,,,3,1,6,17,23
1257_1,,,,2,2,1,3
1258_0,,,,2,2,1,3
1258_1,,,,2,2,1,3
1259_0,,,,2,2,1,3
1259_1,,,,2,2,1,3
1261_0,,,,2,2,1,3
C(C(CCO)(C(C=O)O)O)=O,,,3,1,7,18,25
1261_1,,,,2,2,1,3
1263_0,,,,2,2,1,3
C(C(C(CO)C(CO)O)=O)=O,,,3,1,7,19,26
1263_1,,,,2,2,1,3
1265_0,,,,2,2,1,3
C(C(C(CO)(CCO)O)O)=O,,,3,1,7,15,22
1265_1,,,,2,2,1,3
1266_0,,,,2,2,1,3
1266_1,,,,2,2,1,3
1268_0,,,,2,2,1,3
C(CO)(C(CO)C(CO)O)=O,,,3,1,10,14,24
1268_1,,,,2,2,1,3
1269_0,,,,2,2,1,3
1269_1,,,,2,2,1,3
1271_0,,,,2,2,1,3
C(C(C(C(C)(C(C=O)O)O)O)O)=O,,,3,1,7,24,31
1271_1,,,,2,2,1,3
1273_0,,,,2,2,1,3
C(C(C(C=O)O)O)(CC(CO)O)=O,,,3,1,6,19,25
1275_0,,,,2,2,1,3
C(C(C(C(C=O)O)O)O)=O,,,3,1,8,18,26
1275_1,,,,2,2,1,3
1277_0,,,,2,2,1,3
C(C(C(CO)(C)O)O)=O,,,3,1,12,24,36
1277_1,,,,2,2,1,3
1279_0,,,,2,2,1,3
C(CO)(CC(CO)O)=O,,,3,1,14,30,44
1281_0,,,,2,2,1,3
C(C)(C(C(CO)O)O)=O,,,3,1,14,27,41
1281_1,,,,2,2,1,3
1282_0,,,,2,2,1,3
1282_1,,,,2,2,1,3
1283_0,,,,2,2,1,3
1283_1,,,,2,2,1,3
1285_0,,,,2,2,1,3
C(C(C(CO)O)C(C=O)O)=O,,,3,1,7,21,28
1285_1,,,,2,2,1,3
1287_0,,,,2,2,1,3
C(C(C(C(C(C=O)O)O)O)O)=O,,,3,1,7,15,22
1287_1,,,,2,2,1,3
1289_0,,,,2,2,1,3
C(C(C(C)O)O)=O,,,3,1,23,112,135
1289_1,,,,2,2,1,3
1291_0,,,,2,2,1,3
C(CC(CO)O)=O,,,3,1,11,109,120
1292_0,,,,2,2,1,3
1292_1,,,,2,2,1,3
1294_0,,,,2,2,1,3
C(C(CO)(C(C=O)O)O)=O,,,3,1,11,26,37
1294_1,,,,2,2,1,3
1296_0,,,,2,2,1,3
C(C(C(C(CO)O)O)=O)=O,,,3,1,12,24,36
1296_1,,,,2,2,1,3
1298_0,,,,2,2,1,3
C(C(C(CO)(C(CO)O)O)O)=O,,,3,1,10,15,25
1298_1,,,,2,2,1,3
1299_0,,,,2,2,1,3
1299_1,,,,2,2,1,3
1300_0,,,,2,2,1,3
1300_1,,,,2,2,1,3
1302_0,,,,2,2,1,3
C(C(C(CO)O)(C(C=O)O)O)=O,,,3,1,10,22,32
1302_1,,,,2,2,1,3
1304_0,,,,2,2,1,3
C(C(CC(C(C(CO)O)O)O)=O)=O,,,3,1,7,16,23
1306_0,,,,2,2,1,3
C(CO)(CC(C(C(CO)O)O)O)=O,,,3,1,7,12,19
1308_0,,,,2,2,1,3
C(C)(C(C(C(C(CO)O)O)O)O)=O,,,3,1,8,14,22
1308_1,,,,2,2,1,3
1309_0,,,,2,2,1,3
1310_0,,,,2,2,1,3
1310_1,,,,2,2,1,3
1312_0,,,,2,2,1,3
C(C(C(C(C(CO)O)O)=O)CO)=O,,,3,1,13,15,28
1312_1,,,,2,2,1,3
1314_0,,,,2,2,1,3
C(C(C(C(CO)C(CO)O)=O)O)=O,,,3,1,9,15,24
1314_1,,,,2,2,1,3
1316_0,,,,2,2,1,3
C(C(CO)C(C=O)O)(C(CO)O)=O,,,3,1,15,19,34
1316_1,,,,2,2,1,3
1318_0,,,,2,2,1,3
C(C(C(C=O)O)O)(C(CO)CO)=O,,,3,1,13,16,29
1318_1,,,,2,2,1,3
1319_0,,,,2,2,1,3
1319_1,,,,2,2,1,3
1320_0,,,,2,2,1,3
1320_1,,,,2,2,1,3
1321_0,,,,2,2,1,3
1323_0,,,,2,2,1,3
C(C(CO)C(C(C(C=O)O)O)O)=O,,,3,1,15,24,39
1323_1,,,,2,2,1,3
1325_0,,,,2,2,1,3
C(C(C)O)(O)=O,,,3,1,6,69,75
1325_1,,,,2,2,1,3
1326_0,,,,2,2,1,3
1326_1,,,,2,2,1,3
1327_0,,,,2,2,1,3
1327_1,,,,2,2,1,3
1329_0,,,,2,2,1,3
C(C(CO)O)(O)=O,,,3,1,11,69,80
1329_1,,,,2,2,1,3
1331_0,,,,2,2,1,3
C(C(CO)(CC(CO)O)O)(O)=O,,,3,1,2,9,11
1333_0,,,,2,2,1,3
C(C(C(CC(CO)O)O)O)(O)=O,,,3,1,8,11,19
1333_1,,,,2,2,1,3
1334_0,,,,2,2,1,3
1334_1,,,,2,2,1,3
1335_0,,,,2,2,1,3
1335_1,,,,2,2,1,3
1336_0,,,,2,2,1,3
1336_1,,,,2,2,1,3
1337_0,,,,2,2,1,3
1337_1,,,,2,2,1,3
1339_0,,,,2,2,1,3
C(C(CCO)(CC=O)O)(O)=O,,,3,1,4,13,17
1341_0,,,,2,2,1,3
C(C(C)(CC(C=O)O)O)(O)=O,,,3,1,1,13,14
1342_0,,,,2,2,1,3
1342_1,,,,2,2,1,3
1344_0,,,,2,2,1,3
C(C(C=O)(CC(CO)O)O)(O)=O,,,3,1,1,12,13
1345_0,,,,2,2,1,3
1345_1,,,,2,2,1,3
1346_0,,,,2,2,1,3
1346_1,,,,2,2,1,3
1347_0,,,,2,2,1,3
1347_1,,,,2,2,1,3
1348_0,,,,2,2,1,3
1348_1,,,,2,2,1,3
1349_0,,,,2,2,1,3
1349_1,,,,2,2,1,3
1350_0,,,,2,2,1,3
1350_1,,,,2,2,1,3
1351_0,,,,2,2,1,3
1351_1,,,,2,2,1,3
1352_0,,,,2,1,2,3
1353_0,,,,2,1,2,3
1354_0,,,,2,1,2,3
1355_0,,,,2,1,2,3
1356_0,,,,2,1,2,3
1357_0,,,,2,1,2,3
1358_0,,,,2,1,2,3
1359_0,,,,2,1,2,3
1360_0,,,,2,1,2,3
1361_0,,,,2,1,2,3
1362_0,,,,2,1,2,3
1363_0,,,,2,1,2,3
1364_0,,,,2,1,2,3
1365_0,,,,2,1,2,3
1366_0,,,,2,1,1,2
1366_1,,,,2,1,1,2
1367_0,,,,2,1,1,2
1367_1,,,,2,1,1,2
1368_0,,,,2,1,2,3
1368_1,,,,2,1,2,3
1369_0,,,,2,1,1,2
1370_0,,,,2,1,1,2
1370_1,,,,2,1,1,2
1371_0,,,,2,1,1,2
1371_1,,,,2,1,1,2
1372_0,,,,2,1,2,3
1372_1,,,,2,1,2,3
1373_0,,,,2,1,2,3
1373_1,,,,2,1,2,3
1374_0,,,,2,1,2,3
1375_0,,,,2,1,2,3
1376_0,,,,2,1,2,3
1377_0,,,,2,1,2,3
1377_1,,,,2,1,2,3
1378_0,,,,2,1,2,3
1378_1,,,,2,1,2,3
1379_0,,,,2,1,2,3
1380_0,,,,2,1,2,3
1380_1,,,,2,1,2,3
1381_0,,,,2,1,2,3
1382_0,,,,2,1,2,3
1382_1,,,,2,1,2,3
1383_0,,,,2,1,2,3
1383_1,,,,2,1,2,3
1384_0,,,,2,1,2,3
1384_1,,,,2,1,2,3
1385_0,,,,2,1,2,3
1386_0,,,,2,1,2,3
1386_1,,,,2,1,2,3
1387_0,,,,2,1,2,3
1389_0,,,,2,1,2,3
C(C(CO)=O)(C)=O,,,3,1,20,165,185
1390_0,,,,2,1,2,3
1392_0,,,,2,1,2,3
C(CO)(CC(CO)=O)=O,,,3,1,7,26,33
1392_1,,,,2,1,2,3
1394_0,,,,2,1,2,3
C(CO)(C(C(C)=O)O)=O,,,3,1,10,36,46
1395_0,,,,2,1,2,3
1396_0,,,,2,1,2,3
1396_1,,,,2,1,2,3
1397_0,,,,2,1,2,3
1397_1,,,,2,1,2,3
1398_0,,,,2,1,2,3
1398_1,,,,2,1,2,3
1400_0,,,,2,1,2,3
C(C(C(C)O)=O)=O,,,3,1,21,111,132
1400_1,,,,2,1,2,3
1402_0,,,,2,1,2,3
C(CO)(C(C)O)=O,,,3,1,13,133,146
1402_1,,,,2,1,2,3
1404_0,,,,2,1,2,3
C(CC=O)=O,,,3,1,38,408,446
1404_1,,,,2,1,2,3
1406_0,,,,2,1,2,3
C(C(C(CO)=O)O)=O,,,3,1,18,81,99
1407_0,,,,2,1,2,3
1407_1,,,,2,1,2,3
1408_0,,,,2,1,2,3
1409_0,,,,2,1,2,3
1410_0,,,,2,1,2,3
1410_1,,,,2,1,2,3
1411_0,,,,2,1,2,3
1411_1,,,,2,1,2,3
1412_0,,,,2,1,2,3
1413_0,,,,2,1,2,3
1413_1,,,,2,1,2,3
1414_0,,,,2,1,2,3
1416_0,,,,2,1,2,3
C(C(CCO)O)=O,,,3,1,24,80,104
1416_1,,,,2,1,2,3
1418_0,,,,2,1,2,3
C(C(C)=O)(O)=O,,,3,1,7,154,161
1420_0,,,,2,1,2,3
C(=O)=O,,,3,1,65,896,961
1420_1,,,,2,1,2,3
1422_0,,,,2,1,2,3
C(CC(CO)=O)(O)=O,,,3,1,6,66,72
1422_1,,,,2,1,2,3
1423_0,,,,2,1,2,3
1423_1,,,,2,1,2,3
1425_0,,,,2,1,2,3
C(C(C(C)=O)O)(O)=O,,,3,1,10,54,64
1427_0,,,,2,1,2,3
C(C(O)=O)=O,,,3,1,38,157,195
1429_0,,,,2,1,2,3
C(C(CC(CO)=O)O)(O)=O,,,3,1,9,24,33
1429_1,,,,2,1,2,3
1430_0,,,,2,1,2,3
1430_1,,,,2,1,2,3
1432_0,,,,2,1,2,3
C(C(C(C(C)=O)O)O)(O)=O,,,3,1,9,26,35
1434_0,,,,2,1,2,3
C(C(C=O)O)(O)=O,,,3,1,12,102,114
1435_0,,,,2,1,2,3
1435_1,,,,2,1,2,3
1437_0,,,,2,1,2,3
C(C(C(C=O)O)O)(O)=O,,,3,1,18,37,55
1439_0,,,,2,1,2,3
C(CC(C=O)O)(O)=O,,,3,1,6,44,50
1439_1,,,,2,1,2,3
1441_0,,,,2,1,2,3
C(C(CO)=O)(O)=O,,,3,1,12,99,111
1441_1,,,,2,1,2,3
1443_0,,,,2,1,1,2
C(C)(C(CO)(C(C=O)O)O)=O,,,3,1,13,21,34
1444_0,,,,2,1,1,2
1444_1,,,,2,1,1,2
1444_2,,,,2,1,1,2
1445_0,,,,2,1,2,3
1445_1,,,,2,1,2,3
1445_2,,,,2,1,2,3
1446_0,,,,2,1,1,2
1446_1,,,,2,1,1,2
1446_2,,,,2,1,1,2
1447_0,,,,2,1,1,2
1447_1,,,,2,1,1,2
1447_2,,,,2,1,1,2
1448_0,,,,2,1,2,3
1448_1,,,,2,1,2,3
1448_2,,,,2,1,2,3
1450_0,,,,2,1,2,3
C(C)(CC(C=O)=O)=O,,,3,1,8,97,105
1451_0,,,,2,1,2,3
1452_0,,,,2,1,2,3
1454_0,,,,2,1,2,3
C(CC(C=O)=O)=O,,,3,1,43,172,215
1456_0,,,,2,1,2,3
C(CC(C(C)=O)=O)=O,,,3,1,3,95,98
1457_0,,,,2,1,2,3
1459_0,,,,2,1,2,3
C(C(C)=O)(C)=O,,,3,1,7,152,159
1461_0,,,,2,1,2,3
C(CC(C)=O)=O,,,3,1,16,363,379
1463_0,,,,2,1,1,2
C(OC(C(C)=O)C(CO)O)=O,,,3,1,1,9,10
1465_0,,,,2,1,2,3
C1(COC(C1)O)=O,,,3,1,4,163,167
1465_1,,,,2,1,2,3
1467_0,,,,2,1,1,2
C(C(C(OCC(C)=O)O)O)=O,,,3,1,3,21,24
1467_1,,,,2,1,1,2
1469_0,,,,2,1,1,2
C(C(CO)OCC(CO)=O)=O,,,3,1,2,13,15
1469_1,,,,2,1,1,2
1471_0,,,,2,1,1,2
C(C(CO)OC(C(C)=O)O)=O,,,3,1,1,11,12
1473_0,,,,2,1,1,2
C(OC(CO)C(C(C)=O)O)=O,,,3,1,1,6,7
1475_0,,,,2,1,1,2
C(OC(CO)CC(CO)=O)=O,,,3,1,2,7,9
1475_1,,,,2,1,1,2
1477_0,,,,2,1,1,2
C(C)(C(CO)OC(C=O)O)=O,,,3,1,1,13,14
1479_0,,,,2,1,2,3
C1(COC(C(C1)O)O)=O,,,3,1,3,29,32
1479_1,,,,2,1,2,3
1481_0,,,,2,1,1,2
C(C(COCC(CO)=O)O)=O,,,3,1,2,18,20
1481_1,,,,2,1,1,2
1483_0,,,,2,1,1,2
C(C(COC(C(C)=O)O)O)=O,,,3,1,1,15,16
1485_0,,,,2,1,1,2
C(OCC(C(C(C)=O)O)O)=O,,,3,1,1,9,10
1487_0,,,,2,1,1,2
C(CO)(CC(OCC=O)O)=O,,,3,1,3,18,21
1487_1,,,,2,1,1,2
1489_0,,,,2,1,1,2
C(OCC(CC(CO)=O)O)=O,,,3,1,2,8,10
1489_1,,,,2,1,1,2
1491_0,,,,2,1,1,2
C(C)(C(C(OCC=O)O)O)=O,,,3,1,1,18,19
1493_0,,,,2,1,1,2
C(C)(C(COC(C=O)O)O)=O,,,3,1,1,15,16
1495_0,,,,2,1,1,2
C(CO)(CCOC(C=O)O)=O,,,3,1,2,17,19
1495_1,,,,2,1,1,2
1496_0,,,,2,1,1,2
1498_0,,,,2,1,2,3
C(C)(CCO)=O,,,3,1,5,278,283
1500_0,,,,2,1,2,3
C(C(CC(C)=O)O)(O)=O,,,3,1,4,30,34
1502_0,,,,2,1,2,3
C(C(CC=O)O)(O)=O,,,3,1,12,57,69
1504_0,,,,2,1,2,3
C(C(C(C)=O)=O)=O,,,3,1,15,140,155
1506_0,,,,2,1,2,3
C(CO)(CC(C=O)=O)=O,,,3,1,10,41,51
1506_1,,,,2,1,2,3
1507_0,,,,2,1,2,3
1509_0,,,,2,1,2,3
C(C)(C(C(C=O)=O)O)=O,,,3,1,9,34,43
1510_0,,,,2,1,2,3
1512_0,,,,2,1,2,3
C(C(C=O)=O)=O,,,3,1,40,180,220
1513_0,,,,2,1,2,3
1514_0,,,,2,1,2,3
1514_1,,,,2,1,2,3
1515_0,,,,2,1,2,3
1515_1,,,,2,1,2,3
1516_0,,,,2,1,2,3
1517_0,,,,2,1,2,3
1517_1,,,,2,1,2,3
1519_0,,,,2,1,2,3
C(C(C(C=O)=O)O)=O,,,3,1,20,74,94
1521_0,,,,2,1,2,3
C(C=CC(CO)=O)=O,,,3,1,4,97,101
1521_1,,,,2,1,2,3
1523_0,,,,2,1,2,3
C=CC(C=O)=O,,,3,1,15,293,308
1523_1,,,,2,1,2,3
1525_0,,,,2,1,2,3
C=CC(CO)=O,,,3,1,19,300,319
1525_1,,,,2,1,2,3
1527_0,,,,2,1,2,3
C(C=CC=O)=O,,,3,1,12,193,205
1527_1,,,,2,1,2,3
1529_0,,,,2,1,2,3
C1(C(C(CO1)O)O)=O,,,3,1,7,27,34
1531_0,,,,2,1,2,3
C1(CC(CO1)O)=O,,,3,1,8,39,47
1531_1,,,,2,1,2,3
1533_0,,,,2,1,1,2
C(CC(CO)(OCC=O)O)=O,,,3,1,2,17,19
1533_1,,,,2,1,1,2
1535_0,,,,2,1,1,2
C(C(C(C)(OCC=O)O)O)=O,,,3,1,2,19,21
1535_1,,,,2,1,1,2
1537_0,,,,2,1,1,2
C(C(C(CO)OC(C=O)O)O)=O,,,3,1,2,14,16
1537_1,,,,2,1,1,2
1539_0,,,,2,1,1,2
C(C(CC(OCC=O)O)O)=O,,,3,1,3,16,19
1539_1,,,,2,1,1,2
1541_0,,,,2,1,1,2
C(C(CO)OC(C(CO)=O)O)=O,,,3,1,2,8,10
1541_1,,,,2,1,1,2
1543_0,,,,2,1,1,2
C(C(C(COC(C=O)O)O)O)=O,,,3,1,2,18,20
1543_1,,,,2,1,1,2
1545_0,,,,2,1,1,2
C(C(COC(C(CO)=O)O)O)=O,,,3,1,2,12,14
1545_1,,,,2,1,1,2
1546_0,,,,2,1,2,3
1547_0,,,,2,1,2,3
1547_1,,,,2,1,2,3
1549_0,,,,2,1,1,2
C1(C(C(C(CO)C1O)O)O)=O,,,3,1,4,14,18
1550_0,,,,2,1,1,2
1551_0,,,,2,1,1,2
1552_0,,,,2,1,1,2
1553_0,,,,2,1,1,2
1554_0,,,,2,1,1,2
1555_0,,,,2,1,1,2
1556_0,,,,2,1,1,2
1557_0,,,,2,1,1,2
1559_0,,,,2,1,1,2
C(C(CC(C=O)O)O)=O,,,3,1,3,15,18
1560_0,,,,2,1,1,2
1561_0,,,,2,1,1,2
1563_0,,,,2,1,1,2
C(C(C(C(C)O)=O)O)=O,,,3,1,2,29,31
1564_0,,,,2,1,1,2
1566_0,,,,2,1,1,2
C(C(C)O)=O,,,3,1,39,262,301
1567_0,,,,2,1,1,2
1568_0,,,,2,1,1,2
1569_0,,,,2,1,1,2
1570_0,,,,2,1,1,2
1571_0,,,,2,1,1,2
1572_0,,,,2,1,1,2
1573_0,,,,2,1,1,2
1574_0,,,,2,1,1,2
1575_0,,,,2,1,1,2
1576_0,,,,2,1,1,2
1577_0,,,,2,1,1,2
1578_0,,,,2,1,1,2
1579_0,,,,2,1,1,2
1580_0,,,,2,1,1,2
1581_0,,,,2,1,1,2
1582_0,,,,2,1,1,2
1583_0,,,,2,1,1,2
1585_0,,,,2,1,1,2
C(C(C(CO)O)=O)(CCO)=O,,,3,1,5,16,21
1587_0,,,,2,1,1,2
C(C(CO)=O)(C(CCO)O)=O,,,3,1,4,12,16
1588_0,,,,2,1,1,2
1590_0,,,,2,1,1,2
C(C(C(C(CCO)O)O)=O)=O,,,3,1,8,18,26
1591_0,,,,2,1,1,2
1592_0,,,,2,1,1,2
1593_0,,,,2,1,1,2
1594_0,,,,2,1,1,2
1595_0,,,,2,1,1,2
1596_0,,,,2,1,1,2
1597_0,,,,2,1,1,2
1599_0,,,,2,1,1,2
C(C(CO)O)(C(C(C)=O)O)=O,,,3,1,8,15,23
1601_0,,,,2,1,1,2
C(C(C)O)(C(C(CO)=O)O)=O,,,3,1,4,12,16
1602_0,,,,2,1,1,2
1604_0,,,,2,1,1,2
C(C(C(C(C(C)O)O)=O)O)=O,,,3,1,5,17,22
1605_0,,,,2,1,1,2
1606_0,,,,2,1,1,2
1607_0,,,,2,1,1,2
1609_0,,,,2,1,1,2
C(C(CO)=O)(C(C(CO)O)O)=O,,,3,1,1,14,15
1610_0,,,,2,1,1,2
1611_0,,,,2,1,1,2
1612_0,,,,2,1,1,2
1614_0,,,,2,1,1,2
C(C(CCO)O)(C(CO)O)=O,,,3,1,6,12,18
1616_0,,,,2,1,1,2
C(CO)(C(CC(CO)O)O)=O,,,3,1,5,11,16
1618_0,,,,2,1,1,2
C(C(C(CO)O)O)(C(C)O)=O,,,3,1,6,13,19
1620_0,,,,2,1,1,2
C(CO)(C(C(CCO)O)O)=O,,,3,1,7,13,20
1622_0,,,,2,1,1,2
C(CC(C(C(CO)O)=O)O)(O)=O,,,3,1,5,10,15
1624_0,,,,2,1,1,2
C(C(C(CC(CO)O)O)=O)(O)=O,,,3,1,4,12,16
1626_0,,,,2,1,1,2
C(C(CC(C(CO)=O)O)O)(O)=O,,,3,1,8,10,18
1628_0,,,,2,1,1,2
C(C(C(C(CCO)O)=O)O)(O)=O,,,3,1,6,10,16
1630_0,,,,2,1,1,2
C(C(C(CC(C=O)O)O)O)(O)=O,,,3,1,10,18,28
1632_0,,,,2,1,1,2
C(C(C(C(O)=O)O)O)(C(C)O)=O,,,3,1,9,12,21
1634_0,,,,2,1,1,2
C(CC(C(C(CO)=O)O)O)(O)=O,,,3,1,5,10,15
1636_0,,,,2,1,1,2
C(C(C(C(C(CO)O)O)=O)O)(O)=O,,,3,1,6,15,21
1638_0,,,,2,1,1,2
C(C(CCC(C=O)=O)O)=O,,,3,1,7,25,32
1640_0,,,,2,1,1,2
C(C(C)O)(CC(C=O)=O)=O,,,3,1,4,24,28
1641_0,,,,2,1,1,2
1643_0,,,,2,1,1,2
C(CC(C(C(C)=O)=O)O)=O,,,3,1,5,25,30
1645_0,,,,2,1,1,2
C(CC(C(C(C)O)=O)=O)=O,,,3,1,4,22,26
1646_0,,,,2,1,1,2
1648_0,,,,2,1,1,2
C(C)(CC(C(CO)=O)=O)=O,,,3,1,5,28,33
1650_0,,,,2,1,1,2
C(C)(CC(C(C=O)=O)O)=O,,,3,1,4,28,32
1652_0,,,,2,1,1,2
C(CCC(C(CO)=O)=O)=O,,,3,1,4,25,29
1654_0,,,,2,1,1,2
C(CCC(C(C=O)=O)O)=O,,,3,1,3,23,26
1656_0,,,,2,1,1,2
C(CO)(CC(C(C)=O)=O)=O,,,3,1,5,28,33
1657_0,,,,2,1,1,2
1659_0,,,,2,1,1,2
C1(C(C(CO)O)OCC1O)=O,,,3,1,6,10,16
1660_0,,,,2,1,1,2
1662_0,,,,2,1,1,2
C1(C(C(CO)OCC1O)O)=O,,,3,1,3,7,10
1663_0,,,,2,1,1,2
1665_0,,,,2,1,1,2
C1(C(CO)OC(CC1O)O)=O,,,3,1,3,9,12
1667_0,,,,2,1,1,2
C1(C(O)OC(CO)CC1O)=O,,,3,1,3,7,10
1669_0,,,,2,1,1,2
C1(C(C(COCC1O)O)O)=O,,,3,1,4,10,14
1670_0,,,,2,1,1,2
1672_0,,,,2,1,1,2
C1(C(CC(O)OCC1O)O)=O,,,3,1,4,9,13
1674_0,,,,2,1,1,2
C1(C(O)OCC(CC1O)O)=O,,,3,1,3,8,11
1676_0,,,,2,1,1,2
C1(COC(C(CC1O)O)O)=O,,,3,1,3,10,13
1678_0,,,,2,1,1,2
C1(C(CCOC(C1O)O)O)=O,,,3,1,3,11,14
1680_0,,,,2,1,1,2
C(C(CCC(C=O)O)O)(O)=O,,,3,1,5,15,20
1682_0,,,,2,1,1,2
C(CC(C(O)=O)O)(C(C)O)=O,,,3,1,5,13,18
1683_0,,,,2,1,1,2
1685_0,,,,2,1,1,2
C(C(C(C(CCO)=O)=O)O)=O,,,3,1,3,18,21
1687_0,,,,2,1,1,2
C(C(C(C(CCO)O)=O)=O)=O,,,3,1,3,14,17
1689_0,,,,2,1,1,2
C(C(C=O)O)(CC(CO)=O)=O,,,3,1,4,19,23
1691_0,,,,2,1,1,2
C(C(CC(C(C=O)=O)O)O)=O,,,3,1,5,20,25
1693_0,,,,2,1,1,2
C(C(C(C(C(C)=O)O)=O)O)=O,,,3,1,2,16,18
1695_0,,,,2,1,1,2
C(C(C)O)(C(C(C=O)=O)O)=O,,,3,1,4,16,20
1697_0,,,,2,1,1,2
C(C(C(C(CC=O)O)=O)O)=O,,,3,1,6,22,28
1699_0,,,,2,1,1,2
C(CO)=CC(C(CO)=O)=O,,,3,1,4,18,22
1701_0,,,,2,1,1,2
C(C(C(C=O)=O)O)=CCO,,,3,1,5,14,19
1703_0,,,,2,1,1,2
C(CO)(C(C=CC=O)O)=O,,,3,1,5,23,28
1705_0,,,,2,1,1,2
C(CO)(C(C(C=C)=O)O)=O,,,3,1,4,25,29
1707_0,,,,2,1,1,2
C(C(C(C(C=C)O)=O)O)=O,,,3,1,3,20,23
1709_0,,,,2,1,1,2
C(C=CC(CO)=O)(CO)=O,,,3,1,3,15,18
1711_0,,,,2,1,1,2
C(C(C=CC(C=O)O)O)=O,,,3,1,4,11,15
1712_0,,,,2,1,1,2
1714_0,,,,2,1,1,2
C(CO)(C1(CC(CO1)O)O)=O,,,3,1,3,7,10
1716_0,,,,2,1,1,2
C(CO)(C1C(CC(O1)O)O)=O,,,3,1,3,10,13
1717_0,,,,2,1,1,2
1719_0,,,,2,1,1,2
C1(C(C(CO)O)OC(C1O)O)=O,,,3,1,2,11,13
1720_0,,,,2,1,1,2
1722_0,,,,2,1,1,2
C1(C(C(CO)OC(C1O)O)O)=O,,,3,1,2,8,10
1723_0,,,,2,1,1,2
1725_0,,,,2,1,1,2
C1(C(C(COC(C1O)O)O)O)=O,,,3,1,2,11,13
1726_0,,,,2,1,1,2
1727_0,,,,2,1,1,2
1729_0,,,,2,3,2,5
C(C1C(C(C(C1O)O)O)O)O,,,3,1,1,5,6
1731_0,,,,2,3,2,5
C(C(CO)O)O,,,3,1,3,10,13
1732_0,,,,2,3,2,5
1733_0,,,,2,3,2,5
1734_0,,,,2,3,2,5
1735_0,,,,2,3,2,5
1736_0,,,,2,3,2,5
1738_0,,,,2,3,2,5
CO,,,3,1,9,67,76
1739_0,,,,2,3,2,5
1740_0,,,,2,3,2,5
1741_0,,,,2,3,2,5
1742_0,,,,2,3,2,5
1743_0,,,,2,3,2,5
1744_0,,,,2,3,2,5
1746_0,,,,2,3,2,5
CCO,,,3,1,5,117,122
1747_0,,,,2,3,2,5
1748_0,,,,2,3,2,5
1749_0,,,,2,3,2,5
1750_0,,,,2,3,2,5
1751_0,,,,2,3,2,5
1752_0,,,,2,3,2,5
1754_0,,,,2,3,2,5
C(C(C(CC(CO)O)O)O)=O,,,3,1,8,18,26
1755_0,,,,2,3,2,5
1756_0,,,,2,3,2,5
1757_0,,,,2,3,2,5
1759_0,,,,2,3,2,5
C(C(C(C(CCO)O)O)O)O,,,3,1,2,8,10
1760_0,,,,2,3,2,5
1762_0,,,,2,3,2,5
C(C(C(C(CCO)O)O)O)(O)=O,,,3,1,7,11,18
1764_0,,,,2,3,2,5
C(CC(C(C(CO)O)O)O)(O)=O,,,3,1,3,10,13
1766_0,,,,2,3,2,5
C(C1(C(C(CC1O)O)O)O)O,,,3,1,1,7,8
1768_0,,,,2,3,2,5
C(C(C(CO)O)(C(CO)O)O)O,,,3,1,5,4,9
1770_0,,,,2,3,2,5
C(CCO)(CC(CO)=O)=O,,,3,1,6,28,34
1772_0,,,,2,3,2,5
C(CO)(CCC(CO)=O)=O,,,3,1,3,15,18
1773_0,,,,2,3,2,5
1774_0,,,,2,3,2,5
1776_0,,,,2,3,2,5
C(C(CC(CCO)O)=O)=O,,,3,1,4,21,25
1778_0,,,,2,3,2,5
C(C(CCO)=O)(CCO)=O,,,3,1,2,12,14
1779_0,,,,2,3,2,5
1781_0,,,,2,3,2,5
C(CCO)(C(C(C)=O)O)=O,,,3,1,3,24,27
1782_0,,,,2,3,2,5
1784_0,,,,2,3,2,5
C(CC(C(CCO)O)=O)=O,,,3,1,4,21,25
1786_0,,,,2,3,2,5
C(C(CO)O)(CC(C)=O)=O,,,3,1,4,27,31
1788_0,,,,2,3,2,5
C(CCC=O)(C(CO)O)=O,,,3,1,3,27,30
1790_0,,,,2,3,2,5
C(C(C(CCCO)=O)O)=O,,,3,1,2,21,23
1792_0,,,,2,3,2,5
C(C(C)=O)(CC(CO)O)=O,,,3,1,4,21,25
1794_0,,,,2,3,2,5
C(CC(CC(CO)O)=O)=O,,,3,1,5,26,31
1796_0,,,,2,3,2,5
C(CC(C=O)O)(CCO)=O,,,3,1,6,31,37
1798_0,,,,2,3,2,5
C(CC1C(C(C(O)O1)O)O)O,,,3,1,2,6,8
1800_0,,,,2,3,2,5
C(C(CC(CCO)O)O)(O)=O,,,3,1,4,9,13
1801_0,,,,2,3,2,5
1802_0,,,,2,3,2,5
1803_0,,,,2,3,2,5
1804_0,,,,2,3,2,5
1805_0,,,,2,3,2,5
1806_0,,,,2,3,2,5
1807_0,,,,2,3,2,5
1809_0,,,,2,3,2,5
C(C(CO)O)=CC(CO)=O,,,3,1,5,16,21
1811_0,,,,2,3,2,5
C(CO)=CC(C(CO)O)=O,,,3,1,4,19,23
1812_0,,,,2,3,2,5
1814_0,,,,2,3,2,5
C=CC(C(C(CO)O)O)=O,,,3,1,5,23,28
1815_0,,,,2,3,2,5
1817_0,,,,2,3,2,5
C(C(C(CO)O)O)=CC=O,,,3,1,3,13,16
1819_0,,,,2,3,2,5
C(C(C(C=CCO)O)O)=O,,,3,1,4,19,23
1821_0,,,,2,3,2,5
C(C1(CC(C(CO)O1)O)O)O,,,3,1,3,4,7
1823_0,,,,2,3,2,5
C1C(C(C(CCO)(O)O1)O)O,,,3,1,2,6,8
1825_0,,,,2,3,2,5
C1C(CC(C(CO)O)(O)O1)O,,,3,1,2,6,8
1826_0,,,,2,3,2,5
1828_0,,,,2,3,2,5
CC1(C(C(C(CO)O1)O)O)O,,,3,1,2,5,7
1830_0,,,,2,3,2,5
C(C(C1C(CC(O)O1)O)O)O,,,3,1,2,5,7
1831_0,,,,2,3,2,5
1833_0,,,,2,3,2,5
C1C(C(CC(CO)(O)O1)O)O,,,3,1,2,6,8
1835_0,,,,2,3,2,5
C(C1C(C(CC(O)O1)O)O)O,,,3,1,2,5,7
1836_0,,,,2,3,2,5
1837_0,,,,2,3,2,5
1839_0,,,,2,3,2,5
C(C(C(CC(CO)O)O)O)O,,,3,1,2,8,10
1841_0,,,,2,3,2,5
C(C1C(C(C(C1O)O)O)O)(O)=O,,,3,1,2,7,9
1842_0,,,,2,3,2,5
1843_0,,,,2,3,2,5
1844_0,,,,2,3,2,5
1845_0,,,,2,3,2,5
1846_0,,,,2,3,2,5
1847_0,,,,2,3,2,5
1849_0,,,,2,3,2,5
C(O)=O,,,3,1,1,0,1
1851_0,,,,2,3,2,5
C(C(CCO)=O)(O)=O,,,3,1,11,44,55
1852_0,,,,2,3,2,5
1853_0,,,,2,3,2,5
1854_0,,,,2,3,2,5
1855_0,,,,2,3,2,5
1856_0,,,,2,3,2,5
1858_0,,,,2,3,2,5
C(C)(O)=O,,,3,1,1,16,17
1859_0,,,,2,3,2,5
1860_0,,,,2,3,2,5
1861_0,,,,2,3,2,5
1862_0,,,,2,3,2,5
1863_0,,,,2,3,2,5
1864_0,,,,2,3,2,5
1866_0,,,,2,3,2,5
C(C(CC(C(C=O)O)O)O)(O)=O,,,3,1,10,19,29
1867_0,,,,2,3,2,5
1868_0,,,,2,3,2,5
1869_0,,,,2,3,2,5
1870_0,,,,2,3,2,5
1871_0,,,,2,3,2,5
1873_0,,,,2,3,2,5
C(CC(C(C(C(O)=O)O)O)O)(O)=O,,,3,1,6,12,18
1874_0,,,,2,3,2,5
1876_0,,,,2,3,2,5
C(C1(C(C(CC1O)O)O)O)(O)=O,,,3,1,5,13,18
1878_0,,,,2,3,2,5
C(C(C(CO)O)(C(CO)O)O)(O)=O,,,3,1,4,7,11
1880_0,,,,2,3,2,5
C(CCO)(CC(C(O)=O)=O)=O,,,3,1,4,15,19
1882_0,,,,2,3,2,5
C(CO)(CCC(C(O)=O)=O)=O,,,3,1,4,15,19
1884_0,,,,2,3,2,5
C(C)(C(CC(C(O)=O)=O)O)=O,,,3,1,5,15,20
1886_0,,,,2,3,2,5
C(CC(CC(C(O)=O)=O)O)=O,,,3,1,5,17,22
1888_0,,,,2,3,2,5
C(CC(CC(C=O)=O)O)(O)=O,,,3,1,3,16,19
1890_0,,,,2,3,2,5
C(CC(C(CCO)=O)=O)(O)=O,,,3,1,3,14,17
1892_0,,,,2,3,2,5
C(CC(CC(CO)=O)=O)(O)=O,,,3,1,5,15,20
1894_0,,,,2,3,2,5
C(CC(C(C(C)=O)O)=O)(O)=O,,,3,1,3,13,16
1896_0,,,,2,3,2,5
C(CC(C(CC=O)O)=O)(O)=O,,,3,1,5,18,23
1898_0,,,,2,3,2,5
C(CC(C(CC(O)=O)O)=O)=O,,,3,1,4,14,18
1900_0,,,,2,3,2,5
C(C(C(O)=O)O)(CC(C)=O)=O,,,3,1,6,14,20
1902_0,,,,2,3,2,5
C(C(C(CCC=O)=O)O)(O)=O,,,3,1,6,16,22
1904_0,,,,2,3,2,5
C(C(C(CCC(O)=O)=O)O)=O,,,3,1,2,12,14
1906_0,,,,2,3,2,5
C(C(CC(C(C)=O)=O)O)(O)=O,,,3,1,7,14,21
1908_0,,,,2,3,2,5
C(CC(CC(C(O)=O)O)=O)=O,,,3,1,9,18,27
1910_0,,,,2,3,2,5
C(CC(CC(C=O)O)=O)(O)=O,,,3,1,4,20,24
1912_0,,,,2,3,2,5
C(CC1C(C(C(O)O1)O)O)(O)=O,,,3,1,2,8,10
1914_0,,,,2,3,2,5
C(CC(CC(C(O)=O)O)O)(O)=O,,,3,1,4,8,12
1916_0,,,,2,3,2,5
C(C(C(CC(CO)O)=O)=O)(O)=O,,,3,1,2,14,16
1918_0,,,,2,3,2,5
C(C(CO)O)(CC(C(O)=O)=O)=O,,,3,1,4,15,19
1920_0,,,,2,3,2,5
C(CCO)(C(C(C(O)=O)=O)O)=O,,,3,1,3,11,14
1922_0,,,,2,3,2,5
C(CO)(CC(C(C(O)=O)=O)O)=O,,,3,1,3,13,16
1924_0,,,,2,3,2,5
C(C)(C(C(C(C(O)=O)=O)O)O)=O,,,3,1,5,15,20
1926_0,,,,2,3,2,5
C(CC(C(C(C(O)=O)=O)O)O)=O,,,3,1,5,16,21
1928_0,,,,2,3,2,5
C(CC(C(C(C=O)=O)O)O)(O)=O,,,3,1,3,17,20
1930_0,,,,2,3,2,5
C(C(CO)O)=CC(C(O)=O)=O,,,3,1,4,8,12
1932_0,,,,2,3,2,5
C(C(C(C=CCO)=O)O)(O)=O,,,3,1,6,9,15
1934_0,,,,2,3,2,5
C(C=CC(C(CO)O)=O)(O)=O,,,3,1,3,13,16
1936_0,,,,2,3,2,5
C(C(C(C(C=C)=O)O)O)(O)=O,,,3,1,9,17,26
1938_0,,,,2,3,2,5
C(C(C=CC(CO)=O)O)(O)=O,,,3,1,6,10,16
1940_0,,,,2,3,2,5
C(C(C(C=CC=O)O)O)(O)=O,,,3,1,7,14,21
1942_0,,,,2,3,2,5
C(C(C(C=CC(O)=O)O)O)=O,,,3,1,3,16,19
1944_0,,,,2,3,2,5
C(C1(CC(C(CO)O1)O)O)(O)=O,,,3,1,2,6,8
1946_0,,,,2,3,2,5
C(CC1(C(C(CO1)O)O)O)(O)=O,,,3,1,2,7,9
1948_0,,,,2,3,2,5
C(C(C1(CC(CO1)O)O)O)(O)=O,,,3,1,5,8,13
1950_0,,,,2,3,2,5
C(C1C(CC(CO)(O1)O)O)(O)=O,,,3,1,2,7,9
1952_0,,,,2,3,2,5
C(C1C(C(C(C)(O1)O)O)O)(O)=O,,,3,1,2,8,10
1954_0,,,,2,3,2,5
C(C(C1C(CC(O)O1)O)O)(O)=O,,,3,1,5,7,12
1956_0,,,,2,3,2,5
C(C1(C(C(C(CO)O1)O)O)O)(O)=O,,,3,1,2,8,10
1958_0,,,,2,3,2,5
C(C1(CC(C(CO1)O)O)O)(O)=O,,,3,1,2,8,10
1960_0,,,,2,3,2,5
C(C1C(C(CC(O1)O)O)O)(O)=O,,,3,1,2,8,10
1962_0,,,,2,3,2,5
C(C1(C(C(C(CO1)O)O)O)O)(O)=O,,,3,1,2,10,12
1964_0,,,,2,3,2,5
C(C(C(CO)O)=O)(O)=O,,,3,1,6,22,28
1965_0,,,,2,3,2,5
1967_0,,,,2,1,1,2
C1(C(CC(C1(CO)O)O)O)=O,,,3,1,6,12,18
1967_1,,,,2,1,1,2
1968_0,,,,2,1,1,2
1968_1,,,,2,1,1,2
1969_0,,,,2,1,1,2
1969_1,,,,2,1,1,2
1970_0,,,,2,1,1,2
1972_0,,,,2,1,1,2
C(C1(C(CCC1O)=O)O)=O,,,3,1,3,14,17
1972_1,,,,2,1,1,2
1974_0,,,,2,1,1,2
C1(C(CO)(C(C(C1)=O)O)O)=O,,,3,1,2,19,21
1974_1,,,,2,1,1,2
1976_0,,,,2,1,1,2
C1C(C(C(C=1)=O)(CO)O)O,,,3,1,4,15,19
1976_1,,,,2,1,1,2
1978_0,,,,2,1,1,2
C(C1(C(C=CC1O)O)O)=O,,,3,1,3,8,11
1978_1,,,,2,1,1,2
1979_0,,,,2,2,1,3
1979_1,,,,2,2,1,3
1981_0,,,,2,2,1,3
C1(C(C(C(C1(CO)CO)O)O)O)=O,,,3,1,2,11,13
1983_0,,,,2,2,1,3
C1(CC(C(C(C1(CO)O)O)O)O)=O,,,3,1,5,15,20
1983_1,,,,2,2,1,3
1985_0,,,,2,2,1,3
C(C1(CO)C(C(C(C1O)O)O)O)=O,,,3,1,2,10,12
1987_0,,,,2,2,1,3
C(C(CO)(C(CO)(CO)O)O)=O,,,3,1,6,11,17
1987_1,,,,2,2,1,3
1989_0,,,,2,2,1,3
C(C(C(C)=O)(C(CO)(CO)O)O)=O,,,3,1,3,7,10
1989_1,,,,2,2,1,3
1991_0,,,,2,2,1,3
C(C)(C(CO)(C(CO)(CO)O)O)=O,,,3,1,6,9,15
1991_1,,,,2,2,1,3
1993_0,,,,2,2,1,3
C(C(C=O)(C(CO)(CO)O)O)=O,,,3,1,3,7,10
1993_1,,,,2,2,1,3
1995_0,,,,2,2,1,3
C(C(CO)(C(C(CO)O)O)O)=O,,,3,1,8,16,24
1995_1,,,,2,2,1,3
1996_0,,,,2,2,1,3
1996_1,,,,2,2,1,3
1998_0,,,,2,2,1,3
C(C(CO)(C(C=O)(C)O)O)=O,,,3,1,6,15,21
1998_1,,,,2,2,1,3
2000_0,,,,2,2,1,3
C(C(CO)(C(CC(CO)=O)O)O)=O,,,3,1,10,17,27
2000_1,,,,2,2,1,3
2002_0,,,,2,2,1,3
C(C(CO)(C(CO)(CC=O)O)O)=O,,,3,1,6,16,22
2002_1,,,,2,2,1,3
2004_0,,,,2,2,1,3
C(C(C(C)=O)(C(C(CO)O)O)O)=O,,,3,1,4,13,17
2004_1,,,,2,2,1,3
2006_0,,,,2,2,1,3
C(C(CO)(C(C(C(C)=O)O)O)O)=O,,,3,1,12,18,30
2006_1,,,,2,2,1,3
2008_0,,,,2,2,1,3
C(C(CO)(C(C)(C(C=O)O)O)O)=O,,,3,1,7,18,25
2008_1,,,,2,2,1,3
2009_0,,,,2,2,1,3
2009_1,,,,2,2,1,3
2011_0,,,,2,2,1,3
C(C)(C(CO)(C(C(CO)O)O)O)=O,,,3,1,7,14,21
2011_1,,,,2,2,1,3
2013_0,,,,2,2,1,3
C(C(CO)(C(C)(C(CO)O)O)O)=O,,,3,1,6,14,20
2013_1,,,,2,2,1,3
2015_0,,,,2,2,1,3
C(C(CO)(CO)O)=O,,,3,1,4,19,23
2015_1,,,,2,2,1,3
2016_0,,,,2,2,1,3
2016_1,,,,2,2,1,3
2018_0,,,,2,2,1,3
C(C(CCO)(C(C=O)(CO)O)O)=O,,,3,1,7,16,23
2018_1,,,,2,2,1,3
2020_0,,,,2,2,1,3
C(C(CO)(C(CO)(CCO)O)O)=O,,,3,1,7,13,20
2020_1,,,,2,2,1,3
2022_0,,,,2,2,1,3
C(C(C=O)(C(C(CO)O)O)O)=O,,,3,1,4,12,16
2022_1,,,,2,2,1,3
2024_0,,,,2,2,1,3
C(C(CO)(C(C(C=O)O)O)O)=O,,,3,1,10,23,33
2024_1,,,,2,2,1,3
2026_0,,,,2,2,1,3
C(C(CO)(C(CO)(C)O)O)=O,,,3,1,6,12,18
2026_1,,,,2,2,1,3
2028_0,,,,2,2,1,3
C(C(CO)(C(C(CC=O)O)O)O)=O,,,3,1,12,20,32
2028_1,,,,2,2,1,3
2030_0,,,,2,2,1,3
C(C(CO)(C(CC(C=O)O)O)O)=O,,,3,1,8,19,27
2030_1,,,,2,2,1,3
2032_0,,,,2,2,1,3
C(C(CO)(C(C)O)O)=O,,,3,1,5,14,19
2032_1,,,,2,2,1,3
2033_0,,,,2,2,1,3
2033_1,,,,2,2,1,3
2035_0,,,,2,2,1,3
C(C(CO)(C(C=O)(CO)O)O)=O,,,3,1,5,10,15
2035_1,,,,2,2,1,3
2037_0,,,,2,2,1,3
C(C(C(C)=O)(C(C(C)=O)O)O)=O,,,3,1,6,14,20
2037_1,,,,2,2,1,3
2039_0,,,,2,2,1,3
C(C(C)(C(C=O)(C(C)=O)O)O)=O,,,3,1,4,12,16
2039_1,,,,2,2,1,3
2041_0,,,,2,2,1,3
C(C)(C(CO)(C(C(C)=O)O)O)=O,,,3,1,9,16,25
2041_1,,,,2,2,1,3
2043_0,,,,2,2,1,3
C(C(C)(C(C(C)=O)(CO)O)O)=O,,,3,1,6,15,21
2043_1,,,,2,2,1,3
2045_0,,,,2,2,1,3
C(C(C=O)(C(C(C)=O)O)O)=O,,,3,1,7,14,21
2045_1,,,,2,2,1,3
2047_0,,,,2,2,1,3
C(C(C=O)(C(C=O)(C)O)O)=O,,,3,1,3,10,13
2047_1,,,,2,2,1,3
2049_0,,,,2,2,1,3
C(C(C(C=O)(C(C(C)=O)O)O)O)=O,,,3,1,8,21,29
2049_1,,,,2,2,1,3
2051_0,,,,2,2,1,3
C(C(C(C=O)(C(C=O)(C)O)O)O)=O,,,3,1,5,19,24
2051_1,,,,2,2,1,3
2053_0,,,,2,2,1,3
C(CO)(C(CO)(C(C(C)=O)O)O)=O,,,3,1,6,17,23
2053_1,,,,2,2,1,3
2055_0,,,,2,2,1,3
C(C(C)(C(C(CO)=O)(CO)O)O)=O,,,3,1,6,16,22
2055_1,,,,2,2,1,3
2057_0,,,,2,2,1,3
C(C(C(C(C=O)=O)(CO)O)O)(C)=O,,,3,1,4,19,23
2057_1,,,,2,2,1,3
2059_0,,,,2,2,1,3
C(C(C)(C(C(C=O)=O)(CO)O)O)=O,,,3,1,4,17,21
2059_1,,,,2,2,1,3
2061_0,,,,2,2,1,3
C(C(C=O)(C(CC(CO)=O)O)O)=O,,,3,1,3,12,15
2061_1,,,,2,2,1,3
2063_0,,,,2,2,1,3
C(C(C=O)(C(CO)(CC=O)O)O)=O,,,3,1,2,11,13
2063_1,,,,2,2,1,3
2065_0,,,,2,2,1,3
C(C(C(C)=O)(C(C=O)O)O)=O,,,3,1,8,18,26
2065_1,,,,2,2,1,3
2067_0,,,,2,2,1,3
C(C(C(C)=O)(CO)O)=O,,,3,1,9,18,27
2067_1,,,,2,2,1,3
2069_0,,,,2,2,1,3
C(C(C=O)(C(C(C(C)=O)O)O)O)=O,,,3,1,2,13,15
2069_1,,,,2,2,1,3
2071_0,,,,2,2,1,3
C(C(C=O)(C(C)(C(C=O)O)O)O)=O,,,3,1,2,13,15
2071_1,,,,2,2,1,3
2073_0,,,,2,2,1,3
C(C(C(C(C=O)(C(C)=O)O)O)O)=O,,,3,1,3,17,20
2073_1,,,,2,2,1,3
2075_0,,,,2,2,1,3
C(C(C(C)=O)(C(CO)(C)O)O)=O,,,3,1,4,10,14
2075_1,,,,2,2,1,3
2077_0,,,,2,2,1,3
C(C(C(C)=O)(C(C)O)O)=O,,,3,1,3,13,16
2077_1,,,,2,2,1,3
2079_0,,,,2,2,1,3
C(C(C(C)=O)(C(C(CO)=O)O)O)=O,,,3,1,5,16,21
2079_1,,,,2,2,1,3
2081_0,,,,2,2,1,3
C(C(CO)(C(C=O)(C(C)=O)O)O)=O,,,3,1,6,15,21
2081_1,,,,2,2,1,3
2082_0,,,,2,2,1,3
2082_1,,,,2,2,1,3
2083_0,,,,2,2,1,3
2083_1,,,,2,2,1,3
2085_0,,,,2,2,1,3
C(C(C(C(C)=O)(C(C=O)O)O)O)=O,,,3,1,2,11,13
2085_1,,,,2,2,1,3
2087_0,,,,2,2,1,3
C(C(C=O)(C(C=O)O)O)=O,,,3,1,8,21,29
2087_1,,,,2,2,1,3
2089_0,,,,2,2,1,3
C(C(C(C=O)(C(C=O)O)O)O)=O,,,3,1,4,14,18
2089_1,,,,2,2,1,3
2091_0,,,,2,2,1,3
C(CO)(C(CO)(C(C=O)O)O)=O,,,3,1,6,20,26
2091_1,,,,2,2,1,3
2093_0,,,,2,2,1,3
C(C(C(CO)O)(C(C=O)O)O)(O)=O,,,3,1,7,18,25
2093_1,,,,2,2,1,3
2095_0,,,,2,2,1,3
C(C(C(C(C=O)=O)(CO)O)O)=O,,,3,1,4,24,28
2095_1,,,,2,2,1,3
2097_0,,,,2,2,1,3
C(C)(C(CO)(CO)O)=O,,,3,1,5,13,18
2097_1,,,,2,2,1,3
2099_0,,,,2,2,1,3
C(C(C=O)(C(C)(C(CO)O)O)O)=O,,,3,1,3,10,13
2099_1,,,,2,2,1,3
2101_0,,,,2,2,1,3
C(C(C(C(C(C)=O)(CO)O)O)O)=O,,,3,1,14,20,34
2101_1,,,,2,2,1,3
2103_0,,,,2,2,1,3
C(C)(C(CO)(C(CO)(C)O)O)=O,,,3,1,6,11,17
2103_1,,,,2,2,1,3
2105_0,,,,2,2,1,3
C(C)(C(CO)(C(C)O)O)=O,,,3,1,5,14,19
2105_1,,,,2,2,1,3
2107_0,,,,2,2,1,3
C(C)(C(CO)(C(C(CO)=O)O)O)=O,,,3,1,9,17,26
2107_1,,,,2,2,1,3
2109_0,,,,2,2,1,3
C(C(CO)(C(C(C)=O)(CO)O)O)=O,,,3,1,9,18,27
2109_1,,,,2,2,1,3
2110_0,,,,2,2,1,3
2110_1,,,,2,2,1,3
2111_0,,,,2,2,1,3
2111_1,,,,2,2,1,3
2113_0,,,,2,2,1,3
C(C(C=O)(CO)O)=O,,,3,1,8,19,27
2113_1,,,,2,2,1,3
2114_0,,,,2,2,1,3
2114_1,,,,2,2,1,3
2116_0,,,,2,2,1,3
C(CO)(C(CO)(CO)O)=O,,,3,1,5,12,17
2116_1,,,,2,2,1,3
2118_0,,,,2,2,1,3
C(CC(C(C(CO)(CO)O)=O)O)=O,,,3,1,6,10,16
2118_1,,,,2,2,1,3
2120_0,,,,2,2,1,3
C(C(CO)(CO)O)(CC(CO)=O)=O,,,3,1,5,8,13
2120_1,,,,2,2,1,3
2122_0,,,,2,2,1,3
C(CCO)(C(C(CO)=O)(CO)O)=O,,,3,1,4,9,13
2122_1,,,,2,2,1,3
2124_0,,,,2,2,1,3
C(C(C(C(CCO)O)=O)(CO)O)=O,,,3,1,4,11,15
2124_1,,,,2,2,1,3
2125_0,,,,2,2,1,3
2125_1,,,,2,2,1,3
2126_0,,,,2,2,1,3
2126_1,,,,2,2,1,3
2127_0,,,,2,2,1,3
2127_1,,,,2,2,1,3
2129_0,,,,2,2,1,3
C(C(CO)(C(C(C(C)O)=O)O)O)=O,,,3,1,8,17,25
2129_1,,,,2,2,1,3
2131_0,,,,2,2,1,3
C(C(CO)(C(C=O)O)O)(C(C)O)=O,,,3,1,3,18,21
2131_1,,,,2,2,1,3
2133_0,,,,2,2,1,3
C(CC(C(C(CO)=O)(CO)O)O)=O,,,3,1,6,17,23
2133_1,,,,2,2,1,3
2135_0,,,,2,2,1,3
C(CCO)(C(CO)(C(CO)O)O)=O,,,3,1,7,13,20
2135_1,,,,2,2,1,3
2137_0,,,,2,2,1,3
C(CC(CO)O)(C(CO)(CO)O)=O,,,3,1,5,9,14
2137_1,,,,2,2,1,3
2138_0,,,,2,2,1,3
2138_1,,,,2,2,1,3
2140_0,,,,2,2,1,3
C(C(CO)(C(C(CCO)O)O)O)=O,,,3,1,5,15,20
2140_1,,,,2,2,1,3
2142_0,,,,2,2,1,3
C(C(CO)(C(CO)O)O)(O)=O,,,3,1,5,10,15
2142_1,,,,2,2,1,3
2144_0,,,,2,2,1,3
C(CC=O)(C(C(C)=O)(CO)O)=O,,,3,1,4,12,16
2144_1,,,,2,2,1,3
2146_0,,,,2,2,1,3
C(C(C(CC(C)=O)=O)(CO)O)=O,,,3,1,4,12,16
2146_1,,,,2,2,1,3
2148_0,,,,2,2,1,3
C(C(C(CCC=O)=O)(CO)O)=O,,,3,1,4,13,17
2148_1,,,,2,2,1,3
2150_0,,,,2,2,1,3
C1(C(CO)C(C(C(CO)O)O1)O)=O,,,3,1,3,6,9
2152_0,,,,2,2,1,3
C1(COC(C(CO)O)C1(CO)O)=O,,,3,1,2,8,10
2152_1,,,,2,2,1,3
2154_0,,,,2,2,1,3
C1(CC(OC1(CO)C(CO)O)O)=O,,,3,1,3,12,15
2154_1,,,,2,2,1,3
2156_0,,,,2,2,1,3
C(C)(C1(CO)C(C(C(O1)O)O)O)=O,,,3,1,3,12,15
2156_1,,,,2,2,1,3
2158_0,,,,2,2,1,3
C1(C(CO)C(C(C(CO)O1)O)O)=O,,,3,1,2,7,9
2160_0,,,,2,2,1,3
C1(COC(CO)C(C1(CO)O)O)=O,,,3,1,2,9,11
2160_1,,,,2,2,1,3
2162_0,,,,2,2,1,3
C1(CC(O)OC(CO)C1(CO)O)=O,,,3,1,3,8,11
2162_1,,,,2,2,1,3
2164_0,,,,2,2,1,3
C1(CC(CO)OC(C1(CO)O)O)=O,,,3,1,3,10,13
2164_1,,,,2,2,1,3
2166_0,,,,2,2,1,3
C1(CC(C(OC1(CO)CO)O)O)=O,,,3,1,3,8,11
2166_1,,,,2,2,1,3
2168_0,,,,2,2,1,3
C1(C(CO)C(C(C(CO1)O)O)O)=O,,,3,1,1,10,11
2170_0,,,,2,2,1,3
C1(COCC(C(C1(CO)O)O)O)=O,,,3,1,2,11,13
2170_1,,,,2,2,1,3
2172_0,,,,2,2,1,3
C1(CC(O)OCC(C1(CO)O)O)=O,,,3,1,3,11,14
2172_1,,,,2,2,1,3
2174_0,,,,2,2,1,3
C1(CC(COC(C1(CO)O)O)O)=O,,,3,1,3,11,14
2174_1,,,,2,2,1,3
2176_0,,,,2,2,1,3
C1(CC(C(O)OCC1(CO)O)O)=O,,,3,1,3,10,13
2176_1,,,,2,2,1,3
2178_0,,,,2,2,1,3
C1(CCOC(C(C1(CO)O)O)O)=O,,,3,1,3,12,15
2178_1,,,,2,2,1,3
2180_0,,,,2,2,1,3
C(C(CO)(CO)O)(CC(C=O)=O)=O,,,3,1,3,10,13
2180_1,,,,2,2,1,3
2182_0,,,,2,2,1,3
C(CCO)(C(C(C=O)=O)(CO)O)=O,,,3,1,3,14,17
2182_1,,,,2,2,1,3
2183_0,,,,2,2,1,3
2183_1,,,,2,2,1,3
2185_0,,,,2,2,1,3
C(C)(C(CO)(C(C(C=O)=O)O)O)=O,,,3,1,7,19,26
2185_1,,,,2,2,1,3
2187_0,,,,2,2,1,3
C(CC(C(C(C=O)=O)(CO)O)O)=O,,,3,1,4,20,24
2187_1,,,,2,2,1,3
2189_0,,,,2,2,1,3
C(C(C(C=CCO)=O)(CO)O)=O,,,3,1,4,9,13
2189_1,,,,2,2,1,3
2191_0,,,,2,2,1,3
C(C=CC(C(CO)(CO)O)=O)=O,,,3,1,4,9,13
2191_1,,,,2,2,1,3
2193_0,,,,2,2,1,3
C(C(CO)(C(C(C=C)=O)O)O)=O,,,3,1,8,17,25
2193_1,,,,2,2,1,3
2195_0,,,,2,2,1,3
C(C(C(C(C=C)=O)(CO)O)O)=O,,,3,1,4,20,24
2195_1,,,,2,2,1,3
2197_0,,,,2,2,1,3
C(C(CO)(C(C=CC=O)O)O)=O,,,3,1,6,14,20
2197_1,,,,2,2,1,3
2199_0,,,,2,2,1,3
C(C(CO)(C1(CC(CO1)O)O)O)=O,,,3,1,3,12,15
2199_1,,,,2,2,1,3
2201_0,,,,2,2,1,3
C(C1(CO)C(CC(CO)(O1)O)O)=O,,,3,1,3,12,15
2201_1,,,,2,2,1,3
2203_0,,,,2,2,1,3
C(C1(CO)C(C(C(C)(O1)O)O)O)=O,,,3,1,3,13,16
2203_1,,,,2,2,1,3
2205_0,,,,2,2,1,3
C(C(CO)(C1C(CC(O)O1)O)O)=O,,,3,1,3,10,13
2205_1,,,,2,2,1,3
2207_0,,,,2,2,1,3
C(C1(CO)C(C(CC(O1)O)O)O)=O,,,3,1,3,13,16
2207_1,,,,2,2,1,3
2209_0,,,,2,2,1,3
C(C(C(CO)(CO)O)=O)=O,,,3,1,6,13,19
2209_1,,,,2,2,1,3
2211_0,,,,2,2,1,3
C(C(C=O)(C(C(CCO)=O)O)O)=O,,,3,1,5,13,18
2211_1,,,,2,2,1,3
2213_0,,,,2,2,1,3
C(C(C=O)(C(C=O)(CCO)O)O)=O,,,3,1,3,11,14
2213_1,,,,2,2,1,3
2215_0,,,,2,2,1,3
C(C(C=O)(C(CO)(CCO)O)O)=O,,,3,1,4,9,13
2215_1,,,,2,2,1,3
2217_0,,,,2,2,1,3
C(C(C(C)O)(C(C(C)=O)O)O)=O,,,3,1,6,17,23
2217_1,,,,2,2,1,3
2219_0,,,,2,2,1,3
C(C)(C(C(C)O)(C(C=O)O)O)=O,,,3,1,4,19,23
2219_1,,,,2,2,1,3
2221_0,,,,2,2,1,3
C(C(C=O)(C(C(C=O)O)O)O)=O,,,3,1,3,18,21
2221_1,,,,2,2,1,3
2223_0,,,,2,2,1,3
C(C(C=O)(C(CO)(C)O)O)=O,,,3,1,3,8,11
2223_1,,,,2,2,1,3
2225_0,,,,2,2,1,3
C(C(C=O)(C(C(CC=O)O)O)O)=O,,,3,1,3,15,18
2225_1,,,,2,2,1,3
2227_0,,,,2,2,1,3
C(C(C=O)(C(CC(C=O)O)O)O)=O,,,3,1,3,14,17
2227_1,,,,2,2,1,3
2229_0,,,,2,2,1,3
C(C(C=O)(C(C)O)O)=O,,,3,1,2,10,12
2229_1,,,,2,2,1,3
2231_0,,,,2,2,1,3
C(C(C=O)(C(C(CO)=O)O)O)=O,,,3,1,5,13,18
2231_1,,,,2,2,1,3
2233_0,,,,2,2,1,3
C(C(C=O)(C(C=O)(CO)O)O)=O,,,3,1,6,15,21
2233_1,,,,2,2,1,3
2235_0,,,,2,2,1,3
C(C(C(CO)(C)O)(C(C=O)O)O)=O,,,3,1,5,18,23
2235_1,,,,2,2,1,3
2237_0,,,,2,2,1,3
C(CO)(C(CO)(C(CO)(C)O)O)=O,,,3,1,7,11,18
2237_1,,,,2,2,1,3
2239_0,,,,2,2,1,3
C(C(C(CO)(C(CO)(C)O)O)=O)=O,,,3,1,5,16,21
2239_1,,,,2,2,1,3
2241_0,,,,2,2,1,3
C(C(C(C)O)(C(C=O)O)O)=O,,,3,1,6,21,27
2241_1,,,,2,2,1,3
2243_0,,,,2,2,1,3
C(CO)(C(CO)(C(C)O)O)=O,,,3,1,6,12,18
2243_1,,,,2,2,1,3
2245_0,,,,2,2,1,3
C(C(C(CO)O)(C(C)O)O)(O)=O,,,3,1,5,11,16
2245_1,,,,2,2,1,3
2247_0,,,,2,2,1,3
C(CC=O)(C(C(C)=O)(C(C)O)O)=O,,,3,1,2,9,11
2247_1,,,,2,2,1,3
2249_0,,,,2,2,1,3
C(C(C(CC(C)=O)=O)(C(C)O)O)=O,,,3,1,2,9,11
2249_1,,,,2,2,1,3
2251_0,,,,2,2,1,3
C(C(C(CCC=O)=O)(C(C)O)O)=O,,,3,1,2,10,12
2251_1,,,,2,2,1,3
2253_0,,,,2,2,1,3
C(C(C(C=CCO)=O)(C(C)O)O)=O,,,3,1,2,8,10
2253_1,,,,2,2,1,3
2255_0,,,,2,2,1,3
C(C=CC(C(CO)(C(C)O)O)=O)=O,,,3,1,2,14,16
2255_1,,,,2,2,1,3
2257_0,,,,2,2,1,3
C(C(C(C)O)(C(C(C=C)=O)O)O)=O,,,3,1,6,16,22
2257_1,,,,2,2,1,3
2259_0,,,,2,2,1,3
C(C(C(C(C=C)=O)(C(C)O)O)O)=O,,,3,1,2,18,20
2259_1,,,,2,2,1,3
2261_0,,,,2,2,1,3
C(C(C(C)O)(C(C=CC=O)O)O)=O,,,3,1,4,12,16
2261_1,,,,2,2,1,3
2263_0,,,,2,2,1,3
C(C(C(CO)(C(C)O)O)=O)=O,,,3,1,4,17,21
2263_1,,,,2,2,1,3
2265_0,,,,2,2,1,3
C(C(CO)(C(CO)O)O)=O,,,3,1,9,14,23
2265_1,,,,2,2,1,3
2267_0,,,,2,2,1,3
C(C(C(C)=O)(C(CO)O)O)=O,,,3,1,4,12,16
2267_1,,,,2,2,1,3
2269_0,,,,2,2,1,3
C(C)(C(CO)(C(CO)O)O)=O,,,3,1,8,13,21
2269_1,,,,2,2,1,3
2270_0,,,,2,2,1,3
2270_1,,,,2,2,1,3
2272_0,,,,2,2,1,3
C(C)(C(C(CO)O)(C(C=O)O)O)=O,,,3,1,5,19,24
2272_1,,,,2,2,1,3
2274_0,,,,2,2,1,3
C(C(C=O)(C(CO)O)O)=O,,,3,1,3,10,13
2274_1,,,,2,2,1,3
2275_0,,,,2,2,1,3
2275_1,,,,2,2,1,3
2277_0,,,,2,2,1,3
C(CO)(C(CO)(C(CO)O)O)=O,,,3,1,8,12,20
2277_1,,,,2,2,1,3
2278_0,,,,2,2,1,3
2278_1,,,,2,2,1,3
2280_0,,,,2,2,1,3
C(C(C(CO)(C(CO)O)O)=O)=O,,,3,1,7,20,27
2280_1,,,,2,2,1,3
2281_0,,,,2,2,1,3
2281_1,,,,2,2,1,3
2283_0,,,,2,2,1,3
C(C(C(CO)O)(C(C=O)(C)O)O)=O,,,3,1,9,17,26
2283_1,,,,2,2,1,3
2284_0,,,,2,2,1,3
2284_1,,,,2,2,1,3
2285_0,,,,2,2,1,3
2285_1,,,,2,2,1,3
2287_0,,,,2,2,1,3
C(C(C(CO)O)(C(CO)(C)O)O)=O,,,3,1,9,14,23
2287_1,,,,2,2,1,3
2289_0,,,,2,2,1,3
C(C(C(CO)O)(C(C)O)O)=O,,,3,1,8,14,22
2289_1,,,,2,2,1,3
2291_0,,,,2,2,1,3
C(CC(C(CO)(C(CO)O)O)=O)=O,,,3,1,10,16,26
2291_1,,,,2,2,1,3
2293_0,,,,2,2,1,3
C(C(C(CC(CO)O)=O)(CO)O)=O,,,3,1,9,12,21
2293_1,,,,2,2,1,3
2295_0,,,,2,2,1,3
C(CC(C=O)O)(C(CO)(CO)O)=O,,,3,1,9,11,20
2295_1,,,,2,2,1,3
2296_0,,,,2,2,1,3
2296_1,,,,2,2,1,3
2298_0,,,,2,2,1,3
C(C(CO)(C(C=O)O)O)(CCO)=O,,,3,1,12,19,31
2298_1,,,,2,2,1,3
2299_0,,,,2,2,1,3
2299_1,,,,2,2,1,3
2300_0,,,,2,2,1,3
2300_1,,,,2,2,1,3
2301_0,,,,2,2,1,3
2301_1,,,,2,2,1,3
2302_0,,,,2,2,1,3
2302_1,,,,2,2,1,3
2304_0,,,,2,1,1,2
C(C1(C(C(C(C1)O)O)O)O)=O,,,3,1,6,15,21
2306_0,,,,2,1,1,2
C1(C(C(C(C1(C)O)O)O)O)=O,,,3,1,3,13,16
2308_0,,,,2,1,1,2
C(C1(C(CC(C1)=O)O)O)=O,,,3,1,4,25,29
2310_0,,,,2,1,1,2
C(C1(C(CC(C1)O)O)O)(O)=O,,,3,1,1,9,10
2312_0,,,,2,2,1,3
C(C(C(CO)(CO)O)(CC=O)O)=O,,,3,1,3,10,13
2314_0,,,,2,2,1,3
C(C(C(CO)(CO)O)O)(O)=O,,,3,1,6,8,14
2316_0,,,,2,2,1,3
C(C(C(C(CO)O)O)(CC=O)O)=O,,,3,1,4,16,20
2318_0,,,,2,2,1,3
C(C(C(C(CO)O)O)O)(O)=O,,,3,1,8,13,21
2320_0,,,,2,2,1,3
C(CC(C=O)(C(C(C)=O)O)O)=O,,,3,1,6,17,23
2322_0,,,,2,2,1,3
C(CC(C=O)(C(C=O)(C)O)O)=O,,,3,1,3,15,18
2323_0,,,,2,2,1,3
2325_0,,,,2,2,1,3
C(C(C)(C(C(O)=O)O)O)=O,,,3,1,4,17,21
2327_0,,,,2,2,1,3
C(C(CCO)(C(C(C)=O)O)O)(O)=O,,,3,1,4,11,15
2329_0,,,,2,2,1,3
C(C(CCO)(C(C=O)(C)O)O)(O)=O,,,3,1,2,11,13
2330_0,,,,2,2,1,3
2332_0,,,,2,2,1,3
C(CC(CO)(C(C(O)=O)O)O)=O,,,3,1,4,14,18
2333_0,,,,2,2,1,3
2335_0,,,,2,2,1,3
C(C(C(C)(C(C=O)O)O)O)(O)=O,,,3,1,5,16,21
2337_0,,,,2,2,1,3
C(C(C(C=O)(CC(CO)=O)O)O)=O,,,3,1,4,19,23
2339_0,,,,2,2,1,3
C(CC(C=O)(C(C=O)O)O)=O,,,3,1,8,22,30
2340_0,,,,2,2,1,3
2342_0,,,,2,2,1,3
C(C(CCO)(C(C=O)O)O)(O)=O,,,3,1,5,15,20
2344_0,,,,2,2,1,3
C(C(C(C)(C(CO)O)O)O)(O)=O,,,3,1,4,10,14
2345_0,,,,2,2,1,3
2347_0,,,,2,2,1,3
C(C(C(C)O)(CC(CO)=O)O)=O,,,3,1,2,14,16
2348_0,,,,2,2,1,3
2350_0,,,,2,2,1,3
C(C(CO)(CC=O)O)(C(CO)O)=O,,,3,1,3,16,19
2352_0,,,,2,2,1,3
C(C(C(CO)(CC(CO)O)O)=O)=O,,,3,1,1,15,16
2354_0,,,,2,2,1,3
C(C(CO)(CC(C(CO)=O)O)O)=O,,,3,1,4,14,18
2356_0,,,,2,2,1,3
C(C(CC(C(CO)=O)(CO)O)O)=O,,,3,1,3,15,18
2358_0,,,,2,2,1,3
C(C(C(C(CO)(CCO)O)=O)O)=O,,,3,1,2,12,14
2360_0,,,,2,2,1,3
C(CO)(C(CO)(CC(CO)=O)O)=O,,,3,1,3,14,17
2362_0,,,,2,2,1,3
C(C(CO)(CC(C(C=O)O)O)O)=O,,,3,1,5,20,25
2364_0,,,,2,2,1,3
C(C(C(C=O)O)O)(C(CO)(C)O)=O,,,3,1,1,17,18
2365_0,,,,2,2,1,3
2367_0,,,,2,2,1,3
C(C)(C(CO)(CC(C=O)=O)O)=O,,,3,1,5,17,22
2369_0,,,,2,2,1,3
C(C(CO)(CC=O)O)(CC=O)=O,,,3,1,3,19,22
2371_0,,,,2,2,1,3
C(C(CO)(CC(C(C)=O)=O)O)=O,,,3,1,4,14,18
2373_0,,,,2,2,1,3
C(C(CO)(CC(CC=O)=O)O)=O,,,3,1,5,17,22
2375_0,,,,2,2,1,3
C1(C(CO)(O)OC(C(CO)O)C1)=O,,,3,1,1,8,9
2377_0,,,,2,2,1,3
C1(C(CO)(O)OC(C(C1)O)CO)=O,,,3,1,1,7,8
2379_0,,,,2,2,1,3
C1(C(CO)(O)OCC(C(C1)O)O)=O,,,3,1,1,9,10
2381_0,,,,2,2,1,3
C(C(CO)(CC(CCO)=O)O)(O)=O,,,3,1,2,10,12
2383_0,,,,2,2,1,3
C(C(CO)(CCC(CO)=O)O)(O)=O,,,3,1,2,10,12
2385_0,,,,2,2,1,3
C(C(CO)(CC(C(C)=O)O)O)(O)=O,,,3,1,1,10,11
2387_0,,,,2,2,1,3
C(C(CC(C(C)=O)(CO)O)O)(O)=O,,,3,1,4,11,15
2389_0,,,,2,2,1,3
C(C(CO)(CC(CC=O)O)O)(O)=O,,,3,1,1,12,13
2391_0,,,,2,2,1,3
C(CC(C(C=O)=O)(CO)O)(CO)=O,,,3,1,1,17,18
2393_0,,,,2,2,1,3
C(C(C=CC(CO)=O)(CO)O)=O,,,3,1,3,10,13
2395_0,,,,2,2,1,3
C(C(C=CC(CO)O)(CO)O)(O)=O,,,3,1,1,6,7
2397_0,,,,2,2,1,3
C1(C(CO)(CC(C(CO)O)O1)O)=O,,,3,1,3,5,8
2399_0,,,,2,2,1,3
C1(C(CO)(CC(C(CO)O1)O)O)=O,,,3,1,2,5,7
2401_0,,,,2,2,1,3
C1(C(CO)(CC(C(CO1)O)O)O)=O,,,3,1,1,8,9
2403_0,,,,2,2,1,3
C(C(CO)(CCO)O)(O)=O,,,3,1,1,6,7
2405_0,,,,2,2,1,3
C(C(CO)(CC(C(CO)O)O)O)=O,,,3,1,2,13,15
2406_0,,,,2,2,1,3
2408_0,,,,2,2,1,3
C(C(CCO)(C(C(O)=O)O)O)=O,,,3,1,4,13,17
2410_0,,,,2,2,1,3
C(C(C(CO)(CCO)O)O)(O)=O,,,3,1,5,9,14
2412_0,,,,2,2,1,3
C(C(C(C(C=O)(CC=O)O)O)O)=O,,,3,1,3,23,26
2414_0,,,,2,2,1,3
C(C(C(C(C=O)O)O)O)(O)=O,,,3,1,8,22,30
2416_0,,,,2,2,1,3
C(C(C(CO)(C)O)(CC=O)O)=O,,,3,1,3,14,17
2418_0,,,,2,2,1,3
C(C(C(CO)(C)O)O)(O)=O,,,3,1,4,13,17
2420_0,,,,2,2,1,3
C(C(CCO)(C(CO)(C)O)O)(O)=O,,,3,1,2,8,10
2422_0,,,,2,2,1,3
C(C(C(C)O)(CC=O)O)=O,,,3,1,3,20,23
2424_0,,,,2,2,1,3
C(CC(C=O)(C(C(CO)=O)O)O)=O,,,3,1,4,18,22
2426_0,,,,2,2,1,3
C(CC(C=O)(C(C=O)(CO)O)O)=O,,,3,1,5,17,22
2427_0,,,,2,2,1,3
2428_0,,,,2,2,1,3
2430_0,,,,2,2,1,3
C(C(C(C(C(C=O)O)O)O)O)(O)=O,,,3,1,7,22,29
2432_0,,,,2,2,1,3
C(C(C(C)O)O)(O)=O,,,3,1,8,30,38
2434_0,,,,2,2,1,3
C(C)(C(C(C)O)(CC(C=O)=O)O)=O,,,3,1,1,13,14
2436_0,,,,2,2,1,3
C(C(C(C)O)(CC=O)O)(CC=O)=O,,,3,1,2,15,17
2438_0,,,,2,2,1,3
C(C(C(C)O)(CC(C(C)=O)=O)O)=O,,,3,1,2,11,13
2440_0,,,,2,2,1,3
C(C(C(C)O)(CC(CC=O)=O)O)=O,,,3,1,2,13,15
2442_0,,,,2,2,1,3
C(C(C=CC(CO)=O)(C(C)O)O)=O,,,3,1,1,8,9
2444_0,,,,2,2,1,3
C(C(C(C)O)(CCO)O)(O)=O,,,3,1,1,7,8
2446_0,,,,2,2,1,3
C(C(C(C(CO)=O)O)O)(O)=O,,,3,1,8,17,25
2448_0,,,,2,2,1,3
C(C(CO)(C(C(O)=O)O)O)=O,,,3,1,7,17,24
2450_0,,,,2,2,1,3
C(C(C(CO)(C(CO)O)O)O)(O)=O,,,3,1,7,11,18
2452_0,,,,2,2,1,3
C(C(C(C(O)=O)O)O)(C(CO)O)=O,,,3,1,9,16,25
2454_0,,,,2,2,1,3
C(C(C(CO)O)(C(C(O)=O)O)O)=O,,,3,1,7,18,25
2455_0,,,,2,2,1,3
2456_0,,,,2,2,1,3
2457_0,,,,2,2,1,3
2459_0,,,,2,2,1,3
C(C(C(CO)O)(CCO)O)(O)=O,,,3,1,4,9,13
2460_0,,,,2,2,1,3
2461_0,,,,2,2,1,3
2462_0,,,,2,1,2,3
2463_0,,,,2,1,2,3
2464_0,,,,2,1,2,3
2465_0,,,,2,1,2,3
2466_0,,,,2,1,2,3
2468_0,,,,2,1,1,2
C(C(C(CO)O)OC(CO)=O)=O,,,3,1,1,8,9
2470_0,,,,2,1,1,2
C(C(C(CO)OC(CO)=O)O)=O,,,3,1,2,7,9
2472_0,,,,2,1,1,2
C(C(C(COC(CO)=O)O)O)=O,,,3,1,2,11,13
2474_0,,,,2,1,2,3
C1(CC(C(C1CO)=O)O)=O,,,3,1,4,23,27
2476_0,,,,2,1,2,3
C1(C(CO)CC(C1O)=O)=O,,,3,1,2,23,25
2477_0,,,,2,1,2,3
2478_0,,,,2,1,2,3
2479_0,,,,2,1,2,3
2480_0,,,,2,1,2,3
2481_0,,,,2,1,2,3
2482_0,,,,2,1,2,3
2483_0,,,,2,1,2,3
2484_0,,,,2,1,2,3
2485_0,,,,2,1,2,3
2486_0,,,,2,1,2,3
2487_0,,,,2,1,2,3
2488_0,,,,2,1,2,3
2489_0,,,,2,1,2,3
2490_0,,,,2,1,2,3
2491_0,,,,2,1,2,3
2492_0,,,,2,1,2,3
2493_0,,,,2,1,2,3
2494_0,,,,2,1,2,3
2495_0,,,,2,1,2,3
2496_0,,,,2,1,2,3
2498_0,,,,2,1,2,3
C(C(C)=O)(C(C(CO)O)O)=O,,,3,1,6,16,22
2499_0,,,,2,1,2,3
2500_0,,,,2,1,2,3
2501_0,,,,2,1,2,3
2502_0,,,,2,1,2,3
2503_0,,,,2,1,2,3
2504_0,,,,2,1,2,3
2505_0,,,,2,1,2,3
2506_0,,,,2,1,2,3
2507_0,,,,2,1,2,3
2508_0,,,,2,1,2,3
2509_0,,,,2,1,2,3
2510_0,,,,2,1,2,3
2511_0,,,,2,1,2,3
2512_0,,,,2,1,2,3
2513_0,,,,2,1,2,3
2514_0,,,,2,1,2,3
2515_0,,,,2,1,2,3
2516_0,,,,2,1,2,3
2517_0,,,,2,1,2,3
2518_0,,,,2,1,2,3
2519_0,,,,2,1,2,3
2520_0,,,,2,1,2,3
2521_0,,,,2,1,2,3
2522_0,,,,2,1,2,3
2523_0,,,,2,1,2,3
2524_0,,,,2,1,2,3
2525_0,,,,2,1,2,3
2526_0,,,,2,1,2,3
2527_0,,,,2,1,2,3
2528_0,,,,2,1,2,3
2529_0,,,,2,1,2,3
2530_0,,,,2,1,2,3
2531_0,,,,2,1,2,3
2532_0,,,,2,1,2,3
2533_0,,,,2,1,2,3
2534_0,,,,2,1,2,3
2535_0,,,,2,1,2,3
2536_0,,,,2,1,2,3
2537_0,,,,2,1,2,3
2538_0,,,,2,1,2,3
2539_0,,,,2,1,2,3
2540_0,,,,2,1,2,3
2541_0,,,,2,1,2,3
2542_0,,,,2,1,2,3
2543_0,,,,2,1,2,3
2544_0,,,,2,1,2,3
2545_0,,,,2,1,2,3
2546_0,,,,2,1,2,3
2547_0,,,,2,1,2,3
2548_0,,,,2,1,2,3
2549_0,,,,2,1,2,3
2550_0,,,,2,1,2,3
2551_0,,,,2,1,2,3
2552_0,,,,2,1,2,3
2553_0,,,,2,1,2,3
2554_0,,,,2,1,2,3
2555_0,,,,2,1,2,3
2556_0,,,,2,1,2,3
2557_0,,,,2,1,2,3
2558_0,,,,2,1,2,3
2559_0,,,,2,1,2,3
2560_0,,,,2,1,2,3
2561_0,,,,2,1,2,3
2562_0,,,,2,1,2,3
2563_0,,,,2,1,2,3
2564_0,,,,2,1,2,3
2565_0,,,,2,1,2,3
2566_0,,,,2,1,2,3
2567_0,,,,2,1,2,3
2568_0,,,,2,1,2,3
2569_0,,,,2,1,2,3
2570_0,,,,2,1,2,3
2571_0,,,,2,1,2,3
2572_0,,,,2,1,2,3
2573_0,,,,2,1,2,3
2574_0,,,,2,1,2,3
2575_0,,,,2,1,2,3
2576_0,,,,2,1,2,3
2577_0,,,,2,1,2,3
2578_0,,,,2,1,2,3
2579_0,,,,2,1,2,3
2580_0,,,,2,1,2,3
2581_0,,,,2,1,2,3
2582_0,,,,2,1,2,3
2583_0,,,,2,1,2,3
2584_0,,,,2,1,2,3
2585_0,,,,2,1,2,3
2586_0,,,,2,1,2,3
2587_0,,,,2,1,2,3
2588_0,,,,2,1,2,3
2589_0,,,,2,1,2,3
2590_0,,,,2,1,2,3
2591_0,,,,2,1,2,3
2592_0,,,,2,1,2,3
2594_0,,,,2,1,2,3
C1(CCC(C1(CO)O)=O)=O,,,3,1,1,9,10
2595_0,,,,2,1,2,3
2597_0,,,,2,1,2,3
C1(C(CO)(CC(C1)=O)O)=O,,,3,1,3,24,27
2598_0,,,,2,1,2,3
2599_0,,,,2,1,2,3
2600_0,,,,2,1,2,3
2601_0,,,,2,1,2,3
2602_0,,,,2,1,2,3
2603_0,,,,2,1,2,3
2604_0,,,,2,1,2,3
2605_0,,,,2,1,2,3
2607_0,,,,2,1,2,3
C1(CC(C(C(C)=O)O1)O)=O,,,3,1,2,17,19
2609_0,,,,2,1,2,3
C1(CC(C(CC=O)O1)O)=O,,,3,1,2,16,18
2611_0,,,,2,1,2,3
C1(COC(C(C)=O)C1O)=O,,,3,1,2,28,30
2613_0,,,,2,1,2,3
C(CC1C(C(CO1)=O)O)=O,,,3,1,3,27,30
2615_0,,,,2,1,2,3
C(C)(C1CC(C(O)O1)=O)=O,,,3,1,3,22,25
2617_0,,,,2,1,2,3
C(CC1CC(C(O)O1)=O)=O,,,3,1,3,25,28
2619_0,,,,2,1,2,3
C1(CC(OC1C(C)=O)O)=O,,,3,1,3,22,25
2621_0,,,,2,1,2,3
C(CC1C(CC(O1)O)=O)=O,,,3,1,3,27,30
2622_0,,,,2,1,2,3
2623_0,,,,2,1,2,3
2624_0,,,,2,1,2,3
2625_0,,,,2,1,2,3
2626_0,,,,2,1,2,3
2627_0,,,,2,1,2,3
2628_0,,,,2,1,2,3
2629_0,,,,2,1,2,3
2631_0,,,,2,1,2,3
C1(CC(CC(CO)O1)=O)=O,,,3,1,3,16,19
2633_0,,,,2,1,2,3
C1(CCC(OC1CO)=O)=O,,,3,1,3,13,16
2635_0,,,,2,1,2,3
C1(C(COC(CO)C1)=O)=O,,,3,1,2,18,20
2637_0,,,,2,1,2,3
C1(C(CO)OCC(C1)=O)=O,,,3,1,4,25,29
2638_0,,,,2,1,2,3
2639_0,,,,2,1,2,3
2640_0,,,,2,1,2,3
2641_0,,,,2,1,2,3
2643_0,,,,2,1,2,3
C1(CC(CC(CO1)O)=O)=O,,,3,1,2,18,20
2645_0,,,,2,1,2,3
C1(CCC(OCC1O)=O)=O,,,3,1,2,13,15
2647_0,,,,2,1,2,3
C1(CC(C(CCO1)=O)O)=O,,,3,1,2,16,18
2649_0,,,,2,1,2,3
C1(CC(CC(CO1)=O)O)=O,,,3,1,2,20,22
2651_0,,,,2,1,2,3
C1(C(COCC(C1)O)=O)=O,,,3,1,2,19,21
2653_0,,,,2,1,2,3
C1(C(COCC(C1)=O)O)=O,,,3,1,4,24,28
2655_0,,,,2,1,2,3
C1(CCOCC(C1O)=O)=O,,,3,1,2,23,25
2657_0,,,,2,1,2,3
C1(COCC(CC1O)=O)=O,,,3,1,4,27,31
2659_0,,,,2,1,2,3
C1(CCOC(C(C1)=O)O)=O,,,3,1,3,23,26
2661_0,,,,2,1,2,3
C1(COC(C(CC1)=O)O)=O,,,3,1,3,21,24
2663_0,,,,2,1,2,3
C1(C(CC(O)OCC1)=O)=O,,,3,1,3,21,24
2665_0,,,,2,1,2,3
C1(CC(OCC(C1)=O)O)=O,,,3,1,4,26,30
2666_0,,,,2,1,2,3
2667_0,,,,2,1,2,3
2668_0,,,,2,1,2,3
2669_0,,,,2,1,2,3
2670_0,,,,2,1,2,3
2671_0,,,,2,1,2,3
2672_0,,,,2,1,2,3
2673_0,,,,2,1,2,3
2674_0,,,,2,1,2,3
2675_0,,,,2,1,2,3
2676_0,,,,2,1,2,3
2677_0,,,,2,1,2,3
2679_0,,,,2,1,2,3
C(C)(CC(C(C=O)=O)=O)=O,,,3,1,3,23,26
2681_0,,,,2,1,2,3
C(CCC(C(C=O)=O)=O)=O,,,3,1,3,20,23
2683_0,,,,2,1,2,3
C(C(CC(C(C)=O)=O)=O)=O,,,3,1,4,24,28
2685_0,,,,2,1,2,3
C(CC(CC(C=O)=O)=O)=O,,,3,1,6,29,35
2686_0,,,,2,1,2,3
2687_0,,,,2,1,2,3
2688_0,,,,2,1,2,3
2689_0,,,,2,1,2,3
2691_0,,,,2,1,2,3
C(C(C=CC(C)=O)=O)=O,,,3,1,4,54,58
2693_0,,,,2,1,2,3
C(CC=CC(C=O)=O)=O,,,3,1,5,46,51
2695_0,,,,2,1,2,3
C(C=CC(C(C)=O)=O)=O,,,3,1,3,52,55
2697_0,,,,2,1,2,3
C(CC(C=CC=O)=O)=O,,,3,1,4,62,66
2699_0,,,,2,1,2,3
C=CC(CC(C=O)=O)=O,,,3,1,4,52,56
2701_0,,,,2,1,2,3
C(CC(C(C=C)=O)=O)=O,,,3,1,3,51,54
2703_0,,,,2,1,2,3
C(CC(C=O)=O)=CC=O,,,3,1,5,45,50
2704_0,,,,2,1,2,3
2706_0,,,,2,1,2,3
C(C=CC(CCO)=O)(O)=O,,,3,1,2,22,24
2708_0,,,,2,1,2,3
C(CO)(CC=CC(O)=O)=O,,,3,1,2,19,21
2710_0,,,,2,1,2,3
C(C)(C(C=CC(O)=O)O)=O,,,3,1,2,16,18
2712_0,,,,2,1,2,3
C(CC(C=CC(O)=O)O)=O,,,3,1,2,19,21
2714_0,,,,2,1,2,3
C(C(C=CC(C)=O)O)(O)=O,,,3,1,4,17,21
2716_0,,,,2,1,2,3
C(C(C=CCC=O)O)(O)=O,,,3,1,4,16,20
2717_0,,,,2,1,2,3
2719_0,,,,2,1,2,3
C1(COCC1O)=O,,,3,1,4,160,164
2721_0,,,,2,1,2,3
C1(C(O)OCC1)=O,,,3,1,2,133,135
2722_0,,,,2,1,2,3
2724_0,,,,2,1,2,3
C(C1C(C(C(CO)O1)O)O)=O,,,3,1,4,10,14
2726_0,,,,2,1,2,3
C1(C(CO)OC(CO)C1O)=O,,,3,1,3,8,11
2728_0,,,,2,1,2,3
C1(C(CO)(O)OC(CO)C1)=O,,,3,1,3,8,11
2730_0,,,,2,1,2,3
C1(C(CO)OC(CO)(C1)O)=O,,,3,1,3,12,15
2732_0,,,,2,1,2,3
C(CC1C(C(CO1)O)=O)=O,,,3,1,3,24,27
2734_0,,,,2,1,2,3
C(CC1(C(CCO1)=O)O)=O,,,3,1,2,23,25
2736_0,,,,2,1,2,3
C(CC1(CC(CO1)=O)O)=O,,,3,1,3,31,34
2738_0,,,,2,1,2,3
C(C(C1CC(CO1)O)=O)=O,,,3,1,1,13,14
2740_0,,,,2,1,2,3
C(C1C(CC(C=O)O1)O)=O,,,3,1,2,19,21
2742_0,,,,2,1,2,3
C(C1C(CC(C)(O1)O)=O)=O,,,3,1,2,21,23
2744_0,,,,2,1,2,3
C1(CC(C=O)OC1(C)O)=O,,,3,1,2,16,18
2746_0,,,,2,1,2,3
C(C1C(C(C(C)O1)=O)O)=O,,,3,1,1,22,23
2748_0,,,,2,1,2,3
C1(C(O)OC(C(C)=O)C1O)=O,,,3,1,2,13,15
2750_0,,,,2,1,2,3
C(CC1C(C(C(O)O1)=O)O)=O,,,3,1,2,14,16
2752_0,,,,2,1,2,3
C(C1C(C(C(CO)O1)O)=O)=O,,,3,1,1,10,11
2754_0,,,,2,1,2,3
C(C1(C(CC(CO)O1)=O)O)=O,,,3,1,2,8,10
2756_0,,,,2,1,2,3
C1(CC(C=O)(OC1CO)O)=O,,,3,1,2,13,15
2758_0,,,,2,1,2,3
C(C1C(C(C(CO1)O)O)O)=O,,,3,1,3,12,15
2760_0,,,,2,1,2,3
C1(C(CO)OCC(C1O)O)=O,,,3,1,4,11,15
2762_0,,,,2,1,2,3
C1(C(CO)(O)OCC(C1)O)=O,,,3,1,3,9,12
2764_0,,,,2,1,2,3
C1(C(COC(CO)(C1)O)O)=O,,,3,1,4,11,15
2766_0,,,,2,1,2,3
C1(C(C(CO)(O)OCC1)O)=O,,,3,1,3,12,15
2768_0,,,,2,1,2,3
C1(COC(CO)(C(C1)O)O)=O,,,3,1,3,11,14
2770_0,,,,2,1,2,3
C1(CC(C=O)(O)OCC1)=O,,,3,1,2,23,25
2772_0,,,,2,1,2,3
C(C1(CCC(CO1)=O)O)=O,,,3,1,2,17,19
2774_0,,,,2,1,2,3
C(C1C(CCC(O1)O)=O)=O,,,3,1,2,17,19
2776_0,,,,2,1,2,3
C1(CC(C=O)OC(C1)O)=O,,,3,1,3,26,29
2778_0,,,,2,1,2,3
C1(C(C(O)OC(CO)C1)=O)=O,,,3,1,2,10,12
2780_0,,,,2,1,2,3
C1(C(CO)OC(C(C1)=O)O)=O,,,3,1,2,12,14
2782_0,,,,2,1,2,3
C(C1C(C(C(CO1)O)O)=O)=O,,,3,1,1,13,14
2784_0,,,,2,1,2,3
C(C1(C(CC(CO1)O)=O)O)=O,,,3,1,2,9,11
2786_0,,,,2,1,2,3
C1(CC(C=O)(O)OCC1O)=O,,,3,1,2,14,16
2788_0,,,,2,1,2,3
C1(C(C(C=O)(O)OCC1)O)=O,,,3,1,2,16,18
2790_0,,,,2,1,2,3
C(C1(C(CC(CO1)=O)O)O)=O,,,3,1,2,13,15
2792_0,,,,2,1,2,3
C1(C(C(O)OCC(C1)O)=O)=O,,,3,1,2,11,13
2794_0,,,,2,1,2,3
C1(C(COC(C(C1)=O)O)O)=O,,,3,1,2,12,14
2796_0,,,,2,1,2,3
C1(CCOC(C(C1O)=O)O)=O,,,3,1,2,11,13
2798_0,,,,2,1,2,3
C1(C(O)OCC(CC1O)=O)=O,,,3,1,2,12,14
2800_0,,,,2,1,2,3
C1(C(CC(C(CO)O)O1)=O)=O,,,3,1,4,7,11
2802_0,,,,2,1,2,3
C1(CC(C(C(CO)O)O1)=O)=O,,,3,1,5,10,15
2804_0,,,,2,1,2,3
C1(C(C(C(C(C)=O)O1)O)O)=O,,,3,1,3,12,15
2806_0,,,,2,1,2,3
C(CC1C(C(C(O1)=O)O)O)=O,,,3,1,3,14,17
2808_0,,,,2,1,2,3
C1(C(CC(C(C)=O)O1)O)=O,,,3,1,3,13,16
2810_0,,,,2,1,2,3
C(CC1CC(C(O1)=O)O)=O,,,3,1,3,16,19
2812_0,,,,2,1,2,3
C1(C(CC(C(CO)O1)O)=O)=O,,,3,1,4,7,11
2814_0,,,,2,1,2,3
C1(CC(C(C(CO)O1)O)=O)=O,,,3,1,4,8,12
2816_0,,,,2,1,2,3
C1(C(C(CC(CO)O1)=O)O)=O,,,3,1,4,7,11
2818_0,,,,2,1,2,3
C1(CC(C(OC1CO)=O)O)=O,,,3,1,4,10,14
2820_0,,,,2,1,2,3
C1(C(CC(C(CO1)O)O)=O)=O,,,3,1,3,10,13
2822_0,,,,2,1,2,3
C1(CC(C(C(CO1)O)O)=O)=O,,,3,1,3,12,15
2824_0,,,,2,1,2,3
C1(C(C(CC(CO1)O)=O)O)=O,,,3,1,3,9,12
2826_0,,,,2,1,2,3
C1(CC(C(OCC1O)=O)O)=O,,,3,1,3,10,13
2828_0,,,,2,1,2,3
C1(C(C(C(OCC1)=O)O)O)=O,,,3,1,3,13,16
2830_0,,,,2,1,2,3
C1(C(C(CC(CO1)=O)O)O)=O,,,3,1,3,13,16
2832_0,,,,2,1,2,3
C1(CC(C(OCC1)=O)O)=O,,,3,1,3,20,23
2834_0,,,,2,1,2,3
C1(C(CCC(CO1)=O)O)=O,,,3,1,3,17,20
2835_0,,,,2,1,2,3
2836_0,,,,2,1,2,3
2837_0,,,,2,1,2,3
2839_0,,,,2,1,2,3
C(C(CCC(CO)=O)O)=O,,,3,1,5,27,32
2841_0,,,,2,1,2,3
C(C(CC(C(C)=O)O)O)=O,,,3,1,3,23,26
2842_0,,,,2,1,2,3
2844_0,,,,2,1,2,3
C1C(C(C(C=1CO)=O)O)O,,,3,1,1,19,20
2846_0,,,,2,1,2,3
C=C1C(C(C(C1O)O)O)=O,,,3,1,2,21,23
2847_0,,,,2,1,2,3
2849_0,,,,2,1,2,3
C1C(C(C(C=1C=O)O)O)O,,,3,1,2,14,16
2850_0,,,,2,1,2,3
2851_0,,,,2,1,2,3
2852_0,,,,2,1,2,3
2853_0,,,,2,1,2,3
2854_0,,,,2,1,2,3
2855_0,,,,2,1,2,3
2856_0,,,,2,1,2,3
2857_0,,,,2,1,2,3
2858_0,,,,2,1,2,3
2859_0,,,,2,1,2,3
2860_0,,,,2,1,2,3
2861_0,,,,2,1,2,3
2862_0,,,,2,1,2,3
2863_0,,,,2,1,2,3
2864_0,,,,2,1,2,3
2865_0,,,,2,1,2,3
2866_0,,,,2,1,2,3
2867_0,,,,2,1,2,3
2868_0,,,,2,1,2,3
2869_0,,,,2,1,2,3
2870_0,,,,2,1,2,3
2871_0,,,,2,1,2,3
2872_0,,,,2,1,2,3
2874_0,,,,2,1,2,3
C(C(C(C(C=C)O)O)O)=O,,,3,1,1,22,23
2875_0,,,,2,1,2,3
2876_0,,,,2,1,2,3
2877_0,,,,2,1,2,3
2878_0,,,,2,1,2,3
2879_0,,,,2,1,2,3
2880_0,,,,2,1,2,3
2881_0,,,,2,1,2,3
2882_0,,,,2,1,2,3
2883_0,,,,2,1,2,3
2885_0,,,,2,1,2,3
C(C1(C=CC(C1O)O)O)=O,,,3,1,3,11,14
2886_0,,,,2,1,2,3
2887_0,,,,2,1,2,3
2888_0,,,,2,1,2,3
2889_0,,,,2,1,2,3
2890_0,,,,2,1,2,3
2891_0,,,,2,1,2,3
2892_0,,,,2,1,2,3
2893_0,,,,2,1,2,3
2895_0,,,,2,1,2,3
C1C(C(CO)O)OC(C=1)=O,,,3,1,2,8,10
2897_0,,,,2,1,2,3
C1OC(C(C=1)=O)C(CO)O,,,3,1,1,13,14
2899_0,,,,2,1,2,3
C1C(C(CO)OC(C=1)=O)O,,,3,1,2,6,8
2901_0,,,,2,1,2,3
C1C(CO)OC(C(C=1)=O)O,,,3,1,2,11,13
2903_0,,,,2,1,2,3
C1OC(CO)C(C(C=1)=O)O,,,3,1,1,10,11
2905_0,,,,2,1,2,3
C1C(OC(C(C=1)=O)CO)O,,,3,1,2,16,18
2907_0,,,,2,1,2,3
C1C(C(COC(C=1)=O)O)O,,,3,1,2,8,10
2909_0,,,,2,1,2,3
C1C(COC(C(C=1)=O)O)O,,,3,1,2,11,13
2911_0,,,,2,1,2,3
C1OCC(C(C(C=1)=O)O)O,,,3,1,1,13,14
2913_0,,,,2,1,2,3
C1COC(C(C(C=1)=O)O)O,,,3,1,2,18,20
2915_0,,,,2,1,2,3
C1C(O)OCC(C(C=1)=O)O,,,3,1,2,14,16
2917_0,,,,2,1,2,3
C1C(C(OCC(C=1)=O)O)O,,,3,1,2,15,17
2918_0,,,,2,1,2,3
2920_0,,,,2,1,2,3
C(C(CC(C=C)=O)O)(O)=O,,,3,1,5,23,28
2921_0,,,,2,1,2,3
2922_0,,,,2,1,2,3
2923_0,,,,2,1,2,3
2924_0,,,,2,1,2,3
2925_0,,,,2,1,2,3
2927_0,,,,2,1,2,3
C(C(CC=CC=O)O)(O)=O,,,3,1,5,16,21
2929_0,,,,2,1,2,3
C(CO)=CC(C(C=O)=O)=O,,,3,1,3,14,17
2931_0,,,,2,1,2,3
C=CC(C(C(C=O)=O)O)=O,,,3,1,4,23,27
2933_0,,,,2,1,2,3
C(C(C=CC(CO)=O)=O)=O,,,3,1,8,29,37
2935_0,,,,2,1,2,3
C(C(C(C=O)=O)O)=CC=O,,,3,1,4,21,25
2937_0,,,,2,1,2,3
C1C(C(CO)OC=1C=O)O,,,3,1,1,4,5
2939_0,,,,2,1,2,3
C(C1(C=CC(CO)O1)O)=O,,,3,1,2,5,7
2941_0,,,,2,1,2,3
C1(C(C(CO1)O)O)=CC=O,,,3,1,1,6,7
2943_0,,,,2,1,2,3
C(C(C1OCC(C=1)O)O)=O,,,3,1,1,13,14
2945_0,,,,2,1,2,3
C(C(C1(C=CCO1)O)O)=O,,,3,1,2,17,19
2947_0,,,,2,1,2,3
C(C1C=CC(CO)(O1)O)=O,,,3,1,2,9,11
2949_0,,,,2,1,2,3
C(C1C(C=C(CO)O1)O)=O,,,3,1,1,12,13
2951_0,,,,2,1,2,3
C(C1C(C(C(O1)=C)O)O)=O,,,3,1,1,15,16
2953_0,,,,2,1,2,3
C(C(C1C=CC(O)O1)O)=O,,,3,1,2,14,16
2955_0,,,,2,1,2,3
C(C(C1C(C=CO1)O)O)=O,,,3,1,1,14,15
2957_0,,,,2,1,2,3
C1C(C(COC=1C=O)O)O,,,3,1,1,6,7
2959_0,,,,2,1,2,3
C(C1(C=CC(CO1)O)O)=O,,,3,1,2,5,7
2961_0,,,,2,1,2,3
C(C1C(C=CC(O)O1)O)=O,,,3,1,2,13,15
2963_0,,,,2,1,2,3
C(C1C(C(C=CO1)O)O)=O,,,3,1,1,15,16
2964_0,,,,2,1,2,3
2965_0,,,,2,1,2,3
2967_0,,,,2,1,2,3
C1(C(C=CC(CO)O1)O)=O,,,3,1,2,5,7
2968_0,,,,2,1,2,3
2970_0,,,,2,1,2,3
C1(C(C=CC(CO1)O)O)=O,,,3,1,2,5,7
2972_0,,,,2,1,2,3
C(CO)=CC(O)=O,,,3,1,1,42,43
2974_0,,,,2,1,2,3
C(C(C=C)O)(O)=O,,,3,1,4,37,41
2975_0,,,,2,1,2,3
2977_0,,,,2,1,2,3
C(C(C=CC(CO)O)O)=O,,,3,1,5,13,18
2979_0,,,,2,2,1,3
C(C1(C(C(C(C1O)O)O)O)O)O,,,3,1,5,5,10
2981_0,,,,2,2,1,3
C1(C(C(C(C(C1O)O)O)O)O)O,,,3,1,1,1,2
2982_0,,,,2,2,1,3
2983_0,,,,2,2,1,3
2984_0,,,,2,2,1,3
2985_0,,,,2,2,1,3
2986_0,,,,2,2,1,3
2987_0,,,,2,2,1,3
2988_0,,,,2,2,1,3
2989_0,,,,2,2,1,3
2990_0,,,,2,2,1,3
2991_0,,,,2,2,1,3
2992_0,,,,2,2,1,3
2993_0,,,,2,2,1,3
2994_0,,,,2,2,1,3
2995_0,,,,2,2,1,3
2996_0,,,,2,2,1,3
2997_0,,,,2,2,1,3
2998_0,,,,2,2,1,3
2999_0,,,,2,2,1,3
3000_0,,,,2,2,1,3
3001_0,,,,2,2,1,3
3002_0,,,,2,2,1,3
3003_0,,,,2,2,1,3
3004_0,,,,2,2,1,3
3005_0,,,,2,2,1,3
3006_0,,,,2,2,1,3
3007_0,,,,2,2,1,3
3008_0,,,,2,2,1,3
3009_0,,,,2,2,1,3
3010_0,,,,2,2,1,3
3011_0,,,,2,2,1,3
3012_0,,,,2,2,1,3
3013_0,,,,2,2,1,3
3014_0,,,,2,2,1,3
3015_0,,,,2,2,1,3
3016_0,,,,2,2,1,3
3017_0,,,,2,2,1,3
3018_0,,,,2,2,1,3
3019_0,,,,2,2,1,3
3020_0,,,,2,2,1,3
3021_0,,,,2,2,1,3
3022_0,,,,2,2,1,3
3023_0,,,,2,2,1,3
3024_0,,,,2,2,1,3
3025_0,,,,2,2,1,3
3026_0,,,,2,2,1,3
3027_0,,,,2,2,1,3
3028_0,,,,2,2,1,3
3029_0,,,,2,2,1,3
3030_0,,,,2,2,1,3
3031_0,,,,2,2,1,3
3032_0,,,,2,2,1,3
3033_0,,,,2,2,1,3
3034_0,,,,2,2,1,3
3035_0,,,,2,2,1,3
3036_0,,,,2,2,1,3
3037_0,,,,2,2,1,3
3038_0,,,,2,2,1,3
3039_0,,,,2,2,1,3
3040_0,,,,2,2,1,3
3041_0,,,,2,2,1,3
3042_0,,,,2,2,1,3
3043_0,,,,2,2,1,3
3044_0,,,,2,2,1,3
3045_0,,,,2,2,1,3
3046_0,,,,2,2,1,3
3047_0,,,,2,2,1,3
3048_0,,,,2,2,1,3
3049_0,,,,2,2,1,3
3050_0,,,,2,2,1,3
3051_0,,,,2,2,1,3
3052_0,,,,2,2,1,3
3053_0,,,,2,2,1,3
3054_0,,,,2,2,1,3
3055_0,,,,2,2,1,3
3056_0,,,,2,2,1,3
3057_0,,,,2,2,1,3
3058_0,,,,2,2,1,3
3059_0,,,,2,2,1,3
3060_0,,,,2,2,1,3
3061_0,,,,2,2,1,3
3062_0,,,,2,2,1,3
3063_0,,,,2,2,1,3
3064_0,,,,2,2,1,3
3065_0,,,,2,2,1,3
3066_0,,,,2,2,1,3
3067_0,,,,2,2,1,3
3068_0,,,,2,2,1,3
3069_0,,,,2,2,1,3
3070_0,,,,2,2,1,3
3071_0,,,,2,2,1,3
3072_0,,,,2,2,1,3
3073_0,,,,2,2,1,3
3074_0,,,,2,2,1,3
3076_0,,,,2,2,1,3
C1C(C(C(C(CO)O)(O)O1)O)O,,,3,1,4,7,11
3077_0,,,,2,2,1,3
3078_0,,,,2,2,1,3
3079_0,,,,2,2,1,3
3080_0,,,,2,2,1,3
3081_0,,,,2,2,1,3
3082_0,,,,2,2,1,3
3083_0,,,,2,2,1,3
3084_0,,,,2,2,1,3
3085_0,,,,2,2,1,3
3086_0,,,,2,2,1,3
3087_0,,,,2,2,1,3
3088_0,,,,2,2,1,3
3089_0,,,,2,2,1,3
3090_0,,,,2,2,1,3
3091_0,,,,2,2,1,3
3092_0,,,,2,2,1,3
3094_0,,,,2,1,2,3
C=CC(C(CO)O)O,,,3,1,1,6,7
3096_0,,,,2,1,2,3
C(C(CO)O)=CCO,,,3,1,1,4,5
3098_0,,,,2,1,1,2
C12C(C(C(CC1O)(O)O2)O)O,,,3,1,1,5,6
3100_0,,,,2,1,1,2
C1(C2C(C(C(C2O)O1)O)O)O,,,3,1,2,4,6
3100_1,,,,2,1,1,2
3101_0,,,,2,1,1,2
3102_0,,,,2,1,1,2
3103_0,,,,2,1,1,2
3104_0,,,,2,1,1,2
3105_0,,,,2,1,1,2
3107_0,,,,2,1,1,2
C(C1(C(CC(CO)O1)O)O)=O,,,3,1,2,8,10
3109_0,,,,2,1,1,2
C1(COC(C(CO)O)(C1)O)=O,,,3,1,3,13,16
3110_0,,,,2,1,1,2
3112_0,,,,2,1,1,2
C(C1CC(C(CO)(O1)O)O)=O,,,3,1,2,9,11
3114_0,,,,2,1,1,2
C(CO)(C1CC(C(O1)O)O)=O,,,3,1,2,9,11
3116_0,,,,2,1,1,2
C1(COC(CCO)(C1O)O)=O,,,3,1,1,12,13
3118_0,,,,2,1,1,2
C1(C(CCO)OC(C1O)O)=O,,,3,1,1,11,12
3120_0,,,,2,1,1,2
C(C(C1(C(CCO1)O)O)O)=O,,,3,1,2,14,16
3122_0,,,,2,1,1,2
C(C(C1CC(C(O)O1)O)O)=O,,,3,1,3,13,16
3123_0,,,,2,1,1,2
3124_0,,,,2,1,1,2
3126_0,,,,2,1,1,2
C(C(C1(C(C(CO1)O)O)O)O)=O,,,3,1,1,14,15
3127_0,,,,2,1,1,2
3128_0,,,,2,1,1,2
3129_0,,,,2,1,1,2
3130_0,,,,2,1,1,2
3131_0,,,,2,1,1,2
3132_0,,,,2,1,1,2
3133_0,,,,2,1,1,2
3134_0,,,,2,1,1,2
3135_0,,,,2,1,1,2
3137_0,,,,2,1,1,2
C1(C(CC(C(CO)O)(O)O1)O)=O,,,3,1,1,6,7
3139_0,,,,2,1,1,2
C1(C(C(C(CCO)(O)O1)O)O)=O,,,3,1,1,7,8
3140_0,,,,2,1,1,2
3141_0,,,,2,1,1,2
3142_0,,,,2,1,1,2
3143_0,,,,2,1,1,2
3144_0,,,,2,1,1,2
3146_0,,,,2,1,1,2
C1(C2(C(C(CC2O)O1)O)O)O,,,3,1,2,6,8
3146_1,,,,2,1,1,2
3148_0,,,,2,1,1,2
C1C(C(C(O)O1)(C(CO)O)O)O,,,3,1,1,6,7
3149_0,,,,2,1,1,2
3150_0,,,,2,1,1,2
3151_0,,,,2,1,1,2
3152_0,,,,2,1,1,2
3153_0,,,,2,1,1,2
3154_0,,,,2,1,1,2
3155_0,,,,2,1,1,2
3156_0,,,,2,1,1,2
3158_0,,,,2,1,1,2
C1C2(C(C(C(CO)O2)O1)O)O,,,3,1,1,2,3
3160_0,,,,2,1,1,2
C(C1C2CC(C(O)O2)(O)O1)O,,,3,1,2,3,5
3162_0,,,,2,1,1,2
C1C(C2C(CC(O)O2)(O)O1)O,,,3,1,2,4,6
3164_0,,,,2,1,1,2
CC1(C2C(C(C(O)O2)O1)O)O,,,3,1,2,3,5
3166_0,,,,2,1,1,2
C1(CC2C(C(C(O)O2)O)O1)O,,,3,1,2,5,7
3168_0,,,,2,1,1,2
C1C2C(C(CC(O)O2)(O)O1)O,,,3,1,2,4,6
3170_0,,,,2,1,1,2
C1C2CC(C(C(O)O2)O)(O)O1,,,3,1,2,5,7
3172_0,,,,2,1,1,2
C1C2(C(C(C(CO1)O2)O)O)O,,,3,1,1,4,5
3174_0,,,,2,1,1,2
C1C2C(CC(C(O)O1)(O)O2)O,,,3,1,2,4,6
3176_0,,,,2,1,1,2
C1C(C2(CC(C(O2)O1)O)O)O,,,3,1,1,3,4
3178_0,,,,2,1,1,2
C1CC2(C(C(C(O2)O1)O)O)O,,,3,1,1,4,5
3180_0,,,,2,1,1,2
C1C2(CC(C(C(O)O1)O2)O)O,,,3,1,2,3,5
3182_0,,,,2,1,1,2
C1(C(CC(CCO)(O)O1)O)=O,,,3,1,1,6,7
3184_0,,,,2,1,1,2
C(C1CCC(CO)(O1)O)(O)=O,,,3,1,1,6,7
3186_0,,,,2,1,1,2
C(C1CC(C(C)(O1)O)O)(O)=O,,,3,1,1,7,8
3187_0,,,,2,1,1,2
3189_0,,,,2,1,1,2
C(C(C1(CC(CO1)O)O)=O)=O,,,3,1,3,11,14
3190_0,,,,2,1,1,2
3191_0,,,,2,1,1,2
3193_0,,,,2,1,1,2
C(C(C1C(CC(O1)O)O)=O)=O,,,3,1,3,14,17
3194_0,,,,2,1,1,2
3195_0,,,,2,1,1,2
3196_0,,,,2,1,1,2
3197_0,,,,2,1,1,2
3198_0,,,,2,1,1,2
3200_0,,,,2,1,1,2
C1(C2(C(C(C(CO)O2)O1)O)O)O,,,3,1,2,4,6
3201_0,,,,2,1,1,2
3203_0,,,,2,1,1,2
C1C(C2CC(C(O)O2)(O)O1)O,,,3,1,2,3,5
3205_0,,,,2,1,1,2
C1(C2C(C(CC(O)O2)O1)O)O,,,3,1,2,3,5
3207_0,,,,2,1,1,2
C1C(C2C(C(C(O)O2)(O)O1)O)O,,,3,1,2,4,6
3209_0,,,,2,1,1,2
C1C2C(C(C(C(O)O1)(O)O2)O)O,,,3,1,2,6,8
3211_0,,,,2,1,1,2
C1(C(O)OCC1O)=O,,,3,1,1,52,53
3213_0,,,,2,1,1,2
C(C(C1CC(C(O)O1)O)O)O,,,3,1,2,6,8
3214_0,,,,2,1,1,2
3215_0,,,,2,1,1,2
3216_0,,,,2,1,1,2
3217_0,,,,2,1,1,2
3219_0,,,,2,1,1,2
C(C1(C(CC(CO1)O)O)O)=O,,,3,1,2,9,11
3220_0,,,,2,1,1,2
3221_0,,,,2,1,1,2
3223_0,,,,2,1,1,2
C1(COC(CO)(CC1O)O)=O,,,3,1,2,9,11
3224_0,,,,2,1,1,2
3226_0,,,,2,1,1,2
C(C1C(CC(C(O1)O)O)O)=O,,,3,1,2,12,14
3228_0,,,,2,1,1,2
C(C1CC(C(C(O1)O)O)O)=O,,,3,1,2,11,13
3230_0,,,,2,1,1,2
C1(COC(C)(C(C1O)O)O)=O,,,3,1,1,12,13
3232_0,,,,2,1,1,2
C1(C(C)OC(C(C1O)O)O)=O,,,3,1,1,11,12
3233_0,,,,2,1,1,2
3234_0,,,,2,1,1,2
3236_0,,,,2,1,1,2
CC1(C(C(C(CO1)O)O)O)O,,,3,1,1,7,8
3237_0,,,,2,1,1,2
3238_0,,,,2,1,1,2
3240_0,,,,2,1,1,2
C1(C(C(CC(CO)(O)O1)O)O)=O,,,3,1,1,7,8
3242_0,,,,2,1,1,2
C1(C(C(C(C(C)(O)O1)O)O)O)=O,,,3,1,1,8,9
3243_0,,,,2,1,1,2
3244_0,,,,2,1,1,2
3245_0,,,,2,1,1,2
3246_0,,,,2,1,1,2
3247_0,,,,2,1,1,2
3248_0,,,,2,1,1,2
3250_0,,,,2,1,1,2
C1C2(C(C(C(CO2)O)O1)O)O,,,3,1,1,2,3
3251_0,,,,2,1,1,2
3252_0,,,,2,1,1,2
3254_0,,,,2,1,1,2
C1C2(C(C(C(CO2)O1)O)O)O,,,3,1,1,4,5
3256_0,,,,2,1,1,2
C1C2C(CC(C(O)O2)(O)O1)O,,,3,1,2,4,6
3258_0,,,,2,1,1,2
C1(C(CCC(CO)(O)O1)O)=O,,,3,1,1,5,6
3260_0,,,,2,1,1,2
C1(C(CC(C(C)(O)O1)O)O)=O,,,3,1,1,6,7
3262_0,,,,2,1,1,2
C(C1CC(CC(O1)O)O)(O)=O,,,3,1,1,7,8
3263_0,,,,2,1,1,2
3264_0,,,,2,1,1,2
3265_0,,,,2,1,1,2
3266_0,,,,2,1,1,2
3267_0,,,,2,1,1,2
3268_0,,,,2,1,1,2
3269_0,,,,2,1,1,2
3270_0,,,,2,1,1,2
3271_0,,,,2,1,1,2
3272_0,,,,2,1,1,2
3274_0,,,,2,1,1,2
C1C2C(C(C(C(O)O2)(O)O1)O)O,,,3,1,2,6,8
3275_0,,,,2,1,1,2
3277_0,,,,2,1,1,2
C(C1C(CC(C(O)O1)O)O)O,,,3,1,2,5,7
3278_0,,,,2,1,1,2
3279_0,,,,2,1,1,2
3280_0,,,,2,1,1,2
3281_0,,,,2,1,1,2
3283_0,,,,2,1,1,2
C1(COC(CC(C1O)O)O)=O,,,3,1,3,12,15
3284_0,,,,2,1,1,2
3286_0,,,,2,1,1,2
C1C(C(C(CC(O)O1)O)O)O,,,3,1,1,7,8
3288_0,,,,2,1,1,2
C1CC(C(C(C(O)O1)O)O)O,,,3,1,1,8,9
3290_0,,,,2,1,1,2
C1(C(C(C(CC(O)O1)O)O)O)=O,,,3,1,1,8,9
3292_0,,,,2,1,1,2
C1(CC(C(C(C(O)O1)O)O)O)=O,,,3,1,1,8,9
3293_0,,,,2,1,1,2
3294_0,,,,2,1,1,2
3295_0,,,,2,1,1,2
3296_0,,,,2,1,1,2
3298_0,,,,2,1,1,2
C12C(C(C(CC(O)O1)O2)O)O,,,3,1,1,4,5
3300_0,,,,2,1,1,2
C1(C(CC(CC(O)O1)O)O)=O,,,3,1,1,6,7
3301_0,,,,2,1,1,2
3302_0,,,,2,1,1,2
3303_0,,,,2,1,1,2
3304_0,,,,2,1,1,2
3305_0,,,,2,1,1,2
3306_0,,,,2,1,1,2
3308_0,,,,2,1,1,2
C12CC(C(C(C(O)O1)O)O2)O,,,3,1,1,4,5
3309_0,,,,2,1,1,2
3311_0,,,,2,1,1,2
C1C(C(CC(C(O)O1)O)O)O,,,3,1,1,7,8
3312_0,,,,2,1,1,2
3313_0,,,,2,1,1,2
3314_0,,,,2,1,1,2
3315_0,,,,2,1,1,2
3316_0,,,,2,1,1,2
3317_0,,,,2,1,1,2
3318_0,,,,2,1,1,2
3319_0,,,,2,1,1,2
3320_0,,,,2,1,1,2
3321_0,,,,2,1,1,2
3322_0,,,,2,1,1,2
3323_0,,,,2,1,1,2
3324_0,,,,2,1,1,2
3325_0,,,,2,1,1,2
3326_0,,,,2,1,1,2
3327_0,,,,2,1,1,2
3328_0,,,,2,1,1,2
3329_0,,,,2,1,1,2
3330_0,,,,2,1,1,2
3331_0,,,,2,1,1,2
3332_0,,,,2,1,1,2
3333_0,,,,2,1,1,2
3334_0,,,,2,1,1,2
3335_0,,,,2,1,1,2
3336_0,,,,2,1,1,2
3337_0,,,,2,1,1,2
3338_0,,,,2,1,1,2
3339_0,,,,2,1,1,2
3340_0,,,,2,1,1,2
3341_0,,,,2,1,1,2
3342_0,,,,2,1,2,3
3343_0,,,,2,1,2,3
3344_0,,,,2,1,2,3
3345_0,,,,2,1,2,3
3346_0,,,,2,1,2,3
3347_0,,,,2,1,2,3
3348_0,,,,2,1,2,3
3350_0,,,,2,1,2,3
C1(CC(C(C(C=O)O)O1)O)=O,,,3,1,2,11,13
3352_0,,,,2,1,2,3
C1(C(C(C(C(CO)O)O1)O)=O)=O,,,3,1,3,5,8
3353_0,,,,2,1,1,2
3354_0,,,,2,1,1,2
3355_0,,,,2,1,2,3
3356_0,,,,2,1,2,3
3357_0,,,,2,1,1,2
3358_0,,,,2,1,1,2
3359_0,,,,2,1,1,2
3360_0,,,,2,1,1,2
3362_0,,,,2,1,2,3
C1(C(CCO1)O)=O,,,3,1,4,39,43
3363_0,,,,2,1,2,3
3364_0,,,,2,1,2,3
3365_0,,,,2,1,2,3
3366_0,,,,2,1,2,3
3368_0,,,,2,1,2,3
C1(CC(C(C(C=O)O1)O)O)=O,,,3,1,1,13,14
3370_0,,,,2,1,2,3
C1(C(C(C(C(CO)O1)O)O)=O)=O,,,3,1,3,7,10
3371_0,,,,2,1,1,2
3372_0,,,,2,1,1,2
3373_0,,,,2,1,1,2
3374_0,,,,2,1,2,3
3375_0,,,,2,1,2,3
3376_0,,,,2,1,2,3
3377_0,,,,2,1,2,3
3378_0,,,,2,1,2,3
3379_0,,,,2,1,2,3
3381_0,,,,2,1,2,3
C1(C(C(C(C(CO1)O)O)O)=O)=O,,,3,1,2,10,12
3382_0,,,,2,1,2,3
3383_0,,,,2,1,2,3
3384_0,,,,2,1,1,2
3385_0,,,,2,1,1,2
3387_0,,,,2,2,1,3
C(CC(C(CO)O)CC(C=O)=O)=O,,,3,1,3,17,20
3389_0,,,,2,2,1,3
C(C(C(CC(CO)CC=O)=O)O)=O,,,3,1,1,16,17
3391_0,,,,2,2,1,3
C(CC(C=O)CC=O)(C(CO)O)=O,,,3,1,2,16,18
3393_0,,,,2,2,1,3
C(CC(C(C(CO)O)=O)CC=O)=O,,,3,1,1,11,12
3395_0,,,,2,2,1,3
C(CCCC(C(C(C=O)O)O)=O)=O,,,3,1,1,21,22
3397_0,,,,2,2,1,3
C(CC(C(C=O)O)CC(CO)=O)=O,,,3,1,1,18,19
3399_0,,,,2,2,1,3
C(CC(C(C(C=O)O)O)CC=O)=O,,,3,1,1,17,18
3400_0,,,,2,1,2,3
3401_0,,,,2,3,5,8
3402_0,,,,2,3,5,8
3403_0,,,,2,3,5,8
3404_0,,,,2,3,5,8
3405_0,,,,2,3,5,8
3406_0,,,,2,3,5,8
3407_0,,,,2,3,5,8
3408_0,,,,2,3,5,8
3409_0,,,,2,3,5,8
3410_0,,,,2,3,5,8
3411_0,,,,2,3,5,8
3412_0,,,,2,3,5,8
3413_0,,,,2,3,5,8
3414_0,,,,2,5,3,8
3415_0,,,,2,5,3,8
3416_0,,,,2,2,2,4
3417_0,,,,2,2,2,4
3418_0,,,,2,2,2,4
3419_0,,,,2,2,2,4
3420_0,,,,2,2,2,4
3421_0,,,,2,2,2,4
3422_0,,,,2,2,2,4
3423_0,,,,2,2,2,4
3424_0,,,,2,2,2,4
3425_0,,,,2,3,5,8
3426_0,,,,2,3,5,8
3427_0,,,,2,3,5,8
3428_0,,,,2,3,5,8
3429_0,,,,2,3,5,8
3430_0,,,,2,3,5,8
3431_0,,,,2,3,5,8
3432_0,,,,2,3,5,8
3433_0,,,,2,3,5,8
3434_0,,,,2,3,5,8
3435_0,,,,2,3,5,8
3436_0,,,,2,3,5,8
3437_0,,,,2,3,5,8
3438_0,,,,2,3,5,8
3439_0,,,,2,3,5,8
3440_0,,,,2,3,5,8
3441_0,,,,2,3,5,8
3442_0,,,,2,3,5,8
3443_0,,,,2,3,5,8
3444_0,,,,2,5,3,8
3445_0,,,,2,5,3,8
3446_0,,,,2,5,3,8
3447_0,,,,2,5,3,8
3448_0,,,,2,5,3,8
3449_0,,,,2,5,3,8
3450_0,,,,2,5,3,8
3451_0,,,,2,5,3,8
3452_0,,,,2,5,3,8
3453_0,,,,2,5,3,8
3454_0,,,,2,5,3,8
3455_0,,,,2,5,3,8
3456_0,,,,2,5,3,8
3457_0,,,,2,5,3,8
3458_0,,,,2,5,3,8
3459_0,,,,2,5,3,8
3460_0,,,,2,4,4,8
3461_0,,,,2,4,4,8
3462_0,,,,2,4,4,8
3463_0,,,,2,4,4,8
3464_0,,,,2,4,4,8
3465_0,,,,2,4,4,8
3466_0,,,,2,4,4,8
3467_0,,,,2,4,4,8
3468_0,,,,2,4,4,8
3469_0,,,,2,4,4,8
3470_0,,,,2,4,4,8
3471_0,,,,2,4,4,8
3472_0,,,,2,4,4,8
3473_0,,,,2,4,4,8
3474_0,,,,2,4,4,8
3475_0,,,,2,4,4,8
3476_0,,,,2,4,4,8
3477_0,,,,2,4,4,8
3478_0,,,,2,4,4,8
3479_0,,,,2,4,4,8
3480_0,,,,2,4,4,8
3481_0,,,,2,4,4,8
3482_0,,,,2,4,4,8
3483_0,,,,2,4,4,8
3484_0,,,,2,4,4,8
3485_0,,,,2,4,4,8
3487_0,,,,2,4,3,7
[C](C(O)=O)(CC(C(CO)O)O)O,,,3,1,1,9,10
3489_0,,,,2,4,3,7
[C](C(O)=O)(C(C(C(CO)O)O)O)O,,,3,1,1,11,12
3490_0,,,,2,1,1,2
3490_1,,,,2,1,1,2
3492_0,,,,2,1,1,2
C1(C(C(CO)(C(C(C1)O)O)O)O)=O,,,4,1,2,0,2
3492_1,,,,2,1,1,2
3494_0,,,,2,1,1,2
C1(C(C(CO)(CC(C1O)O)O)O)=O,,,4,1,4,0,4
3494_1,,,,2,1,1,2
3495_0,,,,2,1,1,2
3495_1,,,,2,1,1,2
3497_0,,,,2,1,1,2
C1(C(C(C(C(CO)(C1)O)O)O)O)=O,,,4,1,1,0,1
3499_0,,,,2,1,1,2
C1(C(C(C)(C(C(C1O)O)O)O)O)=O,,,4,1,4,0,4
3499_1,,,,2,1,1,2
3500_0,,,,2,1,1,2
3500_1,,,,2,1,1,2
3502_0,,,,2,1,1,2
C1(C(C(C(C1O)O)O)O)=O,,,4,1,2,0,2
3502_1,,,,2,1,1,2
3504_0,,,,2,1,1,2
C1(C(C(C(CO)(C1CO)O)O)O)=O,,,4,1,6,0,6
3504_1,,,,2,1,1,2
3506_0,,,,2,1,1,2
C1(C(C(C(C1O)O)(CCO)O)O)=O,,,4,1,4,0,4
3506_1,,,,2,1,1,2
3507_0,,,,2,1,1,2
3507_1,,,,2,1,1,2
3509_0,,,,2,1,1,2
C1(C(C(C(C(C1O)O)O)O)O)=O,,,4,1,3,0,3
3509_1,,,,2,1,1,2
3511_0,,,,2,1,1,2
C(C1C(C(C(C1(CO)O)O)O)O)=O,,,4,1,2,0,2
3511_1,,,,2,1,1,2
3513_0,,,,2,1,1,2
C1(C(C(C(CC(C1O)O)O)O)O)=O,,,4,1,4,0,4
3513_1,,,,2,1,1,2
3514_0,,,,2,1,1,2
3514_1,,,,2,1,1,2
3516_0,,,,2,1,1,2
C1(C(C(C(CO)(C1O)O)O)O)=O,,,4,1,7,0,7
3516_1,,,,2,1,1,2
3517_0,,,,2,1,1,2
3517_1,,,,2,1,1,2
3519_0,,,,2,1,1,2
C(CO)(C1C(CC(C1O)=O)O)=O,,,4,1,3,0,3
3519_1,,,,2,1,1,2
3521_0,,,,2,1,1,2
C1(C(C(C(CC(C1)O)=O)O)O)=O,,,4,1,3,0,3
3521_1,,,,2,1,1,2
3523_0,,,,2,1,1,2
C(C1(CC(CC(C1O)=O)O)O)=O,,,4,1,4,0,4
3523_1,,,,2,1,1,2
3525_0,,,,2,1,1,2
C(C1C(CO)(CC(C1O)=O)O)=O,,,4,1,3,0,3
3525_1,,,,2,1,1,2
3527_0,,,,2,1,1,2
C(C1C(C(C(C)(C1O)O)O)=O)=O,,,4,1,4,0,4
3527_1,,,,2,1,1,2
3528_0,,,,2,1,1,2
3529_0,,,,2,1,1,2
3531_0,,,,2,1,1,2
C(C1C(C(C(C1(C)O)O)O)=O)=O,,,4,1,4,0,4
3531_1,,,,2,1,1,2
3532_0,,,,2,1,1,2
3532_1,,,,2,1,1,2
3533_0,,,,2,1,1,2
3535_0,,,,2,1,1,2
C(CC1(C(C(C(C1)=O)O)O)O)=O,,,4,1,1,0,1
3536_0,,,,2,1,1,2
3536_1,,,,2,1,1,2
3538_0,,,,2,1,1,2
C1(CC(C(CC(C1O)O)=O)O)=O,,,4,1,2,0,2
3540_0,,,,2,1,1,2
C(C1(CC(C(C(C1)=O)O)O)O)=O,,,4,1,1,0,1
3541_0,,,,2,1,1,2
3543_0,,,,2,1,1,2
C1(C(CC(C(C=O)O)(C1)O)O)=O,,,4,1,1,0,1
3545_0,,,,2,1,1,2
C1(C(CC(C(CO)O)(C1)O)O)=O,,,4,1,1,0,1
3547_0,,,,2,1,1,2
C1(C(C(C(C(C1)O)=O)CO)O)=O,,,4,1,6,0,6
3547_1,,,,2,1,1,2
3549_0,,,,2,1,1,2
C1(C(CO)C(C=O)(CC1O)O)=O,,,4,1,4,0,4
3549_1,,,,2,1,1,2
3550_0,,,,2,1,1,2
3552_0,,,,2,1,1,2
C(C1(C(CO)C(C(C1)=O)O)O)=O,,,4,1,1,0,1
3554_0,,,,2,1,1,2
C1(C(C(C(C)(C1CO)O)O)O)=O,,,4,1,4,0,4
3554_1,,,,2,1,1,2
3556_0,,,,2,1,1,2
C1(C(C(C(CCO)(C1)O)O)O)=O,,,4,1,3,0,3
3558_0,,,,2,1,1,2
C1(C(C(C)(C(C1CO)O)O)O)=O,,,4,1,4,0,4
3558_1,,,,2,1,1,2
3559_0,,,,2,1,1,2
3559_1,,,,2,1,1,2
3561_0,,,,2,1,1,2
C1(C(C(CO)C(CO)(C1)O)O)=O,,,4,1,1,0,1
3562_0,,,,2,1,1,2
3562_1,,,,2,1,1,2
3564_0,,,,2,1,1,2
C1(C(C(C(C1)O)(C)O)O)=O,,,4,1,3,0,3
3564_1,,,,2,1,1,2
3566_0,,,,2,1,1,2
C1(C(CC(CO)(C1)O)O)=O,,,4,1,2,0,2
3568_0,,,,2,1,1,2
C1(C(C(C(C)(C1)O)O)O)=O,,,4,1,3,0,3
3568_1,,,,2,1,1,2
3569_0,,,,2,1,1,2
3570_0,,,,2,1,1,2
3572_0,,,,2,1,1,2
C(C1C(C(CC(C1O)=O)O)O)=O,,,4,1,3,0,3
3572_1,,,,2,1,1,2
3574_0,,,,2,1,1,2
C(C1C(C(CC1(C=O)O)O)O)=O,,,4,1,2,0,2
3574_1,,,,2,1,1,2
3576_0,,,,2,1,1,2
C(C(C1C(C(CC1O)O)O)=O)=O,,,4,1,4,0,4
3576_1,,,,2,1,1,2
3577_0,,,,2,1,1,2
3577_1,,,,2,1,1,2
3578_0,,,,2,1,1,2
3580_0,,,,2,1,1,2
C1(C(C(C(C1)O)C(C=O)O)O)=O,,,4,1,1,0,1
3582_0,,,,2,1,1,2
C(C(C1C(C(C(C1O)O)O)O)=O)=O,,,4,1,2,0,2
3582_1,,,,2,1,1,2
3584_0,,,,2,1,1,2
C1(C(CC(C1)O)O)=O,,,4,1,1,0,1
3585_0,,,,2,1,1,2
3585_1,,,,2,1,1,2
3587_0,,,,2,1,1,2
C(C1(CC(C(C1O)=O)O)O)=O,,,4,1,4,0,4
3587_1,,,,2,1,1,2
3589_0,,,,2,1,1,2
C1(C(C(C(C(CO)O)(C1)O)O)O)=O,,,4,1,3,0,3
3591_0,,,,2,1,1,2
C(C1C(C(C(C1O)O)O)=O)=O,,,4,1,5,0,5
3591_1,,,,2,1,1,2
3592_0,,,,2,1,1,2
3592_1,,,,2,1,1,2
3594_0,,,,2,1,1,2
C(C1C(C(C(C(C1O)O)O)O)=O)=O,,,4,1,4,0,4
3594_1,,,,2,1,1,2
3595_0,,,,2,1,1,2
3595_1,,,,2,1,1,2
3597_0,,,,2,1,1,2
C1(C(C(CO)(CC(C1)O)O)O)=O,,,4,1,3,0,3
3597_1,,,,2,1,1,2
3599_0,,,,2,1,1,2
C1(C(C(CC(CO)(C1)O)O)O)=O,,,4,1,3,0,3
3599_1,,,,2,1,1,2
3600_0,,,,2,1,1,2
3602_0,,,,2,1,1,2
C1(C(C(C)(C(C(C1)O)O)O)O)=O,,,4,1,3,0,3
3602_1,,,,2,1,1,2
3603_0,,,,2,1,1,2
3605_0,,,,2,1,1,2
C1(C(C(CC(C1)O)O)O)=O,,,4,1,3,0,3
3605_1,,,,2,1,1,2
3607_0,,,,2,1,1,2
C(CO)(C1C(C(C(C1O)=O)O)O)=O,,,4,1,4,0,4
3607_1,,,,2,1,1,2
3609_0,,,,2,1,1,2
C(C1C(CO)(C(C(C1O)=O)O)O)=O,,,4,1,4,0,4
3609_1,,,,2,1,1,2
3611_0,,,,2,1,1,2
C(C1C(C(C(CO)(C1O)O)O)=O)=O,,,4,1,4,0,4
3611_1,,,,2,1,1,2
3613_0,,,,2,1,1,2
C1(C(C(C(C(C(C1)O)O)=O)O)O)=O,,,4,1,4,0,4
3613_1,,,,2,1,1,2
3615_0,,,,2,1,1,2
C(CC1(C(C(C(C1O)=O)O)O)O)=O,,,4,1,4,0,4
3615_1,,,,2,1,1,2
3617_0,,,,2,1,1,2
C(C1C(C(C(C1(CO)O)O)O)=O)=O,,,4,1,4,0,4
3617_1,,,,2,1,1,2
3618_0,,,,2,1,1,2
3618_1,,,,2,1,1,2
3619_0,,,,2,1,1,2
3619_1,,,,2,1,1,2
3620_0,,,,2,1,1,2
3620_1,,,,2,1,1,2
3621_0,,,,2,1,1,2
3621_1,,,,2,1,1,2
3623_0,,,,2,1,1,2
C(C1(C(C(CC(C1O)=O)O)O)O)=O,,,4,1,7,0,7
3623_1,,,,2,1,1,2
3624_0,,,,2,1,1,2
3624_1,,,,2,1,1,2
3626_0,,,,2,1,1,2
C1(C(C(C(C(C)(C1)O)O)O)O)=O,,,4,1,3,0,3
3626_1,,,,2,1,1,2
3627_0,,,,2,1,1,2
3628_0,,,,2,1,1,2
3629_0,,,,2,1,1,2
3631_0,,,,2,1,1,2
C1(CC(C(C(C(C1O)O)O)=O)O)=O,,,4,1,3,0,3
3631_1,,,,2,1,1,2
3633_0,,,,2,1,1,2
C(C(C1(CC(C(C1O)=O)O)O)O)=O,,,4,1,2,0,2
3633_1,,,,2,1,1,2
3634_0,,,,2,1,1,2
3636_0,,,,2,1,1,2
C(C1(C(C(C(C(C1)=O)O)O)O)O)=O,,,4,1,4,0,4
3638_0,,,,2,1,1,2
C1(C(C(C(C1O)O)O)C(C=O)O)=O,,,4,1,6,0,6
3638_1,,,,2,1,1,2
3639_0,,,,2,1,1,2
3639_1,,,,2,1,1,2
3640_0,,,,2,1,1,2
3640_1,,,,2,1,1,2
3642_0,,,,2,1,1,2
C1(C(C(CC1O)(C(CO)O)O)O)=O,,,4,1,2,0,2
3642_1,,,,2,1,1,2
3644_0,,,,2,1,1,2
C1(C(C(C(C1C(C)O)O)O)O)=O,,,4,1,6,0,6
3644_1,,,,2,1,1,2
3646_0,,,,2,1,1,2
C(C1C(C(CC1(CO)O)O)O)=O,,,4,1,4,0,4
3646_1,,,,2,1,1,2
3648_0,,,,2,1,1,2
C(CO)(C1C(C(CC1O)O)O)=O,,,4,1,4,0,4
3648_1,,,,2,1,1,2
3650_0,,,,2,1,1,2
C1(C(C(CC(C(C1)O)O)O)O)=O,,,4,1,3,0,3
3650_1,,,,2,1,1,2
3651_0,,,,2,1,1,2
3651_1,,,,2,1,1,2
3653_0,,,,2,1,1,2
C1(C(C(C(C1)O)(C(CO)O)O)O)=O,,,4,1,3,0,3
3653_1,,,,2,1,1,2
3655_0,,,,2,1,1,2
C1(C(C(CO)(C(C1CO)O)O)O)=O,,,4,1,6,0,6
3655_1,,,,2,1,1,2
3657_0,,,,2,1,1,2
C1(C(C(CO)(C(CO)C1O)O)O)=O,,,4,1,2,0,2
3657_1,,,,2,1,1,2
3659_0,,,,2,1,1,2
C1(C(C(C(CO)C(C1O)O)O)O)=O,,,4,1,2,0,2
3659_1,,,,2,1,1,2
3661_0,,,,2,1,1,2
C1(C(CO)C(C(C1CO)=O)O)=O,,,4,1,7,0,7
3661_1,,,,2,1,1,2
3663_0,,,,2,1,1,2
C1(C(C(C(C(CO)C1)=O)O)O)=O,,,4,1,6,0,6
3663_1,,,,2,1,1,2
3665_0,,,,2,1,1,2
C(C1(C(CO)CC(C1O)=O)O)=O,,,4,1,2,0,2
3665_1,,,,2,1,1,2
3666_0,,,,2,1,1,2
3666_1,,,,2,1,1,2
3668_0,,,,2,1,1,2
C(C1(CC(C(C1O)=O)CO)O)=O,,,4,1,3,0,3
3668_1,,,,2,1,1,2
3670_0,,,,2,1,1,2
C(C1C(C(C(C1O)=O)CO)O)=O,,,4,1,6,0,6
3670_1,,,,2,1,1,2
3672_0,,,,2,1,1,2
C1(C(C(CO)C(C1CO)O)=O)=O,,,4,1,4,0,4
3672_1,,,,2,1,1,2
3674_0,,,,2,1,1,2
C1(C(CO)C(C(C(C1)=O)O)O)=O,,,4,1,7,0,7
3674_1,,,,2,1,1,2
3676_0,,,,2,1,1,2
C1(CC(C(C(C1CO)=O)O)O)=O,,,4,1,7,0,7
3676_1,,,,2,1,1,2
3678_0,,,,2,1,1,2
C1(C(CO)C(CC(C1O)=O)O)=O,,,4,1,6,0,6
3679_0,,,,2,1,1,2
3679_1,,,,2,1,1,2
3680_0,,,,2,1,1,2
3680_1,,,,2,1,1,2
3682_0,,,,2,1,1,2
C(C1C(C(C(CO)C1O)O)=O)=O,,,4,1,2,0,2
3682_1,,,,2,1,1,2
3683_0,,,,2,1,1,2
3684_0,,,,2,1,1,2
3684_1,,,,2,1,1,2
3686_0,,,,2,1,1,2
C1(C(CO)C(C=O)C(C1O)O)=O,,,4,1,2,0,2
3688_0,,,,2,1,1,2
C1(C(CC(C(C1CO)O)O)=O)=O,,,4,1,6,0,6
3689_0,,,,2,1,1,2
3689_1,,,,2,1,1,2
3691_0,,,,2,1,1,2
C(C1C(C(CO)C(C1O)O)=O)=O,,,4,1,5,0,5
3691_1,,,,2,1,1,2
3693_0,,,,2,1,1,2
C1(C(C(C(C(C1CO)O)=O)O)O)=O,,,4,1,8,0,8
3693_1,,,,2,1,1,2
3695_0,,,,2,1,1,2
C(C1(C(C(C(C1O)=O)CO)O)O)=O,,,4,1,8,0,8
3695_1,,,,2,1,1,2
3696_0,,,,2,1,1,2
3696_1,,,,2,1,1,2
3698_0,,,,2,1,1,2
C1(C(CO)C(C=O)(C(C1O)O)O)=O,,,4,1,4,0,4
3698_1,,,,2,1,1,2
3700_0,,,,2,1,1,2
C1(C(C(C(C1)O)(CCO)O)O)=O,,,4,1,3,0,3
3700_1,,,,2,1,1,2
3702_0,,,,2,1,1,2
C1(C(CC(CO)(C1CO)O)O)=O,,,4,1,2,0,2
3702_1,,,,2,1,1,2
3703_0,,,,2,1,1,2
3703_1,,,,2,1,1,2
3704_0,,,,2,1,1,2
3706_0,,,,2,1,1,2
C1(C(CC(C1CO)O)O)=O,,,4,1,4,0,4
3706_1,,,,2,1,1,2
3707_0,,,,2,1,1,2
3707_1,,,,2,1,1,2
3709_0,,,,2,1,1,2
C(C1(C(CO)C(C(C1O)=O)O)O)=O,,,4,1,2,0,2
3709_1,,,,2,1,1,2
3710_0,,,,2,1,1,2
3710_1,,,,2,1,1,2
3711_0,,,,2,1,1,2
3711_1,,,,2,1,1,2
3712_0,,,,2,1,1,2
3712_1,,,,2,1,1,2
3713_0,,,,2,1,1,2
3713_1,,,,2,1,1,2
3714_0,,,,2,1,1,2
3714_1,,,,2,1,1,2
3716_0,,,,2,1,1,2
C(C1C(C(C(C1(C)O)O)O)O)=O,,,4,1,4,0,4
3716_1,,,,2,1,1,2
3718_0,,,,2,1,1,2
C1(C(C(C(CC(C1)O)O)O)O)=O,,,4,1,3,0,3
3719_0,,,,2,1,1,2
3719_1,,,,2,1,1,2
3720_0,,,,2,1,1,2
3720_1,,,,2,1,1,2
3721_0,,,,2,1,1,2
3721_1,,,,2,1,1,2
3722_0,,,,2,1,1,2
3724_0,,,,2,1,1,2
C(CO)(C1C(C(C(C1O)O)O)O)=O,,,4,1,2,0,2
3724_1,,,,2,1,1,2
3726_0,,,,2,1,1,2
C1(C(C(C(C(C(C1)O)O)O)O)O)=O,,,4,1,3,0,3
3726_1,,,,2,1,1,2
3727_0,,,,2,1,1,2
3728_0,,,,2,1,1,2
3728_1,,,,2,1,1,2
3729_0,,,,2,1,1,2
3730_0,,,,2,1,1,2
3730_1,,,,2,1,1,2
3731_0,,,,2,1,1,2
3733_0,,,,2,1,1,2
C(C1C(C(CC1O)O)O)=O,,,4,1,5,0,5
3733_1,,,,2,1,1,2
3734_0,,,,2,1,1,2
3734_1,,,,2,1,1,2
3736_0,,,,2,1,1,2
C(C1C(C(C(C(C1O)=O)O)O)O)=O,,,4,1,4,0,4
3736_1,,,,2,1,1,2
3738_0,,,,2,1,1,2
C(C(C1C(C(C(C1O)=O)O)O)O)=O,,,4,1,2,0,2
3738_1,,,,2,1,1,2
3739_0,,,,2,1,1,2
3739_1,,,,2,1,1,2
3741_0,,,,2,1,1,2
C(C1C(C(C(C1(C=O)O)O)O)O)=O,,,4,1,5,0,5
3741_1,,,,2,1,1,2
3743_0,,,,2,1,1,2
C1(C(C(CC1O)O)O)=O,,,4,1,6,0,6
3743_1,,,,2,1,1,2
3745_0,,,,2,1,1,2
C(CCO)(C1C(C(CC1O)O)=O)=O,,,4,1,2,0,2
3745_1,,,,2,1,1,2
3747_0,,,,2,1,1,2
C1(C(CO)C(CC(C(C1)=O)O)O)=O,,,4,1,2,0,2
3747_1,,,,2,1,1,2
3749_0,,,,2,1,1,2
C(C1C(CCO)(CC(C1O)=O)O)=O,,,4,1,4,0,4
3749_1,,,,2,1,1,2
3751_0,,,,2,1,1,2
C(C1(CC(C(C(C1)=O)CO)O)O)=O,,,4,1,2,0,2
3751_1,,,,2,1,1,2
3753_0,,,,2,1,1,2
C1(CC(C(C1CO)O)(CC=O)O)=O,,,4,1,3,0,3
3753_1,,,,2,1,1,2
3754_0,,,,2,1,1,2
3754_1,,,,2,1,1,2
3756_0,,,,2,1,1,2
C1(C(CO)C(C(C1C(C)O)=O)O)=O,,,4,1,4,0,4
3756_1,,,,2,1,1,2
3758_0,,,,2,1,1,2
C1(C(C(CC1O)O)CC(CO)=O)=O,,,4,1,1,0,1
3760_0,,,,2,1,1,2
C(CO)(C1C(CC(C(C1)=O)O)O)=O,,,4,1,1,0,1
3762_0,,,,2,1,1,2
C1(CCC(C(CC(C1O)O)O)=O)=O,,,4,1,2,0,2
3762_1,,,,2,1,1,2
3764_0,,,,2,1,1,2
C(CC(C1(CCC(C1O)=O)O)O)=O,,,4,1,4,0,4
3764_1,,,,2,1,1,2
3766_0,,,,2,1,1,2
C(C1C(CCC(C1O)=O)(CO)O)=O,,,4,1,4,0,4
3766_1,,,,2,1,1,2
3768_0,,,,2,1,1,2
C(C1(CC(C(CO)=O)C(C1)O)O)=O,,,4,1,1,0,1
3770_0,,,,2,1,1,2
C(C1(CCC(C(C(C1)O)O)=O)O)=O,,,4,1,2,0,2
3770_1,,,,2,1,1,2
3772_0,,,,2,1,1,2
C(CC1(CCC(C(C1O)O)=O)O)=O,,,4,1,4,0,4
3772_1,,,,2,1,1,2
3774_0,,,,2,1,1,2
C(C1C(CO)(CCC1(C=O)O)O)=O,,,4,1,4,0,4
3774_1,,,,2,1,1,2
3776_0,,,,2,1,1,2
C(C(C1CC(CO)(CC1O)O)=O)=O,,,4,1,1,0,1
3777_0,,,,2,1,1,2
3777_1,,,,2,1,1,2
3778_0,,,,2,1,1,2
3778_1,,,,2,1,1,2
3780_0,,,,2,1,1,2
C1(C(C(C(C(C(C)O)C1)=O)O)O)=O,,,4,1,5,0,5
3780_1,,,,2,1,1,2
3782_0,,,,2,1,1,2
C(C1(C(C(C)O)CC(C1O)=O)O)=O,,,4,1,2,0,2
3782_1,,,,2,1,1,2
3783_0,,,,2,1,1,2
3783_1,,,,2,1,1,2
3785_0,,,,2,1,1,2
C(C1(CC(C(C1O)=O)C(C)O)O)=O,,,4,1,3,0,3
3785_1,,,,2,1,1,2
3787_0,,,,2,1,1,2
C1(C(C(CC1O)O)C(C(C)=O)O)=O,,,4,1,2,0,2
3787_1,,,,2,1,1,2
3789_0,,,,2,1,1,2
C1(CC(C(CC(CC1O)O)=O)O)=O,,,4,1,1,0,1
3791_0,,,,2,1,1,2
C(CC(C1(CC(C(C1)=O)O)O)O)=O,,,4,1,2,0,2
3793_0,,,,2,1,1,2
C(C1C(C(CC(C1O)=O)O)(C)O)=O,,,4,1,4,0,4
3793_1,,,,2,1,1,2
3795_0,,,,2,1,1,2
C(C1(CC(C(CC(C1)O)=O)O)O)=O,,,4,1,1,0,1
3797_0,,,,2,1,1,2
C(CC1(C(CC(C(C1)O)=O)O)O)=O,,,4,1,2,0,2
3799_0,,,,2,1,1,2
C(C1C(C)(C(CC1(C=O)O)O)O)=O,,,4,1,4,0,4
3799_1,,,,2,1,1,2
3801_0,,,,2,1,1,2
C(C(C1C(C(C)(CC1O)O)O)=O)=O,,,4,1,2,0,2
3801_1,,,,2,1,1,2
3802_0,,,,2,1,1,2
3802_1,,,,2,1,1,2
3803_0,,,,2,1,1,2
3803_1,,,,2,1,1,2
3805_0,,,,2,1,1,2
C1(C(C(C(C(C1)O)=O)C(C)O)O)=O,,,4,1,5,0,5
3807_0,,,,2,1,1,2
C(C1(C(C(C)O)C(C(C1)=O)O)O)=O,,,4,1,1,0,1
3808_0,,,,2,1,1,2
3808_1,,,,2,1,1,2
3810_0,,,,2,1,1,2
C1(C(C(C)O)C(C=O)(CC1O)O)=O,,,4,1,4,0,4
3810_1,,,,2,1,1,2
3812_0,,,,2,1,1,2
C(CC(C1C(C(CC1O)O)=O)O)=O,,,4,1,3,0,3
3812_1,,,,2,1,1,2
3814_0,,,,2,1,1,2
C(C1C(CC(C(CC1O)O)=O)O)=O,,,4,1,4,0,4
3814_1,,,,2,1,1,2
3816_0,,,,2,1,1,2
C(C1C(CC(CC(C1O)=O)O)O)=O,,,4,1,4,0,4
3816_1,,,,2,1,1,2
3818_0,,,,2,1,1,2
C(C1C(CC(C=O)(CC1O)O)O)=O,,,4,1,2,0,2
3818_1,,,,2,1,1,2
3820_0,,,,2,1,1,2
C(C1C(C(CC1O)(CC=O)O)O)=O,,,4,1,5,0,5
3820_1,,,,2,1,1,2
3822_0,,,,2,1,1,2
C(C1C(CC(CC1(C=O)O)O)O)=O,,,4,1,4,0,4
3822_1,,,,2,1,1,2
3824_0,,,,2,1,1,2
C(C(C1C(CC(CC1O)O)O)=O)=O,,,4,1,2,0,2
3824_1,,,,2,1,1,2
3825_0,,,,2,1,1,2
3825_1,,,,2,1,1,2
3826_0,,,,2,1,1,2
3826_1,,,,2,1,1,2
3828_0,,,,2,1,1,2
C(C1C(C(C(C1O)=O)C(C)O)O)=O,,,4,1,6,0,6
3828_1,,,,2,1,1,2
3830_0,,,,2,1,1,2
C1(C(CC(CC(C1CO)O)O)=O)=O,,,4,1,2,0,2
3830_1,,,,2,1,1,2
3832_0,,,,2,1,1,2
C(C1C(CC(C1(CCO)O)=O)O)=O,,,4,1,4,0,4
3832_1,,,,2,1,1,2
3834_0,,,,2,1,1,2
C1(C(CC(C1CO)O)(CC=O)O)=O,,,4,1,3,0,3
3834_1,,,,2,1,1,2
3836_0,,,,2,1,1,2
C(C1C(C(CCO)(CC1O)O)=O)=O,,,4,1,2,0,2
3836_1,,,,2,1,1,2
3837_0,,,,2,1,1,2
3837_1,,,,2,1,1,2
3839_0,,,,2,1,1,2
C1(C(C(C(C1CO)O)C(C)O)=O)=O,,,4,1,4,0,4
3839_1,,,,2,1,1,2
3841_0,,,,2,1,1,2
C1(CC(CC(C1C(CO)=O)O)O)=O,,,4,1,2,0,2
3841_1,,,,2,1,1,2
3843_0,,,,2,1,1,2
C1(CC(CC(C(C(C1)=O)O)O)O)=O,,,4,1,3,0,3
3843_1,,,,2,1,1,2
3845_0,,,,2,1,1,2
C(C1C(CC(CC1(CO)O)=O)O)=O,,,4,1,4,0,4
3845_1,,,,2,1,1,2
3847_0,,,,2,1,1,2
C(CC1(CC(C(C(C1)=O)O)O)O)=O,,,4,1,3,0,3
3847_1,,,,2,1,1,2
3849_0,,,,2,1,1,2
C(C1C(CC(CO)(CC1O)O)=O)=O,,,4,1,2,0,2
3849_1,,,,2,1,1,2
3850_0,,,,2,1,1,2
3850_1,,,,2,1,1,2
3852_0,,,,2,1,1,2
C1(C(C(C(C(C1)=O)O)O)C(C)O)=O,,,4,1,6,0,6
3852_1,,,,2,1,1,2
3854_0,,,,2,1,1,2
C1(CC(C(C(C1C(C)O)=O)O)O)=O,,,4,1,5,0,5
3854_1,,,,2,1,1,2
3856_0,,,,2,1,1,2
C1(CC(CC(CC(C1O)=O)O)O)=O,,,4,1,1,0,1
3858_0,,,,2,1,1,2
C(C1C(CC(C(C1(C)O)O)=O)O)=O,,,4,1,4,0,4
3858_1,,,,2,1,1,2
3860_0,,,,2,1,1,2
C(CC1(CC(CC(C1O)=O)O)O)=O,,,4,1,2,0,2
3862_0,,,,2,1,1,2
C(C1C(C(C(C)(CC1O)O)O)=O)=O,,,4,1,2,0,2
3862_1,,,,2,1,1,2
3863_0,,,,2,1,1,2
3863_1,,,,2,1,1,2
3865_0,,,,2,1,1,2
C1(C(C(CC(C1O)=O)O)C(C)O)=O,,,4,1,5,0,5
3866_0,,,,2,1,1,2
3866_1,,,,2,1,1,2
3867_0,,,,2,1,1,2
3867_1,,,,2,1,1,2
3869_0,,,,2,1,1,2
C(C1C(CC(C1(CC=O)O)O)O)=O,,,4,1,5,0,5
3869_1,,,,2,1,1,2
3871_0,,,,2,1,1,2
C(C1C(C(CC(CC1O)O)O)=O)=O,,,4,1,2,0,2
3871_1,,,,2,1,1,2
3872_0,,,,2,1,1,2
3872_1,,,,2,1,1,2
3873_0,,,,2,1,1,2
3873_1,,,,2,1,1,2
3874_0,,,,2,1,1,2
3874_1,,,,2,1,1,2
3876_0,,,,2,1,1,2
C(C1C(C(C(C1O)C(C)O)O)=O)=O,,,4,1,2,0,2
3876_1,,,,2,1,1,2
3878_0,,,,2,1,1,2
C1(C(C(CC(C1C(C)=O)O)O)O)=O,,,4,1,2,0,2
3878_1,,,,2,1,1,2
3879_0,,,,2,1,1,2
3881_0,,,,2,1,1,2
C(C1C(C(C(CC1(C)O)=O)O)O)=O,,,4,1,4,0,4
3881_1,,,,2,1,1,2
3883_0,,,,2,1,1,2
C1(CC(CC(C(C=O)O)(C1)O)O)=O,,,4,1,1,0,1
3885_0,,,,2,1,1,2
C(CC1(C(C(CC(C1)=O)O)O)O)=O,,,4,1,2,0,2
3886_0,,,,2,1,1,2
3886_1,,,,2,1,1,2
3887_0,,,,2,1,1,2
3888_0,,,,2,1,1,2
3888_1,,,,2,1,1,2
3890_0,,,,2,1,1,2
C1(C(C(CC(C1O)O)O)CC=O)=O,,,4,1,1,0,1
3892_0,,,,2,1,1,2
C(C1C(CC(C(C(C1)=O)O)O)O)=O,,,4,1,1,0,1
3894_0,,,,2,1,1,2
C(C1C(C(C(CCC1O)=O)O)O)=O,,,4,1,4,0,4
3894_1,,,,2,1,1,2
3896_0,,,,2,1,1,2
C(C1CC(CC1O)(C(C=O)O)O)=O,,,4,1,1,0,1
3898_0,,,,2,1,1,2
C(C1CC(C(C1O)O)(CC=O)O)=O,,,4,1,2,0,2
3900_0,,,,2,1,1,2
C(C1C(CCC1(C(C=O)O)O)O)=O,,,4,1,4,0,4
3900_1,,,,2,1,1,2
3902_0,,,,2,1,1,2
C(C(C(C1C(CC(C1)O)O)=O)O)=O,,,4,1,1,0,1
3903_0,,,,2,1,1,2
3903_1,,,,2,1,1,2
3904_0,,,,2,1,1,2
3904_1,,,,2,1,1,2
3906_0,,,,2,1,1,2
C1(C(C(C)O)C(C=O)C(C1O)O)=O,,,4,1,2,0,2
3908_0,,,,2,1,1,2
C(C(C)=O)(C1C(C(CC1O)O)O)=O,,,4,1,2,0,2
3908_1,,,,2,1,1,2
3910_0,,,,2,1,1,2
C1(C(CC(CC(C(C1)O)O)O)=O)=O,,,4,1,1,0,1
3912_0,,,,2,1,1,2
C(C1C(C(CC1(C(C)=O)O)O)O)=O,,,4,1,4,0,4
3912_1,,,,2,1,1,2
3914_0,,,,2,1,1,2
C(C1C(C(CC(C1(C)O)=O)O)O)=O,,,4,1,4,0,4
3914_1,,,,2,1,1,2
3916_0,,,,2,1,1,2
C1(CC(CC1(CC(C=O)O)O)O)=O,,,4,1,1,0,1
3917_0,,,,2,1,1,2
3917_1,,,,2,1,1,2
3919_0,,,,2,1,1,2
C1(C(CC(C(C1)O)O)(CC=O)O)=O,,,4,1,2,0,2
3921_0,,,,2,1,1,2
C1(C(C(CC1(C)O)O)C(C=O)O)=O,,,4,1,2,0,2
3921_1,,,,2,1,1,2
3922_0,,,,2,1,1,2
3922_1,,,,2,1,1,2
3924_0,,,,2,1,1,2
C1(C(CC(C(C1C(C)O)O)O)=O)=O,,,4,1,5,0,5
3925_0,,,,2,1,1,2
3925_1,,,,2,1,1,2
3927_0,,,,2,1,1,2
C(CC(C1C(C(CC1O)O)O)=O)=O,,,4,1,2,0,2
3927_1,,,,2,1,1,2
3929_0,,,,2,1,1,2
C(C1C(CC(C(CC1O)O)O)=O)=O,,,4,1,2,0,2
3929_1,,,,2,1,1,2
3931_0,,,,2,1,1,2
C(C1C(C(CC1(CC=O)O)O)O)=O,,,4,1,5,0,5
3931_1,,,,2,1,1,2
3933_0,,,,2,1,1,2
C(C1C(CC(CC(C1O)O)=O)O)=O,,,4,1,4,0,4
3933_1,,,,2,1,1,2
3934_0,,,,2,1,1,2
3934_1,,,,2,1,1,2
3936_0,,,,2,1,1,2
C1(C(C(CC(C1)O)O)C(C=O)O)=O,,,4,1,2,0,2
3936_1,,,,2,1,1,2
3937_0,,,,2,1,1,2
3937_1,,,,2,1,1,2
3939_0,,,,2,1,1,2
C1(CC(C(C1C(CC=O)O)O)O)=O,,,4,1,3,0,3
3939_1,,,,2,1,1,2
3941_0,,,,2,1,1,2
C(C1C(C(C(C1O)O)C(C)O)=O)=O,,,4,1,4,0,4
3941_1,,,,2,1,1,2
3943_0,,,,2,1,1,2
C(C1C(C=CC1(C(CO)O)O)O)=O,,,4,1,4,0,4
3943_1,,,,2,1,1,2
3944_0,,,,2,1,1,2
3944_1,,,,2,1,1,2
3946_0,,,,2,1,1,2
C(C1C(C(C(C1(C=C)O)O)O)O)=O,,,4,1,4,0,4
3946_1,,,,2,1,1,2
3947_0,,,,2,1,1,2
3947_1,,,,2,1,1,2
3949_0,,,,2,1,1,2
C1C(C(CC(C(C(C=1)=O)O)O)O)O,,,4,1,2,0,2
3949_1,,,,2,1,1,2
3951_0,,,,2,1,1,2
C(C1C(C(C=CC1(CO)O)O)O)=O,,,4,1,4,0,4
3951_1,,,,2,1,1,2
3952_0,,,,2,1,1,2
3952_1,,,,2,1,1,2
3954_0,,,,2,1,1,2
C(C1C(C(C(C=CC1O)O)O)O)=O,,,4,1,4,0,4
3954_1,,,,2,1,1,2
3955_0,,,,2,1,1,2
3955_1,,,,2,1,1,2
3957_0,,,,2,1,1,2
C1(C(C(C(C(C1O)O)=O)O)O)=O,,,4,1,2,0,2
3957_1,,,,2,1,1,2
3959_0,,,,2,1,1,2
C(C1(C(C(C(C1O)=O)O)O)O)=O,,,4,1,6,0,6
3959_1,,,,2,1,1,2
3961_0,,,,2,1,1,2
C1(C(C(C(C1C(CO)O)O)O)O)=O,,,4,1,6,0,6
3961_1,,,,2,1,1,2
3962_0,,,,2,1,1,2
3962_1,,,,2,1,1,2
3963_0,,,,2,1,1,2
3965_0,,,,2,1,1,2
C1(CC(C(C1)=O)O)=O,,,4,1,8,0,8
3967_0,,,,2,1,1,2
C1(C(CC(C1)O)=O)=O,,,4,1,4,0,4
3968_0,,,,2,1,1,2
3968_1,,,,2,1,1,2
3969_0,,,,2,1,1,2
3970_0,,,,2,1,1,2
3970_1,,,,2,1,1,2
3971_0,,,,2,1,1,2
3972_0,,,,2,1,1,2
3974_0,,,,2,1,1,2
C(CO)(C1C(C(CO1)O)O)=O,,,4,1,3,0,3
3974_1,,,,2,1,1,2
3975_0,,,,2,1,1,2
3975_1,,,,2,1,1,2
3976_0,,,,2,1,1,2
3978_0,,,,2,1,1,2
C(C1C(CO)(CC(O1)O)O)=O,,,4,1,3,0,3
3978_1,,,,2,1,1,2
3980_0,,,,2,1,1,2
C(CO)(C1C(O)OCC1O)=O,,,4,1,4,0,4
3980_1,,,,2,1,1,2
3981_0,,,,2,1,1,2
3981_1,,,,2,1,1,2
3983_0,,,,2,1,1,2
C(C1C(C)(C(C(O1)O)O)O)=O,,,4,1,3,0,3
3983_1,,,,2,1,1,2
3984_0,,,,2,1,1,2
3985_0,,,,2,1,1,2
3986_0,,,,2,1,1,2
3986_1,,,,2,1,1,2
3988_0,,,,2,1,1,2
C(CO)(C1COC(C1O)O)=O,,,4,1,3,0,3
3988_1,,,,2,1,1,2
3990_0,,,,2,1,1,2
C1(C(C(C(C1)=O)O)O)=O,,,4,1,5,0,5
3990_1,,,,2,1,1,2
3992_0,,,,2,1,1,2
C1(C(CC(C1O)=O)O)=O,,,4,1,3,0,3
3994_0,,,,2,1,1,2
C1C(C(C(C=1)=O)O)O,,,4,1,7,0,7
3994_1,,,,2,1,1,2
3996_0,,,,2,1,1,2
C(C1C(CO)(O)OCC1O)=O,,,4,1,3,0,3
3996_1,,,,2,1,1,2
3997_0,,,,2,1,1,2
3997_1,,,,2,1,1,2
3998_0,,,,2,1,1,2
3998_1,,,,2,1,1,2
3999_0,,,,2,1,1,2
3999_1,,,,2,1,1,2
4000_0,,,,2,1,1,2
4000_1,,,,2,1,1,2
4001_0,,,,2,1,1,2
4001_1,,,,2,1,1,2
4003_0,,,,2,1,1,2
C1(C(C(CC(C1)O)O)=O)=O,,,4,1,4,0,4
4004_0,,,,2,1,1,2
4006_0,,,,2,1,1,2
C1(C(C(C(C)(C1)O)O)=O)=O,,,4,1,3,0,3
4006_1,,,,2,1,1,2
4008_0,,,,2,1,1,2
C1(CC(C(C(C1)O)=O)O)=O,,,4,1,3,0,3
4009_0,,,,2,1,1,2
4011_0,,,,2,1,1,2
C1(C(C(C(CC1)O)O)=O)=O,,,4,1,3,0,3
4011_1,,,,2,1,1,2
4013_0,,,,2,1,1,2
C(C1CC(C(C1O)=O)O)=O,,,4,1,3,0,3
4015_0,,,,2,1,1,2
C1(C(CC(CO)(C1)O)=O)=O,,,4,1,2,0,2
4017_0,,,,2,1,1,2
C1(C(C)(C(C(C1)=O)O)O)=O,,,4,1,5,0,5
4017_1,,,,2,1,1,2
4019_0,,,,2,1,1,2
C1(C(C(C(C1CO)O)O)=O)=O,,,4,1,3,0,3
4019_1,,,,2,1,1,2
4021_0,,,,2,1,1,2
C1(C(C(C(C(C1)=O)O)O)O)=O,,,4,1,3,0,3
4021_1,,,,2,1,1,2
4023_0,,,,2,1,1,2
C1(CC(C(C(C1O)=O)O)O)=O,,,4,1,2,0,2
4024_0,,,,2,1,1,2
4024_1,,,,2,1,1,2
4026_0,,,,2,1,1,2
C1(C(C(C=CC1O)O)O)=O,,,4,1,5,0,5
4026_1,,,,2,1,1,2
4028_0,,,,2,1,1,2
C1C(CO)(C(C(C=1)=O)O)O,,,4,1,4,0,4
4028_1,,,,2,1,1,2
4030_0,,,,2,1,1,2
C1(C(C(CC1)(CO)O)O)=O,,,4,1,4,0,4
4030_1,,,,2,1,1,2
4032_0,,,,2,1,1,2
C1(CC(C(C1CO)O)O)=O,,,4,1,5,0,5
4032_1,,,,2,1,1,2
4034_0,,,,2,1,1,2
C(C1(CCC(C1O)=O)O)(O)=O,,,4,1,4,0,4
4034_1,,,,2,1,1,2
4036_0,,,,2,1,1,2
C(C1(CC(C(C1)=O)O)O)(O)=O,,,4,1,2,0,2
4038_0,,,,2,1,1,2
C(C1C(C(CC1O)O)=O)(O)=O,,,4,1,4,0,4
4038_1,,,,2,1,1,2
4040_0,,,,2,1,1,2
C(C1C(CC(C1O)O)=O)(O)=O,,,4,1,5,0,5
4040_1,,,,2,1,1,2
4042_0,,,,2,1,1,2
C(C1(C(CC(C1O)=O)O)O)(O)=O,,,4,1,3,0,3
4042_1,,,,2,1,1,2
4044_0,,,,2,1,1,2
C(C1(C(C(C(C1)=O)O)O)O)(O)=O,,,4,1,2,0,2
4046_0,,,,2,1,1,2
C1(C(C(C(C(C1)O)(CO)O)O)O)=O,,,4,1,3,0,3
4046_1,,,,2,1,1,2
4047_0,,,,2,1,1,2
4049_0,,,,2,1,1,2
C(C1C(C(CO)(C(C1O)O)O)O)=O,,,4,1,2,0,2
4049_1,,,,2,1,1,2
4051_0,,,,2,1,1,2
C(C1(C(CC(C)(C1O)O)=O)O)=O,,,4,1,3,0,3
4053_0,,,,2,1,1,2
C(C)(C1(C(CC(C1O)=O)O)O)=O,,,4,1,5,0,5
4055_0,,,,2,1,1,2
C(C1(C(C)(CC(C1O)=O)O)O)=O,,,4,1,3,0,3
4057_0,,,,2,1,1,2
C(C1(C(CC(C1(C)O)O)=O)O)=O,,,4,1,3,0,3
4059_0,,,,2,1,1,2
C1(CC(C)(C(C1(CO)O)O)O)=O,,,4,1,3,0,3
4061_0,,,,2,1,1,2
C1(C(C(CO)(C(C)(C1)O)O)O)=O,,,4,1,1,0,1
4063_0,,,,2,1,1,2
C1(CC(C(C)(C1(CO)O)O)O)=O,,,4,1,3,0,3
4064_0,,,,2,1,1,2
4066_0,,,,2,1,1,2
C1(C(C(C(C1)O)(C(C=O)O)O)O)=O,,,4,1,1,0,1
4067_0,,,,2,1,1,2
4069_0,,,,2,1,1,2
C1(C(C(C)(C(C1(CO)O)O)O)O)=O,,,4,1,6,0,6
4069_1,,,,2,1,1,2
4071_0,,,,2,1,1,2
C1(C(C(CO)(C(CO)(C1)O)O)O)=O,,,4,1,3,0,3
4073_0,,,,2,1,1,2
C1(C(C(C(C)(C1(CO)O)O)O)O)=O,,,4,1,6,0,6
4073_1,,,,2,1,1,2
4075_0,,,,2,1,1,2
C1(C(C(C(C(C1)O)=O)(CO)O)O)=O,,,4,1,5,0,5
4077_0,,,,2,1,1,2
C(C1(C(CO)(C(C(C1)=O)O)O)O)=O,,,4,1,1,0,1
4079_0,,,,2,1,1,2
C(C1(C(CC(C(C1O)O)=O)O)O)=O,,,4,1,7,0,7
4079_1,,,,2,1,1,2
4081_0,,,,2,1,1,2
C(C1(C(CC(C1O)O)=O)O)=O,,,4,1,3,0,3
4082_0,,,,2,1,1,2
4084_0,,,,2,1,1,2
C(C1(C(CC(C(C1O)O)O)=O)O)=O,,,4,1,3,0,3
4086_0,,,,2,1,1,2
C(C)(C1(C(C(C(C1O)=O)O)O)O)=O,,,4,1,4,0,4
4086_1,,,,2,1,1,2
4088_0,,,,2,1,1,2
C(C1(C(C)(C(C(C1O)=O)O)O)O)=O,,,4,1,4,0,4
4088_1,,,,2,1,1,2
4090_0,,,,2,1,1,2
C(C1(C(CC(CO)(C1O)O)=O)O)=O,,,4,1,3,0,3
4092_0,,,,2,1,1,2
C(C1(C(CC(C1(CO)O)O)=O)O)=O,,,4,1,3,0,3
4094_0,,,,2,1,1,2
C1(C(C(C(C1)O)O)(C(C=O)O)O)=O,,,4,1,5,0,5
4096_0,,,,2,1,1,2
C1(C(C(C(C1(CO)O)O)O)O)=O,,,4,1,5,0,5
4096_1,,,,2,1,1,2
4097_0,,,,2,1,1,2
4099_0,,,,2,1,1,2
C1(C(C(CO)(C(C)(C1O)O)O)O)=O,,,4,1,2,0,2
4099_1,,,,2,1,1,2
4101_0,,,,2,1,1,2
C1(CC(CO)(C(C1(CO)O)O)O)=O,,,4,1,5,0,5
4103_0,,,,2,1,1,2
C1(CC(C(CO)(C1(CO)O)O)O)=O,,,4,1,5,0,5
4105_0,,,,2,1,1,2
C1(C(C(CC(C1(CO)O)O)O)O)=O,,,4,1,6,0,6
4105_1,,,,2,1,1,2
4107_0,,,,2,1,1,2
C1(CC(CC(C1(CO)O)=O)O)=O,,,4,1,4,0,4
4109_0,,,,2,1,1,2
C1(C(CO)(C(CC(C1)=O)O)O)=O,,,4,1,6,0,6
4111_0,,,,2,1,1,2
C(C1C(C(C(C1)=O)(CO)O)O)=O,,,4,1,4,0,4
4113_0,,,,2,1,1,2
C1(C(CO)C(C(C1(CO)O)=O)O)=O,,,4,1,4,0,4
4113_1,,,,2,1,1,2
4115_0,,,,2,1,1,2
C1(CC(C(C(C1(CO)O)O)=O)O)=O,,,4,1,5,0,5
4117_0,,,,2,1,1,2
C(C1(C(C(C(C1)=O)(CO)O)O)O)=O,,,4,1,3,0,3
4119_0,,,,2,1,1,2
C(C1C(C(C(C1O)=O)(CO)O)O)=O,,,4,1,4,0,4
4119_1,,,,2,1,1,2
4120_0,,,,2,1,1,2
4120_1,,,,2,1,1,2
4122_0,,,,2,1,1,2
C1(C(C(C(C1)O)(C(C)O)O)O)=O,,,4,1,1,0,1
4124_0,,,,2,1,1,2
C1(CC(C(C1(C(C)O)O)O)O)=O,,,4,1,5,0,5
4126_0,,,,2,1,1,2
C(C1C(C(C=O)(C(C1O)O)O)O)=O,,,4,1,4,0,4
4126_1,,,,2,1,1,2
4127_0,,,,2,1,1,2
4127_1,,,,2,1,1,2
4129_0,,,,2,1,1,2
C1(CC(CC(C1(C(C)O)O)=O)O)=O,,,4,1,3,0,3
4131_0,,,,2,1,1,2
C1(C(C(CC(C1)=O)O)(C(C)O)O)=O,,,4,1,5,0,5
4133_0,,,,2,1,1,2
C(C1C(C(C(C1)=O)(C(C)O)O)O)=O,,,4,1,4,0,4
4135_0,,,,2,1,1,2
C1(CC(C(C1(C(CO)O)O)O)O)=O,,,4,1,5,0,5
4136_0,,,,2,1,1,2
4136_1,,,,2,1,1,2
4138_0,,,,2,1,1,2
C(CC1(C(CC(C1O)=O)O)O)=O,,,4,1,1,0,1
4139_0,,,,2,1,1,2
4140_0,,,,2,1,1,2
4140_1,,,,2,1,1,2
4142_0,,,,2,1,1,2
C1(C(C(C(C(C=O)O)(C1)O)O)O)=O,,,4,1,2,0,2
4142_1,,,,2,1,1,2
4144_0,,,,2,1,1,2
C1(C(C(C(C(C)O)(C1)O)O)O)=O,,,4,1,2,0,2
4144_1,,,,2,1,1,2
4146_0,,,,2,1,1,2
C1(C(C(C(CO)(CC1O)O)O)O)=O,,,4,1,2,0,2
4146_1,,,,2,1,1,2
4148_0,,,,2,1,1,2
C1(C(C(C(CC1(CO)O)O)O)O)=O,,,4,1,3,0,3
4148_1,,,,2,1,1,2
4149_0,,,,2,1,1,2
4149_1,,,,2,1,1,2
4151_0,,,,2,1,1,2
C1(C(C(CO)(CC1(CO)O)O)O)=O,,,4,1,3,0,3
4151_1,,,,2,1,1,2
4153_0,,,,2,1,1,2
C1(CC(C(CC1(CO)O)=O)O)=O,,,4,1,3,0,3
4155_0,,,,2,1,1,2
C(C1(CC(C(C1)=O)(CO)O)O)=O,,,4,1,2,0,2
4157_0,,,,2,1,1,2
C(C1C(CC(C1(CO)O)=O)O)=O,,,4,1,3,0,3
4157_1,,,,2,1,1,2
4159_0,,,,2,1,1,2
C(C1C(C(CO)(CC1O)O)=O)=O,,,4,1,3,0,3
4159_1,,,,2,1,1,2
4161_0,,,,2,1,1,2
C1(C(CC(CO)(C(C1)O)O)=O)=O,,,4,1,1,0,1
4163_0,,,,2,1,1,2
C(C1C(CC(CO)(C1O)O)=O)=O,,,4,1,2,0,2
4163_1,,,,2,1,1,2
4165_0,,,,2,1,1,2
C1(C(C(C(C(CO)(C1)O)=O)O)O)=O,,,4,1,3,0,3
4165_1,,,,2,1,1,2
4167_0,,,,2,1,1,2
C(C1(C(CO)(CC(C1O)=O)O)O)=O,,,4,1,2,0,2
4167_1,,,,2,1,1,2
4169_0,,,,2,1,1,2
C1C(CO)(C(C(C(C=1)=O)O)O)O,,,4,1,2,0,2
4169_1,,,,2,1,1,2
4170_0,,,,2,1,1,2
4170_1,,,,2,1,1,2
4171_0,,,,2,1,1,2
4171_1,,,,2,1,1,2
4173_0,,,,2,1,1,2
C(C1(CC(C(C(C1O)=O)O)O)O)=O,,,4,1,3,0,3
4173_1,,,,2,1,1,2
4175_0,,,,2,1,1,2
C1(CC(C(CC1(C(C)O)O)=O)O)=O,,,4,1,2,0,2
4177_0,,,,2,1,1,2
C(C1(CC(C(C1)=O)(C(C)O)O)O)=O,,,4,1,2,0,2
4179_0,,,,2,1,1,2
C(C1C(CC(C1(C(C)O)O)=O)O)=O,,,4,1,3,0,3
4179_1,,,,2,1,1,2
4181_0,,,,2,1,1,2
C(C1C(C(C(C)O)(CC1O)O)=O)=O,,,4,1,3,0,3
4181_1,,,,2,1,1,2
4183_0,,,,2,1,1,2
C1(C(CC(C(C(C)O)(C1)O)O)=O)=O,,,4,1,1,0,1
4185_0,,,,2,1,1,2
C(C1C(CC(C1O)(C(C)O)O)=O)=O,,,4,1,2,0,2
4185_1,,,,2,1,1,2
4187_0,,,,2,1,1,2
C1C(C(C(C(C=1)=O)O)O)(C(C)O)O,,,4,1,2,0,2
4187_1,,,,2,1,1,2
4189_0,,,,2,1,1,2
C1(C2C(C(CO2)(C1)O)O)=O,,,4,1,1,0,1
4191_0,,,,2,1,1,2
C1(C2C(CC(C1O)O2)O)=O,,,4,1,2,0,2
4191_1,,,,2,1,1,2
4193_0,,,,2,1,1,2
C1(C2CC(C(O2)O)(C1)O)=O,,,4,1,3,0,3
4195_0,,,,2,1,1,2
C1(C2CC(C1C(O2)O)O)=O,,,4,1,5,0,5
4195_1,,,,2,1,1,2
4197_0,,,,2,1,1,2
C1(CC(C(C(C1)=O)=O)O)=O,,,4,1,2,0,2
4199_0,,,,2,1,1,2
C(C1(C(CC(C1)=O)=O)O)=O,,,4,1,2,0,2
4201_0,,,,2,1,1,2
C(C1CC(C(C1O)=O)=O)=O,,,4,1,2,0,2
4203_0,,,,2,1,1,2
C1(C(CC(C(C1)=O)=O)O)=O,,,4,1,2,0,2
4205_0,,,,2,1,1,2
C(C1(CC(C(C1)=O)=O)O)=O,,,4,1,2,0,2
4207_0,,,,2,1,1,2
C(C1C(CC(C1O)=O)=O)=O,,,4,1,5,0,5
4207_1,,,,2,1,1,2
4209_0,,,,2,1,1,2
C1(C=CC(C(C1)O)=O)=O,,,4,1,3,0,3
4211_0,,,,2,1,1,2
C(C1(C=CC(C1)=O)O)=O,,,4,1,4,0,4
4213_0,,,,2,1,1,2
C(C1C=CC(C1O)=O)=O,,,4,1,2,0,2
4215_0,,,,2,1,1,2
C1C(CC(C(C=1)=O)=O)O,,,4,1,3,0,3
4217_0,,,,2,1,1,2
C(C1C(C=CC1O)=O)=O,,,4,1,6,0,6
4217_1,,,,2,1,1,2
4219_0,,,,2,1,1,2
C1(C2(CC(C1CO2)O)O)=O,,,4,1,4,0,4
4219_1,,,,2,1,1,2
4221_0,,,,2,1,1,2
C1(C2C(CC(C1)(O2)O)O)=O,,,4,1,4,0,4
4221_1,,,,2,1,1,2
4223_0,,,,2,1,1,2
C1(C2C(C(C(O2)O)(C1)O)O)=O,,,4,1,3,0,3
4225_0,,,,2,1,1,2
C1(CC2(C(C1CO2)O)O)=O,,,4,1,4,0,4
4225_1,,,,2,1,1,2
4227_0,,,,2,1,1,2
C1(CC2C(C1C(O)O2)O)=O,,,4,1,6,0,6
4227_1,,,,2,1,1,2
4229_0,,,,2,1,1,2
C1(C(C2(C(C1CO2)O)O)O)=O,,,4,1,4,0,4
4229_1,,,,2,1,1,2
4231_0,,,,2,1,1,2
C1(C(C(C(CC1)O)O)O)=O,,,4,1,3,0,3
4231_1,,,,2,1,1,2
4233_0,,,,2,1,1,2
C1(C(CC(C(C1)O)O)O)=O,,,4,1,1,0,1
4235_0,,,,2,1,1,2
C1(C=CC(C(C1O)O)=O)=O,,,4,1,3,0,3
4235_1,,,,2,1,1,2
4237_0,,,,2,1,1,2
C(C1(C=CC(C1O)=O)O)=O,,,4,1,3,0,3
4237_1,,,,2,1,1,2
4239_0,,,,2,1,1,2
C(C1C(C(CO)O)CC(C1O)=O)=O,,,4,1,2,0,2
4241_0,,,,2,1,1,2
C(C1C(C(C(CC1CO)=O)O)O)=O,,,4,1,2,0,2
4243_0,,,,2,1,1,2
C(C1CCC(C(C(C1O)O)O)=O)=O,,,4,1,2,0,2
4245_0,,,,2,1,1,2
C(CCC1C(C(C(C1O)O)O)=O)=O,,,4,1,2,0,2
4247_0,,,,2,1,1,2
C1(C(C(CC(C(C=O)O)C1)O)O)=O,,,4,1,3,0,3
4247_1,,,,2,1,1,2
4249_0,,,,2,1,1,2
C(CC1C(C(C(C(C1)=O)O)O)O)=O,,,4,1,3,0,3
4249_1,,,,2,1,1,2
4251_0,,,,2,1,1,2
C(C1C(C(C(C1O)O)O)CC=O)=O,,,4,1,3,0,3
4253_0,,,,2,2,1,3
C(C1C(C(C(C1O)O)O)=O)(O)=O,,,4,1,2,0,2
4253_1,,,,2,2,1,3
4255_0,,,,2,2,1,3
C1(C(CO)C(C(C1C(O)=O)=O)O)=O,,,4,1,2,0,2
4255_1,,,,2,2,1,3
4257_0,,,,2,2,1,3
C(C1C(C(C(C(C1)=O)O)O)=O)(O)=O,,,4,1,1,0,1
4259_0,,,,2,2,1,3
C(C1(CC(C(O)=O)C(C1O)=O)O)=O,,,4,1,1,0,1
4261_0,,,,2,2,1,3
C(C1C(C(CC(C1O)=O)O)=O)(O)=O,,,4,1,2,0,2
4261_1,,,,2,2,1,3
4263_0,,,,2,2,1,3
C1(C(CC(C=O)(C1C(O)=O)O)O)=O,,,4,1,2,0,2
4263_1,,,,2,2,1,3
4265_0,,,,2,2,1,3
C(C1C(C(C(O)=O)C(C1O)=O)O)=O,,,4,1,2,0,2
4265_1,,,,2,2,1,3
4267_0,,,,2,2,1,3
C(C1C(C(C(CO)C1O)=O)=O)(O)=O,,,4,1,2,0,2
4267_1,,,,2,2,1,3
4269_0,,,,2,2,1,3
C(C1C(CC(C(C1O)O)=O)=O)(O)=O,,,4,1,2,0,2
4269_1,,,,2,2,1,3
4271_0,,,,2,2,1,3
C1(CC(C(C(C1C(O)=O)=O)O)O)=O,,,4,1,2,0,2
4271_1,,,,2,2,1,3
4273_0,,,,2,2,1,3
C(C1C(C(C(CC1O)=O)O)=O)(O)=O,,,4,1,2,0,2
4273_1,,,,2,2,1,3
4275_0,,,,2,2,1,3
C1(C(C(C(C=O)C1C(O)=O)O)O)=O,,,4,1,1,0,1
4277_0,,,,2,2,1,3
C(C1C(C(CC(C1O)O)=O)=O)(O)=O,,,4,1,2,0,2
4277_1,,,,2,2,1,3
4279_0,,,,2,2,1,3
C(C1C(C(C=O)C(C1O)O)=O)(O)=O,,,4,1,2,0,2
4279_1,,,,2,2,1,3
4281_0,,,,2,2,1,3
C(C(C(C(C(C=O)O)O)=O)O)(O)=O,,,4,1,2,0,2
4281_1,,,,2,2,1,3
4283_0,,,,2,2,1,3
C(C(C(C(C(C)O)O)=O)O)(O)=O,,,4,1,6,0,6
4283_1,,,,2,2,1,3
4285_0,,,,2,2,1,3
C(C(C=O)C(CO)(CO)O)(O)=O,,,4,1,2,0,2
4285_1,,,,2,2,1,3
4287_0,,,,2,2,1,3
C(C(C=O)C(C(CO)O)O)(O)=O,,,4,1,2,0,2
4287_1,,,,2,2,1,3
4289_0,,,,2,2,1,3
C(C(C(C=O)=O)C(C=O)(C)O)(O)=O,,,4,1,2,0,2
4289_1,,,,2,2,1,3
4291_0,,,,2,2,1,3
C(C(C(C=O)=O)C(C=O)O)(O)=O,,,4,1,2,0,2
4291_1,,,,2,2,1,3
4293_0,,,,2,2,1,3
C(C(C(C=O)=O)C(C)(CO)O)(O)=O,,,4,1,2,0,2
4293_1,,,,2,2,1,3
4295_0,,,,2,2,1,3
C(CC(C(CC(CO)=O)O)=O)(O)=O,,,4,1,1,0,1
4297_0,,,,2,2,1,3
C(C(C(CO)=O)C(C(C)=O)O)(O)=O,,,4,1,5,0,5
4297_1,,,,2,2,1,3
4299_0,,,,2,2,1,3
C(C(C(CC(C(C)=O)O)=O)O)(O)=O,,,4,1,5,0,5
4299_1,,,,2,2,1,3
4301_0,,,,2,2,1,3
C(C(C)(C(C(O)=O)C(CO)=O)O)=O,,,4,1,5,0,5
4301_1,,,,2,2,1,3
4303_0,,,,2,2,1,3
C(C(C)(CC(C(C(O)=O)O)=O)O)=O,,,4,1,5,0,5
4303_1,,,,2,2,1,3
4305_0,,,,2,2,1,3
C(CC(C(C(C(C)=O)O)O)=O)(O)=O,,,4,1,4,0,4
4307_0,,,,2,2,1,3
C(C(C)(C(C(CC(O)=O)=O)O)O)=O,,,4,1,4,0,4
4309_0,,,,2,2,1,3
C(C(C(C(C)O)C(CCO)O)=O)=O,,,4,1,5,0,5
4309_1,,,,2,2,1,3
4311_0,,,,2,2,1,3
C(C(CO)C(C(CC(C)O)=O)O)=O,,,4,1,2,0,2
4311_1,,,,2,2,1,3
4313_0,,,,2,2,1,3
C(C(CO)C(C=O)(CC(C)O)O)=O,,,4,1,2,0,2
4313_1,,,,2,2,1,3
4314_0,,,,2,2,1,3
4314_1,,,,2,2,1,3
4316_0,,,,2,2,1,3
C(C(C=O)C(C(CC(C)O)=O)O)=O,,,4,1,2,0,2
4316_1,,,,2,2,1,3
4318_0,,,,2,2,1,3
C(C(C=O)C(C=O)(CC(C)O)O)=O,,,4,1,2,0,2
4318_1,,,,2,2,1,3
4320_0,,,,2,2,1,3
C(C(C(C=O)=O)C(C)O)(O)=O,,,4,1,2,0,2
4320_1,,,,2,2,1,3
4322_0,,,,2,2,1,3
C(C(C(C(C=O)=O)C(C)O)O)(O)=O,,,4,1,2,0,2
4322_1,,,,2,2,1,3
4324_0,,,,2,2,1,3
C(C(C(C(C)O)C(C(C)O)O)=O)=O,,,4,1,2,0,2
4324_1,,,,2,2,1,3
4326_0,,,,2,2,1,3
C(CC(C(CC(CCO)O)=O)O)=O,,,4,1,3,0,3
4328_0,,,,2,2,1,3
C(C(C(CCO)O)C(C(C)=O)O)=O,,,4,1,2,0,2
4328_1,,,,2,2,1,3
4330_0,,,,2,2,1,3
C(C(CO)C(C)(C(CC=O)O)O)=O,,,4,1,2,0,2
4330_1,,,,2,2,1,3
4332_0,,,,2,2,1,3
C(C(CO)C(CC(C(C)=O)O)O)=O,,,4,1,2,0,2
4332_1,,,,2,2,1,3
4333_0,,,,2,2,1,3
4335_0,,,,2,2,1,3
C(CC(C(C=O)C(C(C)=O)O)O)=O,,,4,1,2,0,2
4335_1,,,,2,2,1,3
4337_0,,,,2,2,1,3
C(C(C=O)C(C)(C(CC=O)O)O)=O,,,4,1,2,0,2
4337_1,,,,2,2,1,3
4339_0,,,,2,2,1,3
C(C(C=O)C(CC(C(C)=O)O)O)=O,,,4,1,2,0,2
4339_1,,,,2,2,1,3
4340_0,,,,2,2,1,3
4342_0,,,,2,2,1,3
C(C(C=O)C(C(C)=O)O)(O)=O,,,4,1,2,0,2
4342_1,,,,2,2,1,3
4344_0,,,,2,2,1,3
C(C(CC(C(CC=O)O)=O)O)(O)=O,,,4,1,1,0,1
4346_0,,,,2,2,1,3
C(C(C(C=O)C(C(C)=O)O)O)(O)=O,,,4,1,6,0,6
4346_1,,,,2,2,1,3
4348_0,,,,2,2,1,3
C(CC(C(CC(C(C)O)O)=O)O)=O,,,4,1,1,0,1
4350_0,,,,2,2,1,3
C(C(C(C(C)O)O)C(C(C)=O)O)=O,,,4,1,2,0,2
4350_1,,,,2,2,1,3
4352_0,,,,2,2,1,3
C(C(C(CCO)O)C(C=O)(C)O)=O,,,4,1,2,0,2
4352_1,,,,2,2,1,3
4354_0,,,,2,2,1,3
C(C(CO)C(C(C)(CC=O)O)O)=O,,,4,1,2,0,2
4354_1,,,,2,2,1,3
4356_0,,,,2,2,1,3
C(C(CO)C(CC(C=O)(C)O)O)=O,,,4,1,2,0,2
4356_1,,,,2,2,1,3
4358_0,,,,2,2,1,3
C(CC(C(C=O)C(C=O)(C)O)O)=O,,,4,1,2,0,2
4358_1,,,,2,2,1,3
4360_0,,,,2,2,1,3
C(C(C=O)C(C(C)(CC=O)O)O)=O,,,4,1,2,0,2
4360_1,,,,2,2,1,3
4362_0,,,,2,2,1,3
C(C(C=O)C(CC(C=O)(C)O)O)=O,,,4,1,2,0,2
4362_1,,,,2,2,1,3
4364_0,,,,2,2,1,3
C(C(C=O)C(C=O)(C)O)(O)=O,,,4,1,2,0,2
4364_1,,,,2,2,1,3
4366_0,,,,2,2,1,3
C(C(C(C=O)C(C=O)(C)O)O)(O)=O,,,4,1,6,0,6
4366_1,,,,2,2,1,3
4368_0,,,,2,2,1,3
C(C(C(C(C)O)O)C(C=O)(C)O)=O,,,4,1,2,0,2
4368_1,,,,2,2,1,3
4370_0,,,,2,2,1,3
C(C(C(C(C(O)=O)O)=O)CO)=O,,,4,1,2,0,2
4370_1,,,,2,2,1,3
4372_0,,,,2,2,1,3
C(C(C=O)C(C(CO)O)=O)(O)=O,,,4,1,2,0,2
4372_1,,,,2,2,1,3
4374_0,,,,2,2,1,3
C(C(C(C(C(O)=O)O)=O)C(C)O)=O,,,4,1,2,0,2
4374_1,,,,2,2,1,3
4376_0,,,,2,2,1,3
C(C(C=O)C(C(C(C)O)O)=O)(O)=O,,,4,1,2,0,2
4376_1,,,,2,2,1,3
4378_0,,,,2,2,1,3
C(CC(C(C(O)=O)C(CO)=O)O)=O,,,4,1,4,0,4
4378_1,,,,2,2,1,3
4380_0,,,,2,2,1,3
C(C(C(CC(CC=O)O)=O)O)(O)=O,,,4,1,3,0,3
4380_1,,,,2,2,1,3
4382_0,,,,2,2,1,3
C(C(C=O)C(CC(CO)=O)O)(O)=O,,,4,1,2,0,2
4382_1,,,,2,2,1,3
4384_0,,,,2,2,1,3
C(C(C=O)C(CO)(CC=O)O)(O)=O,,,4,1,2,0,2
4384_1,,,,2,2,1,3
4386_0,,,,2,2,1,3
C(C(C(C(C=O)O)=O)CO)(O)=O,,,4,1,2,0,2
4386_1,,,,2,2,1,3
4388_0,,,,2,2,1,3
C(C(C(C(C=O)O)=O)C(C)O)(O)=O,,,4,1,2,0,2
4388_1,,,,2,2,1,3
4390_0,,,,2,2,1,3
C(CC(C(C(CC(O)=O)=O)O)O)=O,,,4,1,3,0,3
4392_0,,,,2,2,1,3
C(C(C=O)C(C(C(C)=O)O)O)(O)=O,,,4,1,2,0,2
4392_1,,,,2,2,1,3
4394_0,,,,2,2,1,3
C(C(C=O)C(C)(C(C=O)O)O)(O)=O,,,4,1,2,0,2
4394_1,,,,2,2,1,3
4396_0,,,,2,2,1,3
C(C(C(C(CO)O)=O)CO)(O)=O,,,4,1,2,0,2
4396_1,,,,2,2,1,3
4398_0,,,,2,2,1,3
C(C(C(C(CO)O)=O)C(C)O)(O)=O,,,4,1,2,0,2
4398_1,,,,2,2,1,3
4400_0,,,,2,2,1,3
C(C(C=O)C(C)(C(CO)O)O)(O)=O,,,4,1,2,0,2
4400_1,,,,2,2,1,3
4402_0,,,,2,2,1,3
C(C(C(C(CO)CO)=O)O)(O)=O,,,4,1,2,0,2
4402_1,,,,2,2,1,3
4404_0,,,,2,2,1,3
C(C(CO)C(CCO)O)=O,,,4,1,2,0,2
4404_1,,,,2,2,1,3
4406_0,,,,2,2,1,3
C(C(CO)C(CO)(CC(C)O)O)=O,,,4,1,2,0,2
4406_1,,,,2,2,1,3
4408_0,,,,2,2,1,3
C(CO)(C(C(C)O)C(CCO)O)=O,,,4,1,2,0,2
4408_1,,,,2,2,1,3
4410_0,,,,2,2,1,3
C(C(C(CCO)O)O)(CC(C)O)=O,,,4,1,2,0,2
4410_1,,,,2,2,1,3
4412_0,,,,2,2,1,3
C(C(CO)C(C)(C(C(C)O)O)O)=O,,,4,1,2,0,2
4412_1,,,,2,2,1,3
4414_0,,,,2,2,1,3
C(C(C(C)O)O)(CC(CCO)O)=O,,,4,1,1,0,1
4416_0,,,,2,2,1,3
C(C(CO)C(CC(C)(CO)O)O)=O,,,4,1,2,0,2
4416_1,,,,2,2,1,3
4418_0,,,,2,2,1,3
C(C(C(CCO)O)C(C)(CO)O)=O,,,4,1,2,0,2
4418_1,,,,2,2,1,3
4420_0,,,,2,2,1,3
C(C(CO)C(CC(C)O)O)=O,,,4,1,2,0,2
4420_1,,,,2,2,1,3
4422_0,,,,2,2,1,3
C(C(C(C)O)C(CCO)O)=O,,,4,1,2,0,2
4422_1,,,,2,2,1,3
4424_0,,,,2,2,1,3
C(C(CO)C(C(C(C)O)O)O)=O,,,4,1,2,0,2
4424_1,,,,2,2,1,3
4426_0,,,,2,2,1,3
C(C(CO)C(CC(CO)O)O)=O,,,4,1,2,0,2
4426_1,,,,2,2,1,3
4428_0,,,,2,2,1,3
C(C(C(CO)O)C(CCO)O)=O,,,4,1,2,0,2
4428_1,,,,2,2,1,3
4430_0,,,,2,2,1,3
C(C(CO)C(C(C)=O)(CO)O)=O,,,4,1,3,0,3
4430_1,,,,2,2,1,3
4432_0,,,,2,2,1,3
C(C(CO)C(C(CO)=O)(C)O)=O,,,4,1,2,0,2
4432_1,,,,2,2,1,3
4434_0,,,,2,2,1,3
C(C(C)=O)(C(C(CCO)O)O)=O,,,4,1,2,0,2
4434_1,,,,2,2,1,3
4436_0,,,,2,2,1,3
C(C(CO)=O)(CC(CCO)O)=O,,,4,1,1,0,1
4438_0,,,,2,2,1,3
C(C(CO)C(C(C(C)O)=O)O)=O,,,4,1,2,0,2
4438_1,,,,2,2,1,3
4440_0,,,,2,2,1,3
C(C(CO)C(C=O)(C(C)O)O)=O,,,4,1,5,0,5
4440_1,,,,2,2,1,3
4442_0,,,,2,2,1,3
C(C(CO)C(CO)(C(C)O)O)=O,,,4,1,2,0,2
4442_1,,,,2,2,1,3
4444_0,,,,2,2,1,3
C(C(C(CCO)O)O)(C(C)O)=O,,,4,1,2,0,2
4444_1,,,,2,2,1,3
4446_0,,,,2,2,1,3
C(C(CO)C(CC=O)O)=O,,,4,1,2,0,2
4446_1,,,,2,2,1,3
4448_0,,,,2,2,1,3
C(C(C=O)C(CCO)O)=O,,,4,1,2,0,2
4448_1,,,,2,2,1,3
4450_0,,,,2,2,1,3
C(C(CO)C(CO)(C(C=O)O)O)=O,,,4,1,6,0,6
4450_1,,,,2,2,1,3
4451_0,,,,2,2,1,3
4451_1,,,,2,2,1,3
4453_0,,,,2,2,1,3
C(C(C(C(C(CCO)O)O)=O)O)=O,,,4,1,3,0,3
4453_1,,,,2,2,1,3
4455_0,,,,2,2,1,3
C(C(CO)C(C(CCO)O)O)=O,,,4,1,2,0,2
4455_1,,,,2,2,1,3
4457_0,,,,2,2,1,3
C(C(CO)C(C(O)=O)(C)O)=O,,,4,1,2,0,2
4457_1,,,,2,2,1,3
4459_0,,,,2,2,1,3
C(C(CC(CCO)O)=O)(O)=O,,,4,1,5,0,5
4461_0,,,,2,2,1,3
C(C(C=O)CO)(O)=O,,,4,1,2,0,2
4461_1,,,,2,2,1,3
4463_0,,,,2,2,1,3
C(C(CO)C(CO)(CC(O)=O)O)=O,,,4,1,2,0,2
4463_1,,,,2,2,1,3
4465_0,,,,2,2,1,3
C(C(C(CO)=O)C(CCO)O)(O)=O,,,4,1,2,0,2
4465_1,,,,2,2,1,3
4467_0,,,,2,2,1,3
C(CC(C(C(CCO)O)O)=O)(O)=O,,,4,1,2,0,2
4467_1,,,,2,2,1,3
4469_0,,,,2,2,1,3
C(C(CO)C(C)(C(C(O)=O)O)O)=O,,,4,1,2,0,2
4469_1,,,,2,2,1,3
4471_0,,,,2,2,1,3
C(C(C(CC(CCO)O)=O)O)(O)=O,,,4,1,1,0,1
4473_0,,,,2,2,1,3
C(C(CO)C(C(O)=O)O)=O,,,4,1,7,0,7
4473_1,,,,2,2,1,3
4475_0,,,,2,2,1,3
C(C(CO)C(C(C(O)=O)O)O)=O,,,4,1,2,0,2
4475_1,,,,2,2,1,3
4477_0,,,,2,2,1,3
C(C(CO)C(C(CC(O)=O)O)O)=O,,,4,1,2,0,2
4477_1,,,,2,2,1,3
4479_0,,,,2,2,1,3
C(C(CO)C(C(O)=O)(CO)O)=O,,,4,1,2,0,2
4479_1,,,,2,2,1,3
4481_0,,,,2,2,1,3
C(C(C(C(CCO)O)O)=O)(O)=O,,,4,1,7,0,7
4481_1,,,,2,2,1,3
4483_0,,,,2,2,1,3
C(C(CO)C(C(CC(C)=O)=O)O)=O,,,4,1,2,0,2
4483_1,,,,2,2,1,3
4485_0,,,,2,2,1,3
C(CC(C=O)(C(C=O)CO)O)(C)=O,,,4,1,2,0,2
4485_1,,,,2,2,1,3
4487_0,,,,2,2,1,3
C(C(CO)C(C)(CC(C=O)=O)O)=O,,,4,1,2,0,2
4487_1,,,,2,2,1,3
4489_0,,,,2,2,1,3
C(C)(C(C(C=O)=O)C(CCO)O)=O,,,4,1,2,0,2
4489_1,,,,2,2,1,3
4491_0,,,,2,2,1,3
C(CC(CCO)O)(CC(C=O)=O)=O,,,4,1,1,0,1
4492_0,,,,2,2,1,3
4492_1,,,,2,2,1,3
4494_0,,,,2,2,1,3
C(CC(C=O)(C(C=O)CO)O)=O,,,4,1,3,0,3
4494_1,,,,2,2,1,3
4495_0,,,,2,2,1,3
4495_1,,,,2,2,1,3
4497_0,,,,2,2,1,3
C(C(C(C=O)=O)C(CCO)O)=O,,,4,1,2,0,2
4497_1,,,,2,2,1,3
4499_0,,,,2,2,1,3
C(C(CO)C(CC(C(C)=O)=O)O)=O,,,4,1,2,0,2
4499_1,,,,2,2,1,3
4501_0,,,,2,2,1,3
C(CC(C(C)=O)(C(C=O)CO)O)=O,,,4,1,2,0,2
4501_1,,,,2,2,1,3
4503_0,,,,2,2,1,3
C(C(CO)C(C(CC=O)=O)(C)O)=O,,,4,1,2,0,2
4503_1,,,,2,2,1,3
4505_0,,,,2,2,1,3
C(C(C(C(C)=O)=O)C(CCO)O)=O,,,4,1,2,0,2
4505_1,,,,2,2,1,3
4507_0,,,,2,2,1,3
C(CC(C(CC(CCO)O)=O)=O)=O,,,4,1,1,0,1
4509_0,,,,2,2,1,3
C(C(CO)C(C(C)=O)(C)O)=O,,,4,1,2,0,2
4509_1,,,,2,2,1,3
4511_0,,,,2,2,1,3
C(C(C)=O)(CC(CCO)O)=O,,,4,1,1,0,1
4513_0,,,,2,2,1,3
C(C(CO)C(C)(CC=O)O)=O,,,4,1,2,0,2
4513_1,,,,2,2,1,3
4515_0,,,,2,2,1,3
C(C(CO)C(CC(C)=O)O)=O,,,4,1,2,0,2
4515_1,,,,2,2,1,3
4517_0,,,,2,2,1,3
C(CC(CC(CCO)O)=O)=O,,,4,1,1,0,1
4519_0,,,,2,2,1,3
C(C(C(C)=O)C(CCO)O)=O,,,4,1,2,0,2
4519_1,,,,2,2,1,3
4521_0,,,,2,2,1,3
C(C(CO)C1(COC(C1)O)O)=O,,,4,1,2,0,2
4521_1,,,,2,2,1,3
4523_0,,,,2,2,1,3
C1(COC(C1C(CCO)O)O)=O,,,4,1,2,0,2
4523_1,,,,2,2,1,3
4525_0,,,,2,2,1,3
C1(C(C(CCO)O)OC(C1)O)=O,,,4,1,2,0,2
4525_1,,,,2,2,1,3
4527_0,,,,2,2,1,3
C(C(CO)C(C)(CCO)O)=O,,,4,1,2,0,2
4527_1,,,,2,2,1,3
4529_0,,,,2,2,1,3
C(CC(CCO)O)(CCO)=O,,,4,1,1,0,1
4531_0,,,,2,2,1,3
C(C)(C(CO)C(CCO)O)=O,,,4,1,2,0,2
4531_1,,,,2,2,1,3
4532_0,,,,2,2,1,3
4532_1,,,,2,2,1,3
4534_0,,,,2,2,1,3
C(C(C(CCO)O)C(C(O)=O)O)=O,,,4,1,2,0,2
4534_1,,,,2,2,1,3
4536_0,,,,2,2,1,3
C(C(CO)C(C(C(C)=O)=O)O)=O,,,4,1,6,0,6
4536_1,,,,2,2,1,3
4538_0,,,,2,2,1,3
C(C(CO)C(C=O)(C(C)=O)O)=O,,,4,1,3,0,3
4538_1,,,,2,2,1,3
4540_0,,,,2,2,1,3
C(C(CO)C(C(C=O)=O)(C)O)=O,,,4,1,2,0,2
4540_1,,,,2,2,1,3
4542_0,,,,2,2,1,3
C(C(C(CC(CCO)O)=O)=O)=O,,,4,1,1,0,1
4544_0,,,,2,2,1,3
C(C(CO)C(C(C=O)=O)O)=O,,,4,1,3,0,3
4544_1,,,,2,2,1,3
4546_0,,,,2,2,1,3
C(C(C=O)(C(C=O)CO)O)=O,,,4,1,3,0,3
4546_1,,,,2,2,1,3
4548_0,,,,2,2,1,3
C(C(CO)C(C(C(C=O)O)=O)O)=O,,,4,1,5,0,5
4548_1,,,,2,2,1,3
4550_0,,,,2,2,1,3
C(C(C(C=O)(C(C=O)CO)O)O)=O,,,4,1,5,0,5
4550_1,,,,2,2,1,3
4551_0,,,,2,2,1,3
4551_1,,,,2,2,1,3
4553_0,,,,2,2,1,3
C(C(CO)C(C=CC(CO)=O)O)=O,,,4,1,2,0,2
4553_1,,,,2,2,1,3
4555_0,,,,2,2,1,3
C(C(CO)C(C=CC=O)(CO)O)=O,,,4,1,2,0,2
4555_1,,,,2,2,1,3
4557_0,,,,2,2,1,3
C(C=CC(C(C(CCO)O)O)=O)=O,,,4,1,2,0,2
4557_1,,,,2,2,1,3
4559_0,,,,2,2,1,3
C(C(CO)C(C(C=C)=O)O)=O,,,4,1,2,0,2
4559_1,,,,2,2,1,3
4561_0,,,,2,2,1,3
C(C(C=C)(C(C=O)CO)O)=O,,,4,1,2,0,2
4561_1,,,,2,2,1,3
4563_0,,,,2,2,1,3
C(C(CO)C(C=C)(CO)O)=O,,,4,1,2,0,2
4563_1,,,,2,2,1,3
4565_0,,,,2,2,1,3
C=CC(C(C(CCO)O)O)=O,,,4,1,2,0,2
4565_1,,,,2,2,1,3
4567_0,,,,2,2,1,3
C(C(CO)C(C=CC=O)O)=O,,,4,1,2,0,2
4567_1,,,,2,2,1,3
4569_0,,,,2,2,1,3
C(C(CO)C(C(C)O)O)=O,,,4,1,2,0,2
4569_1,,,,2,2,1,3
4571_0,,,,2,2,1,3
C(C(CO)C(C(O)=O)(CCO)O)=O,,,4,1,5,0,5
4571_1,,,,2,2,1,3
4573_0,,,,2,2,1,3
C(C(C(CO)C(CCO)O)=O)(O)=O,,,4,1,2,0,2
4573_1,,,,2,2,1,3
4575_0,,,,2,2,1,3
C(C(CO)C(C(CO)(CO)O)O)=O,,,4,1,2,0,2
4575_1,,,,2,2,1,3
4577_0,,,,2,2,1,3
C(C(CO)C(C(C=O)(CO)O)O)=O,,,4,1,2,0,2
4577_1,,,,2,2,1,3
4579_0,,,,2,2,1,3
C(C(CO)C1(COCC1O)O)=O,,,4,1,2,0,2
4579_1,,,,2,2,1,3
4581_0,,,,2,2,1,3
C1(C(C(CCO)O)OCC1O)=O,,,4,1,2,0,2
4581_1,,,,2,2,1,3
4583_0,,,,2,2,1,3
C(C(CO)C1(C(O)OCC1)O)=O,,,4,1,2,0,2
4583_1,,,,2,2,1,3
4585_0,,,,2,2,1,3
C1(C(O)OCC1C(CCO)O)=O,,,4,1,2,0,2
4585_1,,,,2,2,1,3
4587_0,,,,2,2,1,3
C(C(CO)C1(C(O)OCC1O)O)=O,,,4,1,2,0,2
4587_1,,,,2,2,1,3
4589_0,,,,2,2,1,3
C(CC(C(C(C(O)=O)CO)=O)O)=O,,,4,1,5,0,5
4589_1,,,,2,2,1,3
4591_0,,,,2,2,1,3
C(C(C=O)C(C(CCO)=O)O)(O)=O,,,4,1,2,0,2
4591_1,,,,2,2,1,3
4593_0,,,,2,2,1,3
C(C(C=O)C(C=O)(CCO)O)(O)=O,,,4,1,2,0,2
4593_1,,,,2,2,1,3
4595_0,,,,2,2,1,3
C(C(C(C(C(C)O)O)=O)CO)(O)=O,,,4,1,2,0,2
4595_1,,,,2,2,1,3
4597_0,,,,2,2,1,3
C(C(C(C(CO)C(C)O)=O)O)(O)=O,,,4,1,2,0,2
4597_1,,,,2,2,1,3
4599_0,,,,2,2,1,3
C(C(C=O)C(CO)(CCO)O)(O)=O,,,4,1,2,0,2
4599_1,,,,2,2,1,3
4601_0,,,,2,2,1,3
C(C(C=O)C(C(C=O)O)O)(O)=O,,,4,1,2,0,2
4601_1,,,,2,2,1,3
4603_0,,,,2,2,1,3
C(C(C(CO)=O)C(CO)(C)O)(O)=O,,,4,1,5,0,5
4603_1,,,,2,2,1,3
4605_0,,,,2,2,1,3
C(C(C(CC(CO)(C)O)=O)O)(O)=O,,,4,1,5,0,5
4605_1,,,,2,2,1,3
4607_0,,,,2,2,1,3
C(CC(C(C(CO)(C)O)O)=O)(O)=O,,,4,1,4,0,4
4609_0,,,,2,2,1,3
C(CC(C(C(CO)=O)C(C)O)O)=O,,,4,1,6,0,6
4609_1,,,,2,2,1,3
4611_0,,,,2,2,1,3
C(CC(C(C(CC(C)O)=O)O)O)=O,,,4,1,4,0,4
4611_1,,,,2,2,1,3
4613_0,,,,2,2,1,3
C(C(C=O)C(CO)(CC(C)O)O)=O,,,4,1,2,0,2
4613_1,,,,2,2,1,3
4615_0,,,,2,2,1,3
C(C(C(CO)=O)C(C)O)(O)=O,,,4,1,6,0,6
4615_1,,,,2,2,1,3
4617_0,,,,2,2,1,3
C(C(C(CC(C)O)=O)O)(O)=O,,,4,1,5,0,5
4617_1,,,,2,2,1,3
4619_0,,,,2,2,1,3
C(CO)(C(C(C)O)C(C(O)=O)O)=O,,,4,1,6,0,6
4619_1,,,,2,2,1,3
4621_0,,,,2,2,1,3
C(C(C(C(O)=O)O)O)(CC(C)O)=O,,,4,1,6,0,6
4621_1,,,,2,2,1,3
4623_0,,,,2,2,1,3
C(CO)(C(C(C)O)C(C(C)O)O)=O,,,4,1,2,0,2
4623_1,,,,2,2,1,3
4625_0,,,,2,2,1,3
C(C(C(C(C)O)O)O)(CC(C)O)=O,,,4,1,2,0,2
4625_1,,,,2,2,1,3
4627_0,,,,2,2,1,3
C(CC(CC(C(C(C)O)O)=O)O)=O,,,4,1,4,0,4
4629_0,,,,2,2,1,3
C(C(C=O)C(C)(C(C(C)O)O)O)=O,,,4,1,2,0,2
4629_1,,,,2,2,1,3
4631_0,,,,2,2,1,3
C(CC(C(C(C)O)O)=O)(O)=O,,,4,1,4,0,4
4633_0,,,,2,2,1,3
C(CC(C(O)=O)O)(C(C(C)O)O)=O,,,4,1,5,0,5
4635_0,,,,2,2,1,3
C(C(C(C)O)O)(CC(C(C)O)O)=O,,,4,1,1,0,1
4637_0,,,,2,2,1,3
C(C(C(CC=O)O)C(C)(CO)O)=O,,,4,1,2,0,2
4637_1,,,,2,2,1,3
4639_0,,,,2,2,1,3
C(C(C=O)C(CC(C)(CO)O)O)=O,,,4,1,2,0,2
4639_1,,,,2,2,1,3
4641_0,,,,2,2,1,3
C(C(C=O)C(C)(CO)O)(O)=O,,,4,1,2,0,2
4641_1,,,,2,2,1,3
4643_0,,,,2,2,1,3
C(C(C(CO)(C)O)C(C(O)=O)O)=O,,,4,1,6,0,6
4643_1,,,,2,2,1,3
4645_0,,,,2,2,1,3
C(C(C(C(C)O)O)C(C)(CO)O)=O,,,4,1,2,0,2
4645_1,,,,2,2,1,3
4647_0,,,,2,2,1,3
C(C(C=O)C(C(CC=O)O)O)(O)=O,,,4,1,2,0,2
4647_1,,,,2,2,1,3
4649_0,,,,2,2,1,3
C(C(C=O)C(CC(C=O)O)O)(O)=O,,,4,1,2,0,2
4649_1,,,,2,2,1,3
4651_0,,,,2,2,1,3
C(C(C(C)O)C(CC(C)O)O)=O,,,4,1,2,0,2
4651_1,,,,2,2,1,3
4653_0,,,,2,2,1,3
C(C(C(C)O)C(C(C(C)O)O)O)=O,,,4,1,2,0,2
4653_1,,,,2,2,1,3
4655_0,,,,2,2,1,3
C(C(C(C)O)C(CC(CO)O)O)=O,,,4,1,2,0,2
4655_1,,,,2,2,1,3
4657_0,,,,2,2,1,3
C(C(C(CO)O)C(CC(C)O)O)=O,,,4,1,2,0,2
4657_1,,,,2,2,1,3
4659_0,,,,2,2,1,3
C(C(C(C)O)C(C(C)=O)(CO)O)=O,,,4,1,2,0,2
4659_1,,,,2,2,1,3
4661_0,,,,2,2,1,3
C(C(C(C)O)C(C(CO)=O)(C)O)=O,,,4,1,2,0,2
4661_1,,,,2,2,1,3
4663_0,,,,2,2,1,3
C(C(C)=O)(C(C(CC(C)O)O)O)=O,,,4,1,2,0,2
4663_1,,,,2,2,1,3
4665_0,,,,2,2,1,3
C(C(CO)=O)(CC(CC(C)O)O)=O,,,4,1,1,0,1
4667_0,,,,2,2,1,3
C(C(C(C)O)C(C(C(C)O)=O)O)=O,,,4,1,2,0,2
4667_1,,,,2,2,1,3
4669_0,,,,2,2,1,3
C(C(C(C)O)C(C=O)(C(C)O)O)=O,,,4,1,5,0,5
4669_1,,,,2,2,1,3
4671_0,,,,2,2,1,3
C(C(C(C)O)C(CO)(C(C)O)O)=O,,,4,1,2,0,2
4671_1,,,,2,2,1,3
4673_0,,,,2,2,1,3
C(C(C(CC(C)O)O)O)(C(C)O)=O,,,4,1,2,0,2
4673_1,,,,2,2,1,3
4675_0,,,,2,2,1,3
C(C(C(CC=O)O)C(C)O)=O,,,4,1,2,0,2
4675_1,,,,2,2,1,3
4677_0,,,,2,2,1,3
C(C(C=O)C(CC(C)O)O)=O,,,4,1,2,0,2
4677_1,,,,2,2,1,3
4679_0,,,,2,2,1,3
C(C(C(C(CCO)O)O)C(C)O)=O,,,4,1,2,0,2
4679_1,,,,2,2,1,3
4681_0,,,,2,2,1,3
C(C(C(C)O)C(C(O)=O)(C)O)=O,,,4,1,2,0,2
4681_1,,,,2,2,1,3
4683_0,,,,2,2,1,3
C(C(CC(CC(C)O)O)=O)(O)=O,,,4,1,1,0,1
4685_0,,,,2,2,1,3
C(C(C=O)C(C)O)(O)=O,,,4,1,2,0,2
4685_1,,,,2,2,1,3
4687_0,,,,2,2,1,3
C(C(C(C)O)C(C(O)=O)O)=O,,,4,1,6,0,6
4687_1,,,,2,2,1,3
4689_0,,,,2,2,1,3
C(C(C(C(C(O)=O)O)O)C(C)O)=O,,,4,1,2,0,2
4689_1,,,,2,2,1,3
4691_0,,,,2,2,1,3
C(C(C(C)O)C(C(O)=O)(CO)O)=O,,,4,1,2,0,2
4691_1,,,,2,2,1,3
4693_0,,,,2,2,1,3
C(C(C(C(CC(C)O)O)O)=O)(O)=O,,,4,1,2,0,2
4693_1,,,,2,2,1,3
4694_0,,,,2,2,1,3
4694_1,,,,2,2,1,3
4696_0,,,,2,2,1,3
C(CC(C=O)(C(C=O)C(C)O)O)=O,,,4,1,2,0,2
4696_1,,,,2,2,1,3
4697_0,,,,2,2,1,3
4697_1,,,,2,2,1,3
4699_0,,,,2,2,1,3
C(C(C(C=O)=O)C(CC(C)O)O)=O,,,4,1,2,0,2
4699_1,,,,2,2,1,3
4701_0,,,,2,2,1,3
C(C(C(C)O)C(C(C)=O)(C)O)=O,,,4,1,2,0,2
4701_1,,,,2,2,1,3
4703_0,,,,2,2,1,3
C(C(C)=O)(CC(CC(C)O)O)=O,,,4,1,1,0,1
4705_0,,,,2,2,1,3
C(C(C(C)O)C(C)(CC=O)O)=O,,,4,1,2,0,2
4705_1,,,,2,2,1,3
4707_0,,,,2,2,1,3
C(C(C(CC(C)=O)O)C(C)O)=O,,,4,1,2,0,2
4707_1,,,,2,2,1,3
4709_0,,,,2,2,1,3
C(CC(CC(CC(C)O)O)=O)=O,,,4,1,1,0,1
4711_0,,,,2,2,1,3
C(C(C(C)=O)C(CC(C)O)O)=O,,,4,1,2,0,2
4711_1,,,,2,2,1,3
4713_0,,,,2,2,1,3
C(C(C(C)O)C1(COC(C1)O)O)=O,,,4,1,2,0,2
4713_1,,,,2,2,1,3
4715_0,,,,2,2,1,3
C1(COC(C1C(CC(C)O)O)O)=O,,,4,1,2,0,2
4715_1,,,,2,2,1,3
4717_0,,,,2,2,1,3
C1(C(C(CC(C)O)O)OC(C1)O)=O,,,4,1,2,0,2
4717_1,,,,2,2,1,3
4719_0,,,,2,2,1,3
C(C(C(C)O)C(C)(CCO)O)=O,,,4,1,2,0,2
4719_1,,,,2,2,1,3
4721_0,,,,2,2,1,3
C(CC(CC(C)O)O)(CCO)=O,,,4,1,1,0,1
4723_0,,,,2,2,1,3
C(C)(C(CO)C(CC(C)O)O)=O,,,4,1,2,0,2
4723_1,,,,2,2,1,3
4725_0,,,,2,2,1,3
C(C(C(C)O)C(C(C(C)=O)=O)O)=O,,,4,1,5,0,5
4725_1,,,,2,2,1,3
4727_0,,,,2,2,1,3
C(C(C(C)O)C(C=O)(C(C)=O)O)=O,,,4,1,2,0,2
4727_1,,,,2,2,1,3
4729_0,,,,2,2,1,3
C(C(C(C)O)C(C(C=O)=O)(C)O)=O,,,4,1,2,0,2
4729_1,,,,2,2,1,3
4731_0,,,,2,2,1,3
C(C(C(CC(CC(C)O)O)=O)=O)=O,,,4,1,1,0,1
4733_0,,,,2,2,1,3
C(C(C(C)O)C(C(C=O)=O)O)=O,,,4,1,2,0,2
4733_1,,,,2,2,1,3
4735_0,,,,2,2,1,3
C(C(C=O)(C(C=O)C(C)O)O)=O,,,4,1,2,0,2
4735_1,,,,2,2,1,3
4737_0,,,,2,2,1,3
C(C(C(C)O)C(C(C=C)=O)O)=O,,,4,1,2,0,2
4737_1,,,,2,2,1,3
4739_0,,,,2,2,1,3
C(C(C=C)(C(C=O)C(C)O)O)=O,,,4,1,2,0,2
4739_1,,,,2,2,1,3
4741_0,,,,2,2,1,3
C(C(C(C)O)C(C=C)(CO)O)=O,,,4,1,2,0,2
4741_1,,,,2,2,1,3
4743_0,,,,2,2,1,3
C=CC(C(C(CC(C)O)O)O)=O,,,4,1,2,0,2
4743_1,,,,2,2,1,3
4745_0,,,,2,2,1,3
C(C(C(C)O)C(C=CC=O)O)=O,,,4,1,2,0,2
4745_1,,,,2,2,1,3
4747_0,,,,2,2,1,3
C(C(C(C)O)C(C(C)O)O)=O,,,4,1,2,0,2
4747_1,,,,2,2,1,3
4749_0,,,,2,2,1,3
C(C(C(C)O)C1(COCC1O)O)=O,,,4,1,2,0,2
4749_1,,,,2,2,1,3
4751_0,,,,2,2,1,3
C1(C(C(CC(C)O)O)OCC1O)=O,,,4,1,2,0,2
4751_1,,,,2,2,1,3
4753_0,,,,2,2,1,3
C(C(C(C)O)C1(C(O)OCC1)O)=O,,,4,1,2,0,2
4753_1,,,,2,2,1,3
4755_0,,,,2,2,1,3
C1(C(O)OCC1C(CC(C)O)O)=O,,,4,1,2,0,2
4755_1,,,,2,2,1,3
4757_0,,,,2,2,1,3
C(C(C=O)C(C(CO)=O)O)(O)=O,,,4,1,2,0,2
4757_1,,,,2,2,1,3
4759_0,,,,2,2,1,3
C(C(C(C(CC=O)O)=O)O)(O)=O,,,4,1,6,0,6
4759_1,,,,2,2,1,3
4761_0,,,,2,2,1,3
C(C(C=O)C(C=O)(CO)O)(O)=O,,,4,1,2,0,2
4761_1,,,,2,2,1,3
4762_0,,,,2,2,1,3
4762_1,,,,2,2,1,3
4764_0,,,,2,2,1,3
C(C(C(C=O)=O)C(CO)O)(O)=O,,,4,1,3,0,3
4764_1,,,,2,2,1,3
4766_0,,,,2,2,1,3
C(C(C(CO)=O)C(CO)O)(O)=O,,,4,1,6,0,6
4766_1,,,,2,2,1,3
4767_0,,,,2,2,1,3
4767_1,,,,2,2,1,3
4768_0,,,,2,2,1,3
4770_0,,,,2,2,1,3
C(C(C=O)C(C(C(C)O)O)O)=O,,,4,1,2,0,2
4770_1,,,,2,2,1,3
4772_0,,,,2,2,1,3
C(C(CC(C(C(C)O)O)O)=O)(O)=O,,,4,1,1,0,1
4774_0,,,,2,2,1,3
C(C(C)=O)(CC(C(C(C)O)O)O)=O,,,4,1,1,0,1
4776_0,,,,2,2,1,3
C(CC(CC(C(C(C)O)O)O)=O)=O,,,4,1,1,0,1
4778_0,,,,2,2,1,3
C(C(C(C)=O)C(C(C(C)O)O)O)=O,,,4,1,2,0,2
4778_1,,,,2,2,1,3
4780_0,,,,2,2,1,3
C(CC(C(C(C)O)O)O)(CCO)=O,,,4,1,1,0,1
4782_0,,,,2,2,1,3
C(C)(C(CO)C(C(C(C)O)O)O)=O,,,4,1,2,0,2
4782_1,,,,2,2,1,3
4784_0,,,,2,2,1,3
C=CC(C(C(C(C(C)O)O)O)O)=O,,,4,1,2,0,2
4784_1,,,,2,2,1,3
4786_0,,,,2,2,1,3
C(C(C(CC=O)O)C(CO)O)=O,,,4,1,2,0,2
4786_1,,,,2,2,1,3
4788_0,,,,2,2,1,3
C(C(C=O)C(CC(CO)O)O)=O,,,4,1,2,0,2
4788_1,,,,2,2,1,3
4790_0,,,,2,2,1,3
C(C(C(CO)O)C(C(O)=O)(C)O)=O,,,4,1,2,0,2
4790_1,,,,2,2,1,3
4792_0,,,,2,2,1,3
C(C(CC(CC(CO)O)O)=O)(O)=O,,,4,1,1,0,1
4794_0,,,,2,2,1,3
C(C(C=O)C(CO)O)(O)=O,,,4,1,3,0,3
4794_1,,,,2,2,1,3
4796_0,,,,2,2,1,3
C(C(C(CO)O)C(C(O)=O)O)=O,,,4,1,7,0,7
4796_1,,,,2,2,1,3
4798_0,,,,2,2,1,3
C(C(C(CO)O)C(C(C)=O)(C)O)=O,,,4,1,2,0,2
4798_1,,,,2,2,1,3
4800_0,,,,2,2,1,3
C(C(C)=O)(CC(CC(CO)O)O)=O,,,4,1,1,0,1
4802_0,,,,2,2,1,3
C(C(C(CO)O)C(C)(CC=O)O)=O,,,4,1,2,0,2
4802_1,,,,2,2,1,3
4804_0,,,,2,2,1,3
C(C(C(CC(C)=O)O)C(CO)O)=O,,,4,1,2,0,2
4804_1,,,,2,2,1,3
4806_0,,,,2,2,1,3
C(CC(CC(CC(CO)O)O)=O)=O,,,4,1,1,0,1
4808_0,,,,2,2,1,3
C(C(C(C)=O)C(CC(CO)O)O)=O,,,4,1,2,0,2
4808_1,,,,2,2,1,3
4810_0,,,,2,2,1,3
C(C(C(CO)O)C(C)(CCO)O)=O,,,4,1,2,0,2
4810_1,,,,2,2,1,3
4812_0,,,,2,2,1,3
C(CC(CC(CO)O)O)(CCO)=O,,,4,1,1,0,1
4814_0,,,,2,2,1,3
C(C)(C(CO)C(CC(CO)O)O)=O,,,4,1,2,0,2
4814_1,,,,2,2,1,3
4816_0,,,,2,2,1,3
C(C(C(CO)O)C(C(C=O)=O)O)=O,,,4,1,2,0,2
4816_1,,,,2,2,1,3
4818_0,,,,2,2,1,3
C(C(C=O)(C(C=O)C(CO)O)O)=O,,,4,1,2,0,2
4818_1,,,,2,2,1,3
4820_0,,,,2,2,1,3
C(C(C(CO)O)C(C(C=C)=O)O)=O,,,4,1,2,0,2
4820_1,,,,2,2,1,3
4822_0,,,,2,2,1,3
C(C(C=C)(C(C=O)C(CO)O)O)=O,,,4,1,2,0,2
4822_1,,,,2,2,1,3
4824_0,,,,2,2,1,3
C(C(C(CO)O)C(C=C)(CO)O)=O,,,4,1,2,0,2
4824_1,,,,2,2,1,3
4826_0,,,,2,2,1,3
C=CC(C(C(CC(CO)O)O)O)=O,,,4,1,2,0,2
4826_1,,,,2,2,1,3
4828_0,,,,2,2,1,3
C(C(C(CO)O)C(C=CC=O)O)=O,,,4,1,2,0,2
4828_1,,,,2,2,1,3
4830_0,,,,2,2,1,3
C(C(C(CO)O)C(C(C)O)O)=O,,,4,1,2,0,2
4830_1,,,,2,2,1,3
4832_0,,,,2,2,1,3
C(CC(C(C(C(C)=O)=O)O)O)=O,,,4,1,3,0,3
4832_1,,,,2,2,1,3
4834_0,,,,2,2,1,3
C(CC(CC(C(CO)=O)=O)O)=O,,,4,1,3,0,3
4836_0,,,,2,2,1,3
C(C(C=O)C(C(C)=O)(CO)O)=O,,,4,1,3,0,3
4836_1,,,,2,2,1,3
4838_0,,,,2,2,1,3
C(C(C=O)C(C(CO)=O)(C)O)=O,,,4,1,2,0,2
4838_1,,,,2,2,1,3
4840_0,,,,2,2,1,3
C(C(C)(C(C(C(C)=O)=O)O)O)(O)=O,,,4,1,3,0,3
4840_1,,,,2,2,1,3
4842_0,,,,2,2,1,3
C(C(C)(CC(C(CO)=O)=O)O)(O)=O,,,4,1,1,0,1
4844_0,,,,2,2,1,3
C(C)(C(CO)(CC(C(O)=O)=O)O)=O,,,4,1,4,0,4
4846_0,,,,2,2,1,3
C(CO)(C(C)(CC(C(O)=O)=O)O)=O,,,4,1,1,0,1
4848_0,,,,2,2,1,3
C(C(C(C(C)=O)=O)O)(O)=O,,,4,1,2,0,2
4848_1,,,,2,2,1,3
4850_0,,,,2,2,1,3
C(CC(C(CO)=O)=O)(O)=O,,,4,1,2,0,2
4852_0,,,,2,2,1,3
C(C(C(C(C(C)=O)=O)O)O)(O)=O,,,4,1,4,0,4
4852_1,,,,2,2,1,3
4854_0,,,,2,2,1,3
C(C(CC(C(CO)=O)=O)O)(O)=O,,,4,1,1,0,1
4856_0,,,,2,2,1,3
C(C)(C(C)(C(C(C(C)=O)=O)O)O)=O,,,4,1,2,0,2
4856_1,,,,2,2,1,3
4858_0,,,,2,2,1,3
C(C)(C(C)(CC(C(CO)=O)=O)O)=O,,,4,1,1,0,1
4860_0,,,,2,2,1,3
C(C)(C(CO)(CC(C(C)=O)=O)O)=O,,,4,1,1,0,1
4862_0,,,,2,2,1,3
C(CO)(C(C)(CC(C(C)=O)=O)O)=O,,,4,1,1,0,1
4864_0,,,,2,2,1,3
C(CC(C)(C(C(C(C)=O)=O)O)O)=O,,,4,1,2,0,2
4864_1,,,,2,2,1,3
4866_0,,,,2,2,1,3
C(CC(C)(CC(C(CO)=O)=O)O)=O,,,4,1,3,0,3
4868_0,,,,2,2,1,3
C(C)(CC(C(C(C(C)=O)=O)O)O)=O,,,4,1,2,0,2
4868_1,,,,2,2,1,3
4870_0,,,,2,2,1,3
C(C)(CC(CC(C(CO)=O)=O)O)=O,,,4,1,1,0,1
4872_0,,,,2,2,1,3
C(C)(C(CO)(CC(CC=O)=O)O)=O,,,4,1,1,0,1
4874_0,,,,2,2,1,3
C(CO)(C(C)(CC(CC=O)=O)O)=O,,,4,1,1,0,1
4876_0,,,,2,2,1,3
C(C(C(C)=O)C(C(C)=O)(CO)O)=O,,,4,1,2,0,2
4876_1,,,,2,2,1,3
4878_0,,,,2,2,1,3
C(C)(C(C=O)C(C(CO)=O)(C)O)=O,,,4,1,2,0,2
4878_1,,,,2,2,1,3
4880_0,,,,2,2,1,3
C(C(C)=O)(C(C(C)(CCO)O)O)=O,,,4,1,2,0,2
4880_1,,,,2,2,1,3
4882_0,,,,2,2,1,3
C(C(CO)=O)(CC(C)(CCO)O)=O,,,4,1,1,0,1
4884_0,,,,2,2,1,3
C(C)(C(CO)(CC(CCO)=O)O)=O,,,4,1,1,0,1
4886_0,,,,2,2,1,3
C(CO)(C(C)(CC(CCO)=O)O)=O,,,4,1,1,0,1
4888_0,,,,2,2,1,3
C(C)(C(CO)C(C(C)=O)(CO)O)=O,,,4,1,2,0,2
4888_1,,,,2,2,1,3
4890_0,,,,2,2,1,3
C(C)(C(CO)C(C(CO)=O)(C)O)=O,,,4,1,2,0,2
4890_1,,,,2,2,1,3
4892_0,,,,2,2,1,3
C(C(C(C(C(C(C)=O)=O)O)O)=O)=O,,,4,1,4,0,4
4892_1,,,,2,2,1,3
4894_0,,,,2,2,1,3
C(C(C(CC(C(CO)=O)=O)O)=O)=O,,,4,1,1,0,1
4896_0,,,,2,2,1,3
C(C(C=O)(C(C(C(C)=O)=O)O)O)=O,,,4,1,4,0,4
4896_1,,,,2,2,1,3
4898_0,,,,2,2,1,3
C(C(C=O)(CC(C(CO)=O)=O)O)=O,,,4,1,1,0,1
4900_0,,,,2,2,1,3
C=CC(C(C(C(C(C)=O)=O)O)O)=O,,,4,1,4,0,4
4900_1,,,,2,2,1,3
4902_0,,,,2,2,1,3
C=CC(C(CC(C(CO)=O)=O)O)=O,,,4,1,1,0,1
4904_0,,,,2,2,1,3
C(C(C=C)(C(C(C(C)=O)=O)O)O)=O,,,4,1,2,0,2
4904_1,,,,2,2,1,3
4906_0,,,,2,2,1,3
C(C(C=C)(CC(C(CO)=O)=O)O)=O,,,4,1,1,0,1
4908_0,,,,2,2,1,3
C(C(CO)(C(C(C(C)=O)=O)O)O)=C,,,4,1,2,0,2
4908_1,,,,2,2,1,3
4910_0,,,,2,2,1,3
C(C(CO)(CC(C(CO)=O)=O)O)=C,,,4,1,1,0,1
4912_0,,,,2,2,1,3
C(C)(C(CO)(C(C(C=C)=O)O)O)=O,,,4,1,4,0,4
4912_1,,,,2,2,1,3
4914_0,,,,2,2,1,3
C(CO)(C(C)(C(C(C=C)=O)O)O)=O,,,4,1,3,0,3
4914_1,,,,2,2,1,3
4916_0,,,,2,2,1,3
C(C(C(C(C(C)=O)=O)O)O)=CC=O,,,4,1,2,0,2
4916_1,,,,2,2,1,3
4918_0,,,,2,2,1,3
C(C(CC(C(CO)=O)=O)O)=CC=O,,,4,1,1,0,1
4920_0,,,,2,2,1,3
C(C(C)=O)(C(C(C(C)O)O)O)=O,,,4,1,2,0,2
4920_1,,,,2,2,1,3
4922_0,,,,2,2,1,3
C(C(CO)=O)(CC(C(C)O)O)=O,,,4,1,1,0,1
4924_0,,,,2,2,1,3
C(C(C(O)=O)O)(CC(CO)=O)=O,,,4,1,6,0,6
4924_1,,,,2,2,1,3
4926_0,,,,2,2,1,3
C(C(C(CO)=O)C(CO)=O)(O)=O,,,4,1,2,0,2
4926_1,,,,2,2,1,3
4928_0,,,,2,2,1,3
C(C(C(C(C(C)=O)O)=O)O)(O)=O,,,4,1,6,0,6
4928_1,,,,2,2,1,3
4930_0,,,,2,2,1,3
C(CC(C(C(CO)=O)O)=O)(O)=O,,,4,1,1,0,1
4932_0,,,,2,2,1,3
C(C(C=O)C(C(C(C)O)=O)O)=O,,,4,1,3,0,3
4932_1,,,,2,2,1,3
4934_0,,,,2,2,1,3
C(C(C=O)C(C=O)(C(C)O)O)=O,,,4,1,2,0,2
4934_1,,,,2,2,1,3
4936_0,,,,2,2,1,3
C(C(CC(C(O)=O)=O)O)(C(C)O)=O,,,4,1,1,0,1
4938_0,,,,2,2,1,3
C(C(C(C)O)(CC(C(O)=O)=O)O)=O,,,4,1,1,0,1
4940_0,,,,2,2,1,3
C(C(CC(C(C)=O)=O)O)(C(C)O)=O,,,4,1,1,0,1
4941_0,,,,2,2,1,3
4943_0,,,,2,2,1,3
C(CC(C(C(C)O)=O)O)(CC=O)=O,,,4,1,2,0,2
4944_0,,,,2,2,1,3
4946_0,,,,2,2,1,3
C(C)(C(C=O)C(C(C(C)O)=O)O)=O,,,4,1,2,0,2
4946_1,,,,2,2,1,3
4948_0,,,,2,2,1,3
C(C(C(C)O)(C(C=O)C(C)=O)O)=O,,,4,1,2,0,2
4948_1,,,,2,2,1,3
4950_0,,,,2,2,1,3
C(CC(C(C(C)O)=O)O)(CCO)=O,,,4,1,1,0,1
4952_0,,,,2,2,1,3
C(C(C(C)O)(CC(CCO)=O)O)=O,,,4,1,3,0,3
4954_0,,,,2,2,1,3
C(C)(C(CO)C(C(C(C)O)=O)O)=O,,,4,1,2,0,2
4954_1,,,,2,2,1,3
4956_0,,,,2,2,1,3
C(C(C(C)O)(C(C(C)=O)CO)O)=O,,,4,1,2,0,2
4956_1,,,,2,2,1,3
4958_0,,,,2,2,1,3
C(C(C(C(C=C)=O)O)O)(C(C)O)=O,,,4,1,4,0,4
4958_1,,,,2,2,1,3
4959_0,,,,2,2,1,3
4959_1,,,,2,2,1,3
4961_0,,,,2,2,1,3
C(CC(C(C(C(C)O)=O)O)O)=O,,,4,1,4,0,4
4961_1,,,,2,2,1,3
4963_0,,,,2,2,1,3
C(C(C=O)C(CO)(C(C)O)O)=O,,,4,1,2,0,2
4963_1,,,,2,2,1,3
4965_0,,,,2,2,1,3
C(C(C)(C(C(C(C)O)=O)O)O)(O)=O,,,4,1,3,0,3
4965_1,,,,2,2,1,3
4967_0,,,,2,2,1,3
C(C(CC(CO)(C(C)O)O)=O)(O)=O,,,4,1,1,0,1
4969_0,,,,2,2,1,3
C(C(C(C(C)O)=O)O)(O)=O,,,4,1,5,0,5
4969_1,,,,2,2,1,3
4970_0,,,,2,2,1,3
4970_1,,,,2,2,1,3
4972_0,,,,2,2,1,3
C(C)(C(C)(C(C(C(C)O)=O)O)O)=O,,,4,1,2,0,2
4972_1,,,,2,2,1,3
4974_0,,,,2,2,1,3
C(C(C)=O)(CC(CO)(C(C)O)O)=O,,,4,1,2,0,2
4976_0,,,,2,2,1,3
C(CC(C)(C(C(C(C)O)=O)O)O)=O,,,4,1,2,0,2
4976_1,,,,2,2,1,3
4978_0,,,,2,2,1,3
C(C(C(CC(C)=O)O)O)(C(C)O)=O,,,4,1,2,0,2
4978_1,,,,2,2,1,3
4980_0,,,,2,2,1,3
C(CC(CC(CO)(C(C)O)O)=O)=O,,,4,1,2,0,2
4982_0,,,,2,2,1,3
C(C(C(C)=O)C(CO)(C(C)O)O)=O,,,4,1,2,0,2
4982_1,,,,2,2,1,3
4984_0,,,,2,2,1,3
C(C(C(C)(CCO)O)O)(C(C)O)=O,,,4,1,2,0,2
4984_1,,,,2,2,1,3
4986_0,,,,2,2,1,3
C(CC(CO)(C(C)O)O)(CCO)=O,,,4,1,1,0,1
4988_0,,,,2,2,1,3
C(C)(C(CO)C(CO)(C(C)O)O)=O,,,4,1,2,0,2
4988_1,,,,2,2,1,3
4990_0,,,,2,2,1,3
C(C(C(C(C=O)=O)O)O)(C(C)O)=O,,,4,1,5,0,5
4990_1,,,,2,2,1,3
4992_0,,,,2,2,1,3
C(C(C=O)(C(C(C(C)O)=O)O)O)=O,,,4,1,5,0,5
4992_1,,,,2,2,1,3
4993_0,,,,2,2,1,3
4993_1,,,,2,2,1,3
4995_0,,,,2,2,1,3
C(C(C=C)(C(C(C(C)O)=O)O)O)=O,,,4,1,2,0,2
4995_1,,,,2,2,1,3
4997_0,,,,2,2,1,3
C(C(C(C=C)(CO)O)O)(C(C)O)=O,,,4,1,2,0,2
4997_1,,,,2,2,1,3
4999_0,,,,2,2,1,3
C=CC(C(C(CO)(C(C)O)O)O)=O,,,4,1,3,0,3
4999_1,,,,2,2,1,3
5001_0,,,,2,2,1,3
C(C(C(C=CC=O)O)O)(C(C)O)=O,,,4,1,2,0,2
5001_1,,,,2,2,1,3
5003_0,,,,2,2,1,3
C(C(C(C(C)O)O)O)(C(C)O)=O,,,4,1,2,0,2
5003_1,,,,2,2,1,3
5005_0,,,,2,2,1,3
C(C(C=O)C(CC=O)O)=O,,,4,1,2,0,2
5005_1,,,,2,2,1,3
5007_0,,,,2,2,1,3
C(C(C=O)C(CO)(C(C=O)O)O)=O,,,4,1,2,0,2
5007_1,,,,2,2,1,3
5009_0,,,,2,2,1,3
C(C(C=O)C(C(C(CO)=O)O)O)=O,,,4,1,2,0,2
5009_1,,,,2,2,1,3
5011_0,,,,2,2,1,3
C(CC(C(C(C(C=O)O)=O)O)O)=O,,,4,1,3,0,3
5011_1,,,,2,2,1,3
5013_0,,,,2,2,1,3
C(C(C=O)C(C(CCO)O)O)=O,,,4,1,3,0,3
5013_1,,,,2,2,1,3
5015_0,,,,2,2,1,3
C(C(C=O)C(C(O)=O)(C)O)=O,,,4,1,2,0,2
5015_1,,,,2,2,1,3
5016_0,,,,2,2,1,3
5018_0,,,,2,2,1,3
C(C(C=O)C(O)=O)=O,,,4,1,2,0,2
5018_1,,,,2,2,1,3
5020_0,,,,2,2,1,3
C(C(C=O)C(CO)(CC(O)=O)O)=O,,,4,1,2,0,2
5020_1,,,,2,2,1,3
5021_0,,,,2,2,1,3
5021_1,,,,2,2,1,3
5022_0,,,,2,2,1,3
5022_1,,,,2,2,1,3
5024_0,,,,2,2,1,3
C(C(C=O)C(C)(C(C(O)=O)O)O)=O,,,4,1,2,0,2
5024_1,,,,2,2,1,3
5025_0,,,,2,2,1,3
5027_0,,,,2,2,1,3
C(C(C=O)C(C(O)=O)O)=O,,,4,1,3,0,3
5027_1,,,,2,2,1,3
5029_0,,,,2,2,1,3
C(C(C=O)C(C(C(O)=O)O)O)=O,,,4,1,2,0,2
5029_1,,,,2,2,1,3
5031_0,,,,2,2,1,3
C(C(C=O)C(C(CC(O)=O)O)O)=O,,,4,1,2,0,2
5031_1,,,,2,2,1,3
5033_0,,,,2,2,1,3
C(C(C=O)C(C(O)=O)(CO)O)=O,,,4,1,2,0,2
5033_1,,,,2,2,1,3
5034_0,,,,2,2,1,3
5034_1,,,,2,2,1,3
5036_0,,,,2,2,1,3
C(C(C=O)C(C(CC(C)=O)=O)O)=O,,,4,1,2,0,2
5036_1,,,,2,2,1,3
5038_0,,,,2,2,1,3
C(C(C=O)C(C=O)(CC(C)=O)O)=O,,,4,1,2,0,2
5038_1,,,,2,2,1,3
5040_0,,,,2,2,1,3
C(C(C=O)C(C)(CC(C=O)=O)O)=O,,,4,1,2,0,2
5040_1,,,,2,2,1,3
5042_0,,,,2,2,1,3
C(CC(C(C(C)=O)C(C=O)=O)O)=O,,,4,1,2,0,2
5042_1,,,,2,2,1,3
5044_0,,,,2,2,1,3
C(CC(CC(CC(C=O)=O)=O)O)=O,,,4,1,3,0,3
5046_0,,,,2,2,1,3
C(C(C=O)C(C(CC=O)=O)O)=O,,,4,1,3,0,3
5046_1,,,,2,2,1,3
5048_0,,,,2,2,1,3
C(C(C=O)C(C=O)(CC=O)O)=O,,,4,1,3,0,3
5048_1,,,,2,2,1,3
5050_0,,,,2,2,1,3
C(C(C=O)C(CC(C=O)=O)O)=O,,,4,1,2,0,2
5050_1,,,,2,2,1,3
5052_0,,,,2,2,1,3
C(C(C(C=O)=O)C(CC=O)O)=O,,,4,1,3,0,3
5052_1,,,,2,2,1,3
5054_0,,,,2,2,1,3
C(C(C=O)C(CC(C(C)=O)=O)O)=O,,,4,1,2,0,2
5054_1,,,,2,2,1,3
5056_0,,,,2,2,1,3
C(C(C=O)C(C(C)=O)(CC=O)O)=O,,,4,1,2,0,2
5056_1,,,,2,2,1,3
5058_0,,,,2,2,1,3
C(CC(C(C)(C(C=O)C=O)O)=O)=O,,,4,1,2,0,2
5058_1,,,,2,2,1,3
5060_0,,,,2,2,1,3
C(CC(C(C=O)C(C(C)=O)=O)O)=O,,,4,1,2,0,2
5060_1,,,,2,2,1,3
5062_0,,,,2,2,1,3
C(CC(C(CC(CC=O)O)=O)=O)=O,,,4,1,1,0,1
5064_0,,,,2,2,1,3
C(C(C=O)C(C(C)=O)(C)O)=O,,,4,1,2,0,2
5064_1,,,,2,2,1,3
5066_0,,,,2,2,1,3
C(CC(CC(C(C)=O)=O)O)=O,,,4,1,4,0,4
5068_0,,,,2,2,1,3
C(C(C=O)C(C)(CC=O)O)=O,,,4,1,2,0,2
5068_1,,,,2,2,1,3
5070_0,,,,2,2,1,3
C(C(C=O)C(CC(C)=O)O)=O,,,4,1,2,0,2
5070_1,,,,2,2,1,3
5072_0,,,,2,2,1,3
C(CC(CC(CC=O)O)=O)=O,,,4,1,1,0,1
5074_0,,,,2,2,1,3
C(CC(C(C=O)C(C)=O)O)=O,,,4,1,2,0,2
5074_1,,,,2,2,1,3
5076_0,,,,2,2,1,3
C(C(C=O)C1(COC(C1)O)O)=O,,,4,1,2,0,2
5076_1,,,,2,2,1,3
5078_0,,,,2,2,1,3
C(CC(C1C(COC1O)=O)O)=O,,,4,1,2,0,2
5078_1,,,,2,2,1,3
5080_0,,,,2,2,1,3
C(CC(C1C(CC(O1)O)=O)O)=O,,,4,1,2,0,2
5080_1,,,,2,2,1,3
5082_0,,,,2,2,1,3
C(C(C=O)C(C)(CCO)O)=O,,,4,1,2,0,2
5082_1,,,,2,2,1,3
5084_0,,,,2,2,1,3
C(CC(CC(CCO)=O)O)=O,,,4,1,1,0,1
5086_0,,,,2,2,1,3
C(CC(C(C(C)=O)CO)O)=O,,,4,1,2,0,2
5086_1,,,,2,2,1,3
5088_0,,,,2,2,1,3
C(C(C=O)C(CC(C(O)=O)O)O)=O,,,4,1,2,0,2
5088_1,,,,2,2,1,3
5090_0,,,,2,2,1,3
C(CC(C(C=O)C(C(O)=O)O)O)=O,,,4,1,2,0,2
5090_1,,,,2,2,1,3
5092_0,,,,2,2,1,3
C(C(C=O)C(C(C(C)=O)=O)O)=O,,,4,1,2,0,2
5092_1,,,,2,2,1,3
5094_0,,,,2,2,1,3
C(C(C=O)C(C=O)(C(C)=O)O)=O,,,4,1,3,0,3
5094_1,,,,2,2,1,3
5096_0,,,,2,2,1,3
C(C(C=O)C(C(C=O)=O)(C)O)=O,,,4,1,2,0,2
5096_1,,,,2,2,1,3
5098_0,,,,2,2,1,3
C(CC(CC(C(C=O)=O)=O)O)=O,,,4,1,2,0,2
5100_0,,,,2,2,1,3
C(C(C=O)C(C(C=O)=O)O)=O,,,4,1,3,0,3
5100_1,,,,2,2,1,3
5102_0,,,,2,2,1,3
C(C(C=O)C(C=O)(C=O)O)=O,,,4,1,3,0,3
5102_1,,,,2,2,1,3
5104_0,,,,2,2,1,3
C(C(C=O)C(C(C(C=O)O)=O)O)=O,,,4,1,2,0,2
5104_1,,,,2,2,1,3
5106_0,,,,2,2,1,3
C(C(C=O)C(C=O)(C(C=O)O)O)=O,,,4,1,2,0,2
5106_1,,,,2,2,1,3
5108_0,,,,2,2,1,3
C(C(C=O)C(C(C(C=O)=O)O)O)=O,,,4,1,2,0,2
5108_1,,,,2,2,1,3
5110_0,,,,2,2,1,3
C(C(C=O)C(C=CC(CO)=O)O)=O,,,4,1,2,0,2
5110_1,,,,2,2,1,3
5112_0,,,,2,2,1,3
C(C(C=O)C(C=CC=O)(CO)O)=O,,,4,1,2,0,2
5112_1,,,,2,2,1,3
5114_0,,,,2,2,1,3
C(CC(C(C(C=CC=O)=O)O)O)=O,,,4,1,2,0,2
5114_1,,,,2,2,1,3
5116_0,,,,2,2,1,3
C(C(C=O)C(C(C=C)=O)O)=O,,,4,1,3,0,3
5116_1,,,,2,2,1,3
5118_0,,,,2,2,1,3
C(C(C=O)C(C=O)(C=C)O)=O,,,4,1,2,0,2
5118_1,,,,2,2,1,3
5120_0,,,,2,2,1,3
C(C(C=O)C(C=C)(CO)O)=O,,,4,1,2,0,2
5120_1,,,,2,2,1,3
5122_0,,,,2,2,1,3
C(CC(C(C(C=C)=O)O)O)=O,,,4,1,2,0,2
5122_1,,,,2,2,1,3
5124_0,,,,2,2,1,3
C(C(C=O)C(C=CC=O)O)=O,,,4,1,3,0,3
5124_1,,,,2,2,1,3
5126_0,,,,2,2,1,3
C(C(C=O)C(C(C)O)O)=O,,,4,1,2,0,2
5126_1,,,,2,2,1,3
5128_0,,,,2,2,1,3
C(C(C=O)C(C(O)=O)(CCO)O)=O,,,4,1,2,0,2
5128_1,,,,2,2,1,3
5130_0,,,,2,2,1,3
C(CC(C(C(C(O)=O)=O)CO)O)=O,,,4,1,5,0,5
5130_1,,,,2,2,1,3
5132_0,,,,2,2,1,3
C(C(C=O)C(C(CO)(CO)O)O)=O,,,4,1,2,0,2
5132_1,,,,2,2,1,3
5134_0,,,,2,2,1,3
C(C(C=O)C(C(C=O)(CO)O)O)=O,,,4,1,2,0,2
5134_1,,,,2,2,1,3
5136_0,,,,2,2,1,3
C(C(C=O)C(C(C=CC(C)=O)=O)O)=O,,,4,1,2,0,2
5136_1,,,,2,2,1,3
5138_0,,,,2,2,1,3
C(C(C=O)C(C=O)(C=CC(C)=O)O)=O,,,4,1,2,0,2
5138_1,,,,2,2,1,3
5140_0,,,,2,2,1,3
C(C(C=O)C(C=CC(C=O)=O)(C)O)=O,,,4,1,2,0,2
5140_1,,,,2,2,1,3
5142_0,,,,2,2,1,3
C(CC(CC(C=CC(C=O)=O)=O)O)=O,,,4,1,1,0,1
5144_0,,,,2,2,1,3
C(C(C=O)C(C(C=CCC=O)=O)O)=O,,,4,1,2,0,2
5144_1,,,,2,2,1,3
5146_0,,,,2,2,1,3
C(C(C=O)C(C=O)(C=CCC=O)O)=O,,,4,1,2,0,2
5146_1,,,,2,2,1,3
5148_0,,,,2,2,1,3
C(C(C=O)C(CC=CC(C=O)=O)O)=O,,,4,1,2,0,2
5148_1,,,,2,2,1,3
5150_0,,,,2,2,1,3
C(C(C=CC(C=O)=O)C(CC=O)O)=O,,,4,1,1,0,1
5152_0,,,,2,2,1,3
C(C(C=O)C(C=CC(C(C)=O)=O)O)=O,,,4,1,2,0,2
5152_1,,,,2,2,1,3
5154_0,,,,2,2,1,3
C(C(C=O)C(C(C)=O)(C=CC=O)O)=O,,,4,1,2,0,2
5154_1,,,,2,2,1,3
5156_0,,,,2,2,1,3
C(C(C=O)C(C(C=CC=O)=O)(C)O)=O,,,4,1,2,0,2
5156_1,,,,2,2,1,3
5158_0,,,,2,2,1,3
C(CC(CC(C(C=CC=O)=O)=O)O)=O,,,4,1,1,0,1
5160_0,,,,2,2,1,3
C(C(C=O)C(C=CC(CC=O)=O)O)=O,,,4,1,2,0,2
5160_1,,,,2,2,1,3
5162_0,,,,2,2,1,3
C(C(C=O)C(C=CC=O)(CC=O)O)=O,,,4,1,2,0,2
5162_1,,,,2,2,1,3
5164_0,,,,2,2,1,3
C(C(C=O)C(CC(C=CC=O)=O)O)=O,,,4,1,2,0,2
5164_1,,,,2,2,1,3
5166_0,,,,2,2,1,3
C(C(C(C=CC=O)=O)C(CC=O)O)=O,,,4,1,2,0,2
5166_1,,,,2,2,1,3
5168_0,,,,2,2,1,3
C(C(C=O)C(C(CC(C=C)=O)=O)O)=O,,,4,1,2,0,2
5168_1,,,,2,2,1,3
5170_0,,,,2,2,1,3
C(C(C=O)C(C=O)(CC(C=C)=O)O)=O,,,4,1,2,0,2
5170_1,,,,2,2,1,3
5172_0,,,,2,2,1,3
C(C(C=O)C(C=C)(CC(C=O)=O)O)=O,,,4,1,2,0,2
5172_1,,,,2,2,1,3
5174_0,,,,2,2,1,3
C(CC(C(C(C=O)=O)C(C=C)=O)O)=O,,,4,1,2,0,2
5174_1,,,,2,2,1,3
5176_0,,,,2,2,1,3
C(C(C=O)C(CC(C(C=C)=O)=O)O)=O,,,4,1,2,0,2
5176_1,,,,2,2,1,3
5178_0,,,,2,2,1,3
C(C(C=O)C(C(C=C)=O)(CC=O)O)=O,,,4,1,2,0,2
5178_1,,,,2,2,1,3
5180_0,,,,2,2,1,3
C(C(C=O)C(C(CC=O)=O)(C=C)O)=O,,,4,1,2,0,2
5180_1,,,,2,2,1,3
5182_0,,,,2,2,1,3
C(C(C(C(C=C)=O)=O)C(CC=O)O)=O,,,4,1,2,0,2
5182_1,,,,2,2,1,3
5184_0,,,,2,2,1,3
C(C(C=O)C(C(CC=CC=O)=O)O)=O,,,4,1,2,0,2
5184_1,,,,2,2,1,3
5186_0,,,,2,2,1,3
C(C(C=O)C(C=O)(CC=CC=O)O)=O,,,4,1,2,0,2
5186_1,,,,2,2,1,3
5188_0,,,,2,2,1,3
C(C(C=O)C(C=CCC(C=O)=O)O)=O,,,4,1,2,0,2
5188_1,,,,2,2,1,3
5190_0,,,,2,2,1,3
C(CC(C(C=CC=O)C(C=O)=O)O)=O,,,4,1,1,0,1
5192_0,,,,2,2,1,3
C(C(C=O)C1(COCC1O)O)=O,,,4,1,2,0,2
5192_1,,,,2,2,1,3
5194_0,,,,2,2,1,3
C(CC(C1C(C(CO1)O)=O)O)=O,,,4,1,2,0,2
5194_1,,,,2,2,1,3
5196_0,,,,2,2,1,3
C(C(C=O)C1(C(O)OCC1)O)=O,,,4,1,2,0,2
5196_1,,,,2,2,1,3
5198_0,,,,2,2,1,3
C(CC(C1C(C(O)OC1)=O)O)=O,,,4,1,3,0,3
5198_1,,,,2,2,1,3
5200_0,,,,2,2,1,3
C(C(C=O)C1(C(O)OCC1O)O)=O,,,4,1,2,0,2
5200_1,,,,2,2,1,3
5202_0,,,,2,2,1,3
C(C(C(C(C=O)O)=O)O)(O)=O,,,4,1,2,0,2
5202_1,,,,2,2,1,3
5204_0,,,,2,2,1,3
C(C(C(C(C(C(O)=O)O)O)=O)O)=O,,,4,1,3,0,3
5204_1,,,,2,2,1,3
5206_0,,,,2,2,1,3
C(C(C(C(C(C(C)O)O)O)=O)O)=O,,,4,1,2,0,2
5206_1,,,,2,2,1,3
5208_0,,,,2,2,1,3
C(C(CC(C(CCO)O)O)=O)(O)=O,,,4,1,1,0,1
5210_0,,,,2,2,1,3
C(C(C)=O)(CC(C(CCO)O)O)=O,,,4,1,2,0,2
5212_0,,,,2,2,1,3
C(CC(CC(C(CCO)O)O)=O)=O,,,4,1,2,0,2
5214_0,,,,2,2,1,3
C(C(C(C)=O)C(C(CCO)O)O)=O,,,4,1,2,0,2
5214_1,,,,2,2,1,3
5216_0,,,,2,2,1,3
C(CC(C(CCO)O)O)(CCO)=O,,,4,1,1,0,1
5218_0,,,,2,2,1,3
C(C)(C(CO)C(C(CCO)O)O)=O,,,4,1,2,0,2
5218_1,,,,2,2,1,3
5220_0,,,,2,2,1,3
C=CC(C(C(C(CCO)O)O)O)=O,,,4,1,3,0,3
5220_1,,,,2,2,1,3
5222_0,,,,2,2,1,3
C(C(C)(CC(C(O)=O)=O)O)(O)=O,,,4,1,1,0,1
5224_0,,,,2,2,1,3
C(CC(C(O)=O)=O)(O)=O,,,4,1,1,0,1
5226_0,,,,2,2,1,3
C(C(CC(C(O)=O)=O)O)(O)=O,,,4,1,1,0,1
5228_0,,,,2,2,1,3
C(C(C(CC(C(O)=O)=O)O)O)(O)=O,,,4,1,1,0,1
5230_0,,,,2,2,1,3
C(C(CO)(CC(C(O)=O)=O)O)(O)=O,,,4,1,1,0,1
5232_0,,,,2,2,1,3
C(C(C)(C(C(C(O)=O)=O)O)O)(O)=O,,,4,1,2,0,2
5232_1,,,,2,2,1,3
5234_0,,,,2,2,1,3
C(CC(C(CC(C(O)=O)=O)O)=O)=O,,,4,1,1,0,1
5236_0,,,,2,2,1,3
C(CC(C=O)(CC(C(O)=O)=O)O)=O,,,4,1,1,0,1
5238_0,,,,2,2,1,3
C(C(CC(CC(C=O)=O)O)=O)(O)=O,,,4,1,1,0,1
5240_0,,,,2,2,1,3
C(C(C(C=O)=O)C(C(O)=O)(C)O)=O,,,4,1,2,0,2
5240_1,,,,2,2,1,3
5242_0,,,,2,2,1,3
C(C)(C(C)(CC(C(O)=O)=O)O)=O,,,4,1,1,0,1
5244_0,,,,2,2,1,3
C(C(C)(CC(C(C)=O)=O)O)(O)=O,,,4,1,1,0,1
5246_0,,,,2,2,1,3
C(CC(C)(CC(C(O)=O)=O)O)=O,,,4,1,1,0,1
5248_0,,,,2,2,1,3
C(C)(CC(CC(C(O)=O)=O)O)=O,,,4,1,1,0,1
5250_0,,,,2,2,1,3
C(C(C)(CC(CC=O)=O)O)(O)=O,,,4,1,1,0,1
5252_0,,,,2,2,1,3
C(C(C)(C(C=O)C(C)=O)O)(O)=O,,,4,1,2,0,2
5252_1,,,,2,2,1,3
5254_0,,,,2,2,1,3
C(C(CC1(COC(C1)O)O)=O)(O)=O,,,4,1,1,0,1
5256_0,,,,2,2,1,3
C(C(C)(C1C(COC1O)=O)O)(O)=O,,,4,1,2,0,2
5256_1,,,,2,2,1,3
5258_0,,,,2,2,1,3
C(C(C)(C1C(CC(O1)O)=O)O)(O)=O,,,4,1,2,0,2
5258_1,,,,2,2,1,3
5260_0,,,,2,2,1,3
C(C(CC(C)(CCO)O)=O)(O)=O,,,4,1,1,0,1
5262_0,,,,2,2,1,3
C(C(C)(CC(CCO)=O)O)(O)=O,,,4,1,1,0,1
5264_0,,,,2,2,1,3
C(C(C)(C(C(C)=O)CO)O)(O)=O,,,4,1,2,0,2
5264_1,,,,2,2,1,3
5266_0,,,,2,2,1,3
C(C(CC(C(C(C)=O)=O)O)=O)(O)=O,,,4,1,1,0,1
5268_0,,,,2,2,1,3
C(C(C(C)=O)(CC(C(O)=O)=O)O)=O,,,4,1,1,0,1
5270_0,,,,2,2,1,3
C(C=O)(C(C)(CC(C(O)=O)=O)O)=O,,,4,1,1,0,1
5272_0,,,,2,2,1,3
C(C(C)(CC(C(C=O)=O)=O)O)(O)=O,,,4,1,1,0,1
5274_0,,,,2,2,1,3
C(C(CC(C(C=O)=O)O)=O)(O)=O,,,4,1,1,0,1
5276_0,,,,2,2,1,3
C(C(C=O)(CC(C(O)=O)=O)O)=O,,,4,1,1,0,1
5278_0,,,,2,2,1,3
C=CC(C(CC(C(O)=O)=O)O)=O,,,4,1,1,0,1
5280_0,,,,2,2,1,3
C(C(C=C)(CC(C(O)=O)=O)O)=O,,,4,1,1,0,1
5282_0,,,,2,2,1,3
C(C(CO)(CC(C(O)=O)=O)O)=C,,,4,1,1,0,1
5284_0,,,,2,2,1,3
C(C(C)(C(C(C=C)=O)O)O)(O)=O,,,4,1,3,0,3
5284_1,,,,2,2,1,3
5286_0,,,,2,2,1,3
C(C(CC(C(O)=O)=O)O)=CC=O,,,4,1,1,0,1
5288_0,,,,2,2,1,3
C(C(CC(C(C)O)O)=O)(O)=O,,,4,1,1,0,1
5290_0,,,,2,2,1,3
C(C(CC1(COCC1O)O)=O)(O)=O,,,4,1,1,0,1
5292_0,,,,2,2,1,3
C(C(C)(C1C(C(CO1)O)=O)O)(O)=O,,,4,1,2,0,2
5292_1,,,,2,2,1,3
5294_0,,,,2,2,1,3
C(C(CC1(C(O)OCC1)O)=O)(O)=O,,,4,1,1,0,1
5296_0,,,,2,2,1,3
C(C(C)(C1C(C(O)OC1)=O)O)(O)=O,,,4,1,2,0,2
5296_1,,,,2,2,1,3
5298_0,,,,2,2,1,3
C(C(C(O)=O)C(CO)=O)(O)=O,,,4,1,2,0,2
5298_1,,,,2,2,1,3
5300_0,,,,2,2,1,3
C(CC(C(C(O)=O)O)=O)(O)=O,,,4,1,3,0,3
5300_1,,,,2,2,1,3
5301_0,,,,2,2,1,3
5303_0,,,,2,2,1,3
C(C(C(CO)=O)C(C(O)=O)O)(O)=O,,,4,1,4,0,4
5303_1,,,,2,2,1,3
5305_0,,,,2,2,1,3
C(C(C(CC(C(O)=O)O)=O)O)(O)=O,,,4,1,3,0,3
5305_1,,,,2,2,1,3
5307_0,,,,2,2,1,3
C(CC(C(C(C(O)=O)O)O)=O)(O)=O,,,4,1,3,0,3
5309_0,,,,2,2,1,3
C(C(C(C(O)=O)=O)O)(O)=O,,,4,1,2,0,2
5309_1,,,,2,2,1,3
5311_0,,,,2,2,1,3
C(C(C(C)=O)C(C=O)=O)(O)=O,,,4,1,2,0,2
5311_1,,,,2,2,1,3
5313_0,,,,2,2,1,3
C(CC(CC(C=O)=O)=O)(O)=O,,,4,1,4,0,4
5315_0,,,,2,2,1,3
C(C(C(O)=O)C(C=O)=O)=O,,,4,1,2,0,2
5315_1,,,,2,2,1,3
5317_0,,,,2,2,1,3
C(C(C(O)=O)C(C(C)=O)=O)=O,,,4,1,2,0,2
5317_1,,,,2,2,1,3
5319_0,,,,2,2,1,3
C(CC(C(CC(O)=O)=O)=O)=O,,,4,1,1,0,1
5321_0,,,,2,2,1,3
C(CC(C(C)=O)=O)(O)=O,,,4,1,4,0,4
5323_0,,,,2,2,1,3
C(CC(CC(O)=O)=O)=O,,,4,1,1,0,1
5325_0,,,,2,2,1,3
C(C(C(O)=O)C(C)=O)=O,,,4,1,2,0,2
5325_1,,,,2,2,1,3
5327_0,,,,2,2,1,3
C(C1C(COC1O)=O)(O)=O,,,4,1,2,0,2
5327_1,,,,2,2,1,3
5329_0,,,,2,2,1,3
C(C1C(CC(O1)O)=O)(O)=O,,,4,1,2,0,2
5329_1,,,,2,2,1,3
5331_0,,,,2,2,1,3
C(C1C(COC(C1O)O)=O)(O)=O,,,4,1,2,0,2
5331_1,,,,2,2,1,3
5333_0,,,,2,2,1,3
C(C1C(CC(C(O1)O)O)=O)(O)=O,,,4,1,2,0,2
5333_1,,,,2,2,1,3
5335_0,,,,2,2,1,3
C(CC(CCO)=O)(O)=O,,,4,1,1,0,1
5337_0,,,,2,2,1,3
C(C(C(C)=O)CO)(O)=O,,,4,1,2,0,2
5337_1,,,,2,2,1,3
5339_0,,,,2,2,1,3
C(C(C(C)=O)C(C(O)=O)O)(O)=O,,,4,1,2,0,2
5339_1,,,,2,2,1,3
5341_0,,,,2,2,1,3
C(CC(CC(C(O)=O)O)=O)(O)=O,,,4,1,5,0,5
5343_0,,,,2,2,1,3
C(C(C=O)C(C(O)=O)O)(O)=O,,,4,1,2,0,2
5343_1,,,,2,2,1,3
5345_0,,,,2,2,1,3
C(CC(C(C=O)=O)=O)(O)=O,,,4,1,1,0,1
5347_0,,,,2,2,1,3
C(C(C(CO)=O)C(C=O)=O)(O)=O,,,4,1,2,0,2
5347_1,,,,2,2,1,3
5349_0,,,,2,2,1,3
C(C(C(CC(C=O)=O)=O)O)(O)=O,,,4,1,2,0,2
5349_1,,,,2,2,1,3
5351_0,,,,2,2,1,3
C(CC(C(C(C=O)=O)O)=O)(O)=O,,,4,1,1,0,1
5353_0,,,,2,2,1,3
C(C(C(C=CC=O)=O)O)(O)=O,,,4,1,2,0,2
5353_1,,,,2,2,1,3
5355_0,,,,2,2,1,3
C(C(C(C=C)=O)O)(O)=O,,,4,1,2,0,2
5355_1,,,,2,2,1,3
5357_0,,,,2,2,1,3
C(C(C(C=O)=O)CC(C=O)O)(O)=O,,,4,1,1,0,1
5359_0,,,,2,2,1,3
C(C(C(C(C)O)=O)C(C=O)=O)(O)=O,,,4,1,2,0,2
5359_1,,,,2,2,1,3
5361_0,,,,2,2,1,3
C(C(C=O)C(C(C(C)=O)=O)O)(O)=O,,,4,1,2,0,2
5361_1,,,,2,2,1,3
5363_0,,,,2,2,1,3
C(CC(C(C(CC=O)O)=O)=O)(O)=O,,,4,1,1,0,1
5365_0,,,,2,2,1,3
C(C(C=O)C(C(C(C)O)=O)=O)(O)=O,,,4,1,2,0,2
5365_1,,,,2,2,1,3
5367_0,,,,2,2,1,3
C(C(C(C(CC(C)=O)=O)=O)O)(O)=O,,,4,1,2,0,2
5367_1,,,,2,2,1,3
5369_0,,,,2,2,1,3
C(C(C(C)=O)C(C(CO)=O)=O)(O)=O,,,4,1,2,0,2
5369_1,,,,2,2,1,3
5371_0,,,,2,2,1,3
C(CC(O)=O)(CC(C(CO)=O)=O)=O,,,4,1,1,0,1
5373_0,,,,2,2,1,3
C(C(C(C)=O)C(C(C=O)=O)O)(O)=O,,,4,1,2,0,2
5373_1,,,,2,2,1,3
5375_0,,,,2,2,1,3
C(CC(CC(C(C=O)=O)O)=O)(O)=O,,,4,1,1,0,1
5377_0,,,,2,2,1,3
C(C(C(C(CCC=O)=O)=O)O)(O)=O,,,4,1,2,0,2
5377_1,,,,2,2,1,3
5379_0,,,,2,2,1,3
C(C(C(C(CO)=O)=O)CC=O)(O)=O,,,4,1,1,0,1
5381_0,,,,2,2,1,3
C(C(C=O)CC(C(CO)=O)=O)(O)=O,,,4,1,1,0,1
5383_0,,,,2,2,1,3
C(C(C=O)CC(C(C=O)=O)O)(O)=O,,,4,1,1,0,1
5385_0,,,,2,2,1,3
C(C(C(O)=O)O)(CC(C(C)=O)=O)=O,,,4,1,2,0,2
5385_1,,,,2,2,1,3
5387_0,,,,2,2,1,3
C(C(C(CO)=O)C(C(C)=O)=O)(O)=O,,,4,1,2,0,2
5387_1,,,,2,2,1,3
5389_0,,,,2,2,1,3
C(CC(C(CC(CO)=O)=O)=O)(O)=O,,,4,1,1,0,1
5391_0,,,,2,2,1,3
C(C(C(C(C=CCO)=O)=O)O)(O)=O,,,4,1,2,0,2
5391_1,,,,2,2,1,3
5393_0,,,,2,2,1,3
C(C(C(C(C=CC=O)O)=O)O)(O)=O,,,4,1,2,0,2
5393_1,,,,2,2,1,3
5395_0,,,,2,2,1,3
C(C(C(C(C(C=C)=O)O)=O)O)(O)=O,,,4,1,2,0,2
5395_1,,,,2,2,1,3
5397_0,,,,2,2,1,3
C(C(C(C=CC(CO)=O)=O)O)(O)=O,,,4,1,2,0,2
5397_1,,,,2,2,1,3
5399_0,,,,2,2,1,3
C(C(C(O)=O)O)(CC(CCO)=O)=O,,,4,1,5,0,5
5399_1,,,,2,2,1,3
5401_0,,,,2,2,1,3
C(CCO)(C(C(O)=O)C(CO)=O)=O,,,4,1,2,0,2
5401_1,,,,2,2,1,3
5403_0,,,,2,2,1,3
C(C(C(CC(CO)=O)=O)CO)(O)=O,,,4,1,5,0,5
5403_1,,,,2,2,1,3
5405_0,,,,2,2,1,3
C(C(C(CCC(CO)=O)=O)O)(O)=O,,,4,1,2,0,2
5405_1,,,,2,2,1,3
5407_0,,,,2,2,1,3
C(C(C(CO)=O)CC(CO)=O)(O)=O,,,4,1,1,0,1
5409_0,,,,2,2,1,3
C(C(C(C=O)=O)C(CCO)O)(O)=O,,,4,1,2,0,2
5409_1,,,,2,2,1,3
5411_0,,,,2,2,1,3
C(C(C(C(CCO)=O)=O)CO)(O)=O,,,4,1,5,0,5
5411_1,,,,2,2,1,3
5413_0,,,,2,2,1,3
C(C(C(C(C(C)=O)O)=O)CO)(O)=O,,,4,1,5,0,5
5413_1,,,,2,2,1,3
5415_0,,,,2,2,1,3
C(CC(C(C(CCO)=O)O)=O)(O)=O,,,4,1,3,0,3
5417_0,,,,2,2,1,3
C(C(C=O)C(C(CCO)O)=O)(O)=O,,,4,1,2,0,2
5417_1,,,,2,2,1,3
5419_0,,,,2,2,1,3
C(C(CO)O)(C(C(O)=O)C(C)=O)=O,,,4,1,2,0,2
5419_1,,,,2,2,1,3
5421_0,,,,2,2,1,3
C(CC(CC(C(CO)O)=O)=O)(O)=O,,,4,1,4,0,4
5423_0,,,,2,2,1,3
C(C(CO)O)(C(C(O)=O)CC=O)=O,,,4,1,1,0,1
5425_0,,,,2,2,1,3
C(C(C=O)CC(C(CO)O)=O)(O)=O,,,4,1,1,0,1
5427_0,,,,2,2,1,3
C(C(C(C(C=O)O)=O)CCO)(O)=O,,,4,1,1,0,1
5429_0,,,,2,2,1,3
C(C(C(C(C)=O)=O)C(CO)O)(O)=O,,,4,1,2,0,2
5429_1,,,,2,2,1,3
5431_0,,,,2,2,1,3
C(CC(C(CC(CO)O)=O)=O)(O)=O,,,4,1,1,0,1
5433_0,,,,2,2,1,3
C(C(C(CC=O)=O)C(CO)O)(O)=O,,,4,1,2,0,2
5433_1,,,,2,2,1,3
5435_0,,,,2,2,1,3
C(C(C=O)C(CC(CO)O)=O)(O)=O,,,4,1,2,0,2
5435_1,,,,2,2,1,3
5437_0,,,,2,2,1,3
C(CCO)(C(C(O)=O)C(C=O)O)=O,,,4,1,2,0,2
5437_1,,,,2,2,1,3
5439_0,,,,2,2,1,3
C(CC(C=O)O)(C(C(O)=O)CO)=O,,,4,1,5,0,5
5439_1,,,,2,2,1,3
5441_0,,,,2,2,1,3
C(C(C(C=CC(CO)O)=O)O)(O)=O,,,4,1,2,0,2
5441_1,,,,2,2,1,3
5443_0,,,,2,2,1,3
C(C(C(C(O)=O)=O)CO)(O)=O,,,4,1,2,0,2
5443_1,,,,2,2,1,3
5445_0,,,,2,2,1,3
C(C1C(C(C=O)(C(C1)O)O)=O)(O)=O,,,4,1,1,0,1
5447_0,,,,2,2,1,3
C(C(C(CC(O)=O)=O)(CO)O)=O,,,4,1,1,0,1
5449_0,,,,2,2,1,3
C(C(C(CC(O)=O)=O)(C(C)O)O)=O,,,4,1,1,0,1
5451_0,,,,2,2,1,3
C(CC(C(CO)(CO)O)=O)(O)=O,,,4,1,1,0,1
5453_0,,,,2,2,1,3
C(CC(C(CO)(C(C)O)O)=O)(O)=O,,,4,1,1,0,1
5455_0,,,,2,2,1,3
C(C(C(C(CO)(CO)O)=O)O)(O)=O,,,4,1,2,0,2
5455_1,,,,2,2,1,3
5457_0,,,,2,2,1,3
C1(CC(C(C=O)(C1C(O)=O)O)O)=O,,,4,1,2,0,2
5457_1,,,,2,2,1,3
5459_0,,,,2,2,1,3
C(C1(C(C(C(O)=O)C(C1)=O)O)O)=O,,,4,1,2,0,2
5459_1,,,,2,2,1,3
5461_0,,,,2,2,1,3
C(C(C=O)C(C=O)(C(C)O)O)(O)=O,,,4,1,2,0,2
5461_1,,,,2,2,1,3
5463_0,,,,2,2,1,3
C1(C(C(O)=O)C(C(C1CO)=O)O)=O,,,4,1,2,0,2
5463_1,,,,2,2,1,3
5465_0,,,,2,2,1,3
C1(C(C(O)=O)C(C(C1O)=O)CO)=O,,,4,1,1,0,1
5467_0,,,,2,2,1,3
C1(C(C(O)=O)CC(C1(CO)O)=O)=O,,,4,1,1,0,1
5469_0,,,,2,2,1,3
C1(C(C(O)=O)C(C(C1)=O)(CO)O)=O,,,4,1,2,0,2
5469_1,,,,2,2,1,3
5471_0,,,,2,2,1,3
C1(C(CO)(CC(C1C(O)=O)=O)O)=O,,,4,1,2,0,2
5471_1,,,,2,2,1,3
5473_0,,,,2,2,1,3
C1(CC(C(C(CC(O)=O)=O)O1)O)=O,,,4,1,1,0,1
5475_0,,,,2,2,1,3
C(C(C=O)C1C(CC(O1)=O)O)(O)=O,,,4,1,2,0,2
5475_1,,,,2,2,1,3
5477_0,,,,2,2,1,3
C(C1C(C(C(C(C)=O)O1)O)=O)(O)=O,,,4,1,2,0,2
5477_1,,,,2,2,1,3
5479_0,,,,2,2,1,3
C(CC(C1C(C(CO1)=O)O)=O)(O)=O,,,4,1,1,0,1
5481_0,,,,2,2,1,3
C(CC1C(C(C(C(O)=O)O1)=O)O)=O,,,4,1,2,0,2
5481_1,,,,2,2,1,3
5483_0,,,,2,2,1,3
C(C(C=O)C1C(C(CO1)=O)O)(O)=O,,,4,1,2,0,2
5483_1,,,,2,2,1,3
5485_0,,,,2,2,1,3
C(C1C(C(O)OC1C(C)=O)=O)(O)=O,,,4,1,2,0,2
5485_1,,,,2,2,1,3
5487_0,,,,2,2,1,3
C(CC(C1CC(C(O)O1)=O)=O)(O)=O,,,4,1,1,0,1
5489_0,,,,2,2,1,3
C(CC1C(C(O)=O)C(C(O)O1)=O)=O,,,4,1,2,0,2
5489_1,,,,2,2,1,3
5491_0,,,,2,2,1,3
C(C(C=O)C1CC(C(O)O1)=O)(O)=O,,,4,1,2,0,2
5491_1,,,,2,2,1,3
5493_0,,,,2,2,1,3
C(C1C(C(C(C)=O)OC1O)=O)(O)=O,,,4,1,2,0,2
5493_1,,,,2,2,1,3
5495_0,,,,2,2,1,3
C(CC(C1C(CC(O1)O)=O)=O)(O)=O,,,4,1,1,0,1
5497_0,,,,2,2,1,3
C(CC1C(C(C(O)=O)C(O1)O)=O)=O,,,4,1,2,0,2
5497_1,,,,2,2,1,3
5499_0,,,,2,2,1,3
C(C(C=O)C1C(CC(O1)O)=O)(O)=O,,,4,1,2,0,2
5499_1,,,,2,2,1,3
5501_0,,,,2,2,1,3
C1(C(C(O)=O)C(CC(CO)O1)=O)=O,,,4,1,2,0,2
5501_1,,,,2,2,1,3
5503_0,,,,2,2,1,3
C(C1C(CC(OC1CO)=O)=O)(O)=O,,,4,1,2,0,2
5503_1,,,,2,2,1,3
5505_0,,,,2,2,1,3
C(C1C(C(CO)OC(C1)=O)=O)(O)=O,,,4,1,1,0,1
5507_0,,,,2,2,1,3
C(C1C(C(CC(CO)O1)=O)=O)(O)=O,,,4,1,2,0,2
5507_1,,,,2,2,1,3
5509_0,,,,2,2,1,3
C(C1C(C(COC1CO)=O)=O)(O)=O,,,4,1,2,0,2
5509_1,,,,2,2,1,3
5511_0,,,,2,2,1,3
C1(C(C(O)=O)OC(C(C1)=O)CO)=O,,,4,1,2,0,2
5511_1,,,,2,2,1,3
5513_0,,,,2,2,1,3
C1(C(CO)OCC(C1C(O)=O)=O)=O,,,4,1,2,0,2
5513_1,,,,2,2,1,3
5515_0,,,,2,2,1,3
C1(C(C(O)=O)C(CC(CO1)O)=O)=O,,,4,1,2,0,2
5515_1,,,,2,2,1,3
5517_0,,,,2,2,1,3
C(C1C(CC(OCC1O)=O)=O)(O)=O,,,4,1,2,0,2
5517_1,,,,2,2,1,3
5519_0,,,,2,2,1,3
C1(C(COC(CC1C(O)=O)=O)O)=O,,,4,1,1,0,1
5521_0,,,,2,2,1,3
C1(CC(C(C(C(O)=O)CO1)=O)O)=O,,,4,1,2,0,2
5521_1,,,,2,2,1,3
5523_0,,,,2,2,1,3
C1(CC(C(C(O)=O)C(CO1)=O)O)=O,,,4,1,2,0,2
5523_1,,,,2,2,1,3
5525_0,,,,2,2,1,3
C(C1C(CC(CC(O1)=O)O)=O)(O)=O,,,4,1,2,0,2
5525_1,,,,2,2,1,3
5527_0,,,,2,2,1,3
C(C1C(C(CC(CO1)O)=O)=O)(O)=O,,,4,1,2,0,2
5527_1,,,,2,2,1,3
5529_0,,,,2,2,1,3
C(C1C(C(COCC1O)=O)=O)(O)=O,,,4,1,2,0,2
5529_1,,,,2,2,1,3
5531_0,,,,2,2,1,3
C1(C(C(O)=O)OCC(C(C1)=O)O)=O,,,4,1,2,0,2
5531_1,,,,2,2,1,3
5533_0,,,,2,2,1,3
C1(C(COCC(C1C(O)=O)=O)O)=O,,,4,1,2,0,2
5533_1,,,,2,2,1,3
5535_0,,,,2,2,1,3
C1(C(C(O)=O)OCCC(C1O)=O)=O,,,4,1,2,0,2
5535_1,,,,2,2,1,3
5537_0,,,,2,2,1,3
C(C1C(C(C(COC1)=O)O)=O)(O)=O,,,4,1,2,0,2
5537_1,,,,2,2,1,3
5539_0,,,,2,2,1,3
C(C1C(C(CC(CO1)=O)O)=O)(O)=O,,,4,1,2,0,2
5539_1,,,,2,2,1,3
5541_0,,,,2,2,1,3
C(C1C(COCC(C1O)=O)=O)(O)=O,,,4,1,2,0,2
5541_1,,,,2,2,1,3
5543_0,,,,2,2,1,3
C(C1C(CC(C(CO1)=O)O)=O)(O)=O,,,4,1,2,0,2
5543_1,,,,2,2,1,3
5545_0,,,,2,2,1,3
C1(CCOC(C(C1C(O)=O)=O)O)=O,,,4,1,2,0,2
5545_1,,,,2,2,1,3
5547_0,,,,2,2,1,3
C(C1C(CC(C(O)OC1)=O)=O)(O)=O,,,4,1,2,0,2
5547_1,,,,2,2,1,3
5549_0,,,,2,2,1,3
C(C1C(C(O)OCC(C1)=O)=O)(O)=O,,,4,1,1,0,1
5551_0,,,,2,2,1,3
C(C1C(COC(C(C1)=O)O)=O)(O)=O,,,4,1,1,0,1
5553_0,,,,2,2,1,3
C(C1C(CCC(C(O1)O)=O)=O)(O)=O,,,4,1,2,0,2
5553_1,,,,2,2,1,3
5555_0,,,,2,2,1,3
C(C1C(C(CCOC1O)=O)=O)(O)=O,,,4,1,2,0,2
5555_1,,,,2,2,1,3
5557_0,,,,2,2,1,3
C(C1C(C(CC(O)OC1)=O)=O)(O)=O,,,4,1,2,0,2
5557_1,,,,2,2,1,3
5559_0,,,,2,2,1,3
C(C1C(CC(COC1O)=O)=O)(O)=O,,,4,1,2,0,2
5559_1,,,,2,2,1,3
5561_0,,,,2,2,1,3
C1(CC(OCC(C1C(O)=O)=O)O)=O,,,4,1,2,0,2
5561_1,,,,2,2,1,3
5563_0,,,,2,2,1,3
C1(C(C(O)=O)OC(CC(C1)=O)O)=O,,,4,1,2,0,2
5563_1,,,,2,2,1,3
5565_0,,,,2,2,1,3
C(C(C(C)=O)C(C(C=O)=O)=O)(O)=O,,,4,1,2,0,2
5565_1,,,,2,2,1,3
5567_0,,,,2,2,1,3
C(CC(CC(C(C=O)=O)=O)=O)(O)=O,,,4,1,1,0,1
5569_0,,,,2,2,1,3
C(C(C(C(C=O)=O)=O)CC=O)(O)=O,,,4,1,1,0,1
5571_0,,,,2,2,1,3
C(C(C(O)=O)CC(C(C=O)=O)=O)=O,,,4,1,1,0,1
5573_0,,,,2,2,1,3
C(C(C(C=O)=O)C(C(C)=O)=O)(O)=O,,,4,1,2,0,2
5573_1,,,,2,2,1,3
5575_0,,,,2,2,1,3
C(CC(C(CC(C=O)=O)=O)=O)(O)=O,,,4,1,1,0,1
5577_0,,,,2,2,1,3
C(C(C(CC=O)=O)C(C=O)=O)(O)=O,,,4,1,2,0,2
5577_1,,,,2,2,1,3
5579_0,,,,2,2,1,3
C(C(C(O)=O)C(CC(C=O)=O)=O)=O,,,4,1,2,0,2
5579_1,,,,2,2,1,3
5581_0,,,,2,2,1,3
C(CC(C=CC(C=O)=O)=O)(O)=O,,,4,1,1,0,1
5583_0,,,,2,2,1,3
C(C(C(O)=O)C=CC(C=O)=O)=O,,,4,1,1,0,1
5585_0,,,,2,2,1,3
C(CC(C(C=CC=O)=O)=O)(O)=O,,,4,1,1,0,1
5587_0,,,,2,2,1,3
C(C(C(O)=O)C(C=CC=O)=O)=O,,,4,1,2,0,2
5587_1,,,,2,2,1,3
5589_0,,,,2,2,1,3
C(C(C(C=O)=O)C(C=C)=O)(O)=O,,,4,1,2,0,2
5589_1,,,,2,2,1,3
5591_0,,,,2,2,1,3
C(C(C(O)=O)C(C(C=C)=O)=O)=O,,,4,1,2,0,2
5591_1,,,,2,2,1,3
5593_0,,,,2,2,1,3
C(C(C=CC=O)C(C=O)=O)(O)=O,,,4,1,1,0,1
5595_0,,,,2,2,1,3
C(C(C(C=CC(O)=O)=O)CO)(O)=O,,,4,1,2,0,2
5595_1,,,,2,2,1,3
5597_0,,,,2,2,1,3
C(C(C(CO)=O)C=CC(O)=O)(O)=O,,,4,1,1,0,1
5599_0,,,,2,2,1,3
C(C(C(CC=CC(O)=O)=O)O)(O)=O,,,4,1,2,0,2
5599_1,,,,2,2,1,3
5601_0,,,,2,2,1,3
C(CC(C(C=CC(O)=O)O)=O)(O)=O,,,4,1,1,0,1
5603_0,,,,2,2,1,3
C(C(C=O)C(C=CC(O)=O)O)(O)=O,,,4,1,2,0,2
5603_1,,,,2,2,1,3
5605_0,,,,2,2,1,3
C(CC(C=CC(C(O)=O)O)=O)(O)=O,,,4,1,1,0,1
5607_0,,,,2,2,1,3
C(C(C=O)C=CC(C(O)=O)O)(O)=O,,,4,1,1,0,1
5609_0,,,,2,2,1,3
C(C1C(C(CO1)O)=O)(O)=O,,,4,1,2,0,2
5609_1,,,,2,2,1,3
5611_0,,,,2,2,1,3
C(C1C(C(O)OC1)=O)(O)=O,,,4,1,2,0,2
5611_1,,,,2,2,1,3
5613_0,,,,2,2,1,3
C(C(C=O)C1C(C(CO1)O)=O)(O)=O,,,4,1,2,0,2
5613_1,,,,2,2,1,3
5615_0,,,,2,2,1,3
C(C(C=O)C1(C(CCO1)=O)O)(O)=O,,,4,1,2,0,2
5615_1,,,,2,2,1,3
5617_0,,,,2,2,1,3
C(CC1(C(C(C(O)=O)CO1)=O)O)=O,,,4,1,2,0,2
5617_1,,,,2,2,1,3
5619_0,,,,2,2,1,3
C(C(C=O)C1(CC(CO1)=O)O)(O)=O,,,4,1,2,0,2
5619_1,,,,2,2,1,3
5621_0,,,,2,2,1,3
C(CC1(C(C(O)=O)C(CO1)=O)O)=O,,,4,1,2,0,2
5621_1,,,,2,2,1,3
5623_0,,,,2,2,1,3
C(C1C(CC(CC=O)(O1)O)=O)(O)=O,,,4,1,2,0,2
5623_1,,,,2,2,1,3
5625_0,,,,2,2,1,3
C(C1C(C(C=O)OC1(C)O)=O)(O)=O,,,4,1,2,0,2
5625_1,,,,2,2,1,3
5627_0,,,,2,2,1,3
C1(C(C)(OC(C=O)C1C(O)=O)O)=O,,,4,1,2,0,2
5627_1,,,,2,2,1,3
5629_0,,,,2,2,1,3
C1(CCOC(C=O)(C1C(O)=O)O)=O,,,4,1,2,0,2
5629_1,,,,2,2,1,3
5631_0,,,,2,2,1,3
C1(CC(C=O)(O)OCC1C(O)=O)=O,,,4,1,2,0,2
5631_1,,,,2,2,1,3
5633_0,,,,2,2,1,3
C(C1(CC(C(O)=O)C(CO1)=O)O)=O,,,4,1,1,0,1
5635_0,,,,2,2,1,3
C1(CCC(C=O)(OC1C(O)=O)O)=O,,,4,1,2,0,2
5635_1,,,,2,2,1,3
5637_0,,,,2,2,1,3
C(C1C(C(C=O)OC(C1)O)=O)(O)=O,,,4,1,1,0,1
5639_0,,,,2,2,1,3
C1(CC(OC(C=O)C1C(O)=O)O)=O,,,4,1,2,0,2
5639_1,,,,2,2,1,3
5641_0,,,,2,2,1,3
C1(CC(C=O)OC(C1C(O)=O)O)=O,,,4,1,2,0,2
5641_1,,,,2,2,1,3
5643_0,,,,2,2,1,3
C1(C(CC(C(CC(O)=O)=O)O1)O)=O,,,4,1,1,0,1
5645_0,,,,2,2,1,3
C(C(C=O)C1CC(C(O1)=O)O)(O)=O,,,4,1,2,0,2
5645_1,,,,2,2,1,3
5647_0,,,,2,2,1,3
C1(CCOC(C(C1C(O)=O)O)=O)=O,,,4,1,2,0,2
5647_1,,,,2,2,1,3
5649_0,,,,2,2,1,3
C1(CC(C(OCC1C(O)=O)=O)O)=O,,,4,1,2,0,2
5649_1,,,,2,2,1,3
5651_0,,,,2,2,1,3
C1(C(CC(C(O)=O)C(CO1)=O)O)=O,,,4,1,1,0,1
5653_0,,,,2,2,1,3
C(C1C(CCC(C(O1)=O)O)=O)(O)=O,,,4,1,2,0,2
5653_1,,,,2,2,1,3
5655_0,,,,2,2,1,3
C(C(CC(C(O)=O)C(CO)=O)O)=O,,,4,1,1,0,1
5657_0,,,,2,2,1,3
C(CCC(C=O)O)(C(C(O)=O)O)=O,,,4,1,2,0,2
5657_1,,,,2,2,1,3
5659_0,,,,2,2,1,3
C(CC(C(CC(C=O)O)O)=O)(O)=O,,,4,1,1,0,1
5661_0,,,,2,2,1,3
C(C1C(C=CC(C(O1)O)O)=O)(O)=O,,,4,1,2,0,2
5661_1,,,,2,2,1,3
5663_0,,,,2,2,1,3
C(C(C(C=C)=O)C(C(O)=O)O)(O)=O,,,4,1,2,0,2
5663_1,,,,2,2,1,3
5665_0,,,,2,2,1,3
C(C(C(C=CC(C=O)=O)=O)O)(O)=O,,,4,1,2,0,2
5665_1,,,,2,2,1,3
5666_0,,,,2,2,1,3
5666_1,,,,2,2,1,3
5667_0,,,,2,2,1,3
5667_1,,,,2,2,1,3
5669_0,,,,2,2,1,3
C(C(C(CO)=O)C(C(C)O)O)(O)=O,,,4,1,2,0,2
5669_1,,,,2,2,1,3
5671_0,,,,2,2,1,3
C(CC(C(C(C(C)O)O)O)=O)(O)=O,,,4,1,2,0,2
5671_1,,,,2,2,1,3
5672_0,,,,2,2,1,3
5674_0,,,,2,2,1,3
C(C(C(CC(C(C)O)O)=O)O)(O)=O,,,4,1,1,0,1
5676_0,,,,2,2,1,3
C(C(C(C(C(O)=O)=O)O)O)(O)=O,,,4,1,2,0,2
5676_1,,,,2,2,1,3
5678_0,,,,2,2,1,3
C(C(C(C(C)=O)C(C=O)=O)O)(O)=O,,,4,1,2,0,2
5678_1,,,,2,2,1,3
5680_0,,,,2,2,1,3
C(C(CC(CC(C=O)=O)=O)O)(O)=O,,,4,1,1,0,1
5682_0,,,,2,2,1,3
C(C(C(C=O)=O)C(C(O)=O)O)=O,,,4,1,2,0,2
5682_1,,,,2,2,1,3
5684_0,,,,2,2,1,3
C(C(C(C(C)=O)=O)C(C(O)=O)O)=O,,,4,1,2,0,2
5684_1,,,,2,2,1,3
5686_0,,,,2,2,1,3
C(CC(C(CC(C(O)=O)O)=O)=O)=O,,,4,1,1,0,1
5687_0,,,,2,2,1,3
5688_0,,,,2,2,1,3
5690_0,,,,2,2,1,3
C(C(C(C)=O)C(C(O)=O)O)=O,,,4,1,2,0,2
5690_1,,,,2,2,1,3
5692_0,,,,2,2,1,3
C1(COC(C1C(C(O)=O)O)O)=O,,,4,1,2,0,2
5692_1,,,,2,2,1,3
5694_0,,,,2,2,1,3
C(C(C1C(CC(O1)O)=O)O)(O)=O,,,4,1,2,0,2
5694_1,,,,2,2,1,3
5695_0,,,,2,2,1,3
5697_0,,,,2,2,1,3
C(C)(C(CO)C(C(O)=O)O)=O,,,4,1,5,0,5
5697_1,,,,2,2,1,3
5699_0,,,,2,2,1,3
C(C(C(C=O)C(C(O)=O)O)O)(O)=O,,,4,1,2,0,2
5699_1,,,,2,2,1,3
5701_0,,,,2,2,1,3
C(C(CC(C(C=O)=O)=O)O)(O)=O,,,4,1,1,0,1
5703_0,,,,2,2,1,3
C(C(C(C(C=CC=O)=O)O)O)(O)=O,,,4,1,2,0,2
5703_1,,,,2,2,1,3
5704_0,,,,2,2,1,3
5704_1,,,,2,2,1,3
5706_0,,,,2,2,1,3
C(C(C(C(C(O)=O)=O)CO)O)(O)=O,,,4,1,2,0,2
5706_1,,,,2,2,1,3
5708_0,,,,2,2,1,3
C(C(C1C(C(CO1)O)=O)O)(O)=O,,,4,1,2,0,2
5708_1,,,,2,2,1,3
5710_0,,,,2,2,1,3
C1(C(O)OCC1C(C(O)=O)O)=O,,,4,1,2,0,2
5710_1,,,,2,2,1,3
5712_0,,,,2,2,1,3
C(C(C(CC(C(C)=O)=O)O)O)(O)=O,,,4,1,2,0,2
5714_0,,,,2,2,1,3
C(CC(C(C(O)=O)O)O)(CC=O)=O,,,4,1,1,0,1
5716_0,,,,2,2,1,3
C(C(C(C(C=O)C(C)=O)O)O)(O)=O,,,4,1,2,0,2
5716_1,,,,2,2,1,3
5718_0,,,,2,2,1,3
C(CCO)(CC(C(C(O)=O)O)O)=O,,,4,1,1,0,1
5720_0,,,,2,2,1,3
C(C(C(C(C(C)=O)CO)O)O)(O)=O,,,4,1,2,0,2
5720_1,,,,2,2,1,3
5722_0,,,,2,2,1,3
C(C(C(C(C(C=C)=O)O)O)O)(O)=O,,,4,1,2,0,2
5722_1,,,,2,2,1,3
5724_0,,,,2,2,1,3
C(C)(C(C)(C(C(C(O)=O)=O)O)O)=O,,,4,1,2,0,2
5724_1,,,,2,2,1,3
5726_0,,,,2,2,1,3
C(C(CO)(CC(C(C)=O)=O)O)(O)=O,,,4,1,3,0,3
5728_0,,,,2,2,1,3
C(CC(C)(C(C(C(O)=O)=O)O)O)=O,,,4,1,2,0,2
5728_1,,,,2,2,1,3
5730_0,,,,2,2,1,3
C(C)(CC(C(C(C(O)=O)=O)O)O)=O,,,4,1,2,0,2
5730_1,,,,2,2,1,3
5732_0,,,,2,2,1,3
C(C(CO)(CC(CC=O)=O)O)(O)=O,,,4,1,3,0,3
5734_0,,,,2,2,1,3
C(C(CO)(C(C=O)C(C)=O)O)(O)=O,,,4,1,2,0,2
5734_1,,,,2,2,1,3
5736_0,,,,2,2,1,3
C(C(C(C(C)(CCO)O)O)=O)(O)=O,,,4,1,2,0,2
5736_1,,,,2,2,1,3
5737_0,,,,2,2,1,3
5739_0,,,,2,2,1,3
C(C(CO)(C(C(C)=O)CO)O)(O)=O,,,4,1,2,0,2
5739_1,,,,2,2,1,3
5741_0,,,,2,2,1,3
C(C(C(C(C(C=O)=O)O)O)=O)(O)=O,,,4,1,2,0,2
5741_1,,,,2,2,1,3
5743_0,,,,2,2,1,3
C(C(C=O)(C(C(C(O)=O)=O)O)O)=O,,,4,1,2,0,2
5743_1,,,,2,2,1,3
5745_0,,,,2,2,1,3
C=CC(C(C(C(C(O)=O)=O)O)O)=O,,,4,1,2,0,2
5745_1,,,,2,2,1,3
5747_0,,,,2,2,1,3
C(C(C=C)(C(C(C(O)=O)=O)O)O)=O,,,4,1,2,0,2
5747_1,,,,2,2,1,3
5749_0,,,,2,2,1,3
C(C(CO)(C(C(C(O)=O)=O)O)O)=C,,,4,1,2,0,2
5749_1,,,,2,2,1,3
5751_0,,,,2,2,1,3
C(C(CO)(C(C(C=C)=O)O)O)(O)=O,,,4,1,7,0,7
5751_1,,,,2,2,1,3
5753_0,,,,2,2,1,3
C(C(C(C(C(O)=O)=O)O)O)=CC=O,,,4,1,2,0,2
5753_1,,,,2,2,1,3
5755_0,,,,2,2,1,3
C(C(C(C(C(C)O)O)O)=O)(O)=O,,,4,1,2,0,2
5755_1,,,,2,2,1,3
5757_0,,,,2,2,1,3
C(C)(C(C(C=O)=O)C(C(C=C)=O)O)=O,,,4,1,2,0,2
5757_1,,,,2,2,1,3
5759_0,,,,2,2,1,3
C(CC(C(C=C)=O)O)(CC(C=O)=O)=O,,,4,1,1,0,1
5761_0,,,,2,2,1,3
C(C(C=C)(C(C(C)=O)C(C=O)=O)O)=O,,,4,1,2,0,2
5761_1,,,,2,2,1,3
5763_0,,,,2,2,1,3
C(C(C=C)(CC(CC(C=O)=O)=O)O)=O,,,4,1,1,0,1
5765_0,,,,2,2,1,3
C(C)(C(C(C=O)=O)C(C=CC=O)O)=O,,,4,1,2,0,2
5765_1,,,,2,2,1,3
5767_0,,,,2,2,1,3
C(CC(C=CC=O)O)(CC(C=O)=O)=O,,,4,1,1,0,1
5769_0,,,,2,2,1,3
C(C)(C(C(C=O)=O)C(C(C)O)O)=O,,,4,1,2,0,2
5769_1,,,,2,2,1,3
5771_0,,,,2,2,1,3
C(CC(C(C)O)O)(CC(C=O)=O)=O,,,4,1,1,0,1
5773_0,,,,2,2,1,3
C(C(C(C=O)=O)C(C(C)=O)(C)O)=O,,,4,1,2,0,2
5773_1,,,,2,2,1,3
5775_0,,,,2,2,1,3
C(CC(C(CC(C(C)=O)=O)O)=O)=O,,,4,1,1,0,1
5777_0,,,,2,2,1,3
C(CC(C=O)(CC(C(C)=O)=O)O)=O,,,4,1,2,0,2
5779_0,,,,2,2,1,3
C(C=O)(CC(CC(C(C)=O)=O)O)=O,,,4,1,2,0,2
5781_0,,,,2,2,1,3
C(C(C(C=O)=O)C(C)(CC=O)O)=O,,,4,1,2,0,2
5781_1,,,,2,2,1,3
5783_0,,,,2,2,1,3
C(C(C(C=O)=O)C(CC(C)=O)O)=O,,,4,1,2,0,2
5783_1,,,,2,2,1,3
5785_0,,,,2,2,1,3
C(CC(CC(C(CC=O)=O)O)=O)=O,,,4,1,1,0,1
5787_0,,,,2,2,1,3
C(CC(CC(C=O)(CC=O)O)=O)=O,,,4,1,2,0,2
5789_0,,,,2,2,1,3
C(CC(CC(CC(C=O)=O)O)=O)=O,,,4,1,1,0,1
5791_0,,,,2,2,1,3
C(C(C(C)=O)C(C(CC=O)=O)O)=O,,,4,1,2,0,2
5791_1,,,,2,2,1,3
5793_0,,,,2,2,1,3
C(C(C(C)=O)C(C=O)(CC=O)O)=O,,,4,1,2,0,2
5793_1,,,,2,2,1,3
5795_0,,,,2,2,1,3
C(C(C(C)=O)C(CC(C=O)=O)O)=O,,,4,1,2,0,2
5795_1,,,,2,2,1,3
5797_0,,,,2,2,1,3
C(C(C(C=O)=O)C(C)(CCO)O)=O,,,4,1,2,0,2
5797_1,,,,2,2,1,3
5799_0,,,,2,2,1,3
C(CC(C(CC=O)=O)O)(CCO)=O,,,4,1,2,0,2
5800_0,,,,2,2,1,3
5802_0,,,,2,2,1,3
C(CCO)(CC(CC(C=O)=O)O)=O,,,4,1,1,0,1
5804_0,,,,2,2,1,3
C(C)(C(CO)C(C(CC=O)=O)O)=O,,,4,1,2,0,2
5804_1,,,,2,2,1,3
5806_0,,,,2,2,1,3
C(C)(C(CO)C(C=O)(CC=O)O)=O,,,4,1,2,0,2
5806_1,,,,2,2,1,3
5808_0,,,,2,2,1,3
C(C)(C(CO)C(CC(C=O)=O)O)=O,,,4,1,2,0,2
5808_1,,,,2,2,1,3
5810_0,,,,2,2,1,3
C(C(C(C=O)=O)C(C(C=O)=O)O)=O,,,4,1,2,0,2
5810_1,,,,2,2,1,3
5812_0,,,,2,2,1,3
C(C(C(C=O)=O)C(C=O)(C=O)O)=O,,,4,1,2,0,2
5812_1,,,,2,2,1,3
5814_0,,,,2,2,1,3
C(C(C(C=O)=O)C(C(C=C)=O)O)=O,,,4,1,2,0,2
5814_1,,,,2,2,1,3
5816_0,,,,2,2,1,3
C(C(C(C=O)=O)C(C=O)(C=C)O)=O,,,4,1,2,0,2
5816_1,,,,2,2,1,3
5818_0,,,,2,2,1,3
C(C(C(C=O)=O)C(C=C)(CO)O)=O,,,4,1,2,0,2
5818_1,,,,2,2,1,3
5820_0,,,,2,2,1,3
C(CC(C(C(C(C=C)=O)O)O)=O)=O,,,4,1,4,0,4
5820_1,,,,2,2,1,3
5822_0,,,,2,2,1,3
C(CC(C=O)(C(C(C=C)=O)O)O)=O,,,4,1,4,0,4
5822_1,,,,2,2,1,3
5824_0,,,,2,2,1,3
C=CC(C(C(CC(C=O)=O)O)O)=O,,,4,1,2,0,2
5824_1,,,,2,2,1,3
5826_0,,,,2,2,1,3
C(C(C(C=O)=O)C(C=CC=O)O)=O,,,4,1,2,0,2
5826_1,,,,2,2,1,3
5828_0,,,,2,2,1,3
C(C(C(C=O)=O)C(C(C)O)O)=O,,,4,1,2,0,2
5828_1,,,,2,2,1,3
5830_0,,,,2,2,1,3
C(C(C(C(C)=O)=O)C(C(C=C)=O)O)=O,,,4,1,2,0,2
5830_1,,,,2,2,1,3
5832_0,,,,2,2,1,3
C(CC(C(CC(C(C=C)=O)O)=O)=O)=O,,,4,1,1,0,1
5834_0,,,,2,2,1,3
C(C(C(C(C)=O)=O)C(C=O)(C=C)O)=O,,,4,1,2,0,2
5834_1,,,,2,2,1,3
5836_0,,,,2,2,1,3
C(C(C=C)(CC(C(CC=O)=O)=O)O)=O,,,4,1,1,0,1
5838_0,,,,2,2,1,3
C(C(C(C(C)=O)=O)C(C=CC=O)O)=O,,,4,1,2,0,2
5838_1,,,,2,2,1,3
5840_0,,,,2,2,1,3
C(CC(C(CC(C=CC=O)O)=O)=O)=O,,,4,1,1,0,1
5842_0,,,,2,2,1,3
C(C(C(C(C)=O)=O)C(C(C)O)O)=O,,,4,1,2,0,2
5842_1,,,,2,2,1,3
5844_0,,,,2,2,1,3
C(CC(C(CC(C(C)O)O)=O)=O)=O,,,4,1,1,0,1
5846_0,,,,2,2,1,3
C(C)(C(C)(CC(C(C)=O)=O)O)=O,,,4,1,1,0,1
5848_0,,,,2,2,1,3
C(CC(C)(CC(C(C)=O)=O)O)=O,,,4,1,1,0,1
5850_0,,,,2,2,1,3
C(C)(CC(CC(C(C)=O)=O)O)=O,,,4,1,1,0,1
5852_0,,,,2,2,1,3
C(C)(C(C)(CC(CC=O)=O)O)=O,,,4,1,1,0,1
5854_0,,,,2,2,1,3
C(C(C(C)=O)C(C(C)=O)(C)O)=O,,,4,1,2,0,2
5854_1,,,,2,2,1,3
5856_0,,,,2,2,1,3
C(C(C)=O)(CC1(COC(C1)O)O)=O,,,4,1,1,0,1
5858_0,,,,2,2,1,3
C(C)(C(C)(C1C(COC1O)=O)O)=O,,,4,1,2,0,2
5858_1,,,,2,2,1,3
5860_0,,,,2,2,1,3
C(C)(C(C)(C1C(CC(O1)O)=O)O)=O,,,4,1,2,0,2
5860_1,,,,2,2,1,3
5862_0,,,,2,2,1,3
C(C(C)=O)(CC(C)(CCO)O)=O,,,4,1,1,0,1
5864_0,,,,2,2,1,3
C(C)(C(C)(CC(CCO)=O)O)=O,,,4,1,1,0,1
5866_0,,,,2,2,1,3
C(C)(C(CO)C(C(C)=O)(C)O)=O,,,4,1,2,0,2
5866_1,,,,2,2,1,3
5868_0,,,,2,2,1,3
C(C(C(CC(C(C)=O)=O)O)=O)(C)=O,,,4,1,1,0,1
5870_0,,,,2,2,1,3
C(C(C(C)=O)(CC(C(C)=O)=O)O)=O,,,4,1,1,0,1
5872_0,,,,2,2,1,3
C(C(CC(C(C=O)=O)(C)O)=O)(C)=O,,,4,1,1,0,1
5874_0,,,,2,2,1,3
C(C)(C(C)(CC(C(C=O)=O)=O)O)=O,,,4,1,1,0,1
5876_0,,,,2,2,1,3
C(C(C(CC(C(C)=O)=O)O)=O)=O,,,4,1,3,0,3
5878_0,,,,2,2,1,3
C(C(C=O)(CC(C(C)=O)=O)O)=O,,,4,1,2,0,2
5880_0,,,,2,2,1,3
C=CC(C(CC(C(C)=O)=O)O)=O,,,4,1,1,0,1
5882_0,,,,2,2,1,3
C(C(C=C)(CC(C(C)=O)=O)O)=O,,,4,1,2,0,2
5884_0,,,,2,2,1,3
C(C(CO)(CC(C(C)=O)=O)O)=C,,,4,1,1,0,1
5886_0,,,,2,2,1,3
C(C)(C(C)(C(C(C=C)=O)O)O)=O,,,4,1,2,0,2
5886_1,,,,2,2,1,3
5888_0,,,,2,2,1,3
C(C(CC(C(C)=O)=O)O)=CC=O,,,4,1,2,0,2
5890_0,,,,2,2,1,3
C(C(C)=O)(CC(C(C)O)O)=O,,,4,1,1,0,1
5892_0,,,,2,2,1,3
C(C(C)=O)(CC1(COCC1O)O)=O,,,4,1,1,0,1
5894_0,,,,2,2,1,3
C(C)(C(C)(C1C(C(CO1)O)=O)O)=O,,,4,1,2,0,2
5894_1,,,,2,2,1,3
5896_0,,,,2,2,1,3
C(C(C)=O)(CC1(C(O)OCC1)O)=O,,,4,1,1,0,1
5898_0,,,,2,2,1,3
C(C)(C(C)(C1C(C(O)OC1)=O)O)=O,,,4,1,2,0,2
5898_1,,,,2,2,1,3
5900_0,,,,2,2,1,3
C(CC(CC(C)(CC=O)O)=O)=O,,,4,1,1,0,1
5902_0,,,,2,2,1,3
C(CC(C)(C(C=O)C(C)=O)O)=O,,,4,1,2,0,2
5902_1,,,,2,2,1,3
5904_0,,,,2,2,1,3
C(CC(CC(C)=O)O)(CC=O)=O,,,4,1,1,0,1
5906_0,,,,2,2,1,3
C(C(C(C)=O)C(CC(C)=O)O)=O,,,4,1,2,0,2
5906_1,,,,2,2,1,3
5908_0,,,,2,2,1,3
C(CC(CC1(COC(C1)O)O)=O)=O,,,4,1,2,0,2
5910_0,,,,2,2,1,3
C(C(C(C)=O)C1(COC(C1)O)O)=O,,,4,1,2,0,2
5910_1,,,,2,2,1,3
5912_0,,,,2,2,1,3
C(CC(C)(C1C(COC1O)=O)O)=O,,,4,1,2,0,2
5912_1,,,,2,2,1,3
5914_0,,,,2,2,1,3
C(C)(CC(C1C(COC1O)=O)O)=O,,,4,1,2,0,2
5914_1,,,,2,2,1,3
5916_0,,,,2,2,1,3
C(CC(C)(C1C(CC(O1)O)=O)O)=O,,,4,1,4,0,4
5916_1,,,,2,2,1,3
5918_0,,,,2,2,1,3
C1(C(C(CC(C)=O)O)OC(C1)O)=O,,,4,1,2,0,2
5918_1,,,,2,2,1,3
5920_0,,,,2,2,1,3
C(CC(CC(C)(CCO)O)=O)=O,,,4,1,1,0,1
5922_0,,,,2,2,1,3
C(C(C(C)=O)C(C)(CCO)O)=O,,,4,1,2,0,2
5922_1,,,,2,2,1,3
5924_0,,,,2,2,1,3
C(CC(C)(CC(CCO)=O)O)=O,,,4,1,1,0,1
5926_0,,,,2,2,1,3
C(CCO)(CC(CC(C)=O)O)=O,,,4,1,1,0,1
5928_0,,,,2,2,1,3
C(CC(C)(C(C(C)=O)CO)O)=O,,,4,1,2,0,2
5928_1,,,,2,2,1,3
5930_0,,,,2,2,1,3
C(C)(C(CO)C(CC(C)=O)O)=O,,,4,1,2,0,2
5930_1,,,,2,2,1,3
5932_0,,,,2,2,1,3
C(CC(CC(C(C(C)=O)=O)O)=O)=O,,,4,1,1,0,1
5934_0,,,,2,2,1,3
C(C(C(C)=O)C(C(C(C)=O)=O)O)=O,,,4,1,2,0,2
5934_1,,,,2,2,1,3
5936_0,,,,2,2,1,3
C(C(C(C)=O)(CC(CC=O)=O)O)=O,,,4,1,1,0,1
5938_0,,,,2,2,1,3
C(C(C(C)=O)C(C=O)(C(C)=O)O)=O,,,4,1,2,0,2
5938_1,,,,2,2,1,3
5940_0,,,,2,2,1,3
C(CC(CC(C(C=O)=O)(C)O)=O)=O,,,4,1,1,0,1
5942_0,,,,2,2,1,3
C(C(C(C)=O)C(C(C=O)=O)(C)O)=O,,,4,1,2,0,2
5942_1,,,,2,2,1,3
5944_0,,,,2,2,1,3
C(CC(C)(CC(C(C=O)=O)=O)O)=O,,,4,1,2,0,2
5946_0,,,,2,2,1,3
C(C)(CC(CC(C(C=O)=O)=O)O)=O,,,4,1,1,0,1
5948_0,,,,2,2,1,3
C(CC(CC(C(C=O)=O)O)=O)=O,,,4,1,3,0,3
5950_0,,,,2,2,1,3
C(C(C(C)=O)C(C(C=O)=O)O)=O,,,4,1,3,0,3
5950_1,,,,2,2,1,3
5952_0,,,,2,2,1,3
C(C(C=O)(CC(CC=O)=O)O)=O,,,4,1,2,0,2
5954_0,,,,2,2,1,3
C(C(C(C)=O)C(C=O)(C=O)O)=O,,,4,1,2,0,2
5954_1,,,,2,2,1,3
5956_0,,,,2,2,1,3
C(CC(CC(C(C=C)=O)O)=O)=O,,,4,1,2,0,2
5958_0,,,,2,2,1,3
C(C(C(C)=O)C(C(C=C)=O)O)=O,,,4,1,3,0,3
5958_1,,,,2,2,1,3
5960_0,,,,2,2,1,3
C(C(C=C)(CC(CC=O)=O)O)=O,,,4,1,2,0,2
5962_0,,,,2,2,1,3
C(C(C(C)=O)C(C=O)(C=C)O)=O,,,4,1,2,0,2
5962_1,,,,2,2,1,3
5964_0,,,,2,2,1,3
C(CC(CC(C=C)(CO)O)=O)=O,,,4,1,1,0,1
5966_0,,,,2,2,1,3
C(C(C(C)=O)C(C=C)(CO)O)=O,,,4,1,2,0,2
5966_1,,,,2,2,1,3
5968_0,,,,2,2,1,3
C(CC(C)(C(C(C=C)=O)O)O)=O,,,4,1,2,0,2
5968_1,,,,2,2,1,3
5970_0,,,,2,2,1,3
C(C)(CC(C(C(C=C)=O)O)O)=O,,,4,1,2,0,2
5970_1,,,,2,2,1,3
5972_0,,,,2,2,1,3
C(CC(CC(C=CC=O)O)=O)=O,,,4,1,3,0,3
5974_0,,,,2,2,1,3
C(C(C(C)=O)C(C=CC=O)O)=O,,,4,1,3,0,3
5974_1,,,,2,2,1,3
5976_0,,,,2,2,1,3
C(CC(CC(C(C)O)O)=O)=O,,,4,1,1,0,1
5978_0,,,,2,2,1,3
C(C(C(C)=O)C(C(C)O)O)=O,,,4,1,2,0,2
5978_1,,,,2,2,1,3
5980_0,,,,2,2,1,3
C(CC(CC1(COCC1O)O)=O)=O,,,4,1,1,0,1
5982_0,,,,2,2,1,3
C(C(C(C)=O)C1(COCC1O)O)=O,,,4,1,2,0,2
5982_1,,,,2,2,1,3
5984_0,,,,2,2,1,3
C(CC(C)(C1C(C(CO1)O)=O)O)=O,,,4,1,2,0,2
5984_1,,,,2,2,1,3
5986_0,,,,2,2,1,3
C1(C(C(CC(C)=O)O)OCC1O)=O,,,4,1,2,0,2
5986_1,,,,2,2,1,3
5988_0,,,,2,2,1,3
C(CC(CC1(C(O)OCC1)O)=O)=O,,,4,1,1,0,1
5990_0,,,,2,2,1,3
C(C(C(C)=O)C1(C(O)OCC1)O)=O,,,4,1,2,0,2
5990_1,,,,2,2,1,3
5992_0,,,,2,2,1,3
C(CC(C)(C1C(C(O)OC1)=O)O)=O,,,4,1,2,0,2
5992_1,,,,2,2,1,3
5994_0,,,,2,2,1,3
C(C)(CC(C1C(C(O)OC1)=O)O)=O,,,4,1,2,0,2
5994_1,,,,2,2,1,3
5996_0,,,,2,2,1,3
C1(COC(C1C(C)(CCO)O)O)=O,,,4,1,2,0,2
5996_1,,,,2,2,1,3
5998_0,,,,2,2,1,3
C1(C(C(C)(CCO)O)OC(C1)O)=O,,,4,1,2,0,2
5998_1,,,,2,2,1,3
6000_0,,,,2,2,1,3
C(CC1(COC(C1)O)O)(CCO)=O,,,4,1,1,0,1
6002_0,,,,2,2,1,3
C(C)(C(CO)C1(COC(C1)O)O)=O,,,4,1,2,0,2
6002_1,,,,2,2,1,3
6004_0,,,,2,2,1,3
C1(COC(C1C(C(C=O)=O)O)O)=O,,,4,1,2,0,2
6004_1,,,,2,2,1,3
6006_0,,,,2,2,1,3
C1(C(C(C(C=O)=O)O)OC(C1)O)=O,,,4,1,2,0,2
6006_1,,,,2,2,1,3
6008_0,,,,2,2,1,3
C(C(C=O)(C1C(COC1O)=O)O)=O,,,4,1,2,0,2
6008_1,,,,2,2,1,3
6010_0,,,,2,2,1,3
C(C(C=O)(C1C(CC(O1)O)=O)O)=O,,,4,1,2,0,2
6010_1,,,,2,2,1,3
6012_0,,,,2,2,1,3
C1(COC(C1C(C(C=C)=O)O)O)=O,,,4,1,2,0,2
6012_1,,,,2,2,1,3
6014_0,,,,2,2,1,3
C1(C(C(C(C=C)=O)O)OC(C1)O)=O,,,4,1,2,0,2
6014_1,,,,2,2,1,3
6016_0,,,,2,2,1,3
C(C(C=C)(C1C(COC1O)=O)O)=O,,,4,1,2,0,2
6016_1,,,,2,2,1,3
6018_0,,,,2,2,1,3
C(C(C=C)(C1C(CC(O1)O)=O)O)=O,,,4,1,2,0,2
6018_1,,,,2,2,1,3
6020_0,,,,2,2,1,3
C1(COC(C1C(C=C)(CO)O)O)=O,,,4,1,2,0,2
6020_1,,,,2,2,1,3
6022_0,,,,2,2,1,3
C1(C(C(C=C)(CO)O)OC(C1)O)=O,,,4,1,2,0,2
6022_1,,,,2,2,1,3
6024_0,,,,2,2,1,3
C=CC(C(C1(COC(C1)O)O)O)=O,,,4,1,2,0,2
6024_1,,,,2,2,1,3
6026_0,,,,2,2,1,3
C1(COC(C1C(C=CC=O)O)O)=O,,,4,1,2,0,2
6026_1,,,,2,2,1,3
6028_0,,,,2,2,1,3
C1(C(C(C=CC=O)O)OC(C1)O)=O,,,4,1,2,0,2
6028_1,,,,2,2,1,3
6030_0,,,,2,2,1,3
C1(COC(C1C(C(C)O)O)O)=O,,,4,1,2,0,2
6030_1,,,,2,2,1,3
6032_0,,,,2,2,1,3
C1(C(C(C(C)O)O)OC(C1)O)=O,,,4,1,2,0,2
6032_1,,,,2,2,1,3
6034_0,,,,2,2,1,3
C(CC(C)(CCO)O)(CCO)=O,,,4,1,1,0,1
6036_0,,,,2,2,1,3
C(C)(C(CO)C(C)(CCO)O)=O,,,4,1,2,0,2
6036_1,,,,2,2,1,3
6038_0,,,,2,2,1,3
C(CC(C(C(C)=O)=O)O)(CCO)=O,,,4,1,1,0,1
6040_0,,,,2,2,1,3
C(C)(C(CO)C(C(C(C)=O)=O)O)=O,,,4,1,2,0,2
6040_1,,,,2,2,1,3
6042_0,,,,2,2,1,3
C(C)(C(C=O)(CC(CCO)=O)O)=O,,,4,1,1,0,1
6044_0,,,,2,2,1,3
C(C(C(C)=O)(C(C(C)=O)CO)O)=O,,,4,1,2,0,2
6044_1,,,,2,2,1,3
6046_0,,,,2,2,1,3
C(CC(C(C=O)=O)(C)O)(CCO)=O,,,4,1,1,0,1
6048_0,,,,2,2,1,3
C(C)(C(CO)C(C(C=O)=O)(C)O)=O,,,4,1,2,0,2
6048_1,,,,2,2,1,3
6050_0,,,,2,2,1,3
C(C(C(CC(C)(CCO)O)=O)=O)=O,,,4,1,1,0,1
6052_0,,,,2,2,1,3
C(CC(C(C=O)=O)O)(CCO)=O,,,4,1,3,0,3
6054_0,,,,2,2,1,3
C(C)(C(CO)C(C(C=O)=O)O)=O,,,4,1,5,0,5
6054_1,,,,2,2,1,3
6056_0,,,,2,2,1,3
C(C(C=O)(CC(CCO)=O)O)=O,,,4,1,1,0,1
6058_0,,,,2,2,1,3
C(C(C=O)(C(C(C)=O)CO)O)=O,,,4,1,2,0,2
6058_1,,,,2,2,1,3
6060_0,,,,2,2,1,3
C(CC(C(C=C)=O)O)(CCO)=O,,,4,1,1,0,1
6062_0,,,,2,2,1,3
C(C)(C(CO)C(C(C=C)=O)O)=O,,,4,1,2,0,2
6062_1,,,,2,2,1,3
6064_0,,,,2,2,1,3
C(C(C=C)(CC(CCO)=O)O)=O,,,4,1,1,0,1
6066_0,,,,2,2,1,3
C(C(C=C)(C(C(C)=O)CO)O)=O,,,4,1,2,0,2
6066_1,,,,2,2,1,3
6068_0,,,,2,2,1,3
C(CC(C=C)(CO)O)(CCO)=O,,,4,1,1,0,1
6070_0,,,,2,2,1,3
C(C)(C(CO)C(C=C)(CO)O)=O,,,4,1,2,0,2
6070_1,,,,2,2,1,3
6072_0,,,,2,2,1,3
C=CC(C(C(C)(CCO)O)O)=O,,,4,1,2,0,2
6072_1,,,,2,2,1,3
6074_0,,,,2,2,1,3
C(CC(C=CC=O)O)(CCO)=O,,,4,1,1,0,1
6076_0,,,,2,2,1,3
C(C)(C(CO)C(C=CC=O)O)=O,,,4,1,2,0,2
6076_1,,,,2,2,1,3
6078_0,,,,2,2,1,3
C(CC(C(C)O)O)(CCO)=O,,,4,1,1,0,1
6080_0,,,,2,2,1,3
C(C)(C(CO)C(C(C)O)O)=O,,,4,1,2,0,2
6080_1,,,,2,2,1,3
6082_0,,,,2,2,1,3
C(CC1(COCC1O)O)(CCO)=O,,,4,1,1,0,1
6084_0,,,,2,2,1,3
C(C)(C(CO)C1(COCC1O)O)=O,,,4,1,2,0,2
6084_1,,,,2,2,1,3
6086_0,,,,2,2,1,3
C1(C(C(C)(CCO)O)OCC1O)=O,,,4,1,2,0,2
6086_1,,,,2,2,1,3
6088_0,,,,2,2,1,3
C(CC1(C(O)OCC1)O)(CCO)=O,,,4,1,1,0,1
6090_0,,,,2,2,1,3
C(C)(C(CO)C1(C(O)OCC1)O)=O,,,4,1,2,0,2
6090_1,,,,2,2,1,3
6092_0,,,,2,2,1,3
C1(C(O)OCC1C(C)(CCO)O)=O,,,4,1,2,0,2
6092_1,,,,2,2,1,3
6094_0,,,,2,2,1,3
C(C(C(C(C)O)O)C(C(O)=O)O)=O,,,4,1,2,0,2
6094_1,,,,2,2,1,3
6096_0,,,,2,2,1,3
C(C(C(CC(C(C=O)=O)=O)O)=O)=O,,,4,1,1,0,1
6098_0,,,,2,2,1,3
C(C(C=O)(CC(C(C=O)=O)=O)O)=O,,,4,1,1,0,1
6100_0,,,,2,2,1,3
C=CC(C(CC(C(C=O)=O)=O)O)=O,,,4,1,1,0,1
6102_0,,,,2,2,1,3
C(C(C=C)(CC(C(C=O)=O)=O)O)=O,,,4,1,1,0,1
6104_0,,,,2,2,1,3
C(C(CO)(CC(C(C=O)=O)=O)O)=C,,,4,1,1,0,1
6105_0,,,,2,2,1,3
6105_1,,,,2,2,1,3
6107_0,,,,2,2,1,3
C(C(C(C)=O)(C(C(C=C)=O)O)O)=O,,,4,1,4,0,4
6107_1,,,,2,2,1,3
6109_0,,,,2,2,1,3
C=CC(C(C(C(C=O)=O)(C)O)O)=O,,,4,1,3,0,3
6109_1,,,,2,2,1,3
6111_0,,,,2,2,1,3
C(C(CC(C(C=O)=O)=O)O)=CC=O,,,4,1,1,0,1
6113_0,,,,2,2,1,3
C(C(C(CC(C(C)O)O)=O)=O)=O,,,4,1,1,0,1
6115_0,,,,2,2,1,3
C=CC(C(C(C(C=O)=O)O)O)=O,,,4,1,5,0,5
6115_1,,,,2,2,1,3
6117_0,,,,2,2,1,3
C(C(C=O)(C(C(C=C)=O)O)O)=O,,,4,1,5,0,5
6117_1,,,,2,2,1,3
6119_0,,,,2,2,1,3
C1(C(C(C(C=O)=O)O)OCC1O)=O,,,4,1,2,0,2
6119_1,,,,2,2,1,3
6121_0,,,,2,2,1,3
C(C(C=O)(C1C(C(CO1)O)=O)O)=O,,,4,1,2,0,2
6121_1,,,,2,2,1,3
6123_0,,,,2,2,1,3
C1(C(O)OCC1C(C(C=O)=O)O)=O,,,4,1,2,0,2
6123_1,,,,2,2,1,3
6125_0,,,,2,2,1,3
C(C(C=O)(C1C(C(O)OC1)=O)O)=O,,,4,1,2,0,2
6125_1,,,,2,2,1,3
6127_0,,,,2,2,1,3
C=CC(C(C(C(C=CC=O)=O)O)O)=O,,,4,1,2,0,2
6127_1,,,,2,2,1,3
6129_0,,,,2,2,1,3
C(C(C=C)(C(C(C=CC=O)=O)O)O)=O,,,4,1,2,0,2
6129_1,,,,2,2,1,3
6131_0,,,,2,2,1,3
C(C(C(C(C=CC=O)=O)O)O)=CC=O,,,4,1,2,0,2
6131_1,,,,2,2,1,3
6133_0,,,,2,2,1,3
C(C=CC(C(C(C(C)O)O)O)=O)=O,,,4,1,2,0,2
6133_1,,,,2,2,1,3
6135_0,,,,2,2,1,3
C=CC(C(C(C(C=C)=O)O)O)=O,,,4,1,2,0,2
6135_1,,,,2,2,1,3
6137_0,,,,2,2,1,3
C(C(C=C)(C(C(C=C)=O)O)O)=O,,,4,1,3,0,3
6137_1,,,,2,2,1,3
6139_0,,,,2,2,1,3
C1(C(C(C(C=C)=O)O)OCC1O)=O,,,4,1,2,0,2
6139_1,,,,2,2,1,3
6141_0,,,,2,2,1,3
C(C(C=C)(C1C(C(CO1)O)=O)O)=O,,,4,1,2,0,2
6141_1,,,,2,2,1,3
6143_0,,,,2,2,1,3
C1(C(O)OCC1C(C(C=C)=O)O)=O,,,4,1,2,0,2
6143_1,,,,2,2,1,3
6145_0,,,,2,2,1,3
C(C(C=C)(C1C(C(O)OC1)=O)O)=O,,,4,1,2,0,2
6145_1,,,,2,2,1,3
6147_0,,,,2,2,1,3
C(C(CO)(C(C(C=C)=O)O)O)=C,,,4,1,2,0,2
6147_1,,,,2,2,1,3
6149_0,,,,2,2,1,3
C=CC(C(C(C=CC=O)O)O)=O,,,4,1,3,0,3
6149_1,,,,2,2,1,3
6151_0,,,,2,2,1,3
C=CC(C(C(C(C)O)O)O)=O,,,4,1,2,0,2
6151_1,,,,2,2,1,3
6153_0,,,,2,2,1,3
C=CC(C(C1(COCC1O)O)O)=O,,,4,1,2,0,2
6153_1,,,,2,2,1,3
6155_0,,,,2,2,1,3
C1(C(C(C=C)(CO)O)OCC1O)=O,,,4,1,2,0,2
6155_1,,,,2,2,1,3
6157_0,,,,2,2,1,3
C=CC(C(C1(C(O)OCC1)O)O)=O,,,4,1,2,0,2
6157_1,,,,2,2,1,3
6159_0,,,,2,2,1,3
C1(C(O)OCC1C(C=C)(CO)O)=O,,,4,1,2,0,2
6159_1,,,,2,2,1,3
6161_0,,,,2,2,1,3
C1(C(C(C=CC=O)O)OCC1O)=O,,,4,1,2,0,2
6161_1,,,,2,2,1,3
6163_0,,,,2,2,1,3
C1(C(O)OCC1C(C=CC=O)O)=O,,,4,1,2,0,2
6163_1,,,,2,2,1,3
6165_0,,,,2,2,1,3
C(C(C(CO)C(C(C)O)O)=O)(O)=O,,,4,1,2,0,2
6165_1,,,,2,2,1,3
6167_0,,,,2,2,1,3
C1(C(C(C(C)O)O)OCC1O)=O,,,4,1,2,0,2
6167_1,,,,2,2,1,3
6169_0,,,,2,2,1,3
C1(C(O)OCC1C(C(C)O)O)=O,,,4,1,2,0,2
6169_1,,,,2,2,1,3
6171_0,,,,2,2,1,3
C(C(C1(C(C(C(C1)O)O)O)O)O)=O,,,4,1,2,0,2
6171_1,,,,2,2,1,3
6172_0,,,,2,2,1,3
6172_1,,,,2,2,1,3
6174_0,,,,2,2,1,3
C(C(C(CO)(C(C(C)O)O)O)O)=O,,,4,1,2,0,2
6174_1,,,,2,2,1,3
6176_0,,,,2,2,1,3
C(C(C(CO)O)O)(C(C(C)O)O)=O,,,4,1,4,0,4
6176_1,,,,2,2,1,3
6178_0,,,,2,2,1,3
C(C(C(CC(CO)(CO)O)O)O)=O,,,4,1,3,0,3
6178_1,,,,2,2,1,3
6180_0,,,,2,2,1,3
C(C(C(CO)O)C(CO)(CO)O)=O,,,4,1,5,0,5
6180_1,,,,2,2,1,3
6182_0,,,,2,2,1,3
C(C(C(CC(C(CO)O)O)O)O)=O,,,4,1,2,0,2
6182_1,,,,2,2,1,3
6184_0,,,,2,2,1,3
C(C(C(CO)O)C(C(CO)O)O)=O,,,4,1,5,0,5
6184_1,,,,2,2,1,3
6185_0,,,,2,2,1,3
6185_1,,,,2,2,1,3
6187_0,,,,2,2,1,3
C(C(CC(C=O)(C(C=O)O)O)O)=O,,,4,1,4,0,4
6187_1,,,,2,2,1,3
6188_0,,,,2,2,1,3
6188_1,,,,2,2,1,3
6190_0,,,,2,2,1,3
C(C(C(C(C=O)=O)C(CO)O)O)=O,,,4,1,4,0,4
6190_1,,,,2,2,1,3
6191_0,,,,2,2,1,3
6191_1,,,,2,2,1,3
6193_0,,,,2,2,1,3
C(C(CC(C)O)(C(C=O)O)O)=O,,,4,1,2,0,2
6193_1,,,,2,2,1,3
6195_0,,,,2,2,1,3
C(C(C(C(CO)O)C(C)O)=O)=O,,,4,1,4,0,4
6195_1,,,,2,2,1,3
6197_0,,,,2,2,1,3
C(CC(C(C)(C(C=O)O)O)O)=O,,,4,1,3,0,3
6197_1,,,,2,2,1,3
6199_0,,,,2,2,1,3
C(C(C(CC(C(C)=O)O)O)O)=O,,,4,1,2,0,2
6199_1,,,,2,2,1,3
6201_0,,,,2,2,1,3
C(CC(C(CC(CO)O)=O)O)=O,,,4,1,2,0,2
6203_0,,,,2,2,1,3
C(C(C(CO)O)C(C(C)=O)O)=O,,,4,1,6,0,6
6203_1,,,,2,2,1,3
6204_0,,,,2,2,1,3
6204_1,,,,2,2,1,3
6206_0,,,,2,2,1,3
C(C(C)(CC(C(C=O)O)O)O)=O,,,4,1,2,0,2
6206_1,,,,2,2,1,3
6208_0,,,,2,2,1,3
C(C(C(CO)O)C(C=O)(C)O)=O,,,4,1,5,0,5
6208_1,,,,2,2,1,3
6209_0,,,,2,2,1,3
6209_1,,,,2,2,1,3
6210_0,,,,2,2,1,3
6210_1,,,,2,2,1,3
6211_0,,,,2,2,1,3
6211_1,,,,2,2,1,3
6212_0,,,,2,2,1,3
6212_1,,,,2,2,1,3
6214_0,,,,2,2,1,3
C(CC(C(CO)O)(C(C=O)O)O)=O,,,4,1,2,0,2
6214_1,,,,2,2,1,3
6216_0,,,,2,2,1,3
C(C(C(C(CO)O)=O)C(CO)O)=O,,,4,1,4,0,4
6216_1,,,,2,2,1,3
6217_0,,,,2,2,1,3
6217_1,,,,2,2,1,3
6219_0,,,,2,2,1,3
C(C(C(CCO)(C(C=O)O)O)O)=O,,,4,1,2,0,2
6219_1,,,,2,2,1,3
6220_0,,,,2,2,1,3
6220_1,,,,2,2,1,3
6222_0,,,,2,2,1,3
C(C(C(C(CO)O)(CCO)O)O)=O,,,4,1,2,0,2
6222_1,,,,2,2,1,3
6223_0,,,,2,2,1,3
6223_1,,,,2,2,1,3
6224_0,,,,2,2,1,3
6224_1,,,,2,2,1,3
6226_0,,,,2,2,1,3
C(C(C(CO)CO)(C(C=O)O)O)=O,,,4,1,2,0,2
6226_1,,,,2,2,1,3
6228_0,,,,2,2,1,3
C(C(C(CO)(C(CO)CO)O)O)=O,,,4,1,2,0,2
6228_1,,,,2,2,1,3
6229_0,,,,2,2,1,3
6229_1,,,,2,2,1,3
6230_0,,,,2,2,1,3
6230_1,,,,2,2,1,3
6232_0,,,,2,2,1,3
C(C(C(C(CO)C(C=O)O)O)O)=O,,,4,1,6,0,6
6232_1,,,,2,2,1,3
6234_0,,,,2,2,1,3
C(C(C(CCO)O)O)=O,,,4,1,3,0,3
6234_1,,,,2,2,1,3
6236_0,,,,2,2,1,3
C(C(CO)C(CO)O)=O,,,4,1,5,0,5
6236_1,,,,2,2,1,3
6238_0,,,,2,2,1,3
C(CC(C(C(C(C=O)O)O)O)O)=O,,,4,1,6,0,6
6238_1,,,,2,2,1,3
6240_0,,,,2,2,1,3
C(C(C(CC(C(C=O)O)O)O)O)=O,,,4,1,2,0,2
6240_1,,,,2,2,1,3
6242_0,,,,2,2,1,3
C(C(C(C(C=O)O)O)C(CO)O)=O,,,4,1,5,0,5
6242_1,,,,2,2,1,3
6244_0,,,,2,2,1,3
C(C(C(CO)(CC(C)O)O)O)=O,,,4,1,2,0,2
6244_1,,,,2,2,1,3
6246_0,,,,2,2,1,3
C(CO)(C(C(CO)O)C(C)O)=O,,,4,1,5,0,5
6246_1,,,,2,2,1,3
6248_0,,,,2,2,1,3
C(C(C(CO)O)O)(CC(C)O)=O,,,4,1,4,0,4
6248_1,,,,2,2,1,3
6250_0,,,,2,2,1,3
C(C(C(C)(C(C(C)O)O)O)O)=O,,,4,1,2,0,2
6250_1,,,,2,2,1,3
6252_0,,,,2,2,1,3
C(C(C(C)O)O)(CC(CO)O)=O,,,4,1,4,0,4
6254_0,,,,2,2,1,3
C(C(C(CC(CO)(C)O)O)O)=O,,,4,1,2,0,2
6254_1,,,,2,2,1,3
6256_0,,,,2,2,1,3
C(C(C(CO)O)C(C)(CO)O)=O,,,4,1,5,0,5
6256_1,,,,2,2,1,3
6258_0,,,,2,2,1,3
C(C(C(CC(C)O)O)O)=O,,,4,1,2,0,2
6258_1,,,,2,2,1,3
6260_0,,,,2,2,1,3
C(C(C(CO)O)C(C)O)=O,,,4,1,5,0,5
6260_1,,,,2,2,1,3
6262_0,,,,2,2,1,3
C(C(C(CC(C(CO)=O)O)O)O)=O,,,4,1,3,0,3
6262_1,,,,2,2,1,3
6264_0,,,,2,2,1,3
C(CC(C(CO)(C(C=O)O)O)O)=O,,,4,1,7,0,7
6264_1,,,,2,2,1,3
6266_0,,,,2,2,1,3
C(C(C(CO)O)C(C(CO)=O)O)=O,,,4,1,5,0,5
6266_1,,,,2,2,1,3
6268_0,,,,2,2,1,3
C(CC(C(C(C(CO)O)O)=O)O)=O,,,4,1,5,0,5
6268_1,,,,2,2,1,3
6269_0,,,,2,2,1,3
6269_1,,,,2,2,1,3
6271_0,,,,2,2,1,3
C(CC(CO)(C(C(C=O)O)O)O)=O,,,4,1,9,0,9
6271_1,,,,2,2,1,3
6273_0,,,,2,2,1,3
C(C(C(CO)O)C(C=O)(CO)O)=O,,,4,1,6,0,6
6273_1,,,,2,2,1,3
6275_0,,,,2,2,1,3
C(C(C(C=O)O)O)(C(C(C)O)O)=O,,,4,1,6,0,6
6275_1,,,,2,2,1,3
6277_0,,,,2,2,1,3
C(C(C(C(C)O)O)(C(C=O)O)O)=O,,,4,1,4,0,4
6277_1,,,,2,2,1,3
6279_0,,,,2,2,1,3
C(C(C)(C(C(C(C=O)O)O)O)O)=O,,,4,1,5,0,5
6279_1,,,,2,2,1,3
6280_0,,,,2,2,1,3
6280_1,,,,2,2,1,3
6281_0,,,,2,2,1,3
6281_1,,,,2,2,1,3
6283_0,,,,2,2,1,3
C(C(CC(CO)O)(C(C=O)O)O)=O,,,4,1,2,0,2
6283_1,,,,2,2,1,3
6285_0,,,,2,2,1,3
C(C(C(C(CO)O)C(CO)O)=O)=O,,,4,1,2,0,2
6285_1,,,,2,2,1,3
6287_0,,,,2,2,1,3
C(C(C(C(C(CO)(C)O)O)O)O)=O,,,4,1,4,0,4
6287_1,,,,2,2,1,3
6289_0,,,,2,2,1,3
C(C(C(CO)(CC(CO)O)O)O)=O,,,4,1,4,0,4
6289_1,,,,2,2,1,3
6291_0,,,,2,2,1,3
C(CO)(C(C(CO)O)C(CO)O)=O,,,4,1,3,0,3
6291_1,,,,2,2,1,3
6293_0,,,,2,2,1,3
C(C(C(CO)O)O)(CC(CO)O)=O,,,4,1,5,0,5
6293_1,,,,2,2,1,3
6295_0,,,,2,2,1,3
C(C(C(C)(C(C(CO)O)O)O)O)=O,,,4,1,5,0,5
6295_1,,,,2,2,1,3
6296_0,,,,2,2,1,3
6298_0,,,,2,2,1,3
C(C(C(C(C(C)O)O)O)O)=O,,,4,1,5,0,5
6298_1,,,,2,2,1,3
6299_0,,,,2,2,1,3
6299_1,,,,2,2,1,3
6301_0,,,,2,2,1,3
C(C(C(CO)O)C(CO)O)=O,,,4,1,4,0,4
6301_1,,,,2,2,1,3
6302_0,,,,2,2,1,3
6302_1,,,,2,2,1,3
6304_0,,,,2,2,1,3
C(CO)(C(C)(C(C=O)O)O)=O,,,4,1,6,0,6
6304_1,,,,2,2,1,3
6305_0,,,,2,2,1,3
6305_1,,,,2,2,1,3
6306_0,,,,2,2,1,3
6308_0,,,,2,2,1,3
C(C(C(CO)(CC(CO)=O)O)O)=O,,,4,1,8,0,8
6308_1,,,,2,2,1,3
6310_0,,,,2,2,1,3
C(C(C(CO)O)O)(CC(CO)=O)=O,,,4,1,4,0,4
6310_1,,,,2,2,1,3
6312_0,,,,2,2,1,3
C(CO)(C(C(CO)=O)C(CO)O)=O,,,4,1,3,0,3
6312_1,,,,2,2,1,3
6314_0,,,,2,2,1,3
C(C(C(CO)(C(C(C)=O)O)O)O)=O,,,4,1,11,0,11
6314_1,,,,2,2,1,3
6315_0,,,,2,2,1,3
6315_1,,,,2,2,1,3
6317_0,,,,2,2,1,3
C(C(C(CO)O)O)(C(C(C)=O)O)=O,,,4,1,3,0,3
6317_1,,,,2,2,1,3
6319_0,,,,2,2,1,3
C(CC(CO)O)(C(C(CO)=O)O)=O,,,4,1,3,0,3
6320_0,,,,2,2,1,3
6320_1,,,,2,2,1,3
6321_0,,,,2,2,1,3
6321_1,,,,2,2,1,3
6323_0,,,,2,2,1,3
C(C(C(CO)(C(C)O)O)O)=O,,,4,1,7,0,7
6323_1,,,,2,2,1,3
6324_0,,,,2,2,1,3
6324_1,,,,2,2,1,3
6325_0,,,,2,2,1,3
6325_1,,,,2,2,1,3
6327_0,,,,2,2,1,3
C(C(C=O)C(CO)O)=O,,,4,1,3,0,3
6327_1,,,,2,2,1,3
6329_0,,,,2,2,1,3
C(C(C(CO)(C(C=O)O)O)O)=O,,,4,1,7,0,7
6329_1,,,,2,2,1,3
6330_0,,,,2,2,1,3
6330_1,,,,2,2,1,3
6331_0,,,,2,2,1,3
6331_1,,,,2,2,1,3
6332_0,,,,2,2,1,3
6332_1,,,,2,2,1,3
6334_0,,,,2,2,1,3
C(C(C)(C(C=O)O)O)(O)=O,,,4,1,4,0,4
6334_1,,,,2,2,1,3
6336_0,,,,2,2,1,3
C(C(CC(CO)O)=O)(O)=O,,,4,1,3,0,3
6337_0,,,,2,2,1,3
6337_1,,,,2,2,1,3
6339_0,,,,2,2,1,3
C(CC(CO)(C(C=O)O)O)(O)=O,,,4,1,3,0,3
6339_1,,,,2,2,1,3
6340_0,,,,2,2,1,3
6340_1,,,,2,2,1,3
6341_0,,,,2,2,1,3
6341_1,,,,2,2,1,3
6342_0,,,,2,2,1,3
6342_1,,,,2,2,1,3
6343_0,,,,2,2,1,3
6344_0,,,,2,2,1,3
6344_1,,,,2,2,1,3
6345_0,,,,2,2,1,3
6345_1,,,,2,2,1,3
6346_0,,,,2,2,1,3
6346_1,,,,2,2,1,3
6347_0,,,,2,2,1,3
6347_1,,,,2,2,1,3
6349_0,,,,2,2,1,3
C(C(CO)(C(C=O)O)O)(O)=O,,,4,1,7,0,7
6349_1,,,,2,2,1,3
6351_0,,,,2,2,1,3
C(C(C(C(CO)O)O)=O)(O)=O,,,4,1,4,0,4
6351_1,,,,2,2,1,3
6353_0,,,,2,2,1,3
C(C(C(C(CC(C)=O)=O)O)O)=O,,,4,1,4,0,4
6353_1,,,,2,2,1,3
6355_0,,,,2,2,1,3
C(C(C(C=O)(CC(C)=O)O)O)=O,,,4,1,2,0,2
6355_1,,,,2,2,1,3
6356_0,,,,2,2,1,3
6356_1,,,,2,2,1,3
6358_0,,,,2,2,1,3
C(C)(C(C(C=O)=O)C(CO)O)=O,,,4,1,3,0,3
6358_1,,,,2,2,1,3
6360_0,,,,2,2,1,3
C(CC(CO)O)(CC(C=O)=O)=O,,,4,1,3,0,3
6361_0,,,,2,2,1,3
6361_1,,,,2,2,1,3
6362_0,,,,2,2,1,3
6362_1,,,,2,2,1,3
6363_0,,,,2,2,1,3
6363_1,,,,2,2,1,3
6365_0,,,,2,2,1,3
C(C(C(C=O)=O)C(CO)O)=O,,,4,1,5,0,5
6365_1,,,,2,2,1,3
6367_0,,,,2,2,1,3
C(C(C(CC(C(C)=O)=O)O)O)=O,,,4,1,5,0,5
6367_1,,,,2,2,1,3
6369_0,,,,2,2,1,3
C(CC(C(C)=O)(C(C=O)O)O)=O,,,4,1,4,0,4
6369_1,,,,2,2,1,3
6371_0,,,,2,2,1,3
C(C(C)(C(C=O)O)O)(CC=O)=O,,,4,1,3,0,3
6371_1,,,,2,2,1,3
6373_0,,,,2,2,1,3
C(C(C(C(C)=O)=O)C(CO)O)=O,,,4,1,3,0,3
6373_1,,,,2,2,1,3
6375_0,,,,2,2,1,3
C(CC(C(CC(CO)O)=O)=O)=O,,,4,1,4,0,4
6377_0,,,,2,2,1,3
C(C)(C(C)(C(C=O)O)O)=O,,,4,1,3,0,3
6377_1,,,,2,2,1,3
6378_0,,,,2,2,1,3
6379_0,,,,2,2,1,3
6379_1,,,,2,2,1,3
6381_0,,,,2,2,1,3
C(C(C(CC(C)=O)O)O)=O,,,4,1,4,0,4
6381_1,,,,2,2,1,3
6382_0,,,,2,2,1,3
6384_0,,,,2,2,1,3
C(C(C(C)=O)C(CO)O)=O,,,4,1,4,0,4
6384_1,,,,2,2,1,3
6386_0,,,,2,2,1,3
C(C(C1(COC(C1)O)O)O)=O,,,4,1,3,0,3
6386_1,,,,2,2,1,3
6388_0,,,,2,2,1,3
C1(COC(C1C(CO)O)O)=O,,,4,1,4,0,4
6388_1,,,,2,2,1,3
6389_0,,,,2,2,1,3
6389_1,,,,2,2,1,3
6391_0,,,,2,2,1,3
C(C(C1(COC(C(C1)O)O)O)O)=O,,,4,1,3,0,3
6391_1,,,,2,2,1,3
6393_0,,,,2,2,1,3
C1(COC(C(C1C(CO)O)O)O)=O,,,4,1,3,0,3
6393_1,,,,2,2,1,3
6395_0,,,,2,2,1,3
C1(C(C(CO)O)OC(C(C1)O)O)=O,,,4,1,3,0,3
6395_1,,,,2,2,1,3
6397_0,,,,2,2,1,3
C(C(C(C)(CCO)O)O)=O,,,4,1,3,0,3
6397_1,,,,2,2,1,3
6399_0,,,,2,2,1,3
C(CC(CO)O)(CCO)=O,,,4,1,5,0,5
6401_0,,,,2,2,1,3
C(C)(C(CO)C(CO)O)=O,,,4,1,2,0,2
6401_1,,,,2,2,1,3
6403_0,,,,2,2,1,3
C(C(CC(C)(C(C=O)O)O)O)(O)=O,,,4,1,5,0,5
6403_1,,,,2,2,1,3
6405_0,,,,2,2,1,3
C(C)(C(C(CO)O)C(C(O)=O)O)=O,,,4,1,2,0,2
6405_1,,,,2,2,1,3
6407_0,,,,2,2,1,3
C(CC(C(O)=O)O)(CC(CO)O)=O,,,4,1,2,0,2
6408_0,,,,2,2,1,3
6408_1,,,,2,2,1,3
6409_0,,,,2,2,1,3
6409_1,,,,2,2,1,3
6411_0,,,,2,2,1,3
C(C(C(C(C(C)=O)=O)O)O)=O,,,4,1,7,0,7
6411_1,,,,2,2,1,3
6412_0,,,,2,2,1,3
6412_1,,,,2,2,1,3
6414_0,,,,2,2,1,3
C(C(C(C(C=O)=O)(C)O)O)=O,,,4,1,5,0,5
6414_1,,,,2,2,1,3
6415_0,,,,2,2,1,3
6417_0,,,,2,2,1,3
C(C(C(C(CC(CO)=O)=O)O)O)=O,,,4,1,5,0,5
6417_1,,,,2,2,1,3
6418_0,,,,2,2,1,3
6418_1,,,,2,2,1,3
6420_0,,,,2,2,1,3
C(C(C(CO)(CC(C=O)=O)O)O)=O,,,4,1,4,0,4
6420_1,,,,2,2,1,3
6422_0,,,,2,2,1,3
C(CO)(C(C(C=O)=O)C(CO)O)=O,,,4,1,3,0,3
6422_1,,,,2,2,1,3
6424_0,,,,2,2,1,3
C(C(C(CO)O)O)(CC(C=O)=O)=O,,,4,1,4,0,4
6424_1,,,,2,2,1,3
6426_0,,,,2,2,1,3
C(C(C(C(C(C(C)=O)O)=O)O)O)=O,,,4,1,4,0,4
6426_1,,,,2,2,1,3
6427_0,,,,2,2,1,3
6427_1,,,,2,2,1,3
6428_0,,,,2,2,1,3
6428_1,,,,2,2,1,3
6430_0,,,,2,2,1,3
C(CC(CO)O)(C(C(C=O)=O)O)=O,,,4,1,2,0,2
6431_0,,,,2,2,1,3
6431_1,,,,2,2,1,3
6432_0,,,,2,2,1,3
6432_1,,,,2,2,1,3
6434_0,,,,2,2,1,3
C(C(C(C(C(C=O)O)O)=O)O)=O,,,4,1,5,0,5
6434_1,,,,2,2,1,3
6435_0,,,,2,2,1,3
6435_1,,,,2,2,1,3
6436_0,,,,2,2,1,3
6436_1,,,,2,2,1,3
6438_0,,,,2,2,1,3
C(C(C(C=CC(CO)=O)O)O)=O,,,4,1,3,0,3
6438_1,,,,2,2,1,3
6440_0,,,,2,2,1,3
C(C(C(C=CC=O)(CO)O)O)=O,,,4,1,3,0,3
6440_1,,,,2,2,1,3
6442_0,,,,2,2,1,3
C(C=CC(C(C(CO)O)O)=O)=O,,,4,1,3,0,3
6442_1,,,,2,2,1,3
6443_0,,,,2,2,1,3
6443_1,,,,2,2,1,3
6445_0,,,,2,2,1,3
C(C(C=C)(C(C=O)O)O)=O,,,4,1,4,0,4
6445_1,,,,2,2,1,3
6447_0,,,,2,2,1,3
C(C(C(C=C)(CO)O)O)=O,,,4,1,3,0,3
6447_1,,,,2,2,1,3
6448_0,,,,2,2,1,3
6448_1,,,,2,2,1,3
6449_0,,,,2,2,1,3
6449_1,,,,2,2,1,3
6451_0,,,,2,2,1,3
C(C(C(C(CC(C=O)O)O)O)O)=O,,,4,1,7,0,7
6451_1,,,,2,2,1,3
6453_0,,,,2,2,1,3
C(C(C(C(C(C(C)O)=O)O)O)O)=O,,,4,1,5,0,5
6453_1,,,,2,2,1,3
6455_0,,,,2,2,1,3
C(C(C(C(C)O)(C(C=O)O)O)O)=O,,,4,1,2,0,2
6455_1,,,,2,2,1,3
6457_0,,,,2,2,1,3
C(C(C(C(C)O)O)O)=O,,,4,1,5,0,5
6457_1,,,,2,2,1,3
6458_0,,,,2,2,1,3
6458_1,,,,2,2,1,3
6460_0,,,,2,2,1,3
C(C(C(CO)C(CO)O)=O)(O)=O,,,4,1,4,0,4
6460_1,,,,2,2,1,3
6461_0,,,,2,2,1,3
6461_1,,,,2,2,1,3
6463_0,,,,2,2,1,3
C(C(C(C(CO)(CO)O)O)O)=O,,,4,1,6,0,6
6463_1,,,,2,2,1,3
6465_0,,,,2,2,1,3
C(C(C(C(CO)(C(C)O)O)O)O)=O,,,4,1,2,0,2
6465_1,,,,2,2,1,3
6466_0,,,,2,2,1,3
6466_1,,,,2,2,1,3
6467_0,,,,2,2,1,3
6467_1,,,,2,2,1,3
6468_0,,,,2,2,1,3
6470_0,,,,2,2,1,3
C(C(C(C)(C(CO)(CO)O)O)O)=O,,,4,1,3,0,3
6470_1,,,,2,2,1,3
6471_0,,,,2,2,1,3
6472_0,,,,2,2,1,3
6472_1,,,,2,2,1,3
6474_0,,,,2,2,1,3
C(C(C(C(C=O)O)O)(C(C)O)O)=O,,,4,1,6,0,6
6474_1,,,,2,2,1,3
6476_0,,,,2,2,1,3
C(C(C(C(C=CC(C)=O)=O)O)O)=O,,,4,1,2,0,2
6476_1,,,,2,2,1,3
6478_0,,,,2,2,1,3
C(C(C=CC(C)=O)(C(C=O)O)O)=O,,,4,1,2,0,2
6478_1,,,,2,2,1,3
6480_0,,,,2,2,1,3
C(C(C(C=CC(C=O)=O)(C)O)O)=O,,,4,1,2,0,2
6480_1,,,,2,2,1,3
6482_0,,,,2,2,1,3
C(C(C=CC(CC(CO)O)=O)=O)=O,,,4,1,1,0,1
6484_0,,,,2,2,1,3
C(CC=CC(C(C(C=O)O)O)=O)=O,,,4,1,2,0,2
6484_1,,,,2,2,1,3
6486_0,,,,2,2,1,3
C(C(C=CCC=O)(C(C=O)O)O)=O,,,4,1,2,0,2
6486_1,,,,2,2,1,3
6488_0,,,,2,2,1,3
C(C(C(CC=CC(C=O)=O)O)O)=O,,,4,1,2,0,2
6488_1,,,,2,2,1,3
6490_0,,,,2,2,1,3
C(C(C=CC(C=O)=O)C(CO)O)=O,,,4,1,1,0,1
6492_0,,,,2,2,1,3
C(C(C(C=CC(C(C)=O)=O)O)O)=O,,,4,1,2,0,2
6492_1,,,,2,2,1,3
6494_0,,,,2,2,1,3
C(C(C(C(C)=O)(C=CC=O)O)O)=O,,,4,1,2,0,2
6494_1,,,,2,2,1,3
6496_0,,,,2,2,1,3
C(C(C(C(C=CC=O)=O)(C)O)O)=O,,,4,1,2,0,2
6496_1,,,,2,2,1,3
6498_0,,,,2,2,1,3
C(C(C=CC=O)=O)(CC(CO)O)=O,,,4,1,1,0,1
6500_0,,,,2,2,1,3
C(CC(C=CC(C(C=O)O)O)=O)=O,,,4,1,2,0,2
6500_1,,,,2,2,1,3
6502_0,,,,2,2,1,3
C(CC(C=CC=O)(C(C=O)O)O)=O,,,4,1,2,0,2
6502_1,,,,2,2,1,3
6504_0,,,,2,2,1,3
C(C(C(CC(C=CC=O)=O)O)O)=O,,,4,1,2,0,2
6504_1,,,,2,2,1,3
6506_0,,,,2,2,1,3
C(C(C(C=CC=O)=O)C(CO)O)=O,,,4,1,2,0,2
6506_1,,,,2,2,1,3
6508_0,,,,2,2,1,3
C(C(C(C(CC(C=C)=O)=O)O)O)=O,,,4,1,2,0,2
6508_1,,,,2,2,1,3
6510_0,,,,2,2,1,3
C(C(C(C=O)(CC(C=C)=O)O)O)=O,,,4,1,2,0,2
6510_1,,,,2,2,1,3
6512_0,,,,2,2,1,3
C(C(C(C=C)(CC(C=O)=O)O)O)=O,,,4,1,2,0,2
6512_1,,,,2,2,1,3
6514_0,,,,2,2,1,3
C=CC(C(C(C=O)=O)C(CO)O)=O,,,4,1,2,0,2
6514_1,,,,2,2,1,3
6516_0,,,,2,2,1,3
C(C(C(CC(C(C=C)=O)=O)O)O)=O,,,4,1,2,0,2
6516_1,,,,2,2,1,3
6518_0,,,,2,2,1,3
C(CC(C(C=C)=O)(C(C=O)O)O)=O,,,4,1,2,0,2
6518_1,,,,2,2,1,3
6520_0,,,,2,2,1,3
C(CC=O)(C(C=C)(C(C=O)O)O)=O,,,4,1,2,0,2
6520_1,,,,2,2,1,3
6522_0,,,,2,2,1,3
C(C(C(C(C=C)=O)=O)C(CO)O)=O,,,4,1,2,0,2
6522_1,,,,2,2,1,3
6524_0,,,,2,2,1,3
C(C(C(C(CC=CC=O)=O)O)O)=O,,,4,1,2,0,2
6524_1,,,,2,2,1,3
6526_0,,,,2,2,1,3
C(C(C(C=O)(CC=CC=O)O)O)=O,,,4,1,2,0,2
6526_1,,,,2,2,1,3
6528_0,,,,2,2,1,3
C(C(C(C=CCC(C=O)=O)O)O)=O,,,4,1,2,0,2
6528_1,,,,2,2,1,3
6530_0,,,,2,2,1,3
C(C(C(C=O)=O)C(CO)O)=CC=O,,,4,1,1,0,1
6532_0,,,,2,2,1,3
C(C(C1(COCC1O)O)O)=O,,,4,1,2,0,2
6532_1,,,,2,2,1,3
6533_0,,,,2,2,1,3
6533_1,,,,2,2,1,3
6535_0,,,,2,2,1,3
C(C(C1(C(O)OCC1)O)O)=O,,,4,1,3,0,3
6535_1,,,,2,2,1,3
6537_0,,,,2,2,1,3
C1(C(O)OCC1C(CO)O)=O,,,4,1,3,0,3
6537_1,,,,2,2,1,3
6539_0,,,,2,2,1,3
C(C(C1(C(O)OCC1O)O)O)=O,,,4,1,3,0,3
6539_1,,,,2,2,1,3
6540_0,,,,2,2,1,3
6540_1,,,,2,2,1,3
6542_0,,,,2,2,1,3
C(C(C=O)C(C(C(CO)O)O)O)=O,,,4,1,2,0,2
6542_1,,,,2,2,1,3
6543_0,,,,2,2,1,3
6543_1,,,,2,2,1,3
6545_0,,,,2,2,1,3
C(C(CO)C(CO)(CO)O)=O,,,4,1,4,0,4
6545_1,,,,2,2,1,3
6547_0,,,,2,2,1,3
C(CO)(C(C(CC(C)O)O)O)=O,,,4,1,2,0,2
6547_1,,,,2,2,1,3
6549_0,,,,2,2,1,3
C(C(C(C)O)C(CO)(CO)O)=O,,,4,1,4,0,4
6549_1,,,,2,2,1,3
6551_0,,,,2,2,1,3
C(CO)(C(C(C(C(C)O)O)O)O)=O,,,4,1,2,0,2
6551_1,,,,2,2,1,3
6553_0,,,,2,2,1,3
C(CO)(C(C(CC(CO)O)O)O)=O,,,4,1,3,0,3
6553_1,,,,2,2,1,3
6554_0,,,,2,2,1,3
6554_1,,,,2,2,1,3
6555_0,,,,2,2,1,3
6555_1,,,,2,2,1,3
6557_0,,,,2,2,1,3
C(CO)(C(C)(C(C(CO)=O)O)O)=O,,,4,1,4,0,4
6557_1,,,,2,2,1,3
6559_0,,,,2,2,1,3
C(C(C)=O)(C(C(CO)(CO)O)O)=O,,,4,1,2,0,2
6559_1,,,,2,2,1,3
6561_0,,,,2,2,1,3
C(C(CO)=O)(CC(CO)(CO)O)=O,,,4,1,2,0,2
6563_0,,,,2,2,1,3
C(C(C(C(C(C)O)=O)O)O)(CO)=O,,,4,1,5,0,5
6563_1,,,,2,2,1,3
6565_0,,,,2,2,1,3
C(C(C(C)O)(C(C(CO)=O)O)O)=O,,,4,1,6,0,6
6565_1,,,,2,2,1,3
6567_0,,,,2,2,1,3
C(CO)(C(C(CO)(C(C)O)O)O)=O,,,4,1,2,0,2
6567_1,,,,2,2,1,3
6569_0,,,,2,2,1,3
C(C(C(CO)(CO)O)O)(C(C)O)=O,,,4,1,3,0,3
6569_1,,,,2,2,1,3
6570_0,,,,2,2,1,3
6570_1,,,,2,2,1,3
6572_0,,,,2,2,1,3
C(C(C=O)C(CO)(CO)O)=O,,,4,1,3,0,3
6572_1,,,,2,2,1,3
6574_0,,,,2,2,1,3
C(CO)(C(C(C(CCO)O)O)O)=O,,,4,1,3,0,3
6574_1,,,,2,2,1,3
6576_0,,,,2,2,1,3
C(C(C)(C(C(CO)=O)O)O)(O)=O,,,4,1,4,0,4
6576_1,,,,2,2,1,3
6578_0,,,,2,2,1,3
C(C(CC(CO)(CO)O)=O)(O)=O,,,4,1,2,0,2
6580_0,,,,2,2,1,3
C(C(C(CO)=O)O)(O)=O,,,4,1,9,0,9
6580_1,,,,2,2,1,3
6581_0,,,,2,2,1,3
6581_1,,,,2,2,1,3
6583_0,,,,2,2,1,3
C(C(C(C(C(CO)=O)O)O)O)(O)=O,,,4,1,9,0,9
6583_1,,,,2,2,1,3
6585_0,,,,2,2,1,3
C(C(CO)(C(C(CO)=O)O)O)(O)=O,,,4,1,7,0,7
6585_1,,,,2,2,1,3
6587_0,,,,2,2,1,3
C(C(C(C(CO)(CO)O)O)=O)(O)=O,,,4,1,3,0,3
6587_1,,,,2,2,1,3
6588_0,,,,2,2,1,3
6588_1,,,,2,2,1,3
6589_0,,,,2,2,1,3
6589_1,,,,2,2,1,3
6591_0,,,,2,2,1,3
C(CO)(C(C(CC(C=O)=O)O)O)=O,,,4,1,6,0,6
6591_1,,,,2,2,1,3
6593_0,,,,2,2,1,3
C(C(C(C=O)=O)C(CO)(CO)O)=O,,,4,1,3,0,3
6593_1,,,,2,2,1,3
6595_0,,,,2,2,1,3
C(C)(C(C)(C(C(CO)=O)O)O)=O,,,4,1,3,0,3
6595_1,,,,2,2,1,3
6597_0,,,,2,2,1,3
C(C(C)=O)(CC(CO)(CO)O)=O,,,4,1,3,0,3
6599_0,,,,2,2,1,3
C(CC(C)(C(C(CO)=O)O)O)=O,,,4,1,5,0,5
6599_1,,,,2,2,1,3
6601_0,,,,2,2,1,3
C(C)(CC(C(C(CO)=O)O)O)=O,,,4,1,2,0,2
6601_1,,,,2,2,1,3
6603_0,,,,2,2,1,3
C(CC(CC(CO)(CO)O)=O)=O,,,4,1,3,0,3
6605_0,,,,2,2,1,3
C(C(C(C)=O)C(CO)(CO)O)=O,,,4,1,3,0,3
6605_1,,,,2,2,1,3
6607_0,,,,2,2,1,3
C(CO)(C(C1(COC(C1)O)O)O)=O,,,4,1,3,0,3
6607_1,,,,2,2,1,3
6609_0,,,,2,2,1,3
C1(COC(C1C(CO)(CO)O)O)=O,,,4,1,3,0,3
6609_1,,,,2,2,1,3
6611_0,,,,2,2,1,3
C1(C(C(CO)(CO)O)OC(C1)O)=O,,,4,1,3,0,3
6611_1,,,,2,2,1,3
6613_0,,,,2,2,1,3
C(CO)(C(C(C)(CCO)O)O)=O,,,4,1,2,0,2
6613_1,,,,2,2,1,3
6615_0,,,,2,2,1,3
C(CC(CO)(CO)O)(CCO)=O,,,4,1,1,0,1
6617_0,,,,2,2,1,3
C(C)(C(CO)C(CO)(CO)O)=O,,,4,1,2,0,2
6617_1,,,,2,2,1,3
6619_0,,,,2,2,1,3
C(CO)(C(C(C(C(C)=O)=O)O)O)=O,,,4,1,4,0,4
6619_1,,,,2,2,1,3
6620_0,,,,2,2,1,3
6620_1,,,,2,2,1,3
6622_0,,,,2,2,1,3
C(C(C(C(C=O)=O)(C)O)O)(CO)=O,,,4,1,4,0,4
6622_1,,,,2,2,1,3
6624_0,,,,2,2,1,3
C(C(C(CC(CO)(CO)O)=O)=O)=O,,,4,1,1,0,1
6625_0,,,,2,2,1,3
6625_1,,,,2,2,1,3
6626_0,,,,2,2,1,3
6626_1,,,,2,2,1,3
6628_0,,,,2,2,1,3
C(CO)(C(C(C(C=C)=O)O)O)=O,,,4,1,5,0,5
6628_1,,,,2,2,1,3
6630_0,,,,2,2,1,3
C(C(C=C)(C(C(CO)=O)O)O)=O,,,4,1,3,0,3
6630_1,,,,2,2,1,3
6632_0,,,,2,2,1,3
C(C(C(C=C)(CO)O)O)(CO)=O,,,4,1,3,0,3
6632_1,,,,2,2,1,3
6634_0,,,,2,2,1,3
C=CC(C(C(CO)(CO)O)O)=O,,,4,1,4,0,4
6634_1,,,,2,2,1,3
6636_0,,,,2,2,1,3
C(CO)(C(C(C=CC=O)O)O)=O,,,4,1,4,0,4
6636_1,,,,2,2,1,3
6638_0,,,,2,2,1,3
C(CO)(C(C(C(C)O)O)O)=O,,,4,1,3,0,3
6638_1,,,,2,2,1,3
6640_0,,,,2,2,1,3
C(CO)(C(C1(COCC1O)O)O)=O,,,4,1,2,0,2
6640_1,,,,2,2,1,3
6642_0,,,,2,2,1,3
C1(C(C(CO)(CO)O)OCC1O)=O,,,4,1,2,0,2
6642_1,,,,2,2,1,3
6644_0,,,,2,2,1,3
C(CO)(C(C1(C(O)OCC1)O)O)=O,,,4,1,3,0,3
6644_1,,,,2,2,1,3
6646_0,,,,2,2,1,3
C1(C(O)OCC1C(CO)(CO)O)=O,,,4,1,3,0,3
6646_1,,,,2,2,1,3
6648_0,,,,2,2,1,3
C(C(CO)C(C(CO)O)O)=O,,,4,1,4,0,4
6648_1,,,,2,2,1,3
6650_0,,,,2,2,1,3
C(C(C(C)O)C(C(CO)O)O)=O,,,4,1,4,0,4
6650_1,,,,2,2,1,3
6651_0,,,,2,2,1,3
6651_1,,,,2,2,1,3
6653_0,,,,2,2,1,3
C(C(C)=O)(C(C(C(CO)O)O)O)=O,,,4,1,2,0,2
6653_1,,,,2,2,1,3
6655_0,,,,2,2,1,3
C(C(CO)=O)(CC(C(CO)O)O)=O,,,4,1,5,0,5
6657_0,,,,2,2,1,3
C(C(C(C(CO)O)O)O)(C(C)O)=O,,,4,1,3,0,3
6657_1,,,,2,2,1,3
6659_0,,,,2,2,1,3
C(C(C=O)C(C(CO)O)O)=O,,,4,1,3,0,3
6659_1,,,,2,2,1,3
6660_0,,,,2,2,1,3
6661_0,,,,2,2,1,3
6661_1,,,,2,2,1,3
6663_0,,,,2,2,1,3
C(C(C(C=O)=O)C(C(CO)O)O)=O,,,4,1,3,0,3
6663_1,,,,2,2,1,3
6665_0,,,,2,2,1,3
C(C(C)=O)(CC(C(CO)O)O)=O,,,4,1,3,0,3
6667_0,,,,2,2,1,3
C(CC(CC(C(CO)O)O)=O)=O,,,4,1,2,0,2
6669_0,,,,2,2,1,3
C(C(C(C)=O)C(C(CO)O)O)=O,,,4,1,3,0,3
6669_1,,,,2,2,1,3
6671_0,,,,2,2,1,3
C1(COC(C1C(C(CO)O)O)O)=O,,,4,1,3,0,3
6671_1,,,,2,2,1,3
6673_0,,,,2,2,1,3
C1(C(C(C(CO)O)O)OC(C1)O)=O,,,4,1,3,0,3
6673_1,,,,2,2,1,3
6675_0,,,,2,2,1,3
C(CC(C(CO)O)O)(CCO)=O,,,4,1,1,0,1
6677_0,,,,2,2,1,3
C(C)(C(CO)C(C(CO)O)O)=O,,,4,1,2,0,2
6677_1,,,,2,2,1,3
6679_0,,,,2,2,1,3
C(C(C(CC(C(CO)O)O)=O)=O)=O,,,4,1,1,0,1
6681_0,,,,2,2,1,3
C=CC(C(C(C(CO)O)O)O)=O,,,4,1,3,0,3
6681_1,,,,2,2,1,3
6683_0,,,,2,2,1,3
C1(C(C(C(CO)O)O)OCC1O)=O,,,4,1,2,0,2
6683_1,,,,2,2,1,3
6685_0,,,,2,2,1,3
C1(C(O)OCC1C(C(CO)O)O)=O,,,4,1,3,0,3
6685_1,,,,2,2,1,3
6686_0,,,,2,2,1,3
6688_0,,,,2,2,1,3
C(C(CC(C)O)(CC(C=O)=O)O)=O,,,4,1,1,0,1
6689_0,,,,2,2,1,3
6689_1,,,,2,2,1,3
6691_0,,,,2,2,1,3
C(C(C)(C(C(C=O)=O)C(C)O)O)=O,,,4,1,4,0,4
6691_1,,,,2,2,1,3
6693_0,,,,2,2,1,3
C(CC(C(C)(CC(C=O)=O)O)O)=O,,,4,1,2,0,2
6695_0,,,,2,2,1,3
C(C)(C(CC(CC(C=O)=O)O)O)=O,,,4,1,1,0,1
6696_0,,,,2,2,1,3
6698_0,,,,2,2,1,3
C(CC(C(CC(C=O)(C)O)=O)O)=O,,,4,1,2,0,2
6700_0,,,,2,2,1,3
C(C(C(C(C)=O)O)C(C(C)=O)O)=O,,,4,1,2,0,2
6700_1,,,,2,2,1,3
6702_0,,,,2,2,1,3
C(C(C(C=O)C(C=O)(C)O)O)(C)=O,,,4,1,4,0,4
6702_1,,,,2,2,1,3
6703_0,,,,2,2,1,3
6705_0,,,,2,2,1,3
C(C(C)(CC(CC(C=O)=O)O)O)=O,,,4,1,1,0,1
6706_0,,,,2,2,1,3
6706_1,,,,2,2,1,3
6708_0,,,,2,2,1,3
C(C(C)(C(C=O)C(C=O)(C)O)O)=O,,,4,1,2,0,2
6708_1,,,,2,2,1,3
6709_0,,,,2,2,1,3
6711_0,,,,2,2,1,3
C(C(CO)C(C(C)=O)O)=O,,,4,1,5,0,5
6711_1,,,,2,2,1,3
6713_0,,,,2,2,1,3
C(C(CO)C(C=O)(C)O)=O,,,4,1,4,0,4
6713_1,,,,2,2,1,3
6715_0,,,,2,2,1,3
C(C(CC(CO)(CC(C)O)O)=O)=O,,,4,1,1,0,1
6717_0,,,,2,2,1,3
C(CO)(C(C(C)O)C(C(C)=O)O)=O,,,4,1,5,0,5
6717_1,,,,2,2,1,3
6719_0,,,,2,2,1,3
C(C(C)(C(C(CO)=O)C(C)O)O)=O,,,4,1,4,0,4
6719_1,,,,2,2,1,3
6721_0,,,,2,2,1,3
C(C(C(C(CC(C)O)=O)O)O)(C)=O,,,4,1,5,0,5
6721_1,,,,2,2,1,3
6723_0,,,,2,2,1,3
C(C(C)(C(C(CC(C)O)=O)O)O)=O,,,4,1,4,0,4
6723_1,,,,2,2,1,3
6725_0,,,,2,2,1,3
C(C(CC(C)(C(C(C)O)O)O)=O)=O,,,4,1,1,0,1
6727_0,,,,2,2,1,3
C(CC(C(C)=O)O)(C(C(C)O)O)=O,,,4,1,3,0,3
6729_0,,,,2,2,1,3
C(C(C)(CC(C(C(C)O)O)=O)O)=O,,,4,1,3,0,3
6731_0,,,,2,2,1,3
C(C(CC(CC(C)(CO)O)O)=O)=O,,,4,1,1,0,1
6733_0,,,,2,2,1,3
C(C(C(CO)(C)O)C(C(C)=O)O)=O,,,4,1,4,0,4
6733_1,,,,2,2,1,3
6735_0,,,,2,2,1,3
C(C(C(CO)(C)O)C(C=O)(C)O)=O,,,4,1,4,0,4
6735_1,,,,2,2,1,3
6737_0,,,,2,2,1,3
C(C(CC(CC(C)O)O)=O)=O,,,4,1,1,0,1
6739_0,,,,2,2,1,3
C(C(C(C)O)C(C(C)=O)O)=O,,,4,1,4,0,4
6739_1,,,,2,2,1,3
6741_0,,,,2,2,1,3
C(C(C(C)O)C(C=O)(C)O)=O,,,4,1,4,0,4
6741_1,,,,2,2,1,3
6743_0,,,,2,2,1,3
C(C(CC(C(C(C)O)O)O)=O)=O,,,4,1,1,0,1
6745_0,,,,2,2,1,3
C(C(CC(CC(CO)O)O)=O)=O,,,4,1,2,0,2
6746_0,,,,2,2,1,3
6746_1,,,,2,2,1,3
6747_0,,,,2,2,1,3
6747_1,,,,2,2,1,3
6748_0,,,,2,2,1,3
6750_0,,,,2,2,1,3
C(CO)(C(C)(CC(C=O)=O)O)=O,,,4,1,2,0,2
6752_0,,,,2,2,1,3
C(C)(C(C(C(C(C)=O)=O)O)O)=O,,,4,1,5,0,5
6752_1,,,,2,2,1,3
6754_0,,,,2,2,1,3
C(C(C)(C(C(C(C)=O)=O)O)O)=O,,,4,1,4,0,4
6754_1,,,,2,2,1,3
6756_0,,,,2,2,1,3
C(C)(C(CC(C(CO)=O)=O)O)=O,,,4,1,4,0,4
6758_0,,,,2,2,1,3
C(C(C)(CC(C(CO)=O)=O)O)=O,,,4,1,2,0,2
6760_0,,,,2,2,1,3
C(C(CC(C=O)=O)O)(C(C)O)=O,,,4,1,2,0,2
6762_0,,,,2,2,1,3
C(C(C(C)O)(CC(C=O)=O)O)=O,,,4,1,2,0,2
6764_0,,,,2,2,1,3
C(C(CC(CO)(C(C)O)O)=O)=O,,,4,1,1,0,1
6766_0,,,,2,2,1,3
C(C(C(C(C(C)O)=O)O)O)(C)=O,,,4,1,5,0,5
6766_1,,,,2,2,1,3
6768_0,,,,2,2,1,3
C(C(C)(C(C(C(C)O)=O)O)O)=O,,,4,1,3,0,3
6768_1,,,,2,2,1,3
6769_0,,,,2,2,1,3
6771_0,,,,2,2,1,3
C(C(C=O)C(C(C)=O)O)=O,,,4,1,4,0,4
6771_1,,,,2,2,1,3
6773_0,,,,2,2,1,3
C(C(C=O)C(C=O)(C)O)=O,,,4,1,3,0,3
6773_1,,,,2,2,1,3
6774_0,,,,2,2,1,3
6775_0,,,,2,2,1,3
6777_0,,,,2,2,1,3
C(C(C(C(C(C(C)=O)O)O)=O)O)=O,,,4,1,5,0,5
6777_1,,,,2,2,1,3
6779_0,,,,2,2,1,3
C(C(C)(C(C(C(C=O)O)=O)O)O)=O,,,4,1,3,0,3
6779_1,,,,2,2,1,3
6781_0,,,,2,2,1,3
C(C(CC(C(CCO)O)O)=O)=O,,,4,1,2,0,2
6783_0,,,,2,2,1,3
C(C(C)(CC(C=O)=O)O)(O)=O,,,4,1,4,0,4
6784_0,,,,2,2,1,3
6786_0,,,,2,2,1,3
C(C(C)(CC(C(O)=O)=O)O)=O,,,4,1,2,0,2
6788_0,,,,2,2,1,3
C(CC(C=O)=O)(O)=O,,,4,1,5,0,5
6790_0,,,,2,2,1,3
C(CC(CO)(CC(C=O)=O)O)(O)=O,,,4,1,2,0,2
6791_0,,,,2,2,1,3
6791_1,,,,2,2,1,3
6792_0,,,,2,2,1,3
6792_1,,,,2,2,1,3
6793_0,,,,2,2,1,3
6793_1,,,,2,2,1,3
6794_0,,,,2,2,1,3
6794_1,,,,2,2,1,3
6796_0,,,,2,2,1,3
C(C(C(C)(CC(C=O)=O)O)O)(O)=O,,,4,1,4,0,4
6797_0,,,,2,2,1,3
6798_0,,,,2,2,1,3
6800_0,,,,2,2,1,3
C(C(CC(C=O)=O)O)(O)=O,,,4,1,5,0,5
6802_0,,,,2,2,1,3
C(C(C(CC(C=O)=O)O)O)(O)=O,,,4,1,6,0,6
6804_0,,,,2,2,1,3
C(CC(C(CC(C=O)=O)O)O)(O)=O,,,4,1,2,0,2
6806_0,,,,2,2,1,3
C(C(CO)(CC(C=O)=O)O)(O)=O,,,4,1,2,0,2
6807_0,,,,2,2,1,3
6807_1,,,,2,2,1,3
6809_0,,,,2,2,1,3
C(C(C)(C(C(C(O)=O)=O)O)O)=O,,,4,1,3,0,3
6809_1,,,,2,2,1,3
6811_0,,,,2,2,1,3
C(C(CC(C=O)=O)O)(CC(C)=O)=O,,,4,1,1,0,1
6813_0,,,,2,2,1,3
C(C(CC(C=O)=O)(CC(C)=O)O)=O,,,4,1,1,0,1
6815_0,,,,2,2,1,3
C(C(CC(C)(CC(C=O)=O)O)=O)=O,,,4,1,1,0,1
6817_0,,,,2,2,1,3
C(C)(C(C(C=O)=O)C(C(C)=O)O)=O,,,4,1,2,0,2
6817_1,,,,2,2,1,3
6819_0,,,,2,2,1,3
C(C(C)(C(C(C)=O)C(C=O)=O)O)=O,,,4,1,2,0,2
6819_1,,,,2,2,1,3
6821_0,,,,2,2,1,3
C(CC(C(C)=O)O)(CC(C=O)=O)=O,,,4,1,1,0,1
6823_0,,,,2,2,1,3
C(C(C)(CC(CC(C=O)=O)=O)O)=O,,,4,1,1,0,1
6825_0,,,,2,2,1,3
C(CC(C(CC(C=O)=O)O)=O)=O,,,4,1,4,0,4
6827_0,,,,2,2,1,3
C(CC(C=O)(CC(C=O)=O)O)=O,,,4,1,3,0,3
6829_0,,,,2,2,1,3
C(C(CC(CC(C=O)=O)O)=O)=O,,,4,1,3,0,3
6831_0,,,,2,2,1,3
C(C(C(C=O)=O)C(C(C)=O)O)=O,,,4,1,5,0,5
6831_1,,,,2,2,1,3
6833_0,,,,2,2,1,3
C(C(C(C=O)=O)C(C=O)(C)O)=O,,,4,1,5,0,5
6833_1,,,,2,2,1,3
6834_0,,,,2,2,1,3
6836_0,,,,2,2,1,3
C(CC(C(C)=O)(CC(C=O)=O)O)=O,,,4,1,3,0,3
6838_0,,,,2,2,1,3
C(C(C)(CC(C=O)=O)O)(CC=O)=O,,,4,1,1,0,1
6840_0,,,,2,2,1,3
C(C(C(C(C)=O)=O)C(C(C)=O)O)=O,,,4,1,2,0,2
6840_1,,,,2,2,1,3
6842_0,,,,2,2,1,3
C(C(C)(C(C=O)C(C(C)=O)=O)O)=O,,,4,1,2,0,2
6842_1,,,,2,2,1,3
6844_0,,,,2,2,1,3
C(CC(C(CC(C(C)=O)O)=O)=O)=O,,,4,1,1,0,1
6846_0,,,,2,2,1,3
C(C(C)(CC(C(CC=O)=O)=O)O)=O,,,4,1,1,0,1
6848_0,,,,2,2,1,3
C(C)(C(C)(CC(C=O)=O)O)=O,,,4,1,2,0,2
6850_0,,,,2,2,1,3
C(C)(C(CC(C(C)=O)=O)O)=O,,,4,1,3,0,3
6852_0,,,,2,2,1,3
C(C(C)(CC(C(C)=O)=O)O)=O,,,4,1,2,0,2
6854_0,,,,2,2,1,3
C(CC(C)(CC(C=O)=O)O)=O,,,4,1,4,0,4
6856_0,,,,2,2,1,3
C(C)(CC(CC(C=O)=O)O)=O,,,4,1,1,0,1
6858_0,,,,2,2,1,3
C(CC(CC(C(C)=O)O)=O)=O,,,4,1,3,0,3
6860_0,,,,2,2,1,3
C(C(C)(CC(CC=O)=O)O)=O,,,4,1,2,0,2
6862_0,,,,2,2,1,3
C(C(C(C)=O)C(C(C)=O)O)=O,,,4,1,4,0,4
6862_1,,,,2,2,1,3
6864_0,,,,2,2,1,3
C(C(C)(C(C=O)C(C)=O)O)=O,,,4,1,3,0,3
6864_1,,,,2,2,1,3
6866_0,,,,2,2,1,3
C(C(CC1(COC(C1)O)O)=O)=O,,,4,1,2,0,2
6868_0,,,,2,2,1,3
C1(COC(C1C(C(C)=O)O)O)=O,,,4,1,3,0,3
6868_1,,,,2,2,1,3
6870_0,,,,2,2,1,3
C(C(C)(C1C(COC1O)=O)O)=O,,,4,1,3,0,3
6870_1,,,,2,2,1,3
6872_0,,,,2,2,1,3
C(C(C1C(CC(O1)O)=O)O)(C)=O,,,4,1,3,0,3
6872_1,,,,2,2,1,3
6874_0,,,,2,2,1,3
C(C(C)(C1C(CC(O1)O)=O)O)=O,,,4,1,3,0,3
6874_1,,,,2,2,1,3
6876_0,,,,2,2,1,3
C(C(CC(C)(CCO)O)=O)=O,,,4,1,1,0,1
6878_0,,,,2,2,1,3
C(CC(C(C)=O)O)(CCO)=O,,,4,1,1,0,1
6880_0,,,,2,2,1,3
C(C(C)(CC(CCO)=O)O)=O,,,4,1,1,0,1
6882_0,,,,2,2,1,3
C(C)(C(CO)C(C(C)=O)O)=O,,,4,1,2,0,2
6882_1,,,,2,2,1,3
6884_0,,,,2,2,1,3
C(C(C)(C(C(C)=O)CO)O)=O,,,4,1,2,0,2
6884_1,,,,2,2,1,3
6886_0,,,,2,2,1,3
C(C(CC(CC(C=O)=O)O)O)(O)=O,,,4,1,4,0,4
6887_0,,,,2,2,1,3
6887_1,,,,2,2,1,3
6888_0,,,,2,2,1,3
6888_1,,,,2,2,1,3
6890_0,,,,2,2,1,3
C(C(CC(C(C(C)=O)=O)O)=O)=O,,,4,1,2,0,2
6892_0,,,,2,2,1,3
C(C(C(C)=O)(CC(C=O)=O)O)=O,,,4,1,3,0,3
6894_0,,,,2,2,1,3
C(C=O)(C(C)(CC(C=O)=O)O)=O,,,4,1,2,0,2
6896_0,,,,2,2,1,3
C(C)(C(CC(C(C=O)=O)=O)O)=O,,,4,1,2,0,2
6898_0,,,,2,2,1,3
C(C(C)(CC(C(C=O)=O)=O)O)=O,,,4,1,1,0,1
6900_0,,,,2,2,1,3
C(C(CC(C(C=O)=O)O)=O)=O,,,4,1,4,0,4
6902_0,,,,2,2,1,3
C(C(C=O)(CC(C=O)=O)O)=O,,,4,1,2,0,2
6904_0,,,,2,2,1,3
C(C(C(C(CC(C=O)=O)O)=O)O)=O,,,4,1,1,0,1
6906_0,,,,2,2,1,3
C(C(C(C=O)(CC(C=O)=O)O)O)=O,,,4,1,2,0,2
6908_0,,,,2,2,1,3
C(C=O)(CC(C(C(C=O)=O)O)O)=O,,,4,1,5,0,5
6910_0,,,,2,2,1,3
C(C(CC(C=O)=O)O)=CC(CO)=O,,,4,1,1,0,1
6912_0,,,,2,2,1,3
C(C(CO)(CC(C=O)=O)O)=CC=O,,,4,1,1,0,1
6914_0,,,,2,2,1,3
C(C)(C(C(C(C=CC=O)=O)O)O)=O,,,4,1,2,0,2
6914_1,,,,2,2,1,3
6916_0,,,,2,2,1,3
C(C(C)(C(C(C=CC=O)=O)O)O)=O,,,4,1,2,0,2
6916_1,,,,2,2,1,3
6918_0,,,,2,2,1,3
C=CC(C(CC(C=O)=O)O)=O,,,4,1,2,0,2
6920_0,,,,2,2,1,3
C(C(C=C)(CC(C=O)=O)O)=O,,,4,1,2,0,2
6922_0,,,,2,2,1,3
C(C(CO)(CC(C=O)=O)O)=C,,,4,1,2,0,2
6924_0,,,,2,2,1,3
C(C)(C(C(C(C=C)=O)O)O)=O,,,4,1,5,0,5
6924_1,,,,2,2,1,3
6926_0,,,,2,2,1,3
C(C(C)(C(C(C=C)=O)O)O)=O,,,4,1,4,0,4
6926_1,,,,2,2,1,3
6928_0,,,,2,2,1,3
C(C(CC(C=O)=O)O)=CC=O,,,4,1,3,0,3
6930_0,,,,2,2,1,3
C(C(CC(C(C)O)O)=O)=O,,,4,1,1,0,1
6932_0,,,,2,2,1,3
C(C(CCO)(CC(C=O)=O)O)(O)=O,,,4,1,2,0,2
6934_0,,,,2,2,1,3
C(C(C(C(C(O)=O)=O)CO)O)(C)=O,,,4,1,5,0,5
6934_1,,,,2,2,1,3
6936_0,,,,2,2,1,3
C(C(C)(C(C(C(O)=O)=O)CO)O)=O,,,4,1,3,0,3
6936_1,,,,2,2,1,3
6938_0,,,,2,2,1,3
C(C(CC(C(CO)(CO)O)O)=O)=O,,,4,1,3,0,3
6940_0,,,,2,2,1,3
C(C(CO)(C(CC(C=O)=O)O)O)=O,,,4,1,6,0,6
6942_0,,,,2,2,1,3
C(C(CC(C(C=CC(C)=O)=O)O)=O)=O,,,4,1,1,0,1
6944_0,,,,2,2,1,3
C(C(C=CC(C)=O)(CC(C=O)=O)O)=O,,,4,1,1,0,1
6946_0,,,,2,2,1,3
C(C(C)(CC(C=O)=O)O)=CC(C=O)=O,,,4,1,1,0,1
6948_0,,,,2,2,1,3
C(C)(C(CC(C=CC(C=O)=O)=O)O)=O,,,4,1,1,0,1
6950_0,,,,2,2,1,3
C(C(C)(CC(C=CC(C=O)=O)=O)O)=O,,,4,1,1,0,1
6952_0,,,,2,2,1,3
C(CC=CC(C(CC(C=O)=O)O)=O)=O,,,4,1,1,0,1
6954_0,,,,2,2,1,3
C(C(C=CCC=O)(CC(C=O)=O)O)=O,,,4,1,1,0,1
6956_0,,,,2,2,1,3
C(CC(CC(C=O)=O)O)=CC(C=O)=O,,,4,1,1,0,1
6958_0,,,,2,2,1,3
C(C(C=CC(C=O)=O)C(C(C)=O)O)=O,,,4,1,1,0,1
6960_0,,,,2,2,1,3
C(C(C=CC(C=O)=O)C(C=O)(C)O)=O,,,4,1,1,0,1
6962_0,,,,2,2,1,3
C(C(CC(C=O)=O)O)=CC(C(C)=O)=O,,,4,1,1,0,1
6964_0,,,,2,2,1,3
C(C)(C(C=CC=O)(CC(C=O)=O)O)=O,,,4,1,1,0,1
6966_0,,,,2,2,1,3
C(C(CC(C(C=CC=O)=O)(C)O)=O)=O,,,4,1,1,0,1
6968_0,,,,2,2,1,3
C(C)(C(CC(C(C=CC=O)=O)=O)O)=O,,,4,1,1,0,1
6970_0,,,,2,2,1,3
C(C(C)(CC(C(C=CC=O)=O)=O)O)=O,,,4,1,1,0,1
6972_0,,,,2,2,1,3
C(CC(C=CC(CC(C=O)=O)O)=O)=O,,,4,1,1,0,1
6974_0,,,,2,2,1,3
C(CC(C=CC=O)(CC(C=O)=O)O)=O,,,4,1,1,0,1
6976_0,,,,2,2,1,3
C(C(CC(CC(C=CC=O)=O)O)=O)=O,,,4,1,1,0,1
6978_0,,,,2,2,1,3
C(C(C(C=CC=O)=O)C(C(C)=O)O)=O,,,4,1,2,0,2
6978_1,,,,2,2,1,3
6980_0,,,,2,2,1,3
C(C(C(C=CC=O)=O)C(C=O)(C)O)=O,,,4,1,2,0,2
6980_1,,,,2,2,1,3
6982_0,,,,2,2,1,3
C(C(CC(C=O)=O)O)(CC(C=C)=O)=O,,,4,1,1,0,1
6984_0,,,,2,2,1,3
C(C(CC(C=O)=O)(CC(C=C)=O)O)=O,,,4,1,1,0,1
6986_0,,,,2,2,1,3
C=CC(CC(C=O)=O)(CC(C=O)=O)O,,,4,1,1,0,1
6988_0,,,,2,2,1,3
C(C)(C(C(C(C=O)=O)C(C=C)=O)O)=O,,,4,1,2,0,2
6988_1,,,,2,2,1,3
6990_0,,,,2,2,1,3
C(C(C)(C(C(C=O)=O)C(C=C)=O)O)=O,,,4,1,2,0,2
6990_1,,,,2,2,1,3
6992_0,,,,2,2,1,3
C=CC(C(CC(CC(C=O)=O)O)=O)=O,,,4,1,1,0,1
6994_0,,,,2,2,1,3
C(CC(C(C=C)=O)(CC(C=O)=O)O)=O,,,4,1,1,0,1
6996_0,,,,2,2,1,3
C(CC=O)(C(C=C)(CC(C=O)=O)O)=O,,,4,1,1,0,1
6998_0,,,,2,2,1,3
C(C(C(C(C=C)=O)=O)C(C(C)=O)O)=O,,,4,1,2,0,2
6998_1,,,,2,2,1,3
7000_0,,,,2,2,1,3
C(C(C(C(C=C)=O)=O)C(C=O)(C)O)=O,,,4,1,2,0,2
7000_1,,,,2,2,1,3
7002_0,,,,2,2,1,3
C(C(CC(C=O)=O)O)(CC=CC=O)=O,,,4,1,1,0,1
7004_0,,,,2,2,1,3
C(C(CC(C=O)=O)(CC=CC=O)O)=O,,,4,1,1,0,1
7006_0,,,,2,2,1,3
C(CC(C=O)=O)=CC(CC(C=O)=O)O,,,4,1,1,0,1
7008_0,,,,2,2,1,3
C(C)(C(C(C=CC=O)C(C=O)=O)O)=O,,,4,1,1,0,1
7010_0,,,,2,2,1,3
C(C(C)(C(C=CC=O)C(C=O)=O)O)=O,,,4,1,1,0,1
7012_0,,,,2,2,1,3
C(C(CC1(COCC1O)O)=O)=O,,,4,1,1,0,1
7014_0,,,,2,2,1,3
C(C(C1C(C(CO1)O)=O)O)(C)=O,,,4,1,2,0,2
7014_1,,,,2,2,1,3
7016_0,,,,2,2,1,3
C(C(C)(C1C(C(CO1)O)=O)O)=O,,,4,1,2,0,2
7016_1,,,,2,2,1,3
7018_0,,,,2,2,1,3
C(C(CC1(C(O)OCC1)O)=O)=O,,,4,1,2,0,2
7020_0,,,,2,2,1,3
C(C(C1C(C(O)OC1)=O)O)(C)=O,,,4,1,3,0,3
7020_1,,,,2,2,1,3
7022_0,,,,2,2,1,3
C(C(C)(C1C(C(O)OC1)=O)O)=O,,,4,1,3,0,3
7022_1,,,,2,2,1,3
7024_0,,,,2,2,1,3
C(C(CC1(C(O)OCC1O)O)=O)=O,,,4,1,2,0,2
7026_0,,,,2,2,1,3
C(C(C(CO)=O)C(CCO)O)=O,,,4,1,2,0,2
7026_1,,,,2,2,1,3
7028_0,,,,2,2,1,3
C(CC(C(C(CCO)O)O)=O)=O,,,4,1,2,0,2
7028_1,,,,2,2,1,3
7030_0,,,,2,2,1,3
C(C(CO)C(CC(CO)=O)O)=O,,,4,1,6,0,6
7030_1,,,,2,2,1,3
7032_0,,,,2,2,1,3
C(C(CO)C(CO)(CC=O)O)=O,,,4,1,5,0,5
7032_1,,,,2,2,1,3
7034_0,,,,2,2,1,3
C(C(C(CO)=O)C(CC(C)O)O)=O,,,4,1,2,0,2
7034_1,,,,2,2,1,3
7036_0,,,,2,2,1,3
C(CC(C(C(CC(C)O)O)O)=O)=O,,,4,1,2,0,2
7036_1,,,,2,2,1,3
7038_0,,,,2,2,1,3
C(C(C(CC(CO)=O)O)C(C)O)=O,,,4,1,5,0,5
7038_1,,,,2,2,1,3
7040_0,,,,2,2,1,3
C(C(C(C)O)C(CO)(CC=O)O)=O,,,4,1,5,0,5
7040_1,,,,2,2,1,3
7042_0,,,,2,2,1,3
C(CC(C(C=O)C(CO)=O)O)=O,,,4,1,4,0,4
7042_1,,,,2,2,1,3
7044_0,,,,2,2,1,3
C(CC(C(C(CC=O)=O)O)O)=O,,,4,1,4,0,4
7044_1,,,,2,2,1,3
7046_0,,,,2,2,1,3
C(C(C=O)C(CC(CO)=O)O)=O,,,4,1,3,0,3
7046_1,,,,2,2,1,3
7048_0,,,,2,2,1,3
C(C(C=O)C(CO)(CC=O)O)=O,,,4,1,3,0,3
7048_1,,,,2,2,1,3
7050_0,,,,2,2,1,3
C(C(C)(C(C=O)C(CO)=O)O)(O)=O,,,4,1,3,0,3
7050_1,,,,2,2,1,3
7052_0,,,,2,2,1,3
C(C(C)(C(C(CC=O)=O)O)O)(O)=O,,,4,1,4,0,4
7052_1,,,,2,2,1,3
7054_0,,,,2,2,1,3
C(CO)(CC(CC(C(O)=O)=O)O)=O,,,4,1,2,0,2
7056_0,,,,2,2,1,3
C(CC(CO)(CC(C(O)=O)=O)O)=O,,,4,1,2,0,2
7058_0,,,,2,2,1,3
C(C(C=O)C(CO)=O)(O)=O,,,4,1,2,0,2
7058_1,,,,2,2,1,3
7060_0,,,,2,2,1,3
C(C(C(CC=O)=O)O)(O)=O,,,4,1,3,0,3
7060_1,,,,2,2,1,3
7062_0,,,,2,2,1,3
C(C(C(CO)=O)C(C(O)=O)O)=O,,,4,1,5,0,5
7062_1,,,,2,2,1,3
7064_0,,,,2,2,1,3
C(CC(C(C(C(O)=O)O)O)=O)=O,,,4,1,7,0,7
7064_1,,,,2,2,1,3
7066_0,,,,2,2,1,3
C(C)(C(C)(C(C=O)C(CO)=O)O)=O,,,4,1,2,0,2
7066_1,,,,2,2,1,3
7068_0,,,,2,2,1,3
C(C)(C(C)(C(C(CC=O)=O)O)O)=O,,,4,1,2,0,2
7068_1,,,,2,2,1,3
7070_0,,,,2,2,1,3
C(CO)(CC(CC(C(C)=O)=O)O)=O,,,4,1,2,0,2
7072_0,,,,2,2,1,3
C(CC(CO)(CC(C(C)=O)=O)O)=O,,,4,1,2,0,2
7074_0,,,,2,2,1,3
C(CC(C)(C(C=O)C(CO)=O)O)=O,,,4,1,2,0,2
7074_1,,,,2,2,1,3
7075_0,,,,2,2,1,3
7075_1,,,,2,2,1,3
7077_0,,,,2,2,1,3
C(C)(CC(C(C=O)C(CO)=O)O)=O,,,4,1,2,0,2
7077_1,,,,2,2,1,3
7079_0,,,,2,2,1,3
C(C(C(CC(C)=O)O)O)(CC=O)=O,,,4,1,2,0,2
7079_1,,,,2,2,1,3
7081_0,,,,2,2,1,3
C(CC(CC(CO)=O)O)(CC=O)=O,,,4,1,1,0,1
7082_0,,,,2,2,1,3
7084_0,,,,2,2,1,3
C(C)(C(C=O)C(CC(CO)=O)O)=O,,,4,1,2,0,2
7084_1,,,,2,2,1,3
7086_0,,,,2,2,1,3
C(CC(CO)(C(C=O)C(C)=O)O)=O,,,4,1,2,0,2
7086_1,,,,2,2,1,3
7088_0,,,,2,2,1,3
C(C(C(CO)=O)C(C)(CCO)O)=O,,,4,1,2,0,2
7088_1,,,,2,2,1,3
7090_0,,,,2,2,1,3
C(CC(C(C(C)(CCO)O)O)=O)=O,,,4,1,3,0,3
7090_1,,,,2,2,1,3
7092_0,,,,2,2,1,3
C(CCO)(CC(CC(CO)=O)O)=O,,,4,1,1,0,1
7094_0,,,,2,2,1,3
C(CC(CO)(CC(CCO)=O)O)=O,,,4,1,4,0,4
7096_0,,,,2,2,1,3
C(C)(C(CO)C(CC(CO)=O)O)=O,,,4,1,2,0,2
7096_1,,,,2,2,1,3
7098_0,,,,2,2,1,3
C(CC(CO)(C(C(C)=O)CO)O)=O,,,4,1,2,0,2
7098_1,,,,2,2,1,3
7100_0,,,,2,2,1,3
C(C(C(CO)=O)C(C(C=O)=O)O)=O,,,4,1,3,0,3
7100_1,,,,2,2,1,3
7102_0,,,,2,2,1,3
C(CC(C(C(C(C=O)=O)O)O)=O)=O,,,4,1,5,0,5
7102_1,,,,2,2,1,3
7104_0,,,,2,2,1,3
C(C(C(CO)=O)C(C=O)(C=O)O)=O,,,4,1,2,0,2
7104_1,,,,2,2,1,3
7106_0,,,,2,2,1,3
C(C(C=O)(C(C(CC=O)=O)O)O)=O,,,4,1,4,0,4
7106_1,,,,2,2,1,3
7108_0,,,,2,2,1,3
C(C(C(CO)=O)C(C(C=C)=O)O)=O,,,4,1,2,0,2
7108_1,,,,2,2,1,3
7109_0,,,,2,2,1,3
7109_1,,,,2,2,1,3
7111_0,,,,2,2,1,3
C(C(C(CO)=O)C(C=O)(C=C)O)=O,,,4,1,2,0,2
7111_1,,,,2,2,1,3
7113_0,,,,2,2,1,3
C(C(C=C)(C(C(CC=O)=O)O)O)=O,,,4,1,2,0,2
7113_1,,,,2,2,1,3
7115_0,,,,2,2,1,3
C(C(C(CO)=O)C(C=C)(CO)O)=O,,,4,1,2,0,2
7115_1,,,,2,2,1,3
7117_0,,,,2,2,1,3
C(CC(C(C(C=C)(CO)O)O)=O)=O,,,4,1,2,0,2
7117_1,,,,2,2,1,3
7119_0,,,,2,2,1,3
C(CO)(CC(C(C(C=C)=O)O)O)=O,,,4,1,2,0,2
7119_1,,,,2,2,1,3
7121_0,,,,2,2,1,3
C(CC(CO)(C(C(C=C)=O)O)O)=O,,,4,1,3,0,3
7121_1,,,,2,2,1,3
7123_0,,,,2,2,1,3
C(C(C(CO)=O)C(C=CC=O)O)=O,,,4,1,2,0,2
7123_1,,,,2,2,1,3
7125_0,,,,2,2,1,3
C(CC(C(C(C=CC=O)O)O)=O)=O,,,4,1,2,0,2
7125_1,,,,2,2,1,3
7127_0,,,,2,2,1,3
C(C(C(CO)=O)C(C(C)O)O)=O,,,4,1,2,0,2
7127_1,,,,2,2,1,3
7129_0,,,,2,2,1,3
C(CC(C(C(C(C)O)O)O)=O)=O,,,4,1,2,0,2
7129_1,,,,2,2,1,3
7131_0,,,,2,2,1,3
C(C(C(CC(CCO)O)=O)O)=O,,,4,1,1,0,1
7133_0,,,,2,2,1,3
C(C(CO)C(C(C(C)=O)O)O)=O,,,4,1,5,0,5
7133_1,,,,2,2,1,3
7135_0,,,,2,2,1,3
C(C(CO)C(C)(C(C=O)O)O)=O,,,4,1,4,0,4
7135_1,,,,2,2,1,3
7137_0,,,,2,2,1,3
C(C(C(CC(CC(C)O)O)=O)O)=O,,,4,1,1,0,1
7139_0,,,,2,2,1,3
C(C(C(C(C(C)=O)O)O)C(C)O)=O,,,4,1,4,0,4
7139_1,,,,2,2,1,3
7141_0,,,,2,2,1,3
C(C(C(C)O)C(C)(C(C=O)O)O)=O,,,4,1,4,0,4
7141_1,,,,2,2,1,3
7143_0,,,,2,2,1,3
C(C(C(CC(CC=O)O)=O)O)=O,,,4,1,2,0,2
7145_0,,,,2,2,1,3
C(C(C=O)C(C(C(C)=O)O)O)=O,,,4,1,3,0,3
7145_1,,,,2,2,1,3
7147_0,,,,2,2,1,3
C(C(C=O)C(C)(C(C=O)O)O)=O,,,4,1,3,0,3
7147_1,,,,2,2,1,3
7149_0,,,,2,2,1,3
C(C(C)(CC(C(C=O)O)=O)O)(O)=O,,,4,1,2,0,2
7151_0,,,,2,2,1,3
C(C)(C(C(CC(C(O)=O)=O)O)O)=O,,,4,1,2,0,2
7153_0,,,,2,2,1,3
C(C(C(C)(CC(C(O)=O)=O)O)O)=O,,,4,1,2,0,2
7155_0,,,,2,2,1,3
C(CC(C(C=O)O)=O)(O)=O,,,4,1,2,0,2
7157_0,,,,2,2,1,3
C(C(C(CC(C(O)=O)O)=O)O)=O,,,4,1,4,0,4
7159_0,,,,2,2,1,3
C(C)(C(C)(CC(C(C=O)O)=O)O)=O,,,4,1,1,0,1
7161_0,,,,2,2,1,3
C(C)(C(C(CC(C(C)=O)=O)O)O)=O,,,4,1,3,0,3
7163_0,,,,2,2,1,3
C(C(C(C)(CC(C(C)=O)=O)O)O)=O,,,4,1,1,0,1
7164_0,,,,2,2,1,3
7166_0,,,,2,2,1,3
C(CC(CC(C)=O)O)(C(C=O)O)=O,,,4,1,1,0,1
7168_0,,,,2,2,1,3
C(CC(C(C(C)=O)O)O)(CC=O)=O,,,4,1,1,0,1
7170_0,,,,2,2,1,3
C(CC(C)(C(C=O)O)O)(CC=O)=O,,,4,1,1,0,1
7172_0,,,,2,2,1,3
C(C(C(C)=O)C(C(C(C)=O)O)O)=O,,,4,1,2,0,2
7172_1,,,,2,2,1,3
7174_0,,,,2,2,1,3
C(C(C(C)(C(C=O)C(C)=O)O)O)=O,,,4,1,2,0,2
7174_1,,,,2,2,1,3
7176_0,,,,2,2,1,3
C(C(C(CC(C)(CCO)O)=O)O)=O,,,4,1,2,0,2
7178_0,,,,2,2,1,3
C(CCO)(CC(C(C(C)=O)O)O)=O,,,4,1,1,0,1
7180_0,,,,2,2,1,3
C(CC(C)(C(C=O)O)O)(CCO)=O,,,4,1,1,0,1
7182_0,,,,2,2,1,3
C(C)(C(CO)C(C(C(C)=O)O)O)=O,,,4,1,2,0,2
7182_1,,,,2,2,1,3
7184_0,,,,2,2,1,3
C(C(C(C)(C(C(C)=O)CO)O)O)=O,,,4,1,2,0,2
7184_1,,,,2,2,1,3
7186_0,,,,2,2,1,3
C(C(C(CC(C(C=O)=O)O)=O)O)=O,,,4,1,2,0,2
7188_0,,,,2,2,1,3
C(C(C=O)(CC(C(C=O)O)=O)O)=O,,,4,1,1,0,1
7190_0,,,,2,2,1,3
C(C(C(CC(C(C=C)=O)O)=O)O)=O,,,4,1,1,0,1
7192_0,,,,2,2,1,3
C(C(C=C)(CC(C(C=O)O)=O)O)=O,,,4,1,1,0,1
7194_0,,,,2,2,1,3
C(C(C(CC(C=C)(CO)O)=O)O)=O,,,4,1,1,0,1
7196_0,,,,2,2,1,3
C(C)(C(C(C(C(C=C)=O)O)O)O)=O,,,4,1,2,0,2
7196_1,,,,2,2,1,3
7198_0,,,,2,2,1,3
C(C(C(C)(C(C(C=C)=O)O)O)O)=O,,,4,1,2,0,2
7198_1,,,,2,2,1,3
7200_0,,,,2,2,1,3
C(C(C(CC(C=CC=O)O)=O)O)=O,,,4,1,1,0,1
7202_0,,,,2,2,1,3
C(C(C(CC(C(C)O)O)=O)O)=O,,,4,1,1,0,1
7203_0,,,,2,2,1,3
7203_1,,,,2,2,1,3
7204_0,,,,2,2,1,3
7204_1,,,,2,2,1,3
7205_0,,,,2,2,1,3
7205_1,,,,2,2,1,3
7206_0,,,,2,2,1,3
7206_1,,,,2,2,1,3
7208_0,,,,2,2,1,3
C(C(C(C(C=O)=O)C(C=O)O)O)=O,,,4,1,2,0,2
7208_1,,,,2,2,1,3
7210_0,,,,2,2,1,3
C(C(C(C(C=O)=O)C(C)O)O)=O,,,4,1,4,0,4
7210_1,,,,2,2,1,3
7212_0,,,,2,2,1,3
C(CC(C(CC(C=O)O)=O)O)=O,,,4,1,3,0,3
7213_0,,,,2,2,1,3
7213_1,,,,2,2,1,3
7214_0,,,,2,2,1,3
7214_1,,,,2,2,1,3
7216_0,,,,2,2,1,3
C(C(C(C(C(C=O)O)O)=O)CO)=O,,,4,1,4,0,4
7216_1,,,,2,2,1,3
7218_0,,,,2,2,1,3
C(C(CO)O)(C(C=O)C(C=O)O)=O,,,4,1,5,0,5
7218_1,,,,2,2,1,3
7220_0,,,,2,2,1,3
C(C(CO)C(C=O)O)(C(C=O)O)=O,,,4,1,4,0,4
7220_1,,,,2,2,1,3
7221_0,,,,2,2,1,3
7221_1,,,,2,2,1,3
7222_0,,,,2,2,1,3
7222_1,,,,2,2,1,3
7223_0,,,,2,2,1,3
7223_1,,,,2,2,1,3
7224_0,,,,2,2,1,3
7224_1,,,,2,2,1,3
7225_0,,,,2,2,1,3
7225_1,,,,2,2,1,3
7226_0,,,,2,2,1,3
7226_1,,,,2,2,1,3
7227_0,,,,2,2,1,3
7228_0,,,,2,2,1,3
7228_1,,,,2,2,1,3
7229_0,,,,2,2,1,3
7229_1,,,,2,2,1,3
7230_0,,,,2,2,1,3
7230_1,,,,2,2,1,3
7232_0,,,,2,2,1,3
C(C(C(C(C(CC=O)O)=O)O)O)=O,,,4,1,4,0,4
7232_1,,,,2,2,1,3
7233_0,,,,2,2,1,3
7233_1,,,,2,2,1,3
7234_0,,,,2,2,1,3
7234_1,,,,2,2,1,3
7235_0,,,,2,2,1,3
7235_1,,,,2,2,1,3
7236_0,,,,2,2,1,3
7236_1,,,,2,2,1,3
7237_0,,,,2,2,1,3
7238_0,,,,2,2,1,3
7238_1,,,,2,2,1,3
7239_0,,,,2,2,1,3
7239_1,,,,2,2,1,3
7241_0,,,,2,2,1,3
C(C(CC(C(CO)=O)=O)O)=O,,,4,1,3,0,3
7242_0,,,,2,2,1,3
7242_1,,,,2,2,1,3
7244_0,,,,2,2,1,3
C(C(C(C(CO)=O)C(CO)=O)O)=O,,,4,1,3,0,3
7244_1,,,,2,2,1,3
7245_0,,,,2,2,1,3
7245_1,,,,2,2,1,3
7247_0,,,,2,2,1,3
C(C(CC(C(C(CO)=O)O)=O)O)=O,,,4,1,2,0,2
7248_0,,,,2,2,1,3
7248_1,,,,2,2,1,3
7250_0,,,,2,2,1,3
C(C(C=O)C(C=O)O)=O,,,4,1,5,0,5
7250_1,,,,2,2,1,3
7251_0,,,,2,2,1,3
7251_1,,,,2,2,1,3
7253_0,,,,2,2,1,3
C(C(CC(C(O)=O)=O)O)=O,,,4,1,3,0,3
7255_0,,,,2,2,1,3
C(C(C(CO)=O)C(C=O)O)(O)=O,,,4,1,6,0,6
7255_1,,,,2,2,1,3
7257_0,,,,2,2,1,3
C(CC(C(C(C=O)O)O)=O)(O)=O,,,4,1,5,0,5
7257_1,,,,2,2,1,3
7259_0,,,,2,2,1,3
C(C(C(CC(C=O)O)=O)O)(O)=O,,,4,1,6,0,6
7261_0,,,,2,2,1,3
C(C(C(C(C(O)=O)=O)O)O)=O,,,4,1,4,0,4
7261_1,,,,2,2,1,3
7263_0,,,,2,2,1,3
C(C(C(C(C)=O)C(C=O)=O)O)=O,,,4,1,3,0,3
7263_1,,,,2,2,1,3
7265_0,,,,2,2,1,3
C(C(CC(CC(C=O)=O)=O)O)=O,,,4,1,4,0,4
7267_0,,,,2,2,1,3
C(C(C(C=O)=O)C(C=O)O)=O,,,4,1,5,0,5
7267_1,,,,2,2,1,3
7269_0,,,,2,2,1,3
C(C(C(C(C)=O)=O)C(C=O)O)=O,,,4,1,3,0,3
7269_1,,,,2,2,1,3
7271_0,,,,2,2,1,3
C(CC(C(CC(C=O)O)=O)=O)=O,,,4,1,3,0,3
7272_0,,,,2,2,1,3
7273_0,,,,2,2,1,3
7275_0,,,,2,2,1,3
C(C(C(C)=O)C(C=O)O)=O,,,4,1,6,0,6
7275_1,,,,2,2,1,3
7277_0,,,,2,2,1,3
C1(COC(C1C(C=O)O)O)=O,,,4,1,3,0,3
7277_1,,,,2,2,1,3
7279_0,,,,2,2,1,3
C(C(C1C(CC(O1)O)=O)O)=O,,,4,1,3,0,3
7279_1,,,,2,2,1,3
7281_0,,,,2,2,1,3
C1(COC(C(C1C(C=O)O)O)O)=O,,,4,1,3,0,3
7281_1,,,,2,2,1,3
7283_0,,,,2,2,1,3
C(C(C1C(CC(C(O1)O)O)=O)O)=O,,,4,1,3,0,3
7283_1,,,,2,2,1,3
7284_0,,,,2,2,1,3
7286_0,,,,2,2,1,3
C(C)(C(CO)C(C=O)O)=O,,,4,1,2,0,2
7286_1,,,,2,2,1,3
7288_0,,,,2,2,1,3
C(C(C(C(C)=O)C(C=O)O)O)(O)=O,,,4,1,2,0,2
7288_1,,,,2,2,1,3
7290_0,,,,2,2,1,3
C(C(CC(CC(C=O)O)=O)O)(O)=O,,,4,1,2,0,2
7292_0,,,,2,2,1,3
C(C(C(C=O)C(C=O)O)O)(O)=O,,,4,1,6,0,6
7292_1,,,,2,2,1,3
7294_0,,,,2,2,1,3
C(C(CC(C(C=O)=O)=O)O)=O,,,4,1,2,0,2
7296_0,,,,2,2,1,3
C(C(C(C(CO)=O)C(C=O)=O)O)=O,,,4,1,3,0,3
7296_1,,,,2,2,1,3
7298_0,,,,2,2,1,3
C(C(C(C(CC(C=O)=O)=O)O)O)=O,,,4,1,3,0,3
7298_1,,,,2,2,1,3
7300_0,,,,2,2,1,3
C(C(CC(C(C(C=O)=O)O)=O)O)=O,,,4,1,2,0,2
7302_0,,,,2,2,1,3
C(C(C(C(C=CC=O)=O)O)O)=O,,,4,1,3,0,3
7302_1,,,,2,2,1,3
7303_0,,,,2,2,1,3
7303_1,,,,2,2,1,3
7305_0,,,,2,2,1,3
C(C(C(C(C(O)=O)=O)CO)O)=O,,,4,1,3,0,3
7305_1,,,,2,2,1,3
7307_0,,,,2,2,1,3
C(CC(C=O)O)(C(C=O)(CO)O)=O,,,4,1,3,0,3
7308_0,,,,2,2,1,3
7310_0,,,,2,2,1,3
C(C(CC(C=CC(C=O)=O)=O)O)=O,,,4,1,1,0,1
7312_0,,,,2,2,1,3
C(C(C=CC(C=O)=O)C(C=O)O)=O,,,4,1,1,0,1
7314_0,,,,2,2,1,3
C(C(CC(C(C=CC=O)=O)=O)O)=O,,,4,1,1,0,1
7316_0,,,,2,2,1,3
C(C(C(C=CC=O)=O)C(C=O)O)=O,,,4,1,2,0,2
7316_1,,,,2,2,1,3
7318_0,,,,2,2,1,3
C(C(C(C(C=O)=O)C(C=C)=O)O)=O,,,4,1,2,0,2
7318_1,,,,2,2,1,3
7320_0,,,,2,2,1,3
C(C(C(C(C=C)=O)=O)C(C=O)O)=O,,,4,1,2,0,2
7320_1,,,,2,2,1,3
7322_0,,,,2,2,1,3
C(C(C(C=CC=O)C(C=O)=O)O)=O,,,4,1,1,0,1
7324_0,,,,2,2,1,3
C(C(C1C(C(CO1)O)=O)O)=O,,,4,1,3,0,3
7324_1,,,,2,2,1,3
7326_0,,,,2,2,1,3
C1(C(O)OCC1C(C=O)O)=O,,,4,1,3,0,3
7326_1,,,,2,2,1,3
7328_0,,,,2,2,1,3
C(C(CO)O)(CC(CCO)O)=O,,,4,1,1,0,1
7330_0,,,,2,2,1,3
C(C(CO)C(C)(C(CO)O)O)=O,,,4,1,4,0,4
7330_1,,,,2,2,1,3
7332_0,,,,2,2,1,3
C(C(CO)O)(CC(CC(C)O)O)=O,,,4,1,1,0,1
7334_0,,,,2,2,1,3
C(C(C(C)O)C(C)(C(CO)O)O)=O,,,4,1,4,0,4
7334_1,,,,2,2,1,3
7336_0,,,,2,2,1,3
C(CC(CC(C(CO)O)=O)O)=O,,,4,1,5,0,5
7338_0,,,,2,2,1,3
C(C(C=O)C(C)(C(CO)O)O)=O,,,4,1,3,0,3
7338_1,,,,2,2,1,3
7340_0,,,,2,2,1,3
C(C(C)(CC(C(CO)O)=O)O)(O)=O,,,4,1,2,0,2
7342_0,,,,2,2,1,3
C(C(CC(C)(C(CO)O)O)=O)(O)=O,,,4,1,2,0,2
7344_0,,,,2,2,1,3
C(CC(C(CO)O)=O)(O)=O,,,4,1,5,0,5
7345_0,,,,2,2,1,3
7347_0,,,,2,2,1,3
C(C)(C(C)(CC(C(CO)O)=O)O)=O,,,4,1,1,0,1
7349_0,,,,2,2,1,3
C(C(C)=O)(CC(C)(C(CO)O)O)=O,,,4,1,1,0,1
7351_0,,,,2,2,1,3
C(CC(C)(CC(C(CO)O)=O)O)=O,,,4,1,3,0,3
7353_0,,,,2,2,1,3
C(C(CO)O)(CC(CC(C)=O)O)=O,,,4,1,1,0,1
7355_0,,,,2,2,1,3
C(CC(CC(C)(C(CO)O)O)=O)=O,,,4,1,1,0,1
7357_0,,,,2,2,1,3
C(C(C(C)=O)C(C)(C(CO)O)O)=O,,,4,1,2,0,2
7357_1,,,,2,2,1,3
7359_0,,,,2,2,1,3
C(C(CO)O)(CC(C)(CCO)O)=O,,,4,1,1,0,1
7361_0,,,,2,2,1,3
C(CC(C)(C(CO)O)O)(CCO)=O,,,4,1,1,0,1
7363_0,,,,2,2,1,3
C(C)(C(CO)C(C)(C(CO)O)O)=O,,,4,1,2,0,2
7363_1,,,,2,2,1,3
7364_0,,,,2,2,1,3
7366_0,,,,2,2,1,3
C(C(C=O)(CC(C(CO)O)=O)O)=O,,,4,1,1,0,1
7368_0,,,,2,2,1,3
C(CC(C(C=C)=O)O)(C(CO)O)=O,,,4,1,1,0,1
7370_0,,,,2,2,1,3
C(C(C=C)(CC(C(CO)O)=O)O)=O,,,4,1,1,0,1
7372_0,,,,2,2,1,3
C(CC(C=C)(CO)O)(C(CO)O)=O,,,4,1,1,0,1
7374_0,,,,2,2,1,3
C=CC(C(C(C)(C(CO)O)O)O)=O,,,4,1,2,0,2
7374_1,,,,2,2,1,3
7376_0,,,,2,2,1,3
C(CC(C=CC=O)O)(C(CO)O)=O,,,4,1,1,0,1
7378_0,,,,2,2,1,3
C(C(CO)O)(CC(C(C)O)O)=O,,,4,1,1,0,1
7379_0,,,,2,2,1,3
7379_1,,,,2,2,1,3
7380_0,,,,2,2,1,3
7380_1,,,,2,2,1,3
7381_0,,,,2,2,1,3
7381_1,,,,2,2,1,3
7382_0,,,,2,2,1,3
7382_1,,,,2,2,1,3
7383_0,,,,2,2,1,3
7383_1,,,,2,2,1,3
7384_0,,,,2,2,1,3
7384_1,,,,2,2,1,3
7385_0,,,,2,2,1,3
7386_0,,,,2,2,1,3
7387_0,,,,2,2,1,3
7387_1,,,,2,2,1,3
7388_0,,,,2,2,1,3
7388_1,,,,2,2,1,3
7389_0,,,,2,2,1,3
7389_1,,,,2,2,1,3
7390_0,,,,2,2,1,3
7390_1,,,,2,2,1,3
7391_0,,,,2,2,1,3
7391_1,,,,2,2,1,3
7392_0,,,,2,2,1,3
7392_1,,,,2,2,1,3
7393_0,,,,2,2,1,3
7393_1,,,,2,2,1,3
7394_0,,,,2,2,1,3
7395_0,,,,2,2,1,3
7395_1,,,,2,2,1,3
7396_0,,,,2,2,1,3
7396_1,,,,2,2,1,3
7397_0,,,,2,2,1,3
7397_1,,,,2,2,1,3
7398_0,,,,2,2,1,3
7398_1,,,,2,2,1,3
7399_0,,,,2,2,1,3
7399_1,,,,2,2,1,3
7400_0,,,,2,2,1,3
7400_1,,,,2,2,1,3
7401_0,,,,2,2,1,3
7401_1,,,,2,2,1,3
7402_0,,,,2,2,1,3
7402_1,,,,2,2,1,3
7403_0,,,,2,2,1,3
7403_1,,,,2,2,1,3
7404_0,,,,2,2,1,3
7404_1,,,,2,2,1,3
7405_0,,,,2,2,1,3
7405_1,,,,2,2,1,3
7406_0,,,,2,2,1,3
7407_0,,,,2,2,1,3
7407_1,,,,2,2,1,3
7408_0,,,,2,2,1,3
7408_1,,,,2,2,1,3
7409_0,,,,2,2,1,3
7409_1,,,,2,2,1,3
7410_0,,,,2,2,1,3
7410_1,,,,2,2,1,3
7411_0,,,,2,2,1,3
7411_1,,,,2,2,1,3
7412_0,,,,2,2,1,3
7412_1,,,,2,2,1,3
7413_0,,,,2,2,1,3
7413_1,,,,2,2,1,3
7414_0,,,,2,2,1,3
7415_0,,,,2,2,1,3
7415_1,,,,2,2,1,3
7416_0,,,,2,2,1,3
7416_1,,,,2,2,1,3
7417_0,,,,2,2,1,3
7417_1,,,,2,2,1,3
7418_0,,,,2,2,1,3
7418_1,,,,2,2,1,3
7419_0,,,,2,2,1,3
7420_0,,,,2,2,1,3
7421_0,,,,2,2,1,3
7421_1,,,,2,2,1,3
7422_0,,,,2,2,1,3
7423_0,,,,2,2,1,3
7423_1,,,,2,2,1,3
7424_0,,,,2,2,1,3
7424_1,,,,2,2,1,3
7425_0,,,,2,2,1,3
7425_1,,,,2,2,1,3
7426_0,,,,2,2,1,3
7426_1,,,,2,2,1,3
7427_0,,,,2,2,1,3
7427_1,,,,2,2,1,3
7428_0,,,,2,2,1,3
7428_1,,,,2,2,1,3
7429_0,,,,2,2,1,3
7429_1,,,,2,2,1,3
7431_0,,,,2,2,1,3
C(C(C(C(CO)O)=O)CO)=O,,,4,1,5,0,5
7431_1,,,,2,2,1,3
7432_0,,,,2,2,1,3
7432_1,,,,2,2,1,3
7434_0,,,,2,2,1,3
C(C(C(C(CO)O)=O)C(C)O)=O,,,4,1,4,0,4
7434_1,,,,2,2,1,3
7436_0,,,,2,2,1,3
C(C(C(C(C(C)O)O)=O)CO)=O,,,4,1,4,0,4
7436_1,,,,2,2,1,3
7438_0,,,,2,2,1,3
C(CC(C(C(CO)=O)CO)O)=O,,,4,1,7,0,7
7438_1,,,,2,2,1,3
7439_0,,,,2,2,1,3
7439_1,,,,2,2,1,3
7440_0,,,,2,2,1,3
7440_1,,,,2,2,1,3
7441_0,,,,2,2,1,3
7441_1,,,,2,2,1,3
7442_0,,,,2,2,1,3
7442_1,,,,2,2,1,3
7444_0,,,,2,2,1,3
C(C(C(C(CO)CO)=O)O)=O,,,4,1,2,0,2
7444_1,,,,2,2,1,3
7446_0,,,,2,2,1,3
C(C(C(C(CO)C(C)O)=O)O)=O,,,4,1,4,0,4
7446_1,,,,2,2,1,3
7448_0,,,,2,2,1,3
C(CC(C(C(CCO)=O)O)O)=O,,,4,1,5,0,5
7449_0,,,,2,2,1,3
7449_1,,,,2,2,1,3
7450_0,,,,2,2,1,3
7450_1,,,,2,2,1,3
7451_0,,,,2,2,1,3
7451_1,,,,2,2,1,3
7453_0,,,,2,2,1,3
C(C(CO)O)(C(CO)CO)=O,,,4,1,4,0,4
7453_1,,,,2,2,1,3
7455_0,,,,2,2,1,3
C(C(CO)O)(C(CO)C(C)O)=O,,,4,1,6,0,6
7455_1,,,,2,2,1,3
7456_0,,,,2,2,1,3
7456_1,,,,2,2,1,3
7457_0,,,,2,2,1,3
7457_1,,,,2,2,1,3
7459_0,,,,2,2,1,3
C(C(CO)CO)=O,,,4,1,2,0,2
7459_1,,,,2,2,1,3
7461_0,,,,2,2,1,3
C(CC(C(C(CO)CO)=O)O)=O,,,4,1,5,0,5
7461_1,,,,2,2,1,3
7463_0,,,,2,2,1,3
C(C(CO)C(C(CCO)=O)O)=O,,,4,1,7,0,7
7463_1,,,,2,2,1,3
7465_0,,,,2,2,1,3
C(C(CO)C(C=O)(CCO)O)=O,,,4,1,4,0,4
7465_1,,,,2,2,1,3
7467_0,,,,2,2,1,3
C(C(C(C)O)O)(C(CO)CO)=O,,,4,1,4,0,4
7467_1,,,,2,2,1,3
7468_0,,,,2,2,1,3
7468_1,,,,2,2,1,3
7470_0,,,,2,2,1,3
C(C(CO)C(CO)(CCO)O)=O,,,4,1,4,0,4
7470_1,,,,2,2,1,3
7472_0,,,,2,2,1,3
C(C(CO)C(C(C=O)O)O)=O,,,4,1,4,0,4
7472_1,,,,2,2,1,3
7473_0,,,,2,2,1,3
7473_1,,,,2,2,1,3
7474_0,,,,2,2,1,3
7474_1,,,,2,2,1,3
7475_0,,,,2,2,1,3
7476_0,,,,2,2,1,3
7476_1,,,,2,2,1,3
7477_0,,,,2,2,1,3
7477_1,,,,2,2,1,3
7478_0,,,,2,2,1,3
7480_0,,,,2,2,1,3
C(C(CO)C(C)(CO)O)=O,,,4,1,4,0,4
7480_1,,,,2,2,1,3
7481_0,,,,2,2,1,3
7481_1,,,,2,2,1,3
7482_0,,,,2,2,1,3
7482_1,,,,2,2,1,3
7483_0,,,,2,2,1,3
7485_0,,,,2,2,1,3
C(C(CO)C(C(CC=O)O)O)=O,,,4,1,6,0,6
7485_1,,,,2,2,1,3
7487_0,,,,2,2,1,3
C(C(CO)C(CC(C=O)O)O)=O,,,4,1,5,0,5
7487_1,,,,2,2,1,3
7489_0,,,,2,2,1,3
C(C(CO)C(C)O)=O,,,4,1,4,0,4
7489_1,,,,2,2,1,3
7491_0,,,,2,2,1,3
C(C(CO)C(C(CO)=O)O)=O,,,4,1,9,0,9
7491_1,,,,2,2,1,3
7492_0,,,,2,2,1,3
7492_1,,,,2,2,1,3
7494_0,,,,2,2,1,3
C(C(CO)C(C=O)(CO)O)=O,,,4,1,6,0,6
7494_1,,,,2,2,1,3
7496_0,,,,2,2,1,3
C(C(CO)C(CO)(C(CO)O)O)=O,,,4,1,4,0,4
7496_1,,,,2,2,1,3
7498_0,,,,2,2,1,3
C(C(CO)C(C=O)(C(CO)O)O)=O,,,4,1,5,0,5
7498_1,,,,2,2,1,3
7499_0,,,,2,2,1,3
7499_1,,,,2,2,1,3
7500_0,,,,2,2,1,3
7500_1,,,,2,2,1,3
7501_0,,,,2,2,1,3
7501_1,,,,2,2,1,3
7502_0,,,,2,2,1,3
7502_1,,,,2,2,1,3
7503_0,,,,2,2,1,3
7503_1,,,,2,2,1,3
7504_0,,,,2,2,1,3
7504_1,,,,2,2,1,3
7505_0,,,,2,2,1,3
7505_1,,,,2,2,1,3
7506_0,,,,2,2,1,3
7507_0,,,,2,2,1,3
7507_1,,,,2,2,1,3
7508_0,,,,2,2,1,3
7508_1,,,,2,2,1,3
7510_0,,,,2,2,1,3
C(C(C)=O)(C(CO)O)=O,,,4,1,9,0,9
7510_1,,,,2,2,1,3
7512_0,,,,2,2,1,3
C(C(CO)=O)(CCO)=O,,,4,1,11,0,11
7513_0,,,,2,2,1,3
7513_1,,,,2,2,1,3
7515_0,,,,2,2,1,3
C(CO)(C(C(CO)=O)CO)=O,,,4,1,6,0,6
7515_1,,,,2,2,1,3
7516_0,,,,2,2,1,3
7516_1,,,,2,2,1,3
7517_0,,,,2,2,1,3
7519_0,,,,2,2,1,3
C(C(CO)O)(C(C)O)=O,,,4,1,8,0,8
7519_1,,,,2,2,1,3
7521_0,,,,2,2,1,3
C(C(C=O)CO)=O,,,4,1,8,0,8
7521_1,,,,2,2,1,3
7523_0,,,,2,2,1,3
C(C(C(C(CO)O)=O)O)=O,,,4,1,5,0,5
7523_1,,,,2,2,1,3
7524_0,,,,2,2,1,3
7526_0,,,,2,2,1,3
C(C(C(CO)=O)CO)(O)=O,,,4,1,6,0,6
7526_1,,,,2,2,1,3
7527_0,,,,2,2,1,3
7527_1,,,,2,2,1,3
7529_0,,,,2,2,1,3
C(C(C(CCO)=O)O)(O)=O,,,4,1,6,0,6
7531_0,,,,2,2,1,3
C(CO)(C(CO)C(C(O)=O)O)=O,,,4,1,7,0,7
7531_1,,,,2,2,1,3
7532_0,,,,2,2,1,3
7532_1,,,,2,2,1,3
7533_0,,,,2,2,1,3
7534_0,,,,2,2,1,3
7534_1,,,,2,2,1,3
7535_0,,,,2,2,1,3
7537_0,,,,2,2,1,3
C(C)(C(C(C=O)=O)CO)=O,,,4,1,7,0,7
7537_1,,,,2,2,1,3
7538_0,,,,2,2,1,3
7540_0,,,,2,2,1,3
C(C(C(C=O)=O)CO)=O,,,4,1,9,0,9
7540_1,,,,2,2,1,3
7542_0,,,,2,2,1,3
C(C(C(C(C)=O)=O)CO)=O,,,4,1,5,0,5
7542_1,,,,2,2,1,3
7543_0,,,,2,2,1,3
7545_0,,,,2,2,1,3
C(C(C)=O)(CCO)=O,,,4,1,11,0,11
7547_0,,,,2,2,1,3
C(CC(CCO)=O)=O,,,4,1,7,0,7
7549_0,,,,2,2,1,3
C(C(C(C)=O)CO)=O,,,4,1,5,0,5
7549_1,,,,2,2,1,3
7551_0,,,,2,2,1,3
C(OC(C(CCO)=O)C(CO)O)=O,,,4,1,3,0,3
7553_0,,,,2,2,1,3
C1(COC(C1CO)O)=O,,,4,1,5,0,5
7553_1,,,,2,2,1,3
7555_0,,,,2,2,1,3
C1(C(CO)OC(C1)O)=O,,,4,1,6,0,6
7555_1,,,,2,2,1,3
7557_0,,,,2,2,1,3
C(C(C(OC(C(C)=O)CO)O)O)=O,,,4,1,6,0,6
7557_1,,,,2,2,1,3
7559_0,,,,2,2,1,3
C(C(C(OCC(CCO)=O)O)O)=O,,,4,1,5,0,5
7561_0,,,,2,2,1,3
C(C(CO)OC(C(CO)=O)CO)=O,,,4,1,4,0,4
7561_1,,,,2,2,1,3
7563_0,,,,2,2,1,3
C(C(CO)OCC(C(CO)O)=O)=O,,,4,1,5,0,5
7563_1,,,,2,2,1,3
7565_0,,,,2,2,1,3
C(C(CO)OC(C(CCO)=O)O)=O,,,4,1,3,0,3
7567_0,,,,2,2,1,3
C(OC(CO)C(C(CCO)=O)O)=O,,,4,1,3,0,3
7569_0,,,,2,2,1,3
C(OC(CO)CC(C(CO)O)=O)=O,,,4,1,5,0,5
7569_1,,,,2,2,1,3
7571_0,,,,2,2,1,3
C(OC(CO)C(C(CO)=O)CO)=O,,,4,1,4,0,4
7571_1,,,,2,2,1,3
7573_0,,,,2,2,1,3
C(C(CO)OC(C=O)O)(CCO)=O,,,4,1,3,0,3
7575_0,,,,2,2,1,3
C1(COC(C(C1CO)O)O)=O,,,4,1,5,0,5
7575_1,,,,2,2,1,3
7576_0,,,,2,2,1,3
7576_1,,,,2,2,1,3
7578_0,,,,2,2,1,3
C(C(COC(C(CO)=O)CO)O)=O,,,4,1,4,0,4
7578_1,,,,2,2,1,3
7580_0,,,,2,2,1,3
C(C(COCC(C(CO)O)=O)O)=O,,,4,1,5,0,5
7580_1,,,,2,2,1,3
7582_0,,,,2,2,1,3
C(C(COC(C(CCO)=O)O)O)=O,,,4,1,3,0,3
7584_0,,,,2,2,1,3
C(OCC(C(C(CCO)=O)O)O)=O,,,4,1,3,0,3
7586_0,,,,2,2,1,3
C(CO)(C(C(OCC=O)O)CO)=O,,,4,1,4,0,4
7586_1,,,,2,2,1,3
7588_0,,,,2,2,1,3
C(C(CO)O)(CC(OCC=O)O)=O,,,4,1,5,0,5
7588_1,,,,2,2,1,3
7590_0,,,,2,2,1,3
C(C(CO)OC(CC(CO)=O)O)=O,,,4,1,2,0,2
7590_1,,,,2,2,1,3
7592_0,,,,2,2,1,3
C(OCC(CC(C(CO)O)=O)O)=O,,,4,1,5,0,5
7592_1,,,,2,2,1,3
7594_0,,,,2,2,1,3
C(OCC(C(C(CO)=O)CO)O)=O,,,4,1,4,0,4
7594_1,,,,2,2,1,3
7596_0,,,,2,2,1,3
C(C(C(OCC=O)O)O)(CCO)=O,,,4,1,3,0,3
7598_0,,,,2,2,1,3
C(C(CO)OC(C(C(C)=O)O)O)=O,,,4,1,2,0,2
7598_1,,,,2,2,1,3
7600_0,,,,2,2,1,3
C(C(COC(C=O)O)O)(CCO)=O,,,4,1,3,0,3
7602_0,,,,2,2,1,3
C(C(CO)O)(CCOC(C=O)O)=O,,,4,1,5,0,5
7602_1,,,,2,2,1,3
7604_0,,,,2,2,1,3
C(CO)(C(CO)COC(C=O)O)=O,,,4,1,4,0,4
7604_1,,,,2,2,1,3
7606_0,,,,2,2,1,3
C(CCO)(CCO)=O,,,4,1,3,0,3
7608_0,,,,2,2,1,3
C(C)(C(CO)CO)=O,,,4,1,3,0,3
7608_1,,,,2,2,1,3
7609_0,,,,2,2,1,3
7609_1,,,,2,2,1,3
7610_0,,,,2,2,1,3
7611_0,,,,2,2,1,3
7611_1,,,,2,2,1,3
7613_0,,,,2,2,1,3
C(C(C(CCO)=O)=O)=O,,,4,1,4,0,4
7615_0,,,,2,2,1,3
C(CO)(C(C(C=O)=O)CO)=O,,,4,1,8,0,8
7615_1,,,,2,2,1,3
7616_0,,,,2,2,1,3
7616_1,,,,2,2,1,3
7617_0,,,,2,2,1,3
7618_0,,,,2,2,1,3
7618_1,,,,2,2,1,3
7620_0,,,,2,2,1,3
C=CC(C(CO)O)=O,,,4,1,8,0,8
7620_1,,,,2,2,1,3
7622_0,,,,2,2,1,3
C(CC(CO)(OC(C=O)CO)O)=O,,,4,1,5,0,5
7622_1,,,,2,2,1,3
7624_0,,,,2,2,1,3
C(C(CO)C(CO)(OCC=O)O)=O,,,4,1,2,0,2
7624_1,,,,2,2,1,3
7626_0,,,,2,2,1,3
C(C(C(C)(OC(C=O)CO)O)O)=O,,,4,1,5,0,5
7626_1,,,,2,2,1,3
7628_0,,,,2,2,1,3
C(C(CC(OC(C=O)CO)O)O)=O,,,4,1,5,0,5
7628_1,,,,2,2,1,3
7630_0,,,,2,2,1,3
C(C(C(CO)O)=O)(C(CO)CO)=O,,,4,1,4,0,4
7630_1,,,,2,2,1,3
7632_0,,,,2,2,1,3
C(C(C(CO)O)=O)(C(CCO)O)=O,,,4,1,3,0,3
7632_1,,,,2,2,1,3
7633_0,,,,2,2,1,3
7635_0,,,,2,2,1,3
C(C(CO)O)(C(C(C(C)O)=O)O)=O,,,4,1,3,0,3
7635_1,,,,2,2,1,3
7637_0,,,,2,2,1,3
C(C(CC(CO)O)O)(C(CO)O)=O,,,4,1,3,0,3
7637_1,,,,2,2,1,3
7639_0,,,,2,2,1,3
C(C(C(CCO)O)O)(C(CO)O)=O,,,4,1,5,0,5
7639_1,,,,2,2,1,3
7641_0,,,,2,2,1,3
C(C(CC(C(C=O)=O)CO)O)=O,,,4,1,3,0,3
7643_0,,,,2,2,1,3
C(C(C)O)(C(C(C=O)=O)CO)=O,,,4,1,4,0,4
7643_1,,,,2,2,1,3
7644_0,,,,2,2,1,3
7644_1,,,,2,2,1,3
7646_0,,,,2,2,1,3
C(CC(C(C(CCO)=O)=O)O)=O,,,4,1,2,0,2
7648_0,,,,2,2,1,3
C(C(C(C(C(C)O)=O)=O)CO)=O,,,4,1,4,0,4
7648_1,,,,2,2,1,3
7650_0,,,,2,2,1,3
C(C)(CC(C(C(CO)O)=O)=O)=O,,,4,1,4,0,4
7650_1,,,,2,2,1,3
7652_0,,,,2,2,1,3
C(C)(C(C(C(CO)=O)=O)CO)=O,,,4,1,5,0,5
7652_1,,,,2,2,1,3
7654_0,,,,2,2,1,3
C(CCO)(CC(C(CO)=O)=O)=O,,,4,1,4,0,4
7655_0,,,,2,2,1,3
7655_1,,,,2,2,1,3
7656_0,,,,2,2,1,3
7658_0,,,,2,2,1,3
C(CCC(C(C(CO)O)=O)=O)=O,,,4,1,4,0,4
7658_1,,,,2,2,1,3
7660_0,,,,2,2,1,3
C(CC(C(C(CO)=O)=O)CO)=O,,,4,1,4,0,4
7662_0,,,,2,2,1,3
C(C(CO)CC(C(CO)=O)=O)=O,,,4,1,3,0,3
7664_0,,,,2,2,1,3
C(C(CO)CC(C(C=O)=O)O)=O,,,4,1,2,0,2
7666_0,,,,2,2,1,3
C(C(CO)O)(CC(C(C)=O)=O)=O,,,4,1,4,0,4
7666_1,,,,2,2,1,3
7668_0,,,,2,2,1,3
C(CO)(C(C(C(C)=O)=O)CO)=O,,,4,1,5,0,5
7668_1,,,,2,2,1,3
7670_0,,,,2,2,1,3
C(CO)(CC(C(CCO)=O)=O)=O,,,4,1,3,0,3
7672_0,,,,2,2,1,3
C1(C(CO)OC(C(CC1O)O)O)=O,,,4,1,3,0,3
7672_1,,,,2,2,1,3
7674_0,,,,2,2,1,3
C(C(CO)C(C(O)=O)O)(C(C)O)=O,,,4,1,2,0,2
7674_1,,,,2,2,1,3
7676_0,,,,2,2,1,3
C(C(C(C(C(CO)CO)=O)=O)O)=O,,,4,1,3,0,3
7676_1,,,,2,2,1,3
7678_0,,,,2,2,1,3
C(C(C=O)O)(C(C(CO)=O)CO)=O,,,4,1,3,0,3
7678_1,,,,2,2,1,3
7680_0,,,,2,2,1,3
C(C(C=O)O)(CC(C(CO)O)=O)=O,,,4,1,4,0,4
7680_1,,,,2,2,1,3
7682_0,,,,2,2,1,3
C(C(C(C(C(CCO)=O)O)=O)O)=O,,,4,1,2,0,2
7683_0,,,,2,2,1,3
7683_1,,,,2,2,1,3
7685_0,,,,2,2,1,3
C(CO)=CC(C(C(CO)O)=O)=O,,,4,1,3,0,3
7685_1,,,,2,2,1,3
7687_0,,,,2,2,1,3
C(C(CO)O)(C(C=CC=O)O)=O,,,4,1,4,0,4
7687_1,,,,2,2,1,3
7689_0,,,,2,2,1,3
C(C(CO)O)(C(C(C=C)=O)O)=O,,,4,1,3,0,3
7689_1,,,,2,2,1,3
7691_0,,,,2,2,1,3
C(C=CC(CO)=O)(C(CO)O)=O,,,4,1,5,0,5
7691_1,,,,2,2,1,3
7693_0,,,,2,2,1,3
C(C1(CC(CO1)O)O)(C(CO)O)=O,,,4,1,3,0,3
7693_1,,,,2,2,1,3
7695_0,,,,2,2,1,3
C(C1C(CC(O1)O)O)(C(CO)O)=O,,,4,1,3,0,3
7695_1,,,,2,2,1,3
7697_0,,,,2,2,1,3
C(CCO)(CC(C(CO)O)=O)=O,,,4,1,7,0,7
7697_1,,,,2,2,1,3
7699_0,,,,2,2,1,3
C(CCO)(C(C(CO)=O)CO)=O,,,4,1,6,0,6
7699_1,,,,2,2,1,3
7701_0,,,,2,2,1,3
C(C(CO)CO)(CC(CO)=O)=O,,,4,1,5,0,5
7701_1,,,,2,2,1,3
7703_0,,,,2,2,1,3
C(CCC(C(CO)O)=O)(CO)=O,,,4,1,5,0,5
7703_1,,,,2,2,1,3
7705_0,,,,2,2,1,3
C(CO)(C(CO)CC(CO)=O)=O,,,4,1,6,0,6
7707_0,,,,2,2,1,3
C(C(C(CO)C(CCO)O)=O)=O,,,4,1,5,0,5
7707_1,,,,2,2,1,3
7709_0,,,,2,2,1,3
C(C(CCO)=O)(C(CO)CO)=O,,,4,1,6,0,6
7709_1,,,,2,2,1,3
7711_0,,,,2,2,1,3
C(C(CO)CO)(C(C(C)=O)O)=O,,,4,1,4,0,4
7711_1,,,,2,2,1,3
7713_0,,,,2,2,1,3
C(CCO)(C(C(CCO)=O)O)=O,,,4,1,3,0,3
7715_0,,,,2,2,1,3
C(C(C(C(CCO)O)=O)CO)=O,,,4,1,4,0,4
7715_1,,,,2,2,1,3
7717_0,,,,2,2,1,3
C(C(CO)O)(C(C(C)=O)CO)=O,,,4,1,5,0,5
7717_1,,,,2,2,1,3
7718_0,,,,2,2,1,3
7720_0,,,,2,2,1,3
C(C(CO)CC=O)(C(CO)O)=O,,,4,1,4,0,4
7722_0,,,,2,2,1,3
C(C(CO)CC(C(CO)O)=O)=O,,,4,1,5,0,5
7724_0,,,,2,2,1,3
C(C(C(C(CO)CCO)=O)O)=O,,,4,1,2,0,2
7726_0,,,,2,2,1,3
C(C(C)=O)(C(CO)C(CO)O)=O,,,4,1,5,0,5
7726_1,,,,2,2,1,3
7728_0,,,,2,2,1,3
C(C(CCO)=O)(CC(CO)O)=O,,,4,1,3,0,3
7730_0,,,,2,2,1,3
C(CC(C(CO)C(CO)O)=O)=O,,,4,1,4,0,4
7730_1,,,,2,2,1,3
7732_0,,,,2,2,1,3
C(C(C(CC(CO)O)=O)CO)=O,,,4,1,5,0,5
7732_1,,,,2,2,1,3
7734_0,,,,2,2,1,3
C(C(CO)C(C=O)O)(CCO)=O,,,4,1,4,0,4
7734_1,,,,2,2,1,3
7736_0,,,,2,2,1,3
C(CC(C=O)O)(C(CO)CO)=O,,,4,1,4,0,4
7736_1,,,,2,2,1,3
7738_0,,,,2,2,1,3
C(C(CO)O)=CC(C(CO)O)=O,,,4,1,4,0,4
7738_1,,,,2,2,1,3
7740_0,,,,2,2,1,3
C(C(C(CO)CO)=O)(O)=O,,,4,1,4,0,4
7740_1,,,,2,2,1,3
7742_0,,,,2,2,1,3
C(CCO)(C(C(C(O)=O)=O)CO)=O,,,4,1,4,0,4
7742_1,,,,2,2,1,3
7744_0,,,,2,2,1,3
C(C(CO)CO)(CC(C(O)=O)=O)=O,,,4,1,4,0,4
7744_1,,,,2,2,1,3
7746_0,,,,2,2,1,3
C(CC(C(C(O)=O)=O)CO)(CO)=O,,,4,1,2,0,2
7748_0,,,,2,2,1,3
C(CO)(C(CO)CC(C(O)=O)=O)=O,,,4,1,3,0,3
7750_0,,,,2,2,1,3
C(CCC(C(O)=O)=O)(C(CO)O)=O,,,4,1,4,0,4
7750_1,,,,2,2,1,3
7751_0,,,,2,2,1,3
7751_1,,,,2,2,1,3
7753_0,,,,2,2,1,3
C(C(CC(C(O)=O)=O)O)(CCO)=O,,,4,1,4,0,4
7754_0,,,,2,2,1,3
7754_1,,,,2,2,1,3
7756_0,,,,2,2,1,3
C(C(CO)C(CC(C(O)=O)=O)O)=O,,,4,1,4,0,4
7756_1,,,,2,2,1,3
7758_0,,,,2,2,1,3
C(CC(C(C(C=O)=O)CO)O)(O)=O,,,4,1,3,0,3
7758_1,,,,2,2,1,3
7759_0,,,,2,2,1,3
7759_1,,,,2,2,1,3
7761_0,,,,2,2,1,3
C(CC(C(C(CO)CO)=O)=O)(O)=O,,,4,1,3,0,3
7761_1,,,,2,2,1,3
7762_0,,,,2,2,1,3
7762_1,,,,2,2,1,3
7764_0,,,,2,2,1,3
C(CC(O)=O)(C(C(CO)=O)CO)=O,,,4,1,3,0,3
7764_1,,,,2,2,1,3
7765_0,,,,2,2,1,3
7765_1,,,,2,2,1,3
7766_0,,,,2,2,1,3
7766_1,,,,2,2,1,3
7767_0,,,,2,2,1,3
7768_0,,,,2,2,1,3
7768_1,,,,2,2,1,3
7770_0,,,,2,2,1,3
C(C(CO)C(C(CC(O)=O)=O)O)=O,,,4,1,3,0,3
7770_1,,,,2,2,1,3
7772_0,,,,2,2,1,3
C(CC(C(C(C=O)CO)=O)O)(O)=O,,,4,1,3,0,3
7772_1,,,,2,2,1,3
7774_0,,,,2,2,1,3
C(C(C(O)=O)O)(C(C(C)=O)CO)=O,,,4,1,4,0,4
7774_1,,,,2,2,1,3
7775_0,,,,2,2,1,3
7777_0,,,,2,2,1,3
C(C(CO)CC=O)(C(C(O)=O)O)=O,,,4,1,3,0,3
7779_0,,,,2,2,1,3
C(C(CO)CC(C(C(O)=O)O)=O)=O,,,4,1,3,0,3
7781_0,,,,2,2,1,3
C(C(CO)CC(O)=O)(C(C=O)O)=O,,,4,1,2,0,2
7783_0,,,,2,2,1,3
C(C(C(C(C(C)=O)=O)CO)O)(O)=O,,,4,1,4,0,4
7783_1,,,,2,2,1,3
7785_0,,,,2,2,1,3
C(C(CC(C(CCO)=O)=O)O)(O)=O,,,4,1,3,0,3
7787_0,,,,2,2,1,3
C(C(CO)C(C(O)=O)O)(CC=O)=O,,,4,1,4,0,4
7787_1,,,,2,2,1,3
7789_0,,,,2,2,1,3
C(CC(C(O)=O)O)(C(C=O)CO)=O,,,4,1,4,0,4
7789_1,,,,2,2,1,3
7791_0,,,,2,2,1,3
C(C(CO)C(C=O)O)(CC(O)=O)=O,,,4,1,3,0,3
7791_1,,,,2,2,1,3
7792_0,,,,2,2,1,3
7792_1,,,,2,2,1,3
7794_0,,,,2,2,1,3
C(C(C=CC(C(CO)O)=O)O)(O)=O,,,4,1,4,0,4
7794_1,,,,2,2,1,3
7796_0,,,,2,2,1,3
C(C1(C(C(CO)CC1O)=O)O)=O,,,4,1,3,0,3
7798_0,,,,2,2,1,3
C1(C(CO)(C(C(C1CO)=O)O)O)=O,,,4,1,4,0,4
7798_1,,,,2,2,1,3
7799_0,,,,2,2,1,3
7801_0,,,,2,2,1,3
C(CCO)(C(C=O)(C(C=O)O)O)=O,,,4,1,3,0,3
7803_0,,,,2,2,1,3
C(C(C(CCO)=O)(CO)O)=O,,,4,1,4,0,4
7805_0,,,,2,2,1,3
C(C(C(CCO)=O)(C(C)O)O)=O,,,4,1,3,0,3
7807_0,,,,2,2,1,3
C(CCO)(C(CO)(CO)O)=O,,,4,1,3,0,3
7809_0,,,,2,2,1,3
C(CCO)(C(CO)(C(C)O)O)=O,,,4,1,5,0,5
7811_0,,,,2,2,1,3
C(C(CO)O)(C(CO)(CO)O)=O,,,4,1,5,0,5
7811_1,,,,2,2,1,3
7813_0,,,,2,2,1,3
C(C(CO)O)(C(CO)(C(C)O)O)=O,,,4,1,6,0,6
7813_1,,,,2,2,1,3
7815_0,,,,2,2,1,3
C(C(C(CCO)=O)(C(CO)O)O)=O,,,4,1,3,0,3
7816_0,,,,2,2,1,3
7818_0,,,,2,2,1,3
C1(C(CO)C(C=O)(C(C1)O)O)=O,,,4,1,3,0,3
7818_1,,,,2,2,1,3
7820_0,,,,2,2,1,3
C(C1(C(C(C(C1)=O)CO)O)O)=O,,,4,1,3,0,3
7820_1,,,,2,2,1,3
7821_0,,,,2,2,1,3
7821_1,,,,2,2,1,3
7822_0,,,,2,2,1,3
7822_1,,,,2,2,1,3
7823_0,,,,2,2,1,3
7823_1,,,,2,2,1,3
7824_0,,,,2,2,1,3
7824_1,,,,2,2,1,3
7826_0,,,,2,2,1,3
C1(C(CO)C(C(C1O)=O)CO)=O,,,4,1,1,0,1
7828_0,,,,2,2,1,3
C(C(C(C(CO)O)O)=O)(CCO)=O,,,4,1,2,0,2
7830_0,,,,2,2,1,3
C1(C(CO)CC(C1(CO)O)=O)=O,,,4,1,4,0,4
7832_0,,,,2,2,1,3
C1(C(CO)C(C(C1)=O)(CO)O)=O,,,4,1,3,0,3
7832_1,,,,2,2,1,3
7834_0,,,,2,2,1,3
C1(C(CO)(CC(C1CO)=O)O)=O,,,4,1,4,0,4
7834_1,,,,2,2,1,3
7836_0,,,,2,2,1,3
C1(CC(C(C(CCO)=O)O1)O)=O,,,4,1,2,0,2
7838_0,,,,2,2,1,3
C(C(CO)C1C(CC(O1)=O)O)=O,,,4,1,3,0,3
7838_1,,,,2,2,1,3
7840_0,,,,2,2,1,3
C(C1C(C(C(CO)O1)=O)O)(C)=O,,,4,1,3,0,3
7840_1,,,,2,2,1,3
7842_0,,,,2,2,1,3
C(C1C(C(CO1)=O)O)(CCO)=O,,,4,1,2,0,2
7844_0,,,,2,2,1,3
C(CC1C(C(C(CO)O1)=O)O)=O,,,4,1,3,0,3
7844_1,,,,2,2,1,3
7846_0,,,,2,2,1,3
C(C(CO)C1C(C(CO1)=O)O)=O,,,4,1,3,0,3
7846_1,,,,2,2,1,3
7848_0,,,,2,2,1,3
C(C1C(C(C(O1)O)=O)CO)(C)=O,,,4,1,4,0,4
7848_1,,,,2,2,1,3
7850_0,,,,2,2,1,3
C1(C(OC(C(CCO)=O)C1)O)=O,,,4,1,3,0,3
7852_0,,,,2,2,1,3
C(CC1C(C(C(O)O1)=O)CO)=O,,,4,1,4,0,4
7852_1,,,,2,2,1,3
7854_0,,,,2,2,1,3
C(C(CO)C1CC(C(O)O1)=O)=O,,,4,1,4,0,4
7854_1,,,,2,2,1,3
7856_0,,,,2,2,1,3
C1(C(CO)C(OC1C(C)=O)O)=O,,,4,1,4,0,4
7856_1,,,,2,2,1,3
7858_0,,,,2,2,1,3
C(CCO)(C1C(CC(O1)O)=O)=O,,,4,1,3,0,3
7860_0,,,,2,2,1,3
C(CC1C(C(CO)C(O1)O)=O)=O,,,4,1,4,0,4
7860_1,,,,2,2,1,3
7862_0,,,,2,2,1,3
C(C(CO)C1C(CC(O1)O)=O)=O,,,4,1,4,0,4
7862_1,,,,2,2,1,3
7864_0,,,,2,2,1,3
C1(C(C(CC(CO)O1)=O)CO)=O,,,4,1,4,0,4
7864_1,,,,2,2,1,3
7866_0,,,,2,2,1,3
C1(CC(C(CO)C(CO)O1)=O)=O,,,4,1,3,0,3
7866_1,,,,2,2,1,3
7868_0,,,,2,2,1,3
C1(C(CO)OC(CC1CO)=O)=O,,,4,1,2,0,2
7870_0,,,,2,2,1,3
C1(C(C(CO)OC(CO)C1)=O)=O,,,4,1,3,0,3
7870_1,,,,2,2,1,3
7872_0,,,,2,2,1,3
C1(C(COC(CO)C1CO)=O)=O,,,4,1,3,0,3
7872_1,,,,2,2,1,3
7874_0,,,,2,2,1,3
C1(C(CO)OC(C(C1)=O)CO)=O,,,4,1,3,0,3
7874_1,,,,2,2,1,3
7876_0,,,,2,2,1,3
C1(C(CO)OCC(C1CO)=O)=O,,,4,1,4,0,4
7876_1,,,,2,2,1,3
7878_0,,,,2,2,1,3
C1(C(C(CC(CO1)O)=O)CO)=O,,,4,1,4,0,4
7878_1,,,,2,2,1,3
7880_0,,,,2,2,1,3
C1(CC(C(CO)C(CO1)O)=O)=O,,,4,1,3,0,3
7880_1,,,,2,2,1,3
7882_0,,,,2,2,1,3
C1(C(CO)CC(OCC1O)=O)=O,,,4,1,2,0,2
7884_0,,,,2,2,1,3
C1(CC(C(C(CO)CO1)=O)O)=O,,,4,1,3,0,3
7884_1,,,,2,2,1,3
7886_0,,,,2,2,1,3
C1(CC(C(C(CO1)=O)CO)O)=O,,,4,1,3,0,3
7886_1,,,,2,2,1,3
7888_0,,,,2,2,1,3
C1(CC(CC(C(CO)O1)=O)O)=O,,,4,1,3,0,3
7888_1,,,,2,2,1,3
7890_0,,,,2,2,1,3
C1(C(C(CO)OCC(C1)O)=O)=O,,,4,1,3,0,3
7890_1,,,,2,2,1,3
7892_0,,,,2,2,1,3
C1(C(COCC(C1CO)O)=O)=O,,,4,1,3,0,3
7892_1,,,,2,2,1,3
7894_0,,,,2,2,1,3
C1(C(COC(C(C1)=O)CO)O)=O,,,4,1,3,0,3
7894_1,,,,2,2,1,3
7896_0,,,,2,2,1,3
C1(C(COCC(C1CO)=O)O)=O,,,4,1,4,0,4
7896_1,,,,2,2,1,3
7898_0,,,,2,2,1,3
C1(CCOC(C(C1O)=O)CO)=O,,,4,1,3,0,3
7898_1,,,,2,2,1,3
7900_0,,,,2,2,1,3
C1(C(CO)COCC(C1O)=O)=O,,,4,1,3,0,3
7900_1,,,,2,2,1,3
7902_0,,,,2,2,1,3
C1(CC(C(C(CO)OC1)=O)O)=O,,,4,1,3,0,3
7902_1,,,,2,2,1,3
7904_0,,,,2,2,1,3
C1(COCC(C(C1CO)O)=O)=O,,,4,1,3,0,3
7904_1,,,,2,2,1,3
7906_0,,,,2,2,1,3
C1(CC(C(COC1CO)=O)O)=O,,,4,1,3,0,3
7906_1,,,,2,2,1,3
7908_0,,,,2,2,1,3
C1(CCOC(C(C1CO)=O)O)=O,,,4,1,5,0,5
7908_1,,,,2,2,1,3
7910_0,,,,2,2,1,3
C1(C(CO)COC(C(C1)=O)O)=O,,,4,1,4,0,4
7910_1,,,,2,2,1,3
7912_0,,,,2,2,1,3
C1(CC(C(C(OC1)O)=O)CO)=O,,,4,1,3,0,3
7914_0,,,,2,2,1,3
C1(COC(C(CC1CO)=O)O)=O,,,4,1,3,0,3
7916_0,,,,2,2,1,3
C1(CCC(C(OC1CO)O)=O)=O,,,4,1,4,0,4
7916_1,,,,2,2,1,3
7918_0,,,,2,2,1,3
C1(C(CCOC(C1CO)O)=O)=O,,,4,1,4,0,4
7918_1,,,,2,2,1,3
7920_0,,,,2,2,1,3
C1(C(CC(O)OCC1CO)=O)=O,,,4,1,4,0,4
7920_1,,,,2,2,1,3
7922_0,,,,2,2,1,3
C1(C(CO)C(OCC(C1)=O)O)=O,,,4,1,4,0,4
7922_1,,,,2,2,1,3
7924_0,,,,2,2,1,3
C1(CC(OCC(C1CO)=O)O)=O,,,4,1,5,0,5
7924_1,,,,2,2,1,3
7926_0,,,,2,2,1,3
C1(CC(OC(C(C1)=O)CO)O)=O,,,4,1,4,0,4
7926_1,,,,2,2,1,3
7928_0,,,,2,2,1,3
C(C)(C(C(C(C=O)=O)=O)CO)=O,,,4,1,4,0,4
7928_1,,,,2,2,1,3
7930_0,,,,2,2,1,3
C(CCO)(CC(C(C=O)=O)=O)=O,,,4,1,2,0,2
7932_0,,,,2,2,1,3
C(CC(C(C(C=O)=O)=O)CO)=O,,,4,1,3,0,3
7934_0,,,,2,2,1,3
C(C(CO)CC(C(C=O)=O)=O)=O,,,4,1,2,0,2
7936_0,,,,2,2,1,3
C(C(C(C(C(C)=O)=O)CO)=O)=O,,,4,1,5,0,5
7936_1,,,,2,2,1,3
7938_0,,,,2,2,1,3
C(C(CC(C(CCO)=O)=O)=O)=O,,,4,1,3,0,3
7940_0,,,,2,2,1,3
C(CC=O)(C(C(C=O)=O)CO)=O,,,4,1,6,0,6
7940_1,,,,2,2,1,3
7942_0,,,,2,2,1,3
C(C(C(CC(C=O)=O)=O)CO)=O,,,4,1,5,0,5
7942_1,,,,2,2,1,3
7944_0,,,,2,2,1,3
C(C(C=CC(CCO)=O)=O)=O,,,4,1,2,0,2
7946_0,,,,2,2,1,3
C(C(C=CC(C=O)=O)CO)=O,,,4,1,2,0,2
7948_0,,,,2,2,1,3
C(C(C=CC=O)=O)(CCO)=O,,,4,1,2,0,2
7950_0,,,,2,2,1,3
C(C(C(C=CC=O)=O)CO)=O,,,4,1,6,0,6
7950_1,,,,2,2,1,3
7952_0,,,,2,2,1,3
C=CC(C(C(C=O)=O)CO)=O,,,4,1,4,0,4
7952_1,,,,2,2,1,3
7954_0,,,,2,2,1,3
C(C(C(C(C=C)=O)=O)CO)=O,,,4,1,4,0,4
7954_1,,,,2,2,1,3
7956_0,,,,2,2,1,3
C(C(C(C=O)=O)CO)=CC=O,,,4,1,2,0,2
7958_0,,,,2,2,1,3
C(C=CC(C(CO)CO)=O)(O)=O,,,4,1,3,0,3
7958_1,,,,2,2,1,3
7960_0,,,,2,2,1,3
C(CO)(C(C=CC(O)=O)CO)=O,,,4,1,2,0,2
7962_0,,,,2,2,1,3
C(C(CO)O)(CC=CC(O)=O)=O,,,4,1,3,0,3
7962_1,,,,2,2,1,3
7964_0,,,,2,2,1,3
C(CCO)(C(C=CC(O)=O)O)=O,,,4,1,2,0,2
7966_0,,,,2,2,1,3
C(C(CO)C(C=CC(O)=O)O)=O,,,4,1,3,0,3
7966_1,,,,2,2,1,3
7968_0,,,,2,2,1,3
C(C(C=CC(CCO)=O)O)(O)=O,,,4,1,2,0,2
7970_0,,,,2,2,1,3
C(C(C=CC(C(O)=O)O)CO)=O,,,4,1,2,0,2
7972_0,,,,2,2,1,3
C1(C(CO)OCC1O)=O,,,4,1,2,0,2
7972_1,,,,2,2,1,3
7974_0,,,,2,2,1,3
C1(C(O)OCC1CO)=O,,,4,1,3,0,3
7974_1,,,,2,2,1,3
7976_0,,,,2,2,1,3
C1(C(CO)(O)OC(CO)C1CO)=O,,,4,1,3,0,3
7976_1,,,,2,2,1,3
7978_0,,,,2,2,1,3
C1(C(CO)OC(CO)(C1CO)O)=O,,,4,1,3,0,3
7978_1,,,,2,2,1,3
7980_0,,,,2,2,1,3
C(C(CO)C1C(C(CO1)O)=O)=O,,,4,1,3,0,3
7980_1,,,,2,2,1,3
7982_0,,,,2,2,1,3
C(C(CO)C1(C(CCO1)=O)O)=O,,,4,1,4,0,4
7982_1,,,,2,2,1,3
7984_0,,,,2,2,1,3
C(CC1(C(C(CO)CO1)=O)O)=O,,,4,1,3,0,3
7984_1,,,,2,2,1,3
7986_0,,,,2,2,1,3
C(C(CO)C1(CC(CO1)=O)O)=O,,,4,1,4,0,4
7986_1,,,,2,2,1,3
7988_0,,,,2,2,1,3
C(CC1(C(C(CO1)=O)CO)O)=O,,,4,1,3,0,3
7988_1,,,,2,2,1,3
7990_0,,,,2,2,1,3
C(CC1(CC(C(CO)O1)=O)O)=O,,,4,1,3,0,3
7990_1,,,,2,2,1,3
7992_0,,,,2,2,1,3
C(C1C(C(CO)C(C)(O1)O)=O)=O,,,4,1,3,0,3
7992_1,,,,2,2,1,3
7994_0,,,,2,2,1,3
C1(C(C)(OC(C=O)C1CO)O)=O,,,4,1,3,0,3
7994_1,,,,2,2,1,3
7996_0,,,,2,2,1,3
C(C1C(C(C(O1)O)=O)O)(CCO)=O,,,4,1,2,0,2
7998_0,,,,2,2,1,3
C(C(CO)C1C(C(C(O)O1)=O)O)=O,,,4,1,3,0,3
7998_1,,,,2,2,1,3
8000_0,,,,2,2,1,3
C(C1(C(C(CO)C(CO)O1)=O)O)=O,,,4,1,3,0,3
8000_1,,,,2,2,1,3
8002_0,,,,2,2,1,3
C1(C(CO)C(C=O)(OC1CO)O)=O,,,4,1,3,0,3
8002_1,,,,2,2,1,3
8004_0,,,,2,2,1,3
C1(C(CO)(O)OCC(C1CO)O)=O,,,4,1,3,0,3
8004_1,,,,2,2,1,3
8006_0,,,,2,2,1,3
C1(C(COC(CO)(C1CO)O)O)=O,,,4,1,3,0,3
8006_1,,,,2,2,1,3
8008_0,,,,2,2,1,3
C1(C(C(CO)(O)OCC1CO)O)=O,,,4,1,3,0,3
8008_1,,,,2,2,1,3
8010_0,,,,2,2,1,3
C1(COC(CO)(C(C1CO)O)O)=O,,,4,1,3,0,3
8010_1,,,,2,2,1,3
8012_0,,,,2,2,1,3
C1(C(CO)OC(C(C1)O)(CO)O)=O,,,4,1,3,0,3
8012_1,,,,2,2,1,3
8014_0,,,,2,2,1,3
C1(C(CO)C(C=O)(O)OCC1)=O,,,4,1,3,0,3
8014_1,,,,2,2,1,3
8016_0,,,,2,2,1,3
C1(CC(C=O)(O)OCC1CO)=O,,,4,1,3,0,3
8016_1,,,,2,2,1,3
8018_0,,,,2,2,1,3
C(C1(CC(C(CO1)=O)CO)O)=O,,,4,1,2,0,2
8020_0,,,,2,2,1,3
C1(C(CO)OC(C=O)(CC1)O)=O,,,4,1,3,0,3
8020_1,,,,2,2,1,3
8022_0,,,,2,2,1,3
C(C1C(C(CO)CC(O1)O)=O)=O,,,4,1,2,0,2
8024_0,,,,2,2,1,3
C1(C(CO)C(C=O)OC(C1)O)=O,,,4,1,3,0,3
8024_1,,,,2,2,1,3
8026_0,,,,2,2,1,3
C1(CC(C=O)OC(C1CO)O)=O,,,4,1,3,0,3
8026_1,,,,2,2,1,3
8028_0,,,,2,2,1,3
C1(C(C(O)OC(CO)C1CO)=O)=O,,,4,1,3,0,3
8028_1,,,,2,2,1,3
8030_0,,,,2,2,1,3
C1(C(CO)OC(C(C1CO)=O)O)=O,,,4,1,3,0,3
8030_1,,,,2,2,1,3
8032_0,,,,2,2,1,3
C(C1(C(C(CO)C(CO1)O)=O)O)=O,,,4,1,3,0,3
8032_1,,,,2,2,1,3
8034_0,,,,2,2,1,3
C1(C(CO)C(C=O)(O)OCC1O)=O,,,4,1,3,0,3
8034_1,,,,2,2,1,3
8036_0,,,,2,2,1,3
C1(C(C(C=O)(O)OCC1CO)O)=O,,,4,1,3,0,3
8036_1,,,,2,2,1,3
8038_0,,,,2,2,1,3
C(C1(C(C(C(CO1)=O)CO)O)O)=O,,,4,1,3,0,3
8038_1,,,,2,2,1,3
8040_0,,,,2,2,1,3
C1(C(CO)OC(C=O)(C(C1)O)O)=O,,,4,1,3,0,3
8040_1,,,,2,2,1,3
8042_0,,,,2,2,1,3
C1(C(C(O)OCC(C1CO)O)=O)=O,,,4,1,3,0,3
8042_1,,,,2,2,1,3
8044_0,,,,2,2,1,3
C1(C(COC(C(C1CO)=O)O)O)=O,,,4,1,3,0,3
8044_1,,,,2,2,1,3
8046_0,,,,2,2,1,3
C1(C(CO)COC(C(C1O)=O)O)=O,,,4,1,3,0,3
8046_1,,,,2,2,1,3
8048_0,,,,2,2,1,3
C1(COC(C(C(C1CO)O)=O)O)=O,,,4,1,3,0,3
8048_1,,,,2,2,1,3
8050_0,,,,2,2,1,3
C1(CC(C(C(OC1CO)O)=O)O)=O,,,4,1,3,0,3
8050_1,,,,2,2,1,3
8052_0,,,,2,2,1,3
C1(C(C(CO)C(C(CO)O)O1)=O)=O,,,4,1,2,0,2
8052_1,,,,2,2,1,3
8054_0,,,,2,2,1,3
C1(C(C(C(C(CO)O)O1)=O)CO)=O,,,4,1,2,0,2
8054_1,,,,2,2,1,3
8056_0,,,,2,2,1,3
C1(C(C(C(C(CCO)=O)O1)O)O)=O,,,4,1,1,0,1
8058_0,,,,2,2,1,3
C(C(CO)C1C(C(C(O1)=O)O)O)=O,,,4,1,2,0,2
8058_1,,,,2,2,1,3
8060_0,,,,2,2,1,3
C1(C(CC(C(CCO)=O)O1)O)=O,,,4,1,2,0,2
8062_0,,,,2,2,1,3
C(C(CO)C1CC(C(O1)=O)O)=O,,,4,1,3,0,3
8062_1,,,,2,2,1,3
8064_0,,,,2,2,1,3
C1(C(C(CO)C(C(CO)O1)O)=O)=O,,,4,1,2,0,2
8064_1,,,,2,2,1,3
8066_0,,,,2,2,1,3
C1(C(C(C(C(CO)O1)O)=O)CO)=O,,,4,1,2,0,2
8066_1,,,,2,2,1,3
8068_0,,,,2,2,1,3
C1(C(C(C(CO)C(CO)O1)=O)O)=O,,,4,1,2,0,2
8068_1,,,,2,2,1,3
8070_0,,,,2,2,1,3
C1(C(CO)OC(C(C1CO)O)=O)=O,,,4,1,2,0,2
8070_1,,,,2,2,1,3
8072_0,,,,2,2,1,3
C1(C(C(CO)C(C(CO1)O)O)=O)=O,,,4,1,2,0,2
8072_1,,,,2,2,1,3
8074_0,,,,2,2,1,3
C1(C(C(C(C(CO1)O)O)=O)CO)=O,,,4,1,2,0,2
8074_1,,,,2,2,1,3
8076_0,,,,2,2,1,3
C1(C(C(C(CO)C(CO1)O)=O)O)=O,,,4,1,2,0,2
8076_1,,,,2,2,1,3
8078_0,,,,2,2,1,3
C1(C(CO)C(C(OCC1O)=O)O)=O,,,4,1,2,0,2
8078_1,,,,2,2,1,3
8080_0,,,,2,2,1,3
C1(C(C(C(OCC1CO)=O)O)O)=O,,,4,1,2,0,2
8080_1,,,,2,2,1,3
8082_0,,,,2,2,1,3
C1(C(C(C(C(CO1)=O)CO)O)O)=O,,,4,1,2,0,2
8082_1,,,,2,2,1,3
8084_0,,,,2,2,1,3
C1(C(C(CC(C(CO)O1)=O)O)O)=O,,,4,1,2,0,2
8084_1,,,,2,2,1,3
8086_0,,,,2,2,1,3
C1(C(CO)C(C(OCC1)=O)O)=O,,,4,1,3,0,3
8086_1,,,,2,2,1,3
8088_0,,,,2,2,1,3
C1(CC(C(OCC1CO)=O)O)=O,,,4,1,3,0,3
8088_1,,,,2,2,1,3
8090_0,,,,2,2,1,3
C1(C(CC(C(CO1)=O)CO)O)=O,,,4,1,2,0,2
8092_0,,,,2,2,1,3
C1(C(CCC(C(CO)O1)=O)O)=O,,,4,1,3,0,3
8092_1,,,,2,2,1,3
8094_0,,,,2,2,1,3
C(C(CC(C(CO)=O)CO)O)=O,,,4,1,2,0,2
8096_0,,,,2,2,1,3
C(C(CO)O)(CCC(C=O)O)=O,,,4,1,3,0,3
8096_1,,,,2,2,1,3
8098_0,,,,2,2,1,3
C(C(CC(C=O)O)O)(CCO)=O,,,4,1,3,0,3
8100_0,,,,2,2,1,3
C1C(C(OC(C(C=1)=O)CO)O)O,,,4,1,3,0,3
8100_1,,,,2,2,1,3
8102_0,,,,2,2,1,3
C(C(C(C(C=C)=O)CO)O)(O)=O,,,4,1,3,0,3
8102_1,,,,2,2,1,3
8104_0,,,,2,2,1,3
C(C(C=CC(C(CO)O)=O)=O)=O,,,4,1,5,0,5
8104_1,,,,2,2,1,3
8106_0,,,,2,2,1,3
C1(C(CO)OC(C(CO)O)(C1)O)=O,,,4,1,3,0,3
8106_1,,,,2,2,1,3
8108_0,,,,2,2,1,3
C1(COC(C(CO)O)(C1CO)O)=O,,,4,1,3,0,3
8108_1,,,,2,2,1,3
8110_0,,,,2,2,1,3
C(C1CC(C(O1)O)O)(C(CO)O)=O,,,4,1,3,0,3
8110_1,,,,2,2,1,3
8112_0,,,,2,2,1,3
C1(C(CO)OC(CCO)(C1O)O)=O,,,4,1,3,0,3
8112_1,,,,2,2,1,3
8114_0,,,,2,2,1,3
C1(C(CO)OC(CC1O)(CO)O)=O,,,4,1,3,0,3
8114_1,,,,2,2,1,3
8116_0,,,,2,2,1,3
C1(C(CO)OC(C(C1O)O)(C)O)=O,,,4,1,3,0,3
8116_1,,,,2,2,1,3
8118_0,,,,2,2,1,3
C1(C(CO)OC(CC(C1O)O)O)=O,,,4,1,3,0,3
8118_1,,,,2,2,1,3
8119_0,,,,2,2,1,3
8119_1,,,,2,2,1,3
8120_0,,,,2,2,1,3
8120_1,,,,2,2,1,3
8121_0,,,,2,2,1,3
8121_1,,,,2,2,1,3
8123_0,,,,2,2,1,3
C(C(C(CO)C(CC(C)O)O)=O)=O,,,4,1,2,0,2
8123_1,,,,2,2,1,3
8125_0,,,,2,2,1,3
C(C(C(C)O)C(C(CCO)=O)O)=O,,,4,1,5,0,5
8125_1,,,,2,2,1,3
8127_0,,,,2,2,1,3
C(C(C(C)O)C(C=O)(CCO)O)=O,,,4,1,4,0,4
8127_1,,,,2,2,1,3
8128_0,,,,2,2,1,3
8128_1,,,,2,2,1,3
8130_0,,,,2,2,1,3
C(C(C=O)C(C(CCO)=O)O)=O,,,4,1,3,0,3
8130_1,,,,2,2,1,3
8132_0,,,,2,2,1,3
C(C(C=O)C(C=O)(CCO)O)=O,,,4,1,3,0,3
8132_1,,,,2,2,1,3
8134_0,,,,2,2,1,3
C(C(C)(C(C(C=O)=O)CO)O)(O)=O,,,4,1,3,0,3
8134_1,,,,2,2,1,3
8135_0,,,,2,2,1,3
8137_0,,,,2,2,1,3
C(C(CCO)(CC(C(O)=O)=O)O)=O,,,4,1,2,0,2
8139_0,,,,2,2,1,3
C(C(C(C=O)=O)CO)(O)=O,,,4,1,2,0,2
8139_1,,,,2,2,1,3
8141_0,,,,2,2,1,3
C(C(C(C(C=O)=O)CO)O)(O)=O,,,4,1,4,0,4
8141_1,,,,2,2,1,3
8143_0,,,,2,2,1,3
C(C)(C(C)(C(C(C=O)=O)CO)O)=O,,,4,1,2,0,2
8143_1,,,,2,2,1,3
8145_0,,,,2,2,1,3
C(C(CC(C(C)=O)=O)O)(CCO)=O,,,4,1,1,0,1
8147_0,,,,2,2,1,3
C(C(CCO)(CC(C(C)=O)=O)O)=O,,,4,1,1,0,1
8149_0,,,,2,2,1,3
C(CC(C)(C(C(C=O)=O)CO)O)=O,,,4,1,2,0,2
8149_1,,,,2,2,1,3
8151_0,,,,2,2,1,3
C(C)(CC(C(C(C=O)=O)CO)O)=O,,,4,1,2,0,2
8151_1,,,,2,2,1,3
8153_0,,,,2,2,1,3
C(CC(C(CCO)=O)O)(CC=O)=O,,,4,1,1,0,1
8155_0,,,,2,2,1,3
C(C(CCO)(CC(CC=O)=O)O)=O,,,4,1,1,0,1
8157_0,,,,2,2,1,3
C(C)(C(C=O)C(C(CCO)=O)O)=O,,,4,1,2,0,2
8157_1,,,,2,2,1,3
8159_0,,,,2,2,1,3
C(C(CCO)(C(C=O)C(C)=O)O)=O,,,4,1,2,0,2
8159_1,,,,2,2,1,3
8161_0,,,,2,2,1,3
C(C(C(CO)C(C)(CCO)O)=O)=O,,,4,1,2,0,2
8161_1,,,,2,2,1,3
8163_0,,,,2,2,1,3
C(CC(C(CCO)=O)O)(CCO)=O,,,4,1,1,0,1
8165_0,,,,2,2,1,3
C(C(CCO)(CC(CCO)=O)O)=O,,,4,1,2,0,2
8167_0,,,,2,2,1,3
C(C)(C(CO)C(C(CCO)=O)O)=O,,,4,1,2,0,2
8167_1,,,,2,2,1,3
8169_0,,,,2,2,1,3
C(C(CCO)(C(C(C)=O)CO)O)=O,,,4,1,2,0,2
8169_1,,,,2,2,1,3
8171_0,,,,2,2,1,3
C(C=O)(C(CO)C(C(C=O)=O)O)=O,,,4,1,3,0,3
8171_1,,,,2,2,1,3
8173_0,,,,2,2,1,3
C(C(C=O)(C(C(C=O)=O)CO)O)=O,,,4,1,2,0,2
8173_1,,,,2,2,1,3
8175_0,,,,2,2,1,3
C=CC(C(C(C(C=O)=O)CO)O)=O,,,4,1,2,0,2
8175_1,,,,2,2,1,3
8177_0,,,,2,2,1,3
C(C(C=C)(C(C(C=O)=O)CO)O)=O,,,4,1,2,0,2
8177_1,,,,2,2,1,3
8179_0,,,,2,2,1,3
C=CC(CO)(C(C(C=O)=O)CO)O,,,4,1,2,0,2
8179_1,,,,2,2,1,3
8181_0,,,,2,2,1,3
C(C(C(C(C=C)=O)O)O)(CCO)=O,,,4,1,4,0,4
8181_1,,,,2,2,1,3
8183_0,,,,2,2,1,3
C(C(CCO)(C(C(C=C)=O)O)O)=O,,,4,1,3,0,3
8183_1,,,,2,2,1,3
8185_0,,,,2,2,1,3
C(C(C(C(C=O)=O)CO)O)=CC=O,,,4,1,2,0,2
8185_1,,,,2,2,1,3
8187_0,,,,2,2,1,3
C(C(C(CO)C(C(C)O)O)=O)=O,,,4,1,2,0,2
8187_1,,,,2,2,1,3
8189_0,,,,2,2,1,3
C(C(C(CCO)O)O)(CCO)=O,,,4,1,2,0,2
8189_1,,,,2,2,1,3
8191_0,,,,2,2,1,3
C(CO)(C(CO)C(CCO)O)=O,,,4,1,2,0,2
8191_1,,,,2,2,1,3
8192_0,,,,2,2,1,3
8192_1,,,,2,2,1,3
8194_0,,,,2,2,1,3
C(C(C(CC(C)O)O)O)(CCO)=O,,,4,1,2,0,2
8194_1,,,,2,2,1,3
8196_0,,,,2,2,1,3
C(CO)(C(CO)C(CC(C)O)O)=O,,,4,1,2,0,2
8196_1,,,,2,2,1,3
8198_0,,,,2,2,1,3
C(C(C(C)O)C(CO)(CCO)O)=O,,,4,1,4,0,4
8198_1,,,,2,2,1,3
8199_0,,,,2,2,1,3
8199_1,,,,2,2,1,3
8200_0,,,,2,2,1,3
8200_1,,,,2,2,1,3
8202_0,,,,2,2,1,3
C(C(C=O)C(CO)(CCO)O)=O,,,4,1,3,0,3
8202_1,,,,2,2,1,3
8204_0,,,,2,2,1,3
C(C(C)(C(C(CCO)=O)O)O)(O)=O,,,4,1,4,0,4
8204_1,,,,2,2,1,3
8206_0,,,,2,2,1,3
C(C(C)(C(C(CO)=O)CO)O)(O)=O,,,4,1,3,0,3
8206_1,,,,2,2,1,3
8208_0,,,,2,2,1,3
C(C(CC(CO)(CCO)O)=O)(O)=O,,,4,1,2,0,2
8209_0,,,,2,2,1,3
8209_1,,,,2,2,1,3
8210_0,,,,2,2,1,3
8210_1,,,,2,2,1,3
8211_0,,,,2,2,1,3
8211_1,,,,2,2,1,3
8212_0,,,,2,2,1,3
8212_1,,,,2,2,1,3
8214_0,,,,2,2,1,3
C(C)(C(C)(C(C(CCO)=O)O)O)=O,,,4,1,2,0,2
8214_1,,,,2,2,1,3
8216_0,,,,2,2,1,3
C(C)(C(C)(C(C(CO)=O)CO)O)=O,,,4,1,2,0,2
8216_1,,,,2,2,1,3
8218_0,,,,2,2,1,3
C(C(C)=O)(CC(CO)(CCO)O)=O,,,4,1,1,0,1
8220_0,,,,2,2,1,3
C(CC(C)(C(C(CCO)=O)O)O)=O,,,4,1,4,0,4
8220_1,,,,2,2,1,3
8222_0,,,,2,2,1,3
C(CC(C)(C(C(CO)=O)CO)O)=O,,,4,1,2,0,2
8222_1,,,,2,2,1,3
8224_0,,,,2,2,1,3
C(C(C(CC(C)=O)O)O)(CCO)=O,,,4,1,2,0,2
8224_1,,,,2,2,1,3
8226_0,,,,2,2,1,3
C(C)(CC(C(C(CO)=O)CO)O)=O,,,4,1,2,0,2
8226_1,,,,2,2,1,3
8228_0,,,,2,2,1,3
C(CC(CC(CO)(CCO)O)=O)=O,,,4,1,2,0,2
8230_0,,,,2,2,1,3
C(C(C(C)=O)C(CO)(CCO)O)=O,,,4,1,2,0,2
8230_1,,,,2,2,1,3
8232_0,,,,2,2,1,3
C(C(C(C)(CCO)O)O)(CCO)=O,,,4,1,2,0,2
8232_1,,,,2,2,1,3
8234_0,,,,2,2,1,3
C(CO)(C(CO)C(C)(CCO)O)=O,,,4,1,2,0,2
8234_1,,,,2,2,1,3
8236_0,,,,2,2,1,3
C(CC(CO)(CCO)O)(CCO)=O,,,4,1,1,0,1
8238_0,,,,2,2,1,3
C(C)(C(CO)C(CO)(CCO)O)=O,,,4,1,2,0,2
8238_1,,,,2,2,1,3
8239_0,,,,2,2,1,3
8239_1,,,,2,2,1,3
8240_0,,,,2,2,1,3
8240_1,,,,2,2,1,3
8241_0,,,,2,2,1,3
8241_1,,,,2,2,1,3
8243_0,,,,2,2,1,3
C(C(C=O)(C(C(CO)=O)CO)O)=O,,,4,1,2,0,2
8243_1,,,,2,2,1,3
8244_0,,,,2,2,1,3
8244_1,,,,2,2,1,3
8246_0,,,,2,2,1,3
C(CO)(C(CO)C(C(C=C)=O)O)=O,,,4,1,2,0,2
8246_1,,,,2,2,1,3
8248_0,,,,2,2,1,3
C(C(C=C)(C(C(CCO)=O)O)O)=O,,,4,1,2,0,2
8248_1,,,,2,2,1,3
8250_0,,,,2,2,1,3
C(C(C=C)(C(C(CO)=O)CO)O)=O,,,4,1,2,0,2
8250_1,,,,2,2,1,3
8252_0,,,,2,2,1,3
C(C(C(C=C)(CO)O)O)(CCO)=O,,,4,1,2,0,2
8252_1,,,,2,2,1,3
8254_0,,,,2,2,1,3
C(CO)(C(CO)C(C=C)(CO)O)=O,,,4,1,2,0,2
8254_1,,,,2,2,1,3
8256_0,,,,2,2,1,3
C=CC(C(C(CO)(CCO)O)O)=O,,,4,1,2,0,2
8256_1,,,,2,2,1,3
8258_0,,,,2,2,1,3
C(C(C(C=CC=O)O)O)(CCO)=O,,,4,1,2,0,2
8258_1,,,,2,2,1,3
8260_0,,,,2,2,1,3
C(CO)(C(CO)C(C=CC=O)O)=O,,,4,1,2,0,2
8260_1,,,,2,2,1,3
8262_0,,,,2,2,1,3
C(C(C(C(C)O)O)O)(CCO)=O,,,4,1,2,0,2
8262_1,,,,2,2,1,3
8264_0,,,,2,2,1,3
C(CO)(C(CO)C(C(C)O)O)=O,,,4,1,2,0,2
8264_1,,,,2,2,1,3
8265_0,,,,2,2,1,3
8266_0,,,,2,2,1,3
8266_1,,,,2,2,1,3
8268_0,,,,2,2,1,3
C(C(C(C(C=O)O)O)C(C)O)=O,,,4,1,4,0,4
8268_1,,,,2,2,1,3
8269_0,,,,2,2,1,3
8269_1,,,,2,2,1,3
8271_0,,,,2,2,1,3
C(C(C(C(C(C(C)=O)=O)O)O)O)=O,,,4,1,2,0,2
8271_1,,,,2,2,1,3
8273_0,,,,2,2,1,3
C(C(C(CC(C(CO)=O)=O)O)O)=O,,,4,1,2,0,2
8274_0,,,,2,2,1,3
8274_1,,,,2,2,1,3
8276_0,,,,2,2,1,3
C(C(C=O)C(C(C=O)O)O)=O,,,4,1,3,0,3
8276_1,,,,2,2,1,3
8278_0,,,,2,2,1,3
C(C(C(CC(C(O)=O)=O)O)O)=O,,,4,1,4,0,4
8280_0,,,,2,2,1,3
C(C(C(C(C(C(O)=O)=O)O)O)O)=O,,,4,1,4,0,4
8280_1,,,,2,2,1,3
8282_0,,,,2,2,1,3
C(C(C(C=O)=O)C(C(C=O)O)O)=O,,,4,1,3,0,3
8282_1,,,,2,2,1,3
8283_0,,,,2,2,1,3
8285_0,,,,2,2,1,3
C(CC(C(C=O)O)O)(CC=O)=O,,,4,1,2,0,2
8287_0,,,,2,2,1,3
C(C(C(C(C=O)C(C)=O)O)O)=O,,,4,1,3,0,3
8287_1,,,,2,2,1,3
8289_0,,,,2,2,1,3
C(C(C(C1C(COC1O)=O)O)O)=O,,,4,1,3,0,3
8289_1,,,,2,2,1,3
8291_0,,,,2,2,1,3
C(C(C(C1C(CC(O1)O)=O)O)O)=O,,,4,1,3,0,3
8291_1,,,,2,2,1,3
8293_0,,,,2,2,1,3
C(CCO)(CC(C(C=O)O)O)=O,,,4,1,1,0,1
8295_0,,,,2,2,1,3
C(C(C(C(C(C)=O)CO)O)O)=O,,,4,1,2,0,2
8295_1,,,,2,2,1,3
8297_0,,,,2,2,1,3
C(C(C(CC(C(C=O)=O)=O)O)O)=O,,,4,1,1,0,1
8299_0,,,,2,2,1,3
C(C(C(C(C(C=C)=O)O)O)O)=O,,,4,1,3,0,3
8299_1,,,,2,2,1,3
8301_0,,,,2,2,1,3
C(C(C(C1C(C(CO1)O)=O)O)O)=O,,,4,1,2,0,2
8301_1,,,,2,2,1,3
8303_0,,,,2,2,1,3
C(C(C(C1C(C(O)OC1)=O)O)O)=O,,,4,1,3,0,3
8303_1,,,,2,2,1,3
8305_0,,,,2,2,1,3
C(CC(C(CC(C)O)=O)O)(CO)=O,,,4,1,3,0,3
8306_0,,,,2,2,1,3
8306_1,,,,2,2,1,3
8308_0,,,,2,2,1,3
C(C(CC(C)O)(CC(CO)=O)O)=O,,,4,1,1,0,1
8310_0,,,,2,2,1,3
C(C(CC(C)O)(C(C(C)=O)O)O)=O,,,4,1,2,0,2
8310_1,,,,2,2,1,3
8312_0,,,,2,2,1,3
C(C(C(C(C)O)C(C)(CO)O)=O)=O,,,4,1,4,0,4
8312_1,,,,2,2,1,3
8314_0,,,,2,2,1,3
C(CC(C(C)(CC(CO)=O)O)O)=O,,,4,1,2,0,2
8316_0,,,,2,2,1,3
C(CC(C(C)(C(C(C)=O)O)O)O)=O,,,4,1,3,0,3
8316_1,,,,2,2,1,3
8318_0,,,,2,2,1,3
C(C)(C(CC(CC(CO)=O)O)O)=O,,,4,1,1,0,1
8320_0,,,,2,2,1,3
C(C)(C(C(CC(C(C)=O)O)O)O)=O,,,4,1,2,0,2
8320_1,,,,2,2,1,3
8322_0,,,,2,2,1,3
C(CC(C(CC(CO)(C)O)=O)O)=O,,,4,1,2,0,2
8323_0,,,,2,2,1,3
8323_1,,,,2,2,1,3
8325_0,,,,2,2,1,3
C(CC(C)(C(CC(CO)=O)O)O)=O,,,4,1,3,0,3
8327_0,,,,2,2,1,3
C(CC(C)(C(C(C(C)=O)O)O)O)=O,,,4,1,3,0,3
8327_1,,,,2,2,1,3
8329_0,,,,2,2,1,3
C(C(C)(CC(CC(CO)=O)O)O)=O,,,4,1,1,0,1
8331_0,,,,2,2,1,3
C(C(C)(CC(C(C(C)=O)O)O)O)=O,,,4,1,2,0,2
8331_1,,,,2,2,1,3
8332_0,,,,2,2,1,3
8332_1,,,,2,2,1,3
8334_0,,,,2,2,1,3
C(CO)(CC(CCO)O)=O,,,4,1,4,0,4
8336_0,,,,2,2,1,3
C(C)(C(C(CCO)O)O)=O,,,4,1,4,0,4
8336_1,,,,2,2,1,3
8337_0,,,,2,2,1,3
8337_1,,,,2,2,1,3
8339_0,,,,2,2,1,3
C(CO)(CC(CO)(CC(C)O)O)=O,,,4,1,1,0,1
8341_0,,,,2,2,1,3
C(C)(C(C(CO)(CC(C)O)O)O)=O,,,4,1,2,0,2
8341_1,,,,2,2,1,3
8343_0,,,,2,2,1,3
C(CO)(C(C(C)O)C(CO)(C)O)=O,,,4,1,4,0,4
8343_1,,,,2,2,1,3
8345_0,,,,2,2,1,3
C(C(C(CO)(C)O)O)(CC(C)O)=O,,,4,1,3,0,3
8345_1,,,,2,2,1,3
8347_0,,,,2,2,1,3
C(CO)(CC(C)(C(C(C)O)O)O)=O,,,4,1,1,0,1
8349_0,,,,2,2,1,3
C(C)(C(C(C)(C(C(C)O)O)O)O)=O,,,4,1,2,0,2
8349_1,,,,2,2,1,3
8351_0,,,,2,2,1,3
C(C(C(C)O)O)(CC(CO)(C)O)=O,,,4,1,3,0,3
8353_0,,,,2,2,1,3
C(CO)(CC(CC(CO)(C)O)O)=O,,,4,1,1,0,1
8355_0,,,,2,2,1,3
C(C)(C(C(CC(CO)(C)O)O)O)=O,,,4,1,2,0,2
8355_1,,,,2,2,1,3
8357_0,,,,2,2,1,3
C(C(C(C)(CO)O)C(C)(CO)O)=O,,,4,1,2,0,2
8357_1,,,,2,2,1,3
8359_0,,,,2,2,1,3
C(CO)(CC(CC(C)O)O)=O,,,4,1,1,0,1
8361_0,,,,2,2,1,3
C(C)(C(C(CC(C)O)O)O)=O,,,4,1,2,0,2
8361_1,,,,2,2,1,3
8363_0,,,,2,2,1,3
C(C(C(C)O)C(C)(CO)O)=O,,,4,1,4,0,4
8363_1,,,,2,2,1,3
8365_0,,,,2,2,1,3
C(CO)(CC(C(C(C)O)O)O)=O,,,4,1,1,0,1
8367_0,,,,2,2,1,3
C(C)(C(C(C(C(C)O)O)O)O)=O,,,4,1,2,0,2
8367_1,,,,2,2,1,3
8369_0,,,,2,2,1,3
C(CO)(CC(CC(CO)O)O)=O,,,4,1,2,0,2
8371_0,,,,2,2,1,3
C(C)(C(C(CC(CO)O)O)O)=O,,,4,1,3,0,3
8371_1,,,,2,2,1,3
8372_0,,,,2,2,1,3
8372_1,,,,2,2,1,3
8374_0,,,,2,2,1,3
C(C)(C(CO)(CC(CO)=O)O)=O,,,4,1,5,0,5
8375_0,,,,2,2,1,3
8375_1,,,,2,2,1,3
8377_0,,,,2,2,1,3
C(CO)(C(C)(CC(CO)=O)O)=O,,,4,1,2,0,2
8379_0,,,,2,2,1,3
C(CO)(C(C)(C(C(C)=O)O)O)=O,,,4,1,4,0,4
8379_1,,,,2,2,1,3
8381_0,,,,2,2,1,3
C(C(C)=O)(C(C(CO)(C)O)O)=O,,,4,1,3,0,3
8381_1,,,,2,2,1,3
8383_0,,,,2,2,1,3
C(C(CO)=O)(CC(CO)(C)O)=O,,,4,1,2,0,2
8385_0,,,,2,2,1,3
C(CC(C(C(C)O)=O)O)(CO)=O,,,4,1,2,0,2
8386_0,,,,2,2,1,3
8386_1,,,,2,2,1,3
8387_0,,,,2,2,1,3
8388_0,,,,2,2,1,3
8388_1,,,,2,2,1,3
8390_0,,,,2,2,1,3
C(CO)(CC(CO)(C(C)O)O)=O,,,4,1,2,0,2
8392_0,,,,2,2,1,3
C(C)(C(C(CO)(C(C)O)O)O)=O,,,4,1,3,0,3
8392_1,,,,2,2,1,3
8394_0,,,,2,2,1,3
C(C(C(CO)(C)O)O)(C(C)O)=O,,,4,1,2,0,2
8394_1,,,,2,2,1,3
8395_0,,,,2,2,1,3
8396_0,,,,2,2,1,3
8396_1,,,,2,2,1,3
8398_0,,,,2,2,1,3
C(C(C=O)C(C)(CO)O)=O,,,4,1,3,0,3
8398_1,,,,2,2,1,3
8399_0,,,,2,2,1,3
8400_0,,,,2,2,1,3
8400_1,,,,2,2,1,3
8401_0,,,,2,2,1,3
8402_0,,,,2,2,1,3
8402_1,,,,2,2,1,3
8404_0,,,,2,2,1,3
C(C(C(C(C(CO)(C)O)O)=O)O)=O,,,4,1,3,0,3
8404_1,,,,2,2,1,3
8406_0,,,,2,2,1,3
C(CO)(CC(C(CCO)O)O)=O,,,4,1,2,0,2
8408_0,,,,2,2,1,3
C(C)(C(C(C(CCO)O)O)O)=O,,,4,1,3,0,3
8408_1,,,,2,2,1,3
8410_0,,,,2,2,1,3
C(C(C)(CC(CO)=O)O)(O)=O,,,4,1,4,0,4
8412_0,,,,2,2,1,3
C(C(C)(C(C(C)=O)O)O)(O)=O,,,4,1,4,0,4
8412_1,,,,2,2,1,3
8414_0,,,,2,2,1,3
C(C(CC(C)(CO)O)=O)(O)=O,,,4,1,2,0,2
8415_0,,,,2,2,1,3
8416_0,,,,2,2,1,3
8416_1,,,,2,2,1,3
8418_0,,,,2,2,1,3
C(CC(CO)(CC(CO)=O)O)(O)=O,,,4,1,2,0,2
8420_0,,,,2,2,1,3
C(CC(CO)(C(C(C)=O)O)O)(O)=O,,,4,1,3,0,3
8420_1,,,,2,2,1,3
8421_0,,,,2,2,1,3
8421_1,,,,2,2,1,3
8422_0,,,,2,2,1,3
8422_1,,,,2,2,1,3
8424_0,,,,2,2,1,3
C(C(C(C)(CC(CO)=O)O)O)(O)=O,,,4,1,3,0,3
8426_0,,,,2,2,1,3
C(C(C(C)(C(C(C)=O)O)O)O)(O)=O,,,4,1,4,0,4
8426_1,,,,2,2,1,3
8427_0,,,,2,2,1,3
8428_0,,,,2,2,1,3
8429_0,,,,2,2,1,3
8429_1,,,,2,2,1,3
8430_0,,,,2,2,1,3
8431_0,,,,2,2,1,3
8431_1,,,,2,2,1,3
8433_0,,,,2,2,1,3
C(CC(C(CC(CO)=O)O)O)(O)=O,,,4,1,2,0,2
8435_0,,,,2,2,1,3
C(CC(C(C(C(C)=O)O)O)O)(O)=O,,,4,1,3,0,3
8435_1,,,,2,2,1,3
8437_0,,,,2,2,1,3
C(C(CO)(CC(CO)=O)O)(O)=O,,,4,1,3,0,3
8439_0,,,,2,2,1,3
C(C(CO)(C(C(C)=O)O)O)(O)=O,,,4,1,7,0,7
8439_1,,,,2,2,1,3
8441_0,,,,2,2,1,3
C(C(C(C(CO)(C)O)O)=O)(O)=O,,,4,1,3,0,3
8441_1,,,,2,2,1,3
8443_0,,,,2,2,1,3
C(C)(CC(C(CC(CO)=O)O)=O)=O,,,4,1,1,0,1
8445_0,,,,2,2,1,3
C(C)(CC(C(C(C(C)=O)O)O)=O)=O,,,4,1,2,0,2
8445_1,,,,2,2,1,3
8447_0,,,,2,2,1,3
C(C(CC(C)=O)(CC(CO)=O)O)=O,,,4,1,1,0,1
8449_0,,,,2,2,1,3
C(C(CC(C)=O)(C(C(C)=O)O)O)=O,,,4,1,2,0,2
8449_1,,,,2,2,1,3
8451_0,,,,2,2,1,3
C(CO)(CC(C)(CC(C=O)=O)O)=O,,,4,1,1,0,1
8453_0,,,,2,2,1,3
C(C)(C(C(C)(CC(C=O)=O)O)O)=O,,,4,1,2,0,2
8453_1,,,,2,2,1,3
8455_0,,,,2,2,1,3
C(C)(C(C(C=O)=O)C(C)(CO)O)=O,,,4,1,2,0,2
8455_1,,,,2,2,1,3
8457_0,,,,2,2,1,3
C(CC(C)(CO)O)(CC(C=O)=O)=O,,,4,1,1,0,1
8459_0,,,,2,2,1,3
C(CC(C(CC(CO)=O)O)=O)=O,,,4,1,4,0,4
8460_0,,,,2,2,1,3
8460_1,,,,2,2,1,3
8462_0,,,,2,2,1,3
C(CC(C=O)(CC(CO)=O)O)=O,,,4,1,4,0,4
8463_0,,,,2,2,1,3
8463_1,,,,2,2,1,3
8464_0,,,,2,2,1,3
8465_0,,,,2,2,1,3
8465_1,,,,2,2,1,3
8467_0,,,,2,2,1,3
C(C(C(C=O)=O)C(C)(CO)O)=O,,,4,1,5,0,5
8467_1,,,,2,2,1,3
8468_0,,,,2,2,1,3
8469_0,,,,2,2,1,3
8469_1,,,,2,2,1,3
8471_0,,,,2,2,1,3
C(CC(C(C)=O)(CC(CO)=O)O)=O,,,4,1,3,0,3
8473_0,,,,2,2,1,3
C(CC(C(C)=O)(C(C(C)=O)O)O)=O,,,4,1,3,0,3
8473_1,,,,2,2,1,3
8475_0,,,,2,2,1,3
C(C(C)(CC(CO)=O)O)(CC=O)=O,,,4,1,1,0,1
8477_0,,,,2,2,1,3
C(C(C)(C(C(C)=O)O)O)(CC=O)=O,,,4,1,2,0,2
8477_1,,,,2,2,1,3
8479_0,,,,2,2,1,3
C(C(C(C(C)=O)=O)C(C)(CO)O)=O,,,4,1,2,0,2
8479_1,,,,2,2,1,3
8481_0,,,,2,2,1,3
C(CC(C(CC(C)(CO)O)=O)=O)=O,,,4,1,1,0,1
8483_0,,,,2,2,1,3
C(C)(C(C)(CC(CO)=O)O)=O,,,4,1,2,0,2
8485_0,,,,2,2,1,3
C(C)(C(C)(C(C(C)=O)O)O)=O,,,4,1,3,0,3
8485_1,,,,2,2,1,3
8487_0,,,,2,2,1,3
C(C(C)=O)(CC(C)(CO)O)=O,,,4,1,2,0,2
8489_0,,,,2,2,1,3
C(CC(C)(CC(CO)=O)O)=O,,,4,1,2,0,2
8491_0,,,,2,2,1,3
C(CC(C)(C(C(C)=O)O)O)=O,,,4,1,3,0,3
8491_1,,,,2,2,1,3
8493_0,,,,2,2,1,3
C(C)(CC(CC(CO)=O)O)=O,,,4,1,1,0,1
8495_0,,,,2,2,1,3
C(C)(CC(C(C(C)=O)O)O)=O,,,4,1,2,0,2
8495_1,,,,2,2,1,3
8497_0,,,,2,2,1,3
C(CC(CC(C)(CO)O)=O)=O,,,4,1,2,0,2
8499_0,,,,2,2,1,3
C(C(C(C)=O)C(C)(CO)O)=O,,,4,1,3,0,3
8499_1,,,,2,2,1,3
8501_0,,,,2,2,1,3
C(CO)(CC1(COC(C1)O)O)=O,,,4,1,2,0,2
8503_0,,,,2,2,1,3
C(C)(C(C1(COC(C1)O)O)O)=O,,,4,1,3,0,3
8503_1,,,,2,2,1,3
8505_0,,,,2,2,1,3
C1(COC(C1C(CO)(C)O)O)=O,,,4,1,3,0,3
8505_1,,,,2,2,1,3
8507_0,,,,2,2,1,3
C1(C(C(CO)(C)O)OC(C1)O)=O,,,4,1,3,0,3
8507_1,,,,2,2,1,3
8509_0,,,,2,2,1,3
C(CO)(CC(C)(CCO)O)=O,,,4,1,1,0,1
8511_0,,,,2,2,1,3
C(C)(C(C(C)(CCO)O)O)=O,,,4,1,2,0,2
8511_1,,,,2,2,1,3
8513_0,,,,2,2,1,3
C(CC(C)(CO)O)(CCO)=O,,,4,1,1,0,1
8515_0,,,,2,2,1,3
C(C)(C(CO)C(C)(CO)O)=O,,,4,1,2,0,2
8515_1,,,,2,2,1,3
8517_0,,,,2,2,1,3
C(C(CC(CC(CO)=O)O)O)(O)=O,,,4,1,6,0,6
8519_0,,,,2,2,1,3
C(C(CC(C(C(C)=O)O)O)O)(O)=O,,,4,1,7,0,7
8519_1,,,,2,2,1,3
8520_0,,,,2,2,1,3
8520_1,,,,2,2,1,3
8522_0,,,,2,2,1,3
C(CO)(CC(C(C(C)=O)=O)O)=O,,,4,1,2,0,2
8523_0,,,,2,2,1,3
8523_1,,,,2,2,1,3
8525_0,,,,2,2,1,3
C(C(C(C)=O)(CC(CO)=O)O)=O,,,4,1,3,0,3
8526_0,,,,2,2,1,3
8526_1,,,,2,2,1,3
8528_0,,,,2,2,1,3
C(CC(C(C=O)=O)(C)O)(CO)=O,,,4,1,2,0,2
8530_0,,,,2,2,1,3
C(C(C(C(C=O)=O)(C)O)O)(C)=O,,,4,1,4,0,4
8530_1,,,,2,2,1,3
8532_0,,,,2,2,1,3
C(C(C(CC(C)(CO)O)=O)=O)=O,,,4,1,1,0,1
8533_0,,,,2,2,1,3
8534_0,,,,2,2,1,3
8534_1,,,,2,2,1,3
8536_0,,,,2,2,1,3
C(C(C=O)(CC(CO)=O)O)=O,,,4,1,4,0,4
8537_0,,,,2,2,1,3
8537_1,,,,2,2,1,3
8539_0,,,,2,2,1,3
C(C(C(C(CC(CO)=O)O)=O)O)=O,,,4,1,2,0,2
8540_0,,,,2,2,1,3
8540_1,,,,2,2,1,3
8541_0,,,,2,2,1,3
8542_0,,,,2,2,1,3
8542_1,,,,2,2,1,3
8543_0,,,,2,2,1,3
8544_0,,,,2,2,1,3
8544_1,,,,2,2,1,3
8546_0,,,,2,2,1,3
C(CO)(CC(C=CC(CO)=O)O)=O,,,4,1,1,0,1
8548_0,,,,2,2,1,3
C(C)(C(C(C=CC(CO)=O)O)O)=O,,,4,1,2,0,2
8548_1,,,,2,2,1,3
8550_0,,,,2,2,1,3
C(CC(C=CC=O)(CO)O)(CO)=O,,,4,1,1,0,1
8552_0,,,,2,2,1,3
C(C(C(C=CC=O)(CO)O)O)(C)=O,,,4,1,2,0,2
8552_1,,,,2,2,1,3
8554_0,,,,2,2,1,3
C(C=CC(C(C(CO)(C)O)O)=O)=O,,,4,1,2,0,2
8554_1,,,,2,2,1,3
8556_0,,,,2,2,1,3
C(CO)(CC(C(C=C)=O)O)=O,,,4,1,2,0,2
8557_0,,,,2,2,1,3
8557_1,,,,2,2,1,3
8559_0,,,,2,2,1,3
C(C(C=C)(CC(CO)=O)O)=O,,,4,1,3,0,3
8561_0,,,,2,2,1,3
C(C(C=C)(C(C(C)=O)O)O)=O,,,4,1,4,0,4
8561_1,,,,2,2,1,3
8563_0,,,,2,2,1,3
C(CC(C=C)(CO)O)(CO)=O,,,4,1,2,0,2
8565_0,,,,2,2,1,3
C(C(C(C=C)(CO)O)O)(C)=O,,,4,1,3,0,3
8565_1,,,,2,2,1,3
8567_0,,,,2,2,1,3
C=CC(C(C(CO)(C)O)O)=O,,,4,1,3,0,3
8567_1,,,,2,2,1,3
8569_0,,,,2,2,1,3
C(CO)(CC(C=CC=O)O)=O,,,4,1,3,0,3
8571_0,,,,2,2,1,3
C(C)(C(C(C=CC=O)O)O)=O,,,4,1,4,0,4
8571_1,,,,2,2,1,3
8573_0,,,,2,2,1,3
C(CO)(CC(C(C)O)O)=O,,,4,1,1,0,1
8575_0,,,,2,2,1,3
C(C)(C(C(C(C)O)O)O)=O,,,4,1,2,0,2
8575_1,,,,2,2,1,3
8577_0,,,,2,2,1,3
C(C(CCO)(CC(CO)=O)O)(O)=O,,,4,1,2,0,2
8578_0,,,,2,2,1,3
8578_1,,,,2,2,1,3
8580_0,,,,2,2,1,3
C(C(C(CO)C(C)(CO)O)=O)(O)=O,,,4,1,3,0,3
8580_1,,,,2,2,1,3
8582_0,,,,2,2,1,3
C(CO)(CC(C(CO)(CO)O)O)=O,,,4,1,2,0,2
8584_0,,,,2,2,1,3
C(C)(C(C(C(CO)(CO)O)O)O)=O,,,4,1,3,0,3
8584_1,,,,2,2,1,3
8585_0,,,,2,2,1,3
8586_0,,,,2,2,1,3
8586_1,,,,2,2,1,3
8588_0,,,,2,2,1,3
C(CO)(CC1(COCC1O)O)=O,,,4,1,1,0,1
8590_0,,,,2,2,1,3
C(C)(C(C1(COCC1O)O)O)=O,,,4,1,2,0,2
8590_1,,,,2,2,1,3
8592_0,,,,2,2,1,3
C1(C(C(CO)(C)O)OCC1O)=O,,,4,1,2,0,2
8592_1,,,,2,2,1,3
8594_0,,,,2,2,1,3
C(CO)(CC1(C(O)OCC1)O)=O,,,4,1,2,0,2
8596_0,,,,2,2,1,3
C(C)(C(C1(C(O)OCC1)O)O)=O,,,4,1,3,0,3
8596_1,,,,2,2,1,3
8598_0,,,,2,2,1,3
C1(C(O)OCC1C(CO)(C)O)=O,,,4,1,3,0,3
8598_1,,,,2,2,1,3
8600_0,,,,2,2,1,3
C(CO)(CC1(C(O)OCC1O)O)=O,,,4,1,2,0,2
8602_0,,,,2,2,1,3
C(C)(C(C1(C(O)OCC1O)O)O)=O,,,4,1,3,0,3
8602_1,,,,2,2,1,3
8604_0,,,,2,2,1,3
C(C(C(CCO)O)C(C=O)O)=O,,,4,1,2,0,2
8604_1,,,,2,2,1,3
8605_0,,,,2,2,1,3
8605_1,,,,2,2,1,3
8606_0,,,,2,2,1,3
8606_1,,,,2,2,1,3
8608_0,,,,2,2,1,3
C(C(C(CC(C)O)O)C(C=O)O)=O,,,4,1,2,0,2
8608_1,,,,2,2,1,3
8610_0,,,,2,2,1,3
C(C(C(C(CC=O)O)O)C(C)O)=O,,,4,1,5,0,5
8610_1,,,,2,2,1,3
8612_0,,,,2,2,1,3
C(C(C(C)O)C(CC(C=O)O)O)=O,,,4,1,5,0,5
8612_1,,,,2,2,1,3
8614_0,,,,2,2,1,3
C(CC(C(C=O)C(C=O)O)O)=O,,,4,1,3,0,3
8614_1,,,,2,2,1,3
8616_0,,,,2,2,1,3
C(C(C=O)C(C(CC=O)O)O)=O,,,4,1,3,0,3
8616_1,,,,2,2,1,3
8618_0,,,,2,2,1,3
C(C(C=O)C(CC(C=O)O)O)=O,,,4,1,3,0,3
8618_1,,,,2,2,1,3
8620_0,,,,2,2,1,3
C(C(C)(C(C=O)C(C=O)O)O)(O)=O,,,4,1,3,0,3
8620_1,,,,2,2,1,3
8622_0,,,,2,2,1,3
C(CC(C(CC(C(O)=O)=O)O)O)=O,,,4,1,2,0,2
8624_0,,,,2,2,1,3
C(C(CC(CC(C(O)=O)=O)O)O)=O,,,4,1,2,0,2
8626_0,,,,2,2,1,3
C(C(C=O)C(C=O)O)(O)=O,,,4,1,2,0,2
8626_1,,,,2,2,1,3
8627_0,,,,2,2,1,3
8627_1,,,,2,2,1,3
8629_0,,,,2,2,1,3
C(C)(C(C)(C(C=O)C(C=O)O)O)=O,,,4,1,2,0,2
8629_1,,,,2,2,1,3
8630_0,,,,2,2,1,3
8632_0,,,,2,2,1,3
C(C(CC(CC(C(C)=O)=O)O)O)=O,,,4,1,1,0,1
8634_0,,,,2,2,1,3
C(CC(C)(C(C=O)C(C=O)O)O)=O,,,4,1,2,0,2
8634_1,,,,2,2,1,3
8636_0,,,,2,2,1,3
C(C)(CC(C(C=O)C(C=O)O)O)=O,,,4,1,2,0,2
8636_1,,,,2,2,1,3
8637_0,,,,2,2,1,3
8639_0,,,,2,2,1,3
C(CC(CC(C=O)O)O)(CC=O)=O,,,4,1,1,0,1
8641_0,,,,2,2,1,3
C(CC(C(C(C=O)C(C)=O)O)O)=O,,,4,1,2,0,2
8641_1,,,,2,2,1,3
8643_0,,,,2,2,1,3
C(C(CC(C(C=O)C(C)=O)O)O)=O,,,4,1,2,0,2
8643_1,,,,2,2,1,3
8645_0,,,,2,2,1,3
C(C(C(C)(CCO)O)C(C=O)O)=O,,,4,1,2,0,2
8645_1,,,,2,2,1,3
8647_0,,,,2,2,1,3
C(CC(C(CC(CCO)=O)O)O)=O,,,4,1,3,0,3
8649_0,,,,2,2,1,3
C(CC(CC(C=O)O)O)(CCO)=O,,,4,1,1,0,1
8651_0,,,,2,2,1,3
C(CC(C(C(C(C)=O)CO)O)O)=O,,,4,1,2,0,2
8651_1,,,,2,2,1,3
8653_0,,,,2,2,1,3
C(C(CC(C(C(C)=O)CO)O)O)=O,,,4,1,2,0,2
8653_1,,,,2,2,1,3
8655_0,,,,2,2,1,3
C(C(C(C=O)C(C(C=O)=O)O)O)=O,,,4,1,3,0,3
8655_1,,,,2,2,1,3
8657_0,,,,2,2,1,3
C(C(C=O)(C(C=O)C(C=O)O)O)=O,,,4,1,2,0,2
8657_1,,,,2,2,1,3
8659_0,,,,2,2,1,3
C(C(C(C=O)C(C(C=C)=O)O)O)=O,,,4,1,2,0,2
8659_1,,,,2,2,1,3
8661_0,,,,2,2,1,3
C(C(C=C)(C(C=O)C(C=O)O)O)=O,,,4,1,2,0,2
8661_1,,,,2,2,1,3
8663_0,,,,2,2,1,3
C(C(C(C=O)C(C=C)(CO)O)O)=O,,,4,1,2,0,2
8663_1,,,,2,2,1,3
8664_0,,,,2,2,1,3
8664_1,,,,2,2,1,3
8666_0,,,,2,2,1,3
C(C(CC(C(C(C=C)=O)O)O)O)=O,,,4,1,2,0,2
8666_1,,,,2,2,1,3
8668_0,,,,2,2,1,3
C(C(C(C=O)C(C=CC=O)O)O)=O,,,4,1,2,0,2
8668_1,,,,2,2,1,3
8670_0,,,,2,2,1,3
C(C(C(C(C)O)O)C(C=O)O)=O,,,4,1,2,0,2
8670_1,,,,2,2,1,3
8671_0,,,,2,2,1,3
8671_1,,,,2,2,1,3
8673_0,,,,2,2,1,3
C(C(C=O)C(C(C(C=O)O)O)O)=O,,,4,1,2,0,2
8673_1,,,,2,2,1,3
8675_0,,,,2,2,1,3
C(CC1(CC(C(C1O)O)O)O)=O,,,4,1,1,0,1
8676_0,,,,2,2,1,3
8676_1,,,,2,2,1,3
8677_0,,,,2,2,1,3
8679_0,,,,2,2,1,3
C(CC1(C(CO)C(C(C1)=O)O)O)=O,,,4,1,1,0,1
8680_0,,,,2,2,1,3
8680_1,,,,2,2,1,3
8681_0,,,,2,2,1,3
8682_0,,,,2,2,1,3
8683_0,,,,2,2,1,3
8685_0,,,,2,2,1,3
C(C1(C(C(CC1)(CC=O)O)O)O)=O,,,4,1,1,0,1
8686_0,,,,2,2,1,3
8687_0,,,,2,2,1,3
8688_0,,,,2,2,1,3
8688_1,,,,2,2,1,3
8689_0,,,,2,2,1,3
8691_0,,,,2,2,1,3
C(C1(CC(C(C1)O)(CC=O)O)O)=O,,,4,1,1,0,1
8692_0,,,,2,2,1,3
8692_1,,,,2,2,1,3
8693_0,,,,2,2,1,3
8695_0,,,,2,2,1,3
C(CC(C1C(CC(C1O)=O)O)O)=O,,,4,1,1,0,1
8696_0,,,,2,2,1,3
8696_1,,,,2,2,1,3
8697_0,,,,2,2,1,3
8699_0,,,,2,2,1,3
C1(C(C(C(C1)O)CO)(CC=O)O)=O,,,4,1,1,0,1
8700_0,,,,2,2,1,3
8700_1,,,,2,2,1,3
8701_0,,,,2,2,1,3
8702_0,,,,2,2,1,3
8703_0,,,,2,2,1,3
8703_1,,,,2,2,1,3
8704_0,,,,2,2,1,3
8704_1,,,,2,2,1,3
8705_0,,,,2,2,1,3
8706_0,,,,2,2,1,3
8706_1,,,,2,2,1,3
8707_0,,,,2,2,1,3
8708_0,,,,2,2,1,3
8709_0,,,,2,2,1,3
8711_0,,,,2,2,1,3
C(CC(C1C(C(C(C1)=O)O)O)O)=O,,,4,1,2,0,2
8712_0,,,,2,2,1,3
8713_0,,,,2,2,1,3
8714_0,,,,2,2,1,3
8714_1,,,,2,2,1,3
8715_0,,,,2,2,1,3
8716_0,,,,2,2,1,3
8717_0,,,,2,2,1,3
8717_1,,,,2,2,1,3
8719_0,,,,2,2,1,3
C(CC1(C=CC(C(C1O)O)O)O)=O,,,4,1,1,0,1
8720_0,,,,2,2,1,3
8721_0,,,,2,2,1,3
8722_0,,,,2,2,1,3
8722_1,,,,2,2,1,3
8724_0,,,,2,2,1,3
C(CC(CO)(C(C(C)O)O)O)=O,,,4,1,1,0,1
8726_0,,,,2,2,1,3
C(C(C(C)O)O)(C(C(C)O)O)=O,,,4,1,2,0,2
8726_1,,,,2,2,1,3
8728_0,,,,2,2,1,3
C(CC(CC(CO)(CO)O)O)=O,,,4,1,1,0,1
8729_0,,,,2,2,1,3
8729_1,,,,2,2,1,3
8731_0,,,,2,2,1,3
C(CC(CC(C(CO)O)O)O)=O,,,4,1,1,0,1
8732_0,,,,2,2,1,3
8732_1,,,,2,2,1,3
8733_0,,,,2,2,1,3
8735_0,,,,2,2,1,3
C(C(C)(CC(C=O)(CC=O)O)O)=O,,,4,1,1,0,1
8736_0,,,,2,2,1,3
8737_0,,,,2,2,1,3
8737_1,,,,2,2,1,3
8738_0,,,,2,2,1,3
8740_0,,,,2,2,1,3
C(C(CC(C=O)(CC=O)O)O)=O,,,4,1,1,0,1
8741_0,,,,2,2,1,3
8742_0,,,,2,2,1,3
8742_1,,,,2,2,1,3
8743_0,,,,2,2,1,3
8745_0,,,,2,2,1,3
C(C(CC(CO)(C)O)(CC=O)O)=O,,,4,1,1,0,1
8746_0,,,,2,2,1,3
8746_1,,,,2,2,1,3
8747_0,,,,2,2,1,3
8749_0,,,,2,2,1,3
C(CC(CO)(CC(C(C)=O)O)O)=O,,,4,1,2,0,2
8750_0,,,,2,2,1,3
8751_0,,,,2,2,1,3
8751_1,,,,2,2,1,3
8752_0,,,,2,2,1,3
8752_1,,,,2,2,1,3
8753_0,,,,2,2,1,3
8755_0,,,,2,2,1,3
C(C(C)(CC(CO)(CC=O)O)O)=O,,,4,1,1,0,1
8756_0,,,,2,2,1,3
8756_1,,,,2,2,1,3
8757_0,,,,2,2,1,3
8757_1,,,,2,2,1,3
8758_0,,,,2,2,1,3
8759_0,,,,2,2,1,3
8760_0,,,,2,2,1,3
8762_0,,,,2,2,1,3
C(C(C)(C(C(C)(CC=O)O)O)O)=O,,,4,1,2,0,2
8763_0,,,,2,2,1,3
8765_0,,,,2,2,1,3
C(CC(C(CC(C)O)=O)O)=O,,,4,1,2,0,2
8767_0,,,,2,2,1,3
C(C(CC(C)O)(CC=O)O)=O,,,4,1,1,0,1
8769_0,,,,2,2,1,3
C(C(C(C(C)O)C(C)O)=O)=O,,,4,1,2,0,2
8769_1,,,,2,2,1,3
8771_0,,,,2,2,1,3
C(CC(C(C)(CC=O)O)O)=O,,,4,1,2,0,2
8773_0,,,,2,2,1,3
C(CC(CC(C(C)=O)O)O)=O,,,4,1,1,0,1
8774_0,,,,2,2,1,3
8775_0,,,,2,2,1,3
8775_1,,,,2,2,1,3
8776_0,,,,2,2,1,3
8778_0,,,,2,2,1,3
C(C(C)(CC(CC=O)O)O)=O,,,4,1,1,0,1
8779_0,,,,2,2,1,3
8779_1,,,,2,2,1,3
8780_0,,,,2,2,1,3
8781_0,,,,2,2,1,3
8782_0,,,,2,2,1,3
8782_1,,,,2,2,1,3
8783_0,,,,2,2,1,3
8785_0,,,,2,2,1,3
C(CC(C(CO)O)(CC=O)O)=O,,,4,1,1,0,1
8786_0,,,,2,2,1,3
8786_1,,,,2,2,1,3
8787_0,,,,2,2,1,3
8788_0,,,,2,2,1,3
8790_0,,,,2,2,1,3
C(C(C(C(C(C)O)O)=O)C(C)O)=O,,,4,1,4,0,4
8790_1,,,,2,2,1,3
8791_0,,,,2,2,1,3
8793_0,,,,2,2,1,3
C(CC(C(C(C)O)O)(CC=O)O)=O,,,4,1,1,0,1
8794_0,,,,2,2,1,3
8794_1,,,,2,2,1,3
8796_0,,,,2,2,1,3
C(CC(CC(CO)(CC=O)O)O)=O,,,4,1,3,0,3
8798_0,,,,2,2,1,3
C(CC(CC(CC(CO)=O)O)O)=O,,,4,1,2,0,2
8799_0,,,,2,2,1,3
8799_1,,,,2,2,1,3
8800_0,,,,2,2,1,3
8800_1,,,,2,2,1,3
8801_0,,,,2,2,1,3
8801_1,,,,2,2,1,3
8802_0,,,,2,2,1,3
8803_0,,,,2,2,1,3
8803_1,,,,2,2,1,3
8804_0,,,,2,2,1,3
8806_0,,,,2,2,1,3
C(CC(CCO)(C(C=O)O)O)=O,,,4,1,1,0,1
8807_0,,,,2,2,1,3
8807_1,,,,2,2,1,3
8808_0,,,,2,2,1,3
8810_0,,,,2,2,1,3
C(CC(CC(C)O)(C(C=O)O)O)=O,,,4,1,1,0,1
8812_0,,,,2,2,1,3
C(C(C(C(C(C)O)C(C)O)=O)O)=O,,,4,1,2,0,2
8812_1,,,,2,2,1,3
8814_0,,,,2,2,1,3
C(CC(C)(C(C(CC=O)O)O)O)=O,,,4,1,2,0,2
8816_0,,,,2,2,1,3
C(CC(CC(C(C(C)=O)O)O)O)=O,,,4,1,1,0,1
8817_0,,,,2,2,1,3
8818_0,,,,2,2,1,3
8818_1,,,,2,2,1,3
8819_0,,,,2,2,1,3
8821_0,,,,2,2,1,3
C(CC(CC(C)(C(C=O)O)O)O)=O,,,4,1,1,0,1
8822_0,,,,2,2,1,3
8822_1,,,,2,2,1,3
8823_0,,,,2,2,1,3
8824_0,,,,2,2,1,3
8825_0,,,,2,2,1,3
8827_0,,,,2,2,1,3
C(CC(CCO)(C(CO)O)O)=O,,,4,1,1,0,1
8828_0,,,,2,2,1,3
8828_1,,,,2,2,1,3
8830_0,,,,2,2,1,3
C(CC(CC(C)O)(C(CO)O)O)=O,,,4,1,1,0,1
8832_0,,,,2,2,1,3
C(C(CO)O)(C(C(C)O)C(C)O)=O,,,4,1,2,0,2
8832_1,,,,2,2,1,3
8834_0,,,,2,2,1,3
C(CC(CC(C)(C(CO)O)O)O)=O,,,4,1,1,0,1
8835_0,,,,2,2,1,3
8835_1,,,,2,2,1,3
8836_0,,,,2,2,1,3
8838_0,,,,2,2,1,3
C(C(C(CO)CO)(CC=O)O)=O,,,4,1,1,0,1
8840_0,,,,2,2,1,3
C(CC(CO)(C(CO)CO)O)=O,,,4,1,1,0,1
8841_0,,,,2,2,1,3
8841_1,,,,2,2,1,3
8842_0,,,,2,2,1,3
8844_0,,,,2,2,1,3
C(CC(C(CO)C(C=O)O)O)=O,,,4,1,2,0,2
8846_0,,,,2,2,1,3
C(CC(CCO)O)=O,,,4,1,1,0,1
8847_0,,,,2,2,1,3
8847_1,,,,2,2,1,3
8849_0,,,,2,2,1,3
C(CC(C(CO)O)(C(CO)O)O)=O,,,4,1,1,0,1
8851_0,,,,2,2,1,3
C(CC(C(C(CO)C(C)O)=O)O)=O,,,4,1,4,0,4
8853_0,,,,2,2,1,3
C(C(C(CO)C(C)O)(CC=O)O)=O,,,4,1,1,0,1
8855_0,,,,2,2,1,3
C(CC(C(CCO)(CC=O)O)O)=O,,,4,1,3,0,3
8857_0,,,,2,2,1,3
C(CC(CC(C(CCO)=O)O)O)=O,,,4,1,2,0,2
8858_0,,,,2,2,1,3
8858_1,,,,2,2,1,3
8859_0,,,,2,2,1,3
8859_1,,,,2,2,1,3
8860_0,,,,2,2,1,3
8862_0,,,,2,2,1,3
C(C(CCO)(CC(CC=O)O)O)=O,,,4,1,2,0,2
8863_0,,,,2,2,1,3
8863_1,,,,2,2,1,3
8865_0,,,,2,2,1,3
C(CC(CCO)(C(C(C)O)O)O)=O,,,4,1,1,0,1
8867_0,,,,2,2,1,3
C(C(C(C)O)O)(C(CO)C(C)O)=O,,,4,1,4,0,4
8867_1,,,,2,2,1,3
8869_0,,,,2,2,1,3
C(CC(CO)(C(CO)C(C)O)O)=O,,,4,1,1,0,1
8870_0,,,,2,2,1,3
8870_1,,,,2,2,1,3
8872_0,,,,2,2,1,3
C(CC(CC(CO)(CCO)O)O)=O,,,4,1,1,0,1
8873_0,,,,2,2,1,3
8873_1,,,,2,2,1,3
8875_0,,,,2,2,1,3
C(CC(C(C(CC=O)O)O)O)=O,,,4,1,1,0,1
8877_0,,,,2,2,1,3
C(CC(CC(C(C=O)O)O)O)=O,,,4,1,1,0,1
8878_0,,,,2,2,1,3
8878_1,,,,2,2,1,3
8880_0,,,,2,2,1,3
C(CC(CO)(CC(C)(CO)O)O)=O,,,4,1,1,0,1
8881_0,,,,2,2,1,3
8881_1,,,,2,2,1,3
8882_0,,,,2,2,1,3
8882_1,,,,2,2,1,3
8884_0,,,,2,2,1,3
C(CC(C)(C(C(C)(CO)O)O)O)=O,,,4,1,1,0,1
8885_0,,,,2,2,1,3
8887_0,,,,2,2,1,3
C(CC(CO)(CC(C)O)O)=O,,,4,1,1,0,1
8889_0,,,,2,2,1,3
C(CO)(C(C(C)O)C(C)O)=O,,,4,1,2,0,2
8889_1,,,,2,2,1,3
8891_0,,,,2,2,1,3
C(C(C(C)O)O)(CC(C)O)=O,,,4,1,3,0,3
8891_1,,,,2,2,1,3
8893_0,,,,2,2,1,3
C(CC(C)(C(C(C)O)O)O)=O,,,4,1,1,0,1
8894_0,,,,2,2,1,3
8896_0,,,,2,2,1,3
C(CC(CC(C)(CO)O)O)=O,,,4,1,1,0,1
8897_0,,,,2,2,1,3
8897_1,,,,2,2,1,3
8898_0,,,,2,2,1,3
8900_0,,,,2,2,1,3
C(CC(C(C(C)O)C(C=O)O)O)=O,,,4,1,2,0,2
8902_0,,,,2,2,1,3
C(CC(C(CC(CC=O)O)O)O)=O,,,4,1,2,0,2
8903_0,,,,2,2,1,3
8903_1,,,,2,2,1,3
8904_0,,,,2,2,1,3
8906_0,,,,2,2,1,3
C(CC(CC(CC(C=O)O)O)O)=O,,,4,1,2,0,2
8907_0,,,,2,2,1,3
8907_1,,,,2,2,1,3
8909_0,,,,2,2,1,3
C(CC(CC(C)O)O)=O,,,4,1,1,0,1
8911_0,,,,2,2,1,3
C(C(C(C)O)C(C)O)=O,,,4,1,2,0,2
8911_1,,,,2,2,1,3
8913_0,,,,2,2,1,3
C(CC(CC(C(CO)=O)O)O)=O,,,4,1,1,0,1
8915_0,,,,2,2,1,3
C(CC(C(CO)(CC=O)O)O)=O,,,4,1,2,0,2
8917_0,,,,2,2,1,3
C(C(C(C)O)C(C(CO)=O)O)=O,,,4,1,4,0,4
8917_1,,,,2,2,1,3
8919_0,,,,2,2,1,3
C(CC(C(C(C(C)O)O)=O)O)=O,,,4,1,3,0,3
8919_1,,,,2,2,1,3
8921_0,,,,2,2,1,3
C(C(CO)(CC(CC=O)O)O)=O,,,4,1,3,0,3
8922_0,,,,2,2,1,3
8924_0,,,,2,2,1,3
C(C(C(C)O)C(C=O)(CO)O)=O,,,4,1,5,0,5
8924_1,,,,2,2,1,3
8925_0,,,,2,2,1,3
8927_0,,,,2,2,1,3
C(C(C(C(C)O)O)(CC=O)O)=O,,,4,1,2,0,2
8929_0,,,,2,2,1,3
C(CC(C(C(CO)(CO)O)O)O)=O,,,4,1,2,0,2
8931_0,,,,2,2,1,3
C(CC(CO)(C(C(CO)O)O)O)=O,,,4,1,4,0,4
8932_0,,,,2,2,1,3
8932_1,,,,2,2,1,3
8934_0,,,,2,2,1,3
C(CC(C(C(C(CO)O)O)O)O)=O,,,4,1,3,0,3
8936_0,,,,2,2,1,3
C(C(C)(C(C(CC=O)O)O)O)=O,,,4,1,2,0,2
8937_0,,,,2,2,1,3
8938_0,,,,2,2,1,3
8940_0,,,,2,2,1,3
C(C(CC(CO)O)(CC=O)O)=O,,,4,1,1,0,1
8941_0,,,,2,2,1,3
8941_1,,,,2,2,1,3
8942_0,,,,2,2,1,3
8944_0,,,,2,2,1,3
C(CC(C(C(C)(CO)O)O)O)=O,,,4,1,1,0,1
8946_0,,,,2,2,1,3
C(CC(CO)(CC(CO)O)O)=O,,,4,1,2,0,2
8947_0,,,,2,2,1,3
8947_1,,,,2,2,1,3
8948_0,,,,2,2,1,3
8948_1,,,,2,2,1,3
8950_0,,,,2,2,1,3
C(CC(C)(C(C(CO)O)O)O)=O,,,4,1,2,0,2
8951_0,,,,2,2,1,3
8953_0,,,,2,2,1,3
C(CC(C(C(C)O)O)O)=O,,,4,1,1,0,1
8955_0,,,,2,2,1,3
C(CC(CC(CO)O)O)=O,,,4,1,3,0,3
8956_0,,,,2,2,1,3
8956_1,,,,2,2,1,3
8957_0,,,,2,2,1,3
8958_0,,,,2,2,1,3
8959_0,,,,2,2,1,3
8960_0,,,,2,2,1,3
8962_0,,,,2,2,1,3
C(C)(C(CO)(CC=O)O)=O,,,4,1,4,0,4
8964_0,,,,2,2,1,3
C(CO)(C(C)(CC=O)O)=O,,,4,1,2,0,2
8966_0,,,,2,2,1,3
C(C(C)=O)(C(C(C)O)O)=O,,,4,1,3,0,3
8966_1,,,,2,2,1,3
8968_0,,,,2,2,1,3
C(C(CO)=O)(CC(C)O)=O,,,4,1,2,0,2
8969_0,,,,2,2,1,3
8971_0,,,,2,2,1,3
C(C(C(C)O)O)(CC(CO)=O)=O,,,4,1,3,0,3
8971_1,,,,2,2,1,3
8973_0,,,,2,2,1,3
C(CO)(C(C(CO)=O)C(C)O)=O,,,4,1,3,0,3
8973_1,,,,2,2,1,3
8974_0,,,,2,2,1,3
8975_0,,,,2,2,1,3
8977_0,,,,2,2,1,3
C(C(C(C)O)O)(C(C(C)=O)O)=O,,,4,1,2,0,2
8977_1,,,,2,2,1,3
8979_0,,,,2,2,1,3
C(CC(C)O)(C(C(CO)=O)O)=O,,,4,1,2,0,2
8981_0,,,,2,2,1,3
C(CC(C(C(C)O)=O)O)=O,,,4,1,4,0,4
8982_0,,,,2,2,1,3
8984_0,,,,2,2,1,3
C(CC(CO)(C(C)O)O)=O,,,4,1,2,0,2
8986_0,,,,2,2,1,3
C(C(C(C)O)O)(C(C)O)=O,,,4,1,2,0,2
8986_1,,,,2,2,1,3
8988_0,,,,2,2,1,3
C(CC(CC=O)O)=O,,,4,1,4,0,4
8990_0,,,,2,2,1,3
C(C(C=O)C(C)O)=O,,,4,1,4,0,4
8990_1,,,,2,2,1,3
8991_0,,,,2,2,1,3
8992_0,,,,2,2,1,3
8993_0,,,,2,2,1,3
8993_1,,,,2,2,1,3
8995_0,,,,2,2,1,3
C(CC(C(CCO)O)O)=O,,,4,1,3,0,3
8997_0,,,,2,2,1,3
C(C(C)(CC=O)O)(O)=O,,,4,1,3,0,3
8999_0,,,,2,2,1,3
C(C(CC(C)O)=O)(O)=O,,,4,1,2,0,2
9001_0,,,,2,2,1,3
C(CC(O)=O)=O,,,4,1,8,0,8
9003_0,,,,2,2,1,3
C(CC(CO)(CC=O)O)(O)=O,,,4,1,2,0,2
9004_0,,,,2,2,1,3
9004_1,,,,2,2,1,3
9005_0,,,,2,2,1,3
9005_1,,,,2,2,1,3
9007_0,,,,2,2,1,3
C(CC(C)(C(C(O)=O)O)O)=O,,,4,1,5,0,5
9008_0,,,,2,2,1,3
9009_0,,,,2,2,1,3
9011_0,,,,2,2,1,3
C(CC(CO)(CC(C(O)=O)O)O)=O,,,4,1,5,0,5
9012_0,,,,2,2,1,3
9012_1,,,,2,2,1,3
9013_0,,,,2,2,1,3
9013_1,,,,2,2,1,3
9015_0,,,,2,2,1,3
C(CC(C)(C(C(C(O)=O)O)O)O)=O,,,4,1,4,0,4
9016_0,,,,2,2,1,3
9018_0,,,,2,2,1,3
C(CC(C(C(O)=O)O)O)=O,,,4,1,5,0,5
9019_0,,,,2,2,1,3
9021_0,,,,2,2,1,3
C(CC(C(CC=O)O)O)(O)=O,,,4,1,4,0,4
9023_0,,,,2,2,1,3
C(C(CO)(CC=O)O)(O)=O,,,4,1,5,0,5
9025_0,,,,2,2,1,3
C(C(C(C(C)O)O)=O)(O)=O,,,4,1,3,0,3
9025_1,,,,2,2,1,3
9027_0,,,,2,2,1,3
C(CC(C(CC(C)=O)=O)O)=O,,,4,1,3,0,3
9029_0,,,,2,2,1,3
C(CC(C=O)(CC(C)=O)O)=O,,,4,1,2,0,2
9030_0,,,,2,2,1,3
9032_0,,,,2,2,1,3
C(C)(C(C(C=O)=O)C(C)O)=O,,,4,1,4,0,4
9032_1,,,,2,2,1,3
9034_0,,,,2,2,1,3
C(CC(C)O)(CC(C=O)=O)=O,,,4,1,4,0,4
9035_0,,,,2,2,1,3
9037_0,,,,2,2,1,3
C(CC(C=O)(CC=O)O)=O,,,4,1,4,0,4
9038_0,,,,2,2,1,3
9040_0,,,,2,2,1,3
C(C(C(C=O)=O)C(C)O)=O,,,4,1,7,0,7
9040_1,,,,2,2,1,3
9041_0,,,,2,2,1,3
9043_0,,,,2,2,1,3
C(CC(C(C)=O)(CC=O)O)=O,,,4,1,2,0,2
9045_0,,,,2,2,1,3
C(C(C)(CC=O)O)(CC=O)=O,,,4,1,2,0,2
9047_0,,,,2,2,1,3
C(C(C(C(C)=O)=O)C(C)O)=O,,,4,1,4,0,4
9047_1,,,,2,2,1,3
9049_0,,,,2,2,1,3
C(CC(C(CC(C)O)=O)=O)=O,,,4,1,4,0,4
9051_0,,,,2,2,1,3
C(C)(C(C)(CC=O)O)=O,,,4,1,3,0,3
9053_0,,,,2,2,1,3
C(C(C)=O)(CC(C)O)=O,,,4,1,5,0,5
9055_0,,,,2,2,1,3
C(CC(C)(CC=O)O)=O,,,4,1,2,0,2
9057_0,,,,2,2,1,3
C(CC(CC(C)=O)O)=O,,,4,1,2,0,2
9059_0,,,,2,2,1,3
C(CC(CC(C)O)=O)=O,,,4,1,4,0,4
9061_0,,,,2,2,1,3
C(C(C(C)=O)C(C)O)=O,,,4,1,4,0,4
9061_1,,,,2,2,1,3
9063_0,,,,2,2,1,3
C(CC1(COC(C1)O)O)=O,,,4,1,2,0,2
9065_0,,,,2,2,1,3
C1(COC(C1C(C)O)O)=O,,,4,1,3,0,3
9065_1,,,,2,2,1,3
9067_0,,,,2,2,1,3
C1(C(C(C)O)OC(C1)O)=O,,,4,1,3,0,3
9067_1,,,,2,2,1,3
9069_0,,,,2,2,1,3
C(CC1(COC(C(C1)O)O)O)=O,,,4,1,2,0,2
9071_0,,,,2,2,1,3
C1(COC(C(C1C(C)O)O)O)=O,,,4,1,3,0,3
9071_1,,,,2,2,1,3
9073_0,,,,2,2,1,3
C1(C(C(C)O)OC(C(C1)O)O)=O,,,4,1,3,0,3
9073_1,,,,2,2,1,3
9075_0,,,,2,2,1,3
C(CC(C)(CCO)O)=O,,,4,1,1,0,1
9077_0,,,,2,2,1,3
C(CC(C)O)(CCO)=O,,,4,1,1,0,1
9079_0,,,,2,2,1,3
C(C)(C(CO)C(C)O)=O,,,4,1,2,0,2
9079_1,,,,2,2,1,3
9081_0,,,,2,2,1,3
C(CC(C)(CC(C(O)=O)O)O)=O,,,4,1,2,0,2
9083_0,,,,2,2,1,3
C(C)(C(C(C)O)C(C(O)=O)O)=O,,,4,1,2,0,2
9083_1,,,,2,2,1,3
9085_0,,,,2,2,1,3
C(CC(C(O)=O)O)(CC(C)O)=O,,,4,1,2,0,2
9086_0,,,,2,2,1,3
9087_0,,,,2,2,1,3
9087_1,,,,2,2,1,3
9088_0,,,,2,2,1,3
9090_0,,,,2,2,1,3
C(C(C(C)=O)(CC=O)O)=O,,,4,1,3,0,3
9092_0,,,,2,2,1,3
C(CC(C(C=O)=O)(C)O)=O,,,4,1,2,0,2
9094_0,,,,2,2,1,3
C(C(C(CC(C)O)=O)=O)=O,,,4,1,1,0,1
9096_0,,,,2,2,1,3
C(CC(C(CC(CO)=O)=O)O)=O,,,4,1,2,0,2
9097_0,,,,2,2,1,3
9098_0,,,,2,2,1,3
9100_0,,,,2,2,1,3
C(CO)(C(C(C=O)=O)C(C)O)=O,,,4,1,3,0,3
9100_1,,,,2,2,1,3
9102_0,,,,2,2,1,3
C(C(C(C)O)O)(CC(C=O)=O)=O,,,4,1,3,0,3
9102_1,,,,2,2,1,3
9104_0,,,,2,2,1,3
C(CC(C(C(C(C)=O)O)=O)O)=O,,,4,1,2,0,2
9105_0,,,,2,2,1,3
9107_0,,,,2,2,1,3
C(CC(C)(C(C(C=O)=O)O)O)=O,,,4,1,5,0,5
9109_0,,,,2,2,1,3
C(CC(C)O)(C(C(C=O)=O)O)=O,,,4,1,2,0,2
9111_0,,,,2,2,1,3
C(CC(C(C=O)=O)O)=O,,,4,1,3,0,3
9113_0,,,,2,2,1,3
C(C(C=O)(CC=O)O)=O,,,4,1,4,0,4
9114_0,,,,2,2,1,3
9115_0,,,,2,2,1,3
9116_0,,,,2,2,1,3
9118_0,,,,2,2,1,3
C(CC(C=CC(CO)=O)O)=O,,,4,1,4,0,4
9120_0,,,,2,2,1,3
C(CC(C=CC=O)(CO)O)=O,,,4,1,2,0,2
9122_0,,,,2,2,1,3
C(C=CC(C(C(C)O)O)=O)=O,,,4,1,6,0,6
9122_1,,,,2,2,1,3
9124_0,,,,2,2,1,3
C(CC(C(C=C)=O)O)=O,,,4,1,3,0,3
9126_0,,,,2,2,1,3
C(C(C=C)(CC=O)O)=O,,,4,1,5,0,5
9128_0,,,,2,2,1,3
C(CC(C=C)(CO)O)=O,,,4,1,2,0,2
9130_0,,,,2,2,1,3
C=CC(C(C(C)O)O)=O,,,4,1,6,0,6
9130_1,,,,2,2,1,3
9132_0,,,,2,2,1,3
C(CC(C=CC=O)O)=O,,,4,1,6,0,6
9134_0,,,,2,2,1,3
C(CC(C(CC(C=O)O)O)O)=O,,,4,1,3,0,3
9135_0,,,,2,2,1,3
9137_0,,,,2,2,1,3
C(CC(C(C)O)(C(C=O)O)O)=O,,,4,1,1,0,1
9139_0,,,,2,2,1,3
C(CC(C(C)O)O)=O,,,4,1,1,0,1
9141_0,,,,2,2,1,3
C(CC(C(CCC(C=O)O)=O)O)=O,,,4,1,2,0,2
9143_0,,,,2,2,1,3
C(C(CCC(C=O)(CC=O)O)O)=O,,,4,1,2,0,2
9145_0,,,,2,2,1,3
C(CC(C(CCC(C=O)=O)O)O)=O,,,4,1,2,0,2
9147_0,,,,2,2,1,3
C(C(CC(C(C=O)=O)C(C)O)O)=O,,,4,1,2,0,2
9149_0,,,,2,2,1,3
C(CC(C(CC(C(C)O)=O)=O)O)=O,,,4,1,2,0,2
9151_0,,,,2,2,1,3
C(CC(C=O)(CC=O)O)(C(C)O)=O,,,4,1,2,0,2
9153_0,,,,2,2,1,3
C(CC(C(C)O)(CC(C=O)=O)O)=O,,,4,1,1,0,1
9155_0,,,,2,2,1,3
C(C(C)O)(C(C(C=O)=O)C(C)O)=O,,,4,1,3,0,3
9155_1,,,,2,2,1,3
9157_0,,,,2,2,1,3
C(CC(CC(C(C(C)=O)=O)O)O)=O,,,4,1,2,0,2
9159_0,,,,2,2,1,3
C(C)(C(C(CC=O)O)(CC=O)O)=O,,,4,1,2,0,2
9161_0,,,,2,2,1,3
C(CC(C(C(C)(CC=O)O)=O)O)=O,,,4,1,2,0,2
9162_0,,,,2,2,1,3
9162_1,,,,2,2,1,3
9164_0,,,,2,2,1,3
C(CC(C(C(CC(C)O)=O)=O)O)=O,,,4,1,2,0,2
9166_0,,,,2,2,1,3
C(CC(CC(C(C(C)O)=O)=O)O)=O,,,4,1,2,0,2
9168_0,,,,2,2,1,3
C(CC(C(C(C)O)=O)(CC=O)O)=O,,,4,1,2,0,2
9169_0,,,,2,2,1,3
9171_0,,,,2,2,1,3
C(C(C(C(C(C)O)=O)=O)C(C)O)=O,,,4,1,3,0,3
9171_1,,,,2,2,1,3
9173_0,,,,2,2,1,3
C(C)(CC(C(CO)(CC=O)O)=O)=O,,,4,1,1,0,1
9175_0,,,,2,2,1,3
C(CC(C(CO)=O)(CC(C)=O)O)=O,,,4,1,2,0,2
9176_0,,,,2,2,1,3
9178_0,,,,2,2,1,3
C(C)(CC(C(C(C(C)O)O)=O)=O)=O,,,4,1,2,0,2
9178_1,,,,2,2,1,3
9180_0,,,,2,2,1,3
C(C)(C(C(C(CO)=O)=O)C(C)O)=O,,,4,1,3,0,3
9180_1,,,,2,2,1,3
9182_0,,,,2,2,1,3
C(CC(C)O)(CC(C(CO)=O)=O)=O,,,4,1,2,0,2
9184_0,,,,2,2,1,3
C(CC(C(C(CC(C)=O)O)=O)O)=O,,,4,1,2,0,2
9186_0,,,,2,2,1,3
C(C)(CC(C(C=O)(CC=O)O)O)=O,,,4,1,2,0,2
9188_0,,,,2,2,1,3
C(CC(C)(CC(C(C=O)=O)O)O)=O,,,4,1,2,0,2
9190_0,,,,2,2,1,3
C(C)(C(C(C)O)C(C(C=O)=O)O)=O,,,4,1,3,0,3
9190_1,,,,2,2,1,3
9192_0,,,,2,2,1,3
C(CC(C(C=O)=O)O)(CC(C)O)=O,,,4,1,2,0,2
9194_0,,,,2,2,1,3
C(CCC=O)(C(CO)(CC=O)O)=O,,,4,1,1,0,1
9196_0,,,,2,2,1,3
C(CO)(C(CCC=O)(CC=O)O)=O,,,4,1,2,0,2
9198_0,,,,2,2,1,3
C(CC(CCC(C(CO)=O)=O)O)=O,,,4,1,2,0,2
9200_0,,,,2,2,1,3
C(CCC(C(C(C(C)O)O)=O)=O)=O,,,4,1,2,0,2
9200_1,,,,2,2,1,3
9202_0,,,,2,2,1,3
C(CC(C(C(CO)=O)=O)C(C)O)=O,,,4,1,2,0,2
9204_0,,,,2,2,1,3
C(C(C(C)O)CC(C(CO)=O)=O)=O,,,4,1,2,0,2
9206_0,,,,2,2,1,3
C(CCC(C(C(CC=O)O)=O)O)=O,,,4,1,2,0,2
9208_0,,,,2,2,1,3
C(CCC(C(C=O)(CC=O)O)O)=O,,,4,1,1,0,1
9210_0,,,,2,2,1,3
C(CC(CCC(C(C=O)=O)O)O)=O,,,4,1,2,0,2
9212_0,,,,2,2,1,3
C(C(CC(C(C=O)=O)O)C(C)O)=O,,,4,1,2,0,2
9213_0,,,,2,2,1,3
9214_0,,,,2,2,1,3
9216_0,,,,2,2,1,3
C(CO)(CC(C(C)(CC=O)O)=O)=O,,,4,1,2,0,2
9218_0,,,,2,2,1,3
C(C(C(C)O)O)(CC(C(C)=O)=O)=O,,,4,1,2,0,2
9218_1,,,,2,2,1,3
9220_0,,,,2,2,1,3
C(CO)(C(C(C(C)=O)=O)C(C)O)=O,,,4,1,3,0,3
9220_1,,,,2,2,1,3
9222_0,,,,2,2,1,3
C(CO)(CC(C(CC(C)O)=O)=O)=O,,,4,1,2,0,2
9224_0,,,,2,2,1,3
C(CC(C(C=CCO)=O)(CO)O)=O,,,4,1,1,0,1
9226_0,,,,2,2,1,3
C(CC(C(CO)=O)(C=CCO)O)=O,,,4,1,2,0,2
9228_0,,,,2,2,1,3
C(CO)=CC(C(C(C(C)O)O)=O)=O,,,4,1,2,0,2
9228_1,,,,2,2,1,3
9230_0,,,,2,2,1,3
C(CC(C(C(C=CCO)O)=O)O)=O,,,4,1,2,0,2
9232_0,,,,2,2,1,3
C(CC(C=O)(C(C=CCO)O)O)=O,,,4,1,1,0,1
9234_0,,,,2,2,1,3
C(CC(C=CC(C(CO)=O)O)O)=O,,,4,1,3,0,3
9236_0,,,,2,2,1,3
C(CC(CO)(C(C=CC=O)O)O)=O,,,4,1,1,0,1
9238_0,,,,2,2,1,3
C(C(C(C)O)O)(C(C=CC=O)O)=O,,,4,1,2,0,2
9238_1,,,,2,2,1,3
9239_0,,,,2,2,1,3
9241_0,,,,2,2,1,3
C(CC(C=C)(C(C(CO)=O)O)O)=O,,,4,1,2,0,2
9243_0,,,,2,2,1,3
C(C(C(C)O)O)(C(C(C=C)=O)O)=O,,,4,1,2,0,2
9243_1,,,,2,2,1,3
9245_0,,,,2,2,1,3
C(CC(C(C(C(C=C)O)=O)O)O)=O,,,4,1,2,0,2
9247_0,,,,2,2,1,3
C(CC(C(C=O)O)(C(C=C)O)O)=O,,,4,1,1,0,1
9249_0,,,,2,2,1,3
C(CC(C=CC(CO)=O)(CO)O)=O,,,4,1,2,0,2
9251_0,,,,2,2,1,3
C(C=CC(CO)=O)(C(C(C)O)O)=O,,,4,1,3,0,3
9251_1,,,,2,2,1,3
9253_0,,,,2,2,1,3
C(CC(C(C=CC(C=O)O)O)O)=O,,,4,1,2,0,2
9254_0,,,,2,2,1,3
9256_0,,,,2,2,1,3
C(CC(CCO)(CC(CO)=O)O)=O,,,4,1,3,0,3
9258_0,,,,2,2,1,3
C(CCO)(CC(C(C(C)O)O)=O)=O,,,4,1,3,0,3
9258_1,,,,2,2,1,3
9260_0,,,,2,2,1,3
C(CCO)(C(C(CO)=O)C(C)O)=O,,,4,1,4,0,4
9260_1,,,,2,2,1,3
9262_0,,,,2,2,1,3
C(C(CO)C(C)O)(CC(CO)=O)=O,,,4,1,4,0,4
9262_1,,,,2,2,1,3
9264_0,,,,2,2,1,3
C(CC(CO)(CCC(CO)=O)O)=O,,,4,1,4,0,4
9266_0,,,,2,2,1,3
C(CCC(C(C(C)O)O)=O)(CO)=O,,,4,1,3,0,3
9266_1,,,,2,2,1,3
9268_0,,,,2,2,1,3
C(CO)(C(C(C)O)CC(CO)=O)=O,,,4,1,4,0,4
9269_0,,,,2,2,1,3
9271_0,,,,2,2,1,3
C(C(CC(CCO)O)(CC=O)O)=O,,,4,1,2,0,2
9272_0,,,,2,2,1,3
9272_1,,,,2,2,1,3
9274_0,,,,2,2,1,3
C(C(CCO)(CC=O)O)(CCO)=O,,,4,1,3,0,3
9276_0,,,,2,2,1,3
C(C(CCO)=O)(C(CO)C(C)O)=O,,,4,1,4,0,4
9276_1,,,,2,2,1,3
9278_0,,,,2,2,1,3
C(CC(CCO)(C(C(C)=O)O)O)=O,,,4,1,2,0,2
9279_0,,,,2,2,1,3
9281_0,,,,2,2,1,3
C(C(CO)C(C)O)(C(C(C)=O)O)=O,,,4,1,3,0,3
9281_1,,,,2,2,1,3
9283_0,,,,2,2,1,3
C(CC(C)O)(C(C(CCO)=O)O)=O,,,4,1,2,0,2
9285_0,,,,2,2,1,3
C(CC(CC(C(CCO)O)=O)O)=O,,,4,1,2,0,2
9287_0,,,,2,2,1,3
C(CC(C(CCO)O)(CC=O)O)=O,,,4,1,2,0,2
9289_0,,,,2,2,1,3
C(C(C(C(CCO)O)=O)C(C)O)=O,,,4,1,3,0,3
9289_1,,,,2,2,1,3
9291_0,,,,2,2,1,3
C(CC(C(CO)O)(CC(C)=O)O)=O,,,4,1,2,0,2
9292_0,,,,2,2,1,3
9294_0,,,,2,2,1,3
C(C(CO)O)(C(C(C)=O)C(C)O)=O,,,4,1,3,0,3
9294_1,,,,2,2,1,3
9296_0,,,,2,2,1,3
C(CC(C)O)(CC(C(CO)O)=O)=O,,,4,1,2,0,2
9298_0,,,,2,2,1,3
C(CCC(C(CO)O)(CC=O)O)=O,,,4,1,2,0,2
9300_0,,,,2,2,1,3
C(CC(CCC(C(CO)O)=O)O)=O,,,4,1,2,0,2
9302_0,,,,2,2,1,3
C(C(C(C)O)CC=O)(C(CO)O)=O,,,4,1,3,0,3
9304_0,,,,2,2,1,3
C(C(C(C)O)CC(C(CO)O)=O)=O,,,4,1,3,0,3
9306_0,,,,2,2,1,3
C(CC(C(C(CCCO)=O)O)O)=O,,,4,1,2,0,2
9308_0,,,,2,2,1,3
C(CC(CCCO)(C(C=O)O)O)=O,,,4,1,2,0,2
9310_0,,,,2,2,1,3
C(C(C(C(C(C)O)CCO)=O)O)=O,,,4,1,2,0,2
9312_0,,,,2,2,1,3
C(C)(C(CC(CO)O)(CC=O)O)=O,,,4,1,2,0,2
9314_0,,,,2,2,1,3
C(C(C)(CC=O)O)(CC(CO)O)=O,,,4,1,2,0,2
9316_0,,,,2,2,1,3
C(C(C)=O)(C(C(CO)O)C(C)O)=O,,,4,1,3,0,3
9316_1,,,,2,2,1,3
9318_0,,,,2,2,1,3
C(C(CC(C)O)=O)(CC(CO)O)=O,,,4,1,2,0,2
9320_0,,,,2,2,1,3
C(CC(CC(CO)O)(CC=O)O)=O,,,4,1,2,0,2
9322_0,,,,2,2,1,3
C(CC(CC(CC(CO)O)=O)O)=O,,,4,1,2,0,2
9324_0,,,,2,2,1,3
C(CC(C(C(CO)O)C(C)O)=O)=O,,,4,1,3,0,3
9324_1,,,,2,2,1,3
9326_0,,,,2,2,1,3
C(C(C(CC(CO)O)=O)C(C)O)=O,,,4,1,3,0,3
9326_1,,,,2,2,1,3
9327_0,,,,2,2,1,3
9329_0,,,,2,2,1,3
C(CC(CC(C=O)O)(CCO)O)=O,,,4,1,3,0,3
9331_0,,,,2,2,1,3
C(C(C(C)O)C(C=O)O)(CCO)=O,,,4,1,4,0,4
9331_1,,,,2,2,1,3
9333_0,,,,2,2,1,3
C(CC(C=O)O)(C(CO)C(C)O)=O,,,4,1,4,0,4
9333_1,,,,2,2,1,3
9335_0,,,,2,2,1,3
C(CC(C=CC(CO)O)(CO)O)=O,,,4,1,3,0,3
9337_0,,,,2,2,1,3
C(C(CO)O)=CC(C(C(C)O)O)=O,,,4,1,3,0,3
9337_1,,,,2,2,1,3
9339_0,,,,2,2,1,3
C(CC(C=CCO)(C(CO)O)O)=O,,,4,1,3,0,3
9341_0,,,,2,2,1,3
C(CC(C=C)(C(C(CO)O)O)O)=O,,,4,1,2,0,2
9343_0,,,,2,2,1,3
C(CC(C=CC(C(CO)O)O)O)=O,,,4,1,2,0,2
9345_0,,,,2,2,1,3
C(CC(C(C(C=CCO)O)O)O)=O,,,4,1,2,0,2
9346_0,,,,2,2,1,3
9348_0,,,,2,2,1,3
C(C(C(CO)C(C)O)=O)(O)=O,,,4,1,3,0,3
9348_1,,,,2,2,1,3
9350_0,,,,2,2,1,3
C(C(C(CO)O)(CC=O)O)(O)=O,,,4,1,4,0,4
9352_0,,,,2,2,1,3
C1(CCC(C1(C(CC=O)O)O)O)=O,,,4,1,3,0,3
9354_0,,,,2,2,1,3
C(C1(C(CCC1(CC=O)O)O)O)=O,,,4,1,3,0,3
9356_0,,,,2,2,1,3
C(C1(C(C(C(C)O)CC1O)=O)O)=O,,,4,1,3,0,3
9358_0,,,,2,2,1,3
C(CC1(C=CC(C1(CO)O)O)O)=O,,,4,1,1,0,1
9360_0,,,,2,2,1,3
C(CC(C1(C(C=CC1O)O)O)O)=O,,,4,1,1,0,1
9362_0,,,,2,2,1,3
C(CC(C(CO)(CO)O)O)=O,,,4,1,1,0,1
9364_0,,,,2,2,1,3
C(CC(C(CO)(C(C)O)O)O)=O,,,4,1,1,0,1
9366_0,,,,2,2,1,3
C(CC(C(C(C)=O)(CO)O)O)=O,,,4,1,6,0,6
9368_0,,,,2,2,1,3
C(C(CO)(C(C)(CC=O)O)O)=O,,,4,1,6,0,6
9370_0,,,,2,2,1,3
C(C(C(CC(C)O)=O)(CO)O)=O,,,4,1,3,0,3
9372_0,,,,2,2,1,3
C(CC(C(C(C)=O)(C(C)O)O)O)=O,,,4,1,5,0,5
9374_0,,,,2,2,1,3
C(C(C(C)O)(C(C)(CC=O)O)O)=O,,,4,1,5,0,5
9376_0,,,,2,2,1,3
C(C(C(CC(C)O)=O)(C(C)O)O)=O,,,4,1,3,0,3
9377_0,,,,2,2,1,3
9379_0,,,,2,2,1,3
C(CC(C(C=O)(C(C=O)O)O)O)=O,,,4,1,5,0,5
9381_0,,,,2,2,1,3
C(CC(C)(C(CO)(CO)O)O)=O,,,4,1,1,0,1
9383_0,,,,2,2,1,3
C(CC(C)O)(C(CO)(CO)O)=O,,,4,1,3,0,3
9385_0,,,,2,2,1,3
C(CC(C)(C(CO)(C(C)O)O)O)=O,,,4,1,1,0,1
9387_0,,,,2,2,1,3
C(CC(C)O)(C(CO)(C(C)O)O)=O,,,4,1,3,0,3
9389_0,,,,2,2,1,3
C(C(CO)(C(CC=O)O)O)=O,,,4,1,6,0,6
9391_0,,,,2,2,1,3
C(CC(CO)(C(CO)(CO)O)O)=O,,,4,1,3,0,3
9393_0,,,,2,2,1,3
C(C(C(C)O)O)(C(CO)(CO)O)=O,,,4,1,4,0,4
9393_1,,,,2,2,1,3
9394_0,,,,2,2,1,3
9395_0,,,,2,2,1,3
9397_0,,,,2,2,1,3
C(C(C(CC=O)O)(C(C)O)O)=O,,,4,1,5,0,5
9399_0,,,,2,2,1,3
C(CC(C(CO)(C(CO)O)O)O)=O,,,4,1,1,0,1
9401_0,,,,2,2,1,3
C(C(C(CC=O)O)(C(CO)O)O)=O,,,4,1,5,0,5
9403_0,,,,2,2,1,3
C(CC(C1(C(CC(C1)=O)O)O)O)=O,,,4,1,1,0,1
9405_0,,,,2,2,1,3
C(C1(CC(CC1O)(CC=O)O)O)=O,,,4,1,2,0,2
9407_0,,,,2,2,1,3
C1(C(C(C)O)C(C=O)(C(C1)O)O)=O,,,4,1,3,0,3
9407_1,,,,2,2,1,3
9409_0,,,,2,2,1,3
C(C1(C(C(C(C1)=O)C(C)O)O)O)=O,,,4,1,3,0,3
9409_1,,,,2,2,1,3
9411_0,,,,2,2,1,3
C(CC(C(C)(C(C(O)=O)O)O)O)=O,,,4,1,2,0,2
9413_0,,,,2,2,1,3
C(CC(C(CC=O)O)(C(C)O)O)=O,,,4,1,1,0,1
9415_0,,,,2,2,1,3
C(C(C(C)O)(CC(CC=O)O)O)=O,,,4,1,2,0,2
9416_0,,,,2,2,1,3
9416_1,,,,2,2,1,3
9418_0,,,,2,2,1,3
C(CC1(CC(C(C1CO)=O)O)O)=O,,,4,1,1,0,1
9420_0,,,,2,2,1,3
C1(CC(C(CC=O)(C1CO)O)O)=O,,,4,1,1,0,1
9422_0,,,,2,2,1,3
C1(C(C(C)O)C(C(C1CO)=O)O)=O,,,4,1,2,0,2
9422_1,,,,2,2,1,3
9424_0,,,,2,2,1,3
C(CC1(CC(C(C1O)=O)CO)O)=O,,,4,1,1,0,1
9426_0,,,,2,2,1,3
C(CC1(C(CO)CC(C1O)=O)O)=O,,,4,1,2,0,2
9428_0,,,,2,2,1,3
C1(C(C(C)O)C(C(C1O)=O)CO)=O,,,4,1,1,0,1
9430_0,,,,2,2,1,3
C1(CCC(CC=O)(C1(CO)O)O)=O,,,4,1,1,0,1
9432_0,,,,2,2,1,3
C1(C(C(C)O)CC(C1(CO)O)=O)=O,,,4,1,1,0,1
9434_0,,,,2,2,1,3
C1(CC(CC1(CO)O)(CC=O)O)=O,,,4,1,1,0,1
9436_0,,,,2,2,1,3
C(CC1(C(CO)(CC(C1)=O)O)O)=O,,,4,1,1,0,1
9438_0,,,,2,2,1,3
C1(C(C(C)O)C(C(C1)=O)(CO)O)=O,,,4,1,2,0,2
9438_1,,,,2,2,1,3
9440_0,,,,2,2,1,3
C1(C(CO)(CC(C1C(C)O)=O)O)=O,,,4,1,2,0,2
9440_1,,,,2,2,1,3
9442_0,,,,2,2,1,3
C1(CC(C(C(C)(CC=O)O)O1)O)=O,,,4,1,1,0,1
9444_0,,,,2,2,1,3
C1(CC(C(C(CC(C)O)=O)O1)O)=O,,,4,1,1,0,1
9446_0,,,,2,2,1,3
C1(CC(C(CC(CC=O)O)O1)O)=O,,,4,1,1,0,1
9448_0,,,,2,2,1,3
C(C(C1C(CC(O1)=O)O)C(C)O)=O,,,4,1,2,0,2
9448_1,,,,2,2,1,3
9450_0,,,,2,2,1,3
C(CC1(C(C(C(C)=O)OC1)O)O)=O,,,4,1,1,0,1
9452_0,,,,2,2,1,3
C(CC(C)(C1C(C(CO1)=O)O)O)=O,,,4,1,1,0,1
9454_0,,,,2,2,1,3
C(C1C(C(C(C(C)O)O1)=O)O)(C)=O,,,4,1,2,0,2
9454_1,,,,2,2,1,3
9456_0,,,,2,2,1,3
C(C1C(C(CO1)=O)O)(CC(C)O)=O,,,4,1,1,0,1
9458_0,,,,2,2,1,3
C(CC1(COC(C1O)CC=O)O)=O,,,4,1,1,0,1
9460_0,,,,2,2,1,3
C(CC(CC1C(C(CO1)=O)O)O)=O,,,4,1,1,0,1
9462_0,,,,2,2,1,3
C(CC1C(C(C(C(C)O)O1)=O)O)=O,,,4,1,2,0,2
9462_1,,,,2,2,1,3
9464_0,,,,2,2,1,3
C(C(C1C(C(CO1)=O)O)C(C)O)=O,,,4,1,2,0,2
9464_1,,,,2,2,1,3
9466_0,,,,2,2,1,3
C(CC1(CC(C(C)=O)OC1O)O)=O,,,4,1,2,0,2
9468_0,,,,2,2,1,3
C(CC(C)(C1CC(C(O)O1)=O)O)=O,,,4,1,2,0,2
9470_0,,,,2,2,1,3
C(C1C(C(C(O1)O)=O)C(C)O)(C)=O,,,4,1,3,0,3
9470_1,,,,2,2,1,3
9472_0,,,,2,2,1,3
C1(C(OC(C(CC(C)O)=O)C1)O)=O,,,4,1,2,0,2
9474_0,,,,2,2,1,3
C(CC1CC(C(O)O1)(CC=O)O)=O,,,4,1,2,0,2
9476_0,,,,2,2,1,3
C(CC(CC1CC(C(O)O1)=O)O)=O,,,4,1,2,0,2
9478_0,,,,2,2,1,3
C(CC1C(C(C(O)O1)=O)C(C)O)=O,,,4,1,3,0,3
9478_1,,,,2,2,1,3
9480_0,,,,2,2,1,3
C(C(C1CC(C(O)O1)=O)C(C)O)=O,,,4,1,3,0,3
9480_1,,,,2,2,1,3
9482_0,,,,2,2,1,3
C(CC1(CC(OC1C(C)=O)O)O)=O,,,4,1,2,0,2
9483_0,,,,2,2,1,3
9485_0,,,,2,2,1,3
C1(C(C(OC1C(C)=O)O)C(C)O)=O,,,4,1,3,0,3
9485_1,,,,2,2,1,3
9487_0,,,,2,2,1,3
C(CC(C)O)(C1C(CC(O1)O)=O)=O,,,4,1,2,0,2
9489_0,,,,2,2,1,3
C(CC1C(CC(O)O1)(CC=O)O)=O,,,4,1,2,0,2
9491_0,,,,2,2,1,3
C(CC(CC1C(CC(O1)O)=O)O)=O,,,4,1,2,0,2
9493_0,,,,2,2,1,3
C(CC1C(C(C(O1)O)C(C)O)=O)=O,,,4,1,3,0,3
9493_1,,,,2,2,1,3
9495_0,,,,2,2,1,3
C(C(C(C)O)C1C(CC(O1)O)=O)=O,,,4,1,3,0,3
9495_1,,,,2,2,1,3
9497_0,,,,2,2,1,3
C1(CC(CC(CO)O1)(CC=O)O)=O,,,4,1,1,0,1
9499_0,,,,2,2,1,3
C1(C(C(CC(CO)O1)=O)C(C)O)=O,,,4,1,2,0,2
9499_1,,,,2,2,1,3
9501_0,,,,2,2,1,3
C1(CC(C(C(CO)O1)C(C)O)=O)=O,,,4,1,2,0,2
9501_1,,,,2,2,1,3
9503_0,,,,2,2,1,3
C1(CCC(C(CO)O1)(CC=O)O)=O,,,4,1,1,0,1
9505_0,,,,2,2,1,3
C1(C(CO)OC(CC1C(C)O)=O)=O,,,4,1,1,0,1
9507_0,,,,2,2,1,3
C1(C(COC(CO)C1)(CC=O)O)=O,,,4,1,1,0,1
9509_0,,,,2,2,1,3
C1(COC(CO)CC1(CC=O)O)=O,,,4,1,1,0,1
9511_0,,,,2,2,1,3
C1(C(C(C(C)O)OC(CO)C1)=O)=O,,,4,1,2,0,2
9511_1,,,,2,2,1,3
9513_0,,,,2,2,1,3
C1(C(COC(CO)C1C(C)O)=O)=O,,,4,1,2,0,2
9513_1,,,,2,2,1,3
9515_0,,,,2,2,1,3
C(CC1(COC(C(C1)=O)CO)O)=O,,,4,1,1,0,1
9517_0,,,,2,2,1,3
C(CC1(C(CO)OCC(C1)=O)O)=O,,,4,1,1,0,1
9519_0,,,,2,2,1,3
C1(C(C(C)O)OC(C(C1)=O)CO)=O,,,4,1,2,0,2
9519_1,,,,2,2,1,3
9521_0,,,,2,2,1,3
C1(C(CO)OCC(C1C(C)O)=O)=O,,,4,1,2,0,2
9521_1,,,,2,2,1,3
9523_0,,,,2,2,1,3
C1(CC(CC(CO1)O)(CC=O)O)=O,,,4,1,1,0,1
9525_0,,,,2,2,1,3
C1(C(C(CC(CO1)O)=O)C(C)O)=O,,,4,1,2,0,2
9525_1,,,,2,2,1,3
9527_0,,,,2,2,1,3
C1(CC(C(C(C)O)C(CO1)O)=O)=O,,,4,1,2,0,2
9527_1,,,,2,2,1,3
9529_0,,,,2,2,1,3
C1(CCC(C(CO1)O)(CC=O)O)=O,,,4,1,1,0,1
9531_0,,,,2,2,1,3
C1(C(C(C)O)CC(OCC1O)=O)=O,,,4,1,1,0,1
9533_0,,,,2,2,1,3
C1(CC(C(CCO1)(CC=O)O)O)=O,,,4,1,1,0,1
9535_0,,,,2,2,1,3
C1(CC(C(C(CO1)C(C)O)=O)O)=O,,,4,1,2,0,2
9535_1,,,,2,2,1,3
9537_0,,,,2,2,1,3
C1(CC(CC(CO1)(CC=O)O)O)=O,,,4,1,1,0,1
9539_0,,,,2,2,1,3
C1(CC(C(C(CO1)=O)C(C)O)O)=O,,,4,1,2,0,2
9539_1,,,,2,2,1,3
9541_0,,,,2,2,1,3
C1(CC(CC(C(C(C)O)O1)=O)O)=O,,,4,1,2,0,2
9541_1,,,,2,2,1,3
9543_0,,,,2,2,1,3
C1(C(COCC(C1)O)(CC=O)O)=O,,,4,1,1,0,1
9545_0,,,,2,2,1,3
C1(COCC(CC1(CC=O)O)O)=O,,,4,1,1,0,1
9547_0,,,,2,2,1,3
C1(C(C(C(C)O)OCC(C1)O)=O)=O,,,4,1,2,0,2
9547_1,,,,2,2,1,3
9549_0,,,,2,2,1,3
C1(C(COCC(C1C(C)O)O)=O)=O,,,4,1,2,0,2
9549_1,,,,2,2,1,3
9551_0,,,,2,2,1,3
C(CC1(COCC(C(C1)=O)O)O)=O,,,4,1,1,0,1
9553_0,,,,2,2,1,3
C(CC1(C(COCC(C1)=O)O)O)=O,,,4,1,1,0,1
9555_0,,,,2,2,1,3
C1(C(COC(C(C1)=O)C(C)O)O)=O,,,4,1,2,0,2
9555_1,,,,2,2,1,3
9557_0,,,,2,2,1,3
C1(C(COCC(C1C(C)O)=O)O)=O,,,4,1,2,0,2
9557_1,,,,2,2,1,3
9559_0,,,,2,2,1,3
C(CC1(COCCC(C1O)=O)O)=O,,,4,1,1,0,1
9561_0,,,,2,2,1,3
C(CC1(CCOCC(C1O)=O)O)=O,,,4,1,1,0,1
9563_0,,,,2,2,1,3
C1(CCOC(C(C1O)=O)C(C)O)=O,,,4,1,2,0,2
9563_1,,,,2,2,1,3
9565_0,,,,2,2,1,3
C1(C(COCC(C1O)=O)C(C)O)=O,,,4,1,2,0,2
9565_1,,,,2,2,1,3
9567_0,,,,2,2,1,3
C(CC1(C(CC(COC1)=O)O)O)=O,,,4,1,1,0,1
9569_0,,,,2,2,1,3
C(CC1(COCC(C(C1)O)=O)O)=O,,,4,1,1,0,1
9571_0,,,,2,2,1,3
C1(CC(C(C(C(C)O)OC1)=O)O)=O,,,4,1,2,0,2
9571_1,,,,2,2,1,3
9573_0,,,,2,2,1,3
C1(COCC(C(C1C(C)O)O)=O)=O,,,4,1,2,0,2
9573_1,,,,2,2,1,3
9575_0,,,,2,2,1,3
C1(CC(C(COC1C(C)O)=O)O)=O,,,4,1,2,0,2
9575_1,,,,2,2,1,3
9577_0,,,,2,2,1,3
C(CC1(C(O)OCCC(C1)=O)O)=O,,,4,1,2,0,2
9579_0,,,,2,2,1,3
C(CC1(CCOC(C(C1)=O)O)O)=O,,,4,1,2,0,2
9581_0,,,,2,2,1,3
C1(CCOC(C(C1C(C)O)=O)O)=O,,,4,1,3,0,3
9581_1,,,,2,2,1,3
9583_0,,,,2,2,1,3
C1(C(COC(C(C1)=O)O)C(C)O)=O,,,4,1,3,0,3
9583_1,,,,2,2,1,3
9585_0,,,,2,2,1,3
C(CC1(CCC(COC1O)=O)O)=O,,,4,1,2,0,2
9587_0,,,,2,2,1,3
C(CC1(COC(C(CC1)=O)O)O)=O,,,4,1,2,0,2
9589_0,,,,2,2,1,3
C1(CC(C(C(OC1)O)=O)C(C)O)=O,,,4,1,2,0,2
9591_0,,,,2,2,1,3
C1(COC(C(CC1C(C)O)=O)O)=O,,,4,1,2,0,2
9593_0,,,,2,2,1,3
C1(CCC(C(OC1C(C)O)O)=O)=O,,,4,1,3,0,3
9593_1,,,,2,2,1,3
9595_0,,,,2,2,1,3
C1(C(CC(O)OCC1)(CC=O)O)=O,,,4,1,2,0,2
9597_0,,,,2,2,1,3
C1(C(CCOC(C1)O)(CC=O)O)=O,,,4,1,2,0,2
9599_0,,,,2,2,1,3
C1(C(CCOC(C1C(C)O)O)=O)=O,,,4,1,3,0,3
9599_1,,,,2,2,1,3
9601_0,,,,2,2,1,3
C1(C(CC(O)OCC1C(C)O)=O)=O,,,4,1,3,0,3
9601_1,,,,2,2,1,3
9603_0,,,,2,2,1,3
C(CC1(CC(OCC(C1)=O)O)O)=O,,,4,1,2,0,2
9605_0,,,,2,2,1,3
C(CC1(COC(CC(C1)=O)O)O)=O,,,4,1,2,0,2
9607_0,,,,2,2,1,3
C1(C(C(OCC(C1)=O)O)C(C)O)=O,,,4,1,3,0,3
9607_1,,,,2,2,1,3
9609_0,,,,2,2,1,3
C1(CC(OCC(C1C(C)O)=O)O)=O,,,4,1,3,0,3
9609_1,,,,2,2,1,3
9611_0,,,,2,2,1,3
C1(CC(OC(C(C1)=O)C(C)O)O)=O,,,4,1,3,0,3
9611_1,,,,2,2,1,3
9613_0,,,,2,2,1,3
C(CC(C(C(CC(C)=O)=O)=O)O)=O,,,4,1,1,0,1
9615_0,,,,2,2,1,3
C(C(C(CC(C)=O)=O)(CC=O)O)=O,,,4,1,1,0,1
9617_0,,,,2,2,1,3
C(CC(C(C=O)=O)(CC(C)=O)O)=O,,,4,1,2,0,2
9618_0,,,,2,2,1,3
9620_0,,,,2,2,1,3
C(C)(C(C(C(C=O)=O)=O)C(C)O)=O,,,4,1,2,0,2
9620_1,,,,2,2,1,3
9622_0,,,,2,2,1,3
C(CC(C)O)(CC(C(C=O)=O)=O)=O,,,4,1,1,0,1
9624_0,,,,2,2,1,3
C(CCC(C(C(CC=O)O)=O)=O)=O,,,4,1,1,0,1
9626_0,,,,2,2,1,3
C(C(C(CCC=O)=O)(CC=O)O)=O,,,4,1,1,0,1
9628_0,,,,2,2,1,3
C(CCC(C(C=O)=O)(CC=O)O)=O,,,4,1,2,0,2
9630_0,,,,2,2,1,3
C(CC(CCC(C(C=O)=O)=O)O)=O,,,4,1,1,0,1
9632_0,,,,2,2,1,3
C(CC(C(C(C=O)=O)=O)C(C)O)=O,,,4,1,1,0,1
9634_0,,,,2,2,1,3
C(C(C(C)O)CC(C(C=O)=O)=O)=O,,,4,1,1,0,1
9636_0,,,,2,2,1,3
C(CC(C(CC(C(C)=O)=O)=O)O)=O,,,4,1,1,0,1
9637_0,,,,2,2,1,3
9638_0,,,,2,2,1,3
9640_0,,,,2,2,1,3
C(C(C)(CC=O)O)(CC(C=O)=O)=O,,,4,1,2,0,2
9642_0,,,,2,2,1,3
C(C(C(C(C(C)=O)=O)C(C)O)=O)=O,,,4,1,3,0,3
9642_1,,,,2,2,1,3
9644_0,,,,2,2,1,3
C(C(CC(C(CC(C)O)=O)=O)=O)=O,,,4,1,2,0,2
9646_0,,,,2,2,1,3
C(CC(CC(C(CC=O)O)=O)=O)=O,,,4,1,1,0,1
9647_0,,,,2,2,1,3
9649_0,,,,2,2,1,3
C(CC(CC=O)(CC(C=O)=O)O)=O,,,4,1,2,0,2
9650_0,,,,2,2,1,3
9652_0,,,,2,2,1,3
C(CC=O)(C(C(C=O)=O)C(C)O)=O,,,4,1,3,0,3
9652_1,,,,2,2,1,3
9654_0,,,,2,2,1,3
C(C(C(CC(C=O)=O)=O)C(C)O)=O,,,4,1,3,0,3
9654_1,,,,2,2,1,3
9656_0,,,,2,2,1,3
C(CC(C(C=CC(C)=O)=O)O)=O,,,4,1,3,0,3
9658_0,,,,2,2,1,3
C(C(C=CC(C)=O)(CC=O)O)=O,,,4,1,3,0,3
9660_0,,,,2,2,1,3
C(CC(C=CC(C=O)=O)(C)O)=O,,,4,1,2,0,2
9662_0,,,,2,2,1,3
C(C(C=CC(CC(C)O)=O)=O)=O,,,4,1,2,0,2
9664_0,,,,2,2,1,3
C(CC=CC(C(CC=O)O)=O)=O,,,4,1,3,0,3
9666_0,,,,2,2,1,3
C(C(C=CCC=O)(CC=O)O)=O,,,4,1,3,0,3
9668_0,,,,2,2,1,3
C(CC(CC=CC(C=O)=O)O)=O,,,4,1,2,0,2
9670_0,,,,2,2,1,3
C(C(C=CC(C=O)=O)C(C)O)=O,,,4,1,2,0,2
9672_0,,,,2,2,1,3
C(CC(C=CC(C(C)=O)=O)O)=O,,,4,1,3,0,3
9674_0,,,,2,2,1,3
C(CC(C(C)=O)(C=CC=O)O)=O,,,4,1,3,0,3
9676_0,,,,2,2,1,3
C(CC(C(C=CC=O)=O)(C)O)=O,,,4,1,2,0,2
9678_0,,,,2,2,1,3
C(C(C=CC=O)=O)(CC(C)O)=O,,,4,1,2,0,2
9680_0,,,,2,2,1,3
C(CC(C=CC(CC=O)O)=O)=O,,,4,1,5,0,5
9682_0,,,,2,2,1,3
C(CC(C=CC=O)(CC=O)O)=O,,,4,1,4,0,4
9684_0,,,,2,2,1,3
C(CC(CC(C=CC=O)=O)O)=O,,,4,1,4,0,4
9686_0,,,,2,2,1,3
C(C(C(C=CC=O)=O)C(C)O)=O,,,4,1,6,0,6
9686_1,,,,2,2,1,3
9688_0,,,,2,2,1,3
C(CC(C(CC(C=C)=O)=O)O)=O,,,4,1,3,0,3
9690_0,,,,2,2,1,3
C(CC(C=O)(CC(C=C)=O)O)=O,,,4,1,2,0,2
9692_0,,,,2,2,1,3
C(CC(C=C)(CC(C=O)=O)O)=O,,,4,1,3,0,3
9694_0,,,,2,2,1,3
C=CC(C(C(C=O)=O)C(C)O)=O,,,4,1,4,0,4
9694_1,,,,2,2,1,3
9696_0,,,,2,2,1,3
C(CC(CC(C(C=C)=O)=O)O)=O,,,4,1,3,0,3
9698_0,,,,2,2,1,3
C(CC(C(C=C)=O)(CC=O)O)=O,,,4,1,2,0,2
9700_0,,,,2,2,1,3
C(CC=O)(C(C=C)(CC=O)O)=O,,,4,1,4,0,4
9702_0,,,,2,2,1,3
C(C(C(C(C=C)=O)=O)C(C)O)=O,,,4,1,4,0,4
9702_1,,,,2,2,1,3
9704_0,,,,2,2,1,3
C(CC(C(CC=CC=O)=O)O)=O,,,4,1,3,0,3
9706_0,,,,2,2,1,3
C(CC(C=O)(CC=CC=O)O)=O,,,4,1,2,0,2
9708_0,,,,2,2,1,3
C(CC(C=CCC(C=O)=O)O)=O,,,4,1,3,0,3
9710_0,,,,2,2,1,3
C(C(C(C=O)=O)C(C)O)=CC=O,,,4,1,2,0,2
9712_0,,,,2,2,1,3
C(CC(C=CC(O)=O)(CCO)O)=O,,,4,1,1,0,1
9714_0,,,,2,2,1,3
C(C=CC(C(CO)C(C)O)=O)(O)=O,,,4,1,2,0,2
9714_1,,,,2,2,1,3
9716_0,,,,2,2,1,3
C(CC(CO)(CC=CC(O)=O)O)=O,,,4,1,1,0,1
9718_0,,,,2,2,1,3
C(CO)(C(C=CC(O)=O)C(C)O)=O,,,4,1,1,0,1
9720_0,,,,2,2,1,3
C(C(C(C)O)O)(CC=CC(O)=O)=O,,,4,1,2,0,2
9720_1,,,,2,2,1,3
9722_0,,,,2,2,1,3
C(CC(C)(C(C=CC(O)=O)O)O)=O,,,4,1,1,0,1
9724_0,,,,2,2,1,3
C(CC(C)O)(C(C=CC(O)=O)O)=O,,,4,1,1,0,1
9726_0,,,,2,2,1,3
C(CC(CC(C=CC(O)=O)O)O)=O,,,4,1,1,0,1
9728_0,,,,2,2,1,3
C(C(C(C)O)C(C=CC(O)=O)O)=O,,,4,1,2,0,2
9728_1,,,,2,2,1,3
9730_0,,,,2,2,1,3
C(C(C=CC(C)(CC=O)O)O)(O)=O,,,4,1,1,0,1
9732_0,,,,2,2,1,3
C(C(C=CC(CC(C)O)=O)O)(O)=O,,,4,1,1,0,1
9734_0,,,,2,2,1,3
C(C(C=CCC(CC=O)O)O)(O)=O,,,4,1,1,0,1
9736_0,,,,2,2,1,3
C(C(C=CC(C(O)=O)O)C(C)O)=O,,,4,1,1,0,1
9738_0,,,,2,2,1,3
C(CC1(COCC1O)O)=O,,,4,1,1,0,1
9740_0,,,,2,2,1,3
C1(C(C(C)O)OCC1O)=O,,,4,1,2,0,2
9740_1,,,,2,2,1,3
9742_0,,,,2,2,1,3
C(CC1(C(O)OCC1)O)=O,,,4,1,2,0,2
9744_0,,,,2,2,1,3
C1(C(O)OCC1C(C)O)=O,,,4,1,3,0,3
9744_1,,,,2,2,1,3
9746_0,,,,2,2,1,3
C(CC(CC1C(C(CO1)O)=O)O)=O,,,4,1,1,0,1
9748_0,,,,2,2,1,3
C(CC1(C(CC=O)OCC1O)O)=O,,,4,1,1,0,1
9750_0,,,,2,2,1,3
C(C(C(C)O)C1C(C(CO1)O)=O)=O,,,4,1,2,0,2
9750_1,,,,2,2,1,3
9752_0,,,,2,2,1,3
C(CC(CC1(C(CCO1)=O)O)O)=O,,,4,1,2,0,2
9754_0,,,,2,2,1,3
C(CC1(C(CC=O)(O)OCC1)O)=O,,,4,1,2,0,2
9756_0,,,,2,2,1,3
C(C(C(C)O)C1(C(CCO1)=O)O)=O,,,4,1,3,0,3
9756_1,,,,2,2,1,3
9758_0,,,,2,2,1,3
C(CC1(C(C(CO1)C(C)O)=O)O)=O,,,4,1,3,0,3
9758_1,,,,2,2,1,3
9760_0,,,,2,2,1,3
C(CC(CC1(CC(CO1)=O)O)O)=O,,,4,1,2,0,2
9762_0,,,,2,2,1,3
C(CC1(COC(C1)(CC=O)O)O)=O,,,4,1,2,0,2
9764_0,,,,2,2,1,3
C(C(C1(CC(CO1)=O)O)C(C)O)=O,,,4,1,3,0,3
9764_1,,,,2,2,1,3
9766_0,,,,2,2,1,3
C(CC1(C(C(CO1)=O)C(C)O)O)=O,,,4,1,3,0,3
9766_1,,,,2,2,1,3
9768_0,,,,2,2,1,3
C(CC1(CC(C(C(C)O)O1)=O)O)=O,,,4,1,3,0,3
9768_1,,,,2,2,1,3
9770_0,,,,2,2,1,3
C(CC(C(C1CC(CO1)O)=O)O)=O,,,4,1,1,0,1
9772_0,,,,2,2,1,3
C(C(C1CC(CO1)O)(CC=O)O)=O,,,4,1,1,0,1
9774_0,,,,2,2,1,3
C(CC(C1C(CC(C=O)O1)O)O)=O,,,4,1,1,0,1
9776_0,,,,2,2,1,3
C(CC(C1CC(C(C=O)O1)O)O)=O,,,4,1,1,0,1
9778_0,,,,2,2,1,3
C(CC(C1C(CC(C)(O1)O)=O)O)=O,,,4,1,2,0,2
9780_0,,,,2,2,1,3
C(CC1(CC(C)(OC1C=O)O)O)=O,,,4,1,2,0,2
9782_0,,,,2,2,1,3
C(C1C(C(C(C)O)C(C)(O1)O)=O)=O,,,4,1,3,0,3
9782_1,,,,2,2,1,3
9784_0,,,,2,2,1,3
C(CC(C1CC(C(C)(O)O1)=O)O)=O,,,4,1,2,0,2
9786_0,,,,2,2,1,3
C(CC1(CC(C=O)OC1(C)O)O)=O,,,4,1,2,0,2
9788_0,,,,2,2,1,3
C1(C(C)(OC(C=O)C1C(C)O)O)=O,,,4,1,3,0,3
9788_1,,,,2,2,1,3
9790_0,,,,2,2,1,3
C(CC(C1C(C(C(C)O1)=O)O)O)=O,,,4,1,1,0,1
9792_0,,,,2,2,1,3
C(CC1(C(C(C=O)OC1C)O)O)=O,,,4,1,1,0,1
9794_0,,,,2,2,1,3
C(CC(C1(CC(CCO1)=O)O)O)=O,,,4,1,2,0,2
9796_0,,,,2,2,1,3
C(CC1(CC(C=O)(O)OCC1)O)=O,,,4,1,2,0,2
9798_0,,,,2,2,1,3
C1(C(C(C)O)C(C=O)(O)OCC1)=O,,,4,1,3,0,3
9798_1,,,,2,2,1,3
9800_0,,,,2,2,1,3
C1(CC(C=O)(O)OCC1C(C)O)=O,,,4,1,3,0,3
9800_1,,,,2,2,1,3
9802_0,,,,2,2,1,3
C(CC(C1(CCC(CO1)=O)O)O)=O,,,4,1,2,0,2
9804_0,,,,2,2,1,3
C(CC1(COC(C=O)(CC1)O)O)=O,,,4,1,2,0,2
9806_0,,,,2,2,1,3
C(C1(CC(C(CO1)=O)C(C)O)O)=O,,,4,1,2,0,2
9808_0,,,,2,2,1,3
C1(C(C(C)O)OC(C=O)(CC1)O)=O,,,4,1,3,0,3
9808_1,,,,2,2,1,3
9810_0,,,,2,2,1,3
C(CC(C1C(CCC(O1)O)=O)O)=O,,,4,1,2,0,2
9812_0,,,,2,2,1,3
C(CC1(CCC(OC1C=O)O)O)=O,,,4,1,2,0,2
9814_0,,,,2,2,1,3
C(C1C(C(C(C)O)CC(O1)O)=O)=O,,,4,1,2,0,2
9816_0,,,,2,2,1,3
C(CC(C1CC(CC(O)O1)=O)O)=O,,,4,1,2,0,2
9818_0,,,,2,2,1,3
C(CC1(CC(C=O)OC(C1)O)O)=O,,,4,1,2,0,2
9820_0,,,,2,2,1,3
C1(C(C(C)O)C(C=O)OC(C1)O)=O,,,4,1,3,0,3
9820_1,,,,2,2,1,3
9822_0,,,,2,2,1,3
C1(CC(C=O)OC(C1C(C)O)O)=O,,,4,1,3,0,3
9822_1,,,,2,2,1,3
9824_0,,,,2,2,1,3
C(CC(C)(C1CC(C(O1)=O)O)O)=O,,,4,1,1,0,1
9826_0,,,,2,2,1,3
C1(C(CC(C(CC(C)O)=O)O1)O)=O,,,4,1,1,0,1
9828_0,,,,2,2,1,3
C(CC(CC1CC(C(O1)=O)O)O)=O,,,4,1,1,0,1
9830_0,,,,2,2,1,3
C(C(C(C)O)C1CC(C(O1)=O)O)=O,,,4,1,2,0,2
9830_1,,,,2,2,1,3
9832_0,,,,2,2,1,3
C(CC1(CC(C(OCC1)=O)O)O)=O,,,4,1,1,0,1
9834_0,,,,2,2,1,3
C1(C(C(C)O)C(C(OCC1)=O)O)=O,,,4,1,2,0,2
9834_1,,,,2,2,1,3
9836_0,,,,2,2,1,3
C1(CC(C(OCC1C(C)O)=O)O)=O,,,4,1,2,0,2
9836_1,,,,2,2,1,3
9838_0,,,,2,2,1,3
C(CC1(COC(C(CC1)O)=O)O)=O,,,4,1,1,0,1
9840_0,,,,2,2,1,3
C1(C(CC(C(CO1)=O)C(C)O)O)=O,,,4,1,1,0,1
9842_0,,,,2,2,1,3
C1(C(CCC(C(C(C)O)O1)=O)O)=O,,,4,1,2,0,2
9842_1,,,,2,2,1,3
9844_0,,,,2,2,1,3
C(CC(C(CCC(CO)=O)O)O)=O,,,4,1,2,0,2
9846_0,,,,2,2,1,3
C(CC(CO)(CCC(C=O)O)O)=O,,,4,1,2,0,2
9848_0,,,,2,2,1,3
C(C(CC(C(CO)=O)C(C)O)O)=O,,,4,1,2,0,2
9850_0,,,,2,2,1,3
C(C(C(C)O)O)(CCC(C=O)O)=O,,,4,1,3,0,3
9850_1,,,,2,2,1,3
9852_0,,,,2,2,1,3
C(CC(C(CC(C(C)=O)O)O)O)=O,,,4,1,1,0,1
9854_0,,,,2,2,1,3
C(CC(C)(C(CC(C=O)O)O)O)=O,,,4,1,2,0,2
9856_0,,,,2,2,1,3
C(C(CC(C=O)O)O)(CC(C)O)=O,,,4,1,2,0,2
9858_0,,,,2,2,1,3
C(CC1(C(CO)=CC(C1O)O)O)=O,,,4,1,1,0,1
9860_0,,,,2,2,1,3
C(CC1(C(C(C(C1O)O)O)=C)O)=O,,,4,1,1,0,1
9862_0,,,,2,2,1,3
C(CC(C1C(C(C(C=1)O)O)O)O)=O,,,4,1,1,0,1
9864_0,,,,2,2,1,3
C(CC(C(C(C(C=C)O)O)O)O)=O,,,4,1,1,0,1
9866_0,,,,2,2,1,3
C(CC(C1(C=CC(C1O)O)O)O)=O,,,4,1,1,0,1
9868_0,,,,2,2,1,3
C(CC1(C=COC1C(CO)O)O)=O,,,4,1,1,0,1
9870_0,,,,2,2,1,3
C(CC1(C=CC(CO)OC1O)O)=O,,,4,1,1,0,1
9872_0,,,,2,2,1,3
C(CC1(C=COC(CO)C1O)O)=O,,,4,1,1,0,1
9874_0,,,,2,2,1,3
C(CC1(C=CC(O)OC1CO)O)=O,,,4,1,1,0,1
9876_0,,,,2,2,1,3
C(CC1(C=CC(COC1O)O)O)=O,,,4,1,1,0,1
9878_0,,,,2,2,1,3
C(CC1(C=COCC(C1O)O)O)=O,,,4,1,1,0,1
9880_0,,,,2,2,1,3
C(CC1(C=CCOC(C1O)O)O)=O,,,4,1,1,0,1
9882_0,,,,2,2,1,3
C(CC1(C=CC(O)OCC1O)O)=O,,,4,1,1,0,1
9884_0,,,,2,2,1,3
C(CC1(C=CC(C(O)OC1)O)O)=O,,,4,1,1,0,1
9886_0,,,,2,2,1,3
C1C(C(OC(C(C=1)=O)C(C)O)O)O,,,4,1,2,0,2
9886_1,,,,2,2,1,3
9888_0,,,,2,2,1,3
C(C(CC(C=C)(CC=O)O)O)(O)=O,,,4,1,2,0,2
9890_0,,,,2,2,1,3
C(C(C(C(C=C)=O)C(C)O)O)(O)=O,,,4,1,2,0,2
9890_1,,,,2,2,1,3
9892_0,,,,2,2,1,3
C(C(CC=CC(CC=O)O)O)(O)=O,,,4,1,2,0,2
9894_0,,,,2,2,1,3
C(CC(C(C(C=CCO)=O)=O)O)=O,,,4,1,1,0,1
9896_0,,,,2,2,1,3
C(C(C(C=CCO)=O)(CC=O)O)=O,,,4,1,1,0,1
9898_0,,,,2,2,1,3
C(CC(C=CCO)(C(C=O)=O)O)=O,,,4,1,2,0,2
9900_0,,,,2,2,1,3
C(CC(C(C(C(C=C)=O)O)=O)O)=O,,,4,1,1,0,1
9901_0,,,,2,2,1,3
9903_0,,,,2,2,1,3
C(CC(C=C)(C(C(C=O)=O)O)O)=O,,,4,1,2,0,2
9905_0,,,,2,2,1,3
C(CC(C(C=CC(CO)=O)=O)O)=O,,,4,1,1,0,1
9907_0,,,,2,2,1,3
C(C(C=CC(CO)=O)(CC=O)O)=O,,,4,1,1,0,1
9909_0,,,,2,2,1,3
C(CC(C=CC(C=O)=O)(CO)O)=O,,,4,1,2,0,2
9911_0,,,,2,2,1,3
C(C(C=CC(C(C(C)O)O)=O)=O)=O,,,4,1,3,0,3
9911_1,,,,2,2,1,3
9913_0,,,,2,2,1,3
C(CC(C(C(C=CC=O)O)=O)O)=O,,,4,1,1,0,1
9915_0,,,,2,2,1,3
C(CC(C=O)(C(C=CC=O)O)O)=O,,,4,1,2,0,2
9917_0,,,,2,2,1,3
C(CC(C=CC(C(C=O)=O)O)O)=O,,,4,1,2,0,2
9919_0,,,,2,2,1,3
C(CC(C1OC(CO)C(C=1)O)O)=O,,,4,1,1,0,1
9921_0,,,,2,2,1,3
C(CC(C1(C=CC(CO)O1)O)O)=O,,,4,1,1,0,1
9923_0,,,,2,2,1,3
C(CC(C=C1C(C(CO1)O)O)O)=O,,,4,1,1,0,1
9925_0,,,,2,2,1,3
C(CC(C(C1OCC(C=1)O)O)O)=O,,,4,1,1,0,1
9927_0,,,,2,2,1,3
C(CC(C(C1(C=CCO1)O)O)O)=O,,,4,1,1,0,1
9929_0,,,,2,2,1,3
C(CC(C1C=CC(CO)(O1)O)O)=O,,,4,1,1,0,1
9931_0,,,,2,2,1,3
C(CC(C1C(C=C(CO)O1)O)O)=O,,,4,1,1,0,1
9933_0,,,,2,2,1,3
C(CC(C1C(C(C(O1)=C)O)O)O)=O,,,4,1,1,0,1
9935_0,,,,2,2,1,3
C(CC(C(C1C=CC(O1)O)O)O)=O,,,4,1,1,0,1
9937_0,,,,2,2,1,3
C(CC(C(C1C(C=CO1)O)O)O)=O,,,4,1,1,0,1
9939_0,,,,2,2,1,3
C(CC(C1OCC(C(C=1)O)O)O)=O,,,4,1,1,0,1
9941_0,,,,2,2,1,3
C(CC(C1(C=CC(CO1)O)O)O)=O,,,4,1,1,0,1
9943_0,,,,2,2,1,3
C(CC(C1C(C=CC(O)O1)O)O)=O,,,4,1,1,0,1
9945_0,,,,2,2,1,3
C(CC(C1C(C(C=CO1)O)O)O)=O,,,4,1,1,0,1
9947_0,,,,2,2,1,3
C(CC(C(C=CC(CO)O)O)O)=O,,,4,1,1,0,1
9949_0,,,,2,2,1,3
C(CC1(C(O)OCC1O)O)=O,,,4,1,3,0,3
9950_0,,,,2,2,1,3
9950_1,,,,2,2,1,3
9951_0,,,,2,2,1,3
9951_1,,,,2,2,1,3
9952_0,,,,2,2,1,3
9952_1,,,,2,2,1,3
9954_0,,,,2,2,1,3
C(C(C(C(CC(C)O)O)O)=O)=O,,,4,1,2,0,2
9954_1,,,,2,2,1,3
9955_0,,,,2,2,1,3
9955_1,,,,2,2,1,3
9956_0,,,,2,2,1,3
9956_1,,,,2,2,1,3
9958_0,,,,2,2,1,3
C(C(C(C(C(C(C)O)O)O)O)=O)=O,,,4,1,2,0,2
9958_1,,,,2,2,1,3
9960_0,,,,2,2,1,3
C(C(C(C(CC(CO)O)O)O)=O)=O,,,4,1,3,0,3
9960_1,,,,2,2,1,3
9961_0,,,,2,2,1,3
9961_1,,,,2,2,1,3
9962_0,,,,2,2,1,3
9962_1,,,,2,2,1,3
9963_0,,,,2,2,1,3
9963_1,,,,2,2,1,3
9965_0,,,,2,2,1,3
C(CO)(C(C)(C(C(C=O)=O)O)O)=O,,,4,1,4,0,4
9965_1,,,,2,2,1,3
9966_0,,,,2,2,1,3
9966_1,,,,2,2,1,3
9968_0,,,,2,2,1,3
C(C(CO)(C(C(C(C)=O)=O)O)O)=O,,,4,1,4,0,4
9968_1,,,,2,2,1,3
9970_0,,,,2,2,1,3
C(CO)(C(CC(C(CO)=O)=O)O)=O,,,4,1,2,0,2
9972_0,,,,2,2,1,3
C(C(CO)(CC(C(CO)=O)=O)O)=O,,,4,1,2,0,2
9973_0,,,,2,2,1,3
9973_1,,,,2,2,1,3
9975_0,,,,2,2,1,3
C(C(C(C)O)(C(C(C=O)=O)O)O)=O,,,4,1,6,0,6
9975_1,,,,2,2,1,3
9977_0,,,,2,2,1,3
C(C(C(C(CO)(C(C)O)O)O)=O)=O,,,4,1,2,0,2
9977_1,,,,2,2,1,3
9978_0,,,,2,2,1,3
9978_1,,,,2,2,1,3
9979_0,,,,2,2,1,3
9979_1,,,,2,2,1,3
9980_0,,,,2,2,1,3
9980_1,,,,2,2,1,3
9982_0,,,,2,2,1,3
C(C(C=O)C(C(CO)=O)O)=O,,,4,1,5,0,5
9982_1,,,,2,2,1,3
9984_0,,,,2,2,1,3
C(C(C=O)C(C=O)(CO)O)=O,,,4,1,3,0,3
9984_1,,,,2,2,1,3
9986_0,,,,2,2,1,3
C(C(C(C(C(CCO)O)O)O)=O)=O,,,4,1,3,0,3
9986_1,,,,2,2,1,3
9988_0,,,,2,2,1,3
C(C(C)(C(C(C=O)=O)O)O)(O)=O,,,4,1,4,0,4
9988_1,,,,2,2,1,3
9990_0,,,,2,2,1,3
C(CO)(C(CC(C(O)=O)=O)O)=O,,,4,1,4,0,4
9992_0,,,,2,2,1,3
C(C(CO)(CC(C(O)=O)=O)O)=O,,,4,1,2,0,2
9994_0,,,,2,2,1,3
C(C(C(C=O)=O)O)(O)=O,,,4,1,5,0,5
9994_1,,,,2,2,1,3
9996_0,,,,2,2,1,3
C(C(C(C(C=O)=O)O)O)(O)=O,,,4,1,6,0,6
9996_1,,,,2,2,1,3
9998_0,,,,2,2,1,3
C(C(C(C(C(C=O)=O)O)O)O)(O)=O,,,4,1,6,0,6
9998_1,,,,2,2,1,3
10000_0,,,,2,2,1,3
C(C(CO)(C(C(C=O)=O)O)O)(O)=O,,,4,1,5,0,5
10000_1,,,,2,2,1,3
10002_0,,,,2,2,1,3
C(CO)(C(C(C(C(O)=O)=O)O)O)=O,,,4,1,3,0,3
10002_1,,,,2,2,1,3
10004_0,,,,2,2,1,3
C(C(CO)(C(C(C(O)=O)=O)O)O)=O,,,4,1,3,0,3
10004_1,,,,2,2,1,3
10005_0,,,,2,2,1,3
10005_1,,,,2,2,1,3
10007_0,,,,2,2,1,3
C(CC(C=O)(C(C(C=O)=O)O)O)=O,,,4,1,4,0,4
10007_1,,,,2,2,1,3
10008_0,,,,2,2,1,3
10008_1,,,,2,2,1,3
10010_0,,,,2,2,1,3
C(C(C(C=O)=O)C(C(CO)=O)O)=O,,,4,1,3,0,3
10010_1,,,,2,2,1,3
10012_0,,,,2,2,1,3
C(C(C(C=O)=O)C(C=O)(CO)O)=O,,,4,1,3,0,3
10012_1,,,,2,2,1,3
10014_0,,,,2,2,1,3
C(C)(C(C)(C(C(C=O)=O)O)O)=O,,,4,1,3,0,3
10014_1,,,,2,2,1,3
10016_0,,,,2,2,1,3
C(CO)(C(CC(C(C)=O)=O)O)=O,,,4,1,3,0,3
10017_0,,,,2,2,1,3
10018_0,,,,2,2,1,3
10018_1,,,,2,2,1,3
10020_0,,,,2,2,1,3
C(C)(CC(C(C(C=O)=O)O)O)=O,,,4,1,2,0,2
10020_1,,,,2,2,1,3
10022_0,,,,2,2,1,3
C(CC(CC(C(CO)=O)O)=O)=O,,,4,1,4,0,4
10023_0,,,,2,2,1,3
10025_0,,,,2,2,1,3
C(C(C(C)=O)C(C(CO)=O)O)=O,,,4,1,3,0,3
10025_1,,,,2,2,1,3
10027_0,,,,2,2,1,3
C(C(CO)(C(C=O)C(C)=O)O)=O,,,4,1,3,0,3
10027_1,,,,2,2,1,3
10029_0,,,,2,2,1,3
C(C(C(C1(COC(C1)O)O)O)=O)=O,,,4,1,3,0,3
10029_1,,,,2,2,1,3
10031_0,,,,2,2,1,3
C1(COC(C1C(C(CO)=O)O)O)=O,,,4,1,3,0,3
10031_1,,,,2,2,1,3
10033_0,,,,2,2,1,3
C(C(CO)(C1C(COC1O)=O)O)=O,,,4,1,3,0,3
10033_1,,,,2,2,1,3
10035_0,,,,2,2,1,3
C(C(C1C(CC(O1)O)=O)O)(CO)=O,,,4,1,3,0,3
10035_1,,,,2,2,1,3
10037_0,,,,2,2,1,3
C(C(CO)(C1C(CC(O1)O)=O)O)=O,,,4,1,3,0,3
10037_1,,,,2,2,1,3
10039_0,,,,2,2,1,3
C(C(C(C(C)(CCO)O)O)=O)=O,,,4,1,2,0,2
10039_1,,,,2,2,1,3
10041_0,,,,2,2,1,3
C(CC(C(CO)=O)O)(CCO)=O,,,4,1,1,0,1
10043_0,,,,2,2,1,3
C(C(CO)(CC(CCO)=O)O)=O,,,4,1,5,0,5
10045_0,,,,2,2,1,3
C(C)(C(CO)C(C(CO)=O)O)=O,,,4,1,2,0,2
10045_1,,,,2,2,1,3
10047_0,,,,2,2,1,3
C(C(CO)(C(C(C)=O)CO)O)=O,,,4,1,2,0,2
10047_1,,,,2,2,1,3
10048_0,,,,2,2,1,3
10048_1,,,,2,2,1,3
10050_0,,,,2,2,1,3
C(C(C(C)=O)(C(C(C=O)=O)O)O)=O,,,4,1,5,0,5
10050_1,,,,2,2,1,3
10052_0,,,,2,2,1,3
C(C=O)(C(C)(C(C(C=O)=O)O)O)=O,,,4,1,4,0,4
10052_1,,,,2,2,1,3
10054_0,,,,2,2,1,3
C(CO)(C(CC(C(C=O)=O)=O)O)=O,,,4,1,1,0,1
10056_0,,,,2,2,1,3
C(C(CO)(CC(C(C=O)=O)=O)O)=O,,,4,1,1,0,1
10058_0,,,,2,2,1,3
C(C(C(C(C(C=O)=O)O)O)=O)=O,,,4,1,3,0,3
10058_1,,,,2,2,1,3
10060_0,,,,2,2,1,3
C(C(C=O)(C(C(C=O)=O)O)O)=O,,,4,1,5,0,5
10060_1,,,,2,2,1,3
10061_0,,,,2,2,1,3
10061_1,,,,2,2,1,3
10063_0,,,,2,2,1,3
C(C(C=C)(C(C(C=O)=O)O)O)=O,,,4,1,3,0,3
10063_1,,,,2,2,1,3
10065_0,,,,2,2,1,3
C(C(CO)(C(C(C=O)=O)O)O)=C,,,4,1,3,0,3
10065_1,,,,2,2,1,3
10066_0,,,,2,2,1,3
10066_1,,,,2,2,1,3
10067_0,,,,2,2,1,3
10067_1,,,,2,2,1,3
10069_0,,,,2,2,1,3
C(C(C(C(C=O)=O)O)O)=CC=O,,,4,1,4,0,4
10069_1,,,,2,2,1,3
10071_0,,,,2,2,1,3
C(C(C(C(C(C)O)O)O)=O)=O,,,4,1,5,0,5
10071_1,,,,2,2,1,3
10073_0,,,,2,2,1,3
C(C(C(C1(COCC1O)O)O)=O)=O,,,4,1,2,0,2
10073_1,,,,2,2,1,3
10075_0,,,,2,2,1,3
C(C(C1C(C(CO1)O)=O)O)(CO)=O,,,4,1,2,0,2
10075_1,,,,2,2,1,3
10077_0,,,,2,2,1,3
C(C(CO)(C1C(C(CO1)O)=O)O)=O,,,4,1,2,0,2
10077_1,,,,2,2,1,3
10079_0,,,,2,2,1,3
C(C(C(C1(C(O)OCC1)O)O)=O)=O,,,4,1,3,0,3
10079_1,,,,2,2,1,3
10081_0,,,,2,2,1,3
C(C(C1C(C(O)OC1)=O)O)(CO)=O,,,4,1,3,0,3
10081_1,,,,2,2,1,3
10083_0,,,,2,2,1,3
C(C(CO)(C1C(C(O)OC1)=O)O)=O,,,4,1,3,0,3
10083_1,,,,2,2,1,3
10084_0,,,,2,2,1,3
10084_1,,,,2,2,1,3
10085_0,,,,2,2,1,3
10085_1,,,,2,2,1,3
10086_0,,,,2,2,1,3
10086_1,,,,2,2,1,3
10088_0,,,,2,2,1,3
C(C(C=O)C(CO)(C(CO)O)O)=O,,,4,1,2,0,2
10088_1,,,,2,2,1,3
10090_0,,,,2,2,1,3
C(C(C(C(CO)O)=O)O)(O)=O,,,4,1,3,0,3
10090_1,,,,2,2,1,3
10091_0,,,,2,2,1,3
10091_1,,,,2,2,1,3
10093_0,,,,2,2,1,3
C(C(C(C(C)O)O)O)(C(CO)O)=O,,,4,1,2,0,2
10093_1,,,,2,2,1,3
10095_0,,,,2,2,1,3
C(C(C(CCO)=O)C(C=O)=O)(O)=O,,,4,1,2,0,2
10095_1,,,,2,2,1,3
10097_0,,,,2,2,1,3
C(C(C(CC(C=O)=O)=O)CO)(O)=O,,,4,1,2,0,2
10097_1,,,,2,2,1,3
10099_0,,,,2,2,1,3
C(C(C(C=O)=O)CC(CO)=O)(O)=O,,,4,1,1,0,1
10101_0,,,,2,2,1,3
C(C(C(CO)=O)CC(C=O)=O)(O)=O,,,4,1,1,0,1
10103_0,,,,2,2,1,3
C(C(C(CCC(C=O)=O)=O)O)(O)=O,,,4,1,2,0,2
10103_1,,,,2,2,1,3
10105_0,,,,2,2,1,3
C(C(C(C=O)=O)C(C(C)=O)O)(O)=O,,,4,1,2,0,2
10105_1,,,,2,2,1,3
10107_0,,,,2,2,1,3
C(CC(C(CC(C=O)=O)O)=O)(O)=O,,,4,1,1,0,1
10109_0,,,,2,2,1,3
C(C(C(C=O)=O)C(CC=O)O)(O)=O,,,4,1,2,0,2
10109_1,,,,2,2,1,3
10111_0,,,,2,2,1,3
C(C(C=O)C(CC(C=O)=O)O)(O)=O,,,4,1,2,0,2
10111_1,,,,2,2,1,3
10113_0,,,,2,2,1,3
C(C(C=O)C(C(CCO)=O)=O)(O)=O,,,4,1,2,0,2
10113_1,,,,2,2,1,3
10115_0,,,,2,2,1,3
C(C(C(C(CC=O)=O)=O)CO)(O)=O,,,4,1,2,0,2
10115_1,,,,2,2,1,3
10117_0,,,,2,2,1,3
C(C(C=O)C(CC(CO)=O)=O)(O)=O,,,4,1,2,0,2
10117_1,,,,2,2,1,3
10119_0,,,,2,2,1,3
C(C(C(CC=O)=O)C(CO)=O)(O)=O,,,4,1,2,0,2
10119_1,,,,2,2,1,3
10121_0,,,,2,2,1,3
C(C(C(CC(CC=O)=O)=O)O)(O)=O,,,4,1,2,0,2
10121_1,,,,2,2,1,3
10123_0,,,,2,2,1,3
C(C(C=O)C(C(C(C)=O)O)=O)(O)=O,,,4,1,2,0,2
10123_1,,,,2,2,1,3
10125_0,,,,2,2,1,3
C(CC(C(C(CC=O)=O)O)=O)(O)=O,,,4,1,1,0,1
10127_0,,,,2,2,1,3
C(C(C=O)C(C(CC=O)O)=O)(O)=O,,,4,1,2,0,2
10127_1,,,,2,2,1,3
10129_0,,,,2,2,1,3
C(C(C=O)C(C(CC=O)=O)O)(O)=O,,,4,1,2,0,2
10129_1,,,,2,2,1,3
10131_0,,,,2,2,1,3
C(C(C(C(C=O)O)=O)C(C)=O)(O)=O,,,4,1,2,0,2
10131_1,,,,2,2,1,3
10133_0,,,,2,2,1,3
C(CC(CC(C(C=O)O)=O)=O)(O)=O,,,4,1,1,0,1
10135_0,,,,2,2,1,3
C(C(C(C(C=O)O)=O)CC=O)(O)=O,,,4,1,1,0,1
10137_0,,,,2,2,1,3
C(C(C=O)CC(C(C=O)O)=O)(O)=O,,,4,1,1,0,1
10139_0,,,,2,2,1,3
C(C(C(C(C)=O)=O)C(C=O)O)(O)=O,,,4,1,2,0,2
10139_1,,,,2,2,1,3
10141_0,,,,2,2,1,3
C(CC(C(CC(C=O)O)=O)=O)(O)=O,,,4,1,1,0,1
10143_0,,,,2,2,1,3
C(C(C(CC=O)=O)C(C=O)O)(O)=O,,,4,1,2,0,2
10143_1,,,,2,2,1,3
10145_0,,,,2,2,1,3
C(C(C=O)C(CC(C=O)O)=O)(O)=O,,,4,1,2,0,2
10145_1,,,,2,2,1,3
10147_0,,,,2,2,1,3
C(C(C(C=CC(C=O)O)=O)O)(O)=O,,,4,1,2,0,2
10147_1,,,,2,2,1,3
10148_0,,,,2,2,1,3
10148_1,,,,2,2,1,3
10149_0,,,,2,2,1,3
10149_1,,,,2,2,1,3
10151_0,,,,2,2,1,3
C(C(C=O)C(C(C(CO)O)=O)O)=O,,,4,1,2,0,2
10151_1,,,,2,2,1,3
10153_0,,,,2,2,1,3
C(C(C=O)C(C=O)(C(CO)O)O)=O,,,4,1,2,0,2
10153_1,,,,2,2,1,3
10155_0,,,,2,2,1,3
C(C1(CC(C(C1)O)O)O)(O)=O,,,4,1,1,0,1
10157_0,,,,2,2,1,3
C(C(CC(CO)(CO)O)O)(O)=O,,,4,1,2,0,2
10157_1,,,,2,2,1,3
10159_0,,,,2,2,1,3
C(C(C(C(CO)(CO)O)O)O)(O)=O,,,4,1,3,0,3
10159_1,,,,2,2,1,3
10161_0,,,,2,2,1,3
C(C(C)(CC(C(O)=O)O)O)=O,,,4,1,2,0,2
10161_1,,,,2,2,1,3
10162_0,,,,2,2,1,3
10162_1,,,,2,2,1,3
10163_0,,,,2,2,1,3
10163_1,,,,2,2,1,3
10164_0,,,,2,2,1,3
10164_1,,,,2,2,1,3
10165_0,,,,2,2,1,3
10165_1,,,,2,2,1,3
10167_0,,,,2,2,1,3
C(C(CC(C=O)O)O)(O)=O,,,4,1,6,0,6
10167_1,,,,2,2,1,3
10169_0,,,,2,2,1,3
C(C(CC(C)(C(CO)O)O)O)(O)=O,,,4,1,2,0,2
10169_1,,,,2,2,1,3
10170_0,,,,2,2,1,3
10170_1,,,,2,2,1,3
10172_0,,,,2,2,1,3
C(C(CC(C(O)=O)O)(CCO)O)=O,,,4,1,2,0,2
10172_1,,,,2,2,1,3
10174_0,,,,2,2,1,3
C(C(C(CO)C(C(C)=O)O)O)(O)=O,,,4,1,2,0,2
10174_1,,,,2,2,1,3
10176_0,,,,2,2,1,3
C(C(C)(C(CO)C(C(O)=O)O)O)=O,,,4,1,2,0,2
10176_1,,,,2,2,1,3
10178_0,,,,2,2,1,3
C(C(CC(CO)(CCO)O)O)(O)=O,,,4,1,2,0,2
10178_1,,,,2,2,1,3
10179_0,,,,2,2,1,3
10179_1,,,,2,2,1,3
10181_0,,,,2,2,1,3
C(C(CC(CO)(C)O)O)(O)=O,,,4,1,2,0,2
10181_1,,,,2,2,1,3
10183_0,,,,2,2,1,3
C(CC(C(CC(C(O)=O)O)O)O)=O,,,4,1,2,0,2
10183_1,,,,2,2,1,3
10185_0,,,,2,2,1,3
C(C(CC(CC(C=O)O)O)O)(O)=O,,,4,1,2,0,2
10185_1,,,,2,2,1,3
10187_0,,,,2,2,1,3
C(C(CC(C)O)O)(O)=O,,,4,1,2,0,2
10187_1,,,,2,2,1,3
10188_0,,,,2,2,1,3
10188_1,,,,2,2,1,3
10190_0,,,,2,2,1,3
C(C(CO)(CC(C(O)=O)O)O)=O,,,4,1,3,0,3
10190_1,,,,2,2,1,3
10192_0,,,,2,2,1,3
C(C(C)(C(C(C(O)=O)O)O)O)=O,,,4,1,3,0,3
10192_1,,,,2,2,1,3
10194_0,,,,2,2,1,3
C(C(C(CO)C(C=O)O)O)(O)=O,,,4,1,2,0,2
10194_1,,,,2,2,1,3
10195_0,,,,2,2,1,3
10195_1,,,,2,2,1,3
10197_0,,,,2,2,1,3
C(C(C(CO)CO)O)(O)=O,,,4,1,2,0,2
10197_1,,,,2,2,1,3
10198_0,,,,2,2,1,3
10198_1,,,,2,2,1,3
10199_0,,,,2,2,1,3
10199_1,,,,2,2,1,3
10201_0,,,,2,2,1,3
C(C(C(CO)CC(CO)=O)O)(O)=O,,,4,1,3,0,3
10201_1,,,,2,2,1,3
10202_0,,,,2,2,1,3
10202_1,,,,2,2,1,3
10203_0,,,,2,2,1,3
10203_1,,,,2,2,1,3
10205_0,,,,2,2,1,3
C(CC(C(CO)C(C(O)=O)O)O)=O,,,4,1,2,0,2
10205_1,,,,2,2,1,3
10206_0,,,,2,2,1,3
10206_1,,,,2,2,1,3
10207_0,,,,2,2,1,3
10209_0,,,,2,2,1,3
C(C(C(CO)CO)(CC=O)O)(O)=O,,,4,1,1,0,1
10211_0,,,,2,2,1,3
C(C(C)(C(CO)C(C=O)O)O)(O)=O,,,4,1,1,0,1
10213_0,,,,2,2,1,3
C(C(CC(C=O)O)(CCO)O)(O)=O,,,4,1,1,0,1
10215_0,,,,2,2,1,3
C(C(C(CO)C(CO)(C)O)O)(O)=O,,,4,1,2,0,2
10215_1,,,,2,2,1,3
10217_0,,,,2,2,1,3
C(C(C(CO)C(C)O)O)(O)=O,,,4,1,2,0,2
10217_1,,,,2,2,1,3
10218_0,,,,2,2,1,3
10218_1,,,,2,2,1,3
10220_0,,,,2,2,1,3
C(C(C(C(CO)(C)O)O)O)(O)=O,,,4,1,2,0,2
10220_1,,,,2,2,1,3
10222_0,,,,2,2,1,3
C(C(C(C(C)O)O)O)(O)=O,,,4,1,4,0,4
10222_1,,,,2,2,1,3
10223_0,,,,2,2,1,3
10223_1,,,,2,2,1,3
10225_0,,,,2,2,1,3
C(C(CO)(C(C(C(O)=O)O)O)O)=O,,,4,1,9,0,9
10225_1,,,,2,2,1,3
10227_0,,,,2,2,1,3
C(C(CC(CO)O)O)(O)=O,,,4,1,5,0,5
10227_1,,,,2,2,1,3
10229_0,,,,2,2,1,3
C(C(C(CO)C(CO)O)O)(O)=O,,,4,1,2,0,2
10229_1,,,,2,2,1,3
10230_0,,,,2,2,1,3
10230_1,,,,2,2,1,3
10232_0,,,,2,2,1,3
C(C(CO)(C)O)(O)=O,,,4,1,2,0,2
10233_0,,,,2,2,1,3
10233_1,,,,2,2,1,3
10234_0,,,,2,2,1,3
10234_1,,,,2,2,1,3
10235_0,,,,2,2,1,3
10235_1,,,,2,2,1,3
10236_0,,,,2,2,1,3
10238_0,,,,2,2,1,3
C(C(C)(C)O)(O)=O,,,4,1,1,0,1
10239_0,,,,2,2,1,3
10239_1,,,,2,2,1,3
10241_0,,,,2,2,1,3
C(C(C=O)(C)O)(O)=O,,,4,1,2,0,2
10242_0,,,,2,2,1,3
10242_1,,,,2,2,1,3
10243_0,,,,2,2,1,3
10243_1,,,,2,2,1,3
10244_0,,,,2,2,1,3
10244_1,,,,2,2,1,3
10245_0,,,,2,2,1,3
10245_1,,,,2,2,1,3
10246_0,,,,2,2,1,3
10246_1,,,,2,2,1,3
10247_0,,,,2,2,1,3
10249_0,,,,2,2,1,3
C(C(CO)(C(CCO)O)O)(O)=O,,,4,1,3,0,3
10250_0,,,,2,2,1,3
10250_1,,,,2,2,1,3
10252_0,,,,2,2,1,3
C(C(CO)(C(C(CO)O)O)O)(O)=O,,,4,1,6,0,6
10253_0,,,,2,2,1,3
10253_1,,,,2,2,1,3
10254_0,,,,2,2,1,3
10254_1,,,,2,2,1,3
10256_0,,,,2,2,1,3
C(C(C)(C(CC=O)O)O)(O)=O,,,4,1,2,0,2
10258_0,,,,2,2,1,3
C(C(C(C)O)(CC=O)O)(O)=O,,,4,1,4,0,4
10260_0,,,,2,2,1,3
C(C(CO)(CC(C)=O)O)(O)=O,,,4,1,4,0,4
10262_0,,,,2,2,1,3
C(C(C(CC(C)=O)O)O)(O)=O,,,4,1,5,0,5
10262_1,,,,2,2,1,3
10264_0,,,,2,2,1,3
C(C(CO)(CCC=O)O)(O)=O,,,4,1,2,0,2
10266_0,,,,2,2,1,3
C(CCC(C(C(O)=O)O)O)=O,,,4,1,4,0,4
10266_1,,,,2,2,1,3
10267_0,,,,2,2,1,3
10268_0,,,,2,2,1,3
10269_0,,,,2,2,1,3
10269_1,,,,2,2,1,3
10271_0,,,,2,2,1,3
C(C(C=O)(C(CCO)O)O)(O)=O,,,4,1,3,0,3
10272_0,,,,2,2,1,3
10272_1,,,,2,2,1,3
10273_0,,,,2,2,1,3
10273_1,,,,2,2,1,3
10275_0,,,,2,2,1,3
C(C(C=CCO)(CO)O)(O)=O,,,4,1,2,0,2
10277_0,,,,2,2,1,3
C(C(C(C=CCO)O)O)(O)=O,,,4,1,7,0,7
10277_1,,,,2,2,1,3
10278_0,,,,2,2,1,3
10278_1,,,,2,2,1,3
10280_0,,,,2,2,1,3
C(C(CCO)(CCO)O)(O)=O,,,4,1,2,0,2
10282_0,,,,2,2,1,3
C(C(C)(CC(CO)O)O)(O)=O,,,4,1,2,0,2
10283_0,,,,2,2,1,3
10283_1,,,,2,2,1,3
10285_0,,,,2,2,1,3
C(C(CCO)(CC(O)=O)O)(O)=O,,,4,1,2,0,2
10287_0,,,,2,2,1,3
C(C(C)(CC(C(O)=O)O)O)(O)=O,,,4,1,3,0,3
10289_0,,,,2,2,1,3
C(C(C(O)=O)(CC(CO)O)O)(O)=O,,,4,1,2,0,2
10290_0,,,,2,2,1,3
10290_1,,,,2,2,1,3
10292_0,,,,2,2,1,3
C(C(C(CO)(C(C=O)O)O)O)(O)=O,,,4,1,3,0,3
10292_1,,,,2,2,1,3
10293_0,,,,2,2,1,3
10293_1,,,,2,2,1,3
10295_0,,,,2,2,1,3
C(C(C(CO)(C(C)O)O)O)(O)=O,,,4,1,3,0,3
10295_1,,,,2,2,1,3
10296_0,,,,2,2,1,3
10296_1,,,,2,2,1,3
10297_0,,,,2,2,1,3
10297_1,,,,2,2,1,3
10299_0,,,,2,2,1,3
C(C(C)(CC(C=O)(CO)O)O)(O)=O,,,4,1,2,0,2
10301_0,,,,2,2,1,3
C(C(C)(C(C(CO)O)O)O)(O)=O,,,4,1,2,0,2
10303_0,,,,2,2,1,3
C(C1(COC(CO)C1)O)(O)=O,,,4,1,1,0,1
10305_0,,,,2,2,1,3
C(C1(COCC(C1)O)O)(O)=O,,,4,1,1,0,1
10307_0,,,,2,2,1,3
C(C1(CC(O)OCC1)O)(O)=O,,,4,1,2,0,2
10308_0,,,,2,2,1,3
10308_1,,,,2,2,1,3
10310_0,,,,2,2,1,3
C(C(C=O)(CC(C)=O)O)(O)=O,,,4,1,2,0,2
10311_0,,,,2,2,1,3
10311_1,,,,2,2,1,3
10313_0,,,,2,2,1,3
C(C(C=O)(CCC=O)O)(O)=O,,,4,1,2,0,2
10314_0,,,,2,2,1,3
10314_1,,,,2,2,1,3
10315_0,,,,2,2,1,3
10316_0,,,,2,2,1,3
10316_1,,,,2,2,1,3
10317_0,,,,2,2,1,3
10317_1,,,,2,2,1,3
10318_0,,,,2,2,1,3
10318_1,,,,2,2,1,3
10320_0,,,,2,2,1,3
C(C(C=CC=O)(C)O)(O)=O,,,4,1,2,0,2
10321_0,,,,2,2,1,3
10321_1,,,,2,2,1,3
10323_0,,,,2,2,1,3
C(C(C=C)(CC=O)O)(O)=O,,,4,1,2,0,2
10324_0,,,,2,2,1,3
10324_1,,,,2,2,1,3
10326_0,,,,2,2,1,3
C(C(C1CC(CO1)O)O)(O)=O,,,4,1,2,0,2
10326_1,,,,2,2,1,3
10328_0,,,,2,2,1,3
C(C1(C(O)OC(CO)C1)O)(O)=O,,,4,1,2,0,2
10330_0,,,,2,2,1,3
C(C1(C(O)OCC(C1)O)O)(O)=O,,,4,1,2,0,2
10331_0,,,,2,2,1,3
10331_1,,,,2,2,1,3
10333_0,,,,2,2,1,3
C(C(C=O)(C=CCO)O)(O)=O,,,4,1,2,0,2
10334_0,,,,2,2,1,3
10334_1,,,,2,2,1,3
10335_0,,,,2,2,1,3
10335_1,,,,2,2,1,3
10336_0,,,,2,2,1,3
10336_1,,,,2,2,1,3
10337_0,,,,2,2,1,3
10337_1,,,,2,2,1,3
10338_0,,,,2,2,1,3
10338_1,,,,2,2,1,3
10339_0,,,,2,1,2,3
10340_0,,,,2,1,2,3
10341_0,,,,2,1,2,3
10342_0,,,,2,1,2,3
10343_0,,,,2,1,2,3
10344_0,,,,2,1,2,3
10345_0,,,,2,1,2,3
10346_0,,,,2,1,2,3
10347_0,,,,2,1,2,3
10348_0,,,,2,1,2,3
10349_0,,,,2,1,2,3
10350_0,,,,2,1,2,3
10351_0,,,,2,1,2,3
10352_0,,,,2,1,2,3
10353_0,,,,2,1,2,3
10354_0,,,,2,1,2,3
10355_0,,,,2,1,2,3
10356_0,,,,2,1,2,3
10357_0,,,,2,1,2,3
10358_0,,,,2,1,2,3
10359_0,,,,2,1,2,3
10360_0,,,,2,1,2,3
10361_0,,,,2,1,2,3
10362_0,,,,2,1,2,3
10364_0,,,,2,1,2,3
C(C(C(C(C(CO)O)O)=O)=O)=O,,,4,1,1,0,1
10365_0,,,,2,1,2,3
10366_0,,,,2,1,2,3
10367_0,,,,2,1,2,3
10368_0,,,,2,1,2,3
10369_0,,,,2,1,2,3
10370_0,,,,2,1,2,3
10372_0,,,,2,1,2,3
C1(C(C(CC(C1O)O)O)=O)=O,,,4,1,1,0,1
10374_0,,,,2,1,2,3
C(C(C(CO)O)=O)(C(CO)O)=O,,,4,1,1,0,1
10375_0,,,,2,1,2,3
10376_0,,,,2,1,2,3
10377_0,,,,2,1,2,3
10378_0,,,,2,1,2,3
10379_0,,,,2,1,2,3
10380_0,,,,2,1,2,3
10381_0,,,,2,1,2,3
10382_0,,,,2,1,2,3
10383_0,,,,2,1,2,3
10384_0,,,,2,1,2,3
10385_0,,,,2,1,2,3
10386_0,,,,2,1,2,3
10387_0,,,,2,1,2,3
10388_0,,,,2,1,2,3
10389_0,,,,2,1,2,3
10391_0,,,,2,1,2,3
C(C(C(C(C(CO)O)=O)=O)O)=O,,,4,1,1,0,1
10393_0,,,,2,1,2,3
C(C(CO)=O)(C(CO)O)=O,,,4,1,2,0,2
10395_0,,,,2,1,2,3
C(C(C(C)O)=O)(C(CO)O)=O,,,4,1,4,0,4
10396_0,,,,2,1,2,3
10397_0,,,,2,1,2,3
10398_0,,,,2,1,2,3
10400_0,,,,2,1,2,3
C(C(C(C=O)=O)(C)O)=O,,,4,1,5,0,5
10402_0,,,,2,1,2,3
C(C)(C(C(C(CCO)=O)=O)O)=O,,,4,1,1,0,1
10404_0,,,,2,1,2,3
C(C(C(C(CCO)=O)=O)(C)O)=O,,,4,1,1,0,1
10406_0,,,,2,1,2,3
C(CC(C(C=O)=O)(CO)O)=O,,,4,1,3,0,3
10407_0,,,,2,1,2,3
10408_0,,,,2,1,2,3
10410_0,,,,2,1,2,3
C(C(C(C)(C(CO)O)O)=O)=O,,,4,1,3,0,3
10411_0,,,,2,1,2,3
10413_0,,,,2,1,2,3
C(CO)(CCC(C(CO)=O)=O)=O,,,4,1,2,0,2
10414_0,,,,2,1,2,3
10415_0,,,,2,1,2,3
10416_0,,,,2,1,2,3
10418_0,,,,2,1,2,3
C(C(CO)O)=CC(C(CO)=O)=O,,,4,1,1,0,1
10419_0,,,,2,1,2,3
10421_0,,,,2,1,2,3
C(C(C(C=O)=O)(CCO)O)=O,,,4,1,2,0,2
10423_0,,,,2,1,2,3
C(C(C(CO)(CCO)O)=O)=O,,,4,1,2,0,2
10424_0,,,,2,1,2,3
10426_0,,,,2,1,2,3
C(C(C(CO)(C)O)=O)=O,,,4,1,8,0,8
10428_0,,,,2,1,2,3
C(C(CCO)=O)(C(CO)(C)O)=O,,,4,1,1,0,1
10429_0,,,,2,1,2,3
10430_0,,,,2,1,2,3
10432_0,,,,2,1,2,3
C(C(C(C)O)=O)(CCO)=O,,,4,1,4,0,4
10434_0,,,,2,1,2,3
C(CO)(C(C(C=O)=O)O)=O,,,4,1,5,0,5
10436_0,,,,2,1,2,3
C(C(C(C=O)=O)(CO)O)=O,,,4,1,6,0,6
10437_0,,,,2,1,2,3
10439_0,,,,2,1,2,3
C(C(CO)O)(C(C(C=O)=O)O)=O,,,4,1,3,0,3
10441_0,,,,2,1,2,3
C(C(C(C=O)=O)(C(CO)O)O)=O,,,4,1,4,0,4
10442_0,,,,2,1,2,3
10443_0,,,,2,1,2,3
10444_0,,,,2,1,2,3
10445_0,,,,2,1,2,3
10446_0,,,,2,1,2,3
10447_0,,,,2,1,2,3
10448_0,,,,2,1,1,2
10449_0,,,,2,1,1,2
10449_1,,,,2,1,1,2
10450_0,,,,2,1,1,2
10450_1,,,,2,1,1,2
10451_0,,,,2,1,1,2
10452_0,,,,2,1,1,2
10452_1,,,,2,1,1,2
10453_0,,,,2,1,1,2
10453_1,,,,2,1,1,2
10454_0,,,,2,1,1,2
10454_1,,,,2,1,1,2
10455_0,,,,2,1,1,2
10456_0,,,,2,1,1,2
10456_1,,,,2,1,1,2
10457_0,,,,2,1,1,2
10457_1,,,,2,1,1,2
10458_0,,,,2,1,1,2
10458_1,,,,2,1,1,2
10459_0,,,,2,1,1,2
10459_1,,,,2,1,1,2
10460_0,,,,2,1,2,3
10460_1,,,,2,1,2,3
10461_0,,,,2,1,1,2
10461_1,,,,2,1,1,2
10462_0,,,,2,1,1,2
10462_1,,,,2,1,1,2
10463_0,,,,2,1,1,2
10463_1,,,,2,1,1,2
10464_0,,,,2,1,1,2
10465_0,,,,2,1,1,2
10466_0,,,,2,1,1,2
10467_0,,,,2,1,1,2
10467_1,,,,2,1,1,2
10468_0,,,,2,1,1,2
10468_1,,,,2,1,1,2
10469_0,,,,2,1,1,2
10470_0,,,,2,1,1,2
10470_1,,,,2,1,1,2
10471_0,,,,2,1,2,3
10471_1,,,,2,1,2,3
10472_0,,,,2,1,1,2
10473_0,,,,2,1,1,2
10473_1,,,,2,1,1,2
10474_0,,,,2,1,1,2
10475_0,,,,2,1,1,2
10475_1,,,,2,1,1,2
10477_0,,,,2,1,1,2
C(C(C=O)CC(CO)=O)=O,,,4,1,3,0,3
10477_1,,,,2,1,1,2
10478_0,,,,2,1,1,2
10479_0,,,,2,1,1,2
10480_0,,,,2,1,1,2
10481_0,,,,2,1,1,2
10481_1,,,,2,1,1,2
10482_0,,,,2,1,1,2
10482_1,,,,2,1,1,2
10483_0,,,,2,1,2,3
10483_1,,,,2,1,2,3
10484_0,,,,2,1,1,2
10484_1,,,,2,1,1,2
10485_0,,,,2,1,1,2
10486_0,,,,2,1,1,2
10486_1,,,,2,1,1,2
10487_0,,,,2,1,1,2
10487_1,,,,2,1,1,2
10487_2,,,,2,1,1,2
10488_0,,,,2,1,1,2
10488_1,,,,2,1,1,2
10488_2,,,,2,1,1,2
10489_0,,,,2,1,1,2
10490_0,,,,2,1,1,2
10490_1,,,,2,1,1,2
10491_0,,,,2,1,1,2
10491_1,,,,2,1,1,2
10492_0,,,,2,1,1,2
10492_1,,,,2,1,1,2
10493_0,,,,2,1,1,2
10494_0,,,,2,1,1,2
10494_1,,,,2,1,1,2
10495_0,,,,2,1,1,2
10495_1,,,,2,1,1,2
10496_0,,,,2,1,1,2
10496_1,,,,2,1,1,2
10497_0,,,,2,1,1,2
10497_1,,,,2,1,1,2
10498_0,,,,2,1,1,2
10498_1,,,,2,1,1,2
10499_0,,,,2,1,2,3
10499_1,,,,2,1,2,3
10500_0,,,,2,1,1,2
10500_1,,,,2,1,1,2
10501_0,,,,2,1,2,3
10501_1,,,,2,1,2,3
10502_0,,,,2,1,2,3
10502_1,,,,2,1,2,3
10503_0,,,,2,1,2,3
10503_1,,,,2,1,2,3
10504_0,,,,2,1,2,3
10505_0,,,,2,1,2,3
10505_1,,,,2,1,2,3
10506_0,,,,2,1,2,3
10507_0,,,,2,1,2,3
10507_1,,,,2,1,2,3
10509_0,,,,2,1,2,3
C(CO)(C(C(CO)=O)O)=O,,,4,1,2,0,2
10510_0,,,,2,1,2,3
10510_1,,,,2,1,2,3
10511_0,,,,2,1,2,3
10511_1,,,,2,1,2,3
10512_0,,,,2,1,2,3
10512_1,,,,2,1,2,3
10513_0,,,,2,1,2,3
10513_1,,,,2,1,2,3
10514_0,,,,2,1,2,3
10514_1,,,,2,1,2,3
10515_0,,,,2,1,2,3
10515_1,,,,2,1,2,3
10516_0,,,,2,1,2,3
10517_0,,,,2,1,2,3
10517_1,,,,2,1,2,3
10518_0,,,,2,1,2,3
10518_1,,,,2,1,2,3
10519_0,,,,2,1,2,3
10519_1,,,,2,1,2,3
10520_0,,,,2,1,2,3
10521_0,,,,2,1,2,3
10521_1,,,,2,1,2,3
10522_0,,,,2,1,2,3
10522_1,,,,2,1,2,3
10523_0,,,,2,1,2,3
10523_1,,,,2,1,2,3
10524_0,,,,2,1,2,3
10525_0,,,,2,1,2,3
10525_1,,,,2,1,2,3
10526_0,,,,2,1,2,3
10526_1,,,,2,1,2,3
10527_0,,,,2,1,2,3
10527_1,,,,2,1,2,3
10528_0,,,,2,1,2,3
10528_1,,,,2,1,2,3
10529_0,,,,2,1,2,3
10529_1,,,,2,1,2,3
10530_0,,,,2,1,2,3
10530_1,,,,2,1,2,3
10531_0,,,,2,1,2,3
10532_0,,,,2,1,2,3
10532_1,,,,2,1,2,3
10533_0,,,,2,1,2,3
10533_1,,,,2,1,2,3
10534_0,,,,2,1,2,3
10534_1,,,,2,1,2,3
10535_0,,,,2,1,2,3
10535_1,,,,2,1,2,3
10536_0,,,,2,1,2,3
10536_1,,,,2,1,2,3
10537_0,,,,2,1,2,3
10538_0,,,,2,1,2,3
10538_1,,,,2,1,2,3
10539_0,,,,2,1,2,3
10539_1,,,,2,1,2,3
10540_0,,,,2,1,2,3
10541_0,,,,2,1,2,3
10541_1,,,,2,1,2,3
10542_0,,,,2,1,2,3
10542_1,,,,2,1,2,3
10543_0,,,,2,1,2,3
10543_1,,,,2,1,2,3
10544_0,,,,2,1,2,3
10544_1,,,,2,1,2,3
10545_0,,,,2,1,2,3
10546_0,,,,2,1,2,3
10546_1,,,,2,1,2,3
10547_0,,,,2,1,2,3
10547_1,,,,2,1,2,3
10548_0,,,,2,1,2,3
10548_1,,,,2,1,2,3
10548_2,,,,2,1,2,3
10549_0,,,,2,1,2,3
10549_1,,,,2,1,2,3
10549_2,,,,2,1,2,3
10550_0,,,,2,1,2,3
10551_0,,,,2,1,2,3
10551_1,,,,2,1,2,3
10552_0,,,,2,1,2,3
10552_1,,,,2,1,2,3
10553_0,,,,2,1,2,3
10553_1,,,,2,1,2,3
10554_0,,,,2,1,2,3
10555_0,,,,2,1,2,3
10556_0,,,,2,1,2,3
10556_1,,,,2,1,2,3
10557_0,,,,2,1,2,3
10557_1,,,,2,1,2,3
10558_0,,,,2,1,2,3
10558_1,,,,2,1,2,3
10559_0,,,,2,1,2,3
10559_1,,,,2,1,2,3
10560_0,,,,2,1,2,3
10561_0,,,,2,1,2,3
10561_1,,,,2,1,2,3
10562_0,,,,2,1,2,3
10562_1,,,,2,1,2,3
10563_0,,,,2,1,2,3
10563_1,,,,2,1,2,3
10564_0,,,,2,1,2,3
10564_1,,,,2,1,2,3
10565_0,,,,2,1,2,3
10566_0,,,,2,1,2,3
10567_0,,,,2,1,2,3
10568_0,,,,2,1,2,3
10569_0,,,,2,1,2,3
10570_0,,,,2,1,2,3
10571_0,,,,2,1,2,3
10571_1,,,,2,1,2,3
10572_0,,,,2,1,2,3
10572_1,,,,2,1,2,3
10573_0,,,,2,1,2,3
10573_1,,,,2,1,2,3
10574_0,,,,2,1,2,3
10574_1,,,,2,1,2,3
10575_0,,,,2,1,2,3
10575_1,,,,2,1,2,3
10576_0,,,,2,1,2,3
10576_1,,,,2,1,2,3
10577_0,,,,2,1,2,3
10578_0,,,,2,1,2,3
10578_1,,,,2,1,2,3
10579_0,,,,2,1,2,3
10580_0,,,,2,1,2,3
10580_1,,,,2,1,2,3
10581_0,,,,2,1,2,3
10582_0,,,,2,1,2,3
10583_0,,,,2,1,2,3
10584_0,,,,2,1,2,3
10585_0,,,,2,1,2,3
10586_0,,,,2,1,2,3
10586_1,,,,2,1,2,3
10587_0,,,,2,1,2,3
10588_0,,,,2,1,2,3
10588_1,,,,2,1,2,3
10589_0,,,,2,1,2,3
10590_0,,,,2,1,2,3
10591_0,,,,2,1,2,3
10592_0,,,,2,1,2,3
10592_1,,,,2,1,2,3
10593_0,,,,2,1,2,3
10593_1,,,,2,1,2,3
10594_0,,,,2,1,2,3
10594_1,,,,2,1,2,3
10595_0,,,,2,1,2,3
10595_1,,,,2,1,2,3
10596_0,,,,2,1,2,3
10597_0,,,,2,1,2,3
10597_1,,,,2,1,2,3
10598_0,,,,2,1,2,3
10598_1,,,,2,1,2,3
10599_0,,,,2,1,2,3
10600_0,,,,2,1,2,3
10600_1,,,,2,1,2,3
10601_0,,,,2,1,2,3
10601_1,,,,2,1,2,3
10602_0,,,,2,1,2,3
10603_0,,,,2,1,2,3
10603_1,,,,2,1,2,3
10604_0,,,,2,1,2,3
10604_1,,,,2,1,2,3
10605_0,,,,2,1,2,3
10605_1,,,,2,1,2,3
10606_0,,,,2,1,2,3
10606_1,,,,2,1,2,3
10607_0,,,,2,1,2,3
10608_0,,,,2,1,2,3
10608_1,,,,2,1,2,3
10609_0,,,,2,1,2,3
10610_0,,,,2,1,2,3
10611_0,,,,2,1,2,3
10612_0,,,,2,1,2,3
10612_1,,,,2,1,2,3
10613_0,,,,2,1,2,3
10613_1,,,,2,1,2,3
10614_0,,,,2,1,2,3
10614_1,,,,2,1,2,3
10615_0,,,,2,1,2,3
10616_0,,,,2,1,2,3
10617_0,,,,2,1,2,3
10618_0,,,,2,1,2,3
10618_1,,,,2,1,2,3
10619_0,,,,2,1,2,3
10619_1,,,,2,1,2,3
10620_0,,,,2,1,2,3
10620_1,,,,2,1,2,3
10621_0,,,,2,1,2,3
10621_1,,,,2,1,2,3
10622_0,,,,2,1,2,3
10623_0,,,,2,1,2,3
10623_1,,,,2,1,2,3
10624_0,,,,2,1,2,3
10625_0,,,,2,1,2,3
10626_0,,,,2,1,2,3
10627_0,,,,2,1,2,3
10628_0,,,,2,1,2,3
10629_0,,,,2,1,2,3
10629_1,,,,2,1,2,3
10630_0,,,,2,1,2,3
10630_1,,,,2,1,2,3
10632_0,,,,2,1,2,3
C(C(C=O)(C)O)=O,,,4,1,1,0,1
10633_0,,,,2,1,2,3
10633_1,,,,2,1,2,3
10634_0,,,,2,1,2,3
10635_0,,,,2,1,2,3
10635_1,,,,2,1,2,3
10636_0,,,,2,1,2,3
10636_1,,,,2,1,2,3
10637_0,,,,2,1,2,3
10637_1,,,,2,1,2,3
10638_0,,,,2,1,2,3
10638_1,,,,2,1,2,3
10639_0,,,,2,1,2,3
10639_1,,,,2,1,2,3
10640_0,,,,2,1,2,3
10640_1,,,,2,1,2,3
10641_0,,,,2,1,2,3
10642_0,,,,2,1,2,3
10642_1,,,,2,1,2,3
10643_0,,,,2,1,2,3
10644_0,,,,2,1,2,3
10644_1,,,,2,1,2,3
10645_0,,,,2,1,2,3
10645_1,,,,2,1,2,3
10646_0,,,,2,1,2,3
10646_1,,,,2,1,2,3
10647_0,,,,2,1,2,3
10647_1,,,,2,1,2,3
10648_0,,,,2,1,2,3
10648_1,,,,2,1,2,3
10649_0,,,,2,1,2,3
10649_1,,,,2,1,2,3
10650_0,,,,2,1,2,3
10650_1,,,,2,1,2,3
10652_0,,,,2,1,2,3
C(C(C=O)C(CO)=O)=O,,,4,1,3,0,3
10652_1,,,,2,1,2,3
10653_0,,,,2,1,2,3
10653_1,,,,2,1,2,3
10655_0,,,,2,1,2,3
C(CC(C(C=O)O)=O)=O,,,4,1,6,0,6
10655_1,,,,2,1,2,3
10656_0,,,,2,1,2,3
10656_1,,,,2,1,2,3
10657_0,,,,2,1,2,3
10657_1,,,,2,1,2,3
10658_0,,,,2,1,2,3
10659_0,,,,2,1,2,3
10660_0,,,,2,1,2,3
10661_0,,,,2,1,2,3
10662_0,,,,2,1,2,3
10662_1,,,,2,1,2,3
10663_0,,,,2,1,2,3
10664_0,,,,2,1,2,3
10664_1,,,,2,1,2,3
10665_0,,,,2,1,2,3
10665_1,,,,2,1,2,3
10666_0,,,,2,1,2,3
10666_1,,,,2,1,2,3
10667_0,,,,2,1,2,3
10668_0,,,,2,1,2,3
10669_0,,,,2,1,2,3
10670_0,,,,2,1,2,3
10670_1,,,,2,1,2,3
10671_0,,,,2,1,2,3
10671_1,,,,2,1,2,3
10672_0,,,,2,1,2,3
10672_1,,,,2,1,2,3
10673_0,,,,2,1,2,3
10673_1,,,,2,1,2,3
10674_0,,,,2,1,2,3
10674_1,,,,2,1,2,3
10675_0,,,,2,1,2,3
10675_1,,,,2,1,2,3
10676_0,,,,2,1,2,3
10676_1,,,,2,1,2,3
10676_2,,,,2,1,2,3
10677_0,,,,2,1,2,3
10677_1,,,,2,1,2,3
10677_2,,,,2,1,2,3
10678_0,,,,2,1,2,3
10679_0,,,,2,1,2,3
10680_0,,,,2,1,2,3
10680_1,,,,2,1,2,3
10681_0,,,,2,1,2,3
10682_0,,,,2,1,2,3
10683_0,,,,2,1,2,3
10683_1,,,,2,1,2,3
10684_0,,,,2,1,2,3
10685_0,,,,2,1,2,3
10686_0,,,,2,1,2,3
10687_0,,,,2,1,2,3
10687_1,,,,2,1,2,3
10688_0,,,,2,1,2,3
10690_0,,,,2,1,2,3
C(C)(CC(CO)=O)=O,,,4,1,16,0,16
10690_1,,,,2,1,2,3
10691_0,,,,2,1,2,3
10692_0,,,,2,1,2,3
10692_1,,,,2,1,2,3
10694_0,,,,2,1,2,3
C(C)(C(C(C)=O)O)=O,,,4,1,7,0,7
10694_1,,,,2,1,2,3
10695_0,,,,2,1,2,3
10695_1,,,,2,1,2,3
10696_0,,,,2,1,2,3
10697_0,,,,2,1,2,3
10697_1,,,,2,1,2,3
10698_0,,,,2,1,2,3
10699_0,,,,2,1,2,3
10699_1,,,,2,1,2,3
10700_0,,,,2,1,2,3
10701_0,,,,2,1,2,3
10702_0,,,,2,1,2,3
10703_0,,,,2,1,2,3
10703_1,,,,2,1,2,3
10704_0,,,,2,1,2,3
10704_1,,,,2,1,2,3
10705_0,,,,2,1,2,3
10706_0,,,,2,1,2,3
10706_1,,,,2,1,2,3
10707_0,,,,2,1,2,3
10707_1,,,,2,1,2,3
10708_0,,,,2,1,2,3
10709_0,,,,2,1,2,3
10709_1,,,,2,1,2,3
10710_0,,,,2,1,2,3
10710_1,,,,2,1,2,3
10711_0,,,,2,1,2,3
10711_1,,,,2,1,2,3
10712_0,,,,2,1,2,3
10713_0,,,,2,1,2,3
10713_1,,,,2,1,2,3
10714_0,,,,2,1,2,3
10714_1,,,,2,1,2,3
10715_0,,,,2,1,2,3
10715_1,,,,2,1,2,3
10716_0,,,,2,1,2,3
10716_1,,,,2,1,2,3
10717_0,,,,2,1,2,3
10717_1,,,,2,1,2,3
10718_0,,,,2,1,2,3
10718_1,,,,2,1,2,3
10719_0,,,,2,1,2,3
10719_1,,,,2,1,2,3
10720_0,,,,2,1,2,3
10721_0,,,,2,1,2,3
10721_1,,,,2,1,2,3
10722_0,,,,2,1,2,3
10722_1,,,,2,1,2,3
10723_0,,,,2,1,2,3
10723_1,,,,2,1,2,3
10724_0,,,,2,1,2,3
10724_1,,,,2,1,2,3
10725_0,,,,2,1,2,3
10726_0,,,,2,1,2,3
10726_1,,,,2,1,2,3
10727_0,,,,2,1,2,3
10728_0,,,,2,1,2,3
10728_1,,,,2,1,2,3
10729_0,,,,2,1,2,3
10729_1,,,,2,1,2,3
10730_0,,,,2,1,2,3
10731_0,,,,2,1,2,3
10731_1,,,,2,1,2,3
10732_0,,,,2,1,2,3
10733_0,,,,2,1,2,3
10733_1,,,,2,1,2,3
10734_0,,,,2,1,2,3
10735_0,,,,2,1,2,3
10735_1,,,,2,1,2,3
10736_0,,,,2,1,2,3
10737_0,,,,2,1,2,3
10738_0,,,,2,1,2,3
10738_1,,,,2,1,2,3
10739_0,,,,2,1,2,3
10740_0,,,,2,1,2,3
10740_1,,,,2,1,2,3
10741_0,,,,2,1,2,3
10741_1,,,,2,1,2,3
10743_0,,,,2,1,2,3
C(C(C)(C(CO)O)O)=O,,,4,1,4,0,4
10744_0,,,,2,1,2,3
10744_1,,,,2,1,2,3
10745_0,,,,2,1,2,3
10745_1,,,,2,1,2,3
10746_0,,,,2,1,2,3
10746_1,,,,2,1,2,3
10747_0,,,,2,1,2,3
10748_0,,,,2,1,2,3
10748_1,,,,2,1,2,3
10749_0,,,,2,1,2,3
10750_0,,,,2,1,2,3
10751_0,,,,2,1,2,3
10752_0,,,,2,1,2,3
10752_1,,,,2,1,2,3
10753_0,,,,2,1,2,3
10753_1,,,,2,1,2,3
10754_0,,,,2,1,2,3
10754_1,,,,2,1,2,3
10755_0,,,,2,1,2,3
10755_1,,,,2,1,2,3
10756_0,,,,2,1,2,3
10757_0,,,,2,1,2,3
10757_1,,,,2,1,2,3
10758_0,,,,2,1,2,3
10758_1,,,,2,1,2,3
10759_0,,,,2,1,2,3
10759_1,,,,2,1,2,3
10760_0,,,,2,1,2,3
10760_1,,,,2,1,2,3
10761_0,,,,2,1,2,3
10761_1,,,,2,1,2,3
10762_0,,,,2,1,2,3
10763_0,,,,2,1,2,3
10764_0,,,,2,1,2,3
10765_0,,,,2,1,2,3
10765_1,,,,2,1,2,3
10766_0,,,,2,1,2,3
10766_1,,,,2,1,2,3
10767_0,,,,2,1,2,3
10767_1,,,,2,1,2,3
10768_0,,,,2,1,2,3
10768_1,,,,2,1,2,3
10769_0,,,,2,1,2,3
10769_1,,,,2,1,2,3
10770_0,,,,2,1,2,3
10770_1,,,,2,1,2,3
10771_0,,,,2,1,2,3
10771_1,,,,2,1,2,3
10772_0,,,,2,1,2,3
10773_0,,,,2,1,2,3
10773_1,,,,2,1,2,3
10774_0,,,,2,1,2,3
10774_1,,,,2,1,2,3
10775_0,,,,2,1,2,3
10776_0,,,,2,1,2,3
10776_1,,,,2,1,2,3
10777_0,,,,2,1,2,3
10777_1,,,,2,1,2,3
10778_0,,,,2,1,2,3
10778_1,,,,2,1,2,3
10779_0,,,,2,1,2,3
10779_1,,,,2,1,2,3
10780_0,,,,2,1,2,3
10781_0,,,,2,1,2,3
10781_1,,,,2,1,2,3
10782_0,,,,2,1,2,3
10782_1,,,,2,1,2,3
10783_0,,,,2,1,2,3
10783_1,,,,2,1,2,3
10784_0,,,,2,1,2,3
10784_1,,,,2,1,2,3
10785_0,,,,2,1,2,3
10785_1,,,,2,1,2,3
10786_0,,,,2,1,2,3
10786_1,,,,2,1,2,3
10787_0,,,,2,1,2,3
10787_1,,,,2,1,2,3
10788_0,,,,2,1,2,3
10788_1,,,,2,1,2,3
10789_0,,,,2,1,2,3
10789_1,,,,2,1,2,3
10790_0,,,,2,1,2,3
10790_1,,,,2,1,2,3
10791_0,,,,2,1,2,3
10791_1,,,,2,1,2,3
10792_0,,,,2,1,1,2
10792_1,,,,2,1,1,2
10793_0,,,,2,1,1,2
10793_1,,,,2,1,1,2
10793_2,,,,2,1,1,2
10794_0,,,,2,1,2,3
10794_1,,,,2,1,2,3
10794_2,,,,2,1,2,3
10795_0,,,,2,1,2,3
10795_1,,,,2,1,2,3
10796_0,,,,2,1,2,3
10797_0,,,,2,1,2,3
10797_1,,,,2,1,2,3
10798_0,,,,2,1,2,3
10799_0,,,,2,1,2,3
10800_0,,,,2,1,2,3
10800_1,,,,2,1,2,3
10801_0,,,,2,1,2,3
10801_1,,,,2,1,2,3
10802_0,,,,2,1,2,3
10802_1,,,,2,1,2,3
10803_0,,,,2,1,2,3
10804_0,,,,2,1,2,3
10805_0,,,,2,1,2,3
10805_1,,,,2,1,2,3
10806_0,,,,2,1,2,3
10806_1,,,,2,1,2,3
10807_0,,,,2,1,2,3
10807_1,,,,2,1,2,3
10808_0,,,,2,1,2,3
10809_0,,,,2,1,2,3
10809_1,,,,2,1,2,3
10810_0,,,,2,1,2,3
10810_1,,,,2,1,2,3
10811_0,,,,2,1,2,3
10811_1,,,,2,1,2,3
10812_0,,,,2,1,2,3
10812_1,,,,2,1,2,3
10813_0,,,,2,1,2,3
10813_1,,,,2,1,2,3
10814_0,,,,2,1,2,3
10815_0,,,,2,1,2,3
10815_1,,,,2,1,2,3
10816_0,,,,2,1,2,3
10817_0,,,,2,1,2,3
10817_1,,,,2,1,2,3
10818_0,,,,2,1,2,3
10818_1,,,,2,1,2,3
10819_0,,,,2,1,2,3
10819_1,,,,2,1,2,3
10820_0,,,,2,1,2,3
10821_0,,,,2,1,2,3
10822_0,,,,2,1,2,3
10823_0,,,,2,1,2,3
10823_1,,,,2,1,2,3
10824_0,,,,2,1,2,3
10824_1,,,,2,1,2,3
10825_0,,,,2,1,2,3
10826_0,,,,2,1,2,3
10827_0,,,,2,1,2,3
10827_1,,,,2,1,2,3
10828_0,,,,2,1,2,3
10828_1,,,,2,1,2,3
10829_0,,,,2,1,2,3
10830_0,,,,2,1,2,3
10830_1,,,,2,1,2,3
10831_0,,,,2,1,2,3
10831_1,,,,2,1,2,3
10832_0,,,,2,1,2,3
10832_1,,,,2,1,2,3
10833_0,,,,2,1,2,3
10833_1,,,,2,1,2,3
10834_0,,,,2,1,1,2
10834_1,,,,2,1,1,2
10835_0,,,,2,1,2,3
10835_1,,,,2,1,2,3
10836_0,,,,2,1,1,2
10836_1,,,,2,1,1,2
10837_0,,,,2,1,2,3
10838_0,,,,2,1,2,3
10838_1,,,,2,1,2,3
10839_0,,,,2,1,2,3
10839_1,,,,2,1,2,3
10840_0,,,,2,1,1,2
10840_1,,,,2,1,1,2
10841_0,,,,2,1,2,3
10841_1,,,,2,1,2,3
10842_0,,,,2,1,1,2
10842_1,,,,2,1,1,2
10843_0,,,,2,1,2,3
10843_1,,,,2,1,2,3
10844_0,,,,2,1,1,2
10844_1,,,,2,1,1,2
10845_0,,,,2,1,1,2
10845_1,,,,2,1,1,2
10846_0,,,,2,1,2,3
10846_1,,,,2,1,2,3
10847_0,,,,2,1,2,3
10847_1,,,,2,1,2,3
10848_0,,,,2,1,1,2
10848_1,,,,2,1,1,2
10849_0,,,,2,1,2,3
10849_1,,,,2,1,2,3
10850_0,,,,2,1,2,3
10850_1,,,,2,1,2,3
10851_0,,,,2,1,1,2
10851_1,,,,2,1,1,2
10852_0,,,,2,1,2,3
10852_1,,,,2,1,2,3
10853_0,,,,2,1,1,2
10853_1,,,,2,1,1,2
10854_0,,,,2,1,2,3
10854_1,,,,2,1,2,3
10855_0,,,,2,1,1,2
10855_1,,,,2,1,1,2
10856_0,,,,2,1,1,2
10856_1,,,,2,1,1,2
10857_0,,,,2,1,1,2
10857_1,,,,2,1,1,2
10858_0,,,,2,1,2,3
10858_1,,,,2,1,2,3
10859_0,,,,2,1,1,2
10859_1,,,,2,1,1,2
10860_0,,,,2,1,2,3
10860_1,,,,2,1,2,3
10861_0,,,,2,1,1,2
10861_1,,,,2,1,1,2
10862_0,,,,2,1,1,2
10862_1,,,,2,1,1,2
10863_0,,,,2,1,2,3
10863_1,,,,2,1,2,3
10864_0,,,,2,1,2,3
10864_1,,,,2,1,2,3
10865_0,,,,2,1,1,2
10865_1,,,,2,1,1,2
10866_0,,,,2,1,1,2
10867_0,,,,2,1,2,3
10867_1,,,,2,1,2,3
10868_0,,,,2,1,2,3
10868_1,,,,2,1,2,3
10869_0,,,,2,1,2,3
10869_1,,,,2,1,2,3
10870_0,,,,2,1,2,3
10871_0,,,,2,1,2,3
10872_0,,,,2,1,2,3
10872_1,,,,2,1,2,3
10873_0,,,,2,1,2,3
10874_0,,,,2,1,2,3
10874_1,,,,2,1,2,3
10875_0,,,,2,1,2,3
10876_0,,,,2,1,2,3
10876_1,,,,2,1,2,3
10877_0,,,,2,1,2,3
10877_1,,,,2,1,2,3
10878_0,,,,2,1,2,3
10878_1,,,,2,1,2,3
10879_0,,,,2,1,2,3
10879_1,,,,2,1,2,3
10880_0,,,,2,1,2,3
10880_1,,,,2,1,2,3
10881_0,,,,2,1,2,3
10881_1,,,,2,1,2,3
10882_0,,,,2,1,2,3
10883_0,,,,2,1,2,3
10883_1,,,,2,1,2,3
10884_0,,,,2,1,2,3
10885_0,,,,2,1,2,3
10885_1,,,,2,1,2,3
10886_0,,,,2,1,2,3
10886_1,,,,2,1,2,3
10887_0,,,,2,1,2,3
10888_0,,,,2,1,2,3
10889_0,,,,2,1,2,3
10889_1,,,,2,1,2,3
10890_0,,,,2,1,2,3
10891_0,,,,2,1,2,3
10891_1,,,,2,1,2,3
10892_0,,,,2,1,2,3
10892_1,,,,2,1,2,3
10893_0,,,,2,1,2,3
10894_0,,,,2,1,2,3
10895_0,,,,2,1,2,3
10895_1,,,,2,1,2,3
10896_0,,,,2,1,2,3
10896_1,,,,2,1,2,3
10897_0,,,,2,1,2,3
10897_1,,,,2,1,2,3
10898_0,,,,2,1,2,3
10898_1,,,,2,1,2,3
10899_0,,,,2,1,2,3
10899_1,,,,2,1,2,3
10900_0,,,,2,1,2,3
10900_1,,,,2,1,2,3
10901_0,,,,2,1,2,3
10901_1,,,,2,1,2,3
10902_0,,,,2,1,2,3
10902_1,,,,2,1,2,3
10903_0,,,,2,1,2,3
10903_1,,,,2,1,2,3
10904_0,,,,2,1,2,3
10904_1,,,,2,1,2,3
10905_0,,,,2,1,2,3
10905_1,,,,2,1,2,3
10906_0,,,,2,1,2,3
10907_0,,,,2,1,2,3
10908_0,,,,2,1,2,3
10909_0,,,,2,1,2,3
10909_1,,,,2,1,2,3
10910_0,,,,2,1,2,3
10910_1,,,,2,1,2,3
10911_0,,,,2,1,2,3
10911_1,,,,2,1,2,3
10912_0,,,,2,1,2,3
10912_1,,,,2,1,2,3
10913_0,,,,2,1,2,3
10914_0,,,,2,1,2,3
10915_0,,,,2,1,2,3
10916_0,,,,2,1,2,3
10916_1,,,,2,1,2,3
10917_0,,,,2,1,2,3
10917_1,,,,2,1,2,3
10918_0,,,,2,1,2,3
10918_1,,,,2,1,2,3
10919_0,,,,2,1,2,3
10919_1,,,,2,1,2,3
10920_0,,,,2,1,2,3
10920_1,,,,2,1,2,3
10921_0,,,,2,1,2,3
10921_1,,,,2,1,2,3
10923_0,,,,2,1,2,3
C(C(C=O)(CCO)O)=O,,,4,1,1,0,1
10924_0,,,,2,1,2,3
10924_1,,,,2,1,2,3
10925_0,,,,2,1,2,3
10925_1,,,,2,1,2,3
10926_0,,,,2,1,2,3
10927_0,,,,2,1,2,3
10927_1,,,,2,1,2,3
10928_0,,,,2,1,2,3
10928_1,,,,2,1,2,3
10929_0,,,,2,1,2,3
10929_1,,,,2,1,2,3
10930_0,,,,2,1,2,3
10930_1,,,,2,1,2,3
10931_0,,,,2,1,2,3
10931_1,,,,2,1,2,3
10932_0,,,,2,1,2,3
10933_0,,,,2,1,2,3
10933_1,,,,2,1,2,3
10934_0,,,,2,1,2,3
10934_1,,,,2,1,2,3
10935_0,,,,2,1,2,3
10936_0,,,,2,1,2,3
10936_1,,,,2,1,2,3
10937_0,,,,2,1,2,3
10937_1,,,,2,1,2,3
10938_0,,,,2,1,2,3
10939_0,,,,2,1,2,3
10939_1,,,,2,1,2,3
10940_0,,,,2,1,2,3
10940_1,,,,2,1,2,3
10941_0,,,,2,1,2,3
10942_0,,,,2,1,2,3
10942_1,,,,2,1,2,3
10943_0,,,,2,1,2,3
10944_0,,,,2,1,2,3
10944_1,,,,2,1,2,3
10944_2,,,,2,1,2,3
10945_0,,,,2,1,2,3
10945_1,,,,2,1,2,3
10945_2,,,,2,1,2,3
10946_0,,,,2,1,2,3
10946_1,,,,2,1,2,3
10947_0,,,,2,1,2,3
10947_1,,,,2,1,2,3
10948_0,,,,2,1,2,3
10948_1,,,,2,1,2,3
10950_0,,,,2,1,2,3
C(C(CO)(CCO)O)=O,,,4,1,3,0,3
10951_0,,,,2,1,2,3
10951_1,,,,2,1,2,3
10952_0,,,,2,1,2,3
10952_1,,,,2,1,2,3
10953_0,,,,2,1,2,3
10953_1,,,,2,1,2,3
10954_0,,,,2,1,2,3
10955_0,,,,2,1,2,3
10955_1,,,,2,1,2,3
10956_0,,,,2,1,2,3
10957_0,,,,2,1,2,3
10957_1,,,,2,1,2,3
10958_0,,,,2,1,2,3
10959_0,,,,2,1,2,3
10959_1,,,,2,1,2,3
10960_0,,,,2,1,2,3
10960_1,,,,2,1,2,3
10961_0,,,,2,1,2,3
10961_1,,,,2,1,2,3
10962_0,,,,2,1,2,3
10962_1,,,,2,1,2,3
10963_0,,,,2,1,2,3
10964_0,,,,2,1,2,3
10964_1,,,,2,1,2,3
10965_0,,,,2,1,2,3
10966_0,,,,2,1,2,3
10966_1,,,,2,1,2,3
10967_0,,,,2,1,2,3
10968_0,,,,2,1,2,3
10968_1,,,,2,1,2,3
10969_0,,,,2,1,2,3
10970_0,,,,2,1,2,3
10970_1,,,,2,1,2,3
10971_0,,,,2,1,2,3
10971_1,,,,2,1,2,3
10972_0,,,,2,1,2,3
10972_1,,,,2,1,2,3
10973_0,,,,2,1,2,3
10974_0,,,,2,1,2,3
10974_1,,,,2,1,2,3
10975_0,,,,2,1,2,3
10975_1,,,,2,1,2,3
10976_0,,,,2,1,2,3
10976_1,,,,2,1,2,3
10977_0,,,,2,1,2,3
10978_0,,,,2,1,2,3
10978_1,,,,2,1,2,3
10979_0,,,,2,1,2,3
10980_0,,,,2,1,2,3
10981_0,,,,2,1,2,3
10981_1,,,,2,1,2,3
10982_0,,,,2,1,2,3
10982_1,,,,2,1,2,3
10983_0,,,,2,1,2,3
10983_1,,,,2,1,2,3
10983_2,,,,2,1,2,3
10984_0,,,,2,1,2,3
10984_1,,,,2,1,2,3
10984_2,,,,2,1,2,3
10986_0,,,,2,1,2,3
C(C(CO)(C)O)=O,,,4,1,2,0,2
10987_0,,,,2,1,2,3
10987_1,,,,2,1,2,3
10988_0,,,,2,1,2,3
10989_0,,,,2,1,2,3
10989_1,,,,2,1,2,3
10990_0,,,,2,1,2,3
10990_1,,,,2,1,2,3
10991_0,,,,2,1,2,3
10991_1,,,,2,1,2,3
10992_0,,,,2,1,2,3
10993_0,,,,2,1,2,3
10993_1,,,,2,1,2,3
10994_0,,,,2,1,2,3
10994_1,,,,2,1,2,3
10995_0,,,,2,1,2,3
10995_1,,,,2,1,2,3
10995_2,,,,2,1,2,3
10996_0,,,,2,1,2,3
10996_1,,,,2,1,2,3
10996_2,,,,2,1,2,3
10997_0,,,,2,1,2,3
10997_1,,,,2,1,2,3
10998_0,,,,2,1,2,3
10998_1,,,,2,1,2,3
10999_0,,,,2,1,2,3
11000_0,,,,2,1,2,3
11001_0,,,,2,1,2,3
11001_1,,,,2,1,2,3
11002_0,,,,2,1,2,3
11002_1,,,,2,1,2,3
11003_0,,,,2,1,2,3
11003_1,,,,2,1,2,3
11004_0,,,,2,1,2,3
11004_1,,,,2,1,2,3
11005_0,,,,2,1,2,3
11005_1,,,,2,1,2,3
11006_0,,,,2,1,2,3
11007_0,,,,2,1,2,3
11008_0,,,,2,1,2,3
11008_1,,,,2,1,2,3
11009_0,,,,2,1,2,3
11010_0,,,,2,1,2,3
11010_1,,,,2,1,2,3
11011_0,,,,2,1,2,3
11012_0,,,,2,1,2,3
11013_0,,,,2,1,2,3
11014_0,,,,2,1,2,3
11014_1,,,,2,1,2,3
11015_0,,,,2,1,2,3
11016_0,,,,2,1,2,3
11016_1,,,,2,1,2,3
11017_0,,,,2,1,2,3
11018_0,,,,2,1,2,3
11018_1,,,,2,1,2,3
11019_0,,,,2,1,2,3
11019_1,,,,2,1,2,3
11020_0,,,,2,1,2,3
11021_0,,,,2,1,2,3
11022_0,,,,2,1,2,3
11023_0,,,,2,1,2,3
11024_0,,,,2,1,2,3
11025_0,,,,2,1,2,3
11026_0,,,,2,1,2,3
11027_0,,,,2,1,2,3
11027_1,,,,2,1,2,3
11028_0,,,,2,1,2,3
11029_0,,,,2,1,2,3
11029_1,,,,2,1,2,3
11030_0,,,,2,1,2,3
11030_1,,,,2,1,2,3
11031_0,,,,2,1,2,3
11032_0,,,,2,1,2,3
11033_0,,,,2,1,2,3
11034_0,,,,2,1,2,3
11035_0,,,,2,1,2,3
11036_0,,,,2,1,2,3
11036_1,,,,2,1,2,3
11037_0,,,,2,1,2,3
11038_0,,,,2,1,2,3
11039_0,,,,2,1,2,3
11040_0,,,,2,1,2,3
11041_0,,,,2,1,2,3
11042_0,,,,2,1,2,3
11042_1,,,,2,1,2,3
11043_0,,,,2,1,2,3
11043_1,,,,2,1,2,3
11044_0,,,,2,1,2,3
11045_0,,,,2,1,2,3
11046_0,,,,2,1,2,3
11047_0,,,,2,1,2,3
11048_0,,,,2,1,2,3
11049_0,,,,2,1,2,3
11050_0,,,,2,1,2,3
11051_0,,,,2,1,2,3
11052_0,,,,2,1,2,3
11053_0,,,,2,1,2,3
11053_1,,,,2,1,2,3
11054_0,,,,2,1,2,3
11054_1,,,,2,1,2,3
11055_0,,,,2,1,2,3
11056_0,,,,2,1,2,3
11057_0,,,,2,1,2,3
11057_1,,,,2,1,2,3
11058_0,,,,2,1,2,3
11058_1,,,,2,1,2,3
11059_0,,,,2,1,2,3
11060_0,,,,2,1,2,3
11061_0,,,,2,1,2,3
11062_0,,,,2,1,2,3
11063_0,,,,2,1,2,3
11064_0,,,,2,1,2,3
11065_0,,,,2,1,2,3
11065_1,,,,2,1,2,3
11066_0,,,,2,1,2,3
11067_0,,,,2,1,2,3
11067_1,,,,2,1,2,3
11068_0,,,,2,1,2,3
11068_1,,,,2,1,2,3
11069_0,,,,2,1,2,3
11070_0,,,,2,1,2,3
11071_0,,,,2,1,2,3
11073_0,,,,2,1,2,3
C(CC(CC=O)=O)=O,,,4,1,5,0,5
11074_0,,,,2,1,2,3
11075_0,,,,2,1,2,3
11076_0,,,,2,1,2,3
11076_1,,,,2,1,2,3
11077_0,,,,2,1,2,3
11077_1,,,,2,1,2,3
11078_0,,,,2,1,2,3
11078_1,,,,2,1,2,3
11079_0,,,,2,1,2,3
11080_0,,,,2,1,2,3
11081_0,,,,2,1,2,3
11082_0,,,,2,1,2,3
11082_1,,,,2,1,2,3
11083_0,,,,2,1,2,3
11084_0,,,,2,1,2,3
11084_1,,,,2,1,2,3
11085_0,,,,2,1,2,3
11085_1,,,,2,1,2,3
11086_0,,,,2,1,2,3
11087_0,,,,2,1,2,3
11088_0,,,,2,1,2,3
11089_0,,,,2,1,2,3
11090_0,,,,2,1,2,3
11090_1,,,,2,1,2,3
11091_0,,,,2,1,2,3
11092_0,,,,2,1,2,3
11092_1,,,,2,1,2,3
11093_0,,,,2,1,2,3
11093_1,,,,2,1,2,3
11094_0,,,,2,1,2,3
11095_0,,,,2,1,2,3
11095_1,,,,2,1,2,3
11096_0,,,,2,1,2,3
11098_0,,,,2,1,2,3
C(CC(CC(C)=O)=O)=O,,,4,1,6,0,6
11098_1,,,,2,1,2,3
11100_0,,,,2,1,2,3
C(C)(C)=O,,,4,1,4,0,4
11101_0,,,,2,1,2,3
11102_0,,,,2,1,2,3
11103_0,,,,2,1,2,3
11103_1,,,,2,1,2,3
11104_0,,,,2,1,2,3
11105_0,,,,2,1,2,3
11107_0,,,,2,1,2,3
C(CCC(CO)=O)=O,,,4,1,9,0,9
11107_1,,,,2,1,2,3
11108_0,,,,2,1,2,3
11110_0,,,,2,1,2,3
C(CC(CCC=O)=O)=O,,,4,1,5,0,5
11110_1,,,,2,1,2,3
11111_0,,,,2,1,2,3
11112_0,,,,2,1,2,3
11113_0,,,,2,1,2,3
11114_0,,,,2,1,2,3
11115_0,,,,2,1,2,3
11116_0,,,,2,1,2,3
11117_0,,,,2,1,2,3
11118_0,,,,2,1,2,3
11119_0,,,,2,1,2,3
11119_1,,,,2,1,2,3
11120_0,,,,2,1,2,3
11120_1,,,,2,1,2,3
11121_0,,,,2,1,2,3
11122_0,,,,2,1,2,3
11123_0,,,,2,1,2,3
11124_0,,,,2,1,2,3
11125_0,,,,2,1,2,3
11126_0,,,,2,1,2,3
11127_0,,,,2,1,2,3
11129_0,,,,2,1,2,3
C(C(CC(C)=O)O)=O,,,4,1,5,0,5
11130_0,,,,2,1,2,3
11130_1,,,,2,1,2,3
11131_0,,,,2,1,2,3
11131_1,,,,2,1,2,3
11132_0,,,,2,1,2,3
11133_0,,,,2,1,2,3
11133_1,,,,2,1,2,3
11134_0,,,,2,1,2,3
11135_0,,,,2,1,2,3
11136_0,,,,2,1,2,3
11138_0,,,,2,1,2,3
C(CO)=CC(CO)=O,,,4,1,9,0,9
11138_1,,,,2,1,2,3
11139_0,,,,2,1,2,3
11141_0,,,,2,1,2,3
C(CC(C=CCO)=O)=O,,,4,1,7,0,7
11141_1,,,,2,1,2,3
11142_0,,,,2,1,2,3
11143_0,,,,2,1,2,3
11143_1,,,,2,1,2,3
11144_0,,,,2,1,2,3
11145_0,,,,2,1,2,3
11146_0,,,,2,1,2,3
11146_1,,,,2,1,2,3
11147_0,,,,2,1,2,3
11148_0,,,,2,1,2,3
11148_1,,,,2,1,2,3
11149_0,,,,2,1,2,3
11150_0,,,,2,1,2,3
11151_0,,,,2,1,2,3
11151_1,,,,2,1,2,3
11152_0,,,,2,1,2,3
11153_0,,,,2,1,2,3
11154_0,,,,2,1,2,3
11154_1,,,,2,1,2,3
11155_0,,,,2,1,2,3
11156_0,,,,2,1,2,3
11156_1,,,,2,1,2,3
11157_0,,,,2,1,2,3
11158_0,,,,2,1,2,3
11158_1,,,,2,1,2,3
11159_0,,,,2,1,2,3
11159_1,,,,2,1,2,3
11160_0,,,,2,1,2,3
11161_0,,,,2,1,2,3
11161_1,,,,2,1,2,3
11162_0,,,,2,1,2,3
11162_1,,,,2,1,2,3
11162_2,,,,2,1,2,3
11163_0,,,,2,1,2,3
11163_1,,,,2,1,2,3
11163_2,,,,2,1,2,3
11164_0,,,,2,1,2,3
11164_1,,,,2,1,2,3
11165_0,,,,2,1,2,3
11165_1,,,,2,1,2,3
11166_0,,,,2,1,2,3
11166_1,,,,2,1,2,3
11167_0,,,,2,1,2,3
11167_1,,,,2,1,2,3
11168_0,,,,2,1,2,3
11168_1,,,,2,1,2,3
11169_0,,,,2,1,2,3
11170_0,,,,2,1,2,3
11170_1,,,,2,1,2,3
11171_0,,,,2,1,2,3
11172_0,,,,2,1,2,3
11172_1,,,,2,1,2,3
11173_0,,,,2,1,2,3
11173_1,,,,2,1,2,3
11174_0,,,,2,1,2,3
11174_1,,,,2,1,2,3
11175_0,,,,2,1,2,3
11175_1,,,,2,1,2,3
11176_0,,,,2,1,2,3
11176_1,,,,2,1,2,3
11177_0,,,,2,1,2,3
11177_1,,,,2,1,2,3
11178_0,,,,2,1,2,3
11179_0,,,,2,1,2,3
11179_1,,,,2,1,2,3
11180_0,,,,2,1,2,3
11180_1,,,,2,1,2,3
11181_0,,,,2,1,2,3
11181_1,,,,2,1,2,3
11182_0,,,,2,1,2,3
11182_1,,,,2,1,2,3
11183_0,,,,2,1,2,3
11183_1,,,,2,1,2,3
11184_0,,,,2,1,2,3
11184_1,,,,2,1,2,3
11185_0,,,,2,1,2,3
11185_1,,,,2,1,2,3
11186_0,,,,2,1,2,3
11186_1,,,,2,1,2,3
11187_0,,,,2,1,2,3
11187_1,,,,2,1,2,3
11188_0,,,,2,1,2,3
11188_1,,,,2,1,2,3
11189_0,,,,2,1,2,3
11189_1,,,,2,1,2,3
11190_0,,,,2,1,2,3
11190_1,,,,2,1,2,3
11191_0,,,,2,1,2,3
11192_0,,,,2,1,2,3
11192_1,,,,2,1,2,3
11193_0,,,,2,1,2,3
11193_1,,,,2,1,2,3
11194_0,,,,2,1,2,3
11195_0,,,,2,1,2,3
11195_1,,,,2,1,2,3
11196_0,,,,2,1,2,3
11196_1,,,,2,1,2,3
11197_0,,,,2,1,2,3
11197_1,,,,2,1,2,3
11198_0,,,,2,1,2,3
11198_1,,,,2,1,2,3
11199_0,,,,2,1,2,3
11199_1,,,,2,1,2,3
11200_0,,,,2,1,2,3
11201_0,,,,2,1,2,3
11201_1,,,,2,1,2,3
11202_0,,,,2,1,2,3
11202_1,,,,2,1,2,3
11202_2,,,,2,1,2,3
11203_0,,,,2,1,2,3
11203_1,,,,2,1,2,3
11203_2,,,,2,1,2,3
11204_0,,,,2,1,2,3
11205_0,,,,2,1,2,3
11205_1,,,,2,1,2,3
11206_0,,,,2,1,2,3
11206_1,,,,2,1,2,3
11207_0,,,,2,1,2,3
11207_1,,,,2,1,2,3
11208_0,,,,2,1,2,3
11208_1,,,,2,1,2,3
11208_2,,,,2,1,2,3
11209_0,,,,2,1,2,3
11209_1,,,,2,1,2,3
11209_2,,,,2,1,2,3
11210_0,,,,2,1,2,3
11211_0,,,,2,1,2,3
11212_0,,,,2,1,2,3
11212_1,,,,2,1,2,3
11213_0,,,,2,1,2,3
11213_1,,,,2,1,2,3
11214_0,,,,2,1,2,3
11214_1,,,,2,1,2,3
11215_0,,,,2,1,2,3
11215_1,,,,2,1,2,3
11216_0,,,,2,1,2,3
11216_1,,,,2,1,2,3
11217_0,,,,2,1,2,3
11217_1,,,,2,1,2,3
11218_0,,,,2,1,2,3
11218_1,,,,2,1,2,3
11219_0,,,,2,1,2,3
11219_1,,,,2,1,2,3
11220_0,,,,2,1,2,3
11220_1,,,,2,1,2,3
11221_0,,,,2,1,2,3
11221_1,,,,2,1,2,3
11222_0,,,,2,1,2,3
11222_1,,,,2,1,2,3
11223_0,,,,2,1,2,3
11223_1,,,,2,1,2,3
11224_0,,,,2,1,2,3
11224_1,,,,2,1,2,3
11225_0,,,,2,1,2,3
11225_1,,,,2,1,2,3
11226_0,,,,2,1,2,3
11228_0,,,,2,1,2,3
C(C(CC(CO)O)O)=O,,,4,1,5,0,5
11229_0,,,,2,1,2,3
11230_0,,,,2,1,2,3
11231_0,,,,2,1,2,3
11231_1,,,,2,1,2,3
11232_0,,,,2,1,2,3
11232_1,,,,2,1,2,3
11233_0,,,,2,1,2,3
11234_0,,,,2,1,2,3
11234_1,,,,2,1,2,3
11235_0,,,,2,1,2,3
11235_1,,,,2,1,2,3
11236_0,,,,2,1,2,3
11236_1,,,,2,1,2,3
11237_0,,,,2,1,2,3
11237_1,,,,2,1,2,3
11238_0,,,,2,1,2,3
11238_1,,,,2,1,2,3
11238_2,,,,2,1,2,3
11239_0,,,,2,1,2,3
11239_1,,,,2,1,2,3
11239_2,,,,2,1,2,3
11241_0,,,,2,1,2,3
C(OCC(C)=O)=O,,,4,1,5,0,5
11241_1,,,,2,1,2,3
11242_0,,,,2,1,1,2
11243_0,,,,2,1,2,3
11243_1,,,,2,1,2,3
11245_0,,,,2,1,2,3
C(COCC(CO)=O)=O,,,4,1,2,0,2
11245_1,,,,2,1,2,3
11247_0,,,,2,1,2,3
C(COC(C(C)=O)O)=O,,,4,1,2,0,2
11247_1,,,,2,1,2,3
11249_0,,,,2,1,2,3
C(C(O)OCC(C)=O)=O,,,4,1,3,0,3
11249_1,,,,2,1,2,3
11250_0,,,,2,1,1,2
11252_0,,,,2,1,2,3
C(OCC=O)=O,,,4,1,6,0,6
11252_1,,,,2,1,2,3
11253_0,,,,2,1,2,3
11254_0,,,,2,1,2,3
11255_0,,,,2,1,2,3
11255_1,,,,2,1,2,3
11256_0,,,,2,1,2,3
11257_0,,,,2,1,2,3
11258_0,,,,2,1,2,3
11259_0,,,,2,1,2,3
11260_0,,,,2,1,2,3
11262_0,,,,2,1,2,3
C(CO)(OCC=O)=O,,,4,1,6,0,6
11264_0,,,,2,1,2,3
C(COC(C)=O)=O,,,4,1,2,0,2
11264_1,,,,2,1,2,3
11266_0,,,,2,1,2,3
C(COC(C(CO)=O)O)=O,,,4,1,2,0,2
11266_1,,,,2,1,2,3
11268_0,,,,2,1,2,3
C(COC(C=O)O)=O,,,4,1,2,0,2
11268_1,,,,2,1,2,3
11269_0,,,,2,1,1,2
11269_1,,,,2,1,1,2
11270_0,,,,2,1,2,3
11270_1,,,,2,1,2,3
11271_0,,,,2,1,2,3
11272_0,,,,2,1,2,3
11273_0,,,,2,1,2,3
11275_0,,,,2,1,2,3
C(C(C(CCO)O)=O)=O,,,4,1,2,0,2
11276_0,,,,2,1,2,3
11277_0,,,,2,1,2,3
11277_1,,,,2,1,2,3
11278_0,,,,2,1,2,3
11278_1,,,,2,1,2,3
11279_0,,,,2,1,2,3
11279_1,,,,2,1,2,3
11280_0,,,,2,1,2,3
11281_0,,,,2,1,2,3
11283_0,,,,2,1,2,3
C(C(CO)=O)(CO)=O,,,4,1,10,0,10
11283_1,,,,2,1,2,3
11285_0,,,,2,1,2,3
C(CO)(C(CCO)O)=O,,,4,1,6,0,6
11285_1,,,,2,1,2,3
11286_0,,,,2,1,2,3
11286_1,,,,2,1,2,3
11287_0,,,,2,1,2,3
11287_1,,,,2,1,2,3
11289_0,,,,2,1,2,3
C(CC(C(CO)=O)O)(O)=O,,,4,1,3,0,3
11289_1,,,,2,1,2,3
11290_0,,,,2,1,2,3
11290_1,,,,2,1,2,3
11291_0,,,,2,1,2,3
11291_1,,,,2,1,2,3
11292_0,,,,2,1,2,3
11292_1,,,,2,1,2,3
11293_0,,,,2,1,2,3
11293_1,,,,2,1,2,3
11294_0,,,,2,1,2,3
11294_1,,,,2,1,2,3
11295_0,,,,2,1,2,3
11296_0,,,,2,1,2,3
11297_0,,,,2,1,2,3
11298_0,,,,2,1,2,3
11299_0,,,,2,1,2,3
11300_0,,,,2,1,2,3
11302_0,,,,2,1,2,3
C(CCC(C=O)=O)=O,,,4,1,3,0,3
11304_0,,,,2,1,2,3
C(CCC=O)=O,,,4,1,2,0,2
11305_0,,,,2,1,2,3
11305_1,,,,2,1,2,3
11307_0,,,,2,1,2,3
C1(COC(CC1O)O)=O,,,4,1,3,0,3
11307_1,,,,2,1,2,3
11309_0,,,,2,1,1,2
C(CO)(C(COCC=O)O)=O,,,4,1,2,0,2
11309_1,,,,2,1,1,2
11311_0,,,,2,1,1,2
C(OCCC(C(CO)=O)O)=O,,,4,1,2,0,2
11311_1,,,,2,1,1,2
11313_0,,,,2,1,2,3
C(C)(C(C)O)=O,,,4,1,1,0,1
11314_0,,,,2,1,2,3
11316_0,,,,2,1,2,3
C(C(C(C(C)=O)=O)O)=O,,,4,1,4,0,4
11317_0,,,,2,1,2,3
11318_0,,,,2,1,2,3
11319_0,,,,2,1,2,3
11320_0,,,,2,1,2,3
11322_0,,,,2,1,2,3
C(CO)=CC(C=O)=O,,,4,1,2,0,2
11324_0,,,,2,1,2,3
C(CO)=CC=O,,,4,1,7,0,7
11326_0,,,,2,1,1,2
C(CC(OCC(CO)=O)O)=O,,,4,1,4,0,4
11326_1,,,,2,1,1,2
11328_0,,,,2,1,1,2
C(OC(C(CO)=O)C(CO)O)=O,,,4,1,2,0,2
11328_1,,,,2,1,1,2
11330_0,,,,2,1,2,3
C1(COC(C1O)O)=O,,,4,1,4,0,4
11330_1,,,,2,1,2,3
11332_0,,,,2,1,1,2
C(OC(CO)C(C(CO)=O)O)=O,,,4,1,2,0,2
11332_1,,,,2,1,1,2
11334_0,,,,2,1,1,2
C(OCC(C(C(CO)=O)O)O)=O,,,4,1,2,0,2
11334_1,,,,2,1,1,2
11336_0,,,,2,1,1,2
C(CO)(C(C(OCC=O)O)O)=O,,,4,1,2,0,2
11336_1,,,,2,1,1,2
11337_0,,,,2,1,2,3
11337_1,,,,2,1,2,3
11338_0,,,,2,1,2,3
11339_0,,,,2,1,2,3
11340_0,,,,2,1,2,3
11341_0,,,,2,1,2,3
11342_0,,,,2,1,2,3
11342_1,,,,2,1,2,3
11343_0,,,,2,1,2,3
11343_1,,,,2,1,2,3
11344_0,,,,2,1,2,3
11345_0,,,,2,1,2,3
11346_0,,,,2,1,2,3
11347_0,,,,2,1,2,3
11348_0,,,,2,1,2,3
11348_1,,,,2,1,2,3
11349_0,,,,2,1,2,3
11349_1,,,,2,1,2,3
11350_0,,,,2,1,2,3
11350_1,,,,2,1,2,3
11351_0,,,,2,1,2,3
11352_0,,,,2,1,2,3
11352_1,,,,2,1,2,3
11354_0,,,,2,1,2,3
C(C)(CC(C(O)=O)=O)=O,,,4,1,4,0,4
11355_0,,,,2,1,2,3
11356_0,,,,2,1,2,3
11358_0,,,,2,1,2,3
C(CC(C(O)=O)=O)=O,,,4,1,5,0,5
11359_0,,,,2,1,2,3
11360_0,,,,2,1,2,3
11360_1,,,,2,1,2,3
11361_0,,,,2,1,2,3
11362_0,,,,2,1,2,3
11362_1,,,,2,1,2,3
11363_0,,,,2,1,2,3
11363_1,,,,2,1,2,3
11364_0,,,,2,1,2,3
11364_1,,,,2,1,2,3
11365_0,,,,2,1,2,3
11366_0,,,,2,1,2,3
11366_1,,,,2,1,2,3
11367_0,,,,2,1,2,3
11367_1,,,,2,1,2,3
11368_0,,,,2,1,2,3
11369_0,,,,2,1,2,3
11371_0,,,,2,1,2,3
C(CC(C)=O)(O)=O,,,4,1,3,0,3
11372_0,,,,2,1,2,3
11372_1,,,,2,1,2,3
11373_0,,,,2,1,2,3
11373_1,,,,2,1,2,3
11375_0,,,,2,1,2,3
C(C(C(C)=O)=O)(O)=O,,,4,1,3,0,3
11377_0,,,,2,1,2,3
C(CO)(CC(C(O)=O)=O)=O,,,4,1,5,0,5
11377_1,,,,2,1,2,3
11379_0,,,,2,1,2,3
C(C)(C(C(C(O)=O)=O)O)=O,,,4,1,3,0,3
11381_0,,,,2,1,2,3
C(C(C(O)=O)=O)=O,,,4,1,4,0,4
11382_0,,,,2,1,2,3
11382_1,,,,2,1,2,3
11383_0,,,,2,1,2,3
11383_1,,,,2,1,2,3
11384_0,,,,2,1,2,3
11384_1,,,,2,1,2,3
11386_0,,,,2,1,2,3
C(C(C(C(O)=O)=O)O)=O,,,4,1,3,0,3
11387_0,,,,2,1,2,3
11388_0,,,,2,1,2,3
11388_1,,,,2,1,2,3
11389_0,,,,2,1,2,3
11389_1,,,,2,1,2,3
11391_0,,,,2,1,2,3
C(C=CC(CO)=O)(O)=O,,,4,1,4,0,4
11391_1,,,,2,1,2,3
11392_0,,,,2,1,2,3
11392_1,,,,2,1,2,3
11394_0,,,,2,1,2,3
C(C=CC(O)=O)=O,,,4,1,6,0,6
11394_1,,,,2,1,2,3
11395_0,,,,2,1,2,3
11395_1,,,,2,1,2,3
11396_0,,,,2,1,1,2
11396_1,,,,2,1,1,2
11396_2,,,,2,1,1,2
11397_0,,,,2,1,2,3
11397_1,,,,2,1,2,3
11397_2,,,,2,1,2,3
11398_0,,,,2,1,1,2
11398_1,,,,2,1,1,2
11398_2,,,,2,1,1,2
11400_0,,,,2,1,1,2
C(CO)(CC(C(CO)=O)=O)=O,,,4,1,5,0,5
11400_1,,,,2,1,1,2
11401_0,,,,2,1,1,2
11401_1,,,,2,1,1,2
11401_2,,,,2,1,1,2
11402_0,,,,2,1,2,3
11402_1,,,,2,1,2,3
11402_2,,,,2,1,2,3
11403_0,,,,2,1,1,2
11403_1,,,,2,1,1,2
11403_2,,,,2,1,1,2
11404_0,,,,2,1,2,3
11404_1,,,,2,1,2,3
11404_2,,,,2,1,2,3
11405_0,,,,2,1,1,2
11405_1,,,,2,1,1,2
11405_2,,,,2,1,1,2
11407_0,,,,2,1,1,2
C(CO)(C(CO)(CO)C(C=O)O)=O,,,4,1,4,0,4
11407_1,,,,2,1,1,2
11408_0,,,,2,1,1,2
11408_1,,,,2,1,1,2
11409_0,,,,2,1,2,3
11409_1,,,,2,1,2,3
11410_0,,,,2,1,1,2
11411_0,,,,2,1,1,2
11411_1,,,,2,1,1,2
11411_2,,,,2,1,1,2
11412_0,,,,2,1,2,3
11412_1,,,,2,1,2,3
11412_2,,,,2,1,2,3
11413_0,,,,2,1,1,2
11413_1,,,,2,1,1,2
11414_0,,,,2,1,2,3
11414_1,,,,2,1,2,3
11415_0,,,,2,1,2,3
11415_1,,,,2,1,2,3
11415_2,,,,2,1,2,3
11416_0,,,,2,1,2,3
11416_1,,,,2,1,2,3
11416_2,,,,2,1,2,3
11417_0,,,,2,1,2,3
11417_1,,,,2,1,2,3
11417_2,,,,2,1,2,3
11418_0,,,,2,1,2,3
11418_1,,,,2,1,2,3
11418_2,,,,2,1,2,3
11419_0,,,,2,1,2,3
11419_1,,,,2,1,2,3
11419_2,,,,2,1,2,3
11420_0,,,,2,1,2,3
11420_1,,,,2,1,2,3
11420_2,,,,2,1,2,3
11421_0,,,,2,1,2,3
11421_1,,,,2,1,2,3
11421_2,,,,2,1,2,3
11422_0,,,,2,1,2,3
11422_1,,,,2,1,2,3
11422_2,,,,2,1,2,3
11423_0,,,,2,1,2,3
11423_1,,,,2,1,2,3
11423_2,,,,2,1,2,3
11424_0,,,,2,1,2,3
11424_1,,,,2,1,2,3
11424_2,,,,2,1,2,3
11425_0,,,,2,1,2,3
11425_1,,,,2,1,2,3
11426_0,,,,2,1,2,3
11426_1,,,,2,1,2,3
11426_2,,,,2,1,2,3
11427_0,,,,2,1,2,3
11427_1,,,,2,1,2,3
11427_2,,,,2,1,2,3
11428_0,,,,2,1,2,3
11429_0,,,,2,1,2,3
11429_1,,,,2,1,2,3
11429_2,,,,2,1,2,3
11430_0,,,,2,1,2,3
11430_1,,,,2,1,2,3
11430_2,,,,2,1,2,3
11432_0,,,,2,1,2,3
C(C(C(CO)=O)(CO)O)=O,,,4,1,5,0,5
11433_0,,,,2,1,2,3
11433_1,,,,2,1,2,3
11433_2,,,,2,1,2,3
11434_0,,,,2,1,2,3
11434_1,,,,2,1,2,3
11434_2,,,,2,1,2,3
11435_0,,,,2,1,2,3
11435_1,,,,2,1,2,3
11435_2,,,,2,1,2,3
11436_0,,,,2,1,2,3
11436_1,,,,2,1,2,3
11437_0,,,,2,1,2,3
11437_1,,,,2,1,2,3
11437_2,,,,2,1,2,3
11438_0,,,,2,1,2,3
11438_1,,,,2,1,2,3
11438_2,,,,2,1,2,3
11439_0,,,,2,1,2,3
11439_1,,,,2,1,2,3
11440_0,,,,2,1,2,3
11440_1,,,,2,1,2,3
11440_2,,,,2,1,2,3
11441_0,,,,2,1,2,3
11441_1,,,,2,1,2,3
11441_2,,,,2,1,2,3
11442_0,,,,2,1,2,3
11442_1,,,,2,1,2,3
11442_2,,,,2,1,2,3
11443_0,,,,2,1,2,3
11443_1,,,,2,1,2,3
11443_2,,,,2,1,2,3
11444_0,,,,2,1,2,3
11444_1,,,,2,1,2,3
11444_2,,,,2,1,2,3
11445_0,,,,2,1,2,3
11445_1,,,,2,1,2,3
11445_2,,,,2,1,2,3
11446_0,,,,2,1,2,3
11446_1,,,,2,1,2,3
11446_2,,,,2,1,2,3
11447_0,,,,2,1,2,3
11447_1,,,,2,1,2,3
11448_0,,,,2,1,2,3
11448_1,,,,2,1,2,3
11448_2,,,,2,1,2,3
11449_0,,,,2,1,2,3
11449_1,,,,2,1,2,3
11449_2,,,,2,1,2,3
11450_0,,,,2,1,2,3
11450_1,,,,2,1,2,3
11450_2,,,,2,1,2,3
11451_0,,,,2,1,2,3
11451_1,,,,2,1,2,3
11451_2,,,,2,1,2,3
11452_0,,,,2,1,2,3
11452_1,,,,2,1,2,3
11452_2,,,,2,1,2,3
11453_0,,,,2,1,2,3
11453_1,,,,2,1,2,3
11454_0,,,,2,1,2,3
11454_1,,,,2,1,2,3
11454_2,,,,2,1,2,3
11455_0,,,,2,1,2,3
11455_1,,,,2,1,2,3
11455_2,,,,2,1,2,3
11456_0,,,,2,1,2,3
11456_1,,,,2,1,2,3
11456_2,,,,2,1,2,3
11457_0,,,,2,1,2,3
11457_1,,,,2,1,2,3
11457_2,,,,2,1,2,3
11458_0,,,,2,1,2,3
11459_0,,,,2,1,2,3
11459_1,,,,2,1,2,3
11459_2,,,,2,1,2,3
11460_0,,,,2,1,2,3
11460_1,,,,2,1,2,3
11460_2,,,,2,1,2,3
11461_0,,,,2,1,2,3
11461_1,,,,2,1,2,3
11461_2,,,,2,1,2,3
11462_0,,,,2,1,2,3
11462_1,,,,2,1,2,3
11462_2,,,,2,1,2,3
11463_0,,,,2,1,2,3
11463_1,,,,2,1,2,3
11463_2,,,,2,1,2,3
11464_0,,,,2,1,2,3
11464_1,,,,2,1,2,3
11464_2,,,,2,1,2,3
11465_0,,,,2,1,2,3
11465_1,,,,2,1,2,3
11466_0,,,,2,1,2,3
11466_1,,,,2,1,2,3
11466_2,,,,2,1,2,3
11467_0,,,,2,1,2,3
11467_1,,,,2,1,2,3
11468_0,,,,2,1,2,3
11468_1,,,,2,1,2,3
11468_2,,,,2,1,2,3
11469_0,,,,2,1,2,3
11469_1,,,,2,1,2,3
11470_0,,,,2,1,2,3
11470_1,,,,2,1,2,3
11470_2,,,,2,1,2,3
11471_0,,,,2,1,2,3
11471_1,,,,2,1,2,3
11471_2,,,,2,1,2,3
11472_0,,,,2,1,2,3
11472_1,,,,2,1,2,3
11473_0,,,,2,1,2,3
11473_1,,,,2,1,2,3
11473_2,,,,2,1,2,3
11474_0,,,,2,1,2,3
11474_1,,,,2,1,2,3
11474_2,,,,2,1,2,3
11475_0,,,,2,1,2,3
11475_1,,,,2,1,2,3
11476_0,,,,2,1,2,3
11476_1,,,,2,1,2,3
11476_2,,,,2,1,2,3
11477_0,,,,2,1,2,3
11477_1,,,,2,1,2,3
11478_0,,,,2,1,2,3
11478_1,,,,2,1,2,3
11478_2,,,,2,1,2,3
11479_0,,,,2,1,2,3
11479_1,,,,2,1,2,3
11480_0,,,,2,1,2,3
11480_1,,,,2,1,2,3
11480_2,,,,2,1,2,3
11481_0,,,,2,1,2,3
11481_1,,,,2,1,2,3
11481_2,,,,2,1,2,3
11482_0,,,,2,1,2,3
11482_1,,,,2,1,2,3
11483_0,,,,2,1,2,3
11483_1,,,,2,1,2,3
11484_0,,,,2,1,2,3
11484_1,,,,2,1,2,3
11484_2,,,,2,1,2,3
11485_0,,,,2,1,2,3
11485_1,,,,2,1,2,3
11485_2,,,,2,1,2,3
11486_0,,,,2,1,2,3
11486_1,,,,2,1,2,3
11487_0,,,,2,1,2,3
11487_1,,,,2,1,2,3
11488_0,,,,2,1,2,3
11488_1,,,,2,1,2,3
11488_2,,,,2,1,2,3
11489_0,,,,2,1,2,3
11489_1,,,,2,1,2,3
11489_2,,,,2,1,2,3
11490_0,,,,2,1,2,3
11490_1,,,,2,1,2,3
11491_0,,,,2,1,2,3
11491_1,,,,2,1,2,3
11491_2,,,,2,1,2,3
11492_0,,,,2,1,2,3
11492_1,,,,2,1,2,3
11492_2,,,,2,1,2,3
11494_0,,,,2,1,2,3
C(C(C(CO)=O)=O)=O,,,4,1,8,0,8
11494_1,,,,2,1,2,3
11495_0,,,,2,1,2,3
11496_0,,,,2,1,2,3
11496_1,,,,2,1,2,3
11496_2,,,,2,1,2,3
11497_0,,,,2,1,2,3
11497_1,,,,2,1,2,3
11497_2,,,,2,1,2,3
11498_0,,,,2,1,2,3
11498_1,,,,2,1,2,3
11500_0,,,,2,1,2,3
C(C(C(CO)=O)(C)O)=O,,,4,1,2,0,2
11501_0,,,,2,1,2,3
11501_1,,,,2,1,2,3
11501_2,,,,2,1,2,3
11502_0,,,,2,1,2,3
11502_1,,,,2,1,2,3
11502_2,,,,2,1,2,3
11504_0,,,,2,1,2,3
C(C(C=O)(C=O)O)=O,,,4,1,5,0,5
11505_0,,,,2,1,2,3
11505_1,,,,2,1,2,3
11505_2,,,,2,1,2,3
11507_0,,,,2,1,2,3
C(C(C=O)(C(CO)=O)O)=O,,,4,1,2,0,2
11508_0,,,,2,1,2,3
11508_1,,,,2,1,2,3
11508_2,,,,2,1,2,3
11509_0,,,,2,1,2,3
11509_1,,,,2,1,2,3
11509_2,,,,2,1,2,3
11510_0,,,,2,1,2,3
11510_1,,,,2,1,2,3
11511_0,,,,2,1,2,3
11511_1,,,,2,1,2,3
11511_2,,,,2,1,2,3
11512_0,,,,2,1,2,3
11512_1,,,,2,1,2,3
11513_0,,,,2,1,2,3
11513_1,,,,2,1,2,3
11513_2,,,,2,1,2,3
11515_0,,,,2,1,2,3
C(C(C=O)(C(C)=O)O)=O,,,4,1,5,0,5
11515_1,,,,2,1,2,3
11516_0,,,,2,1,2,3
11516_1,,,,2,1,2,3
11516_2,,,,2,1,2,3
11517_0,,,,2,1,2,3
11517_1,,,,2,1,2,3
11517_2,,,,2,1,2,3
11518_0,,,,2,1,2,3
11518_1,,,,2,1,2,3
11519_0,,,,2,1,2,3
11519_1,,,,2,1,2,3
11519_2,,,,2,1,2,3
11520_0,,,,2,1,2,3
11520_1,,,,2,1,2,3
11520_2,,,,2,1,2,3
11521_0,,,,2,1,2,3
11521_1,,,,2,1,2,3
11521_2,,,,2,1,2,3
11522_0,,,,2,1,2,3
11522_1,,,,2,1,2,3
11523_0,,,,2,1,2,3
11523_1,,,,2,1,2,3
11523_2,,,,2,1,2,3
11524_0,,,,2,1,2,3
11524_1,,,,2,1,2,3
11524_2,,,,2,1,2,3
11525_0,,,,2,1,2,3
11525_1,,,,2,1,2,3
11525_2,,,,2,1,2,3
11526_0,,,,2,1,2,3
11526_1,,,,2,1,2,3
11527_0,,,,2,1,2,3
11527_1,,,,2,1,2,3
11527_2,,,,2,1,2,3
11528_0,,,,2,1,2,3
11528_1,,,,2,1,2,3
11529_0,,,,2,1,2,3
11529_1,,,,2,1,2,3
11529_2,,,,2,1,2,3
11530_0,,,,2,1,2,3
11530_1,,,,2,1,2,3
11531_0,,,,2,1,2,3
11531_1,,,,2,1,2,3
11531_2,,,,2,1,2,3
11532_0,,,,2,1,2,3
11532_1,,,,2,1,2,3
11533_0,,,,2,1,2,3
11533_1,,,,2,1,2,3
11533_2,,,,2,1,2,3
11534_0,,,,2,1,2,3
11534_1,,,,2,1,2,3
11534_2,,,,2,1,2,3
11535_0,,,,2,1,2,3
11535_1,,,,2,1,2,3
11536_0,,,,2,1,2,3
11536_1,,,,2,1,2,3
11537_0,,,,2,1,2,3
11538_0,,,,2,1,2,3
11538_1,,,,2,1,2,3
11538_2,,,,2,1,2,3
11539_0,,,,2,1,2,3
11539_1,,,,2,1,2,3
11539_2,,,,2,1,2,3
11540_0,,,,2,1,2,3
11540_1,,,,2,1,2,3
11540_2,,,,2,1,2,3
11541_0,,,,2,1,2,3
11541_1,,,,2,1,2,3
11541_2,,,,2,1,2,3
11542_0,,,,2,1,2,3
11542_1,,,,2,1,2,3
11542_2,,,,2,1,2,3
11543_0,,,,2,1,2,3
11543_1,,,,2,1,2,3
11543_2,,,,2,1,2,3
11544_0,,,,2,1,2,3
11544_1,,,,2,1,2,3
11545_0,,,,2,1,2,3
11545_1,,,,2,1,2,3
11545_2,,,,2,1,2,3
11546_0,,,,2,1,2,3
11546_1,,,,2,1,2,3
11546_2,,,,2,1,2,3
11547_0,,,,2,1,2,3
11547_1,,,,2,1,2,3
11547_2,,,,2,1,2,3
11548_0,,,,2,1,2,3
11548_1,,,,2,1,2,3
11548_2,,,,2,1,2,3
11549_0,,,,2,1,2,3
11549_1,,,,2,1,2,3
11549_2,,,,2,1,2,3
11550_0,,,,2,1,2,3
11550_1,,,,2,1,2,3
11550_2,,,,2,1,2,3
11551_0,,,,2,1,2,3
11551_1,,,,2,1,2,3
11552_0,,,,2,1,2,3
11552_1,,,,2,1,2,3
11552_2,,,,2,1,2,3
11553_0,,,,2,1,2,3
11553_1,,,,2,1,2,3
11553_2,,,,2,1,2,3
11554_0,,,,2,1,2,3
11554_1,,,,2,1,2,3
11554_2,,,,2,1,2,3
11555_0,,,,2,1,2,3
11555_1,,,,2,1,2,3
11555_2,,,,2,1,2,3
11556_0,,,,2,1,2,3
11556_1,,,,2,1,2,3
11556_2,,,,2,1,2,3
11557_0,,,,2,1,2,3
11557_1,,,,2,1,2,3
11557_2,,,,2,1,2,3
11558_0,,,,2,1,2,3
11559_0,,,,2,1,2,3
11559_1,,,,2,1,2,3
11559_2,,,,2,1,2,3
11560_0,,,,2,1,2,3
11560_1,,,,2,1,2,3
11560_2,,,,2,1,2,3
11561_0,,,,2,1,2,3
11561_1,,,,2,1,2,3
11561_2,,,,2,1,2,3
11563_0,,,,2,1,2,3
C(C)(C(C(CO)=O)(CO)O)=O,,,4,1,5,0,5
11564_0,,,,2,1,2,3
11564_1,,,,2,1,2,3
11564_2,,,,2,1,2,3
11565_0,,,,2,1,2,3
11565_1,,,,2,1,2,3
11565_2,,,,2,1,2,3
11566_0,,,,2,1,2,3
11566_1,,,,2,1,2,3
11566_2,,,,2,1,2,3
11567_0,,,,2,1,2,3
11567_1,,,,2,1,2,3
11569_0,,,,2,1,2,3
C(C(CO)=O)(C(C)O)=O,,,4,1,4,0,4
11569_1,,,,2,1,2,3
11570_0,,,,2,1,2,3
11570_1,,,,2,1,2,3
11570_2,,,,2,1,2,3
11571_0,,,,2,1,2,3
11571_1,,,,2,1,2,3
11571_2,,,,2,1,2,3
11572_0,,,,2,1,2,3
11572_1,,,,2,1,2,3
11572_2,,,,2,1,2,3
11573_0,,,,2,1,2,3
11573_1,,,,2,1,2,3
11573_2,,,,2,1,2,3
11574_0,,,,2,1,2,3
11575_0,,,,2,1,2,3
11576_0,,,,2,1,2,3
11576_1,,,,2,1,2,3
11576_2,,,,2,1,2,3
11577_0,,,,2,1,2,3
11577_1,,,,2,1,2,3
11577_2,,,,2,1,2,3
11578_0,,,,2,1,2,3
11578_1,,,,2,1,2,3
11578_2,,,,2,1,2,3
11579_0,,,,2,1,2,3
11580_0,,,,2,1,2,3
11580_1,,,,2,1,2,3
11580_2,,,,2,1,2,3
11581_0,,,,2,1,2,3
11581_1,,,,2,1,2,3
11581_2,,,,2,1,2,3
11582_0,,,,2,1,2,3
11582_1,,,,2,1,2,3
11582_2,,,,2,1,2,3
11583_0,,,,2,1,2,3
11583_1,,,,2,1,2,3
11583_2,,,,2,1,2,3
11584_0,,,,2,1,2,3
11584_1,,,,2,1,2,3
11584_2,,,,2,1,2,3
11585_0,,,,2,1,2,3
11585_1,,,,2,1,2,3
11585_2,,,,2,1,2,3
11587_0,,,,2,1,1,2
C(OC(C(C)=O)(CO)C(CO)O)=O,,,4,1,3,0,3
11588_0,,,,2,1,2,3
11588_1,,,,2,1,2,3
11588_2,,,,2,1,2,3
11589_0,,,,2,1,2,3
11589_1,,,,2,1,2,3
11589_2,,,,2,1,2,3
11590_0,,,,2,1,2,3
11590_1,,,,2,1,2,3
11590_2,,,,2,1,2,3
11591_0,,,,2,1,1,2
11591_1,,,,2,1,1,2
11591_2,,,,2,1,1,2
11592_0,,,,2,1,2,3
11592_1,,,,2,1,2,3
11592_2,,,,2,1,2,3
11593_0,,,,2,1,1,2
11593_1,,,,2,1,1,2
11593_2,,,,2,1,1,2
11595_0,,,,2,1,1,2
C(OC(CO)C(C(C)=O)(CO)O)=O,,,4,1,3,0,3
11596_0,,,,2,1,2,3
11596_1,,,,2,1,2,3
11596_2,,,,2,1,2,3
11597_0,,,,2,1,2,3
11597_1,,,,2,1,2,3
11597_2,,,,2,1,2,3
11598_0,,,,2,1,1,2
11598_1,,,,2,1,1,2
11598_2,,,,2,1,1,2
11600_0,,,,2,1,1,2
C(C)(C(CO)(CO)OC(C=O)O)=O,,,4,1,3,0,3
11601_0,,,,2,1,2,3
11601_1,,,,2,1,2,3
11601_2,,,,2,1,2,3
11602_0,,,,2,1,2,3
11602_1,,,,2,1,2,3
11602_2,,,,2,1,2,3
11603_0,,,,2,1,1,2
11603_1,,,,2,1,1,2
11603_2,,,,2,1,1,2
11605_0,,,,2,1,1,2
C(OCC(C(C(C)=O)(CO)O)O)=O,,,4,1,3,0,3
11606_0,,,,2,1,2,3
11606_1,,,,2,1,2,3
11606_2,,,,2,1,2,3
11607_0,,,,2,1,1,2
11607_1,,,,2,1,1,2
11607_2,,,,2,1,1,2
11608_0,,,,2,1,2,3
11608_1,,,,2,1,2,3
11608_2,,,,2,1,2,3
11609_0,,,,2,1,1,2
11609_1,,,,2,1,1,2
11609_2,,,,2,1,1,2
11611_0,,,,2,1,1,2
C(C)(C(C(OCC=O)O)(CO)O)=O,,,4,1,3,0,3
11613_0,,,,2,1,1,2
C(C)(C(CO)(COC(C=O)O)O)=O,,,4,1,3,0,3
11614_0,,,,2,1,2,3
11614_1,,,,2,1,2,3
11614_2,,,,2,1,2,3
11615_0,,,,2,1,2,3
11615_1,,,,2,1,2,3
11615_2,,,,2,1,2,3
11616_0,,,,2,1,1,2
11616_1,,,,2,1,1,2
11616_2,,,,2,1,1,2
11617_0,,,,2,1,2,3
11617_1,,,,2,1,2,3
11617_2,,,,2,1,2,3
11618_0,,,,2,1,2,3
11619_0,,,,2,1,2,3
11619_1,,,,2,1,2,3
11619_2,,,,2,1,2,3
11621_0,,,,2,1,2,3
C(C)(C(C(C=O)=O)(CO)O)=O,,,4,1,5,0,5
11622_0,,,,2,1,2,3
11623_0,,,,2,1,2,3
11623_1,,,,2,1,2,3
11624_0,,,,2,1,2,3
11624_1,,,,2,1,2,3
11624_2,,,,2,1,2,3
11625_0,,,,2,1,2,3
11625_1,,,,2,1,2,3
11625_2,,,,2,1,2,3
11626_0,,,,2,1,2,3
11627_0,,,,2,1,2,3
11627_1,,,,2,1,2,3
11627_2,,,,2,1,2,3
11628_0,,,,2,1,2,3
11628_1,,,,2,1,2,3
11628_2,,,,2,1,2,3
11629_0,,,,2,1,2,3
11630_0,,,,2,1,2,3
11630_1,,,,2,1,2,3
11630_2,,,,2,1,2,3
11631_0,,,,2,1,2,3
11631_1,,,,2,1,2,3
11631_2,,,,2,1,2,3
11632_0,,,,2,1,2,3
11632_1,,,,2,1,2,3
11632_2,,,,2,1,2,3
11633_0,,,,2,1,2,3
11633_1,,,,2,1,2,3
11633_2,,,,2,1,2,3
11634_0,,,,2,1,2,3
11634_1,,,,2,1,2,3
11636_0,,,,2,1,2,3
C=CC(C(CO)=O)=O,,,4,1,2,0,2
11636_1,,,,2,1,2,3
11637_0,,,,2,1,2,3
11637_1,,,,2,1,2,3
11637_2,,,,2,1,2,3
11638_0,,,,2,1,2,3
11638_1,,,,2,1,2,3
11638_2,,,,2,1,2,3
11639_0,,,,2,1,2,3
11639_1,,,,2,1,2,3
11639_2,,,,2,1,2,3
11640_0,,,,2,1,2,3
11640_1,,,,2,1,2,3
11640_2,,,,2,1,2,3
11641_0,,,,2,1,2,3
11641_1,,,,2,1,2,3
11641_2,,,,2,1,2,3
11642_0,,,,2,1,2,3
11642_1,,,,2,1,2,3
11642_2,,,,2,1,2,3
11643_0,,,,2,1,2,3
11643_1,,,,2,1,2,3
11643_2,,,,2,1,2,3
11644_0,,,,2,1,1,2
11644_1,,,,2,1,1,2
11644_2,,,,2,1,1,2
11645_0,,,,2,1,2,3
11645_1,,,,2,1,2,3
11645_2,,,,2,1,2,3
11646_0,,,,2,1,1,2
11646_1,,,,2,1,1,2
11646_2,,,,2,1,1,2
11647_0,,,,2,1,2,3
11647_1,,,,2,1,2,3
11647_2,,,,2,1,2,3
11648_0,,,,2,1,2,3
11648_1,,,,2,1,2,3
11648_2,,,,2,1,2,3
11649_0,,,,2,1,1,2
11649_1,,,,2,1,1,2
11649_2,,,,2,1,1,2
11650_0,,,,2,1,2,3
11651_0,,,,2,1,2,3
11651_1,,,,2,1,2,3
11651_2,,,,2,1,2,3
11652_0,,,,2,1,2,3
11652_1,,,,2,1,2,3
11653_0,,,,2,1,2,3
11654_0,,,,2,1,2,3
11654_1,,,,2,1,2,3
11654_2,,,,2,1,2,3
11655_0,,,,2,1,2,3
11655_1,,,,2,1,2,3
11656_0,,,,2,1,2,3
11656_1,,,,2,1,2,3
11656_2,,,,2,1,2,3
11657_0,,,,2,1,2,3
11657_1,,,,2,1,2,3
11657_2,,,,2,1,2,3
11658_0,,,,2,1,2,3
11658_1,,,,2,1,2,3
11658_2,,,,2,1,2,3
11659_0,,,,2,1,2,3
11659_1,,,,2,1,2,3
11659_2,,,,2,1,2,3
11660_0,,,,2,1,2,3
11660_1,,,,2,1,2,3
11662_0,,,,2,1,2,3
C(C(C)=O)(C(C)O)=O,,,4,1,3,0,3
11662_1,,,,2,1,2,3
11663_0,,,,2,1,2,3
11663_1,,,,2,1,2,3
11663_2,,,,2,1,2,3
11664_0,,,,2,1,2,3
11664_1,,,,2,1,2,3
11664_2,,,,2,1,2,3
11665_0,,,,2,1,2,3
11665_1,,,,2,1,2,3
11666_0,,,,2,1,2,3
11666_1,,,,2,1,2,3
11666_2,,,,2,1,2,3
11667_0,,,,2,1,2,3
11667_1,,,,2,1,2,3
11667_2,,,,2,1,2,3
11668_0,,,,2,1,2,3
11668_1,,,,2,1,2,3
11668_2,,,,2,1,2,3
11669_0,,,,2,1,2,3
11670_0,,,,2,1,2,3
11670_1,,,,2,1,2,3
11670_2,,,,2,1,2,3
11671_0,,,,2,1,2,3
11671_1,,,,2,1,2,3
11671_2,,,,2,1,2,3
11672_0,,,,2,1,2,3
11672_1,,,,2,1,2,3
11672_2,,,,2,1,2,3
11673_0,,,,2,1,2,3
11673_1,,,,2,1,2,3
11674_0,,,,2,1,2,3
11674_1,,,,2,1,2,3
11674_2,,,,2,1,2,3
11675_0,,,,2,1,2,3
11675_1,,,,2,1,2,3
11675_2,,,,2,1,2,3
11676_0,,,,2,1,2,3
11676_1,,,,2,1,2,3
11676_2,,,,2,1,2,3
11677_0,,,,2,1,2,3
11677_1,,,,2,1,2,3
11677_2,,,,2,1,2,3
11678_0,,,,2,1,2,3
11678_1,,,,2,1,2,3
11678_2,,,,2,1,2,3
11679_0,,,,2,1,2,3
11679_1,,,,2,1,2,3
11680_0,,,,2,1,2,3
11680_1,,,,2,1,2,3
11680_2,,,,2,1,2,3
11681_0,,,,2,1,2,3
11681_1,,,,2,1,2,3
11681_2,,,,2,1,2,3
11683_0,,,,2,1,2,3
C(CO)(C(CO)(C)O)=O,,,4,1,5,0,5
11684_0,,,,2,1,2,3
11684_1,,,,2,1,2,3
11684_2,,,,2,1,2,3
11685_0,,,,2,1,2,3
11685_1,,,,2,1,2,3
11685_2,,,,2,1,2,3
11686_0,,,,2,1,2,3
11686_1,,,,2,1,2,3
11686_2,,,,2,1,2,3
11687_0,,,,2,1,2,3
11687_1,,,,2,1,2,3
11687_2,,,,2,1,2,3
11688_0,,,,2,1,2,3
11688_1,,,,2,1,2,3
11689_0,,,,2,1,2,3
11689_1,,,,2,1,2,3
11689_2,,,,2,1,2,3
11690_0,,,,2,1,2,3
11690_1,,,,2,1,2,3
11690_2,,,,2,1,2,3
11691_0,,,,2,1,2,3
11691_1,,,,2,1,2,3
11691_2,,,,2,1,2,3
11692_0,,,,2,1,2,3
11692_1,,,,2,1,2,3
11692_2,,,,2,1,2,3
11693_0,,,,2,1,2,3
11693_1,,,,2,1,2,3
11693_2,,,,2,1,2,3
11694_0,,,,2,1,2,3
11694_1,,,,2,1,2,3
11694_2,,,,2,1,2,3
11695_0,,,,2,1,2,3
11695_1,,,,2,1,2,3
11695_2,,,,2,1,2,3
11696_0,,,,2,1,2,3
11696_1,,,,2,1,2,3
11696_2,,,,2,1,2,3
11697_0,,,,2,1,2,3
11697_1,,,,2,1,2,3
11697_2,,,,2,1,2,3
11698_0,,,,2,1,2,3
11698_1,,,,2,1,2,3
11698_2,,,,2,1,2,3
11699_0,,,,2,1,2,3
11699_1,,,,2,1,2,3
11701_0,,,,2,1,2,3
C=CC(C(C(C)O)=O)=O,,,4,1,2,0,2
11701_1,,,,2,1,2,3
11702_0,,,,2,1,2,3
11702_1,,,,2,1,2,3
11702_2,,,,2,1,2,3
11703_0,,,,2,1,2,3
11703_1,,,,2,1,2,3
11703_2,,,,2,1,2,3
11704_0,,,,2,1,2,3
11704_1,,,,2,1,2,3
11704_2,,,,2,1,2,3
11705_0,,,,2,1,2,3
11705_1,,,,2,1,2,3
11705_2,,,,2,1,2,3
11706_0,,,,2,1,2,3
11707_0,,,,2,1,2,3
11707_1,,,,2,1,2,3
11707_2,,,,2,1,2,3
11708_0,,,,2,1,2,3
11708_1,,,,2,1,2,3
11708_2,,,,2,1,2,3
11709_0,,,,2,1,2,3
11709_1,,,,2,1,2,3
11709_2,,,,2,1,2,3
11710_0,,,,2,1,2,3
11710_1,,,,2,1,2,3
11710_2,,,,2,1,2,3
11711_0,,,,2,1,2,3
11711_1,,,,2,1,2,3
11711_2,,,,2,1,2,3
11712_0,,,,2,1,2,3
11712_1,,,,2,1,2,3
11712_2,,,,2,1,2,3
11713_0,,,,2,1,2,3
11713_1,,,,2,1,2,3
11713_2,,,,2,1,2,3
11714_0,,,,2,1,2,3
11714_1,,,,2,1,2,3
11715_0,,,,2,1,2,3
11715_1,,,,2,1,2,3
11715_2,,,,2,1,2,3
11716_0,,,,2,1,2,3
11716_1,,,,2,1,2,3
11716_2,,,,2,1,2,3
11717_0,,,,2,1,2,3
11717_1,,,,2,1,2,3
11717_2,,,,2,1,2,3
11718_0,,,,2,1,2,3
11718_1,,,,2,1,2,3
11718_2,,,,2,1,2,3
11719_0,,,,2,1,2,3
11719_1,,,,2,1,2,3
11719_2,,,,2,1,2,3
11720_0,,,,2,1,2,3
11721_0,,,,2,1,2,3
11721_1,,,,2,1,2,3
11721_2,,,,2,1,2,3
11722_0,,,,2,1,2,3
11722_1,,,,2,1,2,3
11722_2,,,,2,1,2,3
11723_0,,,,2,1,2,3
11723_1,,,,2,1,2,3
11723_2,,,,2,1,2,3
11724_0,,,,2,1,2,3
11724_1,,,,2,1,2,3
11724_2,,,,2,1,2,3
11725_0,,,,2,1,2,3
11725_1,,,,2,1,2,3
11726_0,,,,2,1,2,3
11726_1,,,,2,1,2,3
11726_2,,,,2,1,2,3
11727_0,,,,2,1,2,3
11727_1,,,,2,1,2,3
11727_2,,,,2,1,2,3
11728_0,,,,2,1,2,3
11728_1,,,,2,1,2,3
11728_2,,,,2,1,2,3
11729_0,,,,2,1,2,3
11729_1,,,,2,1,2,3
11729_2,,,,2,1,2,3
11730_0,,,,2,1,2,3
11730_1,,,,2,1,2,3
11730_2,,,,2,1,2,3
11731_0,,,,2,1,2,3
11731_1,,,,2,1,2,3
11731_2,,,,2,1,2,3
11732_0,,,,2,1,2,3
11732_1,,,,2,1,2,3
11732_2,,,,2,1,2,3
11733_0,,,,2,1,2,3
11734_0,,,,2,1,2,3
11735_0,,,,2,1,2,3
11735_1,,,,2,1,2,3
11735_2,,,,2,1,2,3
11736_0,,,,2,1,2,3
11736_1,,,,2,1,2,3
11737_0,,,,2,1,2,3
11737_1,,,,2,1,2,3
11737_2,,,,2,1,2,3
11738_0,,,,2,1,2,3
11738_1,,,,2,1,2,3
11738_2,,,,2,1,2,3
11739_0,,,,2,1,2,3
11740_0,,,,2,1,1,2
11740_1,,,,2,1,1,2
11741_0,,,,2,1,1,2
11741_1,,,,2,1,1,2
11742_0,,,,2,1,1,2
11742_1,,,,2,1,1,2
11743_0,,,,2,1,1,2
11743_1,,,,2,1,1,2
11744_0,,,,2,1,1,2
11746_0,,,,2,1,1,2
C(C(C=O)(CC(C)=O)O)=O,,,4,1,1,0,1
11747_0,,,,2,1,2,3
11747_1,,,,2,1,2,3
11748_0,,,,2,1,2,3
11749_0,,,,2,1,2,3
11749_1,,,,2,1,2,3
11750_0,,,,2,1,2,3
11751_0,,,,2,1,2,3
11751_1,,,,2,1,2,3
11752_0,,,,2,1,2,3
11752_1,,,,2,1,2,3
11753_0,,,,2,1,2,3
11754_0,,,,2,1,2,3
11754_1,,,,2,1,2,3
11755_0,,,,2,1,2,3
11755_1,,,,2,1,2,3
11756_0,,,,2,1,2,3
11757_0,,,,2,1,2,3
11757_1,,,,2,1,2,3
11758_0,,,,2,1,2,3
11758_1,,,,2,1,2,3
11759_0,,,,2,1,2,3
11759_1,,,,2,1,2,3
11760_0,,,,2,1,2,3
11761_0,,,,2,1,2,3
11761_1,,,,2,1,2,3
11762_0,,,,2,1,2,3
11762_1,,,,2,1,2,3
11763_0,,,,2,1,2,3
11763_1,,,,2,1,2,3
11764_0,,,,2,1,2,3
11765_0,,,,2,1,2,3
11765_1,,,,2,1,2,3
11766_0,,,,2,1,2,3
11766_1,,,,2,1,2,3
11767_0,,,,2,1,2,3
11768_0,,,,2,1,2,3
11768_1,,,,2,1,2,3
11769_0,,,,2,1,2,3
11769_1,,,,2,1,2,3
11770_0,,,,2,1,2,3
11771_0,,,,2,1,2,3
11772_0,,,,2,1,2,3
11772_1,,,,2,1,2,3
11774_0,,,,2,1,2,3
C(CO)(C(CO)(CC=O)O)=O,,,4,1,5,0,5
11774_1,,,,2,1,2,3
11775_0,,,,2,1,2,3
11776_0,,,,2,1,2,3
11776_1,,,,2,1,2,3
11777_0,,,,2,1,2,3
11777_1,,,,2,1,2,3
11778_0,,,,2,1,2,3
11778_1,,,,2,1,2,3
11779_0,,,,2,1,2,3
11779_1,,,,2,1,2,3
11780_0,,,,2,1,2,3
11780_1,,,,2,1,2,3
11781_0,,,,2,1,2,3
11782_0,,,,2,1,2,3
11782_1,,,,2,1,2,3
11783_0,,,,2,1,2,3
11783_1,,,,2,1,2,3
11784_0,,,,2,1,2,3
11784_1,,,,2,1,2,3
11785_0,,,,2,1,2,3
11785_1,,,,2,1,2,3
11786_0,,,,2,1,2,3
11786_1,,,,2,1,2,3
11787_0,,,,2,1,2,3
11788_0,,,,2,1,2,3
11788_1,,,,2,1,2,3
11789_0,,,,2,1,2,3
11789_1,,,,2,1,2,3
11791_0,,,,2,1,2,3
C(CC(C(CO)=O)=O)=O,,,4,1,2,0,2
11792_0,,,,2,1,2,3
11792_1,,,,2,1,2,3
11793_0,,,,2,1,2,3
11794_0,,,,2,1,2,3
11794_1,,,,2,1,2,3
11795_0,,,,2,1,2,3
11796_0,,,,2,1,2,3
11796_1,,,,2,1,2,3
11797_0,,,,2,1,2,3
11797_1,,,,2,1,2,3
11799_0,,,,2,1,1,2
C(C(CO)OC(C(C)=O)(CO)O)=O,,,4,1,2,0,2
11800_0,,,,2,1,2,3
11800_1,,,,2,1,2,3
11802_0,,,,2,1,1,2
C(C(COC(C(C)=O)(CO)O)O)=O,,,4,1,2,0,2
11803_0,,,,2,1,2,3
11804_0,,,,2,1,2,3
11805_0,,,,2,1,2,3
11805_1,,,,2,1,2,3
11806_0,,,,2,1,2,3
11807_0,,,,2,1,2,3
11808_0,,,,2,1,2,3
11808_1,,,,2,1,2,3
11809_0,,,,2,1,2,3
11810_0,,,,2,1,2,3
11810_1,,,,2,1,2,3
11811_0,,,,2,1,2,3
11811_1,,,,2,1,2,3
11812_0,,,,2,1,2,3
11812_1,,,,2,1,2,3
11813_0,,,,2,1,2,3
11813_1,,,,2,1,2,3
11814_0,,,,2,1,2,3
11814_1,,,,2,1,2,3
11815_0,,,,2,1,2,3
11816_0,,,,2,1,2,3
11816_1,,,,2,1,2,3
11817_0,,,,2,1,2,3
11817_1,,,,2,1,2,3
11818_0,,,,2,1,2,3
11819_0,,,,2,1,2,3
11819_1,,,,2,1,2,3
11820_0,,,,2,1,2,3
11821_0,,,,2,1,2,3
11821_1,,,,2,1,2,3
11822_0,,,,2,1,2,3
11823_0,,,,2,1,2,3
11823_1,,,,2,1,2,3
11824_0,,,,2,1,2,3
11824_1,,,,2,1,2,3
11825_0,,,,2,1,2,3
11826_0,,,,2,1,2,3
11826_1,,,,2,1,2,3
11826_2,,,,2,1,2,3
11827_0,,,,2,1,2,3
11827_1,,,,2,1,2,3
11827_2,,,,2,1,2,3
11828_0,,,,2,1,2,3
11828_1,,,,2,1,2,3
11829_0,,,,2,1,2,3
11830_0,,,,2,1,2,3
11830_1,,,,2,1,2,3
11831_0,,,,2,1,2,3
11831_1,,,,2,1,2,3
11832_0,,,,2,1,2,3
11833_0,,,,2,1,2,3
11833_1,,,,2,1,2,3
11834_0,,,,2,1,2,3
11835_0,,,,2,1,2,3
11835_1,,,,2,1,2,3
11836_0,,,,2,1,2,3
11837_0,,,,2,1,2,3
11837_1,,,,2,1,2,3
11838_0,,,,2,1,2,3
11838_1,,,,2,1,2,3
11839_0,,,,2,1,2,3
11839_1,,,,2,1,2,3
11839_2,,,,2,1,2,3
11840_0,,,,2,1,2,3
11840_1,,,,2,1,2,3
11840_2,,,,2,1,2,3
11841_0,,,,2,1,2,3
11841_1,,,,2,1,2,3
11842_0,,,,2,1,2,3
11842_1,,,,2,1,2,3
11843_0,,,,2,1,2,3
11843_1,,,,2,1,2,3
11843_2,,,,2,1,2,3
11844_0,,,,2,1,2,3
11844_1,,,,2,1,2,3
11844_2,,,,2,1,2,3
11845_0,,,,2,1,2,3
11845_1,,,,2,1,2,3
11846_0,,,,2,1,2,3
11846_1,,,,2,1,2,3
11847_0,,,,2,1,1,2
11848_0,,,,2,1,2,3
11848_1,,,,2,1,2,3
11850_0,,,,2,1,2,3
C1(CCC(C1O)=O)=O,,,4,1,5,0,5
11851_0,,,,2,1,2,3
11851_1,,,,2,1,2,3
11852_0,,,,2,1,2,3
11853_0,,,,2,1,2,3
11853_1,,,,2,1,2,3
11853_2,,,,2,1,2,3
11854_0,,,,2,1,1,2
11855_0,,,,2,1,2,3
11855_1,,,,2,1,2,3
11857_0,,,,2,1,1,2
C(CC(OCC(C)=O)=O)=O,,,4,1,5,0,5
11857_1,,,,2,1,1,2
11859_0,,,,2,1,1,2
C(COCC(C=O)=O)(C)=O,,,4,1,4,0,4
11859_1,,,,2,1,1,2
11861_0,,,,2,1,1,2
C(OC(C(C)=O)C(C)=O)=O,,,4,1,2,0,2
11863_0,,,,2,1,1,2
C(OC(C(C)=O)CC=O)=O,,,4,1,2,0,2
11865_0,,,,2,1,2,3
C1(CCC(CO1)=O)=O,,,4,1,3,0,3
11865_1,,,,2,1,2,3
11867_0,,,,2,1,2,3
C1(COCC(C1)=O)=O,,,4,1,3,0,3
11867_1,,,,2,1,2,3
11869_0,,,,2,1,1,2
C(CC(C)=O)(OCC=O)=O,,,4,1,2,0,2
11870_0,,,,2,1,1,2
11872_0,,,,2,1,1,2
C(COCC(C(C)=O)=O)=O,,,4,1,2,0,2
11873_0,,,,2,1,1,2
11875_0,,,,2,1,1,2
C(OCCC(C(C)=O)=O)=O,,,4,1,2,0,2
11877_0,,,,2,1,1,2
C(OCC(CC(C)=O)=O)=O,,,4,1,2,0,2
11879_0,,,,2,1,2,3
C(C=CC(C)=O)(O)=O,,,4,1,2,0,2
11880_0,,,,2,1,2,3
11882_0,,,,2,1,1,2
C(C(C(CO)OCC=O)O)=O,,,4,1,2,0,2
11882_1,,,,2,1,1,2
11884_0,,,,2,1,2,3
C1(COC(CO)C1O)=O,,,4,1,2,0,2
11884_1,,,,2,1,2,3
11886_0,,,,2,1,2,3
C1(C(O)OC(CO)C1)=O,,,4,1,3,0,3
11886_1,,,,2,1,2,3
11888_0,,,,2,1,1,2
C(C)(C(CO)OC(CO)=O)=O,,,4,1,2,0,2
11890_0,,,,2,1,2,3
C1(COC(CO)(C1)O)=O,,,4,1,3,0,3
11890_1,,,,2,1,2,3
11892_0,,,,2,1,2,3
C1(C(OCC1)=O)=O,,,4,1,3,0,3
11894_0,,,,2,1,2,3
C1(CC(CO1)=O)=O,,,4,1,5,0,5
11895_0,,,,2,1,1,2
11897_0,,,,2,1,1,2
C(C(CC=O)OCC=O)=O,,,4,1,3,0,3
11897_1,,,,2,1,1,2
11899_0,,,,2,1,1,2
C(C(C(C)=O)OC(C)=O)=O,,,4,1,1,0,1
11901_0,,,,2,1,1,2
C(COC(C(C=O)=O)C)=O,,,4,1,3,0,3
11901_1,,,,2,1,1,2
11903_0,,,,2,1,1,2
C(COC(C(C=O)=O)O)(C)=O,,,4,1,4,0,4
11903_1,,,,2,1,1,2
11905_0,,,,2,1,1,2
C(C)(C(CO)OC(C=O)=O)=O,,,4,1,3,0,3
11907_0,,,,2,1,2,3
C(C1(CC(CO1)=O)O)=O,,,4,1,3,0,3
11907_1,,,,2,1,2,3
11909_0,,,,2,1,1,2
C(C(C(COCC=O)O)O)=O,,,4,1,2,0,2
11909_1,,,,2,1,1,2
11911_0,,,,2,1,2,3
C1(COCC(C1O)O)=O,,,4,1,2,0,2
11911_1,,,,2,1,2,3
11913_0,,,,2,1,1,2
C(COC(C(CO)=O)CO)=O,,,4,1,2,0,2
11913_1,,,,2,1,1,2
11915_0,,,,2,1,2,3
C1(C(O)OCC(C1)O)=O,,,4,1,3,0,3
11915_1,,,,2,1,2,3
11917_0,,,,2,1,1,2
C(C)(C(CO)(OCC=O)O)=O,,,4,1,1,0,1
11919_0,,,,2,1,1,2
C(C)(C(COC(CO)=O)O)=O,,,4,1,2,0,2
11921_0,,,,2,1,1,2
C(CO)(CCOC(CO)=O)=O,,,4,1,3,0,3
11921_1,,,,2,1,1,2
11923_0,,,,2,1,1,2
C(C(CO)(OCC(C)=O)O)=O,,,4,1,1,0,1
11925_0,,,,2,1,1,2
C(C)(CCOC(C=O)=O)=O,,,4,1,2,0,2
11927_0,,,,2,1,1,2
C(OC(C=O)CC(C)=O)=O,,,4,1,1,0,1
11929_0,,,,2,1,1,2
C(OC(CO)CC(C=O)=O)=O,,,4,1,1,0,1
11931_0,,,,2,1,2,3
C1(COC(C(C1)=O)O)=O,,,4,1,3,0,3
11931_1,,,,2,1,2,3
11933_0,,,,2,1,1,2
C(C(C(CO)=O)OCC=O)=O,,,4,1,2,0,2
11933_1,,,,2,1,1,2
11935_0,,,,2,1,1,2
C(C(C(C)=O)(O)OCC=O)=O,,,4,1,1,0,1
11937_0,,,,2,1,1,2
C(C)(C(COC(C=O)=O)O)=O,,,4,1,3,0,3
11939_0,,,,2,1,1,2
C(C(O)OCCC(C=O)=O)=O,,,4,1,3,0,3
11939_1,,,,2,1,1,2
11941_0,,,,2,1,1,2
C(CO)(CCOC(C=O)=O)=O,,,4,1,5,0,5
11941_1,,,,2,1,1,2
11943_0,,,,2,1,1,2
C(CC(COC(C=O)O)=O)=O,,,4,1,3,0,3
11943_1,,,,2,1,1,2
11945_0,,,,2,1,1,2
C(C(C=O)(O)OCC(C)=O)=O,,,4,1,1,0,1
11947_0,,,,2,1,1,2
C(OCC(CC(C=O)=O)O)=O,,,4,1,1,0,1
11949_0,,,,2,1,1,2
C(COC(C(C(C)=O)=O)O)=O,,,4,1,1,0,1
11950_0,,,,2,1,1,2
11951_0,,,,2,1,2,3
11951_1,,,,2,1,2,3
11953_0,,,,2,1,1,2
C(C(C=O)O)(OCC(C)=O)=O,,,4,1,3,0,3
11953_1,,,,2,1,1,2
11955_0,,,,2,1,1,2
C(C(CO)OC(C(C)=O)=O)=O,,,4,1,1,0,1
11956_0,,,,2,1,1,2
11958_0,,,,2,1,2,3
C1(C(CC(CO1)=O)O)=O,,,4,1,3,0,3
11958_1,,,,2,1,2,3
11960_0,,,,2,1,1,2
C(C(COC(C(C)=O)=O)O)=O,,,4,1,1,0,1
11962_0,,,,2,1,1,2
C(CC(CO)=O)(OCC=O)=O,,,4,1,2,0,2
11962_1,,,,2,1,1,2
11964_0,,,,2,1,1,2
C(C(C(C)=O)O)(OCC=O)=O,,,4,1,1,0,1
11965_0,,,,2,1,1,2
11966_0,,,,2,1,1,2
11966_1,,,,2,1,1,2
11967_0,,,,2,1,1,2
11968_0,,,,2,1,1,2
11970_0,,,,2,1,1,2
C(C=C(C(CO)=O)CO)=O,,,4,1,3,0,3
11970_1,,,,2,1,1,2
11971_0,,,,2,1,2,3
11973_0,,,,2,1,1,2
C(C(C(C(CO)=O)=C)O)=O,,,4,1,3,0,3
11973_1,,,,2,1,1,2
11974_0,,,,2,1,1,2
11975_0,,,,2,1,1,2
11977_0,,,,2,1,2,3
C(C(C=C)O)=O,,,4,1,6,0,6
11977_1,,,,2,1,2,3
11978_0,,,,2,1,1,2
11978_1,,,,2,1,1,2
11980_0,,,,2,1,2,3
C1OCC(C=1)=O,,,4,1,3,0,3
11980_1,,,,2,1,2,3
11982_0,,,,2,1,2,3
C1C(O)OCC(C=1)=O,,,4,1,3,0,3
11982_1,,,,2,1,2,3
11984_0,,,,2,1,1,2
C(COC=CC(CO)=O)=O,,,4,1,3,0,3
11984_1,,,,2,1,1,2
11986_0,,,,2,1,1,2
C(OCC=CC(CO)=O)=O,,,4,1,3,0,3
11986_1,,,,2,1,1,2
11988_0,,,,2,1,2,3
C=CC(C)=O,,,4,1,2,0,2
11989_0,,,,2,1,2,3
11990_0,,,,2,1,2,3
11992_0,,,,2,1,2,3
C1COC(C=1)=O,,,4,1,4,0,4
11992_1,,,,2,1,2,3
11994_0,,,,2,1,1,2
C(COC(CO)=CC=O)=O,,,4,1,3,0,3
11994_1,,,,2,1,1,2
11996_0,,,,2,1,1,2
C(C(C(OCC=O)=C)O)=O,,,4,1,3,0,3
11996_1,,,,2,1,1,2
11998_0,,,,2,1,1,2
C(COC(C=CC=O)O)=O,,,4,1,3,0,3
11998_1,,,,2,1,1,2
12000_0,,,,2,1,1,2
C(C(C=COCC=O)O)=O,,,4,1,3,0,3
12000_1,,,,2,1,1,2
12002_0,,,,2,1,1,2
C(CC(CO)OC(C=O)O)=O,,,4,1,2,0,2
12002_1,,,,2,1,1,2
12004_0,,,,2,1,1,2
C(C(CO)O)(OCC(C)=O)=O,,,4,1,1,0,1
12006_0,,,,2,1,1,2
C(CCO)(OCC(CO)=O)=O,,,4,1,2,0,2
12006_1,,,,2,1,1,2
12008_0,,,,2,1,1,2
C(OC(C(CO)=O)CCO)=O,,,4,1,2,0,2
12008_1,,,,2,1,1,2
12009_0,,,,2,1,2,3
12009_1,,,,2,1,2,3
12010_0,,,,2,1,2,3
12010_1,,,,2,1,2,3
12011_0,,,,2,1,2,3
12013_0,,,,2,1,1,2
C(CC(OCC(C=O)=O)O)=O,,,4,1,2,0,2
12013_1,,,,2,1,1,2
12015_0,,,,2,1,1,2
C(CC(COC(C=O)O)O)=O,,,4,1,2,0,2
12015_1,,,,2,1,1,2
12017_0,,,,2,1,1,2
C(CC(C(OCC=O)O)O)=O,,,4,1,2,0,2
12017_1,,,,2,1,1,2
12019_0,,,,2,1,1,2
C(C(C)(OCC(CO)=O)O)=O,,,4,1,2,0,2
12019_1,,,,2,1,1,2
12021_0,,,,2,1,1,2
C(CO)(C(C)OC(C=O)O)=O,,,4,1,2,0,2
12021_1,,,,2,1,1,2
12022_0,,,,2,1,1,2
12022_1,,,,2,1,1,2
12024_0,,,,2,1,1,2
C(CC(C=O)O)(OCC=O)=O,,,4,1,2,0,2
12024_1,,,,2,1,1,2
12026_0,,,,2,1,1,2
C(C(CO)OC(C(CO)=O)=O)=O,,,4,1,2,0,2
12026_1,,,,2,1,1,2
12028_0,,,,2,1,1,2
C(C(COC(C(CO)=O)=O)O)=O,,,4,1,2,0,2
12028_1,,,,2,1,1,2
12030_0,,,,2,1,2,3
C(CC(C=O)CC(CO)=O)=O,,,4,1,5,0,5
12030_1,,,,2,1,2,3
12032_0,,,,2,1,2,3
C(CC(C(CO)=O)CC=O)=O,,,4,1,3,0,3
12032_1,,,,2,1,2,3
12034_0,,,,2,1,2,3
C(CCCC(C=O)=O)=O,,,4,1,3,0,3
12034_1,,,,2,1,2,3
12036_0,,,,2,1,2,3
C(CCCC(CO)=O)=O,,,4,1,3,0,3
12036_1,,,,2,1,2,3
12038_0,,,,2,1,2,3
C(CC(C=O)CC=O)=O,,,4,1,4,0,4
12038_1,,,,2,1,2,3
12039_0,,,,2,1,1,2
12040_0,,,,2,1,1,2
12041_0,,,,2,1,1,2
12042_0,,,,2,1,1,2
12044_0,,,,2,1,1,2
C1(C(C(CC1(CO)O)O)O)=O,,,4,1,3,0,3
12045_0,,,,2,1,1,2
12046_0,,,,2,1,1,2
12047_0,,,,2,1,1,2
12048_0,,,,2,1,1,2
12049_0,,,,2,1,1,2
12050_0,,,,2,1,1,2
12052_0,,,,2,1,1,2
C1(CCC(C(C1O)=O)O)=O,,,4,1,3,0,3
12054_0,,,,2,1,1,2
C(C1(C(C(CC1)O)=O)O)=O,,,4,1,1,0,1
12056_0,,,,2,1,1,2
C1(C(CC(C(C1)=O)O)O)=O,,,4,1,2,0,2
12057_0,,,,2,1,1,2
12058_0,,,,2,1,1,2
12059_0,,,,2,1,1,2
12060_0,,,,2,1,1,2
12061_0,,,,2,1,1,2
12062_0,,,,2,1,1,2
12064_0,,,,2,1,1,2
C1(C(C(C(C1CO)=O)O)O)=O,,,4,1,1,0,1
12065_0,,,,2,1,1,2
12067_0,,,,2,1,1,2
C1(C(C(C(CO)C1O)O)=O)=O,,,4,1,1,0,1
12068_0,,,,2,1,1,2
12069_0,,,,2,1,1,2
12071_0,,,,2,1,1,2
C1(C(CC(C(C1O)=O)O)O)=O,,,4,1,1,0,1
12073_0,,,,2,1,1,2
C(C1(C(C(CC1O)O)=O)O)=O,,,4,1,3,0,3
12074_0,,,,2,1,1,2
12075_0,,,,2,1,1,2
12076_0,,,,2,1,1,2
12077_0,,,,2,1,1,2
12079_0,,,,2,1,1,2
C1(C(C(CO)C(C(C1O)O)O)O)=O,,,4,1,1,0,1
12080_0,,,,2,1,1,2
12081_0,,,,2,1,1,2
12083_0,,,,2,1,1,2
C(C(C(C(CO)O)=O)(C)O)=O,,,4,1,1,0,1
12085_0,,,,2,1,1,2
C(C(C)(C(C(C=O)O)O)O)=O,,,4,1,4,0,4
12086_0,,,,2,1,1,2
12087_0,,,,2,1,1,2
12088_0,,,,2,1,1,2
12089_0,,,,2,1,1,2
12090_0,,,,2,1,1,2
12091_0,,,,2,1,1,2
12092_0,,,,2,1,1,2
12093_0,,,,2,1,1,2
12094_0,,,,2,1,1,2
12095_0,,,,2,1,1,2
12097_0,,,,2,1,1,2
C(C(C)(C(C=O)O)O)(C(CO)O)=O,,,4,1,1,0,1
12098_0,,,,2,1,1,2
12099_0,,,,2,1,1,2
12100_0,,,,2,1,1,2
12102_0,,,,2,1,1,2
C(C(C(CC(CO)(CO)O)O)=O)=O,,,4,1,1,0,1
12103_0,,,,2,1,1,2
12104_0,,,,2,1,1,2
12105_0,,,,2,1,1,2
12107_0,,,,2,1,1,2
C(C(CO)O)(C(C)(C(CO)O)O)=O,,,4,1,1,0,1
12109_0,,,,2,1,1,2
C(C(C(C(C)(C(CO)O)O)O)O)=O,,,4,1,5,0,5
12111_0,,,,2,1,1,2
C(CO)(C(CC(CO)(CO)O)O)=O,,,4,1,2,0,2
12112_0,,,,2,1,1,2
12113_0,,,,2,1,1,2
12115_0,,,,2,1,1,2
C(C(CCO)O)(C(C(CO)=O)O)=O,,,4,1,1,0,1
12117_0,,,,2,1,1,2
C(C(C(C(CO)O)=O)(CCO)O)=O,,,4,1,1,0,1
12119_0,,,,2,1,1,2
C(C(C(C(C=O)O)O)(CCO)O)=O,,,4,1,5,0,5
12121_0,,,,2,1,1,2
C(C(CO)O)(C(CO)(CCO)O)=O,,,4,1,4,0,4
12123_0,,,,2,1,1,2
C(C(C(C(CO)(CCO)O)O)O)=O,,,4,1,3,0,3
12125_0,,,,2,1,1,2
C(C(CCO)O)(C(CO)(CO)O)=O,,,4,1,5,0,5
12127_0,,,,2,1,1,2
C(C(C(CO)C(CO)(CO)O)O)=O,,,4,1,3,0,3
12128_0,,,,2,1,1,2
12129_0,,,,2,1,1,2
12130_0,,,,2,1,1,2
12132_0,,,,2,1,1,2
C(C(CO)O)(C(CO)(C)O)=O,,,4,1,1,0,1
12134_0,,,,2,1,1,2
C(C(C(C(CO)(C)O)O)O)=O,,,4,1,3,0,3
12136_0,,,,2,1,1,2
C(C(CC(CO)(CO)O)O)=O,,,4,1,2,0,2
12138_0,,,,2,1,1,2
C(C(C)O)(C(CO)(CO)O)=O,,,4,1,1,0,1
12139_0,,,,2,1,1,2
12140_0,,,,2,1,1,2
12141_0,,,,2,1,1,2
12142_0,,,,2,1,1,2
12143_0,,,,2,1,1,2
12144_0,,,,2,1,1,2
12145_0,,,,2,1,1,2
12146_0,,,,2,1,1,2
12148_0,,,,2,1,1,2
C(C(CO)O)(C(C(CO)=O)O)=O,,,4,1,3,0,3
12149_0,,,,2,1,1,2
12151_0,,,,2,1,1,2
C(C(C(C(CO)O)=O)(CO)O)=O,,,4,1,1,0,1
12152_0,,,,2,1,1,2
12154_0,,,,2,1,1,2
C(C(C(C(CO)(CO)O)=O)O)=O,,,4,1,1,0,1
12155_0,,,,2,1,1,2
12156_0,,,,2,1,1,2
12157_0,,,,2,1,1,2
12159_0,,,,2,1,1,2
C(C(C(CC(C(CO)O)O)O)=O)=O,,,4,1,1,0,1
12161_0,,,,2,1,1,2
C(CO)(C(CC(C(CO)O)O)O)=O,,,4,1,1,0,1
12163_0,,,,2,1,1,2
C(C(CCO)O)(C(C(CO)O)O)=O,,,4,1,1,0,1
12165_0,,,,2,1,1,2
C(C(C(CO)C(C(CO)O)O)O)=O,,,4,1,3,0,3
12166_0,,,,2,1,1,2
12167_0,,,,2,1,1,2
12169_0,,,,2,1,1,2
C(C(C)O)(C(C=O)C(CO)=O)=O,,,4,1,1,0,1
12170_0,,,,2,1,1,2
12171_0,,,,2,1,1,2
12173_0,,,,2,1,1,2
C(CC(C(C(C(C)O)=O)O)=O)=O,,,4,1,1,0,1
12174_0,,,,2,1,1,2
12176_0,,,,2,1,1,2
C(CC(C(C(C=O)(C)O)=O)O)=O,,,4,1,1,0,1
12177_0,,,,2,1,1,2
12178_0,,,,2,1,1,2
12180_0,,,,2,1,1,2
C(C(C=O)O)(CC(C(C)O)=O)=O,,,4,1,1,0,1
12181_0,,,,2,1,1,2
12183_0,,,,2,1,1,2
C(C)(C(CC(C(C=O)=O)O)O)=O,,,4,1,1,0,1
12184_0,,,,2,1,1,2
12186_0,,,,2,1,1,2
C(C(C)(CC(C(C=O)=O)O)O)=O,,,4,1,1,0,1
12187_0,,,,2,1,1,2
12189_0,,,,2,1,1,2
C(C(CO)O)(CC(C(C)O)=O)=O,,,4,1,1,0,1
12191_0,,,,2,1,1,2
C(C)(C(CC(C(CO)=O)O)O)=O,,,4,1,1,0,1
12193_0,,,,2,1,1,2
C(C(C)(CC(C(CO)=O)O)O)=O,,,4,1,1,0,1
12195_0,,,,2,1,1,2
C(C(CCO)O)(CC(C=O)=O)=O,,,4,1,1,0,1
12196_0,,,,2,1,1,2
12198_0,,,,2,1,1,2
C(CCO)(C(C(C(C)O)=O)O)=O,,,4,1,1,0,1
12200_0,,,,2,1,1,2
C(C(CCO)O)(C(C(C)=O)O)=O,,,4,1,1,0,1
12202_0,,,,2,1,1,2
C(C(C(C(CCO)O)=O)(C)O)=O,,,4,1,1,0,1
12204_0,,,,2,1,1,2
C(C(C)O)(C(C(CO)=O)CO)=O,,,4,1,1,0,1
12206_0,,,,2,1,1,2
C(C(C(CO)C(C(C)=O)O)O)=O,,,4,1,3,0,3
12208_0,,,,2,1,1,2
C(C(C)(C(CO)C(C=O)O)O)=O,,,4,1,3,0,3
12209_0,,,,2,1,1,2
12211_0,,,,2,1,1,2
C(C(C)O)(CC(CO)=O)=O,,,4,1,3,0,3
12212_0,,,,2,1,1,2
12214_0,,,,2,1,1,2
C(C(C)(CC(C=O)O)O)=O,,,4,1,2,0,2
12216_0,,,,2,1,1,2
C(C(C)O)(C(C(C)=O)O)=O,,,4,1,2,0,2
12218_0,,,,2,1,1,2
C(C(C(C(C)O)=O)(C)O)=O,,,4,1,1,0,1
12219_0,,,,2,1,1,2
12221_0,,,,2,1,1,2
C(C(C)O)(C(C=O)C(C=O)O)=O,,,4,1,2,0,2
12222_0,,,,2,1,1,2
12223_0,,,,2,1,1,2
12224_0,,,,2,1,1,2
12226_0,,,,2,1,1,2
C(CC(C(C)O)=O)=O,,,4,1,1,0,1
12227_0,,,,2,1,1,2
12228_0,,,,2,1,1,2
12230_0,,,,2,1,1,2
C(C(C(C(C=O)O)=O)(C)O)=O,,,4,1,1,0,1
12231_0,,,,2,1,1,2
12232_0,,,,2,1,1,2
12233_0,,,,2,1,1,2
12235_0,,,,2,1,1,2
C(C(C(C(C(CO)O)O)=O)(C)O)=O,,,4,1,1,0,1
12237_0,,,,2,1,1,2
C(C(C)(C(C(C(CO)=O)O)O)O)=O,,,4,1,2,0,2
12238_0,,,,2,1,1,2
12239_0,,,,2,1,1,2
12240_0,,,,2,1,1,2
12242_0,,,,2,1,1,2
C(C(C(CO)=O)C(CO)=O)=O,,,4,1,1,0,1
12243_0,,,,2,1,1,2
12245_0,,,,2,1,1,2
C(CC(C(C(CO)=O)O)=O)=O,,,4,1,2,0,2
12246_0,,,,2,1,1,2
12247_0,,,,2,1,1,2
12248_0,,,,2,1,1,2
12249_0,,,,2,1,1,2
12250_0,,,,2,1,1,2
12251_0,,,,2,1,1,2
12252_0,,,,2,1,1,2
12254_0,,,,2,1,1,2
C(CC(C(C(CO)(C)O)=O)O)=O,,,4,1,1,0,1
12255_0,,,,2,1,1,2
12256_0,,,,2,1,1,2
12257_0,,,,2,1,1,2
12258_0,,,,2,1,1,2
12260_0,,,,2,1,1,2
C(C(CO)(CC=O)O)(C(C)O)=O,,,4,1,1,0,1
12261_0,,,,2,1,1,2
12262_0,,,,2,1,1,2
12263_0,,,,2,1,1,2
12264_0,,,,2,1,1,2
12266_0,,,,2,1,1,2
C(C(CO)O)(C(C=O)C(CO)=O)=O,,,4,1,1,0,1
12267_0,,,,2,1,1,2
12269_0,,,,2,1,1,2
C(CC(C(C(C(CO)=O)O)=O)O)=O,,,4,1,1,0,1
12271_0,,,,2,1,1,2
C(CC(C(C(C(CO)O)=O)O)=O)=O,,,4,1,1,0,1
12272_0,,,,2,1,1,2
12273_0,,,,2,1,1,2
12275_0,,,,2,1,1,2
C(CC(C(C(C=O)(CO)O)=O)O)=O,,,4,1,3,0,3
12276_0,,,,2,1,1,2
12277_0,,,,2,1,1,2
12279_0,,,,2,1,1,2
C(C(CO)(CC=O)O)(C(C=O)O)=O,,,4,1,2,0,2
12280_0,,,,2,1,1,2
12281_0,,,,2,1,1,2
12282_0,,,,2,1,1,2
12283_0,,,,2,1,1,2
12284_0,,,,2,1,1,2
12285_0,,,,2,1,1,2
12287_0,,,,2,1,1,2
C(C(C(CC(C(C=O)=O)O)O)O)=O,,,4,1,1,0,1
12288_0,,,,2,1,1,2
12289_0,,,,2,1,1,2
12291_0,,,,2,1,1,2
C(C(C(CC(CO)(C)O)O)=O)=O,,,4,1,1,0,1
12292_0,,,,2,1,1,2
12294_0,,,,2,1,1,2
C(C(CC(C)(C(C=O)O)O)O)=O,,,4,1,2,0,2
12295_0,,,,2,1,1,2
12296_0,,,,2,1,1,2
12298_0,,,,2,1,1,2
C(C(C)(C(C=O)O)O)(C(C)O)=O,,,4,1,1,0,1
12299_0,,,,2,1,1,2
12301_0,,,,2,1,1,2
C(C(C(CC(C)O)O)=O)=O,,,4,1,1,0,1
12302_0,,,,2,1,1,2
12303_0,,,,2,1,1,2
12304_0,,,,2,1,1,2
12306_0,,,,2,1,1,2
C(CO)(C(CC(C(C=O)=O)O)O)=O,,,4,1,2,0,2
12307_0,,,,2,1,1,2
12308_0,,,,2,1,1,2
12309_0,,,,2,1,1,2
12311_0,,,,2,1,1,2
C(C(CO)(CC(C(C=O)=O)O)O)=O,,,4,1,3,0,3
12312_0,,,,2,1,1,2
12313_0,,,,2,1,1,2
12314_0,,,,2,1,1,2
12316_0,,,,2,1,1,2
C(C(C)(C(C=O)O)O)(C(C=O)O)=O,,,4,1,2,0,2
12317_0,,,,2,1,1,2
12319_0,,,,2,1,1,2
C(C(C(C(C=O)O)C(C=O)O)O)=O,,,4,1,1,0,1
12320_0,,,,2,1,1,2
12321_0,,,,2,1,1,2
12323_0,,,,2,1,1,2
C(C(C(C(CC(C=O)O)O)=O)O)=O,,,4,1,2,0,2
12324_0,,,,2,1,1,2
12325_0,,,,2,1,1,2
12327_0,,,,2,1,1,2
C(C(C(CO)C(C=O)O)O)=O,,,4,1,3,0,3
12328_0,,,,2,1,1,2
12329_0,,,,2,1,1,2
12331_0,,,,2,1,1,2
C(C(C(C(C=O)O)=O)O)=O,,,4,1,1,0,1
12332_0,,,,2,1,1,2
12333_0,,,,2,1,1,2
12334_0,,,,2,1,1,2
12335_0,,,,2,1,1,2
12336_0,,,,2,1,1,2
12337_0,,,,2,1,1,2
12339_0,,,,2,1,1,2
C(CO)(C(CC(CO)(C)O)O)=O,,,4,1,1,0,1
12341_0,,,,2,1,1,2
C(C(CC(C)(C(CO)O)O)O)=O,,,4,1,2,0,2
12343_0,,,,2,1,1,2
C(C(C)O)(C(C)(C(CO)O)O)=O,,,4,1,1,0,1
12345_0,,,,2,1,1,2
C(CO)(C(CC(C)O)O)=O,,,4,1,1,0,1
12347_0,,,,2,1,1,2
C(CO)(C(CC(C(CO)=O)O)O)=O,,,4,1,1,0,1
12348_0,,,,2,1,1,2
12349_0,,,,2,1,1,2
12350_0,,,,2,1,1,2
12352_0,,,,2,1,1,2
C(C(C(C(C)(C(CO)O)O)=O)O)=O,,,4,1,2,0,2
12353_0,,,,2,1,1,2
12355_0,,,,2,1,1,2
C(C(C(C(C)O)C(C=O)O)O)=O,,,4,1,1,0,1
12356_0,,,,2,1,1,2
12358_0,,,,2,1,1,2
C(C(CC(C(C(C)O)=O)O)O)=O,,,4,1,2,0,2
12359_0,,,,2,1,1,2
12360_0,,,,2,1,1,2
12362_0,,,,2,1,1,2
C(C(C(CO)CO)O)=O,,,4,1,3,0,3
12363_0,,,,2,1,1,2
12364_0,,,,2,1,1,2
12365_0,,,,2,1,1,2
12366_0,,,,2,1,1,2
12367_0,,,,2,1,1,2
12368_0,,,,2,1,1,2
12369_0,,,,2,1,1,2
12370_0,,,,2,1,1,2
12371_0,,,,2,1,1,2
12372_0,,,,2,1,1,2
12373_0,,,,2,1,1,2
12374_0,,,,2,1,1,2
12375_0,,,,2,1,1,2
12376_0,,,,2,1,1,2
12377_0,,,,2,1,1,2
12378_0,,,,2,1,1,2
12379_0,,,,2,1,1,2
12381_0,,,,2,1,1,2
C(C(CO)=O)(C(C(CO)CO)O)=O,,,4,1,1,0,1
12382_0,,,,2,1,1,2
12383_0,,,,2,1,1,2
12384_0,,,,2,1,1,2
12385_0,,,,2,1,1,2
12386_0,,,,2,1,1,2
12388_0,,,,2,1,1,2
C(C(C(CO)C(C(CO)=O)O)O)=O,,,4,1,4,0,4
12389_0,,,,2,1,1,2
12390_0,,,,2,1,1,2
12391_0,,,,2,1,1,2
12392_0,,,,2,1,1,2
12394_0,,,,2,1,1,2
C(C(C(CO)CO)O)(C(CO)O)=O,,,4,1,2,0,2
12396_0,,,,2,1,1,2
C(CO)(C(C(CO)C(CO)O)O)=O,,,4,1,1,0,1
12397_0,,,,2,1,1,2
12399_0,,,,2,1,1,2
C(C(C(CO)CC(C=O)=O)O)=O,,,4,1,1,0,1
12401_0,,,,2,1,1,2
C(CO)(C(CCC(C=O)=O)O)=O,,,4,1,2,0,2
12402_0,,,,2,1,1,2
12403_0,,,,2,1,1,2
12404_0,,,,2,1,1,2
12405_0,,,,2,1,1,2
12406_0,,,,2,1,1,2
12407_0,,,,2,1,1,2
12409_0,,,,2,1,1,2
C(CC(C(C(CCO)O)=O)=O)=O,,,4,1,1,0,1
12410_0,,,,2,1,1,2
12411_0,,,,2,1,1,2
12412_0,,,,2,1,1,2
12413_0,,,,2,1,1,2
12414_0,,,,2,1,1,2
12415_0,,,,2,1,1,2
12416_0,,,,2,1,1,2
12418_0,,,,2,1,1,2
C(CC(CO)C(C(C=O)=O)O)=O,,,4,1,2,0,2
12419_0,,,,2,1,1,2
12420_0,,,,2,1,1,2
12421_0,,,,2,1,1,2
12422_0,,,,2,1,1,2
12423_0,,,,2,1,1,2
12424_0,,,,2,1,1,2
12426_0,,,,2,1,1,2
C1(C(C(CO)O)OC(CO)C1O)=O,,,4,1,1,0,1
12428_0,,,,2,1,1,2
C1(C(C(CO)C(C(CO)O)O1)O)=O,,,4,1,1,0,1
12430_0,,,,2,1,1,2
C1(C(C(CO)OC(CO)C1O)O)=O,,,4,1,1,0,1
12432_0,,,,2,1,1,2
C1(C(C(CO)C(C(CO)O1)O)O)=O,,,4,1,1,0,1
12434_0,,,,2,1,1,2
C1(C(CO)OC(C(CO)C1O)O)=O,,,4,1,2,0,2
12436_0,,,,2,1,1,2
C1(C(O)OC(CO)C(CO)C1O)=O,,,4,1,1,0,1
12438_0,,,,2,1,1,2
C1(C(C(COC(CO)C1O)O)O)=O,,,4,1,1,0,1
12440_0,,,,2,1,1,2
C1(C(C(CO)C(C(CO1)O)O)O)=O,,,4,1,1,0,1
12442_0,,,,2,1,1,2
C1(C(C(C(O)OCC1O)CO)O)=O,,,4,1,2,0,2
12444_0,,,,2,1,1,2
C1(C(O)OCC(C(CO)C1O)O)=O,,,4,1,1,0,1
12446_0,,,,2,1,1,2
C1(COC(C(C(CO)C1O)O)O)=O,,,4,1,1,0,1
12448_0,,,,2,1,1,2
C1(C(C(COC(C1O)O)CO)O)=O,,,4,1,1,0,1
12450_0,,,,2,1,1,2
C(C(CC(CO)C(C=O)O)O)(O)=O,,,4,1,1,0,1
12452_0,,,,2,1,1,2
C(C(CCC(C(CO)=O)O)O)(O)=O,,,4,1,1,0,1
12454_0,,,,2,1,1,2
C(CC(C(O)=O)O)(C(CCO)O)=O,,,4,1,1,0,1
12455_0,,,,2,1,1,2
12456_0,,,,2,1,1,2
12458_0,,,,2,1,1,2
C(C(C(C(C(CO)CO)O)=O)=O)=O,,,4,1,1,0,1
12459_0,,,,2,1,1,2
12461_0,,,,2,1,1,2
C(C(C(CO)C(C(C=O)=O)O)O)=O,,,4,1,1,0,1
12462_0,,,,2,1,1,2
12463_0,,,,2,1,1,2
12464_0,,,,2,1,1,2
12466_0,,,,2,1,1,2
C(C(CCO)O)(C(C(C=O)=O)O)=O,,,4,1,1,0,1
12467_0,,,,2,1,1,2
12468_0,,,,2,1,1,2
12470_0,,,,2,1,1,2
C(C(C=CC(C(CO)=O)O)O)=O,,,4,1,2,0,2
12471_0,,,,2,1,1,2
12473_0,,,,2,1,1,2
C(C(CCO)O)(CC(CO)=O)=O,,,4,1,1,0,1
12474_0,,,,2,1,1,2
12476_0,,,,2,1,1,2
C(C(CC(C=O)O)(CCO)O)=O,,,4,1,2,0,2
12478_0,,,,2,1,1,2
C(C(C(C(C)O)=O)(CCO)O)=O,,,4,1,1,0,1
12479_0,,,,2,1,1,2
12480_0,,,,2,1,1,2
12481_0,,,,2,1,1,2
12483_0,,,,2,1,1,2
C(C(C(C(C=O)O)=O)(CCO)O)=O,,,4,1,1,0,1
12485_0,,,,2,1,1,2
C(C(C(C=O)O)O)(C(CCO)O)=O,,,4,1,1,0,1
12486_0,,,,2,1,1,2
12487_0,,,,2,1,1,2
12488_0,,,,2,1,1,2
12490_0,,,,2,1,1,2
C(C(CCO)O)(C(CO)(C)O)=O,,,4,1,1,0,1
12492_0,,,,2,1,1,2
C(C(C(CO)C(CO)(C)O)O)=O,,,4,1,3,0,3
12494_0,,,,2,1,1,2
C(C(CC(CO)(CCO)O)O)=O,,,4,1,3,0,3
12496_0,,,,2,1,1,2
C(C(C)O)(C(CO)(CCO)O)=O,,,4,1,1,0,1
12498_0,,,,2,1,1,2
C(C(CCO)O)(C(C)O)=O,,,4,1,1,0,1
12500_0,,,,2,1,1,2
C(C(C(CO)C(C)O)O)=O,,,4,1,3,0,3
12501_0,,,,2,1,1,2
12503_0,,,,2,1,1,2
C(C(CO)(C(CO)C(C=O)O)O)=O,,,4,1,3,0,3
12504_0,,,,2,1,1,2
12505_0,,,,2,1,1,2
12507_0,,,,2,1,1,2
C(C(C(C(CC(C)O)O)=O)O)=O,,,4,1,1,0,1
12508_0,,,,2,1,1,2
12509_0,,,,2,1,1,2
12510_0,,,,2,1,1,2
12511_0,,,,2,1,1,2
12512_0,,,,2,1,1,2
12513_0,,,,2,1,1,2
12514_0,,,,2,1,1,2
12516_0,,,,2,1,1,2
C(C(CC(CO)(C)O)O)=O,,,4,1,2,0,2
12518_0,,,,2,1,1,2
C(C(C)O)(C(CO)(C)O)=O,,,4,1,1,0,1
12520_0,,,,2,1,1,2
C(C(CC(CC(C=O)O)O)O)=O,,,4,1,2,0,2
12521_0,,,,2,1,1,2
12522_0,,,,2,1,1,2
12523_0,,,,2,1,1,2
12524_0,,,,2,1,1,2
12525_0,,,,2,1,1,2
12526_0,,,,2,1,1,2
12527_0,,,,2,1,1,2
12528_0,,,,2,1,1,2
12530_0,,,,2,1,1,2
C(C(CC(C)O)O)=O,,,4,1,2,0,2
12532_0,,,,2,1,1,2
C(C(C)O)(C(C)O)=O,,,4,1,1,0,1
12534_0,,,,2,1,1,2
C(C(CO)(CC(C=O)O)O)=O,,,4,1,3,0,3
12536_0,,,,2,1,1,2
C(C(C(C(C)O)=O)(CO)O)=O,,,4,1,3,0,3
12538_0,,,,2,1,1,2
C(C(C(C(CO)(C)O)=O)O)=O,,,4,1,2,0,2
12540_0,,,,2,1,1,2
C(C(CC(CO)(C(CO)O)O)O)=O,,,4,1,4,0,4
12542_0,,,,2,1,1,2
C(C(C)O)(C(CO)(C(CO)O)O)=O,,,4,1,4,0,4
12544_0,,,,2,1,1,2
C(C(C(CO)O)O)(C(CO)(C)O)=O,,,4,1,3,0,3
12546_0,,,,2,1,1,2
C(CO)(C(C(C(CO)(C)O)O)O)=O,,,4,1,1,0,1
12548_0,,,,2,1,1,2
C(C(CC(C=O)O)(C(CO)O)O)=O,,,4,1,3,0,3
12550_0,,,,2,1,1,2
C(C(C(C(C)O)=O)(C(CO)O)O)=O,,,4,1,3,0,3
12551_0,,,,2,1,1,2
12552_0,,,,2,1,1,2
12553_0,,,,2,1,1,2
12554_0,,,,2,1,1,2
12555_0,,,,2,1,1,2
12556_0,,,,2,1,1,2
12557_0,,,,2,1,1,2
12558_0,,,,2,1,1,2
12559_0,,,,2,1,1,2
12560_0,,,,2,1,1,2
12561_0,,,,2,1,1,2
12562_0,,,,2,1,1,2
12563_0,,,,2,1,1,2
12564_0,,,,2,1,1,2
12565_0,,,,2,1,1,2
12567_0,,,,2,1,1,2
C(C(CCC(CO)=O)O)(CC=O)=O,,,4,1,2,0,2
12568_0,,,,2,1,1,2
12569_0,,,,2,1,1,2
12570_0,,,,2,1,1,2
12572_0,,,,2,1,1,2
C(C(C(C(C)O)CC(C=O)=O)O)=O,,,4,1,1,0,1
12574_0,,,,2,1,1,2
C(C(CCC(C=O)=O)O)(C(C)O)=O,,,4,1,2,0,2
12576_0,,,,2,1,1,2
C(C(CC(C(C)=O)O)O)(CC=O)=O,,,4,1,1,0,1
12577_0,,,,2,1,1,2
12578_0,,,,2,1,1,2
12579_0,,,,2,1,1,2
12581_0,,,,2,1,1,2
C(C(CC(C)O)O)(CC(C=O)=O)=O,,,4,1,1,0,1
12582_0,,,,2,1,1,2
12583_0,,,,2,1,1,2
12584_0,,,,2,1,1,2
12585_0,,,,2,1,1,2
12586_0,,,,2,1,1,2
12587_0,,,,2,1,1,2
12588_0,,,,2,1,1,2
12589_0,,,,2,1,1,2
12590_0,,,,2,1,1,2
12591_0,,,,2,1,1,2
12592_0,,,,2,1,1,2
12593_0,,,,2,1,1,2
12594_0,,,,2,1,1,2
12596_0,,,,2,1,1,2
C(CC(C(C(CC(C)O)O)=O)=O)=O,,,4,1,1,0,1
12597_0,,,,2,1,1,2
12598_0,,,,2,1,1,2
12599_0,,,,2,1,1,2
12600_0,,,,2,1,1,2
12601_0,,,,2,1,1,2
12602_0,,,,2,1,1,2
12603_0,,,,2,1,1,2
12604_0,,,,2,1,1,2
12605_0,,,,2,1,1,2
12606_0,,,,2,1,1,2
12607_0,,,,2,1,1,2
12608_0,,,,2,1,1,2
12609_0,,,,2,1,1,2
12610_0,,,,2,1,1,2
12611_0,,,,2,1,1,2
12612_0,,,,2,1,1,2
12614_0,,,,2,1,1,2
C(CC(C(C)O)C(C(C=O)=O)O)=O,,,4,1,2,0,2
12615_0,,,,2,1,1,2
12616_0,,,,2,1,1,2
12617_0,,,,2,1,1,2
12618_0,,,,2,1,1,2
12619_0,,,,2,1,1,2
12620_0,,,,2,1,1,2
12621_0,,,,2,1,1,2
12622_0,,,,2,1,1,2
12623_0,,,,2,1,1,2
12624_0,,,,2,1,1,2
12626_0,,,,2,1,1,2
C(CC(C(C=CC(CO)O)O)=O)=O,,,4,1,1,0,1
12627_0,,,,2,1,1,2
12628_0,,,,2,1,1,2
12629_0,,,,2,1,1,2
12630_0,,,,2,1,1,2
12631_0,,,,2,1,1,2
12632_0,,,,2,1,1,2
12633_0,,,,2,1,1,2
12634_0,,,,2,1,1,2
12636_0,,,,2,1,1,2
C(C(C=CC(C(C(C)O)=O)O)O)=O,,,4,1,1,0,1
12637_0,,,,2,1,1,2
12639_0,,,,2,1,1,2
C(C(C(C(C(CO)=O)O)=O)O)=O,,,4,1,1,0,1
12640_0,,,,2,1,1,2
12641_0,,,,2,1,1,2
12643_0,,,,2,1,1,2
C(C(C(C(C=O)O)=O)(CO)O)=O,,,4,1,1,0,1
12644_0,,,,2,1,1,2
12645_0,,,,2,1,1,2
12646_0,,,,2,1,1,2
12647_0,,,,2,1,1,2
12648_0,,,,2,1,1,2
12649_0,,,,2,1,1,2
12650_0,,,,2,1,1,2
12651_0,,,,2,1,1,2
12653_0,,,,2,1,1,2
C(CO)(C(C)(C(CO)O)O)=O,,,4,1,2,0,2
12654_0,,,,2,1,1,2
12655_0,,,,2,1,1,2
12656_0,,,,2,1,1,2
12658_0,,,,2,1,1,2
C(C(C(C(CO)O)C(C=O)O)O)=O,,,4,1,1,0,1
12659_0,,,,2,1,1,2
12660_0,,,,2,1,1,2
12662_0,,,,2,1,1,2
C(C(C(CO)=O)(CCO)O)=O,,,4,1,1,0,1
12664_0,,,,2,1,1,2
C(CO)(C(CO)(CCO)O)=O,,,4,1,1,0,1
12666_0,,,,2,1,1,2
C(C(C(CO)C(CO)O)O)=O,,,4,1,3,0,3
12668_0,,,,2,1,1,2
C(C(C(C(C(CO)=O)(C)O)O)O)=O,,,4,1,2,0,2
12669_0,,,,2,1,1,2
12670_0,,,,2,1,1,2
12672_0,,,,2,1,1,2
C(C(C(C(CC(CO)O)O)=O)O)=O,,,4,1,1,0,1
12673_0,,,,2,1,1,2
12674_0,,,,2,1,1,2
12675_0,,,,2,1,1,2
12676_0,,,,2,1,1,2
12677_0,,,,2,1,1,2
12678_0,,,,2,1,1,2
12679_0,,,,2,1,1,2
12680_0,,,,2,1,1,2
12681_0,,,,2,1,1,2
12682_0,,,,2,1,1,2
12684_0,,,,2,1,1,2
C(C(C(CO)=O)(C(CO)O)O)=O,,,4,1,3,0,3
12686_0,,,,2,1,1,2
C(C(CC(C(C(CO)O)O)O)O)=O,,,4,1,4,0,4
12687_0,,,,2,1,1,2
12688_0,,,,2,1,1,2
12689_0,,,,2,1,1,2
12691_0,,,,2,1,1,2
C(C(C(C(CO)C(CO)O)O)=O)=O,,,4,1,1,0,1
12692_0,,,,2,1,1,2
12693_0,,,,2,1,1,2
12694_0,,,,2,1,1,2
12696_0,,,,2,1,1,2
C(C(C(C(C(CO)CO)O)=O)O)=O,,,4,1,1,0,1
12697_0,,,,2,1,1,2
12698_0,,,,2,1,1,2
12699_0,,,,2,1,1,2
12700_0,,,,2,1,1,2
12701_0,,,,2,1,1,2
12702_0,,,,2,1,1,2
12703_0,,,,2,1,1,2
12704_0,,,,2,1,1,2
12705_0,,,,2,1,1,2
12706_0,,,,2,1,1,2
12707_0,,,,2,1,1,2
12708_0,,,,2,1,1,2
12709_0,,,,2,1,1,2
12710_0,,,,2,1,1,2
12711_0,,,,2,1,1,2
12713_0,,,,2,1,1,2
C(C(C(C)O)=O)(O)=O,,,4,1,3,0,3
12714_0,,,,2,1,1,2
12715_0,,,,2,1,1,2
12716_0,,,,2,1,1,2
12717_0,,,,2,1,1,2
12718_0,,,,2,1,1,2
12719_0,,,,2,1,1,2
12720_0,,,,2,1,1,2
12722_0,,,,2,1,1,2
C(COC(C(CO)=O)O)(C)=O,,,4,1,1,0,1
12724_0,,,,2,1,1,2
C(C(COC(C=O)CO)O)=O,,,4,1,1,0,1
12726_0,,,,2,1,1,2
C(C(C)O)(OC(C=O)CO)=O,,,4,1,1,0,1
12728_0,,,,2,1,1,2
C(OC(C(C(C)O)=O)CO)=O,,,4,1,1,0,1
12730_0,,,,2,1,1,2
C(OC(CO)CC(C=O)O)=O,,,4,1,1,0,1
12731_0,,,,2,1,1,2
12733_0,,,,2,1,1,2
C(C(COCC(C=O)O)O)=O,,,4,1,1,0,1
12735_0,,,,2,1,1,2
C(COCC(CO)=O)(CO)=O,,,4,1,1,0,1
12737_0,,,,2,1,1,2
C(C(C)O)(OCC(C=O)O)=O,,,4,1,1,0,1
12739_0,,,,2,1,1,2
C(COC(C(C)=O)O)(CO)=O,,,4,1,1,0,1
12741_0,,,,2,1,1,2
C(OCC(C(C(C)O)=O)O)=O,,,4,1,1,0,1
12742_0,,,,2,1,1,2
12744_0,,,,2,1,1,2
C(OCC(CC(C=O)O)O)=O,,,4,1,1,0,1
12746_0,,,,2,1,1,2
C(COC(C(C(C)O)=O)O)=O,,,4,1,1,0,1
12747_0,,,,2,1,1,2
12749_0,,,,2,1,1,2
C(COC(C=O)O)(C(C)O)=O,,,4,1,1,0,1
12750_0,,,,2,1,1,2
12752_0,,,,2,1,1,2
C(C(CCOC(C=O)O)O)=O,,,4,1,1,0,1
12753_0,,,,2,1,1,2
12754_0,,,,2,1,1,2
12756_0,,,,2,1,1,2
C(C(C(C(C)O)=O)=O)=O,,,4,1,1,0,1
12757_0,,,,2,1,1,2
12758_0,,,,2,1,1,2
12760_0,,,,2,1,1,2
C(C(C=CC=O)O)=O,,,4,1,4,0,4
12761_0,,,,2,1,1,2
12763_0,,,,2,1,1,2
C(COC(C(CO)=O)(C)O)=O,,,4,1,1,0,1
12764_0,,,,2,1,1,2
12766_0,,,,2,1,1,2
C(CO)(C(CO)OC(C=O)O)=O,,,4,1,1,0,1
12767_0,,,,2,1,1,2
12769_0,,,,2,1,1,2
C(C(CO)O)(OC(C=O)CO)=O,,,4,1,1,0,1
12771_0,,,,2,1,1,2
C(C(C(OC(C=O)CO)O)O)=O,,,4,1,1,0,1
12772_0,,,,2,1,1,2
12774_0,,,,2,1,1,2
C(CO)(C(COC(C=O)O)O)=O,,,4,1,1,0,1
12776_0,,,,2,1,1,2
C(C(CO)O)(OCC(C=O)O)=O,,,4,1,1,0,1
12778_0,,,,2,1,1,2
C(C(C(O)OCC(C=O)O)O)=O,,,4,1,1,0,1
12780_0,,,,2,1,1,2
C(C(O)OCC(CO)=O)(CO)=O,,,4,1,1,0,1
12781_0,,,,2,1,1,2
12782_0,,,,2,1,1,2
12783_0,,,,2,1,1,2
12784_0,,,,2,1,1,2
12785_0,,,,2,1,1,2
12786_0,,,,2,1,1,2
12787_0,,,,2,1,1,2
12788_0,,,,2,1,1,2
12789_0,,,,2,1,1,2
12790_0,,,,2,1,1,2
12791_0,,,,2,1,1,2
12792_0,,,,2,1,1,2
12793_0,,,,2,1,1,2
12794_0,,,,2,1,1,2
12795_0,,,,2,1,1,2
12796_0,,,,2,1,1,2
12798_0,,,,2,1,1,2
C(C(CO)=O)(C(C(C)O)O)=O,,,4,1,3,0,3
12799_0,,,,2,1,1,2
12800_0,,,,2,1,1,2
12801_0,,,,2,1,1,2
12802_0,,,,2,1,1,2
12803_0,,,,2,1,1,2
12804_0,,,,2,1,1,2
12805_0,,,,2,1,1,2
12806_0,,,,2,1,1,2
12807_0,,,,2,1,1,2
12808_0,,,,2,1,1,2
12809_0,,,,2,1,1,2
12810_0,,,,2,1,1,2
12811_0,,,,2,1,1,2
12812_0,,,,2,1,1,2
12813_0,,,,2,1,1,2
12814_0,,,,2,1,1,2
12815_0,,,,2,1,1,2
12816_0,,,,2,1,1,2
12817_0,,,,2,1,1,2
12818_0,,,,2,1,1,2
12819_0,,,,2,1,1,2
12820_0,,,,2,1,1,2
12821_0,,,,2,1,1,2
12822_0,,,,2,1,1,2
12823_0,,,,2,1,1,2
12824_0,,,,2,1,1,2
12825_0,,,,2,1,1,2
12826_0,,,,2,1,1,2
12827_0,,,,2,1,1,2
12828_0,,,,2,1,1,2
12829_0,,,,2,1,1,2
12830_0,,,,2,1,1,2
12831_0,,,,2,1,1,2
12832_0,,,,2,1,1,2
12833_0,,,,2,1,1,2
12834_0,,,,2,1,1,2
12835_0,,,,2,1,1,2
12836_0,,,,2,1,1,2
12837_0,,,,2,1,1,2
12838_0,,,,2,1,1,2
12839_0,,,,2,1,1,2
12841_0,,,,2,1,1,2
C1(C(C(CC(CO)O1)O)O)=O,,,4,1,4,0,4
12842_0,,,,2,1,1,2
12843_0,,,,2,1,1,2
12844_0,,,,2,1,1,2
12845_0,,,,2,1,1,2
12846_0,,,,2,1,1,2
12848_0,,,,2,1,1,2
C1(C(C(CC(CO1)O)O)O)=O,,,4,1,4,0,4
12849_0,,,,2,1,1,2
12850_0,,,,2,1,1,2
12852_0,,,,2,1,1,2
C1(C(O)OCCC(C1O)O)=O,,,4,1,3,0,3
12853_0,,,,2,1,1,2
12854_0,,,,2,1,1,2
12855_0,,,,2,1,1,2
12857_0,,,,2,1,1,2
C(C(C(CO)=O)=O)(CCO)=O,,,4,1,2,0,2
12858_0,,,,2,1,1,2
12859_0,,,,2,1,1,2
12860_0,,,,2,1,1,2
12861_0,,,,2,1,1,2
12862_0,,,,2,1,1,2
12863_0,,,,2,1,1,2
12864_0,,,,2,1,1,2
12866_0,,,,2,1,1,2
C(C)(C(C(C(CO)=O)=O)O)=O,,,4,1,2,0,2
12867_0,,,,2,1,1,2
12868_0,,,,2,1,1,2
12870_0,,,,2,1,1,2
C(C(C(C(C(C)O)=O)=O)O)=O,,,4,1,2,0,2
12871_0,,,,2,1,1,2
12873_0,,,,2,1,1,2
C(C(C(C(C(C)O)O)=O)=O)=O,,,4,1,2,0,2
12874_0,,,,2,1,1,2
12876_0,,,,2,1,1,2
C(CC(C(C(CO)=O)=O)O)=O,,,4,1,2,0,2
12877_0,,,,2,1,1,2
12878_0,,,,2,1,1,2
12879_0,,,,2,1,1,2
12880_0,,,,2,1,1,2
12881_0,,,,2,1,1,2
12882_0,,,,2,1,1,2
12883_0,,,,2,1,1,2
12885_0,,,,2,1,1,2
C=CC(C(C(CO)O)=O)=O,,,4,1,3,0,3
12887_0,,,,2,1,1,2
C=CC(C(C(CO)=O)=O)O,,,4,1,3,0,3
12888_0,,,,2,1,1,2
12890_0,,,,2,1,1,2
C=CC(C(C(C=O)=O)O)O,,,4,1,4,0,4
12891_0,,,,2,1,1,2
12892_0,,,,2,1,1,2
12893_0,,,,2,1,1,2
12894_0,,,,2,1,1,2
12895_0,,,,2,1,1,2
12896_0,,,,2,1,1,2
12897_0,,,,2,1,1,2
12899_0,,,,2,1,1,2
C1(C(CO)OC(C(C1O)O)O)=O,,,4,1,3,0,3
12900_0,,,,2,1,1,2
12902_0,,,,2,1,1,2
C1(C(C(C(O)OCC1O)O)O)=O,,,4,1,3,0,3
12903_0,,,,2,1,1,2
12904_0,,,,2,1,1,2
12905_0,,,,2,1,1,2
12907_0,,,,2,1,1,2
C(C(C)=O)(C(CCO)O)=O,,,4,1,3,0,3
12908_0,,,,2,1,1,2
12909_0,,,,2,1,1,2
12911_0,,,,2,1,1,2
C(CO)(C(CC(C)=O)O)=O,,,4,1,3,0,3
12913_0,,,,2,1,1,2
C(CCC(C(CO)=O)O)=O,,,4,1,3,0,3
12915_0,,,,2,1,1,2
C(C(CO)=O)(CCCO)=O,,,4,1,3,0,3
12917_0,,,,2,1,1,2
C(C(C(CCCO)O)=O)=O,,,4,1,2,0,2
12918_0,,,,2,1,1,2
12919_0,,,,2,1,1,2
12921_0,,,,2,1,1,2
C(CO)(C(C=CCO)O)=O,,,4,1,6,0,6
12923_0,,,,2,1,1,2
C(C(CO)O)(C(C=C)O)=O,,,4,1,4,0,4
12924_0,,,,2,1,1,2
12925_0,,,,2,1,1,2
12927_0,,,,2,1,1,2
C(C(CCC(C(O)=O)=O)O)=O,,,4,1,4,0,4
12929_0,,,,2,1,1,2
C(C(C)O)(CC(C(O)=O)=O)=O,,,4,1,4,0,4
12930_0,,,,2,1,1,2
12932_0,,,,2,1,1,2
C(CC(C(C(C)=O)=O)O)(O)=O,,,4,1,3,0,3
12934_0,,,,2,1,1,2
C(CC(C(C(C)O)=O)=O)(O)=O,,,4,1,3,0,3
12935_0,,,,2,1,1,2
12936_0,,,,2,1,1,2
12938_0,,,,2,1,1,2
C(C)(CC(C(C(O)=O)=O)O)=O,,,4,1,3,0,3
12940_0,,,,2,1,1,2
C(CCC(C(C(O)=O)=O)O)=O,,,4,1,3,0,3
12942_0,,,,2,1,1,2
C(CCC(C(CO)=O)=O)(O)=O,,,4,1,3,0,3
12944_0,,,,2,1,1,2
C(CCC(C(C=O)=O)O)(O)=O,,,4,1,2,0,2
12945_0,,,,2,1,1,2
12946_0,,,,2,1,1,2
12948_0,,,,2,1,1,2
C(C(C(C(CCO)=O)=O)O)(O)=O,,,4,1,4,0,4
12950_0,,,,2,1,1,2
C(C(C(C(CCO)O)=O)=O)(O)=O,,,4,1,2,0,2
12951_0,,,,2,1,1,2
12953_0,,,,2,1,1,2
C(C(CC(C(C(O)=O)=O)O)O)=O,,,4,1,3,0,3
12954_0,,,,2,1,1,2
12956_0,,,,2,1,1,2
C(C(C)O)(C(C(C(O)=O)=O)O)=O,,,4,1,3,0,3
12957_0,,,,2,1,1,2
12959_0,,,,2,1,1,2
C(C(C(C(CC(O)=O)O)=O)O)=O,,,4,1,2,0,2
12961_0,,,,2,1,1,2
C(C(C(C(O)=O)=O)O)=CCO,,,4,1,3,0,3
12963_0,,,,2,1,1,2
C(CO)(C(C=CC(O)=O)O)=O,,,4,1,5,0,5
12965_0,,,,2,1,1,2
C(C(C(C(C=C)O)=O)O)(O)=O,,,4,1,4,0,4
12967_0,,,,2,1,1,2
C(C(C=CC(C=O)O)O)(O)=O,,,4,1,5,0,5
12968_0,,,,2,1,1,2
12969_0,,,,2,1,1,2
12970_0,,,,2,1,1,2
12972_0,,,,2,1,1,2
C1(CC(C(C1(CO)O)=O)O)=O,,,4,1,1,0,1
12974_0,,,,2,1,1,2
C1(C(C(C(CO)(CO)C1O)O)O)=O,,,4,1,1,0,1
12975_0,,,,2,1,1,2
12976_0,,,,2,1,1,2
12978_0,,,,2,1,1,2
C(C(CO)(C(C(CO)=O)(C)O)O)=O,,,4,1,4,0,4
12979_0,,,,2,1,1,2
12980_0,,,,2,1,1,2
12982_0,,,,2,1,1,2
C(C(C)O)(C(C=O)(C(C)=O)O)=O,,,4,1,1,0,1
12984_0,,,,2,1,1,2
C(C(C)O)(C(C(C)=O)(CO)O)=O,,,4,1,1,0,1
12986_0,,,,2,1,1,2
C(C(C=O)(C(C(C)O)=O)O)=O,,,4,1,1,0,1
12988_0,,,,2,1,1,2
C(C(C)O)(C(C=O)(C(C=O)O)O)=O,,,4,1,3,0,3
12990_0,,,,2,1,1,2
C(C(C(CO)=O)(C(C(C)=O)O)O)=O,,,4,1,3,0,3
12992_0,,,,2,1,1,2
C(C(C)(C(C=O)(C(CO)=O)O)O)=O,,,4,1,3,0,3
12994_0,,,,2,1,1,2
C(C(C)O)(C(C(CO)=O)(CO)O)=O,,,4,1,4,0,4
12995_0,,,,2,1,1,2
12997_0,,,,2,1,1,2
C(C(C)(C(CO)(C(C=O)O)O)O)=O,,,4,1,6,0,6
12999_0,,,,2,1,1,2
C(C(C)O)(C(C(C=O)=O)(CO)O)=O,,,4,1,4,0,4
13000_0,,,,2,1,1,2
13002_0,,,,2,1,1,2
C(C(C(CO)=O)(C(C)=O)O)=O,,,4,1,1,0,1
13003_0,,,,2,1,1,2
13005_0,,,,2,1,1,2
C(C(C=O)(C(C(CO)=O)(C)O)O)=O,,,4,1,4,0,4
13006_0,,,,2,1,1,2
13008_0,,,,2,1,1,2
C(C(CO)O)(C(C=O)(C(C)=O)O)=O,,,4,1,1,0,1
13009_0,,,,2,1,1,2
13011_0,,,,2,1,1,2
C(C(C(C(CO)=O)(C(C)=O)O)O)=O,,,4,1,3,0,3
13012_0,,,,2,1,1,2
13014_0,,,,2,1,1,2
C(C(C(CO)=O)(C(C=O)O)O)=O,,,4,1,3,0,3
13016_0,,,,2,1,1,2
C(CO)(C(C(CO)=O)(CO)O)=O,,,4,1,1,0,1
13017_0,,,,2,1,1,2
13019_0,,,,2,1,1,2
C(C(C(CO)=O)(C(CO)O)O)(O)=O,,,4,1,3,0,3
13021_0,,,,2,1,1,2
C(CO)(C(C(C=O)=O)(CO)O)=O,,,4,1,2,0,2
13022_0,,,,2,1,1,2
13024_0,,,,2,1,1,2
C(C(CO)O)(C(C(C)=O)(CO)O)=O,,,4,1,4,0,4
13025_0,,,,2,1,1,2
13026_0,,,,2,1,1,2
13027_0,,,,2,1,1,2
13028_0,,,,2,1,1,2
13029_0,,,,2,1,1,2
13030_0,,,,2,1,1,2
13032_0,,,,2,1,1,2
C(C(C(C(C(C)O)O)=O)(CO)O)=O,,,4,1,4,0,4
13033_0,,,,2,1,1,2
13034_0,,,,2,1,1,2
13035_0,,,,2,1,1,2
13036_0,,,,2,1,1,2
13038_0,,,,2,1,1,2
C(C(C=O)O)(C(C(C)=O)(CO)O)=O,,,4,1,3,0,3
13040_0,,,,2,1,1,2
C(C(C(C(C=C)O)=O)(CO)O)=O,,,4,1,4,0,4
13042_0,,,,2,1,1,2
C(CO)(C(C(C=C)=O)(CO)O)=O,,,4,1,4,0,4
13044_0,,,,2,1,1,2
C(C(C=O)(C(C(CCO)O)=O)O)=O,,,4,1,1,0,1
13046_0,,,,2,1,1,2
C(C(C(C(C)O)=O)(C(C)O)O)=O,,,4,1,3,0,3
13048_0,,,,2,1,1,2
C(C)(C(C(CO)=O)(C(C)O)O)=O,,,4,1,3,0,3
13049_0,,,,2,1,1,2
13050_0,,,,2,1,1,2
13052_0,,,,2,1,1,2
C(C(C=O)(C(C(CO)O)=O)O)=O,,,4,1,1,0,1
13053_0,,,,2,1,1,2
13055_0,,,,2,1,1,2
C(C(C(CO)=O)(C(CO)(C)O)O)=O,,,4,1,3,0,3
13057_0,,,,2,1,1,2
C(C(C(CO)(C(CO)(C)O)O)O)=O,,,4,1,5,0,5
13059_0,,,,2,1,1,2
C(C(C(CO)=O)(C(C)O)O)=O,,,4,1,3,0,3
13060_0,,,,2,1,1,2
13062_0,,,,2,1,1,2
C(C(C(C(C=C)O)=O)(C(C)O)O)=O,,,4,1,3,0,3
13064_0,,,,2,1,1,2
C(CO)(C(C(C=C)=O)(C(C)O)O)=O,,,4,1,3,0,3
13066_0,,,,2,1,1,2
C(C)(C(C(CO)=O)(C(CO)O)O)=O,,,4,1,3,0,3
13067_0,,,,2,1,1,2
13068_0,,,,2,1,1,2
13069_0,,,,2,1,1,2
13070_0,,,,2,1,1,2
13072_0,,,,2,1,1,2
C(C(C)O)(C(C=O)(CC=O)O)=O,,,4,1,1,0,1
13074_0,,,,2,1,1,2
C(C(C(C(C)O)=O)(CCO)O)(O)=O,,,4,1,1,0,1
13076_0,,,,2,1,1,2
C(CO)(C(C)(C(C(O)=O)O)O)=O,,,4,1,3,0,3
13078_0,,,,2,1,1,2
C(C(C(CO)=O)(CC(CO)=O)O)=O,,,4,1,1,0,1
13079_0,,,,2,1,1,2
13081_0,,,,2,1,1,2
C(C(C(CO)=O)(CC=O)O)=O,,,4,1,1,0,1
13083_0,,,,2,1,1,2
C(C(C(CO)=O)(CCO)O)(O)=O,,,4,1,1,0,1
13085_0,,,,2,1,1,2
C(C(CC(C=O)O)(C(C)O)O)=O,,,4,1,2,0,2
13086_0,,,,2,1,1,2
13087_0,,,,2,1,1,2
13088_0,,,,2,1,1,2
13089_0,,,,2,1,1,2
13090_0,,,,2,1,1,2
13092_0,,,,2,1,1,2
C(C(CO)=O)(C(CO)(CCO)O)=O,,,4,1,2,0,2
13093_0,,,,2,1,1,2
13094_0,,,,2,1,1,2
13095_0,,,,2,1,1,2
13096_0,,,,2,1,1,2
13098_0,,,,2,1,1,2
C(C(CO)(C)O)(C(C(CO)=O)O)=O,,,4,1,2,0,2
13099_0,,,,2,1,1,2
13101_0,,,,2,1,1,2
C(C(CO)(CCC(C=O)O)O)(O)=O,,,4,1,2,0,2
13103_0,,,,2,1,1,2
C(C(CO)(CC(C(C)O)=O)O)(O)=O,,,4,1,2,0,2
13105_0,,,,2,1,1,2
C(C(CC(C(C=O)=O)(CO)O)O)=O,,,4,1,3,0,3
13107_0,,,,2,1,1,2
C(C(C=CC(C=O)O)(CO)O)=O,,,4,1,4,0,4
13108_0,,,,2,1,1,2
13109_0,,,,2,1,1,2
13111_0,,,,2,1,1,2
C(C(CO)O)(C(C=O)(CC=O)O)=O,,,4,1,1,0,1
13112_0,,,,2,1,1,2
13113_0,,,,2,1,1,2
13115_0,,,,2,1,1,2
C(C(C=CC(C=O)O)(C(C)O)O)=O,,,4,1,2,0,2
13116_0,,,,2,1,1,2
13117_0,,,,2,1,1,2
13118_0,,,,2,1,1,2
13119_0,,,,2,1,1,2
13121_0,,,,2,1,1,2
C(CO)(C(CO)OC(CO)=O)=O,,,4,1,1,0,1
13123_0,,,,2,1,1,2
C(CO)(C(COC(CO)=O)O)=O,,,4,1,1,0,1
13124_0,,,,2,1,1,2
13126_0,,,,2,1,1,2
C1(C(C(CC1CO)O)=O)=O,,,4,1,2,0,2
13128_0,,,,2,1,1,2
C1(C(C(C(CO)C1)O)=O)=O,,,4,1,3,0,3
13129_0,,,,2,1,1,2
13131_0,,,,2,1,1,2
C1(C(COC1C(C)=O)O)=O,,,4,1,2,0,2
13132_0,,,,2,1,1,2
13133_0,,,,2,1,1,2
13134_0,,,,2,1,1,2
13136_0,,,,2,1,1,2
C1(CCC(C(CO1)=O)O)=O,,,4,1,2,0,2
13138_0,,,,2,1,1,2
C1(CC(C(CCO1)O)=O)=O,,,4,1,2,0,2
13139_0,,,,2,1,1,2
13141_0,,,,2,1,1,2
C1(C(C(COCC1)O)=O)=O,,,4,1,2,0,2
13143_0,,,,2,1,1,2
C1(C(COCCC1O)=O)=O,,,4,1,2,0,2
13144_0,,,,2,1,1,2
13145_0,,,,2,1,1,2
13146_0,,,,2,1,1,2
13148_0,,,,2,1,1,2
C(C(CC=CC(O)=O)O)=O,,,4,1,2,0,2
13150_0,,,,2,1,1,2
C(C=CC(C(C)O)=O)(O)=O,,,4,1,2,0,2
13151_0,,,,2,1,1,2
13152_0,,,,2,1,1,2
13153_0,,,,2,1,1,2
13154_0,,,,2,1,1,2
13156_0,,,,2,1,1,2
C(C1C(C(C(C)O1)O)=O)=O,,,4,1,1,0,1
13157_0,,,,2,1,1,2
13159_0,,,,2,1,1,2
C1(C(C(OC1C(C)=O)O)O)=O,,,4,1,3,0,3
13160_0,,,,2,1,1,2
13162_0,,,,2,1,1,2
C(CC1C(C(C(O1)O)O)=O)=O,,,4,1,3,0,3
13164_0,,,,2,1,1,2
C(C1C(C(C(CO)O1)=O)O)=O,,,4,1,1,0,1
13165_0,,,,2,1,1,2
13166_0,,,,2,1,1,2
13168_0,,,,2,1,1,2
C1(C(CO)(O)OCCC1O)=O,,,4,1,2,0,2
13169_0,,,,2,1,1,2
13170_0,,,,2,1,1,2
13172_0,,,,2,1,1,2
C1(C(C(C=O)OCC1O)O)=O,,,4,1,1,0,1
13174_0,,,,2,1,1,2
C(C1(CC(C(CO1)=O)O)O)=O,,,4,1,2,0,2
13176_0,,,,2,1,1,2
C(C1(C(C(CCO1)O)=O)O)=O,,,4,1,2,0,2
13177_0,,,,2,1,1,2
13178_0,,,,2,1,1,2
13180_0,,,,2,1,1,2
C1(COC(C(CC1O)=O)O)=O,,,4,1,2,0,2
13181_0,,,,2,1,1,2
13183_0,,,,2,1,1,2
C1(C(C(C(O)OCC1)O)=O)=O,,,4,1,3,0,3
13185_0,,,,2,1,1,2
C1(C(C(O)OCCC1O)=O)=O,,,4,1,2,0,2
13186_0,,,,2,1,1,2
13188_0,,,,2,1,1,2
C1(C(C(OCC(C1)=O)O)O)=O,,,4,1,3,0,3
13190_0,,,,2,1,1,2
C1(CC(C(C(CO)O1)=O)O)=O,,,4,1,2,0,2
13192_0,,,,2,1,1,2
C1(C(C(CC(CO)O1)O)=O)=O,,,4,1,2,0,2
13194_0,,,,2,1,1,2
C1(CC(C(C(CO1)O)=O)O)=O,,,4,1,2,0,2
13196_0,,,,2,1,1,2
C1(C(C(CC(CO1)O)O)=O)=O,,,4,1,2,0,2
13198_0,,,,2,1,1,2
C1(C(CC(C(CO1)=O)O)O)=O,,,4,1,2,0,2
13200_0,,,,2,1,1,2
C1(C(C(C(CCO1)O)=O)O)=O,,,4,1,2,0,2
13201_0,,,,2,1,1,2
13203_0,,,,2,1,1,2
C(C(CCC(C=O)O)O)=O,,,4,1,2,0,2
13204_0,,,,2,1,1,2
13206_0,,,,2,1,1,2
C(CC(C=O)O)(C(C)O)=O,,,4,1,2,0,2
13208_0,,,,2,1,1,2
C1(C(C=C(CO)C1O)O)=O,,,4,1,3,0,3
13210_0,,,,2,1,1,2
C1(C(C(C(C1O)=C)O)O)=O,,,4,1,3,0,3
13212_0,,,,2,1,1,2
C(CO)(C(C(C=C)O)O)=O,,,4,1,2,0,2
13213_0,,,,2,1,1,2
13215_0,,,,2,1,1,2
C1(C(CO)OC=CC1O)=O,,,4,1,2,0,2
13216_0,,,,2,1,1,2
13218_0,,,,2,1,1,2
C1(C(COC=CC1O)O)=O,,,4,1,2,0,2
13220_0,,,,2,1,1,2
C1(C(O)OCC=CC1O)=O,,,4,1,2,0,2
13222_0,,,,2,1,1,2
C1(COC(C=CC1O)O)=O,,,4,1,3,0,3
13224_0,,,,2,1,1,2
C(C(C(C(C=C)=O)=O)O)=O,,,4,1,2,0,2
13226_0,,,,2,1,1,2
C=CC(C(C(C=O)=O)=O)O,,,4,1,2,0,2
13228_0,,,,2,1,1,2
C(C(C=CC(C=O)=O)O)=O,,,4,1,4,0,4
13230_0,,,,2,1,1,2
C(C(C(C=CC=O)=O)O)=O,,,4,1,7,0,7
13232_0,,,,2,1,1,2
C1C(COC=1C(CO)=O)O,,,4,1,2,0,2
13234_0,,,,2,1,1,2
C(CO)(C1(C=CCO1)O)=O,,,4,1,2,0,2
13236_0,,,,2,1,1,2
C(CO)(C1C=CC(O1)O)=O,,,4,1,3,0,3
13238_0,,,,2,1,1,2
C(CO)(C1C(C=CO1)O)=O,,,4,1,2,0,2
13239_0,,,,2,1,1,2
13240_0,,,,2,1,1,2
13242_0,,,,2,1,1,2
C1(C(CCO)(O)OCC1O)=O,,,4,1,2,0,2
13244_0,,,,2,1,1,2
C1(C(O)OC(CCO)C1O)=O,,,4,1,3,0,3
13246_0,,,,2,1,1,2
C(CO)(C1(C(CCO1)O)O)=O,,,4,1,2,0,2
13247_0,,,,2,1,1,2
13249_0,,,,2,1,1,2
C(CO)(C1(C(C(CO1)O)O)O)=O,,,4,1,3,0,3
13250_0,,,,2,1,1,2
13251_0,,,,2,1,1,2
13252_0,,,,2,1,1,2
13254_0,,,,2,1,1,2
C1(C(C(C)(O)OCC1O)O)=O,,,4,1,2,0,2
13256_0,,,,2,1,1,2
C1(C(C(C)OC(C1O)O)O)=O,,,4,1,2,0,2
13257_0,,,,2,1,1,2
13259_0,,,,2,1,1,2
C1(CC(C(C(CO)=O)O1)O)=O,,,4,1,2,0,2
13261_0,,,,2,1,1,2
C1(C(C(C(C(CO)O)O1)=O)O)=O,,,4,1,2,0,2
13263_0,,,,2,1,1,2
C1(C(C(C(C(CO)O1)O)=O)O)=O,,,4,1,2,0,2
13265_0,,,,2,1,1,2
C1(C(C(C(C(CO1)O)O)=O)O)=O,,,4,1,2,0,2
13267_0,,,,2,1,1,2
C(CC(CO)CC(C(CO)=O)=O)=O,,,4,1,2,0,2
13269_0,,,,2,1,1,2
C(CC(CO)CC(C(C=O)=O)O)=O,,,4,1,1,0,1
13271_0,,,,2,1,1,2
C(CO)(C(CC(C=O)CC=O)O)=O,,,4,1,2,0,2
13273_0,,,,2,1,1,2
C(CC(C(C(CO)=O)O)CC=O)=O,,,4,1,3,0,3
13275_0,,,,2,1,1,2
C(CCCC(C(C(CO)=O)O)=O)=O,,,4,1,2,0,2
13277_0,,,,2,1,1,2
C(CCCC(C(C(C=O)O)=O)O)=O,,,4,1,1,0,1
13279_0,,,,2,1,1,2
C(CC(C(CO)=O)CC(CO)=O)=O,,,4,1,3,0,3
13281_0,,,,2,1,1,2
C(CC(CC(C=O)O)C(C=O)O)=O,,,4,1,1,0,1
13282_0,,,,2,1,1,2
13283_0,,,,2,3,2,5
13284_0,,,,2,3,2,5
13286_0,,,,2,3,2,5
C1(C(C(C(C1)O)CO)O)=O,,,4,1,2,0,2
13287_0,,,,2,3,2,5
13289_0,,,,2,3,2,5
C1(C(C(C(CO)C1)O)O)=O,,,4,1,3,0,3
13290_0,,,,2,3,2,5
13291_0,,,,2,3,2,5
13292_0,,,,2,3,2,5
13293_0,,,,2,3,2,5
13294_0,,,,2,3,2,5
13295_0,,,,2,3,2,5
13296_0,,,,2,3,2,5
13297_0,,,,2,3,2,5
13298_0,,,,2,3,2,5
13299_0,,,,2,3,2,5
13300_0,,,,2,3,2,5
13301_0,,,,2,3,2,5
13302_0,,,,2,3,2,5
13303_0,,,,2,3,2,5
13304_0,,,,2,3,2,5
13305_0,,,,2,3,2,5
13306_0,,,,2,3,2,5
13307_0,,,,2,3,2,5
13308_0,,,,2,3,2,5
13310_0,,,,2,3,2,5
C(C(CO)(CCO)O)O,,,4,1,1,0,1
13311_0,,,,2,3,2,5
13312_0,,,,2,3,2,5
13313_0,,,,2,3,2,5
13314_0,,,,2,3,2,5
13315_0,,,,2,3,2,5
13316_0,,,,2,3,2,5
13317_0,,,,2,3,2,5
13318_0,,,,2,3,2,5
13320_0,,,,2,3,2,5
C(C(C(CCO)O)O)O,,,4,1,3,0,3
13321_0,,,,2,3,2,5
13322_0,,,,2,3,2,5
13323_0,,,,2,3,2,5
13324_0,,,,2,3,2,5
13325_0,,,,2,3,2,5
13326_0,,,,2,3,2,5
13327_0,,,,2,3,2,5
13328_0,,,,2,3,2,5
13329_0,,,,2,3,2,5
13330_0,,,,2,3,2,5
13331_0,,,,2,3,2,5
13332_0,,,,2,3,2,5
13333_0,,,,2,3,2,5
13334_0,,,,2,3,2,5
13335_0,,,,2,3,2,5
13336_0,,,,2,3,2,5
13337_0,,,,2,3,2,5
13338_0,,,,2,3,2,5
13339_0,,,,2,3,2,5
13340_0,,,,2,3,2,5
13341_0,,,,2,3,2,5
13342_0,,,,2,3,2,5
13343_0,,,,2,3,2,5
13344_0,,,,2,3,2,5
13345_0,,,,2,3,2,5
13346_0,,,,2,3,2,5
13347_0,,,,2,3,2,5
13348_0,,,,2,3,2,5
13349_0,,,,2,3,2,5
13350_0,,,,2,3,2,5
13351_0,,,,2,3,2,5
13352_0,,,,2,3,2,5
13353_0,,,,2,3,2,5
13354_0,,,,2,3,2,5
13355_0,,,,2,3,2,5
13356_0,,,,2,3,2,5
13357_0,,,,2,3,2,5
13358_0,,,,2,3,2,5
13359_0,,,,2,3,2,5
13360_0,,,,2,3,2,5
13361_0,,,,2,3,2,5
13362_0,,,,2,3,2,5
13363_0,,,,2,3,2,5
13364_0,,,,2,3,2,5
13365_0,,,,2,3,2,5
13366_0,,,,2,3,2,5
13367_0,,,,2,3,2,5
13369_0,,,,2,3,2,5
C(C)(C(CCO)O)=O,,,4,1,1,0,1
13370_0,,,,2,3,2,5
13372_0,,,,2,3,2,5
C(C(C)(CCO)O)=O,,,4,1,1,0,1
13373_0,,,,2,3,2,5
13374_0,,,,2,3,2,5
13375_0,,,,2,3,2,5
13376_0,,,,2,3,2,5
13377_0,,,,2,3,2,5
13378_0,,,,2,3,2,5
13379_0,,,,2,3,2,5
13380_0,,,,2,3,2,5
13381_0,,,,2,3,2,5
13382_0,,,,2,3,2,5
13383_0,,,,2,3,2,5
13384_0,,,,2,3,2,5
13385_0,,,,2,3,2,5
13386_0,,,,2,3,2,5
13387_0,,,,2,3,2,5
13388_0,,,,2,3,2,5
13389_0,,,,2,3,2,5
13390_0,,,,2,3,2,5
13391_0,,,,2,3,2,5
13392_0,,,,2,3,2,5
13393_0,,,,2,3,2,5
13394_0,,,,2,3,2,5
13395_0,,,,2,3,2,5
13396_0,,,,2,3,2,5
13397_0,,,,2,3,2,5
13398_0,,,,2,3,2,5
13399_0,,,,2,3,2,5
13400_0,,,,2,3,2,5
13401_0,,,,2,3,2,5
13402_0,,,,2,3,2,5
13403_0,,,,2,3,2,5
13404_0,,,,2,3,2,5
13405_0,,,,2,3,2,5
13406_0,,,,2,3,2,5
13407_0,,,,2,3,2,5
13408_0,,,,2,3,2,5
13409_0,,,,2,3,2,5
13410_0,,,,2,3,2,5
13411_0,,,,2,3,2,5
13412_0,,,,2,3,2,5
13413_0,,,,2,3,2,5
13414_0,,,,2,3,2,5
13415_0,,,,2,3,2,5
13416_0,,,,2,3,2,5
13417_0,,,,2,3,2,5
13418_0,,,,2,3,2,5
13419_0,,,,2,3,2,5
13420_0,,,,2,3,2,5
13421_0,,,,2,3,2,5
13422_0,,,,2,3,2,5
13423_0,,,,2,3,2,5
13424_0,,,,2,3,2,5
13425_0,,,,2,3,2,5
13426_0,,,,2,3,2,5
13427_0,,,,2,3,2,5
13428_0,,,,2,3,2,5
13429_0,,,,2,3,2,5
13430_0,,,,2,3,2,5
13431_0,,,,2,3,2,5
13432_0,,,,2,3,2,5
13433_0,,,,2,3,2,5
13434_0,,,,2,3,2,5
13435_0,,,,2,3,2,5
13436_0,,,,2,3,2,5
13437_0,,,,2,3,2,5
13438_0,,,,2,3,2,5
13439_0,,,,2,3,2,5
13441_0,,,,2,3,2,5
CC(CCO)(C(CO)O)O,,,4,1,1,0,1
13442_0,,,,2,3,2,5
13443_0,,,,2,3,2,5
13444_0,,,,2,3,2,5
13445_0,,,,2,3,2,5
13446_0,,,,2,3,2,5
13447_0,,,,2,3,2,5
13448_0,,,,2,3,2,5
13449_0,,,,2,3,2,5
13450_0,,,,2,3,2,5
13451_0,,,,2,3,2,5
13453_0,,,,2,3,2,5
C(CCO)O,,,4,1,1,0,1
13454_0,,,,2,3,2,5
13455_0,,,,2,3,2,5
13456_0,,,,2,3,2,5
13458_0,,,,2,3,2,5
C(CO)(C(C(C(CO)CO)O)O)=O,,,4,1,1,0,1
13460_0,,,,2,3,2,5
C(C(CO)C(C(C(CO)O)O)O)O,,,4,1,1,0,1
13461_0,,,,2,3,2,5
13462_0,,,,2,3,2,5
13463_0,,,,2,3,2,5
13464_0,,,,2,3,2,5
13465_0,,,,2,3,2,5
13466_0,,,,2,3,2,5
13467_0,,,,2,3,2,5
13468_0,,,,2,3,2,5
13470_0,,,,2,3,2,5
C(C(CC(C(CO)CO)O)=O)=O,,,4,1,1,0,1
13471_0,,,,2,3,2,5
13472_0,,,,2,3,2,5
13473_0,,,,2,3,2,5
13474_0,,,,2,3,2,5
13475_0,,,,2,3,2,5
13476_0,,,,2,3,2,5
13477_0,,,,2,3,2,5
13478_0,,,,2,3,2,5
13479_0,,,,2,3,2,5
13480_0,,,,2,3,2,5
13482_0,,,,2,3,2,5
C(CC(C(C(CO)CO)O)=O)=O,,,4,1,1,0,1
13483_0,,,,2,3,2,5
13484_0,,,,2,3,2,5
13485_0,,,,2,3,2,5
13486_0,,,,2,3,2,5
13487_0,,,,2,3,2,5
13489_0,,,,2,3,2,5
C(C(C(CC(CO)CO)=O)O)=O,,,4,1,2,0,2
13490_0,,,,2,3,2,5
13491_0,,,,2,3,2,5
13492_0,,,,2,3,2,5
13493_0,,,,2,3,2,5
13494_0,,,,2,3,2,5
13495_0,,,,2,3,2,5
13497_0,,,,2,3,2,5
C1(C(C(C(C(CO)CO)O1)O)O)O,,,4,1,1,0,1
13499_0,,,,2,3,2,5
C(C(CC(C(CO)CO)O)O)(O)=O,,,4,1,1,0,1
13500_0,,,,2,3,2,5
13501_0,,,,2,3,2,5
13502_0,,,,2,3,2,5
13503_0,,,,2,3,2,5
13504_0,,,,2,3,2,5
13505_0,,,,2,3,2,5
13506_0,,,,2,3,2,5
13508_0,,,,2,3,2,5
C(C(C(C(C(CO)CO)O)O)=O)=O,,,4,1,2,0,2
13509_0,,,,2,3,2,5
13511_0,,,,2,3,2,5
C1C(C(C(C(CO)CO)(O)O1)O)O,,,4,1,2,0,2
13512_0,,,,2,3,2,5
13513_0,,,,2,3,2,5
13514_0,,,,2,3,2,5
13515_0,,,,2,3,2,5
13516_0,,,,2,3,2,5
13517_0,,,,2,3,2,5
13519_0,,,,2,3,2,5
C(C(CCO)O)(CCO)=O,,,4,1,3,0,3
13520_0,,,,2,3,2,5
13522_0,,,,2,3,2,5
C(C(CCO)(CCO)O)=O,,,4,1,1,0,1
13523_0,,,,2,3,2,5
13524_0,,,,2,3,2,5
13525_0,,,,2,3,2,5
13526_0,,,,2,3,2,5
13527_0,,,,2,3,2,5
13528_0,,,,2,3,2,5
13529_0,,,,2,3,2,5
13531_0,,,,2,3,2,5
C(C(CCO)(CCO)O)O,,,4,1,1,0,1
13532_0,,,,2,3,2,5
13533_0,,,,2,3,2,5
13534_0,,,,2,3,2,5
13535_0,,,,2,3,2,5
13536_0,,,,2,3,2,5
13537_0,,,,2,3,2,5
13539_0,,,,2,3,2,5
C(C(C(C(C)(CCO)O)O)O)=O,,,4,1,1,0,1
13540_0,,,,2,3,2,5
13541_0,,,,2,3,2,5
13542_0,,,,2,3,2,5
13543_0,,,,2,3,2,5
13544_0,,,,2,3,2,5
13545_0,,,,2,3,2,5
13546_0,,,,2,3,2,5
13547_0,,,,2,3,2,5
13548_0,,,,2,3,2,5
13549_0,,,,2,3,2,5
13550_0,,,,2,3,2,5
13551_0,,,,2,3,2,5
13552_0,,,,2,3,2,5
13554_0,,,,2,3,2,5
CC(CO)(CCO)O,,,4,1,1,0,1
13555_0,,,,2,3,2,5
13556_0,,,,2,3,2,5
13557_0,,,,2,3,2,5
13558_0,,,,2,3,2,5
13559_0,,,,2,3,2,5
13560_0,,,,2,3,2,5
13561_0,,,,2,3,2,5
13562_0,,,,2,3,2,5
13563_0,,,,2,3,2,5
13565_0,,,,2,3,2,5
C(C(CC(CCO)O)O)=O,,,4,1,2,0,2
13566_0,,,,2,3,2,5
13567_0,,,,2,3,2,5
13568_0,,,,2,3,2,5
13569_0,,,,2,3,2,5
13570_0,,,,2,3,2,5
13571_0,,,,2,3,2,5
13572_0,,,,2,3,2,5
13573_0,,,,2,3,2,5
13574_0,,,,2,3,2,5
13576_0,,,,2,3,2,5
CC(CCO)O,,,4,1,1,0,1
13577_0,,,,2,3,2,5
13578_0,,,,2,3,2,5
13579_0,,,,2,3,2,5
13580_0,,,,2,3,2,5
13582_0,,,,2,3,2,5
C(C(C(CO)(CCO)O)O)O,,,4,1,3,0,3
13584_0,,,,2,3,2,5
C(CCO)(CC(C(CCO)O)=O)=O,,,4,1,1,0,1
13585_0,,,,2,3,2,5
13586_0,,,,2,3,2,5
13588_0,,,,2,3,2,5
C(C(CC(CCO)(CCO)O)=O)=O,,,4,1,1,0,1
13589_0,,,,2,3,2,5
13590_0,,,,2,3,2,5
13591_0,,,,2,3,2,5
13593_0,,,,2,3,2,5
C(CCC(C(CCO)O)=O)(CO)=O,,,4,1,1,0,1
13595_0,,,,2,3,2,5
C(C(CCC(CO)=O)(CCO)O)=O,,,4,1,2,0,2
13596_0,,,,2,3,2,5
13598_0,,,,2,3,2,5
C(C(CCC(CO)(CCO)O)=O)=O,,,4,1,1,0,1
13599_0,,,,2,3,2,5
13600_0,,,,2,3,2,5
13601_0,,,,2,3,2,5
13602_0,,,,2,3,2,5
13604_0,,,,2,3,2,5
C(CC(C(C)=O)O)(C(CCO)O)=O,,,4,1,1,0,1
13606_0,,,,2,3,2,5
C(C(CC(C(C)=O)O)(CCO)O)=O,,,4,1,1,0,1
13607_0,,,,2,3,2,5
13609_0,,,,2,3,2,5
C(C(CC(C(C)(CCO)O)O)=O)=O,,,4,1,1,0,1
13610_0,,,,2,3,2,5
13611_0,,,,2,3,2,5
13612_0,,,,2,3,2,5
13613_0,,,,2,3,2,5
13614_0,,,,2,3,2,5
13615_0,,,,2,3,2,5
13616_0,,,,2,3,2,5
13617_0,,,,2,3,2,5
13619_0,,,,2,3,2,5
C(C(CC(CC(CCO)O)O)=O)=O,,,4,1,1,0,1
13620_0,,,,2,3,2,5
13621_0,,,,2,3,2,5
13622_0,,,,2,3,2,5
13623_0,,,,2,3,2,5
13625_0,,,,2,3,2,5
C(C(CC(C(CO)C(C)O)O)=O)=O,,,4,1,1,0,1
13627_0,,,,2,3,2,5
C(C(CCO)=O)(CC(CCO)O)=O,,,4,1,1,0,1
13628_0,,,,2,3,2,5
13630_0,,,,2,3,2,5
C(CC(C(CCO)(CCO)O)=O)=O,,,4,1,1,0,1
13631_0,,,,2,3,2,5
13632_0,,,,2,3,2,5
13633_0,,,,2,3,2,5
13635_0,,,,2,3,2,5
C(CC(CCO)O)(CC(CO)=O)=O,,,4,1,1,0,1
13636_0,,,,2,3,2,5
13637_0,,,,2,3,2,5
13638_0,,,,2,3,2,5
13639_0,,,,2,3,2,5
13640_0,,,,2,3,2,5
13641_0,,,,2,3,2,5
13643_0,,,,2,3,2,5
C(CC(CCO)O)(C(C(C)=O)O)=O,,,4,1,1,0,1
13644_0,,,,2,3,2,5
13645_0,,,,2,3,2,5
13646_0,,,,2,3,2,5
13647_0,,,,2,3,2,5
13648_0,,,,2,3,2,5
13649_0,,,,2,3,2,5
13650_0,,,,2,3,2,5
13652_0,,,,2,3,2,5
C(CC(C(CC(CCO)O)O)=O)=O,,,4,1,1,0,1
13653_0,,,,2,3,2,5
13654_0,,,,2,3,2,5
13655_0,,,,2,3,2,5
13656_0,,,,2,3,2,5
13658_0,,,,2,3,2,5
C(CC(C(C(CO)C(C)O)O)=O)=O,,,4,1,1,0,1
13660_0,,,,2,3,2,5
C(C(C(CCO)O)O)(CC(C)=O)=O,,,4,1,1,0,1
13662_0,,,,2,3,2,5
C(C(C(CCO)(CC(C)=O)O)O)=O,,,4,1,1,0,1
13663_0,,,,2,3,2,5
13664_0,,,,2,3,2,5
13665_0,,,,2,3,2,5
13666_0,,,,2,3,2,5
13667_0,,,,2,3,2,5
13669_0,,,,2,3,2,5
C(CCC=O)(C(C(CCO)O)O)=O,,,4,1,1,0,1
13670_0,,,,2,3,2,5
13672_0,,,,2,3,2,5
C(CCC(CCO)(C(C=O)O)O)=O,,,4,1,1,0,1
13673_0,,,,2,3,2,5
13674_0,,,,2,3,2,5
13676_0,,,,2,3,2,5
C(C(C(CCC(CCO)O)=O)O)=O,,,4,1,1,0,1
13677_0,,,,2,3,2,5
13678_0,,,,2,3,2,5
13679_0,,,,2,3,2,5
13680_0,,,,2,3,2,5
13682_0,,,,2,3,2,5
C(C(C(CC(CO)C(C)O)=O)O)=O,,,4,1,2,0,2
13683_0,,,,2,3,2,5
13685_0,,,,2,3,2,5
C(C(CC(C(C)=O)(CCO)O)O)=O,,,4,1,1,0,1
13686_0,,,,2,3,2,5
13688_0,,,,2,3,2,5
C(CC(C=O)O)(C(C)(CCO)O)=O,,,4,1,1,0,1
13689_0,,,,2,3,2,5
13690_0,,,,2,3,2,5
13691_0,,,,2,3,2,5
13692_0,,,,2,3,2,5
13693_0,,,,2,3,2,5
13694_0,,,,2,3,2,5
13695_0,,,,2,3,2,5
13697_0,,,,2,3,2,5
C(CC(C=O)O)(CC(CCO)O)=O,,,4,1,1,0,1
13698_0,,,,2,3,2,5
13699_0,,,,2,3,2,5
13700_0,,,,2,3,2,5
13701_0,,,,2,3,2,5
13702_0,,,,2,3,2,5
13704_0,,,,2,3,2,5
C(C(CO)O)=CC(C(CCO)O)=O,,,4,1,1,0,1
13706_0,,,,2,3,2,5
C(C(C=CC(CO)O)(CCO)O)=O,,,4,1,1,0,1
13707_0,,,,2,3,2,5
13709_0,,,,2,3,2,5
C(CO)=CC(C(C(CCO)O)O)=O,,,4,1,1,0,1
13711_0,,,,2,3,2,5
C(C(C(C=CCO)(CCO)O)O)=O,,,4,1,1,0,1
13712_0,,,,2,3,2,5
13714_0,,,,2,3,2,5
C(C(CCO)O)=CC(C(CO)O)=O,,,4,1,1,0,1
13716_0,,,,2,3,2,5
C(C(C(CO)O)(CCO)O)=CC=O,,,4,1,1,0,1
13717_0,,,,2,3,2,5
13718_0,,,,2,3,2,5
13720_0,,,,2,3,2,5
C(C(C(C(C=C)(CCO)O)O)O)=O,,,4,1,1,0,1
13721_0,,,,2,3,2,5
13723_0,,,,2,3,2,5
C(C(C(CCO)O)O)=CC(CO)=O,,,4,1,1,0,1
13725_0,,,,2,3,2,5
C(C(C=CC(CO)(CCO)O)O)=O,,,4,1,1,0,1
13726_0,,,,2,3,2,5
13727_0,,,,2,3,2,5
13729_0,,,,2,3,2,5
C(C(C(C(CCO)O)O)O)=CC=O,,,4,1,1,0,1
13730_0,,,,2,3,2,5
13732_0,,,,2,3,2,5
C(C(C(C=CC(CCO)O)O)O)=O,,,4,1,1,0,1
13733_0,,,,2,3,2,5
13735_0,,,,2,3,2,5
C(C(C(CO)O)(CCO)O)=O,,,4,1,4,0,4
13736_0,,,,2,3,2,5
13737_0,,,,2,3,2,5
13738_0,,,,2,3,2,5
13739_0,,,,2,3,2,5
13741_0,,,,2,3,2,5
C(C(CO)(C(CO)O)O)O,,,4,1,5,0,5
13743_0,,,,2,3,2,5
C(C(C(C(CO)O)O)O)O,,,4,1,5,0,5
13744_0,,,,2,3,2,5
13745_0,,,,2,3,2,5
13746_0,,,,2,3,2,5
13747_0,,,,2,3,2,5
13748_0,,,,2,3,2,5
13749_0,,,,2,3,2,5
13750_0,,,,2,3,2,5
13752_0,,,,2,3,2,5
CC(C(CO)O)(C(CO)O)O,,,4,1,2,0,2
13753_0,,,,2,3,2,5
13754_0,,,,2,3,2,5
13755_0,,,,2,3,2,5
13756_0,,,,2,3,2,5
13757_0,,,,2,3,2,5
13758_0,,,,2,3,2,5
13759_0,,,,2,3,2,5
13760_0,,,,2,3,2,5
13761_0,,,,2,3,2,5
13762_0,,,,2,3,2,5
13763_0,,,,2,3,2,5
13764_0,,,,2,3,2,5
13766_0,,,,2,3,2,5
CC(CO)(C(CO)O)O,,,4,1,2,0,2
13767_0,,,,2,3,2,5
13768_0,,,,2,3,2,5
13769_0,,,,2,3,2,5
13771_0,,,,2,3,2,5
CC(C(CO)O)O,,,4,1,3,0,3
13773_0,,,,2,3,2,5
C(C(CCO)O)O,,,4,1,3,0,3
13774_0,,,,2,3,2,5
13775_0,,,,2,3,2,5
13776_0,,,,2,3,2,5
13777_0,,,,2,3,2,5
13778_0,,,,2,3,2,5
13779_0,,,,2,3,2,5
13780_0,,,,2,3,2,5
13781_0,,,,2,3,2,5
13782_0,,,,2,3,2,5
13783_0,,,,2,3,2,5
13784_0,,,,2,3,2,5
13785_0,,,,2,3,2,5
13787_0,,,,2,3,2,5
C(C(C(C(C(CO)CO)O)O)O)=O,,,4,1,1,0,1
13788_0,,,,2,3,2,5
13789_0,,,,2,3,2,5
13790_0,,,,2,3,2,5
13791_0,,,,2,3,2,5
13792_0,,,,2,3,2,5
13793_0,,,,2,3,2,5
13794_0,,,,2,3,2,5
13795_0,,,,2,3,2,5
13796_0,,,,2,3,2,5
13797_0,,,,2,3,2,5
13799_0,,,,2,3,2,5
C(CC(CO)O)(O)=O,,,4,1,3,0,3
13800_0,,,,2,3,2,5
13801_0,,,,2,3,2,5
13802_0,,,,2,3,2,5
13803_0,,,,2,3,2,5
13804_0,,,,2,3,2,5
13805_0,,,,2,3,2,5
13807_0,,,,2,3,2,5
C(COC(C(CO)O)O)(C)=O,,,4,1,1,0,1
13809_0,,,,2,3,2,5
C(COC(CO)CO)(CO)=O,,,4,1,1,0,1
13811_0,,,,2,3,2,5
C(C(O)OC(CO)CO)(C)=O,,,4,1,1,0,1
13813_0,,,,2,3,2,5
C(C)(C(CO)OC(CO)O)=O,,,4,1,1,0,1
13815_0,,,,2,3,2,5
C(COCC(CO)O)(CO)=O,,,4,1,1,0,1
13817_0,,,,2,3,2,5
C(C(O)OCC(CO)O)(C)=O,,,4,1,1,0,1
13819_0,,,,2,3,2,5
C(CO)(CC(O)OCCO)=O,,,4,1,1,0,1
13821_0,,,,2,3,2,5
C(C)(C(C(O)OCCO)O)=O,,,4,1,1,0,1
13823_0,,,,2,3,2,5
C(C)(C(COC(CO)O)O)=O,,,4,1,1,0,1
13825_0,,,,2,3,2,5
C(CO)(CCOC(CO)O)=O,,,4,1,1,0,1
13826_0,,,,2,3,2,5
13827_0,,,,2,3,2,5
13828_0,,,,2,3,2,5
13829_0,,,,2,3,2,5
13830_0,,,,2,3,2,5
13831_0,,,,2,3,2,5
13832_0,,,,2,3,2,5
13833_0,,,,2,3,2,5
13834_0,,,,2,3,2,5
13835_0,,,,2,3,2,5
13837_0,,,,2,3,2,5
C(CC(CO)(O)OCCO)=O,,,4,1,1,0,1
13839_0,,,,2,3,2,5
C(COC(CO)(CCO)O)=O,,,4,1,1,0,1
13841_0,,,,2,3,2,5
C(C(C(C)(O)OCCO)O)=O,,,4,1,1,0,1
13843_0,,,,2,3,2,5
C(COC(C)(C(CO)O)O)=O,,,4,1,1,0,1
13845_0,,,,2,3,2,5
C(C(C(CO)OC(CO)O)O)=O,,,4,1,1,0,1
13847_0,,,,2,3,2,5
C(C(O)OC(CO)C(CO)O)=O,,,4,1,2,0,2
13849_0,,,,2,3,2,5
C(C(CC(O)OCCO)O)=O,,,4,1,1,0,1
13851_0,,,,2,3,2,5
C(COC(CC(CO)O)O)=O,,,4,1,1,0,1
13853_0,,,,2,3,2,5
C(C(O)OC(CO)CO)(CO)=O,,,4,1,1,0,1
13855_0,,,,2,3,2,5
C(C(C(COC(CO)O)O)O)=O,,,4,1,1,0,1
13857_0,,,,2,3,2,5
C(C(O)OCC(C(CO)O)O)=O,,,4,1,3,0,3
13859_0,,,,2,3,2,5
C(C(O)OCC(CO)O)(CO)=O,,,4,1,1,0,1
13860_0,,,,2,3,2,5
13861_0,,,,2,3,2,5
13863_0,,,,2,3,2,5
CC(CO)O,,,4,1,1,0,1
13864_0,,,,2,3,2,5
13865_0,,,,2,3,2,5
13866_0,,,,2,3,2,5
13867_0,,,,2,3,2,5
13869_0,,,,2,3,2,5
C(C(CCC(CO)O)=O)=O,,,4,1,3,0,3
13870_0,,,,2,3,2,5
13871_0,,,,2,3,2,5
13872_0,,,,2,3,2,5
13873_0,,,,2,3,2,5
13874_0,,,,2,3,2,5
13875_0,,,,2,3,2,5
13876_0,,,,2,3,2,5
13878_0,,,,2,3,2,5
C(C(CCC(CO)O)O)(O)=O,,,4,1,2,0,2
13879_0,,,,2,3,2,5
13880_0,,,,2,3,2,5
13881_0,,,,2,3,2,5
13882_0,,,,2,3,2,5
13883_0,,,,2,3,2,5
13884_0,,,,2,3,2,5
13885_0,,,,2,3,2,5
13886_0,,,,2,3,2,5
13887_0,,,,2,3,2,5
13888_0,,,,2,3,2,5
13889_0,,,,2,3,2,5
13890_0,,,,2,3,2,5
13891_0,,,,2,3,2,5
13892_0,,,,2,3,2,5
13893_0,,,,2,3,2,5
13894_0,,,,2,3,2,5
13896_0,,,,2,3,2,5
C(C(CO)O)(CCCO)=O,,,4,1,3,0,3
13897_0,,,,2,3,2,5
13898_0,,,,2,3,2,5
13899_0,,,,2,3,2,5
13901_0,,,,2,3,2,5
C(C(C(CO)O)O)=CCO,,,4,1,4,0,4
13902_0,,,,2,3,2,5
13903_0,,,,2,3,2,5
13904_0,,,,2,3,2,5
13906_0,,,,2,3,2,5
C(CC(CC(CO)=O)O)(O)=O,,,4,1,4,0,4
13908_0,,,,2,3,2,5
C(CC(C(CCO)O)=O)(O)=O,,,4,1,3,0,3
13910_0,,,,2,3,2,5
C(CC(C(CCO)=O)O)(O)=O,,,4,1,4,0,4
13912_0,,,,2,3,2,5
C(C(C(CCCO)=O)O)(O)=O,,,4,1,4,0,4
13914_0,,,,2,3,2,5
C(CCC(O)=O)(C(CO)O)=O,,,4,1,3,0,3
13915_0,,,,2,3,2,5
13917_0,,,,2,3,2,5
C(CC(CC(CO)O)=O)(O)=O,,,4,1,4,0,4
13918_0,,,,2,3,2,5
13919_0,,,,2,3,2,5
13920_0,,,,2,3,2,5
13921_0,,,,2,3,2,5
13923_0,,,,2,3,2,5
C1(CCC(C1(CO)O)O)=O,,,4,1,4,0,4
13925_0,,,,2,3,2,5
C1C(C(CO)(C(C=1)O)O)O,,,4,1,2,0,2
13927_0,,,,2,3,2,5
C(C1(CO)C(C(C(C1O)O)O)O)O,,,4,1,1,0,1
13929_0,,,,2,3,2,5
C(C(CO)(C(CO)(CO)O)O)O,,,4,1,1,0,1
13930_0,,,,2,3,2,5
13931_0,,,,2,3,2,5
13933_0,,,,2,3,2,5
C(C(CO)(C(C(CO)O)O)O)O,,,4,1,3,0,3
13935_0,,,,2,3,2,5
C(C(C)(C(CO)(CO)O)O)=O,,,4,1,2,0,2
13936_0,,,,2,3,2,5
13937_0,,,,2,3,2,5
13938_0,,,,2,3,2,5
13939_0,,,,2,3,2,5
13940_0,,,,2,3,2,5
13941_0,,,,2,3,2,5
13942_0,,,,2,3,2,5
13943_0,,,,2,3,2,5
13945_0,,,,2,3,2,5
CC(C(CO)O)(C(CO)(CO)O)O,,,4,1,1,0,1
13947_0,,,,2,3,2,5
C(C(CO)(CO)O)O,,,4,1,1,0,1
13949_0,,,,2,3,2,5
C(C(CCO)(C(CO)(CO)O)O)=O,,,4,1,3,0,3
13950_0,,,,2,3,2,5
13952_0,,,,2,3,2,5
C(C(CCO)(C(CO)(CO)O)O)O,,,4,1,1,0,1
13953_0,,,,2,3,2,5
13954_0,,,,2,3,2,5
13955_0,,,,2,3,2,5
13957_0,,,,2,3,2,5
CC(CO)(C(CO)(CO)O)O,,,4,1,1,0,1
13958_0,,,,2,3,2,5
13959_0,,,,2,3,2,5
13961_0,,,,2,3,2,5
C(C(CC(C(CO)(CO)O)O)O)=O,,,4,1,1,0,1
13963_0,,,,2,3,2,5
C(C(CO)(C(CC(CO)O)O)O)=O,,,4,1,5,0,5
13965_0,,,,2,3,2,5
CC(C(CO)(CO)O)O,,,4,1,1,0,1
13966_0,,,,2,3,2,5
13967_0,,,,2,3,2,5
13968_0,,,,2,3,2,5
13969_0,,,,2,3,2,5
13970_0,,,,2,3,2,5
13971_0,,,,2,3,2,5
13972_0,,,,2,3,2,5
13973_0,,,,2,3,2,5
13974_0,,,,2,3,2,5
13975_0,,,,2,3,2,5
13976_0,,,,2,3,2,5
13977_0,,,,2,3,2,5
13978_0,,,,2,3,2,5
13979_0,,,,2,3,2,5
13980_0,,,,2,3,2,5
13981_0,,,,2,3,2,5
13982_0,,,,2,3,2,5
13983_0,,,,2,3,2,5
13984_0,,,,2,3,2,5
13985_0,,,,2,3,2,5
13986_0,,,,2,3,2,5
13987_0,,,,2,3,2,5
13988_0,,,,2,3,2,5
13989_0,,,,2,3,2,5
13990_0,,,,2,3,2,5
13991_0,,,,2,3,2,5
13992_0,,,,2,3,2,5
13993_0,,,,2,3,2,5
13994_0,,,,2,3,2,5
13995_0,,,,2,3,2,5
13996_0,,,,2,3,2,5
13997_0,,,,2,3,2,5
13998_0,,,,2,3,2,5
13999_0,,,,2,3,2,5
14000_0,,,,2,3,2,5
14001_0,,,,2,3,2,5
14002_0,,,,2,3,2,5
14003_0,,,,2,3,2,5
14004_0,,,,2,3,2,5
14005_0,,,,2,3,2,5
14006_0,,,,2,3,2,5
14007_0,,,,2,3,2,5
14008_0,,,,2,3,2,5
14009_0,,,,2,3,2,5
14010_0,,,,2,3,2,5
14011_0,,,,2,3,2,5
14012_0,,,,2,3,2,5
14013_0,,,,2,3,2,5
14014_0,,,,2,3,2,5
14015_0,,,,2,3,2,5
14017_0,,,,2,3,2,5
C(CO)(C(CO)(C(CCO)O)O)=O,,,4,1,5,0,5
14019_0,,,,2,3,2,5
C(C(CO)(C(C(CCO)O)O)O)O,,,4,1,1,0,1
14021_0,,,,2,3,2,5
C(CCO)(C(C(C)=O)(CO)O)=O,,,4,1,5,0,5
14023_0,,,,2,3,2,5
C(C(CO)(CO)O)(CC(C)=O)=O,,,4,1,4,0,4
14025_0,,,,2,3,2,5
C(CCC=O)(C(CO)(CO)O)=O,,,4,1,4,0,4
14027_0,,,,2,3,2,5
C(C(C(CCCO)=O)(CO)O)=O,,,4,1,4,0,4
14028_0,,,,2,3,2,5
14029_0,,,,2,3,2,5
14030_0,,,,2,3,2,5
14031_0,,,,2,3,2,5
14033_0,,,,2,3,2,5
C(C(C(CO)(C(CCO)O)O)=O)=O,,,4,1,6,0,6
14035_0,,,,2,3,2,5
C(CO)=CC(C(CO)(CO)O)=O,,,4,1,5,0,5
14036_0,,,,2,3,2,5
14037_0,,,,2,3,2,5
14039_0,,,,2,3,2,5
C=CC(C(CO)(C(CO)O)O)=O,,,4,1,4,0,4
14041_0,,,,2,3,2,5
C(C(C(CO)(CO)O)O)=CC=O,,,4,1,1,0,1
14043_0,,,,2,3,2,5
C(C(CO)(C(C=CCO)O)O)=O,,,4,1,4,0,4
14045_0,,,,2,3,2,5
C1C(CC(C(CO)(CO)O)(O)O1)O,,,4,1,2,0,2
14047_0,,,,2,3,2,5
C(C1(CC(C(CO)(CO)O1)O)O)O,,,4,1,1,0,1
14049_0,,,,2,3,2,5
CC1(C(C(C(CO)(CO)O1)O)O)O,,,4,1,1,0,1
14051_0,,,,2,3,2,5
C(C(CO)(C1C(CC(O)O1)O)O)O,,,4,1,1,0,1
14053_0,,,,2,3,2,5
C(C1(CO)C(C(CC(O)O1)O)O)O,,,4,1,1,0,1
14054_0,,,,2,3,2,5
14055_0,,,,2,3,2,5
14056_0,,,,2,3,2,5
14057_0,,,,2,3,2,5
14058_0,,,,2,3,2,5
14059_0,,,,2,3,2,5
14061_0,,,,2,3,2,5
C(C)(C(C(CO)O)(C(C)O)O)=O,,,4,1,5,0,5
14062_0,,,,2,3,2,5
14063_0,,,,2,3,2,5
14064_0,,,,2,3,2,5
14065_0,,,,2,3,2,5
14067_0,,,,2,3,2,5
C(C(C=O)(C(C(CCO)O)O)O)=O,,,4,1,3,0,3
14068_0,,,,2,3,2,5
14070_0,,,,2,3,2,5
C(C(C=O)(C(CC(CO)O)O)O)=O,,,4,1,3,0,3
14071_0,,,,2,3,2,5
14072_0,,,,2,3,2,5
14073_0,,,,2,3,2,5
14074_0,,,,2,3,2,5
14075_0,,,,2,3,2,5
14076_0,,,,2,3,2,5
14077_0,,,,2,3,2,5
14078_0,,,,2,3,2,5
14079_0,,,,2,3,2,5
14081_0,,,,2,3,2,5
C(CCO)(C(C(C)=O)(C(C)O)O)=O,,,4,1,3,0,3
14083_0,,,,2,3,2,5
C(C(CO)(C(C)O)O)(CC(C)=O)=O,,,4,1,3,0,3
14085_0,,,,2,3,2,5
C(CCC=O)(C(CO)(C(C)O)O)=O,,,4,1,3,0,3
14087_0,,,,2,3,2,5
C(C(C(CCCO)=O)(C(C)O)O)=O,,,4,1,3,0,3
14089_0,,,,2,3,2,5
C(CO)=CC(C(CO)(C(C)O)O)=O,,,4,1,4,0,4
14090_0,,,,2,3,2,5
14091_0,,,,2,3,2,5
14093_0,,,,2,3,2,5
C=CC(C(C(CO)O)(C(C)O)O)=O,,,4,1,3,0,3
14095_0,,,,2,3,2,5
C(C(C(CO)(C(C)O)O)O)=CC=O,,,4,1,1,0,1
14097_0,,,,2,3,2,5
C(C(C(C)O)(C(C=CCO)O)O)=O,,,4,1,3,0,3
14098_0,,,,2,3,2,5
14099_0,,,,2,3,2,5
14100_0,,,,2,3,2,5
14102_0,,,,2,3,2,5
C(C)(C(C(CO)O)(C(CO)O)O)=O,,,4,1,3,0,3
14103_0,,,,2,3,2,5
14104_0,,,,2,3,2,5
14106_0,,,,2,3,2,5
C(C(C)(C(CO)(C(CO)O)O)O)=O,,,4,1,4,0,4
14107_0,,,,2,3,2,5
14109_0,,,,2,3,2,5
CC(CO)(C(CO)(C(CO)O)O)O,,,4,1,3,0,3
14111_0,,,,2,3,2,5
CC(C(CO)(C(CO)O)O)O,,,4,1,3,0,3
14112_0,,,,2,3,2,5
14113_0,,,,2,3,2,5
14114_0,,,,2,3,2,5
14115_0,,,,2,3,2,5
14117_0,,,,2,3,2,5
C(C1(CC(C(C1O)O)O)O)O,,,4,1,1,0,1
14119_0,,,,2,3,2,5
C1(CC(C(CO)(C1)O)O)=O,,,4,1,2,0,2
14120_0,,,,2,3,2,5
14121_0,,,,2,3,2,5
14122_0,,,,2,3,2,5
14124_0,,,,2,3,2,5
C(C(CCO)(C(C(CO)O)O)O)=O,,,4,1,4,0,4
14125_0,,,,2,3,2,5
14126_0,,,,2,3,2,5
14127_0,,,,2,3,2,5
14129_0,,,,2,3,2,5
C(C(C)(C(CO)(CC=O)O)O)=O,,,4,1,2,0,2
14131_0,,,,2,3,2,5
C(C(CCO)(C(C=O)(C)O)O)=O,,,4,1,3,0,3
14132_0,,,,2,3,2,5
14133_0,,,,2,3,2,5
14134_0,,,,2,3,2,5
14135_0,,,,2,3,2,5
14136_0,,,,2,3,2,5
14137_0,,,,2,3,2,5
14138_0,,,,2,3,2,5
14139_0,,,,2,3,2,5
14140_0,,,,2,3,2,5
14141_0,,,,2,3,2,5
14142_0,,,,2,3,2,5
14143_0,,,,2,3,2,5
14145_0,,,,2,3,2,5
C(CO)(C(CO)(CC(CO)O)O)=O,,,4,1,3,0,3
14146_0,,,,2,3,2,5
14147_0,,,,2,3,2,5
14148_0,,,,2,3,2,5
14149_0,,,,2,3,2,5
14150_0,,,,2,3,2,5
14151_0,,,,2,3,2,5
14152_0,,,,2,3,2,5
14154_0,,,,2,3,2,5
C(C(CO)(CC=O)O)(CCO)=O,,,4,1,3,0,3
14156_0,,,,2,3,2,5
C(CC(C(CO)(CCO)O)=O)=O,,,4,1,2,0,2
14157_0,,,,2,3,2,5
14158_0,,,,2,3,2,5
14159_0,,,,2,3,2,5
14161_0,,,,2,3,2,5
C(C(CO)(CC(CCO)O)O)(O)=O,,,4,1,2,0,2
14162_0,,,,2,3,2,5
14164_0,,,,2,3,2,5
C(C(CO)(CO)O)=CC(CO)=O,,,4,1,1,0,1
14166_0,,,,2,3,2,5
C(C(C(CC(CO)(CO)O)O)O)O,,,4,1,1,0,1
14167_0,,,,2,3,2,5
14168_0,,,,2,3,2,5
14169_0,,,,2,3,2,5
14170_0,,,,2,3,2,5
14171_0,,,,2,3,2,5
14173_0,,,,2,3,2,5
C(CC(CO)(C(C)(CO)O)O)=O,,,4,1,1,0,1
14175_0,,,,2,3,2,5
C(C(CCO)(C(CO)(C)O)O)=O,,,4,1,2,0,2
14176_0,,,,2,3,2,5
14178_0,,,,2,3,2,5
C(C(C(C)O)(CCO)O)=O,,,4,1,2,0,2
14179_0,,,,2,3,2,5
14180_0,,,,2,3,2,5
14181_0,,,,2,3,2,5
14182_0,,,,2,3,2,5
14183_0,,,,2,3,2,5
14184_0,,,,2,3,2,5
14186_0,,,,2,3,2,5
C(C)(C(C(C)O)(CC(CO)=O)O)=O,,,4,1,2,0,2
14188_0,,,,2,3,2,5
C(C(C(C)O)(CC=O)O)(CCO)=O,,,4,1,2,0,2
14190_0,,,,2,3,2,5
C(CC(C(C(C)O)(CCO)O)=O)=O,,,4,1,2,0,2
14191_0,,,,2,3,2,5
14192_0,,,,2,3,2,5
14193_0,,,,2,3,2,5
14195_0,,,,2,3,2,5
C(C(CO)(C(C)O)O)=CC(CO)=O,,,4,1,1,0,1
14196_0,,,,2,3,2,5
14197_0,,,,2,3,2,5
14199_0,,,,2,3,2,5
C(CO)(OC(CO)C(CO)O)=O,,,4,1,2,0,2
14200_0,,,,2,3,2,5
14202_0,,,,2,3,2,5
C(CO)(OCC(C(CO)O)O)=O,,,4,1,1,0,1
14204_0,,,,2,3,2,5
C1(CC(C(CCO)O1)O)=O,,,4,1,2,0,2
14206_0,,,,2,3,2,5
C1(COC(CCO)C1O)=O,,,4,1,2,0,2
14208_0,,,,2,3,2,5
C1(C(O)OC(CCO)C1)=O,,,4,1,3,0,3
14210_0,,,,2,3,2,5
C1(C(CCO)OC(C1)O)=O,,,4,1,3,0,3
14211_0,,,,2,3,2,5
14212_0,,,,2,3,2,5
14214_0,,,,2,3,2,5
C(C(C(CCCO)=O)=O)=O,,,4,1,2,0,2
14215_0,,,,2,3,2,5
14216_0,,,,2,3,2,5
14217_0,,,,2,3,2,5
14219_0,,,,2,3,2,5
C(C=CC(CO)=O)(C)=O,,,4,1,3,0,3
14221_0,,,,2,3,2,5
C(CC=CC(CO)=O)=O,,,4,1,4,0,4
14223_0,,,,2,3,2,5
C(CCO)=CC(C=O)=O,,,4,1,2,0,2
14225_0,,,,2,3,2,5
C(CO)=CC(C(C)=O)=O,,,4,1,3,0,3
14226_0,,,,2,3,2,5
14228_0,,,,2,3,2,5
C(C=CC(CCO)=O)=O,,,4,1,4,0,4
14230_0,,,,2,3,2,5
C(CO)(CC(C=C)=O)=O,,,4,1,3,0,3
14232_0,,,,2,3,2,5
C=CC(C(CCO)=O)=O,,,4,1,3,0,3
14234_0,,,,2,3,2,5
C(CO)(CC=CC=O)=O,,,4,1,5,0,5
14236_0,,,,2,3,2,5
C(CC(C=O)=O)=CCO,,,4,1,3,0,3
14238_0,,,,2,3,2,5
C(C(CCO)O)=CC(O)=O,,,4,1,2,0,2
14240_0,,,,2,3,2,5
C(C(C=CCCO)O)(O)=O,,,4,1,2,0,2
14242_0,,,,2,3,2,5
C(C1C(C(C(CO)O1)O)O)O,,,4,1,1,0,1
14244_0,,,,2,3,2,5
C1(C(CCO)OCC1O)=O,,,4,1,2,0,2
14246_0,,,,2,3,2,5
C1(C(CCO)(O)OCC1)=O,,,4,1,3,0,3
14248_0,,,,2,3,2,5
C1(COC(CCO)(C1)O)=O,,,4,1,3,0,3
14250_0,,,,2,3,2,5
C(CO)(C1CC(CO1)O)=O,,,4,1,2,0,2
14252_0,,,,2,3,2,5
C(C1CC(C(CO)O1)O)=O,,,4,1,2,0,2
14254_0,,,,2,3,2,5
C(C1C(CC(CO)O1)O)=O,,,4,1,1,0,1
14256_0,,,,2,3,2,5
C1(C(CO)OC(C)(C1)O)=O,,,4,1,3,0,3
14258_0,,,,2,3,2,5
C1(C(C)(O)OC(CO)C1)=O,,,4,1,3,0,3
14260_0,,,,2,3,2,5
C1(C(C)OC(CO)C1O)=O,,,4,1,2,0,2
14261_0,,,,2,3,2,5
14262_0,,,,2,3,2,5
14263_0,,,,2,3,2,5
14264_0,,,,2,3,2,5
14266_0,,,,2,3,2,5
C1C(C(C(C(CO)O1)O)O)O,,,4,1,1,0,1
14268_0,,,,2,3,2,5
C1(CC(CO)(O)OCC1)=O,,,4,1,3,0,3
14270_0,,,,2,3,2,5
C1(COC(CO)(CC1)O)=O,,,4,1,3,0,3
14272_0,,,,2,3,2,5
C1(C(CO)OC(CC1)O)=O,,,4,1,3,0,3
14274_0,,,,2,3,2,5
C1(CC(CO)OC(C1)O)=O,,,4,1,3,0,3
14275_0,,,,2,3,2,5
14276_0,,,,2,3,2,5
14277_0,,,,2,3,2,5
14278_0,,,,2,3,2,5
14279_0,,,,2,3,2,5
14281_0,,,,2,3,2,5
C1(C(C(C(CCO)O1)O)O)=O,,,4,1,2,0,2
14283_0,,,,2,3,2,5
C1(C(CC(CCO)O1)O)=O,,,4,1,2,0,2
14285_0,,,,2,3,2,5
C(CO)(CCC(CO)O)=O,,,4,1,3,0,3
14287_0,,,,2,3,2,5
C(C)(C(CC(CO)O)O)=O,,,4,1,2,0,2
14289_0,,,,2,3,2,5
C1C(C(C(C=1CO)O)O)O,,,4,1,2,0,2
14291_0,,,,2,3,2,5
C=CC(C(C(CO)O)O)O,,,4,1,2,0,2
14293_0,,,,2,3,2,5
C1C(CO)(C(C(C=1)O)O)O,,,4,1,2,0,2
14295_0,,,,2,3,2,5
C(C(CC=CCO)O)(O)=O,,,4,1,3,0,3
14296_0,,,,2,3,2,5
14297_0,,,,2,3,2,5
14298_0,,,,2,3,2,5
14299_0,,,,2,3,2,5
14300_0,,,,2,3,2,5
14302_0,,,,2,3,2,5
C1C(C(CO)OC=1CO)O,,,4,1,3,0,3
14304_0,,,,2,3,2,5
C1C(CO)OC(C=1)(CO)O,,,4,1,3,0,3
14306_0,,,,2,3,2,5
C1(C(C(CO1)O)O)=CCO,,,4,1,2,0,2
14308_0,,,,2,3,2,5
C1(C(CO)O)OCC(C=1)O,,,4,1,2,0,2
14310_0,,,,2,3,2,5
C1C(C(CO)O)(OCC=1)O,,,4,1,2,0,2
14311_0,,,,2,3,2,5
14312_0,,,,2,3,2,5
14314_0,,,,2,3,2,5
C=C1C(C(C(CO)O1)O)O,,,4,1,2,0,2
14316_0,,,,2,3,2,5
C1C(C(CO)O)OC(C=1)O,,,4,1,3,0,3
14318_0,,,,2,3,2,5
C1OC(C(CO)O)C(C=1)O,,,4,1,2,0,2
14320_0,,,,2,3,2,5
C1C(C(COC=1CO)O)O,,,4,1,2,0,2
14322_0,,,,2,3,2,5
C1C(COC(C=1)(CO)O)O,,,4,1,2,0,2
14324_0,,,,2,3,2,5
C1C(C(CO)OC(C=1)O)O,,,4,1,3,0,3
14326_0,,,,2,3,2,5
C1OC(CO)C(C(C=1)O)O,,,4,1,2,0,2
14328_0,,,,2,3,2,5
C(C(CO)O)=CC(CO)O,,,4,1,3,0,3
14330_0,,,,2,3,2,5
C(C1(C(CC(CO)O1)O)O)O,,,4,1,3,0,3
14331_0,,,,2,3,2,5
14333_0,,,,2,3,2,5
C1CC(C(C(CO)O)(O)O1)O,,,4,1,2,0,2
14334_0,,,,2,3,2,5
14335_0,,,,2,3,2,5
14336_0,,,,2,3,2,5
14337_0,,,,2,3,2,5
14339_0,,,,2,3,2,5
C1C(CC(C(CO)(O)O1)O)O,,,4,1,2,0,2
14340_0,,,,2,3,2,5
14342_0,,,,2,3,2,5
C(C1CC(C(C(O)O1)O)O)O,,,4,1,2,0,2
14343_0,,,,2,3,2,5
14344_0,,,,2,3,2,5
14346_0,,,,2,3,2,5
C(C(CC(CCO)C(CO)O)=O)=O,,,4,1,2,0,2
14348_0,,,,2,3,2,5
C(CC(C(CO)O)CC(CO)=O)=O,,,4,1,3,0,3
14350_0,,,,2,3,2,5
C(C(C(CC(CO)CCO)=O)O)=O,,,4,1,2,0,2
14352_0,,,,2,3,2,5
C(CC(CO)CC(C(CO)O)=O)=O,,,4,1,3,0,3
14354_0,,,,2,3,2,5
C(C(CCO)CC(C(CO)O)=O)=O,,,4,1,2,0,2
14355_0,,,,2,3,2,5
14357_0,,,,2,3,2,5
C(C(CCO)CC=O)(C(CO)O)=O,,,4,1,2,0,2
14359_0,,,,2,3,2,5
C(C(C(C=O)O)O)(CCCCO)=O,,,4,1,2,0,2
14361_0,,,,2,3,2,5
C(CCCC(C(C(CO)O)O)=O)=O,,,4,1,2,0,2
14363_0,,,,2,3,2,5
C(C(C(CCO)CC(CO)=O)O)=O,,,4,1,2,0,2
14364_0,,,,2,3,2,5
14366_0,,,,2,3,2,5
C(CC(C(C(C=O)O)O)CCO)=O,,,4,1,2,0,2
14368_0,,,,2,3,2,5
C(CC(C(C(CO)O)O)CC=O)=O,,,4,1,2,0,2
14369_0,,,,2,3,2,5
14370_0,,,,2,3,2,5
14372_0,,,,2,3,2,5
C(C1C(CC(C1O)=O)O)(O)=O,,,4,1,4,0,4
14373_0,,,,2,3,2,5
14375_0,,,,2,3,2,5
C(C1C(C(C(C1)=O)O)O)(O)=O,,,4,1,3,0,3
14376_0,,,,2,3,2,5
14377_0,,,,2,3,2,5
14378_0,,,,2,3,2,5
14380_0,,,,2,3,2,5
C(C1C(C(C(C1O)=O)O)O)(O)=O,,,4,1,2,0,2
14381_0,,,,2,3,2,5
14382_0,,,,2,3,2,5
14383_0,,,,2,3,2,5
14384_0,,,,2,3,2,5
14386_0,,,,2,3,2,5
C(CC(CO)(CO)O)(O)=O,,,4,1,1,0,1
14387_0,,,,2,3,2,5
14388_0,,,,2,3,2,5
14390_0,,,,2,3,2,5
C(CC(C(CO)O)O)(O)=O,,,4,1,1,0,1
14391_0,,,,2,3,2,5
14392_0,,,,2,3,2,5
14393_0,,,,2,3,2,5
14394_0,,,,2,3,2,5
14395_0,,,,2,3,2,5
14396_0,,,,2,3,2,5
14397_0,,,,2,3,2,5
14398_0,,,,2,3,2,5
14399_0,,,,2,3,2,5
14400_0,,,,2,3,2,5
14401_0,,,,2,3,2,5
14402_0,,,,2,3,2,5
14403_0,,,,2,3,2,5
14404_0,,,,2,3,2,5
14405_0,,,,2,3,2,5
14406_0,,,,2,3,2,5
14407_0,,,,2,3,2,5
14408_0,,,,2,3,2,5
14409_0,,,,2,3,2,5
14410_0,,,,2,3,2,5
14411_0,,,,2,3,2,5
14412_0,,,,2,3,2,5
14413_0,,,,2,3,2,5
14414_0,,,,2,3,2,5
14415_0,,,,2,3,2,5
14416_0,,,,2,3,2,5
14417_0,,,,2,3,2,5
14418_0,,,,2,3,2,5
14419_0,,,,2,3,2,5
14420_0,,,,2,3,2,5
14421_0,,,,2,3,2,5
14422_0,,,,2,3,2,5
14423_0,,,,2,3,2,5
14424_0,,,,2,3,2,5
14425_0,,,,2,3,2,5
14426_0,,,,2,3,2,5
14427_0,,,,2,3,2,5
14428_0,,,,2,3,2,5
14429_0,,,,2,3,2,5
14430_0,,,,2,3,2,5
14432_0,,,,2,3,2,5
C(C(C(C=O)O)C(C(C)=O)O)(O)=O,,,4,1,2,0,2
14433_0,,,,2,3,2,5
14434_0,,,,2,3,2,5
14436_0,,,,2,3,2,5
C(C(C(C(O)=O)C(C=O)(C)O)O)=O,,,4,1,2,0,2
14437_0,,,,2,3,2,5
14439_0,,,,2,3,2,5
C(CC(C(C)=O)O)(O)=O,,,4,1,1,0,1
14440_0,,,,2,3,2,5
14442_0,,,,2,3,2,5
C(C(C)(CC(O)=O)O)=O,,,4,1,1,0,1
14443_0,,,,2,3,2,5
14444_0,,,,2,3,2,5
14445_0,,,,2,3,2,5
14446_0,,,,2,3,2,5
14447_0,,,,2,3,2,5
14448_0,,,,2,3,2,5
14449_0,,,,2,3,2,5
14450_0,,,,2,3,2,5
14451_0,,,,2,3,2,5
14452_0,,,,2,3,2,5
14453_0,,,,2,3,2,5
14454_0,,,,2,3,2,5
14455_0,,,,2,3,2,5
14456_0,,,,2,3,2,5
14457_0,,,,2,3,2,5
14458_0,,,,2,3,2,5
14459_0,,,,2,3,2,5
14460_0,,,,2,3,2,5
14461_0,,,,2,3,2,5
14462_0,,,,2,3,2,5
14463_0,,,,2,3,2,5
14464_0,,,,2,3,2,5
14465_0,,,,2,3,2,5
14466_0,,,,2,3,2,5
14467_0,,,,2,3,2,5
14468_0,,,,2,3,2,5
14470_0,,,,2,3,2,5
C(CC(C(C(C)=O)O)O)(O)=O,,,4,1,3,0,3
14471_0,,,,2,3,2,5
14473_0,,,,2,3,2,5
C(CC(C)(C(C=O)O)O)(O)=O,,,4,1,1,0,1
14474_0,,,,2,3,2,5
14475_0,,,,2,3,2,5
14476_0,,,,2,3,2,5
14477_0,,,,2,3,2,5
14479_0,,,,2,3,2,5
C(C(C(C=O)O)C(C=O)O)(O)=O,,,4,1,2,0,2
14480_0,,,,2,3,2,5
14481_0,,,,2,3,2,5
14482_0,,,,2,3,2,5
14484_0,,,,2,3,2,5
C(CC(C)(C(CO)O)O)(O)=O,,,4,1,1,0,1
14485_0,,,,2,3,2,5
14486_0,,,,2,3,2,5
14487_0,,,,2,3,2,5
14488_0,,,,2,3,2,5
14490_0,,,,2,3,2,5
C(CC(CO)(CC(C=O)O)O)(O)=O,,,4,1,1,0,1
14491_0,,,,2,3,2,5
14492_0,,,,2,3,2,5
14494_0,,,,2,3,2,5
C(C(CO)C(C=O)O)(O)=O,,,4,1,2,0,2
14496_0,,,,2,3,2,5
C(CCO)(O)=O,,,4,1,1,0,1
14497_0,,,,2,3,2,5
14498_0,,,,2,3,2,5
14499_0,,,,2,3,2,5
14500_0,,,,2,3,2,5
14501_0,,,,2,3,2,5
14502_0,,,,2,3,2,5
14503_0,,,,2,3,2,5
14504_0,,,,2,3,2,5
14506_0,,,,2,3,2,5
C(C(CO)C(CC(C=O)=O)O)(O)=O,,,4,1,2,0,2
14507_0,,,,2,3,2,5
14508_0,,,,2,3,2,5
14509_0,,,,2,3,2,5
14510_0,,,,2,3,2,5
14511_0,,,,2,3,2,5
14512_0,,,,2,3,2,5
14513_0,,,,2,3,2,5
14514_0,,,,2,3,2,5
14515_0,,,,2,3,2,5
14516_0,,,,2,3,2,5
14518_0,,,,2,3,2,5
C(C(CO)C(C(CC=O)=O)O)(O)=O,,,4,1,2,0,2
14519_0,,,,2,3,2,5
14520_0,,,,2,3,2,5
14521_0,,,,2,3,2,5
14522_0,,,,2,3,2,5
14523_0,,,,2,3,2,5
14525_0,,,,2,3,2,5
C(C(CO)CC(C(C=O)O)=O)(O)=O,,,4,1,1,0,1
14526_0,,,,2,3,2,5
14527_0,,,,2,3,2,5
14528_0,,,,2,3,2,5
14529_0,,,,2,3,2,5
14530_0,,,,2,3,2,5
14531_0,,,,2,3,2,5
14532_0,,,,2,3,2,5
14533_0,,,,2,3,2,5
14534_0,,,,2,3,2,5
14535_0,,,,2,3,2,5
14536_0,,,,2,3,2,5
14537_0,,,,2,3,2,5
14538_0,,,,2,3,2,5
14540_0,,,,2,3,2,5
C(C(CCO)(CC(O)=O)O)=O,,,4,1,1,0,1
14542_0,,,,2,3,2,5
C(CC(CO)(CCO)O)(O)=O,,,4,1,1,0,1
14543_0,,,,2,3,2,5
14544_0,,,,2,3,2,5
14545_0,,,,2,3,2,5
14547_0,,,,2,3,2,5
C(CC(C)(C(C(C=O)O)O)O)(O)=O,,,4,1,1,0,1
14548_0,,,,2,3,2,5
14550_0,,,,2,3,2,5
C(CC(C(C=O)O)O)(O)=O,,,4,1,1,0,1
14551_0,,,,2,3,2,5
14552_0,,,,2,3,2,5
14553_0,,,,2,3,2,5
14554_0,,,,2,3,2,5
14555_0,,,,2,3,2,5
14557_0,,,,2,3,2,5
C(C(C(CO)(C)O)C(C=O)O)(O)=O,,,4,1,2,0,2
14559_0,,,,2,3,2,5
C(CC(C)(CO)O)(O)=O,,,4,1,1,0,1
14560_0,,,,2,3,2,5
14561_0,,,,2,3,2,5
14562_0,,,,2,3,2,5
14563_0,,,,2,3,2,5
14565_0,,,,2,3,2,5
C(C(C(C)O)C(C=O)O)(O)=O,,,4,1,2,0,2
14566_0,,,,2,3,2,5
14567_0,,,,2,3,2,5
14569_0,,,,2,3,2,5
C(CC(CC(C=O)O)O)(O)=O,,,4,1,2,0,2
14571_0,,,,2,3,2,5
C(CC(C)O)(O)=O,,,4,1,1,0,1
14572_0,,,,2,3,2,5
14574_0,,,,2,3,2,5
C(C(CO)(CC(O)=O)O)=O,,,4,1,2,0,2
14575_0,,,,2,3,2,5
14576_0,,,,2,3,2,5
14578_0,,,,2,3,2,5
C(CC(CO)(C(CO)O)O)(O)=O,,,4,1,1,0,1
14580_0,,,,2,3,2,5
C(C(C(CO)O)(CC(O)=O)O)=O,,,4,1,2,0,2
14581_0,,,,2,3,2,5
14582_0,,,,2,3,2,5
14583_0,,,,2,3,2,5
14584_0,,,,2,3,2,5
14585_0,,,,2,3,2,5
14586_0,,,,2,3,2,5
14587_0,,,,2,3,2,5
14588_0,,,,2,3,2,5
14589_0,,,,2,3,2,5
14590_0,,,,2,3,2,5
14591_0,,,,2,3,2,5
14592_0,,,,2,3,2,5
14593_0,,,,2,3,2,5
14594_0,,,,2,3,2,5
14595_0,,,,2,3,2,5
14596_0,,,,2,3,2,5
14597_0,,,,2,3,2,5
14598_0,,,,2,3,2,5
14599_0,,,,2,3,2,5
14600_0,,,,2,3,2,5
14601_0,,,,2,3,2,5
14603_0,,,,2,3,2,5
C(C(C(CO)O)C(C=O)O)(O)=O,,,4,1,2,0,2
14604_0,,,,2,3,2,5
14605_0,,,,2,3,2,5
14606_0,,,,2,3,2,5
14607_0,,,,2,3,2,5
14608_0,,,,2,3,2,5
14609_0,,,,2,3,2,5
14610_0,,,,2,3,2,5
14611_0,,,,2,3,2,5
14612_0,,,,2,3,2,5
14613_0,,,,2,3,2,5
14614_0,,,,2,3,2,5
14615_0,,,,2,3,2,5
14616_0,,,,2,3,2,5
14617_0,,,,2,3,2,5
14618_0,,,,2,3,2,5
14619_0,,,,2,3,2,5
14621_0,,,,2,3,2,5
C(C(O)=O)(O)=O,,,4,1,1,0,1
14623_0,,,,2,3,2,5
C(C(C(O)=O)O)(O)=O,,,4,1,3,0,3
14625_0,,,,2,3,2,5
C(C(C(C(O)=O)O)O)(O)=O,,,4,1,3,0,3
14627_0,,,,2,3,2,5
C(CC(C(O)=O)O)(O)=O,,,4,1,4,0,4
14629_0,,,,2,3,2,5
C(C)(C(CO)(C(C(O)=O)O)O)=O,,,4,1,8,0,8
14630_0,,,,2,3,2,5
14631_0,,,,2,3,2,5
14632_0,,,,2,3,2,5
14633_0,,,,2,3,2,5
14634_0,,,,2,3,2,5
14636_0,,,,2,3,2,5
C(C(C(OCC(C)=O)O)O)(O)=O,,,4,1,2,0,2
14638_0,,,,2,3,2,5
C(C(CO)OCC(CO)=O)(O)=O,,,4,1,1,0,1
14640_0,,,,2,3,2,5
C(C(CO)OC(C(C)=O)O)(O)=O,,,4,1,1,0,1
14642_0,,,,2,3,2,5
C(C)(C(CO)OC(C(O)=O)O)=O,,,4,1,2,0,2
14644_0,,,,2,3,2,5
C(C(COCC(CO)=O)O)(O)=O,,,4,1,2,0,2
14646_0,,,,2,3,2,5
C(C(COC(C(C)=O)O)O)(O)=O,,,4,1,2,0,2
14648_0,,,,2,3,2,5
C(CO)(CC(OCC(O)=O)O)=O,,,4,1,1,0,1
14650_0,,,,2,3,2,5
C(C)(C(C(OCC(O)=O)O)O)=O,,,4,1,1,0,1
14652_0,,,,2,3,2,5
C(C)(C(COC(C(O)=O)O)O)=O,,,4,1,2,0,2
14654_0,,,,2,3,2,5
C(CO)(CCOC(C(O)=O)O)=O,,,4,1,2,0,2
14655_0,,,,2,3,2,5
14656_0,,,,2,3,2,5
14657_0,,,,2,3,2,5
14658_0,,,,2,3,2,5
14659_0,,,,2,3,2,5
14660_0,,,,2,3,2,5
14661_0,,,,2,3,2,5
14662_0,,,,2,3,2,5
14664_0,,,,2,3,2,5
C=CC(C(O)=O)=O,,,4,1,3,0,3
14665_0,,,,2,3,2,5
14667_0,,,,2,3,2,5
C(CC(CO)(OCC(O)=O)O)=O,,,4,1,2,0,2
14669_0,,,,2,3,2,5
C(CC(CO)(OCC=O)O)(O)=O,,,4,1,1,0,1
14671_0,,,,2,3,2,5
C(C(C(C)(OCC(O)=O)O)O)=O,,,4,1,2,0,2
14673_0,,,,2,3,2,5
C(C(C(C)(OCC=O)O)O)(O)=O,,,4,1,2,0,2
14675_0,,,,2,3,2,5
C(C(C(CO)OC(C(O)=O)O)O)=O,,,4,1,3,0,3
14677_0,,,,2,3,2,5
C(C(C(CO)OC(C=O)O)O)(O)=O,,,4,1,2,0,2
14679_0,,,,2,3,2,5
C(C(CC(OCC(O)=O)O)O)=O,,,4,1,2,0,2
14681_0,,,,2,3,2,5
C(C(CC(OCC=O)O)O)(O)=O,,,4,1,2,0,2
14683_0,,,,2,3,2,5
C(C(CO)OC(C(CO)=O)O)(O)=O,,,4,1,1,0,1
14685_0,,,,2,3,2,5
C(C(C(COC(C(O)=O)O)O)O)=O,,,4,1,3,0,3
14687_0,,,,2,3,2,5
C(C(C(COC(C=O)O)O)O)(O)=O,,,4,1,2,0,2
14689_0,,,,2,3,2,5
C(C(COC(C(CO)=O)O)O)(O)=O,,,4,1,2,0,2
14690_0,,,,2,3,2,5
14691_0,,,,2,3,2,5
14692_0,,,,2,3,2,5
14693_0,,,,2,3,2,5
14694_0,,,,2,3,2,5
14696_0,,,,2,3,2,5
C(C(C(CC(C(O)=O)O)O)O)(O)=O,,,4,1,6,0,6
14697_0,,,,2,3,2,5
14699_0,,,,2,3,2,5
C(C(CCC(C=O)=O)O)(O)=O,,,4,1,6,0,6
14700_0,,,,2,3,2,5
14701_0,,,,2,3,2,5
14702_0,,,,2,3,2,5
14703_0,,,,2,3,2,5
14704_0,,,,2,3,2,5
14705_0,,,,2,3,2,5
14706_0,,,,2,3,2,5
14708_0,,,,2,3,2,5
C(C(CCC(C(O)=O)O)O)(O)=O,,,4,1,3,0,3
14709_0,,,,2,3,2,5
14710_0,,,,2,3,2,5
14711_0,,,,2,3,2,5
14712_0,,,,2,3,2,5
14714_0,,,,2,3,2,5
C(C(CC(C(C=O)=O)O)O)(O)=O,,,4,1,4,0,4
14715_0,,,,2,3,2,5
14716_0,,,,2,3,2,5
14717_0,,,,2,3,2,5
14718_0,,,,2,3,2,5
14719_0,,,,2,3,2,5
14720_0,,,,2,3,2,5
14721_0,,,,2,3,2,5
14722_0,,,,2,3,2,5
14723_0,,,,2,3,2,5
14724_0,,,,2,3,2,5
14725_0,,,,2,3,2,5
14726_0,,,,2,3,2,5
14727_0,,,,2,3,2,5
14728_0,,,,2,3,2,5
14729_0,,,,2,3,2,5
14730_0,,,,2,3,2,5
14731_0,,,,2,3,2,5
14732_0,,,,2,3,2,5
14734_0,,,,2,3,2,5
C(CC(CC(C(O)=O)=O)O)(O)=O,,,4,1,4,0,4
14735_0,,,,2,3,2,5
14737_0,,,,2,3,2,5
C(CC(C(CC(O)=O)O)=O)(O)=O,,,4,1,3,0,3
14738_0,,,,2,3,2,5
14740_0,,,,2,3,2,5
C(C(C(CCC(O)=O)=O)O)(O)=O,,,4,1,4,0,4
14741_0,,,,2,3,2,5
14742_0,,,,2,3,2,5
14743_0,,,,2,3,2,5
14745_0,,,,2,3,2,5
C(CC(C(C(C(O)=O)=O)O)O)(O)=O,,,4,1,3,0,3
14746_0,,,,2,3,2,5
14748_0,,,,2,3,2,5
C(C(C(C=CC(O)=O)O)O)(O)=O,,,4,1,4,0,4
14749_0,,,,2,3,2,5
14751_0,,,,2,3,2,5
C(C1(C(CCC1O)=O)O)(O)=O,,,4,1,4,0,4
14753_0,,,,2,3,2,5
C(C1(C(C=CC1O)O)O)(O)=O,,,4,1,4,0,4
14755_0,,,,2,3,2,5
C(C(CO)(C(CO)(CO)O)O)(O)=O,,,4,1,5,0,5
14757_0,,,,2,3,2,5
C(C(C=O)(C(CO)(CO)O)O)(O)=O,,,4,1,5,0,5
14758_0,,,,2,3,2,5
14760_0,,,,2,3,2,5
C(C(CO)(C(C=O)(C)O)O)(O)=O,,,4,1,6,0,6
14762_0,,,,2,3,2,5
C(C(C)(C(C=O)(CO)O)O)(O)=O,,,4,1,4,0,4
14764_0,,,,2,3,2,5
C(C(CO)(CO)O)(O)=O,,,4,1,3,0,3
14766_0,,,,2,3,2,5
C(C(C=O)(C(C(CO)O)O)O)(O)=O,,,4,1,5,0,5
14768_0,,,,2,3,2,5
C(C(CO)(C(C(C=O)O)O)O)(O)=O,,,4,1,5,0,5
14769_0,,,,2,3,2,5
14771_0,,,,2,3,2,5
C(C(CO)(C(CO)(C)O)O)(O)=O,,,4,1,5,0,5
14773_0,,,,2,3,2,5
C(C(CO)(C(C)O)O)(O)=O,,,4,1,5,0,5
14775_0,,,,2,3,2,5
C(C(CO)(C(C=O)(CO)O)O)(O)=O,,,4,1,7,0,7
14777_0,,,,2,3,2,5
C(C(C(C)=O)(C(C(C)=O)O)O)(O)=O,,,4,1,5,0,5
14779_0,,,,2,3,2,5
C(C(C)(C(C=O)(C(C)=O)O)O)(O)=O,,,4,1,4,0,4
14781_0,,,,2,3,2,5
C(C(C)(C(C(O)=O)(C(C)=O)O)O)=O,,,4,1,5,0,5
14783_0,,,,2,3,2,5
C(C(C)(C(C(C)=O)(CO)O)O)(O)=O,,,4,1,4,0,4
14785_0,,,,2,3,2,5
C(C(C=O)(C(C(C)=O)O)O)(O)=O,,,4,1,5,0,5
14787_0,,,,2,3,2,5
C(C(C=O)(C(C(O)=O)(C)O)O)=O,,,4,1,4,0,4
14789_0,,,,2,3,2,5
C(C(C=O)(C(C=O)(C)O)O)(O)=O,,,4,1,5,0,5
14791_0,,,,2,3,2,5
C(C(C(C)=O)(C(C=O)O)O)(O)=O,,,4,1,6,0,6
14793_0,,,,2,3,2,5
C(C(C(C)=O)(C(C(O)=O)O)O)=O,,,4,1,6,0,6
14795_0,,,,2,3,2,5
C(C(C(C)=O)(CO)O)(O)=O,,,4,1,6,0,6
14797_0,,,,2,3,2,5
C(C(C(C)=O)(C(CO)(C)O)O)(O)=O,,,4,1,5,0,5
14799_0,,,,2,3,2,5
C(C(C(C)=O)(C(C)O)O)(O)=O,,,4,1,6,0,6
14801_0,,,,2,3,2,5
C(C(C=O)(C(C(O)=O)O)O)=O,,,4,1,5,0,5
14803_0,,,,2,3,2,5
C(C(C=O)(C(C=O)O)O)(O)=O,,,4,1,5,0,5
14805_0,,,,2,3,2,5
C(C(C(C=O)(C(C=O)O)O)O)(O)=O,,,4,1,7,0,7
14807_0,,,,2,3,2,5
C(C(C(C=O)O)(C(C=O)O)O)(O)=O,,,4,1,3,0,3
14809_0,,,,2,3,2,5
C(CO)(C(CO)(C(C(O)=O)O)O)=O,,,4,1,6,0,6
14811_0,,,,2,3,2,5
C(C(C(C(C=O)=O)(CO)O)O)(O)=O,,,4,1,4,0,4
14813_0,,,,2,3,2,5
C(C(C(C(C(O)=O)=O)(CO)O)O)=O,,,4,1,3,0,3
14815_0,,,,2,3,2,5
C(C(C=O)(CO)O)(O)=O,,,4,1,5,0,5
14817_0,,,,2,3,2,5
C(CC(O)=O)(C(C(C)=O)(CO)O)=O,,,4,1,3,0,3
14819_0,,,,2,3,2,5
C(C(C(CC(C)=O)=O)(CO)O)(O)=O,,,4,1,5,0,5
14821_0,,,,2,3,2,5
C(C(C(CCC=O)=O)(CO)O)(O)=O,,,4,1,5,0,5
14823_0,,,,2,3,2,5
C(C(C(CCC(O)=O)=O)(CO)O)=O,,,4,1,3,0,3
14825_0,,,,2,3,2,5
C(C(C(C=CCO)=O)(CO)O)(O)=O,,,4,1,5,0,5
14827_0,,,,2,3,2,5
C(C=CC(C(CO)(CO)O)=O)(O)=O,,,4,1,3,0,3
14828_0,,,,2,3,2,5
14830_0,,,,2,3,2,5
C(C(C(C(C=C)=O)(CO)O)O)(O)=O,,,4,1,4,0,4
14832_0,,,,2,3,2,5
C(C(CO)(C(C=CC=O)O)O)(O)=O,,,4,1,5,0,5
14834_0,,,,2,3,2,5
C(C(CO)(C(C=CC(O)=O)O)O)=O,,,4,1,3,0,3
14836_0,,,,2,3,2,5
C(C(C(CO)(CO)O)=O)(O)=O,,,4,1,4,0,4
14838_0,,,,2,3,2,5
C(C(C(C)O)(C(C(C)=O)O)O)(O)=O,,,4,1,5,0,5
14840_0,,,,2,3,2,5
C(C)(C(C(C)O)(C(C(O)=O)O)O)=O,,,4,1,6,0,6
14842_0,,,,2,3,2,5
C(C(C=O)(C(C(C(O)=O)O)O)O)=O,,,4,1,4,0,4
14844_0,,,,2,3,2,5
C(C(C=O)(C(C(C=O)O)O)O)(O)=O,,,4,1,5,0,5
14846_0,,,,2,3,2,5
C(C(C=O)(C(CO)(C)O)O)(O)=O,,,4,1,5,0,5
14848_0,,,,2,3,2,5
C(C(C=O)(C(C)O)O)(O)=O,,,4,1,5,0,5
14850_0,,,,2,3,2,5
C(C(C=O)(C(C(CO)=O)O)O)(O)=O,,,4,1,5,0,5
14852_0,,,,2,3,2,5
C(C(C=O)(C(C=O)(CO)O)O)(O)=O,,,4,1,5,0,5
14854_0,,,,2,3,2,5
C(C(C=O)(C(C(O)=O)(CO)O)O)=O,,,4,1,5,0,5
14856_0,,,,2,3,2,5
C(C(C(C)O)(C(C=O)O)O)(O)=O,,,4,1,5,0,5
14858_0,,,,2,3,2,5
C(C(C(C)O)(C(C(O)=O)O)O)=O,,,4,1,7,0,7
14860_0,,,,2,3,2,5
C(C(C(CO)(C(C)O)O)=O)(O)=O,,,4,1,3,0,3
14861_0,,,,2,3,2,5
14863_0,,,,2,3,2,5
C(C(C(C)=O)(C(CO)O)O)(O)=O,,,4,1,6,0,6
14865_0,,,,2,3,2,5
C(C(C=O)(C(CO)O)O)(O)=O,,,4,1,5,0,5
14867_0,,,,2,3,2,5
C(C(C(CO)(C(CO)O)O)=O)(O)=O,,,4,1,4,0,4
14868_0,,,,2,3,2,5
14870_0,,,,2,3,2,5
C(C1(C(C(C(C1)O)O)O)O)(O)=O,,,4,1,2,0,2
14872_0,,,,2,3,2,5
C(C1(C(CC(C1)=O)O)O)(O)=O,,,4,1,3,0,3
14874_0,,,,2,3,2,5
C(C(CC=O)(C(C(C)=O)O)O)(O)=O,,,4,1,2,0,2
14876_0,,,,2,3,2,5
C(CC(C=O)(C(C(C)=O)O)O)(O)=O,,,4,1,2,0,2
14878_0,,,,2,3,2,5
C(C(C)(C(C=O)(CC=O)O)O)(O)=O,,,4,1,3,0,3
14880_0,,,,2,3,2,5
C(CC(C(O)=O)(C(C=O)(C)O)O)=O,,,4,1,2,0,2
14882_0,,,,2,3,2,5
C(CC(C=O)(C(C=O)(C)O)O)(O)=O,,,4,1,2,0,2
14884_0,,,,2,3,2,5
C(C(C)(C(C(O)=O)O)O)(O)=O,,,4,1,3,0,3
14886_0,,,,2,3,2,5
C(CC(CO)(C(C(O)=O)O)O)(O)=O,,,4,1,2,0,2
14888_0,,,,2,3,2,5
C(C(C(C)(C(C(O)=O)O)O)O)(O)=O,,,4,1,3,0,3
14890_0,,,,2,3,2,5
C(C(C(C=O)(CC=O)O)O)(O)=O,,,4,1,5,0,5
14892_0,,,,2,3,2,5
C(C(CC=O)(C(C=O)O)O)(O)=O,,,4,1,3,0,3
14894_0,,,,2,3,2,5
C(CC(C=O)(C(C=O)O)O)(O)=O,,,4,1,2,0,2
14896_0,,,,2,3,2,5
C(C(CCO)(C(C(O)=O)O)O)(O)=O,,,4,1,5,0,5
14898_0,,,,2,3,2,5
C(C(C(C)O)(CC(CO)=O)O)(O)=O,,,4,1,2,0,2
14899_0,,,,2,3,2,5
14901_0,,,,2,3,2,5
C(C(CO)(CC=O)O)(CC(O)=O)=O,,,4,1,2,0,2
14903_0,,,,2,3,2,5
C(C(CO)(CC(O)=O)O)(CC=O)=O,,,4,1,2,0,2
14904_0,,,,2,3,2,5
14905_0,,,,2,3,2,5
14907_0,,,,2,3,2,5
C(C(CO)(CC(CC(O)=O)=O)O)=O,,,4,1,2,0,2
14909_0,,,,2,3,2,5
C(C(C=CC(CO)=O)(CO)O)(O)=O,,,4,1,2,0,2
14910_0,,,,2,3,2,5
14912_0,,,,2,3,2,5
C(C(C(C(C(O)=O)O)O)O)(O)=O,,,4,1,3,0,3
14914_0,,,,2,3,2,5
C(C(C(CO)(C)O)(CC=O)O)(O)=O,,,4,1,2,0,2
14916_0,,,,2,3,2,5
C(C(C(CO)(C)O)(CC(O)=O)O)=O,,,4,1,2,0,2
14917_0,,,,2,3,2,5
14919_0,,,,2,3,2,5
C(C(C(C)O)(CC(O)=O)O)=O,,,4,1,2,0,2
14921_0,,,,2,3,2,5
C(C(CO)(C(C(O)=O)O)O)(O)=O,,,4,1,4,0,4
14923_0,,,,2,3,2,5
C(C(C(CO)O)OC(CO)=O)(O)=O,,,4,1,1,0,1
14925_0,,,,2,3,2,5
C(C(C(CO)OC(CO)=O)O)(O)=O,,,4,1,2,0,2
14927_0,,,,2,3,2,5
C(C(C(COC(CO)=O)O)O)(O)=O,,,4,1,2,0,2
14929_0,,,,2,3,2,5
C1(CC(C(CC(O)=O)O1)O)=O,,,4,1,2,0,2
14931_0,,,,2,3,2,5
C(CC1C(C(CO1)=O)O)(O)=O,,,4,1,2,0,2
14933_0,,,,2,3,2,5
C(CC1CC(C(O)O1)=O)(O)=O,,,4,1,3,0,3
14935_0,,,,2,3,2,5
C(CC1C(CC(O1)O)=O)(O)=O,,,4,1,3,0,3
14937_0,,,,2,3,2,5
C(C)(CC(C(C(O)=O)=O)=O)=O,,,4,1,3,0,3
14939_0,,,,2,3,2,5
C(CCC(C(C(O)=O)=O)=O)=O,,,4,1,3,0,3
14941_0,,,,2,3,2,5
C(CCC(C(C=O)=O)=O)(O)=O,,,4,1,2,0,2
14943_0,,,,2,3,2,5
C(C(O)=O)(CC(C(C)=O)=O)=O,,,4,1,4,0,4
14945_0,,,,2,3,2,5
C(CC(CC(C(O)=O)=O)=O)=O,,,4,1,4,0,4
14946_0,,,,2,3,2,5
14948_0,,,,2,3,2,5
C(C(C=CC(C)=O)=O)(O)=O,,,4,1,4,0,4
14950_0,,,,2,3,2,5
C(CC=CC(C(O)=O)=O)=O,,,4,1,4,0,4
14952_0,,,,2,3,2,5
C(CC=CC(C=O)=O)(O)=O,,,4,1,2,0,2
14954_0,,,,2,3,2,5
C(C=CC(C(C)=O)=O)(O)=O,,,4,1,3,0,3
14956_0,,,,2,3,2,5
C(CC(C=CC(O)=O)=O)=O,,,4,1,5,0,5
14958_0,,,,2,3,2,5
C(CC(C=CC=O)=O)(O)=O,,,4,1,4,0,4
14960_0,,,,2,3,2,5
C=CC(CC(C(O)=O)=O)=O,,,4,1,4,0,4
14962_0,,,,2,3,2,5
C(CC(C(C=C)=O)=O)(O)=O,,,4,1,3,0,3
14964_0,,,,2,3,2,5
C(CC(C(O)=O)=O)=CC=O,,,4,1,4,0,4
14966_0,,,,2,3,2,5
C(CC(C=O)=O)=CC(O)=O,,,4,1,3,0,3
14968_0,,,,2,3,2,5
C(CC(C=CC(O)=O)O)(O)=O,,,4,1,2,0,2
14970_0,,,,2,3,2,5
C(CC=CC(C(O)=O)O)(O)=O,,,4,1,2,0,2
14972_0,,,,2,3,2,5
C(C1C(C(C(CO)O1)O)O)(O)=O,,,4,1,1,0,1
14974_0,,,,2,3,2,5
C(CC1C(C(CO1)O)=O)(O)=O,,,4,1,2,0,2
14976_0,,,,2,3,2,5
C(CC1(C(CCO1)=O)O)(O)=O,,,4,1,3,0,3
14978_0,,,,2,3,2,5
C(CC1(CC(CO1)=O)O)(O)=O,,,4,1,3,0,3
14980_0,,,,2,3,2,5
C(C(C1CC(CO1)O)=O)(O)=O,,,4,1,2,0,2
14982_0,,,,2,3,2,5
C(C1C(CC(C=O)O1)O)(O)=O,,,4,1,2,0,2
14984_0,,,,2,3,2,5
C(C1CC(C(C=O)O1)O)(O)=O,,,4,1,1,0,1
14986_0,,,,2,3,2,5
C(C1C(CC(C)(O1)O)=O)(O)=O,,,4,1,3,0,3
14988_0,,,,2,3,2,5
C1(CC(C(O)=O)OC1(C)O)=O,,,4,1,3,0,3
14990_0,,,,2,3,2,5
C(C1C(C(C(C)O1)=O)O)(O)=O,,,4,1,2,0,2
14992_0,,,,2,3,2,5
C(CC1C(C(C(O)O1)=O)O)(O)=O,,,4,1,2,0,2
14994_0,,,,2,3,2,5
C(C1C(C(C(CO)O1)O)=O)(O)=O,,,4,1,2,0,2
14996_0,,,,2,3,2,5
C(C1(C(CC(CO)O1)=O)O)(O)=O,,,4,1,3,0,3
14998_0,,,,2,3,2,5
C1(CC(C(O)=O)(OC1CO)O)=O,,,4,1,3,0,3
15000_0,,,,2,3,2,5
C(C1C(C(C(CO1)O)O)O)(O)=O,,,4,1,1,0,1
15002_0,,,,2,3,2,5
C1(CC(C(O)=O)(O)OCC1)=O,,,4,1,3,0,3
15004_0,,,,2,3,2,5
C(C1(CCC(CO1)=O)O)(O)=O,,,4,1,3,0,3
15006_0,,,,2,3,2,5
C(C1C(CCC(O1)O)=O)(O)=O,,,4,1,3,0,3
15008_0,,,,2,3,2,5
C1(CC(C(O)=O)OC(C1)O)=O,,,4,1,3,0,3
15010_0,,,,2,3,2,5
C(C1C(C(C(CO1)O)O)=O)(O)=O,,,4,1,2,0,2
15012_0,,,,2,3,2,5
C(C1(C(CC(CO1)O)=O)O)(O)=O,,,4,1,3,0,3
15014_0,,,,2,3,2,5
C1(CC(C(O)=O)(O)OCC1O)=O,,,4,1,3,0,3
15016_0,,,,2,3,2,5
C1(C(C(C(O)=O)(O)OCC1)O)=O,,,4,1,3,0,3
15018_0,,,,2,3,2,5
C(C1(C(CC(CO1)=O)O)O)(O)=O,,,4,1,3,0,3
15020_0,,,,2,3,2,5
C(CC1C(C(C(O1)=O)O)O)(O)=O,,,4,1,2,0,2
15022_0,,,,2,3,2,5
C(CC1CC(C(O1)=O)O)(O)=O,,,4,1,2,0,2
15023_0,,,,2,3,2,5
15024_0,,,,2,3,2,5
15026_0,,,,2,3,2,5
C1C(C(C(C=1C(O)=O)O)O)O,,,4,1,2,0,2
15028_0,,,,2,3,2,5
C(C(C(C(C=C)O)O)O)(O)=O,,,4,1,4,0,4
15030_0,,,,2,3,2,5
C(C1(C=CC(C1O)O)O)(O)=O,,,4,1,2,0,2
15032_0,,,,2,3,2,5
C(C(CC=CC(O)=O)O)(O)=O,,,4,1,3,0,3
15034_0,,,,2,3,2,5
C(CO)=CC(C(C(O)=O)=O)=O,,,4,1,2,0,2
15036_0,,,,2,3,2,5
C=CC(C(C(C(O)=O)=O)O)=O,,,4,1,3,0,3
15038_0,,,,2,3,2,5
C(C(C=CC(CO)=O)=O)(O)=O,,,4,1,3,0,3
15040_0,,,,2,3,2,5
C(C(C(C(O)=O)=O)O)=CC=O,,,4,1,3,0,3
15042_0,,,,2,3,2,5
C(C(C(C=O)=O)O)=CC(O)=O,,,4,1,3,0,3
15044_0,,,,2,3,2,5
C1C(C(CO)OC=1C(O)=O)O,,,4,1,2,0,2
15046_0,,,,2,3,2,5
C(C1(C=CC(CO)O1)O)(O)=O,,,4,1,2,0,2
15048_0,,,,2,3,2,5
C1(C(C(CO1)O)O)=CC(O)=O,,,4,1,2,0,2
15050_0,,,,2,3,2,5
C(C(C1OCC(C=1)O)O)(O)=O,,,4,1,3,0,3
15052_0,,,,2,3,2,5
C(C(C1(C=CCO1)O)O)(O)=O,,,4,1,3,0,3
15054_0,,,,2,3,2,5
C(C1C=CC(CO)(O1)O)(O)=O,,,4,1,2,0,2
15056_0,,,,2,3,2,5
C(C1C(C=C(CO)O1)O)(O)=O,,,4,1,2,0,2
15058_0,,,,2,3,2,5
C(C1C(C(C(O1)=C)O)O)(O)=O,,,4,1,2,0,2
15060_0,,,,2,3,2,5
C(C(C1C=CC(O)O1)O)(O)=O,,,4,1,3,0,3
15062_0,,,,2,3,2,5
C(C(C1C(C=CO1)O)O)(O)=O,,,4,1,3,0,3
15064_0,,,,2,3,2,5
C1C(C(COC=1C(O)=O)O)O,,,4,1,2,0,2
15066_0,,,,2,3,2,5
C(C1(C=CC(CO1)O)O)(O)=O,,,4,1,2,0,2
15068_0,,,,2,3,2,5
C(C1C(C=CC(O)O1)O)(O)=O,,,4,1,2,0,2
15070_0,,,,2,3,2,5
C(C1C(C(C=CO1)O)O)(O)=O,,,4,1,2,0,2
15071_0,,,,2,3,2,5
15073_0,,,,2,3,2,5
C(C1(C(CC(CO)O1)O)O)(O)=O,,,4,1,2,0,2
15075_0,,,,2,3,2,5
C(C1CC(C(CO)(O1)O)O)(O)=O,,,4,1,2,0,2
15077_0,,,,2,3,2,5
C(C(C1(C(CCO1)O)O)O)(O)=O,,,4,1,3,0,3
15079_0,,,,2,3,2,5
C(C(C1CC(C(O)O1)O)O)(O)=O,,,4,1,3,0,3
15081_0,,,,2,3,2,5
C(C(C1(C(C(CO1)O)O)O)O)(O)=O,,,4,1,3,0,3
15083_0,,,,2,3,2,5
C(C(C1(CC(CO1)O)O)=O)(O)=O,,,4,1,3,0,3
15085_0,,,,2,3,2,5
C(C(C1C(CC(O1)O)O)=O)(O)=O,,,4,1,3,0,3
15087_0,,,,2,3,2,5
C(C1(C(CC(CO1)O)O)O)(O)=O,,,4,1,2,0,2
15089_0,,,,2,3,2,5
C(C1C(CC(C(O1)O)O)O)(O)=O,,,4,1,2,0,2
15091_0,,,,2,3,2,5
C(C1CC(C(C(O1)O)O)O)(O)=O,,,4,1,2,0,2
15093_0,,,,2,3,2,5
C1(CC(C(C(C(O)=O)O)O1)O)=O,,,4,1,3,0,3
15095_0,,,,2,3,2,5
C1(CC(C(C(C(O)=O)O1)O)O)=O,,,4,1,2,0,2
15097_0,,,,2,1,1,2
C(CO)(C1(C(C(CC1O)O)O)O)=O,,,4,1,4,0,4
15097_1,,,,2,1,1,2
15098_0,,,,2,1,1,2
15098_1,,,,2,1,1,2
15099_0,,,,2,1,1,2
15099_1,,,,2,1,1,2
15100_0,,,,2,1,1,2
15100_1,,,,2,1,1,2
15101_0,,,,2,1,1,2
15101_1,,,,2,1,1,2
15102_0,,,,2,1,1,2
15102_1,,,,2,1,1,2
15103_0,,,,2,1,1,2
15103_1,,,,2,1,1,2
15104_0,,,,2,1,1,2
15104_1,,,,2,1,1,2
15105_0,,,,2,1,1,2
15105_1,,,,2,1,1,2
15106_0,,,,2,1,1,2
15106_1,,,,2,1,1,2
15107_0,,,,2,1,1,2
15107_1,,,,2,1,1,2
15109_0,,,,2,1,1,2
C(C1(C(C(CC1(C=O)O)O)O)O)=O,,,4,1,3,0,3
15109_1,,,,2,1,1,2
15110_0,,,,2,1,1,2
15110_1,,,,2,1,1,2
15111_0,,,,2,1,1,2
15111_1,,,,2,1,1,2
15112_0,,,,2,1,1,2
15112_1,,,,2,1,1,2
15114_0,,,,2,1,1,2
C1(C(CO)(C(C=O)(CC1O)O)O)=O,,,4,1,2,0,2
15114_1,,,,2,1,1,2
15115_0,,,,2,1,1,2
15115_1,,,,2,1,1,2
15116_0,,,,2,1,1,2
15116_1,,,,2,1,1,2
15118_0,,,,2,1,1,2
C(CO)(C1(C(CC(C1O)=O)O)O)=O,,,4,1,2,0,2
15118_1,,,,2,1,1,2
15119_0,,,,2,1,1,2
15119_1,,,,2,1,1,2
15120_0,,,,2,1,1,2
15120_1,,,,2,1,1,2
15121_0,,,,2,1,1,2
15121_1,,,,2,1,1,2
15122_0,,,,2,1,1,2
15122_1,,,,2,1,1,2
15123_0,,,,2,1,1,2
15123_1,,,,2,1,1,2
15124_0,,,,2,1,1,2
15124_1,,,,2,1,1,2
15125_0,,,,2,1,1,2
15125_1,,,,2,1,1,2
15126_0,,,,2,1,1,2
15126_1,,,,2,1,1,2
15127_0,,,,2,1,1,2
15127_1,,,,2,1,1,2
15128_0,,,,2,1,1,2
15128_1,,,,2,1,1,2
15129_0,,,,2,1,1,2
15129_1,,,,2,1,1,2
15130_0,,,,2,1,1,2
15130_1,,,,2,1,1,2
15131_0,,,,2,1,1,2
15131_1,,,,2,1,1,2
15132_0,,,,2,1,1,2
15132_1,,,,2,1,1,2
15134_0,,,,2,1,1,2
C1(C(C(CO)C(C1(CO)O)O)O)=O,,,4,1,4,0,4
15134_1,,,,2,1,1,2
15136_0,,,,2,1,1,2
C1(C(CC(C(C1(CO)O)O)O)O)=O,,,4,1,4,0,4
15136_1,,,,2,1,1,2
15138_0,,,,2,1,1,2
C1(C(CC(CO)(C1(CO)O)O)O)=O,,,4,1,4,0,4
15138_1,,,,2,1,1,2
15139_0,,,,2,1,1,2
15139_1,,,,2,1,1,2
15141_0,,,,2,1,1,2
C1(C(CO)(CO)C(C(C1)=O)O)=O,,,4,1,3,0,3
15143_0,,,,2,1,1,2
C1(CCC(C(C1(CO)O)O)=O)=O,,,4,1,5,0,5
15143_1,,,,2,1,1,2
15145_0,,,,2,1,1,2
C1(C(CO)(C(C=O)(CC1)O)O)=O,,,4,1,5,0,5
15145_1,,,,2,1,1,2
15147_0,,,,2,1,1,2
C(C1(CO)C(CC(C1O)=O)O)=O,,,4,1,4,0,4
15149_0,,,,2,1,1,2
C1(C(CC(C1(CO)CO)O)=O)=O,,,4,1,3,0,3
15150_0,,,,2,1,1,2
15150_1,,,,2,1,1,2
15152_0,,,,2,1,1,2
C(C1(C(C(CC1O)O)=O)CO)=O,,,4,1,2,0,2
15153_0,,,,2,1,1,2
15154_0,,,,2,1,1,2
15154_1,,,,2,1,1,2
15156_0,,,,2,1,1,2
C(C1(C(CC(CO)C1O)=O)O)=O,,,4,1,3,0,3
15156_1,,,,2,1,1,2
15158_0,,,,2,1,1,2
C(C1(CO)C(C(C(C1)=O)O)O)=O,,,4,1,3,0,3
15160_0,,,,2,1,1,2
C(C1(C(CC(C1O)O)=O)CO)=O,,,4,1,3,0,3
15161_0,,,,2,1,1,2
15161_1,,,,2,1,1,2
15163_0,,,,2,1,1,2
C1(C(CO)(CO)C(C(C1O)=O)O)=O,,,4,1,2,0,2
15164_0,,,,2,1,1,2
15164_1,,,,2,1,1,2
15166_0,,,,2,1,1,2
C1(C(CO)(C(C=O)(C(C1)O)O)O)=O,,,4,1,4,0,4
15166_1,,,,2,1,1,2
15168_0,,,,2,1,1,2
C(C1(CO)C(C(C(C1O)=O)O)O)=O,,,4,1,2,0,2
15170_0,,,,2,1,1,2
C1C(C(C(C(C=1)=O)(CO)O)O)O,,,4,1,5,0,5
15170_1,,,,2,1,1,2
15171_0,,,,2,1,1,2
15171_1,,,,2,1,1,2
15173_0,,,,2,1,1,2
C(C)(C1(C(C(CC1O)O)O)O)=O,,,4,1,4,0,4
15173_1,,,,2,1,1,2
15175_0,,,,2,1,1,2
C(C1(C(C(C)(CC1O)O)O)O)=O,,,4,1,2,0,2
15175_1,,,,2,1,1,2
15176_0,,,,2,1,1,2
15176_1,,,,2,1,1,2
15177_0,,,,2,1,1,2
15177_1,,,,2,1,1,2
15178_0,,,,2,1,1,2
15178_1,,,,2,1,1,2
15180_0,,,,2,1,1,2
C(C1(C(C(CC1(CO)O)O)O)O)=O,,,4,1,4,0,4
15180_1,,,,2,1,1,2
15182_0,,,,2,1,1,2
C(C)(C1(C(C(C(C1O)O)O)O)O)=O,,,4,1,2,0,2
15182_1,,,,2,1,1,2
15184_0,,,,2,1,1,2
C(C1(C(C(C(C1(C)O)O)O)O)O)=O,,,4,1,4,0,4
15184_1,,,,2,1,1,2
15186_0,,,,2,1,1,2
C(C(C1(C(C(CC1O)O)O)O)=O)=O,,,4,1,4,0,4
15186_1,,,,2,1,1,2
15187_0,,,,2,1,1,2
15187_1,,,,2,1,1,2
15189_0,,,,2,1,1,2
C1(C(CO)(C(C)O)C(C(C1)=O)O)=O,,,4,1,2,0,2
15191_0,,,,2,1,1,2
C1(CCC(C(C1(C(C)O)O)O)=O)=O,,,4,1,4,0,4
15191_1,,,,2,1,1,2
15193_0,,,,2,1,1,2
C1(C(C(C)O)(C(C=O)(CC1)O)O)=O,,,4,1,5,0,5
15193_1,,,,2,1,1,2
15195_0,,,,2,1,1,2
C(C1(C(CC(C1O)=O)O)C(C)O)=O,,,4,1,3,0,3
15197_0,,,,2,1,1,2
C1(C(CC(C1(CO)C(C)O)O)=O)=O,,,4,1,2,0,2
15198_0,,,,2,1,1,2
15198_1,,,,2,1,1,2
15200_0,,,,2,1,1,2
C1(CC(CC(C1(C(C)=O)O)O)O)=O,,,4,1,2,0,2
15200_1,,,,2,1,1,2
15202_0,,,,2,1,1,2
C(C1(C(C(CC1O)O)=O)C(C)O)=O,,,4,1,2,0,2
15203_0,,,,2,1,1,2
15205_0,,,,2,1,1,2
C(C1(C(CC(C)(CC1O)O)=O)O)=O,,,4,1,2,0,2
15205_1,,,,2,1,1,2
15206_0,,,,2,1,1,2
15206_1,,,,2,1,1,2
15207_0,,,,2,1,1,2
15207_1,,,,2,1,1,2
15209_0,,,,2,1,1,2
C(C1(C(CCC(CC1O)O)=O)O)=O,,,4,1,2,0,2
15209_1,,,,2,1,1,2
15210_0,,,,2,1,1,2
15210_1,,,,2,1,1,2
15212_0,,,,2,1,1,2
C(C1(C(CC(C1O)C(C)O)=O)O)=O,,,4,1,2,0,2
15212_1,,,,2,1,1,2
15214_0,,,,2,1,1,2
C(C1(C(C(C(C1)=O)O)O)C(C)O)=O,,,4,1,2,0,2
15216_0,,,,2,1,1,2
C(C1(C(CC(C1O)O)=O)C(C)O)=O,,,4,1,2,0,2
15218_0,,,,2,1,1,2
C1C(CC(C(C(C=1)=O)(CO)O)O)O,,,4,1,2,0,2
15218_1,,,,2,1,1,2
15220_0,,,,2,1,1,2
C=CC(C1(C(C(CC1O)O)O)O)=O,,,4,1,2,0,2
15220_1,,,,2,1,1,2
15222_0,,,,2,1,1,2
C(C1(C(C(C=C)(CC1O)O)O)O)=O,,,4,1,2,0,2
15222_1,,,,2,1,1,2
15224_0,,,,2,1,1,2
C1C(C(C(C(C=1)=O)(C(C)O)O)O)O,,,4,1,4,0,4
15224_1,,,,2,1,1,2
15226_0,,,,2,1,1,2
C(C1(C(CC(C=CC1O)O)O)O)=O,,,4,1,2,0,2
15226_1,,,,2,1,1,2
15227_0,,,,2,1,1,2
15227_1,,,,2,1,1,2
15228_0,,,,2,1,1,2
15228_1,,,,2,1,1,2
15229_0,,,,2,1,1,2
15229_1,,,,2,1,1,2
15231_0,,,,2,1,1,2
C(C1(C(C(C)(C(C1O)O)O)O)O)=O,,,4,1,2,0,2
15231_1,,,,2,1,1,2
15233_0,,,,2,1,1,2
C(C1(C(C(C(C1O)O)O)O)O)=O,,,4,1,4,0,4
15233_1,,,,2,1,1,2
15234_0,,,,2,1,1,2
15234_1,,,,2,1,1,2
15235_0,,,,2,1,1,2
15237_0,,,,2,1,1,2
C(C1(C(C(CO)C(C1O)O)O)O)=O,,,4,1,2,0,2
15237_1,,,,2,1,1,2
15238_0,,,,2,1,1,2
15240_0,,,,2,1,1,2
C(C1(C(O)OCC1(C)O)O)=O,,,4,1,3,0,3
15240_1,,,,2,1,1,2
15242_0,,,,2,1,1,2
C(C1(COCC1(CO)O)O)=O,,,4,1,2,0,2
15242_1,,,,2,1,1,2
15244_0,,,,2,1,1,2
C(C1(COC(C1(C)O)O)O)=O,,,4,1,3,0,3
15244_1,,,,2,1,1,2
15246_0,,,,2,1,1,2
C(C)(C1(C(O)OCC1O)O)=O,,,4,1,4,0,4
15246_1,,,,2,1,1,2
15248_0,,,,2,1,1,2
C(C)(C1(COC(C1O)O)O)=O,,,4,1,3,0,3
15248_1,,,,2,1,1,2
15250_0,,,,2,1,1,2
C(C1(C(C)(O)OCC1O)O)=O,,,4,1,3,0,3
15250_1,,,,2,1,1,2
15252_0,,,,2,1,1,2
C(C1(C(CO)OC(C1O)O)O)=O,,,4,1,3,0,3
15252_1,,,,2,1,1,2
15254_0,,,,2,1,1,2
C(C1(C(C(O)OCC1O)O)O)=O,,,4,1,3,0,3
15254_1,,,,2,1,1,2
15256_0,,,,2,1,1,2
C(C1(COC(C1(CO)O)O)O)=O,,,4,1,3,0,3
15256_1,,,,2,1,1,2
15257_0,,,,2,1,1,2
15257_1,,,,2,1,1,2
15258_0,,,,2,1,1,2
15258_1,,,,2,1,1,2
15259_0,,,,2,1,1,2
15259_1,,,,2,1,1,2
15260_0,,,,2,1,1,2
15261_0,,,,2,1,1,2
15262_0,,,,2,1,1,2
15262_1,,,,2,1,1,2
15263_0,,,,2,1,1,2
15264_0,,,,2,1,1,2
15264_1,,,,2,1,1,2
15266_0,,,,2,1,1,2
C1(C(CO)(C(CC1(CO)O)O)O)=O,,,4,1,3,0,3
15266_1,,,,2,1,1,2
15268_0,,,,2,1,1,2
C(C1(C(C(CO)(CC1O)O)O)O)=O,,,4,1,2,0,2
15268_1,,,,2,1,1,2
15270_0,,,,2,1,1,2
C(C1(C(C(C=O)(CC1O)O)O)O)=O,,,4,1,3,0,3
15270_1,,,,2,1,1,2
15272_0,,,,2,1,1,2
C(C1(C(C(C(C1O)O)O)O)O)(O)=O,,,4,1,2,0,2
15272_1,,,,2,1,1,2
15274_0,,,,2,1,1,2
C1(C2C(C(CC2O)O1)O)=O,,,4,1,2,0,2
15276_0,,,,2,1,1,2
C1(C2CC(C1(CO2)O)O)=O,,,4,1,2,0,2
15276_1,,,,2,1,1,2
15278_0,,,,2,1,1,2
C1(CC2(C(C1(CO2)O)O)O)=O,,,4,1,4,0,4
15278_1,,,,2,1,1,2
15280_0,,,,2,1,1,2
C1(C2(C(C(CC2O)O1)O)O)=O,,,4,1,4,0,4
15280_1,,,,2,1,1,2
15282_0,,,,2,1,1,2
C1(C2C(C(C(C2O)O1)O)O)=O,,,4,1,4,0,4
15283_0,,,,2,1,1,2
15285_0,,,,2,1,1,2
C(C1(C(CC(CO)CC1O)=O)O)=O,,,4,1,3,0,3
15285_1,,,,2,1,1,2
15287_0,,,,2,1,1,2
C(C1CC(C(C(C1)=O)(CO)O)O)=O,,,4,1,3,0,3
15287_1,,,,2,1,1,2
15289_0,,,,2,1,1,2
C1(CC(C(C1(CO)O)O)CC=O)=O,,,4,1,3,0,3
15289_1,,,,2,1,1,2
15291_0,,,,2,1,1,2
C1(C(CC(C1(CO)O)O)CC=O)=O,,,4,1,3,0,3
15291_1,,,,2,1,1,2
15293_0,,,,2,1,1,2
C(C1(C(CCCC(C1O)=O)O)O)=O,,,4,1,3,0,3
15293_1,,,,2,1,1,2
15295_0,,,,2,1,1,2
C1(C(C(CCC1)O)(C(C=O)O)O)=O,,,4,1,3,0,3
15295_1,,,,2,1,1,2
15297_0,,,,2,1,1,2
C(C1(C(C(CC1O)CC=O)O)O)=O,,,4,1,3,0,3
15297_1,,,,2,1,1,2
15299_0,,,,2,2,1,3
C(C1(C(CC(C1O)O)=O)O)(O)=O,,,4,1,2,0,2
15299_1,,,,2,2,1,3
15301_0,,,,2,2,1,3
C(C1(C(CC(C1O)=O)=O)CO)(O)=O,,,4,1,1,0,1
15303_0,,,,2,2,1,3
C(C1(C(CCC(C1O)=O)=O)O)(O)=O,,,4,1,2,0,2
15303_1,,,,2,2,1,3
15305_0,,,,2,2,1,3
C1(CCC(C=O)(C1(C(O)=O)O)O)=O,,,4,1,2,0,2
15305_1,,,,2,2,1,3
15307_0,,,,2,2,1,3
C(C1(C=O)C(CC(C1O)=O)O)(O)=O,,,4,1,1,0,1
15309_0,,,,2,2,1,3
C(C1(C(C(CC1O)=O)=O)CO)(O)=O,,,4,1,1,0,1
15311_0,,,,2,2,1,3
C(C1(C(CC(CC1O)=O)=O)O)(O)=O,,,4,1,2,0,2
15311_1,,,,2,2,1,3
15313_0,,,,2,2,1,3
C(C1(C(CC(CC1=O)O)=O)O)(O)=O,,,4,1,2,0,2
15313_1,,,,2,2,1,3
15315_0,,,,2,2,1,3
C(C1(C=O)C(C(CC1O)O)=O)(O)=O,,,4,1,1,0,1
15317_0,,,,2,2,1,3
C(C1C(C(C(O)=O)(C(C1)=O)O)O)=O,,,4,1,2,0,2
15317_1,,,,2,2,1,3
15319_0,,,,2,2,1,3
C(C1(C=O)C(C(C(C1)=O)O)O)(O)=O,,,4,1,1,0,1
15321_0,,,,2,2,1,3
C(C1(C=O)C(CC(C1O)O)=O)(O)=O,,,4,1,1,0,1
15323_0,,,,2,2,1,3
C(C1(C(C=CC(C1O)O)=O)O)(O)=O,,,4,1,2,0,2
15323_1,,,,2,2,1,3
15325_0,,,,2,2,1,3
C(C(C(CO)=O)(C(C=O)O)O)(O)=O,,,4,1,2,0,2
15325_1,,,,2,2,1,3
15326_0,,,,2,2,1,3
15326_1,,,,2,2,1,3
15328_0,,,,2,2,1,3
C(C(C(CO)=O)(C(C)O)O)(O)=O,,,4,1,2,0,2
15328_1,,,,2,2,1,3
15329_0,,,,2,2,1,3
15329_1,,,,2,2,1,3
15330_0,,,,2,2,1,3
15330_1,,,,2,2,1,3
15332_0,,,,2,2,1,3
C(C(C=O)(C(CO)=O)CO)(O)=O,,,4,1,1,0,1
15334_0,,,,2,2,1,3
C(C(C(CC=O)=O)(CO)O)(O)=O,,,4,1,2,0,2
15334_1,,,,2,2,1,3
15336_0,,,,2,2,1,3
C(C(C=O)(C(CO)=O)C(C)O)(O)=O,,,4,1,1,0,1
15338_0,,,,2,2,1,3
C(C(C(CC=O)=O)(C(C)O)O)(O)=O,,,4,1,2,0,2
15338_1,,,,2,2,1,3
15340_0,,,,2,2,1,3
C(C(C=O)(C(CCO)=O)O)(O)=O,,,4,1,2,0,2
15340_1,,,,2,2,1,3
15342_0,,,,2,2,1,3
C(C(C=O)(C(CC(C)O)=O)O)(O)=O,,,4,1,2,0,2
15342_1,,,,2,2,1,3
15344_0,,,,2,2,1,3
C(CC(C(C(O)=O)(C(C)=O)O)O)=O,,,4,1,4,0,4
15344_1,,,,2,2,1,3
15346_0,,,,2,2,1,3
C(C(C=O)(C(C)(CC=O)O)O)(O)=O,,,4,1,4,0,4
15346_1,,,,2,2,1,3
15348_0,,,,2,2,1,3
C(C(C=O)(C(C(C=O)=O)O)O)(O)=O,,,4,1,4,0,4
15348_1,,,,2,2,1,3
15350_0,,,,2,2,1,3
C(C(C(C=O)=O)(C(C=O)O)O)(O)=O,,,4,1,2,0,2
15350_1,,,,2,2,1,3
15352_0,,,,2,2,1,3
C(C(C(CCO)=O)(CO)O)(O)=O,,,4,1,2,0,2
15352_1,,,,2,2,1,3
15354_0,,,,2,2,1,3
C(C(C(CC(C)O)=O)(CO)O)(O)=O,,,4,1,2,0,2
15354_1,,,,2,2,1,3
15356_0,,,,2,2,1,3
C(C(C(C=O)=O)(CO)CO)(O)=O,,,4,1,1,0,1
15358_0,,,,2,2,1,3
C(C(C(CO)=O)(CO)CO)(O)=O,,,4,1,1,0,1
15360_0,,,,2,2,1,3
C(C(C=O)(CO)C(C=O)O)(O)=O,,,4,1,1,0,1
15362_0,,,,2,2,1,3
C(C)(C(C(C)O)(C(CCO)O)O)=O,,,4,1,2,0,2
15362_1,,,,2,2,1,3
15364_0,,,,2,2,1,3
C(C(C(C)O)(C(CCO)O)O)=O,,,4,1,2,0,2
15364_1,,,,2,2,1,3
15365_0,,,,2,2,1,3
15365_1,,,,2,2,1,3
15367_0,,,,2,2,1,3
C(C(C(CO)=O)(C(CCO)O)O)=O,,,4,1,2,0,2
15367_1,,,,2,2,1,3
15369_0,,,,2,2,1,3
C(C(C(C)=O)(C(CCO)O)O)(O)=O,,,4,1,2,0,2
15369_1,,,,2,2,1,3
15370_0,,,,2,2,1,3
15370_1,,,,2,2,1,3
15372_0,,,,2,2,1,3
C(C(C(CCO)O)C(C=O)O)(O)=O,,,4,1,1,0,1
15374_0,,,,2,2,1,3
C(C(C(C=O)=O)(C(CCO)O)O)=O,,,4,1,2,0,2
15374_1,,,,2,2,1,3
15376_0,,,,2,2,1,3
C1(C(C(CO1)O)(C(CCO)O)O)=O,,,4,1,2,0,2
15376_1,,,,2,2,1,3
15378_0,,,,2,2,1,3
C1(C(C(CO1)O)C(CCO)O)=O,,,4,1,1,0,1
15380_0,,,,2,2,1,3
C(C(C(C)O)(C(CCO)O)O)(O)=O,,,4,1,2,0,2
15380_1,,,,2,2,1,3
15382_0,,,,2,2,1,3
C1(COCC1(C(CCO)O)O)=O,,,4,1,2,0,2
15382_1,,,,2,2,1,3
15384_0,,,,2,2,1,3
C1(C(O)OCC1(C(CCO)O)O)=O,,,4,1,2,0,2
15384_1,,,,2,2,1,3
15386_0,,,,2,2,1,3
C(C(C(C(CO)O)=O)(CO)O)(O)=O,,,4,1,2,0,2
15386_1,,,,2,2,1,3
15388_0,,,,2,2,1,3
C(C(C(C=O)=O)(CO)C(C)O)(O)=O,,,4,1,1,0,1
15390_0,,,,2,2,1,3
C(C(C(CCO)=O)(C(C)O)O)(O)=O,,,4,1,2,0,2
15390_1,,,,2,2,1,3
15392_0,,,,2,2,1,3
C(C(C(CO)=O)(CO)C(C)O)(O)=O,,,4,1,1,0,1
15394_0,,,,2,2,1,3
C(C(C=O)(C(CC=O)O)O)(O)=O,,,4,1,4,0,4
15394_1,,,,2,2,1,3
15395_0,,,,2,2,1,3
15395_1,,,,2,2,1,3
15396_0,,,,2,2,1,3
15396_1,,,,2,2,1,3
15397_0,,,,2,2,1,3
15397_1,,,,2,2,1,3
15398_0,,,,2,2,1,3
15398_1,,,,2,2,1,3
15400_0,,,,2,2,1,3
C(C)(C(C(C)O)(C(C(C)O)O)O)=O,,,4,1,2,0,2
15400_1,,,,2,2,1,3
15402_0,,,,2,2,1,3
C(C(C=O)(C(C)O)C(C=O)O)(O)=O,,,4,1,1,0,1
15404_0,,,,2,2,1,3
C(C(C(C)O)(C(CC(C)O)O)O)=O,,,4,1,2,0,2
15404_1,,,,2,2,1,3
15406_0,,,,2,2,1,3
C(C(CO)(C(CC(C)O)O)O)(O)=O,,,4,1,2,0,2
15406_1,,,,2,2,1,3
15408_0,,,,2,2,1,3
C(C(C=O)(C(CC(C)O)O)O)(O)=O,,,4,1,2,0,2
15408_1,,,,2,2,1,3
15410_0,,,,2,2,1,3
C1(C(C(CO1)O)C(CC(C)O)O)=O,,,4,1,1,0,1
15412_0,,,,2,2,1,3
C1(COCC1(C(CC(C)O)O)O)=O,,,4,1,2,0,2
15412_1,,,,2,2,1,3
15414_0,,,,2,2,1,3
C(C(C(C=O)=O)(C(C)O)O)(O)=O,,,4,1,2,0,2
15414_1,,,,2,2,1,3
15415_0,,,,2,2,1,3
15415_1,,,,2,2,1,3
15416_0,,,,2,2,1,3
15416_1,,,,2,2,1,3
15417_0,,,,2,2,1,3
15417_1,,,,2,2,1,3
15418_0,,,,2,2,1,3
15418_1,,,,2,2,1,3
15419_0,,,,2,2,1,3
15419_1,,,,2,2,1,3
15420_0,,,,2,2,1,3
15420_1,,,,2,2,1,3
15421_0,,,,2,2,1,3
15421_1,,,,2,2,1,3
15422_0,,,,2,2,1,3
15422_1,,,,2,2,1,3
15424_0,,,,2,2,1,3
C(C(C)(C(C=O)(C(C)O)O)O)(O)=O,,,4,1,3,0,3
15424_1,,,,2,2,1,3
15425_0,,,,2,2,1,3
15425_1,,,,2,2,1,3
15426_0,,,,2,2,1,3
15426_1,,,,2,2,1,3
15428_0,,,,2,2,1,3
C(C(C(C)O)(C(C(C)=O)(C)O)O)=O,,,4,1,2,0,2
15428_1,,,,2,2,1,3
15429_0,,,,2,2,1,3
15429_1,,,,2,2,1,3
15431_0,,,,2,2,1,3
C(C(C(CC(C)=O)O)(C(C)O)O)=O,,,4,1,2,0,2
15431_1,,,,2,2,1,3
15433_0,,,,2,2,1,3
C(C(C(C)O)(C(C)(CCO)O)O)=O,,,4,1,2,0,2
15433_1,,,,2,2,1,3
15434_0,,,,2,2,1,3
15434_1,,,,2,2,1,3
15436_0,,,,2,2,1,3
C(C(C=O)(C(C=O)(C(C)O)O)O)=O,,,4,1,6,0,6
15436_1,,,,2,2,1,3
15437_0,,,,2,2,1,3
15437_1,,,,2,2,1,3
15439_0,,,,2,2,1,3
C(C(C=C)(C(C=O)(C(C)O)O)O)=O,,,4,1,2,0,2
15439_1,,,,2,2,1,3
15441_0,,,,2,2,1,3
C(C(C(C)O)(C(C=C)(CO)O)O)=O,,,4,1,2,0,2
15441_1,,,,2,2,1,3
15442_0,,,,2,2,1,3
15442_1,,,,2,2,1,3
15444_0,,,,2,2,1,3
C(C(C(C)O)(C(C(C)O)O)O)=O,,,4,1,2,0,2
15444_1,,,,2,2,1,3
15445_0,,,,2,2,1,3
15445_1,,,,2,2,1,3
15447_0,,,,2,2,1,3
C(C(C(C=O)=O)(C(CO)O)O)(O)=O,,,4,1,3,0,3
15447_1,,,,2,2,1,3
15449_0,,,,2,2,1,3
C(C(CO)(C(CC=O)O)O)(O)=O,,,4,1,2,0,2
15449_1,,,,2,2,1,3
15451_0,,,,2,2,1,3
C(C(CO)(C(C(O)=O)(C)O)O)(O)=O,,,4,1,3,0,3
15451_1,,,,2,2,1,3
15453_0,,,,2,2,1,3
C(C(C(O)=O)(CO)O)(O)=O,,,4,1,2,0,2
15453_1,,,,2,2,1,3
15454_0,,,,2,2,1,3
15454_1,,,,2,2,1,3
15456_0,,,,2,2,1,3
C(C(CO)(C(C(C)=O)(C)O)O)(O)=O,,,4,1,2,0,2
15456_1,,,,2,2,1,3
15458_0,,,,2,2,1,3
C(C(CO)(C(C)(CC=O)O)O)(O)=O,,,4,1,2,0,2
15458_1,,,,2,2,1,3
15460_0,,,,2,2,1,3
C(C(CO)(C(CC(C)=O)O)O)(O)=O,,,4,1,2,0,2
15460_1,,,,2,2,1,3
15462_0,,,,2,2,1,3
C(C(CO)(C(C)(CCO)O)O)(O)=O,,,4,1,2,0,2
15462_1,,,,2,2,1,3
15463_0,,,,2,2,1,3
15463_1,,,,2,2,1,3
15464_0,,,,2,2,1,3
15464_1,,,,2,2,1,3
15465_0,,,,2,2,1,3
15465_1,,,,2,2,1,3
15467_0,,,,2,2,1,3
C(C(C=C)(C(C(O)=O)(CO)O)O)=O,,,4,1,2,0,2
15467_1,,,,2,2,1,3
15469_0,,,,2,2,1,3
C(C(CO)(C(C=C)(CO)O)O)(O)=O,,,4,1,2,0,2
15469_1,,,,2,2,1,3
15470_0,,,,2,2,1,3
15470_1,,,,2,2,1,3
15472_0,,,,2,2,1,3
C(C(CO)(C(C(C)O)O)O)(O)=O,,,4,1,2,0,2
15472_1,,,,2,2,1,3
15474_0,,,,2,2,1,3
C(C(C(CO)=O)(C(C)=O)O)(O)=O,,,4,1,2,0,2
15474_1,,,,2,2,1,3
15476_0,,,,2,2,1,3
C(CC(C(C=O)(C(CO)=O)O)O)=O,,,4,1,2,0,2
15476_1,,,,2,2,1,3
15477_0,,,,2,2,1,3
15477_1,,,,2,2,1,3
15478_0,,,,2,2,1,3
15478_1,,,,2,2,1,3
15480_0,,,,2,2,1,3
C(C(C(CC=O)O)C(C=O)O)(O)=O,,,4,1,1,0,1
15482_0,,,,2,2,1,3
C(C(C(C=O)=O)(C(CC=O)O)O)=O,,,4,1,2,0,2
15482_1,,,,2,2,1,3
15484_0,,,,2,2,1,3
C1(C(C(CC=O)O)(C(CO1)O)O)=O,,,4,1,2,0,2
15484_1,,,,2,2,1,3
15486_0,,,,2,2,1,3
C1(C(C(CC=O)O)C(CO1)O)=O,,,4,1,1,0,1
15488_0,,,,2,2,1,3
C(C(C(CC=O)O)(C(C)O)O)(O)=O,,,4,1,2,0,2
15488_1,,,,2,2,1,3
15490_0,,,,2,2,1,3
C(CC(C1(C(COC1)=O)O)O)=O,,,4,1,2,0,2
15490_1,,,,2,2,1,3
15492_0,,,,2,2,1,3
C(CC(C1(C(C(O)OC1)=O)O)O)=O,,,4,1,3,0,3
15492_1,,,,2,2,1,3
15494_0,,,,2,2,1,3
C(C(C=O)(C(CO)=O)O)(O)=O,,,4,1,2,0,2
15494_1,,,,2,2,1,3
15496_0,,,,2,2,1,3
C(C(C(CO)=O)(C(C(O)=O)O)O)=O,,,4,1,2,0,2
15496_1,,,,2,2,1,3
15498_0,,,,2,2,1,3
C(C(C(CO)=O)(C(C(C)O)O)O)=O,,,4,1,2,0,2
15498_1,,,,2,2,1,3
15500_0,,,,2,2,1,3
C(C(C=O)(C(C(O)=O)(C)O)O)(O)=O,,,4,1,2,0,2
15500_1,,,,2,2,1,3
15502_0,,,,2,2,1,3
C1(C(C(CO1)O)C(C(O)=O)(C)O)=O,,,4,1,1,0,1
15504_0,,,,2,2,1,3
C(C(C)(C1(C(COC1)=O)O)O)(O)=O,,,4,1,2,0,2
15504_1,,,,2,2,1,3
15506_0,,,,2,2,1,3
C(C(C(O)=O)(C(C)=O)O)(O)=O,,,4,1,2,0,2
15506_1,,,,2,2,1,3
15508_0,,,,2,2,1,3
C(C(C(O)=O)(C(C(C)=O)O)O)(O)=O,,,4,1,2,0,2
15508_1,,,,2,2,1,3
15510_0,,,,2,2,1,3
C(C(C(C)=O)(C(C(O)=O)O)O)(O)=O,,,4,1,4,0,4
15510_1,,,,2,2,1,3
15512_0,,,,2,2,1,3
C(C(C(O)=O)(C=O)O)(O)=O,,,4,1,2,0,2
15512_1,,,,2,2,1,3
15514_0,,,,2,2,1,3
C(C(C(O)=O)(C(C=O)O)O)(O)=O,,,4,1,2,0,2
15514_1,,,,2,2,1,3
15516_0,,,,2,2,1,3
C(C(C=O)(C(C(O)=O)O)O)(O)=O,,,4,1,4,0,4
15516_1,,,,2,2,1,3
15518_0,,,,2,2,1,3
C(C(C(O)=O)C(C=O)O)(O)=O,,,4,1,1,0,1
15520_0,,,,2,2,1,3
C(C(C(C)=O)(C(C=O)=O)O)(O)=O,,,4,1,2,0,2
15520_1,,,,2,2,1,3
15522_0,,,,2,2,1,3
C(C(C=O)(C(C=O)=O)O)(O)=O,,,4,1,2,0,2
15522_1,,,,2,2,1,3
15524_0,,,,2,2,1,3
C1(C(C(O)=O)(C(CO1)O)O)=O,,,4,1,2,0,2
15524_1,,,,2,2,1,3
15526_0,,,,2,2,1,3
C1(C(C(O)=O)C(CO1)O)=O,,,4,1,1,0,1
15528_0,,,,2,2,1,3
C(C(C=O)(C(C(C)O)=O)O)(O)=O,,,4,1,2,0,2
15528_1,,,,2,2,1,3
15530_0,,,,2,2,1,3
C(C(C(CO)=O)(C(C=C)=O)O)(O)=O,,,4,1,2,0,2
15530_1,,,,2,2,1,3
15532_0,,,,2,2,1,3
C(C(C=O)(C(C(C=C)O)=O)O)(O)=O,,,4,1,2,0,2
15532_1,,,,2,2,1,3
15534_0,,,,2,2,1,3
C(CCO)(C(C(O)=O)(C(C)=O)O)=O,,,4,1,2,0,2
15534_1,,,,2,2,1,3
15535_0,,,,2,2,1,3
15535_1,,,,2,2,1,3
15536_0,,,,2,2,1,3
15536_1,,,,2,2,1,3
15538_0,,,,2,2,1,3
C(C(C=O)(C(CCCO)=O)O)(O)=O,,,4,1,2,0,2
15538_1,,,,2,2,1,3
15539_0,,,,2,2,1,3
15539_1,,,,2,2,1,3
15541_0,,,,2,2,1,3
C(C(C(C=C)=O)(C(CO)O)O)(O)=O,,,4,1,2,0,2
15541_1,,,,2,2,1,3
15543_0,,,,2,2,1,3
C(C(C=O)(C(C=CCO)O)O)(O)=O,,,4,1,2,0,2
15543_1,,,,2,2,1,3
15545_0,,,,2,2,1,3
C(C(C(C(O)=O)=O)(CO)O)(O)=O,,,4,1,2,0,2
15545_1,,,,2,2,1,3
15547_0,,,,2,2,1,3
C(C(C=O)(C(C=O)(C=O)O)O)(O)=O,,,4,1,4,0,4
15547_1,,,,2,2,1,3
15549_0,,,,2,2,1,3
C(C(C(O)=O)(C(C=O)(C)O)O)(O)=O,,,4,1,2,0,2
15549_1,,,,2,2,1,3
15551_0,,,,2,2,1,3
C(C(C(O)=O)(C(CO)(C)O)O)(O)=O,,,4,1,2,0,2
15551_1,,,,2,2,1,3
15553_0,,,,2,2,1,3
C(C(C(O)=O)(C(C)O)O)(O)=O,,,4,1,2,0,2
15553_1,,,,2,2,1,3
15555_0,,,,2,2,1,3
C1(CC(C(C1(C(O)=O)CO)=O)O)=O,,,4,1,1,0,1
15557_0,,,,2,2,1,3
C1(C(CO)CC(C1(C(O)=O)O)=O)=O,,,4,1,2,0,2
15557_1,,,,2,2,1,3
15559_0,,,,2,2,1,3
C(C1(C(C(C(C1)=O)O)=O)CO)(O)=O,,,4,1,1,0,1
15561_0,,,,2,2,1,3
C(C1C(OC(C(C)=O)C1O)=O)(O)=O,,,4,1,1,0,1
15563_0,,,,2,2,1,3
C1(CC(C(C(O)=O)(C(C)=O)O1)O)=O,,,4,1,2,0,2
15563_1,,,,2,2,1,3
15565_0,,,,2,2,1,3
C1(C(C(O)=O)C(C(CC=O)O1)O)=O,,,4,1,1,0,1
15567_0,,,,2,2,1,3
C(C1(C(COC1C(C)=O)=O)O)(O)=O,,,4,1,2,0,2
15567_1,,,,2,2,1,3
15569_0,,,,2,2,1,3
C(C1(C(C)=O)C(C(CO1)=O)O)(O)=O,,,4,1,2,0,2
15569_1,,,,2,2,1,3
15571_0,,,,2,2,1,3
C(CC1C(C(O)=O)(C(CO1)=O)O)=O,,,4,1,2,0,2
15571_1,,,,2,2,1,3
15573_0,,,,2,2,1,3
C1(CC(OC1(C(O)=O)C(C)=O)O)=O,,,4,1,2,0,2
15573_1,,,,2,2,1,3
15575_0,,,,2,2,1,3
C(C1(C(CCC(O1)=O)=O)CO)(O)=O,,,4,1,2,0,2
15575_1,,,,2,2,1,3
15577_0,,,,2,2,1,3
C(C1(C(CC(CO1)=O)=O)CO)(O)=O,,,4,1,2,0,2
15577_1,,,,2,2,1,3
15579_0,,,,2,2,1,3
C(C1(C(CCC(OC1)=O)=O)O)(O)=O,,,4,1,2,0,2
15579_1,,,,2,2,1,3
15581_0,,,,2,2,1,3
C1(C(C(O)=O)C(C(CCO1)=O)O)=O,,,4,1,1,0,1
15583_0,,,,2,2,1,3
C(C1C(OCC(CC1O)=O)=O)(O)=O,,,4,1,1,0,1
15585_0,,,,2,2,1,3
C(C1(C(CC(COC1)=O)=O)O)(O)=O,,,4,1,2,0,2
15585_1,,,,2,2,1,3
15587_0,,,,2,2,1,3
C1(CCOCC(C1(C(O)=O)O)=O)=O,,,4,1,2,0,2
15587_1,,,,2,2,1,3
15589_0,,,,2,2,1,3
C(C1(C(COC1)=O)O)(O)=O,,,4,1,2,0,2
15589_1,,,,2,2,1,3
15591_0,,,,2,2,1,3
C(CC1C(C(C(O)=O)(CO1)O)=O)=O,,,4,1,2,0,2
15591_1,,,,2,2,1,3
15593_0,,,,2,2,1,3
C(C1(C=O)C(CC(C=O)O1)O)(O)=O,,,4,1,2,0,2
15593_1,,,,2,2,1,3
15595_0,,,,2,2,1,3
C(C1(C=O)C(CC(C)(O1)O)=O)(O)=O,,,4,1,2,0,2
15595_1,,,,2,2,1,3
15597_0,,,,2,2,1,3
C(C1(C=O)C(C(C(C)O1)=O)O)(O)=O,,,4,1,2,0,2
15597_1,,,,2,2,1,3
15599_0,,,,2,2,1,3
C1(C(C)OC(C=O)C1(C(O)=O)O)=O,,,4,1,2,0,2
15599_1,,,,2,2,1,3
15601_0,,,,2,2,1,3
C(C1(C=O)C(CCC(O1)O)=O)(O)=O,,,4,1,2,0,2
15601_1,,,,2,2,1,3
15603_0,,,,2,2,1,3
C(C1(C(C(CO)=CC1O)=O)O)(O)=O,,,4,1,2,0,2
15603_1,,,,2,2,1,3
15605_0,,,,2,2,1,3
C(C1(C(C(C(C1O)O)=C)=O)O)(O)=O,,,4,1,2,0,2
15605_1,,,,2,2,1,3
15607_0,,,,2,2,1,3
C(C(C=O)(C(C(C=C)O)O)O)(O)=O,,,4,1,2,0,2
15607_1,,,,2,2,1,3
15609_0,,,,2,2,1,3
C(C1(C(C=CO1)=O)C(CO)O)(O)=O,,,4,1,2,0,2
15609_1,,,,2,2,1,3
15611_0,,,,2,2,1,3
C(C1(C(C=COC1CO)=O)O)(O)=O,,,4,1,2,0,2
15611_1,,,,2,2,1,3
15613_0,,,,2,2,1,3
C(C1(C(C=CC(O1)O)=O)CO)(O)=O,,,4,1,2,0,2
15613_1,,,,2,2,1,3
15615_0,,,,2,2,1,3
C(C1(C(C=COCC1O)=O)O)(O)=O,,,4,1,2,0,2
15615_1,,,,2,2,1,3
15617_0,,,,2,2,1,3
C(C1(C(C=CCOC1O)=O)O)(O)=O,,,4,1,2,0,2
15617_1,,,,2,2,1,3
15619_0,,,,2,2,1,3
C(C1(C(C=CC(O)OC1)=O)O)(O)=O,,,4,1,2,0,2
15619_1,,,,2,2,1,3
15621_0,,,,2,2,1,3
C(C(C(C=O)=O)(C(C=C)=O)O)(O)=O,,,4,1,2,0,2
15621_1,,,,2,2,1,3
15623_0,,,,2,2,1,3
C(C(C=O)(C1OCC(C=1)O)O)(O)=O,,,4,1,2,0,2
15623_1,,,,2,2,1,3
15625_0,,,,2,2,1,3
C(C(C=O)(C1(C=CCO1)O)O)(O)=O,,,4,1,2,0,2
15625_1,,,,2,2,1,3
15627_0,,,,2,2,1,3
C(C1(C=O)C(C=C(CO)O1)O)(O)=O,,,4,1,2,0,2
15627_1,,,,2,2,1,3
15629_0,,,,2,2,1,3
C(C1(C=O)C(C(C(O1)=C)O)O)(O)=O,,,4,1,2,0,2
15629_1,,,,2,2,1,3
15631_0,,,,2,2,1,3
C(C(C=O)(C1C=CC(O)O1)O)(O)=O,,,4,1,2,0,2
15631_1,,,,2,2,1,3
15633_0,,,,2,2,1,3
C(C(C=O)(C1C(C=CO1)O)O)(O)=O,,,4,1,2,0,2
15633_1,,,,2,2,1,3
15635_0,,,,2,2,1,3
C(C1(C=O)C(C=CC(O1)O)O)(O)=O,,,4,1,2,0,2
15635_1,,,,2,2,1,3
15637_0,,,,2,2,1,3
C(C1(C=O)C(C(C=CO1)O)O)(O)=O,,,4,1,2,0,2
15637_1,,,,2,2,1,3
15639_0,,,,2,2,1,3
C(C1(C(C(O)OC1)=O)O)(O)=O,,,4,1,2,0,2
15639_1,,,,2,2,1,3
15640_0,,,,2,2,1,3
15640_1,,,,2,2,1,3
15642_0,,,,2,2,1,3
C(C(C(C)=O)(C(C(C)O)O)O)(O)=O,,,4,1,2,0,2
15642_1,,,,2,2,1,3
15643_0,,,,2,2,1,3
15643_1,,,,2,2,1,3
15645_0,,,,2,2,1,3
C(C(C(C(O)=O)C(C=O)O)O)(O)=O,,,4,1,1,0,1
15647_0,,,,2,2,1,3
C(C(C(C=O)=O)(C(C(O)=O)O)O)=O,,,4,1,2,0,2
15647_1,,,,2,2,1,3
15649_0,,,,2,2,1,3
C1(C(C(CO1)O)(C(C(O)=O)O)O)=O,,,4,1,2,0,2
15649_1,,,,2,2,1,3
15651_0,,,,2,2,1,3
C1(C(C(CO1)O)C(C(O)=O)O)=O,,,4,1,1,0,1
15653_0,,,,2,2,1,3
C(C(C(C)O)(C(C(O)=O)O)O)(O)=O,,,4,1,2,0,2
15653_1,,,,2,2,1,3
15655_0,,,,2,2,1,3
C1(COCC1(C(C(O)=O)O)O)=O,,,4,1,2,0,2
15655_1,,,,2,2,1,3
15657_0,,,,2,2,1,3
C1(C(O)OCC1(C(C(O)=O)O)O)=O,,,4,1,2,0,2
15657_1,,,,2,2,1,3
15659_0,,,,2,2,1,3
C(C(C=O)(C(C(C)=O)(C)O)O)(O)=O,,,4,1,2,0,2
15659_1,,,,2,2,1,3
15660_0,,,,2,2,1,3
15660_1,,,,2,2,1,3
15662_0,,,,2,2,1,3
C(C(C=O)(C(CC(C)=O)O)O)(O)=O,,,4,1,2,0,2
15662_1,,,,2,2,1,3
15664_0,,,,2,2,1,3
C(C(C=O)(C(C)(CCO)O)O)(O)=O,,,4,1,2,0,2
15664_1,,,,2,2,1,3
15665_0,,,,2,2,1,3
15665_1,,,,2,2,1,3
15666_0,,,,2,2,1,3
15666_1,,,,2,2,1,3
15668_0,,,,2,2,1,3
C(C(C=O)(C(C(C=C)=O)O)O)(O)=O,,,4,1,4,0,4
15668_1,,,,2,2,1,3
15670_0,,,,2,2,1,3
C(C(C=O)(C(C=O)(C=C)O)O)(O)=O,,,4,1,2,0,2
15670_1,,,,2,2,1,3
15672_0,,,,2,2,1,3
C(C(C=O)(C(C=C)(CO)O)O)(O)=O,,,4,1,2,0,2
15672_1,,,,2,2,1,3
15674_0,,,,2,2,1,3
C(C(C=O)(C(C=CC=O)O)O)(O)=O,,,4,1,4,0,4
15674_1,,,,2,2,1,3
15676_0,,,,2,2,1,3
C(C(C=O)(C(C(C)O)O)O)(O)=O,,,4,1,2,0,2
15676_1,,,,2,2,1,3
15678_0,,,,2,2,1,3
C(C(C(C(C)O)O)C(C=O)O)(O)=O,,,4,1,1,0,1
15680_0,,,,2,2,1,3
C1(C(C(CO1)O)C(C(C)=O)(C)O)=O,,,4,1,1,0,1
15682_0,,,,2,2,1,3
C(C)(C(C)(C1(C(COC1)=O)O)O)=O,,,4,1,2,0,2
15682_1,,,,2,2,1,3
15684_0,,,,2,2,1,3
C1(C(C(CO1)O)C(C)(CC=O)O)=O,,,4,1,1,0,1
15686_0,,,,2,2,1,3
C1(C(C(CC(C)=O)O)C(CO1)O)=O,,,4,1,1,0,1
15688_0,,,,2,2,1,3
C(CC(C)(C1(C(COC1)=O)O)O)=O,,,4,1,2,0,2
15688_1,,,,2,2,1,3
15690_0,,,,2,2,1,3
C(C)(CC(C1(C(COC1)=O)O)O)=O,,,4,1,2,0,2
15690_1,,,,2,2,1,3
15692_0,,,,2,2,1,3
C1(C(C(CO1)O)C(C)(CCO)O)=O,,,4,1,1,0,1
15694_0,,,,2,2,1,3
C1(COCC1(C(C)(CCO)O)O)=O,,,4,1,2,0,2
15694_1,,,,2,2,1,3
15696_0,,,,2,2,1,3
C1(C(C(CO1)O)C(C(C=O)=O)O)=O,,,4,1,1,0,1
15698_0,,,,2,2,1,3
C(C(C=O)(C1C(OCC1O)=O)O)=O,,,4,1,1,0,1
15700_0,,,,2,2,1,3
C1(COCC1(C(C(C=O)=O)O)O)=O,,,4,1,2,0,2
15700_1,,,,2,2,1,3
15702_0,,,,2,2,1,3
C(C(C=O)(C1(C(COC1)=O)O)O)=O,,,4,1,2,0,2
15702_1,,,,2,2,1,3
15704_0,,,,2,2,1,3
C(C(C(C=O)=O)(C(C(C)O)O)O)=O,,,4,1,2,0,2
15704_1,,,,2,2,1,3
15706_0,,,,2,2,1,3
C1(C(C(CO1)O)C(C(C=C)=O)O)=O,,,4,1,1,0,1
15708_0,,,,2,2,1,3
C(C(C=C)(C1C(OCC1O)=O)O)=O,,,4,1,1,0,1
15710_0,,,,2,2,1,3
C1(COCC1(C(C(C=C)=O)O)O)=O,,,4,1,2,0,2
15710_1,,,,2,2,1,3
15712_0,,,,2,2,1,3
C(C(C=C)(C1(C(COC1)=O)O)O)=O,,,4,1,2,0,2
15712_1,,,,2,2,1,3
15714_0,,,,2,2,1,3
C1(C(C(CO1)O)C(C=C)(CO)O)=O,,,4,1,1,0,1
15716_0,,,,2,2,1,3
C1(COCC1(C(C=C)(CO)O)O)=O,,,4,1,2,0,2
15716_1,,,,2,2,1,3
15718_0,,,,2,2,1,3
C1(C(C(CO1)O)C(C=CC=O)O)=O,,,4,1,1,0,1
15720_0,,,,2,2,1,3
C1(COCC1(C(C=CC=O)O)O)=O,,,4,1,2,0,2
15720_1,,,,2,2,1,3
15722_0,,,,2,2,1,3
C1(C(C(CO1)O)(C(C(C)O)O)O)=O,,,4,1,2,0,2
15722_1,,,,2,2,1,3
15724_0,,,,2,2,1,3
C1(C(C(CO1)O)C(C(C)O)O)=O,,,4,1,1,0,1
15726_0,,,,2,2,1,3
C(C(C(C)O)(C(C(C)O)O)O)(O)=O,,,4,1,2,0,2
15726_1,,,,2,2,1,3
15728_0,,,,2,2,1,3
C1(COCC1(C(C(C)O)O)O)=O,,,4,1,2,0,2
15728_1,,,,2,2,1,3
15730_0,,,,2,2,1,3
C1(C(O)OCC1(C(C(C)O)O)O)=O,,,4,1,2,0,2
15730_1,,,,2,2,1,3
15731_0,,,,2,2,1,3
15731_1,,,,2,2,1,3
15733_0,,,,2,2,1,3
C(CO)(C(C(CO)O)(C(C)O)O)=O,,,4,1,4,0,4
15733_1,,,,2,2,1,3
15735_0,,,,2,2,1,3
C(C(C(CO)=O)(CO)C(CO)O)=O,,,4,1,2,0,2
15736_0,,,,2,2,1,3
15736_1,,,,2,2,1,3
15737_0,,,,2,2,1,3
15737_1,,,,2,2,1,3
15738_0,,,,2,2,1,3
15738_1,,,,2,2,1,3
15740_0,,,,2,2,1,3
C(C(C(CO)(CO)C(CO)O)=O)=O,,,4,1,2,0,2
15742_0,,,,2,2,1,3
C(CO)(C(CO)(CO)C(CO)O)=O,,,4,1,2,0,2
15744_0,,,,2,2,1,3
C(C(CO)(C(CO)O)C(C=O)O)=O,,,4,1,2,0,2
15745_0,,,,2,2,1,3
15745_1,,,,2,2,1,3
15746_0,,,,2,2,1,3
15746_1,,,,2,2,1,3
15748_0,,,,2,2,1,3
C(C(C(C(CO)O)(C(C)O)O)=O)=O,,,4,1,4,0,4
15748_1,,,,2,2,1,3
15749_0,,,,2,2,1,3
15749_1,,,,2,2,1,3
15750_0,,,,2,2,1,3
15750_1,,,,2,2,1,3
15751_0,,,,2,2,1,3
15751_1,,,,2,2,1,3
15752_0,,,,2,2,1,3
15752_1,,,,2,2,1,3
15753_0,,,,2,2,1,3
15753_1,,,,2,2,1,3
15754_0,,,,2,2,1,3
15754_1,,,,2,2,1,3
15755_0,,,,2,2,1,3
15755_1,,,,2,2,1,3
15756_0,,,,2,2,1,3
15756_1,,,,2,2,1,3
15757_0,,,,2,2,1,3
15757_1,,,,2,2,1,3
15758_0,,,,2,2,1,3
15758_1,,,,2,2,1,3
15759_0,,,,2,2,1,3
15759_1,,,,2,2,1,3
15760_0,,,,2,2,1,3
15762_0,,,,2,2,1,3
C(C)(C(C(C=O)=O)(C(CO)O)O)=O,,,4,1,3,0,3
15762_1,,,,2,2,1,3
15763_0,,,,2,2,1,3
15763_1,,,,2,2,1,3
15765_0,,,,2,2,1,3
C1(C(C(CO)O)(C(CO1)O)O)=O,,,4,1,3,0,3
15765_1,,,,2,2,1,3
15767_0,,,,2,2,1,3
C1(C(C(CO)O)C(CO1)O)=O,,,4,1,2,0,2
15768_0,,,,2,2,1,3
15768_1,,,,2,2,1,3
15769_0,,,,2,2,1,3
15769_1,,,,2,2,1,3
15770_0,,,,2,2,1,3
15770_1,,,,2,2,1,3
15772_0,,,,2,2,1,3
C1(COCC1(C(CO)O)O)=O,,,4,1,2,0,2
15772_1,,,,2,2,1,3
15774_0,,,,2,2,1,3
C1(C(O)OCC1(C(CO)O)O)=O,,,4,1,3,0,3
15774_1,,,,2,2,1,3
15776_0,,,,2,2,1,3
C(C(C(CO)O)(C(CCO)O)O)=O,,,4,1,2,0,2
15776_1,,,,2,2,1,3
15777_0,,,,2,2,1,3
15777_1,,,,2,2,1,3
15778_0,,,,2,2,1,3
15778_1,,,,2,2,1,3
15779_0,,,,2,2,1,3
15779_1,,,,2,2,1,3
15781_0,,,,2,2,1,3
C(C(C(CO)O)(C(C(C)O)O)O)=O,,,4,1,2,0,2
15781_1,,,,2,2,1,3
15783_0,,,,2,2,1,3
C(C(C(C)O)(C(CO)(CO)O)O)=O,,,4,1,4,0,4
15783_1,,,,2,2,1,3
15784_0,,,,2,2,1,3
15784_1,,,,2,2,1,3
15785_0,,,,2,2,1,3
15785_1,,,,2,2,1,3
15787_0,,,,2,2,1,3
C1(C(C(CO1)O)C(CO)(CO)O)=O,,,4,1,1,0,1
15789_0,,,,2,2,1,3
C1(COCC1(C(CO)(CO)O)O)=O,,,4,1,2,0,2
15789_1,,,,2,2,1,3
15791_0,,,,2,2,1,3
C(C(CO)(C(CCO)O)O)=O,,,4,1,2,0,2
15791_1,,,,2,2,1,3
15793_0,,,,2,2,1,3
C(C(CO)(C(CC(C)O)O)O)=O,,,4,1,2,0,2
15793_1,,,,2,2,1,3
15795_0,,,,2,2,1,3
C(C(C(C)O)(C(C(CO)O)O)O)=O,,,4,1,6,0,6
15795_1,,,,2,2,1,3
15797_0,,,,2,2,1,3
C(C(CO)(C(C(C(C)O)O)O)O)=O,,,4,1,2,0,2
15797_1,,,,2,2,1,3
15798_0,,,,2,2,1,3
15798_1,,,,2,2,1,3
15799_0,,,,2,2,1,3
15799_1,,,,2,2,1,3
15800_0,,,,2,2,1,3
15800_1,,,,2,2,1,3
15801_0,,,,2,2,1,3
15801_1,,,,2,2,1,3
15802_0,,,,2,2,1,3
15802_1,,,,2,2,1,3
15804_0,,,,2,2,1,3
C(C(C(C)O)(C(C=O)(CO)O)O)=O,,,4,1,8,0,8
15804_1,,,,2,2,1,3
15806_0,,,,2,2,1,3
C(C(CO)(C(CO)(C(C)O)O)O)=O,,,4,1,2,0,2
15806_1,,,,2,2,1,3
15807_0,,,,2,2,1,3
15807_1,,,,2,2,1,3
15808_0,,,,2,2,1,3
15808_1,,,,2,2,1,3
15809_0,,,,2,2,1,3
15809_1,,,,2,2,1,3
15810_0,,,,2,2,1,3
15810_1,,,,2,2,1,3
15811_0,,,,2,2,1,3
15811_1,,,,2,2,1,3
15812_0,,,,2,2,1,3
15812_1,,,,2,2,1,3
15813_0,,,,2,2,1,3
15813_1,,,,2,2,1,3
15814_0,,,,2,2,1,3
15814_1,,,,2,2,1,3
15815_0,,,,2,2,1,3
15815_1,,,,2,2,1,3
15816_0,,,,2,2,1,3
15816_1,,,,2,2,1,3
15817_0,,,,2,2,1,3
15817_1,,,,2,2,1,3
15819_0,,,,2,2,1,3
C(C(CO)(C(C(C)=O)(C)O)O)=O,,,4,1,3,0,3
15819_1,,,,2,2,1,3
15820_0,,,,2,2,1,3
15820_1,,,,2,2,1,3
15822_0,,,,2,2,1,3
C(C(CO)(C(CC(C)=O)O)O)=O,,,4,1,2,0,2
15822_1,,,,2,2,1,3
15824_0,,,,2,2,1,3
C(C(CO)(C1(COC(C1)O)O)O)=O,,,4,1,3,0,3
15824_1,,,,2,2,1,3
15826_0,,,,2,2,1,3
C(C(CO)(C(C)(CCO)O)O)=O,,,4,1,2,0,2
15826_1,,,,2,2,1,3
15827_0,,,,2,2,1,3
15827_1,,,,2,2,1,3
15828_0,,,,2,2,1,3
15828_1,,,,2,2,1,3
15830_0,,,,2,2,1,3
C(C(CO)(C(C(C=O)=O)(C)O)O)=O,,,4,1,4,0,4
15830_1,,,,2,2,1,3
15831_0,,,,2,2,1,3
15831_1,,,,2,2,1,3
15832_0,,,,2,2,1,3
15832_1,,,,2,2,1,3
15833_0,,,,2,2,1,3
15833_1,,,,2,2,1,3
15835_0,,,,2,2,1,3
C(C(C=C)(C(C=O)(CO)O)O)=O,,,4,1,3,0,3
15835_1,,,,2,2,1,3
15837_0,,,,2,2,1,3
C(C(CO)(C(C=C)(CO)O)O)=O,,,4,1,3,0,3
15837_1,,,,2,2,1,3
15838_0,,,,2,2,1,3
15838_1,,,,2,2,1,3
15840_0,,,,2,2,1,3
C1(C(C(CO1)O)C(C(CO)O)O)=O,,,4,1,1,0,1
15842_0,,,,2,2,1,3
C(C(CO)(C(C(C)O)O)O)=O,,,4,1,2,0,2
15842_1,,,,2,2,1,3
15844_0,,,,2,2,1,3
C1(COCC1(C(C(CO)O)O)O)=O,,,4,1,2,0,2
15844_1,,,,2,2,1,3
15846_0,,,,2,2,1,3
C(C(CO)(C1(COCC1O)O)O)=O,,,4,1,2,0,2
15846_1,,,,2,2,1,3
15848_0,,,,2,2,1,3
C(C(CO)(C1(C(O)OCC1)O)O)=O,,,4,1,3,0,3
15848_1,,,,2,2,1,3
15850_0,,,,2,2,1,3
C(C)(C(C(C)O)(C(C(C)=O)O)O)=O,,,4,1,4,0,4
15850_1,,,,2,2,1,3
15852_0,,,,2,2,1,3
C(C(C)(C(C(C)=O)(C(C)O)O)O)=O,,,4,1,4,0,4
15852_1,,,,2,2,1,3
15853_0,,,,2,2,1,3
15853_1,,,,2,2,1,3
15855_0,,,,2,2,1,3
C(C(C(C)O)(C(C=O)(C)O)O)=O,,,4,1,5,0,5
15855_1,,,,2,2,1,3
15856_0,,,,2,2,1,3
15856_1,,,,2,2,1,3
15857_0,,,,2,2,1,3
15857_1,,,,2,2,1,3
15858_0,,,,2,2,1,3
15858_1,,,,2,2,1,3
15859_0,,,,2,2,1,3
15859_1,,,,2,2,1,3
15860_0,,,,2,2,1,3
15860_1,,,,2,2,1,3
15861_0,,,,2,2,1,3
15861_1,,,,2,2,1,3
15862_0,,,,2,2,1,3
15862_1,,,,2,2,1,3
15863_0,,,,2,2,1,3
15863_1,,,,2,2,1,3
15864_0,,,,2,2,1,3
15865_0,,,,2,2,1,3
15867_0,,,,2,2,1,3
C(C(C(C=O)=O)(C(C(C)=O)O)O)=O,,,4,1,3,0,3
15867_1,,,,2,2,1,3
15869_0,,,,2,2,1,3
C(C(C(C=O)=O)(C(C=O)(C)O)O)=O,,,4,1,3,0,3
15869_1,,,,2,2,1,3
15871_0,,,,2,2,1,3
C1(C(C(CO1)O)(C(C(C)=O)O)O)=O,,,4,1,2,0,2
15871_1,,,,2,2,1,3
15873_0,,,,2,2,1,3
C1(C(C(CO1)O)(C(C=O)(C)O)O)=O,,,4,1,2,0,2
15873_1,,,,2,2,1,3
15875_0,,,,2,2,1,3
C1(C(C(CO1)O)C(C(C)=O)O)=O,,,4,1,1,0,1
15877_0,,,,2,2,1,3
C1(C(C(CO1)O)C(C=O)(C)O)=O,,,4,1,1,0,1
15878_0,,,,2,2,1,3
15878_1,,,,2,2,1,3
15880_0,,,,2,2,1,3
C(C(C(C)O)(C(C=O)(C)O)O)(O)=O,,,4,1,4,0,4
15880_1,,,,2,2,1,3
15882_0,,,,2,2,1,3
C1(COCC1(C(C(C)=O)O)O)=O,,,4,1,2,0,2
15882_1,,,,2,2,1,3
15884_0,,,,2,2,1,3
C(C(C)(C1(C(COC1)=O)O)O)=O,,,4,1,2,0,2
15884_1,,,,2,2,1,3
15886_0,,,,2,2,1,3
C(C(C1(C(C(O)OC1)=O)O)O)(C)=O,,,4,1,3,0,3
15886_1,,,,2,2,1,3
15888_0,,,,2,2,1,3
C(C(C)(C1(C(C(O)OC1)=O)O)O)=O,,,4,1,3,0,3
15888_1,,,,2,2,1,3
15890_0,,,,2,2,1,3
C(C(C(C)=O)(C(CCO)O)O)=O,,,4,1,2,0,2
15890_1,,,,2,2,1,3
15892_0,,,,2,2,1,3
C(C(C(C)=O)(C(CC(C)O)O)O)=O,,,4,1,2,0,2
15892_1,,,,2,2,1,3
15894_0,,,,2,2,1,3
C(CC(C(C=O)(C(C)=O)O)O)=O,,,4,1,3,0,3
15894_1,,,,2,2,1,3
15895_0,,,,2,2,1,3
15895_1,,,,2,2,1,3
15897_0,,,,2,2,1,3
C(C(C=O)(C(C)=O)O)(O)=O,,,4,1,2,0,2
15897_1,,,,2,2,1,3
15898_0,,,,2,2,1,3
15898_1,,,,2,2,1,3
15900_0,,,,2,2,1,3
C(C(C(C)=O)(C(C(C)=O)(C)O)O)=O,,,4,1,2,0,2
15900_1,,,,2,2,1,3
15902_0,,,,2,2,1,3
C(CC(C)(C(C=O)(C(C)=O)O)O)=O,,,4,1,2,0,2
15902_1,,,,2,2,1,3
15904_0,,,,2,2,1,3
C(C(C(C)=O)(C(CC(C)=O)O)O)=O,,,4,1,2,0,2
15904_1,,,,2,2,1,3
15906_0,,,,2,2,1,3
C(C(C(C)=O)(C(C)(CCO)O)O)=O,,,4,1,2,0,2
15906_1,,,,2,2,1,3
15907_0,,,,2,2,1,3
15907_1,,,,2,2,1,3
15909_0,,,,2,2,1,3
C(C(C=O)(C(C=O)(C(C)=O)O)O)=O,,,4,1,4,0,4
15909_1,,,,2,2,1,3
15910_0,,,,2,2,1,3
15910_1,,,,2,2,1,3
15912_0,,,,2,2,1,3
C(C(C=C)(C(C=O)(C(C)=O)O)O)=O,,,4,1,2,0,2
15912_1,,,,2,2,1,3
15914_0,,,,2,2,1,3
C(C(C(C)=O)(C(C=C)(CO)O)O)=O,,,4,1,2,0,2
15914_1,,,,2,2,1,3
15916_0,,,,2,2,1,3
C(C(C(C)=O)(C(C=CC=O)O)O)=O,,,4,1,2,0,2
15916_1,,,,2,2,1,3
15918_0,,,,2,2,1,3
C(C(C(C)=O)(C(C(C)O)O)O)=O,,,4,1,2,0,2
15918_1,,,,2,2,1,3
15919_0,,,,2,2,1,3
15919_1,,,,2,2,1,3
15921_0,,,,2,2,1,3
C(CO)(C(C(C)O)(C(C=O)O)O)=O,,,4,1,4,0,4
15921_1,,,,2,2,1,3
15923_0,,,,2,2,1,3
C(CO)(C(C=O)(CO)C(C=O)O)=O,,,4,1,2,0,2
15925_0,,,,2,2,1,3
C(C(CO)(C(C=O)O)O)(CC=O)=O,,,4,1,4,0,4
15925_1,,,,2,2,1,3
15926_0,,,,2,2,1,3
15926_1,,,,2,2,1,3
15927_0,,,,2,2,1,3
15927_1,,,,2,2,1,3
15929_0,,,,2,2,1,3
C(C(C(C(C=O)=O)(CO)CO)O)=O,,,4,1,2,0,2
15930_0,,,,2,2,1,3
15932_0,,,,2,2,1,3
C(C(CO)(C(C=O)O)C(C=O)O)=O,,,4,1,2,0,2
15933_0,,,,2,2,1,3
15933_1,,,,2,2,1,3
15934_0,,,,2,2,1,3
15934_1,,,,2,2,1,3
15936_0,,,,2,2,1,3
C(C(C(C(C=O)=O)(C(C)O)O)O)=O,,,4,1,4,0,4
15936_1,,,,2,2,1,3
15937_0,,,,2,2,1,3
15937_1,,,,2,2,1,3
15938_0,,,,2,2,1,3
15938_1,,,,2,2,1,3
15939_0,,,,2,2,1,3
15939_1,,,,2,2,1,3
15940_0,,,,2,2,1,3
15940_1,,,,2,2,1,3
15941_0,,,,2,2,1,3
15941_1,,,,2,2,1,3
15942_0,,,,2,2,1,3
15942_1,,,,2,2,1,3
15943_0,,,,2,2,1,3
15943_1,,,,2,2,1,3
15944_0,,,,2,2,1,3
15944_1,,,,2,2,1,3
15945_0,,,,2,2,1,3
15945_1,,,,2,2,1,3
15946_0,,,,2,2,1,3
15946_1,,,,2,2,1,3
15947_0,,,,2,2,1,3
15947_1,,,,2,2,1,3
15948_0,,,,2,2,1,3
15950_0,,,,2,2,1,3
C(C(C(C(C)=O)(C(C=O)=O)O)O)=O,,,4,1,3,0,3
15950_1,,,,2,2,1,3
15952_0,,,,2,2,1,3
C(C(C(C=O)=O)(C(C=O)O)O)=O,,,4,1,3,0,3
15952_1,,,,2,2,1,3
15954_0,,,,2,2,1,3
C1(C(C(CO1)O)(C(C=O)O)O)=O,,,4,1,3,0,3
15954_1,,,,2,2,1,3
15956_0,,,,2,2,1,3
C1(C(C(CO1)O)C(C=O)O)=O,,,4,1,1,0,1
15957_0,,,,2,2,1,3
15957_1,,,,2,2,1,3
15958_0,,,,2,2,1,3
15958_1,,,,2,2,1,3
15959_0,,,,2,2,1,3
15959_1,,,,2,2,1,3
15961_0,,,,2,2,1,3
C1(COCC1(C(C=O)O)O)=O,,,4,1,2,0,2
15961_1,,,,2,2,1,3
15963_0,,,,2,2,1,3
C1(C(O)OCC1(C(C=O)O)O)=O,,,4,1,3,0,3
15963_1,,,,2,2,1,3
15965_0,,,,2,2,1,3
C(C)(C(CO)(C(CCO)O)O)=O,,,4,1,2,0,2
15965_1,,,,2,2,1,3
15967_0,,,,2,2,1,3
C(C)(C(CO)(C(CC(C)O)O)O)=O,,,4,1,2,0,2
15967_1,,,,2,2,1,3
15968_0,,,,2,2,1,3
15968_1,,,,2,2,1,3
15969_0,,,,2,2,1,3
15969_1,,,,2,2,1,3
15970_0,,,,2,2,1,3
15970_1,,,,2,2,1,3
15971_0,,,,2,2,1,3
15971_1,,,,2,2,1,3
15973_0,,,,2,2,1,3
C(C)(C(CO)(C(C(C)=O)(C)O)O)=O,,,4,1,2,0,2
15973_1,,,,2,2,1,3
15975_0,,,,2,2,1,3
C(CC(C)(C(C(C)=O)(CO)O)O)=O,,,4,1,2,0,2
15975_1,,,,2,2,1,3
15977_0,,,,2,2,1,3
C(C)(C(CO)(C(CC(C)=O)O)O)=O,,,4,1,2,0,2
15977_1,,,,2,2,1,3
15979_0,,,,2,2,1,3
C(C)(C(CO)(C(C)(CCO)O)O)=O,,,4,1,2,0,2
15979_1,,,,2,2,1,3
15980_0,,,,2,2,1,3
15980_1,,,,2,2,1,3
15982_0,,,,2,2,1,3
C(C(C=O)(C(C(C)=O)(CO)O)O)=O,,,4,1,6,0,6
15982_1,,,,2,2,1,3
15983_0,,,,2,2,1,3
15983_1,,,,2,2,1,3
15985_0,,,,2,2,1,3
C(C(C=C)(C(C(C)=O)(CO)O)O)=O,,,4,1,2,0,2
15985_1,,,,2,2,1,3
15987_0,,,,2,2,1,3
C(C)(C(CO)(C(C=C)(CO)O)O)=O,,,4,1,2,0,2
15987_1,,,,2,2,1,3
15989_0,,,,2,2,1,3
C(C)(C(CO)(C(C=CC=O)O)O)=O,,,4,1,2,0,2
15989_1,,,,2,2,1,3
15991_0,,,,2,2,1,3
C(C)(C(CO)(C(C(C)O)O)O)=O,,,4,1,2,0,2
15991_1,,,,2,2,1,3
15992_0,,,,2,2,1,3
15992_1,,,,2,2,1,3
15993_0,,,,2,2,1,3
15993_1,,,,2,2,1,3
15994_0,,,,2,2,1,3
15994_1,,,,2,2,1,3
15995_0,,,,2,2,1,3
15995_1,,,,2,2,1,3
15996_0,,,,2,2,1,3
15996_1,,,,2,2,1,3
15997_0,,,,2,2,1,3
15997_1,,,,2,2,1,3
15998_0,,,,2,2,1,3
15998_1,,,,2,2,1,3
15999_0,,,,2,2,1,3
15999_1,,,,2,2,1,3
16000_0,,,,2,2,1,3
16001_0,,,,2,2,1,3
16001_1,,,,2,2,1,3
16002_0,,,,2,2,1,3
16002_1,,,,2,2,1,3
16003_0,,,,2,2,1,3
16004_0,,,,2,2,1,3
16005_0,,,,2,2,1,3
16005_1,,,,2,2,1,3
16006_0,,,,2,2,1,3
16006_1,,,,2,2,1,3
16007_0,,,,2,2,1,3
16008_0,,,,2,2,1,3
16008_1,,,,2,2,1,3
16009_0,,,,2,2,1,3
16010_0,,,,2,2,1,3
16011_0,,,,2,2,1,3
16011_1,,,,2,2,1,3
16012_0,,,,2,2,1,3
16013_0,,,,2,2,1,3
16013_1,,,,2,2,1,3
16014_0,,,,2,2,1,3
16014_1,,,,2,2,1,3
16015_0,,,,2,2,1,3
16015_1,,,,2,2,1,3
16016_0,,,,2,2,1,3
16016_1,,,,2,2,1,3
16017_0,,,,2,2,1,3
16017_1,,,,2,2,1,3
16018_0,,,,2,2,1,3
16019_0,,,,2,2,1,3
16019_1,,,,2,2,1,3
16020_0,,,,2,2,1,3
16020_1,,,,2,2,1,3
16021_0,,,,2,2,1,3
16021_1,,,,2,2,1,3
16022_0,,,,2,2,1,3
16022_1,,,,2,2,1,3
16023_0,,,,2,2,1,3
16023_1,,,,2,2,1,3
16024_0,,,,2,2,1,3
16024_1,,,,2,2,1,3
16025_0,,,,2,2,1,3
16025_1,,,,2,2,1,3
16026_0,,,,2,2,1,3
16026_1,,,,2,2,1,3
16027_0,,,,2,2,1,3
16027_1,,,,2,2,1,3
16028_0,,,,2,2,1,3
16028_1,,,,2,2,1,3
16029_0,,,,2,2,1,3
16029_1,,,,2,2,1,3
16030_0,,,,2,2,1,3
16031_0,,,,2,2,1,3
16031_1,,,,2,2,1,3
16032_0,,,,2,2,1,3
16032_1,,,,2,2,1,3
16034_0,,,,2,2,1,3
C(C(C(CO)=O)(CO)CO)=O,,,4,1,1,0,1
16036_0,,,,2,2,1,3
C(CC(C(CO)(CO)O)=O)=O,,,4,1,2,0,2
16036_1,,,,2,2,1,3
16038_0,,,,2,2,1,3
C(C(C(CO)=O)(CO)C(C)O)=O,,,4,1,2,0,2
16040_0,,,,2,2,1,3
C(CC(C(CO)(C(C)O)O)=O)=O,,,4,1,4,0,4
16040_1,,,,2,2,1,3
16041_0,,,,2,2,1,3
16041_1,,,,2,2,1,3
16042_0,,,,2,2,1,3
16042_1,,,,2,2,1,3
16043_0,,,,2,2,1,3
16043_1,,,,2,2,1,3
16044_0,,,,2,2,1,3
16044_1,,,,2,2,1,3
16045_0,,,,2,2,1,3
16045_1,,,,2,2,1,3
16046_0,,,,2,2,1,3
16047_0,,,,2,2,1,3
16048_0,,,,2,2,1,3
16049_0,,,,2,2,1,3
16049_1,,,,2,2,1,3
16050_0,,,,2,2,1,3
16050_1,,,,2,2,1,3
16051_0,,,,2,2,1,3
16051_1,,,,2,2,1,3
16052_0,,,,2,2,1,3
16052_1,,,,2,2,1,3
16054_0,,,,2,2,1,3
C(C(C(CO)(CO)CO)=O)=O,,,4,1,1,0,1
16056_0,,,,2,2,1,3
C(CO)(C(CO)(CO)CO)=O,,,4,1,1,0,1
16058_0,,,,2,2,1,3
C(C(CO)(CO)C(C=O)O)=O,,,4,1,1,0,1
16059_0,,,,2,2,1,3
16059_1,,,,2,2,1,3
16061_0,,,,2,2,1,3
C(C(C(CO)(CO)C(C)O)=O)=O,,,4,1,2,0,2
16062_0,,,,2,2,1,3
16062_1,,,,2,2,1,3
16064_0,,,,2,2,1,3
C(CO)(C(CO)(CO)C(C)O)=O,,,4,1,2,0,2
16065_0,,,,2,2,1,3
16065_1,,,,2,2,1,3
16066_0,,,,2,2,1,3
16066_1,,,,2,2,1,3
16067_0,,,,2,2,1,3
16067_1,,,,2,2,1,3
16068_0,,,,2,2,1,3
16068_1,,,,2,2,1,3
16069_0,,,,2,2,1,3
16069_1,,,,2,2,1,3
16071_0,,,,2,2,1,3
C(C(CO)(C(C)O)C(C=O)O)=O,,,4,1,2,0,2
16072_0,,,,2,2,1,3
16072_1,,,,2,2,1,3
16073_0,,,,2,2,1,3
16073_1,,,,2,2,1,3
16074_0,,,,2,2,1,3
16074_1,,,,2,2,1,3
16075_0,,,,2,2,1,3
16075_1,,,,2,2,1,3
16076_0,,,,2,2,1,3
16076_1,,,,2,2,1,3
16077_0,,,,2,2,1,3
16077_1,,,,2,2,1,3
16078_0,,,,2,2,1,3
16078_1,,,,2,2,1,3
16079_0,,,,2,2,1,3
16079_1,,,,2,2,1,3
16080_0,,,,2,2,1,3
16081_0,,,,2,2,1,3
16081_1,,,,2,2,1,3
16082_0,,,,2,2,1,3
16082_1,,,,2,2,1,3
16083_0,,,,2,2,1,3
16083_1,,,,2,2,1,3
16084_0,,,,2,2,1,3
16085_0,,,,2,2,1,3
16085_1,,,,2,2,1,3
16086_0,,,,2,2,1,3
16087_0,,,,2,2,1,3
16087_1,,,,2,2,1,3
16088_0,,,,2,2,1,3
16088_1,,,,2,2,1,3
16089_0,,,,2,2,1,3
16089_1,,,,2,2,1,3
16090_0,,,,2,2,1,3
16091_0,,,,2,2,1,3
16091_1,,,,2,2,1,3
16092_0,,,,2,2,1,3
16092_1,,,,2,2,1,3
16093_0,,,,2,2,1,3
16093_1,,,,2,2,1,3
16094_0,,,,2,2,1,3
16094_1,,,,2,2,1,3
16095_0,,,,2,2,1,3
16095_1,,,,2,2,1,3
16096_0,,,,2,2,1,3
16096_1,,,,2,2,1,3
16097_0,,,,2,2,1,3
16097_1,,,,2,2,1,3
16098_0,,,,2,2,1,3
16098_1,,,,2,2,1,3
16099_0,,,,2,2,1,3
16099_1,,,,2,2,1,3
16100_0,,,,2,2,1,3
16100_1,,,,2,2,1,3
16101_0,,,,2,2,1,3
16101_1,,,,2,2,1,3
16102_0,,,,2,2,1,3
16102_1,,,,2,2,1,3
16103_0,,,,2,2,1,3
16104_0,,,,2,2,1,3
16104_1,,,,2,2,1,3
16105_0,,,,2,2,1,3
16105_1,,,,2,2,1,3
16107_0,,,,2,2,1,3
C(C(C(OCC(C)=O)O)(CO)O)=O,,,4,1,2,0,2
16107_1,,,,2,2,1,3
16109_0,,,,2,2,1,3
C(C(CO)(CO)OCC(CO)=O)=O,,,4,1,2,0,2
16109_1,,,,2,2,1,3
16111_0,,,,2,2,1,3
C(C(CO)(CO)OC(C(C)=O)O)=O,,,4,1,2,0,2
16111_1,,,,2,2,1,3
16112_0,,,,2,2,1,3
16112_1,,,,2,2,1,3
16113_0,,,,2,2,1,3
16113_1,,,,2,2,1,3
16115_0,,,,2,2,1,3
C(C(CO)(COCC(CO)=O)O)=O,,,4,1,2,0,2
16115_1,,,,2,2,1,3
16117_0,,,,2,2,1,3
C(C(CO)(COC(C(C)=O)O)O)=O,,,4,1,2,0,2
16117_1,,,,2,2,1,3
16118_0,,,,2,2,1,3
16118_1,,,,2,2,1,3
16119_0,,,,2,2,1,3
16119_1,,,,2,2,1,3
16120_0,,,,2,2,1,3
16120_1,,,,2,2,1,3
16121_0,,,,2,2,1,3
16121_1,,,,2,2,1,3
16122_0,,,,2,2,1,3
16122_1,,,,2,2,1,3
16124_0,,,,2,2,1,3
C1(C(CO)(C(CO1)O)O)=O,,,4,1,3,0,3
16124_1,,,,2,2,1,3
16126_0,,,,2,2,1,3
C1(C(CO)C(CO1)O)=O,,,4,1,1,0,1
16128_0,,,,2,2,1,3
C(C(CO)(C(C)(OCC=O)O)O)=O,,,4,1,2,0,2
16128_1,,,,2,2,1,3
16129_0,,,,2,2,1,3
16129_1,,,,2,2,1,3
16130_0,,,,2,2,1,3
16130_1,,,,2,2,1,3
16132_0,,,,2,2,1,3
C(C(CCO)=O)(C(CO)(CO)O)=O,,,4,1,3,0,3
16132_1,,,,2,2,1,3
16133_0,,,,2,2,1,3
16133_1,,,,2,2,1,3
16135_0,,,,2,2,1,3
C(C(CO)(CO)O)(C(C(C)=O)O)=O,,,4,1,3,0,3
16135_1,,,,2,2,1,3
16136_0,,,,2,2,1,3
16136_1,,,,2,2,1,3
16137_0,,,,2,2,1,3
16137_1,,,,2,2,1,3
16138_0,,,,2,2,1,3
16138_1,,,,2,2,1,3
16140_0,,,,2,2,1,3
C(C(C(C(CO)(C(C)O)O)=O)O)=O,,,4,1,3,0,3
16140_1,,,,2,2,1,3
16141_0,,,,2,2,1,3
16141_1,,,,2,2,1,3
16142_0,,,,2,2,1,3
16142_1,,,,2,2,1,3
16143_0,,,,2,2,1,3
16143_1,,,,2,2,1,3
16145_0,,,,2,2,1,3
C1(C(C(CO)O)OCC1(CO)O)=O,,,4,1,2,0,2
16145_1,,,,2,2,1,3
16147_0,,,,2,2,1,3
C1(C(COC1(CO)C(CO)O)O)=O,,,4,1,2,0,2
16147_1,,,,2,2,1,3
16149_0,,,,2,2,1,3
C1(C(C(CO)OCC1(CO)O)O)=O,,,4,1,2,0,2
16149_1,,,,2,2,1,3
16151_0,,,,2,2,1,3
C1(C(COC(CO)C1(CO)O)O)=O,,,4,1,2,0,2
16151_1,,,,2,2,1,3
16153_0,,,,2,2,1,3
C1(C(CC(OC1(CO)CO)O)O)=O,,,4,1,3,0,3
16153_1,,,,2,2,1,3
16155_0,,,,2,2,1,3
C1(C(C(COCC1(CO)O)O)O)=O,,,4,1,2,0,2
16155_1,,,,2,2,1,3
16157_0,,,,2,2,1,3
C1(C(COCC(C1(CO)O)O)O)=O,,,4,1,2,0,2
16157_1,,,,2,2,1,3
16159_0,,,,2,2,1,3
C1(C(CC(O)OCC1(CO)O)O)=O,,,4,1,3,0,3
16159_1,,,,2,2,1,3
16161_0,,,,2,2,1,3
C1(C(CCOC(C1(CO)O)O)O)=O,,,4,1,3,0,3
16161_1,,,,2,2,1,3
16163_0,,,,2,2,1,3
C(C(C(C(CCO)=O)=O)(CO)O)=O,,,4,1,2,0,2
16163_1,,,,2,2,1,3
16165_0,,,,2,2,1,3
C(C(C(CC(CO)=O)=O)(CO)O)=O,,,4,1,2,0,2
16165_1,,,,2,2,1,3
16167_0,,,,2,2,1,3
C(C(C(C(C(C)=O)O)=O)(CO)O)=O,,,4,1,2,0,2
16167_1,,,,2,2,1,3
16168_0,,,,2,2,1,3
16168_1,,,,2,2,1,3
16169_0,,,,2,2,1,3
16169_1,,,,2,2,1,3
16170_0,,,,2,2,1,3
16170_1,,,,2,2,1,3
16171_0,,,,2,2,1,3
16171_1,,,,2,2,1,3
16172_0,,,,2,2,1,3
16172_1,,,,2,2,1,3
16174_0,,,,2,2,1,3
C(CO)(C1(CO)C(CC(O1)O)O)=O,,,4,1,3,0,3
16174_1,,,,2,2,1,3
16175_0,,,,2,2,1,3
16175_1,,,,2,2,1,3
16176_0,,,,2,2,1,3
16176_1,,,,2,2,1,3
16177_0,,,,2,2,1,3
16177_1,,,,2,2,1,3
16178_0,,,,2,2,1,3
16178_1,,,,2,2,1,3
16179_0,,,,2,2,1,3
16179_1,,,,2,2,1,3
16180_0,,,,2,2,1,3
16180_1,,,,2,2,1,3
16181_0,,,,2,2,1,3
16181_1,,,,2,2,1,3
16182_0,,,,2,2,1,3
16182_1,,,,2,2,1,3
16183_0,,,,2,2,1,3
16184_0,,,,2,2,1,3
16184_1,,,,2,2,1,3
16185_0,,,,2,2,1,3
16186_0,,,,2,2,1,3
16186_1,,,,2,2,1,3
16187_0,,,,2,2,1,3
16187_1,,,,2,2,1,3
16188_0,,,,2,2,1,3
16188_1,,,,2,2,1,3
16189_0,,,,2,2,1,3
16189_1,,,,2,2,1,3
16190_0,,,,2,2,1,3
16190_1,,,,2,2,1,3
16191_0,,,,2,2,1,3
16191_1,,,,2,2,1,3
16192_0,,,,2,2,1,3
16192_1,,,,2,2,1,3
16193_0,,,,2,2,1,3
16193_1,,,,2,2,1,3
16194_0,,,,2,2,1,3
16194_1,,,,2,2,1,3
16195_0,,,,2,2,1,3
16195_1,,,,2,2,1,3
16197_0,,,,2,2,1,3
C1(C(CO)(C(C(C1)=O)(CO)O)O)=O,,,4,1,2,0,2
16197_1,,,,2,2,1,3
16198_0,,,,2,2,1,3
16198_1,,,,2,2,1,3
16199_0,,,,2,2,1,3
16199_1,,,,2,2,1,3
16200_0,,,,2,2,1,3
16200_1,,,,2,2,1,3
16201_0,,,,2,2,1,3
16201_1,,,,2,2,1,3
16203_0,,,,2,2,1,3
C1(C(CO)(C(C(C1(C)O)O)O)O)=O,,,4,1,3,0,3
16203_1,,,,2,2,1,3
16204_0,,,,2,2,1,3
16204_1,,,,2,2,1,3
16205_0,,,,2,2,1,3
16205_1,,,,2,2,1,3
16206_0,,,,2,2,1,3
16206_1,,,,2,2,1,3
16207_0,,,,2,2,1,3
16207_1,,,,2,2,1,3
16208_0,,,,2,2,1,3
16208_1,,,,2,2,1,3
16209_0,,,,2,2,1,3
16209_1,,,,2,2,1,3
16210_0,,,,2,2,1,3
16210_1,,,,2,2,1,3
16211_0,,,,2,2,1,3
16211_1,,,,2,2,1,3
16212_0,,,,2,2,1,3
16212_1,,,,2,2,1,3
16213_0,,,,2,2,1,3
16213_1,,,,2,2,1,3
16214_0,,,,2,2,1,3
16214_1,,,,2,2,1,3
16216_0,,,,2,2,1,3
C1(CC(C(C1(CO)CO)=O)O)=O,,,4,1,2,0,2
16217_0,,,,2,2,1,3
16217_1,,,,2,2,1,3
16219_0,,,,2,2,1,3
C1(C(CO)(CO)CC(C1O)=O)=O,,,4,1,2,0,2
16221_0,,,,2,2,1,3
C(C(C)=O)(C(CO)(C(CO)O)O)=O,,,4,1,2,0,2
16221_1,,,,2,2,1,3
16223_0,,,,2,2,1,3
C1(C(CO)C(C(C(C)=O)O1)O)=O,,,4,1,2,0,2
16225_0,,,,2,2,1,3
C1(CC(C(C(C)=O)(CO)O1)O)=O,,,4,1,3,0,3
16225_1,,,,2,2,1,3
16227_0,,,,2,2,1,3
C1(C(CO)C(C(CC=O)O1)O)=O,,,4,1,2,0,2
16229_0,,,,2,2,1,3
C1(COC(C(C)=O)C1(CO)O)=O,,,4,1,3,0,3
16229_1,,,,2,2,1,3
16231_0,,,,2,2,1,3
C(C)(C1(CO)C(C(CO1)=O)O)=O,,,4,1,3,0,3
16231_1,,,,2,2,1,3
16233_0,,,,2,2,1,3
C(CC1C(C(CO1)=O)(CO)O)=O,,,4,1,3,0,3
16233_1,,,,2,2,1,3
16235_0,,,,2,2,1,3
C1(CC(OC1(C(C)=O)CO)O)=O,,,4,1,5,0,5
16235_1,,,,2,2,1,3
16237_0,,,,2,2,1,3
C1(CCC(OC1(CO)CO)=O)=O,,,4,1,3,0,3
16237_1,,,,2,2,1,3
16239_0,,,,2,2,1,3
C1(C(CO)(CO)OCC(C1)=O)=O,,,4,1,3,0,3
16239_1,,,,2,2,1,3
16241_0,,,,2,2,1,3
C1(CCC(OCC1(CO)O)=O)=O,,,4,1,3,0,3
16241_1,,,,2,2,1,3
16243_0,,,,2,2,1,3
C1(C(CO)C(C(CCO1)=O)O)=O,,,4,1,2,0,2
16245_0,,,,2,2,1,3
C1(C(CO)C(CC(CO1)=O)O)=O,,,4,1,2,0,2
16247_0,,,,2,2,1,3
C1(C(CO)(COCC(C1)=O)O)=O,,,4,1,3,0,3
16247_1,,,,2,2,1,3
16249_0,,,,2,2,1,3
C1(CCOCC(C1(CO)O)=O)=O,,,4,1,4,0,4
16249_1,,,,2,2,1,3
16251_0,,,,2,2,1,3
C1(COCC1(CO)O)=O,,,4,1,2,0,2
16251_1,,,,2,2,1,3
16253_0,,,,2,2,1,3
C(C1(CO)C(C(C(CO)O1)O)O)=O,,,4,1,2,0,2
16253_1,,,,2,2,1,3
16255_0,,,,2,2,1,3
C1(C(C(CO)OC1(CO)CO)O)=O,,,4,1,2,0,2
16255_1,,,,2,2,1,3
16257_0,,,,2,2,1,3
C1(C(CO)OC(CO)C1(CO)O)=O,,,4,1,2,0,2
16257_1,,,,2,2,1,3
16259_0,,,,2,2,1,3
C1(CC(CO)(OC1(CO)CO)O)=O,,,4,1,3,0,3
16259_1,,,,2,2,1,3
16261_0,,,,2,2,1,3
C(CC1C(C(CO)(CO1)O)=O)=O,,,4,1,2,0,2
16261_1,,,,2,2,1,3
16263_0,,,,2,2,1,3
C(C1(CO)C(CC(C=O)O1)O)=O,,,4,1,3,0,3
16263_1,,,,2,2,1,3
16265_0,,,,2,2,1,3
C(C1(C(CC(C)(O1)O)=O)CO)=O,,,4,1,4,0,4
16265_1,,,,2,2,1,3
16267_0,,,,2,2,1,3
C(C1(CO)C(C(C(C)O1)=O)O)=O,,,4,1,3,0,3
16267_1,,,,2,2,1,3
16269_0,,,,2,2,1,3
C1(C(CO)(C(C=O)OC1C)O)=O,,,4,1,2,0,2
16269_1,,,,2,2,1,3
16271_0,,,,2,2,1,3
C(C1C(C(C(O1)O)=O)(CO)O)(C)=O,,,4,1,3,0,3
16271_1,,,,2,2,1,3
16273_0,,,,2,2,1,3
C(C)(C1(CO)C(C(C(O1)O)=O)O)=O,,,4,1,3,0,3
16273_1,,,,2,2,1,3
16275_0,,,,2,2,1,3
C(CC1C(C(C(O)O1)=O)(CO)O)=O,,,4,1,3,0,3
16275_1,,,,2,2,1,3
16277_0,,,,2,2,1,3
C(C1(C(C(C(CO)O1)O)=O)CO)=O,,,4,1,2,0,2
16277_1,,,,2,2,1,3
16279_0,,,,2,2,1,3
C(C1C(C(CO)(C(CO)O1)O)=O)=O,,,4,1,2,0,2
16279_1,,,,2,2,1,3
16281_0,,,,2,2,1,3
C1(CC(C=O)(OC1(CO)CO)O)=O,,,4,1,3,0,3
16281_1,,,,2,2,1,3
16283_0,,,,2,2,1,3
C(C1(CO)C(C(C(CO1)O)O)O)=O,,,4,1,2,0,2
16283_1,,,,2,2,1,3
16285_0,,,,2,2,1,3
C1(C(C(COC1(CO)CO)O)O)=O,,,4,1,2,0,2
16285_1,,,,2,2,1,3
16287_0,,,,2,2,1,3
C1(C(CO)OCC(C1(CO)O)O)=O,,,4,1,2,0,2
16287_1,,,,2,2,1,3
16289_0,,,,2,2,1,3
C1(CC(CO)(O)OCC1(CO)O)=O,,,4,1,3,0,3
16289_1,,,,2,2,1,3
16291_0,,,,2,2,1,3
C1(CCOC(CO)(C1(CO)O)O)=O,,,4,1,3,0,3
16291_1,,,,2,2,1,3
16293_0,,,,2,2,1,3
C(C1(C(CCC(O1)O)=O)CO)=O,,,4,1,4,0,4
16293_1,,,,2,2,1,3
16295_0,,,,2,2,1,3
C1(C(CO)(CO)OC(C(C1)=O)O)=O,,,4,1,3,0,3
16295_1,,,,2,2,1,3
16297_0,,,,2,2,1,3
C(C1(C(C(C(CO1)O)O)=O)CO)=O,,,4,1,2,0,2
16297_1,,,,2,2,1,3
16299_0,,,,2,2,1,3
C(C1C(C(CO)(C(CO1)O)O)=O)=O,,,4,1,2,0,2
16299_1,,,,2,2,1,3
16301_0,,,,2,2,1,3
C1(CC(C=O)(O)OCC1(CO)O)=O,,,4,1,3,0,3
16301_1,,,,2,2,1,3
16303_0,,,,2,2,1,3
C1(C(CO)(C(C=O)(O)OCC1)O)=O,,,4,1,3,0,3
16303_1,,,,2,2,1,3
16305_0,,,,2,2,1,3
C1(C(CO)(COC(C(C1)=O)O)O)=O,,,4,1,3,0,3
16305_1,,,,2,2,1,3
16307_0,,,,2,2,1,3
C1(CCOC(C(C1(CO)O)=O)O)=O,,,4,1,3,0,3
16307_1,,,,2,2,1,3
16309_0,,,,2,2,1,3
C1(CC(C(CO)(C(CO)O)O1)=O)=O,,,4,1,2,0,2
16309_1,,,,2,2,1,3
16311_0,,,,2,2,1,3
C1(C(CO)(C(C(C(C)=O)O1)O)O)=O,,,4,1,2,0,2
16311_1,,,,2,2,1,3
16313_0,,,,2,2,1,3
C1(C(C(C(C(C)=O)(CO)O1)O)O)=O,,,4,1,2,0,2
16313_1,,,,2,2,1,3
16315_0,,,,2,2,1,3
C1(C(CO)(C(C(CC=O)O1)O)O)=O,,,4,1,2,0,2
16315_1,,,,2,2,1,3
16317_0,,,,2,2,1,3
C1(CC(C(CO)(C(CO)O1)O)=O)=O,,,4,1,2,0,2
16317_1,,,,2,2,1,3
16319_0,,,,2,2,1,3
C1(C(C(CC(CO)O1)=O)(CO)O)=O,,,4,1,2,0,2
16319_1,,,,2,2,1,3
16321_0,,,,2,2,1,3
C1(CC(C(OC1(CO)CO)=O)O)=O,,,4,1,2,0,2
16321_1,,,,2,2,1,3
16323_0,,,,2,2,1,3
C1(CC(C(CO)(C(CO1)O)O)=O)=O,,,4,1,2,0,2
16323_1,,,,2,2,1,3
16325_0,,,,2,2,1,3
C1(C(C(CC(CO1)O)=O)(CO)O)=O,,,4,1,2,0,2
16325_1,,,,2,2,1,3
16327_0,,,,2,2,1,3
C1(CC(C(OCC1(CO)O)=O)O)=O,,,4,1,2,0,2
16327_1,,,,2,2,1,3
16329_0,,,,2,2,1,3
C1(C(CO)(C(C(CCO1)=O)O)O)=O,,,4,1,2,0,2
16329_1,,,,2,2,1,3
16331_0,,,,2,2,1,3
C1(C(CO)(C(C(OCC1)=O)O)O)=O,,,4,1,2,0,2
16331_1,,,,2,2,1,3
16333_0,,,,2,2,1,3
C1(C(CO)(C(CC(CO1)=O)O)O)=O,,,4,1,2,0,2
16333_1,,,,2,2,1,3
16335_0,,,,2,2,1,3
C1C(C(C(C=1CO)=O)(CO)O)O,,,4,1,3,0,3
16335_1,,,,2,2,1,3
16337_0,,,,2,2,1,3
C=C1C(C(CO)(C(C1O)O)O)=O,,,4,1,3,0,3
16337_1,,,,2,2,1,3
16339_0,,,,2,2,1,3
C(C(CO)(C(C(C=C)O)O)O)=O,,,4,1,3,0,3
16339_1,,,,2,2,1,3
16341_0,,,,2,2,1,3
C1OC(C(C=1)=O)(CO)C(CO)O,,,4,1,3,0,3
16341_1,,,,2,2,1,3
16343_0,,,,2,2,1,3
C1OC(CO)C(C(C=1)=O)(CO)O,,,4,1,3,0,3
16343_1,,,,2,2,1,3
16345_0,,,,2,2,1,3
C1C(OC(C(C=1)=O)(CO)CO)O,,,4,1,3,0,3
16345_1,,,,2,2,1,3
16347_0,,,,2,2,1,3
C1OCC(C(C(C=1)=O)(CO)O)O,,,4,1,3,0,3
16347_1,,,,2,2,1,3
16349_0,,,,2,2,1,3
C1COC(C(C(C=1)=O)(CO)O)O,,,4,1,3,0,3
16349_1,,,,2,2,1,3
16351_0,,,,2,2,1,3
C1C(O)OCC(C(C=1)=O)(CO)O,,,4,1,3,0,3
16351_1,,,,2,2,1,3
16353_0,,,,2,2,1,3
C=CC(C(C(C=O)=O)(CO)O)=O,,,4,1,4,0,4
16353_1,,,,2,2,1,3
16355_0,,,,2,2,1,3
C(C(C1OCC(C=1)O)(CO)O)=O,,,4,1,3,0,3
16355_1,,,,2,2,1,3
16357_0,,,,2,2,1,3
C(C(CO)(C1(C=CCO1)O)O)=O,,,4,1,3,0,3
16357_1,,,,2,2,1,3
16359_0,,,,2,2,1,3
C(C1(CO)C(C=C(CO)O1)O)=O,,,4,1,3,0,3
16359_1,,,,2,2,1,3
16361_0,,,,2,2,1,3
C(C1(CO)C(C(C(O1)=C)O)O)=O,,,4,1,3,0,3
16361_1,,,,2,2,1,3
16363_0,,,,2,2,1,3
C(C(CO)(C1C=CC(O1)O)O)=O,,,4,1,3,0,3
16363_1,,,,2,2,1,3
16365_0,,,,2,2,1,3
C(C(CO)(C1C(C=CO1)O)O)=O,,,4,1,3,0,3
16365_1,,,,2,2,1,3
16367_0,,,,2,2,1,3
C(C1(CO)C(C=CC(O1)O)O)=O,,,4,1,3,0,3
16367_1,,,,2,2,1,3
16369_0,,,,2,2,1,3
C(C1(CO)C(C(C=CO1)O)O)=O,,,4,1,3,0,3
16369_1,,,,2,2,1,3
16371_0,,,,2,2,1,3
C1(COC(CCO)(C1(CO)O)O)=O,,,4,1,3,0,3
16371_1,,,,2,2,1,3
16373_0,,,,2,2,1,3
C1(C(CCO)OC(C1(CO)O)O)=O,,,4,1,3,0,3
16373_1,,,,2,2,1,3
16375_0,,,,2,2,1,3
C(C(CO)(C1(C(CCO1)O)O)O)=O,,,4,1,3,0,3
16375_1,,,,2,2,1,3
16377_0,,,,2,2,1,3
C(C(CO)(C1CC(C(O)O1)O)O)=O,,,4,1,3,0,3
16377_1,,,,2,2,1,3
16379_0,,,,2,2,1,3
C(C(C1(CO)C(CC(O1)O)O)=O)=O,,,4,1,3,0,3
16379_1,,,,2,2,1,3
16381_0,,,,2,2,1,3
C1(C(O)OCC1(CO)O)=O,,,4,1,3,0,3
16381_1,,,,2,2,1,3
16383_0,,,,2,2,1,3
C(C1(CO)C(CC(C(O1)O)O)O)=O,,,4,1,3,0,3
16383_1,,,,2,2,1,3
16385_0,,,,2,2,1,3
C1(COC(C)(C(C1(CO)O)O)O)=O,,,4,1,3,0,3
16385_1,,,,2,2,1,3
16387_0,,,,2,2,1,3
C1(C(C)OC(C(C1(CO)O)O)O)=O,,,4,1,3,0,3
16387_1,,,,2,2,1,3
16389_0,,,,2,2,1,3
C1(COC(CC(C1(CO)O)O)O)=O,,,4,1,3,0,3
16389_1,,,,2,2,1,3
16391_0,,,,2,2,1,3
C(C(CO)(C1C(CC(O1)=O)O)O)=O,,,4,1,2,0,2
16391_1,,,,2,2,1,3
16393_0,,,,2,2,1,3
C1(C(CO)C(C(C(C=O)O)O1)O)=O,,,4,1,1,0,1
16395_0,,,,2,2,1,3
C(C1(CO)C(C(CC(O1)=O)O)O)=O,,,4,1,2,0,2
16395_1,,,,2,2,1,3
16397_0,,,,2,2,1,3
C1(C(CO)C(C(C(C=O)O1)O)O)=O,,,4,1,1,0,1
16398_0,,,,2,2,1,3
16398_1,,,,2,2,1,3
16399_0,,,,2,2,1,3
16399_1,,,,2,2,1,3
16401_0,,,,2,2,1,3
C(C(C=O)(C(CCO)O)O)=O,,,4,1,2,0,2
16401_1,,,,2,2,1,3
16403_0,,,,2,2,1,3
C(C(C=O)(C(CC(C)O)O)O)=O,,,4,1,2,0,2
16403_1,,,,2,2,1,3
16404_0,,,,2,2,1,3
16404_1,,,,2,2,1,3
16406_0,,,,2,2,1,3
C(C(C=O)(C(C(C(C)O)O)O)O)=O,,,4,1,2,0,2
16406_1,,,,2,2,1,3
16407_0,,,,2,2,1,3
16407_1,,,,2,2,1,3
16408_0,,,,2,2,1,3
16408_1,,,,2,2,1,3
16409_0,,,,2,2,1,3
16409_1,,,,2,2,1,3
16410_0,,,,2,2,1,3
16410_1,,,,2,2,1,3
16411_0,,,,2,2,1,3
16411_1,,,,2,2,1,3
16412_0,,,,2,2,1,3
16412_1,,,,2,2,1,3
16414_0,,,,2,2,1,3
C(C(C=O)(C(CO)(C(C)O)O)O)=O,,,4,1,2,0,2
16414_1,,,,2,2,1,3
16416_0,,,,2,2,1,3
C(C(C=O)(C(CC=O)O)O)=O,,,4,1,3,0,3
16416_1,,,,2,2,1,3
16417_0,,,,2,2,1,3
16417_1,,,,2,2,1,3
16418_0,,,,2,2,1,3
16418_1,,,,2,2,1,3
16420_0,,,,2,2,1,3
C(C(C=O)(C=O)O)(O)=O,,,4,1,2,0,2
16420_1,,,,2,2,1,3
16421_0,,,,2,2,1,3
16421_1,,,,2,2,1,3
16422_0,,,,2,2,1,3
16422_1,,,,2,2,1,3
16423_0,,,,2,2,1,3
16423_1,,,,2,2,1,3
16424_0,,,,2,2,1,3
16424_1,,,,2,2,1,3
16425_0,,,,2,2,1,3
16425_1,,,,2,2,1,3
16427_0,,,,2,2,1,3
C(C(C=O)(C(C=O)(CC=O)O)O)=O,,,4,1,3,0,3
16427_1,,,,2,2,1,3
16429_0,,,,2,2,1,3
C(C(C=O)(C(CC(C=O)=O)O)O)=O,,,4,1,3,0,3
16429_1,,,,2,2,1,3
16431_0,,,,2,2,1,3
C(C(C=O)(C(C(C)=O)(C)O)O)=O,,,4,1,3,0,3
16431_1,,,,2,2,1,3
16433_0,,,,2,2,1,3
C(C(C=O)(C(C)(CC=O)O)O)=O,,,4,1,3,0,3
16433_1,,,,2,2,1,3
16435_0,,,,2,2,1,3
C(C(C=O)(C(CC(C)=O)O)O)=O,,,4,1,2,0,2
16435_1,,,,2,2,1,3
16437_0,,,,2,2,1,3
C(C(C=O)(C1(COC(C1)O)O)O)=O,,,4,1,3,0,3
16437_1,,,,2,2,1,3
16439_0,,,,2,2,1,3
C(C(C=O)(C(C)(CCO)O)O)=O,,,4,1,2,0,2
16439_1,,,,2,2,1,3
16440_0,,,,2,2,1,3
16440_1,,,,2,2,1,3
16441_0,,,,2,2,1,3
16441_1,,,,2,2,1,3
16443_0,,,,2,2,1,3
C(C(C=O)(C(C(C=O)=O)(C)O)O)=O,,,4,1,4,0,4
16443_1,,,,2,2,1,3
16444_0,,,,2,2,1,3
16444_1,,,,2,2,1,3
16446_0,,,,2,2,1,3
C(C(C=O)(C(C=O)(C=O)O)O)=O,,,4,1,2,0,2
16446_1,,,,2,2,1,3
16447_0,,,,2,2,1,3
16447_1,,,,2,2,1,3
16449_0,,,,2,2,1,3
C(C(C=O)(C(C=O)(C=C)O)O)=O,,,4,1,3,0,3
16449_1,,,,2,2,1,3
16451_0,,,,2,2,1,3
C(C(C=O)(C(C=C)(CO)O)O)=O,,,4,1,3,0,3
16451_1,,,,2,2,1,3
16453_0,,,,2,2,1,3
C(C(C=O)(C(C=CC=O)O)O)=O,,,4,1,4,0,4
16453_1,,,,2,2,1,3
16455_0,,,,2,2,1,3
C1(C(C(C(C=O)O)O)C(CO1)O)=O,,,4,1,1,0,1
16457_0,,,,2,2,1,3
C(C(C=O)(C(C(C)O)O)O)=O,,,4,1,2,0,2
16457_1,,,,2,2,1,3
16459_0,,,,2,2,1,3
C(C(C(C1(C(COC1)=O)O)O)O)=O,,,4,1,2,0,2
16459_1,,,,2,2,1,3
16461_0,,,,2,2,1,3
C(C(C=O)(C1(COCC1O)O)O)=O,,,4,1,2,0,2
16461_1,,,,2,2,1,3
16463_0,,,,2,2,1,3
C(C(C=O)(C1(C(O)OCC1)O)O)=O,,,4,1,3,0,3
16463_1,,,,2,2,1,3
16465_0,,,,2,2,1,3
C(C)(C(C(C)O)(C(CO)(C)O)O)=O,,,4,1,4,0,4
16465_1,,,,2,2,1,3
16467_0,,,,2,2,1,3
C(C(C(C)O)(C(CO)(C)O)O)=O,,,4,1,4,0,4
16467_1,,,,2,2,1,3
16468_0,,,,2,2,1,3
16468_1,,,,2,2,1,3
16469_0,,,,2,2,1,3
16469_1,,,,2,2,1,3
16470_0,,,,2,2,1,3
16470_1,,,,2,2,1,3
16471_0,,,,2,2,1,3
16471_1,,,,2,2,1,3
16472_0,,,,2,2,1,3
16474_0,,,,2,2,1,3
C(C(C(C=O)=O)(C(CO)(C)O)O)=O,,,4,1,3,0,3
16474_1,,,,2,2,1,3
16476_0,,,,2,2,1,3
C1(C(C(CO1)O)(C(CO)(C)O)O)=O,,,4,1,2,0,2
16476_1,,,,2,2,1,3
16478_0,,,,2,2,1,3
C1(C(C(CO1)O)C(C)(CO)O)=O,,,4,1,1,0,1
16480_0,,,,2,2,1,3
C(C(C(C)O)(C(CO)(C)O)O)(O)=O,,,4,1,4,0,4
16480_1,,,,2,2,1,3
16482_0,,,,2,2,1,3
C1(COCC1(C(CO)(C)O)O)=O,,,4,1,2,0,2
16482_1,,,,2,2,1,3
16484_0,,,,2,2,1,3
C1(C(O)OCC1(C(CO)(C)O)O)=O,,,4,1,3,0,3
16484_1,,,,2,2,1,3
16486_0,,,,2,2,1,3
C(C(C(CCO)O)(C(C=O)O)O)=O,,,4,1,2,0,2
16486_1,,,,2,2,1,3
16487_0,,,,2,2,1,3
16487_1,,,,2,2,1,3
16488_0,,,,2,2,1,3
16488_1,,,,2,2,1,3
16489_0,,,,2,2,1,3
16489_1,,,,2,2,1,3
16490_0,,,,2,2,1,3
16490_1,,,,2,2,1,3
16491_0,,,,2,2,1,3
16491_1,,,,2,2,1,3
16492_0,,,,2,2,1,3
16493_0,,,,2,2,1,3
16493_1,,,,2,2,1,3
16494_0,,,,2,2,1,3
16494_1,,,,2,2,1,3
16495_0,,,,2,2,1,3
16496_0,,,,2,2,1,3
16497_0,,,,2,2,1,3
16497_1,,,,2,2,1,3
16498_0,,,,2,2,1,3
16498_1,,,,2,2,1,3
16499_0,,,,2,2,1,3
16500_0,,,,2,2,1,3
16500_1,,,,2,2,1,3
16501_0,,,,2,2,1,3
16502_0,,,,2,2,1,3
16503_0,,,,2,2,1,3
16503_1,,,,2,2,1,3
16504_0,,,,2,2,1,3
16504_1,,,,2,2,1,3
16505_0,,,,2,2,1,3
16505_1,,,,2,2,1,3
16507_0,,,,2,2,1,3
C(CO)(C(C(C)O)(C(C)O)O)=O,,,4,1,2,0,2
16507_1,,,,2,2,1,3
16508_0,,,,2,2,1,3
16508_1,,,,2,2,1,3
16509_0,,,,2,2,1,3
16509_1,,,,2,2,1,3
16510_0,,,,2,2,1,3
16511_0,,,,2,2,1,3
16511_1,,,,2,2,1,3
16513_0,,,,2,2,1,3
C(C(C(CO)=O)(C(C)O)C(C)O)=O,,,4,1,1,0,1
16515_0,,,,2,2,1,3
C(CC(C(C(C)O)(C(C)O)O)=O)=O,,,4,1,2,0,2
16515_1,,,,2,2,1,3
16516_0,,,,2,2,1,3
16516_1,,,,2,2,1,3
16517_0,,,,2,2,1,3
16517_1,,,,2,2,1,3
16518_0,,,,2,2,1,3
16518_1,,,,2,2,1,3
16519_0,,,,2,2,1,3
16519_1,,,,2,2,1,3
16520_0,,,,2,2,1,3
16520_1,,,,2,2,1,3
16521_0,,,,2,2,1,3
16521_1,,,,2,2,1,3
16522_0,,,,2,2,1,3
16522_1,,,,2,2,1,3
16523_0,,,,2,2,1,3
16523_1,,,,2,2,1,3
16524_0,,,,2,2,1,3
16525_0,,,,2,2,1,3
16526_0,,,,2,2,1,3
16527_0,,,,2,2,1,3
16527_1,,,,2,2,1,3
16529_0,,,,2,2,1,3
C(C(C(CO)(C(C)O)C(C)O)=O)=O,,,4,1,1,0,1
16531_0,,,,2,2,1,3
C(CCO)(C(C(C)O)(C(C)O)O)=O,,,4,1,2,0,2
16531_1,,,,2,2,1,3
16533_0,,,,2,2,1,3
C(CO)(C(CO)(C(C)O)C(C)O)=O,,,4,1,1,0,1
16534_0,,,,2,2,1,3
16534_1,,,,2,2,1,3
16535_0,,,,2,2,1,3
16535_1,,,,2,2,1,3
16537_0,,,,2,2,1,3
C(C)(C(C(C)O)(C(C)O)O)=O,,,4,1,2,0,2
16537_1,,,,2,2,1,3
16539_0,,,,2,2,1,3
C(C(C(C)O)(C(C)O)C(C=O)O)=O,,,4,1,1,0,1
16541_0,,,,2,2,1,3
C(C(C(C(C)O)(C(C)O)O)=O)=O,,,4,1,2,0,2
16541_1,,,,2,2,1,3
16542_0,,,,2,2,1,3
16542_1,,,,2,2,1,3
16543_0,,,,2,2,1,3
16543_1,,,,2,2,1,3
16544_0,,,,2,2,1,3
16544_1,,,,2,2,1,3
16545_0,,,,2,2,1,3
16545_1,,,,2,2,1,3
16546_0,,,,2,2,1,3
16546_1,,,,2,2,1,3
16547_0,,,,2,2,1,3
16547_1,,,,2,2,1,3
16548_0,,,,2,2,1,3
16548_1,,,,2,2,1,3
16550_0,,,,2,2,1,3
C(C(C(C)O)(C(C)O)O)=O,,,4,1,2,0,2
16550_1,,,,2,2,1,3
16551_0,,,,2,2,1,3
16551_1,,,,2,2,1,3
16552_0,,,,2,2,1,3
16552_1,,,,2,2,1,3
16553_0,,,,2,2,1,3
16553_1,,,,2,2,1,3
16554_0,,,,2,2,1,3
16554_1,,,,2,2,1,3
16555_0,,,,2,2,1,3
16555_1,,,,2,2,1,3
16556_0,,,,2,2,1,3
16556_1,,,,2,2,1,3
16557_0,,,,2,2,1,3
16557_1,,,,2,2,1,3
16558_0,,,,2,2,1,3
16558_1,,,,2,2,1,3
16559_0,,,,2,2,1,3
16559_1,,,,2,2,1,3
16560_0,,,,2,2,1,3
16560_1,,,,2,2,1,3
16561_0,,,,2,2,1,3
16561_1,,,,2,2,1,3
16562_0,,,,2,2,1,3
16564_0,,,,2,2,1,3
C(C)(C(C(C=O)=O)(C(C)O)O)=O,,,4,1,3,0,3
16564_1,,,,2,2,1,3
16566_0,,,,2,2,1,3
C(C(C(C=O)=O)(C(C)O)O)=O,,,4,1,3,0,3
16566_1,,,,2,2,1,3
16568_0,,,,2,2,1,3
C1(C(C(C)O)(C(CO1)O)O)=O,,,4,1,3,0,3
16568_1,,,,2,2,1,3
16570_0,,,,2,2,1,3
C1(C(C(C)O)C(CO1)O)=O,,,4,1,1,0,1
16571_0,,,,2,2,1,3
16571_1,,,,2,2,1,3
16572_0,,,,2,2,1,3
16572_1,,,,2,2,1,3
16573_0,,,,2,2,1,3
16573_1,,,,2,2,1,3
16574_0,,,,2,2,1,3
16574_1,,,,2,2,1,3
16575_0,,,,2,2,1,3
16575_1,,,,2,2,1,3
16576_0,,,,2,2,1,3
16576_1,,,,2,2,1,3
16577_0,,,,2,2,1,3
16577_1,,,,2,2,1,3
16578_0,,,,2,2,1,3
16578_1,,,,2,2,1,3
16579_0,,,,2,2,1,3
16579_1,,,,2,2,1,3
16580_0,,,,2,2,1,3
16580_1,,,,2,2,1,3
16581_0,,,,2,2,1,3
16581_1,,,,2,2,1,3
16582_0,,,,2,2,1,3
16582_1,,,,2,2,1,3
16583_0,,,,2,2,1,3
16583_1,,,,2,2,1,3
16584_0,,,,2,2,1,3
16584_1,,,,2,2,1,3
16586_0,,,,2,2,1,3
C(C(C(C)O)(C(C)O)O)(O)=O,,,4,1,2,0,2
16586_1,,,,2,2,1,3
16588_0,,,,2,2,1,3
C1(CC(C(C1(CO)C(C)O)=O)O)=O,,,4,1,1,0,1
16590_0,,,,2,2,1,3
C1(C(CO)CC(C1(C(C)O)O)=O)=O,,,4,1,2,0,2
16590_1,,,,2,2,1,3
16592_0,,,,2,2,1,3
C1(C(CO)(C(C)O)CC(C1O)=O)=O,,,4,1,1,0,1
16594_0,,,,2,2,1,3
C1(C(C(C(C(C)=O)O1)O)C(C)O)=O,,,4,1,1,0,1
16596_0,,,,2,2,1,3
C1(CC(C(C(C)=O)(C(C)O)O1)O)=O,,,4,1,2,0,2
16596_1,,,,2,2,1,3
16598_0,,,,2,2,1,3
C1(C(C(C)O)C(C(CC=O)O1)O)=O,,,4,1,1,0,1
16600_0,,,,2,2,1,3
C1(COC(C(C)=O)C1(C(C)O)O)=O,,,4,1,2,0,2
16600_1,,,,2,2,1,3
16602_0,,,,2,2,1,3
C(C)(C1(C(C)O)C(C(CO1)=O)O)=O,,,4,1,2,0,2
16602_1,,,,2,2,1,3
16604_0,,,,2,2,1,3
C(CC1C(C(CO1)=O)(C(C)O)O)=O,,,4,1,2,0,2
16604_1,,,,2,2,1,3
16606_0,,,,2,2,1,3
C1(CC(OC1(C(C)=O)C(C)O)O)=O,,,4,1,3,0,3
16606_1,,,,2,2,1,3
16608_0,,,,2,2,1,3
C1(CCC(OC1(CO)C(C)O)=O)=O,,,4,1,2,0,2
16608_1,,,,2,2,1,3
16610_0,,,,2,2,1,3
C1(C(CO)(C(C)O)OCC(C1)=O)=O,,,4,1,2,0,2
16610_1,,,,2,2,1,3
16612_0,,,,2,2,1,3
C1(CCC(OCC1(C(C)O)O)=O)=O,,,4,1,2,0,2
16612_1,,,,2,2,1,3
16614_0,,,,2,2,1,3
C1(C(C(C)O)C(C(CCO1)=O)O)=O,,,4,1,1,0,1
16616_0,,,,2,2,1,3
C1(C(C(CC(CO1)=O)O)C(C)O)=O,,,4,1,1,0,1
16618_0,,,,2,2,1,3
C1(C(COCC(C1)=O)(C(C)O)O)=O,,,4,1,2,0,2
16618_1,,,,2,2,1,3
16620_0,,,,2,2,1,3
C1(CCOCC(C1(C(C)O)O)=O)=O,,,4,1,2,0,2
16620_1,,,,2,2,1,3
16622_0,,,,2,2,1,3
C1(COCC1(C(C)O)O)=O,,,4,1,2,0,2
16622_1,,,,2,2,1,3
16624_0,,,,2,2,1,3
C(CC1C(C(CO1)(C(C)O)O)=O)=O,,,4,1,2,0,2
16624_1,,,,2,2,1,3
16626_0,,,,2,2,1,3
C(C1(C(C)O)C(CC(C=O)O1)O)=O,,,4,1,2,0,2
16626_1,,,,2,2,1,3
16628_0,,,,2,2,1,3
C(C1(C(CC(C)(O1)O)=O)C(C)O)=O,,,4,1,3,0,3
16628_1,,,,2,2,1,3
16630_0,,,,2,2,1,3
C(C1(C(C)O)C(C(C(C)O1)=O)O)=O,,,4,1,2,0,2
16630_1,,,,2,2,1,3
16632_0,,,,2,2,1,3
C1(C(C(C)O)(C(C=O)OC1C)O)=O,,,4,1,2,0,2
16632_1,,,,2,2,1,3
16634_0,,,,2,2,1,3
C(C1(C(CCC(O1)O)=O)C(C)O)=O,,,4,1,3,0,3
16634_1,,,,2,2,1,3
16636_0,,,,2,2,1,3
C1C(C(C(C=1CO)=O)(C(C)O)O)O,,,4,1,2,0,2
16636_1,,,,2,2,1,3
16638_0,,,,2,2,1,3
C=C1C(C(C(C1O)O)(C(C)O)O)=O,,,4,1,2,0,2
16638_1,,,,2,2,1,3
16640_0,,,,2,2,1,3
C(C(C(C(C=C)O)O)(C(C)O)O)=O,,,4,1,2,0,2
16640_1,,,,2,2,1,3
16642_0,,,,2,2,1,3
C1OC(C(C=1)=O)(C(CO)O)C(C)O,,,4,1,2,0,2
16642_1,,,,2,2,1,3
16644_0,,,,2,2,1,3
C1OC(CO)C(C(C=1)=O)(C(C)O)O,,,4,1,2,0,2
16644_1,,,,2,2,1,3
16646_0,,,,2,2,1,3
C1C(OC(C(C=1)=O)(CO)C(C)O)O,,,4,1,2,0,2
16646_1,,,,2,2,1,3
16648_0,,,,2,2,1,3
C1OCC(C(C(C=1)=O)(C(C)O)O)O,,,4,1,2,0,2
16648_1,,,,2,2,1,3
16650_0,,,,2,2,1,3
C1COC(C(C(C=1)=O)(C(C)O)O)O,,,4,1,2,0,2
16650_1,,,,2,2,1,3
16652_0,,,,2,2,1,3
C1C(O)OCC(C(C=1)=O)(C(C)O)O,,,4,1,2,0,2
16652_1,,,,2,2,1,3
16654_0,,,,2,2,1,3
C=CC(C(C(C=O)=O)(C(C)O)O)=O,,,4,1,3,0,3
16654_1,,,,2,2,1,3
16656_0,,,,2,2,1,3
C(C(C1OCC(C=1)O)(C(C)O)O)=O,,,4,1,2,0,2
16656_1,,,,2,2,1,3
16658_0,,,,2,2,1,3
C(C(C(C)O)(C1(C=CCO1)O)O)=O,,,4,1,2,0,2
16658_1,,,,2,2,1,3
16660_0,,,,2,2,1,3
C(C1(C(C)O)C(C=C(CO)O1)O)=O,,,4,1,2,0,2
16660_1,,,,2,2,1,3
16662_0,,,,2,2,1,3
C(C1(C(C(C(O1)=C)O)O)C(C)O)=O,,,4,1,2,0,2
16662_1,,,,2,2,1,3
16664_0,,,,2,2,1,3
C(C(C(C)O)(C1C=CC(O1)O)O)=O,,,4,1,2,0,2
16664_1,,,,2,2,1,3
16666_0,,,,2,2,1,3
C(C(C1C(C=CO1)O)(C(C)O)O)=O,,,4,1,2,0,2
16666_1,,,,2,2,1,3
16668_0,,,,2,2,1,3
C(C1(C(C)O)C(C=CC(O1)O)O)=O,,,4,1,2,0,2
16668_1,,,,2,2,1,3
16670_0,,,,2,2,1,3
C(C1(C(C(C=CO1)O)O)C(C)O)=O,,,4,1,2,0,2
16670_1,,,,2,2,1,3
16672_0,,,,2,2,1,3
C1(C(O)OCC1(C(C)O)O)=O,,,4,1,3,0,3
16672_1,,,,2,2,1,3
16673_0,,,,2,2,1,3
16673_1,,,,2,2,1,3
16674_0,,,,2,2,1,3
16674_1,,,,2,2,1,3
16675_0,,,,2,2,1,3
16675_1,,,,2,2,1,3
16676_0,,,,2,2,1,3
16676_1,,,,2,2,1,3
16677_0,,,,2,2,1,3
16677_1,,,,2,2,1,3
16678_0,,,,2,2,1,3
16678_1,,,,2,2,1,3
16680_0,,,,2,2,1,3
C1(C(C(CO1)O)C(C(CO)=O)O)=O,,,4,1,1,0,1
16682_0,,,,2,2,1,3
C1(C(C(CO1)O)C(C=O)(CO)O)=O,,,4,1,1,0,1
16684_0,,,,2,2,1,3
C1(COCC1(C(C(CO)=O)O)O)=O,,,4,1,2,0,2
16684_1,,,,2,2,1,3
16686_0,,,,2,2,1,3
C(C(CO)(C1(C(COC1)=O)O)O)=O,,,4,1,2,0,2
16686_1,,,,2,2,1,3
16687_0,,,,2,2,1,3
16687_1,,,,2,2,1,3
16688_0,,,,2,2,1,3
16688_1,,,,2,2,1,3
16690_0,,,,2,2,1,3
C(C(C(CO)=O)(CO)O)(O)=O,,,4,1,2,0,2
16690_1,,,,2,2,1,3
16691_0,,,,2,2,1,3
16691_1,,,,2,2,1,3
16693_0,,,,2,2,1,3
C(CO)(C(CO)(C(C(C)O)O)O)=O,,,4,1,2,0,2
16693_1,,,,2,2,1,3
16695_0,,,,2,2,1,3
C(C(C(O)=O)(C(CO)O)O)(O)=O,,,4,1,2,0,2
16695_1,,,,2,2,1,3
16697_0,,,,2,2,1,3
C(C(C(CC=O)=O)(C(C)=O)O)(O)=O,,,4,1,2,0,2
16697_1,,,,2,2,1,3
16699_0,,,,2,2,1,3
C(C(C=O)(C(CC(C)=O)=O)O)(O)=O,,,4,1,2,0,2
16699_1,,,,2,2,1,3
16701_0,,,,2,2,1,3
C(C(C=O)(C(CCC=O)=O)O)(O)=O,,,4,1,2,0,2
16701_1,,,,2,2,1,3
16703_0,,,,2,2,1,3
C(C(C=O)(C(C=CCO)=O)O)(O)=O,,,4,1,2,0,2
16703_1,,,,2,2,1,3
16705_0,,,,2,2,1,3
C(C(C(C=CC=O)=O)(CO)O)(O)=O,,,4,1,2,0,2
16705_1,,,,2,2,1,3
16706_0,,,,2,2,1,3
16706_1,,,,2,2,1,3
16708_0,,,,2,2,1,3
C(C(C(C=C)=O)(C(C=O)O)O)(O)=O,,,4,1,2,0,2
16708_1,,,,2,2,1,3
16709_0,,,,2,2,1,3
16709_1,,,,2,2,1,3
16710_0,,,,2,2,1,3
16710_1,,,,2,2,1,3
16711_0,,,,2,2,1,3
16711_1,,,,2,2,1,3
16713_0,,,,2,2,1,3
C(C(C(C=O)=O)(CO)O)(O)=O,,,4,1,2,0,2
16713_1,,,,2,2,1,3
16714_0,,,,2,2,1,3
16714_1,,,,2,2,1,3
16716_0,,,,2,2,1,3
C(C(C(CO)(C(C(C)O)O)O)=O)=O,,,4,1,2,0,2
16716_1,,,,2,2,1,3
16718_0,,,,2,1,1,2
C(C1(CC(C(C1(CO)O)O)O)O)=O,,,4,1,1,0,1
16720_0,,,,2,1,1,2
C(C)(C1(C(C(C(C1)=O)O)O)O)=O,,,4,1,1,0,1
16721_0,,,,2,1,1,2
16723_0,,,,2,1,1,2
C(C1(CC(CC1(C=O)O)O)O)=O,,,4,1,1,0,1
16724_0,,,,2,1,1,2
16726_0,,,,2,1,1,2
C(CO)(C1(C(C(C(C1)=O)O)O)O)=O,,,4,1,1,0,1
16727_0,,,,2,1,1,2
16729_0,,,,2,1,1,2
C(C1(CC(CO)(CC1O)O)O)=O,,,4,1,1,0,1
16730_0,,,,2,1,1,2
16731_0,,,,2,1,1,2
16733_0,,,,2,1,1,2
C(C1(C(C(CO)C(C1)O)O)O)(O)=O,,,4,1,1,0,1
16734_0,,,,2,1,1,2
16736_0,,,,2,1,1,2
C(C1(CC(CC1(CO)O)O)O)=O,,,4,1,1,0,1
16738_0,,,,2,1,1,2
C(C1(CC(C(C1(C)O)O)O)O)=O,,,4,1,1,0,1
16740_0,,,,2,1,1,2
C(C1(C(CC(C1)O)O)O)=O,,,4,1,1,0,1
16741_0,,,,2,1,1,2
16742_0,,,,2,1,1,2
16744_0,,,,2,1,1,2
C1(C(C(CC1)(CO)O)(CC=O)O)=O,,,4,1,1,0,1
16746_0,,,,2,1,1,2
C1(C(C(C(C1)O)(C)O)(CC=O)O)=O,,,4,1,1,0,1
16748_0,,,,2,1,1,2
C(C)(C1(C(CC(C(C1)=O)O)O)O)=O,,,4,1,1,0,1
16750_0,,,,2,1,1,2
C(C1(CC(C(C)=O)(C(C1)O)O)O)=O,,,4,1,1,0,1
16752_0,,,,2,1,1,2
C1(C(C(CC(C1)O)O)(CC=O)O)=O,,,4,1,1,0,1
16754_0,,,,2,1,1,2
C(CC(C1(C(CC(C1)O)O)O)=O)=O,,,4,1,1,0,1
16756_0,,,,2,1,1,2
C(C1(CC(C(C)=O)(CC1O)O)O)=O,,,4,1,1,0,1
16758_0,,,,2,1,1,2
C(C1(C(CC(C(C1)=O)(C)O)O)O)=O,,,4,1,1,0,1
16759_0,,,,2,1,1,2
16761_0,,,,2,1,1,2
C(C1(C(CC(CC(C1)=O)O)O)O)=O,,,4,1,1,0,1
16762_0,,,,2,1,1,2
16763_0,,,,2,1,1,2
16765_0,,,,2,1,1,2
C(C1(C=CC(CO)(CC1O)O)O)=O,,,4,1,1,0,1
16767_0,,,,2,1,1,2
C(C1(CC(CO)(C(C1O)O)O)O)=O,,,4,1,1,0,1
16769_0,,,,2,1,1,2
C(C)(C1(C(C(CO1)O)O)O)=O,,,4,1,3,0,3
16771_0,,,,2,1,1,2
C(C1(C(C)(C(CO1)O)O)O)=O,,,4,1,1,0,1
16773_0,,,,2,1,1,2
C(C1(C(CO)(CCO1)O)O)=O,,,4,1,1,0,1
16774_0,,,,2,1,1,2
16776_0,,,,2,1,1,2
C(C1(C(COC(C1)O)O)O)=O,,,4,1,2,0,2
16777_0,,,,2,1,1,2
16778_0,,,,2,1,1,2
16779_0,,,,2,1,1,2
16780_0,,,,2,1,1,2
16782_0,,,,2,1,1,2
C1(C(CC(C1(C)O)O)=O)=O,,,4,1,2,0,2
16784_0,,,,2,1,1,2
C(C1(C(C(CC1)O)O)O)(O)=O,,,4,1,1,0,1
16785_0,,,,2,1,1,2
16787_0,,,,2,1,1,2
C1(C(C)(C(C(C1O)=O)O)O)=O,,,4,1,1,0,1
16788_0,,,,2,1,1,2
16789_0,,,,2,1,1,2
16790_0,,,,2,1,1,2
16792_0,,,,2,1,1,2
C(C1(C(C(CO)(C(C1)O)O)O)O)=O,,,4,1,1,0,1
16794_0,,,,2,1,1,2
C1(C(C(CO)(C(C1(C)O)O)O)O)=O,,,4,1,1,0,1
16795_0,,,,2,1,1,2
16796_0,,,,2,1,1,2
16797_0,,,,2,1,1,2
16798_0,,,,2,1,1,2
16799_0,,,,2,1,1,2
16801_0,,,,2,1,1,2
C1(C2(C(CC(C1)O2)O)O)=O,,,4,1,1,0,1
16803_0,,,,2,1,1,2
C(C1(C=CCC1O)O)(O)=O,,,4,1,2,0,2
16805_0,,,,2,1,1,2
C1(C2(C(CC(C1O)O2)O)O)=O,,,4,1,1,0,1
16807_0,,,,2,1,1,2
C1(C2(CC(CC2O)O1)O)=O,,,4,1,3,0,3
16809_0,,,,2,1,1,2
C(C1(CC=CC1O)O)(O)=O,,,4,1,2,0,2
16811_0,,,,2,2,1,3
C1(C(C(O)=O)(C(C(C1)=O)CO)O)=O,,,4,1,1,0,1
16813_0,,,,2,2,1,3
C(C1(C(CC(C(C1)=O)O)=O)O)(O)=O,,,4,1,1,0,1
16815_0,,,,2,2,1,3
C(C1(CC(C(O)=O)(C(C1)=O)O)O)=O,,,4,1,1,0,1
16817_0,,,,2,2,1,3
C1(CC(C(C=O)C1(C(O)=O)O)O)=O,,,4,1,1,0,1
16819_0,,,,2,2,1,3
C(C1C(C(C(O)=O)(CC1O)O)=O)=O,,,4,1,1,0,1
16821_0,,,,2,2,1,3
C(C(C=O)(CC(C=O)=O)O)(O)=O,,,4,1,1,0,1
16823_0,,,,2,2,1,3
C(C(C(C)=O)(CC(CO)=O)O)(O)=O,,,4,1,1,0,1
16824_0,,,,2,2,1,3
16826_0,,,,2,2,1,3
C(C(CC(C)O)(C(C=O)(C)O)O)=O,,,4,1,1,0,1
16828_0,,,,2,2,1,3
C(C)(C(C(CCO)O)(CC=O)O)=O,,,4,1,1,0,1
16829_0,,,,2,2,1,3
16831_0,,,,2,2,1,3
C(C(C(C)=O)(CC=O)O)(O)=O,,,4,1,1,0,1
16833_0,,,,2,2,1,3
C(C(C(C(C)=O)(CC=O)O)O)(O)=O,,,4,1,2,0,2
16835_0,,,,2,2,1,3
C(C(C)(C(C)(C(CC=O)O)O)O)=O,,,4,1,1,0,1
16837_0,,,,2,2,1,3
C(C(C)(C(CC(C(C)=O)O)O)O)=O,,,4,1,1,0,1
16839_0,,,,2,2,1,3
C(C)(C(C(C(C)O)O)(CC=O)O)=O,,,4,1,1,0,1
16840_0,,,,2,2,1,3
16842_0,,,,2,2,1,3
C(C(C)(CC(C(C=O)(C)O)O)O)=O,,,4,1,1,0,1
16844_0,,,,2,2,1,3
C(C(C=O)(C(C=O)CO)O)(O)=O,,,4,1,1,0,1
16846_0,,,,2,2,1,3
C(C(C)(C(CCO)O)O)(O)=O,,,4,1,1,0,1
16848_0,,,,2,2,1,3
C(C(C(C)(C(CCO)O)O)=O)=O,,,4,1,1,0,1
16850_0,,,,2,2,1,3
C(CO)(C(C)(C(CCO)O)O)=O,,,4,1,1,0,1
16852_0,,,,2,2,1,3
C(C(CCO)(C(CCO)O)O)=O,,,4,1,1,0,1
16854_0,,,,2,2,1,3
C(C(C(CCO)O)(CC(O)=O)O)=O,,,4,1,1,0,1
16856_0,,,,2,2,1,3
C(C(C(CCO)O)(CC=O)O)(O)=O,,,4,1,1,0,1
16858_0,,,,2,2,1,3
C(C(C)(C(CCO)O)O)=O,,,4,1,1,0,1
16860_0,,,,2,2,1,3
C1(C(C(CCO)O)(O)OCC1)=O,,,4,1,1,0,1
16862_0,,,,2,2,1,3
C(C(C=C)(C(CCO)O)O)(O)=O,,,4,1,1,0,1
16864_0,,,,2,2,1,3
C1(C(C(CCO)O)(O)OCC1O)=O,,,4,1,1,0,1
16866_0,,,,2,2,1,3
C1(C(CCO1)(C(CCO)O)O)=O,,,4,1,1,0,1
16868_0,,,,2,2,1,3
C(CCO)(C(C(O)=O)(CC=O)O)=O,,,4,1,1,0,1
16870_0,,,,2,2,1,3
C(C(C)(C(CO)(CC(C)O)O)O)=O,,,4,1,1,0,1
16872_0,,,,2,2,1,3
C(C(C)(C(C)(C(C(C)O)O)O)O)=O,,,4,1,1,0,1
16874_0,,,,2,2,1,3
C(C(C)(C(CC(CO)(C)O)O)O)=O,,,4,1,1,0,1
16876_0,,,,2,2,1,3
C(C(C=O)(C(C=O)C(C)O)O)(O)=O,,,4,1,1,0,1
16878_0,,,,2,2,1,3
C(C(C=O)(CC(CC=O)O)O)(O)=O,,,4,1,1,0,1
16880_0,,,,2,2,1,3
C(C(C)(C(CC(C)O)O)O)(O)=O,,,4,1,1,0,1
16882_0,,,,2,2,1,3
C(C(C(C)(C(CC(C)O)O)O)=O)=O,,,4,1,1,0,1
16884_0,,,,2,2,1,3
C(CO)(C(C)(C(CC(C)O)O)O)=O,,,4,1,1,0,1
16886_0,,,,2,2,1,3
C(C(CCO)(C(CC(C)O)O)O)=O,,,4,1,1,0,1
16888_0,,,,2,2,1,3
C(C(C)(C(CC(C)O)O)O)=O,,,4,1,1,0,1
16890_0,,,,2,2,1,3
C1(C(C(CC(C)O)O)(O)OCC1)=O,,,4,1,1,0,1
16892_0,,,,2,2,1,3
C(C(C=C)(C(CC(C)O)O)O)(O)=O,,,4,1,1,0,1
16894_0,,,,2,2,1,3
C1(C(CCO1)(C(CC(C)O)O)O)=O,,,4,1,1,0,1
16896_0,,,,2,2,1,3
C(C(C(CO)=O)(CC=O)O)(O)=O,,,4,1,1,0,1
16898_0,,,,2,2,1,3
C(C(C)(C(C(C(C)O)O)O)O)(O)=O,,,4,1,1,0,1
16900_0,,,,2,2,1,3
C(C(C)(C(C(C(C)O)O)O)O)=O,,,4,1,1,0,1
16902_0,,,,2,2,1,3
C(C(C)(C(CC(CO)O)O)O)(O)=O,,,4,1,1,0,1
16904_0,,,,2,2,1,3
C(C(C)(C(CC(CO)O)O)O)=O,,,4,1,1,0,1
16905_0,,,,2,2,1,3
16907_0,,,,2,2,1,3
C(C(C)(C(C(CO)=O)(C)O)O)(O)=O,,,4,1,2,0,2
16908_0,,,,2,2,1,3
16909_0,,,,2,2,1,3
16911_0,,,,2,2,1,3
C(C(C)(C(CO)(C(C)O)O)O)(O)=O,,,4,1,1,0,1
16912_0,,,,2,2,1,3
16914_0,,,,2,2,1,3
C(C(C)(C(C(CCO)O)O)O)(O)=O,,,4,1,1,0,1
16916_0,,,,2,2,1,3
C(C(C)(C(C(O)=O)(C)O)O)(O)=O,,,4,1,1,0,1
16918_0,,,,2,2,1,3
C(C(C(O)=O)(C)O)(O)=O,,,4,1,1,0,1
16919_0,,,,2,2,1,3
16921_0,,,,2,2,1,3
C(C(C)(C(C(C(O)=O)O)O)O)(O)=O,,,4,1,1,0,1
16922_0,,,,2,2,1,3
16923_0,,,,2,2,1,3
16924_0,,,,2,2,1,3
16926_0,,,,2,2,1,3
C(C(C)(C(CC(C=O)=O)O)O)(O)=O,,,4,1,1,0,1
16928_0,,,,2,2,1,3
C(C(C)(C(C(C)=O)(C)O)O)(O)=O,,,4,1,1,0,1
16930_0,,,,2,2,1,3
C(C(C)(C(C)(CC=O)O)O)(O)=O,,,4,1,1,0,1
16932_0,,,,2,2,1,3
C(C(C)(C(CC(C)=O)O)O)(O)=O,,,4,1,1,0,1
16934_0,,,,2,2,1,3
C(C(C)(C1(COC(C1)O)O)O)(O)=O,,,4,1,1,0,1
16936_0,,,,2,2,1,3
C(C(C)(C(C)(CCO)O)O)(O)=O,,,4,1,1,0,1
16937_0,,,,2,2,1,3
16938_0,,,,2,2,1,3
16940_0,,,,2,2,1,3
C(C(C)(C(C(C=O)=O)(C)O)O)(O)=O,,,4,1,2,0,2
16941_0,,,,2,2,1,3
16942_0,,,,2,2,1,3
16943_0,,,,2,2,1,3
16945_0,,,,2,2,1,3
C(C(C=C)(C(C(O)=O)(C)O)O)=O,,,4,1,1,0,1
16947_0,,,,2,2,1,3
C(C(C)(C(C=C)(CO)O)O)(O)=O,,,4,1,1,0,1
16949_0,,,,2,2,1,3
C(C(C)(C(C=CC=O)O)O)(O)=O,,,4,1,1,0,1
16951_0,,,,2,2,1,3
C(C(C)(C(C(C)O)O)O)(O)=O,,,4,1,1,0,1
16953_0,,,,2,2,1,3
C(C(C)(C1(COCC1O)O)O)(O)=O,,,4,1,1,0,1
16955_0,,,,2,2,1,3
C(C(C)(C1(C(O)OCC1)O)O)(O)=O,,,4,1,1,0,1
16956_0,,,,2,2,1,3
16958_0,,,,2,2,1,3
C(C(C)(C(C(CO)=O)(C)O)O)=O,,,4,1,2,0,2
16960_0,,,,2,2,1,3
C(CC(C(C(C=O)=O)(C)O)O)=O,,,4,1,1,0,1
16961_0,,,,2,2,1,3
16963_0,,,,2,2,1,3
C(C(C(C=O)=O)(C)O)(O)=O,,,4,1,1,0,1
16965_0,,,,2,2,1,3
C(C(C(C(C=O)=O)(C)O)O)(O)=O,,,4,1,3,0,3
16967_0,,,,2,2,1,3
C(C)(C(C)(C(C(C=O)=O)(C)O)O)=O,,,4,1,1,0,1
16969_0,,,,2,2,1,3
C(CC(C)(C(C(C=O)=O)(C)O)O)=O,,,4,1,1,0,1
16971_0,,,,2,2,1,3
C(C)(CC(C(C(C=O)=O)(C)O)O)=O,,,4,1,1,0,1
16973_0,,,,2,2,1,3
C(C(C(C)(C(C)(CCO)O)O)=O)=O,,,4,1,1,0,1
16974_0,,,,2,2,1,3
16975_0,,,,2,2,1,3
16976_0,,,,2,2,1,3
16978_0,,,,2,2,1,3
C(C(C=C)(C(C(C=O)=O)(C)O)O)=O,,,4,1,1,0,1
16980_0,,,,2,2,1,3
C=CC(CO)(C(C(C=O)=O)(C)O)O,,,4,1,1,0,1
16982_0,,,,2,2,1,3
C(C(C(C(C=O)=O)(C)O)O)=CC=O,,,4,1,1,0,1
16983_0,,,,2,2,1,3
16984_0,,,,2,2,1,3
16986_0,,,,2,2,1,3
C(C(C(C)(C(C(C)O)O)O)=O)=O,,,4,1,1,0,1
16988_0,,,,2,2,1,3
C(CC(C(C(CO)=O)(C)O)O)=O,,,4,1,1,0,1
16989_0,,,,2,2,1,3
16991_0,,,,2,2,1,3
C(C(C(CO)=O)(C)O)(O)=O,,,4,1,1,0,1
16992_0,,,,2,2,1,3
16994_0,,,,2,2,1,3
C(C)(C(C)(C(C(CO)=O)(C)O)O)=O,,,4,1,1,0,1
16996_0,,,,2,2,1,3
C(CC(C)(C(C(CO)=O)(C)O)O)=O,,,4,1,1,0,1
16998_0,,,,2,2,1,3
C(C)(CC(C(C(CO)=O)(C)O)O)=O,,,4,1,1,0,1
17000_0,,,,2,2,1,3
C(CO)(C(C)(C(C)(CCO)O)O)=O,,,4,1,1,0,1
17001_0,,,,2,2,1,3
17002_0,,,,2,2,1,3
17003_0,,,,2,2,1,3
17005_0,,,,2,2,1,3
C(C(C=C)(C(C(CO)=O)(C)O)O)=O,,,4,1,1,0,1
17007_0,,,,2,2,1,3
C(CO)(C(C)(C(C=C)(CO)O)O)=O,,,4,1,1,0,1
17009_0,,,,2,2,1,3
C(CO)(C(C)(C(C=CC=O)O)O)=O,,,4,1,1,0,1
17011_0,,,,2,2,1,3
C(C(C)(C(CO)(C(C)O)O)O)=O,,,4,1,1,0,1
17013_0,,,,2,2,1,3
C(CO)(C(C)(C(C(C)O)O)O)=O,,,4,1,1,0,1
17015_0,,,,2,2,1,3
C(C(C(CC=O)O)(CCO)O)=O,,,4,1,1,0,1
17017_0,,,,2,2,1,3
C(CC(C(C=O)(CC(O)=O)O)O)=O,,,4,1,1,0,1
17019_0,,,,2,2,1,3
C(C(C(CC=O)O)(CC=O)O)(O)=O,,,4,1,1,0,1
17021_0,,,,2,2,1,3
C(C(C)(C(CC=O)O)O)=O,,,4,1,1,0,1
17023_0,,,,2,2,1,3
C(CC(C1(C(CCO1)=O)O)O)=O,,,4,1,1,0,1
17025_0,,,,2,2,1,3
C(C(C=C)(C(CC=O)O)O)(O)=O,,,4,1,1,0,1
17027_0,,,,2,2,1,3
C(CC(C1(C(C(CO1)O)=O)O)O)=O,,,4,1,1,0,1
17029_0,,,,2,2,1,3
C1(C(C(CC=O)O)(CCO1)O)=O,,,4,1,1,0,1
17030_0,,,,2,2,1,3
17031_0,,,,2,2,1,3
17033_0,,,,2,2,1,3
C(C(C)(C(C=O)(CCO)O)O)(O)=O,,,4,1,2,0,2
17035_0,,,,2,2,1,3
C(C(C=O)(CCO)O)(O)=O,,,4,1,1,0,1
17036_0,,,,2,2,1,3
17038_0,,,,2,2,1,3
C(C(CCO)(C(C(C)=O)(C)O)O)=O,,,4,1,1,0,1
17040_0,,,,2,2,1,3
C(C(CCO)(C(C)(CC=O)O)O)=O,,,4,1,1,0,1
17042_0,,,,2,2,1,3
C(C(C(CC(C)=O)O)(CCO)O)=O,,,4,1,1,0,1
17044_0,,,,2,2,1,3
C(C(CCO)(C(C)(CCO)O)O)=O,,,4,1,1,0,1
17045_0,,,,2,2,1,3
17046_0,,,,2,2,1,3
17047_0,,,,2,2,1,3
17049_0,,,,2,2,1,3
C(C(C=C)(C(C=O)(CCO)O)O)=O,,,4,1,1,0,1
17051_0,,,,2,2,1,3
C(C(CCO)(C(C=C)(CO)O)O)=O,,,4,1,1,0,1
17053_0,,,,2,2,1,3
C(C(CCO)(C(C=CC=O)O)O)=O,,,4,1,1,0,1
17055_0,,,,2,2,1,3
C(C(C)(C(C(CCO)O)O)O)=O,,,4,1,1,0,1
17057_0,,,,2,2,1,3
C(C(CCO)(C(C(C)O)O)O)=O,,,4,1,1,0,1
17059_0,,,,2,2,1,3
C(C(C)(C(C=O)(C)O)O)(O)=O,,,4,1,2,0,2
17061_0,,,,2,2,1,3
C(C(C)(C1(C(CCO1)=O)O)O)(O)=O,,,4,1,1,0,1
17063_0,,,,2,2,1,3
C(C(C=C)(C(C(O)=O)(C)O)O)(O)=O,,,4,1,1,0,1
17065_0,,,,2,2,1,3
C1(C(CCO1)(C(C(O)=O)(C)O)O)=O,,,4,1,1,0,1
17067_0,,,,2,2,1,3
C(C(C(O)=O)(CC(CO)=O)O)(O)=O,,,4,1,1,0,1
17069_0,,,,2,2,1,3
C(C(C=O)(CC(O)=O)O)(O)=O,,,4,1,1,0,1
17071_0,,,,2,2,1,3
C(C(C(O)=O)(CC(C)=O)O)(O)=O,,,4,1,1,0,1
17073_0,,,,2,2,1,3
C(C(C(O)=O)(CC=O)O)(O)=O,,,4,1,1,0,1
17075_0,,,,2,2,1,3
C(C(C=O)(CC(C=O)O)O)(O)=O,,,4,1,1,0,1
17077_0,,,,2,2,1,3
C(C(C(C(C=O)O)=O)(C)O)(O)=O,,,4,1,1,0,1
17078_0,,,,2,2,1,3
17080_0,,,,2,2,1,3
C(C(C=O)(CCC(C=O)=O)O)(O)=O,,,4,1,2,0,2
17082_0,,,,2,2,1,3
C(C(C(CC(C=O)=O)=O)(C)O)(O)=O,,,4,1,1,0,1
17084_0,,,,2,2,1,3
C(C(C(C(C)=O)=O)(CC=O)O)(O)=O,,,4,1,1,0,1
17086_0,,,,2,2,1,3
C(C(C(C(CC=O)=O)=O)(C)O)(O)=O,,,4,1,1,0,1
17088_0,,,,2,2,1,3
C(C(C(C=O)=O)(CC(C)=O)O)(O)=O,,,4,1,1,0,1
17090_0,,,,2,2,1,3
C(C(C(C=O)=O)(CCC=O)O)(O)=O,,,4,1,1,0,1
17092_0,,,,2,2,1,3
C(C(C=CCO)(C(C=O)=O)O)(O)=O,,,4,1,1,0,1
17094_0,,,,2,2,1,3
C(C(C(CO)=O)(C=CC=O)O)(O)=O,,,4,1,1,0,1
17096_0,,,,2,2,1,3
C(C(C(C(C=O)O)=O)(C=C)O)(O)=O,,,4,1,1,0,1
17098_0,,,,2,2,1,3
C(C(C=O)(C=CC(C=O)O)O)(O)=O,,,4,1,1,0,1
17100_0,,,,2,2,1,3
C(C(C(CC=O)=O)(CCO)O)(O)=O,,,4,1,1,0,1
17102_0,,,,2,2,1,3
C(C(C=O)(CC(CCO)=O)O)(O)=O,,,4,1,1,0,1
17104_0,,,,2,2,1,3
C1(C(C(O)=O)(CC(C1CO)=O)O)=O,,,4,1,1,0,1
17106_0,,,,2,2,1,3
C(C1(C(CC(C(C)=O)O1)=O)O)(O)=O,,,4,1,1,0,1
17108_0,,,,2,2,1,3
C(C1(C(C)=O)CC(C(O1)O)=O)(O)=O,,,4,1,1,0,1
17110_0,,,,2,2,1,3
C(C1(C(CC(CC=O)O1)=O)O)(O)=O,,,4,1,1,0,1
17112_0,,,,2,2,1,3
C1(CC(OC1(C(O)=O)CC=O)O)=O,,,4,1,1,0,1
17114_0,,,,2,2,1,3
C1(CCOC(CC1(C(O)=O)O)=O)=O,,,4,1,1,0,1
17116_0,,,,2,2,1,3
C(C1(C(COCC(C1)=O)=O)O)(O)=O,,,4,1,1,0,1
17118_0,,,,2,2,1,3
C1(C(C(O)=O)(O)OCCC(C1)=O)=O,,,4,1,1,0,1
17120_0,,,,2,2,1,3
C(C1(C(CCC(CO1)=O)=O)O)(O)=O,,,4,1,1,0,1
17122_0,,,,2,2,1,3
C(C(C(C)=O)(C=CC(O)=O)O)(O)=O,,,4,1,1,0,1
17124_0,,,,2,2,1,3
C(C(C(O)=O)(C=CC(C)=O)O)(O)=O,,,4,1,1,0,1
17126_0,,,,2,2,1,3
C(C(C(O)=O)(C=CCC=O)O)(O)=O,,,4,1,1,0,1
17128_0,,,,2,2,1,3
C(C1(C(CCO1)=O)O)(O)=O,,,4,1,1,0,1
17130_0,,,,2,2,1,3
C1(C(COC1(C(O)=O)CC=O)O)=O,,,4,1,1,0,1
17132_0,,,,2,2,1,3
C(C1(C(C=O)=O)CC(CO1)O)(O)=O,,,4,1,1,0,1
17134_0,,,,2,2,1,3
C(C1(C=O)CC(C(C=O)O1)O)(O)=O,,,4,1,1,0,1
17136_0,,,,2,2,1,3
C(C1(C=O)CC(C(C)(O1)O)=O)(O)=O,,,4,1,1,0,1
17138_0,,,,2,2,1,3
C(C1C(C(C(C(O)=O)(C)O1)=O)O)=O,,,4,1,1,0,1
17140_0,,,,2,2,1,3
C(C1(C=O)CC(CC(O1)O)=O)(O)=O,,,4,1,1,0,1
17142_0,,,,2,2,1,3
C(C1(C(OC(C(C)=O)C1)=O)O)(O)=O,,,4,1,1,0,1
17144_0,,,,2,2,1,3
C1(C(CC(C(O)=O)(C(C)=O)O1)O)=O,,,4,1,1,0,1
17146_0,,,,2,2,1,3
C1(C(C(O)=O)(CC(CC=O)O1)O)=O,,,4,1,1,0,1
17148_0,,,,2,2,1,3
C1(C(C(O)=O)(CC(CCO1)=O)O)=O,,,4,1,1,0,1
17150_0,,,,2,2,1,3
C(C1(C(OCC(CC1)=O)=O)O)(O)=O,,,4,1,1,0,1
17152_0,,,,2,2,1,3
C(C(C=O)(CCC(CO)=O)O)(O)=O,,,4,1,2,0,2
17154_0,,,,2,2,1,3
C(C(C=O)(CC(C(C)=O)O)O)(O)=O,,,4,1,1,0,1
17156_0,,,,2,2,1,3
C(C(CC(C(O)=O)(C(C)=O)O)O)=O,,,4,1,1,0,1
17158_0,,,,2,2,1,3
C(C1(C(C=CC(CO)O1)=O)O)(O)=O,,,4,1,1,0,1
17160_0,,,,2,2,1,3
C(C1(C(C=CC(CO1)O)=O)O)(O)=O,,,4,1,1,0,1
17162_0,,,,2,2,1,3
C(C(C(O)=O)(CC(C=C)=O)O)(O)=O,,,4,1,1,0,1
17164_0,,,,2,2,1,3
C(C(C(O)=O)(CC=CC=O)O)(O)=O,,,4,1,1,0,1
17166_0,,,,2,2,1,3
C(C(C=CC=O)(C(C=O)=O)O)(O)=O,,,4,1,1,0,1
17168_0,,,,2,2,1,3
C(C1(C=O)C=CC(CO)(O1)O)(O)=O,,,4,1,1,0,1
17170_0,,,,2,2,1,3
C(C1(C(OC(C=C1)CO)=O)O)(O)=O,,,4,1,1,0,1
17172_0,,,,2,2,1,3
C1(C(C(O)=O)(C=CC(CO1)O)O)=O,,,4,1,1,0,1
17174_0,,,,2,2,1,3
C(C(C(O)=O)(C=C)O)(O)=O,,,4,1,1,0,1
17176_0,,,,2,2,1,3
C(C(C=O)(C=CC(CO)O)O)(O)=O,,,4,1,1,0,1
17178_0,,,,2,2,1,3
C(C1(C(C(CO1)O)=O)O)(O)=O,,,4,1,1,0,1
17180_0,,,,2,2,1,3
C1(C(C(O)=O)(CCO1)O)=O,,,4,1,1,0,1
17182_0,,,,2,2,1,3
C(C(C)(C(CO)(CC(O)=O)O)O)=O,,,4,1,1,0,1
17184_0,,,,2,2,1,3
C(C(C)(C(C)(C(C(O)=O)O)O)O)=O,,,4,1,1,0,1
17186_0,,,,2,2,1,3
C(CC(C=O)(C(C(O)=O)O)O)(O)=O,,,4,1,1,0,1
17188_0,,,,2,2,1,3
C(C(C(C(O)=O)(CC=O)O)O)(O)=O,,,4,1,1,0,1
17189_0,,,,2,2,1,3
17191_0,,,,2,2,1,3
C(C(C1(C(CCO1)=O)O)O)(O)=O,,,4,1,1,0,1
17193_0,,,,2,2,1,3
C(C(C=C)(C(C(O)=O)O)O)(O)=O,,,4,1,1,0,1
17195_0,,,,2,2,1,3
C(C(C1(C(C(CO1)O)=O)O)O)(O)=O,,,4,1,1,0,1
17197_0,,,,2,2,1,3
C1(C(CCO1)(C(C(O)=O)O)O)=O,,,4,1,1,0,1
17198_0,,,,2,2,1,3
17200_0,,,,2,2,1,3
C(C(C)(C(C(CC(O)=O)O)O)O)=O,,,4,1,1,0,1
17202_0,,,,2,2,1,3
C(C(C(C(C)O)O)(CC(O)=O)O)=O,,,4,1,1,0,1
17203_0,,,,2,2,1,3
17205_0,,,,2,2,1,3
C(C(C)(C(C(CC(C)=O)=O)O)O)=O,,,4,1,1,0,1
17207_0,,,,2,2,1,3
C(CC(C=O)(C(C=O)(C)O)O)(C)=O,,,4,1,1,0,1
17209_0,,,,2,2,1,3
C(C(C)(C(C)(CC(C=O)=O)O)O)=O,,,4,1,1,0,1
17210_0,,,,2,2,1,3
17211_0,,,,2,2,1,3
17213_0,,,,2,2,1,3
C(C(C)(C(CC(C=O)=O)O)O)=O,,,4,1,1,0,1
17215_0,,,,2,2,1,3
C(C(C)(C(CC(C(C)=O)=O)O)O)=O,,,4,1,1,0,1
17217_0,,,,2,2,1,3
C(CC(C(C)=O)(C(C=O)(C)O)O)=O,,,4,1,2,0,2
17219_0,,,,2,2,1,3
C(CC(C(C)(C(C=O)(C)O)O)=O)=O,,,4,1,1,0,1
17221_0,,,,2,2,1,3
C(C(C)(C(C(C)=O)(C)O)O)=O,,,4,1,1,0,1
17223_0,,,,2,2,1,3
C(C)(C(C)(C1(C(CCO1)=O)O)O)=O,,,4,1,1,0,1
17225_0,,,,2,2,1,3
C(C(C=C)(C(C(C)=O)(C)O)O)(O)=O,,,4,1,1,0,1
17227_0,,,,2,2,1,3
C1(C(CCO1)(C(C(C)=O)(C)O)O)=O,,,4,1,1,0,1
17229_0,,,,2,2,1,3
C(C(C)(C(C)(CC=O)O)O)=O,,,4,1,1,0,1
17231_0,,,,2,2,1,3
C(C(C)(C(CC(C)=O)O)O)=O,,,4,1,1,0,1
17233_0,,,,2,2,1,3
C(CC(C)(C1(C(CCO1)=O)O)O)=O,,,4,1,1,0,1
17235_0,,,,2,2,1,3
C1(C(C(CC(C)=O)O)(O)OCC1)=O,,,4,1,1,0,1
17237_0,,,,2,2,1,3
C(C(C=C)(C(C)(CC=O)O)O)(O)=O,,,4,1,1,0,1
17239_0,,,,2,2,1,3
C(C(C=C)(C(CC(C)=O)O)O)(O)=O,,,4,1,1,0,1
17241_0,,,,2,2,1,3
C1(C(CCO1)(C(C)(CC=O)O)O)=O,,,4,1,1,0,1
17243_0,,,,2,2,1,3
C1(C(C(CC(C)=O)O)(CCO1)O)=O,,,4,1,1,0,1
17245_0,,,,2,2,1,3
C(C(C)(C1(COC(C1)O)O)O)=O,,,4,1,1,0,1
17247_0,,,,2,2,1,3
C(C(C)(C(C)(CCO)O)O)=O,,,4,1,1,0,1
17249_0,,,,2,2,1,3
C1(C(C(C)(CCO)O)(O)OCC1)=O,,,4,1,1,0,1
17251_0,,,,2,2,1,3
C(C(C=C)(C(C)(CCO)O)O)(O)=O,,,4,1,1,0,1
17253_0,,,,2,2,1,3
C1(C(CCO1)(C(C)(CCO)O)O)=O,,,4,1,1,0,1
17255_0,,,,2,2,1,3
C(C(C)(C(CC(C(O)=O)O)O)O)=O,,,4,1,1,0,1
17257_0,,,,2,2,1,3
C(C(C(C(C)O)O)(CC=O)O)(O)=O,,,4,1,1,0,1
17258_0,,,,2,2,1,3
17259_0,,,,2,2,1,3
17261_0,,,,2,2,1,3
C(C(C)(C(C(C=O)=O)(C)O)O)=O,,,4,1,2,0,2
17262_0,,,,2,2,1,3
17263_0,,,,2,2,1,3
17265_0,,,,2,2,1,3
C1(C(C(C(C=O)=O)O)(O)OCC1)=O,,,4,1,1,0,1
17267_0,,,,2,2,1,3
C(C(C=O)(C1(C(CCO1)=O)O)O)=O,,,4,1,1,0,1
17269_0,,,,2,2,1,3
C(C(C=C)(C(C(C=O)=O)O)O)(O)=O,,,4,1,1,0,1
17271_0,,,,2,2,1,3
C(C(C=C)(C(C=O)(C=O)O)O)(O)=O,,,4,1,1,0,1
17273_0,,,,2,2,1,3
C1(C(CCO1)(C(C(C=O)=O)O)O)=O,,,4,1,1,0,1
17275_0,,,,2,2,1,3
C(C(C=O)(C1(C(OCC1)=O)O)O)=O,,,4,1,1,0,1
17276_0,,,,2,2,1,3
17277_0,,,,2,2,1,3
17279_0,,,,2,2,1,3
C(C(C)(C(C(C(C=O)=O)O)O)O)=O,,,4,1,1,0,1
17281_0,,,,2,2,1,3
C(C(C)(C(C=CC(CO)=O)O)O)=O,,,4,1,1,0,1
17283_0,,,,2,2,1,3
C(C(C)(C(C=CC=O)(CO)O)O)=O,,,4,1,1,0,1
17284_0,,,,2,2,1,3
17286_0,,,,2,2,1,3
C(C(C=C)(C(C=O)(C)O)O)=O,,,4,1,1,0,1
17288_0,,,,2,2,1,3
C1(C(C(C(C=C)=O)O)(O)OCC1)=O,,,4,1,1,0,1
17290_0,,,,2,2,1,3
C(C(C=C)(C1(C(CCO1)=O)O)O)=O,,,4,1,1,0,1
17292_0,,,,2,2,1,3
C(C(C=C)(C(C(C=C)=O)O)O)(O)=O,,,4,1,1,0,1
17294_0,,,,2,2,1,3
C(C(C=C)(C(C(O)=O)(C=C)O)O)=O,,,4,1,1,0,1
17296_0,,,,2,2,1,3
C1(C(CCO1)(C(C(C=C)=O)O)O)=O,,,4,1,1,0,1
17298_0,,,,2,2,1,3
C(C(C=C)(C1(C(OCC1)=O)O)O)=O,,,4,1,1,0,1
17300_0,,,,2,2,1,3
C(C(C)(C(C=C)(CO)O)O)=O,,,4,1,1,0,1
17302_0,,,,2,2,1,3
C1(C(C(C=C)(CO)O)(O)OCC1)=O,,,4,1,1,0,1
17304_0,,,,2,2,1,3
C(C(C=C)(C(C=C)(CO)O)O)(O)=O,,,4,1,1,0,1
17306_0,,,,2,2,1,3
C1(C(CCO1)(C(C=C)(CO)O)O)=O,,,4,1,1,0,1
17308_0,,,,2,2,1,3
C(C(C)(C(C=CC=O)O)O)=O,,,4,1,1,0,1
17310_0,,,,2,2,1,3
C1(C(C(C=CC=O)O)(O)OCC1)=O,,,4,1,1,0,1
17312_0,,,,2,2,1,3
C(C(C=C)(C(C=CC=O)O)O)(O)=O,,,4,1,1,0,1
17314_0,,,,2,2,1,3
C1(C(CCO1)(C(C=CC=O)O)O)=O,,,4,1,1,0,1
17316_0,,,,2,2,1,3
C(C(C)(C(C(C)O)O)O)=O,,,4,1,1,0,1
17317_0,,,,2,2,1,3
17319_0,,,,2,2,1,3
C(C(C)(C(C(CO)(CO)O)O)O)=O,,,4,1,1,0,1
17321_0,,,,2,2,1,3
C(C(CO)(C(C(C=O)(C)O)O)O)=O,,,4,1,1,0,1
17323_0,,,,2,2,1,3
C(C(C)(C1(COCC1O)O)O)=O,,,4,1,1,0,1
17325_0,,,,2,2,1,3
C1(C(C(C(C)O)O)(O)OCC1)=O,,,4,1,1,0,1
17327_0,,,,2,2,1,3
C(C(C)(C1(C(O)OCC1)O)O)=O,,,4,1,1,0,1
17329_0,,,,2,2,1,3
C(C(C=C)(C(C(C)O)O)O)(O)=O,,,4,1,1,0,1
17331_0,,,,2,2,1,3
C1(C(C(C(C)O)O)(O)OCC1O)=O,,,4,1,1,0,1
17333_0,,,,2,2,1,3
C(C(C)(C1(C(O)OCC1O)O)O)=O,,,4,1,2,0,2
17335_0,,,,2,2,1,3
C1(C(CCO1)(C(C(C)O)O)O)=O,,,4,1,1,0,1
17336_0,,,,2,2,1,3
17338_0,,,,2,2,1,3
C(C)(C(C(CO)O)(CC=O)O)=O,,,4,1,1,0,1
17339_0,,,,2,2,1,3
17341_0,,,,2,2,1,3
C(CO)(C(C(CO)O)(CC=O)O)=O,,,4,1,1,0,1
17343_0,,,,2,2,1,3
C(C(C)(C(CO)O)O)(O)=O,,,4,1,1,0,1
17344_0,,,,2,2,1,3
17345_0,,,,2,2,1,3
17346_0,,,,2,2,1,3
17347_0,,,,2,2,1,3
17349_0,,,,2,2,1,3
C(C(C(CO)O)(CC(C)=O)O)(O)=O,,,4,1,1,0,1
17350_0,,,,2,2,1,3
17351_0,,,,2,2,1,3
17352_0,,,,2,2,1,3
17353_0,,,,2,2,1,3
17355_0,,,,2,2,1,3
C1(C(C(CO)O)(O)OCC1)=O,,,4,1,4,0,4
17357_0,,,,2,2,1,3
C(C(C=C)(C(CO)O)O)(O)=O,,,4,1,3,0,3
17359_0,,,,2,2,1,3
C1(C(C(CO)O)(O)OCC1O)=O,,,4,1,1,0,1
17361_0,,,,2,2,1,3
C1(C(C(CO)O)(CCO1)O)=O,,,4,1,2,0,2
17363_0,,,,2,2,1,3
C(C(C)(C(C(C(CO)O)O)O)O)=O,,,4,1,3,0,3
17365_0,,,,2,2,1,3
C(C(C)(C(CO)(CO)O)O)(O)=O,,,4,1,1,0,1
17367_0,,,,2,2,1,3
C(C(C(C)(C(CO)(CO)O)O)=O)=O,,,4,1,1,0,1
17369_0,,,,2,2,1,3
C(CO)(C(C)(C(CO)(CO)O)O)=O,,,4,1,1,0,1
17370_0,,,,2,2,1,3
17371_0,,,,2,2,1,3
17373_0,,,,2,2,1,3
C1(C(C(CO)(CO)O)(O)OCC1)=O,,,4,1,1,0,1
17375_0,,,,2,2,1,3
C(C(C=C)(C(CO)(CO)O)O)(O)=O,,,4,1,1,0,1
17377_0,,,,2,2,1,3
C1(C(CCO1)(C(CO)(CO)O)O)=O,,,4,1,1,0,1
17378_0,,,,2,2,1,3
17380_0,,,,2,2,1,3
C(C(C(C)(C(C(CO)O)O)O)=O)=O,,,4,1,1,0,1
17382_0,,,,2,2,1,3
C(CO)(C(C)(C(C(CO)O)O)O)=O,,,4,1,1,0,1
17383_0,,,,2,2,1,3
17385_0,,,,2,2,1,3
C(C(C)(C(C(CO)O)O)O)=O,,,4,1,3,0,3
17387_0,,,,2,2,1,3
C1(C(C(C(CO)O)O)(O)OCC1)=O,,,4,1,1,0,1
17389_0,,,,2,2,1,3
C(C(C=C)(C(C(CO)O)O)O)(O)=O,,,4,1,1,0,1
17391_0,,,,2,2,1,3
C1(C(CCO1)(C(C(CO)O)O)O)=O,,,4,1,1,0,1
17392_0,,,,2,2,1,3
17393_0,,,,2,2,1,3
17394_0,,,,2,2,1,3
17395_0,,,,2,2,1,3
17396_0,,,,2,2,1,3
17397_0,,,,2,2,1,3
17398_0,,,,2,2,1,3
17399_0,,,,2,2,1,3
17400_0,,,,2,2,1,3
17401_0,,,,2,2,1,3
17402_0,,,,2,2,1,3
17403_0,,,,2,2,1,3
17404_0,,,,2,2,1,3
17405_0,,,,2,2,1,3
17406_0,,,,2,2,1,3
17408_0,,,,2,2,1,3
C(C(C)(C(C=O)(C)O)O)=O,,,4,1,1,0,1
17410_0,,,,2,2,1,3
C(C(C1(C(CCO1)=O)O)O)(C)=O,,,4,1,1,0,1
17412_0,,,,2,2,1,3
C(C(C)(C1(C(CCO1)=O)O)O)=O,,,4,1,1,0,1
17414_0,,,,2,2,1,3
C(C(C=C)(C(C(C)=O)O)O)(O)=O,,,4,1,2,0,2
17416_0,,,,2,2,1,3
C(C(C=C)(C(C=O)(C)O)O)(O)=O,,,4,1,2,0,2
17418_0,,,,2,2,1,3
C(C(C1(C(C(CO1)O)=O)O)O)(C)=O,,,4,1,1,0,1
17420_0,,,,2,2,1,3
C(C(C)(C1(C(C(CO1)O)=O)O)O)=O,,,4,1,1,0,1
17422_0,,,,2,2,1,3
C1(C(CCO1)(C(C(C)=O)O)O)=O,,,4,1,2,0,2
17424_0,,,,2,2,1,3
C1(C(CCO1)(C(C=O)(C)O)O)=O,,,4,1,2,0,2
17426_0,,,,2,2,1,3
C(C(C)(C(CC(CO)=O)O)O)(O)=O,,,4,1,1,0,1
17428_0,,,,2,2,1,3
C(C(C)(C(CO)(CC=O)O)O)(O)=O,,,4,1,1,0,1
17430_0,,,,2,2,1,3
C(C(C)(C(CC(CO)=O)O)O)=O,,,4,1,1,0,1
17431_0,,,,2,2,1,3
17433_0,,,,2,2,1,3
C(C(C)(C(C(C(C)=O)O)O)O)(O)=O,,,4,1,1,0,1
17435_0,,,,2,2,1,3
C(C(C)(C(C)(C(C=O)O)O)O)(O)=O,,,4,1,1,0,1
17437_0,,,,2,2,1,3
C(C(C)(C(C(C(C)=O)O)O)O)=O,,,4,1,1,0,1
17439_0,,,,2,2,1,3
C(C(C)(C(C)(C(C=O)O)O)O)=O,,,4,1,1,0,1
17440_0,,,,2,2,1,3
17441_0,,,,2,2,1,3
17442_0,,,,2,2,1,3
17444_0,,,,2,2,1,3
C(CC(C(CO)=O)(C(C=O)O)O)=O,,,4,1,1,0,1
17445_0,,,,2,2,1,3
17446_0,,,,2,2,1,3
17447_0,,,,2,2,1,3
17448_0,,,,2,2,1,3
17449_0,,,,2,2,1,3
17451_0,,,,2,2,1,3
C(C(CC(C)=O)(C(C=O)O)O)(O)=O,,,4,1,1,0,1
17452_0,,,,2,2,1,3
17453_0,,,,2,2,1,3
17454_0,,,,2,2,1,3
17455_0,,,,2,2,1,3
17457_0,,,,2,2,1,3
C(C(C1(C(CCO1)=O)O)O)=O,,,4,1,3,0,3
17459_0,,,,2,2,1,3
C(C(C=C)(C(C=O)O)O)(O)=O,,,4,1,2,0,2
17461_0,,,,2,2,1,3
C(C(C1(C(C(CO1)O)=O)O)O)=O,,,4,1,1,0,1
17463_0,,,,2,2,1,3
C1(C(CCO1)(C(C=O)O)O)=O,,,4,1,2,0,2
17465_0,,,,2,2,1,3
C(C(C)(C(C)(C(CO)O)O)O)(O)=O,,,4,1,1,0,1
17467_0,,,,2,2,1,3
C(C(C)(C(C)(C(CO)O)O)O)=O,,,4,1,1,0,1
17469_0,,,,2,2,1,3
C(C(C=O)(CC(CO)=O)O)(O)=O,,,4,1,1,0,1
17470_0,,,,2,2,1,3
17471_0,,,,2,2,1,3
17472_0,,,,2,2,1,3
17473_0,,,,2,2,1,3
17474_0,,,,2,2,1,3
17475_0,,,,2,2,1,3
17476_0,,,,2,2,1,3
17478_0,,,,2,2,1,3
C1(C(CO)C(C(C1O)=O)(CO)O)=O,,,4,1,1,0,1
17479_0,,,,2,2,1,3
17481_0,,,,2,2,1,3
C(C1C(C(C(C1(CO)O)=O)O)O)=O,,,4,1,1,0,1
17482_0,,,,2,2,1,3
17483_0,,,,2,2,1,3
17484_0,,,,2,2,1,3
17486_0,,,,2,2,1,3
C(CO)(C(CO)(CC(C=O)=O)O)=O,,,4,1,2,0,2
17487_0,,,,2,2,1,3
17488_0,,,,2,2,1,3
17489_0,,,,2,2,1,3
17490_0,,,,2,2,1,3
17491_0,,,,2,2,1,3
17492_0,,,,2,2,1,3
17493_0,,,,2,2,1,3
17494_0,,,,2,2,1,3
17495_0,,,,2,2,1,3
17496_0,,,,2,2,1,3
17497_0,,,,2,2,1,3
17498_0,,,,2,2,1,3
17499_0,,,,2,2,1,3
17500_0,,,,2,2,1,3
17501_0,,,,2,2,1,3
17502_0,,,,2,2,1,3
17503_0,,,,2,2,1,3
17504_0,,,,2,2,1,3
17505_0,,,,2,2,1,3
17507_0,,,,2,2,1,3
C(C(CO)(OC(C(C)=O)CO)O)=O,,,4,1,1,0,1
17508_0,,,,2,2,1,3
17510_0,,,,2,2,1,3
C(C(CO)(O)OCC(C(C)=O)O)=O,,,4,1,1,0,1
17512_0,,,,2,2,1,3
C(C(CO)(O)OCCC(CO)=O)=O,,,4,1,1,0,1
17513_0,,,,2,2,1,3
17514_0,,,,2,2,1,3
17516_0,,,,2,2,1,3
C(C(CO)(CC(OCC=O)O)O)=O,,,4,1,1,0,1
17518_0,,,,2,2,1,3
C1(C(C(C(CO)C1(CO)O)O)O)=O,,,4,1,1,0,1
17519_0,,,,2,2,1,3
17520_0,,,,2,2,1,3
17521_0,,,,2,2,1,3
17522_0,,,,2,2,1,3
17523_0,,,,2,2,1,3
17524_0,,,,2,2,1,3
17525_0,,,,2,2,1,3
17526_0,,,,2,2,1,3
17528_0,,,,2,2,1,3
C(C(CO)(CCC(C=O)=O)O)=O,,,4,1,3,0,3
17530_0,,,,2,2,1,3
C(C(CO)(C)O)(CC(C=O)=O)=O,,,4,1,2,0,2
17532_0,,,,2,2,1,3
C(CC(C(C(C)=O)=O)(CO)O)=O,,,4,1,2,0,2
17534_0,,,,2,2,1,3
C(CC(C(C(CO)(C)O)=O)=O)=O,,,4,1,2,0,2
17536_0,,,,2,2,1,3
C(CC(C(C=O)=O)(CO)O)(C)=O,,,4,1,2,0,2
17538_0,,,,2,2,1,3
C(CCC(C(C=O)=O)(CO)O)=O,,,4,1,2,0,2
17540_0,,,,2,2,1,3
C1(C(CO)OC(CC1(CO)O)O)=O,,,4,1,2,0,2
17542_0,,,,2,2,1,3
C1(C(CO)(O)OC(CO)CC1O)=O,,,4,1,1,0,1
17544_0,,,,2,2,1,3
C1(C(O)OC(CO)CC1(CO)O)=O,,,4,1,2,0,2
17546_0,,,,2,2,1,3
C1(C(COC(CC1(CO)O)O)O)=O,,,4,1,2,0,2
17548_0,,,,2,2,1,3
C1(C(CO)(O)OCC(CC1O)O)=O,,,4,1,1,0,1
17550_0,,,,2,2,1,3
C1(C(O)OCC(CC1(CO)O)O)=O,,,4,1,2,0,2
17552_0,,,,2,2,1,3
C1(COC(C(CC1(CO)O)O)O)=O,,,4,1,2,0,2
17554_0,,,,2,2,1,3
C1(C(C(O)OCCC1(CO)O)O)=O,,,4,1,2,0,2
17555_0,,,,2,2,1,3
17557_0,,,,2,2,1,3
C(C(CO)(CCC(C(O)=O)O)O)=O,,,4,1,2,0,2
17558_0,,,,2,2,1,3
17560_0,,,,2,2,1,3
C(CC(C(O)=O)O)(C(CO)(C)O)=O,,,4,1,2,0,2
17562_0,,,,2,2,1,3
C(C(C(C(CO)(CCO)O)=O)=O)=O,,,4,1,1,0,1
17563_0,,,,2,2,1,3
17564_0,,,,2,2,1,3
17566_0,,,,2,2,1,3
C(C(CO)(C)O)(C(C(C=O)=O)O)=O,,,4,1,2,0,2
17567_0,,,,2,2,1,3
17569_0,,,,2,2,1,3
C(C(C(C=O)=O)(CO)O)=CCO,,,4,1,2,0,2
17571_0,,,,2,2,1,3
C(CO)(C(C=CC=O)(CO)O)=O,,,4,1,3,0,3
17573_0,,,,2,2,1,3
C(C(C=O)O)(C(C=C)(CO)O)=O,,,4,1,2,0,2
17574_0,,,,2,2,1,3
17575_0,,,,2,2,1,3
17576_0,,,,2,2,1,3
17577_0,,,,2,2,1,3
17578_0,,,,2,2,1,3
17579_0,,,,2,2,1,3
17580_0,,,,2,2,1,3
17581_0,,,,2,2,1,3
17582_0,,,,2,2,1,3
17583_0,,,,2,2,1,3
17584_0,,,,2,2,1,3
17585_0,,,,2,2,1,3
17586_0,,,,2,2,1,3
17588_0,,,,2,2,1,3
C1(CC(C(C)=O)OC1(CO)O)=O,,,4,1,2,0,2
17590_0,,,,2,2,1,3
C(C)(C1(CO)CC(C(O1)O)=O)=O,,,4,1,3,0,3
17592_0,,,,2,2,1,3
C(CC1CC(C(CO)(O)O1)=O)=O,,,4,1,2,0,2
17594_0,,,,2,2,1,3
C1(C(CO)(CC=O)OC(C1)O)=O,,,4,1,3,0,3
17596_0,,,,2,2,1,3
C1(C(CO)(CC(OCC1)=O)O)=O,,,4,1,2,0,2
17598_0,,,,2,2,1,3
C1(COCC(CC1(CO)O)=O)=O,,,4,1,2,0,2
17600_0,,,,2,2,1,3
C1(CCOC(C(C1)=O)(CO)O)=O,,,4,1,2,0,2
17602_0,,,,2,2,1,3
C1(CCC(C(CO)(OC1)O)=O)=O,,,4,1,2,0,2
17604_0,,,,2,2,1,3
C(C)(C(C=CC(O)=O)(CO)O)=O,,,4,1,2,0,2
17606_0,,,,2,2,1,3
C(C(C=CC(C)=O)(CO)O)(O)=O,,,4,1,3,0,3
17608_0,,,,2,2,1,3
C(C(C=CCC=O)(CO)O)(O)=O,,,4,1,3,0,3
17610_0,,,,2,2,1,3
C1(C(CO)(O)OCC1)=O,,,4,1,1,0,1
17612_0,,,,2,2,1,3
C1(C(CO)(CC=O)OCC1O)=O,,,4,1,1,0,1
17614_0,,,,2,2,1,3
C(C(C1(CO)CC(CO1)O)=O)=O,,,4,1,1,0,1
17616_0,,,,2,2,1,3
C(C1(CO)CC(C(C=O)O1)O)=O,,,4,1,1,0,1
17618_0,,,,2,2,1,3
C(C1(CO)CC(C(C)(O1)O)=O)=O,,,4,1,3,0,3
17620_0,,,,2,2,1,3
C(C1C(C(C(CO)(C)O1)=O)O)=O,,,4,1,1,0,1
17622_0,,,,2,2,1,3
C(C1C(C(C(CO)(O1)O)=O)O)(C)=O,,,4,1,1,0,1
17624_0,,,,2,2,1,3
C(CC1C(C(C(CO)(O)O1)=O)O)=O,,,4,1,1,0,1
17626_0,,,,2,2,1,3
C(C1(CO)CC(CC(O1)O)=O)=O,,,4,1,3,0,3
17628_0,,,,2,2,1,3
C1(C(C(CO)(O)OC(CO)C1)=O)=O,,,4,1,1,0,1
17630_0,,,,2,2,1,3
C1(C(CO)OC(C(C1)=O)(CO)O)=O,,,4,1,1,0,1
17632_0,,,,2,2,1,3
C1(C(C(CO)(O)OCC(C1)O)=O)=O,,,4,1,1,0,1
17634_0,,,,2,2,1,3
C1(C(COC(C(C1)=O)(CO)O)O)=O,,,4,1,1,0,1
17636_0,,,,2,2,1,3
C1(CCOC(C(C1O)=O)(CO)O)=O,,,4,1,1,0,1
17638_0,,,,2,2,1,3
C1(CC(C(C(CO)(OC1)O)=O)O)=O,,,4,1,1,0,1
17640_0,,,,2,2,1,3
C1(CC(C(C(OC1)O)=O)(CO)O)=O,,,4,1,2,0,2
17642_0,,,,2,2,1,3
C1(C(CO)(CC(C(C)=O)O1)O)=O,,,4,1,3,0,3
17644_0,,,,2,2,1,3
C1(C(CC(C(C)=O)(CO)O1)O)=O,,,4,1,2,0,2
17646_0,,,,2,2,1,3
C1(C(CO)(CC(CC=O)O1)O)=O,,,4,1,3,0,3
17648_0,,,,2,2,1,3
C1(C(CO)(CC(C(CO)O1)=O)O)=O,,,4,1,1,0,1
17650_0,,,,2,2,1,3
C1(C(CO)(CC(C(CO1)O)=O)O)=O,,,4,1,1,0,1
17652_0,,,,2,2,1,3
C1(C(CO)(CC(CCO1)=O)O)=O,,,4,1,3,0,3
17654_0,,,,2,2,1,3
C1(C(CO)(CCC(CO1)=O)O)=O,,,4,1,3,0,3
17656_0,,,,2,2,1,3
C(C(CO)(CCC(CO)=O)O)=O,,,4,1,3,0,3
17658_0,,,,2,2,1,3
C(C(CO)(CC(C(C)=O)O)O)=O,,,4,1,2,0,2
17660_0,,,,2,2,1,3
C(C(CC(C(C)=O)(CO)O)O)=O,,,4,1,2,0,2
17662_0,,,,2,2,1,3
C1C(CO)OC(C(C=1)=O)(CO)O,,,4,1,2,0,2
17664_0,,,,2,2,1,3
C1C(COC(C(C=1)=O)(CO)O)O,,,4,1,2,0,2
17666_0,,,,2,2,1,3
C(C(CO)(CC(C=C)=O)O)(O)=O,,,4,1,2,0,2
17668_0,,,,2,2,1,3
C(C(CO)(CC=CC=O)O)(O)=O,,,4,1,2,0,2
17670_0,,,,2,2,1,3
C(C(C(C=O)=O)(CO)O)=CC=O,,,4,1,2,0,2
17672_0,,,,2,2,1,3
C(C1(C=CC(CO)(O1)O)CO)=O,,,4,1,2,0,2
17674_0,,,,2,2,1,3
C1(C(C=CC(CO)O1)(CO)O)=O,,,4,1,2,0,2
17676_0,,,,2,2,1,3
C1(C(C=CC(CO1)O)(CO)O)=O,,,4,1,2,0,2
17678_0,,,,2,2,1,3
C(C(C=C)(CO)O)(O)=O,,,4,1,2,0,2
17680_0,,,,2,2,1,3
C(C(C=CC(CO)O)(CO)O)=O,,,4,1,2,0,2
17682_0,,,,2,2,1,3
C(C1(CO)CC(C(CO)(O1)O)O)=O,,,4,1,2,0,2
17684_0,,,,2,2,1,3
C(CO)(C1(CO)CC(C(O1)O)O)=O,,,4,1,2,0,2
17686_0,,,,2,2,1,3
C1(C(C(OC1(CO)CCO)O)O)=O,,,4,1,2,0,2
17688_0,,,,2,2,1,3
C1(C(CO)(CC(CCO)(O)O1)O)=O,,,4,1,2,0,2
17690_0,,,,2,2,1,3
C(C1(CO)CCC(CO)(O1)O)(O)=O,,,4,1,2,0,2
17692_0,,,,2,2,1,3
C(C1(CO)CC(C(C)(O1)O)O)(O)=O,,,4,1,2,0,2
17694_0,,,,2,2,1,3
C1(C(CO)(O)OCC1O)=O,,,4,1,1,0,1
17696_0,,,,2,2,1,3
C1(COC(CO)(CC1(CO)O)O)=O,,,4,1,2,0,2
17698_0,,,,2,2,1,3
C(C1(CO)CC(C(C(O1)O)O)O)=O,,,4,1,2,0,2
17700_0,,,,2,2,1,3
C1(C(C(C(OC1(CO)C)O)O)O)=O,,,4,1,2,0,2
17702_0,,,,2,2,1,3
C1(C(CO)(CCC(CO)(O)O1)O)=O,,,4,1,2,0,2
17704_0,,,,2,2,1,3
C1(C(CO)(CC(C(C)(O)O1)O)O)=O,,,4,1,2,0,2
17706_0,,,,2,2,1,3
C(C1(CO)CC(CC(O1)O)O)(O)=O,,,4,1,2,0,2
17708_0,,,,2,2,1,3
C1(C(CO)(CC(CC(O)O1)O)O)=O,,,4,1,2,0,2
17710_0,,,,2,2,1,3
C1(C(CO)(CCO1)O)=O,,,4,1,2,0,2
17711_0,,,,2,2,1,3
17712_0,,,,2,2,1,3
17713_0,,,,2,2,1,3
17714_0,,,,2,2,1,3
17716_0,,,,2,2,1,3
C(C(C)(C(CO)(CCO)O)O)(O)=O,,,4,1,1,0,1
17718_0,,,,2,2,1,3
C(C(C)(C(CO)(CCO)O)O)=O,,,4,1,1,0,1
17720_0,,,,2,2,1,3
C(C(C)(C(C(C=O)O)O)O)(O)=O,,,4,1,1,0,1
17722_0,,,,2,2,1,3
C(C(C(C(C(C=O)=O)(C)O)O)O)=O,,,4,1,2,0,2
17723_0,,,,2,2,1,3
17724_0,,,,2,2,1,3
17725_0,,,,2,2,1,3
17727_0,,,,2,2,1,3
C(C(C(C1(C(CCO1)=O)O)O)O)=O,,,4,1,1,0,1
17729_0,,,,2,2,1,3
C(C(C=C)(C(C(C=O)O)O)O)(O)=O,,,4,1,1,0,1
17731_0,,,,2,2,1,3
C1(C(C(C(C=O)O)O)(CCO1)O)=O,,,4,1,1,0,1
17733_0,,,,2,2,1,3
C(C)(C(C(CO)(C)O)(CC=O)O)=O,,,4,1,1,0,1
17735_0,,,,2,2,1,3
C(C(C)(C(CO)(C)O)O)(O)=O,,,4,1,1,0,1
17737_0,,,,2,2,1,3
C(C(C(C)(C(CO)(C)O)O)=O)=O,,,4,1,1,0,1
17739_0,,,,2,2,1,3
C(CO)(C(C)(C(CO)(C)O)O)=O,,,4,1,1,0,1
17740_0,,,,2,2,1,3
17741_0,,,,2,2,1,3
17742_0,,,,2,2,1,3
17744_0,,,,2,2,1,3
C(C(C)(C(CO)(C)O)O)=O,,,4,1,1,0,1
17746_0,,,,2,2,1,3
C1(C(C(CO)(C)O)(O)OCC1)=O,,,4,1,1,0,1
17748_0,,,,2,2,1,3
C(C(C=C)(C(CO)(C)O)O)(O)=O,,,4,1,2,0,2
17750_0,,,,2,2,1,3
C1(C(C(CO)(C)O)(O)OCC1O)=O,,,4,1,1,0,1
17752_0,,,,2,2,1,3
C1(C(CCO1)(C(CO)(C)O)O)=O,,,4,1,2,0,2
17754_0,,,,2,2,1,3
C(C(C(CCO)O)(CC=O)O)=O,,,4,1,1,0,1
17756_0,,,,2,2,1,3
C(C(C(CC(C)O)O)(CC=O)O)=O,,,4,1,1,0,1
17758_0,,,,2,2,1,3
C(C(C)(C(C(CC=O)O)O)O)(O)=O,,,4,1,1,0,1
17760_0,,,,2,2,1,3
C(C(C)(C(CC(C=O)O)O)O)(O)=O,,,4,1,1,0,1
17762_0,,,,2,2,1,3
C(CC(C(C=O)(CC=O)O)O)=O,,,4,1,2,0,2
17763_0,,,,2,2,1,3
17765_0,,,,2,2,1,3
C(C(C=O)(CC=O)O)(O)=O,,,4,1,1,0,1
17766_0,,,,2,2,1,3
17768_0,,,,2,2,1,3
C(C)(C(C)(C(C=O)(CC=O)O)O)=O,,,4,1,1,0,1
17770_0,,,,2,2,1,3
C(CC(C)(C(C=O)(CC=O)O)O)=O,,,4,1,1,0,1
17771_0,,,,2,2,1,3
17773_0,,,,2,2,1,3
C(C(C(C)(CCO)O)(CC=O)O)=O,,,4,1,1,0,1
17774_0,,,,2,2,1,3
17775_0,,,,2,2,1,3
17776_0,,,,2,2,1,3
17778_0,,,,2,2,1,3
C(C(C=C)(C(C=O)(CC=O)O)O)=O,,,4,1,1,0,1
17780_0,,,,2,2,1,3
C(CC(C=O)(C(C=C)(CO)O)O)=O,,,4,1,1,0,1
17781_0,,,,2,2,1,3
17782_0,,,,2,2,1,3
17784_0,,,,2,2,1,3
C(C(C)(C(CC(C=O)O)O)O)=O,,,4,1,1,0,1
17785_0,,,,2,2,1,3
17786_0,,,,2,2,1,3
17788_0,,,,2,2,1,3
C1(C(CO)C(C(C1)=O)(C(C)O)O)=O,,,4,1,1,0,1
17789_0,,,,2,2,1,3
17790_0,,,,2,2,1,3
17791_0,,,,2,2,1,3
17792_0,,,,2,2,1,3
17793_0,,,,2,2,1,3
17794_0,,,,2,2,1,3
17796_0,,,,2,2,1,3
C(C)(C(C(C)O)(CC=O)O)=O,,,4,1,1,0,1
17797_0,,,,2,2,1,3
17798_0,,,,2,2,1,3
17799_0,,,,2,2,1,3
17800_0,,,,2,2,1,3
17802_0,,,,2,2,1,3
C(CO)(C(C(C)O)(CC=O)O)=O,,,4,1,1,0,1
17804_0,,,,2,2,1,3
C(C(C)(C(C)O)O)(O)=O,,,4,1,1,0,1
17806_0,,,,2,2,1,3
C(C(C(C)(C(C)O)O)=O)=O,,,4,1,1,0,1
17808_0,,,,2,2,1,3
C(CO)(C(C)(C(C)O)O)=O,,,4,1,1,0,1
17809_0,,,,2,2,1,3
17810_0,,,,2,2,1,3
17811_0,,,,2,2,1,3
17813_0,,,,2,2,1,3
C(C(C(C)O)(CC(C)=O)O)(O)=O,,,4,1,1,0,1
17814_0,,,,2,2,1,3
17815_0,,,,2,2,1,3
17817_0,,,,2,2,1,3
C(C(C(C(C)(C(C)O)O)=O)O)=O,,,4,1,1,0,1
17819_0,,,,2,2,1,3
C(C(C)(C(C)O)O)=O,,,4,1,1,0,1
17821_0,,,,2,2,1,3
C(C(CCC(C=O)=O)(C(C)O)O)=O,,,4,1,2,0,2
17823_0,,,,2,2,1,3
C(C(C)(C(C)O)O)(CC(C=O)=O)=O,,,4,1,1,0,1
17825_0,,,,2,2,1,3
C(CC(C(C(C)=O)=O)(C(C)O)O)=O,,,4,1,1,0,1
17827_0,,,,2,2,1,3
C(CC(C(C(C)(C(C)O)O)=O)=O)=O,,,4,1,1,0,1
17829_0,,,,2,2,1,3
C(CC(C(C=O)=O)(C(C)O)O)(C)=O,,,4,1,1,0,1
17831_0,,,,2,2,1,3
C(CCC(C(C=O)=O)(C(C)O)O)=O,,,4,1,1,0,1
17833_0,,,,2,2,1,3
C(C(C(C=O)=O)(C(C)O)O)=CCO,,,4,1,1,0,1
17835_0,,,,2,2,1,3
C(CO)(C(C=CC=O)(C(C)O)O)=O,,,4,1,1,0,1
17837_0,,,,2,2,1,3
C(C(C=O)O)(C(C=C)(C(C)O)O)=O,,,4,1,1,0,1
17838_0,,,,2,2,1,3
17839_0,,,,2,2,1,3
17840_0,,,,2,2,1,3
17842_0,,,,2,2,1,3
C1(C(C(C)O)(CC(C1CO)=O)O)=O,,,4,1,1,0,1
17844_0,,,,2,2,1,3
C1(CC(C(C)=O)OC1(C(C)O)O)=O,,,4,1,1,0,1
17846_0,,,,2,2,1,3
C(C)(C1(C(C)O)CC(C(O1)O)=O)=O,,,4,1,2,0,2
17848_0,,,,2,2,1,3
C(CC1CC(C(C(C)O)(O)O1)=O)=O,,,4,1,1,0,1
17850_0,,,,2,2,1,3
C1(C(C(C)O)(CC=O)OC(C1)O)=O,,,4,1,2,0,2
17852_0,,,,2,2,1,3
C1(C(C(C)O)(CC(OCC1)=O)O)=O,,,4,1,1,0,1
17854_0,,,,2,2,1,3
C1(COCC(CC1(C(C)O)O)=O)=O,,,4,1,1,0,1
17856_0,,,,2,2,1,3
C1(CCOC(C(C1)=O)(C(C)O)O)=O,,,4,1,1,0,1
17858_0,,,,2,2,1,3
C1(CCC(C(C(C)O)(OC1)O)=O)=O,,,4,1,1,0,1
17860_0,,,,2,2,1,3
C(C)(C(C=CC(O)=O)(C(C)O)O)=O,,,4,1,1,0,1
17862_0,,,,2,2,1,3
C(C(C=CC(C)=O)(C(C)O)O)(O)=O,,,4,1,1,0,1
17864_0,,,,2,2,1,3
C(C(C=CCC=O)(C(C)O)O)(O)=O,,,4,1,1,0,1
17866_0,,,,2,2,1,3
C1(C(C(C)O)(O)OCC1)=O,,,4,1,1,0,1
17868_0,,,,2,2,1,3
C1(C(C(C)O)(CC=O)OCC1O)=O,,,4,1,1,0,1
17870_0,,,,2,2,1,3
C(C(C1(C(C)O)CC(CO1)O)=O)=O,,,4,1,1,0,1
17872_0,,,,2,2,1,3
C(C1(C(C)O)CC(C(C=O)O1)O)=O,,,4,1,1,0,1
17874_0,,,,2,2,1,3
C(C1(C(C)O)CC(C(C)(O1)O)=O)=O,,,4,1,2,0,2
17876_0,,,,2,2,1,3
C(C1C(C(C(C)(C(C)O)O1)=O)O)=O,,,4,1,1,0,1
17878_0,,,,2,2,1,3
C(C1(C(C)O)CC(CC(O1)O)=O)=O,,,4,1,2,0,2
17880_0,,,,2,2,1,3
C1(C(CC(C(C)=O)O1)(C(C)O)O)=O,,,4,1,1,0,1
17882_0,,,,2,2,1,3
C1(C(CC(C(C)=O)(C(C)O)O1)O)=O,,,4,1,1,0,1
17884_0,,,,2,2,1,3
C1(C(C(C)O)(CC(CC=O)O1)O)=O,,,4,1,1,0,1
17886_0,,,,2,2,1,3
C1(C(C(C)O)(CC(CCO1)=O)O)=O,,,4,1,1,0,1
17888_0,,,,2,2,1,3
C1(C(CCC(CO1)=O)(C(C)O)O)=O,,,4,1,1,0,1
17890_0,,,,2,2,1,3
C(C(CCC(CO)=O)(C(C)O)O)=O,,,4,1,2,0,2
17892_0,,,,2,2,1,3
C(C(CC(C(C)=O)O)(C(C)O)O)=O,,,4,1,1,0,1
17894_0,,,,2,2,1,3
C(C(CC(C(C)=O)(C(C)O)O)O)=O,,,4,1,2,0,2
17896_0,,,,2,2,1,3
C1C(CO)OC(C(C=1)=O)(C(C)O)O,,,4,1,1,0,1
17898_0,,,,2,2,1,3
C1C(COC(C(C=1)=O)(C(C)O)O)O,,,4,1,1,0,1
17900_0,,,,2,2,1,3
C(C(C(C)O)(CC(C=C)=O)O)(O)=O,,,4,1,1,0,1
17902_0,,,,2,2,1,3
C(C(C(C)O)(CC=CC=O)O)(O)=O,,,4,1,1,0,1
17904_0,,,,2,2,1,3
C(C(C(C=O)=O)(C(C)O)O)=CC=O,,,4,1,1,0,1
17906_0,,,,2,2,1,3
C(C1(C=CC(CO)(O1)O)C(C)O)=O,,,4,1,1,0,1
17908_0,,,,2,2,1,3
C1(C(C=CC(CO)O1)(C(C)O)O)=O,,,4,1,1,0,1
17910_0,,,,2,2,1,3
C1(C(C=CC(CO1)O)(C(C)O)O)=O,,,4,1,1,0,1
17912_0,,,,2,2,1,3
C(C(C=C)(C(C)O)O)(O)=O,,,4,1,2,0,2
17914_0,,,,2,2,1,3
C(C(C=CC(CO)O)(C(C)O)O)=O,,,4,1,1,0,1
17916_0,,,,2,2,1,3
C1(C(C(C)O)(O)OCC1O)=O,,,4,1,1,0,1
17918_0,,,,2,2,1,3
C1(C(C(C)O)(CCO1)O)=O,,,4,1,2,0,2
17919_0,,,,2,2,1,3
17920_0,,,,2,2,1,3
17921_0,,,,2,2,1,3
17922_0,,,,2,2,1,3
17923_0,,,,2,2,1,3
17924_0,,,,2,2,1,3
17925_0,,,,2,2,1,3
17926_0,,,,2,2,1,3
17927_0,,,,2,2,1,3
17928_0,,,,2,2,1,3
17930_0,,,,2,2,1,3
C(C(C1(C(CCO1)=O)O)O)(CO)=O,,,4,1,1,0,1
17932_0,,,,2,2,1,3
C(C(CO)(C1(C(CCO1)=O)O)O)=O,,,4,1,1,0,1
17934_0,,,,2,2,1,3
C(C(C=C)(C(C(CO)=O)O)O)(O)=O,,,4,1,1,0,1
17936_0,,,,2,2,1,3
C(C(C=C)(C(C=O)(CO)O)O)(O)=O,,,4,1,1,0,1
17938_0,,,,2,2,1,3
C1(C(CCO1)(C(C(CO)=O)O)O)=O,,,4,1,1,0,1
17940_0,,,,2,2,1,3
C1(C(CCO1)(C(C=O)(CO)O)O)=O,,,4,1,1,0,1
17941_0,,,,2,2,1,3
17942_0,,,,2,2,1,3
17944_0,,,,2,2,1,3
C(C(CC(C)O)(C(C(O)=O)O)O)=O,,,4,1,1,0,1
17945_0,,,,2,2,1,3
17947_0,,,,2,2,1,3
C(C(C(CC(C(C)=O)O)O)O)(O)=O,,,4,1,1,0,1
17948_0,,,,2,2,1,3
17950_0,,,,2,2,1,3
C(C(C)(CC(C(C(O)=O)O)O)O)=O,,,4,1,1,0,1
17952_0,,,,2,2,1,3
C(C(C(CCO)O)O)(O)=O,,,4,1,1,0,1
17954_0,,,,2,2,1,3
C(C(C(CO)(CC(C)O)O)O)(O)=O,,,4,1,1,0,1
17956_0,,,,2,2,1,3
C(C(C(C)(C(C(C)O)O)O)O)(O)=O,,,4,1,1,0,1
17958_0,,,,2,2,1,3
C(C(C(CC(CO)(C)O)O)O)(O)=O,,,4,1,1,0,1
17960_0,,,,2,2,1,3
C(C(C(CC(C)O)O)O)(O)=O,,,4,1,1,0,1
17962_0,,,,2,2,1,3
C(C(C(C(C(C)O)O)O)O)(O)=O,,,4,1,2,0,2
17963_0,,,,2,2,1,3
17964_0,,,,2,2,1,3
17965_0,,,,2,2,1,3
17966_0,,,,2,2,1,3
17967_0,,,,2,2,1,3
17968_0,,,,2,2,1,3
17969_0,,,,2,2,1,3
17970_0,,,,2,2,1,3
17971_0,,,,2,2,1,3
17972_0,,,,2,2,1,3
17973_0,,,,2,2,1,3
17974_0,,,,2,2,1,3
17975_0,,,,2,2,1,3
17976_0,,,,2,2,1,3
17977_0,,,,2,2,1,3
17978_0,,,,2,2,1,3
17979_0,,,,2,2,1,3
17980_0,,,,2,2,1,3
17982_0,,,,2,2,1,3
C(C(C(C(CC(C)=O)=O)O)O)(O)=O,,,4,1,1,0,1
17984_0,,,,2,2,1,3
C(C(C(C=O)(CC(C)=O)O)O)(O)=O,,,4,1,1,0,1
17985_0,,,,2,2,1,3
17986_0,,,,2,2,1,3
17987_0,,,,2,2,1,3
17988_0,,,,2,2,1,3
17989_0,,,,2,2,1,3
17990_0,,,,2,2,1,3
17992_0,,,,2,2,1,3
C(C(C)(C(C(O)=O)O)O)(CC=O)=O,,,4,1,1,0,1
17994_0,,,,2,2,1,3
C(C)(C(C)(C(C(O)=O)O)O)=O,,,4,1,2,0,2
17995_0,,,,2,2,1,3
17996_0,,,,2,2,1,3
17998_0,,,,2,2,1,3
C(C(C1(COC(C1)O)O)O)(O)=O,,,4,1,2,0,2
18000_0,,,,2,2,1,3
C(C(C(C)(CCO)O)O)(O)=O,,,4,1,1,0,1
18001_0,,,,2,2,1,3
18002_0,,,,2,2,1,3
18003_0,,,,2,2,1,3
18004_0,,,,2,2,1,3
18005_0,,,,2,2,1,3
18006_0,,,,2,2,1,3
18007_0,,,,2,2,1,3
18008_0,,,,2,2,1,3
18009_0,,,,2,2,1,3
18011_0,,,,2,2,1,3
C(C(C(C=CC(CO)=O)O)O)(O)=O,,,4,1,1,0,1
18013_0,,,,2,2,1,3
C(C(C(C=CC=O)(CO)O)O)(O)=O,,,4,1,1,0,1
18014_0,,,,2,2,1,3
18016_0,,,,2,2,1,3
C(C(C=C)(C(C(O)=O)O)O)=O,,,4,1,2,0,2
18018_0,,,,2,2,1,3
C(C(C(C=C)(CO)O)O)(O)=O,,,4,1,2,0,2
18019_0,,,,2,2,1,3
18020_0,,,,2,2,1,3
18021_0,,,,2,2,1,3
18022_0,,,,2,2,1,3
18023_0,,,,2,2,1,3
18025_0,,,,2,2,1,3
C(C(C1(COCC1O)O)O)(O)=O,,,4,1,1,0,1
18027_0,,,,2,2,1,3
C(C(C1(C(O)OCC1)O)O)(O)=O,,,4,1,2,0,2
18029_0,,,,2,2,1,3
C(C(C1(C(O)OCC1O)O)O)(O)=O,,,4,1,2,0,2
18031_0,,,,2,2,1,3
C(C(C(C)=O)(CC(C=O)=O)O)(O)=O,,,4,1,1,0,1
18033_0,,,,2,2,1,3
C(C(C(CC=O)=O)(CC=O)O)(O)=O,,,4,1,1,0,1
18035_0,,,,2,2,1,3
C(C(C=O)(CC(C(C)=O)=O)O)(O)=O,,,4,1,1,0,1
18037_0,,,,2,2,1,3
C(C(C=O)(CC(CC=O)=O)O)(O)=O,,,4,1,1,0,1
18039_0,,,,2,2,1,3
C(C(C=O)(C=CC(CO)=O)O)(O)=O,,,4,1,1,0,1
18041_0,,,,2,2,1,3
C(C(CCO)(C(CCO)O)O)(O)=O,,,4,1,1,0,1
18043_0,,,,2,2,1,3
C(C(C(CC=O)O)(CCO)O)(O)=O,,,4,1,1,0,1
18045_0,,,,2,2,1,3
C(C(C(O)=O)(CCO)O)(O)=O,,,4,1,1,0,1
18046_0,,,,2,2,1,3
18048_0,,,,2,2,1,3
C(C(CCO)(C(C(C)O)O)O)(O)=O,,,4,1,1,0,1
18049_0,,,,2,2,1,3
18050_0,,,,2,2,1,3
18051_0,,,,2,1,1,2
18052_0,,,,2,1,1,2
18052_1,,,,2,1,1,2
18053_0,,,,2,1,1,2
18053_1,,,,2,1,1,2
18054_0,,,,2,1,2,3
18054_1,,,,2,1,2,3
18055_0,,,,2,1,2,3
18055_1,,,,2,1,2,3
18056_0,,,,2,1,2,3
18056_1,,,,2,1,2,3
18057_0,,,,2,1,2,3
18057_1,,,,2,1,2,3
18058_0,,,,2,1,2,3
18058_1,,,,2,1,2,3
18059_0,,,,2,1,2,3
18061_0,,,,2,1,1,2
C(CCO)(OC(C=O)C(CO)O)=O,,,4,1,1,0,1
18062_0,,,,2,1,2,3
18064_0,,,,2,1,1,2
C(CCO)(OC(CO)C(C=O)O)=O,,,4,1,1,0,1
18065_0,,,,2,1,2,3
18067_0,,,,2,1,1,2
C(CCO)(OCC(C(C=O)O)O)=O,,,4,1,1,0,1
18068_0,,,,2,1,2,3
18068_1,,,,2,1,2,3
18069_0,,,,2,1,2,3
18069_1,,,,2,1,2,3
18070_0,,,,2,1,2,3
18071_0,,,,2,1,2,3
18072_0,,,,2,1,2,3
18073_0,,,,2,1,2,3
18074_0,,,,2,1,2,3
18075_0,,,,2,1,1,2
18076_0,,,,2,1,2,3
18077_0,,,,2,1,2,3
18078_0,,,,2,1,2,3
18079_0,,,,2,1,2,3
18080_0,,,,2,1,2,3
18081_0,,,,2,1,2,3
18082_0,,,,2,1,2,3
18083_0,,,,2,1,1,2
18084_0,,,,2,1,1,2
18085_0,,,,2,1,1,2
18086_0,,,,2,1,1,2
18087_0,,,,2,1,1,2
18088_0,,,,2,1,1,2
18089_0,,,,2,1,2,3
18090_0,,,,2,1,2,3
18091_0,,,,2,1,2,3
18092_0,,,,2,1,2,3
18093_0,,,,2,1,2,3
18094_0,,,,2,1,2,3
18095_0,,,,2,1,2,3
18096_0,,,,2,1,2,3
18097_0,,,,2,1,2,3
18098_0,,,,2,1,2,3
18099_0,,,,2,1,2,3
18100_0,,,,2,1,2,3
18101_0,,,,2,1,2,3
18102_0,,,,2,1,2,3
18103_0,,,,2,1,2,3
18104_0,,,,2,1,2,3
18105_0,,,,2,1,2,3
18106_0,,,,2,1,2,3
18107_0,,,,2,1,2,3
18108_0,,,,2,1,2,3
18109_0,,,,2,1,2,3
18110_0,,,,2,1,2,3
18111_0,,,,2,1,2,3
18112_0,,,,2,1,2,3
18113_0,,,,2,1,2,3
18114_0,,,,2,1,2,3
18115_0,,,,2,1,2,3
18116_0,,,,2,1,2,3
18117_0,,,,2,1,2,3
18118_0,,,,2,1,2,3
18119_0,,,,2,1,2,3
18120_0,,,,2,1,2,3
18122_0,,,,2,1,1,2
C(C(C(C)=O)OC(CO)=O)=O,,,4,1,2,0,2
18124_0,,,,2,1,1,2
C(CO)(OC(C=O)CC=O)=O,,,4,1,2,0,2
18126_0,,,,2,1,1,2
C(CO)(OCCC(C=O)=O)=O,,,4,1,2,0,2
18128_0,,,,2,1,1,2
C(CC(COC(CO)=O)=O)=O,,,4,1,2,0,2
18130_0,,,,2,1,1,2
C(C(CCO)(O)OC(CO)=O)=O,,,4,1,1,0,1
18132_0,,,,2,1,1,2
C(CC(CO)(O)OC(CO)=O)=O,,,4,1,1,0,1
18134_0,,,,2,1,1,2
C(C(C(C)(O)OC(CO)=O)O)=O,,,4,1,1,0,1
18136_0,,,,2,1,1,2
C(C(CC(O)OC(CO)=O)O)=O,,,4,1,1,0,1
18138_0,,,,2,1,2,3
[CH](C(O)=O)O,,,4,1,2,0,2
18139_0,,,,2,1,2,3
18140_0,,,,2,1,2,3
18141_0,,,,2,1,2,3
18142_0,,,,2,1,2,3
18143_0,,,,2,1,2,3
18144_0,,,,2,1,2,3
18145_0,,,,2,1,2,3
18146_0,,,,2,1,2,3
18147_0,,,,2,1,2,3
18148_0,,,,2,1,2,3
18149_0,,,,2,1,2,3
18150_0,,,,2,1,2,3
18151_0,,,,2,1,2,3
18152_0,,,,2,1,2,3
18153_0,,,,2,1,2,3
18154_0,,,,2,1,2,3
18156_0,,,,2,1,2,3
C1(C(C(C(C1C)O)O)=O)=O,,,4,1,1,0,1
18157_0,,,,2,1,2,3
18158_0,,,,2,1,2,3
18160_0,,,,2,1,2,3
C1(C(C)C(C(C1O)=O)O)=O,,,4,1,1,0,1
18161_0,,,,2,1,2,3
18162_0,,,,2,1,2,3
18164_0,,,,2,1,2,3
C1(CCC(C(C1)=O)=O)=O,,,4,1,3,0,3
18166_0,,,,2,1,2,3
C(C1C(C(CC1)=O)=O)=O,,,4,1,2,0,2
18168_0,,,,2,1,2,3
C1(CC(CC(C1)=O)=O)=O,,,4,1,1,0,1
18169_0,,,,2,1,2,3
18171_0,,,,2,1,2,3
C(C1C(CC(C1)=O)=O)=O,,,4,1,4,0,4
18173_0,,,,2,1,2,3
C(C1CC(C(C1)=O)=O)=O,,,4,1,2,0,2
18174_0,,,,2,1,2,3
18176_0,,,,2,1,2,3
C(C1C(CCC1=O)=O)=O,,,4,1,3,0,3
18177_0,,,,2,1,2,3
18178_0,,,,2,1,2,3
18179_0,,,,2,1,2,3
18180_0,,,,2,1,2,3
18182_0,,,,2,1,2,3
C(C1C(C(CC1O)=O)=O)=O,,,4,1,1,0,1
18184_0,,,,2,1,2,3
C(C1C(C(C(C1)=O)O)=O)=O,,,4,1,1,0,1
18185_0,,,,2,1,2,3
18186_0,,,,2,1,2,3
18187_0,,,,2,1,2,3
18188_0,,,,2,1,2,3
18190_0,,,,2,1,2,3
C1(CC=CC(C1O)=O)=O,,,4,1,2,0,2
18192_0,,,,2,1,2,3
C1(CC(C=CC1O)=O)=O,,,4,1,2,0,2
18193_0,,,,2,1,2,3
18194_0,,,,2,1,2,3
18195_0,,,,2,1,2,3
18196_0,,,,2,1,2,3
18197_0,,,,2,1,2,3
18198_0,,,,2,1,2,3
18199_0,,,,2,1,2,3
18200_0,,,,2,1,2,3
18202_0,,,,2,1,2,3
C(C(CO)=O)(C(CO)CO)=O,,,4,1,1,0,1
18203_0,,,,2,1,2,3
18205_0,,,,2,1,2,3
C(C(C(C(CO)=O)=O)C)=O,,,4,1,1,0,1
18207_0,,,,2,1,2,3
C(C(CO)CC(C=O)=O)=O,,,4,1,1,0,1
18208_0,,,,2,1,2,3
18210_0,,,,2,1,2,3
C(CC(CO)=O)(CC(CO)=O)=O,,,4,1,1,0,1
18211_0,,,,2,1,2,3
18213_0,,,,2,1,2,3
C(CC(C=O)C(C(CO)=O)O)=O,,,4,1,2,0,2
18215_0,,,,2,1,2,3
C(C(CO)C(C=O)C(CO)=O)=O,,,4,1,1,0,1
18216_0,,,,2,1,2,3
18217_0,,,,2,1,2,3
18218_0,,,,2,1,2,3
18220_0,,,,2,1,2,3
C(C(C(C)=O)O)(CC(CO)=O)=O,,,4,1,1,0,1
18222_0,,,,2,1,2,3
C(C(C(CO)=O)O)(CC(C)=O)=O,,,4,1,1,0,1
18223_0,,,,2,1,2,3
18225_0,,,,2,1,2,3
C(C(C(C(C(CO)=O)=O)C)O)=O,,,4,1,1,0,1
18227_0,,,,2,1,2,3
C(C(C(C(C=O)=O)C)O)(CO)=O,,,4,1,1,0,1
18228_0,,,,2,1,2,3
18229_0,,,,2,1,2,3
18230_0,,,,2,1,2,3
18232_0,,,,2,1,2,3
C(C(CO)=O)(C(C)C(CO)O)=O,,,4,1,1,0,1
18234_0,,,,2,1,2,3
C(CO)(C(C)C(C(CO)=O)O)=O,,,4,1,1,0,1
18235_0,,,,2,1,2,3
18236_0,,,,2,1,2,3
18237_0,,,,2,1,2,3
18238_0,,,,2,1,2,3
18239_0,,,,2,1,2,3
18240_0,,,,2,1,2,3
18241_0,,,,2,1,2,3
18243_0,,,,2,1,2,3
C(C(C(C(CO)=O)=O)CCO)=O,,,4,1,1,0,1
18245_0,,,,2,1,2,3
C(C(CO)C(C(C=O)=O)CO)=O,,,4,1,1,0,1
18247_0,,,,2,1,2,3
C(C(CO)=O)(C(CO)CCO)=O,,,4,1,1,0,1
18249_0,,,,2,1,2,3
C(C(CCO)C(C(CO)=O)O)=O,,,4,1,1,0,1
18250_0,,,,2,1,2,3
18251_0,,,,2,1,2,3
18253_0,,,,2,1,2,3
C(C(CO)C(C(CO)=O)CO)=O,,,4,1,1,0,1
18254_0,,,,2,1,2,3
18255_0,,,,2,1,2,3
18256_0,,,,2,1,2,3
18257_0,,,,2,1,2,3
18259_0,,,,2,1,2,3
C(C(CO)=O)(C(CO)C)=O,,,4,1,1,0,1
18261_0,,,,2,1,2,3
C(C(C)C(C(CO)=O)O)=O,,,4,1,1,0,1
18263_0,,,,2,1,2,3
C(C(CO)CC(CO)=O)=O,,,4,1,2,0,2
18264_0,,,,2,1,2,3
18266_0,,,,2,1,2,3
C(C(C)=O)(C(CO)CO)=O,,,4,1,1,0,1
18267_0,,,,2,1,2,3
18268_0,,,,2,1,2,3
18270_0,,,,2,1,2,3
C(CCC(C(C(CO)=O)O)=O)=O,,,4,1,1,0,1
18271_0,,,,2,1,2,3
18273_0,,,,2,1,2,3
C(C(CCC(C(CO)=O)=O)O)=O,,,4,1,1,0,1
18275_0,,,,2,1,2,3
C(C(CC(CC(CO)=O)=O)O)=O,,,4,1,3,0,3
18277_0,,,,2,1,2,3
C(C(C(C=O)C(C=O)CO)O)=O,,,4,1,1,0,1
18279_0,,,,2,1,2,3
C(C(CO)=O)(CC)=O,,,4,1,1,0,1
18280_0,,,,2,1,2,3
18282_0,,,,2,1,2,3
C(C(CO)CC=O)=O,,,4,1,2,0,2
18283_0,,,,2,1,2,3
18285_0,,,,2,1,2,3
C(C(C(C(CO)=O)=O)CO)=O,,,4,1,1,0,1
18286_0,,,,2,1,2,3
18287_0,,,,2,1,2,3
18289_0,,,,2,1,2,3
C(C(C(C(CO)CO)=O)=O)=O,,,4,1,1,0,1
18291_0,,,,2,1,2,3
C(CCO)(C(C=O)C(CO)=O)=O,,,4,1,2,0,2
18293_0,,,,2,1,2,3
C(C(C(CO)=O)CC(CO)=O)=O,,,4,1,3,0,3
18294_0,,,,2,1,2,3
18295_0,,,,2,1,2,3
18296_0,,,,2,1,2,3
18297_0,,,,2,1,2,3
18298_0,,,,2,1,2,3
18299_0,,,,2,1,2,3
18300_0,,,,2,1,2,3
18301_0,,,,2,1,2,3
18302_0,,,,2,1,2,3
18304_0,,,,2,1,2,3
C(C(C(CCC(CO)=O)=O)O)=O,,,4,1,2,0,2
18305_0,,,,2,1,2,3
18306_0,,,,2,1,2,3
18307_0,,,,2,1,2,3
18308_0,,,,2,1,2,3
18309_0,,,,2,1,2,3
18310_0,,,,2,1,2,3
18311_0,,,,2,1,2,3
18312_0,,,,2,1,2,3
18313_0,,,,2,1,2,3
18314_0,,,,2,1,2,3
18315_0,,,,2,1,2,3
18316_0,,,,2,1,2,3
18317_0,,,,2,1,2,3
18318_0,,,,2,1,2,3
18319_0,,,,2,1,2,3
18320_0,,,,2,1,2,3
18321_0,,,,2,1,2,3
18322_0,,,,2,1,2,3
18323_0,,,,2,1,2,3
18324_0,,,,2,1,2,3
18325_0,,,,2,1,2,3
18326_0,,,,2,1,2,3
18328_0,,,,2,1,2,3
C(CCO)(C(C=O)C(C=O)O)=O,,,4,1,2,0,2
18330_0,,,,2,1,2,3
C(C(C(C=O)CC(CO)=O)O)=O,,,4,1,2,0,2
18331_0,,,,2,1,2,3
18332_0,,,,2,1,2,3
18333_0,,,,2,1,2,3
18334_0,,,,2,1,2,3
18335_0,,,,2,1,2,3
18336_0,,,,2,1,2,3
18338_0,,,,2,1,2,3
C(CC(C=O)CC(C=O)=O)=O,,,4,1,2,0,2
18340_0,,,,2,1,2,3
C(CC=O)(CC(C(C)=O)=O)=O,,,4,1,2,0,2
18342_0,,,,2,1,2,3
C(CC(C(CC(C)=O)=O)=O)=O,,,4,1,1,0,1
18344_0,,,,2,1,2,3
C(C(C(C(CC=O)=O)=O)C)=O,,,4,1,1,0,1
18346_0,,,,2,1,2,3
C(CC(C)=O)(CC(C=O)=O)=O,,,4,1,1,0,1
18348_0,,,,2,1,2,3
C(C(CCC(C(C)=O)=O)=O)=O,,,4,1,2,0,2
18350_0,,,,2,1,2,3
C(C=O)(C(C)CC(C=O)=O)=O,,,4,1,1,0,1
18352_0,,,,2,1,2,3
C(CO)(C(C)CC(C=O)=O)=O,,,4,1,1,0,1
18353_0,,,,2,1,2,3
18354_0,,,,2,1,2,3
18355_0,,,,2,1,2,3
18356_0,,,,2,1,2,3
18357_0,,,,2,1,2,3
18358_0,,,,2,1,2,3
18360_0,,,,2,1,2,3
C(C(CCO)CC(C=O)=O)=O,,,4,1,1,0,1
18362_0,,,,2,1,2,3
C(CCO)(CC(C(C)=O)=O)=O,,,4,1,1,0,1
18364_0,,,,2,1,2,3
C(C)(CC(C(CCO)=O)=O)=O,,,4,1,1,0,1
18366_0,,,,2,1,2,3
C(C(C(C(CCO)=O)=O)C)=O,,,4,1,1,0,1
18367_0,,,,2,1,2,3
18369_0,,,,2,1,2,3
C(C(CCC(C=O)=O)=O)=O,,,4,1,2,0,2
18371_0,,,,2,1,2,3
C(C(C)CC(C=O)=O)=O,,,4,1,1,0,1
18373_0,,,,2,1,2,3
C(C)(CC(C(C)=O)=O)=O,,,4,1,3,0,3
18375_0,,,,2,1,2,3
C(C(C(C(C)=O)=O)C)=O,,,4,1,1,0,1
18377_0,,,,2,1,2,3
C(CCC(CC(C=O)=O)=O)=O,,,4,1,1,0,1
18379_0,,,,2,1,2,3
C(CC(CCC(C=O)=O)=O)=O,,,4,1,2,0,2
18380_0,,,,2,1,2,3
18382_0,,,,2,1,2,3
C(C(C(CCC(C=O)=O)=O)O)=O,,,4,1,2,0,2
18383_0,,,,2,1,2,3
18384_0,,,,2,1,2,3
18386_0,,,,2,1,2,3
C(C(C=O)CC(C=O)=O)=O,,,4,1,1,0,1
18388_0,,,,2,1,2,3
C(C(C(C(C=O)=O)=O)C)=O,,,4,1,1,0,1
18390_0,,,,2,1,2,3
C(C(C(CO)O)CC(C=O)=O)=O,,,4,1,1,0,1
18391_0,,,,2,1,2,3
18392_0,,,,2,1,2,3
18393_0,,,,2,1,2,3
18394_0,,,,2,1,2,3
18395_0,,,,2,1,2,3
18396_0,,,,2,1,2,3
18397_0,,,,2,1,2,3
18399_0,,,,2,1,2,3
C(C(C(C(C(CO)O)=O)=O)C)=O,,,4,1,1,0,1
18400_0,,,,2,1,2,3
18401_0,,,,2,1,2,3
18402_0,,,,2,1,2,3
18403_0,,,,2,1,2,3
18405_0,,,,2,1,2,3
C(C(C(CO)=O)CC(C=O)=O)=O,,,4,1,2,0,2
18406_0,,,,2,1,2,3
18407_0,,,,2,1,2,3
18409_0,,,,2,1,2,3
C(CC(C(CC=O)=O)=O)=O,,,4,1,1,0,1
18410_0,,,,2,1,2,3
18411_0,,,,2,1,2,3
18412_0,,,,2,1,2,3
18414_0,,,,2,1,2,3
C(C(C(CC=O)=O)C(CO)=O)=O,,,4,1,1,0,1
18415_0,,,,2,1,2,3
18416_0,,,,2,1,2,3
18418_0,,,,2,1,2,3
C(CC(CC(C(C=O)O)=O)=O)=O,,,4,1,2,0,2
18420_0,,,,2,1,2,3
C(CC(C(C(CC=O)=O)O)=O)=O,,,4,1,1,0,1
18421_0,,,,2,1,2,3
18423_0,,,,2,1,2,3
C(C(C)C(C=O)C(CO)=O)=O,,,4,1,1,0,1
18425_0,,,,2,1,2,3
C(CC(C(C(C)CO)=O)=O)=O,,,4,1,1,0,1
18427_0,,,,2,1,2,3
C(C(C)C(C(CC=O)=O)O)=O,,,4,1,1,0,1
18428_0,,,,2,1,2,3
18430_0,,,,2,1,2,3
C(CC(C)=O)(CC(CO)=O)=O,,,4,1,1,0,1
18432_0,,,,2,1,2,3
C(CO)(CCC(C(C)=O)=O)=O,,,4,1,1,0,1
18434_0,,,,2,1,2,3
C(CC(C=O)C(C(C)=O)O)=O,,,4,1,2,0,2
18436_0,,,,2,1,2,3
C(CC(C(C(C)=O)=O)CO)=O,,,4,1,2,0,2
18438_0,,,,2,1,2,3
C(CC(C(CC)=O)=O)=O,,,4,1,1,0,1
18439_0,,,,2,1,2,3
18440_0,,,,2,1,2,3
18442_0,,,,2,1,2,3
C(CC(C(CC(CO)=O)=O)=O)=O,,,4,1,1,0,1
18444_0,,,,2,1,2,3
C(CC=O)(CC(C(CO)=O)=O)=O,,,4,1,1,0,1
18446_0,,,,2,1,2,3
C(C(C=O)C(C=O)C(CO)=O)=O,,,4,1,1,0,1
18448_0,,,,2,1,2,3
C(C(C(C(CC=O)=O)=O)CO)=O,,,4,1,1,0,1
18449_0,,,,2,1,2,3
18451_0,,,,2,1,2,3
C(CC(CO)=O)(CC(C=O)=O)=O,,,4,1,1,0,1
18453_0,,,,2,1,2,3
C(CO)(CCC(C(C=O)=O)=O)=O,,,4,1,1,0,1
18455_0,,,,2,1,2,3
C(CC(C=O)C(C(C=O)=O)O)=O,,,4,1,2,0,2
18456_0,,,,2,1,2,3
18457_0,,,,2,1,2,3
18458_0,,,,2,1,2,3
18460_0,,,,2,1,2,3
C(C(C)CC(C(C=O)O)=O)=O,,,4,1,1,0,1
18462_0,,,,2,1,2,3
C(CC(C(C=O)=O)C)(CO)=O,,,4,1,1,0,1
18464_0,,,,2,1,2,3
C(C(C(C)=O)O)(CC(C)=O)=O,,,4,1,1,0,1
18465_0,,,,2,1,2,3
18467_0,,,,2,1,2,3
C(C(C(C(C=O)=O)C)O)(C)=O,,,4,1,1,0,1
18469_0,,,,2,1,2,3
C(C(C(C(C(C)=O)=O)C)O)=O,,,4,1,1,0,1
18470_0,,,,2,1,2,3
18472_0,,,,2,1,2,3
C(CCC(C(C)=O)=O)=O,,,4,1,3,0,3
18474_0,,,,2,1,2,3
C(CC(C(C=O)=O)C)=O,,,4,1,1,0,1
18476_0,,,,2,1,2,3
C(C(C=O)CC(C(C=O)O)=O)=O,,,4,1,1,0,1
18478_0,,,,2,1,2,3
C(C(C(C=O)=O)O)(CC(C)=O)=O,,,4,1,1,0,1
18480_0,,,,2,1,2,3
C(C(C(C)=O)O)(CC(C=O)=O)=O,,,4,1,1,0,1
18481_0,,,,2,1,2,3
18482_0,,,,2,1,2,3
18484_0,,,,2,1,2,3
C(C=O)(C(C)C(C(C=O)=O)O)=O,,,4,1,1,0,1
18486_0,,,,2,1,2,3
C(C(C(C(C(C=O)=O)=O)C)O)=O,,,4,1,1,0,1
18487_0,,,,2,1,2,3
18488_0,,,,2,1,2,3
18490_0,,,,2,1,2,3
C(C(CC(C=O)=O)=O)=O,,,4,1,2,0,2
18492_0,,,,2,1,2,3
C(CC(C(C=O)=O)=O)=O,,,4,1,1,0,1
18493_0,,,,2,1,2,3
18495_0,,,,2,1,2,3
C(CC(C(C(CO)O)=O)=O)=O,,,4,1,1,0,1
18496_0,,,,2,1,2,3
18497_0,,,,2,1,2,3
18498_0,,,,2,1,2,3
18499_0,,,,2,1,2,3
18500_0,,,,2,1,2,3
18501_0,,,,2,1,2,3
18502_0,,,,2,1,2,3
18503_0,,,,2,1,2,3
18504_0,,,,2,1,2,3
18505_0,,,,2,1,2,3
18507_0,,,,2,1,2,3
C(C(C)CC(C(CO)O)=O)=O,,,4,1,1,0,1
18509_0,,,,2,1,2,3
C(CO)(C(C)CC(CO)=O)=O,,,4,1,1,0,1
18510_0,,,,2,1,2,3
18511_0,,,,2,1,2,3
18513_0,,,,2,1,2,3
C(CO)(C(C)C(C(C)=O)O)=O,,,4,1,1,0,1
18514_0,,,,2,1,2,3
18515_0,,,,2,1,2,3
18517_0,,,,2,1,2,3
C(C(C)=O)(C(C)C(CO)O)=O,,,4,1,1,0,1
18518_0,,,,2,1,2,3
18519_0,,,,2,1,2,3
18521_0,,,,2,1,2,3
C(CO)(C(C)CC=O)=O,,,4,1,1,0,1
18522_0,,,,2,1,2,3
18523_0,,,,2,1,2,3
18524_0,,,,2,1,2,3
18525_0,,,,2,1,2,3
18526_0,,,,2,1,2,3
18527_0,,,,2,1,2,3
18529_0,,,,2,1,2,3
C(C(C=O)CC(C(CO)O)=O)=O,,,4,1,1,0,1
18531_0,,,,2,1,2,3
C(CO)(C(C)C(C(C=O)=O)O)=O,,,4,1,1,0,1
18532_0,,,,2,1,2,3
18533_0,,,,2,1,2,3
18535_0,,,,2,1,2,3
C(C(C(C(C)C(CO)O)=O)=O)=O,,,4,1,1,0,1
18537_0,,,,2,1,2,3
C(C(CC(C(CC)=O)=O)O)=O,,,4,1,1,0,1
18539_0,,,,2,1,2,3
C(C(CC(CC(C)=O)=O)O)=O,,,4,1,2,0,2
18541_0,,,,2,1,2,3
C(CC(CCC(CO)=O)=O)=O,,,4,1,1,0,1
18543_0,,,,2,1,2,3
C(CCC(CC(CO)=O)=O)=O,,,4,1,1,0,1
18545_0,,,,2,1,2,3
C(C(CC(C=O)CC=O)O)=O,,,4,1,2,0,2
18546_0,,,,2,1,2,3
18547_0,,,,2,1,2,3
18548_0,,,,2,1,2,3
18549_0,,,,2,1,2,3
18550_0,,,,2,1,2,3
18552_0,,,,2,1,2,3
C(C(C(C)=O)=O)(CC(CO)O)=O,,,4,1,1,0,1
18553_0,,,,2,1,2,3
18554_0,,,,2,1,2,3
18555_0,,,,2,1,2,3
18556_0,,,,2,1,2,3
18557_0,,,,2,1,2,3
18558_0,,,,2,1,2,3
18559_0,,,,2,1,2,3
18560_0,,,,2,1,2,3
18562_0,,,,2,1,2,3
C(CC(C(CC(C=O)O)O)=O)=O,,,4,1,1,0,1
18564_0,,,,2,1,2,3
C(C(CC(C(C(C)=O)=O)O)O)=O,,,4,1,1,0,1
18565_0,,,,2,1,2,3
18567_0,,,,2,1,2,3
C(CCO)(C(C(C(C)=O)=O)O)=O,,,4,1,1,0,1
18568_0,,,,2,1,2,3
18569_0,,,,2,1,2,3
18570_0,,,,2,1,2,3
18571_0,,,,2,1,2,3
18572_0,,,,2,1,2,3
18573_0,,,,2,1,2,3
18574_0,,,,2,1,2,3
18575_0,,,,2,1,2,3
18576_0,,,,2,1,2,3
18577_0,,,,2,1,2,3
18578_0,,,,2,1,2,3
18579_0,,,,2,1,2,3
18580_0,,,,2,1,2,3
18581_0,,,,2,1,2,3
18582_0,,,,2,1,2,3
18583_0,,,,2,1,2,3
18584_0,,,,2,1,2,3
18585_0,,,,2,1,2,3
18586_0,,,,2,1,2,3
18587_0,,,,2,1,2,3
18588_0,,,,2,1,2,3
18589_0,,,,2,1,2,3
18590_0,,,,2,1,2,3
18591_0,,,,2,1,2,3
18592_0,,,,2,1,2,3
18593_0,,,,2,1,2,3
18594_0,,,,2,1,2,3
18595_0,,,,2,1,2,3
18597_0,,,,2,1,2,3
C(CC(CC(CC=O)=O)=O)=O,,,4,1,1,0,1
18598_0,,,,2,1,2,3
18599_0,,,,2,1,2,3
18600_0,,,,2,1,2,3
18601_0,,,,2,1,2,3
18602_0,,,,2,1,2,3
18603_0,,,,2,1,2,3
18604_0,,,,2,1,2,3
18605_0,,,,2,1,2,3
18606_0,,,,2,1,2,3
18607_0,,,,2,1,2,3
18608_0,,,,2,1,2,3
18609_0,,,,2,1,2,3
18610_0,,,,2,1,2,3
18611_0,,,,2,1,2,3
18612_0,,,,2,1,2,3
18613_0,,,,2,1,2,3
18614_0,,,,2,1,2,3
18615_0,,,,2,1,2,3
18616_0,,,,2,1,2,3
18617_0,,,,2,1,2,3
18618_0,,,,2,1,2,3
18619_0,,,,2,1,2,3
18620_0,,,,2,1,2,3
18621_0,,,,2,1,2,3
18622_0,,,,2,1,2,3
18623_0,,,,2,1,2,3
18624_0,,,,2,1,2,3
18625_0,,,,2,1,2,3
18626_0,,,,2,1,2,3
18627_0,,,,2,1,2,3
18628_0,,,,2,1,2,3
18629_0,,,,2,1,2,3
18630_0,,,,2,1,2,3
18631_0,,,,2,1,2,3
18632_0,,,,2,1,2,3
18633_0,,,,2,1,2,3
18634_0,,,,2,1,2,3
18635_0,,,,2,1,2,3
18636_0,,,,2,1,2,3
18637_0,,,,2,1,2,3
18638_0,,,,2,1,2,3
18639_0,,,,2,1,2,3
18640_0,,,,2,1,2,3
18641_0,,,,2,1,2,3
18642_0,,,,2,1,2,3
18644_0,,,,2,1,2,3
C(CCC(C(O)=O)O)(CC=O)=O,,,4,1,1,0,1
18646_0,,,,2,1,2,3
C(C(CCC(C(C)=O)=O)O)(O)=O,,,4,1,1,0,1
18647_0,,,,2,1,2,3
18648_0,,,,2,1,2,3
18649_0,,,,2,1,2,3
18650_0,,,,2,1,2,3
18651_0,,,,2,1,2,3
18652_0,,,,2,1,2,3
18653_0,,,,2,1,2,3
18654_0,,,,2,1,2,3
18655_0,,,,2,1,2,3
18656_0,,,,2,1,2,3
18658_0,,,,2,1,2,3
C(CC(C=CC(C=O)O)=O)=O,,,4,1,1,0,1
18660_0,,,,2,1,2,3
C(C(C=CC(C(C)=O)=O)O)=O,,,4,1,1,0,1
18661_0,,,,2,1,2,3
18662_0,,,,2,1,2,3
18663_0,,,,2,1,2,3
18664_0,,,,2,1,2,3
18666_0,,,,2,1,2,3
C(C=O)(C(CO)CC(C=O)=O)=O,,,4,1,1,0,1
18668_0,,,,2,1,2,3
C(C(C)C(C(C=O)=O)CO)=O,,,4,1,1,0,1
18670_0,,,,2,1,2,3
C(C(C(C(C)=O)=O)CCO)=O,,,4,1,1,0,1
18672_0,,,,2,1,2,3
C(C(C=O)C(C(C=O)=O)CO)=O,,,4,1,1,0,1
18674_0,,,,2,1,2,3
C(C(C(C(C=O)=O)=O)CCO)=O,,,4,1,1,0,1
18675_0,,,,2,1,2,3
18676_0,,,,2,1,2,3
18677_0,,,,2,1,2,3
18678_0,,,,2,1,2,3
18679_0,,,,2,1,2,3
18680_0,,,,2,1,2,3
18682_0,,,,2,1,2,3
C(C(CCO)=O)(C(C)CO)=O,,,4,1,1,0,1
18684_0,,,,2,1,2,3
C(C(C)C(C(CCO)=O)O)=O,,,4,1,1,0,1
18686_0,,,,2,1,2,3
C(C(C)C(C(CO)=O)CO)=O,,,4,1,1,0,1
18688_0,,,,2,1,2,3
C(C(CCO)CC(CO)=O)=O,,,4,1,2,0,2
18690_0,,,,2,1,2,3
C(C(CCO)C(C(C)=O)O)=O,,,4,1,1,0,1
18692_0,,,,2,1,2,3
C(C(C)=O)(C(CO)CCO)=O,,,4,1,1,0,1
18694_0,,,,2,1,2,3
C(C(CCO)=O)(CC)=O,,,4,1,1,0,1
18696_0,,,,2,1,2,3
C(CCO)(CC(C)=O)=O,,,4,1,1,0,1
18698_0,,,,2,1,2,3
C(C(CCO)CC=O)=O,,,4,1,2,0,2
18699_0,,,,2,1,2,3
18700_0,,,,2,1,2,3
18702_0,,,,2,1,2,3
C(C(C=O)C(C(CO)=O)CO)=O,,,4,1,1,0,1
18704_0,,,,2,1,2,3
C(C(CCO)C(C(C=O)=O)O)=O,,,4,1,1,0,1
18706_0,,,,2,1,2,3
C(C(C(C(CO)CCO)=O)=O)=O,,,4,1,1,0,1
18707_0,,,,2,1,2,3
18708_0,,,,2,1,2,3
18709_0,,,,2,1,2,3
18711_0,,,,2,1,2,3
C(CCC(C(C(C)=O)O)=O)=O,,,4,1,1,0,1
18712_0,,,,2,1,2,3
18713_0,,,,2,1,2,3
18714_0,,,,2,1,2,3
18715_0,,,,2,1,2,3
18717_0,,,,2,1,2,3
C(C(C)CC=O)(C(C=O)O)=O,,,4,1,1,0,1
18719_0,,,,2,1,2,3
C(C(C(CC=O)=O)C(C=O)O)=O,,,4,1,1,0,1
18721_0,,,,2,1,2,3
C(C(C(C=O)CC(C=O)=O)O)=O,,,4,1,1,0,1
18722_0,,,,2,1,2,3
18723_0,,,,2,1,2,3
18725_0,,,,2,1,2,3
C(CC(C(C(C=O)=O)O)=O)=O,,,4,1,2,0,2
18727_0,,,,2,1,2,3
C(C(C(CC(C=O)=O)=O)O)=O,,,4,1,2,0,2
18728_0,,,,2,1,2,3
18729_0,,,,2,1,2,3
18731_0,,,,2,1,2,3
C(C(C)CC(CO)=O)=O,,,4,1,1,0,1
18733_0,,,,2,1,2,3
C(C(C)=O)(C(C)CO)=O,,,4,1,1,0,1
18735_0,,,,2,1,2,3
C(C(C)C(C(C)=O)O)=O,,,4,1,1,0,1
18737_0,,,,2,1,2,3
C(C(CCC(C(C)=O)=O)O)=O,,,4,1,1,0,1
18738_0,,,,2,1,2,3
18740_0,,,,2,1,2,3
C(C(C(C=O)C(C=O)C)O)=O,,,4,1,1,0,1
18741_0,,,,2,1,2,3
18742_0,,,,2,1,2,3
18743_0,,,,2,1,2,3
18744_0,,,,2,1,2,3
18745_0,,,,2,1,2,3
18746_0,,,,2,1,2,3
18748_0,,,,2,1,2,3
C(C(CC(C(C(C)=O)O)=O)O)=O,,,4,1,2,0,2
18749_0,,,,2,1,2,3
18750_0,,,,2,1,2,3
18751_0,,,,2,1,2,3
18753_0,,,,2,1,2,3
C(C(C)=O)(CC)=O,,,4,1,1,0,1
18755_0,,,,2,1,2,3
C(C)(CC(C)=O)=O,,,4,1,1,0,1
18757_0,,,,2,1,2,3
C(C(C)CC=O)=O,,,4,1,1,0,1
18758_0,,,,2,1,2,3
18759_0,,,,2,1,2,3
18760_0,,,,2,1,2,3
18762_0,,,,2,1,2,3
C(C(C)C(C(C=O)=O)O)=O,,,4,1,1,0,1
18764_0,,,,2,1,2,3
C(C(C(C(C)CO)=O)=O)=O,,,4,1,1,0,1
18766_0,,,,2,1,2,3
C(C(C(CO)O)CC(CO)=O)=O,,,4,1,2,0,2
18767_0,,,,2,1,2,3
18768_0,,,,2,1,2,3
18769_0,,,,2,1,2,3
18770_0,,,,2,1,2,3
18771_0,,,,2,1,2,3
18772_0,,,,2,1,2,3
18773_0,,,,2,1,2,3
18774_0,,,,2,1,2,3
18776_0,,,,2,1,2,3
C(C(C)C(C(C(CO)O)=O)O)=O,,,4,1,1,0,1
18778_0,,,,2,1,2,3
C(C(C(CO)O)=O)(C(CO)C)=O,,,4,1,1,0,1
18779_0,,,,2,1,2,3
18780_0,,,,2,1,2,3
18781_0,,,,2,1,2,3
18782_0,,,,2,1,2,3
18783_0,,,,2,1,2,3
18784_0,,,,2,1,2,3
18785_0,,,,2,1,2,3
18786_0,,,,2,1,2,3
18787_0,,,,2,1,2,3
18788_0,,,,2,1,2,3
18790_0,,,,2,1,2,3
C(C(C=O)C(C=O)C(C=O)O)=O,,,4,1,1,0,1
18792_0,,,,2,1,2,3
C(CCC(C(C(C=O)=O)O)=O)=O,,,4,1,1,0,1
18794_0,,,,2,1,2,3
C(CC(C(CC(C=O)=O)=O)O)=O,,,4,1,1,0,1
18795_0,,,,2,1,2,3
18796_0,,,,2,1,2,3
18797_0,,,,2,1,2,3
18799_0,,,,2,1,2,3
C(C(CCC(C(C=O)=O)=O)O)=O,,,4,1,1,0,1
18801_0,,,,2,1,2,3
C(C(C=O)CC=O)=O,,,4,1,1,0,1
18802_0,,,,2,1,2,3
18804_0,,,,2,1,2,3
C(C(C(CC)=O)=O)=O,,,4,1,1,0,1
18806_0,,,,2,1,2,3
C(C(C(CO)O)CC=O)=O,,,4,1,2,0,2
18808_0,,,,2,1,2,3
C(CO)(C(CO)CC=O)=O,,,4,1,3,0,3
18809_0,,,,2,1,2,3
18810_0,,,,2,1,2,3
18811_0,,,,2,1,2,3
18813_0,,,,2,1,2,3
C(C(C(CO)O)=O)(CC)=O,,,4,1,1,0,1
18814_0,,,,2,1,2,3
18815_0,,,,2,1,2,3
18817_0,,,,2,1,2,3
C(C(CCC(C=O)=O)CC=O)=O,,,4,1,1,0,1
18819_0,,,,2,1,2,3
C(CCC(C=O)=O)(CC(C)=O)=O,,,4,1,1,0,1
18821_0,,,,2,1,2,3
C(C(CCC(C=O)=O)=O)(CC)=O,,,4,1,1,0,1
18823_0,,,,2,1,2,3
C(C(C)CC=O)(CC(C=O)=O)=O,,,4,1,1,0,1
18825_0,,,,2,1,2,3
C(CC(CC(C=O)CC=O)=O)=O,,,4,1,4,0,4
18827_0,,,,2,1,2,3
C(CC(CC(CC(C)=O)=O)=O)=O,,,4,1,2,0,2
18829_0,,,,2,1,2,3
C(CC=O)(CC(C(CC)=O)=O)=O,,,4,1,1,0,1
18831_0,,,,2,1,2,3
C(CC(C(C(C)=O)=O)CC=O)=O,,,4,1,3,0,3
18833_0,,,,2,1,2,3
C(CC(C(C(C)CC=O)=O)=O)=O,,,4,1,1,0,1
18835_0,,,,2,1,2,3
C(CC(C(CC=O)CC=O)=O)=O,,,4,1,4,0,4
18836_0,,,,2,1,2,3
18838_0,,,,2,1,2,3
C(CCC(C(CC(C)=O)=O)=O)=O,,,4,1,1,0,1
18840_0,,,,2,1,2,3
C(CC(C(C=O)=O)CC(C)=O)=O,,,4,1,2,0,2
18842_0,,,,2,1,2,3
C(CC(CC(CCC=O)=O)=O)=O,,,4,1,2,0,2
18844_0,,,,2,1,2,3
C(CCC(C(CCC=O)=O)=O)=O,,,4,1,1,0,1
18846_0,,,,2,1,2,3
C(CCC(C(C=O)=O)CC=O)=O,,,4,1,1,0,1
18848_0,,,,2,1,2,3
C(CC(CCC(C(C)=O)=O)=O)=O,,,4,1,1,0,1
18850_0,,,,2,1,2,3
C(CCC(CC(C(C)=O)=O)=O)=O,,,4,1,1,0,1
18852_0,,,,2,1,2,3
C(CC(CCC(CC=O)=O)=O)=O,,,4,1,1,0,1
18853_0,,,,2,1,2,3
18854_0,,,,2,1,2,3
18855_0,,,,2,1,2,3
18856_0,,,,2,1,2,3
18857_0,,,,2,1,2,3
18859_0,,,,2,1,2,3
C(CC=O)(CC(C=CCO)=O)=O,,,4,1,1,0,1
18861_0,,,,2,1,2,3
C(CCC(C(C=CCO)=O)=O)=O,,,4,1,1,0,1
18863_0,,,,2,1,2,3
C(CC(C=CCO)C(C=O)=O)=O,,,4,1,1,0,1
18864_0,,,,2,1,2,3
18865_0,,,,2,1,2,3
18867_0,,,,2,1,2,3
C(CC(C(CO)=O)C=CC=O)=O,,,4,1,1,0,1
18868_0,,,,2,1,2,3
18869_0,,,,2,1,2,3
18870_0,,,,2,1,2,3
18872_0,,,,2,1,2,3
C(CCC(C(C(C=C)=O)O)=O)=O,,,4,1,1,0,1
18873_0,,,,2,1,2,3
18874_0,,,,2,1,2,3
18875_0,,,,2,1,2,3
18876_0,,,,2,1,2,3
18878_0,,,,2,1,2,3
C(C(C=O)O)(C(C=C)CC=O)=O,,,4,1,2,0,2
18880_0,,,,2,1,2,3
C(CC=O)(CC=CC(CO)=O)=O,,,4,1,1,0,1
18882_0,,,,2,1,2,3
C(CCC(C=CC(CO)=O)=O)=O,,,4,1,1,0,1
18884_0,,,,2,1,2,3
C(C(C=CC(C=O)O)CC=O)=O,,,4,1,1,0,1
18886_0,,,,2,1,2,3
C(C(C=CC(CC(C)=O)=O)O)=O,,,4,1,1,0,1
18888_0,,,,2,1,2,3
C(C(C=CC(C(CC)=O)=O)O)=O,,,4,1,1,0,1
18889_0,,,,2,1,2,3
18891_0,,,,2,1,2,3
C(CCC(C(C=CC=O)O)=O)=O,,,4,1,2,0,2
18892_0,,,,2,1,2,3
18893_0,,,,2,1,2,3
18894_0,,,,2,1,2,3
18895_0,,,,2,1,2,3
18897_0,,,,2,1,2,3
C(C(C(CO)=O)CC=O)=O,,,4,1,2,0,2
18898_0,,,,2,1,2,3
18899_0,,,,2,1,2,3
18901_0,,,,2,1,2,3
C(CO)(CC(C(C=O)=O)=O)=O,,,4,1,1,0,1
18903_0,,,,2,1,2,3
C(C(CC(C(CO)=O)=O)=O)=O,,,4,1,1,0,1
18905_0,,,,2,1,2,3
C(C(C(C(C=O)=O)=O)CO)=O,,,4,1,1,0,1
18906_0,,,,2,1,2,3
18907_0,,,,2,1,2,3
18908_0,,,,2,1,2,3
18909_0,,,,2,1,2,3
18910_0,,,,2,1,2,3
18911_0,,,,2,1,2,3
18912_0,,,,2,1,2,3
18913_0,,,,2,1,2,3
18914_0,,,,2,1,2,3
18915_0,,,,2,1,2,3
18916_0,,,,2,1,2,3
18917_0,,,,2,1,2,3
18918_0,,,,2,1,2,3
18920_0,,,,2,1,2,3
C(C(C(C=O)=O)C)=O,,,4,1,1,0,1
18921_0,,,,2,1,2,3
18922_0,,,,2,1,2,3
18924_0,,,,2,1,2,3
C(CC(C(C=O)=O)CO)=O,,,4,1,2,0,2
18926_0,,,,2,1,2,3
C(CC(C=O)C(C=O)O)=O,,,4,1,3,0,3
18928_0,,,,2,1,2,3
C(C(C(C)=O)C(CO)=O)=O,,,4,1,2,0,2
18929_0,,,,2,1,2,3
18931_0,,,,2,1,2,3
C(C(C(C(C=O)=O)C)O)=O,,,4,1,1,0,1
18933_0,,,,2,1,2,3
C(C(C(C)C(CO)O)=O)=O,,,4,1,1,0,1
18935_0,,,,2,1,2,3
C(CO)(C(C)C(C=O)O)=O,,,4,1,1,0,1
18936_0,,,,2,1,2,3
18937_0,,,,2,1,2,3
18938_0,,,,2,1,2,3
18940_0,,,,2,1,2,3
C(C(CC(C=O)C(C=O)O)O)=O,,,4,1,1,0,1
18942_0,,,,2,1,2,3
C(C(C(C(CO)=O)C(C)=O)O)=O,,,4,1,2,0,2
18944_0,,,,2,1,2,3
C(CC(C(CO)=O)C(C=O)O)=O,,,4,1,2,0,2
18945_0,,,,2,1,2,3
18946_0,,,,2,1,2,3
18947_0,,,,2,1,2,3
18948_0,,,,2,1,2,3
18950_0,,,,2,1,2,3
C(C(C(C=O)=O)CCO)=O,,,4,1,1,0,1
18951_0,,,,2,1,2,3
18952_0,,,,2,1,2,3
18954_0,,,,2,1,2,3
C(C(C(CO)CCO)=O)=O,,,4,1,1,0,1
18956_0,,,,2,1,2,3
C(C(CCO)C(C=O)O)=O,,,4,1,1,0,1
18958_0,,,,2,1,2,3
C(C)(C(C(CO)=O)CO)=O,,,4,1,3,0,3
18959_0,,,,2,1,2,3
18961_0,,,,2,1,2,3
C(C(C(C(C(C=O)=O)C)O)O)=O,,,4,1,1,0,1
18962_0,,,,2,1,2,3
18963_0,,,,2,1,2,3
18965_0,,,,2,1,2,3
C(C(C)C(C=O)O)(C(C=O)O)=O,,,4,1,1,0,1
18966_0,,,,2,1,2,3
18968_0,,,,2,1,2,3
C(CCC(C(C(C=O)O)O)=O)=O,,,4,1,1,0,1
18969_0,,,,2,1,2,3
18970_0,,,,2,1,2,3
18971_0,,,,2,1,2,3
18972_0,,,,2,1,2,3
18974_0,,,,2,1,2,3
C(C(C(C)CO)=O)=O,,,4,1,1,0,1
18976_0,,,,2,1,2,3
C(C(C)C(C=O)O)=O,,,4,1,1,0,1
18977_0,,,,2,1,2,3
18978_0,,,,2,1,2,3
18979_0,,,,2,1,2,3
18980_0,,,,2,1,2,3
18981_0,,,,2,1,2,3
18982_0,,,,2,1,2,3
18983_0,,,,2,1,2,3
18984_0,,,,2,1,2,3
18985_0,,,,2,1,2,3
18986_0,,,,2,1,2,3
18987_0,,,,2,1,2,3
18989_0,,,,2,1,2,3
C(C(CC)=O)=O,,,4,1,1,0,1
18990_0,,,,2,1,2,3
18991_0,,,,2,1,2,3
18992_0,,,,2,1,2,3
18993_0,,,,2,1,2,3
18994_0,,,,2,1,2,3
18995_0,,,,2,1,2,3
18996_0,,,,2,1,2,3
18997_0,,,,2,1,2,3
18998_0,,,,2,1,2,3
18999_0,,,,2,1,2,3
19000_0,,,,2,1,2,3
19001_0,,,,2,1,2,3
19002_0,,,,2,1,2,3
19003_0,,,,2,1,2,3
19004_0,,,,2,1,2,3
19005_0,,,,2,1,2,3
19006_0,,,,2,1,2,3
19007_0,,,,2,1,2,3
19008_0,,,,2,1,2,3
19009_0,,,,2,1,2,3
19010_0,,,,2,1,2,3
19011_0,,,,2,1,2,3
19012_0,,,,2,1,2,3
19013_0,,,,2,1,2,3
19015_0,,,,2,1,2,3
C(CC(CO)O)(CC(CO)=O)=O,,,4,1,1,0,1
19016_0,,,,2,1,2,3
19017_0,,,,2,1,2,3
19018_0,,,,2,1,2,3
19019_0,,,,2,1,2,3
19020_0,,,,2,1,2,3
19022_0,,,,2,1,2,3
C(CC(CO)O)(C(C(C)=O)O)=O,,,4,1,1,0,1
19024_0,,,,2,1,2,3
C(C(C(CO)O)O)(CC(C)=O)=O,,,4,1,1,0,1
19025_0,,,,2,1,2,3
19026_0,,,,2,1,2,3
19027_0,,,,2,1,2,3
19028_0,,,,2,1,2,3
19029_0,,,,2,1,2,3
19030_0,,,,2,1,2,3
19031_0,,,,2,1,2,3
19032_0,,,,2,1,2,3
19033_0,,,,2,1,2,3
19034_0,,,,2,1,2,3
19035_0,,,,2,1,2,3
19036_0,,,,2,1,2,3
19037_0,,,,2,1,2,3
19038_0,,,,2,1,2,3
19039_0,,,,2,1,2,3
19040_0,,,,2,1,2,3
19041_0,,,,2,1,2,3
19042_0,,,,2,1,2,3
19043_0,,,,2,1,2,3
19044_0,,,,2,1,2,3
19045_0,,,,2,1,2,3
19046_0,,,,2,1,2,3
19048_0,,,,2,1,2,3
C(C(C=O)CC(CO)O)(O)=O,,,4,1,1,0,1
19049_0,,,,2,1,2,3
19050_0,,,,2,1,2,3
19052_0,,,,2,1,2,3
C(C(CCC(CO)O)=O)(O)=O,,,4,1,1,0,1
19053_0,,,,2,1,2,3
19054_0,,,,2,1,2,3
19055_0,,,,2,1,2,3
19056_0,,,,2,1,2,3
19057_0,,,,2,1,2,3
19058_0,,,,2,1,2,3
19059_0,,,,2,1,2,3
19060_0,,,,2,1,2,3
19061_0,,,,2,1,2,3
19062_0,,,,2,1,2,3
19063_0,,,,2,1,2,3
19064_0,,,,2,1,2,3
19065_0,,,,2,1,2,3
19066_0,,,,2,1,2,3
19067_0,,,,2,1,2,3
19068_0,,,,2,1,2,3
19069_0,,,,2,1,2,3
19070_0,,,,2,1,2,3
19071_0,,,,2,1,2,3
19072_0,,,,2,1,2,3
19073_0,,,,2,1,2,3
19074_0,,,,2,1,2,3
19075_0,,,,2,1,2,3
19076_0,,,,2,1,2,3
19077_0,,,,2,1,2,3
19078_0,,,,2,1,2,3
19079_0,,,,2,1,2,3
19080_0,,,,2,1,2,3
19081_0,,,,2,1,2,3
19082_0,,,,2,1,2,3
19084_0,,,,2,1,2,3
C(C(C(C)=O)=O)(CCO)=O,,,4,1,2,0,2
19085_0,,,,2,1,2,3
19086_0,,,,2,1,2,3
19087_0,,,,2,1,2,3
19089_0,,,,2,1,2,3
C(C)(C(C(C(C)=O)=O)O)=O,,,4,1,2,0,2
19091_0,,,,2,1,2,3
C(C(C(C(CC)=O)=O)O)=O,,,4,1,1,0,1
19092_0,,,,2,1,2,3
19093_0,,,,2,1,2,3
19094_0,,,,2,1,2,3
19095_0,,,,2,1,2,3
19096_0,,,,2,1,2,3
19097_0,,,,2,1,2,3
19098_0,,,,2,1,2,3
19099_0,,,,2,1,2,3
19100_0,,,,2,1,2,3
19101_0,,,,2,1,2,3
19102_0,,,,2,1,2,3
19103_0,,,,2,1,2,3
19104_0,,,,2,1,2,3
19105_0,,,,2,1,2,3
19106_0,,,,2,1,2,3
19107_0,,,,2,1,2,3
19108_0,,,,2,1,2,3
19109_0,,,,2,1,2,3
19110_0,,,,2,1,2,3
19111_0,,,,2,1,2,3
19112_0,,,,2,1,2,3
19113_0,,,,2,1,2,3
19114_0,,,,2,1,2,3
19115_0,,,,2,1,2,3
19116_0,,,,2,1,2,3
19117_0,,,,2,1,2,3
19118_0,,,,2,1,2,3
19119_0,,,,2,1,2,3
19120_0,,,,2,1,2,3
19121_0,,,,2,1,2,3
19122_0,,,,2,1,2,3
19123_0,,,,2,1,2,3
19124_0,,,,2,1,2,3
19125_0,,,,2,1,2,3
19126_0,,,,2,1,2,3
19127_0,,,,2,1,2,3
19128_0,,,,2,1,2,3
19129_0,,,,2,1,2,3
19131_0,,,,2,1,2,3
C1(C(COC1C(CO)O)=O)=O,,,4,1,1,0,1
19132_0,,,,2,1,2,3
19133_0,,,,2,1,2,3
19134_0,,,,2,1,2,3
19136_0,,,,2,1,2,3
C1(C(COC(CO)C1O)=O)=O,,,4,1,1,0,1
19137_0,,,,2,1,2,3
19139_0,,,,2,1,2,3
C1(C(COCC(C1O)O)=O)=O,,,4,1,1,0,1
19140_0,,,,2,1,2,3
19141_0,,,,2,1,2,3
19142_0,,,,2,1,2,3
19143_0,,,,2,1,2,3
19144_0,,,,2,1,2,3
19145_0,,,,2,1,2,3
19146_0,,,,2,1,2,3
19147_0,,,,2,1,2,3
19148_0,,,,2,1,2,3
19149_0,,,,2,1,2,3
19151_0,,,,2,1,2,3
C(CCC(C(C=O)O)O)=O,,,4,1,2,0,2
19152_0,,,,2,1,2,3
19153_0,,,,2,1,2,3
19154_0,,,,2,1,2,3
19155_0,,,,2,1,2,3
19156_0,,,,2,1,2,3
19157_0,,,,2,1,2,3
19158_0,,,,2,1,2,3
19159_0,,,,2,1,2,3
19160_0,,,,2,1,2,3
19161_0,,,,2,1,2,3
19162_0,,,,2,1,2,3
19163_0,,,,2,1,2,3
19164_0,,,,2,1,2,3
19165_0,,,,2,1,2,3
19166_0,,,,2,1,2,3
19167_0,,,,2,1,2,3
19168_0,,,,2,1,2,3
19169_0,,,,2,1,2,3
19170_0,,,,2,1,2,3
19171_0,,,,2,1,2,3
19172_0,,,,2,1,2,3
19173_0,,,,2,1,2,3
19174_0,,,,2,1,2,3
19175_0,,,,2,1,2,3
19176_0,,,,2,1,2,3
19177_0,,,,2,1,2,3
19178_0,,,,2,1,2,3
19179_0,,,,2,1,2,3
19180_0,,,,2,1,2,3
19181_0,,,,2,1,2,3
19182_0,,,,2,1,2,3
19183_0,,,,2,1,2,3
19184_0,,,,2,1,2,3
19185_0,,,,2,1,2,3
19186_0,,,,2,1,2,3
19187_0,,,,2,1,2,3
19188_0,,,,2,1,2,3
19189_0,,,,2,1,2,3
19190_0,,,,2,1,2,3
19191_0,,,,2,1,2,3
19192_0,,,,2,1,2,3
19193_0,,,,2,1,2,3
19195_0,,,,2,1,2,3
C(C)(C(C(C=C)=O)O)=O,,,4,1,2,0,2
19196_0,,,,2,1,2,3
19197_0,,,,2,1,2,3
19198_0,,,,2,1,2,3
19200_0,,,,2,1,2,3
C(C)(C(C=CC=O)O)=O,,,4,1,3,0,3
19201_0,,,,2,1,2,3
19202_0,,,,2,1,2,3
19203_0,,,,2,1,2,3
19204_0,,,,2,1,2,3
19205_0,,,,2,1,2,3
19206_0,,,,2,1,2,3
19207_0,,,,2,1,2,3
19208_0,,,,2,1,2,3
19210_0,,,,2,1,2,3
C(CC1(CC(CO1)O)O)=O,,,4,1,2,0,2
19212_0,,,,2,1,2,3
C(C)(C1(CC(CO1)O)O)=O,,,4,1,2,0,2
19213_0,,,,2,1,2,3
19214_0,,,,2,1,2,3
19215_0,,,,2,1,2,3
19216_0,,,,2,1,2,3
19218_0,,,,2,1,2,3
C(CC1C(CC(O)O1)O)=O,,,4,1,2,0,2
19220_0,,,,2,1,2,3
C(C)(C1C(CC(O1)O)O)=O,,,4,1,2,0,2
19222_0,,,,2,1,2,3
C(C1CC(C(CO1)O)O)=O,,,4,1,1,0,1
19223_0,,,,2,1,2,3
19224_0,,,,2,1,2,3
19225_0,,,,2,1,2,3
19226_0,,,,2,1,2,3
19228_0,,,,2,1,2,3
C(CCC(C(CO)O)O)=O,,,4,1,1,0,1
19230_0,,,,2,1,2,3
C(C)(CC(C(CO)O)O)=O,,,4,1,1,0,1
19231_0,,,,2,1,2,3
19232_0,,,,2,1,2,3
19233_0,,,,2,1,2,3
19234_0,,,,2,1,2,3
19235_0,,,,2,1,2,3
19236_0,,,,2,1,2,3
19237_0,,,,2,1,2,3
19238_0,,,,2,1,2,3
19239_0,,,,2,1,2,3
19240_0,,,,2,1,2,3
19241_0,,,,2,1,2,3
19242_0,,,,2,1,2,3
19243_0,,,,2,1,2,3
19244_0,,,,2,1,2,3
19245_0,,,,2,1,2,3
19246_0,,,,2,1,2,3
19247_0,,,,2,1,2,3
19248_0,,,,2,1,2,3
19249_0,,,,2,1,2,3
19250_0,,,,2,1,2,3
19251_0,,,,2,1,2,3
19252_0,,,,2,1,2,3
19253_0,,,,2,1,2,3
19254_0,,,,2,1,2,3
19255_0,,,,2,1,2,3
19256_0,,,,2,1,2,3
19257_0,,,,2,1,2,3
19258_0,,,,2,1,2,3
19259_0,,,,2,1,2,3
19260_0,,,,2,1,2,3
19261_0,,,,2,1,2,3
19262_0,,,,2,1,2,3
19263_0,,,,2,1,2,3
19264_0,,,,2,1,2,3
19265_0,,,,2,1,2,3
19266_0,,,,2,1,2,3
19267_0,,,,2,1,2,3
19268_0,,,,2,1,2,3
19269_0,,,,2,1,2,3
19270_0,,,,2,1,2,3
19271_0,,,,2,1,2,3
19272_0,,,,2,1,2,3
19273_0,,,,2,1,2,3
19274_0,,,,2,1,2,3
19275_0,,,,2,1,2,3
19276_0,,,,2,1,2,3
19277_0,,,,2,1,2,3
19278_0,,,,2,1,2,3
19279_0,,,,2,1,2,3
19280_0,,,,2,1,2,3
19281_0,,,,2,1,2,3
19282_0,,,,2,1,2,3
19283_0,,,,2,1,2,3
19284_0,,,,2,1,2,3
19285_0,,,,2,1,2,3
19286_0,,,,2,1,2,3
19287_0,,,,2,1,2,3
19288_0,,,,2,1,2,3
19289_0,,,,2,1,2,3
19290_0,,,,2,1,2,3
19291_0,,,,2,1,2,3
19292_0,,,,2,1,2,3
19293_0,,,,2,1,2,3
19294_0,,,,2,1,2,3
19295_0,,,,2,1,2,3
19296_0,,,,2,1,2,3
19297_0,,,,2,1,2,3
19298_0,,,,2,1,2,3
19299_0,,,,2,1,2,3
19301_0,,,,2,1,2,3
C1(CC(C(C1CO)=O)=O)=O,,,4,1,1,0,1
19302_0,,,,2,1,2,3
19304_0,,,,2,1,2,3
C1(C=CC(C1CO)=O)=O,,,4,1,2,0,2
19305_0,,,,2,1,2,3
19306_0,,,,2,1,2,3
19307_0,,,,2,1,2,3
19308_0,,,,2,1,2,3
19309_0,,,,2,1,2,3
19310_0,,,,2,1,2,3
19311_0,,,,2,1,2,3
19312_0,,,,2,1,2,3
19313_0,,,,2,1,2,3
19314_0,,,,2,1,2,3
19315_0,,,,2,1,2,3
19317_0,,,,2,1,2,3
C(C1C(CC(C(C1O)O)O)=O)=O,,,4,1,1,0,1
19318_0,,,,2,1,2,3
19319_0,,,,2,1,2,3
19320_0,,,,2,1,2,3
19321_0,,,,2,1,2,3
19322_0,,,,2,1,2,3
19323_0,,,,2,1,2,3
19324_0,,,,2,1,2,3
19325_0,,,,2,1,2,3
19326_0,,,,2,1,2,3
19327_0,,,,2,1,2,3
19328_0,,,,2,1,2,3
19329_0,,,,2,1,2,3
19330_0,,,,2,1,2,3
19331_0,,,,2,1,2,3
19332_0,,,,2,1,2,3
19333_0,,,,2,1,2,3
19334_0,,,,2,1,2,3
19335_0,,,,2,1,2,3
19336_0,,,,2,1,2,3
19338_0,,,,2,1,2,3
C(CC(C=O)C(C=O)(CO)O)=O,,,4,1,2,0,2
19340_0,,,,2,1,2,3
C(CCO)(C(C=O)(C(C)=O)O)=O,,,4,1,1,0,1
19342_0,,,,2,1,2,3
C(C(CO)O)(C(C=O)C(C)=O)=O,,,4,1,1,0,1
19343_0,,,,2,1,2,3
19344_0,,,,2,1,2,3
19345_0,,,,2,1,2,3
19346_0,,,,2,1,2,3
19347_0,,,,2,1,2,3
19348_0,,,,2,1,2,3
19349_0,,,,2,1,2,3
19350_0,,,,2,1,2,3
19352_0,,,,2,1,2,3
C(C(CO)(C(C(C=O)=O)C)O)=O,,,4,1,1,0,1
19353_0,,,,2,1,2,3
19354_0,,,,2,1,2,3
19355_0,,,,2,1,2,3
19356_0,,,,2,1,2,3
19357_0,,,,2,1,2,3
19358_0,,,,2,1,2,3
19359_0,,,,2,1,2,3
19361_0,,,,2,1,2,3
C(C(CO)(C(C(CO)=O)C)O)=O,,,4,1,1,0,1
19362_0,,,,2,1,2,3
19363_0,,,,2,1,2,3
19364_0,,,,2,1,2,3
19365_0,,,,2,1,2,3
19366_0,,,,2,1,2,3
19368_0,,,,2,1,2,3
C(C(CCO)C(C=O)(CO)O)=O,,,4,1,1,0,1
19370_0,,,,2,1,2,3
C(C(C=O)(C(CCO)=O)O)=O,,,4,1,1,0,1
19372_0,,,,2,1,2,3
C(C(C=O)C(C(CO)O)=O)=O,,,4,1,1,0,1
19373_0,,,,2,1,2,3
19374_0,,,,2,1,2,3
19375_0,,,,2,1,2,3
19376_0,,,,2,1,2,3
19378_0,,,,2,1,2,3
C(C(C(C(C=O)O)=O)CO)=O,,,4,1,1,0,1
19380_0,,,,2,1,2,3
C(C(C(CC=O)=O)(CO)O)=O,,,4,1,1,0,1
19381_0,,,,2,1,2,3
19382_0,,,,2,1,2,3
19384_0,,,,2,1,2,3
C(C(C)C(C=O)(CO)O)=O,,,4,1,1,0,1
19385_0,,,,2,1,2,3
19386_0,,,,2,1,2,3
19387_0,,,,2,1,2,3
19388_0,,,,2,1,2,3
19389_0,,,,2,1,2,3
19390_0,,,,2,1,2,3
19391_0,,,,2,1,2,3
19392_0,,,,2,1,2,3
19393_0,,,,2,1,2,3
19395_0,,,,2,1,2,3
C(C(C(C)=O)C(C(C)=O)=O)=O,,,4,1,1,0,1
19397_0,,,,2,1,2,3
C(C)(C(C(C(C)=O)=O)CO)=O,,,4,1,1,0,1
19398_0,,,,2,1,2,3
19399_0,,,,2,1,2,3
19401_0,,,,2,1,2,3
C(C(C=O)C(C(C)=O)=O)=O,,,4,1,1,0,1
19402_0,,,,2,1,2,3
19403_0,,,,2,1,2,3
19404_0,,,,2,1,2,3
19405_0,,,,2,1,2,3
19406_0,,,,2,1,2,3
19407_0,,,,2,1,2,3
19408_0,,,,2,1,2,3
19409_0,,,,2,1,2,3
19410_0,,,,2,1,2,3
19412_0,,,,2,1,2,3
C(C(C=O)C(CC(CO)=O)=O)=O,,,4,1,1,0,1
19414_0,,,,2,1,2,3
C(C(C=O)(C(C=O)CC=O)O)=O,,,4,1,2,0,2
19416_0,,,,2,1,2,3
C(C(C(C)=O)C(C=O)=O)=O,,,4,1,1,0,1
19418_0,,,,2,1,2,3
C(C(C=O)C(C)=O)=O,,,4,1,2,0,2
19420_0,,,,2,1,2,3
C(C(C=O)(C(CC(C)=O)=O)O)=O,,,4,1,1,0,1
19422_0,,,,2,1,2,3
C(C(C=O)C(C(C(C)=O)O)=O)=O,,,4,1,1,0,1
19423_0,,,,2,1,2,3
19425_0,,,,2,1,2,3
C(C(C=O)(C(C(C=O)=O)C)O)=O,,,4,1,1,0,1
19427_0,,,,2,1,2,3
C(C(C(C(C=O)O)=O)C(C)=O)=O,,,4,1,1,0,1
19429_0,,,,2,1,2,3
C(C(C(CC=O)=O)(C(C)=O)O)=O,,,4,1,1,0,1
19430_0,,,,2,1,2,3
19432_0,,,,2,1,2,3
C(C(C)C(C=O)(C(C)=O)O)=O,,,4,1,1,0,1
19434_0,,,,2,1,2,3
C(C(C(C)=O)C(C)=O)=O,,,4,1,1,0,1
19436_0,,,,2,1,2,3
C(C(C(C)=O)C(C(CO)=O)=O)=O,,,4,1,1,0,1
19437_0,,,,2,1,2,3
19438_0,,,,2,1,2,3
19440_0,,,,2,1,2,3
C(C(C=O)C(C=O)=O)=O,,,4,1,1,0,1
19441_0,,,,2,1,2,3
19442_0,,,,2,1,2,3
19443_0,,,,2,1,2,3
19444_0,,,,2,1,2,3
19445_0,,,,2,1,2,3
19446_0,,,,2,1,2,3
19447_0,,,,2,1,2,3
19449_0,,,,2,1,2,3
C(C(C(C(C=O)=O)CO)=O)=O,,,4,1,2,0,2
19450_0,,,,2,1,2,3
19451_0,,,,2,1,2,3
19453_0,,,,2,1,2,3
C(C(C=O)(C(C(CO)=O)C)O)=O,,,4,1,1,0,1
19454_0,,,,2,1,2,3
19455_0,,,,2,1,2,3
19456_0,,,,2,1,2,3
19457_0,,,,2,1,2,3
19458_0,,,,2,1,2,3
19459_0,,,,2,1,2,3
19460_0,,,,2,1,2,3
19462_0,,,,2,1,2,3
C(C(C)C(C(C)=O)(CO)O)=O,,,4,1,1,0,1
19463_0,,,,2,1,2,3
19465_0,,,,2,1,2,3
C(C)(C(C(C)=O)CO)=O,,,4,1,1,0,1
19466_0,,,,2,1,2,3
19467_0,,,,2,1,2,3
19468_0,,,,2,1,2,3
19469_0,,,,2,1,2,3
19471_0,,,,2,1,2,3
C(C(C=O)C=O)=O,,,4,1,1,0,1
19472_0,,,,2,1,2,3
19473_0,,,,2,1,2,3
19474_0,,,,2,1,2,3
19475_0,,,,2,1,2,3
19477_0,,,,2,1,2,3
C(C(C=O)C(C(CCO)O)=O)=O,,,4,1,1,0,1
19478_0,,,,2,1,2,3
19479_0,,,,2,1,2,3
19480_0,,,,2,1,2,3
19481_0,,,,2,1,2,3
19482_0,,,,2,1,2,3
19483_0,,,,2,1,2,3
19485_0,,,,2,1,2,3
C(C(C(CCO)=O)C(CO)O)=O,,,4,1,1,0,1
19486_0,,,,2,1,2,3
19487_0,,,,2,1,2,3
19488_0,,,,2,1,2,3
19489_0,,,,2,1,2,3
19490_0,,,,2,1,2,3
19491_0,,,,2,1,2,3
19492_0,,,,2,1,2,3
19493_0,,,,2,1,2,3
19494_0,,,,2,1,2,3
19495_0,,,,2,1,2,3
19496_0,,,,2,1,2,3
19497_0,,,,2,1,2,3
19498_0,,,,2,1,2,3
19499_0,,,,2,1,2,3
19501_0,,,,2,1,2,3
C(C(C(CC=O)=O)C(C)=O)=O,,,4,1,1,0,1
19503_0,,,,2,1,2,3
C(C(C=O)C(CC(C)=O)=O)=O,,,4,1,1,0,1
19505_0,,,,2,1,2,3
C(C(C=O)C(CCC=O)=O)=O,,,4,1,1,0,1
19506_0,,,,2,1,2,3
19507_0,,,,2,1,2,3
19509_0,,,,2,1,2,3
C(C1C(COC1C(CO)O)=O)=O,,,4,1,1,0,1
19510_0,,,,2,1,2,3
19511_0,,,,2,1,2,3
19512_0,,,,2,1,2,3
19513_0,,,,2,1,2,3
19514_0,,,,2,1,2,3
19515_0,,,,2,1,2,3
19516_0,,,,2,1,2,3
19517_0,,,,2,1,2,3
19518_0,,,,2,1,2,3
19520_0,,,,2,1,2,3
C1(C(CO)CC(C(CO)O1)=O)=O,,,4,1,1,0,1
19522_0,,,,2,1,2,3
C(C1C(COC(CO)C1O)=O)=O,,,4,1,1,0,1
19523_0,,,,2,1,2,3
19525_0,,,,2,1,2,3
C(C1C(CC(O)OC1CO)=O)=O,,,4,1,1,0,1
19527_0,,,,2,1,2,3
C(C1C(CC(CO)OC1O)=O)=O,,,4,1,1,0,1
19528_0,,,,2,1,2,3
19529_0,,,,2,1,2,3
19530_0,,,,2,1,2,3
19531_0,,,,2,1,2,3
19533_0,,,,2,1,2,3
C1(C(CO)CC(C(CO1)O)=O)=O,,,4,1,1,0,1
19534_0,,,,2,1,2,3
19535_0,,,,2,1,2,3
19537_0,,,,2,1,2,3
C(C1C(COCC(C1O)O)=O)=O,,,4,1,1,0,1
19538_0,,,,2,1,2,3
19539_0,,,,2,1,2,3
19540_0,,,,2,1,2,3
19542_0,,,,2,1,2,3
C(C1C(CC(O)OCC1O)=O)=O,,,4,1,1,0,1
19543_0,,,,2,1,2,3
19545_0,,,,2,1,2,3
C(C1C(CC(COC1O)O)=O)=O,,,4,1,1,0,1
19546_0,,,,2,1,2,3
19548_0,,,,2,1,2,3
C(C1C(CC(C(O)OC1)O)=O)=O,,,4,1,2,0,2
19549_0,,,,2,1,2,3
19550_0,,,,2,1,2,3
19552_0,,,,2,1,2,3
C(C1C(CCOC(C1O)O)=O)=O,,,4,1,1,0,1
19553_0,,,,2,1,2,3
19554_0,,,,2,1,2,3
19555_0,,,,2,1,2,3
19556_0,,,,2,1,2,3
19558_0,,,,2,1,2,3
C(C(C(CCO)=O)C(C=O)=O)=O,,,4,1,1,0,1
19559_0,,,,2,1,2,3
19560_0,,,,2,1,2,3
19561_0,,,,2,1,2,3
19562_0,,,,2,1,2,3
19564_0,,,,2,1,2,3
C(C(C=O)C(C=CCO)=O)=O,,,4,1,1,0,1
19565_0,,,,2,1,2,3
19566_0,,,,2,1,2,3
19567_0,,,,2,1,2,3
19569_0,,,,2,1,2,3
C(C(C(C=C)=O)C(C=O)O)=O,,,4,1,1,0,1
19570_0,,,,2,1,2,3
19571_0,,,,2,1,2,3
19572_0,,,,2,1,2,3
19574_0,,,,2,1,2,3
C(C(C=O)C1(CC(CO1)O)O)=O,,,4,1,1,0,1
19575_0,,,,2,1,2,3
19576_0,,,,2,1,2,3
19577_0,,,,2,1,2,3
19578_0,,,,2,1,2,3
19580_0,,,,2,1,2,3
C(C(C=O)C1C(CC(O)O1)O)=O,,,4,1,1,0,1
19581_0,,,,2,1,2,3
19582_0,,,,2,1,2,3
19583_0,,,,2,1,2,3
19585_0,,,,2,1,2,3
C(C(C=O)C(C(CCO)=O)=O)=O,,,4,1,1,0,1
19587_0,,,,2,1,2,3
C(C(C=O)(C(C=O)CCO)O)=O,,,4,1,1,0,1
19588_0,,,,2,1,2,3
19589_0,,,,2,1,2,3
19590_0,,,,2,1,2,3
19592_0,,,,2,1,2,3
C(C(C(C(C)=O)C(C)=O)O)=O,,,4,1,1,0,1
19594_0,,,,2,1,2,3
C(C(C=O)(C(CC=O)=O)O)=O,,,4,1,1,0,1
19596_0,,,,2,1,2,3
C(C(C=O)C(C(C=O)O)=O)=O,,,4,1,1,0,1
19597_0,,,,2,1,2,3
19599_0,,,,2,1,2,3
C(C(C=O)(C(C=O)C)O)=O,,,4,1,1,0,1
19601_0,,,,2,1,2,3
C(C(C=O)C(C(CC=O)O)=O)=O,,,4,1,1,0,1
19603_0,,,,2,1,2,3
C(C(C=O)(C(CCC=O)=O)O)=O,,,4,1,1,0,1
19604_0,,,,2,1,2,3
19606_0,,,,2,1,2,3
C(C(C=O)C(CC(C=O)O)=O)=O,,,4,1,1,0,1
19607_0,,,,2,1,2,3
19609_0,,,,2,1,2,3
C(C(C=O)C(C(CO)=O)=O)=O,,,4,1,1,0,1
19610_0,,,,2,1,2,3
19612_0,,,,2,1,2,3
C(C(C(C=O)(C(C=O)C)O)O)=O,,,4,1,1,0,1
19613_0,,,,2,1,2,3
19615_0,,,,2,1,2,3
C(C(C)C(C(CO)=O)(CO)O)=O,,,4,1,1,0,1
19616_0,,,,2,1,2,3
19618_0,,,,2,1,2,3
C(C(C)C(C(C=O)=O)(CO)O)=O,,,4,1,1,0,1
19619_0,,,,2,1,2,3
19620_0,,,,2,1,2,3
19621_0,,,,2,1,2,3
19622_0,,,,2,1,2,3
19623_0,,,,2,1,2,3
19625_0,,,,2,1,2,3
C(C(C(C)=O)C(CO)O)(O)=O,,,4,1,1,0,1
19626_0,,,,2,1,2,3
19627_0,,,,2,1,2,3
19628_0,,,,2,1,2,3
19630_0,,,,2,1,2,3
C(CC(C(C(C)=O)C(C)=O)=O)=O,,,4,1,1,0,1
19632_0,,,,2,1,2,3
C(C(C(CC(C)=O)=O)C(C)=O)=O,,,4,1,1,0,1
19634_0,,,,2,1,2,3
C(C(C(CCC=O)=O)C(C)=O)=O,,,4,1,1,0,1
19636_0,,,,2,1,2,3
C(C(C(C)=O)C(C=CCO)=O)=O,,,4,1,1,0,1
19638_0,,,,2,1,2,3
C(C)(C(C(C=CC=O)=O)CO)=O,,,4,1,1,0,1
19639_0,,,,2,1,2,3
19640_0,,,,2,1,2,3
19641_0,,,,2,1,2,3
19643_0,,,,2,1,2,3
C(C(C(C(C)=O)C(C=C)=O)O)=O,,,4,1,1,0,1
19644_0,,,,2,1,2,3
19645_0,,,,2,1,2,3
19646_0,,,,2,1,2,3
19647_0,,,,2,1,2,3
19648_0,,,,2,1,2,3
19649_0,,,,2,1,2,3
19650_0,,,,2,1,2,3
19651_0,,,,2,1,2,3
19652_0,,,,2,1,2,3
19654_0,,,,2,1,2,3
C(C(C(C)=O)(C(C)=O)O)=O,,,4,1,1,0,1
19655_0,,,,2,1,2,3
19656_0,,,,2,1,2,3
19658_0,,,,2,1,2,3
C(C)(C(C(C)=O)(CO)O)=O,,,4,1,1,0,1
19659_0,,,,2,1,2,3
19660_0,,,,2,1,2,3
19661_0,,,,2,1,2,3
19663_0,,,,2,1,2,3
C(C(C(C(C)=O)(C(C)=O)O)O)=O,,,4,1,1,0,1
19664_0,,,,2,1,2,3
19665_0,,,,2,1,2,3
19666_0,,,,2,1,2,3
19667_0,,,,2,1,2,3
19668_0,,,,2,1,2,3
19669_0,,,,2,1,2,3
19670_0,,,,2,1,2,3
19671_0,,,,2,1,2,3
19672_0,,,,2,1,2,3
19673_0,,,,2,1,2,3
19674_0,,,,2,1,2,3
19675_0,,,,2,1,2,3
19676_0,,,,2,1,2,3
19677_0,,,,2,1,2,3
19678_0,,,,2,1,2,3
19679_0,,,,2,1,2,3
19680_0,,,,2,1,2,3
19681_0,,,,2,1,2,3
19682_0,,,,2,1,2,3
19683_0,,,,2,1,2,3
19685_0,,,,2,1,2,3
C(C(C)C(C=O)(C(CO)O)O)=O,,,4,1,1,0,1
19686_0,,,,2,1,2,3
19687_0,,,,2,1,2,3
19688_0,,,,2,1,2,3
19689_0,,,,2,1,2,3
19690_0,,,,2,1,2,3
19691_0,,,,2,1,2,3
19692_0,,,,2,1,2,3
19694_0,,,,2,1,2,3
C(C(C(CC=O)=O)C(CO)O)=O,,,4,1,1,0,1
19695_0,,,,2,1,2,3
19696_0,,,,2,1,2,3
19698_0,,,,2,1,2,3
C(C(C=O)C(CC(CO)O)=O)=O,,,4,1,1,0,1
19699_0,,,,2,1,2,3
19700_0,,,,2,1,2,3
19701_0,,,,2,1,2,3
19703_0,,,,2,1,2,3
C(C1(C(CC(C1)O)=O)O)=O,,,4,1,1,0,1
19705_0,,,,2,1,2,3
C(C1C(C(C(C1)O)O)=O)=O,,,4,1,1,0,1
19706_0,,,,2,1,2,3
19707_0,,,,2,1,2,3
19708_0,,,,2,1,2,3
19710_0,,,,2,1,2,3
C1(CC(C(C1(C)O)=O)O)=O,,,4,1,1,0,1
19712_0,,,,2,1,2,3
C1(C(C(C(C1C)=O)O)O)=O,,,4,1,1,0,1
19714_0,,,,2,1,2,3
C1(C(C)(CC(C1O)=O)O)=O,,,4,1,1,0,1
19715_0,,,,2,1,2,3
19716_0,,,,2,1,2,3
19717_0,,,,2,1,2,3
19719_0,,,,2,1,2,3
C(C1C(CC(C1)O)=O)(O)=O,,,4,1,1,0,1
19720_0,,,,2,1,2,3
19721_0,,,,2,1,2,3
19722_0,,,,2,1,2,3
19724_0,,,,2,1,2,3
C(CCO)(C(C=O)(CC=O)O)=O,,,4,1,1,0,1
19726_0,,,,2,1,2,3
C(C(CO)O)(C(C=O)CC=O)=O,,,4,1,2,0,2
19727_0,,,,2,1,2,3
19728_0,,,,2,1,2,3
19729_0,,,,2,1,2,3
19730_0,,,,2,1,2,3
19731_0,,,,2,1,2,3
19732_0,,,,2,1,2,3
19733_0,,,,2,1,2,3
19734_0,,,,2,1,2,3
19735_0,,,,2,1,2,3
19737_0,,,,2,1,2,3
C(C(C(C(C)=O)=O)CC=O)=O,,,4,1,1,0,1
19739_0,,,,2,1,2,3
C(C(C(C(O)=O)=O)C)=O,,,4,1,1,0,1
19741_0,,,,2,1,2,3
C(C(C(C(C)=O)=O)CCO)(O)=O,,,4,1,1,0,1
19743_0,,,,2,1,2,3
C(C(C(C=O)CC=O)O)(O)=O,,,4,1,2,0,2
19745_0,,,,2,1,2,3
C(CC(C(C(O)=O)=O)CO)=O,,,4,1,1,0,1
19747_0,,,,2,1,2,3
C(C(C(C(C=O)=O)C)O)(O)=O,,,4,1,1,0,1
19749_0,,,,2,1,2,3
C(C(C(C(C(O)=O)=O)C)O)=O,,,4,1,1,0,1
19751_0,,,,2,1,2,3
C(C(C(C=O)=O)CC(CO)=O)=O,,,4,1,2,0,2
19753_0,,,,2,1,2,3
C(C(C(C=O)=O)CC=O)=O,,,4,1,1,0,1
19755_0,,,,2,1,2,3
C(C(C(C=O)=O)CCO)(O)=O,,,4,1,1,0,1
19757_0,,,,2,1,2,3
C(CO)(C(C)C(C(O)=O)O)=O,,,4,1,1,0,1
19758_0,,,,2,1,2,3
19759_0,,,,2,1,2,3
19761_0,,,,2,1,2,3
C(C(C(C)C(CO)O)=O)(O)=O,,,4,1,1,0,1
19763_0,,,,2,1,2,3
C(C(C(C)=O)CC(CO)=O)=O,,,4,1,1,0,1
19764_0,,,,2,1,2,3
19765_0,,,,2,1,2,3
19766_0,,,,2,1,2,3
19768_0,,,,2,1,2,3
C(C(C(C=O)=O)CC(CO)O)=O,,,4,1,1,0,1
19769_0,,,,2,1,2,3
19770_0,,,,2,1,2,3
19772_0,,,,2,1,2,3
C(C(C=O)CC(C(CO)=O)O)=O,,,4,1,1,0,1
19774_0,,,,2,1,2,3
C(C(CC(C=O)C(CO)=O)O)=O,,,4,1,1,0,1
19776_0,,,,2,1,2,3
C(C(C(C(C=O)O)=O)CCO)=O,,,4,1,1,0,1
19777_0,,,,2,1,2,3
19779_0,,,,2,1,2,3
C(C(C=O)CC(C(C=O)O)O)=O,,,4,1,1,0,1
19780_0,,,,2,1,2,3
19781_0,,,,2,1,2,3
19783_0,,,,2,1,2,3
C(C(C(C(C(C=O)O)O)=O)C)=O,,,4,1,1,0,1
19784_0,,,,2,1,2,3
19785_0,,,,2,1,2,3
19787_0,,,,2,1,2,3
C(C(C(C)=O)CC(C=O)=O)=O,,,4,1,1,0,1
19789_0,,,,2,1,2,3
C(C(C(CC=O)=O)CC=O)=O,,,4,1,1,0,1
19791_0,,,,2,1,2,3
C(C(C=O)CC(C(C)=O)=O)=O,,,4,1,1,0,1
19793_0,,,,2,1,2,3
C(C(C=O)CC(CC=O)=O)=O,,,4,1,1,0,1
19795_0,,,,2,1,2,3
C(C1C(CC(C(CO)O)O1)=O)=O,,,4,1,1,0,1
19796_0,,,,2,1,2,3
19797_0,,,,2,1,2,3
19799_0,,,,2,1,2,3
C(C1C(CC(C(CO)O1)O)=O)=O,,,4,1,1,0,1
19801_0,,,,2,1,2,3
C(C1C(CC(C(CO1)O)O)=O)=O,,,4,1,1,0,1
19802_0,,,,2,1,2,3
19803_0,,,,2,1,2,3
19805_0,,,,2,1,2,3
C(C(C=O)CC(CCO)=O)(O)=O,,,4,1,1,0,1
19807_0,,,,2,1,2,3
C(C(C=O)CCC(CO)=O)(O)=O,,,4,1,1,0,1
19809_0,,,,2,1,2,3
C(C(C=O)CC(C(C)=O)O)(O)=O,,,4,1,1,0,1
19811_0,,,,2,1,2,3
C(C(CC(C=O)C(C)=O)O)(O)=O,,,4,1,1,0,1
19813_0,,,,2,1,2,3
C(C(C=O)CC(CC=O)O)(O)=O,,,4,1,1,0,1
19814_0,,,,2,1,2,3
19816_0,,,,2,1,2,3
C(C(C=O)C=CC(CO)=O)=O,,,4,1,1,0,1
19818_0,,,,2,1,2,3
C(C(C=O)C=CC(CO)O)(O)=O,,,4,1,1,0,1
19819_0,,,,2,1,2,3
19820_0,,,,2,1,2,3
19822_0,,,,2,1,2,3
C1(C(C=O)CC(C(CO)O)O1)=O,,,4,1,1,0,1
19823_0,,,,2,1,2,3
19824_0,,,,2,1,2,3
19826_0,,,,2,1,2,3
C1(C(C=O)CC(C(CO)O1)O)=O,,,4,1,1,0,1
19828_0,,,,2,1,2,3
C1(C(C=O)CC(C(CO1)O)O)=O,,,4,1,1,0,1
19829_0,,,,2,1,2,3
19830_0,,,,2,1,2,3
19832_0,,,,2,1,2,3
C(C(C=O)CCO)(O)=O,,,4,1,1,0,1
19834_0,,,,2,1,2,3
C(C(C=O)CC(C(CO)O)O)=O,,,4,1,1,0,1
19835_0,,,,2,1,2,3
19836_0,,,,2,1,2,3
19837_0,,,,2,1,2,3
19838_0,,,,2,1,2,3
19840_0,,,,2,1,2,3
C(C(C(C(O)=O)=O)CCO)=O,,,4,1,1,0,1
19842_0,,,,2,1,2,3
C(C(CCO)C(C(O)=O)O)=O,,,4,1,1,0,1
19844_0,,,,2,1,2,3
C(C(C(CO)CCO)=O)(O)=O,,,4,1,1,0,1
19846_0,,,,2,1,2,3
C(C(C(CC=O)=O)(CC=O)O)=O,,,4,1,1,0,1
19848_0,,,,2,1,2,3
C(C(C(C(C=O)O)=O)CC=O)=O,,,4,1,1,0,1
19849_0,,,,2,1,2,3
19850_0,,,,2,1,2,3
19851_0,,,,2,1,2,3
19852_0,,,,2,1,2,3
19853_0,,,,2,1,2,3
19855_0,,,,2,1,2,3
C(CC(C=O)(C(C=O)C)O)=O,,,4,1,1,0,1
19857_0,,,,2,1,2,3
C(C(C)C(C(O)=O)O)=O,,,4,1,1,0,1
19859_0,,,,2,1,2,3
C(C(C(C)CO)=O)(O)=O,,,4,1,1,0,1
19861_0,,,,2,1,2,3
C(C(C)C(C(O)=O)(CCO)O)=O,,,4,1,1,0,1
19863_0,,,,2,1,2,3
C(C(C(C)=O)CC=O)=O,,,4,1,1,0,1
19865_0,,,,2,1,2,3
C(C(C(C(CO)=O)=O)CC=O)=O,,,4,1,1,0,1
19866_0,,,,2,1,2,3
19867_0,,,,2,1,2,3
19868_0,,,,2,1,2,3
19869_0,,,,2,1,2,3
19870_0,,,,2,1,2,3
19871_0,,,,2,1,2,3
19872_0,,,,2,1,2,3
19873_0,,,,2,1,2,3
19875_0,,,,2,1,2,3
C(C(O)=O)(CC)=O,,,4,1,1,0,1
19877_0,,,,2,1,2,3
C(C)(C(C(C)=O)CC(C=O)=O)=O,,,4,1,1,0,1
19879_0,,,,2,1,2,3
C(CC=O)(C(C(C)=O)CC=O)=O,,,4,1,1,0,1
19881_0,,,,2,1,2,3
C(C(C(C)=O)CC(C(C)=O)=O)=O,,,4,1,1,0,1
19883_0,,,,2,1,2,3
C(C(C(C)=O)CC(CC=O)=O)=O,,,4,1,1,0,1
19885_0,,,,2,1,2,3
C(C(C(C)=O)C=CC(CO)=O)=O,,,4,1,1,0,1
19887_0,,,,2,1,2,3
C(C(C(C)=O)CCO)(O)=O,,,4,1,1,0,1
19888_0,,,,2,1,2,3
19889_0,,,,2,1,2,3
19890_0,,,,2,1,2,3
19892_0,,,,2,1,2,3
C(C(C(C(O)=O)=O)CO)=O,,,4,1,1,0,1
19893_0,,,,2,1,2,3
19894_0,,,,2,1,2,3
19895_0,,,,2,1,2,3
19896_0,,,,2,1,2,3
19897_0,,,,2,1,2,3
19898_0,,,,2,1,2,3
19900_0,,,,2,1,2,3
C(CC(C(C(CO)O)=O)=O)(O)=O,,,4,1,1,0,1
19901_0,,,,2,1,2,3
19902_0,,,,2,1,2,3
19904_0,,,,2,1,2,3
C(C(C(C(O)=O)=O)C(CO)O)=O,,,4,1,1,0,1
19905_0,,,,2,1,2,3
19906_0,,,,2,1,2,3
19907_0,,,,2,1,2,3
19909_0,,,,2,1,2,3
C(C(C(C)=O)(CCO)O)(O)=O,,,4,1,1,0,1
19911_0,,,,2,1,2,3
C(C(C(CO)=O)CCO)(O)=O,,,4,1,1,0,1
19912_0,,,,2,1,2,3
19913_0,,,,2,1,2,3
19914_0,,,,2,1,2,3
19915_0,,,,2,1,2,3
19916_0,,,,2,1,2,3
19917_0,,,,2,1,2,3
19918_0,,,,2,1,2,3
19919_0,,,,2,1,2,3
19920_0,,,,2,1,2,3
19921_0,,,,2,1,2,3
19922_0,,,,2,1,2,3
19924_0,,,,2,1,2,3
C(C1C(CC(CO)O1)=O)=O,,,4,1,3,0,3
19926_0,,,,2,1,2,3
C1(CC(C=O)OC1CO)=O,,,4,1,3,0,3
19927_0,,,,2,1,2,3
19928_0,,,,2,1,2,3
19930_0,,,,2,1,2,3
C(C1C(CC(CO1)O)=O)=O,,,4,1,3,0,3
19932_0,,,,2,1,2,3
C1(CC(C=O)OCC1O)=O,,,4,1,2,0,2
19934_0,,,,2,1,2,3
C1(C(C(C=O)OCC1)O)=O,,,4,1,2,0,2
19936_0,,,,2,1,2,3
C(C1C(CC(CO1)=O)O)=O,,,4,1,3,0,3
19938_0,,,,2,1,2,3
C1(C(C(CO)OCC1)=O)=O,,,4,1,2,0,2
19939_0,,,,2,1,2,3
19940_0,,,,2,1,2,3
19941_0,,,,2,1,2,3
19942_0,,,,2,1,2,3
19943_0,,,,2,1,2,3
19944_0,,,,2,1,2,3
19945_0,,,,2,1,2,3
19947_0,,,,2,1,2,3
C(C1C(C(CCO1)=O)=O)=O,,,4,1,2,0,2
19949_0,,,,2,1,2,3
C1(C(C=O)OCC(C1)=O)=O,,,4,1,2,0,2
19950_0,,,,2,1,2,3
19951_0,,,,2,1,2,3
19953_0,,,,2,1,2,3
C(C)(C1CC(C(O1)=O)=O)=O,,,4,1,3,0,3
19955_0,,,,2,1,2,3
C(CC1CC(C(O1)=O)=O)=O,,,4,1,3,0,3
19957_0,,,,2,1,2,3
C1(C(C(C)=O)OC(C1)=O)=O,,,4,1,3,0,3
19959_0,,,,2,1,2,3
C1(CC(C(CC=O)O1)=O)=O,,,4,1,3,0,3
19960_0,,,,2,1,2,3
19961_0,,,,2,1,2,3
19962_0,,,,2,1,2,3
19963_0,,,,2,1,2,3
19965_0,,,,2,1,2,3
C1(CCOC(C(C1)=O)=O)=O,,,4,1,3,0,3
19967_0,,,,2,1,2,3
C1(COC(C(CC1)=O)=O)=O,,,4,1,3,0,3
19969_0,,,,2,1,2,3
C1(CC(C(CCO1)=O)=O)=O,,,4,1,3,0,3
19971_0,,,,2,1,2,3
C1(CC(OCC(C1)=O)=O)=O,,,4,1,3,0,3
19972_0,,,,2,1,2,3
19973_0,,,,2,1,2,3
19974_0,,,,2,1,2,3
19975_0,,,,2,1,2,3
19977_0,,,,2,1,2,3
C1(C(CO)=CC(C1)=O)=O,,,4,1,3,0,3
19979_0,,,,2,1,2,3
C1CC(C(C=1CO)=O)=O,,,4,1,2,0,2
19981_0,,,,2,1,2,3
C=C1C(CC(C1=O)O)=O,,,4,1,2,0,2
19983_0,,,,2,1,2,3
C1(CC(C(C1O)=O)=C)=O,,,4,1,2,0,2
19985_0,,,,2,1,2,3
C1(CC(C(C1O)=C)=O)=O,,,4,1,2,0,2
19987_0,,,,2,1,2,3
C=C1C(C(CC1O)=O)=O,,,4,1,2,0,2
19989_0,,,,2,1,2,3
C(C1C(CC(C=1)=O)O)=O,,,4,1,3,0,3
19991_0,,,,2,1,2,3
C1(CC=C(C=O)C1O)=O,,,4,1,3,0,3
19993_0,,,,2,1,2,3
C1(CC(C=O)=CC1O)=O,,,4,1,3,0,3
19995_0,,,,2,1,2,3
C1C(CC(C=1C=O)=O)O,,,4,1,2,0,2
19997_0,,,,2,1,2,3
C=CC(CC(C=O)=O)O,,,4,1,2,0,2
19999_0,,,,2,1,2,3
C(CC(C(C=C)O)=O)=O,,,4,1,3,0,3
20001_0,,,,2,1,2,3
C(C(C(CC=C)=O)O)=O,,,4,1,3,0,3
20003_0,,,,2,1,2,3
C(C(CC(C=C)=O)O)=O,,,4,1,3,0,3
20005_0,,,,2,1,2,3
C(C1C(C(C=C1)O)=O)=O,,,4,1,2,0,2
20007_0,,,,2,1,2,3
C(C1(C(CC=C1)=O)O)=O,,,4,1,2,0,2
20008_0,,,,2,1,2,3
20010_0,,,,2,1,2,3
C(C)(C1C=CC(O1)=O)=O,,,4,1,3,0,3
20012_0,,,,2,1,2,3
C(CC1C=CC(O1)=O)=O,,,4,1,3,0,3
20014_0,,,,2,1,2,3
C(C)(C1C(C=CO1)=O)=O,,,4,1,2,0,2
20016_0,,,,2,1,2,3
C(CC1C(C=CO1)=O)=O,,,4,1,2,0,2
20018_0,,,,2,1,2,3
C1(C=CC(OCC1)=O)=O,,,4,1,3,0,3
20020_0,,,,2,1,2,3
C1(COC(C=CC1)=O)=O,,,4,1,3,0,3
20022_0,,,,2,1,2,3
C1OCCC(C(C=1)=O)=O,,,4,1,2,0,2
20024_0,,,,2,1,2,3
C1(COC=CC(C1)=O)=O,,,4,1,2,0,2
20026_0,,,,2,1,2,3
C1(CC(C=CCO1)=O)=O,,,4,1,2,0,2
20028_0,,,,2,1,2,3
C1COCC(C(C=1)=O)=O,,,4,1,2,0,2
20030_0,,,,2,1,2,3
C1(CC=CC(CO1)=O)=O,,,4,1,2,0,2
20032_0,,,,2,1,2,3
C1(C=CC(COC1)=O)=O,,,4,1,2,0,2
20034_0,,,,2,1,2,3
C1(C(OCC1)=CC=O)=O,,,4,1,2,0,2
20036_0,,,,2,1,2,3
C1(COC(C1)=CC=O)=O,,,4,1,2,0,2
20038_0,,,,2,1,2,3
C1C(C(C=O)=O)OCC=1,,,4,1,2,0,2
20040_0,,,,2,1,2,3
C(C1C=CC(C=O)O1)=O,,,4,1,2,0,2
20042_0,,,,2,1,2,3
C(C1C(CC(O1)=C)=O)=O,,,4,1,2,0,2
20044_0,,,,2,1,2,3
C(C1CC(C(O1)=C)=O)=O,,,4,1,2,0,2
20046_0,,,,2,1,2,3
C(C1OCCC(C=1)=O)=O,,,4,1,2,0,2
20048_0,,,,2,1,2,3
C1(COC(C=O)=CC1)=O,,,4,1,2,0,2
20050_0,,,,2,1,2,3
C(C1C(CC=CO1)=O)=O,,,4,1,2,0,2
20052_0,,,,2,1,2,3
C(C1CC(C=CO1)=O)=O,,,4,1,2,0,2
20054_0,,,,2,1,2,3
C(C(C=CC(C)=O)O)=O,,,4,1,3,0,3
20056_0,,,,2,1,2,3
C(CC=CC(C=O)O)=O,,,4,1,3,0,3
20057_0,,,,2,1,2,3
20058_0,,,,2,1,2,3
20059_0,,,,2,1,2,3
20060_0,,,,2,1,2,3
20061_0,,,,2,1,2,3
20062_0,,,,2,1,2,3
20063_0,,,,2,1,2,3
20064_0,,,,2,1,2,3
20065_0,,,,2,1,2,3
20066_0,,,,2,1,2,3
20067_0,,,,2,1,2,3
20068_0,,,,2,1,2,3
20070_0,,,,2,1,2,3
C=CC(CCO)=O,,,4,1,2,0,2
20072_0,,,,2,1,2,3
C(CO)(CC=C)=O,,,4,1,3,0,3
20074_0,,,,2,1,2,3
C(C)(C(C=C)O)=O,,,4,1,3,0,3
20076_0,,,,2,1,2,3
C(CC(C=C)O)=O,,,4,1,2,0,2
20078_0,,,,2,1,2,3
C(CO)=CC(C)=O,,,4,1,2,0,2
20080_0,,,,2,1,2,3
C(CC=CCO)=O,,,4,1,2,0,2
20081_0,,,,2,1,2,3
20083_0,,,,2,1,2,3
C1(C2(CC(C(C1)O2)O)O)=O,,,4,1,2,0,2
20085_0,,,,2,1,2,3
C1(C2CC(C(C1O)O2)O)=O,,,4,1,1,0,1
20087_0,,,,2,1,2,3
C1(C2C(C(C(O2)O)C1)O)=O,,,4,1,4,0,4
20088_0,,,,2,1,2,3
20089_0,,,,2,1,2,3
20091_0,,,,2,1,2,3
C1(COC(C(CO)=O)C1)=O,,,4,1,2,0,2
20093_0,,,,2,1,2,3
C(C)(C1(CC(CO1)=O)O)=O,,,4,1,2,0,2
20094_0,,,,2,1,2,3
20095_0,,,,2,1,2,3
20096_0,,,,2,1,2,3
20098_0,,,,2,1,2,3
C1(CCC(C(CO)=O)O1)=O,,,4,1,1,0,1
20099_0,,,,2,1,2,3
20101_0,,,,2,1,2,3
C1(C(COC1CCO)=O)=O,,,4,1,2,0,2
20103_0,,,,2,1,2,3
C1(CC(C(CCO)O1)=O)=O,,,4,1,1,0,1
20104_0,,,,2,1,2,3
20106_0,,,,2,1,2,3
C(C(C1C(CCO1)O)=O)=O,,,4,1,1,0,1
20108_0,,,,2,1,2,3
C(C(C1C(CCO1)=O)O)=O,,,4,1,1,0,1
20110_0,,,,2,1,2,3
C(C(C1CC(CO1)=O)O)=O,,,4,1,1,0,1
20112_0,,,,2,1,2,3
C1(CCC(C(C=O)O)O1)=O,,,4,1,1,0,1
20114_0,,,,2,1,2,3
C(C(C1C(C(CO1)O)O)=O)=O,,,4,1,1,0,1
20115_0,,,,2,1,2,3
20116_0,,,,2,1,2,3
20118_0,,,,2,1,2,3
C(C(C1(CC(CO1)=O)O)O)=O,,,4,1,2,0,2
20120_0,,,,2,1,2,3
C1(C(CC(C(CO)=O)O1)O)=O,,,4,1,2,0,2
20122_0,,,,2,1,2,3
C1(C(CC(C(C)=O)(O)O1)O)=O,,,4,1,2,0,2
20124_0,,,,2,1,2,3
C(CC1(CC(C(O1)=O)O)O)=O,,,4,1,2,0,2
20126_0,,,,2,1,2,3
C1(C(CC(CCO)(O)O1)=O)=O,,,4,1,2,0,2
20128_0,,,,2,1,2,3
C1(CC(C(CCO)(O)O1)=O)=O,,,4,1,2,0,2
20130_0,,,,2,1,2,3
C1(C(C(C(CCO)O1)=O)O)=O,,,4,1,2,0,2
20131_0,,,,2,1,2,3
20132_0,,,,2,1,2,3
20133_0,,,,2,1,2,3
20134_0,,,,2,1,2,3
20135_0,,,,2,1,2,3
20136_0,,,,2,1,2,3
20137_0,,,,2,1,2,3
20138_0,,,,2,1,2,3
20140_0,,,,2,1,2,3
C1(C2C(CO)OC1CO2)=O,,,4,1,1,0,1
20142_0,,,,2,1,2,3
C1(C2CC(C(CO)O2)O1)=O,,,4,1,1,0,1
20144_0,,,,2,1,2,3
C1(CC2C(CC(O)O2)O1)=O,,,4,1,2,0,2
20146_0,,,,2,1,2,3
C1(COC2CC(OC12)O)=O,,,4,1,2,0,2
20148_0,,,,2,1,2,3
C1(C2CC(OC1CO2)O)=O,,,4,1,2,0,2
20150_0,,,,2,1,2,3
C1(CC2(CC(CO2)O1)O)=O,,,4,1,2,0,2
20152_0,,,,2,1,2,3
C1(COC2COC1(C2)O)=O,,,4,1,2,0,2
20154_0,,,,2,1,2,3
C1(C(O)OC2COC1C2)=O,,,4,1,2,0,2
20156_0,,,,2,1,2,3
C1(C2COCC(C1O)O2)=O,,,4,1,1,0,1
20158_0,,,,2,1,2,3
C1(C2(COCC(C1)O2)O)=O,,,4,1,2,0,2
20160_0,,,,2,1,2,3
C1(C2COCC(C1)(O2)O)=O,,,4,1,2,0,2
20162_0,,,,2,1,2,3
C1(C2CC(C(CO1)O2)O)=O,,,4,1,1,0,1
20164_0,,,,2,1,2,3
C1(COC2C(CC1O2)O)=O,,,4,1,1,0,1
20166_0,,,,2,1,2,3
C1(C2OCCC(C1)(O2)O)=O,,,4,1,2,0,2
20168_0,,,,2,1,2,3
C1(C2(CCOC(C1)O2)O)=O,,,4,1,2,0,2
20170_0,,,,2,1,2,3
C1(C2CCOC(C1O)O2)=O,,,4,1,1,0,1
20172_0,,,,2,1,2,3
C(C1CCC(C=O)O1)(O)=O,,,4,1,1,0,1
20174_0,,,,2,1,2,3
C1(CC(C(O)=O)OC1C)=O,,,4,1,1,0,1
20176_0,,,,2,1,2,3
C1(C2C(C(C(CO)O2)O1)O)=O,,,4,1,1,0,1
20178_0,,,,2,1,2,3
C1(C2C(CO)OC1C(O2)O)=O,,,4,1,2,0,2
20180_0,,,,2,1,2,3
C1(C2CC(C(CO2)O)O1)=O,,,4,1,1,0,1
20182_0,,,,2,1,2,3
C1(C2C(C(C(CO2)O)O1)O)=O,,,4,1,1,0,1
20184_0,,,,2,1,2,3
C1(C2C(COC1C(O2)O)O)=O,,,4,1,2,0,2
20186_0,,,,2,1,2,3
C1(C2C(C(C(CO1)O2)O)O)=O,,,4,1,1,0,1
20188_0,,,,2,1,2,3
C1(C2C(O)OCC(C1O)O2)=O,,,4,1,2,0,2
20190_0,,,,2,1,2,3
C1(C2(C(O)OCC(C1)O2)O)=O,,,4,1,3,0,3
20192_0,,,,2,1,2,3
C1(C2COC(C(C1)(O2)O)O)=O,,,4,1,3,0,3
20194_0,,,,2,1,2,3
C1(CCC(C(CO)O)O1)=O,,,4,1,1,0,1
20196_0,,,,2,1,2,3
C1(COC(C(CO)O)C1)=O,,,4,1,1,0,1
20198_0,,,,2,1,2,3
C(C)(C1CC(C(O1)O)O)=O,,,4,1,2,0,2
20200_0,,,,2,1,2,3
C(CC1CC(C(O)O1)O)=O,,,4,1,2,0,2
20201_0,,,,2,1,2,3
20203_0,,,,2,1,2,3
C(C1CC(C(CO1)=O)O)=O,,,4,1,2,0,2
20204_0,,,,2,1,2,3
20206_0,,,,2,1,2,3
C1(CCC(C(C=O)O1)O)=O,,,4,1,1,0,1
20208_0,,,,2,1,2,3
C1(CC(CC(C=O)O1)O)=O,,,4,1,1,0,1
20209_0,,,,2,1,2,3
20211_0,,,,2,1,2,3
C(C1CCC(C(O1)O)=O)=O,,,4,1,2,0,2
20212_0,,,,2,1,2,3
20214_0,,,,2,1,2,3
C1(C(COC(C)(C1)O)=O)=O,,,4,1,2,0,2
20216_0,,,,2,1,2,3
C1(C(C)(OCC(C1)=O)O)=O,,,4,1,2,0,2
20218_0,,,,2,1,2,3
C1(C(C)OCC(C1O)=O)=O,,,4,1,2,0,2
20220_0,,,,2,1,2,3
C1(CC(C(C(C)O1)=O)O)=O,,,4,1,1,0,1
20221_0,,,,2,1,2,3
20223_0,,,,2,1,2,3
C1(C(C)OC(C(C1)=O)O)=O,,,4,1,2,0,2
20225_0,,,,2,1,2,3
C1(C(C(C)OC(C1)O)=O)=O,,,4,1,2,0,2
20227_0,,,,2,1,2,3
C1(COC(C)(C(C1)O)O)=O,,,4,1,2,0,2
20229_0,,,,2,1,2,3
C1(C(C(C)(O)OCC1)O)=O,,,4,1,2,0,2
20231_0,,,,2,1,2,3
C1(C(COC(C)(C1)O)O)=O,,,4,1,2,0,2
20233_0,,,,2,1,2,3
C1(C(C)(O)OCC(C1)O)=O,,,4,1,2,0,2
20235_0,,,,2,1,2,3
C1(C(C)OCC(C1O)O)=O,,,4,1,1,0,1
20237_0,,,,2,1,2,3
C1(C(CCC(CO)(O)O1)=O)=O,,,4,1,2,0,2
20239_0,,,,2,1,2,3
C1(CC(CC(CO)(O)O1)=O)=O,,,4,1,2,0,2
20241_0,,,,2,1,2,3
C1(C(C(CC(C=O)O1)O)O)=O,,,4,1,2,0,2
20243_0,,,,2,1,2,3
C1(C(CC(C(C)(O)O1)O)=O)=O,,,4,1,2,0,2
20245_0,,,,2,1,2,3
C1(CC(C(C(C)(O)O1)O)=O)=O,,,4,1,2,0,2
20247_0,,,,2,1,2,3
C1(C(C(CC(C)(O)O1)=O)O)=O,,,4,1,2,0,2
20249_0,,,,2,1,2,3
C1(CC(C(OC1(C)O)=O)O)=O,,,4,1,2,0,2
20251_0,,,,2,1,2,3
C1(C(C(C(OC1C)=O)O)O)=O,,,4,1,2,0,2
20253_0,,,,2,1,2,3
C1(C2C(COC1CO2)O)=O,,,4,1,1,0,1
20255_0,,,,2,1,2,3
C1(C2COC(CO2)C1O)=O,,,4,1,1,0,1
20257_0,,,,2,1,2,3
C1(C2(COC(CO2)C1)O)=O,,,4,1,2,0,2
20259_0,,,,2,1,2,3
C1(C2COC(CO2)(C1)O)=O,,,4,1,2,0,2
20261_0,,,,2,1,2,3
C1(C2CC(C(CO2)O1)O)=O,,,4,1,1,0,1
20263_0,,,,2,1,2,3
C1(C(CCC(C=O)O1)O)=O,,,4,1,2,0,2
20265_0,,,,2,1,2,3
C1(CC(C(OC1C)=O)O)=O,,,4,1,2,0,2
20267_0,,,,2,1,2,3
C1(C2C(C(C(CO2)O1)O)O)=O,,,4,1,1,0,1
20269_0,,,,2,1,2,3
C1(C2C(O)OC(CO2)C1O)=O,,,4,1,2,0,2
20271_0,,,,2,1,2,3
C1(C2(C(O)OC(CO2)C1)O)=O,,,4,1,3,0,3
20273_0,,,,2,1,2,3
C1(C2COC(C(O2)O)(C1)O)=O,,,4,1,3,0,3
20275_0,,,,2,1,2,3
C1(CCC(C(CO)O1)O)=O,,,4,1,1,0,1
20277_0,,,,2,1,2,3
C1(COC(CO)C(C1)O)=O,,,4,1,1,0,1
20279_0,,,,2,1,2,3
C1(C(COC(CC1)O)=O)=O,,,4,1,2,0,2
20280_0,,,,2,1,2,3
20282_0,,,,2,1,2,3
C1(COC(CC(C1)O)O)=O,,,4,1,2,0,2
20284_0,,,,2,1,2,3
C1(C(CC(O)OCC1)O)=O,,,4,1,2,0,2
20286_0,,,,2,1,2,3
C1(C(COC(CC1)O)O)=O,,,4,1,2,0,2
20288_0,,,,2,1,2,3
C1(CC(COC(C1)O)O)=O,,,4,1,2,0,2
20290_0,,,,2,1,2,3
C1(CC(C(CCO1)O)O)=O,,,4,1,1,0,1
20292_0,,,,2,1,2,3
C1(COCCC(C1O)O)=O,,,4,1,1,0,1
20294_0,,,,2,1,2,3
C1(C(O)OCCC(C1)O)=O,,,4,1,2,0,2
20296_0,,,,2,1,2,3
C1(C(CCOC(C1)O)O)=O,,,4,1,2,0,2
20298_0,,,,2,1,2,3
C1(C(C(O)OCCC1)O)=O,,,4,1,2,0,2
20300_0,,,,2,1,2,3
C1(CC(C(O)OCC1)O)=O,,,4,1,3,0,3
20302_0,,,,2,1,2,3
C1(C(CC(CC(O)O1)O)=O)=O,,,4,1,2,0,2
20304_0,,,,2,1,2,3
C1(CC(C(CC(O)O1)O)=O)=O,,,4,1,2,0,2
20306_0,,,,2,1,2,3
C1(C(C(CCC(O)O1)=O)O)=O,,,4,1,2,0,2
20308_0,,,,2,1,2,3
C1(CC(C(OC(C1)O)=O)O)=O,,,4,1,2,0,2
20310_0,,,,2,1,2,3
C1(CC(C(CC(O1)=O)O)O)=O,,,4,1,1,0,1
20312_0,,,,2,1,2,3
C1(CC(C(C(CO1)=O)O)O)=O,,,4,1,2,0,2
20314_0,,,,2,1,2,3
C1(CC(CC(C(O)O1)=O)O)=O,,,4,1,2,0,2
20316_0,,,,2,1,2,3
C1(CC(C(CC(O)O1)=O)O)=O,,,4,1,2,0,2
20318_0,,,,2,1,2,3
C1(CCC(OC(C1O)O)=O)=O,,,4,1,2,0,2
20320_0,,,,2,1,2,3
C1(CC(CC(C(O)O1)O)=O)=O,,,4,1,2,0,2
20322_0,,,,2,1,2,3
C1(C2OC(CC(C1)O2)O)=O,,,4,1,2,0,2
20324_0,,,,2,1,2,3
C1(C2CC(O)OC(C1)O2)=O,,,4,1,2,0,2
20326_0,,,,2,1,2,3
C1(CC2C(CC(O2)O1)O)=O,,,4,1,1,0,1
20328_0,,,,2,1,2,3
C1(COC2CC(C1O2)O)=O,,,4,1,1,0,1
20330_0,,,,2,1,2,3
C1(CCC(C(CO1)O)O)=O,,,4,1,1,0,1
20332_0,,,,2,1,2,3
C1(COCC(C(C1)O)O)=O,,,4,1,1,0,1
20333_0,,,,2,1,2,3
20335_0,,,,2,1,2,3
C1(COC(C(CC1)O)O)=O,,,4,1,2,0,2
20337_0,,,,2,1,2,3
C(C)(C1C(C(C(O1)=O)=O)O)=O,,,4,1,2,0,2
20339_0,,,,2,1,2,3
C(CC1C(C(C(O1)=O)=O)O)=O,,,4,1,2,0,2
20341_0,,,,2,1,2,3
C(C1C(CCC(O1)=O)=O)=O,,,4,1,2,0,2
20343_0,,,,2,1,2,3
C1(CC(CC(C=O)O1)=O)=O,,,4,1,2,0,2
20345_0,,,,2,1,2,3
C1(C(C(CC(CO)O1)=O)=O)=O,,,4,1,2,0,2
20347_0,,,,2,1,2,3
C1(C(CO)OC(C(C1)=O)=O)=O,,,4,1,2,0,2
20349_0,,,,2,1,2,3
C1(C(C(CC(CO1)O)=O)=O)=O,,,4,1,2,0,2
20351_0,,,,2,1,2,3
C1(C(COC(C(C1)=O)=O)O)=O,,,4,1,2,0,2
20353_0,,,,2,1,2,3
C1(CCOC(C(C1O)=O)=O)=O,,,4,1,2,0,2
20355_0,,,,2,1,2,3
C1(COC(C(C(C1)O)=O)=O)=O,,,4,1,2,0,2
20357_0,,,,2,1,2,3
C(CC(C(C)=O)CC(C=O)=O)=O,,,4,1,2,0,2
20359_0,,,,2,1,2,3
C(CC(CC=O)CC(C=O)=O)=O,,,4,1,4,0,4
20361_0,,,,2,1,2,3
C(CC(C=O)CC(C(C)=O)=O)=O,,,4,1,3,0,3
20362_0,,,,2,1,2,3
20363_0,,,,2,1,2,3
20364_0,,,,2,1,2,3
20366_0,,,,2,1,2,3
C(CCCC(CC(C=O)=O)=O)=O,,,4,1,2,0,2
20368_0,,,,2,1,2,3
C(CC(C(CCCC=O)=O)=O)=O,,,4,1,2,0,2
20369_0,,,,2,1,2,3
20370_0,,,,2,1,2,3
20372_0,,,,2,1,2,3
C(CCO)(C[C](C(O)=O)O)=O,,,4,1,2,0,2
20374_0,,,,2,1,2,3
C(CO)(CC[C](C(O)=O)O)=O,,,4,1,2,0,2
20376_0,,,,2,1,2,3
C(C)(C(C[C](C(O)=O)O)O)=O,,,4,1,2,0,2
20378_0,,,,2,1,2,3
C(CC(C[C](C(O)=O)O)O)=O,,,4,1,2,0,2
20380_0,,,,2,1,2,3
C([CH]C(C(C(CO)O)O)=O)(O)=O,,,4,1,1,0,1
20382_0,,,,2,1,2,3
C([C](C(CC(CO)O)=O)O)(O)=O,,,4,1,2,0,2
20384_0,,,,2,1,2,3
C(C(CO)O)(C[C](C(O)=O)O)=O,,,4,1,2,0,2
20386_0,,,,2,1,2,3
C(CCO)(C([C](C(O)=O)O)O)=O,,,4,1,2,0,2
20388_0,,,,2,1,2,3
C(CO)(CC([C](C(O)=O)O)O)=O,,,4,1,2,0,2
20390_0,,,,2,1,2,3
C(C)(C(C([C](C(O)=O)O)O)O)=O,,,4,1,2,0,2
20392_0,,,,2,1,2,3
C(CC(C([C](C(O)=O)O)O)O)=O,,,4,1,2,0,2
20393_0,,,,2,1,2,3
20394_0,,,,2,1,2,3
20395_0,,,,2,1,2,3
20396_0,,,,2,1,2,3
20397_0,,,,2,1,2,3
20398_0,,,,2,1,2,3
20400_0,,,,2,1,2,3
C1(CO)C(C(C(C=1)=O)O)O,,,4,1,2,0,2
20401_0,,,,2,1,2,3
20402_0,,,,2,1,2,3
20403_0,,,,2,1,2,3
20404_0,,,,2,1,2,3
20405_0,,,,2,1,2,3
20406_0,,,,2,1,2,3
20407_0,,,,2,1,2,3
20408_0,,,,2,1,2,3
20410_0,,,,2,1,2,3
C(C1CC(C(C=1)=O)O)=O,,,4,1,1,0,1
20411_0,,,,2,1,2,3
20412_0,,,,2,1,2,3
20413_0,,,,2,1,2,3
20415_0,,,,2,1,2,3
C1C(C(C(C=1)=O)=O)CO,,,4,1,1,0,1
20416_0,,,,2,1,2,3
20417_0,,,,2,1,2,3
20418_0,,,,2,1,2,3
20419_0,,,,2,1,2,3
20421_0,,,,2,1,2,3
C1CC(C(C=1C=O)=O)O,,,4,1,1,0,1
20422_0,,,,2,1,2,3
20423_0,,,,2,1,2,3
20424_0,,,,2,1,2,3
20425_0,,,,2,1,2,3
20426_0,,,,2,1,2,3
20427_0,,,,2,1,2,3
20429_0,,,,2,1,2,3
C1(C(CO)=CC(C1O)=O)=O,,,4,1,1,0,1
20431_0,,,,2,1,2,3
C1(C(C(C(C1O)=O)=C)O)=O,,,4,1,1,0,1
20432_0,,,,2,1,2,3
20433_0,,,,2,1,2,3
20435_0,,,,2,1,2,3
C(C1C(C(C(C=1)=O)O)O)=O,,,4,1,2,0,2
20436_0,,,,2,1,2,3
20438_0,,,,2,1,2,3
C1(C(C(C=O)=CC1O)O)=O,,,4,1,1,0,1
20440_0,,,,2,1,2,3
C1C(C(C(C(C=1CO)=O)O)O)O,,,4,1,1,0,1
20442_0,,,,2,1,2,3
C=C1C(C(C(C(C1O)O)O)O)=O,,,4,1,1,0,1
20444_0,,,,2,1,2,3
C(CO)(C(C(C=O)=C)O)=O,,,4,1,1,0,1
20446_0,,,,2,1,2,3
C(CO)(CO)=CC(C=O)=O,,,4,1,1,0,1
20448_0,,,,2,1,2,3
C(CO)(C(C=CC(CO)=O)O)=O,,,4,1,1,0,1
20450_0,,,,2,1,2,3
C(CO)(C(C(CO)=CC=O)O)=O,,,4,1,1,0,1
20452_0,,,,2,1,2,3
C(CO)(CO)=C(C=O)C(CO)=O,,,4,1,1,0,1
20454_0,,,,2,1,2,3
C(C(C(C(C(CO)=O)O)=C)O)=O,,,4,1,1,0,1
20456_0,,,,2,1,2,3
C(C(C(C=C(CO)CO)=O)O)=O,,,4,1,1,0,1
20458_0,,,,2,1,2,3
C(CO)(C(C(C(CO)O)=C)O)=O,,,4,1,1,0,1
20460_0,,,,2,1,2,3
C(CO)(CO)=CC(C(CO)O)=O,,,4,1,1,0,1
20461_0,,,,2,1,2,3
20463_0,,,,2,1,2,3
C(CO)(C(C(C=O)=CCO)O)=O,,,4,1,1,0,1
20464_0,,,,2,1,2,3
20466_0,,,,2,1,2,3
C(CO)(CO)=C(C(C=O)=O)CO,,,4,1,1,0,1
20468_0,,,,2,1,2,3
C=C(C(C=O)=O)C(CO)(CO)O,,,4,1,1,0,1
20470_0,,,,2,1,2,3
C(CO)(C(C(CO)=CCO)O)=O,,,4,1,1,0,1
20471_0,,,,2,1,2,3
20472_0,,,,2,1,2,3
20474_0,,,,2,1,2,3
C(CO)(CO)=C(C(CO)=O)CO,,,4,1,1,0,1
20476_0,,,,2,1,2,3
C=C(C(CO)=O)C(CO)(CO)O,,,4,1,1,0,1
20478_0,,,,2,1,2,3
C(CO)(C(C(CO)=C)O)=O,,,4,1,1,0,1
20480_0,,,,2,1,2,3
C(CO)(CO)=CC(CO)=O,,,4,1,1,0,1
20481_0,,,,2,1,2,3
20482_0,,,,2,1,2,3
20483_0,,,,2,1,2,3
20485_0,,,,2,1,2,3
C(C(C(C=O)=C(CO)CO)O)=O,,,4,1,1,0,1
20487_0,,,,2,1,2,3
C(C=C(C=O)C(CO)(CO)O)=O,,,4,1,2,0,2
20489_0,,,,2,1,2,3
C(CO)(C(C=C)O)=O,,,4,1,1,0,1
20491_0,,,,2,1,2,3
C(CO)(CO)=CC=O,,,4,1,1,0,1
20493_0,,,,2,1,2,3
C(C(CO)O)=C(C=O)C(CO)=O,,,4,1,1,0,1
20495_0,,,,2,1,2,3
C(C(C(C=CC(CO)O)=O)O)=O,,,4,1,1,0,1
20496_0,,,,2,1,2,3
20498_0,,,,2,1,2,3
C(C(CO)O)=C(C(C=O)=O)CO,,,4,1,2,0,2
20500_0,,,,2,1,2,3
C=C(C(C=O)=O)C(C(CO)O)O,,,4,1,1,0,1
20501_0,,,,2,1,2,3
20503_0,,,,2,1,2,3
C(C(CO)O)=C(C(CO)=O)CO,,,4,1,1,0,1
20505_0,,,,2,1,2,3
C=C(C(CO)=O)C(C(CO)O)O,,,4,1,1,0,1
20507_0,,,,2,1,2,3
C(C(C(C=O)=CC(CO)O)O)=O,,,4,1,1,0,1
20509_0,,,,2,1,2,3
C(C=C(C=O)C(C(CO)O)O)=O,,,4,1,2,0,2
20511_0,,,,2,1,2,3
C(C(CO)O)=CC=O,,,4,1,3,0,3
20513_0,,,,2,1,2,3
C(C(C)=CC(C=O)=O)=O,,,4,1,1,0,1
20515_0,,,,2,1,2,3
C=C(C=O)CC(C=O)=O,,,4,1,1,0,1
20517_0,,,,2,1,2,3
C(CO)(CC=CC(C=O)=O)=O,,,4,1,1,0,1
20519_0,,,,2,1,2,3
C(CC(C=O)=O)=CC(CO)=O,,,4,1,1,0,1
20521_0,,,,2,1,2,3
C(CC(CO)=CC(C=O)=O)=O,,,4,1,1,0,1
20523_0,,,,2,1,2,3
C(CO)(CC(C=O)=O)=CC=O,,,4,1,1,0,1
20525_0,,,,2,1,2,3
C(C(C(CO)=O)=CC(C)=O)=O,,,4,1,1,0,1
20527_0,,,,2,1,2,3
C(C(C(CO)=O)C(C=O)=C)=O,,,4,1,1,0,1
20529_0,,,,2,1,2,3
C(C(C(CO)=O)=C(C=O)C)=O,,,4,1,1,0,1
20531_0,,,,2,1,2,3
C(CC(C(C(C=O)=C)O)=O)=O,,,4,1,2,0,2
20533_0,,,,2,1,2,3
C(C)(C(C=CC(C=O)=O)O)=O,,,4,1,1,0,1
20535_0,,,,2,1,2,3
C(C(C(C)=CC(C=O)=O)O)=O,,,4,1,1,0,1
20537_0,,,,2,1,2,3
C(C(C(CC(C=O)=O)=C)O)=O,,,4,1,1,0,1
20539_0,,,,2,1,2,3
C(C(C(C=CC(C)=O)=O)O)=O,,,4,1,1,0,1
20541_0,,,,2,1,2,3
C(C(C(CC(C=O)=C)=O)O)=O,,,4,1,2,0,2
20543_0,,,,2,1,2,3
C(C(C(C=C(C=O)C)=O)O)=O,,,4,1,1,0,1
20545_0,,,,2,1,2,3
C(C(C=CC=O)=O)=O,,,4,1,1,0,1
20547_0,,,,2,1,2,3
C(C)(C(CO)O)=CC(C=O)=O,,,4,1,1,0,1
20549_0,,,,2,1,2,3
C=C(C(CO)O)CC(C=O)=O,,,4,1,1,0,1
20551_0,,,,2,1,2,3
C(C=CC(C)=O)(C(CO)O)=O,,,4,1,1,0,1
20553_0,,,,2,1,2,3
C(C(CO)O)(CC(C=O)=C)=O,,,4,1,1,0,1
20555_0,,,,2,1,2,3
C(C=C(C=O)C)(C(CO)O)=O,,,4,1,1,0,1
20556_0,,,,2,1,2,3
20557_0,,,,2,1,2,3
20559_0,,,,2,1,2,3
C(C(C=C(C=O)CCO)=O)=O,,,4,1,1,0,1
20561_0,,,,2,1,2,3
C(CO)=C(C=O)CC(C=O)=O,,,4,1,1,0,1
20562_0,,,,2,1,2,3
20564_0,,,,2,1,2,3
C(C(C(CO)=CC(C)=O)=O)=O,,,4,1,1,0,1
20566_0,,,,2,1,2,3
C(C)(C(C(C(C=O)=O)=C)O)=O,,,4,1,1,0,1
20568_0,,,,2,1,2,3
C=C(C=O)C(C(C=O)=O)CO,,,4,1,1,0,1
20570_0,,,,2,1,2,3
C(C(C(CO)=C(C=O)C)=O)=O,,,4,1,1,0,1
20572_0,,,,2,1,2,3
C(C(C(C(C=O)=O)=C)(C)O)=O,,,4,1,1,0,1
20574_0,,,,2,1,2,3
C(CO)(CCO)=CC(C=O)=O,,,4,1,1,0,1
20576_0,,,,2,1,2,3
C(CO)=C(CO)CC(C=O)=O,,,4,1,1,0,1
20577_0,,,,2,1,2,3
20578_0,,,,2,1,2,3
20580_0,,,,2,1,2,3
C(CCO)(C(C(C=O)=C)O)=O,,,4,1,1,0,1
20581_0,,,,2,1,2,3
20583_0,,,,2,1,2,3
C(C(CO)=CC(C)=O)(CO)=O,,,4,1,1,0,1
20585_0,,,,2,1,2,3
C(C)(C(C(C(CO)=O)=C)O)=O,,,4,1,1,0,1
20587_0,,,,2,1,2,3
C(CO)(C(C(C=O)=C)CO)=O,,,4,1,1,0,1
20589_0,,,,2,1,2,3
C(C(C)=C(C(CO)=O)CO)=O,,,4,1,1,0,1
20591_0,,,,2,1,2,3
C(C(C(C(CO)=O)=C)(C)O)=O,,,4,1,1,0,1
20592_0,,,,2,1,2,3
20594_0,,,,2,1,2,3
C(C)(CO)=CC(C=O)=O,,,4,1,1,0,1
20596_0,,,,2,1,2,3
C=C(CO)CC(C=O)=O,,,4,1,1,0,1
20597_0,,,,2,1,2,3
20599_0,,,,2,1,2,3
C(CO)(CC(C=O)=C)=O,,,4,1,1,0,1
20601_0,,,,2,1,2,3
C(C(C)=CC(CO)=O)=O,,,4,1,1,0,1
20603_0,,,,2,1,2,3
C(C)(C(C(C=O)=C)O)=O,,,4,1,1,0,1
20605_0,,,,2,1,2,3
C(CC(C=CC(C=O)=O)O)=O,,,4,1,1,0,1
20606_0,,,,2,1,2,3
20608_0,,,,2,1,2,3
C(C(CC=CC(C=O)=O)O)=O,,,4,1,1,0,1
20609_0,,,,2,1,2,3
20611_0,,,,2,1,2,3
C(C(C=CCC(C=O)=O)O)=O,,,4,1,1,0,1
20613_0,,,,2,1,2,3
C(C(C(C=O)=CC(C)=O)O)=O,,,4,1,1,0,1
20615_0,,,,2,1,2,3
C(C)(C(C(C=O)=CC=O)O)=O,,,4,1,2,0,2
20617_0,,,,2,1,2,3
C(C(C(C=O)=C)C(C=O)O)=O,,,4,1,1,0,1
20619_0,,,,2,1,2,3
C(C(C(C=O)=C(C=O)C)O)=O,,,4,1,1,0,1
20621_0,,,,2,1,2,3
C(C(C(C=O)=CC=O)(C)O)=O,,,4,1,2,0,2
20623_0,,,,2,1,2,3
C(C(C(C=CC(C=O)=O)O)O)=O,,,4,1,1,0,1
20625_0,,,,2,1,2,3
C(C)=CC(C=O)=O,,,4,1,1,0,1
20627_0,,,,2,1,2,3
C=CCC(C=O)=O,,,4,1,1,0,1
20629_0,,,,2,1,2,3
C(C=CC(C)=O)=O,,,4,1,1,0,1
20631_0,,,,2,1,2,3
C(CC(C=O)=C)=O,,,4,1,1,0,1
20633_0,,,,2,1,2,3
C(C(C)=CC=O)=O,,,4,1,1,0,1
20634_0,,,,2,1,2,3
20636_0,,,,2,1,2,3
C(C(CO)=CC(C=O)=O)=O,,,4,1,1,0,1
20638_0,,,,2,1,2,3
C=C(C=O)C(C(C=O)=O)O,,,4,1,1,0,1
20640_0,,,,2,1,2,3
C(CO)(C(CO)O)=CC(C=O)=O,,,4,1,1,0,1
20642_0,,,,2,1,2,3
C(C(CO)O)(C(C(C=O)=C)O)=O,,,4,1,2,0,2
20643_0,,,,2,1,2,3
20645_0,,,,2,1,2,3
C(C(C=C(C=O)C(CO)O)=O)=O,,,4,1,1,0,1
20647_0,,,,2,1,2,3
C(C(C(CO)=O)=CC=O)=O,,,4,1,1,0,1
20649_0,,,,2,1,2,3
C=C(C=O)C(CO)=O,,,4,1,1,0,1
20651_0,,,,2,1,2,3
C(C(C=C(C=O)C(CO)=O)O)=O,,,4,1,1,0,1
20653_0,,,,2,1,2,3
C(C)(CO)=C(C=O)C(CO)=O,,,4,1,1,0,1
20655_0,,,,2,1,2,3
C(C(C(CO)=O)C(CO)=C)=O,,,4,1,1,0,1
20657_0,,,,2,1,2,3
C(CC(C(C(CO)=C)O)=O)=O,,,4,1,1,0,1
20659_0,,,,2,1,2,3
C(CO)(CC=CC(CO)=O)=O,,,4,1,1,0,1
20661_0,,,,2,1,2,3
C(CO)(CC(CO)=CC=O)=O,,,4,1,1,0,1
20663_0,,,,2,1,2,3
C(CC(CO)=CC(CO)=O)=O,,,4,1,1,0,1
20665_0,,,,2,1,2,3
C(C)(C(C=CC(CO)=O)O)=O,,,4,1,1,0,1
20667_0,,,,2,1,2,3
C(C)(C(C(CO)=CC=O)O)=O,,,4,1,1,0,1
20669_0,,,,2,1,2,3
C(C)=C(C=O)C(CO)=O,,,4,1,1,0,1
20671_0,,,,2,1,2,3
C(C(C(CO)=O)C=C)=O,,,4,1,1,0,1
20672_0,,,,2,1,2,3
20673_0,,,,2,1,2,3
20674_0,,,,2,1,2,3
20676_0,,,,2,1,2,3
C(CC(CO)=CC=O)=O,,,4,1,1,0,1
20678_0,,,,2,1,2,3
C(C(C(CO)=O)=CC(CO)=O)=O,,,4,1,1,0,1
20680_0,,,,2,1,2,3
C(C(C(CO)=O)=C(C=O)CO)=O,,,4,1,1,0,1
20682_0,,,,2,1,2,3
C(C(C(C=O)=O)O)=CC(CO)=O,,,4,1,1,0,1
20684_0,,,,2,1,2,3
C(CO)(C(C(C=O)=O)O)=CC=O,,,4,1,1,0,1
20685_0,,,,2,1,2,3
20687_0,,,,2,1,2,3
C(C(C(C=C)=O)O)=O,,,4,1,4,0,4
20689_0,,,,2,1,2,3
C(C(C(C=CC(C=O)O)=O)O)=O,,,4,1,1,0,1
20691_0,,,,2,1,2,3
C(C(C(C=C(CO)C)=O)O)=O,,,4,1,1,0,1
20693_0,,,,2,1,2,3
C(C(C=O)O)(CC(CO)=C)=O,,,4,1,1,0,1
20695_0,,,,2,1,2,3
C(C(C(CC(CO)=O)=C)O)=O,,,4,1,1,0,1
20697_0,,,,2,1,2,3
C(C(C(C)=CC(CO)=O)O)=O,,,4,1,1,0,1
20699_0,,,,2,1,2,3
C(C(C(C(C(C)=O)O)=C)O)=O,,,4,1,1,0,1
20701_0,,,,2,1,2,3
C(C(C(C=CC)=O)O)=O,,,4,1,1,0,1
20702_0,,,,2,1,2,3
20703_0,,,,2,1,2,3
20705_0,,,,2,1,2,3
C(CC(C(C=O)O)=C)=O,,,4,1,1,0,1
20707_0,,,,2,1,2,3
C(C(C(C)=CC=O)O)=O,,,4,1,1,0,1
20709_0,,,,2,1,2,3
C(C(C(C=CC(CO)=O)=O)O)=O,,,4,1,1,0,1
20711_0,,,,2,1,2,3
C(C(C(C=C(C=O)CO)=O)O)=O,,,4,1,1,0,1
20713_0,,,,2,1,2,3
C(C(C(C(C(C=O)=O)O)=C)O)=O,,,4,1,1,0,1
20715_0,,,,2,1,2,3
C(C(C(C(CO)=O)=CC=O)O)=O,,,4,1,1,0,1
20716_0,,,,2,1,2,3
20718_0,,,,2,1,2,3
C(C(C(CO)=CC=O)=O)=O,,,4,1,1,0,1
20720_0,,,,2,1,2,3
C(C(C(C(C=O)=O)=C)O)=O,,,4,1,1,0,1
20721_0,,,,2,1,2,3
20722_0,,,,2,1,2,3
20724_0,,,,2,1,2,3
C(C(C(C=O)=CC=O)O)=O,,,4,1,2,0,2
20725_0,,,,2,1,2,3
20726_0,,,,2,1,2,3
20728_0,,,,2,1,2,3
C(CO)(C)=CC(C(CO)O)=O,,,4,1,1,0,1
20730_0,,,,2,1,2,3
C(C(CO)O)(CC(CO)=C)=O,,,4,1,1,0,1
20732_0,,,,2,1,2,3
C(CO)(CC(C(CO)O)=C)=O,,,4,1,1,0,1
20734_0,,,,2,1,2,3
C(C)(C(CO)O)=CC(CO)=O,,,4,1,1,0,1
20736_0,,,,2,1,2,3
C(C)(C(C(C(CO)O)=C)O)=O,,,4,1,1,0,1
20738_0,,,,2,1,2,3
C(C)=CC(C(CO)O)=O,,,4,1,1,0,1
20740_0,,,,2,1,2,3
C(C(CO)O)(CC=C)=O,,,4,1,1,0,1
20742_0,,,,2,1,2,3
C(CC(C(CO)O)=C)=O,,,4,1,1,0,1
20744_0,,,,2,1,2,3
C(C)(C(CO)O)=CC=O,,,4,1,1,0,1
20745_0,,,,2,1,2,3
20747_0,,,,2,1,2,3
C(C=C(C=O)CO)(C(CO)O)=O,,,4,1,2,0,2
20749_0,,,,2,1,2,3
C=C(C(CO)O)C(C(C=O)=O)O,,,4,1,1,0,1
20751_0,,,,2,1,2,3
C(C=C(C(CO)=O)C(C)O)=O,,,4,1,1,0,1
20753_0,,,,2,1,2,3
C(C(C(C(CO)=O)=CC)O)=O,,,4,1,1,0,1
20755_0,,,,2,1,2,3
C(C(C(C(CO)=O)C=C)O)=O,,,4,1,1,0,1
20756_0,,,,2,1,2,3
20758_0,,,,2,1,2,3
C(C(CC(C(C=C)O)=O)O)=O,,,4,1,1,0,1
20759_0,,,,2,1,2,3
20760_0,,,,2,1,2,3
20761_0,,,,2,1,2,3
20763_0,,,,2,1,2,3
C(CC(CO)=CC(C=O)O)=O,,,4,1,1,0,1
20765_0,,,,2,1,2,3
C(C(CC(CO)=CC=O)O)=O,,,4,1,1,0,1
20767_0,,,,2,1,2,3
C=C(C(C=O)=O)CO,,,4,1,1,0,1
20769_0,,,,2,1,2,3
C=C(C(CO)=O)CO,,,4,1,2,0,2
20771_0,,,,2,1,2,3
C(C(C(C=O)=C)O)=O,,,4,1,2,0,2
20773_0,,,,2,1,2,3
C(C(CO)=CC=O)=O,,,4,1,2,0,2
20775_0,,,,2,1,2,3
C=CC=O,,,4,1,5,0,5
20776_0,,,,2,1,2,3
20777_0,,,,2,1,2,3
20778_0,,,,2,1,2,3
20780_0,,,,2,1,2,3
C=C(C(C(CO)=O)=O)C(CO)O,,,4,1,1,0,1
20782_0,,,,2,1,2,3
C(CO)=C(C(C(CO)=O)=O)CO,,,4,1,1,0,1
20784_0,,,,2,1,2,3
C=C(C(C(CO)O)=O)C(CO)=O,,,4,1,1,0,1
20785_0,,,,2,1,2,3
20786_0,,,,2,1,2,3
20787_0,,,,2,1,2,3
20789_0,,,,2,1,2,3
C(CO)(C(C(C(CO)=C)=O)O)=O,,,4,1,1,0,1
20790_0,,,,2,1,2,3
20792_0,,,,2,1,2,3
C(CO)(C(C(C(CO)=O)=C)O)=O,,,4,1,1,0,1
20794_0,,,,2,1,2,3
C(C(CO)=CC(CO)=O)(CO)=O,,,4,1,2,0,2
20795_0,,,,2,1,2,3
20797_0,,,,2,1,2,3
C(CO)(C(C(C(C=O)=C)O)O)=O,,,4,1,1,0,1
20799_0,,,,2,1,2,3
C(CO)(C(C=C(C=O)CO)O)=O,,,4,1,2,0,2
20801_0,,,,2,1,2,3
C=C(C(C(C(CO)O)O)=O)CO,,,4,1,1,0,1
20803_0,,,,2,1,2,3
C=C(C(C(CO)O)=O)C(CO)O,,,4,1,1,0,1
20805_0,,,,2,1,2,3
C(CO)=C(C(C(CO)O)=O)CO,,,4,1,1,0,1
20807_0,,,,2,1,2,3
C=C(C=O)C(C(C(CO)O)O)O,,,4,1,1,0,1
20809_0,,,,2,1,2,3
C(C(C(CO)O)O)=C(C=O)CO,,,4,1,2,0,2
20810_0,,,,2,1,2,3
20811_0,,,,2,1,2,3
20813_0,,,,2,1,2,3
C=C(C(CCO)=O)C(C=O)=O,,,4,1,1,0,1
20814_0,,,,2,1,2,3
20816_0,,,,2,1,2,3
C=C(C(CC(C=O)=O)=O)CO,,,4,1,1,0,1
20818_0,,,,2,1,2,3
C(CO)(CC(C(C=O)=O)=C)=O,,,4,1,1,0,1
20820_0,,,,2,1,2,3
C=C(C(CO)=O)CC(C=O)=O,,,4,1,1,0,1
20822_0,,,,2,1,2,3
C(CC(C(C(C=O)=O)=C)O)=O,,,4,1,1,0,1
20824_0,,,,2,1,2,3
C(CC=C(C(C=O)=O)CO)=O,,,4,1,1,0,1
20825_0,,,,2,1,2,3
20826_0,,,,2,1,2,3
20828_0,,,,2,1,2,3
C=C(C=O)C(CC(C=O)=O)O,,,4,1,1,0,1
20830_0,,,,2,1,2,3
C(CC(C=O)=O)=C(C=O)CO,,,4,1,1,0,1
20832_0,,,,2,1,2,3
C=C(C=O)C(C(CCO)=O)=O,,,4,1,1,0,1
20833_0,,,,2,1,2,3
20835_0,,,,2,1,2,3
C(CC(C(C(CO)=C)=O)=O)=O,,,4,1,1,0,1
20837_0,,,,2,1,2,3
C(CO)(CC(C(C=O)=C)=O)=O,,,4,1,1,0,1
20839_0,,,,2,1,2,3
C(CC(C(C(CO)=O)=C)=O)=O,,,4,1,1,0,1
20841_0,,,,2,1,2,3
C(C)(C(C(C(C=O)=C)=O)O)=O,,,4,1,1,0,1
20843_0,,,,2,1,2,3
C(CC(C(C(C=C)=O)O)=O)=O,,,4,1,1,0,1
20845_0,,,,2,1,2,3
C(CC(C(C(C=O)=C)=O)O)=O,,,4,1,1,0,1
20846_0,,,,2,1,2,3
20847_0,,,,2,1,2,3
20849_0,,,,2,1,2,3
C(CC(C=C(C=O)CO)=O)=O,,,4,1,2,0,2
20851_0,,,,2,1,2,3
C(C(C(C(C(C)=O)=C)=O)O)=O,,,4,1,1,0,1
20853_0,,,,2,1,2,3
C(C(C(CC(C=C)=O)=O)O)=O,,,4,1,1,0,1
20855_0,,,,2,1,2,3
C(CC(C(C(C=O)O)=O)=C)=O,,,4,1,1,0,1
20856_0,,,,2,1,2,3
20858_0,,,,2,1,2,3
C(C(C(C(C(C)=O)=O)=C)O)=O,,,4,1,1,0,1
20860_0,,,,2,1,2,3
C(C=C(C(C(C)=O)=O)CO)=O,,,4,1,1,0,1
20861_0,,,,2,1,2,3
20863_0,,,,2,1,2,3
C(C(CC(C(C=C)=O)=O)O)=O,,,4,1,1,0,1
20865_0,,,,2,1,2,3
C(CC(C(C(C=O)O)=C)=O)=O,,,4,1,1,0,1
20867_0,,,,2,1,2,3
C(CC(C(CO)=CC=O)=O)=O,,,4,1,2,0,2
20868_0,,,,2,1,2,3
20870_0,,,,2,1,2,3
C(C(CC(C(C=O)=C)=O)O)=O,,,4,1,1,0,1
20872_0,,,,2,1,2,3
C=C1C(C(OC1C(CO)O)O)=O,,,4,1,1,0,1
20874_0,,,,2,1,2,3
C=C1C(C(C(CO)O)OC1O)=O,,,4,1,1,0,1
20876_0,,,,2,1,2,3
C1OC(C(C=1CO)=O)C(CO)O,,,4,1,1,0,1
20878_0,,,,2,1,2,3
C=CC(C1C(C(C(O1)O)O)O)=O,,,4,1,1,0,1
20880_0,,,,2,1,2,3
C=C(C=O)C1C(C(C(O1)O)O)O,,,4,1,1,0,1
20882_0,,,,2,1,2,3
C=C1C(C(O)OC(CO)C1O)=O,,,4,1,1,0,1
20884_0,,,,2,1,2,3
C1C(CO)OC(C(C=1CO)=O)O,,,4,1,1,0,1
20886_0,,,,2,1,2,3
C=C1C(C(C(CO)OC1O)O)=O,,,4,1,1,0,1
20888_0,,,,2,1,2,3
C1OC(CO)C(C(C=1CO)=O)O,,,4,1,1,0,1
20890_0,,,,2,1,2,3
C=C1C(C(C(OC1CO)O)O)=O,,,4,1,1,0,1
20892_0,,,,2,1,2,3
C=C1C(C(CO)OC(C1O)O)=O,,,4,1,1,0,1
20894_0,,,,2,1,2,3
C1C(OC(C(C=1CO)=O)CO)O,,,4,1,1,0,1
20896_0,,,,2,1,2,3
C=C1C(C(O)OCC(C1O)O)=O,,,4,1,1,0,1
20898_0,,,,2,1,2,3
C1C(COC(C(C=1CO)=O)O)O,,,4,1,1,0,1
20900_0,,,,2,1,2,3
C=C1C(C(C(COC1O)O)O)=O,,,4,1,1,0,1
20902_0,,,,2,1,2,3
C1OCC(C(C(C=1CO)=O)O)O,,,4,1,1,0,1
20904_0,,,,2,1,2,3
C=C1C(C(C(O)OCC1O)O)=O,,,4,1,1,0,1
20906_0,,,,2,1,2,3
C1COC(C(C(C=1CO)=O)O)O,,,4,1,1,0,1
20908_0,,,,2,1,2,3
C=C1C(C(COC(C1O)O)O)=O,,,4,1,1,0,1
20910_0,,,,2,1,2,3
C1C(O)OCC(C(C=1CO)=O)O,,,4,1,1,0,1
20912_0,,,,2,1,2,3
C=C1C(C(C(C(OC1)O)O)O)=O,,,4,1,1,0,1
20914_0,,,,2,1,2,3
C=C1C(COC(C(C1O)O)O)=O,,,4,1,1,0,1
20916_0,,,,2,1,2,3
C1C(C(OCC(C=1CO)=O)O)O,,,4,1,1,0,1
20917_0,,,,2,1,2,3
20919_0,,,,2,1,2,3
C(C(C(C(CCO)=O)=C)O)(O)=O,,,4,1,1,0,1
20921_0,,,,2,1,2,3
C(C(CO)=CC(O)=O)(CCO)=O,,,4,1,1,0,1
20922_0,,,,2,1,2,3
20923_0,,,,2,1,2,3
20925_0,,,,2,1,2,3
C(C(CC(C(CO)=C)=O)O)(O)=O,,,4,1,1,0,1
20926_0,,,,2,1,2,3
20928_0,,,,2,1,2,3
C(C(CC(C(CO)=O)=C)O)(O)=O,,,4,1,1,0,1
20929_0,,,,2,1,2,3
20930_0,,,,2,1,2,3
20931_0,,,,2,1,2,3
20933_0,,,,2,1,2,3
C(C(CC(C(C=C)=O)O)O)(O)=O,,,4,1,1,0,1
20934_0,,,,2,1,2,3
20935_0,,,,2,1,2,3
20937_0,,,,2,1,2,3
C(C(CC(C(C=O)=C)O)O)(O)=O,,,4,1,1,0,1
20939_0,,,,2,1,2,3
C(C(CC=C(C=O)CO)O)(O)=O,,,4,1,1,0,1
20941_0,,,,2,1,2,3
C=C(C(C(C=O)=O)=O)C(CO)O,,,4,1,1,0,1
20943_0,,,,2,1,2,3
C(CO)=C(C(C(C=O)=O)=O)CO,,,4,1,1,0,1
20945_0,,,,2,1,2,3
C=C(C(C(CO)O)=O)C(C=O)=O,,,4,1,1,0,1
20947_0,,,,2,1,2,3
C=C(C(C(C(C=O)=O)O)=O)CO,,,4,1,1,0,1
20949_0,,,,2,1,2,3
C=C(C(CO)=O)C(C(C=O)=O)O,,,4,1,1,0,1
20951_0,,,,2,1,2,3
C(C(C=C(C(CO)=O)CO)=O)=O,,,4,1,1,0,1
20952_0,,,,2,1,2,3
20953_0,,,,2,1,2,3
20955_0,,,,2,1,2,3
C=C(C=O)C(C(C(C=O)=O)O)O,,,4,1,1,0,1
20957_0,,,,2,1,2,3
C(C(C(C=O)=O)O)=C(C=O)CO,,,4,1,1,0,1
20959_0,,,,2,1,2,3
C=C(C=O)C1(C(C(CO1)O)O)O,,,4,1,1,0,1
20961_0,,,,2,1,2,3
C1(C(C(CO1)O)O)=C(C=O)CO,,,4,1,1,0,1
20963_0,,,,2,1,2,3
C(C(C(C(C(C=O)=O)=C)O)O)=O,,,4,1,1,0,1
20965_0,,,,2,1,2,3
C(C(C=C(C(C=O)=O)CO)O)=O,,,4,1,1,0,1
20967_0,,,,2,1,2,3
C=C(C(C=O)=O)C(CO)(C)O,,,4,1,1,0,1
20969_0,,,,2,1,2,3
C(C)(CO)=C(C(C=O)=O)CO,,,4,1,1,0,1
20971_0,,,,2,1,2,3
C=C(CO)C(C(C=O)=O)CO,,,4,1,1,0,1
20972_0,,,,2,1,2,3
20974_0,,,,2,1,2,3
C(C=CC(CO)=O)(CCO)=O,,,4,1,1,0,1
20976_0,,,,2,1,2,3
C(CO)(CC(C=O)=CCO)=O,,,4,1,1,0,1
20977_0,,,,2,1,2,3
20979_0,,,,2,1,2,3
C(C(CCO)=CC(CO)=O)=O,,,4,1,1,0,1
20981_0,,,,2,1,2,3
C(C)(C(C(C=O)=CCO)O)=O,,,4,1,1,0,1
20982_0,,,,2,1,2,3
20984_0,,,,2,1,2,3
C=C(C(C=O)=O)C(C)O,,,4,1,1,0,1
20986_0,,,,2,1,2,3
C(C)=C(C(C=O)=O)CO,,,4,1,1,0,1
20988_0,,,,2,1,2,3
C=CC(C(C=O)=O)CO,,,4,1,1,0,1
20989_0,,,,2,1,2,3
20990_0,,,,2,1,2,3
20992_0,,,,2,1,2,3
C(CC(C=O)=CCO)=O,,,4,1,1,0,1
20993_0,,,,2,1,2,3
20995_0,,,,2,1,2,3
C(C=C(C=O)CCO)=O,,,4,1,1,0,1
20997_0,,,,2,1,2,3
C(CO)(C(C(C(C=O)=O)=C)O)=O,,,4,1,1,0,1
20999_0,,,,2,1,2,3
C(C(C(CO)=CC(CO)=O)=O)=O,,,4,1,2,0,2
21001_0,,,,2,1,2,3
C(C(C(C(C=O)=O)=C)(CO)O)=O,,,4,1,1,0,1
21003_0,,,,2,1,2,3
C(C(C(CO)=C(C=O)CO)=O)=O,,,4,1,1,0,1
21005_0,,,,2,1,2,3
C(CO)=C(C=O)C(C(C=O)=O)O,,,4,1,1,0,1
21006_0,,,,2,1,2,3
21007_0,,,,2,1,2,3
21009_0,,,,2,1,2,3
C(C(C(C(C(CO)=O)=C)O)O)=O,,,4,1,1,0,1
21011_0,,,,2,1,2,3
C(C(C=C(C(CO)=O)CO)O)=O,,,4,1,2,0,2
21012_0,,,,2,1,2,3
21014_0,,,,2,1,2,3
C(CCO)(C(C(CO)=C)O)=O,,,4,1,1,0,1
21016_0,,,,2,1,2,3
C=C(C(CO)=O)C(CO)(C)O,,,4,1,1,0,1
21018_0,,,,2,1,2,3
C(C)(CO)=C(C(CO)=O)CO,,,4,1,1,0,1
21020_0,,,,2,1,2,3
C(CO)(C(C(CO)=C)CO)=O,,,4,1,1,0,1
21022_0,,,,2,1,2,3
C(CO)(CC(CO)=CCO)=O,,,4,1,1,0,1
21023_0,,,,2,1,2,3
21025_0,,,,2,1,2,3
C(CO)(CCO)=CC(CO)=O,,,4,1,1,0,1
21027_0,,,,2,1,2,3
C(C)(C(C(CO)=CCO)O)=O,,,4,1,1,0,1
21028_0,,,,2,1,2,3
21029_0,,,,2,1,2,3
21031_0,,,,2,1,2,3
C(CCO)(C(C=C)O)=O,,,4,1,1,0,1
21033_0,,,,2,1,2,3
C=C(C(CO)=O)C(C)O,,,4,1,1,0,1
21035_0,,,,2,1,2,3
C(C)=C(C(CO)=O)CO,,,4,1,1,0,1
21037_0,,,,2,1,2,3
C(CO)(C(C=C)CO)=O,,,4,1,1,0,1
21039_0,,,,2,1,2,3
C(CC(CO)=CCO)=O,,,4,1,1,0,1
21040_0,,,,2,1,2,3
21042_0,,,,2,1,2,3
C(CO)(CCO)=CC=O,,,4,1,1,0,1
21043_0,,,,2,1,2,3
21045_0,,,,2,1,2,3
C(C(C(C(CO)=O)=C)(CO)O)=O,,,4,1,1,0,1
21047_0,,,,2,1,2,3
C(C(CO)=C(C(CO)=O)CO)=O,,,4,1,1,0,1
21049_0,,,,2,1,2,3
C(CO)=C(CO)C(C(C=O)=O)O,,,4,1,1,0,1
21050_0,,,,2,1,2,3
21052_0,,,,2,1,2,3
C(C(C(C(C=CC)=O)O)O)=O,,,4,1,1,0,1
21054_0,,,,2,1,2,3
C(C(C(C(CC=C)=O)O)O)=O,,,4,1,1,0,1
21055_0,,,,2,1,2,3
21057_0,,,,2,1,2,3
C(CC(C(C(C=O)O)O)=C)=O,,,4,1,1,0,1
21059_0,,,,2,1,2,3
C(C(C(C(C)=CC=O)O)O)=O,,,4,1,1,0,1
21061_0,,,,2,1,2,3
C(C(C(C=O)=CC(C=O)O)O)=O,,,4,1,1,0,1
21063_0,,,,2,1,2,3
C(C(C(C(C=O)=CC=O)O)O)=O,,,4,1,2,0,2
21064_0,,,,2,1,2,3
21066_0,,,,2,1,2,3
C(C)(CO)=CC(CO)=O,,,4,1,1,0,1
21068_0,,,,2,1,2,3
C(CO)(CC(CO)=C)=O,,,4,1,1,0,1
21070_0,,,,2,1,2,3
C(C)(C(C(CO)=C)O)=O,,,4,1,1,0,1
21072_0,,,,2,1,2,3
C(C(CC=CC(CO)=O)O)=O,,,4,1,1,0,1
21073_0,,,,2,1,2,3
21075_0,,,,2,1,2,3
C(C(C=CCC(CO)=O)O)=O,,,4,1,1,0,1
21076_0,,,,2,1,2,3
21078_0,,,,2,1,2,3
C(C(C=CC(C(C)=O)O)O)=O,,,4,1,1,0,1
21080_0,,,,2,1,2,3
C(C(C(CO)=C)C(C=O)O)=O,,,4,1,1,0,1
21082_0,,,,2,1,2,3
C(C(C(C=O)=C(CO)C)O)=O,,,4,1,1,0,1
21084_0,,,,2,1,2,3
C(C=C(C=O)C(CO)(C)O)=O,,,4,1,2,0,2
21085_0,,,,2,1,2,3
21087_0,,,,2,1,2,3
C(C)=CC(CO)=O,,,4,1,1,0,1
21088_0,,,,2,1,2,3
21089_0,,,,2,1,2,3
21091_0,,,,2,1,2,3
C(CC(CO)=C)=O,,,4,1,1,0,1
21093_0,,,,2,1,2,3
C(C)(CO)=CC=O,,,4,1,1,0,1
21095_0,,,,2,1,2,3
C(C(CO)=CC(CO)=O)=O,,,4,1,1,0,1
21097_0,,,,2,1,2,3
C=C(CO)C(C(C=O)=O)O,,,4,1,1,0,1
21099_0,,,,2,1,2,3
C(CO)(C(CO)O)=CC(CO)=O,,,4,1,1,0,1
21101_0,,,,2,1,2,3
C(C(CO)O)(C(C(CO)=C)O)=O,,,4,1,1,0,1
21103_0,,,,2,1,2,3
C(C(C(CO)O)=CC(CO)=O)=O,,,4,1,1,0,1
21105_0,,,,2,1,2,3
C(C=C(C=O)C(C)O)=O,,,4,1,2,0,2
21107_0,,,,2,1,2,3
C(C(C(C=O)=CC)O)=O,,,4,1,1,0,1
21109_0,,,,2,1,2,3
C(C(C=C)C(C=O)O)=O,,,4,1,1,0,1
21110_0,,,,2,1,2,3
21111_0,,,,2,1,2,3
21112_0,,,,2,1,2,3
21114_0,,,,2,1,2,3
C(C(CC=CC=O)O)=O,,,4,1,2,0,2
21116_0,,,,2,1,2,3
C(CO)(C(C(C=O)=CC=O)O)=O,,,4,1,2,0,2
21118_0,,,,2,1,2,3
C(C(C(C=O)=CC(CO)=O)O)=O,,,4,1,2,0,2
21120_0,,,,2,1,2,3
C(C(C(C=O)=CC=O)(CO)O)=O,,,4,1,2,0,2
21122_0,,,,2,1,2,3
C(C(C(C=O)=C(C=O)CO)O)=O,,,4,1,1,0,1
21123_0,,,,2,1,2,3
21124_0,,,,2,1,2,3
21126_0,,,,2,1,2,3
C(C(C=CC(C(C=O)=O)O)O)=O,,,4,1,1,0,1
21128_0,,,,2,1,2,3
C(C)=CC=O,,,4,1,1,0,1
21130_0,,,,2,1,2,3
C(CC=C)=O,,,4,1,1,0,1
21131_0,,,,2,1,2,3
21132_0,,,,2,1,2,3
21134_0,,,,2,1,2,3
C=CC(C(C=O)=O)O,,,4,1,1,0,1
21136_0,,,,2,1,2,3
C(CO)(C(CO)O)=CC=O,,,4,1,1,0,1
21137_0,,,,2,1,2,3
21139_0,,,,2,1,2,3
C(CCO)(CC(C=CC=O)=O)=O,,,4,1,1,0,1
21140_0,,,,2,1,2,3
21142_0,,,,2,1,2,3
C(CCO)(CC(C=O)=CC=O)=O,,,4,1,1,0,1
21144_0,,,,2,1,2,3
C(CC(C=O)=CC(CCO)=O)=O,,,4,1,1,0,1
21145_0,,,,2,1,2,3
21147_0,,,,2,1,2,3
C(CCO)(CC(C=O)=O)=CC=O,,,4,1,1,0,1
21149_0,,,,2,1,2,3
C(CC(CCO)=CC(C=O)=O)=O,,,4,1,1,0,1
21151_0,,,,2,1,2,3
C(CC(CC(C=O)=O)=CCO)=O,,,4,1,2,0,2
21152_0,,,,2,1,2,3
21154_0,,,,2,1,2,3
C(CCO)(C(C=C)C(C=O)=O)=O,,,4,1,1,0,1
21156_0,,,,2,1,2,3
C(C)=C(C(CCO)=O)C(C=O)=O,,,4,1,1,0,1
21157_0,,,,2,1,2,3
21159_0,,,,2,1,2,3
C(CC(C=O)=O)(C(C=C)CO)=O,,,4,1,1,0,1
21161_0,,,,2,1,2,3
C(C)=C(C(CC(C=O)=O)=O)CO,,,4,1,1,0,1
21163_0,,,,2,1,2,3
C=C(C(CC(C=O)=O)=O)C(C)O,,,4,1,1,0,1
21165_0,,,,2,1,2,3
C(CO)(CCC(C=CC=O)=O)=O,,,4,1,1,0,1
21167_0,,,,2,1,2,3
C(CO)(CCC(C=O)=CC=O)=O,,,4,1,1,0,1
21169_0,,,,2,1,2,3
C(CC(C=O)=CCC(CO)=O)=O,,,4,1,1,0,1
21171_0,,,,2,1,2,3
C(CO)(CCC(C=O)=O)=CC=O,,,4,1,1,0,1
21173_0,,,,2,1,2,3
C(CC(CO)=CCC(C=O)=O)=O,,,4,1,1,0,1
21175_0,,,,2,1,2,3
C(CC(C=C)C(C=O)=O)(CO)=O,,,4,1,1,0,1
21177_0,,,,2,1,2,3
C(CO)(CC(C(C=O)=O)=CC)=O,,,4,1,1,0,1
21179_0,,,,2,1,2,3
C(CO)(C(C=C)CC(C=O)=O)=O,,,4,1,1,0,1
21181_0,,,,2,1,2,3
C(C)=C(C(CO)=O)CC(C=O)=O,,,4,1,1,0,1
21183_0,,,,2,1,2,3
C(CCC(C=O)=O)(C(C=C)O)=O,,,4,1,1,0,1
21185_0,,,,2,1,2,3
C(C)(C(CC(C=CC=O)=O)O)=O,,,4,1,1,0,1
21186_0,,,,2,1,2,3
21188_0,,,,2,1,2,3
C(C)(C(CC(C=O)=CC=O)O)=O,,,4,1,1,0,1
21190_0,,,,2,1,2,3
C(CC(C=O)=CC(C(C)=O)O)=O,,,4,1,1,0,1
21191_0,,,,2,1,2,3
21193_0,,,,2,1,2,3
C(C)(C(CC(C=O)=O)O)=CC=O,,,4,1,1,0,1
21194_0,,,,2,1,2,3
21196_0,,,,2,1,2,3
C(CC(C(CC(C=O)=O)O)=C)=O,,,4,1,1,0,1
21198_0,,,,2,1,2,3
C(C)(C(C(C=C)C(C=O)=O)O)=O,,,4,1,1,0,1
21200_0,,,,2,1,2,3
C(C)(C(C(C(C=O)=O)=CC)O)=O,,,4,1,1,0,1
21202_0,,,,2,1,2,3
C(C(C(C(C)O)=CC(C)=O)=O)=O,,,4,1,1,0,1
21204_0,,,,2,1,2,3
C(C(CC(C=O)=O)O)(CC=C)=O,,,4,1,1,0,1
21205_0,,,,2,1,2,3
21207_0,,,,2,1,2,3
C(C)=CC(C(CC(C=O)=O)O)=O,,,4,1,1,0,1
21208_0,,,,2,1,2,3
21209_0,,,,2,1,2,3
21210_0,,,,2,1,2,3
21212_0,,,,2,1,2,3
C(CC(CC(C=O)=CC=O)O)=O,,,4,1,1,0,1
21214_0,,,,2,1,2,3
C(CC(C=O)=CC(CC=O)O)=O,,,4,1,1,0,1
21215_0,,,,2,1,2,3
21216_0,,,,2,1,2,3
21218_0,,,,2,1,2,3
C(CC(CC(C=O)=O)O)=CC=O,,,4,1,1,0,1
21219_0,,,,2,1,2,3
21220_0,,,,2,1,2,3
21222_0,,,,2,1,2,3
C(CC=CC(CC(C=O)=O)O)=O,,,4,1,1,0,1
21224_0,,,,2,1,2,3
C(CC(C(C=C)C(C=O)=O)O)=O,,,4,1,1,0,1
21226_0,,,,2,1,2,3
C(CC(C(C(C=O)=O)=CC)O)=O,,,4,1,1,0,1
21228_0,,,,2,1,2,3
C(CC=C(C(C=O)=O)C(C)O)=O,,,4,1,1,0,1
21229_0,,,,2,1,2,3
21231_0,,,,2,1,2,3
C(C(C=C)C(CC(C=O)=O)O)=O,,,4,1,1,0,1
21232_0,,,,2,1,2,3
21234_0,,,,2,1,2,3
C(C)=C(C=O)C(CC(C=O)=O)O,,,4,1,1,0,1
21236_0,,,,2,1,2,3
C(CC(C=O)=O)=C(C=O)C(C)O,,,4,1,1,0,1
21238_0,,,,2,1,2,3
C(CC(C(CCO)=O)=O)=CC=O,,,4,1,1,0,1
21240_0,,,,2,1,2,3
C(CC=CC(C(CCO)=O)=O)=O,,,4,1,1,0,1
21241_0,,,,2,1,2,3
21243_0,,,,2,1,2,3
C(CC(C(CCO)=O)=CC=O)=O,,,4,1,1,0,1
21244_0,,,,2,1,2,3
21246_0,,,,2,1,2,3
C(CC(C(CCO)=CC=O)=O)=O,,,4,1,1,0,1
21248_0,,,,2,1,2,3
C(CC(C(CC=O)=CCO)=O)=O,,,4,1,1,0,1
21249_0,,,,2,1,2,3
21251_0,,,,2,1,2,3
C(C(C=C)C(C(CCO)=O)=O)=O,,,4,1,1,0,1
21253_0,,,,2,1,2,3
C(C)=C(C=O)C(C(CCO)=O)=O,,,4,1,1,0,1
21254_0,,,,2,1,2,3
21256_0,,,,2,1,2,3
C(CC(C(C(C=C)CO)=O)=O)=O,,,4,1,1,0,1
21258_0,,,,2,1,2,3
C(CC(C(C(CO)=CC)=O)=O)=O,,,4,1,1,0,1
21260_0,,,,2,1,2,3
C(CC(C(C(C(C)O)=C)=O)=O)=O,,,4,1,1,0,1
21262_0,,,,2,1,2,3
C(CC(CO)=O)(CC=CC=O)=O,,,4,1,1,0,1
21264_0,,,,2,1,2,3
C(CC=CC(CC(CO)=O)=O)=O,,,4,1,1,0,1
21266_0,,,,2,1,2,3
C(CC(CC(CO)=O)=CC=O)=O,,,4,1,2,0,2
21268_0,,,,2,1,2,3
C(CC(CC=O)=CC(CO)=O)=O,,,4,1,1,0,1
21270_0,,,,2,1,2,3
C(CC=O)(CC(CO)=CC=O)=O,,,4,1,1,0,1
21272_0,,,,2,1,2,3
C(CC(CO)=CC(CC=O)=O)=O,,,4,1,1,0,1
21274_0,,,,2,1,2,3
C(C(C(CC(CO)=O)=O)C=C)=O,,,4,1,1,0,1
21276_0,,,,2,1,2,3
C(CO)(CC(C(C=O)=CC)=O)=O,,,4,1,1,0,1
21278_0,,,,2,1,2,3
C(CC(C(C(CO)=O)C=C)=O)=O,,,4,1,1,0,1
21280_0,,,,2,1,2,3
C(CC(C(C(CO)=O)=CC)=O)=O,,,4,1,1,0,1
21282_0,,,,2,1,2,3
C(CC(CC(C(C=C)O)=O)=O)=O,,,4,1,1,0,1
21284_0,,,,2,1,2,3
C(C(C(C)=O)O)(CC=CC=O)=O,,,4,1,1,0,1
21286_0,,,,2,1,2,3
C(CC=CC(C(C(C)=O)O)=O)=O,,,4,1,1,0,1
21288_0,,,,2,1,2,3
C(CC(C(C(C)=O)O)=CC=O)=O,,,4,1,1,0,1
21290_0,,,,2,1,2,3
C(CC(C(C(C)=CC=O)O)=O)=O,,,4,1,1,0,1
21292_0,,,,2,1,2,3
C(CC(C(C(CC=O)=O)O)=C)=O,,,4,1,1,0,1
21294_0,,,,2,1,2,3
C(C(C(C(C(C)=O)O)=O)C=C)=O,,,4,1,1,0,1
21296_0,,,,2,1,2,3
C(C)(C(C(C(C=O)=CC)=O)O)=O,,,4,1,1,0,1
21298_0,,,,2,1,2,3
C(CC(C(C(CC=C)=O)O)=O)=O,,,4,1,1,0,1
21300_0,,,,2,1,2,3
C(CC(C(C(C=CC)=O)O)=O)=O,,,4,1,1,0,1
21302_0,,,,2,1,2,3
C(CC(C(CC=O)O)=CC=O)=O,,,4,1,1,0,1
21303_0,,,,2,1,2,3
21305_0,,,,2,1,2,3
C(CC(C(CC=CC=O)O)=O)=O,,,4,1,1,0,1
21306_0,,,,2,1,2,3
21308_0,,,,2,1,2,3
C(CC(C(C=CCC=O)O)=O)=O,,,4,1,1,0,1
21310_0,,,,2,1,2,3
C(C(C(C(CC=O)O)=O)C=C)=O,,,4,1,1,0,1
21312_0,,,,2,1,2,3
C(CC(C(C(C=O)=CC)=O)O)=O,,,4,1,1,0,1
21313_0,,,,2,1,2,3
21315_0,,,,2,1,2,3
C(C(C=C)C(C(CC=O)=O)O)=O,,,4,1,1,0,1
21317_0,,,,2,1,2,3
C(CC(C(C(C=O)=CC)O)=O)=O,,,4,1,1,0,1
21319_0,,,,2,1,2,3
C(CC(C=C(C=O)C(C)O)=O)=O,,,4,1,2,0,2
21321_0,,,,2,1,2,3
C(C(C=CC=O)O)(CC(C)=O)=O,,,4,1,1,0,1
21323_0,,,,2,1,2,3
C(C(C(CC(C)=O)=CC=O)O)=O,,,4,1,1,0,1
21325_0,,,,2,1,2,3
C(CC(C(C=O)O)=CC(C)=O)=O,,,4,1,1,0,1
21327_0,,,,2,1,2,3
C(C(C=O)O)(CC(C)=CC=O)=O,,,4,1,1,0,1
21329_0,,,,2,1,2,3
C(CC(C)=CC(C(C=O)O)=O)=O,,,4,1,1,0,1
21331_0,,,,2,1,2,3
C(CC(CC(C(C=O)O)=O)=C)=O,,,4,1,2,0,2
21333_0,,,,2,1,2,3
C(C(C(C(C(C)=O)C=C)=O)O)=O,,,4,1,1,0,1
21335_0,,,,2,1,2,3
C(C(C(C(C(C)=O)=CC)=O)O)=O,,,4,1,1,0,1
21337_0,,,,2,1,2,3
C(C(C(CC(CC=C)=O)=O)O)=O,,,4,1,1,0,1
21339_0,,,,2,1,2,3
C(C(C=O)O)(CC(C=CC)=O)=O,,,4,1,1,0,1
21340_0,,,,2,1,2,3
21342_0,,,,2,1,2,3
C(C(C(CCC=O)=CC=O)O)=O,,,4,1,1,0,1
21344_0,,,,2,1,2,3
C(CC(C(C=O)O)=CCC=O)=O,,,4,1,1,0,1
21346_0,,,,2,1,2,3
C(C(C(CCC=CC=O)=O)O)=O,,,4,1,1,0,1
21348_0,,,,2,1,2,3
C(CC=CCC(C(C=O)O)=O)=O,,,4,1,1,0,1
21349_0,,,,2,1,2,3
21351_0,,,,2,1,2,3
C(CC(C(C(C=O)O)=O)=CC)=O,,,4,1,1,0,1
21353_0,,,,2,1,2,3
C(C(C=C)CC(C(C=O)O)=O)=O,,,4,1,1,0,1
21355_0,,,,2,1,2,3
C(C(C=O)O)(CC(C=O)=CC)=O,,,4,1,1,0,1
21356_0,,,,2,1,2,3
21357_0,,,,2,1,2,3
21359_0,,,,2,1,2,3
C(C(CC(C(C)=O)=CC=O)O)=O,,,4,1,1,0,1
21360_0,,,,2,1,2,3
21362_0,,,,2,1,2,3
C(CC(C(C)=O)=CC(C=O)O)=O,,,4,1,1,0,1
21364_0,,,,2,1,2,3
C(C(CC(C(C)=CC=O)=O)O)=O,,,4,1,1,0,1
21365_0,,,,2,1,2,3
21367_0,,,,2,1,2,3
C(CC(C(CC(C=O)O)=O)=C)=O,,,4,1,1,0,1
21369_0,,,,2,1,2,3
C(C(C(C=C)C(C(C)=O)=O)O)=O,,,4,1,1,0,1
21371_0,,,,2,1,2,3
C(C(C(C(C(C)=O)=O)=CC)O)=O,,,4,1,1,0,1
21373_0,,,,2,1,2,3
C(C(C(C(C)O)=CC=O)=O)(C)=O,,,4,1,1,0,1
21375_0,,,,2,1,2,3
C(C(CC(C(CC=C)=O)=O)O)=O,,,4,1,1,0,1
21376_0,,,,2,1,2,3
21378_0,,,,2,1,2,3
C(C(CC(C(C=CC)=O)=O)O)=O,,,4,1,1,0,1
21379_0,,,,2,1,2,3
21380_0,,,,2,1,2,3
21382_0,,,,2,1,2,3
C(CC(CC(C=O)O)=CC=O)=O,,,4,1,1,0,1
21383_0,,,,2,1,2,3
21385_0,,,,2,1,2,3
C(CC(CC=O)=CC(C=O)O)=O,,,4,1,2,0,2
21387_0,,,,2,1,2,3
C(C(CC(CC=CC=O)=O)O)=O,,,4,1,1,0,1
21388_0,,,,2,1,2,3
21390_0,,,,2,1,2,3
C(CC=CC(CC(C=O)O)=O)=O,,,4,1,1,0,1
21392_0,,,,2,1,2,3
C(CC=O)(C(C=C)C(C=O)O)=O,,,4,1,1,0,1
21394_0,,,,2,1,2,3
C(CC(C(C(C=O)O)=CC)=O)=O,,,4,1,1,0,1
21396_0,,,,2,1,2,3
C(CC(C(C(C)O)=CC=O)=O)=O,,,4,1,2,0,2
21398_0,,,,2,1,2,3
C(C(C(CC(C=O)O)=O)C=C)=O,,,4,1,1,0,1
21399_0,,,,2,1,2,3
21401_0,,,,2,1,2,3
C(C(CC(C(C=O)=CC)=O)O)=O,,,4,1,1,0,1
21403_0,,,,2,1,2,3
C(C(CO)O)=CC(C=CC=O)=O,,,4,1,1,0,1
21405_0,,,,2,1,2,3
C(C(CO)O)=CC(C=O)=CC=O,,,4,1,1,0,1
21407_0,,,,2,1,2,3
C(C(C(C=CCO)=O)O)=CC=O,,,4,1,1,0,1
21409_0,,,,2,1,2,3
C(C(C(C=CCO)=CC=O)O)=O,,,4,1,1,0,1
21411_0,,,,2,1,2,3
C(C=CC=CC(C(CO)O)=O)=O,,,4,1,1,0,1
21413_0,,,,2,1,2,3
C(C=CC(C(CO)O)=CC=O)=O,,,4,1,1,0,1
21414_0,,,,2,1,2,3
21416_0,,,,2,1,2,3
C(C(C(C(C=C)=CC=O)O)O)=O,,,4,1,1,0,1
21418_0,,,,2,1,2,3
C(C(C=CC(CO)=O)O)=CC=O,,,4,1,1,0,1
21420_0,,,,2,1,2,3
C(C(C=CC(CO)=CC=O)O)=O,,,4,1,1,0,1
21422_0,,,,2,1,2,3
C(C(C=CC(C(C=C)O)=O)O)=O,,,4,1,1,0,1
21424_0,,,,2,1,2,3
C(C(C(C=CC=O)O)O)=CC=O,,,4,1,1,0,1
21426_0,,,,2,1,2,3
C(C(C(C=CC=CC=O)O)O)=O,,,4,1,1,0,1
21428_0,,,,2,1,2,3
C(C=C(C=O)C(CO)O)=O,,,4,1,2,0,2
21429_0,,,,2,1,2,3
21430_0,,,,2,1,2,3
21432_0,,,,2,1,2,3
C(C(C(CO)=CC=O)O)=O,,,4,1,1,0,1
21434_0,,,,2,1,2,3
C(CO)=C(C=O)C(CO)=O,,,4,1,1,0,1
21436_0,,,,2,1,2,3
C(C(C(C(C=O)O)=C)O)=O,,,4,1,1,0,1
21438_0,,,,2,1,2,3
C(C(C(C(CO)O)=C)O)=O,,,4,1,1,0,1
21439_0,,,,2,1,2,3
21441_0,,,,2,1,2,3
C(C(C=C(CO)C(C=O)O)O)=O,,,4,1,1,0,1
21443_0,,,,2,1,2,3
C(C(C(C(CO)=O)=CCO)O)=O,,,4,1,1,0,1
21445_0,,,,2,1,2,3
C(C=C(C(CO)=O)C(CO)O)=O,,,4,1,1,0,1
21446_0,,,,2,1,2,3
21448_0,,,,2,1,2,3
C(C(C(C=O)=CCO)O)=O,,,4,1,2,0,2
21449_0,,,,2,1,2,3
21451_0,,,,2,1,2,3
C(CO)=C(C(C=O)=O)CO,,,4,1,1,0,1
21453_0,,,,2,1,2,3
C=C(C(C=O)=O)C(CO)O,,,4,1,1,0,1
21455_0,,,,2,1,2,3
C(C(C(CO)=CCO)O)=O,,,4,1,1,0,1
21456_0,,,,2,1,2,3
21458_0,,,,2,1,2,3
C(CO)=C(C(CO)=O)CO,,,4,1,1,0,1
21460_0,,,,2,1,2,3
C=C(C(CO)=O)C(CO)O,,,4,1,1,0,1
21462_0,,,,2,1,2,3
C(C(C(C(C(C=O)O)O)=C)O)=O,,,4,1,1,0,1
21464_0,,,,2,1,2,3
C(C(C(C(C=CCO)=O)O)O)=O,,,4,1,1,0,1
21466_0,,,,2,1,2,3
C(C(C(CO)=C)O)=O,,,4,1,1,0,1
21467_0,,,,2,1,2,3
21468_0,,,,2,1,2,3
21469_0,,,,2,1,2,3
21470_0,,,,2,1,2,3
21471_0,,,,2,1,2,3
21473_0,,,,2,1,2,3
C(C(C(CO)O)O)=CC(C=O)=O,,,4,1,1,0,1
21475_0,,,,2,1,2,3
C(C(C(CO)O)O)=CC(CO)=O,,,4,1,1,0,1
21477_0,,,,2,1,2,3
C=C(C=O)C(C(C(CO)O)O)=O,,,4,1,1,0,1
21479_0,,,,2,1,2,3
C(C(C(C(CO)=CCO)=O)O)=O,,,4,1,2,0,2
21481_0,,,,2,1,2,3
C(C(C(C(C(CO)O)=C)=O)O)=O,,,4,1,1,0,1
21483_0,,,,2,1,2,3
C(C(CO)=CC=O)(C(CO)O)=O,,,4,1,2,0,2
21485_0,,,,2,1,2,3
C(C(C(C(C(CO)O)=O)=C)O)=O,,,4,1,1,0,1
21487_0,,,,2,1,2,3
C(C(C(C(C(CO)=C)=O)O)O)=O,,,4,1,2,0,2
21489_0,,,,2,1,2,3
C(C(C(C=C(C=O)CO)O)O)=O,,,4,1,2,0,2
21491_0,,,,2,1,2,3
C(C(C(C(C(C=O)=C)O)O)O)=O,,,4,1,1,0,1
21493_0,,,,2,1,2,3
C=CC(O)=O,,,4,1,1,0,1
21495_0,,,,2,1,2,3
C(C(CO)O)=C(C(O)=O)CO,,,4,1,1,0,1
21496_0,,,,2,1,2,3
21497_0,,,,2,1,2,3
21498_0,,,,2,1,2,3
21500_0,,,,2,1,2,3
C(C(CCO)=CC=O)(O)=O,,,4,1,1,0,1
21502_0,,,,2,1,2,3
C(CC(C(O)=O)=CCO)=O,,,4,1,1,0,1
21503_0,,,,2,1,2,3
21504_0,,,,2,1,2,3
21506_0,,,,2,1,2,3
C(C(C=C(C(O)=O)C)O)=O,,,4,1,1,0,1
21508_0,,,,2,1,2,3
C(C(CC(C(O)=O)=C)O)=O,,,4,1,1,0,1
21510_0,,,,2,1,2,3
C(C(CO)O)=C(C(O)=O)C=O,,,4,1,1,0,1
21511_0,,,,2,1,2,3
21512_0,,,,2,1,2,3
21513_0,,,,2,1,2,3
21514_0,,,,2,1,2,3
21515_0,,,,2,1,2,3
21516_0,,,,2,1,2,3
21517_0,,,,2,1,2,3
21518_0,,,,2,1,2,3
21519_0,,,,2,1,2,3
21520_0,,,,2,1,2,3
21521_0,,,,2,1,2,3
21522_0,,,,2,1,2,3
21523_0,,,,2,1,2,3
21524_0,,,,2,1,2,3
21525_0,,,,2,1,2,3
21526_0,,,,2,1,2,3
21527_0,,,,2,1,2,3
21528_0,,,,2,1,2,3
21529_0,,,,2,1,2,3
21530_0,,,,2,1,2,3
21531_0,,,,2,1,2,3
21532_0,,,,2,1,2,3
21533_0,,,,2,1,2,3
21534_0,,,,2,1,2,3
21535_0,,,,2,1,2,3
21536_0,,,,2,1,2,3
21537_0,,,,2,1,2,3
21538_0,,,,2,1,2,3
21539_0,,,,2,1,2,3
21540_0,,,,2,1,2,3
21541_0,,,,2,1,2,3
21542_0,,,,2,1,2,3
21543_0,,,,2,1,2,3
21544_0,,,,2,1,2,3
21545_0,,,,2,1,2,3
21546_0,,,,2,1,2,3
21547_0,,,,2,1,2,3
21548_0,,,,2,1,2,3
21549_0,,,,2,1,2,3
21550_0,,,,2,1,2,3
21551_0,,,,2,1,2,3
21552_0,,,,2,1,2,3
21553_0,,,,2,1,2,3
21554_0,,,,2,1,2,3
21555_0,,,,2,1,2,3
21556_0,,,,2,1,2,3
21557_0,,,,2,1,2,3
21558_0,,,,2,1,2,3
21559_0,,,,2,1,2,3
21560_0,,,,2,1,2,3
21561_0,,,,2,1,2,3
21562_0,,,,2,1,2,3
21563_0,,,,2,1,2,3
21564_0,,,,2,1,2,3
21565_0,,,,2,1,2,3
21566_0,,,,2,1,2,3
21567_0,,,,2,1,2,3
21568_0,,,,2,1,2,3
21569_0,,,,2,1,2,3
21570_0,,,,2,1,2,3
21571_0,,,,2,1,2,3
21572_0,,,,2,1,2,3
21573_0,,,,2,1,2,3
21574_0,,,,2,1,2,3
21575_0,,,,2,1,2,3
21576_0,,,,2,1,2,3
21577_0,,,,2,1,2,3
21578_0,,,,2,1,2,3
21579_0,,,,2,1,2,3
21580_0,,,,2,1,2,3
21581_0,,,,2,1,2,3
21582_0,,,,2,1,2,3
21583_0,,,,2,1,2,3
21584_0,,,,2,1,2,3
21585_0,,,,2,1,2,3
21586_0,,,,2,1,2,3
21587_0,,,,2,1,2,3
21588_0,,,,2,1,2,3
21589_0,,,,2,1,2,3
21590_0,,,,2,1,2,3
21591_0,,,,2,1,2,3
21592_0,,,,2,1,2,3
21594_0,,,,2,1,2,3
C=C1C(C(C(C1O)O)O)O,,,4,1,1,0,1
21596_0,,,,2,1,2,3
C=C,,,4,1,1,0,1
21597_0,,,,2,1,2,3
21598_0,,,,2,1,2,3
21599_0,,,,2,1,2,3
21600_0,,,,2,1,2,3
21601_0,,,,2,1,2,3
21602_0,,,,2,1,2,3
21603_0,,,,2,1,2,3
21604_0,,,,2,1,2,3
21605_0,,,,2,1,2,3
21606_0,,,,2,1,2,3
21607_0,,,,2,1,2,3
21608_0,,,,2,1,2,3
21609_0,,,,2,1,2,3
21610_0,,,,2,1,2,3
21611_0,,,,2,1,2,3
21612_0,,,,2,1,2,3
21613_0,,,,2,1,2,3
21614_0,,,,2,1,2,3
21615_0,,,,2,1,2,3
21616_0,,,,2,1,2,3
21617_0,,,,2,1,2,3
21618_0,,,,2,1,2,3
21620_0,,,,2,1,2,3
C=CC1C(C(C(O1)O)O)O,,,4,1,2,0,2
21621_0,,,,2,1,2,3
21622_0,,,,2,1,2,3
21623_0,,,,2,1,2,3
21625_0,,,,2,1,2,3
C(C(CC(C=C)O)O)(O)=O,,,4,1,2,0,2
21626_0,,,,2,1,2,3
21627_0,,,,2,1,2,3
21629_0,,,,2,1,2,3
C=CC1(C(C(CO1)O)O)O,,,4,1,2,0,2
21630_0,,,,2,1,2,3
21631_0,,,,2,1,2,3
21632_0,,,,2,1,2,3
21633_0,,,,2,1,2,3
21634_0,,,,2,1,2,3
21635_0,,,,2,1,2,3
21636_0,,,,2,1,2,3
21637_0,,,,2,1,2,3
21638_0,,,,2,1,2,3
21639_0,,,,2,1,2,3
21640_0,,,,2,1,2,3
21641_0,,,,2,1,2,3
21642_0,,,,2,1,2,3
21643_0,,,,2,1,2,3
21644_0,,,,2,1,2,3
21645_0,,,,2,1,2,3
21646_0,,,,2,1,2,3
21647_0,,,,2,1,2,3
21648_0,,,,2,1,2,3
21649_0,,,,2,1,2,3
21650_0,,,,2,1,2,3
21651_0,,,,2,1,2,3
21652_0,,,,2,1,2,3
21653_0,,,,2,1,2,3
21654_0,,,,2,1,2,3
21655_0,,,,2,1,2,3
21656_0,,,,2,1,2,3
21657_0,,,,2,1,2,3
21658_0,,,,2,1,2,3
21659_0,,,,2,1,2,3
21660_0,,,,2,1,2,3
21661_0,,,,2,1,2,3
21662_0,,,,2,1,2,3
21663_0,,,,2,1,2,3
21664_0,,,,2,1,2,3
21665_0,,,,2,1,2,3
21666_0,,,,2,1,2,3
21667_0,,,,2,1,2,3
21668_0,,,,2,1,2,3
21669_0,,,,2,1,2,3
21670_0,,,,2,1,2,3
21671_0,,,,2,1,2,3
21672_0,,,,2,1,2,3
21673_0,,,,2,1,2,3
21674_0,,,,2,1,2,3
21675_0,,,,2,1,2,3
21676_0,,,,2,1,2,3
21677_0,,,,2,1,2,3
21678_0,,,,2,1,2,3
21679_0,,,,2,1,2,3
21680_0,,,,2,1,2,3
21681_0,,,,2,1,2,3
21682_0,,,,2,1,2,3
21684_0,,,,2,1,2,3
C1(C(C=CC1(CO)O)O)=O,,,4,1,1,0,1
21685_0,,,,2,1,2,3
21686_0,,,,2,1,2,3
21687_0,,,,2,1,2,3
21689_0,,,,2,1,2,3
C(C(C(C=O)=C)(CO)O)=O,,,4,1,1,0,1
21690_0,,,,2,1,2,3
21692_0,,,,2,1,2,3
C(C(C(CO)=CC=O)(CO)O)=O,,,4,1,1,0,1
21694_0,,,,2,1,2,3
C(C(C(C(C=O)O)=C)(CO)O)=O,,,4,1,1,0,1
21696_0,,,,2,1,2,3
C(C(C(C(CO)O)=C)(CO)O)=O,,,4,1,1,0,1
21698_0,,,,2,1,2,3
C(C(C(C=O)=CCO)(CO)O)=O,,,4,1,1,0,1
21699_0,,,,2,1,2,3
21701_0,,,,2,1,2,3
C(C(C(CO)=CCO)(CO)O)=O,,,4,1,1,0,1
21702_0,,,,2,1,2,3
21704_0,,,,2,1,2,3
C(C(C(CO)=C)(CO)O)=O,,,4,1,1,0,1
21705_0,,,,2,1,2,3
21706_0,,,,2,1,2,3
21707_0,,,,2,1,2,3
21709_0,,,,2,1,2,3
C(C(C=C)(CO)O)=O,,,4,1,1,0,1
21711_0,,,,2,1,2,3
C(C(C(C)=O)(C(C=O)=C)O)=O,,,4,1,1,0,1
21713_0,,,,2,1,2,3
C(C)(C(C(C=O)=C)(CO)O)=O,,,4,1,1,0,1
21715_0,,,,2,1,2,3
C(C(C=O)(C(C=O)=C)O)=O,,,4,1,1,0,1
21717_0,,,,2,1,2,3
C(C(C(C=O)=C)(C(C=O)O)O)=O,,,4,1,1,0,1
21719_0,,,,2,1,2,3
C(CO)(C(C(C=O)=C)(CO)O)=O,,,4,1,1,0,1
21721_0,,,,2,1,2,3
C=C(C=O)C(C(C=O)=O)(CO)O,,,4,1,1,0,1
21723_0,,,,2,1,2,3
C(C(C=O)(C=CC(CO)=O)O)=O,,,4,1,1,0,1
21725_0,,,,2,1,2,3
C(C(C=O)(C(CO)=CC=O)O)=O,,,4,1,1,0,1
21727_0,,,,2,1,2,3
C(C(C=O)(C(C(C=O)O)=C)O)=O,,,4,1,1,0,1
21729_0,,,,2,1,2,3
C(C(C(C)=O)(C(CO)=C)O)=O,,,4,1,1,0,1
21731_0,,,,2,1,2,3
C(C(C(C)=O)(C=C)O)=O,,,4,1,1,0,1
21733_0,,,,2,1,2,3
C(C(C=O)(C(C(CO)O)=C)O)=O,,,4,1,1,0,1
21735_0,,,,2,1,2,3
C(C)(C(C(CO)=C)(CO)O)=O,,,4,1,1,0,1
21737_0,,,,2,1,2,3
C(C)(C(C=C)(CO)O)=O,,,4,1,1,0,1
21738_0,,,,2,1,2,3
21739_0,,,,2,1,2,3
21740_0,,,,2,1,2,3
21741_0,,,,2,1,2,3
21742_0,,,,2,1,2,3
21743_0,,,,2,1,2,3
21744_0,,,,2,1,2,3
21745_0,,,,2,1,2,3
21746_0,,,,2,1,2,3
21747_0,,,,2,1,2,3
21748_0,,,,2,1,2,3
21750_0,,,,2,1,2,3
C=C1C(OC(C(CO)O)C1O)=O,,,4,1,1,0,1
21752_0,,,,2,1,2,3
C1C(C(CO)O)OC(C=1CO)=O,,,4,1,2,0,2
21753_0,,,,2,1,2,3
21755_0,,,,2,1,2,3
C=C1C(OC(CO)C(C1O)O)=O,,,4,1,1,0,1
21757_0,,,,2,1,2,3
C1C(C(CO)OC(C=1CO)=O)O,,,4,1,2,0,2
21758_0,,,,2,1,2,3
21759_0,,,,2,1,2,3
21761_0,,,,2,1,2,3
C=C1C(OCC(C(C1O)O)O)=O,,,4,1,1,0,1
21763_0,,,,2,1,2,3
C1C(C(COC(C=1CO)=O)O)O,,,4,1,2,0,2
21764_0,,,,2,1,2,3
21765_0,,,,2,1,2,3
21766_0,,,,2,1,2,3
21767_0,,,,2,1,2,3
21768_0,,,,2,1,2,3
21769_0,,,,2,1,2,3
21770_0,,,,2,1,2,3
21771_0,,,,2,1,2,3
21772_0,,,,2,1,2,3
21773_0,,,,2,1,2,3
21774_0,,,,2,1,2,3
21775_0,,,,2,1,2,3
21776_0,,,,2,1,2,3
21777_0,,,,2,1,2,3
21778_0,,,,2,1,2,3
21780_0,,,,2,1,2,3
C(C(C=O)(C(C=O)=CCO)O)=O,,,4,1,1,0,1
21781_0,,,,2,1,2,3
21783_0,,,,2,1,2,3
C(C(C=O)(C(CO)=CCO)O)=O,,,4,1,1,0,1
21784_0,,,,2,1,2,3
21785_0,,,,2,1,2,3
21787_0,,,,2,1,2,3
C(C(C(C(C)=O)(C=C)O)O)=O,,,4,1,1,0,1
21789_0,,,,2,1,2,3
C(C(C=O)(C(CO)=C)O)=O,,,4,1,1,0,1
21790_0,,,,2,1,2,3
21791_0,,,,2,1,2,3
21793_0,,,,2,1,2,3
C(C(C=O)(C=CC(C=O)O)O)=O,,,4,1,1,0,1
21795_0,,,,2,1,2,3
C(C(C=O)(C=C)O)=O,,,4,1,1,0,1
21797_0,,,,2,1,2,3
C(C(C(CO)=C)(C(C=O)O)O)=O,,,4,1,1,0,1
21799_0,,,,2,1,2,3
C(CO)(C(C(CO)=C)(CO)O)=O,,,4,1,1,0,1
21801_0,,,,2,1,2,3
C=C(CO)C(C(C=O)=O)(CO)O,,,4,1,1,0,1
21802_0,,,,2,1,2,3
21804_0,,,,2,1,2,3
C(CO)(C(C=C)(CO)O)=O,,,4,1,1,0,1
21805_0,,,,2,1,2,3
21807_0,,,,2,1,2,3
C(CC(C(C(C)=O)(C=C)O)=O)=O,,,4,1,1,0,1
21809_0,,,,2,1,2,3
C(C(C(CC(C)=O)=O)(C=C)O)=O,,,4,1,1,0,1
21811_0,,,,2,1,2,3
C(C(C(CCC=O)=O)(C=C)O)=O,,,4,1,1,0,1
21813_0,,,,2,1,2,3
C(C(C=C)(C(C=CCO)=O)O)=O,,,4,1,1,0,1
21815_0,,,,2,1,2,3
C=CC(C(C=CC=O)=O)(CO)O,,,4,1,1,0,1
21816_0,,,,2,1,2,3
21818_0,,,,2,1,2,3
C(C(C(C=C)(C(C=C)=O)O)O)=O,,,4,1,1,0,1
21820_0,,,,2,1,2,3
C(C(C=C)(C(C=CC=O)O)O)=O,,,4,1,1,0,1
21822_0,,,,2,1,2,3
C=CC(C(C=O)=O)(CO)O,,,4,1,1,0,1
21824_0,,,,2,1,2,3
C(C(C(C=O)=C)(C(CO)O)O)=O,,,4,1,1,0,1
21826_0,,,,2,1,2,3
C(C(C(CO)=C)(C(CO)O)O)=O,,,4,1,1,0,1
21828_0,,,,2,1,2,3
C(C(C=C)(C(CO)O)O)=O,,,4,1,1,0,1
21829_0,,,,2,1,2,3
21830_0,,,,2,1,2,3
21831_0,,,,2,1,2,3
21832_0,,,,2,1,2,3
21833_0,,,,2,1,2,3
21834_0,,,,2,1,2,3
21835_0,,,,2,1,2,3
21836_0,,,,2,1,2,3
21838_0,,,,2,1,2,3
C1C(CC(C=1C(O)=O)O)O,,,4,1,1,0,1
21839_0,,,,2,1,2,3
21840_0,,,,2,1,2,3
21842_0,,,,2,1,2,3
C(C1(C=CC(C1)O)O)(O)=O,,,4,1,1,0,1
21843_0,,,,2,1,2,3
21844_0,,,,2,1,2,3
21845_0,,,,2,1,2,3
21847_0,,,,2,1,2,3
C(C(C(C=O)=C)(CC=O)O)=O,,,4,1,1,0,1
21848_0,,,,2,1,2,3
21850_0,,,,2,1,2,3
C(C(C(C=O)=C)O)(O)=O,,,4,1,1,0,1
21852_0,,,,2,1,2,3
C(C)(C(C(C(O)=O)=CCO)O)=O,,,4,1,1,0,1
21853_0,,,,2,1,2,3
21855_0,,,,2,1,2,3
C(C(C(C=O)=C)(CCO)O)(O)=O,,,4,1,1,0,1
21857_0,,,,2,1,2,3
C(C(C(C(O)=O)=CCO)(C)O)=O,,,4,1,1,0,1
21858_0,,,,2,1,2,3
21860_0,,,,2,1,2,3
C(C(C(CO)=CC=O)O)(O)=O,,,4,1,1,0,1
21862_0,,,,2,1,2,3
C(C(C(C(C=O)O)=C)O)(O)=O,,,4,1,1,0,1
21863_0,,,,2,1,2,3
21864_0,,,,2,1,2,3
21866_0,,,,2,1,2,3
C(C(C(C(O)=O)=CCO)O)=O,,,4,1,1,0,1
21867_0,,,,2,1,2,3
21869_0,,,,2,1,2,3
C(C(C(C(CO)O)=C)O)(O)=O,,,4,1,1,0,1
21871_0,,,,2,1,2,3
C(C(C(C)O)=CC(CO)=O)=O,,,4,1,1,0,1
21872_0,,,,2,1,2,3
21873_0,,,,2,1,2,3
21874_0,,,,2,1,2,3
21875_0,,,,2,1,2,3
21876_0,,,,2,1,2,3
21877_0,,,,2,1,2,3
21878_0,,,,2,1,2,3
21879_0,,,,2,1,2,3
21880_0,,,,2,1,2,3
21881_0,,,,2,1,2,3
21882_0,,,,2,1,2,3
21883_0,,,,2,1,2,3
21884_0,,,,2,1,2,3
21885_0,,,,2,1,2,3
21887_0,,,,2,1,2,3
C(C(C=C(C(C)=O)CO)=O)=O,,,4,1,1,0,1
21888_0,,,,2,1,2,3
21890_0,,,,2,1,2,3
C(C(CO)=CC(C(C)=O)=O)=O,,,4,1,1,0,1
21891_0,,,,2,1,2,3
21892_0,,,,2,1,2,3
21893_0,,,,2,1,2,3
21895_0,,,,2,1,2,3
C(C=C(C(O)=O)CO)(CCO)=O,,,4,1,1,0,1
21896_0,,,,2,1,2,3
21898_0,,,,2,1,2,3
C(CO)(CC=C(C(O)=O)CO)=O,,,4,1,1,0,1
21900_0,,,,2,1,2,3
C(C)(C(C=C(C(O)=O)CO)O)=O,,,4,1,1,0,1
21901_0,,,,2,1,2,3
21902_0,,,,2,1,2,3
21904_0,,,,2,1,2,3
C(C(C=C(C(C)=O)CO)O)(O)=O,,,4,1,1,0,1
21906_0,,,,2,1,2,3
C(CC(C=C(C(O)=O)CO)O)=O,,,4,1,1,0,1
21907_0,,,,2,1,2,3
21908_0,,,,2,1,2,3
21909_0,,,,2,1,2,3
21910_0,,,,2,1,2,3
21911_0,,,,2,1,2,3
21912_0,,,,2,1,2,3
21913_0,,,,2,1,2,3
21914_0,,,,2,1,2,3
21916_0,,,,2,1,2,3
C(CO)=C(C(O)=O)CO,,,4,1,1,0,1
21917_0,,,,2,1,2,3
21918_0,,,,2,1,2,3
21919_0,,,,2,1,2,3
21921_0,,,,2,1,2,3
C(C(C(C=O)=CCO)O)(O)=O,,,4,1,1,0,1
21922_0,,,,2,1,2,3
21924_0,,,,2,1,2,3
C(C(C(CO)=CCO)O)(O)=O,,,4,1,1,0,1
21925_0,,,,2,1,2,3
21926_0,,,,2,1,2,3
21928_0,,,,2,1,2,3
C(C(C(CO)=C)(CC=O)O)=O,,,4,1,1,0,1
21929_0,,,,2,1,2,3
21931_0,,,,2,1,2,3
C(C(C(CO)=C)O)(O)=O,,,4,1,1,0,1
21933_0,,,,2,1,2,3
C(C(C(CO)=C)(CCO)O)(O)=O,,,4,1,1,0,1
21935_0,,,,2,1,2,3
C(CO)=C(C(O)=O)C(CO)(C)O,,,4,1,1,0,1
21936_0,,,,2,1,2,3
21937_0,,,,2,1,2,3
21938_0,,,,2,1,2,3
21939_0,,,,2,1,2,3
21940_0,,,,2,1,2,3
21941_0,,,,2,1,2,3
21943_0,,,,2,1,2,3
C(C)(C(C=C)(CC(C=O)=O)O)=O,,,4,1,1,0,1
21945_0,,,,2,1,2,3
C(C(C=C(C(C)=O)C(C)O)=O)=O,,,4,1,1,0,1
21946_0,,,,2,1,2,3
21947_0,,,,2,1,2,3
21948_0,,,,2,1,2,3
21950_0,,,,2,1,2,3
C(C(C=C(C=O)C(C)O)=O)(C)=O,,,4,1,1,0,1
21951_0,,,,2,1,2,3
21952_0,,,,2,1,2,3
21954_0,,,,2,1,2,3
C(C(C=C)(C=CC(CO)=O)O)=O,,,4,1,1,0,1
21956_0,,,,2,1,2,3
C(C(C=C)(CCO)O)(O)=O,,,4,1,1,0,1
21958_0,,,,2,1,2,3
C(CO)=C(C(O)=O)C(C)O,,,4,1,1,0,1
21959_0,,,,2,1,2,3
21961_0,,,,2,1,2,3
C(CO)=C(C(O)=O)C(CO)O,,,4,1,1,0,1
21962_0,,,,2,1,2,3
21963_0,,,,2,1,2,3
21964_0,,,,2,1,2,3
21965_0,,,,2,1,2,3
21966_0,,,,2,1,2,3
21967_0,,,,2,1,2,3
21968_0,,,,2,1,2,3
21969_0,,,,2,1,2,3
21970_0,,,,2,1,2,3
21971_0,,,,2,1,2,3
21972_0,,,,2,1,2,3
21973_0,,,,2,1,2,3
21974_0,,,,2,1,2,3
21975_0,,,,2,1,2,3
21976_0,,,,2,1,2,3
21977_0,,,,2,1,2,3
21978_0,,,,2,1,2,3
21980_0,,,,2,1,2,3
C=CC(C=CC(O)=O)=O,,,4,1,2,0,2
21982_0,,,,2,1,2,3
C(C=CC=CC(O)=O)=O,,,4,1,2,0,2
21984_0,,,,2,1,2,3
C1(CO)OC(C(C=1)=O)CO,,,4,1,1,0,1
21985_0,,,,2,1,2,3
21986_0,,,,2,1,2,3
21988_0,,,,2,1,2,3
C(CC1OCC(C=1)=O)=O,,,4,1,1,0,1
21989_0,,,,2,1,2,3
21990_0,,,,2,1,2,3
21992_0,,,,2,1,2,3
C(C1C(C=C(C)O1)=O)=O,,,4,1,1,0,1
21993_0,,,,2,1,2,3
21994_0,,,,2,1,2,3
21996_0,,,,2,1,2,3
C(C1OC(C(C=1)=O)CO)=O,,,4,1,1,0,1
21998_0,,,,2,1,2,3
C1COC(C(C=1)=O)(CO)O,,,4,1,1,0,1
22000_0,,,,2,1,2,3
C1(CO)OCC(C(C=1)=O)O,,,4,1,1,0,1
22002_0,,,,2,1,2,3
C1C(CO)(OCC(C=1)=O)O,,,4,1,2,0,2
22003_0,,,,2,1,2,3
22004_0,,,,2,1,2,3
22005_0,,,,2,1,2,3
22006_0,,,,2,1,2,3
22008_0,,,,2,1,2,3
C(C1(C(C=CCO1)=O)O)=O,,,4,1,1,0,1
22010_0,,,,2,1,2,3
C(C1OCC(C(C=1)=O)O)=O,,,4,1,1,0,1
22012_0,,,,2,1,2,3
C(C1(C=CC(CO1)=O)O)=O,,,4,1,1,0,1
22014_0,,,,2,1,2,3
C1COC(C(C(C=1)=O)=O)O,,,4,1,1,0,1
22016_0,,,,2,1,2,3
C1(C=CC(C(O)OC1)=O)=O,,,4,1,1,0,1
22017_0,,,,2,1,2,3
22018_0,,,,2,1,2,3
22020_0,,,,2,1,2,3
C1C(CO)OC(C(C=1)=O)=O,,,4,1,1,0,1
22022_0,,,,2,1,2,3
C1(C=CC(C(CO)O1)=O)=O,,,4,1,1,0,1
22024_0,,,,2,1,2,3
C1C(COC(C(C=1)=O)=O)O,,,4,1,1,0,1
22026_0,,,,2,1,2,3
C1(C(C(C=CCO1)=O)O)=O,,,4,1,1,0,1
22028_0,,,,2,1,2,3
C1(C=CC(C(CO1)O)=O)=O,,,4,1,1,0,1
22030_0,,,,2,1,2,3
C1(C(C=CC(CO1)=O)O)=O,,,4,1,1,0,1
22031_0,,,,2,1,2,3
22032_0,,,,2,1,2,3
22033_0,,,,2,1,2,3
22034_0,,,,2,1,2,3
22035_0,,,,2,1,2,3
22036_0,,,,2,1,2,3
22037_0,,,,2,1,2,3
22039_0,,,,2,1,2,3
C1C2C(C(C(C=1)(O2)O)O)O,,,4,1,2,0,2
22040_0,,,,2,1,2,3
22042_0,,,,2,1,2,3
C1(C(CO)O)OCC(C=1)=O,,,4,1,1,0,1
22043_0,,,,2,1,2,3
22044_0,,,,2,1,2,3
22046_0,,,,2,1,2,3
C1(COC(C1O)=CCO)=O,,,4,1,1,0,1
22048_0,,,,2,1,2,3
C1(COC(C=C)(C1O)O)=O,,,4,1,2,0,2
22050_0,,,,2,1,2,3
C1(C(C(OC1C=C)O)O)=O,,,4,1,2,0,2
22051_0,,,,2,1,2,3
22052_0,,,,2,1,2,3
22054_0,,,,2,1,2,3
C1C(C(CO)O)(O)OC(C=1)=O,,,4,1,1,0,1
22056_0,,,,2,1,2,3
C1(C(C=C(C(CO)O)O1)O)=O,,,4,1,1,0,1
22058_0,,,,2,1,2,3
C1(C(C(C(O1)=CCO)O)O)=O,,,4,1,1,0,1
22060_0,,,,2,1,2,3
C1(C(C(C(C=C)(O)O1)O)O)=O,,,4,1,2,0,2
22062_0,,,,2,1,2,3
C1C2(C(OC(C=1)C2O)O)O,,,4,1,2,0,2
22064_0,,,,2,1,2,3
C1OC2C(COC2(C=1)O)O,,,4,1,2,0,2
22066_0,,,,2,1,2,3
C12C(C(CO1)O)OC(C=2)O,,,4,1,1,0,1
22068_0,,,,2,1,2,3
C=C1C2C(C(C(O2)O)O1)O,,,4,1,2,0,2
22070_0,,,,2,1,2,3
C1OC2C(C(OC2C=1)O)O,,,4,1,2,0,2
22072_0,,,,2,1,2,3
C1OC2COC(C=1)(C2O)O,,,4,1,2,0,2
22074_0,,,,2,1,2,3
C1C2COC(C(C=1)(O2)O)O,,,4,1,1,0,1
22076_0,,,,2,1,2,3
C1C2(C(COC(C=1)O2)O)O,,,4,1,1,0,1
22078_0,,,,2,1,2,3
C1C2C(O)OCC(C=1)(O2)O,,,4,1,1,0,1
22080_0,,,,2,1,2,3
C1C(CCO)(O)OC(C=1)=O,,,4,1,1,0,1
22082_0,,,,2,1,2,3
C1(C(C=C(CCO)O1)O)=O,,,4,1,1,0,1
22084_0,,,,2,1,2,3
C1(C(CC(O1)=CCO)O)=O,,,4,1,1,0,1
22086_0,,,,2,1,2,3
C1(C(CC(C=C)(O)O1)O)=O,,,4,1,2,0,2
22088_0,,,,2,1,2,3
C(C1CC=C(CO)O1)(O)=O,,,4,1,1,0,1
22090_0,,,,2,1,2,3
C(C1C=CC(C)(O1)O)(O)=O,,,4,1,1,0,1
22092_0,,,,2,1,2,3
C(C1CC(C(O1)=C)O)(O)=O,,,4,1,1,0,1
22094_0,,,,2,1,2,3
C1C(COC=1C(C=O)=O)O,,,4,1,2,0,2
22096_0,,,,2,1,2,3
C1C(C(C=O)=O)(O)OCC=1,,,4,1,2,0,2
22098_0,,,,2,1,2,3
C1C(C(C=O)=O)OC(C=1)O,,,4,1,2,0,2
22100_0,,,,2,1,2,3
C1OC(C(C=O)=O)C(C=1)O,,,4,1,2,0,2
22102_0,,,,2,1,2,3
C1OC2C(C(C=1)OC2O)O,,,4,1,2,0,2
22103_0,,,,2,1,2,3
22104_0,,,,2,1,2,3
22106_0,,,,2,1,2,3
C(C1(C(C=CCO1)O)O)=O,,,4,1,1,0,1
22107_0,,,,2,1,2,3
22109_0,,,,2,1,2,3
C1(COC(CO)=CC1O)=O,,,4,1,1,0,1
22111_0,,,,2,1,2,3
C(C1C=CC(C(O1)O)O)=O,,,4,1,2,0,2
22112_0,,,,2,1,2,3
22113_0,,,,2,1,2,3
22115_0,,,,2,1,2,3
C1(COC(C(C1O)O)=C)=O,,,4,1,1,0,1
22117_0,,,,2,1,2,3
C=C1C(C(C(CO1)O)O)O,,,4,1,1,0,1
22119_0,,,,2,1,2,3
C1(C(C=CC(CO)(O)O1)O)=O,,,4,1,1,0,1
22121_0,,,,2,1,2,3
C1(C(C(C=C(CO)O1)O)O)=O,,,4,1,1,0,1
22123_0,,,,2,1,2,3
C1(C(C(C(C(O1)=C)O)O)O)=O,,,4,1,1,0,1
22125_0,,,,2,1,2,3
C1C2COC(C=1)(C(O2)O)O,,,4,1,1,0,1
22127_0,,,,2,1,2,3
C1CC(CO)(O)OC(C=1)=O,,,4,1,1,0,1
22129_0,,,,2,1,2,3
C1(C(CC=C(CO)O1)O)=O,,,4,1,1,0,1
22131_0,,,,2,1,2,3
C1C(C(C)(O)OC(C=1)=O)O,,,4,1,1,0,1
22133_0,,,,2,1,2,3
C1(C(C=CC(C)(O)O1)O)=O,,,4,1,1,0,1
22135_0,,,,2,1,2,3
C1(C(CC(C(O1)=C)O)O)=O,,,4,1,1,0,1
22137_0,,,,2,1,2,3
C(C1C=CCC(O1)O)(O)=O,,,4,1,1,0,1
22139_0,,,,2,1,2,3
C(C1CC=CC(O)O1)(O)=O,,,4,1,1,0,1
22141_0,,,,2,1,2,3
C(C1CC(C=CO1)O)(O)=O,,,4,1,1,0,1
22142_0,,,,2,1,2,3
22144_0,,,,2,1,2,3
C1C(C(OC(C=1)CO)O)O,,,4,1,1,0,1
22145_0,,,,2,1,2,3
22147_0,,,,2,1,2,3
C1(COC=CC(C1O)O)=O,,,4,1,1,0,1
22149_0,,,,2,1,2,3
C1C(C(COC(C=1)O)O)O,,,4,1,2,0,2
22151_0,,,,2,1,2,3
C1OCC(C(C(C=1)O)O)O,,,4,1,1,0,1
22153_0,,,,2,1,2,3
C1C(C(C(OCC=1)O)O)O,,,4,1,1,0,1
22155_0,,,,2,1,2,3
C1(C(C(C=CC(O)O1)O)O)=O,,,4,1,1,0,1
22157_0,,,,2,1,2,3
C1(C(C(C(C=CO1)O)O)O)=O,,,4,1,1,0,1
22159_0,,,,2,1,2,3
C1C(C(C(O)OC(C=1)=O)O)O,,,4,1,1,0,1
22161_0,,,,2,1,2,3
C1OC2C(C(C(C=1)O2)O)O,,,4,1,1,0,1
22163_0,,,,2,1,2,3
C1C(CC(O)OC(C=1)=O)O,,,4,1,1,0,1
22165_0,,,,2,1,2,3
C1(C(C=CCC(O)O1)O)=O,,,4,1,1,0,1
22167_0,,,,2,1,2,3
C1(C(CC=CC(O)O1)O)=O,,,4,1,1,0,1
22169_0,,,,2,1,2,3
C1(C(CC(C=CO1)O)O)=O,,,4,1,1,0,1
22171_0,,,,2,1,2,3
C1C2C(C(OC(C=1)O2)O)O,,,4,1,1,0,1
22172_0,,,,2,1,2,3
22174_0,,,,2,1,2,3
C1C(C(O)OCC(C=1)O)O,,,4,1,1,0,1
22176_0,,,,2,1,2,3
C(C(C1C=CC(O1)=O)O)=O,,,4,1,1,0,1
22177_0,,,,2,1,2,3
22179_0,,,,2,1,2,3
C(C1C(C=CC(O1)=O)O)=O,,,4,1,1,0,1
22180_0,,,,2,1,2,3
22181_0,,,,2,1,2,3
22182_0,,,,2,1,2,3
22183_0,,,,2,1,2,3
22185_0,,,,2,1,2,3
[C](C(O)=O)=CC(C(CO)O)O,,,4,1,1,0,1
22187_0,,,,2,1,2,3
C(C(CO)O)=C[C](C(O)=O)O,,,4,1,2,0,2
22189_0,,,,2,2,1,3
C1(C(C(C(C1O)O)O)O)O,,,4,1,1,0,1
22190_0,,,,2,2,1,3
22191_0,,,,2,2,1,3
22192_0,,,,2,2,1,3
22193_0,,,,2,2,1,3
22194_0,,,,2,2,1,3
22195_0,,,,2,2,1,3
22196_0,,,,2,2,1,3
22197_0,,,,2,2,1,3
22198_0,,,,2,2,1,3
22199_0,,,,2,2,1,3
22200_0,,,,2,2,1,3
22201_0,,,,2,2,1,3
22202_0,,,,2,2,1,3
22203_0,,,,2,2,1,3
22204_0,,,,2,2,1,3
22205_0,,,,2,2,1,3
22206_0,,,,2,2,1,3
22207_0,,,,2,2,1,3
22208_0,,,,2,2,1,3
22209_0,,,,2,2,1,3
22210_0,,,,2,2,1,3
22211_0,,,,2,2,1,3
22212_0,,,,2,2,1,3
22213_0,,,,2,2,1,3
22214_0,,,,2,2,1,3
22215_0,,,,2,2,1,3
22216_0,,,,2,2,1,3
22217_0,,,,2,2,1,3
22218_0,,,,2,2,1,3
22219_0,,,,2,2,1,3
22220_0,,,,2,2,1,3
22221_0,,,,2,2,1,3
22222_0,,,,2,2,1,3
22223_0,,,,2,2,1,3
22224_0,,,,2,2,1,3
22225_0,,,,2,2,1,3
22226_0,,,,2,2,1,3
22227_0,,,,2,2,1,3
22228_0,,,,2,2,1,3
22229_0,,,,2,2,1,3
22230_0,,,,2,2,1,3
22231_0,,,,2,2,1,3
22232_0,,,,2,2,1,3
22233_0,,,,2,2,1,3
22234_0,,,,2,2,1,3
22235_0,,,,2,2,1,3
22236_0,,,,2,2,1,3
22237_0,,,,2,2,1,3
22238_0,,,,2,2,1,3
22239_0,,,,2,2,1,3
22240_0,,,,2,2,1,3
22241_0,,,,2,2,1,3
22242_0,,,,2,2,1,3
22243_0,,,,2,2,1,3
22244_0,,,,2,2,1,3
22245_0,,,,2,2,1,3
22246_0,,,,2,2,1,3
22247_0,,,,2,2,1,3
22248_0,,,,2,2,1,3
22249_0,,,,2,2,1,3
22250_0,,,,2,2,1,3
22251_0,,,,2,2,1,3
22252_0,,,,2,2,1,3
22253_0,,,,2,2,1,3
22254_0,,,,2,2,1,3
22255_0,,,,2,2,1,3
22256_0,,,,2,2,1,3
22257_0,,,,2,2,1,3
22258_0,,,,2,2,1,3
22259_0,,,,2,2,1,3
22260_0,,,,2,2,1,3
22261_0,,,,2,2,1,3
22262_0,,,,2,2,1,3
22263_0,,,,2,2,1,3
22264_0,,,,2,2,1,3
22265_0,,,,2,2,1,3
22266_0,,,,2,2,1,3
22267_0,,,,2,2,1,3
22268_0,,,,2,2,1,3
22269_0,,,,2,2,1,3
22270_0,,,,2,2,1,3
22271_0,,,,2,2,1,3
22272_0,,,,2,2,1,3
22273_0,,,,2,2,1,3
22274_0,,,,2,2,1,3
22275_0,,,,2,2,1,3
22276_0,,,,2,2,1,3
22277_0,,,,2,2,1,3
22278_0,,,,2,2,1,3
22279_0,,,,2,2,1,3
22280_0,,,,2,2,1,3
22281_0,,,,2,2,1,3
22282_0,,,,2,2,1,3
22283_0,,,,2,2,1,3
22284_0,,,,2,2,1,3
22285_0,,,,2,2,1,3
22286_0,,,,2,2,1,3
22287_0,,,,2,2,1,3
22288_0,,,,2,2,1,3
22289_0,,,,2,2,1,3
22290_0,,,,2,2,1,3
22291_0,,,,2,2,1,3
22292_0,,,,2,2,1,3
22293_0,,,,2,2,1,3
22294_0,,,,2,2,1,3
22295_0,,,,2,2,1,3
22296_0,,,,2,2,1,3
22297_0,,,,2,2,1,3
22298_0,,,,2,2,1,3
22299_0,,,,2,2,1,3
22300_0,,,,2,2,1,3
22301_0,,,,2,2,1,3
22302_0,,,,2,2,1,3
22303_0,,,,2,2,1,3
22304_0,,,,2,2,1,3
22305_0,,,,2,2,1,3
22306_0,,,,2,2,1,3
22307_0,,,,2,2,1,3
22308_0,,,,2,2,1,3
22309_0,,,,2,2,1,3
22310_0,,,,2,2,1,3
22311_0,,,,2,2,1,3
22312_0,,,,2,2,1,3
22313_0,,,,2,2,1,3
22314_0,,,,2,2,1,3
22315_0,,,,2,2,1,3
22316_0,,,,2,2,1,3
22317_0,,,,2,2,1,3
22318_0,,,,2,2,1,3
22319_0,,,,2,2,1,3
22320_0,,,,2,2,1,3
22321_0,,,,2,2,1,3
22323_0,,,,2,2,1,3
CC(CO)(C(C(C(CO)O)O)O)O,,,4,1,2,0,2
22325_0,,,,2,2,1,3
CC(C(CO)O)(C(C(CO)O)O)O,,,4,1,2,0,2
22326_0,,,,2,2,1,3
22328_0,,,,2,2,1,3
CC(C(C(C(CO)O)O)O)O,,,4,1,2,0,2
22329_0,,,,2,2,1,3
22331_0,,,,2,2,1,3
C(C(C(C(CO)O)(C(C)O)O)O)=O,,,4,1,2,0,2
22333_0,,,,2,2,1,3
C(C(C(C(C(C(C)O)O)O)O)O)=O,,,4,1,2,0,2
22334_0,,,,2,2,1,3
22335_0,,,,2,2,1,3
22336_0,,,,2,2,1,3
22337_0,,,,2,2,1,3
22338_0,,,,2,2,1,3
22339_0,,,,2,2,1,3
22340_0,,,,2,2,1,3
22341_0,,,,2,2,1,3
22342_0,,,,2,2,1,3
22343_0,,,,2,2,1,3
22344_0,,,,2,2,1,3
22345_0,,,,2,2,1,3
22346_0,,,,2,2,1,3
22347_0,,,,2,2,1,3
22348_0,,,,2,2,1,3
22349_0,,,,2,2,1,3
22350_0,,,,2,2,1,3
22351_0,,,,2,2,1,3
22352_0,,,,2,2,1,3
22353_0,,,,2,2,1,3
22354_0,,,,2,2,1,3
22355_0,,,,2,2,1,3
22356_0,,,,2,2,1,3
22357_0,,,,2,2,1,3
22358_0,,,,2,2,1,3
22359_0,,,,2,2,1,3
22360_0,,,,2,2,1,3
22361_0,,,,2,2,1,3
22362_0,,,,2,2,1,3
22363_0,,,,2,2,1,3
22364_0,,,,2,2,1,3
22365_0,,,,2,2,1,3
22366_0,,,,2,2,1,3
22367_0,,,,2,2,1,3
22368_0,,,,2,2,1,3
22369_0,,,,2,2,1,3
22370_0,,,,2,2,1,3
22371_0,,,,2,2,1,3
22372_0,,,,2,2,1,3
22373_0,,,,2,2,1,3
22374_0,,,,2,2,1,3
22375_0,,,,2,2,1,3
22376_0,,,,2,2,1,3
22377_0,,,,2,2,1,3
22378_0,,,,2,2,1,3
22379_0,,,,2,2,1,3
22380_0,,,,2,2,1,3
22381_0,,,,2,2,1,3
22382_0,,,,2,2,1,3
22383_0,,,,2,2,1,3
22384_0,,,,2,2,1,3
22385_0,,,,2,2,1,3
22386_0,,,,2,2,1,3
22387_0,,,,2,2,1,3
22388_0,,,,2,2,1,3
22389_0,,,,2,2,1,3
22390_0,,,,2,2,1,3
22391_0,,,,2,2,1,3
22392_0,,,,2,2,1,3
22393_0,,,,2,2,1,3
22394_0,,,,2,2,1,3
22395_0,,,,2,2,1,3
22396_0,,,,2,2,1,3
22397_0,,,,2,2,1,3
22398_0,,,,2,2,1,3
22399_0,,,,2,2,1,3
22400_0,,,,2,2,1,3
22401_0,,,,2,2,1,3
22402_0,,,,2,2,1,3
22403_0,,,,2,2,1,3
22404_0,,,,2,2,1,3
22405_0,,,,2,2,1,3
22406_0,,,,2,2,1,3
22407_0,,,,2,2,1,3
22408_0,,,,2,2,1,3
22409_0,,,,2,2,1,3
22410_0,,,,2,2,1,3
22411_0,,,,2,2,1,3
22412_0,,,,2,2,1,3
22413_0,,,,2,2,1,3
22414_0,,,,2,2,1,3
22415_0,,,,2,2,1,3
22416_0,,,,2,2,1,3
22417_0,,,,2,2,1,3
22419_0,,,,2,2,1,3
C(C(C(C(CO)(CCO)O)O)O)O,,,4,1,2,0,2
22420_0,,,,2,2,1,3
22421_0,,,,2,2,1,3
22422_0,,,,2,2,1,3
22423_0,,,,2,2,1,3
22424_0,,,,2,2,1,3
22425_0,,,,2,2,1,3
22426_0,,,,2,2,1,3
22427_0,,,,2,2,1,3
22428_0,,,,2,2,1,3
22430_0,,,,2,2,1,3
CC(CO)(C(C(CO)O)O)O,,,4,1,2,0,2
22431_0,,,,2,2,1,3
22432_0,,,,2,2,1,3
22433_0,,,,2,2,1,3
22434_0,,,,2,2,1,3
22436_0,,,,2,2,1,3
CC(C(C(CO)O)O)O,,,4,1,3,0,3
22437_0,,,,2,2,1,3
22438_0,,,,2,2,1,3
22439_0,,,,2,2,1,3
22440_0,,,,2,2,1,3
22441_0,,,,2,2,1,3
22442_0,,,,2,2,1,3
22443_0,,,,2,2,1,3
22444_0,,,,2,2,1,3
22445_0,,,,2,2,1,3
22446_0,,,,2,2,1,3
22447_0,,,,2,2,1,3
22448_0,,,,2,2,1,3
22449_0,,,,2,2,1,3
22450_0,,,,2,2,1,3
22451_0,,,,2,2,1,3
22452_0,,,,2,2,1,3
22453_0,,,,2,2,1,3
22454_0,,,,2,2,1,3
22455_0,,,,2,2,1,3
22456_0,,,,2,2,1,3
22457_0,,,,2,2,1,3
22458_0,,,,2,2,1,3
22459_0,,,,2,2,1,3
22460_0,,,,2,2,1,3
22461_0,,,,2,2,1,3
22462_0,,,,2,2,1,3
22463_0,,,,2,2,1,3
22464_0,,,,2,2,1,3
22465_0,,,,2,2,1,3
22466_0,,,,2,2,1,3
22467_0,,,,2,2,1,3
22468_0,,,,2,2,1,3
22469_0,,,,2,2,1,3
22470_0,,,,2,2,1,3
22471_0,,,,2,2,1,3
22472_0,,,,2,2,1,3
22473_0,,,,2,2,1,3
22474_0,,,,2,2,1,3
22475_0,,,,2,2,1,3
22476_0,,,,2,2,1,3
22477_0,,,,2,2,1,3
22478_0,,,,2,2,1,3
22479_0,,,,2,2,1,3
22480_0,,,,2,2,1,3
22481_0,,,,2,2,1,3
22483_0,,,,2,2,1,3
C(OC(C(CO)O)C(CO)O)=O,,,4,1,1,0,1
22484_0,,,,2,2,1,3
22486_0,,,,2,2,1,3
C(C(C(O)OCC(CO)O)O)=O,,,4,1,1,0,1
22488_0,,,,2,2,1,3
C(C(CO)OC(C(CO)O)O)=O,,,4,1,1,0,1
22490_0,,,,2,2,1,3
C(OC(CO)C(C(CO)O)O)=O,,,4,1,2,0,2
22491_0,,,,2,2,1,3
22492_0,,,,2,2,1,3
22494_0,,,,2,2,1,3
C1C(C(C(C(O)O1)O)O)O,,,4,1,2,0,2
22496_0,,,,2,2,1,3
C(C(COC(C(CO)O)O)O)=O,,,4,1,1,0,1
22498_0,,,,2,2,1,3
C(OCC(C(C(CO)O)O)O)=O,,,4,1,2,0,2
22500_0,,,,2,2,1,3
C(COC(C(C(CO)O)O)O)=O,,,4,1,2,0,2
22501_0,,,,2,2,1,3
22502_0,,,,2,2,1,3
22503_0,,,,2,2,1,3
22504_0,,,,2,2,1,3
22505_0,,,,2,2,1,3
22506_0,,,,2,2,1,3
22507_0,,,,2,2,1,3
22508_0,,,,2,2,1,3
22509_0,,,,2,2,1,3
22510_0,,,,2,2,1,3
22511_0,,,,2,2,1,3
22512_0,,,,2,2,1,3
22513_0,,,,2,2,1,3
22515_0,,,,2,2,1,3
C(COC(CO)(C(CO)O)O)=O,,,4,1,1,0,1
22516_0,,,,2,2,1,3
22517_0,,,,2,2,1,3
22518_0,,,,2,2,1,3
22519_0,,,,2,2,1,3
22520_0,,,,2,2,1,3
22521_0,,,,2,2,1,3
22522_0,,,,2,2,1,3
22523_0,,,,2,2,1,3
22524_0,,,,2,2,1,3
22525_0,,,,2,2,1,3
22526_0,,,,2,2,1,3
22527_0,,,,2,2,1,3
22528_0,,,,2,2,1,3
22529_0,,,,2,2,1,3
22530_0,,,,2,2,1,3
22531_0,,,,2,2,1,3
22532_0,,,,2,2,1,3
22533_0,,,,2,2,1,3
22534_0,,,,2,2,1,3
22535_0,,,,2,2,1,3
22536_0,,,,2,2,1,3
22537_0,,,,2,2,1,3
22538_0,,,,2,2,1,3
22539_0,,,,2,2,1,3
22540_0,,,,2,2,1,3
22541_0,,,,2,2,1,3
22542_0,,,,2,2,1,3
22543_0,,,,2,2,1,3
22544_0,,,,2,2,1,3
22545_0,,,,2,2,1,3
22546_0,,,,2,2,1,3
22547_0,,,,2,2,1,3
22548_0,,,,2,2,1,3
22549_0,,,,2,2,1,3
22550_0,,,,2,2,1,3
22551_0,,,,2,2,1,3
22552_0,,,,2,2,1,3
22553_0,,,,2,2,1,3
22554_0,,,,2,2,1,3
22555_0,,,,2,2,1,3
22556_0,,,,2,2,1,3
22557_0,,,,2,2,1,3
22558_0,,,,2,2,1,3
22559_0,,,,2,2,1,3
22560_0,,,,2,2,1,3
22561_0,,,,2,2,1,3
22562_0,,,,2,2,1,3
22563_0,,,,2,2,1,3
22564_0,,,,2,2,1,3
22565_0,,,,2,2,1,3
22566_0,,,,2,2,1,3
22567_0,,,,2,2,1,3
22568_0,,,,2,2,1,3
22569_0,,,,2,2,1,3
22570_0,,,,2,2,1,3
22571_0,,,,2,2,1,3
22572_0,,,,2,2,1,3
22573_0,,,,2,2,1,3
22574_0,,,,2,2,1,3
22575_0,,,,2,2,1,3
22576_0,,,,2,2,1,3
22577_0,,,,2,2,1,3
22578_0,,,,2,2,1,3
22579_0,,,,2,2,1,3
22580_0,,,,2,2,1,3
22581_0,,,,2,2,1,3
22582_0,,,,2,2,1,3
22583_0,,,,2,2,1,3
22584_0,,,,2,2,1,3
22585_0,,,,2,2,1,3
22586_0,,,,2,2,1,3
22587_0,,,,2,2,1,3
22588_0,,,,2,2,1,3
22589_0,,,,2,2,1,3
22590_0,,,,2,2,1,3
22591_0,,,,2,2,1,3
22592_0,,,,2,2,1,3
22593_0,,,,2,2,1,3
22594_0,,,,2,2,1,3
22595_0,,,,2,2,1,3
22596_0,,,,2,2,1,3
22597_0,,,,2,2,1,3
22598_0,,,,2,2,1,3
22599_0,,,,2,2,1,3
22600_0,,,,2,2,1,3
22601_0,,,,2,2,1,3
22602_0,,,,2,2,1,3
22603_0,,,,2,2,1,3
22604_0,,,,2,2,1,3
22605_0,,,,2,2,1,3
22606_0,,,,2,2,1,3
22607_0,,,,2,2,1,3
22608_0,,,,2,2,1,3
22609_0,,,,2,2,1,3
22610_0,,,,2,2,1,3
22611_0,,,,2,2,1,3
22612_0,,,,2,2,1,3
22613_0,,,,2,2,1,3
22614_0,,,,2,2,1,3
22615_0,,,,2,2,1,3
22616_0,,,,2,2,1,3
22617_0,,,,2,2,1,3
22618_0,,,,2,2,1,3
22619_0,,,,2,2,1,3
22620_0,,,,2,2,1,3
22621_0,,,,2,2,1,3
22622_0,,,,2,2,1,3
22623_0,,,,2,2,1,3
22624_0,,,,2,2,1,3
22625_0,,,,2,2,1,3
22626_0,,,,2,2,1,3
22627_0,,,,2,2,1,3
22628_0,,,,2,2,1,3
22629_0,,,,2,2,1,3
22630_0,,,,2,2,1,3
22631_0,,,,2,2,1,3
22632_0,,,,2,2,1,3
22633_0,,,,2,2,1,3
22634_0,,,,2,2,1,3
22635_0,,,,2,2,1,3
22636_0,,,,2,2,1,3
22637_0,,,,2,2,1,3
22638_0,,,,2,2,1,3
22639_0,,,,2,2,1,3
22640_0,,,,2,2,1,3
22641_0,,,,2,2,1,3
22642_0,,,,2,2,1,3
22643_0,,,,2,2,1,3
22644_0,,,,2,2,1,3
22645_0,,,,2,2,1,3
22646_0,,,,2,2,1,3
22647_0,,,,2,2,1,3
22648_0,,,,2,2,1,3
22649_0,,,,2,2,1,3
22650_0,,,,2,2,1,3
22651_0,,,,2,2,1,3
22652_0,,,,2,2,1,3
22653_0,,,,2,2,1,3
22654_0,,,,2,2,1,3
22655_0,,,,2,2,1,3
22656_0,,,,2,2,1,3
22657_0,,,,2,2,1,3
22658_0,,,,2,2,1,3
22659_0,,,,2,2,1,3
22660_0,,,,2,2,1,3
22661_0,,,,2,2,1,3
22662_0,,,,2,2,1,3
22663_0,,,,2,2,1,3
22664_0,,,,2,2,1,3
22665_0,,,,2,2,1,3
22666_0,,,,2,2,1,3
22667_0,,,,2,2,1,3
22668_0,,,,2,2,1,3
22669_0,,,,2,2,1,3
22670_0,,,,2,2,1,3
22671_0,,,,2,2,1,3
22672_0,,,,2,2,1,3
22673_0,,,,2,2,1,3
22674_0,,,,2,2,1,3
22675_0,,,,2,2,1,3
22676_0,,,,2,2,1,3
22677_0,,,,2,2,1,3
22678_0,,,,2,2,1,3
22679_0,,,,2,2,1,3
22680_0,,,,2,2,1,3
22681_0,,,,2,2,1,3
22682_0,,,,2,2,1,3
22683_0,,,,2,2,1,3
22684_0,,,,2,2,1,3
22685_0,,,,2,2,1,3
22686_0,,,,2,2,1,3
22687_0,,,,2,2,1,3
22688_0,,,,2,2,1,3
22689_0,,,,2,2,1,3
22690_0,,,,2,2,1,3
22691_0,,,,2,2,1,3
22692_0,,,,2,2,1,3
22693_0,,,,2,2,1,3
22694_0,,,,2,2,1,3
22695_0,,,,2,2,1,3
22696_0,,,,2,2,1,3
22697_0,,,,2,2,1,3
22698_0,,,,2,2,1,3
22699_0,,,,2,2,1,3
22700_0,,,,2,2,1,3
22701_0,,,,2,2,1,3
22702_0,,,,2,2,1,3
22703_0,,,,2,2,1,3
22704_0,,,,2,2,1,3
22705_0,,,,2,2,1,3
22706_0,,,,2,2,1,3
22707_0,,,,2,2,1,3
22708_0,,,,2,2,1,3
22709_0,,,,2,2,1,3
22710_0,,,,2,2,1,3
22711_0,,,,2,2,1,3
22712_0,,,,2,2,1,3
22713_0,,,,2,2,1,3
22714_0,,,,2,2,1,3
22715_0,,,,2,2,1,3
22716_0,,,,2,2,1,3
22717_0,,,,2,2,1,3
22718_0,,,,2,2,1,3
22719_0,,,,2,2,1,3
22720_0,,,,2,2,1,3
22721_0,,,,2,2,1,3
22722_0,,,,2,2,1,3
22723_0,,,,2,2,1,3
22724_0,,,,2,2,1,3
22725_0,,,,2,2,1,3
22726_0,,,,2,2,1,3
22727_0,,,,2,2,1,3
22728_0,,,,2,2,1,3
22729_0,,,,2,2,1,3
22730_0,,,,2,2,1,3
22731_0,,,,2,2,1,3
22732_0,,,,2,2,1,3
22733_0,,,,2,2,1,3
22734_0,,,,2,2,1,3
22735_0,,,,2,2,1,3
22736_0,,,,2,2,1,3
22737_0,,,,2,2,1,3
22738_0,,,,2,2,1,3
22739_0,,,,2,2,1,3
22740_0,,,,2,2,1,3
22741_0,,,,2,2,1,3
22742_0,,,,2,2,1,3
22743_0,,,,2,2,1,3
22744_0,,,,2,2,1,3
22745_0,,,,2,2,1,3
22746_0,,,,2,2,1,3
22747_0,,,,2,2,1,3
22748_0,,,,2,2,1,3
22749_0,,,,2,2,1,3
22751_0,,,,2,2,1,3
C(C1(C(C(CCO1)O)O)O)=O,,,4,1,2,0,2
22752_0,,,,2,2,1,3
22753_0,,,,2,2,1,3
22754_0,,,,2,2,1,3
22755_0,,,,2,2,1,3
22756_0,,,,2,2,1,3
22757_0,,,,2,2,1,3
22758_0,,,,2,2,1,3
22759_0,,,,2,2,1,3
22760_0,,,,2,2,1,3
22761_0,,,,2,2,1,3
22762_0,,,,2,2,1,3
22763_0,,,,2,2,1,3
22764_0,,,,2,2,1,3
22765_0,,,,2,2,1,3
22766_0,,,,2,2,1,3
22767_0,,,,2,2,1,3
22768_0,,,,2,2,1,3
22769_0,,,,2,2,1,3
22770_0,,,,2,2,1,3
22771_0,,,,2,2,1,3
22772_0,,,,2,2,1,3
22773_0,,,,2,2,1,3
22774_0,,,,2,2,1,3
22775_0,,,,2,2,1,3
22776_0,,,,2,2,1,3
22777_0,,,,2,2,1,3
22778_0,,,,2,2,1,3
22779_0,,,,2,2,1,3
22780_0,,,,2,2,1,3
22781_0,,,,2,2,1,3
22782_0,,,,2,2,1,3
22783_0,,,,2,2,1,3
22784_0,,,,2,2,1,3
22786_0,,,,2,2,1,3
C1(C(C(C(CCO1)O)O)O)=O,,,4,1,2,0,2
22787_0,,,,2,2,1,3
22788_0,,,,2,2,1,3
22789_0,,,,2,2,1,3
22790_0,,,,2,2,1,3
22791_0,,,,2,2,1,3
22792_0,,,,2,2,1,3
22793_0,,,,2,2,1,3
22794_0,,,,2,2,1,3
22795_0,,,,2,2,1,3
22796_0,,,,2,2,1,3
22797_0,,,,2,2,1,3
22798_0,,,,2,2,1,3
22799_0,,,,2,2,1,3
22800_0,,,,2,2,1,3
22801_0,,,,2,2,1,3
22802_0,,,,2,2,1,3
22803_0,,,,2,2,1,3
22804_0,,,,2,2,1,3
22805_0,,,,2,2,1,3
22806_0,,,,2,2,1,3
22807_0,,,,2,2,1,3
22808_0,,,,2,2,1,3
22809_0,,,,2,2,1,3
22810_0,,,,2,2,1,3
22811_0,,,,2,2,1,3
22812_0,,,,2,2,1,3
22813_0,,,,2,2,1,3
22814_0,,,,2,2,1,3
22815_0,,,,2,2,1,3
22816_0,,,,2,2,1,3
22817_0,,,,2,2,1,3
22818_0,,,,2,2,1,3
22819_0,,,,2,2,1,3
22820_0,,,,2,2,1,3
22821_0,,,,2,2,1,3
22822_0,,,,2,2,1,3
22823_0,,,,2,2,1,3
22824_0,,,,2,2,1,3
22825_0,,,,2,2,1,3
22826_0,,,,2,2,1,3
22827_0,,,,2,2,1,3
22828_0,,,,2,2,1,3
22829_0,,,,2,2,1,3
22830_0,,,,2,2,1,3
22831_0,,,,2,2,1,3
22832_0,,,,2,2,1,3
22833_0,,,,2,2,1,3
22834_0,,,,2,2,1,3
22835_0,,,,2,2,1,3
22836_0,,,,2,2,1,3
22837_0,,,,2,2,1,3
22838_0,,,,2,2,1,3
22839_0,,,,2,2,1,3
22840_0,,,,2,2,1,3
22841_0,,,,2,2,1,3
22842_0,,,,2,2,1,3
22843_0,,,,2,2,1,3
22844_0,,,,2,2,1,3
22845_0,,,,2,2,1,3
22846_0,,,,2,2,1,3
22847_0,,,,2,2,1,3
22848_0,,,,2,2,1,3
22849_0,,,,2,2,1,3
22850_0,,,,2,2,1,3
22851_0,,,,2,2,1,3
22852_0,,,,2,2,1,3
22853_0,,,,2,2,1,3
22854_0,,,,2,2,1,3
22855_0,,,,2,2,1,3
22856_0,,,,2,2,1,3
22857_0,,,,2,2,1,3
22858_0,,,,2,2,1,3
22859_0,,,,2,2,1,3
22860_0,,,,2,2,1,3
22861_0,,,,2,2,1,3
22862_0,,,,2,2,1,3
22863_0,,,,2,2,1,3
22864_0,,,,2,2,1,3
22865_0,,,,2,2,1,3
22866_0,,,,2,2,1,3
22867_0,,,,2,2,1,3
22868_0,,,,2,2,1,3
22869_0,,,,2,2,1,3
22870_0,,,,2,2,1,3
22871_0,,,,2,2,1,3
22872_0,,,,2,2,1,3
22873_0,,,,2,2,1,3
22874_0,,,,2,2,1,3
22875_0,,,,2,2,1,3
22876_0,,,,2,2,1,3
22877_0,,,,2,2,1,3
22878_0,,,,2,2,1,3
22879_0,,,,2,2,1,3
22880_0,,,,2,2,1,3
22881_0,,,,2,2,1,3
22882_0,,,,2,2,1,3
22883_0,,,,2,2,1,3
22884_0,,,,2,2,1,3
22885_0,,,,2,2,1,3
22886_0,,,,2,2,1,3
22887_0,,,,2,2,1,3
22888_0,,,,2,2,1,3
22889_0,,,,2,2,1,3
22890_0,,,,2,2,1,3
22891_0,,,,2,2,1,3
22892_0,,,,2,2,1,3
22893_0,,,,2,2,1,3
22894_0,,,,2,2,1,3
22895_0,,,,2,2,1,3
22896_0,,,,2,2,1,3
22897_0,,,,2,2,1,3
22898_0,,,,2,2,1,3
22899_0,,,,2,2,1,3
22900_0,,,,2,2,1,3
22901_0,,,,2,2,1,3
22902_0,,,,2,2,1,3
22903_0,,,,2,2,1,3
22904_0,,,,2,2,1,3
22905_0,,,,2,2,1,3
22906_0,,,,2,2,1,3
22907_0,,,,2,2,1,3
22908_0,,,,2,2,1,3
22909_0,,,,2,2,1,3
22910_0,,,,2,2,1,3
22911_0,,,,2,2,1,3
22912_0,,,,2,2,1,3
22913_0,,,,2,2,1,3
22914_0,,,,2,2,1,3
22915_0,,,,2,2,1,3
22916_0,,,,2,2,1,3
22917_0,,,,2,2,1,3
22918_0,,,,2,2,1,3
22919_0,,,,2,2,1,3
22920_0,,,,2,2,1,3
22921_0,,,,2,2,1,3
22922_0,,,,2,2,1,3
22923_0,,,,2,2,1,3
22924_0,,,,2,2,1,3
22925_0,,,,2,2,1,3
22926_0,,,,2,2,1,3
22928_0,,,,2,2,1,3
C(C(C1C(C(CO1)O)O)O)=O,,,4,1,3,0,3
22929_0,,,,2,2,1,3
22930_0,,,,2,2,1,3
22931_0,,,,2,2,1,3
22932_0,,,,2,2,1,3
22933_0,,,,2,2,1,3
22934_0,,,,2,2,1,3
22935_0,,,,2,2,1,3
22936_0,,,,2,2,1,3
22937_0,,,,2,2,1,3
22938_0,,,,2,2,1,3
22939_0,,,,2,2,1,3
22940_0,,,,2,2,1,3
22941_0,,,,2,2,1,3
22942_0,,,,2,2,1,3
22943_0,,,,2,2,1,3
22944_0,,,,2,2,1,3
22945_0,,,,2,2,1,3
22946_0,,,,2,2,1,3
22947_0,,,,2,2,1,3
22948_0,,,,2,2,1,3
22949_0,,,,2,2,1,3
22950_0,,,,2,2,1,3
22951_0,,,,2,2,1,3
22952_0,,,,2,2,1,3
22953_0,,,,2,2,1,3
22954_0,,,,2,2,1,3
22955_0,,,,2,2,1,3
22956_0,,,,2,2,1,3
22957_0,,,,2,2,1,3
22959_0,,,,2,2,1,3
C(C(CC(CO)O)O)O,,,4,1,1,0,1
22960_0,,,,2,1,2,3
22962_0,,,,2,1,2,3
C(C(C(C=C)O)O)=O,,,4,1,1,0,1
22963_0,,,,2,1,2,3
22964_0,,,,2,1,2,3
22965_0,,,,2,1,2,3
22966_0,,,,2,1,2,3
22968_0,,,,2,1,2,3
C=CCO,,,4,1,2,0,2
22969_0,,,,2,1,2,3
22970_0,,,,2,1,2,3
22971_0,,,,2,1,2,3
22972_0,,,,2,1,2,3
22973_0,,,,2,1,2,3
22975_0,,,,2,1,1,2
C12CC(C(C(C1O)O)(O)O2)O,,,4,1,1,0,1
22977_0,,,,2,1,1,2
C1C2(C(C(CC2O)(O)O1)O)O,,,4,1,2,0,2
22977_1,,,,2,1,1,2
22979_0,,,,2,1,1,2
C1C2(CC(C(C2O)(O)O1)O)O,,,4,1,2,0,2
22979_1,,,,2,1,1,2
22981_0,,,,2,1,1,2
C1C2(CC(C(C2O)O)(O)O1)O,,,4,1,2,0,2
22981_1,,,,2,1,1,2
22982_0,,,,2,1,1,2
22982_1,,,,2,1,1,2
22983_0,,,,2,1,1,2
22983_1,,,,2,1,1,2
22984_0,,,,2,1,1,2
22984_1,,,,2,1,1,2
22985_0,,,,2,1,1,2
22986_0,,,,2,1,1,2
22986_1,,,,2,1,1,2
22987_0,,,,2,1,1,2
22987_1,,,,2,1,1,2
22988_0,,,,2,1,1,2
22989_0,,,,2,1,1,2
22989_1,,,,2,1,1,2
22990_0,,,,2,1,1,2
22990_1,,,,2,1,1,2
22991_0,,,,2,1,1,2
22991_1,,,,2,1,1,2
22993_0,,,,2,1,1,2
C1(C2C(C(C(O2)O)C1O)O)=O,,,4,1,2,0,2
22993_1,,,,2,1,1,2
22994_0,,,,2,1,1,2
22996_0,,,,2,1,1,2
C(C1C2(C(C(C(C1O)O2)O)O)O)O,,,4,1,1,0,1
22998_0,,,,2,1,1,2
C1C(CO)(C(C(CO)(O)O1)O)O,,,4,1,1,0,1
23000_0,,,,2,1,1,2
C(C1(CC(CO)(CO1)O)O)=O,,,4,1,1,0,1
23002_0,,,,2,1,1,2
C1(C(O)OC(CO)(CO)C1)=O,,,4,1,1,0,1
23004_0,,,,2,1,1,2
C(CO)(C1C(CC(CO)(O1)O)O)=O,,,4,1,1,0,1
23006_0,,,,2,1,1,2
C(CO)(C1C(CO)(CC(O1)O)O)=O,,,4,1,1,0,1
23008_0,,,,2,1,1,2
C(CC1(COC(CO)(C1O)O)O)=O,,,4,1,1,0,1
23009_0,,,,2,1,1,2
23011_0,,,,2,1,1,2
C(CO)(C1C(O)OCC1(CO)O)=O,,,4,1,1,0,1
23013_0,,,,2,1,1,2
C(C1C(CO)(O)OCC1(CO)O)=O,,,4,1,1,0,1
23014_0,,,,2,1,1,2
23016_0,,,,2,1,1,2
C(CC1(C(C(CO1)(CO)O)O)O)=O,,,4,1,1,0,1
23017_0,,,,2,1,1,2
23019_0,,,,2,1,1,2
C(CO)(C1C(C(C(C)(O1)O)O)O)=O,,,4,1,1,0,1
23021_0,,,,2,1,1,2
C(C)(C1C(C(C(CO)(O1)O)O)O)=O,,,4,1,1,0,1
23023_0,,,,2,1,1,2
C(CO)(C1C(C)(C(C(O1)O)O)O)=O,,,4,1,1,0,1
23025_0,,,,2,1,1,2
C(C1C(C)(C(C(CO)(O1)O)O)O)=O,,,4,1,1,0,1
23027_0,,,,2,1,1,2
C(C(C1(CC(CO1)(CO)O)O)O)=O,,,4,1,1,0,1
23029_0,,,,2,1,1,2
CC1(C(CO)OC(CO)(C1O)O)O,,,4,1,1,0,1
23031_0,,,,2,1,1,2
C1C(CO)(CC(C(CO)O)(O)O1)O,,,4,1,1,0,1
23032_0,,,,2,1,1,2
23034_0,,,,2,1,1,2
C(C1(C(CO)C(CO)(CO1)O)O)=O,,,4,1,1,0,1
23036_0,,,,2,1,1,2
C1(C(O)OC(CO)(CO)C1CO)=O,,,4,1,1,0,1
23037_0,,,,2,1,1,2
23039_0,,,,2,1,1,2
C1C(CCO)(C(C(CO)(O)O1)O)O,,,4,1,1,0,1
23041_0,,,,2,1,1,2
C1C(CO)(C(C(CCO)(O)O1)O)O,,,4,1,1,0,1
23043_0,,,,2,1,1,2
C1C(CO)(C(CO)C(CO)(O)O1)O,,,4,1,1,0,1
23045_0,,,,2,1,1,2
C(CO)(C1C(C(C(O1)O)O)O)=O,,,4,1,1,0,1
23047_0,,,,2,1,1,2
C(C1C(C(C(CO)(O1)O)O)O)=O,,,4,1,1,0,1
23049_0,,,,2,1,1,2
C1C(C)(C(C(CO)(O)O1)O)O,,,4,1,1,0,1
23051_0,,,,2,1,1,2
C1C(CO)(CC(CO)(O)O1)O,,,4,1,1,0,1
23053_0,,,,2,1,1,2
C1C(CO)(C(C(C)(O)O1)O)O,,,4,1,1,0,1
23055_0,,,,2,1,1,2
C(CO)(C(C1C(CC(O)O1)O)O)=O,,,4,1,1,0,1
23057_0,,,,2,1,1,2
C(CC1C(C(C(CO)(O)O1)O)O)=O,,,4,1,1,0,1
23059_0,,,,2,1,1,2
C(CO)(C(C1CC(C(O)O1)O)O)=O,,,4,1,1,0,1
23061_0,,,,2,1,1,2
C(C(C1C(O)OCC1(CO)O)O)=O,,,4,1,1,0,1
23063_0,,,,2,1,1,2
C(C1C(C(O)OC1(CO)CO)O)=O,,,4,1,1,0,1
23065_0,,,,2,1,1,2
C1C(CO)(CC(O)O1)O,,,4,1,1,0,1
23067_0,,,,2,1,1,2
C(C1(COC(CO)(C1O)O)O)=O,,,4,1,1,0,1
23069_0,,,,2,1,1,2
C(C1(C(C(CO)(CO1)O)O)O)=O,,,4,1,1,0,1
23071_0,,,,2,1,1,2
C1(C(O)OC(CO)(CO)C1O)=O,,,4,1,1,0,1
23073_0,,,,2,1,1,2
C(CO)(C1C(O)OC(CO)C1O)=O,,,4,1,1,0,1
23075_0,,,,2,1,1,2
C(C1C(CO)(O)OC(CO)C1O)=O,,,4,1,1,0,1
23076_0,,,,2,1,1,2
23078_0,,,,2,1,1,2
C(CC1(C(C(C(CO)O1)O)O)O)=O,,,4,1,1,0,1
23079_0,,,,2,1,1,2
23081_0,,,,2,1,1,2
C(C(C1(CC(C(CO)O1)O)O)O)=O,,,4,1,1,0,1
23083_0,,,,2,1,1,2
C(C(C1(CC(C(CO)O1)O)O)O)O,,,4,1,1,0,1
23085_0,,,,2,1,1,2
C(C1(C(CO)C(C(CO)O1)O)O)=O,,,4,1,1,0,1
23086_0,,,,2,1,1,2
23087_0,,,,2,1,1,2
23089_0,,,,2,1,1,2
C(CC1(C(C(C(CO)O1)O)O)O)O,,,4,1,1,0,1
23091_0,,,,2,1,1,2
C(C1(C(CO)C(C(CO)O1)O)O)O,,,4,1,1,0,1
23093_0,,,,2,1,1,2
C(C(C1C(O)OC(CO)C1O)O)=O,,,4,1,1,0,1
23095_0,,,,2,1,1,2
C(C1C(C(CO)O)OC(C1O)O)=O,,,4,1,1,0,1
23097_0,,,,2,1,1,2
C(C1C(CC(O)O1)O)O,,,4,1,1,0,1
23099_0,,,,2,1,1,2
C(C1(C)CC(C(O1)O)=O)=O,,,4,1,1,0,1
23101_0,,,,2,1,1,2
C(CO)(CC1CC(C(O)O1)=O)=O,,,4,1,1,0,1
23103_0,,,,2,1,1,2
C(CC1(CO)CC(C(O)O1)=O)=O,,,4,1,1,0,1
23105_0,,,,2,1,1,2
C(CC1(COC(C=O)(C1)O)O)=O,,,4,1,1,0,1
23106_0,,,,2,1,1,2
23107_0,,,,2,1,1,2
23108_0,,,,2,1,1,2
23109_0,,,,2,1,1,2
23110_0,,,,2,1,1,2
23112_0,,,,2,1,1,2
C(C)(C(C1CC(C(O)O1)=O)O)=O,,,4,1,1,0,1
23114_0,,,,2,1,1,2
C(C1(CC(C(C(C)=O)O1)O)O)=O,,,4,1,1,0,1
23116_0,,,,2,1,1,2
C(C(C1(C)CC(C(O)O1)=O)O)=O,,,4,1,1,0,1
23118_0,,,,2,1,1,2
C(C1C(C)(CC(C=O)(O1)O)O)=O,,,4,1,1,0,1
23120_0,,,,2,1,1,2
C(C1CC(C(O)O1)=O)=O,,,4,1,1,0,1
23122_0,,,,2,1,1,2
C1(C(O)OC(C)(C(CO)O)C1)=O,,,4,1,1,0,1
23124_0,,,,2,1,1,2
C(C1(CC(C)(C(CO)O1)O)O)=O,,,4,1,1,0,1
23125_0,,,,2,1,1,2
23127_0,,,,2,1,1,2
C(C1(CCO)CC(C(O1)O)=O)=O,,,4,1,1,0,1
23128_0,,,,2,1,1,2
23129_0,,,,2,1,1,2
23131_0,,,,2,1,1,2
C(C(C1COC(C)(C1O)O)=O)=O,,,4,1,1,0,1
23132_0,,,,2,1,1,2
23134_0,,,,2,1,1,2
C(C1(C)C(C(C(O1)O)=O)CO)=O,,,4,1,1,0,1
23136_0,,,,2,1,1,2
C(C(C1COC(C1(C)O)O)=O)=O,,,4,1,1,0,1
23137_0,,,,2,1,1,2
23139_0,,,,2,1,1,2
C1(C(O)OC(CO)(CCO)C1)=O,,,4,1,1,0,1
23141_0,,,,2,1,1,2
C(C1(CC(CO1)(CCO)O)O)=O,,,4,1,1,0,1
23143_0,,,,2,1,1,2
C(CO)(C1COC(C)(C1O)O)=O,,,4,1,1,0,1
23145_0,,,,2,1,1,2
C(CO)(C1COC(C1(C)O)O)=O,,,4,1,1,0,1
23147_0,,,,2,1,1,2
C(C(C1CC(C(O)O1)=O)O)=O,,,4,1,1,0,1
23149_0,,,,2,1,1,2
C(C1C(CC(C=O)(O1)O)O)=O,,,4,1,1,0,1
23151_0,,,,2,1,1,2
C1(C(O)OC(CO)(C)C1)=O,,,4,1,1,0,1
23153_0,,,,2,1,1,2
C(C1(CC(CO1)(C)O)O)=O,,,4,1,1,0,1
23155_0,,,,2,1,1,2
C(CC(C1CC(C(O)O1)=O)O)=O,,,4,1,1,0,1
23157_0,,,,2,1,1,2
C(C(CC1C(CC(O)O1)O)=O)=O,,,4,1,1,0,1
23159_0,,,,2,1,1,2
C(CC1C(CC(C=O)(O)O1)O)=O,,,4,1,1,0,1
23161_0,,,,2,1,1,2
C(C(CC1CC(C(O)O1)=O)O)=O,,,4,1,1,0,1
23163_0,,,,2,1,1,2
C(C(CC1CC(C(O)O1)O)=O)=O,,,4,1,1,0,1
23165_0,,,,2,1,1,2
C(C1C(C(C)(OC1C=O)O)O)=O,,,4,1,1,0,1
23167_0,,,,2,1,1,2
C(C1C(C(OC1C(C)=O)O)O)=O,,,4,1,1,0,1
23169_0,,,,2,1,1,2
C(C1C(C)(C(OC1C=O)O)O)=O,,,4,1,1,0,1
23171_0,,,,2,1,1,2
C(C1C(C(OC1(C=O)C)O)O)=O,,,4,1,1,0,1
23173_0,,,,2,1,1,2
C(C(C(C1CC(C(O)O1)=O)O)O)=O,,,4,1,1,0,1
23175_0,,,,2,1,1,2
C(C(CC1C(C(C(O)O1)O)O)=O)=O,,,4,1,1,0,1
23177_0,,,,2,1,1,2
C(C(C1C(CC(C=O)(O)O1)O)O)=O,,,4,1,1,0,1
23179_0,,,,2,1,1,2
C1(C(O)OC(C)C1)=O,,,4,1,1,0,1
23181_0,,,,2,1,1,2
C1(C(O)OC(C(CO)=O)C1)=O,,,4,1,1,0,1
23183_0,,,,2,1,1,2
C(C1(CO)CC(C(O1)O)=O)=O,,,4,1,1,0,1
23185_0,,,,2,1,1,2
C(C1(COC(C=O)(C1)O)O)=O,,,4,1,1,0,1
23187_0,,,,2,1,1,2
C(C1(C)C(C(C(O1)O)=O)O)=O,,,4,1,1,0,1
23189_0,,,,2,1,1,2
C1(C(O)OC(CO)(C(CO)O)C1)=O,,,4,1,1,0,1
23191_0,,,,2,1,1,2
C(C1(CC(CO1)(C(CO)O)O)O)=O,,,4,1,1,0,1
23193_0,,,,2,1,1,2
C(C1(CC(CO)(C(CO)O1)O)O)=O,,,4,1,1,0,1
23195_0,,,,2,1,1,2
C1(C(OC(C(C(CO)O)=O)C1)O)=O,,,4,1,1,0,1
23197_0,,,,2,1,1,2
C(C1(C(CO)O)CC(C(O1)O)=O)=O,,,4,1,1,0,1
23199_0,,,,2,1,1,2
C(C1(CC(C=O)(O)OC1CO)O)=O,,,4,1,1,0,1
23200_0,,,,2,1,1,2
23201_0,,,,2,1,1,2
23202_0,,,,2,1,1,2
23203_0,,,,2,1,1,2
23204_0,,,,2,1,1,2
23205_0,,,,2,1,1,2
23207_0,,,,2,1,1,2
C(C1C(C(C(CO)=O)C(O1)O)O)=O,,,4,1,1,0,1
23209_0,,,,2,1,1,2
C(C1C(C(C=O)OC1(CO)O)O)=O,,,4,1,1,0,1
23210_0,,,,2,1,1,2
23212_0,,,,2,1,1,2
C(CC(C1C(C(C(O1)O)O)O)=O)=O,,,4,1,1,0,1
23214_0,,,,2,1,1,2
C(CC1(C(C(C(C=O)O1)O)O)O)=O,,,4,1,1,0,1
23215_0,,,,2,1,1,2
23217_0,,,,2,1,1,2
C(CO)(C1C(O)OCC1(C)O)=O,,,4,1,1,0,1
23219_0,,,,2,1,1,2
C(C1C(CO)(O)OCC1(C)O)=O,,,4,1,1,0,1
23220_0,,,,2,1,1,2
23222_0,,,,2,1,1,2
C(CC1(C(C(CO1)(C)O)O)O)=O,,,4,1,1,0,1
23223_0,,,,2,1,1,2
23225_0,,,,2,1,1,2
C(CC1(COC(CO)(C1)O)O)=O,,,4,1,1,0,1
23227_0,,,,2,1,1,2
C(C)(C1C(CC(CO)(O1)O)O)=O,,,4,1,1,0,1
23228_0,,,,2,1,1,2
23230_0,,,,2,1,1,2
C(CC1(COC(C)(C1O)O)O)=O,,,4,1,1,0,1
23232_0,,,,2,1,1,2
C(C)(C1C(CO)(CC(O1)O)O)=O,,,4,1,1,0,1
23233_0,,,,2,1,1,2
23234_0,,,,2,1,1,2
23235_0,,,,2,1,1,2
23236_0,,,,2,1,1,2
23237_0,,,,2,1,1,2
23238_0,,,,2,1,1,2
23240_0,,,,2,1,1,2
C(C1(COC(C1C(CO)=O)O)O)=O,,,4,1,1,0,1
23242_0,,,,2,1,1,2
C(C1C(CO)(O)OCC1(C=O)O)=O,,,4,1,1,0,1
23243_0,,,,2,1,1,2
23245_0,,,,2,1,1,2
C(C1(COC(C1O)(CC=O)O)O)=O,,,4,1,1,0,1
23247_0,,,,2,1,1,2
C(CO)(CC1C(C(C(O)O1)=O)O)=O,,,4,1,1,0,1
23249_0,,,,2,1,1,2
C(C(C1C(CC(CO)(O1)O)O)=O)=O,,,4,1,1,0,1
23250_0,,,,2,1,1,2
23252_0,,,,2,1,1,2
C(CC1(COC(C=O)(C1O)O)O)=O,,,4,1,1,0,1
23254_0,,,,2,1,1,2
C(CC1(CO)C(C(C(O)O1)=O)O)=O,,,4,1,1,0,1
23256_0,,,,2,1,1,2
C(C(C1C(CO)(CC(O1)O)O)=O)=O,,,4,1,1,0,1
23258_0,,,,2,1,1,2
C(C(C1(CC(C(C=O)O1)O)O)O)=O,,,4,1,1,0,1
23260_0,,,,2,1,1,2
C(C(C1(CC(CO1)(C)O)O)O)=O,,,4,1,1,0,1
23262_0,,,,2,1,1,2
C(C1C(C)(CC(CO)(O1)O)O)=O,,,4,1,1,0,1
23264_0,,,,2,1,1,2
C(C)(C1C(C(C(C)(O1)O)O)O)=O,,,4,1,1,0,1
23266_0,,,,2,1,1,2
C(C1C(C)(C(C(C)(O1)O)O)O)=O,,,4,1,1,0,1
23268_0,,,,2,1,1,2
C(C)(C1C(C)(C(C(O1)O)O)O)=O,,,4,1,1,0,1
23269_0,,,,2,1,1,2
23271_0,,,,2,1,1,2
C(C1C(C)(CC(O1)O)O)=O,,,4,1,1,0,1
23273_0,,,,2,1,1,2
C(C1(COC(C1)(C(C=O)O)O)O)=O,,,4,1,1,0,1
23275_0,,,,2,1,1,2
C(C1(C(C(C(C(C)=O)O1)O)O)O)=O,,,4,1,1,0,1
23277_0,,,,2,1,1,2
C(C)(C(C1C(C(C(O)O1)=O)O)O)=O,,,4,1,1,0,1
23279_0,,,,2,1,1,2
C(C(C1C(C(C(C)(O1)O)O)O)=O)=O,,,4,1,1,0,1
23281_0,,,,2,1,1,2
C(C1C(C)(C(C(C=O)(O1)O)O)O)=O,,,4,1,1,0,1
23283_0,,,,2,1,1,2
C(C(C1(C)C(C(C(O)O1)=O)O)O)=O,,,4,1,1,0,1
23285_0,,,,2,1,1,2
C(C(C1C(C)(C(C(O1)O)O)O)=O)=O,,,4,1,1,0,1
23287_0,,,,2,1,1,2
C(CO)(C1C(C(OC1C=O)O)O)=O,,,4,1,1,0,1
23289_0,,,,2,1,1,2
C1(C(OC(C=O)C1CO)O)=O,,,4,1,1,0,1
23291_0,,,,2,1,1,2
C(C(C1COC(C1O)O)=O)=O,,,4,1,1,0,1
23292_0,,,,2,1,1,2
23293_0,,,,2,1,1,2
23295_0,,,,2,1,1,2
C(C1C(C(OC1C=O)O)O)=O,,,4,1,1,0,1
23297_0,,,,2,1,1,2
C(C1C(C(C(O)O1)=O)O)=O,,,4,1,1,0,1
23299_0,,,,2,1,1,2
C(C1C(CC(C(CO)O)(O1)O)O)=O,,,4,1,1,0,1
23301_0,,,,2,1,1,2
C1C(C)(CC(C(CO)O)(O)O1)O,,,4,1,1,0,1
23303_0,,,,2,1,1,2
CC1(CC(CO)(O)OC1CO)O,,,4,1,1,0,1
23305_0,,,,2,1,1,2
CC1(C(C(C)(C(CO)O1)O)O)O,,,4,1,1,0,1
23307_0,,,,2,1,1,2
CC1(CC(O)OC1CO)O,,,4,1,1,0,1
23309_0,,,,2,1,1,2
C(C1(COC(C1)(C(CO)O)O)O)=O,,,4,1,1,0,1
23311_0,,,,2,1,1,2
C(C1(C(C(C)(C(CO)O1)O)O)O)=O,,,4,1,1,0,1
23313_0,,,,2,1,1,2
C1(C(O)OC(C)(C(CO)O)C1O)=O,,,4,1,1,0,1
23315_0,,,,2,1,1,2
C(CO)(C1C(C)OC(C1O)O)=O,,,4,1,1,0,1
23317_0,,,,2,1,1,2
C(CO)(CC1C(CC(O)O1)O)=O,,,4,1,1,0,1
23319_0,,,,2,1,1,2
C(CC1C(CC(CO)(O)O1)O)=O,,,4,1,1,0,1
23321_0,,,,2,1,1,2
C(C(CC1(COC(C1)O)O)O)=O,,,4,1,1,0,1
23323_0,,,,2,1,1,2
C(CC1(CO)CC(C(O)O1)O)=O,,,4,1,1,0,1
23324_0,,,,2,1,1,2
23326_0,,,,2,1,1,2
C(C1COC(C1O)O)=O,,,4,1,1,0,1
23328_0,,,,2,1,1,2
C(C1COC(C1O)(C(CO)O)O)=O,,,4,1,1,0,1
23330_0,,,,2,1,1,2
C1(C(CC(CO)O)(O)OCC1O)=O,,,4,1,1,0,1
23332_0,,,,2,1,1,2
C1(C(C(CO)O)(O)OC(CO)C1)=O,,,4,1,1,0,1
23333_0,,,,2,1,1,2
23335_0,,,,2,1,1,2
C1(C(CO)(O)OCC1C(CO)O)=O,,,4,1,1,0,1
23336_0,,,,2,1,1,2
23338_0,,,,2,1,1,2
C(CO)(C1(C(CO)C(CO1)O)O)=O,,,4,1,1,0,1
23339_0,,,,2,1,1,2
23340_0,,,,2,1,1,2
23341_0,,,,2,1,1,2
23343_0,,,,2,1,1,2
C(C1CC(C(C(CO)O)(O1)O)O)=O,,,4,1,1,0,1
23344_0,,,,2,1,1,2
23345_0,,,,2,1,1,2
23347_0,,,,2,1,1,2
C1(COC(C(CO)CO)(C1O)O)=O,,,4,1,1,0,1
23349_0,,,,2,1,1,2
C(CO)(C1COC(CO)(C1O)O)=O,,,4,1,1,0,1
23350_0,,,,2,1,1,2
23352_0,,,,2,1,1,2
C(CO)(C1C(C(C(O1)O)CO)O)=O,,,4,1,1,0,1
23353_0,,,,2,1,1,2
23355_0,,,,2,1,1,2
C1C(C(CO)C(C(CO)O)(O)O1)O,,,4,1,1,0,1
23357_0,,,,2,1,1,2
C(C(C1C(C(C(O)O1)CO)O)O)O,,,4,1,1,0,1
23359_0,,,,2,1,1,2
C(CCO)(C1C(C(O)OC1)=O)=O,,,4,1,1,0,1
23361_0,,,,2,1,1,2
C(CC1C(C(O)OC1)=O)(CO)=O,,,4,1,1,0,1
23363_0,,,,2,1,1,2
C(C(C1COC(C1)(CO)O)=O)=O,,,4,1,1,0,1
23365_0,,,,2,1,1,2
C(C1(CC(C(CO)=O)CO1)O)=O,,,4,1,1,0,1
23366_0,,,,2,1,1,2
23367_0,,,,2,1,1,2
23368_0,,,,2,1,1,2
23370_0,,,,2,1,1,2
C(C1C(C(CCO)(O)OC1)=O)=O,,,4,1,1,0,1
23371_0,,,,2,1,1,2
23372_0,,,,2,1,1,2
23373_0,,,,2,1,1,2
23374_0,,,,2,1,1,2
23375_0,,,,2,1,1,2
23376_0,,,,2,1,1,2
23377_0,,,,2,1,1,2
23378_0,,,,2,1,1,2
23379_0,,,,2,1,1,2
23381_0,,,,2,1,1,2
C(C1COC(C1O)(CC=O)O)=O,,,4,1,1,0,1
23382_0,,,,2,1,1,2
23384_0,,,,2,1,1,2
C(C1C(CC(CCO)(O1)O)=O)=O,,,4,1,1,0,1
23386_0,,,,2,1,1,2
C(C(C(C1COC(C1)O)=O)O)=O,,,4,1,1,0,1
23388_0,,,,2,1,1,2
C(C1COC(C1)(C(C=O)O)O)=O,,,4,1,1,0,1
23389_0,,,,2,1,1,2
23391_0,,,,2,1,1,2
C(C(C)=O)(C1COC(C1O)O)=O,,,4,1,1,0,1
23393_0,,,,2,1,1,2
C1(C(C)(O)OCC1C(C=O)O)=O,,,4,1,1,0,1
23395_0,,,,2,1,1,2
C1(CC(C=O)OC1(CCO)O)=O,,,4,1,1,0,1
23397_0,,,,2,1,1,2
C(C(CC1(C(CCO1)=O)O)O)=O,,,4,1,1,0,1
23399_0,,,,2,1,1,2
C(CC(C1COC(C1O)O)=O)=O,,,4,1,1,0,1
23401_0,,,,2,1,1,2
C(C1C2C(C(C(CO)O2)(O)O1)O)O,,,4,1,1,0,1
23403_0,,,,2,1,1,2
C1(C2(C(CO)C(C(CO)O2)O1)O)O,,,4,1,1,0,1
23405_0,,,,2,1,1,2
C1C(C2C(C(C(O)O2)CO)(O)O1)O,,,4,1,2,0,2
23407_0,,,,2,1,1,2
C1(C2C(C(C(CCO)(O)O2)O1)O)O,,,4,1,1,0,1
23409_0,,,,2,1,1,2
C1(C(C2C(C(C(O)O2)CO)O1)O)O,,,4,1,1,0,1
23411_0,,,,2,1,1,2
C1C2C(C(C(C(O)O2)CO)(O)O1)O,,,4,1,2,0,2
23413_0,,,,2,1,1,2
C1C2C(CO)C(C(C(O)O2)O)(O)O1,,,4,1,1,0,1
23415_0,,,,2,1,1,2
C1C2C(C(C(C(CO)O1)(O)O2)O)O,,,4,1,1,0,1
23417_0,,,,2,1,1,2
C1C2C(C(CO)C(C(O)O1)(O)O2)O,,,4,1,1,0,1
23419_0,,,,2,1,1,2
C12C(C(CO)C(C(CO1)O)(O)O2)O,,,4,1,1,0,1
23421_0,,,,2,1,1,2
C1C(CO)C2(C(C(C(O1)O2)O)O)O,,,4,1,1,0,1
23423_0,,,,2,1,1,2
C1C2(C(CO)C(C(C(O)O1)O2)O)O,,,4,1,1,0,1
23425_0,,,,2,1,1,2
C1(C2C(CC(C(CO)O1)(O)O2)O)O,,,4,1,1,0,1
23427_0,,,,2,1,1,2
C1(C(C(CO)C(CCO)(O)O1)O)=O,,,4,1,1,0,1
23429_0,,,,2,1,1,2
C1(C(CC(C(CO)CO)(O)O1)O)=O,,,4,1,1,0,1
23431_0,,,,2,1,1,2
C(C1CC(CO)C(CO)(O1)O)(O)=O,,,4,1,1,0,1
23433_0,,,,2,1,1,2
C(C1CCC(C(CO)O)(O1)O)(O)=O,,,4,1,1,0,1
23435_0,,,,2,1,1,2
C(C1CC(C(CCO)(O1)O)O)(O)=O,,,4,1,1,0,1
23437_0,,,,2,1,1,2
C(C1(C(C(CO1)C(CO)O)=O)O)=O,,,4,1,1,0,1
23438_0,,,,2,1,1,2
23440_0,,,,2,1,1,2
C(C(C1(C(CO)C(CO1)O)O)=O)=O,,,4,1,1,0,1
23442_0,,,,2,1,1,2
C(C(CO)O)(C1C(C(O)OC1)=O)=O,,,4,1,1,0,1
23443_0,,,,2,1,1,2
23445_0,,,,2,1,1,2
C(C1(C(C(C(CO)=O)CO1)O)O)=O,,,4,1,1,0,1
23446_0,,,,2,1,1,2
23448_0,,,,2,1,1,2
C(C(C1C(C(CO)C(O1)O)O)=O)=O,,,4,1,1,0,1
23449_0,,,,2,1,1,2
23450_0,,,,2,1,1,2
23452_0,,,,2,1,1,2
C(C(C1C(C(C(O)O1)=O)CO)O)=O,,,4,1,1,0,1
23453_0,,,,2,1,1,2
23455_0,,,,2,1,1,2
C(C1C(C(CO)C(C=O)(O1)O)O)=O,,,4,1,1,0,1
23457_0,,,,2,1,1,2
C1(C(O)OC(CO)(C)C1CO)=O,,,4,1,1,0,1
23458_0,,,,2,1,1,2
23460_0,,,,2,1,1,2
C(C1(C(CO)C(CO1)(C)O)O)=O,,,4,1,1,0,1
23461_0,,,,2,1,1,2
23462_0,,,,2,1,1,2
23464_0,,,,2,1,1,2
C1(C(O)OC(C)C1CO)=O,,,4,1,1,0,1
23465_0,,,,2,1,1,2
23466_0,,,,2,1,1,2
23468_0,,,,2,1,1,2
C(C1C(C(C(O1)O)=O)CO)(CO)=O,,,4,1,1,0,1
23469_0,,,,2,1,1,2
23471_0,,,,2,1,1,2
C(C(C1COC(CO)(C1O)O)=O)=O,,,4,1,1,0,1
23473_0,,,,2,1,1,2
C(C1(CO)C(C(C(O1)O)=O)CO)=O,,,4,1,1,0,1
23474_0,,,,2,1,1,2
23476_0,,,,2,1,1,2
C(C(C1COC(C1(CO)O)O)=O)=O,,,4,1,1,0,1
23478_0,,,,2,1,1,2
C(C1(COC(C=O)(C1CO)O)O)=O,,,4,1,1,0,1
23479_0,,,,2,1,1,2
23481_0,,,,2,1,1,2
C(C1(CCO)C(C(C(O1)O)=O)O)=O,,,4,1,1,0,1
23482_0,,,,2,1,1,2
23484_0,,,,2,1,1,2
C(C1C(C(C(CCO)(O1)O)O)O)=O,,,4,1,1,0,1
23486_0,,,,2,1,1,2
C(C1C(C(CO)C(CO)(O1)O)O)=O,,,4,1,1,0,1
23488_0,,,,2,1,1,2
C1C(C)(C(C(CCO)(O)O1)O)O,,,4,1,1,0,1
23490_0,,,,2,1,1,2
C1C(C)(C(CO)C(CO)(O)O1)O,,,4,1,1,0,1
23492_0,,,,2,1,1,2
C1C(CCO)(CC(CO)(O)O1)O,,,4,1,1,0,1
23494_0,,,,2,1,1,2
CC1(C(C(CO1)(CCO)O)O)O,,,4,1,1,0,1
23496_0,,,,2,1,1,2
C1C(CC(O)O1)(CCO)O,,,4,1,1,0,1
23498_0,,,,2,1,1,2
C(C1(COC(C1O)(CCO)O)O)=O,,,4,1,1,0,1
23500_0,,,,2,1,1,2
C(CO)(C1COC(C1(CO)O)O)=O,,,4,1,1,0,1
23502_0,,,,2,1,1,2
C(C1(COC(CO)(C1CO)O)O)=O,,,4,1,1,0,1
23504_0,,,,2,1,1,2
C(C1(C(C(CO1)(CCO)O)O)O)=O,,,4,1,1,0,1
23506_0,,,,2,1,1,2
C1(C(O)OC(CO)(CCO)C1O)=O,,,4,1,1,0,1
23508_0,,,,2,1,1,2
C(C)(C(C1C(CC(O)O1)O)O)=O,,,4,1,1,0,1
23510_0,,,,2,1,1,2
C(CC1C(C(C(C)(O)O1)O)O)=O,,,4,1,1,0,1
23512_0,,,,2,1,1,2
C(C(C1C(C)(CC(O)O1)O)O)=O,,,4,1,1,0,1
23514_0,,,,2,1,1,2
C(CC1(C)C(C(C(O)O1)O)O)=O,,,4,1,1,0,1
23516_0,,,,2,1,1,2
C(C(C1C(OC(C=O)C1O)O)O)=O,,,4,1,1,0,1
23518_0,,,,2,1,1,2
C(C1C(C(C=O)O)OC(C1O)O)=O,,,4,1,1,0,1
23520_0,,,,2,1,1,2
C(C1C(CC(O1)O)O)=O,,,4,1,1,0,1
23522_0,,,,2,1,1,2
C(C1C(C(C(C=O)(O1)O)O)O)=O,,,4,1,1,0,1
23524_0,,,,2,1,1,2
C(C(C1C(C(C(O)O1)=O)O)O)=O,,,4,1,1,0,1
23526_0,,,,2,1,1,2
C(C(C1C(C(C(O1)O)O)O)=O)=O,,,4,1,1,0,1
23528_0,,,,2,1,1,2
C1C(C)(CC(CO)(O)O1)O,,,4,1,1,0,1
23530_0,,,,2,1,1,2
C1C(C)(C(C(C)(O)O1)O)O,,,4,1,1,0,1
23532_0,,,,2,1,1,2
C(CO)(CC1CC(C(O)O1)O)=O,,,4,1,1,0,1
23534_0,,,,2,1,1,2
C(C)(C(C1CC(C(O)O1)O)O)=O,,,4,1,1,0,1
23536_0,,,,2,1,1,2
C(C(C1C(O)OCC1(C)O)O)=O,,,4,1,1,0,1
23538_0,,,,2,1,1,2
C(C1C(C(O)OC1(C)CO)O)=O,,,4,1,1,0,1
23540_0,,,,2,1,1,2
C(CO)(CC1C(C(C(O)O1)O)O)=O,,,4,1,1,0,1
23542_0,,,,2,1,1,2
C(C(C1C(CC(CO)(O)O1)O)O)=O,,,4,1,1,0,1
23544_0,,,,2,1,1,2
C(C)(C(C1C(C(C(O)O1)O)O)O)=O,,,4,1,1,0,1
23546_0,,,,2,1,1,2
C(C(C1C(C(C(C)(O)O1)O)O)O)=O,,,4,1,1,0,1
23548_0,,,,2,1,1,2
C1C(C)(CC(O)O1)O,,,4,1,1,0,1
23550_0,,,,2,1,1,2
C(C1(COC(CO)(C1)O)O)=O,,,4,1,1,0,1
23552_0,,,,2,1,1,2
C(C1(COC(C)(C1O)O)O)=O,,,4,1,1,0,1
23554_0,,,,2,1,1,2
C(C1(C(C(CO1)(C)O)O)O)=O,,,4,1,1,0,1
23556_0,,,,2,1,1,2
C1(C(O)OC(CO)(C)C1O)=O,,,4,1,1,0,1
23558_0,,,,2,1,1,2
C1C(CC(CO)(O)O1)(C(CO)O)O,,,4,1,1,0,1
23560_0,,,,2,1,1,2
C(C1(CC(CO)(C(CO)O1)O)O)O,,,4,1,1,0,1
23562_0,,,,2,1,1,2
C1C(C(CO)O)(C(C(C)(O)O1)O)O,,,4,1,1,0,1
23564_0,,,,2,1,1,2
CC1(C(C(CO)(C(CO)O1)O)O)O,,,4,1,1,0,1
23566_0,,,,2,1,1,2
C1C(C)(C(C(C(CO)O)(O)O1)O)O,,,4,1,1,0,1
23568_0,,,,2,1,1,2
C(C1(C(CO)OC(CO)(C1)O)O)=O,,,4,1,1,0,1
23569_0,,,,2,1,1,2
23571_0,,,,2,1,1,2
C(C1(C(CO)OC(C)(C1O)O)O)=O,,,4,1,1,0,1
23572_0,,,,2,1,1,2
23574_0,,,,2,1,1,2
C(C1C(C)OC(C1O)O)=O,,,4,1,1,0,1
23575_0,,,,2,1,1,2
23576_0,,,,2,1,1,2
23578_0,,,,2,1,1,2
C(C1C(C(CO)(OC1C=O)O)O)=O,,,4,1,1,0,1
23580_0,,,,2,1,1,2
C(C1C(C(OC1C(CO)=O)O)O)=O,,,4,1,1,0,1
23582_0,,,,2,1,1,2
C(C1C(CO)(C(OC1C=O)O)O)=O,,,4,1,1,0,1
23584_0,,,,2,1,1,2
C(C1C(C(OC1(C=O)CO)O)O)=O,,,4,1,1,0,1
23586_0,,,,2,1,1,2
C(C1(COC(C1C(C=O)O)O)O)=O,,,4,1,1,0,1
23588_0,,,,2,1,1,2
C(CC1C(C(C(C=O)(O)O1)O)O)=O,,,4,1,1,0,1
23590_0,,,,2,1,1,2
C(C(C(C1C(CC(O)O1)O)O)=O)=O,,,4,1,1,0,1
23592_0,,,,2,1,1,2
C(CC(C1C(C(C(O)O1)=O)O)O)=O,,,4,1,1,0,1
23594_0,,,,2,1,1,2
C(C(C(C1CC(C(O)O1)O)O)=O)=O,,,4,1,1,0,1
23596_0,,,,2,1,1,2
C(C(CC1C(C(C(O)O1)=O)O)O)=O,,,4,1,1,0,1
23598_0,,,,2,1,1,2
C(C1(COC(C1)O)O)=O,,,4,1,1,0,1
23600_0,,,,2,1,1,2
C1(C(O)OC(C)C1O)=O,,,4,1,1,0,1
23602_0,,,,2,1,1,2
C1C(CC(O)O1)(C(CO)O)O,,,4,1,1,0,1
23604_0,,,,2,1,1,2
C(C1(CC(O)OC1CO)O)O,,,4,1,1,0,1
23606_0,,,,2,1,1,2
C(CC1C(CC(CCO)(O1)O)=O)=O,,,4,1,1,0,1
23608_0,,,,2,1,1,2
C(CC1(CCO)CC(C(O)O1)=O)=O,,,4,1,1,0,1
23610_0,,,,2,1,1,2
C(CCO)(C1C(C(O)OC1C)=O)=O,,,4,1,1,0,1
23612_0,,,,2,1,1,2
C(C1(CCC(CO)(O1)O)CC=O)=O,,,4,1,1,0,1
23614_0,,,,2,1,1,2
C(CC1(CO)CCC(C=O)(O)O1)=O,,,4,1,1,0,1
23616_0,,,,2,1,1,2
C(C(CCC1(COC(C1)O)O)=O)=O,,,4,1,1,0,1
23618_0,,,,2,1,1,2
C(CC1C(C(O)OC1C)=O)(CO)=O,,,4,1,1,0,1
23620_0,,,,2,1,1,2
C(C(C1C(C)OC(C1)(CO)O)=O)=O,,,4,1,1,0,1
23622_0,,,,2,1,1,2
C(C1(CC(C(CO)=O)C(C)O1)O)=O,,,4,1,1,0,1
23624_0,,,,2,1,1,2
C(C1(CC(C(C)(O1)O)O)CC=O)=O,,,4,1,1,0,1
23625_0,,,,2,1,1,2
23627_0,,,,2,1,1,2
C(CC1(C)C(CC(C=O)(O)O1)O)=O,,,4,1,1,0,1
23628_0,,,,2,1,1,2
23630_0,,,,2,1,1,2
C(C(CC1C(C)(CC(O)O1)O)=O)=O,,,4,1,1,0,1
23632_0,,,,2,1,1,2
C(C(C1C(C(O)OC1C)=O)O)(C)=O,,,4,1,1,0,1
23634_0,,,,2,1,1,2
C(C(C1C(C)OC(C)(C1O)O)=O)=O,,,4,1,1,0,1
23635_0,,,,2,1,1,2
23636_0,,,,2,1,1,2
23637_0,,,,2,1,1,2
23638_0,,,,2,1,1,2
23640_0,,,,2,1,1,2
C(CC(C1C(C(O)OC1C)=O)O)=O,,,4,1,1,0,1
23641_0,,,,2,1,1,2
23642_0,,,,2,1,1,2
23644_0,,,,2,1,1,2
C(CC1CC(C(CCO)(O)O1)=O)=O,,,4,1,1,0,1
23645_0,,,,2,1,1,2
23647_0,,,,2,1,1,2
C1(C(CCO)(CC=O)OC(C1)O)=O,,,4,1,1,0,1
23648_0,,,,2,1,1,2
23650_0,,,,2,1,1,2
C(C1C(C(CCO)(O)OC1C)=O)=O,,,4,1,1,0,1
23651_0,,,,2,1,1,2
23653_0,,,,2,1,1,2
C(CC1(C(C(CO)C(C)O1)=O)O)=O,,,4,1,1,0,1
23654_0,,,,2,1,1,2
23655_0,,,,2,1,1,2
23656_0,,,,2,1,1,2
23657_0,,,,2,1,1,2
23658_0,,,,2,1,1,2
23659_0,,,,2,1,1,2
23660_0,,,,2,1,1,2
23661_0,,,,2,1,1,2
23662_0,,,,2,1,1,2
23664_0,,,,2,1,1,2
C(CC(C1C(C)(CC(O1)O)O)=O)=O,,,4,1,1,0,1
23665_0,,,,2,1,1,2
23666_0,,,,2,1,1,2
23668_0,,,,2,1,1,2
C(CC1(C(CC(O)O1)O)CC=O)=O,,,4,1,1,0,1
23669_0,,,,2,1,1,2
23671_0,,,,2,1,1,2
C(CC1CC(C(CC=O)(O)O1)O)=O,,,4,1,1,0,1
23672_0,,,,2,1,1,2
23673_0,,,,2,1,1,2
23674_0,,,,2,1,1,2
23676_0,,,,2,1,1,2
C(C1C(C)OC(C1O)(CC=O)O)=O,,,4,1,1,0,1
23678_0,,,,2,1,1,2
C(C1C(CC(O1)O)O)(CC(C)=O)=O,,,4,1,1,0,1
23679_0,,,,2,1,1,2
23681_0,,,,2,1,1,2
C(C1C(CC(O1)O)(CC(C)=O)O)=O,,,4,1,1,0,1
23682_0,,,,2,1,1,2
23683_0,,,,2,1,1,2
23685_0,,,,2,1,1,2
C(C1C(CC(CC(C)O)(O1)O)=O)=O,,,4,1,1,0,1
23687_0,,,,2,1,1,2
C(CCC=O)(C1C(CC(O1)O)O)=O,,,4,1,1,0,1
23689_0,,,,2,1,1,2
C(CC1(CCC(O)O1)C(C=O)O)=O,,,4,1,1,0,1
23691_0,,,,2,1,1,2
C(CCC1(CC(OC1C=O)O)O)=O,,,4,1,1,0,1
23693_0,,,,2,1,1,2
C(CC1CCC(C(C=O)O)(O)O1)=O,,,4,1,1,0,1
23695_0,,,,2,1,1,2
C(C(C(C1C(C)OC(C1)O)=O)O)=O,,,4,1,1,0,1
23697_0,,,,2,1,1,2
C(C1C(C)OC(C1)(C(C=O)O)O)=O,,,4,1,1,0,1
23699_0,,,,2,1,1,2
C(CC1C(CC(C(C)=O)(O)O1)O)=O,,,4,1,1,0,1
23701_0,,,,2,1,1,2
C(C(C)=O)(CC1C(CC(O)O1)O)=O,,,4,1,1,0,1
23702_0,,,,2,1,1,2
23704_0,,,,2,1,1,2
C(C)(C1(CC(C(O1)O)O)CC=O)=O,,,4,1,1,0,1
23705_0,,,,2,1,1,2
23706_0,,,,2,1,1,2
23708_0,,,,2,1,1,2
C(C(C)=O)(C1C(C)OC(C1O)O)=O,,,4,1,1,0,1
23710_0,,,,2,1,1,2
C1(C(C)(O)OC(C)C1C(C=O)O)=O,,,4,1,1,0,1
23712_0,,,,2,1,1,2
C1(CC(C=O)OC1(CC(C)O)O)=O,,,4,1,1,0,1
23714_0,,,,2,1,1,2
C(C(CC1(C(CC(C)O1)=O)O)O)=O,,,4,1,1,0,1
23716_0,,,,2,1,1,2
C(CC1C(CC(CC=O)(O)O1)O)=O,,,4,1,1,0,1
23718_0,,,,2,1,1,2
C(CC(CC1C(CC(O)O1)O)=O)=O,,,4,1,1,0,1
23720_0,,,,2,1,1,2
C(CC1(CC(C(O)O1)O)CC=O)=O,,,4,1,1,0,1
23722_0,,,,2,1,1,2
C(CC(C1C(C)OC(C1O)O)=O)=O,,,4,1,1,0,1
23724_0,,,,2,1,1,2
C(CO)=CC(C1C(CC(O1)O)O)=O,,,4,1,1,0,1
23726_0,,,,2,1,1,2
C(C1C(C=CCO)(CC(O1)O)O)=O,,,4,1,1,0,1
23728_0,,,,2,1,1,2
C(C1(C(CO)OC(C1)O)O)=CC=O,,,4,1,1,0,1
23730_0,,,,2,1,1,2
C(CC1C(C(C(C=C)(O)O1)O)O)=O,,,4,1,1,0,1
23732_0,,,,2,1,1,2
C=CC(C(C1C(CC(O)O1)O)O)=O,,,4,1,1,0,1
23734_0,,,,2,1,1,2
C(CC1(C=C)C(C(C(O1)O)O)O)=O,,,4,1,1,0,1
23736_0,,,,2,1,1,2
C(C(C1C(C=C)(CC(O)O1)O)O)=O,,,4,1,1,0,1
23738_0,,,,2,1,1,2
C(C1C(CC(O1)O)O)=CC(CO)=O,,,4,1,1,0,1
23740_0,,,,2,1,1,2
C(C(C=CC1(COC(C1)O)O)O)=O,,,4,1,1,0,1
23742_0,,,,2,1,1,2
C(C(C1C(CC(O)O1)O)O)=CC=O,,,4,1,1,0,1
23744_0,,,,2,1,1,2
C(C1(C(CO)OC(C1)O)O)=O,,,4,1,1,0,1
23745_0,,,,2,1,1,2
23747_0,,,,2,1,1,2
C1(C(O)OC(C(CO)=O)C1O)=O,,,4,1,1,0,1
23749_0,,,,2,1,1,2
C(C1(CO)C(C(C(O1)O)=O)O)=O,,,4,1,1,0,1
23751_0,,,,2,1,1,2
C(C1(COC(C=O)(C1O)O)O)=O,,,4,1,1,0,1
23753_0,,,,2,1,1,2
C1C(CO)(C(C(O)O1)O)O,,,4,1,1,0,1
23755_0,,,,2,1,1,2
C1C(C(C(CO)(O)O1)O)O,,,4,1,1,0,1
23757_0,,,,2,1,1,2
C(C1C(C(C(O)O1)O)O)O,,,4,1,1,0,1
23759_0,,,,2,1,1,2
C(C1(CC(CO1)O)O)=O,,,4,1,1,0,1
23760_0,,,,2,1,1,2
23761_0,,,,2,1,1,2
23763_0,,,,2,1,1,2
C(CC1(COC(C1O)O)O)=O,,,4,1,1,0,1
23764_0,,,,2,1,1,2
23765_0,,,,2,1,1,2
23766_0,,,,2,1,1,2
23767_0,,,,2,1,1,2
23768_0,,,,2,1,1,2
23770_0,,,,2,1,1,2
CC1(C(CO)OC(C1O)O)O,,,4,1,1,0,1
23772_0,,,,2,1,1,2
C(C(C1(CO)CC(C(O)O1)O)O)=O,,,4,1,1,0,1
23774_0,,,,2,1,1,2
C(C(CC1(COC(C1O)O)O)O)=O,,,4,1,1,0,1
23776_0,,,,2,1,1,2
C(C(C1C(CO)(O)OCC1O)O)=O,,,4,1,1,0,1
23778_0,,,,2,1,1,2
C(CO)(C1C(CO)OC(C1O)O)=O,,,4,1,1,0,1
23780_0,,,,2,1,1,2
C(C(CC1(C(C(CO1)O)O)O)O)=O,,,4,1,1,0,1
23781_0,,,,2,1,1,2
23783_0,,,,2,1,1,2
C(C1(C(CO)C(CO1)O)O)=O,,,4,1,1,0,1
23785_0,,,,2,1,1,2
C1(C(O)OC(CO)C1CO)=O,,,4,1,1,0,1
23786_0,,,,2,1,1,2
23788_0,,,,2,1,1,2
C1C(CCO)(C(C(O)O1)O)O,,,4,1,1,0,1
23790_0,,,,2,1,1,2
C1C(C(CO)C(CO)(O)O1)O,,,4,1,1,0,1
23792_0,,,,2,1,1,2
C(C(C1(C)C(C(C(O)O1)O)O)O)=O,,,4,1,1,0,1
23794_0,,,,2,1,1,2
C(C(C1C(C)(C(C(O)O1)O)O)O)=O,,,4,1,1,0,1
23796_0,,,,2,1,1,2
C(C(C(C1(CC(CO1)O)O)O)O)=O,,,4,1,1,0,1
23798_0,,,,2,1,1,2
C(C1C(C(C(O1)O)O)O)=O,,,4,1,1,0,1
23800_0,,,,2,1,1,2
C1C(C)(C(C(O)O1)O)O,,,4,1,1,0,1
23802_0,,,,2,1,1,2
C1C(CC(CO)(O)O1)O,,,4,1,1,0,1
23804_0,,,,2,1,1,2
CC1(C(C(CO1)O)O)O,,,4,1,1,0,1
23806_0,,,,2,1,1,2
C(C(C1C(O)OCC1O)O)=O,,,4,1,1,0,1
23808_0,,,,2,1,1,2
C(C1C(CO)OC(C1O)O)=O,,,4,1,1,0,1
23810_0,,,,2,1,1,2
C(C(C1C(C(C(O)O1)O)O)O)=O,,,4,1,1,0,1
23812_0,,,,2,1,1,2
C1C(CC(O)O1)O,,,4,1,1,0,1
23814_0,,,,2,1,1,2
C(C1(COC(C1O)O)O)=O,,,4,1,1,0,1
23816_0,,,,2,1,1,2
C(C1(C(C(CO1)O)O)O)=O,,,4,1,1,0,1
23818_0,,,,2,1,1,2
C1(C(O)OC(CO)C1O)=O,,,4,1,1,0,1
23820_0,,,,2,1,1,2
C1C(C(C(O)O1)O)(C(CO)O)O,,,4,1,1,0,1
23822_0,,,,2,1,1,2
C1(C(C(CO)(C(CO)O1)O)O)O,,,4,1,1,0,1
23823_0,,,,2,1,1,2
23824_0,,,,2,1,1,2
23826_0,,,,2,1,1,2
C(C1(CC(C(C(CO)O)O1)O)O)=O,,,4,1,1,0,1
23828_0,,,,2,1,1,2
C1(C(O)OC(C(C(CO)O)O)C1)=O,,,4,1,1,0,1
23830_0,,,,2,1,1,2
C(C1(CC(C(C(CO)O)O1)O)O)O,,,4,1,1,0,1
23832_0,,,,2,1,1,2
CC1(C(C(C(C(CO)O)O1)O)O)O,,,4,1,1,0,1
23833_0,,,,2,1,1,2
23834_0,,,,2,1,1,2
23836_0,,,,2,1,1,2
C(C(C1(C(CO)C(CO1)O)O)O)=O,,,4,1,1,0,1
23838_0,,,,2,1,1,2
C(C(CO)O)(C1COC(C1O)O)=O,,,4,1,1,0,1
23840_0,,,,2,1,1,2
C(C(C1C(C(C(O)O1)CO)O)O)=O,,,4,1,1,0,1
23841_0,,,,2,1,1,2
23843_0,,,,2,1,1,2
C1(C(CCO)(CC(O)O1)O)=O,,,4,1,1,0,1
23845_0,,,,2,1,1,2
C(C1(C)CC(C(O1)O)O)(O)=O,,,4,1,1,0,1
23846_0,,,,2,1,1,2
23847_0,,,,2,1,1,2
23849_0,,,,2,1,1,2
C1(COC(C)(C1O)O)=O,,,4,1,1,0,1
23850_0,,,,2,1,1,2
23852_0,,,,2,1,1,2
C1CC(C(O)O1)O,,,4,1,1,0,1
23854_0,,,,2,1,1,2
C1(C(CC(CO)(O)O1)O)=O,,,4,1,1,0,1
23856_0,,,,2,1,1,2
C1(C(C(C(C)(O)O1)O)O)=O,,,4,1,1,0,1
23858_0,,,,2,1,1,2
C1(C(C(C(O)O1)O)O)=O,,,4,1,1,0,1
23860_0,,,,2,1,1,2
C1(CC(C(O)O1)O)=O,,,4,1,1,0,1
23861_0,,,,2,1,1,2
23863_0,,,,2,1,1,2
C(OC1C(C)(O)OCC1O)=O,,,4,1,1,0,1
23865_0,,,,2,1,1,2
C(OC1COC(C)(C1O)O)=O,,,4,1,1,0,1
23867_0,,,,2,1,1,2
C(OC1COC(CO)(C1)O)=O,,,4,1,1,0,1
23869_0,,,,2,1,1,2
C1(C(CC(C)(O)O1)O)=O,,,4,1,1,0,1
23871_0,,,,2,1,1,2
C1(C(CC(O)O1)O)=O,,,4,1,1,0,1
23872_0,,,,2,1,1,2
23874_0,,,,2,1,1,2
C(COC1(COC(C1)O)O)=O,,,4,1,1,0,1
23876_0,,,,2,1,1,2
C(C(O)OC1COC(C1O)O)=O,,,4,1,1,0,1
23878_0,,,,2,1,1,2
C(COC1CC(C(O)O1)O)=O,,,4,1,1,0,1
23880_0,,,,2,1,1,2
C1C2C(C(C(C2O)O)(O)O1)O,,,4,1,2,0,2
23880_1,,,,2,1,1,2
23882_0,,,,2,1,1,2
C(C1CC(C(O1)O)O)=O,,,4,1,1,0,1
23884_0,,,,2,1,1,2
C1(C(C)OC(C1O)O)=O,,,4,1,1,0,1
23885_0,,,,2,1,1,2
23886_0,,,,2,1,1,2
23887_0,,,,2,1,1,2
23888_0,,,,2,1,1,2
23890_0,,,,2,1,1,2
C1(C(CO)OC(C)(C1O)O)=O,,,4,1,1,0,1
23892_0,,,,2,1,1,2
C1(COC(C(C)O)(C1O)O)=O,,,4,1,1,0,1
23894_0,,,,2,1,1,2
C1(C(C)OC(CO)(C1O)O)=O,,,4,1,1,0,1
23896_0,,,,2,1,1,2
C1(C(C(C)O)OC(C1O)O)=O,,,4,1,1,0,1
23898_0,,,,2,1,1,2
C1(C(CO)(O)OC(CO)C1O)=O,,,4,1,1,0,1
23899_0,,,,2,1,1,2
23900_0,,,,2,1,1,2
23901_0,,,,2,1,1,2
23903_0,,,,2,1,1,2
CC(C1(C(C(CO1)O)O)O)O,,,4,1,1,0,1
23905_0,,,,2,1,1,2
C1(CC(C(C(CO)O)(O)O1)O)=O,,,4,1,1,0,1
23906_0,,,,2,1,1,2
23907_0,,,,2,1,1,2
23908_0,,,,2,1,1,2
23909_0,,,,2,1,1,2
23911_0,,,,2,1,1,2
C1(C(C(C(C(C)O)(O)O1)O)O)=O,,,4,1,1,0,1
23912_0,,,,2,1,1,2
23914_0,,,,2,1,1,2
C(C1CCC(C=O)(O1)O)=O,,,4,1,1,0,1
23916_0,,,,2,1,1,2
C1(CC(C=O)(OC1C)O)=O,,,4,1,1,0,1
23918_0,,,,2,1,1,2
C(C(C1CCC(O1)O)=O)=O,,,4,1,1,0,1
23919_0,,,,2,1,1,2
23921_0,,,,2,1,1,2
C1C(C2(C(C(CO2)O)O1)O)O,,,4,1,1,0,1
23923_0,,,,2,1,1,2
C1C(C2(C(C(CO2)O1)O)O)O,,,4,1,1,0,1
23925_0,,,,2,1,1,2
C1C(C2(C(CC(O2)O1)O)O)O,,,4,1,1,0,1
23927_0,,,,2,1,1,2
C1C2CC(C(C(O)O1)(O)O2)O,,,4,1,2,0,2
23929_0,,,,2,1,1,2
C1C2(C(CC(C(O)O1)O2)O)O,,,4,1,2,0,2
23931_0,,,,2,1,1,2
C1(C(CC(C(C)O)(O)O1)O)=O,,,4,1,1,0,1
23932_0,,,,2,1,1,2
23934_0,,,,2,1,1,2
C1(C(C(OC1CCO)O)=O)=O,,,4,1,1,0,1
23936_0,,,,2,1,1,2
C(C(C1(C(CCO1)O)O)=O)=O,,,4,1,2,0,2
23938_0,,,,2,1,1,2
C(C1C(CC(CO)(O1)O)=O)=O,,,4,1,1,0,1
23939_0,,,,2,1,1,2
23941_0,,,,2,1,1,2
C(C(C1CC(C(O1)O)O)=O)=O,,,4,1,2,0,2
23943_0,,,,2,1,1,2
C(C1CC(C(C=O)(O1)O)O)=O,,,4,1,1,0,1
23945_0,,,,2,1,1,2
C(C1C(C(C(C)(O1)O)O)=O)=O,,,4,1,1,0,1
23946_0,,,,2,1,1,2
23948_0,,,,2,1,1,2
C1(C(C(C=O)(OC1C)O)O)=O,,,4,1,1,0,1
23949_0,,,,2,1,1,2
23950_0,,,,2,1,1,2
23951_0,,,,2,1,1,2
23953_0,,,,2,1,1,2
C1C2CC(C(CO)(O)O2)(O)O1,,,4,1,2,0,2
23955_0,,,,2,1,1,2
C1C(C2C(C(C(O)O2)O)(O)O1)O,,,4,1,2,0,2
23957_0,,,,2,1,1,2
C1C2C(C(C(C(O)O2)O)(O)O1)O,,,4,1,2,0,2
23958_0,,,,2,1,1,2
23959_0,,,,2,1,1,2
23960_0,,,,2,1,1,2
23962_0,,,,2,1,1,2
C(CC1(C(CCO1)O)O)=O,,,4,1,1,0,1
23963_0,,,,2,1,1,2
23964_0,,,,2,1,1,2
23966_0,,,,2,1,1,2
C(C(C1(CCCO1)O)O)=O,,,4,1,1,0,1
23967_0,,,,2,1,1,2
23968_0,,,,2,1,1,2
23969_0,,,,2,1,1,2
23970_0,,,,2,1,1,2
23971_0,,,,2,1,1,2
23972_0,,,,2,1,1,2
23973_0,,,,2,1,1,2
23974_0,,,,2,1,1,2
23975_0,,,,2,1,1,2
23977_0,,,,2,1,1,2
C1(CC(C(CC=O)(O)O1)O)=O,,,4,1,1,0,1
23978_0,,,,2,1,1,2
23979_0,,,,2,1,1,2
23981_0,,,,2,1,1,2
C1(CCC(C(C=O)O)(O)O1)=O,,,4,1,1,0,1
23982_0,,,,2,1,1,2
23983_0,,,,2,1,1,2
23984_0,,,,2,1,1,2
23985_0,,,,2,1,1,2
23986_0,,,,2,1,1,2
23988_0,,,,2,1,1,2
C1(C(CC(C(CO)O)(O)O1)=O)=O,,,4,1,1,0,1
23989_0,,,,2,1,1,2
23991_0,,,,2,1,1,2
C1(C(C(C(CCO)(O)O1)O)=O)=O,,,4,1,1,0,1
23992_0,,,,2,1,1,2
23993_0,,,,2,1,1,2
23994_0,,,,2,1,1,2
23995_0,,,,2,1,1,2
23995_1,,,,2,1,1,2
23997_0,,,,2,1,1,2
C(C1(C2(CC(C(C1O)O2)O)O)O)O,,,4,1,1,0,1
23999_0,,,,2,1,1,2
C(C12C(O)OC(C(C1O)O)C2O)O,,,4,1,2,0,2
23999_1,,,,2,1,1,2
24001_0,,,,2,1,1,2
C1C(CO)(C(C(O)O1)(CO)O)O,,,4,1,1,0,1
24003_0,,,,2,1,1,2
C(C)(C1(C(O)OCC1(CO)O)O)=O,,,4,1,1,0,1
24005_0,,,,2,1,1,2
C(C1(C(C)(O)OCC1(CO)O)O)=O,,,4,1,1,0,1
24007_0,,,,2,1,1,2
C1C(CO)(C(CO)(C(C)(O)O1)O)O,,,4,1,1,0,1
24009_0,,,,2,1,1,2
C(C1(C(O)OCC1(CO)O)O)=O,,,4,1,1,0,1
24011_0,,,,2,1,1,2
C1(C(CO)(C(C(CO)O1)O)O)O,,,4,1,1,0,1
24012_0,,,,2,1,1,2
24013_0,,,,2,1,1,2
24015_0,,,,2,1,1,2
C(C1(CO)C(CO)(CC(O1)O)O)=O,,,4,1,1,0,1
24017_0,,,,2,1,1,2
C(CC1(COC(C1(CO)O)O)O)=O,,,4,1,1,0,1
24018_0,,,,2,1,1,2
24020_0,,,,2,1,1,2
C(C)(C1(C(O)OC(CO)C1O)O)=O,,,4,1,1,0,1
24022_0,,,,2,1,1,2
C(C1(C(C)(O)OC(CO)C1O)O)=O,,,4,1,1,0,1
24023_0,,,,2,1,1,2
24025_0,,,,2,1,1,2
C(C)(C1C(C(CO)(C(O1)O)O)O)=O,,,4,1,1,0,1
24027_0,,,,2,1,1,2
C(C1(CO)C(C)(C(C(O1)O)O)O)=O,,,4,1,1,0,1
24029_0,,,,2,1,1,2
C(C1C(C)(C(CO)(C(O1)O)O)O)=O,,,4,1,1,0,1
24031_0,,,,2,1,1,2
CC1(C(CO)(C(C(CO)O1)O)O)O,,,4,1,1,0,1
24033_0,,,,2,1,1,2
CC1(C(CO)OC(C1(CO)O)O)O,,,4,1,1,0,1
24035_0,,,,2,1,1,2
C(C1(COC(C1(CCO)O)O)O)=O,,,4,1,1,0,1
24036_0,,,,2,1,1,2
24038_0,,,,2,1,1,2
C1C(CCO)(C(C(O)O1)(CO)O)O,,,4,1,1,0,1
24040_0,,,,2,1,1,2
C(C1(C(O)OC(CO)C1O)O)=O,,,4,1,1,0,1
24042_0,,,,2,1,1,2
C(C1(CO)C(C(C(O1)O)O)O)=O,,,4,1,1,0,1
24044_0,,,,2,1,1,2
C(C1C(C(CO)(C(O1)O)O)O)=O,,,4,1,1,0,1
24046_0,,,,2,1,1,2
C1C(C)(C(C(O)O1)(CO)O)O,,,4,1,1,0,1
24047_0,,,,2,1,1,2
24049_0,,,,2,1,1,2
C(CC1C(C(C(O)O1)(CO)O)O)=O,,,4,1,1,0,1
24050_0,,,,2,1,1,2
24051_0,,,,2,1,1,2
24053_0,,,,2,1,1,2
C(C)(C1(COC(C)(C1O)O)O)=O,,,4,1,1,0,1
24055_0,,,,2,1,1,2
C(C)(C1(COC(C1(C)O)O)O)=O,,,4,1,1,0,1
24057_0,,,,2,1,1,2
C(C1(C(C(OC1C(C)=O)O)O)O)=O,,,4,1,1,0,1
24059_0,,,,2,1,1,2
C(C1(C(C(C)(OC1C=O)O)O)O)=O,,,4,1,1,0,1
24061_0,,,,2,1,1,2
C(C1(C(C(OC1(C=O)C)O)O)O)=O,,,4,1,1,0,1
24063_0,,,,2,1,1,2
C(C1(C(C(OC1C=O)O)(C)O)O)=O,,,4,1,1,0,1
24065_0,,,,2,1,1,2
C(CO)(C1(COC(C)(C1O)O)O)=O,,,4,1,1,0,1
24067_0,,,,2,1,1,2
C(CO)(C1(COC(C1(C)O)O)O)=O,,,4,1,1,0,1
24068_0,,,,2,1,1,2
24070_0,,,,2,1,1,2
C(C(C1(COC(C)(C1O)O)O)=O)=O,,,4,1,1,0,1
24071_0,,,,2,1,1,2
24073_0,,,,2,1,1,2
C(C1(C)C(C(C(O1)O)=O)(CO)O)=O,,,4,1,1,0,1
24075_0,,,,2,1,1,2
C(C(C1(COC(C1(C)O)O)O)=O)=O,,,4,1,1,0,1
24076_0,,,,2,1,1,2
24078_0,,,,2,1,1,2
C(C1(C=O)C(CC(CO)(O1)O)O)=O,,,4,1,1,0,1
24079_0,,,,2,1,1,2
24081_0,,,,2,1,1,2
C(C1(C(O)OCC1(CC=O)O)O)=O,,,4,1,1,0,1
24083_0,,,,2,1,1,2
C(C1(C=O)C(CO)(CC(O1)O)O)=O,,,4,1,1,0,1
24085_0,,,,2,1,1,2
C(C1(C(OC(C(C)=O)C1O)O)O)=O,,,4,1,1,0,1
24087_0,,,,2,1,1,2
C(C1(C=O)C(C(C(C)(O1)O)O)O)=O,,,4,1,1,0,1
24089_0,,,,2,1,1,2
C(C1(C(OC(C=O)C1(C)O)O)O)=O,,,4,1,1,0,1
24091_0,,,,2,1,1,2
C(C1(C=O)C(C)(C(C(O1)O)O)O)=O,,,4,1,1,0,1
24093_0,,,,2,1,1,2
C(C1(C(C)=O)C(C(C(O1)O)O)O)=O,,,4,1,1,0,1
24095_0,,,,2,1,1,2
C(C1C(C(C(C)=O)(C(O1)O)O)O)=O,,,4,1,1,0,1
24097_0,,,,2,1,1,2
C(C1(C(C(C=O)OC1(C)O)O)O)=O,,,4,1,1,0,1
24099_0,,,,2,1,1,2
C(C)(C1(C(O)OCC1(C)O)O)=O,,,4,1,1,0,1
24101_0,,,,2,1,1,2
C(C1(C(C)(O)OCC1(C)O)O)=O,,,4,1,1,0,1
24103_0,,,,2,1,1,2
C(C1(COC(C1(C(C)=O)O)O)O)=O,,,4,1,1,0,1
24105_0,,,,2,1,1,2
C(C1(C(C)(O)OCC1(C=O)O)O)=O,,,4,1,1,0,1
24107_0,,,,2,1,1,2
C(C)(C1(C(C(OC1C=O)O)O)O)=O,,,4,1,1,0,1
24109_0,,,,2,1,1,2
C(C1(C(C(OC1C=O)O)O)O)=O,,,4,1,1,0,1
24111_0,,,,2,1,1,2
C(CO)(C1(COC(C1O)O)O)=O,,,4,1,1,0,1
24113_0,,,,2,1,1,2
C1(C(C(CO)O)(C(C(O)O1)O)O)=O,,,4,1,1,0,1
24115_0,,,,2,1,1,2
C(C1(C(CO)OC(C1O)O)O)(O)=O,,,4,1,1,0,1
24117_0,,,,2,1,1,2
C1(C(OC(C=O)C1(CO)O)O)=O,,,4,1,1,0,1
24119_0,,,,2,1,1,2
C(C(C1(COC(C1O)O)O)=O)=O,,,4,1,1,0,1
24120_0,,,,2,1,1,2
24122_0,,,,2,1,1,2
C(C1(C(O)OC(CO)C1(C)O)O)=O,,,4,1,1,0,1
24123_0,,,,2,1,1,2
24125_0,,,,2,1,1,2
C(C1C(C(CO)(C(C)(O1)O)O)O)=O,,,4,1,1,0,1
24127_0,,,,2,1,1,2
C1C(C)(C(CO)(C(C)(O)O1)O)O,,,4,1,1,0,1
24129_0,,,,2,1,1,2
C(C)(C1(COC(CO)(C1O)O)O)=O,,,4,1,1,0,1
24131_0,,,,2,1,1,2
C(C)(C1(COC(C1(CO)O)O)O)=O,,,4,1,1,0,1
24133_0,,,,2,1,1,2
C(C1(COC(C)(C1(CO)O)O)O)=O,,,4,1,1,0,1
24135_0,,,,2,1,1,2
C1(COC(C(CO)(CO)O)(C1)O)=O,,,4,1,1,0,1
24136_0,,,,2,1,1,2
24137_0,,,,2,1,1,2
24138_0,,,,2,1,1,2
24139_0,,,,2,1,1,2
24141_0,,,,2,1,1,2
C(C1(COC(C1O)(C(C)O)O)O)=O,,,4,1,1,0,1
24143_0,,,,2,1,1,2
C(C(C)O)(C1(COC(C1O)O)O)=O,,,4,1,1,0,1
24144_0,,,,2,1,1,2
24146_0,,,,2,1,1,2
C1C(C(CO)(C(CCO)(O)O1)O)O,,,4,1,1,0,1
24147_0,,,,2,1,1,2
24149_0,,,,2,1,1,2
C1(C(CO)(C(C(CCO)O1)O)O)O,,,4,1,1,0,1
24150_0,,,,2,1,1,2
24151_0,,,,2,1,1,2
24153_0,,,,2,1,1,2
C1C2(C(CO)(C(C(CO)O2)O1)O)O,,,4,1,1,0,1
24155_0,,,,2,1,1,2
C1C(C2(CO)C(CC(O)O2)(O)O1)O,,,4,1,1,0,1
24157_0,,,,2,1,1,2
CC1(C2(CO)C(C(C(O)O2)O1)O)O,,,4,1,1,0,1
24159_0,,,,2,1,1,2
C1C2C(CO)(C(CC(O)O2)(O)O1)O,,,4,1,1,0,1
24161_0,,,,2,1,1,2
C1C2CC(C(C(O)O2)(CO)O)(O)O1,,,4,1,2,0,2
24163_0,,,,2,1,1,2
C1C2(C(CO)(C(C(CO1)O2)O)O)O,,,4,1,1,0,1
24165_0,,,,2,1,1,2
C12C(CC(C(CO1)(CO)O)(O)O2)O,,,4,1,1,0,1
24167_0,,,,2,1,1,2
C12C(C(CO)(C(CCO1)(O)O2)O)O,,,4,1,1,0,1
24168_0,,,,2,1,1,2
24170_0,,,,2,1,1,2
C(CCO)(C1(C(C(O)OC1)=O)O)=O,,,4,1,1,0,1
24172_0,,,,2,1,1,2
C(C1(C(C(C(C)=O)(CO1)O)O)O)=O,,,4,1,1,0,1
24173_0,,,,2,1,1,2
24174_0,,,,2,1,1,2
24175_0,,,,2,1,1,2
24176_0,,,,2,1,1,2
24178_0,,,,2,1,1,2
C(C1(COC(C=C)(C1O)O)O)=O,,,4,1,1,0,1
24180_0,,,,2,1,1,2
C=CC(C1(COC(C1O)O)O)=O,,,4,1,1,0,1
24182_0,,,,2,1,1,2
CC1(C2C(C(C(O)O2)(CO)O1)O)O,,,4,1,1,0,1
24184_0,,,,2,1,1,2
C1(C(CO)(C2C(CC(O)O2)O1)O)O,,,4,1,1,0,1
24186_0,,,,2,1,1,2
C1(C2(CO)C(C(CC(O)O2)O1)O)O,,,4,1,1,0,1
24187_0,,,,2,1,1,2
24188_0,,,,2,1,1,2
24190_0,,,,2,1,1,2
C(C1(C(O)OCC1(CCO)O)O)=O,,,4,1,1,0,1
24192_0,,,,2,1,1,2
C(C1(C(C)OC(C)(C1O)O)O)=O,,,4,1,1,0,1
24194_0,,,,2,1,1,2
C(C)(C1(C(C)OC(C1O)O)O)=O,,,4,1,1,0,1
24196_0,,,,2,1,1,2
C(C1(C(OC(C=O)C1O)O)O)=O,,,4,1,1,0,1
24198_0,,,,2,1,1,2
C(C1(C=O)C(C(C(O1)O)O)O)=O,,,4,1,1,0,1
24199_0,,,,2,1,1,2
24201_0,,,,2,1,1,2
C(C(C=O)(C1C(CC(O)O1)O)O)=O,,,4,1,1,0,1
24203_0,,,,2,1,1,2
C(C1(C(O)OC(C1O)CC=O)O)=O,,,4,1,1,0,1
24205_0,,,,2,1,1,2
C(C(C=O)(C1CC(C(O)O1)O)O)=O,,,4,1,1,0,1
24207_0,,,,2,1,1,2
C(C1(C(O)OCC1(C=O)O)O)=O,,,4,1,1,0,1
24209_0,,,,2,1,1,2
C(C(C1(C(O)OCC1(C)O)O)O)=O,,,4,1,1,0,1
24211_0,,,,2,1,1,2
C(C1(C(C(O)OC1(CO)C)O)O)=O,,,4,1,1,0,1
24213_0,,,,2,1,1,2
C1C(C)(C(CO)(C(CO)(O)O1)O)O,,,4,1,1,0,1
24215_0,,,,2,1,1,2
C(C1(C(CO)(C(CO1)(C)O)O)O)=O,,,4,1,1,0,1
24217_0,,,,2,1,1,2
C1(C(O)OC(CO)(C)C1(CO)O)=O,,,4,1,1,0,1
24218_0,,,,2,1,1,2
24220_0,,,,2,1,1,2
C(C1(C(C)OC(C1O)O)O)=O,,,4,1,1,0,1
24221_0,,,,2,1,1,2
24222_0,,,,2,1,1,2
24224_0,,,,2,1,1,2
C(C1(C(C(C=C)(O)OC1C)O)O)=O,,,4,1,1,0,1
24226_0,,,,2,1,1,2
C=CC(C1(C(C)OC(C1O)O)O)=O,,,4,1,1,0,1
24228_0,,,,2,1,1,2
C1(C(O)OC(C)C1(CO)O)=O,,,4,1,1,0,1
24229_0,,,,2,1,1,2
24231_0,,,,2,1,1,2
C1C(C(C(O)O1)(CO)O)O,,,4,1,1,0,1
24232_0,,,,2,1,1,2
24233_0,,,,2,1,1,2
24235_0,,,,2,1,1,2
C1C(C(CO)(C(C)(O)O1)O)O,,,4,1,1,0,1
24237_0,,,,2,1,1,2
C(C(C1(C(C)(O)OCC1O)O)O)=O,,,4,1,1,0,1
24239_0,,,,2,1,1,2
C(C)(C1(C(CO)OC(C1O)O)O)=O,,,4,1,1,0,1
24241_0,,,,2,1,1,2
C(C1(C(O)OCC1O)O)=O,,,4,1,1,0,1
24243_0,,,,2,1,1,2
C1C(C(CO)(C(CO)(O)O1)O)O,,,4,1,1,0,1
24245_0,,,,2,1,1,2
C(C1(C(CO)(C(CO1)O)O)O)=O,,,4,1,1,0,1
24247_0,,,,2,1,1,2
C1(C(O)OC(CO)C1(CO)O)=O,,,4,1,1,0,1
24248_0,,,,2,1,1,2
24250_0,,,,2,1,1,2
C(C1(C(CO)OC(C1(C)O)O)O)=O,,,4,1,1,0,1
24251_0,,,,2,1,1,2
24253_0,,,,2,1,1,2
CC(CO)(C1(C(O)OCC1O)O)O,,,4,1,1,0,1
24255_0,,,,2,1,1,2
C1C(C)(C(C(O)O1)(C(CO)O)O)O,,,4,1,1,0,1
24257_0,,,,2,1,1,2
C1C(C(C(O)O1)(C(C)O)O)O,,,4,1,1,0,1
24258_0,,,,2,1,1,2
24260_0,,,,2,1,1,2
C(CC1(C(CO)(C(CO1)O)O)O)=O,,,4,1,1,0,1
24261_0,,,,2,1,1,2
24263_0,,,,2,1,1,2
C(CCO)(C1(COC(C1O)O)O)=O,,,4,1,1,0,1
24265_0,,,,2,1,1,2
C1(C2(CC(C(C2O)O1)O)O)O,,,4,1,2,0,2
24265_1,,,,2,1,1,2
24267_0,,,,2,1,1,2
C1(C2(CC(C(C2O)O)O1)O)O,,,4,1,2,0,2
24267_1,,,,2,1,1,2
24269_0,,,,2,1,1,2
C(CC1(C(O)OCC1(CO)O)O)=O,,,4,1,1,0,1
24271_0,,,,2,1,1,2
C(C1(CC(O)OC1(CO)CO)O)=O,,,4,1,1,0,1
24273_0,,,,2,1,1,2
C(CC1(C(O)OC(CO)C1O)O)=O,,,4,1,1,0,1
24275_0,,,,2,1,1,2
C(C1(CC(O)OC1C(CO)O)O)=O,,,4,1,1,0,1
24277_0,,,,2,1,1,2
C(C1(CC(OC1C(C)=O)O)O)=O,,,4,1,1,0,1
24279_0,,,,2,1,1,2
C(C1(CC(OC1(C=O)C)O)O)=O,,,4,1,1,0,1
24281_0,,,,2,1,1,2
C1(C(C(C)(C(O)O1)O)O)=O,,,4,1,1,0,1
24283_0,,,,2,1,1,2
C1(C(CCO)(C(C(C)(O)O1)O)O)=O,,,4,1,1,0,1
24285_0,,,,2,1,1,2
C1(C(CCO)(C(C)(C(O)O1)O)O)=O,,,4,1,1,0,1
24286_0,,,,2,1,1,2
24288_0,,,,2,1,1,2
C(C1C(CO)(CC(O1)O)O)(O)=O,,,4,1,1,0,1
24290_0,,,,2,1,1,2
C(C1C(C)(C(C(O1)O)O)O)(O)=O,,,4,1,1,0,1
24292_0,,,,2,1,1,2
C(C1(CC(CO)(OC1C=O)O)O)=O,,,4,1,1,0,1
24294_0,,,,2,1,1,2
C(C1(CC(OC1C=O)O)O)=O,,,4,1,1,0,1
24296_0,,,,2,1,1,2
C1(C(C(C(O)O1)O)(CCO)O)=O,,,4,1,1,0,1
24298_0,,,,2,1,1,2
C(C1(C(C)OC(CO)(C1)O)O)=O,,,4,1,1,0,1
24300_0,,,,2,1,1,2
C(C(CO)O)(C1(COC(C1)O)O)=O,,,4,1,1,0,1
24302_0,,,,2,1,1,2
C1(C(O)OCC1(CC(CO)O)O)=O,,,4,1,1,0,1
24304_0,,,,2,1,1,2
C(C1(C(CO)(CC(CO)O1)O)O)=O,,,4,1,1,0,1
24305_0,,,,2,1,1,2
24307_0,,,,2,1,1,2
C(CO)(C1CC(C(O1)O)(CO)O)=O,,,4,1,1,0,1
24309_0,,,,2,1,1,2
C(C1CC(CO)(C(CO)(O1)O)O)=O,,,4,1,1,0,1
24310_0,,,,2,1,1,2
24311_0,,,,2,1,1,2
24313_0,,,,2,1,1,2
C(C(C1(C(CO)(CCO1)O)O)O)=O,,,4,1,1,0,1
24315_0,,,,2,1,1,2
C(CO)(C1(COC(CO)(C1)O)O)=O,,,4,1,1,0,1
24317_0,,,,2,1,1,2
C(C(C1CC(C(O)O1)(CO)O)O)=O,,,4,1,1,0,1
24319_0,,,,2,1,1,2
C(C1(CC(C(C)=O)(CO1)O)O)=O,,,4,1,1,0,1
24320_0,,,,2,1,1,2
24322_0,,,,2,1,1,2
C(CC(C1(COC(C1)O)O)=O)=O,,,4,1,1,0,1
24323_0,,,,2,1,1,2
24325_0,,,,2,1,1,2
C(C1(COC(C(C)=O)(C1)O)O)=O,,,4,1,1,0,1
24326_0,,,,2,1,1,2
24328_0,,,,2,1,1,2
C(C1(COC(C1)(CC=O)O)O)=O,,,4,1,1,0,1
24330_0,,,,2,1,1,2
C(C1(C2(CC(C(CO)O2)O1)O)O)O,,,4,1,1,0,1
24332_0,,,,2,1,1,2
C1C2C(CC(C(CO)(O)O1)(O)O2)O,,,4,1,1,0,1
24334_0,,,,2,1,1,2
C(C1(COC(C1)(CCO)O)O)(O)=O,,,4,1,1,0,1
24335_0,,,,2,1,1,2
24336_0,,,,2,1,1,2
24337_0,,,,2,1,1,2
24339_0,,,,2,1,1,2
C(C1CC(CO)(C(C)(O1)O)O)(O)=O,,,4,1,1,0,1
24341_0,,,,2,1,1,2
C(CC1(C(C(O)OC1)=O)O)(CO)=O,,,4,1,1,0,1
24343_0,,,,2,1,1,2
C(C(C1(COC(CO)(C1)O)O)=O)=O,,,4,1,1,0,1
24345_0,,,,2,1,1,2
C(C(C1CC(C(O)O1)(CO)O)O)O,,,4,1,1,0,1
24346_0,,,,2,1,1,2
24348_0,,,,2,1,1,2
C1(C(C(C(O)O1)(CCO)O)O)=O,,,4,1,1,0,1
24350_0,,,,2,1,1,2
C(CC1(C(C(C=O)OC1O)O)O)=O,,,4,1,1,0,1
24352_0,,,,2,1,1,2
C(C1(C(C(C=O)O)OC(C1)O)O)=O,,,4,1,1,0,1
24354_0,,,,2,1,1,2
C(C1(C(C(C(O1)O)O)O)CC=O)=O,,,4,1,1,0,1
24356_0,,,,2,1,1,2
C(C1C(C(C(O1)O)O)O)(O)=O,,,4,1,1,0,1
24358_0,,,,2,1,1,2
C(CC1(C(O)OCC1(C)O)O)=O,,,4,1,1,0,1
24360_0,,,,2,1,1,2
C(C1(CC(O)OC1(CO)C)O)=O,,,4,1,1,0,1
24362_0,,,,2,1,1,2
C(C1(C(C)OC(C1)O)O)=O,,,4,1,1,0,1
24364_0,,,,2,1,1,2
C(C1(CC(OC1C(CO)=O)O)O)=O,,,4,1,1,0,1
24366_0,,,,2,1,1,2
C(C1(CC(OC1(C=O)CO)O)O)=O,,,4,1,1,0,1
24368_0,,,,2,1,1,2
C(C1(COC(C1(CC=O)O)O)O)=O,,,4,1,1,0,1
24370_0,,,,2,1,1,2
C(C(C1C(C(C(O)O1)O)O)O)(O)=O,,,4,1,1,0,1
24372_0,,,,2,1,1,2
C(C1(CC(C(C)=O)(C(C)O1)O)O)=O,,,4,1,1,0,1
24373_0,,,,2,1,1,2
24375_0,,,,2,1,1,2
C(CC(C1(C(C)OC(C1)O)O)=O)=O,,,4,1,1,0,1
24376_0,,,,2,1,1,2
24378_0,,,,2,1,1,2
C(C1(CC(C(C)=O)(O)OC1C)O)=O,,,4,1,1,0,1
24379_0,,,,2,1,1,2
24381_0,,,,2,1,1,2
C(C1(C(C)OC(C1)(CC=O)O)O)=O,,,4,1,1,0,1
24383_0,,,,2,1,1,2
C1(C(C(C(CO)(O)O1)O)O)=O,,,4,1,1,0,1
24385_0,,,,2,1,1,2
C1(C(C(CO)(C(O)O1)O)O)=O,,,4,1,1,0,1
24387_0,,,,2,1,1,2
C1(C(C(C(C(CO)O)(O)O1)O)O)=O,,,4,1,1,0,1
24389_0,,,,2,1,1,2
C1(C(C(C(O)O1)(C(CO)O)O)O)=O,,,4,1,1,0,1
24390_0,,,,2,1,1,2
24392_0,,,,2,1,1,2
C(CO)(OC1C(O)OCC1O)=O,,,4,1,1,0,1
24394_0,,,,2,1,1,2
C(CO)(OC1COC(C1O)O)=O,,,4,1,1,0,1
24396_0,,,,2,1,1,2
C1(C(C2(CC1CO2)O)O)=O,,,4,1,2,0,2
24396_1,,,,2,1,1,2
24398_0,,,,2,1,1,2
C1(C(C)(O)OC(CO)C1O)=O,,,4,1,1,0,1
24399_0,,,,2,1,1,2
24401_0,,,,2,1,1,2
C1(CC2(CC1(CO2)O)O)=O,,,4,1,2,0,2
24401_1,,,,2,1,1,2
24402_0,,,,2,1,1,2
24403_0,,,,2,1,1,2
24404_0,,,,2,1,1,2
24405_0,,,,2,1,1,2
24406_0,,,,2,1,1,2
24407_0,,,,2,1,1,2
24408_0,,,,2,1,1,2
24409_0,,,,2,1,1,2
24411_0,,,,2,1,1,2
C1(C2C(C(C(CO)O2)O1)O)O,,,4,1,1,0,1
24413_0,,,,2,1,1,2
C1C2C(C(C(CO)O2)(O)O1)O,,,4,1,1,0,1
24414_0,,,,2,1,1,2
24416_0,,,,2,1,1,2
C1C2(CC(C(CO)O2)(O)O1)O,,,4,1,2,0,2
24418_0,,,,2,1,1,2
C(C1(C2CC(CO2)O1)O)=O,,,4,1,1,0,1
24420_0,,,,2,1,1,2
C(C1C2CC(C(O)O2)O1)=O,,,4,1,1,0,1
24422_0,,,,2,1,1,2
C1(C(O)OC2CC(OC12)O)=O,,,4,1,2,0,2
24423_0,,,,2,1,1,2
24425_0,,,,2,1,1,2
C(C1C2(C(C(CO2)O1)O)O)=O,,,4,1,1,0,1
24427_0,,,,2,1,1,2
C(C1(C2(CC(CO2)O1)O)O)=O,,,4,1,2,0,2
24429_0,,,,2,1,1,2
C1C(C2C(C(C(O)O2)O1)O)O,,,4,1,1,0,1
24431_0,,,,2,1,1,2
C1C2(CC(C(CO2)O)(O)O1)O,,,4,1,2,0,2
24433_0,,,,2,1,1,2
C1C2(C(C(CCO2)(O)O1)O)O,,,4,1,2,0,2
24435_0,,,,2,1,1,2
C1(C(O)OC2COC1(C2)O)=O,,,4,1,2,0,2
24436_0,,,,2,1,1,2
24437_0,,,,2,1,1,2
24438_0,,,,2,1,1,2
24440_0,,,,2,1,1,2
C1(C2OCC(C(C1)(O2)O)O)=O,,,4,1,1,0,1
24442_0,,,,2,1,1,2
C1(C2OCCC(C1O)(O2)O)=O,,,4,1,1,0,1
24444_0,,,,2,1,1,2
C1(C2(CC(C(CO)O2)O1)O)=O,,,4,1,2,0,2
24446_0,,,,2,1,1,2
C1(CC2(C(C(CO2)O)O1)O)=O,,,4,1,2,0,2
24448_0,,,,2,1,1,2
C1(C2C(C(C(C)(O2)O)O1)O)=O,,,4,1,2,0,2
24450_0,,,,2,1,1,2
C1(C(C2C(CC(O)O2)O1)O)=O,,,4,1,2,0,2
24452_0,,,,2,1,1,2
C1(C2CC(C(C)(O2)O)O1)=O,,,4,1,2,0,2
24454_0,,,,2,1,1,2
C1(CC2(C(C(CO2)O1)O)O)=O,,,4,1,2,0,2
24456_0,,,,2,1,1,2
C1(C(C2(CC(CO2)O1)O)O)=O,,,4,1,2,0,2
24458_0,,,,2,1,1,2
C1(C2(CC(C(CO1)O2)O)O)=O,,,4,1,2,0,2
24460_0,,,,2,1,1,2
C1(C2C(CC(CO1)(O2)O)O)=O,,,4,1,2,0,2
24462_0,,,,2,1,1,2
C1(C2CCC(CO1)(O2)O)=O,,,4,1,2,0,2
24464_0,,,,2,1,1,2
C(C1CCC(CO)(O1)O)=O,,,4,1,1,0,1
24466_0,,,,2,1,1,2
C(C1CC(C(C)(O1)O)O)=O,,,4,1,1,0,1
24467_0,,,,2,1,1,2
24468_0,,,,2,1,1,2
24469_0,,,,2,1,1,2
24470_0,,,,2,1,1,2
24471_0,,,,2,1,1,2
24472_0,,,,2,1,1,2
24473_0,,,,2,1,1,2
24474_0,,,,2,1,1,2
24475_0,,,,2,1,1,2
24476_0,,,,2,1,1,2
24478_0,,,,2,1,1,2
C1(C2CC(C(CO)(O)O2)O1)O,,,4,1,2,0,2
24479_0,,,,2,1,1,2
24481_0,,,,2,1,1,2
C1CC2C(C(C(O)O2)O)(O)O1,,,4,1,2,0,2
24482_0,,,,2,1,1,2
24483_0,,,,2,1,1,2
24484_0,,,,2,1,1,2
24485_0,,,,2,1,1,2
24487_0,,,,2,1,1,2
C1(C2CC(C(C(O)O2)O)O1)O,,,4,1,2,0,2
24489_0,,,,2,1,1,2
C1(CC2C(C(C(O)O2)O)O1)=O,,,4,1,2,0,2
24491_0,,,,2,1,1,2
C1(C2(C(C(C(CO)O2)O1)O)O)=O,,,4,1,2,0,2
24493_0,,,,2,1,1,2
C1(CC2C(C(C(O)O2)O1)O)=O,,,4,1,2,0,2
24495_0,,,,2,1,1,2
C1(C2(C(C(C(CO1)O2)O)O)O)=O,,,4,1,2,0,2
24497_0,,,,2,1,1,2
C(C(CC1C(CO)OC(C1)O)=O)=O,,,4,1,1,0,1
24499_0,,,,2,1,1,2
C(CC1CC(C=O)(O)OC1CO)=O,,,4,1,1,0,1
24501_0,,,,2,1,1,2
C(C(C(CC1COC(C1)O)=O)O)=O,,,4,1,1,0,1
24503_0,,,,2,1,1,2
C(CC1COC(C1)(C(C=O)O)O)=O,,,4,1,1,0,1
24505_0,,,,2,1,1,2
C(C1C(CC(O1)O)CC(CO)=O)=O,,,4,1,1,0,1
24507_0,,,,2,1,1,2
C(CC1CC(CO)(OC1C=O)O)=O,,,4,1,1,0,1
24509_0,,,,2,1,1,2
C(CC1C(C(C=O)O)OC(C1)O)=O,,,4,1,1,0,1
24511_0,,,,2,1,1,2
C1(COC(C(C)(C1O)O)O)=O,,,4,1,1,0,1
24513_0,,,,2,1,1,2
C1(C(O)OCC(CO)(C1)O)=O,,,4,1,1,0,1
24515_0,,,,2,1,1,2
C1(C(C(CO)(CO)OC(C1)O)O)=O,,,4,1,1,0,1
24517_0,,,,2,1,1,2
C1(C(C(O)OC(CO)(CO)C1)O)=O,,,4,1,1,0,1
24519_0,,,,2,1,1,2
C1(COC(C(C1O)O)O)=O,,,4,1,1,0,1
24521_0,,,,2,1,1,2
CC1(C(COC(CO)(C1O)O)O)O,,,4,1,1,0,1
24523_0,,,,2,1,1,2
C1(COC(C(C1O)O)(CCO)O)=O,,,4,1,1,0,1
24525_0,,,,2,1,1,2
C1(COC(C(CCO)(C1O)O)O)=O,,,4,1,1,0,1
24527_0,,,,2,1,1,2
C(C1(CCOC(CO)(C1O)O)O)=O,,,4,1,1,0,1
24529_0,,,,2,1,1,2
C1(C(O)OCC(CO)(C1CO)O)=O,,,4,1,1,0,1
24531_0,,,,2,1,1,2
C1CC(CO)(C(C(CO)(O)O1)O)O,,,4,1,1,0,1
24533_0,,,,2,1,1,2
C(CO)(C1C(C(CC(O1)O)O)O)=O,,,4,1,1,0,1
24535_0,,,,2,1,1,2
C(CO)(C1C(CC(C(O1)O)O)O)=O,,,4,1,1,0,1
24537_0,,,,2,1,1,2
C(C1CC(C(C(CO)(O1)O)O)O)=O,,,4,1,1,0,1
24539_0,,,,2,1,1,2
C(C1C(C(O)OCC1(CO)O)O)=O,,,4,1,1,0,1
24541_0,,,,2,1,1,2
C1(COC(CO)(C(C1O)O)O)=O,,,4,1,1,0,1
24543_0,,,,2,1,1,2
C1(COC(C(CO)(C1O)O)O)=O,,,4,1,1,0,1
24545_0,,,,2,1,1,2
C1(C(O)OCC(CO)(C1O)O)=O,,,4,1,1,0,1
24547_0,,,,2,1,1,2
C(CO)(C1C(O)OCC(C1O)O)=O,,,4,1,1,0,1
24549_0,,,,2,1,1,2
C(C1C(CO)(O)OCC(C1O)O)=O,,,4,1,1,0,1
24551_0,,,,2,1,1,2
C(CC1(C(C(C(CO1)O)O)O)O)=O,,,4,1,1,0,1
24553_0,,,,2,1,1,2
C1(C(C(C(CO)O)OC(C1)O)O)=O,,,4,1,1,0,1
24555_0,,,,2,1,1,2
C(C(C1(CC(C(CO1)O)O)O)O)=O,,,4,1,1,0,1
24557_0,,,,2,1,1,2
C1(C(C(O)OC(C(CO)O)C1)O)=O,,,4,1,1,0,1
24559_0,,,,2,1,1,2
C1C(C(CC(C(CO)O)(O)O1)O)O,,,4,1,1,0,1
24560_0,,,,2,1,1,2
24562_0,,,,2,1,1,2
C(C1(C(CO)C(C(CO1)O)O)O)=O,,,4,1,1,0,1
24564_0,,,,2,1,1,2
C1C(C(C(C(CCO)(O)O1)O)O)O,,,4,1,1,0,1
24566_0,,,,2,1,1,2
C1C(C(C(CO)C(CO)(O)O1)O)O,,,4,1,1,0,1
24568_0,,,,2,1,1,2
C(C1C(C(O)OC(CO)C1O)O)=O,,,4,1,1,0,1
24570_0,,,,2,1,1,2
C(C(C1C(O)OCC(C1O)O)O)=O,,,4,1,1,0,1
24572_0,,,,2,1,1,2
C1C(C(CC(O)O1)O)O,,,4,1,1,0,1
24574_0,,,,2,1,1,2
C(CC1(COC(C(C1)=O)O)O)=O,,,4,1,1,0,1
24576_0,,,,2,1,1,2
C(C1C(COC(C)(C1O)O)=O)=O,,,4,1,1,0,1
24578_0,,,,2,1,1,2
C(C1C(COC(C1(C)O)O)=O)=O,,,4,1,1,0,1
24580_0,,,,2,1,1,2
C1(C(C(C(C)=O)OC(C1)O)O)=O,,,4,1,1,0,1
24582_0,,,,2,1,1,2
C(C1(C)C(C(CC(O1)O)=O)O)=O,,,4,1,1,0,1
24584_0,,,,2,1,1,2
C(C)(C1C(CC(C(O1)O)=O)O)=O,,,4,1,1,0,1
24586_0,,,,2,1,1,2
C(C1C(C)(CC(C(O1)O)=O)O)=O,,,4,1,1,0,1
24588_0,,,,2,1,1,2
C(C1C(CC(C(C)(O1)O)O)=O)=O,,,4,1,1,0,1
24590_0,,,,2,1,1,2
C1(CC(C(C)=O)OC(C1O)O)=O,,,4,1,1,0,1
24592_0,,,,2,1,1,2
C(C1C(CC(C)(C(O1)O)O)=O)=O,,,4,1,1,0,1
24594_0,,,,2,1,1,2
C(C1(C)CC(C(C(O1)O)O)=O)=O,,,4,1,1,0,1
24596_0,,,,2,1,1,2
C1(C(O)OC(CO)C(C)(C1)O)=O,,,4,1,1,0,1
24598_0,,,,2,1,1,2
C(C1(CC(C)(C(CO1)O)O)O)=O,,,4,1,1,0,1
24600_0,,,,2,1,1,2
C1(C(CO)OC(C(C1)O)(C)O)=O,,,4,1,1,0,1
24602_0,,,,2,1,1,2
C1(C(CO)OC(C(C)(C1)O)O)=O,,,4,1,1,0,1
24604_0,,,,2,1,1,2
C(C1(CC(C=O)(O)OCC1)O)=O,,,4,1,1,0,1
24606_0,,,,2,1,1,2
C1(C(O)OCC(CCO)(C1)O)=O,,,4,1,1,0,1
24608_0,,,,2,1,1,2
C(C1(CC(CO)(CCO1)O)O)=O,,,4,1,1,0,1
24610_0,,,,2,1,1,2
C1(COC(C)(C(C1CO)O)O)=O,,,4,1,1,0,1
24612_0,,,,2,1,1,2
C1(COC(C(C)(C1CO)O)O)=O,,,4,1,1,0,1
24614_0,,,,2,1,1,2
C(C1C(CC(C(O1)O)=O)O)=O,,,4,1,1,0,1
24616_0,,,,2,1,1,2
C1(C(O)OCC(C)(C1)O)=O,,,4,1,1,0,1
24617_0,,,,2,1,1,2
24619_0,,,,2,1,1,2
C1(COC(C(C)(C1)O)O)=O,,,4,1,1,0,1
24621_0,,,,2,1,1,2
C(CC1C(CC(C(O)O1)=O)O)=O,,,4,1,1,0,1
24623_0,,,,2,1,1,2
C(C1CC(CC(C=O)(O1)O)O)=O,,,4,1,1,0,1
24625_0,,,,2,1,1,2
C(C(C1C(CC(C(O)O1)=O)O)O)=O,,,4,1,1,0,1
24627_0,,,,2,1,1,2
C(C1C(C(CC(C=O)(O1)O)O)O)=O,,,4,1,1,0,1
24628_0,,,,2,1,1,2
24630_0,,,,2,1,1,2
C(C1(COC(C(C1)=O)O)O)=O,,,4,1,1,0,1
24632_0,,,,2,1,1,2
C1(C(O)OCC(C(CO)O)(C1)O)=O,,,4,1,1,0,1
24634_0,,,,2,1,1,2
C1(C(O)OC(CO)C(CO)(C1)O)=O,,,4,1,1,0,1
24636_0,,,,2,1,1,2
C(C1(CC(CO)(C(CO1)O)O)O)=O,,,4,1,1,0,1
24637_0,,,,2,1,1,2
24639_0,,,,2,1,1,2
C1(C(CO)OC(C(C)(C1O)O)O)=O,,,4,1,1,0,1
24641_0,,,,2,1,1,2
C1(C(CC(C=O)(OC1CO)O)O)=O,,,4,1,1,0,1
24643_0,,,,2,1,1,2
C(C1(C(CO)OC(C(C1)=O)O)O)=O,,,4,1,1,0,1
24645_0,,,,2,1,1,2
C(C1(CC(C=O)(O)OCC1O)O)=O,,,4,1,1,0,1
24647_0,,,,2,1,1,2
C(C1C(COC(C1O)O)=O)=O,,,4,1,1,0,1
24649_0,,,,2,1,1,2
C1(C(C(C=O)OC(C1)O)O)=O,,,4,1,1,0,1
24651_0,,,,2,1,1,2
C1(C(COC(C1)O)O)=O,,,4,1,1,0,1
24653_0,,,,2,1,1,2
C1(C(C(C(C=O)O)OC(C1)O)O)=O,,,4,1,1,0,1
24655_0,,,,2,1,1,2
C1(C(C(CO)(C)OC(C1)O)O)=O,,,4,1,1,0,1
24657_0,,,,2,1,1,2
C1(C(C(C)OC(C1)O)O)=O,,,4,1,1,0,1
24659_0,,,,2,1,1,2
C(C1C(COC(CO)(C1O)O)=O)=O,,,4,1,1,0,1
24661_0,,,,2,1,1,2
C(CO)(C1C(OCC(C1O)=O)O)=O,,,4,1,1,0,1
24663_0,,,,2,1,1,2
C(C1C(CO)(OCC(C1O)=O)O)=O,,,4,1,1,0,1
24665_0,,,,2,1,1,2
C1(C(C(C(CO)=O)OC(C1)O)O)=O,,,4,1,1,0,1
24667_0,,,,2,1,1,2
C(CC1(C(C(C(CO1)=O)O)O)O)=O,,,4,1,1,0,1
24669_0,,,,2,1,1,2
C(C1C(COC(C1(CO)O)O)=O)=O,,,4,1,1,0,1
24671_0,,,,2,1,1,2
C(C1(CO)C(C(CC(O1)O)=O)O)=O,,,4,1,1,0,1
24673_0,,,,2,1,1,2
C(CC1(COC(C(C1O)=O)O)O)=O,,,4,1,1,0,1
24675_0,,,,2,1,1,2
C(C1C(CC(C(O1)O)O)=O)=O,,,4,1,1,0,1
24677_0,,,,2,1,1,2
C1(CC(C=O)OC(C1O)O)=O,,,4,1,1,0,1
24679_0,,,,2,1,1,2
C1(C(C(O)OCC1)O)=O,,,4,1,1,0,1
24681_0,,,,2,1,1,2
C1(C(C(O)OC(C(C=O)O)C1)O)=O,,,4,1,1,0,1
24683_0,,,,2,1,1,2
C1(C(C(O)OC(CO)(C)C1)O)=O,,,4,1,1,0,1
24685_0,,,,2,1,1,2
C1(C(C(O)OC(C)C1)O)=O,,,4,1,1,0,1
24687_0,,,,2,1,1,2
C(C1C(CC(C(CO)(O1)O)O)=O)=O,,,4,1,1,0,1
24689_0,,,,2,1,1,2
C1(CC(C(CO)=O)OC(C1O)O)=O,,,4,1,1,0,1
24691_0,,,,2,1,1,2
C(C(C1(CC(C(CO1)=O)O)O)O)=O,,,4,1,1,0,1
24693_0,,,,2,1,1,2
C(C1C(CC(CO)(C(O1)O)O)=O)=O,,,4,1,1,0,1
24695_0,,,,2,1,1,2
C(C1(CO)CC(C(C(O1)O)O)=O)=O,,,4,1,1,0,1
24697_0,,,,2,1,1,2
C(C)(C1C(C(C(C(O1)O)=O)O)O)=O,,,4,1,1,0,1
24699_0,,,,2,1,1,2
C(C1C(C)(C(C(C(O1)O)=O)O)O)=O,,,4,1,1,0,1
24700_0,,,,2,1,1,2
24701_0,,,,2,1,1,2
24702_0,,,,2,1,1,2
24703_0,,,,2,1,1,2
24705_0,,,,2,1,1,2
C1C(C(C)(CC(CO)(O)O1)O)O,,,4,1,1,0,1
24707_0,,,,2,1,1,2
CC1(C(COC(C)(C1O)O)O)O,,,4,1,1,0,1
24709_0,,,,2,1,1,2
C1C(C(C)(CC(O)O1)O)O,,,4,1,1,0,1
24710_0,,,,2,1,1,2
24712_0,,,,2,1,1,2
C1(COC(CC1O)(C(CO)O)O)=O,,,4,1,1,0,1
24714_0,,,,2,1,1,2
C1(C(CO)OC(C(CO)(C1)O)O)=O,,,4,1,1,0,1
24716_0,,,,2,1,1,2
C1(C(O)OC(CO)C(C)(C1O)O)=O,,,4,1,1,0,1
24718_0,,,,2,1,1,2
C(C1(C(C(C)(C(CO1)O)O)O)O)=O,,,4,1,1,0,1
24719_0,,,,2,1,1,2
24720_0,,,,2,1,1,2
24722_0,,,,2,1,1,2
C(C1CC(CO)(CC(O1)O)O)=O,,,4,1,1,0,1
24723_0,,,,2,1,1,2
24724_0,,,,2,1,1,2
24726_0,,,,2,1,1,2
C1(C(C(CO)O)(O)OCC(C1)O)=O,,,4,1,1,0,1
24727_0,,,,2,1,1,2
24729_0,,,,2,1,1,2
C1(C(COC(C(CO)O)(C1)O)O)=O,,,4,1,1,0,1
24730_0,,,,2,1,1,2
24732_0,,,,2,1,1,2
C1(C(C(CCO)(O)OCC1O)O)=O,,,4,1,1,0,1
24734_0,,,,2,1,1,2
C1(C(C(C(CO)O)(O)OCC1)O)=O,,,4,1,1,0,1
24735_0,,,,2,1,1,2
24736_0,,,,2,1,1,2
24738_0,,,,2,1,1,2
C1(COC(C(C1)O)(C(CO)O)O)=O,,,4,1,1,0,1
24740_0,,,,2,1,1,2
C1(COC(CO)(C(CO)C1O)O)=O,,,4,1,1,0,1
24741_0,,,,2,1,1,2
24743_0,,,,2,1,1,2
C(C1COC(CO)(C(C1O)O)O)=O,,,4,1,1,0,1
24745_0,,,,2,1,1,2
C1(C(CO)C(C(C(CO)O1)O)O)O,,,4,1,1,0,1
24746_0,,,,2,1,1,2
24747_0,,,,2,1,1,2
24749_0,,,,2,1,1,2
C(C1(C(CO)CC(CO1)=O)O)=O,,,4,1,1,0,1
24751_0,,,,2,1,1,2
C(CO)(C1COC(C(C1)=O)O)=O,,,4,1,1,0,1
24752_0,,,,2,1,1,2
24753_0,,,,2,1,1,2
24755_0,,,,2,1,1,2
C(C(C1COC(CC1O)O)=O)=O,,,4,1,1,0,1
24757_0,,,,2,1,1,2
C(C1COC(C=O)(CC1O)O)=O,,,4,1,1,0,1
24759_0,,,,2,1,1,2
C(C1C(CC(CO)(O)OC1)=O)=O,,,4,1,1,0,1
24761_0,,,,2,1,1,2
C1(CC(O)OCC1C(CO)=O)=O,,,4,1,1,0,1
24763_0,,,,2,1,1,2
C(CC1(CC(C(CO1)O)=O)O)=O,,,4,1,1,0,1
24765_0,,,,2,1,1,2
C(C1C(C(C(C)(O)OC1)O)=O)=O,,,4,1,1,0,1
24767_0,,,,2,1,1,2
C(CC1(C(C(CCO1)=O)O)O)=O,,,4,1,1,0,1
24769_0,,,,2,1,1,2
C1(C(C(O)OCC1C(C)=O)O)=O,,,4,1,1,0,1
24771_0,,,,2,1,1,2
C1(CCOC(C(C=O)O)(C1)O)=O,,,4,1,1,0,1
24772_0,,,,2,1,1,2
24774_0,,,,2,1,1,2
C1(C(COC(C1O)O)CC=O)=O,,,4,1,1,0,1
24776_0,,,,2,1,1,2
C(C1C(CC(CO)C(O1)O)=O)=O,,,4,1,1,0,1
24777_0,,,,2,1,1,2
24779_0,,,,2,1,1,2
C1(C(COC(C1)O)C(C=O)O)=O,,,4,1,1,0,1
24780_0,,,,2,1,1,2
24782_0,,,,2,1,1,2
C1C(C2C(C(C(CO)O2)(O)O1)O)O,,,4,1,1,0,1
24784_0,,,,2,1,1,2
C1C(C2C(CO)C(C(O)O2)(O)O1)O,,,4,1,1,0,1
24786_0,,,,2,1,1,2
C1(C(CO)C2C(C(C(O)O2)O1)O)O,,,4,1,1,0,1
24788_0,,,,2,1,1,2
C1C2C(C(C(C(CO)O2)(O)O1)O)O,,,4,1,1,0,1
24790_0,,,,2,1,1,2
C1C2C(C(CO)C(C(O)O2)(O)O1)O,,,4,1,1,0,1
24792_0,,,,2,1,1,2
C1(C(CC(CO)C(CO)(O)O1)O)=O,,,4,1,1,0,1
24794_0,,,,2,1,1,2
C1(C(CCC(C(CO)O)(O)O1)O)=O,,,4,1,1,0,1
24796_0,,,,2,1,1,2
C1(C(CC(C(CCO)(O)O1)O)O)=O,,,4,1,1,0,1
24798_0,,,,2,1,1,2
C(C1CC(C(CO)C(O1)O)O)(O)=O,,,4,1,1,0,1
24800_0,,,,2,1,1,2
C1(C(C(O)OCC1C(CO)O)=O)=O,,,4,1,1,0,1
24801_0,,,,2,1,1,2
24802_0,,,,2,1,1,2
24803_0,,,,2,1,1,2
24804_0,,,,2,1,1,2
24805_0,,,,2,1,1,2
24807_0,,,,2,1,1,2
C(CO)(C1COC(C(C1O)=O)O)=O,,,4,1,1,0,1
24808_0,,,,2,1,1,2
24809_0,,,,2,1,1,2
24811_0,,,,2,1,1,2
C(C1COC(C=O)(C(C1O)O)O)=O,,,4,1,1,0,1
24812_0,,,,2,1,1,2
24814_0,,,,2,1,1,2
C(C(C1COC(C(C1O)O)O)=O)=O,,,4,1,1,0,1
24816_0,,,,2,1,1,2
C(C1C(C(C(C(O1)O)=O)CO)O)=O,,,4,1,1,0,1
24818_0,,,,2,1,1,2
C1(C(O)OCC(C)(C1CO)O)=O,,,4,1,1,0,1
24820_0,,,,2,1,1,2
C1(COC(C(C1)O)(CCO)O)=O,,,4,1,1,0,1
24822_0,,,,2,1,1,2
C(C1(CCOC(CO)(C1)O)O)=O,,,4,1,1,0,1
24824_0,,,,2,1,1,2
C1(COC(C(CCO)(C1)O)O)=O,,,4,1,1,0,1
24826_0,,,,2,1,1,2
C(C1(CCOC(C)(C1O)O)O)=O,,,4,1,1,0,1
24828_0,,,,2,1,1,2
C(C1(CC(O)OCC1)O)=O,,,4,1,1,0,1
24830_0,,,,2,1,1,2
C(C1(C(CO)C(C(CO1)=O)O)O)=O,,,4,1,1,0,1
24832_0,,,,2,1,1,2
C(C1(COC(C(C1CO)=O)O)O)=O,,,4,1,1,0,1
24834_0,,,,2,1,1,2
C(C1(C(C(C=O)(O)OCC1)O)O)=O,,,4,1,1,0,1
24836_0,,,,2,1,1,2
C(CO)(C1COC(C(C1O)O)O)=O,,,4,1,1,0,1
24838_0,,,,2,1,1,2
C1CC(CO)(CC(CO)(O)O1)O,,,4,1,1,0,1
24840_0,,,,2,1,1,2
CC1(C(C(CO)(CCO1)O)O)O,,,4,1,1,0,1
24842_0,,,,2,1,1,2
C1CC(CO)(CC(O)O1)O,,,4,1,1,0,1
24844_0,,,,2,1,1,2
C1(COC(C(CO)(C1CO)O)O)=O,,,4,1,1,0,1
24846_0,,,,2,1,1,2
C1(C(O)OCC(CCO)(C1O)O)=O,,,4,1,1,0,1
24848_0,,,,2,1,1,2
C(C1(C(C(CO)(CCO1)O)O)O)=O,,,4,1,1,0,1
24850_0,,,,2,1,1,2
C(C)(C1C(C(CC(O1)O)O)O)=O,,,4,1,1,0,1
24852_0,,,,2,1,1,2
C(C1C(C(C)(CC(O1)O)O)O)=O,,,4,1,1,0,1
24854_0,,,,2,1,1,2
C(C1C(C(C=O)OC(C1O)O)O)=O,,,4,1,1,0,1
24856_0,,,,2,1,1,2
C(C1C(C(C(OC1C=O)O)O)O)=O,,,4,1,1,0,1
24858_0,,,,2,1,1,2
C(C1C(C(C(C(O1)O)=O)O)O)=O,,,4,1,1,0,1
24860_0,,,,2,1,1,2
C(C1CC(CC(CO)(O1)O)O)=O,,,4,1,1,0,1
24862_0,,,,2,1,1,2
C(C)(C1C(CC(C(O1)O)O)O)=O,,,4,1,1,0,1
24864_0,,,,2,1,1,2
C(C1CC(C(C(C)(O1)O)O)O)=O,,,4,1,1,0,1
24866_0,,,,2,1,1,2
C(C1C(C(O)OCC1(C)O)O)=O,,,4,1,1,0,1
24868_0,,,,2,1,1,2
C(C1C(C(CC(CO)(O1)O)O)O)=O,,,4,1,1,0,1
24870_0,,,,2,1,1,2
C(C)(C1C(C(C(C(O1)O)O)O)O)=O,,,4,1,1,0,1
24872_0,,,,2,1,1,2
C(C1C(C(C(C(C)(O1)O)O)O)O)=O,,,4,1,1,0,1
24874_0,,,,2,1,1,2
C1(COC(C(CO)(C1)O)O)=O,,,4,1,1,0,1
24876_0,,,,2,1,1,2
C1(C(O)OCC(C)(C1O)O)=O,,,4,1,1,0,1
24878_0,,,,2,1,1,2
C1C(C(CO)(CC(CO)(O)O1)O)O,,,4,1,1,0,1
24880_0,,,,2,1,1,2
C1C(C(CO)(C(C(C)(O)O1)O)O)O,,,4,1,1,0,1
24882_0,,,,2,1,1,2
C1(COC(C(C(CO)O)(C1)O)O)=O,,,4,1,1,0,1
24884_0,,,,2,1,1,2
C(C1(C(COC(CO)(C1)O)O)O)=O,,,4,1,1,0,1
24886_0,,,,2,1,1,2
C(C1(C(COC(C)(C1O)O)O)O)=O,,,4,1,1,0,1
24888_0,,,,2,1,1,2
C(C1CC(CC(O1)O)O)=O,,,4,1,1,0,1
24890_0,,,,2,1,1,2
C(C(C1C(OCC(C1O)=O)O)O)=O,,,4,1,1,0,1
24892_0,,,,2,1,1,2
C(C1C(C(O)OCC1(C=O)O)O)=O,,,4,1,1,0,1
24894_0,,,,2,1,1,2
C(CC1C(C(C(C(O)O1)=O)O)O)=O,,,4,1,1,0,1
24896_0,,,,2,1,1,2
C(C(C1C(C(CC(O1)O)O)O)=O)=O,,,4,1,1,0,1
24898_0,,,,2,1,1,2
C(C1CC(C(C(C=O)(O1)O)O)O)=O,,,4,1,1,0,1
24900_0,,,,2,1,1,2
C(C(C1C(CC(C(O1)O)O)O)=O)=O,,,4,1,1,0,1
24901_0,,,,2,1,1,2
24903_0,,,,2,1,1,2
C1C(C(CO)(CC(O)O1)O)O,,,4,1,1,0,1
24904_0,,,,2,1,1,2
24906_0,,,,2,1,1,2
C(C(CC1(CC(O)OCC1)O)=O)=O,,,4,1,1,0,1
24907_0,,,,2,1,1,2
24908_0,,,,2,1,1,2
24910_0,,,,2,1,1,2
C1(CC(C=O)(O)OC(C)C1CO)=O,,,4,1,1,0,1
24911_0,,,,2,1,1,2
24913_0,,,,2,1,1,2
C(CC1C(CCC(CO)(O1)O)=O)=O,,,4,1,1,0,1
24914_0,,,,2,1,1,2
24916_0,,,,2,1,1,2
C(CC1(CO)CCC(C(O)O1)=O)=O,,,4,1,1,0,1
24917_0,,,,2,1,1,2
24919_0,,,,2,1,1,2
C(C1(C(C(C)O)CC(CO1)=O)O)=O,,,4,1,1,0,1
24921_0,,,,2,1,1,2
C(CO)(C1C(C)OC(C(C1)=O)O)=O,,,4,1,1,0,1
24922_0,,,,2,1,1,2
24923_0,,,,2,1,1,2
24925_0,,,,2,1,1,2
C(CC1C(CC(C(C)(O1)O)O)=O)=O,,,4,1,1,0,1
24927_0,,,,2,1,1,2
C(C1(CC(C(C)=O)OC(C1)O)O)=O,,,4,1,1,0,1
24929_0,,,,2,1,1,2
C(CC1(C)C(CC(C(O)O1)=O)O)=O,,,4,1,1,0,1
24931_0,,,,2,1,1,2
C(C1(CC(CC(O1)O)O)CC=O)=O,,,4,1,1,0,1
24933_0,,,,2,1,1,2
C(C1(CC(O)OC(C1)CC=O)O)=O,,,4,1,1,0,1
24935_0,,,,2,1,1,2
C(CC1CC(CC(C=O)(O)O1)O)=O,,,4,1,1,0,1
24937_0,,,,2,1,1,2
C(C(CC1CC(CC(O)O1)O)=O)=O,,,4,1,1,0,1
24939_0,,,,2,1,1,2
C(C(C1C(C)OC(CC1O)O)=O)=O,,,4,1,1,0,1
24941_0,,,,2,1,1,2
C(C1C(CC(C=O)(O)OC1C)O)=O,,,4,1,1,0,1
24943_0,,,,2,1,1,2
C(CC(C1(CC(O)OCC1)O)=O)=O,,,4,1,1,0,1
24945_0,,,,2,1,1,2
C(CC1CC(CC(CO)(O)O1)=O)=O,,,4,1,1,0,1
24947_0,,,,2,1,1,2
C(CC1(CO)CC(CC(O)O1)=O)=O,,,4,1,1,0,1
24949_0,,,,2,1,1,2
C(C1C(CC(CO)(O)OC1C)=O)=O,,,4,1,1,0,1
24951_0,,,,2,1,1,2
C1(CC(O)OC(C)C1C(CO)=O)=O,,,4,1,1,0,1
24953_0,,,,2,1,1,2
C(CC1(CC(C(C(C)O1)O)=O)O)=O,,,4,1,1,0,1
24955_0,,,,2,1,1,2
C(CC1CC(C(C(C)(O)O1)O)=O)=O,,,4,1,1,0,1
24957_0,,,,2,1,1,2
C(CC1(C)C(C(CC(O)O1)=O)O)=O,,,4,1,1,0,1
24959_0,,,,2,1,1,2
C(C1C(C(C(C)(O)OC1C)O)=O)=O,,,4,1,1,0,1
24961_0,,,,2,1,1,2
C(CC1(C(C(CC(C)O1)=O)O)O)=O,,,4,1,1,0,1
24963_0,,,,2,1,1,2
C(CC(C1CC(CC(O1)O)O)=O)=O,,,4,1,1,0,1
24965_0,,,,2,1,1,2
C(CC1C(C(CC(C)(O)O1)=O)O)=O,,,4,1,1,0,1
24967_0,,,,2,1,1,2
C(CC1(C)CC(C(C(O)O1)O)=O)=O,,,4,1,1,0,1
24969_0,,,,2,1,1,2
C1(C(C(O)OC(C)C1C(C)=O)O)=O,,,4,1,1,0,1
24971_0,,,,2,1,1,2
C1(CC(C)OC(C(C=O)O)(C1)O)=O,,,4,1,1,0,1
24972_0,,,,2,1,1,2
24973_0,,,,2,1,1,2
24974_0,,,,2,1,1,2
24976_0,,,,2,1,1,2
C1(C(C(C)OC(C1O)O)CC=O)=O,,,4,1,1,0,1
24978_0,,,,2,1,1,2
C(C1C(CC(C(O1)O)C(C)O)=O)=O,,,4,1,1,0,1
24980_0,,,,2,1,1,2
C(CC1C(CC(C(C)(O)O1)=O)O)=O,,,4,1,1,0,1
24982_0,,,,2,1,1,2
C(C1CC(C(C)=O)(CC(O1)O)O)=O,,,4,1,1,0,1
24984_0,,,,2,1,1,2
C1(C(C)(CC=O)OC(C(C1)O)O)=O,,,4,1,1,0,1
24985_0,,,,2,1,1,2
24986_0,,,,2,1,1,2
24987_0,,,,2,1,1,2
24989_0,,,,2,1,1,2
C1(C(C(C)OC(C1)O)C(C=O)O)=O,,,4,1,1,0,1
24990_0,,,,2,1,1,2
24992_0,,,,2,1,1,2
C(C1(C(COC(C1)O)O)O)=CC=O,,,4,1,1,0,1
24994_0,,,,2,1,1,2
C=CC(C1C(C(CC(O1)O)O)O)=O,,,4,1,1,0,1
24996_0,,,,2,1,1,2
C(C1C(C(C=C)(CC(O1)O)O)O)=O,,,4,1,1,0,1
24998_0,,,,2,1,1,2
C(C1C(C(CC(O1)O)O)O)=CC=O,,,4,1,1,0,1
24999_0,,,,2,1,1,2
25001_0,,,,2,1,1,2
C(C1(C(C(C(CO1)=O)O)O)O)=O,,,4,1,1,0,1
25003_0,,,,2,1,1,2
C(C1(COC(C(C1O)=O)O)O)=O,,,4,1,1,0,1
25004_0,,,,2,1,1,2
25005_0,,,,2,1,1,2
25007_0,,,,2,1,1,2
CC1(C(COC(C1O)O)O)O,,,4,1,1,0,1
25009_0,,,,2,1,1,2
C(C1C(CO)(CC(C(O1)O)O)O)=O,,,4,1,1,0,1
25011_0,,,,2,1,1,2
C(C1CC(CO)(C(C(O1)O)O)O)=O,,,4,1,1,0,1
25012_0,,,,2,1,1,2
25014_0,,,,2,1,1,2
C(CO)(C1C(C(O)OCC1O)O)=O,,,4,1,1,0,1
25015_0,,,,2,1,1,2
25016_0,,,,2,1,1,2
25018_0,,,,2,1,1,2
C(C1(C(C(O)OCC1)O)O)=O,,,4,1,1,0,1
25020_0,,,,2,1,1,2
C1(C(O)OCC(C1CO)O)=O,,,4,1,1,0,1
25022_0,,,,2,1,1,2
C1CC(CO)(C(C(O)O1)O)O,,,4,1,1,0,1
25024_0,,,,2,1,1,2
C(C1C(C)(C(C(C(O1)O)O)O)O)=O,,,4,1,1,0,1
25026_0,,,,2,1,1,2
C(C1C(C(C)(C(C(O1)O)O)O)O)=O,,,4,1,1,0,1
25028_0,,,,2,1,1,2
C(C1C(C(O)OCC1O)O)=O,,,4,1,1,0,1
25030_0,,,,2,1,1,2
C(C1C(C(C(C(O1)O)O)O)O)=O,,,4,1,1,0,1
25032_0,,,,2,1,1,2
C1(C(O)OCC(C1O)O)=O,,,4,1,1,0,1
25034_0,,,,2,1,1,2
C1C(C(CO)(C(C(O)O1)O)O)O,,,4,1,1,0,1
25035_0,,,,2,1,1,2
25037_0,,,,2,1,1,2
C1(C(O)OC(C(C1)O)C(CO)O)=O,,,4,1,1,0,1
25039_0,,,,2,1,1,2
C(C1(CC(C(C(CO)O1)O)O)O)=O,,,4,1,1,0,1
25041_0,,,,2,1,1,2
C(C1(CC(C(C(CO)O1)O)O)O)O,,,4,1,1,0,1
25043_0,,,,2,1,1,2
CC1(C(C(C(C(CO)O1)O)O)O)O,,,4,1,1,0,1
25044_0,,,,2,1,1,2
25046_0,,,,2,1,1,2
C1(C(C(O)OCC1C(CO)O)O)=O,,,4,1,1,0,1
25047_0,,,,2,1,1,2
25048_0,,,,2,1,1,2
25050_0,,,,2,1,1,2
C(C1C(C(C(CO)C(O1)O)O)O)=O,,,4,1,1,0,1
25051_0,,,,2,1,1,2
25053_0,,,,2,1,1,2
C1(C(C)(CC(C(O)O1)O)O)=O,,,4,1,1,0,1
25054_0,,,,2,1,1,2
25055_0,,,,2,1,1,2
25056_0,,,,2,1,1,2
25057_0,,,,2,1,1,2
25058_0,,,,2,1,1,2
25059_0,,,,2,1,1,2
25061_0,,,,2,1,1,2
C1(C(CO)(O)OCC(C1O)O)=O,,,4,1,1,0,1
25062_0,,,,2,1,1,2
25064_0,,,,2,1,1,2
C1CC(C(C(CO)(O)O1)O)O,,,4,1,1,0,1
25065_0,,,,2,1,1,2
25067_0,,,,2,1,1,2
C1(C(CC(C(CO)(O)O1)O)O)=O,,,4,1,1,0,1
25068_0,,,,2,1,1,2
25070_0,,,,2,1,1,2
C1(CC(C(C(CO)(O)O1)O)O)=O,,,4,1,1,0,1
25071_0,,,,2,1,1,2
25072_0,,,,2,1,1,2
25073_0,,,,2,1,1,2
25074_0,,,,2,1,1,2
25075_0,,,,2,1,1,2
25077_0,,,,2,1,1,2
C1C2CC(C(C(O)O2)(O)O1)O,,,4,1,2,0,2
25079_0,,,,2,1,1,2
C(C1CCC(C(O1)O)O)(O)=O,,,4,1,1,0,1
25080_0,,,,2,1,1,2
25082_0,,,,2,1,1,2
C(C1CC(C(C(O1)O)=O)O)=O,,,4,1,1,0,1
25084_0,,,,2,1,1,2
C1(C(C)OC(C(C1O)=O)O)=O,,,4,1,1,0,1
25086_0,,,,2,1,1,2
C(C1C(C(CC(O1)O)O)=O)=O,,,4,1,1,0,1
25087_0,,,,2,1,1,2
25088_0,,,,2,1,1,2
25089_0,,,,2,1,1,2
25091_0,,,,2,1,1,2
C(C1(CC(CCO1)O)O)=O,,,4,1,1,0,1
25092_0,,,,2,1,1,2
25093_0,,,,2,1,1,2
25094_0,,,,2,1,1,2
25095_0,,,,2,1,1,2
25096_0,,,,2,1,1,2
25097_0,,,,2,1,1,2
25098_0,,,,2,1,1,2
25099_0,,,,2,1,1,2
25100_0,,,,2,1,1,2
25101_0,,,,2,1,1,2
25103_0,,,,2,1,1,2
C1(CC(CC(C=O)(O)O1)O)=O,,,4,1,1,0,1
25104_0,,,,2,1,1,2
25105_0,,,,2,1,1,2
25106_0,,,,2,1,1,2
25107_0,,,,2,1,1,2
25108_0,,,,2,1,1,2
25109_0,,,,2,1,1,2
25110_0,,,,2,1,1,2
25111_0,,,,2,1,1,2
25112_0,,,,2,1,1,2
25114_0,,,,2,1,1,2
C1(C(C(CC(CO)(O)O1)O)=O)=O,,,4,1,1,0,1
25115_0,,,,2,1,1,2
25117_0,,,,2,1,1,2
C1(C(C(C(C(C)(O)O1)O)O)=O)=O,,,4,1,1,0,1
25119_0,,,,2,1,1,2
C1(CC(C(C(C=O)(O)O1)O)O)=O,,,4,1,1,0,1
25121_0,,,,2,1,1,2
C1C(C(C(C(O)O1)(CO)O)O)O,,,4,1,1,0,1
25123_0,,,,2,1,1,2
C(C1(COC(CO)(CC1O)O)O)=O,,,4,1,1,0,1
25125_0,,,,2,1,1,2
C(C1(COC(CC1(CO)O)O)O)=O,,,4,1,1,0,1
25127_0,,,,2,1,1,2
C(C)(C1(C(O)OCC(C1O)O)O)=O,,,4,1,1,0,1
25129_0,,,,2,1,1,2
C(C1(C(C)(O)OCC(C1O)O)O)=O,,,4,1,1,0,1
25131_0,,,,2,1,1,2
C(C1(COC(C)(C(C1O)O)O)O)=O,,,4,1,1,0,1
25133_0,,,,2,1,1,2
C(C1(COC(C(C1(C)O)O)O)O)=O,,,4,1,1,0,1
25135_0,,,,2,1,1,2
C1C(C(C(CO)(C(C)(O)O1)O)O)O,,,4,1,1,0,1
25137_0,,,,2,1,1,2
CC1(C(COC(C1(CO)O)O)O)O,,,4,1,1,0,1
25139_0,,,,2,1,1,2
C(C1(CCOC(C1(CO)O)O)O)=O,,,4,1,1,0,1
25141_0,,,,2,1,1,2
C1CC(CO)(C(C(O)O1)(CO)O)O,,,4,1,1,0,1
25143_0,,,,2,1,1,2
C(C1(C(O)OCC(C1O)O)O)=O,,,4,1,1,0,1
25145_0,,,,2,1,1,2
C(C1(COC(C(C1O)O)O)O)=O,,,4,1,1,0,1
25146_0,,,,2,1,1,2
25147_0,,,,2,1,1,2
25149_0,,,,2,1,1,2
C(C1CC(C(CO)(C(O1)O)O)O)=O,,,4,1,1,0,1
25150_0,,,,2,1,1,2
25152_0,,,,2,1,1,2
C1(COC(C(C)(C1(CO)O)O)O)=O,,,4,1,1,0,1
25154_0,,,,2,1,1,2
C(C)(C1(C(OCC(C1O)=O)O)O)=O,,,4,1,1,0,1
25156_0,,,,2,1,1,2
C(C1(C(C)(OCC(C1O)=O)O)O)=O,,,4,1,1,0,1
25158_0,,,,2,1,1,2
C1(COC(C(C1(CO)O)O)O)=O,,,4,1,1,0,1
25160_0,,,,2,1,1,2
C(C1(C(C(O)OCC1O)O)O)(O)=O,,,4,1,1,0,1
25162_0,,,,2,1,1,2
C(C1(C(O)OCC(C1(C)O)O)O)=O,,,4,1,1,0,1
25164_0,,,,2,1,1,2
C(C)(C1(COC(C(C1O)O)O)O)=O,,,4,1,1,0,1
25166_0,,,,2,1,1,2
C1(COC(C)(C(CO)(C1O)O)O)=O,,,4,1,1,0,1
25167_0,,,,2,1,1,2
25168_0,,,,2,1,1,2
25169_0,,,,2,1,1,2
25171_0,,,,2,1,1,2
C1(C(C)OC(C(CO)(C1O)O)O)=O,,,4,1,1,0,1
25172_0,,,,2,1,1,2
25174_0,,,,2,1,1,2
C(CO)(C1(COC(CC1O)O)O)=O,,,4,1,1,0,1
25176_0,,,,2,1,1,2
C1(CC(O)OCC1(C(C)=O)O)=O,,,4,1,1,0,1
25178_0,,,,2,1,1,2
C(C1(C(CC(C)(O)OC1)=O)O)=O,,,4,1,1,0,1
25179_0,,,,2,1,1,2
25181_0,,,,2,1,1,2
C1C2(C(CO)(C(C(CO2)O)O1)O)O,,,4,1,1,0,1
25183_0,,,,2,1,1,2
C1C2(C(CO)(C(C(CO2)O1)O)O)O,,,4,1,1,0,1
25184_0,,,,2,1,1,2
25185_0,,,,2,1,1,2
25186_0,,,,2,1,1,2
25188_0,,,,2,1,1,2
C(C)(C1(COC(C(C1O)=O)O)O)=O,,,4,1,1,0,1
25190_0,,,,2,1,1,2
C(C(C1(COC(CC1O)O)O)=O)=O,,,4,1,1,0,1
25191_0,,,,2,1,1,2
25193_0,,,,2,1,1,2
C(C1(CCOC(C1(C=O)O)O)O)=O,,,4,1,1,0,1
25195_0,,,,2,1,1,2
C(C1(C(O)OCCC1(CO)O)O)=O,,,4,1,1,0,1
25197_0,,,,2,1,1,2
C(C1(C=O)C(C(CC(O1)O)O)O)=O,,,4,1,1,0,1
25199_0,,,,2,1,1,2
C(C1(C=O)C(CC(C(O1)O)O)O)=O,,,4,1,1,0,1
25201_0,,,,2,1,1,2
C(C1(C(OC(C=O)CC1O)O)O)=O,,,4,1,1,0,1
25203_0,,,,2,1,1,2
C(C1(C(OCC(C1O)=O)O)O)=O,,,4,1,1,0,1
25205_0,,,,2,1,1,2
C(C1(C(C(O)OCC1(C)O)O)O)=O,,,4,1,1,0,1
25207_0,,,,2,1,1,2
C1(C(O)OCC(C)(C1(CO)O)O)=O,,,4,1,1,0,1
25209_0,,,,2,1,1,2
C1(CC(O)OC(C)C1(C(C)=O)O)=O,,,4,1,1,0,1
25211_0,,,,2,1,1,2
C(C1(C(CC(C)(O)OC1C)=O)O)=O,,,4,1,1,0,1
25212_0,,,,2,1,1,2
25214_0,,,,2,1,1,2
C(C)(C1(C(C(O)OCC1O)O)O)=O,,,4,1,1,0,1
25216_0,,,,2,1,1,2
C1(C(O)OCC(C1(CO)O)O)=O,,,4,1,1,0,1
25218_0,,,,2,1,1,2
C(C1(C(COC(C1(C)O)O)O)O)=O,,,4,1,1,0,1
25220_0,,,,2,1,1,2
C1(CC(O)OCC1(C(CO)O)O)=O,,,4,1,1,0,1
25221_0,,,,2,1,1,2
25222_0,,,,2,1,1,2
25223_0,,,,2,1,1,2
25225_0,,,,2,1,1,2
C(C1(CC(O)OCC1(CO)O)O)=O,,,4,1,1,0,1
25227_0,,,,2,1,1,2
C(C1(CC(O)OC(CO)C1O)O)=O,,,4,1,1,0,1
25229_0,,,,2,1,1,2
C(CC1(C(O)OCC(C1O)O)O)=O,,,4,1,1,0,1
25231_0,,,,2,1,1,2
C(C1(CCOC(C)(C1O)O)O)(O)=O,,,4,1,1,0,1
25233_0,,,,2,1,1,2
C(C1(CCOC(C1(C)O)O)O)(O)=O,,,4,1,1,0,1
25235_0,,,,2,1,1,2
C1(C(C(CO)(CC(O)O1)O)O)=O,,,4,1,1,0,1
25237_0,,,,2,1,1,2
C1(C(C(C)(C(C(O)O1)O)O)O)=O,,,4,1,1,0,1
25239_0,,,,2,1,1,2
C(C(C1(C(OCC(C1)=O)O)O)O)=O,,,4,1,1,0,1
25241_0,,,,2,1,1,2
C(C1(C(C(O)OCC1)O)O)(O)=O,,,4,1,1,0,1
25243_0,,,,2,1,1,2
C1(COC(C(C(C)O)(C1)O)O)=O,,,4,1,1,0,1
25244_0,,,,2,1,1,2
25245_0,,,,2,1,1,2
25247_0,,,,2,1,1,2
C(C1(C(CO)(CC(CO1)O)O)O)=O,,,4,1,1,0,1
25249_0,,,,2,1,1,2
C(C1(COC(CO)(C(C1)O)O)O)=O,,,4,1,1,0,1
25251_0,,,,2,1,1,2
C(CO)(C1(COC(C(C1)O)O)O)=O,,,4,1,1,0,1
25253_0,,,,2,1,1,2
C1(C(C(O)OCC1(CCO)O)O)=O,,,4,1,1,0,1
25254_0,,,,2,1,1,2
25256_0,,,,2,1,1,2
C1(COC(CO)(C(CO)(C1)O)O)=O,,,4,1,1,0,1
25258_0,,,,2,1,1,2
C(C1C(CC(CO)(C(O1)O)O)O)=O,,,4,1,1,0,1
25259_0,,,,2,1,1,2
25260_0,,,,2,1,1,2
25262_0,,,,2,1,1,2
C(C)(C1(COC(C(C1)=O)O)O)=O,,,4,1,1,0,1
25264_0,,,,2,1,1,2
C1(C(COC(C1)O)(CC=O)O)=O,,,4,1,1,0,1
25266_0,,,,2,1,1,2
C(C1(COC(C(C1)=O)(C)O)O)=O,,,4,1,1,0,1
25267_0,,,,2,1,1,2
25269_0,,,,2,1,1,2
C1C(C2CC(C(CO)(O)O2)(O)O1)O,,,4,1,1,0,1
25271_0,,,,2,1,1,2
C1C2C(CC(C(CO)(O)O2)(O)O1)O,,,4,1,1,0,1
25273_0,,,,2,1,1,2
C(C1(COC(CO)(CC1)O)O)(O)=O,,,4,1,1,0,1
25274_0,,,,2,1,1,2
25276_0,,,,2,1,1,2
C(C1(COC(C)(C(C1)O)O)O)(O)=O,,,4,1,1,0,1
25277_0,,,,2,1,1,2
25279_0,,,,2,1,1,2
C1(C(CC(CO)(C(C)(O)O1)O)O)=O,,,4,1,1,0,1
25280_0,,,,2,1,1,2
25282_0,,,,2,1,1,2
C(C1(C(CO)(CC(CO1)=O)O)O)=O,,,4,1,1,0,1
25284_0,,,,2,1,1,2
C1(C(CO)(CC(C(CO)O1)O)O)O,,,4,1,1,0,1
25286_0,,,,2,1,1,2
C(C1(C(C(C=O)OC(C1)O)O)O)=O,,,4,1,1,0,1
25288_0,,,,2,1,1,2
C1(C(C(C(C(O)O1)O)O)O)=O,,,4,1,1,0,1
25290_0,,,,2,1,1,2
C(C1(CC(O)OCC1(C)O)O)=O,,,4,1,1,0,1
25292_0,,,,2,1,1,2
C(CC1(C(OCC(C1O)=O)O)O)=O,,,4,1,1,0,1
25294_0,,,,2,1,1,2
C(C1(CC(O)OCC1(C=O)O)O)=O,,,4,1,1,0,1
25296_0,,,,2,1,1,2
C(C1C(C(C(C(O1)O)O)O)O)(O)=O,,,4,1,1,0,1
25298_0,,,,2,1,1,2
C(C)(C1(C(C)OC(C(C1)=O)O)O)=O,,,4,1,1,0,1
25300_0,,,,2,1,1,2
C1(C(C(C)OC(C1)O)(CC=O)O)=O,,,4,1,1,0,1
25302_0,,,,2,1,1,2
C(C1(C(C)OC(C(C1)=O)(C)O)O)=O,,,4,1,1,0,1
25303_0,,,,2,1,1,2
25305_0,,,,2,1,1,2
C1(C(C)(O)OCC(C1O)O)=O,,,4,1,1,0,1
25306_0,,,,2,1,1,2
25307_0,,,,2,1,1,2
25308_0,,,,2,1,1,2
25309_0,,,,2,1,1,2
25311_0,,,,2,1,1,2
C1C2C(C(C(C(O)O2)O1)O)O,,,4,1,1,0,1
25313_0,,,,2,1,1,2
C1C2(C(CC(CO2)(O)O1)O)O,,,4,1,2,0,2
25314_0,,,,2,1,1,2
25315_0,,,,2,1,1,2
25316_0,,,,2,1,1,2
25317_0,,,,2,1,1,2
25318_0,,,,2,1,1,2
25320_0,,,,2,1,1,2
C1(C2(CC(C(CO2)O)O1)O)=O,,,4,1,2,0,2
25322_0,,,,2,1,1,2
C1(C2C(C(CC(O2)O)O1)O)=O,,,4,1,2,0,2
25324_0,,,,2,1,1,2
C1(C2CC(CC(O2)O)O1)=O,,,4,1,2,0,2
25326_0,,,,2,1,1,2
C1(C2(CC(C(CO2)O1)O)O)=O,,,4,1,2,0,2
25327_0,,,,2,1,1,2
25328_0,,,,2,1,1,2
25329_0,,,,2,1,1,2
25330_0,,,,2,1,1,2
25331_0,,,,2,1,1,2
25332_0,,,,2,1,1,2
25333_0,,,,2,1,1,2
25335_0,,,,2,1,1,2
C1(C2CC(C(C(O)O2)O1)O)O,,,4,1,2,0,2
25336_0,,,,2,1,1,2
25338_0,,,,2,1,1,2
C1(C2(C(C(C(CO2)O)O1)O)O)=O,,,4,1,2,0,2
25340_0,,,,2,1,1,2
C1(C2(C(C(C(CO2)O1)O)O)O)=O,,,4,1,2,0,2
25342_0,,,,2,1,1,2
C(CC1C(CO)OC(C(C1)=O)O)=O,,,4,1,2,0,2
25344_0,,,,2,1,1,2
C(C(CC1CC(O)OCC1O)=O)=O,,,4,1,1,0,1
25346_0,,,,2,1,1,2
C(CC1CC(C=O)(O)OCC1O)=O,,,4,1,1,0,1
25348_0,,,,2,1,1,2
C(CC1C(OC(C(C1)=O)CO)O)=O,,,4,1,2,0,2
25350_0,,,,2,1,1,2
C1(C(CC(OC1CO)O)CC=O)=O,,,4,1,1,0,1
25352_0,,,,2,1,1,2
C(CC1C(C(C=O)OC(C1)O)O)=O,,,4,1,1,0,1
25354_0,,,,2,1,1,2
C1(COC(CO)(CC(C1O)O)O)=O,,,4,1,1,0,1
25356_0,,,,2,1,1,2
C1(COC(CO)(C(C(C1)O)O)O)=O,,,4,1,1,0,1
25358_0,,,,2,1,1,2
C1(COC(CC(CO)(C1O)O)O)=O,,,4,1,1,0,1
25360_0,,,,2,1,1,2
C1(C(C(COC(C1)O)(CO)O)O)=O,,,4,1,1,0,1
25362_0,,,,2,1,1,2
C1(COC(C)(C(C(C1O)O)O)O)=O,,,4,1,1,0,1
25364_0,,,,2,1,1,2
C1(COC(C(C(C)(C1O)O)O)O)=O,,,4,1,1,0,1
25366_0,,,,2,1,1,2
C1(C(C(O)OCC(CO)(C1)O)O)=O,,,4,1,1,0,1
25368_0,,,,2,1,1,2
C1(C(C(C(CO)(O)OCC1)O)O)=O,,,4,1,1,0,1
25370_0,,,,2,1,1,2
C1(COC(C(C(C1O)O)O)O)=O,,,4,1,1,0,1
25372_0,,,,2,1,1,2
C1(C(C(C(CO)OC(C1)O)O)O)=O,,,4,1,1,0,1
25374_0,,,,2,1,1,2
C1(C(C(O)OC(C(C1)O)CO)O)=O,,,4,1,1,0,1
25375_0,,,,2,1,1,2
25377_0,,,,2,1,1,2
C(C1C(C(O)OCC(C1O)O)O)=O,,,4,1,1,0,1
25379_0,,,,2,1,1,2
C(C1(CC(CC(CO1)=O)O)O)=O,,,4,1,1,0,1
25381_0,,,,2,1,1,2
C1(C(O)OCC(C(C)(C1)O)O)=O,,,4,1,1,0,1
25383_0,,,,2,1,1,2
C1(C(COC(C(C1)O)(C)O)O)=O,,,4,1,1,0,1
25385_0,,,,2,1,1,2
C1(C(COC(C(C)(C1)O)O)O)=O,,,4,1,1,0,1
25387_0,,,,2,1,1,2
C1(C(CC(C=O)(O)OCC1)O)=O,,,4,1,1,0,1
25389_0,,,,2,1,1,2
C(C1(CCOC(C(C1)=O)O)O)=O,,,4,1,1,0,1
25391_0,,,,2,1,1,2
C1(C(O)OCCC(CO)(C1)O)=O,,,4,1,1,0,1
25393_0,,,,2,1,1,2
C1(C(C(C(C)(O)OCC1)O)O)=O,,,4,1,1,0,1
25395_0,,,,2,1,1,2
C1(C(C(C(O)OCC1)(C)O)O)=O,,,4,1,1,0,1
25397_0,,,,2,1,1,2
C(C1CC(CC(C(O1)O)=O)O)=O,,,4,1,1,0,1
25399_0,,,,2,1,1,2
C(C1C(C(CC(C(O1)O)=O)O)O)=O,,,4,1,1,0,1
25400_0,,,,2,1,1,2
25402_0,,,,2,1,1,2
C1(C(O)OCC(C(CO)(C1)O)O)=O,,,4,1,1,0,1
25404_0,,,,2,1,1,2
C1(C(C(C(C)(O)OCC1O)O)O)=O,,,4,1,1,0,1
25406_0,,,,2,1,1,2
C1(C(C(C(O)OCC1O)(C)O)O)=O,,,4,1,1,0,1
25408_0,,,,2,1,1,2
C1(C(OC(C(C(C1)O)=O)CO)O)=O,,,4,1,1,0,1
25410_0,,,,2,1,1,2
C1(C(COC(C=O)(CC1O)O)O)=O,,,4,1,1,0,1
25412_0,,,,2,1,1,2
C(C1(C(COC(C(C1)=O)O)O)O)=O,,,4,1,1,0,1
25414_0,,,,2,1,1,2
C(C1C(COC(C(C1O)O)O)=O)=O,,,4,1,1,0,1
25416_0,,,,2,1,1,2
C1(C(C(C(C=O)OC(C1)O)O)O)=O,,,4,1,1,0,1
25418_0,,,,2,1,1,2
C1(C(C(COC(C1)O)(C)O)O)=O,,,4,1,1,0,1
25420_0,,,,2,1,1,2
C1(COC(CO)(CC(C1)O)O)=O,,,4,1,1,0,1
25422_0,,,,2,1,1,2
C1(COC(CC(CO)(C1)O)O)=O,,,4,1,1,0,1
25424_0,,,,2,1,1,2
C1(COC(C)(C(C(C1)O)O)O)=O,,,4,1,1,0,1
25425_0,,,,2,1,1,2
25427_0,,,,2,1,1,2
C(C1(COC(CC(C1O)=O)O)O)=O,,,4,1,1,0,1
25429_0,,,,2,1,1,2
C(C1(C(C(CC(CO1)=O)O)O)O)=O,,,4,1,1,0,1
25431_0,,,,2,1,1,2
C(C1C(CC(C(C(O1)O)O)O)=O)=O,,,4,1,1,0,1
25433_0,,,,2,1,1,2
C1(C(C(OC(C=O)C(C1)O)O)O)=O,,,4,1,1,0,1
25435_0,,,,2,1,1,2
C1(C(C(O)OCC(C)(C1)O)O)=O,,,4,1,1,0,1
25437_0,,,,2,1,1,2
C1(COC(C(C(C)(C1)O)O)O)=O,,,4,1,1,0,1
25439_0,,,,2,1,1,2
C(C1(COC(C(C(C1)=O)O)O)O)=O,,,4,1,1,0,1
25441_0,,,,2,1,1,2
C1(CC(C=O)OC(C(C1O)O)O)=O,,,4,1,1,0,1
25443_0,,,,2,1,1,2
C1(C(C(C=O)OC(C(C1)O)O)O)=O,,,4,1,1,0,1
25444_0,,,,2,1,1,2
25445_0,,,,2,1,1,2
25447_0,,,,2,1,1,2
C1(C(COC(C(C1)O)(CO)O)O)=O,,,4,1,1,0,1
25449_0,,,,2,1,1,2
C1(C(COC(C(CO)(C1)O)O)O)=O,,,4,1,1,0,1
25451_0,,,,2,1,1,2
C1(C(O)OCC(C(C)(C1O)O)O)=O,,,4,1,1,0,1
25453_0,,,,2,1,1,2
C1(C(C(C)OC(C(C1)O)O)O)=O,,,4,1,1,0,1
25454_0,,,,2,1,1,2
25455_0,,,,2,1,1,2
25457_0,,,,2,1,1,2
C1(C(CC(CO)(O)OCC1O)O)=O,,,4,1,1,0,1
25458_0,,,,2,1,1,2
25460_0,,,,2,1,1,2
C1(COC(C(CO)C(C1O)O)O)=O,,,4,1,1,0,1
25462_0,,,,2,1,1,2
C1C(C(C(C(C(O)O1)CO)O)O)O,,,4,1,1,0,1
25463_0,,,,2,1,1,2
25464_0,,,,2,1,1,2
25465_0,,,,2,1,1,2
25466_0,,,,2,1,1,2
25468_0,,,,2,1,1,2
C1(C(COC(C=O)(CC1)O)O)=O,,,4,1,1,0,1
25469_0,,,,2,1,1,2
25471_0,,,,2,1,1,2
C(C1COC(C(CC1O)=O)O)=O,,,4,1,1,0,1
25472_0,,,,2,1,1,2
25473_0,,,,2,1,1,2
25474_0,,,,2,1,1,2
25475_0,,,,2,1,1,2
25476_0,,,,2,1,1,2
25478_0,,,,2,1,1,2
C(C1C(C(CC(O)OC1)O)=O)=O,,,4,1,1,0,1
25480_0,,,,2,1,1,2
C(C1COC(CC(C1O)=O)O)=O,,,4,1,1,0,1
25482_0,,,,2,1,1,2
C(C1COC(C(C(C1)=O)O)O)=O,,,4,1,1,0,1
25483_0,,,,2,1,1,2
25485_0,,,,2,1,1,2
C12C(C(C(C(C(O)O1)CO)O2)O)O,,,4,1,1,0,1
25487_0,,,,2,1,1,2
C1(C(CC(C(CO)C(O)O1)O)O)=O,,,4,1,1,0,1
25488_0,,,,2,1,1,2
25489_0,,,,2,1,1,2
25490_0,,,,2,1,1,2
25491_0,,,,2,1,1,2
25493_0,,,,2,1,1,2
C1(C(COC(C=O)(C(C1)O)O)O)=O,,,4,1,1,0,1
25494_0,,,,2,1,1,2
25496_0,,,,2,1,1,2
C1(C(C(C(C=O)(O)OCC1)O)O)=O,,,4,1,1,0,1
25498_0,,,,2,1,1,2
C(C1COC(C(C(C1O)O)=O)O)=O,,,4,1,1,0,1
25500_0,,,,2,1,1,2
C1(C(CC(CO)(O)OCC1)O)=O,,,4,1,1,0,1
25501_0,,,,2,1,1,2
25503_0,,,,2,1,1,2
C1(C(OCC(C(C1CO)O)=O)O)=O,,,4,1,1,0,1
25505_0,,,,2,1,1,2
C(C1(CCOC(C(C1O)=O)O)O)=O,,,4,1,1,0,1
25506_0,,,,2,1,1,2
25508_0,,,,2,1,1,2
C1(C(C(C(O)OCC1)(CO)O)O)=O,,,4,1,1,0,1
25510_0,,,,2,1,1,2
C1(C(O)OCCC(CO)(C1O)O)=O,,,4,1,1,0,1
25512_0,,,,2,1,1,2
C1(C(C(C(O)OC(C)C1)O)O)=O,,,4,1,1,0,1
25514_0,,,,2,1,1,2
C(C1C(C(OCC(C1O)=O)O)O)=O,,,4,1,1,0,1
25516_0,,,,2,1,1,2
C(C1CC(C(C(C(O1)O)=O)O)O)=O,,,4,1,1,0,1
25517_0,,,,2,1,1,2
25518_0,,,,2,1,1,2
25519_0,,,,2,1,1,2
25521_0,,,,2,1,1,2
C1(C(CO)C(C)OC(C(C1)=O)O)=O,,,4,1,1,0,1
25522_0,,,,2,1,1,2
25523_0,,,,2,1,1,2
25524_0,,,,2,1,1,2
25525_0,,,,2,1,1,2
25526_0,,,,2,1,1,2
25528_0,,,,2,1,1,2
C1(C(C(C)OC(C=O)(CC1)O)O)=O,,,4,1,1,0,1
25529_0,,,,2,1,1,2
25531_0,,,,2,1,1,2
C1(CC(C(C)=O)OC(CC1O)O)=O,,,4,1,1,0,1
25533_0,,,,2,1,1,2
C1(C(CC(C=O)(O)OC(C)C1)O)=O,,,4,1,1,0,1
25535_0,,,,2,1,1,2
C(CC1C(CC(CC(O1)O)O)=O)=O,,,4,1,1,0,1
25537_0,,,,2,1,1,2
C(CC1CC(C(CC(O)O1)O)=O)=O,,,4,1,1,0,1
25539_0,,,,2,1,1,2
C(CC1CC(CC(C(O)O1)=O)O)=O,,,4,1,1,0,1
25541_0,,,,2,1,1,2
C(C1C(CC(C(O)OC1C)=O)O)=O,,,4,1,1,0,1
25542_0,,,,2,1,1,2
25543_0,,,,2,1,1,2
25544_0,,,,2,1,1,2
25546_0,,,,2,1,1,2
C1(C(CC(O)OC(C)C1CO)=O)=O,,,4,1,1,0,1
25547_0,,,,2,1,1,2
25548_0,,,,2,1,1,2
25549_0,,,,2,1,1,2
25550_0,,,,2,1,1,2
25551_0,,,,2,1,1,2
25552_0,,,,2,1,1,2
25554_0,,,,2,1,1,2
C1(CC(CC(OC1C(C)=O)O)O)=O,,,4,1,1,0,1
25556_0,,,,2,1,1,2
C(CC1CC(C(CC(O)O1)=O)O)=O,,,4,1,1,0,1
25558_0,,,,2,1,1,2
C(C1C(C(CC(O)OC1C)O)=O)=O,,,4,1,1,0,1
25560_0,,,,2,1,1,2
C(C1C(C)OC(CC(C1O)=O)O)=O,,,4,1,1,0,1
25562_0,,,,2,1,1,2
C(C1C(CC(C)(CC(O1)O)O)=O)=O,,,4,1,1,0,1
25564_0,,,,2,1,1,2
C(CC1C(C(CCC(O)O1)=O)O)=O,,,4,1,1,0,1
25566_0,,,,2,1,1,2
C(CC1CCC(C(C(O)O1)O)=O)=O,,,4,1,1,0,1
25568_0,,,,2,1,1,2
C(C1C(C)OC(C(C(C1)=O)O)O)=O,,,4,1,1,0,1
25570_0,,,,2,1,1,2
C1(CC(C=O)OC(CC1(C)O)O)=O,,,4,1,1,0,1
25572_0,,,,2,1,1,2
C(CC1C(CC(CC(O)O1)=O)O)=O,,,4,1,1,0,1
25574_0,,,,2,1,1,2
C(CC1CC(CC(C(O)O1)O)=O)=O,,,4,1,1,0,1
25576_0,,,,2,1,1,2
C(C1C(CC(C(O)OC1C)O)=O)=O,,,4,1,1,0,1
25578_0,,,,2,1,1,2
C1(COC(C(C(C1O)O)=O)O)=O,,,4,1,1,0,1
25580_0,,,,2,1,1,2
C1(C(C(CO)OC(C(C1)O)O)O)=O,,,4,1,1,0,1
25582_0,,,,2,1,1,2
C1(C(C(C(O)OC(CO)C1)O)O)=O,,,4,1,1,0,1
25584_0,,,,2,1,1,2
C1(C(O)OC(CO)C(C(C1)O)O)=O,,,4,1,1,0,1
25586_0,,,,2,1,1,2
C(C1(CC(C(C(CO1)O)O)O)O)=O,,,4,1,1,0,1
25588_0,,,,2,1,1,2
C1C(C(C(CC(CO)(O)O1)O)O)O,,,4,1,1,0,1
25590_0,,,,2,1,1,2
CC1(C(C(C(C(CO1)O)O)O)O)O,,,4,1,1,0,1
25591_0,,,,2,1,1,2
25592_0,,,,2,1,1,2
25593_0,,,,2,1,1,2
25594_0,,,,2,1,1,2
25596_0,,,,2,1,1,2
C(C1COC(C(C(C1O)O)O)O)=O,,,4,1,1,0,1
25597_0,,,,2,1,1,2
25599_0,,,,2,1,1,2
C1(C(C(CC(C(O)O1)O)O)O)=O,,,4,1,1,0,1
25600_0,,,,2,1,1,2
25602_0,,,,2,1,1,2
C1(C(CCC(C(O)O1)O)O)=O,,,4,1,1,0,1
25603_0,,,,2,1,1,2
25604_0,,,,2,1,1,2
25605_0,,,,2,1,1,2
25607_0,,,,2,1,1,2
C1C(CC(C(C(O)O1)O)O)O,,,4,1,1,0,1
25608_0,,,,2,1,1,2
25609_0,,,,2,1,1,2
25610_0,,,,2,1,1,2
25611_0,,,,2,1,1,2
25612_0,,,,2,1,1,2
25613_0,,,,2,1,1,2
25615_0,,,,2,1,1,2
C1(C(CC(C(C(O)O1)O)O)O)=O,,,4,1,1,0,1
25616_0,,,,2,1,1,2
25617_0,,,,2,1,1,2
25618_0,,,,2,1,1,2
25619_0,,,,2,1,1,2
25620_0,,,,2,1,1,2
25621_0,,,,2,1,1,2
25622_0,,,,2,1,1,2
25623_0,,,,2,1,1,2
25625_0,,,,2,1,1,2
C1(C(C(C(CC(O)O1)O)O)=O)=O,,,4,1,1,0,1
25627_0,,,,2,1,1,2
C1(CC(C(C(C(O)O1)=O)O)O)=O,,,4,1,1,0,1
25629_0,,,,2,1,1,2
C1(COC(C(CO)(C(C1)O)O)O)=O,,,4,1,1,0,1
25631_0,,,,2,1,1,2
C(C1(COC(CC(C1O)O)O)O)=O,,,4,1,1,0,1
25633_0,,,,2,1,1,2
C(C1(COC(C(CC1O)O)O)O)=O,,,4,1,1,0,1
25635_0,,,,2,1,1,2
C(C1(C(OCC(CC1O)=O)O)O)=O,,,4,1,1,0,1
25636_0,,,,2,1,1,2
25637_0,,,,2,1,1,2
25638_0,,,,2,1,1,2
25640_0,,,,2,1,1,2
C1CC(C(C(C(O)O1)(CO)O)O)O,,,4,1,1,0,1
25642_0,,,,2,1,1,2
C(C1(C(CCC(O)OC1)=O)O)=O,,,4,1,1,0,1
25643_0,,,,2,1,1,2
25644_0,,,,2,1,1,2
25646_0,,,,2,1,1,2
C1C2(CC(C(C(O)O1)(CO)O2)O)O,,,4,1,1,0,1
25648_0,,,,2,1,1,2
C12CC(C(C(C(O)O1)(CO)O)O2)O,,,4,1,1,0,1
25650_0,,,,2,1,1,2
C(C1(C(O)OCCC(C1O)=O)O)=O,,,4,1,1,0,1
25652_0,,,,2,1,1,2
C(C1(C(CCC(O)OC1C)=O)O)=O,,,4,1,1,0,1
25653_0,,,,2,1,1,2
25654_0,,,,2,1,1,2
25655_0,,,,2,1,1,2
25656_0,,,,2,1,1,2
25658_0,,,,2,1,1,2
C(C1(CC(O)OCC(C1O)O)O)=O,,,4,1,1,0,1
25660_0,,,,2,1,1,2
C(C1(C(C(OCC(C1)=O)O)O)O)=O,,,4,1,1,0,1
25661_0,,,,2,1,1,2
25662_0,,,,2,1,1,2
25664_0,,,,2,1,1,2
C1(COC(C(CO)(CC1O)O)O)=O,,,4,1,1,0,1
25665_0,,,,2,1,1,2
25666_0,,,,2,1,1,2
25668_0,,,,2,1,1,2
C(C1(COC(C(C(C1)O)O)O)O)=O,,,4,1,1,0,1
25670_0,,,,2,1,1,2
C1(C(C(C(O)OCC1(C)O)O)O)=O,,,4,1,1,0,1
25672_0,,,,2,1,1,2
C(C1(COC(CC(C1)=O)O)O)=O,,,4,1,1,0,1
25674_0,,,,2,1,1,2
C(C1(COC(CC(C1)O)O)O)(O)=O,,,4,1,1,0,1
25675_0,,,,2,1,1,2
25676_0,,,,2,1,1,2
25678_0,,,,2,1,1,2
C1C(C(CC(C(O)O1)(CO)O)O)O,,,4,1,1,0,1
25680_0,,,,2,1,1,2
C(C1(CC(OCC(C1O)=O)O)O)=O,,,4,1,1,0,1
25682_0,,,,2,1,1,2
C1(C(C(C(C(C(O)O1)O)O)O)O)=O,,,4,1,1,0,1
25684_0,,,,2,1,1,2
C(C1(C(C)OC(CC(C1)=O)O)O)=O,,,4,1,1,0,1
25685_0,,,,2,1,1,2
25686_0,,,,2,1,1,2
25688_0,,,,2,1,1,2
C1C2C(C(C(C(O)O1)O2)O)O,,,4,1,1,0,1
25690_0,,,,2,1,1,2
C1(C2OC(CC(C1O)O2)O)=O,,,4,1,1,0,1
25691_0,,,,2,1,1,2
25692_0,,,,2,1,1,2
25693_0,,,,2,1,1,2
25694_0,,,,2,1,1,2
25695_0,,,,2,1,1,2
25696_0,,,,2,1,1,2
25698_0,,,,2,1,1,2
C12C(CC(C(C(O)O1)O)O2)O,,,4,1,1,0,1
25700_0,,,,2,1,1,2
C1(C(O)OC2CC(C1O2)O)=O,,,4,1,1,0,1
25702_0,,,,2,1,1,2
C(CC1C(COC(C(C1)=O)O)O)=O,,,4,1,2,0,2
25704_0,,,,2,1,1,2
C(C1C(CC(CO)CC(O1)O)=O)=O,,,4,1,1,0,1
25706_0,,,,2,1,1,2
C(CC1COC(C(C(C1)=O)O)O)=O,,,4,1,2,0,2
25708_0,,,,2,1,1,2
C(C1CC(OC(C(C1)=O)CO)O)=O,,,4,1,1,0,1
25710_0,,,,2,1,1,2
C(CC1C(O)OCC(C(C1)=O)O)=O,,,4,1,2,0,2
25712_0,,,,2,1,1,2
C1(C(CC(O)OCC1O)CC=O)=O,,,4,1,1,0,1
25714_0,,,,2,1,1,2
C(C(C1C(CCCC(O1)O)=O)O)=O,,,4,1,1,0,1
25716_0,,,,2,1,1,2
C(C(C1CC(OCC(C1)=O)O)O)=O,,,4,1,1,0,1
25718_0,,,,2,1,1,2
C(CC1C(C(OCC(C1)=O)O)O)=O,,,4,1,2,0,2
25719_0,,,,2,1,1,2
25720_0,,,,2,1,1,2
25721_0,,,,2,1,1,2
25722_0,,,,2,1,1,2
25723_0,,,,2,1,1,2
25724_0,,,,2,1,1,2
25725_0,,,,2,1,1,2
25726_0,,,,2,1,1,2
25727_0,,,,2,1,1,2
25728_0,,,,2,1,1,2
25729_0,,,,2,1,1,2
25730_0,,,,2,1,1,2
25731_0,,,,2,1,1,2
25732_0,,,,2,1,1,2
25733_0,,,,2,1,1,2
25734_0,,,,2,1,1,2
25735_0,,,,2,1,1,2
25736_0,,,,2,1,1,2
25737_0,,,,2,1,1,2
25738_0,,,,2,1,1,2
25739_0,,,,2,1,1,2
25740_0,,,,2,1,1,2
25741_0,,,,2,1,1,2
25742_0,,,,2,1,1,2
25743_0,,,,2,1,1,2
25744_0,,,,2,1,1,2
25745_0,,,,2,1,1,2
25746_0,,,,2,1,1,2
25747_0,,,,2,1,1,2
25748_0,,,,2,1,1,2
25749_0,,,,2,1,1,2
25750_0,,,,2,1,1,2
25751_0,,,,2,1,1,2
25752_0,,,,2,1,1,2
25753_0,,,,2,1,1,2
25754_0,,,,2,1,1,2
25755_0,,,,2,1,1,2
25756_0,,,,2,1,1,2
25757_0,,,,2,1,1,2
25758_0,,,,2,1,1,2
25759_0,,,,2,1,1,2
25760_0,,,,2,1,1,2
25761_0,,,,2,1,1,2
25762_0,,,,2,1,1,2
25763_0,,,,2,1,1,2
25764_0,,,,2,1,1,2
25765_0,,,,2,1,1,2
25766_0,,,,2,1,1,2
25766_1,,,,2,1,1,2
25767_0,,,,2,1,1,2
25768_0,,,,2,1,1,2
25769_0,,,,2,1,1,2
25770_0,,,,2,1,1,2
25771_0,,,,2,1,1,2
25772_0,,,,2,1,1,2
25773_0,,,,2,1,1,2
25774_0,,,,2,1,1,2
25775_0,,,,2,1,1,2
25776_0,,,,2,1,1,2
25777_0,,,,2,1,1,2
25778_0,,,,2,1,1,2
25778_1,,,,2,1,1,2
25779_0,,,,2,1,1,2
25780_0,,,,2,1,1,2
25781_0,,,,2,1,1,2
25782_0,,,,2,1,1,2
25783_0,,,,2,1,1,2
25784_0,,,,2,1,1,2
25785_0,,,,2,1,1,2
25786_0,,,,2,1,1,2
25787_0,,,,2,1,1,2
25788_0,,,,2,1,1,2
25789_0,,,,2,1,1,2
25790_0,,,,2,1,1,2
25791_0,,,,2,1,1,2
25792_0,,,,2,1,1,2
25793_0,,,,2,1,1,2
25794_0,,,,2,1,1,2
25795_0,,,,2,1,1,2
25796_0,,,,2,1,1,2
25797_0,,,,2,1,1,2
25798_0,,,,2,1,1,2
25799_0,,,,2,1,1,2
25800_0,,,,2,1,1,2
25801_0,,,,2,1,1,2
25802_0,,,,2,1,1,2
25803_0,,,,2,1,1,2
25804_0,,,,2,1,1,2
25805_0,,,,2,1,1,2
25806_0,,,,2,1,1,2
25807_0,,,,2,1,1,2
25808_0,,,,2,1,1,2
25809_0,,,,2,1,1,2
25810_0,,,,2,1,1,2
25811_0,,,,2,1,1,2
25812_0,,,,2,1,1,2
25813_0,,,,2,1,1,2
25814_0,,,,2,1,1,2
25815_0,,,,2,1,1,2
25816_0,,,,2,1,1,2
25817_0,,,,2,1,1,2
25818_0,,,,2,1,1,2
25819_0,,,,2,1,1,2
25820_0,,,,2,1,1,2
25821_0,,,,2,1,1,2
25822_0,,,,2,1,1,2
25823_0,,,,2,1,1,2
25824_0,,,,2,1,1,2
25825_0,,,,2,1,1,2
25826_0,,,,2,1,1,2
25827_0,,,,2,1,1,2
25828_0,,,,2,1,1,2
25829_0,,,,2,1,1,2
25830_0,,,,2,1,1,2
25831_0,,,,2,1,1,2
25832_0,,,,2,1,1,2
25833_0,,,,2,1,1,2
25834_0,,,,2,1,1,2
25835_0,,,,2,1,1,2
25836_0,,,,2,1,1,2
25837_0,,,,2,1,1,2
25838_0,,,,2,1,1,2
25839_0,,,,2,1,1,2
25840_0,,,,2,1,1,2
25841_0,,,,2,1,1,2
25842_0,,,,2,1,1,2
25843_0,,,,2,1,1,2
25844_0,,,,2,1,1,2
25845_0,,,,2,1,1,2
25846_0,,,,2,1,1,2
25847_0,,,,2,1,1,2
25848_0,,,,2,1,1,2
25849_0,,,,2,1,1,2
25850_0,,,,2,1,1,2
25851_0,,,,2,1,1,2
25852_0,,,,2,1,1,2
25853_0,,,,2,1,1,2
25854_0,,,,2,1,1,2
25855_0,,,,2,1,1,2
25856_0,,,,2,1,1,2
25857_0,,,,2,1,1,2
25858_0,,,,2,1,1,2
25859_0,,,,2,1,1,2
25860_0,,,,2,1,1,2
25861_0,,,,2,1,1,2
25862_0,,,,2,1,1,2
25863_0,,,,2,1,1,2
25864_0,,,,2,1,1,2
25865_0,,,,2,1,1,2
25866_0,,,,2,1,1,2
25867_0,,,,2,1,1,2
25868_0,,,,2,1,1,2
25869_0,,,,2,1,1,2
25870_0,,,,2,1,1,2
25871_0,,,,2,1,1,2
25872_0,,,,2,1,1,2
25873_0,,,,2,1,1,2
25874_0,,,,2,1,1,2
25875_0,,,,2,1,1,2
25876_0,,,,2,1,1,2
25877_0,,,,2,1,1,2
25878_0,,,,2,1,1,2
25879_0,,,,2,1,1,2
25880_0,,,,2,1,1,2
25881_0,,,,2,1,1,2
25882_0,,,,2,1,1,2
25883_0,,,,2,1,1,2
25884_0,,,,2,1,1,2
25885_0,,,,2,1,1,2
25886_0,,,,2,1,1,2
25887_0,,,,2,1,1,2
25888_0,,,,2,1,1,2
25889_0,,,,2,1,1,2
25890_0,,,,2,1,1,2
25891_0,,,,2,1,1,2
25892_0,,,,2,1,1,2
25893_0,,,,2,1,1,2
25894_0,,,,2,1,1,2
25895_0,,,,2,1,1,2
25896_0,,,,2,1,1,2
25897_0,,,,2,1,1,2
25898_0,,,,2,1,1,2
25899_0,,,,2,1,1,2
25900_0,,,,2,1,1,2
25901_0,,,,2,1,1,2
25902_0,,,,2,1,2,3
25903_0,,,,2,1,2,3
25904_0,,,,2,1,2,3
25905_0,,,,2,1,2,3
25906_0,,,,2,1,2,3
25907_0,,,,2,1,2,3
25908_0,,,,2,1,2,3
25909_0,,,,2,1,2,3
25910_0,,,,2,1,2,3
25911_0,,,,2,1,2,3
25912_0,,,,2,1,2,3
25913_0,,,,2,1,2,3
25914_0,,,,2,1,2,3
25915_0,,,,2,1,2,3
25916_0,,,,2,1,2,3
25917_0,,,,2,1,2,3
25919_0,,,,2,1,2,3
C(C1COC(C1O)=O)(CCO)=O,,,4,1,1,0,1
25920_0,,,,2,1,2,3
25921_0,,,,2,1,2,3
25923_0,,,,2,1,2,3
C1(C(CO)(CC(CO)O1)O)=O,,,4,1,1,0,1
25925_0,,,,2,1,2,3
C1(C(CCO1)(CC=O)O)=O,,,4,1,1,0,1
25927_0,,,,2,1,2,3
C1(C(C)(CC(C=O)O1)O)=O,,,4,1,1,0,1
25929_0,,,,2,1,2,3
C1(C(C=O)(CC(CO)O1)O)=O,,,4,1,1,0,1
25930_0,,,,2,1,2,3
25931_0,,,,2,1,2,3
25932_0,,,,2,1,2,3
25933_0,,,,2,1,2,3
25934_0,,,,2,1,2,3
25935_0,,,,2,1,2,3
25936_0,,,,2,1,2,3
25937_0,,,,2,1,2,3
25938_0,,,,2,1,2,3
25938_1,,,,2,1,2,3
25939_0,,,,2,1,2,3
25941_0,,,,2,1,2,3
C1(C(CC(C(C=O)O)O1)O)=O,,,4,1,1,0,1
25942_0,,,,2,1,2,3
25943_0,,,,2,1,2,3
25944_0,,,,2,1,2,3
25944_1,,,,2,1,2,3
25945_0,,,,2,1,2,3
25946_0,,,,2,1,2,3
25947_0,,,,2,1,2,3
25948_0,,,,2,1,2,3
25949_0,,,,2,1,2,3
25950_0,,,,2,1,2,3
25951_0,,,,2,1,2,3
25952_0,,,,2,1,2,3
25953_0,,,,2,1,2,3
25955_0,,,,2,1,2,3
C1(CC(C(C(C=O)=O)O1)O)=O,,,4,1,2,0,2
25956_0,,,,2,1,2,3
25957_0,,,,2,1,2,3
25958_0,,,,2,1,2,3
25959_0,,,,2,1,2,3
25960_0,,,,2,1,2,3
25961_0,,,,2,1,2,3
25962_0,,,,2,1,2,3
25963_0,,,,2,1,2,3
25965_0,,,,2,1,2,3
C1(C(C(CO1)O)=O)=O,,,4,1,1,0,1
25966_0,,,,2,1,2,3
25967_0,,,,2,1,2,3
25968_0,,,,2,1,1,2
25969_0,,,,2,1,1,2
25970_0,,,,2,1,2,3
25971_0,,,,2,1,2,3
25971_1,,,,2,1,2,3
25973_0,,,,2,1,2,3
C1(C(C(CO)(CO1)O)O)=O,,,4,1,1,0,1
25975_0,,,,2,1,2,3
C1(C(C(C(CO)O1)O)O)=O,,,4,1,1,0,1
25976_0,,,,2,1,2,3
25977_0,,,,2,1,2,3
25979_0,,,,2,1,2,3
C(CC1(COC(C1O)=O)O)=O,,,4,1,1,0,1
25981_0,,,,2,1,2,3
C1(C(C(C)(C(C=O)O1)O)O)=O,,,4,1,1,0,1
25982_0,,,,2,1,2,3
25984_0,,,,2,1,2,3
C1(C(C(C)(C(CO)O1)O)O)=O,,,4,1,1,0,1
25985_0,,,,2,1,2,3
25986_0,,,,2,1,2,3
25987_0,,,,2,1,2,3
25988_0,,,,2,1,1,2
25989_0,,,,2,1,1,2
25990_0,,,,2,1,2,3
25992_0,,,,2,1,2,3
C1(C(C(CO1)(CCO)O)O)=O,,,4,1,1,0,1
25994_0,,,,2,1,2,3
C1(C(C(C(C=O)O1)O)O)=O,,,4,1,1,0,1
25996_0,,,,2,1,2,3
C1(C(C(C)(CO1)O)O)=O,,,4,1,1,0,1
25998_0,,,,2,1,2,3
C1(C(CCO)(C(C)(CO1)O)O)=O,,,4,1,1,0,1
25999_0,,,,2,1,2,3
26001_0,,,,2,1,2,3
C1(C(C(C(C(C=O)O)O1)O)O)=O,,,4,1,1,0,1
26002_0,,,,2,1,2,3
26004_0,,,,2,1,2,3
C(C1(COC(C1O)=O)O)=O,,,4,1,1,0,1
26006_0,,,,2,1,2,3
C1(C(C(CO1)(C(CO)O)O)O)=O,,,4,1,1,0,1
26008_0,,,,2,1,2,3
C1(C(C(CO)(C(CO)O1)O)O)=O,,,4,1,1,0,1
26010_0,,,,2,1,2,3
C(C1(C(CO)OC(C1O)=O)O)=O,,,4,1,1,0,1
26012_0,,,,2,1,2,3
C1(C(C(CO1)O)(CCO)O)=O,,,4,1,1,0,1
26013_0,,,,2,1,2,3
26014_0,,,,2,1,1,2
26015_0,,,,2,1,1,2
26016_0,,,,2,1,1,2
26017_0,,,,2,1,1,2
26018_0,,,,2,1,2,3
26019_0,,,,2,1,2,3
26020_0,,,,2,1,1,2
26021_0,,,,2,1,1,2
26022_0,,,,2,1,1,2
26024_0,,,,2,1,2,3
[C]1(C(OC(C(CO)O)C1)=O)O,,,4,1,1,0,1
26026_0,,,,2,1,2,3
[C]1(C(OC(C(CO)O)C1O)=O)O,,,4,1,1,0,1
26028_0,,,,2,1,2,3
C1(C(CC(C(CO)=O)CO1)O)=O,,,4,1,1,0,1
26030_0,,,,2,1,2,3
C1(C(CO)(CC(CO1)O)O)=O,,,4,1,1,0,1
26031_0,,,,2,1,2,3
26033_0,,,,2,1,2,3
C1(C(C=O)(CC(CO1)O)O)=O,,,4,1,1,0,1
26034_0,,,,2,1,2,3
26035_0,,,,2,1,2,3
26036_0,,,,2,1,2,3
26037_0,,,,2,1,2,3
26038_0,,,,2,1,2,3
26039_0,,,,2,1,2,3
26040_0,,,,2,1,2,3
26041_0,,,,2,1,2,3
26042_0,,,,2,1,2,3
26044_0,,,,2,1,2,3
C1(C(CC(C(C=O)O1)O)O)=O,,,4,1,1,0,1
26045_0,,,,2,1,2,3
26046_0,,,,2,1,2,3
26047_0,,,,2,1,2,3
26048_0,,,,2,1,2,3
26050_0,,,,2,1,2,3
C1(CC(CC(C(O)=O)O1)O)=O,,,4,1,1,0,1
26051_0,,,,2,1,2,3
26052_0,,,,2,1,2,3
26053_0,,,,2,1,2,3
26054_0,,,,2,1,2,3
26056_0,,,,2,1,2,3
C1(C2C(CC(CO)(O2)O1)O)=O,,,4,1,1,0,1
26058_0,,,,2,1,2,3
C1(C2C(C(C(C)(O2)O1)O)O)=O,,,4,1,1,0,1
26059_0,,,,2,1,2,3
26060_0,,,,2,1,2,3
26061_0,,,,2,1,1,2
26063_0,,,,2,1,2,3
C1(C(C(C(CO1)O)O)O)=O,,,4,1,1,0,1
26065_0,,,,2,1,2,3
C1(C(C(C)(C(CO1)O)O)O)=O,,,4,1,1,0,1
26067_0,,,,2,1,2,3
C1(C(CC(C(C)=O)(CO1)O)O)=O,,,4,1,1,0,1
26068_0,,,,2,1,1,2
26070_0,,,,2,1,2,3
C(C1(CCOC(C1O)=O)O)=O,,,4,1,1,0,1
26072_0,,,,2,1,2,3
C1(C(C(CO)(CCO1)O)O)=O,,,4,1,1,0,1
26074_0,,,,2,1,2,3
C1(C(C(C(C(C=O)O1)O)O)O)=O,,,4,1,1,0,1
26076_0,,,,2,1,2,3
C1(C(C(C(CO1)=O)O)O)=O,,,4,1,1,0,1
26078_0,,,,2,1,2,3
C1(C(C(CO)(C(CO1)O)O)O)=O,,,4,1,1,0,1
26080_0,,,,2,1,2,3
C1(C(C(C(OC1CO)=O)O)O)=O,,,4,1,1,0,1
26082_0,,,,2,1,2,3
C(C1(C(COC(C1O)=O)O)O)=O,,,4,1,1,0,1
26083_0,,,,2,1,1,2
26084_0,,,,2,1,1,2
26085_0,,,,2,1,1,2
26086_0,,,,2,1,1,2
26087_0,,,,2,1,1,2
26088_0,,,,2,1,1,2
26090_0,,,,2,1,2,3
C1(C2CCC(CO)(O2)O1)=O,,,4,1,1,0,1
26092_0,,,,2,1,2,3
C1(C2CC(C(C)(O2)O1)O)=O,,,4,1,1,0,1
26093_0,,,,2,1,1,2
26095_0,,,,2,1,2,3
[C]1(C(OC(CO)C(C1)O)=O)O,,,4,1,1,0,1
26097_0,,,,2,1,2,3
[C]1(C(OC(CO)C(C1O)O)=O)O,,,4,1,1,0,1
26098_0,,,,2,1,2,3
26099_0,,,,2,1,2,3
26100_0,,,,2,1,2,3
26101_0,,,,2,1,2,3
26103_0,,,,2,1,2,3
C(C1COC(C(CC1O)O)=O)=O,,,4,1,1,0,1
26104_0,,,,2,1,2,3
26105_0,,,,2,1,2,3
26106_0,,,,2,1,2,3
26107_0,,,,2,1,2,3
26108_0,,,,2,1,2,3
26109_0,,,,2,1,2,3
26110_0,,,,2,1,2,3
26111_0,,,,2,1,2,3
26112_0,,,,2,1,2,3
26114_0,,,,2,1,2,3
C1(C(CC(CCO1)O)O)=O,,,4,1,1,0,1
26116_0,,,,2,1,2,3
C1(CC(C(C(C(O1)=O)O)O)O)=O,,,4,1,1,0,1
26117_0,,,,2,1,2,3
26118_0,,,,2,1,2,3
26119_0,,,,2,1,2,3
26120_0,,,,2,1,2,3
26122_0,,,,2,1,2,3
C1(CC2C(C(C(O2)O1)O)O)=O,,,4,1,1,0,1
26124_0,,,,2,1,2,3
C1(CC(CC(C(O1)=O)O)O)=O,,,4,1,1,0,1
26125_0,,,,2,1,2,3
26126_0,,,,2,1,2,3
26127_0,,,,2,1,2,3
26128_0,,,,2,1,2,3
26129_0,,,,2,1,2,3
26130_0,,,,2,1,2,3
26132_0,,,,2,1,2,3
C1(C(C2C(CC(O2)O1)O)O)=O,,,4,1,1,0,1
26133_0,,,,2,1,2,3
26135_0,,,,2,1,2,3
C1(C2C(C(CC(O2)O1)O)O)=O,,,4,1,1,0,1
26136_0,,,,2,1,2,3
26137_0,,,,2,1,2,3
26139_0,,,,2,1,2,3
C1(C(C(C(OCC1O)=O)O)O)=O,,,4,1,1,0,1
26140_0,,,,2,1,2,3
26142_0,,,,2,1,2,3
C1(C2CC(CC(O2)O1)O)=O,,,4,1,1,0,1
26144_0,,,,2,1,2,3
[C]1(C(OCC(C(C1)O)O)=O)O,,,4,1,1,0,1
26146_0,,,,2,1,2,3
[C]1(C(OCC(C(C1O)O)O)=O)O,,,4,1,1,0,1
26148_0,,,,2,1,1,2
C1(C(C(C(C(C=O)O)C1)O)O)=O,,,4,1,1,0,1
26149_0,,,,2,1,1,2
26150_0,,,,2,1,1,2
26151_0,,,,2,1,1,2
26152_0,,,,2,1,1,2
26153_0,,,,2,1,1,2
26154_0,,,,2,1,1,2
26155_0,,,,2,1,1,2
26156_0,,,,2,1,1,2
26158_0,,,,2,1,1,2
C1(C(C(C)(C(C(C=O)O)C1)O)O)=O,,,4,1,1,0,1
26159_0,,,,2,1,1,2
26160_0,,,,2,1,1,2
26161_0,,,,2,1,1,2
26162_0,,,,2,1,1,2
26163_0,,,,2,1,1,2
26164_0,,,,2,1,1,2
26165_0,,,,2,1,1,2
26166_0,,,,2,1,1,2
26167_0,,,,2,1,1,2
26168_0,,,,2,1,1,2
26170_0,,,,2,1,1,2
C(C1(C(CCC(C1O)=O)O)O)=O,,,4,1,1,0,1
26172_0,,,,2,1,1,2
C1(C(C(CC1)O)(C(C=O)O)O)=O,,,4,1,1,0,1
26173_0,,,,2,1,1,2
26174_0,,,,2,1,1,2
26176_0,,,,2,1,1,2
C(C1(C(CC(CO)C1(C)O)=O)O)=O,,,4,1,1,0,1
26177_0,,,,2,1,1,2
26178_0,,,,2,1,1,2
26180_0,,,,2,1,1,2
C(C1C(C)(C(C(C1)=O)(CO)O)O)=O,,,4,1,1,0,1
26181_0,,,,2,1,1,2
26182_0,,,,2,1,1,2
26184_0,,,,2,1,1,2
C(C1(C(CCC(C1O)=O)(C)O)O)=O,,,4,1,1,0,1
26185_0,,,,2,1,1,2
26187_0,,,,2,1,1,2
C1(C(C(CC1)(C)O)(C(C=O)O)O)=O,,,4,1,1,0,1
26188_0,,,,2,1,1,2
26189_0,,,,2,1,1,2
26190_0,,,,2,1,1,2
26191_0,,,,2,1,1,2
26193_0,,,,2,1,1,2
C(C1C(CC(C1)=O)O)(O)=O,,,4,1,1,0,1
26194_0,,,,2,1,1,2
26196_0,,,,2,1,1,2
C(C1(CCC(C1)=O)O)(O)=O,,,4,1,1,0,1
26198_0,,,,2,2,1,3
C1(C(C(C(C(CO)C1)O)O)O)=O,,,4,1,1,0,1
26200_0,,,,2,2,1,3
C1(C(C(C(C(CCO)C1)O)O)O)=O,,,4,1,1,0,1
26202_0,,,,2,2,1,3
C1(C(C(C(C(C(C)O)C1)O)O)O)=O,,,4,1,1,0,1
26204_0,,,,2,2,1,3
C(CC(C(C=O)CC(CO)=O)O)=O,,,4,1,1,0,1
26206_0,,,,2,2,1,3
C(CC(C=O)C(C=O)CO)(CO)=O,,,4,1,1,0,1
26208_0,,,,2,2,1,3
C(CO)(C(C(CC=O)O)CC=O)=O,,,4,1,1,0,1
26210_0,,,,2,2,1,3
C(CC(C(CO)=O)C(C=O)CO)=O,,,4,1,1,0,1
26212_0,,,,2,2,1,3
C(CC(CCC(C=O)=O)O)=O,,,4,1,1,0,1
26214_0,,,,2,2,1,3
C(C(CCC(C=O)=O)CO)=O,,,4,1,1,0,1
26216_0,,,,2,2,1,3
C(CC(CCC(CO)=O)O)=O,,,4,1,1,0,1
26218_0,,,,2,2,1,3
C(C(CO)CCC(CO)=O)=O,,,4,1,1,0,1
26220_0,,,,2,2,1,3
C(CC(C(C=O)CC=O)O)=O,,,4,1,1,0,1
26222_0,,,,2,2,1,3
C(CC(C=O)C(C=O)CO)=O,,,4,1,1,0,1
26224_0,,,,2,2,1,3
C(CC(CO)C(CC=O)O)(O)=O,,,4,1,2,0,2
26226_0,,,,2,2,1,3
C(C(CO)C(CO)CC(O)=O)=O,,,4,1,1,0,1
26228_0,,,,2,2,1,3
C(C(CCC(C=O)=O)C(C)O)=O,,,4,1,1,0,1
26230_0,,,,2,2,1,3
C(CC(CCCC(C=O)=O)O)=O,,,4,1,1,0,1
26232_0,,,,2,2,1,3
C(CC(C)(CCC(C=O)=O)O)=O,,,4,1,1,0,1
26234_0,,,,2,2,1,3
C(C(CCC(CO)=O)C(C)O)=O,,,4,1,1,0,1
26236_0,,,,2,2,1,3
C(CC(CCCC(CO)=O)O)=O,,,4,1,1,0,1
26238_0,,,,2,2,1,3
C(CC(C)(CCC(CO)=O)O)=O,,,4,1,1,0,1
26240_0,,,,2,2,1,3
C(CC(C=O)C(C=O)C(C)O)=O,,,4,1,1,0,1
26242_0,,,,2,2,1,3
C(CC(CC(C=O)CC=O)O)=O,,,4,1,1,0,1
26244_0,,,,2,2,1,3
C(CC(C)(C(C=O)CC=O)O)=O,,,4,1,1,0,1
26246_0,,,,2,2,1,3
C(C(C(CO)CC(O)=O)C(C)O)=O,,,4,1,1,0,1
26248_0,,,,2,2,1,3
C(CC(CO)CC(CC=O)O)(O)=O,,,4,1,1,0,1
26250_0,,,,2,2,1,3
C(CC(CO)C(C)(CC=O)O)(O)=O,,,4,1,1,0,1
26251_0,,,,2,2,1,3
26253_0,,,,2,2,1,3
C(C(C(CCCC(C=O)=O)O)O)=O,,,4,1,1,0,1
26255_0,,,,2,2,1,3
C(C(C(CCC(C=O)=O)(C)O)O)=O,,,4,1,1,0,1
26256_0,,,,2,2,1,3
26258_0,,,,2,2,1,3
C(C(C(CCCC(CO)=O)O)O)=O,,,4,1,1,0,1
26260_0,,,,2,2,1,3
C(C(C(CCC(CO)=O)(C)O)O)=O,,,4,1,1,0,1
26262_0,,,,2,2,1,3
C(CC(C=O)C(C=O)(C(C)O)O)=O,,,4,1,1,0,1
26264_0,,,,2,2,1,3
C(C(C(CC(C=O)CC=O)O)O)=O,,,4,1,1,0,1
26266_0,,,,2,2,1,3
C(C(C(C)(C(C=O)CC=O)O)O)=O,,,4,1,1,0,1
26267_0,,,,2,2,1,3
26268_0,,,,2,2,1,3
26270_0,,,,2,2,1,3
C(C(CCC(C=O)=O)C(CO)O)=O,,,4,1,1,0,1
26271_0,,,,2,2,1,3
26272_0,,,,2,2,1,3
26274_0,,,,2,2,1,3
C(C(CCC(CO)=O)C(CO)O)=O,,,4,1,1,0,1
26276_0,,,,2,2,1,3
C(CC(CO)(C(C=O)CC=O)O)=O,,,4,1,1,0,1
26278_0,,,,2,2,1,3
C(CC(C(C(C=O)CC=O)O)O)=O,,,4,1,1,0,1
26280_0,,,,2,2,1,3
C(CC(C=O)C(C=O)C(CO)O)=O,,,4,1,1,0,1
26282_0,,,,2,2,1,3
C(C(C)(CCC(C=O)=O)O)(O)=O,,,4,1,1,0,1
26284_0,,,,2,2,1,3
C(C(CCCC(C=O)=O)O)(O)=O,,,4,1,1,0,1
26286_0,,,,2,2,1,3
C(C(C)(CCC(CO)=O)O)(O)=O,,,4,1,1,0,1
26288_0,,,,2,2,1,3
C(C(CCCC(CO)=O)O)(O)=O,,,4,1,1,0,1
26290_0,,,,2,2,1,3
C(C(C)(C(C=O)CC=O)O)(O)=O,,,4,1,1,0,1
26292_0,,,,2,2,1,3
C(C(CC(C=O)CC=O)O)(O)=O,,,4,1,1,0,1
26294_0,,,,2,2,1,3
C(C(C)(C(CO)CC(O)=O)O)(O)=O,,,4,1,1,0,1
26296_0,,,,2,2,1,3
C(CC(CO)CC(C(O)=O)O)(O)=O,,,4,1,1,0,1
26298_0,,,,2,2,1,3
C(C(CO)(CCC(C=O)=O)O)(O)=O,,,4,1,1,0,1
26300_0,,,,2,2,1,3
C(C(C(CCC(C=O)=O)O)O)(O)=O,,,4,1,1,0,1
26301_0,,,,2,2,1,3
26303_0,,,,2,2,1,3
C(C(C(CCC(CO)=O)O)O)(O)=O,,,4,1,1,0,1
26305_0,,,,2,2,1,3
C(C(CO)(C(C=O)CC=O)O)(O)=O,,,4,1,1,0,1
26307_0,,,,2,2,1,3
C(C(C(C(C=O)CC=O)O)O)(O)=O,,,4,1,1,0,1
26309_0,,,,2,2,1,3
C(C=O)(CCC(C(C(C)=O)=O)O)=O,,,4,1,1,0,1
26311_0,,,,2,2,1,3
C(C=O)(CCCC(C(CO)=O)=O)=O,,,4,1,1,0,1
26313_0,,,,2,2,1,3
C(CO)(CCC(C(C(C)=O)=O)O)=O,,,4,1,1,0,1
26315_0,,,,2,2,1,3
C(CO)(CCCC(C(CO)=O)=O)=O,,,4,1,1,0,1
26317_0,,,,2,2,1,3
C(CC(C=O)C(C(C(C)=O)=O)O)=O,,,4,1,1,0,1
26319_0,,,,2,2,1,3
C(CC(C=O)CC(C(CO)=O)=O)=O,,,4,1,1,0,1
26321_0,,,,2,2,1,3
C(C=O)(C(C)(CCC(C=O)=O)O)=O,,,4,1,1,0,1
26323_0,,,,2,2,1,3
C(C=O)(CCCC(C(C=O)=O)O)=O,,,4,1,1,0,1
26325_0,,,,2,2,1,3
C(CO)(CCC(C(C=O)=O)(C)O)=O,,,4,1,1,0,1
26327_0,,,,2,2,1,3
C(CO)(CCCC(C(C=O)=O)O)=O,,,4,1,1,0,1
26329_0,,,,2,2,1,3
C(CC(C=O)C(C(C=O)=O)(C)O)=O,,,4,1,1,0,1
26331_0,,,,2,2,1,3
C(C(CC(C(C=O)=O)O)CC=O)=O,,,4,1,1,0,1
26332_0,,,,2,2,1,3
26334_0,,,,2,2,1,3
C(CO)(C(C)(CCC(C=O)=O)O)=O,,,4,1,1,0,1
26336_0,,,,2,2,1,3
C(CO)(C(CCCC(C=O)=O)O)=O,,,4,1,1,0,1
26338_0,,,,2,2,1,3
C(C(CCC(CO)=O)O)(C(C)O)=O,,,4,1,1,0,1
26340_0,,,,2,2,1,3
C(CO)(C(C)(CCC(CO)=O)O)=O,,,4,1,1,0,1
26342_0,,,,2,2,1,3
C(CO)(CCCC(C(CO)=O)O)=O,,,4,1,1,0,1
26344_0,,,,2,2,1,3
C(C(C(C=O)CC=O)O)(C(C)O)=O,,,4,1,1,0,1
26346_0,,,,2,2,1,3
C(CO)(C(C)(C(C=O)CC=O)O)=O,,,4,1,1,0,1
26347_0,,,,2,2,1,3
26349_0,,,,2,2,1,3
C(C(C=O)C(C=O)CC(CO)=O)=O,,,4,1,1,0,1
26351_0,,,,2,2,1,3
C(C(C=O)C(C(CO)=O)CC=O)=O,,,4,1,1,0,1
26353_0,,,,2,2,1,3
C(C(C=O)CCC(C=O)=O)=O,,,4,1,1,0,1
26355_0,,,,2,2,1,3
C(C(C=O)CCC(CO)=O)=O,,,4,1,1,0,1
26357_0,,,,2,2,1,3
C(C(C=O)C(C=O)CC=O)=O,,,4,1,1,0,1
26359_0,,,,2,2,1,3
C(C(C=O)C(C(C=O)=O)CC(C)=O)=O,,,4,1,1,0,1
26361_0,,,,2,2,1,3
C(C(C=O)C(C(C)=O)CC(C=O)=O)=O,,,4,1,1,0,1
26363_0,,,,2,2,1,3
C(C(C=O)C(CC=O)CC(C=O)=O)=O,,,4,1,2,0,2
26365_0,,,,2,2,1,3
C(C(C=O)C(C=O)CC(C(C)=O)=O)=O,,,4,1,1,0,1
26367_0,,,,2,2,1,3
C(C(C=O)C(C(C(C)=O)=O)CC=O)=O,,,4,1,1,0,1
26369_0,,,,2,2,1,3
C(C(C=O)C(C=O)CC(CC=O)=O)=O,,,4,1,1,0,1
26371_0,,,,2,2,1,3
C(C(C=O)C(C(CC=O)=O)CC=O)=O,,,4,1,1,0,1
26373_0,,,,2,2,1,3
C(C(C=O)CCC(CC(C=O)=O)=O)=O,,,4,1,1,0,1
26375_0,,,,2,2,1,3
C(C(C=O)CCC(C(CC=O)=O)=O)=O,,,4,1,1,0,1
26376_0,,,,2,2,1,3
26378_0,,,,2,2,1,3
C(C(C=O)C(CO)CC(O)=O)=O,,,4,1,1,0,1
26380_0,,,,2,2,1,3
C(C(CCC(C=O)=O)(CCO)O)=O,,,4,1,1,0,1
26382_0,,,,2,2,1,3
C(C(C(CCC(C=O)=O)CO)O)=O,,,4,1,1,0,1
26384_0,,,,2,2,1,3
C(C(CC(CCC(C=O)=O)O)O)=O,,,4,1,1,0,1
26385_0,,,,2,2,1,3
26387_0,,,,2,2,1,3
C(C(C(CCC(CO)=O)CO)O)=O,,,4,1,1,0,1
26389_0,,,,2,2,1,3
C(C(CC(CCC(CO)=O)O)O)=O,,,4,1,1,0,1
26391_0,,,,2,2,1,3
C(CC(C=O)C(C=O)(CCO)O)=O,,,4,1,1,0,1
26393_0,,,,2,2,1,3
C(C(C(CO)C(C=O)CC=O)O)=O,,,4,1,1,0,1
26395_0,,,,2,2,1,3
C(C(CC(C(C=O)CC=O)O)O)=O,,,4,1,1,0,1
26397_0,,,,2,2,1,3
C(C(CCCC(C(O)=O)=O)=O)=O,,,4,1,1,0,1
26399_0,,,,2,2,1,3
C(CO)(CCCC(C(O)=O)=O)=O,,,4,1,1,0,1
26401_0,,,,2,2,1,3
C(CC(C=O)CC(C(O)=O)=O)=O,,,4,1,1,0,1
26403_0,,,,2,2,1,3
C(CC(CO)CC(C(O)=O)=O)(O)=O,,,4,1,1,0,1
26404_0,,,,2,2,1,3
26405_0,,,,2,2,1,3
26407_0,,,,2,2,1,3
C(C(C=O)(C(C=O)CC=O)O)(O)=O,,,4,1,1,0,1
26409_0,,,,2,2,1,3
C(C=O)(CCC(C(C(O)=O)=O)O)=O,,,4,1,1,0,1
26411_0,,,,2,2,1,3
C(CO)(CCC(C(C(O)=O)=O)O)=O,,,4,1,1,0,1
26413_0,,,,2,2,1,3
C(CC(C=O)C(C(C(O)=O)=O)O)=O,,,4,1,1,0,1
26415_0,,,,2,2,1,3
C(C)(C(C(C=O)=O)CCC(C=O)=O)=O,,,4,1,1,0,1
26417_0,,,,2,2,1,3
C(CCCC(C=O)=O)(CC(C=O)=O)=O,,,4,1,2,0,2
26419_0,,,,2,2,1,3
C(CC(C=O)C(C(C)=O)C(C=O)=O)=O,,,4,1,1,0,1
26421_0,,,,2,2,1,3
C(CC(C=O)CC(CC(C=O)=O)=O)=O,,,4,1,1,0,1
26423_0,,,,2,2,1,3
C(C(C(C=O)=O)CCC(C=O)=O)=O,,,4,1,1,0,1
26425_0,,,,2,2,1,3
C(C(C(C=O)=O)CCC(CO)=O)=O,,,4,1,1,0,1
26427_0,,,,2,2,1,3
C(C(C(C=O)=O)C(C=O)CC=O)=O,,,4,1,1,0,1
26429_0,,,,2,2,1,3
C(C(C(C(C)=O)=O)CCC(C=O)=O)=O,,,4,1,1,0,1
26431_0,,,,2,2,1,3
C(CC(C(CCCC(C=O)=O)=O)=O)=O,,,4,1,2,0,2
26433_0,,,,2,2,1,3
C(C(C(C(C)=O)=O)C(C=O)CC=O)=O,,,4,1,1,0,1
26435_0,,,,2,2,1,3
C(CC(C(CC(C=O)CC=O)=O)=O)=O,,,4,1,1,0,1
26437_0,,,,2,2,1,3
C(C=O)(CCCC(C(C)=O)=O)=O,,,4,1,1,0,1
26439_0,,,,2,2,1,3
C(CO)(CCCC(C(C)=O)=O)=O,,,4,1,1,0,1
26440_0,,,,2,2,1,3
26442_0,,,,2,2,1,3
C(CC(CO)CC(C(C)=O)=O)(O)=O,,,4,1,1,0,1
26444_0,,,,2,2,1,3
C(CC(CCCC(C=O)=O)=O)=O,,,4,1,1,0,1
26446_0,,,,2,2,1,3
C(C(C(C)=O)CCC(C=O)=O)=O,,,4,1,1,0,1
26448_0,,,,2,2,1,3
C(CCCC(CO)=O)(CC=O)=O,,,4,1,1,0,1
26450_0,,,,2,2,1,3
C(C)(C(C=O)CCC(CO)=O)=O,,,4,1,1,0,1
26451_0,,,,2,2,1,3
26453_0,,,,2,2,1,3
C(C(C(C)=O)C(C=O)CC=O)=O,,,4,1,1,0,1
26455_0,,,,2,2,1,3
C(CC(CC(CO)CC(O)=O)=O)=O,,,4,1,1,0,1
26457_0,,,,2,2,1,3
C(CC(CO)C(C=O)C(C)=O)(O)=O,,,4,1,1,0,1
26459_0,,,,2,2,1,3
C1(COC(CCC(C=O)=O)(C1)O)=O,,,4,1,1,0,1
26461_0,,,,2,2,1,3
C1(COC(C1CCC(C=O)=O)O)=O,,,4,1,1,0,1
26463_0,,,,2,2,1,3
C1(C(CCC(C=O)=O)OC(C1)O)=O,,,4,1,1,0,1
26465_0,,,,2,2,1,3
C(CO)(CCC1(CC(CO1)=O)O)=O,,,4,1,1,0,1
26467_0,,,,2,2,1,3
C(CO)(CCC1C(COC1O)=O)=O,,,4,1,1,0,1
26469_0,,,,2,2,1,3
C1(C(CCC(CO)=O)OC(C1)O)=O,,,4,1,1,0,1
26471_0,,,,2,2,1,3
C1(COC(C(C=O)CC=O)(C1)O)=O,,,4,1,1,0,1
26473_0,,,,2,2,1,3
C1(COC(C1C(C=O)CC=O)O)=O,,,4,1,1,0,1
26475_0,,,,2,2,1,3
C1(C(C(C=O)CC=O)OC(C1)O)=O,,,4,1,1,0,1
26477_0,,,,2,2,1,3
C(CCCC(C=O)=O)(CCO)=O,,,4,1,1,0,1
26479_0,,,,2,2,1,3
C(C)(C(CCC(C=O)=O)CO)=O,,,4,1,1,0,1
26481_0,,,,2,2,1,3
C(C)(CC(CCC(C=O)=O)O)=O,,,4,1,1,0,1
26483_0,,,,2,2,1,3
C(CCO)(CCCC(CO)=O)=O,,,4,1,1,0,1
26485_0,,,,2,2,1,3
C(C)(C(CO)CCC(CO)=O)=O,,,4,1,1,0,1
26487_0,,,,2,2,1,3
C(C)(CC(CCC(CO)=O)O)=O,,,4,1,1,0,1
26489_0,,,,2,2,1,3
C(CC(C=O)CC=O)(CCO)=O,,,4,1,1,0,1
26491_0,,,,2,2,1,3
C(C)(C(CO)C(C=O)CC=O)=O,,,4,1,1,0,1
26493_0,,,,2,2,1,3
C(C)(CC(C(C=O)CC=O)O)=O,,,4,1,1,0,1
26495_0,,,,2,2,1,3
C(CC(CO)CC(CCO)=O)(O)=O,,,4,1,1,0,1
26497_0,,,,2,2,1,3
C(CC(CO)C(C(C)=O)CO)(O)=O,,,4,1,1,0,1
26499_0,,,,2,2,1,3
C(CC(CO)C(CC(C)=O)O)(O)=O,,,4,1,1,0,1
26501_0,,,,2,2,1,3
C(C(CCCC(C(C=O)=O)=O)=O)=O,,,4,1,1,0,1
26503_0,,,,2,2,1,3
C(CO)(CCCC(C(C=O)=O)=O)=O,,,4,1,1,0,1
26505_0,,,,2,2,1,3
C(CC(C=O)CC(C(C=O)=O)=O)=O,,,4,1,1,0,1
26507_0,,,,2,2,1,3
C(C=O)(CCC(C(C=CC=O)=O)O)=O,,,4,1,1,0,1
26509_0,,,,2,2,1,3
C(CC(C=O)C(C(C=CC=O)=O)O)=O,,,4,1,1,0,1
26511_0,,,,2,2,1,3
C(C(CC(C=O)CC(CO)=O)O)=O,,,4,1,1,0,1
26513_0,,,,2,2,1,3
C(CO)(C(CC(C=O)O)CC=O)=O,,,4,1,1,0,1
26515_0,,,,2,2,1,3
C(CC(C=O)C(C=O)(C)O)(CO)=O,,,4,1,1,0,1
26517_0,,,,2,2,1,3
C(CC(C(CO)=O)C(C=O)(C)O)=O,,,4,1,1,0,1
26518_0,,,,2,2,1,3
26519_0,,,,2,2,1,3
26520_0,,,,2,2,1,3
26522_0,,,,2,2,1,3
C(CO)(C(CCO)CC=O)=O,,,4,1,1,0,1
26524_0,,,,2,2,1,3
C(C(C(C)O)CC(CO)=O)=O,,,4,1,1,0,1
26526_0,,,,2,2,1,3
C(CO)(C(C(C)O)CC=O)=O,,,4,1,1,0,1
26528_0,,,,2,2,1,3
C(CC(C=O)CC(CO)=O)(O)=O,,,4,1,1,0,1
26530_0,,,,2,2,1,3
C(CC(C(CO)=O)CC=O)(O)=O,,,4,1,1,0,1
26532_0,,,,2,2,1,3
C=CC(C(CCC(C=O)=O)O)=O,,,4,1,1,0,1
26534_0,,,,2,2,1,3
C1(C(CCC(C=O)=O)C(CO1)O)=O,,,4,1,1,0,1
26536_0,,,,2,2,1,3
C1(CC(CO1)(CCC(C=O)=O)O)=O,,,4,1,1,0,1
26538_0,,,,2,2,1,3
C1(CC(C(CCC(C=O)=O)O1)O)=O,,,4,1,1,0,1
26540_0,,,,2,2,1,3
C(C(CCCC(C=O)=O)O)=O,,,4,1,1,0,1
26542_0,,,,2,2,1,3
C(C(C)(CCC(C=O)=O)O)=O,,,4,1,1,0,1
26544_0,,,,2,2,1,3
C(C(CCC(C(CO)O)O)=O)=O,,,4,1,1,0,1
26546_0,,,,2,2,1,3
C(C(CCC(CO)(CO)O)=O)=O,,,4,1,1,0,1
26548_0,,,,2,2,1,3
C(C(CCCO)=O)=O,,,4,1,1,0,1
26550_0,,,,2,2,1,3
C(C(CCCCO)=O)=O,,,4,1,1,0,1
26552_0,,,,2,2,1,3
C(C(CCC(C)O)=O)=O,,,4,1,1,0,1
26554_0,,,,2,2,1,3
C(CCCC(C=O)=O)(O)=O,,,4,1,1,0,1
26556_0,,,,2,2,1,3
C1(C(CCC(C=O)=O)OCC1O)=O,,,4,1,1,0,1
26558_0,,,,2,2,1,3
C1(COCC1(CCC(C=O)=O)O)=O,,,4,1,1,0,1
26560_0,,,,2,2,1,3
C1(COC(CCC(C=O)=O)C1O)=O,,,4,1,1,0,1
26562_0,,,,2,2,1,3
C1(C(CCC(C=O)=O)(O)OCC1)=O,,,4,1,1,0,1
26564_0,,,,2,2,1,3
C1(C(O)OCC1CCC(C=O)=O)=O,,,4,1,1,0,1
26566_0,,,,2,2,1,3
C1(C(O)OC(CCC(C=O)=O)C1)=O,,,4,1,1,0,1
26568_0,,,,2,2,1,3
C(C(CCC(C=O)=O)O)=CC(O)=O,,,4,1,1,0,1
26570_0,,,,2,2,1,3
C(C(C=C)(CCC(C=O)=O)O)(O)=O,,,4,1,1,0,1
26572_0,,,,2,2,1,3
C1(C(CCC(C=O)=O)(CCO1)O)=O,,,4,1,1,0,1
26574_0,,,,2,2,1,3
C1(C(C(CCC(C=O)=O)CO1)O)=O,,,4,1,1,0,1
26576_0,,,,2,2,1,3
C1(C(CC(CCC(C=O)=O)O1)O)=O,,,4,1,1,0,1
26578_0,,,,2,2,1,3
C(CO)(CCC(C(C=C)=O)O)=O,,,4,1,1,0,1
26580_0,,,,2,2,1,3
C(CC(C=O)C(C(C=C)=O)O)=O,,,4,1,1,0,1
26582_0,,,,2,2,1,3
C1(C(CCC(CO)=O)C(CO1)O)=O,,,4,1,1,0,1
26584_0,,,,2,2,1,3
C1(CC(CCC(CO)=O)(CO1)O)=O,,,4,1,1,0,1
26586_0,,,,2,2,1,3
C1(CC(C(CCC(CO)=O)O1)O)=O,,,4,1,1,0,1
26588_0,,,,2,2,1,3
C(C(CCCC(CO)=O)O)=O,,,4,1,1,0,1
26590_0,,,,2,2,1,3
C(C(C)(CCC(CO)=O)O)=O,,,4,1,1,0,1
26592_0,,,,2,2,1,3
C(CO)(CCC(C(CO)O)O)=O,,,4,1,1,0,1
26594_0,,,,2,2,1,3
C(CO)(CCC(CO)(CO)O)=O,,,4,1,1,0,1
26596_0,,,,2,2,1,3
C(CO)(CCCO)=O,,,4,1,1,0,1
26598_0,,,,2,2,1,3
C(CO)(CCCCO)=O,,,4,1,1,0,1
26600_0,,,,2,2,1,3
C(CO)(CCC(C)O)=O,,,4,1,1,0,1
26602_0,,,,2,2,1,3
C(CCCC(CO)=O)(O)=O,,,4,1,1,0,1
26604_0,,,,2,2,1,3
C1(C(CCC(CO)=O)OCC1O)=O,,,4,1,1,0,1
26606_0,,,,2,2,1,3
C(CO)(CCC1(C(COC1)=O)O)=O,,,4,1,1,0,1
26608_0,,,,2,2,1,3
C(CO)(CCC1C(C(CO1)=O)O)=O,,,4,1,1,0,1
26610_0,,,,2,2,1,3
C1(C(CCC(CO)=O)(O)OCC1)=O,,,4,1,1,0,1
26612_0,,,,2,2,1,3
C(CO)(CCC1C(C(O)OC1)=O)=O,,,4,1,1,0,1
26614_0,,,,2,2,1,3
C(CO)(CCC1CC(C(O)O1)=O)=O,,,4,1,1,0,1
26616_0,,,,2,2,1,3
C(CO)(CCC(C=CC(O)=O)O)=O,,,4,1,1,0,1
26618_0,,,,2,2,1,3
C(CC(CO)C(C(C=C)=O)O)(O)=O,,,4,1,1,0,1
26620_0,,,,2,2,1,3
C(C(C=C)(CCC(CO)=O)O)(O)=O,,,4,1,1,0,1
26622_0,,,,2,2,1,3
C1(C(CCC(CO)=O)(CCO1)O)=O,,,4,1,1,0,1
26624_0,,,,2,2,1,3
C1(C(C(CCC(CO)=O)CO1)O)=O,,,4,1,1,0,1
26626_0,,,,2,2,1,3
C1(C(CC(CCC(CO)=O)O1)O)=O,,,4,1,1,0,1
26628_0,,,,2,2,1,3
C1(C(C(CO1)O)C(C=O)CC=O)=O,,,4,1,1,0,1
26630_0,,,,2,2,1,3
C1(CC(CO1)(C(C=O)CC=O)O)=O,,,4,1,1,0,1
26632_0,,,,2,2,1,3
C1(CC(C(C(C=O)CC=O)O1)O)=O,,,4,1,1,0,1
26633_0,,,,2,2,1,3
26635_0,,,,2,2,1,3
C(CC(C=O)C(C=O)(C)O)=O,,,4,1,1,0,1
26637_0,,,,2,2,1,3
C(C(C(C(CO)O)O)CC=O)=O,,,4,1,1,0,1
26639_0,,,,2,2,1,3
C(C(C(CO)(CO)O)CC=O)=O,,,4,1,1,0,1
26640_0,,,,2,2,1,3
26641_0,,,,2,2,1,3
26643_0,,,,2,2,1,3
C(C(C(C)O)CC=O)=O,,,4,1,1,0,1
26645_0,,,,2,2,1,3
C(CC(C=O)CC(O)=O)=O,,,4,1,1,0,1
26647_0,,,,2,2,1,3
C(CC(C=O)C1C(C(CO1)O)=O)=O,,,4,1,1,0,1
26649_0,,,,2,2,1,3
C1(COCC1(C(C=O)CC=O)O)=O,,,4,1,1,0,1
26651_0,,,,2,2,1,3
C(C(C1C(C(CO1)=O)O)CC=O)=O,,,4,1,1,0,1
26653_0,,,,2,2,1,3
C(CC(C=O)C1(C(CCO1)=O)O)=O,,,4,1,1,0,1
26655_0,,,,2,2,1,3
C1(C(O)OCC1C(C=O)CC=O)=O,,,4,1,1,0,1
26657_0,,,,2,2,1,3
C(CC(C=O)C1CC(C(O)O1)=O)=O,,,4,1,1,0,1
26659_0,,,,2,2,1,3
C(CC(C=O)C(C=CC(O)=O)O)=O,,,4,1,1,0,1
26661_0,,,,2,2,1,3
C(C(C=C)(C(C=O)CC=O)O)(O)=O,,,4,1,1,0,1
26663_0,,,,2,2,1,3
C1(C(CCO1)(C(C=O)CC=O)O)=O,,,4,1,1,0,1
26665_0,,,,2,2,1,3
C1(C(C(CO1)C(C=O)CC=O)O)=O,,,4,1,1,0,1
26667_0,,,,2,2,1,3
C1(C(CC(C(C=O)CC=O)O1)O)=O,,,4,1,1,0,1
26669_0,,,,2,2,1,3
C(CC(CO)CC(C=O)O)(O)=O,,,4,1,1,0,1
26671_0,,,,2,2,1,3
C(C(C)(C(CO)CC(O)=O)O)=O,,,4,1,1,0,1
26673_0,,,,2,2,1,3
C(C(CO)=O)(CC(CO)CO)=O,,,4,1,1,0,1
26675_0,,,,2,2,1,3
C(C(CO)=O)(CC(CO)CCO)=O,,,4,1,1,0,1
26677_0,,,,2,2,1,3
C(C(CO)=O)(CC(CO)C(C)O)=O,,,4,1,1,0,1
26679_0,,,,2,2,1,3
C(CC(CO)C(C(CO)=O)O)=O,,,4,1,1,0,1
26681_0,,,,2,2,1,3
C(CC(CCO)C(C(CO)=O)O)=O,,,4,1,1,0,1
26683_0,,,,2,2,1,3
C(CC(C(C)O)C(C(CO)=O)O)=O,,,4,1,1,0,1
26685_0,,,,2,2,1,3
C(CCCO)(C(C(CO)=O)O)=O,,,4,1,1,0,1
26687_0,,,,2,2,1,3
C(CCCCO)(C(C(CO)=O)O)=O,,,4,1,1,0,1
26689_0,,,,2,2,1,3
C(CCC(C)O)(C(C(CO)=O)O)=O,,,4,1,1,0,1
26690_0,,,,2,2,1,3
26692_0,,,,2,2,1,3
C(CO)(C(CCO)CC(CO)=O)=O,,,4,1,1,0,1
26693_0,,,,2,2,1,3
26695_0,,,,2,2,1,3
C(CC(CO)C(C(CO)O)O)(O)=O,,,4,1,2,0,2
26697_0,,,,2,2,1,3
C(CC(CO)C(CO)(CO)O)(O)=O,,,4,1,1,0,1
26699_0,,,,2,2,1,3
C(CO)(CC(CO)C(CO)O)=O,,,4,1,1,0,1
26701_0,,,,2,2,1,3
C(C(CO)O)(CC(CO)CO)=O,,,4,1,1,0,1
26703_0,,,,2,2,1,3
C(C(C(CO)O)O)(CCCO)=O,,,4,1,1,0,1
26705_0,,,,2,2,1,3
C(CC(CO)C(C(CO)O)O)=O,,,4,1,1,0,1
26707_0,,,,2,2,1,3
C(C(CC(CO)C(CO)O)=O)(O)=O,,,4,1,1,0,1
26709_0,,,,2,2,1,3
C(C(C(CC(CO)CO)=O)O)(O)=O,,,4,1,1,0,1
26711_0,,,,2,2,1,3
C(C(CO)CC(C(CO)O)=O)(O)=O,,,4,1,1,0,1
26713_0,,,,2,2,1,3
C(C(CO)CC(O)=O)(C(CO)O)=O,,,4,1,1,0,1
26715_0,,,,2,2,1,3
C(C(C(C(O)=O)O)O)(CCCO)=O,,,4,1,1,0,1
26716_0,,,,2,2,1,3
26718_0,,,,2,2,1,3
C(CC(CO)C(C(C(O)=O)O)O)=O,,,4,1,1,0,1
26720_0,,,,2,2,1,3
C(CC(CO)C(C(C=O)O)O)(O)=O,,,4,1,2,0,2
26722_0,,,,2,2,1,3
C1(CC(CO)C(C1(CO)O)O)=O,,,4,1,1,0,1
26724_0,,,,2,2,1,3
C(CC(C(C=O)=O)CO)(C)=O,,,4,1,1,0,1
26726_0,,,,2,2,1,3
C(C)(C(CO)CC(C=O)=O)=O,,,4,1,1,0,1
26728_0,,,,2,2,1,3
C(CC(CO)CC(C=O)=O)=O,,,4,1,2,0,2
26730_0,,,,2,2,1,3
C(C(CO)CC(C(C)=O)=O)=O,,,4,1,1,0,1
26731_0,,,,2,2,1,3
26733_0,,,,2,2,1,3
C(C(CO)CC(CC=O)=O)=O,,,4,1,1,0,1
26735_0,,,,2,2,1,3
C(C(CO)CC=O)(CC=O)=O,,,4,1,1,0,1
26737_0,,,,2,2,1,3
C(CCCO)(CC(C=O)=O)=O,,,4,1,1,0,1
26739_0,,,,2,2,1,3
C(CC(C(CCCO)=O)=O)=O,,,4,1,1,0,1
26740_0,,,,2,2,1,3
26742_0,,,,2,2,1,3
C(C(CO)CC(CCO)=O)(O)=O,,,4,1,1,0,1
26744_0,,,,2,2,1,3
C(C(CO)CC(O)=O)(CCO)=O,,,4,1,1,0,1
26746_0,,,,2,2,1,3
C(CC(CO)CC(CO)=O)(O)=O,,,4,1,2,0,2
26748_0,,,,2,2,1,3
C(CC(CO)C(C(C)=O)O)(O)=O,,,4,1,2,0,2
26749_0,,,,2,2,1,3
26751_0,,,,2,2,1,3
C(C(C(CO)CC(C)=O)O)(O)=O,,,4,1,1,0,1
26753_0,,,,2,2,1,3
C1(C(C(C(CO)C1CO)O)O)=O,,,4,1,1,0,1
26755_0,,,,2,2,1,3
C1(C(C(C(C1CCO)O)O)O)=O,,,4,1,1,0,1
26757_0,,,,2,2,1,3
C(C1C(C(C(C1CO)O)O)O)=O,,,4,1,1,0,1
26759_0,,,,2,2,1,3
C1(CC(CO)C(C(CO)O)O1)=O,,,4,1,1,0,1
26761_0,,,,2,2,1,3
C1(CC(CO)C(C(CO)O1)O)=O,,,4,1,1,0,1
26763_0,,,,2,2,1,3
C1(C(O)OC(CO)C(CO)C1)=O,,,4,1,1,0,1
26765_0,,,,2,2,1,3
C1(C(CO)OC(C(CO)C1)O)=O,,,4,1,1,0,1
26767_0,,,,2,2,1,3
C1(CC(CO)C(C(CO1)O)O)=O,,,4,1,1,0,1
26769_0,,,,2,2,1,3
C1(C(O)OCC(C(CO)C1)O)=O,,,4,1,1,0,1
26771_0,,,,2,2,1,3
C1(C(C(O)OCC(CO)C1)O)=O,,,4,1,1,0,1
26773_0,,,,2,2,1,3
C1(C(COC(C(CO)C1)O)O)=O,,,4,1,1,0,1
26775_0,,,,2,2,1,3
C1(COC(C(C(CO)C1)O)O)=O,,,4,1,1,0,1
26777_0,,,,2,2,1,3
C(CC(C(O)=O)O)(CCCO)=O,,,4,1,1,0,1
26779_0,,,,2,2,1,3
C(CC(CO)CC(C(O)=O)O)=O,,,4,1,1,0,1
26781_0,,,,2,2,1,3
C(C(C(CC(CO)CO)=O)=O)=O,,,4,1,1,0,1
26783_0,,,,2,2,1,3
C(CCCO)(C(C(C=O)=O)O)=O,,,4,1,1,0,1
26784_0,,,,2,2,1,3
26785_0,,,,2,2,1,3
26786_0,,,,2,2,1,3
26788_0,,,,2,2,1,3
C(CC(CO)CO)(O)=O,,,4,1,1,0,1
26790_0,,,,2,2,1,3
C(CO)(CC(C(CO)O)CCO)=O,,,4,1,1,0,1
26792_0,,,,2,2,1,3
C(CO)(CC(C(CO)O)C(C)O)=O,,,4,1,1,0,1
26794_0,,,,2,2,1,3
C(C(CO)O)(CC(CO)CCO)=O,,,4,1,1,0,1
26796_0,,,,2,2,1,3
C(C(CO)O)(CC(CO)C(C)O)=O,,,4,1,1,0,1
26798_0,,,,2,2,1,3
C(C(C(CO)O)O)(CCCCO)=O,,,4,1,1,0,1
26800_0,,,,2,2,1,3
C(C(C(CO)O)O)(CCC(C)O)=O,,,4,1,1,0,1
26802_0,,,,2,2,1,3
C(CC(CCO)C(C(CO)O)O)=O,,,4,1,1,0,1
26804_0,,,,2,2,1,3
C(CC(C(C(CO)O)O)C(C)O)=O,,,4,1,1,0,1
26806_0,,,,2,2,1,3
C1(CC(C(C1(CO)O)O)CCO)=O,,,4,1,1,0,1
26808_0,,,,2,2,1,3
C1(CC(C(C1(CO)O)O)C(C)O)=O,,,4,1,1,0,1
26810_0,,,,2,2,1,3
C(CC(C(C=O)=O)CCO)(C)=O,,,4,1,1,0,1
26812_0,,,,2,2,1,3
C(CC(C(C=O)=O)C(C)O)(C)=O,,,4,1,1,0,1
26814_0,,,,2,2,1,3
C(C)(C(CCO)CC(C=O)=O)=O,,,4,1,1,0,1
26816_0,,,,2,2,1,3
C(C)(C(C(C)O)CC(C=O)=O)=O,,,4,1,1,0,1
26818_0,,,,2,2,1,3
C(CC(CCO)CC(C=O)=O)=O,,,4,1,2,0,2
26820_0,,,,2,2,1,3
C(CC(C(C)O)CC(C=O)=O)=O,,,4,1,2,0,2
26822_0,,,,2,2,1,3
C(C(CCO)CC(C(C)=O)=O)=O,,,4,1,1,0,1
26824_0,,,,2,2,1,3
C(C(C(C)O)CC(C(C)=O)=O)=O,,,4,1,1,0,1
26826_0,,,,2,2,1,3
C(CC(C(C(C)=O)=O)CCO)=O,,,4,1,1,0,1
26828_0,,,,2,2,1,3
C(CC(C(C(C)=O)=O)C(C)O)=O,,,4,1,1,0,1
26830_0,,,,2,2,1,3
C(C(CCO)CC(CC=O)=O)=O,,,4,1,1,0,1
26832_0,,,,2,2,1,3
C(C(C(C)O)CC(CC=O)=O)=O,,,4,1,1,0,1
26834_0,,,,2,2,1,3
C(C(CCO)CC=O)(CC=O)=O,,,4,1,1,0,1
26836_0,,,,2,2,1,3
C(C(C(C)O)CC=O)(CC=O)=O,,,4,1,1,0,1
26838_0,,,,2,2,1,3
C(CCCCO)(CC(C=O)=O)=O,,,4,1,1,0,1
26840_0,,,,2,2,1,3
C(CCC(C)O)(CC(C=O)=O)=O,,,4,1,1,0,1
26842_0,,,,2,2,1,3
C(CC(C(CCCCO)=O)=O)=O,,,4,1,1,0,1
26844_0,,,,2,2,1,3
C(CC(C(CCC(C)O)=O)=O)=O,,,4,1,1,0,1
26845_0,,,,2,2,1,3
26846_0,,,,2,2,1,3
26848_0,,,,2,2,1,3
C(C(CCO)CC(CCO)=O)(O)=O,,,4,1,1,0,1
26850_0,,,,2,2,1,3
C(C(C(C)O)CC(CCO)=O)(O)=O,,,4,1,1,0,1
26852_0,,,,2,2,1,3
C(C(CCO)CC(O)=O)(CCO)=O,,,4,1,1,0,1
26854_0,,,,2,2,1,3
C(C(C(C)O)CC(O)=O)(CCO)=O,,,4,1,1,0,1
26856_0,,,,2,2,1,3
C(CC(CCO)CC(CO)=O)(O)=O,,,4,1,1,0,1
26858_0,,,,2,2,1,3
C(CC(C(C)O)CC(CO)=O)(O)=O,,,4,1,1,0,1
26860_0,,,,2,2,1,3
C(CC(CCO)C(C(C)=O)O)(O)=O,,,4,1,1,0,1
26862_0,,,,2,2,1,3
C(CC(C(C)O)C(C(C)=O)O)(O)=O,,,4,1,1,0,1
26864_0,,,,2,2,1,3
C(CC(C(CC=O)O)CCO)(O)=O,,,4,1,1,0,1
26866_0,,,,2,2,1,3
C(CC(C(CC=O)O)C(C)O)(O)=O,,,4,1,1,0,1
26868_0,,,,2,2,1,3
C(C(C(CCO)CC(C)=O)O)(O)=O,,,4,1,1,0,1
26870_0,,,,2,2,1,3
C(C(C(C(C)O)CC(C)=O)O)(O)=O,,,4,1,1,0,1
26872_0,,,,2,2,1,3
C1(C(C(C(CCO)C1CO)O)O)=O,,,4,1,1,0,1
26874_0,,,,2,2,1,3
C1(C(C(C(C(C)O)C1CO)O)O)=O,,,4,1,1,0,1
26876_0,,,,2,2,1,3
C1(C(C(C(C1CCCO)O)O)O)=O,,,4,1,1,0,1
26878_0,,,,2,2,1,3
C1(C(C(C(C1CC(C)O)O)O)O)=O,,,4,1,1,0,1
26880_0,,,,2,2,1,3
C(C1C(C(C(C1CCO)O)O)O)=O,,,4,1,1,0,1
26882_0,,,,2,2,1,3
C(C1C(C(C(C1C(C)O)O)O)O)=O,,,4,1,1,0,1
26884_0,,,,2,2,1,3
C1(CC(CCO)C(C(CO)O)O1)=O,,,4,1,1,0,1
26886_0,,,,2,2,1,3
C1(CC(C(C(CO)O)O1)C(C)O)=O,,,4,1,1,0,1
26888_0,,,,2,2,1,3
C1(CC(CCO)C(C(CO)O1)O)=O,,,4,1,1,0,1
26890_0,,,,2,2,1,3
C1(CC(C(C(CO)O1)O)C(C)O)=O,,,4,1,1,0,1
26892_0,,,,2,2,1,3
C1(C(O)OC(CO)C(CCO)C1)=O,,,4,1,1,0,1
26894_0,,,,2,2,1,3
C1(C(O)OC(CO)C(C(C)O)C1)=O,,,4,1,1,0,1
26896_0,,,,2,2,1,3
C1(C(CO)OC(C(CCO)C1)O)=O,,,4,1,1,0,1
26898_0,,,,2,2,1,3
C1(C(CO)OC(C(C(C)O)C1)O)=O,,,4,1,1,0,1
26900_0,,,,2,2,1,3
C1(CC(CCO)C(C(CO1)O)O)=O,,,4,1,1,0,1
26902_0,,,,2,2,1,3
C1(CC(C(C(CO1)O)O)C(C)O)=O,,,4,1,1,0,1
26904_0,,,,2,2,1,3
C1(C(O)OCC(C(CCO)C1)O)=O,,,4,1,1,0,1
26906_0,,,,2,2,1,3
C1(C(O)OCC(C(C(C)O)C1)O)=O,,,4,1,1,0,1
26908_0,,,,2,2,1,3
C1(C(C(O)OCC(CCO)C1)O)=O,,,4,1,1,0,1
26910_0,,,,2,2,1,3
C1(C(C(O)OCC(C(C)O)C1)O)=O,,,4,1,1,0,1
26912_0,,,,2,2,1,3
C1(C(COC(C(CCO)C1)O)O)=O,,,4,1,1,0,1
26914_0,,,,2,2,1,3
C1(C(COC(C(C(C)O)C1)O)O)=O,,,4,1,1,0,1
26916_0,,,,2,2,1,3
C1(COC(C(C(CCO)C1)O)O)=O,,,4,1,1,0,1
26918_0,,,,2,2,1,3
C1(COC(C(C(C(C)O)C1)O)O)=O,,,4,1,1,0,1
26920_0,,,,2,2,1,3
C(CC(C(O)=O)O)(CCCCO)=O,,,4,1,1,0,1
26922_0,,,,2,2,1,3
C(CC(C(O)=O)O)(CCC(C)O)=O,,,4,1,1,0,1
26924_0,,,,2,2,1,3
C(CC(CC(C(O)=O)O)CCO)=O,,,4,1,1,0,1
26926_0,,,,2,2,1,3
C(CC(CC(C(O)=O)O)C(C)O)=O,,,4,1,1,0,1
26928_0,,,,2,2,1,3
C(C(C(CC(CO)CCO)=O)=O)=O,,,4,1,1,0,1
26930_0,,,,2,2,1,3
C(C(C(CC(CO)C(C)O)=O)=O)=O,,,4,1,1,0,1
26932_0,,,,2,2,1,3
C(CCCCO)(C(C(C=O)=O)O)=O,,,4,1,1,0,1
26934_0,,,,2,2,1,3
C(CCC(C)O)(C(C(C=O)=O)O)=O,,,4,1,1,0,1
26936_0,,,,2,2,1,3
C(CC(C(C=O)=O)CCO)(CO)=O,,,4,1,1,0,1
26937_0,,,,2,2,1,3
26939_0,,,,2,2,1,3
C(CO)(C(CCO)CC(C=O)=O)=O,,,4,1,1,0,1
26940_0,,,,2,2,1,3
26942_0,,,,2,2,1,3
C(CC(CCO)C(C(C=O)=O)O)=O,,,4,1,1,0,1
26943_0,,,,2,2,1,3
26945_0,,,,2,2,1,3
C(CC(CO)CCO)(O)=O,,,4,1,1,0,1
26947_0,,,,2,2,1,3
C(CC(CO)C(C)O)(O)=O,,,4,1,1,0,1
26949_0,,,,2,2,1,3
C(CC(C(C=O)=O)CC(C)=O)(O)=O,,,4,1,1,0,1
26951_0,,,,2,2,1,3
C(CC(C(C)=O)CC(C=O)=O)(O)=O,,,4,1,1,0,1
26953_0,,,,2,2,1,3
C(CC(CC(O)=O)CC(C=O)=O)=O,,,4,1,2,0,2
26955_0,,,,2,2,1,3
C(C(CC(O)=O)CC(C(C)=O)=O)=O,,,4,1,1,0,1
26957_0,,,,2,2,1,3
C(CC(C(C(C)=O)=O)CC(O)=O)=O,,,4,1,1,0,1
26959_0,,,,2,2,1,3
C(CC(CC(C=O)CC(O)=O)=O)=O,,,4,1,1,0,1
26961_0,,,,2,2,1,3
C(CC(C(CC=O)CC(O)=O)=O)=O,,,4,1,1,0,1
26963_0,,,,2,2,1,3
C(CCCC(O)=O)(CC(C=O)=O)=O,,,4,1,1,0,1
26965_0,,,,2,2,1,3
C(CC(C(CCCC(O)=O)=O)=O)=O,,,4,1,1,0,1
26966_0,,,,2,2,1,3
26968_0,,,,2,2,1,3
C(CC(CO)CC(O)=O)(O)=O,,,4,1,1,0,1
26969_0,,,,2,2,1,3
26970_0,,,,2,2,1,3
26971_0,,,,2,2,1,3
26972_0,,,,2,2,1,3
26973_0,,,,2,2,1,3
26975_0,,,,2,2,1,3
C(C(C(C(C=O)=O)CC(C)=O)O)=O,,,4,1,1,0,1
26977_0,,,,2,2,1,3
C(C(C(C(C)=O)CC(C=O)=O)O)=O,,,4,1,1,0,1
26979_0,,,,2,2,1,3
C(CC(C(C=O)O)CC(C=O)=O)=O,,,4,1,2,0,2
26981_0,,,,2,2,1,3
C(C(C(C=O)CC(C(C)=O)=O)O)=O,,,4,1,1,0,1
26983_0,,,,2,2,1,3
C(CC(C(C(C)=O)=O)C(C=O)O)=O,,,4,1,1,0,1
26985_0,,,,2,2,1,3
C(CC(CC(C=O)C(C=O)O)=O)=O,,,4,1,1,0,1
26987_0,,,,2,2,1,3
C(CC(C(CC=O)C(C=O)O)=O)=O,,,4,1,1,0,1
26989_0,,,,2,2,1,3
C(CCC(C=O)O)(CC(C=O)=O)=O,,,4,1,1,0,1
26991_0,,,,2,2,1,3
C(CC(C(CCC(C=O)O)=O)=O)=O,,,4,1,1,0,1
26992_0,,,,2,2,1,3
26994_0,,,,2,2,1,3
C(CC(CO)C(C=O)O)(O)=O,,,4,1,1,0,1
26995_0,,,,2,2,1,3
26997_0,,,,2,2,1,3
C(CO)(CCC(C(CO)=O)O)=O,,,4,1,1,0,1
26998_0,,,,2,2,1,3
27000_0,,,,2,2,1,3
C(CC(CO)C(C(CO)=O)O)(O)=O,,,4,1,1,0,1
27001_0,,,,2,2,1,3
27003_0,,,,2,2,1,3
C(C(C(CCC(C=O)=O)O)O)=O,,,4,1,1,0,1
27004_0,,,,2,2,1,3
27006_0,,,,2,2,1,3
C(C(C(CCC(CO)=O)O)O)=O,,,4,1,1,0,1
27007_0,,,,2,2,1,3
27009_0,,,,2,2,1,3
C(C(C(C(C=O)CC=O)O)O)=O,,,4,1,1,0,1
27011_0,,,,2,2,1,3
C(C(CO)(C(CO)CC(O)=O)O)=O,,,4,1,1,0,1
27012_0,,,,2,2,1,3
27014_0,,,,2,2,1,3
C(C(CC(C=O)=O)CC(CO)=O)=O,,,4,1,1,0,1
27016_0,,,,2,2,1,3
C(CC(C(CO)=O)CC(C=O)=O)=O,,,4,1,2,0,2
27018_0,,,,2,2,1,3
C(C(CCCC(C=O)=O)=O)=O,,,4,1,1,0,1
27020_0,,,,2,2,1,3
C(CO)(CCCC(C=O)=O)=O,,,4,1,2,0,2
27021_0,,,,2,2,1,3
27023_0,,,,2,2,1,3
C(C)(CC(C(C=O)=O)CC(C=O)=O)=O,,,4,1,1,0,1
27025_0,,,,2,2,1,3
C(C)(C(CC(C=O)=O)CC(C=O)=O)=O,,,4,1,1,0,1
27027_0,,,,2,2,1,3
C(CC(CC(C=O)=O)CC(C=O)=O)=O,,,4,1,2,0,2
27029_0,,,,2,2,1,3
C(C(CC(C(C)=O)=O)CC(C=O)=O)=O,,,4,1,1,0,1
27031_0,,,,2,2,1,3
C(CC(C(C(C)=O)=O)CC(C=O)=O)=O,,,4,1,1,0,1
27033_0,,,,2,2,1,3
C(CC(CC(C=O)CC(C=O)=O)=O)=O,,,4,1,1,0,1
27035_0,,,,2,2,1,3
C(CC(C(CC=O)CC(C=O)=O)=O)=O,,,4,1,1,0,1
27036_0,,,,2,2,1,3
27037_0,,,,2,2,1,3
27038_0,,,,2,2,1,3
27040_0,,,,2,2,1,3
C(CC(CO)CC(C=O)=O)(O)=O,,,4,1,1,0,1
27042_0,,,,2,2,1,3
C(C(C(CO)=O)CCC(C=O)=O)=O,,,4,1,1,0,1
27044_0,,,,2,2,1,3
C(CC(C(CCC(C=O)=O)O)=O)=O,,,4,1,1,0,1
27046_0,,,,2,2,1,3
C(C(C(CO)=O)CCC(CO)=O)=O,,,4,1,1,0,1
27047_0,,,,2,2,1,3
27049_0,,,,2,2,1,3
C(C(C(CO)=O)C(C=O)CC=O)=O,,,4,1,1,0,1
27051_0,,,,2,2,1,3
C(CC(C(C(C=O)CC=O)O)=O)=O,,,4,1,1,0,1
27053_0,,,,2,2,1,3
C(C(C(C)=O)(CCC(C=O)=O)O)=O,,,4,1,1,0,1
27055_0,,,,2,2,1,3
C(C(C(CCCC(C=O)=O)=O)O)=O,,,4,1,1,0,1
27057_0,,,,2,2,1,3
C(C)(C(C=O)(CCC(CO)=O)O)=O,,,4,1,1,0,1
27059_0,,,,2,2,1,3
C(CCCC(CO)=O)(C(C=O)O)=O,,,4,1,1,0,1
27061_0,,,,2,2,1,3
C(C(C(C)=O)(C(C=O)CC=O)O)=O,,,4,1,1,0,1
27063_0,,,,2,2,1,3
C(C(C(CC(C=O)CC=O)=O)O)=O,,,4,1,1,0,1
27065_0,,,,2,2,1,3
C(C(CO)O)(CCCC(C=O)=O)=O,,,4,1,1,0,1
27067_0,,,,2,2,1,3
C(C)(C(CO)(CCC(C=O)=O)O)=O,,,4,1,1,0,1
27069_0,,,,2,2,1,3
C(C)(C(C(CCC(C=O)=O)O)O)=O,,,4,1,1,0,1
27071_0,,,,2,2,1,3
C(C(CO)O)(CCCC(CO)=O)=O,,,4,1,1,0,1
27073_0,,,,2,2,1,3
C(C)(C(CO)(CCC(CO)=O)O)=O,,,4,1,1,0,1
27075_0,,,,2,2,1,3
C(C)(C(C(CCC(CO)=O)O)O)=O,,,4,1,1,0,1
27076_0,,,,2,2,1,3
27078_0,,,,2,2,1,3
C(C)(C(CO)(C(C=O)CC=O)O)=O,,,4,1,1,0,1
27080_0,,,,2,2,1,3
C(C)(C(C(C(C=O)CC=O)O)O)=O,,,4,1,1,0,1
27082_0,,,,2,2,1,3
C(C=O)(C(CCC(C=O)=O)CO)=O,,,4,1,1,0,1
27084_0,,,,2,2,1,3
C(C(CCC(CC(C=O)=O)O)=O)=O,,,4,1,1,0,1
27086_0,,,,2,2,1,3
C(CO)(CCC(C(C=O)=O)CO)=O,,,4,1,1,0,1
27088_0,,,,2,2,1,3
C(CO)(CCC(CC(C=O)=O)O)=O,,,4,1,1,0,1
27090_0,,,,2,2,1,3
C(CC(C=O)C(C(C=O)=O)CO)=O,,,4,1,1,0,1
27092_0,,,,2,2,1,3
C(C(C(CC(C=O)=O)O)CC=O)=O,,,4,1,1,0,1
27094_0,,,,2,2,1,3
C(C(CCC(C=O)=O)O)(CCO)=O,,,4,1,1,0,1
27096_0,,,,2,2,1,3
C(CO)(C(CO)CCC(C=O)=O)=O,,,4,1,1,0,1
27098_0,,,,2,2,1,3
C(CO)(CC(CCC(C=O)=O)O)=O,,,4,1,1,0,1
27100_0,,,,2,2,1,3
C(C(CCC(CO)=O)O)(CCO)=O,,,4,1,1,0,1
27102_0,,,,2,2,1,3
C(CO)(C(CO)CCC(CO)=O)=O,,,4,1,1,0,1
27104_0,,,,2,2,1,3
C(CO)(CC(CCC(CO)=O)O)=O,,,4,1,1,0,1
27106_0,,,,2,2,1,3
C(C(C(C=O)CC=O)O)(CCO)=O,,,4,1,1,0,1
27108_0,,,,2,2,1,3
C(CO)(C(CO)C(C=O)CC=O)=O,,,4,1,1,0,1
27110_0,,,,2,2,1,3
C(CO)(CC(C(C=O)CC=O)O)=O,,,4,1,1,0,1
27112_0,,,,2,2,1,3
C(C(C=O)(CCC(C=O)=O)O)=O,,,4,1,1,0,1
27114_0,,,,2,2,1,3
C(C(C=O)(CCC(CO)=O)O)=O,,,4,1,1,0,1
27115_0,,,,2,2,1,3
27117_0,,,,2,2,1,3
C(C(C=O)(C(CO)CC(O)=O)O)=O,,,4,1,1,0,1
27119_0,,,,2,2,1,3
C(C(CC(CO)=O)CC(CO)=O)=O,,,4,1,1,0,1
27121_0,,,,2,2,1,3
C(C(CC(CO)=O)C(C(C)=O)O)=O,,,4,1,1,0,1
27122_0,,,,2,2,1,3
27124_0,,,,2,2,1,3
C(CC(C(CO)=O)C(C(C)=O)O)=O,,,4,1,1,0,1
27125_0,,,,2,2,1,3
27127_0,,,,2,2,1,3
C(C)(C(CCC(C=O)=O)O)=O,,,4,1,1,0,1
27129_0,,,,2,2,1,3
C(CO)(CCCC(CO)=O)=O,,,4,1,1,0,1
27131_0,,,,2,2,1,3
C(C)(C(CCC(CO)=O)O)=O,,,4,1,1,0,1
27132_0,,,,2,2,1,3
27133_0,,,,2,2,1,3
27134_0,,,,2,2,1,3
27135_0,,,,2,2,1,3
27137_0,,,,2,2,1,3
C(C(CCC(C=O)=O)(CC=O)O)=O,,,4,1,1,0,1
27139_0,,,,2,2,1,3
C(C(CCC(C=O)=O)C(C=O)O)=O,,,4,1,1,0,1
27140_0,,,,2,2,1,3
27142_0,,,,2,2,1,3
C(CO)(CCC(C=O)C(C=O)O)=O,,,4,1,1,0,1
27144_0,,,,2,2,1,3
C(CC(C=O)(C(C=O)CC=O)O)=O,,,4,1,1,0,1
27146_0,,,,2,2,1,3
C(CC(C=O)C(C=O)C(C=O)O)=O,,,4,1,1,0,1
27147_0,,,,2,2,1,3
27148_0,,,,2,2,1,3
27149_0,,,,2,2,1,3
27150_0,,,,2,2,1,3
27151_0,,,,2,2,1,3
27152_0,,,,2,2,1,3
27153_0,,,,2,2,1,3
27154_0,,,,2,2,1,3
27155_0,,,,2,2,1,3
27156_0,,,,2,2,1,3
27157_0,,,,2,2,1,3
27158_0,,,,2,2,1,3
27159_0,,,,2,2,1,3
27160_0,,,,2,2,1,3
27161_0,,,,2,2,1,3
27162_0,,,,2,2,1,3
27163_0,,,,2,2,1,3
27164_0,,,,2,2,1,3
27165_0,,,,2,2,1,3
27166_0,,,,2,2,1,3
27167_0,,,,2,2,1,3
27168_0,,,,2,2,1,3
27169_0,,,,2,2,1,3
27170_0,,,,2,2,1,3
27171_0,,,,2,2,1,3
27173_0,,,,2,2,1,3
C(CC(C(O)=O)CC=O)(CCO)=O,,,4,1,1,0,1
27175_0,,,,2,2,1,3
C(CC(C(CCO)=O)CC=O)(O)=O,,,4,1,1,0,1
27177_0,,,,2,2,1,3
C(CC(CC=O)CC(CO)=O)(O)=O,,,4,1,1,0,1
27179_0,,,,2,2,1,3
C(CC(C(C(C)=O)O)CC=O)(O)=O,,,4,1,1,0,1
27181_0,,,,2,2,1,3
C(CC(C(CC=O)O)CC=O)(O)=O,,,4,1,1,0,1
27183_0,,,,2,2,1,3
C(C(C(CC=O)CC(C)=O)O)(O)=O,,,4,1,1,0,1
27185_0,,,,2,2,1,3
C(CC1C(C(C(C1CO)=O)O)O)=O,,,4,1,1,0,1
27186_0,,,,2,2,1,3
27187_0,,,,2,2,1,3
27189_0,,,,2,2,1,3
C1(CC(C(C(CO)O)O1)CC=O)=O,,,4,1,1,0,1
27191_0,,,,2,2,1,3
C1(CC(C(C(CO)O1)O)CC=O)=O,,,4,1,1,0,1
27192_0,,,,2,2,1,3
27193_0,,,,2,2,1,3
27195_0,,,,2,2,1,3
C1(CC(C(C(CO1)O)O)CC=O)=O,,,4,1,1,0,1
27196_0,,,,2,2,1,3
27197_0,,,,2,2,1,3
27198_0,,,,2,2,1,3
27199_0,,,,2,2,1,3
27201_0,,,,2,2,1,3
C(CC(C(O)=O)O)(CCCC=O)=O,,,4,1,2,0,2
27203_0,,,,2,2,1,3
C(CC(CC(C(O)=O)O)CC=O)=O,,,4,1,2,0,2
27205_0,,,,2,2,1,3
C(CC(CO)CC(C(C=O)=O)=O)=O,,,4,1,1,0,1
27207_0,,,,2,2,1,3
C(CCCC(C(C(C=O)=O)O)=O)=O,,,4,1,2,0,2
27209_0,,,,2,2,1,3
C(CC(C(C=O)=O)CC(CO)=O)=O,,,4,1,2,0,2
27210_0,,,,2,2,1,3
27212_0,,,,2,2,1,3
C(CC(C(C(C=O)=O)O)CC=O)=O,,,4,1,2,0,2
27214_0,,,,2,2,1,3
C(CC(CO)CC=O)(O)=O,,,4,1,1,0,1
27216_0,,,,2,2,1,3
C(C=O)(CCC(C(C=O)=O)O)=O,,,4,1,1,0,1
27218_0,,,,2,2,1,3
C(CO)(CCC(C(C=O)=O)O)=O,,,4,1,1,0,1
27219_0,,,,2,2,1,3
27221_0,,,,2,2,1,3
C(CC(CO)C(C(C=O)=O)O)(O)=O,,,4,1,1,0,1
27222_0,,,,2,2,1,3
27224_0,,,,2,2,1,3
C(CO)(C(C(CO)O)CC=O)=O,,,4,1,1,0,1
27225_0,,,,2,2,1,3
27226_0,,,,2,2,1,3
27227_0,,,,2,2,1,3
27229_0,,,,2,2,1,3
C(CC(C(C=O)=O)C(CO)O)(C)=O,,,4,1,1,0,1
27231_0,,,,2,2,1,3
C(C)(C(C(CO)O)CC(C=O)=O)=O,,,4,1,1,0,1
27232_0,,,,2,2,1,3
27234_0,,,,2,2,1,3
C(C(C(CO)O)CC(C(C)=O)=O)=O,,,4,1,1,0,1
27236_0,,,,2,2,1,3
C(CC(C(C(C)=O)=O)C(CO)O)=O,,,4,1,1,0,1
27238_0,,,,2,2,1,3
C(C(C(CO)O)CC(CC=O)=O)=O,,,4,1,1,0,1
27240_0,,,,2,2,1,3
C(C(C(CO)O)CC=O)(CC=O)=O,,,4,1,1,0,1
27242_0,,,,2,2,1,3
C(CCC(CO)O)(CC(C=O)=O)=O,,,4,1,1,0,1
27244_0,,,,2,2,1,3
C(CC(C(CCC(CO)O)=O)=O)=O,,,4,1,1,0,1
27245_0,,,,2,2,1,3
27247_0,,,,2,2,1,3
C(CC(CO)C(CO)O)(O)=O,,,4,1,1,0,1
27249_0,,,,2,2,1,3
C(C(C(C=O)CC(CO)=O)O)(O)=O,,,4,1,1,0,1
27251_0,,,,2,2,1,3
C(C(C(C(CO)=O)CC=O)O)(O)=O,,,4,1,1,0,1
27252_0,,,,2,2,1,3
27253_0,,,,2,2,1,3
27254_0,,,,2,2,1,3
27256_0,,,,2,2,1,3
C(CC(CO)C(C(O)=O)O)(O)=O,,,4,1,1,0,1
27258_0,,,,2,2,1,3
C(C(CC(CO)C(CO)O)=O)=O,,,4,1,1,0,1
27259_0,,,,2,2,1,3
27261_0,,,,2,2,1,3
C(C(CC(C(CO)O)C(C)O)=O)=O,,,4,1,1,0,1
27262_0,,,,2,2,1,3
27263_0,,,,2,2,1,3
27264_0,,,,2,2,1,3
27265_0,,,,2,2,1,3
27266_0,,,,2,2,1,3
27267_0,,,,2,2,1,3
27268_0,,,,2,2,1,3
27269_0,,,,2,2,1,3
27270_0,,,,2,2,1,3
27272_0,,,,2,2,1,3
C(C(C(C=O)O)O)(CCCO)=O,,,4,1,1,0,1
27273_0,,,,2,2,1,3
27275_0,,,,2,2,1,3
C(C(C(C=O)O)O)(CCC(C)O)=O,,,4,1,1,0,1
27277_0,,,,2,2,1,3
C(C(C(CO)CC(CO)=O)O)=O,,,4,1,2,0,2
27278_0,,,,2,2,1,3
27280_0,,,,2,2,1,3
C(C(C(C(C)O)CC(CO)=O)O)=O,,,4,1,2,0,2
27282_0,,,,2,2,1,3
C(CC(CO)C(C(C=O)O)O)=O,,,4,1,1,0,1
27283_0,,,,2,2,1,3
27285_0,,,,2,2,1,3
C(CC(C(C(C=O)O)O)C(C)O)=O,,,4,1,1,0,1
27286_0,,,,2,2,1,3
27287_0,,,,2,1,1,2
27288_0,,,,2,1,1,2
27289_0,,,,2,1,2,3
27290_0,,,,2,1,2,3
27291_0,,,,2,1,2,3
27292_0,,,,2,1,2,3
27293_0,,,,2,1,2,3
27294_0,,,,2,1,2,3
27295_0,,,,2,1,2,3
27296_0,,,,2,1,2,3
27297_0,,,,2,1,2,3
27298_0,,,,2,1,2,3
27299_0,,,,2,1,2,3
27300_0,,,,2,1,2,3
27301_0,,,,2,1,2,3
27302_0,,,,2,1,2,3
27303_0,,,,2,1,2,3
27304_0,,,,2,1,2,3
27305_0,,,,2,1,2,3
27307_0,,,,2,1,1,2
C(C(C(C=C)=O)(CO)O)=O,,,4,1,1,0,1
27308_0,,,,2,1,2,3
27310_0,,,,2,1,2,3
C1(C=CC(C1O)=O)=O,,,4,1,1,0,1
27312_0,,,,2,1,1,2
C(C(O)OCC(C=C)=O)=O,,,4,1,1,0,1
27314_0,,,,2,1,1,2
C(C(C(C=C)=O)OCO)=O,,,4,1,1,0,1
27316_0,,,,2,1,1,2
C(CO)(OCC(C=C)=O)=O,,,4,1,1,0,1
27317_0,,,,2,1,2,3
27318_0,,,,2,1,2,3
27319_0,,,,2,1,2,3
27320_0,,,,2,1,2,3
27321_0,,,,2,1,2,3
27322_0,,,,2,1,2,3
27324_0,,,,2,1,2,3
C(C(C(CC=CC=O)=O)O)=O,,,4,1,1,0,1
27325_0,,,,2,1,2,3
27327_0,,,,2,1,2,3
C(CC=CC(C(C=O)O)=O)=O,,,4,1,1,0,1
27328_0,,,,2,1,2,3
27329_0,,,,2,1,2,3
27330_0,,,,2,1,2,3
27331_0,,,,2,1,2,3
27332_0,,,,2,1,2,3
27333_0,,,,2,1,2,3
27334_0,,,,2,1,2,3
27335_0,,,,2,1,2,3
27336_0,,,,2,1,2,3
27338_0,,,,2,1,2,3
C(CC=CC=O)=O,,,4,1,1,0,1
27339_0,,,,2,1,2,3
27340_0,,,,2,3,5,8
27341_0,,,,2,3,5,8
27342_0,,,,2,3,5,8
27343_0,,,,2,3,5,8
27344_0,,,,2,3,5,8
27345_0,,,,2,3,5,8
27346_0,,,,2,3,5,8
27347_0,,,,2,3,5,8
27348_0,,,,2,3,5,8
27349_0,,,,2,3,5,8
27350_0,,,,2,3,5,8
27351_0,,,,2,3,5,8
27352_0,,,,2,3,5,8
27353_0,,,,2,3,5,8
27354_0,,,,2,3,5,8
27355_0,,,,2,3,5,8
27356_0,,,,2,3,5,8
27357_0,,,,2,3,5,8
27358_0,,,,2,3,5,8
27359_0,,,,2,3,5,8
27360_0,,,,2,3,5,8
27361_0,,,,2,3,5,8
27362_0,,,,2,3,5,8
27363_0,,,,2,3,5,8
27364_0,,,,2,3,5,8
27365_0,,,,2,3,5,8
27366_0,,,,2,3,5,8
27367_0,,,,2,3,5,8
27368_0,,,,2,3,5,8
27369_0,,,,2,3,5,8
27370_0,,,,2,3,5,8
27371_0,,,,2,3,5,8
27372_0,,,,2,3,5,8
27374_0,,,,2,3,5,8
C(C(C(C(O)=O)=O)(C)O)=O,,,4,1,1,0,1
27376_0,,,,2,3,5,8
C(CC(C(C(O)=O)=O)(CO)O)=O,,,4,1,1,0,1
27378_0,,,,2,3,5,8
C(C(C(C(C(O)=O)=O)(C)O)O)=O,,,4,1,1,0,1
27380_0,,,,2,3,5,8
C(C(C(C)(C(CO)O)O)=O)(O)=O,,,4,1,1,0,1
27381_0,,,,2,3,5,8
27383_0,,,,2,3,5,8
C(C(C(C(O)=O)=O)(CCO)O)=O,,,4,1,1,0,1
27385_0,,,,2,3,5,8
C(C(C(CO)(CCO)O)=O)(O)=O,,,4,1,1,0,1
27386_0,,,,2,3,5,8
27388_0,,,,2,3,5,8
C(C(C(CO)(C)O)=O)(O)=O,,,4,1,1,0,1
27389_0,,,,2,3,5,8
27390_0,,,,2,3,5,8
27392_0,,,,2,3,5,8
C(CO)(C(C(C(O)=O)=O)O)=O,,,4,1,1,0,1
27394_0,,,,2,3,5,8
C(C(C(C(O)=O)=O)(CO)O)=O,,,4,1,1,0,1
27395_0,,,,2,3,5,8
27397_0,,,,2,3,5,8
C(C(CO)O)(C(C(C(O)=O)=O)O)=O,,,4,1,1,0,1
27399_0,,,,2,3,5,8
C(C(C(C(O)=O)=O)(C(CO)O)O)=O,,,4,1,1,0,1
27400_0,,,,2,3,5,8
27401_0,,,,2,3,5,8
27402_0,,,,2,3,5,8
27403_0,,,,2,3,5,8
27404_0,,,,2,3,5,8
27405_0,,,,2,5,3,8
27406_0,,,,2,5,3,8
27407_0,,,,2,5,3,8
27408_0,,,,2,5,3,8
27409_0,,,,2,5,3,8
27410_0,,,,2,5,3,8
27411_0,,,,2,5,3,8
27412_0,,,,2,5,3,8
27413_0,,,,2,5,3,8
27414_0,,,,2,5,3,8
27415_0,,,,2,5,3,8
27416_0,,,,2,5,3,8
27417_0,,,,2,5,3,8
27418_0,,,,2,5,3,8
27419_0,,,,2,5,3,8
27420_0,,,,2,5,3,8
27421_0,,,,2,2,2,4
27422_0,,,,2,2,2,4
27423_0,,,,2,2,2,4
27424_0,,,,2,2,2,4
27425_0,,,,2,2,2,4
27427_0,,,,2,2,2,4
C(C(CC(C=O)C(CO)=O)O)(O)=O,,,4,1,1,0,1
27429_0,,,,2,2,2,4
C(CC(C(CC(C(O)=O)O)O)=O)=O,,,4,1,1,0,1
27431_0,,,,2,2,2,4
C(CCC(C(O)=O)O)(C(C=O)O)=O,,,4,1,1,0,1
27432_0,,,,2,2,2,4
27433_0,,,,2,2,2,4
27434_0,,,,2,2,2,4
27435_0,,,,2,2,2,4
27437_0,,,,2,2,2,4
C(C(CC(C(C=O)=O)CO)O)(O)=O,,,4,1,1,0,1
27438_0,,,,2,2,2,4
27439_0,,,,2,2,2,4
27440_0,,,,2,2,2,4
27441_0,,,,2,2,2,4
27443_0,,,,2,2,2,4
C(C(CC(C=O)C(C=O)O)O)(O)=O,,,4,1,1,0,1
27445_0,,,,2,2,2,4
C(CCC(C(O)=O)O)=O,,,4,1,1,0,1
27446_0,,,,2,2,2,4
27447_0,,,,2,2,2,4
27448_0,,,,2,2,2,4
27449_0,,,,2,2,2,4
27450_0,,,,2,2,2,4
27451_0,,,,2,2,2,4
27452_0,,,,2,2,2,4
27453_0,,,,2,2,2,4
27454_0,,,,2,2,2,4
27455_0,,,,2,2,2,4
27457_0,,,,2,2,2,4
C(C(CC)O)(O)=O,,,4,1,1,0,1
27458_0,,,,2,2,2,4
27459_0,,,,2,2,2,4
27460_0,,,,2,2,2,4
27462_0,,,,2,2,2,4
C(C(COCC(C)=O)O)(O)=O,,,4,1,1,0,1
27464_0,,,,2,2,2,4
C(C(CCOC(C=O)O)O)(O)=O,,,4,1,1,0,1
27465_0,,,,2,2,2,4
27466_0,,,,2,2,2,4
27467_0,,,,2,2,2,4
27468_0,,,,2,2,2,4
27469_0,,,,2,2,2,4
27471_0,,,,2,2,2,4
C(C(CC(C=O)(C(C)=O)O)O)(O)=O,,,4,1,1,0,1
27472_0,,,,2,2,2,4
27474_0,,,,2,2,2,4
C(C(C=O)(CC(C(O)=O)O)O)=O,,,4,1,1,0,1
27475_0,,,,2,2,2,4
27476_0,,,,2,2,2,4
27478_0,,,,2,2,2,4
C(C(CC(C=O)(CC=O)O)O)(O)=O,,,4,1,1,0,1
27480_0,,,,2,2,2,4
C(C(CC(C(O)=O)O)O)(O)=O,,,4,1,1,0,1
27481_0,,,,2,2,2,4
27483_0,,,,2,2,2,4
C(C(CCOC(CO)=O)O)(O)=O,,,4,1,1,0,1
27484_0,,,,2,2,2,4
27485_0,,,,2,2,2,4
27486_0,,,,2,2,2,4
27487_0,,,,2,3,5,8
27488_0,,,,2,3,5,8
27489_0,,,,2,3,5,8
27490_0,,,,2,3,5,8
27491_0,,,,2,3,5,8
27492_0,,,,2,3,5,8
27493_0,,,,2,3,5,8
27494_0,,,,2,3,5,8
27495_0,,,,2,3,5,8
27496_0,,,,2,3,5,8
27497_0,,,,2,3,5,8
27498_0,,,,2,3,5,8
27499_0,,,,2,3,5,8
27501_0,,,,2,3,5,8
C(C(C(CO)=O)C(C=O)=O)=O,,,4,1,1,0,1
27502_0,,,,2,3,5,8
27503_0,,,,2,3,5,8
27504_0,,,,2,3,5,8
27505_0,,,,2,3,5,8
27506_0,,,,2,3,5,8
27507_0,,,,2,3,5,8
27508_0,,,,2,3,5,8
27509_0,,,,2,3,5,8
27510_0,,,,2,3,5,8
27511_0,,,,2,3,5,8
27512_0,,,,2,3,5,8
27513_0,,,,2,3,5,8
27514_0,,,,2,3,5,8
27515_0,,,,2,3,5,8
27516_0,,,,2,3,5,8
27518_0,,,,2,3,5,8
C(C(C(C(C=O)=O)O)=O)=O,,,4,1,1,0,1
27519_0,,,,2,3,5,8
27520_0,,,,2,3,5,8
27521_0,,,,2,3,5,8
27522_0,,,,2,3,5,8
27523_0,,,,2,3,5,8
27524_0,,,,2,3,5,8
27525_0,,,,2,3,5,8
27526_0,,,,2,3,5,8
27527_0,,,,2,3,5,8
27528_0,,,,2,3,5,8
27529_0,,,,2,3,5,8
27530_0,,,,2,3,5,8
27531_0,,,,2,3,5,8
27532_0,,,,2,3,5,8
27533_0,,,,2,3,5,8
27534_0,,,,2,3,5,8
27535_0,,,,2,3,5,8
27536_0,,,,2,3,5,8
27537_0,,,,2,3,5,8
27538_0,,,,2,3,5,8
27539_0,,,,2,3,5,8
27540_0,,,,2,3,5,8
27541_0,,,,2,3,5,8
27542_0,,,,2,3,5,8
27543_0,,,,2,3,5,8
27544_0,,,,2,3,5,8
27545_0,,,,2,3,5,8
27546_0,,,,2,3,5,8
27547_0,,,,2,3,5,8
27548_0,,,,2,3,5,8
27549_0,,,,2,3,5,8
27550_0,,,,2,3,5,8
27551_0,,,,2,3,5,8
27552_0,,,,2,3,5,8
27553_0,,,,2,3,5,8
27554_0,,,,2,3,5,8
27555_0,,,,2,3,5,8
27556_0,,,,2,3,5,8
27557_0,,,,2,3,5,8
27558_0,,,,2,3,5,8
27559_0,,,,2,3,5,8
27560_0,,,,2,3,5,8
27561_0,,,,2,3,5,8
27562_0,,,,2,3,5,8
27563_0,,,,2,3,5,8
27564_0,,,,2,3,5,8
27565_0,,,,2,3,5,8
27566_0,,,,2,3,5,8
27567_0,,,,2,3,5,8
27568_0,,,,2,3,5,8
27569_0,,,,2,3,5,8
27570_0,,,,2,3,5,8
27571_0,,,,2,3,5,8
27572_0,,,,2,3,5,8
27573_0,,,,2,3,5,8
27574_0,,,,2,3,5,8
27575_0,,,,2,3,5,8
27576_0,,,,2,3,5,8
27577_0,,,,2,3,5,8
27578_0,,,,2,3,5,8
27579_0,,,,2,3,5,8
27580_0,,,,2,3,5,8
27581_0,,,,2,3,5,8
27582_0,,,,2,3,5,8
27583_0,,,,2,3,5,8
27584_0,,,,2,3,5,8
27585_0,,,,2,3,5,8
27586_0,,,,2,3,5,8
27587_0,,,,2,3,5,8
27588_0,,,,2,3,5,8
27589_0,,,,2,3,5,8
27590_0,,,,2,3,5,8
27591_0,,,,2,3,5,8
27592_0,,,,2,3,5,8
27593_0,,,,2,3,5,8
27594_0,,,,2,3,5,8
27595_0,,,,2,3,5,8
27596_0,,,,2,3,5,8
27597_0,,,,2,3,5,8
27599_0,,,,2,3,5,8
C(COCC(C=O)=O)(CO)=O,,,4,1,1,0,1
27601_0,,,,2,3,5,8
C(C)(C(O)OCC(C=O)=O)=O,,,4,1,1,0,1
27602_0,,,,2,3,5,8
27603_0,,,,2,3,5,8
27605_0,,,,2,3,5,8
C(COC(C(C=O)=O)(C)O)=O,,,4,1,1,0,1
27607_0,,,,2,3,5,8
C(C(C(CO)OC(C=O)=O)O)=O,,,4,1,1,0,1
27609_0,,,,2,3,5,8
C(C(OC(C(C=O)=O)CO)O)=O,,,4,1,1,0,1
27611_0,,,,2,3,5,8
C(COC(CC(C=O)=O)O)=O,,,4,1,1,0,1
27613_0,,,,2,3,5,8
C(C(C(COC(C=O)=O)O)O)=O,,,4,1,1,0,1
27615_0,,,,2,3,5,8
C(C(O)OCC(C(C=O)=O)O)=O,,,4,1,1,0,1
27617_0,,,,2,3,5,8
C(C(O)OCC(C=O)=O)(CO)=O,,,4,1,1,0,1
27618_0,,,,2,3,5,8
27619_0,,,,2,3,5,8
27620_0,,,,2,3,5,8
27621_0,,,,2,3,5,8
27622_0,,,,2,3,5,8
27623_0,,,,2,3,5,8
27624_0,,,,2,3,5,8
27625_0,,,,2,3,5,8
27626_0,,,,2,3,5,8
27627_0,,,,2,3,5,8
27628_0,,,,2,3,5,8
27629_0,,,,2,3,5,8
27630_0,,,,2,3,5,8
27631_0,,,,2,3,5,8
27632_0,,,,2,3,5,8
27633_0,,,,2,3,5,8
27634_0,,,,2,3,5,8
27635_0,,,,2,3,5,8
27637_0,,,,2,3,5,8
C(C(C(C)=O)(C(C=O)=O)O)=O,,,4,1,1,0,1
27638_0,,,,2,3,5,8
27639_0,,,,2,3,5,8
27640_0,,,,2,3,5,8
27642_0,,,,2,3,5,8
C(C(C=O)(C(C=O)=O)O)=O,,,4,1,1,0,1
27643_0,,,,2,3,5,8
27644_0,,,,2,3,5,8
27645_0,,,,2,3,5,8
27647_0,,,,2,3,5,8
C(C(C(C(C=O)=O)(CO)O)=O)=O,,,4,1,1,0,1
27648_0,,,,2,3,5,8
27649_0,,,,2,3,5,8
27650_0,,,,2,3,5,8
27651_0,,,,2,3,5,8
27652_0,,,,2,3,5,8
27653_0,,,,2,3,5,8
27654_0,,,,2,3,5,8
27655_0,,,,2,3,5,8
27656_0,,,,2,3,5,8
27657_0,,,,2,3,5,8
27658_0,,,,2,3,5,8
27659_0,,,,2,3,5,8
27660_0,,,,2,3,5,8
27662_0,,,,2,3,5,8
C(C(C(C=O)=O)(CC(CO)=O)O)=O,,,4,1,1,0,1
27664_0,,,,2,3,5,8
C(C(C(C=O)=O)(CC=O)O)=O,,,4,1,1,0,1
27666_0,,,,2,3,5,8
C(C(C(C=O)=O)(CCO)O)(O)=O,,,4,1,1,0,1
27667_0,,,,2,3,5,8
27668_0,,,,2,3,5,8
27669_0,,,,2,3,5,8
27670_0,,,,2,3,5,8
27671_0,,,,2,3,5,8
27672_0,,,,2,3,5,8
27674_0,,,,2,3,5,8
C(CO)(OC(C(C=O)=O)CO)=O,,,4,1,1,0,1
27676_0,,,,2,3,5,8
C(CO)(OCC(C(C=O)=O)O)=O,,,4,1,1,0,1
27677_0,,,,2,3,5,8
27678_0,,,,2,3,5,8
27679_0,,,,2,3,5,8
27680_0,,,,2,3,5,8
27681_0,,,,2,3,5,8
27682_0,,,,2,3,5,8
27683_0,,,,2,3,5,8
27684_0,,,,2,3,5,8
27685_0,,,,2,3,5,8
27686_0,,,,2,3,5,8
27688_0,,,,2,3,5,8
C(C(C1(C(C(CO1)O)O)O)=O)=O,,,4,1,1,0,1
27689_0,,,,2,3,5,8
27690_0,,,,2,3,5,8
27691_0,,,,2,3,5,8
27692_0,,,,2,3,5,8
27693_0,,,,2,5,3,8
27694_0,,,,2,5,3,8
27695_0,,,,2,5,3,8
27696_0,,,,2,5,3,8
27697_0,,,,2,5,3,8
27698_0,,,,2,5,3,8
27699_0,,,,2,5,3,8
27700_0,,,,2,5,3,8
27701_0,,,,2,5,3,8
27702_0,,,,2,5,3,8
27703_0,,,,2,5,3,8
27704_0,,,,2,5,3,8
27705_0,,,,2,5,3,8
27706_0,,,,2,5,3,8
27707_0,,,,2,5,3,8
27708_0,,,,2,5,3,8
27709_0,,,,2,5,3,8
27710_0,,,,2,5,3,8
27711_0,,,,2,5,3,8
27712_0,,,,2,5,3,8
27713_0,,,,2,5,3,8
27714_0,,,,2,5,3,8
27715_0,,,,2,5,3,8
27716_0,,,,2,5,3,8
27717_0,,,,2,5,3,8
27718_0,,,,2,5,3,8
27719_0,,,,2,5,3,8
27720_0,,,,2,5,3,8
27721_0,,,,2,5,3,8
27722_0,,,,2,5,3,8
27723_0,,,,2,5,3,8
27724_0,,,,2,5,3,8
27725_0,,,,2,5,3,8
27726_0,,,,2,5,3,8
27727_0,,,,2,5,3,8
27728_0,,,,2,5,3,8
27729_0,,,,2,5,3,8
27730_0,,,,2,5,3,8
27731_0,,,,2,5,3,8
27732_0,,,,2,5,3,8
27733_0,,,,2,5,3,8
27734_0,,,,2,5,3,8
27735_0,,,,2,5,3,8
27736_0,,,,2,5,3,8
27737_0,,,,2,5,3,8
27738_0,,,,2,5,3,8
27739_0,,,,2,5,3,8
27740_0,,,,2,5,3,8
27741_0,,,,2,5,3,8
27742_0,,,,2,5,3,8
27743_0,,,,2,5,3,8
27744_0,,,,2,5,3,8
27745_0,,,,2,5,3,8
27746_0,,,,2,5,3,8
27747_0,,,,2,5,3,8
27748_0,,,,2,5,3,8
27749_0,,,,2,5,3,8
27750_0,,,,2,5,3,8
27751_0,,,,2,5,3,8
27752_0,,,,2,5,3,8
27753_0,,,,2,5,3,8
27754_0,,,,2,5,3,8
27755_0,,,,2,5,3,8
27756_0,,,,2,5,3,8
27757_0,,,,2,5,3,8
27758_0,,,,2,5,3,8
27759_0,,,,2,5,3,8
27760_0,,,,2,5,3,8
27761_0,,,,2,5,3,8
27763_0,,,,2,5,3,8
C(C(C(C(C)O)C(C(C)=O)O)O)=O,,,4,1,1,0,1
27764_0,,,,2,5,3,8
27765_0,,,,2,5,3,8
27766_0,,,,2,5,3,8
27767_0,,,,2,5,3,8
27768_0,,,,2,5,3,8
27769_0,,,,2,5,3,8
27770_0,,,,2,5,3,8
27771_0,,,,2,5,3,8
27772_0,,,,2,5,3,8
27773_0,,,,2,5,3,8
27774_0,,,,2,5,3,8
27776_0,,,,2,5,3,8
C(C(O)O)=O,,,4,1,1,0,1
27777_0,,,,2,5,3,8
27778_0,,,,2,5,3,8
27779_0,,,,2,5,3,8
27780_0,,,,2,5,3,8
27781_0,,,,2,5,3,8
27782_0,,,,2,5,3,8
27783_0,,,,2,5,3,8
27784_0,,,,2,5,3,8
27785_0,,,,2,5,3,8
27786_0,,,,2,5,3,8
27787_0,,,,2,5,3,8
27788_0,,,,2,5,3,8
27789_0,,,,2,5,3,8
27790_0,,,,2,5,3,8
27791_0,,,,2,5,3,8
27792_0,,,,2,5,3,8
27793_0,,,,2,5,3,8
27794_0,,,,2,5,3,8
27795_0,,,,2,5,3,8
27796_0,,,,2,5,3,8
27797_0,,,,2,5,3,8
27798_0,,,,2,5,3,8
27799_0,,,,2,5,3,8
27800_0,,,,2,5,3,8
27801_0,,,,2,5,3,8
27802_0,,,,2,5,3,8
27803_0,,,,2,5,3,8
27804_0,,,,2,5,3,8
27805_0,,,,2,5,3,8
27806_0,,,,2,5,3,8
27807_0,,,,2,5,3,8
27808_0,,,,2,5,3,8
27809_0,,,,2,5,3,8
27810_0,,,,2,5,3,8
27811_0,,,,2,5,3,8
27812_0,,,,2,5,3,8
27813_0,,,,2,5,3,8
27814_0,,,,2,5,3,8
27816_0,,,,2,5,3,8
C(C(C1CC(CO1)O)O)=O,,,4,1,1,0,1
27817_0,,,,2,5,3,8
27818_0,,,,2,5,3,8
27819_0,,,,2,5,3,8
27820_0,,,,2,5,3,8
27821_0,,,,2,5,3,8
27823_0,,,,2,5,3,8
C(CC(CC(C=O)O)C(CO)O)=O,,,4,1,1,0,1
27824_0,,,,2,4,4,8
27825_0,,,,2,4,4,8
27826_0,,,,2,4,4,8
27827_0,,,,2,4,4,8
27828_0,,,,2,4,4,8
27829_0,,,,2,4,4,8
27830_0,,,,2,4,4,8
27831_0,,,,2,4,4,8
27832_0,,,,2,4,4,8
27833_0,,,,2,4,4,8
27834_0,,,,2,4,4,8
27835_0,,,,2,4,4,8
27836_0,,,,2,4,4,8
27837_0,,,,2,4,4,8
27838_0,,,,2,4,4,8
27839_0,,,,2,4,4,8
27840_0,,,,2,4,4,8
27841_0,,,,2,4,4,8
27842_0,,,,2,4,4,8
27843_0,,,,2,4,4,8
27844_0,,,,2,4,4,8
27845_0,,,,2,4,4,8
27846_0,,,,2,4,4,8
27847_0,,,,2,4,4,8
27848_0,,,,2,4,4,8
27849_0,,,,2,4,4,8
27850_0,,,,2,4,4,8
27851_0,,,,2,4,4,8
27852_0,,,,2,4,4,8
27853_0,,,,2,4,4,8
27854_0,,,,2,4,4,8
27855_0,,,,2,4,4,8
27856_0,,,,2,4,4,8
27857_0,,,,2,4,4,8
27858_0,,,,2,4,4,8
27859_0,,,,2,4,4,8
27860_0,,,,2,4,4,8
27861_0,,,,2,4,4,8
27862_0,,,,2,4,4,8
27863_0,,,,2,4,4,8
27864_0,,,,2,4,4,8
27865_0,,,,2,4,4,8
27866_0,,,,2,4,4,8
27867_0,,,,2,4,4,8
27868_0,,,,2,4,4,8
27869_0,,,,2,4,4,8
27870_0,,,,2,4,4,8
27871_0,,,,2,4,4,8
27872_0,,,,2,4,4,8
27873_0,,,,2,4,4,8
27874_0,,,,2,4,4,8
27875_0,,,,2,4,4,8
27876_0,,,,2,4,4,8
27877_0,,,,2,4,4,8
27878_0,,,,2,4,4,8
27879_0,,,,2,4,4,8
27880_0,,,,2,4,4,8
27881_0,,,,2,4,4,8
27882_0,,,,2,4,4,8
27883_0,,,,2,4,4,8
27884_0,,,,2,4,4,8
27885_0,,,,2,4,4,8
27886_0,,,,2,4,4,8
27887_0,,,,2,4,4,8
27888_0,,,,2,4,4,8
27889_0,,,,2,4,4,8
27890_0,,,,2,4,4,8
27891_0,,,,2,4,4,8
27892_0,,,,2,4,4,8
27893_0,,,,2,4,4,8
27894_0,,,,2,4,4,8
27895_0,,,,2,4,4,8
27896_0,,,,2,4,4,8
27897_0,,,,2,4,4,8
27898_0,,,,2,4,4,8
27899_0,,,,2,4,4,8
27900_0,,,,2,4,4,8
27901_0,,,,2,4,4,8
27902_0,,,,2,4,4,8
27903_0,,,,2,4,4,8
27904_0,,,,2,4,4,8
27905_0,,,,2,4,4,8
27906_0,,,,2,4,4,8
27907_0,,,,2,4,4,8
27908_0,,,,2,4,4,8
27909_0,,,,2,4,4,8
27910_0,,,,2,4,4,8
27911_0,,,,2,4,4,8
27912_0,,,,2,4,4,8
27913_0,,,,2,4,4,8
27914_0,,,,2,4,4,8
27915_0,,,,2,4,4,8
27916_0,,,,2,4,4,8
27917_0,,,,2,4,4,8
27918_0,,,,2,4,4,8
27919_0,,,,2,4,4,8
27920_0,,,,2,4,4,8
27921_0,,,,2,4,4,8
27922_0,,,,2,4,4,8
27923_0,,,,2,4,4,8
27924_0,,,,2,4,4,8
27925_0,,,,2,4,4,8
27926_0,,,,2,4,4,8
27927_0,,,,2,4,4,8
27928_0,,,,2,4,4,8
27929_0,,,,2,4,4,8
27930_0,,,,2,4,4,8
27931_0,,,,2,4,4,8
27932_0,,,,2,4,4,8
27933_0,,,,2,4,4,8
27934_0,,,,2,4,4,8
27935_0,,,,2,4,4,8
27936_0,,,,2,4,4,8
27937_0,,,,2,4,4,8
27938_0,,,,2,4,4,8
27939_0,,,,2,4,4,8
27940_0,,,,2,4,4,8
27941_0,,,,2,4,4,8
27942_0,,,,2,4,4,8
27943_0,,,,2,4,4,8
27944_0,,,,2,4,4,8
27945_0,,,,2,4,4,8
27946_0,,,,2,4,4,8
27947_0,,,,2,4,4,8
27948_0,,,,2,4,4,8
27949_0,,,,2,4,4,8
27950_0,,,,2,4,4,8
27951_0,,,,2,4,4,8
27952_0,,,,2,4,4,8
27953_0,,,,2,4,4,8
27954_0,,,,2,4,4,8
27955_0,,,,2,4,4,8
27956_0,,,,2,4,4,8
27957_0,,,,2,4,4,8
27959_0,,,,2,4,3,7
C([C](C)O)(O)=O,,,4,1,1,0,1
27960_0,,,,2,4,3,7
27962_0,,,,2,4,3,7
C([C](CO)O)(O)=O,,,4,1,1,0,1
27964_0,,,,2,4,3,7
[C](C(O)=O)(C(CC(CO)O)O)O,,,4,1,1,0,1
27966_0,,,,2,4,3,7
[C](C(O)=O)(CCO)O,,,4,1,1,0,1
27967_0,,,,2,4,3,7
27968_0,,,,2,4,3,7
27969_0,,,,2,4,3,7
27970_0,,,,2,4,3,7
27971_0,,,,2,4,3,7
27972_0,,,,2,4,3,7
27973_0,,,,2,4,3,7
27974_0,,,,2,4,3,7
27975_0,,,,2,4,3,7
27976_0,,,,2,4,3,7
27977_0,,,,2,4,3,7
27979_0,,,,2,4,3,7
[C](C(O)=O)(C(CO)O)O,,,4,1,1,0,1
[OH-],,,0,1,0,169,169
