Id,Label,timeset,gen,type,weighted indegree,weighted outdegree,Weighted Degree
4_0,,,,2,1,2,3
C(CO)=O,,,1,1,362,565,927
C(C(C(CO)O)O)=O,,,1,1,41,47,88
4_1,,,,2,1,2,3
6_0,,,,2,1,1,2
C(CO)(C(C(C(CO)O)O)O)=O,,,1,1,14,12,26
9_0,,,,2,3,2,5
C(C(C(C(C(CO)O)O)O)O)(O)=O,,,1,1,799,13,812
C(C(C(C(C(CO)O)O)O)O)O,,,1,1,500,5,505
9_1,,,,2,3,2,5
11_0,,,,2,1,2,3
O,,,0,1,2983,2208,5191
C(C(CC(C(CO)O)O)=O)=O,,,1,1,16,18,34
13_0,,,,2,1,2,3
C(CC(C(C(CO)O)O)=O)=O,,,1,1,19,19,38
15_0,,,,2,1,2,3
C(C(C(CC(CO)O)=O)O)=O,,,1,1,16,16,32
17_0,,,,2,1,2,3
C(CC(C=O)O)(C(CO)O)=O,,,1,1,22,20,42
19_0,,,,2,1,2,3
C(C(C(C=O)O)O)(CCO)=O,,,1,1,23,22,45
21_0,,,,2,1,2,3
C(C(C(CC(CO)=O)O)O)=O,,,1,1,21,21,42
23_0,,,,2,1,2,3
C(C(C(C(C(C)=O)O)O)O)=O,,,1,1,21,21,42
25_0,,,,2,1,2,3
C(CC(C(C(C=O)O)O)O)=O,,,1,1,23,25,48
27_0,,,,2,1,1,2
C(C(C1C(C(C(O)O1)O)O)O)O,,,1,1,5,7,12
29_0,,,,2,1,1,2
C(C1C(C(C(C(O)O1)O)O)O)O,,,1,1,5,7,12
31_0,,,,2,1,1,2
C1C(C(C(C(C(O)O1)O)O)O)O,,,1,1,7,9,16
33_0,,,,2,1,1,2
C1(C(C(C(C1CO)O)O)O)=O,,,2,1,19,17,36
33_1,,,,2,1,1,2
35_0,,,,2,1,1,2
C1(C(C(C(C(C1)O)O)O)O)=O,,,2,1,17,16,33
35_1,,,,2,1,1,2
36_0,,,,2,1,1,2
38_0,,,,2,1,1,2
C(C1C(C(C(C1O)O)O)O)=O,,,2,1,11,12,23
38_1,,,,2,1,1,2
39_0,,,,2,2,1,3
39_1,,,,2,2,1,3
40_0,,,,2,2,1,3
C(C(C(C(C(CO)O)O)O)O)=O,,,0,1,15,1296,1311
40_1,,,,2,2,1,3
42_0,,,,2,2,1,3
C(C(CC(C(CO)O)O)O)(O)=O,,,2,1,10,10,20
42_1,,,,2,2,1,3
44_0,,,,2,1,2,3
C(C(C(C(C(CO)O)O)O)=O)=O,,,2,1,15,19,34
45_0,,,,2,1,2,3
45_1,,,,2,1,2,3
48_0,,,,2,1,2,3
C(CO)(CO)=O,,,2,1,90,186,276
C(C(CO)O)=O,,,2,1,126,195,321
48_1,,,,2,1,2,3
50_0,,,,2,1,2,3
C(C(C)=O)=O,,,2,1,151,419,570
52_0,,,,2,1,2,3
C(CC(CO)=O)=O,,,2,1,81,178,259
52_1,,,,2,1,2,3
54_0,,,,2,1,2,3
C(C(C(C)=O)O)=O,,,2,1,78,151,229
57_0,,,,2,1,2,3
C(C=O)=O,,,2,1,169,247,416
C(C)(C(CO)O)=O,,,2,1,70,124,194
60_0,,,,2,1,2,3
C(C(CC(CO)=O)O)=O,,,2,1,39,41,80
C=O,,,2,1,666,1551,2217
60_1,,,,2,1,2,3
62_0,,,,2,1,2,3
C(C(CCO)=O)=O,,,2,1,64,128,192
62_1,,,,2,1,2,3
64_0,,,,2,1,2,3
C(CO)(CCO)=O,,,2,1,72,148,220
64_1,,,,2,1,2,3
66_0,,,,2,1,2,3
C(C(C(C(C)=O)O)O)=O,,,2,1,45,43,88
67_0,,,,2,1,2,3
67_1,,,,2,1,2,3
70_0,,,,2,1,2,3
C(C(C=O)O)=O,,,2,1,99,188,287
C(C)(CO)=O,,,2,1,190,396,586
71_0,,,,2,1,2,3
71_1,,,,2,1,2,3
72_0,,,,2,1,2,3
72_1,,,,2,1,2,3
74_0,,,,2,1,2,3
C(CC(C=O)O)=O,,,2,1,82,154,236
74_1,,,,2,1,2,3
77_0,,,,2,1,2,3
C(C(C(C=O)O)O)=O,,,2,1,35,43,78
C(C)=O,,,2,1,283,1309,1592
78_0,,,,2,1,1,2
80_0,,,,2,1,1,2
C(CO)(C(CO)O)=O,,,2,1,56,67,123
81_0,,,,2,1,1,2
83_0,,,,2,1,1,2
C(C(C(CO)O)O)(C(CO)O)=O,,,2,1,15,13,28
85_0,,,,2,1,1,2
C(CC(C(C(CO)O)=O)O)=O,,,2,1,21,20,41
87_0,,,,2,1,1,2
C(C(CO)=O)(CC(CO)O)=O,,,2,1,15,15,30
89_0,,,,2,1,1,2
C(C(C(CC(CO)O)O)=O)=O,,,2,1,12,15,27
91_0,,,,2,1,1,2
C(C(CO)O)(CC(CO)=O)=O,,,2,1,19,17,36
93_0,,,,2,1,1,2
C(C(CC(C(CO)=O)O)O)=O,,,2,1,16,16,32
95_0,,,,2,1,1,2
C(CCO)(C(C(CO)=O)O)=O,,,2,1,16,14,30
97_0,,,,2,1,1,2
C(C(C(C(CCO)O)=O)O)=O,,,2,1,13,13,26
99_0,,,,2,1,1,2
C(CO)(C(CC(CO)=O)O)=O,,,2,1,21,19,40
101_0,,,,2,1,1,2
C(C(C(CC(C=O)O)O)O)=O,,,2,1,21,21,42
103_0,,,,2,1,1,2
C(C)(C(C(C(CO)=O)O)O)=O,,,2,1,24,21,45
105_0,,,,2,1,1,2
C(C(C(C=O)O)O)(C(C)O)=O,,,2,1,21,19,40
107_0,,,,2,1,1,2
C(CC(C(C(CO)=O)O)O)=O,,,2,1,21,21,42
109_0,,,,2,3,2,5
C(CO)O,,,2,1,4,16,20
111_0,,,,2,3,2,5
C(C(C(CO)O)O)O,,,2,1,4,3,7
113_0,,,,2,3,2,5
C(CO)(CC(C(CO)O)O)=O,,,2,1,16,14,30
115_0,,,,2,3,2,5
C(C(C(CO)O)O)(CCO)=O,,,2,1,18,15,33
117_0,,,,2,3,2,5
C(C(CO)O)(CC(CO)O)=O,,,2,1,18,15,33
118_0,,,,2,3,2,5
119_0,,,,2,3,2,5
120_0,,,,2,3,2,5
122_0,,,,2,3,2,5
C(C)(C(C(C(CO)O)O)O)=O,,,2,1,17,15,32
124_0,,,,2,3,2,5
C(CC(C(C(CO)O)O)O)=O,,,2,1,15,16,31
126_0,,,,2,3,2,5
C(C(C(C(CCO)O)O)O)=O,,,2,1,15,15,30
128_0,,,,2,3,2,5
C(CO)(O)=O,,,2,1,35,88,123
130_0,,,,2,3,2,5
C(C(C(CO)O)O)(O)=O,,,2,1,17,17,34
132_0,,,,2,3,2,5
C(C(CC(C(CO)O)O)=O)(O)=O,,,2,1,10,13,23
134_0,,,,2,3,2,5
C(CC(C(C(CO)O)O)=O)(O)=O,,,2,1,11,14,25
136_0,,,,2,3,2,5
C(C(C(CC(CO)O)=O)O)(O)=O,,,2,1,12,12,24
138_0,,,,2,3,2,5
C(CC(C(O)=O)O)(C(CO)O)=O,,,2,1,12,12,24
140_0,,,,2,3,2,5
C(C(C(C(O)=O)O)O)(CCO)=O,,,2,1,13,12,25
142_0,,,,2,3,2,5
C(C(C(CC(CO)=O)O)O)(O)=O,,,2,1,12,11,23
144_0,,,,2,3,2,5
C(C(C(C(C(C)=O)O)O)O)(O)=O,,,2,1,14,13,27
146_0,,,,2,3,2,5
C(CC(C(C(C(O)=O)O)O)O)=O,,,2,1,16,17,33
148_0,,,,2,3,2,5
C(CC(C(C(C=O)O)O)O)(O)=O,,,2,1,12,15,27
150_0,,,,2,1,1,2
C1(CC(C(C1(CO)O)O)O)=O,,,2,1,13,15,28
150_1,,,,2,1,1,2
152_0,,,,2,1,1,2
C(C1(C(C(CC1O)O)O)O)=O,,,2,1,12,16,28
152_1,,,,2,1,1,2
154_0,,,,2,2,1,3
C(C(C(CO)O)(C(CO)O)O)=O,,,2,1,7,9,16
154_1,,,,2,2,1,3
155_0,,,,2,1,2,3
156_0,,,,2,1,2,3
157_0,,,,2,1,2,3
158_0,,,,2,1,2,3
159_0,,,,2,1,2,3
160_0,,,,2,1,2,3
161_0,,,,2,1,2,3
162_0,,,,2,1,2,3
163_0,,,,2,1,2,3
164_0,,,,2,1,2,3
165_0,,,,2,1,2,3
166_0,,,,2,1,2,3
167_0,,,,2,1,2,3
168_0,,,,2,1,2,3
169_0,,,,2,1,2,3
170_0,,,,2,1,2,3
171_0,,,,2,1,2,3
172_0,,,,2,1,2,3
173_0,,,,2,1,2,3
174_0,,,,2,1,2,3
175_0,,,,2,1,2,3
176_0,,,,2,1,2,3
177_0,,,,2,1,2,3
178_0,,,,2,1,2,3
180_0,,,,2,1,2,3
C(CCO)(CC(C=O)=O)=O,,,2,1,21,28,49
182_0,,,,2,1,2,3
C(CO)(CCC(C=O)=O)=O,,,2,1,21,28,49
184_0,,,,2,1,2,3
C(C)(C(CC(C=O)=O)O)=O,,,2,1,22,27,49
186_0,,,,2,1,2,3
C(CC(CC(C=O)=O)O)=O,,,2,1,21,30,51
188_0,,,,2,1,2,3
C(CC(C(CCO)=O)=O)=O,,,2,1,21,27,48
190_0,,,,2,1,2,3
C(CC(CC(CO)=O)=O)=O,,,2,1,24,32,56
192_0,,,,2,1,2,3
C(CC(C(C(C)=O)O)=O)=O,,,2,1,22,27,49
194_0,,,,2,1,2,3
C(CC(C(CC=O)O)=O)=O,,,2,1,26,33,59
196_0,,,,2,1,2,3
C(C(C=O)O)(CC(C)=O)=O,,,2,1,22,27,49
198_0,,,,2,1,2,3
C(C(C(CCC=O)=O)O)=O,,,2,1,22,27,49
200_0,,,,2,1,2,3
C(C(CC(C(C)=O)=O)O)=O,,,2,1,21,25,46
202_0,,,,2,1,2,3
C(CC(CC(C=O)O)=O)=O,,,2,1,26,32,58
203_0,,,,2,1,2,3
204_0,,,,2,1,2,3
205_0,,,,2,1,2,3
206_0,,,,2,1,2,3
207_0,,,,2,1,2,3
208_0,,,,2,1,2,3
209_0,,,,2,1,2,3
210_0,,,,2,1,2,3
211_0,,,,2,1,2,3
212_0,,,,2,1,2,3
213_0,,,,2,1,2,3
214_0,,,,2,1,2,3
216_0,,,,2,1,2,3
C1(CC(C(C(CO)O)O1)O)=O,,,2,1,9,4,13
218_0,,,,2,1,2,3
C1(COC(C(CO)O)C1O)=O,,,2,1,11,9,20
220_0,,,,2,1,2,3
C1(C(O)OC(C(CO)O)C1)=O,,,2,1,10,10,20
222_0,,,,2,1,2,3
C1(C(C(CO)O)OC(C1)O)=O,,,2,1,12,13,25
224_0,,,,2,1,2,3
C(C)(C1C(C(C(O1)O)O)O)=O,,,2,1,11,12,23
226_0,,,,2,1,2,3
C(CC1C(C(C(O)O1)O)O)=O,,,2,1,9,13,22
228_0,,,,2,1,2,3
C1(CC(C(C(CO)O1)O)O)=O,,,2,1,8,5,13
230_0,,,,2,1,2,3
C1(COC(CO)C(C1O)O)=O,,,2,1,12,10,22
232_0,,,,2,1,2,3
C1(C(O)OC(CO)C(C1)O)=O,,,2,1,9,9,18
234_0,,,,2,1,2,3
C1(C(C(CO)OC(C1)O)O)=O,,,2,1,9,10,19
236_0,,,,2,1,2,3
C1(C(C(O)OC(CO)C1)O)=O,,,2,1,9,12,21
238_0,,,,2,1,2,3
C1(C(CO)OC(C(C1)O)O)=O,,,2,1,11,12,23
240_0,,,,2,1,2,3
C1(CC(C(C(CO1)O)O)O)=O,,,2,1,8,8,16
242_0,,,,2,1,2,3
C1(COCC(C(C1O)O)O)=O,,,2,1,14,12,26
244_0,,,,2,1,2,3
C1(C(O)OCC(C(C1)O)O)=O,,,2,1,11,11,22
246_0,,,,2,1,2,3
C1(C(C(COC(C1)O)O)O)=O,,,2,1,12,13,25
248_0,,,,2,1,2,3
C1(C(C(O)OCC(C1)O)O)=O,,,2,1,10,13,23
250_0,,,,2,1,2,3
C1(C(COC(C(C1)O)O)O)=O,,,2,1,11,12,23
252_0,,,,2,1,2,3
C1(C(C(C(O)OCC1)O)O)=O,,,2,1,13,14,27
254_0,,,,2,1,2,3
C1(COC(C(C(C1)O)O)O)=O,,,2,1,11,13,24
256_0,,,,2,1,2,3
C(C(CO)O)=CC(C=O)=O,,,2,1,8,14,22
258_0,,,,2,1,2,3
C(C(C(C=CCO)=O)O)=O,,,2,1,13,18,31
260_0,,,,2,1,2,3
C(C=CC(C(CO)O)=O)=O,,,2,1,21,28,49
262_0,,,,2,1,2,3
C(C(C(C(C=C)=O)O)O)=O,,,2,1,27,31,58
264_0,,,,2,1,2,3
C(C(C=CC(CO)=O)O)=O,,,2,1,17,23,40
266_0,,,,2,1,2,3
C(C(C(C=CC=O)O)O)=O,,,2,1,20,25,45
267_0,,,,2,2,1,3
268_0,,,,2,2,1,3
269_0,,,,2,2,1,3
270_0,,,,2,2,1,3
271_0,,,,2,2,1,3
272_0,,,,2,2,1,3
273_0,,,,2,2,1,3
274_0,,,,2,2,1,3
275_0,,,,2,2,1,3
277_0,,,,2,1,1,2
C1C(C(C(O)O1)O)O,,,2,1,3,5,8
279_0,,,,2,1,1,2
C(C1(C(C(C(CO)O1)O)O)O)O,,,2,1,4,5,9
280_0,,,,2,1,1,2
282_0,,,,2,1,1,2
C(C1(CC(C(CO)O1)O)O)=O,,,2,1,4,7,11
283_0,,,,2,1,1,2
285_0,,,,2,1,1,2
C(CC1(C(C(CO1)O)O)O)=O,,,2,1,8,13,21
287_0,,,,2,1,1,2
C(C(C1(CC(CO1)O)O)O)=O,,,2,1,7,12,19
289_0,,,,2,1,1,2
C(C1C(CC(CO)(O1)O)O)=O,,,2,1,8,11,19
291_0,,,,2,1,1,2
C(C1C(C(C(C)(O1)O)O)O)=O,,,2,1,9,12,21
292_0,,,,2,1,1,2
294_0,,,,2,1,1,2
C(C(C1C(CC(O)O1)O)O)=O,,,2,1,8,10,18
295_0,,,,2,1,1,2
297_0,,,,2,1,1,2
C1C(C(C(C(CO)(O)O1)O)O)O,,,2,1,6,7,13
298_0,,,,2,1,1,2
300_0,,,,2,1,1,2
C(C1(CC(C(CO1)O)O)O)=O,,,2,1,6,9,15
301_0,,,,2,1,1,2
302_0,,,,2,1,1,2
303_0,,,,2,1,1,2
305_0,,,,2,1,1,2
C(C1C(C(CC(O1)O)O)O)=O,,,2,1,10,12,22
306_0,,,,2,1,1,2
307_0,,,,2,1,1,2
308_0,,,,2,1,1,2
309_0,,,,2,1,1,2
310_0,,,,2,1,1,2
311_0,,,,2,1,1,2
312_0,,,,2,1,1,2
313_0,,,,2,1,1,2
314_0,,,,2,1,1,2
316_0,,,,2,1,2,3
C1(C(C(C(C(CO)O)O1)O)O)=O,,,2,1,9,5,14
318_0,,,,2,1,2,3
C1(C(C(C(C(CO)O1)O)O)O)=O,,,2,1,8,6,14
320_0,,,,2,1,2,3
C1(C(C(C(C(CO1)O)O)O)O)=O,,,2,1,9,9,18
322_0,,,,2,1,1,2
C1(C(C(C(C1)O)O)O)=O,,,3,1,8,32,40
322_1,,,,2,1,1,2
323_0,,,,2,1,1,2
325_0,,,,2,1,1,2
C1(C(C(C(CC1O)O)O)O)=O,,,3,1,5,14,19
325_1,,,,2,1,1,2
327_0,,,,2,1,1,2
C1(C(C(C(C1)O)(CO)O)O)=O,,,3,1,8,15,23
327_1,,,,2,1,1,2
329_0,,,,2,1,1,2
C1(C(CC(CO)(C1O)O)O)=O,,,3,1,3,13,16
329_1,,,,2,1,1,2
331_0,,,,2,1,1,2
C1(C(C(C(CO)(C1)O)O)O)=O,,,3,1,8,16,24
333_0,,,,2,1,1,2
C1(C(C(C(C)(C1O)O)O)O)=O,,,3,1,6,15,21
333_1,,,,2,1,1,2
335_0,,,,2,1,1,2
C1(C(C(CC(C1O)O)O)O)=O,,,3,1,4,8,12
335_1,,,,2,1,1,2
337_0,,,,2,1,1,2
C1(C(CO)C(C(C1)=O)O)=O,,,3,1,6,26,32
337_1,,,,2,1,1,2
339_0,,,,2,1,1,2
C1(CCC(C(C1O)O)=O)=O,,,3,1,3,15,18
339_1,,,,2,1,1,2
341_0,,,,2,1,1,2
C(C1(CCC(C1O)=O)O)=O,,,3,1,5,22,27
341_1,,,,2,1,1,2
343_0,,,,2,1,1,2
C1(CC(C(CC1O)=O)O)=O,,,3,1,2,14,16
345_0,,,,2,1,1,2
C(C1(CC(C(C1)=O)O)O)=O,,,3,1,3,21,24
347_0,,,,2,1,1,2
C(C1C(CC(C1O)=O)O)=O,,,3,1,7,27,34
347_1,,,,2,1,1,2
349_0,,,,2,1,1,2
C1(C(CC(C1CO)O)=O)=O,,,3,1,4,23,27
349_1,,,,2,1,1,2
351_0,,,,2,1,1,2
C1(CC(C(C(C1)=O)O)O)=O,,,3,1,5,30,35
351_1,,,,2,1,1,2
353_0,,,,2,1,1,2
C1(CC(CC(C1O)=O)O)=O,,,3,1,2,17,19
354_0,,,,2,1,1,2
354_1,,,,2,1,1,2
356_0,,,,2,1,1,2
C(C1C(C(CC1O)O)=O)=O,,,3,1,5,20,25
356_1,,,,2,1,1,2
357_0,,,,2,1,1,2
359_0,,,,2,1,1,2
C(C1C(C(C(C1)=O)O)O)=O,,,3,1,4,28,32
361_0,,,,2,1,1,2
C1(C(CC(C(C1)O)O)=O)=O,,,3,1,2,13,15
363_0,,,,2,1,1,2
C(C1C(CC(C1O)O)=O)=O,,,3,1,5,25,30
363_1,,,,2,1,1,2
365_0,,,,2,1,1,2
C1C(C(C(C(C=1)=O)O)O)O,,,3,1,4,21,25
365_1,,,,2,1,1,2
367_0,,,,2,2,1,3
C1(C(C(C(C(C1CO)O)O)O)O)=O,,,3,1,6,16,22
367_1,,,,2,2,1,3
369_0,,,,2,2,1,3
C(CO)(C(C(CO)(CO)O)O)=O,,,3,1,2,7,9
369_1,,,,2,2,1,3
370_0,,,,2,2,1,3
370_1,,,,2,2,1,3
371_0,,,,2,2,1,3
371_1,,,,2,2,1,3
373_0,,,,2,2,1,3
C(C(C)(C(C(CO)=O)O)O)=O,,,3,1,10,17,27
373_1,,,,2,2,1,3
375_0,,,,2,2,1,3
C(C(CC(CO)(CO)O)=O)=O,,,3,1,3,13,16
377_0,,,,2,2,1,3
C(CO)(CC(C(C(CO)=O)O)O)=O,,,3,1,6,16,22
377_1,,,,2,2,1,3
379_0,,,,2,2,1,3
C(CC(CO)(C(C(CO)=O)O)O)=O,,,3,1,3,15,18
379_1,,,,2,2,1,3
381_0,,,,2,2,1,3
C(C(C(CO)=O)C(CO)(CO)O)=O,,,3,1,3,9,12
381_1,,,,2,2,1,3
383_0,,,,2,2,1,3
C(CC(C(C(CO)(CO)O)O)=O)=O,,,3,1,5,10,15
383_1,,,,2,2,1,3
385_0,,,,2,2,1,3
C(C)(C(C(C(C(CO)=O)O)O)O)=O,,,3,1,6,17,23
385_1,,,,2,2,1,3
387_0,,,,2,2,1,3
C(C(C(C)(C(C(CO)=O)O)O)O)=O,,,3,1,5,16,21
387_1,,,,2,2,1,3
389_0,,,,2,2,1,3
C(C(C(CC(CO)(CO)O)=O)O)=O,,,3,1,2,9,11
391_0,,,,2,2,1,3
C(C(C(C(CO)=O)O)O)=O,,,3,1,11,34,45
391_1,,,,2,2,1,3
393_0,,,,2,2,1,3
C(CO)(C(C(C)(C(CO)O)O)O)=O,,,3,1,3,11,14
393_1,,,,2,2,1,3
395_0,,,,2,2,1,3
C(C(CO)O)(CC(CO)(CO)O)=O,,,3,1,5,9,14
396_0,,,,2,2,1,3
396_1,,,,2,2,1,3
398_0,,,,2,2,1,3
C(C(C(C(CCO)=O)O)O)(CO)=O,,,3,1,7,17,24
398_1,,,,2,2,1,3
400_0,,,,2,2,1,3
C(C(CCO)(C(C(CO)=O)O)O)=O,,,3,1,3,15,18
400_1,,,,2,2,1,3
402_0,,,,2,2,1,3
C(C(C(CO)C(CO)(CO)O)=O)=O,,,3,1,4,12,16
402_1,,,,2,2,1,3
404_0,,,,2,2,1,3
C(CO)(C(C(CO)(CCO)O)O)=O,,,3,1,4,10,14
404_1,,,,2,2,1,3
406_0,,,,2,2,1,3
C(C(C(CO)(CO)O)O)(CCO)=O,,,3,1,5,8,13
406_1,,,,2,2,1,3
408_0,,,,2,2,1,3
C(CO)(C(CO)C(CO)(CO)O)=O,,,3,1,6,9,15
408_1,,,,2,2,1,3
410_0,,,,2,2,1,3
C(C(C(C(C(CO)=O)O)O)O)=O,,,3,1,6,18,24
410_1,,,,2,2,1,3
412_0,,,,2,2,1,3
C(CO)(C(C(CO)(C)O)O)=O,,,3,1,8,12,20
412_1,,,,2,2,1,3
414_0,,,,2,2,1,3
C(CO)(CC(CO)(CO)O)=O,,,3,1,7,10,17
416_0,,,,2,2,1,3
C(C)(C(C(CO)(CO)O)O)=O,,,3,1,7,10,17
416_1,,,,2,2,1,3
418_0,,,,2,2,1,3
C(CC(C(C(C(CO)=O)O)O)O)=O,,,3,1,4,20,24
418_1,,,,2,2,1,3
420_0,,,,2,2,1,3
C(C(CC(C(C(CO)=O)O)O)O)=O,,,3,1,4,18,22
420_1,,,,2,2,1,3
422_0,,,,2,2,1,3
C(C(C(CO)(CO)O)C(C=O)O)=O,,,3,1,5,13,18
422_1,,,,2,2,1,3
424_0,,,,2,2,1,3
C(CO)(C(C(C)O)O)=O,,,3,1,7,30,37
424_1,,,,2,2,1,3
426_0,,,,2,2,1,3
C(CC(CO)(CO)O)=O,,,3,1,4,20,24
427_0,,,,2,2,1,3
429_0,,,,2,2,1,3
C(C(C(CO)=O)C(C(CO)O)O)=O,,,3,1,5,14,19
429_1,,,,2,2,1,3
431_0,,,,2,2,1,3
C(CC(C(C(C(CO)O)O)O)=O)=O,,,3,1,6,15,21
431_1,,,,2,2,1,3
433_0,,,,2,2,1,3
C(C(C(CC(C(CO)O)O)=O)O)=O,,,3,1,4,13,17
435_0,,,,2,2,1,3
C(C(CO)O)(CC(C(CO)O)O)=O,,,3,1,6,13,19
437_0,,,,2,2,1,3
C(C(C(CO)C(C(CO)O)O)=O)=O,,,3,1,12,17,29
437_1,,,,2,2,1,3
439_0,,,,2,2,1,3
C(C(C(C(CO)O)O)O)(CCO)=O,,,3,1,7,13,20
439_1,,,,2,2,1,3
441_0,,,,2,2,1,3
C(CO)(C(CO)C(C(CO)O)O)=O,,,3,1,8,13,21
441_1,,,,2,2,1,3
442_0,,,,2,2,1,3
443_0,,,,2,2,1,3
443_1,,,,2,2,1,3
445_0,,,,2,2,1,3
C(C(C(C(CO)O)O)C(C=O)O)=O,,,3,1,7,18,25
445_1,,,,2,2,1,3
447_0,,,,2,2,1,3
C(CC(C(CO)O)O)=O,,,3,1,6,24,30
448_0,,,,2,2,1,3
450_0,,,,2,2,1,3
C(C(C)(CC(C=O)=O)O)=O,,,3,1,3,20,23
452_0,,,,2,2,1,3
C(CO)(CC(CC(C=O)=O)O)=O,,,3,1,5,19,24
454_0,,,,2,2,1,3
C(CC(CO)(CC(C=O)=O)O)=O,,,3,1,2,19,21
456_0,,,,2,2,1,3
C(C(C(CO)=O)C(C(C)=O)O)=O,,,3,1,6,16,22
456_1,,,,2,2,1,3
458_0,,,,2,2,1,3
C(C(C)(C(C=O)C(CO)=O)O)=O,,,3,1,5,15,20
458_1,,,,2,2,1,3
460_0,,,,2,2,1,3
C(CC(C(C(C(C)=O)O)O)=O)=O,,,3,1,7,21,28
460_1,,,,2,2,1,3
462_0,,,,2,2,1,3
C(C(C)(C(C(CC=O)=O)O)O)=O,,,3,1,4,17,21
462_1,,,,2,2,1,3
464_0,,,,2,2,1,3
C(C)(C(C(CC(C=O)=O)O)O)=O,,,3,1,5,20,25
466_0,,,,2,2,1,3
C(C(C(C)(CC(C=O)=O)O)O)=O,,,3,1,4,19,23
468_0,,,,2,2,1,3
C(C(C(CC(C(C)=O)O)=O)O)=O,,,3,1,3,16,19
470_0,,,,2,2,1,3
C(C(C)(CC(C(C=O)O)=O)O)=O,,,3,1,1,14,15
472_0,,,,2,2,1,3
C(C(CC(C=O)=O)O)=O,,,3,1,9,35,44
474_0,,,,2,2,1,3
C(C(CC(C)(C(CO)O)O)=O)=O,,,3,1,2,16,18
476_0,,,,2,2,1,3
C(CC(C(C)=O)O)(C(CO)O)=O,,,3,1,6,15,21
478_0,,,,2,2,1,3
C(C(C)(CC(C(CO)O)=O)O)=O,,,3,1,4,15,19
479_0,,,,2,2,1,3
481_0,,,,2,2,1,3
C(C(CC(C=O)=O)O)(CCO)=O,,,3,1,4,17,21
483_0,,,,2,2,1,3
C(C(CCO)(CC(C=O)=O)O)=O,,,3,1,1,15,16
485_0,,,,2,2,1,3
C(C(C(C(C=O)=O)CO)O)(C)=O,,,3,1,5,18,23
485_1,,,,2,2,1,3
487_0,,,,2,2,1,3
C(C(C)(C(C(C=O)=O)CO)O)=O,,,3,1,4,17,21
487_1,,,,2,2,1,3
489_0,,,,2,2,1,3
C(C(CC(CO)(CCO)O)=O)=O,,,3,1,3,15,18
491_0,,,,2,2,1,3
C(C(C(C(CCO)=O)O)O)(C)=O,,,3,1,8,16,24
491_1,,,,2,2,1,3
493_0,,,,2,2,1,3
C(C(C)(C(C(CCO)=O)O)O)=O,,,3,1,5,15,20
493_1,,,,2,2,1,3
495_0,,,,2,2,1,3
C(CO)(C(CO)C(C(C)=O)O)=O,,,3,1,8,15,23
495_1,,,,2,2,1,3
497_0,,,,2,2,1,3
C(C(C)(C(C(CO)=O)CO)O)=O,,,3,1,6,15,21
497_1,,,,2,2,1,3
499_0,,,,2,2,1,3
C(C(C(CC(C=O)=O)O)O)=O,,,3,1,7,23,30
501_0,,,,2,2,1,3
C(C(CC(C)(CO)O)=O)=O,,,3,1,4,20,24
503_0,,,,2,2,1,3
C(C)(C(CC(CO)=O)O)=O,,,3,1,9,30,39
505_0,,,,2,2,1,3
C(C(C)(CC(CO)=O)O)=O,,,3,1,6,24,30
507_0,,,,2,2,1,3
C(C)(C(C(C(C)=O)O)O)=O,,,3,1,7,16,23
507_1,,,,2,2,1,3
509_0,,,,2,2,1,3
C(C(C)(C(C(C)=O)O)O)=O,,,3,1,7,22,29
509_1,,,,2,2,1,3
511_0,,,,2,2,1,3
C(CC(C(CC(C=O)=O)O)O)=O,,,3,1,3,24,27
513_0,,,,2,2,1,3
C(C(CC(CC(C=O)=O)O)O)=O,,,3,1,2,20,22
515_0,,,,2,2,1,3
C(C(C(C=O)C(C(C)=O)O)O)=O,,,3,1,6,18,24
515_1,,,,2,2,1,3
517_0,,,,2,2,1,3
C(C(C(C=O)C(C=O)(C)O)O)=O,,,3,1,5,17,22
517_1,,,,2,2,1,3
519_0,,,,2,2,1,3
C(C(C(C(CC(C=O)=O)O)O)O)=O,,,3,1,3,23,26
521_0,,,,2,2,1,3
C(C(CC(C)O)=O)=O,,,3,1,10,59,69
523_0,,,,2,2,1,3
C(CC(C(C)=O)O)=O,,,3,1,11,82,93
525_0,,,,2,2,1,3
C(C(C)(CC=O)O)=O,,,3,1,6,58,64
527_0,,,,2,2,1,3
C(C(CC(CO)(C(CO)O)O)=O)=O,,,3,1,4,14,18
529_0,,,,2,2,1,3
C(C(C(C(C(CO)O)=O)O)O)(C)=O,,,3,1,8,18,26
529_1,,,,2,2,1,3
531_0,,,,2,2,1,3
C(C(C)(C(C(C(CO)O)=O)O)O)=O,,,3,1,6,17,23
531_1,,,,2,2,1,3
533_0,,,,2,2,1,3
C(C(C(CO)=O)C(C=O)O)=O,,,3,1,5,19,24
533_1,,,,2,2,1,3
535_0,,,,2,2,1,3
C(CC(C(C(C=O)O)O)=O)=O,,,3,1,6,26,32
535_1,,,,2,2,1,3
537_0,,,,2,2,1,3
C(C(C(CO)=O)CO)=O,,,3,1,9,30,39
537_1,,,,2,2,1,3
539_0,,,,2,2,1,3
C(CC(C(CO)O)=O)=O,,,3,1,11,37,48
539_1,,,,2,2,1,3
541_0,,,,2,2,1,3
C(C(C(C(C=O)C(CO)=O)O)O)=O,,,3,1,3,17,20
541_1,,,,2,2,1,3
543_0,,,,2,2,1,3
C(CC(C(C(C(C=O)O)O)O)=O)=O,,,3,1,2,21,23
543_1,,,,2,2,1,3
545_0,,,,2,2,1,3
C(C(C(CO)=O)C(CO)(C)O)=O,,,3,1,6,13,19
545_1,,,,2,2,1,3
547_0,,,,2,2,1,3
C(CC(C(C(CO)(C)O)O)=O)=O,,,3,1,4,14,18
547_1,,,,2,2,1,3
549_0,,,,2,2,1,3
C(CO)(CC(CC(CO)=O)O)=O,,,3,1,4,7,11
551_0,,,,2,2,1,3
C(CC(CO)(CC(CO)=O)O)=O,,,3,1,5,15,20
553_0,,,,2,2,1,3
C(C)(C(C(CC(CO)=O)O)O)=O,,,3,1,7,15,22
553_1,,,,2,2,1,3
555_0,,,,2,2,1,3
C(CC(CO)(C(C(C)=O)O)O)=O,,,3,1,5,15,20
555_1,,,,2,2,1,3
557_0,,,,2,2,1,3
C(C(C(CO)=O)C(C)O)=O,,,3,1,5,21,26
557_1,,,,2,2,1,3
559_0,,,,2,2,1,3
C(CC(C(C(C)O)O)=O)=O,,,3,1,3,26,29
559_1,,,,2,2,1,3
561_0,,,,2,2,1,3
C(CC(CC(CO)=O)O)=O,,,3,1,6,32,38
563_0,,,,2,2,1,3
C(CC(CO)(CC=O)O)=O,,,3,1,2,14,16
565_0,,,,2,2,1,3
C(C(C(CC(C=O)O)=O)O)=O,,,3,1,2,20,22
567_0,,,,2,2,1,3
C(C(C(CCO)=O)O)=O,,,3,1,6,34,40
569_0,,,,2,2,1,3
C(CC(C(C=O)O)O)(C(C=O)O)=O,,,3,1,1,19,20
571_0,,,,2,2,1,3
C(C(C(CC(CO)(C)O)=O)O)=O,,,3,1,2,12,14
572_0,,,,2,2,1,3
574_0,,,,2,2,1,3
C(C(C(C)(CC(CO)=O)O)O)=O,,,3,1,2,15,17
576_0,,,,2,2,1,3
C(C)(C(C(C(C(C)=O)O)O)O)=O,,,3,1,3,8,11
576_1,,,,2,2,1,3
578_0,,,,2,2,1,3
C(C(C(C)(C(C(C)=O)O)O)O)=O,,,3,1,2,15,17
578_1,,,,2,2,1,3
580_0,,,,2,2,1,3
C(C(C(CC(C)O)=O)O)=O,,,3,1,1,23,24
582_0,,,,2,2,1,3
C(CC(C(C(C)=O)O)O)=O,,,3,1,5,30,35
584_0,,,,2,2,1,3
C(CC(C)(C(C=O)O)O)=O,,,3,1,4,27,31
585_0,,,,2,2,1,3
587_0,,,,2,2,1,3
C(C(C(C(CO)=O)C(C=O)O)O)=O,,,3,1,2,10,12
587_1,,,,2,2,1,3
589_0,,,,2,2,1,3
C(C(C(C(CC(C=O)O)=O)O)O)=O,,,3,1,5,23,28
589_1,,,,2,2,1,3
591_0,,,,2,2,1,3
C(C(C(C(C=O)=O)CO)O)=O,,,3,1,4,19,23
591_1,,,,2,2,1,3
592_0,,,,2,2,1,3
592_1,,,,2,2,1,3
594_0,,,,2,2,1,3
C(CO)(C(CO)C(C=O)O)=O,,,3,1,11,19,30
594_1,,,,2,2,1,3
595_0,,,,2,2,1,3
596_0,,,,2,2,1,3
597_0,,,,2,2,1,3
597_1,,,,2,2,1,3
599_0,,,,2,2,1,3
C(C(C(C=O)C(C=O)O)O)=O,,,3,1,3,12,15
599_1,,,,2,2,1,3
600_0,,,,2,2,1,3
602_0,,,,2,2,1,3
C(C(C(C=O)O)O)(C(CO)O)=O,,,3,1,10,19,29
602_1,,,,2,2,1,3
604_0,,,,2,2,1,3
C(C(CO)O)(CCO)=O,,,3,1,15,31,46
606_0,,,,2,2,1,3
C(C(CO)O)(CC(C(C=O)O)O)=O,,,3,1,14,17,31
608_0,,,,2,2,1,3
C(C(CO)O)(CC(CO)(C)O)=O,,,3,1,5,11,16
610_0,,,,2,2,1,3
C(CO)(CC(C)(C(CO)O)O)=O,,,3,1,3,10,13
612_0,,,,2,2,1,3
C(C)(C(C(C)(C(CO)O)O)O)=O,,,3,1,3,11,14
612_1,,,,2,2,1,3
614_0,,,,2,2,1,3
C(C(CO)O)(CC(C)O)=O,,,3,1,4,22,26
616_0,,,,2,2,1,3
C(CC(C)(C(CO)O)O)=O,,,3,1,2,18,20
617_0,,,,2,2,1,3
617_1,,,,2,2,1,3
618_0,,,,2,2,1,3
618_1,,,,2,2,1,3
620_0,,,,2,2,1,3
C(CO)(C(C(C)O)C(C=O)O)=O,,,3,1,4,16,20
620_1,,,,2,2,1,3
622_0,,,,2,2,1,3
C(CC(C=O)O)(C(C(C)O)O)=O,,,3,1,3,16,19
622_1,,,,2,2,1,3
624_0,,,,2,2,1,3
C(CC(C(CC(CO)=O)O)O)=O,,,3,1,4,19,23
626_0,,,,2,2,1,3
C(CC(CO)(CC(C=O)O)O)=O,,,3,1,2,18,20
628_0,,,,2,2,1,3
C(C(C(CO)CO)=O)=O,,,3,1,5,20,25
628_1,,,,2,2,1,3
629_0,,,,2,2,1,3
629_1,,,,2,2,1,3
631_0,,,,2,2,1,3
C(CO)(C(CO)CO)=O,,,3,1,8,23,31
631_1,,,,2,2,1,3
632_0,,,,2,2,1,3
633_0,,,,2,2,1,3
634_0,,,,2,2,1,3
634_1,,,,2,2,1,3
636_0,,,,2,2,1,3
C(C(CO)C(C=O)O)=O,,,3,1,8,29,37
636_1,,,,2,2,1,3
638_0,,,,2,2,1,3
C(CCO)=O,,,3,1,27,317,344
640_0,,,,2,2,1,3
C(C(CO)O)(C(CO)O)=O,,,3,1,4,12,16
640_1,,,,2,2,1,3
642_0,,,,2,2,1,3
C(C(CO)C(C(C(CO)O)=O)O)=O,,,3,1,7,18,25
642_1,,,,2,2,1,3
644_0,,,,2,2,1,3
C(C(C(CO)O)=O)(CC(CO)O)=O,,,3,1,2,14,16
644_1,,,,2,2,1,3
646_0,,,,2,2,1,3
C(C(CO)=O)(C(CO)C(CO)O)=O,,,3,1,3,14,17
646_1,,,,2,2,1,3
648_0,,,,2,2,1,3
C(C(CO)O)(CC(C(CO)O)=O)=O,,,3,1,4,7,11
648_1,,,,2,2,1,3
650_0,,,,2,2,1,3
C(C(CO)O)(C(C(CO)=O)CO)=O,,,3,1,5,12,17
650_1,,,,2,2,1,3
652_0,,,,2,2,1,3
C(C(CC(C(C(CO)O)=O)O)O)=O,,,3,1,6,15,21
652_1,,,,2,2,1,3
654_0,,,,2,2,1,3
C(CCO)(C(C(C(CO)O)=O)O)=O,,,3,1,5,12,17
654_1,,,,2,2,1,3
656_0,,,,2,2,1,3
C(C(CO)CO)(C(C(CO)=O)O)=O,,,3,1,3,8,11
656_1,,,,2,2,1,3
658_0,,,,2,2,1,3
C(CC(C(C(CO)O)=O)O)(CO)=O,,,3,1,5,16,21
658_1,,,,2,2,1,3
660_0,,,,2,2,1,3
C(CO)(C(CO)C(C(CO)=O)O)=O,,,3,1,6,16,22
660_1,,,,2,2,1,3
662_0,,,,2,2,1,3
C(CC(C(CO)=O)O)(C(CO)O)=O,,,3,1,5,16,21
662_1,,,,2,2,1,3
663_0,,,,2,2,1,3
663_1,,,,2,2,1,3
664_0,,,,2,2,1,3
666_0,,,,2,2,1,3
C(CC(C(C(C(CO)O)=O)O)O)=O,,,3,1,6,17,23
666_1,,,,2,2,1,3
668_0,,,,2,2,1,3
C(C(CO)C(C(C(CO)=O)O)O)=O,,,3,1,7,18,25
668_1,,,,2,2,1,3
669_0,,,,2,2,1,3
669_1,,,,2,2,1,3
670_0,,,,2,2,1,3
670_1,,,,2,2,1,3
672_0,,,,2,2,1,3
C(C(C(CO)O)O)(C(CO)CO)=O,,,3,1,6,11,17
672_1,,,,2,2,1,3
674_0,,,,2,2,1,3
C(C(CO)O)(C(CO)C(CO)O)=O,,,3,1,8,14,22
674_1,,,,2,2,1,3
675_0,,,,2,2,1,3
677_0,,,,2,2,1,3
C(C(CO)C(C(C(CO)O)O)O)=O,,,3,1,5,16,21
677_1,,,,2,2,1,3
679_0,,,,2,2,1,3
C1(C(CO)(C(C(C1CO)O)O)O)=O,,,3,1,8,16,24
679_1,,,,2,2,1,3
681_0,,,,2,2,1,3
C(CCO)(C(C(C=O)=O)CO)=O,,,3,1,4,17,21
681_1,,,,2,2,1,3
683_0,,,,2,2,1,3
C(C(CO)CO)(CC(C=O)=O)=O,,,3,1,3,13,16
683_1,,,,2,2,1,3
685_0,,,,2,2,1,3
C(CC(C(C=O)=O)CO)(CO)=O,,,3,1,2,18,20
687_0,,,,2,2,1,3
C(CO)(C(CO)CC(C=O)=O)=O,,,3,1,3,18,21
689_0,,,,2,2,1,3
C(CCC(C=O)=O)(C(CO)O)=O,,,3,1,4,18,22
689_1,,,,2,2,1,3
690_0,,,,2,2,1,3
690_1,,,,2,2,1,3
691_0,,,,2,2,1,3
693_0,,,,2,2,1,3
C(CC(C(C(C=O)=O)CO)O)=O,,,3,1,5,21,26
693_1,,,,2,2,1,3
695_0,,,,2,2,1,3
C(C(CO)C(CC(C=O)=O)O)=O,,,3,1,5,20,25
695_1,,,,2,2,1,3
697_0,,,,2,2,1,3
C(C(C(C(CCO)=O)=O)CO)=O,,,3,1,4,16,20
697_1,,,,2,2,1,3
699_0,,,,2,2,1,3
C(CC(C(C(CO)CO)=O)=O)=O,,,3,1,4,12,16
699_1,,,,2,2,1,3
701_0,,,,2,2,1,3
C(C(C(CC(CO)=O)=O)CO)=O,,,3,1,7,15,22
701_1,,,,2,2,1,3
703_0,,,,2,2,1,3
C(CC=O)(C(C(CO)=O)CO)=O,,,3,1,7,15,22
703_1,,,,2,2,1,3
705_0,,,,2,2,1,3
C(CC(CC(C(CO)O)=O)=O)=O,,,3,1,6,16,22
705_1,,,,2,2,1,3
707_0,,,,2,2,1,3
C(C(C(C(C(C)=O)O)=O)CO)=O,,,3,1,4,13,17
707_1,,,,2,2,1,3
709_0,,,,2,2,1,3
C(CC(C(C(CCO)=O)O)=O)=O,,,3,1,4,13,17
711_0,,,,2,2,1,3
C(CC(C(C(C=O)CO)=O)O)=O,,,3,1,6,18,24
711_1,,,,2,2,1,3
713_0,,,,2,2,1,3
C(C(CO)C(C(CC=O)=O)O)=O,,,3,1,8,20,28
713_1,,,,2,2,1,3
715_0,,,,2,2,1,3
C(C(C=O)O)(C(C(C)=O)CO)=O,,,3,1,4,13,17
715_1,,,,2,2,1,3
717_0,,,,2,2,1,3
C(C(C=O)O)(CC(CCO)=O)=O,,,3,1,3,13,16
719_0,,,,2,2,1,3
C(C(CO)CC=O)(C(C=O)O)=O,,,3,1,2,17,19
721_0,,,,2,2,1,3
C(C(CO)CC(C(C=O)O)=O)=O,,,3,1,3,17,20
723_0,,,,2,2,1,3
C(C(C(C(C(C)=O)=O)CO)O)=O,,,3,1,3,16,19
723_1,,,,2,2,1,3
725_0,,,,2,2,1,3
C(C(CC(C(CCO)=O)=O)O)=O,,,3,1,3,14,17
727_0,,,,2,2,1,3
C(C(CO)C(C=O)O)(CC=O)=O,,,3,1,4,20,24
727_1,,,,2,2,1,3
729_0,,,,2,2,1,3
C(CC(C=O)O)(C(C=O)CO)=O,,,3,1,6,17,23
729_1,,,,2,2,1,3
731_0,,,,2,2,1,3
C1(C(CO)OC(C(CO)O)C1O)=O,,,3,1,2,7,9
731_1,,,,2,2,1,3
733_0,,,,2,2,1,3
C1(C(O)OC(C(CO)O)C1CO)=O,,,3,1,3,9,12
733_1,,,,2,2,1,3
735_0,,,,2,2,1,3
C1(C(C(CO)O)OC(C1CO)O)=O,,,3,1,3,12,15
735_1,,,,2,2,1,3
737_0,,,,2,2,1,3
C(C1C(C(C(O1)O)O)O)(CCO)=O,,,3,1,2,10,12
739_0,,,,2,2,1,3
C(C(CO)C1C(C(C(O)O1)O)O)=O,,,3,1,3,12,15
739_1,,,,2,2,1,3
741_0,,,,2,2,1,3
C1(C(CO)OC(C(C1O)O)CO)=O,,,3,1,2,8,10
741_1,,,,2,2,1,3
743_0,,,,2,2,1,3
C1(C(O)OC(CO)C(C1CO)O)=O,,,3,1,3,9,12
743_1,,,,2,2,1,3
745_0,,,,2,2,1,3
C1(C(C(CO)OC(C1CO)O)O)=O,,,3,1,3,9,12
745_1,,,,2,2,1,3
747_0,,,,2,2,1,3
C1(C(C(O)OC(CO)C1CO)O)=O,,,3,1,3,10,13
747_1,,,,2,2,1,3
749_0,,,,2,2,1,3
C1(C(CO)OC(C(C1CO)O)O)=O,,,3,1,3,11,14
749_1,,,,2,2,1,3
751_0,,,,2,2,1,3
C1(C(CO)OCC(C(C1O)O)O)=O,,,3,1,2,10,12
751_1,,,,2,2,1,3
753_0,,,,2,2,1,3
C1(C(O)OCC(C(C1CO)O)O)=O,,,3,1,3,11,14
753_1,,,,2,2,1,3
755_0,,,,2,2,1,3
C1(C(C(COC(C1CO)O)O)O)=O,,,3,1,3,12,15
755_1,,,,2,2,1,3
757_0,,,,2,2,1,3
C1(C(C(O)OCC(C1CO)O)O)=O,,,3,1,3,12,15
757_1,,,,2,2,1,3
759_0,,,,2,2,1,3
C1(C(COC(C(C1CO)O)O)O)=O,,,3,1,3,11,14
759_1,,,,2,2,1,3
761_0,,,,2,2,1,3
C1(C(C(C(O)OCC1CO)O)O)=O,,,3,1,3,12,15
761_1,,,,2,2,1,3
763_0,,,,2,2,1,3
C1(COC(C(C(C1CO)O)O)O)=O,,,3,1,3,12,15
763_1,,,,2,2,1,3
765_0,,,,2,2,1,3
C1(C(CO)OC(C(C(C1)O)O)O)=O,,,3,1,3,10,13
765_1,,,,2,2,1,3
767_0,,,,2,2,1,3
C(C(C=CC(C(CO)O)=O)O)=O,,,3,1,4,13,17
767_1,,,,2,2,1,3
769_0,,,,2,2,1,3
C(C(CO)C1(C(C(CO1)O)O)O)=O,,,3,1,3,13,16
769_1,,,,2,2,1,3
771_0,,,,2,2,1,3
C(C(C(C(C(C=O)=O)CO)O)O)=O,,,3,1,4,20,24
771_1,,,,2,2,1,3
773_0,,,,2,2,1,3
C(C(C(CO)C(C)(CO)O)=O)=O,,,3,1,5,17,22
773_1,,,,2,2,1,3
775_0,,,,2,2,1,3
C(CC(C(CCO)=O)O)(CO)=O,,,3,1,5,14,19
777_0,,,,2,2,1,3
C(C(CCO)(CC(CO)=O)O)=O,,,3,1,2,13,15
778_0,,,,2,2,1,3
778_1,,,,2,2,1,3
780_0,,,,2,2,1,3
C(C(CCO)(C(C(C)=O)O)O)=O,,,3,1,4,14,18
780_1,,,,2,2,1,3
782_0,,,,2,2,1,3
C(C(C(CO)C(C)O)=O)=O,,,3,1,4,19,23
782_1,,,,2,2,1,3
784_0,,,,2,2,1,3
C(CC(C(CCO)=O)O)=O,,,3,1,6,29,35
786_0,,,,2,2,1,3
C(C(CCO)(CC=O)O)=O,,,3,1,1,19,20
788_0,,,,2,2,1,3
C(C(C(C(C=O)O)O)O)(CCO)=O,,,3,1,14,17,31
788_1,,,,2,2,1,3
790_0,,,,2,2,1,3
C(C(C(C(C(CO)=O)CO)O)O)=O,,,3,1,14,18,32
790_1,,,,2,2,1,3
792_0,,,,2,2,1,3
C(C(C(CO)(C)O)O)(CCO)=O,,,3,1,5,10,15
792_1,,,,2,2,1,3
794_0,,,,2,2,1,3
C(CO)(C(CO)C(CO)(C)O)=O,,,3,1,7,11,18
794_1,,,,2,2,1,3
796_0,,,,2,2,1,3
C(CO)(CC(CO)(CCO)O)=O,,,3,1,4,9,13
798_0,,,,2,2,1,3
C(C)(C(C(CO)(CCO)O)O)=O,,,3,1,4,10,14
798_1,,,,2,2,1,3
800_0,,,,2,2,1,3
C(C(C(C)O)O)(CCO)=O,,,3,1,4,22,26
800_1,,,,2,2,1,3
802_0,,,,2,2,1,3
C(CO)(C(CO)C(C)O)=O,,,3,1,6,19,25
802_1,,,,2,2,1,3
804_0,,,,2,2,1,3
C(CC(CO)(CCO)O)=O,,,3,1,3,17,20
806_0,,,,2,2,1,3
C(C(C(C=O)O)O)(CC(C)O)=O,,,3,1,5,17,22
808_0,,,,2,2,1,3
C(CC(C(C(C(C)=O)O)O)O)=O,,,3,1,4,21,25
810_0,,,,2,2,1,3
C(CC(C)(C(C(C=O)O)O)O)=O,,,3,1,3,21,24
811_0,,,,2,2,1,3
812_0,,,,2,2,1,3
812_1,,,,2,2,1,3
814_0,,,,2,2,1,3
C(C(C(C(C=O)C(C=O)O)O)O)=O,,,3,1,5,22,27
814_1,,,,2,2,1,3
816_0,,,,2,2,1,3
C(CC(C(C=O)O)O)=O,,,3,1,8,39,47
818_0,,,,2,2,1,3
C(CO)(CC(CO)(C)O)=O,,,3,1,7,20,27
820_0,,,,2,2,1,3
C(C)(C(C(CO)(C)O)O)=O,,,3,1,7,18,25
820_1,,,,2,2,1,3
821_0,,,,2,2,1,3
822_0,,,,2,2,1,3
822_1,,,,2,2,1,3
824_0,,,,2,2,1,3
C(C(CC(CC(CO)=O)O)O)=O,,,3,1,3,16,19
826_0,,,,2,2,1,3
C(C(CC(C(C(C)=O)O)O)O)=O,,,3,1,3,18,21
826_1,,,,2,2,1,3
828_0,,,,2,2,1,3
C(C(C(CO)(C)O)C(C=O)O)=O,,,3,1,6,17,23
828_1,,,,2,2,1,3
830_0,,,,2,2,1,3
C(C(C(C(CC(CO)=O)O)O)O)=O,,,3,1,6,20,26
832_0,,,,2,2,1,3
C(C(C(C(C(C(C)=O)O)O)O)O)=O,,,3,1,8,22,30
832_1,,,,2,2,1,3
834_0,,,,2,2,1,3
C(CO)(CC(C)O)=O,,,3,1,10,66,76
836_0,,,,2,2,1,3
C(C)(C(C(C)O)O)=O,,,3,1,10,56,66
836_1,,,,2,2,1,3
838_0,,,,2,2,1,3
C(CC(C)(CO)O)=O,,,3,1,4,45,49
840_0,,,,2,2,1,3
C(CO)(CC(CO)(C(CO)O)O)=O,,,3,1,4,10,14
842_0,,,,2,2,1,3
C(C)(C(C(CO)(C(CO)O)O)O)=O,,,3,1,6,11,17
842_1,,,,2,2,1,3
844_0,,,,2,2,1,3
C(C(C(CO)(C)O)O)(C(CO)O)=O,,,3,1,6,12,18
844_1,,,,2,2,1,3
846_0,,,,2,2,1,3
C(C(C(C)O)C(C=O)O)=O,,,3,1,5,22,27
846_1,,,,2,2,1,3
848_0,,,,2,2,1,3
C(CC(C(CC=O)O)O)=O,,,3,1,2,16,18
850_0,,,,2,2,1,3
C(CC(CC(C=O)O)O)=O,,,3,1,3,26,29
851_0,,,,2,2,1,3
853_0,,,,2,2,1,3
C(CC(C)O)=O,,,3,1,7,197,204
855_0,,,,2,2,1,3
C(CC(CO)(C(CO)O)O)=O,,,3,1,5,14,19
857_0,,,,2,2,1,3
C(C(C(C)O)O)(C(CO)O)=O,,,3,1,8,15,23
857_1,,,,2,2,1,3
859_0,,,,2,2,1,3
C(CC(C(CC(CCO)=O)=O)O)=O,,,3,1,1,14,15
861_0,,,,2,2,1,3
C(CC(C=O)(CC=O)O)(CCO)=O,,,3,1,1,13,14
863_0,,,,2,2,1,3
C(CC(CCO)(CC(C=O)=O)O)=O,,,3,1,1,14,15
865_0,,,,2,2,1,3
C(CCO)(C(C(C=O)=O)C(C)O)=O,,,3,1,2,12,14
865_1,,,,2,2,1,3
867_0,,,,2,2,1,3
C(C(CO)C(C)O)(CC(C=O)=O)=O,,,3,1,2,13,15
867_1,,,,2,2,1,3
869_0,,,,2,2,1,3
C(CC(C(CCC(CO)=O)=O)O)=O,,,3,1,1,16,17
871_0,,,,2,2,1,3
C(CO)(CCC(C=O)(CC=O)O)=O,,,3,1,2,16,18
873_0,,,,2,2,1,3
C(CC(CCC(C=O)=O)(CO)O)=O,,,3,1,2,17,19
875_0,,,,2,2,1,3
C(CC(C(C=O)=O)C(C)O)(CO)=O,,,3,1,1,14,15
877_0,,,,2,2,1,3
C(CO)(C(C(C)O)CC(C=O)=O)=O,,,3,1,1,14,15
879_0,,,,2,2,1,3
C(CCC(C=O)=O)(C(C(C)O)O)=O,,,3,1,2,14,16
879_1,,,,2,2,1,3
881_0,,,,2,2,1,3
C(CC(C(CC(C(C)=O)O)=O)O)=O,,,3,1,2,17,19
883_0,,,,2,2,1,3
C(C)(C(CC(C=O)(CC=O)O)O)=O,,,3,1,1,15,16
885_0,,,,2,2,1,3
C(CC(C)(C(CC(C=O)=O)O)O)=O,,,3,1,2,18,20
887_0,,,,2,2,1,3
C(C(C(C(C=O)=O)C(C)O)O)(C)=O,,,3,1,4,14,18
887_1,,,,2,2,1,3
889_0,,,,2,2,1,3
C(C(CC(C=O)=O)O)(CC(C)O)=O,,,3,1,2,13,15
891_0,,,,2,2,1,3
C(CC(C(CC(CC=O)O)=O)O)=O,,,3,1,4,18,22
893_0,,,,2,2,1,3
C(CC(CC(C=O)(CC=O)O)O)=O,,,3,1,1,18,19
895_0,,,,2,2,1,3
C(CC(CC(CC(C=O)=O)O)O)=O,,,3,1,1,18,19
897_0,,,,2,2,1,3
C(CC(C(C(C=O)=O)C(C)O)O)=O,,,3,1,4,16,20
897_1,,,,2,2,1,3
899_0,,,,2,2,1,3
C(C(C(CC(C=O)=O)O)C(C)O)=O,,,3,1,4,15,19
899_1,,,,2,2,1,3
901_0,,,,2,2,1,3
C(CC(CC(C(CCO)=O)=O)O)=O,,,3,1,1,13,14
903_0,,,,2,2,1,3
C(CC(C(CCO)=O)(CC=O)O)=O,,,3,1,1,8,9
905_0,,,,2,2,1,3
C(C(CCO)(CC=O)O)(CC=O)=O,,,3,1,1,14,15
907_0,,,,2,2,1,3
C(C(C(C(CCO)=O)=O)C(C)O)=O,,,3,1,2,12,14
907_1,,,,2,2,1,3
909_0,,,,2,2,1,3
C(CC(C(C(CO)C(C)O)=O)=O)=O,,,3,1,2,13,15
909_1,,,,2,2,1,3
911_0,,,,2,2,1,3
C(CC(CC(CC(CO)=O)=O)O)=O,,,3,1,2,14,16
913_0,,,,2,2,1,3
C(CC(CC=O)(CC(CO)=O)O)=O,,,3,1,2,9,11
915_0,,,,2,2,1,3
C(CC(CC(CO)(CC=O)O)=O)=O,,,3,1,2,15,17
917_0,,,,2,2,1,3
C(C(C(CC(CO)=O)=O)C(C)O)=O,,,3,1,3,11,14
917_1,,,,2,2,1,3
919_0,,,,2,2,1,3
C(CC=O)(C(C(CO)=O)C(C)O)=O,,,3,1,3,11,14
919_1,,,,2,2,1,3
921_0,,,,2,2,1,3
C(CC(CC(C(C(C)O)O)=O)=O)=O,,,3,1,2,12,14
921_1,,,,2,2,1,3
923_0,,,,2,2,1,3
C(CC(CC(C(C(C)=O)O)=O)O)=O,,,3,1,1,14,15
925_0,,,,2,2,1,3
C(CC(C(C(C)=O)O)(CC=O)O)=O,,,3,1,1,9,10
927_0,,,,2,2,1,3
C(CC(C)(C(C(CC=O)=O)O)O)=O,,,3,1,3,16,19
929_0,,,,2,2,1,3
C(C(C(C(C(C)=O)O)=O)C(C)O)=O,,,3,1,2,10,12
929_1,,,,2,2,1,3
931_0,,,,2,2,1,3
C(CC(C(C(CC(C)O)=O)O)=O)=O,,,3,1,1,10,11
932_0,,,,2,2,1,3
934_0,,,,2,2,1,3
C(CC(C(CC=O)O)(CC=O)O)=O,,,3,1,1,13,14
936_0,,,,2,2,1,3
C(CC(CC(C(CC=O)=O)O)O)=O,,,3,1,2,18,20
938_0,,,,2,2,1,3
C(CC(C(C(C=O)C(C)O)=O)O)=O,,,3,1,3,14,17
938_1,,,,2,2,1,3
940_0,,,,2,2,1,3
C(C(C(C)O)C(C(CC=O)=O)O)=O,,,3,1,5,16,21
940_1,,,,2,2,1,3
942_0,,,,2,2,1,3
C(CC(C(C(CC(C)=O)=O)O)O)=O,,,3,1,1,16,17
944_0,,,,2,2,1,3
C(CC(C(C=O)O)(CC(C)=O)O)=O,,,3,1,1,14,15
946_0,,,,2,2,1,3
C(C(C(CC(C)(CC=O)O)=O)O)=O,,,3,1,2,15,17
948_0,,,,2,2,1,3
C(C(C=O)O)(C(C(C)=O)C(C)O)=O,,,3,1,2,10,12
948_1,,,,2,2,1,3
950_0,,,,2,2,1,3
C(C(C=O)O)(CC(CC(C)O)=O)=O,,,3,1,1,10,11
952_0,,,,2,2,1,3
C(CC(C(C(CCC=O)=O)O)O)=O,,,3,1,1,18,19
954_0,,,,2,2,1,3
C(CCC(C(C=O)O)(CC=O)O)=O,,,3,1,1,20,21
956_0,,,,2,2,1,3
C(C(C(CCC(CC=O)O)=O)O)=O,,,3,1,1,17,18
958_0,,,,2,2,1,3
C(C(C(C)O)CC=O)(C(C=O)O)=O,,,3,1,1,14,15
960_0,,,,2,2,1,3
C(C(C(C)O)CC(C(C=O)O)=O)=O,,,3,1,1,14,15
962_0,,,,2,2,1,3
C(CC(C(CC(C(C)=O)=O)O)O)=O,,,3,1,2,18,20
964_0,,,,2,2,1,3
C(C)(C(CC(C=O)O)(CC=O)O)=O,,,3,1,1,15,16
966_0,,,,2,2,1,3
C(CC(C=O)O)(C(C)(CC=O)O)=O,,,3,1,1,15,16
968_0,,,,2,2,1,3
C(C(C(C(C(C)=O)=O)C(C)O)O)=O,,,3,1,2,13,15
968_1,,,,2,2,1,3
970_0,,,,2,2,1,3
C(C(CC(C(CC(C)O)=O)=O)O)=O,,,3,1,1,11,12
972_0,,,,2,2,1,3
C(CC(CC(C(CC=O)O)O)=O)=O,,,3,1,2,20,22
974_0,,,,2,2,1,3
C(CC(CC(C=O)O)(CC=O)O)=O,,,3,1,2,12,14
976_0,,,,2,2,1,3
C(CC(C=O)O)(CC(CC=O)O)=O,,,3,1,2,17,19
978_0,,,,2,2,1,3
C(C(C(C)O)C(C=O)O)(CC=O)=O,,,3,1,3,16,19
978_1,,,,2,2,1,3
980_0,,,,2,2,1,3
C(CC(C=O)O)(C(C=O)C(C)O)=O,,,3,1,3,13,16
980_1,,,,2,2,1,3
982_0,,,,2,2,1,3
C(CC(C(C=CC(CO)O)=O)O)=O,,,3,1,1,7,8
984_0,,,,2,2,1,3
C(C(C=CC(CO)O)(CC=O)O)=O,,,3,1,1,6,7
986_0,,,,2,2,1,3
C(CC(C(C(C=CCO)=O)O)O)=O,,,3,1,1,11,12
988_0,,,,2,2,1,3
C(CC(C=CCO)(C(C=O)O)O)=O,,,3,1,1,9,10
990_0,,,,2,2,1,3
C(CC(C=CC(C(CO)O)=O)O)=O,,,3,1,1,13,14
992_0,,,,2,2,1,3
C(CC(C=CC=O)(C(CO)O)O)=O,,,3,1,1,11,12
994_0,,,,2,2,1,3
C(CC(C(C(C(C=C)=O)O)O)O)=O,,,3,1,3,20,23
996_0,,,,2,2,1,3
C(C(C(C(C=C)(CC=O)O)O)O)=O,,,3,1,1,17,18
998_0,,,,2,2,1,3
C(CC(C(C=CC(CO)=O)O)O)=O,,,3,1,1,11,12
1000_0,,,,2,2,1,3
C(C(C=CC(CO)(CC=O)O)O)=O,,,3,1,1,10,11
1002_0,,,,2,2,1,3
C(C(C=CC(C(C(C)O)O)=O)O)=O,,,3,1,2,12,14
1002_1,,,,2,2,1,3
1004_0,,,,2,2,1,3
C(CC(C(C(C=CC=O)O)O)O)=O,,,3,1,1,13,14
1006_0,,,,2,2,1,3
C(C(C(C=CC(CC=O)O)O)O)=O,,,3,1,1,13,14
1008_0,,,,2,2,1,3
C(C(C(CO)(CO)O)O)=O,,,3,1,9,15,24
1008_1,,,,2,2,1,3
1010_0,,,,2,2,1,3
C(CO)(C(C(CO)O)O)=O,,,3,1,13,22,35
1010_1,,,,2,2,1,3
1012_0,,,,2,2,1,3
C(C(C(C(CO)O)O)O)=O,,,3,1,14,20,34
1012_1,,,,2,2,1,3
1013_0,,,,2,2,1,3
1013_1,,,,2,2,1,3
1015_0,,,,2,2,1,3
C(C(C)(C(C=O)O)O)=O,,,3,1,14,27,41
1015_1,,,,2,2,1,3
1017_0,,,,2,2,1,3
C(C(CC(CO)O)=O)=O,,,3,1,10,28,38
1018_0,,,,2,2,1,3
1018_1,,,,2,2,1,3
1020_0,,,,2,2,1,3
C(CC(CO)(C(C=O)O)O)=O,,,3,1,8,19,27
1020_1,,,,2,2,1,3
1022_0,,,,2,2,1,3
C(C(C(CO)=O)C(CO)O)=O,,,3,1,6,16,22
1022_1,,,,2,2,1,3
1023_0,,,,2,2,1,3
1023_1,,,,2,2,1,3
1024_0,,,,2,2,1,3
1024_1,,,,2,2,1,3
1026_0,,,,2,2,1,3
C(C(C(C)(C(C=O)O)O)O)=O,,,3,1,5,10,15
1026_1,,,,2,2,1,3
1027_0,,,,2,2,1,3
1028_0,,,,2,2,1,3
1028_1,,,,2,2,1,3
1030_0,,,,2,2,1,3
C(C(C(C)(C(CO)O)O)O)=O,,,3,1,7,14,21
1030_1,,,,2,2,1,3
1031_0,,,,2,2,1,3
1032_0,,,,2,2,1,3
1032_1,,,,2,2,1,3
1034_0,,,,2,2,1,3
C(C(CC(CO)(C(C=O)O)O)O)=O,,,3,1,3,18,21
1034_1,,,,2,2,1,3
1036_0,,,,2,2,1,3
C(CO)(C(C(CO)O)C(C=O)O)=O,,,3,1,5,17,22
1036_1,,,,2,2,1,3
1038_0,,,,2,2,1,3
C(CC(C=O)O)(C(C(CO)O)O)=O,,,3,1,6,16,22
1038_1,,,,2,2,1,3
1039_0,,,,2,2,1,3
1039_1,,,,2,2,1,3
1040_0,,,,2,2,1,3
1040_1,,,,2,2,1,3
1042_0,,,,2,2,1,3
C(C(CCO)(C(C=O)O)O)=O,,,3,1,7,16,23
1042_1,,,,2,2,1,3
1044_0,,,,2,2,1,3
C(C(C(CO)C(CO)O)=O)=O,,,3,1,7,18,25
1044_1,,,,2,2,1,3
1046_0,,,,2,2,1,3
C(C(C(CO)(CCO)O)O)=O,,,3,1,7,13,20
1046_1,,,,2,2,1,3
1047_0,,,,2,2,1,3
1047_1,,,,2,2,1,3
1049_0,,,,2,2,1,3
C(CO)(C(CO)C(CO)O)=O,,,3,1,10,14,24
1049_1,,,,2,2,1,3
1050_0,,,,2,2,1,3
1050_1,,,,2,2,1,3
1052_0,,,,2,2,1,3
C(C(C(C(C)(C(C=O)O)O)O)O)=O,,,3,1,6,21,27
1052_1,,,,2,2,1,3
1054_0,,,,2,2,1,3
C(C(C(C=O)O)O)(CC(CO)O)=O,,,3,1,6,17,23
1056_0,,,,2,2,1,3
C(C(C(C(C=O)O)O)O)=O,,,3,1,7,15,22
1056_1,,,,2,2,1,3
1058_0,,,,2,2,1,3
C(C(C(CO)(C)O)O)=O,,,3,1,12,22,34
1058_1,,,,2,2,1,3
1060_0,,,,2,2,1,3
C(CO)(CC(CO)O)=O,,,3,1,14,30,44
1062_0,,,,2,2,1,3
C(C)(C(C(CO)O)O)=O,,,3,1,14,27,41
1062_1,,,,2,2,1,3
1063_0,,,,2,2,1,3
1063_1,,,,2,2,1,3
1064_0,,,,2,2,1,3
1064_1,,,,2,2,1,3
1066_0,,,,2,2,1,3
C(C(C(CO)O)C(C=O)O)=O,,,3,1,7,19,26
1066_1,,,,2,2,1,3
1068_0,,,,2,2,1,3
C(C(C(C(C(C=O)O)O)O)O)=O,,,3,1,6,12,18
1068_1,,,,2,2,1,3
1070_0,,,,2,2,1,3
C(C(C(C)O)O)=O,,,3,1,22,100,122
1070_1,,,,2,2,1,3
1072_0,,,,2,2,1,3
C(CC(CO)O)=O,,,3,1,11,100,111
1074_0,,,,2,2,1,3
C(C(C(CO)(C(CO)O)O)O)=O,,,3,1,9,13,22
1074_1,,,,2,2,1,3
1075_0,,,,2,2,1,3
1075_1,,,,2,2,1,3
1077_0,,,,2,2,1,3
C(C(CC(C(C(CO)O)O)O)=O)=O,,,3,1,7,15,22
1079_0,,,,2,2,1,3
C(CO)(CC(C(C(CO)O)O)O)=O,,,3,1,7,12,19
1081_0,,,,2,2,1,3
C(C)(C(C(C(C(CO)O)O)O)O)=O,,,3,1,8,14,22
1081_1,,,,2,2,1,3
1082_0,,,,2,2,1,3
1083_0,,,,2,2,1,3
1083_1,,,,2,2,1,3
1085_0,,,,2,2,1,3
C(C(C(C(C(CO)O)O)=O)CO)=O,,,3,1,13,15,28
1085_1,,,,2,2,1,3
1087_0,,,,2,2,1,3
C(C(C(C(CO)C(CO)O)=O)O)=O,,,3,1,9,15,24
1087_1,,,,2,2,1,3
1089_0,,,,2,2,1,3
C(C(CO)C(C=O)O)(C(CO)O)=O,,,3,1,14,18,32
1089_1,,,,2,2,1,3
1091_0,,,,2,2,1,3
C(C(C(C=O)O)O)(C(CO)CO)=O,,,3,1,12,14,26
1091_1,,,,2,2,1,3
1092_0,,,,2,2,1,3
1092_1,,,,2,2,1,3
1093_0,,,,2,2,1,3
1093_1,,,,2,2,1,3
1094_0,,,,2,2,1,3
1096_0,,,,2,2,1,3
C(C(CO)C(C(C(C=O)O)O)O)=O,,,3,1,14,22,36
1096_1,,,,2,2,1,3
1097_0,,,,2,2,1,3
1097_1,,,,2,2,1,3
1099_0,,,,2,2,1,3
C(C(C)O)(O)=O,,,3,1,3,59,62
1099_1,,,,2,2,1,3
1100_0,,,,2,2,1,3
1100_1,,,,2,2,1,3
1102_0,,,,2,2,1,3
C(C(CCO)O)(O)=O,,,3,1,4,16,20
1102_1,,,,2,2,1,3
1104_0,,,,2,2,1,3
C(C(CO)(CC(CO)O)O)(O)=O,,,3,1,1,9,10
1106_0,,,,2,2,1,3
C(C(C(CC(CO)O)O)O)(O)=O,,,3,1,6,10,16
1106_1,,,,2,2,1,3
1108_0,,,,2,2,1,3
C(CC(C(O)=O)O)(CCO)=O,,,3,1,6,14,20
1108_1,,,,2,2,1,3
1110_0,,,,2,2,1,3
C(C(CCC(CO)=O)O)(O)=O,,,3,1,4,12,16
1110_1,,,,2,2,1,3
1112_0,,,,2,2,1,3
C(C(CC(C(C)=O)O)O)(O)=O,,,3,1,3,11,14
1112_1,,,,2,2,1,3
1114_0,,,,2,2,1,3
C(CC(CC(C(O)=O)O)O)=O,,,3,1,5,15,20
1114_1,,,,2,2,1,3
1116_0,,,,2,2,1,3
C(C(CCO)(CC=O)O)(O)=O,,,3,1,3,13,16
1118_0,,,,2,2,1,3
C(C(C)(CC(C=O)O)O)(O)=O,,,3,1,1,11,12
1120_0,,,,2,2,1,3
C(C(C=CC(CO)O)O)(O)=O,,,3,1,4,7,11
1120_1,,,,2,2,1,3
1121_0,,,,2,1,2,3
1122_0,,,,2,1,2,3
1124_0,,,,2,1,2,3
C(C(C(CO)O)=O)=O,,,3,1,23,61,84
1126_0,,,,2,1,2,3
C(C(C(CC(CO)O)=O)=O)=O,,,3,1,2,17,19
1128_0,,,,2,1,2,3
C(C(CO)O)(CC(C=O)=O)=O,,,3,1,3,21,24
1130_0,,,,2,1,2,3
C(CCO)(C(C(C=O)=O)O)=O,,,3,1,2,18,20
1132_0,,,,2,1,2,3
C(CO)(CC(C(C=O)=O)O)=O,,,3,1,2,21,23
1134_0,,,,2,1,2,3
C(C)(C(C(C(C=O)=O)O)O)=O,,,3,1,4,22,26
1136_0,,,,2,1,2,3
C(CC(C(C(C=O)=O)O)O)=O,,,3,1,4,23,27
1137_0,,,,2,1,1,2
1137_1,,,,2,1,1,2
1138_0,,,,2,1,1,2
1138_1,,,,2,1,1,2
1139_0,,,,2,1,2,3
1139_1,,,,2,1,2,3
1140_0,,,,2,1,1,2
1141_0,,,,2,1,1,2
1141_1,,,,2,1,1,2
1142_0,,,,2,1,1,2
1142_1,,,,2,1,1,2
1144_0,,,,2,1,2,3
C(C(CO)=O)=O,,,3,1,51,271,322
1144_1,,,,2,1,2,3
1145_0,,,,2,1,2,3
1146_0,,,,2,1,2,3
1146_1,,,,2,1,2,3
1147_0,,,,2,1,2,3
1147_1,,,,2,1,2,3
1148_0,,,,2,1,2,3
1149_0,,,,2,1,2,3
1150_0,,,,2,1,2,3
1151_0,,,,2,1,2,3
1151_1,,,,2,1,2,3
1152_0,,,,2,1,2,3
1152_1,,,,2,1,2,3
1153_0,,,,2,1,2,3
1154_0,,,,2,1,2,3
1154_1,,,,2,1,2,3
1155_0,,,,2,1,2,3
1155_1,,,,2,1,2,3
1156_0,,,,2,1,2,3
1156_1,,,,2,1,2,3
1157_0,,,,2,1,2,3
1157_1,,,,2,1,2,3
1158_0,,,,2,1,2,3
1160_0,,,,2,1,2,3
C(CC(C(CO)=O)O)=O,,,3,1,7,41,48
1160_1,,,,2,1,2,3
1161_0,,,,2,1,2,3
1163_0,,,,2,1,2,3
C(C(CO)=O)(C)=O,,,3,1,14,150,164
1164_0,,,,2,1,2,3
1166_0,,,,2,1,2,3
C(CO)(CC(CO)=O)=O,,,3,1,5,26,31
1166_1,,,,2,1,2,3
1168_0,,,,2,1,2,3
C(CO)(C(C(C)=O)O)=O,,,3,1,8,36,44
1169_0,,,,2,1,2,3
1170_0,,,,2,1,2,3
1170_1,,,,2,1,2,3
1171_0,,,,2,1,2,3
1171_1,,,,2,1,2,3
1172_0,,,,2,1,2,3
1172_1,,,,2,1,2,3
1174_0,,,,2,1,2,3
C(C(C(C)O)=O)=O,,,3,1,19,101,120
1174_1,,,,2,1,2,3
1176_0,,,,2,1,2,3
C(CO)(C(C)O)=O,,,3,1,12,121,133
1176_1,,,,2,1,2,3
1178_0,,,,2,1,2,3
C(CC=O)=O,,,3,1,33,372,405
1178_1,,,,2,1,2,3
1180_0,,,,2,1,2,3
C(C(C(CO)=O)O)=O,,,3,1,15,80,95
1181_0,,,,2,1,2,3
1182_0,,,,2,1,2,3
1183_0,,,,2,1,2,3
1183_1,,,,2,1,2,3
1184_0,,,,2,1,2,3
1184_1,,,,2,1,2,3
1185_0,,,,2,1,2,3
1186_0,,,,2,1,2,3
1186_1,,,,2,1,2,3
1187_0,,,,2,1,2,3
1189_0,,,,2,1,2,3
C(C(CCO)O)=O,,,3,1,21,72,93
1189_1,,,,2,1,2,3
1191_0,,,,2,1,2,3
C(C(C)=O)(O)=O,,,3,1,6,136,142
1193_0,,,,2,1,2,3
C(=O)=O,,,3,1,44,803,847
1193_1,,,,2,1,2,3
1195_0,,,,2,1,2,3
C(CC(CO)=O)(O)=O,,,3,1,6,66,72
1195_1,,,,2,1,2,3
1196_0,,,,2,1,2,3
1196_1,,,,2,1,2,3
1198_0,,,,2,1,2,3
C(C(C(C)=O)O)(O)=O,,,3,1,7,54,61
1200_0,,,,2,1,2,3
C(C(O)=O)=O,,,3,1,21,141,162
1202_0,,,,2,1,2,3
C(C(CC(CO)=O)O)(O)=O,,,3,1,5,23,28
1202_1,,,,2,1,2,3
1203_0,,,,2,1,2,3
1203_1,,,,2,1,2,3
1205_0,,,,2,1,2,3
C(C(C(C(C)=O)O)O)(O)=O,,,3,1,6,25,31
1207_0,,,,2,1,2,3
C(C(C=O)O)(O)=O,,,3,1,8,92,100
1208_0,,,,2,1,2,3
1208_1,,,,2,1,2,3
1210_0,,,,2,1,2,3
C(C(C(C=O)O)O)(O)=O,,,3,1,9,33,42
1212_0,,,,2,1,2,3
C(CC(C=O)O)(O)=O,,,3,1,5,42,47
1212_1,,,,2,1,2,3
1214_0,,,,2,1,1,2
C(C)(C(CO)(C(C=O)O)O)=O,,,3,1,10,19,29
1215_0,,,,2,1,1,2
1215_1,,,,2,1,1,2
1215_2,,,,2,1,1,2
1216_0,,,,2,1,2,3
1216_1,,,,2,1,2,3
1216_2,,,,2,1,2,3
1217_0,,,,2,1,1,2
1217_1,,,,2,1,1,2
1217_2,,,,2,1,1,2
1218_0,,,,2,1,1,2
1218_1,,,,2,1,1,2
1218_2,,,,2,1,1,2
1219_0,,,,2,1,2,3
1219_1,,,,2,1,2,3
1219_2,,,,2,1,2,3
1221_0,,,,2,1,2,3
C(C)(CC(C=O)=O)=O,,,3,1,6,96,102
1222_0,,,,2,1,2,3
1223_0,,,,2,1,2,3
1225_0,,,,2,1,2,3
C(CC(C=O)=O)=O,,,3,1,32,156,188
1227_0,,,,2,1,2,3
C(CC(C(C)=O)=O)=O,,,3,1,3,95,98
1228_0,,,,2,1,2,3
1230_0,,,,2,1,2,3
C(C(C)=O)(C)=O,,,3,1,7,136,143
1232_0,,,,2,1,2,3
C(CC(C)=O)=O,,,3,1,16,324,340
1234_0,,,,2,1,1,2
C(OC(C(C)=O)C(CO)O)=O,,,3,1,1,9,10
1236_0,,,,2,1,2,3
C1(COC(C1)O)=O,,,3,1,4,148,152
1236_1,,,,2,1,2,3
1238_0,,,,2,1,1,2
C(C(C(OCC(C)=O)O)O)=O,,,3,1,3,18,21
1238_1,,,,2,1,1,2
1240_0,,,,2,1,1,2
C(C(CO)OCC(CO)=O)=O,,,3,1,2,13,15
1240_1,,,,2,1,1,2
1242_0,,,,2,1,1,2
C(C(CO)OC(C(C)=O)O)=O,,,3,1,1,11,12
1244_0,,,,2,1,1,2
C(OC(CO)C(C(C)=O)O)=O,,,3,1,1,6,7
1246_0,,,,2,1,1,2
C(OC(CO)CC(CO)=O)=O,,,3,1,2,7,9
1246_1,,,,2,1,1,2
1248_0,,,,2,1,1,2
C(C)(C(CO)OC(C=O)O)=O,,,3,1,1,11,12
1250_0,,,,2,1,2,3
C1(COC(C(C1)O)O)=O,,,3,1,3,29,32
1250_1,,,,2,1,2,3
1252_0,,,,2,1,1,2
C(C(COCC(CO)=O)O)=O,,,3,1,2,16,18
1252_1,,,,2,1,1,2
1254_0,,,,2,1,1,2
C(C(COC(C(C)=O)O)O)=O,,,3,1,1,13,14
1256_0,,,,2,1,1,2
C(OCC(C(C(C)=O)O)O)=O,,,3,1,1,9,10
1258_0,,,,2,1,1,2
C(CO)(CC(OCC=O)O)=O,,,3,1,3,18,21
1258_1,,,,2,1,1,2
1260_0,,,,2,1,1,2
C(OCC(CC(CO)=O)O)=O,,,3,1,2,8,10
1260_1,,,,2,1,1,2
1262_0,,,,2,1,1,2
C(C)(C(C(OCC=O)O)O)=O,,,3,1,1,18,19
1264_0,,,,2,1,1,2
C(C)(C(COC(C=O)O)O)=O,,,3,1,1,13,14
1266_0,,,,2,1,1,2
C(CO)(CCOC(C=O)O)=O,,,3,1,2,15,17
1266_1,,,,2,1,1,2
1267_0,,,,2,1,1,2
1269_0,,,,2,1,2,3
C(C=CC(CO)=O)=O,,,3,1,4,97,101
1269_1,,,,2,1,2,3
1271_0,,,,2,1,2,3
C=CC(C=O)=O,,,3,1,13,266,279
1271_1,,,,2,1,2,3
1273_0,,,,2,1,2,3
C=CC(CO)=O,,,3,1,17,267,284
1273_1,,,,2,1,2,3
1275_0,,,,2,1,2,3
C(C=CC=O)=O,,,3,1,11,175,186
1275_1,,,,2,1,2,3
1277_0,,,,2,1,2,3
C1(C(C(CO1)O)O)=O,,,3,1,4,27,31
1279_0,,,,2,1,2,3
C1(CC(CO1)O)=O,,,3,1,7,36,43
1279_1,,,,2,1,2,3
1281_0,,,,2,1,1,2
C(CC(CO)(OCC=O)O)=O,,,3,1,2,17,19
1281_1,,,,2,1,1,2
1283_0,,,,2,1,1,2
C(C(C(C)(OCC=O)O)O)=O,,,3,1,2,17,19
1283_1,,,,2,1,1,2
1285_0,,,,2,1,1,2
C(C(CC(OCC=O)O)O)=O,,,3,1,3,14,17
1285_1,,,,2,1,1,2
1287_0,,,,2,1,1,2
C1(C(C(C(CO)C1O)O)O)=O,,,3,1,3,14,17
1288_0,,,,2,1,1,2
1290_0,,,,2,1,1,2
C(C(C(C(C(CO)O)O)=O)O)=O,,,3,1,4,15,19
1291_0,,,,2,1,1,2
1292_0,,,,2,1,1,2
1293_0,,,,2,1,1,2
1294_0,,,,2,1,1,2
1295_0,,,,2,1,1,2
1296_0,,,,2,1,1,2
1297_0,,,,2,1,1,2
1299_0,,,,2,1,1,2
C(C(CC(C=O)O)O)=O,,,3,1,1,13,14
1300_0,,,,2,1,1,2
1301_0,,,,2,1,1,2
1303_0,,,,2,1,1,2
C(C(C(C(C)O)=O)O)=O,,,3,1,1,28,29
1304_0,,,,2,1,1,2
1306_0,,,,2,1,1,2
C(C(C)O)=O,,,3,1,31,234,265
1307_0,,,,2,1,1,2
1308_0,,,,2,1,1,2
1309_0,,,,2,1,1,2
1310_0,,,,2,1,1,2
1311_0,,,,2,1,1,2
1312_0,,,,2,1,1,2
1313_0,,,,2,1,1,2
1314_0,,,,2,1,1,2
1315_0,,,,2,1,1,2
1316_0,,,,2,1,1,2
1317_0,,,,2,1,1,2
1318_0,,,,2,1,1,2
1319_0,,,,2,1,1,2
1320_0,,,,2,1,1,2
1321_0,,,,2,1,1,2
1322_0,,,,2,1,1,2
1324_0,,,,2,1,1,2
C(C(C(CO)O)=O)(CCO)=O,,,3,1,3,16,19
1326_0,,,,2,1,1,2
C(C(CO)=O)(C(CCO)O)=O,,,3,1,3,12,15
1327_0,,,,2,1,1,2
1329_0,,,,2,1,1,2
C(C(C(C(CCO)O)O)=O)=O,,,3,1,7,17,24
1330_0,,,,2,1,1,2
1331_0,,,,2,1,1,2
1332_0,,,,2,1,1,2
1333_0,,,,2,1,1,2
1334_0,,,,2,1,1,2
1335_0,,,,2,1,1,2
1336_0,,,,2,1,1,2
1338_0,,,,2,1,1,2
C(C(CO)O)(C(C(C)=O)O)=O,,,3,1,7,15,22
1340_0,,,,2,1,1,2
C(C(C)O)(C(C(CO)=O)O)=O,,,3,1,3,12,15
1341_0,,,,2,1,1,2
1343_0,,,,2,1,1,2
C(C(C(C(C(C)O)O)=O)O)=O,,,3,1,5,16,21
1344_0,,,,2,1,1,2
1345_0,,,,2,1,1,2
1346_0,,,,2,1,1,2
1348_0,,,,2,1,1,2
C(C(CC(C(CO)O)O)O)=O,,,3,1,5,13,18
1350_0,,,,2,1,1,2
C(C(CCO)O)(C(CO)O)=O,,,3,1,6,12,18
1352_0,,,,2,1,1,2
C(CO)(C(CC(CO)O)O)=O,,,3,1,5,11,16
1354_0,,,,2,1,1,2
C(C(C(CO)O)O)(C(C)O)=O,,,3,1,6,13,19
1356_0,,,,2,1,1,2
C(CO)(C(C(CCO)O)O)=O,,,3,1,7,13,20
1358_0,,,,2,1,1,2
C(CC(C(C(CO)O)=O)O)(O)=O,,,3,1,5,10,15
1360_0,,,,2,1,1,2
C(C(C(CC(CO)O)O)=O)(O)=O,,,3,1,3,10,13
1362_0,,,,2,1,1,2
C(C(CC(C(CO)=O)O)O)(O)=O,,,3,1,4,9,13
1364_0,,,,2,1,1,2
C(C(C(C(CCO)O)=O)O)(O)=O,,,3,1,3,10,13
1366_0,,,,2,1,1,2
C(C(C(CC(C=O)O)O)O)(O)=O,,,3,1,7,15,22
1368_0,,,,2,1,1,2
C(C(C(C(O)=O)O)O)(C(C)O)=O,,,3,1,6,11,17
1370_0,,,,2,1,1,2
C(CC(C(C(CO)=O)O)O)(O)=O,,,3,1,4,10,14
1372_0,,,,2,1,1,2
C(C(CCC(C=O)=O)O)=O,,,3,1,6,22,28
1374_0,,,,2,1,1,2
C(C(C)O)(CC(C=O)=O)=O,,,3,1,3,23,26
1375_0,,,,2,1,1,2
1377_0,,,,2,1,1,2
C(CC(C(C(C)=O)=O)O)=O,,,3,1,4,25,29
1379_0,,,,2,1,1,2
C(CC(C(C(C)O)=O)=O)=O,,,3,1,4,22,26
1380_0,,,,2,1,1,2
1382_0,,,,2,1,1,2
C(C)(CC(C(CO)=O)=O)=O,,,3,1,4,28,32
1384_0,,,,2,1,1,2
C(C)(CC(C(C=O)=O)O)=O,,,3,1,4,27,31
1386_0,,,,2,1,1,2
C(CCC(C(CO)=O)=O)=O,,,3,1,3,25,28
1388_0,,,,2,1,1,2
C(CCC(C(C=O)=O)O)=O,,,3,1,3,22,25
1390_0,,,,2,1,1,2
C(CO)(CC(C(C)=O)=O)=O,,,3,1,4,28,32
1391_0,,,,2,1,1,2
1393_0,,,,2,1,1,2
C1(C(C(CO)O)OCC1O)=O,,,3,1,6,10,16
1395_0,,,,2,1,1,2
C1(C(CC(C(CO)O)O1)O)=O,,,3,1,5,4,9
1397_0,,,,2,1,1,2
C1(C(C(CO)OCC1O)O)=O,,,3,1,3,7,10
1399_0,,,,2,1,1,2
C1(C(CC(C(CO)O1)O)O)=O,,,3,1,4,4,8
1401_0,,,,2,1,1,2
C1(C(CO)OC(CC1O)O)=O,,,3,1,3,9,12
1403_0,,,,2,1,1,2
C1(C(O)OC(CO)CC1O)=O,,,3,1,3,7,10
1405_0,,,,2,1,1,2
C1(C(C(COCC1O)O)O)=O,,,3,1,4,10,14
1407_0,,,,2,1,1,2
C1(C(CC(C(CO1)O)O)O)=O,,,3,1,3,7,10
1409_0,,,,2,1,1,2
C1(C(CC(O)OCC1O)O)=O,,,3,1,4,9,13
1411_0,,,,2,1,1,2
C1(C(O)OCC(CC1O)O)=O,,,3,1,3,8,11
1413_0,,,,2,1,1,2
C1(COC(C(CC1O)O)O)=O,,,3,1,3,10,13
1415_0,,,,2,1,1,2
C1(C(CCOC(C1O)O)O)=O,,,3,1,3,11,14
1417_0,,,,2,1,1,2
C(CO)=CC(C(CO)=O)=O,,,3,1,3,18,21
1419_0,,,,2,1,1,2
C(C(C(C=O)=O)O)=CCO,,,3,1,3,13,16
1421_0,,,,2,1,1,2
C(CO)(C(C=CC=O)O)=O,,,3,1,4,23,27
1423_0,,,,2,1,1,2
C(CO)(C(C(C=C)=O)O)=O,,,3,1,3,25,28
1425_0,,,,2,1,1,2
C(C(C(C(C=C)O)=O)O)=O,,,3,1,3,19,22
1427_0,,,,2,1,1,2
C(C=CC(CO)=O)(CO)=O,,,3,1,2,15,17
1429_0,,,,2,1,1,2
C(C(C=CC(C=O)O)O)=O,,,3,1,4,9,13
1430_0,,,,2,1,1,2
1432_0,,,,2,1,1,2
C(CO)(C1(CC(CO1)O)O)=O,,,3,1,2,7,9
1434_0,,,,2,1,1,2
C(CO)(C1C(CC(O1)O)O)=O,,,3,1,2,10,12
1436_0,,,,2,3,2,5
C(C1C(C(C(C1O)O)O)O)O,,,3,1,1,5,6
1437_0,,,,2,3,2,5
1439_0,,,,2,3,2,5
C(C(CO)O)O,,,3,1,3,8,11
1440_0,,,,2,3,2,5
1441_0,,,,2,3,2,5
1442_0,,,,2,3,2,5
1443_0,,,,2,3,2,5
1444_0,,,,2,3,2,5
1446_0,,,,2,3,2,5
CO,,,3,1,9,53,62
1447_0,,,,2,3,2,5
1448_0,,,,2,3,2,5
1449_0,,,,2,3,2,5
1450_0,,,,2,3,2,5
1451_0,,,,2,3,2,5
1452_0,,,,2,3,2,5
1454_0,,,,2,3,2,5
CCO,,,3,1,5,89,94
1455_0,,,,2,3,2,5
1456_0,,,,2,3,2,5
1457_0,,,,2,3,2,5
1458_0,,,,2,3,2,5
1459_0,,,,2,3,2,5
1461_0,,,,2,3,2,5
C(C(C(CC(CO)O)O)O)=O,,,3,1,6,15,21
1462_0,,,,2,3,2,5
1463_0,,,,2,3,2,5
1465_0,,,,2,3,2,5
C(C(C(C(CCO)O)O)O)O,,,3,1,2,8,10
1466_0,,,,2,3,2,5
1468_0,,,,2,3,2,5
C(C(C(C(CCO)O)O)O)(O)=O,,,3,1,6,10,16
1470_0,,,,2,3,2,5
C(CC(C(C(CO)O)O)O)(O)=O,,,3,1,3,10,13
1472_0,,,,2,3,2,5
C(C1(C(C(CC1O)O)O)O)O,,,3,1,1,7,8
1474_0,,,,2,3,2,5
C(C(C(CO)O)(C(CO)O)O)O,,,3,1,5,4,9
1476_0,,,,2,3,2,5
C(CCO)(CC(CO)=O)=O,,,3,1,6,28,34
1478_0,,,,2,3,2,5
C(CO)(CCC(CO)=O)=O,,,3,1,2,15,17
1479_0,,,,2,3,2,5
1480_0,,,,2,3,2,5
1482_0,,,,2,3,2,5
C(C(CC(CCO)O)=O)=O,,,3,1,3,20,23
1484_0,,,,2,3,2,5
C(C(CCO)=O)(CCO)=O,,,3,1,2,12,14
1485_0,,,,2,3,2,5
1487_0,,,,2,3,2,5
C(CCO)(C(C(C)=O)O)=O,,,3,1,3,24,27
1488_0,,,,2,3,2,5
1490_0,,,,2,3,2,5
C(CC(C(CCO)O)=O)=O,,,3,1,4,21,25
1492_0,,,,2,3,2,5
C(C(CO)O)(CC(C)=O)=O,,,3,1,4,27,31
1494_0,,,,2,3,2,5
C(CCC=O)(C(CO)O)=O,,,3,1,3,27,30
1496_0,,,,2,3,2,5
C(C(C(CCCO)=O)O)=O,,,3,1,2,20,22
1498_0,,,,2,3,2,5
C(C(C)=O)(CC(CO)O)=O,,,3,1,4,21,25
1500_0,,,,2,3,2,5
C(CC(CC(CO)O)=O)=O,,,3,1,5,26,31
1502_0,,,,2,3,2,5
C(CC(C=O)O)(CCO)=O,,,3,1,4,29,33
1504_0,,,,2,3,2,5
C(CC1C(C(C(O)O1)O)O)O,,,3,1,2,6,8
1506_0,,,,2,3,2,5
C(C(CO)O)=CC(CO)=O,,,3,1,4,16,20
1508_0,,,,2,3,2,5
C(CO)=CC(C(CO)O)=O,,,3,1,4,19,23
1509_0,,,,2,3,2,5
1511_0,,,,2,3,2,5
C=CC(C(C(CO)O)O)=O,,,3,1,5,23,28
1512_0,,,,2,3,2,5
1514_0,,,,2,3,2,5
C(C(C(CO)O)O)=CC=O,,,3,1,3,13,16
1516_0,,,,2,3,2,5
C(C(C(C=CCO)O)O)=O,,,3,1,3,16,19
1518_0,,,,2,3,2,5
C(C1(CC(C(CO)O1)O)O)O,,,3,1,3,4,7
1520_0,,,,2,3,2,5
C1C(C(C(CCO)(O)O1)O)O,,,3,1,2,6,8
1522_0,,,,2,3,2,5
C1C(CC(C(CO)O)(O)O1)O,,,3,1,2,6,8
1523_0,,,,2,3,2,5
1525_0,,,,2,3,2,5
CC1(C(C(C(CO)O1)O)O)O,,,3,1,2,5,7
1527_0,,,,2,3,2,5
C(C(C1C(CC(O)O1)O)O)O,,,3,1,2,5,7
1529_0,,,,2,3,2,5
C1C(C(CC(CO)(O)O1)O)O,,,3,1,2,6,8
1531_0,,,,2,3,2,5
C(C1C(C(CC(O)O1)O)O)O,,,3,1,2,5,7
1533_0,,,,2,3,2,5
C(C1C(C(C(C1O)O)O)O)(O)=O,,,3,1,2,7,9
1535_0,,,,2,3,2,5
C(C(C(C(C(CO)O)O)O)=O)(O)=O,,,3,1,1,15,16
1537_0,,,,2,3,2,5
C(C(CO)O)(O)=O,,,3,1,8,62,70
1538_0,,,,2,3,2,5
1539_0,,,,2,3,2,5
1540_0,,,,2,3,2,5
1541_0,,,,2,3,2,5
1542_0,,,,2,3,2,5
1544_0,,,,2,3,2,5
C(O)=O,,,3,1,1,0,1
1546_0,,,,2,3,2,5
C(C(CCO)=O)(O)=O,,,3,1,4,42,46
1547_0,,,,2,3,2,5
1548_0,,,,2,3,2,5
1550_0,,,,2,3,2,5
C(C(CC=O)O)(O)=O,,,3,1,8,56,64
1551_0,,,,2,3,2,5
1552_0,,,,2,3,2,5
1554_0,,,,2,3,2,5
C(C)(O)=O,,,3,1,1,15,16
1555_0,,,,2,3,2,5
1556_0,,,,2,3,2,5
1557_0,,,,2,3,2,5
1558_0,,,,2,3,2,5
1559_0,,,,2,3,2,5
1561_0,,,,2,3,2,5
C(C(CC(C(C=O)O)O)O)(O)=O,,,3,1,8,15,23
1562_0,,,,2,3,2,5
1563_0,,,,2,3,2,5
1564_0,,,,2,3,2,5
1565_0,,,,2,3,2,5
1567_0,,,,2,3,2,5
C(CC(C(C(C(O)=O)O)O)O)(O)=O,,,3,1,3,11,14
1568_0,,,,2,3,2,5
1570_0,,,,2,3,2,5
C(C1(C(C(CC1O)O)O)O)(O)=O,,,3,1,5,13,18
1572_0,,,,2,3,2,5
C(C(C(CO)O)(C(CO)O)O)(O)=O,,,3,1,4,7,11
1574_0,,,,2,3,2,5
C(CCO)(CC(C(O)=O)=O)=O,,,3,1,3,13,16
1576_0,,,,2,3,2,5
C(CO)(CCC(C(O)=O)=O)=O,,,3,1,3,13,16
1578_0,,,,2,3,2,5
C(C)(C(CC(C(O)=O)=O)O)=O,,,3,1,4,13,17
1580_0,,,,2,3,2,5
C(CC(CC(C(O)=O)=O)O)=O,,,3,1,4,15,19
1582_0,,,,2,3,2,5
C(CC(CC(C=O)=O)O)(O)=O,,,3,1,2,15,17
1584_0,,,,2,3,2,5
C(CC(C(CCO)=O)=O)(O)=O,,,3,1,3,14,17
1586_0,,,,2,3,2,5
C(CC(CC(CO)=O)=O)(O)=O,,,3,1,5,15,20
1588_0,,,,2,3,2,5
C(CC(C(C(C)=O)O)=O)(O)=O,,,3,1,3,13,16
1590_0,,,,2,3,2,5
C(CC(C(CC=O)O)=O)(O)=O,,,3,1,5,18,23
1592_0,,,,2,3,2,5
C(CC(C(CC(O)=O)O)=O)=O,,,3,1,4,14,18
1594_0,,,,2,3,2,5
C(C(C(O)=O)O)(CC(C)=O)=O,,,3,1,3,14,17
1596_0,,,,2,3,2,5
C(C(C(CCC=O)=O)O)(O)=O,,,3,1,3,16,19
1598_0,,,,2,3,2,5
C(C(C(CCC(O)=O)=O)O)=O,,,3,1,2,11,13
1600_0,,,,2,3,2,5
C(C(CC(C(C)=O)=O)O)(O)=O,,,3,1,4,13,17
1602_0,,,,2,3,2,5
C(CC(CC(C(O)=O)O)=O)=O,,,3,1,5,17,22
1604_0,,,,2,3,2,5
C(CC(CC(C=O)O)=O)(O)=O,,,3,1,4,18,22
1606_0,,,,2,3,2,5
C(CC1C(C(C(O)O1)O)O)(O)=O,,,3,1,2,8,10
1608_0,,,,2,3,2,5
C(C(CO)O)=CC(C(O)=O)=O,,,3,1,3,6,9
1610_0,,,,2,3,2,5
C(C(C(C=CCO)=O)O)(O)=O,,,3,1,3,9,12
1612_0,,,,2,3,2,5
C(C=CC(C(CO)O)=O)(O)=O,,,3,1,3,13,16
1614_0,,,,2,3,2,5
C(C(C(C(C=C)=O)O)O)(O)=O,,,3,1,6,16,22
1616_0,,,,2,3,2,5
C(C(C=CC(CO)=O)O)(O)=O,,,3,1,3,9,12
1618_0,,,,2,3,2,5
C(C(C(C=CC=O)O)O)(O)=O,,,3,1,4,13,17
1620_0,,,,2,3,2,5
C(C(C(C=CC(O)=O)O)O)=O,,,3,1,3,13,16
1622_0,,,,2,3,2,5
C(C1(CC(C(CO)O1)O)O)(O)=O,,,3,1,2,6,8
1624_0,,,,2,3,2,5
C(CC1(C(C(CO1)O)O)O)(O)=O,,,3,1,2,7,9
1626_0,,,,2,3,2,5
C(C(C1(CC(CO1)O)O)O)(O)=O,,,3,1,2,7,9
1628_0,,,,2,3,2,5
C(C1C(CC(CO)(O1)O)O)(O)=O,,,3,1,2,7,9
1630_0,,,,2,3,2,5
C(C1C(C(C(C)(O1)O)O)O)(O)=O,,,3,1,2,8,10
1632_0,,,,2,3,2,5
C(C(C1C(CC(O)O1)O)O)(O)=O,,,3,1,2,6,8
1634_0,,,,2,3,2,5
C(C1(CC(C(CO1)O)O)O)(O)=O,,,3,1,2,8,10
1636_0,,,,2,3,2,5
C(C1C(C(CC(O1)O)O)O)(O)=O,,,3,1,2,8,10
1638_0,,,,2,1,1,2
C1(C(CC(C1(CO)O)O)O)=O,,,3,1,6,12,18
1638_1,,,,2,1,1,2
1639_0,,,,2,1,1,2
1639_1,,,,2,1,1,2
1640_0,,,,2,1,1,2
1640_1,,,,2,1,1,2
1641_0,,,,2,1,1,2
1643_0,,,,2,1,1,2
C(C1(C(CCC1O)=O)O)=O,,,3,1,3,14,17
1643_1,,,,2,1,1,2
1645_0,,,,2,1,1,2
C1C(C(C(C=1)=O)(CO)O)O,,,3,1,4,15,19
1645_1,,,,2,1,1,2
1647_0,,,,2,1,1,2
C(C1(C(C=CC1O)O)O)=O,,,3,1,3,8,11
1647_1,,,,2,1,1,2
1648_0,,,,2,2,1,3
1648_1,,,,2,2,1,3
1650_0,,,,2,2,1,3
C1(C(C(C(C1(CO)CO)O)O)O)=O,,,3,1,2,11,13
1652_0,,,,2,2,1,3
C1(CC(C(C(C1(CO)O)O)O)O)=O,,,3,1,5,15,20
1652_1,,,,2,2,1,3
1654_0,,,,2,2,1,3
C(C1(CO)C(C(C(C1O)O)O)O)=O,,,3,1,2,10,12
1656_0,,,,2,2,1,3
C(C(CO)(C(CO)(CO)O)O)=O,,,3,1,5,11,16
1656_1,,,,2,2,1,3
1658_0,,,,2,2,1,3
C(C(C(C)=O)(C(CO)(CO)O)O)=O,,,3,1,2,7,9
1658_1,,,,2,2,1,3
1660_0,,,,2,2,1,3
C(C)(C(CO)(C(CO)(CO)O)O)=O,,,3,1,5,9,14
1660_1,,,,2,2,1,3
1662_0,,,,2,2,1,3
C(C(C=O)(C(CO)(CO)O)O)=O,,,3,1,2,7,9
1662_1,,,,2,2,1,3
1664_0,,,,2,2,1,3
C(C(CO)(C(C(CO)O)O)O)=O,,,3,1,8,16,24
1664_1,,,,2,2,1,3
1666_0,,,,2,2,1,3
C(C(CO)(C(C(C)=O)O)O)=O,,,3,1,10,19,29
1666_1,,,,2,2,1,3
1668_0,,,,2,2,1,3
C(C(CO)(C(C=O)(C)O)O)=O,,,3,1,6,15,21
1668_1,,,,2,2,1,3
1670_0,,,,2,2,1,3
C(C(CO)(C(CC(CO)=O)O)O)=O,,,3,1,10,17,27
1670_1,,,,2,2,1,3
1672_0,,,,2,2,1,3
C(C(CO)(C(CO)(CC=O)O)O)=O,,,3,1,5,16,21
1672_1,,,,2,2,1,3
1674_0,,,,2,2,1,3
C(C(C(C)=O)(C(C(CO)O)O)O)=O,,,3,1,4,13,17
1674_1,,,,2,2,1,3
1676_0,,,,2,2,1,3
C(C(CO)(C(C(C(C)=O)O)O)O)=O,,,3,1,12,18,30
1676_1,,,,2,2,1,3
1678_0,,,,2,2,1,3
C(C(CO)(C(C)(C(C=O)O)O)O)=O,,,3,1,7,17,24
1678_1,,,,2,2,1,3
1680_0,,,,2,2,1,3
C(C(CO)(C(C=O)O)O)=O,,,3,1,8,24,32
1680_1,,,,2,2,1,3
1682_0,,,,2,2,1,3
C(C)(C(CO)(C(C(CO)O)O)O)=O,,,3,1,7,14,21
1682_1,,,,2,2,1,3
1684_0,,,,2,2,1,3
C(C(CO)(C(C)(C(CO)O)O)O)=O,,,3,1,6,14,20
1684_1,,,,2,2,1,3
1686_0,,,,2,2,1,3
C(C(CO)(CO)O)=O,,,3,1,3,19,22
1686_1,,,,2,2,1,3
1688_0,,,,2,2,1,3
C(C(CO)(C(C(CCO)=O)O)O)=O,,,3,1,11,18,29
1688_1,,,,2,2,1,3
1690_0,,,,2,2,1,3
C(C(CCO)(C(C=O)(CO)O)O)=O,,,3,1,6,16,22
1690_1,,,,2,2,1,3
1692_0,,,,2,2,1,3
C(C(CO)(C(CO)(CCO)O)O)=O,,,3,1,7,13,20
1692_1,,,,2,2,1,3
1694_0,,,,2,2,1,3
C(C(C=O)(C(C(CO)O)O)O)=O,,,3,1,4,12,16
1694_1,,,,2,2,1,3
1696_0,,,,2,2,1,3
C(C(CO)(C(C(C=O)O)O)O)=O,,,3,1,7,20,27
1696_1,,,,2,2,1,3
1698_0,,,,2,2,1,3
C(C(CO)(C(CO)(C)O)O)=O,,,3,1,6,12,18
1698_1,,,,2,2,1,3
1700_0,,,,2,2,1,3
C(C(CO)(C(C(CC=O)O)O)O)=O,,,3,1,12,20,32
1700_1,,,,2,2,1,3
1702_0,,,,2,2,1,3
C(C(CO)(C(CC(C=O)O)O)O)=O,,,3,1,8,18,26
1702_1,,,,2,2,1,3
1704_0,,,,2,2,1,3
C(C(CO)(C(C)O)O)=O,,,3,1,5,14,19
1704_1,,,,2,2,1,3
1706_0,,,,2,2,1,3
C(C(C(C)=O)(C(C(C)=O)O)O)=O,,,3,1,4,14,18
1706_1,,,,2,2,1,3
1708_0,,,,2,2,1,3
C(C(C)(C(C=O)(C(C)=O)O)O)=O,,,3,1,3,12,15
1708_1,,,,2,2,1,3
1710_0,,,,2,2,1,3
C(C)(C(CO)(C(C(C)=O)O)O)=O,,,3,1,9,16,25
1710_1,,,,2,2,1,3
1712_0,,,,2,2,1,3
C(C(C)(C(C(C)=O)(CO)O)O)=O,,,3,1,6,15,21
1712_1,,,,2,2,1,3
1714_0,,,,2,2,1,3
C(C(C=O)(C(C(C)=O)O)O)=O,,,3,1,4,14,18
1714_1,,,,2,2,1,3
1716_0,,,,2,2,1,3
C(C(C=O)(C(C=O)(C)O)O)=O,,,3,1,2,10,12
1716_1,,,,2,2,1,3
1718_0,,,,2,2,1,3
C(C(C(C=O)(C(C(C)=O)O)O)O)=O,,,3,1,4,20,24
1718_1,,,,2,2,1,3
1720_0,,,,2,2,1,3
C(C(C(C=O)(C(C=O)(C)O)O)O)=O,,,3,1,4,18,22
1720_1,,,,2,2,1,3
1722_0,,,,2,2,1,3
C(CO)(C(CO)(C(C(C)=O)O)O)=O,,,3,1,5,17,22
1722_1,,,,2,2,1,3
1724_0,,,,2,2,1,3
C(C(C)(C(C(CO)=O)(CO)O)O)=O,,,3,1,5,16,21
1724_1,,,,2,2,1,3
1726_0,,,,2,2,1,3
C(C(C=O)(C(CC(CO)=O)O)O)=O,,,3,1,3,12,15
1726_1,,,,2,2,1,3
1728_0,,,,2,2,1,3
C(C(C=O)(C(CO)(CC=O)O)O)=O,,,3,1,2,11,13
1728_1,,,,2,2,1,3
1730_0,,,,2,2,1,3
C(C(C(C)=O)(C(C=O)O)O)=O,,,3,1,3,16,19
1730_1,,,,2,2,1,3
1732_0,,,,2,2,1,3
C(C(C(C)=O)(CO)O)=O,,,3,1,8,18,26
1732_1,,,,2,2,1,3
1734_0,,,,2,2,1,3
C(C(C=O)(C(C(C(C)=O)O)O)O)=O,,,3,1,2,13,15
1734_1,,,,2,2,1,3
1736_0,,,,2,2,1,3
C(C(C=O)(C(C)(C(C=O)O)O)O)=O,,,3,1,2,12,14
1736_1,,,,2,2,1,3
1738_0,,,,2,2,1,3
C(C(C(C(C=O)(C(C)=O)O)O)O)=O,,,3,1,2,15,17
1738_1,,,,2,2,1,3
1740_0,,,,2,2,1,3
C(C(C(C)=O)(C(CO)(C)O)O)=O,,,3,1,4,10,14
1740_1,,,,2,2,1,3
1742_0,,,,2,2,1,3
C(C(C(C)=O)(C(C)O)O)=O,,,3,1,3,13,16
1742_1,,,,2,2,1,3
1743_0,,,,2,2,1,3
1743_1,,,,2,2,1,3
1744_0,,,,2,2,1,3
1744_1,,,,2,2,1,3
1746_0,,,,2,2,1,3
C(C(C(C(C)=O)(C(C=O)O)O)O)=O,,,3,1,2,10,12
1746_1,,,,2,2,1,3
1748_0,,,,2,2,1,3
C(C(C=O)(C(C=O)O)O)=O,,,3,1,3,19,22
1748_1,,,,2,2,1,3
1750_0,,,,2,2,1,3
C(C(C(C=O)(C(C=O)O)O)O)=O,,,3,1,2,12,14
1750_1,,,,2,2,1,3
1752_0,,,,2,2,1,3
C(CO)(C(CO)(C(C=O)O)O)=O,,,3,1,5,18,23
1752_1,,,,2,2,1,3
1754_0,,,,2,2,1,3
C(C(C(CO)O)(C(C=O)O)O)(O)=O,,,3,1,5,17,22
1754_1,,,,2,2,1,3
1756_0,,,,2,2,1,3
C(C)(C(CO)(CO)O)=O,,,3,1,5,13,18
1756_1,,,,2,2,1,3
1758_0,,,,2,2,1,3
C(C(C=O)(C(C)(C(CO)O)O)O)=O,,,3,1,3,10,13
1758_1,,,,2,2,1,3
1760_0,,,,2,2,1,3
C(C(C(C(C(C)=O)(CO)O)O)O)=O,,,3,1,13,18,31
1760_1,,,,2,2,1,3
1762_0,,,,2,2,1,3
C(C)(C(CO)(C(CO)(C)O)O)=O,,,3,1,6,11,17
1762_1,,,,2,2,1,3
1764_0,,,,2,2,1,3
C(C)(C(CO)(C(C)O)O)=O,,,3,1,5,14,19
1764_1,,,,2,2,1,3
1765_0,,,,2,2,1,3
1765_1,,,,2,2,1,3
1766_0,,,,2,2,1,3
1766_1,,,,2,2,1,3
1768_0,,,,2,2,1,3
C(C(C=O)(CO)O)=O,,,3,1,7,19,26
1768_1,,,,2,2,1,3
1769_0,,,,2,2,1,3
1769_1,,,,2,2,1,3
1771_0,,,,2,2,1,3
C(CO)(C(CO)(CO)O)=O,,,3,1,4,12,16
1771_1,,,,2,2,1,3
1773_0,,,,2,2,1,3
C(CC(C(C(CO)(CO)O)=O)O)=O,,,3,1,5,10,15
1773_1,,,,2,2,1,3
1775_0,,,,2,2,1,3
C(C(CO)(CO)O)(CC(CO)=O)=O,,,3,1,4,8,12
1775_1,,,,2,2,1,3
1777_0,,,,2,2,1,3
C(CCO)(C(C(CO)=O)(CO)O)=O,,,3,1,3,9,12
1777_1,,,,2,2,1,3
1779_0,,,,2,2,1,3
C(C(C(C(CCO)O)=O)(CO)O)=O,,,3,1,4,11,15
1779_1,,,,2,2,1,3
1780_0,,,,2,2,1,3
1780_1,,,,2,2,1,3
1781_0,,,,2,2,1,3
1781_1,,,,2,2,1,3
1783_0,,,,2,2,1,3
C(C)(C(CO)(C(C(CO)=O)O)O)=O,,,3,1,7,17,24
1783_1,,,,2,2,1,3
1785_0,,,,2,2,1,3
C(C(CO)(C(C(C(C)O)=O)O)O)=O,,,3,1,8,17,25
1785_1,,,,2,2,1,3
1787_0,,,,2,2,1,3
C(C(CO)(C(C=O)O)O)(C(C)O)=O,,,3,1,3,17,20
1787_1,,,,2,2,1,3
1789_0,,,,2,2,1,3
C(CC(C(C(CO)=O)(CO)O)O)=O,,,3,1,5,17,22
1789_1,,,,2,2,1,3
1791_0,,,,2,2,1,3
C(CCO)(C(CO)(C(CO)O)O)=O,,,3,1,7,13,20
1791_1,,,,2,2,1,3
1793_0,,,,2,2,1,3
C(CC(CO)O)(C(CO)(CO)O)=O,,,3,1,5,9,14
1793_1,,,,2,2,1,3
1794_0,,,,2,2,1,3
1794_1,,,,2,2,1,3
1796_0,,,,2,2,1,3
C(C(CO)(C(C(CCO)O)O)O)=O,,,3,1,5,15,20
1796_1,,,,2,2,1,3
1798_0,,,,2,2,1,3
C(C(CO)(C(CO)O)O)(O)=O,,,3,1,5,10,15
1798_1,,,,2,2,1,3
1800_0,,,,2,2,1,3
C(CC=O)(C(C(C)=O)(CO)O)=O,,,3,1,4,12,16
1800_1,,,,2,2,1,3
1802_0,,,,2,2,1,3
C(C(C(CC(C)=O)=O)(CO)O)=O,,,3,1,4,12,16
1802_1,,,,2,2,1,3
1804_0,,,,2,2,1,3
C(C(C(CCC=O)=O)(CO)O)=O,,,3,1,4,13,17
1804_1,,,,2,2,1,3
1806_0,,,,2,2,1,3
C1(C(CO)C(C(C(CO)O)O1)O)=O,,,3,1,3,6,9
1808_0,,,,2,2,1,3
C1(COC(C(CO)O)C1(CO)O)=O,,,3,1,2,8,10
1808_1,,,,2,2,1,3
1810_0,,,,2,2,1,3
C1(CC(OC1(CO)C(CO)O)O)=O,,,3,1,3,12,15
1810_1,,,,2,2,1,3
1812_0,,,,2,2,1,3
C(C)(C1(CO)C(C(C(O1)O)O)O)=O,,,3,1,3,12,15
1812_1,,,,2,2,1,3
1814_0,,,,2,2,1,3
C1(C(CO)C(C(C(CO)O1)O)O)=O,,,3,1,2,7,9
1816_0,,,,2,2,1,3
C1(COC(CO)C(C1(CO)O)O)=O,,,3,1,2,9,11
1816_1,,,,2,2,1,3
1818_0,,,,2,2,1,3
C1(CC(O)OC(CO)C1(CO)O)=O,,,3,1,3,8,11
1818_1,,,,2,2,1,3
1820_0,,,,2,2,1,3
C1(CC(CO)OC(C1(CO)O)O)=O,,,3,1,3,10,13
1820_1,,,,2,2,1,3
1822_0,,,,2,2,1,3
C1(CC(C(OC1(CO)CO)O)O)=O,,,3,1,3,8,11
1822_1,,,,2,2,1,3
1824_0,,,,2,2,1,3
C1(C(CO)C(C(C(CO1)O)O)O)=O,,,3,1,1,10,11
1826_0,,,,2,2,1,3
C1(COCC(C(C1(CO)O)O)O)=O,,,3,1,2,11,13
1826_1,,,,2,2,1,3
1828_0,,,,2,2,1,3
C1(CC(O)OCC(C1(CO)O)O)=O,,,3,1,3,11,14
1828_1,,,,2,2,1,3
1830_0,,,,2,2,1,3
C1(CC(COC(C1(CO)O)O)O)=O,,,3,1,3,11,14
1830_1,,,,2,2,1,3
1832_0,,,,2,2,1,3
C1(CC(C(O)OCC1(CO)O)O)=O,,,3,1,3,10,13
1832_1,,,,2,2,1,3
1834_0,,,,2,2,1,3
C1(CCOC(C(C1(CO)O)O)O)=O,,,3,1,3,12,15
1834_1,,,,2,2,1,3
1836_0,,,,2,2,1,3
C(C(C(C=CCO)=O)(CO)O)=O,,,3,1,4,9,13
1836_1,,,,2,2,1,3
1838_0,,,,2,2,1,3
C(C=CC(C(CO)(CO)O)=O)=O,,,3,1,4,9,13
1838_1,,,,2,2,1,3
1840_0,,,,2,2,1,3
C(C(CO)(C(C(C=C)=O)O)O)=O,,,3,1,8,17,25
1840_1,,,,2,2,1,3
1842_0,,,,2,2,1,3
C(C(C(C(C=C)=O)(CO)O)O)=O,,,3,1,4,18,22
1842_1,,,,2,2,1,3
1844_0,,,,2,2,1,3
C(C(CO)(C(C=CC=O)O)O)=O,,,3,1,6,14,20
1844_1,,,,2,2,1,3
1846_0,,,,2,2,1,3
C(C(CO)(C1(CC(CO1)O)O)O)=O,,,3,1,3,12,15
1846_1,,,,2,2,1,3
1848_0,,,,2,2,1,3
C(C1(CO)C(CC(CO)(O1)O)O)=O,,,3,1,3,12,15
1848_1,,,,2,2,1,3
1850_0,,,,2,2,1,3
C(C1(CO)C(C(C(C)(O1)O)O)O)=O,,,3,1,3,13,16
1850_1,,,,2,2,1,3
1852_0,,,,2,2,1,3
C(C(CO)(C1C(CC(O)O1)O)O)=O,,,3,1,3,10,13
1852_1,,,,2,2,1,3
1854_0,,,,2,2,1,3
C(C1(CO)C(C(CC(O1)O)O)O)=O,,,3,1,3,13,16
1854_1,,,,2,2,1,3
1856_0,,,,2,2,1,3
C(C(C=O)(C(C(CCO)=O)O)O)=O,,,3,1,3,13,16
1856_1,,,,2,2,1,3
1858_0,,,,2,2,1,3
C(C(C=O)(C(C=O)(CCO)O)O)=O,,,3,1,2,11,13
1858_1,,,,2,2,1,3
1860_0,,,,2,2,1,3
C(C(C=O)(C(CO)(CCO)O)O)=O,,,3,1,4,9,13
1860_1,,,,2,2,1,3
1862_0,,,,2,2,1,3
C(C(C(C)O)(C(C(C)=O)O)O)=O,,,3,1,6,17,23
1862_1,,,,2,2,1,3
1864_0,,,,2,2,1,3
C(C)(C(C(C)O)(C(C=O)O)O)=O,,,3,1,4,17,21
1864_1,,,,2,2,1,3
1866_0,,,,2,2,1,3
C(C(C=O)(C(C(C=O)O)O)O)=O,,,3,1,2,15,17
1866_1,,,,2,2,1,3
1868_0,,,,2,2,1,3
C(C(C=O)(C(CO)(C)O)O)=O,,,3,1,3,8,11
1868_1,,,,2,2,1,3
1870_0,,,,2,2,1,3
C(C(C=O)(C(C(CC=O)O)O)O)=O,,,3,1,3,15,18
1870_1,,,,2,2,1,3
1872_0,,,,2,2,1,3
C(C(C=O)(C(CC(C=O)O)O)O)=O,,,3,1,3,13,16
1872_1,,,,2,2,1,3
1874_0,,,,2,2,1,3
C(C(C=O)(C(C)O)O)=O,,,3,1,2,10,12
1874_1,,,,2,2,1,3
1876_0,,,,2,2,1,3
C(C(C(CO)(C)O)(C(C=O)O)O)=O,,,3,1,5,17,22
1876_1,,,,2,2,1,3
1878_0,,,,2,2,1,3
C(CO)(C(CO)(C(CO)(C)O)O)=O,,,3,1,6,11,17
1878_1,,,,2,2,1,3
1880_0,,,,2,2,1,3
C(C(C(C)O)(C(C=O)O)O)=O,,,3,1,6,19,25
1880_1,,,,2,2,1,3
1882_0,,,,2,2,1,3
C(CO)(C(CO)(C(C)O)O)=O,,,3,1,5,12,17
1882_1,,,,2,2,1,3
1884_0,,,,2,2,1,3
C(C(C(CO)O)(C(C)O)O)(O)=O,,,3,1,5,11,16
1884_1,,,,2,2,1,3
1886_0,,,,2,2,1,3
C(CC=O)(C(C(C)=O)(C(C)O)O)=O,,,3,1,2,9,11
1886_1,,,,2,2,1,3
1888_0,,,,2,2,1,3
C(C(C(CC(C)=O)=O)(C(C)O)O)=O,,,3,1,2,9,11
1888_1,,,,2,2,1,3
1890_0,,,,2,2,1,3
C(C(C(CCC=O)=O)(C(C)O)O)=O,,,3,1,2,10,12
1890_1,,,,2,2,1,3
1892_0,,,,2,2,1,3
C(C(C(C=CCO)=O)(C(C)O)O)=O,,,3,1,2,8,10
1892_1,,,,2,2,1,3
1894_0,,,,2,2,1,3
C(C=CC(C(CO)(C(C)O)O)=O)=O,,,3,1,2,14,16
1894_1,,,,2,2,1,3
1896_0,,,,2,2,1,3
C(C(C(C)O)(C(C(C=C)=O)O)O)=O,,,3,1,6,16,22
1896_1,,,,2,2,1,3
1898_0,,,,2,2,1,3
C(C(C(C(C=C)=O)(C(C)O)O)O)=O,,,3,1,2,17,19
1898_1,,,,2,2,1,3
1900_0,,,,2,2,1,3
C(C(C(C)O)(C(C=CC=O)O)O)=O,,,3,1,4,12,16
1900_1,,,,2,2,1,3
1902_0,,,,2,2,1,3
C(C(CO)(C(CO)O)O)=O,,,3,1,9,14,23
1902_1,,,,2,2,1,3
1904_0,,,,2,2,1,3
C(C(C(C)=O)(C(CO)O)O)=O,,,3,1,4,12,16
1904_1,,,,2,2,1,3
1906_0,,,,2,2,1,3
C(C)(C(CO)(C(CO)O)O)=O,,,3,1,8,13,21
1906_1,,,,2,2,1,3
1908_0,,,,2,2,1,3
C(C(C(CO)O)(C(C(C)=O)O)O)=O,,,3,1,10,18,28
1908_1,,,,2,2,1,3
1910_0,,,,2,2,1,3
C(C)(C(C(CO)O)(C(C=O)O)O)=O,,,3,1,5,18,23
1910_1,,,,2,2,1,3
1912_0,,,,2,2,1,3
C(C(C=O)(C(CO)O)O)=O,,,3,1,3,10,13
1912_1,,,,2,2,1,3
1914_0,,,,2,2,1,3
C(C(C(CO)O)(C(C=O)O)O)=O,,,3,1,10,20,30
1914_1,,,,2,2,1,3
1916_0,,,,2,2,1,3
C(CO)(C(CO)(C(CO)O)O)=O,,,3,1,7,12,19
1916_1,,,,2,2,1,3
1917_0,,,,2,2,1,3
1917_1,,,,2,2,1,3
1918_0,,,,2,2,1,3
1918_1,,,,2,2,1,3
1920_0,,,,2,2,1,3
C(C(C(CO)O)(C(C=O)(C)O)O)=O,,,3,1,9,17,26
1920_1,,,,2,2,1,3
1921_0,,,,2,2,1,3
1921_1,,,,2,2,1,3
1922_0,,,,2,2,1,3
1922_1,,,,2,2,1,3
1924_0,,,,2,2,1,3
C(C(C(CO)O)(C(CO)(C)O)O)=O,,,3,1,9,14,23
1924_1,,,,2,2,1,3
1926_0,,,,2,2,1,3
C(C(C(CO)O)(C(C)O)O)=O,,,3,1,8,14,22
1926_1,,,,2,2,1,3
1928_0,,,,2,2,1,3
C(CC(C(CO)(C(CO)O)O)=O)=O,,,3,1,10,16,26
1928_1,,,,2,2,1,3
1930_0,,,,2,2,1,3
C(C(C(CC(CO)O)=O)(CO)O)=O,,,3,1,9,12,21
1930_1,,,,2,2,1,3
1932_0,,,,2,2,1,3
C(CC(C=O)O)(C(CO)(CO)O)=O,,,3,1,8,10,18
1932_1,,,,2,2,1,3
1933_0,,,,2,2,1,3
1933_1,,,,2,2,1,3
1935_0,,,,2,2,1,3
C(C(CO)(C(C=O)O)O)(CCO)=O,,,3,1,11,18,29
1935_1,,,,2,2,1,3
1936_0,,,,2,2,1,3
1936_1,,,,2,2,1,3
1937_0,,,,2,2,1,3
1937_1,,,,2,2,1,3
1938_0,,,,2,2,1,3
1938_1,,,,2,2,1,3
1939_0,,,,2,2,1,3
1939_1,,,,2,2,1,3
1941_0,,,,2,1,1,2
C(C1(C(C(C(C1)O)O)O)O)=O,,,3,1,6,15,21
1943_0,,,,2,1,1,2
C1(C(C(C(C1(C)O)O)O)O)=O,,,3,1,3,13,16
1945_0,,,,2,1,1,2
C(C1(C(CC(C1)=O)O)O)=O,,,3,1,4,25,29
1947_0,,,,2,2,1,3
C(C(C(CO)(CO)O)(CC=O)O)=O,,,3,1,1,10,11
1949_0,,,,2,2,1,3
C(C(C(CO)(CO)O)O)(O)=O,,,3,1,2,7,9
1951_0,,,,2,2,1,3
C(C(C(C(CO)O)O)(CC=O)O)=O,,,3,1,3,16,19
1953_0,,,,2,2,1,3
C(C(C(C(CO)O)O)O)(O)=O,,,3,1,5,12,17
1955_0,,,,2,2,1,3
C(CC(C=O)(C(C(C)=O)O)O)=O,,,3,1,5,17,22
1957_0,,,,2,2,1,3
C(CC(C=O)(C(C=O)(C)O)O)=O,,,3,1,3,15,18
1958_0,,,,2,2,1,3
1960_0,,,,2,2,1,3
C(C(C)(C(C(O)=O)O)O)=O,,,3,1,3,16,19
1961_0,,,,2,2,1,3
1963_0,,,,2,2,1,3
C(CC(CO)(C(C(O)=O)O)O)=O,,,3,1,3,13,16
1964_0,,,,2,2,1,3
1966_0,,,,2,2,1,3
C(C(C(C)(C(C=O)O)O)O)(O)=O,,,3,1,4,13,17
1968_0,,,,2,2,1,3
C(C(C(C=O)(CC(CO)=O)O)O)=O,,,3,1,1,18,19
1970_0,,,,2,2,1,3
C(CC(C=O)(C(C=O)O)O)=O,,,3,1,4,20,24
1971_0,,,,2,2,1,3
1973_0,,,,2,2,1,3
C(C(C(C)(C(CO)O)O)O)(O)=O,,,3,1,3,9,12
1975_0,,,,2,2,1,3
C(C(CO)(CC(CO)=O)O)=O,,,3,1,7,17,24
1977_0,,,,2,2,1,3
C(C(C(C)O)(CC(CO)=O)O)=O,,,3,1,2,14,16
1979_0,,,,2,2,1,3
C(C(CO)(CC=O)O)=O,,,3,1,5,27,32
1981_0,,,,2,2,1,3
C(C(CO)(CC=O)O)(C(CO)O)=O,,,3,1,3,16,19
1983_0,,,,2,2,1,3
C(C(C(CO)(CC(CO)O)O)=O)=O,,,3,1,1,14,15
1985_0,,,,2,2,1,3
C(C(CO)(CC(C(CO)=O)O)O)=O,,,3,1,4,14,18
1987_0,,,,2,2,1,3
C(C(CC(C(CO)=O)(CO)O)O)=O,,,3,1,3,14,17
1989_0,,,,2,2,1,3
C(C(C(C(CO)(CCO)O)=O)O)=O,,,3,1,1,12,13
1991_0,,,,2,2,1,3
C(CO)(C(CO)(CC(CO)=O)O)=O,,,3,1,2,14,16
1993_0,,,,2,2,1,3
C(C(CO)(CC(C(C=O)O)O)O)=O,,,3,1,5,18,23
1995_0,,,,2,2,1,3
C(C(C(C=O)O)O)(C(CO)(C)O)=O,,,3,1,1,15,16
1996_0,,,,2,2,1,3
1998_0,,,,2,2,1,3
C(C)(C(CO)(CC(C=O)=O)O)=O,,,3,1,4,16,20
2000_0,,,,2,2,1,3
C(C(CO)(CC=O)O)(CC=O)=O,,,3,1,3,19,22
2002_0,,,,2,2,1,3
C(C(CO)(CC(C(C)=O)=O)O)=O,,,3,1,4,14,18
2004_0,,,,2,2,1,3
C(C(CO)(CC(CC=O)=O)O)=O,,,3,1,5,17,22
2006_0,,,,2,2,1,3
C1(C(CO)(O)OC(C(CO)O)C1)=O,,,3,1,1,8,9
2008_0,,,,2,2,1,3
C1(C(CO)(O)OC(C(C1)O)CO)=O,,,3,1,1,7,8
2010_0,,,,2,2,1,3
C1(C(CO)(O)OCC(C(C1)O)O)=O,,,3,1,1,9,10
2012_0,,,,2,2,1,3
C(C(C=CC(CO)=O)(CO)O)=O,,,3,1,3,10,13
2013_0,,,,2,2,1,3
2015_0,,,,2,2,1,3
C(C(CCO)(C(C(O)=O)O)O)=O,,,3,1,3,12,15
2017_0,,,,2,2,1,3
C(C(C(CO)(CCO)O)O)(O)=O,,,3,1,4,8,12
2019_0,,,,2,2,1,3
C(C(C(C(C=O)(CC=O)O)O)O)=O,,,3,1,1,21,22
2021_0,,,,2,2,1,3
C(C(C(C(C=O)O)O)O)(O)=O,,,3,1,4,18,22
2023_0,,,,2,2,1,3
C(C(C(CO)(C)O)(CC=O)O)=O,,,3,1,3,14,17
2025_0,,,,2,2,1,3
C(C(C(CO)(C)O)O)(O)=O,,,3,1,3,12,15
2027_0,,,,2,2,1,3
C(C(C(C)O)(CC=O)O)=O,,,3,1,3,20,23
2028_0,,,,2,2,1,3
2029_0,,,,2,2,1,3
2031_0,,,,2,2,1,3
C(C(C(C(C(C=O)O)O)O)O)(O)=O,,,3,1,4,19,23
2033_0,,,,2,2,1,3
C(C(C(C)O)O)(O)=O,,,3,1,6,29,35
2035_0,,,,2,2,1,3
C(C)(C(C(C)O)(CC(C=O)=O)O)=O,,,3,1,1,12,13
2037_0,,,,2,2,1,3
C(C(C(C)O)(CC=O)O)(CC=O)=O,,,3,1,2,15,17
2039_0,,,,2,2,1,3
C(C(C(C)O)(CC(C(C)=O)=O)O)=O,,,3,1,2,11,13
2041_0,,,,2,2,1,3
C(C(C(C)O)(CC(CC=O)=O)O)=O,,,3,1,2,13,15
2043_0,,,,2,2,1,3
C(C(C=CC(CO)=O)(C(C)O)O)=O,,,3,1,1,8,9
2045_0,,,,2,2,1,3
C(C(C(CO)(C(CO)O)O)O)(O)=O,,,3,1,3,10,13
2047_0,,,,2,2,1,3
C(C(C(CO)O)(CC(CO)=O)O)=O,,,3,1,3,15,18
2049_0,,,,2,2,1,3
C(C(C(CO)O)(CC=O)O)=O,,,3,1,4,17,21
2050_0,,,,2,2,1,3
2051_0,,,,2,2,1,3
2053_0,,,,2,2,1,3
C(C(CO)(CC(C(CO)O)=O)O)=O,,,3,1,7,16,23
2054_0,,,,2,1,2,3
2055_0,,,,2,1,2,3
2056_0,,,,2,1,2,3
2057_0,,,,2,1,2,3
2058_0,,,,2,1,2,3
2060_0,,,,2,1,1,2
C(C(C(CO)O)OC(CO)=O)=O,,,3,1,1,8,9
2062_0,,,,2,1,1,2
C(C(C(CO)OC(CO)=O)O)=O,,,3,1,1,5,6
2064_0,,,,2,1,1,2
C(C(C(COC(CO)=O)O)O)=O,,,3,1,1,8,9
2066_0,,,,2,1,2,3
C1(CC(C(C1CO)=O)O)=O,,,3,1,4,23,27
2068_0,,,,2,1,2,3
C1(C(CO)CC(C1O)=O)=O,,,3,1,2,23,25
2069_0,,,,2,1,2,3
2070_0,,,,2,1,2,3
2071_0,,,,2,1,2,3
2072_0,,,,2,1,2,3
2073_0,,,,2,1,2,3
2074_0,,,,2,1,2,3
2075_0,,,,2,1,2,3
2076_0,,,,2,1,2,3
2077_0,,,,2,1,2,3
2078_0,,,,2,1,2,3
2079_0,,,,2,1,2,3
2080_0,,,,2,1,2,3
2081_0,,,,2,1,2,3
2082_0,,,,2,1,2,3
2083_0,,,,2,1,2,3
2084_0,,,,2,1,2,3
2085_0,,,,2,1,2,3
2086_0,,,,2,1,2,3
2087_0,,,,2,1,2,3
2088_0,,,,2,1,2,3
2089_0,,,,2,1,2,3
2090_0,,,,2,1,2,3
2091_0,,,,2,1,2,3
2092_0,,,,2,1,2,3
2093_0,,,,2,1,2,3
2094_0,,,,2,1,2,3
2095_0,,,,2,1,2,3
2096_0,,,,2,1,2,3
2097_0,,,,2,1,2,3
2098_0,,,,2,1,2,3
2100_0,,,,2,1,2,3
C(C(C)=O)(C(C(CO)O)O)=O,,,3,1,6,16,22
2101_0,,,,2,1,2,3
2102_0,,,,2,1,2,3
2103_0,,,,2,1,2,3
2104_0,,,,2,1,2,3
2105_0,,,,2,1,2,3
2106_0,,,,2,1,2,3
2107_0,,,,2,1,2,3
2108_0,,,,2,1,2,3
2109_0,,,,2,1,2,3
2110_0,,,,2,1,2,3
2111_0,,,,2,1,2,3
2112_0,,,,2,1,2,3
2113_0,,,,2,1,2,3
2114_0,,,,2,1,2,3
2115_0,,,,2,1,2,3
2116_0,,,,2,1,2,3
2117_0,,,,2,1,2,3
2118_0,,,,2,1,2,3
2119_0,,,,2,1,2,3
2120_0,,,,2,1,2,3
2121_0,,,,2,1,2,3
2122_0,,,,2,1,2,3
2123_0,,,,2,1,2,3
2124_0,,,,2,1,2,3
2125_0,,,,2,1,2,3
2126_0,,,,2,1,2,3
2127_0,,,,2,1,2,3
2128_0,,,,2,1,2,3
2129_0,,,,2,1,2,3
2130_0,,,,2,1,2,3
2131_0,,,,2,1,2,3
2132_0,,,,2,1,2,3
2133_0,,,,2,1,2,3
2134_0,,,,2,1,2,3
2135_0,,,,2,1,2,3
2136_0,,,,2,1,2,3
2137_0,,,,2,1,2,3
2138_0,,,,2,1,2,3
2139_0,,,,2,1,2,3
2140_0,,,,2,1,2,3
2141_0,,,,2,1,2,3
2142_0,,,,2,1,2,3
2143_0,,,,2,1,2,3
2144_0,,,,2,1,2,3
2145_0,,,,2,1,2,3
2146_0,,,,2,1,2,3
2147_0,,,,2,1,2,3
2148_0,,,,2,1,2,3
2149_0,,,,2,1,2,3
2150_0,,,,2,1,2,3
2151_0,,,,2,1,2,3
2152_0,,,,2,1,2,3
2153_0,,,,2,1,2,3
2154_0,,,,2,1,2,3
2155_0,,,,2,1,2,3
2156_0,,,,2,1,2,3
2157_0,,,,2,1,2,3
2158_0,,,,2,1,2,3
2159_0,,,,2,1,2,3
2160_0,,,,2,1,2,3
2161_0,,,,2,1,2,3
2162_0,,,,2,1,2,3
2163_0,,,,2,1,2,3
2164_0,,,,2,1,2,3
2165_0,,,,2,1,2,3
2166_0,,,,2,1,2,3
2167_0,,,,2,1,2,3
2168_0,,,,2,1,2,3
2169_0,,,,2,1,2,3
2170_0,,,,2,1,2,3
2171_0,,,,2,1,2,3
2172_0,,,,2,1,2,3
2173_0,,,,2,1,2,3
2174_0,,,,2,1,2,3
2175_0,,,,2,1,2,3
2176_0,,,,2,1,2,3
2177_0,,,,2,1,2,3
2178_0,,,,2,1,2,3
2179_0,,,,2,1,2,3
2180_0,,,,2,1,2,3
2181_0,,,,2,1,2,3
2182_0,,,,2,1,2,3
2183_0,,,,2,1,2,3
2184_0,,,,2,1,2,3
2186_0,,,,2,1,2,3
C1(CCC(C1(CO)O)=O)=O,,,3,1,1,9,10
2187_0,,,,2,1,2,3
2189_0,,,,2,1,2,3
C1(C(CO)(CC(C1)=O)O)=O,,,3,1,3,24,27
2190_0,,,,2,1,2,3
2191_0,,,,2,1,2,3
2192_0,,,,2,1,2,3
2193_0,,,,2,1,2,3
2194_0,,,,2,1,2,3
2195_0,,,,2,1,2,3
2196_0,,,,2,1,2,3
2197_0,,,,2,1,2,3
2199_0,,,,2,1,2,3
C1(CC(C(C(C)=O)O1)O)=O,,,3,1,2,17,19
2201_0,,,,2,1,2,3
C1(CC(C(CC=O)O1)O)=O,,,3,1,2,16,18
2203_0,,,,2,1,2,3
C1(COC(C(C)=O)C1O)=O,,,3,1,2,28,30
2205_0,,,,2,1,2,3
C(CC1C(C(CO1)=O)O)=O,,,3,1,3,27,30
2207_0,,,,2,1,2,3
C(C)(C1CC(C(O)O1)=O)=O,,,3,1,3,22,25
2209_0,,,,2,1,2,3
C(CC1CC(C(O)O1)=O)=O,,,3,1,3,25,28
2211_0,,,,2,1,2,3
C1(CC(OC1C(C)=O)O)=O,,,3,1,3,22,25
2213_0,,,,2,1,2,3
C(CC1C(CC(O1)O)=O)=O,,,3,1,3,27,30
2214_0,,,,2,1,2,3
2215_0,,,,2,1,2,3
2216_0,,,,2,1,2,3
2217_0,,,,2,1,2,3
2218_0,,,,2,1,2,3
2219_0,,,,2,1,2,3
2220_0,,,,2,1,2,3
2221_0,,,,2,1,2,3
2223_0,,,,2,1,2,3
C1(CC(CC(CO)O1)=O)=O,,,3,1,3,16,19
2225_0,,,,2,1,2,3
C1(CCC(OC1CO)=O)=O,,,3,1,3,13,16
2227_0,,,,2,1,2,3
C1(C(COC(CO)C1)=O)=O,,,3,1,2,18,20
2229_0,,,,2,1,2,3
C1(C(CO)OCC(C1)=O)=O,,,3,1,4,25,29
2230_0,,,,2,1,2,3
2231_0,,,,2,1,2,3
2232_0,,,,2,1,2,3
2233_0,,,,2,1,2,3
2235_0,,,,2,1,2,3
C1(CC(CC(CO1)O)=O)=O,,,3,1,2,18,20
2237_0,,,,2,1,2,3
C1(CCC(OCC1O)=O)=O,,,3,1,2,13,15
2239_0,,,,2,1,2,3
C1(CC(C(CCO1)=O)O)=O,,,3,1,2,16,18
2241_0,,,,2,1,2,3
C1(CC(CC(CO1)=O)O)=O,,,3,1,2,20,22
2243_0,,,,2,1,2,3
C1(C(COCC(C1)O)=O)=O,,,3,1,2,19,21
2245_0,,,,2,1,2,3
C1(C(COCC(C1)=O)O)=O,,,3,1,4,24,28
2247_0,,,,2,1,2,3
C1(CCOCC(C1O)=O)=O,,,3,1,2,23,25
2249_0,,,,2,1,2,3
C1(COCC(CC1O)=O)=O,,,3,1,4,27,31
2251_0,,,,2,1,2,3
C1(CCOC(C(C1)=O)O)=O,,,3,1,3,23,26
2253_0,,,,2,1,2,3
C1(COC(C(CC1)=O)O)=O,,,3,1,3,21,24
2255_0,,,,2,1,2,3
C1(C(CC(O)OCC1)=O)=O,,,3,1,3,21,24
2257_0,,,,2,1,2,3
C1(CC(OCC(C1)=O)O)=O,,,3,1,4,26,30
2258_0,,,,2,1,2,3
2259_0,,,,2,1,2,3
2260_0,,,,2,1,2,3
2261_0,,,,2,1,2,3
2262_0,,,,2,1,2,3
2263_0,,,,2,1,2,3
2264_0,,,,2,1,2,3
2265_0,,,,2,1,2,3
2266_0,,,,2,1,2,3
2267_0,,,,2,1,2,3
2268_0,,,,2,1,2,3
2269_0,,,,2,1,2,3
2271_0,,,,2,1,2,3
C(C(C=CC(C)=O)=O)=O,,,3,1,3,53,56
2273_0,,,,2,1,2,3
C(CC=CC(C=O)=O)=O,,,3,1,4,45,49
2275_0,,,,2,1,2,3
C(C=CC(C(C)=O)=O)=O,,,3,1,3,52,55
2277_0,,,,2,1,2,3
C(CC(C=CC=O)=O)=O,,,3,1,4,62,66
2279_0,,,,2,1,2,3
C=CC(CC(C=O)=O)=O,,,3,1,3,51,54
2281_0,,,,2,1,2,3
C(CC(C(C=C)=O)=O)=O,,,3,1,3,51,54
2283_0,,,,2,1,2,3
C(CC(C=O)=O)=CC=O,,,3,1,4,44,48
2284_0,,,,2,1,2,3
2285_0,,,,2,1,2,3
2287_0,,,,2,1,2,3
C1(COCC1O)=O,,,3,1,4,145,149
2289_0,,,,2,1,2,3
C1(C(O)OCC1)=O,,,3,1,2,121,123
2290_0,,,,2,1,2,3
2292_0,,,,2,1,2,3
C(C1C(C(C(CO)O1)O)O)=O,,,3,1,4,10,14
2294_0,,,,2,1,2,3
C1(C(CO)OC(CO)C1O)=O,,,3,1,2,8,10
2296_0,,,,2,1,2,3
C1(C(CO)(O)OC(CO)C1)=O,,,3,1,2,8,10
2298_0,,,,2,1,2,3
C1(C(CO)OC(CO)(C1)O)=O,,,3,1,2,12,14
2300_0,,,,2,1,2,3
C(CC1C(C(CO1)O)=O)=O,,,3,1,3,24,27
2302_0,,,,2,1,2,3
C(CC1(C(CCO1)=O)O)=O,,,3,1,2,23,25
2304_0,,,,2,1,2,3
C(CC1(CC(CO1)=O)O)=O,,,3,1,3,31,34
2306_0,,,,2,1,2,3
C(C(C1CC(CO1)O)=O)=O,,,3,1,1,12,13
2308_0,,,,2,1,2,3
C(C1C(CC(C=O)O1)O)=O,,,3,1,2,19,21
2310_0,,,,2,1,2,3
C(C1C(CC(C)(O1)O)=O)=O,,,3,1,2,21,23
2312_0,,,,2,1,2,3
C1(CC(C=O)OC1(C)O)=O,,,3,1,2,16,18
2314_0,,,,2,1,2,3
C(C1C(C(C(C)O1)=O)O)=O,,,3,1,1,22,23
2316_0,,,,2,1,2,3
C(C1C(C(C(CO1)O)O)O)=O,,,3,1,3,12,15
2318_0,,,,2,1,2,3
C1(C(CO)OCC(C1O)O)=O,,,3,1,3,11,14
2320_0,,,,2,1,2,3
C1(C(CO)(O)OCC(C1)O)=O,,,3,1,2,9,11
2322_0,,,,2,1,2,3
C1(C(COC(CO)(C1)O)O)=O,,,3,1,3,11,14
2324_0,,,,2,1,2,3
C1(C(C(CO)(O)OCC1)O)=O,,,3,1,2,12,14
2326_0,,,,2,1,2,3
C1(COC(CO)(C(C1)O)O)=O,,,3,1,2,11,13
2328_0,,,,2,1,2,3
C1(CC(C=O)(O)OCC1)=O,,,3,1,2,23,25
2330_0,,,,2,1,2,3
C(C1(CCC(CO1)=O)O)=O,,,3,1,2,17,19
2332_0,,,,2,1,2,3
C(C1C(CCC(O1)O)=O)=O,,,3,1,2,17,19
2334_0,,,,2,1,2,3
C1(CC(C=O)OC(C1)O)=O,,,3,1,3,26,29
2336_0,,,,2,1,2,3
C1(C(CC(C(CO)O)O1)=O)=O,,,3,1,4,7,11
2338_0,,,,2,1,2,3
C1(CC(C(C(CO)O)O1)=O)=O,,,3,1,4,10,14
2340_0,,,,2,1,2,3
C1(C(C(C(C(C)=O)O1)O)O)=O,,,3,1,2,12,14
2342_0,,,,2,1,2,3
C(CC1C(C(C(O1)=O)O)O)=O,,,3,1,2,14,16
2344_0,,,,2,1,2,3
C1(C(CC(C(CO)O1)O)=O)=O,,,3,1,4,7,11
2346_0,,,,2,1,2,3
C1(CC(C(C(CO)O1)O)=O)=O,,,3,1,3,8,11
2348_0,,,,2,1,2,3
C1(C(C(CC(CO)O1)=O)O)=O,,,3,1,3,7,10
2350_0,,,,2,1,2,3
C1(CC(C(OC1CO)=O)O)=O,,,3,1,3,10,13
2352_0,,,,2,1,2,3
C1(C(CC(C(CO1)O)O)=O)=O,,,3,1,3,10,13
2354_0,,,,2,1,2,3
C1(CC(C(C(CO1)O)O)=O)=O,,,3,1,2,12,14
2356_0,,,,2,1,2,3
C1(C(C(CC(CO1)O)=O)O)=O,,,3,1,2,9,11
2358_0,,,,2,1,2,3
C1(CC(C(OCC1O)=O)O)=O,,,3,1,2,10,12
2360_0,,,,2,1,2,3
C1(C(C(C(OCC1)=O)O)O)=O,,,3,1,2,13,15
2362_0,,,,2,1,2,3
C1(C(C(CC(CO1)=O)O)O)=O,,,3,1,2,13,15
2364_0,,,,2,1,2,3
C1C(C(C(C=1CO)=O)O)O,,,3,1,1,19,20
2366_0,,,,2,1,2,3
C=C1C(C(C(C1O)O)O)=O,,,3,1,2,21,23
2367_0,,,,2,1,2,3
2369_0,,,,2,1,2,3
C1C(C(C(C=1C=O)O)O)O,,,3,1,2,14,16
2371_0,,,,2,1,2,3
C(C(C(CO)O)O)=CC(O)=O,,,3,1,4,8,12
2372_0,,,,2,1,2,3
2373_0,,,,2,1,2,3
2374_0,,,,2,1,2,3
2375_0,,,,2,1,2,3
2376_0,,,,2,1,2,3
2377_0,,,,2,1,2,3
2378_0,,,,2,1,2,3
2379_0,,,,2,1,2,3
2380_0,,,,2,1,2,3
2381_0,,,,2,1,2,3
2382_0,,,,2,1,2,3
2383_0,,,,2,1,2,3
2384_0,,,,2,1,2,3
2385_0,,,,2,1,2,3
2386_0,,,,2,1,2,3
2387_0,,,,2,1,2,3
2388_0,,,,2,1,2,3
2389_0,,,,2,1,2,3
2390_0,,,,2,1,2,3
2391_0,,,,2,1,2,3
2392_0,,,,2,1,2,3
2393_0,,,,2,1,2,3
2394_0,,,,2,1,2,3
2395_0,,,,2,1,2,3
2397_0,,,,2,1,2,3
C(C(C(C(C=C)O)O)O)=O,,,3,1,1,19,20
2398_0,,,,2,1,2,3
2399_0,,,,2,1,2,3
2400_0,,,,2,1,2,3
2401_0,,,,2,1,2,3
2402_0,,,,2,1,2,3
2403_0,,,,2,1,2,3
2404_0,,,,2,1,2,3
2405_0,,,,2,1,2,3
2406_0,,,,2,1,2,3
2408_0,,,,2,1,2,3
C(C1(C=CC(C1O)O)O)=O,,,3,1,3,11,14
2409_0,,,,2,1,2,3
2410_0,,,,2,1,2,3
2411_0,,,,2,1,2,3
2412_0,,,,2,1,2,3
2413_0,,,,2,1,2,3
2414_0,,,,2,1,2,3
2415_0,,,,2,1,2,3
2416_0,,,,2,1,2,3
2418_0,,,,2,1,2,3
C1C(C(CO)O)OC(C=1)=O,,,3,1,2,8,10
2420_0,,,,2,1,2,3
C1OC(C(C=1)=O)C(CO)O,,,3,1,1,13,14
2422_0,,,,2,1,2,3
C1C(C(CO)OC(C=1)=O)O,,,3,1,2,6,8
2424_0,,,,2,1,2,3
C1C(CO)OC(C(C=1)=O)O,,,3,1,2,11,13
2426_0,,,,2,1,2,3
C1OC(CO)C(C(C=1)=O)O,,,3,1,1,10,11
2428_0,,,,2,1,2,3
C1C(OC(C(C=1)=O)CO)O,,,3,1,2,16,18
2430_0,,,,2,1,2,3
C1C(C(COC(C=1)=O)O)O,,,3,1,2,8,10
2432_0,,,,2,1,2,3
C1C(COC(C(C=1)=O)O)O,,,3,1,2,11,13
2434_0,,,,2,1,2,3
C1OCC(C(C(C=1)=O)O)O,,,3,1,1,13,14
2436_0,,,,2,1,2,3
C1COC(C(C(C=1)=O)O)O,,,3,1,2,18,20
2438_0,,,,2,1,2,3
C1C(O)OCC(C(C=1)=O)O,,,3,1,2,14,16
2440_0,,,,2,1,2,3
C1C(C(OCC(C=1)=O)O)O,,,3,1,2,15,17
2442_0,,,,2,1,2,3
C1C(C(CO)OC=1C=O)O,,,3,1,1,4,5
2444_0,,,,2,1,2,3
C(C1(C=CC(CO)O1)O)=O,,,3,1,2,5,7
2446_0,,,,2,1,2,3
C1(C(C(CO1)O)O)=CC=O,,,3,1,1,6,7
2448_0,,,,2,1,2,3
C(C(C1OCC(C=1)O)O)=O,,,3,1,1,11,12
2450_0,,,,2,1,2,3
C(C(C1(C=CCO1)O)O)=O,,,3,1,2,15,17
2452_0,,,,2,1,2,3
C(C1C=CC(CO)(O1)O)=O,,,3,1,2,9,11
2454_0,,,,2,1,2,3
C(C1C(C=C(CO)O1)O)=O,,,3,1,1,12,13
2456_0,,,,2,1,2,3
C(C1C(C(C(O1)=C)O)O)=O,,,3,1,1,15,16
2458_0,,,,2,1,2,3
C(C(C1C=CC(O)O1)O)=O,,,3,1,2,12,14
2460_0,,,,2,1,2,3
C(C(C1C(C=CO1)O)O)=O,,,3,1,1,12,13
2462_0,,,,2,1,2,3
C1C(C(COC=1C=O)O)O,,,3,1,1,6,7
2464_0,,,,2,1,2,3
C(C1(C=CC(CO1)O)O)=O,,,3,1,2,5,7
2466_0,,,,2,1,2,3
C(C1C(C=CC(O)O1)O)=O,,,3,1,2,13,15
2468_0,,,,2,1,2,3
C(C1C(C(C=CO1)O)O)=O,,,3,1,1,15,16
2470_0,,,,2,2,1,3
C(C1(C(C(C(C1O)O)O)O)O)O,,,3,1,5,5,10
2472_0,,,,2,2,1,3
C1(C(C(C(C(C1O)O)O)O)O)O,,,3,1,1,1,2
2473_0,,,,2,2,1,3
2474_0,,,,2,2,1,3
2475_0,,,,2,2,1,3
2476_0,,,,2,2,1,3
2477_0,,,,2,2,1,3
2478_0,,,,2,2,1,3
2479_0,,,,2,2,1,3
2480_0,,,,2,2,1,3
2481_0,,,,2,2,1,3
2482_0,,,,2,2,1,3
2483_0,,,,2,2,1,3
2484_0,,,,2,2,1,3
2485_0,,,,2,2,1,3
2486_0,,,,2,2,1,3
2487_0,,,,2,2,1,3
2488_0,,,,2,2,1,3
2489_0,,,,2,2,1,3
2490_0,,,,2,2,1,3
2491_0,,,,2,2,1,3
2492_0,,,,2,2,1,3
2493_0,,,,2,2,1,3
2494_0,,,,2,2,1,3
2495_0,,,,2,2,1,3
2496_0,,,,2,2,1,3
2497_0,,,,2,2,1,3
2498_0,,,,2,2,1,3
2499_0,,,,2,2,1,3
2500_0,,,,2,2,1,3
2501_0,,,,2,2,1,3
2502_0,,,,2,2,1,3
2503_0,,,,2,2,1,3
2504_0,,,,2,2,1,3
2505_0,,,,2,2,1,3
2506_0,,,,2,2,1,3
2507_0,,,,2,2,1,3
2508_0,,,,2,2,1,3
2509_0,,,,2,2,1,3
2510_0,,,,2,2,1,3
2511_0,,,,2,2,1,3
2512_0,,,,2,2,1,3
2513_0,,,,2,2,1,3
2514_0,,,,2,2,1,3
2515_0,,,,2,2,1,3
2516_0,,,,2,2,1,3
2517_0,,,,2,2,1,3
2518_0,,,,2,2,1,3
2519_0,,,,2,2,1,3
2520_0,,,,2,2,1,3
2521_0,,,,2,2,1,3
2522_0,,,,2,2,1,3
2523_0,,,,2,2,1,3
2524_0,,,,2,2,1,3
2525_0,,,,2,2,1,3
2526_0,,,,2,2,1,3
2527_0,,,,2,2,1,3
2528_0,,,,2,2,1,3
2529_0,,,,2,2,1,3
2530_0,,,,2,2,1,3
2531_0,,,,2,2,1,3
2532_0,,,,2,2,1,3
2533_0,,,,2,2,1,3
2534_0,,,,2,2,1,3
2535_0,,,,2,2,1,3
2536_0,,,,2,2,1,3
2537_0,,,,2,2,1,3
2538_0,,,,2,2,1,3
2539_0,,,,2,2,1,3
2540_0,,,,2,2,1,3
2541_0,,,,2,2,1,3
2542_0,,,,2,2,1,3
2543_0,,,,2,2,1,3
2544_0,,,,2,2,1,3
2545_0,,,,2,2,1,3
2546_0,,,,2,2,1,3
2547_0,,,,2,2,1,3
2548_0,,,,2,2,1,3
2549_0,,,,2,2,1,3
2550_0,,,,2,2,1,3
2551_0,,,,2,2,1,3
2552_0,,,,2,2,1,3
2553_0,,,,2,2,1,3
2555_0,,,,2,2,1,3
C1C(C(C(C(CO)O)(O)O1)O)O,,,3,1,3,7,10
2556_0,,,,2,2,1,3
2557_0,,,,2,2,1,3
2558_0,,,,2,2,1,3
2559_0,,,,2,2,1,3
2560_0,,,,2,2,1,3
2561_0,,,,2,2,1,3
2562_0,,,,2,2,1,3
2563_0,,,,2,2,1,3
2564_0,,,,2,2,1,3
2565_0,,,,2,2,1,3
2566_0,,,,2,2,1,3
2567_0,,,,2,2,1,3
2569_0,,,,2,1,1,2
C12C(C(C(CC1O)(O)O2)O)O,,,3,1,1,5,6
2571_0,,,,2,1,1,2
C1(C2C(C(C(C2O)O1)O)O)O,,,3,1,2,4,6
2571_1,,,,2,1,1,2
2573_0,,,,2,1,1,2
C1(C(O)OC(C(CO)O)C1O)=O,,,3,1,1,7,8
2575_0,,,,2,1,1,2
C(C1(C(C(C(CO)O1)O)O)O)=O,,,3,1,1,10,11
2576_0,,,,2,1,1,2
2577_0,,,,2,1,1,2
2578_0,,,,2,1,1,2
2579_0,,,,2,1,1,2
2580_0,,,,2,1,1,2
2582_0,,,,2,1,1,2
C(C1(C(CC(CO)O1)O)O)=O,,,3,1,2,8,10
2584_0,,,,2,1,1,2
C1(COC(C(CO)O)(C1)O)=O,,,3,1,3,13,16
2585_0,,,,2,1,1,2
2587_0,,,,2,1,1,2
C(C1CC(C(CO)(O1)O)O)=O,,,3,1,2,9,11
2589_0,,,,2,1,1,2
C(CO)(C1CC(C(O1)O)O)=O,,,3,1,2,9,11
2591_0,,,,2,1,1,2
C1(COC(CCO)(C1O)O)=O,,,3,1,1,12,13
2593_0,,,,2,1,1,2
C1(C(CCO)OC(C1O)O)=O,,,3,1,1,11,12
2595_0,,,,2,1,1,2
C(C(C1(C(CCO1)O)O)O)=O,,,3,1,2,12,14
2597_0,,,,2,1,1,2
C(C(C1CC(C(O)O1)O)O)=O,,,3,1,3,11,14
2598_0,,,,2,1,1,2
2599_0,,,,2,1,1,2
2600_0,,,,2,1,1,2
2601_0,,,,2,1,1,2
2602_0,,,,2,1,1,2
2603_0,,,,2,1,1,2
2604_0,,,,2,1,1,2
2605_0,,,,2,1,1,2
2606_0,,,,2,1,1,2
2607_0,,,,2,1,1,2
2609_0,,,,2,1,1,2
C1(C(CC(C(CO)O)(O)O1)O)=O,,,3,1,1,6,7
2611_0,,,,2,1,1,2
C1(C(C(C(CCO)(O)O1)O)O)=O,,,3,1,1,7,8
2612_0,,,,2,1,1,2
2613_0,,,,2,1,1,2
2614_0,,,,2,1,1,2
2615_0,,,,2,1,1,2
2617_0,,,,2,1,1,2
C1(C2(C(C(CC2O)O1)O)O)O,,,3,1,2,6,8
2617_1,,,,2,1,1,2
2619_0,,,,2,1,1,2
C1C(C(C(O)O1)(C(CO)O)O)O,,,3,1,1,6,7
2620_0,,,,2,1,1,2
2621_0,,,,2,1,1,2
2622_0,,,,2,1,1,2
2623_0,,,,2,1,1,2
2624_0,,,,2,1,1,2
2625_0,,,,2,1,1,2
2626_0,,,,2,1,1,2
2627_0,,,,2,1,1,2
2629_0,,,,2,1,1,2
C1C2(C(C(C(CO)O2)O1)O)O,,,3,1,1,2,3
2631_0,,,,2,1,1,2
C(C1C2CC(C(O)O2)(O)O1)O,,,3,1,2,3,5
2633_0,,,,2,1,1,2
C1C(C2C(CC(O)O2)(O)O1)O,,,3,1,2,4,6
2635_0,,,,2,1,1,2
CC1(C2C(C(C(O)O2)O1)O)O,,,3,1,2,3,5
2637_0,,,,2,1,1,2
C1(CC2C(C(C(O)O2)O)O1)O,,,3,1,2,5,7
2639_0,,,,2,1,1,2
C1C2C(C(CC(O)O2)(O)O1)O,,,3,1,2,4,6
2641_0,,,,2,1,1,2
C1C2CC(C(C(O)O2)O)(O)O1,,,3,1,2,5,7
2643_0,,,,2,1,1,2
C1C2(C(C(C(CO1)O2)O)O)O,,,3,1,1,4,5
2645_0,,,,2,1,1,2
C1C2C(CC(C(O)O1)(O)O2)O,,,3,1,2,4,6
2647_0,,,,2,1,1,2
C1C(C2(CC(C(O2)O1)O)O)O,,,3,1,1,3,4
2649_0,,,,2,1,1,2
C1CC2(C(C(C(O2)O1)O)O)O,,,3,1,1,4,5
2651_0,,,,2,1,1,2
C1C2(CC(C(C(O)O1)O2)O)O,,,3,1,2,3,5
2652_0,,,,2,1,1,2
2653_0,,,,2,1,1,2
2654_0,,,,2,1,1,2
2655_0,,,,2,1,1,2
2657_0,,,,2,1,1,2
C1C(C2CC(C(O)O2)(O)O1)O,,,3,1,2,3,5
2659_0,,,,2,1,1,2
C1(C2C(C(CC(O)O2)O1)O)O,,,3,1,2,3,5
2661_0,,,,2,1,1,2
C1(C(O)OC(CO)C(C1O)O)=O,,,3,1,1,8,9
2663_0,,,,2,1,1,2
C(C1(C(C(C(CO1)O)O)O)O)=O,,,3,1,1,12,13
2664_0,,,,2,1,1,2
2665_0,,,,2,1,1,2
2666_0,,,,2,1,1,2
2667_0,,,,2,1,1,2
2669_0,,,,2,1,1,2
C(C1(C(CC(CO1)O)O)O)=O,,,3,1,2,9,11
2670_0,,,,2,1,1,2
2671_0,,,,2,1,1,2
2673_0,,,,2,1,1,2
C1(COC(CO)(CC1O)O)=O,,,3,1,2,9,11
2674_0,,,,2,1,1,2
2676_0,,,,2,1,1,2
C(C1C(CC(C(O1)O)O)O)=O,,,3,1,2,12,14
2678_0,,,,2,1,1,2
C(C1CC(C(C(O1)O)O)O)=O,,,3,1,2,11,13
2680_0,,,,2,1,1,2
C1(COC(C)(C(C1O)O)O)=O,,,3,1,1,12,13
2682_0,,,,2,1,1,2
C1(C(C)OC(C(C1O)O)O)=O,,,3,1,1,11,12
2683_0,,,,2,1,1,2
2685_0,,,,2,1,1,2
CC1(C(C(C(CO1)O)O)O)O,,,3,1,1,7,8
2686_0,,,,2,1,1,2
2687_0,,,,2,1,1,2
2689_0,,,,2,1,1,2
C1(C(C(CC(CO)(O)O1)O)O)=O,,,3,1,1,7,8
2691_0,,,,2,1,1,2
C1(C(C(C(C(C)(O)O1)O)O)O)=O,,,3,1,1,8,9
2692_0,,,,2,1,1,2
2693_0,,,,2,1,1,2
2694_0,,,,2,1,1,2
2695_0,,,,2,1,1,2
2696_0,,,,2,1,1,2
2698_0,,,,2,1,1,2
C1C2(C(C(C(CO2)O)O1)O)O,,,3,1,1,2,3
2699_0,,,,2,1,1,2
2700_0,,,,2,1,1,2
2702_0,,,,2,1,1,2
C1C2(C(C(C(CO2)O1)O)O)O,,,3,1,1,4,5
2704_0,,,,2,1,1,2
C1C2C(CC(C(O)O2)(O)O1)O,,,3,1,2,4,6
2705_0,,,,2,1,1,2
2706_0,,,,2,1,1,2
2707_0,,,,2,1,1,2
2709_0,,,,2,1,1,2
C1(C(O)OCC(C(C1O)O)O)=O,,,3,1,1,10,11
2710_0,,,,2,1,1,2
2711_0,,,,2,1,1,2
2712_0,,,,2,1,1,2
2713_0,,,,2,1,1,2
2715_0,,,,2,1,1,2
C1(COC(CC(C1O)O)O)=O,,,3,1,3,12,15
2717_0,,,,2,1,1,2
C1C(C(C(CC(O)O1)O)O)O,,,3,1,1,7,8
2719_0,,,,2,1,1,2
C1CC(C(C(C(O)O1)O)O)O,,,3,1,1,8,9
2721_0,,,,2,1,1,2
C1(C(C(C(CC(O)O1)O)O)O)=O,,,3,1,1,8,9
2723_0,,,,2,1,1,2
C1(CC(C(C(C(O)O1)O)O)O)=O,,,3,1,1,8,9
2724_0,,,,2,1,1,2
2725_0,,,,2,1,1,2
2726_0,,,,2,1,1,2
2727_0,,,,2,1,1,2
2729_0,,,,2,1,1,2
C12C(C(C(CC(O)O1)O2)O)O,,,3,1,1,4,5
2730_0,,,,2,1,1,2
2731_0,,,,2,1,1,2
2733_0,,,,2,1,1,2
C12CC(C(C(C(O)O1)O)O2)O,,,3,1,1,4,5
2734_0,,,,2,1,1,2
2735_0,,,,2,1,1,2
2736_0,,,,2,1,1,2
2737_0,,,,2,1,1,2
2738_0,,,,2,1,1,2
2739_0,,,,2,1,1,2
2740_0,,,,2,1,1,2
2741_0,,,,2,1,1,2
2742_0,,,,2,1,1,2
2743_0,,,,2,1,1,2
2744_0,,,,2,1,1,2
2745_0,,,,2,1,1,2
2746_0,,,,2,1,1,2
2747_0,,,,2,1,1,2
2748_0,,,,2,1,1,2
2749_0,,,,2,1,1,2
2750_0,,,,2,1,1,2
2751_0,,,,2,1,1,2
2752_0,,,,2,1,1,2
2753_0,,,,2,1,1,2
2754_0,,,,2,1,1,2
2755_0,,,,2,1,1,2
2756_0,,,,2,1,1,2
2757_0,,,,2,1,1,2
2758_0,,,,2,1,1,2
2759_0,,,,2,1,2,3
2760_0,,,,2,1,2,3
2761_0,,,,2,1,2,3
2762_0,,,,2,1,2,3
2763_0,,,,2,1,2,3
2764_0,,,,2,1,2,3
2765_0,,,,2,1,2,3
2767_0,,,,2,1,2,3
C1(CC(C(C(C=O)O)O1)O)=O,,,3,1,2,9,11
2768_0,,,,2,1,1,2
2769_0,,,,2,1,1,2
2770_0,,,,2,1,1,2
2771_0,,,,2,1,1,2
2772_0,,,,2,1,2,3
2773_0,,,,2,1,2,3
2774_0,,,,2,1,2,3
2775_0,,,,2,1,2,3
2776_0,,,,2,1,2,3
2778_0,,,,2,1,2,3
C1(CC(C(C(C=O)O1)O)O)=O,,,3,1,1,13,14
2779_0,,,,2,1,1,2
2780_0,,,,2,1,1,2
2781_0,,,,2,1,2,3
2782_0,,,,2,1,2,3
2783_0,,,,2,1,2,3
2784_0,,,,2,1,2,3
2785_0,,,,2,1,2,3
2786_0,,,,2,1,2,3
2787_0,,,,2,1,2,3
2788_0,,,,2,1,1,2
2789_0,,,,2,1,1,2
2791_0,,,,2,2,1,3
C(CC(C(CO)O)CC(C=O)=O)=O,,,3,1,3,16,19
2793_0,,,,2,2,1,3
C(C(C(CC(CO)CC=O)=O)O)=O,,,3,1,1,16,17
2795_0,,,,2,2,1,3
C(CC(C=O)CC=O)(C(CO)O)=O,,,3,1,2,16,18
2797_0,,,,2,2,1,3
C(CC(C(C(CO)O)=O)CC=O)=O,,,3,1,1,11,12
2799_0,,,,2,2,1,3
C(CCCC(C(C(C=O)O)O)=O)=O,,,3,1,1,19,20
2801_0,,,,2,2,1,3
C(CC(C(C=O)O)CC(CO)=O)=O,,,3,1,1,17,18
2803_0,,,,2,2,1,3
C(CC(C(C(C=O)O)O)CC=O)=O,,,3,1,1,15,16
2804_0,,,,2,1,1,2
2804_1,,,,2,1,1,2
2806_0,,,,2,1,1,2
C1(C(C(CO)(C(C(C1)O)O)O)O)=O,,,4,1,2,0,2
2806_1,,,,2,1,1,2
2808_0,,,,2,1,1,2
C1(C(C(CO)(CC(C1O)O)O)O)=O,,,4,1,4,0,4
2808_1,,,,2,1,1,2
2809_0,,,,2,1,1,2
2809_1,,,,2,1,1,2
2811_0,,,,2,1,1,2
C1(C(C(C(C(CO)(C1)O)O)O)O)=O,,,4,1,1,0,1
2813_0,,,,2,1,1,2
C1(C(C(C)(C(C(C1O)O)O)O)O)=O,,,4,1,4,0,4
2813_1,,,,2,1,1,2
2814_0,,,,2,1,1,2
2814_1,,,,2,1,1,2
2816_0,,,,2,1,1,2
C1(C(C(C(C1O)O)O)O)=O,,,4,1,2,0,2
2816_1,,,,2,1,1,2
2818_0,,,,2,1,1,2
C1(C(C(C(CO)(C1CO)O)O)O)=O,,,4,1,4,0,4
2818_1,,,,2,1,1,2
2820_0,,,,2,1,1,2
C1(C(C(C(C1O)O)(CCO)O)O)=O,,,4,1,4,0,4
2820_1,,,,2,1,1,2
2821_0,,,,2,1,1,2
2821_1,,,,2,1,1,2
2823_0,,,,2,1,1,2
C1(C(C(C(C(C1O)O)O)O)O)=O,,,4,1,2,0,2
2823_1,,,,2,1,1,2
2825_0,,,,2,1,1,2
C(C1C(C(C(C1(CO)O)O)O)O)=O,,,4,1,2,0,2
2825_1,,,,2,1,1,2
2827_0,,,,2,1,1,2
C1(C(C(C(CC(C1O)O)O)O)O)=O,,,4,1,4,0,4
2827_1,,,,2,1,1,2
2828_0,,,,2,1,1,2
2828_1,,,,2,1,1,2
2830_0,,,,2,1,1,2
C(CO)(C1C(CC(C1O)=O)O)=O,,,4,1,3,0,3
2830_1,,,,2,1,1,2
2832_0,,,,2,1,1,2
C1(C(C(C(CC(C1)O)=O)O)O)=O,,,4,1,3,0,3
2832_1,,,,2,1,1,2
2834_0,,,,2,1,1,2
C(C1(CC(CC(C1O)=O)O)O)=O,,,4,1,4,0,4
2834_1,,,,2,1,1,2
2836_0,,,,2,1,1,2
C(C1C(CO)(CC(C1O)=O)O)=O,,,4,1,3,0,3
2836_1,,,,2,1,1,2
2838_0,,,,2,1,1,2
C(C1C(C(C(C)(C1O)O)O)=O)=O,,,4,1,4,0,4
2838_1,,,,2,1,1,2
2839_0,,,,2,1,1,2
2840_0,,,,2,1,1,2
2842_0,,,,2,1,1,2
C(C1C(C(C(C1(C)O)O)O)=O)=O,,,4,1,4,0,4
2842_1,,,,2,1,1,2
2843_0,,,,2,1,1,2
2843_1,,,,2,1,1,2
2844_0,,,,2,1,1,2
2846_0,,,,2,1,1,2
C(CC1(C(C(C(C1)=O)O)O)O)=O,,,4,1,1,0,1
2847_0,,,,2,1,1,2
2847_1,,,,2,1,1,2
2849_0,,,,2,1,1,2
C1(CC(C(CC(C1O)O)=O)O)=O,,,4,1,2,0,2
2851_0,,,,2,1,1,2
C(C1(CC(C(C(C1)=O)O)O)O)=O,,,4,1,1,0,1
2852_0,,,,2,1,1,2
2854_0,,,,2,1,1,2
C1(C(CC(C(C=O)O)(C1)O)O)=O,,,4,1,1,0,1
2856_0,,,,2,1,1,2
C1(C(CC(C(CO)O)(C1)O)O)=O,,,4,1,1,0,1
2858_0,,,,2,1,1,2
C1(C(C(C(C(C1)O)=O)CO)O)=O,,,4,1,6,0,6
2858_1,,,,2,1,1,2
2860_0,,,,2,1,1,2
C1(C(CO)C(C=O)(CC1O)O)=O,,,4,1,4,0,4
2860_1,,,,2,1,1,2
2861_0,,,,2,1,1,2
2863_0,,,,2,1,1,2
C(C1(C(CO)C(C(C1)=O)O)O)=O,,,4,1,1,0,1
2865_0,,,,2,1,1,2
C1(C(C(C(C)(C1CO)O)O)O)=O,,,4,1,4,0,4
2865_1,,,,2,1,1,2
2867_0,,,,2,1,1,2
C1(C(C(C(CCO)(C1)O)O)O)=O,,,4,1,3,0,3
2869_0,,,,2,1,1,2
C1(C(C(C)(C(C1CO)O)O)O)=O,,,4,1,4,0,4
2869_1,,,,2,1,1,2
2870_0,,,,2,1,1,2
2870_1,,,,2,1,1,2
2872_0,,,,2,1,1,2
C1(C(C(CO)C(CO)(C1)O)O)=O,,,4,1,1,0,1
2873_0,,,,2,1,1,2
2873_1,,,,2,1,1,2
2875_0,,,,2,1,1,2
C1(C(C(C(C1)O)(C)O)O)=O,,,4,1,3,0,3
2875_1,,,,2,1,1,2
2877_0,,,,2,1,1,2
C1(C(CC(CO)(C1)O)O)=O,,,4,1,2,0,2
2879_0,,,,2,1,1,2
C1(C(C(C(C)(C1)O)O)O)=O,,,4,1,3,0,3
2879_1,,,,2,1,1,2
2880_0,,,,2,1,1,2
2881_0,,,,2,1,1,2
2883_0,,,,2,1,1,2
C(C1C(C(CC(C1O)=O)O)O)=O,,,4,1,3,0,3
2883_1,,,,2,1,1,2
2885_0,,,,2,1,1,2
C(C1C(C(CC1(C=O)O)O)O)=O,,,4,1,2,0,2
2885_1,,,,2,1,1,2
2887_0,,,,2,1,1,2
C(C(C1C(C(CC1O)O)O)=O)=O,,,4,1,4,0,4
2887_1,,,,2,1,1,2
2888_0,,,,2,1,1,2
2888_1,,,,2,1,1,2
2889_0,,,,2,1,1,2
2891_0,,,,2,1,1,2
C1(C(C(C(C1)O)C(C=O)O)O)=O,,,4,1,1,0,1
2893_0,,,,2,1,1,2
C(C(C1C(C(C(C1O)O)O)O)=O)=O,,,4,1,2,0,2
2893_1,,,,2,1,1,2
2895_0,,,,2,1,1,2
C1(C(CC(C1)O)O)=O,,,4,1,1,0,1
2897_0,,,,2,1,1,2
C1(C(C(C(C(CO)O)(C1)O)O)O)=O,,,4,1,3,0,3
2899_0,,,,2,1,1,2
C(C1C(C(C(C1O)O)O)=O)=O,,,4,1,4,0,4
2899_1,,,,2,1,1,2
2900_0,,,,2,1,1,2
2900_1,,,,2,1,1,2
2902_0,,,,2,1,1,2
C(C1C(C(C(C(C1O)O)O)O)=O)=O,,,4,1,4,0,4
2902_1,,,,2,1,1,2
2903_0,,,,2,1,1,2
2903_1,,,,2,1,1,2
2905_0,,,,2,1,1,2
C1(C(C(CO)(CC(C1)O)O)O)=O,,,4,1,3,0,3
2905_1,,,,2,1,1,2
2907_0,,,,2,1,1,2
C1(C(C(CC(CO)(C1)O)O)O)=O,,,4,1,3,0,3
2907_1,,,,2,1,1,2
2908_0,,,,2,1,1,2
2910_0,,,,2,1,1,2
C1(C(C(C)(C(C(C1)O)O)O)O)=O,,,4,1,3,0,3
2910_1,,,,2,1,1,2
2911_0,,,,2,1,1,2
2913_0,,,,2,1,1,2
C1(C(C(CC(C1)O)O)O)=O,,,4,1,3,0,3
2913_1,,,,2,1,1,2
2915_0,,,,2,1,1,2
C1(C(C(C(C(C)(C1)O)O)O)O)=O,,,4,1,3,0,3
2915_1,,,,2,1,1,2
2916_0,,,,2,1,1,2
2917_0,,,,2,1,1,2
2918_0,,,,2,1,1,2
2920_0,,,,2,1,1,2
C1(C(C(C(C1O)O)O)C(C=O)O)=O,,,4,1,6,0,6
2920_1,,,,2,1,1,2
2921_0,,,,2,1,1,2
2921_1,,,,2,1,1,2
2922_0,,,,2,1,1,2
2922_1,,,,2,1,1,2
2924_0,,,,2,1,1,2
C1(C(C(C(C1C(C)O)O)O)O)=O,,,4,1,6,0,6
2924_1,,,,2,1,1,2
2926_0,,,,2,1,1,2
C(C1C(C(CC1(CO)O)O)O)=O,,,4,1,4,0,4
2926_1,,,,2,1,1,2
2928_0,,,,2,1,1,2
C(CO)(C1C(C(CC1O)O)O)=O,,,4,1,4,0,4
2928_1,,,,2,1,1,2
2930_0,,,,2,1,1,2
C1(C(C(CC(C(C1)O)O)O)O)=O,,,4,1,3,0,3
2930_1,,,,2,1,1,2
2931_0,,,,2,1,1,2
2931_1,,,,2,1,1,2
2933_0,,,,2,1,1,2
C1(C(C(C(C1)O)(C(CO)O)O)O)=O,,,4,1,3,0,3
2933_1,,,,2,1,1,2
2935_0,,,,2,1,1,2
C1(C(C(CO)(C(C1CO)O)O)O)=O,,,4,1,6,0,6
2935_1,,,,2,1,1,2
2937_0,,,,2,1,1,2
C1(C(C(CO)(C(CO)C1O)O)O)=O,,,4,1,2,0,2
2937_1,,,,2,1,1,2
2939_0,,,,2,1,1,2
C1(C(C(CC1O)(C(CO)O)O)O)=O,,,4,1,2,0,2
2939_1,,,,2,1,1,2
2941_0,,,,2,1,1,2
C1(C(C(C(CO)C(C1O)O)O)O)=O,,,4,1,2,0,2
2941_1,,,,2,1,1,2
2943_0,,,,2,1,1,2
C1(C(CO)C(C(C1CO)=O)O)=O,,,4,1,7,0,7
2943_1,,,,2,1,1,2
2945_0,,,,2,1,1,2
C1(C(C(C(C(CO)C1)=O)O)O)=O,,,4,1,6,0,6
2945_1,,,,2,1,1,2
2947_0,,,,2,1,1,2
C(C1(C(CO)CC(C1O)=O)O)=O,,,4,1,2,0,2
2947_1,,,,2,1,1,2
2948_0,,,,2,1,1,2
2948_1,,,,2,1,1,2
2950_0,,,,2,1,1,2
C(C1(CC(C(C1O)=O)CO)O)=O,,,4,1,3,0,3
2950_1,,,,2,1,1,2
2952_0,,,,2,1,1,2
C(C1C(C(C(C1O)=O)CO)O)=O,,,4,1,6,0,6
2952_1,,,,2,1,1,2
2954_0,,,,2,1,1,2
C1(C(C(CO)C(C1CO)O)=O)=O,,,4,1,4,0,4
2954_1,,,,2,1,1,2
2956_0,,,,2,1,1,2
C1(C(CO)C(C(C(C1)=O)O)O)=O,,,4,1,7,0,7
2956_1,,,,2,1,1,2
2958_0,,,,2,1,1,2
C1(CC(C(C(C1CO)=O)O)O)=O,,,4,1,7,0,7
2958_1,,,,2,1,1,2
2960_0,,,,2,1,1,2
C1(C(CO)C(CC(C1O)=O)O)=O,,,4,1,6,0,6
2961_0,,,,2,1,1,2
2961_1,,,,2,1,1,2
2962_0,,,,2,1,1,2
2962_1,,,,2,1,1,2
2964_0,,,,2,1,1,2
C(C1C(C(C(CO)C1O)O)=O)=O,,,4,1,2,0,2
2964_1,,,,2,1,1,2
2965_0,,,,2,1,1,2
2966_0,,,,2,1,1,2
2966_1,,,,2,1,1,2
2968_0,,,,2,1,1,2
C1(C(CO)C(C=O)C(C1O)O)=O,,,4,1,2,0,2
2970_0,,,,2,1,1,2
C1(C(CC(C(C1CO)O)O)=O)=O,,,4,1,6,0,6
2971_0,,,,2,1,1,2
2971_1,,,,2,1,1,2
2973_0,,,,2,1,1,2
C(C1C(C(CO)C(C1O)O)=O)=O,,,4,1,5,0,5
2973_1,,,,2,1,1,2
2975_0,,,,2,1,1,2
C1(C(C(C(C1)O)(CCO)O)O)=O,,,4,1,3,0,3
2975_1,,,,2,1,1,2
2977_0,,,,2,1,1,2
C1(C(CC(CO)(C1CO)O)O)=O,,,4,1,2,0,2
2977_1,,,,2,1,1,2
2978_0,,,,2,1,1,2
2978_1,,,,2,1,1,2
2979_0,,,,2,1,1,2
2981_0,,,,2,1,1,2
C1(C(CC(C1CO)O)O)=O,,,4,1,4,0,4
2981_1,,,,2,1,1,2
2982_0,,,,2,1,1,2
2982_1,,,,2,1,1,2
2983_0,,,,2,1,1,2
2983_1,,,,2,1,1,2
2984_0,,,,2,1,1,2
2984_1,,,,2,1,1,2
2986_0,,,,2,1,1,2
C(C1C(C(C(C1(C)O)O)O)O)=O,,,4,1,4,0,4
2986_1,,,,2,1,1,2
2988_0,,,,2,1,1,2
C1(C(C(C(CC(C1)O)O)O)O)=O,,,4,1,3,0,3
2989_0,,,,2,1,1,2
2989_1,,,,2,1,1,2
2990_0,,,,2,1,1,2
2990_1,,,,2,1,1,2
2991_0,,,,2,1,1,2
2991_1,,,,2,1,1,2
2992_0,,,,2,1,1,2
2994_0,,,,2,1,1,2
C(CO)(C1C(C(C(C1O)O)O)O)=O,,,4,1,2,0,2
2994_1,,,,2,1,1,2
2996_0,,,,2,1,1,2
C1(C(C(C(C(C(C1)O)O)O)O)O)=O,,,4,1,3,0,3
2996_1,,,,2,1,1,2
2997_0,,,,2,1,1,2
2999_0,,,,2,1,1,2
C(C1C(C(CC1O)O)O)=O,,,4,1,5,0,5
2999_1,,,,2,1,1,2
3000_0,,,,2,1,1,2
3000_1,,,,2,1,1,2
3002_0,,,,2,1,1,2
C(CCO)(C1C(C(CC1O)O)=O)=O,,,4,1,2,0,2
3002_1,,,,2,1,1,2
3004_0,,,,2,1,1,2
C1(C(CO)C(CC(C(C1)=O)O)O)=O,,,4,1,2,0,2
3004_1,,,,2,1,1,2
3006_0,,,,2,1,1,2
C(C1C(CCO)(CC(C1O)=O)O)=O,,,4,1,4,0,4
3006_1,,,,2,1,1,2
3008_0,,,,2,1,1,2
C(C1(CC(C(C(C1)=O)CO)O)O)=O,,,4,1,2,0,2
3008_1,,,,2,1,1,2
3010_0,,,,2,1,1,2
C1(CC(C(C1CO)O)(CC=O)O)=O,,,4,1,3,0,3
3010_1,,,,2,1,1,2
3011_0,,,,2,1,1,2
3011_1,,,,2,1,1,2
3013_0,,,,2,1,1,2
C1(C(CO)C(C(C1C(C)O)=O)O)=O,,,4,1,4,0,4
3013_1,,,,2,1,1,2
3015_0,,,,2,1,1,2
C1(C(C(CC1O)O)CC(CO)=O)=O,,,4,1,1,0,1
3017_0,,,,2,1,1,2
C(CO)(C1C(CC(C(C1)=O)O)O)=O,,,4,1,1,0,1
3019_0,,,,2,1,1,2
C1(CCC(C(CC(C1O)O)O)=O)=O,,,4,1,2,0,2
3019_1,,,,2,1,1,2
3021_0,,,,2,1,1,2
C(CC(C1(CCC(C1O)=O)O)O)=O,,,4,1,4,0,4
3021_1,,,,2,1,1,2
3023_0,,,,2,1,1,2
C(C1C(CCC(C1O)=O)(CO)O)=O,,,4,1,4,0,4
3023_1,,,,2,1,1,2
3025_0,,,,2,1,1,2
C(C1(CC(C(CO)=O)C(C1)O)O)=O,,,4,1,1,0,1
3027_0,,,,2,1,1,2
C(C1(CCC(C(C(C1)O)O)=O)O)=O,,,4,1,2,0,2
3027_1,,,,2,1,1,2
3029_0,,,,2,1,1,2
C(CC1(CCC(C(C1O)O)=O)O)=O,,,4,1,4,0,4
3029_1,,,,2,1,1,2
3031_0,,,,2,1,1,2
C(C1C(CO)(CCC1(C=O)O)O)=O,,,4,1,4,0,4
3031_1,,,,2,1,1,2
3033_0,,,,2,1,1,2
C(C(C1CC(CO)(CC1O)O)=O)=O,,,4,1,1,0,1
3034_0,,,,2,1,1,2
3034_1,,,,2,1,1,2
3035_0,,,,2,1,1,2
3035_1,,,,2,1,1,2
3037_0,,,,2,1,1,2
C1(C(C(C(C(C(C)O)C1)=O)O)O)=O,,,4,1,5,0,5
3037_1,,,,2,1,1,2
3039_0,,,,2,1,1,2
C(C1(C(C(C)O)CC(C1O)=O)O)=O,,,4,1,2,0,2
3039_1,,,,2,1,1,2
3040_0,,,,2,1,1,2
3040_1,,,,2,1,1,2
3042_0,,,,2,1,1,2
C(C1(CC(C(C1O)=O)C(C)O)O)=O,,,4,1,3,0,3
3042_1,,,,2,1,1,2
3044_0,,,,2,1,1,2
C1(C(C(CC1O)O)C(C(C)=O)O)=O,,,4,1,2,0,2
3044_1,,,,2,1,1,2
3046_0,,,,2,1,1,2
C1(CC(C(CC(CC1O)O)=O)O)=O,,,4,1,1,0,1
3048_0,,,,2,1,1,2
C(CC(C1(CC(C(C1)=O)O)O)O)=O,,,4,1,2,0,2
3050_0,,,,2,1,1,2
C(C1C(C(CC(C1O)=O)O)(C)O)=O,,,4,1,4,0,4
3050_1,,,,2,1,1,2
3052_0,,,,2,1,1,2
C(C1(CC(C(CC(C1)O)=O)O)O)=O,,,4,1,1,0,1
3054_0,,,,2,1,1,2
C(CC1(C(CC(C(C1)O)=O)O)O)=O,,,4,1,2,0,2
3056_0,,,,2,1,1,2
C(C1C(C)(C(CC1(C=O)O)O)O)=O,,,4,1,4,0,4
3056_1,,,,2,1,1,2
3058_0,,,,2,1,1,2
C(C(C1C(C(C)(CC1O)O)O)=O)=O,,,4,1,2,0,2
3058_1,,,,2,1,1,2
3059_0,,,,2,1,1,2
3059_1,,,,2,1,1,2
3060_0,,,,2,1,1,2
3060_1,,,,2,1,1,2
3062_0,,,,2,1,1,2
C1(C(C(C(C(C1)O)=O)C(C)O)O)=O,,,4,1,5,0,5
3064_0,,,,2,1,1,2
C(C1(C(C(C)O)C(C(C1)=O)O)O)=O,,,4,1,1,0,1
3065_0,,,,2,1,1,2
3065_1,,,,2,1,1,2
3067_0,,,,2,1,1,2
C1(C(C(C)O)C(C=O)(CC1O)O)=O,,,4,1,4,0,4
3067_1,,,,2,1,1,2
3069_0,,,,2,1,1,2
C(CC(C1C(C(CC1O)O)=O)O)=O,,,4,1,3,0,3
3069_1,,,,2,1,1,2
3071_0,,,,2,1,1,2
C(C1C(CC(C(CC1O)O)=O)O)=O,,,4,1,4,0,4
3071_1,,,,2,1,1,2
3073_0,,,,2,1,1,2
C(C1C(CC(CC(C1O)=O)O)O)=O,,,4,1,4,0,4
3073_1,,,,2,1,1,2
3075_0,,,,2,1,1,2
C(C1C(CC(C=O)(CC1O)O)O)=O,,,4,1,2,0,2
3075_1,,,,2,1,1,2
3077_0,,,,2,1,1,2
C(C1C(C(CC1O)(CC=O)O)O)=O,,,4,1,5,0,5
3077_1,,,,2,1,1,2
3079_0,,,,2,1,1,2
C(C1C(CC(CC1(C=O)O)O)O)=O,,,4,1,4,0,4
3079_1,,,,2,1,1,2
3081_0,,,,2,1,1,2
C(C(C1C(CC(CC1O)O)O)=O)=O,,,4,1,2,0,2
3081_1,,,,2,1,1,2
3082_0,,,,2,1,1,2
3082_1,,,,2,1,1,2
3083_0,,,,2,1,1,2
3083_1,,,,2,1,1,2
3085_0,,,,2,1,1,2
C(C1C(C(C(C1O)=O)C(C)O)O)=O,,,4,1,6,0,6
3085_1,,,,2,1,1,2
3087_0,,,,2,1,1,2
C1(C(CC(CC(C1CO)O)O)=O)=O,,,4,1,2,0,2
3087_1,,,,2,1,1,2
3089_0,,,,2,1,1,2
C(C1C(CC(C1(CCO)O)=O)O)=O,,,4,1,4,0,4
3089_1,,,,2,1,1,2
3091_0,,,,2,1,1,2
C1(C(CC(C1CO)O)(CC=O)O)=O,,,4,1,3,0,3
3091_1,,,,2,1,1,2
3093_0,,,,2,1,1,2
C(C1C(C(CCO)(CC1O)O)=O)=O,,,4,1,2,0,2
3093_1,,,,2,1,1,2
3094_0,,,,2,1,1,2
3094_1,,,,2,1,1,2
3096_0,,,,2,1,1,2
C1(C(C(C(C1CO)O)C(C)O)=O)=O,,,4,1,4,0,4
3096_1,,,,2,1,1,2
3098_0,,,,2,1,1,2
C1(CC(CC(C1C(CO)=O)O)O)=O,,,4,1,2,0,2
3098_1,,,,2,1,1,2
3100_0,,,,2,1,1,2
C1(CC(CC(C(C(C1)=O)O)O)O)=O,,,4,1,3,0,3
3100_1,,,,2,1,1,2
3102_0,,,,2,1,1,2
C(C1C(CC(CC1(CO)O)=O)O)=O,,,4,1,4,0,4
3102_1,,,,2,1,1,2
3104_0,,,,2,1,1,2
C(CC1(CC(C(C(C1)=O)O)O)O)=O,,,4,1,3,0,3
3104_1,,,,2,1,1,2
3106_0,,,,2,1,1,2
C(C1C(CC(CO)(CC1O)O)=O)=O,,,4,1,2,0,2
3106_1,,,,2,1,1,2
3107_0,,,,2,1,1,2
3107_1,,,,2,1,1,2
3109_0,,,,2,1,1,2
C1(C(C(C(C(C1)=O)O)O)C(C)O)=O,,,4,1,6,0,6
3109_1,,,,2,1,1,2
3111_0,,,,2,1,1,2
C1(CC(C(C(C1C(C)O)=O)O)O)=O,,,4,1,5,0,5
3111_1,,,,2,1,1,2
3113_0,,,,2,1,1,2
C1(CC(CC(CC(C1O)=O)O)O)=O,,,4,1,1,0,1
3115_0,,,,2,1,1,2
C(C1C(CC(C(C1(C)O)O)=O)O)=O,,,4,1,4,0,4
3115_1,,,,2,1,1,2
3117_0,,,,2,1,1,2
C(CC1(CC(CC(C1O)=O)O)O)=O,,,4,1,2,0,2
3119_0,,,,2,1,1,2
C(C1C(C(C(C)(CC1O)O)O)=O)=O,,,4,1,2,0,2
3119_1,,,,2,1,1,2
3120_0,,,,2,1,1,2
3120_1,,,,2,1,1,2
3122_0,,,,2,1,1,2
C1(C(C(CC(C1O)=O)O)C(C)O)=O,,,4,1,5,0,5
3123_0,,,,2,1,1,2
3123_1,,,,2,1,1,2
3124_0,,,,2,1,1,2
3124_1,,,,2,1,1,2
3126_0,,,,2,1,1,2
C(C1C(CC(C1(CC=O)O)O)O)=O,,,4,1,5,0,5
3126_1,,,,2,1,1,2
3128_0,,,,2,1,1,2
C(C1C(C(CC(CC1O)O)O)=O)=O,,,4,1,2,0,2
3128_1,,,,2,1,1,2
3129_0,,,,2,1,1,2
3129_1,,,,2,1,1,2
3130_0,,,,2,1,1,2
3130_1,,,,2,1,1,2
3131_0,,,,2,1,1,2
3131_1,,,,2,1,1,2
3133_0,,,,2,1,1,2
C(C1C(C(C(C1O)C(C)O)O)=O)=O,,,4,1,2,0,2
3133_1,,,,2,1,1,2
3135_0,,,,2,1,1,2
C1(C(C(CC(C1C(C)=O)O)O)O)=O,,,4,1,2,0,2
3135_1,,,,2,1,1,2
3136_0,,,,2,1,1,2
3138_0,,,,2,1,1,2
C(C1C(C(C(CC1(C)O)=O)O)O)=O,,,4,1,4,0,4
3138_1,,,,2,1,1,2
3140_0,,,,2,1,1,2
C1(CC(CC(C(C=O)O)(C1)O)O)=O,,,4,1,1,0,1
3142_0,,,,2,1,1,2
C(CC1(C(C(CC(C1)=O)O)O)O)=O,,,4,1,2,0,2
3143_0,,,,2,1,1,2
3143_1,,,,2,1,1,2
3144_0,,,,2,1,1,2
3145_0,,,,2,1,1,2
3145_1,,,,2,1,1,2
3147_0,,,,2,1,1,2
C1(C(C(CC(C1O)O)O)CC=O)=O,,,4,1,1,0,1
3149_0,,,,2,1,1,2
C(C1C(CC(C(C(C1)=O)O)O)O)=O,,,4,1,1,0,1
3151_0,,,,2,1,1,2
C(C1C(C(C(CCC1O)=O)O)O)=O,,,4,1,4,0,4
3151_1,,,,2,1,1,2
3153_0,,,,2,1,1,2
C(C1CC(CC1O)(C(C=O)O)O)=O,,,4,1,1,0,1
3155_0,,,,2,1,1,2
C(C1CC(C(C1O)O)(CC=O)O)=O,,,4,1,2,0,2
3157_0,,,,2,1,1,2
C(C1C(CCC1(C(C=O)O)O)O)=O,,,4,1,4,0,4
3157_1,,,,2,1,1,2
3159_0,,,,2,1,1,2
C(C(C(C1C(CC(C1)O)O)=O)O)=O,,,4,1,1,0,1
3160_0,,,,2,1,1,2
3160_1,,,,2,1,1,2
3161_0,,,,2,1,1,2
3161_1,,,,2,1,1,2
3163_0,,,,2,1,1,2
C1(C(C(C)O)C(C=O)C(C1O)O)=O,,,4,1,2,0,2
3165_0,,,,2,1,1,2
C(C(C)=O)(C1C(C(CC1O)O)O)=O,,,4,1,2,0,2
3165_1,,,,2,1,1,2
3167_0,,,,2,1,1,2
C1(C(CC(CC(C(C1)O)O)O)=O)=O,,,4,1,1,0,1
3169_0,,,,2,1,1,2
C(C1C(C(CC1(C(C)=O)O)O)O)=O,,,4,1,4,0,4
3169_1,,,,2,1,1,2
3171_0,,,,2,1,1,2
C(C1C(C(CC(C1(C)O)=O)O)O)=O,,,4,1,4,0,4
3171_1,,,,2,1,1,2
3173_0,,,,2,1,1,2
C1(CC(CC1(CC(C=O)O)O)O)=O,,,4,1,1,0,1
3174_0,,,,2,1,1,2
3174_1,,,,2,1,1,2
3176_0,,,,2,1,1,2
C1(C(CC(C(C1)O)O)(CC=O)O)=O,,,4,1,2,0,2
3178_0,,,,2,1,1,2
C1(C(C(CC1(C)O)O)C(C=O)O)=O,,,4,1,2,0,2
3178_1,,,,2,1,1,2
3179_0,,,,2,1,1,2
3179_1,,,,2,1,1,2
3181_0,,,,2,1,1,2
C1(C(CC(C(C1C(C)O)O)O)=O)=O,,,4,1,5,0,5
3182_0,,,,2,1,1,2
3182_1,,,,2,1,1,2
3184_0,,,,2,1,1,2
C(CC(C1C(C(CC1O)O)O)=O)=O,,,4,1,2,0,2
3184_1,,,,2,1,1,2
3186_0,,,,2,1,1,2
C(C1C(CC(C(CC1O)O)O)=O)=O,,,4,1,2,0,2
3186_1,,,,2,1,1,2
3188_0,,,,2,1,1,2
C(C1C(C(CC1(CC=O)O)O)O)=O,,,4,1,5,0,5
3188_1,,,,2,1,1,2
3190_0,,,,2,1,1,2
C(C1C(CC(CC(C1O)O)=O)O)=O,,,4,1,4,0,4
3190_1,,,,2,1,1,2
3191_0,,,,2,1,1,2
3191_1,,,,2,1,1,2
3193_0,,,,2,1,1,2
C1(C(C(CC(C1)O)O)C(C=O)O)=O,,,4,1,2,0,2
3193_1,,,,2,1,1,2
3194_0,,,,2,1,1,2
3194_1,,,,2,1,1,2
3196_0,,,,2,1,1,2
C1(CC(C(C1C(CC=O)O)O)O)=O,,,4,1,3,0,3
3196_1,,,,2,1,1,2
3198_0,,,,2,1,1,2
C(C1C(C(C(C1O)O)C(C)O)=O)=O,,,4,1,4,0,4
3198_1,,,,2,1,1,2
3200_0,,,,2,1,1,2
C(C1C(C=CC1(C(CO)O)O)O)=O,,,4,1,4,0,4
3200_1,,,,2,1,1,2
3201_0,,,,2,1,1,2
3201_1,,,,2,1,1,2
3203_0,,,,2,1,1,2
C(C1C(C(C(C1(C=C)O)O)O)O)=O,,,4,1,4,0,4
3203_1,,,,2,1,1,2
3204_0,,,,2,1,1,2
3204_1,,,,2,1,1,2
3206_0,,,,2,1,1,2
C1C(C(CC(C(C(C=1)=O)O)O)O)O,,,4,1,2,0,2
3206_1,,,,2,1,1,2
3208_0,,,,2,1,1,2
C(C1C(C(C=CC1(CO)O)O)O)=O,,,4,1,4,0,4
3208_1,,,,2,1,1,2
3209_0,,,,2,1,1,2
3209_1,,,,2,1,1,2
3211_0,,,,2,1,1,2
C(C1C(C(C(C=CC1O)O)O)O)=O,,,4,1,4,0,4
3211_1,,,,2,1,1,2
3212_0,,,,2,1,1,2
3212_1,,,,2,1,1,2
3214_0,,,,2,1,1,2
C1(C(C(C(C1C(CO)O)O)O)O)=O,,,4,1,6,0,6
3214_1,,,,2,1,1,2
3215_0,,,,2,1,1,2
3215_1,,,,2,1,1,2
3217_0,,,,2,1,1,2
C1(C(CO)C(C(C1O)=O)O)=O,,,4,1,2,0,2
3217_1,,,,2,1,1,2
3219_0,,,,2,1,1,2
C(C1(C(CC(C1O)=O)O)O)=O,,,4,1,7,0,7
3219_1,,,,2,1,1,2
3221_0,,,,2,1,1,2
C1(C(C(C(CC1O)=O)O)O)=O,,,4,1,3,0,3
3221_1,,,,2,1,1,2
3223_0,,,,2,1,1,2
C(C1(C(C(C(C1)=O)O)O)O)=O,,,4,1,2,0,2
3224_0,,,,2,1,1,2
3226_0,,,,2,1,1,2
C(C1C(C(C(C1O)=O)O)O)=O,,,4,1,2,0,2
3226_1,,,,2,1,1,2
3228_0,,,,2,1,1,2
C1(C(C(CC1O)O)O)=O,,,4,1,6,0,6
3228_1,,,,2,1,1,2
3229_0,,,,2,1,1,2
3231_0,,,,2,1,1,2
C1(CC(C(C1)=O)O)=O,,,4,1,8,0,8
3233_0,,,,2,1,1,2
C1(C(CC(C1)O)=O)=O,,,4,1,4,0,4
3234_0,,,,2,1,1,2
3234_1,,,,2,1,1,2
3235_0,,,,2,1,1,2
3236_0,,,,2,1,1,2
3236_1,,,,2,1,1,2
3237_0,,,,2,1,1,2
3238_0,,,,2,1,1,2
3240_0,,,,2,1,1,2
C(CO)(C1C(C(CO1)O)O)=O,,,4,1,3,0,3
3240_1,,,,2,1,1,2
3241_0,,,,2,1,1,2
3241_1,,,,2,1,1,2
3242_0,,,,2,1,1,2
3244_0,,,,2,1,1,2
C(C1C(CO)(CC(O1)O)O)=O,,,4,1,3,0,3
3244_1,,,,2,1,1,2
3246_0,,,,2,1,1,2
C(CO)(C1C(O)OCC1O)=O,,,4,1,4,0,4
3246_1,,,,2,1,1,2
3247_0,,,,2,1,1,2
3247_1,,,,2,1,1,2
3249_0,,,,2,1,1,2
C(C1C(C)(C(C(O1)O)O)O)=O,,,4,1,3,0,3
3249_1,,,,2,1,1,2
3250_0,,,,2,1,1,2
3251_0,,,,2,1,1,2
3252_0,,,,2,1,1,2
3252_1,,,,2,1,1,2
3254_0,,,,2,1,1,2
C(CO)(C1COC(C1O)O)=O,,,4,1,3,0,3
3254_1,,,,2,1,1,2
3256_0,,,,2,1,1,2
C1C(C(C(C=1)=O)O)O,,,4,1,7,0,7
3256_1,,,,2,1,1,2
3258_0,,,,2,1,1,2
C(C1C(CO)(O)OCC1O)=O,,,4,1,3,0,3
3258_1,,,,2,1,1,2
3259_0,,,,2,1,1,2
3259_1,,,,2,1,1,2
3260_0,,,,2,1,1,2
3260_1,,,,2,1,1,2
3261_0,,,,2,1,1,2
3261_1,,,,2,1,1,2
3263_0,,,,2,1,1,2
C1(C(C(CC(C1)O)O)=O)=O,,,4,1,3,0,3
3264_0,,,,2,1,1,2
3266_0,,,,2,1,1,2
C1(C(C(C(C)(C1)O)O)=O)=O,,,4,1,3,0,3
3266_1,,,,2,1,1,2
3268_0,,,,2,1,1,2
C1(CC(C(C(C1)O)=O)O)=O,,,4,1,3,0,3
3269_0,,,,2,1,1,2
3271_0,,,,2,1,1,2
C1(C(C(C(CC1)O)O)=O)=O,,,4,1,3,0,3
3271_1,,,,2,1,1,2
3273_0,,,,2,1,1,2
C(C1CC(C(C1O)=O)O)=O,,,4,1,3,0,3
3275_0,,,,2,1,1,2
C1(C(CC(CO)(C1)O)=O)=O,,,4,1,2,0,2
3277_0,,,,2,1,1,2
C1(C(C)(C(C(C1)=O)O)O)=O,,,4,1,5,0,5
3277_1,,,,2,1,1,2
3279_0,,,,2,1,1,2
C1(C(C(C=CC1O)O)O)=O,,,4,1,5,0,5
3279_1,,,,2,1,1,2
3281_0,,,,2,1,1,2
C1C(CO)(C(C(C=1)=O)O)O,,,4,1,4,0,4
3281_1,,,,2,1,1,2
3283_0,,,,2,1,1,2
C1(C(C(CC1)(CO)O)O)=O,,,4,1,4,0,4
3283_1,,,,2,1,1,2
3285_0,,,,2,1,1,2
C1(CC(C(C1CO)O)O)=O,,,4,1,5,0,5
3285_1,,,,2,1,1,2
3287_0,,,,2,1,1,2
C(C1(CCC(C1O)=O)O)(O)=O,,,4,1,4,0,4
3287_1,,,,2,1,1,2
3289_0,,,,2,1,1,2
C(C1(CC(C(C1)=O)O)O)(O)=O,,,4,1,2,0,2
3291_0,,,,2,1,1,2
C(C1C(C(CC1O)O)=O)(O)=O,,,4,1,4,0,4
3291_1,,,,2,1,1,2
3293_0,,,,2,1,1,2
C(C1C(CC(C1O)O)=O)(O)=O,,,4,1,5,0,5
3293_1,,,,2,1,1,2
3294_0,,,,2,1,1,2
3296_0,,,,2,1,1,2
C1(C(C(C(C(C1)O)(CO)O)O)O)=O,,,4,1,3,0,3
3296_1,,,,2,1,1,2
3297_0,,,,2,1,1,2
3298_0,,,,2,1,1,2
3298_1,,,,2,1,1,2
3300_0,,,,2,1,1,2
C(C1C(C(CO)(C(C1O)O)O)O)=O,,,4,1,2,0,2
3300_1,,,,2,1,1,2
3302_0,,,,2,1,1,2
C(C1(C(CC(C)(C1O)O)=O)O)=O,,,4,1,3,0,3
3304_0,,,,2,1,1,2
C(C)(C1(C(CC(C1O)=O)O)O)=O,,,4,1,5,0,5
3306_0,,,,2,1,1,2
C(C1(C(C)(CC(C1O)=O)O)O)=O,,,4,1,3,0,3
3308_0,,,,2,1,1,2
C(C1(C(CC(C1(C)O)O)=O)O)=O,,,4,1,3,0,3
3310_0,,,,2,1,1,2
C1(CC(C)(C(C1(CO)O)O)O)=O,,,4,1,3,0,3
3312_0,,,,2,1,1,2
C1(C(C(CO)(C(C)(C1)O)O)O)=O,,,4,1,1,0,1
3314_0,,,,2,1,1,2
C1(CC(C(C)(C1(CO)O)O)O)=O,,,4,1,3,0,3
3315_0,,,,2,1,1,2
3317_0,,,,2,1,1,2
C1(C(C(C(C1)O)(C(C=O)O)O)O)=O,,,4,1,1,0,1
3319_0,,,,2,1,1,2
C(C1(C(C(CC(C1O)=O)O)O)O)=O,,,4,1,5,0,5
3321_0,,,,2,1,1,2
C1(C(C(C)(C(C1(CO)O)O)O)O)=O,,,4,1,6,0,6
3321_1,,,,2,1,1,2
3323_0,,,,2,1,1,2
C1(C(C(CO)(C(CO)(C1)O)O)O)=O,,,4,1,3,0,3
3325_0,,,,2,1,1,2
C1(C(C(C(C)(C1(CO)O)O)O)O)=O,,,4,1,6,0,6
3325_1,,,,2,1,1,2
3327_0,,,,2,1,1,2
C(C1(C(CC(C(C1O)O)=O)O)O)=O,,,4,1,7,0,7
3327_1,,,,2,1,1,2
3329_0,,,,2,1,1,2
C(C1(C(CC(C1O)O)=O)O)=O,,,4,1,3,0,3
3330_0,,,,2,1,1,2
3332_0,,,,2,1,1,2
C(C1(C(CC(C(C1O)O)O)=O)O)=O,,,4,1,3,0,3
3334_0,,,,2,1,1,2
C1(C(C(C(C1)O)O)(C(C=O)O)O)=O,,,4,1,5,0,5
3336_0,,,,2,1,1,2
C1(C(C(C(C1(CO)O)O)O)O)=O,,,4,1,4,0,4
3336_1,,,,2,1,1,2
3337_0,,,,2,1,1,2
3339_0,,,,2,1,1,2
C1(CC(CO)(C(C1(CO)O)O)O)=O,,,4,1,5,0,5
3341_0,,,,2,1,1,2
C1(C(C(CO)(C(C)(C1O)O)O)O)=O,,,4,1,2,0,2
3341_1,,,,2,1,1,2
3343_0,,,,2,1,1,2
C1(C(C(CC(C1(CO)O)O)O)O)=O,,,4,1,6,0,6
3343_1,,,,2,1,1,2
3345_0,,,,2,1,1,2
C1(CC(CC(C1(CO)O)=O)O)=O,,,4,1,4,0,4
3347_0,,,,2,1,1,2
C1(C(CO)(C(CC(C1)=O)O)O)=O,,,4,1,6,0,6
3349_0,,,,2,1,1,2
C(C1C(C(C(C1)=O)(CO)O)O)=O,,,4,1,4,0,4
3351_0,,,,2,1,1,2
C(C1(C(C(C(C1O)=O)CO)O)O)=O,,,4,1,4,0,4
3351_1,,,,2,1,1,2
3353_0,,,,2,1,1,2
C1(C(C(C(C1)O)(C(C)O)O)O)=O,,,4,1,1,0,1
3355_0,,,,2,1,1,2
C1(CC(C(C1(C(C)O)O)O)O)=O,,,4,1,5,0,5
3357_0,,,,2,1,1,2
C(C1C(C(C=O)(C(C1O)O)O)O)=O,,,4,1,4,0,4
3357_1,,,,2,1,1,2
3359_0,,,,2,1,1,2
C1(CC(CC(C1(C(C)O)O)=O)O)=O,,,4,1,3,0,3
3361_0,,,,2,1,1,2
C1(C(C(CC(C1)=O)O)(C(C)O)O)=O,,,4,1,5,0,5
3363_0,,,,2,1,1,2
C(C1C(C(C(C1)=O)(C(C)O)O)O)=O,,,4,1,4,0,4
3364_0,,,,2,1,1,2
3366_0,,,,2,1,1,2
C1(CC(C(C1(C(CO)O)O)O)O)=O,,,4,1,5,0,5
3367_0,,,,2,1,1,2
3367_1,,,,2,1,1,2
3369_0,,,,2,1,1,2
C(CC1(C(CC(C1O)=O)O)O)=O,,,4,1,1,0,1
3370_0,,,,2,1,1,2
3372_0,,,,2,1,1,2
C(C1(C(C(C(C(C1)=O)O)O)O)O)=O,,,4,1,3,0,3
3372_1,,,,2,1,1,2
3374_0,,,,2,1,1,2
C1(C(C(C(C(C=O)O)(C1)O)O)O)=O,,,4,1,2,0,2
3374_1,,,,2,1,1,2
3375_0,,,,2,1,1,2
3375_1,,,,2,1,1,2
3377_0,,,,2,1,1,2
C1(C(C(C(C(C)O)(C1)O)O)O)=O,,,4,1,2,0,2
3377_1,,,,2,1,1,2
3379_0,,,,2,1,1,2
C1(C(C(C(CO)(CC1O)O)O)O)=O,,,4,1,2,0,2
3379_1,,,,2,1,1,2
3381_0,,,,2,1,1,2
C1(C(C(C(CC1(CO)O)O)O)O)=O,,,4,1,3,0,3
3381_1,,,,2,1,1,2
3382_0,,,,2,1,1,2
3382_1,,,,2,1,1,2
3384_0,,,,2,1,1,2
C1(C(C(CO)(CC1(CO)O)O)O)=O,,,4,1,3,0,3
3384_1,,,,2,1,1,2
3386_0,,,,2,1,1,2
C1(CC(C(CC1(CO)O)=O)O)=O,,,4,1,3,0,3
3388_0,,,,2,1,1,2
C(C1(CC(C(C1)=O)(CO)O)O)=O,,,4,1,2,0,2
3390_0,,,,2,1,1,2
C(C1C(CC(C1(CO)O)=O)O)=O,,,4,1,3,0,3
3390_1,,,,2,1,1,2
3392_0,,,,2,1,1,2
C(C1C(C(CO)(CC1O)O)=O)=O,,,4,1,3,0,3
3392_1,,,,2,1,1,2
3394_0,,,,2,1,1,2
C1(C(CC(CO)(C(C1)O)O)=O)=O,,,4,1,1,0,1
3396_0,,,,2,1,1,2
C(C1C(CC(CO)(C1O)O)=O)=O,,,4,1,2,0,2
3396_1,,,,2,1,1,2
3398_0,,,,2,1,1,2
C1C(CO)(C(C(C(C=1)=O)O)O)O,,,4,1,2,0,2
3398_1,,,,2,1,1,2
3400_0,,,,2,1,1,2
C(C1C(C(C(C1(C=O)O)O)O)O)=O,,,4,1,3,0,3
3400_1,,,,2,1,1,2
3402_0,,,,2,1,1,2
C1(CC(C(CC1(C(C)O)O)=O)O)=O,,,4,1,2,0,2
3404_0,,,,2,1,1,2
C(C1(CC(C(C1)=O)(C(C)O)O)O)=O,,,4,1,2,0,2
3406_0,,,,2,1,1,2
C(C1C(CC(C1(C(C)O)O)=O)O)=O,,,4,1,3,0,3
3406_1,,,,2,1,1,2
3408_0,,,,2,1,1,2
C(C1C(C(C(C)O)(CC1O)O)=O)=O,,,4,1,3,0,3
3408_1,,,,2,1,1,2
3410_0,,,,2,1,1,2
C1(C(CC(C(C(C)O)(C1)O)O)=O)=O,,,4,1,1,0,1
3412_0,,,,2,1,1,2
C(C1C(CC(C1O)(C(C)O)O)=O)=O,,,4,1,2,0,2
3412_1,,,,2,1,1,2
3414_0,,,,2,1,1,2
C1C(C(C(C(C=1)=O)O)O)(C(C)O)O,,,4,1,2,0,2
3414_1,,,,2,1,1,2
3415_0,,,,2,1,1,2
3415_1,,,,2,1,1,2
3417_0,,,,2,1,1,2
C1(C2C(C(CO2)(C1)O)O)=O,,,4,1,1,0,1
3419_0,,,,2,1,1,2
C1(C2C(CC(C1O)O2)O)=O,,,4,1,2,0,2
3419_1,,,,2,1,1,2
3421_0,,,,2,1,1,2
C1(C2CC(C(O2)O)(C1)O)=O,,,4,1,3,0,3
3423_0,,,,2,1,1,2
C1(C2CC(C1C(O2)O)O)=O,,,4,1,5,0,5
3423_1,,,,2,1,1,2
3425_0,,,,2,1,1,2
C1(C=CC(C(C1)O)=O)=O,,,4,1,3,0,3
3427_0,,,,2,1,1,2
C(C1(C=CC(C1)=O)O)=O,,,4,1,4,0,4
3429_0,,,,2,1,1,2
C(C1C=CC(C1O)=O)=O,,,4,1,2,0,2
3431_0,,,,2,1,1,2
C1C(CC(C(C=1)=O)=O)O,,,4,1,3,0,3
3433_0,,,,2,1,1,2
C(C1C(C=CC1O)=O)=O,,,4,1,6,0,6
3433_1,,,,2,1,1,2
3435_0,,,,2,1,1,2
C1(C2(CC(C1CO2)O)O)=O,,,4,1,4,0,4
3435_1,,,,2,1,1,2
3437_0,,,,2,1,1,2
C1(C2C(CC(C1)(O2)O)O)=O,,,4,1,4,0,4
3437_1,,,,2,1,1,2
3439_0,,,,2,1,1,2
C1(CC2(C(C1CO2)O)O)=O,,,4,1,4,0,4
3439_1,,,,2,1,1,2
3441_0,,,,2,1,1,2
C1(CC2C(C1C(O)O2)O)=O,,,4,1,6,0,6
3441_1,,,,2,1,1,2
3443_0,,,,2,1,1,2
C(C1C(C(CO)O)CC(C1O)=O)=O,,,4,1,2,0,2
3445_0,,,,2,1,1,2
C(C1C(C(C(CC1CO)=O)O)O)=O,,,4,1,2,0,2
3447_0,,,,2,1,1,2
C(C1CCC(C(C(C1O)O)O)=O)=O,,,4,1,2,0,2
3449_0,,,,2,1,1,2
C(CCC1C(C(C(C1O)O)O)=O)=O,,,4,1,2,0,2
3451_0,,,,2,1,1,2
C1(C(C(CC(C(C=O)O)C1)O)O)=O,,,4,1,3,0,3
3451_1,,,,2,1,1,2
3453_0,,,,2,1,1,2
C(CC1C(C(C(C(C1)=O)O)O)O)=O,,,4,1,3,0,3
3453_1,,,,2,1,1,2
3455_0,,,,2,1,1,2
C(C1C(C(C(C1O)O)O)CC=O)=O,,,4,1,3,0,3
3457_0,,,,2,2,1,3
C(C1C(C(C(C1O)O)O)=O)(O)=O,,,4,1,2,0,2
3457_1,,,,2,2,1,3
3459_0,,,,2,2,1,3
C1(C(CO)C(C(C1C(O)=O)=O)O)=O,,,4,1,2,0,2
3459_1,,,,2,2,1,3
3461_0,,,,2,2,1,3
C(C1C(C(C(C(C1)=O)O)O)=O)(O)=O,,,4,1,1,0,1
3463_0,,,,2,2,1,3
C(C1(CC(C(O)=O)C(C1O)=O)O)=O,,,4,1,1,0,1
3465_0,,,,2,2,1,3
C(C1C(C(CC(C1O)=O)O)=O)(O)=O,,,4,1,2,0,2
3465_1,,,,2,2,1,3
3467_0,,,,2,2,1,3
C1(C(CC(C=O)(C1C(O)=O)O)O)=O,,,4,1,2,0,2
3467_1,,,,2,2,1,3
3469_0,,,,2,2,1,3
C(C1C(C(C(O)=O)C(C1O)=O)O)=O,,,4,1,2,0,2
3469_1,,,,2,2,1,3
3471_0,,,,2,2,1,3
C(C1C(C(C(CO)C1O)=O)=O)(O)=O,,,4,1,2,0,2
3471_1,,,,2,2,1,3
3473_0,,,,2,2,1,3
C(C1C(CC(C(C1O)O)=O)=O)(O)=O,,,4,1,2,0,2
3473_1,,,,2,2,1,3
3475_0,,,,2,2,1,3
C1(CC(C(C(C1C(O)=O)=O)O)O)=O,,,4,1,2,0,2
3475_1,,,,2,2,1,3
3477_0,,,,2,2,1,3
C(C1C(C(C(CC1O)=O)O)=O)(O)=O,,,4,1,2,0,2
3477_1,,,,2,2,1,3
3479_0,,,,2,2,1,3
C1(C(C(C(C=O)C1C(O)=O)O)O)=O,,,4,1,1,0,1
3481_0,,,,2,2,1,3
C(C1C(C(CC(C1O)O)=O)=O)(O)=O,,,4,1,2,0,2
3481_1,,,,2,2,1,3
3483_0,,,,2,2,1,3
C(C1C(C(C=O)C(C1O)O)=O)(O)=O,,,4,1,2,0,2
3483_1,,,,2,2,1,3
3485_0,,,,2,2,1,3
C(C(C(C(C(C=O)O)O)=O)O)(O)=O,,,4,1,2,0,2
3485_1,,,,2,2,1,3
3487_0,,,,2,2,1,3
C(C(C(C(C(C)O)O)=O)O)(O)=O,,,4,1,5,0,5
3487_1,,,,2,2,1,3
3489_0,,,,2,2,1,3
C(C(C=O)C(CO)(CO)O)(O)=O,,,4,1,2,0,2
3489_1,,,,2,2,1,3
3491_0,,,,2,2,1,3
C(C(C=O)C(C(CO)O)O)(O)=O,,,4,1,2,0,2
3491_1,,,,2,2,1,3
3493_0,,,,2,2,1,3
C(C(C(C=O)=O)C(C=O)(C)O)(O)=O,,,4,1,2,0,2
3493_1,,,,2,2,1,3
3495_0,,,,2,2,1,3
C(C(C(C=O)=O)C(C=O)O)(O)=O,,,4,1,2,0,2
3495_1,,,,2,2,1,3
3497_0,,,,2,2,1,3
C(C(C(C=O)=O)C(C)(CO)O)(O)=O,,,4,1,2,0,2
3497_1,,,,2,2,1,3
3499_0,,,,2,2,1,3
C(CC(C(CC(CO)=O)O)=O)(O)=O,,,4,1,1,0,1
3501_0,,,,2,2,1,3
C(C(C(CO)=O)C(C(C)=O)O)(O)=O,,,4,1,5,0,5
3501_1,,,,2,2,1,3
3503_0,,,,2,2,1,3
C(C(C(CC(C(C)=O)O)=O)O)(O)=O,,,4,1,4,0,4
3503_1,,,,2,2,1,3
3505_0,,,,2,2,1,3
C(C(C)(C(C(O)=O)C(CO)=O)O)=O,,,4,1,5,0,5
3505_1,,,,2,2,1,3
3507_0,,,,2,2,1,3
C(C(C)(CC(C(C(O)=O)O)=O)O)=O,,,4,1,4,0,4
3507_1,,,,2,2,1,3
3509_0,,,,2,2,1,3
C(CC(C(C(C(C)=O)O)O)=O)(O)=O,,,4,1,4,0,4
3511_0,,,,2,2,1,3
C(C(C)(C(C(CC(O)=O)=O)O)O)=O,,,4,1,4,0,4
3513_0,,,,2,2,1,3
C(C(C(C(C)O)C(CCO)O)=O)=O,,,4,1,5,0,5
3513_1,,,,2,2,1,3
3515_0,,,,2,2,1,3
C(C(CO)C(C(CC(C)O)=O)O)=O,,,4,1,2,0,2
3515_1,,,,2,2,1,3
3517_0,,,,2,2,1,3
C(C(CO)C(C=O)(CC(C)O)O)=O,,,4,1,2,0,2
3517_1,,,,2,2,1,3
3518_0,,,,2,2,1,3
3518_1,,,,2,2,1,3
3520_0,,,,2,2,1,3
C(C(C=O)C(C(CC(C)O)=O)O)=O,,,4,1,2,0,2
3520_1,,,,2,2,1,3
3522_0,,,,2,2,1,3
C(C(C=O)C(C=O)(CC(C)O)O)=O,,,4,1,2,0,2
3522_1,,,,2,2,1,3
3524_0,,,,2,2,1,3
C(C(C(C=O)=O)C(C)O)(O)=O,,,4,1,2,0,2
3524_1,,,,2,2,1,3
3526_0,,,,2,2,1,3
C(C(C(C(C=O)=O)C(C)O)O)(O)=O,,,4,1,2,0,2
3526_1,,,,2,2,1,3
3528_0,,,,2,2,1,3
C(C(C(C(C)O)C(C(C)O)O)=O)=O,,,4,1,2,0,2
3528_1,,,,2,2,1,3
3530_0,,,,2,2,1,3
C(CC(C(CC(CCO)O)=O)O)=O,,,4,1,3,0,3
3532_0,,,,2,2,1,3
C(C(C(CCO)O)C(C(C)=O)O)=O,,,4,1,2,0,2
3532_1,,,,2,2,1,3
3534_0,,,,2,2,1,3
C(C(CO)C(C)(C(CC=O)O)O)=O,,,4,1,2,0,2
3534_1,,,,2,2,1,3
3536_0,,,,2,2,1,3
C(C(CO)C(CC(C(C)=O)O)O)=O,,,4,1,2,0,2
3536_1,,,,2,2,1,3
3537_0,,,,2,2,1,3
3539_0,,,,2,2,1,3
C(CC(C(C=O)C(C(C)=O)O)O)=O,,,4,1,2,0,2
3539_1,,,,2,2,1,3
3541_0,,,,2,2,1,3
C(C(C=O)C(C)(C(CC=O)O)O)=O,,,4,1,2,0,2
3541_1,,,,2,2,1,3
3543_0,,,,2,2,1,3
C(C(C=O)C(CC(C(C)=O)O)O)=O,,,4,1,2,0,2
3543_1,,,,2,2,1,3
3544_0,,,,2,2,1,3
3546_0,,,,2,2,1,3
C(C(C=O)C(C(C)=O)O)(O)=O,,,4,1,2,0,2
3546_1,,,,2,2,1,3
3548_0,,,,2,2,1,3
C(C(CC(C(CC=O)O)=O)O)(O)=O,,,4,1,1,0,1
3550_0,,,,2,2,1,3
C(C(C(C=O)C(C(C)=O)O)O)(O)=O,,,4,1,5,0,5
3550_1,,,,2,2,1,3
3552_0,,,,2,2,1,3
C(CC(C(CC(C(C)O)O)=O)O)=O,,,4,1,1,0,1
3554_0,,,,2,2,1,3
C(C(C(C(C)O)O)C(C(C)=O)O)=O,,,4,1,2,0,2
3554_1,,,,2,2,1,3
3556_0,,,,2,2,1,3
C(C(C(CCO)O)C(C=O)(C)O)=O,,,4,1,2,0,2
3556_1,,,,2,2,1,3
3558_0,,,,2,2,1,3
C(C(CO)C(C(C)(CC=O)O)O)=O,,,4,1,2,0,2
3558_1,,,,2,2,1,3
3560_0,,,,2,2,1,3
C(C(CO)C(CC(C=O)(C)O)O)=O,,,4,1,2,0,2
3560_1,,,,2,2,1,3
3562_0,,,,2,2,1,3
C(CC(C(C=O)C(C=O)(C)O)O)=O,,,4,1,2,0,2
3562_1,,,,2,2,1,3
3564_0,,,,2,2,1,3
C(C(C=O)C(C(C)(CC=O)O)O)=O,,,4,1,2,0,2
3564_1,,,,2,2,1,3
3566_0,,,,2,2,1,3
C(C(C=O)C(CC(C=O)(C)O)O)=O,,,4,1,2,0,2
3566_1,,,,2,2,1,3
3568_0,,,,2,2,1,3
C(C(C=O)C(C=O)(C)O)(O)=O,,,4,1,2,0,2
3568_1,,,,2,2,1,3
3570_0,,,,2,2,1,3
C(C(C(C=O)C(C=O)(C)O)O)(O)=O,,,4,1,5,0,5
3570_1,,,,2,2,1,3
3572_0,,,,2,2,1,3
C(C(C(C(C)O)O)C(C=O)(C)O)=O,,,4,1,2,0,2
3572_1,,,,2,2,1,3
3574_0,,,,2,2,1,3
C(C(C(C(C(O)=O)O)=O)CO)=O,,,4,1,2,0,2
3574_1,,,,2,2,1,3
3576_0,,,,2,2,1,3
C(C(C=O)C(C(CO)O)=O)(O)=O,,,4,1,2,0,2
3576_1,,,,2,2,1,3
3578_0,,,,2,2,1,3
C(C(C(C(C(O)=O)O)=O)C(C)O)=O,,,4,1,2,0,2
3578_1,,,,2,2,1,3
3580_0,,,,2,2,1,3
C(C(C=O)C(C(C(C)O)O)=O)(O)=O,,,4,1,2,0,2
3580_1,,,,2,2,1,3
3582_0,,,,2,2,1,3
C(CC(C(C(O)=O)C(CO)=O)O)=O,,,4,1,4,0,4
3582_1,,,,2,2,1,3
3584_0,,,,2,2,1,3
C(C(C(CC(CC=O)O)=O)O)(O)=O,,,4,1,3,0,3
3584_1,,,,2,2,1,3
3586_0,,,,2,2,1,3
C(C(C=O)C(CC(CO)=O)O)(O)=O,,,4,1,2,0,2
3586_1,,,,2,2,1,3
3588_0,,,,2,2,1,3
C(C(C=O)C(CO)(CC=O)O)(O)=O,,,4,1,2,0,2
3588_1,,,,2,2,1,3
3590_0,,,,2,2,1,3
C(C(C(C(C=O)O)=O)CO)(O)=O,,,4,1,2,0,2
3590_1,,,,2,2,1,3
3592_0,,,,2,2,1,3
C(C(C(C(C=O)O)=O)C(C)O)(O)=O,,,4,1,2,0,2
3592_1,,,,2,2,1,3
3594_0,,,,2,2,1,3
C(CC(C(C(CC(O)=O)=O)O)O)=O,,,4,1,3,0,3
3596_0,,,,2,2,1,3
C(C(C=O)C(C(C(C)=O)O)O)(O)=O,,,4,1,2,0,2
3596_1,,,,2,2,1,3
3598_0,,,,2,2,1,3
C(C(C=O)C(C)(C(C=O)O)O)(O)=O,,,4,1,2,0,2
3598_1,,,,2,2,1,3
3600_0,,,,2,2,1,3
C(C(C(C(CO)O)=O)CO)(O)=O,,,4,1,2,0,2
3600_1,,,,2,2,1,3
3602_0,,,,2,2,1,3
C(C(C(C(CO)O)=O)C(C)O)(O)=O,,,4,1,2,0,2
3602_1,,,,2,2,1,3
3604_0,,,,2,2,1,3
C(C(C=O)C(C)(C(CO)O)O)(O)=O,,,4,1,2,0,2
3604_1,,,,2,2,1,3
3606_0,,,,2,2,1,3
C(C(C(C(CO)CO)=O)O)(O)=O,,,4,1,2,0,2
3606_1,,,,2,2,1,3
3608_0,,,,2,2,1,3
C(C(CO)C(CCO)O)=O,,,4,1,2,0,2
3608_1,,,,2,2,1,3
3610_0,,,,2,2,1,3
C(C(CO)C(CO)(CC(C)O)O)=O,,,4,1,2,0,2
3610_1,,,,2,2,1,3
3612_0,,,,2,2,1,3
C(CO)(C(C(C)O)C(CCO)O)=O,,,4,1,2,0,2
3612_1,,,,2,2,1,3
3614_0,,,,2,2,1,3
C(C(C(CCO)O)O)(CC(C)O)=O,,,4,1,2,0,2
3614_1,,,,2,2,1,3
3616_0,,,,2,2,1,3
C(C(CO)C(C)(C(C(C)O)O)O)=O,,,4,1,2,0,2
3616_1,,,,2,2,1,3
3618_0,,,,2,2,1,3
C(C(C(C)O)O)(CC(CCO)O)=O,,,4,1,1,0,1
3620_0,,,,2,2,1,3
C(C(CO)C(CC(C)(CO)O)O)=O,,,4,1,2,0,2
3620_1,,,,2,2,1,3
3622_0,,,,2,2,1,3
C(C(C(CCO)O)C(C)(CO)O)=O,,,4,1,2,0,2
3622_1,,,,2,2,1,3
3624_0,,,,2,2,1,3
C(C(CO)C(CC(C)O)O)=O,,,4,1,2,0,2
3624_1,,,,2,2,1,3
3626_0,,,,2,2,1,3
C(C(C(C)O)C(CCO)O)=O,,,4,1,2,0,2
3626_1,,,,2,2,1,3
3628_0,,,,2,2,1,3
C(C(CO)C(C(C(C)O)O)O)=O,,,4,1,2,0,2
3628_1,,,,2,2,1,3
3630_0,,,,2,2,1,3
C(C(CO)C(CC(CO)O)O)=O,,,4,1,2,0,2
3630_1,,,,2,2,1,3
3632_0,,,,2,2,1,3
C(C(C(CO)O)C(CCO)O)=O,,,4,1,2,0,2
3632_1,,,,2,2,1,3
3634_0,,,,2,2,1,3
C(C(CO)C(C=O)(C(CO)O)O)=O,,,4,1,5,0,5
3634_1,,,,2,2,1,3
3635_0,,,,2,2,1,3
3635_1,,,,2,2,1,3
3637_0,,,,2,2,1,3
C(C(CO)C(C=O)(CO)O)=O,,,4,1,6,0,6
3637_1,,,,2,2,1,3
3639_0,,,,2,2,1,3
C(C(CO)C(C(CO)=O)O)=O,,,4,1,9,0,9
3639_1,,,,2,2,1,3
3640_0,,,,2,2,1,3
3640_1,,,,2,2,1,3
3642_0,,,,2,2,1,3
C(C(CO)C(C(C)=O)(CO)O)=O,,,4,1,3,0,3
3642_1,,,,2,2,1,3
3644_0,,,,2,2,1,3
C(C(CO)C(C(CO)=O)(C)O)=O,,,4,1,2,0,2
3644_1,,,,2,2,1,3
3646_0,,,,2,2,1,3
C(C(C)=O)(C(C(CCO)O)O)=O,,,4,1,2,0,2
3646_1,,,,2,2,1,3
3648_0,,,,2,2,1,3
C(C(CO)=O)(CC(CCO)O)=O,,,4,1,1,0,1
3650_0,,,,2,2,1,3
C(C(CO)C(C(C(C)O)=O)O)=O,,,4,1,2,0,2
3650_1,,,,2,2,1,3
3652_0,,,,2,2,1,3
C(C(CO)C(C=O)(C(C)O)O)=O,,,4,1,5,0,5
3652_1,,,,2,2,1,3
3654_0,,,,2,2,1,3
C(C(CO)C(CO)(C(C)O)O)=O,,,4,1,2,0,2
3654_1,,,,2,2,1,3
3656_0,,,,2,2,1,3
C(C(C(CCO)O)O)(C(C)O)=O,,,4,1,2,0,2
3656_1,,,,2,2,1,3
3658_0,,,,2,2,1,3
C(C(CO)C(CC=O)O)=O,,,4,1,2,0,2
3658_1,,,,2,2,1,3
3660_0,,,,2,2,1,3
C(C(C=O)C(CCO)O)=O,,,4,1,2,0,2
3660_1,,,,2,2,1,3
3662_0,,,,2,2,1,3
C(C(CO)C(CO)(C(C=O)O)O)=O,,,4,1,6,0,6
3662_1,,,,2,2,1,3
3663_0,,,,2,2,1,3
3663_1,,,,2,2,1,3
3665_0,,,,2,2,1,3
C(C(C(C(C(CCO)O)O)=O)O)=O,,,4,1,3,0,3
3665_1,,,,2,2,1,3
3667_0,,,,2,2,1,3
C(C(CO)C(C(CCO)O)O)=O,,,4,1,2,0,2
3667_1,,,,2,2,1,3
3669_0,,,,2,2,1,3
C(C(CO)C(C(O)=O)(C)O)=O,,,4,1,2,0,2
3669_1,,,,2,2,1,3
3671_0,,,,2,2,1,3
C(C(CC(CCO)O)=O)(O)=O,,,4,1,4,0,4
3673_0,,,,2,2,1,3
C(C(C=O)CO)(O)=O,,,4,1,2,0,2
3673_1,,,,2,2,1,3
3675_0,,,,2,2,1,3
C(C(CO)C(CO)(CC(O)=O)O)=O,,,4,1,2,0,2
3675_1,,,,2,2,1,3
3677_0,,,,2,2,1,3
C(C(C(CO)=O)C(CCO)O)(O)=O,,,4,1,2,0,2
3677_1,,,,2,2,1,3
3679_0,,,,2,2,1,3
C(CC(C(C(CCO)O)O)=O)(O)=O,,,4,1,2,0,2
3679_1,,,,2,2,1,3
3681_0,,,,2,2,1,3
C(C(CO)C(C)(C(C(O)=O)O)O)=O,,,4,1,2,0,2
3681_1,,,,2,2,1,3
3683_0,,,,2,2,1,3
C(C(C(CC(CCO)O)=O)O)(O)=O,,,4,1,1,0,1
3685_0,,,,2,2,1,3
C(C(CO)C(C(O)=O)O)=O,,,4,1,6,0,6
3685_1,,,,2,2,1,3
3687_0,,,,2,2,1,3
C(C(CO)C(C(C(O)=O)O)O)=O,,,4,1,2,0,2
3687_1,,,,2,2,1,3
3689_0,,,,2,2,1,3
C(C(CO)C(C(CC(O)=O)O)O)=O,,,4,1,2,0,2
3689_1,,,,2,2,1,3
3691_0,,,,2,2,1,3
C(C(CO)C(C(CC(C)=O)=O)O)=O,,,4,1,2,0,2
3691_1,,,,2,2,1,3
3693_0,,,,2,2,1,3
C(CC(C=O)(C(C=O)CO)O)(C)=O,,,4,1,2,0,2
3693_1,,,,2,2,1,3
3695_0,,,,2,2,1,3
C(C(CO)C(C)(CC(C=O)=O)O)=O,,,4,1,2,0,2
3695_1,,,,2,2,1,3
3697_0,,,,2,2,1,3
C(C)(C(C(C=O)=O)C(CCO)O)=O,,,4,1,2,0,2
3697_1,,,,2,2,1,3
3699_0,,,,2,2,1,3
C(CC(CCO)O)(CC(C=O)=O)=O,,,4,1,1,0,1
3700_0,,,,2,2,1,3
3700_1,,,,2,2,1,3
3702_0,,,,2,2,1,3
C(CC(C=O)(C(C=O)CO)O)=O,,,4,1,3,0,3
3702_1,,,,2,2,1,3
3703_0,,,,2,2,1,3
3703_1,,,,2,2,1,3
3705_0,,,,2,2,1,3
C(C(C(C=O)=O)C(CCO)O)=O,,,4,1,2,0,2
3705_1,,,,2,2,1,3
3707_0,,,,2,2,1,3
C(C(CO)C(CC(C(C)=O)=O)O)=O,,,4,1,2,0,2
3707_1,,,,2,2,1,3
3709_0,,,,2,2,1,3
C(CC(C(C)=O)(C(C=O)CO)O)=O,,,4,1,2,0,2
3709_1,,,,2,2,1,3
3711_0,,,,2,2,1,3
C(C(CO)C(C(CC=O)=O)(C)O)=O,,,4,1,2,0,2
3711_1,,,,2,2,1,3
3713_0,,,,2,2,1,3
C(C(C(C(C)=O)=O)C(CCO)O)=O,,,4,1,2,0,2
3713_1,,,,2,2,1,3
3715_0,,,,2,2,1,3
C(CC(C(CC(CCO)O)=O)=O)=O,,,4,1,1,0,1
3717_0,,,,2,2,1,3
C(C(CO)C(C(C)=O)(C)O)=O,,,4,1,2,0,2
3717_1,,,,2,2,1,3
3719_0,,,,2,2,1,3
C(C(C)=O)(CC(CCO)O)=O,,,4,1,1,0,1
3721_0,,,,2,2,1,3
C(C(CO)C(C)(CC=O)O)=O,,,4,1,2,0,2
3721_1,,,,2,2,1,3
3723_0,,,,2,2,1,3
C(C(CO)C(CC(C)=O)O)=O,,,4,1,2,0,2
3723_1,,,,2,2,1,3
3725_0,,,,2,2,1,3
C(CC(CC(CCO)O)=O)=O,,,4,1,1,0,1
3727_0,,,,2,2,1,3
C(C(C(C)=O)C(CCO)O)=O,,,4,1,2,0,2
3727_1,,,,2,2,1,3
3729_0,,,,2,2,1,3
C(C(CO)C1(COC(C1)O)O)=O,,,4,1,2,0,2
3729_1,,,,2,2,1,3
3731_0,,,,2,2,1,3
C1(COC(C1C(CCO)O)O)=O,,,4,1,2,0,2
3731_1,,,,2,2,1,3
3733_0,,,,2,2,1,3
C1(C(C(CCO)O)OC(C1)O)=O,,,4,1,2,0,2
3733_1,,,,2,2,1,3
3735_0,,,,2,2,1,3
C(C(CO)C(C=CC(CO)=O)O)=O,,,4,1,2,0,2
3735_1,,,,2,2,1,3
3737_0,,,,2,2,1,3
C(C(CO)C(C=CC=O)(CO)O)=O,,,4,1,2,0,2
3737_1,,,,2,2,1,3
3739_0,,,,2,2,1,3
C(C=CC(C(C(CCO)O)O)=O)=O,,,4,1,2,0,2
3739_1,,,,2,2,1,3
3741_0,,,,2,2,1,3
C(C(CO)C(C(C=C)=O)O)=O,,,4,1,2,0,2
3741_1,,,,2,2,1,3
3743_0,,,,2,2,1,3
C(C(C=C)(C(C=O)CO)O)=O,,,4,1,2,0,2
3743_1,,,,2,2,1,3
3745_0,,,,2,2,1,3
C(C(CO)C(C=C)(CO)O)=O,,,4,1,2,0,2
3745_1,,,,2,2,1,3
3747_0,,,,2,2,1,3
C=CC(C(C(CCO)O)O)=O,,,4,1,2,0,2
3747_1,,,,2,2,1,3
3749_0,,,,2,2,1,3
C(C(CO)C(C=CC=O)O)=O,,,4,1,2,0,2
3749_1,,,,2,2,1,3
3751_0,,,,2,2,1,3
C(C(CO)C(C(C)O)O)=O,,,4,1,2,0,2
3751_1,,,,2,2,1,3
3753_0,,,,2,2,1,3
C(C(CO)C(C(O)=O)(CCO)O)=O,,,4,1,5,0,5
3753_1,,,,2,2,1,3
3755_0,,,,2,2,1,3
C(C(C(CO)C(CCO)O)=O)(O)=O,,,4,1,2,0,2
3755_1,,,,2,2,1,3
3757_0,,,,2,2,1,3
C(C(CO)C(CC(C(O)=O)O)O)=O,,,4,1,6,0,6
3757_1,,,,2,2,1,3
3759_0,,,,2,2,1,3
C(C(C(CCO)O)C(C(O)=O)O)=O,,,4,1,2,0,2
3759_1,,,,2,2,1,3
3761_0,,,,2,2,1,3
C(C(CO)C(C(CO)(CO)O)O)=O,,,4,1,2,0,2
3761_1,,,,2,2,1,3
3763_0,,,,2,2,1,3
C(C(CO)C(C(C=O)(CO)O)O)=O,,,4,1,2,0,2
3763_1,,,,2,2,1,3
3765_0,,,,2,2,1,3
C(C(CO)C1(COCC1O)O)=O,,,4,1,2,0,2
3765_1,,,,2,2,1,3
3767_0,,,,2,2,1,3
C1(C(C(CCO)O)OCC1O)=O,,,4,1,2,0,2
3767_1,,,,2,2,1,3
3769_0,,,,2,2,1,3
C(C(CO)C1(C(O)OCC1)O)=O,,,4,1,2,0,2
3769_1,,,,2,2,1,3
3771_0,,,,2,2,1,3
C1(C(O)OCC1C(CCO)O)=O,,,4,1,2,0,2
3771_1,,,,2,2,1,3
3773_0,,,,2,2,1,3
C(CC(C(C(C(O)=O)CO)=O)O)=O,,,4,1,5,0,5
3773_1,,,,2,2,1,3
3775_0,,,,2,2,1,3
C(C(C=O)C(C(CCO)=O)O)(O)=O,,,4,1,2,0,2
3775_1,,,,2,2,1,3
3777_0,,,,2,2,1,3
C(C(C=O)C(C=O)(CCO)O)(O)=O,,,4,1,2,0,2
3777_1,,,,2,2,1,3
3779_0,,,,2,2,1,3
C(C(C(C(C(C)O)O)=O)CO)(O)=O,,,4,1,2,0,2
3779_1,,,,2,2,1,3
3781_0,,,,2,2,1,3
C(C(C(C(CO)C(C)O)=O)O)(O)=O,,,4,1,2,0,2
3781_1,,,,2,2,1,3
3783_0,,,,2,2,1,3
C(C(C=O)C(CO)(CCO)O)(O)=O,,,4,1,2,0,2
3783_1,,,,2,2,1,3
3785_0,,,,2,2,1,3
C(C(C=O)C(C(C=O)O)O)(O)=O,,,4,1,2,0,2
3785_1,,,,2,2,1,3
3787_0,,,,2,2,1,3
C(C(C(CO)=O)C(CO)(C)O)(O)=O,,,4,1,5,0,5
3787_1,,,,2,2,1,3
3789_0,,,,2,2,1,3
C(C(C(CC(CO)(C)O)=O)O)(O)=O,,,4,1,4,0,4
3789_1,,,,2,2,1,3
3791_0,,,,2,2,1,3
C(CC(C(C(CO)(C)O)O)=O)(O)=O,,,4,1,4,0,4
3793_0,,,,2,2,1,3
C(CC(C(C(CO)=O)C(C)O)O)=O,,,4,1,6,0,6
3793_1,,,,2,2,1,3
3795_0,,,,2,2,1,3
C(CC(C(C(CC(C)O)=O)O)O)=O,,,4,1,4,0,4
3795_1,,,,2,2,1,3
3797_0,,,,2,2,1,3
C(C(C=O)C(CO)(CC(C)O)O)=O,,,4,1,2,0,2
3797_1,,,,2,2,1,3
3799_0,,,,2,2,1,3
C(C(C(CO)=O)C(C)O)(O)=O,,,4,1,6,0,6
3799_1,,,,2,2,1,3
3801_0,,,,2,2,1,3
C(C(C(CC(C)O)=O)O)(O)=O,,,4,1,4,0,4
3801_1,,,,2,2,1,3
3803_0,,,,2,2,1,3
C(CO)(C(C(C)O)C(C(O)=O)O)=O,,,4,1,5,0,5
3803_1,,,,2,2,1,3
3805_0,,,,2,2,1,3
C(C(C(C(O)=O)O)O)(CC(C)O)=O,,,4,1,5,0,5
3805_1,,,,2,2,1,3
3807_0,,,,2,2,1,3
C(CO)(C(C(C)O)C(C(C)O)O)=O,,,4,1,2,0,2
3807_1,,,,2,2,1,3
3809_0,,,,2,2,1,3
C(C(C(C(C)O)O)O)(CC(C)O)=O,,,4,1,2,0,2
3809_1,,,,2,2,1,3
3811_0,,,,2,2,1,3
C(CC(CC(C(C(C)O)O)=O)O)=O,,,4,1,4,0,4
3813_0,,,,2,2,1,3
C(C(C=O)C(C)(C(C(C)O)O)O)=O,,,4,1,2,0,2
3813_1,,,,2,2,1,3
3815_0,,,,2,2,1,3
C(CC(C(C(C)O)O)=O)(O)=O,,,4,1,4,0,4
3817_0,,,,2,2,1,3
C(CC(C(O)=O)O)(C(C(C)O)O)=O,,,4,1,4,0,4
3819_0,,,,2,2,1,3
C(C(C(C)O)O)(CC(C(C)O)O)=O,,,4,1,1,0,1
3821_0,,,,2,2,1,3
C(C(C(CC=O)O)C(C)(CO)O)=O,,,4,1,2,0,2
3821_1,,,,2,2,1,3
3823_0,,,,2,2,1,3
C(C(C=O)C(CC(C)(CO)O)O)=O,,,4,1,2,0,2
3823_1,,,,2,2,1,3
3825_0,,,,2,2,1,3
C(C(C=O)C(C)(CO)O)(O)=O,,,4,1,2,0,2
3825_1,,,,2,2,1,3
3827_0,,,,2,2,1,3
C(C(C(CO)(C)O)C(C(O)=O)O)=O,,,4,1,5,0,5
3827_1,,,,2,2,1,3
3829_0,,,,2,2,1,3
C(C(C(C(C)O)O)C(C)(CO)O)=O,,,4,1,2,0,2
3829_1,,,,2,2,1,3
3831_0,,,,2,2,1,3
C(C(C=O)C(C(CC=O)O)O)(O)=O,,,4,1,2,0,2
3831_1,,,,2,2,1,3
3833_0,,,,2,2,1,3
C(C(C=O)C(CC(C=O)O)O)(O)=O,,,4,1,2,0,2
3833_1,,,,2,2,1,3
3835_0,,,,2,2,1,3
C(C(C(C)O)C(CC(C)O)O)=O,,,4,1,2,0,2
3835_1,,,,2,2,1,3
3837_0,,,,2,2,1,3
C(C(C(C)O)C(C(C(C)O)O)O)=O,,,4,1,2,0,2
3837_1,,,,2,2,1,3
3839_0,,,,2,2,1,3
C(C(C(C)O)C(CC(CO)O)O)=O,,,4,1,2,0,2
3839_1,,,,2,2,1,3
3841_0,,,,2,2,1,3
C(C(C(CO)O)C(CC(C)O)O)=O,,,4,1,2,0,2
3841_1,,,,2,2,1,3
3843_0,,,,2,2,1,3
C(C(C(C)O)C(C=O)(CO)O)=O,,,4,1,5,0,5
3843_1,,,,2,2,1,3
3845_0,,,,2,2,1,3
C(C(C(C)O)C(C(CO)=O)O)=O,,,4,1,4,0,4
3845_1,,,,2,2,1,3
3847_0,,,,2,2,1,3
C(C(C(C(CC(C)O)O)O)=O)=O,,,4,1,2,0,2
3847_1,,,,2,2,1,3
3849_0,,,,2,2,1,3
C(C(C(C)O)C(C(C)=O)(CO)O)=O,,,4,1,2,0,2
3849_1,,,,2,2,1,3
3851_0,,,,2,2,1,3
C(C(C(C)O)C(C(CO)=O)(C)O)=O,,,4,1,2,0,2
3851_1,,,,2,2,1,3
3853_0,,,,2,2,1,3
C(C(C)=O)(C(C(CC(C)O)O)O)=O,,,4,1,2,0,2
3853_1,,,,2,2,1,3
3855_0,,,,2,2,1,3
C(C(CO)=O)(CC(CC(C)O)O)=O,,,4,1,1,0,1
3857_0,,,,2,2,1,3
C(C(C(C)O)C(C(C(C)O)=O)O)=O,,,4,1,2,0,2
3857_1,,,,2,2,1,3
3859_0,,,,2,2,1,3
C(C(C(C)O)C(C=O)(C(C)O)O)=O,,,4,1,5,0,5
3859_1,,,,2,2,1,3
3861_0,,,,2,2,1,3
C(C(C(C)O)C(CO)(C(C)O)O)=O,,,4,1,2,0,2
3861_1,,,,2,2,1,3
3863_0,,,,2,2,1,3
C(C(C(CC(C)O)O)O)(C(C)O)=O,,,4,1,2,0,2
3863_1,,,,2,2,1,3
3865_0,,,,2,2,1,3
C(C(C(CC=O)O)C(C)O)=O,,,4,1,2,0,2
3865_1,,,,2,2,1,3
3867_0,,,,2,2,1,3
C(C(C=O)C(CC(C)O)O)=O,,,4,1,2,0,2
3867_1,,,,2,2,1,3
3869_0,,,,2,2,1,3
C(C(C(C(CCO)O)O)C(C)O)=O,,,4,1,2,0,2
3869_1,,,,2,2,1,3
3871_0,,,,2,2,1,3
C(C(C(C)O)C(C(O)=O)(C)O)=O,,,4,1,2,0,2
3871_1,,,,2,2,1,3
3873_0,,,,2,2,1,3
C(C(CC(CC(C)O)O)=O)(O)=O,,,4,1,1,0,1
3875_0,,,,2,2,1,3
C(C(C=O)C(C)O)(O)=O,,,4,1,2,0,2
3875_1,,,,2,2,1,3
3877_0,,,,2,2,1,3
C(C(C(C)O)C(C(O)=O)O)=O,,,4,1,5,0,5
3877_1,,,,2,2,1,3
3879_0,,,,2,2,1,3
C(C(C(C(C(O)=O)O)O)C(C)O)=O,,,4,1,2,0,2
3879_1,,,,2,2,1,3
3880_0,,,,2,2,1,3
3880_1,,,,2,2,1,3
3882_0,,,,2,2,1,3
C(CC(C=O)(C(C=O)C(C)O)O)=O,,,4,1,2,0,2
3882_1,,,,2,2,1,3
3883_0,,,,2,2,1,3
3883_1,,,,2,2,1,3
3885_0,,,,2,2,1,3
C(C(C(C=O)=O)C(CC(C)O)O)=O,,,4,1,2,0,2
3885_1,,,,2,2,1,3
3887_0,,,,2,2,1,3
C(C(C(C)O)C(C(C)=O)(C)O)=O,,,4,1,2,0,2
3887_1,,,,2,2,1,3
3889_0,,,,2,2,1,3
C(C(C)=O)(CC(CC(C)O)O)=O,,,4,1,1,0,1
3891_0,,,,2,2,1,3
C(C(C(C)O)C(C)(CC=O)O)=O,,,4,1,2,0,2
3891_1,,,,2,2,1,3
3893_0,,,,2,2,1,3
C(C(C(CC(C)=O)O)C(C)O)=O,,,4,1,2,0,2
3893_1,,,,2,2,1,3
3895_0,,,,2,2,1,3
C(CC(CC(CC(C)O)O)=O)=O,,,4,1,1,0,1
3897_0,,,,2,2,1,3
C(C(C(C)=O)C(CC(C)O)O)=O,,,4,1,2,0,2
3897_1,,,,2,2,1,3
3899_0,,,,2,2,1,3
C(C(C(C)O)C1(COC(C1)O)O)=O,,,4,1,2,0,2
3899_1,,,,2,2,1,3
3901_0,,,,2,2,1,3
C1(COC(C1C(CC(C)O)O)O)=O,,,4,1,2,0,2
3901_1,,,,2,2,1,3
3903_0,,,,2,2,1,3
C1(C(C(CC(C)O)O)OC(C1)O)=O,,,4,1,2,0,2
3903_1,,,,2,2,1,3
3905_0,,,,2,2,1,3
C(C(C(C)O)C(C(C=C)=O)O)=O,,,4,1,2,0,2
3905_1,,,,2,2,1,3
3907_0,,,,2,2,1,3
C(C(C=C)(C(C=O)C(C)O)O)=O,,,4,1,2,0,2
3907_1,,,,2,2,1,3
3909_0,,,,2,2,1,3
C(C(C(C)O)C(C=C)(CO)O)=O,,,4,1,2,0,2
3909_1,,,,2,2,1,3
3911_0,,,,2,2,1,3
C=CC(C(C(CC(C)O)O)O)=O,,,4,1,2,0,2
3911_1,,,,2,2,1,3
3913_0,,,,2,2,1,3
C(C(C(C)O)C(C=CC=O)O)=O,,,4,1,2,0,2
3913_1,,,,2,2,1,3
3915_0,,,,2,2,1,3
C(C(C(C)O)C(C(C)O)O)=O,,,4,1,2,0,2
3915_1,,,,2,2,1,3
3917_0,,,,2,2,1,3
C(C(C(C)O)C1(COCC1O)O)=O,,,4,1,2,0,2
3917_1,,,,2,2,1,3
3919_0,,,,2,2,1,3
C1(C(C(CC(C)O)O)OCC1O)=O,,,4,1,2,0,2
3919_1,,,,2,2,1,3
3921_0,,,,2,2,1,3
C(C(C(C)O)C1(C(O)OCC1)O)=O,,,4,1,2,0,2
3921_1,,,,2,2,1,3
3923_0,,,,2,2,1,3
C1(C(O)OCC1C(CC(C)O)O)=O,,,4,1,2,0,2
3923_1,,,,2,2,1,3
3925_0,,,,2,2,1,3
C(C(C(C(C(CO)O)O)=O)O)(O)=O,,,4,1,4,0,4
3925_1,,,,2,2,1,3
3927_0,,,,2,2,1,3
C(C(C(C=O)=O)C(CO)O)(O)=O,,,4,1,3,0,3
3927_1,,,,2,2,1,3
3929_0,,,,2,2,1,3
C(C(C(CO)=O)C(CO)O)(O)=O,,,4,1,6,0,6
3929_1,,,,2,2,1,3
3930_0,,,,2,2,1,3
3930_1,,,,2,2,1,3
3931_0,,,,2,2,1,3
3933_0,,,,2,2,1,3
C(C(C(C(C(C(C)O)O)O)O)=O)=O,,,4,1,2,0,2
3933_1,,,,2,2,1,3
3935_0,,,,2,2,1,3
C(C(C=O)C(C(C(C)O)O)O)=O,,,4,1,2,0,2
3935_1,,,,2,2,1,3
3937_0,,,,2,2,1,3
C(C(CC(C(C(C)O)O)O)=O)(O)=O,,,4,1,1,0,1
3939_0,,,,2,2,1,3
C(C(C)=O)(CC(C(C(C)O)O)O)=O,,,4,1,1,0,1
3941_0,,,,2,2,1,3
C(CC(CC(C(C(C)O)O)O)=O)=O,,,4,1,1,0,1
3943_0,,,,2,2,1,3
C(C(C(C)=O)C(C(C(C)O)O)O)=O,,,4,1,2,0,2
3943_1,,,,2,2,1,3
3945_0,,,,2,2,1,3
C=CC(C(C(C(C(C)O)O)O)O)=O,,,4,1,2,0,2
3945_1,,,,2,2,1,3
3947_0,,,,2,2,1,3
C(C(C(CO)O)C(C=O)(CO)O)=O,,,4,1,5,0,5
3947_1,,,,2,2,1,3
3949_0,,,,2,2,1,3
C(C(C(CO)O)C(C(CO)=O)O)=O,,,4,1,4,0,4
3949_1,,,,2,2,1,3
3951_0,,,,2,2,1,3
C(C(C(C(CC(CO)O)O)O)=O)=O,,,4,1,2,0,2
3951_1,,,,2,2,1,3
3953_0,,,,2,2,1,3
C(C(C(CC=O)O)C(CO)O)=O,,,4,1,2,0,2
3953_1,,,,2,2,1,3
3955_0,,,,2,2,1,3
C(C(C=O)C(CC(CO)O)O)=O,,,4,1,2,0,2
3955_1,,,,2,2,1,3
3957_0,,,,2,2,1,3
C(C(C(CO)O)C(C(O)=O)(C)O)=O,,,4,1,2,0,2
3957_1,,,,2,2,1,3
3959_0,,,,2,2,1,3
C(C(CC(CC(CO)O)O)=O)(O)=O,,,4,1,1,0,1
3961_0,,,,2,2,1,3
C(C(C=O)C(CO)O)(O)=O,,,4,1,3,0,3
3961_1,,,,2,2,1,3
3963_0,,,,2,2,1,3
C(C(C(CO)O)C(C(O)=O)O)=O,,,4,1,6,0,6
3963_1,,,,2,2,1,3
3965_0,,,,2,2,1,3
C(C(C(CO)O)C(C(C)=O)(C)O)=O,,,4,1,2,0,2
3965_1,,,,2,2,1,3
3967_0,,,,2,2,1,3
C(C(C)=O)(CC(CC(CO)O)O)=O,,,4,1,1,0,1
3969_0,,,,2,2,1,3
C(C(C(CO)O)C(C)(CC=O)O)=O,,,4,1,2,0,2
3969_1,,,,2,2,1,3
3971_0,,,,2,2,1,3
C(C(C(CC(C)=O)O)C(CO)O)=O,,,4,1,2,0,2
3971_1,,,,2,2,1,3
3973_0,,,,2,2,1,3
C(CC(CC(CC(CO)O)O)=O)=O,,,4,1,1,0,1
3975_0,,,,2,2,1,3
C(C(C(C)=O)C(CC(CO)O)O)=O,,,4,1,2,0,2
3975_1,,,,2,2,1,3
3977_0,,,,2,2,1,3
C(C(C(CO)O)C(C(C=C)=O)O)=O,,,4,1,2,0,2
3977_1,,,,2,2,1,3
3979_0,,,,2,2,1,3
C(C(C=C)(C(C=O)C(CO)O)O)=O,,,4,1,2,0,2
3979_1,,,,2,2,1,3
3981_0,,,,2,2,1,3
C(C(C(CO)O)C(C=C)(CO)O)=O,,,4,1,2,0,2
3981_1,,,,2,2,1,3
3983_0,,,,2,2,1,3
C=CC(C(C(CC(CO)O)O)O)=O,,,4,1,2,0,2
3983_1,,,,2,2,1,3
3985_0,,,,2,2,1,3
C(C(C(CO)O)C(C=CC=O)O)=O,,,4,1,2,0,2
3985_1,,,,2,2,1,3
3987_0,,,,2,2,1,3
C(C(C(CO)O)C(C(C)O)O)=O,,,4,1,2,0,2
3987_1,,,,2,2,1,3
3989_0,,,,2,2,1,3
C(C(C=O)C(C=O)(C(CO)O)O)=O,,,4,1,2,0,2
3989_1,,,,2,2,1,3
3991_0,,,,2,2,1,3
C(C(C=O)C(C(C(CO)O)=O)O)=O,,,4,1,2,0,2
3991_1,,,,2,2,1,3
3993_0,,,,2,2,1,3
C(C(CO)(C(C(C=O)=O)O)O)=O,,,4,1,2,0,2
3993_1,,,,2,2,1,3
3995_0,,,,2,2,1,3
C(CO)(C(C(C(C=O)=O)O)O)=O,,,4,1,2,0,2
3995_1,,,,2,2,1,3
3997_0,,,,2,2,1,3
C(C)(C(CO)(C(C(C=O)=O)O)O)=O,,,4,1,4,0,4
3997_1,,,,2,2,1,3
3999_0,,,,2,2,1,3
C(CO)(C(C)(C(C(C=O)=O)O)O)=O,,,4,1,2,0,2
3999_1,,,,2,2,1,3
4001_0,,,,2,2,1,3
C(C(CO)(C(C(C(C)=O)=O)O)O)=O,,,4,1,2,0,2
4001_1,,,,2,2,1,3
4003_0,,,,2,2,1,3
C(CO)(C(C(C(C(C)=O)=O)O)O)=O,,,4,1,2,0,2
4003_1,,,,2,2,1,3
4005_0,,,,2,2,1,3
C(C(CO)(CC(C(CO)=O)=O)O)=O,,,4,1,1,0,1
4007_0,,,,2,2,1,3
C(CO)(C(CC(C(CO)=O)=O)O)=O,,,4,1,1,0,1
4009_0,,,,2,2,1,3
C(C(C(C(C=O)=O)O)O)(C(C)O)=O,,,4,1,2,0,2
4009_1,,,,2,2,1,3
4011_0,,,,2,2,1,3
C(C(C(C)O)(C(C(C=O)=O)O)O)=O,,,4,1,2,0,2
4011_1,,,,2,2,1,3
4013_0,,,,2,2,1,3
C(C(C(C(CO)(C(C)O)O)O)=O)=O,,,4,1,2,0,2
4013_1,,,,2,2,1,3
4014_0,,,,2,2,1,3
4014_1,,,,2,2,1,3
4016_0,,,,2,2,1,3
C(C(C(C(C(C)O)=O)O)O)(CO)=O,,,4,1,5,0,5
4016_1,,,,2,2,1,3
4017_0,,,,2,2,1,3
4017_1,,,,2,2,1,3
4019_0,,,,2,2,1,3
C(C(C=O)C(C=O)(CO)O)=O,,,4,1,2,0,2
4019_1,,,,2,2,1,3
4021_0,,,,2,2,1,3
C(C(C=O)C(C(CO)=O)O)=O,,,4,1,2,0,2
4021_1,,,,2,2,1,3
4023_0,,,,2,2,1,3
C(C(C(C(C(CCO)O)O)O)=O)=O,,,4,1,2,0,2
4023_1,,,,2,2,1,3
4025_0,,,,2,2,1,3
C(C(C)(C(C(C=O)=O)O)O)(O)=O,,,4,1,2,0,2
4025_1,,,,2,2,1,3
4027_0,,,,2,2,1,3
C(C(CO)(CC(C(O)=O)=O)O)=O,,,4,1,1,0,1
4029_0,,,,2,2,1,3
C(CO)(C(CC(C(O)=O)=O)O)=O,,,4,1,1,0,1
4031_0,,,,2,2,1,3
C(C(C(C=O)=O)O)(O)=O,,,4,1,2,0,2
4031_1,,,,2,2,1,3
4033_0,,,,2,2,1,3
C(C(C(C(C=O)=O)O)O)(O)=O,,,4,1,2,0,2
4033_1,,,,2,2,1,3
4035_0,,,,2,2,1,3
C(C(C(C(C(C=O)=O)O)O)O)(O)=O,,,4,1,2,0,2
4035_1,,,,2,2,1,3
4037_0,,,,2,2,1,3
C(CC(C(C(C(C=O)=O)O)O)=O)=O,,,4,1,2,0,2
4037_1,,,,2,2,1,3
4039_0,,,,2,2,1,3
C(CC(C=O)(C(C(C=O)=O)O)O)=O,,,4,1,2,0,2
4039_1,,,,2,2,1,3
4041_0,,,,2,2,1,3
C(C=O)(CC(C(C(C=O)=O)O)O)=O,,,4,1,2,0,2
4041_1,,,,2,2,1,3
4043_0,,,,2,2,1,3
C(C(C(C=O)=O)C(C=O)(CO)O)=O,,,4,1,2,0,2
4043_1,,,,2,2,1,3
4045_0,,,,2,2,1,3
C(C(C(C=O)=O)C(C(CO)=O)O)=O,,,4,1,2,0,2
4045_1,,,,2,2,1,3
4047_0,,,,2,2,1,3
C(C)(C(C)(C(C(C=O)=O)O)O)=O,,,4,1,2,0,2
4047_1,,,,2,2,1,3
4048_0,,,,2,2,1,3
4050_0,,,,2,2,1,3
C(CO)(C(CC(C(C)=O)=O)O)=O,,,4,1,3,0,3
4052_0,,,,2,2,1,3
C(CC(C)(C(C(C=O)=O)O)O)=O,,,4,1,2,0,2
4052_1,,,,2,2,1,3
4054_0,,,,2,2,1,3
C(C)(CC(C(C(C=O)=O)O)O)=O,,,4,1,2,0,2
4054_1,,,,2,2,1,3
4055_0,,,,2,2,1,3
4057_0,,,,2,2,1,3
C(CC(CC(C(CO)=O)O)=O)=O,,,4,1,4,0,4
4059_0,,,,2,2,1,3
C(C(CO)(C(C=O)C(C)=O)O)=O,,,4,1,2,0,2
4059_1,,,,2,2,1,3
4061_0,,,,2,2,1,3
C(C(C(C)=O)C(C(CO)=O)O)=O,,,4,1,3,0,3
4061_1,,,,2,2,1,3
4063_0,,,,2,2,1,3
C(C(C(C1(COC(C1)O)O)O)=O)=O,,,4,1,2,0,2
4063_1,,,,2,2,1,3
4065_0,,,,2,2,1,3
C(C(CO)(C1C(COC1O)=O)O)=O,,,4,1,2,0,2
4065_1,,,,2,2,1,3
4067_0,,,,2,2,1,3
C1(COC(C1C(C(CO)=O)O)O)=O,,,4,1,2,0,2
4067_1,,,,2,2,1,3
4069_0,,,,2,2,1,3
C(C(CO)(C1C(CC(O1)O)=O)O)=O,,,4,1,2,0,2
4069_1,,,,2,2,1,3
4071_0,,,,2,2,1,3
C(C(C1C(CC(O1)O)=O)O)(CO)=O,,,4,1,2,0,2
4071_1,,,,2,2,1,3
4073_0,,,,2,2,1,3
C=CC(C(C(C(C=O)=O)O)O)=O,,,4,1,2,0,2
4073_1,,,,2,2,1,3
4075_0,,,,2,2,1,3
C(C(C=C)(C(C(C=O)=O)O)O)=O,,,4,1,2,0,2
4075_1,,,,2,2,1,3
4077_0,,,,2,2,1,3
C(C(CO)(C(C(C=O)=O)O)O)=C,,,4,1,2,0,2
4077_1,,,,2,2,1,3
4078_0,,,,2,2,1,3
4078_1,,,,2,2,1,3
4080_0,,,,2,2,1,3
C(CO)(C(C(C(C=C)=O)O)O)=O,,,4,1,5,0,5
4080_1,,,,2,2,1,3
4082_0,,,,2,2,1,3
C(C(C(C(C=O)=O)O)O)=CC=O,,,4,1,2,0,2
4082_1,,,,2,2,1,3
4084_0,,,,2,2,1,3
C(C(C(C(C(C)O)O)O)=O)=O,,,4,1,5,0,5
4084_1,,,,2,2,1,3
4086_0,,,,2,2,1,3
C(C(C(C1(COCC1O)O)O)=O)=O,,,4,1,2,0,2
4086_1,,,,2,2,1,3
4088_0,,,,2,2,1,3
C(C(CO)(C1C(C(CO1)O)=O)O)=O,,,4,1,2,0,2
4088_1,,,,2,2,1,3
4090_0,,,,2,2,1,3
C(C(C1C(C(CO1)O)=O)O)(CO)=O,,,4,1,2,0,2
4090_1,,,,2,2,1,3
4092_0,,,,2,2,1,3
C(C(C(C1(C(O)OCC1)O)O)=O)=O,,,4,1,2,0,2
4092_1,,,,2,2,1,3
4094_0,,,,2,2,1,3
C(C(CO)(C1C(C(O)OC1)=O)O)=O,,,4,1,2,0,2
4094_1,,,,2,2,1,3
4096_0,,,,2,2,1,3
C(C(C1C(C(O)OC1)=O)O)(CO)=O,,,4,1,2,0,2
4096_1,,,,2,2,1,3
4098_0,,,,2,2,1,3
C(C(C=O)C(C(CO)=O)O)(O)=O,,,4,1,2,0,2
4098_1,,,,2,2,1,3
4100_0,,,,2,2,1,3
C(C(C(C(CC=O)O)=O)O)(O)=O,,,4,1,2,0,2
4100_1,,,,2,2,1,3
4102_0,,,,2,2,1,3
C(CC(C(C(C(C)=O)=O)O)O)=O,,,4,1,3,0,3
4102_1,,,,2,2,1,3
4104_0,,,,2,2,1,3
C(CC(CC(C(CO)=O)=O)O)=O,,,4,1,2,0,2
4106_0,,,,2,2,1,3
C(C(C=O)C(C(C)=O)(CO)O)=O,,,4,1,2,0,2
4106_1,,,,2,2,1,3
4108_0,,,,2,2,1,3
C(C(C=O)C(C(CO)=O)(C)O)=O,,,4,1,2,0,2
4108_1,,,,2,2,1,3
4110_0,,,,2,2,1,3
C(C(C)(C(C(C(C)=O)=O)O)O)(O)=O,,,4,1,2,0,2
4110_1,,,,2,2,1,3
4112_0,,,,2,2,1,3
C(C(C)(CC(C(CO)=O)=O)O)(O)=O,,,4,1,1,0,1
4114_0,,,,2,2,1,3
C(C)(C(CO)(CC(C(O)=O)=O)O)=O,,,4,1,3,0,3
4116_0,,,,2,2,1,3
C(CO)(C(C)(CC(C(O)=O)=O)O)=O,,,4,1,1,0,1
4118_0,,,,2,2,1,3
C(C(C(C(C)=O)=O)O)(O)=O,,,4,1,2,0,2
4118_1,,,,2,2,1,3
4120_0,,,,2,2,1,3
C(CC(C(CO)=O)=O)(O)=O,,,4,1,1,0,1
4122_0,,,,2,2,1,3
C(C(C(C(C(C)=O)=O)O)O)(O)=O,,,4,1,2,0,2
4122_1,,,,2,2,1,3
4124_0,,,,2,2,1,3
C(C(CC(C(CO)=O)=O)O)(O)=O,,,4,1,1,0,1
4126_0,,,,2,2,1,3
C(C)(C(C)(C(C(C(C)=O)=O)O)O)=O,,,4,1,2,0,2
4126_1,,,,2,2,1,3
4128_0,,,,2,2,1,3
C(C)(C(C)(CC(C(CO)=O)=O)O)=O,,,4,1,1,0,1
4130_0,,,,2,2,1,3
C(C)(C(CO)(CC(C(C)=O)=O)O)=O,,,4,1,1,0,1
4132_0,,,,2,2,1,3
C(CO)(C(C)(CC(C(C)=O)=O)O)=O,,,4,1,1,0,1
4134_0,,,,2,2,1,3
C(CC(C)(C(C(C(C)=O)=O)O)O)=O,,,4,1,2,0,2
4134_1,,,,2,2,1,3
4136_0,,,,2,2,1,3
C(CC(C)(CC(C(CO)=O)=O)O)=O,,,4,1,3,0,3
4138_0,,,,2,2,1,3
C(C)(CC(C(C(C(C)=O)=O)O)O)=O,,,4,1,2,0,2
4138_1,,,,2,2,1,3
4140_0,,,,2,2,1,3
C(C)(CC(CC(C(CO)=O)=O)O)=O,,,4,1,1,0,1
4142_0,,,,2,2,1,3
C(C)(C(CO)(CC(CC=O)=O)O)=O,,,4,1,1,0,1
4144_0,,,,2,2,1,3
C(CO)(C(C)(CC(CC=O)=O)O)=O,,,4,1,1,0,1
4146_0,,,,2,2,1,3
C(C(C(C)=O)C(C(C)=O)(CO)O)=O,,,4,1,2,0,2
4146_1,,,,2,2,1,3
4148_0,,,,2,2,1,3
C(C)(C(C=O)C(C(CO)=O)(C)O)=O,,,4,1,2,0,2
4148_1,,,,2,2,1,3
4150_0,,,,2,2,1,3
C=CC(C(C(C(C(C)=O)=O)O)O)=O,,,4,1,2,0,2
4150_1,,,,2,2,1,3
4152_0,,,,2,2,1,3
C=CC(C(CC(C(CO)=O)=O)O)=O,,,4,1,1,0,1
4154_0,,,,2,2,1,3
C(C(C=C)(C(C(C(C)=O)=O)O)O)=O,,,4,1,2,0,2
4154_1,,,,2,2,1,3
4156_0,,,,2,2,1,3
C(C(C=C)(CC(C(CO)=O)=O)O)=O,,,4,1,1,0,1
4158_0,,,,2,2,1,3
C(C(CO)(C(C(C(C)=O)=O)O)O)=C,,,4,1,2,0,2
4158_1,,,,2,2,1,3
4160_0,,,,2,2,1,3
C(C(CO)(CC(C(CO)=O)=O)O)=C,,,4,1,1,0,1
4162_0,,,,2,2,1,3
C(C)(C(CO)(C(C(C=C)=O)O)O)=O,,,4,1,4,0,4
4162_1,,,,2,2,1,3
4164_0,,,,2,2,1,3
C(CO)(C(C)(C(C(C=C)=O)O)O)=O,,,4,1,3,0,3
4164_1,,,,2,2,1,3
4166_0,,,,2,2,1,3
C(C(C(C(C(C)=O)=O)O)O)=CC=O,,,4,1,2,0,2
4166_1,,,,2,2,1,3
4168_0,,,,2,2,1,3
C(C(CC(C(CO)=O)=O)O)=CC=O,,,4,1,1,0,1
4170_0,,,,2,2,1,3
C(C(C)=O)(C(C(C(C)O)O)O)=O,,,4,1,2,0,2
4170_1,,,,2,2,1,3
4172_0,,,,2,2,1,3
C(C(CO)=O)(CC(C(C)O)O)=O,,,4,1,1,0,1
4174_0,,,,2,2,1,3
C(C(C(O)=O)O)(CC(CO)=O)=O,,,4,1,2,0,2
4174_1,,,,2,2,1,3
4176_0,,,,2,2,1,3
C(C(C(CO)=O)C(CO)=O)(O)=O,,,4,1,2,0,2
4176_1,,,,2,2,1,3
4178_0,,,,2,2,1,3
C(C(C(C(C(C)=O)O)=O)O)(O)=O,,,4,1,2,0,2
4178_1,,,,2,2,1,3
4180_0,,,,2,2,1,3
C(CC(C(C(CO)=O)O)=O)(O)=O,,,4,1,1,0,1
4182_0,,,,2,2,1,3
C(C(C=O)C(C(C(C)O)=O)O)=O,,,4,1,3,0,3
4182_1,,,,2,2,1,3
4184_0,,,,2,2,1,3
C(C(C=O)C(C=O)(C(C)O)O)=O,,,4,1,2,0,2
4184_1,,,,2,2,1,3
4186_0,,,,2,2,1,3
C(C(CC(C(O)=O)=O)O)(C(C)O)=O,,,4,1,1,0,1
4188_0,,,,2,2,1,3
C(C(C(C)O)(CC(C(O)=O)=O)O)=O,,,4,1,1,0,1
4190_0,,,,2,2,1,3
C(C(CC(C(C)=O)=O)O)(C(C)O)=O,,,4,1,1,0,1
4191_0,,,,2,2,1,3
4193_0,,,,2,2,1,3
C(CC(C(C(C)O)=O)O)(CC=O)=O,,,4,1,2,0,2
4194_0,,,,2,2,1,3
4196_0,,,,2,2,1,3
C(C)(C(C=O)C(C(C(C)O)=O)O)=O,,,4,1,2,0,2
4196_1,,,,2,2,1,3
4198_0,,,,2,2,1,3
C(C(C(C)O)(C(C=O)C(C)=O)O)=O,,,4,1,2,0,2
4198_1,,,,2,2,1,3
4200_0,,,,2,2,1,3
C(C(C(C(C=C)=O)O)O)(C(C)O)=O,,,4,1,4,0,4
4200_1,,,,2,2,1,3
4201_0,,,,2,2,1,3
4201_1,,,,2,2,1,3
4203_0,,,,2,2,1,3
C(CC(C(C(C(C)O)=O)O)O)=O,,,4,1,4,0,4
4203_1,,,,2,2,1,3
4205_0,,,,2,2,1,3
C(C(C=O)C(CO)(C(C)O)O)=O,,,4,1,2,0,2
4205_1,,,,2,2,1,3
4207_0,,,,2,2,1,3
C(C(C)(C(C(C(C)O)=O)O)O)(O)=O,,,4,1,3,0,3
4207_1,,,,2,2,1,3
4209_0,,,,2,2,1,3
C(C(CC(CO)(C(C)O)O)=O)(O)=O,,,4,1,1,0,1
4211_0,,,,2,2,1,3
C(C(C(C(C)O)=O)O)(O)=O,,,4,1,4,0,4
4211_1,,,,2,2,1,3
4212_0,,,,2,2,1,3
4212_1,,,,2,2,1,3
4214_0,,,,2,2,1,3
C(C)(C(C)(C(C(C(C)O)=O)O)O)=O,,,4,1,2,0,2
4214_1,,,,2,2,1,3
4216_0,,,,2,2,1,3
C(C(C)=O)(CC(CO)(C(C)O)O)=O,,,4,1,2,0,2
4218_0,,,,2,2,1,3
C(CC(C)(C(C(C(C)O)=O)O)O)=O,,,4,1,2,0,2
4218_1,,,,2,2,1,3
4220_0,,,,2,2,1,3
C(C(C(CC(C)=O)O)O)(C(C)O)=O,,,4,1,2,0,2
4220_1,,,,2,2,1,3
4222_0,,,,2,2,1,3
C(CC(CC(CO)(C(C)O)O)=O)=O,,,4,1,2,0,2
4224_0,,,,2,2,1,3
C(C(C(C)=O)C(CO)(C(C)O)O)=O,,,4,1,2,0,2
4224_1,,,,2,2,1,3
4225_0,,,,2,2,1,3
4225_1,,,,2,2,1,3
4227_0,,,,2,2,1,3
C(C(C=C)(C(C(C(C)O)=O)O)O)=O,,,4,1,2,0,2
4227_1,,,,2,2,1,3
4229_0,,,,2,2,1,3
C(C(C(C=C)(CO)O)O)(C(C)O)=O,,,4,1,2,0,2
4229_1,,,,2,2,1,3
4231_0,,,,2,2,1,3
C=CC(C(C(CO)(C(C)O)O)O)=O,,,4,1,3,0,3
4231_1,,,,2,2,1,3
4233_0,,,,2,2,1,3
C(C(C(C=CC=O)O)O)(C(C)O)=O,,,4,1,2,0,2
4233_1,,,,2,2,1,3
4235_0,,,,2,2,1,3
C(C(C(C(C)O)O)O)(C(C)O)=O,,,4,1,2,0,2
4235_1,,,,2,2,1,3
4237_0,,,,2,2,1,3
C(C(C=O)C(CC=O)O)=O,,,4,1,2,0,2
4237_1,,,,2,2,1,3
4239_0,,,,2,2,1,3
C(C(C=O)C(CO)(C(C=O)O)O)=O,,,4,1,2,0,2
4239_1,,,,2,2,1,3
4241_0,,,,2,2,1,3
C(C(C=O)C(C(C(CO)=O)O)O)=O,,,4,1,2,0,2
4241_1,,,,2,2,1,3
4243_0,,,,2,2,1,3
C(CC(C(C(C(C=O)O)=O)O)O)=O,,,4,1,2,0,2
4243_1,,,,2,2,1,3
4245_0,,,,2,2,1,3
C(C(C=O)C(C(CCO)O)O)=O,,,4,1,3,0,3
4245_1,,,,2,2,1,3
4247_0,,,,2,2,1,3
C(C(C=O)C(C(O)=O)(C)O)=O,,,4,1,2,0,2
4247_1,,,,2,2,1,3
4248_0,,,,2,2,1,3
4250_0,,,,2,2,1,3
C(C(C=O)C(O)=O)=O,,,4,1,2,0,2
4250_1,,,,2,2,1,3
4252_0,,,,2,2,1,3
C(C(C=O)C(CO)(CC(O)=O)O)=O,,,4,1,2,0,2
4252_1,,,,2,2,1,3
4253_0,,,,2,2,1,3
4253_1,,,,2,2,1,3
4254_0,,,,2,2,1,3
4254_1,,,,2,2,1,3
4256_0,,,,2,2,1,3
C(C(C=O)C(C)(C(C(O)=O)O)O)=O,,,4,1,2,0,2
4256_1,,,,2,2,1,3
4257_0,,,,2,2,1,3
4259_0,,,,2,2,1,3
C(C(C=O)C(C(O)=O)O)=O,,,4,1,2,0,2
4259_1,,,,2,2,1,3
4261_0,,,,2,2,1,3
C(C(C=O)C(C(C(O)=O)O)O)=O,,,4,1,2,0,2
4261_1,,,,2,2,1,3
4263_0,,,,2,2,1,3
C(C(C=O)C(C(CC(O)=O)O)O)=O,,,4,1,2,0,2
4263_1,,,,2,2,1,3
4265_0,,,,2,2,1,3
C(C(C=O)C(C(CC(C)=O)=O)O)=O,,,4,1,2,0,2
4265_1,,,,2,2,1,3
4267_0,,,,2,2,1,3
C(C(C=O)C(C=O)(CC(C)=O)O)=O,,,4,1,2,0,2
4267_1,,,,2,2,1,3
4269_0,,,,2,2,1,3
C(C(C=O)C(C)(CC(C=O)=O)O)=O,,,4,1,2,0,2
4269_1,,,,2,2,1,3
4271_0,,,,2,2,1,3
C(CC(C(C(C)=O)C(C=O)=O)O)=O,,,4,1,2,0,2
4271_1,,,,2,2,1,3
4273_0,,,,2,2,1,3
C(CC(CC(CC(C=O)=O)=O)O)=O,,,4,1,1,0,1
4275_0,,,,2,2,1,3
C(C(C=O)C(C(CC=O)=O)O)=O,,,4,1,2,0,2
4275_1,,,,2,2,1,3
4277_0,,,,2,2,1,3
C(C(C=O)C(C=O)(CC=O)O)=O,,,4,1,2,0,2
4277_1,,,,2,2,1,3
4279_0,,,,2,2,1,3
C(C(C=O)C(CC(C=O)=O)O)=O,,,4,1,2,0,2
4279_1,,,,2,2,1,3
4281_0,,,,2,2,1,3
C(C(C(C=O)=O)C(CC=O)O)=O,,,4,1,2,0,2
4281_1,,,,2,2,1,3
4283_0,,,,2,2,1,3
C(C(C=O)C(CC(C(C)=O)=O)O)=O,,,4,1,2,0,2
4283_1,,,,2,2,1,3
4285_0,,,,2,2,1,3
C(C(C=O)C(C(C)=O)(CC=O)O)=O,,,4,1,2,0,2
4285_1,,,,2,2,1,3
4287_0,,,,2,2,1,3
C(CC(C(C)(C(C=O)C=O)O)=O)=O,,,4,1,2,0,2
4287_1,,,,2,2,1,3
4289_0,,,,2,2,1,3
C(CC(C(C=O)C(C(C)=O)=O)O)=O,,,4,1,2,0,2
4289_1,,,,2,2,1,3
4291_0,,,,2,2,1,3
C(CC(C(CC(CC=O)O)=O)=O)=O,,,4,1,1,0,1
4293_0,,,,2,2,1,3
C(C(C=O)C(C(C)=O)(C)O)=O,,,4,1,2,0,2
4293_1,,,,2,2,1,3
4295_0,,,,2,2,1,3
C(CC(CC(C(C)=O)=O)O)=O,,,4,1,4,0,4
4297_0,,,,2,2,1,3
C(C(C=O)C(C)(CC=O)O)=O,,,4,1,2,0,2
4297_1,,,,2,2,1,3
4299_0,,,,2,2,1,3
C(C(C=O)C(CC(C)=O)O)=O,,,4,1,2,0,2
4299_1,,,,2,2,1,3
4301_0,,,,2,2,1,3
C(CC(CC(CC=O)O)=O)=O,,,4,1,1,0,1
4303_0,,,,2,2,1,3
C(CC(C(C=O)C(C)=O)O)=O,,,4,1,2,0,2
4303_1,,,,2,2,1,3
4305_0,,,,2,2,1,3
C(C(C=O)C1(COC(C1)O)O)=O,,,4,1,2,0,2
4305_1,,,,2,2,1,3
4307_0,,,,2,2,1,3
C(CC(C1C(COC1O)=O)O)=O,,,4,1,2,0,2
4307_1,,,,2,2,1,3
4309_0,,,,2,2,1,3
C(CC(C1C(CC(O1)O)=O)O)=O,,,4,1,2,0,2
4309_1,,,,2,2,1,3
4311_0,,,,2,2,1,3
C(C(C=O)C(C=CC(CO)=O)O)=O,,,4,1,2,0,2
4311_1,,,,2,2,1,3
4313_0,,,,2,2,1,3
C(C(C=O)C(C=CC=O)(CO)O)=O,,,4,1,2,0,2
4313_1,,,,2,2,1,3
4315_0,,,,2,2,1,3
C(CC(C(C(C=CC=O)=O)O)O)=O,,,4,1,2,0,2
4315_1,,,,2,2,1,3
4317_0,,,,2,2,1,3
C(C(C=O)C(C(C=C)=O)O)=O,,,4,1,3,0,3
4317_1,,,,2,2,1,3
4319_0,,,,2,2,1,3
C(C(C=O)C(C=O)(C=C)O)=O,,,4,1,2,0,2
4319_1,,,,2,2,1,3
4321_0,,,,2,2,1,3
C(C(C=O)C(C=C)(CO)O)=O,,,4,1,2,0,2
4321_1,,,,2,2,1,3
4323_0,,,,2,2,1,3
C(CC(C(C(C=C)=O)O)O)=O,,,4,1,2,0,2
4323_1,,,,2,2,1,3
4325_0,,,,2,2,1,3
C(C(C=O)C(C=CC=O)O)=O,,,4,1,3,0,3
4325_1,,,,2,2,1,3
4327_0,,,,2,2,1,3
C(C(C=O)C(C(C)O)O)=O,,,4,1,2,0,2
4327_1,,,,2,2,1,3
4329_0,,,,2,2,1,3
C(C(C=O)C(C(O)=O)(CCO)O)=O,,,4,1,2,0,2
4329_1,,,,2,2,1,3
4331_0,,,,2,2,1,3
C(CC(C(C(C(O)=O)=O)CO)O)=O,,,4,1,5,0,5
4331_1,,,,2,2,1,3
4333_0,,,,2,2,1,3
C(C(C=O)C(CC(C(O)=O)O)O)=O,,,4,1,2,0,2
4333_1,,,,2,2,1,3
4335_0,,,,2,2,1,3
C(CC(C(C=O)C(C(O)=O)O)O)=O,,,4,1,2,0,2
4335_1,,,,2,2,1,3
4337_0,,,,2,2,1,3
C(C(C=O)C(C(CO)(CO)O)O)=O,,,4,1,2,0,2
4337_1,,,,2,2,1,3
4339_0,,,,2,2,1,3
C(C(C=O)C(C(C=O)(CO)O)O)=O,,,4,1,2,0,2
4339_1,,,,2,2,1,3
4341_0,,,,2,2,1,3
C(C(C=O)C(C(C=CC(C)=O)=O)O)=O,,,4,1,2,0,2
4341_1,,,,2,2,1,3
4343_0,,,,2,2,1,3
C(C(C=O)C(C=O)(C=CC(C)=O)O)=O,,,4,1,2,0,2
4343_1,,,,2,2,1,3
4345_0,,,,2,2,1,3
C(C(C=O)C(C=CC(C=O)=O)(C)O)=O,,,4,1,2,0,2
4345_1,,,,2,2,1,3
4347_0,,,,2,2,1,3
C(CC(CC(C=CC(C=O)=O)=O)O)=O,,,4,1,1,0,1
4349_0,,,,2,2,1,3
C(C(C=O)C(C(C=CCC=O)=O)O)=O,,,4,1,2,0,2
4349_1,,,,2,2,1,3
4351_0,,,,2,2,1,3
C(C(C=O)C(C=O)(C=CCC=O)O)=O,,,4,1,2,0,2
4351_1,,,,2,2,1,3
4353_0,,,,2,2,1,3
C(C(C=O)C(CC=CC(C=O)=O)O)=O,,,4,1,2,0,2
4353_1,,,,2,2,1,3
4355_0,,,,2,2,1,3
C(C(C=CC(C=O)=O)C(CC=O)O)=O,,,4,1,1,0,1
4357_0,,,,2,2,1,3
C(C(C=O)C(C=CC(C(C)=O)=O)O)=O,,,4,1,2,0,2
4357_1,,,,2,2,1,3
4359_0,,,,2,2,1,3
C(C(C=O)C(C(C)=O)(C=CC=O)O)=O,,,4,1,2,0,2
4359_1,,,,2,2,1,3
4361_0,,,,2,2,1,3
C(C(C=O)C(C(C=CC=O)=O)(C)O)=O,,,4,1,2,0,2
4361_1,,,,2,2,1,3
4363_0,,,,2,2,1,3
C(CC(CC(C(C=CC=O)=O)=O)O)=O,,,4,1,1,0,1
4365_0,,,,2,2,1,3
C(C(C=O)C(C=CC(CC=O)=O)O)=O,,,4,1,2,0,2
4365_1,,,,2,2,1,3
4367_0,,,,2,2,1,3
C(C(C=O)C(C=CC=O)(CC=O)O)=O,,,4,1,2,0,2
4367_1,,,,2,2,1,3
4369_0,,,,2,2,1,3
C(C(C=O)C(CC(C=CC=O)=O)O)=O,,,4,1,2,0,2
4369_1,,,,2,2,1,3
4371_0,,,,2,2,1,3
C(C(C(C=CC=O)=O)C(CC=O)O)=O,,,4,1,2,0,2
4371_1,,,,2,2,1,3
4373_0,,,,2,2,1,3
C(C(C=O)C(C(CC(C=C)=O)=O)O)=O,,,4,1,2,0,2
4373_1,,,,2,2,1,3
4375_0,,,,2,2,1,3
C(C(C=O)C(C=O)(CC(C=C)=O)O)=O,,,4,1,2,0,2
4375_1,,,,2,2,1,3
4377_0,,,,2,2,1,3
C(C(C=O)C(C=C)(CC(C=O)=O)O)=O,,,4,1,2,0,2
4377_1,,,,2,2,1,3
4379_0,,,,2,2,1,3
C(CC(C(C(C=O)=O)C(C=C)=O)O)=O,,,4,1,2,0,2
4379_1,,,,2,2,1,3
4381_0,,,,2,2,1,3
C(C(C=O)C(CC(C(C=C)=O)=O)O)=O,,,4,1,2,0,2
4381_1,,,,2,2,1,3
4383_0,,,,2,2,1,3
C(C(C=O)C(C(C=C)=O)(CC=O)O)=O,,,4,1,2,0,2
4383_1,,,,2,2,1,3
4385_0,,,,2,2,1,3
C(C(C=O)C(C(CC=O)=O)(C=C)O)=O,,,4,1,2,0,2
4385_1,,,,2,2,1,3
4387_0,,,,2,2,1,3
C(C(C(C(C=C)=O)=O)C(CC=O)O)=O,,,4,1,2,0,2
4387_1,,,,2,2,1,3
4389_0,,,,2,2,1,3
C(C(C=O)C(C(CC=CC=O)=O)O)=O,,,4,1,2,0,2
4389_1,,,,2,2,1,3
4391_0,,,,2,2,1,3
C(C(C=O)C(C=O)(CC=CC=O)O)=O,,,4,1,2,0,2
4391_1,,,,2,2,1,3
4393_0,,,,2,2,1,3
C(C(C=O)C(C=CCC(C=O)=O)O)=O,,,4,1,2,0,2
4393_1,,,,2,2,1,3
4395_0,,,,2,2,1,3
C(CC(C(C=CC=O)C(C=O)=O)O)=O,,,4,1,1,0,1
4397_0,,,,2,2,1,3
C(C(C=O)C1(COCC1O)O)=O,,,4,1,2,0,2
4397_1,,,,2,2,1,3
4399_0,,,,2,2,1,3
C(CC(C1C(C(CO1)O)=O)O)=O,,,4,1,2,0,2
4399_1,,,,2,2,1,3
4401_0,,,,2,2,1,3
C(C(C=O)C1(C(O)OCC1)O)=O,,,4,1,2,0,2
4401_1,,,,2,2,1,3
4403_0,,,,2,2,1,3
C(CC(C1C(C(O)OC1)=O)O)=O,,,4,1,3,0,3
4403_1,,,,2,2,1,3
4405_0,,,,2,2,1,3
C(C(C(C(C=O)O)=O)O)(O)=O,,,4,1,2,0,2
4405_1,,,,2,2,1,3
4407_0,,,,2,2,1,3
C(C(C(C(C(C(O)=O)O)O)=O)O)=O,,,4,1,2,0,2
4407_1,,,,2,2,1,3
4409_0,,,,2,2,1,3
C(C(C(C(C(C(C)O)O)O)=O)O)=O,,,4,1,2,0,2
4409_1,,,,2,2,1,3
4411_0,,,,2,2,1,3
C(C(CC(C(CCO)O)O)=O)(O)=O,,,4,1,1,0,1
4413_0,,,,2,2,1,3
C(C(C)=O)(CC(C(CCO)O)O)=O,,,4,1,2,0,2
4415_0,,,,2,2,1,3
C(CC(CC(C(CCO)O)O)=O)=O,,,4,1,2,0,2
4417_0,,,,2,2,1,3
C(C(C(C)=O)C(C(CCO)O)O)=O,,,4,1,2,0,2
4417_1,,,,2,2,1,3
4419_0,,,,2,2,1,3
C=CC(C(C(C(CCO)O)O)O)=O,,,4,1,3,0,3
4419_1,,,,2,2,1,3
4421_0,,,,2,2,1,3
C(C(C)(CC(C(O)=O)=O)O)(O)=O,,,4,1,1,0,1
4423_0,,,,2,2,1,3
C(CC(C(O)=O)=O)(O)=O,,,4,1,1,0,1
4425_0,,,,2,2,1,3
C(C(CC(C(O)=O)=O)O)(O)=O,,,4,1,1,0,1
4427_0,,,,2,2,1,3
C(C(C(CC(C(O)=O)=O)O)O)(O)=O,,,4,1,1,0,1
4429_0,,,,2,2,1,3
C(CC(C(CC(C(O)=O)=O)O)=O)=O,,,4,1,1,0,1
4431_0,,,,2,2,1,3
C(CC(C=O)(CC(C(O)=O)=O)O)=O,,,4,1,1,0,1
4433_0,,,,2,2,1,3
C(C(CC(CC(C=O)=O)O)=O)(O)=O,,,4,1,1,0,1
4435_0,,,,2,2,1,3
C(C(C(C=O)=O)C(C(O)=O)(C)O)=O,,,4,1,2,0,2
4435_1,,,,2,2,1,3
4437_0,,,,2,2,1,3
C(C)(C(C)(CC(C(O)=O)=O)O)=O,,,4,1,1,0,1
4439_0,,,,2,2,1,3
C(C(C)(CC(C(C)=O)=O)O)(O)=O,,,4,1,1,0,1
4441_0,,,,2,2,1,3
C(CC(C)(CC(C(O)=O)=O)O)=O,,,4,1,1,0,1
4443_0,,,,2,2,1,3
C(C)(CC(CC(C(O)=O)=O)O)=O,,,4,1,1,0,1
4445_0,,,,2,2,1,3
C(C(C)(CC(CC=O)=O)O)(O)=O,,,4,1,1,0,1
4447_0,,,,2,2,1,3
C(C(C)(C(C=O)C(C)=O)O)(O)=O,,,4,1,2,0,2
4447_1,,,,2,2,1,3
4449_0,,,,2,2,1,3
C(C(CC1(COC(C1)O)O)=O)(O)=O,,,4,1,1,0,1
4451_0,,,,2,2,1,3
C(C(C)(C1C(COC1O)=O)O)(O)=O,,,4,1,2,0,2
4451_1,,,,2,2,1,3
4453_0,,,,2,2,1,3
C(C(C)(C1C(CC(O1)O)=O)O)(O)=O,,,4,1,2,0,2
4453_1,,,,2,2,1,3
4455_0,,,,2,2,1,3
C=CC(C(CC(C(O)=O)=O)O)=O,,,4,1,1,0,1
4457_0,,,,2,2,1,3
C(C(C=C)(CC(C(O)=O)=O)O)=O,,,4,1,1,0,1
4459_0,,,,2,2,1,3
C(C(CO)(CC(C(O)=O)=O)O)=C,,,4,1,1,0,1
4461_0,,,,2,2,1,3
C(C(C)(C(C(C=C)=O)O)O)(O)=O,,,4,1,3,0,3
4461_1,,,,2,2,1,3
4463_0,,,,2,2,1,3
C(C(CC(C(O)=O)=O)O)=CC=O,,,4,1,1,0,1
4465_0,,,,2,2,1,3
C(C(CC(C(C)O)O)=O)(O)=O,,,4,1,1,0,1
4467_0,,,,2,2,1,3
C(C(CC1(COCC1O)O)=O)(O)=O,,,4,1,1,0,1
4469_0,,,,2,2,1,3
C(C(C)(C1C(C(CO1)O)=O)O)(O)=O,,,4,1,2,0,2
4469_1,,,,2,2,1,3
4471_0,,,,2,2,1,3
C(C(CC1(C(O)OCC1)O)=O)(O)=O,,,4,1,1,0,1
4473_0,,,,2,2,1,3
C(C(C)(C1C(C(O)OC1)=O)O)(O)=O,,,4,1,2,0,2
4473_1,,,,2,2,1,3
4475_0,,,,2,2,1,3
C(C(C(O)=O)C(CO)=O)(O)=O,,,4,1,2,0,2
4475_1,,,,2,2,1,3
4477_0,,,,2,2,1,3
C(CC(C(C(O)=O)O)=O)(O)=O,,,4,1,3,0,3
4477_1,,,,2,2,1,3
4478_0,,,,2,2,1,3
4480_0,,,,2,2,1,3
C(C(C(CO)=O)C(C(O)=O)O)(O)=O,,,4,1,4,0,4
4480_1,,,,2,2,1,3
4482_0,,,,2,2,1,3
C(C(C(CC(C(O)=O)O)=O)O)(O)=O,,,4,1,3,0,3
4482_1,,,,2,2,1,3
4484_0,,,,2,2,1,3
C(CC(C(C(C(O)=O)O)O)=O)(O)=O,,,4,1,3,0,3
4486_0,,,,2,2,1,3
C(C(C(C)=O)C(C=O)=O)(O)=O,,,4,1,2,0,2
4486_1,,,,2,2,1,3
4488_0,,,,2,2,1,3
C(CC(CC(C=O)=O)=O)(O)=O,,,4,1,1,0,1
4490_0,,,,2,2,1,3
C(C(C(O)=O)C(C=O)=O)=O,,,4,1,2,0,2
4490_1,,,,2,2,1,3
4492_0,,,,2,2,1,3
C(C(C(O)=O)C(C(C)=O)=O)=O,,,4,1,2,0,2
4492_1,,,,2,2,1,3
4494_0,,,,2,2,1,3
C(CC(C(CC(O)=O)=O)=O)=O,,,4,1,1,0,1
4496_0,,,,2,2,1,3
C(CC(C(C)=O)=O)(O)=O,,,4,1,4,0,4
4498_0,,,,2,2,1,3
C(CC(CC(O)=O)=O)=O,,,4,1,1,0,1
4500_0,,,,2,2,1,3
C(C(C(O)=O)C(C)=O)=O,,,4,1,2,0,2
4500_1,,,,2,2,1,3
4502_0,,,,2,2,1,3
C(C1C(COC1O)=O)(O)=O,,,4,1,2,0,2
4502_1,,,,2,2,1,3
4504_0,,,,2,2,1,3
C(C1C(CC(O1)O)=O)(O)=O,,,4,1,2,0,2
4504_1,,,,2,2,1,3
4506_0,,,,2,2,1,3
C(C1C(COC(C1O)O)=O)(O)=O,,,4,1,2,0,2
4506_1,,,,2,2,1,3
4508_0,,,,2,2,1,3
C(C1C(CC(C(O1)O)O)=O)(O)=O,,,4,1,2,0,2
4508_1,,,,2,2,1,3
4510_0,,,,2,2,1,3
C(C(C(C=CC=O)=O)O)(O)=O,,,4,1,2,0,2
4510_1,,,,2,2,1,3
4512_0,,,,2,2,1,3
C(C(C(C=C)=O)O)(O)=O,,,4,1,2,0,2
4512_1,,,,2,2,1,3
4514_0,,,,2,2,1,3
C(C(C(C=O)=O)CC(C=O)O)(O)=O,,,4,1,1,0,1
4516_0,,,,2,2,1,3
C(C(C(C(C)O)=O)C(C=O)=O)(O)=O,,,4,1,2,0,2
4516_1,,,,2,2,1,3
4518_0,,,,2,2,1,3
C(C(C=O)C(C(C(C)=O)=O)O)(O)=O,,,4,1,2,0,2
4518_1,,,,2,2,1,3
4520_0,,,,2,2,1,3
C(CC(C(C(CC=O)O)=O)=O)(O)=O,,,4,1,1,0,1
4522_0,,,,2,2,1,3
C(C(C=O)C(C(C(C)O)=O)=O)(O)=O,,,4,1,2,0,2
4522_1,,,,2,2,1,3
4524_0,,,,2,2,1,3
C(C(C(C(CC(C)=O)=O)=O)O)(O)=O,,,4,1,2,0,2
4524_1,,,,2,2,1,3
4526_0,,,,2,2,1,3
C(C(C(C)=O)C(C(CO)=O)=O)(O)=O,,,4,1,2,0,2
4526_1,,,,2,2,1,3
4528_0,,,,2,2,1,3
C(CC(O)=O)(CC(C(CO)=O)=O)=O,,,4,1,1,0,1
4530_0,,,,2,2,1,3
C(C(C(C)=O)C(C(C=O)=O)O)(O)=O,,,4,1,2,0,2
4530_1,,,,2,2,1,3
4532_0,,,,2,2,1,3
C(CC(CC(C(C=O)=O)O)=O)(O)=O,,,4,1,1,0,1
4534_0,,,,2,2,1,3
C(C(C(C(CCC=O)=O)=O)O)(O)=O,,,4,1,2,0,2
4534_1,,,,2,2,1,3
4536_0,,,,2,2,1,3
C(C(C(C(CO)=O)=O)CC=O)(O)=O,,,4,1,1,0,1
4538_0,,,,2,2,1,3
C(C(C=O)CC(C(CO)=O)=O)(O)=O,,,4,1,1,0,1
4540_0,,,,2,2,1,3
C(C(C=O)CC(C(C=O)=O)O)(O)=O,,,4,1,1,0,1
4542_0,,,,2,2,1,3
C(C(C(O)=O)O)(CC(C(C)=O)=O)=O,,,4,1,2,0,2
4542_1,,,,2,2,1,3
4544_0,,,,2,2,1,3
C(C(C(CO)=O)C(C(C)=O)=O)(O)=O,,,4,1,2,0,2
4544_1,,,,2,2,1,3
4546_0,,,,2,2,1,3
C(CC(C(CC(CO)=O)=O)=O)(O)=O,,,4,1,1,0,1
4548_0,,,,2,2,1,3
C(C(C(C(C=CCO)=O)=O)O)(O)=O,,,4,1,2,0,2
4548_1,,,,2,2,1,3
4550_0,,,,2,2,1,3
C(C(C(C(C=CC=O)O)=O)O)(O)=O,,,4,1,2,0,2
4550_1,,,,2,2,1,3
4552_0,,,,2,2,1,3
C(C(C(C(C(C=C)=O)O)=O)O)(O)=O,,,4,1,2,0,2
4552_1,,,,2,2,1,3
4554_0,,,,2,2,1,3
C(C(C(C=CC(CO)=O)=O)O)(O)=O,,,4,1,2,0,2
4554_1,,,,2,2,1,3
4556_0,,,,2,2,1,3
C(C(C(O)=O)O)(CC(CCO)=O)=O,,,4,1,4,0,4
4556_1,,,,2,2,1,3
4558_0,,,,2,2,1,3
C(CCO)(C(C(O)=O)C(CO)=O)=O,,,4,1,2,0,2
4558_1,,,,2,2,1,3
4560_0,,,,2,2,1,3
C(C(C(CC(CO)=O)=O)CO)(O)=O,,,4,1,5,0,5
4560_1,,,,2,2,1,3
4562_0,,,,2,2,1,3
C(C(C(CCC(CO)=O)=O)O)(O)=O,,,4,1,2,0,2
4562_1,,,,2,2,1,3
4564_0,,,,2,2,1,3
C(C(C(CO)=O)CC(CO)=O)(O)=O,,,4,1,1,0,1
4566_0,,,,2,2,1,3
C(C(C(C=O)=O)C(CCO)O)(O)=O,,,4,1,2,0,2
4566_1,,,,2,2,1,3
4568_0,,,,2,2,1,3
C(C(C(C(CCO)=O)=O)CO)(O)=O,,,4,1,5,0,5
4568_1,,,,2,2,1,3
4570_0,,,,2,2,1,3
C(C(C(C(C(C)=O)O)=O)CO)(O)=O,,,4,1,5,0,5
4570_1,,,,2,2,1,3
4572_0,,,,2,2,1,3
C(CC(C(C(CCO)=O)O)=O)(O)=O,,,4,1,3,0,3
4574_0,,,,2,2,1,3
C(C(C=O)C(C(CCO)O)=O)(O)=O,,,4,1,2,0,2
4574_1,,,,2,2,1,3
4576_0,,,,2,2,1,3
C(C(CO)O)(C(C(O)=O)C(C)=O)=O,,,4,1,2,0,2
4576_1,,,,2,2,1,3
4578_0,,,,2,2,1,3
C(CC(CC(C(CO)O)=O)=O)(O)=O,,,4,1,4,0,4
4580_0,,,,2,2,1,3
C(C(CO)O)(C(C(O)=O)CC=O)=O,,,4,1,1,0,1
4582_0,,,,2,2,1,3
C(C(C=O)CC(C(CO)O)=O)(O)=O,,,4,1,1,0,1
4584_0,,,,2,2,1,3
C(C(C(C(C=O)O)=O)CCO)(O)=O,,,4,1,1,0,1
4586_0,,,,2,2,1,3
C(C(C(C(C)=O)=O)C(CO)O)(O)=O,,,4,1,2,0,2
4586_1,,,,2,2,1,3
4588_0,,,,2,2,1,3
C(CC(C(CC(CO)O)=O)=O)(O)=O,,,4,1,1,0,1
4590_0,,,,2,2,1,3
C(C(C(CC=O)=O)C(CO)O)(O)=O,,,4,1,2,0,2
4590_1,,,,2,2,1,3
4592_0,,,,2,2,1,3
C(C(C=O)C(CC(CO)O)=O)(O)=O,,,4,1,2,0,2
4592_1,,,,2,2,1,3
4594_0,,,,2,2,1,3
C(CCO)(C(C(O)=O)C(C=O)O)=O,,,4,1,2,0,2
4594_1,,,,2,2,1,3
4596_0,,,,2,2,1,3
C(CC(C=O)O)(C(C(O)=O)CO)=O,,,4,1,5,0,5
4596_1,,,,2,2,1,3
4598_0,,,,2,2,1,3
C(C(C(C=CC(CO)O)=O)O)(O)=O,,,4,1,2,0,2
4598_1,,,,2,2,1,3
4600_0,,,,2,2,1,3
C(C(C(C(O)=O)=O)CO)(O)=O,,,4,1,2,0,2
4600_1,,,,2,2,1,3
4602_0,,,,2,2,1,3
C(C(C=O)C(C(O)=O)O)(O)=O,,,4,1,2,0,2
4602_1,,,,2,2,1,3
4604_0,,,,2,2,1,3
C(C1C(C(C=O)(C(C1)O)O)=O)(O)=O,,,4,1,1,0,1
4606_0,,,,2,2,1,3
C(C(C(CC(O)=O)=O)(CO)O)=O,,,4,1,1,0,1
4608_0,,,,2,2,1,3
C(C(C(CC(O)=O)=O)(C(C)O)O)=O,,,4,1,1,0,1
4610_0,,,,2,2,1,3
C(CC(C(CO)(CO)O)=O)(O)=O,,,4,1,1,0,1
4612_0,,,,2,2,1,3
C(CC(C(CO)(C(C)O)O)=O)(O)=O,,,4,1,1,0,1
4614_0,,,,2,2,1,3
C(C(C(C(CO)(CO)O)=O)O)(O)=O,,,4,1,2,0,2
4614_1,,,,2,2,1,3
4616_0,,,,2,2,1,3
C1(CC(C(C=O)(C1C(O)=O)O)O)=O,,,4,1,2,0,2
4616_1,,,,2,2,1,3
4618_0,,,,2,2,1,3
C(C1(C(C(C(O)=O)C(C1)=O)O)O)=O,,,4,1,2,0,2
4618_1,,,,2,2,1,3
4620_0,,,,2,2,1,3
C(C(C=O)C(C=O)(CO)O)(O)=O,,,4,1,2,0,2
4620_1,,,,2,2,1,3
4622_0,,,,2,2,1,3
C(C(C=O)C(C=O)(C(C)O)O)(O)=O,,,4,1,2,0,2
4622_1,,,,2,2,1,3
4624_0,,,,2,2,1,3
C1(C(C(O)=O)C(C(C1CO)=O)O)=O,,,4,1,2,0,2
4624_1,,,,2,2,1,3
4626_0,,,,2,2,1,3
C1(C(C(O)=O)C(C(C1O)=O)CO)=O,,,4,1,1,0,1
4628_0,,,,2,2,1,3
C1(C(C(O)=O)CC(C1(CO)O)=O)=O,,,4,1,1,0,1
4630_0,,,,2,2,1,3
C1(C(C(O)=O)C(C(C1)=O)(CO)O)=O,,,4,1,2,0,2
4630_1,,,,2,2,1,3
4632_0,,,,2,2,1,3
C1(C(CO)(CC(C1C(O)=O)=O)O)=O,,,4,1,2,0,2
4632_1,,,,2,2,1,3
4634_0,,,,2,2,1,3
C1(CC(C(C(CC(O)=O)=O)O1)O)=O,,,4,1,1,0,1
4636_0,,,,2,2,1,3
C(C(C=O)C1C(CC(O1)=O)O)(O)=O,,,4,1,2,0,2
4636_1,,,,2,2,1,3
4638_0,,,,2,2,1,3
C(C1C(C(C(C(C)=O)O1)O)=O)(O)=O,,,4,1,2,0,2
4638_1,,,,2,2,1,3
4640_0,,,,2,2,1,3
C(CC(C1C(C(CO1)=O)O)=O)(O)=O,,,4,1,1,0,1
4642_0,,,,2,2,1,3
C(CC1C(C(C(C(O)=O)O1)=O)O)=O,,,4,1,2,0,2
4642_1,,,,2,2,1,3
4644_0,,,,2,2,1,3
C(C(C=O)C1C(C(CO1)=O)O)(O)=O,,,4,1,2,0,2
4644_1,,,,2,2,1,3
4646_0,,,,2,2,1,3
C(C1C(C(O)OC1C(C)=O)=O)(O)=O,,,4,1,2,0,2
4646_1,,,,2,2,1,3
4648_0,,,,2,2,1,3
C(CC(C1CC(C(O)O1)=O)=O)(O)=O,,,4,1,1,0,1
4650_0,,,,2,2,1,3
C(CC1C(C(O)=O)C(C(O)O1)=O)=O,,,4,1,2,0,2
4650_1,,,,2,2,1,3
4652_0,,,,2,2,1,3
C(C(C=O)C1CC(C(O)O1)=O)(O)=O,,,4,1,2,0,2
4652_1,,,,2,2,1,3
4654_0,,,,2,2,1,3
C(C1C(C(C(C)=O)OC1O)=O)(O)=O,,,4,1,2,0,2
4654_1,,,,2,2,1,3
4656_0,,,,2,2,1,3
C(CC(C1C(CC(O1)O)=O)=O)(O)=O,,,4,1,1,0,1
4658_0,,,,2,2,1,3
C(CC1C(C(C(O)=O)C(O1)O)=O)=O,,,4,1,2,0,2
4658_1,,,,2,2,1,3
4660_0,,,,2,2,1,3
C(C(C=O)C1C(CC(O1)O)=O)(O)=O,,,4,1,2,0,2
4660_1,,,,2,2,1,3
4662_0,,,,2,2,1,3
C1(C(C(O)=O)C(CC(CO)O1)=O)=O,,,4,1,2,0,2
4662_1,,,,2,2,1,3
4664_0,,,,2,2,1,3
C(C1C(CC(OC1CO)=O)=O)(O)=O,,,4,1,2,0,2
4664_1,,,,2,2,1,3
4666_0,,,,2,2,1,3
C(C1C(C(CO)OC(C1)=O)=O)(O)=O,,,4,1,1,0,1
4668_0,,,,2,2,1,3
C(C1C(C(CC(CO)O1)=O)=O)(O)=O,,,4,1,2,0,2
4668_1,,,,2,2,1,3
4670_0,,,,2,2,1,3
C(C1C(C(COC1CO)=O)=O)(O)=O,,,4,1,2,0,2
4670_1,,,,2,2,1,3
4672_0,,,,2,2,1,3
C1(C(C(O)=O)OC(C(C1)=O)CO)=O,,,4,1,2,0,2
4672_1,,,,2,2,1,3
4674_0,,,,2,2,1,3
C1(C(CO)OCC(C1C(O)=O)=O)=O,,,4,1,2,0,2
4674_1,,,,2,2,1,3
4676_0,,,,2,2,1,3
C1(C(C(O)=O)C(CC(CO1)O)=O)=O,,,4,1,2,0,2
4676_1,,,,2,2,1,3
4678_0,,,,2,2,1,3
C(C1C(CC(OCC1O)=O)=O)(O)=O,,,4,1,2,0,2
4678_1,,,,2,2,1,3
4680_0,,,,2,2,1,3
C1(C(COC(CC1C(O)=O)=O)O)=O,,,4,1,1,0,1
4682_0,,,,2,2,1,3
C1(CC(C(C(C(O)=O)CO1)=O)O)=O,,,4,1,2,0,2
4682_1,,,,2,2,1,3
4684_0,,,,2,2,1,3
C1(CC(C(C(O)=O)C(CO1)=O)O)=O,,,4,1,2,0,2
4684_1,,,,2,2,1,3
4686_0,,,,2,2,1,3
C(C1C(CC(CC(O1)=O)O)=O)(O)=O,,,4,1,2,0,2
4686_1,,,,2,2,1,3
4688_0,,,,2,2,1,3
C(C1C(C(CC(CO1)O)=O)=O)(O)=O,,,4,1,2,0,2
4688_1,,,,2,2,1,3
4690_0,,,,2,2,1,3
C(C1C(C(COCC1O)=O)=O)(O)=O,,,4,1,2,0,2
4690_1,,,,2,2,1,3
4692_0,,,,2,2,1,3
C1(C(C(O)=O)OCC(C(C1)=O)O)=O,,,4,1,2,0,2
4692_1,,,,2,2,1,3
4694_0,,,,2,2,1,3
C1(C(COCC(C1C(O)=O)=O)O)=O,,,4,1,2,0,2
4694_1,,,,2,2,1,3
4696_0,,,,2,2,1,3
C1(C(C(O)=O)OCCC(C1O)=O)=O,,,4,1,2,0,2
4696_1,,,,2,2,1,3
4698_0,,,,2,2,1,3
C(C1C(C(C(COC1)=O)O)=O)(O)=O,,,4,1,2,0,2
4698_1,,,,2,2,1,3
4700_0,,,,2,2,1,3
C(C1C(C(CC(CO1)=O)O)=O)(O)=O,,,4,1,2,0,2
4700_1,,,,2,2,1,3
4702_0,,,,2,2,1,3
C(C1C(COCC(C1O)=O)=O)(O)=O,,,4,1,2,0,2
4702_1,,,,2,2,1,3
4704_0,,,,2,2,1,3
C(C1C(CC(C(CO1)=O)O)=O)(O)=O,,,4,1,2,0,2
4704_1,,,,2,2,1,3
4706_0,,,,2,2,1,3
C1(CCOC(C(C1C(O)=O)=O)O)=O,,,4,1,2,0,2
4706_1,,,,2,2,1,3
4708_0,,,,2,2,1,3
C(C1C(CC(C(O)OC1)=O)=O)(O)=O,,,4,1,2,0,2
4708_1,,,,2,2,1,3
4710_0,,,,2,2,1,3
C(C1C(C(O)OCC(C1)=O)=O)(O)=O,,,4,1,1,0,1
4712_0,,,,2,2,1,3
C(C1C(COC(C(C1)=O)O)=O)(O)=O,,,4,1,1,0,1
4714_0,,,,2,2,1,3
C(C1C(CCC(C(O1)O)=O)=O)(O)=O,,,4,1,2,0,2
4714_1,,,,2,2,1,3
4716_0,,,,2,2,1,3
C(C1C(C(CCOC1O)=O)=O)(O)=O,,,4,1,2,0,2
4716_1,,,,2,2,1,3
4718_0,,,,2,2,1,3
C(C1C(C(CC(O)OC1)=O)=O)(O)=O,,,4,1,2,0,2
4718_1,,,,2,2,1,3
4720_0,,,,2,2,1,3
C(C1C(CC(COC1O)=O)=O)(O)=O,,,4,1,2,0,2
4720_1,,,,2,2,1,3
4722_0,,,,2,2,1,3
C1(CC(OCC(C1C(O)=O)=O)O)=O,,,4,1,2,0,2
4722_1,,,,2,2,1,3
4724_0,,,,2,2,1,3
C1(C(C(O)=O)OC(CC(C1)=O)O)=O,,,4,1,2,0,2
4724_1,,,,2,2,1,3
4726_0,,,,2,2,1,3
C(CC(C=CC(C=O)=O)=O)(O)=O,,,4,1,1,0,1
4728_0,,,,2,2,1,3
C(C(C(O)=O)C=CC(C=O)=O)=O,,,4,1,1,0,1
4730_0,,,,2,2,1,3
C(CC(C(C=CC=O)=O)=O)(O)=O,,,4,1,1,0,1
4732_0,,,,2,2,1,3
C(C(C(O)=O)C(C=CC=O)=O)=O,,,4,1,2,0,2
4732_1,,,,2,2,1,3
4734_0,,,,2,2,1,3
C(C(C(C=O)=O)C(C=C)=O)(O)=O,,,4,1,2,0,2
4734_1,,,,2,2,1,3
4736_0,,,,2,2,1,3
C(C(C(O)=O)C(C(C=C)=O)=O)=O,,,4,1,2,0,2
4736_1,,,,2,2,1,3
4738_0,,,,2,2,1,3
C(C(C=CC=O)C(C=O)=O)(O)=O,,,4,1,1,0,1
4740_0,,,,2,2,1,3
C(C1C(C(CO1)O)=O)(O)=O,,,4,1,2,0,2
4740_1,,,,2,2,1,3
4742_0,,,,2,2,1,3
C(C1C(C(O)OC1)=O)(O)=O,,,4,1,2,0,2
4742_1,,,,2,2,1,3
4744_0,,,,2,2,1,3
C(C(C=O)C1C(C(CO1)O)=O)(O)=O,,,4,1,2,0,2
4744_1,,,,2,2,1,3
4746_0,,,,2,2,1,3
C(C(C=O)C1(C(CCO1)=O)O)(O)=O,,,4,1,2,0,2
4746_1,,,,2,2,1,3
4748_0,,,,2,2,1,3
C(CC1(C(C(C(O)=O)CO1)=O)O)=O,,,4,1,2,0,2
4748_1,,,,2,2,1,3
4750_0,,,,2,2,1,3
C(C(C=O)C1(CC(CO1)=O)O)(O)=O,,,4,1,2,0,2
4750_1,,,,2,2,1,3
4752_0,,,,2,2,1,3
C(CC1(C(C(O)=O)C(CO1)=O)O)=O,,,4,1,2,0,2
4752_1,,,,2,2,1,3
4754_0,,,,2,2,1,3
C(C1C(CC(CC=O)(O1)O)=O)(O)=O,,,4,1,2,0,2
4754_1,,,,2,2,1,3
4756_0,,,,2,2,1,3
C(C1C(C(C=O)OC1(C)O)=O)(O)=O,,,4,1,2,0,2
4756_1,,,,2,2,1,3
4758_0,,,,2,2,1,3
C1(C(C)(OC(C=O)C1C(O)=O)O)=O,,,4,1,2,0,2
4758_1,,,,2,2,1,3
4760_0,,,,2,2,1,3
C1(CCOC(C=O)(C1C(O)=O)O)=O,,,4,1,2,0,2
4760_1,,,,2,2,1,3
4762_0,,,,2,2,1,3
C1(CC(C=O)(O)OCC1C(O)=O)=O,,,4,1,2,0,2
4762_1,,,,2,2,1,3
4764_0,,,,2,2,1,3
C(C1(CC(C(O)=O)C(CO1)=O)O)=O,,,4,1,1,0,1
4766_0,,,,2,2,1,3
C1(CCC(C=O)(OC1C(O)=O)O)=O,,,4,1,2,0,2
4766_1,,,,2,2,1,3
4768_0,,,,2,2,1,3
C(C1C(C(C=O)OC(C1)O)=O)(O)=O,,,4,1,1,0,1
4770_0,,,,2,2,1,3
C1(CC(OC(C=O)C1C(O)=O)O)=O,,,4,1,2,0,2
4770_1,,,,2,2,1,3
4772_0,,,,2,2,1,3
C1(CC(C=O)OC(C1C(O)=O)O)=O,,,4,1,2,0,2
4772_1,,,,2,2,1,3
4774_0,,,,2,2,1,3
C(C1C(C=CC(C(O1)O)O)=O)(O)=O,,,4,1,2,0,2
4774_1,,,,2,2,1,3
4775_0,,,,2,2,1,3
4775_1,,,,2,2,1,3
4776_0,,,,2,2,1,3
4776_1,,,,2,2,1,3
4778_0,,,,2,2,1,3
C(C(C(CO)=O)C(C(C)O)O)(O)=O,,,4,1,2,0,2
4778_1,,,,2,2,1,3
4780_0,,,,2,2,1,3
C(CC(C(C(C(C)O)O)O)=O)(O)=O,,,4,1,2,0,2
4780_1,,,,2,2,1,3
4781_0,,,,2,2,1,3
4783_0,,,,2,2,1,3
C(C(C(CC(C(C)O)O)=O)O)(O)=O,,,4,1,1,0,1
4785_0,,,,2,2,1,3
C(C(C(C(C)=O)C(C=O)=O)O)(O)=O,,,4,1,2,0,2
4785_1,,,,2,2,1,3
4787_0,,,,2,2,1,3
C(C(CC(CC(C=O)=O)=O)O)(O)=O,,,4,1,1,0,1
4789_0,,,,2,2,1,3
C(C(C(C=O)=O)C(C(O)=O)O)=O,,,4,1,2,0,2
4789_1,,,,2,2,1,3
4791_0,,,,2,2,1,3
C(C(C(C(C)=O)=O)C(C(O)=O)O)=O,,,4,1,2,0,2
4791_1,,,,2,2,1,3
4793_0,,,,2,2,1,3
C(CC(C(CC(C(O)=O)O)=O)=O)=O,,,4,1,1,0,1
4794_0,,,,2,2,1,3
4795_0,,,,2,2,1,3
4797_0,,,,2,2,1,3
C(C(C(C)=O)C(C(O)=O)O)=O,,,4,1,2,0,2
4797_1,,,,2,2,1,3
4799_0,,,,2,2,1,3
C1(COC(C1C(C(O)=O)O)O)=O,,,4,1,2,0,2
4799_1,,,,2,2,1,3
4801_0,,,,2,2,1,3
C(C(C1C(CC(O1)O)=O)O)(O)=O,,,4,1,2,0,2
4801_1,,,,2,2,1,3
4803_0,,,,2,2,1,3
C(C(C(C(C=CC=O)=O)O)O)(O)=O,,,4,1,2,0,2
4803_1,,,,2,2,1,3
4804_0,,,,2,2,1,3
4804_1,,,,2,2,1,3
4806_0,,,,2,2,1,3
C(C(C(C(C(O)=O)=O)CO)O)(O)=O,,,4,1,2,0,2
4806_1,,,,2,2,1,3
4808_0,,,,2,2,1,3
C(C(C(C=O)C(C(O)=O)O)O)(O)=O,,,4,1,2,0,2
4808_1,,,,2,2,1,3
4810_0,,,,2,2,1,3
C(C(C1C(C(CO1)O)=O)O)(O)=O,,,4,1,2,0,2
4810_1,,,,2,2,1,3
4812_0,,,,2,2,1,3
C1(C(O)OCC1C(C(O)=O)O)=O,,,4,1,2,0,2
4812_1,,,,2,2,1,3
4814_0,,,,2,2,1,3
C(C(C(CC(C(C)=O)=O)O)O)(O)=O,,,4,1,2,0,2
4816_0,,,,2,2,1,3
C(CC(C(C(O)=O)O)O)(CC=O)=O,,,4,1,1,0,1
4818_0,,,,2,2,1,3
C(C(C(C(C=O)C(C)=O)O)O)(O)=O,,,4,1,2,0,2
4818_1,,,,2,2,1,3
4820_0,,,,2,2,1,3
C(C(C(C(C(C=C)=O)O)O)O)(O)=O,,,4,1,2,0,2
4820_1,,,,2,2,1,3
4822_0,,,,2,2,1,3
C(C)(C(C(C=O)=O)C(C(C=C)=O)O)=O,,,4,1,2,0,2
4822_1,,,,2,2,1,3
4824_0,,,,2,2,1,3
C(CC(C(C=C)=O)O)(CC(C=O)=O)=O,,,4,1,1,0,1
4826_0,,,,2,2,1,3
C(C(C=C)(C(C(C)=O)C(C=O)=O)O)=O,,,4,1,2,0,2
4826_1,,,,2,2,1,3
4828_0,,,,2,2,1,3
C(C(C=C)(CC(CC(C=O)=O)=O)O)=O,,,4,1,1,0,1
4830_0,,,,2,2,1,3
C(C)(C(C(C=O)=O)C(C=CC=O)O)=O,,,4,1,2,0,2
4830_1,,,,2,2,1,3
4832_0,,,,2,2,1,3
C(CC(C=CC=O)O)(CC(C=O)=O)=O,,,4,1,1,0,1
4834_0,,,,2,2,1,3
C(C)(C(C(C=O)=O)C(C(C)O)O)=O,,,4,1,2,0,2
4834_1,,,,2,2,1,3
4836_0,,,,2,2,1,3
C(CC(C(C)O)O)(CC(C=O)=O)=O,,,4,1,1,0,1
4838_0,,,,2,2,1,3
C(C(C(C=O)=O)C(C(C)=O)(C)O)=O,,,4,1,2,0,2
4838_1,,,,2,2,1,3
4840_0,,,,2,2,1,3
C(CC(C(CC(C(C)=O)=O)O)=O)=O,,,4,1,1,0,1
4842_0,,,,2,2,1,3
C(CC(C=O)(CC(C(C)=O)=O)O)=O,,,4,1,1,0,1
4844_0,,,,2,2,1,3
C(C=O)(CC(CC(C(C)=O)=O)O)=O,,,4,1,2,0,2
4846_0,,,,2,2,1,3
C(C(C(C=O)=O)C(C)(CC=O)O)=O,,,4,1,2,0,2
4846_1,,,,2,2,1,3
4848_0,,,,2,2,1,3
C(C(C(C=O)=O)C(CC(C)=O)O)=O,,,4,1,2,0,2
4848_1,,,,2,2,1,3
4850_0,,,,2,2,1,3
C(CC(CC(C(CC=O)=O)O)=O)=O,,,4,1,1,0,1
4852_0,,,,2,2,1,3
C(CC(CC(C=O)(CC=O)O)=O)=O,,,4,1,1,0,1
4854_0,,,,2,2,1,3
C(CC(CC(CC(C=O)=O)O)=O)=O,,,4,1,1,0,1
4856_0,,,,2,2,1,3
C(C(C(C)=O)C(C(CC=O)=O)O)=O,,,4,1,2,0,2
4856_1,,,,2,2,1,3
4858_0,,,,2,2,1,3
C(C(C(C)=O)C(C=O)(CC=O)O)=O,,,4,1,2,0,2
4858_1,,,,2,2,1,3
4860_0,,,,2,2,1,3
C(C(C(C)=O)C(CC(C=O)=O)O)=O,,,4,1,2,0,2
4860_1,,,,2,2,1,3
4862_0,,,,2,2,1,3
C(C(C(C=O)=O)C(C(C=C)=O)O)=O,,,4,1,2,0,2
4862_1,,,,2,2,1,3
4864_0,,,,2,2,1,3
C(C(C(C=O)=O)C(C=O)(C=C)O)=O,,,4,1,2,0,2
4864_1,,,,2,2,1,3
4866_0,,,,2,2,1,3
C(C(C(C=O)=O)C(C=C)(CO)O)=O,,,4,1,2,0,2
4866_1,,,,2,2,1,3
4868_0,,,,2,2,1,3
C(CC(C(C(C(C=C)=O)O)O)=O)=O,,,4,1,4,0,4
4868_1,,,,2,2,1,3
4870_0,,,,2,2,1,3
C(CC(C=O)(C(C(C=C)=O)O)O)=O,,,4,1,3,0,3
4870_1,,,,2,2,1,3
4872_0,,,,2,2,1,3
C=CC(C(C(CC(C=O)=O)O)O)=O,,,4,1,2,0,2
4872_1,,,,2,2,1,3
4874_0,,,,2,2,1,3
C(C(C(C=O)=O)C(C=CC=O)O)=O,,,4,1,2,0,2
4874_1,,,,2,2,1,3
4876_0,,,,2,2,1,3
C(C(C(C=O)=O)C(C(C)O)O)=O,,,4,1,2,0,2
4876_1,,,,2,2,1,3
4878_0,,,,2,2,1,3
C(C(C(C(C)=O)=O)C(C(C=C)=O)O)=O,,,4,1,2,0,2
4878_1,,,,2,2,1,3
4880_0,,,,2,2,1,3
C(CC(C(CC(C(C=C)=O)O)=O)=O)=O,,,4,1,1,0,1
4882_0,,,,2,2,1,3
C(C(C(C(C)=O)=O)C(C=O)(C=C)O)=O,,,4,1,2,0,2
4882_1,,,,2,2,1,3
4884_0,,,,2,2,1,3
C(C(C=C)(CC(C(CC=O)=O)=O)O)=O,,,4,1,1,0,1
4886_0,,,,2,2,1,3
C(C(C(C(C)=O)=O)C(C=CC=O)O)=O,,,4,1,2,0,2
4886_1,,,,2,2,1,3
4888_0,,,,2,2,1,3
C(CC(C(CC(C=CC=O)O)=O)=O)=O,,,4,1,1,0,1
4890_0,,,,2,2,1,3
C(C(C(C(C)=O)=O)C(C(C)O)O)=O,,,4,1,2,0,2
4890_1,,,,2,2,1,3
4892_0,,,,2,2,1,3
C(CC(C(CC(C(C)O)O)=O)=O)=O,,,4,1,1,0,1
4894_0,,,,2,2,1,3
C(C)(C(C)(CC(C(C)=O)=O)O)=O,,,4,1,1,0,1
4896_0,,,,2,2,1,3
C(CC(C)(CC(C(C)=O)=O)O)=O,,,4,1,1,0,1
4898_0,,,,2,2,1,3
C(C)(CC(CC(C(C)=O)=O)O)=O,,,4,1,1,0,1
4900_0,,,,2,2,1,3
C(C)(C(C)(CC(CC=O)=O)O)=O,,,4,1,1,0,1
4902_0,,,,2,2,1,3
C(C(C(C)=O)C(C(C)=O)(C)O)=O,,,4,1,2,0,2
4902_1,,,,2,2,1,3
4904_0,,,,2,2,1,3
C(C(C)=O)(CC1(COC(C1)O)O)=O,,,4,1,1,0,1
4906_0,,,,2,2,1,3
C(C)(C(C)(C1C(COC1O)=O)O)=O,,,4,1,2,0,2
4906_1,,,,2,2,1,3
4908_0,,,,2,2,1,3
C(C)(C(C)(C1C(CC(O1)O)=O)O)=O,,,4,1,2,0,2
4908_1,,,,2,2,1,3
4910_0,,,,2,2,1,3
C=CC(C(CC(C(C)=O)=O)O)=O,,,4,1,1,0,1
4912_0,,,,2,2,1,3
C(C(C=C)(CC(C(C)=O)=O)O)=O,,,4,1,2,0,2
4914_0,,,,2,2,1,3
C(C(CO)(CC(C(C)=O)=O)O)=C,,,4,1,1,0,1
4916_0,,,,2,2,1,3
C(C)(C(C)(C(C(C=C)=O)O)O)=O,,,4,1,2,0,2
4916_1,,,,2,2,1,3
4918_0,,,,2,2,1,3
C(C(CC(C(C)=O)=O)O)=CC=O,,,4,1,2,0,2
4920_0,,,,2,2,1,3
C(C(C)=O)(CC(C(C)O)O)=O,,,4,1,1,0,1
4922_0,,,,2,2,1,3
C(C(C)=O)(CC1(COCC1O)O)=O,,,4,1,1,0,1
4924_0,,,,2,2,1,3
C(C)(C(C)(C1C(C(CO1)O)=O)O)=O,,,4,1,2,0,2
4924_1,,,,2,2,1,3
4926_0,,,,2,2,1,3
C(C(C)=O)(CC1(C(O)OCC1)O)=O,,,4,1,1,0,1
4928_0,,,,2,2,1,3
C(C)(C(C)(C1C(C(O)OC1)=O)O)=O,,,4,1,2,0,2
4928_1,,,,2,2,1,3
4930_0,,,,2,2,1,3
C(CC(CC(C)(CC=O)O)=O)=O,,,4,1,1,0,1
4932_0,,,,2,2,1,3
C(CC(C)(C(C=O)C(C)=O)O)=O,,,4,1,2,0,2
4932_1,,,,2,2,1,3
4934_0,,,,2,2,1,3
C(CC(CC(C)=O)O)(CC=O)=O,,,4,1,1,0,1
4936_0,,,,2,2,1,3
C(C(C(C)=O)C(CC(C)=O)O)=O,,,4,1,2,0,2
4936_1,,,,2,2,1,3
4938_0,,,,2,2,1,3
C(CC(CC1(COC(C1)O)O)=O)=O,,,4,1,2,0,2
4940_0,,,,2,2,1,3
C(C(C(C)=O)C1(COC(C1)O)O)=O,,,4,1,2,0,2
4940_1,,,,2,2,1,3
4942_0,,,,2,2,1,3
C(CC(C)(C1C(COC1O)=O)O)=O,,,4,1,2,0,2
4942_1,,,,2,2,1,3
4944_0,,,,2,2,1,3
C(C)(CC(C1C(COC1O)=O)O)=O,,,4,1,2,0,2
4944_1,,,,2,2,1,3
4946_0,,,,2,2,1,3
C(CC(C)(C1C(CC(O1)O)=O)O)=O,,,4,1,4,0,4
4946_1,,,,2,2,1,3
4948_0,,,,2,2,1,3
C1(C(C(CC(C)=O)O)OC(C1)O)=O,,,4,1,2,0,2
4948_1,,,,2,2,1,3
4950_0,,,,2,2,1,3
C(CC(CC(C(C=C)=O)O)=O)=O,,,4,1,2,0,2
4952_0,,,,2,2,1,3
C(C(C(C)=O)C(C(C=C)=O)O)=O,,,4,1,3,0,3
4952_1,,,,2,2,1,3
4954_0,,,,2,2,1,3
C(C(C=C)(CC(CC=O)=O)O)=O,,,4,1,2,0,2
4956_0,,,,2,2,1,3
C(C(C(C)=O)C(C=O)(C=C)O)=O,,,4,1,2,0,2
4956_1,,,,2,2,1,3
4958_0,,,,2,2,1,3
C(CC(CC(C=C)(CO)O)=O)=O,,,4,1,1,0,1
4960_0,,,,2,2,1,3
C(C(C(C)=O)C(C=C)(CO)O)=O,,,4,1,2,0,2
4960_1,,,,2,2,1,3
4962_0,,,,2,2,1,3
C(CC(C)(C(C(C=C)=O)O)O)=O,,,4,1,2,0,2
4962_1,,,,2,2,1,3
4964_0,,,,2,2,1,3
C(C)(CC(C(C(C=C)=O)O)O)=O,,,4,1,2,0,2
4964_1,,,,2,2,1,3
4966_0,,,,2,2,1,3
C(CC(CC(C=CC=O)O)=O)=O,,,4,1,3,0,3
4968_0,,,,2,2,1,3
C(C(C(C)=O)C(C=CC=O)O)=O,,,4,1,3,0,3
4968_1,,,,2,2,1,3
4970_0,,,,2,2,1,3
C(CC(CC(C(C)O)O)=O)=O,,,4,1,1,0,1
4972_0,,,,2,2,1,3
C(C(C(C)=O)C(C(C)O)O)=O,,,4,1,2,0,2
4972_1,,,,2,2,1,3
4974_0,,,,2,2,1,3
C(CC(CC1(COCC1O)O)=O)=O,,,4,1,1,0,1
4976_0,,,,2,2,1,3
C(C(C(C)=O)C1(COCC1O)O)=O,,,4,1,2,0,2
4976_1,,,,2,2,1,3
4978_0,,,,2,2,1,3
C(CC(C)(C1C(C(CO1)O)=O)O)=O,,,4,1,2,0,2
4978_1,,,,2,2,1,3
4980_0,,,,2,2,1,3
C1(C(C(CC(C)=O)O)OCC1O)=O,,,4,1,2,0,2
4980_1,,,,2,2,1,3
4982_0,,,,2,2,1,3
C(CC(CC1(C(O)OCC1)O)=O)=O,,,4,1,1,0,1
4984_0,,,,2,2,1,3
C(C(C(C)=O)C1(C(O)OCC1)O)=O,,,4,1,2,0,2
4984_1,,,,2,2,1,3
4986_0,,,,2,2,1,3
C(CC(C)(C1C(C(O)OC1)=O)O)=O,,,4,1,2,0,2
4986_1,,,,2,2,1,3
4988_0,,,,2,2,1,3
C(C)(CC(C1C(C(O)OC1)=O)O)=O,,,4,1,2,0,2
4988_1,,,,2,2,1,3
4990_0,,,,2,2,1,3
C1(COC(C1C(C(C=C)=O)O)O)=O,,,4,1,2,0,2
4990_1,,,,2,2,1,3
4992_0,,,,2,2,1,3
C1(C(C(C(C=C)=O)O)OC(C1)O)=O,,,4,1,2,0,2
4992_1,,,,2,2,1,3
4994_0,,,,2,2,1,3
C(C(C=C)(C1C(COC1O)=O)O)=O,,,4,1,2,0,2
4994_1,,,,2,2,1,3
4996_0,,,,2,2,1,3
C(C(C=C)(C1C(CC(O1)O)=O)O)=O,,,4,1,2,0,2
4996_1,,,,2,2,1,3
4998_0,,,,2,2,1,3
C1(COC(C1C(C=C)(CO)O)O)=O,,,4,1,2,0,2
4998_1,,,,2,2,1,3
5000_0,,,,2,2,1,3
C1(C(C(C=C)(CO)O)OC(C1)O)=O,,,4,1,2,0,2
5000_1,,,,2,2,1,3
5002_0,,,,2,2,1,3
C=CC(C(C1(COC(C1)O)O)O)=O,,,4,1,2,0,2
5002_1,,,,2,2,1,3
5004_0,,,,2,2,1,3
C1(COC(C1C(C=CC=O)O)O)=O,,,4,1,2,0,2
5004_1,,,,2,2,1,3
5006_0,,,,2,2,1,3
C1(C(C(C=CC=O)O)OC(C1)O)=O,,,4,1,2,0,2
5006_1,,,,2,2,1,3
5008_0,,,,2,2,1,3
C1(COC(C1C(C(C)O)O)O)=O,,,4,1,2,0,2
5008_1,,,,2,2,1,3
5010_0,,,,2,2,1,3
C1(C(C(C(C)O)O)OC(C1)O)=O,,,4,1,2,0,2
5010_1,,,,2,2,1,3
5012_0,,,,2,2,1,3
C=CC(C(C(C(C=CC=O)=O)O)O)=O,,,4,1,2,0,2
5012_1,,,,2,2,1,3
5014_0,,,,2,2,1,3
C(C(C=C)(C(C(C=CC=O)=O)O)O)=O,,,4,1,2,0,2
5014_1,,,,2,2,1,3
5016_0,,,,2,2,1,3
C(C(C(C(C=CC=O)=O)O)O)=CC=O,,,4,1,2,0,2
5016_1,,,,2,2,1,3
5018_0,,,,2,2,1,3
C(C=CC(C(C(C(C)O)O)O)=O)=O,,,4,1,2,0,2
5018_1,,,,2,2,1,3
5020_0,,,,2,2,1,3
C=CC(C(C(C(C=C)=O)O)O)=O,,,4,1,2,0,2
5020_1,,,,2,2,1,3
5022_0,,,,2,2,1,3
C(C(C=C)(C(C(C=C)=O)O)O)=O,,,4,1,3,0,3
5022_1,,,,2,2,1,3
5024_0,,,,2,2,1,3
C1(C(C(C(C=C)=O)O)OCC1O)=O,,,4,1,2,0,2
5024_1,,,,2,2,1,3
5026_0,,,,2,2,1,3
C(C(C=C)(C1C(C(CO1)O)=O)O)=O,,,4,1,2,0,2
5026_1,,,,2,2,1,3
5028_0,,,,2,2,1,3
C1(C(O)OCC1C(C(C=C)=O)O)=O,,,4,1,2,0,2
5028_1,,,,2,2,1,3
5030_0,,,,2,2,1,3
C(C(C=C)(C1C(C(O)OC1)=O)O)=O,,,4,1,2,0,2
5030_1,,,,2,2,1,3
5032_0,,,,2,2,1,3
C(C(CO)(C(C(C=C)=O)O)O)=C,,,4,1,2,0,2
5032_1,,,,2,2,1,3
5034_0,,,,2,2,1,3
C=CC(C(C(C=CC=O)O)O)=O,,,4,1,3,0,3
5034_1,,,,2,2,1,3
5036_0,,,,2,2,1,3
C=CC(C(C(C(C)O)O)O)=O,,,4,1,2,0,2
5036_1,,,,2,2,1,3
5038_0,,,,2,2,1,3
C=CC(C(C1(COCC1O)O)O)=O,,,4,1,2,0,2
5038_1,,,,2,2,1,3
5040_0,,,,2,2,1,3
C1(C(C(C=C)(CO)O)OCC1O)=O,,,4,1,2,0,2
5040_1,,,,2,2,1,3
5042_0,,,,2,2,1,3
C=CC(C(C1(C(O)OCC1)O)O)=O,,,4,1,2,0,2
5042_1,,,,2,2,1,3
5044_0,,,,2,2,1,3
C1(C(O)OCC1C(C=C)(CO)O)=O,,,4,1,2,0,2
5044_1,,,,2,2,1,3
5046_0,,,,2,2,1,3
C1(C(C(C=CC=O)O)OCC1O)=O,,,4,1,2,0,2
5046_1,,,,2,2,1,3
5048_0,,,,2,2,1,3
C1(C(O)OCC1C(C=CC=O)O)=O,,,4,1,2,0,2
5048_1,,,,2,2,1,3
5050_0,,,,2,2,1,3
C(C(C(CO)C(C(C)O)O)=O)(O)=O,,,4,1,2,0,2
5050_1,,,,2,2,1,3
5052_0,,,,2,2,1,3
C(C(C(C(C)O)O)C(C(O)=O)O)=O,,,4,1,2,0,2
5052_1,,,,2,2,1,3
5054_0,,,,2,2,1,3
C1(C(C(C(C)O)O)OCC1O)=O,,,4,1,2,0,2
5054_1,,,,2,2,1,3
5056_0,,,,2,2,1,3
C1(C(O)OCC1C(C(C)O)O)=O,,,4,1,2,0,2
5056_1,,,,2,2,1,3
5058_0,,,,2,2,1,3
C(C(C1(C(C(C(C1)O)O)O)O)O)=O,,,4,1,2,0,2
5058_1,,,,2,2,1,3
5059_0,,,,2,2,1,3
5059_1,,,,2,2,1,3
5061_0,,,,2,2,1,3
C(C(C(CO)(C(C(C)O)O)O)O)=O,,,4,1,2,0,2
5061_1,,,,2,2,1,3
5063_0,,,,2,2,1,3
C(C(C(CO)O)O)(C(C(C)O)O)=O,,,4,1,4,0,4
5063_1,,,,2,2,1,3
5065_0,,,,2,2,1,3
C(C(C(CC(CO)(CO)O)O)O)=O,,,4,1,3,0,3
5065_1,,,,2,2,1,3
5067_0,,,,2,2,1,3
C(C(C(CO)O)C(CO)(CO)O)=O,,,4,1,5,0,5
5067_1,,,,2,2,1,3
5069_0,,,,2,2,1,3
C(C(C(CC(C(CO)O)O)O)O)=O,,,4,1,2,0,2
5069_1,,,,2,2,1,3
5071_0,,,,2,2,1,3
C(C(C(CO)O)C(C(CO)O)O)=O,,,4,1,5,0,5
5071_1,,,,2,2,1,3
5072_0,,,,2,2,1,3
5072_1,,,,2,2,1,3
5074_0,,,,2,2,1,3
C(C(CC(C=O)(C(C=O)O)O)O)=O,,,4,1,4,0,4
5074_1,,,,2,2,1,3
5075_0,,,,2,2,1,3
5075_1,,,,2,2,1,3
5077_0,,,,2,2,1,3
C(C(C(C(C=O)=O)C(CO)O)O)=O,,,4,1,4,0,4
5077_1,,,,2,2,1,3
5078_0,,,,2,2,1,3
5078_1,,,,2,2,1,3
5080_0,,,,2,2,1,3
C(C(CC(C)O)(C(C=O)O)O)=O,,,4,1,2,0,2
5080_1,,,,2,2,1,3
5082_0,,,,2,2,1,3
C(C(C(C(CO)O)C(C)O)=O)=O,,,4,1,4,0,4
5082_1,,,,2,2,1,3
5084_0,,,,2,2,1,3
C(CC(C(C)(C(C=O)O)O)O)=O,,,4,1,3,0,3
5084_1,,,,2,2,1,3
5086_0,,,,2,2,1,3
C(C(C(CC(C(C)=O)O)O)O)=O,,,4,1,2,0,2
5086_1,,,,2,2,1,3
5088_0,,,,2,2,1,3
C(CC(C(CC(CO)O)=O)O)=O,,,4,1,2,0,2
5090_0,,,,2,2,1,3
C(C(C(CO)O)C(C(C)=O)O)=O,,,4,1,6,0,6
5090_1,,,,2,2,1,3
5091_0,,,,2,2,1,3
5091_1,,,,2,2,1,3
5093_0,,,,2,2,1,3
C(C(C)(CC(C(C=O)O)O)O)=O,,,4,1,2,0,2
5093_1,,,,2,2,1,3
5095_0,,,,2,2,1,3
C(C(C(CO)O)C(C=O)(C)O)=O,,,4,1,5,0,5
5095_1,,,,2,2,1,3
5096_0,,,,2,2,1,3
5096_1,,,,2,2,1,3
5097_0,,,,2,2,1,3
5097_1,,,,2,2,1,3
5098_0,,,,2,2,1,3
5098_1,,,,2,2,1,3
5099_0,,,,2,2,1,3
5099_1,,,,2,2,1,3
5101_0,,,,2,2,1,3
C(CC(C(CO)O)(C(C=O)O)O)=O,,,4,1,2,0,2
5101_1,,,,2,2,1,3
5103_0,,,,2,2,1,3
C(C(C(C(CO)O)=O)C(CO)O)=O,,,4,1,4,0,4
5103_1,,,,2,2,1,3
5104_0,,,,2,2,1,3
5104_1,,,,2,2,1,3
5106_0,,,,2,2,1,3
C(C(C(CCO)(C(C=O)O)O)O)=O,,,4,1,2,0,2
5106_1,,,,2,2,1,3
5107_0,,,,2,2,1,3
5107_1,,,,2,2,1,3
5109_0,,,,2,2,1,3
C(C(C(C(CO)O)(CCO)O)O)=O,,,4,1,2,0,2
5109_1,,,,2,2,1,3
5110_0,,,,2,2,1,3
5110_1,,,,2,2,1,3
5111_0,,,,2,2,1,3
5111_1,,,,2,2,1,3
5113_0,,,,2,2,1,3
C(C(C(CO)CO)(C(C=O)O)O)=O,,,4,1,2,0,2
5113_1,,,,2,2,1,3
5115_0,,,,2,2,1,3
C(C(C(CO)(C(CO)CO)O)O)=O,,,4,1,2,0,2
5115_1,,,,2,2,1,3
5116_0,,,,2,2,1,3
5116_1,,,,2,2,1,3
5117_0,,,,2,2,1,3
5117_1,,,,2,2,1,3
5119_0,,,,2,2,1,3
C(C(C(C(CO)C(C=O)O)O)O)=O,,,4,1,5,0,5
5119_1,,,,2,2,1,3
5121_0,,,,2,2,1,3
C(C(C(CCO)O)O)=O,,,4,1,3,0,3
5121_1,,,,2,2,1,3
5123_0,,,,2,2,1,3
C(C(CO)C(CO)O)=O,,,4,1,5,0,5
5123_1,,,,2,2,1,3
5125_0,,,,2,2,1,3
C(CC(C(C(C(C=O)O)O)O)O)=O,,,4,1,5,0,5
5125_1,,,,2,2,1,3
5127_0,,,,2,2,1,3
C(C(C(CC(C(C=O)O)O)O)O)=O,,,4,1,2,0,2
5127_1,,,,2,2,1,3
5129_0,,,,2,2,1,3
C(C(C(C(C=O)O)O)C(CO)O)=O,,,4,1,5,0,5
5129_1,,,,2,2,1,3
5131_0,,,,2,2,1,3
C(C(C(CO)(CC(C)O)O)O)=O,,,4,1,2,0,2
5131_1,,,,2,2,1,3
5133_0,,,,2,2,1,3
C(CO)(C(C(CO)O)C(C)O)=O,,,4,1,5,0,5
5133_1,,,,2,2,1,3
5135_0,,,,2,2,1,3
C(C(C(CO)O)O)(CC(C)O)=O,,,4,1,4,0,4
5135_1,,,,2,2,1,3
5137_0,,,,2,2,1,3
C(C(C(C)(C(C(C)O)O)O)O)=O,,,4,1,2,0,2
5137_1,,,,2,2,1,3
5139_0,,,,2,2,1,3
C(C(C(C)O)O)(CC(CO)O)=O,,,4,1,4,0,4
5141_0,,,,2,2,1,3
C(C(C(CC(CO)(C)O)O)O)=O,,,4,1,2,0,2
5141_1,,,,2,2,1,3
5143_0,,,,2,2,1,3
C(C(C(CO)O)C(C)(CO)O)=O,,,4,1,5,0,5
5143_1,,,,2,2,1,3
5145_0,,,,2,2,1,3
C(C(C(CC(C)O)O)O)=O,,,4,1,2,0,2
5145_1,,,,2,2,1,3
5147_0,,,,2,2,1,3
C(C(C(CO)O)C(C)O)=O,,,4,1,5,0,5
5147_1,,,,2,2,1,3
5149_0,,,,2,2,1,3
C(C(C)(C(C(C(C=O)O)O)O)O)=O,,,4,1,5,0,5
5149_1,,,,2,2,1,3
5150_0,,,,2,2,1,3
5150_1,,,,2,2,1,3
5151_0,,,,2,2,1,3
5151_1,,,,2,2,1,3
5153_0,,,,2,2,1,3
C(C(CC(CO)O)(C(C=O)O)O)=O,,,4,1,2,0,2
5153_1,,,,2,2,1,3
5155_0,,,,2,2,1,3
C(C(C(C(CO)O)C(CO)O)=O)=O,,,4,1,2,0,2
5155_1,,,,2,2,1,3
5157_0,,,,2,2,1,3
C(C(C(C(C(CO)(C)O)O)O)O)=O,,,4,1,4,0,4
5157_1,,,,2,2,1,3
5159_0,,,,2,2,1,3
C(C(C(CO)(CC(CO)O)O)O)=O,,,4,1,3,0,3
5159_1,,,,2,2,1,3
5161_0,,,,2,2,1,3
C(CO)(C(C(CO)O)C(CO)O)=O,,,4,1,3,0,3
5161_1,,,,2,2,1,3
5163_0,,,,2,2,1,3
C(C(C(CO)O)O)(CC(CO)O)=O,,,4,1,5,0,5
5163_1,,,,2,2,1,3
5165_0,,,,2,2,1,3
C(C(C(C)(C(C(CO)O)O)O)O)=O,,,4,1,5,0,5
5165_1,,,,2,2,1,3
5166_0,,,,2,2,1,3
5168_0,,,,2,2,1,3
C(C(C(C(C(C)O)O)O)O)=O,,,4,1,5,0,5
5168_1,,,,2,2,1,3
5169_0,,,,2,2,1,3
5169_1,,,,2,2,1,3
5171_0,,,,2,2,1,3
C(C(C(CO)O)C(CO)O)=O,,,4,1,4,0,4
5171_1,,,,2,2,1,3
5172_0,,,,2,2,1,3
5172_1,,,,2,2,1,3
5173_0,,,,2,2,1,3
5173_1,,,,2,2,1,3
5174_0,,,,2,2,1,3
5174_1,,,,2,2,1,3
5175_0,,,,2,2,1,3
5175_1,,,,2,2,1,3
5177_0,,,,2,2,1,3
C(C(C(C(CO)O)O)=O)=O,,,4,1,4,0,4
5177_1,,,,2,2,1,3
5179_0,,,,2,2,1,3
C(C(C(CC(C(CO)=O)O)O)O)=O,,,4,1,3,0,3
5179_1,,,,2,2,1,3
5181_0,,,,2,2,1,3
C(CC(C(CO)(C(C=O)O)O)O)=O,,,4,1,6,0,6
5181_1,,,,2,2,1,3
5182_0,,,,2,2,1,3
5182_1,,,,2,2,1,3
5184_0,,,,2,2,1,3
C(CC(C(C(C(CO)O)O)=O)O)=O,,,4,1,4,0,4
5184_1,,,,2,2,1,3
5185_0,,,,2,2,1,3
5185_1,,,,2,2,1,3
5187_0,,,,2,2,1,3
C(CO)(C(C)(C(C=O)O)O)=O,,,4,1,6,0,6
5187_1,,,,2,2,1,3
5188_0,,,,2,2,1,3
5188_1,,,,2,2,1,3
5189_0,,,,2,2,1,3
5191_0,,,,2,2,1,3
C(C(C(CO)(CC(CO)=O)O)O)=O,,,4,1,7,0,7
5191_1,,,,2,2,1,3
5193_0,,,,2,2,1,3
C(C(C(CO)O)O)(CC(CO)=O)=O,,,4,1,4,0,4
5193_1,,,,2,2,1,3
5195_0,,,,2,2,1,3
C(CO)(C(C(CO)=O)C(CO)O)=O,,,4,1,3,0,3
5195_1,,,,2,2,1,3
5197_0,,,,2,2,1,3
C(C(C(CO)(C(C(C)=O)O)O)O)=O,,,4,1,10,0,10
5197_1,,,,2,2,1,3
5198_0,,,,2,2,1,3
5198_1,,,,2,2,1,3
5200_0,,,,2,2,1,3
C(C(C(CO)O)O)(C(C(C)=O)O)=O,,,4,1,3,0,3
5200_1,,,,2,2,1,3
5202_0,,,,2,2,1,3
C(CC(CO)O)(C(C(CO)=O)O)=O,,,4,1,3,0,3
5203_0,,,,2,2,1,3
5203_1,,,,2,2,1,3
5204_0,,,,2,2,1,3
5204_1,,,,2,2,1,3
5206_0,,,,2,2,1,3
C(C(C(CO)(C(C)O)O)O)=O,,,4,1,6,0,6
5206_1,,,,2,2,1,3
5207_0,,,,2,2,1,3
5207_1,,,,2,2,1,3
5208_0,,,,2,2,1,3
5208_1,,,,2,2,1,3
5210_0,,,,2,2,1,3
C(C(C=O)C(CO)O)=O,,,4,1,3,0,3
5210_1,,,,2,2,1,3
5212_0,,,,2,2,1,3
C(C(C(CO)(C(C=O)O)O)O)=O,,,4,1,6,0,6
5212_1,,,,2,2,1,3
5213_0,,,,2,2,1,3
5213_1,,,,2,2,1,3
5214_0,,,,2,2,1,3
5214_1,,,,2,2,1,3
5215_0,,,,2,2,1,3
5215_1,,,,2,2,1,3
5217_0,,,,2,2,1,3
C(C(C)(C(C=O)O)O)(O)=O,,,4,1,4,0,4
5217_1,,,,2,2,1,3
5219_0,,,,2,2,1,3
C(C(CC(CO)O)=O)(O)=O,,,4,1,3,0,3
5220_0,,,,2,2,1,3
5220_1,,,,2,2,1,3
5222_0,,,,2,2,1,3
C(CC(CO)(C(C=O)O)O)(O)=O,,,4,1,3,0,3
5222_1,,,,2,2,1,3
5223_0,,,,2,2,1,3
5223_1,,,,2,2,1,3
5224_0,,,,2,2,1,3
5224_1,,,,2,2,1,3
5225_0,,,,2,2,1,3
5225_1,,,,2,2,1,3
5226_0,,,,2,2,1,3
5227_0,,,,2,2,1,3
5227_1,,,,2,2,1,3
5228_0,,,,2,2,1,3
5228_1,,,,2,2,1,3
5229_0,,,,2,2,1,3
5229_1,,,,2,2,1,3
5230_0,,,,2,2,1,3
5230_1,,,,2,2,1,3
5232_0,,,,2,2,1,3
C(C(C(C(CC(C)=O)=O)O)O)=O,,,4,1,4,0,4
5232_1,,,,2,2,1,3
5234_0,,,,2,2,1,3
C(C(C(C=O)(CC(C)=O)O)O)=O,,,4,1,2,0,2
5234_1,,,,2,2,1,3
5235_0,,,,2,2,1,3
5235_1,,,,2,2,1,3
5237_0,,,,2,2,1,3
C(C)(C(C(C=O)=O)C(CO)O)=O,,,4,1,3,0,3
5237_1,,,,2,2,1,3
5239_0,,,,2,2,1,3
C(CC(CO)O)(CC(C=O)=O)=O,,,4,1,3,0,3
5240_0,,,,2,2,1,3
5240_1,,,,2,2,1,3
5241_0,,,,2,2,1,3
5241_1,,,,2,2,1,3
5242_0,,,,2,2,1,3
5242_1,,,,2,2,1,3
5244_0,,,,2,2,1,3
C(C(C(C=O)=O)C(CO)O)=O,,,4,1,3,0,3
5244_1,,,,2,2,1,3
5246_0,,,,2,2,1,3
C(C(C(CC(C(C)=O)=O)O)O)=O,,,4,1,5,0,5
5246_1,,,,2,2,1,3
5248_0,,,,2,2,1,3
C(CC(C(C)=O)(C(C=O)O)O)=O,,,4,1,4,0,4
5248_1,,,,2,2,1,3
5250_0,,,,2,2,1,3
C(C(C)(C(C=O)O)O)(CC=O)=O,,,4,1,3,0,3
5250_1,,,,2,2,1,3
5252_0,,,,2,2,1,3
C(C(C(C(C)=O)=O)C(CO)O)=O,,,4,1,3,0,3
5252_1,,,,2,2,1,3
5254_0,,,,2,2,1,3
C(CC(C(CC(CO)O)=O)=O)=O,,,4,1,4,0,4
5256_0,,,,2,2,1,3
C(C)(C(C)(C(C=O)O)O)=O,,,4,1,3,0,3
5256_1,,,,2,2,1,3
5257_0,,,,2,2,1,3
5258_0,,,,2,2,1,3
5258_1,,,,2,2,1,3
5260_0,,,,2,2,1,3
C(C(C(CC(C)=O)O)O)=O,,,4,1,3,0,3
5260_1,,,,2,2,1,3
5261_0,,,,2,2,1,3
5263_0,,,,2,2,1,3
C(C(C(C)=O)C(CO)O)=O,,,4,1,4,0,4
5263_1,,,,2,2,1,3
5265_0,,,,2,2,1,3
C(C(C1(COC(C1)O)O)O)=O,,,4,1,3,0,3
5265_1,,,,2,2,1,3
5267_0,,,,2,2,1,3
C1(COC(C1C(CO)O)O)=O,,,4,1,4,0,4
5267_1,,,,2,2,1,3
5268_0,,,,2,2,1,3
5268_1,,,,2,2,1,3
5270_0,,,,2,2,1,3
C(C(C1(COC(C(C1)O)O)O)O)=O,,,4,1,3,0,3
5270_1,,,,2,2,1,3
5272_0,,,,2,2,1,3
C1(COC(C(C1C(CO)O)O)O)=O,,,4,1,3,0,3
5272_1,,,,2,2,1,3
5274_0,,,,2,2,1,3
C1(C(C(CO)O)OC(C(C1)O)O)=O,,,4,1,3,0,3
5274_1,,,,2,2,1,3
5276_0,,,,2,2,1,3
C(C(C(C=CC(CO)=O)O)O)=O,,,4,1,3,0,3
5276_1,,,,2,2,1,3
5278_0,,,,2,2,1,3
C(C(C(C=CC=O)(CO)O)O)=O,,,4,1,3,0,3
5278_1,,,,2,2,1,3
5280_0,,,,2,2,1,3
C(C=CC(C(C(CO)O)O)=O)=O,,,4,1,3,0,3
5280_1,,,,2,2,1,3
5281_0,,,,2,2,1,3
5281_1,,,,2,2,1,3
5283_0,,,,2,2,1,3
C(C(C=C)(C(C=O)O)O)=O,,,4,1,4,0,4
5283_1,,,,2,2,1,3
5285_0,,,,2,2,1,3
C(C(C(C=C)(CO)O)O)=O,,,4,1,3,0,3
5285_1,,,,2,2,1,3
5286_0,,,,2,2,1,3
5286_1,,,,2,2,1,3
5287_0,,,,2,2,1,3
5287_1,,,,2,2,1,3
5289_0,,,,2,2,1,3
C(C(C(C(CC(C=O)O)O)O)O)=O,,,4,1,5,0,5
5289_1,,,,2,2,1,3
5291_0,,,,2,2,1,3
C(C(C(C(C(C(C)O)=O)O)O)O)=O,,,4,1,5,0,5
5291_1,,,,2,2,1,3
5293_0,,,,2,2,1,3
C(C(C(C(C)O)(C(C=O)O)O)O)=O,,,4,1,2,0,2
5293_1,,,,2,2,1,3
5295_0,,,,2,2,1,3
C(C(C(C(C)O)O)O)=O,,,4,1,4,0,4
5295_1,,,,2,2,1,3
5297_0,,,,2,2,1,3
C(C(CCO)(C(C=O)O)O)(O)=O,,,4,1,4,0,4
5297_1,,,,2,2,1,3
5299_0,,,,2,2,1,3
C(C(C(CO)C(CO)O)=O)(O)=O,,,4,1,4,0,4
5299_1,,,,2,2,1,3
5300_0,,,,2,2,1,3
5300_1,,,,2,2,1,3
5301_0,,,,2,2,1,3
5301_1,,,,2,2,1,3
5303_0,,,,2,2,1,3
C(C(C(C(CO)(CO)O)O)O)=O,,,4,1,5,0,5
5303_1,,,,2,2,1,3
5305_0,,,,2,2,1,3
C(C(C(C(CO)(C(C)O)O)O)O)=O,,,4,1,2,0,2
5305_1,,,,2,2,1,3
5306_0,,,,2,2,1,3
5306_1,,,,2,2,1,3
5307_0,,,,2,2,1,3
5307_1,,,,2,2,1,3
5308_0,,,,2,2,1,3
5310_0,,,,2,2,1,3
C(C(C(C)(C(CO)(CO)O)O)O)=O,,,4,1,3,0,3
5310_1,,,,2,2,1,3
5311_0,,,,2,2,1,3
5312_0,,,,2,2,1,3
5312_1,,,,2,2,1,3
5314_0,,,,2,2,1,3
C(C(C(C(C=O)O)O)(C(C)O)O)=O,,,4,1,6,0,6
5314_1,,,,2,2,1,3
5316_0,,,,2,2,1,3
C(CC(CO)(C(C(C=O)O)O)O)=O,,,4,1,8,0,8
5316_1,,,,2,2,1,3
5317_0,,,,2,2,1,3
5317_1,,,,2,2,1,3
5318_0,,,,2,2,1,3
5318_1,,,,2,2,1,3
5320_0,,,,2,2,1,3
C(C(C(C(C=CC(C)=O)=O)O)O)=O,,,4,1,2,0,2
5320_1,,,,2,2,1,3
5322_0,,,,2,2,1,3
C(C(C=CC(C)=O)(C(C=O)O)O)=O,,,4,1,2,0,2
5322_1,,,,2,2,1,3
5324_0,,,,2,2,1,3
C(C(C(C=CC(C=O)=O)(C)O)O)=O,,,4,1,2,0,2
5324_1,,,,2,2,1,3
5326_0,,,,2,2,1,3
C(C(C=CC(CC(CO)O)=O)=O)=O,,,4,1,1,0,1
5328_0,,,,2,2,1,3
C(CC=CC(C(C(C=O)O)O)=O)=O,,,4,1,2,0,2
5328_1,,,,2,2,1,3
5330_0,,,,2,2,1,3
C(C(C=CCC=O)(C(C=O)O)O)=O,,,4,1,2,0,2
5330_1,,,,2,2,1,3
5332_0,,,,2,2,1,3
C(C(C(CC=CC(C=O)=O)O)O)=O,,,4,1,2,0,2
5332_1,,,,2,2,1,3
5334_0,,,,2,2,1,3
C(C(C=CC(C=O)=O)C(CO)O)=O,,,4,1,1,0,1
5336_0,,,,2,2,1,3
C(C(C(C=CC(C(C)=O)=O)O)O)=O,,,4,1,2,0,2
5336_1,,,,2,2,1,3
5338_0,,,,2,2,1,3
C(C(C(C(C)=O)(C=CC=O)O)O)=O,,,4,1,2,0,2
5338_1,,,,2,2,1,3
5340_0,,,,2,2,1,3
C(C(C(C(C=CC=O)=O)(C)O)O)=O,,,4,1,2,0,2
5340_1,,,,2,2,1,3
5342_0,,,,2,2,1,3
C(C(C=CC=O)=O)(CC(CO)O)=O,,,4,1,1,0,1
5344_0,,,,2,2,1,3
C(CC(C=CC(C(C=O)O)O)=O)=O,,,4,1,2,0,2
5344_1,,,,2,2,1,3
5346_0,,,,2,2,1,3
C(CC(C=CC=O)(C(C=O)O)O)=O,,,4,1,2,0,2
5346_1,,,,2,2,1,3
5348_0,,,,2,2,1,3
C(C(C(CC(C=CC=O)=O)O)O)=O,,,4,1,2,0,2
5348_1,,,,2,2,1,3
5350_0,,,,2,2,1,3
C(C(C(C=CC=O)=O)C(CO)O)=O,,,4,1,2,0,2
5350_1,,,,2,2,1,3
5352_0,,,,2,2,1,3
C(C(C(C(CC(C=C)=O)=O)O)O)=O,,,4,1,2,0,2
5352_1,,,,2,2,1,3
5354_0,,,,2,2,1,3
C(C(C(C=O)(CC(C=C)=O)O)O)=O,,,4,1,2,0,2
5354_1,,,,2,2,1,3
5356_0,,,,2,2,1,3
C(C(C(C=C)(CC(C=O)=O)O)O)=O,,,4,1,2,0,2
5356_1,,,,2,2,1,3
5358_0,,,,2,2,1,3
C=CC(C(C(C=O)=O)C(CO)O)=O,,,4,1,2,0,2
5358_1,,,,2,2,1,3
5360_0,,,,2,2,1,3
C(C(C(CC(C(C=C)=O)=O)O)O)=O,,,4,1,2,0,2
5360_1,,,,2,2,1,3
5362_0,,,,2,2,1,3
C(CC(C(C=C)=O)(C(C=O)O)O)=O,,,4,1,2,0,2
5362_1,,,,2,2,1,3
5364_0,,,,2,2,1,3
C(CC=O)(C(C=C)(C(C=O)O)O)=O,,,4,1,2,0,2
5364_1,,,,2,2,1,3
5366_0,,,,2,2,1,3
C(C(C(C(C=C)=O)=O)C(CO)O)=O,,,4,1,2,0,2
5366_1,,,,2,2,1,3
5368_0,,,,2,2,1,3
C(C(C(C(CC=CC=O)=O)O)O)=O,,,4,1,2,0,2
5368_1,,,,2,2,1,3
5370_0,,,,2,2,1,3
C(C(C(C=O)(CC=CC=O)O)O)=O,,,4,1,2,0,2
5370_1,,,,2,2,1,3
5372_0,,,,2,2,1,3
C(C(C(C=CCC(C=O)=O)O)O)=O,,,4,1,2,0,2
5372_1,,,,2,2,1,3
5374_0,,,,2,2,1,3
C(C(C(C=O)=O)C(CO)O)=CC=O,,,4,1,1,0,1
5376_0,,,,2,2,1,3
C(C(C1(COCC1O)O)O)=O,,,4,1,2,0,2
5376_1,,,,2,2,1,3
5377_0,,,,2,2,1,3
5377_1,,,,2,2,1,3
5379_0,,,,2,2,1,3
C(C(C1(C(O)OCC1)O)O)=O,,,4,1,3,0,3
5379_1,,,,2,2,1,3
5381_0,,,,2,2,1,3
C1(C(O)OCC1C(CO)O)=O,,,4,1,3,0,3
5381_1,,,,2,2,1,3
5382_0,,,,2,2,1,3
5382_1,,,,2,2,1,3
5384_0,,,,2,2,1,3
C(C(C=O)C(C(C(CO)O)O)O)=O,,,4,1,2,0,2
5384_1,,,,2,2,1,3
5385_0,,,,2,2,1,3
5385_1,,,,2,2,1,3
5387_0,,,,2,2,1,3
C(C(CO)C(CO)(CO)O)=O,,,4,1,4,0,4
5387_1,,,,2,2,1,3
5389_0,,,,2,2,1,3
C(CO)(C(C(CC(C)O)O)O)=O,,,4,1,2,0,2
5389_1,,,,2,2,1,3
5391_0,,,,2,2,1,3
C(C(C(C)O)C(CO)(CO)O)=O,,,4,1,4,0,4
5391_1,,,,2,2,1,3
5393_0,,,,2,2,1,3
C(CO)(C(C(C(C(C)O)O)O)O)=O,,,4,1,2,0,2
5393_1,,,,2,2,1,3
5395_0,,,,2,2,1,3
C(CO)(C(C(CC(CO)O)O)O)=O,,,4,1,3,0,3
5395_1,,,,2,2,1,3
5396_0,,,,2,2,1,3
5396_1,,,,2,2,1,3
5398_0,,,,2,2,1,3
C(C(CO)(C(C(CO)=O)O)O)=O,,,4,1,7,0,7
5398_1,,,,2,2,1,3
5400_0,,,,2,2,1,3
C(CO)(C(C(C(CO)=O)O)O)=O,,,4,1,3,0,3
5400_1,,,,2,2,1,3
5402_0,,,,2,2,1,3
C(C(C(C(CO)(CO)O)O)=O)=O,,,4,1,2,0,2
5402_1,,,,2,2,1,3
5403_0,,,,2,2,1,3
5403_1,,,,2,2,1,3
5405_0,,,,2,2,1,3
C(CO)(C(C)(C(C(CO)=O)O)O)=O,,,4,1,4,0,4
5405_1,,,,2,2,1,3
5407_0,,,,2,2,1,3
C(C(C)=O)(C(C(CO)(CO)O)O)=O,,,4,1,2,0,2
5407_1,,,,2,2,1,3
5409_0,,,,2,2,1,3
C(C(CO)=O)(CC(CO)(CO)O)=O,,,4,1,2,0,2
5410_0,,,,2,2,1,3
5410_1,,,,2,2,1,3
5412_0,,,,2,2,1,3
C(C(C(C)O)(C(C(CO)=O)O)O)=O,,,4,1,6,0,6
5412_1,,,,2,2,1,3
5414_0,,,,2,2,1,3
C(CO)(C(C(CO)(C(C)O)O)O)=O,,,4,1,2,0,2
5414_1,,,,2,2,1,3
5416_0,,,,2,2,1,3
C(C(C(CO)(CO)O)O)(C(C)O)=O,,,4,1,3,0,3
5416_1,,,,2,2,1,3
5417_0,,,,2,2,1,3
5417_1,,,,2,2,1,3
5419_0,,,,2,2,1,3
C(C(C=O)C(CO)(CO)O)=O,,,4,1,3,0,3
5419_1,,,,2,2,1,3
5421_0,,,,2,2,1,3
C(CO)(C(C(C(CCO)O)O)O)=O,,,4,1,3,0,3
5421_1,,,,2,2,1,3
5423_0,,,,2,2,1,3
C(C(C)(C(C(CO)=O)O)O)(O)=O,,,4,1,4,0,4
5423_1,,,,2,2,1,3
5425_0,,,,2,2,1,3
C(C(CC(CO)(CO)O)=O)(O)=O,,,4,1,2,0,2
5427_0,,,,2,2,1,3
C(C(C(CO)=O)O)(O)=O,,,4,1,5,0,5
5427_1,,,,2,2,1,3
5429_0,,,,2,2,1,3
C(C(C(C(CO)=O)O)O)(O)=O,,,4,1,5,0,5
5429_1,,,,2,2,1,3
5431_0,,,,2,2,1,3
C(C(C(C(C(CO)=O)O)O)O)(O)=O,,,4,1,5,0,5
5431_1,,,,2,2,1,3
5433_0,,,,2,2,1,3
C(CC(C(C(C(CO)=O)O)O)=O)=O,,,4,1,5,0,5
5433_1,,,,2,2,1,3
5435_0,,,,2,2,1,3
C(CC(C=O)(C(C(CO)=O)O)O)=O,,,4,1,4,0,4
5435_1,,,,2,2,1,3
5437_0,,,,2,2,1,3
C(CO)(C(C(CC(C=O)=O)O)O)=O,,,4,1,4,0,4
5437_1,,,,2,2,1,3
5439_0,,,,2,2,1,3
C(C(C(C=O)=O)C(CO)(CO)O)=O,,,4,1,2,0,2
5439_1,,,,2,2,1,3
5441_0,,,,2,2,1,3
C(C)(C(C)(C(C(CO)=O)O)O)=O,,,4,1,3,0,3
5441_1,,,,2,2,1,3
5443_0,,,,2,2,1,3
C(C(C)=O)(CC(CO)(CO)O)=O,,,4,1,3,0,3
5445_0,,,,2,2,1,3
C(CC(C)(C(C(CO)=O)O)O)=O,,,4,1,5,0,5
5445_1,,,,2,2,1,3
5447_0,,,,2,2,1,3
C(C)(CC(C(C(CO)=O)O)O)=O,,,4,1,2,0,2
5447_1,,,,2,2,1,3
5449_0,,,,2,2,1,3
C(CC(CC(CO)(CO)O)=O)=O,,,4,1,3,0,3
5451_0,,,,2,2,1,3
C(C(C(C)=O)C(CO)(CO)O)=O,,,4,1,3,0,3
5451_1,,,,2,2,1,3
5453_0,,,,2,2,1,3
C(CO)(C(C1(COC(C1)O)O)O)=O,,,4,1,3,0,3
5453_1,,,,2,2,1,3
5455_0,,,,2,2,1,3
C1(COC(C1C(CO)(CO)O)O)=O,,,4,1,3,0,3
5455_1,,,,2,2,1,3
5457_0,,,,2,2,1,3
C1(C(C(CO)(CO)O)OC(C1)O)=O,,,4,1,3,0,3
5457_1,,,,2,2,1,3
5458_0,,,,2,2,1,3
5458_1,,,,2,2,1,3
5460_0,,,,2,2,1,3
C(C(C=C)(C(C(CO)=O)O)O)=O,,,4,1,3,0,3
5460_1,,,,2,2,1,3
5462_0,,,,2,2,1,3
C(C(C(C=C)(CO)O)O)(CO)=O,,,4,1,3,0,3
5462_1,,,,2,2,1,3
5464_0,,,,2,2,1,3
C=CC(C(C(CO)(CO)O)O)=O,,,4,1,4,0,4
5464_1,,,,2,2,1,3
5466_0,,,,2,2,1,3
C(CO)(C(C(C=CC=O)O)O)=O,,,4,1,4,0,4
5466_1,,,,2,2,1,3
5468_0,,,,2,2,1,3
C(CO)(C(C(C(C)O)O)O)=O,,,4,1,3,0,3
5468_1,,,,2,2,1,3
5470_0,,,,2,2,1,3
C(CO)(C(C1(COCC1O)O)O)=O,,,4,1,2,0,2
5470_1,,,,2,2,1,3
5472_0,,,,2,2,1,3
C1(C(C(CO)(CO)O)OCC1O)=O,,,4,1,2,0,2
5472_1,,,,2,2,1,3
5474_0,,,,2,2,1,3
C(CO)(C(C1(C(O)OCC1)O)O)=O,,,4,1,3,0,3
5474_1,,,,2,2,1,3
5476_0,,,,2,2,1,3
C1(C(O)OCC1C(CO)(CO)O)=O,,,4,1,3,0,3
5476_1,,,,2,2,1,3
5478_0,,,,2,2,1,3
C(C(CO)C(C(CO)O)O)=O,,,4,1,4,0,4
5478_1,,,,2,2,1,3
5480_0,,,,2,2,1,3
C(C(C(C)O)C(C(CO)O)O)=O,,,4,1,4,0,4
5480_1,,,,2,2,1,3
5481_0,,,,2,2,1,3
5481_1,,,,2,2,1,3
5482_0,,,,2,2,1,3
5482_1,,,,2,2,1,3
5484_0,,,,2,2,1,3
C(C(C)=O)(C(C(C(CO)O)O)O)=O,,,4,1,2,0,2
5484_1,,,,2,2,1,3
5486_0,,,,2,2,1,3
C(C(CO)=O)(CC(C(CO)O)O)=O,,,4,1,5,0,5
5488_0,,,,2,2,1,3
C(C(C(C(CO)O)O)O)(C(C)O)=O,,,4,1,3,0,3
5488_1,,,,2,2,1,3
5490_0,,,,2,2,1,3
C(C(C=O)C(C(CO)O)O)=O,,,4,1,3,0,3
5490_1,,,,2,2,1,3
5491_0,,,,2,2,1,3
5493_0,,,,2,2,1,3
C(C(C(C=O)=O)C(C(CO)O)O)=O,,,4,1,2,0,2
5493_1,,,,2,2,1,3
5495_0,,,,2,2,1,3
C(C(C)=O)(CC(C(CO)O)O)=O,,,4,1,3,0,3
5497_0,,,,2,2,1,3
C(CC(CC(C(CO)O)O)=O)=O,,,4,1,2,0,2
5499_0,,,,2,2,1,3
C(C(C(C)=O)C(C(CO)O)O)=O,,,4,1,3,0,3
5499_1,,,,2,2,1,3
5501_0,,,,2,2,1,3
C1(COC(C1C(C(CO)O)O)O)=O,,,4,1,3,0,3
5501_1,,,,2,2,1,3
5503_0,,,,2,2,1,3
C1(C(C(C(CO)O)O)OC(C1)O)=O,,,4,1,3,0,3
5503_1,,,,2,2,1,3
5505_0,,,,2,2,1,3
C=CC(C(C(C(CO)O)O)O)=O,,,4,1,3,0,3
5505_1,,,,2,2,1,3
5507_0,,,,2,2,1,3
C1(C(C(C(CO)O)O)OCC1O)=O,,,4,1,2,0,2
5507_1,,,,2,2,1,3
5509_0,,,,2,2,1,3
C1(C(O)OCC1C(C(CO)O)O)=O,,,4,1,3,0,3
5509_1,,,,2,2,1,3
5510_0,,,,2,2,1,3
5512_0,,,,2,2,1,3
C(C(CC(C)O)(CC(C=O)=O)O)=O,,,4,1,1,0,1
5513_0,,,,2,2,1,3
5513_1,,,,2,2,1,3
5515_0,,,,2,2,1,3
C(C(C)(C(C(C=O)=O)C(C)O)O)=O,,,4,1,4,0,4
5515_1,,,,2,2,1,3
5517_0,,,,2,2,1,3
C(CC(C(C)(CC(C=O)=O)O)O)=O,,,4,1,2,0,2
5519_0,,,,2,2,1,3
C(C)(C(CC(CC(C=O)=O)O)O)=O,,,4,1,1,0,1
5520_0,,,,2,2,1,3
5522_0,,,,2,2,1,3
C(CC(C(CC(C=O)(C)O)=O)O)=O,,,4,1,2,0,2
5524_0,,,,2,2,1,3
C(C(C(C(C)=O)O)C(C(C)=O)O)=O,,,4,1,2,0,2
5524_1,,,,2,2,1,3
5526_0,,,,2,2,1,3
C(C(C(C=O)C(C=O)(C)O)O)(C)=O,,,4,1,4,0,4
5526_1,,,,2,2,1,3
5527_0,,,,2,2,1,3
5529_0,,,,2,2,1,3
C(C(C)(CC(CC(C=O)=O)O)O)=O,,,4,1,1,0,1
5530_0,,,,2,2,1,3
5530_1,,,,2,2,1,3
5532_0,,,,2,2,1,3
C(C(C)(C(C=O)C(C=O)(C)O)O)=O,,,4,1,2,0,2
5532_1,,,,2,2,1,3
5533_0,,,,2,2,1,3
5535_0,,,,2,2,1,3
C(C(CO)C(C(C)=O)O)=O,,,4,1,5,0,5
5535_1,,,,2,2,1,3
5537_0,,,,2,2,1,3
C(C(CO)C(C=O)(C)O)=O,,,4,1,4,0,4
5537_1,,,,2,2,1,3
5539_0,,,,2,2,1,3
C(C(CC(CO)(CC(C)O)O)=O)=O,,,4,1,1,0,1
5541_0,,,,2,2,1,3
C(CO)(C(C(C)O)C(C(C)=O)O)=O,,,4,1,5,0,5
5541_1,,,,2,2,1,3
5543_0,,,,2,2,1,3
C(C(C)(C(C(CO)=O)C(C)O)O)=O,,,4,1,4,0,4
5543_1,,,,2,2,1,3
5545_0,,,,2,2,1,3
C(C(C(C(CC(C)O)=O)O)O)(C)=O,,,4,1,5,0,5
5545_1,,,,2,2,1,3
5547_0,,,,2,2,1,3
C(C(C)(C(C(CC(C)O)=O)O)O)=O,,,4,1,4,0,4
5547_1,,,,2,2,1,3
5549_0,,,,2,2,1,3
C(C(CC(C)(C(C(C)O)O)O)=O)=O,,,4,1,1,0,1
5551_0,,,,2,2,1,3
C(CC(C(C)=O)O)(C(C(C)O)O)=O,,,4,1,3,0,3
5553_0,,,,2,2,1,3
C(C(C)(CC(C(C(C)O)O)=O)O)=O,,,4,1,3,0,3
5555_0,,,,2,2,1,3
C(C(CC(CC(C)(CO)O)O)=O)=O,,,4,1,1,0,1
5557_0,,,,2,2,1,3
C(C(C(CO)(C)O)C(C(C)=O)O)=O,,,4,1,4,0,4
5557_1,,,,2,2,1,3
5559_0,,,,2,2,1,3
C(C(C(CO)(C)O)C(C=O)(C)O)=O,,,4,1,4,0,4
5559_1,,,,2,2,1,3
5561_0,,,,2,2,1,3
C(C(CC(CC(C)O)O)=O)=O,,,4,1,1,0,1
5563_0,,,,2,2,1,3
C(C(C(C)O)C(C(C)=O)O)=O,,,4,1,4,0,4
5563_1,,,,2,2,1,3
5565_0,,,,2,2,1,3
C(C(C(C)O)C(C=O)(C)O)=O,,,4,1,4,0,4
5565_1,,,,2,2,1,3
5567_0,,,,2,2,1,3
C(C(CC(C(C(C)O)O)O)=O)=O,,,4,1,1,0,1
5569_0,,,,2,2,1,3
C(C(CC(CC(CO)O)O)=O)=O,,,4,1,2,0,2
5570_0,,,,2,2,1,3
5570_1,,,,2,2,1,3
5571_0,,,,2,2,1,3
5571_1,,,,2,2,1,3
5573_0,,,,2,2,1,3
C(C(C(CO)O)(CC(C=O)=O)O)=O,,,4,1,2,0,2
5575_0,,,,2,2,1,3
C(C(CC(C=O)=O)O)(C(CO)O)=O,,,4,1,1,0,1
5577_0,,,,2,2,1,3
C(C(CO)(CC(C=O)=O)O)=O,,,4,1,3,0,3
5579_0,,,,2,2,1,3
C(CO)(C(CC(C=O)=O)O)=O,,,4,1,5,0,5
5580_0,,,,2,2,1,3
5580_1,,,,2,2,1,3
5582_0,,,,2,2,1,3
C(C(C)(C(C(C=O)=O)O)O)=O,,,4,1,2,0,2
5582_1,,,,2,2,1,3
5583_0,,,,2,2,1,3
5585_0,,,,2,2,1,3
C(CO)(C(C)(CC(C=O)=O)O)=O,,,4,1,2,0,2
5587_0,,,,2,2,1,3
C(C)(C(C(C(C(C)=O)=O)O)O)=O,,,4,1,3,0,3
5587_1,,,,2,2,1,3
5589_0,,,,2,2,1,3
C(C(C)(C(C(C(C)=O)=O)O)O)=O,,,4,1,3,0,3
5589_1,,,,2,2,1,3
5591_0,,,,2,2,1,3
C(C)(C(CC(C(CO)=O)=O)O)=O,,,4,1,3,0,3
5593_0,,,,2,2,1,3
C(C(C)(CC(C(CO)=O)=O)O)=O,,,4,1,2,0,2
5595_0,,,,2,2,1,3
C(C(CC(C=O)=O)O)(C(C)O)=O,,,4,1,2,0,2
5597_0,,,,2,2,1,3
C(C(C(C)O)(CC(C=O)=O)O)=O,,,4,1,2,0,2
5599_0,,,,2,2,1,3
C(C(CC(CO)(C(C)O)O)=O)=O,,,4,1,1,0,1
5601_0,,,,2,2,1,3
C(C(C(C(C(C)O)=O)O)O)(C)=O,,,4,1,5,0,5
5601_1,,,,2,2,1,3
5603_0,,,,2,2,1,3
C(C(C)(C(C(C(C)O)=O)O)O)=O,,,4,1,3,0,3
5603_1,,,,2,2,1,3
5604_0,,,,2,2,1,3
5606_0,,,,2,2,1,3
C(C(C=O)C(C(C)=O)O)=O,,,4,1,4,0,4
5606_1,,,,2,2,1,3
5608_0,,,,2,2,1,3
C(C(C=O)C(C=O)(C)O)=O,,,4,1,3,0,3
5608_1,,,,2,2,1,3
5610_0,,,,2,2,1,3
C(C(C(CO)(CC(C=O)=O)O)O)=O,,,4,1,1,0,1
5611_0,,,,2,2,1,3
5613_0,,,,2,2,1,3
C(C(C(C(C(C(C)=O)O)O)=O)O)=O,,,4,1,2,0,2
5613_1,,,,2,2,1,3
5615_0,,,,2,2,1,3
C(C(C)(C(C(C(C=O)O)=O)O)O)=O,,,4,1,2,0,2
5615_1,,,,2,2,1,3
5617_0,,,,2,2,1,3
C(C(CC(C(CCO)O)O)=O)=O,,,4,1,2,0,2
5619_0,,,,2,2,1,3
C(C(C)(CC(C=O)=O)O)(O)=O,,,4,1,2,0,2
5620_0,,,,2,2,1,3
5622_0,,,,2,2,1,3
C(C(C)(CC(C(O)=O)=O)O)=O,,,4,1,2,0,2
5624_0,,,,2,2,1,3
C(CC(C=O)=O)(O)=O,,,4,1,4,0,4
5626_0,,,,2,2,1,3
C(CC(CO)(CC(C=O)=O)O)(O)=O,,,4,1,2,0,2
5627_0,,,,2,2,1,3
5627_1,,,,2,2,1,3
5628_0,,,,2,2,1,3
5628_1,,,,2,2,1,3
5629_0,,,,2,2,1,3
5629_1,,,,2,2,1,3
5630_0,,,,2,2,1,3
5630_1,,,,2,2,1,3
5632_0,,,,2,2,1,3
C(C(C(C)(CC(C=O)=O)O)O)(O)=O,,,4,1,3,0,3
5633_0,,,,2,2,1,3
5634_0,,,,2,2,1,3
5636_0,,,,2,2,1,3
C(C(CC(C=O)=O)O)(O)=O,,,4,1,3,0,3
5638_0,,,,2,2,1,3
C(C(C(CC(C=O)=O)O)O)(O)=O,,,4,1,4,0,4
5640_0,,,,2,2,1,3
C(CC(C(CC(C=O)=O)O)O)(O)=O,,,4,1,2,0,2
5642_0,,,,2,2,1,3
C(C(CC(C=O)=O)O)(CC(C)=O)=O,,,4,1,1,0,1
5644_0,,,,2,2,1,3
C(C(CC(C=O)=O)(CC(C)=O)O)=O,,,4,1,1,0,1
5646_0,,,,2,2,1,3
C(C(CC(C)(CC(C=O)=O)O)=O)=O,,,4,1,1,0,1
5648_0,,,,2,2,1,3
C(C)(C(C(C=O)=O)C(C(C)=O)O)=O,,,4,1,2,0,2
5648_1,,,,2,2,1,3
5650_0,,,,2,2,1,3
C(C(C)(C(C(C)=O)C(C=O)=O)O)=O,,,4,1,2,0,2
5650_1,,,,2,2,1,3
5652_0,,,,2,2,1,3
C(CC(C(C)=O)O)(CC(C=O)=O)=O,,,4,1,1,0,1
5654_0,,,,2,2,1,3
C(C(C)(CC(CC(C=O)=O)=O)O)=O,,,4,1,1,0,1
5656_0,,,,2,2,1,3
C(CC(C(CC(C=O)=O)O)=O)=O,,,4,1,3,0,3
5658_0,,,,2,2,1,3
C(CC(C=O)(CC(C=O)=O)O)=O,,,4,1,2,0,2
5660_0,,,,2,2,1,3
C(C(CC(CC(C=O)=O)O)=O)=O,,,4,1,2,0,2
5662_0,,,,2,2,1,3
C(C(C(C=O)=O)C(C(C)=O)O)=O,,,4,1,3,0,3
5662_1,,,,2,2,1,3
5664_0,,,,2,2,1,3
C(C(C(C=O)=O)C(C=O)(C)O)=O,,,4,1,3,0,3
5664_1,,,,2,2,1,3
5665_0,,,,2,2,1,3
5667_0,,,,2,2,1,3
C(CC(C(C)=O)(CC(C=O)=O)O)=O,,,4,1,1,0,1
5669_0,,,,2,2,1,3
C(C(C)(CC(C=O)=O)O)(CC=O)=O,,,4,1,1,0,1
5671_0,,,,2,2,1,3
C(C(C(C(C)=O)=O)C(C(C)=O)O)=O,,,4,1,2,0,2
5671_1,,,,2,2,1,3
5673_0,,,,2,2,1,3
C(C(C)(C(C=O)C(C(C)=O)=O)O)=O,,,4,1,2,0,2
5673_1,,,,2,2,1,3
5675_0,,,,2,2,1,3
C(CC(C(CC(C(C)=O)O)=O)=O)=O,,,4,1,1,0,1
5677_0,,,,2,2,1,3
C(C(C)(CC(C(CC=O)=O)=O)O)=O,,,4,1,1,0,1
5679_0,,,,2,2,1,3
C(C)(C(C)(CC(C=O)=O)O)=O,,,4,1,2,0,2
5681_0,,,,2,2,1,3
C(C)(C(CC(C(C)=O)=O)O)=O,,,4,1,3,0,3
5683_0,,,,2,2,1,3
C(C(C)(CC(C(C)=O)=O)O)=O,,,4,1,2,0,2
5685_0,,,,2,2,1,3
C(CC(C)(CC(C=O)=O)O)=O,,,4,1,4,0,4
5687_0,,,,2,2,1,3
C(C)(CC(CC(C=O)=O)O)=O,,,4,1,1,0,1
5689_0,,,,2,2,1,3
C(CC(CC(C(C)=O)O)=O)=O,,,4,1,3,0,3
5691_0,,,,2,2,1,3
C(C(C)(CC(CC=O)=O)O)=O,,,4,1,2,0,2
5693_0,,,,2,2,1,3
C(C(C(C)=O)C(C(C)=O)O)=O,,,4,1,4,0,4
5693_1,,,,2,2,1,3
5695_0,,,,2,2,1,3
C(C(C)(C(C=O)C(C)=O)O)=O,,,4,1,3,0,3
5695_1,,,,2,2,1,3
5697_0,,,,2,2,1,3
C(C(CC1(COC(C1)O)O)=O)=O,,,4,1,2,0,2
5699_0,,,,2,2,1,3
C1(COC(C1C(C(C)=O)O)O)=O,,,4,1,3,0,3
5699_1,,,,2,2,1,3
5701_0,,,,2,2,1,3
C(C(C)(C1C(COC1O)=O)O)=O,,,4,1,3,0,3
5701_1,,,,2,2,1,3
5703_0,,,,2,2,1,3
C(C(C1C(CC(O1)O)=O)O)(C)=O,,,4,1,3,0,3
5703_1,,,,2,2,1,3
5705_0,,,,2,2,1,3
C(C(C)(C1C(CC(O1)O)=O)O)=O,,,4,1,3,0,3
5705_1,,,,2,2,1,3
5707_0,,,,2,2,1,3
C(C(CC(C=O)=O)O)=CC(CO)=O,,,4,1,1,0,1
5709_0,,,,2,2,1,3
C(C(CO)(CC(C=O)=O)O)=CC=O,,,4,1,1,0,1
5711_0,,,,2,2,1,3
C(C)(C(C(C(C=CC=O)=O)O)O)=O,,,4,1,2,0,2
5711_1,,,,2,2,1,3
5713_0,,,,2,2,1,3
C(C(C)(C(C(C=CC=O)=O)O)O)=O,,,4,1,2,0,2
5713_1,,,,2,2,1,3
5715_0,,,,2,2,1,3
C=CC(C(CC(C=O)=O)O)=O,,,4,1,2,0,2
5717_0,,,,2,2,1,3
C(C(C=C)(CC(C=O)=O)O)=O,,,4,1,2,0,2
5719_0,,,,2,2,1,3
C(C(CO)(CC(C=O)=O)O)=C,,,4,1,2,0,2
5721_0,,,,2,2,1,3
C(C)(C(C(C(C=C)=O)O)O)=O,,,4,1,5,0,5
5721_1,,,,2,2,1,3
5723_0,,,,2,2,1,3
C(C(C)(C(C(C=C)=O)O)O)=O,,,4,1,4,0,4
5723_1,,,,2,2,1,3
5725_0,,,,2,2,1,3
C(C(CC(C=O)=O)O)=CC=O,,,4,1,3,0,3
5727_0,,,,2,2,1,3
C(C(CC(C(C)O)O)=O)=O,,,4,1,1,0,1
5729_0,,,,2,2,1,3
C(C(CCO)(CC(C=O)=O)O)(O)=O,,,4,1,2,0,2
5731_0,,,,2,2,1,3
C(C(C(C(C(O)=O)=O)CO)O)(C)=O,,,4,1,5,0,5
5731_1,,,,2,2,1,3
5733_0,,,,2,2,1,3
C(C(C)(C(C(C(O)=O)=O)CO)O)=O,,,4,1,3,0,3
5733_1,,,,2,2,1,3
5735_0,,,,2,2,1,3
C(C(CC(CC(C=O)=O)O)O)(O)=O,,,4,1,2,0,2
5736_0,,,,2,2,1,3
5736_1,,,,2,2,1,3
5737_0,,,,2,2,1,3
5737_1,,,,2,2,1,3
5739_0,,,,2,2,1,3
C(C(CC(C(CO)(CO)O)O)=O)=O,,,4,1,3,0,3
5741_0,,,,2,2,1,3
C(C(CO)(C(CC(C=O)=O)O)O)=O,,,4,1,5,0,5
5743_0,,,,2,2,1,3
C(C(CC(C(C=CC(C)=O)=O)O)=O)=O,,,4,1,1,0,1
5745_0,,,,2,2,1,3
C(C(C=CC(C)=O)(CC(C=O)=O)O)=O,,,4,1,1,0,1
5747_0,,,,2,2,1,3
C(C(C)(CC(C=O)=O)O)=CC(C=O)=O,,,4,1,1,0,1
5749_0,,,,2,2,1,3
C(C)(C(CC(C=CC(C=O)=O)=O)O)=O,,,4,1,1,0,1
5751_0,,,,2,2,1,3
C(C(C)(CC(C=CC(C=O)=O)=O)O)=O,,,4,1,1,0,1
5753_0,,,,2,2,1,3
C(CC=CC(C(CC(C=O)=O)O)=O)=O,,,4,1,1,0,1
5755_0,,,,2,2,1,3
C(C(C=CCC=O)(CC(C=O)=O)O)=O,,,4,1,1,0,1
5757_0,,,,2,2,1,3
C(CC(CC(C=O)=O)O)=CC(C=O)=O,,,4,1,1,0,1
5759_0,,,,2,2,1,3
C(C(C=CC(C=O)=O)C(C(C)=O)O)=O,,,4,1,1,0,1
5761_0,,,,2,2,1,3
C(C(C=CC(C=O)=O)C(C=O)(C)O)=O,,,4,1,1,0,1
5763_0,,,,2,2,1,3
C(C(CC(C=O)=O)O)=CC(C(C)=O)=O,,,4,1,1,0,1
5765_0,,,,2,2,1,3
C(C)(C(C=CC=O)(CC(C=O)=O)O)=O,,,4,1,1,0,1
5767_0,,,,2,2,1,3
C(C(CC(C(C=CC=O)=O)(C)O)=O)=O,,,4,1,1,0,1
5769_0,,,,2,2,1,3
C(C)(C(CC(C(C=CC=O)=O)=O)O)=O,,,4,1,1,0,1
5771_0,,,,2,2,1,3
C(C(C)(CC(C(C=CC=O)=O)=O)O)=O,,,4,1,1,0,1
5773_0,,,,2,2,1,3
C(CC(C=CC(CC(C=O)=O)O)=O)=O,,,4,1,1,0,1
5775_0,,,,2,2,1,3
C(CC(C=CC=O)(CC(C=O)=O)O)=O,,,4,1,1,0,1
5777_0,,,,2,2,1,3
C(C(CC(CC(C=CC=O)=O)O)=O)=O,,,4,1,1,0,1
5779_0,,,,2,2,1,3
C(C(C(C=CC=O)=O)C(C(C)=O)O)=O,,,4,1,2,0,2
5779_1,,,,2,2,1,3
5781_0,,,,2,2,1,3
C(C(C(C=CC=O)=O)C(C=O)(C)O)=O,,,4,1,2,0,2
5781_1,,,,2,2,1,3
5783_0,,,,2,2,1,3
C(C(CC(C=O)=O)O)(CC(C=C)=O)=O,,,4,1,1,0,1
5785_0,,,,2,2,1,3
C(C(CC(C=O)=O)(CC(C=C)=O)O)=O,,,4,1,1,0,1
5787_0,,,,2,2,1,3
C=CC(CC(C=O)=O)(CC(C=O)=O)O,,,4,1,1,0,1
5789_0,,,,2,2,1,3
C(C)(C(C(C(C=O)=O)C(C=C)=O)O)=O,,,4,1,2,0,2
5789_1,,,,2,2,1,3
5791_0,,,,2,2,1,3
C(C(C)(C(C(C=O)=O)C(C=C)=O)O)=O,,,4,1,2,0,2
5791_1,,,,2,2,1,3
5793_0,,,,2,2,1,3
C=CC(C(CC(CC(C=O)=O)O)=O)=O,,,4,1,1,0,1
5795_0,,,,2,2,1,3
C(CC(C(C=C)=O)(CC(C=O)=O)O)=O,,,4,1,1,0,1
5797_0,,,,2,2,1,3
C(CC=O)(C(C=C)(CC(C=O)=O)O)=O,,,4,1,1,0,1
5799_0,,,,2,2,1,3
C(C(C(C(C=C)=O)=O)C(C(C)=O)O)=O,,,4,1,2,0,2
5799_1,,,,2,2,1,3
5801_0,,,,2,2,1,3
C(C(C(C(C=C)=O)=O)C(C=O)(C)O)=O,,,4,1,2,0,2
5801_1,,,,2,2,1,3
5803_0,,,,2,2,1,3
C(C(CC(C=O)=O)O)(CC=CC=O)=O,,,4,1,1,0,1
5805_0,,,,2,2,1,3
C(C(CC(C=O)=O)(CC=CC=O)O)=O,,,4,1,1,0,1
5807_0,,,,2,2,1,3
C(CC(C=O)=O)=CC(CC(C=O)=O)O,,,4,1,1,0,1
5809_0,,,,2,2,1,3
C(C)(C(C(C=CC=O)C(C=O)=O)O)=O,,,4,1,1,0,1
5811_0,,,,2,2,1,3
C(C(C)(C(C=CC=O)C(C=O)=O)O)=O,,,4,1,1,0,1
5813_0,,,,2,2,1,3
C(C(CC1(COCC1O)O)=O)=O,,,4,1,1,0,1
5815_0,,,,2,2,1,3
C(C(C1C(C(CO1)O)=O)O)(C)=O,,,4,1,2,0,2
5815_1,,,,2,2,1,3
5817_0,,,,2,2,1,3
C(C(C)(C1C(C(CO1)O)=O)O)=O,,,4,1,2,0,2
5817_1,,,,2,2,1,3
5819_0,,,,2,2,1,3
C(C(CC1(C(O)OCC1)O)=O)=O,,,4,1,2,0,2
5821_0,,,,2,2,1,3
C(C(C1C(C(O)OC1)=O)O)(C)=O,,,4,1,3,0,3
5821_1,,,,2,2,1,3
5823_0,,,,2,2,1,3
C(C(C)(C1C(C(O)OC1)=O)O)=O,,,4,1,3,0,3
5823_1,,,,2,2,1,3
5825_0,,,,2,2,1,3
C(C(C(CO)=O)C(CCO)O)=O,,,4,1,2,0,2
5825_1,,,,2,2,1,3
5827_0,,,,2,2,1,3
C(CC(C(C(CCO)O)O)=O)=O,,,4,1,2,0,2
5827_1,,,,2,2,1,3
5829_0,,,,2,2,1,3
C(C(CO)C(CC(CO)=O)O)=O,,,4,1,6,0,6
5829_1,,,,2,2,1,3
5831_0,,,,2,2,1,3
C(C(CO)C(CO)(CC=O)O)=O,,,4,1,5,0,5
5831_1,,,,2,2,1,3
5833_0,,,,2,2,1,3
C(C(C(CO)=O)C(CC(C)O)O)=O,,,4,1,2,0,2
5833_1,,,,2,2,1,3
5835_0,,,,2,2,1,3
C(CC(C(C(CC(C)O)O)O)=O)=O,,,4,1,2,0,2
5835_1,,,,2,2,1,3
5837_0,,,,2,2,1,3
C(C(C(CC(CO)=O)O)C(C)O)=O,,,4,1,5,0,5
5837_1,,,,2,2,1,3
5839_0,,,,2,2,1,3
C(C(C(C)O)C(CO)(CC=O)O)=O,,,4,1,5,0,5
5839_1,,,,2,2,1,3
5841_0,,,,2,2,1,3
C(C(CO)(C(C=O)C(CO)=O)O)=O,,,4,1,3,0,3
5841_1,,,,2,2,1,3
5843_0,,,,2,2,1,3
C(C(CO)(C(C(CC=O)=O)O)O)=O,,,4,1,6,0,6
5843_1,,,,2,2,1,3
5845_0,,,,2,2,1,3
C(C(C(CO)=O)C(C(CO)=O)O)=O,,,4,1,3,0,3
5845_1,,,,2,2,1,3
5846_0,,,,2,2,1,3
5846_1,,,,2,2,1,3
5848_0,,,,2,2,1,3
C(CO)(CC(C(C(C=O)=O)O)O)=O,,,4,1,2,0,2
5848_1,,,,2,2,1,3
5850_0,,,,2,2,1,3
C(CC(CO)(C(C(C=O)=O)O)O)=O,,,4,1,2,0,2
5850_1,,,,2,2,1,3
5852_0,,,,2,2,1,3
C(CC(C(C=O)C(CO)=O)O)=O,,,4,1,4,0,4
5852_1,,,,2,2,1,3
5854_0,,,,2,2,1,3
C(CC(C(C(CC=O)=O)O)O)=O,,,4,1,4,0,4
5854_1,,,,2,2,1,3
5856_0,,,,2,2,1,3
C(C(C=O)C(CC(CO)=O)O)=O,,,4,1,3,0,3
5856_1,,,,2,2,1,3
5858_0,,,,2,2,1,3
C(C(C=O)C(CO)(CC=O)O)=O,,,4,1,3,0,3
5858_1,,,,2,2,1,3
5860_0,,,,2,2,1,3
C(C(C)(C(C=O)C(CO)=O)O)(O)=O,,,4,1,3,0,3
5860_1,,,,2,2,1,3
5862_0,,,,2,2,1,3
C(C(C)(C(C(CC=O)=O)O)O)(O)=O,,,4,1,4,0,4
5862_1,,,,2,2,1,3
5864_0,,,,2,2,1,3
C(CO)(CC(CC(C(O)=O)=O)O)=O,,,4,1,2,0,2
5866_0,,,,2,2,1,3
C(CC(CO)(CC(C(O)=O)=O)O)=O,,,4,1,2,0,2
5868_0,,,,2,2,1,3
C(C(C=O)C(CO)=O)(O)=O,,,4,1,2,0,2
5868_1,,,,2,2,1,3
5870_0,,,,2,2,1,3
C(C(C(CC=O)=O)O)(O)=O,,,4,1,3,0,3
5870_1,,,,2,2,1,3
5872_0,,,,2,2,1,3
C(C(C(CO)=O)C(C(O)=O)O)=O,,,4,1,3,0,3
5872_1,,,,2,2,1,3
5874_0,,,,2,2,1,3
C(CC(C(C(C(O)=O)O)O)=O)=O,,,4,1,5,0,5
5874_1,,,,2,2,1,3
5876_0,,,,2,2,1,3
C(C)(C(C)(C(C=O)C(CO)=O)O)=O,,,4,1,2,0,2
5876_1,,,,2,2,1,3
5878_0,,,,2,2,1,3
C(C)(C(C)(C(C(CC=O)=O)O)O)=O,,,4,1,2,0,2
5878_1,,,,2,2,1,3
5880_0,,,,2,2,1,3
C(CO)(CC(CC(C(C)=O)=O)O)=O,,,4,1,2,0,2
5882_0,,,,2,2,1,3
C(CC(CO)(CC(C(C)=O)=O)O)=O,,,4,1,2,0,2
5884_0,,,,2,2,1,3
C(CC(C)(C(C=O)C(CO)=O)O)=O,,,4,1,2,0,2
5884_1,,,,2,2,1,3
5885_0,,,,2,2,1,3
5885_1,,,,2,2,1,3
5887_0,,,,2,2,1,3
C(C)(CC(C(C=O)C(CO)=O)O)=O,,,4,1,2,0,2
5887_1,,,,2,2,1,3
5889_0,,,,2,2,1,3
C(C(C(CC(C)=O)O)O)(CC=O)=O,,,4,1,2,0,2
5889_1,,,,2,2,1,3
5891_0,,,,2,2,1,3
C(CC(CC(CO)=O)O)(CC=O)=O,,,4,1,1,0,1
5892_0,,,,2,2,1,3
5894_0,,,,2,2,1,3
C(C)(C(C=O)C(CC(CO)=O)O)=O,,,4,1,2,0,2
5894_1,,,,2,2,1,3
5896_0,,,,2,2,1,3
C(CC(CO)(C(C=O)C(C)=O)O)=O,,,4,1,2,0,2
5896_1,,,,2,2,1,3
5898_0,,,,2,2,1,3
C(C(C(CO)=O)C(C(C=C)=O)O)=O,,,4,1,2,0,2
5898_1,,,,2,2,1,3
5899_0,,,,2,2,1,3
5899_1,,,,2,2,1,3
5901_0,,,,2,2,1,3
C(C(C(CO)=O)C(C=O)(C=C)O)=O,,,4,1,2,0,2
5901_1,,,,2,2,1,3
5903_0,,,,2,2,1,3
C(C(C=C)(C(C(CC=O)=O)O)O)=O,,,4,1,2,0,2
5903_1,,,,2,2,1,3
5905_0,,,,2,2,1,3
C(C(C(CO)=O)C(C=C)(CO)O)=O,,,4,1,2,0,2
5905_1,,,,2,2,1,3
5907_0,,,,2,2,1,3
C(CC(C(C(C=C)(CO)O)O)=O)=O,,,4,1,2,0,2
5907_1,,,,2,2,1,3
5909_0,,,,2,2,1,3
C(CO)(CC(C(C(C=C)=O)O)O)=O,,,4,1,2,0,2
5909_1,,,,2,2,1,3
5911_0,,,,2,2,1,3
C(CC(CO)(C(C(C=C)=O)O)O)=O,,,4,1,3,0,3
5911_1,,,,2,2,1,3
5913_0,,,,2,2,1,3
C(C(C(CO)=O)C(C=CC=O)O)=O,,,4,1,2,0,2
5913_1,,,,2,2,1,3
5915_0,,,,2,2,1,3
C(CC(C(C(C=CC=O)O)O)=O)=O,,,4,1,2,0,2
5915_1,,,,2,2,1,3
5917_0,,,,2,2,1,3
C(C(C(CO)=O)C(C(C)O)O)=O,,,4,1,2,0,2
5917_1,,,,2,2,1,3
5919_0,,,,2,2,1,3
C(CC(C(C(C(C)O)O)O)=O)=O,,,4,1,2,0,2
5919_1,,,,2,2,1,3
5921_0,,,,2,2,1,3
C(C(C(CC(CCO)O)=O)O)=O,,,4,1,1,0,1
5923_0,,,,2,2,1,3
C(C(CO)C(C(C(C)=O)O)O)=O,,,4,1,5,0,5
5923_1,,,,2,2,1,3
5925_0,,,,2,2,1,3
C(C(CO)C(C)(C(C=O)O)O)=O,,,4,1,4,0,4
5925_1,,,,2,2,1,3
5927_0,,,,2,2,1,3
C(C(C(CC(CC(C)O)O)=O)O)=O,,,4,1,1,0,1
5929_0,,,,2,2,1,3
C(C(C(C(C(C)=O)O)O)C(C)O)=O,,,4,1,4,0,4
5929_1,,,,2,2,1,3
5931_0,,,,2,2,1,3
C(C(C(C)O)C(C)(C(C=O)O)O)=O,,,4,1,4,0,4
5931_1,,,,2,2,1,3
5933_0,,,,2,2,1,3
C(C(CO)(CC(C(C=O)O)=O)O)=O,,,4,1,2,0,2
5935_0,,,,2,2,1,3
C(C(C(CC(C(CO)=O)O)=O)O)=O,,,4,1,2,0,2
5937_0,,,,2,2,1,3
C(C)(C(C(C(C(C=O)=O)O)O)O)=O,,,4,1,2,0,2
5937_1,,,,2,2,1,3
5939_0,,,,2,2,1,3
C(C(C(C)(C(C(C=O)=O)O)O)O)=O,,,4,1,2,0,2
5939_1,,,,2,2,1,3
5941_0,,,,2,2,1,3
C(C(C(CC(CC=O)O)=O)O)=O,,,4,1,2,0,2
5943_0,,,,2,2,1,3
C(C(C=O)C(C(C(C)=O)O)O)=O,,,4,1,3,0,3
5943_1,,,,2,2,1,3
5945_0,,,,2,2,1,3
C(C(C=O)C(C)(C(C=O)O)O)=O,,,4,1,3,0,3
5945_1,,,,2,2,1,3
5947_0,,,,2,2,1,3
C(C(C)(CC(C(C=O)O)=O)O)(O)=O,,,4,1,2,0,2
5949_0,,,,2,2,1,3
C(C)(C(C(CC(C(O)=O)=O)O)O)=O,,,4,1,2,0,2
5951_0,,,,2,2,1,3
C(C(C(C)(CC(C(O)=O)=O)O)O)=O,,,4,1,2,0,2
5953_0,,,,2,2,1,3
C(CC(C(C=O)O)=O)(O)=O,,,4,1,2,0,2
5955_0,,,,2,2,1,3
C(C(C(CC(C(O)=O)O)=O)O)=O,,,4,1,3,0,3
5957_0,,,,2,2,1,3
C(C)(C(C)(CC(C(C=O)O)=O)O)=O,,,4,1,1,0,1
5959_0,,,,2,2,1,3
C(C)(C(C(CC(C(C)=O)=O)O)O)=O,,,4,1,3,0,3
5961_0,,,,2,2,1,3
C(C(C(C)(CC(C(C)=O)=O)O)O)=O,,,4,1,1,0,1
5962_0,,,,2,2,1,3
5964_0,,,,2,2,1,3
C(CC(CC(C)=O)O)(C(C=O)O)=O,,,4,1,1,0,1
5966_0,,,,2,2,1,3
C(CC(C(C(C)=O)O)O)(CC=O)=O,,,4,1,1,0,1
5968_0,,,,2,2,1,3
C(CC(C)(C(C=O)O)O)(CC=O)=O,,,4,1,1,0,1
5970_0,,,,2,2,1,3
C(C(C(C)=O)C(C(C(C)=O)O)O)=O,,,4,1,2,0,2
5970_1,,,,2,2,1,3
5972_0,,,,2,2,1,3
C(C(C(C)(C(C=O)C(C)=O)O)O)=O,,,4,1,2,0,2
5972_1,,,,2,2,1,3
5974_0,,,,2,2,1,3
C(C(C(CC(C(C=C)=O)O)=O)O)=O,,,4,1,1,0,1
5976_0,,,,2,2,1,3
C(C(C=C)(CC(C(C=O)O)=O)O)=O,,,4,1,1,0,1
5978_0,,,,2,2,1,3
C(C(C(CC(C=C)(CO)O)=O)O)=O,,,4,1,1,0,1
5980_0,,,,2,2,1,3
C(C)(C(C(C(C(C=C)=O)O)O)O)=O,,,4,1,2,0,2
5980_1,,,,2,2,1,3
5982_0,,,,2,2,1,3
C(C(C(C)(C(C(C=C)=O)O)O)O)=O,,,4,1,2,0,2
5982_1,,,,2,2,1,3
5984_0,,,,2,2,1,3
C(C(C(CC(C=CC=O)O)=O)O)=O,,,4,1,1,0,1
5986_0,,,,2,2,1,3
C(C(C(CC(C(C)O)O)=O)O)=O,,,4,1,1,0,1
5987_0,,,,2,2,1,3
5987_1,,,,2,2,1,3
5989_0,,,,2,2,1,3
C(C(C(C=O)O)O)(C(C(C)O)O)=O,,,4,1,4,0,4
5989_1,,,,2,2,1,3
5990_0,,,,2,2,1,3
5990_1,,,,2,2,1,3
5991_0,,,,2,2,1,3
5991_1,,,,2,2,1,3
5993_0,,,,2,2,1,3
C(C(C(C(C=O)=O)C(C=O)O)O)=O,,,4,1,2,0,2
5993_1,,,,2,2,1,3
5995_0,,,,2,2,1,3
C(C(C(C(C=O)=O)C(C)O)O)=O,,,4,1,4,0,4
5995_1,,,,2,2,1,3
5997_0,,,,2,2,1,3
C(CC(C(CC(C=O)O)=O)O)=O,,,4,1,3,0,3
5998_0,,,,2,2,1,3
5998_1,,,,2,2,1,3
5999_0,,,,2,2,1,3
5999_1,,,,2,2,1,3
6001_0,,,,2,2,1,3
C(C(C(C(C(C=O)O)O)=O)CO)=O,,,4,1,4,0,4
6001_1,,,,2,2,1,3
6003_0,,,,2,2,1,3
C(C(CO)O)(C(C=O)C(C=O)O)=O,,,4,1,4,0,4
6003_1,,,,2,2,1,3
6005_0,,,,2,2,1,3
C(C(CO)C(C=O)O)(C(C=O)O)=O,,,4,1,4,0,4
6005_1,,,,2,2,1,3
6006_0,,,,2,2,1,3
6006_1,,,,2,2,1,3
6007_0,,,,2,2,1,3
6007_1,,,,2,2,1,3
6008_0,,,,2,2,1,3
6008_1,,,,2,2,1,3
6009_0,,,,2,2,1,3
6009_1,,,,2,2,1,3
6010_0,,,,2,2,1,3
6010_1,,,,2,2,1,3
6011_0,,,,2,2,1,3
6011_1,,,,2,2,1,3
6012_0,,,,2,2,1,3
6013_0,,,,2,2,1,3
6013_1,,,,2,2,1,3
6014_0,,,,2,2,1,3
6014_1,,,,2,2,1,3
6015_0,,,,2,2,1,3
6015_1,,,,2,2,1,3
6016_0,,,,2,2,1,3
6016_1,,,,2,2,1,3
6017_0,,,,2,2,1,3
6017_1,,,,2,2,1,3
6018_0,,,,2,2,1,3
6019_0,,,,2,2,1,3
6019_1,,,,2,2,1,3
6021_0,,,,2,2,1,3
C(C(C(C(C=O)=O)O)O)=O,,,4,1,4,0,4
6021_1,,,,2,2,1,3
6023_0,,,,2,2,1,3
C(C(C(C=O)C(C(CO)=O)O)O)=O,,,4,1,5,0,5
6023_1,,,,2,2,1,3
6025_0,,,,2,2,1,3
C(C(C(C(C(CC=O)O)=O)O)O)=O,,,4,1,3,0,3
6025_1,,,,2,2,1,3
6027_0,,,,2,2,1,3
C(C(C(C(C(C)=O)=O)O)O)=O,,,4,1,3,0,3
6027_1,,,,2,2,1,3
6029_0,,,,2,2,1,3
C(C(CC(C(CO)=O)=O)O)=O,,,4,1,3,0,3
6031_0,,,,2,2,1,3
C(C(C(C(CC(CO)=O)=O)O)O)=O,,,4,1,3,0,3
6031_1,,,,2,2,1,3
6033_0,,,,2,2,1,3
C(C(C(C(CO)=O)C(CO)=O)O)=O,,,4,1,3,0,3
6033_1,,,,2,2,1,3
6035_0,,,,2,2,1,3
C(C(C(C(C(C(C)=O)O)=O)O)O)=O,,,4,1,2,0,2
6035_1,,,,2,2,1,3
6037_0,,,,2,2,1,3
C(C(CC(C(C(CO)=O)O)=O)O)=O,,,4,1,2,0,2
6038_0,,,,2,2,1,3
6038_1,,,,2,2,1,3
6040_0,,,,2,2,1,3
C(C(C=O)C(C=O)O)=O,,,4,1,5,0,5
6040_1,,,,2,2,1,3
6042_0,,,,2,2,1,3
C(C(C(C(C(C=O)O)O)=O)O)=O,,,4,1,2,0,2
6042_1,,,,2,2,1,3
6044_0,,,,2,2,1,3
C(C(CC(C(O)=O)=O)O)=O,,,4,1,3,0,3
6046_0,,,,2,2,1,3
C(C(C(CO)=O)C(C=O)O)(O)=O,,,4,1,6,0,6
6046_1,,,,2,2,1,3
6048_0,,,,2,2,1,3
C(CC(C(C(C=O)O)O)=O)(O)=O,,,4,1,5,0,5
6048_1,,,,2,2,1,3
6050_0,,,,2,2,1,3
C(C(C(CC(C=O)O)=O)O)(O)=O,,,4,1,5,0,5
6052_0,,,,2,2,1,3
C(C(C(C(C)=O)C(C=O)=O)O)=O,,,4,1,3,0,3
6052_1,,,,2,2,1,3
6054_0,,,,2,2,1,3
C(C(CC(CC(C=O)=O)=O)O)=O,,,4,1,3,0,3
6056_0,,,,2,2,1,3
C(C(C(C=O)=O)C(C=O)O)=O,,,4,1,3,0,3
6056_1,,,,2,2,1,3
6058_0,,,,2,2,1,3
C(C(C(C(C)=O)=O)C(C=O)O)=O,,,4,1,3,0,3
6058_1,,,,2,2,1,3
6060_0,,,,2,2,1,3
C(CC(C(CC(C=O)O)=O)=O)=O,,,4,1,3,0,3
6061_0,,,,2,2,1,3
6062_0,,,,2,2,1,3
6064_0,,,,2,2,1,3
C(C(C(C)=O)C(C=O)O)=O,,,4,1,6,0,6
6064_1,,,,2,2,1,3
6066_0,,,,2,2,1,3
C1(COC(C1C(C=O)O)O)=O,,,4,1,3,0,3
6066_1,,,,2,2,1,3
6068_0,,,,2,2,1,3
C(C(C1C(CC(O1)O)=O)O)=O,,,4,1,3,0,3
6068_1,,,,2,2,1,3
6070_0,,,,2,2,1,3
C1(COC(C(C1C(C=O)O)O)O)=O,,,4,1,3,0,3
6070_1,,,,2,2,1,3
6072_0,,,,2,2,1,3
C(C(C1C(CC(C(O1)O)O)=O)O)=O,,,4,1,3,0,3
6072_1,,,,2,2,1,3
6074_0,,,,2,2,1,3
C(C(C(C(C=CC=O)=O)O)O)=O,,,4,1,3,0,3
6074_1,,,,2,2,1,3
6075_0,,,,2,2,1,3
6075_1,,,,2,2,1,3
6077_0,,,,2,2,1,3
C(C(C(C(C(O)=O)=O)CO)O)=O,,,4,1,3,0,3
6077_1,,,,2,2,1,3
6079_0,,,,2,2,1,3
C(C(C(C=O)C(C=O)O)O)(O)=O,,,4,1,5,0,5
6079_1,,,,2,2,1,3
6081_0,,,,2,2,1,3
C(CC(C=O)O)(C(C=O)(CO)O)=O,,,4,1,3,0,3
6082_0,,,,2,2,1,3
6084_0,,,,2,2,1,3
C(C(C(C=O)C(C=O)(CO)O)O)=O,,,4,1,5,0,5
6084_1,,,,2,2,1,3
6086_0,,,,2,2,1,3
C(C(CC(C=CC(C=O)=O)=O)O)=O,,,4,1,1,0,1
6088_0,,,,2,2,1,3
C(C(C=CC(C=O)=O)C(C=O)O)=O,,,4,1,1,0,1
6090_0,,,,2,2,1,3
C(C(CC(C(C=CC=O)=O)=O)O)=O,,,4,1,1,0,1
6092_0,,,,2,2,1,3
C(C(C(C=CC=O)=O)C(C=O)O)=O,,,4,1,2,0,2
6092_1,,,,2,2,1,3
6094_0,,,,2,2,1,3
C(C(C(C(C=O)=O)C(C=C)=O)O)=O,,,4,1,2,0,2
6094_1,,,,2,2,1,3
6096_0,,,,2,2,1,3
C(C(C(C(C=C)=O)=O)C(C=O)O)=O,,,4,1,2,0,2
6096_1,,,,2,2,1,3
6098_0,,,,2,2,1,3
C(C(C(C=CC=O)C(C=O)=O)O)=O,,,4,1,1,0,1
6100_0,,,,2,2,1,3
C(C(C1C(C(CO1)O)=O)O)=O,,,4,1,2,0,2
6100_1,,,,2,2,1,3
6102_0,,,,2,2,1,3
C1(C(O)OCC1C(C=O)O)=O,,,4,1,3,0,3
6102_1,,,,2,2,1,3
6104_0,,,,2,2,1,3
C(C(CO)O)(CC(CCO)O)=O,,,4,1,1,0,1
6106_0,,,,2,2,1,3
C(C(CO)C(C)(C(CO)O)O)=O,,,4,1,4,0,4
6106_1,,,,2,2,1,3
6108_0,,,,2,2,1,3
C(C(CO)O)(CC(CC(C)O)O)=O,,,4,1,1,0,1
6110_0,,,,2,2,1,3
C(C(C(C)O)C(C)(C(CO)O)O)=O,,,4,1,4,0,4
6110_1,,,,2,2,1,3
6111_0,,,,2,2,1,3
6112_0,,,,2,2,1,3
6114_0,,,,2,2,1,3
C(C(C(C(C)(C(CO)O)O)O)=O)=O,,,4,1,2,0,2
6114_1,,,,2,2,1,3
6116_0,,,,2,2,1,3
C(CC(CC(C(CO)O)=O)O)=O,,,4,1,5,0,5
6118_0,,,,2,2,1,3
C(C(C=O)C(C)(C(CO)O)O)=O,,,4,1,3,0,3
6118_1,,,,2,2,1,3
6120_0,,,,2,2,1,3
C(C(C)(CC(C(CO)O)=O)O)(O)=O,,,4,1,2,0,2
6122_0,,,,2,2,1,3
C(C(CC(C)(C(CO)O)O)=O)(O)=O,,,4,1,2,0,2
6124_0,,,,2,2,1,3
C(CC(C(CO)O)=O)(O)=O,,,4,1,5,0,5
6125_0,,,,2,2,1,3
6127_0,,,,2,2,1,3
C(C)(C(C)(CC(C(CO)O)=O)O)=O,,,4,1,1,0,1
6129_0,,,,2,2,1,3
C(C(C)=O)(CC(C)(C(CO)O)O)=O,,,4,1,1,0,1
6131_0,,,,2,2,1,3
C(CC(C)(CC(C(CO)O)=O)O)=O,,,4,1,3,0,3
6133_0,,,,2,2,1,3
C(C(CO)O)(CC(CC(C)=O)O)=O,,,4,1,1,0,1
6135_0,,,,2,2,1,3
C(CC(CC(C)(C(CO)O)O)=O)=O,,,4,1,1,0,1
6137_0,,,,2,2,1,3
C(C(C(C)=O)C(C)(C(CO)O)O)=O,,,4,1,2,0,2
6137_1,,,,2,2,1,3
6139_0,,,,2,2,1,3
C(CC(C(C=C)=O)O)(C(CO)O)=O,,,4,1,1,0,1
6141_0,,,,2,2,1,3
C(C(C=C)(CC(C(CO)O)=O)O)=O,,,4,1,1,0,1
6143_0,,,,2,2,1,3
C(CC(C=C)(CO)O)(C(CO)O)=O,,,4,1,1,0,1
6145_0,,,,2,2,1,3
C=CC(C(C(C)(C(CO)O)O)O)=O,,,4,1,2,0,2
6145_1,,,,2,2,1,3
6147_0,,,,2,2,1,3
C(CC(C=CC=O)O)(C(CO)O)=O,,,4,1,1,0,1
6149_0,,,,2,2,1,3
C(C(CO)O)(CC(C(C)O)O)=O,,,4,1,1,0,1
6150_0,,,,2,2,1,3
6150_1,,,,2,2,1,3
6151_0,,,,2,2,1,3
6151_1,,,,2,2,1,3
6152_0,,,,2,2,1,3
6152_1,,,,2,2,1,3
6153_0,,,,2,2,1,3
6153_1,,,,2,2,1,3
6154_0,,,,2,2,1,3
6154_1,,,,2,2,1,3
6155_0,,,,2,2,1,3
6155_1,,,,2,2,1,3
6156_0,,,,2,2,1,3
6157_0,,,,2,2,1,3
6158_0,,,,2,2,1,3
6158_1,,,,2,2,1,3
6159_0,,,,2,2,1,3
6159_1,,,,2,2,1,3
6160_0,,,,2,2,1,3
6160_1,,,,2,2,1,3
6161_0,,,,2,2,1,3
6161_1,,,,2,2,1,3
6162_0,,,,2,2,1,3
6162_1,,,,2,2,1,3
6163_0,,,,2,2,1,3
6163_1,,,,2,2,1,3
6164_0,,,,2,2,1,3
6164_1,,,,2,2,1,3
6165_0,,,,2,2,1,3
6166_0,,,,2,2,1,3
6166_1,,,,2,2,1,3
6167_0,,,,2,2,1,3
6167_1,,,,2,2,1,3
6168_0,,,,2,2,1,3
6168_1,,,,2,2,1,3
6169_0,,,,2,2,1,3
6169_1,,,,2,2,1,3
6170_0,,,,2,2,1,3
6170_1,,,,2,2,1,3
6171_0,,,,2,2,1,3
6171_1,,,,2,2,1,3
6172_0,,,,2,2,1,3
6172_1,,,,2,2,1,3
6173_0,,,,2,2,1,3
6173_1,,,,2,2,1,3
6174_0,,,,2,2,1,3
6175_0,,,,2,2,1,3
6175_1,,,,2,2,1,3
6176_0,,,,2,2,1,3
6176_1,,,,2,2,1,3
6177_0,,,,2,2,1,3
6177_1,,,,2,2,1,3
6178_0,,,,2,2,1,3
6178_1,,,,2,2,1,3
6179_0,,,,2,2,1,3
6179_1,,,,2,2,1,3
6180_0,,,,2,2,1,3
6180_1,,,,2,2,1,3
6181_0,,,,2,2,1,3
6181_1,,,,2,2,1,3
6182_0,,,,2,2,1,3
6183_0,,,,2,2,1,3
6183_1,,,,2,2,1,3
6184_0,,,,2,2,1,3
6184_1,,,,2,2,1,3
6185_0,,,,2,2,1,3
6185_1,,,,2,2,1,3
6186_0,,,,2,2,1,3
6186_1,,,,2,2,1,3
6187_0,,,,2,2,1,3
6188_0,,,,2,2,1,3
6189_0,,,,2,2,1,3
6189_1,,,,2,2,1,3
6190_0,,,,2,2,1,3
6191_0,,,,2,2,1,3
6191_1,,,,2,2,1,3
6192_0,,,,2,2,1,3
6192_1,,,,2,2,1,3
6193_0,,,,2,2,1,3
6193_1,,,,2,2,1,3
6194_0,,,,2,2,1,3
6194_1,,,,2,2,1,3
6196_0,,,,2,2,1,3
C(C(C(C(CO)O)=O)CO)=O,,,4,1,5,0,5
6196_1,,,,2,2,1,3
6197_0,,,,2,2,1,3
6197_1,,,,2,2,1,3
6199_0,,,,2,2,1,3
C(C(C(C(CO)O)=O)C(C)O)=O,,,4,1,4,0,4
6199_1,,,,2,2,1,3
6201_0,,,,2,2,1,3
C(C(C(C(C(C)O)O)=O)CO)=O,,,4,1,4,0,4
6201_1,,,,2,2,1,3
6203_0,,,,2,2,1,3
C(CC(C(C(CO)=O)CO)O)=O,,,4,1,7,0,7
6203_1,,,,2,2,1,3
6204_0,,,,2,2,1,3
6204_1,,,,2,2,1,3
6205_0,,,,2,2,1,3
6205_1,,,,2,2,1,3
6206_0,,,,2,2,1,3
6206_1,,,,2,2,1,3
6207_0,,,,2,2,1,3
6207_1,,,,2,2,1,3
6209_0,,,,2,2,1,3
C(C(C(C(CO)CO)=O)O)=O,,,4,1,2,0,2
6209_1,,,,2,2,1,3
6211_0,,,,2,2,1,3
C(C(C(C(CO)C(C)O)=O)O)=O,,,4,1,4,0,4
6211_1,,,,2,2,1,3
6213_0,,,,2,2,1,3
C(CC(C(C(CCO)=O)O)O)=O,,,4,1,5,0,5
6214_0,,,,2,2,1,3
6214_1,,,,2,2,1,3
6215_0,,,,2,2,1,3
6215_1,,,,2,2,1,3
6216_0,,,,2,2,1,3
6216_1,,,,2,2,1,3
6218_0,,,,2,2,1,3
C(C(CO)O)(C(CO)CO)=O,,,4,1,4,0,4
6218_1,,,,2,2,1,3
6220_0,,,,2,2,1,3
C(C(CO)O)(C(CO)C(C)O)=O,,,4,1,6,0,6
6220_1,,,,2,2,1,3
6221_0,,,,2,2,1,3
6221_1,,,,2,2,1,3
6222_0,,,,2,2,1,3
6222_1,,,,2,2,1,3
6224_0,,,,2,2,1,3
C(C(CO)CO)=O,,,4,1,2,0,2
6224_1,,,,2,2,1,3
6226_0,,,,2,2,1,3
C(CC(C(C(CO)CO)=O)O)=O,,,4,1,5,0,5
6226_1,,,,2,2,1,3
6228_0,,,,2,2,1,3
C(C(CO)C(C(CCO)=O)O)=O,,,4,1,7,0,7
6228_1,,,,2,2,1,3
6230_0,,,,2,2,1,3
C(C(CO)C(C=O)(CCO)O)=O,,,4,1,4,0,4
6230_1,,,,2,2,1,3
6232_0,,,,2,2,1,3
C(C(C(C)O)O)(C(CO)CO)=O,,,4,1,4,0,4
6232_1,,,,2,2,1,3
6233_0,,,,2,2,1,3
6233_1,,,,2,2,1,3
6235_0,,,,2,2,1,3
C(C(CO)C(CO)(CCO)O)=O,,,4,1,4,0,4
6235_1,,,,2,2,1,3
6237_0,,,,2,2,1,3
C(C(CO)C(C(C=O)O)O)=O,,,4,1,4,0,4
6237_1,,,,2,2,1,3
6238_0,,,,2,2,1,3
6238_1,,,,2,2,1,3
6239_0,,,,2,2,1,3
6239_1,,,,2,2,1,3
6240_0,,,,2,2,1,3
6241_0,,,,2,2,1,3
6241_1,,,,2,2,1,3
6242_0,,,,2,2,1,3
6242_1,,,,2,2,1,3
6243_0,,,,2,2,1,3
6245_0,,,,2,2,1,3
C(C(CO)C(C)(CO)O)=O,,,4,1,4,0,4
6245_1,,,,2,2,1,3
6247_0,,,,2,2,1,3
C(C(CO)C(C(CC=O)O)O)=O,,,4,1,6,0,6
6247_1,,,,2,2,1,3
6249_0,,,,2,2,1,3
C(C(CO)C(CC(C=O)O)O)=O,,,4,1,4,0,4
6249_1,,,,2,2,1,3
6251_0,,,,2,2,1,3
C(C(CO)C(C)O)=O,,,4,1,4,0,4
6251_1,,,,2,2,1,3
6253_0,,,,2,2,1,3
C(C(CO)C(CO)(C(CO)O)O)=O,,,4,1,4,0,4
6253_1,,,,2,2,1,3
6254_0,,,,2,2,1,3
6254_1,,,,2,2,1,3
6255_0,,,,2,2,1,3
6255_1,,,,2,2,1,3
6256_0,,,,2,2,1,3
6256_1,,,,2,2,1,3
6257_0,,,,2,2,1,3
6257_1,,,,2,2,1,3
6258_0,,,,2,2,1,3
6258_1,,,,2,2,1,3
6259_0,,,,2,2,1,3
6259_1,,,,2,2,1,3
6260_0,,,,2,2,1,3
6260_1,,,,2,2,1,3
6261_0,,,,2,2,1,3
6262_0,,,,2,2,1,3
6262_1,,,,2,2,1,3
6264_0,,,,2,2,1,3
C(C(CO)C(C(O)=O)O)(CCO)=O,,,4,1,4,0,4
6264_1,,,,2,2,1,3
6266_0,,,,2,2,1,3
C(CC(C(O)=O)O)(C(CO)CO)=O,,,4,1,4,0,4
6266_1,,,,2,2,1,3
6268_0,,,,2,2,1,3
C(C(CC(C(CO)=O)CO)O)(O)=O,,,4,1,3,0,3
6270_0,,,,2,2,1,3
C(C(CO)O)(CCC(C(O)=O)O)=O,,,4,1,4,0,4
6270_1,,,,2,2,1,3
6272_0,,,,2,2,1,3
C(C(CC(C(O)=O)O)O)(CCO)=O,,,4,1,3,0,3
6273_0,,,,2,2,1,3
6273_1,,,,2,2,1,3
6274_0,,,,2,2,1,3
6274_1,,,,2,2,1,3
6276_0,,,,2,2,1,3
C(C(C(C(CO)C(CO)O)=O)=O)=O,,,4,1,2,0,2
6276_1,,,,2,2,1,3
6278_0,,,,2,2,1,3
C(C(CO)O)(C(C(C=O)=O)CO)=O,,,4,1,2,0,2
6278_1,,,,2,2,1,3
6280_0,,,,2,2,1,3
C(C(CO)CO)(C(C(C=O)=O)O)=O,,,4,1,2,0,2
6280_1,,,,2,2,1,3
6282_0,,,,2,2,1,3
C(CO)(C(CO)C(C(C=O)=O)O)=O,,,4,1,2,0,2
6282_1,,,,2,2,1,3
6284_0,,,,2,2,1,3
C(CC(C(C=O)=O)O)(C(CO)O)=O,,,4,1,2,0,2
6284_1,,,,2,2,1,3
6286_0,,,,2,2,1,3
C(C(C(C(C=O)=O)O)O)(CCO)=O,,,4,1,3,0,3
6288_0,,,,2,2,1,3
C(C(CO)C(C(C(C=O)=O)O)O)=O,,,4,1,2,0,2
6288_1,,,,2,2,1,3
6289_0,,,,2,2,1,3
6289_1,,,,2,2,1,3
6290_0,,,,2,2,1,3
6290_1,,,,2,2,1,3
6291_0,,,,2,2,1,3
6291_1,,,,2,2,1,3
6293_0,,,,2,2,1,3
C(C(C)=O)(C(CO)O)=O,,,4,1,9,0,9
6293_1,,,,2,2,1,3
6295_0,,,,2,2,1,3
C(C(CO)=O)(CCO)=O,,,4,1,9,0,9
6296_0,,,,2,2,1,3
6296_1,,,,2,2,1,3
6298_0,,,,2,2,1,3
C(CO)(C(C(CO)=O)CO)=O,,,4,1,6,0,6
6298_1,,,,2,2,1,3
6299_0,,,,2,2,1,3
6299_1,,,,2,2,1,3
6300_0,,,,2,2,1,3
6302_0,,,,2,2,1,3
C(C(CO)O)(C(C)O)=O,,,4,1,8,0,8
6302_1,,,,2,2,1,3
6304_0,,,,2,2,1,3
C(C(C=O)CO)=O,,,4,1,6,0,6
6304_1,,,,2,2,1,3
6306_0,,,,2,2,1,3
C(C(C(C(CO)O)=O)O)=O,,,4,1,4,0,4
6306_1,,,,2,2,1,3
6307_0,,,,2,2,1,3
6309_0,,,,2,2,1,3
C(C(C(CO)=O)CO)(O)=O,,,4,1,6,0,6
6309_1,,,,2,2,1,3
6310_0,,,,2,2,1,3
6310_1,,,,2,2,1,3
6312_0,,,,2,2,1,3
C(C(C(CCO)=O)O)(O)=O,,,4,1,5,0,5
6314_0,,,,2,2,1,3
C(CO)(C(CO)C(C(O)=O)O)=O,,,4,1,6,0,6
6314_1,,,,2,2,1,3
6315_0,,,,2,2,1,3
6315_1,,,,2,2,1,3
6316_0,,,,2,2,1,3
6317_0,,,,2,2,1,3
6319_0,,,,2,2,1,3
C(C)(C(C(C=O)=O)CO)=O,,,4,1,6,0,6
6319_1,,,,2,2,1,3
6320_0,,,,2,2,1,3
6322_0,,,,2,2,1,3
C(C(C(C=O)=O)CO)=O,,,4,1,7,0,7
6322_1,,,,2,2,1,3
6324_0,,,,2,2,1,3
C(C(C(C(C)=O)=O)CO)=O,,,4,1,5,0,5
6324_1,,,,2,2,1,3
6325_0,,,,2,2,1,3
6327_0,,,,2,2,1,3
C(C(C)=O)(CCO)=O,,,4,1,11,0,11
6329_0,,,,2,2,1,3
C(CC(CCO)=O)=O,,,4,1,7,0,7
6331_0,,,,2,2,1,3
C(C(C(C)=O)CO)=O,,,4,1,5,0,5
6331_1,,,,2,2,1,3
6333_0,,,,2,2,1,3
C(OC(C(CCO)=O)C(CO)O)=O,,,4,1,3,0,3
6335_0,,,,2,2,1,3
C1(COC(C1CO)O)=O,,,4,1,5,0,5
6335_1,,,,2,2,1,3
6337_0,,,,2,2,1,3
C1(C(CO)OC(C1)O)=O,,,4,1,6,0,6
6337_1,,,,2,2,1,3
6339_0,,,,2,2,1,3
C(C(C(OC(C(C)=O)CO)O)O)=O,,,4,1,6,0,6
6339_1,,,,2,2,1,3
6341_0,,,,2,2,1,3
C(C(C(OCC(CCO)=O)O)O)=O,,,4,1,5,0,5
6343_0,,,,2,2,1,3
C(C(CO)OC(C(CO)=O)CO)=O,,,4,1,4,0,4
6343_1,,,,2,2,1,3
6345_0,,,,2,2,1,3
C(C(CO)OCC(C(CO)O)=O)=O,,,4,1,5,0,5
6345_1,,,,2,2,1,3
6347_0,,,,2,2,1,3
C(C(CO)OC(C(CCO)=O)O)=O,,,4,1,3,0,3
6349_0,,,,2,2,1,3
C(OC(CO)C(C(CCO)=O)O)=O,,,4,1,3,0,3
6351_0,,,,2,2,1,3
C(OC(CO)CC(C(CO)O)=O)=O,,,4,1,5,0,5
6351_1,,,,2,2,1,3
6353_0,,,,2,2,1,3
C(OC(CO)C(C(CO)=O)CO)=O,,,4,1,4,0,4
6353_1,,,,2,2,1,3
6355_0,,,,2,2,1,3
C(C(CO)OC(C=O)O)(CCO)=O,,,4,1,3,0,3
6357_0,,,,2,2,1,3
C1(COC(C(C1CO)O)O)=O,,,4,1,5,0,5
6357_1,,,,2,2,1,3
6358_0,,,,2,2,1,3
6358_1,,,,2,2,1,3
6360_0,,,,2,2,1,3
C(C(COC(C(CO)=O)CO)O)=O,,,4,1,4,0,4
6360_1,,,,2,2,1,3
6362_0,,,,2,2,1,3
C(C(COCC(C(CO)O)=O)O)=O,,,4,1,5,0,5
6362_1,,,,2,2,1,3
6364_0,,,,2,2,1,3
C(C(COC(C(CCO)=O)O)O)=O,,,4,1,3,0,3
6366_0,,,,2,2,1,3
C(OCC(C(C(CCO)=O)O)O)=O,,,4,1,3,0,3
6368_0,,,,2,2,1,3
C(CO)(C(C(OCC=O)O)CO)=O,,,4,1,4,0,4
6368_1,,,,2,2,1,3
6370_0,,,,2,2,1,3
C(C(CO)O)(CC(OCC=O)O)=O,,,4,1,5,0,5
6370_1,,,,2,2,1,3
6372_0,,,,2,2,1,3
C(C(CO)OC(CC(CO)=O)O)=O,,,4,1,2,0,2
6372_1,,,,2,2,1,3
6374_0,,,,2,2,1,3
C(OCC(CC(C(CO)O)=O)O)=O,,,4,1,5,0,5
6374_1,,,,2,2,1,3
6376_0,,,,2,2,1,3
C(OCC(C(C(CO)=O)CO)O)=O,,,4,1,4,0,4
6376_1,,,,2,2,1,3
6378_0,,,,2,2,1,3
C(C(C(OCC=O)O)O)(CCO)=O,,,4,1,3,0,3
6380_0,,,,2,2,1,3
C(C(CO)OC(C(C(C)=O)O)O)=O,,,4,1,2,0,2
6380_1,,,,2,2,1,3
6382_0,,,,2,2,1,3
C(C(COC(C=O)O)O)(CCO)=O,,,4,1,3,0,3
6384_0,,,,2,2,1,3
C(C(CO)O)(CCOC(C=O)O)=O,,,4,1,5,0,5
6384_1,,,,2,2,1,3
6386_0,,,,2,2,1,3
C(CO)(C(CO)COC(C=O)O)=O,,,4,1,4,0,4
6386_1,,,,2,2,1,3
6387_0,,,,2,2,1,3
6387_1,,,,2,2,1,3
6389_0,,,,2,2,1,3
C=CC(C(CO)O)=O,,,4,1,7,0,7
6389_1,,,,2,2,1,3
6391_0,,,,2,2,1,3
C(CC(CO)(OC(C=O)CO)O)=O,,,4,1,5,0,5
6391_1,,,,2,2,1,3
6393_0,,,,2,2,1,3
C(C(CO)C(CO)(OCC=O)O)=O,,,4,1,2,0,2
6393_1,,,,2,2,1,3
6395_0,,,,2,2,1,3
C(C(C(C)(OC(C=O)CO)O)O)=O,,,4,1,5,0,5
6395_1,,,,2,2,1,3
6397_0,,,,2,2,1,3
C(C(CC(OC(C=O)CO)O)O)=O,,,4,1,5,0,5
6397_1,,,,2,2,1,3
6399_0,,,,2,2,1,3
C(C(C(CO)O)=O)(C(CO)CO)=O,,,4,1,4,0,4
6399_1,,,,2,2,1,3
6401_0,,,,2,2,1,3
C(C(C(CO)O)=O)(C(CCO)O)=O,,,4,1,3,0,3
6401_1,,,,2,2,1,3
6402_0,,,,2,2,1,3
6404_0,,,,2,2,1,3
C(C(CO)O)(C(C(C(C)O)=O)O)=O,,,4,1,3,0,3
6404_1,,,,2,2,1,3
6406_0,,,,2,2,1,3
C(C(CC(CO)O)O)(C(CO)O)=O,,,4,1,3,0,3
6406_1,,,,2,2,1,3
6408_0,,,,2,2,1,3
C(C(C(CCO)O)O)(C(CO)O)=O,,,4,1,5,0,5
6408_1,,,,2,2,1,3
6410_0,,,,2,2,1,3
C(C(CC(C(C=O)=O)CO)O)=O,,,4,1,3,0,3
6412_0,,,,2,2,1,3
C(C(C)O)(C(C(C=O)=O)CO)=O,,,4,1,4,0,4
6412_1,,,,2,2,1,3
6414_0,,,,2,2,1,3
C(C(CO)C(C(C(C)=O)=O)O)=O,,,4,1,4,0,4
6414_1,,,,2,2,1,3
6416_0,,,,2,2,1,3
C(CC(C(C(CCO)=O)=O)O)=O,,,4,1,2,0,2
6418_0,,,,2,2,1,3
C(C(C(C(C(C)O)=O)=O)CO)=O,,,4,1,4,0,4
6418_1,,,,2,2,1,3
6420_0,,,,2,2,1,3
C(C)(CC(C(C(CO)O)=O)=O)=O,,,4,1,4,0,4
6420_1,,,,2,2,1,3
6422_0,,,,2,2,1,3
C(C)(C(C(C(CO)=O)=O)CO)=O,,,4,1,5,0,5
6422_1,,,,2,2,1,3
6424_0,,,,2,2,1,3
C(CCO)(CC(C(CO)=O)=O)=O,,,4,1,3,0,3
6426_0,,,,2,2,1,3
C(C)(C(CO)C(C(C=O)=O)O)=O,,,4,1,3,0,3
6426_1,,,,2,2,1,3
6428_0,,,,2,2,1,3
C(CC(C(C=O)=O)O)(CCO)=O,,,4,1,2,0,2
6430_0,,,,2,2,1,3
C(CCC(C(C(CO)O)=O)=O)=O,,,4,1,4,0,4
6430_1,,,,2,2,1,3
6432_0,,,,2,2,1,3
C(CC(C(C(CO)=O)=O)CO)=O,,,4,1,4,0,4
6434_0,,,,2,2,1,3
C(C(CO)CC(C(CO)=O)=O)=O,,,4,1,3,0,3
6436_0,,,,2,2,1,3
C(C(CO)CC(C(C=O)=O)O)=O,,,4,1,2,0,2
6438_0,,,,2,2,1,3
C(C(CO)O)(CC(C(C)=O)=O)=O,,,4,1,4,0,4
6438_1,,,,2,2,1,3
6440_0,,,,2,2,1,3
C(CO)(C(C(C(C)=O)=O)CO)=O,,,4,1,5,0,5
6440_1,,,,2,2,1,3
6442_0,,,,2,2,1,3
C(CO)(CC(C(CCO)=O)=O)=O,,,4,1,3,0,3
6444_0,,,,2,2,1,3
C1(C(CO)OC(C(CC1O)O)O)=O,,,4,1,3,0,3
6444_1,,,,2,2,1,3
6446_0,,,,2,2,1,3
C(CO)=CC(C(C(CO)O)=O)=O,,,4,1,3,0,3
6446_1,,,,2,2,1,3
6448_0,,,,2,2,1,3
C(C(CO)O)(C(C=CC=O)O)=O,,,4,1,4,0,4
6448_1,,,,2,2,1,3
6450_0,,,,2,2,1,3
C(C(CO)O)(C(C(C=C)=O)O)=O,,,4,1,3,0,3
6450_1,,,,2,2,1,3
6452_0,,,,2,2,1,3
C(C=CC(CO)=O)(C(CO)O)=O,,,4,1,5,0,5
6452_1,,,,2,2,1,3
6454_0,,,,2,2,1,3
C(C1(CC(CO1)O)O)(C(CO)O)=O,,,4,1,3,0,3
6454_1,,,,2,2,1,3
6456_0,,,,2,2,1,3
C(C1C(CC(O1)O)O)(C(CO)O)=O,,,4,1,3,0,3
6456_1,,,,2,2,1,3
6458_0,,,,2,2,1,3
C(CCO)(CC(C(CO)O)=O)=O,,,4,1,7,0,7
6458_1,,,,2,2,1,3
6460_0,,,,2,2,1,3
C(CCO)(C(C(CO)=O)CO)=O,,,4,1,6,0,6
6460_1,,,,2,2,1,3
6462_0,,,,2,2,1,3
C(C(CO)CO)(CC(CO)=O)=O,,,4,1,5,0,5
6462_1,,,,2,2,1,3
6464_0,,,,2,2,1,3
C(CCC(C(CO)O)=O)(CO)=O,,,4,1,5,0,5
6464_1,,,,2,2,1,3
6466_0,,,,2,2,1,3
C(CO)(C(CO)CC(CO)=O)=O,,,4,1,6,0,6
6468_0,,,,2,2,1,3
C(C(C(CO)C(CCO)O)=O)=O,,,4,1,5,0,5
6468_1,,,,2,2,1,3
6470_0,,,,2,2,1,3
C(C(CCO)=O)(C(CO)CO)=O,,,4,1,6,0,6
6470_1,,,,2,2,1,3
6472_0,,,,2,2,1,3
C(C(CO)CO)(C(C(C)=O)O)=O,,,4,1,4,0,4
6472_1,,,,2,2,1,3
6474_0,,,,2,2,1,3
C(CCO)(C(C(CCO)=O)O)=O,,,4,1,3,0,3
6476_0,,,,2,2,1,3
C(C(C(C(CCO)O)=O)CO)=O,,,4,1,4,0,4
6476_1,,,,2,2,1,3
6478_0,,,,2,2,1,3
C(C(CO)O)(C(C(C)=O)CO)=O,,,4,1,5,0,5
6478_1,,,,2,2,1,3
6479_0,,,,2,2,1,3
6481_0,,,,2,2,1,3
C(C(CO)CC=O)(C(CO)O)=O,,,4,1,4,0,4
6483_0,,,,2,2,1,3
C(C(CO)CC(C(CO)O)=O)=O,,,4,1,5,0,5
6485_0,,,,2,2,1,3
C(C(C(C(CO)CCO)=O)O)=O,,,4,1,2,0,2
6487_0,,,,2,2,1,3
C(C(C)=O)(C(CO)C(CO)O)=O,,,4,1,5,0,5
6487_1,,,,2,2,1,3
6489_0,,,,2,2,1,3
C(C(CCO)=O)(CC(CO)O)=O,,,4,1,3,0,3
6491_0,,,,2,2,1,3
C(CC(C(CO)C(CO)O)=O)=O,,,4,1,4,0,4
6491_1,,,,2,2,1,3
6493_0,,,,2,2,1,3
C(C(C(CC(CO)O)=O)CO)=O,,,4,1,5,0,5
6493_1,,,,2,2,1,3
6495_0,,,,2,2,1,3
C(C(CO)C(C=O)O)(CCO)=O,,,4,1,3,0,3
6495_1,,,,2,2,1,3
6497_0,,,,2,2,1,3
C(CC(C=O)O)(C(CO)CO)=O,,,4,1,3,0,3
6497_1,,,,2,2,1,3
6499_0,,,,2,2,1,3
C(C(CO)O)=CC(C(CO)O)=O,,,4,1,4,0,4
6499_1,,,,2,2,1,3
6501_0,,,,2,2,1,3
C(C(C(CO)CO)=O)(O)=O,,,4,1,4,0,4
6501_1,,,,2,2,1,3
6502_0,,,,2,2,1,3
6502_1,,,,2,2,1,3
6504_0,,,,2,2,1,3
C(CCO)(C(C(C(O)=O)=O)CO)=O,,,4,1,3,0,3
6504_1,,,,2,2,1,3
6506_0,,,,2,2,1,3
C(C(CO)CO)(CC(C(O)=O)=O)=O,,,4,1,3,0,3
6506_1,,,,2,2,1,3
6508_0,,,,2,2,1,3
C(CC(C(C(O)=O)=O)CO)(CO)=O,,,4,1,2,0,2
6510_0,,,,2,2,1,3
C(CO)(C(CO)CC(C(O)=O)=O)=O,,,4,1,2,0,2
6512_0,,,,2,2,1,3
C(CCC(C(O)=O)=O)(C(CO)O)=O,,,4,1,3,0,3
6512_1,,,,2,2,1,3
6513_0,,,,2,2,1,3
6513_1,,,,2,2,1,3
6515_0,,,,2,2,1,3
C(C(CC(C(O)=O)=O)O)(CCO)=O,,,4,1,3,0,3
6516_0,,,,2,2,1,3
6516_1,,,,2,2,1,3
6518_0,,,,2,2,1,3
C(C(CO)C(CC(C(O)=O)=O)O)=O,,,4,1,3,0,3
6518_1,,,,2,2,1,3
6520_0,,,,2,2,1,3
C(CC(C(C(C=O)=O)CO)O)(O)=O,,,4,1,3,0,3
6520_1,,,,2,2,1,3
6521_0,,,,2,2,1,3
6521_1,,,,2,2,1,3
6523_0,,,,2,2,1,3
C(CC(C(C(CO)CO)=O)=O)(O)=O,,,4,1,3,0,3
6523_1,,,,2,2,1,3
6524_0,,,,2,2,1,3
6524_1,,,,2,2,1,3
6526_0,,,,2,2,1,3
C(CC(O)=O)(C(C(CO)=O)CO)=O,,,4,1,3,0,3
6526_1,,,,2,2,1,3
6527_0,,,,2,2,1,3
6527_1,,,,2,2,1,3
6528_0,,,,2,2,1,3
6528_1,,,,2,2,1,3
6529_0,,,,2,2,1,3
6530_0,,,,2,2,1,3
6530_1,,,,2,2,1,3
6532_0,,,,2,2,1,3
C(C(CO)C(C(CC(O)=O)=O)O)=O,,,4,1,3,0,3
6532_1,,,,2,2,1,3
6534_0,,,,2,2,1,3
C(CC(C(C(C=O)CO)=O)O)(O)=O,,,4,1,3,0,3
6534_1,,,,2,2,1,3
6536_0,,,,2,2,1,3
C(C(C(O)=O)O)(C(C(C)=O)CO)=O,,,4,1,3,0,3
6536_1,,,,2,2,1,3
6537_0,,,,2,2,1,3
6539_0,,,,2,2,1,3
C(C(CO)CC=O)(C(C(O)=O)O)=O,,,4,1,2,0,2
6541_0,,,,2,2,1,3
C(C(CO)CC(C(C(O)=O)O)=O)=O,,,4,1,2,0,2
6543_0,,,,2,2,1,3
C(C(CO)CC(O)=O)(C(C=O)O)=O,,,4,1,2,0,2
6545_0,,,,2,2,1,3
C(C(C(C(C(C)=O)=O)CO)O)(O)=O,,,4,1,3,0,3
6545_1,,,,2,2,1,3
6547_0,,,,2,2,1,3
C(C(CC(C(CCO)=O)=O)O)(O)=O,,,4,1,2,0,2
6549_0,,,,2,2,1,3
C(C(CO)C(C(O)=O)O)(CC=O)=O,,,4,1,3,0,3
6549_1,,,,2,2,1,3
6551_0,,,,2,2,1,3
C(CC(C(O)=O)O)(C(C=O)CO)=O,,,4,1,3,0,3
6551_1,,,,2,2,1,3
6553_0,,,,2,2,1,3
C(C(CO)C(C=O)O)(CC(O)=O)=O,,,4,1,3,0,3
6553_1,,,,2,2,1,3
6554_0,,,,2,2,1,3
6554_1,,,,2,2,1,3
6556_0,,,,2,2,1,3
C(C(C=CC(C(CO)O)=O)O)(O)=O,,,4,1,3,0,3
6556_1,,,,2,2,1,3
6558_0,,,,2,2,1,3
C(C1(C(C(CO)CC1O)=O)O)=O,,,4,1,3,0,3
6559_0,,,,2,2,1,3
6560_0,,,,2,2,1,3
6562_0,,,,2,2,1,3
C(CCO)(C(C=O)(C(C=O)O)O)=O,,,4,1,3,0,3
6564_0,,,,2,2,1,3
C(C(C(CCO)=O)(CO)O)=O,,,4,1,4,0,4
6566_0,,,,2,2,1,3
C(C(C(CCO)=O)(C(C)O)O)=O,,,4,1,3,0,3
6568_0,,,,2,2,1,3
C(CCO)(C(CO)(CO)O)=O,,,4,1,3,0,3
6570_0,,,,2,2,1,3
C(CCO)(C(CO)(C(C)O)O)=O,,,4,1,5,0,5
6572_0,,,,2,2,1,3
C(C(CO)O)(C(CO)(CO)O)=O,,,4,1,5,0,5
6572_1,,,,2,2,1,3
6574_0,,,,2,2,1,3
C(C(CO)O)(C(CO)(C(C)O)O)=O,,,4,1,6,0,6
6574_1,,,,2,2,1,3
6576_0,,,,2,2,1,3
C(C(C(CCO)=O)(C(CO)O)O)=O,,,4,1,3,0,3
6577_0,,,,2,2,1,3
6579_0,,,,2,2,1,3
C1(C(CO)C(C=O)(C(C1)O)O)=O,,,4,1,3,0,3
6579_1,,,,2,2,1,3
6581_0,,,,2,2,1,3
C(C1(C(C(C(C1)=O)CO)O)O)=O,,,4,1,3,0,3
6581_1,,,,2,2,1,3
6583_0,,,,2,2,1,3
C(C(C(C=O)(C(C=O)CO)O)O)=O,,,4,1,3,0,3
6583_1,,,,2,2,1,3
6585_0,,,,2,2,1,3
C(C(CO)(C(C(CO)=O)CO)O)=O,,,4,1,5,0,5
6585_1,,,,2,2,1,3
6586_0,,,,2,2,1,3
6586_1,,,,2,2,1,3
6587_0,,,,2,2,1,3
6587_1,,,,2,2,1,3
6588_0,,,,2,2,1,3
6588_1,,,,2,2,1,3
6589_0,,,,2,2,1,3
6589_1,,,,2,2,1,3
6590_0,,,,2,2,1,3
6590_1,,,,2,2,1,3
6592_0,,,,2,2,1,3
C1(C(CO)C(C(C1O)=O)CO)=O,,,4,1,1,0,1
6594_0,,,,2,2,1,3
C(C(C(C(CO)O)O)=O)(CCO)=O,,,4,1,2,0,2
6596_0,,,,2,2,1,3
C1(C(CO)CC(C1(CO)O)=O)=O,,,4,1,4,0,4
6598_0,,,,2,2,1,3
C1(C(CO)C(C(C1)=O)(CO)O)=O,,,4,1,3,0,3
6598_1,,,,2,2,1,3
6600_0,,,,2,2,1,3
C1(C(CO)(CC(C1CO)=O)O)=O,,,4,1,4,0,4
6600_1,,,,2,2,1,3
6602_0,,,,2,2,1,3
C1(CC(C(C(CCO)=O)O1)O)=O,,,4,1,2,0,2
6604_0,,,,2,2,1,3
C(C(CO)C1C(CC(O1)=O)O)=O,,,4,1,3,0,3
6604_1,,,,2,2,1,3
6606_0,,,,2,2,1,3
C(C1C(C(C(CO)O1)=O)O)(C)=O,,,4,1,3,0,3
6606_1,,,,2,2,1,3
6608_0,,,,2,2,1,3
C(C1C(C(CO1)=O)O)(CCO)=O,,,4,1,2,0,2
6610_0,,,,2,2,1,3
C(CC1C(C(C(CO)O1)=O)O)=O,,,4,1,3,0,3
6610_1,,,,2,2,1,3
6612_0,,,,2,2,1,3
C(C(CO)C1C(C(CO1)=O)O)=O,,,4,1,3,0,3
6612_1,,,,2,2,1,3
6614_0,,,,2,2,1,3
C(C1C(C(C(O1)O)=O)CO)(C)=O,,,4,1,4,0,4
6614_1,,,,2,2,1,3
6616_0,,,,2,2,1,3
C1(C(OC(C(CCO)=O)C1)O)=O,,,4,1,3,0,3
6618_0,,,,2,2,1,3
C(CC1C(C(C(O)O1)=O)CO)=O,,,4,1,4,0,4
6618_1,,,,2,2,1,3
6620_0,,,,2,2,1,3
C(C(CO)C1CC(C(O)O1)=O)=O,,,4,1,4,0,4
6620_1,,,,2,2,1,3
6622_0,,,,2,2,1,3
C1(C(CO)C(OC1C(C)=O)O)=O,,,4,1,4,0,4
6622_1,,,,2,2,1,3
6624_0,,,,2,2,1,3
C(CCO)(C1C(CC(O1)O)=O)=O,,,4,1,3,0,3
6626_0,,,,2,2,1,3
C(CC1C(C(CO)C(O1)O)=O)=O,,,4,1,4,0,4
6626_1,,,,2,2,1,3
6628_0,,,,2,2,1,3
C(C(CO)C1C(CC(O1)O)=O)=O,,,4,1,4,0,4
6628_1,,,,2,2,1,3
6630_0,,,,2,2,1,3
C1(C(C(CC(CO)O1)=O)CO)=O,,,4,1,4,0,4
6630_1,,,,2,2,1,3
6632_0,,,,2,2,1,3
C1(CC(C(CO)C(CO)O1)=O)=O,,,4,1,3,0,3
6632_1,,,,2,2,1,3
6634_0,,,,2,2,1,3
C1(C(CO)OC(CC1CO)=O)=O,,,4,1,2,0,2
6636_0,,,,2,2,1,3
C1(C(C(CO)OC(CO)C1)=O)=O,,,4,1,3,0,3
6636_1,,,,2,2,1,3
6638_0,,,,2,2,1,3
C1(C(COC(CO)C1CO)=O)=O,,,4,1,3,0,3
6638_1,,,,2,2,1,3
6640_0,,,,2,2,1,3
C1(C(CO)OC(C(C1)=O)CO)=O,,,4,1,3,0,3
6640_1,,,,2,2,1,3
6642_0,,,,2,2,1,3
C1(C(CO)OCC(C1CO)=O)=O,,,4,1,4,0,4
6642_1,,,,2,2,1,3
6644_0,,,,2,2,1,3
C1(C(C(CC(CO1)O)=O)CO)=O,,,4,1,4,0,4
6644_1,,,,2,2,1,3
6646_0,,,,2,2,1,3
C1(CC(C(CO)C(CO1)O)=O)=O,,,4,1,3,0,3
6646_1,,,,2,2,1,3
6648_0,,,,2,2,1,3
C1(C(CO)CC(OCC1O)=O)=O,,,4,1,2,0,2
6650_0,,,,2,2,1,3
C1(CC(C(C(CO)CO1)=O)O)=O,,,4,1,3,0,3
6650_1,,,,2,2,1,3
6652_0,,,,2,2,1,3
C1(CC(C(C(CO1)=O)CO)O)=O,,,4,1,3,0,3
6652_1,,,,2,2,1,3
6654_0,,,,2,2,1,3
C1(CC(CC(C(CO)O1)=O)O)=O,,,4,1,3,0,3
6654_1,,,,2,2,1,3
6656_0,,,,2,2,1,3
C1(C(C(CO)OCC(C1)O)=O)=O,,,4,1,3,0,3
6656_1,,,,2,2,1,3
6658_0,,,,2,2,1,3
C1(C(COCC(C1CO)O)=O)=O,,,4,1,3,0,3
6658_1,,,,2,2,1,3
6660_0,,,,2,2,1,3
C1(C(COC(C(C1)=O)CO)O)=O,,,4,1,3,0,3
6660_1,,,,2,2,1,3
6662_0,,,,2,2,1,3
C1(C(COCC(C1CO)=O)O)=O,,,4,1,4,0,4
6662_1,,,,2,2,1,3
6664_0,,,,2,2,1,3
C1(CCOC(C(C1O)=O)CO)=O,,,4,1,3,0,3
6664_1,,,,2,2,1,3
6666_0,,,,2,2,1,3
C1(C(CO)COCC(C1O)=O)=O,,,4,1,3,0,3
6666_1,,,,2,2,1,3
6668_0,,,,2,2,1,3
C1(CC(C(C(CO)OC1)=O)O)=O,,,4,1,3,0,3
6668_1,,,,2,2,1,3
6670_0,,,,2,2,1,3
C1(COCC(C(C1CO)O)=O)=O,,,4,1,3,0,3
6670_1,,,,2,2,1,3
6672_0,,,,2,2,1,3
C1(CC(C(COC1CO)=O)O)=O,,,4,1,3,0,3
6672_1,,,,2,2,1,3
6674_0,,,,2,2,1,3
C1(CCOC(C(C1CO)=O)O)=O,,,4,1,5,0,5
6674_1,,,,2,2,1,3
6676_0,,,,2,2,1,3
C1(C(CO)COC(C(C1)=O)O)=O,,,4,1,4,0,4
6676_1,,,,2,2,1,3
6678_0,,,,2,2,1,3
C1(CC(C(C(OC1)O)=O)CO)=O,,,4,1,3,0,3
6680_0,,,,2,2,1,3
C1(COC(C(CC1CO)=O)O)=O,,,4,1,3,0,3
6682_0,,,,2,2,1,3
C1(CCC(C(OC1CO)O)=O)=O,,,4,1,4,0,4
6682_1,,,,2,2,1,3
6684_0,,,,2,2,1,3
C1(C(CCOC(C1CO)O)=O)=O,,,4,1,4,0,4
6684_1,,,,2,2,1,3
6686_0,,,,2,2,1,3
C1(C(CC(O)OCC1CO)=O)=O,,,4,1,4,0,4
6686_1,,,,2,2,1,3
6688_0,,,,2,2,1,3
C1(C(CO)C(OCC(C1)=O)O)=O,,,4,1,4,0,4
6688_1,,,,2,2,1,3
6690_0,,,,2,2,1,3
C1(CC(OCC(C1CO)=O)O)=O,,,4,1,5,0,5
6690_1,,,,2,2,1,3
6692_0,,,,2,2,1,3
C1(CC(OC(C(C1)=O)CO)O)=O,,,4,1,4,0,4
6692_1,,,,2,2,1,3
6694_0,,,,2,2,1,3
C(C(C=CC(CCO)=O)=O)=O,,,4,1,2,0,2
6696_0,,,,2,2,1,3
C(C(C=CC(C=O)=O)CO)=O,,,4,1,2,0,2
6698_0,,,,2,2,1,3
C(C(C=CC=O)=O)(CCO)=O,,,4,1,2,0,2
6700_0,,,,2,2,1,3
C(C(C(C=CC=O)=O)CO)=O,,,4,1,6,0,6
6700_1,,,,2,2,1,3
6702_0,,,,2,2,1,3
C=CC(C(C(C=O)=O)CO)=O,,,4,1,4,0,4
6702_1,,,,2,2,1,3
6704_0,,,,2,2,1,3
C(C(C(C(C=C)=O)=O)CO)=O,,,4,1,4,0,4
6704_1,,,,2,2,1,3
6706_0,,,,2,2,1,3
C(C(C(C=O)=O)CO)=CC=O,,,4,1,2,0,2
6708_0,,,,2,2,1,3
C1(C(CO)OCC1O)=O,,,4,1,2,0,2
6708_1,,,,2,2,1,3
6710_0,,,,2,2,1,3
C1(C(O)OCC1CO)=O,,,4,1,3,0,3
6710_1,,,,2,2,1,3
6712_0,,,,2,2,1,3
C1(C(CO)(O)OC(CO)C1CO)=O,,,4,1,3,0,3
6712_1,,,,2,2,1,3
6714_0,,,,2,2,1,3
C1(C(CO)OC(CO)(C1CO)O)=O,,,4,1,3,0,3
6714_1,,,,2,2,1,3
6716_0,,,,2,2,1,3
C(C(CO)C1C(C(CO1)O)=O)=O,,,4,1,3,0,3
6716_1,,,,2,2,1,3
6718_0,,,,2,2,1,3
C(C(CO)C1(C(CCO1)=O)O)=O,,,4,1,4,0,4
6718_1,,,,2,2,1,3
6720_0,,,,2,2,1,3
C(CC1(C(C(CO)CO1)=O)O)=O,,,4,1,3,0,3
6720_1,,,,2,2,1,3
6722_0,,,,2,2,1,3
C(C(CO)C1(CC(CO1)=O)O)=O,,,4,1,4,0,4
6722_1,,,,2,2,1,3
6724_0,,,,2,2,1,3
C(CC1(C(C(CO1)=O)CO)O)=O,,,4,1,3,0,3
6724_1,,,,2,2,1,3
6726_0,,,,2,2,1,3
C(CC1(CC(C(CO)O1)=O)O)=O,,,4,1,3,0,3
6726_1,,,,2,2,1,3
6728_0,,,,2,2,1,3
C(C1C(C(CO)C(C)(O1)O)=O)=O,,,4,1,3,0,3
6728_1,,,,2,2,1,3
6730_0,,,,2,2,1,3
C1(C(C)(OC(C=O)C1CO)O)=O,,,4,1,3,0,3
6730_1,,,,2,2,1,3
6732_0,,,,2,2,1,3
C1(C(CO)(O)OCC(C1CO)O)=O,,,4,1,3,0,3
6732_1,,,,2,2,1,3
6734_0,,,,2,2,1,3
C1(C(COC(CO)(C1CO)O)O)=O,,,4,1,3,0,3
6734_1,,,,2,2,1,3
6736_0,,,,2,2,1,3
C1(C(C(CO)(O)OCC1CO)O)=O,,,4,1,3,0,3
6736_1,,,,2,2,1,3
6738_0,,,,2,2,1,3
C1(COC(CO)(C(C1CO)O)O)=O,,,4,1,3,0,3
6738_1,,,,2,2,1,3
6740_0,,,,2,2,1,3
C1(C(CO)OC(C(C1)O)(CO)O)=O,,,4,1,3,0,3
6740_1,,,,2,2,1,3
6742_0,,,,2,2,1,3
C1(C(CO)C(C=O)(O)OCC1)=O,,,4,1,3,0,3
6742_1,,,,2,2,1,3
6744_0,,,,2,2,1,3
C1(CC(C=O)(O)OCC1CO)=O,,,4,1,3,0,3
6744_1,,,,2,2,1,3
6746_0,,,,2,2,1,3
C(C1(CC(C(CO1)=O)CO)O)=O,,,4,1,2,0,2
6748_0,,,,2,2,1,3
C1(C(CO)OC(C=O)(CC1)O)=O,,,4,1,3,0,3
6748_1,,,,2,2,1,3
6750_0,,,,2,2,1,3
C(C1C(C(CO)CC(O1)O)=O)=O,,,4,1,2,0,2
6752_0,,,,2,2,1,3
C1(C(CO)C(C=O)OC(C1)O)=O,,,4,1,3,0,3
6752_1,,,,2,2,1,3
6754_0,,,,2,2,1,3
C1(CC(C=O)OC(C1CO)O)=O,,,4,1,3,0,3
6754_1,,,,2,2,1,3
6756_0,,,,2,2,1,3
C1(C(C(CO)C(C(CO)O)O1)=O)=O,,,4,1,2,0,2
6756_1,,,,2,2,1,3
6758_0,,,,2,2,1,3
C1(C(C(C(C(CO)O)O1)=O)CO)=O,,,4,1,2,0,2
6758_1,,,,2,2,1,3
6760_0,,,,2,2,1,3
C1(C(C(C(C(CCO)=O)O1)O)O)=O,,,4,1,1,0,1
6762_0,,,,2,2,1,3
C(C(CO)C1C(C(C(O1)=O)O)O)=O,,,4,1,2,0,2
6762_1,,,,2,2,1,3
6764_0,,,,2,2,1,3
C1(C(C(CO)C(C(CO)O1)O)=O)=O,,,4,1,2,0,2
6764_1,,,,2,2,1,3
6766_0,,,,2,2,1,3
C1(C(C(C(C(CO)O1)O)=O)CO)=O,,,4,1,2,0,2
6766_1,,,,2,2,1,3
6768_0,,,,2,2,1,3
C1(C(C(C(CO)C(CO)O1)=O)O)=O,,,4,1,2,0,2
6768_1,,,,2,2,1,3
6770_0,,,,2,2,1,3
C1(C(CO)OC(C(C1CO)O)=O)=O,,,4,1,2,0,2
6770_1,,,,2,2,1,3
6772_0,,,,2,2,1,3
C1(C(C(CO)C(C(CO1)O)O)=O)=O,,,4,1,2,0,2
6772_1,,,,2,2,1,3
6774_0,,,,2,2,1,3
C1(C(C(C(C(CO1)O)O)=O)CO)=O,,,4,1,2,0,2
6774_1,,,,2,2,1,3
6776_0,,,,2,2,1,3
C1(C(C(C(CO)C(CO1)O)=O)O)=O,,,4,1,2,0,2
6776_1,,,,2,2,1,3
6778_0,,,,2,2,1,3
C1(C(CO)C(C(OCC1O)=O)O)=O,,,4,1,2,0,2
6778_1,,,,2,2,1,3
6780_0,,,,2,2,1,3
C1(C(C(C(OCC1CO)=O)O)O)=O,,,4,1,2,0,2
6780_1,,,,2,2,1,3
6782_0,,,,2,2,1,3
C1(C(C(C(C(CO1)=O)CO)O)O)=O,,,4,1,2,0,2
6782_1,,,,2,2,1,3
6784_0,,,,2,2,1,3
C1(C(C(CC(C(CO)O1)=O)O)O)=O,,,4,1,2,0,2
6784_1,,,,2,2,1,3
6786_0,,,,2,2,1,3
C1C(C(OC(C(C=1)=O)CO)O)O,,,4,1,3,0,3
6786_1,,,,2,2,1,3
6788_0,,,,2,2,1,3
C1(C(CO)OC(C(CO)O)(C1)O)=O,,,4,1,3,0,3
6788_1,,,,2,2,1,3
6790_0,,,,2,2,1,3
C1(COC(C(CO)O)(C1CO)O)=O,,,4,1,3,0,3
6790_1,,,,2,2,1,3
6792_0,,,,2,2,1,3
C(C1CC(C(O1)O)O)(C(CO)O)=O,,,4,1,3,0,3
6792_1,,,,2,2,1,3
6794_0,,,,2,2,1,3
C1(C(CO)OC(CCO)(C1O)O)=O,,,4,1,3,0,3
6794_1,,,,2,2,1,3
6796_0,,,,2,2,1,3
C1(C(CO)OC(CC1O)(CO)O)=O,,,4,1,3,0,3
6796_1,,,,2,2,1,3
6798_0,,,,2,2,1,3
C1(C(CO)OC(C(C1O)O)(C)O)=O,,,4,1,3,0,3
6798_1,,,,2,2,1,3
6800_0,,,,2,2,1,3
C1(C(CO)OC(CC(C1O)O)O)=O,,,4,1,3,0,3
6800_1,,,,2,2,1,3
6801_0,,,,2,2,1,3
6801_1,,,,2,2,1,3
6802_0,,,,2,2,1,3
6802_1,,,,2,2,1,3
6803_0,,,,2,2,1,3
6803_1,,,,2,2,1,3
6805_0,,,,2,2,1,3
C(C(C(CO)C(CC(C)O)O)=O)=O,,,4,1,2,0,2
6805_1,,,,2,2,1,3
6807_0,,,,2,2,1,3
C(C(C(C)O)C(C(CCO)=O)O)=O,,,4,1,5,0,5
6807_1,,,,2,2,1,3
6809_0,,,,2,2,1,3
C(C(C(C)O)C(C=O)(CCO)O)=O,,,4,1,4,0,4
6809_1,,,,2,2,1,3
6811_0,,,,2,2,1,3
C(C(CO)(C(C(C=O)=O)CO)O)=O,,,4,1,3,0,3
6811_1,,,,2,2,1,3
6813_0,,,,2,2,1,3
C(C(C(C(C=O)=O)CO)O)(CO)=O,,,4,1,3,0,3
6813_1,,,,2,2,1,3
6814_0,,,,2,2,1,3
6814_1,,,,2,2,1,3
6816_0,,,,2,2,1,3
C(C(CCO)(C(C(C=O)=O)O)O)=O,,,4,1,2,0,2
6816_1,,,,2,2,1,3
6817_0,,,,2,2,1,3
6817_1,,,,2,2,1,3
6819_0,,,,2,2,1,3
C(C(C=O)C(C(CCO)=O)O)=O,,,4,1,3,0,3
6819_1,,,,2,2,1,3
6821_0,,,,2,2,1,3
C(C(C=O)C(C=O)(CCO)O)=O,,,4,1,3,0,3
6821_1,,,,2,2,1,3
6823_0,,,,2,2,1,3
C(C(C)(C(C(C=O)=O)CO)O)(O)=O,,,4,1,3,0,3
6823_1,,,,2,2,1,3
6824_0,,,,2,2,1,3
6826_0,,,,2,2,1,3
C(C(CCO)(CC(C(O)=O)=O)O)=O,,,4,1,2,0,2
6828_0,,,,2,2,1,3
C(C(C(C=O)=O)CO)(O)=O,,,4,1,2,0,2
6828_1,,,,2,2,1,3
6830_0,,,,2,2,1,3
C(C(C(C(C=O)=O)CO)O)(O)=O,,,4,1,3,0,3
6830_1,,,,2,2,1,3
6832_0,,,,2,2,1,3
C(C)(C(C)(C(C(C=O)=O)CO)O)=O,,,4,1,2,0,2
6832_1,,,,2,2,1,3
6834_0,,,,2,2,1,3
C(C(CC(C(C)=O)=O)O)(CCO)=O,,,4,1,1,0,1
6836_0,,,,2,2,1,3
C(C(CCO)(CC(C(C)=O)=O)O)=O,,,4,1,1,0,1
6838_0,,,,2,2,1,3
C(CC(C)(C(C(C=O)=O)CO)O)=O,,,4,1,2,0,2
6838_1,,,,2,2,1,3
6840_0,,,,2,2,1,3
C(C)(CC(C(C(C=O)=O)CO)O)=O,,,4,1,2,0,2
6840_1,,,,2,2,1,3
6842_0,,,,2,2,1,3
C(CC(C(CCO)=O)O)(CC=O)=O,,,4,1,1,0,1
6844_0,,,,2,2,1,3
C(C(CCO)(CC(CC=O)=O)O)=O,,,4,1,1,0,1
6846_0,,,,2,2,1,3
C(C)(C(C=O)C(C(CCO)=O)O)=O,,,4,1,2,0,2
6846_1,,,,2,2,1,3
6848_0,,,,2,2,1,3
C(C(CCO)(C(C=O)C(C)=O)O)=O,,,4,1,2,0,2
6848_1,,,,2,2,1,3
6850_0,,,,2,2,1,3
C=CC(C(C(C(C=O)=O)CO)O)=O,,,4,1,2,0,2
6850_1,,,,2,2,1,3
6852_0,,,,2,2,1,3
C(C(C=C)(C(C(C=O)=O)CO)O)=O,,,4,1,2,0,2
6852_1,,,,2,2,1,3
6854_0,,,,2,2,1,3
C=CC(CO)(C(C(C=O)=O)CO)O,,,4,1,2,0,2
6854_1,,,,2,2,1,3
6856_0,,,,2,2,1,3
C(C(C(C(C=C)=O)O)O)(CCO)=O,,,4,1,4,0,4
6856_1,,,,2,2,1,3
6858_0,,,,2,2,1,3
C(C(CCO)(C(C(C=C)=O)O)O)=O,,,4,1,3,0,3
6858_1,,,,2,2,1,3
6860_0,,,,2,2,1,3
C(C(C(C(C=O)=O)CO)O)=CC=O,,,4,1,2,0,2
6860_1,,,,2,2,1,3
6862_0,,,,2,2,1,3
C(C(C(CO)C(C(C)O)O)=O)=O,,,4,1,2,0,2
6862_1,,,,2,2,1,3
6864_0,,,,2,2,1,3
C(C(C(CCO)O)O)(CCO)=O,,,4,1,2,0,2
6864_1,,,,2,2,1,3
6866_0,,,,2,2,1,3
C(CO)(C(CO)C(CCO)O)=O,,,4,1,2,0,2
6866_1,,,,2,2,1,3
6867_0,,,,2,2,1,3
6867_1,,,,2,2,1,3
6869_0,,,,2,2,1,3
C(C(C(CC(C)O)O)O)(CCO)=O,,,4,1,2,0,2
6869_1,,,,2,2,1,3
6871_0,,,,2,2,1,3
C(CO)(C(CO)C(CC(C)O)O)=O,,,4,1,2,0,2
6871_1,,,,2,2,1,3
6873_0,,,,2,2,1,3
C(C(C(C)O)C(CO)(CCO)O)=O,,,4,1,4,0,4
6873_1,,,,2,2,1,3
6874_0,,,,2,2,1,3
6874_1,,,,2,2,1,3
6875_0,,,,2,2,1,3
6875_1,,,,2,2,1,3
6876_0,,,,2,2,1,3
6876_1,,,,2,2,1,3
6877_0,,,,2,2,1,3
6877_1,,,,2,2,1,3
6879_0,,,,2,2,1,3
C(C(C(C(CO)(CCO)O)O)=O)=O,,,4,1,3,0,3
6879_1,,,,2,2,1,3
6880_0,,,,2,2,1,3
6880_1,,,,2,2,1,3
6881_0,,,,2,2,1,3
6881_1,,,,2,2,1,3
6883_0,,,,2,2,1,3
C(C(C=O)C(CO)(CCO)O)=O,,,4,1,3,0,3
6883_1,,,,2,2,1,3
6885_0,,,,2,2,1,3
C(C(C)(C(C(CCO)=O)O)O)(O)=O,,,4,1,4,0,4
6885_1,,,,2,2,1,3
6887_0,,,,2,2,1,3
C(C(C)(C(C(CO)=O)CO)O)(O)=O,,,4,1,3,0,3
6887_1,,,,2,2,1,3
6889_0,,,,2,2,1,3
C(C(CC(CO)(CCO)O)=O)(O)=O,,,4,1,2,0,2
6890_0,,,,2,2,1,3
6890_1,,,,2,2,1,3
6891_0,,,,2,2,1,3
6891_1,,,,2,2,1,3
6892_0,,,,2,2,1,3
6892_1,,,,2,2,1,3
6893_0,,,,2,2,1,3
6893_1,,,,2,2,1,3
6895_0,,,,2,2,1,3
C(C)(C(C)(C(C(CCO)=O)O)O)=O,,,4,1,2,0,2
6895_1,,,,2,2,1,3
6897_0,,,,2,2,1,3
C(C)(C(C)(C(C(CO)=O)CO)O)=O,,,4,1,2,0,2
6897_1,,,,2,2,1,3
6899_0,,,,2,2,1,3
C(C(C)=O)(CC(CO)(CCO)O)=O,,,4,1,1,0,1
6901_0,,,,2,2,1,3
C(CC(C)(C(C(CCO)=O)O)O)=O,,,4,1,4,0,4
6901_1,,,,2,2,1,3
6903_0,,,,2,2,1,3
C(CC(C)(C(C(CO)=O)CO)O)=O,,,4,1,2,0,2
6903_1,,,,2,2,1,3
6905_0,,,,2,2,1,3
C(C(C(CC(C)=O)O)O)(CCO)=O,,,4,1,2,0,2
6905_1,,,,2,2,1,3
6907_0,,,,2,2,1,3
C(C)(CC(C(C(CO)=O)CO)O)=O,,,4,1,2,0,2
6907_1,,,,2,2,1,3
6909_0,,,,2,2,1,3
C(CC(CC(CO)(CCO)O)=O)=O,,,4,1,2,0,2
6911_0,,,,2,2,1,3
C(C(C(C)=O)C(CO)(CCO)O)=O,,,4,1,2,0,2
6911_1,,,,2,2,1,3
6912_0,,,,2,2,1,3
6912_1,,,,2,2,1,3
6914_0,,,,2,2,1,3
C(CO)(C(CO)C(C(C=C)=O)O)=O,,,4,1,2,0,2
6914_1,,,,2,2,1,3
6916_0,,,,2,2,1,3
C(C(C=C)(C(C(CCO)=O)O)O)=O,,,4,1,2,0,2
6916_1,,,,2,2,1,3
6918_0,,,,2,2,1,3
C(C(C=C)(C(C(CO)=O)CO)O)=O,,,4,1,2,0,2
6918_1,,,,2,2,1,3
6920_0,,,,2,2,1,3
C(C(C(C=C)(CO)O)O)(CCO)=O,,,4,1,2,0,2
6920_1,,,,2,2,1,3
6922_0,,,,2,2,1,3
C(CO)(C(CO)C(C=C)(CO)O)=O,,,4,1,2,0,2
6922_1,,,,2,2,1,3
6924_0,,,,2,2,1,3
C=CC(C(C(CO)(CCO)O)O)=O,,,4,1,2,0,2
6924_1,,,,2,2,1,3
6926_0,,,,2,2,1,3
C(C(C(C=CC=O)O)O)(CCO)=O,,,4,1,2,0,2
6926_1,,,,2,2,1,3
6928_0,,,,2,2,1,3
C(CO)(C(CO)C(C=CC=O)O)=O,,,4,1,2,0,2
6928_1,,,,2,2,1,3
6930_0,,,,2,2,1,3
C(C(C(C(C)O)O)O)(CCO)=O,,,4,1,2,0,2
6930_1,,,,2,2,1,3
6932_0,,,,2,2,1,3
C(CO)(C(CO)C(C(C)O)O)=O,,,4,1,2,0,2
6932_1,,,,2,2,1,3
6933_0,,,,2,2,1,3
6934_0,,,,2,2,1,3
6934_1,,,,2,2,1,3
6936_0,,,,2,2,1,3
C(C(C(C(C=O)O)O)C(C)O)=O,,,4,1,4,0,4
6936_1,,,,2,2,1,3
6937_0,,,,2,2,1,3
6937_1,,,,2,2,1,3
6939_0,,,,2,2,1,3
C(C(C(C(C(C=O)=O)O)O)O)=O,,,4,1,3,0,3
6939_1,,,,2,2,1,3
6941_0,,,,2,2,1,3
C(C(C(C(C(C(C)=O)=O)O)O)O)=O,,,4,1,2,0,2
6941_1,,,,2,2,1,3
6943_0,,,,2,2,1,3
C(C(C(CC(C(CO)=O)=O)O)O)=O,,,4,1,2,0,2
6944_0,,,,2,2,1,3
6944_1,,,,2,2,1,3
6946_0,,,,2,2,1,3
C(C(C=O)C(C(C=O)O)O)=O,,,4,1,3,0,3
6946_1,,,,2,2,1,3
6948_0,,,,2,2,1,3
C(C(C(CC(C(O)=O)=O)O)O)=O,,,4,1,3,0,3
6950_0,,,,2,2,1,3
C(C(C(C=O)=O)C(C(C=O)O)O)=O,,,4,1,2,0,2
6950_1,,,,2,2,1,3
6951_0,,,,2,2,1,3
6953_0,,,,2,2,1,3
C(CC(C(C=O)O)O)(CC=O)=O,,,4,1,2,0,2
6955_0,,,,2,2,1,3
C(C(C(C(C=O)C(C)=O)O)O)=O,,,4,1,3,0,3
6955_1,,,,2,2,1,3
6957_0,,,,2,2,1,3
C(C(C(C1C(COC1O)=O)O)O)=O,,,4,1,3,0,3
6957_1,,,,2,2,1,3
6959_0,,,,2,2,1,3
C(C(C(C1C(CC(O1)O)=O)O)O)=O,,,4,1,3,0,3
6959_1,,,,2,2,1,3
6961_0,,,,2,2,1,3
C(C(C(C(C(C=C)=O)O)O)O)=O,,,4,1,3,0,3
6961_1,,,,2,2,1,3
6963_0,,,,2,2,1,3
C(C(C(C1C(C(CO1)O)=O)O)O)=O,,,4,1,2,0,2
6963_1,,,,2,2,1,3
6965_0,,,,2,2,1,3
C(C(C(C1C(C(O)OC1)=O)O)O)=O,,,4,1,3,0,3
6965_1,,,,2,2,1,3
6967_0,,,,2,2,1,3
C(CC(C(CC(C)O)=O)O)(CO)=O,,,4,1,3,0,3
6968_0,,,,2,2,1,3
6968_1,,,,2,2,1,3
6970_0,,,,2,2,1,3
C(C(CC(C)O)(CC(CO)=O)O)=O,,,4,1,1,0,1
6972_0,,,,2,2,1,3
C(C(CC(C)O)(C(C(C)=O)O)O)=O,,,4,1,2,0,2
6972_1,,,,2,2,1,3
6974_0,,,,2,2,1,3
C(C(C(C(C)O)C(C)(CO)O)=O)=O,,,4,1,4,0,4
6974_1,,,,2,2,1,3
6976_0,,,,2,2,1,3
C(CC(C(C)(CC(CO)=O)O)O)=O,,,4,1,2,0,2
6978_0,,,,2,2,1,3
C(CC(C(C)(C(C(C)=O)O)O)O)=O,,,4,1,3,0,3
6978_1,,,,2,2,1,3
6980_0,,,,2,2,1,3
C(C)(C(CC(CC(CO)=O)O)O)=O,,,4,1,1,0,1
6982_0,,,,2,2,1,3
C(C)(C(C(CC(C(C)=O)O)O)O)=O,,,4,1,2,0,2
6982_1,,,,2,2,1,3
6984_0,,,,2,2,1,3
C(CC(C(CC(CO)(C)O)=O)O)=O,,,4,1,2,0,2
6985_0,,,,2,2,1,3
6985_1,,,,2,2,1,3
6987_0,,,,2,2,1,3
C(CC(C)(C(CC(CO)=O)O)O)=O,,,4,1,3,0,3
6989_0,,,,2,2,1,3
C(CC(C)(C(C(C(C)=O)O)O)O)=O,,,4,1,3,0,3
6989_1,,,,2,2,1,3
6991_0,,,,2,2,1,3
C(C(C)(CC(CC(CO)=O)O)O)=O,,,4,1,1,0,1
6993_0,,,,2,2,1,3
C(C(C)(CC(C(C(C)=O)O)O)O)=O,,,4,1,2,0,2
6993_1,,,,2,2,1,3
6994_0,,,,2,2,1,3
6994_1,,,,2,2,1,3
6996_0,,,,2,2,1,3
C(CO)(CC(CCO)O)=O,,,4,1,4,0,4
6998_0,,,,2,2,1,3
C(C)(C(C(CCO)O)O)=O,,,4,1,4,0,4
6998_1,,,,2,2,1,3
6999_0,,,,2,2,1,3
6999_1,,,,2,2,1,3
7001_0,,,,2,2,1,3
C(CO)(CC(CO)(CC(C)O)O)=O,,,4,1,1,0,1
7003_0,,,,2,2,1,3
C(C)(C(C(CO)(CC(C)O)O)O)=O,,,4,1,2,0,2
7003_1,,,,2,2,1,3
7005_0,,,,2,2,1,3
C(CO)(C(C(C)O)C(CO)(C)O)=O,,,4,1,4,0,4
7005_1,,,,2,2,1,3
7007_0,,,,2,2,1,3
C(C(C(CO)(C)O)O)(CC(C)O)=O,,,4,1,3,0,3
7007_1,,,,2,2,1,3
7009_0,,,,2,2,1,3
C(CO)(CC(C)(C(C(C)O)O)O)=O,,,4,1,1,0,1
7011_0,,,,2,2,1,3
C(C)(C(C(C)(C(C(C)O)O)O)O)=O,,,4,1,2,0,2
7011_1,,,,2,2,1,3
7013_0,,,,2,2,1,3
C(C(C(C)O)O)(CC(CO)(C)O)=O,,,4,1,3,0,3
7015_0,,,,2,2,1,3
C(CO)(CC(CC(CO)(C)O)O)=O,,,4,1,1,0,1
7017_0,,,,2,2,1,3
C(C)(C(C(CC(CO)(C)O)O)O)=O,,,4,1,2,0,2
7017_1,,,,2,2,1,3
7019_0,,,,2,2,1,3
C(C(C(C)(CO)O)C(C)(CO)O)=O,,,4,1,2,0,2
7019_1,,,,2,2,1,3
7021_0,,,,2,2,1,3
C(CO)(CC(CC(C)O)O)=O,,,4,1,1,0,1
7023_0,,,,2,2,1,3
C(C)(C(C(CC(C)O)O)O)=O,,,4,1,2,0,2
7023_1,,,,2,2,1,3
7025_0,,,,2,2,1,3
C(C(C(C)O)C(C)(CO)O)=O,,,4,1,4,0,4
7025_1,,,,2,2,1,3
7027_0,,,,2,2,1,3
C(CO)(CC(C(C(C)O)O)O)=O,,,4,1,1,0,1
7029_0,,,,2,2,1,3
C(C)(C(C(C(C(C)O)O)O)O)=O,,,4,1,2,0,2
7029_1,,,,2,2,1,3
7031_0,,,,2,2,1,3
C(CO)(CC(CC(CO)O)O)=O,,,4,1,2,0,2
7033_0,,,,2,2,1,3
C(C)(C(C(CC(CO)O)O)O)=O,,,4,1,3,0,3
7033_1,,,,2,2,1,3
7034_0,,,,2,2,1,3
7034_1,,,,2,2,1,3
7035_0,,,,2,2,1,3
7036_0,,,,2,2,1,3
7036_1,,,,2,2,1,3
7037_0,,,,2,2,1,3
7038_0,,,,2,2,1,3
7038_1,,,,2,2,1,3
7039_0,,,,2,2,1,3
7040_0,,,,2,2,1,3
7040_1,,,,2,2,1,3
7041_0,,,,2,2,1,3
7042_0,,,,2,2,1,3
7042_1,,,,2,2,1,3
7044_0,,,,2,2,1,3
C(C(C(C(CO)(C)O)O)=O)=O,,,4,1,2,0,2
7044_1,,,,2,2,1,3
7046_0,,,,2,2,1,3
C(C)(C(CO)(CC(CO)=O)O)=O,,,4,1,5,0,5
7047_0,,,,2,2,1,3
7047_1,,,,2,2,1,3
7049_0,,,,2,2,1,3
C(CO)(C(C)(CC(CO)=O)O)=O,,,4,1,2,0,2
7051_0,,,,2,2,1,3
C(CO)(C(C)(C(C(C)=O)O)O)=O,,,4,1,4,0,4
7051_1,,,,2,2,1,3
7053_0,,,,2,2,1,3
C(C(C)=O)(C(C(CO)(C)O)O)=O,,,4,1,3,0,3
7053_1,,,,2,2,1,3
7055_0,,,,2,2,1,3
C(C(CO)=O)(CC(CO)(C)O)=O,,,4,1,2,0,2
7057_0,,,,2,2,1,3
C(CC(C(C(C)O)=O)O)(CO)=O,,,4,1,2,0,2
7058_0,,,,2,2,1,3
7058_1,,,,2,2,1,3
7059_0,,,,2,2,1,3
7060_0,,,,2,2,1,3
7060_1,,,,2,2,1,3
7062_0,,,,2,2,1,3
C(CO)(CC(CO)(C(C)O)O)=O,,,4,1,2,0,2
7064_0,,,,2,2,1,3
C(C)(C(C(CO)(C(C)O)O)O)=O,,,4,1,3,0,3
7064_1,,,,2,2,1,3
7066_0,,,,2,2,1,3
C(C(C(CO)(C)O)O)(C(C)O)=O,,,4,1,2,0,2
7066_1,,,,2,2,1,3
7067_0,,,,2,2,1,3
7068_0,,,,2,2,1,3
7068_1,,,,2,2,1,3
7070_0,,,,2,2,1,3
C(C(C=O)C(C)(CO)O)=O,,,4,1,3,0,3
7070_1,,,,2,2,1,3
7071_0,,,,2,2,1,3
7072_0,,,,2,2,1,3
7072_1,,,,2,2,1,3
7073_0,,,,2,2,1,3
7074_0,,,,2,2,1,3
7074_1,,,,2,2,1,3
7076_0,,,,2,2,1,3
C(C(C(C(C(CO)(C)O)O)=O)O)=O,,,4,1,3,0,3
7076_1,,,,2,2,1,3
7078_0,,,,2,2,1,3
C(CO)(CC(C(CCO)O)O)=O,,,4,1,2,0,2
7080_0,,,,2,2,1,3
C(C)(C(C(C(CCO)O)O)O)=O,,,4,1,3,0,3
7080_1,,,,2,2,1,3
7082_0,,,,2,2,1,3
C(C(C)(CC(CO)=O)O)(O)=O,,,4,1,4,0,4
7084_0,,,,2,2,1,3
C(C(C)(C(C(C)=O)O)O)(O)=O,,,4,1,4,0,4
7084_1,,,,2,2,1,3
7086_0,,,,2,2,1,3
C(C(CC(C)(CO)O)=O)(O)=O,,,4,1,2,0,2
7087_0,,,,2,2,1,3
7088_0,,,,2,2,1,3
7088_1,,,,2,2,1,3
7090_0,,,,2,2,1,3
C(CC(CO)(CC(CO)=O)O)(O)=O,,,4,1,2,0,2
7092_0,,,,2,2,1,3
C(CC(CO)(C(C(C)=O)O)O)(O)=O,,,4,1,3,0,3
7092_1,,,,2,2,1,3
7093_0,,,,2,2,1,3
7093_1,,,,2,2,1,3
7094_0,,,,2,2,1,3
7094_1,,,,2,2,1,3
7096_0,,,,2,2,1,3
C(C(C(C)(CC(CO)=O)O)O)(O)=O,,,4,1,2,0,2
7098_0,,,,2,2,1,3
C(C(C(C)(C(C(C)=O)O)O)O)(O)=O,,,4,1,3,0,3
7098_1,,,,2,2,1,3
7099_0,,,,2,2,1,3
7100_0,,,,2,2,1,3
7101_0,,,,2,2,1,3
7101_1,,,,2,2,1,3
7102_0,,,,2,2,1,3
7103_0,,,,2,2,1,3
7103_1,,,,2,2,1,3
7105_0,,,,2,2,1,3
C(CC(C(CC(CO)=O)O)O)(O)=O,,,4,1,2,0,2
7107_0,,,,2,2,1,3
C(CC(C(C(C(C)=O)O)O)O)(O)=O,,,4,1,3,0,3
7107_1,,,,2,2,1,3
7109_0,,,,2,2,1,3
C(C)(CC(C(CC(CO)=O)O)=O)=O,,,4,1,1,0,1
7111_0,,,,2,2,1,3
C(C)(CC(C(C(C(C)=O)O)O)=O)=O,,,4,1,2,0,2
7111_1,,,,2,2,1,3
7113_0,,,,2,2,1,3
C(C(CC(C)=O)(CC(CO)=O)O)=O,,,4,1,1,0,1
7115_0,,,,2,2,1,3
C(C(CC(C)=O)(C(C(C)=O)O)O)=O,,,4,1,2,0,2
7115_1,,,,2,2,1,3
7117_0,,,,2,2,1,3
C(CO)(CC(C)(CC(C=O)=O)O)=O,,,4,1,1,0,1
7119_0,,,,2,2,1,3
C(C)(C(C(C)(CC(C=O)=O)O)O)=O,,,4,1,2,0,2
7119_1,,,,2,2,1,3
7121_0,,,,2,2,1,3
C(C)(C(C(C=O)=O)C(C)(CO)O)=O,,,4,1,2,0,2
7121_1,,,,2,2,1,3
7123_0,,,,2,2,1,3
C(CC(C)(CO)O)(CC(C=O)=O)=O,,,4,1,1,0,1
7125_0,,,,2,2,1,3
C(CC(C(CC(CO)=O)O)=O)=O,,,4,1,4,0,4
7126_0,,,,2,2,1,3
7126_1,,,,2,2,1,3
7128_0,,,,2,2,1,3
C(CC(C=O)(CC(CO)=O)O)=O,,,4,1,3,0,3
7129_0,,,,2,2,1,3
7129_1,,,,2,2,1,3
7130_0,,,,2,2,1,3
7131_0,,,,2,2,1,3
7131_1,,,,2,2,1,3
7133_0,,,,2,2,1,3
C(C(C(C=O)=O)C(C)(CO)O)=O,,,4,1,3,0,3
7133_1,,,,2,2,1,3
7134_0,,,,2,2,1,3
7135_0,,,,2,2,1,3
7135_1,,,,2,2,1,3
7137_0,,,,2,2,1,3
C(CC(C(C)=O)(CC(CO)=O)O)=O,,,4,1,3,0,3
7139_0,,,,2,2,1,3
C(CC(C(C)=O)(C(C(C)=O)O)O)=O,,,4,1,3,0,3
7139_1,,,,2,2,1,3
7141_0,,,,2,2,1,3
C(C(C)(CC(CO)=O)O)(CC=O)=O,,,4,1,1,0,1
7143_0,,,,2,2,1,3
C(C(C)(C(C(C)=O)O)O)(CC=O)=O,,,4,1,2,0,2
7143_1,,,,2,2,1,3
7145_0,,,,2,2,1,3
C(C(C(C(C)=O)=O)C(C)(CO)O)=O,,,4,1,2,0,2
7145_1,,,,2,2,1,3
7147_0,,,,2,2,1,3
C(CC(C(CC(C)(CO)O)=O)=O)=O,,,4,1,1,0,1
7149_0,,,,2,2,1,3
C(C)(C(C)(CC(CO)=O)O)=O,,,4,1,2,0,2
7151_0,,,,2,2,1,3
C(C)(C(C)(C(C(C)=O)O)O)=O,,,4,1,3,0,3
7151_1,,,,2,2,1,3
7153_0,,,,2,2,1,3
C(C(C)=O)(CC(C)(CO)O)=O,,,4,1,2,0,2
7155_0,,,,2,2,1,3
C(CC(C)(CC(CO)=O)O)=O,,,4,1,2,0,2
7157_0,,,,2,2,1,3
C(CC(C)(C(C(C)=O)O)O)=O,,,4,1,3,0,3
7157_1,,,,2,2,1,3
7159_0,,,,2,2,1,3
C(C)(CC(CC(CO)=O)O)=O,,,4,1,1,0,1
7161_0,,,,2,2,1,3
C(C)(CC(C(C(C)=O)O)O)=O,,,4,1,2,0,2
7161_1,,,,2,2,1,3
7163_0,,,,2,2,1,3
C(CC(CC(C)(CO)O)=O)=O,,,4,1,2,0,2
7165_0,,,,2,2,1,3
C(C(C(C)=O)C(C)(CO)O)=O,,,4,1,3,0,3
7165_1,,,,2,2,1,3
7167_0,,,,2,2,1,3
C(CO)(CC1(COC(C1)O)O)=O,,,4,1,2,0,2
7169_0,,,,2,2,1,3
C(C)(C(C1(COC(C1)O)O)O)=O,,,4,1,3,0,3
7169_1,,,,2,2,1,3
7171_0,,,,2,2,1,3
C1(COC(C1C(CO)(C)O)O)=O,,,4,1,3,0,3
7171_1,,,,2,2,1,3
7173_0,,,,2,2,1,3
C1(C(C(CO)(C)O)OC(C1)O)=O,,,4,1,3,0,3
7173_1,,,,2,2,1,3
7175_0,,,,2,2,1,3
C(CO)(CC(C=CC(CO)=O)O)=O,,,4,1,1,0,1
7177_0,,,,2,2,1,3
C(C)(C(C(C=CC(CO)=O)O)O)=O,,,4,1,2,0,2
7177_1,,,,2,2,1,3
7179_0,,,,2,2,1,3
C(CC(C=CC=O)(CO)O)(CO)=O,,,4,1,1,0,1
7181_0,,,,2,2,1,3
C(C(C(C=CC=O)(CO)O)O)(C)=O,,,4,1,2,0,2
7181_1,,,,2,2,1,3
7183_0,,,,2,2,1,3
C(C=CC(C(C(CO)(C)O)O)=O)=O,,,4,1,2,0,2
7183_1,,,,2,2,1,3
7185_0,,,,2,2,1,3
C(CO)(CC(C(C=C)=O)O)=O,,,4,1,2,0,2
7186_0,,,,2,2,1,3
7186_1,,,,2,2,1,3
7188_0,,,,2,2,1,3
C(C(C=C)(CC(CO)=O)O)=O,,,4,1,3,0,3
7190_0,,,,2,2,1,3
C(C(C=C)(C(C(C)=O)O)O)=O,,,4,1,4,0,4
7190_1,,,,2,2,1,3
7192_0,,,,2,2,1,3
C(CC(C=C)(CO)O)(CO)=O,,,4,1,2,0,2
7194_0,,,,2,2,1,3
C(C(C(C=C)(CO)O)O)(C)=O,,,4,1,3,0,3
7194_1,,,,2,2,1,3
7196_0,,,,2,2,1,3
C=CC(C(C(CO)(C)O)O)=O,,,4,1,3,0,3
7196_1,,,,2,2,1,3
7198_0,,,,2,2,1,3
C(CO)(CC(C=CC=O)O)=O,,,4,1,3,0,3
7200_0,,,,2,2,1,3
C(C)(C(C(C=CC=O)O)O)=O,,,4,1,4,0,4
7200_1,,,,2,2,1,3
7202_0,,,,2,2,1,3
C(CO)(CC(C(C)O)O)=O,,,4,1,1,0,1
7204_0,,,,2,2,1,3
C(C)(C(C(C(C)O)O)O)=O,,,4,1,2,0,2
7204_1,,,,2,2,1,3
7206_0,,,,2,2,1,3
C(C(CCO)(CC(CO)=O)O)(O)=O,,,4,1,2,0,2
7208_0,,,,2,2,1,3
C(C(CCO)(C(C(C)=O)O)O)(O)=O,,,4,1,4,0,4
7208_1,,,,2,2,1,3
7210_0,,,,2,2,1,3
C(C(C(CO)C(C)(CO)O)=O)(O)=O,,,4,1,3,0,3
7210_1,,,,2,2,1,3
7212_0,,,,2,2,1,3
C(C(CC(CC(CO)=O)O)O)(O)=O,,,4,1,4,0,4
7214_0,,,,2,2,1,3
C(C(CC(C(C(C)=O)O)O)O)(O)=O,,,4,1,5,0,5
7214_1,,,,2,2,1,3
7215_0,,,,2,2,1,3
7215_1,,,,2,2,1,3
7217_0,,,,2,2,1,3
C(CO)(CC(C(CO)(CO)O)O)=O,,,4,1,2,0,2
7219_0,,,,2,2,1,3
C(C)(C(C(C(CO)(CO)O)O)O)=O,,,4,1,3,0,3
7219_1,,,,2,2,1,3
7220_0,,,,2,2,1,3
7221_0,,,,2,2,1,3
7221_1,,,,2,2,1,3
7223_0,,,,2,2,1,3
C(CO)(CC1(COCC1O)O)=O,,,4,1,1,0,1
7225_0,,,,2,2,1,3
C(C)(C(C1(COCC1O)O)O)=O,,,4,1,2,0,2
7225_1,,,,2,2,1,3
7227_0,,,,2,2,1,3
C1(C(C(CO)(C)O)OCC1O)=O,,,4,1,2,0,2
7227_1,,,,2,2,1,3
7229_0,,,,2,2,1,3
C(CO)(CC1(C(O)OCC1)O)=O,,,4,1,2,0,2
7231_0,,,,2,2,1,3
C(C)(C(C1(C(O)OCC1)O)O)=O,,,4,1,3,0,3
7231_1,,,,2,2,1,3
7233_0,,,,2,2,1,3
C1(C(O)OCC1C(CO)(C)O)=O,,,4,1,3,0,3
7233_1,,,,2,2,1,3
7235_0,,,,2,2,1,3
C(C(C(CCO)O)C(C=O)O)=O,,,4,1,2,0,2
7235_1,,,,2,2,1,3
7236_0,,,,2,2,1,3
7236_1,,,,2,2,1,3
7237_0,,,,2,2,1,3
7237_1,,,,2,2,1,3
7239_0,,,,2,2,1,3
C(C(C(CC(C)O)O)C(C=O)O)=O,,,4,1,2,0,2
7239_1,,,,2,2,1,3
7241_0,,,,2,2,1,3
C(C(C(C(CC=O)O)O)C(C)O)=O,,,4,1,5,0,5
7241_1,,,,2,2,1,3
7243_0,,,,2,2,1,3
C(C(C(C)O)C(CC(C=O)O)O)=O,,,4,1,4,0,4
7243_1,,,,2,2,1,3
7244_0,,,,2,2,1,3
7244_1,,,,2,2,1,3
7245_0,,,,2,2,1,3
7245_1,,,,2,2,1,3
7247_0,,,,2,2,1,3
C(CC(C(C(C(C=O)=O)O)O)O)=O,,,4,1,2,0,2
7247_1,,,,2,2,1,3
7249_0,,,,2,2,1,3
C(C(CC(C(C(C=O)=O)O)O)O)=O,,,4,1,2,0,2
7249_1,,,,2,2,1,3
7251_0,,,,2,2,1,3
C(CC(C(C=O)C(C=O)O)O)=O,,,4,1,3,0,3
7251_1,,,,2,2,1,3
7253_0,,,,2,2,1,3
C(C(C=O)C(C(CC=O)O)O)=O,,,4,1,3,0,3
7253_1,,,,2,2,1,3
7255_0,,,,2,2,1,3
C(C(C=O)C(CC(C=O)O)O)=O,,,4,1,3,0,3
7255_1,,,,2,2,1,3
7257_0,,,,2,2,1,3
C(C(C)(C(C=O)C(C=O)O)O)(O)=O,,,4,1,3,0,3
7257_1,,,,2,2,1,3
7259_0,,,,2,2,1,3
C(CC(C(CC(C(O)=O)=O)O)O)=O,,,4,1,2,0,2
7261_0,,,,2,2,1,3
C(C(CC(CC(C(O)=O)=O)O)O)=O,,,4,1,2,0,2
7263_0,,,,2,2,1,3
C(C(C=O)C(C=O)O)(O)=O,,,4,1,2,0,2
7263_1,,,,2,2,1,3
7264_0,,,,2,2,1,3
7264_1,,,,2,2,1,3
7266_0,,,,2,2,1,3
C(C)(C(C)(C(C=O)C(C=O)O)O)=O,,,4,1,2,0,2
7266_1,,,,2,2,1,3
7267_0,,,,2,2,1,3
7269_0,,,,2,2,1,3
C(C(CC(CC(C(C)=O)=O)O)O)=O,,,4,1,1,0,1
7271_0,,,,2,2,1,3
C(CC(C)(C(C=O)C(C=O)O)O)=O,,,4,1,2,0,2
7271_1,,,,2,2,1,3
7273_0,,,,2,2,1,3
C(C)(CC(C(C=O)C(C=O)O)O)=O,,,4,1,2,0,2
7273_1,,,,2,2,1,3
7274_0,,,,2,2,1,3
7276_0,,,,2,2,1,3
C(CC(CC(C=O)O)O)(CC=O)=O,,,4,1,1,0,1
7278_0,,,,2,2,1,3
C(CC(C(C(C=O)C(C)=O)O)O)=O,,,4,1,2,0,2
7278_1,,,,2,2,1,3
7280_0,,,,2,2,1,3
C(C(CC(C(C=O)C(C)=O)O)O)=O,,,4,1,2,0,2
7280_1,,,,2,2,1,3
7282_0,,,,2,2,1,3
C(C(C(C=O)C(C(C=C)=O)O)O)=O,,,4,1,2,0,2
7282_1,,,,2,2,1,3
7284_0,,,,2,2,1,3
C(C(C=C)(C(C=O)C(C=O)O)O)=O,,,4,1,2,0,2
7284_1,,,,2,2,1,3
7286_0,,,,2,2,1,3
C(C(C(C=O)C(C=C)(CO)O)O)=O,,,4,1,2,0,2
7286_1,,,,2,2,1,3
7287_0,,,,2,2,1,3
7287_1,,,,2,2,1,3
7289_0,,,,2,2,1,3
C(C(CC(C(C(C=C)=O)O)O)O)=O,,,4,1,2,0,2
7289_1,,,,2,2,1,3
7291_0,,,,2,2,1,3
C(C(C(C=O)C(C=CC=O)O)O)=O,,,4,1,2,0,2
7291_1,,,,2,2,1,3
7293_0,,,,2,2,1,3
C(C(C(C(C)O)O)C(C=O)O)=O,,,4,1,2,0,2
7293_1,,,,2,2,1,3
7294_0,,,,2,2,1,3
7294_1,,,,2,2,1,3
7296_0,,,,2,2,1,3
C(C(C=O)C(C(C(C=O)O)O)O)=O,,,4,1,2,0,2
7296_1,,,,2,2,1,3
7298_0,,,,2,2,1,3
C(CC1(CC(C(C1O)O)O)O)=O,,,4,1,1,0,1
7299_0,,,,2,2,1,3
7299_1,,,,2,2,1,3
7300_0,,,,2,2,1,3
7302_0,,,,2,2,1,3
C(CC1(C(CO)C(C(C1)=O)O)O)=O,,,4,1,1,0,1
7303_0,,,,2,2,1,3
7303_1,,,,2,2,1,3
7304_0,,,,2,2,1,3
7305_0,,,,2,2,1,3
7306_0,,,,2,2,1,3
7308_0,,,,2,2,1,3
C(C1(C(C(CC1)(CC=O)O)O)O)=O,,,4,1,1,0,1
7309_0,,,,2,2,1,3
7310_0,,,,2,2,1,3
7311_0,,,,2,2,1,3
7311_1,,,,2,2,1,3
7312_0,,,,2,2,1,3
7314_0,,,,2,2,1,3
C(C1(CC(C(C1)O)(CC=O)O)O)=O,,,4,1,1,0,1
7315_0,,,,2,2,1,3
7315_1,,,,2,2,1,3
7316_0,,,,2,2,1,3
7318_0,,,,2,2,1,3
C(CC(C1C(CC(C1O)=O)O)O)=O,,,4,1,1,0,1
7319_0,,,,2,2,1,3
7319_1,,,,2,2,1,3
7320_0,,,,2,2,1,3
7322_0,,,,2,2,1,3
C1(C(C(C(C1)O)CO)(CC=O)O)=O,,,4,1,1,0,1
7323_0,,,,2,2,1,3
7323_1,,,,2,2,1,3
7324_0,,,,2,2,1,3
7325_0,,,,2,2,1,3
7326_0,,,,2,2,1,3
7326_1,,,,2,2,1,3
7327_0,,,,2,2,1,3
7327_1,,,,2,2,1,3
7328_0,,,,2,2,1,3
7329_0,,,,2,2,1,3
7329_1,,,,2,2,1,3
7330_0,,,,2,2,1,3
7331_0,,,,2,2,1,3
7332_0,,,,2,2,1,3
7334_0,,,,2,2,1,3
C(CC(C1C(C(C(C1)=O)O)O)O)=O,,,4,1,2,0,2
7335_0,,,,2,2,1,3
7336_0,,,,2,2,1,3
7337_0,,,,2,2,1,3
7337_1,,,,2,2,1,3
7338_0,,,,2,2,1,3
7339_0,,,,2,2,1,3
7340_0,,,,2,2,1,3
7340_1,,,,2,2,1,3
7342_0,,,,2,2,1,3
C(CC1(C=CC(C(C1O)O)O)O)=O,,,4,1,1,0,1
7343_0,,,,2,2,1,3
7344_0,,,,2,2,1,3
7345_0,,,,2,2,1,3
7345_1,,,,2,2,1,3
7347_0,,,,2,2,1,3
C(CC(CO)(C(C(C)O)O)O)=O,,,4,1,1,0,1
7349_0,,,,2,2,1,3
C(C(C(C)O)O)(C(C(C)O)O)=O,,,4,1,2,0,2
7349_1,,,,2,2,1,3
7351_0,,,,2,2,1,3
C(CC(CC(CO)(CO)O)O)=O,,,4,1,1,0,1
7352_0,,,,2,2,1,3
7352_1,,,,2,2,1,3
7354_0,,,,2,2,1,3
C(CC(CC(C(CO)O)O)O)=O,,,4,1,1,0,1
7355_0,,,,2,2,1,3
7355_1,,,,2,2,1,3
7356_0,,,,2,2,1,3
7358_0,,,,2,2,1,3
C(C(C)(CC(C=O)(CC=O)O)O)=O,,,4,1,1,0,1
7359_0,,,,2,2,1,3
7360_0,,,,2,2,1,3
7360_1,,,,2,2,1,3
7361_0,,,,2,2,1,3
7363_0,,,,2,2,1,3
C(C(CC(C=O)(CC=O)O)O)=O,,,4,1,1,0,1
7364_0,,,,2,2,1,3
7365_0,,,,2,2,1,3
7365_1,,,,2,2,1,3
7366_0,,,,2,2,1,3
7368_0,,,,2,2,1,3
C(C(CC(CO)(C)O)(CC=O)O)=O,,,4,1,1,0,1
7369_0,,,,2,2,1,3
7369_1,,,,2,2,1,3
7370_0,,,,2,2,1,3
7372_0,,,,2,2,1,3
C(CC(CO)(CC(C(C)=O)O)O)=O,,,4,1,2,0,2
7373_0,,,,2,2,1,3
7374_0,,,,2,2,1,3
7374_1,,,,2,2,1,3
7375_0,,,,2,2,1,3
7375_1,,,,2,2,1,3
7376_0,,,,2,2,1,3
7378_0,,,,2,2,1,3
C(C(C)(CC(CO)(CC=O)O)O)=O,,,4,1,1,0,1
7379_0,,,,2,2,1,3
7379_1,,,,2,2,1,3
7380_0,,,,2,2,1,3
7380_1,,,,2,2,1,3
7381_0,,,,2,2,1,3
7382_0,,,,2,2,1,3
7383_0,,,,2,2,1,3
7385_0,,,,2,2,1,3
C(C(C)(C(C(C)(CC=O)O)O)O)=O,,,4,1,2,0,2
7386_0,,,,2,2,1,3
7388_0,,,,2,2,1,3
C(CC(C(CC(C)O)=O)O)=O,,,4,1,2,0,2
7390_0,,,,2,2,1,3
C(C(CC(C)O)(CC=O)O)=O,,,4,1,1,0,1
7392_0,,,,2,2,1,3
C(C(C(C(C)O)C(C)O)=O)=O,,,4,1,2,0,2
7392_1,,,,2,2,1,3
7394_0,,,,2,2,1,3
C(CC(C(C)(CC=O)O)O)=O,,,4,1,2,0,2
7396_0,,,,2,2,1,3
C(CC(CC(C(C)=O)O)O)=O,,,4,1,1,0,1
7397_0,,,,2,2,1,3
7398_0,,,,2,2,1,3
7398_1,,,,2,2,1,3
7399_0,,,,2,2,1,3
7401_0,,,,2,2,1,3
C(C(C)(CC(CC=O)O)O)=O,,,4,1,1,0,1
7402_0,,,,2,2,1,3
7402_1,,,,2,2,1,3
7403_0,,,,2,2,1,3
7404_0,,,,2,2,1,3
7405_0,,,,2,2,1,3
7405_1,,,,2,2,1,3
7406_0,,,,2,2,1,3
7408_0,,,,2,2,1,3
C(CC(C(CO)O)(CC=O)O)=O,,,4,1,1,0,1
7409_0,,,,2,2,1,3
7409_1,,,,2,2,1,3
7410_0,,,,2,2,1,3
7411_0,,,,2,2,1,3
7413_0,,,,2,2,1,3
C(C(C(C(C(C)O)O)=O)C(C)O)=O,,,4,1,4,0,4
7413_1,,,,2,2,1,3
7414_0,,,,2,2,1,3
7416_0,,,,2,2,1,3
C(CC(C(C(C)O)O)(CC=O)O)=O,,,4,1,1,0,1
7417_0,,,,2,2,1,3
7417_1,,,,2,2,1,3
7419_0,,,,2,2,1,3
C(CC(CC(CO)(CC=O)O)O)=O,,,4,1,3,0,3
7421_0,,,,2,2,1,3
C(CC(CC(CC(CO)=O)O)O)=O,,,4,1,2,0,2
7422_0,,,,2,2,1,3
7422_1,,,,2,2,1,3
7423_0,,,,2,2,1,3
7423_1,,,,2,2,1,3
7424_0,,,,2,2,1,3
7424_1,,,,2,2,1,3
7425_0,,,,2,2,1,3
7426_0,,,,2,2,1,3
7426_1,,,,2,2,1,3
7427_0,,,,2,2,1,3
7429_0,,,,2,2,1,3
C(CC(CCO)(C(C=O)O)O)=O,,,4,1,1,0,1
7430_0,,,,2,2,1,3
7430_1,,,,2,2,1,3
7431_0,,,,2,2,1,3
7433_0,,,,2,2,1,3
C(CC(CC(C)O)(C(C=O)O)O)=O,,,4,1,1,0,1
7435_0,,,,2,2,1,3
C(C(C(C(C(C)O)C(C)O)=O)O)=O,,,4,1,2,0,2
7435_1,,,,2,2,1,3
7437_0,,,,2,2,1,3
C(CC(C)(C(C(CC=O)O)O)O)=O,,,4,1,2,0,2
7439_0,,,,2,2,1,3
C(CC(CC(C(C(C)=O)O)O)O)=O,,,4,1,1,0,1
7440_0,,,,2,2,1,3
7441_0,,,,2,2,1,3
7441_1,,,,2,2,1,3
7442_0,,,,2,2,1,3
7444_0,,,,2,2,1,3
C(CC(CC(C)(C(C=O)O)O)O)=O,,,4,1,1,0,1
7445_0,,,,2,2,1,3
7445_1,,,,2,2,1,3
7447_0,,,,2,2,1,3
C(CC(CCO)(C(CO)O)O)=O,,,4,1,1,0,1
7448_0,,,,2,2,1,3
7448_1,,,,2,2,1,3
7450_0,,,,2,2,1,3
C(CC(CC(C)O)(C(CO)O)O)=O,,,4,1,1,0,1
7452_0,,,,2,2,1,3
C(C(CO)O)(C(C(C)O)C(C)O)=O,,,4,1,2,0,2
7452_1,,,,2,2,1,3
7454_0,,,,2,2,1,3
C(CC(CC(C)(C(CO)O)O)O)=O,,,4,1,1,0,1
7455_0,,,,2,2,1,3
7455_1,,,,2,2,1,3
7456_0,,,,2,2,1,3
7458_0,,,,2,2,1,3
C(C(C(CO)CO)(CC=O)O)=O,,,4,1,1,0,1
7460_0,,,,2,2,1,3
C(CC(CO)(C(CO)CO)O)=O,,,4,1,1,0,1
7461_0,,,,2,2,1,3
7461_1,,,,2,2,1,3
7462_0,,,,2,2,1,3
7464_0,,,,2,2,1,3
C(CC(C(CO)C(C=O)O)O)=O,,,4,1,1,0,1
7466_0,,,,2,2,1,3
C(CC(CCO)O)=O,,,4,1,1,0,1
7467_0,,,,2,2,1,3
7467_1,,,,2,2,1,3
7469_0,,,,2,2,1,3
C(CC(C(CO)O)(C(CO)O)O)=O,,,4,1,1,0,1
7471_0,,,,2,2,1,3
C(CC(C(C(CO)C(C)O)=O)O)=O,,,4,1,4,0,4
7473_0,,,,2,2,1,3
C(C(C(CO)C(C)O)(CC=O)O)=O,,,4,1,1,0,1
7475_0,,,,2,2,1,3
C(CC(C(CCO)(CC=O)O)O)=O,,,4,1,3,0,3
7477_0,,,,2,2,1,3
C(CC(CC(C(CCO)=O)O)O)=O,,,4,1,2,0,2
7478_0,,,,2,2,1,3
7478_1,,,,2,2,1,3
7479_0,,,,2,2,1,3
7479_1,,,,2,2,1,3
7480_0,,,,2,2,1,3
7482_0,,,,2,2,1,3
C(C(CCO)(CC(CC=O)O)O)=O,,,4,1,2,0,2
7483_0,,,,2,2,1,3
7483_1,,,,2,2,1,3
7485_0,,,,2,2,1,3
C(CC(CCO)(C(C(C)O)O)O)=O,,,4,1,1,0,1
7487_0,,,,2,2,1,3
C(C(C(C)O)O)(C(CO)C(C)O)=O,,,4,1,4,0,4
7487_1,,,,2,2,1,3
7489_0,,,,2,2,1,3
C(CC(CO)(C(CO)C(C)O)O)=O,,,4,1,1,0,1
7490_0,,,,2,2,1,3
7490_1,,,,2,2,1,3
7492_0,,,,2,2,1,3
C(CC(CC(CO)(CCO)O)O)=O,,,4,1,1,0,1
7493_0,,,,2,2,1,3
7493_1,,,,2,2,1,3
7495_0,,,,2,2,1,3
C(CC(C(C(CC=O)O)O)O)=O,,,4,1,1,0,1
7497_0,,,,2,2,1,3
C(CC(CC(C(C=O)O)O)O)=O,,,4,1,1,0,1
7498_0,,,,2,2,1,3
7498_1,,,,2,2,1,3
7500_0,,,,2,2,1,3
C(CC(CO)(CC(C)(CO)O)O)=O,,,4,1,1,0,1
7501_0,,,,2,2,1,3
7501_1,,,,2,2,1,3
7502_0,,,,2,2,1,3
7502_1,,,,2,2,1,3
7504_0,,,,2,2,1,3
C(CC(C)(C(C(C)(CO)O)O)O)=O,,,4,1,1,0,1
7505_0,,,,2,2,1,3
7507_0,,,,2,2,1,3
C(CC(CO)(CC(C)O)O)=O,,,4,1,1,0,1
7509_0,,,,2,2,1,3
C(CO)(C(C(C)O)C(C)O)=O,,,4,1,2,0,2
7509_1,,,,2,2,1,3
7511_0,,,,2,2,1,3
C(C(C(C)O)O)(CC(C)O)=O,,,4,1,3,0,3
7511_1,,,,2,2,1,3
7513_0,,,,2,2,1,3
C(CC(C)(C(C(C)O)O)O)=O,,,4,1,1,0,1
7514_0,,,,2,2,1,3
7516_0,,,,2,2,1,3
C(CC(CC(C)(CO)O)O)=O,,,4,1,1,0,1
7517_0,,,,2,2,1,3
7517_1,,,,2,2,1,3
7518_0,,,,2,2,1,3
7520_0,,,,2,2,1,3
C(CC(C(C(C)O)C(C=O)O)O)=O,,,4,1,1,0,1
7522_0,,,,2,2,1,3
C(CC(C(CC(CC=O)O)O)O)=O,,,4,1,2,0,2
7523_0,,,,2,2,1,3
7523_1,,,,2,2,1,3
7524_0,,,,2,2,1,3
7526_0,,,,2,2,1,3
C(CC(CC(CC(C=O)O)O)O)=O,,,4,1,1,0,1
7527_0,,,,2,2,1,3
7527_1,,,,2,2,1,3
7529_0,,,,2,2,1,3
C(CC(CC(C)O)O)=O,,,4,1,1,0,1
7531_0,,,,2,2,1,3
C(C(C(C)O)C(C)O)=O,,,4,1,2,0,2
7531_1,,,,2,2,1,3
7533_0,,,,2,2,1,3
C(CC(C(C(CO)(CO)O)O)O)=O,,,4,1,2,0,2
7535_0,,,,2,2,1,3
C(CC(CO)(C(C(CO)O)O)O)=O,,,4,1,4,0,4
7536_0,,,,2,2,1,3
7536_1,,,,2,2,1,3
7538_0,,,,2,2,1,3
C(CC(C(C(C(CO)O)O)O)O)=O,,,4,1,3,0,3
7540_0,,,,2,2,1,3
C(C(C)(C(C(CC=O)O)O)O)=O,,,4,1,2,0,2
7541_0,,,,2,2,1,3
7542_0,,,,2,2,1,3
7544_0,,,,2,2,1,3
C(C(CC(CO)O)(CC=O)O)=O,,,4,1,1,0,1
7545_0,,,,2,2,1,3
7545_1,,,,2,2,1,3
7546_0,,,,2,2,1,3
7548_0,,,,2,2,1,3
C(CC(C(C(C)(CO)O)O)O)=O,,,4,1,1,0,1
7550_0,,,,2,2,1,3
C(CC(CO)(CC(CO)O)O)=O,,,4,1,2,0,2
7551_0,,,,2,2,1,3
7551_1,,,,2,2,1,3
7552_0,,,,2,2,1,3
7552_1,,,,2,2,1,3
7554_0,,,,2,2,1,3
C(CC(C)(C(C(CO)O)O)O)=O,,,4,1,2,0,2
7555_0,,,,2,2,1,3
7557_0,,,,2,2,1,3
C(CC(C(C(C)O)O)O)=O,,,4,1,1,0,1
7559_0,,,,2,2,1,3
C(CC(CC(CO)O)O)=O,,,4,1,2,0,2
7560_0,,,,2,2,1,3
7560_1,,,,2,2,1,3
7561_0,,,,2,2,1,3
7562_0,,,,2,2,1,3
7563_0,,,,2,2,1,3
7564_0,,,,2,2,1,3
7566_0,,,,2,2,1,3
C(C(C(C(C)O)O)=O)=O,,,4,1,4,0,4
7566_1,,,,2,2,1,3
7568_0,,,,2,2,1,3
C(CC(CC(C(CO)=O)O)O)=O,,,4,1,1,0,1
7570_0,,,,2,2,1,3
C(CC(C(CO)(CC=O)O)O)=O,,,4,1,2,0,2
7571_0,,,,2,2,1,3
7571_1,,,,2,2,1,3
7573_0,,,,2,2,1,3
C(CC(C(C(C(C)O)O)=O)O)=O,,,4,1,2,0,2
7573_1,,,,2,2,1,3
7575_0,,,,2,2,1,3
C(C)(C(CO)(CC=O)O)=O,,,4,1,4,0,4
7577_0,,,,2,2,1,3
C(CO)(C(C)(CC=O)O)=O,,,4,1,2,0,2
7579_0,,,,2,2,1,3
C(C(C)=O)(C(C(C)O)O)=O,,,4,1,3,0,3
7579_1,,,,2,2,1,3
7581_0,,,,2,2,1,3
C(C(CO)=O)(CC(C)O)=O,,,4,1,2,0,2
7582_0,,,,2,2,1,3
7584_0,,,,2,2,1,3
C(C(C(C)O)O)(CC(CO)=O)=O,,,4,1,3,0,3
7584_1,,,,2,2,1,3
7586_0,,,,2,2,1,3
C(CO)(C(C(CO)=O)C(C)O)=O,,,4,1,3,0,3
7586_1,,,,2,2,1,3
7587_0,,,,2,2,1,3
7588_0,,,,2,2,1,3
7590_0,,,,2,2,1,3
C(C(C(C)O)O)(C(C(C)=O)O)=O,,,4,1,2,0,2
7590_1,,,,2,2,1,3
7592_0,,,,2,2,1,3
C(CC(C)O)(C(C(CO)=O)O)=O,,,4,1,2,0,2
7594_0,,,,2,2,1,3
C(CC(C(C(C)O)=O)O)=O,,,4,1,4,0,4
7595_0,,,,2,2,1,3
7597_0,,,,2,2,1,3
C(CC(CO)(C(C)O)O)=O,,,4,1,2,0,2
7599_0,,,,2,2,1,3
C(C(C(C)O)O)(C(C)O)=O,,,4,1,2,0,2
7599_1,,,,2,2,1,3
7601_0,,,,2,2,1,3
C(CC(CC=O)O)=O,,,4,1,4,0,4
7603_0,,,,2,2,1,3
C(C(C=O)C(C)O)=O,,,4,1,4,0,4
7603_1,,,,2,2,1,3
7604_0,,,,2,2,1,3
7605_0,,,,2,2,1,3
7606_0,,,,2,2,1,3
7606_1,,,,2,2,1,3
7608_0,,,,2,2,1,3
C(CC(C(CCO)O)O)=O,,,4,1,3,0,3
7610_0,,,,2,2,1,3
C(C(C)(CC=O)O)(O)=O,,,4,1,3,0,3
7612_0,,,,2,2,1,3
C(C(CC(C)O)=O)(O)=O,,,4,1,2,0,2
7614_0,,,,2,2,1,3
C(CC(O)=O)=O,,,4,1,6,0,6
7616_0,,,,2,2,1,3
C(CC(CO)(CC=O)O)(O)=O,,,4,1,2,0,2
7617_0,,,,2,2,1,3
7617_1,,,,2,2,1,3
7618_0,,,,2,2,1,3
7618_1,,,,2,2,1,3
7620_0,,,,2,2,1,3
C(CC(C)(C(C(O)=O)O)O)=O,,,4,1,4,0,4
7621_0,,,,2,2,1,3
7622_0,,,,2,2,1,3
7624_0,,,,2,2,1,3
C(CC(CO)(CC(C(O)=O)O)O)=O,,,4,1,4,0,4
7625_0,,,,2,2,1,3
7625_1,,,,2,2,1,3
7626_0,,,,2,2,1,3
7626_1,,,,2,2,1,3
7628_0,,,,2,2,1,3
C(CC(C)(C(C(C(O)=O)O)O)O)=O,,,4,1,3,0,3
7629_0,,,,2,2,1,3
7631_0,,,,2,2,1,3
C(CC(C(C(O)=O)O)O)=O,,,4,1,4,0,4
7632_0,,,,2,2,1,3
7634_0,,,,2,2,1,3
C(CC(C(CC=O)O)O)(O)=O,,,4,1,3,0,3
7636_0,,,,2,2,1,3
C(CC(C(CC(C)=O)=O)O)=O,,,4,1,3,0,3
7638_0,,,,2,2,1,3
C(CC(C=O)(CC(C)=O)O)=O,,,4,1,2,0,2
7639_0,,,,2,2,1,3
7641_0,,,,2,2,1,3
C(C)(C(C(C=O)=O)C(C)O)=O,,,4,1,4,0,4
7641_1,,,,2,2,1,3
7643_0,,,,2,2,1,3
C(CC(C)O)(CC(C=O)=O)=O,,,4,1,4,0,4
7644_0,,,,2,2,1,3
7646_0,,,,2,2,1,3
C(CC(C=O)(CC=O)O)=O,,,4,1,4,0,4
7647_0,,,,2,2,1,3
7649_0,,,,2,2,1,3
C(C(C(C=O)=O)C(C)O)=O,,,4,1,5,0,5
7649_1,,,,2,2,1,3
7650_0,,,,2,2,1,3
7652_0,,,,2,2,1,3
C(CC(C(C)=O)(CC=O)O)=O,,,4,1,2,0,2
7654_0,,,,2,2,1,3
C(C(C)(CC=O)O)(CC=O)=O,,,4,1,2,0,2
7656_0,,,,2,2,1,3
C(C(C(C(C)=O)=O)C(C)O)=O,,,4,1,4,0,4
7656_1,,,,2,2,1,3
7658_0,,,,2,2,1,3
C(CC(C(CC(C)O)=O)=O)=O,,,4,1,4,0,4
7660_0,,,,2,2,1,3
C(C)(C(C)(CC=O)O)=O,,,4,1,3,0,3
7662_0,,,,2,2,1,3
C(C(C)=O)(CC(C)O)=O,,,4,1,5,0,5
7664_0,,,,2,2,1,3
C(CC(C)(CC=O)O)=O,,,4,1,2,0,2
7666_0,,,,2,2,1,3
C(CC(CC(C)=O)O)=O,,,4,1,2,0,2
7668_0,,,,2,2,1,3
C(CC(CC(C)O)=O)=O,,,4,1,4,0,4
7670_0,,,,2,2,1,3
C(C(C(C)=O)C(C)O)=O,,,4,1,4,0,4
7670_1,,,,2,2,1,3
7672_0,,,,2,2,1,3
C(CC1(COC(C1)O)O)=O,,,4,1,2,0,2
7674_0,,,,2,2,1,3
C1(COC(C1C(C)O)O)=O,,,4,1,3,0,3
7674_1,,,,2,2,1,3
7676_0,,,,2,2,1,3
C1(C(C(C)O)OC(C1)O)=O,,,4,1,3,0,3
7676_1,,,,2,2,1,3
7678_0,,,,2,2,1,3
C(CC1(COC(C(C1)O)O)O)=O,,,4,1,2,0,2
7680_0,,,,2,2,1,3
C1(COC(C(C1C(C)O)O)O)=O,,,4,1,3,0,3
7680_1,,,,2,2,1,3
7682_0,,,,2,2,1,3
C1(C(C(C)O)OC(C(C1)O)O)=O,,,4,1,3,0,3
7682_1,,,,2,2,1,3
7684_0,,,,2,2,1,3
C(CC(C=CC(CO)=O)O)=O,,,4,1,4,0,4
7686_0,,,,2,2,1,3
C(CC(C=CC=O)(CO)O)=O,,,4,1,2,0,2
7688_0,,,,2,2,1,3
C(C=CC(C(C(C)O)O)=O)=O,,,4,1,6,0,6
7688_1,,,,2,2,1,3
7690_0,,,,2,2,1,3
C(CC(C(C=C)=O)O)=O,,,4,1,3,0,3
7692_0,,,,2,2,1,3
C(C(C=C)(CC=O)O)=O,,,4,1,5,0,5
7694_0,,,,2,2,1,3
C(CC(C=C)(CO)O)=O,,,4,1,2,0,2
7696_0,,,,2,2,1,3
C=CC(C(C(C)O)O)=O,,,4,1,6,0,6
7696_1,,,,2,2,1,3
7698_0,,,,2,2,1,3
C(CC(C=CC=O)O)=O,,,4,1,6,0,6
7700_0,,,,2,2,1,3
C(CC(C(CC(C=O)O)O)O)=O,,,4,1,2,0,2
7701_0,,,,2,2,1,3
7703_0,,,,2,2,1,3
C(CC(C(C)O)(C(C=O)O)O)=O,,,4,1,1,0,1
7705_0,,,,2,2,1,3
C(CC(C(C)O)O)=O,,,4,1,1,0,1
7707_0,,,,2,2,1,3
C(CC(C(CCC(C=O)O)=O)O)=O,,,4,1,2,0,2
7709_0,,,,2,2,1,3
C(C(CCC(C=O)(CC=O)O)O)=O,,,4,1,2,0,2
7711_0,,,,2,2,1,3
C(CC(C(CCC(C=O)=O)O)O)=O,,,4,1,2,0,2
7713_0,,,,2,2,1,3
C(C(CC(C(C=O)=O)C(C)O)O)=O,,,4,1,2,0,2
7715_0,,,,2,2,1,3
C(CC(C(CC(C(C)O)=O)=O)O)=O,,,4,1,2,0,2
7717_0,,,,2,2,1,3
C(CC(C=O)(CC=O)O)(C(C)O)=O,,,4,1,2,0,2
7719_0,,,,2,2,1,3
C(CC(C(C)O)(CC(C=O)=O)O)=O,,,4,1,1,0,1
7721_0,,,,2,2,1,3
C(C(C)O)(C(C(C=O)=O)C(C)O)=O,,,4,1,3,0,3
7721_1,,,,2,2,1,3
7723_0,,,,2,2,1,3
C(CC(CC(C(C(C)=O)=O)O)O)=O,,,4,1,2,0,2
7725_0,,,,2,2,1,3
C(C)(C(C(CC=O)O)(CC=O)O)=O,,,4,1,2,0,2
7727_0,,,,2,2,1,3
C(CC(C(C(C)(CC=O)O)=O)O)=O,,,4,1,2,0,2
7729_0,,,,2,2,1,3
C(C(C(C)O)C(C(C(C)=O)=O)O)=O,,,4,1,3,0,3
7729_1,,,,2,2,1,3
7731_0,,,,2,2,1,3
C(CC(C(C(CC(C)O)=O)=O)O)=O,,,4,1,2,0,2
7733_0,,,,2,2,1,3
C(CC(CC(C(C(C)O)=O)=O)O)=O,,,4,1,2,0,2
7735_0,,,,2,2,1,3
C(CC(C(C(C)O)=O)(CC=O)O)=O,,,4,1,2,0,2
7736_0,,,,2,2,1,3
7738_0,,,,2,2,1,3
C(C(C(C(C(C)O)=O)=O)C(C)O)=O,,,4,1,3,0,3
7738_1,,,,2,2,1,3
7740_0,,,,2,2,1,3
C(C)(CC(C(CO)(CC=O)O)=O)=O,,,4,1,1,0,1
7742_0,,,,2,2,1,3
C(CC(C(CO)=O)(CC(C)=O)O)=O,,,4,1,2,0,2
7743_0,,,,2,2,1,3
7745_0,,,,2,2,1,3
C(C)(CC(C(C(C(C)O)O)=O)=O)=O,,,4,1,2,0,2
7745_1,,,,2,2,1,3
7747_0,,,,2,2,1,3
C(C)(C(C(C(CO)=O)=O)C(C)O)=O,,,4,1,3,0,3
7747_1,,,,2,2,1,3
7749_0,,,,2,2,1,3
C(CC(C)O)(CC(C(CO)=O)=O)=O,,,4,1,2,0,2
7751_0,,,,2,2,1,3
C(CC(C(C(CC(C)=O)O)=O)O)=O,,,4,1,2,0,2
7753_0,,,,2,2,1,3
C(C)(CC(C(C=O)(CC=O)O)O)=O,,,4,1,2,0,2
7755_0,,,,2,2,1,3
C(CC(C)(CC(C(C=O)=O)O)O)=O,,,4,1,2,0,2
7757_0,,,,2,2,1,3
C(C)(C(C(C)O)C(C(C=O)=O)O)=O,,,4,1,3,0,3
7757_1,,,,2,2,1,3
7759_0,,,,2,2,1,3
C(CC(C(C=O)=O)O)(CC(C)O)=O,,,4,1,2,0,2
7761_0,,,,2,2,1,3
C(CCC=O)(C(CO)(CC=O)O)=O,,,4,1,1,0,1
7763_0,,,,2,2,1,3
C(CO)(C(CCC=O)(CC=O)O)=O,,,4,1,2,0,2
7765_0,,,,2,2,1,3
C(CC(CCC(C(CO)=O)=O)O)=O,,,4,1,2,0,2
7767_0,,,,2,2,1,3
C(CCC(C(C(C(C)O)O)=O)=O)=O,,,4,1,2,0,2
7767_1,,,,2,2,1,3
7769_0,,,,2,2,1,3
C(CC(C(C(CO)=O)=O)C(C)O)=O,,,4,1,2,0,2
7771_0,,,,2,2,1,3
C(C(C(C)O)CC(C(CO)=O)=O)=O,,,4,1,2,0,2
7773_0,,,,2,2,1,3
C(CCC(C(C(CC=O)O)=O)O)=O,,,4,1,2,0,2
7775_0,,,,2,2,1,3
C(CCC(C(C=O)(CC=O)O)O)=O,,,4,1,1,0,1
7777_0,,,,2,2,1,3
C(CC(CCC(C(C=O)=O)O)O)=O,,,4,1,2,0,2
7779_0,,,,2,2,1,3
C(C(CC(C(C=O)=O)O)C(C)O)=O,,,4,1,2,0,2
7780_0,,,,2,2,1,3
7781_0,,,,2,2,1,3
7783_0,,,,2,2,1,3
C(CO)(CC(C(C)(CC=O)O)=O)=O,,,4,1,2,0,2
7785_0,,,,2,2,1,3
C(C(C(C)O)O)(CC(C(C)=O)=O)=O,,,4,1,2,0,2
7785_1,,,,2,2,1,3
7787_0,,,,2,2,1,3
C(CO)(C(C(C(C)=O)=O)C(C)O)=O,,,4,1,3,0,3
7787_1,,,,2,2,1,3
7789_0,,,,2,2,1,3
C(CO)(CC(C(CC(C)O)=O)=O)=O,,,4,1,2,0,2
7791_0,,,,2,2,1,3
C(CC(C(C=CCO)=O)(CO)O)=O,,,4,1,1,0,1
7793_0,,,,2,2,1,3
C(CC(C(CO)=O)(C=CCO)O)=O,,,4,1,2,0,2
7795_0,,,,2,2,1,3
C(CO)=CC(C(C(C(C)O)O)=O)=O,,,4,1,2,0,2
7795_1,,,,2,2,1,3
7797_0,,,,2,2,1,3
C(CC(C(C(C=CCO)O)=O)O)=O,,,4,1,2,0,2
7799_0,,,,2,2,1,3
C(CC(C=O)(C(C=CCO)O)O)=O,,,4,1,1,0,1
7801_0,,,,2,2,1,3
C(CC(C=CC(C(CO)=O)O)O)=O,,,4,1,3,0,3
7803_0,,,,2,2,1,3
C(CC(CO)(C(C=CC=O)O)O)=O,,,4,1,1,0,1
7805_0,,,,2,2,1,3
C(C(C(C)O)O)(C(C=CC=O)O)=O,,,4,1,2,0,2
7805_1,,,,2,2,1,3
7806_0,,,,2,2,1,3
7808_0,,,,2,2,1,3
C(CC(C=C)(C(C(CO)=O)O)O)=O,,,4,1,2,0,2
7810_0,,,,2,2,1,3
C(C(C(C)O)O)(C(C(C=C)=O)O)=O,,,4,1,2,0,2
7810_1,,,,2,2,1,3
7812_0,,,,2,2,1,3
C(CC(C(C(C(C=C)O)=O)O)O)=O,,,4,1,2,0,2
7814_0,,,,2,2,1,3
C(CC(C(C=O)O)(C(C=C)O)O)=O,,,4,1,1,0,1
7816_0,,,,2,2,1,3
C(CC(C=CC(CO)=O)(CO)O)=O,,,4,1,2,0,2
7818_0,,,,2,2,1,3
C(C=CC(CO)=O)(C(C(C)O)O)=O,,,4,1,3,0,3
7818_1,,,,2,2,1,3
7820_0,,,,2,2,1,3
C(CC(C(C=CC(C=O)O)O)O)=O,,,4,1,2,0,2
7822_0,,,,2,2,1,3
C(CC(CO)(CC(CCO)=O)O)=O,,,4,1,3,0,3
7824_0,,,,2,2,1,3
C(CC(CCO)(CC(CO)=O)O)=O,,,4,1,3,0,3
7826_0,,,,2,2,1,3
C(CCO)(CC(C(C(C)O)O)=O)=O,,,4,1,3,0,3
7826_1,,,,2,2,1,3
7828_0,,,,2,2,1,3
C(CCO)(C(C(CO)=O)C(C)O)=O,,,4,1,4,0,4
7828_1,,,,2,2,1,3
7830_0,,,,2,2,1,3
C(C(CO)C(C)O)(CC(CO)=O)=O,,,4,1,4,0,4
7830_1,,,,2,2,1,3
7832_0,,,,2,2,1,3
C(CC(CO)(CCC(CO)=O)O)=O,,,4,1,4,0,4
7834_0,,,,2,2,1,3
C(CCC(C(C(C)O)O)=O)(CO)=O,,,4,1,3,0,3
7834_1,,,,2,2,1,3
7836_0,,,,2,2,1,3
C(CO)(C(C(C)O)CC(CO)=O)=O,,,4,1,4,0,4
7837_0,,,,2,2,1,3
7839_0,,,,2,2,1,3
C(C(CC(CCO)O)(CC=O)O)=O,,,4,1,2,0,2
7840_0,,,,2,2,1,3
7840_1,,,,2,2,1,3
7842_0,,,,2,2,1,3
C(C(CCO)(CC=O)O)(CCO)=O,,,4,1,3,0,3
7844_0,,,,2,2,1,3
C(C(CCO)=O)(C(CO)C(C)O)=O,,,4,1,4,0,4
7844_1,,,,2,2,1,3
7846_0,,,,2,2,1,3
C(CC(CCO)(C(C(C)=O)O)O)=O,,,4,1,2,0,2
7847_0,,,,2,2,1,3
7849_0,,,,2,2,1,3
C(C(CO)C(C)O)(C(C(C)=O)O)=O,,,4,1,3,0,3
7849_1,,,,2,2,1,3
7851_0,,,,2,2,1,3
C(CC(C)O)(C(C(CCO)=O)O)=O,,,4,1,2,0,2
7853_0,,,,2,2,1,3
C(CC(CC(C(CCO)O)=O)O)=O,,,4,1,2,0,2
7855_0,,,,2,2,1,3
C(CC(C(CCO)O)(CC=O)O)=O,,,4,1,2,0,2
7857_0,,,,2,2,1,3
C(C(C(C(CCO)O)=O)C(C)O)=O,,,4,1,3,0,3
7857_1,,,,2,2,1,3
7859_0,,,,2,2,1,3
C(CC(C(CO)O)(CC(C)=O)O)=O,,,4,1,2,0,2
7860_0,,,,2,2,1,3
7862_0,,,,2,2,1,3
C(C(CO)O)(C(C(C)=O)C(C)O)=O,,,4,1,3,0,3
7862_1,,,,2,2,1,3
7864_0,,,,2,2,1,3
C(CC(C)O)(CC(C(CO)O)=O)=O,,,4,1,2,0,2
7866_0,,,,2,2,1,3
C(CCC(C(CO)O)(CC=O)O)=O,,,4,1,2,0,2
7868_0,,,,2,2,1,3
C(CC(CCC(C(CO)O)=O)O)=O,,,4,1,2,0,2
7870_0,,,,2,2,1,3
C(C(C(C)O)CC=O)(C(CO)O)=O,,,4,1,3,0,3
7872_0,,,,2,2,1,3
C(C(C(C)O)CC(C(CO)O)=O)=O,,,4,1,3,0,3
7874_0,,,,2,2,1,3
C(CC(C(C(CCCO)=O)O)O)=O,,,4,1,2,0,2
7876_0,,,,2,2,1,3
C(CC(CCCO)(C(C=O)O)O)=O,,,4,1,2,0,2
7878_0,,,,2,2,1,3
C(C(C(C(C(C)O)CCO)=O)O)=O,,,4,1,2,0,2
7880_0,,,,2,2,1,3
C(C)(C(CC(CO)O)(CC=O)O)=O,,,4,1,2,0,2
7882_0,,,,2,2,1,3
C(C(C)(CC=O)O)(CC(CO)O)=O,,,4,1,2,0,2
7884_0,,,,2,2,1,3
C(C(C)=O)(C(C(CO)O)C(C)O)=O,,,4,1,3,0,3
7884_1,,,,2,2,1,3
7886_0,,,,2,2,1,3
C(C(CC(C)O)=O)(CC(CO)O)=O,,,4,1,2,0,2
7888_0,,,,2,2,1,3
C(CC(CC(CO)O)(CC=O)O)=O,,,4,1,2,0,2
7890_0,,,,2,2,1,3
C(CC(CC(CC(CO)O)=O)O)=O,,,4,1,2,0,2
7892_0,,,,2,2,1,3
C(CC(C(C(CO)O)C(C)O)=O)=O,,,4,1,3,0,3
7892_1,,,,2,2,1,3
7894_0,,,,2,2,1,3
C(C(C(CC(CO)O)=O)C(C)O)=O,,,4,1,3,0,3
7894_1,,,,2,2,1,3
7896_0,,,,2,2,1,3
C(CC(C(CC(CCO)=O)O)O)=O,,,4,1,2,0,2
7898_0,,,,2,2,1,3
C(CC(CC(C=O)O)(CCO)O)=O,,,4,1,2,0,2
7900_0,,,,2,2,1,3
C(C(C(C)O)C(C=O)O)(CCO)=O,,,4,1,3,0,3
7900_1,,,,2,2,1,3
7902_0,,,,2,2,1,3
C(CC(C=O)O)(C(CO)C(C)O)=O,,,4,1,3,0,3
7902_1,,,,2,2,1,3
7904_0,,,,2,2,1,3
C(CC(C=CC(CO)O)(CO)O)=O,,,4,1,3,0,3
7906_0,,,,2,2,1,3
C(C(CO)O)=CC(C(C(C)O)O)=O,,,4,1,3,0,3
7906_1,,,,2,2,1,3
7908_0,,,,2,2,1,3
C(CC(C=CCO)(C(CO)O)O)=O,,,4,1,3,0,3
7910_0,,,,2,2,1,3
C(CC(C=C)(C(C(CO)O)O)O)=O,,,4,1,2,0,2
7912_0,,,,2,2,1,3
C(CC(C=CC(C(CO)O)O)O)=O,,,4,1,2,0,2
7914_0,,,,2,2,1,3
C(CC(C(C(C=CCO)O)O)O)=O,,,4,1,2,0,2
7915_0,,,,2,2,1,3
7917_0,,,,2,2,1,3
C(C(C(CO)C(C)O)=O)(O)=O,,,4,1,3,0,3
7917_1,,,,2,2,1,3
7918_0,,,,2,2,1,3
7919_0,,,,2,2,1,3
7919_1,,,,2,2,1,3
7921_0,,,,2,2,1,3
C1(CCC(C1(C(CC=O)O)O)O)=O,,,4,1,3,0,3
7923_0,,,,2,2,1,3
C(C1(C(CCC1(CC=O)O)O)O)=O,,,4,1,3,0,3
7925_0,,,,2,2,1,3
C(C1(C(C(C(C)O)CC1O)=O)O)=O,,,4,1,3,0,3
7927_0,,,,2,2,1,3
C(CC1(C=CC(C1(CO)O)O)O)=O,,,4,1,1,0,1
7929_0,,,,2,2,1,3
C(CC(C1(C(C=CC1O)O)O)O)=O,,,4,1,1,0,1
7930_0,,,,2,2,1,3
7931_0,,,,2,2,1,3
7933_0,,,,2,2,1,3
C(CC(C(CO)(CO)O)O)=O,,,4,1,1,0,1
7935_0,,,,2,2,1,3
C(CC(C(CO)(C(C)O)O)O)=O,,,4,1,1,0,1
7937_0,,,,2,2,1,3
C(CC(C(C(C)=O)(CO)O)O)=O,,,4,1,6,0,6
7939_0,,,,2,2,1,3
C(C(CO)(C(C)(CC=O)O)O)=O,,,4,1,6,0,6
7941_0,,,,2,2,1,3
C(C(C(CC(C)O)=O)(CO)O)=O,,,4,1,3,0,3
7943_0,,,,2,2,1,3
C(CC(C(C(C)=O)(C(C)O)O)O)=O,,,4,1,5,0,5
7945_0,,,,2,2,1,3
C(C(C(C)O)(C(C)(CC=O)O)O)=O,,,4,1,5,0,5
7947_0,,,,2,2,1,3
C(C(C(CC(C)O)=O)(C(C)O)O)=O,,,4,1,3,0,3
7948_0,,,,2,2,1,3
7950_0,,,,2,2,1,3
C(CC(C(C=O)(C(C=O)O)O)O)=O,,,4,1,5,0,5
7952_0,,,,2,2,1,3
C(CC(C)(C(CO)(CO)O)O)=O,,,4,1,1,0,1
7954_0,,,,2,2,1,3
C(CC(C)O)(C(CO)(CO)O)=O,,,4,1,3,0,3
7956_0,,,,2,2,1,3
C(CC(C)(C(CO)(C(C)O)O)O)=O,,,4,1,1,0,1
7958_0,,,,2,2,1,3
C(CC(C)O)(C(CO)(C(C)O)O)=O,,,4,1,3,0,3
7960_0,,,,2,2,1,3
C(C(CO)(C(CC=O)O)O)=O,,,4,1,6,0,6
7962_0,,,,2,2,1,3
C(CC(CO)(C(CO)(CO)O)O)=O,,,4,1,3,0,3
7964_0,,,,2,2,1,3
C(C(C(C)O)O)(C(CO)(CO)O)=O,,,4,1,4,0,4
7964_1,,,,2,2,1,3
7966_0,,,,2,2,1,3
C(C(C(CC=O)O)(C(C)O)O)=O,,,4,1,5,0,5
7968_0,,,,2,2,1,3
C(CC(C(CO)(C(CO)O)O)O)=O,,,4,1,1,0,1
7970_0,,,,2,2,1,3
C(C(C(CC=O)O)(C(CO)O)O)=O,,,4,1,5,0,5
7972_0,,,,2,2,1,3
C(CC(C1(C(CC(C1)=O)O)O)O)=O,,,4,1,1,0,1
7974_0,,,,2,2,1,3
C(C1(CC(CC1O)(CC=O)O)O)=O,,,4,1,2,0,2
7976_0,,,,2,2,1,3
C1(C(C(C)O)C(C=O)(C(C1)O)O)=O,,,4,1,3,0,3
7976_1,,,,2,2,1,3
7978_0,,,,2,2,1,3
C(C1(C(C(C(C1)=O)C(C)O)O)O)=O,,,4,1,3,0,3
7978_1,,,,2,2,1,3
7980_0,,,,2,2,1,3
C(CC(C(C)(C(C(O)=O)O)O)O)=O,,,4,1,2,0,2
7981_0,,,,2,2,1,3
7983_0,,,,2,2,1,3
C(C(CO)(CC(CC=O)O)O)=O,,,4,1,2,0,2
7984_0,,,,2,2,1,3
7984_1,,,,2,2,1,3
7986_0,,,,2,2,1,3
C(CC(C(CC=O)O)(C(C)O)O)=O,,,4,1,1,0,1
7988_0,,,,2,2,1,3
C(C(C(C)O)(CC(CC=O)O)O)=O,,,4,1,2,0,2
7989_0,,,,2,2,1,3
7989_1,,,,2,2,1,3
7991_0,,,,2,2,1,3
C(CC1(CC(C(C1CO)=O)O)O)=O,,,4,1,1,0,1
7993_0,,,,2,2,1,3
C1(CC(C(CC=O)(C1CO)O)O)=O,,,4,1,1,0,1
7995_0,,,,2,2,1,3
C1(C(C(C)O)C(C(C1CO)=O)O)=O,,,4,1,2,0,2
7995_1,,,,2,2,1,3
7997_0,,,,2,2,1,3
C(CC1(CC(C(C1O)=O)CO)O)=O,,,4,1,1,0,1
7999_0,,,,2,2,1,3
C(CC1(C(CO)CC(C1O)=O)O)=O,,,4,1,2,0,2
8001_0,,,,2,2,1,3
C1(C(C(C)O)C(C(C1O)=O)CO)=O,,,4,1,1,0,1
8003_0,,,,2,2,1,3
C1(CCC(CC=O)(C1(CO)O)O)=O,,,4,1,1,0,1
8005_0,,,,2,2,1,3
C1(C(C(C)O)CC(C1(CO)O)=O)=O,,,4,1,1,0,1
8007_0,,,,2,2,1,3
C1(CC(CC1(CO)O)(CC=O)O)=O,,,4,1,1,0,1
8009_0,,,,2,2,1,3
C(CC1(C(CO)(CC(C1)=O)O)O)=O,,,4,1,1,0,1
8011_0,,,,2,2,1,3
C1(C(C(C)O)C(C(C1)=O)(CO)O)=O,,,4,1,2,0,2
8011_1,,,,2,2,1,3
8013_0,,,,2,2,1,3
C1(C(CO)(CC(C1C(C)O)=O)O)=O,,,4,1,2,0,2
8013_1,,,,2,2,1,3
8015_0,,,,2,2,1,3
C1(CC(C(C(C)(CC=O)O)O1)O)=O,,,4,1,1,0,1
8017_0,,,,2,2,1,3
C1(CC(C(C(CC(C)O)=O)O1)O)=O,,,4,1,1,0,1
8019_0,,,,2,2,1,3
C1(CC(C(CC(CC=O)O)O1)O)=O,,,4,1,1,0,1
8021_0,,,,2,2,1,3
C(C(C1C(CC(O1)=O)O)C(C)O)=O,,,4,1,2,0,2
8021_1,,,,2,2,1,3
8023_0,,,,2,2,1,3
C(CC1(C(C(C(C)=O)OC1)O)O)=O,,,4,1,1,0,1
8025_0,,,,2,2,1,3
C(CC(C)(C1C(C(CO1)=O)O)O)=O,,,4,1,1,0,1
8027_0,,,,2,2,1,3
C(C1C(C(C(C(C)O)O1)=O)O)(C)=O,,,4,1,2,0,2
8027_1,,,,2,2,1,3
8029_0,,,,2,2,1,3
C(C1C(C(CO1)=O)O)(CC(C)O)=O,,,4,1,1,0,1
8031_0,,,,2,2,1,3
C(CC1(COC(C1O)CC=O)O)=O,,,4,1,1,0,1
8033_0,,,,2,2,1,3
C(CC(CC1C(C(CO1)=O)O)O)=O,,,4,1,1,0,1
8035_0,,,,2,2,1,3
C(CC1C(C(C(C(C)O)O1)=O)O)=O,,,4,1,2,0,2
8035_1,,,,2,2,1,3
8037_0,,,,2,2,1,3
C(C(C1C(C(CO1)=O)O)C(C)O)=O,,,4,1,2,0,2
8037_1,,,,2,2,1,3
8039_0,,,,2,2,1,3
C(CC1(CC(C(C)=O)OC1O)O)=O,,,4,1,2,0,2
8041_0,,,,2,2,1,3
C(CC(C)(C1CC(C(O)O1)=O)O)=O,,,4,1,2,0,2
8043_0,,,,2,2,1,3
C(C1C(C(C(O1)O)=O)C(C)O)(C)=O,,,4,1,3,0,3
8043_1,,,,2,2,1,3
8045_0,,,,2,2,1,3
C1(C(OC(C(CC(C)O)=O)C1)O)=O,,,4,1,2,0,2
8047_0,,,,2,2,1,3
C(CC1CC(C(O)O1)(CC=O)O)=O,,,4,1,2,0,2
8049_0,,,,2,2,1,3
C(CC(CC1CC(C(O)O1)=O)O)=O,,,4,1,2,0,2
8051_0,,,,2,2,1,3
C(CC1C(C(C(O)O1)=O)C(C)O)=O,,,4,1,3,0,3
8051_1,,,,2,2,1,3
8053_0,,,,2,2,1,3
C(C(C1CC(C(O)O1)=O)C(C)O)=O,,,4,1,3,0,3
8053_1,,,,2,2,1,3
8055_0,,,,2,2,1,3
C(CC1(CC(OC1C(C)=O)O)O)=O,,,4,1,2,0,2
8056_0,,,,2,2,1,3
8058_0,,,,2,2,1,3
C1(C(C(OC1C(C)=O)O)C(C)O)=O,,,4,1,3,0,3
8058_1,,,,2,2,1,3
8060_0,,,,2,2,1,3
C(CC(C)O)(C1C(CC(O1)O)=O)=O,,,4,1,2,0,2
8062_0,,,,2,2,1,3
C(CC1C(CC(O)O1)(CC=O)O)=O,,,4,1,2,0,2
8064_0,,,,2,2,1,3
C(CC(CC1C(CC(O1)O)=O)O)=O,,,4,1,2,0,2
8066_0,,,,2,2,1,3
C(CC1C(C(C(O1)O)C(C)O)=O)=O,,,4,1,3,0,3
8066_1,,,,2,2,1,3
8068_0,,,,2,2,1,3
C(C(C(C)O)C1C(CC(O1)O)=O)=O,,,4,1,3,0,3
8068_1,,,,2,2,1,3
8070_0,,,,2,2,1,3
C1(CC(CC(CO)O1)(CC=O)O)=O,,,4,1,1,0,1
8072_0,,,,2,2,1,3
C1(C(C(CC(CO)O1)=O)C(C)O)=O,,,4,1,2,0,2
8072_1,,,,2,2,1,3
8074_0,,,,2,2,1,3
C1(CC(C(C(CO)O1)C(C)O)=O)=O,,,4,1,2,0,2
8074_1,,,,2,2,1,3
8076_0,,,,2,2,1,3
C1(CCC(C(CO)O1)(CC=O)O)=O,,,4,1,1,0,1
8078_0,,,,2,2,1,3
C1(C(CO)OC(CC1C(C)O)=O)=O,,,4,1,1,0,1
8080_0,,,,2,2,1,3
C1(C(COC(CO)C1)(CC=O)O)=O,,,4,1,1,0,1
8082_0,,,,2,2,1,3
C1(COC(CO)CC1(CC=O)O)=O,,,4,1,1,0,1
8084_0,,,,2,2,1,3
C1(C(C(C(C)O)OC(CO)C1)=O)=O,,,4,1,2,0,2
8084_1,,,,2,2,1,3
8086_0,,,,2,2,1,3
C1(C(COC(CO)C1C(C)O)=O)=O,,,4,1,2,0,2
8086_1,,,,2,2,1,3
8088_0,,,,2,2,1,3
C(CC1(COC(C(C1)=O)CO)O)=O,,,4,1,1,0,1
8090_0,,,,2,2,1,3
C(CC1(C(CO)OCC(C1)=O)O)=O,,,4,1,1,0,1
8092_0,,,,2,2,1,3
C1(C(C(C)O)OC(C(C1)=O)CO)=O,,,4,1,2,0,2
8092_1,,,,2,2,1,3
8094_0,,,,2,2,1,3
C1(C(CO)OCC(C1C(C)O)=O)=O,,,4,1,2,0,2
8094_1,,,,2,2,1,3
8096_0,,,,2,2,1,3
C1(CC(CC(CO1)O)(CC=O)O)=O,,,4,1,1,0,1
8098_0,,,,2,2,1,3
C1(C(C(CC(CO1)O)=O)C(C)O)=O,,,4,1,2,0,2
8098_1,,,,2,2,1,3
8100_0,,,,2,2,1,3
C1(CC(C(C(C)O)C(CO1)O)=O)=O,,,4,1,2,0,2
8100_1,,,,2,2,1,3
8102_0,,,,2,2,1,3
C1(CCC(C(CO1)O)(CC=O)O)=O,,,4,1,1,0,1
8104_0,,,,2,2,1,3
C1(C(C(C)O)CC(OCC1O)=O)=O,,,4,1,1,0,1
8106_0,,,,2,2,1,3
C1(CC(C(CCO1)(CC=O)O)O)=O,,,4,1,1,0,1
8108_0,,,,2,2,1,3
C1(CC(C(C(CO1)C(C)O)=O)O)=O,,,4,1,2,0,2
8108_1,,,,2,2,1,3
8110_0,,,,2,2,1,3
C1(CC(CC(CO1)(CC=O)O)O)=O,,,4,1,1,0,1
8112_0,,,,2,2,1,3
C1(CC(C(C(CO1)=O)C(C)O)O)=O,,,4,1,2,0,2
8112_1,,,,2,2,1,3
8114_0,,,,2,2,1,3
C1(CC(CC(C(C(C)O)O1)=O)O)=O,,,4,1,2,0,2
8114_1,,,,2,2,1,3
8116_0,,,,2,2,1,3
C1(C(COCC(C1)O)(CC=O)O)=O,,,4,1,1,0,1
8118_0,,,,2,2,1,3
C1(COCC(CC1(CC=O)O)O)=O,,,4,1,1,0,1
8120_0,,,,2,2,1,3
C1(C(C(C(C)O)OCC(C1)O)=O)=O,,,4,1,2,0,2
8120_1,,,,2,2,1,3
8122_0,,,,2,2,1,3
C1(C(COCC(C1C(C)O)O)=O)=O,,,4,1,2,0,2
8122_1,,,,2,2,1,3
8124_0,,,,2,2,1,3
C(CC1(COCC(C(C1)=O)O)O)=O,,,4,1,1,0,1
8126_0,,,,2,2,1,3
C(CC1(C(COCC(C1)=O)O)O)=O,,,4,1,1,0,1
8128_0,,,,2,2,1,3
C1(C(COC(C(C1)=O)C(C)O)O)=O,,,4,1,2,0,2
8128_1,,,,2,2,1,3
8130_0,,,,2,2,1,3
C1(C(COCC(C1C(C)O)=O)O)=O,,,4,1,2,0,2
8130_1,,,,2,2,1,3
8132_0,,,,2,2,1,3
C(CC1(COCCC(C1O)=O)O)=O,,,4,1,1,0,1
8134_0,,,,2,2,1,3
C(CC1(CCOCC(C1O)=O)O)=O,,,4,1,1,0,1
8136_0,,,,2,2,1,3
C1(CCOC(C(C1O)=O)C(C)O)=O,,,4,1,2,0,2
8136_1,,,,2,2,1,3
8138_0,,,,2,2,1,3
C1(C(COCC(C1O)=O)C(C)O)=O,,,4,1,2,0,2
8138_1,,,,2,2,1,3
8140_0,,,,2,2,1,3
C(CC1(C(CC(COC1)=O)O)O)=O,,,4,1,1,0,1
8142_0,,,,2,2,1,3
C(CC1(COCC(C(C1)O)=O)O)=O,,,4,1,1,0,1
8144_0,,,,2,2,1,3
C1(CC(C(C(C(C)O)OC1)=O)O)=O,,,4,1,2,0,2
8144_1,,,,2,2,1,3
8146_0,,,,2,2,1,3
C1(COCC(C(C1C(C)O)O)=O)=O,,,4,1,2,0,2
8146_1,,,,2,2,1,3
8148_0,,,,2,2,1,3
C1(CC(C(COC1C(C)O)=O)O)=O,,,4,1,2,0,2
8148_1,,,,2,2,1,3
8150_0,,,,2,2,1,3
C(CC1(C(O)OCCC(C1)=O)O)=O,,,4,1,2,0,2
8152_0,,,,2,2,1,3
C(CC1(CCOC(C(C1)=O)O)O)=O,,,4,1,2,0,2
8154_0,,,,2,2,1,3
C1(CCOC(C(C1C(C)O)=O)O)=O,,,4,1,3,0,3
8154_1,,,,2,2,1,3
8156_0,,,,2,2,1,3
C1(C(COC(C(C1)=O)O)C(C)O)=O,,,4,1,3,0,3
8156_1,,,,2,2,1,3
8158_0,,,,2,2,1,3
C(CC1(CCC(COC1O)=O)O)=O,,,4,1,2,0,2
8160_0,,,,2,2,1,3
C(CC1(COC(C(CC1)=O)O)O)=O,,,4,1,2,0,2
8162_0,,,,2,2,1,3
C1(CC(C(C(OC1)O)=O)C(C)O)=O,,,4,1,2,0,2
8164_0,,,,2,2,1,3
C1(COC(C(CC1C(C)O)=O)O)=O,,,4,1,2,0,2
8166_0,,,,2,2,1,3
C1(CCC(C(OC1C(C)O)O)=O)=O,,,4,1,3,0,3
8166_1,,,,2,2,1,3
8168_0,,,,2,2,1,3
C1(C(CC(O)OCC1)(CC=O)O)=O,,,4,1,2,0,2
8170_0,,,,2,2,1,3
C1(C(CCOC(C1)O)(CC=O)O)=O,,,4,1,2,0,2
8172_0,,,,2,2,1,3
C1(C(CCOC(C1C(C)O)O)=O)=O,,,4,1,3,0,3
8172_1,,,,2,2,1,3
8174_0,,,,2,2,1,3
C1(C(CC(O)OCC1C(C)O)=O)=O,,,4,1,3,0,3
8174_1,,,,2,2,1,3
8176_0,,,,2,2,1,3
C(CC1(CC(OCC(C1)=O)O)O)=O,,,4,1,2,0,2
8178_0,,,,2,2,1,3
C(CC1(COC(CC(C1)=O)O)O)=O,,,4,1,2,0,2
8180_0,,,,2,2,1,3
C1(C(C(OCC(C1)=O)O)C(C)O)=O,,,4,1,3,0,3
8180_1,,,,2,2,1,3
8182_0,,,,2,2,1,3
C1(CC(OCC(C1C(C)O)=O)O)=O,,,4,1,3,0,3
8182_1,,,,2,2,1,3
8184_0,,,,2,2,1,3
C1(CC(OC(C(C1)=O)C(C)O)O)=O,,,4,1,3,0,3
8184_1,,,,2,2,1,3
8186_0,,,,2,2,1,3
C(CC(C(C=CC(C)=O)=O)O)=O,,,4,1,3,0,3
8188_0,,,,2,2,1,3
C(C(C=CC(C)=O)(CC=O)O)=O,,,4,1,3,0,3
8190_0,,,,2,2,1,3
C(CC(C=CC(C=O)=O)(C)O)=O,,,4,1,2,0,2
8192_0,,,,2,2,1,3
C(C(C=CC(CC(C)O)=O)=O)=O,,,4,1,2,0,2
8194_0,,,,2,2,1,3
C(CC=CC(C(CC=O)O)=O)=O,,,4,1,3,0,3
8196_0,,,,2,2,1,3
C(C(C=CCC=O)(CC=O)O)=O,,,4,1,3,0,3
8198_0,,,,2,2,1,3
C(CC(CC=CC(C=O)=O)O)=O,,,4,1,2,0,2
8200_0,,,,2,2,1,3
C(C(C=CC(C=O)=O)C(C)O)=O,,,4,1,2,0,2
8202_0,,,,2,2,1,3
C(CC(C=CC(C(C)=O)=O)O)=O,,,4,1,3,0,3
8204_0,,,,2,2,1,3
C(CC(C(C)=O)(C=CC=O)O)=O,,,4,1,3,0,3
8206_0,,,,2,2,1,3
C(CC(C(C=CC=O)=O)(C)O)=O,,,4,1,2,0,2
8208_0,,,,2,2,1,3
C(C(C=CC=O)=O)(CC(C)O)=O,,,4,1,2,0,2
8210_0,,,,2,2,1,3
C(CC(C=CC(CC=O)O)=O)=O,,,4,1,5,0,5
8212_0,,,,2,2,1,3
C(CC(C=CC=O)(CC=O)O)=O,,,4,1,4,0,4
8214_0,,,,2,2,1,3
C(CC(CC(C=CC=O)=O)O)=O,,,4,1,4,0,4
8216_0,,,,2,2,1,3
C(C(C(C=CC=O)=O)C(C)O)=O,,,4,1,6,0,6
8216_1,,,,2,2,1,3
8218_0,,,,2,2,1,3
C(CC(C(CC(C=C)=O)=O)O)=O,,,4,1,3,0,3
8220_0,,,,2,2,1,3
C(CC(C=O)(CC(C=C)=O)O)=O,,,4,1,2,0,2
8222_0,,,,2,2,1,3
C(CC(C=C)(CC(C=O)=O)O)=O,,,4,1,3,0,3
8224_0,,,,2,2,1,3
C=CC(C(C(C=O)=O)C(C)O)=O,,,4,1,4,0,4
8224_1,,,,2,2,1,3
8226_0,,,,2,2,1,3
C(CC(CC(C(C=C)=O)=O)O)=O,,,4,1,3,0,3
8228_0,,,,2,2,1,3
C(CC(C(C=C)=O)(CC=O)O)=O,,,4,1,2,0,2
8230_0,,,,2,2,1,3
C(CC=O)(C(C=C)(CC=O)O)=O,,,4,1,4,0,4
8232_0,,,,2,2,1,3
C(C(C(C(C=C)=O)=O)C(C)O)=O,,,4,1,4,0,4
8232_1,,,,2,2,1,3
8234_0,,,,2,2,1,3
C(CC(C(CC=CC=O)=O)O)=O,,,4,1,3,0,3
8236_0,,,,2,2,1,3
C(CC(C=O)(CC=CC=O)O)=O,,,4,1,2,0,2
8238_0,,,,2,2,1,3
C(CC(C=CCC(C=O)=O)O)=O,,,4,1,3,0,3
8240_0,,,,2,2,1,3
C(C(C(C=O)=O)C(C)O)=CC=O,,,4,1,2,0,2
8242_0,,,,2,2,1,3
C(CC1(COCC1O)O)=O,,,4,1,1,0,1
8244_0,,,,2,2,1,3
C1(C(C(C)O)OCC1O)=O,,,4,1,2,0,2
8244_1,,,,2,2,1,3
8246_0,,,,2,2,1,3
C(CC1(C(O)OCC1)O)=O,,,4,1,2,0,2
8248_0,,,,2,2,1,3
C1(C(O)OCC1C(C)O)=O,,,4,1,3,0,3
8248_1,,,,2,2,1,3
8250_0,,,,2,2,1,3
C(CC(CC1C(C(CO1)O)=O)O)=O,,,4,1,1,0,1
8252_0,,,,2,2,1,3
C(CC1(C(CC=O)OCC1O)O)=O,,,4,1,1,0,1
8254_0,,,,2,2,1,3
C(C(C(C)O)C1C(C(CO1)O)=O)=O,,,4,1,2,0,2
8254_1,,,,2,2,1,3
8256_0,,,,2,2,1,3
C(CC(CC1(C(CCO1)=O)O)O)=O,,,4,1,2,0,2
8258_0,,,,2,2,1,3
C(CC1(C(CC=O)(O)OCC1)O)=O,,,4,1,2,0,2
8260_0,,,,2,2,1,3
C(C(C(C)O)C1(C(CCO1)=O)O)=O,,,4,1,3,0,3
8260_1,,,,2,2,1,3
8262_0,,,,2,2,1,3
C(CC1(C(C(CO1)C(C)O)=O)O)=O,,,4,1,3,0,3
8262_1,,,,2,2,1,3
8264_0,,,,2,2,1,3
C(CC(CC1(CC(CO1)=O)O)O)=O,,,4,1,2,0,2
8266_0,,,,2,2,1,3
C(CC1(COC(C1)(CC=O)O)O)=O,,,4,1,2,0,2
8268_0,,,,2,2,1,3
C(C(C1(CC(CO1)=O)O)C(C)O)=O,,,4,1,3,0,3
8268_1,,,,2,2,1,3
8270_0,,,,2,2,1,3
C(CC1(C(C(CO1)=O)C(C)O)O)=O,,,4,1,3,0,3
8270_1,,,,2,2,1,3
8272_0,,,,2,2,1,3
C(CC1(CC(C(C(C)O)O1)=O)O)=O,,,4,1,3,0,3
8272_1,,,,2,2,1,3
8274_0,,,,2,2,1,3
C(CC(C(C1CC(CO1)O)=O)O)=O,,,4,1,1,0,1
8276_0,,,,2,2,1,3
C(C(C1CC(CO1)O)(CC=O)O)=O,,,4,1,1,0,1
8278_0,,,,2,2,1,3
C(CC(C1C(CC(C=O)O1)O)O)=O,,,4,1,1,0,1
8280_0,,,,2,2,1,3
C(CC(C1CC(C(C=O)O1)O)O)=O,,,4,1,1,0,1
8282_0,,,,2,2,1,3
C(CC(C1C(CC(C)(O1)O)=O)O)=O,,,4,1,2,0,2
8284_0,,,,2,2,1,3
C(CC1(CC(C)(OC1C=O)O)O)=O,,,4,1,2,0,2
8286_0,,,,2,2,1,3
C(C1C(C(C(C)O)C(C)(O1)O)=O)=O,,,4,1,3,0,3
8286_1,,,,2,2,1,3
8288_0,,,,2,2,1,3
C(CC(C1CC(C(C)(O)O1)=O)O)=O,,,4,1,2,0,2
8290_0,,,,2,2,1,3
C(CC1(CC(C=O)OC1(C)O)O)=O,,,4,1,2,0,2
8292_0,,,,2,2,1,3
C1(C(C)(OC(C=O)C1C(C)O)O)=O,,,4,1,3,0,3
8292_1,,,,2,2,1,3
8294_0,,,,2,2,1,3
C(CC(C1C(C(C(C)O1)=O)O)O)=O,,,4,1,1,0,1
8296_0,,,,2,2,1,3
C(CC1(C(C(C=O)OC1C)O)O)=O,,,4,1,1,0,1
8298_0,,,,2,2,1,3
C(CC(C1(CC(CCO1)=O)O)O)=O,,,4,1,2,0,2
8300_0,,,,2,2,1,3
C(CC1(CC(C=O)(O)OCC1)O)=O,,,4,1,2,0,2
8302_0,,,,2,2,1,3
C1(C(C(C)O)C(C=O)(O)OCC1)=O,,,4,1,3,0,3
8302_1,,,,2,2,1,3
8304_0,,,,2,2,1,3
C1(CC(C=O)(O)OCC1C(C)O)=O,,,4,1,3,0,3
8304_1,,,,2,2,1,3
8306_0,,,,2,2,1,3
C(CC(C1(CCC(CO1)=O)O)O)=O,,,4,1,2,0,2
8308_0,,,,2,2,1,3
C(CC1(COC(C=O)(CC1)O)O)=O,,,4,1,2,0,2
8310_0,,,,2,2,1,3
C(C1(CC(C(CO1)=O)C(C)O)O)=O,,,4,1,2,0,2
8312_0,,,,2,2,1,3
C1(C(C(C)O)OC(C=O)(CC1)O)=O,,,4,1,3,0,3
8312_1,,,,2,2,1,3
8314_0,,,,2,2,1,3
C(CC(C1C(CCC(O1)O)=O)O)=O,,,4,1,2,0,2
8316_0,,,,2,2,1,3
C(CC1(CCC(OC1C=O)O)O)=O,,,4,1,2,0,2
8318_0,,,,2,2,1,3
C(C1C(C(C(C)O)CC(O1)O)=O)=O,,,4,1,2,0,2
8320_0,,,,2,2,1,3
C(CC(C1CC(CC(O)O1)=O)O)=O,,,4,1,2,0,2
8322_0,,,,2,2,1,3
C(CC1(CC(C=O)OC(C1)O)O)=O,,,4,1,2,0,2
8324_0,,,,2,2,1,3
C1(C(C(C)O)C(C=O)OC(C1)O)=O,,,4,1,3,0,3
8324_1,,,,2,2,1,3
8326_0,,,,2,2,1,3
C1(CC(C=O)OC(C1C(C)O)O)=O,,,4,1,3,0,3
8326_1,,,,2,2,1,3
8328_0,,,,2,2,1,3
C(CC1(C(CO)=CC(C1O)O)O)=O,,,4,1,1,0,1
8330_0,,,,2,2,1,3
C(CC1(C(C(C(C1O)O)O)=C)O)=O,,,4,1,1,0,1
8332_0,,,,2,2,1,3
C(CC(C1C(C(C(C=1)O)O)O)O)=O,,,4,1,1,0,1
8334_0,,,,2,2,1,3
C(CC(C(C(C(C=C)O)O)O)O)=O,,,4,1,1,0,1
8336_0,,,,2,2,1,3
C(CC(C1(C=CC(C1O)O)O)O)=O,,,4,1,1,0,1
8338_0,,,,2,2,1,3
C(CC1(C=COC1C(CO)O)O)=O,,,4,1,1,0,1
8340_0,,,,2,2,1,3
C(CC1(C=CC(CO)OC1O)O)=O,,,4,1,1,0,1
8342_0,,,,2,2,1,3
C(CC1(C=COC(CO)C1O)O)=O,,,4,1,1,0,1
8344_0,,,,2,2,1,3
C(CC1(C=CC(O)OC1CO)O)=O,,,4,1,1,0,1
8346_0,,,,2,2,1,3
C(CC1(C=CC(COC1O)O)O)=O,,,4,1,1,0,1
8348_0,,,,2,2,1,3
C(CC1(C=COCC(C1O)O)O)=O,,,4,1,1,0,1
8350_0,,,,2,2,1,3
C(CC1(C=CCOC(C1O)O)O)=O,,,4,1,1,0,1
8352_0,,,,2,2,1,3
C(CC1(C=CC(O)OCC1O)O)=O,,,4,1,1,0,1
8354_0,,,,2,2,1,3
C(CC1(C=CC(C(O)OC1)O)O)=O,,,4,1,1,0,1
8356_0,,,,2,2,1,3
C1C(C(OC(C(C=1)=O)C(C)O)O)O,,,4,1,2,0,2
8356_1,,,,2,2,1,3
8358_0,,,,2,2,1,3
C(CC(C1OC(CO)C(C=1)O)O)=O,,,4,1,1,0,1
8360_0,,,,2,2,1,3
C(CC(C1(C=CC(CO)O1)O)O)=O,,,4,1,1,0,1
8362_0,,,,2,2,1,3
C(CC(C=C1C(C(CO1)O)O)O)=O,,,4,1,1,0,1
8364_0,,,,2,2,1,3
C(CC(C(C1OCC(C=1)O)O)O)=O,,,4,1,1,0,1
8366_0,,,,2,2,1,3
C(CC(C(C1(C=CCO1)O)O)O)=O,,,4,1,1,0,1
8368_0,,,,2,2,1,3
C(CC(C1C=CC(CO)(O1)O)O)=O,,,4,1,1,0,1
8370_0,,,,2,2,1,3
C(CC(C1C(C=C(CO)O1)O)O)=O,,,4,1,1,0,1
8372_0,,,,2,2,1,3
C(CC(C1C(C(C(O1)=C)O)O)O)=O,,,4,1,1,0,1
8374_0,,,,2,2,1,3
C(CC(C(C1C=CC(O1)O)O)O)=O,,,4,1,1,0,1
8376_0,,,,2,2,1,3
C(CC(C(C1C(C=CO1)O)O)O)=O,,,4,1,1,0,1
8378_0,,,,2,2,1,3
C(CC(C1OCC(C(C=1)O)O)O)=O,,,4,1,1,0,1
8380_0,,,,2,2,1,3
C(CC(C1(C=CC(CO1)O)O)O)=O,,,4,1,1,0,1
8382_0,,,,2,2,1,3
C(CC(C1C(C=CC(O)O1)O)O)=O,,,4,1,1,0,1
8384_0,,,,2,2,1,3
C(CC(C1C(C(C=CO1)O)O)O)=O,,,4,1,1,0,1
8385_0,,,,2,2,1,3
8385_1,,,,2,2,1,3
8386_0,,,,2,2,1,3
8386_1,,,,2,2,1,3
8387_0,,,,2,2,1,3
8387_1,,,,2,2,1,3
8389_0,,,,2,2,1,3
C(C(C=O)C(CO)(C(CO)O)O)=O,,,4,1,2,0,2
8389_1,,,,2,2,1,3
8391_0,,,,2,2,1,3
C(C(C(C(CO)O)=O)O)(O)=O,,,4,1,2,0,2
8391_1,,,,2,2,1,3
8393_0,,,,2,2,1,3
C(C(C(C(O)=O)O)O)(C(CO)O)=O,,,4,1,4,0,4
8393_1,,,,2,2,1,3
8395_0,,,,2,2,1,3
C(C(C(C(C)O)O)O)(C(CO)O)=O,,,4,1,2,0,2
8395_1,,,,2,2,1,3
8397_0,,,,2,2,1,3
C(C(C(CCO)=O)C(C=O)=O)(O)=O,,,4,1,2,0,2
8397_1,,,,2,2,1,3
8399_0,,,,2,2,1,3
C(C(C(CC(C=O)=O)=O)CO)(O)=O,,,4,1,2,0,2
8399_1,,,,2,2,1,3
8401_0,,,,2,2,1,3
C(C(C(C=O)=O)CC(CO)=O)(O)=O,,,4,1,1,0,1
8403_0,,,,2,2,1,3
C(C(C(CO)=O)CC(C=O)=O)(O)=O,,,4,1,1,0,1
8405_0,,,,2,2,1,3
C(C(C(CCC(C=O)=O)=O)O)(O)=O,,,4,1,2,0,2
8405_1,,,,2,2,1,3
8407_0,,,,2,2,1,3
C(C(C(C=O)=O)C(C(C)=O)O)(O)=O,,,4,1,2,0,2
8407_1,,,,2,2,1,3
8409_0,,,,2,2,1,3
C(CC(C(CC(C=O)=O)O)=O)(O)=O,,,4,1,1,0,1
8411_0,,,,2,2,1,3
C(C(C(C=O)=O)C(CC=O)O)(O)=O,,,4,1,2,0,2
8411_1,,,,2,2,1,3
8413_0,,,,2,2,1,3
C(C(C=O)C(CC(C=O)=O)O)(O)=O,,,4,1,2,0,2
8413_1,,,,2,2,1,3
8415_0,,,,2,2,1,3
C(C(C=O)C(C(CCO)=O)=O)(O)=O,,,4,1,2,0,2
8415_1,,,,2,2,1,3
8417_0,,,,2,2,1,3
C(C(C(C(CC=O)=O)=O)CO)(O)=O,,,4,1,2,0,2
8417_1,,,,2,2,1,3
8419_0,,,,2,2,1,3
C(C(C=O)C(CC(CO)=O)=O)(O)=O,,,4,1,2,0,2
8419_1,,,,2,2,1,3
8421_0,,,,2,2,1,3
C(C(C(CC=O)=O)C(CO)=O)(O)=O,,,4,1,2,0,2
8421_1,,,,2,2,1,3
8423_0,,,,2,2,1,3
C(C(C(CC(CC=O)=O)=O)O)(O)=O,,,4,1,2,0,2
8423_1,,,,2,2,1,3
8425_0,,,,2,2,1,3
C(C(C=O)C(C(C(C)=O)O)=O)(O)=O,,,4,1,2,0,2
8425_1,,,,2,2,1,3
8427_0,,,,2,2,1,3
C(CC(C(C(CC=O)=O)O)=O)(O)=O,,,4,1,1,0,1
8429_0,,,,2,2,1,3
C(C(C=O)C(C(CC=O)O)=O)(O)=O,,,4,1,2,0,2
8429_1,,,,2,2,1,3
8431_0,,,,2,2,1,3
C(C(C=O)C(C(CC=O)=O)O)(O)=O,,,4,1,2,0,2
8431_1,,,,2,2,1,3
8433_0,,,,2,2,1,3
C(C(C(C(C=O)O)=O)C(C)=O)(O)=O,,,4,1,2,0,2
8433_1,,,,2,2,1,3
8435_0,,,,2,2,1,3
C(CC(CC(C(C=O)O)=O)=O)(O)=O,,,4,1,1,0,1
8437_0,,,,2,2,1,3
C(C(C(C(C=O)O)=O)CC=O)(O)=O,,,4,1,1,0,1
8439_0,,,,2,2,1,3
C(C(C=O)CC(C(C=O)O)=O)(O)=O,,,4,1,1,0,1
8441_0,,,,2,2,1,3
C(C(C(C(C)=O)=O)C(C=O)O)(O)=O,,,4,1,2,0,2
8441_1,,,,2,2,1,3
8443_0,,,,2,2,1,3
C(CC(C(CC(C=O)O)=O)=O)(O)=O,,,4,1,1,0,1
8445_0,,,,2,2,1,3
C(C(C(CC=O)=O)C(C=O)O)(O)=O,,,4,1,2,0,2
8445_1,,,,2,2,1,3
8447_0,,,,2,2,1,3
C(C(C=O)C(CC(C=O)O)=O)(O)=O,,,4,1,2,0,2
8447_1,,,,2,2,1,3
8449_0,,,,2,2,1,3
C(C(C(C=CC(C=O)O)=O)O)(O)=O,,,4,1,2,0,2
8449_1,,,,2,2,1,3
8451_0,,,,2,2,1,3
C(C1(CC(C(C1)O)O)O)(O)=O,,,4,1,1,0,1
8453_0,,,,2,2,1,3
C(C(CC(CO)(CO)O)O)(O)=O,,,4,1,2,0,2
8453_1,,,,2,2,1,3
8455_0,,,,2,2,1,3
C(C(C)(CC(C(O)=O)O)O)=O,,,4,1,2,0,2
8455_1,,,,2,2,1,3
8456_0,,,,2,2,1,3
8456_1,,,,2,2,1,3
8457_0,,,,2,2,1,3
8457_1,,,,2,2,1,3
8458_0,,,,2,2,1,3
8458_1,,,,2,2,1,3
8460_0,,,,2,2,1,3
C(C(CC(C)(C(C=O)O)O)O)(O)=O,,,4,1,2,0,2
8460_1,,,,2,2,1,3
8462_0,,,,2,2,1,3
C(C(CC(C=O)O)O)(O)=O,,,4,1,4,0,4
8462_1,,,,2,2,1,3
8464_0,,,,2,2,1,3
C(C(CC(C)(C(CO)O)O)O)(O)=O,,,4,1,2,0,2
8464_1,,,,2,2,1,3
8465_0,,,,2,2,1,3
8465_1,,,,2,2,1,3
8467_0,,,,2,2,1,3
C(C(CC(C(O)=O)O)(CCO)O)=O,,,4,1,2,0,2
8467_1,,,,2,2,1,3
8469_0,,,,2,2,1,3
C(C(C(CO)C(C(C)=O)O)O)(O)=O,,,4,1,2,0,2
8469_1,,,,2,2,1,3
8471_0,,,,2,2,1,3
C(C(C)(C(CO)C(C(O)=O)O)O)=O,,,4,1,2,0,2
8471_1,,,,2,2,1,3
8473_0,,,,2,2,1,3
C(C(CC(CO)(CCO)O)O)(O)=O,,,4,1,2,0,2
8473_1,,,,2,2,1,3
8474_0,,,,2,2,1,3
8474_1,,,,2,2,1,3
8476_0,,,,2,2,1,3
C(C(CC(CO)(C)O)O)(O)=O,,,4,1,2,0,2
8476_1,,,,2,2,1,3
8478_0,,,,2,2,1,3
C(CC(C(CC(C(O)=O)O)O)O)=O,,,4,1,2,0,2
8478_1,,,,2,2,1,3
8480_0,,,,2,2,1,3
C(C(CC(CC(C=O)O)O)O)(O)=O,,,4,1,2,0,2
8480_1,,,,2,2,1,3
8482_0,,,,2,2,1,3
C(C(CC(C)O)O)(O)=O,,,4,1,2,0,2
8482_1,,,,2,2,1,3
8484_0,,,,2,2,1,3
C(C(C(CO)C(C=O)O)O)(O)=O,,,4,1,2,0,2
8484_1,,,,2,2,1,3
8486_0,,,,2,2,1,3
C(C(C(CO)CO)O)(O)=O,,,4,1,2,0,2
8486_1,,,,2,2,1,3
8487_0,,,,2,2,1,3
8487_1,,,,2,2,1,3
8488_0,,,,2,2,1,3
8488_1,,,,2,2,1,3
8490_0,,,,2,2,1,3
C(C(C(CO)CC(CO)=O)O)(O)=O,,,4,1,3,0,3
8490_1,,,,2,2,1,3
8491_0,,,,2,2,1,3
8491_1,,,,2,2,1,3
8492_0,,,,2,2,1,3
8492_1,,,,2,2,1,3
8494_0,,,,2,2,1,3
C(CC(C(CO)C(C(O)=O)O)O)=O,,,4,1,2,0,2
8494_1,,,,2,2,1,3
8495_0,,,,2,2,1,3
8495_1,,,,2,2,1,3
8496_0,,,,2,2,1,3
8498_0,,,,2,2,1,3
C(C(C(CO)CO)(CC=O)O)(O)=O,,,4,1,1,0,1
8500_0,,,,2,2,1,3
C(C(C)(C(CO)C(C=O)O)O)(O)=O,,,4,1,1,0,1
8502_0,,,,2,2,1,3
C(C(CC(C=O)O)(CCO)O)(O)=O,,,4,1,1,0,1
8504_0,,,,2,2,1,3
C(C(C(CO)C(CO)(C)O)O)(O)=O,,,4,1,2,0,2
8504_1,,,,2,2,1,3
8506_0,,,,2,2,1,3
C(C(C(CO)C(C)O)O)(O)=O,,,4,1,2,0,2
8506_1,,,,2,2,1,3
8508_0,,,,2,2,1,3
C(C(CC(CO)O)O)(O)=O,,,4,1,3,0,3
8508_1,,,,2,2,1,3
8510_0,,,,2,2,1,3
C(C(C(CO)C(CO)O)O)(O)=O,,,4,1,2,0,2
8510_1,,,,2,2,1,3
8511_0,,,,2,2,1,3
8511_1,,,,2,2,1,3
8512_0,,,,2,2,1,3
8512_1,,,,2,2,1,3
8514_0,,,,2,2,1,3
C(C(C=O)(CC(CO)O)O)(O)=O,,,4,1,1,0,1
8515_0,,,,2,2,1,3
8515_1,,,,2,2,1,3
8516_0,,,,2,2,1,3
8516_1,,,,2,2,1,3
8517_0,,,,2,2,1,3
8517_1,,,,2,2,1,3
8518_0,,,,2,2,1,3
8518_1,,,,2,2,1,3
8519_0,,,,2,2,1,3
8519_1,,,,2,2,1,3
8520_0,,,,2,2,1,3
8520_1,,,,2,2,1,3
8522_0,,,,2,2,1,3
C(C(CO)(C)O)(O)=O,,,4,1,2,0,2
8523_0,,,,2,2,1,3
8523_1,,,,2,2,1,3
8525_0,,,,2,2,1,3
C(C(CC(C)=O)O)(O)=O,,,4,1,3,0,3
8525_1,,,,2,2,1,3
8526_0,,,,2,2,1,3
8526_1,,,,2,2,1,3
8527_0,,,,2,2,1,3
8529_0,,,,2,2,1,3
C(C(C)(C)O)(O)=O,,,4,1,1,0,1
8531_0,,,,2,2,1,3
C(C(C=C)O)(O)=O,,,4,1,4,0,4
8531_1,,,,2,2,1,3
8533_0,,,,2,2,1,3
C(C(C(CO)O)(CCO)O)(O)=O,,,4,1,3,0,3
8535_0,,,,2,2,1,3
C(C(CO)(C(CCO)O)O)(O)=O,,,4,1,3,0,3
8536_0,,,,2,2,1,3
8536_1,,,,2,2,1,3
8538_0,,,,2,2,1,3
C(C(CCC(C=O)O)O)(O)=O,,,4,1,3,0,3
8538_1,,,,2,2,1,3
8540_0,,,,2,2,1,3
C(CC(C(O)=O)O)(C(C)O)=O,,,4,1,3,0,3
8540_1,,,,2,2,1,3
8542_0,,,,2,2,1,3
C(C(C)(C(CC=O)O)O)(O)=O,,,4,1,2,0,2
8544_0,,,,2,2,1,3
C(C(C(C)O)(CC=O)O)(O)=O,,,4,1,4,0,4
8546_0,,,,2,2,1,3
C(C(CO)(CC(C)=O)O)(O)=O,,,4,1,2,0,2
8548_0,,,,2,2,1,3
C(C(C(CC(C)=O)O)O)(O)=O,,,4,1,4,0,4
8548_1,,,,2,2,1,3
8550_0,,,,2,2,1,3
C(C(CO)(CCC=O)O)(O)=O,,,4,1,2,0,2
8552_0,,,,2,2,1,3
C(CCC(C(C(O)=O)O)O)=O,,,4,1,3,0,3
8552_1,,,,2,2,1,3
8553_0,,,,2,2,1,3
8555_0,,,,2,2,1,3
C(C(C=CCO)(CO)O)(O)=O,,,4,1,2,0,2
8557_0,,,,2,2,1,3
C(C(C(C=CCO)O)O)(O)=O,,,4,1,6,0,6
8557_1,,,,2,2,1,3
8559_0,,,,2,2,1,3
C(C(CC(CCO)O)O)(O)=O,,,4,1,3,0,3
8559_1,,,,2,2,1,3
8561_0,,,,2,2,1,3
C(C(CCO)(CCO)O)(O)=O,,,4,1,2,0,2
8563_0,,,,2,2,1,3
C(C(C)(CC(CO)O)O)(O)=O,,,4,1,2,0,2
8565_0,,,,2,2,1,3
C(CC(CC(C(O)=O)O)O)(O)=O,,,4,1,3,0,3
8565_1,,,,2,2,1,3
8567_0,,,,2,2,1,3
C(C(CCO)(CC(O)=O)O)(O)=O,,,4,1,2,0,2
8569_0,,,,2,2,1,3
C(C(C)(CC(C(O)=O)O)O)(O)=O,,,4,1,2,0,2
8571_0,,,,2,2,1,3
C(C(CC(C(C)=O)(CO)O)O)(O)=O,,,4,1,3,0,3
8571_1,,,,2,2,1,3
8573_0,,,,2,2,1,3
C(C(C)(CC(C=O)(CO)O)O)(O)=O,,,4,1,2,0,2
8575_0,,,,2,2,1,3
C(C(C)(C(C(CO)O)O)O)(O)=O,,,4,1,2,0,2
8577_0,,,,2,2,1,3
C(C1(COC(CO)C1)O)(O)=O,,,4,1,1,0,1
8579_0,,,,2,2,1,3
C(C1(COCC(C1)O)O)(O)=O,,,4,1,1,0,1
8581_0,,,,2,2,1,3
C(C1(CC(O)OCC1)O)(O)=O,,,4,1,2,0,2
8583_0,,,,2,2,1,3
C(C(C=CC(C)=O)O)(O)=O,,,4,1,4,0,4
8583_1,,,,2,2,1,3
8585_0,,,,2,2,1,3
C(C(C=CCC=O)O)(O)=O,,,4,1,4,0,4
8585_1,,,,2,2,1,3
8587_0,,,,2,2,1,3
C(C(C=CC=O)(C)O)(O)=O,,,4,1,2,0,2
8589_0,,,,2,2,1,3
C(C(CC(C=C)=O)O)(O)=O,,,4,1,3,0,3
8589_1,,,,2,2,1,3
8591_0,,,,2,2,1,3
C(C(C=C)(CC=O)O)(O)=O,,,4,1,2,0,2
8593_0,,,,2,2,1,3
C(C(CC=CC=O)O)(O)=O,,,4,1,3,0,3
8593_1,,,,2,2,1,3
8595_0,,,,2,2,1,3
C(C(C1CC(CO1)O)O)(O)=O,,,4,1,2,0,2
8595_1,,,,2,2,1,3
8596_0,,,,2,1,2,3
8597_0,,,,2,1,2,3
8598_0,,,,2,1,2,3
8599_0,,,,2,1,2,3
8600_0,,,,2,1,2,3
8601_0,,,,2,1,2,3
8602_0,,,,2,1,2,3
8603_0,,,,2,1,2,3
8604_0,,,,2,1,2,3
8605_0,,,,2,1,2,3
8606_0,,,,2,1,2,3
8608_0,,,,2,1,2,3
C(C(C(C)=O)=O)=O,,,4,1,10,0,10
8610_0,,,,2,1,2,3
C(CO)(CC(C=O)=O)=O,,,4,1,8,0,8
8612_0,,,,2,1,2,3
C(C)(C(C(C=O)=O)O)=O,,,4,1,5,0,5
8614_0,,,,2,1,2,3
C(C(C=O)=O)=O,,,4,1,15,0,15
8616_0,,,,2,1,2,3
C(C(C(C=O)=O)O)=O,,,4,1,10,0,10
8617_0,,,,2,1,2,3
8619_0,,,,2,1,2,3
C(C(C(C(CCO)O)=O)=O)=O,,,4,1,2,0,2
8621_0,,,,2,1,2,3
C(C(CC(C(C=O)=O)O)O)=O,,,4,1,3,0,3
8623_0,,,,2,1,2,3
C(C(C)O)(C(C(C=O)=O)O)=O,,,4,1,2,0,2
8624_0,,,,2,1,2,3
8625_0,,,,2,1,2,3
8626_0,,,,2,1,2,3
8627_0,,,,2,1,2,3
8629_0,,,,2,1,2,3
C(CC(C(C(C=O)=O)O)O)(O)=O,,,4,1,2,0,2
8631_0,,,,2,1,2,3
C1(C(C(CC(C1O)O)O)=O)=O,,,4,1,1,0,1
8633_0,,,,2,1,2,3
C(C(C(CO)O)=O)(C(CO)O)=O,,,4,1,1,0,1
8635_0,,,,2,1,2,3
C(C)(CC(C(C=O)=O)=O)=O,,,4,1,3,0,3
8637_0,,,,2,1,2,3
C(CCC(C(C=O)=O)=O)=O,,,4,1,3,0,3
8639_0,,,,2,1,2,3
C(C(CC(C(C)=O)=O)=O)=O,,,4,1,3,0,3
8641_0,,,,2,1,2,3
C(CC(CC(C=O)=O)=O)=O,,,4,1,5,0,5
8643_0,,,,2,1,2,3
C(CO)=CC(C(C=O)=O)=O,,,4,1,2,0,2
8645_0,,,,2,1,2,3
C=CC(C(C(C=O)=O)O)=O,,,4,1,2,0,2
8647_0,,,,2,1,2,3
C(C(C=CC(CO)=O)=O)=O,,,4,1,6,0,6
8649_0,,,,2,1,2,3
C(C(C(C=O)=O)O)=CC=O,,,4,1,2,0,2
8650_0,,,,2,1,2,3
8652_0,,,,2,1,2,3
C(C(C1(CC(CO1)O)O)=O)=O,,,4,1,2,0,2
8654_0,,,,2,1,2,3
C(C(C1C(CC(O1)O)O)=O)=O,,,4,1,2,0,2
8655_0,,,,2,1,2,3
8657_0,,,,2,1,2,3
C(C(C(C(C(CO)O)=O)=O)O)=O,,,4,1,1,0,1
8659_0,,,,2,1,2,3
C(C(CO)=O)(C(CO)O)=O,,,4,1,2,0,2
8661_0,,,,2,1,2,3
C(C(C(C)O)=O)(C(CO)O)=O,,,4,1,4,0,4
8663_0,,,,2,1,2,3
C(C(C(CO)(CO)O)=O)=O,,,4,1,5,0,5
8664_0,,,,2,1,2,3
8666_0,,,,2,1,2,3
C(C(C(C=O)=O)(C)O)=O,,,4,1,4,0,4
8668_0,,,,2,1,2,3
C(CC(C(C=O)=O)(CO)O)=O,,,4,1,1,0,1
8670_0,,,,2,1,2,3
C(C(C(C(C=O)=O)(C)O)O)=O,,,4,1,2,0,2
8672_0,,,,2,1,2,3
C(C(C(C)(C(CO)O)O)=O)=O,,,4,1,2,0,2
8674_0,,,,2,1,2,3
C(C(C(C=O)=O)(CCO)O)=O,,,4,1,1,0,1
8676_0,,,,2,1,2,3
C(C(C(CO)(CCO)O)=O)=O,,,4,1,1,0,1
8677_0,,,,2,1,2,3
8679_0,,,,2,1,2,3
C(C(C(CO)(C)O)=O)=O,,,4,1,7,0,7
8680_0,,,,2,1,2,3
8681_0,,,,2,1,2,3
8683_0,,,,2,1,2,3
C(C(C(CO)(C(CO)O)O)=O)=O,,,4,1,3,0,3
8684_0,,,,2,1,1,2
8685_0,,,,2,1,1,2
8685_1,,,,2,1,1,2
8686_0,,,,2,1,1,2
8686_1,,,,2,1,1,2
8687_0,,,,2,1,1,2
8688_0,,,,2,1,1,2
8688_1,,,,2,1,1,2
8689_0,,,,2,1,1,2
8689_1,,,,2,1,1,2
8690_0,,,,2,1,1,2
8690_1,,,,2,1,1,2
8691_0,,,,2,1,1,2
8692_0,,,,2,1,1,2
8692_1,,,,2,1,1,2
8693_0,,,,2,1,1,2
8693_1,,,,2,1,1,2
8694_0,,,,2,1,1,2
8694_1,,,,2,1,1,2
8695_0,,,,2,1,1,2
8695_1,,,,2,1,1,2
8696_0,,,,2,1,2,3
8696_1,,,,2,1,2,3
8697_0,,,,2,1,1,2
8697_1,,,,2,1,1,2
8698_0,,,,2,1,1,2
8698_1,,,,2,1,1,2
8699_0,,,,2,1,1,2
8699_1,,,,2,1,1,2
8700_0,,,,2,1,1,2
8701_0,,,,2,1,1,2
8702_0,,,,2,1,1,2
8703_0,,,,2,1,1,2
8703_1,,,,2,1,1,2
8704_0,,,,2,1,1,2
8704_1,,,,2,1,1,2
8705_0,,,,2,1,1,2
8706_0,,,,2,1,1,2
8706_1,,,,2,1,1,2
8707_0,,,,2,1,2,3
8707_1,,,,2,1,2,3
8708_0,,,,2,1,1,2
8709_0,,,,2,1,1,2
8709_1,,,,2,1,1,2
8710_0,,,,2,1,1,2
8711_0,,,,2,1,1,2
8711_1,,,,2,1,1,2
8713_0,,,,2,1,1,2
C(C(C=O)CC(CO)=O)=O,,,4,1,3,0,3
8713_1,,,,2,1,1,2
8714_0,,,,2,1,1,2
8715_0,,,,2,1,1,2
8716_0,,,,2,1,1,2
8717_0,,,,2,1,1,2
8717_1,,,,2,1,1,2
8718_0,,,,2,1,1,2
8718_1,,,,2,1,1,2
8719_0,,,,2,1,1,2
8719_1,,,,2,1,1,2
8720_0,,,,2,1,2,3
8720_1,,,,2,1,2,3
8721_0,,,,2,1,1,2
8721_1,,,,2,1,1,2
8722_0,,,,2,1,2,3
8722_1,,,,2,1,2,3
8723_0,,,,2,1,2,3
8723_1,,,,2,1,2,3
8724_0,,,,2,1,2,3
8724_1,,,,2,1,2,3
8725_0,,,,2,1,2,3
8726_0,,,,2,1,2,3
8726_1,,,,2,1,2,3
8727_0,,,,2,1,2,3
8728_0,,,,2,1,2,3
8728_1,,,,2,1,2,3
8730_0,,,,2,1,2,3
C(CO)(C(C(CO)=O)O)=O,,,4,1,2,0,2
8731_0,,,,2,1,2,3
8731_1,,,,2,1,2,3
8732_0,,,,2,1,2,3
8732_1,,,,2,1,2,3
8733_0,,,,2,1,2,3
8733_1,,,,2,1,2,3
8734_0,,,,2,1,2,3
8734_1,,,,2,1,2,3
8735_0,,,,2,1,2,3
8735_1,,,,2,1,2,3
8736_0,,,,2,1,2,3
8736_1,,,,2,1,2,3
8737_0,,,,2,1,2,3
8738_0,,,,2,1,2,3
8738_1,,,,2,1,2,3
8739_0,,,,2,1,2,3
8739_1,,,,2,1,2,3
8740_0,,,,2,1,2,3
8740_1,,,,2,1,2,3
8741_0,,,,2,1,2,3
8742_0,,,,2,1,2,3
8742_1,,,,2,1,2,3
8743_0,,,,2,1,2,3
8743_1,,,,2,1,2,3
8744_0,,,,2,1,2,3
8744_1,,,,2,1,2,3
8745_0,,,,2,1,2,3
8746_0,,,,2,1,2,3
8746_1,,,,2,1,2,3
8747_0,,,,2,1,2,3
8747_1,,,,2,1,2,3
8748_0,,,,2,1,2,3
8748_1,,,,2,1,2,3
8749_0,,,,2,1,2,3
8749_1,,,,2,1,2,3
8750_0,,,,2,1,2,3
8750_1,,,,2,1,2,3
8751_0,,,,2,1,2,3
8751_1,,,,2,1,2,3
8752_0,,,,2,1,2,3
8753_0,,,,2,1,2,3
8753_1,,,,2,1,2,3
8754_0,,,,2,1,2,3
8754_1,,,,2,1,2,3
8755_0,,,,2,1,2,3
8755_1,,,,2,1,2,3
8756_0,,,,2,1,2,3
8756_1,,,,2,1,2,3
8757_0,,,,2,1,2,3
8757_1,,,,2,1,2,3
8758_0,,,,2,1,2,3
8759_0,,,,2,1,2,3
8759_1,,,,2,1,2,3
8760_0,,,,2,1,2,3
8760_1,,,,2,1,2,3
8761_0,,,,2,1,2,3
8762_0,,,,2,1,2,3
8762_1,,,,2,1,2,3
8763_0,,,,2,1,2,3
8763_1,,,,2,1,2,3
8764_0,,,,2,1,2,3
8764_1,,,,2,1,2,3
8765_0,,,,2,1,2,3
8765_1,,,,2,1,2,3
8766_0,,,,2,1,2,3
8767_0,,,,2,1,2,3
8767_1,,,,2,1,2,3
8768_0,,,,2,1,2,3
8768_1,,,,2,1,2,3
8769_0,,,,2,1,2,3
8770_0,,,,2,1,2,3
8771_0,,,,2,1,2,3
8771_1,,,,2,1,2,3
8772_0,,,,2,1,2,3
8772_1,,,,2,1,2,3
8773_0,,,,2,1,2,3
8773_1,,,,2,1,2,3
8774_0,,,,2,1,2,3
8774_1,,,,2,1,2,3
8775_0,,,,2,1,2,3
8776_0,,,,2,1,2,3
8776_1,,,,2,1,2,3
8777_0,,,,2,1,2,3
8777_1,,,,2,1,2,3
8778_0,,,,2,1,2,3
8778_1,,,,2,1,2,3
8779_0,,,,2,1,2,3
8779_1,,,,2,1,2,3
8780_0,,,,2,1,2,3
8781_0,,,,2,1,2,3
8782_0,,,,2,1,2,3
8783_0,,,,2,1,2,3
8784_0,,,,2,1,2,3
8785_0,,,,2,1,2,3
8786_0,,,,2,1,2,3
8786_1,,,,2,1,2,3
8787_0,,,,2,1,2,3
8787_1,,,,2,1,2,3
8788_0,,,,2,1,2,3
8788_1,,,,2,1,2,3
8789_0,,,,2,1,2,3
8789_1,,,,2,1,2,3
8790_0,,,,2,1,2,3
8790_1,,,,2,1,2,3
8791_0,,,,2,1,2,3
8791_1,,,,2,1,2,3
8792_0,,,,2,1,2,3
8793_0,,,,2,1,2,3
8793_1,,,,2,1,2,3
8794_0,,,,2,1,2,3
8795_0,,,,2,1,2,3
8795_1,,,,2,1,2,3
8796_0,,,,2,1,2,3
8797_0,,,,2,1,2,3
8798_0,,,,2,1,2,3
8799_0,,,,2,1,2,3
8800_0,,,,2,1,2,3
8801_0,,,,2,1,2,3
8801_1,,,,2,1,2,3
8802_0,,,,2,1,2,3
8803_0,,,,2,1,2,3
8803_1,,,,2,1,2,3
8804_0,,,,2,1,2,3
8805_0,,,,2,1,2,3
8806_0,,,,2,1,2,3
8807_0,,,,2,1,2,3
8807_1,,,,2,1,2,3
8808_0,,,,2,1,2,3
8808_1,,,,2,1,2,3
8809_0,,,,2,1,2,3
8809_1,,,,2,1,2,3
8810_0,,,,2,1,2,3
8810_1,,,,2,1,2,3
8811_0,,,,2,1,2,3
8812_0,,,,2,1,2,3
8812_1,,,,2,1,2,3
8813_0,,,,2,1,2,3
8813_1,,,,2,1,2,3
8814_0,,,,2,1,2,3
8815_0,,,,2,1,2,3
8815_1,,,,2,1,2,3
8816_0,,,,2,1,2,3
8816_1,,,,2,1,2,3
8817_0,,,,2,1,2,3
8818_0,,,,2,1,2,3
8818_1,,,,2,1,2,3
8819_0,,,,2,1,2,3
8819_1,,,,2,1,2,3
8820_0,,,,2,1,2,3
8820_1,,,,2,1,2,3
8821_0,,,,2,1,2,3
8821_1,,,,2,1,2,3
8822_0,,,,2,1,2,3
8823_0,,,,2,1,2,3
8823_1,,,,2,1,2,3
8824_0,,,,2,1,2,3
8825_0,,,,2,1,2,3
8826_0,,,,2,1,2,3
8827_0,,,,2,1,2,3
8827_1,,,,2,1,2,3
8828_0,,,,2,1,2,3
8828_1,,,,2,1,2,3
8829_0,,,,2,1,2,3
8829_1,,,,2,1,2,3
8830_0,,,,2,1,2,3
8831_0,,,,2,1,2,3
8832_0,,,,2,1,2,3
8833_0,,,,2,1,2,3
8833_1,,,,2,1,2,3
8834_0,,,,2,1,2,3
8834_1,,,,2,1,2,3
8835_0,,,,2,1,2,3
8835_1,,,,2,1,2,3
8836_0,,,,2,1,2,3
8836_1,,,,2,1,2,3
8837_0,,,,2,1,2,3
8838_0,,,,2,1,2,3
8838_1,,,,2,1,2,3
8839_0,,,,2,1,2,3
8840_0,,,,2,1,2,3
8841_0,,,,2,1,2,3
8842_0,,,,2,1,2,3
8843_0,,,,2,1,2,3
8843_1,,,,2,1,2,3
8844_0,,,,2,1,2,3
8844_1,,,,2,1,2,3
8845_0,,,,2,1,2,3
8845_1,,,,2,1,2,3
8846_0,,,,2,1,2,3
8846_1,,,,2,1,2,3
8847_0,,,,2,1,2,3
8847_1,,,,2,1,2,3
8848_0,,,,2,1,2,3
8848_1,,,,2,1,2,3
8849_0,,,,2,1,2,3
8849_1,,,,2,1,2,3
8850_0,,,,2,1,2,3
8850_1,,,,2,1,2,3
8851_0,,,,2,1,2,3
8851_1,,,,2,1,2,3
8852_0,,,,2,1,2,3
8852_1,,,,2,1,2,3
8853_0,,,,2,1,2,3
8853_1,,,,2,1,2,3
8854_0,,,,2,1,2,3
8854_1,,,,2,1,2,3
8856_0,,,,2,1,2,3
C(C(C=O)C(CO)=O)=O,,,4,1,3,0,3
8856_1,,,,2,1,2,3
8857_0,,,,2,1,2,3
8857_1,,,,2,1,2,3
8859_0,,,,2,1,2,3
C(CC(C(C=O)O)=O)=O,,,4,1,6,0,6
8859_1,,,,2,1,2,3
8860_0,,,,2,1,2,3
8860_1,,,,2,1,2,3
8861_0,,,,2,1,2,3
8861_1,,,,2,1,2,3
8862_0,,,,2,1,2,3
8863_0,,,,2,1,2,3
8864_0,,,,2,1,2,3
8865_0,,,,2,1,2,3
8866_0,,,,2,1,2,3
8866_1,,,,2,1,2,3
8867_0,,,,2,1,2,3
8868_0,,,,2,1,2,3
8868_1,,,,2,1,2,3
8869_0,,,,2,1,2,3
8869_1,,,,2,1,2,3
8870_0,,,,2,1,2,3
8870_1,,,,2,1,2,3
8871_0,,,,2,1,2,3
8872_0,,,,2,1,2,3
8873_0,,,,2,1,2,3
8874_0,,,,2,1,2,3
8875_0,,,,2,1,2,3
8876_0,,,,2,1,2,3
8877_0,,,,2,1,2,3
8877_1,,,,2,1,2,3
8878_0,,,,2,1,2,3
8880_0,,,,2,1,2,3
C(C)(CC(CO)=O)=O,,,4,1,16,0,16
8880_1,,,,2,1,2,3
8881_0,,,,2,1,2,3
8882_0,,,,2,1,2,3
8882_1,,,,2,1,2,3
8884_0,,,,2,1,2,3
C(C)(C(C(C)=O)O)=O,,,4,1,7,0,7
8884_1,,,,2,1,2,3
8885_0,,,,2,1,2,3
8885_1,,,,2,1,2,3
8886_0,,,,2,1,2,3
8887_0,,,,2,1,2,3
8887_1,,,,2,1,2,3
8888_0,,,,2,1,2,3
8889_0,,,,2,1,2,3
8889_1,,,,2,1,2,3
8890_0,,,,2,1,2,3
8891_0,,,,2,1,2,3
8891_1,,,,2,1,2,3
8892_0,,,,2,1,2,3
8892_1,,,,2,1,2,3
8893_0,,,,2,1,2,3
8894_0,,,,2,1,2,3
8894_1,,,,2,1,2,3
8895_0,,,,2,1,2,3
8895_1,,,,2,1,2,3
8896_0,,,,2,1,2,3
8896_1,,,,2,1,2,3
8897_0,,,,2,1,2,3
8897_1,,,,2,1,2,3
8898_0,,,,2,1,2,3
8898_1,,,,2,1,2,3
8899_0,,,,2,1,2,3
8899_1,,,,2,1,2,3
8900_0,,,,2,1,2,3
8900_1,,,,2,1,2,3
8901_0,,,,2,1,2,3
8901_1,,,,2,1,2,3
8902_0,,,,2,1,2,3
8902_1,,,,2,1,2,3
8903_0,,,,2,1,2,3
8904_0,,,,2,1,2,3
8904_1,,,,2,1,2,3
8905_0,,,,2,1,2,3
8906_0,,,,2,1,2,3
8906_1,,,,2,1,2,3
8907_0,,,,2,1,2,3
8907_1,,,,2,1,2,3
8908_0,,,,2,1,2,3
8909_0,,,,2,1,2,3
8909_1,,,,2,1,2,3
8910_0,,,,2,1,2,3
8911_0,,,,2,1,2,3
8911_1,,,,2,1,2,3
8912_0,,,,2,1,2,3
8913_0,,,,2,1,2,3
8913_1,,,,2,1,2,3
8914_0,,,,2,1,2,3
8915_0,,,,2,1,2,3
8915_1,,,,2,1,2,3
8916_0,,,,2,1,2,3
8916_1,,,,2,1,2,3
8917_0,,,,2,1,2,3
8918_0,,,,2,1,2,3
8918_1,,,,2,1,2,3
8919_0,,,,2,1,2,3
8920_0,,,,2,1,2,3
8921_0,,,,2,1,2,3
8922_0,,,,2,1,2,3
8922_1,,,,2,1,2,3
8923_0,,,,2,1,2,3
8923_1,,,,2,1,2,3
8924_0,,,,2,1,2,3
8924_1,,,,2,1,2,3
8925_0,,,,2,1,2,3
8925_1,,,,2,1,2,3
8926_0,,,,2,1,2,3
8927_0,,,,2,1,2,3
8927_1,,,,2,1,2,3
8928_0,,,,2,1,2,3
8928_1,,,,2,1,2,3
8929_0,,,,2,1,2,3
8929_1,,,,2,1,2,3
8930_0,,,,2,1,2,3
8930_1,,,,2,1,2,3
8931_0,,,,2,1,2,3
8931_1,,,,2,1,2,3
8932_0,,,,2,1,2,3
8933_0,,,,2,1,2,3
8934_0,,,,2,1,2,3
8935_0,,,,2,1,2,3
8935_1,,,,2,1,2,3
8936_0,,,,2,1,2,3
8936_1,,,,2,1,2,3
8937_0,,,,2,1,2,3
8937_1,,,,2,1,2,3
8938_0,,,,2,1,2,3
8938_1,,,,2,1,2,3
8939_0,,,,2,1,2,3
8939_1,,,,2,1,2,3
8940_0,,,,2,1,2,3
8940_1,,,,2,1,2,3
8941_0,,,,2,1,2,3
8941_1,,,,2,1,2,3
8942_0,,,,2,1,2,3
8943_0,,,,2,1,2,3
8943_1,,,,2,1,2,3
8944_0,,,,2,1,2,3
8944_1,,,,2,1,2,3
8945_0,,,,2,1,2,3
8946_0,,,,2,1,2,3
8946_1,,,,2,1,2,3
8947_0,,,,2,1,2,3
8947_1,,,,2,1,2,3
8948_0,,,,2,1,2,3
8949_0,,,,2,1,2,3
8949_1,,,,2,1,2,3
8950_0,,,,2,1,2,3
8950_1,,,,2,1,2,3
8951_0,,,,2,1,2,3
8951_1,,,,2,1,2,3
8952_0,,,,2,1,2,3
8953_0,,,,2,1,2,3
8953_1,,,,2,1,2,3
8954_0,,,,2,1,2,3
8954_1,,,,2,1,2,3
8955_0,,,,2,1,2,3
8955_1,,,,2,1,2,3
8956_0,,,,2,1,2,3
8956_1,,,,2,1,2,3
8957_0,,,,2,1,2,3
8957_1,,,,2,1,2,3
8958_0,,,,2,1,2,3
8958_1,,,,2,1,2,3
8959_0,,,,2,1,2,3
8959_1,,,,2,1,2,3
8960_0,,,,2,1,2,3
8960_1,,,,2,1,2,3
8961_0,,,,2,1,2,3
8961_1,,,,2,1,2,3
8962_0,,,,2,1,2,3
8962_1,,,,2,1,2,3
8963_0,,,,2,1,2,3
8963_1,,,,2,1,2,3
8964_0,,,,2,1,1,2
8964_1,,,,2,1,1,2
8965_0,,,,2,1,1,2
8965_1,,,,2,1,1,2
8965_2,,,,2,1,1,2
8966_0,,,,2,1,2,3
8966_1,,,,2,1,2,3
8966_2,,,,2,1,2,3
8967_0,,,,2,1,2,3
8967_1,,,,2,1,2,3
8968_0,,,,2,1,2,3
8969_0,,,,2,1,2,3
8969_1,,,,2,1,2,3
8970_0,,,,2,1,2,3
8971_0,,,,2,1,2,3
8972_0,,,,2,1,2,3
8972_1,,,,2,1,2,3
8973_0,,,,2,1,2,3
8973_1,,,,2,1,2,3
8974_0,,,,2,1,2,3
8974_1,,,,2,1,2,3
8975_0,,,,2,1,2,3
8976_0,,,,2,1,2,3
8977_0,,,,2,1,2,3
8977_1,,,,2,1,2,3
8978_0,,,,2,1,2,3
8978_1,,,,2,1,2,3
8979_0,,,,2,1,2,3
8979_1,,,,2,1,2,3
8980_0,,,,2,1,2,3
8981_0,,,,2,1,2,3
8981_1,,,,2,1,2,3
8982_0,,,,2,1,2,3
8982_1,,,,2,1,2,3
8983_0,,,,2,1,2,3
8983_1,,,,2,1,2,3
8984_0,,,,2,1,2,3
8984_1,,,,2,1,2,3
8985_0,,,,2,1,2,3
8985_1,,,,2,1,2,3
8986_0,,,,2,1,2,3
8987_0,,,,2,1,2,3
8987_1,,,,2,1,2,3
8988_0,,,,2,1,2,3
8989_0,,,,2,1,2,3
8989_1,,,,2,1,2,3
8990_0,,,,2,1,2,3
8990_1,,,,2,1,2,3
8991_0,,,,2,1,2,3
8991_1,,,,2,1,2,3
8992_0,,,,2,1,2,3
8993_0,,,,2,1,2,3
8994_0,,,,2,1,2,3
8995_0,,,,2,1,2,3
8995_1,,,,2,1,2,3
8996_0,,,,2,1,2,3
8996_1,,,,2,1,2,3
8997_0,,,,2,1,2,3
8998_0,,,,2,1,2,3
8999_0,,,,2,1,2,3
8999_1,,,,2,1,2,3
9000_0,,,,2,1,2,3
9000_1,,,,2,1,2,3
9001_0,,,,2,1,2,3
9002_0,,,,2,1,2,3
9002_1,,,,2,1,2,3
9003_0,,,,2,1,2,3
9003_1,,,,2,1,2,3
9004_0,,,,2,1,2,3
9004_1,,,,2,1,2,3
9005_0,,,,2,1,2,3
9005_1,,,,2,1,2,3
9006_0,,,,2,1,1,2
9006_1,,,,2,1,1,2
9007_0,,,,2,1,2,3
9007_1,,,,2,1,2,3
9008_0,,,,2,1,1,2
9008_1,,,,2,1,1,2
9009_0,,,,2,1,2,3
9010_0,,,,2,1,2,3
9010_1,,,,2,1,2,3
9011_0,,,,2,1,2,3
9011_1,,,,2,1,2,3
9012_0,,,,2,1,1,2
9012_1,,,,2,1,1,2
9013_0,,,,2,1,2,3
9013_1,,,,2,1,2,3
9014_0,,,,2,1,1,2
9014_1,,,,2,1,1,2
9015_0,,,,2,1,2,3
9015_1,,,,2,1,2,3
9016_0,,,,2,1,1,2
9016_1,,,,2,1,1,2
9017_0,,,,2,1,1,2
9017_1,,,,2,1,1,2
9018_0,,,,2,1,2,3
9018_1,,,,2,1,2,3
9019_0,,,,2,1,2,3
9019_1,,,,2,1,2,3
9020_0,,,,2,1,1,2
9020_1,,,,2,1,1,2
9021_0,,,,2,1,2,3
9021_1,,,,2,1,2,3
9022_0,,,,2,1,2,3
9022_1,,,,2,1,2,3
9023_0,,,,2,1,1,2
9023_1,,,,2,1,1,2
9024_0,,,,2,1,2,3
9024_1,,,,2,1,2,3
9025_0,,,,2,1,1,2
9025_1,,,,2,1,1,2
9026_0,,,,2,1,2,3
9026_1,,,,2,1,2,3
9027_0,,,,2,1,1,2
9027_1,,,,2,1,1,2
9028_0,,,,2,1,1,2
9028_1,,,,2,1,1,2
9029_0,,,,2,1,1,2
9029_1,,,,2,1,1,2
9030_0,,,,2,1,2,3
9030_1,,,,2,1,2,3
9031_0,,,,2,1,1,2
9031_1,,,,2,1,1,2
9032_0,,,,2,1,2,3
9032_1,,,,2,1,2,3
9033_0,,,,2,1,1,2
9033_1,,,,2,1,1,2
9034_0,,,,2,1,1,2
9034_1,,,,2,1,1,2
9035_0,,,,2,1,2,3
9035_1,,,,2,1,2,3
9036_0,,,,2,1,2,3
9036_1,,,,2,1,2,3
9037_0,,,,2,1,1,2
9037_1,,,,2,1,1,2
9038_0,,,,2,1,1,2
9039_0,,,,2,1,2,3
9039_1,,,,2,1,2,3
9040_0,,,,2,1,2,3
9040_1,,,,2,1,2,3
9041_0,,,,2,1,2,3
9041_1,,,,2,1,2,3
9042_0,,,,2,1,2,3
9042_1,,,,2,1,2,3
9043_0,,,,2,1,2,3
9043_1,,,,2,1,2,3
9044_0,,,,2,1,2,3
9044_1,,,,2,1,2,3
9045_0,,,,2,1,2,3
9045_1,,,,2,1,2,3
9046_0,,,,2,1,2,3
9046_1,,,,2,1,2,3
9047_0,,,,2,1,2,3
9047_1,,,,2,1,2,3
9048_0,,,,2,1,2,3
9049_0,,,,2,1,2,3
9050_0,,,,2,1,2,3
9051_0,,,,2,1,2,3
9051_1,,,,2,1,2,3
9052_0,,,,2,1,2,3
9052_1,,,,2,1,2,3
9053_0,,,,2,1,2,3
9053_1,,,,2,1,2,3
9054_0,,,,2,1,2,3
9054_1,,,,2,1,2,3
9055_0,,,,2,1,2,3
9056_0,,,,2,1,2,3
9057_0,,,,2,1,2,3
9058_0,,,,2,1,2,3
9058_1,,,,2,1,2,3
9059_0,,,,2,1,2,3
9060_0,,,,2,1,2,3
9060_1,,,,2,1,2,3
9061_0,,,,2,1,2,3
9061_1,,,,2,1,2,3
9062_0,,,,2,1,2,3
9062_1,,,,2,1,2,3
9063_0,,,,2,1,2,3
9063_1,,,,2,1,2,3
9064_0,,,,2,1,2,3
9064_1,,,,2,1,2,3
9065_0,,,,2,1,2,3
9066_0,,,,2,1,2,3
9066_1,,,,2,1,2,3
9067_0,,,,2,1,2,3
9067_1,,,,2,1,2,3
9068_0,,,,2,1,2,3
9069_0,,,,2,1,2,3
9069_1,,,,2,1,2,3
9070_0,,,,2,1,2,3
9070_1,,,,2,1,2,3
9071_0,,,,2,1,2,3
9072_0,,,,2,1,2,3
9072_1,,,,2,1,2,3
9073_0,,,,2,1,2,3
9073_1,,,,2,1,2,3
9074_0,,,,2,1,2,3
9075_0,,,,2,1,2,3
9075_1,,,,2,1,2,3
9076_0,,,,2,1,2,3
9076_1,,,,2,1,2,3
9077_0,,,,2,1,2,3
9078_0,,,,2,1,2,3
9078_1,,,,2,1,2,3
9079_0,,,,2,1,2,3
9080_0,,,,2,1,2,3
9080_1,,,,2,1,2,3
9081_0,,,,2,1,2,3
9082_0,,,,2,1,2,3
9082_1,,,,2,1,2,3
9083_0,,,,2,1,2,3
9083_1,,,,2,1,2,3
9084_0,,,,2,1,2,3
9084_1,,,,2,1,2,3
9085_0,,,,2,1,2,3
9085_1,,,,2,1,2,3
9086_0,,,,2,1,2,3
9087_0,,,,2,1,2,3
9088_0,,,,2,1,2,3
9088_1,,,,2,1,2,3
9089_0,,,,2,1,2,3
9090_0,,,,2,1,2,3
9090_1,,,,2,1,2,3
9091_0,,,,2,1,2,3
9091_1,,,,2,1,2,3
9092_0,,,,2,1,2,3
9092_1,,,,2,1,2,3
9093_0,,,,2,1,2,3
9094_0,,,,2,1,2,3
9094_1,,,,2,1,2,3
9095_0,,,,2,1,2,3
9095_1,,,,2,1,2,3
9096_0,,,,2,1,2,3
9096_1,,,,2,1,2,3
9097_0,,,,2,1,2,3
9098_0,,,,2,1,2,3
9098_1,,,,2,1,2,3
9099_0,,,,2,1,2,3
9100_0,,,,2,1,2,3
9101_0,,,,2,1,2,3
9101_1,,,,2,1,2,3
9102_0,,,,2,1,2,3
9102_1,,,,2,1,2,3
9103_0,,,,2,1,2,3
9103_1,,,,2,1,2,3
9104_0,,,,2,1,2,3
9104_1,,,,2,1,2,3
9105_0,,,,2,1,2,3
9105_1,,,,2,1,2,3
9106_0,,,,2,1,2,3
9107_0,,,,2,1,2,3
9108_0,,,,2,1,2,3
9109_0,,,,2,1,2,3
9110_0,,,,2,1,2,3
9110_1,,,,2,1,2,3
9111_0,,,,2,1,2,3
9111_1,,,,2,1,2,3
9112_0,,,,2,1,2,3
9113_0,,,,2,1,2,3
9114_0,,,,2,1,2,3
9116_0,,,,2,1,2,3
C(C)(CCO)=O,,,4,1,4,0,4
9117_0,,,,2,1,2,3
9118_0,,,,2,1,2,3
9119_0,,,,2,1,2,3
9120_0,,,,2,1,2,3
9120_1,,,,2,1,2,3
9121_0,,,,2,1,2,3
9122_0,,,,2,1,2,3
9122_1,,,,2,1,2,3
9123_0,,,,2,1,2,3
9123_1,,,,2,1,2,3
9124_0,,,,2,1,2,3
9125_0,,,,2,1,2,3
9126_0,,,,2,1,2,3
9127_0,,,,2,1,2,3
9128_0,,,,2,1,2,3
9129_0,,,,2,1,2,3
9129_1,,,,2,1,2,3
9130_0,,,,2,1,2,3
9131_0,,,,2,1,2,3
9132_0,,,,2,1,2,3
9133_0,,,,2,1,2,3
9134_0,,,,2,1,2,3
9135_0,,,,2,1,2,3
9135_1,,,,2,1,2,3
9136_0,,,,2,1,2,3
9136_1,,,,2,1,2,3
9137_0,,,,2,1,2,3
9138_0,,,,2,1,2,3
9139_0,,,,2,1,2,3
9140_0,,,,2,1,2,3
9141_0,,,,2,1,2,3
9142_0,,,,2,1,2,3
9143_0,,,,2,1,2,3
9144_0,,,,2,1,2,3
9145_0,,,,2,1,2,3
9146_0,,,,2,1,2,3
9146_1,,,,2,1,2,3
9147_0,,,,2,1,2,3
9147_1,,,,2,1,2,3
9148_0,,,,2,1,2,3
9149_0,,,,2,1,2,3
9150_0,,,,2,1,2,3
9150_1,,,,2,1,2,3
9151_0,,,,2,1,2,3
9151_1,,,,2,1,2,3
9152_0,,,,2,1,2,3
9153_0,,,,2,1,2,3
9154_0,,,,2,1,2,3
9155_0,,,,2,1,2,3
9156_0,,,,2,1,2,3
9157_0,,,,2,1,2,3
9158_0,,,,2,1,2,3
9158_1,,,,2,1,2,3
9159_0,,,,2,1,2,3
9160_0,,,,2,1,2,3
9160_1,,,,2,1,2,3
9161_0,,,,2,1,2,3
9161_1,,,,2,1,2,3
9162_0,,,,2,1,2,3
9163_0,,,,2,1,2,3
9164_0,,,,2,1,2,3
9166_0,,,,2,1,2,3
C(CC(CC=O)=O)=O,,,4,1,5,0,5
9167_0,,,,2,1,2,3
9168_0,,,,2,1,2,3
9169_0,,,,2,1,2,3
9169_1,,,,2,1,2,3
9170_0,,,,2,1,2,3
9170_1,,,,2,1,2,3
9171_0,,,,2,1,2,3
9171_1,,,,2,1,2,3
9172_0,,,,2,1,2,3
9173_0,,,,2,1,2,3
9174_0,,,,2,1,2,3
9175_0,,,,2,1,2,3
9175_1,,,,2,1,2,3
9176_0,,,,2,1,2,3
9177_0,,,,2,1,2,3
9177_1,,,,2,1,2,3
9178_0,,,,2,1,2,3
9178_1,,,,2,1,2,3
9179_0,,,,2,1,2,3
9180_0,,,,2,1,2,3
9181_0,,,,2,1,2,3
9182_0,,,,2,1,2,3
9183_0,,,,2,1,2,3
9183_1,,,,2,1,2,3
9184_0,,,,2,1,2,3
9185_0,,,,2,1,2,3
9185_1,,,,2,1,2,3
9186_0,,,,2,1,2,3
9186_1,,,,2,1,2,3
9187_0,,,,2,1,2,3
9188_0,,,,2,1,2,3
9188_1,,,,2,1,2,3
9189_0,,,,2,1,2,3
9191_0,,,,2,1,2,3
C(CC(CC(C)=O)=O)=O,,,4,1,6,0,6
9191_1,,,,2,1,2,3
9193_0,,,,2,1,2,3
C(C)(C)=O,,,4,1,2,0,2
9194_0,,,,2,1,2,3
9195_0,,,,2,1,2,3
9196_0,,,,2,1,2,3
9196_1,,,,2,1,2,3
9197_0,,,,2,1,2,3
9198_0,,,,2,1,2,3
9200_0,,,,2,1,2,3
C(CCC(CO)=O)=O,,,4,1,9,0,9
9200_1,,,,2,1,2,3
9201_0,,,,2,1,2,3
9203_0,,,,2,1,2,3
C(CC(CCC=O)=O)=O,,,4,1,5,0,5
9203_1,,,,2,1,2,3
9204_0,,,,2,1,2,3
9205_0,,,,2,1,2,3
9206_0,,,,2,1,2,3
9207_0,,,,2,1,2,3
9208_0,,,,2,1,2,3
9209_0,,,,2,1,2,3
9210_0,,,,2,1,2,3
9211_0,,,,2,1,2,3
9212_0,,,,2,1,2,3
9212_1,,,,2,1,2,3
9213_0,,,,2,1,2,3
9213_1,,,,2,1,2,3
9214_0,,,,2,1,2,3
9215_0,,,,2,1,2,3
9216_0,,,,2,1,2,3
9217_0,,,,2,1,2,3
9218_0,,,,2,1,2,3
9219_0,,,,2,1,2,3
9220_0,,,,2,1,2,3
9222_0,,,,2,1,2,3
C(C(CC(C)=O)O)=O,,,4,1,4,0,4
9223_0,,,,2,1,2,3
9223_1,,,,2,1,2,3
9224_0,,,,2,1,2,3
9224_1,,,,2,1,2,3
9225_0,,,,2,1,2,3
9226_0,,,,2,1,2,3
9226_1,,,,2,1,2,3
9227_0,,,,2,1,2,3
9228_0,,,,2,1,2,3
9229_0,,,,2,1,2,3
9231_0,,,,2,1,2,3
C(CO)=CC(CO)=O,,,4,1,9,0,9
9231_1,,,,2,1,2,3
9232_0,,,,2,1,2,3
9234_0,,,,2,1,2,3
C(CC(C=CCO)=O)=O,,,4,1,7,0,7
9234_1,,,,2,1,2,3
9235_0,,,,2,1,2,3
9236_0,,,,2,1,2,3
9236_1,,,,2,1,2,3
9237_0,,,,2,1,2,3
9238_0,,,,2,1,2,3
9239_0,,,,2,1,2,3
9239_1,,,,2,1,2,3
9240_0,,,,2,1,2,3
9241_0,,,,2,1,2,3
9241_1,,,,2,1,2,3
9242_0,,,,2,1,2,3
9243_0,,,,2,1,2,3
9244_0,,,,2,1,2,3
9244_1,,,,2,1,2,3
9245_0,,,,2,1,2,3
9246_0,,,,2,1,2,3
9247_0,,,,2,1,2,3
9247_1,,,,2,1,2,3
9248_0,,,,2,1,2,3
9248_1,,,,2,1,2,3
9249_0,,,,2,1,2,3
9249_1,,,,2,1,2,3
9250_0,,,,2,1,2,3
9250_1,,,,2,1,2,3
9251_0,,,,2,1,2,3
9251_1,,,,2,1,2,3
9252_0,,,,2,1,2,3
9252_1,,,,2,1,2,3
9253_0,,,,2,1,2,3
9254_0,,,,2,1,2,3
9254_1,,,,2,1,2,3
9255_0,,,,2,1,2,3
9256_0,,,,2,1,2,3
9256_1,,,,2,1,2,3
9257_0,,,,2,1,2,3
9257_1,,,,2,1,2,3
9258_0,,,,2,1,2,3
9258_1,,,,2,1,2,3
9259_0,,,,2,1,2,3
9259_1,,,,2,1,2,3
9260_0,,,,2,1,2,3
9260_1,,,,2,1,2,3
9261_0,,,,2,1,2,3
9261_1,,,,2,1,2,3
9262_0,,,,2,1,2,3
9263_0,,,,2,1,2,3
9263_1,,,,2,1,2,3
9264_0,,,,2,1,2,3
9264_1,,,,2,1,2,3
9265_0,,,,2,1,2,3
9265_1,,,,2,1,2,3
9266_0,,,,2,1,2,3
9266_1,,,,2,1,2,3
9267_0,,,,2,1,2,3
9267_1,,,,2,1,2,3
9268_0,,,,2,1,2,3
9268_1,,,,2,1,2,3
9269_0,,,,2,1,2,3
9269_1,,,,2,1,2,3
9270_0,,,,2,1,2,3
9270_1,,,,2,1,2,3
9271_0,,,,2,1,2,3
9271_1,,,,2,1,2,3
9272_0,,,,2,1,2,3
9272_1,,,,2,1,2,3
9273_0,,,,2,1,2,3
9273_1,,,,2,1,2,3
9274_0,,,,2,1,2,3
9274_1,,,,2,1,2,3
9275_0,,,,2,1,2,3
9276_0,,,,2,1,2,3
9276_1,,,,2,1,2,3
9277_0,,,,2,1,2,3
9277_1,,,,2,1,2,3
9278_0,,,,2,1,2,3
9279_0,,,,2,1,2,3
9279_1,,,,2,1,2,3
9280_0,,,,2,1,2,3
9280_1,,,,2,1,2,3
9281_0,,,,2,1,2,3
9281_1,,,,2,1,2,3
9282_0,,,,2,1,2,3
9282_1,,,,2,1,2,3
9283_0,,,,2,1,2,3
9283_1,,,,2,1,2,3
9284_0,,,,2,1,2,3
9285_0,,,,2,1,2,3
9285_1,,,,2,1,2,3
9286_0,,,,2,1,2,3
9287_0,,,,2,1,2,3
9288_0,,,,2,1,2,3
9288_1,,,,2,1,2,3
9289_0,,,,2,1,2,3
9289_1,,,,2,1,2,3
9290_0,,,,2,1,2,3
9290_1,,,,2,1,2,3
9291_0,,,,2,1,2,3
9291_1,,,,2,1,2,3
9292_0,,,,2,1,2,3
9292_1,,,,2,1,2,3
9293_0,,,,2,1,2,3
9293_1,,,,2,1,2,3
9294_0,,,,2,1,2,3
9294_1,,,,2,1,2,3
9295_0,,,,2,1,2,3
9295_1,,,,2,1,2,3
9296_0,,,,2,1,2,3
9296_1,,,,2,1,2,3
9297_0,,,,2,1,2,3
9297_1,,,,2,1,2,3
9298_0,,,,2,1,2,3
9298_1,,,,2,1,2,3
9299_0,,,,2,1,2,3
9299_1,,,,2,1,2,3
9300_0,,,,2,1,2,3
9300_1,,,,2,1,2,3
9301_0,,,,2,1,2,3
9301_1,,,,2,1,2,3
9302_0,,,,2,1,2,3
9303_0,,,,2,1,2,3
9304_0,,,,2,1,2,3
9305_0,,,,2,1,2,3
9306_0,,,,2,1,2,3
9306_1,,,,2,1,2,3
9307_0,,,,2,1,2,3
9308_0,,,,2,1,2,3
9309_0,,,,2,1,2,3
9309_1,,,,2,1,2,3
9310_0,,,,2,1,2,3
9311_0,,,,2,1,2,3
9312_0,,,,2,1,2,3
9313_0,,,,2,1,2,3
9314_0,,,,2,1,2,3
9314_1,,,,2,1,2,3
9315_0,,,,2,1,2,3
9316_0,,,,2,1,2,3
9316_1,,,,2,1,2,3
9317_0,,,,2,1,2,3
9317_1,,,,2,1,2,3
9318_0,,,,2,1,2,3
9319_0,,,,2,1,2,3
9320_0,,,,2,1,2,3
9321_0,,,,2,1,2,3
9322_0,,,,2,1,2,3
9323_0,,,,2,1,2,3
9324_0,,,,2,1,2,3
9324_1,,,,2,1,2,3
9325_0,,,,2,1,2,3
9325_1,,,,2,1,2,3
9326_0,,,,2,1,2,3
9327_0,,,,2,1,2,3
9327_1,,,,2,1,2,3
9328_0,,,,2,1,2,3
9328_1,,,,2,1,2,3
9329_0,,,,2,1,2,3
9329_1,,,,2,1,2,3
9330_0,,,,2,1,2,3
9330_1,,,,2,1,2,3
9331_0,,,,2,1,2,3
9331_1,,,,2,1,2,3
9331_2,,,,2,1,2,3
9332_0,,,,2,1,2,3
9332_1,,,,2,1,2,3
9332_2,,,,2,1,2,3
9334_0,,,,2,1,2,3
C(OCC(C)=O)=O,,,4,1,5,0,5
9334_1,,,,2,1,2,3
9335_0,,,,2,1,1,2
9336_0,,,,2,1,2,3
9336_1,,,,2,1,2,3
9338_0,,,,2,1,2,3
C(COCC(CO)=O)=O,,,4,1,2,0,2
9338_1,,,,2,1,2,3
9340_0,,,,2,1,2,3
C(COC(C(C)=O)O)=O,,,4,1,2,0,2
9340_1,,,,2,1,2,3
9342_0,,,,2,1,2,3
C(C(O)OCC(C)=O)=O,,,4,1,3,0,3
9342_1,,,,2,1,2,3
9343_0,,,,2,1,1,2
9345_0,,,,2,1,2,3
C(OCC=O)=O,,,4,1,6,0,6
9345_1,,,,2,1,2,3
9346_0,,,,2,1,2,3
9347_0,,,,2,1,2,3
9348_0,,,,2,1,2,3
9348_1,,,,2,1,2,3
9350_0,,,,2,1,2,3
C(CO)(OCC=O)=O,,,4,1,6,0,6
9352_0,,,,2,1,2,3
C(COC(C)=O)=O,,,4,1,2,0,2
9352_1,,,,2,1,2,3
9353_0,,,,2,1,1,2
9353_1,,,,2,1,1,2
9354_0,,,,2,1,2,3
9354_1,,,,2,1,2,3
9355_0,,,,2,1,2,3
9355_1,,,,2,1,2,3
9356_0,,,,2,1,2,3
9357_0,,,,2,1,2,3
9358_0,,,,2,1,2,3
9360_0,,,,2,1,2,3
C(C(C(CCO)O)=O)=O,,,4,1,2,0,2
9361_0,,,,2,1,2,3
9362_0,,,,2,1,2,3
9362_1,,,,2,1,2,3
9363_0,,,,2,1,2,3
9363_1,,,,2,1,2,3
9364_0,,,,2,1,2,3
9364_1,,,,2,1,2,3
9366_0,,,,2,1,2,3
C(CO)(C(CCO)O)=O,,,4,1,6,0,6
9366_1,,,,2,1,2,3
9367_0,,,,2,1,2,3
9367_1,,,,2,1,2,3
9368_0,,,,2,1,2,3
9368_1,,,,2,1,2,3
9370_0,,,,2,1,2,3
C(CC(C(CO)=O)O)(O)=O,,,4,1,3,0,3
9370_1,,,,2,1,2,3
9371_0,,,,2,1,2,3
9371_1,,,,2,1,2,3
9372_0,,,,2,1,2,3
9372_1,,,,2,1,2,3
9373_0,,,,2,1,2,3
9373_1,,,,2,1,2,3
9374_0,,,,2,1,2,3
9375_0,,,,2,1,2,3
9376_0,,,,2,1,2,3
9377_0,,,,2,1,2,3
9378_0,,,,2,1,2,3
9379_0,,,,2,1,2,3
9381_0,,,,2,1,2,3
C(CCC(C=O)=O)=O,,,4,1,3,0,3
9383_0,,,,2,1,2,3
C(CCC=O)=O,,,4,1,2,0,2
9384_0,,,,2,1,2,3
9384_1,,,,2,1,2,3
9386_0,,,,2,1,2,3
C1(COC(CC1O)O)=O,,,4,1,3,0,3
9386_1,,,,2,1,2,3
9388_0,,,,2,1,1,2
C(CO)(C(COCC=O)O)=O,,,4,1,2,0,2
9388_1,,,,2,1,1,2
9390_0,,,,2,1,1,2
C(OCCC(C(CO)=O)O)=O,,,4,1,2,0,2
9390_1,,,,2,1,1,2
9392_0,,,,2,1,2,3
C(CO)=CC(C=O)=O,,,4,1,2,0,2
9394_0,,,,2,1,2,3
C(CO)=CC=O,,,4,1,7,0,7
9396_0,,,,2,1,1,2
C(CC(OCC(CO)=O)O)=O,,,4,1,4,0,4
9396_1,,,,2,1,1,2
9397_0,,,,2,1,2,3
9397_1,,,,2,1,2,3
9398_0,,,,2,1,2,3
9399_0,,,,2,1,2,3
9400_0,,,,2,1,2,3
9401_0,,,,2,1,2,3
9402_0,,,,2,1,2,3
9402_1,,,,2,1,2,3
9403_0,,,,2,1,2,3
9403_1,,,,2,1,2,3
9404_0,,,,2,1,2,3
9405_0,,,,2,1,2,3
9406_0,,,,2,1,2,3
9407_0,,,,2,1,2,3
9408_0,,,,2,1,2,3
9408_1,,,,2,1,2,3
9409_0,,,,2,1,2,3
9409_1,,,,2,1,2,3
9410_0,,,,2,1,2,3
9410_1,,,,2,1,2,3
9412_0,,,,2,1,2,3
C(C(CO)=O)(O)=O,,,4,1,4,0,4
9412_1,,,,2,1,2,3
9413_0,,,,2,1,2,3
9414_0,,,,2,1,2,3
9415_0,,,,2,1,2,3
9415_1,,,,2,1,2,3
9417_0,,,,2,1,2,3
C(C)(CC(C(O)=O)=O)=O,,,4,1,3,0,3
9418_0,,,,2,1,2,3
9419_0,,,,2,1,2,3
9421_0,,,,2,1,2,3
C(CC(C(O)=O)=O)=O,,,4,1,3,0,3
9422_0,,,,2,1,2,3
9423_0,,,,2,1,2,3
9423_1,,,,2,1,2,3
9424_0,,,,2,1,2,3
9425_0,,,,2,1,2,3
9425_1,,,,2,1,2,3
9426_0,,,,2,1,2,3
9426_1,,,,2,1,2,3
9427_0,,,,2,1,2,3
9427_1,,,,2,1,2,3
9428_0,,,,2,1,2,3
9429_0,,,,2,1,2,3
9429_1,,,,2,1,2,3
9430_0,,,,2,1,2,3
9430_1,,,,2,1,2,3
9431_0,,,,2,1,2,3
9432_0,,,,2,1,2,3
9434_0,,,,2,1,2,3
C(CC(C)=O)(O)=O,,,4,1,3,0,3
9435_0,,,,2,1,2,3
9435_1,,,,2,1,2,3
9436_0,,,,2,1,2,3
9436_1,,,,2,1,2,3
9438_0,,,,2,1,2,3
C(C=CC(CO)=O)(O)=O,,,4,1,4,0,4
9438_1,,,,2,1,2,3
9439_0,,,,2,1,2,3
9439_1,,,,2,1,2,3
9441_0,,,,2,1,2,3
C(C=CC(O)=O)=O,,,4,1,5,0,5
9441_1,,,,2,1,2,3
9442_0,,,,2,1,1,2
9442_1,,,,2,1,1,2
9442_2,,,,2,1,1,2
9443_0,,,,2,1,2,3
9443_1,,,,2,1,2,3
9443_2,,,,2,1,2,3
9444_0,,,,2,1,1,2
9444_1,,,,2,1,1,2
9444_2,,,,2,1,1,2
9445_0,,,,2,1,1,2
9445_1,,,,2,1,1,2
9445_2,,,,2,1,1,2
9446_0,,,,2,1,2,3
9446_1,,,,2,1,2,3
9446_2,,,,2,1,2,3
9447_0,,,,2,1,1,2
9447_1,,,,2,1,1,2
9447_2,,,,2,1,1,2
9449_0,,,,2,1,1,2
C(CO)(C(CO)(CO)C(C=O)O)=O,,,4,1,4,0,4
9449_1,,,,2,1,1,2
9450_0,,,,2,1,1,2
9450_1,,,,2,1,1,2
9451_0,,,,2,1,2,3
9451_1,,,,2,1,2,3
9452_0,,,,2,1,1,2
9453_0,,,,2,1,1,2
9453_1,,,,2,1,1,2
9453_2,,,,2,1,1,2
9454_0,,,,2,1,2,3
9454_1,,,,2,1,2,3
9454_2,,,,2,1,2,3
9455_0,,,,2,1,1,2
9455_1,,,,2,1,1,2
9456_0,,,,2,1,2,3
9456_1,,,,2,1,2,3
9457_0,,,,2,1,2,3
9457_1,,,,2,1,2,3
9457_2,,,,2,1,2,3
9458_0,,,,2,1,2,3
9458_1,,,,2,1,2,3
9458_2,,,,2,1,2,3
9459_0,,,,2,1,2,3
9459_1,,,,2,1,2,3
9459_2,,,,2,1,2,3
9460_0,,,,2,1,2,3
9460_1,,,,2,1,2,3
9460_2,,,,2,1,2,3
9461_0,,,,2,1,2,3
9461_1,,,,2,1,2,3
9461_2,,,,2,1,2,3
9462_0,,,,2,1,2,3
9462_1,,,,2,1,2,3
9462_2,,,,2,1,2,3
9463_0,,,,2,1,2,3
9463_1,,,,2,1,2,3
9463_2,,,,2,1,2,3
9464_0,,,,2,1,2,3
9464_1,,,,2,1,2,3
9464_2,,,,2,1,2,3
9465_0,,,,2,1,2,3
9465_1,,,,2,1,2,3
9465_2,,,,2,1,2,3
9466_0,,,,2,1,2,3
9466_1,,,,2,1,2,3
9466_2,,,,2,1,2,3
9467_0,,,,2,1,2,3
9467_1,,,,2,1,2,3
9468_0,,,,2,1,2,3
9468_1,,,,2,1,2,3
9468_2,,,,2,1,2,3
9469_0,,,,2,1,2,3
9469_1,,,,2,1,2,3
9469_2,,,,2,1,2,3
9470_0,,,,2,1,2,3
9470_1,,,,2,1,2,3
9471_0,,,,2,1,2,3
9471_1,,,,2,1,2,3
9471_2,,,,2,1,2,3
9472_0,,,,2,1,2,3
9472_1,,,,2,1,2,3
9472_2,,,,2,1,2,3
9473_0,,,,2,1,2,3
9474_0,,,,2,1,2,3
9474_1,,,,2,1,2,3
9474_2,,,,2,1,2,3
9475_0,,,,2,1,2,3
9475_1,,,,2,1,2,3
9475_2,,,,2,1,2,3
9477_0,,,,2,1,2,3
C(C(C(CO)=O)(CO)O)=O,,,4,1,5,0,5
9478_0,,,,2,1,2,3
9478_1,,,,2,1,2,3
9478_2,,,,2,1,2,3
9479_0,,,,2,1,2,3
9479_1,,,,2,1,2,3
9479_2,,,,2,1,2,3
9480_0,,,,2,1,2,3
9480_1,,,,2,1,2,3
9480_2,,,,2,1,2,3
9481_0,,,,2,1,2,3
9481_1,,,,2,1,2,3
9482_0,,,,2,1,2,3
9482_1,,,,2,1,2,3
9482_2,,,,2,1,2,3
9483_0,,,,2,1,2,3
9483_1,,,,2,1,2,3
9483_2,,,,2,1,2,3
9484_0,,,,2,1,2,3
9484_1,,,,2,1,2,3
9485_0,,,,2,1,2,3
9485_1,,,,2,1,2,3
9485_2,,,,2,1,2,3
9486_0,,,,2,1,2,3
9486_1,,,,2,1,2,3
9486_2,,,,2,1,2,3
9487_0,,,,2,1,2,3
9487_1,,,,2,1,2,3
9488_0,,,,2,1,2,3
9488_1,,,,2,1,2,3
9488_2,,,,2,1,2,3
9489_0,,,,2,1,2,3
9489_1,,,,2,1,2,3
9489_2,,,,2,1,2,3
9490_0,,,,2,1,2,3
9490_1,,,,2,1,2,3
9490_2,,,,2,1,2,3
9491_0,,,,2,1,2,3
9491_1,,,,2,1,2,3
9491_2,,,,2,1,2,3
9492_0,,,,2,1,2,3
9492_1,,,,2,1,2,3
9492_2,,,,2,1,2,3
9493_0,,,,2,1,2,3
9493_1,,,,2,1,2,3
9493_2,,,,2,1,2,3
9494_0,,,,2,1,2,3
9494_1,,,,2,1,2,3
9494_2,,,,2,1,2,3
9495_0,,,,2,1,2,3
9495_1,,,,2,1,2,3
9496_0,,,,2,1,2,3
9497_0,,,,2,1,2,3
9497_1,,,,2,1,2,3
9497_2,,,,2,1,2,3
9498_0,,,,2,1,2,3
9498_1,,,,2,1,2,3
9498_2,,,,2,1,2,3
9499_0,,,,2,1,2,3
9499_1,,,,2,1,2,3
9500_0,,,,2,1,2,3
9500_1,,,,2,1,2,3
9500_2,,,,2,1,2,3
9501_0,,,,2,1,2,3
9501_1,,,,2,1,2,3
9501_2,,,,2,1,2,3
9502_0,,,,2,1,2,3
9502_1,,,,2,1,2,3
9502_2,,,,2,1,2,3
9503_0,,,,2,1,2,3
9503_1,,,,2,1,2,3
9503_2,,,,2,1,2,3
9504_0,,,,2,1,2,3
9504_1,,,,2,1,2,3
9504_2,,,,2,1,2,3
9505_0,,,,2,1,2,3
9505_1,,,,2,1,2,3
9506_0,,,,2,1,2,3
9506_1,,,,2,1,2,3
9506_2,,,,2,1,2,3
9507_0,,,,2,1,2,3
9507_1,,,,2,1,2,3
9507_2,,,,2,1,2,3
9508_0,,,,2,1,2,3
9508_1,,,,2,1,2,3
9508_2,,,,2,1,2,3
9509_0,,,,2,1,2,3
9509_1,,,,2,1,2,3
9509_2,,,,2,1,2,3
9510_0,,,,2,1,2,3
9511_0,,,,2,1,2,3
9511_1,,,,2,1,2,3
9511_2,,,,2,1,2,3
9512_0,,,,2,1,2,3
9512_1,,,,2,1,2,3
9512_2,,,,2,1,2,3
9513_0,,,,2,1,2,3
9513_1,,,,2,1,2,3
9513_2,,,,2,1,2,3
9514_0,,,,2,1,2,3
9514_1,,,,2,1,2,3
9514_2,,,,2,1,2,3
9515_0,,,,2,1,2,3
9515_1,,,,2,1,2,3
9516_0,,,,2,1,2,3
9516_1,,,,2,1,2,3
9516_2,,,,2,1,2,3
9517_0,,,,2,1,2,3
9517_1,,,,2,1,2,3
9518_0,,,,2,1,2,3
9518_1,,,,2,1,2,3
9518_2,,,,2,1,2,3
9519_0,,,,2,1,2,3
9519_1,,,,2,1,2,3
9520_0,,,,2,1,2,3
9520_1,,,,2,1,2,3
9520_2,,,,2,1,2,3
9521_0,,,,2,1,2,3
9521_1,,,,2,1,2,3
9521_2,,,,2,1,2,3
9522_0,,,,2,1,2,3
9522_1,,,,2,1,2,3
9523_0,,,,2,1,2,3
9523_1,,,,2,1,2,3
9523_2,,,,2,1,2,3
9524_0,,,,2,1,2,3
9524_1,,,,2,1,2,3
9524_2,,,,2,1,2,3
9525_0,,,,2,1,2,3
9525_1,,,,2,1,2,3
9526_0,,,,2,1,2,3
9526_1,,,,2,1,2,3
9526_2,,,,2,1,2,3
9527_0,,,,2,1,2,3
9527_1,,,,2,1,2,3
9528_0,,,,2,1,2,3
9528_1,,,,2,1,2,3
9528_2,,,,2,1,2,3
9529_0,,,,2,1,2,3
9529_1,,,,2,1,2,3
9530_0,,,,2,1,2,3
9530_1,,,,2,1,2,3
9530_2,,,,2,1,2,3
9531_0,,,,2,1,2,3
9531_1,,,,2,1,2,3
9531_2,,,,2,1,2,3
9532_0,,,,2,1,2,3
9532_1,,,,2,1,2,3
9533_0,,,,2,1,2,3
9533_1,,,,2,1,2,3
9534_0,,,,2,1,2,3
9534_1,,,,2,1,2,3
9534_2,,,,2,1,2,3
9535_0,,,,2,1,2,3
9535_1,,,,2,1,2,3
9535_2,,,,2,1,2,3
9536_0,,,,2,1,2,3
9536_1,,,,2,1,2,3
9538_0,,,,2,1,2,3
C(C(CO)=O)(CO)=O,,,4,1,8,0,8
9538_1,,,,2,1,2,3
9539_0,,,,2,1,2,3
9539_1,,,,2,1,2,3
9539_2,,,,2,1,2,3
9540_0,,,,2,1,2,3
9540_1,,,,2,1,2,3
9540_2,,,,2,1,2,3
9541_0,,,,2,1,2,3
9541_1,,,,2,1,2,3
9542_0,,,,2,1,2,3
9542_1,,,,2,1,2,3
9542_2,,,,2,1,2,3
9543_0,,,,2,1,2,3
9543_1,,,,2,1,2,3
9543_2,,,,2,1,2,3
9545_0,,,,2,1,2,3
C(C(C=O)(C=O)O)=O,,,4,1,5,0,5
9546_0,,,,2,1,2,3
9546_1,,,,2,1,2,3
9546_2,,,,2,1,2,3
9548_0,,,,2,1,2,3
C(C(C=O)(C(CO)=O)O)=O,,,4,1,2,0,2
9549_0,,,,2,1,2,3
9549_1,,,,2,1,2,3
9549_2,,,,2,1,2,3
9550_0,,,,2,1,2,3
9550_1,,,,2,1,2,3
9550_2,,,,2,1,2,3
9551_0,,,,2,1,2,3
9551_1,,,,2,1,2,3
9552_0,,,,2,1,2,3
9552_1,,,,2,1,2,3
9552_2,,,,2,1,2,3
9553_0,,,,2,1,2,3
9553_1,,,,2,1,2,3
9554_0,,,,2,1,2,3
9554_1,,,,2,1,2,3
9554_2,,,,2,1,2,3
9556_0,,,,2,1,2,3
C(C(C=O)(C(C)=O)O)=O,,,4,1,5,0,5
9556_1,,,,2,1,2,3
9557_0,,,,2,1,2,3
9557_1,,,,2,1,2,3
9557_2,,,,2,1,2,3
9558_0,,,,2,1,2,3
9558_1,,,,2,1,2,3
9558_2,,,,2,1,2,3
9559_0,,,,2,1,2,3
9559_1,,,,2,1,2,3
9560_0,,,,2,1,2,3
9560_1,,,,2,1,2,3
9560_2,,,,2,1,2,3
9561_0,,,,2,1,2,3
9561_1,,,,2,1,2,3
9561_2,,,,2,1,2,3
9563_0,,,,2,1,2,3
C(C(C(C(C)=O)=O)O)=O,,,4,1,2,0,2
9563_1,,,,2,1,2,3
9564_0,,,,2,1,2,3
9564_1,,,,2,1,2,3
9564_2,,,,2,1,2,3
9565_0,,,,2,1,2,3
9565_1,,,,2,1,2,3
9566_0,,,,2,1,2,3
9566_1,,,,2,1,2,3
9566_2,,,,2,1,2,3
9567_0,,,,2,1,2,3
9567_1,,,,2,1,2,3
9568_0,,,,2,1,2,3
9568_1,,,,2,1,2,3
9568_2,,,,2,1,2,3
9569_0,,,,2,1,2,3
9569_1,,,,2,1,2,3
9570_0,,,,2,1,2,3
9570_1,,,,2,1,2,3
9570_2,,,,2,1,2,3
9571_0,,,,2,1,2,3
9571_1,,,,2,1,2,3
9571_2,,,,2,1,2,3
9573_0,,,,2,1,2,3
C(C(C(CO)O)=O)(O)=O,,,4,1,3,0,3
9573_1,,,,2,1,2,3
9574_0,,,,2,1,2,3
9574_1,,,,2,1,2,3
9574_2,,,,2,1,2,3
9575_0,,,,2,1,2,3
9575_1,,,,2,1,2,3
9575_2,,,,2,1,2,3
9576_0,,,,2,1,2,3
9576_1,,,,2,1,2,3
9576_2,,,,2,1,2,3
9577_0,,,,2,1,2,3
9577_1,,,,2,1,2,3
9577_2,,,,2,1,2,3
9578_0,,,,2,1,2,3
9578_1,,,,2,1,2,3
9579_0,,,,2,1,2,3
9579_1,,,,2,1,2,3
9579_2,,,,2,1,2,3
9580_0,,,,2,1,2,3
9580_1,,,,2,1,2,3
9580_2,,,,2,1,2,3
9581_0,,,,2,1,2,3
9581_1,,,,2,1,2,3
9581_2,,,,2,1,2,3
9582_0,,,,2,1,2,3
9582_1,,,,2,1,2,3
9582_2,,,,2,1,2,3
9583_0,,,,2,1,2,3
9583_1,,,,2,1,2,3
9583_2,,,,2,1,2,3
9584_0,,,,2,1,2,3
9584_1,,,,2,1,2,3
9584_2,,,,2,1,2,3
9585_0,,,,2,1,2,3
9586_0,,,,2,1,2,3
9586_1,,,,2,1,2,3
9586_2,,,,2,1,2,3
9587_0,,,,2,1,2,3
9587_1,,,,2,1,2,3
9587_2,,,,2,1,2,3
9588_0,,,,2,1,2,3
9588_1,,,,2,1,2,3
9588_2,,,,2,1,2,3
9590_0,,,,2,1,2,3
C(C)(C(C(CO)=O)(CO)O)=O,,,4,1,5,0,5
9591_0,,,,2,1,2,3
9591_1,,,,2,1,2,3
9591_2,,,,2,1,2,3
9592_0,,,,2,1,2,3
9592_1,,,,2,1,2,3
9593_0,,,,2,1,2,3
9593_1,,,,2,1,2,3
9593_2,,,,2,1,2,3
9594_0,,,,2,1,2,3
9594_1,,,,2,1,2,3
9594_2,,,,2,1,2,3
9595_0,,,,2,1,2,3
9595_1,,,,2,1,2,3
9595_2,,,,2,1,2,3
9596_0,,,,2,1,2,3
9596_1,,,,2,1,2,3
9596_2,,,,2,1,2,3
9597_0,,,,2,1,2,3
9597_1,,,,2,1,2,3
9599_0,,,,2,1,2,3
C(C(CO)=O)(C(C)O)=O,,,4,1,4,0,4
9599_1,,,,2,1,2,3
9600_0,,,,2,1,2,3
9600_1,,,,2,1,2,3
9600_2,,,,2,1,2,3
9601_0,,,,2,1,2,3
9601_1,,,,2,1,2,3
9601_2,,,,2,1,2,3
9602_0,,,,2,1,2,3
9602_1,,,,2,1,2,3
9602_2,,,,2,1,2,3
9603_0,,,,2,1,2,3
9603_1,,,,2,1,2,3
9603_2,,,,2,1,2,3
9604_0,,,,2,1,2,3
9605_0,,,,2,1,2,3
9606_0,,,,2,1,2,3
9606_1,,,,2,1,2,3
9606_2,,,,2,1,2,3
9607_0,,,,2,1,2,3
9607_1,,,,2,1,2,3
9607_2,,,,2,1,2,3
9608_0,,,,2,1,2,3
9608_1,,,,2,1,2,3
9608_2,,,,2,1,2,3
9609_0,,,,2,1,2,3
9610_0,,,,2,1,2,3
9610_1,,,,2,1,2,3
9610_2,,,,2,1,2,3
9611_0,,,,2,1,2,3
9611_1,,,,2,1,2,3
9611_2,,,,2,1,2,3
9612_0,,,,2,1,2,3
9612_1,,,,2,1,2,3
9612_2,,,,2,1,2,3
9613_0,,,,2,1,2,3
9613_1,,,,2,1,2,3
9613_2,,,,2,1,2,3
9614_0,,,,2,1,2,3
9614_1,,,,2,1,2,3
9614_2,,,,2,1,2,3
9615_0,,,,2,1,2,3
9615_1,,,,2,1,2,3
9615_2,,,,2,1,2,3
9617_0,,,,2,1,1,2
C(OC(C(C)=O)(CO)C(CO)O)=O,,,4,1,3,0,3
9618_0,,,,2,1,2,3
9618_1,,,,2,1,2,3
9618_2,,,,2,1,2,3
9619_0,,,,2,1,2,3
9619_1,,,,2,1,2,3
9619_2,,,,2,1,2,3
9620_0,,,,2,1,2,3
9620_1,,,,2,1,2,3
9620_2,,,,2,1,2,3
9621_0,,,,2,1,1,2
9621_1,,,,2,1,1,2
9621_2,,,,2,1,1,2
9622_0,,,,2,1,2,3
9622_1,,,,2,1,2,3
9622_2,,,,2,1,2,3
9623_0,,,,2,1,1,2
9623_1,,,,2,1,1,2
9623_2,,,,2,1,1,2
9625_0,,,,2,1,1,2
C(OC(CO)C(C(C)=O)(CO)O)=O,,,4,1,3,0,3
9626_0,,,,2,1,2,3
9626_1,,,,2,1,2,3
9626_2,,,,2,1,2,3
9627_0,,,,2,1,2,3
9627_1,,,,2,1,2,3
9627_2,,,,2,1,2,3
9628_0,,,,2,1,1,2
9628_1,,,,2,1,1,2
9628_2,,,,2,1,1,2
9630_0,,,,2,1,1,2
C(C)(C(CO)(CO)OC(C=O)O)=O,,,4,1,3,0,3
9631_0,,,,2,1,2,3
9631_1,,,,2,1,2,3
9631_2,,,,2,1,2,3
9632_0,,,,2,1,2,3
9632_1,,,,2,1,2,3
9632_2,,,,2,1,2,3
9633_0,,,,2,1,1,2
9633_1,,,,2,1,1,2
9633_2,,,,2,1,1,2
9635_0,,,,2,1,1,2
C(OCC(C(C(C)=O)(CO)O)O)=O,,,4,1,3,0,3
9636_0,,,,2,1,2,3
9636_1,,,,2,1,2,3
9636_2,,,,2,1,2,3
9637_0,,,,2,1,1,2
9637_1,,,,2,1,1,2
9637_2,,,,2,1,1,2
9638_0,,,,2,1,2,3
9638_1,,,,2,1,2,3
9638_2,,,,2,1,2,3
9639_0,,,,2,1,1,2
9639_1,,,,2,1,1,2
9639_2,,,,2,1,1,2
9641_0,,,,2,1,1,2
C(C)(C(C(OCC=O)O)(CO)O)=O,,,4,1,3,0,3
9643_0,,,,2,1,1,2
C(C)(C(CO)(COC(C=O)O)O)=O,,,4,1,3,0,3
9644_0,,,,2,1,2,3
9644_1,,,,2,1,2,3
9644_2,,,,2,1,2,3
9645_0,,,,2,1,2,3
9645_1,,,,2,1,2,3
9645_2,,,,2,1,2,3
9646_0,,,,2,1,1,2
9646_1,,,,2,1,1,2
9646_2,,,,2,1,1,2
9647_0,,,,2,1,2,3
9647_1,,,,2,1,2,3
9647_2,,,,2,1,2,3
9648_0,,,,2,1,2,3
9648_1,,,,2,1,2,3
9648_2,,,,2,1,2,3
9649_0,,,,2,1,2,3
9649_1,,,,2,1,2,3
9649_2,,,,2,1,2,3
9650_0,,,,2,1,2,3
9650_1,,,,2,1,2,3
9650_2,,,,2,1,2,3
9651_0,,,,2,1,2,3
9651_1,,,,2,1,2,3
9653_0,,,,2,1,2,3
C=CC(C(CO)=O)=O,,,4,1,2,0,2
9653_1,,,,2,1,2,3
9654_0,,,,2,1,2,3
9654_1,,,,2,1,2,3
9654_2,,,,2,1,2,3
9655_0,,,,2,1,2,3
9655_1,,,,2,1,2,3
9655_2,,,,2,1,2,3
9656_0,,,,2,1,2,3
9656_1,,,,2,1,2,3
9656_2,,,,2,1,2,3
9657_0,,,,2,1,2,3
9657_1,,,,2,1,2,3
9657_2,,,,2,1,2,3
9658_0,,,,2,1,2,3
9658_1,,,,2,1,2,3
9658_2,,,,2,1,2,3
9659_0,,,,2,1,2,3
9659_1,,,,2,1,2,3
9659_2,,,,2,1,2,3
9660_0,,,,2,1,2,3
9660_1,,,,2,1,2,3
9660_2,,,,2,1,2,3
9661_0,,,,2,1,1,2
9661_1,,,,2,1,1,2
9661_2,,,,2,1,1,2
9662_0,,,,2,1,2,3
9662_1,,,,2,1,2,3
9662_2,,,,2,1,2,3
9663_0,,,,2,1,1,2
9663_1,,,,2,1,1,2
9663_2,,,,2,1,1,2
9664_0,,,,2,1,2,3
9664_1,,,,2,1,2,3
9664_2,,,,2,1,2,3
9665_0,,,,2,1,2,3
9665_1,,,,2,1,2,3
9665_2,,,,2,1,2,3
9666_0,,,,2,1,1,2
9666_1,,,,2,1,1,2
9666_2,,,,2,1,1,2
9667_0,,,,2,1,2,3
9667_1,,,,2,1,2,3
9668_0,,,,2,1,2,3
9669_0,,,,2,1,2,3
9669_1,,,,2,1,2,3
9669_2,,,,2,1,2,3
9670_0,,,,2,1,2,3
9670_1,,,,2,1,2,3
9671_0,,,,2,1,2,3
9671_1,,,,2,1,2,3
9671_2,,,,2,1,2,3
9672_0,,,,2,1,2,3
9672_1,,,,2,1,2,3
9672_2,,,,2,1,2,3
9673_0,,,,2,1,2,3
9673_1,,,,2,1,2,3
9673_2,,,,2,1,2,3
9674_0,,,,2,1,2,3
9674_1,,,,2,1,2,3
9674_2,,,,2,1,2,3
9675_0,,,,2,1,2,3
9675_1,,,,2,1,2,3
9677_0,,,,2,1,2,3
C(C(C)=O)(C(C)O)=O,,,4,1,3,0,3
9677_1,,,,2,1,2,3
9678_0,,,,2,1,2,3
9678_1,,,,2,1,2,3
9678_2,,,,2,1,2,3
9679_0,,,,2,1,2,3
9679_1,,,,2,1,2,3
9679_2,,,,2,1,2,3
9680_0,,,,2,1,2,3
9680_1,,,,2,1,2,3
9681_0,,,,2,1,2,3
9681_1,,,,2,1,2,3
9681_2,,,,2,1,2,3
9682_0,,,,2,1,2,3
9682_1,,,,2,1,2,3
9682_2,,,,2,1,2,3
9683_0,,,,2,1,2,3
9683_1,,,,2,1,2,3
9683_2,,,,2,1,2,3
9684_0,,,,2,1,2,3
9685_0,,,,2,1,2,3
9685_1,,,,2,1,2,3
9685_2,,,,2,1,2,3
9686_0,,,,2,1,2,3
9686_1,,,,2,1,2,3
9686_2,,,,2,1,2,3
9687_0,,,,2,1,2,3
9687_1,,,,2,1,2,3
9687_2,,,,2,1,2,3
9688_0,,,,2,1,2,3
9688_1,,,,2,1,2,3
9688_2,,,,2,1,2,3
9689_0,,,,2,1,2,3
9689_1,,,,2,1,2,3
9690_0,,,,2,1,2,3
9690_1,,,,2,1,2,3
9690_2,,,,2,1,2,3
9691_0,,,,2,1,2,3
9691_1,,,,2,1,2,3
9691_2,,,,2,1,2,3
9692_0,,,,2,1,2,3
9692_1,,,,2,1,2,3
9692_2,,,,2,1,2,3
9693_0,,,,2,1,2,3
9693_1,,,,2,1,2,3
9693_2,,,,2,1,2,3
9694_0,,,,2,1,2,3
9694_1,,,,2,1,2,3
9695_0,,,,2,1,2,3
9695_1,,,,2,1,2,3
9695_2,,,,2,1,2,3
9696_0,,,,2,1,2,3
9696_1,,,,2,1,2,3
9696_2,,,,2,1,2,3
9697_0,,,,2,1,2,3
9697_1,,,,2,1,2,3
9697_2,,,,2,1,2,3
9698_0,,,,2,1,2,3
9698_1,,,,2,1,2,3
9698_2,,,,2,1,2,3
9699_0,,,,2,1,2,3
9699_1,,,,2,1,2,3
9699_2,,,,2,1,2,3
9700_0,,,,2,1,2,3
9700_1,,,,2,1,2,3
9700_2,,,,2,1,2,3
9701_0,,,,2,1,2,3
9701_1,,,,2,1,2,3
9701_2,,,,2,1,2,3
9702_0,,,,2,1,2,3
9702_1,,,,2,1,2,3
9702_2,,,,2,1,2,3
9703_0,,,,2,1,2,3
9703_1,,,,2,1,2,3
9703_2,,,,2,1,2,3
9704_0,,,,2,1,2,3
9704_1,,,,2,1,2,3
9704_2,,,,2,1,2,3
9705_0,,,,2,1,2,3
9705_1,,,,2,1,2,3
9707_0,,,,2,1,2,3
C=CC(C(C(C)O)=O)=O,,,4,1,2,0,2
9707_1,,,,2,1,2,3
9708_0,,,,2,1,2,3
9708_1,,,,2,1,2,3
9708_2,,,,2,1,2,3
9709_0,,,,2,1,2,3
9709_1,,,,2,1,2,3
9709_2,,,,2,1,2,3
9710_0,,,,2,1,2,3
9710_1,,,,2,1,2,3
9710_2,,,,2,1,2,3
9711_0,,,,2,1,2,3
9711_1,,,,2,1,2,3
9711_2,,,,2,1,2,3
9712_0,,,,2,1,2,3
9712_1,,,,2,1,2,3
9712_2,,,,2,1,2,3
9713_0,,,,2,1,2,3
9713_1,,,,2,1,2,3
9713_2,,,,2,1,2,3
9714_0,,,,2,1,2,3
9714_1,,,,2,1,2,3
9714_2,,,,2,1,2,3
9715_0,,,,2,1,2,3
9715_1,,,,2,1,2,3
9715_2,,,,2,1,2,3
9716_0,,,,2,1,2,3
9716_1,,,,2,1,2,3
9716_2,,,,2,1,2,3
9717_0,,,,2,1,2,3
9717_1,,,,2,1,2,3
9717_2,,,,2,1,2,3
9718_0,,,,2,1,2,3
9718_1,,,,2,1,2,3
9718_2,,,,2,1,2,3
9719_0,,,,2,1,2,3
9719_1,,,,2,1,2,3
9720_0,,,,2,1,2,3
9720_1,,,,2,1,2,3
9721_0,,,,2,1,2,3
9721_1,,,,2,1,2,3
9721_2,,,,2,1,2,3
9722_0,,,,2,1,2,3
9722_1,,,,2,1,2,3
9722_2,,,,2,1,2,3
9723_0,,,,2,1,2,3
9723_1,,,,2,1,2,3
9723_2,,,,2,1,2,3
9724_0,,,,2,1,2,3
9724_1,,,,2,1,2,3
9724_2,,,,2,1,2,3
9725_0,,,,2,1,2,3
9725_1,,,,2,1,2,3
9725_2,,,,2,1,2,3
9726_0,,,,2,1,2,3
9726_1,,,,2,1,2,3
9727_0,,,,2,1,2,3
9727_1,,,,2,1,2,3
9727_2,,,,2,1,2,3
9728_0,,,,2,1,2,3
9728_1,,,,2,1,2,3
9728_2,,,,2,1,2,3
9729_0,,,,2,1,2,3
9729_1,,,,2,1,2,3
9729_2,,,,2,1,2,3
9730_0,,,,2,1,2,3
9730_1,,,,2,1,2,3
9730_2,,,,2,1,2,3
9731_0,,,,2,1,2,3
9731_1,,,,2,1,2,3
9732_0,,,,2,1,2,3
9732_1,,,,2,1,2,3
9732_2,,,,2,1,2,3
9733_0,,,,2,1,2,3
9733_1,,,,2,1,2,3
9733_2,,,,2,1,2,3
9734_0,,,,2,1,2,3
9734_1,,,,2,1,2,3
9734_2,,,,2,1,2,3
9735_0,,,,2,1,2,3
9735_1,,,,2,1,2,3
9735_2,,,,2,1,2,3
9736_0,,,,2,1,2,3
9736_1,,,,2,1,2,3
9736_2,,,,2,1,2,3
9737_0,,,,2,1,2,3
9737_1,,,,2,1,2,3
9737_2,,,,2,1,2,3
9738_0,,,,2,1,2,3
9738_1,,,,2,1,2,3
9738_2,,,,2,1,2,3
9739_0,,,,2,1,2,3
9740_0,,,,2,1,2,3
9741_0,,,,2,1,2,3
9741_1,,,,2,1,2,3
9741_2,,,,2,1,2,3
9742_0,,,,2,1,2,3
9742_1,,,,2,1,2,3
9743_0,,,,2,1,2,3
9743_1,,,,2,1,2,3
9743_2,,,,2,1,2,3
9744_0,,,,2,1,2,3
9744_1,,,,2,1,2,3
9744_2,,,,2,1,2,3
9745_0,,,,2,1,2,3
9746_0,,,,2,1,1,2
9746_1,,,,2,1,1,2
9747_0,,,,2,1,1,2
9747_1,,,,2,1,1,2
9748_0,,,,2,1,1,2
9748_1,,,,2,1,1,2
9749_0,,,,2,1,1,2
9749_1,,,,2,1,1,2
9750_0,,,,2,1,1,2
9752_0,,,,2,1,1,2
C(C(C=O)(CC(C)=O)O)=O,,,4,1,1,0,1
9753_0,,,,2,1,2,3
9753_1,,,,2,1,2,3
9754_0,,,,2,1,2,3
9755_0,,,,2,1,2,3
9755_1,,,,2,1,2,3
9756_0,,,,2,1,2,3
9757_0,,,,2,1,2,3
9757_1,,,,2,1,2,3
9758_0,,,,2,1,2,3
9758_1,,,,2,1,2,3
9759_0,,,,2,1,2,3
9760_0,,,,2,1,2,3
9760_1,,,,2,1,2,3
9761_0,,,,2,1,2,3
9761_1,,,,2,1,2,3
9762_0,,,,2,1,2,3
9763_0,,,,2,1,2,3
9763_1,,,,2,1,2,3
9764_0,,,,2,1,2,3
9765_0,,,,2,1,2,3
9765_1,,,,2,1,2,3
9766_0,,,,2,1,2,3
9766_1,,,,2,1,2,3
9767_0,,,,2,1,2,3
9767_1,,,,2,1,2,3
9768_0,,,,2,1,2,3
9769_0,,,,2,1,2,3
9769_1,,,,2,1,2,3
9770_0,,,,2,1,2,3
9770_1,,,,2,1,2,3
9771_0,,,,2,1,2,3
9772_0,,,,2,1,2,3
9772_1,,,,2,1,2,3
9773_0,,,,2,1,2,3
9774_0,,,,2,1,2,3
9774_1,,,,2,1,2,3
9775_0,,,,2,1,2,3
9776_0,,,,2,1,2,3
9776_1,,,,2,1,2,3
9777_0,,,,2,1,2,3
9778_0,,,,2,1,2,3
9779_0,,,,2,1,2,3
9779_1,,,,2,1,2,3
9781_0,,,,2,1,2,3
C(CO)(C(CO)(CC=O)O)=O,,,4,1,5,0,5
9781_1,,,,2,1,2,3
9782_0,,,,2,1,2,3
9783_0,,,,2,1,2,3
9783_1,,,,2,1,2,3
9784_0,,,,2,1,2,3
9784_1,,,,2,1,2,3
9785_0,,,,2,1,2,3
9785_1,,,,2,1,2,3
9786_0,,,,2,1,2,3
9786_1,,,,2,1,2,3
9787_0,,,,2,1,2,3
9787_1,,,,2,1,2,3
9788_0,,,,2,1,2,3
9789_0,,,,2,1,2,3
9789_1,,,,2,1,2,3
9790_0,,,,2,1,2,3
9790_1,,,,2,1,2,3
9791_0,,,,2,1,2,3
9791_1,,,,2,1,2,3
9793_0,,,,2,1,2,3
C(CO)(C(CO)(C)O)=O,,,4,1,4,0,4
9793_1,,,,2,1,2,3
9794_0,,,,2,1,2,3
9794_1,,,,2,1,2,3
9795_0,,,,2,1,2,3
9796_0,,,,2,1,2,3
9796_1,,,,2,1,2,3
9797_0,,,,2,1,2,3
9797_1,,,,2,1,2,3
9799_0,,,,2,1,2,3
C(CC(C(CO)=O)=O)=O,,,4,1,2,0,2
9800_0,,,,2,1,2,3
9800_1,,,,2,1,2,3
9801_0,,,,2,1,2,3
9802_0,,,,2,1,2,3
9802_1,,,,2,1,2,3
9803_0,,,,2,1,2,3
9804_0,,,,2,1,2,3
9804_1,,,,2,1,2,3
9805_0,,,,2,1,2,3
9805_1,,,,2,1,2,3
9807_0,,,,2,1,1,2
C(C(CO)OC(C(C)=O)(CO)O)=O,,,4,1,2,0,2
9808_0,,,,2,1,2,3
9808_1,,,,2,1,2,3
9810_0,,,,2,1,1,2
C(C(COC(C(C)=O)(CO)O)O)=O,,,4,1,2,0,2
9811_0,,,,2,1,2,3
9811_1,,,,2,1,2,3
9812_0,,,,2,1,2,3
9812_1,,,,2,1,2,3
9814_0,,,,2,1,2,3
C(C(C=O)(CC=O)O)=O,,,4,1,3,0,3
9814_1,,,,2,1,2,3
9815_0,,,,2,1,2,3
9815_1,,,,2,1,2,3
9816_0,,,,2,1,2,3
9817_0,,,,2,1,2,3
9817_1,,,,2,1,2,3
9818_0,,,,2,1,2,3
9818_1,,,,2,1,2,3
9819_0,,,,2,1,2,3
9820_0,,,,2,1,2,3
9820_1,,,,2,1,2,3
9821_0,,,,2,1,2,3
9822_0,,,,2,1,2,3
9822_1,,,,2,1,2,3
9823_0,,,,2,1,2,3
9824_0,,,,2,1,2,3
9824_1,,,,2,1,2,3
9825_0,,,,2,1,2,3
9825_1,,,,2,1,2,3
9826_0,,,,2,1,2,3
9827_0,,,,2,1,2,3
9827_1,,,,2,1,2,3
9828_0,,,,2,1,2,3
9829_0,,,,2,1,2,3
9829_1,,,,2,1,2,3
9830_0,,,,2,1,2,3
9831_0,,,,2,1,2,3
9831_1,,,,2,1,2,3
9832_0,,,,2,1,2,3
9832_1,,,,2,1,2,3
9833_0,,,,2,1,2,3
9834_0,,,,2,1,2,3
9834_1,,,,2,1,2,3
9835_0,,,,2,1,2,3
9836_0,,,,2,1,2,3
9836_1,,,,2,1,2,3
9837_0,,,,2,1,2,3
9838_0,,,,2,1,2,3
9838_1,,,,2,1,2,3
9839_0,,,,2,1,2,3
9839_1,,,,2,1,2,3
9840_0,,,,2,1,2,3
9840_1,,,,2,1,2,3
9841_0,,,,2,1,1,2
9842_0,,,,2,1,2,3
9842_1,,,,2,1,2,3
9844_0,,,,2,1,2,3
C1(CCC(C1O)=O)=O,,,4,1,5,0,5
9845_0,,,,2,1,2,3
9845_1,,,,2,1,2,3
9846_0,,,,2,1,2,3
9847_0,,,,2,1,2,3
9847_1,,,,2,1,2,3
9847_2,,,,2,1,2,3
9848_0,,,,2,1,1,2
9849_0,,,,2,1,2,3
9849_1,,,,2,1,2,3
9851_0,,,,2,1,1,2
C(CC(OCC(C)=O)=O)=O,,,4,1,5,0,5
9851_1,,,,2,1,1,2
9853_0,,,,2,1,1,2
C(COCC(C=O)=O)(C)=O,,,4,1,4,0,4
9853_1,,,,2,1,1,2
9855_0,,,,2,1,1,2
C(OC(C(C)=O)C(C)=O)=O,,,4,1,2,0,2
9857_0,,,,2,1,1,2
C(OC(C(C)=O)CC=O)=O,,,4,1,2,0,2
9859_0,,,,2,1,2,3
C1(CCC(CO1)=O)=O,,,4,1,3,0,3
9859_1,,,,2,1,2,3
9861_0,,,,2,1,2,3
C1(COCC(C1)=O)=O,,,4,1,3,0,3
9861_1,,,,2,1,2,3
9863_0,,,,2,1,1,2
C(CC(C)=O)(OCC=O)=O,,,4,1,2,0,2
9864_0,,,,2,1,1,2
9866_0,,,,2,1,1,2
C(COCC(C(C)=O)=O)=O,,,4,1,2,0,2
9867_0,,,,2,1,1,2
9869_0,,,,2,1,1,2
C(OCCC(C(C)=O)=O)=O,,,4,1,2,0,2
9871_0,,,,2,1,1,2
C(OCC(CC(C)=O)=O)=O,,,4,1,2,0,2
9873_0,,,,2,1,1,2
C(C(C(CO)OCC=O)O)=O,,,4,1,2,0,2
9873_1,,,,2,1,1,2
9875_0,,,,2,1,2,3
C1(COC(CO)C1O)=O,,,4,1,2,0,2
9875_1,,,,2,1,2,3
9877_0,,,,2,1,2,3
C1(C(O)OC(CO)C1)=O,,,4,1,3,0,3
9877_1,,,,2,1,2,3
9879_0,,,,2,1,1,2
C(C)(C(CO)OC(CO)=O)=O,,,4,1,2,0,2
9881_0,,,,2,1,2,3
C1(COC(CO)(C1)O)=O,,,4,1,3,0,3
9881_1,,,,2,1,2,3
9883_0,,,,2,1,2,3
C1(C(OCC1)=O)=O,,,4,1,3,0,3
9885_0,,,,2,1,2,3
C1(CC(CO1)=O)=O,,,4,1,5,0,5
9886_0,,,,2,1,1,2
9888_0,,,,2,1,1,2
C(C(CC=O)OCC=O)=O,,,4,1,3,0,3
9888_1,,,,2,1,1,2
9890_0,,,,2,1,1,2
C(C(C(C)=O)OC(C)=O)=O,,,4,1,1,0,1
9892_0,,,,2,1,1,2
C(COC(C(C=O)=O)C)=O,,,4,1,3,0,3
9892_1,,,,2,1,1,2
9894_0,,,,2,1,1,2
C(C(C(COCC=O)O)O)=O,,,4,1,2,0,2
9894_1,,,,2,1,1,2
9896_0,,,,2,1,2,3
C1(COCC(C1O)O)=O,,,4,1,2,0,2
9896_1,,,,2,1,2,3
9898_0,,,,2,1,1,2
C(COC(C(CO)=O)CO)=O,,,4,1,2,0,2
9898_1,,,,2,1,1,2
9900_0,,,,2,1,2,3
C1(C(O)OCC(C1)O)=O,,,4,1,3,0,3
9900_1,,,,2,1,2,3
9902_0,,,,2,1,1,2
C(C)(C(CO)(OCC=O)O)=O,,,4,1,1,0,1
9904_0,,,,2,1,1,2
C(C)(C(COC(CO)=O)O)=O,,,4,1,2,0,2
9906_0,,,,2,1,1,2
C(CO)(CCOC(CO)=O)=O,,,4,1,3,0,3
9906_1,,,,2,1,1,2
9908_0,,,,2,1,1,2
C(C(CO)(OCC(C)=O)O)=O,,,4,1,1,0,1
9910_0,,,,2,1,1,2
C(C)(CCOC(C=O)=O)=O,,,4,1,1,0,1
9912_0,,,,2,1,1,2
C(OC(C=O)CC(C)=O)=O,,,4,1,1,0,1
9913_0,,,,2,1,2,3
9913_1,,,,2,1,2,3
9915_0,,,,2,1,1,2
C(C(C=O)O)(OCC(C)=O)=O,,,4,1,3,0,3
9915_1,,,,2,1,1,2
9917_0,,,,2,1,1,2
C(C(CO)OC(C(C)=O)=O)=O,,,4,1,1,0,1
9919_0,,,,2,1,1,2
C(C)(C(CO)OC(C=O)=O)=O,,,4,1,1,0,1
9921_0,,,,2,1,2,3
C1(C(CC(CO1)=O)O)=O,,,4,1,3,0,3
9921_1,,,,2,1,2,3
9923_0,,,,2,1,1,2
C(C(COC(C(C)=O)=O)O)=O,,,4,1,1,0,1
9925_0,,,,2,1,1,2
C(CC(CO)=O)(OCC=O)=O,,,4,1,2,0,2
9925_1,,,,2,1,1,2
9927_0,,,,2,1,1,2
C(C(C(C)=O)O)(OCC=O)=O,,,4,1,1,0,1
9929_0,,,,2,1,1,2
C(C)(C(COC(C=O)=O)O)=O,,,4,1,1,0,1
9931_0,,,,2,1,1,2
C(CO)(CCOC(C=O)=O)=O,,,4,1,2,0,2
9931_1,,,,2,1,1,2
9932_0,,,,2,1,1,2
9934_0,,,,2,1,1,2
C(C=C(C(CO)=O)CO)=O,,,4,1,3,0,3
9934_1,,,,2,1,1,2
9935_0,,,,2,1,2,3
9937_0,,,,2,1,1,2
C(C(C(C(CO)=O)=C)O)=O,,,4,1,3,0,3
9937_1,,,,2,1,1,2
9938_0,,,,2,1,1,2
9939_0,,,,2,1,1,2
9941_0,,,,2,1,2,3
C(C(C=C)O)=O,,,4,1,5,0,5
9941_1,,,,2,1,2,3
9942_0,,,,2,1,1,2
9942_1,,,,2,1,1,2
9944_0,,,,2,1,2,3
C1OCC(C=1)=O,,,4,1,3,0,3
9944_1,,,,2,1,2,3
9946_0,,,,2,1,2,3
C1C(O)OCC(C=1)=O,,,4,1,3,0,3
9946_1,,,,2,1,2,3
9948_0,,,,2,1,1,2
C(COC=CC(CO)=O)=O,,,4,1,3,0,3
9948_1,,,,2,1,1,2
9950_0,,,,2,1,1,2
C(OCC=CC(CO)=O)=O,,,4,1,3,0,3
9950_1,,,,2,1,1,2
9952_0,,,,2,1,2,3
C1COC(C=1)=O,,,4,1,3,0,3
9952_1,,,,2,1,2,3
9954_0,,,,2,1,1,2
C(COC(CO)=CC=O)=O,,,4,1,3,0,3
9954_1,,,,2,1,1,2
9956_0,,,,2,1,1,2
C(C(C(OCC=O)=C)O)=O,,,4,1,3,0,3
9956_1,,,,2,1,1,2
9958_0,,,,2,1,1,2
C(COC(C=CC=O)O)=O,,,4,1,3,0,3
9958_1,,,,2,1,1,2
9960_0,,,,2,1,1,2
C(C(C=COCC=O)O)=O,,,4,1,3,0,3
9960_1,,,,2,1,1,2
9962_0,,,,2,1,1,2
C(C(C(CO)OC(C=O)O)O)=O,,,4,1,2,0,2
9962_1,,,,2,1,1,2
9964_0,,,,2,1,1,2
C(CC(CO)OC(C=O)O)=O,,,4,1,2,0,2
9964_1,,,,2,1,1,2
9966_0,,,,2,1,1,2
C(C(CO)O)(OCC(C)=O)=O,,,4,1,1,0,1
9968_0,,,,2,1,1,2
C(CCO)(OCC(CO)=O)=O,,,4,1,2,0,2
9968_1,,,,2,1,1,2
9970_0,,,,2,1,1,2
C(OC(C(CO)=O)CCO)=O,,,4,1,2,0,2
9970_1,,,,2,1,1,2
9972_0,,,,2,1,2,3
C1(C(CCO1)O)=O,,,4,1,4,0,4
9972_1,,,,2,1,2,3
9974_0,,,,2,1,1,2
C(C(CO)OC(C(CO)=O)O)=O,,,4,1,2,0,2
9974_1,,,,2,1,1,2
9976_0,,,,2,1,1,2
C(C(C(COC(C=O)O)O)O)=O,,,4,1,2,0,2
9976_1,,,,2,1,1,2
9978_0,,,,2,1,1,2
C(CC(COC(C=O)O)O)=O,,,4,1,2,0,2
9978_1,,,,2,1,1,2
9980_0,,,,2,1,1,2
C(CC(C(OCC=O)O)O)=O,,,4,1,2,0,2
9980_1,,,,2,1,1,2
9982_0,,,,2,1,1,2
C(C(C)(OCC(CO)=O)O)=O,,,4,1,2,0,2
9982_1,,,,2,1,1,2
9984_0,,,,2,1,1,2
C(CO)(C(C)OC(C=O)O)=O,,,4,1,2,0,2
9984_1,,,,2,1,1,2
9986_0,,,,2,1,1,2
C(C(COC(C(CO)=O)O)O)=O,,,4,1,2,0,2
9986_1,,,,2,1,1,2
9987_0,,,,2,1,1,2
9987_1,,,,2,1,1,2
9989_0,,,,2,1,1,2
C(CC(C=O)O)(OCC=O)=O,,,4,1,2,0,2
9989_1,,,,2,1,1,2
9991_0,,,,2,1,2,3
C(CC(C=O)CC(CO)=O)=O,,,4,1,5,0,5
9991_1,,,,2,1,2,3
9993_0,,,,2,1,2,3
C(CC(C(CO)=O)CC=O)=O,,,4,1,3,0,3
9993_1,,,,2,1,2,3
9995_0,,,,2,1,2,3
C(CCCC(C=O)=O)=O,,,4,1,3,0,3
9995_1,,,,2,1,2,3
9997_0,,,,2,1,2,3
C(CCCC(CO)=O)=O,,,4,1,3,0,3
9997_1,,,,2,1,2,3
9999_0,,,,2,1,2,3
C(CC(C=O)CC=O)=O,,,4,1,4,0,4
9999_1,,,,2,1,2,3
10000_0,,,,2,1,1,2
10001_0,,,,2,1,1,2
10002_0,,,,2,1,1,2
10003_0,,,,2,1,1,2
10005_0,,,,2,1,1,2
C1(C(C(CC1(CO)O)O)O)=O,,,4,1,3,0,3
10006_0,,,,2,1,1,2
10007_0,,,,2,1,1,2
10008_0,,,,2,1,1,2
10009_0,,,,2,1,1,2
10010_0,,,,2,1,1,2
10011_0,,,,2,1,1,2
10013_0,,,,2,1,1,2
C1(CCC(C(C1O)=O)O)=O,,,4,1,3,0,3
10015_0,,,,2,1,1,2
C(C1(C(C(CC1)O)=O)O)=O,,,4,1,1,0,1
10017_0,,,,2,1,1,2
C1(C(CC(C(C1)=O)O)O)=O,,,4,1,2,0,2
10018_0,,,,2,1,1,2
10019_0,,,,2,1,1,2
10020_0,,,,2,1,1,2
10021_0,,,,2,1,1,2
10022_0,,,,2,1,1,2
10023_0,,,,2,1,1,2
10024_0,,,,2,1,1,2
10026_0,,,,2,1,1,2
C1(C(C(CO)C(C(C1O)O)O)O)=O,,,4,1,1,0,1
10027_0,,,,2,1,1,2
10028_0,,,,2,1,1,2
10030_0,,,,2,1,1,2
C(C(C(C(CO)O)=O)(C)O)=O,,,4,1,1,0,1
10032_0,,,,2,1,1,2
C(C(C)(C(C(C=O)O)O)O)=O,,,4,1,3,0,3
10033_0,,,,2,1,1,2
10034_0,,,,2,1,1,2
10035_0,,,,2,1,1,2
10036_0,,,,2,1,1,2
10037_0,,,,2,1,1,2
10038_0,,,,2,1,1,2
10039_0,,,,2,1,1,2
10040_0,,,,2,1,1,2
10041_0,,,,2,1,1,2
10042_0,,,,2,1,1,2
10044_0,,,,2,1,1,2
C(C(C)(C(C=O)O)O)(C(CO)O)=O,,,4,1,1,0,1
10045_0,,,,2,1,1,2
10046_0,,,,2,1,1,2
10047_0,,,,2,1,1,2
10049_0,,,,2,1,1,2
C(C(C(CC(CO)(CO)O)O)=O)=O,,,4,1,1,0,1
10050_0,,,,2,1,1,2
10051_0,,,,2,1,1,2
10052_0,,,,2,1,1,2
10054_0,,,,2,1,1,2
C(C(CO)O)(C(C)(C(CO)O)O)=O,,,4,1,1,0,1
10056_0,,,,2,1,1,2
C(C(C(C(C)(C(CO)O)O)O)O)=O,,,4,1,4,0,4
10058_0,,,,2,1,1,2
C(CO)(C(CC(CO)(CO)O)O)=O,,,4,1,2,0,2
10059_0,,,,2,1,1,2
10060_0,,,,2,1,1,2
10062_0,,,,2,1,1,2
C(C(CCO)O)(C(C(CO)=O)O)=O,,,4,1,1,0,1
10064_0,,,,2,1,1,2
C(C(C(C(CO)O)=O)(CCO)O)=O,,,4,1,1,0,1
10066_0,,,,2,1,1,2
C(C(C(C(C=O)O)O)(CCO)O)=O,,,4,1,4,0,4
10068_0,,,,2,1,1,2
C(C(CO)O)(C(CO)(CCO)O)=O,,,4,1,4,0,4
10070_0,,,,2,1,1,2
C(C(C(C(CO)(CCO)O)O)O)=O,,,4,1,2,0,2
10072_0,,,,2,1,1,2
C(C(CCO)O)(C(CO)(CO)O)=O,,,4,1,5,0,5
10074_0,,,,2,1,1,2
C(C(C(CO)C(CO)(CO)O)O)=O,,,4,1,2,0,2
10075_0,,,,2,1,1,2
10076_0,,,,2,1,1,2
10077_0,,,,2,1,1,2
10079_0,,,,2,1,1,2
C(C(CO)O)(C(CO)(C)O)=O,,,4,1,1,0,1
10081_0,,,,2,1,1,2
C(C(C(C(CO)(C)O)O)O)=O,,,4,1,2,0,2
10083_0,,,,2,1,1,2
C(C(CC(CO)(CO)O)O)=O,,,4,1,1,0,1
10085_0,,,,2,1,1,2
C(C(C)O)(C(CO)(CO)O)=O,,,4,1,1,0,1
10086_0,,,,2,1,1,2
10087_0,,,,2,1,1,2
10088_0,,,,2,1,1,2
10089_0,,,,2,1,1,2
10090_0,,,,2,1,1,2
10091_0,,,,2,1,1,2
10092_0,,,,2,1,1,2
10093_0,,,,2,1,1,2
10094_0,,,,2,1,1,2
10095_0,,,,2,1,1,2
10096_0,,,,2,1,1,2
10098_0,,,,2,1,1,2
C(C(C(CC(C(CO)O)O)O)=O)=O,,,4,1,1,0,1
10100_0,,,,2,1,1,2
C(CO)(C(CC(C(CO)O)O)O)=O,,,4,1,1,0,1
10102_0,,,,2,1,1,2
C(C(CCO)O)(C(C(CO)O)O)=O,,,4,1,1,0,1
10104_0,,,,2,1,1,2
C(C(C(CO)C(C(CO)O)O)O)=O,,,4,1,2,0,2
10105_0,,,,2,1,1,2
10106_0,,,,2,1,1,2
10108_0,,,,2,1,1,2
C(C(C)O)(C(C=O)C(CO)=O)=O,,,4,1,1,0,1
10109_0,,,,2,1,1,2
10110_0,,,,2,1,1,2
10112_0,,,,2,1,1,2
C(CC(C(C(C(C)O)=O)O)=O)=O,,,4,1,1,0,1
10114_0,,,,2,1,1,2
C(CC(C(C(C(C)=O)O)=O)O)=O,,,4,1,1,0,1
10116_0,,,,2,1,1,2
C(CC(C(C(C=O)(C)O)=O)O)=O,,,4,1,1,0,1
10117_0,,,,2,1,1,2
10118_0,,,,2,1,1,2
10120_0,,,,2,1,1,2
C(C(C=O)O)(CC(C(C)O)=O)=O,,,4,1,1,0,1
10121_0,,,,2,1,1,2
10123_0,,,,2,1,1,2
C(C)(C(CC(C(C=O)=O)O)O)=O,,,4,1,1,0,1
10124_0,,,,2,1,1,2
10126_0,,,,2,1,1,2
C(C(C)(CC(C(C=O)=O)O)O)=O,,,4,1,1,0,1
10127_0,,,,2,1,1,2
10129_0,,,,2,1,1,2
C(C(CO)O)(CC(C(C)O)=O)=O,,,4,1,1,0,1
10131_0,,,,2,1,1,2
C(C)(C(CC(C(CO)=O)O)O)=O,,,4,1,1,0,1
10133_0,,,,2,1,1,2
C(C(C)(CC(C(CO)=O)O)O)=O,,,4,1,1,0,1
10135_0,,,,2,1,1,2
C(C(CCO)O)(CC(C=O)=O)=O,,,4,1,1,0,1
10136_0,,,,2,1,1,2
10138_0,,,,2,1,1,2
C(CCO)(C(C(C(C)O)=O)O)=O,,,4,1,1,0,1
10140_0,,,,2,1,1,2
C(C(CCO)O)(C(C(C)=O)O)=O,,,4,1,1,0,1
10142_0,,,,2,1,1,2
C(C(C(C(CCO)O)=O)(C)O)=O,,,4,1,1,0,1
10144_0,,,,2,1,1,2
C(C(C)O)(C(C(CO)=O)CO)=O,,,4,1,1,0,1
10146_0,,,,2,1,1,2
C(C(C(CO)C(C(C)=O)O)O)=O,,,4,1,2,0,2
10148_0,,,,2,1,1,2
C(C(C)(C(CO)C(C=O)O)O)=O,,,4,1,2,0,2
10149_0,,,,2,1,1,2
10151_0,,,,2,1,1,2
C(C(C)O)(CC(CO)=O)=O,,,4,1,3,0,3
10153_0,,,,2,1,1,2
C(C(CC(C(C)=O)O)O)=O,,,4,1,2,0,2
10155_0,,,,2,1,1,2
C(C(C)(CC(C=O)O)O)=O,,,4,1,1,0,1
10157_0,,,,2,1,1,2
C(C(C)O)(C(C(C)=O)O)=O,,,4,1,2,0,2
10159_0,,,,2,1,1,2
C(C(C(C(C)O)=O)(C)O)=O,,,4,1,1,0,1
10160_0,,,,2,1,1,2
10162_0,,,,2,1,1,2
C(C(C)O)(C(C=O)C(C=O)O)=O,,,4,1,2,0,2
10163_0,,,,2,1,1,2
10164_0,,,,2,1,1,2
10165_0,,,,2,1,1,2
10167_0,,,,2,1,1,2
C(CC(C(C)O)=O)=O,,,4,1,1,0,1
10168_0,,,,2,1,1,2
10169_0,,,,2,1,1,2
10170_0,,,,2,1,1,2
10172_0,,,,2,1,1,2
C(C(C(C(C(CO)O)O)=O)(C)O)=O,,,4,1,1,0,1
10174_0,,,,2,1,1,2
C(C(C)(C(C(C(CO)=O)O)O)O)=O,,,4,1,2,0,2
10175_0,,,,2,1,1,2
10177_0,,,,2,1,1,2
C(C(C(CO)=O)C(CO)=O)=O,,,4,1,1,0,1
10179_0,,,,2,1,1,2
C(C(C(C(CC=O)O)=O)O)=O,,,4,1,3,0,3
10181_0,,,,2,1,1,2
C(CC(C(C(CO)=O)O)=O)=O,,,4,1,2,0,2
10182_0,,,,2,1,1,2
10183_0,,,,2,1,1,2
10184_0,,,,2,1,1,2
10185_0,,,,2,1,1,2
10186_0,,,,2,1,1,2
10187_0,,,,2,1,1,2
10188_0,,,,2,1,1,2
10190_0,,,,2,1,1,2
C(CC(C(C(CO)(C)O)=O)O)=O,,,4,1,1,0,1
10191_0,,,,2,1,1,2
10192_0,,,,2,1,1,2
10193_0,,,,2,1,1,2
10194_0,,,,2,1,1,2
10196_0,,,,2,1,1,2
C(C(CO)(CC=O)O)(C(C)O)=O,,,4,1,1,0,1
10197_0,,,,2,1,1,2
10198_0,,,,2,1,1,2
10199_0,,,,2,1,1,2
10200_0,,,,2,1,1,2
10201_0,,,,2,1,1,2
10203_0,,,,2,1,1,2
C(C(C=O)O)(CC(CO)=O)=O,,,4,1,4,0,4
10204_0,,,,2,1,1,2
10205_0,,,,2,1,1,2
10206_0,,,,2,1,1,2
10208_0,,,,2,1,1,2
C(C(C(CC(C(C=O)=O)O)O)O)=O,,,4,1,1,0,1
10209_0,,,,2,1,1,2
10210_0,,,,2,1,1,2
10212_0,,,,2,1,1,2
C(C(C(CC(CO)(C)O)O)=O)=O,,,4,1,1,0,1
10213_0,,,,2,1,1,2
10215_0,,,,2,1,1,2
C(C(CC(C)(C(C=O)O)O)O)=O,,,4,1,1,0,1
10216_0,,,,2,1,1,2
10217_0,,,,2,1,1,2
10219_0,,,,2,1,1,2
C(C(C)(C(C=O)O)O)(C(C)O)=O,,,4,1,1,0,1
10220_0,,,,2,1,1,2
10222_0,,,,2,1,1,2
C(C(C(CC(C)O)O)=O)=O,,,4,1,1,0,1
10223_0,,,,2,1,1,2
10224_0,,,,2,1,1,2
10225_0,,,,2,1,1,2
10227_0,,,,2,1,1,2
C(C(C(C(C=O)O)C(C=O)O)O)=O,,,4,1,1,0,1
10228_0,,,,2,1,1,2
10229_0,,,,2,1,1,2
10231_0,,,,2,1,1,2
C(C(C(C(CC(C=O)O)O)=O)O)=O,,,4,1,1,0,1
10233_0,,,,2,1,1,2
C(CO)(C(C(C=O)=O)CO)=O,,,4,1,2,0,2
10234_0,,,,2,1,1,2
10236_0,,,,2,1,1,2
C(C(C(CO)C(C=O)O)O)=O,,,4,1,2,0,2
10237_0,,,,2,1,1,2
10239_0,,,,2,1,1,2
C(C(CO)O)(C(C(CO)=O)O)=O,,,4,1,1,0,1
10240_0,,,,2,1,1,2
10241_0,,,,2,1,1,2
10242_0,,,,2,1,1,2
10243_0,,,,2,1,1,2
10244_0,,,,2,1,1,2
10246_0,,,,2,1,1,2
C(CO)(C(CC(CO)(C)O)O)=O,,,4,1,1,0,1
10248_0,,,,2,1,1,2
C(C(CC(C)(C(CO)O)O)O)=O,,,4,1,1,0,1
10250_0,,,,2,1,1,2
C(C(C)O)(C(C)(C(CO)O)O)=O,,,4,1,1,0,1
10252_0,,,,2,1,1,2
C(CO)(C(CC(C)O)O)=O,,,4,1,1,0,1
10253_0,,,,2,1,1,2
10255_0,,,,2,1,1,2
C(C(C(C(C)O)C(C=O)O)O)=O,,,4,1,1,0,1
10256_0,,,,2,1,1,2
10258_0,,,,2,1,1,2
C(C(CC(C(C(C)O)=O)O)O)=O,,,4,1,2,0,2
10259_0,,,,2,1,1,2
10260_0,,,,2,1,1,2
10262_0,,,,2,1,1,2
C(C(C(CO)CO)O)=O,,,4,1,2,0,2
10263_0,,,,2,1,1,2
10264_0,,,,2,1,1,2
10265_0,,,,2,1,1,2
10266_0,,,,2,1,1,2
10267_0,,,,2,1,1,2
10268_0,,,,2,1,1,2
10269_0,,,,2,1,1,2
10270_0,,,,2,1,1,2
10271_0,,,,2,1,1,2
10272_0,,,,2,1,1,2
10273_0,,,,2,1,1,2
10274_0,,,,2,1,1,2
10275_0,,,,2,1,1,2
10276_0,,,,2,1,1,2
10277_0,,,,2,1,1,2
10278_0,,,,2,1,1,2
10279_0,,,,2,1,1,2
10281_0,,,,2,1,1,2
C(C(CO)=O)(C(C(CO)CO)O)=O,,,4,1,1,0,1
10282_0,,,,2,1,1,2
10283_0,,,,2,1,1,2
10284_0,,,,2,1,1,2
10285_0,,,,2,1,1,2
10286_0,,,,2,1,1,2
10288_0,,,,2,1,1,2
C(C(C(CO)C(C(CO)=O)O)O)=O,,,4,1,2,0,2
10289_0,,,,2,1,1,2
10290_0,,,,2,1,1,2
10292_0,,,,2,1,1,2
C(CO)(C(CC(C(CO)=O)O)O)=O,,,4,1,1,0,1
10293_0,,,,2,1,1,2
10294_0,,,,2,1,1,2
10295_0,,,,2,1,1,2
10296_0,,,,2,1,1,2
10298_0,,,,2,1,1,2
C(C(C(CO)CO)O)(C(CO)O)=O,,,4,1,2,0,2
10300_0,,,,2,1,1,2
C(CO)(C(C(CO)C(CO)O)O)=O,,,4,1,1,0,1
10301_0,,,,2,1,1,2
10303_0,,,,2,1,1,2
C(C(C(CO)CC(C=O)=O)O)=O,,,4,1,1,0,1
10305_0,,,,2,1,1,2
C(CO)(C(CCC(C=O)=O)O)=O,,,4,1,2,0,2
10306_0,,,,2,1,1,2
10307_0,,,,2,1,1,2
10308_0,,,,2,1,1,2
10309_0,,,,2,1,1,2
10310_0,,,,2,1,1,2
10311_0,,,,2,1,1,2
10313_0,,,,2,1,1,2
C(CC(C(C(CCO)O)=O)=O)=O,,,4,1,1,0,1
10314_0,,,,2,1,1,2
10315_0,,,,2,1,1,2
10316_0,,,,2,1,1,2
10317_0,,,,2,1,1,2
10318_0,,,,2,1,1,2
10319_0,,,,2,1,1,2
10320_0,,,,2,1,1,2
10322_0,,,,2,1,1,2
C(CC(CO)C(C(C=O)=O)O)=O,,,4,1,1,0,1
10323_0,,,,2,1,1,2
10324_0,,,,2,1,1,2
10325_0,,,,2,1,1,2
10326_0,,,,2,1,1,2
10327_0,,,,2,1,1,2
10328_0,,,,2,1,1,2
10330_0,,,,2,1,1,2
C1(C(C(CO)O)OC(CO)C1O)=O,,,4,1,1,0,1
10332_0,,,,2,1,1,2
C1(C(C(CO)C(C(CO)O)O1)O)=O,,,4,1,1,0,1
10334_0,,,,2,1,1,2
C1(C(C(CO)OC(CO)C1O)O)=O,,,4,1,1,0,1
10336_0,,,,2,1,1,2
C1(C(C(CO)C(C(CO)O1)O)O)=O,,,4,1,1,0,1
10338_0,,,,2,1,1,2
C1(C(CO)OC(C(CO)C1O)O)=O,,,4,1,2,0,2
10340_0,,,,2,1,1,2
C1(C(O)OC(CO)C(CO)C1O)=O,,,4,1,1,0,1
10342_0,,,,2,1,1,2
C1(C(C(COC(CO)C1O)O)O)=O,,,4,1,1,0,1
10344_0,,,,2,1,1,2
C1(C(C(CO)C(C(CO1)O)O)O)=O,,,4,1,1,0,1
10346_0,,,,2,1,1,2
C1(C(C(C(O)OCC1O)CO)O)=O,,,4,1,2,0,2
10348_0,,,,2,1,1,2
C1(C(O)OCC(C(CO)C1O)O)=O,,,4,1,1,0,1
10350_0,,,,2,1,1,2
C1(COC(C(C(CO)C1O)O)O)=O,,,4,1,1,0,1
10352_0,,,,2,1,1,2
C1(C(C(COC(C1O)O)CO)O)=O,,,4,1,1,0,1
10353_0,,,,2,1,1,2
10355_0,,,,2,1,1,2
C(C(C=CC(C(CO)=O)O)O)=O,,,4,1,2,0,2
10356_0,,,,2,1,1,2
10358_0,,,,2,1,1,2
C(C(CCO)O)(CC(CO)=O)=O,,,4,1,1,0,1
10360_0,,,,2,1,1,2
C(C(CC(C=O)O)O)(CCO)=O,,,4,1,1,0,1
10362_0,,,,2,1,1,2
C(C(CC(C=O)O)(CCO)O)=O,,,4,1,1,0,1
10364_0,,,,2,1,1,2
C(C(C(C(C)O)=O)(CCO)O)=O,,,4,1,1,0,1
10365_0,,,,2,1,1,2
10367_0,,,,2,1,1,2
C(C(C(C=O)O)O)(C(CCO)O)=O,,,4,1,1,0,1
10368_0,,,,2,1,1,2
10369_0,,,,2,1,1,2
10370_0,,,,2,1,1,2
10372_0,,,,2,1,1,2
C(C(CCO)O)(C(CO)(C)O)=O,,,4,1,1,0,1
10374_0,,,,2,1,1,2
C(C(C(CO)C(CO)(C)O)O)=O,,,4,1,2,0,2
10376_0,,,,2,1,1,2
C(C(CC(CO)(CCO)O)O)=O,,,4,1,2,0,2
10378_0,,,,2,1,1,2
C(C(C)O)(C(CO)(CCO)O)=O,,,4,1,1,0,1
10380_0,,,,2,1,1,2
C(C(CCO)O)(C(C)O)=O,,,4,1,1,0,1
10382_0,,,,2,1,1,2
C(C(C(CO)C(C)O)O)=O,,,4,1,2,0,2
10383_0,,,,2,1,1,2
10385_0,,,,2,1,1,2
C(C(C(C(CC(C)O)O)=O)O)=O,,,4,1,1,0,1
10386_0,,,,2,1,1,2
10387_0,,,,2,1,1,2
10388_0,,,,2,1,1,2
10389_0,,,,2,1,1,2
10390_0,,,,2,1,1,2
10392_0,,,,2,1,1,2
C(C(CC(CO)(C)O)O)=O,,,4,1,1,0,1
10394_0,,,,2,1,1,2
C(C(C)O)(C(CO)(C)O)=O,,,4,1,1,0,1
10396_0,,,,2,1,1,2
C(C(CC(CC(C=O)O)O)O)=O,,,4,1,1,0,1
10397_0,,,,2,1,1,2
10398_0,,,,2,1,1,2
10399_0,,,,2,1,1,2
10400_0,,,,2,1,1,2
10401_0,,,,2,1,1,2
10402_0,,,,2,1,1,2
10403_0,,,,2,1,1,2
10404_0,,,,2,1,1,2
10406_0,,,,2,1,1,2
C(C(CC(C)O)O)=O,,,4,1,1,0,1
10408_0,,,,2,1,1,2
C(C(C)O)(C(C)O)=O,,,4,1,1,0,1
10410_0,,,,2,1,1,2
C(C(CC(CO)(C(CO)O)O)O)=O,,,4,1,3,0,3
10412_0,,,,2,1,1,2
C(C(C)O)(C(CO)(C(CO)O)O)=O,,,4,1,4,0,4
10414_0,,,,2,1,1,2
C(C(C(CO)O)O)(C(CO)(C)O)=O,,,4,1,3,0,3
10416_0,,,,2,1,1,2
C(CO)(C(C(C(CO)(C)O)O)O)=O,,,4,1,1,0,1
10417_0,,,,2,1,1,2
10418_0,,,,2,1,1,2
10419_0,,,,2,1,1,2
10420_0,,,,2,1,1,2
10422_0,,,,2,1,1,2
C(CC(C(CC=O)=O)O)(CCO)=O,,,4,1,1,0,1
10424_0,,,,2,1,1,2
C(C(CCC(CO)=O)O)(CC=O)=O,,,4,1,2,0,2
10425_0,,,,2,1,1,2
10426_0,,,,2,1,1,2
10427_0,,,,2,1,1,2
10429_0,,,,2,1,1,2
C(C(C(C(C)O)CC(C=O)=O)O)=O,,,4,1,1,0,1
10431_0,,,,2,1,1,2
C(C(CCC(C=O)=O)O)(C(C)O)=O,,,4,1,2,0,2
10433_0,,,,2,1,1,2
C(C(CC(C(C)=O)O)O)(CC=O)=O,,,4,1,1,0,1
10434_0,,,,2,1,1,2
10435_0,,,,2,1,1,2
10436_0,,,,2,1,1,2
10438_0,,,,2,1,1,2
C(C(CC(C)O)O)(CC(C=O)=O)=O,,,4,1,1,0,1
10439_0,,,,2,1,1,2
10440_0,,,,2,1,1,2
10441_0,,,,2,1,1,2
10442_0,,,,2,1,1,2
10443_0,,,,2,1,1,2
10444_0,,,,2,1,1,2
10445_0,,,,2,1,1,2
10446_0,,,,2,1,1,2
10447_0,,,,2,1,1,2
10448_0,,,,2,1,1,2
10449_0,,,,2,1,1,2
10450_0,,,,2,1,1,2
10451_0,,,,2,1,1,2
10453_0,,,,2,1,1,2
C(CC(C(C(CC(C)O)O)=O)=O)=O,,,4,1,1,0,1
10454_0,,,,2,1,1,2
10455_0,,,,2,1,1,2
10456_0,,,,2,1,1,2
10457_0,,,,2,1,1,2
10458_0,,,,2,1,1,2
10459_0,,,,2,1,1,2
10460_0,,,,2,1,1,2
10461_0,,,,2,1,1,2
10462_0,,,,2,1,1,2
10463_0,,,,2,1,1,2
10464_0,,,,2,1,1,2
10465_0,,,,2,1,1,2
10466_0,,,,2,1,1,2
10467_0,,,,2,1,1,2
10468_0,,,,2,1,1,2
10469_0,,,,2,1,1,2
10471_0,,,,2,1,1,2
C(CC(C(C)O)C(C(C=O)=O)O)=O,,,4,1,1,0,1
10472_0,,,,2,1,1,2
10473_0,,,,2,1,1,2
10474_0,,,,2,1,1,2
10475_0,,,,2,1,1,2
10476_0,,,,2,1,1,2
10477_0,,,,2,1,1,2
10478_0,,,,2,1,1,2
10479_0,,,,2,1,1,2
10480_0,,,,2,1,1,2
10481_0,,,,2,1,1,2
10483_0,,,,2,1,1,2
C(CC(C(C=CC(CO)O)O)=O)=O,,,4,1,1,0,1
10484_0,,,,2,1,1,2
10485_0,,,,2,1,1,2
10486_0,,,,2,1,1,2
10487_0,,,,2,1,1,2
10488_0,,,,2,1,1,2
10489_0,,,,2,1,1,2
10490_0,,,,2,1,1,2
10491_0,,,,2,1,1,2
10493_0,,,,2,1,1,2
C(C(C=CC(C(C(C)O)=O)O)O)=O,,,4,1,1,0,1
10494_0,,,,2,1,1,2
10495_0,,,,2,1,1,2
10496_0,,,,2,1,1,2
10497_0,,,,2,1,1,2
10498_0,,,,2,1,1,2
10500_0,,,,2,1,1,2
C(C(C(CO)=O)(C)O)=O,,,4,1,1,0,1
10501_0,,,,2,1,1,2
10502_0,,,,2,1,1,2
10503_0,,,,2,1,1,2
10505_0,,,,2,1,1,2
C(CO)(C(C)(C(CO)O)O)=O,,,4,1,2,0,2
10506_0,,,,2,1,1,2
10507_0,,,,2,1,1,2
10508_0,,,,2,1,1,2
10510_0,,,,2,1,1,2
C(C(C(C(CO)O)C(C=O)O)O)=O,,,4,1,1,0,1
10511_0,,,,2,1,1,2
10512_0,,,,2,1,1,2
10514_0,,,,2,1,1,2
C(C(C(CO)=O)(CCO)O)=O,,,4,1,1,0,1
10516_0,,,,2,1,1,2
C(CO)(C(CO)(CCO)O)=O,,,4,1,1,0,1
10518_0,,,,2,1,1,2
C(C(C(CO)C(CO)O)O)=O,,,4,1,2,0,2
10520_0,,,,2,1,1,2
C(C(C(C(C(CO)=O)(C)O)O)O)=O,,,4,1,2,0,2
10521_0,,,,2,1,1,2
10522_0,,,,2,1,1,2
10524_0,,,,2,1,1,2
C(C(C(C(CC(CO)O)O)=O)O)=O,,,4,1,1,0,1
10525_0,,,,2,1,1,2
10526_0,,,,2,1,1,2
10528_0,,,,2,1,1,2
C(C(CC(CO)O)O)=O,,,4,1,3,0,3
10529_0,,,,2,1,1,2
10530_0,,,,2,1,1,2
10531_0,,,,2,1,1,2
10532_0,,,,2,1,1,2
10533_0,,,,2,1,1,2
10535_0,,,,2,1,1,2
C(C(CC(C(C(CO)O)O)O)O)=O,,,4,1,3,0,3
10536_0,,,,2,1,1,2
10537_0,,,,2,1,1,2
10538_0,,,,2,1,1,2
10540_0,,,,2,1,1,2
C(C(C(C(CO)C(CO)O)O)=O)=O,,,4,1,1,0,1
10541_0,,,,2,1,1,2
10542_0,,,,2,1,1,2
10543_0,,,,2,1,1,2
10545_0,,,,2,1,1,2
C(C(C(C(C(CO)CO)O)=O)O)=O,,,4,1,1,0,1
10546_0,,,,2,1,1,2
10547_0,,,,2,1,1,2
10548_0,,,,2,1,1,2
10549_0,,,,2,1,1,2
10550_0,,,,2,1,1,2
10551_0,,,,2,1,1,2
10553_0,,,,2,1,1,2
C(C(C(C(CCO)=O)=O)O)=O,,,4,1,2,0,2
10554_0,,,,2,1,1,2
10555_0,,,,2,1,1,2
10556_0,,,,2,1,1,2
10558_0,,,,2,1,1,2
C(C(C(C(C(C)=O)O)=O)O)=O,,,4,1,2,0,2
10559_0,,,,2,1,1,2
10560_0,,,,2,1,1,2
10561_0,,,,2,1,1,2
10562_0,,,,2,1,1,2
10563_0,,,,2,1,1,2
10564_0,,,,2,1,1,2
10565_0,,,,2,1,1,2
10566_0,,,,2,1,1,2
10567_0,,,,2,1,1,2
10568_0,,,,2,1,1,2
10569_0,,,,2,1,1,2
10570_0,,,,2,1,1,2
10571_0,,,,2,1,1,2
10572_0,,,,2,1,1,2
10573_0,,,,2,1,1,2
10574_0,,,,2,1,1,2
10575_0,,,,2,1,1,2
10576_0,,,,2,1,1,2
10578_0,,,,2,1,1,2
C(C(C(C)O)=O)(O)=O,,,4,1,2,0,2
10579_0,,,,2,1,1,2
10580_0,,,,2,1,1,2
10581_0,,,,2,1,1,2
10582_0,,,,2,1,1,2
10583_0,,,,2,1,1,2
10584_0,,,,2,1,1,2
10586_0,,,,2,1,1,2
C(COC(C(CO)=O)O)(C)=O,,,4,1,1,0,1
10588_0,,,,2,1,1,2
C(C(COC(C=O)CO)O)=O,,,4,1,1,0,1
10590_0,,,,2,1,1,2
C(C(C)O)(OC(C=O)CO)=O,,,4,1,1,0,1
10592_0,,,,2,1,1,2
C(OC(C(C(C)O)=O)CO)=O,,,4,1,1,0,1
10594_0,,,,2,1,1,2
C(OC(CO)CC(C=O)O)=O,,,4,1,1,0,1
10595_0,,,,2,1,1,2
10597_0,,,,2,1,1,2
C(C(COCC(C=O)O)O)=O,,,4,1,1,0,1
10599_0,,,,2,1,1,2
C(COCC(CO)=O)(CO)=O,,,4,1,1,0,1
10601_0,,,,2,1,1,2
C(C(C)O)(OCC(C=O)O)=O,,,4,1,1,0,1
10603_0,,,,2,1,1,2
C(COC(C(C)=O)O)(CO)=O,,,4,1,1,0,1
10605_0,,,,2,1,1,2
C(OCC(C(C(C)O)=O)O)=O,,,4,1,1,0,1
10606_0,,,,2,1,1,2
10608_0,,,,2,1,1,2
C(OCC(CC(C=O)O)O)=O,,,4,1,1,0,1
10610_0,,,,2,1,1,2
C(COC(C(C(C)O)=O)O)=O,,,4,1,1,0,1
10611_0,,,,2,1,1,2
10613_0,,,,2,1,1,2
C(COC(C=O)O)(C(C)O)=O,,,4,1,1,0,1
10614_0,,,,2,1,1,2
10616_0,,,,2,1,1,2
C(C(CCOC(C=O)O)O)=O,,,4,1,1,0,1
10618_0,,,,2,1,1,2
C(C(C=CC=O)O)=O,,,4,1,4,0,4
10619_0,,,,2,1,1,2
10621_0,,,,2,1,1,2
C(COC(C(CO)=O)(C)O)=O,,,4,1,1,0,1
10622_0,,,,2,1,1,2
10623_0,,,,2,1,1,2
10624_0,,,,2,1,1,2
10626_0,,,,2,1,1,2
C(C(CO)=O)(C(C(CO)O)O)=O,,,4,1,1,0,1
10627_0,,,,2,1,1,2
10628_0,,,,2,1,1,2
10629_0,,,,2,1,1,2
10630_0,,,,2,1,1,2
10631_0,,,,2,1,1,2
10632_0,,,,2,1,1,2
10633_0,,,,2,1,1,2
10634_0,,,,2,1,1,2
10635_0,,,,2,1,1,2
10636_0,,,,2,1,1,2
10637_0,,,,2,1,1,2
10638_0,,,,2,1,1,2
10639_0,,,,2,1,1,2
10640_0,,,,2,1,1,2
10641_0,,,,2,1,1,2
10642_0,,,,2,1,1,2
10644_0,,,,2,1,1,2
C(C(CO)=O)(C(C(C)O)O)=O,,,4,1,3,0,3
10645_0,,,,2,1,1,2
10646_0,,,,2,1,1,2
10647_0,,,,2,1,1,2
10648_0,,,,2,1,1,2
10649_0,,,,2,1,1,2
10650_0,,,,2,1,1,2
10651_0,,,,2,1,1,2
10652_0,,,,2,1,1,2
10653_0,,,,2,1,1,2
10654_0,,,,2,1,1,2
10655_0,,,,2,1,1,2
10656_0,,,,2,1,1,2
10657_0,,,,2,1,1,2
10658_0,,,,2,1,1,2
10659_0,,,,2,1,1,2
10660_0,,,,2,1,1,2
10661_0,,,,2,1,1,2
10662_0,,,,2,1,1,2
10664_0,,,,2,1,1,2
C(C(C(C(CCO)O)O)=O)(O)=O,,,4,1,3,0,3
10665_0,,,,2,1,1,2
10666_0,,,,2,1,1,2
10667_0,,,,2,1,1,2
10668_0,,,,2,1,1,2
10669_0,,,,2,1,1,2
10670_0,,,,2,1,1,2
10671_0,,,,2,1,1,2
10672_0,,,,2,1,1,2
10673_0,,,,2,1,1,2
10674_0,,,,2,1,1,2
10675_0,,,,2,1,1,2
10676_0,,,,2,1,1,2
10677_0,,,,2,1,1,2
10678_0,,,,2,1,1,2
10679_0,,,,2,1,1,2
10680_0,,,,2,1,1,2
10681_0,,,,2,1,1,2
10682_0,,,,2,1,1,2
10683_0,,,,2,1,1,2
10685_0,,,,2,1,1,2
C1(C(C(CC(CO)O1)O)O)=O,,,4,1,3,0,3
10686_0,,,,2,1,1,2
10687_0,,,,2,1,1,2
10688_0,,,,2,1,1,2
10689_0,,,,2,1,1,2
10690_0,,,,2,1,1,2
10692_0,,,,2,1,1,2
C1(C(C(CC(CO1)O)O)O)=O,,,4,1,3,0,3
10693_0,,,,2,1,1,2
10694_0,,,,2,1,1,2
10696_0,,,,2,1,1,2
C1(C(O)OCCC(C1O)O)=O,,,4,1,3,0,3
10697_0,,,,2,1,1,2
10698_0,,,,2,1,1,2
10699_0,,,,2,1,1,2
10700_0,,,,2,1,1,2
10701_0,,,,2,1,1,2
10702_0,,,,2,1,1,2
10704_0,,,,2,1,1,2
C=CC(C(C(CO)O)=O)=O,,,4,1,3,0,3
10706_0,,,,2,1,1,2
C=CC(C(C(CO)=O)=O)O,,,4,1,3,0,3
10707_0,,,,2,1,1,2
10709_0,,,,2,1,1,2
C=CC(C(C(C=O)=O)O)O,,,4,1,3,0,3
10710_0,,,,2,1,1,2
10711_0,,,,2,1,1,2
10712_0,,,,2,1,1,2
10713_0,,,,2,1,1,2
10714_0,,,,2,1,1,2
10715_0,,,,2,1,1,2
10716_0,,,,2,1,1,2
10718_0,,,,2,1,1,2
C(C(CCC(CO)=O)O)=O,,,4,1,4,0,4
10720_0,,,,2,1,1,2
C(C(C)=O)(C(CCO)O)=O,,,4,1,3,0,3
10722_0,,,,2,1,1,2
C(C(C(C)O)=O)(CCO)=O,,,4,1,3,0,3
10723_0,,,,2,1,1,2
10725_0,,,,2,1,1,2
C(CO)(C(CC(C)=O)O)=O,,,4,1,3,0,3
10727_0,,,,2,1,1,2
C(CCC(C(CO)=O)O)=O,,,4,1,3,0,3
10729_0,,,,2,1,1,2
C(C(CO)=O)(CCCO)=O,,,4,1,3,0,3
10731_0,,,,2,1,1,2
C(C(C(CCCO)O)=O)=O,,,4,1,2,0,2
10732_0,,,,2,1,1,2
10734_0,,,,2,1,1,2
C(C(C=CC(CO)O)O)=O,,,4,1,4,0,4
10736_0,,,,2,1,1,2
C(CO)(C(C=CCO)O)=O,,,4,1,6,0,6
10738_0,,,,2,1,1,2
C(C(CO)O)(C(C=C)O)=O,,,4,1,4,0,4
10739_0,,,,2,1,1,2
10740_0,,,,2,1,1,2
10741_0,,,,2,1,1,2
10743_0,,,,2,1,1,2
C(C(CCC(C(O)=O)=O)O)=O,,,4,1,3,0,3
10745_0,,,,2,1,1,2
C(C(C)O)(CC(C(O)=O)=O)=O,,,4,1,3,0,3
10746_0,,,,2,1,1,2
10748_0,,,,2,1,1,2
C(CC(C(C(C)=O)=O)O)(O)=O,,,4,1,3,0,3
10750_0,,,,2,1,1,2
C(CC(C(C(C)O)=O)=O)(O)=O,,,4,1,3,0,3
10751_0,,,,2,1,1,2
10752_0,,,,2,1,1,2
10754_0,,,,2,1,1,2
C(C)(CC(C(C(O)=O)=O)O)=O,,,4,1,3,0,3
10756_0,,,,2,1,1,2
C(CCC(C(C(O)=O)=O)O)=O,,,4,1,3,0,3
10758_0,,,,2,1,1,2
C(CCC(C(CO)=O)=O)(O)=O,,,4,1,3,0,3
10760_0,,,,2,1,1,2
C(CCC(C(C=O)=O)O)(O)=O,,,4,1,2,0,2
10761_0,,,,2,1,1,2
10763_0,,,,2,1,1,2
C(C(C(C(O)=O)=O)O)=CCO,,,4,1,3,0,3
10765_0,,,,2,1,1,2
C(CO)(C(C=CC(O)=O)O)=O,,,4,1,5,0,5
10767_0,,,,2,1,1,2
C(C(C(C(C=C)O)=O)O)(O)=O,,,4,1,3,0,3
10769_0,,,,2,1,1,2
C(C(C=CC(C=O)O)O)(O)=O,,,4,1,4,0,4
10770_0,,,,2,1,1,2
10771_0,,,,2,1,1,2
10773_0,,,,2,1,1,2
C1(C(C(C(CO)(CO)C1O)O)O)=O,,,4,1,1,0,1
10775_0,,,,2,1,1,2
C(C(C(C(C)O)=O)(CO)O)=O,,,4,1,3,0,3
10776_0,,,,2,1,1,2
10777_0,,,,2,1,1,2
10779_0,,,,2,1,1,2
C(C(CO)(C(C(CO)=O)(C)O)O)=O,,,4,1,4,0,4
10780_0,,,,2,1,1,2
10781_0,,,,2,1,1,2
10782_0,,,,2,1,1,2
10783_0,,,,2,1,1,2
10785_0,,,,2,1,1,2
C(C(C)O)(C(C=O)(C(C)=O)O)=O,,,4,1,1,0,1
10787_0,,,,2,1,1,2
C(C(C)O)(C(C(C)=O)(CO)O)=O,,,4,1,1,0,1
10789_0,,,,2,1,1,2
C(C(C=O)(C(C(C)O)=O)O)=O,,,4,1,1,0,1
10791_0,,,,2,1,1,2
C(C(C)O)(C(C=O)(C(C=O)O)O)=O,,,4,1,3,0,3
10793_0,,,,2,1,1,2
C(C(C(CO)=O)(C(C(C)=O)O)O)=O,,,4,1,3,0,3
10795_0,,,,2,1,1,2
C(C(C)(C(C=O)(C(CO)=O)O)O)=O,,,4,1,3,0,3
10797_0,,,,2,1,1,2
C(C(C)O)(C(C(CO)=O)(CO)O)=O,,,4,1,4,0,4
10798_0,,,,2,1,1,2
10800_0,,,,2,1,1,2
C(C(C)(C(CO)(C(C=O)O)O)O)=O,,,4,1,5,0,5
10801_0,,,,2,1,1,2
10803_0,,,,2,1,1,2
C(C(C(CO)=O)(C(C)=O)O)=O,,,4,1,1,0,1
10805_0,,,,2,1,1,2
C(C(C=O)(C(C(C(C)O)=O)O)O)=O,,,4,1,3,0,3
10807_0,,,,2,1,1,2
C(C(C=O)(C(C(CO)=O)(C)O)O)=O,,,4,1,3,0,3
10809_0,,,,2,1,1,2
C(C(C(C)=O)(C(C(CO)=O)O)O)=O,,,4,1,3,0,3
10811_0,,,,2,1,1,2
C(C(C(C(CO)=O)(C(C)=O)O)O)=O,,,4,1,3,0,3
10812_0,,,,2,1,1,2
10814_0,,,,2,1,1,2
C(C(C(CO)=O)(C(C=O)O)O)=O,,,4,1,3,0,3
10816_0,,,,2,1,1,2
C(CO)(C(C(CO)=O)(CO)O)=O,,,4,1,1,0,1
10817_0,,,,2,1,1,2
10819_0,,,,2,1,1,2
C(C(C(CO)=O)(C(CO)O)O)(O)=O,,,4,1,3,0,3
10820_0,,,,2,1,1,2
10821_0,,,,2,1,1,2
10822_0,,,,2,1,1,2
10823_0,,,,2,1,1,2
10824_0,,,,2,1,1,2
10825_0,,,,2,1,1,2
10826_0,,,,2,1,1,2
10828_0,,,,2,1,1,2
C(C(CO)O)(C(C(C)=O)(CO)O)=O,,,4,1,4,0,4
10830_0,,,,2,1,1,2
C(C(C(C(C(C)O)O)=O)(CO)O)=O,,,4,1,4,0,4
10831_0,,,,2,1,1,2
10832_0,,,,2,1,1,2
10833_0,,,,2,1,1,2
10834_0,,,,2,1,1,2
10836_0,,,,2,1,1,2
C(C(C(C(C=C)O)=O)(CO)O)=O,,,4,1,4,0,4
10838_0,,,,2,1,1,2
C(CO)(C(C(C=C)=O)(CO)O)=O,,,4,1,4,0,4
10840_0,,,,2,1,1,2
C(C(C=O)(C(C(CCO)O)=O)O)=O,,,4,1,1,0,1
10842_0,,,,2,1,1,2
C(C(C(C(C)O)=O)(C(C)O)O)=O,,,4,1,3,0,3
10844_0,,,,2,1,1,2
C(C)(C(C(CO)=O)(C(C)O)O)=O,,,4,1,3,0,3
10846_0,,,,2,1,1,2
C(C(C=O)(C(C(CO)=O)O)O)=O,,,4,1,3,0,3
10847_0,,,,2,1,1,2
10849_0,,,,2,1,1,2
C(C(C(CO)=O)(C(CO)(C)O)O)=O,,,4,1,3,0,3
10851_0,,,,2,1,1,2
C(C(C(CO)(C(CO)(C)O)O)O)=O,,,4,1,4,0,4
10853_0,,,,2,1,1,2
C(C(C(CO)=O)(C(C)O)O)=O,,,4,1,3,0,3
10854_0,,,,2,1,1,2
10856_0,,,,2,1,1,2
C(C(C(C(C=C)O)=O)(C(C)O)O)=O,,,4,1,3,0,3
10858_0,,,,2,1,1,2
C(CO)(C(C(C=C)=O)(C(C)O)O)=O,,,4,1,3,0,3
10860_0,,,,2,1,1,2
C(C(C(C(C)O)=O)(C(CO)O)O)=O,,,4,1,3,0,3
10862_0,,,,2,1,1,2
C(C)(C(C(CO)=O)(C(CO)O)O)=O,,,4,1,3,0,3
10864_0,,,,2,1,1,2
C(C(C(CO)=O)(C(CO)O)O)=O,,,4,1,3,0,3
10865_0,,,,2,1,1,2
10866_0,,,,2,1,1,2
10867_0,,,,2,1,1,2
10868_0,,,,2,1,1,2
10870_0,,,,2,1,1,2
C(C(C)O)(C(C=O)(CC=O)O)=O,,,4,1,1,0,1
10872_0,,,,2,1,1,2
C(CO)(C(C)(C(C(O)=O)O)O)=O,,,4,1,3,0,3
10874_0,,,,2,1,1,2
C(C(C(CO)=O)(CC(CO)=O)O)=O,,,4,1,1,0,1
10875_0,,,,2,1,1,2
10877_0,,,,2,1,1,2
C(C(C(CO)=O)(CC=O)O)=O,,,4,1,1,0,1
10879_0,,,,2,1,1,2
C(C(CO)(CC(C=O)O)O)=O,,,4,1,2,0,2
10881_0,,,,2,1,1,2
C(C(CC(C=O)O)(C(C)O)O)=O,,,4,1,2,0,2
10882_0,,,,2,1,1,2
10883_0,,,,2,1,1,2
10884_0,,,,2,1,1,2
10885_0,,,,2,1,1,2
10886_0,,,,2,1,1,2
10888_0,,,,2,1,1,2
C(C(CO)=O)(C(CO)(CCO)O)=O,,,4,1,2,0,2
10889_0,,,,2,1,1,2
10890_0,,,,2,1,1,2
10891_0,,,,2,1,1,2
10892_0,,,,2,1,1,2
10894_0,,,,2,1,1,2
C(C(CO)(C)O)(C(C(CO)=O)O)=O,,,4,1,2,0,2
10895_0,,,,2,1,1,2
10897_0,,,,2,1,1,2
C(C(C=CC(C=O)O)(CO)O)=O,,,4,1,4,0,4
10898_0,,,,2,1,1,2
10899_0,,,,2,1,1,2
10900_0,,,,2,1,1,2
10902_0,,,,2,1,1,2
C(C(C=CC(C=O)O)(C(C)O)O)=O,,,4,1,2,0,2
10904_0,,,,2,1,1,2
C(C(CC(C=O)O)(C(CO)O)O)=O,,,4,1,2,0,2
10905_0,,,,2,1,1,2
10907_0,,,,2,1,1,2
C(CO)(C(CO)OC(CO)=O)=O,,,4,1,1,0,1
10909_0,,,,2,1,1,2
C(CO)(C(COC(CO)=O)O)=O,,,4,1,1,0,1
10910_0,,,,2,1,1,2
10912_0,,,,2,1,1,2
C1(C(C(CC1CO)O)=O)=O,,,4,1,2,0,2
10914_0,,,,2,1,1,2
C1(C(C(C(CO)C1)O)=O)=O,,,4,1,3,0,3
10915_0,,,,2,1,1,2
10917_0,,,,2,1,1,2
C1(C(COC1C(C)=O)O)=O,,,4,1,2,0,2
10918_0,,,,2,1,1,2
10920_0,,,,2,1,1,2
C1(C(CC(C(C)=O)O1)O)=O,,,4,1,3,0,3
10922_0,,,,2,1,1,2
C(CC1CC(C(O1)=O)O)=O,,,4,1,3,0,3
10924_0,,,,2,1,1,2
C1(CCC(C(CO1)=O)O)=O,,,4,1,2,0,2
10926_0,,,,2,1,1,2
C1(CC(C(CCO1)O)=O)=O,,,4,1,2,0,2
10927_0,,,,2,1,1,2
10929_0,,,,2,1,1,2
C1(C(C(COCC1)O)=O)=O,,,4,1,2,0,2
10931_0,,,,2,1,1,2
C1(C(COCCC1O)=O)=O,,,4,1,2,0,2
10932_0,,,,2,1,1,2
10934_0,,,,2,1,1,2
C1(CC(C(OCC1)=O)O)=O,,,4,1,3,0,3
10936_0,,,,2,1,1,2
C1(C(CCC(CO1)=O)O)=O,,,4,1,3,0,3
10937_0,,,,2,1,1,2
10938_0,,,,2,1,1,2
10939_0,,,,2,1,1,2
10940_0,,,,2,1,1,2
10942_0,,,,2,1,1,2
C(C1C(C(C(C)O1)O)=O)=O,,,4,1,1,0,1
10943_0,,,,2,1,1,2
10944_0,,,,2,1,1,2
10946_0,,,,2,1,1,2
C1(C(CO)(O)OCCC1O)=O,,,4,1,2,0,2
10948_0,,,,2,1,1,2
C1(CC(C(C(CO)O1)=O)O)=O,,,4,1,2,0,2
10950_0,,,,2,1,1,2
C1(C(C(CC(CO)O1)O)=O)=O,,,4,1,2,0,2
10952_0,,,,2,1,1,2
C1(CC(C(C(CO1)O)=O)O)=O,,,4,1,2,0,2
10954_0,,,,2,1,1,2
C1(C(C(CC(CO1)O)O)=O)=O,,,4,1,2,0,2
10956_0,,,,2,1,1,2
C1(C(CC(C(CO1)=O)O)O)=O,,,4,1,2,0,2
10958_0,,,,2,1,1,2
C1(C(C(C(CCO1)O)=O)O)=O,,,4,1,2,0,2
10960_0,,,,2,1,1,2
C1(C(C=C(CO)C1O)O)=O,,,4,1,3,0,3
10962_0,,,,2,1,1,2
C1(C(C(C(C1O)=C)O)O)=O,,,4,1,3,0,3
10964_0,,,,2,1,1,2
C(CO)(C(C(C=C)O)O)=O,,,4,1,2,0,2
10966_0,,,,2,1,1,2
C1(C(C=CC(CO)O1)O)=O,,,4,1,2,0,2
10968_0,,,,2,1,1,2
C1(C(CO)OC=CC1O)=O,,,4,1,2,0,2
10970_0,,,,2,1,1,2
C1(C(C=CC(CO1)O)O)=O,,,4,1,2,0,2
10972_0,,,,2,1,1,2
C1(C(COC=CC1O)O)=O,,,4,1,2,0,2
10974_0,,,,2,1,1,2
C1(C(O)OCC=CC1O)=O,,,4,1,2,0,2
10976_0,,,,2,1,1,2
C1(COC(C=CC1O)O)=O,,,4,1,3,0,3
10978_0,,,,2,1,1,2
C1C(COC=1C(CO)=O)O,,,4,1,2,0,2
10980_0,,,,2,1,1,2
C(CO)(C1(C=CCO1)O)=O,,,4,1,2,0,2
10982_0,,,,2,1,1,2
C(CO)(C1C=CC(O1)O)=O,,,4,1,3,0,3
10984_0,,,,2,1,1,2
C(CO)(C1C(C=CO1)O)=O,,,4,1,2,0,2
10985_0,,,,2,1,1,2
10987_0,,,,2,1,1,2
C1(C(C(CO)O)OC(C1O)O)=O,,,4,1,2,0,2
10988_0,,,,2,1,1,2
10990_0,,,,2,1,1,2
C1(C(CCO)(O)OCC1O)=O,,,4,1,2,0,2
10992_0,,,,2,1,1,2
C1(C(O)OC(CCO)C1O)=O,,,4,1,2,0,2
10994_0,,,,2,1,1,2
C(CO)(C1(C(CCO1)O)O)=O,,,4,1,2,0,2
10995_0,,,,2,1,1,2
10996_0,,,,2,1,1,2
10998_0,,,,2,1,1,2
C1(C(C(CO)OC(C1O)O)O)=O,,,4,1,2,0,2
10999_0,,,,2,1,1,2
11001_0,,,,2,1,1,2
C1(C(C(C)(O)OCC1O)O)=O,,,4,1,2,0,2
11003_0,,,,2,1,1,2
C1(C(C(C)OC(C1O)O)O)=O,,,4,1,2,0,2
11004_0,,,,2,1,1,2
11006_0,,,,2,1,1,2
C1(C(C(COC(C1O)O)O)O)=O,,,4,1,2,0,2
11007_0,,,,2,1,1,2
11009_0,,,,2,1,1,2
C1(CC(C(C(CO)=O)O1)O)=O,,,4,1,2,0,2
11011_0,,,,2,1,1,2
C(CC(CO)CC(C(CO)=O)=O)=O,,,4,1,2,0,2
11013_0,,,,2,1,1,2
C(CC(CO)CC(C(C=O)=O)O)=O,,,4,1,1,0,1
11015_0,,,,2,1,1,2
C(CO)(C(CC(C=O)CC=O)O)=O,,,4,1,2,0,2
11017_0,,,,2,1,1,2
C(CC(C(C(CO)=O)O)CC=O)=O,,,4,1,3,0,3
11019_0,,,,2,1,1,2
C(CCCC(C(C(CO)=O)O)=O)=O,,,4,1,2,0,2
11021_0,,,,2,1,1,2
C(CCCC(C(C(C=O)O)=O)O)=O,,,4,1,1,0,1
11023_0,,,,2,1,1,2
C(CC(C(CO)=O)CC(CO)=O)=O,,,4,1,3,0,3
11025_0,,,,2,1,1,2
C(CC(CC(C=O)O)C(C=O)O)=O,,,4,1,1,0,1
11026_0,,,,2,1,1,2
11027_0,,,,2,3,2,5
11028_0,,,,2,3,2,5
11030_0,,,,2,3,2,5
C1(C(C(C(C1)O)CO)O)=O,,,4,1,2,0,2
11031_0,,,,2,3,2,5
11033_0,,,,2,3,2,5
C1(C(C(C(CO)C1)O)O)=O,,,4,1,3,0,3
11034_0,,,,2,3,2,5
11035_0,,,,2,3,2,5
11036_0,,,,2,3,2,5
11037_0,,,,2,3,2,5
11038_0,,,,2,3,2,5
11039_0,,,,2,3,2,5
11040_0,,,,2,3,2,5
11041_0,,,,2,3,2,5
11042_0,,,,2,3,2,5
11043_0,,,,2,3,2,5
11044_0,,,,2,3,2,5
11045_0,,,,2,3,2,5
11046_0,,,,2,3,2,5
11047_0,,,,2,3,2,5
11048_0,,,,2,3,2,5
11049_0,,,,2,3,2,5
11051_0,,,,2,3,2,5
C(C(CO)(CCO)O)O,,,4,1,1,0,1
11052_0,,,,2,3,2,5
11053_0,,,,2,3,2,5
11054_0,,,,2,3,2,5
11055_0,,,,2,3,2,5
11056_0,,,,2,3,2,5
11057_0,,,,2,3,2,5
11059_0,,,,2,3,2,5
C(C(C(CCO)O)O)O,,,4,1,1,0,1
11060_0,,,,2,3,2,5
11061_0,,,,2,3,2,5
11062_0,,,,2,3,2,5
11063_0,,,,2,3,2,5
11064_0,,,,2,3,2,5
11065_0,,,,2,3,2,5
11066_0,,,,2,3,2,5
11067_0,,,,2,3,2,5
11068_0,,,,2,3,2,5
11069_0,,,,2,3,2,5
11070_0,,,,2,3,2,5
11071_0,,,,2,3,2,5
11072_0,,,,2,3,2,5
11073_0,,,,2,3,2,5
11074_0,,,,2,3,2,5
11075_0,,,,2,3,2,5
11076_0,,,,2,3,2,5
11077_0,,,,2,3,2,5
11078_0,,,,2,3,2,5
11079_0,,,,2,3,2,5
11080_0,,,,2,3,2,5
11081_0,,,,2,3,2,5
11082_0,,,,2,3,2,5
11083_0,,,,2,3,2,5
11084_0,,,,2,3,2,5
11085_0,,,,2,3,2,5
11086_0,,,,2,3,2,5
11087_0,,,,2,3,2,5
11088_0,,,,2,3,2,5
11089_0,,,,2,3,2,5
11090_0,,,,2,3,2,5
11091_0,,,,2,3,2,5
11092_0,,,,2,3,2,5
11093_0,,,,2,3,2,5
11094_0,,,,2,3,2,5
11095_0,,,,2,3,2,5
11096_0,,,,2,3,2,5
11097_0,,,,2,3,2,5
11098_0,,,,2,3,2,5
11099_0,,,,2,3,2,5
11100_0,,,,2,3,2,5
11101_0,,,,2,3,2,5
11102_0,,,,2,3,2,5
11103_0,,,,2,3,2,5
11104_0,,,,2,3,2,5
11105_0,,,,2,3,2,5
11106_0,,,,2,3,2,5
11108_0,,,,2,3,2,5
C(C)(C(CCO)O)=O,,,4,1,1,0,1
11109_0,,,,2,3,2,5
11111_0,,,,2,3,2,5
C(C(C)(CCO)O)=O,,,4,1,1,0,1
11112_0,,,,2,3,2,5
11113_0,,,,2,3,2,5
11114_0,,,,2,3,2,5
11115_0,,,,2,3,2,5
11116_0,,,,2,3,2,5
11117_0,,,,2,3,2,5
11118_0,,,,2,3,2,5
11119_0,,,,2,3,2,5
11120_0,,,,2,3,2,5
11121_0,,,,2,3,2,5
11122_0,,,,2,3,2,5
11123_0,,,,2,3,2,5
11124_0,,,,2,3,2,5
11125_0,,,,2,3,2,5
11126_0,,,,2,3,2,5
11127_0,,,,2,3,2,5
11128_0,,,,2,3,2,5
11129_0,,,,2,3,2,5
11130_0,,,,2,3,2,5
11131_0,,,,2,3,2,5
11132_0,,,,2,3,2,5
11133_0,,,,2,3,2,5
11134_0,,,,2,3,2,5
11135_0,,,,2,3,2,5
11136_0,,,,2,3,2,5
11137_0,,,,2,3,2,5
11138_0,,,,2,3,2,5
11139_0,,,,2,3,2,5
11140_0,,,,2,3,2,5
11141_0,,,,2,3,2,5
11142_0,,,,2,3,2,5
11144_0,,,,2,3,2,5
C(C(C(C)(CCO)O)O)=O,,,4,1,1,0,1
11145_0,,,,2,3,2,5
11146_0,,,,2,3,2,5
11147_0,,,,2,3,2,5
11148_0,,,,2,3,2,5
11149_0,,,,2,3,2,5
11150_0,,,,2,3,2,5
11151_0,,,,2,3,2,5
11152_0,,,,2,3,2,5
11153_0,,,,2,3,2,5
11154_0,,,,2,3,2,5
11156_0,,,,2,3,2,5
CC(CCO)(C(CO)O)O,,,4,1,1,0,1
11157_0,,,,2,3,2,5
11158_0,,,,2,3,2,5
11159_0,,,,2,3,2,5
11160_0,,,,2,3,2,5
11161_0,,,,2,3,2,5
11162_0,,,,2,3,2,5
11163_0,,,,2,3,2,5
11164_0,,,,2,3,2,5
11166_0,,,,2,3,2,5
C(CCO)O,,,4,1,1,0,1
11167_0,,,,2,3,2,5
11168_0,,,,2,3,2,5
11169_0,,,,2,3,2,5
11171_0,,,,2,3,2,5
C(CO)(C(C(C(CO)CO)O)O)=O,,,4,1,1,0,1
11173_0,,,,2,3,2,5
C(C(CO)C(C(C(CO)O)O)O)O,,,4,1,1,0,1
11174_0,,,,2,3,2,5
11175_0,,,,2,3,2,5
11176_0,,,,2,3,2,5
11177_0,,,,2,3,2,5
11178_0,,,,2,3,2,5
11179_0,,,,2,3,2,5
11180_0,,,,2,3,2,5
11181_0,,,,2,3,2,5
11183_0,,,,2,3,2,5
C(C(CC(C(CO)CO)O)=O)=O,,,4,1,1,0,1
11184_0,,,,2,3,2,5
11185_0,,,,2,3,2,5
11186_0,,,,2,3,2,5
11187_0,,,,2,3,2,5
11188_0,,,,2,3,2,5
11189_0,,,,2,3,2,5
11190_0,,,,2,3,2,5
11191_0,,,,2,3,2,5
11192_0,,,,2,3,2,5
11193_0,,,,2,3,2,5
11195_0,,,,2,3,2,5
C(CC(C(C(CO)CO)O)=O)=O,,,4,1,1,0,1
11196_0,,,,2,3,2,5
11197_0,,,,2,3,2,5
11198_0,,,,2,3,2,5
11199_0,,,,2,3,2,5
11200_0,,,,2,3,2,5
11202_0,,,,2,3,2,5
C(C(C(CC(CO)CO)=O)O)=O,,,4,1,2,0,2
11203_0,,,,2,3,2,5
11204_0,,,,2,3,2,5
11205_0,,,,2,3,2,5
11206_0,,,,2,3,2,5
11207_0,,,,2,3,2,5
11208_0,,,,2,3,2,5
11210_0,,,,2,3,2,5
C1(C(C(C(C(CO)CO)O1)O)O)O,,,4,1,1,0,1
11211_0,,,,2,3,2,5
11213_0,,,,2,3,2,5
C1C(C(C(C(CO)CO)(O)O1)O)O,,,4,1,2,0,2
11214_0,,,,2,3,2,5
11215_0,,,,2,3,2,5
11216_0,,,,2,3,2,5
11217_0,,,,2,3,2,5
11218_0,,,,2,3,2,5
11219_0,,,,2,3,2,5
11221_0,,,,2,3,2,5
C(C(CCO)O)(CCO)=O,,,4,1,3,0,3
11222_0,,,,2,3,2,5
11224_0,,,,2,3,2,5
C(C(CCO)(CCO)O)=O,,,4,1,1,0,1
11225_0,,,,2,3,2,5
11226_0,,,,2,3,2,5
11228_0,,,,2,3,2,5
C(C(CCO)(CCO)O)O,,,4,1,1,0,1
11229_0,,,,2,3,2,5
11230_0,,,,2,3,2,5
11231_0,,,,2,3,2,5
11233_0,,,,2,3,2,5
C(C(C(C(C)(CCO)O)O)O)=O,,,4,1,1,0,1
11234_0,,,,2,3,2,5
11235_0,,,,2,3,2,5
11236_0,,,,2,3,2,5
11237_0,,,,2,3,2,5
11238_0,,,,2,3,2,5
11239_0,,,,2,3,2,5
11240_0,,,,2,3,2,5
11241_0,,,,2,3,2,5
11242_0,,,,2,3,2,5
11243_0,,,,2,3,2,5
11244_0,,,,2,3,2,5
11246_0,,,,2,3,2,5
CC(CO)(CCO)O,,,4,1,1,0,1
11247_0,,,,2,3,2,5
11248_0,,,,2,3,2,5
11249_0,,,,2,3,2,5
11250_0,,,,2,3,2,5
11252_0,,,,2,3,2,5
C(C(CC(CCO)O)O)=O,,,4,1,1,0,1
11254_0,,,,2,3,2,5
CC(CCO)O,,,4,1,1,0,1
11256_0,,,,2,3,2,5
C(C(C(CO)(CCO)O)O)O,,,4,1,3,0,3
11258_0,,,,2,3,2,5
C(CCO)(CC(C(CCO)O)=O)=O,,,4,1,1,0,1
11260_0,,,,2,3,2,5
C(C(CCO)(CC(CCO)=O)O)=O,,,4,1,1,0,1
11261_0,,,,2,3,2,5
11263_0,,,,2,3,2,5
C(C(CC(CCO)(CCO)O)=O)=O,,,4,1,1,0,1
11264_0,,,,2,3,2,5
11265_0,,,,2,3,2,5
11266_0,,,,2,3,2,5
11268_0,,,,2,3,2,5
C(CCC(C(CCO)O)=O)(CO)=O,,,4,1,1,0,1
11270_0,,,,2,3,2,5
C(C(CCC(CO)=O)(CCO)O)=O,,,4,1,2,0,2
11271_0,,,,2,3,2,5
11273_0,,,,2,3,2,5
C(C(CCC(CO)(CCO)O)=O)=O,,,4,1,1,0,1
11274_0,,,,2,3,2,5
11275_0,,,,2,3,2,5
11276_0,,,,2,3,2,5
11277_0,,,,2,3,2,5
11279_0,,,,2,3,2,5
C(CC(C(C)=O)O)(C(CCO)O)=O,,,4,1,1,0,1
11281_0,,,,2,3,2,5
C(C(CC(C(C)=O)O)(CCO)O)=O,,,4,1,1,0,1
11282_0,,,,2,3,2,5
11284_0,,,,2,3,2,5
C(C(CC(C(C)(CCO)O)O)=O)=O,,,4,1,1,0,1
11285_0,,,,2,3,2,5
11286_0,,,,2,3,2,5
11287_0,,,,2,3,2,5
11288_0,,,,2,3,2,5
11289_0,,,,2,3,2,5
11290_0,,,,2,3,2,5
11291_0,,,,2,3,2,5
11292_0,,,,2,3,2,5
11294_0,,,,2,3,2,5
C(C(CC(CC(CCO)O)O)=O)=O,,,4,1,1,0,1
11295_0,,,,2,3,2,5
11296_0,,,,2,3,2,5
11297_0,,,,2,3,2,5
11298_0,,,,2,3,2,5
11300_0,,,,2,3,2,5
C(C(CC(C(CO)C(C)O)O)=O)=O,,,4,1,1,0,1
11302_0,,,,2,3,2,5
C(C(CCO)=O)(CC(CCO)O)=O,,,4,1,1,0,1
11303_0,,,,2,3,2,5
11305_0,,,,2,3,2,5
C(CC(C(CCO)(CCO)O)=O)=O,,,4,1,1,0,1
11306_0,,,,2,3,2,5
11307_0,,,,2,3,2,5
11308_0,,,,2,3,2,5
11310_0,,,,2,3,2,5
C(CC(CCO)O)(CC(CO)=O)=O,,,4,1,1,0,1
11311_0,,,,2,3,2,5
11312_0,,,,2,3,2,5
11313_0,,,,2,3,2,5
11314_0,,,,2,3,2,5
11315_0,,,,2,3,2,5
11316_0,,,,2,3,2,5
11318_0,,,,2,3,2,5
C(CC(CCO)O)(C(C(C)=O)O)=O,,,4,1,1,0,1
11319_0,,,,2,3,2,5
11321_0,,,,2,3,2,5
C(CC(C(C(C)(CCO)O)O)=O)=O,,,4,1,1,0,1
11322_0,,,,2,3,2,5
11323_0,,,,2,3,2,5
11324_0,,,,2,3,2,5
11325_0,,,,2,3,2,5
11326_0,,,,2,3,2,5
11328_0,,,,2,3,2,5
C(CC(C(CC(CCO)O)O)=O)=O,,,4,1,1,0,1
11329_0,,,,2,3,2,5
11330_0,,,,2,3,2,5
11331_0,,,,2,3,2,5
11332_0,,,,2,3,2,5
11334_0,,,,2,3,2,5
C(CC(C(C(CO)C(C)O)O)=O)=O,,,4,1,1,0,1
11336_0,,,,2,3,2,5
C(C(C(CCO)O)O)(CC(C)=O)=O,,,4,1,1,0,1
11338_0,,,,2,3,2,5
C(C(C(CCO)(CC(C)=O)O)O)=O,,,4,1,1,0,1
11339_0,,,,2,3,2,5
11341_0,,,,2,3,2,5
C(C(C(CC(C)(CCO)O)=O)O)=O,,,4,1,1,0,1
11342_0,,,,2,3,2,5
11343_0,,,,2,3,2,5
11344_0,,,,2,3,2,5
11346_0,,,,2,3,2,5
C(CCC=O)(C(C(CCO)O)O)=O,,,4,1,1,0,1
11347_0,,,,2,3,2,5
11349_0,,,,2,3,2,5
C(CCC(CCO)(C(C=O)O)O)=O,,,4,1,1,0,1
11350_0,,,,2,3,2,5
11351_0,,,,2,3,2,5
11353_0,,,,2,3,2,5
C(C(C(CCC(CCO)O)=O)O)=O,,,4,1,1,0,1
11354_0,,,,2,3,2,5
11355_0,,,,2,3,2,5
11356_0,,,,2,3,2,5
11357_0,,,,2,3,2,5
11359_0,,,,2,3,2,5
C(C(C(CC(CO)C(C)O)=O)O)=O,,,4,1,2,0,2
11360_0,,,,2,3,2,5
11362_0,,,,2,3,2,5
C(C(CC(C(C)=O)(CCO)O)O)=O,,,4,1,1,0,1
11363_0,,,,2,3,2,5
11365_0,,,,2,3,2,5
C(CC(C=O)O)(C(C)(CCO)O)=O,,,4,1,1,0,1
11366_0,,,,2,3,2,5
11367_0,,,,2,3,2,5
11368_0,,,,2,3,2,5
11369_0,,,,2,3,2,5
11370_0,,,,2,3,2,5
11371_0,,,,2,3,2,5
11372_0,,,,2,3,2,5
11374_0,,,,2,3,2,5
C(CC(C=O)O)(CC(CCO)O)=O,,,4,1,1,0,1
11375_0,,,,2,3,2,5
11376_0,,,,2,3,2,5
11377_0,,,,2,3,2,5
11378_0,,,,2,3,2,5
11379_0,,,,2,3,2,5
11381_0,,,,2,3,2,5
C(C(CO)O)=CC(C(CCO)O)=O,,,4,1,1,0,1
11383_0,,,,2,3,2,5
C(C(C=CC(CO)O)(CCO)O)=O,,,4,1,1,0,1
11384_0,,,,2,3,2,5
11386_0,,,,2,3,2,5
C(CO)=CC(C(C(CCO)O)O)=O,,,4,1,1,0,1
11388_0,,,,2,3,2,5
C(C(C(C=CCO)(CCO)O)O)=O,,,4,1,1,0,1
11389_0,,,,2,3,2,5
11391_0,,,,2,3,2,5
C(C(CCO)O)=CC(C(CO)O)=O,,,4,1,1,0,1
11393_0,,,,2,3,2,5
C(C(C(CO)O)(CCO)O)=CC=O,,,4,1,1,0,1
11394_0,,,,2,3,2,5
11395_0,,,,2,3,2,5
11397_0,,,,2,3,2,5
C(C(C(C(C=C)(CCO)O)O)O)=O,,,4,1,1,0,1
11398_0,,,,2,3,2,5
11400_0,,,,2,3,2,5
C(C(C(CCO)O)O)=CC(CO)=O,,,4,1,1,0,1
11402_0,,,,2,3,2,5
C(C(C=CC(CO)(CCO)O)O)=O,,,4,1,1,0,1
11403_0,,,,2,3,2,5
11404_0,,,,2,3,2,5
11406_0,,,,2,3,2,5
C(C(C(C(CCO)O)O)O)=CC=O,,,4,1,1,0,1
11407_0,,,,2,3,2,5
11409_0,,,,2,3,2,5
C(C(C(C=CC(CCO)O)O)O)=O,,,4,1,1,0,1
11410_0,,,,2,3,2,5
11412_0,,,,2,3,2,5
C(C(CO)(C(CO)O)O)O,,,4,1,5,0,5
11414_0,,,,2,3,2,5
C(C(C(C(CO)O)O)O)O,,,4,1,5,0,5
11416_0,,,,2,3,2,5
C(C(C)(C(CO)O)O)=O,,,4,1,3,0,3
11417_0,,,,2,3,2,5
11418_0,,,,2,3,2,5
11419_0,,,,2,3,2,5
11420_0,,,,2,3,2,5
11421_0,,,,2,3,2,5
11422_0,,,,2,3,2,5
11424_0,,,,2,3,2,5
CC(C(CO)O)(C(CO)O)O,,,4,1,2,0,2
11425_0,,,,2,3,2,5
11426_0,,,,2,3,2,5
11427_0,,,,2,3,2,5
11428_0,,,,2,3,2,5
11430_0,,,,2,3,2,5
C(C(C(CO)O)(CCO)O)=O,,,4,1,4,0,4
11431_0,,,,2,3,2,5
11432_0,,,,2,3,2,5
11433_0,,,,2,3,2,5
11434_0,,,,2,3,2,5
11435_0,,,,2,3,2,5
11436_0,,,,2,3,2,5
11437_0,,,,2,3,2,5
11439_0,,,,2,3,2,5
CC(CO)(C(CO)O)O,,,4,1,2,0,2
11440_0,,,,2,3,2,5
11441_0,,,,2,3,2,5
11442_0,,,,2,3,2,5
11444_0,,,,2,3,2,5
CC(C(CO)O)O,,,4,1,2,0,2
11446_0,,,,2,3,2,5
C(C(CCO)O)O,,,4,1,2,0,2
11447_0,,,,2,3,2,5
11448_0,,,,2,3,2,5
11449_0,,,,2,3,2,5
11450_0,,,,2,3,2,5
11451_0,,,,2,3,2,5
11452_0,,,,2,3,2,5
11453_0,,,,2,3,2,5
11455_0,,,,2,3,2,5
C(C(C(C(C(CO)CO)O)O)O)=O,,,4,1,1,0,1
11456_0,,,,2,3,2,5
11457_0,,,,2,3,2,5
11458_0,,,,2,3,2,5
11459_0,,,,2,3,2,5
11460_0,,,,2,3,2,5
11461_0,,,,2,3,2,5
11462_0,,,,2,3,2,5
11463_0,,,,2,3,2,5
11464_0,,,,2,3,2,5
11465_0,,,,2,3,2,5
11466_0,,,,2,3,2,5
11467_0,,,,2,3,2,5
11468_0,,,,2,3,2,5
11469_0,,,,2,3,2,5
11470_0,,,,2,3,2,5
11471_0,,,,2,3,2,5
11472_0,,,,2,3,2,5
11473_0,,,,2,3,2,5
11474_0,,,,2,3,2,5
11475_0,,,,2,3,2,5
11477_0,,,,2,3,2,5
C(CC(CO)O)(O)=O,,,4,1,2,0,2
11478_0,,,,2,3,2,5
11479_0,,,,2,3,2,5
11480_0,,,,2,3,2,5
11481_0,,,,2,3,2,5
11482_0,,,,2,3,2,5
11483_0,,,,2,3,2,5
11485_0,,,,2,3,2,5
C(COC(C(CO)O)O)(C)=O,,,4,1,1,0,1
11487_0,,,,2,3,2,5
C(COC(CO)CO)(CO)=O,,,4,1,1,0,1
11489_0,,,,2,3,2,5
C(C(O)OC(CO)CO)(C)=O,,,4,1,1,0,1
11491_0,,,,2,3,2,5
C(C)(C(CO)OC(CO)O)=O,,,4,1,1,0,1
11493_0,,,,2,3,2,5
C(COCC(CO)O)(CO)=O,,,4,1,1,0,1
11495_0,,,,2,3,2,5
C(C(O)OCC(CO)O)(C)=O,,,4,1,1,0,1
11497_0,,,,2,3,2,5
C(CO)(CC(O)OCCO)=O,,,4,1,1,0,1
11499_0,,,,2,3,2,5
C(C)(C(C(O)OCCO)O)=O,,,4,1,1,0,1
11501_0,,,,2,3,2,5
C(C)(C(COC(CO)O)O)=O,,,4,1,1,0,1
11503_0,,,,2,3,2,5
C(CO)(CCOC(CO)O)=O,,,4,1,1,0,1
11504_0,,,,2,3,2,5
11505_0,,,,2,3,2,5
11506_0,,,,2,3,2,5
11508_0,,,,2,3,2,5
C(CC(CO)(O)OCCO)=O,,,4,1,1,0,1
11510_0,,,,2,3,2,5
C(COC(CO)(CCO)O)=O,,,4,1,1,0,1
11512_0,,,,2,3,2,5
C(C(C(C)(O)OCCO)O)=O,,,4,1,1,0,1
11514_0,,,,2,3,2,5
C(COC(C)(C(CO)O)O)=O,,,4,1,1,0,1
11516_0,,,,2,3,2,5
C(C(CC(O)OCCO)O)=O,,,4,1,1,0,1
11518_0,,,,2,3,2,5
C(COC(CC(CO)O)O)=O,,,4,1,1,0,1
11519_0,,,,2,3,2,5
11520_0,,,,2,3,2,5
11521_0,,,,2,3,2,5
11523_0,,,,2,3,2,5
CC(CO)O,,,4,1,1,0,1
11524_0,,,,2,3,2,5
11525_0,,,,2,3,2,5
11527_0,,,,2,3,2,5
C(C(C(CC(CO)O)O)O)O,,,4,1,2,0,2
11528_0,,,,2,3,2,5
11529_0,,,,2,3,2,5
11531_0,,,,2,3,2,5
C(C(CCC(CO)O)=O)=O,,,4,1,3,0,3
11532_0,,,,2,3,2,5
11533_0,,,,2,3,2,5
11534_0,,,,2,3,2,5
11535_0,,,,2,3,2,5
11536_0,,,,2,3,2,5
11537_0,,,,2,3,2,5
11538_0,,,,2,3,2,5
11539_0,,,,2,3,2,5
11540_0,,,,2,3,2,5
11541_0,,,,2,3,2,5
11542_0,,,,2,3,2,5
11543_0,,,,2,3,2,5
11544_0,,,,2,3,2,5
11545_0,,,,2,3,2,5
11547_0,,,,2,3,2,5
C(C(CO)O)(CCCO)=O,,,4,1,3,0,3
11548_0,,,,2,3,2,5
11550_0,,,,2,3,2,5
C(CC(CO)O)(CCO)=O,,,4,1,3,0,3
11551_0,,,,2,3,2,5
11553_0,,,,2,3,2,5
C(C(C(CO)O)O)=CCO,,,4,1,3,0,3
11554_0,,,,2,3,2,5
11555_0,,,,2,3,2,5
11556_0,,,,2,3,2,5
11557_0,,,,2,3,2,5
11559_0,,,,2,3,2,5
C(CC(CC(CO)=O)O)(O)=O,,,4,1,3,0,3
11561_0,,,,2,3,2,5
C(CC(C(CCO)O)=O)(O)=O,,,4,1,3,0,3
11563_0,,,,2,3,2,5
C(CC(C(CCO)=O)O)(O)=O,,,4,1,3,0,3
11565_0,,,,2,3,2,5
C(C(C(CCCO)=O)O)(O)=O,,,4,1,3,0,3
11567_0,,,,2,3,2,5
C(CCC(O)=O)(C(CO)O)=O,,,4,1,3,0,3
11568_0,,,,2,3,2,5
11570_0,,,,2,3,2,5
C(CC(CC(CO)O)=O)(O)=O,,,4,1,4,0,4
11571_0,,,,2,3,2,5
11572_0,,,,2,3,2,5
11574_0,,,,2,3,2,5
C1(CCC(C1(CO)O)O)=O,,,4,1,4,0,4
11576_0,,,,2,3,2,5
C1C(C(CO)(C(C=1)O)O)O,,,4,1,2,0,2
11578_0,,,,2,3,2,5
C(C1(CO)C(C(C(C1O)O)O)O)O,,,4,1,1,0,1
11580_0,,,,2,3,2,5
C(C(CO)(C(CO)(CO)O)O)O,,,4,1,1,0,1
11581_0,,,,2,3,2,5
11582_0,,,,2,3,2,5
11584_0,,,,2,3,2,5
C(C(CO)(C(C(CO)O)O)O)O,,,4,1,3,0,3
11585_0,,,,2,3,2,5
11587_0,,,,2,3,2,5
C(C(C)(C(CO)(CO)O)O)=O,,,4,1,2,0,2
11588_0,,,,2,3,2,5
11589_0,,,,2,3,2,5
11590_0,,,,2,3,2,5
11591_0,,,,2,3,2,5
11592_0,,,,2,3,2,5
11593_0,,,,2,3,2,5
11594_0,,,,2,3,2,5
11595_0,,,,2,3,2,5
11596_0,,,,2,3,2,5
11597_0,,,,2,3,2,5
11599_0,,,,2,3,2,5
CC(C(CO)O)(C(CO)(CO)O)O,,,4,1,1,0,1
11601_0,,,,2,3,2,5
C(C(CO)(CO)O)O,,,4,1,1,0,1
11602_0,,,,2,3,2,5
11604_0,,,,2,3,2,5
C(C(CCO)(C(CO)(CO)O)O)=O,,,4,1,3,0,3
11605_0,,,,2,3,2,5
11607_0,,,,2,3,2,5
C(C(CCO)(C(CO)(CO)O)O)O,,,4,1,1,0,1
11608_0,,,,2,3,2,5
11609_0,,,,2,3,2,5
11610_0,,,,2,3,2,5
11612_0,,,,2,3,2,5
CC(CO)(C(CO)(CO)O)O,,,4,1,1,0,1
11613_0,,,,2,3,2,5
11614_0,,,,2,3,2,5
11616_0,,,,2,3,2,5
C(C(CC(C(CO)(CO)O)O)O)=O,,,4,1,1,0,1
11618_0,,,,2,3,2,5
C(C(CO)(C(CC(CO)O)O)O)=O,,,4,1,5,0,5
11620_0,,,,2,3,2,5
CC(C(CO)(CO)O)O,,,4,1,1,0,1
11621_0,,,,2,3,2,5
11622_0,,,,2,3,2,5
11623_0,,,,2,3,2,5
11624_0,,,,2,3,2,5
11625_0,,,,2,3,2,5
11626_0,,,,2,3,2,5
11627_0,,,,2,3,2,5
11628_0,,,,2,3,2,5
11629_0,,,,2,3,2,5
11630_0,,,,2,3,2,5
11631_0,,,,2,3,2,5
11632_0,,,,2,3,2,5
11633_0,,,,2,3,2,5
11634_0,,,,2,3,2,5
11635_0,,,,2,3,2,5
11636_0,,,,2,3,2,5
11637_0,,,,2,3,2,5
11638_0,,,,2,3,2,5
11639_0,,,,2,3,2,5
11640_0,,,,2,3,2,5
11641_0,,,,2,3,2,5
11642_0,,,,2,3,2,5
11643_0,,,,2,3,2,5
11644_0,,,,2,3,2,5
11645_0,,,,2,3,2,5
11646_0,,,,2,3,2,5
11647_0,,,,2,3,2,5
11648_0,,,,2,3,2,5
11649_0,,,,2,3,2,5
11650_0,,,,2,3,2,5
11651_0,,,,2,3,2,5
11652_0,,,,2,3,2,5
11653_0,,,,2,3,2,5
11654_0,,,,2,3,2,5
11655_0,,,,2,3,2,5
11656_0,,,,2,3,2,5
11657_0,,,,2,3,2,5
11658_0,,,,2,3,2,5
11659_0,,,,2,3,2,5
11660_0,,,,2,3,2,5
11662_0,,,,2,3,2,5
C(CO)(C(CO)(C(CCO)O)O)=O,,,4,1,5,0,5
11664_0,,,,2,3,2,5
C(C(CO)(C(C(CCO)O)O)O)O,,,4,1,1,0,1
11666_0,,,,2,3,2,5
C(CCO)(C(C(C)=O)(CO)O)=O,,,4,1,5,0,5
11668_0,,,,2,3,2,5
C(C(CO)(CO)O)(CC(C)=O)=O,,,4,1,4,0,4
11670_0,,,,2,3,2,5
C(CCC=O)(C(CO)(CO)O)=O,,,4,1,4,0,4
11672_0,,,,2,3,2,5
C(C(C(CCCO)=O)(CO)O)=O,,,4,1,4,0,4
11674_0,,,,2,3,2,5
C(CO)=CC(C(CO)(CO)O)=O,,,4,1,5,0,5
11675_0,,,,2,3,2,5
11676_0,,,,2,3,2,5
11678_0,,,,2,3,2,5
C=CC(C(CO)(C(CO)O)O)=O,,,4,1,4,0,4
11680_0,,,,2,3,2,5
C(C(C(CO)(CO)O)O)=CC=O,,,4,1,1,0,1
11682_0,,,,2,3,2,5
C(C(CO)(C(C=CCO)O)O)=O,,,4,1,4,0,4
11684_0,,,,2,3,2,5
C1C(CC(C(CO)(CO)O)(O)O1)O,,,4,1,2,0,2
11686_0,,,,2,3,2,5
C(C1(CC(C(CO)(CO)O1)O)O)O,,,4,1,1,0,1
11688_0,,,,2,3,2,5
CC1(C(C(C(CO)(CO)O1)O)O)O,,,4,1,1,0,1
11690_0,,,,2,3,2,5
C(C(CO)(C1C(CC(O)O1)O)O)O,,,4,1,1,0,1
11692_0,,,,2,3,2,5
C(C1(CO)C(C(CC(O)O1)O)O)O,,,4,1,1,0,1
11693_0,,,,2,3,2,5
11694_0,,,,2,3,2,5
11695_0,,,,2,3,2,5
11696_0,,,,2,3,2,5
11697_0,,,,2,3,2,5
11699_0,,,,2,3,2,5
C(C)(C(C(CO)O)(C(C)O)O)=O,,,4,1,5,0,5
11700_0,,,,2,3,2,5
11701_0,,,,2,3,2,5
11702_0,,,,2,3,2,5
11703_0,,,,2,3,2,5
11705_0,,,,2,3,2,5
C(C(C=O)(C(C(CCO)O)O)O)=O,,,4,1,3,0,3
11706_0,,,,2,3,2,5
11708_0,,,,2,3,2,5
C(C(C=O)(C(CC(CO)O)O)O)=O,,,4,1,3,0,3
11709_0,,,,2,3,2,5
11710_0,,,,2,3,2,5
11711_0,,,,2,3,2,5
11712_0,,,,2,3,2,5
11713_0,,,,2,3,2,5
11715_0,,,,2,3,2,5
C(CCO)(C(C(C)=O)(C(C)O)O)=O,,,4,1,3,0,3
11717_0,,,,2,3,2,5
C(C(CO)(C(C)O)O)(CC(C)=O)=O,,,4,1,3,0,3
11719_0,,,,2,3,2,5
C(CCC=O)(C(CO)(C(C)O)O)=O,,,4,1,3,0,3
11721_0,,,,2,3,2,5
C(C(C(CCCO)=O)(C(C)O)O)=O,,,4,1,3,0,3
11723_0,,,,2,3,2,5
C(CO)=CC(C(CO)(C(C)O)O)=O,,,4,1,4,0,4
11724_0,,,,2,3,2,5
11725_0,,,,2,3,2,5
11727_0,,,,2,3,2,5
C=CC(C(C(CO)O)(C(C)O)O)=O,,,4,1,3,0,3
11729_0,,,,2,3,2,5
C(C(C(CO)(C(C)O)O)O)=CC=O,,,4,1,1,0,1
11731_0,,,,2,3,2,5
C(C(C(C)O)(C(C=CCO)O)O)=O,,,4,1,3,0,3
11732_0,,,,2,3,2,5
11733_0,,,,2,3,2,5
11734_0,,,,2,3,2,5
11736_0,,,,2,3,2,5
C(C)(C(C(CO)O)(C(CO)O)O)=O,,,4,1,3,0,3
11737_0,,,,2,3,2,5
11738_0,,,,2,3,2,5
11739_0,,,,2,3,2,5
11741_0,,,,2,3,2,5
C(C(C)(C(CO)(C(CO)O)O)O)=O,,,4,1,4,0,4
11742_0,,,,2,3,2,5
11744_0,,,,2,3,2,5
CC(CO)(C(CO)(C(CO)O)O)O,,,4,1,3,0,3
11746_0,,,,2,3,2,5
CC(C(CO)(C(CO)O)O)O,,,4,1,3,0,3
11747_0,,,,2,3,2,5
11748_0,,,,2,3,2,5
11749_0,,,,2,3,2,5
11750_0,,,,2,3,2,5
11752_0,,,,2,3,2,5
C(C1(CC(C(C1O)O)O)O)O,,,4,1,1,0,1
11754_0,,,,2,3,2,5
C1(CC(C(CO)(C1)O)O)=O,,,4,1,2,0,2
11755_0,,,,2,3,2,5
11756_0,,,,2,3,2,5
11757_0,,,,2,3,2,5
11759_0,,,,2,3,2,5
C(C(CCO)(C(C(CO)O)O)O)=O,,,4,1,4,0,4
11760_0,,,,2,3,2,5
11761_0,,,,2,3,2,5
11762_0,,,,2,3,2,5
11764_0,,,,2,3,2,5
C(C(C)(C(CO)(CC=O)O)O)=O,,,4,1,2,0,2
11766_0,,,,2,3,2,5
C(C(CCO)(C(C=O)(C)O)O)=O,,,4,1,3,0,3
11767_0,,,,2,3,2,5
11768_0,,,,2,3,2,5
11769_0,,,,2,3,2,5
11770_0,,,,2,3,2,5
11771_0,,,,2,3,2,5
11772_0,,,,2,3,2,5
11773_0,,,,2,3,2,5
11774_0,,,,2,3,2,5
11775_0,,,,2,3,2,5
11776_0,,,,2,3,2,5
11777_0,,,,2,3,2,5
11779_0,,,,2,3,2,5
C(C(CO)(CCO)O)=O,,,4,1,2,0,2
11780_0,,,,2,3,2,5
11782_0,,,,2,3,2,5
C(CO)(C(CO)(CC(CO)O)O)=O,,,4,1,3,0,3
11783_0,,,,2,3,2,5
11784_0,,,,2,3,2,5
11785_0,,,,2,3,2,5
11787_0,,,,2,3,2,5
C(C(CO)(CC(C(CO)O)O)O)=O,,,4,1,2,0,2
11788_0,,,,2,3,2,5
11789_0,,,,2,3,2,5
11790_0,,,,2,3,2,5
11792_0,,,,2,3,2,5
C(C(CO)(CC=O)O)(CCO)=O,,,4,1,3,0,3
11794_0,,,,2,3,2,5
C(CC(C(CO)(CCO)O)=O)=O,,,4,1,2,0,2
11795_0,,,,2,3,2,5
11796_0,,,,2,3,2,5
11798_0,,,,2,3,2,5
C(C(CO)(CC(CCO)=O)O)=O,,,4,1,3,0,3
11800_0,,,,2,3,2,5
C(C(CO)(CO)O)=CC(CO)=O,,,4,1,1,0,1
11801_0,,,,2,3,2,5
11802_0,,,,2,3,2,5
11803_0,,,,2,3,2,5
11804_0,,,,2,3,2,5
11805_0,,,,2,3,2,5
11807_0,,,,2,3,2,5
C(CC(CO)(C(C)(CO)O)O)=O,,,4,1,1,0,1
11809_0,,,,2,3,2,5
C(C(CCO)(C(CO)(C)O)O)=O,,,4,1,2,0,2
11810_0,,,,2,3,2,5
11812_0,,,,2,3,2,5
C(C(C(C)O)(CCO)O)=O,,,4,1,2,0,2
11813_0,,,,2,3,2,5
11815_0,,,,2,3,2,5
C(C)(C(C(C)O)(CC(CO)=O)O)=O,,,4,1,2,0,2
11817_0,,,,2,3,2,5
C(C(C(C)O)(CC=O)O)(CCO)=O,,,4,1,2,0,2
11819_0,,,,2,3,2,5
C(CC(C(C(C)O)(CCO)O)=O)=O,,,4,1,2,0,2
11820_0,,,,2,3,2,5
11821_0,,,,2,3,2,5
11823_0,,,,2,3,2,5
C(C(C(C)O)(CC(CCO)=O)O)=O,,,4,1,2,0,2
11825_0,,,,2,3,2,5
C(C(CO)(C(C)O)O)=CC(CO)=O,,,4,1,1,0,1
11826_0,,,,2,3,2,5
11827_0,,,,2,3,2,5
11828_0,,,,2,3,2,5
11829_0,,,,2,3,2,5
11831_0,,,,2,3,2,5
C(CO)(OC(CO)C(CO)O)=O,,,4,1,2,0,2
11832_0,,,,2,3,2,5
11834_0,,,,2,3,2,5
C(CO)(OCC(C(CO)O)O)=O,,,4,1,1,0,1
11836_0,,,,2,3,2,5
C1(CC(C(CCO)O1)O)=O,,,4,1,2,0,2
11838_0,,,,2,3,2,5
C1(COC(CCO)C1O)=O,,,4,1,2,0,2
11840_0,,,,2,3,2,5
C1(C(O)OC(CCO)C1)=O,,,4,1,3,0,3
11842_0,,,,2,3,2,5
C1(C(CCO)OC(C1)O)=O,,,4,1,3,0,3
11844_0,,,,2,3,2,5
C(C=CC(CO)=O)(C)=O,,,4,1,3,0,3
11846_0,,,,2,3,2,5
C(CC=CC(CO)=O)=O,,,4,1,4,0,4
11848_0,,,,2,3,2,5
C(CCO)=CC(C=O)=O,,,4,1,2,0,2
11850_0,,,,2,3,2,5
C(CO)=CC(C(C)=O)=O,,,4,1,3,0,3
11851_0,,,,2,3,2,5
11853_0,,,,2,3,2,5
C(C=CC(CCO)=O)=O,,,4,1,4,0,4
11855_0,,,,2,3,2,5
C(CO)(CC(C=C)=O)=O,,,4,1,3,0,3
11857_0,,,,2,3,2,5
C=CC(C(CCO)=O)=O,,,4,1,3,0,3
11859_0,,,,2,3,2,5
C(CO)(CC=CC=O)=O,,,4,1,4,0,4
11861_0,,,,2,3,2,5
C(CC(C=O)=O)=CCO,,,4,1,3,0,3
11863_0,,,,2,3,2,5
C(C1C(C(C(CO)O1)O)O)O,,,4,1,1,0,1
11865_0,,,,2,3,2,5
C1(C(CCO)OCC1O)=O,,,4,1,2,0,2
11867_0,,,,2,3,2,5
C1(C(CCO)(O)OCC1)=O,,,4,1,3,0,3
11869_0,,,,2,3,2,5
C1(COC(CCO)(C1)O)=O,,,4,1,3,0,3
11871_0,,,,2,3,2,5
C(CO)(C1CC(CO1)O)=O,,,4,1,2,0,2
11873_0,,,,2,3,2,5
C(C1CC(C(CO)O1)O)=O,,,4,1,2,0,2
11875_0,,,,2,3,2,5
C(C1C(CC(CO)O1)O)=O,,,4,1,1,0,1
11877_0,,,,2,3,2,5
C1(C(CO)OC(C)(C1)O)=O,,,4,1,3,0,3
11879_0,,,,2,3,2,5
C1(C(C)(O)OC(CO)C1)=O,,,4,1,3,0,3
11881_0,,,,2,3,2,5
C1(C(C)OC(CO)C1O)=O,,,4,1,2,0,2
11883_0,,,,2,3,2,5
C1C(C(C(C(CO)O1)O)O)O,,,4,1,1,0,1
11885_0,,,,2,3,2,5
C1(CC(CO)(O)OCC1)=O,,,4,1,3,0,3
11887_0,,,,2,3,2,5
C1(COC(CO)(CC1)O)=O,,,4,1,3,0,3
11889_0,,,,2,3,2,5
C1(C(CO)OC(CC1)O)=O,,,4,1,3,0,3
11891_0,,,,2,3,2,5
C1(CC(CO)OC(C1)O)=O,,,4,1,3,0,3
11893_0,,,,2,3,2,5
C1(C(C(C(CCO)O1)O)O)=O,,,4,1,2,0,2
11895_0,,,,2,3,2,5
C1C(C(C(C=1CO)O)O)O,,,4,1,2,0,2
11897_0,,,,2,3,2,5
C=CC(C(C(CO)O)O)O,,,4,1,2,0,2
11899_0,,,,2,3,2,5
C1C(CO)(C(C(C=1)O)O)O,,,4,1,2,0,2
11901_0,,,,2,3,2,5
C1C(C(CO)OC=1CO)O,,,4,1,3,0,3
11903_0,,,,2,3,2,5
C1C(CO)OC(C=1)(CO)O,,,4,1,3,0,3
11905_0,,,,2,3,2,5
C1(C(C(CO1)O)O)=CCO,,,4,1,2,0,2
11907_0,,,,2,3,2,5
C1(C(CO)O)OCC(C=1)O,,,4,1,2,0,2
11909_0,,,,2,3,2,5
C1C(C(CO)O)(OCC=1)O,,,4,1,2,0,2
11910_0,,,,2,3,2,5
11911_0,,,,2,3,2,5
11913_0,,,,2,3,2,5
C=C1C(C(C(CO)O1)O)O,,,4,1,2,0,2
11915_0,,,,2,3,2,5
C1C(C(CO)O)OC(C=1)O,,,4,1,2,0,2
11917_0,,,,2,3,2,5
C1OC(C(CO)O)C(C=1)O,,,4,1,2,0,2
11919_0,,,,2,3,2,5
C1C(C(COC=1CO)O)O,,,4,1,2,0,2
11921_0,,,,2,3,2,5
C1C(COC(C=1)(CO)O)O,,,4,1,2,0,2
11923_0,,,,2,3,2,5
C1C(C(CO)OC(C=1)O)O,,,4,1,2,0,2
11925_0,,,,2,3,2,5
C1OC(CO)C(C(C=1)O)O,,,4,1,2,0,2
11926_0,,,,2,3,2,5
11928_0,,,,2,3,2,5
C(C1(C(CC(CO)O1)O)O)O,,,4,1,3,0,3
11929_0,,,,2,3,2,5
11931_0,,,,2,3,2,5
C1CC(C(C(CO)O)(O)O1)O,,,4,1,2,0,2
11933_0,,,,2,3,2,5
C(C(C1CC(C(O)O1)O)O)O,,,4,1,2,0,2
11934_0,,,,2,3,2,5
11936_0,,,,2,3,2,5
C1C(CC(C(CO)(O)O1)O)O,,,4,1,2,0,2
11938_0,,,,2,3,2,5
C(C1C(CC(C(O)O1)O)O)O,,,4,1,2,0,2
11940_0,,,,2,3,2,5
C(C1CC(C(C(O)O1)O)O)O,,,4,1,2,0,2
11941_0,,,,2,3,2,5
11942_0,,,,2,3,2,5
11944_0,,,,2,3,2,5
C(C(CC(CCO)C(CO)O)=O)=O,,,4,1,2,0,2
11946_0,,,,2,3,2,5
C(CC(C(CO)O)CC(CO)=O)=O,,,4,1,3,0,3
11948_0,,,,2,3,2,5
C(C(C(CC(CO)CCO)=O)O)=O,,,4,1,2,0,2
11950_0,,,,2,3,2,5
C(CC(CO)CC(C(CO)O)=O)=O,,,4,1,3,0,3
11952_0,,,,2,3,2,5
C(C(CCO)CC(C(CO)O)=O)=O,,,4,1,2,0,2
11953_0,,,,2,3,2,5
11955_0,,,,2,3,2,5
C(C(CCO)CC=O)(C(CO)O)=O,,,4,1,2,0,2
11957_0,,,,2,3,2,5
C(C(C(C=O)O)O)(CCCCO)=O,,,4,1,2,0,2
11959_0,,,,2,3,2,5
C(CCCC(C(C(CO)O)O)=O)=O,,,4,1,2,0,2
11961_0,,,,2,3,2,5
C(C(C(CCO)CC(CO)=O)O)=O,,,4,1,2,0,2
11962_0,,,,2,3,2,5
11964_0,,,,2,3,2,5
C(CC(C(C(C=O)O)O)CCO)=O,,,4,1,2,0,2
11966_0,,,,2,3,2,5
C(CC(C(C(CO)O)O)CC=O)=O,,,4,1,2,0,2
11967_0,,,,2,3,2,5
11968_0,,,,2,3,2,5
11970_0,,,,2,3,2,5
C(C1C(CC(C1O)=O)O)(O)=O,,,4,1,4,0,4
11971_0,,,,2,3,2,5
11973_0,,,,2,3,2,5
C(C1C(C(C(C1)=O)O)O)(O)=O,,,4,1,3,0,3
11974_0,,,,2,3,2,5
11975_0,,,,2,3,2,5
11976_0,,,,2,3,2,5
11977_0,,,,2,3,2,5
11978_0,,,,2,3,2,5
11980_0,,,,2,3,2,5
C(CC(CO)(CO)O)(O)=O,,,4,1,1,0,1
11982_0,,,,2,3,2,5
C(CC(C(CO)O)O)(O)=O,,,4,1,1,0,1
11983_0,,,,2,3,2,5
11984_0,,,,2,3,2,5
11985_0,,,,2,3,2,5
11986_0,,,,2,3,2,5
11987_0,,,,2,3,2,5
11988_0,,,,2,3,2,5
11989_0,,,,2,3,2,5
11990_0,,,,2,3,2,5
11991_0,,,,2,3,2,5
11992_0,,,,2,3,2,5
11993_0,,,,2,3,2,5
11994_0,,,,2,3,2,5
11995_0,,,,2,3,2,5
11996_0,,,,2,3,2,5
11997_0,,,,2,3,2,5
11998_0,,,,2,3,2,5
11999_0,,,,2,3,2,5
12000_0,,,,2,3,2,5
12001_0,,,,2,3,2,5
12002_0,,,,2,3,2,5
12003_0,,,,2,3,2,5
12004_0,,,,2,3,2,5
12005_0,,,,2,3,2,5
12006_0,,,,2,3,2,5
12007_0,,,,2,3,2,5
12008_0,,,,2,3,2,5
12009_0,,,,2,3,2,5
12010_0,,,,2,3,2,5
12011_0,,,,2,3,2,5
12012_0,,,,2,3,2,5
12013_0,,,,2,3,2,5
12014_0,,,,2,3,2,5
12015_0,,,,2,3,2,5
12016_0,,,,2,3,2,5
12017_0,,,,2,3,2,5
12018_0,,,,2,3,2,5
12019_0,,,,2,3,2,5
12020_0,,,,2,3,2,5
12021_0,,,,2,3,2,5
12022_0,,,,2,3,2,5
12024_0,,,,2,3,2,5
C(C(C(C=O)O)C(C(C)=O)O)(O)=O,,,4,1,2,0,2
12025_0,,,,2,3,2,5
12026_0,,,,2,3,2,5
12028_0,,,,2,3,2,5
C(C(C(C(O)=O)C(C=O)(C)O)O)=O,,,4,1,2,0,2
12029_0,,,,2,3,2,5
12031_0,,,,2,3,2,5
C(CC(C(C)=O)O)(O)=O,,,4,1,1,0,1
12032_0,,,,2,3,2,5
12034_0,,,,2,3,2,5
C(C(C)(CC(O)=O)O)=O,,,4,1,1,0,1
12035_0,,,,2,3,2,5
12036_0,,,,2,3,2,5
12037_0,,,,2,3,2,5
12038_0,,,,2,3,2,5
12039_0,,,,2,3,2,5
12040_0,,,,2,3,2,5
12041_0,,,,2,3,2,5
12042_0,,,,2,3,2,5
12043_0,,,,2,3,2,5
12044_0,,,,2,3,2,5
12045_0,,,,2,3,2,5
12046_0,,,,2,3,2,5
12047_0,,,,2,3,2,5
12048_0,,,,2,3,2,5
12049_0,,,,2,3,2,5
12050_0,,,,2,3,2,5
12051_0,,,,2,3,2,5
12052_0,,,,2,3,2,5
12053_0,,,,2,3,2,5
12054_0,,,,2,3,2,5
12055_0,,,,2,3,2,5
12057_0,,,,2,3,2,5
C(CC(C(C(C)=O)O)O)(O)=O,,,4,1,2,0,2
12058_0,,,,2,3,2,5
12060_0,,,,2,3,2,5
C(CC(C)(C(C=O)O)O)(O)=O,,,4,1,1,0,1
12061_0,,,,2,3,2,5
12062_0,,,,2,3,2,5
12063_0,,,,2,3,2,5
12064_0,,,,2,3,2,5
12066_0,,,,2,3,2,5
C(C(C(C=O)O)C(C=O)O)(O)=O,,,4,1,2,0,2
12067_0,,,,2,3,2,5
12069_0,,,,2,3,2,5
C(CC(C)(C(CO)O)O)(O)=O,,,4,1,1,0,1
12070_0,,,,2,3,2,5
12071_0,,,,2,3,2,5
12072_0,,,,2,3,2,5
12073_0,,,,2,3,2,5
12075_0,,,,2,3,2,5
C(CC(CO)(CC(C=O)O)O)(O)=O,,,4,1,1,0,1
12076_0,,,,2,3,2,5
12077_0,,,,2,3,2,5
12079_0,,,,2,3,2,5
C(C(CO)C(C=O)O)(O)=O,,,4,1,2,0,2
12081_0,,,,2,3,2,5
C(CCO)(O)=O,,,4,1,1,0,1
12082_0,,,,2,3,2,5
12083_0,,,,2,3,2,5
12084_0,,,,2,3,2,5
12085_0,,,,2,3,2,5
12086_0,,,,2,3,2,5
12087_0,,,,2,3,2,5
12088_0,,,,2,3,2,5
12089_0,,,,2,3,2,5
12091_0,,,,2,3,2,5
C(C(CO)C(CC(C=O)=O)O)(O)=O,,,4,1,2,0,2
12092_0,,,,2,3,2,5
12093_0,,,,2,3,2,5
12094_0,,,,2,3,2,5
12095_0,,,,2,3,2,5
12096_0,,,,2,3,2,5
12097_0,,,,2,3,2,5
12098_0,,,,2,3,2,5
12099_0,,,,2,3,2,5
12100_0,,,,2,3,2,5
12101_0,,,,2,3,2,5
12103_0,,,,2,3,2,5
C(C(CO)C(C(CC=O)=O)O)(O)=O,,,4,1,2,0,2
12104_0,,,,2,3,2,5
12105_0,,,,2,3,2,5
12106_0,,,,2,3,2,5
12107_0,,,,2,3,2,5
12108_0,,,,2,3,2,5
12110_0,,,,2,3,2,5
C(C(CO)CC(C(C=O)O)=O)(O)=O,,,4,1,1,0,1
12111_0,,,,2,3,2,5
12112_0,,,,2,3,2,5
12113_0,,,,2,3,2,5
12114_0,,,,2,3,2,5
12115_0,,,,2,3,2,5
12116_0,,,,2,3,2,5
12117_0,,,,2,3,2,5
12118_0,,,,2,3,2,5
12119_0,,,,2,3,2,5
12120_0,,,,2,3,2,5
12121_0,,,,2,3,2,5
12122_0,,,,2,3,2,5
12123_0,,,,2,3,2,5
12125_0,,,,2,3,2,5
C(C(CCO)(CC(O)=O)O)=O,,,4,1,1,0,1
12127_0,,,,2,3,2,5
C(CC(CO)(CCO)O)(O)=O,,,4,1,1,0,1
12128_0,,,,2,3,2,5
12129_0,,,,2,3,2,5
12130_0,,,,2,3,2,5
12132_0,,,,2,3,2,5
C(CC(C)(C(C(C=O)O)O)O)(O)=O,,,4,1,1,0,1
12133_0,,,,2,3,2,5
12135_0,,,,2,3,2,5
C(CC(C(C=O)O)O)(O)=O,,,4,1,1,0,1
12136_0,,,,2,3,2,5
12137_0,,,,2,3,2,5
12138_0,,,,2,3,2,5
12140_0,,,,2,3,2,5
C(C(C(CO)(C)O)C(C=O)O)(O)=O,,,4,1,2,0,2
12142_0,,,,2,3,2,5
C(CC(C)(CO)O)(O)=O,,,4,1,1,0,1
12143_0,,,,2,3,2,5
12145_0,,,,2,3,2,5
C(C(C(C)O)C(C=O)O)(O)=O,,,4,1,2,0,2
12146_0,,,,2,3,2,5
12147_0,,,,2,3,2,5
12149_0,,,,2,3,2,5
C(CC(CC(C=O)O)O)(O)=O,,,4,1,1,0,1
12151_0,,,,2,3,2,5
C(CC(C)O)(O)=O,,,4,1,1,0,1
12153_0,,,,2,3,2,5
C(CC(CO)(C(CO)O)O)(O)=O,,,4,1,1,0,1
12154_0,,,,2,3,2,5
12155_0,,,,2,3,2,5
12156_0,,,,2,3,2,5
12157_0,,,,2,3,2,5
12158_0,,,,2,3,2,5
12159_0,,,,2,3,2,5
12160_0,,,,2,3,2,5
12161_0,,,,2,3,2,5
12162_0,,,,2,3,2,5
12163_0,,,,2,3,2,5
12164_0,,,,2,3,2,5
12165_0,,,,2,3,2,5
12166_0,,,,2,3,2,5
12167_0,,,,2,3,2,5
12168_0,,,,2,3,2,5
12169_0,,,,2,3,2,5
12170_0,,,,2,3,2,5
12172_0,,,,2,3,2,5
C(C(C(CO)O)C(C=O)O)(O)=O,,,4,1,2,0,2
12173_0,,,,2,3,2,5
12174_0,,,,2,3,2,5
12175_0,,,,2,3,2,5
12176_0,,,,2,3,2,5
12177_0,,,,2,3,2,5
12178_0,,,,2,3,2,5
12179_0,,,,2,3,2,5
12180_0,,,,2,3,2,5
12182_0,,,,2,3,2,5
C(C(C(CC(CO)O)=O)=O)(O)=O,,,4,1,2,0,2
12184_0,,,,2,3,2,5
C(C(CO)O)(CC(C(O)=O)=O)=O,,,4,1,2,0,2
12186_0,,,,2,3,2,5
C(CCO)(C(C(C(O)=O)=O)O)=O,,,4,1,2,0,2
12188_0,,,,2,3,2,5
C(CO)(CC(C(C(O)=O)=O)O)=O,,,4,1,2,0,2
12190_0,,,,2,3,2,5
C(C)(C(C(C(C(O)=O)=O)O)O)=O,,,4,1,2,0,2
12192_0,,,,2,3,2,5
C(CC(C(C(C(O)=O)=O)O)O)=O,,,4,1,2,0,2
12193_0,,,,2,3,2,5
12194_0,,,,2,3,2,5
12195_0,,,,2,3,2,5
12196_0,,,,2,3,2,5
12197_0,,,,2,3,2,5
12198_0,,,,2,3,2,5
12199_0,,,,2,3,2,5
12201_0,,,,2,3,2,5
C(C(O)=O)(O)=O,,,4,1,1,0,1
12203_0,,,,2,3,2,5
C(C(C(O)=O)O)(O)=O,,,4,1,2,0,2
12205_0,,,,2,3,2,5
C(C(C(C(O)=O)O)O)(O)=O,,,4,1,2,0,2
12207_0,,,,2,3,2,5
C(CC(C(O)=O)O)(O)=O,,,4,1,2,0,2
12209_0,,,,2,3,2,5
C(C)(C(CO)(C(C(O)=O)O)O)=O,,,4,1,7,0,7
12210_0,,,,2,3,2,5
12211_0,,,,2,3,2,5
12212_0,,,,2,3,2,5
12213_0,,,,2,3,2,5
12214_0,,,,2,3,2,5
12216_0,,,,2,3,2,5
C(C(C(OCC(C)=O)O)O)(O)=O,,,4,1,1,0,1
12218_0,,,,2,3,2,5
C(C(CO)OCC(CO)=O)(O)=O,,,4,1,1,0,1
12220_0,,,,2,3,2,5
C(C(CO)OC(C(C)=O)O)(O)=O,,,4,1,1,0,1
12222_0,,,,2,3,2,5
C(C)(C(CO)OC(C(O)=O)O)=O,,,4,1,1,0,1
12224_0,,,,2,3,2,5
C(C(COCC(CO)=O)O)(O)=O,,,4,1,1,0,1
12226_0,,,,2,3,2,5
C(C(COC(C(C)=O)O)O)(O)=O,,,4,1,1,0,1
12228_0,,,,2,3,2,5
C(CO)(CC(OCC(O)=O)O)=O,,,4,1,1,0,1
12230_0,,,,2,3,2,5
C(C)(C(C(OCC(O)=O)O)O)=O,,,4,1,1,0,1
12232_0,,,,2,3,2,5
C(C)(C(COC(C(O)=O)O)O)=O,,,4,1,1,0,1
12234_0,,,,2,3,2,5
C(CO)(CCOC(C(O)=O)O)=O,,,4,1,1,0,1
12235_0,,,,2,3,2,5
12237_0,,,,2,3,2,5
C=CC(C(O)=O)=O,,,4,1,2,0,2
12238_0,,,,2,3,2,5
12240_0,,,,2,3,2,5
C(CC(CO)(OCC(O)=O)O)=O,,,4,1,2,0,2
12242_0,,,,2,3,2,5
C(CC(CO)(OCC=O)O)(O)=O,,,4,1,1,0,1
12244_0,,,,2,3,2,5
C(C(C(C)(OCC(O)=O)O)O)=O,,,4,1,2,0,2
12246_0,,,,2,3,2,5
C(C(C(C)(OCC=O)O)O)(O)=O,,,4,1,1,0,1
12248_0,,,,2,3,2,5
C(C(CC(OCC(O)=O)O)O)=O,,,4,1,2,0,2
12250_0,,,,2,3,2,5
C(C(CC(OCC=O)O)O)(O)=O,,,4,1,1,0,1
12251_0,,,,2,3,2,5
12252_0,,,,2,3,2,5
12253_0,,,,2,3,2,5
12254_0,,,,2,3,2,5
12255_0,,,,2,3,2,5
12256_0,,,,2,3,2,5
12257_0,,,,2,3,2,5
12259_0,,,,2,3,2,5
C(C(C(CC(C(O)=O)O)O)O)(O)=O,,,4,1,3,0,3
12260_0,,,,2,3,2,5
12262_0,,,,2,3,2,5
C(C(CCC(C=O)=O)O)(O)=O,,,4,1,3,0,3
12263_0,,,,2,3,2,5
12264_0,,,,2,3,2,5
12265_0,,,,2,3,2,5
12266_0,,,,2,3,2,5
12267_0,,,,2,3,2,5
12268_0,,,,2,3,2,5
12269_0,,,,2,3,2,5
12270_0,,,,2,3,2,5
12271_0,,,,2,3,2,5
12272_0,,,,2,3,2,5
12273_0,,,,2,3,2,5
12274_0,,,,2,3,2,5
12275_0,,,,2,3,2,5
12276_0,,,,2,3,2,5
12277_0,,,,2,3,2,5
12278_0,,,,2,3,2,5
12279_0,,,,2,3,2,5
12280_0,,,,2,3,2,5
12281_0,,,,2,3,2,5
12282_0,,,,2,3,2,5
12283_0,,,,2,3,2,5
12284_0,,,,2,3,2,5
12286_0,,,,2,3,2,5
C(CC(CC(C(O)=O)=O)O)(O)=O,,,4,1,3,0,3
12287_0,,,,2,3,2,5
12289_0,,,,2,3,2,5
C(CC(C(CC(O)=O)O)=O)(O)=O,,,4,1,3,0,3
12290_0,,,,2,3,2,5
12292_0,,,,2,3,2,5
C(C(C(CCC(O)=O)=O)O)(O)=O,,,4,1,3,0,3
12293_0,,,,2,3,2,5
12295_0,,,,2,3,2,5
C(CC(CC(C(O)=O)O)=O)(O)=O,,,4,1,3,0,3
12296_0,,,,2,3,2,5
12298_0,,,,2,3,2,5
C(C(C(C=CC(O)=O)O)O)(O)=O,,,4,1,3,0,3
12299_0,,,,2,3,2,5
12301_0,,,,2,3,2,5
C(C1(C(CCC1O)=O)O)(O)=O,,,4,1,4,0,4
12303_0,,,,2,3,2,5
C(C1(C(C=CC1O)O)O)(O)=O,,,4,1,4,0,4
12305_0,,,,2,3,2,5
C(C(CO)(C(CO)(CO)O)O)(O)=O,,,4,1,5,0,5
12307_0,,,,2,3,2,5
C(C(C=O)(C(CO)(CO)O)O)(O)=O,,,4,1,5,0,5
12309_0,,,,2,3,2,5
C(C(CO)(C(C(CO)O)O)O)(O)=O,,,4,1,5,0,5
12311_0,,,,2,3,2,5
C(C(CO)(C(C(C)=O)O)O)(O)=O,,,4,1,5,0,5
12313_0,,,,2,3,2,5
C(C(CO)(C(C=O)(C)O)O)(O)=O,,,4,1,5,0,5
12315_0,,,,2,3,2,5
C(C(C)(C(C=O)(CO)O)O)(O)=O,,,4,1,4,0,4
12317_0,,,,2,3,2,5
C(C(CO)(C(C=O)O)O)(O)=O,,,4,1,5,0,5
12319_0,,,,2,3,2,5
C(C(CO)(C(C(O)=O)O)O)=O,,,4,1,6,0,6
12321_0,,,,2,3,2,5
C(C(CO)(CO)O)(O)=O,,,4,1,3,0,3
12323_0,,,,2,3,2,5
C(C(C=O)(C(C(CO)O)O)O)(O)=O,,,4,1,5,0,5
12325_0,,,,2,3,2,5
C(C(CO)(C(C(C=O)O)O)O)(O)=O,,,4,1,5,0,5
12327_0,,,,2,3,2,5
C(C(CO)(C(C(C(O)=O)O)O)O)=O,,,4,1,6,0,6
12329_0,,,,2,3,2,5
C(C(CO)(C(CO)(C)O)O)(O)=O,,,4,1,5,0,5
12331_0,,,,2,3,2,5
C(C(CO)(C(C)O)O)(O)=O,,,4,1,5,0,5
12333_0,,,,2,3,2,5
C(C(C(C)=O)(C(C(C)=O)O)O)(O)=O,,,4,1,5,0,5
12335_0,,,,2,3,2,5
C(C(C)(C(C=O)(C(C)=O)O)O)(O)=O,,,4,1,3,0,3
12337_0,,,,2,3,2,5
C(C(C)(C(C(O)=O)(C(C)=O)O)O)=O,,,4,1,5,0,5
12339_0,,,,2,3,2,5
C(C(C)(C(C(C)=O)(CO)O)O)(O)=O,,,4,1,4,0,4
12341_0,,,,2,3,2,5
C(C(C=O)(C(C(C)=O)O)O)(O)=O,,,4,1,5,0,5
12343_0,,,,2,3,2,5
C(C(C=O)(C(C(O)=O)(C)O)O)=O,,,4,1,3,0,3
12345_0,,,,2,3,2,5
C(C(C=O)(C(C=O)(C)O)O)(O)=O,,,4,1,5,0,5
12347_0,,,,2,3,2,5
C(C(C(C)=O)(C(C=O)O)O)(O)=O,,,4,1,6,0,6
12349_0,,,,2,3,2,5
C(C(C(C)=O)(C(C(O)=O)O)O)=O,,,4,1,3,0,3
12351_0,,,,2,3,2,5
C(C(C(C)=O)(CO)O)(O)=O,,,4,1,6,0,6
12353_0,,,,2,3,2,5
C(C(C(C)=O)(C(CO)(C)O)O)(O)=O,,,4,1,5,0,5
12355_0,,,,2,3,2,5
C(C(C(C)=O)(C(C)O)O)(O)=O,,,4,1,6,0,6
12357_0,,,,2,3,2,5
C(C(C=O)(C(C(O)=O)O)O)=O,,,4,1,3,0,3
12359_0,,,,2,3,2,5
C(C(C=O)(C(C=O)O)O)(O)=O,,,4,1,5,0,5
12361_0,,,,2,3,2,5
C(C(C(C=O)(C(C=O)O)O)O)(O)=O,,,4,1,5,0,5
12363_0,,,,2,3,2,5
C(C(C(C=O)O)(C(C=O)O)O)(O)=O,,,4,1,3,0,3
12365_0,,,,2,3,2,5
C(CO)(C(CO)(C(C(O)=O)O)O)=O,,,4,1,3,0,3
12367_0,,,,2,3,2,5
C(C(C=O)(CO)O)(O)=O,,,4,1,5,0,5
12369_0,,,,2,3,2,5
C(CC(O)=O)(C(C(C)=O)(CO)O)=O,,,4,1,3,0,3
12371_0,,,,2,3,2,5
C(C(C(CC(C)=O)=O)(CO)O)(O)=O,,,4,1,5,0,5
12373_0,,,,2,3,2,5
C(C(C(CCC=O)=O)(CO)O)(O)=O,,,4,1,5,0,5
12375_0,,,,2,3,2,5
C(C(C(CCC(O)=O)=O)(CO)O)=O,,,4,1,3,0,3
12377_0,,,,2,3,2,5
C(C(C(C=CCO)=O)(CO)O)(O)=O,,,4,1,5,0,5
12379_0,,,,2,3,2,5
C(C=CC(C(CO)(CO)O)=O)(O)=O,,,4,1,3,0,3
12381_0,,,,2,3,2,5
C(C(CO)(C(C(C=C)=O)O)O)(O)=O,,,4,1,5,0,5
12383_0,,,,2,3,2,5
C(C(C(C(C=C)=O)(CO)O)O)(O)=O,,,4,1,3,0,3
12385_0,,,,2,3,2,5
C(C(CO)(C(C=CC=O)O)O)(O)=O,,,4,1,5,0,5
12387_0,,,,2,3,2,5
C(C(CO)(C(C=CC(O)=O)O)O)=O,,,4,1,3,0,3
12389_0,,,,2,3,2,5
C(C(C(C)O)(C(C(C)=O)O)O)(O)=O,,,4,1,5,0,5
12391_0,,,,2,3,2,5
C(C)(C(C(C)O)(C(C(O)=O)O)O)=O,,,4,1,5,0,5
12393_0,,,,2,3,2,5
C(C(C=O)(C(C(C(O)=O)O)O)O)=O,,,4,1,3,0,3
12395_0,,,,2,3,2,5
C(C(C=O)(C(C(C=O)O)O)O)(O)=O,,,4,1,5,0,5
12397_0,,,,2,3,2,5
C(C(C=O)(C(CO)(C)O)O)(O)=O,,,4,1,5,0,5
12399_0,,,,2,3,2,5
C(C(C=O)(C(C)O)O)(O)=O,,,4,1,5,0,5
12401_0,,,,2,3,2,5
C(C(C(C)O)(C(C=O)O)O)(O)=O,,,4,1,5,0,5
12403_0,,,,2,3,2,5
C(C(C(C)O)(C(C(O)=O)O)O)=O,,,4,1,6,0,6
12404_0,,,,2,3,2,5
12406_0,,,,2,3,2,5
C(C(C(C)=O)(C(CO)O)O)(O)=O,,,4,1,6,0,6
12408_0,,,,2,3,2,5
C(C(C=O)(C(CO)O)O)(O)=O,,,4,1,5,0,5
12409_0,,,,2,3,2,5
12411_0,,,,2,3,2,5
C(C(C(CO)O)(C(C(O)=O)O)O)=O,,,4,1,6,0,6
12412_0,,,,2,3,2,5
12414_0,,,,2,3,2,5
C(C1(C(C(C(C1)O)O)O)O)(O)=O,,,4,1,2,0,2
12416_0,,,,2,3,2,5
C(C1(C(CC(C1)=O)O)O)(O)=O,,,4,1,3,0,3
12418_0,,,,2,3,2,5
C(C(CC=O)(C(C(C)=O)O)O)(O)=O,,,4,1,2,0,2
12420_0,,,,2,3,2,5
C(CC(C=O)(C(C(C)=O)O)O)(O)=O,,,4,1,2,0,2
12422_0,,,,2,3,2,5
C(C(C)(C(C=O)(CC=O)O)O)(O)=O,,,4,1,3,0,3
12424_0,,,,2,3,2,5
C(CC(C(O)=O)(C(C=O)(C)O)O)=O,,,4,1,2,0,2
12426_0,,,,2,3,2,5
C(CC(C=O)(C(C=O)(C)O)O)(O)=O,,,4,1,2,0,2
12428_0,,,,2,3,2,5
C(C(C)(C(C(O)=O)O)O)(O)=O,,,4,1,3,0,3
12430_0,,,,2,3,2,5
C(CC(CO)(C(C(O)=O)O)O)(O)=O,,,4,1,2,0,2
12432_0,,,,2,3,2,5
C(C(C(C)(C(C(O)=O)O)O)O)(O)=O,,,4,1,2,0,2
12434_0,,,,2,3,2,5
C(C(C(C=O)(CC=O)O)O)(O)=O,,,4,1,3,0,3
12436_0,,,,2,3,2,5
C(C(CC=O)(C(C=O)O)O)(O)=O,,,4,1,3,0,3
12438_0,,,,2,3,2,5
C(CC(C=O)(C(C=O)O)O)(O)=O,,,4,1,2,0,2
12440_0,,,,2,3,2,5
C(C(CO)(CC(CO)=O)O)(O)=O,,,4,1,2,0,2
12442_0,,,,2,3,2,5
C(C(C(C)O)(CC(CO)=O)O)(O)=O,,,4,1,2,0,2
12444_0,,,,2,3,2,5
C(C(CO)(CC=O)O)(O)=O,,,4,1,3,0,3
12446_0,,,,2,3,2,5
C(C(CO)(CC(O)=O)O)=O,,,4,1,2,0,2
12447_0,,,,2,3,2,5
12449_0,,,,2,3,2,5
C(C(CO)(CC=O)O)(CC(O)=O)=O,,,4,1,2,0,2
12451_0,,,,2,3,2,5
C(C(CO)(CC(O)=O)O)(CC=O)=O,,,4,1,2,0,2
12453_0,,,,2,3,2,5
C(C(CO)(CC(C(C)=O)=O)O)(O)=O,,,4,1,2,0,2
12455_0,,,,2,3,2,5
C(C(CO)(CC(CC=O)=O)O)(O)=O,,,4,1,2,0,2
12457_0,,,,2,3,2,5
C(C(CO)(CC(CC(O)=O)=O)O)=O,,,4,1,2,0,2
12459_0,,,,2,3,2,5
C(C(C=CC(CO)=O)(CO)O)(O)=O,,,4,1,2,0,2
12461_0,,,,2,3,2,5
C(C(CCO)(C(C(O)=O)O)O)(O)=O,,,4,1,3,0,3
12463_0,,,,2,3,2,5
C(C(C(C(C(O)=O)O)O)O)(O)=O,,,4,1,2,0,2
12465_0,,,,2,3,2,5
C(C(C(CO)(C)O)(CC=O)O)(O)=O,,,4,1,2,0,2
12467_0,,,,2,3,2,5
C(C(C(CO)(C)O)(CC(O)=O)O)=O,,,4,1,2,0,2
12468_0,,,,2,3,2,5
12470_0,,,,2,3,2,5
C(C(C(C)O)(CC(O)=O)O)=O,,,4,1,2,0,2
12472_0,,,,2,3,2,5
C(C(C(CO)O)(CC=O)O)(O)=O,,,4,1,3,0,3
12474_0,,,,2,3,2,5
C(C(C(CO)O)(CC(O)=O)O)=O,,,4,1,2,0,2
12476_0,,,,2,3,2,5
C(C(C(CO)O)OC(CO)=O)(O)=O,,,4,1,1,0,1
12478_0,,,,2,3,2,5
C(C(C(CO)OC(CO)=O)O)(O)=O,,,4,1,1,0,1
12480_0,,,,2,3,2,5
C(C(C(COC(CO)=O)O)O)(O)=O,,,4,1,1,0,1
12482_0,,,,2,3,2,5
C1(CC(C(CC(O)=O)O1)O)=O,,,4,1,2,0,2
12484_0,,,,2,3,2,5
C(CC1C(C(CO1)=O)O)(O)=O,,,4,1,2,0,2
12486_0,,,,2,3,2,5
C(CC1CC(C(O)O1)=O)(O)=O,,,4,1,3,0,3
12488_0,,,,2,3,2,5
C(CC1C(CC(O1)O)=O)(O)=O,,,4,1,3,0,3
12490_0,,,,2,3,2,5
C(C(C=CC(C)=O)=O)(O)=O,,,4,1,3,0,3
12492_0,,,,2,3,2,5
C(CC=CC(C(O)=O)=O)=O,,,4,1,3,0,3
12494_0,,,,2,3,2,5
C(CC=CC(C=O)=O)(O)=O,,,4,1,2,0,2
12496_0,,,,2,3,2,5
C(C=CC(C(C)=O)=O)(O)=O,,,4,1,3,0,3
12498_0,,,,2,3,2,5
C(CC(C=CC(O)=O)=O)=O,,,4,1,5,0,5
12500_0,,,,2,3,2,5
C(CC(C=CC=O)=O)(O)=O,,,4,1,4,0,4
12502_0,,,,2,3,2,5
C=CC(CC(C(O)=O)=O)=O,,,4,1,3,0,3
12504_0,,,,2,3,2,5
C(CC(C(C=C)=O)=O)(O)=O,,,4,1,3,0,3
12506_0,,,,2,3,2,5
C(CC(C(O)=O)=O)=CC=O,,,4,1,3,0,3
12508_0,,,,2,3,2,5
C(CC(C=O)=O)=CC(O)=O,,,4,1,3,0,3
12510_0,,,,2,3,2,5
C(C1C(C(C(CO)O1)O)O)(O)=O,,,4,1,1,0,1
12512_0,,,,2,3,2,5
C(CC1C(C(CO1)O)=O)(O)=O,,,4,1,2,0,2
12514_0,,,,2,3,2,5
C(CC1(C(CCO1)=O)O)(O)=O,,,4,1,3,0,3
12516_0,,,,2,3,2,5
C(CC1(CC(CO1)=O)O)(O)=O,,,4,1,3,0,3
12518_0,,,,2,3,2,5
C(C(C1CC(CO1)O)=O)(O)=O,,,4,1,2,0,2
12520_0,,,,2,3,2,5
C(C1C(CC(C=O)O1)O)(O)=O,,,4,1,2,0,2
12522_0,,,,2,3,2,5
C(C1CC(C(C=O)O1)O)(O)=O,,,4,1,1,0,1
12524_0,,,,2,3,2,5
C(C1C(CC(C)(O1)O)=O)(O)=O,,,4,1,3,0,3
12526_0,,,,2,3,2,5
C1(CC(C(O)=O)OC1(C)O)=O,,,4,1,3,0,3
12528_0,,,,2,3,2,5
C(C1C(C(C(C)O1)=O)O)(O)=O,,,4,1,2,0,2
12530_0,,,,2,3,2,5
C(C1C(C(C(CO1)O)O)O)(O)=O,,,4,1,1,0,1
12532_0,,,,2,3,2,5
C1(CC(C(O)=O)(O)OCC1)=O,,,4,1,3,0,3
12534_0,,,,2,3,2,5
C(C1(CCC(CO1)=O)O)(O)=O,,,4,1,3,0,3
12536_0,,,,2,3,2,5
C(C1C(CCC(O1)O)=O)(O)=O,,,4,1,3,0,3
12538_0,,,,2,3,2,5
C1(CC(C(O)=O)OC(C1)O)=O,,,4,1,3,0,3
12540_0,,,,2,3,2,5
C(CC1C(C(C(O1)=O)O)O)(O)=O,,,4,1,2,0,2
12542_0,,,,2,3,2,5
C1C(C(C(C=1C(O)=O)O)O)O,,,4,1,2,0,2
12544_0,,,,2,3,2,5
C(C(C(C(C=C)O)O)O)(O)=O,,,4,1,2,0,2
12546_0,,,,2,3,2,5
C(C1(C=CC(C1O)O)O)(O)=O,,,4,1,2,0,2
12548_0,,,,2,3,2,5
C1C(C(CO)OC=1C(O)=O)O,,,4,1,2,0,2
12550_0,,,,2,3,2,5
C(C1(C=CC(CO)O1)O)(O)=O,,,4,1,2,0,2
12552_0,,,,2,3,2,5
C1(C(C(CO1)O)O)=CC(O)=O,,,4,1,2,0,2
12554_0,,,,2,3,2,5
C(C(C1OCC(C=1)O)O)(O)=O,,,4,1,2,0,2
12556_0,,,,2,3,2,5
C(C(C1(C=CCO1)O)O)(O)=O,,,4,1,2,0,2
12558_0,,,,2,3,2,5
C(C1C=CC(CO)(O1)O)(O)=O,,,4,1,2,0,2
12560_0,,,,2,3,2,5
C(C1C(C=C(CO)O1)O)(O)=O,,,4,1,2,0,2
12562_0,,,,2,3,2,5
C(C1C(C(C(O1)=C)O)O)(O)=O,,,4,1,2,0,2
12564_0,,,,2,3,2,5
C(C(C1C=CC(O)O1)O)(O)=O,,,4,1,2,0,2
12566_0,,,,2,3,2,5
C(C(C1C(C=CO1)O)O)(O)=O,,,4,1,2,0,2
12568_0,,,,2,3,2,5
C1C(C(COC=1C(O)=O)O)O,,,4,1,2,0,2
12570_0,,,,2,3,2,5
C(C1(C=CC(CO1)O)O)(O)=O,,,4,1,2,0,2
12572_0,,,,2,3,2,5
C(C1C(C=CC(O)O1)O)(O)=O,,,4,1,2,0,2
12574_0,,,,2,3,2,5
C(C1C(C(C=CO1)O)O)(O)=O,,,4,1,2,0,2
12576_0,,,,2,3,2,5
C(C1(C(C(C(CO)O1)O)O)O)(O)=O,,,4,1,2,0,2
12578_0,,,,2,3,2,5
C(C1(C(CC(CO)O1)O)O)(O)=O,,,4,1,2,0,2
12580_0,,,,2,3,2,5
C(C1CC(C(CO)(O1)O)O)(O)=O,,,4,1,2,0,2
12582_0,,,,2,3,2,5
C(C(C1(C(CCO1)O)O)O)(O)=O,,,4,1,2,0,2
12584_0,,,,2,3,2,5
C(C(C1CC(C(O)O1)O)O)(O)=O,,,4,1,2,0,2
12586_0,,,,2,3,2,5
C(C1(C(C(C(CO1)O)O)O)O)(O)=O,,,4,1,2,0,2
12588_0,,,,2,3,2,5
C(C1(C(CC(CO1)O)O)O)(O)=O,,,4,1,2,0,2
12590_0,,,,2,3,2,5
C(C1C(CC(C(O1)O)O)O)(O)=O,,,4,1,2,0,2
12592_0,,,,2,3,2,5
C(C1CC(C(C(O1)O)O)O)(O)=O,,,4,1,2,0,2
12594_0,,,,2,3,2,5
C1(CC(C(C(C(O)=O)O)O1)O)=O,,,4,1,2,0,2
12596_0,,,,2,3,2,5
C1(CC(C(C(C(O)=O)O1)O)O)=O,,,4,1,2,0,2
12598_0,,,,2,1,1,2
C(CO)(C1(C(C(CC1O)O)O)O)=O,,,4,1,4,0,4
12598_1,,,,2,1,1,2
12599_0,,,,2,1,1,2
12599_1,,,,2,1,1,2
12600_0,,,,2,1,1,2
12600_1,,,,2,1,1,2
12601_0,,,,2,1,1,2
12601_1,,,,2,1,1,2
12602_0,,,,2,1,1,2
12602_1,,,,2,1,1,2
12603_0,,,,2,1,1,2
12603_1,,,,2,1,1,2
12604_0,,,,2,1,1,2
12604_1,,,,2,1,1,2
12605_0,,,,2,1,1,2
12605_1,,,,2,1,1,2
12606_0,,,,2,1,1,2
12606_1,,,,2,1,1,2
12607_0,,,,2,1,1,2
12607_1,,,,2,1,1,2
12608_0,,,,2,1,1,2
12608_1,,,,2,1,1,2
12610_0,,,,2,1,1,2
C(C1(C(C(CC1(C=O)O)O)O)O)=O,,,4,1,2,0,2
12610_1,,,,2,1,1,2
12611_0,,,,2,1,1,2
12611_1,,,,2,1,1,2
12612_0,,,,2,1,1,2
12612_1,,,,2,1,1,2
12613_0,,,,2,1,1,2
12613_1,,,,2,1,1,2
12614_0,,,,2,1,1,2
12614_1,,,,2,1,1,2
12615_0,,,,2,1,1,2
12615_1,,,,2,1,1,2
12616_0,,,,2,1,1,2
12616_1,,,,2,1,1,2
12617_0,,,,2,1,1,2
12617_1,,,,2,1,1,2
12618_0,,,,2,1,1,2
12618_1,,,,2,1,1,2
12619_0,,,,2,1,1,2
12619_1,,,,2,1,1,2
12620_0,,,,2,1,1,2
12620_1,,,,2,1,1,2
12621_0,,,,2,1,1,2
12621_1,,,,2,1,1,2
12622_0,,,,2,1,1,2
12622_1,,,,2,1,1,2
12624_0,,,,2,1,1,2
C1(C(C(CO)C(C1(CO)O)O)O)=O,,,4,1,4,0,4
12624_1,,,,2,1,1,2
12626_0,,,,2,1,1,2
C1(C(CC(C(C1(CO)O)O)O)O)=O,,,4,1,4,0,4
12626_1,,,,2,1,1,2
12628_0,,,,2,1,1,2
C1(C(CC(CO)(C1(CO)O)O)O)=O,,,4,1,4,0,4
12628_1,,,,2,1,1,2
12630_0,,,,2,1,1,2
C1(CC(C(CO)(C1(CO)O)O)O)=O,,,4,1,4,0,4
12630_1,,,,2,1,1,2
12631_0,,,,2,1,1,2
12631_1,,,,2,1,1,2
12633_0,,,,2,1,1,2
C1(C(CO)(CO)C(C(C1)=O)O)=O,,,4,1,3,0,3
12635_0,,,,2,1,1,2
C1(CCC(C(C1(CO)O)O)=O)=O,,,4,1,5,0,5
12635_1,,,,2,1,1,2
12637_0,,,,2,1,1,2
C1(C(CO)(C(C=O)(CC1)O)O)=O,,,4,1,5,0,5
12637_1,,,,2,1,1,2
12639_0,,,,2,1,1,2
C(C1(CO)C(CC(C1O)=O)O)=O,,,4,1,4,0,4
12641_0,,,,2,1,1,2
C1(C(CC(C1(CO)CO)O)=O)=O,,,4,1,3,0,3
12642_0,,,,2,1,1,2
12642_1,,,,2,1,1,2
12644_0,,,,2,1,1,2
C(C1(C(C(CC1O)O)=O)CO)=O,,,4,1,2,0,2
12645_0,,,,2,1,1,2
12646_0,,,,2,1,1,2
12646_1,,,,2,1,1,2
12648_0,,,,2,1,1,2
C(C1(C(CC(CO)C1O)=O)O)=O,,,4,1,3,0,3
12648_1,,,,2,1,1,2
12650_0,,,,2,1,1,2
C(C1(CO)C(C(C(C1)=O)O)O)=O,,,4,1,3,0,3
12652_0,,,,2,1,1,2
C(C1(C(CC(C1O)O)=O)CO)=O,,,4,1,3,0,3
12654_0,,,,2,1,1,2
C1C(C(C(C(C=1)=O)(CO)O)O)O,,,4,1,5,0,5
12654_1,,,,2,1,1,2
12655_0,,,,2,1,1,2
12655_1,,,,2,1,1,2
12657_0,,,,2,1,1,2
C(C)(C1(C(C(CC1O)O)O)O)=O,,,4,1,4,0,4
12657_1,,,,2,1,1,2
12659_0,,,,2,1,1,2
C(C1(C(C(C)(CC1O)O)O)O)=O,,,4,1,2,0,2
12659_1,,,,2,1,1,2
12660_0,,,,2,1,1,2
12660_1,,,,2,1,1,2
12661_0,,,,2,1,1,2
12661_1,,,,2,1,1,2
12663_0,,,,2,1,1,2
C(C1(C(C(CC1(CO)O)O)O)O)=O,,,4,1,4,0,4
12663_1,,,,2,1,1,2
12665_0,,,,2,1,1,2
C(C)(C1(C(C(C(C1O)O)O)O)O)=O,,,4,1,2,0,2
12665_1,,,,2,1,1,2
12667_0,,,,2,1,1,2
C(C1(C(C(C(C1(C)O)O)O)O)O)=O,,,4,1,4,0,4
12667_1,,,,2,1,1,2
12669_0,,,,2,1,1,2
C1(C(CO)(C(C)O)C(C(C1)=O)O)=O,,,4,1,2,0,2
12671_0,,,,2,1,1,2
C1(CCC(C(C1(C(C)O)O)O)=O)=O,,,4,1,4,0,4
12671_1,,,,2,1,1,2
12673_0,,,,2,1,1,2
C1(C(C(C)O)(C(C=O)(CC1)O)O)=O,,,4,1,5,0,5
12673_1,,,,2,1,1,2
12675_0,,,,2,1,1,2
C(C1(C(CC(C1O)=O)O)C(C)O)=O,,,4,1,3,0,3
12677_0,,,,2,1,1,2
C1(C(CC(C1(CO)C(C)O)O)=O)=O,,,4,1,2,0,2
12678_0,,,,2,1,1,2
12678_1,,,,2,1,1,2
12680_0,,,,2,1,1,2
C1(CC(CC(C1(C(C)=O)O)O)O)=O,,,4,1,2,0,2
12680_1,,,,2,1,1,2
12682_0,,,,2,1,1,2
C(C1(C(C(CC1O)O)=O)C(C)O)=O,,,4,1,2,0,2
12683_0,,,,2,1,1,2
12685_0,,,,2,1,1,2
C(C1(C(CC(C)(CC1O)O)=O)O)=O,,,4,1,2,0,2
12685_1,,,,2,1,1,2
12686_0,,,,2,1,1,2
12686_1,,,,2,1,1,2
12687_0,,,,2,1,1,2
12687_1,,,,2,1,1,2
12689_0,,,,2,1,1,2
C(C1(C(CCC(CC1O)O)=O)O)=O,,,4,1,2,0,2
12689_1,,,,2,1,1,2
12690_0,,,,2,1,1,2
12690_1,,,,2,1,1,2
12692_0,,,,2,1,1,2
C(C1(C(CC(C1O)C(C)O)=O)O)=O,,,4,1,2,0,2
12692_1,,,,2,1,1,2
12694_0,,,,2,1,1,2
C(C1(C(C(C(C1)=O)O)O)C(C)O)=O,,,4,1,2,0,2
12696_0,,,,2,1,1,2
C(C1(C(CC(C1O)O)=O)C(C)O)=O,,,4,1,2,0,2
12698_0,,,,2,1,1,2
C1C(CC(C(C(C=1)=O)(CO)O)O)O,,,4,1,2,0,2
12698_1,,,,2,1,1,2
12700_0,,,,2,1,1,2
C=CC(C1(C(C(CC1O)O)O)O)=O,,,4,1,2,0,2
12700_1,,,,2,1,1,2
12702_0,,,,2,1,1,2
C(C1(C(C(C=C)(CC1O)O)O)O)=O,,,4,1,2,0,2
12702_1,,,,2,1,1,2
12704_0,,,,2,1,1,2
C1C(C(C(C(C=1)=O)(C(C)O)O)O)O,,,4,1,4,0,4
12704_1,,,,2,1,1,2
12706_0,,,,2,1,1,2
C(C1(C(CC(C=CC1O)O)O)O)=O,,,4,1,2,0,2
12706_1,,,,2,1,1,2
12707_0,,,,2,1,1,2
12707_1,,,,2,1,1,2
12708_0,,,,2,1,1,2
12708_1,,,,2,1,1,2
12709_0,,,,2,1,1,2
12709_1,,,,2,1,1,2
12711_0,,,,2,1,1,2
C(C1(C(C(C)(C(C1O)O)O)O)O)=O,,,4,1,2,0,2
12711_1,,,,2,1,1,2
12713_0,,,,2,1,1,2
C(C1(C(C(C(C1O)O)O)O)O)=O,,,4,1,2,0,2
12713_1,,,,2,1,1,2
12714_0,,,,2,1,1,2
12714_1,,,,2,1,1,2
12715_0,,,,2,1,1,2
12717_0,,,,2,1,1,2
C(C1(C(C(CO)C(C1O)O)O)O)=O,,,4,1,2,0,2
12717_1,,,,2,1,1,2
12718_0,,,,2,1,1,2
12720_0,,,,2,1,1,2
C1(C(CO)(C(C(C1)=O)O)O)=O,,,4,1,2,0,2
12720_1,,,,2,1,1,2
12722_0,,,,2,1,1,2
C(C1(C(O)OCC1(C)O)O)=O,,,4,1,3,0,3
12722_1,,,,2,1,1,2
12724_0,,,,2,1,1,2
C(C1(COCC1(CO)O)O)=O,,,4,1,2,0,2
12724_1,,,,2,1,1,2
12726_0,,,,2,1,1,2
C(C1(COC(C1(C)O)O)O)=O,,,4,1,3,0,3
12726_1,,,,2,1,1,2
12728_0,,,,2,1,1,2
C(C)(C1(C(O)OCC1O)O)=O,,,4,1,4,0,4
12728_1,,,,2,1,1,2
12730_0,,,,2,1,1,2
C(C)(C1(COC(C1O)O)O)=O,,,4,1,3,0,3
12730_1,,,,2,1,1,2
12732_0,,,,2,1,1,2
C(C1(C(C)(O)OCC1O)O)=O,,,4,1,3,0,3
12732_1,,,,2,1,1,2
12733_0,,,,2,1,1,2
12733_1,,,,2,1,1,2
12734_0,,,,2,1,1,2
12734_1,,,,2,1,1,2
12735_0,,,,2,1,1,2
12736_0,,,,2,1,1,2
12737_0,,,,2,1,1,2
12737_1,,,,2,1,1,2
12738_0,,,,2,1,1,2
12738_1,,,,2,1,1,2
12740_0,,,,2,1,1,2
C1(C(CO)(C(CC1(CO)O)O)O)=O,,,4,1,3,0,3
12740_1,,,,2,1,1,2
12742_0,,,,2,1,1,2
C(C1(C(C(CO)(CC1O)O)O)O)=O,,,4,1,2,0,2
12742_1,,,,2,1,1,2
12744_0,,,,2,1,1,2
C(C1(C(C(C=O)(CC1O)O)O)O)=O,,,4,1,3,0,3
12744_1,,,,2,1,1,2
12746_0,,,,2,1,1,2
C(C1(C(C(C(C1O)O)O)O)O)(O)=O,,,4,1,2,0,2
12746_1,,,,2,1,1,2
12747_0,,,,2,1,1,2
12747_1,,,,2,1,1,2
12749_0,,,,2,1,1,2
C1(C2C(C(CC2O)O1)O)=O,,,4,1,2,0,2
12751_0,,,,2,1,1,2
C1(C2CC(C1(CO2)O)O)=O,,,4,1,2,0,2
12751_1,,,,2,1,1,2
12753_0,,,,2,1,1,2
C1(C2(C(C(CC2O)O1)O)O)=O,,,4,1,4,0,4
12753_1,,,,2,1,1,2
12755_0,,,,2,1,1,2
C1(C2C(C(C(C2O)O1)O)O)=O,,,4,1,4,0,4
12756_0,,,,2,1,1,2
12758_0,,,,2,1,1,2
C(C1(C(CC(CO)CC1O)=O)O)=O,,,4,1,3,0,3
12758_1,,,,2,1,1,2
12760_0,,,,2,1,1,2
C(C1CC(C(C(C1)=O)(CO)O)O)=O,,,4,1,3,0,3
12760_1,,,,2,1,1,2
12762_0,,,,2,1,1,2
C1(CC(C(C1(CO)O)O)CC=O)=O,,,4,1,3,0,3
12762_1,,,,2,1,1,2
12764_0,,,,2,1,1,2
C1(C(CC(C1(CO)O)O)CC=O)=O,,,4,1,3,0,3
12764_1,,,,2,1,1,2
12766_0,,,,2,1,1,2
C(C1(C(CCCC(C1O)=O)O)O)=O,,,4,1,3,0,3
12766_1,,,,2,1,1,2
12768_0,,,,2,1,1,2
C1(C(C(CCC1)O)(C(C=O)O)O)=O,,,4,1,3,0,3
12768_1,,,,2,1,1,2
12770_0,,,,2,1,1,2
C(C1(C(C(CC1O)CC=O)O)O)=O,,,4,1,3,0,3
12770_1,,,,2,1,1,2
12772_0,,,,2,2,1,3
C(C1(C(CC(C1O)O)=O)O)(O)=O,,,4,1,2,0,2
12772_1,,,,2,2,1,3
12774_0,,,,2,2,1,3
C(C1(C(CC(C1O)=O)=O)CO)(O)=O,,,4,1,1,0,1
12776_0,,,,2,2,1,3
C(C1(C(CCC(C1O)=O)=O)O)(O)=O,,,4,1,2,0,2
12776_1,,,,2,2,1,3
12778_0,,,,2,2,1,3
C1(CCC(C=O)(C1(C(O)=O)O)O)=O,,,4,1,2,0,2
12778_1,,,,2,2,1,3
12780_0,,,,2,2,1,3
C(C1(C=O)C(CC(C1O)=O)O)(O)=O,,,4,1,1,0,1
12782_0,,,,2,2,1,3
C(C1(C(C(CC1O)=O)=O)CO)(O)=O,,,4,1,1,0,1
12784_0,,,,2,2,1,3
C(C1(C(CC(CC1O)=O)=O)O)(O)=O,,,4,1,2,0,2
12784_1,,,,2,2,1,3
12786_0,,,,2,2,1,3
C(C1(C(CC(CC1=O)O)=O)O)(O)=O,,,4,1,2,0,2
12786_1,,,,2,2,1,3
12788_0,,,,2,2,1,3
C(C1(C=O)C(C(CC1O)O)=O)(O)=O,,,4,1,1,0,1
12790_0,,,,2,2,1,3
C(C1C(C(C(O)=O)(C(C1)=O)O)O)=O,,,4,1,2,0,2
12790_1,,,,2,2,1,3
12792_0,,,,2,2,1,3
C(C1(C=O)C(C(C(C1)=O)O)O)(O)=O,,,4,1,1,0,1
12794_0,,,,2,2,1,3
C(C1(C=O)C(CC(C1O)O)=O)(O)=O,,,4,1,1,0,1
12796_0,,,,2,2,1,3
C(C1(C(C=CC(C1O)O)=O)O)(O)=O,,,4,1,2,0,2
12796_1,,,,2,2,1,3
12798_0,,,,2,2,1,3
C(C(C(CO)=O)(C(C=O)O)O)(O)=O,,,4,1,2,0,2
12798_1,,,,2,2,1,3
12800_0,,,,2,2,1,3
C(C(C=O)(C(C(CO)=O)O)O)(O)=O,,,4,1,4,0,4
12800_1,,,,2,2,1,3
12802_0,,,,2,2,1,3
C(C(C(CO)=O)(C(C)O)O)(O)=O,,,4,1,2,0,2
12802_1,,,,2,2,1,3
12803_0,,,,2,2,1,3
12803_1,,,,2,2,1,3
12804_0,,,,2,2,1,3
12804_1,,,,2,2,1,3
12806_0,,,,2,2,1,3
C(C(C=O)(C(CO)=O)CO)(O)=O,,,4,1,1,0,1
12808_0,,,,2,2,1,3
C(C(C(CC=O)=O)(CO)O)(O)=O,,,4,1,2,0,2
12808_1,,,,2,2,1,3
12810_0,,,,2,2,1,3
C(C(C=O)(C(CO)=O)C(C)O)(O)=O,,,4,1,1,0,1
12812_0,,,,2,2,1,3
C(C(C(CC=O)=O)(C(C)O)O)(O)=O,,,4,1,2,0,2
12812_1,,,,2,2,1,3
12814_0,,,,2,2,1,3
C(C(C=O)(C(CCO)=O)O)(O)=O,,,4,1,2,0,2
12814_1,,,,2,2,1,3
12816_0,,,,2,2,1,3
C(C(C=O)(C(CC(C)O)=O)O)(O)=O,,,4,1,2,0,2
12816_1,,,,2,2,1,3
12818_0,,,,2,2,1,3
C(CC(C(C(O)=O)(C(C)=O)O)O)=O,,,4,1,4,0,4
12818_1,,,,2,2,1,3
12820_0,,,,2,2,1,3
C(C(C=O)(C(C)(CC=O)O)O)(O)=O,,,4,1,4,0,4
12820_1,,,,2,2,1,3
12822_0,,,,2,2,1,3
C(C(C(CCO)=O)(CO)O)(O)=O,,,4,1,2,0,2
12822_1,,,,2,2,1,3
12824_0,,,,2,2,1,3
C(C(C(CC(C)O)=O)(CO)O)(O)=O,,,4,1,2,0,2
12824_1,,,,2,2,1,3
12826_0,,,,2,2,1,3
C(C(C(C=O)=O)(CO)CO)(O)=O,,,4,1,1,0,1
12828_0,,,,2,2,1,3
C(C(C(CO)=O)(CO)CO)(O)=O,,,4,1,1,0,1
12830_0,,,,2,2,1,3
C(C(C=O)(CO)C(C=O)O)(O)=O,,,4,1,1,0,1
12832_0,,,,2,2,1,3
C(C)(C(C(C)O)(C(CCO)O)O)=O,,,4,1,2,0,2
12832_1,,,,2,2,1,3
12834_0,,,,2,2,1,3
C(C(C(C)O)(C(CCO)O)O)=O,,,4,1,2,0,2
12834_1,,,,2,2,1,3
12836_0,,,,2,2,1,3
C(C(C(CO)(C(CCO)O)O)=O)=O,,,4,1,5,0,5
12836_1,,,,2,2,1,3
12838_0,,,,2,2,1,3
C(C(C(CO)=O)(C(CCO)O)O)=O,,,4,1,2,0,2
12838_1,,,,2,2,1,3
12840_0,,,,2,2,1,3
C(C(C(C)=O)(C(CCO)O)O)(O)=O,,,4,1,2,0,2
12840_1,,,,2,2,1,3
12842_0,,,,2,2,1,3
C(C(C=O)(C(CCO)O)O)(O)=O,,,4,1,2,0,2
12842_1,,,,2,2,1,3
12844_0,,,,2,2,1,3
C(C(C(CCO)O)C(C=O)O)(O)=O,,,4,1,1,0,1
12846_0,,,,2,2,1,3
C1(C(C(CO1)O)(C(CCO)O)O)=O,,,4,1,2,0,2
12846_1,,,,2,2,1,3
12848_0,,,,2,2,1,3
C1(C(C(CO1)O)C(CCO)O)=O,,,4,1,1,0,1
12849_0,,,,2,2,1,3
12849_1,,,,2,2,1,3
12851_0,,,,2,2,1,3
C(C(C(C)O)(C(CCO)O)O)(O)=O,,,4,1,2,0,2
12851_1,,,,2,2,1,3
12853_0,,,,2,2,1,3
C1(COCC1(C(CCO)O)O)=O,,,4,1,2,0,2
12853_1,,,,2,2,1,3
12855_0,,,,2,2,1,3
C(C(C(C(CO)O)=O)(CO)O)(O)=O,,,4,1,2,0,2
12855_1,,,,2,2,1,3
12857_0,,,,2,2,1,3
C(C(C(C=O)=O)(CO)C(C)O)(O)=O,,,4,1,1,0,1
12859_0,,,,2,2,1,3
C(C(C(CCO)=O)(C(C)O)O)(O)=O,,,4,1,2,0,2
12859_1,,,,2,2,1,3
12861_0,,,,2,2,1,3
C(C(C(CO)=O)(CO)C(C)O)(O)=O,,,4,1,1,0,1
12863_0,,,,2,2,1,3
C(C(C=O)(C(CC=O)O)O)(O)=O,,,4,1,4,0,4
12863_1,,,,2,2,1,3
12864_0,,,,2,2,1,3
12864_1,,,,2,2,1,3
12865_0,,,,2,2,1,3
12865_1,,,,2,2,1,3
12866_0,,,,2,2,1,3
12866_1,,,,2,2,1,3
12867_0,,,,2,2,1,3
12867_1,,,,2,2,1,3
12869_0,,,,2,2,1,3
C(C)(C(C(C)O)(C(C(C)O)O)O)=O,,,4,1,2,0,2
12869_1,,,,2,2,1,3
12871_0,,,,2,2,1,3
C(C(C=O)(C(C)O)C(C=O)O)(O)=O,,,4,1,1,0,1
12873_0,,,,2,2,1,3
C(C(C(C)O)(C(CC(C)O)O)O)=O,,,4,1,2,0,2
12873_1,,,,2,2,1,3
12875_0,,,,2,2,1,3
C(C(C=O)(C(CC(C)O)O)O)(O)=O,,,4,1,2,0,2
12875_1,,,,2,2,1,3
12877_0,,,,2,2,1,3
C1(C(C(CO1)O)C(CC(C)O)O)=O,,,4,1,1,0,1
12879_0,,,,2,2,1,3
C(C(CO)(C(CC(C)O)O)O)(O)=O,,,4,1,2,0,2
12879_1,,,,2,2,1,3
12881_0,,,,2,2,1,3
C1(COCC1(C(CC(C)O)O)O)=O,,,4,1,2,0,2
12881_1,,,,2,2,1,3
12882_0,,,,2,2,1,3
12882_1,,,,2,2,1,3
12883_0,,,,2,2,1,3
12883_1,,,,2,2,1,3
12884_0,,,,2,2,1,3
12884_1,,,,2,2,1,3
12885_0,,,,2,2,1,3
12885_1,,,,2,2,1,3
12886_0,,,,2,2,1,3
12886_1,,,,2,2,1,3
12887_0,,,,2,2,1,3
12887_1,,,,2,2,1,3
12888_0,,,,2,2,1,3
12888_1,,,,2,2,1,3
12890_0,,,,2,2,1,3
C(C(C(C)O)(C(C=O)(CO)O)O)=O,,,4,1,8,0,8
12890_1,,,,2,2,1,3
12891_0,,,,2,2,1,3
12891_1,,,,2,2,1,3
12892_0,,,,2,2,1,3
12892_1,,,,2,2,1,3
12894_0,,,,2,2,1,3
C(C(C)(C(C=O)(C(C)O)O)O)(O)=O,,,4,1,3,0,3
12894_1,,,,2,2,1,3
12895_0,,,,2,2,1,3
12895_1,,,,2,2,1,3
12896_0,,,,2,2,1,3
12896_1,,,,2,2,1,3
12898_0,,,,2,2,1,3
C(C(C(C)O)(C(C(C)=O)(C)O)O)=O,,,4,1,2,0,2
12898_1,,,,2,2,1,3
12899_0,,,,2,2,1,3
12899_1,,,,2,2,1,3
12901_0,,,,2,2,1,3
C(C(C(CC(C)=O)O)(C(C)O)O)=O,,,4,1,2,0,2
12901_1,,,,2,2,1,3
12902_0,,,,2,2,1,3
12902_1,,,,2,2,1,3
12904_0,,,,2,2,1,3
C(C(C=C)(C(C=O)(C(C)O)O)O)=O,,,4,1,2,0,2
12904_1,,,,2,2,1,3
12906_0,,,,2,2,1,3
C(C(C(C)O)(C(C=C)(CO)O)O)=O,,,4,1,2,0,2
12906_1,,,,2,2,1,3
12907_0,,,,2,2,1,3
12907_1,,,,2,2,1,3
12909_0,,,,2,2,1,3
C(C(C(C)O)(C(C(C)O)O)O)=O,,,4,1,2,0,2
12909_1,,,,2,2,1,3
12911_0,,,,2,2,1,3
C(CC(C(C(C=O)=O)(CO)O)O)=O,,,4,1,4,0,4
12911_1,,,,2,2,1,3
12913_0,,,,2,2,1,3
C(C(C(C=O)=O)(CO)O)(O)=O,,,4,1,2,0,2
12913_1,,,,2,2,1,3
12915_0,,,,2,2,1,3
C(C(C(C(C=O)=O)(CO)O)O)(O)=O,,,4,1,2,0,2
12915_1,,,,2,2,1,3
12917_0,,,,2,2,1,3
C(C(C(CO)(C(C(C)O)O)O)=O)=O,,,4,1,2,0,2
12917_1,,,,2,2,1,3
12919_0,,,,2,2,1,3
C(C(C=O)(C(C=O)(CO)O)O)(O)=O,,,4,1,4,0,4
12919_1,,,,2,2,1,3
12920_0,,,,2,2,1,3
12920_1,,,,2,2,1,3
12922_0,,,,2,2,1,3
C1(C(C(CO1)O)C(C=O)(CO)O)=O,,,4,1,1,0,1
12924_0,,,,2,2,1,3
C1(C(C(CO1)O)C(C(CO)=O)O)=O,,,4,1,1,0,1
12926_0,,,,2,2,1,3
C(C(CO)(C(C=O)(CO)O)O)(O)=O,,,4,1,2,0,2
12926_1,,,,2,2,1,3
12928_0,,,,2,2,1,3
C(C(CO)(C(C(CO)=O)O)O)(O)=O,,,4,1,2,0,2
12928_1,,,,2,2,1,3
12930_0,,,,2,2,1,3
C(C(CO)(C1(C(COC1)=O)O)O)=O,,,4,1,2,0,2
12930_1,,,,2,2,1,3
12932_0,,,,2,2,1,3
C1(COCC1(C(C(CO)=O)O)O)=O,,,4,1,2,0,2
12932_1,,,,2,2,1,3
12934_0,,,,2,2,1,3
C(C(C(CO)=O)(C(C)=O)O)(O)=O,,,4,1,2,0,2
12934_1,,,,2,2,1,3
12936_0,,,,2,2,1,3
C(CC(C(C=O)(C(CO)=O)O)O)=O,,,4,1,2,0,2
12936_1,,,,2,2,1,3
12937_0,,,,2,2,1,3
12937_1,,,,2,2,1,3
12938_0,,,,2,2,1,3
12938_1,,,,2,2,1,3
12940_0,,,,2,2,1,3
C(C(C(CC=O)O)C(C=O)O)(O)=O,,,4,1,1,0,1
12942_0,,,,2,2,1,3
C1(C(C(CC=O)O)(C(CO1)O)O)=O,,,4,1,2,0,2
12942_1,,,,2,2,1,3
12944_0,,,,2,2,1,3
C1(C(C(CC=O)O)C(CO1)O)=O,,,4,1,1,0,1
12946_0,,,,2,2,1,3
C(C(CO)(C(CC=O)O)O)(O)=O,,,4,1,2,0,2
12946_1,,,,2,2,1,3
12948_0,,,,2,2,1,3
C(C(C(CC=O)O)(C(C)O)O)(O)=O,,,4,1,2,0,2
12948_1,,,,2,2,1,3
12950_0,,,,2,2,1,3
C(CC(C1(C(COC1)=O)O)O)=O,,,4,1,2,0,2
12950_1,,,,2,2,1,3
12952_0,,,,2,2,1,3
C(C(C=O)(C(CO)=O)O)(O)=O,,,4,1,2,0,2
12952_1,,,,2,2,1,3
12954_0,,,,2,2,1,3
C(C(C(CO)=O)(C(C(O)=O)O)O)=O,,,4,1,2,0,2
12954_1,,,,2,2,1,3
12956_0,,,,2,2,1,3
C(C(C(CO)=O)(C(C(C)O)O)O)=O,,,4,1,2,0,2
12956_1,,,,2,2,1,3
12958_0,,,,2,2,1,3
C(C(C=O)(C(C(O)=O)(C)O)O)(O)=O,,,4,1,2,0,2
12958_1,,,,2,2,1,3
12960_0,,,,2,2,1,3
C1(C(C(CO1)O)C(C(O)=O)(C)O)=O,,,4,1,1,0,1
12962_0,,,,2,2,1,3
C(C(CO)(C(C(O)=O)(C)O)O)(O)=O,,,4,1,2,0,2
12962_1,,,,2,2,1,3
12964_0,,,,2,2,1,3
C(C(C)(C1(C(COC1)=O)O)O)(O)=O,,,4,1,2,0,2
12964_1,,,,2,2,1,3
12966_0,,,,2,2,1,3
C(C(C(O)=O)(C(C)=O)O)(O)=O,,,4,1,2,0,2
12966_1,,,,2,2,1,3
12968_0,,,,2,2,1,3
C(C(C(O)=O)(C(C(C)=O)O)O)(O)=O,,,4,1,2,0,2
12968_1,,,,2,2,1,3
12970_0,,,,2,2,1,3
C(C(C(C)=O)(C(C(O)=O)O)O)(O)=O,,,4,1,4,0,4
12970_1,,,,2,2,1,3
12972_0,,,,2,2,1,3
C(C(C(O)=O)(C=O)O)(O)=O,,,4,1,2,0,2
12972_1,,,,2,2,1,3
12974_0,,,,2,2,1,3
C(C(C(O)=O)(C(C=O)O)O)(O)=O,,,4,1,2,0,2
12974_1,,,,2,2,1,3
12976_0,,,,2,2,1,3
C(C(C=O)(C(C(O)=O)O)O)(O)=O,,,4,1,4,0,4
12976_1,,,,2,2,1,3
12978_0,,,,2,2,1,3
C(C(C(O)=O)C(C=O)O)(O)=O,,,4,1,1,0,1
12980_0,,,,2,2,1,3
C1(C(C(O)=O)(C(CO1)O)O)=O,,,4,1,2,0,2
12980_1,,,,2,2,1,3
12982_0,,,,2,2,1,3
C1(C(C(O)=O)C(CO1)O)=O,,,4,1,1,0,1
12984_0,,,,2,2,1,3
C(C(C=O)(C(C(C)O)=O)O)(O)=O,,,4,1,2,0,2
12984_1,,,,2,2,1,3
12986_0,,,,2,2,1,3
C(C(C(CO)=O)(C(C=C)=O)O)(O)=O,,,4,1,2,0,2
12986_1,,,,2,2,1,3
12988_0,,,,2,2,1,3
C(C(C=O)(C(C(C=C)O)=O)O)(O)=O,,,4,1,2,0,2
12988_1,,,,2,2,1,3
12990_0,,,,2,2,1,3
C(CCO)(C(C(O)=O)(C(C)=O)O)=O,,,4,1,2,0,2
12990_1,,,,2,2,1,3
12991_0,,,,2,2,1,3
12991_1,,,,2,2,1,3
12992_0,,,,2,2,1,3
12992_1,,,,2,2,1,3
12994_0,,,,2,2,1,3
C(C(C=O)(C(CCCO)=O)O)(O)=O,,,4,1,2,0,2
12994_1,,,,2,2,1,3
12995_0,,,,2,2,1,3
12995_1,,,,2,2,1,3
12997_0,,,,2,2,1,3
C(C(C(C=C)=O)(C(CO)O)O)(O)=O,,,4,1,2,0,2
12997_1,,,,2,2,1,3
12999_0,,,,2,2,1,3
C(C(C=O)(C(C=CCO)O)O)(O)=O,,,4,1,2,0,2
12999_1,,,,2,2,1,3
13001_0,,,,2,2,1,3
C(C(C(O)=O)(CO)O)(O)=O,,,4,1,2,0,2
13001_1,,,,2,2,1,3
13002_0,,,,2,2,1,3
13002_1,,,,2,2,1,3
13004_0,,,,2,2,1,3
C(C(C=O)(C(C=O)(C=O)O)O)(O)=O,,,4,1,2,0,2
13004_1,,,,2,2,1,3
13006_0,,,,2,2,1,3
C(C(C(O)=O)(C(C=O)(C)O)O)(O)=O,,,4,1,2,0,2
13006_1,,,,2,2,1,3
13008_0,,,,2,2,1,3
C(C(C(O)=O)(C(CO)(C)O)O)(O)=O,,,4,1,2,0,2
13008_1,,,,2,2,1,3
13010_0,,,,2,2,1,3
C(C(C(O)=O)(C(C)O)O)(O)=O,,,4,1,2,0,2
13010_1,,,,2,2,1,3
13012_0,,,,2,2,1,3
C1(CC(C(C1(C(O)=O)CO)=O)O)=O,,,4,1,1,0,1
13014_0,,,,2,2,1,3
C1(C(CO)CC(C1(C(O)=O)O)=O)=O,,,4,1,2,0,2
13014_1,,,,2,2,1,3
13016_0,,,,2,2,1,3
C(C1(C(C(C(C1)=O)O)=O)CO)(O)=O,,,4,1,1,0,1
13018_0,,,,2,2,1,3
C(C1C(OC(C(C)=O)C1O)=O)(O)=O,,,4,1,1,0,1
13020_0,,,,2,2,1,3
C1(CC(C(C(O)=O)(C(C)=O)O1)O)=O,,,4,1,2,0,2
13020_1,,,,2,2,1,3
13022_0,,,,2,2,1,3
C1(C(C(O)=O)C(C(CC=O)O1)O)=O,,,4,1,1,0,1
13024_0,,,,2,2,1,3
C(C1(C(COC1C(C)=O)=O)O)(O)=O,,,4,1,2,0,2
13024_1,,,,2,2,1,3
13026_0,,,,2,2,1,3
C(C1(C(C)=O)C(C(CO1)=O)O)(O)=O,,,4,1,2,0,2
13026_1,,,,2,2,1,3
13028_0,,,,2,2,1,3
C(CC1C(C(O)=O)(C(CO1)=O)O)=O,,,4,1,2,0,2
13028_1,,,,2,2,1,3
13030_0,,,,2,2,1,3
C1(CC(OC1(C(O)=O)C(C)=O)O)=O,,,4,1,2,0,2
13030_1,,,,2,2,1,3
13032_0,,,,2,2,1,3
C(C1(C(CCC(O1)=O)=O)CO)(O)=O,,,4,1,2,0,2
13032_1,,,,2,2,1,3
13034_0,,,,2,2,1,3
C(C1(C(CC(CO1)=O)=O)CO)(O)=O,,,4,1,2,0,2
13034_1,,,,2,2,1,3
13036_0,,,,2,2,1,3
C(C1(C(CCC(OC1)=O)=O)O)(O)=O,,,4,1,2,0,2
13036_1,,,,2,2,1,3
13038_0,,,,2,2,1,3
C1(C(C(O)=O)C(C(CCO1)=O)O)=O,,,4,1,1,0,1
13040_0,,,,2,2,1,3
C(C1C(OCC(CC1O)=O)=O)(O)=O,,,4,1,1,0,1
13042_0,,,,2,2,1,3
C(C1(C(CC(COC1)=O)=O)O)(O)=O,,,4,1,2,0,2
13042_1,,,,2,2,1,3
13044_0,,,,2,2,1,3
C1(CCOCC(C1(C(O)=O)O)=O)=O,,,4,1,2,0,2
13044_1,,,,2,2,1,3
13046_0,,,,2,2,1,3
C(C1(C(COC1)=O)O)(O)=O,,,4,1,2,0,2
13046_1,,,,2,2,1,3
13048_0,,,,2,2,1,3
C(CC1C(C(C(O)=O)(CO1)O)=O)=O,,,4,1,2,0,2
13048_1,,,,2,2,1,3
13050_0,,,,2,2,1,3
C(C1(C=O)C(CC(C=O)O1)O)(O)=O,,,4,1,2,0,2
13050_1,,,,2,2,1,3
13052_0,,,,2,2,1,3
C(C1(C=O)C(CC(C)(O1)O)=O)(O)=O,,,4,1,2,0,2
13052_1,,,,2,2,1,3
13054_0,,,,2,2,1,3
C(C1(C=O)C(C(C(C)O1)=O)O)(O)=O,,,4,1,2,0,2
13054_1,,,,2,2,1,3
13056_0,,,,2,2,1,3
C1(C(C)OC(C=O)C1(C(O)=O)O)=O,,,4,1,2,0,2
13056_1,,,,2,2,1,3
13058_0,,,,2,2,1,3
C(C1(C=O)C(CCC(O1)O)=O)(O)=O,,,4,1,2,0,2
13058_1,,,,2,2,1,3
13060_0,,,,2,2,1,3
C(C1(C(C(CO)=CC1O)=O)O)(O)=O,,,4,1,2,0,2
13060_1,,,,2,2,1,3
13062_0,,,,2,2,1,3
C(C1(C(C(C(C1O)O)=C)=O)O)(O)=O,,,4,1,2,0,2
13062_1,,,,2,2,1,3
13064_0,,,,2,2,1,3
C(C(C=O)(C(C(C=C)O)O)O)(O)=O,,,4,1,2,0,2
13064_1,,,,2,2,1,3
13066_0,,,,2,2,1,3
C(C1(C(C=CO1)=O)C(CO)O)(O)=O,,,4,1,2,0,2
13066_1,,,,2,2,1,3
13068_0,,,,2,2,1,3
C(C1(C(C=COC1CO)=O)O)(O)=O,,,4,1,2,0,2
13068_1,,,,2,2,1,3
13070_0,,,,2,2,1,3
C(C1(C(C=CC(O1)O)=O)CO)(O)=O,,,4,1,2,0,2
13070_1,,,,2,2,1,3
13072_0,,,,2,2,1,3
C(C1(C(C=COCC1O)=O)O)(O)=O,,,4,1,2,0,2
13072_1,,,,2,2,1,3
13074_0,,,,2,2,1,3
C(C1(C(C=CCOC1O)=O)O)(O)=O,,,4,1,2,0,2
13074_1,,,,2,2,1,3
13076_0,,,,2,2,1,3
C(C1(C(C=CC(O)OC1)=O)O)(O)=O,,,4,1,2,0,2
13076_1,,,,2,2,1,3
13078_0,,,,2,2,1,3
C(C(C=O)(C1OCC(C=1)O)O)(O)=O,,,4,1,2,0,2
13078_1,,,,2,2,1,3
13080_0,,,,2,2,1,3
C(C(C=O)(C1(C=CCO1)O)O)(O)=O,,,4,1,2,0,2
13080_1,,,,2,2,1,3
13082_0,,,,2,2,1,3
C(C1(C=O)C(C=C(CO)O1)O)(O)=O,,,4,1,2,0,2
13082_1,,,,2,2,1,3
13084_0,,,,2,2,1,3
C(C1(C=O)C(C(C(O1)=C)O)O)(O)=O,,,4,1,2,0,2
13084_1,,,,2,2,1,3
13086_0,,,,2,2,1,3
C(C(C=O)(C1C=CC(O)O1)O)(O)=O,,,4,1,2,0,2
13086_1,,,,2,2,1,3
13088_0,,,,2,2,1,3
C(C(C=O)(C1C(C=CO1)O)O)(O)=O,,,4,1,2,0,2
13088_1,,,,2,2,1,3
13090_0,,,,2,2,1,3
C(C1(C=O)C(C=CC(O1)O)O)(O)=O,,,4,1,2,0,2
13090_1,,,,2,2,1,3
13092_0,,,,2,2,1,3
C(C1(C=O)C(C(C=CO1)O)O)(O)=O,,,4,1,2,0,2
13092_1,,,,2,2,1,3
13093_0,,,,2,2,1,3
13093_1,,,,2,2,1,3
13095_0,,,,2,2,1,3
C(C(C(C)=O)(C(C(C)O)O)O)(O)=O,,,4,1,2,0,2
13095_1,,,,2,2,1,3
13096_0,,,,2,2,1,3
13096_1,,,,2,2,1,3
13098_0,,,,2,2,1,3
C(C(C(C(O)=O)C(C=O)O)O)(O)=O,,,4,1,1,0,1
13100_0,,,,2,2,1,3
C1(C(C(CO1)O)(C(C(O)=O)O)O)=O,,,4,1,2,0,2
13100_1,,,,2,2,1,3
13102_0,,,,2,2,1,3
C1(C(C(CO1)O)C(C(O)=O)O)=O,,,4,1,1,0,1
13104_0,,,,2,2,1,3
C(C(CO)(C(C(O)=O)O)O)(O)=O,,,4,1,2,0,2
13104_1,,,,2,2,1,3
13106_0,,,,2,2,1,3
C(C(C(C)O)(C(C(O)=O)O)O)(O)=O,,,4,1,2,0,2
13106_1,,,,2,2,1,3
13108_0,,,,2,2,1,3
C1(COCC1(C(C(O)=O)O)O)=O,,,4,1,2,0,2
13108_1,,,,2,2,1,3
13110_0,,,,2,2,1,3
C(C(C=O)(C(C(C)=O)(C)O)O)(O)=O,,,4,1,2,0,2
13110_1,,,,2,2,1,3
13111_0,,,,2,2,1,3
13111_1,,,,2,2,1,3
13113_0,,,,2,2,1,3
C(C(C=O)(C(CC(C)=O)O)O)(O)=O,,,4,1,2,0,2
13113_1,,,,2,2,1,3
13115_0,,,,2,2,1,3
C(C(C=O)(C(C(C=C)=O)O)O)(O)=O,,,4,1,4,0,4
13115_1,,,,2,2,1,3
13117_0,,,,2,2,1,3
C(C(C=O)(C(C=O)(C=C)O)O)(O)=O,,,4,1,2,0,2
13117_1,,,,2,2,1,3
13119_0,,,,2,2,1,3
C(C(C=O)(C(C=C)(CO)O)O)(O)=O,,,4,1,2,0,2
13119_1,,,,2,2,1,3
13121_0,,,,2,2,1,3
C(C(C=O)(C(C=CC=O)O)O)(O)=O,,,4,1,4,0,4
13121_1,,,,2,2,1,3
13123_0,,,,2,2,1,3
C(C(C=O)(C(C(C)O)O)O)(O)=O,,,4,1,2,0,2
13123_1,,,,2,2,1,3
13125_0,,,,2,2,1,3
C(C(C(C(C)O)O)C(C=O)O)(O)=O,,,4,1,1,0,1
13127_0,,,,2,2,1,3
C1(C(C(CO1)O)C(C(C)=O)(C)O)=O,,,4,1,1,0,1
13129_0,,,,2,2,1,3
C(C(CO)(C(C(C)=O)(C)O)O)(O)=O,,,4,1,2,0,2
13129_1,,,,2,2,1,3
13131_0,,,,2,2,1,3
C(C)(C(C)(C1(C(COC1)=O)O)O)=O,,,4,1,2,0,2
13131_1,,,,2,2,1,3
13133_0,,,,2,2,1,3
C1(C(C(CO1)O)C(C)(CC=O)O)=O,,,4,1,1,0,1
13135_0,,,,2,2,1,3
C1(C(C(CC(C)=O)O)C(CO1)O)=O,,,4,1,1,0,1
13137_0,,,,2,2,1,3
C(C(CO)(C(C)(CC=O)O)O)(O)=O,,,4,1,2,0,2
13137_1,,,,2,2,1,3
13139_0,,,,2,2,1,3
C(C(CO)(C(CC(C)=O)O)O)(O)=O,,,4,1,2,0,2
13139_1,,,,2,2,1,3
13141_0,,,,2,2,1,3
C(CC(C)(C1(C(COC1)=O)O)O)=O,,,4,1,2,0,2
13141_1,,,,2,2,1,3
13143_0,,,,2,2,1,3
C(C)(CC(C1(C(COC1)=O)O)O)=O,,,4,1,2,0,2
13143_1,,,,2,2,1,3
13145_0,,,,2,2,1,3
C1(C(C(CO1)O)C(C(C=C)=O)O)=O,,,4,1,1,0,1
13147_0,,,,2,2,1,3
C(C(C=C)(C1C(OCC1O)=O)O)=O,,,4,1,1,0,1
13148_0,,,,2,2,1,3
13148_1,,,,2,2,1,3
13150_0,,,,2,2,1,3
C(C(C=C)(C(C(O)=O)(CO)O)O)=O,,,4,1,2,0,2
13150_1,,,,2,2,1,3
13152_0,,,,2,2,1,3
C1(COCC1(C(C(C=C)=O)O)O)=O,,,4,1,2,0,2
13152_1,,,,2,2,1,3
13154_0,,,,2,2,1,3
C(C(C=C)(C1(C(COC1)=O)O)O)=O,,,4,1,2,0,2
13154_1,,,,2,2,1,3
13156_0,,,,2,2,1,3
C1(C(C(CO1)O)C(C=C)(CO)O)=O,,,4,1,1,0,1
13158_0,,,,2,2,1,3
C(C(CO)(C(C=C)(CO)O)O)(O)=O,,,4,1,2,0,2
13158_1,,,,2,2,1,3
13160_0,,,,2,2,1,3
C1(COCC1(C(C=C)(CO)O)O)=O,,,4,1,2,0,2
13160_1,,,,2,2,1,3
13162_0,,,,2,2,1,3
C1(C(C(CO1)O)C(C=CC=O)O)=O,,,4,1,1,0,1
13163_0,,,,2,2,1,3
13163_1,,,,2,2,1,3
13165_0,,,,2,2,1,3
C1(COCC1(C(C=CC=O)O)O)=O,,,4,1,2,0,2
13165_1,,,,2,2,1,3
13167_0,,,,2,2,1,3
C1(C(C(CO1)O)(C(C(C)O)O)O)=O,,,4,1,2,0,2
13167_1,,,,2,2,1,3
13169_0,,,,2,2,1,3
C1(C(C(CO1)O)C(C(C)O)O)=O,,,4,1,1,0,1
13171_0,,,,2,2,1,3
C(C(CO)(C(C(C)O)O)O)(O)=O,,,4,1,2,0,2
13171_1,,,,2,2,1,3
13173_0,,,,2,2,1,3
C(C(C(C)O)(C(C(C)O)O)O)(O)=O,,,4,1,2,0,2
13173_1,,,,2,2,1,3
13175_0,,,,2,2,1,3
C1(COCC1(C(C(C)O)O)O)=O,,,4,1,2,0,2
13175_1,,,,2,2,1,3
13176_0,,,,2,2,1,3
13176_1,,,,2,2,1,3
13178_0,,,,2,2,1,3
C(CO)(C(C(CO)O)(C(C)O)O)=O,,,4,1,4,0,4
13178_1,,,,2,2,1,3
13180_0,,,,2,2,1,3
C(C(C(CO)=O)(CO)C(CO)O)=O,,,4,1,2,0,2
13181_0,,,,2,2,1,3
13181_1,,,,2,2,1,3
13182_0,,,,2,2,1,3
13182_1,,,,2,2,1,3
13183_0,,,,2,2,1,3
13183_1,,,,2,2,1,3
13185_0,,,,2,2,1,3
C(C(C(CO)(CO)C(CO)O)=O)=O,,,4,1,2,0,2
13187_0,,,,2,2,1,3
C(CO)(C(CO)(CO)C(CO)O)=O,,,4,1,2,0,2
13189_0,,,,2,2,1,3
C(C(CO)(C(CO)O)C(C=O)O)=O,,,4,1,2,0,2
13190_0,,,,2,2,1,3
13190_1,,,,2,2,1,3
13191_0,,,,2,2,1,3
13191_1,,,,2,2,1,3
13192_0,,,,2,2,1,3
13192_1,,,,2,2,1,3
13193_0,,,,2,2,1,3
13193_1,,,,2,2,1,3
13194_0,,,,2,2,1,3
13194_1,,,,2,2,1,3
13195_0,,,,2,2,1,3
13195_1,,,,2,2,1,3
13196_0,,,,2,2,1,3
13196_1,,,,2,2,1,3
13197_0,,,,2,2,1,3
13197_1,,,,2,2,1,3
13198_0,,,,2,2,1,3
13198_1,,,,2,2,1,3
13199_0,,,,2,2,1,3
13199_1,,,,2,2,1,3
13200_0,,,,2,2,1,3
13200_1,,,,2,2,1,3
13201_0,,,,2,2,1,3
13201_1,,,,2,2,1,3
13202_0,,,,2,2,1,3
13202_1,,,,2,2,1,3
13203_0,,,,2,2,1,3
13205_0,,,,2,2,1,3
C1(C(C(CO)O)(C(CO1)O)O)=O,,,4,1,3,0,3
13205_1,,,,2,2,1,3
13207_0,,,,2,2,1,3
C1(C(C(CO)O)C(CO1)O)=O,,,4,1,2,0,2
13208_0,,,,2,2,1,3
13208_1,,,,2,2,1,3
13209_0,,,,2,2,1,3
13209_1,,,,2,2,1,3
13210_0,,,,2,2,1,3
13210_1,,,,2,2,1,3
13212_0,,,,2,2,1,3
C1(COCC1(C(CO)O)O)=O,,,4,1,2,0,2
13212_1,,,,2,2,1,3
13214_0,,,,2,2,1,3
C(C(C(CO)O)(C(CCO)O)O)=O,,,4,1,2,0,2
13214_1,,,,2,2,1,3
13215_0,,,,2,2,1,3
13215_1,,,,2,2,1,3
13216_0,,,,2,2,1,3
13216_1,,,,2,2,1,3
13217_0,,,,2,2,1,3
13217_1,,,,2,2,1,3
13219_0,,,,2,2,1,3
C(C(C(CO)O)(C(C(C)O)O)O)=O,,,4,1,2,0,2
13219_1,,,,2,2,1,3
13221_0,,,,2,2,1,3
C(C(C(C)O)(C(CO)(CO)O)O)=O,,,4,1,4,0,4
13221_1,,,,2,2,1,3
13222_0,,,,2,2,1,3
13222_1,,,,2,2,1,3
13224_0,,,,2,2,1,3
C1(C(C(CO1)O)C(CO)(CO)O)=O,,,4,1,1,0,1
13225_0,,,,2,2,1,3
13225_1,,,,2,2,1,3
13227_0,,,,2,2,1,3
C1(COCC1(C(CO)(CO)O)O)=O,,,4,1,2,0,2
13227_1,,,,2,2,1,3
13229_0,,,,2,2,1,3
C(C(CO)(C(CCO)O)O)=O,,,4,1,2,0,2
13229_1,,,,2,2,1,3
13231_0,,,,2,2,1,3
C(C(CO)(C(CC(C)O)O)O)=O,,,4,1,2,0,2
13231_1,,,,2,2,1,3
13233_0,,,,2,2,1,3
C(C(C(C)O)(C(C(CO)O)O)O)=O,,,4,1,6,0,6
13233_1,,,,2,2,1,3
13235_0,,,,2,2,1,3
C(C(CO)(C(C(C(C)O)O)O)O)=O,,,4,1,2,0,2
13235_1,,,,2,2,1,3
13236_0,,,,2,2,1,3
13236_1,,,,2,2,1,3
13238_0,,,,2,2,1,3
C(C(CO)(C(C=O)(CO)O)O)=O,,,4,1,4,0,4
13238_1,,,,2,2,1,3
13239_0,,,,2,2,1,3
13239_1,,,,2,2,1,3
13241_0,,,,2,2,1,3
C(C(CO)(C(C(C)=O)(CO)O)O)=O,,,4,1,8,0,8
13241_1,,,,2,2,1,3
13242_0,,,,2,2,1,3
13242_1,,,,2,2,1,3
13243_0,,,,2,2,1,3
13243_1,,,,2,2,1,3
13244_0,,,,2,2,1,3
13244_1,,,,2,2,1,3
13246_0,,,,2,2,1,3
C(C(CO)(C(CO)(C(C)O)O)O)=O,,,4,1,2,0,2
13246_1,,,,2,2,1,3
13247_0,,,,2,2,1,3
13247_1,,,,2,2,1,3
13248_0,,,,2,2,1,3
13248_1,,,,2,2,1,3
13249_0,,,,2,2,1,3
13249_1,,,,2,2,1,3
13250_0,,,,2,2,1,3
13250_1,,,,2,2,1,3
13251_0,,,,2,2,1,3
13251_1,,,,2,2,1,3
13252_0,,,,2,2,1,3
13252_1,,,,2,2,1,3
13253_0,,,,2,2,1,3
13253_1,,,,2,2,1,3
13254_0,,,,2,2,1,3
13254_1,,,,2,2,1,3
13256_0,,,,2,2,1,3
C(CC(C=O)(C(C=O)(CO)O)O)=O,,,4,1,5,0,5
13256_1,,,,2,2,1,3
13257_0,,,,2,2,1,3
13257_1,,,,2,2,1,3
13259_0,,,,2,2,1,3
C(C(CO)(C(C(C)=O)(C)O)O)=O,,,4,1,3,0,3
13259_1,,,,2,2,1,3
13260_0,,,,2,2,1,3
13260_1,,,,2,2,1,3
13262_0,,,,2,2,1,3
C(C(CO)(C(CC(C)=O)O)O)=O,,,4,1,2,0,2
13262_1,,,,2,2,1,3
13264_0,,,,2,2,1,3
C(C(CO)(C1(COC(C1)O)O)O)=O,,,4,1,3,0,3
13264_1,,,,2,2,1,3
13265_0,,,,2,2,1,3
13265_1,,,,2,2,1,3
13267_0,,,,2,2,1,3
C(C(C=C)(C(C=O)(CO)O)O)=O,,,4,1,3,0,3
13267_1,,,,2,2,1,3
13269_0,,,,2,2,1,3
C(C(CO)(C(C=C)(CO)O)O)=O,,,4,1,3,0,3
13269_1,,,,2,2,1,3
13270_0,,,,2,2,1,3
13270_1,,,,2,2,1,3
13272_0,,,,2,2,1,3
C1(C(C(CO1)O)C(C(CO)O)O)=O,,,4,1,1,0,1
13274_0,,,,2,2,1,3
C(C(CO)(C(C(C)O)O)O)=O,,,4,1,2,0,2
13274_1,,,,2,2,1,3
13275_0,,,,2,2,1,3
13275_1,,,,2,2,1,3
13277_0,,,,2,2,1,3
C1(COCC1(C(C(CO)O)O)O)=O,,,4,1,2,0,2
13277_1,,,,2,2,1,3
13279_0,,,,2,2,1,3
C(C(CO)(C1(COCC1O)O)O)=O,,,4,1,2,0,2
13279_1,,,,2,2,1,3
13281_0,,,,2,2,1,3
C(C(CO)(C1(C(O)OCC1)O)O)=O,,,4,1,3,0,3
13281_1,,,,2,2,1,3
13283_0,,,,2,2,1,3
C(C)(C(C(C)O)(C(C(C)=O)O)O)=O,,,4,1,4,0,4
13283_1,,,,2,2,1,3
13285_0,,,,2,2,1,3
C(C(C)(C(C(C)=O)(C(C)O)O)O)=O,,,4,1,4,0,4
13285_1,,,,2,2,1,3
13286_0,,,,2,2,1,3
13286_1,,,,2,2,1,3
13288_0,,,,2,2,1,3
C(C(C(C)O)(C(C=O)(C)O)O)=O,,,4,1,5,0,5
13288_1,,,,2,2,1,3
13290_0,,,,2,2,1,3
C(C(C(C(C=O)=O)(CO)O)O)(C)=O,,,4,1,4,0,4
13290_1,,,,2,2,1,3
13292_0,,,,2,2,1,3
C(C(C)(C(C(C=O)=O)(CO)O)O)=O,,,4,1,2,0,2
13292_1,,,,2,2,1,3
13293_0,,,,2,2,1,3
13293_1,,,,2,2,1,3
13294_0,,,,2,2,1,3
13294_1,,,,2,2,1,3
13295_0,,,,2,2,1,3
13295_1,,,,2,2,1,3
13296_0,,,,2,2,1,3
13296_1,,,,2,2,1,3
13297_0,,,,2,2,1,3
13297_1,,,,2,2,1,3
13298_0,,,,2,2,1,3
13298_1,,,,2,2,1,3
13299_0,,,,2,2,1,3
13300_0,,,,2,2,1,3
13302_0,,,,2,2,1,3
C1(C(C(CO1)O)(C(C(C)=O)O)O)=O,,,4,1,2,0,2
13302_1,,,,2,2,1,3
13304_0,,,,2,2,1,3
C1(C(C(CO1)O)(C(C=O)(C)O)O)=O,,,4,1,2,0,2
13304_1,,,,2,2,1,3
13306_0,,,,2,2,1,3
C1(C(C(CO1)O)C(C(C)=O)O)=O,,,4,1,1,0,1
13308_0,,,,2,2,1,3
C1(C(C(CO1)O)C(C=O)(C)O)=O,,,4,1,1,0,1
13309_0,,,,2,2,1,3
13309_1,,,,2,2,1,3
13310_0,,,,2,2,1,3
13310_1,,,,2,2,1,3
13311_0,,,,2,2,1,3
13311_1,,,,2,2,1,3
13313_0,,,,2,2,1,3
C(C(C(C)O)(C(C=O)(C)O)O)(O)=O,,,4,1,4,0,4
13313_1,,,,2,2,1,3
13315_0,,,,2,2,1,3
C1(COCC1(C(C(C)=O)O)O)=O,,,4,1,2,0,2
13315_1,,,,2,2,1,3
13317_0,,,,2,2,1,3
C(C(C)(C1(C(COC1)=O)O)O)=O,,,4,1,2,0,2
13317_1,,,,2,2,1,3
13319_0,,,,2,2,1,3
C(C(C(C)=O)(C(CCO)O)O)=O,,,4,1,2,0,2
13319_1,,,,2,2,1,3
13321_0,,,,2,2,1,3
C(C(C(C)=O)(C(CC(C)O)O)O)=O,,,4,1,2,0,2
13321_1,,,,2,2,1,3
13323_0,,,,2,2,1,3
C(C(CO)(C(C=O)(C(C)=O)O)O)=O,,,4,1,4,0,4
13323_1,,,,2,2,1,3
13324_0,,,,2,2,1,3
13324_1,,,,2,2,1,3
13326_0,,,,2,2,1,3
C(CC(C(C=O)(C(C)=O)O)O)=O,,,4,1,3,0,3
13326_1,,,,2,2,1,3
13327_0,,,,2,2,1,3
13327_1,,,,2,2,1,3
13329_0,,,,2,2,1,3
C(C(C=O)(C(C)=O)O)(O)=O,,,4,1,2,0,2
13329_1,,,,2,2,1,3
13330_0,,,,2,2,1,3
13330_1,,,,2,2,1,3
13332_0,,,,2,2,1,3
C(C(C(C)=O)(C(C(C)=O)(C)O)O)=O,,,4,1,2,0,2
13332_1,,,,2,2,1,3
13334_0,,,,2,2,1,3
C(CC(C)(C(C=O)(C(C)=O)O)O)=O,,,4,1,2,0,2
13334_1,,,,2,2,1,3
13336_0,,,,2,2,1,3
C(C(C(C)=O)(C(CC(C)=O)O)O)=O,,,4,1,2,0,2
13336_1,,,,2,2,1,3
13338_0,,,,2,2,1,3
C(C(C(C)=O)(C(C(C=C)=O)O)O)=O,,,4,1,2,0,2
13338_1,,,,2,2,1,3
13340_0,,,,2,2,1,3
C(C(C=C)(C(C=O)(C(C)=O)O)O)=O,,,4,1,2,0,2
13340_1,,,,2,2,1,3
13342_0,,,,2,2,1,3
C(C(C(C)=O)(C(C=C)(CO)O)O)=O,,,4,1,2,0,2
13342_1,,,,2,2,1,3
13344_0,,,,2,2,1,3
C(C(C(C)=O)(C(C=CC=O)O)O)=O,,,4,1,2,0,2
13344_1,,,,2,2,1,3
13346_0,,,,2,2,1,3
C(C(C(C)=O)(C(C(C)O)O)O)=O,,,4,1,2,0,2
13346_1,,,,2,2,1,3
13347_0,,,,2,2,1,3
13347_1,,,,2,2,1,3
13349_0,,,,2,2,1,3
C(CO)(C(C(C)O)(C(C=O)O)O)=O,,,4,1,4,0,4
13349_1,,,,2,2,1,3
13351_0,,,,2,2,1,3
C(CO)(C(C=O)(CO)C(C=O)O)=O,,,4,1,2,0,2
13353_0,,,,2,2,1,3
C(C(CO)(C(C=O)O)O)(CC=O)=O,,,4,1,4,0,4
13353_1,,,,2,2,1,3
13354_0,,,,2,2,1,3
13354_1,,,,2,2,1,3
13355_0,,,,2,2,1,3
13355_1,,,,2,2,1,3
13357_0,,,,2,2,1,3
C(C(C(C(C=O)=O)(CO)CO)O)=O,,,4,1,2,0,2
13358_0,,,,2,2,1,3
13360_0,,,,2,2,1,3
C(C(CO)(C(C=O)O)C(C=O)O)=O,,,4,1,2,0,2
13361_0,,,,2,2,1,3
13361_1,,,,2,2,1,3
13362_0,,,,2,2,1,3
13362_1,,,,2,2,1,3
13363_0,,,,2,2,1,3
13363_1,,,,2,2,1,3
13364_0,,,,2,2,1,3
13364_1,,,,2,2,1,3
13365_0,,,,2,2,1,3
13365_1,,,,2,2,1,3
13366_0,,,,2,2,1,3
13366_1,,,,2,2,1,3
13368_0,,,,2,2,1,3
C(C(C(C(C=O)=O)(CO)O)O)=O,,,4,1,2,0,2
13368_1,,,,2,2,1,3
13369_0,,,,2,2,1,3
13369_1,,,,2,2,1,3
13370_0,,,,2,2,1,3
13370_1,,,,2,2,1,3
13371_0,,,,2,2,1,3
13371_1,,,,2,2,1,3
13372_0,,,,2,2,1,3
13372_1,,,,2,2,1,3
13373_0,,,,2,2,1,3
13373_1,,,,2,2,1,3
13374_0,,,,2,2,1,3
13374_1,,,,2,2,1,3
13375_0,,,,2,2,1,3
13377_0,,,,2,2,1,3
C1(C(C(CO1)O)(C(C=O)O)O)=O,,,4,1,3,0,3
13377_1,,,,2,2,1,3
13379_0,,,,2,2,1,3
C1(C(C(CO1)O)C(C=O)O)=O,,,4,1,1,0,1
13380_0,,,,2,2,1,3
13380_1,,,,2,2,1,3
13381_0,,,,2,2,1,3
13381_1,,,,2,2,1,3
13382_0,,,,2,2,1,3
13382_1,,,,2,2,1,3
13384_0,,,,2,2,1,3
C1(COCC1(C(C=O)O)O)=O,,,4,1,2,0,2
13384_1,,,,2,2,1,3
13386_0,,,,2,2,1,3
C(C)(C(CO)(C(CCO)O)O)=O,,,4,1,2,0,2
13386_1,,,,2,2,1,3
13388_0,,,,2,2,1,3
C(C)(C(CO)(C(CC(C)O)O)O)=O,,,4,1,2,0,2
13388_1,,,,2,2,1,3
13389_0,,,,2,2,1,3
13389_1,,,,2,2,1,3
13390_0,,,,2,2,1,3
13390_1,,,,2,2,1,3
13391_0,,,,2,2,1,3
13391_1,,,,2,2,1,3
13392_0,,,,2,2,1,3
13392_1,,,,2,2,1,3
13393_0,,,,2,2,1,3
13393_1,,,,2,2,1,3
13394_0,,,,2,2,1,3
13394_1,,,,2,2,1,3
13396_0,,,,2,2,1,3
C(C)(C(CO)(C(C(C)=O)(C)O)O)=O,,,4,1,2,0,2
13396_1,,,,2,2,1,3
13398_0,,,,2,2,1,3
C(CC(C)(C(C(C)=O)(CO)O)O)=O,,,4,1,2,0,2
13398_1,,,,2,2,1,3
13400_0,,,,2,2,1,3
C(C)(C(CO)(C(CC(C)=O)O)O)=O,,,4,1,2,0,2
13400_1,,,,2,2,1,3
13401_0,,,,2,2,1,3
13401_1,,,,2,2,1,3
13403_0,,,,2,2,1,3
C(C(C=C)(C(C(C)=O)(CO)O)O)=O,,,4,1,2,0,2
13403_1,,,,2,2,1,3
13405_0,,,,2,2,1,3
C(C)(C(CO)(C(C=C)(CO)O)O)=O,,,4,1,2,0,2
13405_1,,,,2,2,1,3
13407_0,,,,2,2,1,3
C(C)(C(CO)(C(C=CC=O)O)O)=O,,,4,1,2,0,2
13407_1,,,,2,2,1,3
13409_0,,,,2,2,1,3
C(C)(C(CO)(C(C(C)O)O)O)=O,,,4,1,2,0,2
13409_1,,,,2,2,1,3
13410_0,,,,2,2,1,3
13410_1,,,,2,2,1,3
13411_0,,,,2,2,1,3
13411_1,,,,2,2,1,3
13412_0,,,,2,2,1,3
13412_1,,,,2,2,1,3
13413_0,,,,2,2,1,3
13413_1,,,,2,2,1,3
13414_0,,,,2,2,1,3
13414_1,,,,2,2,1,3
13415_0,,,,2,2,1,3
13415_1,,,,2,2,1,3
13416_0,,,,2,2,1,3
13416_1,,,,2,2,1,3
13417_0,,,,2,2,1,3
13417_1,,,,2,2,1,3
13418_0,,,,2,2,1,3
13419_0,,,,2,2,1,3
13419_1,,,,2,2,1,3
13420_0,,,,2,2,1,3
13420_1,,,,2,2,1,3
13421_0,,,,2,2,1,3
13422_0,,,,2,2,1,3
13423_0,,,,2,2,1,3
13423_1,,,,2,2,1,3
13424_0,,,,2,2,1,3
13424_1,,,,2,2,1,3
13425_0,,,,2,2,1,3
13426_0,,,,2,2,1,3
13426_1,,,,2,2,1,3
13427_0,,,,2,2,1,3
13428_0,,,,2,2,1,3
13429_0,,,,2,2,1,3
13429_1,,,,2,2,1,3
13430_0,,,,2,2,1,3
13430_1,,,,2,2,1,3
13431_0,,,,2,2,1,3
13431_1,,,,2,2,1,3
13432_0,,,,2,2,1,3
13432_1,,,,2,2,1,3
13433_0,,,,2,2,1,3
13433_1,,,,2,2,1,3
13434_0,,,,2,2,1,3
13434_1,,,,2,2,1,3
13435_0,,,,2,2,1,3
13435_1,,,,2,2,1,3
13436_0,,,,2,2,1,3
13436_1,,,,2,2,1,3
13437_0,,,,2,2,1,3
13437_1,,,,2,2,1,3
13438_0,,,,2,2,1,3
13438_1,,,,2,2,1,3
13439_0,,,,2,2,1,3
13440_0,,,,2,2,1,3
13440_1,,,,2,2,1,3
13441_0,,,,2,2,1,3
13441_1,,,,2,2,1,3
13443_0,,,,2,2,1,3
C(C(C(CO)=O)(CO)CO)=O,,,4,1,1,0,1
13445_0,,,,2,2,1,3
C(CC(C(CO)(CO)O)=O)=O,,,4,1,2,0,2
13445_1,,,,2,2,1,3
13447_0,,,,2,2,1,3
C(C(C(CO)=O)(CO)C(C)O)=O,,,4,1,2,0,2
13449_0,,,,2,2,1,3
C(CC(C(CO)(C(C)O)O)=O)=O,,,4,1,4,0,4
13449_1,,,,2,2,1,3
13450_0,,,,2,2,1,3
13450_1,,,,2,2,1,3
13451_0,,,,2,2,1,3
13451_1,,,,2,2,1,3
13452_0,,,,2,2,1,3
13452_1,,,,2,2,1,3
13453_0,,,,2,2,1,3
13453_1,,,,2,2,1,3
13454_0,,,,2,2,1,3
13454_1,,,,2,2,1,3
13455_0,,,,2,2,1,3
13456_0,,,,2,2,1,3
13457_0,,,,2,2,1,3
13458_0,,,,2,2,1,3
13458_1,,,,2,2,1,3
13459_0,,,,2,2,1,3
13459_1,,,,2,2,1,3
13461_0,,,,2,2,1,3
C(C(C(CO)(CO)CO)=O)=O,,,4,1,1,0,1
13463_0,,,,2,2,1,3
C(CO)(C(CO)(CO)CO)=O,,,4,1,1,0,1
13465_0,,,,2,2,1,3
C(C(CO)(CO)C(C=O)O)=O,,,4,1,1,0,1
13466_0,,,,2,2,1,3
13466_1,,,,2,2,1,3
13468_0,,,,2,2,1,3
C(C(C(CO)(CO)C(C)O)=O)=O,,,4,1,2,0,2
13469_0,,,,2,2,1,3
13469_1,,,,2,2,1,3
13471_0,,,,2,2,1,3
C(CO)(C(CO)(CO)C(C)O)=O,,,4,1,2,0,2
13472_0,,,,2,2,1,3
13472_1,,,,2,2,1,3
13473_0,,,,2,2,1,3
13473_1,,,,2,2,1,3
13474_0,,,,2,2,1,3
13474_1,,,,2,2,1,3
13476_0,,,,2,2,1,3
C(C(CO)(C(C)O)C(C=O)O)=O,,,4,1,2,0,2
13477_0,,,,2,2,1,3
13477_1,,,,2,2,1,3
13478_0,,,,2,2,1,3
13478_1,,,,2,2,1,3
13479_0,,,,2,2,1,3
13479_1,,,,2,2,1,3
13480_0,,,,2,2,1,3
13480_1,,,,2,2,1,3
13481_0,,,,2,2,1,3
13481_1,,,,2,2,1,3
13482_0,,,,2,2,1,3
13482_1,,,,2,2,1,3
13483_0,,,,2,2,1,3
13483_1,,,,2,2,1,3
13484_0,,,,2,2,1,3
13485_0,,,,2,2,1,3
13485_1,,,,2,2,1,3
13486_0,,,,2,2,1,3
13486_1,,,,2,2,1,3
13487_0,,,,2,2,1,3
13487_1,,,,2,2,1,3
13488_0,,,,2,2,1,3
13489_0,,,,2,2,1,3
13489_1,,,,2,2,1,3
13490_0,,,,2,2,1,3
13491_0,,,,2,2,1,3
13491_1,,,,2,2,1,3
13492_0,,,,2,2,1,3
13492_1,,,,2,2,1,3
13493_0,,,,2,2,1,3
13493_1,,,,2,2,1,3
13494_0,,,,2,2,1,3
13495_0,,,,2,2,1,3
13495_1,,,,2,2,1,3
13496_0,,,,2,2,1,3
13496_1,,,,2,2,1,3
13498_0,,,,2,2,1,3
C(C(CO)(CO)O)(CC(C=O)=O)=O,,,4,1,2,0,2
13498_1,,,,2,2,1,3
13500_0,,,,2,2,1,3
C(CCO)(C(C(C=O)=O)(CO)O)=O,,,4,1,2,0,2
13500_1,,,,2,2,1,3
13501_0,,,,2,2,1,3
13501_1,,,,2,2,1,3
13502_0,,,,2,2,1,3
13502_1,,,,2,2,1,3
13503_0,,,,2,2,1,3
13503_1,,,,2,2,1,3
13504_0,,,,2,2,1,3
13504_1,,,,2,2,1,3
13505_0,,,,2,2,1,3
13505_1,,,,2,2,1,3
13506_0,,,,2,2,1,3
13506_1,,,,2,2,1,3
13507_0,,,,2,2,1,3
13507_1,,,,2,2,1,3
13508_0,,,,2,2,1,3
13508_1,,,,2,2,1,3
13509_0,,,,2,2,1,3
13509_1,,,,2,2,1,3
13510_0,,,,2,2,1,3
13510_1,,,,2,2,1,3
13511_0,,,,2,2,1,3
13511_1,,,,2,2,1,3
13512_0,,,,2,2,1,3
13513_0,,,,2,2,1,3
13513_1,,,,2,2,1,3
13514_0,,,,2,2,1,3
13514_1,,,,2,2,1,3
13516_0,,,,2,2,1,3
C(C(C(OCC(C)=O)O)(CO)O)=O,,,4,1,2,0,2
13516_1,,,,2,2,1,3
13518_0,,,,2,2,1,3
C(C(CO)(CO)OCC(CO)=O)=O,,,4,1,2,0,2
13518_1,,,,2,2,1,3
13520_0,,,,2,2,1,3
C(C(CO)(CO)OC(C(C)=O)O)=O,,,4,1,2,0,2
13520_1,,,,2,2,1,3
13521_0,,,,2,2,1,3
13521_1,,,,2,2,1,3
13522_0,,,,2,2,1,3
13522_1,,,,2,2,1,3
13524_0,,,,2,2,1,3
C(C(CO)(COCC(CO)=O)O)=O,,,4,1,2,0,2
13524_1,,,,2,2,1,3
13526_0,,,,2,2,1,3
C(C(CO)(COC(C(C)=O)O)O)=O,,,4,1,2,0,2
13526_1,,,,2,2,1,3
13527_0,,,,2,2,1,3
13527_1,,,,2,2,1,3
13528_0,,,,2,2,1,3
13528_1,,,,2,2,1,3
13529_0,,,,2,2,1,3
13529_1,,,,2,2,1,3
13531_0,,,,2,2,1,3
C1(C(CO)(C(CO1)O)O)=O,,,4,1,3,0,3
13531_1,,,,2,2,1,3
13533_0,,,,2,2,1,3
C1(C(CO)C(CO1)O)=O,,,4,1,1,0,1
13535_0,,,,2,2,1,3
C(C(CO)(C(C)(OCC=O)O)O)=O,,,4,1,2,0,2
13535_1,,,,2,2,1,3
13536_0,,,,2,2,1,3
13536_1,,,,2,2,1,3
13537_0,,,,2,2,1,3
13537_1,,,,2,2,1,3
13539_0,,,,2,2,1,3
C(C(CCO)=O)(C(CO)(CO)O)=O,,,4,1,3,0,3
13539_1,,,,2,2,1,3
13540_0,,,,2,2,1,3
13540_1,,,,2,2,1,3
13542_0,,,,2,2,1,3
C(C(CO)(CO)O)(C(C(C)=O)O)=O,,,4,1,3,0,3
13542_1,,,,2,2,1,3
13543_0,,,,2,2,1,3
13543_1,,,,2,2,1,3
13544_0,,,,2,2,1,3
13544_1,,,,2,2,1,3
13545_0,,,,2,2,1,3
13545_1,,,,2,2,1,3
13547_0,,,,2,2,1,3
C(C(C(C(CO)(C(C)O)O)=O)O)=O,,,4,1,3,0,3
13547_1,,,,2,2,1,3
13548_0,,,,2,2,1,3
13548_1,,,,2,2,1,3
13549_0,,,,2,2,1,3
13549_1,,,,2,2,1,3
13550_0,,,,2,2,1,3
13550_1,,,,2,2,1,3
13552_0,,,,2,2,1,3
C1(C(C(CO)O)OCC1(CO)O)=O,,,4,1,2,0,2
13552_1,,,,2,2,1,3
13554_0,,,,2,2,1,3
C1(C(COC1(CO)C(CO)O)O)=O,,,4,1,2,0,2
13554_1,,,,2,2,1,3
13556_0,,,,2,2,1,3
C1(C(C(CO)OCC1(CO)O)O)=O,,,4,1,2,0,2
13556_1,,,,2,2,1,3
13558_0,,,,2,2,1,3
C1(C(COC(CO)C1(CO)O)O)=O,,,4,1,2,0,2
13558_1,,,,2,2,1,3
13560_0,,,,2,2,1,3
C1(C(CC(OC1(CO)CO)O)O)=O,,,4,1,3,0,3
13560_1,,,,2,2,1,3
13562_0,,,,2,2,1,3
C1(C(C(COCC1(CO)O)O)O)=O,,,4,1,2,0,2
13562_1,,,,2,2,1,3
13564_0,,,,2,2,1,3
C1(C(COCC(C1(CO)O)O)O)=O,,,4,1,2,0,2
13564_1,,,,2,2,1,3
13566_0,,,,2,2,1,3
C1(C(CC(O)OCC1(CO)O)O)=O,,,4,1,3,0,3
13566_1,,,,2,2,1,3
13568_0,,,,2,2,1,3
C1(C(CCOC(C1(CO)O)O)O)=O,,,4,1,3,0,3
13568_1,,,,2,2,1,3
13569_0,,,,2,2,1,3
13569_1,,,,2,2,1,3
13570_0,,,,2,2,1,3
13570_1,,,,2,2,1,3
13572_0,,,,2,2,1,3
C(CO)(C1(CO)C(CC(O1)O)O)=O,,,4,1,3,0,3
13572_1,,,,2,2,1,3
13573_0,,,,2,2,1,3
13573_1,,,,2,2,1,3
13574_0,,,,2,2,1,3
13574_1,,,,2,2,1,3
13575_0,,,,2,2,1,3
13575_1,,,,2,2,1,3
13576_0,,,,2,2,1,3
13576_1,,,,2,2,1,3
13577_0,,,,2,2,1,3
13577_1,,,,2,2,1,3
13578_0,,,,2,2,1,3
13578_1,,,,2,2,1,3
13579_0,,,,2,2,1,3
13579_1,,,,2,2,1,3
13580_0,,,,2,2,1,3
13580_1,,,,2,2,1,3
13581_0,,,,2,2,1,3
13581_1,,,,2,2,1,3
13582_0,,,,2,2,1,3
13583_0,,,,2,2,1,3
13583_1,,,,2,2,1,3
13584_0,,,,2,2,1,3
13585_0,,,,2,2,1,3
13585_1,,,,2,2,1,3
13586_0,,,,2,2,1,3
13586_1,,,,2,2,1,3
13587_0,,,,2,2,1,3
13587_1,,,,2,2,1,3
13588_0,,,,2,2,1,3
13588_1,,,,2,2,1,3
13589_0,,,,2,2,1,3
13589_1,,,,2,2,1,3
13590_0,,,,2,2,1,3
13590_1,,,,2,2,1,3
13591_0,,,,2,2,1,3
13591_1,,,,2,2,1,3
13592_0,,,,2,2,1,3
13592_1,,,,2,2,1,3
13593_0,,,,2,2,1,3
13593_1,,,,2,2,1,3
13594_0,,,,2,2,1,3
13594_1,,,,2,2,1,3
13595_0,,,,2,2,1,3
13595_1,,,,2,2,1,3
13597_0,,,,2,2,1,3
C(C(C=O)(C(C(C)=O)(CO)O)O)=O,,,4,1,4,0,4
13597_1,,,,2,2,1,3
13598_0,,,,2,2,1,3
13598_1,,,,2,2,1,3
13600_0,,,,2,2,1,3
C(C(C=O)(C(C=O)(CO)O)O)=O,,,4,1,4,0,4
13600_1,,,,2,2,1,3
13601_0,,,,2,2,1,3
13601_1,,,,2,2,1,3
13603_0,,,,2,2,1,3
C1(C(CO)(C(C(C1(C)O)O)O)O)=O,,,4,1,3,0,3
13603_1,,,,2,2,1,3
13604_0,,,,2,2,1,3
13604_1,,,,2,2,1,3
13605_0,,,,2,2,1,3
13605_1,,,,2,2,1,3
13606_0,,,,2,2,1,3
13606_1,,,,2,2,1,3
13607_0,,,,2,2,1,3
13607_1,,,,2,2,1,3
13608_0,,,,2,2,1,3
13608_1,,,,2,2,1,3
13609_0,,,,2,2,1,3
13609_1,,,,2,2,1,3
13610_0,,,,2,2,1,3
13610_1,,,,2,2,1,3
13611_0,,,,2,2,1,3
13611_1,,,,2,2,1,3
13613_0,,,,2,2,1,3
C1(CC(C(C1(CO)CO)=O)O)=O,,,4,1,2,0,2
13614_0,,,,2,2,1,3
13614_1,,,,2,2,1,3
13616_0,,,,2,2,1,3
C1(C(CO)(CO)CC(C1O)=O)=O,,,4,1,2,0,2
13618_0,,,,2,2,1,3
C(C(C)=O)(C(CO)(C(CO)O)O)=O,,,4,1,2,0,2
13618_1,,,,2,2,1,3
13620_0,,,,2,2,1,3
C1(C(CO)C(C(C(C)=O)O1)O)=O,,,4,1,2,0,2
13622_0,,,,2,2,1,3
C1(CC(C(C(C)=O)(CO)O1)O)=O,,,4,1,3,0,3
13622_1,,,,2,2,1,3
13624_0,,,,2,2,1,3
C1(C(CO)C(C(CC=O)O1)O)=O,,,4,1,2,0,2
13626_0,,,,2,2,1,3
C1(COC(C(C)=O)C1(CO)O)=O,,,4,1,3,0,3
13626_1,,,,2,2,1,3
13628_0,,,,2,2,1,3
C(C)(C1(CO)C(C(CO1)=O)O)=O,,,4,1,3,0,3
13628_1,,,,2,2,1,3
13630_0,,,,2,2,1,3
C(CC1C(C(CO1)=O)(CO)O)=O,,,4,1,3,0,3
13630_1,,,,2,2,1,3
13632_0,,,,2,2,1,3
C1(CC(OC1(C(C)=O)CO)O)=O,,,4,1,5,0,5
13632_1,,,,2,2,1,3
13634_0,,,,2,2,1,3
C1(CCC(OC1(CO)CO)=O)=O,,,4,1,3,0,3
13634_1,,,,2,2,1,3
13636_0,,,,2,2,1,3
C1(C(CO)(CO)OCC(C1)=O)=O,,,4,1,3,0,3
13636_1,,,,2,2,1,3
13638_0,,,,2,2,1,3
C1(CCC(OCC1(CO)O)=O)=O,,,4,1,3,0,3
13638_1,,,,2,2,1,3
13640_0,,,,2,2,1,3
C1(C(CO)C(C(CCO1)=O)O)=O,,,4,1,2,0,2
13642_0,,,,2,2,1,3
C1(C(CO)C(CC(CO1)=O)O)=O,,,4,1,2,0,2
13644_0,,,,2,2,1,3
C1(C(CO)(COCC(C1)=O)O)=O,,,4,1,3,0,3
13644_1,,,,2,2,1,3
13646_0,,,,2,2,1,3
C1(CCOCC(C1(CO)O)=O)=O,,,4,1,4,0,4
13646_1,,,,2,2,1,3
13648_0,,,,2,2,1,3
C1(COCC1(CO)O)=O,,,4,1,2,0,2
13648_1,,,,2,2,1,3
13650_0,,,,2,2,1,3
C(C1(CO)C(C(C(CO)O1)O)O)=O,,,4,1,2,0,2
13650_1,,,,2,2,1,3
13652_0,,,,2,2,1,3
C1(C(C(CO)OC1(CO)CO)O)=O,,,4,1,2,0,2
13652_1,,,,2,2,1,3
13654_0,,,,2,2,1,3
C1(C(CO)OC(CO)C1(CO)O)=O,,,4,1,2,0,2
13654_1,,,,2,2,1,3
13656_0,,,,2,2,1,3
C1(CC(CO)(OC1(CO)CO)O)=O,,,4,1,3,0,3
13656_1,,,,2,2,1,3
13658_0,,,,2,2,1,3
C(CC1C(C(CO)(CO1)O)=O)=O,,,4,1,2,0,2
13658_1,,,,2,2,1,3
13660_0,,,,2,2,1,3
C(C1(CO)C(CC(C=O)O1)O)=O,,,4,1,3,0,3
13660_1,,,,2,2,1,3
13662_0,,,,2,2,1,3
C(C1(C(CC(C)(O1)O)=O)CO)=O,,,4,1,4,0,4
13662_1,,,,2,2,1,3
13664_0,,,,2,2,1,3
C(C1(CO)C(C(C(C)O1)=O)O)=O,,,4,1,3,0,3
13664_1,,,,2,2,1,3
13666_0,,,,2,2,1,3
C1(C(CO)(C(C=O)OC1C)O)=O,,,4,1,2,0,2
13666_1,,,,2,2,1,3
13668_0,,,,2,2,1,3
C(C1(CO)C(C(C(CO1)O)O)O)=O,,,4,1,2,0,2
13668_1,,,,2,2,1,3
13670_0,,,,2,2,1,3
C1(C(C(COC1(CO)CO)O)O)=O,,,4,1,2,0,2
13670_1,,,,2,2,1,3
13672_0,,,,2,2,1,3
C1(C(CO)OCC(C1(CO)O)O)=O,,,4,1,2,0,2
13672_1,,,,2,2,1,3
13674_0,,,,2,2,1,3
C1(CC(CO)(O)OCC1(CO)O)=O,,,4,1,3,0,3
13674_1,,,,2,2,1,3
13676_0,,,,2,2,1,3
C1(CCOC(CO)(C1(CO)O)O)=O,,,4,1,3,0,3
13676_1,,,,2,2,1,3
13678_0,,,,2,2,1,3
C(C1(C(CCC(O1)O)=O)CO)=O,,,4,1,4,0,4
13678_1,,,,2,2,1,3
13680_0,,,,2,2,1,3
C1(CC(C(CO)(C(CO)O)O1)=O)=O,,,4,1,2,0,2
13680_1,,,,2,2,1,3
13682_0,,,,2,2,1,3
C1(C(CO)(C(C(C(C)=O)O1)O)O)=O,,,4,1,2,0,2
13682_1,,,,2,2,1,3
13684_0,,,,2,2,1,3
C1(C(C(C(C(C)=O)(CO)O1)O)O)=O,,,4,1,2,0,2
13684_1,,,,2,2,1,3
13686_0,,,,2,2,1,3
C1(C(CO)(C(C(CC=O)O1)O)O)=O,,,4,1,2,0,2
13686_1,,,,2,2,1,3
13688_0,,,,2,2,1,3
C1(CC(C(CO)(C(CO)O1)O)=O)=O,,,4,1,2,0,2
13688_1,,,,2,2,1,3
13690_0,,,,2,2,1,3
C1(C(C(CC(CO)O1)=O)(CO)O)=O,,,4,1,2,0,2
13690_1,,,,2,2,1,3
13692_0,,,,2,2,1,3
C1(CC(C(OC1(CO)CO)=O)O)=O,,,4,1,2,0,2
13692_1,,,,2,2,1,3
13694_0,,,,2,2,1,3
C1(CC(C(CO)(C(CO1)O)O)=O)=O,,,4,1,2,0,2
13694_1,,,,2,2,1,3
13696_0,,,,2,2,1,3
C1(C(C(CC(CO1)O)=O)(CO)O)=O,,,4,1,2,0,2
13696_1,,,,2,2,1,3
13698_0,,,,2,2,1,3
C1(CC(C(OCC1(CO)O)=O)O)=O,,,4,1,2,0,2
13698_1,,,,2,2,1,3
13700_0,,,,2,2,1,3
C1(C(CO)(C(C(CCO1)=O)O)O)=O,,,4,1,2,0,2
13700_1,,,,2,2,1,3
13702_0,,,,2,2,1,3
C1(C(CO)(C(C(OCC1)=O)O)O)=O,,,4,1,2,0,2
13702_1,,,,2,2,1,3
13704_0,,,,2,2,1,3
C1(C(CO)(C(CC(CO1)=O)O)O)=O,,,4,1,2,0,2
13704_1,,,,2,2,1,3
13706_0,,,,2,2,1,3
C1C(C(C(C=1CO)=O)(CO)O)O,,,4,1,3,0,3
13706_1,,,,2,2,1,3
13708_0,,,,2,2,1,3
C=C1C(C(CO)(C(C1O)O)O)=O,,,4,1,3,0,3
13708_1,,,,2,2,1,3
13710_0,,,,2,2,1,3
C(C(CO)(C(C(C=C)O)O)O)=O,,,4,1,3,0,3
13710_1,,,,2,2,1,3
13712_0,,,,2,2,1,3
C1OC(C(C=1)=O)(CO)C(CO)O,,,4,1,3,0,3
13712_1,,,,2,2,1,3
13714_0,,,,2,2,1,3
C1OC(CO)C(C(C=1)=O)(CO)O,,,4,1,3,0,3
13714_1,,,,2,2,1,3
13716_0,,,,2,2,1,3
C1C(OC(C(C=1)=O)(CO)CO)O,,,4,1,3,0,3
13716_1,,,,2,2,1,3
13718_0,,,,2,2,1,3
C1OCC(C(C(C=1)=O)(CO)O)O,,,4,1,3,0,3
13718_1,,,,2,2,1,3
13720_0,,,,2,2,1,3
C1COC(C(C(C=1)=O)(CO)O)O,,,4,1,3,0,3
13720_1,,,,2,2,1,3
13722_0,,,,2,2,1,3
C1C(O)OCC(C(C=1)=O)(CO)O,,,4,1,3,0,3
13722_1,,,,2,2,1,3
13724_0,,,,2,2,1,3
C(C(C1OCC(C=1)O)(CO)O)=O,,,4,1,3,0,3
13724_1,,,,2,2,1,3
13726_0,,,,2,2,1,3
C(C(CO)(C1(C=CCO1)O)O)=O,,,4,1,3,0,3
13726_1,,,,2,2,1,3
13728_0,,,,2,2,1,3
C(C1(CO)C(C=C(CO)O1)O)=O,,,4,1,3,0,3
13728_1,,,,2,2,1,3
13730_0,,,,2,2,1,3
C(C1(CO)C(C(C(O1)=C)O)O)=O,,,4,1,3,0,3
13730_1,,,,2,2,1,3
13732_0,,,,2,2,1,3
C(C(CO)(C1C=CC(O1)O)O)=O,,,4,1,3,0,3
13732_1,,,,2,2,1,3
13734_0,,,,2,2,1,3
C(C(CO)(C1C(C=CO1)O)O)=O,,,4,1,3,0,3
13734_1,,,,2,2,1,3
13736_0,,,,2,2,1,3
C(C1(CO)C(C=CC(O1)O)O)=O,,,4,1,3,0,3
13736_1,,,,2,2,1,3
13738_0,,,,2,2,1,3
C(C1(CO)C(C(C=CO1)O)O)=O,,,4,1,3,0,3
13738_1,,,,2,2,1,3
13740_0,,,,2,2,1,3
C1(COC(CCO)(C1(CO)O)O)=O,,,4,1,3,0,3
13740_1,,,,2,2,1,3
13742_0,,,,2,2,1,3
C1(C(CCO)OC(C1(CO)O)O)=O,,,4,1,3,0,3
13742_1,,,,2,2,1,3
13744_0,,,,2,2,1,3
C(C(CO)(C1(C(CCO1)O)O)O)=O,,,4,1,3,0,3
13744_1,,,,2,2,1,3
13746_0,,,,2,2,1,3
C(C(CO)(C1CC(C(O)O1)O)O)=O,,,4,1,3,0,3
13746_1,,,,2,2,1,3
13748_0,,,,2,2,1,3
C(C1(CO)C(CC(C(O1)O)O)O)=O,,,4,1,3,0,3
13748_1,,,,2,2,1,3
13750_0,,,,2,2,1,3
C1(COC(C)(C(C1(CO)O)O)O)=O,,,4,1,3,0,3
13750_1,,,,2,2,1,3
13752_0,,,,2,2,1,3
C1(C(C)OC(C(C1(CO)O)O)O)=O,,,4,1,3,0,3
13752_1,,,,2,2,1,3
13754_0,,,,2,2,1,3
C1(COC(CC(C1(CO)O)O)O)=O,,,4,1,3,0,3
13754_1,,,,2,2,1,3
13756_0,,,,2,2,1,3
C(C(CO)(C1C(CC(O1)=O)O)O)=O,,,4,1,2,0,2
13756_1,,,,2,2,1,3
13758_0,,,,2,2,1,3
C1(C(CO)C(C(C(C=O)O)O1)O)=O,,,4,1,1,0,1
13760_0,,,,2,2,1,3
C(C1(CO)C(C(CC(O1)=O)O)O)=O,,,4,1,2,0,2
13760_1,,,,2,2,1,3
13762_0,,,,2,2,1,3
C1(C(CO)C(C(C(C=O)O1)O)O)=O,,,4,1,1,0,1
13763_0,,,,2,2,1,3
13763_1,,,,2,2,1,3
13764_0,,,,2,2,1,3
13764_1,,,,2,2,1,3
13766_0,,,,2,2,1,3
C(C(C=O)(C(CCO)O)O)=O,,,4,1,2,0,2
13766_1,,,,2,2,1,3
13768_0,,,,2,2,1,3
C(C(C=O)(C(CC(C)O)O)O)=O,,,4,1,2,0,2
13768_1,,,,2,2,1,3
13769_0,,,,2,2,1,3
13769_1,,,,2,2,1,3
13771_0,,,,2,2,1,3
C(C(C=O)(C(C(C(C)O)O)O)O)=O,,,4,1,2,0,2
13771_1,,,,2,2,1,3
13772_0,,,,2,2,1,3
13772_1,,,,2,2,1,3
13773_0,,,,2,2,1,3
13773_1,,,,2,2,1,3
13774_0,,,,2,2,1,3
13774_1,,,,2,2,1,3
13775_0,,,,2,2,1,3
13775_1,,,,2,2,1,3
13776_0,,,,2,2,1,3
13776_1,,,,2,2,1,3
13777_0,,,,2,2,1,3
13777_1,,,,2,2,1,3
13779_0,,,,2,2,1,3
C(C(C=O)(C(C=O)(C(C)O)O)O)=O,,,4,1,4,0,4
13779_1,,,,2,2,1,3
13781_0,,,,2,2,1,3
C(C(C=O)(C(CO)(C(C)O)O)O)=O,,,4,1,2,0,2
13781_1,,,,2,2,1,3
13783_0,,,,2,2,1,3
C(C(C=O)(C(CC=O)O)O)=O,,,4,1,3,0,3
13783_1,,,,2,2,1,3
13784_0,,,,2,2,1,3
13784_1,,,,2,2,1,3
13785_0,,,,2,2,1,3
13785_1,,,,2,2,1,3
13787_0,,,,2,2,1,3
C(C(C=O)(C=O)O)(O)=O,,,4,1,2,0,2
13787_1,,,,2,2,1,3
13788_0,,,,2,2,1,3
13788_1,,,,2,2,1,3
13789_0,,,,2,2,1,3
13789_1,,,,2,2,1,3
13790_0,,,,2,2,1,3
13790_1,,,,2,2,1,3
13792_0,,,,2,2,1,3
C(C(C=O)(C(C(CC=O)=O)O)O)=O,,,4,1,2,0,2
13792_1,,,,2,2,1,3
13794_0,,,,2,2,1,3
C(C(C=O)(C(C=O)(CC=O)O)O)=O,,,4,1,2,0,2
13794_1,,,,2,2,1,3
13796_0,,,,2,2,1,3
C(C(C=O)(C(CC(C=O)=O)O)O)=O,,,4,1,2,0,2
13796_1,,,,2,2,1,3
13798_0,,,,2,2,1,3
C(C(C=O)(C(C(C)=O)(C)O)O)=O,,,4,1,3,0,3
13798_1,,,,2,2,1,3
13800_0,,,,2,2,1,3
C(C(C=O)(C(C)(CC=O)O)O)=O,,,4,1,3,0,3
13800_1,,,,2,2,1,3
13802_0,,,,2,2,1,3
C(C(C=O)(C(CC(C)=O)O)O)=O,,,4,1,2,0,2
13802_1,,,,2,2,1,3
13804_0,,,,2,2,1,3
C(C(C=O)(C1(COC(C1)O)O)O)=O,,,4,1,3,0,3
13804_1,,,,2,2,1,3
13806_0,,,,2,2,1,3
C(C(C=O)(C(C(C=C)=O)O)O)=O,,,4,1,3,0,3
13806_1,,,,2,2,1,3
13808_0,,,,2,2,1,3
C(C(C=O)(C(C=O)(C=C)O)O)=O,,,4,1,3,0,3
13808_1,,,,2,2,1,3
13810_0,,,,2,2,1,3
C(C(C=O)(C(C=C)(CO)O)O)=O,,,4,1,3,0,3
13810_1,,,,2,2,1,3
13812_0,,,,2,2,1,3
C(C(C=O)(C(C=CC=O)O)O)=O,,,4,1,4,0,4
13812_1,,,,2,2,1,3
13814_0,,,,2,2,1,3
C1(C(C(C(C=O)O)O)C(CO1)O)=O,,,4,1,1,0,1
13816_0,,,,2,2,1,3
C(C(C=O)(C(C(C)O)O)O)=O,,,4,1,2,0,2
13816_1,,,,2,2,1,3
13817_0,,,,2,2,1,3
13817_1,,,,2,2,1,3
13819_0,,,,2,2,1,3
C(C(C(C1(C(COC1)=O)O)O)O)=O,,,4,1,2,0,2
13819_1,,,,2,2,1,3
13821_0,,,,2,2,1,3
C(C(C=O)(C1(COCC1O)O)O)=O,,,4,1,2,0,2
13821_1,,,,2,2,1,3
13823_0,,,,2,2,1,3
C(C(C=O)(C1(C(O)OCC1)O)O)=O,,,4,1,3,0,3
13823_1,,,,2,2,1,3
13825_0,,,,2,2,1,3
C(C)(C(C(C)O)(C(CO)(C)O)O)=O,,,4,1,4,0,4
13825_1,,,,2,2,1,3
13827_0,,,,2,2,1,3
C(C(C(C)O)(C(CO)(C)O)O)=O,,,4,1,4,0,4
13827_1,,,,2,2,1,3
13829_0,,,,2,2,1,3
C(C(C(CO)(C(CO)(C)O)O)=O)=O,,,4,1,2,0,2
13829_1,,,,2,2,1,3
13830_0,,,,2,2,1,3
13830_1,,,,2,2,1,3
13831_0,,,,2,2,1,3
13831_1,,,,2,2,1,3
13832_0,,,,2,2,1,3
13832_1,,,,2,2,1,3
13833_0,,,,2,2,1,3
13835_0,,,,2,2,1,3
C1(C(C(CO1)O)(C(CO)(C)O)O)=O,,,4,1,2,0,2
13835_1,,,,2,2,1,3
13837_0,,,,2,2,1,3
C1(C(C(CO1)O)C(C)(CO)O)=O,,,4,1,1,0,1
13838_0,,,,2,2,1,3
13838_1,,,,2,2,1,3
13840_0,,,,2,2,1,3
C(C(C(C)O)(C(CO)(C)O)O)(O)=O,,,4,1,4,0,4
13840_1,,,,2,2,1,3
13842_0,,,,2,2,1,3
C1(COCC1(C(CO)(C)O)O)=O,,,4,1,2,0,2
13842_1,,,,2,2,1,3
13844_0,,,,2,2,1,3
C(C(C(CCO)O)(C(C=O)O)O)=O,,,4,1,2,0,2
13844_1,,,,2,2,1,3
13845_0,,,,2,2,1,3
13845_1,,,,2,2,1,3
13846_0,,,,2,2,1,3
13846_1,,,,2,2,1,3
13847_0,,,,2,2,1,3
13847_1,,,,2,2,1,3
13849_0,,,,2,2,1,3
C(C(C(C(C)O)O)(C(C=O)O)O)=O,,,4,1,2,0,2
13849_1,,,,2,2,1,3
13850_0,,,,2,2,1,3
13850_1,,,,2,2,1,3
13851_0,,,,2,2,1,3
13852_0,,,,2,2,1,3
13852_1,,,,2,2,1,3
13853_0,,,,2,2,1,3
13853_1,,,,2,2,1,3
13854_0,,,,2,2,1,3
13855_0,,,,2,2,1,3
13856_0,,,,2,2,1,3
13856_1,,,,2,2,1,3
13857_0,,,,2,2,1,3
13857_1,,,,2,2,1,3
13858_0,,,,2,2,1,3
13859_0,,,,2,2,1,3
13859_1,,,,2,2,1,3
13860_0,,,,2,2,1,3
13861_0,,,,2,2,1,3
13862_0,,,,2,2,1,3
13862_1,,,,2,2,1,3
13863_0,,,,2,2,1,3
13863_1,,,,2,2,1,3
13864_0,,,,2,2,1,3
13864_1,,,,2,2,1,3
13866_0,,,,2,2,1,3
C(CO)(C(C(C)O)(C(C)O)O)=O,,,4,1,2,0,2
13866_1,,,,2,2,1,3
13867_0,,,,2,2,1,3
13867_1,,,,2,2,1,3
13868_0,,,,2,2,1,3
13868_1,,,,2,2,1,3
13869_0,,,,2,2,1,3
13870_0,,,,2,2,1,3
13870_1,,,,2,2,1,3
13872_0,,,,2,2,1,3
C(C(C(CO)=O)(C(C)O)C(C)O)=O,,,4,1,1,0,1
13874_0,,,,2,2,1,3
C(CC(C(C(C)O)(C(C)O)O)=O)=O,,,4,1,2,0,2
13874_1,,,,2,2,1,3
13875_0,,,,2,2,1,3
13875_1,,,,2,2,1,3
13876_0,,,,2,2,1,3
13876_1,,,,2,2,1,3
13877_0,,,,2,2,1,3
13877_1,,,,2,2,1,3
13878_0,,,,2,2,1,3
13878_1,,,,2,2,1,3
13879_0,,,,2,2,1,3
13879_1,,,,2,2,1,3
13880_0,,,,2,2,1,3
13880_1,,,,2,2,1,3
13881_0,,,,2,2,1,3
13882_0,,,,2,2,1,3
13883_0,,,,2,2,1,3
13884_0,,,,2,2,1,3
13884_1,,,,2,2,1,3
13886_0,,,,2,2,1,3
C(C(C(CO)(C(C)O)C(C)O)=O)=O,,,4,1,1,0,1
13888_0,,,,2,2,1,3
C(CCO)(C(C(C)O)(C(C)O)O)=O,,,4,1,2,0,2
13888_1,,,,2,2,1,3
13890_0,,,,2,2,1,3
C(CO)(C(CO)(C(C)O)C(C)O)=O,,,4,1,1,0,1
13891_0,,,,2,2,1,3
13891_1,,,,2,2,1,3
13892_0,,,,2,2,1,3
13892_1,,,,2,2,1,3
13894_0,,,,2,2,1,3
C(C)(C(C(C)O)(C(C)O)O)=O,,,4,1,2,0,2
13894_1,,,,2,2,1,3
13896_0,,,,2,2,1,3
C(C(C(C)O)(C(C)O)C(C=O)O)=O,,,4,1,1,0,1
13897_0,,,,2,2,1,3
13897_1,,,,2,2,1,3
13898_0,,,,2,2,1,3
13898_1,,,,2,2,1,3
13899_0,,,,2,2,1,3
13899_1,,,,2,2,1,3
13900_0,,,,2,2,1,3
13900_1,,,,2,2,1,3
13901_0,,,,2,2,1,3
13901_1,,,,2,2,1,3
13902_0,,,,2,2,1,3
13902_1,,,,2,2,1,3
13903_0,,,,2,2,1,3
13903_1,,,,2,2,1,3
13905_0,,,,2,2,1,3
C(C(C(C)O)(C(C)O)O)=O,,,4,1,2,0,2
13905_1,,,,2,2,1,3
13907_0,,,,2,2,1,3
C(C(C(CO)(C(C)O)O)=O)=O,,,4,1,2,0,2
13907_1,,,,2,2,1,3
13908_0,,,,2,2,1,3
13908_1,,,,2,2,1,3
13909_0,,,,2,2,1,3
13909_1,,,,2,2,1,3
13910_0,,,,2,2,1,3
13910_1,,,,2,2,1,3
13911_0,,,,2,2,1,3
13911_1,,,,2,2,1,3
13912_0,,,,2,2,1,3
13912_1,,,,2,2,1,3
13913_0,,,,2,2,1,3
13913_1,,,,2,2,1,3
13914_0,,,,2,2,1,3
13914_1,,,,2,2,1,3
13915_0,,,,2,2,1,3
13915_1,,,,2,2,1,3
13916_0,,,,2,2,1,3
13918_0,,,,2,2,1,3
C1(C(C(C)O)(C(CO1)O)O)=O,,,4,1,3,0,3
13918_1,,,,2,2,1,3
13920_0,,,,2,2,1,3
C1(C(C(C)O)C(CO1)O)=O,,,4,1,1,0,1
13921_0,,,,2,2,1,3
13921_1,,,,2,2,1,3
13922_0,,,,2,2,1,3
13922_1,,,,2,2,1,3
13923_0,,,,2,2,1,3
13923_1,,,,2,2,1,3
13924_0,,,,2,2,1,3
13924_1,,,,2,2,1,3
13925_0,,,,2,2,1,3
13925_1,,,,2,2,1,3
13926_0,,,,2,2,1,3
13926_1,,,,2,2,1,3
13927_0,,,,2,2,1,3
13927_1,,,,2,2,1,3
13928_0,,,,2,2,1,3
13928_1,,,,2,2,1,3
13929_0,,,,2,2,1,3
13929_1,,,,2,2,1,3
13930_0,,,,2,2,1,3
13930_1,,,,2,2,1,3
13931_0,,,,2,2,1,3
13931_1,,,,2,2,1,3
13932_0,,,,2,2,1,3
13932_1,,,,2,2,1,3
13933_0,,,,2,2,1,3
13933_1,,,,2,2,1,3
13934_0,,,,2,2,1,3
13934_1,,,,2,2,1,3
13935_0,,,,2,2,1,3
13935_1,,,,2,2,1,3
13937_0,,,,2,2,1,3
C(C(C(C)O)(C(C)O)O)(O)=O,,,4,1,2,0,2
13937_1,,,,2,2,1,3
13939_0,,,,2,2,1,3
C1(CC(C(C1(CO)C(C)O)=O)O)=O,,,4,1,1,0,1
13941_0,,,,2,2,1,3
C1(C(CO)CC(C1(C(C)O)O)=O)=O,,,4,1,2,0,2
13941_1,,,,2,2,1,3
13943_0,,,,2,2,1,3
C1(C(CO)(C(C)O)CC(C1O)=O)=O,,,4,1,1,0,1
13945_0,,,,2,2,1,3
C1(C(C(C(C(C)=O)O1)O)C(C)O)=O,,,4,1,1,0,1
13947_0,,,,2,2,1,3
C1(CC(C(C(C)=O)(C(C)O)O1)O)=O,,,4,1,2,0,2
13947_1,,,,2,2,1,3
13949_0,,,,2,2,1,3
C1(C(C(C)O)C(C(CC=O)O1)O)=O,,,4,1,1,0,1
13951_0,,,,2,2,1,3
C1(COC(C(C)=O)C1(C(C)O)O)=O,,,4,1,2,0,2
13951_1,,,,2,2,1,3
13953_0,,,,2,2,1,3
C(C)(C1(C(C)O)C(C(CO1)=O)O)=O,,,4,1,2,0,2
13953_1,,,,2,2,1,3
13955_0,,,,2,2,1,3
C(CC1C(C(CO1)=O)(C(C)O)O)=O,,,4,1,2,0,2
13955_1,,,,2,2,1,3
13957_0,,,,2,2,1,3
C1(CC(OC1(C(C)=O)C(C)O)O)=O,,,4,1,3,0,3
13957_1,,,,2,2,1,3
13959_0,,,,2,2,1,3
C1(CCC(OC1(CO)C(C)O)=O)=O,,,4,1,2,0,2
13959_1,,,,2,2,1,3
13961_0,,,,2,2,1,3
C1(C(CO)(C(C)O)OCC(C1)=O)=O,,,4,1,2,0,2
13961_1,,,,2,2,1,3
13963_0,,,,2,2,1,3
C1(CCC(OCC1(C(C)O)O)=O)=O,,,4,1,2,0,2
13963_1,,,,2,2,1,3
13965_0,,,,2,2,1,3
C1(C(C(C)O)C(C(CCO1)=O)O)=O,,,4,1,1,0,1
13967_0,,,,2,2,1,3
C1(C(C(CC(CO1)=O)O)C(C)O)=O,,,4,1,1,0,1
13969_0,,,,2,2,1,3
C1(C(COCC(C1)=O)(C(C)O)O)=O,,,4,1,2,0,2
13969_1,,,,2,2,1,3
13971_0,,,,2,2,1,3
C1(CCOCC(C1(C(C)O)O)=O)=O,,,4,1,2,0,2
13971_1,,,,2,2,1,3
13973_0,,,,2,2,1,3
C1(COCC1(C(C)O)O)=O,,,4,1,2,0,2
13973_1,,,,2,2,1,3
13975_0,,,,2,2,1,3
C(CC1C(C(CO1)(C(C)O)O)=O)=O,,,4,1,2,0,2
13975_1,,,,2,2,1,3
13977_0,,,,2,2,1,3
C(C1(C(C)O)C(CC(C=O)O1)O)=O,,,4,1,2,0,2
13977_1,,,,2,2,1,3
13979_0,,,,2,2,1,3
C(C1(C(CC(C)(O1)O)=O)C(C)O)=O,,,4,1,3,0,3
13979_1,,,,2,2,1,3
13981_0,,,,2,2,1,3
C(C1(C(C)O)C(C(C(C)O1)=O)O)=O,,,4,1,2,0,2
13981_1,,,,2,2,1,3
13983_0,,,,2,2,1,3
C1(C(C(C)O)(C(C=O)OC1C)O)=O,,,4,1,2,0,2
13983_1,,,,2,2,1,3
13985_0,,,,2,2,1,3
C(C1(C(CCC(O1)O)=O)C(C)O)=O,,,4,1,3,0,3
13985_1,,,,2,2,1,3
13987_0,,,,2,2,1,3
C1C(C(C(C=1CO)=O)(C(C)O)O)O,,,4,1,2,0,2
13987_1,,,,2,2,1,3
13989_0,,,,2,2,1,3
C=C1C(C(C(C1O)O)(C(C)O)O)=O,,,4,1,2,0,2
13989_1,,,,2,2,1,3
13991_0,,,,2,2,1,3
C(C(C(C(C=C)O)O)(C(C)O)O)=O,,,4,1,2,0,2
13991_1,,,,2,2,1,3
13993_0,,,,2,2,1,3
C1OC(C(C=1)=O)(C(CO)O)C(C)O,,,4,1,2,0,2
13993_1,,,,2,2,1,3
13995_0,,,,2,2,1,3
C1OC(CO)C(C(C=1)=O)(C(C)O)O,,,4,1,2,0,2
13995_1,,,,2,2,1,3
13997_0,,,,2,2,1,3
C1C(OC(C(C=1)=O)(CO)C(C)O)O,,,4,1,2,0,2
13997_1,,,,2,2,1,3
13999_0,,,,2,2,1,3
C1OCC(C(C(C=1)=O)(C(C)O)O)O,,,4,1,2,0,2
13999_1,,,,2,2,1,3
14001_0,,,,2,2,1,3
C1COC(C(C(C=1)=O)(C(C)O)O)O,,,4,1,2,0,2
14001_1,,,,2,2,1,3
14003_0,,,,2,2,1,3
C1C(O)OCC(C(C=1)=O)(C(C)O)O,,,4,1,2,0,2
14003_1,,,,2,2,1,3
14005_0,,,,2,2,1,3
C(C(C1OCC(C=1)O)(C(C)O)O)=O,,,4,1,2,0,2
14005_1,,,,2,2,1,3
14007_0,,,,2,2,1,3
C(C(C(C)O)(C1(C=CCO1)O)O)=O,,,4,1,2,0,2
14007_1,,,,2,2,1,3
14009_0,,,,2,2,1,3
C(C1(C(C)O)C(C=C(CO)O1)O)=O,,,4,1,2,0,2
14009_1,,,,2,2,1,3
14011_0,,,,2,2,1,3
C(C1(C(C(C(O1)=C)O)O)C(C)O)=O,,,4,1,2,0,2
14011_1,,,,2,2,1,3
14013_0,,,,2,2,1,3
C(C(C(C)O)(C1C=CC(O1)O)O)=O,,,4,1,2,0,2
14013_1,,,,2,2,1,3
14015_0,,,,2,2,1,3
C(C(C1C(C=CO1)O)(C(C)O)O)=O,,,4,1,2,0,2
14015_1,,,,2,2,1,3
14017_0,,,,2,2,1,3
C(C1(C(C)O)C(C=CC(O1)O)O)=O,,,4,1,2,0,2
14017_1,,,,2,2,1,3
14019_0,,,,2,2,1,3
C(C1(C(C(C=CO1)O)O)C(C)O)=O,,,4,1,2,0,2
14019_1,,,,2,2,1,3
14020_0,,,,2,2,1,3
14020_1,,,,2,2,1,3
14021_0,,,,2,2,1,3
14021_1,,,,2,2,1,3
14023_0,,,,2,2,1,3
C(C(C(CO)=O)(CO)O)(O)=O,,,4,1,2,0,2
14023_1,,,,2,2,1,3
14024_0,,,,2,2,1,3
14024_1,,,,2,2,1,3
14026_0,,,,2,2,1,3
C(CO)(C(CO)(C(C(C)O)O)O)=O,,,4,1,2,0,2
14026_1,,,,2,2,1,3
14028_0,,,,2,2,1,3
C(C(C(O)=O)(C(CO)O)O)(O)=O,,,4,1,2,0,2
14028_1,,,,2,2,1,3
14030_0,,,,2,2,1,3
C(C(C(CC=O)=O)(C(C)=O)O)(O)=O,,,4,1,2,0,2
14030_1,,,,2,2,1,3
14032_0,,,,2,2,1,3
C(C(C=O)(C(CC(C)=O)=O)O)(O)=O,,,4,1,2,0,2
14032_1,,,,2,2,1,3
14034_0,,,,2,2,1,3
C(C(C=O)(C(CCC=O)=O)O)(O)=O,,,4,1,2,0,2
14034_1,,,,2,2,1,3
14036_0,,,,2,2,1,3
C(C(C=O)(C(C=CCO)=O)O)(O)=O,,,4,1,2,0,2
14036_1,,,,2,2,1,3
14038_0,,,,2,2,1,3
C(C(C(C=CC=O)=O)(CO)O)(O)=O,,,4,1,2,0,2
14038_1,,,,2,2,1,3
14039_0,,,,2,2,1,3
14039_1,,,,2,2,1,3
14041_0,,,,2,2,1,3
C(C(C(C=C)=O)(C(C=O)O)O)(O)=O,,,4,1,2,0,2
14041_1,,,,2,2,1,3
14042_0,,,,2,2,1,3
14042_1,,,,2,2,1,3
14044_0,,,,2,1,1,2
C(C1(CC(C(C1(CO)O)O)O)O)=O,,,4,1,1,0,1
14046_0,,,,2,1,1,2
C(C)(C1(C(C(C(C1)=O)O)O)O)=O,,,4,1,1,0,1
14047_0,,,,2,1,1,2
14049_0,,,,2,1,1,2
C(C1(CC(CC1(C=O)O)O)O)=O,,,4,1,1,0,1
14050_0,,,,2,1,1,2
14051_0,,,,2,1,1,2
14053_0,,,,2,1,1,2
C(C1(CC(CO)(CC1O)O)O)=O,,,4,1,1,0,1
14054_0,,,,2,1,1,2
14055_0,,,,2,1,1,2
14056_0,,,,2,1,1,2
14058_0,,,,2,1,1,2
C(C1(CC(CC1(CO)O)O)O)=O,,,4,1,1,0,1
14060_0,,,,2,1,1,2
C(C1(CC(C(C1(C)O)O)O)O)=O,,,4,1,1,0,1
14062_0,,,,2,1,1,2
C(C1(C(CC(C1)O)O)O)=O,,,4,1,1,0,1
14064_0,,,,2,1,1,2
C1(C(C(CC1)(CO)O)(CC=O)O)=O,,,4,1,1,0,1
14066_0,,,,2,1,1,2
C1(C(C(C(C1)O)(C)O)(CC=O)O)=O,,,4,1,1,0,1
14068_0,,,,2,1,1,2
C(C)(C1(C(CC(C(C1)=O)O)O)O)=O,,,4,1,1,0,1
14070_0,,,,2,1,1,2
C(C1(CC(C(C)=O)(C(C1)O)O)O)=O,,,4,1,1,0,1
14072_0,,,,2,1,1,2
C1(C(C(CC(C1)O)O)(CC=O)O)=O,,,4,1,1,0,1
14074_0,,,,2,1,1,2
C(CC(C1(C(CC(C1)O)O)O)=O)=O,,,4,1,1,0,1
14076_0,,,,2,1,1,2
C(C1(CC(C(C)=O)(CC1O)O)O)=O,,,4,1,1,0,1
14078_0,,,,2,1,1,2
C(C1(C(CC(C(C1)=O)(C)O)O)O)=O,,,4,1,1,0,1
14079_0,,,,2,1,1,2
14081_0,,,,2,1,1,2
C(C1(C(CC(CC(C1)=O)O)O)O)=O,,,4,1,1,0,1
14082_0,,,,2,1,1,2
14083_0,,,,2,1,1,2
14085_0,,,,2,1,1,2
C(C1(C=CC(CO)(CC1O)O)O)=O,,,4,1,1,0,1
14087_0,,,,2,1,1,2
C(C1(CC(CO)(C(C1O)O)O)O)=O,,,4,1,1,0,1
14089_0,,,,2,1,1,2
C(C1(C(CC(C1)O)O)O)(O)=O,,,4,1,1,0,1
14091_0,,,,2,1,1,2
C(C)(C1(C(C(CO1)O)O)O)=O,,,4,1,3,0,3
14093_0,,,,2,1,1,2
C(C1(C(C)(C(CO1)O)O)O)=O,,,4,1,1,0,1
14095_0,,,,2,1,1,2
C(C1(C(CO)(CCO1)O)O)=O,,,4,1,1,0,1
14097_0,,,,2,1,1,2
C(C1(C(COC(C1)O)O)O)=O,,,4,1,2,0,2
14098_0,,,,2,1,1,2
14099_0,,,,2,1,1,2
14101_0,,,,2,1,1,2
C1(C(CC(C1(C)O)O)=O)=O,,,4,1,2,0,2
14102_0,,,,2,1,1,2
14103_0,,,,2,1,1,2
14104_0,,,,2,1,1,2
14106_0,,,,2,1,1,2
C(C1(C(C(CO)(C(C1)O)O)O)O)=O,,,4,1,1,0,1
14108_0,,,,2,1,1,2
C1(C(C(CO)(C(C1(C)O)O)O)O)=O,,,4,1,1,0,1
14109_0,,,,2,1,1,2
14110_0,,,,2,1,1,2
14111_0,,,,2,1,1,2
14112_0,,,,2,1,1,2
14113_0,,,,2,1,1,2
14115_0,,,,2,1,1,2
C1(C2(C(CC(C1)O2)O)O)=O,,,4,1,1,0,1
14117_0,,,,2,2,1,3
C1(C(C(O)=O)(C(C(C1)=O)CO)O)=O,,,4,1,1,0,1
14119_0,,,,2,2,1,3
C(C1(C(CC(C(C1)=O)O)=O)O)(O)=O,,,4,1,1,0,1
14121_0,,,,2,2,1,3
C(C1(CC(C(O)=O)(C(C1)=O)O)O)=O,,,4,1,1,0,1
14123_0,,,,2,2,1,3
C1(CC(C(C=O)C1(C(O)=O)O)O)=O,,,4,1,1,0,1
14125_0,,,,2,2,1,3
C(C1C(C(C(O)=O)(CC1O)O)=O)=O,,,4,1,1,0,1
14127_0,,,,2,2,1,3
C(C(C=O)(CC(C=O)=O)O)(O)=O,,,4,1,1,0,1
14129_0,,,,2,2,1,3
C(C(C(C)=O)(CC(CO)=O)O)(O)=O,,,4,1,1,0,1
14130_0,,,,2,2,1,3
14132_0,,,,2,2,1,3
C(C(CC(C)O)(C(C=O)(C)O)O)=O,,,4,1,1,0,1
14134_0,,,,2,2,1,3
C(C)(C(C(CCO)O)(CC=O)O)=O,,,4,1,1,0,1
14135_0,,,,2,2,1,3
14137_0,,,,2,2,1,3
C(C(C(C)=O)(CC=O)O)(O)=O,,,4,1,1,0,1
14139_0,,,,2,2,1,3
C(C(C(C(C)=O)(CC=O)O)O)(O)=O,,,4,1,2,0,2
14141_0,,,,2,2,1,3
C(C(C)(C(C)(C(CC=O)O)O)O)=O,,,4,1,1,0,1
14143_0,,,,2,2,1,3
C(C(C)(C(CC(C(C)=O)O)O)O)=O,,,4,1,1,0,1
14145_0,,,,2,2,1,3
C(C)(C(C(C(C)O)O)(CC=O)O)=O,,,4,1,1,0,1
14146_0,,,,2,2,1,3
14148_0,,,,2,2,1,3
C(C(C)(CC(C(C=O)(C)O)O)O)=O,,,4,1,1,0,1
14150_0,,,,2,2,1,3
C(C(C=O)(C(C=O)CO)O)(O)=O,,,4,1,1,0,1
14152_0,,,,2,2,1,3
C(C(C)(C(CCO)O)O)(O)=O,,,4,1,1,0,1
14154_0,,,,2,2,1,3
C(C(CCO)(C(CCO)O)O)(O)=O,,,4,1,1,0,1
14156_0,,,,2,2,1,3
C(C(C(C)(C(CCO)O)O)=O)=O,,,4,1,1,0,1
14158_0,,,,2,2,1,3
C(CO)(C(C)(C(CCO)O)O)=O,,,4,1,1,0,1
14160_0,,,,2,2,1,3
C(C(CCO)(C(CCO)O)O)=O,,,4,1,1,0,1
14162_0,,,,2,2,1,3
C(C(C(CCO)O)(CC(O)=O)O)=O,,,4,1,1,0,1
14164_0,,,,2,2,1,3
C(C(C)(C(CCO)O)O)=O,,,4,1,1,0,1
14166_0,,,,2,2,1,3
C(C(C(CCO)O)(CC=O)O)(O)=O,,,4,1,1,0,1
14168_0,,,,2,2,1,3
C1(C(C(CCO)O)(O)OCC1)=O,,,4,1,1,0,1
14170_0,,,,2,2,1,3
C(CCO)(C(C(O)=O)(CC=O)O)=O,,,4,1,1,0,1
14172_0,,,,2,2,1,3
C(C(C)(C(CO)(CC(C)O)O)O)=O,,,4,1,1,0,1
14174_0,,,,2,2,1,3
C(C(C)(C(C)(C(C(C)O)O)O)O)=O,,,4,1,1,0,1
14176_0,,,,2,2,1,3
C(C(C)(C(CC(CO)(C)O)O)O)=O,,,4,1,1,0,1
14178_0,,,,2,2,1,3
C(C(C=O)(C(C=O)C(C)O)O)(O)=O,,,4,1,1,0,1
14180_0,,,,2,2,1,3
C(C(C=O)(CC(CC=O)O)O)(O)=O,,,4,1,1,0,1
14182_0,,,,2,2,1,3
C(C(C)(C(CC(C)O)O)O)(O)=O,,,4,1,1,0,1
14184_0,,,,2,2,1,3
C(C(C(C)(C(CC(C)O)O)O)=O)=O,,,4,1,1,0,1
14186_0,,,,2,2,1,3
C(CO)(C(C)(C(CC(C)O)O)O)=O,,,4,1,1,0,1
14188_0,,,,2,2,1,3
C(C(CCO)(C(CC(C)O)O)O)=O,,,4,1,1,0,1
14190_0,,,,2,2,1,3
C(C(C)(C(CC(C)O)O)O)=O,,,4,1,1,0,1
14192_0,,,,2,2,1,3
C1(C(C(CC(C)O)O)(O)OCC1)=O,,,4,1,1,0,1
14194_0,,,,2,2,1,3
C(C(C)(C(C(C(C)O)O)O)O)(O)=O,,,4,1,1,0,1
14196_0,,,,2,2,1,3
C(C(C)(C(C(C(C)O)O)O)O)=O,,,4,1,1,0,1
14198_0,,,,2,2,1,3
C(C(C)(C(CC(CO)O)O)O)(O)=O,,,4,1,1,0,1
14200_0,,,,2,2,1,3
C(C(C)(C(CC(CO)O)O)O)=O,,,4,1,1,0,1
14201_0,,,,2,2,1,3
14202_0,,,,2,2,1,3
14203_0,,,,2,2,1,3
14205_0,,,,2,2,1,3
C(C(C)(C(C(CO)=O)(C)O)O)(O)=O,,,4,1,2,0,2
14206_0,,,,2,2,1,3
14207_0,,,,2,2,1,3
14209_0,,,,2,2,1,3
C(C(C)(C(CO)(C(C)O)O)O)(O)=O,,,4,1,1,0,1
14210_0,,,,2,2,1,3
14212_0,,,,2,2,1,3
C(C(C)(C(C(CCO)O)O)O)(O)=O,,,4,1,1,0,1
14214_0,,,,2,2,1,3
C(C(C)(C(C(O)=O)(C)O)O)(O)=O,,,4,1,1,0,1
14216_0,,,,2,2,1,3
C(C(C(O)=O)(C)O)(O)=O,,,4,1,1,0,1
14217_0,,,,2,2,1,3
14219_0,,,,2,2,1,3
C(C(C)(C(C(C(O)=O)O)O)O)(O)=O,,,4,1,1,0,1
14220_0,,,,2,2,1,3
14221_0,,,,2,2,1,3
14223_0,,,,2,2,1,3
C(C(C)(C(CC(C=O)=O)O)O)(O)=O,,,4,1,1,0,1
14225_0,,,,2,2,1,3
C(C(C)(C(C(C)=O)(C)O)O)(O)=O,,,4,1,1,0,1
14227_0,,,,2,2,1,3
C(C(C)(C(C)(CC=O)O)O)(O)=O,,,4,1,1,0,1
14229_0,,,,2,2,1,3
C(C(C)(C(CC(C)=O)O)O)(O)=O,,,4,1,1,0,1
14231_0,,,,2,2,1,3
C(C(C)(C1(COC(C1)O)O)O)(O)=O,,,4,1,1,0,1
14232_0,,,,2,2,1,3
14234_0,,,,2,2,1,3
C(C(C=C)(C(C(O)=O)(C)O)O)=O,,,4,1,1,0,1
14236_0,,,,2,2,1,3
C(C(C)(C(C=C)(CO)O)O)(O)=O,,,4,1,1,0,1
14238_0,,,,2,2,1,3
C(C(C)(C(C=CC=O)O)O)(O)=O,,,4,1,1,0,1
14240_0,,,,2,2,1,3
C(C(C)(C(C(C)O)O)O)(O)=O,,,4,1,1,0,1
14242_0,,,,2,2,1,3
C(C(C)(C1(COCC1O)O)O)(O)=O,,,4,1,1,0,1
14244_0,,,,2,2,1,3
C(C(C)(C1(C(O)OCC1)O)O)(O)=O,,,4,1,1,0,1
14246_0,,,,2,2,1,3
C(C(C(CC=O)O)(CCO)O)(O)=O,,,4,1,1,0,1
14248_0,,,,2,2,1,3
C(C(C(O)=O)(CCO)O)(O)=O,,,4,1,1,0,1
14249_0,,,,2,2,1,3
14251_0,,,,2,2,1,3
C(C(CCO)(C(C(C)O)O)O)(O)=O,,,4,1,1,0,1
14252_0,,,,2,2,1,3
14253_0,,,,2,2,1,3
14255_0,,,,2,2,1,3
C(C(CO)(C(C(C=O)=O)(C)O)O)=O,,,4,1,1,0,1
14257_0,,,,2,2,1,3
C(C(C(C(C=O)=O)(C)O)O)(CO)=O,,,4,1,1,0,1
14258_0,,,,2,2,1,3
14259_0,,,,2,2,1,3
14260_0,,,,2,2,1,3
14261_0,,,,2,2,1,3
14262_0,,,,2,2,1,3
14263_0,,,,2,2,1,3
14265_0,,,,2,2,1,3
C(C(CO)(C1(C(CCO1)=O)O)O)=O,,,4,1,1,0,1
14267_0,,,,2,2,1,3
C(C(C1(C(CCO1)=O)O)O)(CO)=O,,,4,1,1,0,1
14269_0,,,,2,2,1,3
C(C(C(CO)=O)(CC=O)O)(O)=O,,,4,1,1,0,1
14270_0,,,,2,2,1,3
14272_0,,,,2,2,1,3
C(C(C)(C(C(CO)=O)(C)O)O)=O,,,4,1,2,0,2
14274_0,,,,2,2,1,3
C(CC(C(C(C=O)=O)(C)O)O)=O,,,4,1,1,0,1
14276_0,,,,2,2,1,3
C(C(C)(C(C(C=O)=O)(C)O)O)(O)=O,,,4,1,1,0,1
14278_0,,,,2,2,1,3
C(C(C(C=O)=O)(C)O)(O)=O,,,4,1,1,0,1
14280_0,,,,2,2,1,3
C(C(C(C(C=O)=O)(C)O)O)(O)=O,,,4,1,1,0,1
14282_0,,,,2,2,1,3
C(C)(C(C)(C(C(C=O)=O)(C)O)O)=O,,,4,1,1,0,1
14284_0,,,,2,2,1,3
C(CC(C)(C(C(C=O)=O)(C)O)O)=O,,,4,1,1,0,1
14286_0,,,,2,2,1,3
C(C)(CC(C(C(C=O)=O)(C)O)O)=O,,,4,1,1,0,1
14288_0,,,,2,2,1,3
C=CC(C(C(C(C=O)=O)(C)O)O)=O,,,4,1,1,0,1
14290_0,,,,2,2,1,3
C(C(C=C)(C(C(C=O)=O)(C)O)O)=O,,,4,1,1,0,1
14292_0,,,,2,2,1,3
C=CC(CO)(C(C(C=O)=O)(C)O)O,,,4,1,1,0,1
14294_0,,,,2,2,1,3
C(C(C(C(C=O)=O)(C)O)O)=CC=O,,,4,1,1,0,1
14295_0,,,,2,2,1,3
14296_0,,,,2,2,1,3
14298_0,,,,2,2,1,3
C(C(C(C)(C(C(C)O)O)O)=O)=O,,,4,1,1,0,1
14300_0,,,,2,2,1,3
C(CC(C(C(CO)=O)(C)O)O)=O,,,4,1,1,0,1
14301_0,,,,2,2,1,3
14303_0,,,,2,2,1,3
C(C(C(CO)=O)(C)O)(O)=O,,,4,1,1,0,1
14304_0,,,,2,2,1,3
14306_0,,,,2,2,1,3
C(C)(C(C)(C(C(CO)=O)(C)O)O)=O,,,4,1,1,0,1
14308_0,,,,2,2,1,3
C(CC(C)(C(C(CO)=O)(C)O)O)=O,,,4,1,1,0,1
14310_0,,,,2,2,1,3
C(C)(CC(C(C(CO)=O)(C)O)O)=O,,,4,1,1,0,1
14311_0,,,,2,2,1,3
14313_0,,,,2,2,1,3
C(C(C=C)(C(C(CO)=O)(C)O)O)=O,,,4,1,1,0,1
14315_0,,,,2,2,1,3
C(CO)(C(C)(C(C=C)(CO)O)O)=O,,,4,1,1,0,1
14317_0,,,,2,2,1,3
C(CO)(C(C)(C(C=CC=O)O)O)=O,,,4,1,1,0,1
14319_0,,,,2,2,1,3
C(C(C)(C(CO)(C(C)O)O)O)=O,,,4,1,1,0,1
14321_0,,,,2,2,1,3
C(CO)(C(C)(C(C(C)O)O)O)=O,,,4,1,1,0,1
14323_0,,,,2,2,1,3
C(C(C(CC=O)O)(CCO)O)=O,,,4,1,1,0,1
14325_0,,,,2,2,1,3
C(CC(C(C=O)(CC(O)=O)O)O)=O,,,4,1,1,0,1
14327_0,,,,2,2,1,3
C(C(C)(C(CC=O)O)O)=O,,,4,1,1,0,1
14329_0,,,,2,2,1,3
C(C(C(CC=O)O)(CC=O)O)(O)=O,,,4,1,1,0,1
14331_0,,,,2,2,1,3
C(CC(C1(C(CCO1)=O)O)O)=O,,,4,1,1,0,1
14332_0,,,,2,2,1,3
14333_0,,,,2,2,1,3
14335_0,,,,2,2,1,3
C(C(C)(C(C=O)(CCO)O)O)(O)=O,,,4,1,2,0,2
14337_0,,,,2,2,1,3
C(C(C=O)(CCO)O)(O)=O,,,4,1,1,0,1
14338_0,,,,2,2,1,3
14340_0,,,,2,2,1,3
C(C(CCO)(C(C(C)=O)(C)O)O)=O,,,4,1,1,0,1
14342_0,,,,2,2,1,3
C(C(CCO)(C(C)(CC=O)O)O)=O,,,4,1,1,0,1
14344_0,,,,2,2,1,3
C(C(C(CC(C)=O)O)(CCO)O)=O,,,4,1,1,0,1
14345_0,,,,2,2,1,3
14347_0,,,,2,2,1,3
C(C(C=C)(C(C=O)(CCO)O)O)=O,,,4,1,1,0,1
14349_0,,,,2,2,1,3
C(C(CCO)(C(C=C)(CO)O)O)=O,,,4,1,1,0,1
14351_0,,,,2,2,1,3
C(C(CCO)(C(C=CC=O)O)O)=O,,,4,1,1,0,1
14353_0,,,,2,2,1,3
C(C(C)(C(C(CCO)O)O)O)=O,,,4,1,1,0,1
14355_0,,,,2,2,1,3
C(C(CCO)(C(C(C)O)O)O)=O,,,4,1,1,0,1
14357_0,,,,2,2,1,3
C(C(C)(C(C=O)(C)O)O)(O)=O,,,4,1,2,0,2
14359_0,,,,2,2,1,3
C(C(C)(C1(C(CCO1)=O)O)O)(O)=O,,,4,1,1,0,1
14361_0,,,,2,2,1,3
C(C(C(O)=O)(CC(CO)=O)O)(O)=O,,,4,1,1,0,1
14363_0,,,,2,2,1,3
C(C(C=O)(CC(O)=O)O)(O)=O,,,4,1,1,0,1
14365_0,,,,2,2,1,3
C(C(C=O)(CC(C=O)O)O)(O)=O,,,4,1,1,0,1
14367_0,,,,2,2,1,3
C(C(C(C(C=O)O)=O)(C)O)(O)=O,,,4,1,1,0,1
14369_0,,,,2,2,1,3
C(C(C=O)(C)O)(O)=O,,,4,1,1,0,1
14371_0,,,,2,2,1,3
C(C(C=O)(CCC(C=O)=O)O)(O)=O,,,4,1,2,0,2
14373_0,,,,2,2,1,3
C(C(C(CC(C=O)=O)=O)(C)O)(O)=O,,,4,1,1,0,1
14375_0,,,,2,2,1,3
C(C(C(C(C)=O)=O)(CC=O)O)(O)=O,,,4,1,1,0,1
14377_0,,,,2,2,1,3
C(C(C(C(CC=O)=O)=O)(C)O)(O)=O,,,4,1,1,0,1
14379_0,,,,2,2,1,3
C(C(C(C=O)=O)(CC(C)=O)O)(O)=O,,,4,1,1,0,1
14381_0,,,,2,2,1,3
C(C(C(C=O)=O)(CCC=O)O)(O)=O,,,4,1,1,0,1
14383_0,,,,2,2,1,3
C(C(C=CCO)(C(C=O)=O)O)(O)=O,,,4,1,1,0,1
14385_0,,,,2,2,1,3
C(C(C(CO)=O)(C=CC=O)O)(O)=O,,,4,1,1,0,1
14387_0,,,,2,2,1,3
C(C(C(C(C=O)O)=O)(C=C)O)(O)=O,,,4,1,1,0,1
14389_0,,,,2,2,1,3
C(C(C=O)(C=CC(C=O)O)O)(O)=O,,,4,1,1,0,1
14391_0,,,,2,2,1,3
C(C(C(CC=O)=O)(CCO)O)(O)=O,,,4,1,1,0,1
14393_0,,,,2,2,1,3
C(C(C=O)(CC(CCO)=O)O)(O)=O,,,4,1,1,0,1
14395_0,,,,2,2,1,3
C(C(C(O)=O)(CC=O)O)(O)=O,,,4,1,1,0,1
14397_0,,,,2,2,1,3
C1(C(C(O)=O)(CC(C1CO)=O)O)=O,,,4,1,1,0,1
14399_0,,,,2,2,1,3
C(C1(C(CC(C(C)=O)O1)=O)O)(O)=O,,,4,1,1,0,1
14401_0,,,,2,2,1,3
C(C1(C(C)=O)CC(C(O1)O)=O)(O)=O,,,4,1,1,0,1
14403_0,,,,2,2,1,3
C(C1(C(CC(CC=O)O1)=O)O)(O)=O,,,4,1,1,0,1
14405_0,,,,2,2,1,3
C1(CC(OC1(C(O)=O)CC=O)O)=O,,,4,1,1,0,1
14407_0,,,,2,2,1,3
C1(CCOC(CC1(C(O)=O)O)=O)=O,,,4,1,1,0,1
14409_0,,,,2,2,1,3
C(C1(C(COCC(C1)=O)=O)O)(O)=O,,,4,1,1,0,1
14411_0,,,,2,2,1,3
C1(C(C(O)=O)(O)OCCC(C1)=O)=O,,,4,1,1,0,1
14413_0,,,,2,2,1,3
C(C1(C(CCC(CO1)=O)=O)O)(O)=O,,,4,1,1,0,1
14415_0,,,,2,2,1,3
C(C1(C(CCO1)=O)O)(O)=O,,,4,1,1,0,1
14417_0,,,,2,2,1,3
C1(C(COC1(C(O)=O)CC=O)O)=O,,,4,1,1,0,1
14419_0,,,,2,2,1,3
C(C1(C(C=O)=O)CC(CO1)O)(O)=O,,,4,1,1,0,1
14421_0,,,,2,2,1,3
C(C1(C=O)CC(C(C=O)O1)O)(O)=O,,,4,1,1,0,1
14423_0,,,,2,2,1,3
C(C1(C=O)CC(C(C)(O1)O)=O)(O)=O,,,4,1,1,0,1
14425_0,,,,2,2,1,3
C(C1C(C(C(C(O)=O)(C)O1)=O)O)=O,,,4,1,1,0,1
14427_0,,,,2,2,1,3
C(C1(C=O)CC(CC(O1)O)=O)(O)=O,,,4,1,1,0,1
14429_0,,,,2,2,1,3
C(C1(C(C=CC(CO)O1)=O)O)(O)=O,,,4,1,1,0,1
14431_0,,,,2,2,1,3
C(C1(C(C=CC(CO1)O)=O)O)(O)=O,,,4,1,1,0,1
14433_0,,,,2,2,1,3
C(C1(C=O)C=CC(CO)(O1)O)(O)=O,,,4,1,1,0,1
14435_0,,,,2,2,1,3
C(C(C)(C(CO)(CC(O)=O)O)O)=O,,,4,1,1,0,1
14437_0,,,,2,2,1,3
C(C(C)(C(C)(C(C(O)=O)O)O)O)=O,,,4,1,1,0,1
14439_0,,,,2,2,1,3
C(CC(C=O)(C(C(O)=O)O)O)(O)=O,,,4,1,1,0,1
14440_0,,,,2,2,1,3
14442_0,,,,2,2,1,3
C(C(C(C(O)=O)(CC=O)O)O)(O)=O,,,4,1,1,0,1
14444_0,,,,2,2,1,3
C(C(C1(C(CCO1)=O)O)O)(O)=O,,,4,1,1,0,1
14446_0,,,,2,2,1,3
C(C(C)(C(C(C(O)=O)O)O)O)=O,,,4,1,1,0,1
14448_0,,,,2,2,1,3
C(C(C)(C(C(CC(O)=O)O)O)O)=O,,,4,1,1,0,1
14450_0,,,,2,2,1,3
C(C(C(C(C)O)O)(CC(O)=O)O)=O,,,4,1,1,0,1
14452_0,,,,2,2,1,3
C(C(C)(C(C(CC(C)=O)=O)O)O)=O,,,4,1,1,0,1
14454_0,,,,2,2,1,3
C(CC(C=O)(C(C=O)(C)O)O)(C)=O,,,4,1,1,0,1
14456_0,,,,2,2,1,3
C(C(C)(C(C)(CC(C=O)=O)O)O)=O,,,4,1,1,0,1
14457_0,,,,2,2,1,3
14458_0,,,,2,2,1,3
14460_0,,,,2,2,1,3
C(C(C)(C(CC(C=O)=O)O)O)=O,,,4,1,1,0,1
14462_0,,,,2,2,1,3
C(C(C)(C(CC(C(C)=O)=O)O)O)=O,,,4,1,1,0,1
14464_0,,,,2,2,1,3
C(CC(C(C)=O)(C(C=O)(C)O)O)=O,,,4,1,2,0,2
14466_0,,,,2,2,1,3
C(CC(C(C)(C(C=O)(C)O)O)=O)=O,,,4,1,1,0,1
14468_0,,,,2,2,1,3
C(C(C)(C(C(C)=O)(C)O)O)=O,,,4,1,1,0,1
14470_0,,,,2,2,1,3
C(C)(C(C)(C1(C(CCO1)=O)O)O)=O,,,4,1,1,0,1
14472_0,,,,2,2,1,3
C(C(C)(C(C)(CC=O)O)O)=O,,,4,1,1,0,1
14474_0,,,,2,2,1,3
C(C(C)(C(CC(C)=O)O)O)=O,,,4,1,1,0,1
14476_0,,,,2,2,1,3
C(CC(C)(C1(C(CCO1)=O)O)O)=O,,,4,1,1,0,1
14478_0,,,,2,2,1,3
C1(C(C(CC(C)=O)O)(O)OCC1)=O,,,4,1,1,0,1
14480_0,,,,2,2,1,3
C(C(C)(C1(COC(C1)O)O)O)=O,,,4,1,1,0,1
14482_0,,,,2,2,1,3
C(C(C)(C(C=CC(CO)=O)O)O)=O,,,4,1,1,0,1
14484_0,,,,2,2,1,3
C(C(C)(C(C=CC=O)(CO)O)O)=O,,,4,1,1,0,1
14485_0,,,,2,2,1,3
14487_0,,,,2,2,1,3
C(C(C=C)(C(C=O)(C)O)O)=O,,,4,1,1,0,1
14489_0,,,,2,2,1,3
C1(C(C(C(C=C)=O)O)(O)OCC1)=O,,,4,1,1,0,1
14491_0,,,,2,2,1,3
C(C(C=C)(C1(C(CCO1)=O)O)O)=O,,,4,1,1,0,1
14493_0,,,,2,2,1,3
C(C(C)(C(C=C)(CO)O)O)=O,,,4,1,1,0,1
14495_0,,,,2,2,1,3
C1(C(C(C=C)(CO)O)(O)OCC1)=O,,,4,1,1,0,1
14497_0,,,,2,2,1,3
C(C(C)(C(C=CC=O)O)O)=O,,,4,1,1,0,1
14499_0,,,,2,2,1,3
C1(C(C(C=CC=O)O)(O)OCC1)=O,,,4,1,1,0,1
14501_0,,,,2,2,1,3
C(C(C)(C(C(C)O)O)O)=O,,,4,1,1,0,1
14503_0,,,,2,2,1,3
C(C(CCO)(C(C=O)(C)O)O)(O)=O,,,4,1,2,0,2
14505_0,,,,2,2,1,3
C(C(C(C(C)O)O)(CC=O)O)(O)=O,,,4,1,1,0,1
14507_0,,,,2,2,1,3
C(C(C)(C(CC(C(O)=O)O)O)O)=O,,,4,1,1,0,1
14509_0,,,,2,2,1,3
C(C(C)(C(C(CO)(CO)O)O)O)=O,,,4,1,1,0,1
14511_0,,,,2,2,1,3
C(C(CO)(C(C(C=O)(C)O)O)O)=O,,,4,1,1,0,1
14513_0,,,,2,2,1,3
C(C(C)(C1(COCC1O)O)O)=O,,,4,1,1,0,1
14515_0,,,,2,2,1,3
C1(C(C(C(C)O)O)(O)OCC1)=O,,,4,1,1,0,1
14517_0,,,,2,2,1,3
C(C(C)(C1(C(O)OCC1)O)O)=O,,,4,1,1,0,1
14518_0,,,,2,2,1,3
14520_0,,,,2,2,1,3
C(C)(C(C(CO)O)(CC=O)O)=O,,,4,1,1,0,1
14521_0,,,,2,2,1,3
14523_0,,,,2,2,1,3
C(C(C)(C(CO)O)O)(O)=O,,,4,1,1,0,1
14524_0,,,,2,2,1,3
14526_0,,,,2,2,1,3
C(CO)(C(C(CO)O)(CC=O)O)=O,,,4,1,1,0,1
14527_0,,,,2,2,1,3
14528_0,,,,2,2,1,3
14529_0,,,,2,2,1,3
14530_0,,,,2,2,1,3
14531_0,,,,2,2,1,3
14533_0,,,,2,2,1,3
C(C(C(C(C)(C(CO)O)O)=O)O)=O,,,4,1,1,0,1
14534_0,,,,2,2,1,3
14535_0,,,,2,2,1,3
14537_0,,,,2,2,1,3
C1(C(C(CO)O)(O)OCC1)=O,,,4,1,4,0,4
14539_0,,,,2,2,1,3
C(C(C)(C(C(C(CO)O)O)O)O)=O,,,4,1,3,0,3
14541_0,,,,2,2,1,3
C(C(C)(C(CO)(CO)O)O)(O)=O,,,4,1,1,0,1
14543_0,,,,2,2,1,3
C(C(C(C)(C(CO)(CO)O)O)=O)=O,,,4,1,1,0,1
14545_0,,,,2,2,1,3
C(CO)(C(C)(C(CO)(CO)O)O)=O,,,4,1,1,0,1
14546_0,,,,2,2,1,3
14547_0,,,,2,2,1,3
14549_0,,,,2,2,1,3
C1(C(C(CO)(CO)O)(O)OCC1)=O,,,4,1,1,0,1
14550_0,,,,2,2,1,3
14552_0,,,,2,2,1,3
C(C(C(C)(C(C(CO)O)O)O)=O)=O,,,4,1,1,0,1
14554_0,,,,2,2,1,3
C(CO)(C(C)(C(C(CO)O)O)O)=O,,,4,1,1,0,1
14555_0,,,,2,2,1,3
14557_0,,,,2,2,1,3
C(C(C)(C(C(CO)O)O)O)=O,,,4,1,3,0,3
14559_0,,,,2,2,1,3
C1(C(C(C(CO)O)O)(O)OCC1)=O,,,4,1,1,0,1
14560_0,,,,2,2,1,3
14561_0,,,,2,2,1,3
14562_0,,,,2,2,1,3
14563_0,,,,2,2,1,3
14564_0,,,,2,2,1,3
14565_0,,,,2,2,1,3
14567_0,,,,2,2,1,3
C(C(C(C(C=O)=O)(C)O)O)(C)=O,,,4,1,1,0,1
14569_0,,,,2,2,1,3
C(C(C)(C(C(C=O)=O)(C)O)O)=O,,,4,1,1,0,1
14570_0,,,,2,2,1,3
14571_0,,,,2,2,1,3
14572_0,,,,2,2,1,3
14573_0,,,,2,2,1,3
14574_0,,,,2,2,1,3
14575_0,,,,2,2,1,3
14576_0,,,,2,2,1,3
14578_0,,,,2,2,1,3
C(C(C)(C(C=O)(C)O)O)=O,,,4,1,1,0,1
14579_0,,,,2,2,1,3
14580_0,,,,2,2,1,3
14582_0,,,,2,2,1,3
C(C(C1(C(CCO1)=O)O)O)(C)=O,,,4,1,1,0,1
14584_0,,,,2,2,1,3
C(C(C)(C1(C(CCO1)=O)O)O)=O,,,4,1,1,0,1
14586_0,,,,2,2,1,3
C(C(C)(C(CC(CO)=O)O)O)(O)=O,,,4,1,1,0,1
14588_0,,,,2,2,1,3
C(C(C)(C(CO)(CC=O)O)O)(O)=O,,,4,1,1,0,1
14590_0,,,,2,2,1,3
C(C(C)(C(CC(CO)=O)O)O)=O,,,4,1,1,0,1
14591_0,,,,2,2,1,3
14593_0,,,,2,2,1,3
C(C(C)(C(C(C(C)=O)O)O)O)(O)=O,,,4,1,1,0,1
14595_0,,,,2,2,1,3
C(C(C)(C(C)(C(C=O)O)O)O)(O)=O,,,4,1,1,0,1
14597_0,,,,2,2,1,3
C(C(C)(C(C(C(C)=O)O)O)O)=O,,,4,1,1,0,1
14599_0,,,,2,2,1,3
C(C(C)(C(C)(C(C=O)O)O)O)=O,,,4,1,1,0,1
14601_0,,,,2,2,1,3
C(C(C(C=O)(CC(C=O)=O)O)O)=O,,,4,1,1,0,1
14602_0,,,,2,2,1,3
14603_0,,,,2,2,1,3
14604_0,,,,2,2,1,3
14605_0,,,,2,2,1,3
14607_0,,,,2,2,1,3
C(CC(C(CO)=O)(C(C=O)O)O)=O,,,4,1,1,0,1
14608_0,,,,2,2,1,3
14609_0,,,,2,2,1,3
14610_0,,,,2,2,1,3
14611_0,,,,2,2,1,3
14612_0,,,,2,2,1,3
14614_0,,,,2,2,1,3
C(C(C)(C(C=O)O)O)(C(C=O)O)=O,,,4,1,1,0,1
14615_0,,,,2,2,1,3
14616_0,,,,2,2,1,3
14618_0,,,,2,2,1,3
C(C(C1(C(CCO1)=O)O)O)=O,,,4,1,1,0,1
14620_0,,,,2,2,1,3
C(C(C)(C(C)(C(CO)O)O)O)(O)=O,,,4,1,1,0,1
14622_0,,,,2,2,1,3
C(C(C)(C(C)(C(CO)O)O)O)=O,,,4,1,1,0,1
14624_0,,,,2,2,1,3
C(C(C=O)(CC(CO)=O)O)(O)=O,,,4,1,1,0,1
14625_0,,,,2,2,1,3
14626_0,,,,2,2,1,3
14627_0,,,,2,2,1,3
14628_0,,,,2,2,1,3
14629_0,,,,2,2,1,3
14630_0,,,,2,2,1,3
14631_0,,,,2,2,1,3
14632_0,,,,2,2,1,3
14633_0,,,,2,2,1,3
14634_0,,,,2,2,1,3
14635_0,,,,2,2,1,3
14636_0,,,,2,2,1,3
14637_0,,,,2,2,1,3
14638_0,,,,2,2,1,3
14639_0,,,,2,2,1,3
14640_0,,,,2,2,1,3
14641_0,,,,2,2,1,3
14642_0,,,,2,2,1,3
14643_0,,,,2,2,1,3
14644_0,,,,2,2,1,3
14645_0,,,,2,2,1,3
14647_0,,,,2,2,1,3
C(C(CO)(CCO)O)(O)=O,,,4,1,1,0,1
14649_0,,,,2,2,1,3
C(C(CO)(CC(CCO)=O)O)(O)=O,,,4,1,1,0,1
14651_0,,,,2,2,1,3
C(C(CO)(CCC(CO)=O)O)(O)=O,,,4,1,2,0,2
14653_0,,,,2,2,1,3
C(C(CO)(CC(C(C)=O)O)O)(O)=O,,,4,1,1,0,1
14654_0,,,,2,2,1,3
14656_0,,,,2,2,1,3
C(C(CO)(CC(CC=O)O)O)(O)=O,,,4,1,1,0,1
14657_0,,,,2,2,1,3
14659_0,,,,2,2,1,3
C(C(C=CC(CO)O)(CO)O)(O)=O,,,4,1,1,0,1
14661_0,,,,2,2,1,3
C(CC(C(C=O)=O)(CO)O)(CO)=O,,,4,1,1,0,1
14662_0,,,,2,2,1,3
14663_0,,,,2,2,1,3
14664_0,,,,2,2,1,3
14665_0,,,,2,2,1,3
14666_0,,,,2,2,1,3
14667_0,,,,2,2,1,3
14668_0,,,,2,2,1,3
14670_0,,,,2,2,1,3
C(C(CO)(OC(C(C)=O)CO)O)=O,,,4,1,1,0,1
14671_0,,,,2,2,1,3
14673_0,,,,2,2,1,3
C(C(CO)(O)OCC(C(C)=O)O)=O,,,4,1,1,0,1
14675_0,,,,2,2,1,3
C(C(CO)(O)OCCC(CO)=O)=O,,,4,1,1,0,1
14677_0,,,,2,2,1,3
C(C(CO)(CC(OCC=O)O)O)=O,,,4,1,1,0,1
14679_0,,,,2,2,1,3
C1(C(C(C(CO)C1(CO)O)O)O)=O,,,4,1,1,0,1
14680_0,,,,2,2,1,3
14682_0,,,,2,2,1,3
C(C(C(C(CO)(C)O)=O)O)=O,,,4,1,1,0,1
14684_0,,,,2,2,1,3
C(C(CO)(C)O)=O,,,4,1,1,0,1
14685_0,,,,2,2,1,3
14686_0,,,,2,2,1,3
14687_0,,,,2,2,1,3
14688_0,,,,2,2,1,3
14689_0,,,,2,2,1,3
14690_0,,,,2,2,1,3
14692_0,,,,2,2,1,3
C(C(CO)(CCC(C=O)=O)O)=O,,,4,1,3,0,3
14694_0,,,,2,2,1,3
C(C(CO)(C)O)(CC(C=O)=O)=O,,,4,1,2,0,2
14696_0,,,,2,2,1,3
C(CC(C(C(C)=O)=O)(CO)O)=O,,,4,1,2,0,2
14698_0,,,,2,2,1,3
C(CC(C(C(CO)(C)O)=O)=O)=O,,,4,1,2,0,2
14700_0,,,,2,2,1,3
C(CC(C(C=O)=O)(CO)O)(C)=O,,,4,1,2,0,2
14702_0,,,,2,2,1,3
C(CCC(C(C=O)=O)(CO)O)=O,,,4,1,2,0,2
14704_0,,,,2,2,1,3
C1(C(CO)(CC(C(CO)O)O1)O)=O,,,4,1,1,0,1
14706_0,,,,2,2,1,3
C1(C(CO)(CC(C(CO)O1)O)O)=O,,,4,1,1,0,1
14708_0,,,,2,2,1,3
C1(C(CO)OC(CC1(CO)O)O)=O,,,4,1,2,0,2
14710_0,,,,2,2,1,3
C1(C(CO)(O)OC(CO)CC1O)=O,,,4,1,1,0,1
14712_0,,,,2,2,1,3
C1(C(O)OC(CO)CC1(CO)O)=O,,,4,1,2,0,2
14714_0,,,,2,2,1,3
C1(C(CO)(CC(C(CO1)O)O)O)=O,,,4,1,1,0,1
14716_0,,,,2,2,1,3
C1(C(COC(CC1(CO)O)O)O)=O,,,4,1,2,0,2
14718_0,,,,2,2,1,3
C1(C(CO)(O)OCC(CC1O)O)=O,,,4,1,1,0,1
14720_0,,,,2,2,1,3
C1(C(O)OCC(CC1(CO)O)O)=O,,,4,1,2,0,2
14722_0,,,,2,2,1,3
C1(COC(C(CC1(CO)O)O)O)=O,,,4,1,2,0,2
14724_0,,,,2,2,1,3
C1(C(C(O)OCCC1(CO)O)O)=O,,,4,1,2,0,2
14726_0,,,,2,2,1,3
C(C(C(C=O)=O)(CO)O)=CCO,,,4,1,2,0,2
14728_0,,,,2,2,1,3
C(CO)(C(C=CC=O)(CO)O)=O,,,4,1,3,0,3
14730_0,,,,2,2,1,3
C(C(C=O)O)(C(C=C)(CO)O)=O,,,4,1,2,0,2
14731_0,,,,2,2,1,3
14732_0,,,,2,2,1,3
14733_0,,,,2,2,1,3
14734_0,,,,2,2,1,3
14735_0,,,,2,2,1,3
14736_0,,,,2,2,1,3
14737_0,,,,2,2,1,3
14738_0,,,,2,2,1,3
14739_0,,,,2,2,1,3
14740_0,,,,2,2,1,3
14741_0,,,,2,2,1,3
14742_0,,,,2,2,1,3
14743_0,,,,2,2,1,3
14745_0,,,,2,2,1,3
C1(CC(C(C)=O)OC1(CO)O)=O,,,4,1,2,0,2
14747_0,,,,2,2,1,3
C(C)(C1(CO)CC(C(O1)O)=O)=O,,,4,1,3,0,3
14749_0,,,,2,2,1,3
C(CC1CC(C(CO)(O)O1)=O)=O,,,4,1,2,0,2
14751_0,,,,2,2,1,3
C1(C(CO)(CC=O)OC(C1)O)=O,,,4,1,3,0,3
14753_0,,,,2,2,1,3
C1(C(CO)(CC(OCC1)=O)O)=O,,,4,1,2,0,2
14755_0,,,,2,2,1,3
C1(COCC(CC1(CO)O)=O)=O,,,4,1,2,0,2
14757_0,,,,2,2,1,3
C1(CCOC(C(C1)=O)(CO)O)=O,,,4,1,2,0,2
14759_0,,,,2,2,1,3
C1(CCC(C(CO)(OC1)O)=O)=O,,,4,1,2,0,2
14761_0,,,,2,2,1,3
C1(C(CO)(O)OCC1)=O,,,4,1,1,0,1
14763_0,,,,2,2,1,3
C1(C(CO)(CC=O)OCC1O)=O,,,4,1,1,0,1
14765_0,,,,2,2,1,3
C(C(C1(CO)CC(CO1)O)=O)=O,,,4,1,1,0,1
14767_0,,,,2,2,1,3
C(C1(CO)CC(C(C=O)O1)O)=O,,,4,1,1,0,1
14769_0,,,,2,2,1,3
C(C1(CO)CC(C(C)(O1)O)=O)=O,,,4,1,3,0,3
14771_0,,,,2,2,1,3
C(C1C(C(C(CO)(C)O1)=O)O)=O,,,4,1,1,0,1
14773_0,,,,2,2,1,3
C(C1(CO)CC(CC(O1)O)=O)=O,,,4,1,3,0,3
14775_0,,,,2,2,1,3
C1(C(CO)(CC(C(CO)O1)=O)O)=O,,,4,1,1,0,1
14777_0,,,,2,2,1,3
C1(C(CO)(CC(C(CO1)O)=O)O)=O,,,4,1,1,0,1
14779_0,,,,2,2,1,3
C1C(CO)OC(C(C=1)=O)(CO)O,,,4,1,2,0,2
14781_0,,,,2,2,1,3
C1C(COC(C(C=1)=O)(CO)O)O,,,4,1,2,0,2
14783_0,,,,2,2,1,3
C(C1(C=CC(CO)(O1)O)CO)=O,,,4,1,2,0,2
14785_0,,,,2,2,1,3
C(C1(CO)CC(C(CO)(O1)O)O)=O,,,4,1,2,0,2
14787_0,,,,2,2,1,3
C(CO)(C1(CO)CC(C(O1)O)O)=O,,,4,1,2,0,2
14789_0,,,,2,2,1,3
C1(C(C(OC1(CO)CCO)O)O)=O,,,4,1,2,0,2
14791_0,,,,2,2,1,3
C1(COC(CO)(CC1(CO)O)O)=O,,,4,1,2,0,2
14793_0,,,,2,2,1,3
C(C1(CO)CC(C(C(O1)O)O)O)=O,,,4,1,2,0,2
14795_0,,,,2,2,1,3
C1(C(C(C(OC1(CO)C)O)O)O)=O,,,4,1,2,0,2
14796_0,,,,2,2,1,3
14797_0,,,,2,2,1,3
14798_0,,,,2,2,1,3
14799_0,,,,2,2,1,3
14801_0,,,,2,2,1,3
C(C(C)(C(CO)(CCO)O)O)(O)=O,,,4,1,1,0,1
14803_0,,,,2,2,1,3
C(C(C)(C(CO)(CCO)O)O)=O,,,4,1,1,0,1
14805_0,,,,2,2,1,3
C(C(C)(C(C(C=O)O)O)O)(O)=O,,,4,1,1,0,1
14807_0,,,,2,2,1,3
C(C(C(C(C(C=O)=O)(C)O)O)O)=O,,,4,1,1,0,1
14808_0,,,,2,2,1,3
14809_0,,,,2,2,1,3
14810_0,,,,2,2,1,3
14812_0,,,,2,2,1,3
C(C(C(C1(C(CCO1)=O)O)O)O)=O,,,4,1,1,0,1
14814_0,,,,2,2,1,3
C(C)(C(C(CO)(C)O)(CC=O)O)=O,,,4,1,1,0,1
14816_0,,,,2,2,1,3
C(C(C)(C(CO)(C)O)O)(O)=O,,,4,1,1,0,1
14818_0,,,,2,2,1,3
C(C(CCO)(C(CO)(C)O)O)(O)=O,,,4,1,1,0,1
14820_0,,,,2,2,1,3
C(C(C(C)(C(CO)(C)O)O)=O)=O,,,4,1,1,0,1
14822_0,,,,2,2,1,3
C(CO)(C(C)(C(CO)(C)O)O)=O,,,4,1,1,0,1
14823_0,,,,2,2,1,3
14824_0,,,,2,2,1,3
14826_0,,,,2,2,1,3
C(C(C)(C(CO)(C)O)O)=O,,,4,1,1,0,1
14827_0,,,,2,2,1,3
14829_0,,,,2,2,1,3
C1(C(C(CO)(C)O)(O)OCC1)=O,,,4,1,1,0,1
14831_0,,,,2,2,1,3
C(C(C(CCO)O)(CC=O)O)=O,,,4,1,1,0,1
14833_0,,,,2,2,1,3
C(C(C(CC(C)O)O)(CC=O)O)=O,,,4,1,1,0,1
14835_0,,,,2,2,1,3
C(C(C)(C(C(CC=O)O)O)O)(O)=O,,,4,1,1,0,1
14837_0,,,,2,2,1,3
C(C(C)(C(CC(C=O)O)O)O)(O)=O,,,4,1,1,0,1
14838_0,,,,2,2,1,3
14839_0,,,,2,2,1,3
14841_0,,,,2,2,1,3
C(CC(C(C=O)(CC=O)O)O)=O,,,4,1,2,0,2
14842_0,,,,2,2,1,3
14844_0,,,,2,2,1,3
C(C(C=O)(CC=O)O)(O)=O,,,4,1,1,0,1
14845_0,,,,2,2,1,3
14847_0,,,,2,2,1,3
C(C)(C(C)(C(C=O)(CC=O)O)O)=O,,,4,1,1,0,1
14849_0,,,,2,2,1,3
C(CC(C)(C(C=O)(CC=O)O)O)=O,,,4,1,1,0,1
14850_0,,,,2,2,1,3
14851_0,,,,2,2,1,3
14853_0,,,,2,2,1,3
C(C(C=C)(C(C=O)(CC=O)O)O)=O,,,4,1,1,0,1
14855_0,,,,2,2,1,3
C(CC(C=O)(C(C=C)(CO)O)O)=O,,,4,1,1,0,1
14857_0,,,,2,2,1,3
C(CC(C=O)(C(C=CC=O)O)O)=O,,,4,1,1,0,1
14858_0,,,,2,2,1,3
14860_0,,,,2,2,1,3
C(C(C)(C(CC(C=O)O)O)O)=O,,,4,1,1,0,1
14862_0,,,,2,2,1,3
C(C(C(C(C)O)O)(CC=O)O)=O,,,4,1,1,0,1
14863_0,,,,2,2,1,3
14865_0,,,,2,2,1,3
C1(C(CO)C(C(C1)=O)(C(C)O)O)=O,,,4,1,1,0,1
14866_0,,,,2,2,1,3
14867_0,,,,2,2,1,3
14868_0,,,,2,2,1,3
14869_0,,,,2,2,1,3
14870_0,,,,2,2,1,3
14871_0,,,,2,2,1,3
14873_0,,,,2,2,1,3
C(C)(C(C(C)O)(CC=O)O)=O,,,4,1,1,0,1
14874_0,,,,2,2,1,3
14875_0,,,,2,2,1,3
14876_0,,,,2,2,1,3
14877_0,,,,2,2,1,3
14879_0,,,,2,2,1,3
C(C(C)(C(C)O)O)(O)=O,,,4,1,1,0,1
14881_0,,,,2,2,1,3
C(C(C(C)O)(CCO)O)(O)=O,,,4,1,1,0,1
14883_0,,,,2,2,1,3
C(CO)(C(C(C)O)(CC=O)O)=O,,,4,1,1,0,1
14885_0,,,,2,2,1,3
C(C(C(C)(C(C)O)O)=O)=O,,,4,1,1,0,1
14887_0,,,,2,2,1,3
C(CO)(C(C)(C(C)O)O)=O,,,4,1,1,0,1
14888_0,,,,2,2,1,3
14889_0,,,,2,2,1,3
14890_0,,,,2,2,1,3
14891_0,,,,2,2,1,3
14893_0,,,,2,2,1,3
C(C(C(C(C)(C(C)O)O)=O)O)=O,,,4,1,1,0,1
14895_0,,,,2,2,1,3
C(C(C)(C(C)O)O)=O,,,4,1,1,0,1
14897_0,,,,2,2,1,3
C(C(CCC(C=O)=O)(C(C)O)O)=O,,,4,1,2,0,2
14899_0,,,,2,2,1,3
C(C(C)(C(C)O)O)(CC(C=O)=O)=O,,,4,1,1,0,1
14901_0,,,,2,2,1,3
C(CC(C(C(C)=O)=O)(C(C)O)O)=O,,,4,1,1,0,1
14903_0,,,,2,2,1,3
C(CC(C(C(C)(C(C)O)O)=O)=O)=O,,,4,1,1,0,1
14905_0,,,,2,2,1,3
C(CC(C(C=O)=O)(C(C)O)O)(C)=O,,,4,1,1,0,1
14907_0,,,,2,2,1,3
C(CCC(C(C=O)=O)(C(C)O)O)=O,,,4,1,1,0,1
14909_0,,,,2,2,1,3
C(C(C(C=O)=O)(C(C)O)O)=CCO,,,4,1,1,0,1
14911_0,,,,2,2,1,3
C(CO)(C(C=CC=O)(C(C)O)O)=O,,,4,1,1,0,1
14913_0,,,,2,2,1,3
C(C(C=O)O)(C(C=C)(C(C)O)O)=O,,,4,1,1,0,1
14914_0,,,,2,2,1,3
14915_0,,,,2,2,1,3
14916_0,,,,2,2,1,3
14917_0,,,,2,2,1,3
14919_0,,,,2,2,1,3
C1(C(C(C)O)(CC(C1CO)=O)O)=O,,,4,1,1,0,1
14921_0,,,,2,2,1,3
C1(CC(C(C)=O)OC1(C(C)O)O)=O,,,4,1,1,0,1
14923_0,,,,2,2,1,3
C(C)(C1(C(C)O)CC(C(O1)O)=O)=O,,,4,1,2,0,2
14925_0,,,,2,2,1,3
C(CC1CC(C(C(C)O)(O)O1)=O)=O,,,4,1,1,0,1
14927_0,,,,2,2,1,3
C1(C(C(C)O)(CC=O)OC(C1)O)=O,,,4,1,2,0,2
14929_0,,,,2,2,1,3
C1(C(C(C)O)(CC(OCC1)=O)O)=O,,,4,1,1,0,1
14931_0,,,,2,2,1,3
C1(COCC(CC1(C(C)O)O)=O)=O,,,4,1,1,0,1
14933_0,,,,2,2,1,3
C1(CCOC(C(C1)=O)(C(C)O)O)=O,,,4,1,1,0,1
14935_0,,,,2,2,1,3
C1(CCC(C(C(C)O)(OC1)O)=O)=O,,,4,1,1,0,1
14937_0,,,,2,2,1,3
C1(C(C(C)O)(O)OCC1)=O,,,4,1,1,0,1
14939_0,,,,2,2,1,3
C1(C(C(C)O)(CC=O)OCC1O)=O,,,4,1,1,0,1
14941_0,,,,2,2,1,3
C(C(C1(C(C)O)CC(CO1)O)=O)=O,,,4,1,1,0,1
14943_0,,,,2,2,1,3
C(C1(C(C)O)CC(C(C=O)O1)O)=O,,,4,1,1,0,1
14945_0,,,,2,2,1,3
C(C1(C(C)O)CC(C(C)(O1)O)=O)=O,,,4,1,2,0,2
14947_0,,,,2,2,1,3
C(C1C(C(C(C)(C(C)O)O1)=O)O)=O,,,4,1,1,0,1
14949_0,,,,2,2,1,3
C(C1(C(C)O)CC(CC(O1)O)=O)=O,,,4,1,2,0,2
14951_0,,,,2,2,1,3
C1C(CO)OC(C(C=1)=O)(C(C)O)O,,,4,1,1,0,1
14953_0,,,,2,2,1,3
C1C(COC(C(C=1)=O)(C(C)O)O)O,,,4,1,1,0,1
14955_0,,,,2,2,1,3
C(C1(C=CC(CO)(O1)O)C(C)O)=O,,,4,1,1,0,1
14956_0,,,,2,2,1,3
14957_0,,,,2,2,1,3
14959_0,,,,2,2,1,3
C(C(CC(C)O)(C(C(O)=O)O)O)=O,,,4,1,1,0,1
14960_0,,,,2,2,1,3
14962_0,,,,2,2,1,3
C(C(C(CC(C(C)=O)O)O)O)(O)=O,,,4,1,1,0,1
14963_0,,,,2,2,1,3
14965_0,,,,2,2,1,3
C(C(C)(CC(C(C(O)=O)O)O)O)=O,,,4,1,1,0,1
14967_0,,,,2,2,1,3
C(C(C(CCO)O)O)(O)=O,,,4,1,1,0,1
14969_0,,,,2,2,1,3
C(C(C(CO)(CC(C)O)O)O)(O)=O,,,4,1,1,0,1
14971_0,,,,2,2,1,3
C(C(C(C)(C(C(C)O)O)O)O)(O)=O,,,4,1,1,0,1
14973_0,,,,2,2,1,3
C(C(C(CC(CO)(C)O)O)O)(O)=O,,,4,1,1,0,1
14975_0,,,,2,2,1,3
C(C(C(CC(C)O)O)O)(O)=O,,,4,1,1,0,1
14977_0,,,,2,2,1,3
C(C(C(C(C(C)O)O)O)O)(O)=O,,,4,1,1,0,1
14978_0,,,,2,2,1,3
14979_0,,,,2,2,1,3
14980_0,,,,2,2,1,3
14981_0,,,,2,2,1,3
14982_0,,,,2,2,1,3
14983_0,,,,2,2,1,3
14984_0,,,,2,2,1,3
14985_0,,,,2,2,1,3
14986_0,,,,2,2,1,3
14988_0,,,,2,2,1,3
C(C(C(CO)(C(C)O)O)O)(O)=O,,,4,1,1,0,1
14989_0,,,,2,2,1,3
14991_0,,,,2,2,1,3
C(C(C(CO)(C(C=O)O)O)O)(O)=O,,,4,1,1,0,1
14992_0,,,,2,2,1,3
14993_0,,,,2,2,1,3
14994_0,,,,2,2,1,3
14995_0,,,,2,2,1,3
14996_0,,,,2,2,1,3
14997_0,,,,2,2,1,3
14998_0,,,,2,2,1,3
14999_0,,,,2,2,1,3
15000_0,,,,2,2,1,3
15002_0,,,,2,2,1,3
C(C(C(C(CC(C)=O)=O)O)O)(O)=O,,,4,1,1,0,1
15004_0,,,,2,2,1,3
C(C(C(C=O)(CC(C)=O)O)O)(O)=O,,,4,1,1,0,1
15005_0,,,,2,2,1,3
15006_0,,,,2,2,1,3
15007_0,,,,2,2,1,3
15008_0,,,,2,2,1,3
15009_0,,,,2,2,1,3
15010_0,,,,2,2,1,3
15012_0,,,,2,2,1,3
C(C(C)(C(C(O)=O)O)O)(CC=O)=O,,,4,1,1,0,1
15014_0,,,,2,2,1,3
C(C)(C(C)(C(C(O)=O)O)O)=O,,,4,1,2,0,2
15015_0,,,,2,2,1,3
15016_0,,,,2,2,1,3
15018_0,,,,2,2,1,3
C(C(C1(COC(C1)O)O)O)(O)=O,,,4,1,2,0,2
15020_0,,,,2,2,1,3
C(C(C(C=CC(CO)=O)O)O)(O)=O,,,4,1,1,0,1
15022_0,,,,2,2,1,3
C(C(C(C=CC=O)(CO)O)O)(O)=O,,,4,1,1,0,1
15023_0,,,,2,2,1,3
15025_0,,,,2,2,1,3
C(C(C=C)(C(C(O)=O)O)O)=O,,,4,1,2,0,2
15027_0,,,,2,2,1,3
C(C(C(C=C)(CO)O)O)(O)=O,,,4,1,2,0,2
15028_0,,,,2,2,1,3
15030_0,,,,2,2,1,3
C(C(C(C(C)O)O)O)(O)=O,,,4,1,1,0,1
15031_0,,,,2,2,1,3
15032_0,,,,2,2,1,3
15034_0,,,,2,2,1,3
C(C(C(C(CO)(CO)O)O)O)(O)=O,,,4,1,1,0,1
15035_0,,,,2,2,1,3
15037_0,,,,2,2,1,3
C(C(C1(COCC1O)O)O)(O)=O,,,4,1,1,0,1
15039_0,,,,2,2,1,3
C(C(C1(C(O)OCC1)O)O)(O)=O,,,4,1,2,0,2
15041_0,,,,2,2,1,3
C(C(C(C)=O)(CC(C=O)=O)O)(O)=O,,,4,1,1,0,1
15043_0,,,,2,2,1,3
C(C(C(CC=O)=O)(CC=O)O)(O)=O,,,4,1,1,0,1
15045_0,,,,2,2,1,3
C(C(C=O)(CC(C(C)=O)=O)O)(O)=O,,,4,1,1,0,1
15047_0,,,,2,2,1,3
C(C(C=O)(CC(CC=O)=O)O)(O)=O,,,4,1,1,0,1
15049_0,,,,2,2,1,3
C(C(C=O)(C=CC(CO)=O)O)(O)=O,,,4,1,1,0,1
15050_0,,,,2,1,1,2
15051_0,,,,2,1,1,2
15051_1,,,,2,1,1,2
15052_0,,,,2,1,1,2
15052_1,,,,2,1,1,2
15053_0,,,,2,1,2,3
15053_1,,,,2,1,2,3
15054_0,,,,2,1,2,3
15054_1,,,,2,1,2,3
15055_0,,,,2,1,2,3
15055_1,,,,2,1,2,3
15056_0,,,,2,1,2,3
15056_1,,,,2,1,2,3
15057_0,,,,2,1,2,3
15057_1,,,,2,1,2,3
15058_0,,,,2,1,2,3
15060_0,,,,2,1,1,2
C(CCO)(OC(C=O)C(CO)O)=O,,,4,1,1,0,1
15061_0,,,,2,1,2,3
15063_0,,,,2,1,1,2
C(CCO)(OC(CO)C(C=O)O)=O,,,4,1,1,0,1
15064_0,,,,2,1,2,3
15066_0,,,,2,1,1,2
C(CCO)(OCC(C(C=O)O)O)=O,,,4,1,1,0,1
15067_0,,,,2,1,2,3
15067_1,,,,2,1,2,3
15068_0,,,,2,1,2,3
15068_1,,,,2,1,2,3
15069_0,,,,2,1,2,3
15070_0,,,,2,1,2,3
15071_0,,,,2,1,2,3
15072_0,,,,2,1,2,3
15073_0,,,,2,1,1,2
15074_0,,,,2,1,2,3
15075_0,,,,2,1,2,3
15076_0,,,,2,1,2,3
15077_0,,,,2,1,2,3
15078_0,,,,2,1,2,3
15079_0,,,,2,1,2,3
15080_0,,,,2,1,2,3
15081_0,,,,2,1,2,3
15082_0,,,,2,1,1,2
15083_0,,,,2,1,1,2
15084_0,,,,2,1,1,2
15085_0,,,,2,1,2,3
15086_0,,,,2,1,2,3
15087_0,,,,2,1,2,3
15088_0,,,,2,1,2,3
15089_0,,,,2,1,2,3
15090_0,,,,2,1,2,3
15091_0,,,,2,1,2,3
15092_0,,,,2,1,2,3
15093_0,,,,2,1,2,3
15094_0,,,,2,1,2,3
15095_0,,,,2,1,2,3
15096_0,,,,2,1,2,3
15097_0,,,,2,1,2,3
15099_0,,,,2,1,1,2
C(C(C(C)=O)OC(CO)=O)=O,,,4,1,2,0,2
15101_0,,,,2,1,1,2
C(CO)(OC(C=O)CC=O)=O,,,4,1,2,0,2
15103_0,,,,2,1,1,2
C(CO)(OCCC(C=O)=O)=O,,,4,1,2,0,2
15105_0,,,,2,1,1,2
C(CC(COC(CO)=O)=O)=O,,,4,1,2,0,2
15107_0,,,,2,1,1,2
C(C(CCO)(O)OC(CO)=O)=O,,,4,1,1,0,1
15109_0,,,,2,1,1,2
C(CC(CO)(O)OC(CO)=O)=O,,,4,1,1,0,1
15111_0,,,,2,1,1,2
C(C(C(C)(O)OC(CO)=O)O)=O,,,4,1,1,0,1
15113_0,,,,2,1,1,2
C(C(CC(O)OC(CO)=O)O)=O,,,4,1,1,0,1
15114_0,,,,2,1,2,3
15115_0,,,,2,1,2,3
15116_0,,,,2,1,2,3
15117_0,,,,2,1,2,3
15118_0,,,,2,1,2,3
15119_0,,,,2,1,2,3
15120_0,,,,2,1,2,3
15121_0,,,,2,1,2,3
15122_0,,,,2,1,2,3
15123_0,,,,2,1,2,3
15124_0,,,,2,1,2,3
15125_0,,,,2,1,2,3
15126_0,,,,2,1,2,3
15127_0,,,,2,1,2,3
15128_0,,,,2,1,2,3
15129_0,,,,2,1,2,3
15131_0,,,,2,1,2,3
C1(C(C(C(C1C)O)O)=O)=O,,,4,1,1,0,1
15132_0,,,,2,1,2,3
15133_0,,,,2,1,2,3
15135_0,,,,2,1,2,3
C1(C(C)C(C(C1O)=O)O)=O,,,4,1,1,0,1
15136_0,,,,2,1,2,3
15137_0,,,,2,1,2,3
15139_0,,,,2,1,2,3
C1(CCC(C(C1)=O)=O)=O,,,4,1,3,0,3
15141_0,,,,2,1,2,3
C(C1C(C(CC1)=O)=O)=O,,,4,1,2,0,2
15143_0,,,,2,1,2,3
C1(CC(CC(C1)=O)=O)=O,,,4,1,1,0,1
15144_0,,,,2,1,2,3
15146_0,,,,2,1,2,3
C(C1C(CC(C1)=O)=O)=O,,,4,1,4,0,4
15148_0,,,,2,1,2,3
C(C1CC(C(C1)=O)=O)=O,,,4,1,2,0,2
15149_0,,,,2,1,2,3
15151_0,,,,2,1,2,3
C(C1C(CCC1=O)=O)=O,,,4,1,3,0,3
15152_0,,,,2,1,2,3
15154_0,,,,2,1,2,3
C1(CC=CC(C1O)=O)=O,,,4,1,2,0,2
15156_0,,,,2,1,2,3
C1(CC(C=CC1O)=O)=O,,,4,1,2,0,2
15157_0,,,,2,1,2,3
15158_0,,,,2,1,2,3
15159_0,,,,2,1,2,3
15160_0,,,,2,1,2,3
15161_0,,,,2,1,2,3
15162_0,,,,2,1,2,3
15163_0,,,,2,1,2,3
15164_0,,,,2,1,2,3
15166_0,,,,2,1,2,3
C(C(CO)=O)(C(CO)CO)=O,,,4,1,1,0,1
15167_0,,,,2,1,2,3
15169_0,,,,2,1,2,3
C(C(C(C(CO)=O)=O)C)=O,,,4,1,1,0,1
15171_0,,,,2,1,2,3
C(C(CO)CC(C=O)=O)=O,,,4,1,1,0,1
15173_0,,,,2,1,2,3
C(CO)(CCC(C(CO)=O)=O)=O,,,4,1,1,0,1
15175_0,,,,2,1,2,3
C(CC(CO)=O)(CC(CO)=O)=O,,,4,1,1,0,1
15176_0,,,,2,1,2,3
15178_0,,,,2,1,2,3
C(CC(C=O)C(C(CO)=O)O)=O,,,4,1,2,0,2
15180_0,,,,2,1,2,3
C(C(CO)C(C=O)C(CO)=O)=O,,,4,1,1,0,1
15181_0,,,,2,1,2,3
15182_0,,,,2,1,2,3
15183_0,,,,2,1,2,3
15185_0,,,,2,1,2,3
C(C(C(C)=O)O)(CC(CO)=O)=O,,,4,1,1,0,1
15187_0,,,,2,1,2,3
C(C(C(CO)=O)O)(CC(C)=O)=O,,,4,1,1,0,1
15188_0,,,,2,1,2,3
15190_0,,,,2,1,2,3
C(C(C(C(C(CO)=O)=O)C)O)=O,,,4,1,1,0,1
15192_0,,,,2,1,2,3
C(C(C(C(C=O)=O)C)O)(CO)=O,,,4,1,1,0,1
15193_0,,,,2,1,2,3
15194_0,,,,2,1,2,3
15195_0,,,,2,1,2,3
15197_0,,,,2,1,2,3
C(C(CO)=O)(C(C)C(CO)O)=O,,,4,1,1,0,1
15199_0,,,,2,1,2,3
C(CO)(C(C)C(C(CO)=O)O)=O,,,4,1,1,0,1
15200_0,,,,2,1,2,3
15201_0,,,,2,1,2,3
15202_0,,,,2,1,2,3
15203_0,,,,2,1,2,3
15204_0,,,,2,1,2,3
15205_0,,,,2,1,2,3
15206_0,,,,2,1,2,3
15208_0,,,,2,1,2,3
C(C(C(C(CO)=O)=O)CCO)=O,,,4,1,1,0,1
15210_0,,,,2,1,2,3
C(C(CO)C(C(C=O)=O)CO)=O,,,4,1,1,0,1
15212_0,,,,2,1,2,3
C(C(CO)=O)(C(CO)CCO)=O,,,4,1,1,0,1
15214_0,,,,2,1,2,3
C(C(CCO)C(C(CO)=O)O)=O,,,4,1,1,0,1
15215_0,,,,2,1,2,3
15216_0,,,,2,1,2,3
15218_0,,,,2,1,2,3
C(C(CO)C(C(CO)=O)CO)=O,,,4,1,1,0,1
15219_0,,,,2,1,2,3
15220_0,,,,2,1,2,3
15221_0,,,,2,1,2,3
15222_0,,,,2,1,2,3
15224_0,,,,2,1,2,3
C(C(CO)=O)(C(CO)C)=O,,,4,1,1,0,1
15226_0,,,,2,1,2,3
C(C(C)C(C(CO)=O)O)=O,,,4,1,1,0,1
15228_0,,,,2,1,2,3
C(C(CO)CC(CO)=O)=O,,,4,1,2,0,2
15229_0,,,,2,1,2,3
15231_0,,,,2,1,2,3
C(C(C)=O)(C(CO)CO)=O,,,4,1,1,0,1
15232_0,,,,2,1,2,3
15234_0,,,,2,1,2,3
C(CC(C(CC(CO)=O)=O)O)=O,,,4,1,1,0,1
15236_0,,,,2,1,2,3
C(CCC(C(C(CO)=O)O)=O)=O,,,4,1,1,0,1
15237_0,,,,2,1,2,3
15239_0,,,,2,1,2,3
C(C(CCC(C(CO)=O)=O)O)=O,,,4,1,1,0,1
15241_0,,,,2,1,2,3
C(C(CC(CC(CO)=O)=O)O)=O,,,4,1,3,0,3
15243_0,,,,2,1,2,3
C(C(C(C=O)C(C=O)CO)O)=O,,,4,1,1,0,1
15245_0,,,,2,1,2,3
C(C(CO)=O)(CC)=O,,,4,1,1,0,1
15246_0,,,,2,1,2,3
15248_0,,,,2,1,2,3
C(C(CO)CC=O)=O,,,4,1,2,0,2
15250_0,,,,2,1,2,3
C(CCO)(C(C=O)C(CO)=O)=O,,,4,1,2,0,2
15252_0,,,,2,1,2,3
C(C(C(CO)=O)CC(CO)=O)=O,,,4,1,3,0,3
15253_0,,,,2,1,2,3
15254_0,,,,2,1,2,3
15255_0,,,,2,1,2,3
15256_0,,,,2,1,2,3
15257_0,,,,2,1,2,3
15258_0,,,,2,1,2,3
15259_0,,,,2,1,2,3
15260_0,,,,2,1,2,3
15261_0,,,,2,1,2,3
15263_0,,,,2,1,2,3
C(C(C(CCC(CO)=O)=O)O)=O,,,4,1,2,0,2
15264_0,,,,2,1,2,3
15265_0,,,,2,1,2,3
15266_0,,,,2,1,2,3
15267_0,,,,2,1,2,3
15268_0,,,,2,1,2,3
15269_0,,,,2,1,2,3
15270_0,,,,2,1,2,3
15271_0,,,,2,1,2,3
15272_0,,,,2,1,2,3
15273_0,,,,2,1,2,3
15274_0,,,,2,1,2,3
15275_0,,,,2,1,2,3
15276_0,,,,2,1,2,3
15277_0,,,,2,1,2,3
15278_0,,,,2,1,2,3
15279_0,,,,2,1,2,3
15280_0,,,,2,1,2,3
15281_0,,,,2,1,2,3
15282_0,,,,2,1,2,3
15283_0,,,,2,1,2,3
15284_0,,,,2,1,2,3
15285_0,,,,2,1,2,3
15287_0,,,,2,1,2,3
C(CCO)(C(C=O)C(C=O)O)=O,,,4,1,2,0,2
15289_0,,,,2,1,2,3
C(C(C(C=O)CC(CO)=O)O)=O,,,4,1,2,0,2
15290_0,,,,2,1,2,3
15291_0,,,,2,1,2,3
15292_0,,,,2,1,2,3
15293_0,,,,2,1,2,3
15294_0,,,,2,1,2,3
15295_0,,,,2,1,2,3
15297_0,,,,2,1,2,3
C(CC(C=O)CC(C=O)=O)=O,,,4,1,2,0,2
15299_0,,,,2,1,2,3
C(CC=O)(CC(C(C)=O)=O)=O,,,4,1,2,0,2
15301_0,,,,2,1,2,3
C(CC(C(CC(C)=O)=O)=O)=O,,,4,1,1,0,1
15303_0,,,,2,1,2,3
C(C(C(C(CC=O)=O)=O)C)=O,,,4,1,1,0,1
15305_0,,,,2,1,2,3
C(CC(C)=O)(CC(C=O)=O)=O,,,4,1,1,0,1
15307_0,,,,2,1,2,3
C(C(CCC(C(C)=O)=O)=O)=O,,,4,1,2,0,2
15309_0,,,,2,1,2,3
C(C=O)(C(C)CC(C=O)=O)=O,,,4,1,1,0,1
15311_0,,,,2,1,2,3
C(CO)(C(C)CC(C=O)=O)=O,,,4,1,1,0,1
15312_0,,,,2,1,2,3
15313_0,,,,2,1,2,3
15314_0,,,,2,1,2,3
15315_0,,,,2,1,2,3
15316_0,,,,2,1,2,3
15317_0,,,,2,1,2,3
15319_0,,,,2,1,2,3
C(C(CCO)CC(C=O)=O)=O,,,4,1,1,0,1
15321_0,,,,2,1,2,3
C(CCO)(CC(C(C)=O)=O)=O,,,4,1,1,0,1
15323_0,,,,2,1,2,3
C(C)(CC(C(CCO)=O)=O)=O,,,4,1,1,0,1
15325_0,,,,2,1,2,3
C(C(C(C(CCO)=O)=O)C)=O,,,4,1,1,0,1
15326_0,,,,2,1,2,3
15328_0,,,,2,1,2,3
C(C(CCC(C=O)=O)=O)=O,,,4,1,1,0,1
15330_0,,,,2,1,2,3
C(C(C)CC(C=O)=O)=O,,,4,1,1,0,1
15332_0,,,,2,1,2,3
C(C)(CC(C(C)=O)=O)=O,,,4,1,3,0,3
15334_0,,,,2,1,2,3
C(C(C(C(C)=O)=O)C)=O,,,4,1,1,0,1
15336_0,,,,2,1,2,3
C(CCC(CC(C=O)=O)=O)=O,,,4,1,1,0,1
15338_0,,,,2,1,2,3
C(CC(CCC(C=O)=O)=O)=O,,,4,1,2,0,2
15339_0,,,,2,1,2,3
15341_0,,,,2,1,2,3
C(C(C(CCC(C=O)=O)=O)O)=O,,,4,1,2,0,2
15342_0,,,,2,1,2,3
15343_0,,,,2,1,2,3
15345_0,,,,2,1,2,3
C(C(C(CO)O)CC(C=O)=O)=O,,,4,1,1,0,1
15346_0,,,,2,1,2,3
15347_0,,,,2,1,2,3
15348_0,,,,2,1,2,3
15349_0,,,,2,1,2,3
15350_0,,,,2,1,2,3
15351_0,,,,2,1,2,3
15352_0,,,,2,1,2,3
15354_0,,,,2,1,2,3
C(C(C(C(C(CO)O)=O)=O)C)=O,,,4,1,1,0,1
15355_0,,,,2,1,2,3
15356_0,,,,2,1,2,3
15358_0,,,,2,1,2,3
C(CC(C(CC=O)=O)=O)=O,,,4,1,1,0,1
15359_0,,,,2,1,2,3
15360_0,,,,2,1,2,3
15361_0,,,,2,1,2,3
15363_0,,,,2,1,2,3
C(C(C(CC=O)=O)C(CO)=O)=O,,,4,1,1,0,1
15365_0,,,,2,1,2,3
C(C(C(CO)=O)CC(C=O)=O)=O,,,4,1,1,0,1
15366_0,,,,2,1,2,3
15368_0,,,,2,1,2,3
C(CC(CC(C(C=O)O)=O)=O)=O,,,4,1,2,0,2
15370_0,,,,2,1,2,3
C(CC(C(C(CC=O)=O)O)=O)=O,,,4,1,1,0,1
15371_0,,,,2,1,2,3
15373_0,,,,2,1,2,3
C(C(C)C(C=O)C(CO)=O)=O,,,4,1,1,0,1
15375_0,,,,2,1,2,3
C(CC(C(C(C)CO)=O)=O)=O,,,4,1,1,0,1
15377_0,,,,2,1,2,3
C(C(C)C(C(CC=O)=O)O)=O,,,4,1,1,0,1
15378_0,,,,2,1,2,3
15380_0,,,,2,1,2,3
C(CC(C)=O)(CC(CO)=O)=O,,,4,1,1,0,1
15382_0,,,,2,1,2,3
C(CO)(CCC(C(C)=O)=O)=O,,,4,1,1,0,1
15384_0,,,,2,1,2,3
C(CC(C=O)C(C(C)=O)O)=O,,,4,1,2,0,2
15386_0,,,,2,1,2,3
C(CC(C(C(C)=O)=O)CO)=O,,,4,1,2,0,2
15388_0,,,,2,1,2,3
C(CC(C(CC)=O)=O)=O,,,4,1,1,0,1
15389_0,,,,2,1,2,3
15390_0,,,,2,1,2,3
15391_0,,,,2,1,2,3
15392_0,,,,2,1,2,3
15394_0,,,,2,1,2,3
C(C(C)CC(C(C=O)O)=O)=O,,,4,1,1,0,1
15396_0,,,,2,1,2,3
C(CC(C(C=O)=O)C)(CO)=O,,,4,1,1,0,1
15398_0,,,,2,1,2,3
C(C(C(C)=O)O)(CC(C)=O)=O,,,4,1,1,0,1
15399_0,,,,2,1,2,3
15401_0,,,,2,1,2,3
C(C(C(C(C=O)=O)C)O)(C)=O,,,4,1,1,0,1
15403_0,,,,2,1,2,3
C(C(C(C(C(C)=O)=O)C)O)=O,,,4,1,1,0,1
15404_0,,,,2,1,2,3
15406_0,,,,2,1,2,3
C(CCC(C(C)=O)=O)=O,,,4,1,3,0,3
15408_0,,,,2,1,2,3
C(CC(C(C=O)=O)C)=O,,,4,1,1,0,1
15409_0,,,,2,1,2,3
15410_0,,,,2,1,2,3
15411_0,,,,2,1,2,3
15413_0,,,,2,1,2,3
C(CC(C(C(CO)O)=O)=O)=O,,,4,1,1,0,1
15414_0,,,,2,1,2,3
15415_0,,,,2,1,2,3
15416_0,,,,2,1,2,3
15417_0,,,,2,1,2,3
15418_0,,,,2,1,2,3
15419_0,,,,2,1,2,3
15420_0,,,,2,1,2,3
15421_0,,,,2,1,2,3
15422_0,,,,2,1,2,3
15423_0,,,,2,1,2,3
15425_0,,,,2,1,2,3
C(C(C)CC(C(CO)O)=O)=O,,,4,1,1,0,1
15427_0,,,,2,1,2,3
C(CO)(C(C)CC(CO)=O)=O,,,4,1,1,0,1
15428_0,,,,2,1,2,3
15429_0,,,,2,1,2,3
15431_0,,,,2,1,2,3
C(CO)(C(C)C(C(C)=O)O)=O,,,4,1,1,0,1
15432_0,,,,2,1,2,3
15433_0,,,,2,1,2,3
15435_0,,,,2,1,2,3
C(C(C)=O)(C(C)C(CO)O)=O,,,4,1,1,0,1
15436_0,,,,2,1,2,3
15437_0,,,,2,1,2,3
15439_0,,,,2,1,2,3
C(CO)(C(C)CC=O)=O,,,4,1,1,0,1
15440_0,,,,2,1,2,3
15441_0,,,,2,1,2,3
15443_0,,,,2,1,2,3
C(C(CC(C(CC)=O)=O)O)=O,,,4,1,1,0,1
15445_0,,,,2,1,2,3
C(C(CC(CC(C)=O)=O)O)=O,,,4,1,2,0,2
15447_0,,,,2,1,2,3
C(CC(CCC(CO)=O)=O)=O,,,4,1,1,0,1
15449_0,,,,2,1,2,3
C(CCC(CC(CO)=O)=O)=O,,,4,1,1,0,1
15451_0,,,,2,1,2,3
C(C(CC(C=O)CC=O)O)=O,,,4,1,2,0,2
15452_0,,,,2,1,2,3
15453_0,,,,2,1,2,3
15454_0,,,,2,1,2,3
15455_0,,,,2,1,2,3
15456_0,,,,2,1,2,3
15458_0,,,,2,1,2,3
C(C(C(C)=O)=O)(CC(CO)O)=O,,,4,1,1,0,1
15459_0,,,,2,1,2,3
15460_0,,,,2,1,2,3
15461_0,,,,2,1,2,3
15462_0,,,,2,1,2,3
15463_0,,,,2,1,2,3
15464_0,,,,2,1,2,3
15465_0,,,,2,1,2,3
15466_0,,,,2,1,2,3
15468_0,,,,2,1,2,3
C(CC(C(CC(C=O)O)O)=O)=O,,,4,1,1,0,1
15470_0,,,,2,1,2,3
C(C(CC(C(C(C)=O)=O)O)O)=O,,,4,1,1,0,1
15471_0,,,,2,1,2,3
15473_0,,,,2,1,2,3
C(CCO)(C(C(C(C)=O)=O)O)=O,,,4,1,1,0,1
15474_0,,,,2,1,2,3
15476_0,,,,2,1,2,3
C(CO)(CC(C(C(C)=O)=O)O)=O,,,4,1,1,0,1
15477_0,,,,2,1,2,3
15478_0,,,,2,1,2,3
15479_0,,,,2,1,2,3
15480_0,,,,2,1,2,3
15481_0,,,,2,1,2,3
15482_0,,,,2,1,2,3
15483_0,,,,2,1,2,3
15484_0,,,,2,1,2,3
15485_0,,,,2,1,2,3
15486_0,,,,2,1,2,3
15487_0,,,,2,1,2,3
15488_0,,,,2,1,2,3
15489_0,,,,2,1,2,3
15490_0,,,,2,1,2,3
15491_0,,,,2,1,2,3
15492_0,,,,2,1,2,3
15493_0,,,,2,1,2,3
15494_0,,,,2,1,2,3
15495_0,,,,2,1,2,3
15496_0,,,,2,1,2,3
15497_0,,,,2,1,2,3
15498_0,,,,2,1,2,3
15499_0,,,,2,1,2,3
15500_0,,,,2,1,2,3
15501_0,,,,2,1,2,3
15502_0,,,,2,1,2,3
15503_0,,,,2,1,2,3
15504_0,,,,2,1,2,3
15506_0,,,,2,1,2,3
C(CC(CC(CC=O)=O)=O)=O,,,4,1,1,0,1
15507_0,,,,2,1,2,3
15508_0,,,,2,1,2,3
15509_0,,,,2,1,2,3
15510_0,,,,2,1,2,3
15511_0,,,,2,1,2,3
15512_0,,,,2,1,2,3
15513_0,,,,2,1,2,3
15514_0,,,,2,1,2,3
15515_0,,,,2,1,2,3
15516_0,,,,2,1,2,3
15517_0,,,,2,1,2,3
15518_0,,,,2,1,2,3
15519_0,,,,2,1,2,3
15520_0,,,,2,1,2,3
15521_0,,,,2,1,2,3
15522_0,,,,2,1,2,3
15523_0,,,,2,1,2,3
15524_0,,,,2,1,2,3
15525_0,,,,2,1,2,3
15526_0,,,,2,1,2,3
15527_0,,,,2,1,2,3
15528_0,,,,2,1,2,3
15529_0,,,,2,1,2,3
15530_0,,,,2,1,2,3
15531_0,,,,2,1,2,3
15532_0,,,,2,1,2,3
15533_0,,,,2,1,2,3
15534_0,,,,2,1,2,3
15535_0,,,,2,1,2,3
15536_0,,,,2,1,2,3
15537_0,,,,2,1,2,3
15538_0,,,,2,1,2,3
15539_0,,,,2,1,2,3
15540_0,,,,2,1,2,3
15541_0,,,,2,1,2,3
15542_0,,,,2,1,2,3
15543_0,,,,2,1,2,3
15544_0,,,,2,1,2,3
15545_0,,,,2,1,2,3
15546_0,,,,2,1,2,3
15547_0,,,,2,1,2,3
15548_0,,,,2,1,2,3
15549_0,,,,2,1,2,3
15550_0,,,,2,1,2,3
15551_0,,,,2,1,2,3
15553_0,,,,2,1,2,3
C(CC(C=CC(C=O)O)=O)=O,,,4,1,1,0,1
15555_0,,,,2,1,2,3
C(C(C=CC(C(C)=O)=O)O)=O,,,4,1,1,0,1
15556_0,,,,2,1,2,3
15557_0,,,,2,1,2,3
15558_0,,,,2,1,2,3
15560_0,,,,2,1,2,3
C(CC=O)(C(C(C=O)=O)CO)=O,,,4,1,1,0,1
15562_0,,,,2,1,2,3
C(C=O)(C(CO)CC(C=O)=O)=O,,,4,1,1,0,1
15564_0,,,,2,1,2,3
C(C(C)C(C(C=O)=O)CO)=O,,,4,1,1,0,1
15566_0,,,,2,1,2,3
C(C(C(C(C)=O)=O)CCO)=O,,,4,1,1,0,1
15567_0,,,,2,1,2,3
15568_0,,,,2,1,2,3
15569_0,,,,2,1,2,3
15570_0,,,,2,1,2,3
15571_0,,,,2,1,2,3
15572_0,,,,2,1,2,3
15574_0,,,,2,1,2,3
C(C(CCO)=O)(C(C)CO)=O,,,4,1,1,0,1
15576_0,,,,2,1,2,3
C(C(C)C(C(CCO)=O)O)=O,,,4,1,1,0,1
15578_0,,,,2,1,2,3
C(C(C)C(C(CO)=O)CO)=O,,,4,1,1,0,1
15580_0,,,,2,1,2,3
C(C(CCO)CC(CO)=O)=O,,,4,1,2,0,2
15582_0,,,,2,1,2,3
C(C(CCO)C(C(C)=O)O)=O,,,4,1,1,0,1
15584_0,,,,2,1,2,3
C(C(C)=O)(C(CO)CCO)=O,,,4,1,1,0,1
15586_0,,,,2,1,2,3
C(C(CCO)=O)(CC)=O,,,4,1,1,0,1
15588_0,,,,2,1,2,3
C(CCO)(CC(C)=O)=O,,,4,1,1,0,1
15590_0,,,,2,1,2,3
C(C(CCO)CC=O)=O,,,4,1,2,0,2
15591_0,,,,2,1,2,3
15592_0,,,,2,1,2,3
15593_0,,,,2,1,2,3
15595_0,,,,2,1,2,3
C(CCC(C(C(C)=O)O)=O)=O,,,4,1,1,0,1
15596_0,,,,2,1,2,3
15597_0,,,,2,1,2,3
15598_0,,,,2,1,2,3
15599_0,,,,2,1,2,3
15601_0,,,,2,1,2,3
C(C(C)CC=O)(C(C=O)O)=O,,,4,1,1,0,1
15603_0,,,,2,1,2,3
C(C(C(CC=O)=O)C(C=O)O)=O,,,4,1,1,0,1
15605_0,,,,2,1,2,3
C(C(C(C=O)CC(C=O)=O)O)=O,,,4,1,1,0,1
15606_0,,,,2,1,2,3
15607_0,,,,2,1,2,3
15609_0,,,,2,1,2,3
C(C(C)CC(CO)=O)=O,,,4,1,1,0,1
15611_0,,,,2,1,2,3
C(C(C)=O)(C(C)CO)=O,,,4,1,1,0,1
15613_0,,,,2,1,2,3
C(C(C)C(C(C)=O)O)=O,,,4,1,1,0,1
15615_0,,,,2,1,2,3
C(C(CCC(C(C)=O)=O)O)=O,,,4,1,1,0,1
15616_0,,,,2,1,2,3
15618_0,,,,2,1,2,3
C(C(C(C=O)C(C=O)C)O)=O,,,4,1,1,0,1
15619_0,,,,2,1,2,3
15620_0,,,,2,1,2,3
15621_0,,,,2,1,2,3
15622_0,,,,2,1,2,3
15623_0,,,,2,1,2,3
15624_0,,,,2,1,2,3
15626_0,,,,2,1,2,3
C(C(CC(C(C(C)=O)O)=O)O)=O,,,4,1,2,0,2
15627_0,,,,2,1,2,3
15628_0,,,,2,1,2,3
15629_0,,,,2,1,2,3
15631_0,,,,2,1,2,3
C(C(C)=O)(CC)=O,,,4,1,1,0,1
15633_0,,,,2,1,2,3
C(C)(CC(C)=O)=O,,,4,1,1,0,1
15635_0,,,,2,1,2,3
C(C(C)CC=O)=O,,,4,1,1,0,1
15637_0,,,,2,1,2,3
C(C(C(CO)O)CC(CO)=O)=O,,,4,1,2,0,2
15638_0,,,,2,1,2,3
15639_0,,,,2,1,2,3
15640_0,,,,2,1,2,3
15641_0,,,,2,1,2,3
15642_0,,,,2,1,2,3
15643_0,,,,2,1,2,3
15644_0,,,,2,1,2,3
15645_0,,,,2,1,2,3
15647_0,,,,2,1,2,3
C(C(C)C(C(C(CO)O)=O)O)=O,,,4,1,1,0,1
15649_0,,,,2,1,2,3
C(C(C(CO)O)=O)(C(CO)C)=O,,,4,1,1,0,1
15650_0,,,,2,1,2,3
15651_0,,,,2,1,2,3
15652_0,,,,2,1,2,3
15654_0,,,,2,1,2,3
C(C(C(CO)O)CC=O)=O,,,4,1,2,0,2
15656_0,,,,2,1,2,3
C(CO)(C(CO)CC=O)=O,,,4,1,3,0,3
15657_0,,,,2,1,2,3
15658_0,,,,2,1,2,3
15659_0,,,,2,1,2,3
15661_0,,,,2,1,2,3
C(C(C(CO)O)=O)(CC)=O,,,4,1,1,0,1
15662_0,,,,2,1,2,3
15663_0,,,,2,1,2,3
15665_0,,,,2,1,2,3
C(C(CCC(C=O)=O)CC=O)=O,,,4,1,1,0,1
15667_0,,,,2,1,2,3
C(CCC(C=O)=O)(CC(C)=O)=O,,,4,1,1,0,1
15669_0,,,,2,1,2,3
C(C(CCC(C=O)=O)=O)(CC)=O,,,4,1,1,0,1
15671_0,,,,2,1,2,3
C(C(C)CC=O)(CC(C=O)=O)=O,,,4,1,1,0,1
15673_0,,,,2,1,2,3
C(CC(CC(C=O)CC=O)=O)=O,,,4,1,4,0,4
15675_0,,,,2,1,2,3
C(CC(CC(CC(C)=O)=O)=O)=O,,,4,1,2,0,2
15677_0,,,,2,1,2,3
C(CC=O)(CC(C(CC)=O)=O)=O,,,4,1,1,0,1
15679_0,,,,2,1,2,3
C(CC(C(C(C)=O)=O)CC=O)=O,,,4,1,3,0,3
15681_0,,,,2,1,2,3
C(CC(C(C(C)CC=O)=O)=O)=O,,,4,1,1,0,1
15683_0,,,,2,1,2,3
C(CC(C(CC=O)CC=O)=O)=O,,,4,1,4,0,4
15684_0,,,,2,1,2,3
15686_0,,,,2,1,2,3
C(CCC(C(CC(C)=O)=O)=O)=O,,,4,1,1,0,1
15688_0,,,,2,1,2,3
C(CC(C(C=O)=O)CC(C)=O)=O,,,4,1,2,0,2
15690_0,,,,2,1,2,3
C(CC(CC(CCC=O)=O)=O)=O,,,4,1,2,0,2
15692_0,,,,2,1,2,3
C(CCC(C(CCC=O)=O)=O)=O,,,4,1,1,0,1
15694_0,,,,2,1,2,3
C(CCC(C(C=O)=O)CC=O)=O,,,4,1,1,0,1
15696_0,,,,2,1,2,3
C(CC(CCC(C(C)=O)=O)=O)=O,,,4,1,1,0,1
15698_0,,,,2,1,2,3
C(CCC(CC(C(C)=O)=O)=O)=O,,,4,1,1,0,1
15700_0,,,,2,1,2,3
C(CC(CCC(CC=O)=O)=O)=O,,,4,1,1,0,1
15701_0,,,,2,1,2,3
15702_0,,,,2,1,2,3
15703_0,,,,2,1,2,3
15704_0,,,,2,1,2,3
15705_0,,,,2,1,2,3
15707_0,,,,2,1,2,3
C(CC=O)(CC(C=CCO)=O)=O,,,4,1,1,0,1
15709_0,,,,2,1,2,3
C(CCC(C(C=CCO)=O)=O)=O,,,4,1,1,0,1
15711_0,,,,2,1,2,3
C(CC(C=CCO)C(C=O)=O)=O,,,4,1,1,0,1
15712_0,,,,2,1,2,3
15713_0,,,,2,1,2,3
15715_0,,,,2,1,2,3
C(CC(C(CO)=O)C=CC=O)=O,,,4,1,1,0,1
15716_0,,,,2,1,2,3
15717_0,,,,2,1,2,3
15718_0,,,,2,1,2,3
15720_0,,,,2,1,2,3
C(CCC(C(C(C=C)=O)O)=O)=O,,,4,1,1,0,1
15721_0,,,,2,1,2,3
15722_0,,,,2,1,2,3
15723_0,,,,2,1,2,3
15724_0,,,,2,1,2,3
15726_0,,,,2,1,2,3
C(C(C=O)O)(C(C=C)CC=O)=O,,,4,1,2,0,2
15728_0,,,,2,1,2,3
C(CC=O)(CC=CC(CO)=O)=O,,,4,1,1,0,1
15730_0,,,,2,1,2,3
C(CCC(C=CC(CO)=O)=O)=O,,,4,1,1,0,1
15732_0,,,,2,1,2,3
C(C(C=CC(C=O)O)CC=O)=O,,,4,1,1,0,1
15734_0,,,,2,1,2,3
C(C(C=CC(CC(C)=O)=O)O)=O,,,4,1,1,0,1
15736_0,,,,2,1,2,3
C(C(C=CC(C(CC)=O)=O)O)=O,,,4,1,1,0,1
15737_0,,,,2,1,2,3
15739_0,,,,2,1,2,3
C(CCC(C(C=CC=O)O)=O)=O,,,4,1,2,0,2
15740_0,,,,2,1,2,3
15741_0,,,,2,1,2,3
15742_0,,,,2,1,2,3
15743_0,,,,2,1,2,3
15744_0,,,,2,1,2,3
15745_0,,,,2,1,2,3
15746_0,,,,2,1,2,3
15747_0,,,,2,1,2,3
15748_0,,,,2,1,2,3
15749_0,,,,2,1,2,3
15750_0,,,,2,1,2,3
15751_0,,,,2,1,2,3
15752_0,,,,2,1,2,3
15753_0,,,,2,1,2,3
15754_0,,,,2,1,2,3
15755_0,,,,2,1,2,3
15757_0,,,,2,1,2,3
C(C(C(C=O)=O)C)=O,,,4,1,1,0,1
15758_0,,,,2,1,2,3
15759_0,,,,2,1,2,3
15761_0,,,,2,1,2,3
C(CC(C(C=O)=O)CO)=O,,,4,1,2,0,2
15763_0,,,,2,1,2,3
C(CC(C=O)C(C=O)O)=O,,,4,1,3,0,3
15765_0,,,,2,1,2,3
C(C(C(C)=O)C(CO)=O)=O,,,4,1,2,0,2
15767_0,,,,2,1,2,3
C(C(C(CO)=O)CC=O)=O,,,4,1,2,0,2
15769_0,,,,2,1,2,3
C(C(C(C(C=O)=O)C)O)=O,,,4,1,1,0,1
15771_0,,,,2,1,2,3
C(C(C(C)C(CO)O)=O)=O,,,4,1,1,0,1
15773_0,,,,2,1,2,3
C(CO)(C(C)C(C=O)O)=O,,,4,1,1,0,1
15774_0,,,,2,1,2,3
15775_0,,,,2,1,2,3
15776_0,,,,2,1,2,3
15778_0,,,,2,1,2,3
C(C(CC(C=O)C(C=O)O)O)=O,,,4,1,1,0,1
15780_0,,,,2,1,2,3
C(C(C(C(CO)=O)C(C)=O)O)=O,,,4,1,2,0,2
15782_0,,,,2,1,2,3
C(CC(C(CO)=O)C(C=O)O)=O,,,4,1,2,0,2
15783_0,,,,2,1,2,3
15784_0,,,,2,1,2,3
15785_0,,,,2,1,2,3
15786_0,,,,2,1,2,3
15788_0,,,,2,1,2,3
C(C(C(C=O)=O)CCO)=O,,,4,1,1,0,1
15789_0,,,,2,1,2,3
15790_0,,,,2,1,2,3
15792_0,,,,2,1,2,3
C(C(C(CO)CCO)=O)=O,,,4,1,1,0,1
15794_0,,,,2,1,2,3
C(C(CCO)C(C=O)O)=O,,,4,1,1,0,1
15796_0,,,,2,1,2,3
C(C)(C(C(CO)=O)CO)=O,,,4,1,3,0,3
15797_0,,,,2,1,2,3
15799_0,,,,2,1,2,3
C(C(C(C(C(C=O)=O)C)O)O)=O,,,4,1,1,0,1
15800_0,,,,2,1,2,3
15801_0,,,,2,1,2,3
15803_0,,,,2,1,2,3
C(C(C)C(C=O)O)(C(C=O)O)=O,,,4,1,1,0,1
15804_0,,,,2,1,2,3
15806_0,,,,2,1,2,3
C(CCC(C(C(C=O)O)O)=O)=O,,,4,1,1,0,1
15807_0,,,,2,1,2,3
15808_0,,,,2,1,2,3
15809_0,,,,2,1,2,3
15810_0,,,,2,1,2,3
15812_0,,,,2,1,2,3
C(C(C(C)CO)=O)=O,,,4,1,1,0,1
15814_0,,,,2,1,2,3
C(C(C)C(C=O)O)=O,,,4,1,1,0,1
15815_0,,,,2,1,2,3
15816_0,,,,2,1,2,3
15817_0,,,,2,1,2,3
15818_0,,,,2,1,2,3
15819_0,,,,2,1,2,3
15820_0,,,,2,1,2,3
15821_0,,,,2,1,2,3
15822_0,,,,2,1,2,3
15823_0,,,,2,1,2,3
15824_0,,,,2,1,2,3
15825_0,,,,2,1,2,3
15827_0,,,,2,1,2,3
C(C(CC)=O)=O,,,4,1,1,0,1
15828_0,,,,2,1,2,3
15829_0,,,,2,1,2,3
15830_0,,,,2,1,2,3
15831_0,,,,2,1,2,3
15832_0,,,,2,1,2,3
15833_0,,,,2,1,2,3
15834_0,,,,2,1,2,3
15835_0,,,,2,1,2,3
15836_0,,,,2,1,2,3
15837_0,,,,2,1,2,3
15838_0,,,,2,1,2,3
15839_0,,,,2,1,2,3
15840_0,,,,2,1,2,3
15841_0,,,,2,1,2,3
15843_0,,,,2,1,2,3
C(CC(CO)O)(CC(CO)=O)=O,,,4,1,1,0,1
15844_0,,,,2,1,2,3
15845_0,,,,2,1,2,3
15846_0,,,,2,1,2,3
15847_0,,,,2,1,2,3
15848_0,,,,2,1,2,3
15850_0,,,,2,1,2,3
C(CC(CO)O)(C(C(C)=O)O)=O,,,4,1,1,0,1
15852_0,,,,2,1,2,3
C(C(C(CO)O)O)(CC(C)=O)=O,,,4,1,1,0,1
15853_0,,,,2,1,2,3
15854_0,,,,2,1,2,3
15855_0,,,,2,1,2,3
15856_0,,,,2,1,2,3
15857_0,,,,2,1,2,3
15858_0,,,,2,1,2,3
15859_0,,,,2,1,2,3
15860_0,,,,2,1,2,3
15861_0,,,,2,1,2,3
15862_0,,,,2,1,2,3
15863_0,,,,2,1,2,3
15864_0,,,,2,1,2,3
15865_0,,,,2,1,2,3
15866_0,,,,2,1,2,3
15867_0,,,,2,1,2,3
15868_0,,,,2,1,2,3
15869_0,,,,2,1,2,3
15870_0,,,,2,1,2,3
15871_0,,,,2,1,2,3
15872_0,,,,2,1,2,3
15874_0,,,,2,1,2,3
C(C(C=O)CC(CO)O)(O)=O,,,4,1,1,0,1
15875_0,,,,2,1,2,3
15876_0,,,,2,1,2,3
15878_0,,,,2,1,2,3
C(C(CCC(CO)O)=O)(O)=O,,,4,1,1,0,1
15879_0,,,,2,1,2,3
15880_0,,,,2,1,2,3
15881_0,,,,2,1,2,3
15882_0,,,,2,1,2,3
15883_0,,,,2,1,2,3
15884_0,,,,2,1,2,3
15885_0,,,,2,1,2,3
15886_0,,,,2,1,2,3
15887_0,,,,2,1,2,3
15888_0,,,,2,1,2,3
15889_0,,,,2,1,2,3
15890_0,,,,2,1,2,3
15891_0,,,,2,1,2,3
15892_0,,,,2,1,2,3
15893_0,,,,2,1,2,3
15894_0,,,,2,1,2,3
15895_0,,,,2,1,2,3
15896_0,,,,2,1,2,3
15897_0,,,,2,1,2,3
15898_0,,,,2,1,2,3
15899_0,,,,2,1,2,3
15900_0,,,,2,1,2,3
15901_0,,,,2,1,2,3
15902_0,,,,2,1,2,3
15903_0,,,,2,1,2,3
15904_0,,,,2,1,2,3
15905_0,,,,2,1,2,3
15906_0,,,,2,1,2,3
15907_0,,,,2,1,2,3
15908_0,,,,2,1,2,3
15909_0,,,,2,1,2,3
15910_0,,,,2,1,2,3
15911_0,,,,2,1,2,3
15912_0,,,,2,1,2,3
15913_0,,,,2,1,2,3
15914_0,,,,2,1,2,3
15915_0,,,,2,1,2,3
15916_0,,,,2,1,2,3
15917_0,,,,2,1,2,3
15918_0,,,,2,1,2,3
15919_0,,,,2,1,2,3
15920_0,,,,2,1,2,3
15922_0,,,,2,1,2,3
C(C(C(C)=O)=O)(CCO)=O,,,4,1,2,0,2
15924_0,,,,2,1,2,3
C(C(C(CCCO)=O)=O)=O,,,4,1,1,0,1
15925_0,,,,2,1,2,3
15926_0,,,,2,1,2,3
15928_0,,,,2,1,2,3
C(C)(C(C(C(C)=O)=O)O)=O,,,4,1,2,0,2
15930_0,,,,2,1,2,3
C(C(C(C(CC)=O)=O)O)=O,,,4,1,1,0,1
15931_0,,,,2,1,2,3
15932_0,,,,2,1,2,3
15933_0,,,,2,1,2,3
15934_0,,,,2,1,2,3
15935_0,,,,2,1,2,3
15936_0,,,,2,1,2,3
15937_0,,,,2,1,2,3
15938_0,,,,2,1,2,3
15939_0,,,,2,1,2,3
15940_0,,,,2,1,2,3
15941_0,,,,2,1,2,3
15942_0,,,,2,1,2,3
15943_0,,,,2,1,2,3
15944_0,,,,2,1,2,3
15945_0,,,,2,1,2,3
15946_0,,,,2,1,2,3
15947_0,,,,2,1,2,3
15948_0,,,,2,1,2,3
15949_0,,,,2,1,2,3
15950_0,,,,2,1,2,3
15951_0,,,,2,1,2,3
15952_0,,,,2,1,2,3
15953_0,,,,2,1,2,3
15954_0,,,,2,1,2,3
15955_0,,,,2,1,2,3
15956_0,,,,2,1,2,3
15957_0,,,,2,1,2,3
15958_0,,,,2,1,2,3
15959_0,,,,2,1,2,3
15960_0,,,,2,1,2,3
15961_0,,,,2,1,2,3
15962_0,,,,2,1,2,3
15963_0,,,,2,1,2,3
15964_0,,,,2,1,2,3
15965_0,,,,2,1,2,3
15966_0,,,,2,1,2,3
15967_0,,,,2,1,2,3
15968_0,,,,2,1,2,3
15969_0,,,,2,1,2,3
15970_0,,,,2,1,2,3
15971_0,,,,2,1,2,3
15972_0,,,,2,1,2,3
15973_0,,,,2,1,2,3
15974_0,,,,2,1,2,3
15975_0,,,,2,1,2,3
15977_0,,,,2,1,2,3
C(CCC(C(C=O)O)O)=O,,,4,1,1,0,1
15978_0,,,,2,1,2,3
15979_0,,,,2,1,2,3
15980_0,,,,2,1,2,3
15981_0,,,,2,1,2,3
15982_0,,,,2,1,2,3
15983_0,,,,2,1,2,3
15984_0,,,,2,1,2,3
15985_0,,,,2,1,2,3
15986_0,,,,2,1,2,3
15987_0,,,,2,1,2,3
15988_0,,,,2,1,2,3
15989_0,,,,2,1,2,3
15990_0,,,,2,1,2,3
15991_0,,,,2,1,2,3
15992_0,,,,2,1,2,3
15993_0,,,,2,1,2,3
15994_0,,,,2,1,2,3
15995_0,,,,2,1,2,3
15996_0,,,,2,1,2,3
15997_0,,,,2,1,2,3
15998_0,,,,2,1,2,3
15999_0,,,,2,1,2,3
16000_0,,,,2,1,2,3
16001_0,,,,2,1,2,3
16002_0,,,,2,1,2,3
16003_0,,,,2,1,2,3
16004_0,,,,2,1,2,3
16005_0,,,,2,1,2,3
16006_0,,,,2,1,2,3
16007_0,,,,2,1,2,3
16008_0,,,,2,1,2,3
16009_0,,,,2,1,2,3
16010_0,,,,2,1,2,3
16011_0,,,,2,1,2,3
16012_0,,,,2,1,2,3
16013_0,,,,2,1,2,3
16014_0,,,,2,1,2,3
16015_0,,,,2,1,2,3
16016_0,,,,2,1,2,3
16017_0,,,,2,1,2,3
16018_0,,,,2,1,2,3
16019_0,,,,2,1,2,3
16021_0,,,,2,1,2,3
C(C)(C(C(C=C)=O)O)=O,,,4,1,2,0,2
16022_0,,,,2,1,2,3
16023_0,,,,2,1,2,3
16024_0,,,,2,1,2,3
16026_0,,,,2,1,2,3
C(C)(C(C=CC=O)O)=O,,,4,1,2,0,2
16027_0,,,,2,1,2,3
16028_0,,,,2,1,2,3
16029_0,,,,2,1,2,3
16030_0,,,,2,1,2,3
16031_0,,,,2,1,2,3
16032_0,,,,2,1,2,3
16033_0,,,,2,1,2,3
16034_0,,,,2,1,2,3
16036_0,,,,2,1,2,3
C(CC1(CC(CO1)O)O)=O,,,4,1,2,0,2
16038_0,,,,2,1,2,3
C(C)(C1(CC(CO1)O)O)=O,,,4,1,2,0,2
16039_0,,,,2,1,2,3
16040_0,,,,2,1,2,3
16041_0,,,,2,1,2,3
16042_0,,,,2,1,2,3
16044_0,,,,2,1,2,3
C(CC1C(CC(O)O1)O)=O,,,4,1,2,0,2
16046_0,,,,2,1,2,3
C(C)(C1C(CC(O1)O)O)=O,,,4,1,2,0,2
16048_0,,,,2,1,2,3
C(C1CC(C(CO1)O)O)=O,,,4,1,1,0,1
16049_0,,,,2,1,2,3
16050_0,,,,2,1,2,3
16051_0,,,,2,1,2,3
16052_0,,,,2,1,2,3
16053_0,,,,2,1,2,3
16054_0,,,,2,1,2,3
16055_0,,,,2,1,2,3
16056_0,,,,2,1,2,3
16057_0,,,,2,1,2,3
16058_0,,,,2,1,2,3
16059_0,,,,2,1,2,3
16060_0,,,,2,1,2,3
16061_0,,,,2,1,2,3
16062_0,,,,2,1,2,3
16063_0,,,,2,1,2,3
16064_0,,,,2,1,2,3
16065_0,,,,2,1,2,3
16066_0,,,,2,1,2,3
16067_0,,,,2,1,2,3
16068_0,,,,2,1,2,3
16069_0,,,,2,1,2,3
16070_0,,,,2,1,2,3
16071_0,,,,2,1,2,3
16072_0,,,,2,1,2,3
16073_0,,,,2,1,2,3
16074_0,,,,2,1,2,3
16075_0,,,,2,1,2,3
16076_0,,,,2,1,2,3
16077_0,,,,2,1,2,3
16078_0,,,,2,1,2,3
16079_0,,,,2,1,2,3
16080_0,,,,2,1,2,3
16081_0,,,,2,1,2,3
16082_0,,,,2,1,2,3
16083_0,,,,2,1,2,3
16084_0,,,,2,1,2,3
16085_0,,,,2,1,2,3
16086_0,,,,2,1,2,3
16087_0,,,,2,1,2,3
16088_0,,,,2,1,2,3
16089_0,,,,2,1,2,3
16090_0,,,,2,1,2,3
16091_0,,,,2,1,2,3
16092_0,,,,2,1,2,3
16093_0,,,,2,1,2,3
16094_0,,,,2,1,2,3
16095_0,,,,2,1,2,3
16096_0,,,,2,1,2,3
16097_0,,,,2,1,2,3
16098_0,,,,2,1,2,3
16099_0,,,,2,1,2,3
16100_0,,,,2,1,2,3
16101_0,,,,2,1,2,3
16102_0,,,,2,1,2,3
16103_0,,,,2,1,2,3
16104_0,,,,2,1,2,3
16105_0,,,,2,1,2,3
16107_0,,,,2,1,2,3
C1(C=CC(C1CO)=O)=O,,,4,1,2,0,2
16108_0,,,,2,1,2,3
16109_0,,,,2,1,2,3
16110_0,,,,2,1,2,3
16111_0,,,,2,1,2,3
16112_0,,,,2,1,2,3
16113_0,,,,2,1,2,3
16114_0,,,,2,1,2,3
16115_0,,,,2,1,2,3
16116_0,,,,2,1,2,3
16117_0,,,,2,1,2,3
16118_0,,,,2,1,2,3
16120_0,,,,2,1,2,3
C(C1C(CC(C(C1O)O)O)=O)=O,,,4,1,1,0,1
16121_0,,,,2,1,2,3
16122_0,,,,2,1,2,3
16123_0,,,,2,1,2,3
16124_0,,,,2,1,2,3
16125_0,,,,2,1,2,3
16127_0,,,,2,1,2,3
C(C(CO)C(C=O)(C(C)=O)O)=O,,,4,1,1,0,1
16128_0,,,,2,1,2,3
16129_0,,,,2,1,2,3
16131_0,,,,2,1,2,3
C(C(C=O)(C(C=O)CO)O)=O,,,4,1,1,0,1
16132_0,,,,2,1,2,3
16133_0,,,,2,1,2,3
16134_0,,,,2,1,2,3
16135_0,,,,2,1,2,3
16136_0,,,,2,1,2,3
16137_0,,,,2,1,2,3
16138_0,,,,2,1,2,3
16139_0,,,,2,1,2,3
16140_0,,,,2,1,2,3
16141_0,,,,2,1,2,3
16142_0,,,,2,1,2,3
16143_0,,,,2,1,2,3
16145_0,,,,2,1,2,3
C(CC(C=O)C(C=O)(CO)O)=O,,,4,1,2,0,2
16147_0,,,,2,1,2,3
C(CCO)(C(C=O)(C(C)=O)O)=O,,,4,1,1,0,1
16149_0,,,,2,1,2,3
C(C(CO)O)(C(C=O)C(C)=O)=O,,,4,1,1,0,1
16151_0,,,,2,1,2,3
C(C(C(C)=O)(CC(CO)=O)O)=O,,,4,1,2,0,2
16152_0,,,,2,1,2,3
16153_0,,,,2,1,2,3
16154_0,,,,2,1,2,3
16155_0,,,,2,1,2,3
16156_0,,,,2,1,2,3
16157_0,,,,2,1,2,3
16158_0,,,,2,1,2,3
16160_0,,,,2,1,2,3
C(C(CO)(C(C(C=O)=O)C)O)=O,,,4,1,1,0,1
16161_0,,,,2,1,2,3
16162_0,,,,2,1,2,3
16163_0,,,,2,1,2,3
16164_0,,,,2,1,2,3
16165_0,,,,2,1,2,3
16166_0,,,,2,1,2,3
16167_0,,,,2,1,2,3
16168_0,,,,2,1,2,3
16169_0,,,,2,1,2,3
16171_0,,,,2,1,2,3
C(C(CO)(C(C(CO)=O)C)O)=O,,,4,1,1,0,1
16172_0,,,,2,1,2,3
16173_0,,,,2,1,2,3
16174_0,,,,2,1,2,3
16175_0,,,,2,1,2,3
16176_0,,,,2,1,2,3
16177_0,,,,2,1,2,3
16178_0,,,,2,1,2,3
16180_0,,,,2,1,2,3
C(C(CCO)C(C=O)(CO)O)=O,,,4,1,1,0,1
16182_0,,,,2,1,2,3
C(C(C=O)(C(CCO)=O)O)=O,,,4,1,1,0,1
16184_0,,,,2,1,2,3
C(C(C=O)C(C(CO)O)=O)=O,,,4,1,1,0,1
16186_0,,,,2,1,2,3
C(C(C=O)(CC(CO)=O)O)=O,,,4,1,1,0,1
16187_0,,,,2,1,2,3
16188_0,,,,2,1,2,3
16189_0,,,,2,1,2,3
16191_0,,,,2,1,2,3
C(C(C(C(C=O)O)=O)CO)=O,,,4,1,1,0,1
16193_0,,,,2,1,2,3
C(C(C(CC=O)=O)(CO)O)=O,,,4,1,1,0,1
16194_0,,,,2,1,2,3
16195_0,,,,2,1,2,3
16197_0,,,,2,1,2,3
C(C(C)C(C=O)(CO)O)=O,,,4,1,1,0,1
16198_0,,,,2,1,2,3
16199_0,,,,2,1,2,3
16200_0,,,,2,1,2,3
16201_0,,,,2,1,2,3
16202_0,,,,2,1,2,3
16203_0,,,,2,1,2,3
16204_0,,,,2,1,2,3
16205_0,,,,2,1,2,3
16207_0,,,,2,1,2,3
C(C(C(C)=O)C(C(C)=O)=O)=O,,,4,1,1,0,1
16209_0,,,,2,1,2,3
C(C)(C(C(C(C)=O)=O)CO)=O,,,4,1,1,0,1
16210_0,,,,2,1,2,3
16211_0,,,,2,1,2,3
16213_0,,,,2,1,2,3
C(C(C=O)C(C(C)=O)=O)=O,,,4,1,1,0,1
16214_0,,,,2,1,2,3
16215_0,,,,2,1,2,3
16216_0,,,,2,1,2,3
16217_0,,,,2,1,2,3
16218_0,,,,2,1,2,3
16219_0,,,,2,1,2,3
16221_0,,,,2,1,2,3
C(C(C=O)C(CC(CO)=O)=O)=O,,,4,1,1,0,1
16223_0,,,,2,1,2,3
C(C(C=O)(C(C=O)CC=O)O)=O,,,4,1,2,0,2
16225_0,,,,2,1,2,3
C(C(C(C)=O)C(C=O)=O)=O,,,4,1,1,0,1
16227_0,,,,2,1,2,3
C(C(C=O)C(C)=O)=O,,,4,1,2,0,2
16229_0,,,,2,1,2,3
C(C(C=O)(C(CC(C)=O)=O)O)=O,,,4,1,1,0,1
16231_0,,,,2,1,2,3
C(C(C=O)C(C(C(C)=O)O)=O)=O,,,4,1,1,0,1
16233_0,,,,2,1,2,3
C(C(C=O)(CC(C(C)=O)=O)O)=O,,,4,1,1,0,1
16235_0,,,,2,1,2,3
C(C(C=O)(C(C(C=O)=O)C)O)=O,,,4,1,1,0,1
16237_0,,,,2,1,2,3
C(C(C(C(C=O)O)=O)C(C)=O)=O,,,4,1,1,0,1
16239_0,,,,2,1,2,3
C(C(C(CC=O)=O)(C(C)=O)O)=O,,,4,1,1,0,1
16241_0,,,,2,1,2,3
C(C(C(C)=O)(CC(C=O)=O)O)=O,,,4,1,1,0,1
16243_0,,,,2,1,2,3
C(C(C)C(C=O)(C(C)=O)O)=O,,,4,1,1,0,1
16245_0,,,,2,1,2,3
C(C(C(C)=O)C(C)=O)=O,,,4,1,1,0,1
16246_0,,,,2,1,2,3
16248_0,,,,2,1,2,3
C(C(C=O)C(C=O)=O)=O,,,4,1,1,0,1
16249_0,,,,2,1,2,3
16250_0,,,,2,1,2,3
16251_0,,,,2,1,2,3
16252_0,,,,2,1,2,3
16253_0,,,,2,1,2,3
16254_0,,,,2,1,2,3
16255_0,,,,2,1,2,3
16256_0,,,,2,1,2,3
16258_0,,,,2,1,2,3
C(C(C=O)(C(C(CO)=O)C)O)=O,,,4,1,1,0,1
16259_0,,,,2,1,2,3
16260_0,,,,2,1,2,3
16261_0,,,,2,1,2,3
16262_0,,,,2,1,2,3
16263_0,,,,2,1,2,3
16264_0,,,,2,1,2,3
16265_0,,,,2,1,2,3
16267_0,,,,2,1,2,3
C(C(C)C(C(C)=O)(CO)O)=O,,,4,1,1,0,1
16268_0,,,,2,1,2,3
16270_0,,,,2,1,2,3
C(C)(C(C(C)=O)CO)=O,,,4,1,1,0,1
16272_0,,,,2,1,2,3
C(C(C=O)C=O)=O,,,4,1,1,0,1
16273_0,,,,2,1,2,3
16274_0,,,,2,1,2,3
16275_0,,,,2,1,2,3
16276_0,,,,2,1,2,3
16278_0,,,,2,1,2,3
C(C(C=O)C(C(CCO)O)=O)=O,,,4,1,1,0,1
16279_0,,,,2,1,2,3
16280_0,,,,2,1,2,3
16281_0,,,,2,1,2,3
16282_0,,,,2,1,2,3
16283_0,,,,2,1,2,3
16284_0,,,,2,1,2,3
16285_0,,,,2,1,2,3
16286_0,,,,2,1,2,3
16288_0,,,,2,1,2,3
C(C(C(CCO)=O)C(CO)O)=O,,,4,1,1,0,1
16289_0,,,,2,1,2,3
16290_0,,,,2,1,2,3
16291_0,,,,2,1,2,3
16292_0,,,,2,1,2,3
16293_0,,,,2,1,2,3
16294_0,,,,2,1,2,3
16295_0,,,,2,1,2,3
16296_0,,,,2,1,2,3
16297_0,,,,2,1,2,3
16298_0,,,,2,1,2,3
16299_0,,,,2,1,2,3
16300_0,,,,2,1,2,3
16301_0,,,,2,1,2,3
16302_0,,,,2,1,2,3
16304_0,,,,2,1,2,3
C(C(C(CC=O)=O)C(C)=O)=O,,,4,1,1,0,1
16306_0,,,,2,1,2,3
C(C(C=O)C(CC(C)=O)=O)=O,,,4,1,1,0,1
16308_0,,,,2,1,2,3
C(C(C=O)C(CCC=O)=O)=O,,,4,1,1,0,1
16309_0,,,,2,1,2,3
16310_0,,,,2,1,2,3
16312_0,,,,2,1,2,3
C(C1C(COC1C(CO)O)=O)=O,,,4,1,1,0,1
16313_0,,,,2,1,2,3
16314_0,,,,2,1,2,3
16315_0,,,,2,1,2,3
16316_0,,,,2,1,2,3
16317_0,,,,2,1,2,3
16318_0,,,,2,1,2,3
16319_0,,,,2,1,2,3
16320_0,,,,2,1,2,3
16321_0,,,,2,1,2,3
16323_0,,,,2,1,2,3
C1(C(CO)CC(C(CO)O1)=O)=O,,,4,1,1,0,1
16325_0,,,,2,1,2,3
C(C1C(COC(CO)C1O)=O)=O,,,4,1,1,0,1
16326_0,,,,2,1,2,3
16328_0,,,,2,1,2,3
C(C1C(CC(O)OC1CO)=O)=O,,,4,1,1,0,1
16330_0,,,,2,1,2,3
C(C1C(CC(CO)OC1O)=O)=O,,,4,1,1,0,1
16331_0,,,,2,1,2,3
16332_0,,,,2,1,2,3
16333_0,,,,2,1,2,3
16334_0,,,,2,1,2,3
16336_0,,,,2,1,2,3
C1(C(CO)CC(C(CO1)O)=O)=O,,,4,1,1,0,1
16337_0,,,,2,1,2,3
16338_0,,,,2,1,2,3
16340_0,,,,2,1,2,3
C(C1C(COCC(C1O)O)=O)=O,,,4,1,1,0,1
16341_0,,,,2,1,2,3
16342_0,,,,2,1,2,3
16343_0,,,,2,1,2,3
16345_0,,,,2,1,2,3
C(C1C(CC(O)OCC1O)=O)=O,,,4,1,1,0,1
16346_0,,,,2,1,2,3
16348_0,,,,2,1,2,3
C(C1C(CC(COC1O)O)=O)=O,,,4,1,1,0,1
16349_0,,,,2,1,2,3
16351_0,,,,2,1,2,3
C(C1C(CC(C(O)OC1)O)=O)=O,,,4,1,2,0,2
16352_0,,,,2,1,2,3
16353_0,,,,2,1,2,3
16355_0,,,,2,1,2,3
C(C1C(CCOC(C1O)O)=O)=O,,,4,1,1,0,1
16356_0,,,,2,1,2,3
16357_0,,,,2,1,2,3
16358_0,,,,2,1,2,3
16360_0,,,,2,1,2,3
C(C(C=O)C(C=CCO)=O)=O,,,4,1,1,0,1
16361_0,,,,2,1,2,3
16362_0,,,,2,1,2,3
16363_0,,,,2,1,2,3
16365_0,,,,2,1,2,3
C(C(C(C=C)=O)C(C=O)O)=O,,,4,1,1,0,1
16366_0,,,,2,1,2,3
16367_0,,,,2,1,2,3
16368_0,,,,2,1,2,3
16370_0,,,,2,1,2,3
C(C(C=O)C1(CC(CO1)O)O)=O,,,4,1,1,0,1
16371_0,,,,2,1,2,3
16372_0,,,,2,1,2,3
16373_0,,,,2,1,2,3
16374_0,,,,2,1,2,3
16376_0,,,,2,1,2,3
C(C(C=O)C1C(CC(O)O1)O)=O,,,4,1,1,0,1
16377_0,,,,2,1,2,3
16378_0,,,,2,1,2,3
16380_0,,,,2,1,2,3
C(C(C=O)C(C(CCO)=O)=O)=O,,,4,1,1,0,1
16382_0,,,,2,1,2,3
C(C(C=O)(C(C=O)CCO)O)=O,,,4,1,1,0,1
16383_0,,,,2,1,2,3
16384_0,,,,2,1,2,3
16385_0,,,,2,1,2,3
16387_0,,,,2,1,2,3
C(C(C(C(C)=O)C(C)=O)O)=O,,,4,1,1,0,1
16389_0,,,,2,1,2,3
C(C(C=O)(C(CC=O)=O)O)=O,,,4,1,1,0,1
16391_0,,,,2,1,2,3
C(C(C=O)C(C(C=O)O)=O)=O,,,4,1,1,0,1
16393_0,,,,2,1,2,3
C(C(C=O)(CC(C=O)=O)O)=O,,,4,1,1,0,1
16395_0,,,,2,1,2,3
C(C(C=O)(C(C=O)C)O)=O,,,4,1,1,0,1
16397_0,,,,2,1,2,3
C(C(C=O)C(C(CC=O)O)=O)=O,,,4,1,1,0,1
16399_0,,,,2,1,2,3
C(C(C=O)(C(CCC=O)=O)O)=O,,,4,1,1,0,1
16401_0,,,,2,1,2,3
C(C(C=O)(CC(CC=O)=O)O)=O,,,4,1,1,0,1
16403_0,,,,2,1,2,3
C(C(C=O)C(CC(C=O)O)=O)=O,,,4,1,1,0,1
16404_0,,,,2,1,2,3
16406_0,,,,2,1,2,3
C(C(C(C=O)(C(C=O)C)O)O)=O,,,4,1,1,0,1
16407_0,,,,2,1,2,3
16409_0,,,,2,1,2,3
C(C(C)C(C(CO)=O)(CO)O)=O,,,4,1,1,0,1
16410_0,,,,2,1,2,3
16411_0,,,,2,1,2,3
16412_0,,,,2,1,2,3
16413_0,,,,2,1,2,3
16414_0,,,,2,1,2,3
16416_0,,,,2,1,2,3
C(C(C(C)=O)C(CO)O)(O)=O,,,4,1,1,0,1
16417_0,,,,2,1,2,3
16418_0,,,,2,1,2,3
16419_0,,,,2,1,2,3
16421_0,,,,2,1,2,3
C(CC(C(C(C)=O)C(C)=O)=O)=O,,,4,1,1,0,1
16423_0,,,,2,1,2,3
C(C(C(CC(C)=O)=O)C(C)=O)=O,,,4,1,1,0,1
16425_0,,,,2,1,2,3
C(C(C(CCC=O)=O)C(C)=O)=O,,,4,1,1,0,1
16427_0,,,,2,1,2,3
C(C(C(C)=O)C(C=CCO)=O)=O,,,4,1,1,0,1
16429_0,,,,2,1,2,3
C(C)(C(C(C=CC=O)=O)CO)=O,,,4,1,1,0,1
16430_0,,,,2,1,2,3
16431_0,,,,2,1,2,3
16432_0,,,,2,1,2,3
16434_0,,,,2,1,2,3
C(C(C(C(C)=O)C(C=C)=O)O)=O,,,4,1,1,0,1
16435_0,,,,2,1,2,3
16436_0,,,,2,1,2,3
16437_0,,,,2,1,2,3
16438_0,,,,2,1,2,3
16439_0,,,,2,1,2,3
16440_0,,,,2,1,2,3
16441_0,,,,2,1,2,3
16443_0,,,,2,1,2,3
C(C(C(C)=O)(C(C)=O)O)=O,,,4,1,1,0,1
16444_0,,,,2,1,2,3
16446_0,,,,2,1,2,3
C(C(C(C)=O)(CC=O)O)=O,,,4,1,2,0,2
16448_0,,,,2,1,2,3
C(C)(C(C(C)=O)(CO)O)=O,,,4,1,1,0,1
16449_0,,,,2,1,2,3
16450_0,,,,2,1,2,3
16451_0,,,,2,1,2,3
16452_0,,,,2,1,2,3
16453_0,,,,2,1,2,3
16454_0,,,,2,1,2,3
16455_0,,,,2,1,2,3
16457_0,,,,2,1,2,3
C(C(C(C(C)=O)(C(C)=O)O)O)=O,,,4,1,1,0,1
16458_0,,,,2,1,2,3
16459_0,,,,2,1,2,3
16460_0,,,,2,1,2,3
16461_0,,,,2,1,2,3
16462_0,,,,2,1,2,3
16463_0,,,,2,1,2,3
16464_0,,,,2,1,2,3
16465_0,,,,2,1,2,3
16466_0,,,,2,1,2,3
16467_0,,,,2,1,2,3
16468_0,,,,2,1,2,3
16469_0,,,,2,1,2,3
16470_0,,,,2,1,2,3
16471_0,,,,2,1,2,3
16472_0,,,,2,1,2,3
16473_0,,,,2,1,2,3
16474_0,,,,2,1,2,3
16475_0,,,,2,1,2,3
16476_0,,,,2,1,2,3
16477_0,,,,2,1,2,3
16479_0,,,,2,1,2,3
C(C(C)C(C=O)(C(CO)O)O)=O,,,4,1,1,0,1
16480_0,,,,2,1,2,3
16481_0,,,,2,1,2,3
16482_0,,,,2,1,2,3
16483_0,,,,2,1,2,3
16484_0,,,,2,1,2,3
16485_0,,,,2,1,2,3
16486_0,,,,2,1,2,3
16488_0,,,,2,1,2,3
C(C(C(CC=O)=O)C(CO)O)=O,,,4,1,1,0,1
16489_0,,,,2,1,2,3
16490_0,,,,2,1,2,3
16492_0,,,,2,1,2,3
C(C(C=O)C(CC(CO)O)=O)=O,,,4,1,1,0,1
16493_0,,,,2,1,2,3
16494_0,,,,2,1,2,3
16495_0,,,,2,1,2,3
16497_0,,,,2,1,2,3
C(C1(C(CC(C1)O)=O)O)=O,,,4,1,1,0,1
16499_0,,,,2,1,2,3
C(C1C(C(C(C1)O)O)=O)=O,,,4,1,1,0,1
16500_0,,,,2,1,2,3
16501_0,,,,2,1,2,3
16502_0,,,,2,1,2,3
16504_0,,,,2,1,2,3
C1(CC(C(C1(C)O)=O)O)=O,,,4,1,1,0,1
16506_0,,,,2,1,2,3
C1(C(C(C(C1C)=O)O)O)=O,,,4,1,1,0,1
16508_0,,,,2,1,2,3
C1(C(C)(CC(C1O)=O)O)=O,,,4,1,1,0,1
16509_0,,,,2,1,2,3
16510_0,,,,2,1,2,3
16511_0,,,,2,1,2,3
16512_0,,,,2,1,2,3
16513_0,,,,2,1,2,3
16514_0,,,,2,1,2,3
16516_0,,,,2,1,2,3
C(CCO)(C(C=O)(CC=O)O)=O,,,4,1,1,0,1
16518_0,,,,2,1,2,3
C(C(CO)O)(C(C=O)CC=O)=O,,,4,1,2,0,2
16519_0,,,,2,1,2,3
16520_0,,,,2,1,2,3
16521_0,,,,2,1,2,3
16522_0,,,,2,1,2,3
16523_0,,,,2,1,2,3
16524_0,,,,2,1,2,3
16525_0,,,,2,1,2,3
16526_0,,,,2,1,2,3
16527_0,,,,2,1,2,3
16529_0,,,,2,1,2,3
C(C(C(C(C)=O)=O)CC=O)=O,,,4,1,1,0,1
16531_0,,,,2,1,2,3
C(C(C(C(O)=O)=O)C)=O,,,4,1,1,0,1
16533_0,,,,2,1,2,3
C(C(C(C=O)CC=O)O)(O)=O,,,4,1,2,0,2
16535_0,,,,2,1,2,3
C(CC(C(C(O)=O)=O)CO)=O,,,4,1,1,0,1
16537_0,,,,2,1,2,3
C(C(C(C(C=O)=O)C)O)(O)=O,,,4,1,1,0,1
16539_0,,,,2,1,2,3
C(C(C(C(C(O)=O)=O)C)O)=O,,,4,1,1,0,1
16541_0,,,,2,1,2,3
C(C(C(C=O)=O)CC(CO)=O)=O,,,4,1,1,0,1
16543_0,,,,2,1,2,3
C(C(C(C=O)=O)CC=O)=O,,,4,1,1,0,1
16545_0,,,,2,1,2,3
C(CO)(C(C)C(C(O)=O)O)=O,,,4,1,1,0,1
16546_0,,,,2,1,2,3
16547_0,,,,2,1,2,3
16549_0,,,,2,1,2,3
C(C(C(C)C(CO)O)=O)(O)=O,,,4,1,1,0,1
16550_0,,,,2,1,2,3
16552_0,,,,2,1,2,3
C(C(C(C)=O)CC(CO)=O)=O,,,4,1,1,0,1
16554_0,,,,2,1,2,3
C(C(C=O)CC=O)=O,,,4,1,1,0,1
16555_0,,,,2,1,2,3
16556_0,,,,2,1,2,3
16557_0,,,,2,1,2,3
16559_0,,,,2,1,2,3
C(C(C(C=O)=O)CC(CO)O)=O,,,4,1,1,0,1
16560_0,,,,2,1,2,3
16561_0,,,,2,1,2,3
16563_0,,,,2,1,2,3
C(C(C=O)CC(C(CO)=O)O)=O,,,4,1,1,0,1
16565_0,,,,2,1,2,3
C(C(CC(C=O)C(CO)=O)O)=O,,,4,1,1,0,1
16567_0,,,,2,1,2,3
C(C(C(C(C=O)O)=O)CCO)=O,,,4,1,1,0,1
16568_0,,,,2,1,2,3
16570_0,,,,2,1,2,3
C(C(C=O)CC(C(C=O)O)O)=O,,,4,1,1,0,1
16571_0,,,,2,1,2,3
16572_0,,,,2,1,2,3
16574_0,,,,2,1,2,3
C(C(C(C(C(C=O)O)O)=O)C)=O,,,4,1,1,0,1
16575_0,,,,2,1,2,3
16576_0,,,,2,1,2,3
16578_0,,,,2,1,2,3
C(C(C(C)=O)CC(C=O)=O)=O,,,4,1,1,0,1
16580_0,,,,2,1,2,3
C(C(C(CC=O)=O)CC=O)=O,,,4,1,1,0,1
16582_0,,,,2,1,2,3
C(C(C=O)CC(C(C)=O)=O)=O,,,4,1,1,0,1
16584_0,,,,2,1,2,3
C(C(C=O)CC(CC=O)=O)=O,,,4,1,1,0,1
16586_0,,,,2,1,2,3
C(C1C(CC(C(CO)O)O1)=O)=O,,,4,1,1,0,1
16587_0,,,,2,1,2,3
16588_0,,,,2,1,2,3
16590_0,,,,2,1,2,3
C(C1C(CC(C(CO)O1)O)=O)=O,,,4,1,1,0,1
16592_0,,,,2,1,2,3
C(C1C(CC(C(CO1)O)O)=O)=O,,,4,1,1,0,1
16593_0,,,,2,1,2,3
16594_0,,,,2,1,2,3
16596_0,,,,2,1,2,3
C(C(C=O)C=CC(CO)=O)=O,,,4,1,1,0,1
16598_0,,,,2,1,2,3
C(C(C(C(O)=O)=O)CCO)=O,,,4,1,1,0,1
16600_0,,,,2,1,2,3
C(C(CCO)C(C(O)=O)O)=O,,,4,1,1,0,1
16602_0,,,,2,1,2,3
C(C(C(CO)CCO)=O)(O)=O,,,4,1,1,0,1
16604_0,,,,2,1,2,3
C(C(C(CC=O)=O)(CC=O)O)=O,,,4,1,1,0,1
16606_0,,,,2,1,2,3
C(C(C(C(C=O)O)=O)CC=O)=O,,,4,1,1,0,1
16607_0,,,,2,1,2,3
16608_0,,,,2,1,2,3
16609_0,,,,2,1,2,3
16610_0,,,,2,1,2,3
16611_0,,,,2,1,2,3
16613_0,,,,2,1,2,3
C(CC(C=O)(C(C=O)C)O)=O,,,4,1,1,0,1
16615_0,,,,2,1,2,3
C(C(C)C(C(O)=O)O)=O,,,4,1,1,0,1
16617_0,,,,2,1,2,3
C(C(C(C)CO)=O)(O)=O,,,4,1,1,0,1
16619_0,,,,2,1,2,3
C(C(C(C)=O)CC=O)=O,,,4,1,1,0,1
16620_0,,,,2,1,2,3
16621_0,,,,2,1,2,3
16622_0,,,,2,1,2,3
16623_0,,,,2,1,2,3
16624_0,,,,2,1,2,3
16625_0,,,,2,1,2,3
16626_0,,,,2,1,2,3
16628_0,,,,2,1,2,3
C(C(O)=O)(CC)=O,,,4,1,1,0,1
16630_0,,,,2,1,2,3
C(C)(C(C(C)=O)CC(C=O)=O)=O,,,4,1,1,0,1
16632_0,,,,2,1,2,3
C(CC=O)(C(C(C)=O)CC=O)=O,,,4,1,1,0,1
16634_0,,,,2,1,2,3
C(C(C(C)=O)CC(C(C)=O)=O)=O,,,4,1,1,0,1
16636_0,,,,2,1,2,3
C(C(C(C)=O)CC(CC=O)=O)=O,,,4,1,1,0,1
16638_0,,,,2,1,2,3
C(C(C(C)=O)C=CC(CO)=O)=O,,,4,1,1,0,1
16639_0,,,,2,1,2,3
16640_0,,,,2,1,2,3
16641_0,,,,2,1,2,3
16642_0,,,,2,1,2,3
16643_0,,,,2,1,2,3
16644_0,,,,2,1,2,3
16645_0,,,,2,1,2,3
16646_0,,,,2,1,2,3
16647_0,,,,2,1,2,3
16648_0,,,,2,1,2,3
16649_0,,,,2,1,2,3
16650_0,,,,2,1,2,3
16651_0,,,,2,1,2,3
16653_0,,,,2,1,2,3
C(C(C=O)CC(C(CO)O)=O)=O,,,4,1,1,0,1
16654_0,,,,2,1,2,3
16655_0,,,,2,1,2,3
16656_0,,,,2,1,2,3
16657_0,,,,2,1,2,3
16658_0,,,,2,1,2,3
16659_0,,,,2,1,2,3
16660_0,,,,2,1,2,3
16661_0,,,,2,1,2,3
16662_0,,,,2,1,2,3
16663_0,,,,2,1,2,3
16665_0,,,,2,1,2,3
C(C1C(CC(CO)O1)=O)=O,,,4,1,3,0,3
16667_0,,,,2,1,2,3
C1(CC(C=O)OC1CO)=O,,,4,1,3,0,3
16668_0,,,,2,1,2,3
16669_0,,,,2,1,2,3
16671_0,,,,2,1,2,3
C(C1C(CC(CO1)O)=O)=O,,,4,1,3,0,3
16673_0,,,,2,1,2,3
C1(CC(C=O)OCC1O)=O,,,4,1,2,0,2
16675_0,,,,2,1,2,3
C1(C(C(C=O)OCC1)O)=O,,,4,1,2,0,2
16677_0,,,,2,1,2,3
C(C1C(CC(CO1)=O)O)=O,,,4,1,3,0,3
16679_0,,,,2,1,2,3
C1(C(C(CO)OCC1)=O)=O,,,4,1,2,0,2
16680_0,,,,2,1,2,3
16681_0,,,,2,1,2,3
16682_0,,,,2,1,2,3
16683_0,,,,2,1,2,3
16684_0,,,,2,1,2,3
16685_0,,,,2,1,2,3
16686_0,,,,2,1,2,3
16688_0,,,,2,1,2,3
C(C)(C1CC(C(O1)=O)=O)=O,,,4,1,3,0,3
16690_0,,,,2,1,2,3
C(CC1CC(C(O1)=O)=O)=O,,,4,1,3,0,3
16692_0,,,,2,1,2,3
C1(C(C(C)=O)OC(C1)=O)=O,,,4,1,3,0,3
16694_0,,,,2,1,2,3
C1(CC(C(CC=O)O1)=O)=O,,,4,1,3,0,3
16695_0,,,,2,1,2,3
16696_0,,,,2,1,2,3
16697_0,,,,2,1,2,3
16698_0,,,,2,1,2,3
16700_0,,,,2,1,2,3
C1(CCOC(C(C1)=O)=O)=O,,,4,1,3,0,3
16702_0,,,,2,1,2,3
C1(COC(C(CC1)=O)=O)=O,,,4,1,3,0,3
16704_0,,,,2,1,2,3
C1(CC(C(CCO1)=O)=O)=O,,,4,1,3,0,3
16706_0,,,,2,1,2,3
C1(CC(OCC(C1)=O)=O)=O,,,4,1,3,0,3
16707_0,,,,2,1,2,3
16708_0,,,,2,1,2,3
16709_0,,,,2,1,2,3
16710_0,,,,2,1,2,3
16712_0,,,,2,1,2,3
C1(C(CO)=CC(C1)=O)=O,,,4,1,3,0,3
16714_0,,,,2,1,2,3
C1CC(C(C=1CO)=O)=O,,,4,1,2,0,2
16716_0,,,,2,1,2,3
C=C1C(CC(C1=O)O)=O,,,4,1,2,0,2
16718_0,,,,2,1,2,3
C1(CC(C(C1O)=O)=C)=O,,,4,1,2,0,2
16720_0,,,,2,1,2,3
C1(CC(C(C1O)=C)=O)=O,,,4,1,2,0,2
16722_0,,,,2,1,2,3
C=C1C(C(CC1O)=O)=O,,,4,1,2,0,2
16724_0,,,,2,1,2,3
C(C1C(CC(C=1)=O)O)=O,,,4,1,3,0,3
16726_0,,,,2,1,2,3
C1(CC=C(C=O)C1O)=O,,,4,1,3,0,3
16728_0,,,,2,1,2,3
C1(CC(C=O)=CC1O)=O,,,4,1,3,0,3
16730_0,,,,2,1,2,3
C1C(CC(C=1C=O)=O)O,,,4,1,2,0,2
16732_0,,,,2,1,2,3
C(C=CC(CCO)=O)(O)=O,,,4,1,2,0,2
16734_0,,,,2,1,2,3
C(CO)(CC=CC(O)=O)=O,,,4,1,2,0,2
16736_0,,,,2,1,2,3
C(C)(C(C=CC(O)=O)O)=O,,,4,1,2,0,2
16738_0,,,,2,1,2,3
C(CC(C=CC(O)=O)O)=O,,,4,1,2,0,2
16740_0,,,,2,1,2,3
C=CC(CC(C=O)=O)O,,,4,1,2,0,2
16742_0,,,,2,1,2,3
C(CC(C(C=C)O)=O)=O,,,4,1,3,0,3
16744_0,,,,2,1,2,3
C(C(C(CC=C)=O)O)=O,,,4,1,3,0,3
16746_0,,,,2,1,2,3
C(C(CC(C=C)=O)O)=O,,,4,1,2,0,2
16748_0,,,,2,1,2,3
C(C1C(C(C=C1)O)=O)=O,,,4,1,2,0,2
16750_0,,,,2,1,2,3
C(C1(C(CC=C1)=O)O)=O,,,4,1,2,0,2
16751_0,,,,2,1,2,3
16753_0,,,,2,1,2,3
C(C)(C1C=CC(O1)=O)=O,,,4,1,2,0,2
16755_0,,,,2,1,2,3
C(CC1C=CC(O1)=O)=O,,,4,1,2,0,2
16757_0,,,,2,1,2,3
C(C)(C1C(C=CO1)=O)=O,,,4,1,2,0,2
16759_0,,,,2,1,2,3
C(CC1C(C=CO1)=O)=O,,,4,1,2,0,2
16761_0,,,,2,1,2,3
C1(C=CC(OCC1)=O)=O,,,4,1,2,0,2
16763_0,,,,2,1,2,3
C1(COC(C=CC1)=O)=O,,,4,1,2,0,2
16765_0,,,,2,1,2,3
C1OCCC(C(C=1)=O)=O,,,4,1,2,0,2
16767_0,,,,2,1,2,3
C1(COC=CC(C1)=O)=O,,,4,1,2,0,2
16769_0,,,,2,1,2,3
C1(CC(C=CCO1)=O)=O,,,4,1,2,0,2
16771_0,,,,2,1,2,3
C1COCC(C(C=1)=O)=O,,,4,1,2,0,2
16773_0,,,,2,1,2,3
C1(CC=CC(CO1)=O)=O,,,4,1,2,0,2
16775_0,,,,2,1,2,3
C1(C=CC(COC1)=O)=O,,,4,1,2,0,2
16777_0,,,,2,1,2,3
C1(C(OCC1)=CC=O)=O,,,4,1,2,0,2
16779_0,,,,2,1,2,3
C1(COC(C1)=CC=O)=O,,,4,1,2,0,2
16781_0,,,,2,1,2,3
C1C(C(C=O)=O)OCC=1,,,4,1,2,0,2
16783_0,,,,2,1,2,3
C(C1C=CC(C=O)O1)=O,,,4,1,2,0,2
16785_0,,,,2,1,2,3
C(C1C(CC(O1)=C)=O)=O,,,4,1,2,0,2
16787_0,,,,2,1,2,3
C(C1CC(C(O1)=C)=O)=O,,,4,1,2,0,2
16789_0,,,,2,1,2,3
C(C1OCCC(C=1)=O)=O,,,4,1,2,0,2
16791_0,,,,2,1,2,3
C1(COC(C=O)=CC1)=O,,,4,1,2,0,2
16793_0,,,,2,1,2,3
C(C1C(CC=CO1)=O)=O,,,4,1,2,0,2
16795_0,,,,2,1,2,3
C(C1CC(C=CO1)=O)=O,,,4,1,2,0,2
16796_0,,,,2,1,2,3
16797_0,,,,2,1,2,3
16798_0,,,,2,1,2,3
16799_0,,,,2,1,2,3
16800_0,,,,2,1,2,3
16801_0,,,,2,1,2,3
16802_0,,,,2,1,2,3
16803_0,,,,2,1,2,3
16804_0,,,,2,1,2,3
16805_0,,,,2,1,2,3
16806_0,,,,2,1,2,3
16807_0,,,,2,1,2,3
16808_0,,,,2,1,2,3
16810_0,,,,2,1,2,3
C1(C2(CC(C(C1)O2)O)O)=O,,,4,1,2,0,2
16812_0,,,,2,1,2,3
C1(C2CC(C(C1O)O2)O)=O,,,4,1,1,0,1
16814_0,,,,2,1,2,3
C1(C2C(C(C(O2)O)C1)O)=O,,,4,1,4,0,4
16815_0,,,,2,1,2,3
16817_0,,,,2,1,2,3
C1(C(O)OC(C(C)=O)C1O)=O,,,4,1,2,0,2
16819_0,,,,2,1,2,3
C(CC1C(C(C(O)O1)=O)O)=O,,,4,1,2,0,2
16821_0,,,,2,1,2,3
C(C1C(C(C(CO)O1)O)=O)=O,,,4,1,1,0,1
16823_0,,,,2,1,2,3
C(C1(C(CC(CO)O1)=O)O)=O,,,4,1,2,0,2
16825_0,,,,2,1,2,3
C1(CC(C=O)(OC1CO)O)=O,,,4,1,2,0,2
16826_0,,,,2,1,2,3
16828_0,,,,2,1,2,3
C1(COC(C(CO)=O)C1)=O,,,4,1,2,0,2
16830_0,,,,2,1,2,3
C(C)(C1(CC(CO1)=O)O)=O,,,4,1,2,0,2
16831_0,,,,2,1,2,3
16832_0,,,,2,1,2,3
16833_0,,,,2,1,2,3
16835_0,,,,2,1,2,3
C1(CCC(C(CO)=O)O1)=O,,,4,1,1,0,1
16836_0,,,,2,1,2,3
16838_0,,,,2,1,2,3
C1(C(COC1CCO)=O)=O,,,4,1,2,0,2
16840_0,,,,2,1,2,3
C1(CC(C(CCO)O1)=O)=O,,,4,1,1,0,1
16841_0,,,,2,1,2,3
16843_0,,,,2,1,2,3
C(C(C1C(CCO1)O)=O)=O,,,4,1,1,0,1
16845_0,,,,2,1,2,3
C(C(C1C(CCO1)=O)O)=O,,,4,1,1,0,1
16847_0,,,,2,1,2,3
C(C(C1CC(CO1)=O)O)=O,,,4,1,1,0,1
16849_0,,,,2,1,2,3
C1(CCC(C(C=O)O)O1)=O,,,4,1,1,0,1
16851_0,,,,2,1,2,3
C1(C(CC(C(CO)=O)O1)O)=O,,,4,1,2,0,2
16853_0,,,,2,1,2,3
C1(C(CC(C(C)=O)(O)O1)O)=O,,,4,1,2,0,2
16855_0,,,,2,1,2,3
C(CC1(CC(C(O1)=O)O)O)=O,,,4,1,2,0,2
16857_0,,,,2,1,2,3
C1(C(CC(CCO)(O)O1)=O)=O,,,4,1,2,0,2
16859_0,,,,2,1,2,3
C1(CC(C(CCO)(O)O1)=O)=O,,,4,1,2,0,2
16861_0,,,,2,1,2,3
C1(C(C(C(CCO)O1)=O)O)=O,,,4,1,2,0,2
16862_0,,,,2,1,2,3
16863_0,,,,2,1,2,3
16864_0,,,,2,1,2,3
16865_0,,,,2,1,2,3
16866_0,,,,2,1,2,3
16867_0,,,,2,1,2,3
16868_0,,,,2,1,2,3
16870_0,,,,2,1,2,3
C(CC1(C(O)OCC1O)O)=O,,,4,1,2,0,2
16872_0,,,,2,1,2,3
C1(C2C(CO)OC1CO2)=O,,,4,1,1,0,1
16874_0,,,,2,1,2,3
C1(C2CC(C(CO)O2)O1)=O,,,4,1,1,0,1
16876_0,,,,2,1,2,3
C1(CC2C(CC(O)O2)O1)=O,,,4,1,2,0,2
16878_0,,,,2,1,2,3
C1(COC2CC(OC12)O)=O,,,4,1,2,0,2
16880_0,,,,2,1,2,3
C1(C2CC(OC1CO2)O)=O,,,4,1,2,0,2
16882_0,,,,2,1,2,3
C1(CC2(CC(CO2)O1)O)=O,,,4,1,2,0,2
16884_0,,,,2,1,2,3
C1(COC2COC1(C2)O)=O,,,4,1,2,0,2
16886_0,,,,2,1,2,3
C1(C(O)OC2COC1C2)=O,,,4,1,2,0,2
16888_0,,,,2,1,2,3
C1(C2COCC(C1O)O2)=O,,,4,1,1,0,1
16890_0,,,,2,1,2,3
C1(C2(COCC(C1)O2)O)=O,,,4,1,2,0,2
16892_0,,,,2,1,2,3
C1(C2COCC(C1)(O2)O)=O,,,4,1,2,0,2
16894_0,,,,2,1,2,3
C1(C2CC(C(CO1)O2)O)=O,,,4,1,1,0,1
16896_0,,,,2,1,2,3
C1(COC2C(CC1O2)O)=O,,,4,1,1,0,1
16898_0,,,,2,1,2,3
C1(C2OCCC(C1)(O2)O)=O,,,4,1,2,0,2
16900_0,,,,2,1,2,3
C1(C2(CCOC(C1)O2)O)=O,,,4,1,2,0,2
16902_0,,,,2,1,2,3
C1(C2CCOC(C1O)O2)=O,,,4,1,1,0,1
16904_0,,,,2,1,2,3
C1(C2CC(C(CO2)O)O1)=O,,,4,1,1,0,1
16906_0,,,,2,1,2,3
C1(C(C(O)OC(CO)C1)=O)=O,,,4,1,2,0,2
16908_0,,,,2,1,2,3
C1(C(CO)OC(C(C1)=O)O)=O,,,4,1,2,0,2
16910_0,,,,2,1,2,3
C(C1C(C(C(CO1)O)O)=O)=O,,,4,1,1,0,1
16912_0,,,,2,1,2,3
C(C1(C(CC(CO1)O)=O)O)=O,,,4,1,2,0,2
16914_0,,,,2,1,2,3
C1(CC(C=O)(O)OCC1O)=O,,,4,1,2,0,2
16916_0,,,,2,1,2,3
C1(C(C(C=O)(O)OCC1)O)=O,,,4,1,2,0,2
16918_0,,,,2,1,2,3
C(C1(C(CC(CO1)=O)O)O)=O,,,4,1,2,0,2
16919_0,,,,2,1,2,3
16921_0,,,,2,1,2,3
C(C1CC(C(CO1)=O)O)=O,,,4,1,2,0,2
16922_0,,,,2,1,2,3
16924_0,,,,2,1,2,3
C1(CCC(C(C=O)O1)O)=O,,,4,1,1,0,1
16926_0,,,,2,1,2,3
C1(CC(CC(C=O)O1)O)=O,,,4,1,1,0,1
16927_0,,,,2,1,2,3
16929_0,,,,2,1,2,3
C(C1CCC(C(O1)O)=O)=O,,,4,1,2,0,2
16930_0,,,,2,1,2,3
16932_0,,,,2,1,2,3
C1(C(COC(C)(C1)O)=O)=O,,,4,1,2,0,2
16934_0,,,,2,1,2,3
C1(C(C)(OCC(C1)=O)O)=O,,,4,1,2,0,2
16936_0,,,,2,1,2,3
C1(C(C)OCC(C1O)=O)=O,,,4,1,2,0,2
16938_0,,,,2,1,2,3
C1(CC(C(C(C)O1)=O)O)=O,,,4,1,1,0,1
16939_0,,,,2,1,2,3
16941_0,,,,2,1,2,3
C1(C(C)OC(C(C1)=O)O)=O,,,4,1,2,0,2
16943_0,,,,2,1,2,3
C1(C(C(C)OC(C1)O)=O)=O,,,4,1,2,0,2
16945_0,,,,2,1,2,3
C1(COC(C)(C(C1)O)O)=O,,,4,1,2,0,2
16947_0,,,,2,1,2,3
C1(C(C(C)(O)OCC1)O)=O,,,4,1,2,0,2
16949_0,,,,2,1,2,3
C1(C(COC(C)(C1)O)O)=O,,,4,1,2,0,2
16951_0,,,,2,1,2,3
C1(C(C)(O)OCC(C1)O)=O,,,4,1,2,0,2
16953_0,,,,2,1,2,3
C1(C(C)OCC(C1O)O)=O,,,4,1,1,0,1
16955_0,,,,2,1,2,3
C1(C(CCC(CO)(O)O1)=O)=O,,,4,1,2,0,2
16957_0,,,,2,1,2,3
C1(CC(CC(CO)(O)O1)=O)=O,,,4,1,2,0,2
16959_0,,,,2,1,2,3
C1(C(C(CC(C=O)O1)O)O)=O,,,4,1,2,0,2
16961_0,,,,2,1,2,3
C1(C(CC(C(C)(O)O1)O)=O)=O,,,4,1,2,0,2
16963_0,,,,2,1,2,3
C1(CC(C(C(C)(O)O1)O)=O)=O,,,4,1,2,0,2
16965_0,,,,2,1,2,3
C1(C(C(CC(C)(O)O1)=O)O)=O,,,4,1,2,0,2
16967_0,,,,2,1,2,3
C1(CC(C(OC1(C)O)=O)O)=O,,,4,1,2,0,2
16969_0,,,,2,1,2,3
C1(C(C(C(OC1C)=O)O)O)=O,,,4,1,2,0,2
16971_0,,,,2,1,2,3
C1(C2C(COC1CO2)O)=O,,,4,1,1,0,1
16973_0,,,,2,1,2,3
C1(C2COC(CO2)C1O)=O,,,4,1,1,0,1
16975_0,,,,2,1,2,3
C1(C2(COC(CO2)C1)O)=O,,,4,1,2,0,2
16977_0,,,,2,1,2,3
C1(C2COC(CO2)(C1)O)=O,,,4,1,2,0,2
16979_0,,,,2,1,2,3
C1(C2CC(C(CO2)O1)O)=O,,,4,1,1,0,1
16981_0,,,,2,1,2,3
C1(C(C(O)OCC(C1)O)=O)=O,,,4,1,2,0,2
16983_0,,,,2,1,2,3
C1(C(COC(C(C1)=O)O)O)=O,,,4,1,2,0,2
16985_0,,,,2,1,2,3
C1(CCOC(C(C1O)=O)O)=O,,,4,1,2,0,2
16987_0,,,,2,1,2,3
C1(C(O)OCC(CC1O)=O)=O,,,4,1,2,0,2
16989_0,,,,2,1,2,3
C1(C(COC(CC1)O)=O)=O,,,4,1,2,0,2
16990_0,,,,2,1,2,3
16992_0,,,,2,1,2,3
C1(COC(CC(C1)O)O)=O,,,4,1,2,0,2
16994_0,,,,2,1,2,3
C1(C(CC(O)OCC1)O)=O,,,4,1,2,0,2
16996_0,,,,2,1,2,3
C1(C(COC(CC1)O)O)=O,,,4,1,2,0,2
16998_0,,,,2,1,2,3
C1(CC(COC(C1)O)O)=O,,,4,1,2,0,2
17000_0,,,,2,1,2,3
C1(CC(C(CCO1)O)O)=O,,,4,1,1,0,1
17002_0,,,,2,1,2,3
C1(COCCC(C1O)O)=O,,,4,1,1,0,1
17004_0,,,,2,1,2,3
C1(C(O)OCCC(C1)O)=O,,,4,1,2,0,2
17006_0,,,,2,1,2,3
C1(C(CCOC(C1)O)O)=O,,,4,1,2,0,2
17008_0,,,,2,1,2,3
C1(C(C(O)OCCC1)O)=O,,,4,1,2,0,2
17010_0,,,,2,1,2,3
C1(CC(C(O)OCC1)O)=O,,,4,1,2,0,2
17012_0,,,,2,1,2,3
C1(C(CC(CC(O)O1)O)=O)=O,,,4,1,2,0,2
17014_0,,,,2,1,2,3
C1(CC(C(CC(O)O1)O)=O)=O,,,4,1,2,0,2
17016_0,,,,2,1,2,3
C1(C(C(CCC(O)O1)=O)O)=O,,,4,1,2,0,2
17018_0,,,,2,1,2,3
C1(CC(C(OC(C1)O)=O)O)=O,,,4,1,2,0,2
17020_0,,,,2,1,2,3
C1(CC(C(CC(O1)=O)O)O)=O,,,4,1,1,0,1
17022_0,,,,2,1,2,3
C1(CC(C(C(CO1)=O)O)O)=O,,,4,1,2,0,2
17024_0,,,,2,1,2,3
C1(CC(CC(C(O)O1)=O)O)=O,,,4,1,2,0,2
17026_0,,,,2,1,2,3
C1(CC(C(CC(O)O1)=O)O)=O,,,4,1,2,0,2
17028_0,,,,2,1,2,3
C1(CCC(OC(C1O)O)=O)=O,,,4,1,2,0,2
17030_0,,,,2,1,2,3
C1(CC(CC(C(O)O1)O)=O)=O,,,4,1,2,0,2
17032_0,,,,2,1,2,3
C1(C2OC(CC(C1)O2)O)=O,,,4,1,2,0,2
17034_0,,,,2,1,2,3
C1(C2CC(O)OC(C1)O2)=O,,,4,1,2,0,2
17036_0,,,,2,1,2,3
C1(CC2C(CC(O2)O1)O)=O,,,4,1,1,0,1
17038_0,,,,2,1,2,3
C1(COC2CC(C1O2)O)=O,,,4,1,1,0,1
17040_0,,,,2,1,2,3
C(C1C(CCC(O1)=O)=O)=O,,,4,1,2,0,2
17042_0,,,,2,1,2,3
C1(CC(CC(C=O)O1)=O)=O,,,4,1,2,0,2
17044_0,,,,2,1,2,3
C(CC(C(C)=O)CC(C=O)=O)=O,,,4,1,2,0,2
17046_0,,,,2,1,2,3
C(CC(CC=O)CC(C=O)=O)=O,,,4,1,4,0,4
17048_0,,,,2,1,2,3
C(CC(C=O)CC(C(C)=O)=O)=O,,,4,1,3,0,3
17049_0,,,,2,1,2,3
17050_0,,,,2,1,2,3
17051_0,,,,2,1,2,3
17053_0,,,,2,1,2,3
C(CCCC(CC(C=O)=O)=O)=O,,,4,1,2,0,2
17055_0,,,,2,1,2,3
C(CC(C(CCCC=O)=O)=O)=O,,,4,1,2,0,2
17056_0,,,,2,1,2,3
17057_0,,,,2,1,2,3
17058_0,,,,2,1,2,3
17059_0,,,,2,1,2,3
17060_0,,,,2,1,2,3
17061_0,,,,2,1,2,3
17062_0,,,,2,1,2,3
17063_0,,,,2,1,2,3
17065_0,,,,2,1,2,3
C1(CO)C(C(C(C=1)=O)O)O,,,4,1,2,0,2
17066_0,,,,2,1,2,3
17067_0,,,,2,1,2,3
17068_0,,,,2,1,2,3
17069_0,,,,2,1,2,3
17070_0,,,,2,1,2,3
17071_0,,,,2,1,2,3
17072_0,,,,2,1,2,3
17073_0,,,,2,1,2,3
17075_0,,,,2,1,2,3
C(C1CC(C(C=1)=O)O)=O,,,4,1,1,0,1
17076_0,,,,2,1,2,3
17077_0,,,,2,1,2,3
17078_0,,,,2,1,2,3
17080_0,,,,2,1,2,3
C1C(C(C(C=1)=O)=O)CO,,,4,1,1,0,1
17081_0,,,,2,1,2,3
17082_0,,,,2,1,2,3
17083_0,,,,2,1,2,3
17084_0,,,,2,1,2,3
17086_0,,,,2,1,2,3
C1CC(C(C=1C=O)=O)O,,,4,1,1,0,1
17087_0,,,,2,1,2,3
17088_0,,,,2,1,2,3
17089_0,,,,2,1,2,3
17090_0,,,,2,1,2,3
17091_0,,,,2,1,2,3
17092_0,,,,2,1,2,3
17094_0,,,,2,1,2,3
C1C(C(C(C(C=1CO)=O)O)O)O,,,4,1,1,0,1
17096_0,,,,2,1,2,3
C=C1C(C(C(C(C1O)O)O)O)=O,,,4,1,1,0,1
17098_0,,,,2,1,2,3
C(CO)(C(C(C=O)=C)O)=O,,,4,1,1,0,1
17100_0,,,,2,1,2,3
C(CO)(CO)=CC(C=O)=O,,,4,1,1,0,1
17102_0,,,,2,1,2,3
C(CO)(C(C=CC(CO)=O)O)=O,,,4,1,1,0,1
17104_0,,,,2,1,2,3
C(CO)(C(C(CO)=CC=O)O)=O,,,4,1,1,0,1
17106_0,,,,2,1,2,3
C(CO)(CO)=C(C=O)C(CO)=O,,,4,1,1,0,1
17108_0,,,,2,1,2,3
C(C(C(C(C(CO)=O)O)=C)O)=O,,,4,1,1,0,1
17110_0,,,,2,1,2,3
C(C(C(C=C(CO)CO)=O)O)=O,,,4,1,1,0,1
17112_0,,,,2,1,2,3
C(CO)(C(C(C(CO)O)=C)O)=O,,,4,1,1,0,1
17114_0,,,,2,1,2,3
C(CO)(CO)=CC(C(CO)O)=O,,,4,1,1,0,1
17115_0,,,,2,1,2,3
17117_0,,,,2,1,2,3
C(CO)(C(C(C=O)=CCO)O)=O,,,4,1,1,0,1
17118_0,,,,2,1,2,3
17120_0,,,,2,1,2,3
C(CO)(CO)=C(C(C=O)=O)CO,,,4,1,1,0,1
17122_0,,,,2,1,2,3
C=C(C(C=O)=O)C(CO)(CO)O,,,4,1,1,0,1
17124_0,,,,2,1,2,3
C(CO)(C(C(CO)=CCO)O)=O,,,4,1,1,0,1
17125_0,,,,2,1,2,3
17126_0,,,,2,1,2,3
17128_0,,,,2,1,2,3
C(CO)(CO)=C(C(CO)=O)CO,,,4,1,1,0,1
17130_0,,,,2,1,2,3
C=C(C(CO)=O)C(CO)(CO)O,,,4,1,1,0,1
17132_0,,,,2,1,2,3
C(CO)(C(C(CO)=C)O)=O,,,4,1,1,0,1
17134_0,,,,2,1,2,3
C(CO)(CO)=CC(CO)=O,,,4,1,1,0,1
17135_0,,,,2,1,2,3
17136_0,,,,2,1,2,3
17137_0,,,,2,1,2,3
17139_0,,,,2,1,2,3
C(C(C(C=O)=C(CO)CO)O)=O,,,4,1,1,0,1
17141_0,,,,2,1,2,3
C(C=C(C=O)C(CO)(CO)O)=O,,,4,1,2,0,2
17143_0,,,,2,1,2,3
C(CO)(C(C=C)O)=O,,,4,1,1,0,1
17145_0,,,,2,1,2,3
C(CO)(CO)=CC=O,,,4,1,1,0,1
17147_0,,,,2,1,2,3
C(C(CO)O)=C(C=O)C(CO)=O,,,4,1,1,0,1
17149_0,,,,2,1,2,3
C(C(C(C=CC(CO)O)=O)O)=O,,,4,1,1,0,1
17150_0,,,,2,1,2,3
17152_0,,,,2,1,2,3
C(C(CO)O)=C(C(C=O)=O)CO,,,4,1,2,0,2
17154_0,,,,2,1,2,3
C=C(C(C=O)=O)C(C(CO)O)O,,,4,1,1,0,1
17155_0,,,,2,1,2,3
17157_0,,,,2,1,2,3
C(C(CO)O)=C(C(CO)=O)CO,,,4,1,1,0,1
17159_0,,,,2,1,2,3
C=C(C(CO)=O)C(C(CO)O)O,,,4,1,1,0,1
17161_0,,,,2,1,2,3
C(C(C(C=O)=CC(CO)O)O)=O,,,4,1,1,0,1
17163_0,,,,2,1,2,3
C(C=C(C=O)C(C(CO)O)O)=O,,,4,1,2,0,2
17165_0,,,,2,1,2,3
C(C(CO)O)=CC=O,,,4,1,3,0,3
17167_0,,,,2,1,2,3
C(C(C)=CC(C=O)=O)=O,,,4,1,1,0,1
17169_0,,,,2,1,2,3
C=C(C=O)CC(C=O)=O,,,4,1,1,0,1
17171_0,,,,2,1,2,3
C(CO)(CC=CC(C=O)=O)=O,,,4,1,1,0,1
17173_0,,,,2,1,2,3
C(CC(C=O)=O)=CC(CO)=O,,,4,1,1,0,1
17175_0,,,,2,1,2,3
C(CC(CO)=CC(C=O)=O)=O,,,4,1,1,0,1
17177_0,,,,2,1,2,3
C(CO)(CC(C=O)=O)=CC=O,,,4,1,1,0,1
17179_0,,,,2,1,2,3
C(C(C(CO)=O)=CC(C)=O)=O,,,4,1,1,0,1
17181_0,,,,2,1,2,3
C(C(C(CO)=O)C(C=O)=C)=O,,,4,1,1,0,1
17183_0,,,,2,1,2,3
C(C(C(CO)=O)=C(C=O)C)=O,,,4,1,1,0,1
17185_0,,,,2,1,2,3
C(CC(C(C(C=O)=C)O)=O)=O,,,4,1,2,0,2
17187_0,,,,2,1,2,3
C(C)(C(C=CC(C=O)=O)O)=O,,,4,1,1,0,1
17189_0,,,,2,1,2,3
C(C(C(C)=CC(C=O)=O)O)=O,,,4,1,1,0,1
17191_0,,,,2,1,2,3
C(C(C(CC(C=O)=O)=C)O)=O,,,4,1,1,0,1
17193_0,,,,2,1,2,3
C(C(C(C=CC(C)=O)=O)O)=O,,,4,1,1,0,1
17195_0,,,,2,1,2,3
C(C(C(CC(C=O)=C)=O)O)=O,,,4,1,2,0,2
17197_0,,,,2,1,2,3
C(C(C(C=C(C=O)C)=O)O)=O,,,4,1,1,0,1
17199_0,,,,2,1,2,3
C(C(C=CC=O)=O)=O,,,4,1,1,0,1
17201_0,,,,2,1,2,3
C(C)(C(CO)O)=CC(C=O)=O,,,4,1,1,0,1
17203_0,,,,2,1,2,3
C=C(C(CO)O)CC(C=O)=O,,,4,1,1,0,1
17205_0,,,,2,1,2,3
C(C=CC(C)=O)(C(CO)O)=O,,,4,1,1,0,1
17207_0,,,,2,1,2,3
C(C(CO)O)(CC(C=O)=C)=O,,,4,1,1,0,1
17209_0,,,,2,1,2,3
C(C=C(C=O)C)(C(CO)O)=O,,,4,1,1,0,1
17210_0,,,,2,1,2,3
17211_0,,,,2,1,2,3
17213_0,,,,2,1,2,3
C(C(C=C(C=O)CCO)=O)=O,,,4,1,1,0,1
17215_0,,,,2,1,2,3
C(CO)=C(C=O)CC(C=O)=O,,,4,1,1,0,1
17216_0,,,,2,1,2,3
17218_0,,,,2,1,2,3
C(C(C(CO)=CC(C)=O)=O)=O,,,4,1,1,0,1
17220_0,,,,2,1,2,3
C(C)(C(C(C(C=O)=O)=C)O)=O,,,4,1,1,0,1
17222_0,,,,2,1,2,3
C=C(C=O)C(C(C=O)=O)CO,,,4,1,1,0,1
17224_0,,,,2,1,2,3
C(C(C(CO)=C(C=O)C)=O)=O,,,4,1,1,0,1
17226_0,,,,2,1,2,3
C(C(C(C(C=O)=O)=C)(C)O)=O,,,4,1,1,0,1
17228_0,,,,2,1,2,3
C(CO)(CCO)=CC(C=O)=O,,,4,1,1,0,1
17230_0,,,,2,1,2,3
C(CO)=C(CO)CC(C=O)=O,,,4,1,1,0,1
17231_0,,,,2,1,2,3
17232_0,,,,2,1,2,3
17234_0,,,,2,1,2,3
C(CCO)(C(C(C=O)=C)O)=O,,,4,1,1,0,1
17235_0,,,,2,1,2,3
17237_0,,,,2,1,2,3
C(C(CO)=CC(C)=O)(CO)=O,,,4,1,1,0,1
17239_0,,,,2,1,2,3
C(C)(C(C(C(CO)=O)=C)O)=O,,,4,1,1,0,1
17241_0,,,,2,1,2,3
C(CO)(C(C(C=O)=C)CO)=O,,,4,1,1,0,1
17243_0,,,,2,1,2,3
C(C(C)=C(C(CO)=O)CO)=O,,,4,1,1,0,1
17245_0,,,,2,1,2,3
C(C(C(C(CO)=O)=C)(C)O)=O,,,4,1,1,0,1
17247_0,,,,2,1,2,3
C(C(C=CC(C=O)=O)O)=O,,,4,1,1,0,1
17249_0,,,,2,1,2,3
C(C)(CO)=CC(C=O)=O,,,4,1,1,0,1
17251_0,,,,2,1,2,3
C=C(CO)CC(C=O)=O,,,4,1,1,0,1
17252_0,,,,2,1,2,3
17254_0,,,,2,1,2,3
C(CO)(CC(C=O)=C)=O,,,4,1,1,0,1
17256_0,,,,2,1,2,3
C(C(C)=CC(CO)=O)=O,,,4,1,1,0,1
17258_0,,,,2,1,2,3
C(C)(C(C(C=O)=C)O)=O,,,4,1,1,0,1
17260_0,,,,2,1,2,3
C(CC(C=CC(C=O)=O)O)=O,,,4,1,1,0,1
17261_0,,,,2,1,2,3
17263_0,,,,2,1,2,3
C(C(CC=CC(C=O)=O)O)=O,,,4,1,1,0,1
17264_0,,,,2,1,2,3
17266_0,,,,2,1,2,3
C(C(C=CCC(C=O)=O)O)=O,,,4,1,1,0,1
17268_0,,,,2,1,2,3
C(C(C(C=O)=CC(C)=O)O)=O,,,4,1,1,0,1
17270_0,,,,2,1,2,3
C(C)(C(C(C=O)=CC=O)O)=O,,,4,1,2,0,2
17272_0,,,,2,1,2,3
C(C(C(C=O)=C)C(C=O)O)=O,,,4,1,1,0,1
17274_0,,,,2,1,2,3
C(C(C(C=O)=C(C=O)C)O)=O,,,4,1,1,0,1
17276_0,,,,2,1,2,3
C(C(C(C=O)=CC=O)(C)O)=O,,,4,1,2,0,2
17278_0,,,,2,1,2,3
C(C(C(C=CC(C=O)=O)O)O)=O,,,4,1,1,0,1
17280_0,,,,2,1,2,3
C(C)=CC(C=O)=O,,,4,1,1,0,1
17282_0,,,,2,1,2,3
C=CCC(C=O)=O,,,4,1,1,0,1
17284_0,,,,2,1,2,3
C(C=CC(C)=O)=O,,,4,1,1,0,1
17286_0,,,,2,1,2,3
C(CC(C=O)=C)=O,,,4,1,1,0,1
17288_0,,,,2,1,2,3
C(C(C)=CC=O)=O,,,4,1,1,0,1
17290_0,,,,2,1,2,3
C(CO)(C(CO)O)=CC(C=O)=O,,,4,1,1,0,1
17292_0,,,,2,1,2,3
C(C(CO)O)(C(C(C=O)=C)O)=O,,,4,1,2,0,2
17294_0,,,,2,1,2,3
C(C(C(CO)=O)=CC=O)=O,,,4,1,1,0,1
17296_0,,,,2,1,2,3
C=C(C=O)C(CO)=O,,,4,1,1,0,1
17298_0,,,,2,1,2,3
C(C(C=C(C=O)C(CO)=O)O)=O,,,4,1,1,0,1
17300_0,,,,2,1,2,3
C(C)(CO)=C(C=O)C(CO)=O,,,4,1,1,0,1
17302_0,,,,2,1,2,3
C(C(C(CO)=O)C(CO)=C)=O,,,4,1,1,0,1
17304_0,,,,2,1,2,3
C(CC(C(C(CO)=C)O)=O)=O,,,4,1,1,0,1
17306_0,,,,2,1,2,3
C(CO)(CC=CC(CO)=O)=O,,,4,1,1,0,1
17308_0,,,,2,1,2,3
C(CO)(CC(CO)=CC=O)=O,,,4,1,1,0,1
17310_0,,,,2,1,2,3
C(CC(CO)=CC(CO)=O)=O,,,4,1,1,0,1
17312_0,,,,2,1,2,3
C(C)(C(C=CC(CO)=O)O)=O,,,4,1,1,0,1
17314_0,,,,2,1,2,3
C(C)(C(C(CO)=CC=O)O)=O,,,4,1,1,0,1
17316_0,,,,2,1,2,3
C(C)=C(C=O)C(CO)=O,,,4,1,1,0,1
17318_0,,,,2,1,2,3
C(C(C(CO)=O)C=C)=O,,,4,1,1,0,1
17319_0,,,,2,1,2,3
17320_0,,,,2,1,2,3
17321_0,,,,2,1,2,3
17323_0,,,,2,1,2,3
C(CC(CO)=CC=O)=O,,,4,1,1,0,1
17325_0,,,,2,1,2,3
C(C(C(C=CC=O)=O)O)=O,,,4,1,5,0,5
17327_0,,,,2,1,2,3
C(C(C(C=C)=O)O)=O,,,4,1,4,0,4
17329_0,,,,2,1,2,3
C(C(C(C=CC(C=O)O)=O)O)=O,,,4,1,1,0,1
17331_0,,,,2,1,2,3
C(C(C(C=C(CO)C)=O)O)=O,,,4,1,1,0,1
17333_0,,,,2,1,2,3
C(C(C=O)O)(CC(CO)=C)=O,,,4,1,1,0,1
17335_0,,,,2,1,2,3
C(C(C(CC(CO)=O)=C)O)=O,,,4,1,1,0,1
17337_0,,,,2,1,2,3
C(C(C(C)=CC(CO)=O)O)=O,,,4,1,1,0,1
17339_0,,,,2,1,2,3
C(C(C(C(C(C)=O)O)=C)O)=O,,,4,1,1,0,1
17341_0,,,,2,1,2,3
C(C(C(C=CC)=O)O)=O,,,4,1,1,0,1
17342_0,,,,2,1,2,3
17343_0,,,,2,1,2,3
17345_0,,,,2,1,2,3
C(CC(C(C=O)O)=C)=O,,,4,1,1,0,1
17347_0,,,,2,1,2,3
C(C(C(C)=CC=O)O)=O,,,4,1,1,0,1
17349_0,,,,2,1,2,3
C(C(C(C(CO)=O)=CC=O)O)=O,,,4,1,1,0,1
17350_0,,,,2,1,2,3
17352_0,,,,2,1,2,3
C(C(C(CO)=CC=O)=O)=O,,,4,1,1,0,1
17354_0,,,,2,1,2,3
C(C(C(C(C=O)=O)=C)O)=O,,,4,1,1,0,1
17355_0,,,,2,1,2,3
17356_0,,,,2,1,2,3
17358_0,,,,2,1,2,3
C(C(C(C=O)=CC=O)O)=O,,,4,1,2,0,2
17359_0,,,,2,1,2,3
17360_0,,,,2,1,2,3
17362_0,,,,2,1,2,3
C(CO)(C)=CC(C(CO)O)=O,,,4,1,1,0,1
17364_0,,,,2,1,2,3
C(C(CO)O)(CC(CO)=C)=O,,,4,1,1,0,1
17366_0,,,,2,1,2,3
C(CO)(CC(C(CO)O)=C)=O,,,4,1,1,0,1
17368_0,,,,2,1,2,3
C(C)(C(CO)O)=CC(CO)=O,,,4,1,1,0,1
17370_0,,,,2,1,2,3
C(C)(C(C(C(CO)O)=C)O)=O,,,4,1,1,0,1
17372_0,,,,2,1,2,3
C(C)=CC(C(CO)O)=O,,,4,1,1,0,1
17374_0,,,,2,1,2,3
C(C(CO)O)(CC=C)=O,,,4,1,1,0,1
17376_0,,,,2,1,2,3
C(CC(C(CO)O)=C)=O,,,4,1,1,0,1
17378_0,,,,2,1,2,3
C(C)(C(CO)O)=CC=O,,,4,1,1,0,1
17380_0,,,,2,1,2,3
C(C=C(C(CO)=O)C(C)O)=O,,,4,1,1,0,1
17382_0,,,,2,1,2,3
C(C(C(C(CO)=O)=CC)O)=O,,,4,1,1,0,1
17384_0,,,,2,1,2,3
C(C(C(C(CO)=O)C=C)O)=O,,,4,1,1,0,1
17385_0,,,,2,1,2,3
17387_0,,,,2,1,2,3
C(C(CC(C(C=C)O)=O)O)=O,,,4,1,1,0,1
17388_0,,,,2,1,2,3
17389_0,,,,2,1,2,3
17390_0,,,,2,1,2,3
17392_0,,,,2,1,2,3
C(CC(CO)=CC(C=O)O)=O,,,4,1,1,0,1
17394_0,,,,2,1,2,3
C(C(CC(CO)=CC=O)O)=O,,,4,1,1,0,1
17396_0,,,,2,1,2,3
C=C(C(C=O)=O)CO,,,4,1,1,0,1
17398_0,,,,2,1,2,3
C=C(C(CO)=O)CO,,,4,1,1,0,1
17400_0,,,,2,1,2,3
C(C(C(C=O)=C)O)=O,,,4,1,2,0,2
17402_0,,,,2,1,2,3
C(C(CO)=CC=O)=O,,,4,1,2,0,2
17404_0,,,,2,1,2,3
C=CC=O,,,4,1,5,0,5
17405_0,,,,2,1,2,3
17407_0,,,,2,1,2,3
C(C=C(C=O)CO)(C(CO)O)=O,,,4,1,2,0,2
17408_0,,,,2,1,2,3
17410_0,,,,2,1,2,3
C=C(C(C(CO)=O)=O)C(CO)O,,,4,1,1,0,1
17412_0,,,,2,1,2,3
C(CO)=C(C(C(CO)=O)=O)CO,,,4,1,1,0,1
17414_0,,,,2,1,2,3
C=C(C(C(CO)O)=O)C(CO)=O,,,4,1,1,0,1
17415_0,,,,2,1,2,3
17416_0,,,,2,1,2,3
17417_0,,,,2,1,2,3
17419_0,,,,2,1,2,3
C(CO)(C(C(C(CO)=C)=O)O)=O,,,4,1,1,0,1
17420_0,,,,2,1,2,3
17422_0,,,,2,1,2,3
C(CO)(C(C(C(CO)=O)=C)O)=O,,,4,1,1,0,1
17424_0,,,,2,1,2,3
C(C(CO)=CC(CO)=O)(CO)=O,,,4,1,2,0,2
17425_0,,,,2,1,2,3
17426_0,,,,2,1,2,3
17428_0,,,,2,1,2,3
C(CO)(C(C(C(C=O)=C)O)O)=O,,,4,1,1,0,1
17430_0,,,,2,1,2,3
C(CO)(C(C=C(C=O)CO)O)=O,,,4,1,2,0,2
17432_0,,,,2,1,2,3
C=C(C(C(C(CO)O)O)=O)CO,,,4,1,1,0,1
17434_0,,,,2,1,2,3
C=C(C(C(CO)O)=O)C(CO)O,,,4,1,1,0,1
17436_0,,,,2,1,2,3
C(CO)=C(C(C(CO)O)=O)CO,,,4,1,1,0,1
17438_0,,,,2,1,2,3
C=C(C=O)C(C(C(CO)O)O)O,,,4,1,1,0,1
17440_0,,,,2,1,2,3
C(C(C(CO)O)O)=C(C=O)CO,,,4,1,1,0,1
17441_0,,,,2,1,2,3
17442_0,,,,2,1,2,3
17444_0,,,,2,1,2,3
C=C(C(CCO)=O)C(C=O)=O,,,4,1,1,0,1
17445_0,,,,2,1,2,3
17447_0,,,,2,1,2,3
C=C(C(CC(C=O)=O)=O)CO,,,4,1,1,0,1
17449_0,,,,2,1,2,3
C(CO)(CC(C(C=O)=O)=C)=O,,,4,1,1,0,1
17451_0,,,,2,1,2,3
C=C(C(CO)=O)CC(C=O)=O,,,4,1,1,0,1
17453_0,,,,2,1,2,3
C(CC(C(C(C=O)=O)=C)O)=O,,,4,1,1,0,1
17455_0,,,,2,1,2,3
C(CC=C(C(C=O)=O)CO)=O,,,4,1,1,0,1
17456_0,,,,2,1,2,3
17457_0,,,,2,1,2,3
17459_0,,,,2,1,2,3
C=C(C=O)C(CC(C=O)=O)O,,,4,1,1,0,1
17461_0,,,,2,1,2,3
C(CC(C=O)=O)=C(C=O)CO,,,4,1,1,0,1
17463_0,,,,2,1,2,3
C=C(C=O)C(C(CCO)=O)=O,,,4,1,1,0,1
17464_0,,,,2,1,2,3
17466_0,,,,2,1,2,3
C(CC(C(C(CO)=C)=O)=O)=O,,,4,1,1,0,1
17468_0,,,,2,1,2,3
C(CO)(CC(C(C=O)=C)=O)=O,,,4,1,1,0,1
17470_0,,,,2,1,2,3
C(CC(C(C(CO)=O)=C)=O)=O,,,4,1,1,0,1
17472_0,,,,2,1,2,3
C(C)(C(C(C(C=O)=C)=O)O)=O,,,4,1,1,0,1
17474_0,,,,2,1,2,3
C(CC(C(C(C=C)=O)O)=O)=O,,,4,1,1,0,1
17476_0,,,,2,1,2,3
C(CC(C(C(C=O)=C)=O)O)=O,,,4,1,1,0,1
17477_0,,,,2,1,2,3
17478_0,,,,2,1,2,3
17480_0,,,,2,1,2,3
C(CC(C=C(C=O)CO)=O)=O,,,4,1,2,0,2
17482_0,,,,2,1,2,3
C(C(C(C(C(C)=O)=C)=O)O)=O,,,4,1,1,0,1
17484_0,,,,2,1,2,3
C(C(C(CC(C=C)=O)=O)O)=O,,,4,1,1,0,1
17486_0,,,,2,1,2,3
C(CC(C(C(C=O)O)=O)=C)=O,,,4,1,1,0,1
17487_0,,,,2,1,2,3
17489_0,,,,2,1,2,3
C(C(C(C(C(C)=O)=O)=C)O)=O,,,4,1,1,0,1
17491_0,,,,2,1,2,3
C(C=C(C(C(C)=O)=O)CO)=O,,,4,1,1,0,1
17492_0,,,,2,1,2,3
17494_0,,,,2,1,2,3
C(C(CC(C(C=C)=O)=O)O)=O,,,4,1,1,0,1
17496_0,,,,2,1,2,3
C(CC(C(C(C=O)O)=C)=O)=O,,,4,1,1,0,1
17498_0,,,,2,1,2,3
C(CC(C(CO)=CC=O)=O)=O,,,4,1,2,0,2
17499_0,,,,2,1,2,3
17501_0,,,,2,1,2,3
C(C(CC(C(C=O)=C)=O)O)=O,,,4,1,1,0,1
17503_0,,,,2,1,2,3
C=C1C(C(OC1C(CO)O)O)=O,,,4,1,1,0,1
17505_0,,,,2,1,2,3
C=C1C(C(C(CO)O)OC1O)=O,,,4,1,1,0,1
17507_0,,,,2,1,2,3
C1OC(C(C=1CO)=O)C(CO)O,,,4,1,1,0,1
17509_0,,,,2,1,2,3
C=CC(C1C(C(C(O1)O)O)O)=O,,,4,1,1,0,1
17511_0,,,,2,1,2,3
C=C(C=O)C1C(C(C(O1)O)O)O,,,4,1,1,0,1
17513_0,,,,2,1,2,3
C=C1C(C(O)OC(CO)C1O)=O,,,4,1,1,0,1
17515_0,,,,2,1,2,3
C1C(CO)OC(C(C=1CO)=O)O,,,4,1,1,0,1
17517_0,,,,2,1,2,3
C=C1C(C(C(CO)OC1O)O)=O,,,4,1,1,0,1
17519_0,,,,2,1,2,3
C1OC(CO)C(C(C=1CO)=O)O,,,4,1,1,0,1
17521_0,,,,2,1,2,3
C=C1C(C(C(OC1CO)O)O)=O,,,4,1,1,0,1
17523_0,,,,2,1,2,3
C=C1C(C(CO)OC(C1O)O)=O,,,4,1,1,0,1
17525_0,,,,2,1,2,3
C1C(OC(C(C=1CO)=O)CO)O,,,4,1,1,0,1
17527_0,,,,2,1,2,3
C=C1C(C(O)OCC(C1O)O)=O,,,4,1,1,0,1
17529_0,,,,2,1,2,3
C1C(COC(C(C=1CO)=O)O)O,,,4,1,1,0,1
17531_0,,,,2,1,2,3
C=C1C(C(C(COC1O)O)O)=O,,,4,1,1,0,1
17533_0,,,,2,1,2,3
C1OCC(C(C(C=1CO)=O)O)O,,,4,1,1,0,1
17535_0,,,,2,1,2,3
C=C1C(C(C(O)OCC1O)O)=O,,,4,1,1,0,1
17537_0,,,,2,1,2,3
C1COC(C(C(C=1CO)=O)O)O,,,4,1,1,0,1
17539_0,,,,2,1,2,3
C=C1C(C(COC(C1O)O)O)=O,,,4,1,1,0,1
17541_0,,,,2,1,2,3
C1C(O)OCC(C(C=1CO)=O)O,,,4,1,1,0,1
17543_0,,,,2,1,2,3
C=C1C(C(C(C(OC1)O)O)O)=O,,,4,1,1,0,1
17545_0,,,,2,1,2,3
C=C1C(COC(C(C1O)O)O)=O,,,4,1,1,0,1
17547_0,,,,2,1,2,3
C1C(C(OCC(C=1CO)=O)O)O,,,4,1,1,0,1
17548_0,,,,2,1,2,3
17550_0,,,,2,1,2,3
C=C(C=O)C1(C(C(CO1)O)O)O,,,4,1,1,0,1
17552_0,,,,2,1,2,3
C1(C(C(CO1)O)O)=C(C=O)CO,,,4,1,1,0,1
17554_0,,,,2,1,2,3
C(C(C(C(C(C=O)=O)=C)O)O)=O,,,4,1,1,0,1
17556_0,,,,2,1,2,3
C(C(C=C(C(C=O)=O)CO)O)=O,,,4,1,1,0,1
17558_0,,,,2,1,2,3
C=C(C(C=O)=O)C(CO)(C)O,,,4,1,1,0,1
17560_0,,,,2,1,2,3
C(C)(CO)=C(C(C=O)=O)CO,,,4,1,1,0,1
17562_0,,,,2,1,2,3
C=C(CO)C(C(C=O)=O)CO,,,4,1,1,0,1
17563_0,,,,2,1,2,3
17565_0,,,,2,1,2,3
C(C=CC(CO)=O)(CCO)=O,,,4,1,1,0,1
17567_0,,,,2,1,2,3
C(CO)(CC(C=O)=CCO)=O,,,4,1,1,0,1
17568_0,,,,2,1,2,3
17570_0,,,,2,1,2,3
C(C(CCO)=CC(CO)=O)=O,,,4,1,1,0,1
17572_0,,,,2,1,2,3
C(C)(C(C(C=O)=CCO)O)=O,,,4,1,1,0,1
17573_0,,,,2,1,2,3
17575_0,,,,2,1,2,3
C=C(C(C=O)=O)C(C)O,,,4,1,1,0,1
17577_0,,,,2,1,2,3
C(C)=C(C(C=O)=O)CO,,,4,1,1,0,1
17579_0,,,,2,1,2,3
C=CC(C(C=O)=O)CO,,,4,1,1,0,1
17580_0,,,,2,1,2,3
17581_0,,,,2,1,2,3
17583_0,,,,2,1,2,3
C(CC(C=O)=CCO)=O,,,4,1,1,0,1
17584_0,,,,2,1,2,3
17586_0,,,,2,1,2,3
C(C=C(C=O)CCO)=O,,,4,1,1,0,1
17587_0,,,,2,1,2,3
17589_0,,,,2,1,2,3
C(C(C(C(C(CO)=O)=C)O)O)=O,,,4,1,1,0,1
17591_0,,,,2,1,2,3
C(C(C=C(C(CO)=O)CO)O)=O,,,4,1,2,0,2
17592_0,,,,2,1,2,3
17594_0,,,,2,1,2,3
C(CCO)(C(C(CO)=C)O)=O,,,4,1,1,0,1
17596_0,,,,2,1,2,3
C=C(C(CO)=O)C(CO)(C)O,,,4,1,1,0,1
17598_0,,,,2,1,2,3
C(C)(CO)=C(C(CO)=O)CO,,,4,1,1,0,1
17600_0,,,,2,1,2,3
C(CO)(C(C(CO)=C)CO)=O,,,4,1,1,0,1
17602_0,,,,2,1,2,3
C(CO)(CC(CO)=CCO)=O,,,4,1,1,0,1
17603_0,,,,2,1,2,3
17605_0,,,,2,1,2,3
C(CO)(CCO)=CC(CO)=O,,,4,1,1,0,1
17607_0,,,,2,1,2,3
C(C)(C(C(CO)=CCO)O)=O,,,4,1,1,0,1
17608_0,,,,2,1,2,3
17609_0,,,,2,1,2,3
17611_0,,,,2,1,2,3
C(CCO)(C(C=C)O)=O,,,4,1,1,0,1
17613_0,,,,2,1,2,3
C=C(C(CO)=O)C(C)O,,,4,1,1,0,1
17615_0,,,,2,1,2,3
C(C)=C(C(CO)=O)CO,,,4,1,1,0,1
17617_0,,,,2,1,2,3
C(CO)(C(C=C)CO)=O,,,4,1,1,0,1
17619_0,,,,2,1,2,3
C(CC(CO)=CCO)=O,,,4,1,1,0,1
17620_0,,,,2,1,2,3
17622_0,,,,2,1,2,3
C(CO)(CCO)=CC=O,,,4,1,1,0,1
17624_0,,,,2,1,2,3
C(C(C(C(C=CC)=O)O)O)=O,,,4,1,1,0,1
17626_0,,,,2,1,2,3
C(C(C(C(CC=C)=O)O)O)=O,,,4,1,1,0,1
17627_0,,,,2,1,2,3
17629_0,,,,2,1,2,3
C(CC(C(C(C=O)O)O)=C)=O,,,4,1,1,0,1
17631_0,,,,2,1,2,3
C(C(C(C(C)=CC=O)O)O)=O,,,4,1,1,0,1
17633_0,,,,2,1,2,3
C(C(C(C=O)=CC(C=O)O)O)=O,,,4,1,1,0,1
17635_0,,,,2,1,2,3
C(C(C(C(C=O)=CC=O)O)O)=O,,,4,1,2,0,2
17636_0,,,,2,1,2,3
17638_0,,,,2,1,2,3
C(C)(CO)=CC(CO)=O,,,4,1,1,0,1
17640_0,,,,2,1,2,3
C(CO)(CC(CO)=C)=O,,,4,1,1,0,1
17642_0,,,,2,1,2,3
C(C)(C(C(CO)=C)O)=O,,,4,1,1,0,1
17644_0,,,,2,1,2,3
C(C(CC=CC(CO)=O)O)=O,,,4,1,1,0,1
17645_0,,,,2,1,2,3
17647_0,,,,2,1,2,3
C(C(C=CCC(CO)=O)O)=O,,,4,1,1,0,1
17648_0,,,,2,1,2,3
17650_0,,,,2,1,2,3
C(C(C=CC(C(C)=O)O)O)=O,,,4,1,1,0,1
17652_0,,,,2,1,2,3
C(C(C(CO)=C)C(C=O)O)=O,,,4,1,1,0,1
17654_0,,,,2,1,2,3
C(C(C(C=O)=C(CO)C)O)=O,,,4,1,1,0,1
17656_0,,,,2,1,2,3
C(C=C(C=O)C(CO)(C)O)=O,,,4,1,2,0,2
17657_0,,,,2,1,2,3
17659_0,,,,2,1,2,3
C(C)=CC(CO)=O,,,4,1,1,0,1
17661_0,,,,2,1,2,3
C(CO)(CC=C)=O,,,4,1,1,0,1
17663_0,,,,2,1,2,3
C(C)(C(C=C)O)=O,,,4,1,1,0,1
17665_0,,,,2,1,2,3
C(CC(CO)=C)=O,,,4,1,1,0,1
17667_0,,,,2,1,2,3
C(C)(CO)=CC=O,,,4,1,1,0,1
17669_0,,,,2,1,2,3
C(CO)(C(CO)O)=CC(CO)=O,,,4,1,1,0,1
17671_0,,,,2,1,2,3
C(C(CO)O)(C(C(CO)=C)O)=O,,,4,1,1,0,1
17673_0,,,,2,1,2,3
C(C=C(C=O)C(C)O)=O,,,4,1,2,0,2
17675_0,,,,2,1,2,3
C(C(C(C=O)=CC)O)=O,,,4,1,1,0,1
17677_0,,,,2,1,2,3
C(C(C=C)C(C=O)O)=O,,,4,1,1,0,1
17678_0,,,,2,1,2,3
17679_0,,,,2,1,2,3
17681_0,,,,2,1,2,3
C(CC=CC(C=O)O)=O,,,4,1,1,0,1
17683_0,,,,2,1,2,3
C(C(CC=CC=O)O)=O,,,4,1,1,0,1
17685_0,,,,2,1,2,3
C(C)=CC=O,,,4,1,1,0,1
17687_0,,,,2,1,2,3
C(CC=C)=O,,,4,1,1,0,1
17689_0,,,,2,1,2,3
C(CO)(C(CO)O)=CC=O,,,4,1,1,0,1
17690_0,,,,2,1,2,3
17692_0,,,,2,1,2,3
C(CCO)(CC(C=CC=O)=O)=O,,,4,1,1,0,1
17693_0,,,,2,1,2,3
17695_0,,,,2,1,2,3
C(CCO)(CC(C=O)=CC=O)=O,,,4,1,1,0,1
17697_0,,,,2,1,2,3
C(CC(C=O)=CC(CCO)=O)=O,,,4,1,1,0,1
17698_0,,,,2,1,2,3
17700_0,,,,2,1,2,3
C(CCO)(CC(C=O)=O)=CC=O,,,4,1,1,0,1
17702_0,,,,2,1,2,3
C(CC(CCO)=CC(C=O)=O)=O,,,4,1,1,0,1
17704_0,,,,2,1,2,3
C(CC(CC(C=O)=O)=CCO)=O,,,4,1,2,0,2
17705_0,,,,2,1,2,3
17707_0,,,,2,1,2,3
C(CCO)(C(C=C)C(C=O)=O)=O,,,4,1,1,0,1
17709_0,,,,2,1,2,3
C(C)=C(C(CCO)=O)C(C=O)=O,,,4,1,1,0,1
17710_0,,,,2,1,2,3
17712_0,,,,2,1,2,3
C(CC(C=O)=O)(C(C=C)CO)=O,,,4,1,1,0,1
17714_0,,,,2,1,2,3
C(C)=C(C(CC(C=O)=O)=O)CO,,,4,1,1,0,1
17716_0,,,,2,1,2,3
C=C(C(CC(C=O)=O)=O)C(C)O,,,4,1,1,0,1
17718_0,,,,2,1,2,3
C(CO)(CCC(C=CC=O)=O)=O,,,4,1,1,0,1
17720_0,,,,2,1,2,3
C(CO)(CCC(C=O)=CC=O)=O,,,4,1,1,0,1
17722_0,,,,2,1,2,3
C(CC(C=O)=CCC(CO)=O)=O,,,4,1,1,0,1
17724_0,,,,2,1,2,3
C(CO)(CCC(C=O)=O)=CC=O,,,4,1,1,0,1
17726_0,,,,2,1,2,3
C(CC(CO)=CCC(C=O)=O)=O,,,4,1,1,0,1
17728_0,,,,2,1,2,3
C(CC(C=C)C(C=O)=O)(CO)=O,,,4,1,1,0,1
17730_0,,,,2,1,2,3
C(CO)(CC(C(C=O)=O)=CC)=O,,,4,1,1,0,1
17732_0,,,,2,1,2,3
C(CO)(C(C=C)CC(C=O)=O)=O,,,4,1,1,0,1
17734_0,,,,2,1,2,3
C(C)=C(C(CO)=O)CC(C=O)=O,,,4,1,1,0,1
17736_0,,,,2,1,2,3
C(CCC(C=O)=O)(C(C=C)O)=O,,,4,1,1,0,1
17738_0,,,,2,1,2,3
C(C)(C(CC(C=CC=O)=O)O)=O,,,4,1,1,0,1
17739_0,,,,2,1,2,3
17741_0,,,,2,1,2,3
C(C)(C(CC(C=O)=CC=O)O)=O,,,4,1,1,0,1
17743_0,,,,2,1,2,3
C(CC(C=O)=CC(C(C)=O)O)=O,,,4,1,1,0,1
17744_0,,,,2,1,2,3
17746_0,,,,2,1,2,3
C(C)(C(CC(C=O)=O)O)=CC=O,,,4,1,1,0,1
17747_0,,,,2,1,2,3
17749_0,,,,2,1,2,3
C(CC(C(CC(C=O)=O)O)=C)=O,,,4,1,1,0,1
17751_0,,,,2,1,2,3
C(C)(C(C(C=C)C(C=O)=O)O)=O,,,4,1,1,0,1
17753_0,,,,2,1,2,3
C(C)(C(C(C(C=O)=O)=CC)O)=O,,,4,1,1,0,1
17755_0,,,,2,1,2,3
C(C(C(C(C)O)=CC(C)=O)=O)=O,,,4,1,1,0,1
17757_0,,,,2,1,2,3
C(C(CC(C=O)=O)O)(CC=C)=O,,,4,1,1,0,1
17758_0,,,,2,1,2,3
17760_0,,,,2,1,2,3
C(C)=CC(C(CC(C=O)=O)O)=O,,,4,1,1,0,1
17761_0,,,,2,1,2,3
17762_0,,,,2,1,2,3
17763_0,,,,2,1,2,3
17765_0,,,,2,1,2,3
C(CC(CC(C=O)=CC=O)O)=O,,,4,1,1,0,1
17767_0,,,,2,1,2,3
C(CC(C=O)=CC(CC=O)O)=O,,,4,1,1,0,1
17768_0,,,,2,1,2,3
17769_0,,,,2,1,2,3
17771_0,,,,2,1,2,3
C(CC(CC(C=O)=O)O)=CC=O,,,4,1,1,0,1
17772_0,,,,2,1,2,3
17773_0,,,,2,1,2,3
17775_0,,,,2,1,2,3
C(CC=CC(CC(C=O)=O)O)=O,,,4,1,1,0,1
17777_0,,,,2,1,2,3
C(CC(C(C=C)C(C=O)=O)O)=O,,,4,1,1,0,1
17779_0,,,,2,1,2,3
C(CC(C(C(C=O)=O)=CC)O)=O,,,4,1,1,0,1
17781_0,,,,2,1,2,3
C(CC=C(C(C=O)=O)C(C)O)=O,,,4,1,1,0,1
17782_0,,,,2,1,2,3
17784_0,,,,2,1,2,3
C(C(C=C)C(CC(C=O)=O)O)=O,,,4,1,1,0,1
17785_0,,,,2,1,2,3
17787_0,,,,2,1,2,3
C(C)=C(C=O)C(CC(C=O)=O)O,,,4,1,1,0,1
17789_0,,,,2,1,2,3
C(CC(C=O)=O)=C(C=O)C(C)O,,,4,1,1,0,1
17791_0,,,,2,1,2,3
C(CC(C(CCO)=O)=O)=CC=O,,,4,1,1,0,1
17793_0,,,,2,1,2,3
C(CC=CC(C(CCO)=O)=O)=O,,,4,1,1,0,1
17794_0,,,,2,1,2,3
17796_0,,,,2,1,2,3
C(CC(C(CCO)=O)=CC=O)=O,,,4,1,1,0,1
17797_0,,,,2,1,2,3
17799_0,,,,2,1,2,3
C(CC(C(CCO)=CC=O)=O)=O,,,4,1,1,0,1
17801_0,,,,2,1,2,3
C(CC(C(CC=O)=CCO)=O)=O,,,4,1,1,0,1
17802_0,,,,2,1,2,3
17804_0,,,,2,1,2,3
C(C(C=C)C(C(CCO)=O)=O)=O,,,4,1,1,0,1
17806_0,,,,2,1,2,3
C(C)=C(C=O)C(C(CCO)=O)=O,,,4,1,1,0,1
17807_0,,,,2,1,2,3
17809_0,,,,2,1,2,3
C(CC(C(C(C=C)CO)=O)=O)=O,,,4,1,1,0,1
17811_0,,,,2,1,2,3
C(CC(C(C(CO)=CC)=O)=O)=O,,,4,1,1,0,1
17813_0,,,,2,1,2,3
C(CC(C(C(C(C)O)=C)=O)=O)=O,,,4,1,1,0,1
17815_0,,,,2,1,2,3
C(CC(CO)=O)(CC=CC=O)=O,,,4,1,1,0,1
17817_0,,,,2,1,2,3
C(CC=CC(CC(CO)=O)=O)=O,,,4,1,1,0,1
17819_0,,,,2,1,2,3
C(CC(CC(CO)=O)=CC=O)=O,,,4,1,2,0,2
17821_0,,,,2,1,2,3
C(CC(CC=O)=CC(CO)=O)=O,,,4,1,1,0,1
17823_0,,,,2,1,2,3
C(CC=O)(CC(CO)=CC=O)=O,,,4,1,1,0,1
17825_0,,,,2,1,2,3
C(CC(CO)=CC(CC=O)=O)=O,,,4,1,1,0,1
17827_0,,,,2,1,2,3
C(C(C(CC(CO)=O)=O)C=C)=O,,,4,1,1,0,1
17829_0,,,,2,1,2,3
C(CO)(CC(C(C=O)=CC)=O)=O,,,4,1,1,0,1
17831_0,,,,2,1,2,3
C(CC(C(C(CO)=O)C=C)=O)=O,,,4,1,1,0,1
17833_0,,,,2,1,2,3
C(CC(C(C(CO)=O)=CC)=O)=O,,,4,1,1,0,1
17835_0,,,,2,1,2,3
C(CC(CC(C(C=C)O)=O)=O)=O,,,4,1,1,0,1
17837_0,,,,2,1,2,3
C(C(C(C)=O)O)(CC=CC=O)=O,,,4,1,1,0,1
17839_0,,,,2,1,2,3
C(CC=CC(C(C(C)=O)O)=O)=O,,,4,1,1,0,1
17841_0,,,,2,1,2,3
C(CC(C(C(C)=O)O)=CC=O)=O,,,4,1,1,0,1
17843_0,,,,2,1,2,3
C(CC(C(C(C)=CC=O)O)=O)=O,,,4,1,1,0,1
17845_0,,,,2,1,2,3
C(CC(C(C(CC=O)=O)O)=C)=O,,,4,1,1,0,1
17847_0,,,,2,1,2,3
C(C(C(C(C(C)=O)O)=O)C=C)=O,,,4,1,1,0,1
17849_0,,,,2,1,2,3
C(C)(C(C(C(C=O)=CC)=O)O)=O,,,4,1,1,0,1
17851_0,,,,2,1,2,3
C(CC(C(C(CC=C)=O)O)=O)=O,,,4,1,1,0,1
17853_0,,,,2,1,2,3
C(CC(C(C(C=CC)=O)O)=O)=O,,,4,1,1,0,1
17855_0,,,,2,1,2,3
C(CC(C(CC=O)O)=CC=O)=O,,,4,1,1,0,1
17856_0,,,,2,1,2,3
17858_0,,,,2,1,2,3
C(CC(C(CC=CC=O)O)=O)=O,,,4,1,1,0,1
17859_0,,,,2,1,2,3
17861_0,,,,2,1,2,3
C(CC(C(C=CCC=O)O)=O)=O,,,4,1,1,0,1
17863_0,,,,2,1,2,3
C(C(C(C(CC=O)O)=O)C=C)=O,,,4,1,1,0,1
17865_0,,,,2,1,2,3
C(CC(C(C(C=O)=CC)=O)O)=O,,,4,1,1,0,1
17866_0,,,,2,1,2,3
17868_0,,,,2,1,2,3
C(C(C=C)C(C(CC=O)=O)O)=O,,,4,1,1,0,1
17870_0,,,,2,1,2,3
C(CC(C(C(C=O)=CC)O)=O)=O,,,4,1,1,0,1
17872_0,,,,2,1,2,3
C(CC(C=C(C=O)C(C)O)=O)=O,,,4,1,2,0,2
17874_0,,,,2,1,2,3
C(C(C=CC=O)O)(CC(C)=O)=O,,,4,1,1,0,1
17876_0,,,,2,1,2,3
C(C(C(CC(C)=O)=CC=O)O)=O,,,4,1,1,0,1
17878_0,,,,2,1,2,3
C(CC(C(C=O)O)=CC(C)=O)=O,,,4,1,1,0,1
17880_0,,,,2,1,2,3
C(C(C=O)O)(CC(C)=CC=O)=O,,,4,1,1,0,1
17882_0,,,,2,1,2,3
C(CC(C)=CC(C(C=O)O)=O)=O,,,4,1,1,0,1
17884_0,,,,2,1,2,3
C(CC(CC(C(C=O)O)=O)=C)=O,,,4,1,2,0,2
17886_0,,,,2,1,2,3
C(C(C(C(C(C)=O)C=C)=O)O)=O,,,4,1,1,0,1
17888_0,,,,2,1,2,3
C(C(C(C(C(C)=O)=CC)=O)O)=O,,,4,1,1,0,1
17890_0,,,,2,1,2,3
C(C(C(CC(CC=C)=O)=O)O)=O,,,4,1,1,0,1
17892_0,,,,2,1,2,3
C(C(C=O)O)(CC(C=CC)=O)=O,,,4,1,1,0,1
17893_0,,,,2,1,2,3
17895_0,,,,2,1,2,3
C(C(C(CCC=O)=CC=O)O)=O,,,4,1,1,0,1
17897_0,,,,2,1,2,3
C(CC(C(C=O)O)=CCC=O)=O,,,4,1,1,0,1
17899_0,,,,2,1,2,3
C(C(C(CCC=CC=O)=O)O)=O,,,4,1,1,0,1
17901_0,,,,2,1,2,3
C(CC=CCC(C(C=O)O)=O)=O,,,4,1,1,0,1
17902_0,,,,2,1,2,3
17904_0,,,,2,1,2,3
C(CC(C(C(C=O)O)=O)=CC)=O,,,4,1,1,0,1
17906_0,,,,2,1,2,3
C(C(C=C)CC(C(C=O)O)=O)=O,,,4,1,1,0,1
17908_0,,,,2,1,2,3
C(C(C=O)O)(CC(C=O)=CC)=O,,,4,1,1,0,1
17909_0,,,,2,1,2,3
17910_0,,,,2,1,2,3
17912_0,,,,2,1,2,3
C(C(CC(C(C)=O)=CC=O)O)=O,,,4,1,1,0,1
17913_0,,,,2,1,2,3
17915_0,,,,2,1,2,3
C(CC(C(C)=O)=CC(C=O)O)=O,,,4,1,1,0,1
17917_0,,,,2,1,2,3
C(C(CC(C(C)=CC=O)=O)O)=O,,,4,1,1,0,1
17918_0,,,,2,1,2,3
17920_0,,,,2,1,2,3
C(CC(C(CC(C=O)O)=O)=C)=O,,,4,1,1,0,1
17922_0,,,,2,1,2,3
C(C(C(C=C)C(C(C)=O)=O)O)=O,,,4,1,1,0,1
17924_0,,,,2,1,2,3
C(C(C(C(C(C)=O)=O)=CC)O)=O,,,4,1,1,0,1
17926_0,,,,2,1,2,3
C(C(C(C(C)O)=CC=O)=O)(C)=O,,,4,1,1,0,1
17928_0,,,,2,1,2,3
C(C(CC(C(CC=C)=O)=O)O)=O,,,4,1,1,0,1
17929_0,,,,2,1,2,3
17931_0,,,,2,1,2,3
C(C(CC(C(C=CC)=O)=O)O)=O,,,4,1,1,0,1
17932_0,,,,2,1,2,3
17933_0,,,,2,1,2,3
17935_0,,,,2,1,2,3
C(CC(CC(C=O)O)=CC=O)=O,,,4,1,1,0,1
17936_0,,,,2,1,2,3
17938_0,,,,2,1,2,3
C(CC(CC=O)=CC(C=O)O)=O,,,4,1,2,0,2
17940_0,,,,2,1,2,3
C(C(CC(CC=CC=O)=O)O)=O,,,4,1,1,0,1
17941_0,,,,2,1,2,3
17943_0,,,,2,1,2,3
C(CC=CC(CC(C=O)O)=O)=O,,,4,1,1,0,1
17945_0,,,,2,1,2,3
C(CC=O)(C(C=C)C(C=O)O)=O,,,4,1,1,0,1
17947_0,,,,2,1,2,3
C(CC(C(C(C=O)O)=CC)=O)=O,,,4,1,1,0,1
17949_0,,,,2,1,2,3
C(CC(C(C(C)O)=CC=O)=O)=O,,,4,1,2,0,2
17951_0,,,,2,1,2,3
C(C(C(CC(C=O)O)=O)C=C)=O,,,4,1,1,0,1
17952_0,,,,2,1,2,3
17954_0,,,,2,1,2,3
C(C(CC(C(C=O)=CC)=O)O)=O,,,4,1,1,0,1
17956_0,,,,2,1,2,3
C(C(CO)O)=CC(C=CC=O)=O,,,4,1,1,0,1
17958_0,,,,2,1,2,3
C(C(CO)O)=CC(C=O)=CC=O,,,4,1,1,0,1
17960_0,,,,2,1,2,3
C(C(C(C=CCO)=O)O)=CC=O,,,4,1,1,0,1
17962_0,,,,2,1,2,3
C(C(C(C=CCO)=CC=O)O)=O,,,4,1,1,0,1
17964_0,,,,2,1,2,3
C(C=CC=CC(C(CO)O)=O)=O,,,4,1,1,0,1
17966_0,,,,2,1,2,3
C(C=CC(C(CO)O)=CC=O)=O,,,4,1,1,0,1
17967_0,,,,2,1,2,3
17969_0,,,,2,1,2,3
C(C(C(C(C=C)=CC=O)O)O)=O,,,4,1,1,0,1
17971_0,,,,2,1,2,3
C(C(C=CC(CO)=O)O)=CC=O,,,4,1,1,0,1
17973_0,,,,2,1,2,3
C(C(C=CC(CO)=CC=O)O)=O,,,4,1,1,0,1
17975_0,,,,2,1,2,3
C(C(C=CC(C(C=C)O)=O)O)=O,,,4,1,1,0,1
17977_0,,,,2,1,2,3
C(C(C(C=CC=O)O)O)=CC=O,,,4,1,1,0,1
17979_0,,,,2,1,2,3
C(C(C(C=CC=CC=O)O)O)=O,,,4,1,1,0,1
17980_0,,,,2,1,2,3
17981_0,,,,2,1,2,3
17983_0,,,,2,1,2,3
C(C(C(CO)=CC=O)O)=O,,,4,1,1,0,1
17985_0,,,,2,1,2,3
C(CO)=C(C=O)C(CO)=O,,,4,1,1,0,1
17987_0,,,,2,1,2,3
C(C(C(C(C=O)O)=C)O)=O,,,4,1,1,0,1
17989_0,,,,2,1,2,3
C(C(C(C(CO)O)=C)O)=O,,,4,1,1,0,1
17990_0,,,,2,1,2,3
17992_0,,,,2,1,2,3
C(C(C=C(CO)C(C=O)O)O)=O,,,4,1,1,0,1
17994_0,,,,2,1,2,3
C(C(C(C(CO)=O)=CCO)O)=O,,,4,1,1,0,1
17996_0,,,,2,1,2,3
C(C=C(C(CO)=O)C(CO)O)=O,,,4,1,1,0,1
17997_0,,,,2,1,2,3
17999_0,,,,2,1,2,3
C(C(C(C=O)=CCO)O)=O,,,4,1,2,0,2
18000_0,,,,2,1,2,3
18002_0,,,,2,1,2,3
C(CO)=C(C(C=O)=O)CO,,,4,1,1,0,1
18004_0,,,,2,1,2,3
C=C(C(C=O)=O)C(CO)O,,,4,1,1,0,1
18006_0,,,,2,1,2,3
C(C(C(CO)=CCO)O)=O,,,4,1,1,0,1
18007_0,,,,2,1,2,3
18009_0,,,,2,1,2,3
C(CO)=C(C(CO)=O)CO,,,4,1,1,0,1
18011_0,,,,2,1,2,3
C=C(C(CO)=O)C(CO)O,,,4,1,1,0,1
18013_0,,,,2,1,2,3
C(C(C(C(C(C=O)O)O)=C)O)=O,,,4,1,1,0,1
18015_0,,,,2,1,2,3
C(C(C(C(C=CCO)=O)O)O)=O,,,4,1,1,0,1
18017_0,,,,2,1,2,3
C(C(C(CO)=C)O)=O,,,4,1,1,0,1
18018_0,,,,2,1,2,3
18019_0,,,,2,1,2,3
18021_0,,,,2,1,2,3
C(C=C(C=O)C(CO)O)=O,,,4,1,2,0,2
18022_0,,,,2,1,2,3
18023_0,,,,2,1,2,3
18025_0,,,,2,1,2,3
C(C(C(CO)O)O)=CC(C=O)=O,,,4,1,1,0,1
18027_0,,,,2,1,2,3
C(C(C(CO)O)O)=CC(CO)=O,,,4,1,1,0,1
18029_0,,,,2,1,2,3
C=C(C=O)C(C(C(CO)O)O)=O,,,4,1,1,0,1
18031_0,,,,2,1,2,3
C(C(C(C(CO)=CCO)=O)O)=O,,,4,1,2,0,2
18033_0,,,,2,1,2,3
C(C(C(C(C(CO)O)=C)=O)O)=O,,,4,1,1,0,1
18035_0,,,,2,1,2,3
C(C(CO)=CC=O)(C(CO)O)=O,,,4,1,2,0,2
18037_0,,,,2,1,2,3
C(C(C(C(C(CO)O)=O)=C)O)=O,,,4,1,1,0,1
18039_0,,,,2,1,2,3
C(C(C(C(C(CO)=C)=O)O)O)=O,,,4,1,2,0,2
18041_0,,,,2,1,2,3
C(C(C(C=C(C=O)CO)O)O)=O,,,4,1,2,0,2
18043_0,,,,2,1,2,3
C(C(C(C(C(C=O)=C)O)O)O)=O,,,4,1,1,0,1
18045_0,,,,2,1,2,3
C=CC(O)=O,,,4,1,1,0,1
18047_0,,,,2,1,2,3
C(CO)=CC(O)=O,,,4,1,1,0,1
18048_0,,,,2,1,2,3
18050_0,,,,2,1,2,3
C(C(CO)O)=C(C(O)=O)CO,,,4,1,1,0,1
18051_0,,,,2,1,2,3
18052_0,,,,2,1,2,3
18053_0,,,,2,1,2,3
18054_0,,,,2,1,2,3
18055_0,,,,2,1,2,3
18056_0,,,,2,1,2,3
18057_0,,,,2,1,2,3
18058_0,,,,2,1,2,3
18059_0,,,,2,1,2,3
18060_0,,,,2,1,2,3
18061_0,,,,2,1,2,3
18063_0,,,,2,1,2,3
C(C(CCO)=CC=O)(O)=O,,,4,1,1,0,1
18065_0,,,,2,1,2,3
C(CC(C(O)=O)=CCO)=O,,,4,1,1,0,1
18066_0,,,,2,1,2,3
18067_0,,,,2,1,2,3
18069_0,,,,2,1,2,3
C(C(C=C(C(O)=O)C)O)=O,,,4,1,1,0,1
18071_0,,,,2,1,2,3
C(C(CC(C(O)=O)=C)O)=O,,,4,1,1,0,1
18072_0,,,,2,1,2,3
18073_0,,,,2,1,2,3
18074_0,,,,2,1,2,3
18075_0,,,,2,1,2,3
18076_0,,,,2,1,2,3
18077_0,,,,2,1,2,3
18078_0,,,,2,1,2,3
18079_0,,,,2,1,2,3
18080_0,,,,2,1,2,3
18081_0,,,,2,1,2,3
18082_0,,,,2,1,2,3
18083_0,,,,2,1,2,3
18084_0,,,,2,1,2,3
18085_0,,,,2,1,2,3
18086_0,,,,2,1,2,3
18087_0,,,,2,1,2,3
18088_0,,,,2,1,2,3
18089_0,,,,2,1,2,3
18090_0,,,,2,1,2,3
18091_0,,,,2,1,2,3
18092_0,,,,2,1,2,3
18093_0,,,,2,1,2,3
18094_0,,,,2,1,2,3
18095_0,,,,2,1,2,3
18096_0,,,,2,1,2,3
18097_0,,,,2,1,2,3
18098_0,,,,2,1,2,3
18099_0,,,,2,1,2,3
18100_0,,,,2,1,2,3
18101_0,,,,2,1,2,3
18102_0,,,,2,1,2,3
18103_0,,,,2,1,2,3
18104_0,,,,2,1,2,3
18105_0,,,,2,1,2,3
18106_0,,,,2,1,2,3
18107_0,,,,2,1,2,3
18108_0,,,,2,1,2,3
18109_0,,,,2,1,2,3
18110_0,,,,2,1,2,3
18111_0,,,,2,1,2,3
18112_0,,,,2,1,2,3
18113_0,,,,2,1,2,3
18114_0,,,,2,1,2,3
18115_0,,,,2,1,2,3
18116_0,,,,2,1,2,3
18117_0,,,,2,1,2,3
18118_0,,,,2,1,2,3
18119_0,,,,2,1,2,3
18120_0,,,,2,1,2,3
18121_0,,,,2,1,2,3
18122_0,,,,2,1,2,3
18123_0,,,,2,1,2,3
18124_0,,,,2,1,2,3
18125_0,,,,2,1,2,3
18126_0,,,,2,1,2,3
18127_0,,,,2,1,2,3
18128_0,,,,2,1,2,3
18129_0,,,,2,1,2,3
18130_0,,,,2,1,2,3
18131_0,,,,2,1,2,3
18132_0,,,,2,1,2,3
18133_0,,,,2,1,2,3
18134_0,,,,2,1,2,3
18135_0,,,,2,1,2,3
18136_0,,,,2,1,2,3
18137_0,,,,2,1,2,3
18138_0,,,,2,1,2,3
18139_0,,,,2,1,2,3
18140_0,,,,2,1,2,3
18141_0,,,,2,1,2,3
18142_0,,,,2,1,2,3
18143_0,,,,2,1,2,3
18144_0,,,,2,1,2,3
18145_0,,,,2,1,2,3
18146_0,,,,2,1,2,3
18147_0,,,,2,1,2,3
18148_0,,,,2,1,2,3
18149_0,,,,2,1,2,3
18150_0,,,,2,1,2,3
18152_0,,,,2,1,2,3
C=C1C(C(C(C1O)O)O)O,,,4,1,1,0,1
18154_0,,,,2,1,2,3
C=C,,,4,1,1,0,1
18155_0,,,,2,1,2,3
18156_0,,,,2,1,2,3
18157_0,,,,2,1,2,3
18158_0,,,,2,1,2,3
18159_0,,,,2,1,2,3
18160_0,,,,2,1,2,3
18161_0,,,,2,1,2,3
18162_0,,,,2,1,2,3
18163_0,,,,2,1,2,3
18164_0,,,,2,1,2,3
18165_0,,,,2,1,2,3
18166_0,,,,2,1,2,3
18167_0,,,,2,1,2,3
18168_0,,,,2,1,2,3
18169_0,,,,2,1,2,3
18170_0,,,,2,1,2,3
18171_0,,,,2,1,2,3
18172_0,,,,2,1,2,3
18173_0,,,,2,1,2,3
18174_0,,,,2,1,2,3
18175_0,,,,2,1,2,3
18176_0,,,,2,1,2,3
18178_0,,,,2,1,2,3
C=CC1C(C(C(O1)O)O)O,,,4,1,2,0,2
18179_0,,,,2,1,2,3
18180_0,,,,2,1,2,3
18182_0,,,,2,1,2,3
C=CC1(C(C(CO1)O)O)O,,,4,1,2,0,2
18183_0,,,,2,1,2,3
18184_0,,,,2,1,2,3
18185_0,,,,2,1,2,3
18186_0,,,,2,1,2,3
18187_0,,,,2,1,2,3
18188_0,,,,2,1,2,3
18189_0,,,,2,1,2,3
18190_0,,,,2,1,2,3
18191_0,,,,2,1,2,3
18192_0,,,,2,1,2,3
18193_0,,,,2,1,2,3
18194_0,,,,2,1,2,3
18195_0,,,,2,1,2,3
18196_0,,,,2,1,2,3
18197_0,,,,2,1,2,3
18198_0,,,,2,1,2,3
18199_0,,,,2,1,2,3
18200_0,,,,2,1,2,3
18201_0,,,,2,1,2,3
18202_0,,,,2,1,2,3
18203_0,,,,2,1,2,3
18204_0,,,,2,1,2,3
18205_0,,,,2,1,2,3
18206_0,,,,2,1,2,3
18207_0,,,,2,1,2,3
18208_0,,,,2,1,2,3
18209_0,,,,2,1,2,3
18210_0,,,,2,1,2,3
18211_0,,,,2,1,2,3
18212_0,,,,2,1,2,3
18213_0,,,,2,1,2,3
18214_0,,,,2,1,2,3
18215_0,,,,2,1,2,3
18216_0,,,,2,1,2,3
18217_0,,,,2,1,2,3
18218_0,,,,2,1,2,3
18219_0,,,,2,1,2,3
18220_0,,,,2,1,2,3
18221_0,,,,2,1,2,3
18222_0,,,,2,1,2,3
18223_0,,,,2,1,2,3
18224_0,,,,2,1,2,3
18225_0,,,,2,1,2,3
18226_0,,,,2,1,2,3
18228_0,,,,2,1,2,3
C1(C(C=CC1(CO)O)O)=O,,,4,1,1,0,1
18229_0,,,,2,1,2,3
18230_0,,,,2,1,2,3
18231_0,,,,2,1,2,3
18233_0,,,,2,1,2,3
C(C(C(C=O)=C)(CO)O)=O,,,4,1,1,0,1
18234_0,,,,2,1,2,3
18236_0,,,,2,1,2,3
C(C(C(CO)=CC=O)(CO)O)=O,,,4,1,1,0,1
18238_0,,,,2,1,2,3
C(C(C(C(C=O)O)=C)(CO)O)=O,,,4,1,1,0,1
18240_0,,,,2,1,2,3
C(C(C(C(CO)O)=C)(CO)O)=O,,,4,1,1,0,1
18241_0,,,,2,1,2,3
18243_0,,,,2,1,2,3
C(C(C(C=O)=CCO)(CO)O)=O,,,4,1,1,0,1
18244_0,,,,2,1,2,3
18246_0,,,,2,1,2,3
C(C(C(CO)=CCO)(CO)O)=O,,,4,1,1,0,1
18247_0,,,,2,1,2,3
18249_0,,,,2,1,2,3
C(C(C(CO)=C)(CO)O)=O,,,4,1,1,0,1
18250_0,,,,2,1,2,3
18251_0,,,,2,1,2,3
18252_0,,,,2,1,2,3
18254_0,,,,2,1,2,3
C(C(C=C)(CO)O)=O,,,4,1,1,0,1
18256_0,,,,2,1,2,3
C(C(C(C)=O)(C(C=O)=C)O)=O,,,4,1,1,0,1
18258_0,,,,2,1,2,3
C(C)(C(C(C=O)=C)(CO)O)=O,,,4,1,1,0,1
18260_0,,,,2,1,2,3
C(C(C=O)(C(C=O)=C)O)=O,,,4,1,1,0,1
18262_0,,,,2,1,2,3
C(C(C(C=O)=C)(C(C=O)O)O)=O,,,4,1,1,0,1
18264_0,,,,2,1,2,3
C(CO)(C(C(C=O)=C)(CO)O)=O,,,4,1,1,0,1
18266_0,,,,2,1,2,3
C(C(C=O)(C=CC(CO)=O)O)=O,,,4,1,1,0,1
18268_0,,,,2,1,2,3
C(C(C=O)(C(CO)=CC=O)O)=O,,,4,1,1,0,1
18270_0,,,,2,1,2,3
C(C(C=O)(C(C(C=O)O)=C)O)=O,,,4,1,1,0,1
18272_0,,,,2,1,2,3
C(C(C(C)=O)(C(CO)=C)O)=O,,,4,1,1,0,1
18274_0,,,,2,1,2,3
C(C(C(C)=O)(C=C)O)=O,,,4,1,1,0,1
18276_0,,,,2,1,2,3
C(C(C=O)(C(C(CO)O)=C)O)=O,,,4,1,1,0,1
18278_0,,,,2,1,2,3
C(C)(C(C(CO)=C)(CO)O)=O,,,4,1,1,0,1
18280_0,,,,2,1,2,3
C(C)(C(C=C)(CO)O)=O,,,4,1,1,0,1
18281_0,,,,2,1,2,3
18282_0,,,,2,1,2,3
18283_0,,,,2,1,2,3
18284_0,,,,2,1,2,3
18285_0,,,,2,1,2,3
18286_0,,,,2,1,2,3
18287_0,,,,2,1,2,3
18288_0,,,,2,1,2,3
18289_0,,,,2,1,2,3
18290_0,,,,2,1,2,3
18291_0,,,,2,1,2,3
18293_0,,,,2,1,2,3
C=C1C(OC(C(CO)O)C1O)=O,,,4,1,1,0,1
18295_0,,,,2,1,2,3
C1C(C(CO)O)OC(C=1CO)=O,,,4,1,1,0,1
18296_0,,,,2,1,2,3
18298_0,,,,2,1,2,3
C=C1C(OC(CO)C(C1O)O)=O,,,4,1,1,0,1
18300_0,,,,2,1,2,3
C1C(C(CO)OC(C=1CO)=O)O,,,4,1,1,0,1
18301_0,,,,2,1,2,3
18302_0,,,,2,1,2,3
18304_0,,,,2,1,2,3
C=C1C(OCC(C(C1O)O)O)=O,,,4,1,1,0,1
18306_0,,,,2,1,2,3
C1C(C(COC(C=1CO)=O)O)O,,,4,1,1,0,1
18307_0,,,,2,1,2,3
18308_0,,,,2,1,2,3
18309_0,,,,2,1,2,3
18310_0,,,,2,1,2,3
18311_0,,,,2,1,2,3
18312_0,,,,2,1,2,3
18313_0,,,,2,1,2,3
18314_0,,,,2,1,2,3
18315_0,,,,2,1,2,3
18316_0,,,,2,1,2,3
18317_0,,,,2,1,2,3
18318_0,,,,2,1,2,3
18319_0,,,,2,1,2,3
18321_0,,,,2,1,2,3
C(C(C=O)(C(C=O)=CCO)O)=O,,,4,1,1,0,1
18322_0,,,,2,1,2,3
18324_0,,,,2,1,2,3
C(C(C=O)(C(CO)=CCO)O)=O,,,4,1,1,0,1
18325_0,,,,2,1,2,3
18326_0,,,,2,1,2,3
18328_0,,,,2,1,2,3
C(C(C(C(C)=O)(C=C)O)O)=O,,,4,1,1,0,1
18330_0,,,,2,1,2,3
C(C(C=O)(C(CO)=C)O)=O,,,4,1,1,0,1
18331_0,,,,2,1,2,3
18332_0,,,,2,1,2,3
18334_0,,,,2,1,2,3
C(C(C=O)(C=CC(C=O)O)O)=O,,,4,1,1,0,1
18336_0,,,,2,1,2,3
C(C(C=O)(C=C)O)=O,,,4,1,1,0,1
18338_0,,,,2,1,2,3
C(C(C(CO)=C)(C(C=O)O)O)=O,,,4,1,1,0,1
18340_0,,,,2,1,2,3
C(CO)(C(C(CO)=C)(CO)O)=O,,,4,1,1,0,1
18341_0,,,,2,1,2,3
18343_0,,,,2,1,2,3
C(CO)(C(C=C)(CO)O)=O,,,4,1,1,0,1
18345_0,,,,2,1,2,3
C(C(C=C)(C(CO)O)O)(O)=O,,,4,1,1,0,1
18347_0,,,,2,1,2,3
C(CC(C(C(C)=O)(C=C)O)=O)=O,,,4,1,1,0,1
18349_0,,,,2,1,2,3
C(C(C(CC(C)=O)=O)(C=C)O)=O,,,4,1,1,0,1
18351_0,,,,2,1,2,3
C(C(C(CCC=O)=O)(C=C)O)=O,,,4,1,1,0,1
18353_0,,,,2,1,2,3
C(C(C=C)(C(C=CCO)=O)O)=O,,,4,1,1,0,1
18355_0,,,,2,1,2,3
C=CC(C(C=CC=O)=O)(CO)O,,,4,1,1,0,1
18356_0,,,,2,1,2,3
18358_0,,,,2,1,2,3
C(C(C(C=C)(C(C=C)=O)O)O)=O,,,4,1,1,0,1
18360_0,,,,2,1,2,3
C(C(C=C)(C(C=CC=O)O)O)=O,,,4,1,1,0,1
18362_0,,,,2,1,2,3
C(C(C(C=O)=C)(C(CO)O)O)=O,,,4,1,1,0,1
18364_0,,,,2,1,2,3
C(C(C(CO)=C)(C(CO)O)O)=O,,,4,1,1,0,1
18366_0,,,,2,1,2,3
C(C(C=C)(C(CO)O)O)=O,,,4,1,1,0,1
18367_0,,,,2,1,2,3
18368_0,,,,2,1,2,3
18369_0,,,,2,1,2,3
18370_0,,,,2,1,2,3
18371_0,,,,2,1,2,3
18372_0,,,,2,1,2,3
18373_0,,,,2,1,2,3
18374_0,,,,2,1,2,3
18375_0,,,,2,1,2,3
18376_0,,,,2,1,2,3
18377_0,,,,2,1,2,3
18379_0,,,,2,1,2,3
C(C(C(C=O)=C)(CC=O)O)=O,,,4,1,1,0,1
18380_0,,,,2,1,2,3
18382_0,,,,2,1,2,3
C(C(C(C=O)=C)O)(O)=O,,,4,1,1,0,1
18384_0,,,,2,1,2,3
C(C(C(CO)=CC=O)O)(O)=O,,,4,1,1,0,1
18386_0,,,,2,1,2,3
C(C(C(C(C=O)O)=C)O)(O)=O,,,4,1,1,0,1
18388_0,,,,2,1,2,3
C(C(C(C=O)=CC(CO)=O)O)=O,,,4,1,1,0,1
18389_0,,,,2,1,2,3
18391_0,,,,2,1,2,3
C(C(C(C(CO)O)=C)O)(O)=O,,,4,1,1,0,1
18393_0,,,,2,1,2,3
C(C(CO)=CC(CO)=O)=O,,,4,1,1,0,1
18395_0,,,,2,1,2,3
C(C(C(C)O)=CC(CO)=O)=O,,,4,1,1,0,1
18396_0,,,,2,1,2,3
18397_0,,,,2,1,2,3
18398_0,,,,2,1,2,3
18399_0,,,,2,1,2,3
18400_0,,,,2,1,2,3
18401_0,,,,2,1,2,3
18402_0,,,,2,1,2,3
18403_0,,,,2,1,2,3
18404_0,,,,2,1,2,3
18405_0,,,,2,1,2,3
18406_0,,,,2,1,2,3
18407_0,,,,2,1,2,3
18408_0,,,,2,1,2,3
18409_0,,,,2,1,2,3
18410_0,,,,2,1,2,3
18412_0,,,,2,1,2,3
C(C(C=C(C(C)=O)CO)=O)=O,,,4,1,1,0,1
18413_0,,,,2,1,2,3
18415_0,,,,2,1,2,3
C(C(CO)=CC(C(C)=O)=O)=O,,,4,1,1,0,1
18416_0,,,,2,1,2,3
18417_0,,,,2,1,2,3
18418_0,,,,2,1,2,3
18420_0,,,,2,1,2,3
C(C(C(C=O)=CCO)O)(O)=O,,,4,1,1,0,1
18421_0,,,,2,1,2,3
18423_0,,,,2,1,2,3
C(C(C(CO)=CCO)O)(O)=O,,,4,1,1,0,1
18424_0,,,,2,1,2,3
18425_0,,,,2,1,2,3
18427_0,,,,2,1,2,3
C(C(C(CO)=C)(CC=O)O)=O,,,4,1,1,0,1
18428_0,,,,2,1,2,3
18430_0,,,,2,1,2,3
C(C(C(CO)=C)O)(O)=O,,,4,1,1,0,1
18431_0,,,,2,1,2,3
18432_0,,,,2,1,2,3
18433_0,,,,2,1,2,3
18435_0,,,,2,1,2,3
C(C)(C(C=C)(CC(C=O)=O)O)=O,,,4,1,1,0,1
18437_0,,,,2,1,2,3
C(C(C=C(C(C)=O)C(C)O)=O)=O,,,4,1,1,0,1
18438_0,,,,2,1,2,3
18439_0,,,,2,1,2,3
18440_0,,,,2,1,2,3
18442_0,,,,2,1,2,3
C(C(C=C(C=O)C(C)O)=O)(C)=O,,,4,1,1,0,1
18443_0,,,,2,1,2,3
18444_0,,,,2,1,2,3
18446_0,,,,2,1,2,3
C(C(C=C)(C=CC(CO)=O)O)=O,,,4,1,1,0,1
18448_0,,,,2,1,2,3
C(C(C(CO)O)=CC(CO)=O)=O,,,4,1,1,0,1
18449_0,,,,2,1,2,3
18450_0,,,,2,1,2,3
18451_0,,,,2,1,2,3
18452_0,,,,2,1,2,3
18453_0,,,,2,1,2,3
18454_0,,,,2,1,2,3
18455_0,,,,2,1,2,3
18456_0,,,,2,1,2,3
18457_0,,,,2,1,2,3
18458_0,,,,2,1,2,3
18459_0,,,,2,1,2,3
18460_0,,,,2,1,2,3
18461_0,,,,2,1,2,3
18462_0,,,,2,1,2,3
18463_0,,,,2,1,2,3
18464_0,,,,2,1,2,3
18465_0,,,,2,1,2,3
18466_0,,,,2,1,2,3
18468_0,,,,2,1,2,3
C1(CO)OC(C(C=1)=O)CO,,,4,1,1,0,1
18469_0,,,,2,1,2,3
18470_0,,,,2,1,2,3
18472_0,,,,2,1,2,3
C(CC1OCC(C=1)=O)=O,,,4,1,1,0,1
18473_0,,,,2,1,2,3
18474_0,,,,2,1,2,3
18476_0,,,,2,1,2,3
C(C1C(C=C(C)O1)=O)=O,,,4,1,1,0,1
18477_0,,,,2,1,2,3
18478_0,,,,2,1,2,3
18480_0,,,,2,1,2,3
C1COC(C(C=1)=O)(CO)O,,,4,1,1,0,1
18482_0,,,,2,1,2,3
C1(CO)OCC(C(C=1)=O)O,,,4,1,1,0,1
18484_0,,,,2,1,2,3
C1C(CO)(OCC(C=1)=O)O,,,4,1,2,0,2
18485_0,,,,2,1,2,3
18486_0,,,,2,1,2,3
18487_0,,,,2,1,2,3
18488_0,,,,2,1,2,3
18490_0,,,,2,1,2,3
C1C(CO)OC(C(C=1)=O)=O,,,4,1,1,0,1
18492_0,,,,2,1,2,3
C1(C=CC(C(CO)O1)=O)=O,,,4,1,1,0,1
18494_0,,,,2,1,2,3
C1C(COC(C(C=1)=O)=O)O,,,4,1,1,0,1
18496_0,,,,2,1,2,3
C1(C(C(C=CCO1)=O)O)=O,,,4,1,1,0,1
18498_0,,,,2,1,2,3
C1(C=CC(C(CO1)O)=O)=O,,,4,1,1,0,1
18500_0,,,,2,1,2,3
C1(C(C=CC(CO1)=O)O)=O,,,4,1,1,0,1
18502_0,,,,2,1,2,3
C1C2C(C(C(C=1)(O2)O)O)O,,,4,1,2,0,2
18503_0,,,,2,1,2,3
18505_0,,,,2,1,2,3
C1(C(CO)O)OCC(C=1)=O,,,4,1,1,0,1
18506_0,,,,2,1,2,3
18507_0,,,,2,1,2,3
18509_0,,,,2,1,2,3
C1(COC(C1O)=CCO)=O,,,4,1,1,0,1
18511_0,,,,2,1,2,3
C1(COC(C=C)(C1O)O)=O,,,4,1,2,0,2
18513_0,,,,2,1,2,3
C1(C(C(OC1C=C)O)O)=O,,,4,1,2,0,2
18514_0,,,,2,1,2,3
18515_0,,,,2,1,2,3
18517_0,,,,2,1,2,3
C1C(C(CO)O)(O)OC(C=1)=O,,,4,1,1,0,1
18519_0,,,,2,1,2,3
C1(C(C=C(C(CO)O)O1)O)=O,,,4,1,1,0,1
18521_0,,,,2,1,2,3
C1(C(C(C(O1)=CCO)O)O)=O,,,4,1,1,0,1
18523_0,,,,2,1,2,3
C1(C(C(C(C=C)(O)O1)O)O)=O,,,4,1,2,0,2
18525_0,,,,2,1,2,3
C1C2(C(OC(C=1)C2O)O)O,,,4,1,2,0,2
18527_0,,,,2,1,2,3
C1OC2C(COC2(C=1)O)O,,,4,1,2,0,2
18529_0,,,,2,1,2,3
C12C(C(CO1)O)OC(C=2)O,,,4,1,1,0,1
18531_0,,,,2,1,2,3
C=C1C2C(C(C(O2)O)O1)O,,,4,1,2,0,2
18533_0,,,,2,1,2,3
C1OC2C(C(OC2C=1)O)O,,,4,1,2,0,2
18535_0,,,,2,1,2,3
C1OC2COC(C=1)(C2O)O,,,4,1,2,0,2
18537_0,,,,2,1,2,3
C1C2COC(C(C=1)(O2)O)O,,,4,1,1,0,1
18539_0,,,,2,1,2,3
C1C2(C(COC(C=1)O2)O)O,,,4,1,1,0,1
18541_0,,,,2,1,2,3
C1C2C(O)OCC(C=1)(O2)O,,,4,1,1,0,1
18543_0,,,,2,1,2,3
C1OC2C(C(C=1)OC2O)O,,,4,1,2,0,2
18544_0,,,,2,1,2,3
18546_0,,,,2,1,2,3
C(C1(C(C=CCO1)O)O)=O,,,4,1,1,0,1
18547_0,,,,2,1,2,3
18549_0,,,,2,1,2,3
C1(COC(CO)=CC1O)=O,,,4,1,1,0,1
18551_0,,,,2,1,2,3
C(C1C=CC(C(O1)O)O)=O,,,4,1,2,0,2
18552_0,,,,2,1,2,3
18553_0,,,,2,1,2,3
18555_0,,,,2,1,2,3
C1(COC(C(C1O)O)=C)=O,,,4,1,1,0,1
18557_0,,,,2,1,2,3
C=C1C(C(C(CO1)O)O)O,,,4,1,1,0,1
18559_0,,,,2,1,2,3
C1(C(C=CC(CO)(O)O1)O)=O,,,4,1,1,0,1
18561_0,,,,2,1,2,3
C1(C(C(C=C(CO)O1)O)O)=O,,,4,1,1,0,1
18563_0,,,,2,1,2,3
C1(C(C(C(C(O1)=C)O)O)O)=O,,,4,1,1,0,1
18565_0,,,,2,1,2,3
C1C2COC(C=1)(C(O2)O)O,,,4,1,1,0,1
18566_0,,,,2,1,2,3
18568_0,,,,2,1,2,3
C1(COC=CC(C1O)O)=O,,,4,1,1,0,1
18570_0,,,,2,1,2,3
C1C(C(COC(C=1)O)O)O,,,4,1,1,0,1
18572_0,,,,2,1,2,3
C1OCC(C(C(C=1)O)O)O,,,4,1,1,0,1
18574_0,,,,2,1,2,3
C1C(C(C(OCC=1)O)O)O,,,4,1,1,0,1
18576_0,,,,2,1,2,3
C1(C(C(C=CC(O)O1)O)O)=O,,,4,1,1,0,1
18578_0,,,,2,1,2,3
C1(C(C(C(C=CO1)O)O)O)=O,,,4,1,1,0,1
18580_0,,,,2,1,2,3
C1C(C(C(O)OC(C=1)=O)O)O,,,4,1,1,0,1
18582_0,,,,2,1,2,3
C1OC2C(C(C(C=1)O2)O)O,,,4,1,1,0,1
18584_0,,,,2,1,2,3
C1C2C(C(OC(C=1)O2)O)O,,,4,1,1,0,1
18586_0,,,,2,1,2,3
C(C(C1C=CC(O1)=O)O)=O,,,4,1,1,0,1
18588_0,,,,2,1,2,3
C(C1C(C=CC(O1)=O)O)=O,,,4,1,1,0,1
18589_0,,,,2,1,2,3
18590_0,,,,2,1,2,3
18591_0,,,,2,1,2,3
18592_0,,,,2,1,2,3
18594_0,,,,2,2,1,3
C1(C(C(C(C1O)O)O)O)O,,,4,1,1,0,1
18595_0,,,,2,2,1,3
18596_0,,,,2,2,1,3
18597_0,,,,2,2,1,3
18598_0,,,,2,2,1,3
18599_0,,,,2,2,1,3
18600_0,,,,2,2,1,3
18601_0,,,,2,2,1,3
18602_0,,,,2,2,1,3
18603_0,,,,2,2,1,3
18604_0,,,,2,2,1,3
18605_0,,,,2,2,1,3
18606_0,,,,2,2,1,3
18607_0,,,,2,2,1,3
18608_0,,,,2,2,1,3
18609_0,,,,2,2,1,3
18610_0,,,,2,2,1,3
18611_0,,,,2,2,1,3
18612_0,,,,2,2,1,3
18613_0,,,,2,2,1,3
18614_0,,,,2,2,1,3
18615_0,,,,2,2,1,3
18616_0,,,,2,2,1,3
18617_0,,,,2,2,1,3
18618_0,,,,2,2,1,3
18619_0,,,,2,2,1,3
18620_0,,,,2,2,1,3
18621_0,,,,2,2,1,3
18622_0,,,,2,2,1,3
18623_0,,,,2,2,1,3
18624_0,,,,2,2,1,3
18625_0,,,,2,2,1,3
18626_0,,,,2,2,1,3
18627_0,,,,2,2,1,3
18628_0,,,,2,2,1,3
18629_0,,,,2,2,1,3
18630_0,,,,2,2,1,3
18631_0,,,,2,2,1,3
18632_0,,,,2,2,1,3
18633_0,,,,2,2,1,3
18634_0,,,,2,2,1,3
18635_0,,,,2,2,1,3
18636_0,,,,2,2,1,3
18637_0,,,,2,2,1,3
18638_0,,,,2,2,1,3
18639_0,,,,2,2,1,3
18640_0,,,,2,2,1,3
18641_0,,,,2,2,1,3
18642_0,,,,2,2,1,3
18643_0,,,,2,2,1,3
18644_0,,,,2,2,1,3
18645_0,,,,2,2,1,3
18646_0,,,,2,2,1,3
18647_0,,,,2,2,1,3
18648_0,,,,2,2,1,3
18649_0,,,,2,2,1,3
18650_0,,,,2,2,1,3
18651_0,,,,2,2,1,3
18652_0,,,,2,2,1,3
18653_0,,,,2,2,1,3
18654_0,,,,2,2,1,3
18655_0,,,,2,2,1,3
18656_0,,,,2,2,1,3
18657_0,,,,2,2,1,3
18658_0,,,,2,2,1,3
18659_0,,,,2,2,1,3
18660_0,,,,2,2,1,3
18661_0,,,,2,2,1,3
18662_0,,,,2,2,1,3
18663_0,,,,2,2,1,3
18664_0,,,,2,2,1,3
18665_0,,,,2,2,1,3
18666_0,,,,2,2,1,3
18667_0,,,,2,2,1,3
18668_0,,,,2,2,1,3
18669_0,,,,2,2,1,3
18670_0,,,,2,2,1,3
18671_0,,,,2,2,1,3
18672_0,,,,2,2,1,3
18673_0,,,,2,2,1,3
18674_0,,,,2,2,1,3
18675_0,,,,2,2,1,3
18676_0,,,,2,2,1,3
18677_0,,,,2,2,1,3
18678_0,,,,2,2,1,3
18679_0,,,,2,2,1,3
18680_0,,,,2,2,1,3
18681_0,,,,2,2,1,3
18682_0,,,,2,2,1,3
18683_0,,,,2,2,1,3
18684_0,,,,2,2,1,3
18685_0,,,,2,2,1,3
18686_0,,,,2,2,1,3
18687_0,,,,2,2,1,3
18688_0,,,,2,2,1,3
18689_0,,,,2,2,1,3
18690_0,,,,2,2,1,3
18691_0,,,,2,2,1,3
18692_0,,,,2,2,1,3
18693_0,,,,2,2,1,3
18694_0,,,,2,2,1,3
18695_0,,,,2,2,1,3
18696_0,,,,2,2,1,3
18697_0,,,,2,2,1,3
18698_0,,,,2,2,1,3
18699_0,,,,2,2,1,3
18700_0,,,,2,2,1,3
18701_0,,,,2,2,1,3
18702_0,,,,2,2,1,3
18703_0,,,,2,2,1,3
18704_0,,,,2,2,1,3
18705_0,,,,2,2,1,3
18706_0,,,,2,2,1,3
18707_0,,,,2,2,1,3
18708_0,,,,2,2,1,3
18709_0,,,,2,2,1,3
18710_0,,,,2,2,1,3
18711_0,,,,2,2,1,3
18712_0,,,,2,2,1,3
18713_0,,,,2,2,1,3
18714_0,,,,2,2,1,3
18715_0,,,,2,2,1,3
18716_0,,,,2,2,1,3
18717_0,,,,2,2,1,3
18718_0,,,,2,2,1,3
18719_0,,,,2,2,1,3
18721_0,,,,2,2,1,3
CC(CO)(C(C(C(CO)O)O)O)O,,,4,1,2,0,2
18723_0,,,,2,2,1,3
CC(C(CO)O)(C(C(CO)O)O)O,,,4,1,2,0,2
18724_0,,,,2,2,1,3
18726_0,,,,2,2,1,3
CC(C(C(C(CO)O)O)O)O,,,4,1,2,0,2
18727_0,,,,2,2,1,3
18729_0,,,,2,2,1,3
C(C(C(C(CO)O)(C(C)O)O)O)=O,,,4,1,2,0,2
18731_0,,,,2,2,1,3
C(C(C(C(C(C(C)O)O)O)O)O)=O,,,4,1,2,0,2
18732_0,,,,2,2,1,3
18733_0,,,,2,2,1,3
18734_0,,,,2,2,1,3
18735_0,,,,2,2,1,3
18736_0,,,,2,2,1,3
18737_0,,,,2,2,1,3
18738_0,,,,2,2,1,3
18739_0,,,,2,2,1,3
18740_0,,,,2,2,1,3
18741_0,,,,2,2,1,3
18742_0,,,,2,2,1,3
18744_0,,,,2,2,1,3
C(C(C(C(C(CO)CO)O)O)=O)=O,,,4,1,1,0,1
18745_0,,,,2,2,1,3
18746_0,,,,2,2,1,3
18747_0,,,,2,2,1,3
18748_0,,,,2,2,1,3
18749_0,,,,2,2,1,3
18750_0,,,,2,2,1,3
18751_0,,,,2,2,1,3
18752_0,,,,2,2,1,3
18753_0,,,,2,2,1,3
18754_0,,,,2,2,1,3
18755_0,,,,2,2,1,3
18756_0,,,,2,2,1,3
18757_0,,,,2,2,1,3
18758_0,,,,2,2,1,3
18759_0,,,,2,2,1,3
18760_0,,,,2,2,1,3
18761_0,,,,2,2,1,3
18762_0,,,,2,2,1,3
18763_0,,,,2,2,1,3
18764_0,,,,2,2,1,3
18765_0,,,,2,2,1,3
18766_0,,,,2,2,1,3
18767_0,,,,2,2,1,3
18768_0,,,,2,2,1,3
18769_0,,,,2,2,1,3
18770_0,,,,2,2,1,3
18771_0,,,,2,2,1,3
18772_0,,,,2,2,1,3
18773_0,,,,2,2,1,3
18774_0,,,,2,2,1,3
18775_0,,,,2,2,1,3
18776_0,,,,2,2,1,3
18777_0,,,,2,2,1,3
18778_0,,,,2,2,1,3
18779_0,,,,2,2,1,3
18780_0,,,,2,2,1,3
18781_0,,,,2,2,1,3
18782_0,,,,2,2,1,3
18783_0,,,,2,2,1,3
18784_0,,,,2,2,1,3
18785_0,,,,2,2,1,3
18786_0,,,,2,2,1,3
18787_0,,,,2,2,1,3
18788_0,,,,2,2,1,3
18789_0,,,,2,2,1,3
18790_0,,,,2,2,1,3
18791_0,,,,2,2,1,3
18792_0,,,,2,2,1,3
18793_0,,,,2,2,1,3
18794_0,,,,2,2,1,3
18795_0,,,,2,2,1,3
18796_0,,,,2,2,1,3
18797_0,,,,2,2,1,3
18798_0,,,,2,2,1,3
18799_0,,,,2,2,1,3
18800_0,,,,2,2,1,3
18801_0,,,,2,2,1,3
18802_0,,,,2,2,1,3
18803_0,,,,2,2,1,3
18804_0,,,,2,2,1,3
18805_0,,,,2,2,1,3
18806_0,,,,2,2,1,3
18807_0,,,,2,2,1,3
18808_0,,,,2,2,1,3
18809_0,,,,2,2,1,3
18810_0,,,,2,2,1,3
18811_0,,,,2,2,1,3
18812_0,,,,2,2,1,3
18813_0,,,,2,2,1,3
18814_0,,,,2,2,1,3
18815_0,,,,2,2,1,3
18816_0,,,,2,2,1,3
18818_0,,,,2,2,1,3
C(C(C(C(CO)(CCO)O)O)O)O,,,4,1,2,0,2
18819_0,,,,2,2,1,3
18820_0,,,,2,2,1,3
18821_0,,,,2,2,1,3
18822_0,,,,2,2,1,3
18823_0,,,,2,2,1,3
18824_0,,,,2,2,1,3
18825_0,,,,2,2,1,3
18826_0,,,,2,2,1,3
18827_0,,,,2,2,1,3
18829_0,,,,2,2,1,3
CC(CO)(C(C(CO)O)O)O,,,4,1,2,0,2
18830_0,,,,2,2,1,3
18831_0,,,,2,2,1,3
18832_0,,,,2,2,1,3
18833_0,,,,2,2,1,3
18835_0,,,,2,2,1,3
CC(C(C(CO)O)O)O,,,4,1,2,0,2
18836_0,,,,2,2,1,3
18837_0,,,,2,2,1,3
18838_0,,,,2,2,1,3
18839_0,,,,2,2,1,3
18840_0,,,,2,2,1,3
18841_0,,,,2,2,1,3
18842_0,,,,2,2,1,3
18843_0,,,,2,2,1,3
18844_0,,,,2,2,1,3
18845_0,,,,2,2,1,3
18846_0,,,,2,2,1,3
18847_0,,,,2,2,1,3
18848_0,,,,2,2,1,3
18849_0,,,,2,2,1,3
18850_0,,,,2,2,1,3
18851_0,,,,2,2,1,3
18852_0,,,,2,2,1,3
18853_0,,,,2,2,1,3
18854_0,,,,2,2,1,3
18855_0,,,,2,2,1,3
18856_0,,,,2,2,1,3
18857_0,,,,2,2,1,3
18858_0,,,,2,2,1,3
18859_0,,,,2,2,1,3
18860_0,,,,2,2,1,3
18861_0,,,,2,2,1,3
18862_0,,,,2,2,1,3
18863_0,,,,2,2,1,3
18864_0,,,,2,2,1,3
18865_0,,,,2,2,1,3
18866_0,,,,2,2,1,3
18867_0,,,,2,2,1,3
18868_0,,,,2,2,1,3
18869_0,,,,2,2,1,3
18870_0,,,,2,2,1,3
18871_0,,,,2,2,1,3
18872_0,,,,2,2,1,3
18873_0,,,,2,2,1,3
18874_0,,,,2,2,1,3
18875_0,,,,2,2,1,3
18876_0,,,,2,2,1,3
18877_0,,,,2,2,1,3
18878_0,,,,2,2,1,3
18879_0,,,,2,2,1,3
18880_0,,,,2,2,1,3
18881_0,,,,2,2,1,3
18882_0,,,,2,2,1,3
18883_0,,,,2,2,1,3
18884_0,,,,2,2,1,3
18885_0,,,,2,2,1,3
18886_0,,,,2,2,1,3
18887_0,,,,2,2,1,3
18888_0,,,,2,2,1,3
18890_0,,,,2,2,1,3
C(OC(C(CO)O)C(CO)O)=O,,,4,1,1,0,1
18891_0,,,,2,2,1,3
18893_0,,,,2,2,1,3
C(C(C(O)OCC(CO)O)O)=O,,,4,1,1,0,1
18895_0,,,,2,2,1,3
C(C(CO)OC(C(CO)O)O)=O,,,4,1,1,0,1
18897_0,,,,2,2,1,3
C(OC(CO)C(C(CO)O)O)=O,,,4,1,2,0,2
18898_0,,,,2,2,1,3
18900_0,,,,2,2,1,3
C(C(O)OC(CO)C(CO)O)=O,,,4,1,1,0,1
18902_0,,,,2,2,1,3
C1C(C(C(C(O)O1)O)O)O,,,4,1,2,0,2
18904_0,,,,2,2,1,3
C(C(COC(C(CO)O)O)O)=O,,,4,1,1,0,1
18906_0,,,,2,2,1,3
C(OCC(C(C(CO)O)O)O)=O,,,4,1,2,0,2
18908_0,,,,2,2,1,3
C(COC(C(C(CO)O)O)O)=O,,,4,1,2,0,2
18909_0,,,,2,2,1,3
18910_0,,,,2,2,1,3
18912_0,,,,2,2,1,3
C(C(O)OCC(C(CO)O)O)=O,,,4,1,2,0,2
18913_0,,,,2,2,1,3
18915_0,,,,2,2,1,3
C(COC(CO)(C(CO)O)O)=O,,,4,1,1,0,1
18916_0,,,,2,2,1,3
18917_0,,,,2,2,1,3
18918_0,,,,2,2,1,3
18919_0,,,,2,2,1,3
18920_0,,,,2,2,1,3
18921_0,,,,2,2,1,3
18922_0,,,,2,2,1,3
18923_0,,,,2,2,1,3
18924_0,,,,2,2,1,3
18925_0,,,,2,2,1,3
18926_0,,,,2,2,1,3
18927_0,,,,2,2,1,3
18928_0,,,,2,2,1,3
18929_0,,,,2,2,1,3
18930_0,,,,2,2,1,3
18931_0,,,,2,2,1,3
18932_0,,,,2,2,1,3
18933_0,,,,2,2,1,3
18934_0,,,,2,2,1,3
18935_0,,,,2,2,1,3
18936_0,,,,2,2,1,3
18937_0,,,,2,2,1,3
18938_0,,,,2,2,1,3
18939_0,,,,2,2,1,3
18940_0,,,,2,2,1,3
18941_0,,,,2,2,1,3
18942_0,,,,2,2,1,3
18943_0,,,,2,2,1,3
18944_0,,,,2,2,1,3
18945_0,,,,2,2,1,3
18946_0,,,,2,2,1,3
18947_0,,,,2,2,1,3
18948_0,,,,2,2,1,3
18949_0,,,,2,2,1,3
18950_0,,,,2,2,1,3
18951_0,,,,2,2,1,3
18952_0,,,,2,2,1,3
18953_0,,,,2,2,1,3
18954_0,,,,2,2,1,3
18955_0,,,,2,2,1,3
18956_0,,,,2,2,1,3
18957_0,,,,2,2,1,3
18958_0,,,,2,2,1,3
18959_0,,,,2,2,1,3
18960_0,,,,2,2,1,3
18961_0,,,,2,2,1,3
18962_0,,,,2,2,1,3
18963_0,,,,2,2,1,3
18964_0,,,,2,2,1,3
18965_0,,,,2,2,1,3
18966_0,,,,2,2,1,3
18967_0,,,,2,2,1,3
18968_0,,,,2,2,1,3
18969_0,,,,2,2,1,3
18970_0,,,,2,2,1,3
18971_0,,,,2,2,1,3
18972_0,,,,2,2,1,3
18973_0,,,,2,2,1,3
18974_0,,,,2,2,1,3
18975_0,,,,2,2,1,3
18976_0,,,,2,2,1,3
18977_0,,,,2,2,1,3
18978_0,,,,2,2,1,3
18979_0,,,,2,2,1,3
18980_0,,,,2,2,1,3
18981_0,,,,2,2,1,3
18982_0,,,,2,2,1,3
18983_0,,,,2,2,1,3
18984_0,,,,2,2,1,3
18985_0,,,,2,2,1,3
18986_0,,,,2,2,1,3
18987_0,,,,2,2,1,3
18988_0,,,,2,2,1,3
18989_0,,,,2,2,1,3
18990_0,,,,2,2,1,3
18991_0,,,,2,2,1,3
18992_0,,,,2,2,1,3
18993_0,,,,2,2,1,3
18994_0,,,,2,2,1,3
18995_0,,,,2,2,1,3
18996_0,,,,2,2,1,3
18997_0,,,,2,2,1,3
18998_0,,,,2,2,1,3
18999_0,,,,2,2,1,3
19000_0,,,,2,2,1,3
19001_0,,,,2,2,1,3
19002_0,,,,2,2,1,3
19003_0,,,,2,2,1,3
19004_0,,,,2,2,1,3
19005_0,,,,2,2,1,3
19006_0,,,,2,2,1,3
19007_0,,,,2,2,1,3
19008_0,,,,2,2,1,3
19009_0,,,,2,2,1,3
19010_0,,,,2,2,1,3
19011_0,,,,2,2,1,3
19012_0,,,,2,2,1,3
19013_0,,,,2,2,1,3
19014_0,,,,2,2,1,3
19015_0,,,,2,2,1,3
19016_0,,,,2,2,1,3
19017_0,,,,2,2,1,3
19018_0,,,,2,2,1,3
19019_0,,,,2,2,1,3
19020_0,,,,2,2,1,3
19021_0,,,,2,2,1,3
19022_0,,,,2,2,1,3
19023_0,,,,2,2,1,3
19024_0,,,,2,2,1,3
19025_0,,,,2,2,1,3
19026_0,,,,2,2,1,3
19027_0,,,,2,2,1,3
19028_0,,,,2,2,1,3
19029_0,,,,2,2,1,3
19030_0,,,,2,2,1,3
19031_0,,,,2,2,1,3
19032_0,,,,2,2,1,3
19033_0,,,,2,2,1,3
19034_0,,,,2,2,1,3
19035_0,,,,2,2,1,3
19036_0,,,,2,2,1,3
19037_0,,,,2,2,1,3
19038_0,,,,2,2,1,3
19039_0,,,,2,2,1,3
19040_0,,,,2,2,1,3
19041_0,,,,2,2,1,3
19042_0,,,,2,2,1,3
19043_0,,,,2,2,1,3
19044_0,,,,2,2,1,3
19045_0,,,,2,2,1,3
19046_0,,,,2,2,1,3
19047_0,,,,2,2,1,3
19048_0,,,,2,2,1,3
19049_0,,,,2,2,1,3
19050_0,,,,2,2,1,3
19051_0,,,,2,2,1,3
19052_0,,,,2,2,1,3
19053_0,,,,2,2,1,3
19054_0,,,,2,2,1,3
19055_0,,,,2,2,1,3
19056_0,,,,2,2,1,3
19057_0,,,,2,2,1,3
19058_0,,,,2,2,1,3
19059_0,,,,2,2,1,3
19060_0,,,,2,2,1,3
19061_0,,,,2,2,1,3
19062_0,,,,2,2,1,3
19063_0,,,,2,2,1,3
19064_0,,,,2,2,1,3
19065_0,,,,2,2,1,3
19066_0,,,,2,2,1,3
19067_0,,,,2,2,1,3
19068_0,,,,2,2,1,3
19069_0,,,,2,2,1,3
19070_0,,,,2,2,1,3
19071_0,,,,2,2,1,3
19072_0,,,,2,2,1,3
19073_0,,,,2,2,1,3
19074_0,,,,2,2,1,3
19075_0,,,,2,2,1,3
19076_0,,,,2,2,1,3
19077_0,,,,2,2,1,3
19078_0,,,,2,2,1,3
19079_0,,,,2,2,1,3
19080_0,,,,2,2,1,3
19081_0,,,,2,2,1,3
19082_0,,,,2,2,1,3
19083_0,,,,2,2,1,3
19084_0,,,,2,2,1,3
19085_0,,,,2,2,1,3
19086_0,,,,2,2,1,3
19087_0,,,,2,2,1,3
19088_0,,,,2,2,1,3
19089_0,,,,2,2,1,3
19090_0,,,,2,2,1,3
19091_0,,,,2,2,1,3
19092_0,,,,2,2,1,3
19093_0,,,,2,2,1,3
19094_0,,,,2,2,1,3
19095_0,,,,2,2,1,3
19096_0,,,,2,2,1,3
19097_0,,,,2,2,1,3
19098_0,,,,2,2,1,3
19099_0,,,,2,2,1,3
19100_0,,,,2,2,1,3
19101_0,,,,2,2,1,3
19102_0,,,,2,2,1,3
19103_0,,,,2,2,1,3
19104_0,,,,2,2,1,3
19105_0,,,,2,2,1,3
19106_0,,,,2,2,1,3
19107_0,,,,2,2,1,3
19108_0,,,,2,2,1,3
19109_0,,,,2,2,1,3
19110_0,,,,2,2,1,3
19111_0,,,,2,2,1,3
19112_0,,,,2,2,1,3
19113_0,,,,2,2,1,3
19114_0,,,,2,2,1,3
19115_0,,,,2,2,1,3
19116_0,,,,2,2,1,3
19117_0,,,,2,2,1,3
19119_0,,,,2,2,1,3
C(C1(C(C(CCO1)O)O)O)=O,,,4,1,2,0,2
19120_0,,,,2,2,1,3
19121_0,,,,2,2,1,3
19122_0,,,,2,2,1,3
19123_0,,,,2,2,1,3
19124_0,,,,2,2,1,3
19125_0,,,,2,2,1,3
19126_0,,,,2,2,1,3
19127_0,,,,2,2,1,3
19128_0,,,,2,2,1,3
19129_0,,,,2,2,1,3
19130_0,,,,2,2,1,3
19131_0,,,,2,2,1,3
19132_0,,,,2,2,1,3
19133_0,,,,2,2,1,3
19134_0,,,,2,2,1,3
19135_0,,,,2,2,1,3
19136_0,,,,2,2,1,3
19137_0,,,,2,2,1,3
19138_0,,,,2,2,1,3
19139_0,,,,2,2,1,3
19140_0,,,,2,2,1,3
19141_0,,,,2,2,1,3
19142_0,,,,2,2,1,3
19143_0,,,,2,2,1,3
19144_0,,,,2,2,1,3
19145_0,,,,2,2,1,3
19146_0,,,,2,2,1,3
19147_0,,,,2,2,1,3
19148_0,,,,2,2,1,3
19149_0,,,,2,2,1,3
19150_0,,,,2,2,1,3
19151_0,,,,2,2,1,3
19152_0,,,,2,2,1,3
19153_0,,,,2,2,1,3
19154_0,,,,2,2,1,3
19155_0,,,,2,2,1,3
19156_0,,,,2,2,1,3
19157_0,,,,2,2,1,3
19158_0,,,,2,2,1,3
19159_0,,,,2,2,1,3
19160_0,,,,2,2,1,3
19161_0,,,,2,2,1,3
19162_0,,,,2,2,1,3
19163_0,,,,2,2,1,3
19164_0,,,,2,2,1,3
19165_0,,,,2,2,1,3
19166_0,,,,2,2,1,3
19167_0,,,,2,2,1,3
19168_0,,,,2,2,1,3
19169_0,,,,2,2,1,3
19170_0,,,,2,2,1,3
19171_0,,,,2,2,1,3
19172_0,,,,2,2,1,3
19173_0,,,,2,2,1,3
19174_0,,,,2,2,1,3
19175_0,,,,2,2,1,3
19176_0,,,,2,2,1,3
19177_0,,,,2,2,1,3
19178_0,,,,2,2,1,3
19179_0,,,,2,2,1,3
19180_0,,,,2,2,1,3
19181_0,,,,2,2,1,3
19182_0,,,,2,2,1,3
19183_0,,,,2,2,1,3
19184_0,,,,2,2,1,3
19185_0,,,,2,2,1,3
19186_0,,,,2,2,1,3
19187_0,,,,2,2,1,3
19188_0,,,,2,2,1,3
19189_0,,,,2,2,1,3
19190_0,,,,2,2,1,3
19191_0,,,,2,2,1,3
19192_0,,,,2,2,1,3
19193_0,,,,2,2,1,3
19194_0,,,,2,2,1,3
19195_0,,,,2,2,1,3
19196_0,,,,2,2,1,3
19197_0,,,,2,2,1,3
19198_0,,,,2,2,1,3
19199_0,,,,2,2,1,3
19200_0,,,,2,2,1,3
19201_0,,,,2,2,1,3
19202_0,,,,2,2,1,3
19203_0,,,,2,2,1,3
19204_0,,,,2,2,1,3
19205_0,,,,2,2,1,3
19206_0,,,,2,2,1,3
19207_0,,,,2,2,1,3
19208_0,,,,2,2,1,3
19209_0,,,,2,2,1,3
19210_0,,,,2,2,1,3
19211_0,,,,2,2,1,3
19212_0,,,,2,2,1,3
19213_0,,,,2,2,1,3
19214_0,,,,2,2,1,3
19215_0,,,,2,2,1,3
19216_0,,,,2,2,1,3
19217_0,,,,2,2,1,3
19218_0,,,,2,2,1,3
19219_0,,,,2,2,1,3
19220_0,,,,2,2,1,3
19221_0,,,,2,2,1,3
19222_0,,,,2,2,1,3
19223_0,,,,2,2,1,3
19224_0,,,,2,2,1,3
19225_0,,,,2,2,1,3
19226_0,,,,2,2,1,3
19227_0,,,,2,2,1,3
19228_0,,,,2,2,1,3
19229_0,,,,2,2,1,3
19230_0,,,,2,2,1,3
19231_0,,,,2,2,1,3
19232_0,,,,2,2,1,3
19233_0,,,,2,2,1,3
19234_0,,,,2,2,1,3
19235_0,,,,2,2,1,3
19236_0,,,,2,2,1,3
19237_0,,,,2,2,1,3
19238_0,,,,2,2,1,3
19239_0,,,,2,2,1,3
19240_0,,,,2,2,1,3
19241_0,,,,2,2,1,3
19242_0,,,,2,2,1,3
19243_0,,,,2,2,1,3
19244_0,,,,2,2,1,3
19245_0,,,,2,2,1,3
19246_0,,,,2,2,1,3
19247_0,,,,2,2,1,3
19248_0,,,,2,2,1,3
19249_0,,,,2,2,1,3
19250_0,,,,2,2,1,3
19251_0,,,,2,2,1,3
19252_0,,,,2,2,1,3
19253_0,,,,2,2,1,3
19255_0,,,,2,2,1,3
C(C(C1C(C(CO1)O)O)O)=O,,,4,1,3,0,3
19256_0,,,,2,2,1,3
19257_0,,,,2,2,1,3
19258_0,,,,2,2,1,3
19259_0,,,,2,2,1,3
19260_0,,,,2,2,1,3
19261_0,,,,2,2,1,3
19262_0,,,,2,2,1,3
19263_0,,,,2,2,1,3
19264_0,,,,2,2,1,3
19265_0,,,,2,2,1,3
19266_0,,,,2,2,1,3
19267_0,,,,2,2,1,3
19268_0,,,,2,2,1,3
19269_0,,,,2,2,1,3
19270_0,,,,2,2,1,3
19271_0,,,,2,2,1,3
19272_0,,,,2,1,2,3
19274_0,,,,2,1,2,3
C(C(C(C=C)O)O)=O,,,4,1,1,0,1
19276_0,,,,2,1,2,3
C=CC(C(CO)O)O,,,4,1,1,0,1
19278_0,,,,2,1,2,3
C(C(CO)O)=CCO,,,4,1,1,0,1
19279_0,,,,2,1,2,3
19281_0,,,,2,1,1,2
C12CC(C(C(C1O)O)(O)O2)O,,,4,1,1,0,1
19283_0,,,,2,1,1,2
C1C2(C(C(CC2O)(O)O1)O)O,,,4,1,2,0,2
19283_1,,,,2,1,1,2
19285_0,,,,2,1,1,2
C1C2(CC(C(C2O)(O)O1)O)O,,,4,1,2,0,2
19285_1,,,,2,1,1,2
19287_0,,,,2,1,1,2
C1C2(CC(C(C2O)O)(O)O1)O,,,4,1,2,0,2
19287_1,,,,2,1,1,2
19288_0,,,,2,1,1,2
19288_1,,,,2,1,1,2
19289_0,,,,2,1,1,2
19289_1,,,,2,1,1,2
19290_0,,,,2,1,1,2
19290_1,,,,2,1,1,2
19291_0,,,,2,1,1,2
19292_0,,,,2,1,1,2
19292_1,,,,2,1,1,2
19293_0,,,,2,1,1,2
19293_1,,,,2,1,1,2
19294_0,,,,2,1,1,2
19295_0,,,,2,1,1,2
19295_1,,,,2,1,1,2
19296_0,,,,2,1,1,2
19298_0,,,,2,1,1,2
C(C1C2(C(C(C(C1O)O2)O)O)O)O,,,4,1,1,0,1
19300_0,,,,2,1,1,2
C1C(CO)(C(C(CO)(O)O1)O)O,,,4,1,1,0,1
19302_0,,,,2,1,1,2
C(C1(CC(CO)(CO1)O)O)=O,,,4,1,1,0,1
19304_0,,,,2,1,1,2
C1(C(O)OC(CO)(CO)C1)=O,,,4,1,1,0,1
19306_0,,,,2,1,1,2
C(CO)(C1C(CC(CO)(O1)O)O)=O,,,4,1,1,0,1
19308_0,,,,2,1,1,2
C(CO)(C1C(CO)(CC(O1)O)O)=O,,,4,1,1,0,1
19310_0,,,,2,1,1,2
C(CC1(COC(CO)(C1O)O)O)=O,,,4,1,1,0,1
19311_0,,,,2,1,1,2
19313_0,,,,2,1,1,2
C(CO)(C1C(O)OCC1(CO)O)=O,,,4,1,1,0,1
19315_0,,,,2,1,1,2
C(C1C(CO)(O)OCC1(CO)O)=O,,,4,1,1,0,1
19316_0,,,,2,1,1,2
19318_0,,,,2,1,1,2
C(CC1(C(C(CO1)(CO)O)O)O)=O,,,4,1,1,0,1
19319_0,,,,2,1,1,2
19321_0,,,,2,1,1,2
C(CO)(C1C(C(C(C)(O1)O)O)O)=O,,,4,1,1,0,1
19323_0,,,,2,1,1,2
C(C)(C1C(C(C(CO)(O1)O)O)O)=O,,,4,1,1,0,1
19325_0,,,,2,1,1,2
C(CO)(C1C(C)(C(C(O1)O)O)O)=O,,,4,1,1,0,1
19327_0,,,,2,1,1,2
C(C1C(C)(C(C(CO)(O1)O)O)O)=O,,,4,1,1,0,1
19329_0,,,,2,1,1,2
C(C(C1(CC(CO1)(CO)O)O)O)=O,,,4,1,1,0,1
19331_0,,,,2,1,1,2
CC1(C(CO)OC(CO)(C1O)O)O,,,4,1,1,0,1
19333_0,,,,2,1,1,2
C1C(CO)(CC(C(CO)O)(O)O1)O,,,4,1,1,0,1
19334_0,,,,2,1,1,2
19336_0,,,,2,1,1,2
C(C1(C(CO)C(CO)(CO1)O)O)=O,,,4,1,1,0,1
19338_0,,,,2,1,1,2
C1(C(O)OC(CO)(CO)C1CO)=O,,,4,1,1,0,1
19339_0,,,,2,1,1,2
19341_0,,,,2,1,1,2
C1C(CCO)(C(C(CO)(O)O1)O)O,,,4,1,1,0,1
19343_0,,,,2,1,1,2
C1C(CO)(C(C(CCO)(O)O1)O)O,,,4,1,1,0,1
19345_0,,,,2,1,1,2
C1C(CO)(C(CO)C(CO)(O)O1)O,,,4,1,1,0,1
19347_0,,,,2,1,1,2
C(CO)(C1C(C(C(O1)O)O)O)=O,,,4,1,1,0,1
19349_0,,,,2,1,1,2
C(C1C(C(C(CO)(O1)O)O)O)=O,,,4,1,1,0,1
19351_0,,,,2,1,1,2
C1C(C)(C(C(CO)(O)O1)O)O,,,4,1,1,0,1
19353_0,,,,2,1,1,2
C1C(CO)(CC(CO)(O)O1)O,,,4,1,1,0,1
19355_0,,,,2,1,1,2
C1C(CO)(C(C(C)(O)O1)O)O,,,4,1,1,0,1
19357_0,,,,2,1,1,2
C(CO)(C(C1C(CC(O)O1)O)O)=O,,,4,1,1,0,1
19359_0,,,,2,1,1,2
C(CC1C(C(C(CO)(O)O1)O)O)=O,,,4,1,1,0,1
19361_0,,,,2,1,1,2
C(CO)(C(C1CC(C(O)O1)O)O)=O,,,4,1,1,0,1
19363_0,,,,2,1,1,2
C(C(C1C(O)OCC1(CO)O)O)=O,,,4,1,1,0,1
19365_0,,,,2,1,1,2
C(C1C(C(O)OC1(CO)CO)O)=O,,,4,1,1,0,1
19367_0,,,,2,1,1,2
C1C(CO)(CC(O)O1)O,,,4,1,1,0,1
19369_0,,,,2,1,1,2
C(CO)(C1C(O)OC(CO)C1O)=O,,,4,1,1,0,1
19371_0,,,,2,1,1,2
C(C1C(CO)(O)OC(CO)C1O)=O,,,4,1,1,0,1
19372_0,,,,2,1,1,2
19374_0,,,,2,1,1,2
C(CC1(C(C(C(CO)O1)O)O)O)=O,,,4,1,1,0,1
19375_0,,,,2,1,1,2
19377_0,,,,2,1,1,2
C(C(C1(CC(C(CO)O1)O)O)O)=O,,,4,1,1,0,1
19379_0,,,,2,1,1,2
C(C(C1(CC(C(CO)O1)O)O)O)O,,,4,1,1,0,1
19381_0,,,,2,1,1,2
C(C1(C(CO)C(C(CO)O1)O)O)=O,,,4,1,1,0,1
19382_0,,,,2,1,1,2
19383_0,,,,2,1,1,2
19385_0,,,,2,1,1,2
C(CC1(C(C(C(CO)O1)O)O)O)O,,,4,1,1,0,1
19387_0,,,,2,1,1,2
C(C1(C(CO)C(C(CO)O1)O)O)O,,,4,1,1,0,1
19389_0,,,,2,1,1,2
C(C(C1C(O)OC(CO)C1O)O)=O,,,4,1,1,0,1
19391_0,,,,2,1,1,2
C(C1C(C(CO)O)OC(C1O)O)=O,,,4,1,1,0,1
19393_0,,,,2,1,1,2
C(C1C(CC(O)O1)O)O,,,4,1,1,0,1
19395_0,,,,2,1,1,2
C(C1(C)CC(C(O1)O)=O)=O,,,4,1,1,0,1
19397_0,,,,2,1,1,2
C(CO)(CC1CC(C(O)O1)=O)=O,,,4,1,1,0,1
19399_0,,,,2,1,1,2
C(CC1(CO)CC(C(O)O1)=O)=O,,,4,1,1,0,1
19401_0,,,,2,1,1,2
C(CC1(COC(C=O)(C1)O)O)=O,,,4,1,1,0,1
19402_0,,,,2,1,1,2
19403_0,,,,2,1,1,2
19404_0,,,,2,1,1,2
19405_0,,,,2,1,1,2
19406_0,,,,2,1,1,2
19408_0,,,,2,1,1,2
C(C)(C(C1CC(C(O)O1)=O)O)=O,,,4,1,1,0,1
19410_0,,,,2,1,1,2
C(C1(CC(C(C(C)=O)O1)O)O)=O,,,4,1,1,0,1
19412_0,,,,2,1,1,2
C(C(C1(C)CC(C(O)O1)=O)O)=O,,,4,1,1,0,1
19414_0,,,,2,1,1,2
C(C1C(C)(CC(C=O)(O1)O)O)=O,,,4,1,1,0,1
19416_0,,,,2,1,1,2
C(C1CC(C(O)O1)=O)=O,,,4,1,1,0,1
19418_0,,,,2,1,1,2
C1(C(O)OC(C)(C(CO)O)C1)=O,,,4,1,1,0,1
19420_0,,,,2,1,1,2
C(C1(CC(C)(C(CO)O1)O)O)=O,,,4,1,1,0,1
19421_0,,,,2,1,1,2
19423_0,,,,2,1,1,2
C(C1(CCO)CC(C(O1)O)=O)=O,,,4,1,1,0,1
19424_0,,,,2,1,1,2
19425_0,,,,2,1,1,2
19427_0,,,,2,1,1,2
C(C(C1COC(C)(C1O)O)=O)=O,,,4,1,1,0,1
19428_0,,,,2,1,1,2
19430_0,,,,2,1,1,2
C(C1(C)C(C(C(O1)O)=O)CO)=O,,,4,1,1,0,1
19432_0,,,,2,1,1,2
C(C(C1COC(C1(C)O)O)=O)=O,,,4,1,1,0,1
19433_0,,,,2,1,1,2
19435_0,,,,2,1,1,2
C1(C(O)OC(CO)(CCO)C1)=O,,,4,1,1,0,1
19437_0,,,,2,1,1,2
C(C1(CC(CO1)(CCO)O)O)=O,,,4,1,1,0,1
19439_0,,,,2,1,1,2
C(CO)(C1COC(C)(C1O)O)=O,,,4,1,1,0,1
19441_0,,,,2,1,1,2
C(CO)(C1COC(C1(C)O)O)=O,,,4,1,1,0,1
19443_0,,,,2,1,1,2
C(C(C1CC(C(O)O1)=O)O)=O,,,4,1,1,0,1
19445_0,,,,2,1,1,2
C(C1C(CC(C=O)(O1)O)O)=O,,,4,1,1,0,1
19447_0,,,,2,1,1,2
C1(C(O)OC(CO)(C)C1)=O,,,4,1,1,0,1
19449_0,,,,2,1,1,2
C(C1(CC(CO1)(C)O)O)=O,,,4,1,1,0,1
19451_0,,,,2,1,1,2
C(CC(C1CC(C(O)O1)=O)O)=O,,,4,1,1,0,1
19453_0,,,,2,1,1,2
C(C(CC1C(CC(O)O1)O)=O)=O,,,4,1,1,0,1
19455_0,,,,2,1,1,2
C(CC1C(CC(C=O)(O)O1)O)=O,,,4,1,1,0,1
19457_0,,,,2,1,1,2
C(C(CC1CC(C(O)O1)=O)O)=O,,,4,1,1,0,1
19459_0,,,,2,1,1,2
C(C(CC1CC(C(O)O1)O)=O)=O,,,4,1,1,0,1
19461_0,,,,2,1,1,2
C(C1C(C(C)(OC1C=O)O)O)=O,,,4,1,1,0,1
19463_0,,,,2,1,1,2
C(C1C(C(OC1C(C)=O)O)O)=O,,,4,1,1,0,1
19465_0,,,,2,1,1,2
C(C1C(C)(C(OC1C=O)O)O)=O,,,4,1,1,0,1
19467_0,,,,2,1,1,2
C(C1C(C(OC1(C=O)C)O)O)=O,,,4,1,1,0,1
19469_0,,,,2,1,1,2
C(C(C(C1CC(C(O)O1)=O)O)O)=O,,,4,1,1,0,1
19471_0,,,,2,1,1,2
C(C(CC1C(C(C(O)O1)O)O)=O)=O,,,4,1,1,0,1
19473_0,,,,2,1,1,2
C(C(C1C(CC(C=O)(O)O1)O)O)=O,,,4,1,1,0,1
19475_0,,,,2,1,1,2
C1(C(O)OC(C)C1)=O,,,4,1,1,0,1
19477_0,,,,2,1,1,2
C1(C(O)OC(CO)(C(CO)O)C1)=O,,,4,1,1,0,1
19479_0,,,,2,1,1,2
C(C1(CC(CO1)(C(CO)O)O)O)=O,,,4,1,1,0,1
19481_0,,,,2,1,1,2
C(C1(CC(CO)(C(CO)O1)O)O)=O,,,4,1,1,0,1
19482_0,,,,2,1,1,2
19483_0,,,,2,1,1,2
19484_0,,,,2,1,1,2
19485_0,,,,2,1,1,2
19486_0,,,,2,1,1,2
19488_0,,,,2,1,1,2
C(C1C(C(C(CO)=O)C(O1)O)O)=O,,,4,1,1,0,1
19490_0,,,,2,1,1,2
C(C1C(C(C=O)OC1(CO)O)O)=O,,,4,1,1,0,1
19491_0,,,,2,1,1,2
19493_0,,,,2,1,1,2
C(CC(C1C(C(C(O1)O)O)O)=O)=O,,,4,1,1,0,1
19495_0,,,,2,1,1,2
C(CC1(C(C(C(C=O)O1)O)O)O)=O,,,4,1,1,0,1
19496_0,,,,2,1,1,2
19498_0,,,,2,1,1,2
C(CO)(C1C(O)OCC1(C)O)=O,,,4,1,1,0,1
19500_0,,,,2,1,1,2
C(C1C(CO)(O)OCC1(C)O)=O,,,4,1,1,0,1
19501_0,,,,2,1,1,2
19503_0,,,,2,1,1,2
C(CC1(C(C(CO1)(C)O)O)O)=O,,,4,1,1,0,1
19504_0,,,,2,1,1,2
19506_0,,,,2,1,1,2
C(CC1(COC(CO)(C1)O)O)=O,,,4,1,1,0,1
19508_0,,,,2,1,1,2
C(C)(C1C(CC(CO)(O1)O)O)=O,,,4,1,1,0,1
19509_0,,,,2,1,1,2
19511_0,,,,2,1,1,2
C(CC1(COC(C)(C1O)O)O)=O,,,4,1,1,0,1
19513_0,,,,2,1,1,2
C(C)(C1C(CO)(CC(O1)O)O)=O,,,4,1,1,0,1
19514_0,,,,2,1,1,2
19515_0,,,,2,1,1,2
19516_0,,,,2,1,1,2
19518_0,,,,2,1,1,2
C(C(C1(CC(C(C=O)O1)O)O)O)=O,,,4,1,1,0,1
19520_0,,,,2,1,1,2
C(C(C1(CC(CO1)(C)O)O)O)=O,,,4,1,1,0,1
19522_0,,,,2,1,1,2
C(C1C(C)(CC(CO)(O1)O)O)=O,,,4,1,1,0,1
19524_0,,,,2,1,1,2
C(C)(C1C(C(C(C)(O1)O)O)O)=O,,,4,1,1,0,1
19526_0,,,,2,1,1,2
C(C1C(C)(C(C(C)(O1)O)O)O)=O,,,4,1,1,0,1
19528_0,,,,2,1,1,2
C(C)(C1C(C)(C(C(O1)O)O)O)=O,,,4,1,1,0,1
19529_0,,,,2,1,1,2
19531_0,,,,2,1,1,2
C(C1C(C)(CC(O1)O)O)=O,,,4,1,1,0,1
19533_0,,,,2,1,1,2
C(CO)(C1C(C(OC1C=O)O)O)=O,,,4,1,1,0,1
19535_0,,,,2,1,1,2
C1(C(OC(C=O)C1CO)O)=O,,,4,1,1,0,1
19537_0,,,,2,1,1,2
C(C(C1COC(C1O)O)=O)=O,,,4,1,1,0,1
19538_0,,,,2,1,1,2
19539_0,,,,2,1,1,2
19541_0,,,,2,1,1,2
C(C1C(C(OC1C=O)O)O)=O,,,4,1,1,0,1
19543_0,,,,2,1,1,2
C(C1C(CC(C(CO)O)(O1)O)O)=O,,,4,1,1,0,1
19545_0,,,,2,1,1,2
C1C(C)(CC(C(CO)O)(O)O1)O,,,4,1,1,0,1
19547_0,,,,2,1,1,2
CC1(CC(CO)(O)OC1CO)O,,,4,1,1,0,1
19549_0,,,,2,1,1,2
CC1(C(C(C)(C(CO)O1)O)O)O,,,4,1,1,0,1
19551_0,,,,2,1,1,2
CC1(CC(O)OC1CO)O,,,4,1,1,0,1
19553_0,,,,2,1,1,2
C(CO)(C1C(C)OC(C1O)O)=O,,,4,1,1,0,1
19555_0,,,,2,1,1,2
C(CO)(CC1C(CC(O)O1)O)=O,,,4,1,1,0,1
19557_0,,,,2,1,1,2
C(CC1C(CC(CO)(O)O1)O)=O,,,4,1,1,0,1
19559_0,,,,2,1,1,2
C(C(CC1(COC(C1)O)O)O)=O,,,4,1,1,0,1
19561_0,,,,2,1,1,2
C(CC1(CO)CC(C(O)O1)O)=O,,,4,1,1,0,1
19562_0,,,,2,1,1,2
19564_0,,,,2,1,1,2
C(C1COC(C1O)O)=O,,,4,1,1,0,1
19566_0,,,,2,1,1,2
C(C1COC(C1O)(C(CO)O)O)=O,,,4,1,1,0,1
19568_0,,,,2,1,1,2
C1(C(CC(CO)O)(O)OCC1O)=O,,,4,1,1,0,1
19570_0,,,,2,1,1,2
C1(C(C(CO)O)(O)OC(CO)C1)=O,,,4,1,1,0,1
19571_0,,,,2,1,1,2
19573_0,,,,2,1,1,2
C1(C(CO)(O)OCC1C(CO)O)=O,,,4,1,1,0,1
19574_0,,,,2,1,1,2
19576_0,,,,2,1,1,2
C(CO)(C1(C(CO)C(CO1)O)O)=O,,,4,1,1,0,1
19577_0,,,,2,1,1,2
19578_0,,,,2,1,1,2
19579_0,,,,2,1,1,2
19581_0,,,,2,1,1,2
C(C1CC(C(C(CO)O)(O1)O)O)=O,,,4,1,1,0,1
19582_0,,,,2,1,1,2
19583_0,,,,2,1,1,2
19585_0,,,,2,1,1,2
C1(COC(C(CO)CO)(C1O)O)=O,,,4,1,1,0,1
19587_0,,,,2,1,1,2
C(CO)(C1COC(CO)(C1O)O)=O,,,4,1,1,0,1
19588_0,,,,2,1,1,2
19590_0,,,,2,1,1,2
C(CO)(C1C(C(C(O1)O)CO)O)=O,,,4,1,1,0,1
19591_0,,,,2,1,1,2
19593_0,,,,2,1,1,2
C1C(C(CO)C(C(CO)O)(O)O1)O,,,4,1,1,0,1
19595_0,,,,2,1,1,2
C(C(C1C(C(C(O)O1)CO)O)O)O,,,4,1,1,0,1
19597_0,,,,2,1,1,2
C(CCO)(C1C(C(O)OC1)=O)=O,,,4,1,1,0,1
19599_0,,,,2,1,1,2
C(CC1C(C(O)OC1)=O)(CO)=O,,,4,1,1,0,1
19601_0,,,,2,1,1,2
C(C(C1COC(C1)(CO)O)=O)=O,,,4,1,1,0,1
19603_0,,,,2,1,1,2
C(C1(CC(C(CO)=O)CO1)O)=O,,,4,1,1,0,1
19604_0,,,,2,1,1,2
19605_0,,,,2,1,1,2
19606_0,,,,2,1,1,2
19608_0,,,,2,1,1,2
C(C1C(C(CCO)(O)OC1)=O)=O,,,4,1,1,0,1
19609_0,,,,2,1,1,2
19610_0,,,,2,1,1,2
19611_0,,,,2,1,1,2
19612_0,,,,2,1,1,2
19613_0,,,,2,1,1,2
19614_0,,,,2,1,1,2
19615_0,,,,2,1,1,2
19616_0,,,,2,1,1,2
19617_0,,,,2,1,1,2
19619_0,,,,2,1,1,2
C(C1COC(C1O)(CC=O)O)=O,,,4,1,1,0,1
19620_0,,,,2,1,1,2
19622_0,,,,2,1,1,2
C(C1C(CC(CCO)(O1)O)=O)=O,,,4,1,1,0,1
19624_0,,,,2,1,1,2
C(C(C(C1COC(C1)O)=O)O)=O,,,4,1,1,0,1
19626_0,,,,2,1,1,2
C(C1COC(C1)(C(C=O)O)O)=O,,,4,1,1,0,1
19627_0,,,,2,1,1,2
19629_0,,,,2,1,1,2
C(C(C)=O)(C1COC(C1O)O)=O,,,4,1,1,0,1
19631_0,,,,2,1,1,2
C1(C(C)(O)OCC1C(C=O)O)=O,,,4,1,1,0,1
19633_0,,,,2,1,1,2
C1(CC(C=O)OC1(CCO)O)=O,,,4,1,1,0,1
19635_0,,,,2,1,1,2
C(C(CC1(C(CCO1)=O)O)O)=O,,,4,1,1,0,1
19637_0,,,,2,1,1,2
C(CC(C1COC(C1O)O)=O)=O,,,4,1,1,0,1
19639_0,,,,2,1,1,2
C(C1C2C(C(C(CO)O2)(O)O1)O)O,,,4,1,1,0,1
19641_0,,,,2,1,1,2
C1(C2(C(CO)C(C(CO)O2)O1)O)O,,,4,1,1,0,1
19643_0,,,,2,1,1,2
C1C(C2C(C(C(O)O2)CO)(O)O1)O,,,4,1,2,0,2
19645_0,,,,2,1,1,2
C1(C2C(C(C(CCO)(O)O2)O1)O)O,,,4,1,1,0,1
19647_0,,,,2,1,1,2
C1(C(C2C(C(C(O)O2)CO)O1)O)O,,,4,1,1,0,1
19649_0,,,,2,1,1,2
C1C2C(C(C(C(O)O2)CO)(O)O1)O,,,4,1,2,0,2
19651_0,,,,2,1,1,2
C1C2C(CO)C(C(C(O)O2)O)(O)O1,,,4,1,1,0,1
19653_0,,,,2,1,1,2
C1C2C(C(C(C(CO)O1)(O)O2)O)O,,,4,1,1,0,1
19655_0,,,,2,1,1,2
C1C2C(C(CO)C(C(O)O1)(O)O2)O,,,4,1,1,0,1
19657_0,,,,2,1,1,2
C12C(C(CO)C(C(CO1)O)(O)O2)O,,,4,1,1,0,1
19659_0,,,,2,1,1,2
C1C(CO)C2(C(C(C(O1)O2)O)O)O,,,4,1,1,0,1
19661_0,,,,2,1,1,2
C1C2(C(CO)C(C(C(O)O1)O2)O)O,,,4,1,1,0,1
19663_0,,,,2,1,1,2
C1(C2C(CC(C(CO)O1)(O)O2)O)O,,,4,1,1,0,1
19664_0,,,,2,1,1,2
19666_0,,,,2,1,1,2
C(C(C1C(C(C(O)O1)=O)CO)O)=O,,,4,1,1,0,1
19667_0,,,,2,1,1,2
19669_0,,,,2,1,1,2
C(C1C(C(CO)C(C=O)(O1)O)O)=O,,,4,1,1,0,1
19671_0,,,,2,1,1,2
C1(C(O)OC(CO)(C)C1CO)=O,,,4,1,1,0,1
19672_0,,,,2,1,1,2
19674_0,,,,2,1,1,2
C(C1(C(CO)C(CO1)(C)O)O)=O,,,4,1,1,0,1
19675_0,,,,2,1,1,2
19676_0,,,,2,1,1,2
19678_0,,,,2,1,1,2
C1(C(O)OC(C)C1CO)=O,,,4,1,1,0,1
19679_0,,,,2,1,1,2
19680_0,,,,2,1,1,2
19681_0,,,,2,1,1,2
19683_0,,,,2,1,1,2
C(C1C(C(C(CCO)(O1)O)O)O)=O,,,4,1,1,0,1
19685_0,,,,2,1,1,2
C(C1C(C(CO)C(CO)(O1)O)O)=O,,,4,1,1,0,1
19687_0,,,,2,1,1,2
C1C(C)(C(C(CCO)(O)O1)O)O,,,4,1,1,0,1
19689_0,,,,2,1,1,2
C1C(C)(C(CO)C(CO)(O)O1)O,,,4,1,1,0,1
19691_0,,,,2,1,1,2
C1C(CCO)(CC(CO)(O)O1)O,,,4,1,1,0,1
19693_0,,,,2,1,1,2
CC1(C(C(CO1)(CCO)O)O)O,,,4,1,1,0,1
19695_0,,,,2,1,1,2
C1C(CC(O)O1)(CCO)O,,,4,1,1,0,1
19697_0,,,,2,1,1,2
C(C)(C(C1C(CC(O)O1)O)O)=O,,,4,1,1,0,1
19699_0,,,,2,1,1,2
C(CC1C(C(C(C)(O)O1)O)O)=O,,,4,1,1,0,1
19701_0,,,,2,1,1,2
C(C(C1C(C)(CC(O)O1)O)O)=O,,,4,1,1,0,1
19703_0,,,,2,1,1,2
C(CC1(C)C(C(C(O)O1)O)O)=O,,,4,1,1,0,1
19705_0,,,,2,1,1,2
C(C(C1C(OC(C=O)C1O)O)O)=O,,,4,1,1,0,1
19707_0,,,,2,1,1,2
C(C1C(C(C=O)O)OC(C1O)O)=O,,,4,1,1,0,1
19709_0,,,,2,1,1,2
C(C1C(CC(O1)O)O)=O,,,4,1,1,0,1
19711_0,,,,2,1,1,2
C1C(C)(CC(CO)(O)O1)O,,,4,1,1,0,1
19713_0,,,,2,1,1,2
C1C(C)(C(C(C)(O)O1)O)O,,,4,1,1,0,1
19715_0,,,,2,1,1,2
C(CO)(CC1CC(C(O)O1)O)=O,,,4,1,1,0,1
19717_0,,,,2,1,1,2
C(C)(C(C1CC(C(O)O1)O)O)=O,,,4,1,1,0,1
19719_0,,,,2,1,1,2
C(C(C1C(O)OCC1(C)O)O)=O,,,4,1,1,0,1
19721_0,,,,2,1,1,2
C(C1C(C(O)OC1(C)CO)O)=O,,,4,1,1,0,1
19723_0,,,,2,1,1,2
C(CO)(CC1C(C(C(O)O1)O)O)=O,,,4,1,1,0,1
19725_0,,,,2,1,1,2
C(C(C1C(CC(CO)(O)O1)O)O)=O,,,4,1,1,0,1
19727_0,,,,2,1,1,2
C(C)(C(C1C(C(C(O)O1)O)O)O)=O,,,4,1,1,0,1
19729_0,,,,2,1,1,2
C(C(C1C(C(C(C)(O)O1)O)O)O)=O,,,4,1,1,0,1
19731_0,,,,2,1,1,2
C1C(C)(CC(O)O1)O,,,4,1,1,0,1
19733_0,,,,2,1,1,2
C1C(CC(CO)(O)O1)(C(CO)O)O,,,4,1,1,0,1
19735_0,,,,2,1,1,2
C(C1(CC(CO)(C(CO)O1)O)O)O,,,4,1,1,0,1
19737_0,,,,2,1,1,2
C1C(C(CO)O)(C(C(C)(O)O1)O)O,,,4,1,1,0,1
19739_0,,,,2,1,1,2
CC1(C(C(CO)(C(CO)O1)O)O)O,,,4,1,1,0,1
19741_0,,,,2,1,1,2
C1C(C)(C(C(C(CO)O)(O)O1)O)O,,,4,1,1,0,1
19743_0,,,,2,1,1,2
C(C1C(C)OC(C1O)O)=O,,,4,1,1,0,1
19744_0,,,,2,1,1,2
19746_0,,,,2,1,1,2
C(CC1CC(C(O)O1)O)=O,,,4,1,1,0,1
19748_0,,,,2,1,1,2
C1C(CC(O)O1)(C(CO)O)O,,,4,1,1,0,1
19750_0,,,,2,1,1,2
C(C1(CC(O)OC1CO)O)O,,,4,1,1,0,1
19752_0,,,,2,1,1,2
C(CC1C(CC(CCO)(O1)O)=O)=O,,,4,1,1,0,1
19754_0,,,,2,1,1,2
C(CC1(CCO)CC(C(O)O1)=O)=O,,,4,1,1,0,1
19756_0,,,,2,1,1,2
C(CCO)(C1C(C(O)OC1C)=O)=O,,,4,1,1,0,1
19758_0,,,,2,1,1,2
C(C1(CCC(CO)(O1)O)CC=O)=O,,,4,1,1,0,1
19760_0,,,,2,1,1,2
C(CC1(CO)CCC(C=O)(O)O1)=O,,,4,1,1,0,1
19762_0,,,,2,1,1,2
C(C(CCC1(COC(C1)O)O)=O)=O,,,4,1,1,0,1
19764_0,,,,2,1,1,2
C(CC1C(C(O)OC1C)=O)(CO)=O,,,4,1,1,0,1
19766_0,,,,2,1,1,2
C(C(C1C(C)OC(C1)(CO)O)=O)=O,,,4,1,1,0,1
19768_0,,,,2,1,1,2
C(C1(CC(C(CO)=O)C(C)O1)O)=O,,,4,1,1,0,1
19770_0,,,,2,1,1,2
C(C1(CC(C(C)(O1)O)O)CC=O)=O,,,4,1,1,0,1
19771_0,,,,2,1,1,2
19773_0,,,,2,1,1,2
C(CC1(C)C(CC(C=O)(O)O1)O)=O,,,4,1,1,0,1
19774_0,,,,2,1,1,2
19776_0,,,,2,1,1,2
C(C(CC1C(C)(CC(O)O1)O)=O)=O,,,4,1,1,0,1
19778_0,,,,2,1,1,2
C(C(C1C(C(O)OC1C)=O)O)(C)=O,,,4,1,1,0,1
19780_0,,,,2,1,1,2
C(C(C1C(C)OC(C)(C1O)O)=O)=O,,,4,1,1,0,1
19781_0,,,,2,1,1,2
19782_0,,,,2,1,1,2
19783_0,,,,2,1,1,2
19784_0,,,,2,1,1,2
19786_0,,,,2,1,1,2
C(CC(C1C(C(O)OC1C)=O)O)=O,,,4,1,1,0,1
19787_0,,,,2,1,1,2
19788_0,,,,2,1,1,2
19790_0,,,,2,1,1,2
C(CC1CC(C(CCO)(O)O1)=O)=O,,,4,1,1,0,1
19791_0,,,,2,1,1,2
19793_0,,,,2,1,1,2
C1(C(CCO)(CC=O)OC(C1)O)=O,,,4,1,1,0,1
19794_0,,,,2,1,1,2
19796_0,,,,2,1,1,2
C(C1C(C(CCO)(O)OC1C)=O)=O,,,4,1,1,0,1
19797_0,,,,2,1,1,2
19799_0,,,,2,1,1,2
C(CC1(C(C(CO)C(C)O1)=O)O)=O,,,4,1,1,0,1
19800_0,,,,2,1,1,2
19801_0,,,,2,1,1,2
19802_0,,,,2,1,1,2
19803_0,,,,2,1,1,2
19804_0,,,,2,1,1,2
19805_0,,,,2,1,1,2
19806_0,,,,2,1,1,2
19807_0,,,,2,1,1,2
19808_0,,,,2,1,1,2
19810_0,,,,2,1,1,2
C(CC(C1C(C)(CC(O1)O)O)=O)=O,,,4,1,1,0,1
19811_0,,,,2,1,1,2
19812_0,,,,2,1,1,2
19814_0,,,,2,1,1,2
C(CC1(C(CC(O)O1)O)CC=O)=O,,,4,1,1,0,1
19815_0,,,,2,1,1,2
19817_0,,,,2,1,1,2
C(CC1CC(C(CC=O)(O)O1)O)=O,,,4,1,1,0,1
19818_0,,,,2,1,1,2
19819_0,,,,2,1,1,2
19820_0,,,,2,1,1,2
19822_0,,,,2,1,1,2
C(C1C(C)OC(C1O)(CC=O)O)=O,,,4,1,1,0,1
19824_0,,,,2,1,1,2
C(C1C(CC(O1)O)O)(CC(C)=O)=O,,,4,1,1,0,1
19825_0,,,,2,1,1,2
19827_0,,,,2,1,1,2
C(C1C(CC(O1)O)(CC(C)=O)O)=O,,,4,1,1,0,1
19828_0,,,,2,1,1,2
19829_0,,,,2,1,1,2
19831_0,,,,2,1,1,2
C(C1C(CC(CC(C)O)(O1)O)=O)=O,,,4,1,1,0,1
19833_0,,,,2,1,1,2
C(CCC=O)(C1C(CC(O1)O)O)=O,,,4,1,1,0,1
19835_0,,,,2,1,1,2
C(CC1(CCC(O)O1)C(C=O)O)=O,,,4,1,1,0,1
19837_0,,,,2,1,1,2
C(CCC1(CC(OC1C=O)O)O)=O,,,4,1,1,0,1
19839_0,,,,2,1,1,2
C(CC1CCC(C(C=O)O)(O)O1)=O,,,4,1,1,0,1
19841_0,,,,2,1,1,2
C(C(C(C1C(C)OC(C1)O)=O)O)=O,,,4,1,1,0,1
19843_0,,,,2,1,1,2
C(C1C(C)OC(C1)(C(C=O)O)O)=O,,,4,1,1,0,1
19845_0,,,,2,1,1,2
C(CC1C(CC(C(C)=O)(O)O1)O)=O,,,4,1,1,0,1
19847_0,,,,2,1,1,2
C(C(C)=O)(CC1C(CC(O)O1)O)=O,,,4,1,1,0,1
19848_0,,,,2,1,1,2
19850_0,,,,2,1,1,2
C(C)(C1(CC(C(O1)O)O)CC=O)=O,,,4,1,1,0,1
19851_0,,,,2,1,1,2
19852_0,,,,2,1,1,2
19854_0,,,,2,1,1,2
C(C(C)=O)(C1C(C)OC(C1O)O)=O,,,4,1,1,0,1
19856_0,,,,2,1,1,2
C1(C(C)(O)OC(C)C1C(C=O)O)=O,,,4,1,1,0,1
19858_0,,,,2,1,1,2
C1(CC(C=O)OC1(CC(C)O)O)=O,,,4,1,1,0,1
19860_0,,,,2,1,1,2
C(C(CC1(C(CC(C)O1)=O)O)O)=O,,,4,1,1,0,1
19862_0,,,,2,1,1,2
C(CC1C(CC(CC=O)(O)O1)O)=O,,,4,1,1,0,1
19864_0,,,,2,1,1,2
C(CC(CC1C(CC(O)O1)O)=O)=O,,,4,1,1,0,1
19866_0,,,,2,1,1,2
C(CC1(CC(C(O)O1)O)CC=O)=O,,,4,1,1,0,1
19868_0,,,,2,1,1,2
C(CC(C1C(C)OC(C1O)O)=O)=O,,,4,1,1,0,1
19870_0,,,,2,1,1,2
C(CO)=CC(C1C(CC(O1)O)O)=O,,,4,1,1,0,1
19872_0,,,,2,1,1,2
C(C1C(C=CCO)(CC(O1)O)O)=O,,,4,1,1,0,1
19874_0,,,,2,1,1,2
C(C1(C(CO)OC(C1)O)O)=CC=O,,,4,1,1,0,1
19876_0,,,,2,1,1,2
C(CC1C(C(C(C=C)(O)O1)O)O)=O,,,4,1,1,0,1
19878_0,,,,2,1,1,2
C=CC(C(C1C(CC(O)O1)O)O)=O,,,4,1,1,0,1
19880_0,,,,2,1,1,2
C(CC1(C=C)C(C(C(O1)O)O)O)=O,,,4,1,1,0,1
19882_0,,,,2,1,1,2
C(C(C1C(C=C)(CC(O)O1)O)O)=O,,,4,1,1,0,1
19884_0,,,,2,1,1,2
C(C1C(CC(O1)O)O)=CC(CO)=O,,,4,1,1,0,1
19886_0,,,,2,1,1,2
C(C(C=CC1(COC(C1)O)O)O)=O,,,4,1,1,0,1
19888_0,,,,2,1,1,2
C(C(C1C(CC(O)O1)O)O)=CC=O,,,4,1,1,0,1
19890_0,,,,2,1,1,2
C1C(CO)(C(C(O)O1)O)O,,,4,1,1,0,1
19892_0,,,,2,1,1,2
C1C(C(C(CO)(O)O1)O)O,,,4,1,1,0,1
19894_0,,,,2,1,1,2
C(C1C(C(C(O)O1)O)O)O,,,4,1,1,0,1
19896_0,,,,2,1,1,2
C(C1(CC(CO1)O)O)=O,,,4,1,1,0,1
19897_0,,,,2,1,1,2
19898_0,,,,2,1,1,2
19900_0,,,,2,1,1,2
C(CC1(COC(C1O)O)O)=O,,,4,1,1,0,1
19901_0,,,,2,1,1,2
19902_0,,,,2,1,1,2
19903_0,,,,2,1,1,2
19904_0,,,,2,1,1,2
19905_0,,,,2,1,1,2
19907_0,,,,2,1,1,2
CC1(C(CO)OC(C1O)O)O,,,4,1,1,0,1
19909_0,,,,2,1,1,2
C(C(C1(CO)CC(C(O)O1)O)O)=O,,,4,1,1,0,1
19911_0,,,,2,1,1,2
C(C(CC1(COC(C1O)O)O)O)=O,,,4,1,1,0,1
19913_0,,,,2,1,1,2
C(C(C1C(CO)(O)OCC1O)O)=O,,,4,1,1,0,1
19915_0,,,,2,1,1,2
C(CO)(C1C(CO)OC(C1O)O)=O,,,4,1,1,0,1
19917_0,,,,2,1,1,2
C(C(CC1(C(C(CO1)O)O)O)O)=O,,,4,1,1,0,1
19918_0,,,,2,1,1,2
19920_0,,,,2,1,1,2
C(C1(C(CO)C(CO1)O)O)=O,,,4,1,1,0,1
19922_0,,,,2,1,1,2
C1(C(O)OC(CO)C1CO)=O,,,4,1,1,0,1
19923_0,,,,2,1,1,2
19925_0,,,,2,1,1,2
C1C(CCO)(C(C(O)O1)O)O,,,4,1,1,0,1
19927_0,,,,2,1,1,2
C1C(C(CO)C(CO)(O)O1)O,,,4,1,1,0,1
19929_0,,,,2,1,1,2
C(C(C1(C)C(C(C(O)O1)O)O)O)=O,,,4,1,1,0,1
19931_0,,,,2,1,1,2
C(C(C1C(C)(C(C(O)O1)O)O)O)=O,,,4,1,1,0,1
19933_0,,,,2,1,1,2
C(C(C(C1(CC(CO1)O)O)O)O)=O,,,4,1,1,0,1
19935_0,,,,2,1,1,2
C(C1C(C(C(O1)O)O)O)=O,,,4,1,1,0,1
19937_0,,,,2,1,1,2
C1C(C)(C(C(O)O1)O)O,,,4,1,1,0,1
19939_0,,,,2,1,1,2
C1C(CC(CO)(O)O1)O,,,4,1,1,0,1
19941_0,,,,2,1,1,2
CC1(C(C(CO1)O)O)O,,,4,1,1,0,1
19943_0,,,,2,1,1,2
C(C(C1C(O)OCC1O)O)=O,,,4,1,1,0,1
19945_0,,,,2,1,1,2
C(C1C(CO)OC(C1O)O)=O,,,4,1,1,0,1
19947_0,,,,2,1,1,2
C(C(C1C(C(C(O)O1)O)O)O)=O,,,4,1,1,0,1
19949_0,,,,2,1,1,2
C1C(CC(O)O1)O,,,4,1,1,0,1
19951_0,,,,2,1,1,2
C1C(C(C(O)O1)O)(C(CO)O)O,,,4,1,1,0,1
19953_0,,,,2,1,1,2
C1(C(C(CO)(C(CO)O1)O)O)O,,,4,1,1,0,1
19955_0,,,,2,1,1,2
C(C1(CC(C(C(CO)O)O1)O)O)=O,,,4,1,1,0,1
19957_0,,,,2,1,1,2
C1(C(O)OC(C(C(CO)O)O)C1)=O,,,4,1,1,0,1
19959_0,,,,2,1,1,2
C(C1(CC(C(C(CO)O)O1)O)O)O,,,4,1,1,0,1
19961_0,,,,2,1,1,2
CC1(C(C(C(C(CO)O)O1)O)O)O,,,4,1,1,0,1
19962_0,,,,2,1,1,2
19963_0,,,,2,1,1,2
19965_0,,,,2,1,1,2
C(C(C1(C(CO)C(CO1)O)O)O)=O,,,4,1,1,0,1
19967_0,,,,2,1,1,2
C(C(CO)O)(C1COC(C1O)O)=O,,,4,1,1,0,1
19969_0,,,,2,1,1,2
C(C(C1C(C(C(O)O1)CO)O)O)=O,,,4,1,1,0,1
19970_0,,,,2,1,1,2
19972_0,,,,2,1,1,2
C1(C(CC(CCO)(O)O1)O)=O,,,4,1,1,0,1
19974_0,,,,2,1,1,2
C(C1CCC(CO)(O1)O)(O)=O,,,4,1,1,0,1
19976_0,,,,2,1,1,2
C(C1CC(C(C)(O1)O)O)(O)=O,,,4,1,1,0,1
19978_0,,,,2,1,1,2
C1(C(CCO)(CC(O)O1)O)=O,,,4,1,1,0,1
19980_0,,,,2,1,1,2
C(C1(C)CC(C(O1)O)O)(O)=O,,,4,1,1,0,1
19982_0,,,,2,1,1,2
C1(C(O)OCC1O)=O,,,4,1,1,0,1
19983_0,,,,2,1,1,2
19984_0,,,,2,1,1,2
19985_0,,,,2,1,1,2
19986_0,,,,2,1,1,2
19987_0,,,,2,1,1,2
19988_0,,,,2,1,1,2
19989_0,,,,2,1,1,2
19991_0,,,,2,1,1,2
C1(COC(C)(C1O)O)=O,,,4,1,1,0,1
19993_0,,,,2,1,1,2
C1(COC(C1O)O)=O,,,4,1,1,0,1
19995_0,,,,2,1,1,2
C1CC(C(O)O1)O,,,4,1,1,0,1
19997_0,,,,2,1,1,2
C1(C(CC(CO)(O)O1)O)=O,,,4,1,1,0,1
19999_0,,,,2,1,1,2
C1(C(C(C(C)(O)O1)O)O)=O,,,4,1,1,0,1
20001_0,,,,2,1,1,2
C1(C(C(C(O)O1)O)O)=O,,,4,1,1,0,1
20003_0,,,,2,1,1,2
C1(CC(C(O)O1)O)=O,,,4,1,1,0,1
20004_0,,,,2,1,1,2
20006_0,,,,2,1,1,2
C(OC1C(C)(O)OCC1O)=O,,,4,1,1,0,1
20008_0,,,,2,1,1,2
C(OC1COC(C)(C1O)O)=O,,,4,1,1,0,1
20010_0,,,,2,1,1,2
C(OC1COC(CO)(C1)O)=O,,,4,1,1,0,1
20012_0,,,,2,1,1,2
C(COC1(COC(C1)O)O)=O,,,4,1,1,0,1
20014_0,,,,2,1,1,2
C(COC1CC(C(O)O1)O)=O,,,4,1,1,0,1
20016_0,,,,2,1,1,2
C1C2C(C(C(C2O)O)(O)O1)O,,,4,1,2,0,2
20016_1,,,,2,1,1,2
20017_0,,,,2,1,1,2
20019_0,,,,2,1,1,2
C(C(C1(C(C(CO1)O)O)O)O)=O,,,4,1,1,0,1
20021_0,,,,2,1,1,2
C(C1CC(C(O1)O)O)=O,,,4,1,1,0,1
20023_0,,,,2,1,1,2
C1(C(C)OC(C1O)O)=O,,,4,1,1,0,1
20024_0,,,,2,1,1,2
20025_0,,,,2,1,1,2
20026_0,,,,2,1,1,2
20027_0,,,,2,1,1,2
20029_0,,,,2,1,1,2
C1(C(CO)OC(C)(C1O)O)=O,,,4,1,1,0,1
20031_0,,,,2,1,1,2
C1(COC(C(C)O)(C1O)O)=O,,,4,1,1,0,1
20033_0,,,,2,1,1,2
C1(C(C)OC(CO)(C1O)O)=O,,,4,1,1,0,1
20035_0,,,,2,1,1,2
C1(C(C(C)O)OC(C1O)O)=O,,,4,1,1,0,1
20036_0,,,,2,1,1,2
20037_0,,,,2,1,1,2
20038_0,,,,2,1,1,2
20040_0,,,,2,1,1,2
CC(C1(C(C(CO1)O)O)O)O,,,4,1,1,0,1
20042_0,,,,2,1,1,2
C1(CC(C(C(CO)O)(O)O1)O)=O,,,4,1,1,0,1
20043_0,,,,2,1,1,2
20044_0,,,,2,1,1,2
20045_0,,,,2,1,1,2
20046_0,,,,2,1,1,2
20048_0,,,,2,1,1,2
C1(C(C(C(C(C)O)(O)O1)O)O)=O,,,4,1,1,0,1
20050_0,,,,2,1,1,2
C(C1CCC(C=O)(O1)O)=O,,,4,1,1,0,1
20052_0,,,,2,1,1,2
C1(CC(C=O)(OC1C)O)=O,,,4,1,1,0,1
20054_0,,,,2,1,1,2
C(C(C1CCC(O1)O)=O)=O,,,4,1,1,0,1
20055_0,,,,2,1,1,2
20057_0,,,,2,1,1,2
C1C(C2(C(C(CO2)O)O1)O)O,,,4,1,1,0,1
20059_0,,,,2,1,1,2
C1C(C2(C(C(CO2)O1)O)O)O,,,4,1,1,0,1
20061_0,,,,2,1,1,2
C1C(C2(C(CC(O2)O1)O)O)O,,,4,1,1,0,1
20063_0,,,,2,1,1,2
C1C2CC(C(C(O)O1)(O)O2)O,,,4,1,2,0,2
20065_0,,,,2,1,1,2
C1C2(C(CC(C(O)O1)O2)O)O,,,4,1,2,0,2
20066_0,,,,2,1,1,2
20067_0,,,,2,1,1,2
20069_0,,,,2,1,1,2
C1C2CC(C(CO)(O)O2)(O)O1,,,4,1,2,0,2
20070_0,,,,2,1,1,2
20071_0,,,,2,1,1,2
20072_0,,,,2,1,1,2
20074_0,,,,2,1,1,2
C(CC1(C(CCO1)O)O)=O,,,4,1,1,0,1
20075_0,,,,2,1,1,2
20076_0,,,,2,1,1,2
20078_0,,,,2,1,1,2
C(C(C1(CCCO1)O)O)=O,,,4,1,1,0,1
20079_0,,,,2,1,1,2
20080_0,,,,2,1,1,2
20081_0,,,,2,1,1,2
20082_0,,,,2,1,1,2
20083_0,,,,2,1,1,2
20085_0,,,,2,1,1,2
C1(C(CC(O)O1)O)=O,,,4,1,1,0,1
20086_0,,,,2,1,1,2
20087_0,,,,2,1,1,2
20088_0,,,,2,1,1,2
20089_0,,,,2,1,1,2
20090_0,,,,2,1,1,2
20092_0,,,,2,1,1,2
C1(CC(C(CC=O)(O)O1)O)=O,,,4,1,1,0,1
20093_0,,,,2,1,1,2
20094_0,,,,2,1,1,2
20096_0,,,,2,1,1,2
C1(CCC(C(C=O)O)(O)O1)=O,,,4,1,1,0,1
20097_0,,,,2,1,1,2
20098_0,,,,2,1,1,2
20099_0,,,,2,1,1,2
20100_0,,,,2,1,1,2
20102_0,,,,2,1,1,2
C(C1(C2(CC(C(C1O)O2)O)O)O)O,,,4,1,1,0,1
20104_0,,,,2,1,1,2
C(C12C(O)OC(C(C1O)O)C2O)O,,,4,1,2,0,2
20104_1,,,,2,1,1,2
20106_0,,,,2,1,1,2
C1C(CO)(C(C(O)O1)(CO)O)O,,,4,1,1,0,1
20108_0,,,,2,1,1,2
C(C)(C1(C(O)OCC1(CO)O)O)=O,,,4,1,1,0,1
20110_0,,,,2,1,1,2
C(C1(C(C)(O)OCC1(CO)O)O)=O,,,4,1,1,0,1
20112_0,,,,2,1,1,2
C1C(CO)(C(CO)(C(C)(O)O1)O)O,,,4,1,1,0,1
20114_0,,,,2,1,1,2
C(C1(C(O)OCC1(CO)O)O)=O,,,4,1,1,0,1
20116_0,,,,2,1,1,2
C1(C(CO)(C(C(CO)O1)O)O)O,,,4,1,1,0,1
20118_0,,,,2,1,1,2
C(C1(COC(C)(C1O)O)O)=O,,,4,1,1,0,1
20119_0,,,,2,1,1,2
20120_0,,,,2,1,1,2
20122_0,,,,2,1,1,2
C(C1(CO)C(CO)(CC(O1)O)O)=O,,,4,1,1,0,1
20124_0,,,,2,1,1,2
C(CC1(COC(C1(CO)O)O)O)=O,,,4,1,1,0,1
20125_0,,,,2,1,1,2
20127_0,,,,2,1,1,2
C(C)(C1(C(O)OC(CO)C1O)O)=O,,,4,1,1,0,1
20129_0,,,,2,1,1,2
C(C1(C(C)(O)OC(CO)C1O)O)=O,,,4,1,1,0,1
20130_0,,,,2,1,1,2
20132_0,,,,2,1,1,2
C(C)(C1C(C(CO)(C(O1)O)O)O)=O,,,4,1,1,0,1
20134_0,,,,2,1,1,2
C(C1(CO)C(C)(C(C(O1)O)O)O)=O,,,4,1,1,0,1
20136_0,,,,2,1,1,2
C(C1C(C)(C(CO)(C(O1)O)O)O)=O,,,4,1,1,0,1
20138_0,,,,2,1,1,2
C(C1(COC(C1O)O)O)=O,,,4,1,1,0,1
20140_0,,,,2,1,1,2
CC1(C(CO)(C(C(CO)O1)O)O)O,,,4,1,1,0,1
20142_0,,,,2,1,1,2
CC1(C(CO)OC(C1(CO)O)O)O,,,4,1,1,0,1
20144_0,,,,2,1,1,2
C(C1(COC(C1O)(CCO)O)O)=O,,,4,1,1,0,1
20146_0,,,,2,1,1,2
C(C1(COC(C1(CCO)O)O)O)=O,,,4,1,1,0,1
20147_0,,,,2,1,1,2
20149_0,,,,2,1,1,2
C1C(CCO)(C(C(O)O1)(CO)O)O,,,4,1,1,0,1
20151_0,,,,2,1,1,2
C(C1(C(O)OC(CO)C1O)O)=O,,,4,1,1,0,1
20153_0,,,,2,1,1,2
C(C1(CO)C(C(C(O1)O)O)O)=O,,,4,1,1,0,1
20155_0,,,,2,1,1,2
C(C1C(C(CO)(C(O1)O)O)O)=O,,,4,1,1,0,1
20157_0,,,,2,1,1,2
C1C(C)(C(C(O)O1)(CO)O)O,,,4,1,1,0,1
20158_0,,,,2,1,1,2
20160_0,,,,2,1,1,2
C(CC1C(C(C(O)O1)(CO)O)O)=O,,,4,1,1,0,1
20161_0,,,,2,1,1,2
20163_0,,,,2,1,1,2
C(C)(C1(COC(C)(C1O)O)O)=O,,,4,1,1,0,1
20165_0,,,,2,1,1,2
C(C)(C1(COC(C1(C)O)O)O)=O,,,4,1,1,0,1
20167_0,,,,2,1,1,2
C(C1(C(C(OC1C(C)=O)O)O)O)=O,,,4,1,1,0,1
20169_0,,,,2,1,1,2
C(C1(C(C(C)(OC1C=O)O)O)O)=O,,,4,1,1,0,1
20171_0,,,,2,1,1,2
C(C1(C(C(OC1(C=O)C)O)O)O)=O,,,4,1,1,0,1
20173_0,,,,2,1,1,2
C(C1(C(C(OC1C=O)O)(C)O)O)=O,,,4,1,1,0,1
20175_0,,,,2,1,1,2
C(CO)(C1(COC(C)(C1O)O)O)=O,,,4,1,1,0,1
20177_0,,,,2,1,1,2
C(CO)(C1(COC(C1(C)O)O)O)=O,,,4,1,1,0,1
20179_0,,,,2,1,1,2
C(C1(C=O)C(CC(CO)(O1)O)O)=O,,,4,1,1,0,1
20180_0,,,,2,1,1,2
20182_0,,,,2,1,1,2
C(C1(C(O)OCC1(CC=O)O)O)=O,,,4,1,1,0,1
20184_0,,,,2,1,1,2
C(C1(C=O)C(CO)(CC(O1)O)O)=O,,,4,1,1,0,1
20186_0,,,,2,1,1,2
C(C1(C(OC(C(C)=O)C1O)O)O)=O,,,4,1,1,0,1
20188_0,,,,2,1,1,2
C(C1(C=O)C(C(C(C)(O1)O)O)O)=O,,,4,1,1,0,1
20190_0,,,,2,1,1,2
C(C1(C(OC(C=O)C1(C)O)O)O)=O,,,4,1,1,0,1
20192_0,,,,2,1,1,2
C(C1(C=O)C(C)(C(C(O1)O)O)O)=O,,,4,1,1,0,1
20194_0,,,,2,1,1,2
C(C1(C(C)=O)C(C(C(O1)O)O)O)=O,,,4,1,1,0,1
20196_0,,,,2,1,1,2
C(C1C(C(C(C)=O)(C(O1)O)O)O)=O,,,4,1,1,0,1
20198_0,,,,2,1,1,2
C(C1(C(C(C=O)OC1(C)O)O)O)=O,,,4,1,1,0,1
20200_0,,,,2,1,1,2
C(C)(C1(C(O)OCC1(C)O)O)=O,,,4,1,1,0,1
20202_0,,,,2,1,1,2
C(C1(C(C)(O)OCC1(C)O)O)=O,,,4,1,1,0,1
20204_0,,,,2,1,1,2
C(C)(C1(C(C(OC1C=O)O)O)O)=O,,,4,1,1,0,1
20206_0,,,,2,1,1,2
C(C1(C(C(OC1C=O)O)O)O)=O,,,4,1,1,0,1
20208_0,,,,2,1,1,2
C(CO)(C1(COC(C1O)O)O)=O,,,4,1,1,0,1
20210_0,,,,2,1,1,2
C1(C(C(CO)O)(C(C(O)O1)O)O)=O,,,4,1,1,0,1
20212_0,,,,2,1,1,2
C(C1(C(CO)OC(C1O)O)O)(O)=O,,,4,1,1,0,1
20214_0,,,,2,1,1,2
C(C1(C(O)OC(CO)C1(C)O)O)=O,,,4,1,1,0,1
20215_0,,,,2,1,1,2
20217_0,,,,2,1,1,2
C(C1C(C(CO)(C(C)(O1)O)O)O)=O,,,4,1,1,0,1
20219_0,,,,2,1,1,2
C1C(C)(C(CO)(C(C)(O)O1)O)O,,,4,1,1,0,1
20221_0,,,,2,1,1,2
C1(COC(C(CO)(CO)O)(C1)O)=O,,,4,1,1,0,1
20222_0,,,,2,1,1,2
20223_0,,,,2,1,1,2
20224_0,,,,2,1,1,2
20225_0,,,,2,1,1,2
20227_0,,,,2,1,1,2
C(C)(C1(COC(CO)(C1O)O)O)=O,,,4,1,1,0,1
20229_0,,,,2,1,1,2
C(C1(COC(C1O)(C(C)O)O)O)=O,,,4,1,1,0,1
20231_0,,,,2,1,1,2
C(C(C)O)(C1(COC(C1O)O)O)=O,,,4,1,1,0,1
20232_0,,,,2,1,1,2
20234_0,,,,2,1,1,2
C1C(C(CO)(C(CCO)(O)O1)O)O,,,4,1,1,0,1
20235_0,,,,2,1,1,2
20237_0,,,,2,1,1,2
C1(C(CO)(C(C(CCO)O1)O)O)O,,,4,1,1,0,1
20238_0,,,,2,1,1,2
20239_0,,,,2,1,1,2
20241_0,,,,2,1,1,2
C1C2(C(CO)(C(C(CO)O2)O1)O)O,,,4,1,1,0,1
20243_0,,,,2,1,1,2
C1C(C2(CO)C(CC(O)O2)(O)O1)O,,,4,1,1,0,1
20245_0,,,,2,1,1,2
CC1(C2(CO)C(C(C(O)O2)O1)O)O,,,4,1,1,0,1
20247_0,,,,2,1,1,2
C1C2C(CO)(C(CC(O)O2)(O)O1)O,,,4,1,1,0,1
20249_0,,,,2,1,1,2
C1C2CC(C(C(O)O2)(CO)O)(O)O1,,,4,1,2,0,2
20251_0,,,,2,1,1,2
C1C2(C(CO)(C(C(CO1)O2)O)O)O,,,4,1,1,0,1
20253_0,,,,2,1,1,2
C12C(CC(C(CO1)(CO)O)(O)O2)O,,,4,1,1,0,1
20255_0,,,,2,1,1,2
C12C(C(CO)(C(CCO1)(O)O2)O)O,,,4,1,1,0,1
20257_0,,,,2,1,1,2
C(C1(COC(C=C)(C1O)O)O)=O,,,4,1,1,0,1
20259_0,,,,2,1,1,2
C=CC(C1(COC(C1O)O)O)=O,,,4,1,1,0,1
20261_0,,,,2,1,1,2
CC1(C2C(C(C(O)O2)(CO)O1)O)O,,,4,1,1,0,1
20263_0,,,,2,1,1,2
C1(C(CO)(C2C(CC(O)O2)O1)O)O,,,4,1,1,0,1
20265_0,,,,2,1,1,2
C1(C2(CO)C(C(CC(O)O2)O1)O)O,,,4,1,1,0,1
20266_0,,,,2,1,1,2
20268_0,,,,2,1,1,2
C(C1(C(O)OCC1(CCO)O)O)=O,,,4,1,1,0,1
20270_0,,,,2,1,1,2
C(C1(C(C)OC(C)(C1O)O)O)=O,,,4,1,1,0,1
20272_0,,,,2,1,1,2
C(C)(C1(C(C)OC(C1O)O)O)=O,,,4,1,1,0,1
20274_0,,,,2,1,1,2
C(C1(C(OC(C=O)C1O)O)O)=O,,,4,1,1,0,1
20276_0,,,,2,1,1,2
C(C1(C=O)C(C(C(O1)O)O)O)=O,,,4,1,1,0,1
20277_0,,,,2,1,1,2
20279_0,,,,2,1,1,2
C(C(C=O)(C1C(CC(O)O1)O)O)=O,,,4,1,1,0,1
20281_0,,,,2,1,1,2
C(C1(C(O)OC(C1O)CC=O)O)=O,,,4,1,1,0,1
20283_0,,,,2,1,1,2
C(C(C=O)(C1CC(C(O)O1)O)O)=O,,,4,1,1,0,1
20285_0,,,,2,1,1,2
C(C(C1(C(O)OCC1(C)O)O)O)=O,,,4,1,1,0,1
20287_0,,,,2,1,1,2
C(C1(C(C(O)OC1(CO)C)O)O)=O,,,4,1,1,0,1
20289_0,,,,2,1,1,2
C1C(C)(C(CO)(C(CO)(O)O1)O)O,,,4,1,1,0,1
20291_0,,,,2,1,1,2
C(C1(C(C)OC(C1O)O)O)=O,,,4,1,1,0,1
20292_0,,,,2,1,1,2
20293_0,,,,2,1,1,2
20295_0,,,,2,1,1,2
C(C1(C(C(C=C)(O)OC1C)O)O)=O,,,4,1,1,0,1
20297_0,,,,2,1,1,2
C=CC(C1(C(C)OC(C1O)O)O)=O,,,4,1,1,0,1
20299_0,,,,2,1,1,2
C1C(C(C(O)O1)(CO)O)O,,,4,1,1,0,1
20300_0,,,,2,1,1,2
20301_0,,,,2,1,1,2
20303_0,,,,2,1,1,2
C1C(C(CO)(C(C)(O)O1)O)O,,,4,1,1,0,1
20305_0,,,,2,1,1,2
C(C)(C(C1(C(O)OCC1O)O)O)=O,,,4,1,1,0,1
20307_0,,,,2,1,1,2
C(C1(C(CO)OC(C)(C1O)O)O)=O,,,4,1,1,0,1
20309_0,,,,2,1,1,2
C(C(C1(C(C)(O)OCC1O)O)O)=O,,,4,1,1,0,1
20311_0,,,,2,1,1,2
C(C)(C1(C(CO)OC(C1O)O)O)=O,,,4,1,1,0,1
20313_0,,,,2,1,1,2
C(C1(C(O)OCC1O)O)=O,,,4,1,1,0,1
20315_0,,,,2,1,1,2
C(C(C1(C(O)OCC1O)O)O)=O,,,4,1,1,0,1
20317_0,,,,2,1,1,2
C(C1(C(CO)OC(C1O)O)O)=O,,,4,1,1,0,1
20319_0,,,,2,1,1,2
C1C(C(CO)(C(CO)(O)O1)O)O,,,4,1,1,0,1
20321_0,,,,2,1,1,2
C(C1(C(CO)OC(C1(C)O)O)O)=O,,,4,1,1,0,1
20323_0,,,,2,1,1,2
C(C(C)(C1(C(O)OCC1O)O)O)=O,,,4,1,1,0,1
20325_0,,,,2,1,1,2
CC(CO)(C1(C(O)OCC1O)O)O,,,4,1,1,0,1
20327_0,,,,2,1,1,2
C1C(C)(C(C(O)O1)(C(CO)O)O)O,,,4,1,1,0,1
20329_0,,,,2,1,1,2
C1C(C(C(O)O1)(C(C)O)O)O,,,4,1,1,0,1
20330_0,,,,2,1,1,2
20332_0,,,,2,1,1,2
C(CC1(C(CO)(C(CO1)O)O)O)=O,,,4,1,1,0,1
20333_0,,,,2,1,1,2
20335_0,,,,2,1,1,2
C(CCO)(C1(COC(C1O)O)O)=O,,,4,1,1,0,1
20337_0,,,,2,1,1,2
C1(C2(CC(C(C2O)O1)O)O)O,,,4,1,2,0,2
20337_1,,,,2,1,1,2
20339_0,,,,2,1,1,2
C1(C2(CC(C(C2O)O)O1)O)O,,,4,1,2,0,2
20339_1,,,,2,1,1,2
20341_0,,,,2,1,1,2
C(CC1(C(O)OCC1(CO)O)O)=O,,,4,1,1,0,1
20343_0,,,,2,1,1,2
C(C1(CC(O)OC1(CO)CO)O)=O,,,4,1,1,0,1
20345_0,,,,2,1,1,2
C(CC1(C(O)OC(CO)C1O)O)=O,,,4,1,1,0,1
20347_0,,,,2,1,1,2
C(C1(CC(O)OC1C(CO)O)O)=O,,,4,1,1,0,1
20349_0,,,,2,1,1,2
C(C1(CC(OC1C(C)=O)O)O)=O,,,4,1,1,0,1
20351_0,,,,2,1,1,2
C(C1(CC(OC1(C=O)C)O)O)=O,,,4,1,1,0,1
20353_0,,,,2,1,1,2
C1(C(C(C)(C(O)O1)O)O)=O,,,4,1,1,0,1
20354_0,,,,2,1,1,2
20356_0,,,,2,1,1,2
C(C1C(CO)(CC(O1)O)O)(O)=O,,,4,1,1,0,1
20358_0,,,,2,1,1,2
C(C1C(C)(C(C(O1)O)O)O)(O)=O,,,4,1,1,0,1
20360_0,,,,2,1,1,2
C(C1(CC(CO)(OC1C=O)O)O)=O,,,4,1,1,0,1
20362_0,,,,2,1,1,2
C(C1(CC(OC1C=O)O)O)=O,,,4,1,1,0,1
20364_0,,,,2,1,1,2
C(C1(COC(CO)(C1)O)O)=O,,,4,1,1,0,1
20366_0,,,,2,1,1,2
C(C1(C(C)OC(CO)(C1)O)O)=O,,,4,1,1,0,1
20368_0,,,,2,1,1,2
C(C1(COC(C1)O)O)=O,,,4,1,1,0,1
20370_0,,,,2,1,1,2
C(C(CO)O)(C1(COC(C1)O)O)=O,,,4,1,1,0,1
20372_0,,,,2,1,1,2
C1(C(O)OCC1(CC(CO)O)O)=O,,,4,1,1,0,1
20374_0,,,,2,1,1,2
C(C1(C(CO)(CC(CO)O1)O)O)=O,,,4,1,1,0,1
20375_0,,,,2,1,1,2
20377_0,,,,2,1,1,2
C(CO)(C1CC(C(O1)O)(CO)O)=O,,,4,1,1,0,1
20379_0,,,,2,1,1,2
C(C1CC(CO)(C(CO)(O1)O)O)=O,,,4,1,1,0,1
20380_0,,,,2,1,1,2
20381_0,,,,2,1,1,2
20383_0,,,,2,1,1,2
C(C(C1(C(CO)(CCO1)O)O)O)=O,,,4,1,1,0,1
20385_0,,,,2,1,1,2
C(CO)(C1(COC(CO)(C1)O)O)=O,,,4,1,1,0,1
20387_0,,,,2,1,1,2
C(C(C1CC(C(O)O1)(CO)O)O)=O,,,4,1,1,0,1
20389_0,,,,2,1,1,2
C(C1(CC(C(C)=O)(CO1)O)O)=O,,,4,1,1,0,1
20390_0,,,,2,1,1,2
20392_0,,,,2,1,1,2
C(CC(C1(COC(C1)O)O)=O)=O,,,4,1,1,0,1
20393_0,,,,2,1,1,2
20395_0,,,,2,1,1,2
C(C1(COC(C(C)=O)(C1)O)O)=O,,,4,1,1,0,1
20396_0,,,,2,1,1,2
20398_0,,,,2,1,1,2
C(C1(COC(C1)(CC=O)O)O)=O,,,4,1,1,0,1
20400_0,,,,2,1,1,2
C(C1(C2(CC(C(CO)O2)O1)O)O)O,,,4,1,1,0,1
20402_0,,,,2,1,1,2
C1C2C(CC(C(CO)(O)O1)(O)O2)O,,,4,1,1,0,1
20403_0,,,,2,1,1,2
20405_0,,,,2,1,1,2
C1(C(C(C(O)O1)(CCO)O)O)=O,,,4,1,1,0,1
20407_0,,,,2,1,1,2
C(CC1(C(C(C=O)OC1O)O)O)=O,,,4,1,1,0,1
20409_0,,,,2,1,1,2
C(C1(C(C(C=O)O)OC(C1)O)O)=O,,,4,1,1,0,1
20411_0,,,,2,1,1,2
C(C1(C(C(C(O1)O)O)O)CC=O)=O,,,4,1,1,0,1
20413_0,,,,2,1,1,2
C(C1C(C(C(O1)O)O)O)(O)=O,,,4,1,1,0,1
20415_0,,,,2,1,1,2
C(CC1(C(O)OCC1(C)O)O)=O,,,4,1,1,0,1
20417_0,,,,2,1,1,2
C(C1(CC(O)OC1(CO)C)O)=O,,,4,1,1,0,1
20419_0,,,,2,1,1,2
C(C1(C(C)OC(C1)O)O)=O,,,4,1,1,0,1
20421_0,,,,2,1,1,2
C(C(C1C(C(C(O)O1)O)O)O)(O)=O,,,4,1,1,0,1
20423_0,,,,2,1,1,2
C(C1(CC(C(C)=O)(C(C)O1)O)O)=O,,,4,1,1,0,1
20424_0,,,,2,1,1,2
20426_0,,,,2,1,1,2
C(CC(C1(C(C)OC(C1)O)O)=O)=O,,,4,1,1,0,1
20427_0,,,,2,1,1,2
20429_0,,,,2,1,1,2
C(C1(CC(C(C)=O)(O)OC1C)O)=O,,,4,1,1,0,1
20430_0,,,,2,1,1,2
20432_0,,,,2,1,1,2
C(C1(C(C)OC(C1)(CC=O)O)O)=O,,,4,1,1,0,1
20434_0,,,,2,1,1,2
C(CO)(CC1(C(O)OCC1O)O)=O,,,4,1,1,0,1
20436_0,,,,2,1,1,2
C(C1(C(CO)OC(CO)(C1)O)O)=O,,,4,1,1,0,1
20437_0,,,,2,1,1,2
20439_0,,,,2,1,1,2
C(C1(C(CO)OC(C1)O)O)=O,,,4,1,1,0,1
20441_0,,,,2,1,1,2
C(C1(COC(C1)(C(CO)O)O)O)=O,,,4,1,1,0,1
20443_0,,,,2,1,1,2
C(CO)(OC1C(O)OCC1O)=O,,,4,1,1,0,1
20445_0,,,,2,1,1,2
C(CO)(OC1COC(C1O)O)=O,,,4,1,1,0,1
20447_0,,,,2,1,1,2
C1(C(C2(CC1CO2)O)O)=O,,,4,1,2,0,2
20447_1,,,,2,1,1,2
20449_0,,,,2,1,1,2
C1(C(C)(O)OC(CO)C1O)=O,,,4,1,1,0,1
20450_0,,,,2,1,1,2
20452_0,,,,2,1,1,2
C1(CC2(CC1(CO2)O)O)=O,,,4,1,2,0,2
20452_1,,,,2,1,1,2
20453_0,,,,2,1,1,2
20454_0,,,,2,1,1,2
20455_0,,,,2,1,1,2
20456_0,,,,2,1,1,2
20457_0,,,,2,1,1,2
20458_0,,,,2,1,1,2
20459_0,,,,2,1,1,2
20460_0,,,,2,1,1,2
20462_0,,,,2,1,1,2
C1(C2C(C(C(CO)O2)O1)O)O,,,4,1,1,0,1
20464_0,,,,2,1,1,2
C1C2C(C(C(CO)O2)(O)O1)O,,,4,1,1,0,1
20465_0,,,,2,1,1,2
20467_0,,,,2,1,1,2
C1C2(CC(C(CO)O2)(O)O1)O,,,4,1,2,0,2
20469_0,,,,2,1,1,2
C(C1(C2CC(CO2)O1)O)=O,,,4,1,1,0,1
20471_0,,,,2,1,1,2
C(C1C2CC(C(O)O2)O1)=O,,,4,1,1,0,1
20473_0,,,,2,1,1,2
C1C(C2C(C(C(O)O2)O1)O)O,,,4,1,1,0,1
20475_0,,,,2,1,1,2
C1C2(CC(C(CO2)O)(O)O1)O,,,4,1,2,0,2
20477_0,,,,2,1,1,2
C1C2(C(C(CCO2)(O)O1)O)O,,,4,1,2,0,2
20479_0,,,,2,1,1,2
C1(C2(CC(C(CO)O2)O1)O)=O,,,4,1,2,0,2
20481_0,,,,2,1,1,2
C1(CC2(C(C(CO2)O)O1)O)=O,,,4,1,2,0,2
20483_0,,,,2,1,1,2
C1(C2C(C(C(C)(O2)O)O1)O)=O,,,4,1,2,0,2
20485_0,,,,2,1,1,2
C1(C(C2C(CC(O)O2)O1)O)=O,,,4,1,2,0,2
20487_0,,,,2,1,1,2
C1(CC2(C(C(CO2)O1)O)O)=O,,,4,1,2,0,2
20489_0,,,,2,1,1,2
C1(C(C2(CC(CO2)O1)O)O)=O,,,4,1,2,0,2
20491_0,,,,2,1,1,2
C1(C2(CC(C(CO1)O2)O)O)=O,,,4,1,2,0,2
20493_0,,,,2,1,1,2
C1(C2C(CC(CO1)(O2)O)O)=O,,,4,1,2,0,2
20494_0,,,,2,1,1,2
20495_0,,,,2,1,1,2
20496_0,,,,2,1,1,2
20497_0,,,,2,1,1,2
20498_0,,,,2,1,1,2
20499_0,,,,2,1,1,2
20500_0,,,,2,1,1,2
20502_0,,,,2,1,1,2
C1(C2(C(C(C(CO)O2)O1)O)O)O,,,4,1,2,0,2
20503_0,,,,2,1,1,2
20504_0,,,,2,1,1,2
20506_0,,,,2,1,1,2
C1(C2CC(C(CO)(O)O2)O1)O,,,4,1,2,0,2
20507_0,,,,2,1,1,2
20509_0,,,,2,1,1,2
C1CC2C(C(C(O)O2)O)(O)O1,,,4,1,2,0,2
20510_0,,,,2,1,1,2
20512_0,,,,2,1,1,2
C1C(C2C(C(C(O)O2)(O)O1)O)O,,,4,1,2,0,2
20514_0,,,,2,1,1,2
C1(C2CC(C(C(O)O2)O)O1)O,,,4,1,2,0,2
20516_0,,,,2,1,1,2
C1C2C(C(C(C(O)O1)(O)O2)O)O,,,4,1,2,0,2
20518_0,,,,2,1,1,2
C1(CC2C(C(C(O)O2)O)O1)=O,,,4,1,2,0,2
20520_0,,,,2,1,1,2
C1(CC2C(C(C(O)O2)O1)O)=O,,,4,1,2,0,2
20522_0,,,,2,1,1,2
C(C(CC1C(CO)OC(C1)O)=O)=O,,,4,1,1,0,1
20524_0,,,,2,1,1,2
C(CC1CC(C=O)(O)OC1CO)=O,,,4,1,1,0,1
20526_0,,,,2,1,1,2
C(C(C(CC1COC(C1)O)=O)O)=O,,,4,1,1,0,1
20528_0,,,,2,1,1,2
C(CC1COC(C1)(C(C=O)O)O)=O,,,4,1,1,0,1
20530_0,,,,2,1,1,2
C(C1C(CC(O1)O)CC(CO)=O)=O,,,4,1,1,0,1
20532_0,,,,2,1,1,2
C(CC1CC(CO)(OC1C=O)O)=O,,,4,1,1,0,1
20534_0,,,,2,1,1,2
C(CC1C(C(C=O)O)OC(C1)O)=O,,,4,1,1,0,1
20536_0,,,,2,1,1,2
C1(COC(C(C)(C1O)O)O)=O,,,4,1,1,0,1
20538_0,,,,2,1,1,2
C1(C(O)OCC(CO)(C1)O)=O,,,4,1,1,0,1
20540_0,,,,2,1,1,2
C1(C(C(CO)(CO)OC(C1)O)O)=O,,,4,1,1,0,1
20542_0,,,,2,1,1,2
C1(C(C(O)OC(CO)(CO)C1)O)=O,,,4,1,1,0,1
20544_0,,,,2,1,1,2
C1(COC(C(C1O)O)O)=O,,,4,1,1,0,1
20546_0,,,,2,1,1,2
CC1(C(COC(CO)(C1O)O)O)O,,,4,1,1,0,1
20548_0,,,,2,1,1,2
C1(COC(C(C1O)O)(CCO)O)=O,,,4,1,1,0,1
20550_0,,,,2,1,1,2
C1(COC(C(CCO)(C1O)O)O)=O,,,4,1,1,0,1
20552_0,,,,2,1,1,2
C(C1(CCOC(CO)(C1O)O)O)=O,,,4,1,1,0,1
20554_0,,,,2,1,1,2
C1(C(O)OCC(CO)(C1CO)O)=O,,,4,1,1,0,1
20556_0,,,,2,1,1,2
C1CC(CO)(C(C(CO)(O)O1)O)O,,,4,1,1,0,1
20558_0,,,,2,1,1,2
C(CO)(C1C(C(CC(O1)O)O)O)=O,,,4,1,1,0,1
20560_0,,,,2,1,1,2
C(CO)(C1C(CC(C(O1)O)O)O)=O,,,4,1,1,0,1
20562_0,,,,2,1,1,2
C(C1CC(C(C(CO)(O1)O)O)O)=O,,,4,1,1,0,1
20564_0,,,,2,1,1,2
C(C1C(C(O)OCC1(CO)O)O)=O,,,4,1,1,0,1
20566_0,,,,2,1,1,2
C(CO)(C1C(O)OCC(C1O)O)=O,,,4,1,1,0,1
20568_0,,,,2,1,1,2
C(C1C(CO)(O)OCC(C1O)O)=O,,,4,1,1,0,1
20570_0,,,,2,1,1,2
C(CC1(C(C(C(CO1)O)O)O)O)=O,,,4,1,1,0,1
20572_0,,,,2,1,1,2
C1(C(C(C(CO)O)OC(C1)O)O)=O,,,4,1,1,0,1
20574_0,,,,2,1,1,2
C(C(C1(CC(C(CO1)O)O)O)O)=O,,,4,1,1,0,1
20576_0,,,,2,1,1,2
C1(C(C(O)OC(C(CO)O)C1)O)=O,,,4,1,1,0,1
20578_0,,,,2,1,1,2
C1C(C(CC(C(CO)O)(O)O1)O)O,,,4,1,1,0,1
20579_0,,,,2,1,1,2
20581_0,,,,2,1,1,2
C(C1(C(CO)C(C(CO1)O)O)O)=O,,,4,1,1,0,1
20583_0,,,,2,1,1,2
C1C(C(C(C(CCO)(O)O1)O)O)O,,,4,1,1,0,1
20585_0,,,,2,1,1,2
C1C(C(C(CO)C(CO)(O)O1)O)O,,,4,1,1,0,1
20587_0,,,,2,1,1,2
C(C1C(C(O)OC(CO)C1O)O)=O,,,4,1,1,0,1
20589_0,,,,2,1,1,2
C(C(C1C(O)OCC(C1O)O)O)=O,,,4,1,1,0,1
20591_0,,,,2,1,1,2
C1C(C(CC(O)O1)O)O,,,4,1,1,0,1
20593_0,,,,2,1,1,2
C(CC1(COC(C(C1)=O)O)O)=O,,,4,1,1,0,1
20595_0,,,,2,1,1,2
C(C1C(COC(C)(C1O)O)=O)=O,,,4,1,1,0,1
20597_0,,,,2,1,1,2
C(C1C(COC(C1(C)O)O)=O)=O,,,4,1,1,0,1
20599_0,,,,2,1,1,2
C1(C(C(C(C)=O)OC(C1)O)O)=O,,,4,1,1,0,1
20601_0,,,,2,1,1,2
C(C1(C)C(C(CC(O1)O)=O)O)=O,,,4,1,1,0,1
20603_0,,,,2,1,1,2
C(C)(C1C(CC(C(O1)O)=O)O)=O,,,4,1,1,0,1
20605_0,,,,2,1,1,2
C(C1C(C)(CC(C(O1)O)=O)O)=O,,,4,1,1,0,1
20607_0,,,,2,1,1,2
C(C1C(CC(C(C)(O1)O)O)=O)=O,,,4,1,1,0,1
20609_0,,,,2,1,1,2
C1(CC(C(C)=O)OC(C1O)O)=O,,,4,1,1,0,1
20611_0,,,,2,1,1,2
C(C1C(CC(C)(C(O1)O)O)=O)=O,,,4,1,1,0,1
20613_0,,,,2,1,1,2
C(C1(C)CC(C(C(O1)O)O)=O)=O,,,4,1,1,0,1
20615_0,,,,2,1,1,2
C1(C(O)OC(CO)C(C)(C1)O)=O,,,4,1,1,0,1
20617_0,,,,2,1,1,2
C(C1(CC(C)(C(CO1)O)O)O)=O,,,4,1,1,0,1
20619_0,,,,2,1,1,2
C1(C(CO)OC(C(C1)O)(C)O)=O,,,4,1,1,0,1
20621_0,,,,2,1,1,2
C1(C(CO)OC(C(C)(C1)O)O)=O,,,4,1,1,0,1
20623_0,,,,2,1,1,2
C(C1(CC(C=O)(O)OCC1)O)=O,,,4,1,1,0,1
20625_0,,,,2,1,1,2
C1(C(O)OCC(CCO)(C1)O)=O,,,4,1,1,0,1
20627_0,,,,2,1,1,2
C(C1(CC(CO)(CCO1)O)O)=O,,,4,1,1,0,1
20629_0,,,,2,1,1,2
C1(COC(C)(C(C1CO)O)O)=O,,,4,1,1,0,1
20631_0,,,,2,1,1,2
C1(COC(C(C)(C1CO)O)O)=O,,,4,1,1,0,1
20633_0,,,,2,1,1,2
C(C1C(CC(C(O1)O)=O)O)=O,,,4,1,1,0,1
20635_0,,,,2,1,1,2
C1(C(O)OCC(C)(C1)O)=O,,,4,1,1,0,1
20636_0,,,,2,1,1,2
20638_0,,,,2,1,1,2
C1(COC(C(C)(C1)O)O)=O,,,4,1,1,0,1
20640_0,,,,2,1,1,2
C(CC1C(CC(C(O)O1)=O)O)=O,,,4,1,1,0,1
20642_0,,,,2,1,1,2
C(C1CC(CC(C=O)(O1)O)O)=O,,,4,1,1,0,1
20644_0,,,,2,1,1,2
C(C(C1C(CC(C(O)O1)=O)O)O)=O,,,4,1,1,0,1
20646_0,,,,2,1,1,2
C(C1C(C(CC(C=O)(O1)O)O)O)=O,,,4,1,1,0,1
20648_0,,,,2,1,1,2
C1(C(O)OCC(C(CO)O)(C1)O)=O,,,4,1,1,0,1
20650_0,,,,2,1,1,2
C1(C(O)OC(CO)C(CO)(C1)O)=O,,,4,1,1,0,1
20652_0,,,,2,1,1,2
C(C1(CC(CO)(C(CO1)O)O)O)=O,,,4,1,1,0,1
20653_0,,,,2,1,1,2
20655_0,,,,2,1,1,2
C1(C(CO)OC(C(C)(C1O)O)O)=O,,,4,1,1,0,1
20657_0,,,,2,1,1,2
C(C1C(COC(C1O)O)=O)=O,,,4,1,1,0,1
20659_0,,,,2,1,1,2
C1(C(C(C=O)OC(C1)O)O)=O,,,4,1,1,0,1
20661_0,,,,2,1,1,2
C1(C(COC(C1)O)O)=O,,,4,1,1,0,1
20663_0,,,,2,1,1,2
C1(C(C(C(C=O)O)OC(C1)O)O)=O,,,4,1,1,0,1
20665_0,,,,2,1,1,2
C1(C(C(CO)(C)OC(C1)O)O)=O,,,4,1,1,0,1
20667_0,,,,2,1,1,2
C1(C(C(C)OC(C1)O)O)=O,,,4,1,1,0,1
20669_0,,,,2,1,1,2
C(C1C(CC(C(O1)O)O)=O)=O,,,4,1,1,0,1
20671_0,,,,2,1,1,2
C1(CC(C=O)OC(C1O)O)=O,,,4,1,1,0,1
20673_0,,,,2,1,1,2
C1(C(C(O)OCC1)O)=O,,,4,1,1,0,1
20675_0,,,,2,1,1,2
C1(C(C(O)OC(C(C=O)O)C1)O)=O,,,4,1,1,0,1
20677_0,,,,2,1,1,2
C1(C(C(O)OC(CO)(C)C1)O)=O,,,4,1,1,0,1
20679_0,,,,2,1,1,2
C1(C(C(O)OC(C)C1)O)=O,,,4,1,1,0,1
20680_0,,,,2,1,1,2
20681_0,,,,2,1,1,2
20682_0,,,,2,1,1,2
20684_0,,,,2,1,1,2
C1(C(CO)OC(C(C1O)O)O)=O,,,4,1,1,0,1
20686_0,,,,2,1,1,2
C1C(C(C)(CC(CO)(O)O1)O)O,,,4,1,1,0,1
20688_0,,,,2,1,1,2
CC1(C(COC(C)(C1O)O)O)O,,,4,1,1,0,1
20690_0,,,,2,1,1,2
C1C(C(C)(CC(O)O1)O)O,,,4,1,1,0,1
20691_0,,,,2,1,1,2
20692_0,,,,2,1,1,2
20694_0,,,,2,1,1,2
C(C1CC(CO)(CC(O1)O)O)=O,,,4,1,1,0,1
20695_0,,,,2,1,1,2
20696_0,,,,2,1,1,2
20698_0,,,,2,1,1,2
C1(C(C(CO)O)(O)OCC(C1)O)=O,,,4,1,1,0,1
20699_0,,,,2,1,1,2
20701_0,,,,2,1,1,2
C1(C(COC(C(CO)O)(C1)O)O)=O,,,4,1,1,0,1
20702_0,,,,2,1,1,2
20704_0,,,,2,1,1,2
C1(C(C(CCO)(O)OCC1O)O)=O,,,4,1,1,0,1
20706_0,,,,2,1,1,2
C1(C(C(C(CO)O)(O)OCC1)O)=O,,,4,1,1,0,1
20707_0,,,,2,1,1,2
20708_0,,,,2,1,1,2
20710_0,,,,2,1,1,2
C1(COC(C(C1)O)(C(CO)O)O)=O,,,4,1,1,0,1
20712_0,,,,2,1,1,2
C1(COC(CO)(C(CO)C1O)O)=O,,,4,1,1,0,1
20713_0,,,,2,1,1,2
20715_0,,,,2,1,1,2
C1(COC(CC1O)(C(CO)O)O)=O,,,4,1,1,0,1
20716_0,,,,2,1,1,2
20718_0,,,,2,1,1,2
C(C1COC(CO)(C(C1O)O)O)=O,,,4,1,1,0,1
20720_0,,,,2,1,1,2
C1(C(CO)C(C(C(CO)O1)O)O)O,,,4,1,1,0,1
20721_0,,,,2,1,1,2
20722_0,,,,2,1,1,2
20724_0,,,,2,1,1,2
C(C1(C(CO)CC(CO1)=O)O)=O,,,4,1,1,0,1
20726_0,,,,2,1,1,2
C(CO)(C1COC(C(C1)=O)O)=O,,,4,1,1,0,1
20727_0,,,,2,1,1,2
20728_0,,,,2,1,1,2
20730_0,,,,2,1,1,2
C(C(C1COC(CC1O)O)=O)=O,,,4,1,1,0,1
20732_0,,,,2,1,1,2
C(C1COC(C=O)(CC1O)O)=O,,,4,1,1,0,1
20734_0,,,,2,1,1,2
C(C1C(CC(CO)(O)OC1)=O)=O,,,4,1,1,0,1
20736_0,,,,2,1,1,2
C1(CC(O)OCC1C(CO)=O)=O,,,4,1,1,0,1
20738_0,,,,2,1,1,2
C(CC1(CC(C(CO1)O)=O)O)=O,,,4,1,1,0,1
20740_0,,,,2,1,1,2
C(C1C(C(C(C)(O)OC1)O)=O)=O,,,4,1,1,0,1
20742_0,,,,2,1,1,2
C(CC1(C(C(CCO1)=O)O)O)=O,,,4,1,1,0,1
20744_0,,,,2,1,1,2
C1(C(C(O)OCC1C(C)=O)O)=O,,,4,1,1,0,1
20746_0,,,,2,1,1,2
C1(CCOC(C(C=O)O)(C1)O)=O,,,4,1,1,0,1
20747_0,,,,2,1,1,2
20749_0,,,,2,1,1,2
C1(C(COC(C1O)O)CC=O)=O,,,4,1,1,0,1
20751_0,,,,2,1,1,2
C(C1C(CC(CO)C(O1)O)=O)=O,,,4,1,1,0,1
20752_0,,,,2,1,1,2
20754_0,,,,2,1,1,2
C1(C(COC(C1)O)C(C=O)O)=O,,,4,1,1,0,1
20755_0,,,,2,1,1,2
20757_0,,,,2,1,1,2
C1C(C2C(C(C(CO)O2)(O)O1)O)O,,,4,1,1,0,1
20759_0,,,,2,1,1,2
C1C(C2C(CO)C(C(O)O2)(O)O1)O,,,4,1,1,0,1
20761_0,,,,2,1,1,2
C1(C(CO)C2C(C(C(O)O2)O1)O)O,,,4,1,1,0,1
20763_0,,,,2,1,1,2
C1C2C(C(C(C(CO)O2)(O)O1)O)O,,,4,1,1,0,1
20765_0,,,,2,1,1,2
C1C2C(C(CO)C(C(O)O2)(O)O1)O,,,4,1,1,0,1
20766_0,,,,2,1,1,2
20768_0,,,,2,1,1,2
C(C(C1COC(C(C1O)O)O)=O)=O,,,4,1,1,0,1
20770_0,,,,2,1,1,2
C(C1C(C(C(C(O1)O)=O)CO)O)=O,,,4,1,1,0,1
20772_0,,,,2,1,1,2
C1(C(O)OCC(C)(C1CO)O)=O,,,4,1,1,0,1
20774_0,,,,2,1,1,2
C1(COC(C(C1)O)(CCO)O)=O,,,4,1,1,0,1
20776_0,,,,2,1,1,2
C(C1(CCOC(CO)(C1)O)O)=O,,,4,1,1,0,1
20778_0,,,,2,1,1,2
C1(COC(C(CCO)(C1)O)O)=O,,,4,1,1,0,1
20780_0,,,,2,1,1,2
C(C1(CCOC(C)(C1O)O)O)=O,,,4,1,1,0,1
20782_0,,,,2,1,1,2
C(C1(CC(O)OCC1)O)=O,,,4,1,1,0,1
20784_0,,,,2,1,1,2
C(CO)(C1COC(C(C1O)O)O)=O,,,4,1,1,0,1
20786_0,,,,2,1,1,2
C1CC(CO)(CC(CO)(O)O1)O,,,4,1,1,0,1
20788_0,,,,2,1,1,2
CC1(C(C(CO)(CCO1)O)O)O,,,4,1,1,0,1
20790_0,,,,2,1,1,2
C1CC(CO)(CC(O)O1)O,,,4,1,1,0,1
20792_0,,,,2,1,1,2
C(C)(C1C(C(CC(O1)O)O)O)=O,,,4,1,1,0,1
20794_0,,,,2,1,1,2
C(C1C(C(C)(CC(O1)O)O)O)=O,,,4,1,1,0,1
20796_0,,,,2,1,1,2
C(C1C(C(C=O)OC(C1O)O)O)=O,,,4,1,1,0,1
20798_0,,,,2,1,1,2
C(C1C(C(C(OC1C=O)O)O)O)=O,,,4,1,1,0,1
20800_0,,,,2,1,1,2
C(C1CC(CC(CO)(O1)O)O)=O,,,4,1,1,0,1
20802_0,,,,2,1,1,2
C(C)(C1C(CC(C(O1)O)O)O)=O,,,4,1,1,0,1
20804_0,,,,2,1,1,2
C(C1CC(C(C(C)(O1)O)O)O)=O,,,4,1,1,0,1
20806_0,,,,2,1,1,2
C(C1C(C(O)OCC1(C)O)O)=O,,,4,1,1,0,1
20808_0,,,,2,1,1,2
C(C1C(C(CC(CO)(O1)O)O)O)=O,,,4,1,1,0,1
20810_0,,,,2,1,1,2
C(C)(C1C(C(C(C(O1)O)O)O)O)=O,,,4,1,1,0,1
20812_0,,,,2,1,1,2
C(C1C(C(C(C(C)(O1)O)O)O)O)=O,,,4,1,1,0,1
20814_0,,,,2,1,1,2
C1C(C(CO)(CC(CO)(O)O1)O)O,,,4,1,1,0,1
20816_0,,,,2,1,1,2
C1C(C(CO)(C(C(C)(O)O1)O)O)O,,,4,1,1,0,1
20818_0,,,,2,1,1,2
C(C1CC(CC(O1)O)O)=O,,,4,1,1,0,1
20820_0,,,,2,1,1,2
C1C(C(CO)(CC(O)O1)O)O,,,4,1,1,0,1
20821_0,,,,2,1,1,2
20823_0,,,,2,1,1,2
C(C(CC1(CC(O)OCC1)O)=O)=O,,,4,1,1,0,1
20824_0,,,,2,1,1,2
20825_0,,,,2,1,1,2
20827_0,,,,2,1,1,2
C1(CC(C=O)(O)OC(C)C1CO)=O,,,4,1,1,0,1
20828_0,,,,2,1,1,2
20830_0,,,,2,1,1,2
C(CC1C(CCC(CO)(O1)O)=O)=O,,,4,1,1,0,1
20831_0,,,,2,1,1,2
20833_0,,,,2,1,1,2
C(CC1(CO)CCC(C(O)O1)=O)=O,,,4,1,1,0,1
20834_0,,,,2,1,1,2
20836_0,,,,2,1,1,2
C(C1(C(C(C)O)CC(CO1)=O)O)=O,,,4,1,1,0,1
20838_0,,,,2,1,1,2
C(CO)(C1C(C)OC(C(C1)=O)O)=O,,,4,1,1,0,1
20839_0,,,,2,1,1,2
20840_0,,,,2,1,1,2
20842_0,,,,2,1,1,2
C(CC1C(CC(C(C)(O1)O)O)=O)=O,,,4,1,1,0,1
20844_0,,,,2,1,1,2
C(C1(CC(C(C)=O)OC(C1)O)O)=O,,,4,1,1,0,1
20846_0,,,,2,1,1,2
C(CC1(C)C(CC(C(O)O1)=O)O)=O,,,4,1,1,0,1
20848_0,,,,2,1,1,2
C(C1(CC(CC(O1)O)O)CC=O)=O,,,4,1,1,0,1
20850_0,,,,2,1,1,2
C(C1(CC(O)OC(C1)CC=O)O)=O,,,4,1,1,0,1
20852_0,,,,2,1,1,2
C(CC1CC(CC(C=O)(O)O1)O)=O,,,4,1,1,0,1
20854_0,,,,2,1,1,2
C(C(CC1CC(CC(O)O1)O)=O)=O,,,4,1,1,0,1
20856_0,,,,2,1,1,2
C(C(C1C(C)OC(CC1O)O)=O)=O,,,4,1,1,0,1
20858_0,,,,2,1,1,2
C(C1C(CC(C=O)(O)OC1C)O)=O,,,4,1,1,0,1
20860_0,,,,2,1,1,2
C(CC(C1(CC(O)OCC1)O)=O)=O,,,4,1,1,0,1
20862_0,,,,2,1,1,2
C(CC1CC(CC(CO)(O)O1)=O)=O,,,4,1,1,0,1
20864_0,,,,2,1,1,2
C(CC1(CO)CC(CC(O)O1)=O)=O,,,4,1,1,0,1
20866_0,,,,2,1,1,2
C(C1C(CC(CO)(O)OC1C)=O)=O,,,4,1,1,0,1
20868_0,,,,2,1,1,2
C1(CC(O)OC(C)C1C(CO)=O)=O,,,4,1,1,0,1
20870_0,,,,2,1,1,2
C(CC1(CC(C(C(C)O1)O)=O)O)=O,,,4,1,1,0,1
20872_0,,,,2,1,1,2
C(CC1CC(C(C(C)(O)O1)O)=O)=O,,,4,1,1,0,1
20874_0,,,,2,1,1,2
C(CC1(C)C(C(CC(O)O1)=O)O)=O,,,4,1,1,0,1
20876_0,,,,2,1,1,2
C(C1C(C(C(C)(O)OC1C)O)=O)=O,,,4,1,1,0,1
20878_0,,,,2,1,1,2
C(CC1(C(C(CC(C)O1)=O)O)O)=O,,,4,1,1,0,1
20880_0,,,,2,1,1,2
C(CC(C1CC(CC(O1)O)O)=O)=O,,,4,1,1,0,1
20882_0,,,,2,1,1,2
C(CC1C(C(CC(C)(O)O1)=O)O)=O,,,4,1,1,0,1
20884_0,,,,2,1,1,2
C(CC1(C)CC(C(C(O)O1)O)=O)=O,,,4,1,1,0,1
20886_0,,,,2,1,1,2
C1(C(C(O)OC(C)C1C(C)=O)O)=O,,,4,1,1,0,1
20888_0,,,,2,1,1,2
C1(CC(C)OC(C(C=O)O)(C1)O)=O,,,4,1,1,0,1
20889_0,,,,2,1,1,2
20890_0,,,,2,1,1,2
20891_0,,,,2,1,1,2
20893_0,,,,2,1,1,2
C1(C(C(C)OC(C1O)O)CC=O)=O,,,4,1,1,0,1
20895_0,,,,2,1,1,2
C(C1C(CC(C(O1)O)C(C)O)=O)=O,,,4,1,1,0,1
20897_0,,,,2,1,1,2
C(CC1C(CC(C(C)(O)O1)=O)O)=O,,,4,1,1,0,1
20899_0,,,,2,1,1,2
C(C1CC(C(C)=O)(CC(O1)O)O)=O,,,4,1,1,0,1
20901_0,,,,2,1,1,2
C1(C(C)(CC=O)OC(C(C1)O)O)=O,,,4,1,1,0,1
20902_0,,,,2,1,1,2
20903_0,,,,2,1,1,2
20904_0,,,,2,1,1,2
20906_0,,,,2,1,1,2
C1(C(C(C)OC(C1)O)C(C=O)O)=O,,,4,1,1,0,1
20907_0,,,,2,1,1,2
20909_0,,,,2,1,1,2
C(C1(C(COC(C1)O)O)O)=CC=O,,,4,1,1,0,1
20911_0,,,,2,1,1,2
C=CC(C1C(C(CC(O1)O)O)O)=O,,,4,1,1,0,1
20913_0,,,,2,1,1,2
C(C1C(C(C=C)(CC(O1)O)O)O)=O,,,4,1,1,0,1
20915_0,,,,2,1,1,2
C(C1C(C(CC(O1)O)O)O)=CC=O,,,4,1,1,0,1
20916_0,,,,2,1,1,2
20917_0,,,,2,1,1,2
20919_0,,,,2,1,1,2
CC1(C(COC(C1O)O)O)O,,,4,1,1,0,1
20921_0,,,,2,1,1,2
C(C1C(CO)(CC(C(O1)O)O)O)=O,,,4,1,1,0,1
20923_0,,,,2,1,1,2
C(C1CC(CO)(C(C(O1)O)O)O)=O,,,4,1,1,0,1
20924_0,,,,2,1,1,2
20926_0,,,,2,1,1,2
C(CO)(C1C(C(O)OCC1O)O)=O,,,4,1,1,0,1
20927_0,,,,2,1,1,2
20928_0,,,,2,1,1,2
20930_0,,,,2,1,1,2
C(C1(C(C(O)OCC1)O)O)=O,,,4,1,1,0,1
20932_0,,,,2,1,1,2
C1(C(O)OCC(C1CO)O)=O,,,4,1,1,0,1
20934_0,,,,2,1,1,2
C1CC(CO)(C(C(O)O1)O)O,,,4,1,1,0,1
20936_0,,,,2,1,1,2
C(C1C(C)(C(C(C(O1)O)O)O)O)=O,,,4,1,1,0,1
20938_0,,,,2,1,1,2
C(C1C(C(C)(C(C(O1)O)O)O)O)=O,,,4,1,1,0,1
20940_0,,,,2,1,1,2
C(C1C(C(O)OCC1O)O)=O,,,4,1,1,0,1
20942_0,,,,2,1,1,2
C(C1C(C(C(C(O1)O)O)O)O)=O,,,4,1,1,0,1
20944_0,,,,2,1,1,2
C1C(C(CO)(C(C(O)O1)O)O)O,,,4,1,1,0,1
20946_0,,,,2,1,1,2
C1(C(O)OC(C(C1)O)C(CO)O)=O,,,4,1,1,0,1
20948_0,,,,2,1,1,2
C(C1(CC(C(C(CO)O1)O)O)O)=O,,,4,1,1,0,1
20950_0,,,,2,1,1,2
C(C1(CC(C(C(CO)O1)O)O)O)O,,,4,1,1,0,1
20952_0,,,,2,1,1,2
CC1(C(C(C(C(CO)O1)O)O)O)O,,,4,1,1,0,1
20953_0,,,,2,1,1,2
20955_0,,,,2,1,1,2
C1(C(C(O)OCC1C(CO)O)O)=O,,,4,1,1,0,1
20956_0,,,,2,1,1,2
20957_0,,,,2,1,1,2
20959_0,,,,2,1,1,2
C(C1C(C(C(CO)C(O1)O)O)O)=O,,,4,1,1,0,1
20961_0,,,,2,1,1,2
C1(C(CCC(CO)(O)O1)O)=O,,,4,1,1,0,1
20963_0,,,,2,1,1,2
C1(C(CC(C(C)(O)O1)O)O)=O,,,4,1,1,0,1
20965_0,,,,2,1,1,2
C(C1CC(CC(O1)O)O)(O)=O,,,4,1,1,0,1
20966_0,,,,2,1,1,2
20968_0,,,,2,1,1,2
C1(C(C)(CC(C(O)O1)O)O)=O,,,4,1,1,0,1
20969_0,,,,2,1,1,2
20970_0,,,,2,1,1,2
20971_0,,,,2,1,1,2
20972_0,,,,2,1,1,2
20973_0,,,,2,1,1,2
20974_0,,,,2,1,1,2
20975_0,,,,2,1,1,2
20976_0,,,,2,1,1,2
20977_0,,,,2,1,1,2
20978_0,,,,2,1,1,2
20979_0,,,,2,1,1,2
20980_0,,,,2,1,1,2
20981_0,,,,2,1,1,2
20982_0,,,,2,1,1,2
20984_0,,,,2,1,1,2
C1CC(C(C(CO)(O)O1)O)O,,,4,1,1,0,1
20985_0,,,,2,1,1,2
20987_0,,,,2,1,1,2
C1(C(CC(C(CO)(O)O1)O)O)=O,,,4,1,1,0,1
20988_0,,,,2,1,1,2
20990_0,,,,2,1,1,2
C1(CC(C(C(CO)(O)O1)O)O)=O,,,4,1,1,0,1
20991_0,,,,2,1,1,2
20992_0,,,,2,1,1,2
20993_0,,,,2,1,1,2
20994_0,,,,2,1,1,2
20995_0,,,,2,1,1,2
20997_0,,,,2,1,1,2
C1C2CC(C(C(O)O2)(O)O1)O,,,4,1,2,0,2
20998_0,,,,2,1,1,2
20999_0,,,,2,1,1,2
21000_0,,,,2,1,1,2
21002_0,,,,2,1,1,2
C(C1(CC(CCO1)O)O)=O,,,4,1,1,0,1
21003_0,,,,2,1,1,2
21004_0,,,,2,1,1,2
21005_0,,,,2,1,1,2
21006_0,,,,2,1,1,2
21007_0,,,,2,1,1,2
21008_0,,,,2,1,1,2
21009_0,,,,2,1,1,2
21010_0,,,,2,1,1,2
21011_0,,,,2,1,1,2
21012_0,,,,2,1,1,2
21013_0,,,,2,1,1,2
21015_0,,,,2,1,1,2
C1(CC(CC(C=O)(O)O1)O)=O,,,4,1,1,0,1
21016_0,,,,2,1,1,2
21017_0,,,,2,1,1,2
21018_0,,,,2,1,1,2
21019_0,,,,2,1,1,2
21020_0,,,,2,1,1,2
21021_0,,,,2,1,1,2
21023_0,,,,2,1,1,2
C1C(C(C(C(O)O1)(CO)O)O)O,,,4,1,1,0,1
21025_0,,,,2,1,1,2
C(C1(COC(CO)(CC1O)O)O)=O,,,4,1,1,0,1
21027_0,,,,2,1,1,2
C(C1(COC(CC1(CO)O)O)O)=O,,,4,1,1,0,1
21029_0,,,,2,1,1,2
C(C)(C1(C(O)OCC(C1O)O)O)=O,,,4,1,1,0,1
21031_0,,,,2,1,1,2
C(C1(C(C)(O)OCC(C1O)O)O)=O,,,4,1,1,0,1
21033_0,,,,2,1,1,2
C(C1(COC(C)(C(C1O)O)O)O)=O,,,4,1,1,0,1
21035_0,,,,2,1,1,2
C(C1(COC(C(C1(C)O)O)O)O)=O,,,4,1,1,0,1
21037_0,,,,2,1,1,2
C1C(C(C(CO)(C(C)(O)O1)O)O)O,,,4,1,1,0,1
21039_0,,,,2,1,1,2
CC1(C(COC(C1(CO)O)O)O)O,,,4,1,1,0,1
21041_0,,,,2,1,1,2
C(C1(CCOC(C1(CO)O)O)O)=O,,,4,1,1,0,1
21043_0,,,,2,1,1,2
C1CC(CO)(C(C(O)O1)(CO)O)O,,,4,1,1,0,1
21045_0,,,,2,1,1,2
C(C1(C(O)OCC(C1O)O)O)=O,,,4,1,1,0,1
21047_0,,,,2,1,1,2
C(C1(COC(C(C1O)O)O)O)=O,,,4,1,1,0,1
21048_0,,,,2,1,1,2
21049_0,,,,2,1,1,2
21051_0,,,,2,1,1,2
C(C1CC(C(CO)(C(O1)O)O)O)=O,,,4,1,1,0,1
21052_0,,,,2,1,1,2
21054_0,,,,2,1,1,2
C1(COC(C(C)(C1(CO)O)O)O)=O,,,4,1,1,0,1
21056_0,,,,2,1,1,2
C1(COC(C(C1(CO)O)O)O)=O,,,4,1,1,0,1
21058_0,,,,2,1,1,2
C(C1(C(C(O)OCC1O)O)O)(O)=O,,,4,1,1,0,1
21060_0,,,,2,1,1,2
C(C1(C(O)OCC(C1(C)O)O)O)=O,,,4,1,1,0,1
21062_0,,,,2,1,1,2
C(C)(C1(COC(C(C1O)O)O)O)=O,,,4,1,1,0,1
21063_0,,,,2,1,1,2
21064_0,,,,2,1,1,2
21065_0,,,,2,1,1,2
21067_0,,,,2,1,1,2
C1(COC(C)(C(CO)(C1O)O)O)=O,,,4,1,1,0,1
21069_0,,,,2,1,1,2
C1(C(C)OC(C(CO)(C1O)O)O)=O,,,4,1,1,0,1
21070_0,,,,2,1,1,2
21072_0,,,,2,1,1,2
C(CO)(C1(COC(CC1O)O)O)=O,,,4,1,1,0,1
21074_0,,,,2,1,1,2
C1(CC(O)OCC1(C(C)=O)O)=O,,,4,1,1,0,1
21076_0,,,,2,1,1,2
C(C1(C(CC(C)(O)OC1)=O)O)=O,,,4,1,1,0,1
21077_0,,,,2,1,1,2
21079_0,,,,2,1,1,2
C1C2(C(CO)(C(C(CO2)O)O1)O)O,,,4,1,1,0,1
21081_0,,,,2,1,1,2
C1C2(C(CO)(C(C(CO2)O1)O)O)O,,,4,1,1,0,1
21082_0,,,,2,1,1,2
21084_0,,,,2,1,1,2
C(C1(CCOC(C1(C=O)O)O)O)=O,,,4,1,1,0,1
21086_0,,,,2,1,1,2
C(C1(C(O)OCCC1(CO)O)O)=O,,,4,1,1,0,1
21088_0,,,,2,1,1,2
C(C1(C=O)C(C(CC(O1)O)O)O)=O,,,4,1,1,0,1
21090_0,,,,2,1,1,2
C(C1(C=O)C(CC(C(O1)O)O)O)=O,,,4,1,1,0,1
21092_0,,,,2,1,1,2
C(C1(C(OC(C=O)CC1O)O)O)=O,,,4,1,1,0,1
21094_0,,,,2,1,1,2
C(C1(C(C(O)OCC1(C)O)O)O)=O,,,4,1,1,0,1
21096_0,,,,2,1,1,2
C1(CC(O)OC(C)C1(C(C)=O)O)=O,,,4,1,1,0,1
21098_0,,,,2,1,1,2
C(C1(C(CC(C)(O)OC1C)=O)O)=O,,,4,1,1,0,1
21099_0,,,,2,1,1,2
21101_0,,,,2,1,1,2
C(C1(C(COC(C)(C1O)O)O)O)=O,,,4,1,1,0,1
21103_0,,,,2,1,1,2
C(C)(C1(C(C(O)OCC1O)O)O)=O,,,4,1,1,0,1
21105_0,,,,2,1,1,2
C(C1(C(C(O)OCC1O)O)O)=O,,,4,1,1,0,1
21107_0,,,,2,1,1,2
C(C1(C(COC(C1(C)O)O)O)O)=O,,,4,1,1,0,1
21109_0,,,,2,1,1,2
C1(CC(O)OCC1(C(CO)O)O)=O,,,4,1,1,0,1
21110_0,,,,2,1,1,2
21111_0,,,,2,1,1,2
21112_0,,,,2,1,1,2
21114_0,,,,2,1,1,2
C(C1(CC(O)OCC1(CO)O)O)=O,,,4,1,1,0,1
21116_0,,,,2,1,1,2
C(C1(CC(O)OC(CO)C1O)O)=O,,,4,1,1,0,1
21118_0,,,,2,1,1,2
C(CC1(C(O)OCC(C1O)O)O)=O,,,4,1,1,0,1
21120_0,,,,2,1,1,2
C1(C(C(CO)(CC(O)O1)O)O)=O,,,4,1,1,0,1
21122_0,,,,2,1,1,2
C1(C(C(C)(C(C(O)O1)O)O)O)=O,,,4,1,1,0,1
21124_0,,,,2,1,1,2
C(C(C1(C(OCC(C1)=O)O)O)O)=O,,,4,1,1,0,1
21126_0,,,,2,1,1,2
C1(COC(C(CO)(C1)O)O)=O,,,4,1,1,0,1
21128_0,,,,2,1,1,2
C1(COC(C(C(C)O)(C1)O)O)=O,,,4,1,1,0,1
21129_0,,,,2,1,1,2
21130_0,,,,2,1,1,2
21132_0,,,,2,1,1,2
C(C1(C(CO)(CC(CO1)O)O)O)=O,,,4,1,1,0,1
21134_0,,,,2,1,1,2
C(C1(COC(CO)(C(C1)O)O)O)=O,,,4,1,1,0,1
21136_0,,,,2,1,1,2
C(CO)(C1(COC(C(C1)O)O)O)=O,,,4,1,1,0,1
21138_0,,,,2,1,1,2
C1(C(C(O)OCC1(CCO)O)O)=O,,,4,1,1,0,1
21139_0,,,,2,1,1,2
21141_0,,,,2,1,1,2
C1(COC(CO)(C(CO)(C1)O)O)=O,,,4,1,1,0,1
21143_0,,,,2,1,1,2
C(C1C(CC(CO)(C(O1)O)O)O)=O,,,4,1,1,0,1
21144_0,,,,2,1,1,2
21145_0,,,,2,1,1,2
21147_0,,,,2,1,1,2
C(C)(C1(COC(C(C1)=O)O)O)=O,,,4,1,1,0,1
21149_0,,,,2,1,1,2
C1(C(COC(C1)O)(CC=O)O)=O,,,4,1,1,0,1
21151_0,,,,2,1,1,2
C(C1(COC(C(C1)=O)(C)O)O)=O,,,4,1,1,0,1
21152_0,,,,2,1,1,2
21154_0,,,,2,1,1,2
C1C(C2CC(C(CO)(O)O2)(O)O1)O,,,4,1,1,0,1
21156_0,,,,2,1,1,2
C1C2C(CC(C(CO)(O)O2)(O)O1)O,,,4,1,1,0,1
21158_0,,,,2,1,1,2
C(C1(C(C(C=O)OC(C1)O)O)O)=O,,,4,1,1,0,1
21160_0,,,,2,1,1,2
C1(C(C(C(C(O)O1)O)O)O)=O,,,4,1,1,0,1
21162_0,,,,2,1,1,2
C(C1(CC(O)OCC1(C)O)O)=O,,,4,1,1,0,1
21164_0,,,,2,1,1,2
C(C1C(C(C(C(O1)O)O)O)O)(O)=O,,,4,1,1,0,1
21166_0,,,,2,1,1,2
C(C)(C1(C(C)OC(C(C1)=O)O)O)=O,,,4,1,1,0,1
21168_0,,,,2,1,1,2
C1(C(C(C)OC(C1)O)(CC=O)O)=O,,,4,1,1,0,1
21170_0,,,,2,1,1,2
C(C1(C(C)OC(C(C1)=O)(C)O)O)=O,,,4,1,1,0,1
21171_0,,,,2,1,1,2
21173_0,,,,2,1,1,2
C(C1(C(COC(CO)(C1)O)O)O)=O,,,4,1,1,0,1
21175_0,,,,2,1,1,2
C1(COC(C(C(CO)O)(C1)O)O)=O,,,4,1,1,0,1
21176_0,,,,2,1,1,2
21178_0,,,,2,1,1,2
C1(C(CO)OC(C(CO)(C1)O)O)=O,,,4,1,1,0,1
21180_0,,,,2,1,1,2
C1(C(C)(O)OCC(C1O)O)=O,,,4,1,1,0,1
21181_0,,,,2,1,1,2
21182_0,,,,2,1,1,2
21183_0,,,,2,1,1,2
21184_0,,,,2,1,1,2
21186_0,,,,2,1,1,2
C1C2C(C(C(C(O)O2)O1)O)O,,,4,1,1,0,1
21188_0,,,,2,1,1,2
C1C2(C(CC(CO2)(O)O1)O)O,,,4,1,2,0,2
21190_0,,,,2,1,1,2
C1(C2(CC(C(CO2)O)O1)O)=O,,,4,1,2,0,2
21192_0,,,,2,1,1,2
C1(C2C(C(CC(O2)O)O1)O)=O,,,4,1,2,0,2
21194_0,,,,2,1,1,2
C1(C2(CC(C(CO2)O1)O)O)=O,,,4,1,2,0,2
21195_0,,,,2,1,1,2
21196_0,,,,2,1,1,2
21197_0,,,,2,1,1,2
21198_0,,,,2,1,1,2
21200_0,,,,2,1,1,2
C1C2C(C(C(C(O)O2)(O)O1)O)O,,,4,1,2,0,2
21201_0,,,,2,1,1,2
21202_0,,,,2,1,1,2
21203_0,,,,2,1,1,2
21205_0,,,,2,1,1,2
C1(C2CC(C(C(O)O2)O1)O)O,,,4,1,2,0,2
21206_0,,,,2,1,1,2
21208_0,,,,2,1,1,2
C(CC1C(CO)OC(C(C1)=O)O)=O,,,4,1,2,0,2
21210_0,,,,2,1,1,2
C(C(CC1CC(O)OCC1O)=O)=O,,,4,1,1,0,1
21212_0,,,,2,1,1,2
C(CC1CC(C=O)(O)OCC1O)=O,,,4,1,1,0,1
21214_0,,,,2,1,1,2
C(CC1C(OC(C(C1)=O)CO)O)=O,,,4,1,2,0,2
21216_0,,,,2,1,1,2
C1(C(CC(OC1CO)O)CC=O)=O,,,4,1,1,0,1
21218_0,,,,2,1,1,2
C(CC1C(C(C=O)OC(C1)O)O)=O,,,4,1,1,0,1
21220_0,,,,2,1,1,2
C1(COC(CO)(CC(C1O)O)O)=O,,,4,1,1,0,1
21222_0,,,,2,1,1,2
C1(COC(CO)(C(C(C1)O)O)O)=O,,,4,1,1,0,1
21224_0,,,,2,1,1,2
C1(COC(CC(CO)(C1O)O)O)=O,,,4,1,1,0,1
21226_0,,,,2,1,1,2
C1(C(C(COC(C1)O)(CO)O)O)=O,,,4,1,1,0,1
21228_0,,,,2,1,1,2
C1(COC(C)(C(C(C1O)O)O)O)=O,,,4,1,1,0,1
21230_0,,,,2,1,1,2
C1(COC(C(C(C)(C1O)O)O)O)=O,,,4,1,1,0,1
21232_0,,,,2,1,1,2
C1(C(C(O)OCC(CO)(C1)O)O)=O,,,4,1,1,0,1
21234_0,,,,2,1,1,2
C1(C(C(C(CO)(O)OCC1)O)O)=O,,,4,1,1,0,1
21236_0,,,,2,1,1,2
C1(COC(C(C(C1O)O)O)O)=O,,,4,1,1,0,1
21238_0,,,,2,1,1,2
C1(C(C(C(CO)OC(C1)O)O)O)=O,,,4,1,1,0,1
21240_0,,,,2,1,1,2
C1(C(C(O)OC(C(C1)O)CO)O)=O,,,4,1,1,0,1
21241_0,,,,2,1,1,2
21243_0,,,,2,1,1,2
C(C1C(C(O)OCC(C1O)O)O)=O,,,4,1,1,0,1
21245_0,,,,2,1,1,2
C(C1(CC(CC(CO1)=O)O)O)=O,,,4,1,1,0,1
21247_0,,,,2,1,1,2
C1(C(O)OCC(C(C)(C1)O)O)=O,,,4,1,1,0,1
21249_0,,,,2,1,1,2
C1(C(COC(C(C1)O)(C)O)O)=O,,,4,1,1,0,1
21251_0,,,,2,1,1,2
C1(C(COC(C(C)(C1)O)O)O)=O,,,4,1,1,0,1
21253_0,,,,2,1,1,2
C1(C(CC(C=O)(O)OCC1)O)=O,,,4,1,1,0,1
21255_0,,,,2,1,1,2
C(C1(CCOC(C(C1)=O)O)O)=O,,,4,1,1,0,1
21257_0,,,,2,1,1,2
C1(C(O)OCCC(CO)(C1)O)=O,,,4,1,1,0,1
21259_0,,,,2,1,1,2
C1(C(C(C(C)(O)OCC1)O)O)=O,,,4,1,1,0,1
21261_0,,,,2,1,1,2
C1(C(C(C(O)OCC1)(C)O)O)=O,,,4,1,1,0,1
21263_0,,,,2,1,1,2
C(C1CC(CC(C(O1)O)=O)O)=O,,,4,1,1,0,1
21265_0,,,,2,1,1,2
C(C1C(C(CC(C(O1)O)=O)O)O)=O,,,4,1,1,0,1
21267_0,,,,2,1,1,2
C1(C(O)OCC(C(CO)(C1)O)O)=O,,,4,1,1,0,1
21269_0,,,,2,1,1,2
C1(C(C(C(C)(O)OCC1O)O)O)=O,,,4,1,1,0,1
21271_0,,,,2,1,1,2
C1(C(C(C(O)OCC1O)(C)O)O)=O,,,4,1,1,0,1
21273_0,,,,2,1,1,2
C(C1C(COC(C(C1O)O)O)=O)=O,,,4,1,1,0,1
21275_0,,,,2,1,1,2
C1(C(C(C(C=O)OC(C1)O)O)O)=O,,,4,1,1,0,1
21277_0,,,,2,1,1,2
C1(C(C(COC(C1)O)(C)O)O)=O,,,4,1,1,0,1
21279_0,,,,2,1,1,2
C1(COC(CO)(CC(C1)O)O)=O,,,4,1,1,0,1
21281_0,,,,2,1,1,2
C1(COC(CC(CO)(C1)O)O)=O,,,4,1,1,0,1
21283_0,,,,2,1,1,2
C1(COC(C)(C(C(C1)O)O)O)=O,,,4,1,1,0,1
21284_0,,,,2,1,1,2
21286_0,,,,2,1,1,2
C(C1C(CC(C(C(O1)O)O)O)=O)=O,,,4,1,1,0,1
21288_0,,,,2,1,1,2
C1(C(C(OC(C=O)C(C1)O)O)O)=O,,,4,1,1,0,1
21290_0,,,,2,1,1,2
C1(C(C(O)OCC(C)(C1)O)O)=O,,,4,1,1,0,1
21292_0,,,,2,1,1,2
C1(COC(C(C(C)(C1)O)O)O)=O,,,4,1,1,0,1
21294_0,,,,2,1,1,2
C1(CC(C=O)OC(C(C1O)O)O)=O,,,4,1,1,0,1
21296_0,,,,2,1,1,2
C1(C(C(C=O)OC(C(C1)O)O)O)=O,,,4,1,1,0,1
21298_0,,,,2,1,1,2
C1(C(C(C(O)OCC1O)O)O)=O,,,4,1,1,0,1
21299_0,,,,2,1,1,2
21301_0,,,,2,1,1,2
C1(C(C(C)OC(C(C1)O)O)O)=O,,,4,1,1,0,1
21302_0,,,,2,1,1,2
21303_0,,,,2,1,1,2
21305_0,,,,2,1,1,2
C1(C(CC(CO)(O)OCC1O)O)=O,,,4,1,1,0,1
21307_0,,,,2,1,1,2
C1(C(COC(C(C1)O)(CO)O)O)=O,,,4,1,1,0,1
21308_0,,,,2,1,1,2
21310_0,,,,2,1,1,2
C1(COC(C(CO)C(C1O)O)O)=O,,,4,1,1,0,1
21312_0,,,,2,1,1,2
C1C(C(C(C(C(O)O1)CO)O)O)O,,,4,1,1,0,1
21313_0,,,,2,1,1,2
21314_0,,,,2,1,1,2
21315_0,,,,2,1,1,2
21316_0,,,,2,1,1,2
21318_0,,,,2,1,1,2
C1(C(COC(C=O)(CC1)O)O)=O,,,4,1,1,0,1
21319_0,,,,2,1,1,2
21321_0,,,,2,1,1,2
C(C1COC(C(CC1O)=O)O)=O,,,4,1,1,0,1
21322_0,,,,2,1,1,2
21323_0,,,,2,1,1,2
21324_0,,,,2,1,1,2
21325_0,,,,2,1,1,2
21326_0,,,,2,1,1,2
21328_0,,,,2,1,1,2
C(C1C(C(CC(O)OC1)O)=O)=O,,,4,1,1,0,1
21330_0,,,,2,1,1,2
C(C1COC(CC(C1O)=O)O)=O,,,4,1,1,0,1
21332_0,,,,2,1,1,2
C(C1COC(C(C(C1)=O)O)O)=O,,,4,1,1,0,1
21333_0,,,,2,1,1,2
21335_0,,,,2,1,1,2
C12C(C(C(C(C(O)O1)CO)O2)O)O,,,4,1,1,0,1
21337_0,,,,2,1,1,2
C1(C(CC(CO)(O)OCC1)O)=O,,,4,1,1,0,1
21338_0,,,,2,1,1,2
21339_0,,,,2,1,1,2
21341_0,,,,2,1,1,2
C1(C(C(C(O)OC(C)C1)O)O)=O,,,4,1,1,0,1
21342_0,,,,2,1,1,2
21343_0,,,,2,1,1,2
21344_0,,,,2,1,1,2
21346_0,,,,2,1,1,2
C1(C(CO)C(C)OC(C(C1)=O)O)=O,,,4,1,1,0,1
21347_0,,,,2,1,1,2
21348_0,,,,2,1,1,2
21349_0,,,,2,1,1,2
21350_0,,,,2,1,1,2
21351_0,,,,2,1,1,2
21353_0,,,,2,1,1,2
C1(C(C(C)OC(C=O)(CC1)O)O)=O,,,4,1,1,0,1
21354_0,,,,2,1,1,2
21356_0,,,,2,1,1,2
C1(CC(C(C)=O)OC(CC1O)O)=O,,,4,1,1,0,1
21358_0,,,,2,1,1,2
C1(C(CC(C=O)(O)OC(C)C1)O)=O,,,4,1,1,0,1
21360_0,,,,2,1,1,2
C(CC1C(CC(CC(O1)O)O)=O)=O,,,4,1,1,0,1
21362_0,,,,2,1,1,2
C(CC1CC(C(CC(O)O1)O)=O)=O,,,4,1,1,0,1
21364_0,,,,2,1,1,2
C(CC1CC(CC(C(O)O1)=O)O)=O,,,4,1,1,0,1
21366_0,,,,2,1,1,2
C(C1C(CC(C(O)OC1C)=O)O)=O,,,4,1,1,0,1
21367_0,,,,2,1,1,2
21368_0,,,,2,1,1,2
21369_0,,,,2,1,1,2
21371_0,,,,2,1,1,2
C1(C(CC(O)OC(C)C1CO)=O)=O,,,4,1,1,0,1
21372_0,,,,2,1,1,2
21373_0,,,,2,1,1,2
21374_0,,,,2,1,1,2
21375_0,,,,2,1,1,2
21376_0,,,,2,1,1,2
21377_0,,,,2,1,1,2
21379_0,,,,2,1,1,2
C1(CC(CC(OC1C(C)=O)O)O)=O,,,4,1,1,0,1
21381_0,,,,2,1,1,2
C(CC1CC(C(CC(O)O1)=O)O)=O,,,4,1,1,0,1
21383_0,,,,2,1,1,2
C(C1C(C(CC(O)OC1C)O)=O)=O,,,4,1,1,0,1
21385_0,,,,2,1,1,2
C(C1C(C)OC(CC(C1O)=O)O)=O,,,4,1,1,0,1
21387_0,,,,2,1,1,2
C(C1C(CC(C)(CC(O1)O)O)=O)=O,,,4,1,1,0,1
21389_0,,,,2,1,1,2
C(CC1C(C(CCC(O)O1)=O)O)=O,,,4,1,1,0,1
21391_0,,,,2,1,1,2
C(CC1CCC(C(C(O)O1)O)=O)=O,,,4,1,1,0,1
21393_0,,,,2,1,1,2
C(C1C(C)OC(C(C(C1)=O)O)O)=O,,,4,1,1,0,1
21395_0,,,,2,1,1,2
C1(CC(C=O)OC(CC1(C)O)O)=O,,,4,1,1,0,1
21397_0,,,,2,1,1,2
C(CC1C(CC(CC(O)O1)=O)O)=O,,,4,1,1,0,1
21399_0,,,,2,1,1,2
C(CC1CC(CC(C(O)O1)O)=O)=O,,,4,1,1,0,1
21401_0,,,,2,1,1,2
C(C1C(CC(C(O)OC1C)O)=O)=O,,,4,1,1,0,1
21403_0,,,,2,1,1,2
C1(C(C(CO)OC(C(C1)O)O)O)=O,,,4,1,1,0,1
21405_0,,,,2,1,1,2
C1(C(C(C(O)OC(CO)C1)O)O)=O,,,4,1,1,0,1
21407_0,,,,2,1,1,2
C1(C(O)OC(CO)C(C(C1)O)O)=O,,,4,1,1,0,1
21409_0,,,,2,1,1,2
C(C1(CC(C(C(CO1)O)O)O)O)=O,,,4,1,1,0,1
21411_0,,,,2,1,1,2
C1C(C(C(CC(CO)(O)O1)O)O)O,,,4,1,1,0,1
21413_0,,,,2,1,1,2
CC1(C(C(C(C(CO1)O)O)O)O)O,,,4,1,1,0,1
21414_0,,,,2,1,1,2
21415_0,,,,2,1,1,2
21416_0,,,,2,1,1,2
21417_0,,,,2,1,1,2
21419_0,,,,2,1,1,2
C(C1COC(C(C(C1O)O)O)O)=O,,,4,1,1,0,1
21421_0,,,,2,1,1,2
C1(C(CC(CC(O)O1)O)O)=O,,,4,1,1,0,1
21422_0,,,,2,1,1,2
21423_0,,,,2,1,1,2
21424_0,,,,2,1,1,2
21425_0,,,,2,1,1,2
21426_0,,,,2,1,1,2
21427_0,,,,2,1,1,2
21429_0,,,,2,1,1,2
C1C(C(CC(C(O)O1)O)O)O,,,4,1,1,0,1
21431_0,,,,2,1,1,2
C1(C(C(CC(C(O)O1)O)O)O)=O,,,4,1,1,0,1
21432_0,,,,2,1,1,2
21434_0,,,,2,1,1,2
C1C(CC(C(C(O)O1)O)O)O,,,4,1,1,0,1
21435_0,,,,2,1,1,2
21436_0,,,,2,1,1,2
21437_0,,,,2,1,1,2
21438_0,,,,2,1,1,2
21439_0,,,,2,1,1,2
21440_0,,,,2,1,1,2
21442_0,,,,2,1,1,2
C1(C(CC(C(C(O)O1)O)O)O)=O,,,4,1,1,0,1
21443_0,,,,2,1,1,2
21444_0,,,,2,1,1,2
21445_0,,,,2,1,1,2
21446_0,,,,2,1,1,2
21447_0,,,,2,1,1,2
21448_0,,,,2,1,1,2
21449_0,,,,2,1,1,2
21450_0,,,,2,1,1,2
21452_0,,,,2,1,1,2
C1(COC(C(CO)(C(C1)O)O)O)=O,,,4,1,1,0,1
21454_0,,,,2,1,1,2
C1(C(C(C(O)OCC1)(CO)O)O)=O,,,4,1,1,0,1
21456_0,,,,2,1,1,2
C(C1(COC(CC(C1O)O)O)O)=O,,,4,1,1,0,1
21458_0,,,,2,1,1,2
C(C1(COC(C(CC1O)O)O)O)=O,,,4,1,1,0,1
21460_0,,,,2,1,1,2
C(C1(C(OCC(CC1O)=O)O)O)=O,,,4,1,1,0,1
21461_0,,,,2,1,1,2
21462_0,,,,2,1,1,2
21463_0,,,,2,1,1,2
21465_0,,,,2,1,1,2
C1CC(C(C(C(O)O1)(CO)O)O)O,,,4,1,1,0,1
21467_0,,,,2,1,1,2
C(C1(C(CCC(O)OC1)=O)O)=O,,,4,1,1,0,1
21469_0,,,,2,1,1,2
C1C2(CC(C(C(O)O1)(CO)O2)O)O,,,4,1,1,0,1
21471_0,,,,2,1,1,2
C12CC(C(C(C(O)O1)(CO)O)O2)O,,,4,1,1,0,1
21473_0,,,,2,1,1,2
C(C1(C(O)OCCC(C1O)=O)O)=O,,,4,1,1,0,1
21475_0,,,,2,1,1,2
C(C1(C(CCC(O)OC1C)=O)O)=O,,,4,1,1,0,1
21476_0,,,,2,1,1,2
21477_0,,,,2,1,1,2
21478_0,,,,2,1,1,2
21479_0,,,,2,1,1,2
21481_0,,,,2,1,1,2
C(C1(CC(O)OCC(C1O)O)O)=O,,,4,1,1,0,1
21483_0,,,,2,1,1,2
C(C1(C(C(OCC(C1)=O)O)O)O)=O,,,4,1,1,0,1
21484_0,,,,2,1,1,2
21485_0,,,,2,1,1,2
21487_0,,,,2,1,1,2
C1(COC(C(CO)(CC1O)O)O)=O,,,4,1,1,0,1
21488_0,,,,2,1,1,2
21489_0,,,,2,1,1,2
21491_0,,,,2,1,1,2
C(C1(COC(C(C(C1)O)O)O)O)=O,,,4,1,1,0,1
21493_0,,,,2,1,1,2
C1(C(C(C(O)OCC1(C)O)O)O)=O,,,4,1,1,0,1
21495_0,,,,2,1,1,2
C(C1(COC(CC(C1)=O)O)O)=O,,,4,1,1,0,1
21497_0,,,,2,1,1,2
C1(C(C(C(C(C(O)O1)O)O)O)O)=O,,,4,1,1,0,1
21499_0,,,,2,1,1,2
C(C1(C(C)OC(CC(C1)=O)O)O)=O,,,4,1,1,0,1
21501_0,,,,2,1,1,2
C1(C(COC(C(CO)(C1)O)O)O)=O,,,4,1,1,0,1
21502_0,,,,2,1,1,2
21503_0,,,,2,1,1,2
21505_0,,,,2,1,1,2
C1C2C(C(C(C(O)O1)O2)O)O,,,4,1,1,0,1
21506_0,,,,2,1,1,2
21507_0,,,,2,1,1,2
21508_0,,,,2,1,1,2
21510_0,,,,2,1,1,2
C12C(CC(C(C(O)O1)O)O2)O,,,4,1,1,0,1
21512_0,,,,2,1,1,2
C(CC1C(COC(C(C1)=O)O)O)=O,,,4,1,2,0,2
21514_0,,,,2,1,1,2
C(C1C(CC(CO)CC(O1)O)=O)=O,,,4,1,1,0,1
21516_0,,,,2,1,1,2
C(CC1COC(C(C(C1)=O)O)O)=O,,,4,1,2,0,2
21518_0,,,,2,1,1,2
C(C1CC(OC(C(C1)=O)CO)O)=O,,,4,1,1,0,1
21520_0,,,,2,1,1,2
C(CC1C(O)OCC(C(C1)=O)O)=O,,,4,1,2,0,2
21522_0,,,,2,1,1,2
C1(C(CC(O)OCC1O)CC=O)=O,,,4,1,1,0,1
21524_0,,,,2,1,1,2
C(C(C1C(CCCC(O1)O)=O)O)=O,,,4,1,1,0,1
21526_0,,,,2,1,1,2
C(C(C1CC(OCC(C1)=O)O)O)=O,,,4,1,1,0,1
21528_0,,,,2,1,1,2
C(CC1C(C(OCC(C1)=O)O)O)=O,,,4,1,2,0,2
21529_0,,,,2,1,1,2
21530_0,,,,2,1,1,2
21531_0,,,,2,1,1,2
21532_0,,,,2,1,1,2
21533_0,,,,2,1,1,2
21534_0,,,,2,1,1,2
21535_0,,,,2,1,1,2
21536_0,,,,2,1,1,2
21537_0,,,,2,1,1,2
21538_0,,,,2,1,1,2
21539_0,,,,2,1,1,2
21540_0,,,,2,1,1,2
21541_0,,,,2,1,1,2
21542_0,,,,2,1,1,2
21543_0,,,,2,1,1,2
21544_0,,,,2,1,1,2
21545_0,,,,2,1,1,2
21546_0,,,,2,1,1,2
21547_0,,,,2,1,1,2
21548_0,,,,2,1,1,2
21549_0,,,,2,1,1,2
21550_0,,,,2,1,1,2
21551_0,,,,2,1,1,2
21552_0,,,,2,1,1,2
21553_0,,,,2,1,1,2
21554_0,,,,2,1,1,2
21555_0,,,,2,1,1,2
21556_0,,,,2,1,1,2
21557_0,,,,2,1,1,2
21558_0,,,,2,1,1,2
21559_0,,,,2,1,1,2
21560_0,,,,2,1,1,2
21561_0,,,,2,1,1,2
21562_0,,,,2,1,1,2
21563_0,,,,2,1,1,2
21564_0,,,,2,1,1,2
21565_0,,,,2,1,1,2
21566_0,,,,2,1,1,2
21567_0,,,,2,1,1,2
21568_0,,,,2,1,1,2
21569_0,,,,2,1,1,2
21570_0,,,,2,1,1,2
21570_1,,,,2,1,1,2
21571_0,,,,2,1,1,2
21572_0,,,,2,1,1,2
21573_0,,,,2,1,1,2
21574_0,,,,2,1,1,2
21575_0,,,,2,1,1,2
21576_0,,,,2,1,1,2
21577_0,,,,2,1,1,2
21578_0,,,,2,1,1,2
21579_0,,,,2,1,1,2
21580_0,,,,2,1,1,2
21581_0,,,,2,1,1,2
21582_0,,,,2,1,1,2
21583_0,,,,2,1,1,2
21583_1,,,,2,1,1,2
21584_0,,,,2,1,1,2
21585_0,,,,2,1,1,2
21586_0,,,,2,1,1,2
21587_0,,,,2,1,1,2
21588_0,,,,2,1,1,2
21589_0,,,,2,1,1,2
21590_0,,,,2,1,1,2
21591_0,,,,2,1,1,2
21592_0,,,,2,1,1,2
21593_0,,,,2,1,1,2
21594_0,,,,2,1,1,2
21595_0,,,,2,1,1,2
21596_0,,,,2,1,1,2
21597_0,,,,2,1,1,2
21598_0,,,,2,1,1,2
21599_0,,,,2,1,1,2
21600_0,,,,2,1,1,2
21601_0,,,,2,1,1,2
21602_0,,,,2,1,1,2
21603_0,,,,2,1,1,2
21604_0,,,,2,1,1,2
21605_0,,,,2,1,1,2
21606_0,,,,2,1,1,2
21607_0,,,,2,1,1,2
21608_0,,,,2,1,1,2
21609_0,,,,2,1,1,2
21610_0,,,,2,1,1,2
21611_0,,,,2,1,1,2
21612_0,,,,2,1,1,2
21613_0,,,,2,1,1,2
21614_0,,,,2,1,1,2
21615_0,,,,2,1,1,2
21616_0,,,,2,1,1,2
21617_0,,,,2,1,1,2
21618_0,,,,2,1,1,2
21619_0,,,,2,1,1,2
21620_0,,,,2,1,1,2
21621_0,,,,2,1,1,2
21622_0,,,,2,1,1,2
21623_0,,,,2,1,1,2
21624_0,,,,2,1,1,2
21625_0,,,,2,1,1,2
21626_0,,,,2,1,1,2
21627_0,,,,2,1,1,2
21628_0,,,,2,1,1,2
21629_0,,,,2,1,1,2
21630_0,,,,2,1,1,2
21631_0,,,,2,1,1,2
21632_0,,,,2,1,1,2
21633_0,,,,2,1,1,2
21634_0,,,,2,1,1,2
21635_0,,,,2,1,1,2
21636_0,,,,2,1,1,2
21637_0,,,,2,1,1,2
21638_0,,,,2,1,1,2
21639_0,,,,2,1,1,2
21640_0,,,,2,1,1,2
21641_0,,,,2,1,1,2
21642_0,,,,2,1,1,2
21643_0,,,,2,1,1,2
21644_0,,,,2,1,1,2
21645_0,,,,2,1,1,2
21646_0,,,,2,1,1,2
21647_0,,,,2,1,1,2
21648_0,,,,2,1,1,2
21649_0,,,,2,1,1,2
21650_0,,,,2,1,1,2
21651_0,,,,2,1,1,2
21652_0,,,,2,1,1,2
21653_0,,,,2,1,1,2
21654_0,,,,2,1,1,2
21655_0,,,,2,1,1,2
21656_0,,,,2,1,1,2
21657_0,,,,2,1,1,2
21658_0,,,,2,1,1,2
21659_0,,,,2,1,1,2
21660_0,,,,2,1,1,2
21661_0,,,,2,1,1,2
21662_0,,,,2,1,1,2
21663_0,,,,2,1,1,2
21664_0,,,,2,1,1,2
21665_0,,,,2,1,1,2
21666_0,,,,2,1,1,2
21667_0,,,,2,1,1,2
21668_0,,,,2,1,1,2
21669_0,,,,2,1,1,2
21670_0,,,,2,1,1,2
21671_0,,,,2,1,1,2
21672_0,,,,2,1,1,2
21673_0,,,,2,1,1,2
21674_0,,,,2,1,1,2
21675_0,,,,2,1,1,2
21676_0,,,,2,1,2,3
21677_0,,,,2,1,2,3
21678_0,,,,2,1,2,3
21679_0,,,,2,1,2,3
21680_0,,,,2,1,2,3
21681_0,,,,2,1,2,3
21682_0,,,,2,1,2,3
21683_0,,,,2,1,2,3
21684_0,,,,2,1,2,3
21685_0,,,,2,1,2,3
21686_0,,,,2,1,2,3
21688_0,,,,2,1,2,3
C1(C(CO)(CC(CO)O1)O)=O,,,4,1,1,0,1
21689_0,,,,2,1,2,3
21690_0,,,,2,1,2,3
21692_0,,,,2,1,2,3
C1(C(CCO1)(CC=O)O)=O,,,4,1,1,0,1
21694_0,,,,2,1,2,3
C1(C(C)(CC(C=O)O1)O)=O,,,4,1,1,0,1
21695_0,,,,2,1,2,3
21696_0,,,,2,1,2,3
21697_0,,,,2,1,2,3
21698_0,,,,2,1,2,3
21699_0,,,,2,1,1,2
21700_0,,,,2,1,1,2
21701_0,,,,2,1,2,3
21702_0,,,,2,1,2,3
21703_0,,,,2,1,2,3
21703_1,,,,2,1,2,3
21705_0,,,,2,1,2,3
C1(C(C(C(C(CO)O)O1)O)=O)=O,,,4,1,1,0,1
21706_0,,,,2,1,2,3
21708_0,,,,2,1,2,3
C1(C(CC(C(C=O)O)O1)O)=O,,,4,1,1,0,1
21709_0,,,,2,1,2,3
21710_0,,,,2,1,2,3
21711_0,,,,2,1,2,3
21711_1,,,,2,1,2,3
21712_0,,,,2,1,2,3
21713_0,,,,2,1,2,3
21714_0,,,,2,1,2,3
21715_0,,,,2,1,2,3
21716_0,,,,2,1,2,3
21717_0,,,,2,1,2,3
21718_0,,,,2,1,2,3
21719_0,,,,2,1,2,3
21720_0,,,,2,1,2,3
21721_0,,,,2,1,2,3
21722_0,,,,2,1,2,3
21723_0,,,,2,1,2,3
21724_0,,,,2,1,2,3
21725_0,,,,2,1,2,3
21726_0,,,,2,1,1,2
21727_0,,,,2,1,1,2
21728_0,,,,2,1,2,3
21730_0,,,,2,1,2,3
C1(C(C(CO)(CO1)O)O)=O,,,4,1,1,0,1
21732_0,,,,2,1,2,3
C1(C(C(C(CO)O1)O)O)=O,,,4,1,1,0,1
21734_0,,,,2,1,2,3
C(CC1(COC(C1O)=O)O)=O,,,4,1,1,0,1
21736_0,,,,2,1,2,3
C1(C(C(C)(C(C=O)O1)O)O)=O,,,4,1,1,0,1
21738_0,,,,2,1,2,3
C1(C(C(C)(C(CO)O1)O)O)=O,,,4,1,1,0,1
21740_0,,,,2,1,2,3
C1(C(C(CO1)(CCO)O)O)=O,,,4,1,1,0,1
21742_0,,,,2,1,2,3
C1(C(C(C(C=O)O1)O)O)=O,,,4,1,1,0,1
21744_0,,,,2,1,2,3
C1(C(C(C)(CO1)O)O)=O,,,4,1,1,0,1
21746_0,,,,2,1,2,3
C1(C(C(C(C(C=O)O)O1)O)O)=O,,,4,1,1,0,1
21748_0,,,,2,1,2,3
C1(C(C(CO1)(C(CO)O)O)O)=O,,,4,1,1,0,1
21750_0,,,,2,1,2,3
C1(C(C(CO)(C(CO)O1)O)O)=O,,,4,1,1,0,1
21751_0,,,,2,1,1,2
21752_0,,,,2,1,1,2
21753_0,,,,2,1,1,2
21754_0,,,,2,1,1,2
21755_0,,,,2,1,1,2
21757_0,,,,2,1,2,3
C1(C(CO)(CC(CO1)O)O)=O,,,4,1,1,0,1
21758_0,,,,2,1,2,3
21759_0,,,,2,1,2,3
21760_0,,,,2,1,2,3
21761_0,,,,2,1,2,3
21762_0,,,,2,1,2,3
21763_0,,,,2,1,2,3
21764_0,,,,2,1,1,2
21765_0,,,,2,1,2,3
21767_0,,,,2,1,2,3
C1(C(C(C(C(CO)O1)O)O)=O)=O,,,4,1,1,0,1
21769_0,,,,2,1,2,3
C1(C(CC(C(C=O)O1)O)O)=O,,,4,1,1,0,1
21770_0,,,,2,1,2,3
21771_0,,,,2,1,2,3
21772_0,,,,2,1,2,3
21773_0,,,,2,1,2,3
21774_0,,,,2,1,2,3
21775_0,,,,2,1,2,3
21777_0,,,,2,1,2,3
C1(C2C(CC(CO)(O2)O1)O)=O,,,4,1,1,0,1
21779_0,,,,2,1,2,3
C1(C2C(C(C(C)(O2)O1)O)O)=O,,,4,1,1,0,1
21780_0,,,,2,1,2,3
21781_0,,,,2,1,1,2
21783_0,,,,2,1,2,3
C1(C(C(C(CO1)O)O)O)=O,,,4,1,1,0,1
21785_0,,,,2,1,2,3
C1(C(C(C)(C(CO1)O)O)O)=O,,,4,1,1,0,1
21787_0,,,,2,1,2,3
C(C1(CCOC(C1O)=O)O)=O,,,4,1,1,0,1
21789_0,,,,2,1,2,3
C1(C(C(CO)(CCO1)O)O)=O,,,4,1,1,0,1
21791_0,,,,2,1,2,3
C1(C(C(C(C(C=O)O1)O)O)O)=O,,,4,1,1,0,1
21793_0,,,,2,1,2,3
C1(C(C(CO)(C(CO1)O)O)O)=O,,,4,1,1,0,1
21794_0,,,,2,1,1,2
21795_0,,,,2,1,1,2
21796_0,,,,2,1,1,2
21797_0,,,,2,1,1,2
21798_0,,,,2,1,1,2
21799_0,,,,2,1,1,2
21800_0,,,,2,1,2,3
21801_0,,,,2,1,2,3
21802_0,,,,2,1,2,3
21803_0,,,,2,1,2,3
21804_0,,,,2,1,2,3
21805_0,,,,2,1,2,3
21806_0,,,,2,1,2,3
21807_0,,,,2,1,2,3
21809_0,,,,2,1,2,3
C1(C(C(C(CCO1)O)O)O)=O,,,4,1,1,0,1
21810_0,,,,2,1,2,3
21812_0,,,,2,1,2,3
C1(C(C(C(C(CO1)O)O)O)=O)=O,,,4,1,1,0,1
21814_0,,,,2,1,2,3
C1(CC(C(C(C(O1)=O)O)O)O)=O,,,4,1,1,0,1
21815_0,,,,2,1,2,3
21816_0,,,,2,1,2,3
21817_0,,,,2,1,2,3
21818_0,,,,2,1,2,3
21820_0,,,,2,1,2,3
C1(CC2C(C(C(O2)O1)O)O)=O,,,4,1,1,0,1
21821_0,,,,2,1,2,3
21822_0,,,,2,1,2,3
21824_0,,,,2,1,2,3
C1(C(C2C(CC(O2)O1)O)O)=O,,,4,1,1,0,1
21826_0,,,,2,1,2,3
C1(C2C(C(CC(O2)O1)O)O)=O,,,4,1,1,0,1
21828_0,,,,2,1,1,2
C1(C(C(C(C(C=O)O)C1)O)O)=O,,,4,1,1,0,1
21829_0,,,,2,1,1,2
21830_0,,,,2,1,1,2
21831_0,,,,2,1,1,2
21832_0,,,,2,1,1,2
21833_0,,,,2,1,1,2
21834_0,,,,2,1,1,2
21835_0,,,,2,1,1,2
21836_0,,,,2,1,1,2
21838_0,,,,2,1,1,2
C1(C(C(C)(C(C(C=O)O)C1)O)O)=O,,,4,1,1,0,1
21839_0,,,,2,1,1,2
21840_0,,,,2,1,1,2
21841_0,,,,2,1,1,2
21842_0,,,,2,1,1,2
21844_0,,,,2,1,1,2
C1(C(C(C(CC1)O)O)O)=O,,,4,1,1,0,1
21845_0,,,,2,1,1,2
21846_0,,,,2,1,1,2
21847_0,,,,2,1,1,2
21848_0,,,,2,1,1,2
21849_0,,,,2,1,1,2
21851_0,,,,2,1,1,2
C(C1(C(CCC(C1O)=O)O)O)=O,,,4,1,1,0,1
21853_0,,,,2,1,1,2
C1(C(C(CC1)O)(C(C=O)O)O)=O,,,4,1,1,0,1
21854_0,,,,2,1,1,2
21855_0,,,,2,1,1,2
21857_0,,,,2,1,1,2
C(C1(C(CC(CO)C1(C)O)=O)O)=O,,,4,1,1,0,1
21858_0,,,,2,1,1,2
21859_0,,,,2,1,1,2
21861_0,,,,2,1,1,2
C(C1C(C)(C(C(C1)=O)(CO)O)O)=O,,,4,1,1,0,1
21862_0,,,,2,1,1,2
21863_0,,,,2,1,1,2
21865_0,,,,2,1,1,2
C(C1(C(CCC(C1O)=O)(C)O)O)=O,,,4,1,1,0,1
21866_0,,,,2,1,1,2
21868_0,,,,2,1,1,2
C1(C(C(CC1)(C)O)(C(C=O)O)O)=O,,,4,1,1,0,1
21869_0,,,,2,1,1,2
21870_0,,,,2,1,1,2
21871_0,,,,2,1,1,2
21872_0,,,,2,1,1,2
21873_0,,,,2,1,1,2
21875_0,,,,2,2,1,3
C1(C(C(C(C(CO)C1)O)O)O)=O,,,4,1,1,0,1
21877_0,,,,2,2,1,3
C1(C(C(C(C(CCO)C1)O)O)O)=O,,,4,1,1,0,1
21879_0,,,,2,2,1,3
C1(C(C(C(C(C(C)O)C1)O)O)O)=O,,,4,1,1,0,1
21881_0,,,,2,2,1,3
C(CC(C(C=O)CC(CO)=O)O)=O,,,4,1,1,0,1
21883_0,,,,2,2,1,3
C(CC(C=O)C(C=O)CO)(CO)=O,,,4,1,1,0,1
21885_0,,,,2,2,1,3
C(CO)(C(C(CC=O)O)CC=O)=O,,,4,1,1,0,1
21887_0,,,,2,2,1,3
C(CC(C(CO)=O)C(C=O)CO)=O,,,4,1,1,0,1
21889_0,,,,2,2,1,3
C(CC(CCC(C=O)=O)O)=O,,,4,1,1,0,1
21891_0,,,,2,2,1,3
C(C(CCC(C=O)=O)CO)=O,,,4,1,1,0,1
21893_0,,,,2,2,1,3
C(CC(CCC(CO)=O)O)=O,,,4,1,1,0,1
21895_0,,,,2,2,1,3
C(C(CO)CCC(CO)=O)=O,,,4,1,1,0,1
21897_0,,,,2,2,1,3
C(CC(C(C=O)CC=O)O)=O,,,4,1,1,0,1
21899_0,,,,2,2,1,3
C(CC(C=O)C(C=O)CO)=O,,,4,1,1,0,1
21901_0,,,,2,2,1,3
C(C(CCC(C=O)=O)C(C)O)=O,,,4,1,1,0,1
21903_0,,,,2,2,1,3
C(CC(CCCC(C=O)=O)O)=O,,,4,1,1,0,1
21905_0,,,,2,2,1,3
C(CC(C)(CCC(C=O)=O)O)=O,,,4,1,1,0,1
21907_0,,,,2,2,1,3
C(C(CCC(CO)=O)C(C)O)=O,,,4,1,1,0,1
21909_0,,,,2,2,1,3
C(CC(CCCC(CO)=O)O)=O,,,4,1,1,0,1
21911_0,,,,2,2,1,3
C(CC(C)(CCC(CO)=O)O)=O,,,4,1,1,0,1
21913_0,,,,2,2,1,3
C(CC(C=O)C(C=O)C(C)O)=O,,,4,1,1,0,1
21915_0,,,,2,2,1,3
C(CC(CC(C=O)CC=O)O)=O,,,4,1,1,0,1
21917_0,,,,2,2,1,3
C(CC(C)(C(C=O)CC=O)O)=O,,,4,1,1,0,1
21918_0,,,,2,2,1,3
21920_0,,,,2,2,1,3
C(C(C(CCCC(C=O)=O)O)O)=O,,,4,1,1,0,1
21922_0,,,,2,2,1,3
C(C(C(CCC(C=O)=O)(C)O)O)=O,,,4,1,1,0,1
21924_0,,,,2,2,1,3
C(C(CCC(CO)=O)(C(C)O)O)=O,,,4,1,1,0,1
21926_0,,,,2,2,1,3
C(C(C(CCCC(CO)=O)O)O)=O,,,4,1,1,0,1
21928_0,,,,2,2,1,3
C(C(C(CCC(CO)=O)(C)O)O)=O,,,4,1,1,0,1
21930_0,,,,2,2,1,3
C(CC(C=O)C(C=O)(C(C)O)O)=O,,,4,1,1,0,1
21932_0,,,,2,2,1,3
C(C(C(CC(C=O)CC=O)O)O)=O,,,4,1,1,0,1
21934_0,,,,2,2,1,3
C(C(C(C)(C(C=O)CC=O)O)O)=O,,,4,1,1,0,1
21935_0,,,,2,2,1,3
21936_0,,,,2,2,1,3
21938_0,,,,2,2,1,3
C(C(CCC(C=O)=O)C(CO)O)=O,,,4,1,1,0,1
21939_0,,,,2,2,1,3
21941_0,,,,2,2,1,3
C(CC(C(CCC(CO)=O)O)O)=O,,,4,1,1,0,1
21943_0,,,,2,2,1,3
C(C(CCC(CO)=O)C(CO)O)=O,,,4,1,1,0,1
21945_0,,,,2,2,1,3
C(CC(CO)(C(C=O)CC=O)O)=O,,,4,1,1,0,1
21947_0,,,,2,2,1,3
C(CC(C(C(C=O)CC=O)O)O)=O,,,4,1,1,0,1
21949_0,,,,2,2,1,3
C(CC(C=O)C(C=O)C(CO)O)=O,,,4,1,1,0,1
21951_0,,,,2,2,1,3
C(C(C)(CCC(C=O)=O)O)(O)=O,,,4,1,1,0,1
21953_0,,,,2,2,1,3
C(C(CCCC(C=O)=O)O)(O)=O,,,4,1,1,0,1
21955_0,,,,2,2,1,3
C(C(C)(CCC(CO)=O)O)(O)=O,,,4,1,1,0,1
21957_0,,,,2,2,1,3
C(C(CCCC(CO)=O)O)(O)=O,,,4,1,1,0,1
21959_0,,,,2,2,1,3
C(C(C)(C(C=O)CC=O)O)(O)=O,,,4,1,1,0,1
21961_0,,,,2,2,1,3
C(C(CC(C=O)CC=O)O)(O)=O,,,4,1,1,0,1
21963_0,,,,2,2,1,3
C(C=O)(CCC(C(C=O)=O)O)=O,,,4,1,1,0,1
21965_0,,,,2,2,1,3
C(CO)(CCC(C(C=O)=O)O)=O,,,4,1,1,0,1
21967_0,,,,2,2,1,3
C(CC(C=O)C(C(C=O)=O)O)=O,,,4,1,1,0,1
21969_0,,,,2,2,1,3
C(C=O)(CCC(C(C(C)=O)=O)O)=O,,,4,1,1,0,1
21971_0,,,,2,2,1,3
C(C=O)(CCCC(C(CO)=O)=O)=O,,,4,1,1,0,1
21973_0,,,,2,2,1,3
C(CO)(CCC(C(C(C)=O)=O)O)=O,,,4,1,1,0,1
21975_0,,,,2,2,1,3
C(CO)(CCCC(C(CO)=O)=O)=O,,,4,1,1,0,1
21977_0,,,,2,2,1,3
C(CC(C=O)C(C(C(C)=O)=O)O)=O,,,4,1,1,0,1
21979_0,,,,2,2,1,3
C(CC(C=O)CC(C(CO)=O)=O)=O,,,4,1,1,0,1
21981_0,,,,2,2,1,3
C(C=O)(C(C)(CCC(C=O)=O)O)=O,,,4,1,1,0,1
21983_0,,,,2,2,1,3
C(C=O)(CCCC(C(C=O)=O)O)=O,,,4,1,1,0,1
21985_0,,,,2,2,1,3
C(CO)(CCC(C(C=O)=O)(C)O)=O,,,4,1,1,0,1
21987_0,,,,2,2,1,3
C(CO)(CCCC(C(C=O)=O)O)=O,,,4,1,1,0,1
21989_0,,,,2,2,1,3
C(CC(C=O)C(C(C=O)=O)(C)O)=O,,,4,1,1,0,1
21991_0,,,,2,2,1,3
C(C(CC(C(C=O)=O)O)CC=O)=O,,,4,1,1,0,1
21992_0,,,,2,2,1,3
21994_0,,,,2,2,1,3
C(CO)(C(C)(CCC(C=O)=O)O)=O,,,4,1,1,0,1
21996_0,,,,2,2,1,3
C(CO)(C(CCCC(C=O)=O)O)=O,,,4,1,1,0,1
21998_0,,,,2,2,1,3
C(C(CCC(CO)=O)O)(C(C)O)=O,,,4,1,1,0,1
22000_0,,,,2,2,1,3
C(CO)(C(C)(CCC(CO)=O)O)=O,,,4,1,1,0,1
22002_0,,,,2,2,1,3
C(CO)(CCCC(C(CO)=O)O)=O,,,4,1,1,0,1
22004_0,,,,2,2,1,3
C(C(C(C=O)CC=O)O)(C(C)O)=O,,,4,1,1,0,1
22006_0,,,,2,2,1,3
C(CO)(C(C)(C(C=O)CC=O)O)=O,,,4,1,1,0,1
22007_0,,,,2,2,1,3
22009_0,,,,2,2,1,3
C(C(C=O)C(C=O)CC(CO)=O)=O,,,4,1,1,0,1
22011_0,,,,2,2,1,3
C(C(C=O)C(C(CO)=O)CC=O)=O,,,4,1,1,0,1
22013_0,,,,2,2,1,3
C(C(C=O)CCC(C=O)=O)=O,,,4,1,1,0,1
22015_0,,,,2,2,1,3
C(C(C=O)CCC(CO)=O)=O,,,4,1,1,0,1
22017_0,,,,2,2,1,3
C(C(C=O)C(C=O)CC=O)=O,,,4,1,1,0,1
22019_0,,,,2,2,1,3
C(C(C=O)C(C(C=O)=O)CC(C)=O)=O,,,4,1,1,0,1
22021_0,,,,2,2,1,3
C(C(C=O)C(C(C)=O)CC(C=O)=O)=O,,,4,1,1,0,1
22023_0,,,,2,2,1,3
C(C(C=O)C(CC=O)CC(C=O)=O)=O,,,4,1,2,0,2
22025_0,,,,2,2,1,3
C(C(C=O)C(C=O)CC(C(C)=O)=O)=O,,,4,1,1,0,1
22027_0,,,,2,2,1,3
C(C(C=O)C(C(C(C)=O)=O)CC=O)=O,,,4,1,1,0,1
22029_0,,,,2,2,1,3
C(C(C=O)C(C=O)CC(CC=O)=O)=O,,,4,1,1,0,1
22031_0,,,,2,2,1,3
C(C(C=O)C(C(CC=O)=O)CC=O)=O,,,4,1,1,0,1
22033_0,,,,2,2,1,3
C(C(C=O)CCC(CC(C=O)=O)=O)=O,,,4,1,1,0,1
22035_0,,,,2,2,1,3
C(C(C=O)CCC(C(CC=O)=O)=O)=O,,,4,1,1,0,1
22036_0,,,,2,2,1,3
22038_0,,,,2,2,1,3
C(C(CCC(C=O)=O)(CCO)O)=O,,,4,1,1,0,1
22040_0,,,,2,2,1,3
C(C(C(CCC(C=O)=O)CO)O)=O,,,4,1,1,0,1
22042_0,,,,2,2,1,3
C(C(CC(CCC(C=O)=O)O)O)=O,,,4,1,1,0,1
22043_0,,,,2,2,1,3
22045_0,,,,2,2,1,3
C(C(C(CCC(CO)=O)CO)O)=O,,,4,1,1,0,1
22047_0,,,,2,2,1,3
C(C(CC(CCC(CO)=O)O)O)=O,,,4,1,1,0,1
22049_0,,,,2,2,1,3
C(CC(C=O)C(C=O)(CCO)O)=O,,,4,1,1,0,1
22051_0,,,,2,2,1,3
C(C(C(CO)C(C=O)CC=O)O)=O,,,4,1,1,0,1
22053_0,,,,2,2,1,3
C(C(CC(C(C=O)CC=O)O)O)=O,,,4,1,1,0,1
22055_0,,,,2,2,1,3
C(C(CCCC(C(O)=O)=O)=O)=O,,,4,1,1,0,1
22057_0,,,,2,2,1,3
C(CO)(CCCC(C(O)=O)=O)=O,,,4,1,1,0,1
22059_0,,,,2,2,1,3
C(CC(C=O)CC(C(O)=O)=O)=O,,,4,1,1,0,1
22060_0,,,,2,2,1,3
22062_0,,,,2,2,1,3
C(C(C=O)(CCC(CO)=O)O)(O)=O,,,4,1,1,0,1
22064_0,,,,2,2,1,3
C(C(C=O)(C(C=O)CC=O)O)(O)=O,,,4,1,1,0,1
22066_0,,,,2,2,1,3
C(C)(C(C(C=O)=O)CCC(C=O)=O)=O,,,4,1,1,0,1
22068_0,,,,2,2,1,3
C(CCCC(C=O)=O)(CC(C=O)=O)=O,,,4,1,2,0,2
22070_0,,,,2,2,1,3
C(CC(C=O)C(C(C)=O)C(C=O)=O)=O,,,4,1,1,0,1
22072_0,,,,2,2,1,3
C(CC(C=O)CC(CC(C=O)=O)=O)=O,,,4,1,1,0,1
22074_0,,,,2,2,1,3
C(C(C(C=O)=O)CCC(C=O)=O)=O,,,4,1,1,0,1
22076_0,,,,2,2,1,3
C(C(C(C=O)=O)CCC(CO)=O)=O,,,4,1,1,0,1
22078_0,,,,2,2,1,3
C(C(C(C=O)=O)C(C=O)CC=O)=O,,,4,1,1,0,1
22080_0,,,,2,2,1,3
C(C(C(C(C)=O)=O)CCC(C=O)=O)=O,,,4,1,1,0,1
22082_0,,,,2,2,1,3
C(CC(C(CCCC(C=O)=O)=O)=O)=O,,,4,1,2,0,2
22084_0,,,,2,2,1,3
C(C(C(C(C)=O)=O)C(C=O)CC=O)=O,,,4,1,1,0,1
22086_0,,,,2,2,1,3
C(CC(C(CC(C=O)CC=O)=O)=O)=O,,,4,1,1,0,1
22088_0,,,,2,2,1,3
C(C=O)(CCCC(C(C)=O)=O)=O,,,4,1,1,0,1
22090_0,,,,2,2,1,3
C(CO)(CCCC(C(C)=O)=O)=O,,,4,1,1,0,1
22091_0,,,,2,2,1,3
22093_0,,,,2,2,1,3
C(CC(CCCC(C=O)=O)=O)=O,,,4,1,1,0,1
22095_0,,,,2,2,1,3
C(C(C(C)=O)CCC(C=O)=O)=O,,,4,1,1,0,1
22097_0,,,,2,2,1,3
C(CCCC(CO)=O)(CC=O)=O,,,4,1,1,0,1
22099_0,,,,2,2,1,3
C(C)(C(C=O)CCC(CO)=O)=O,,,4,1,1,0,1
22100_0,,,,2,2,1,3
22102_0,,,,2,2,1,3
C(C(C(C)=O)C(C=O)CC=O)=O,,,4,1,1,0,1
22104_0,,,,2,2,1,3
C1(COC(CCC(C=O)=O)(C1)O)=O,,,4,1,1,0,1
22106_0,,,,2,2,1,3
C1(COC(C1CCC(C=O)=O)O)=O,,,4,1,1,0,1
22108_0,,,,2,2,1,3
C1(C(CCC(C=O)=O)OC(C1)O)=O,,,4,1,1,0,1
22110_0,,,,2,2,1,3
C(CO)(CCC1(CC(CO1)=O)O)=O,,,4,1,1,0,1
22112_0,,,,2,2,1,3
C(CO)(CCC1C(COC1O)=O)=O,,,4,1,1,0,1
22114_0,,,,2,2,1,3
C1(C(CCC(CO)=O)OC(C1)O)=O,,,4,1,1,0,1
22116_0,,,,2,2,1,3
C1(COC(C(C=O)CC=O)(C1)O)=O,,,4,1,1,0,1
22118_0,,,,2,2,1,3
C1(COC(C1C(C=O)CC=O)O)=O,,,4,1,1,0,1
22120_0,,,,2,2,1,3
C1(C(C(C=O)CC=O)OC(C1)O)=O,,,4,1,1,0,1
22122_0,,,,2,2,1,3
C(C=O)(CCC(C(C=CC=O)=O)O)=O,,,4,1,1,0,1
22124_0,,,,2,2,1,3
C(CC(C=O)C(C(C=CC=O)=O)O)=O,,,4,1,1,0,1
22126_0,,,,2,2,1,3
C(C(CC(C=O)CC(CO)=O)O)=O,,,4,1,1,0,1
22128_0,,,,2,2,1,3
C(CO)(C(CC(C=O)O)CC=O)=O,,,4,1,1,0,1
22130_0,,,,2,2,1,3
C(CC(C=O)C(C=O)(C)O)(CO)=O,,,4,1,1,0,1
22132_0,,,,2,2,1,3
C(CC(C(CO)=O)C(C=O)(C)O)=O,,,4,1,1,0,1
22133_0,,,,2,2,1,3
22134_0,,,,2,2,1,3
22135_0,,,,2,2,1,3
22137_0,,,,2,2,1,3
C(CO)(C(CCO)CC=O)=O,,,4,1,1,0,1
22139_0,,,,2,2,1,3
C(C(C(C)O)CC(CO)=O)=O,,,4,1,1,0,1
22141_0,,,,2,2,1,3
C(CO)(C(C(C)O)CC=O)=O,,,4,1,1,0,1
22143_0,,,,2,2,1,3
C(CC(C=O)CC(CO)=O)(O)=O,,,4,1,1,0,1
22145_0,,,,2,2,1,3
C(CC(C(CO)=O)CC=O)(O)=O,,,4,1,1,0,1
22147_0,,,,2,2,1,3
C=CC(C(CCC(C=O)=O)O)=O,,,4,1,1,0,1
22149_0,,,,2,2,1,3
C1(C(CCC(C=O)=O)C(CO1)O)=O,,,4,1,1,0,1
22151_0,,,,2,2,1,3
C1(CC(CO1)(CCC(C=O)=O)O)=O,,,4,1,1,0,1
22153_0,,,,2,2,1,3
C1(CC(C(CCC(C=O)=O)O1)O)=O,,,4,1,1,0,1
22155_0,,,,2,2,1,3
C(C(CCCC(C=O)=O)O)=O,,,4,1,1,0,1
22157_0,,,,2,2,1,3
C(C(C)(CCC(C=O)=O)O)=O,,,4,1,1,0,1
22159_0,,,,2,2,1,3
C(C(CCC(C(CO)O)O)=O)=O,,,4,1,1,0,1
22161_0,,,,2,2,1,3
C(C(CCC(CO)(CO)O)=O)=O,,,4,1,1,0,1
22163_0,,,,2,2,1,3
C(C(CCCO)=O)=O,,,4,1,1,0,1
22165_0,,,,2,2,1,3
C(C(CCCCO)=O)=O,,,4,1,1,0,1
22167_0,,,,2,2,1,3
C(C(CCC(C)O)=O)=O,,,4,1,1,0,1
22169_0,,,,2,2,1,3
C(C(CO)(CCC(C=O)=O)O)(O)=O,,,4,1,1,0,1
22171_0,,,,2,2,1,3
C(C(C(CCC(C=O)=O)O)O)(O)=O,,,4,1,1,0,1
22173_0,,,,2,2,1,3
C(CCCC(C=O)=O)(O)=O,,,4,1,1,0,1
22175_0,,,,2,2,1,3
C1(C(CCC(C=O)=O)OCC1O)=O,,,4,1,1,0,1
22177_0,,,,2,2,1,3
C1(COCC1(CCC(C=O)=O)O)=O,,,4,1,1,0,1
22179_0,,,,2,2,1,3
C1(COC(CCC(C=O)=O)C1O)=O,,,4,1,1,0,1
22181_0,,,,2,2,1,3
C1(C(CCC(C=O)=O)(O)OCC1)=O,,,4,1,1,0,1
22183_0,,,,2,2,1,3
C1(C(O)OCC1CCC(C=O)=O)=O,,,4,1,1,0,1
22185_0,,,,2,2,1,3
C1(C(O)OC(CCC(C=O)=O)C1)=O,,,4,1,1,0,1
22187_0,,,,2,2,1,3
C(CO)(CCC(C(C=C)=O)O)=O,,,4,1,1,0,1
22189_0,,,,2,2,1,3
C(CC(C=O)C(C(C=C)=O)O)=O,,,4,1,1,0,1
22191_0,,,,2,2,1,3
C1(C(CCC(CO)=O)C(CO1)O)=O,,,4,1,1,0,1
22193_0,,,,2,2,1,3
C1(CC(CCC(CO)=O)(CO1)O)=O,,,4,1,1,0,1
22195_0,,,,2,2,1,3
C1(CC(C(CCC(CO)=O)O1)O)=O,,,4,1,1,0,1
22197_0,,,,2,2,1,3
C(C(CCCC(CO)=O)O)=O,,,4,1,1,0,1
22199_0,,,,2,2,1,3
C(C(C)(CCC(CO)=O)O)=O,,,4,1,1,0,1
22201_0,,,,2,2,1,3
C(CO)(CCC(C(CO)O)O)=O,,,4,1,1,0,1
22203_0,,,,2,2,1,3
C(CO)(CCC(CO)(CO)O)=O,,,4,1,1,0,1
22205_0,,,,2,2,1,3
C(CO)(CCCO)=O,,,4,1,1,0,1
22207_0,,,,2,2,1,3
C(CO)(CCCCO)=O,,,4,1,1,0,1
22209_0,,,,2,2,1,3
C(CO)(CCC(C)O)=O,,,4,1,1,0,1
22210_0,,,,2,2,1,3
22212_0,,,,2,2,1,3
C(C(C(CCC(CO)=O)O)O)(O)=O,,,4,1,1,0,1
22214_0,,,,2,2,1,3
C(CCCC(CO)=O)(O)=O,,,4,1,1,0,1
22216_0,,,,2,2,1,3
C1(C(CCC(CO)=O)OCC1O)=O,,,4,1,1,0,1
22218_0,,,,2,2,1,3
C(CO)(CCC1(C(COC1)=O)O)=O,,,4,1,1,0,1
22220_0,,,,2,2,1,3
C(CO)(CCC1C(C(CO1)=O)O)=O,,,4,1,1,0,1
22222_0,,,,2,2,1,3
C1(C(CCC(CO)=O)(O)OCC1)=O,,,4,1,1,0,1
22224_0,,,,2,2,1,3
C(CO)(CCC1C(C(O)OC1)=O)=O,,,4,1,1,0,1
22226_0,,,,2,2,1,3
C(CO)(CCC1CC(C(O)O1)=O)=O,,,4,1,1,0,1
22228_0,,,,2,2,1,3
C1(C(C(CO1)O)C(C=O)CC=O)=O,,,4,1,1,0,1
22230_0,,,,2,2,1,3
C1(CC(CO1)(C(C=O)CC=O)O)=O,,,4,1,1,0,1
22232_0,,,,2,2,1,3
C1(CC(C(C(C=O)CC=O)O1)O)=O,,,4,1,1,0,1
22233_0,,,,2,2,1,3
22235_0,,,,2,2,1,3
C(CC(C=O)C(C=O)(C)O)=O,,,4,1,1,0,1
22237_0,,,,2,2,1,3
C(C(C(C(CO)O)O)CC=O)=O,,,4,1,1,0,1
22239_0,,,,2,2,1,3
C(C(C(CO)(CO)O)CC=O)=O,,,4,1,1,0,1
22240_0,,,,2,2,1,3
22241_0,,,,2,2,1,3
22243_0,,,,2,2,1,3
C(C(C(C)O)CC=O)=O,,,4,1,1,0,1
22245_0,,,,2,2,1,3
C(C(CO)(C(C=O)CC=O)O)(O)=O,,,4,1,1,0,1
22247_0,,,,2,2,1,3
C(C(C(C(C=O)CC=O)O)O)(O)=O,,,4,1,1,0,1
22249_0,,,,2,2,1,3
C(CC(C=O)CC(O)=O)=O,,,4,1,1,0,1
22251_0,,,,2,2,1,3
C(CC(C=O)C1C(C(CO1)O)=O)=O,,,4,1,1,0,1
22253_0,,,,2,2,1,3
C1(COCC1(C(C=O)CC=O)O)=O,,,4,1,1,0,1
22255_0,,,,2,2,1,3
C(C(C1C(C(CO1)=O)O)CC=O)=O,,,4,1,1,0,1
22257_0,,,,2,2,1,3
C(CC(C=O)C1(C(CCO1)=O)O)=O,,,4,1,1,0,1
22259_0,,,,2,2,1,3
C1(C(O)OCC1C(C=O)CC=O)=O,,,4,1,1,0,1
22261_0,,,,2,2,1,3
C(CC(C=O)C1CC(C(O)O1)=O)=O,,,4,1,1,0,1
22263_0,,,,2,2,1,3
C(C(CO)=O)(CC(CO)CO)=O,,,4,1,1,0,1
22265_0,,,,2,2,1,3
C(C(CO)=O)(CC(CO)CCO)=O,,,4,1,1,0,1
22267_0,,,,2,2,1,3
C(C(CO)=O)(CC(CO)C(C)O)=O,,,4,1,1,0,1
22269_0,,,,2,2,1,3
C(CC(CO)C(C(CO)=O)O)=O,,,4,1,1,0,1
22271_0,,,,2,2,1,3
C(CC(CCO)C(C(CO)=O)O)=O,,,4,1,1,0,1
22273_0,,,,2,2,1,3
C(CC(C(C)O)C(C(CO)=O)O)=O,,,4,1,1,0,1
22275_0,,,,2,2,1,3
C(CCCO)(C(C(CO)=O)O)=O,,,4,1,1,0,1
22277_0,,,,2,2,1,3
C(CCCCO)(C(C(CO)=O)O)=O,,,4,1,1,0,1
22279_0,,,,2,2,1,3
C(CCC(C)O)(C(C(CO)=O)O)=O,,,4,1,1,0,1
22280_0,,,,2,2,1,3
22282_0,,,,2,2,1,3
C(CO)(C(CCO)CC(CO)=O)=O,,,4,1,1,0,1
22283_0,,,,2,2,1,3
22285_0,,,,2,2,1,3
C(CO)(CC(CO)C(CO)O)=O,,,4,1,1,0,1
22287_0,,,,2,2,1,3
C(C(CO)O)(CC(CO)CO)=O,,,4,1,1,0,1
22289_0,,,,2,2,1,3
C(C(C(CO)O)O)(CCCO)=O,,,4,1,1,0,1
22291_0,,,,2,2,1,3
C(CC(CO)C(C(CO)O)O)=O,,,4,1,1,0,1
22293_0,,,,2,2,1,3
C(C(CC(CO)C(CO)O)=O)(O)=O,,,4,1,1,0,1
22295_0,,,,2,2,1,3
C(C(C(CC(CO)CO)=O)O)(O)=O,,,4,1,1,0,1
22297_0,,,,2,2,1,3
C(C(CO)CC(C(CO)O)=O)(O)=O,,,4,1,1,0,1
22299_0,,,,2,2,1,3
C(C(CO)CC(O)=O)(C(CO)O)=O,,,4,1,1,0,1
22301_0,,,,2,2,1,3
C(C(C(C(O)=O)O)O)(CCCO)=O,,,4,1,1,0,1
22302_0,,,,2,2,1,3
22304_0,,,,2,2,1,3
C(CC(CO)C(C(C(O)=O)O)O)=O,,,4,1,1,0,1
22306_0,,,,2,2,1,3
C(CC(CO)C(C(C=O)O)O)(O)=O,,,4,1,1,0,1
22308_0,,,,2,2,1,3
C1(CC(CO)C(C1(CO)O)O)=O,,,4,1,1,0,1
22310_0,,,,2,2,1,3
C(CC(C(C=O)=O)CO)(C)=O,,,4,1,1,0,1
22312_0,,,,2,2,1,3
C(C)(C(CO)CC(C=O)=O)=O,,,4,1,1,0,1
22314_0,,,,2,2,1,3
C(CC(CO)CC(C=O)=O)=O,,,4,1,2,0,2
22316_0,,,,2,2,1,3
C(C(CO)CC(C(C)=O)=O)=O,,,4,1,1,0,1
22317_0,,,,2,2,1,3
22319_0,,,,2,2,1,3
C(C(CO)CC(CC=O)=O)=O,,,4,1,1,0,1
22321_0,,,,2,2,1,3
C(C(CO)CC=O)(CC=O)=O,,,4,1,1,0,1
22323_0,,,,2,2,1,3
C(CCCO)(CC(C=O)=O)=O,,,4,1,1,0,1
22325_0,,,,2,2,1,3
C(CC(C(CCCO)=O)=O)=O,,,4,1,1,0,1
22326_0,,,,2,2,1,3
22328_0,,,,2,2,1,3
C1(C(C(C(CO)C1CO)O)O)=O,,,4,1,1,0,1
22330_0,,,,2,2,1,3
C1(C(C(C(C1CCO)O)O)O)=O,,,4,1,1,0,1
22332_0,,,,2,2,1,3
C(C1C(C(C(C1CO)O)O)O)=O,,,4,1,1,0,1
22334_0,,,,2,2,1,3
C(CC(CO)C(C(CO)O)O)(O)=O,,,4,1,1,0,1
22336_0,,,,2,2,1,3
C1(CC(CO)C(C(CO)O)O1)=O,,,4,1,1,0,1
22338_0,,,,2,2,1,3
C1(CC(CO)C(C(CO)O1)O)=O,,,4,1,1,0,1
22340_0,,,,2,2,1,3
C1(C(O)OC(CO)C(CO)C1)=O,,,4,1,1,0,1
22342_0,,,,2,2,1,3
C1(C(CO)OC(C(CO)C1)O)=O,,,4,1,1,0,1
22344_0,,,,2,2,1,3
C1(CC(CO)C(C(CO1)O)O)=O,,,4,1,1,0,1
22346_0,,,,2,2,1,3
C1(C(O)OCC(C(CO)C1)O)=O,,,4,1,1,0,1
22348_0,,,,2,2,1,3
C1(C(C(O)OCC(CO)C1)O)=O,,,4,1,1,0,1
22350_0,,,,2,2,1,3
C1(C(COC(C(CO)C1)O)O)=O,,,4,1,1,0,1
22352_0,,,,2,2,1,3
C1(COC(C(C(CO)C1)O)O)=O,,,4,1,1,0,1
22354_0,,,,2,2,1,3
C(CO)(CC(C(CO)O)CCO)=O,,,4,1,1,0,1
22356_0,,,,2,2,1,3
C(CO)(CC(C(CO)O)C(C)O)=O,,,4,1,1,0,1
22358_0,,,,2,2,1,3
C(C(CO)O)(CC(CO)CCO)=O,,,4,1,1,0,1
22360_0,,,,2,2,1,3
C(C(CO)O)(CC(CO)C(C)O)=O,,,4,1,1,0,1
22362_0,,,,2,2,1,3
C(C(C(CO)O)O)(CCCCO)=O,,,4,1,1,0,1
22364_0,,,,2,2,1,3
C(C(C(CO)O)O)(CCC(C)O)=O,,,4,1,1,0,1
22366_0,,,,2,2,1,3
C(CC(CCO)C(C(CO)O)O)=O,,,4,1,1,0,1
22368_0,,,,2,2,1,3
C(CC(C(C(CO)O)O)C(C)O)=O,,,4,1,1,0,1
22370_0,,,,2,2,1,3
C1(CC(C(C1(CO)O)O)CCO)=O,,,4,1,1,0,1
22372_0,,,,2,2,1,3
C1(CC(C(C1(CO)O)O)C(C)O)=O,,,4,1,1,0,1
22374_0,,,,2,2,1,3
C(CC(C(C=O)=O)CCO)(C)=O,,,4,1,1,0,1
22376_0,,,,2,2,1,3
C(CC(C(C=O)=O)C(C)O)(C)=O,,,4,1,1,0,1
22378_0,,,,2,2,1,3
C(C)(C(CCO)CC(C=O)=O)=O,,,4,1,1,0,1
22380_0,,,,2,2,1,3
C(C)(C(C(C)O)CC(C=O)=O)=O,,,4,1,1,0,1
22382_0,,,,2,2,1,3
C(CC(CCO)CC(C=O)=O)=O,,,4,1,2,0,2
22384_0,,,,2,2,1,3
C(CC(C(C)O)CC(C=O)=O)=O,,,4,1,2,0,2
22386_0,,,,2,2,1,3
C(C(CCO)CC(C(C)=O)=O)=O,,,4,1,1,0,1
22388_0,,,,2,2,1,3
C(C(C(C)O)CC(C(C)=O)=O)=O,,,4,1,1,0,1
22390_0,,,,2,2,1,3
C(CC(C(C(C)=O)=O)CCO)=O,,,4,1,1,0,1
22392_0,,,,2,2,1,3
C(CC(C(C(C)=O)=O)C(C)O)=O,,,4,1,1,0,1
22394_0,,,,2,2,1,3
C(C(CCO)CC(CC=O)=O)=O,,,4,1,1,0,1
22396_0,,,,2,2,1,3
C(C(C(C)O)CC(CC=O)=O)=O,,,4,1,1,0,1
22398_0,,,,2,2,1,3
C(C(CCO)CC=O)(CC=O)=O,,,4,1,1,0,1
22400_0,,,,2,2,1,3
C(C(C(C)O)CC=O)(CC=O)=O,,,4,1,1,0,1
22402_0,,,,2,2,1,3
C(CCCCO)(CC(C=O)=O)=O,,,4,1,1,0,1
22404_0,,,,2,2,1,3
C(CCC(C)O)(CC(C=O)=O)=O,,,4,1,1,0,1
22406_0,,,,2,2,1,3
C(CC(C(CCCCO)=O)=O)=O,,,4,1,1,0,1
22408_0,,,,2,2,1,3
C(CC(C(CCC(C)O)=O)=O)=O,,,4,1,1,0,1
22409_0,,,,2,2,1,3
22410_0,,,,2,2,1,3
22412_0,,,,2,2,1,3
C1(C(C(C(CCO)C1CO)O)O)=O,,,4,1,1,0,1
22414_0,,,,2,2,1,3
C1(C(C(C(C(C)O)C1CO)O)O)=O,,,4,1,1,0,1
22416_0,,,,2,2,1,3
C1(C(C(C(C1CCCO)O)O)O)=O,,,4,1,1,0,1
22418_0,,,,2,2,1,3
C1(C(C(C(C1CC(C)O)O)O)O)=O,,,4,1,1,0,1
22420_0,,,,2,2,1,3
C(C1C(C(C(C1CCO)O)O)O)=O,,,4,1,1,0,1
22422_0,,,,2,2,1,3
C(C1C(C(C(C1C(C)O)O)O)O)=O,,,4,1,1,0,1
22424_0,,,,2,2,1,3
C1(CC(CCO)C(C(CO)O)O1)=O,,,4,1,1,0,1
22426_0,,,,2,2,1,3
C1(CC(C(C(CO)O)O1)C(C)O)=O,,,4,1,1,0,1
22428_0,,,,2,2,1,3
C1(CC(CCO)C(C(CO)O1)O)=O,,,4,1,1,0,1
22430_0,,,,2,2,1,3
C1(CC(C(C(CO)O1)O)C(C)O)=O,,,4,1,1,0,1
22432_0,,,,2,2,1,3
C1(C(O)OC(CO)C(CCO)C1)=O,,,4,1,1,0,1
22434_0,,,,2,2,1,3
C1(C(O)OC(CO)C(C(C)O)C1)=O,,,4,1,1,0,1
22436_0,,,,2,2,1,3
C1(C(CO)OC(C(CCO)C1)O)=O,,,4,1,1,0,1
22438_0,,,,2,2,1,3
C1(C(CO)OC(C(C(C)O)C1)O)=O,,,4,1,1,0,1
22440_0,,,,2,2,1,3
C1(CC(CCO)C(C(CO1)O)O)=O,,,4,1,1,0,1
22442_0,,,,2,2,1,3
C1(CC(C(C(CO1)O)O)C(C)O)=O,,,4,1,1,0,1
22444_0,,,,2,2,1,3
C1(C(O)OCC(C(CCO)C1)O)=O,,,4,1,1,0,1
22446_0,,,,2,2,1,3
C1(C(O)OCC(C(C(C)O)C1)O)=O,,,4,1,1,0,1
22448_0,,,,2,2,1,3
C1(C(C(O)OCC(CCO)C1)O)=O,,,4,1,1,0,1
22450_0,,,,2,2,1,3
C1(C(C(O)OCC(C(C)O)C1)O)=O,,,4,1,1,0,1
22452_0,,,,2,2,1,3
C1(C(COC(C(CCO)C1)O)O)=O,,,4,1,1,0,1
22454_0,,,,2,2,1,3
C1(C(COC(C(C(C)O)C1)O)O)=O,,,4,1,1,0,1
22456_0,,,,2,2,1,3
C1(COC(C(C(CCO)C1)O)O)=O,,,4,1,1,0,1
22458_0,,,,2,2,1,3
C1(COC(C(C(C(C)O)C1)O)O)=O,,,4,1,1,0,1
22460_0,,,,2,2,1,3
C(CC(C(C=O)=O)CC(C)=O)(O)=O,,,4,1,1,0,1
22462_0,,,,2,2,1,3
C(CC(C(C)=O)CC(C=O)=O)(O)=O,,,4,1,1,0,1
22464_0,,,,2,2,1,3
C(CC(CC(O)=O)CC(C=O)=O)=O,,,4,1,2,0,2
22466_0,,,,2,2,1,3
C(C(CC(O)=O)CC(C(C)=O)=O)=O,,,4,1,1,0,1
22468_0,,,,2,2,1,3
C(CC(C(C(C)=O)=O)CC(O)=O)=O,,,4,1,1,0,1
22470_0,,,,2,2,1,3
C(CC(CC(C=O)CC(O)=O)=O)=O,,,4,1,1,0,1
22472_0,,,,2,2,1,3
C(CC(C(CC=O)CC(O)=O)=O)=O,,,4,1,1,0,1
22474_0,,,,2,2,1,3
C(CCCC(O)=O)(CC(C=O)=O)=O,,,4,1,1,0,1
22476_0,,,,2,2,1,3
C(CC(C(CCCC(O)=O)=O)=O)=O,,,4,1,1,0,1
22477_0,,,,2,2,1,3
22478_0,,,,2,2,1,3
22479_0,,,,2,2,1,3
22480_0,,,,2,2,1,3
22481_0,,,,2,2,1,3
22482_0,,,,2,2,1,3
22484_0,,,,2,2,1,3
C(C(C(C(C=O)=O)CC(C)=O)O)=O,,,4,1,1,0,1
22486_0,,,,2,2,1,3
C(C(C(C(C)=O)CC(C=O)=O)O)=O,,,4,1,1,0,1
22488_0,,,,2,2,1,3
C(CC(C(C=O)O)CC(C=O)=O)=O,,,4,1,2,0,2
22490_0,,,,2,2,1,3
C(C(C(C=O)CC(C(C)=O)=O)O)=O,,,4,1,1,0,1
22492_0,,,,2,2,1,3
C(CC(C(C(C)=O)=O)C(C=O)O)=O,,,4,1,1,0,1
22494_0,,,,2,2,1,3
C(CC(CC(C=O)C(C=O)O)=O)=O,,,4,1,1,0,1
22496_0,,,,2,2,1,3
C(CC(C(CC=O)C(C=O)O)=O)=O,,,4,1,1,0,1
22498_0,,,,2,2,1,3
C(CCC(C=O)O)(CC(C=O)=O)=O,,,4,1,1,0,1
22500_0,,,,2,2,1,3
C(CC(C(CCC(C=O)O)=O)=O)=O,,,4,1,1,0,1
22501_0,,,,2,2,1,3
22502_0,,,,2,2,1,3
22504_0,,,,2,2,1,3
C(CO)(CCC(C(CO)=O)O)=O,,,4,1,1,0,1
22505_0,,,,2,2,1,3
22506_0,,,,2,2,1,3
22508_0,,,,2,2,1,3
C(C(C(CCC(C=O)=O)O)O)=O,,,4,1,1,0,1
22510_0,,,,2,2,1,3
C(C(CO)(CCC(CO)=O)O)=O,,,4,1,1,0,1
22512_0,,,,2,2,1,3
C(C(C(CCC(CO)=O)O)O)=O,,,4,1,1,0,1
22513_0,,,,2,2,1,3
22515_0,,,,2,2,1,3
C(C(C(C(C=O)CC=O)O)O)=O,,,4,1,1,0,1
22517_0,,,,2,2,1,3
C(C(CC(C=O)=O)CC(CO)=O)=O,,,4,1,1,0,1
22519_0,,,,2,2,1,3
C(CC(C(CO)=O)CC(C=O)=O)=O,,,4,1,1,0,1
22521_0,,,,2,2,1,3
C(C(CCCC(C=O)=O)=O)=O,,,4,1,1,0,1
22523_0,,,,2,2,1,3
C(CO)(CCCC(C=O)=O)=O,,,4,1,2,0,2
22524_0,,,,2,2,1,3
22526_0,,,,2,2,1,3
C(C)(CC(C(C=O)=O)CC(C=O)=O)=O,,,4,1,1,0,1
22528_0,,,,2,2,1,3
C(C)(C(CC(C=O)=O)CC(C=O)=O)=O,,,4,1,1,0,1
22530_0,,,,2,2,1,3
C(CC(CC(C=O)=O)CC(C=O)=O)=O,,,4,1,2,0,2
22532_0,,,,2,2,1,3
C(C(CC(C(C)=O)=O)CC(C=O)=O)=O,,,4,1,1,0,1
22534_0,,,,2,2,1,3
C(CC(C(C(C)=O)=O)CC(C=O)=O)=O,,,4,1,1,0,1
22536_0,,,,2,2,1,3
C(CC(CC(C=O)CC(C=O)=O)=O)=O,,,4,1,1,0,1
22538_0,,,,2,2,1,3
C(CC(C(CC=O)CC(C=O)=O)=O)=O,,,4,1,1,0,1
22539_0,,,,2,2,1,3
22540_0,,,,2,2,1,3
22541_0,,,,2,2,1,3
22543_0,,,,2,2,1,3
C(C(C(CO)=O)CCC(C=O)=O)=O,,,4,1,1,0,1
22545_0,,,,2,2,1,3
C(CC(C(CCC(C=O)=O)O)=O)=O,,,4,1,1,0,1
22547_0,,,,2,2,1,3
C(C(C(CO)=O)CCC(CO)=O)=O,,,4,1,1,0,1
22548_0,,,,2,2,1,3
22550_0,,,,2,2,1,3
C(C(C(CO)=O)C(C=O)CC=O)=O,,,4,1,1,0,1
22552_0,,,,2,2,1,3
C(CC(C(C(C=O)CC=O)O)=O)=O,,,4,1,1,0,1
22554_0,,,,2,2,1,3
C(C(C(C)=O)(CCC(C=O)=O)O)=O,,,4,1,1,0,1
22556_0,,,,2,2,1,3
C(C(C(CCCC(C=O)=O)=O)O)=O,,,4,1,1,0,1
22558_0,,,,2,2,1,3
C(C)(C(C=O)(CCC(CO)=O)O)=O,,,4,1,1,0,1
22560_0,,,,2,2,1,3
C(CCCC(CO)=O)(C(C=O)O)=O,,,4,1,1,0,1
22562_0,,,,2,2,1,3
C(C(C(C)=O)(C(C=O)CC=O)O)=O,,,4,1,1,0,1
22564_0,,,,2,2,1,3
C(C(C(CC(C=O)CC=O)=O)O)=O,,,4,1,1,0,1
22566_0,,,,2,2,1,3
C(C(CO)O)(CCCC(C=O)=O)=O,,,4,1,1,0,1
22568_0,,,,2,2,1,3
C(C)(C(CO)(CCC(C=O)=O)O)=O,,,4,1,1,0,1
22570_0,,,,2,2,1,3
C(C)(C(C(CCC(C=O)=O)O)O)=O,,,4,1,1,0,1
22572_0,,,,2,2,1,3
C(C(CO)O)(CCCC(CO)=O)=O,,,4,1,1,0,1
22574_0,,,,2,2,1,3
C(C)(C(CO)(CCC(CO)=O)O)=O,,,4,1,1,0,1
22576_0,,,,2,2,1,3
C(C)(C(C(CCC(CO)=O)O)O)=O,,,4,1,1,0,1
22577_0,,,,2,2,1,3
22579_0,,,,2,2,1,3
C(C)(C(CO)(C(C=O)CC=O)O)=O,,,4,1,1,0,1
22581_0,,,,2,2,1,3
C(C)(C(C(C(C=O)CC=O)O)O)=O,,,4,1,1,0,1
22583_0,,,,2,2,1,3
C(C=O)(C(CCC(C=O)=O)CO)=O,,,4,1,1,0,1
22585_0,,,,2,2,1,3
C(C(CCC(CC(C=O)=O)O)=O)=O,,,4,1,1,0,1
22587_0,,,,2,2,1,3
C(CO)(CCC(C(C=O)=O)CO)=O,,,4,1,1,0,1
22589_0,,,,2,2,1,3
C(CO)(CCC(CC(C=O)=O)O)=O,,,4,1,1,0,1
22591_0,,,,2,2,1,3
C(CC(C=O)C(C(C=O)=O)CO)=O,,,4,1,1,0,1
22593_0,,,,2,2,1,3
C(C(C(CC(C=O)=O)O)CC=O)=O,,,4,1,1,0,1
22595_0,,,,2,2,1,3
C(C(CCC(C=O)=O)O)(CCO)=O,,,4,1,1,0,1
22597_0,,,,2,2,1,3
C(CO)(C(CO)CCC(C=O)=O)=O,,,4,1,1,0,1
22599_0,,,,2,2,1,3
C(CO)(CC(CCC(C=O)=O)O)=O,,,4,1,1,0,1
22601_0,,,,2,2,1,3
C(C(CCC(CO)=O)O)(CCO)=O,,,4,1,1,0,1
22603_0,,,,2,2,1,3
C(CO)(C(CO)CCC(CO)=O)=O,,,4,1,1,0,1
22605_0,,,,2,2,1,3
C(CO)(CC(CCC(CO)=O)O)=O,,,4,1,1,0,1
22607_0,,,,2,2,1,3
C(C(C(C=O)CC=O)O)(CCO)=O,,,4,1,1,0,1
22609_0,,,,2,2,1,3
C(CO)(C(CO)C(C=O)CC=O)=O,,,4,1,1,0,1
22611_0,,,,2,2,1,3
C(CO)(CC(C(C=O)CC=O)O)=O,,,4,1,1,0,1
22613_0,,,,2,2,1,3
C(C(C=O)(CCC(C=O)=O)O)=O,,,4,1,1,0,1
22615_0,,,,2,2,1,3
C(C(C=O)(CCC(CO)=O)O)=O,,,4,1,1,0,1
22616_0,,,,2,2,1,3
22618_0,,,,2,2,1,3
C(C(CC(CO)=O)CC(CO)=O)=O,,,4,1,1,0,1
22620_0,,,,2,2,1,3
C(C(CC(CO)=O)C(C(C)=O)O)=O,,,4,1,1,0,1
22621_0,,,,2,2,1,3
22623_0,,,,2,2,1,3
C(CC(C(CO)=O)C(C(C)=O)O)=O,,,4,1,1,0,1
22624_0,,,,2,2,1,3
22626_0,,,,2,2,1,3
C(C)(C(CCC(C=O)=O)O)=O,,,4,1,1,0,1
22628_0,,,,2,2,1,3
C(CO)(CCCC(CO)=O)=O,,,4,1,1,0,1
22630_0,,,,2,2,1,3
C(C)(C(CCC(CO)=O)O)=O,,,4,1,1,0,1
22631_0,,,,2,2,1,3
22632_0,,,,2,2,1,3
22634_0,,,,2,2,1,3
C(C(CCC(C=O)=O)(CC=O)O)=O,,,4,1,1,0,1
22636_0,,,,2,2,1,3
C(C(CCC(C=O)=O)C(C=O)O)=O,,,4,1,1,0,1
22637_0,,,,2,2,1,3
22639_0,,,,2,2,1,3
C(CO)(CCC(C=O)C(C=O)O)=O,,,4,1,1,0,1
22641_0,,,,2,2,1,3
C(CC(C=O)(C(C=O)CC=O)O)=O,,,4,1,1,0,1
22643_0,,,,2,2,1,3
C(CC(C=O)C(C=O)C(C=O)O)=O,,,4,1,1,0,1
22644_0,,,,2,2,1,3
22645_0,,,,2,2,1,3
22646_0,,,,2,2,1,3
22647_0,,,,2,2,1,3
22648_0,,,,2,2,1,3
22649_0,,,,2,2,1,3
22650_0,,,,2,2,1,3
22651_0,,,,2,2,1,3
22652_0,,,,2,2,1,3
22653_0,,,,2,2,1,3
22654_0,,,,2,2,1,3
22655_0,,,,2,2,1,3
22656_0,,,,2,2,1,3
22657_0,,,,2,2,1,3
22658_0,,,,2,2,1,3
22659_0,,,,2,2,1,3
22660_0,,,,2,2,1,3
22661_0,,,,2,2,1,3
22662_0,,,,2,2,1,3
22663_0,,,,2,2,1,3
22664_0,,,,2,2,1,3
22665_0,,,,2,2,1,3
22666_0,,,,2,2,1,3
22667_0,,,,2,2,1,3
22668_0,,,,2,2,1,3
22670_0,,,,2,2,1,3
C(CC1C(C(C(C1CO)=O)O)O)=O,,,4,1,1,0,1
22671_0,,,,2,2,1,3
22672_0,,,,2,2,1,3
22674_0,,,,2,2,1,3
C1(CC(C(C(CO)O)O1)CC=O)=O,,,4,1,1,0,1
22676_0,,,,2,2,1,3
C1(CC(C(C(CO)O1)O)CC=O)=O,,,4,1,1,0,1
22677_0,,,,2,2,1,3
22678_0,,,,2,2,1,3
22680_0,,,,2,2,1,3
C1(CC(C(C(CO1)O)O)CC=O)=O,,,4,1,1,0,1
22681_0,,,,2,2,1,3
22682_0,,,,2,2,1,3
22683_0,,,,2,2,1,3
22684_0,,,,2,2,1,3
22685_0,,,,2,2,1,3
22687_0,,,,2,2,1,3
C(CO)(C(C(CO)O)CC=O)=O,,,4,1,1,0,1
22688_0,,,,2,2,1,3
22690_0,,,,2,2,1,3
C(CO)(CCC(CO)O)=O,,,4,1,1,0,1
22691_0,,,,2,2,1,3
22693_0,,,,2,2,1,3
C(CC(C(C=O)=O)C(CO)O)(C)=O,,,4,1,1,0,1
22695_0,,,,2,2,1,3
C(C)(C(C(CO)O)CC(C=O)=O)=O,,,4,1,1,0,1
22696_0,,,,2,2,1,3
22698_0,,,,2,2,1,3
C(C(C(CO)O)CC(C(C)=O)=O)=O,,,4,1,1,0,1
22700_0,,,,2,2,1,3
C(CC(C(C(C)=O)=O)C(CO)O)=O,,,4,1,1,0,1
22702_0,,,,2,2,1,3
C(C(C(CO)O)CC(CC=O)=O)=O,,,4,1,1,0,1
22704_0,,,,2,2,1,3
C(C(C(CO)O)CC=O)(CC=O)=O,,,4,1,1,0,1
22706_0,,,,2,2,1,3
C(CCC(CO)O)(CC(C=O)=O)=O,,,4,1,1,0,1
22708_0,,,,2,2,1,3
C(CC(C(CCC(CO)O)=O)=O)=O,,,4,1,1,0,1
22709_0,,,,2,2,1,3
22711_0,,,,2,2,1,3
C(C(C(C=O)CC(CO)=O)O)(O)=O,,,4,1,1,0,1
22713_0,,,,2,2,1,3
C(C(C(C(CO)=O)CC=O)O)(O)=O,,,4,1,1,0,1
22714_0,,,,2,2,1,3
22715_0,,,,2,2,1,3
22716_0,,,,2,2,1,3
22718_0,,,,2,2,1,3
C(C(CC(CO)C(CO)O)=O)=O,,,4,1,1,0,1
22719_0,,,,2,2,1,3
22721_0,,,,2,2,1,3
C(C(CC(C(CO)O)C(C)O)=O)=O,,,4,1,1,0,1
22722_0,,,,2,2,1,3
22723_0,,,,2,2,1,3
22724_0,,,,2,2,1,3
22725_0,,,,2,2,1,3
22726_0,,,,2,2,1,3
22727_0,,,,2,2,1,3
22728_0,,,,2,2,1,3
22729_0,,,,2,2,1,3
22730_0,,,,2,2,1,3
22732_0,,,,2,2,1,3
C(C(C(C=O)O)O)(CCCO)=O,,,4,1,1,0,1
22733_0,,,,2,2,1,3
22735_0,,,,2,2,1,3
C(C(C(C=O)O)O)(CCC(C)O)=O,,,4,1,1,0,1
22737_0,,,,2,2,1,3
C(C(C(CO)CC(CO)=O)O)=O,,,4,1,1,0,1
22738_0,,,,2,2,1,3
22740_0,,,,2,2,1,3
C(C(C(C(C)O)CC(CO)=O)O)=O,,,4,1,1,0,1
22742_0,,,,2,2,1,3
C(CC(CO)C(C(C=O)O)O)=O,,,4,1,1,0,1
22743_0,,,,2,2,1,3
22745_0,,,,2,2,1,3
C(CC(C(C(C=O)O)O)C(C)O)=O,,,4,1,1,0,1
22746_0,,,,2,1,1,2
22747_0,,,,2,1,1,2
22748_0,,,,2,1,2,3
22749_0,,,,2,1,2,3
22750_0,,,,2,1,2,3
22751_0,,,,2,1,2,3
22752_0,,,,2,1,2,3
22753_0,,,,2,1,2,3
22754_0,,,,2,1,2,3
22755_0,,,,2,1,2,3
22756_0,,,,2,1,2,3
22757_0,,,,2,1,2,3
22758_0,,,,2,1,2,3
22759_0,,,,2,1,2,3
22760_0,,,,2,1,2,3
22761_0,,,,2,1,2,3
22762_0,,,,2,1,2,3
22763_0,,,,2,1,2,3
22765_0,,,,2,1,1,2
C(C(C(C=C)=O)(CO)O)=O,,,4,1,1,0,1
22767_0,,,,2,1,2,3
C1(C=CC(C1O)=O)=O,,,4,1,1,0,1
22769_0,,,,2,1,1,2
C(C(O)OCC(C=C)=O)=O,,,4,1,1,0,1
22771_0,,,,2,1,1,2
C(C(C(C=C)=O)OCO)=O,,,4,1,1,0,1
22772_0,,,,2,1,2,3
22773_0,,,,2,1,2,3
22774_0,,,,2,1,2,3
22775_0,,,,2,1,2,3
22776_0,,,,2,1,2,3
22778_0,,,,2,1,2,3
C(C(C(CC=CC=O)=O)O)=O,,,4,1,1,0,1
22779_0,,,,2,1,2,3
22781_0,,,,2,1,2,3
C(CC=CC(C(C=O)O)=O)=O,,,4,1,1,0,1
22782_0,,,,2,1,2,3
22783_0,,,,2,1,2,3
22784_0,,,,2,1,2,3
22785_0,,,,2,1,2,3
22786_0,,,,2,1,2,3
22787_0,,,,2,1,2,3
22788_0,,,,2,1,2,3
22789_0,,,,2,1,2,3
22790_0,,,,2,1,2,3
22792_0,,,,2,1,2,3
C(CC=CC=O)=O,,,4,1,1,0,1
22793_0,,,,2,1,2,3
