Id,Label,timeset,gen,type,weighted indegree,weighted outdegree,Weighted Degree
9_0,,,,2,1,2,3
C(CO)=O,,,1,1,461,197,658
C(C(C(CO)O)O)=O,,,1,1,35,71,106
9_1,,,,2,1,2,3
11_0,,,,2,1,1,2
C(CO)(C(C(C(CO)O)O)O)=O,,,1,1,18,32,50
14_0,,,,2,3,2,5
C(C(C(C(C(CO)O)O)O)O)(O)=O,,,1,1,175,15,190
C(C(C(C(C(CO)O)O)O)O)O,,,1,1,140,5,145
14_1,,,,2,3,2,5
17_0,,,,2,1,2,3
CN,,,1,1,84,506,590
C(=O)=O,,,1,1,2077,166,2243
19_0,,,,2,1,2,3
O,,,0,1,2223,538,2761
C(C(CC(C(CO)O)O)=O)=O,,,1,1,24,43,67
21_0,,,,2,1,2,3
C(CC(C(C(CO)O)O)=O)=O,,,1,1,29,49,78
23_0,,,,2,1,2,3
C(C(C(CC(CO)O)=O)O)=O,,,1,1,23,49,72
25_0,,,,2,1,2,3
C(CC(C=O)O)(C(CO)O)=O,,,1,1,32,56,88
27_0,,,,2,1,2,3
C(C(C(C=O)O)O)(CCO)=O,,,1,1,33,61,94
29_0,,,,2,1,2,3
C(C(C(CC(CO)=O)O)O)=O,,,1,1,28,54,82
31_0,,,,2,1,2,3
C(C(C(C(C(C)=O)O)O)O)=O,,,1,1,30,56,86
33_0,,,,2,1,2,3
C(CC(C(C(C=O)O)O)O)=O,,,1,1,32,58,90
35_0,,,,2,1,1,2
C(C(C1C(C(C(O)O1)O)O)O)O,,,1,1,5,7,12
37_0,,,,2,1,1,2
C(C1C(C(C(C(O)O1)O)O)O)O,,,1,1,5,7,12
39_0,,,,2,1,1,2
C1C(C(C(C(C(O)O1)O)O)O)O,,,1,1,7,9,16
42_0,,,,2,2,2,4
C(C(C(C(C(CN)O)O)O)O)O,,,1,1,22,14,36
C(C(O)=O)=O,,,1,1,633,102,735
44_0,,,,2,2,3,5
C=O,,,1,1,570,458,1028
46_0,,,,2,2,2,4
[Fe+3],,,0,1,103,305,408
C(C(CC(C(CO)O)O)O)(O)=O,,,1,1,12,11,23
48_0,,,,2,3,5,8
[H+],,,0,1,214,68,282
[Fe+2],,,0,1,274,72,346
C(C(C(C(C(CO)O)O)O)=O)=O,,,1,1,24,48,72
49_0,,,,2,4,4,8
51_0,,,,2,1,1,2
C1(C(C(C(C1CO)O)O)O)=O,,,2,1,2,39,41
51_1,,,,2,1,1,2
53_0,,,,2,1,1,2
C1(C(C(C(C(C1)O)O)O)O)=O,,,2,1,3,36,39
53_1,,,,2,1,1,2
54_0,,,,2,1,1,2
56_0,,,,2,1,1,2
C(C1C(C(C(C1O)O)O)O)=O,,,2,1,2,26,28
56_1,,,,2,1,1,2
57_0,,,,2,2,1,3
57_1,,,,2,2,1,3
58_0,,,,2,2,1,3
C(C(C(C(C(CO)O)O)O)O)=O,,,0,1,19,330,349
58_1,,,,2,2,1,3
60_0,,,,2,2,1,3
C(C(C=O)O)(O)=O,,,2,1,342,79,421
60_1,,,,2,2,1,3
62_0,,,,2,2,1,3
C(C(C(C=O)O)O)(O)=O,,,2,1,9,65,74
62_1,,,,2,2,1,3
64_0,,,,2,2,1,3
C(C(CO)O)=O,,,2,1,377,141,518
64_1,,,,2,2,1,3
66_0,,,,2,2,1,3
C(C(C(CO)C(C(CO)O)O)=O)=O,,,2,1,4,42,46
66_1,,,,2,2,1,3
68_0,,,,2,2,1,3
C(C(C(C(C(CO)O)O)=O)CO)=O,,,2,1,2,43,45
68_1,,,,2,2,1,3
70_0,,,,2,2,1,3
C(C(C(C(CO)C(CO)O)=O)O)=O,,,2,1,2,44,46
70_1,,,,2,2,1,3
72_0,,,,2,2,1,3
C(C(CO)C(C=O)O)(C(CO)O)=O,,,2,1,2,49,51
72_1,,,,2,2,1,3
74_0,,,,2,2,1,3
C(C(C(C=O)O)O)(C(CO)CO)=O,,,2,1,2,46,48
74_1,,,,2,2,1,3
76_0,,,,2,2,1,3
C(C(C(C(C(CO)=O)CO)O)O)=O,,,2,1,4,48,52
76_1,,,,2,2,1,3
78_0,,,,2,2,1,3
C(C(CO)O)(CC(C(C=O)O)O)=O,,,2,1,3,48,51
78_1,,,,2,2,1,3
80_0,,,,2,2,1,3
C(C(C(C(C=O)O)O)O)(CCO)=O,,,2,1,3,48,51
82_0,,,,2,2,1,3
C(C(CO)C(C(C(C=O)O)O)O)=O,,,2,1,2,52,54
82_1,,,,2,2,1,3
83_0,,,,2,2,1,3
83_1,,,,2,2,1,3
84_0,,,,2,2,1,3
84_1,,,,2,2,1,3
85_0,,,,2,1,2,3
86_0,,,,2,1,2,3
87_0,,,,2,1,2,3
87_1,,,,2,1,2,3
89_0,,,,2,1,2,3
C(CO)(CO)=O,,,2,1,10,123,133
89_1,,,,2,1,2,3
91_0,,,,2,1,2,3
C(C(C)=O)=O,,,2,1,14,187,201
93_0,,,,2,1,2,3
C(CC(CO)=O)=O,,,2,1,12,144,156
93_1,,,,2,1,2,3
95_0,,,,2,1,2,3
C(C(C(C)=O)O)=O,,,2,1,9,140,149
98_0,,,,2,1,2,3
C(C=O)=O,,,2,1,43,103,146
C(C)(C(CO)O)=O,,,2,1,14,106,120
100_0,,,,2,1,2,3
C(C(CC(CO)=O)O)=O,,,2,1,3,84,87
100_1,,,,2,1,2,3
102_0,,,,2,1,2,3
C(C(CCO)=O)=O,,,2,1,16,113,129
102_1,,,,2,1,2,3
104_0,,,,2,1,2,3
C(CO)(CCO)=O,,,2,1,18,114,132
104_1,,,,2,1,2,3
106_0,,,,2,1,2,3
C(C(C(C(C)=O)O)O)=O,,,2,1,5,97,102
107_0,,,,2,1,2,3
107_1,,,,2,1,2,3
110_0,,,,2,1,2,3
C(C(C=O)O)=O,,,2,1,14,126,140
C(C)(CO)=O,,,2,1,31,188,219
111_0,,,,2,1,2,3
111_1,,,,2,1,2,3
112_0,,,,2,1,2,3
112_1,,,,2,1,2,3
114_0,,,,2,1,2,3
C(CC(C=O)O)=O,,,2,1,14,138,152
114_1,,,,2,1,2,3
117_0,,,,2,1,2,3
C(C(C(C=O)O)O)=O,,,2,1,5,67,72
C(C)=O,,,2,1,17,269,286
118_0,,,,2,1,2,3
120_0,,,,2,1,2,3
C(C(CO)=O)=O,,,2,1,16,186,202
120_1,,,,2,1,2,3
121_0,,,,2,1,1,2
123_0,,,,2,1,1,2
C(CO)(C(CO)O)=O,,,2,1,8,96,104
124_0,,,,2,1,1,2
126_0,,,,2,1,1,2
C(C(C(CO)O)O)(C(CO)O)=O,,,2,1,9,37,46
128_0,,,,2,1,1,2
C(CC(C(C(CO)O)=O)O)=O,,,2,1,8,56,64
130_0,,,,2,1,1,2
C(C(CO)=O)(CC(CO)O)=O,,,2,1,4,41,45
132_0,,,,2,1,1,2
C(C(C(CC(CO)O)O)=O)=O,,,2,1,3,42,45
134_0,,,,2,1,1,2
C(C(CO)O)(CC(CO)=O)=O,,,2,1,7,49,56
136_0,,,,2,1,1,2
C(C(CC(C(CO)=O)O)O)=O,,,2,1,5,50,55
138_0,,,,2,1,1,2
C(CCO)(C(C(CO)=O)O)=O,,,2,1,3,48,51
140_0,,,,2,1,1,2
C(C(C(C(CCO)O)=O)O)=O,,,2,1,3,48,51
142_0,,,,2,1,1,2
C(CO)(C(CC(CO)=O)O)=O,,,2,1,7,53,60
144_0,,,,2,1,1,2
C(C(C(CC(C=O)O)O)O)=O,,,2,1,9,56,65
146_0,,,,2,1,1,2
C(C)(C(C(C(CO)=O)O)O)=O,,,2,1,7,59,66
148_0,,,,2,1,1,2
C(C(C(C=O)O)O)(C(C)O)=O,,,2,1,3,60,63
150_0,,,,2,1,1,2
C(CC(C(C(CO)=O)O)O)=O,,,2,1,5,53,58
152_0,,,,2,1,1,2
C(C(C(C(C(CO)O)O)=O)O)=O,,,2,1,2,52,54
154_0,,,,2,2,2,4
C(CNC)=O,,,2,1,7,234,241
156_0,,,,2,2,2,4
C(CNC)(C(CO)O)=O,,,2,1,3,61,64
158_0,,,,2,2,2,4
C(C(C(C(C(CO)O)O)O)NC)=O,,,2,1,6,28,34
160_0,,,,2,2,2,4
C(C(C(CO)O)O)(C(CO)NC)=O,,,2,1,3,30,33
162_0,,,,2,2,2,4
C(CC(C(C(CO)O)=O)NC)=O,,,2,1,5,45,50
164_0,,,,2,2,2,4
C(C(CNC)=O)(CC(CO)O)=O,,,2,1,2,34,36
166_0,,,,2,2,2,4
C(C(C(CC(CO)O)NC)=O)=O,,,2,1,3,37,40
168_0,,,,2,2,2,4
C(C(CO)O)(CC(CNC)=O)=O,,,2,1,2,42,44
170_0,,,,2,2,2,4
C(C(CC(C(CO)=O)NC)O)=O,,,2,1,3,43,46
172_0,,,,2,2,2,4
C(CCO)(C(C(CNC)=O)O)=O,,,2,1,2,40,42
174_0,,,,2,2,2,4
C(C(C(C(CCO)NC)=O)O)=O,,,2,1,3,42,45
176_0,,,,2,2,2,4
C(CC(C(CNC)=O)O)(CO)=O,,,2,1,2,43,45
178_0,,,,2,2,2,4
C(C(CC(C(C=O)O)O)NC)=O,,,2,1,2,49,51
180_0,,,,2,2,2,4
C(C(C(C(CNC)=O)O)O)(C)=O,,,2,1,2,50,52
182_0,,,,2,2,2,4
C(C(C(C=O)O)O)(C(C)NC)=O,,,2,1,3,51,54
184_0,,,,2,2,2,4
C(CC(C(C(CNC)=O)O)O)=O,,,2,1,2,44,46
186_0,,,,2,2,2,4
C(C(C(C(C(CO)O)O)=O)NC)=O,,,2,1,2,40,42
188_0,,,,2,2,2,4
C(CNCC(O)=O)=O,,,2,1,2,159,161
190_0,,,,2,2,2,4
C(CNCC(O)=O)(C(CO)O)=O,,,2,1,2,38,40
192_0,,,,2,2,2,4
C(CNC)(C(C(C(CO)O)O)O)=O,,,2,1,7,26,33
194_0,,,,2,3,2,5
C(CO)O,,,2,1,4,1,5
196_0,,,,2,3,2,5
C(C(C(CO)O)O)O,,,2,1,3,3,6
198_0,,,,2,3,2,5
C(CO)(CC(C(CO)O)O)=O,,,2,1,5,30,35
200_0,,,,2,3,2,5
C(C(C(CO)O)O)(CCO)=O,,,2,1,7,35,42
202_0,,,,2,3,2,5
C(C(CO)O)(CC(CO)O)=O,,,2,1,5,35,40
203_0,,,,2,3,2,5
204_0,,,,2,3,2,5
205_0,,,,2,3,2,5
207_0,,,,2,3,2,5
C(C)(C(C(C(CO)O)O)O)=O,,,2,1,5,33,38
209_0,,,,2,3,2,5
C(CC(C(C(CO)O)O)O)=O,,,2,1,6,30,36
211_0,,,,2,3,2,5
C(C(C(C(CCO)O)O)O)=O,,,2,1,1,34,35
213_0,,,,2,3,2,5
C(CO)(O)=O,,,2,1,16,35,51
215_0,,,,2,3,2,5
CO,,,2,1,3,8,11
216_0,,,,2,3,2,5
217_0,,,,2,3,2,5
219_0,,,,2,3,2,5
C(C(C(CO)O)O)(O)=O,,,2,1,6,23,29
221_0,,,,2,3,2,5
C(C(CC(C(CO)O)O)=O)(O)=O,,,2,1,3,53,56
223_0,,,,2,3,2,5
C(CC(C(C(CO)O)O)=O)(O)=O,,,2,1,3,32,35
225_0,,,,2,3,2,5
C(C(C(CC(CO)O)=O)O)(O)=O,,,2,1,5,30,35
227_0,,,,2,3,2,5
C(CC(C(O)=O)O)(C(CO)O)=O,,,2,1,6,33,39
229_0,,,,2,3,2,5
C(C(C(C(O)=O)O)O)(CCO)=O,,,2,1,8,35,43
231_0,,,,2,3,2,5
C(C(C(CC(CO)=O)O)O)(O)=O,,,2,1,7,28,35
233_0,,,,2,3,2,5
C(C(C(C(C(C)=O)O)O)O)(O)=O,,,2,1,8,32,40
235_0,,,,2,3,2,5
C(CC(C(C(C(O)=O)O)O)O)=O,,,2,1,7,34,41
237_0,,,,2,3,2,5
C(CC(C(C(C=O)O)O)O)(O)=O,,,2,1,1,36,37
239_0,,,,2,3,2,5
C(C(O)=O)(O)=O,,,2,1,1,4,5
241_0,,,,2,3,2,5
C(O)=O,,,2,1,2,0,2
243_0,,,,2,3,2,5
C(C(C(C(C(CO)O)O)O)=O)(O)=O,,,2,1,343,56,399
245_0,,,,2,1,1,2
C1(CC(C(C1(CO)O)O)O)=O,,,2,1,2,29,31
245_1,,,,2,1,1,2
247_0,,,,2,1,1,2
C(C1(C(C(CC1O)O)O)O)=O,,,2,1,4,28,32
247_1,,,,2,1,1,2
249_0,,,,2,2,1,3
C(C(C(CO)O)(C(CO)O)O)=O,,,2,1,2,21,23
249_1,,,,2,2,1,3
251_0,,,,2,2,1,3
C(C(C=O)(C(CO)O)O)(O)=O,,,2,1,4,24,28
251_1,,,,2,2,1,3
253_0,,,,2,2,1,3
C(C(C(CO)O)(C(C(O)=O)O)O)=O,,,2,1,5,30,35
253_1,,,,2,2,1,3
255_0,,,,2,2,1,3
C(C(CO)(C(CO)O)O)=O,,,2,1,4,27,31
255_1,,,,2,2,1,3
257_0,,,,2,2,1,3
C(CC(C(CO)(C(CO)O)O)=O)=O,,,2,1,2,40,42
257_1,,,,2,2,1,3
259_0,,,,2,2,1,3
C(C(C(CC(CO)O)=O)(CO)O)=O,,,2,1,2,37,39
259_1,,,,2,2,1,3
261_0,,,,2,2,1,3
C(CC(C=O)O)(C(CO)(CO)O)=O,,,2,1,2,37,39
261_1,,,,2,2,1,3
263_0,,,,2,2,1,3
C(C(CO)(C(C(CCO)=O)O)O)=O,,,2,1,6,45,51
263_1,,,,2,2,1,3
265_0,,,,2,2,1,3
C(C(CO)(C(C=O)O)O)(CCO)=O,,,2,1,2,45,47
265_1,,,,2,2,1,3
267_0,,,,2,2,1,3
C(C(CO)(C(CC(CO)=O)O)O)=O,,,2,1,4,43,47
267_1,,,,2,2,1,3
269_0,,,,2,2,1,3
C(C(CO)(C(C(C(C)=O)O)O)O)=O,,,2,1,4,45,49
269_1,,,,2,2,1,3
271_0,,,,2,2,1,3
C(C(C(C(C(C)=O)(CO)O)O)O)=O,,,2,1,4,46,50
271_1,,,,2,2,1,3
273_0,,,,2,2,1,3
C(C(CO)(C(C(CC=O)O)O)O)=O,,,2,1,4,45,49
273_1,,,,2,2,1,3
275_0,,,,2,2,1,3
C(C(CO)(CC(C(CO)O)=O)O)=O,,,2,1,2,43,45
277_0,,,,2,2,1,3
C(C(C(CO)O)N)(O)=O,,,2,1,1,699,700
279_0,,,,2,2,1,3
C(C(C(C(C(CO)O)O)O)N)(O)=O,,,2,1,38,688,726
281_0,,,,2,2,1,3
C(C(C(O)=O)N)(O)=O,,,2,1,2,652,654
281_1,,,,2,2,1,3
283_0,,,,2,2,1,3
C(C(C(C(O)=O)N)O)(O)=O,,,2,1,1,698,699
285_0,,,,2,2,1,3
C(C(CO)N)(O)=O,,,2,1,2,738,740
286_0,,,,2,1,2,3
288_0,,,,2,2,2,4
C(CO)(C(C(C(CO)O)O)NC)=O,,,2,1,4,27,31
290_0,,,,2,2,2,4
C(CC(C(C(CO)O)NC)=O)=O,,,2,1,2,41,43
292_0,,,,2,2,2,4
C(C(C(CC(CO)O)=O)NC)=O,,,2,1,4,37,41
294_0,,,,2,2,2,4
C(CC(C=O)O)(C(CO)NC)=O,,,2,1,2,48,50
296_0,,,,2,2,2,4
C(C(C(C=O)O)NC)(CCO)=O,,,2,1,4,48,52
296_1,,,,2,2,2,4
298_0,,,,2,2,2,4
C(C(C(C(C(C)=O)NC)O)O)=O,,,2,1,2,48,50
300_0,,,,2,2,2,4
C(C(C(C(C(CO)O)O)NC)=O)=O,,,2,1,3,40,43
302_0,,,,2,2,3,5
C(C(CC(C(CO)O)O)N)=O,,,2,1,12,28,40
304_0,,,,2,2,3,5
C(C(C(C(C(CO)O)O)O)N)=O,,,2,1,12,33,45
306_0,,,,2,2,3,5
C(CN)(CC(C(CO)O)O)=O,,,2,1,13,30,43
308_0,,,,2,2,3,5
C(CN)(C(C(C(CO)O)O)O)=O,,,2,1,12,32,44
309_0,,,,2,2,1,3
C(CN)(O)=O,,,0,1,47,758,805
310_0,,,,2,1,2,3
311_0,,,,2,1,2,3
312_0,,,,2,1,2,3
313_0,,,,2,1,2,3
314_0,,,,2,1,2,3
315_0,,,,2,1,2,3
316_0,,,,2,1,2,3
317_0,,,,2,1,2,3
318_0,,,,2,1,2,3
319_0,,,,2,1,2,3
320_0,,,,2,1,2,3
321_0,,,,2,1,2,3
322_0,,,,2,1,2,3
323_0,,,,2,1,2,3
324_0,,,,2,1,2,3
325_0,,,,2,1,2,3
326_0,,,,2,1,2,3
327_0,,,,2,1,2,3
328_0,,,,2,1,2,3
329_0,,,,2,1,2,3
330_0,,,,2,1,2,3
331_0,,,,2,1,2,3
332_0,,,,2,1,2,3
334_0,,,,2,1,2,3
C(CCO)(CC(C=O)=O)=O,,,2,1,4,70,74
336_0,,,,2,1,2,3
C(CO)(CCC(C=O)=O)=O,,,2,1,5,70,75
338_0,,,,2,1,2,3
C(C)(C(CC(C=O)=O)O)=O,,,2,1,5,77,82
340_0,,,,2,1,2,3
C(CC(CC(C=O)=O)O)=O,,,2,1,4,72,76
342_0,,,,2,1,2,3
C(CC(C(CCO)=O)=O)=O,,,2,1,4,68,72
344_0,,,,2,1,2,3
C(CC(CC(CO)=O)=O)=O,,,2,1,6,75,81
346_0,,,,2,1,2,3
C(CC(C(C(C)=O)O)=O)=O,,,2,1,2,78,80
348_0,,,,2,1,2,3
C(CC(C(CC=O)O)=O)=O,,,2,1,5,84,89
350_0,,,,2,1,2,3
C(C(C=O)O)(CC(C)=O)=O,,,2,1,3,79,82
352_0,,,,2,1,2,3
C(C(C(CCC=O)=O)O)=O,,,2,1,4,79,83
354_0,,,,2,1,2,3
C(C(CC(C(C)=O)=O)O)=O,,,2,1,4,72,76
356_0,,,,2,1,2,3
C(CC(CC(C=O)O)=O)=O,,,2,1,6,81,87
357_0,,,,2,1,2,3
358_0,,,,2,1,2,3
359_0,,,,2,1,2,3
360_0,,,,2,1,2,3
361_0,,,,2,1,2,3
362_0,,,,2,1,2,3
363_0,,,,2,1,2,3
364_0,,,,2,1,2,3
365_0,,,,2,1,2,3
366_0,,,,2,1,2,3
367_0,,,,2,1,2,3
368_0,,,,2,1,2,3
370_0,,,,2,1,2,3
C1(CC(C(C(CO)O)O1)O)=O,,,2,1,3,12,15
372_0,,,,2,1,2,3
C1(COC(C(CO)O)C1O)=O,,,2,1,1,25,26
374_0,,,,2,1,2,3
C1(C(O)OC(C(CO)O)C1)=O,,,2,1,2,24,26
376_0,,,,2,1,2,3
C1(C(C(CO)O)OC(C1)O)=O,,,2,1,2,29,31
378_0,,,,2,1,2,3
C(C)(C1C(C(C(O1)O)O)O)=O,,,2,1,2,26,28
380_0,,,,2,1,2,3
C(CC1C(C(C(O)O1)O)O)=O,,,2,1,2,25,27
382_0,,,,2,1,2,3
C1(CC(C(C(CO)O1)O)O)=O,,,2,1,2,13,15
384_0,,,,2,1,2,3
C1(COC(CO)C(C1O)O)=O,,,2,1,1,28,29
386_0,,,,2,1,2,3
C1(C(O)OC(CO)C(C1)O)=O,,,2,1,2,25,27
388_0,,,,2,1,2,3
C1(C(C(CO)OC(C1)O)O)=O,,,2,1,2,28,30
390_0,,,,2,1,2,3
C1(C(C(O)OC(CO)C1)O)=O,,,2,1,2,30,32
392_0,,,,2,1,2,3
C1(C(CO)OC(C(C1)O)O)=O,,,2,1,2,28,30
394_0,,,,2,1,2,3
C1(CC(C(C(CO1)O)O)O)=O,,,2,1,1,16,17
396_0,,,,2,1,2,3
C1(COCC(C(C1O)O)O)=O,,,2,1,1,30,31
398_0,,,,2,1,2,3
C1(C(O)OCC(C(C1)O)O)=O,,,2,1,2,27,29
400_0,,,,2,1,2,3
C1(C(C(COC(C1)O)O)O)=O,,,2,1,2,33,35
402_0,,,,2,1,2,3
C1(C(C(O)OCC(C1)O)O)=O,,,2,1,2,33,35
404_0,,,,2,1,2,3
C1(C(COC(C(C1)O)O)O)=O,,,2,1,2,30,32
406_0,,,,2,1,2,3
C1(C(C(C(O)OCC1)O)O)=O,,,2,1,2,32,34
408_0,,,,2,1,2,3
C1(COC(C(C(C1)O)O)O)=O,,,2,1,2,27,29
409_0,,,,2,1,2,3
411_0,,,,2,1,2,3
C(C(C(CO)O)O)(CCN)=O,,,2,1,14,38,52
413_0,,,,2,1,2,3
C(C(CN)O)(CC(CO)O)=O,,,2,1,14,37,51
415_0,,,,2,1,2,3
C(C(CO)O)(CC(CN)O)=O,,,2,1,13,42,55
417_0,,,,2,1,2,3
C(C(C(CN)O)O)(CCO)=O,,,2,1,13,41,54
419_0,,,,2,1,2,3
C(CO)(CC(C(CN)O)O)=O,,,2,1,13,35,48
421_0,,,,2,1,2,3
C(C)(C(C(C(CN)O)O)O)=O,,,2,1,13,39,52
423_0,,,,2,1,2,3
C(CC(C(C(CN)O)O)O)=O,,,2,1,13,34,47
425_0,,,,2,1,2,3
C(CC(C(O)=O)O)(CCO)=O,,,2,1,4,31,35
427_0,,,,2,1,2,3
C(C(CCC(CO)=O)O)(O)=O,,,2,1,4,27,31
429_0,,,,2,1,2,3
C(C(CC(C(C)=O)O)O)(O)=O,,,2,1,4,28,32
431_0,,,,2,1,2,3
C(CC(CC(C(O)=O)O)O)=O,,,2,1,4,30,34
433_0,,,,2,1,2,3
C(C(C(CC(CO)O)=O)=O)=O,,,2,1,3,37,40
435_0,,,,2,1,2,3
C(C(CO)O)(CC(C=O)=O)=O,,,2,1,4,62,66
437_0,,,,2,1,2,3
C(CCO)(C(C(C=O)=O)O)=O,,,2,1,3,61,64
439_0,,,,2,1,2,3
C(CO)(CC(C(C=O)=O)O)=O,,,2,1,4,64,68
441_0,,,,2,1,2,3
C(C)(C(C(C(C=O)=O)O)O)=O,,,2,1,5,69,74
443_0,,,,2,1,2,3
C(CC(C(C(C=O)=O)O)O)=O,,,2,1,3,64,67
445_0,,,,2,1,2,3
C(C(CO)O)=CC(C=O)=O,,,2,1,5,44,49
447_0,,,,2,1,2,3
C(C(C(C=CCO)=O)O)=O,,,2,1,4,62,66
449_0,,,,2,1,2,3
C(C=CC(C(CO)O)=O)=O,,,2,1,4,72,76
451_0,,,,2,1,2,3
C(C(C(C(C=C)=O)O)O)=O,,,2,1,4,85,89
453_0,,,,2,1,2,3
C(C(C=CC(CO)=O)O)=O,,,2,1,4,64,68
455_0,,,,2,1,2,3
C(C(C(C=CC=O)O)O)=O,,,2,1,4,67,71
457_0,,,,2,1,2,3
C(C(C(C(CO)O)O)O)=CN,,,2,1,2,12,14
457_1,,,,2,1,2,3
459_0,,,,2,1,2,3
C(C(C(CO)O)O)=CC(O)=O,,,2,1,1,15,16
461_0,,,,2,1,2,3
C(C(C=CC(CO)O)O)(O)=O,,,2,1,3,12,15
462_0,,,,2,2,1,3
463_0,,,,2,2,1,3
464_0,,,,2,2,1,3
465_0,,,,2,2,1,3
466_0,,,,2,2,1,3
467_0,,,,2,2,1,3
468_0,,,,2,2,1,3
469_0,,,,2,2,1,3
470_0,,,,2,2,1,3
472_0,,,,2,1,2,3
N,,,2,1,38,592,630
474_0,,,,2,2,2,4
C(C(C(CO)NC)O)=O,,,2,1,3,48,51
476_0,,,,2,2,2,4
C(CO)(C(C(C(CO)O)NC)O)=O,,,2,1,2,28,30
478_0,,,,2,2,2,4
C(C(CC(C(CO)O)NC)=O)=O,,,2,1,3,40,43
480_0,,,,2,2,2,4
C(CC(C(C(CO)NC)O)=O)=O,,,2,1,1,43,44
482_0,,,,2,2,2,4
C(C(C(CC(CO)NC)=O)O)=O,,,2,1,3,46,49
484_0,,,,2,2,2,4
C(CC(C=O)NC)(C(CO)O)=O,,,2,1,5,46,51
486_0,,,,2,2,2,4
C(CC(C=O)O)(C(CNC)O)=O,,,2,1,1,50,51
488_0,,,,2,2,2,4
C(C(C(C(CCO)=O)O)NC)=O,,,2,1,5,48,53
490_0,,,,2,2,2,4
C(C(C(C=O)O)O)(CCNC)=O,,,2,1,3,56,59
492_0,,,,2,2,2,4
C(C(C(CC(CO)=O)NC)O)=O,,,2,1,4,45,49
494_0,,,,2,2,2,4
C(C(C(C(C(C)=O)O)NC)O)=O,,,2,1,2,47,49
496_0,,,,2,2,2,4
C(CC(C(C(C=O)O)NC)O)=O,,,2,1,2,51,53
498_0,,,,2,2,2,4
C(CC(C(C(C=O)O)O)NC)=O,,,2,1,3,54,57
500_0,,,,2,2,2,4
C(C(C(C(C(CO)O)NC)O)=O)=O,,,2,1,1,41,42
502_0,,,,2,2,2,4
C(C(C(CO)NCC(O)=O)O)=O,,,2,1,2,43,45
504_0,,,,2,2,2,4
C(C(C(C(C(CO)O)O)NC)O)=O,,,2,1,7,30,37
506_0,,,,2,1,1,2
C1C(C(C(O)O1)O)O,,,2,1,1,5,6
508_0,,,,2,1,1,2
C(C1(C(C(C(CO)O1)O)O)O)O,,,2,1,2,5,7
509_0,,,,2,1,1,2
511_0,,,,2,1,1,2
C(C1(CC(C(CO)O1)O)O)=O,,,2,1,1,19,20
512_0,,,,2,1,1,2
514_0,,,,2,1,1,2
C(CC1(C(C(CO1)O)O)O)=O,,,2,1,1,25,26
516_0,,,,2,1,1,2
C(C(C1(CC(CO1)O)O)O)=O,,,2,1,1,28,29
518_0,,,,2,1,1,2
C(C1C(CC(CO)(O1)O)O)=O,,,2,1,1,25,26
520_0,,,,2,1,1,2
C(C1C(C(C(C)(O1)O)O)O)=O,,,2,1,1,26,27
521_0,,,,2,1,1,2
523_0,,,,2,1,1,2
C(C(C1C(CC(O)O1)O)O)=O,,,2,1,1,26,27
524_0,,,,2,1,1,2
526_0,,,,2,1,1,2
C1(C(O)OC(C(CO)O)C1O)=O,,,2,1,1,25,26
528_0,,,,2,1,1,2
C(C1(C(C(C(CO)O1)O)O)O)=O,,,2,1,1,22,23
530_0,,,,2,1,1,2
C1C(C(C(C(CO)(O)O1)O)O)O,,,2,1,2,7,9
531_0,,,,2,1,1,2
533_0,,,,2,1,1,2
C(C1(CC(C(CO1)O)O)O)=O,,,2,1,1,21,22
534_0,,,,2,1,1,2
535_0,,,,2,1,1,2
536_0,,,,2,1,1,2
538_0,,,,2,1,1,2
C(C1C(C(CC(O1)O)O)O)=O,,,2,1,1,26,27
540_0,,,,2,1,1,2
C1(C(O)OC(CO)C(C1O)O)=O,,,2,1,1,28,29
542_0,,,,2,1,1,2
C(C1(C(C(C(CO1)O)O)O)O)=O,,,2,1,1,24,25
543_0,,,,2,1,1,2
544_0,,,,2,1,1,2
545_0,,,,2,1,1,2
546_0,,,,2,1,1,2
547_0,,,,2,1,1,2
548_0,,,,2,1,1,2
550_0,,,,2,1,1,2
C1(C(O)OCC(C(C1O)O)O)=O,,,2,1,1,30,31
551_0,,,,2,1,1,2
552_0,,,,2,1,1,2
553_0,,,,2,1,1,2
554_0,,,,2,2,2,4
555_0,,,,2,2,2,4
556_0,,,,2,2,2,4
556_1,,,,2,2,2,4
558_0,,,,2,2,2,4
C(CN)O,,,2,1,13,97,110
560_0,,,,2,2,2,4
C(C(C(CN)O)O)O,,,2,1,12,19,31
562_0,,,,2,2,2,4
C(C(C(C(C(CO)N)O)O)O)O,,,2,1,13,15,28
563_0,,,,2,2,2,4
564_0,,,,2,2,2,4
565_0,,,,2,2,2,4
567_0,,,,2,2,2,4
C(CC(C(C(CO)O)O)N)=O,,,2,1,13,33,46
568_0,,,,2,2,2,4
570_0,,,,2,2,2,4
C(C(C(CC(CO)O)N)O)=O,,,2,1,12,34,46
571_0,,,,2,2,2,4
573_0,,,,2,2,2,4
C(C(CC(C(CO)O)N)O)=O,,,2,1,12,34,46
574_0,,,,2,2,2,4
576_0,,,,2,2,2,4
C(C(C(C(CCO)N)O)O)=O,,,2,1,12,39,51
577_0,,,,2,2,2,4
579_0,,,,2,2,2,4
C(C(C(CC(CO)N)O)O)=O,,,2,1,12,39,51
580_0,,,,2,2,2,4
582_0,,,,2,2,2,4
C(C(C(C(C(C)N)O)O)O)=O,,,2,1,12,40,52
583_0,,,,2,2,2,4
585_0,,,,2,2,2,4
C(C(C(C(CCN)O)O)O)=O,,,2,1,12,38,50
586_0,,,,2,2,2,4
587_0,,,,2,2,2,4
588_0,,,,2,2,2,4
589_0,,,,2,1,2,3
591_0,,,,2,1,2,3
C1(C(C(C(C(CO)O)O1)O)O)=O,,,2,1,4,10,14
593_0,,,,2,1,2,3
C1(C(CC(C(CO)O)O1)O)=O,,,2,1,4,10,14
595_0,,,,2,1,2,3
C1(C(C(C(C(CO)O1)O)O)O)=O,,,2,1,3,11,14
597_0,,,,2,1,2,3
C1(C(CC(C(CO)O1)O)O)=O,,,2,1,3,10,13
599_0,,,,2,1,2,3
C1(C(C(C(C(CO1)O)O)O)O)=O,,,2,1,2,14,16
601_0,,,,2,1,2,3
C1(C(CC(C(CO1)O)O)O)=O,,,2,1,2,13,15
602_0,,,,2,2,3,5
603_0,,,,2,2,3,5
604_0,,,,2,2,3,5
605_0,,,,2,2,3,5
606_0,,,,2,2,3,5
607_0,,,,2,2,3,5
608_0,,,,2,2,3,5
609_0,,,,2,2,3,5
610_0,,,,2,2,3,5
611_0,,,,2,2,3,5
612_0,,,,2,2,3,5
613_0,,,,2,2,3,5
614_0,,,,2,2,3,5
615_0,,,,2,2,3,5
616_0,,,,2,2,3,5
617_0,,,,2,2,3,5
618_0,,,,2,2,3,5
619_0,,,,2,2,3,5
620_0,,,,2,3,5,8
621_0,,,,2,3,5,8
622_0,,,,2,5,3,8
624_0,,,,2,2,2,4
C(C(CCO)O)(O)=O,,,2,1,3,16,19
625_0,,,,2,2,2,4
626_0,,,,2,2,2,4
627_0,,,,2,2,2,4
628_0,,,,2,2,2,4
629_0,,,,2,3,5,8
631_0,,,,2,3,5,8
C(C(C(CO)O)=O)=O,,,2,1,6,99,105
632_0,,,,2,3,5,8
633_0,,,,2,3,5,8
634_0,,,,2,3,5,8
635_0,,,,2,3,5,8
636_0,,,,2,3,5,8
638_0,,,,2,5,3,8
C(C(CC(C(CO)O)O)O)=O,,,2,1,3,29,32
640_0,,,,2,5,3,8
C(C(O)O)=O,,,2,1,1,125,126
641_0,,,,2,5,3,8
642_0,,,,2,4,4,8
643_0,,,,2,4,4,8
644_0,,,,2,4,4,8
645_0,,,,2,4,4,8
646_0,,,,2,4,4,8
647_0,,,,2,4,4,8
648_0,,,,2,4,4,8
649_0,,,,2,4,4,8
651_0,,,,2,4,3,7
[CH](C(O)=O)O,,,2,1,1,33,34
653_0,,,,2,1,1,2
C1(C(C(C(C(C1CO)O)O)O)O)=O,,,3,1,6,0,6
653_1,,,,2,1,1,2
654_0,,,,2,1,1,2
654_1,,,,2,1,1,2
656_0,,,,2,1,1,2
C1(C(C(C(C1)O)O)O)=O,,,3,1,8,0,8
656_1,,,,2,1,1,2
657_0,,,,2,1,1,2
659_0,,,,2,1,1,2
C1(C(C(C(CC1O)O)O)O)=O,,,3,1,3,0,3
659_1,,,,2,1,1,2
661_0,,,,2,1,1,2
C1(C(C(C(C1)O)(CO)O)O)=O,,,3,1,2,0,2
661_1,,,,2,1,1,2
663_0,,,,2,1,1,2
C1(C(CC(CO)(C1O)O)O)=O,,,3,1,2,0,2
663_1,,,,2,1,1,2
665_0,,,,2,1,1,2
C1(C(C(C(CO)(C1)O)O)O)=O,,,3,1,1,0,1
667_0,,,,2,1,1,2
C1(C(C(C(C)(C1O)O)O)O)=O,,,3,1,2,0,2
667_1,,,,2,1,1,2
669_0,,,,2,1,1,2
C1(C(C(CC(C1O)O)O)O)=O,,,3,1,2,0,2
669_1,,,,2,1,1,2
671_0,,,,2,1,1,2
C1(C(C(C(CC1NC)O)O)O)=O,,,3,1,3,0,3
671_1,,,,2,1,1,2
673_0,,,,2,1,1,2
C1(C(C(C(C1)O)(CNC)O)O)=O,,,3,1,2,0,2
673_1,,,,2,1,1,2
675_0,,,,2,1,1,2
C1(C(CC(CO)(C1NC)O)O)=O,,,3,1,2,0,2
675_1,,,,2,1,1,2
677_0,,,,2,1,1,2
C1(C(C(C(CNC)(C1)O)O)O)=O,,,3,1,1,0,1
679_0,,,,2,1,1,2
C1(C(C(C(C)(C1NC)O)O)O)=O,,,3,1,2,0,2
679_1,,,,2,1,1,2
681_0,,,,2,1,1,2
C1(C(C(CC(C1NC)O)O)O)=O,,,3,1,2,0,2
681_1,,,,2,1,1,2
683_0,,,,2,1,1,2
C1(C(C(CO)(C(C1CO)O)O)O)=O,,,3,1,2,0,2
683_1,,,,2,1,1,2
685_0,,,,2,1,1,2
C1(C(CO)(C(C(C1CO)O)O)O)=O,,,3,1,8,0,8
685_1,,,,2,1,1,2
687_0,,,,2,1,1,2
C1(C(C(C(C(C1)O)(CO)O)O)O)=O,,,3,1,3,0,3
687_1,,,,2,1,1,2
688_0,,,,2,1,1,2
690_0,,,,2,1,1,2
C1(CC(C(C(C1(CO)O)O)O)O)=O,,,3,1,5,0,5
692_0,,,,2,1,1,2
C(C1C(C(CO)(C(C1O)O)O)O)=O,,,3,1,2,0,2
692_1,,,,2,1,1,2
694_0,,,,2,1,1,2
C1(C(C(C(C1CO)O)O)NC)=O,,,3,1,3,0,3
694_1,,,,2,1,1,2
696_0,,,,2,1,1,2
C1(C(C(C(C(C1)O)O)O)NC)=O,,,3,1,2,0,2
698_0,,,,2,1,1,2
C1(C(CO)C(C(C1)=O)O)=O,,,3,1,3,0,3
698_1,,,,2,1,1,2
700_0,,,,2,1,1,2
C1(CCC(C(C1O)O)=O)=O,,,3,1,3,0,3
700_1,,,,2,1,1,2
702_0,,,,2,1,1,2
C(C1(CCC(C1O)=O)O)=O,,,3,1,3,0,3
702_1,,,,2,1,1,2
704_0,,,,2,1,1,2
C1(CC(C(CC1O)=O)O)=O,,,3,1,2,0,2
706_0,,,,2,1,1,2
C(C1(CC(C(C1)=O)O)O)=O,,,3,1,1,0,1
708_0,,,,2,1,1,2
C(C1C(CC(C1O)=O)O)=O,,,3,1,5,0,5
708_1,,,,2,1,1,2
710_0,,,,2,1,1,2
C1(C(CC(C1CO)O)=O)=O,,,3,1,3,0,3
710_1,,,,2,1,1,2
712_0,,,,2,1,1,2
C1(CC(C(C(C1)=O)O)O)=O,,,3,1,4,0,4
712_1,,,,2,1,1,2
714_0,,,,2,1,1,2
C1(CC(CC(C1O)=O)O)=O,,,3,1,2,0,2
715_0,,,,2,1,1,2
715_1,,,,2,1,1,2
717_0,,,,2,1,1,2
C(C1C(C(CC1O)O)=O)=O,,,3,1,3,0,3
717_1,,,,2,1,1,2
718_0,,,,2,1,1,2
720_0,,,,2,1,1,2
C(C1C(C(C(C1)=O)O)O)=O,,,3,1,3,0,3
722_0,,,,2,1,1,2
C1(C(CC(C(C1)O)O)=O)=O,,,3,1,2,0,2
724_0,,,,2,1,1,2
C(C1C(CC(C1O)O)=O)=O,,,3,1,5,0,5
724_1,,,,2,1,1,2
726_0,,,,2,1,1,2
C1(C(CO)C(C(C1O)=O)O)=O,,,3,1,2,0,2
726_1,,,,2,1,1,2
728_0,,,,2,1,1,2
C1(C(C(C(CC1O)=O)O)O)=O,,,3,1,3,0,3
728_1,,,,2,1,1,2
730_0,,,,2,1,1,2
C(C1(C(CC(C1O)=O)O)O)=O,,,3,1,2,0,2
730_1,,,,2,1,1,2
731_0,,,,2,1,1,2
733_0,,,,2,1,1,2
C(C1(C(C(C(C1)=O)O)O)O)=O,,,3,1,1,0,1
735_0,,,,2,1,1,2
C(C1C(C(C(C1O)=O)O)O)=O,,,3,1,2,0,2
735_1,,,,2,1,1,2
737_0,,,,2,1,1,2
C1C(C(C(C(C=1)=O)O)O)O,,,3,1,3,0,3
737_1,,,,2,1,1,2
739_0,,,,2,1,1,2
C1(C(C(C(C1CO)O)NC)O)=O,,,3,1,3,0,3
739_1,,,,2,1,1,2
741_0,,,,2,1,1,2
C1(C(C(C(C1CNC)O)O)O)=O,,,3,1,3,0,3
741_1,,,,2,1,1,2
743_0,,,,2,1,1,2
C1(C(C(C(C(C1)NC)O)O)O)=O,,,3,1,3,0,3
743_1,,,,2,1,1,2
745_0,,,,2,1,1,2
C1(C(C(C(C(C1)O)O)NC)O)=O,,,3,1,2,0,2
747_0,,,,2,1,1,2
C(C1C(C(C(C1O)O)NC)O)=O,,,3,1,2,0,2
747_1,,,,2,1,1,2
749_0,,,,2,1,1,2
C(C1C(C(C(C1NC)O)O)O)=O,,,3,1,3,0,3
749_1,,,,2,1,1,2
751_0,,,,2,2,1,3
C(C(C(C(C(CO)=O)O)O)O)(O)=O,,,3,1,2,0,2
751_1,,,,2,2,1,3
753_0,,,,2,2,1,3
C(C(C(CC(C=O)=O)O)O)(O)=O,,,3,1,1,0,1
754_0,,,,2,2,1,3
755_0,,,,2,2,1,3
755_1,,,,2,2,1,3
757_0,,,,2,2,1,3
C(CC(C(C(O)=O)O)O)=O,,,3,1,1,0,1
759_0,,,,2,2,1,3
C(C(C(C(C(C=O)=O)O)O)O)(O)=O,,,3,1,2,0,2
759_1,,,,2,2,1,3
761_0,,,,2,2,1,3
C(C(C(C(C(O)=O)O)O)NC)=O,,,3,1,2,0,2
761_1,,,,2,2,1,3
762_0,,,,2,2,1,3
763_0,,,,2,2,1,3
763_1,,,,2,2,1,3
764_0,,,,2,2,1,3
766_0,,,,2,2,1,3
C(C(C(CO)=O)C(C(CO)O)O)=O,,,3,1,2,0,2
766_1,,,,2,2,1,3
768_0,,,,2,2,1,3
C(CC(C(C(C(CO)O)O)O)=O)=O,,,3,1,2,0,2
768_1,,,,2,2,1,3
770_0,,,,2,2,1,3
C(C(C(CC(C(CO)O)O)=O)O)=O,,,3,1,1,0,1
772_0,,,,2,2,1,3
C(C(CO)O)(CC(C(CO)O)O)=O,,,3,1,4,0,4
773_0,,,,2,2,1,3
773_1,,,,2,2,1,3
775_0,,,,2,2,1,3
C(C(C(C(CO)O)O)O)(CCO)=O,,,3,1,4,0,4
775_1,,,,2,2,1,3
777_0,,,,2,2,1,3
C(CO)(C(CO)C(C(CO)O)O)=O,,,3,1,6,0,6
777_1,,,,2,2,1,3
778_0,,,,2,2,1,3
779_0,,,,2,2,1,3
779_1,,,,2,2,1,3
781_0,,,,2,2,1,3
C(C(C(C(CO)O)O)C(C=O)O)=O,,,3,1,2,0,2
781_1,,,,2,2,1,3
783_0,,,,2,2,1,3
C(CC(C(CO)O)O)=O,,,3,1,2,0,2
784_0,,,,2,2,1,3
784_1,,,,2,2,1,3
786_0,,,,2,2,1,3
C(C(C(C(CO)O)O)NC)=O,,,3,1,2,0,2
786_1,,,,2,2,1,3
788_0,,,,2,2,1,3
C(CO)(C(C(CO)(CO)O)O)=O,,,3,1,2,0,2
788_1,,,,2,2,1,3
789_0,,,,2,2,1,3
789_1,,,,2,2,1,3
791_0,,,,2,2,1,3
C(C(C)(C(C(CO)=O)O)O)=O,,,3,1,2,0,2
791_1,,,,2,2,1,3
793_0,,,,2,2,1,3
C(C(CC(CO)(CO)O)=O)=O,,,3,1,1,0,1
795_0,,,,2,2,1,3
C(CO)(CC(C(C(CO)=O)O)O)=O,,,3,1,2,0,2
795_1,,,,2,2,1,3
797_0,,,,2,2,1,3
C(CC(CO)(C(C(CO)=O)O)O)=O,,,3,1,2,0,2
797_1,,,,2,2,1,3
799_0,,,,2,2,1,3
C(C(C(CO)=O)C(CO)(CO)O)=O,,,3,1,2,0,2
799_1,,,,2,2,1,3
801_0,,,,2,2,1,3
C(CC(C(C(CO)(CO)O)O)=O)=O,,,3,1,2,0,2
801_1,,,,2,2,1,3
803_0,,,,2,2,1,3
C(C)(C(C(C(C(CO)=O)O)O)O)=O,,,3,1,2,0,2
803_1,,,,2,2,1,3
805_0,,,,2,2,1,3
C(C(C(C)(C(C(CO)=O)O)O)O)=O,,,3,1,2,0,2
805_1,,,,2,2,1,3
807_0,,,,2,2,1,3
C(C(C(CC(CO)(CO)O)=O)O)=O,,,3,1,1,0,1
809_0,,,,2,2,1,3
C(C(C(C(CO)=O)O)O)=O,,,3,1,4,0,4
809_1,,,,2,2,1,3
811_0,,,,2,2,1,3
C(CO)(C(C(C)(C(CO)O)O)O)=O,,,3,1,2,0,2
811_1,,,,2,2,1,3
813_0,,,,2,2,1,3
C(C(CO)O)(CC(CO)(CO)O)=O,,,3,1,2,0,2
815_0,,,,2,2,1,3
C(C(C(C(CCO)=O)O)O)(CO)=O,,,3,1,6,0,6
815_1,,,,2,2,1,3
817_0,,,,2,2,1,3
C(C(CCO)(C(C(CO)=O)O)O)=O,,,3,1,2,0,2
817_1,,,,2,2,1,3
819_0,,,,2,2,1,3
C(C(C(CO)C(CO)(CO)O)=O)=O,,,3,1,2,0,2
819_1,,,,2,2,1,3
821_0,,,,2,2,1,3
C(CO)(C(C(CO)(CCO)O)O)=O,,,3,1,2,0,2
821_1,,,,2,2,1,3
823_0,,,,2,2,1,3
C(C(C(CO)(CO)O)O)(CCO)=O,,,3,1,3,0,3
823_1,,,,2,2,1,3
825_0,,,,2,2,1,3
C(CO)(C(CO)C(CO)(CO)O)=O,,,3,1,2,0,2
825_1,,,,2,2,1,3
827_0,,,,2,2,1,3
C(C(C(C(C(CO)=O)O)O)O)=O,,,3,1,2,0,2
827_1,,,,2,2,1,3
829_0,,,,2,2,1,3
C(CO)(C(C(CO)(C)O)O)=O,,,3,1,2,0,2
829_1,,,,2,2,1,3
831_0,,,,2,2,1,3
C(CO)(CC(CO)(CO)O)=O,,,3,1,1,0,1
833_0,,,,2,2,1,3
C(C)(C(C(CO)(CO)O)O)=O,,,3,1,2,0,2
833_1,,,,2,2,1,3
835_0,,,,2,2,1,3
C(CC(C(C(C(CO)=O)O)O)O)=O,,,3,1,2,0,2
835_1,,,,2,2,1,3
837_0,,,,2,2,1,3
C(C(CC(C(C(CO)=O)O)O)O)=O,,,3,1,2,0,2
837_1,,,,2,2,1,3
839_0,,,,2,2,1,3
C(C(C(CO)(CO)O)C(C=O)O)=O,,,3,1,2,0,2
839_1,,,,2,2,1,3
841_0,,,,2,2,1,3
C(CO)(C(C(C)O)O)=O,,,3,1,2,0,2
841_1,,,,2,2,1,3
843_0,,,,2,2,1,3
C(CC(CO)(CO)O)=O,,,3,1,1,0,1
845_0,,,,2,2,1,3
C(CO)(C(C(C(CO)=O)O)O)=O,,,3,1,2,0,2
845_1,,,,2,2,1,3
847_0,,,,2,2,1,3
C(C(CO)(C(C(CO)=O)O)O)=O,,,3,1,4,0,4
847_1,,,,2,2,1,3
849_0,,,,2,2,1,3
C(C(C(C(CO)(CO)O)O)=O)=O,,,3,1,2,0,2
849_1,,,,2,2,1,3
851_0,,,,2,2,1,3
C(CO)(C(C(CNC)O)O)=O,,,3,1,2,0,2
851_1,,,,2,2,1,3
853_0,,,,2,2,1,3
C(C(C(CO)(CO)O)NC)=O,,,3,1,2,0,2
853_1,,,,2,2,1,3
855_0,,,,2,2,1,3
C(CO)(C(C(C(O)O)O)O)=O,,,3,1,2,0,2
855_1,,,,2,2,1,3
856_0,,,,2,2,1,3
858_0,,,,2,2,1,3
C(C(C)(CC(C=O)=O)O)=O,,,3,1,1,0,1
860_0,,,,2,2,1,3
C(CO)(CC(CC(C=O)=O)O)=O,,,3,1,1,0,1
862_0,,,,2,2,1,3
C(CC(CO)(CC(C=O)=O)O)=O,,,3,1,1,0,1
864_0,,,,2,2,1,3
C(C(C(CO)=O)C(C(C)=O)O)=O,,,3,1,2,0,2
864_1,,,,2,2,1,3
866_0,,,,2,2,1,3
C(C(C)(C(C=O)C(CO)=O)O)=O,,,3,1,2,0,2
866_1,,,,2,2,1,3
868_0,,,,2,2,1,3
C(CC(C(C(C(C)=O)O)O)=O)=O,,,3,1,2,0,2
868_1,,,,2,2,1,3
870_0,,,,2,2,1,3
C(C(C)(C(C(CC=O)=O)O)O)=O,,,3,1,2,0,2
870_1,,,,2,2,1,3
872_0,,,,2,2,1,3
C(C)(C(C(CC(C=O)=O)O)O)=O,,,3,1,1,0,1
874_0,,,,2,2,1,3
C(C(C(C)(CC(C=O)=O)O)O)=O,,,3,1,1,0,1
876_0,,,,2,2,1,3
C(C(C(CC(C(C)=O)O)=O)O)=O,,,3,1,1,0,1
878_0,,,,2,2,1,3
C(C(C)(CC(C(C=O)O)=O)O)=O,,,3,1,1,0,1
880_0,,,,2,2,1,3
C(C(CC(C=O)=O)O)=O,,,3,1,1,0,1
882_0,,,,2,2,1,3
C(C(CC(C)(C(CO)O)O)=O)=O,,,3,1,1,0,1
884_0,,,,2,2,1,3
C(CC(C(C)=O)O)(C(CO)O)=O,,,3,1,1,0,1
886_0,,,,2,2,1,3
C(C(C)(CC(C(CO)O)=O)O)=O,,,3,1,1,0,1
888_0,,,,2,2,1,3
C(C(CC(C=O)=O)O)(CCO)=O,,,3,1,3,0,3
890_0,,,,2,2,1,3
C(C(CCO)(CC(C=O)=O)O)=O,,,3,1,1,0,1
892_0,,,,2,2,1,3
C(C(C(C(C=O)=O)CO)O)(C)=O,,,3,1,5,0,5
892_1,,,,2,2,1,3
894_0,,,,2,2,1,3
C(C(C)(C(C(C=O)=O)CO)O)=O,,,3,1,2,0,2
894_1,,,,2,2,1,3
896_0,,,,2,2,1,3
C(C(CC(CO)(CCO)O)=O)=O,,,3,1,1,0,1
898_0,,,,2,2,1,3
C(C(C(C(CCO)=O)O)O)(C)=O,,,3,1,4,0,4
898_1,,,,2,2,1,3
900_0,,,,2,2,1,3
C(C(C)(C(C(CCO)=O)O)O)=O,,,3,1,2,0,2
900_1,,,,2,2,1,3
902_0,,,,2,2,1,3
C(CO)(C(CO)C(C(C)=O)O)=O,,,3,1,2,0,2
902_1,,,,2,2,1,3
904_0,,,,2,2,1,3
C(C(C)(C(C(CO)=O)CO)O)=O,,,3,1,2,0,2
904_1,,,,2,2,1,3
906_0,,,,2,2,1,3
C(C(C(CC(C=O)=O)O)O)=O,,,3,1,2,0,2
908_0,,,,2,2,1,3
C(C(CC(C)(CO)O)=O)=O,,,3,1,1,0,1
910_0,,,,2,2,1,3
C(C)(C(CC(CO)=O)O)=O,,,3,1,5,0,5
912_0,,,,2,2,1,3
C(C(C)(CC(CO)=O)O)=O,,,3,1,1,0,1
914_0,,,,2,2,1,3
C(C)(C(C(C(C)=O)O)O)=O,,,3,1,4,0,4
914_1,,,,2,2,1,3
916_0,,,,2,2,1,3
C(C(C)(C(C(C)=O)O)O)=O,,,3,1,2,0,2
916_1,,,,2,2,1,3
918_0,,,,2,2,1,3
C(CC(C(CC(C=O)=O)O)O)=O,,,3,1,1,0,1
920_0,,,,2,2,1,3
C(C(CC(CC(C=O)=O)O)O)=O,,,3,1,1,0,1
922_0,,,,2,2,1,3
C(C(C(C=O)C(C(C)=O)O)O)=O,,,3,1,2,0,2
922_1,,,,2,2,1,3
924_0,,,,2,2,1,3
C(C(C(C=O)C(C=O)(C)O)O)=O,,,3,1,2,0,2
924_1,,,,2,2,1,3
926_0,,,,2,2,1,3
C(C(C(C(CC(C=O)=O)O)O)O)=O,,,3,1,1,0,1
928_0,,,,2,2,1,3
C(C(CC(C)O)=O)=O,,,3,1,1,0,1
930_0,,,,2,2,1,3
C(CC(C(C)=O)O)=O,,,3,1,1,0,1
932_0,,,,2,2,1,3
C(C(C)(CC=O)O)=O,,,3,1,1,0,1
934_0,,,,2,2,1,3
C(CO)(C(CC(C=O)=O)O)=O,,,3,1,3,0,3
936_0,,,,2,2,1,3
C(C(CO)(CC(C=O)=O)O)=O,,,3,1,1,0,1
937_0,,,,2,2,1,3
937_1,,,,2,2,1,3
939_0,,,,2,2,1,3
C(C(C)(C(C(C=O)=O)O)O)=O,,,3,1,2,0,2
939_1,,,,2,2,1,3
941_0,,,,2,2,1,3
C(C(CC(CO)(C(CO)O)O)=O)=O,,,3,1,1,0,1
943_0,,,,2,2,1,3
C(C(C(C(C(CO)O)=O)O)O)(C)=O,,,3,1,6,0,6
943_1,,,,2,2,1,3
945_0,,,,2,2,1,3
C(C(C)(C(C(C(CO)O)=O)O)O)=O,,,3,1,2,0,2
945_1,,,,2,2,1,3
947_0,,,,2,2,1,3
C(C(CC(CNC)O)=O)=O,,,3,1,1,0,1
949_0,,,,2,2,1,3
C(C(C(C(C)=O)O)NC)=O,,,3,1,4,0,4
949_1,,,,2,2,1,3
951_0,,,,2,2,1,3
C(C(C)(C(C=O)NC)O)=O,,,3,1,2,0,2
951_1,,,,2,2,1,3
953_0,,,,2,2,1,3
C(CNCC(CC(C=O)=O)O)(O)=O,,,3,1,1,0,1
955_0,,,,2,2,1,3
C(CNC(C=O)C(C(C)=O)O)(O)=O,,,3,1,3,0,3
955_1,,,,2,2,1,3
957_0,,,,2,2,1,3
C(CNC(C=O)C(C=O)(C)O)(O)=O,,,3,1,2,0,2
957_1,,,,2,2,1,3
959_0,,,,2,2,1,3
C(C(CC(C=O)=O)O)(C(CO)O)=O,,,3,1,1,0,1
961_0,,,,2,2,1,3
C(C(C(CO)O)(CC(C=O)=O)O)=O,,,3,1,1,0,1
963_0,,,,2,2,1,3
C(C(CC(C(O)O)O)=O)=O,,,3,1,1,0,1
965_0,,,,2,2,1,3
C(C(C(CO)=O)C(C=O)O)=O,,,3,1,2,0,2
965_1,,,,2,2,1,3
967_0,,,,2,2,1,3
C(CC(C(C(C=O)O)O)=O)=O,,,3,1,2,0,2
967_1,,,,2,2,1,3
969_0,,,,2,2,1,3
C(C(C(C(C=O)C(CO)=O)O)O)=O,,,3,1,2,0,2
969_1,,,,2,2,1,3
971_0,,,,2,2,1,3
C(CC(C(C(C(C=O)O)O)O)=O)=O,,,3,1,2,0,2
971_1,,,,2,2,1,3
973_0,,,,2,2,1,3
C(C(C(CO)=O)C(CO)(C)O)=O,,,3,1,2,0,2
973_1,,,,2,2,1,3
975_0,,,,2,2,1,3
C(CC(C(C(CO)(C)O)O)=O)=O,,,3,1,2,0,2
975_1,,,,2,2,1,3
977_0,,,,2,2,1,3
C(CO)(CC(CC(CO)=O)O)=O,,,3,1,1,0,1
979_0,,,,2,2,1,3
C(CC(CO)(CC(CO)=O)O)=O,,,3,1,1,0,1
981_0,,,,2,2,1,3
C(C)(C(C(CC(CO)=O)O)O)=O,,,3,1,3,0,3
981_1,,,,2,2,1,3
983_0,,,,2,2,1,3
C(CC(CO)(C(C(C)=O)O)O)=O,,,3,1,2,0,2
983_1,,,,2,2,1,3
985_0,,,,2,2,1,3
C(C(C(CO)=O)C(C)O)=O,,,3,1,2,0,2
985_1,,,,2,2,1,3
987_0,,,,2,2,1,3
C(CC(C(C(C)O)O)=O)=O,,,3,1,2,0,2
987_1,,,,2,2,1,3
989_0,,,,2,2,1,3
C(CC(CC(CO)=O)O)=O,,,3,1,4,0,4
991_0,,,,2,2,1,3
C(CC(CO)(CC=O)O)=O,,,3,1,1,0,1
993_0,,,,2,2,1,3
C(C(C(CO)=O)C(C(CO)=O)O)=O,,,3,1,2,0,2
993_1,,,,2,2,1,3
995_0,,,,2,2,1,3
C(CC(C(C(C(CO)=O)O)O)=O)=O,,,3,1,2,0,2
995_1,,,,2,2,1,3
997_0,,,,2,2,1,3
C(C(CO)(C(C=O)C(CO)=O)O)=O,,,3,1,2,0,2
997_1,,,,2,2,1,3
999_0,,,,2,2,1,3
C(C(CO)(C(C(CC=O)=O)O)O)=O,,,3,1,2,0,2
999_1,,,,2,2,1,3
1001_0,,,,2,2,1,3
C(CO)(CC(C(C(C=O)=O)O)O)=O,,,3,1,2,0,2
1001_1,,,,2,2,1,3
1003_0,,,,2,2,1,3
C(CC(CO)(C(C(C=O)=O)O)O)=O,,,3,1,2,0,2
1003_1,,,,2,2,1,3
1005_0,,,,2,2,1,3
C(C(C(CO)=O)C(CNC)O)=O,,,3,1,2,0,2
1005_1,,,,2,2,1,3
1007_0,,,,2,2,1,3
C(CC(C(C(CNC)O)O)=O)=O,,,3,1,2,0,2
1007_1,,,,2,2,1,3
1009_0,,,,2,2,1,3
C(C(C(CC(CO)=O)O)NC)=O,,,3,1,4,0,4
1009_1,,,,2,2,1,3
1011_0,,,,2,2,1,3
C(CC(CO)(C(C=O)NC)O)=O,,,3,1,2,0,2
1011_1,,,,2,2,1,3
1013_0,,,,2,2,1,3
C(C(C(CO)=O)C(C(O)O)O)=O,,,3,1,2,0,2
1013_1,,,,2,2,1,3
1015_0,,,,2,2,1,3
C(CC(C(C(C(O)O)O)O)=O)=O,,,3,1,2,0,2
1015_1,,,,2,2,1,3
1017_0,,,,2,2,1,3
C(C(C(CC(C=O)O)=O)O)=O,,,3,1,1,0,1
1019_0,,,,2,2,1,3
C(CC(C(C=O)O)O)(C(C=O)O)=O,,,3,1,1,0,1
1021_0,,,,2,2,1,3
C(C(C(CC(CO)(C)O)=O)O)=O,,,3,1,1,0,1
1022_0,,,,2,2,1,3
1024_0,,,,2,2,1,3
C(C(C(C)(CC(CO)=O)O)O)=O,,,3,1,1,0,1
1026_0,,,,2,2,1,3
C(C)(C(C(C(C(C)=O)O)O)O)=O,,,3,1,2,0,2
1026_1,,,,2,2,1,3
1028_0,,,,2,2,1,3
C(C(C(C)(C(C(C)=O)O)O)O)=O,,,3,1,2,0,2
1028_1,,,,2,2,1,3
1030_0,,,,2,2,1,3
C(C(C(CC(C)O)=O)O)=O,,,3,1,1,0,1
1032_0,,,,2,2,1,3
C(CC(C(C(C)=O)O)O)=O,,,3,1,4,0,4
1034_0,,,,2,2,1,3
C(CC(C)(C(C=O)O)O)=O,,,3,1,1,0,1
1036_0,,,,2,2,1,3
C(C(C(CC(C(CO)=O)O)=O)O)=O,,,3,1,1,0,1
1038_0,,,,2,2,1,3
C(C(CO)(CC(C(C=O)O)=O)O)=O,,,3,1,1,0,1
1040_0,,,,2,2,1,3
C(C)(C(C(C(C(C=O)=O)O)O)O)=O,,,3,1,2,0,2
1040_1,,,,2,2,1,3
1042_0,,,,2,2,1,3
C(C(C(C)(C(C(C=O)=O)O)O)O)=O,,,3,1,2,0,2
1042_1,,,,2,2,1,3
1044_0,,,,2,2,1,3
C(C(C(CC(CNC)O)=O)O)=O,,,3,1,1,0,1
1046_0,,,,2,2,1,3
C(C(C(C(C(C)=O)O)O)NC)=O,,,3,1,4,0,4
1046_1,,,,2,2,1,3
1048_0,,,,2,2,1,3
C(C(C(C)(C(C=O)O)O)NC)=O,,,3,1,2,0,2
1048_1,,,,2,2,1,3
1050_0,,,,2,2,1,3
C(C(C(CC(C(O)O)O)=O)O)=O,,,3,1,1,0,1
1051_0,,,,2,2,1,3
1053_0,,,,2,2,1,3
C(C(C(C(CO)=O)C(C=O)O)O)=O,,,3,1,2,0,2
1053_1,,,,2,2,1,3
1055_0,,,,2,2,1,3
C(C(C(C(CC(C=O)O)=O)O)O)=O,,,3,1,3,0,3
1055_1,,,,2,2,1,3
1057_0,,,,2,2,1,3
C(C(C(C(C=O)=O)CO)O)=O,,,3,1,2,0,2
1057_1,,,,2,2,1,3
1058_0,,,,2,2,1,3
1058_1,,,,2,2,1,3
1060_0,,,,2,2,1,3
C(CO)(C(CO)C(C=O)O)=O,,,3,1,8,0,8
1060_1,,,,2,2,1,3
1061_0,,,,2,2,1,3
1062_0,,,,2,2,1,3
1063_0,,,,2,2,1,3
1063_1,,,,2,2,1,3
1065_0,,,,2,2,1,3
C(C(C(C=O)C(C=O)O)O)=O,,,3,1,2,0,2
1065_1,,,,2,2,1,3
1066_0,,,,2,2,1,3
1068_0,,,,2,2,1,3
C(C(C(C(C=O)=O)O)O)=O,,,3,1,2,0,2
1068_1,,,,2,2,1,3
1070_0,,,,2,2,1,3
C(C(C(C=O)O)O)(C(CO)O)=O,,,3,1,6,0,6
1070_1,,,,2,2,1,3
1072_0,,,,2,2,1,3
C(C(C(C=O)O)NC)=O,,,3,1,4,0,4
1072_1,,,,2,2,1,3
1074_0,,,,2,2,1,3
C(C(C(C=O)O)NC)(C(CO)O)=O,,,3,1,3,0,3
1074_1,,,,2,2,1,3
1076_0,,,,2,2,1,3
C(CNC(C=O)C(C=O)O)(O)=O,,,3,1,3,0,3
1076_1,,,,2,2,1,3
1077_0,,,,2,2,1,3
1079_0,,,,2,2,1,3
C(C(CO)O)(CC(CO)(C)O)=O,,,3,1,1,0,1
1081_0,,,,2,2,1,3
C(CO)(CC(C)(C(CO)O)O)=O,,,3,1,1,0,1
1083_0,,,,2,2,1,3
C(C)(C(C(C)(C(CO)O)O)O)=O,,,3,1,2,0,2
1083_1,,,,2,2,1,3
1085_0,,,,2,2,1,3
C(C(CO)O)(CC(C)O)=O,,,3,1,1,0,1
1087_0,,,,2,2,1,3
C(CC(C)(C(CO)O)O)=O,,,3,1,1,0,1
1089_0,,,,2,2,1,3
C(CC(C(CO)=O)O)(C(CO)O)=O,,,3,1,4,0,4
1090_0,,,,2,2,1,3
1092_0,,,,2,2,1,3
C(C(C(C(C)(C(CO)O)O)O)=O)=O,,,3,1,2,0,2
1092_1,,,,2,2,1,3
1094_0,,,,2,2,1,3
C(C(CO)O)(CC(CNC)O)=O,,,3,1,1,0,1
1096_0,,,,2,2,1,3
C(C(C(C)(C(CO)O)O)NC)=O,,,3,1,2,0,2
1096_1,,,,2,2,1,3
1098_0,,,,2,2,1,3
C(C(CO)O)(CC(C(O)O)O)=O,,,3,1,1,0,1
1100_0,,,,2,2,1,3
C(CO)(C(C(C)O)C(C=O)O)=O,,,3,1,2,0,2
1100_1,,,,2,2,1,3
1102_0,,,,2,2,1,3
C(CC(C=O)O)(C(C(C)O)O)=O,,,3,1,2,0,2
1102_1,,,,2,2,1,3
1104_0,,,,2,2,1,3
C(CC(C(CC(CO)=O)O)O)=O,,,3,1,2,0,2
1106_0,,,,2,2,1,3
C(CC(CO)(CC(C=O)O)O)=O,,,3,1,1,0,1
1108_0,,,,2,2,1,3
C(C(C(C(C(C=O)=O)CO)O)O)=O,,,3,1,2,0,2
1108_1,,,,2,2,1,3
1110_0,,,,2,2,1,3
C(C(C(CO)C(C)(CO)O)=O)=O,,,3,1,2,0,2
1110_1,,,,2,2,1,3
1112_0,,,,2,2,1,3
C(CC(C(CCO)=O)O)(CO)=O,,,3,1,1,0,1
1114_0,,,,2,2,1,3
C(C(CCO)(CC(CO)=O)O)=O,,,3,1,1,0,1
1115_0,,,,2,2,1,3
1115_1,,,,2,2,1,3
1117_0,,,,2,2,1,3
C(C(CCO)(C(C(C)=O)O)O)=O,,,3,1,2,0,2
1117_1,,,,2,2,1,3
1119_0,,,,2,2,1,3
C(C(C(CO)C(C)O)=O)=O,,,3,1,2,0,2
1119_1,,,,2,2,1,3
1121_0,,,,2,2,1,3
C(CC(C(CCO)=O)O)=O,,,3,1,4,0,4
1123_0,,,,2,2,1,3
C(C(CCO)(CC=O)O)=O,,,3,1,1,0,1
1125_0,,,,2,2,1,3
C(C(C(C(C=O)=O)CO)O)(CO)=O,,,3,1,2,0,2
1125_1,,,,2,2,1,3
1127_0,,,,2,2,1,3
C(C(CO)(C(C(C=O)=O)CO)O)=O,,,3,1,2,0,2
1127_1,,,,2,2,1,3
1129_0,,,,2,2,1,3
C(C(C(C(C=O)=O)O)O)(CCO)=O,,,3,1,4,0,4
1129_1,,,,2,2,1,3
1131_0,,,,2,2,1,3
C(C(CCO)(C(C(C=O)=O)O)O)=O,,,3,1,2,0,2
1131_1,,,,2,2,1,3
1133_0,,,,2,2,1,3
C(C(C(CO)C(CNC)O)=O)=O,,,3,1,2,0,2
1133_1,,,,2,2,1,3
1134_0,,,,2,2,1,3
1134_1,,,,2,2,1,3
1136_0,,,,2,2,1,3
C(C(CCO)(C(C=O)NC)O)=O,,,3,1,2,0,2
1136_1,,,,2,2,1,3
1138_0,,,,2,2,1,3
C(C(C(CO)C(C(O)O)O)=O)=O,,,3,1,2,0,2
1138_1,,,,2,2,1,3
1139_0,,,,2,2,1,3
1139_1,,,,2,2,1,3
1140_0,,,,2,2,1,3
1140_1,,,,2,2,1,3
1142_0,,,,2,2,1,3
C(C(C(CO)(C)O)O)(CCO)=O,,,3,1,2,0,2
1142_1,,,,2,2,1,3
1144_0,,,,2,2,1,3
C(CO)(C(CO)C(CO)(C)O)=O,,,3,1,2,0,2
1144_1,,,,2,2,1,3
1146_0,,,,2,2,1,3
C(CO)(CC(CO)(CCO)O)=O,,,3,1,1,0,1
1148_0,,,,2,2,1,3
C(C)(C(C(CO)(CCO)O)O)=O,,,3,1,2,0,2
1148_1,,,,2,2,1,3
1150_0,,,,2,2,1,3
C(C(C(C)O)O)(CCO)=O,,,3,1,2,0,2
1150_1,,,,2,2,1,3
1152_0,,,,2,2,1,3
C(CO)(C(CO)C(C)O)=O,,,3,1,2,0,2
1152_1,,,,2,2,1,3
1154_0,,,,2,2,1,3
C(CC(CO)(CCO)O)=O,,,3,1,1,0,1
1155_0,,,,2,2,1,3
1155_1,,,,2,2,1,3
1157_0,,,,2,2,1,3
C(CO)(C(CO)C(C(CO)=O)O)=O,,,3,1,5,0,5
1157_1,,,,2,2,1,3
1158_0,,,,2,2,1,3
1158_1,,,,2,2,1,3
1160_0,,,,2,2,1,3
C(C(CO)(C(C(CO)=O)CO)O)=O,,,3,1,2,0,2
1160_1,,,,2,2,1,3
1162_0,,,,2,2,1,3
C(C(C(C(CO)(CCO)O)O)=O)=O,,,3,1,2,0,2
1162_1,,,,2,2,1,3
1164_0,,,,2,2,1,3
C(C(C(CNC)O)O)(CCO)=O,,,3,1,2,0,2
1164_1,,,,2,2,1,3
1166_0,,,,2,2,1,3
C(CO)(C(CO)C(CNC)O)=O,,,3,1,2,0,2
1166_1,,,,2,2,1,3
1168_0,,,,2,2,1,3
C(C(C(CO)(CCO)O)NC)=O,,,3,1,2,0,2
1168_1,,,,2,2,1,3
1170_0,,,,2,2,1,3
C(C(C(C(O)O)O)O)(CCO)=O,,,3,1,2,0,2
1170_1,,,,2,2,1,3
1172_0,,,,2,2,1,3
C(CO)(C(CO)C(C(O)O)O)=O,,,3,1,2,0,2
1172_1,,,,2,2,1,3
1174_0,,,,2,2,1,3
C(C(C(C=O)O)O)(CC(C)O)=O,,,3,1,1,0,1
1176_0,,,,2,2,1,3
C(CC(C(C(C(C)=O)O)O)O)=O,,,3,1,3,0,3
1178_0,,,,2,2,1,3
C(CC(C)(C(C(C=O)O)O)O)=O,,,3,1,1,0,1
1179_0,,,,2,2,1,3
1180_0,,,,2,2,1,3
1180_1,,,,2,2,1,3
1182_0,,,,2,2,1,3
C(C(C(C(C=O)C(C=O)O)O)O)=O,,,3,1,2,0,2
1182_1,,,,2,2,1,3
1184_0,,,,2,2,1,3
C(CC(C(C=O)O)O)=O,,,3,1,1,0,1
1186_0,,,,2,2,1,3
C(C(C(C(C(C=O)=O)O)O)O)=O,,,3,1,2,0,2
1186_1,,,,2,2,1,3
1188_0,,,,2,2,1,3
C(C(C(C(C=O)O)O)NC)=O,,,3,1,2,0,2
1188_1,,,,2,2,1,3
1190_0,,,,2,2,1,3
C(CO)(CC(CO)(C)O)=O,,,3,1,1,0,1
1192_0,,,,2,2,1,3
C(C)(C(C(CO)(C)O)O)=O,,,3,1,2,0,2
1192_1,,,,2,2,1,3
1193_0,,,,2,2,1,3
1194_0,,,,2,2,1,3
1194_1,,,,2,2,1,3
1196_0,,,,2,2,1,3
C(C(CC(CC(CO)=O)O)O)=O,,,3,1,1,0,1
1198_0,,,,2,2,1,3
C(C(CC(C(C(C)=O)O)O)O)=O,,,3,1,2,0,2
1198_1,,,,2,2,1,3
1200_0,,,,2,2,1,3
C(C(C(CO)(C)O)C(C=O)O)=O,,,3,1,2,0,2
1200_1,,,,2,2,1,3
1202_0,,,,2,2,1,3
C(C(C(C(CC(CO)=O)O)O)O)=O,,,3,1,3,0,3
1204_0,,,,2,2,1,3
C(C(C(C(C(C(C)=O)O)O)O)O)=O,,,3,1,4,0,4
1204_1,,,,2,2,1,3
1206_0,,,,2,2,1,3
C(CO)(CC(C)O)=O,,,3,1,1,0,1
1208_0,,,,2,2,1,3
C(C)(C(C(C)O)O)=O,,,3,1,2,0,2
1208_1,,,,2,2,1,3
1210_0,,,,2,2,1,3
C(CC(C)(CO)O)=O,,,3,1,1,0,1
1211_0,,,,2,2,1,3
1212_0,,,,2,2,1,3
1212_1,,,,2,2,1,3
1214_0,,,,2,2,1,3
C(C(CO)(CC(CO)=O)O)=O,,,3,1,4,0,4
1216_0,,,,2,2,1,3
C(C(CO)(C(C(C)=O)O)O)=O,,,3,1,7,0,7
1216_1,,,,2,2,1,3
1218_0,,,,2,2,1,3
C(C(C(C(CO)(C)O)O)=O)=O,,,3,1,2,0,2
1218_1,,,,2,2,1,3
1220_0,,,,2,2,1,3
C(CO)(CC(CO)(C(CO)O)O)=O,,,3,1,1,0,1
1222_0,,,,2,2,1,3
C(C)(C(C(CO)(C(CO)O)O)O)=O,,,3,1,2,0,2
1222_1,,,,2,2,1,3
1224_0,,,,2,2,1,3
C(C(C(CO)(C)O)O)(C(CO)O)=O,,,3,1,2,0,2
1224_1,,,,2,2,1,3
1226_0,,,,2,2,1,3
C(CO)(CC(CNC)O)=O,,,3,1,1,0,1
1228_0,,,,2,2,1,3
C(C)(C(C(CNC)O)O)=O,,,3,1,2,0,2
1228_1,,,,2,2,1,3
1230_0,,,,2,2,1,3
C(C(C(C)(CO)O)NC)=O,,,3,1,2,0,2
1230_1,,,,2,2,1,3
1232_0,,,,2,2,1,3
C(CNCC(CC(CO)=O)O)(O)=O,,,3,1,1,0,1
1234_0,,,,2,2,1,3
C(C)(C(C(CNCC(O)=O)O)O)=O,,,3,1,2,0,2
1234_1,,,,2,2,1,3
1236_0,,,,2,2,1,3
C(C(C(C)(CO)O)NCC(O)=O)=O,,,3,1,2,0,2
1236_1,,,,2,2,1,3
1238_0,,,,2,2,1,3
C(CC(C(C(CO)O)=O)O)(CO)=O,,,3,1,3,0,3
1239_0,,,,2,2,1,3
1239_1,,,,2,2,1,3
1241_0,,,,2,2,1,3
C(C(C(CO)O)(CC(CO)=O)O)=O,,,3,1,2,0,2
1243_0,,,,2,2,1,3
C(C(C(CO)O)(C(C(C)=O)O)O)=O,,,3,1,6,0,6
1243_1,,,,2,2,1,3
1245_0,,,,2,2,1,3
C(CO)(CC(C(O)O)O)=O,,,3,1,1,0,1
1247_0,,,,2,2,1,3
C(C)(C(C(C(O)O)O)O)=O,,,3,1,2,0,2
1247_1,,,,2,2,1,3
1249_0,,,,2,2,1,3
C(C(C(C)O)C(C=O)O)=O,,,3,1,2,0,2
1249_1,,,,2,2,1,3
1251_0,,,,2,2,1,3
C(CC(C(CC=O)O)O)=O,,,3,1,2,0,2
1253_0,,,,2,2,1,3
C(CC(CC(C=O)O)O)=O,,,3,1,3,0,3
1255_0,,,,2,2,1,3
C(C(C(C=O)C(C(CO)=O)O)O)=O,,,3,1,2,0,2
1255_1,,,,2,2,1,3
1257_0,,,,2,2,1,3
C(C(C(C=O)C(C=O)(CO)O)O)=O,,,3,1,2,0,2
1257_1,,,,2,2,1,3
1259_0,,,,2,2,1,3
C(CC(C(C(C(C=O)=O)O)O)O)=O,,,3,1,2,0,2
1259_1,,,,2,2,1,3
1261_0,,,,2,2,1,3
C(C(CC(C(C(C=O)=O)O)O)O)=O,,,3,1,2,0,2
1261_1,,,,2,2,1,3
1263_0,,,,2,2,1,3
C(C(C(CNC)O)C(C=O)O)=O,,,3,1,2,0,2
1263_1,,,,2,2,1,3
1265_0,,,,2,2,1,3
C(CC(C(C(C=O)NC)O)O)=O,,,3,1,4,0,4
1265_1,,,,2,2,1,3
1267_0,,,,2,2,1,3
C(C(C(CC(C=O)O)O)NC)=O,,,3,1,3,0,3
1267_1,,,,2,2,1,3
1269_0,,,,2,2,1,3
C(C(C(C(O)O)O)C(C=O)O)=O,,,3,1,2,0,2
1269_1,,,,2,2,1,3
1270_0,,,,2,2,1,3
1272_0,,,,2,2,1,3
C(C(C(C(C(C=O)O)O)O)NC)=O,,,3,1,2,0,2
1272_1,,,,2,2,1,3
1274_0,,,,2,2,1,3
C(CC(C)O)=O,,,3,1,1,0,1
1276_0,,,,2,2,1,3
C(CC(C(CO)=O)O)=O,,,3,1,3,0,3
1278_0,,,,2,2,1,3
C(C(CO)(CC=O)O)=O,,,3,1,3,0,3
1280_0,,,,2,2,1,3
C(C(C(C(C)O)O)=O)=O,,,3,1,2,0,2
1280_1,,,,2,2,1,3
1282_0,,,,2,2,1,3
C(CC(CO)(C(CO)O)O)=O,,,3,1,1,0,1
1284_0,,,,2,2,1,3
C(C(C(C)O)O)(C(CO)O)=O,,,3,1,2,0,2
1284_1,,,,2,2,1,3
1286_0,,,,2,2,1,3
C(CC(CNC)O)=O,,,3,1,1,0,1
1288_0,,,,2,2,1,3
C(C(C(C)O)NC)=O,,,3,1,2,0,2
1288_1,,,,2,2,1,3
1290_0,,,,2,2,1,3
C(CC(CNC)(C(CO)O)O)=O,,,3,1,1,0,1
1292_0,,,,2,2,1,3
C(C(CO)O)(C(C(C)O)NC)=O,,,3,1,2,0,2
1292_1,,,,2,2,1,3
1294_0,,,,2,2,1,3
C(CC(CNCC(O)=O)O)=O,,,3,1,1,0,1
1296_0,,,,2,2,1,3
C(C(C(C)O)NCC(O)=O)=O,,,3,1,2,0,2
1296_1,,,,2,2,1,3
1298_0,,,,2,2,1,3
C(CC(C(CO)(C(CO)O)O)O)=O,,,3,1,1,0,1
1300_0,,,,2,2,1,3
C(CC(C(CC(CCO)=O)=O)O)=O,,,3,1,1,0,1
1302_0,,,,2,2,1,3
C(CC(C=O)(CC=O)O)(CCO)=O,,,3,1,1,0,1
1304_0,,,,2,2,1,3
C(CC(CCO)(CC(C=O)=O)O)=O,,,3,1,1,0,1
1306_0,,,,2,2,1,3
C(CCO)(C(C(C=O)=O)C(C)O)=O,,,3,1,2,0,2
1306_1,,,,2,2,1,3
1308_0,,,,2,2,1,3
C(C(CO)C(C)O)(CC(C=O)=O)=O,,,3,1,2,0,2
1308_1,,,,2,2,1,3
1310_0,,,,2,2,1,3
C(CC(C(CCC(CO)=O)=O)O)=O,,,3,1,1,0,1
1312_0,,,,2,2,1,3
C(CO)(CCC(C=O)(CC=O)O)=O,,,3,1,1,0,1
1314_0,,,,2,2,1,3
C(CC(CCC(C=O)=O)(CO)O)=O,,,3,1,1,0,1
1316_0,,,,2,2,1,3
C(CC(C(C=O)=O)C(C)O)(CO)=O,,,3,1,1,0,1
1318_0,,,,2,2,1,3
C(CO)(C(C(C)O)CC(C=O)=O)=O,,,3,1,1,0,1
1320_0,,,,2,2,1,3
C(CCC(C=O)=O)(C(C(C)O)O)=O,,,3,1,2,0,2
1320_1,,,,2,2,1,3
1322_0,,,,2,2,1,3
C(CC(C(CC(C(C)=O)O)=O)O)=O,,,3,1,1,0,1
1324_0,,,,2,2,1,3
C(C)(C(CC(C=O)(CC=O)O)O)=O,,,3,1,1,0,1
1326_0,,,,2,2,1,3
C(CC(C)(C(CC(C=O)=O)O)O)=O,,,3,1,1,0,1
1328_0,,,,2,2,1,3
C(C(C(C(C=O)=O)C(C)O)O)(C)=O,,,3,1,2,0,2
1328_1,,,,2,2,1,3
1330_0,,,,2,2,1,3
C(C(CC(C=O)=O)O)(CC(C)O)=O,,,3,1,1,0,1
1332_0,,,,2,2,1,3
C(CC(C(CC(CC=O)O)=O)O)=O,,,3,1,2,0,2
1334_0,,,,2,2,1,3
C(CC(CC(C=O)(CC=O)O)O)=O,,,3,1,1,0,1
1336_0,,,,2,2,1,3
C(CC(CC(CC(C=O)=O)O)O)=O,,,3,1,1,0,1
1338_0,,,,2,2,1,3
C(CC(C(C(C=O)=O)C(C)O)O)=O,,,3,1,2,0,2
1338_1,,,,2,2,1,3
1340_0,,,,2,2,1,3
C(C(C(CC(C=O)=O)O)C(C)O)=O,,,3,1,2,0,2
1340_1,,,,2,2,1,3
1342_0,,,,2,2,1,3
C(CC(CC(C(CCO)=O)=O)O)=O,,,3,1,1,0,1
1344_0,,,,2,2,1,3
C(CC(C(CCO)=O)(CC=O)O)=O,,,3,1,1,0,1
1346_0,,,,2,2,1,3
C(C(CCO)(CC=O)O)(CC=O)=O,,,3,1,1,0,1
1348_0,,,,2,2,1,3
C(C(C(C(CCO)=O)=O)C(C)O)=O,,,3,1,2,0,2
1348_1,,,,2,2,1,3
1350_0,,,,2,2,1,3
C(CC(C(C(CO)C(C)O)=O)=O)=O,,,3,1,2,0,2
1350_1,,,,2,2,1,3
1352_0,,,,2,2,1,3
C(CC(CC(CC(CO)=O)=O)O)=O,,,3,1,1,0,1
1354_0,,,,2,2,1,3
C(CC(CC=O)(CC(CO)=O)O)=O,,,3,1,1,0,1
1356_0,,,,2,2,1,3
C(CC(CC(CO)(CC=O)O)=O)=O,,,3,1,1,0,1
1358_0,,,,2,2,1,3
C(C(C(CC(CO)=O)=O)C(C)O)=O,,,3,1,2,0,2
1358_1,,,,2,2,1,3
1360_0,,,,2,2,1,3
C(CC=O)(C(C(CO)=O)C(C)O)=O,,,3,1,2,0,2
1360_1,,,,2,2,1,3
1362_0,,,,2,2,1,3
C(CC(CC(C(C(C)O)O)=O)=O)=O,,,3,1,2,0,2
1362_1,,,,2,2,1,3
1364_0,,,,2,2,1,3
C(CC(CC(C(C(C)=O)O)=O)O)=O,,,3,1,1,0,1
1366_0,,,,2,2,1,3
C(CC(C(C(C)=O)O)(CC=O)O)=O,,,3,1,1,0,1
1368_0,,,,2,2,1,3
C(CC(C)(C(C(CC=O)=O)O)O)=O,,,3,1,1,0,1
1370_0,,,,2,2,1,3
C(C(C(C(C(C)=O)O)=O)C(C)O)=O,,,3,1,2,0,2
1370_1,,,,2,2,1,3
1372_0,,,,2,2,1,3
C(CC(C(C(CC(C)O)=O)O)=O)=O,,,3,1,1,0,1
1373_0,,,,2,2,1,3
1375_0,,,,2,2,1,3
C(CC(C(CC=O)O)(CC=O)O)=O,,,3,1,1,0,1
1377_0,,,,2,2,1,3
C(CC(CC(C(CC=O)=O)O)O)=O,,,3,1,1,0,1
1379_0,,,,2,2,1,3
C(CC(C(C(C=O)C(C)O)=O)O)=O,,,3,1,2,0,2
1379_1,,,,2,2,1,3
1381_0,,,,2,2,1,3
C(C(C(C)O)C(C(CC=O)=O)O)=O,,,3,1,2,0,2
1381_1,,,,2,2,1,3
1383_0,,,,2,2,1,3
C(CC(C(C(CC(C)=O)=O)O)O)=O,,,3,1,1,0,1
1385_0,,,,2,2,1,3
C(CC(C(C=O)O)(CC(C)=O)O)=O,,,3,1,1,0,1
1387_0,,,,2,2,1,3
C(C(C(CC(C)(CC=O)O)=O)O)=O,,,3,1,1,0,1
1389_0,,,,2,2,1,3
C(C(C=O)O)(C(C(C)=O)C(C)O)=O,,,3,1,2,0,2
1389_1,,,,2,2,1,3
1391_0,,,,2,2,1,3
C(C(C=O)O)(CC(CC(C)O)=O)=O,,,3,1,1,0,1
1393_0,,,,2,2,1,3
C(CC(C(C(CCC=O)=O)O)O)=O,,,3,1,1,0,1
1395_0,,,,2,2,1,3
C(CCC(C(C=O)O)(CC=O)O)=O,,,3,1,1,0,1
1397_0,,,,2,2,1,3
C(C(C(CCC(CC=O)O)=O)O)=O,,,3,1,1,0,1
1399_0,,,,2,2,1,3
C(C(C(C)O)CC=O)(C(C=O)O)=O,,,3,1,1,0,1
1401_0,,,,2,2,1,3
C(C(C(C)O)CC(C(C=O)O)=O)=O,,,3,1,1,0,1
1403_0,,,,2,2,1,3
C(CC(C(CC(C(C)=O)=O)O)O)=O,,,3,1,1,0,1
1405_0,,,,2,2,1,3
C(C)(C(CC(C=O)O)(CC=O)O)=O,,,3,1,1,0,1
1407_0,,,,2,2,1,3
C(CC(C=O)O)(C(C)(CC=O)O)=O,,,3,1,1,0,1
1409_0,,,,2,2,1,3
C(C(C(C(C(C)=O)=O)C(C)O)O)=O,,,3,1,2,0,2
1409_1,,,,2,2,1,3
1411_0,,,,2,2,1,3
C(C(CC(C(CC(C)O)=O)=O)O)=O,,,3,1,1,0,1
1413_0,,,,2,2,1,3
C(CC(CC(C(CC=O)O)O)=O)=O,,,3,1,1,0,1
1415_0,,,,2,2,1,3
C(CC(CC(C=O)O)(CC=O)O)=O,,,3,1,1,0,1
1417_0,,,,2,2,1,3
C(CC(C=O)O)(CC(CC=O)O)=O,,,3,1,1,0,1
1419_0,,,,2,2,1,3
C(C(C(C)O)C(C=O)O)(CC=O)=O,,,3,1,2,0,2
1419_1,,,,2,2,1,3
1421_0,,,,2,2,1,3
C(CC(C=O)O)(C(C=O)C(C)O)=O,,,3,1,2,0,2
1421_1,,,,2,2,1,3
1423_0,,,,2,2,1,3
C(CC(C(C=CC(CO)O)=O)O)=O,,,3,1,1,0,1
1425_0,,,,2,2,1,3
C(C(C=CC(CO)O)(CC=O)O)=O,,,3,1,1,0,1
1427_0,,,,2,2,1,3
C(CC(C(C(C=CCO)=O)O)O)=O,,,3,1,1,0,1
1429_0,,,,2,2,1,3
C(CC(C=CCO)(C(C=O)O)O)=O,,,3,1,1,0,1
1431_0,,,,2,2,1,3
C(CC(C=CC(C(CO)O)=O)O)=O,,,3,1,1,0,1
1433_0,,,,2,2,1,3
C(CC(C=CC=O)(C(CO)O)O)=O,,,3,1,1,0,1
1435_0,,,,2,2,1,3
C(CC(C(C(C(C=C)=O)O)O)O)=O,,,3,1,1,0,1
1437_0,,,,2,2,1,3
C(C(C(C(C=C)(CC=O)O)O)O)=O,,,3,1,1,0,1
1439_0,,,,2,2,1,3
C(CC(C(C=CC(CO)=O)O)O)=O,,,3,1,1,0,1
1441_0,,,,2,2,1,3
C(C(C=CC(CO)(CC=O)O)O)=O,,,3,1,1,0,1
1443_0,,,,2,2,1,3
C(C(C=CC(C(C(C)O)O)=O)O)=O,,,3,1,2,0,2
1443_1,,,,2,2,1,3
1445_0,,,,2,2,1,3
C(CC(C(C(C=CC=O)O)O)O)=O,,,3,1,1,0,1
1447_0,,,,2,2,1,3
C(C(C(C=CC(CC=O)O)O)O)=O,,,3,1,1,0,1
1449_0,,,,2,2,1,3
C(CC(C(C(CO)NC)O)O)=O,,,3,1,1,0,1
1450_0,,,,2,2,1,3
1452_0,,,,2,2,1,3
C(C(C(CO)O)(CC=O)O)=O,,,3,1,3,0,3
1454_0,,,,2,2,1,3
C(CC(C(O)O)O)=O,,,3,1,1,0,1
1456_0,,,,2,2,1,3
C(CO)(C(C(C(C=O)=O)O)O)=O,,,3,1,2,0,2
1456_1,,,,2,2,1,3
1458_0,,,,2,2,1,3
C(C(CO)(C(C(C=O)=O)O)O)=O,,,3,1,2,0,2
1458_1,,,,2,2,1,3
1460_0,,,,2,2,1,3
C(C(C(C(CNC)O)O)=O)=O,,,3,1,2,0,2
1460_1,,,,2,2,1,3
1462_0,,,,2,2,1,3
C(C(C(C(CO)=O)O)NC)=O,,,3,1,2,0,2
1462_1,,,,2,2,1,3
1464_0,,,,2,2,1,3
C(C(CO)(C(C=O)NC)O)=O,,,3,1,2,0,2
1464_1,,,,2,2,1,3
1466_0,,,,2,2,1,3
C(C(C(C(C(O)O)O)O)=O)=O,,,3,1,2,0,2
1466_1,,,,2,2,1,3
1468_0,,,,2,2,1,3
C(C(CO)O)(C(C(CNC)O)O)=O,,,3,1,3,0,3
1468_1,,,,2,2,1,3
1470_0,,,,2,2,1,3
C(C(C(CO)(C(CO)O)O)NC)=O,,,3,1,2,0,2
1470_1,,,,2,2,1,3
1472_0,,,,2,2,1,3
C(C(C(C(O)O)O)O)(C(CO)O)=O,,,3,1,2,0,2
1472_1,,,,2,2,1,3
1474_0,,,,2,2,1,3
C(C(C(CNC)O)NC)=O,,,3,1,2,0,2
1474_1,,,,2,2,1,3
1476_0,,,,2,2,1,3
C(C(C(CNCC(O)=O)O)NC)=O,,,3,1,2,0,2
1476_1,,,,2,2,1,3
1478_0,,,,2,2,1,3
C(C(C(CNC)O)NCC(O)=O)=O,,,3,1,2,0,2
1478_1,,,,2,2,1,3
1480_0,,,,2,2,1,3
C(C(C(C(C(CO)O)=O)O)NC)=O,,,3,1,3,0,3
1480_1,,,,2,2,1,3
1482_0,,,,2,2,1,3
C(C(C(CO)O)(C(C=O)NC)O)=O,,,3,1,2,0,2
1482_1,,,,2,2,1,3
1484_0,,,,2,2,1,3
C(C(C(C(O)O)O)NC)=O,,,3,1,2,0,2
1484_1,,,,2,2,1,3
1486_0,,,,2,2,1,3
C(C(C(C(O)O)O)NCC(O)=O)=O,,,3,1,2,0,2
1486_1,,,,2,2,1,3
1488_0,,,,2,2,1,3
C(C(C(C(C=O)O)O)O)(O)=O,,,3,1,3,0,3
1488_1,,,,2,2,1,3
1490_0,,,,2,2,1,3
C(C(C(C(C(C=O)O)O)O)O)(O)=O,,,3,1,3,0,3
1490_1,,,,2,2,1,3
1492_0,,,,2,2,1,3
C(C(C(C(CO)O)O)O)=O,,,3,1,337,0,337
1492_1,,,,2,2,1,3
1494_0,,,,2,2,1,3
C(C(C(CO)(CO)O)O)=O,,,3,1,2,0,2
1494_1,,,,2,2,1,3
1496_0,,,,2,2,1,3
C(CO)(C(C(CO)O)O)=O,,,3,1,4,0,4
1496_1,,,,2,2,1,3
1497_0,,,,2,2,1,3
1497_1,,,,2,2,1,3
1499_0,,,,2,2,1,3
C(C(C)(C(C=O)O)O)=O,,,3,1,2,0,2
1499_1,,,,2,2,1,3
1501_0,,,,2,2,1,3
C(C(CC(CO)O)=O)=O,,,3,1,2,0,2
1502_0,,,,2,2,1,3
1502_1,,,,2,2,1,3
1504_0,,,,2,2,1,3
C(CC(CO)(C(C=O)O)O)=O,,,3,1,2,0,2
1504_1,,,,2,2,1,3
1506_0,,,,2,2,1,3
C(C(C(CO)=O)C(CO)O)=O,,,3,1,3,0,3
1506_1,,,,2,2,1,3
1507_0,,,,2,2,1,3
1507_1,,,,2,2,1,3
1508_0,,,,2,2,1,3
1508_1,,,,2,2,1,3
1510_0,,,,2,2,1,3
C(C(C(C)(C(C=O)O)O)O)=O,,,3,1,2,0,2
1510_1,,,,2,2,1,3
1511_0,,,,2,2,1,3
1512_0,,,,2,2,1,3
1512_1,,,,2,2,1,3
1514_0,,,,2,2,1,3
C(C(C(C)(C(CO)O)O)O)=O,,,3,1,2,0,2
1514_1,,,,2,2,1,3
1515_0,,,,2,2,1,3
1516_0,,,,2,2,1,3
1516_1,,,,2,2,1,3
1518_0,,,,2,2,1,3
C(C(CC(CO)(C(C=O)O)O)O)=O,,,3,1,2,0,2
1518_1,,,,2,2,1,3
1520_0,,,,2,2,1,3
C(CO)(C(C(CO)O)C(C=O)O)=O,,,3,1,2,0,2
1520_1,,,,2,2,1,3
1522_0,,,,2,2,1,3
C(CC(C=O)O)(C(C(CO)O)O)=O,,,3,1,2,0,2
1522_1,,,,2,2,1,3
1523_0,,,,2,2,1,3
1523_1,,,,2,2,1,3
1525_0,,,,2,2,1,3
C(C(CCO)(C(C=O)O)O)=O,,,3,1,2,0,2
1525_1,,,,2,2,1,3
1527_0,,,,2,2,1,3
C(C(C(CO)C(CO)O)=O)=O,,,3,1,2,0,2
1527_1,,,,2,2,1,3
1529_0,,,,2,2,1,3
C(C(C(CO)(CCO)O)O)=O,,,3,1,2,0,2
1529_1,,,,2,2,1,3
1530_0,,,,2,2,1,3
1530_1,,,,2,2,1,3
1532_0,,,,2,2,1,3
C(CO)(C(CO)C(CO)O)=O,,,3,1,2,0,2
1532_1,,,,2,2,1,3
1533_0,,,,2,2,1,3
1533_1,,,,2,2,1,3
1535_0,,,,2,2,1,3
C(C(C(C(C)(C(C=O)O)O)O)O)=O,,,3,1,2,0,2
1535_1,,,,2,2,1,3
1537_0,,,,2,2,1,3
C(C(C(C=O)O)O)(CC(CO)O)=O,,,3,1,1,0,1
1539_0,,,,2,2,1,3
C(C(C(C(C=O)O)O)O)=O,,,3,1,2,0,2
1539_1,,,,2,2,1,3
1541_0,,,,2,2,1,3
C(C(C(CO)(C)O)O)=O,,,3,1,2,0,2
1541_1,,,,2,2,1,3
1543_0,,,,2,2,1,3
C(CO)(CC(CO)O)=O,,,3,1,6,0,6
1545_0,,,,2,2,1,3
C(C)(C(C(CO)O)O)=O,,,3,1,6,0,6
1545_1,,,,2,2,1,3
1546_0,,,,2,2,1,3
1546_1,,,,2,2,1,3
1547_0,,,,2,2,1,3
1547_1,,,,2,2,1,3
1549_0,,,,2,2,1,3
C(C(C(CO)O)C(C=O)O)=O,,,3,1,2,0,2
1549_1,,,,2,2,1,3
1551_0,,,,2,2,1,3
C(C(C(C(C(C=O)O)O)O)O)=O,,,3,1,2,0,2
1551_1,,,,2,2,1,3
1553_0,,,,2,2,1,3
C(C(C(C)O)O)=O,,,3,1,2,0,2
1553_1,,,,2,2,1,3
1555_0,,,,2,2,1,3
C(CC(CO)O)=O,,,3,1,4,0,4
1556_0,,,,2,2,1,3
1556_1,,,,2,2,1,3
1558_0,,,,2,2,1,3
C(C(CO)(C(C=O)O)O)=O,,,3,1,7,0,7
1558_1,,,,2,2,1,3
1560_0,,,,2,2,1,3
C(C(C(C(CO)O)O)=O)=O,,,3,1,2,0,2
1560_1,,,,2,2,1,3
1562_0,,,,2,2,1,3
C(C(C(CO)(C(CO)O)O)O)=O,,,3,1,2,0,2
1562_1,,,,2,2,1,3
1563_0,,,,2,2,1,3
1563_1,,,,2,2,1,3
1565_0,,,,2,2,1,3
C(C(C(CNC)O)O)=O,,,3,1,2,0,2
1565_1,,,,2,2,1,3
1567_0,,,,2,2,1,3
C(C(C(CO)O)NC)=O,,,3,1,4,0,4
1567_1,,,,2,2,1,3
1569_0,,,,2,2,1,3
C(C(C(CNC)(C(CO)O)O)O)=O,,,3,1,2,0,2
1569_1,,,,2,2,1,3
1571_0,,,,2,2,1,3
C(C(CO)O)(C(C(CO)O)NC)=O,,,3,1,7,0,7
1571_1,,,,2,2,1,3
1573_0,,,,2,2,1,3
C(C(C(CNCC(O)=O)O)O)=O,,,3,1,2,0,2
1573_1,,,,2,2,1,3
1575_0,,,,2,2,1,3
C(C(C(CO)O)NCC(O)=O)=O,,,3,1,3,0,3
1575_1,,,,2,2,1,3
1577_0,,,,2,2,1,3
C(C(C(C(C(CO)NC)O)O)O)=O,,,3,1,5,0,5
1577_1,,,,2,2,1,3
1578_0,,,,2,2,1,3
1578_1,,,,2,2,1,3
1580_0,,,,2,2,1,3
C(C(C(CO)O)(C(C=O)O)O)=O,,,3,1,6,0,6
1580_1,,,,2,2,1,3
1582_0,,,,2,2,1,3
C(C(C(C(O)O)O)O)=O,,,3,1,2,0,2
1582_1,,,,2,2,1,3
1584_0,,,,2,2,1,3
C(C(CC(C(C(CO)O)O)O)=O)=O,,,3,1,1,0,1
1586_0,,,,2,2,1,3
C(CO)(CC(C(C(CO)O)O)O)=O,,,3,1,1,0,1
1588_0,,,,2,2,1,3
C(C)(C(C(C(C(CO)O)O)O)O)=O,,,3,1,2,0,2
1588_1,,,,2,2,1,3
1589_0,,,,2,2,1,3
1590_0,,,,2,2,1,3
1590_1,,,,2,2,1,3
1592_0,,,,2,2,1,3
C(C(C(CO)=O)O)(O)=O,,,3,1,3,0,3
1592_1,,,,2,2,1,3
1594_0,,,,2,2,1,3
C(CC(C=O)=O)(O)=O,,,3,1,2,0,2
1596_0,,,,2,2,1,3
C(C(C=O)C(CO)=O)(O)=O,,,3,1,3,0,3
1596_1,,,,2,2,1,3
1598_0,,,,2,2,1,3
C(C(C(CC=O)=O)O)(O)=O,,,3,1,2,0,2
1598_1,,,,2,2,1,3
1600_0,,,,2,2,1,3
C(CC(C(C=O)O)=O)(O)=O,,,3,1,1,0,1
1602_0,,,,2,2,1,3
C(CC(C(CO)O)=O)(O)=O,,,3,1,1,0,1
1604_0,,,,2,2,1,3
C(C(C(CO)=O)C(C=O)O)(O)=O,,,3,1,2,0,2
1604_1,,,,2,2,1,3
1606_0,,,,2,2,1,3
C(C(C(CC(C=O)O)=O)O)(O)=O,,,3,1,2,0,2
1606_1,,,,2,2,1,3
1608_0,,,,2,2,1,3
C(C(C(C=O)=O)CO)(O)=O,,,3,1,2,0,2
1608_1,,,,2,2,1,3
1610_0,,,,2,2,1,3
C(C(C(CCO)=O)O)(O)=O,,,3,1,2,0,2
1610_1,,,,2,2,1,3
1612_0,,,,2,2,1,3
C(C(C(CO)=O)CO)(O)=O,,,3,1,2,0,2
1612_1,,,,2,2,1,3
1614_0,,,,2,2,1,3
C(CC(C(C(C=O)O)O)=O)(O)=O,,,3,1,1,0,1
1616_0,,,,2,2,1,3
C(CC(CO)=O)(O)=O,,,3,1,6,0,6
1618_0,,,,2,2,1,3
C(C(C(C)=O)O)(O)=O,,,3,1,6,0,6
1618_1,,,,2,2,1,3
1620_0,,,,2,2,1,3
C(C(C=O)C(C=O)O)(O)=O,,,3,1,2,0,2
1620_1,,,,2,2,1,3
1622_0,,,,2,2,1,3
C(CC(O)=O)=O,,,3,1,2,0,2
1624_0,,,,2,2,1,3
C(C(C(C=O)=O)O)(O)=O,,,3,1,3,0,3
1624_1,,,,2,2,1,3
1626_0,,,,2,2,1,3
C(C(C(C(CO)O)=O)O)(O)=O,,,3,1,2,0,2
1626_1,,,,2,2,1,3
1628_0,,,,2,2,1,3
C(C(C(O)=O)NC)=O,,,3,1,3,0,3
1628_1,,,,2,2,1,3
1628_2,,,,2,2,1,3
1630_0,,,,2,2,1,3
C(C(C(C(CO)O)=O)NC)(O)=O,,,3,1,3,0,3
1630_1,,,,2,2,1,3
1630_2,,,,2,2,1,3
1632_0,,,,2,2,1,3
C(C(C(O)=O)NCC(O)=O)=O,,,3,1,3,0,3
1632_1,,,,2,2,1,3
1632_2,,,,2,2,1,3
1634_0,,,,2,2,1,3
C(C(C(CCO)=O)C(C=O)=O)(O)=O,,,3,1,2,0,2
1634_1,,,,2,2,1,3
1636_0,,,,2,2,1,3
C(C(C(CC(C=O)=O)=O)CO)(O)=O,,,3,1,2,0,2
1636_1,,,,2,2,1,3
1638_0,,,,2,2,1,3
C(C(C(C=O)=O)CC(CO)=O)(O)=O,,,3,1,1,0,1
1640_0,,,,2,2,1,3
C(C(C(CO)=O)CC(C=O)=O)(O)=O,,,3,1,1,0,1
1642_0,,,,2,2,1,3
C(C(C(CCC(C=O)=O)=O)O)(O)=O,,,3,1,2,0,2
1642_1,,,,2,2,1,3
1644_0,,,,2,2,1,3
C(C(C(C=O)=O)C(C(C)=O)O)(O)=O,,,3,1,2,0,2
1644_1,,,,2,2,1,3
1646_0,,,,2,2,1,3
C(CC(C(CC(C=O)=O)O)=O)(O)=O,,,3,1,1,0,1
1648_0,,,,2,2,1,3
C(C(C(C=O)=O)C(CC=O)O)(O)=O,,,3,1,2,0,2
1648_1,,,,2,2,1,3
1650_0,,,,2,2,1,3
C(C(C=O)C(CC(C=O)=O)O)(O)=O,,,3,1,2,0,2
1650_1,,,,2,2,1,3
1652_0,,,,2,2,1,3
C(C(C=O)C(C(CCO)=O)=O)(O)=O,,,3,1,2,0,2
1652_1,,,,2,2,1,3
1654_0,,,,2,2,1,3
C(C(C(C(CC=O)=O)=O)CO)(O)=O,,,3,1,2,0,2
1654_1,,,,2,2,1,3
1656_0,,,,2,2,1,3
C(C(C=O)C(CC(CO)=O)=O)(O)=O,,,3,1,2,0,2
1656_1,,,,2,2,1,3
1658_0,,,,2,2,1,3
C(C(C(CC=O)=O)C(CO)=O)(O)=O,,,3,1,2,0,2
1658_1,,,,2,2,1,3
1660_0,,,,2,2,1,3
C(C(C(CC(CC=O)=O)=O)O)(O)=O,,,3,1,2,0,2
1660_1,,,,2,2,1,3
1662_0,,,,2,2,1,3
C(C(C=O)C(C(C(C)=O)O)=O)(O)=O,,,3,1,2,0,2
1662_1,,,,2,2,1,3
1664_0,,,,2,2,1,3
C(CC(C(C(CC=O)=O)O)=O)(O)=O,,,3,1,1,0,1
1666_0,,,,2,2,1,3
C(C(C=O)C(C(CC=O)O)=O)(O)=O,,,3,1,2,0,2
1666_1,,,,2,2,1,3
1668_0,,,,2,2,1,3
C(C(C=O)C(C(CC=O)=O)O)(O)=O,,,3,1,2,0,2
1668_1,,,,2,2,1,3
1670_0,,,,2,2,1,3
C(C(C(C(C=O)O)=O)C(C)=O)(O)=O,,,3,1,2,0,2
1670_1,,,,2,2,1,3
1672_0,,,,2,2,1,3
C(CC(CC(C(C=O)O)=O)=O)(O)=O,,,3,1,1,0,1
1674_0,,,,2,2,1,3
C(C(C(C(C=O)O)=O)CC=O)(O)=O,,,3,1,1,0,1
1676_0,,,,2,2,1,3
C(C(C=O)CC(C(C=O)O)=O)(O)=O,,,3,1,1,0,1
1678_0,,,,2,2,1,3
C(C(C(C(C)=O)=O)C(C=O)O)(O)=O,,,3,1,2,0,2
1678_1,,,,2,2,1,3
1680_0,,,,2,2,1,3
C(CC(C(CC(C=O)O)=O)=O)(O)=O,,,3,1,1,0,1
1682_0,,,,2,2,1,3
C(C(C(CC=O)=O)C(C=O)O)(O)=O,,,3,1,2,0,2
1682_1,,,,2,2,1,3
1684_0,,,,2,2,1,3
C(C(C=O)C(CC(C=O)O)=O)(O)=O,,,3,1,2,0,2
1684_1,,,,2,2,1,3
1686_0,,,,2,2,1,3
C(C(C(C=CC(C=O)O)=O)O)(O)=O,,,3,1,2,0,2
1686_1,,,,2,2,1,3
1688_0,,,,2,2,1,3
C(C(C(C(CO)=O)O)O)(O)=O,,,3,1,3,0,3
1688_1,,,,2,2,1,3
1690_0,,,,2,2,1,3
C(C(CC(C=O)=O)O)(O)=O,,,3,1,1,0,1
1692_0,,,,2,2,1,3
C(C(C(CO)=O)C(C(O)=O)O)=O,,,3,1,3,0,3
1692_1,,,,2,2,1,3
1694_0,,,,2,2,1,3
C(CC(C(C(C(O)=O)O)O)=O)=O,,,3,1,2,0,2
1694_1,,,,2,2,1,3
1696_0,,,,2,2,1,3
C(C(C(CC(C(O)=O)O)=O)O)=O,,,3,1,1,0,1
1697_0,,,,2,2,1,3
1699_0,,,,2,2,1,3
C(C(C(C(C=O)=O)CO)O)(O)=O,,,3,1,2,0,2
1699_1,,,,2,2,1,3
1700_0,,,,2,2,1,3
1700_1,,,,2,2,1,3
1702_0,,,,2,2,1,3
C(CO)(C(CO)C(C(O)=O)O)=O,,,3,1,2,0,2
1702_1,,,,2,2,1,3
1704_0,,,,2,2,1,3
C(C(CC(CO)=O)O)(O)=O,,,3,1,5,0,5
1706_0,,,,2,2,1,3
C(C(C(C(C)=O)O)O)(O)=O,,,3,1,6,0,6
1706_1,,,,2,2,1,3
1708_0,,,,2,2,1,3
C(C(C(C=O)C(C=O)O)O)(O)=O,,,3,1,2,0,2
1708_1,,,,2,2,1,3
1710_0,,,,2,2,1,3
C(C(CC=O)O)(O)=O,,,3,1,6,0,6
1712_0,,,,2,2,1,3
C(C(C(C(C=O)=O)O)O)(O)=O,,,3,1,2,0,2
1712_1,,,,2,2,1,3
1714_0,,,,2,2,1,3
C(C(C(C(O)=O)O)O)(C(CO)O)=O,,,3,1,3,0,3
1714_1,,,,2,2,1,3
1716_0,,,,2,2,1,3
C(C(C(C(O)=O)O)NC)=O,,,3,1,3,0,3
1716_1,,,,2,2,1,3
1718_0,,,,2,2,1,3
C(C(C(C=O)NCC(O)=O)O)(O)=O,,,3,1,3,0,3
1718_1,,,,2,2,1,3
1719_0,,,,2,2,1,3
1719_1,,,,2,2,1,3
1720_0,,,,2,2,1,3
1720_1,,,,2,2,1,3
1721_0,,,,2,2,1,3
1723_0,,,,2,2,1,3
C(C(C(CO)=O)CO)=O,,,3,1,7,0,7
1723_1,,,,2,2,1,3
1725_0,,,,2,2,1,3
C(CC(C(CO)O)=O)=O,,,3,1,7,0,7
1725_1,,,,2,2,1,3
1727_0,,,,2,2,1,3
C(C(C(CCO)=O)O)=O,,,3,1,5,0,5
1729_0,,,,2,2,1,3
C(C(CO)O)(CCO)=O,,,3,1,8,0,8
1730_0,,,,2,2,1,3
1730_1,,,,2,2,1,3
1731_0,,,,2,2,1,3
1731_1,,,,2,2,1,3
1733_0,,,,2,2,1,3
C(C(C(CO)CO)=O)=O,,,3,1,4,0,4
1733_1,,,,2,2,1,3
1734_0,,,,2,2,1,3
1734_1,,,,2,2,1,3
1736_0,,,,2,2,1,3
C(CO)(C(CO)CO)=O,,,3,1,4,0,4
1736_1,,,,2,2,1,3
1737_0,,,,2,2,1,3
1738_0,,,,2,2,1,3
1739_0,,,,2,2,1,3
1739_1,,,,2,2,1,3
1741_0,,,,2,2,1,3
C(C(CO)C(C=O)O)=O,,,3,1,4,0,4
1741_1,,,,2,2,1,3
1743_0,,,,2,2,1,3
C(CCO)=O,,,3,1,3,0,3
1744_0,,,,2,2,1,3
1744_1,,,,2,2,1,3
1746_0,,,,2,2,1,3
C(C(CO)O)(C(CO)O)=O,,,3,1,2,0,2
1746_1,,,,2,2,1,3
1748_0,,,,2,2,1,3
C(C(CO)C(C(C(CO)O)=O)O)=O,,,3,1,3,0,3
1748_1,,,,2,2,1,3
1750_0,,,,2,2,1,3
C(C(C(CO)O)=O)(CC(CO)O)=O,,,3,1,2,0,2
1750_1,,,,2,2,1,3
1752_0,,,,2,2,1,3
C(C(CO)=O)(C(CO)C(CO)O)=O,,,3,1,3,0,3
1752_1,,,,2,2,1,3
1754_0,,,,2,2,1,3
C(C(CO)O)(CC(C(CO)O)=O)=O,,,3,1,2,0,2
1754_1,,,,2,2,1,3
1756_0,,,,2,2,1,3
C(C(CO)O)(C(C(CO)=O)CO)=O,,,3,1,3,0,3
1756_1,,,,2,2,1,3
1758_0,,,,2,2,1,3
C(C(CC(C(C(CO)O)=O)O)O)=O,,,3,1,2,0,2
1758_1,,,,2,2,1,3
1760_0,,,,2,2,1,3
C(CCO)(C(C(C(CO)O)=O)O)=O,,,3,1,2,0,2
1760_1,,,,2,2,1,3
1762_0,,,,2,2,1,3
C(C(CO)CO)(C(C(CO)=O)O)=O,,,3,1,3,0,3
1762_1,,,,2,2,1,3
1763_0,,,,2,2,1,3
1763_1,,,,2,2,1,3
1764_0,,,,2,2,1,3
1764_1,,,,2,2,1,3
1765_0,,,,2,2,1,3
1765_1,,,,2,2,1,3
1766_0,,,,2,2,1,3
1766_1,,,,2,2,1,3
1767_0,,,,2,2,1,3
1769_0,,,,2,2,1,3
C(CC(C(C(C(CO)O)=O)O)O)=O,,,3,1,2,0,2
1769_1,,,,2,2,1,3
1771_0,,,,2,2,1,3
C(C(CO)C(C(C(CO)=O)O)O)=O,,,3,1,3,0,3
1771_1,,,,2,2,1,3
1773_0,,,,2,2,1,3
C(C(CO)NC)=O,,,3,1,3,0,3
1773_1,,,,2,2,1,3
1775_0,,,,2,2,1,3
C(C(CO)O)(C(CO)NC)=O,,,3,1,2,0,2
1775_1,,,,2,2,1,3
1777_0,,,,2,2,1,3
C(C(CO)NCC(O)=O)=O,,,3,1,3,0,3
1777_1,,,,2,2,1,3
1778_0,,,,2,2,1,3
1778_1,,,,2,2,1,3
1779_0,,,,2,2,1,3
1779_1,,,,2,2,1,3
1781_0,,,,2,2,1,3
C(C(C(CO)O)O)(C(CO)CO)=O,,,3,1,4,0,4
1781_1,,,,2,2,1,3
1783_0,,,,2,2,1,3
C(C(CO)O)(C(CO)C(CO)O)=O,,,3,1,4,0,4
1783_1,,,,2,2,1,3
1784_0,,,,2,2,1,3
1786_0,,,,2,2,1,3
C(C(CO)C(C(C(CO)O)O)O)=O,,,3,1,3,0,3
1786_1,,,,2,2,1,3
1787_0,,,,2,2,1,3
1787_1,,,,2,2,1,3
1789_0,,,,2,2,1,3
C(C(CO)N)(CC(C(CO)O)O)=O,,,3,1,2,0,2
1789_1,,,,2,2,1,3
1791_0,,,,2,2,1,3
C(CN)(C(CO)C(C(CO)O)O)=O,,,3,1,13,0,13
1791_1,,,,2,2,1,3
1793_0,,,,2,2,1,3
C(CCO)(C(C(C=O)=O)CO)=O,,,3,1,4,0,4
1793_1,,,,2,2,1,3
1795_0,,,,2,2,1,3
C(C(CO)CO)(CC(C=O)=O)=O,,,3,1,3,0,3
1795_1,,,,2,2,1,3
1797_0,,,,2,2,1,3
C(CC(C(C=O)=O)CO)(CO)=O,,,3,1,2,0,2
1799_0,,,,2,2,1,3
C(CO)(C(CO)CC(C=O)=O)=O,,,3,1,2,0,2
1801_0,,,,2,2,1,3
C(CCC(C=O)=O)(C(CO)O)=O,,,3,1,3,0,3
1801_1,,,,2,2,1,3
1802_0,,,,2,2,1,3
1802_1,,,,2,2,1,3
1803_0,,,,2,2,1,3
1805_0,,,,2,2,1,3
C(CC(C(C(C=O)=O)CO)O)=O,,,3,1,3,0,3
1805_1,,,,2,2,1,3
1807_0,,,,2,2,1,3
C(C(CO)C(CC(C=O)=O)O)=O,,,3,1,3,0,3
1807_1,,,,2,2,1,3
1809_0,,,,2,2,1,3
C(C(C(C(CCO)=O)=O)CO)=O,,,3,1,4,0,4
1809_1,,,,2,2,1,3
1811_0,,,,2,2,1,3
C(CC(C(C(CO)CO)=O)=O)=O,,,3,1,3,0,3
1811_1,,,,2,2,1,3
1813_0,,,,2,2,1,3
C(C(C(CC(CO)=O)=O)CO)=O,,,3,1,4,0,4
1813_1,,,,2,2,1,3
1815_0,,,,2,2,1,3
C(CC=O)(C(C(CO)=O)CO)=O,,,3,1,4,0,4
1815_1,,,,2,2,1,3
1817_0,,,,2,2,1,3
C(CC(CC(C(CO)O)=O)=O)=O,,,3,1,3,0,3
1817_1,,,,2,2,1,3
1819_0,,,,2,2,1,3
C(C(C(C(C(C)=O)O)=O)CO)=O,,,3,1,4,0,4
1819_1,,,,2,2,1,3
1821_0,,,,2,2,1,3
C(CC(C(C(CCO)=O)O)=O)=O,,,3,1,2,0,2
1823_0,,,,2,2,1,3
C(CC(C(C(C=O)CO)=O)O)=O,,,3,1,4,0,4
1823_1,,,,2,2,1,3
1825_0,,,,2,2,1,3
C(C(CO)C(C(CC=O)=O)O)=O,,,3,1,3,0,3
1825_1,,,,2,2,1,3
1827_0,,,,2,2,1,3
C(C(C=O)O)(C(C(C)=O)CO)=O,,,3,1,4,0,4
1827_1,,,,2,2,1,3
1829_0,,,,2,2,1,3
C(C(C=O)O)(CC(CCO)=O)=O,,,3,1,2,0,2
1831_0,,,,2,2,1,3
C(C(CO)CC=O)(C(C=O)O)=O,,,3,1,2,0,2
1833_0,,,,2,2,1,3
C(C(CO)CC(C(C=O)O)=O)=O,,,3,1,2,0,2
1835_0,,,,2,2,1,3
C(C(C(C(C(C)=O)=O)CO)O)=O,,,3,1,3,0,3
1835_1,,,,2,2,1,3
1837_0,,,,2,2,1,3
C(C(CC(C(CCO)=O)=O)O)=O,,,3,1,2,0,2
1839_0,,,,2,2,1,3
C(C(CO)C(C=O)O)(CC=O)=O,,,3,1,3,0,3
1839_1,,,,2,2,1,3
1841_0,,,,2,2,1,3
C(CC(C=O)O)(C(C=O)CO)=O,,,3,1,4,0,4
1841_1,,,,2,2,1,3
1843_0,,,,2,2,1,3
C1(C(CO)OC(C(CO)O)C1O)=O,,,3,1,2,0,2
1843_1,,,,2,2,1,3
1845_0,,,,2,2,1,3
C1(C(O)OC(C(CO)O)C1CO)=O,,,3,1,3,0,3
1845_1,,,,2,2,1,3
1847_0,,,,2,2,1,3
C1(C(C(CO)O)OC(C1CO)O)=O,,,3,1,3,0,3
1847_1,,,,2,2,1,3
1849_0,,,,2,2,1,3
C(C1C(C(C(O1)O)O)O)(CCO)=O,,,3,1,2,0,2
1851_0,,,,2,2,1,3
C(C(CO)C1C(C(C(O)O1)O)O)=O,,,3,1,3,0,3
1851_1,,,,2,2,1,3
1853_0,,,,2,2,1,3
C1(C(CO)OC(C(C1O)O)CO)=O,,,3,1,2,0,2
1853_1,,,,2,2,1,3
1855_0,,,,2,2,1,3
C1(C(O)OC(CO)C(C1CO)O)=O,,,3,1,3,0,3
1855_1,,,,2,2,1,3
1857_0,,,,2,2,1,3
C1(C(C(CO)OC(C1CO)O)O)=O,,,3,1,3,0,3
1857_1,,,,2,2,1,3
1859_0,,,,2,2,1,3
C1(C(C(O)OC(CO)C1CO)O)=O,,,3,1,3,0,3
1859_1,,,,2,2,1,3
1861_0,,,,2,2,1,3
C1(C(CO)OC(C(C1CO)O)O)=O,,,3,1,3,0,3
1861_1,,,,2,2,1,3
1863_0,,,,2,2,1,3
C1(C(CO)OCC(C(C1O)O)O)=O,,,3,1,2,0,2
1863_1,,,,2,2,1,3
1865_0,,,,2,2,1,3
C1(C(O)OCC(C(C1CO)O)O)=O,,,3,1,3,0,3
1865_1,,,,2,2,1,3
1867_0,,,,2,2,1,3
C1(C(C(COC(C1CO)O)O)O)=O,,,3,1,3,0,3
1867_1,,,,2,2,1,3
1869_0,,,,2,2,1,3
C1(C(C(O)OCC(C1CO)O)O)=O,,,3,1,3,0,3
1869_1,,,,2,2,1,3
1871_0,,,,2,2,1,3
C1(C(COC(C(C1CO)O)O)O)=O,,,3,1,3,0,3
1871_1,,,,2,2,1,3
1873_0,,,,2,2,1,3
C1(C(C(C(O)OCC1CO)O)O)=O,,,3,1,3,0,3
1873_1,,,,2,2,1,3
1875_0,,,,2,2,1,3
C1(COC(C(C(C1CO)O)O)O)=O,,,3,1,3,0,3
1875_1,,,,2,2,1,3
1877_0,,,,2,2,1,3
C1(C(CO)OC(C(C(C1)O)O)O)=O,,,3,1,3,0,3
1877_1,,,,2,2,1,3
1879_0,,,,2,2,1,3
C(C(C(CO)O)O)(C(CO)CN)=O,,,3,1,14,0,14
1879_1,,,,2,2,1,3
1881_0,,,,2,2,1,3
C(C(CN)O)(C(CO)C(CO)O)=O,,,3,1,14,0,14
1881_1,,,,2,2,1,3
1883_0,,,,2,2,1,3
C(C(CO)O)(C(CO)C(CN)O)=O,,,3,1,14,0,14
1883_1,,,,2,2,1,3
1885_0,,,,2,2,1,3
C(C(C(CN)O)O)(C(CO)CO)=O,,,3,1,14,0,14
1885_1,,,,2,2,1,3
1887_0,,,,2,2,1,3
C(CO)(C(CO)C(C(CN)O)O)=O,,,3,1,14,0,14
1887_1,,,,2,2,1,3
1889_0,,,,2,2,1,3
C(C(CO)O)(CC(C(CN)O)O)=O,,,3,1,14,0,14
1889_1,,,,2,2,1,3
1891_0,,,,2,2,1,3
C(C(C(C(CN)O)O)O)(CCO)=O,,,3,1,13,0,13
1893_0,,,,2,2,1,3
C(C(CO)C(C(C(CN)O)O)O)=O,,,3,1,14,0,14
1893_1,,,,2,2,1,3
1895_0,,,,2,2,1,3
C(C(CO)C(C(O)=O)O)(CCO)=O,,,3,1,2,0,2
1895_1,,,,2,2,1,3
1897_0,,,,2,2,1,3
C(CC(C(O)=O)O)(C(CO)CO)=O,,,3,1,3,0,3
1897_1,,,,2,2,1,3
1899_0,,,,2,2,1,3
C(C(CC(C(CO)=O)CO)O)(O)=O,,,3,1,2,0,2
1901_0,,,,2,2,1,3
C(C(CO)O)(CCC(C(O)=O)O)=O,,,3,1,3,0,3
1901_1,,,,2,2,1,3
1903_0,,,,2,2,1,3
C(C(CC(C(O)=O)O)O)(CCO)=O,,,3,1,2,0,2
1905_0,,,,2,2,1,3
C(C(CO)C(CC(C(O)=O)O)O)=O,,,3,1,3,0,3
1905_1,,,,2,2,1,3
1907_0,,,,2,2,1,3
C(C(C(C(CO)C(CO)O)=O)=O)=O,,,3,1,2,0,2
1907_1,,,,2,2,1,3
1909_0,,,,2,2,1,3
C(C(CO)O)(C(C(C=O)=O)CO)=O,,,3,1,3,0,3
1909_1,,,,2,2,1,3
1911_0,,,,2,2,1,3
C(C(CO)CO)(C(C(C=O)=O)O)=O,,,3,1,3,0,3
1911_1,,,,2,2,1,3
1913_0,,,,2,2,1,3
C(CO)(C(CO)C(C(C=O)=O)O)=O,,,3,1,3,0,3
1913_1,,,,2,2,1,3
1915_0,,,,2,2,1,3
C(CC(C(C=O)=O)O)(C(CO)O)=O,,,3,1,3,0,3
1915_1,,,,2,2,1,3
1916_0,,,,2,2,1,3
1918_0,,,,2,2,1,3
C(C(CO)C(C(C(C=O)=O)O)O)=O,,,3,1,3,0,3
1918_1,,,,2,2,1,3
1920_0,,,,2,2,1,3
C(C(C=CC(C(CO)O)=O)O)=O,,,3,1,3,0,3
1920_1,,,,2,2,1,3
1922_0,,,,2,2,1,3
C(C(CO)C1(C(C(CO1)O)O)O)=O,,,3,1,3,0,3
1922_1,,,,2,2,1,3
1924_0,,,,2,2,1,3
C(C(CO)C(C(C(CO)O)O)N)=O,,,3,1,14,0,14
1924_1,,,,2,2,1,3
1926_0,,,,2,2,1,3
C(C(C)O)(O)=O,,,3,1,3,0,3
1926_1,,,,2,2,1,3
1927_0,,,,2,2,1,3
1927_1,,,,2,2,1,3
1928_0,,,,2,2,1,3
1928_1,,,,2,2,1,3
1930_0,,,,2,2,1,3
C(C(CO)O)(O)=O,,,3,1,6,0,6
1930_1,,,,2,2,1,3
1932_0,,,,2,2,1,3
C(C(CO)(CC(CO)O)O)(O)=O,,,3,1,1,0,1
1934_0,,,,2,2,1,3
C(C(C(CC(CO)O)O)O)(O)=O,,,3,1,3,0,3
1934_1,,,,2,2,1,3
1936_0,,,,2,2,1,3
C(C(CNC)(CC(CO)O)O)(O)=O,,,3,1,1,0,1
1938_0,,,,2,2,1,3
C(C(C(CC(CO)O)NC)O)(O)=O,,,3,1,3,0,3
1938_1,,,,2,2,1,3
1939_0,,,,2,2,1,3
1939_1,,,,2,2,1,3
1940_0,,,,2,2,1,3
1940_1,,,,2,2,1,3
1941_0,,,,2,2,1,3
1941_1,,,,2,2,1,3
1942_0,,,,2,2,1,3
1942_1,,,,2,2,1,3
1944_0,,,,2,2,1,3
C(C(CCO)(CC=O)O)(O)=O,,,3,1,1,0,1
1946_0,,,,2,2,1,3
C(C(C)(CC(C=O)O)O)(O)=O,,,3,1,1,0,1
1947_0,,,,2,2,1,3
1947_1,,,,2,2,1,3
1949_0,,,,2,2,1,3
C(C(C=O)(CC(CO)O)O)(O)=O,,,3,1,1,0,1
1950_0,,,,2,2,1,3
1950_1,,,,2,2,1,3
1951_0,,,,2,2,1,3
1951_1,,,,2,2,1,3
1952_0,,,,2,2,1,3
1952_1,,,,2,2,1,3
1953_0,,,,2,2,1,3
1953_1,,,,2,2,1,3
1954_0,,,,2,2,1,3
1954_1,,,,2,2,1,3
1955_0,,,,2,2,1,3
1955_1,,,,2,2,1,3
1957_0,,,,2,2,1,3
C(C(CC(C(CO)O)NC)O)(O)=O,,,3,1,3,0,3
1957_1,,,,2,2,1,3
1958_0,,,,2,2,1,3
1958_1,,,,2,2,1,3
1960_0,,,,2,1,2,3
C(C(C=O)=O)=O,,,3,1,4,0,4
1962_0,,,,2,1,2,3
C(C(C(C=O)=O)O)=O,,,3,1,3,0,3
1963_0,,,,2,1,2,3
1964_0,,,,2,1,2,3
1965_0,,,,2,1,2,3
1966_0,,,,2,1,2,3
1967_0,,,,2,1,2,3
1968_0,,,,2,1,2,3
1969_0,,,,2,1,2,3
1970_0,,,,2,1,2,3
1972_0,,,,2,1,2,3
C(C(C(C(CO)O)=O)=O)=O,,,3,1,1,0,1
1974_0,,,,2,1,2,3
C(C(C(C=O)=O)(C(CO)O)O)=O,,,3,1,1,0,1
1976_0,,,,2,1,2,3
C(C(C(C=O)=O)N)(O)=O,,,3,1,1,0,1
1977_0,,,,2,1,2,3
1978_0,,,,2,1,2,3
1979_0,,,,2,1,2,3
1980_0,,,,2,1,2,3
1981_0,,,,2,1,2,3
1982_0,,,,2,1,2,3
1983_0,,,,2,1,1,2
1983_1,,,,2,1,1,2
1984_0,,,,2,1,1,2
1984_1,,,,2,1,1,2
1985_0,,,,2,1,2,3
1985_1,,,,2,1,2,3
1986_0,,,,2,1,1,2
1987_0,,,,2,1,1,2
1987_1,,,,2,1,1,2
1988_0,,,,2,1,1,2
1988_1,,,,2,1,1,2
1989_0,,,,2,1,2,3
1989_1,,,,2,1,2,3
1990_0,,,,2,1,2,3
1990_1,,,,2,1,2,3
1991_0,,,,2,1,2,3
1991_1,,,,2,1,2,3
1992_0,,,,2,1,2,3
1992_1,,,,2,1,2,3
1993_0,,,,2,1,2,3
1993_1,,,,2,1,2,3
1994_0,,,,2,1,2,3
1994_1,,,,2,1,2,3
1995_0,,,,2,1,2,3
1995_1,,,,2,1,2,3
1996_0,,,,2,1,2,3
1996_1,,,,2,1,2,3
1997_0,,,,2,1,2,3
1997_1,,,,2,1,2,3
1998_0,,,,2,1,2,3
1998_1,,,,2,1,2,3
1999_0,,,,2,1,2,3
1999_1,,,,2,1,2,3
2000_0,,,,2,1,2,3
2000_1,,,,2,1,2,3
2001_0,,,,2,1,2,3
2001_1,,,,2,1,2,3
2002_0,,,,2,1,2,3
2002_1,,,,2,1,2,3
2003_0,,,,2,1,2,3
2003_1,,,,2,1,2,3
2004_0,,,,2,1,2,3
2004_1,,,,2,1,2,3
2005_0,,,,2,1,2,3
2005_1,,,,2,1,2,3
2006_0,,,,2,1,2,3
2006_1,,,,2,1,2,3
2007_0,,,,2,1,2,3
2007_1,,,,2,1,2,3
2008_0,,,,2,1,2,3
2009_0,,,,2,1,2,3
2009_1,,,,2,1,2,3
2010_0,,,,2,1,2,3
2010_1,,,,2,1,2,3
2011_0,,,,2,1,2,3
2011_1,,,,2,1,2,3
2012_0,,,,2,1,2,3
2013_0,,,,2,1,2,3
2013_1,,,,2,1,2,3
2014_0,,,,2,1,2,3
2014_1,,,,2,1,2,3
2015_0,,,,2,1,2,3
2015_1,,,,2,1,2,3
2016_0,,,,2,1,2,3
2016_1,,,,2,1,2,3
2017_0,,,,2,1,2,3
2018_0,,,,2,1,2,3
2019_0,,,,2,1,2,3
2020_0,,,,2,1,2,3
2020_1,,,,2,1,2,3
2021_0,,,,2,1,2,3
2021_1,,,,2,1,2,3
2022_0,,,,2,1,2,3
2023_0,,,,2,1,2,3
2023_1,,,,2,1,2,3
2024_0,,,,2,1,2,3
2025_0,,,,2,1,2,3
2025_1,,,,2,1,2,3
2026_0,,,,2,1,2,3
2026_1,,,,2,1,2,3
2027_0,,,,2,1,2,3
2027_1,,,,2,1,2,3
2028_0,,,,2,1,2,3
2029_0,,,,2,1,2,3
2029_1,,,,2,1,2,3
2030_0,,,,2,1,2,3
2032_0,,,,2,1,2,3
C(C(CO)=O)(C)=O,,,3,1,3,0,3
2033_0,,,,2,1,2,3
2035_0,,,,2,1,2,3
C(CO)(CC(CO)=O)=O,,,3,1,3,0,3
2035_1,,,,2,1,2,3
2037_0,,,,2,1,2,3
C(CO)(C(C(C)=O)O)=O,,,3,1,2,0,2
2038_0,,,,2,1,2,3
2039_0,,,,2,1,2,3
2039_1,,,,2,1,2,3
2040_0,,,,2,1,2,3
2040_1,,,,2,1,2,3
2041_0,,,,2,1,2,3
2041_1,,,,2,1,2,3
2043_0,,,,2,1,2,3
C(C(C(C)O)=O)=O,,,3,1,3,0,3
2043_1,,,,2,1,2,3
2045_0,,,,2,1,2,3
C(CO)(C(C)O)=O,,,3,1,3,0,3
2045_1,,,,2,1,2,3
2047_0,,,,2,1,2,3
C(CC=O)=O,,,3,1,8,0,8
2047_1,,,,2,1,2,3
2049_0,,,,2,1,2,3
C(C(C(CO)=O)O)=O,,,3,1,5,0,5
2050_0,,,,2,1,2,3
2050_1,,,,2,1,2,3
2052_0,,,,2,1,2,3
C(CO)(CNC)=O,,,3,1,11,0,11
2052_1,,,,2,1,2,3
2053_0,,,,2,1,2,3
2053_1,,,,2,1,2,3
2055_0,,,,2,1,2,3
C(CNC)(C(C(CO)O)O)=O,,,3,1,2,0,2
2055_1,,,,2,1,2,3
2057_0,,,,2,1,2,3
C(CO)(C(CO)NC)=O,,,3,1,5,0,5
2057_1,,,,2,1,2,3
2059_0,,,,2,1,2,3
C(CC(C(CO)=O)NC)=O,,,3,1,2,0,2
2059_1,,,,2,1,2,3
2061_0,,,,2,1,2,3
C(C(CNC)=O)(C)=O,,,3,1,3,0,3
2063_0,,,,2,1,2,3
C(CNC)(CC(CO)=O)=O,,,3,1,3,0,3
2063_1,,,,2,1,2,3
2065_0,,,,2,1,2,3
C(C)(C(C(CNC)=O)O)=O,,,3,1,2,0,2
2067_0,,,,2,1,2,3
C(C(CNC)=O)=O,,,3,1,6,0,6
2069_0,,,,2,1,2,3
C(CC(C=O)NC)=O,,,3,1,6,0,6
2069_1,,,,2,1,2,3
2070_0,,,,2,1,2,3
2070_1,,,,2,1,2,3
2071_0,,,,2,1,2,3
2071_1,,,,2,1,2,3
2073_0,,,,2,1,2,3
C(C(C(C)NC)=O)=O,,,3,1,3,0,3
2073_1,,,,2,1,2,3
2075_0,,,,2,1,2,3
C(CO)(C(C)NC)=O,,,3,1,3,0,3
2075_1,,,,2,1,2,3
2076_0,,,,2,1,2,3
2076_1,,,,2,1,2,3
2078_0,,,,2,1,2,3
C(C(C(CNC)=O)O)=O,,,3,1,2,0,2
2080_0,,,,2,1,2,3
C(C(C(CO)=O)NC)=O,,,3,1,3,0,3
2080_1,,,,2,1,2,3
2082_0,,,,2,1,2,3
C(CNCC(CO)=O)(O)=O,,,3,1,3,0,3
2082_1,,,,2,1,2,3
2083_0,,,,2,1,2,3
2083_1,,,,2,1,2,3
2084_0,,,,2,1,2,3
2085_0,,,,2,1,2,3
2086_0,,,,2,1,2,3
2086_1,,,,2,1,2,3
2087_0,,,,2,1,2,3
2087_1,,,,2,1,2,3
2088_0,,,,2,1,2,3
2089_0,,,,2,1,2,3
2089_1,,,,2,1,2,3
2090_0,,,,2,1,2,3
2092_0,,,,2,1,2,3
C(C(CCO)O)=O,,,3,1,5,0,5
2092_1,,,,2,1,2,3
2094_0,,,,2,1,2,3
C(C(C)=O)(O)=O,,,3,1,2,0,2
2095_0,,,,2,1,2,3
2095_1,,,,2,1,2,3
2096_0,,,,2,1,2,3
2096_1,,,,2,1,2,3
2097_0,,,,2,1,2,3
2097_1,,,,2,1,2,3
2098_0,,,,2,1,2,3
2099_0,,,,2,1,2,3
2100_0,,,,2,1,2,3
2100_1,,,,2,1,2,3
2101_0,,,,2,1,2,3
2101_1,,,,2,1,2,3
2102_0,,,,2,1,2,3
2103_0,,,,2,1,2,3
2104_0,,,,2,1,2,3
2104_1,,,,2,1,2,3
2105_0,,,,2,1,2,3
2107_0,,,,2,1,2,3
C(CC(C=O)O)(O)=O,,,3,1,3,0,3
2107_1,,,,2,1,2,3
2109_0,,,,2,1,2,3
C(C(CO)=O)(O)=O,,,3,1,345,0,345
2109_1,,,,2,1,2,3
2111_0,,,,2,1,1,2
C(C)(C(CO)(C(C=O)O)O)=O,,,3,1,6,0,6
2112_0,,,,2,1,1,2
2112_1,,,,2,1,1,2
2112_2,,,,2,1,1,2
2113_0,,,,2,1,2,3
2113_1,,,,2,1,2,3
2113_2,,,,2,1,2,3
2114_0,,,,2,1,1,2
2114_1,,,,2,1,1,2
2114_2,,,,2,1,1,2
2115_0,,,,2,1,1,2
2115_1,,,,2,1,1,2
2115_2,,,,2,1,1,2
2116_0,,,,2,1,2,3
2116_1,,,,2,1,2,3
2116_2,,,,2,1,2,3
2117_0,,,,2,1,2,3
2117_1,,,,2,1,2,3
2117_2,,,,2,1,2,3
2118_0,,,,2,1,2,3
2119_0,,,,2,1,2,3
2119_1,,,,2,1,2,3
2119_2,,,,2,1,2,3
2120_0,,,,2,1,2,3
2120_1,,,,2,1,2,3
2120_2,,,,2,1,2,3
2121_0,,,,2,1,2,3
2121_1,,,,2,1,2,3
2121_2,,,,2,1,2,3
2122_0,,,,2,1,2,3
2122_1,,,,2,1,2,3
2122_2,,,,2,1,2,3
2123_0,,,,2,1,2,3
2123_1,,,,2,1,2,3
2123_2,,,,2,1,2,3
2124_0,,,,2,1,2,3
2124_1,,,,2,1,2,3
2124_2,,,,2,1,2,3
2125_0,,,,2,1,2,3
2125_1,,,,2,1,2,3
2125_2,,,,2,1,2,3
2127_0,,,,2,1,2,3
C(C(C(C)=O)(CO)O)=O,,,3,1,6,0,6
2129_0,,,,2,1,2,3
C(C)(C(CO)(CO)O)=O,,,3,1,3,0,3
2130_0,,,,2,1,2,3
2130_1,,,,2,1,2,3
2130_2,,,,2,1,2,3
2131_0,,,,2,1,2,3
2131_1,,,,2,1,2,3
2131_2,,,,2,1,2,3
2132_0,,,,2,1,2,3
2132_1,,,,2,1,2,3
2132_2,,,,2,1,2,3
2133_0,,,,2,1,2,3
2133_1,,,,2,1,2,3
2134_0,,,,2,1,2,3
2136_0,,,,2,1,2,3
C(C(CO)=O)(CCO)=O,,,3,1,2,0,2
2136_1,,,,2,1,2,3
2137_0,,,,2,1,2,3
2137_1,,,,2,1,2,3
2137_2,,,,2,1,2,3
2138_0,,,,2,1,2,3
2138_1,,,,2,1,2,3
2138_2,,,,2,1,2,3
2139_0,,,,2,1,2,3
2140_0,,,,2,1,2,3
2140_1,,,,2,1,2,3
2140_2,,,,2,1,2,3
2141_0,,,,2,1,2,3
2141_1,,,,2,1,2,3
2141_2,,,,2,1,2,3
2143_0,,,,2,1,2,3
C(C(C=O)(CO)O)=O,,,3,1,5,0,5
2144_0,,,,2,1,2,3
2144_1,,,,2,1,2,3
2144_2,,,,2,1,2,3
2145_0,,,,2,1,2,3
2145_1,,,,2,1,2,3
2145_2,,,,2,1,2,3
2146_0,,,,2,1,2,3
2146_1,,,,2,1,2,3
2147_0,,,,2,1,2,3
2147_1,,,,2,1,2,3
2148_0,,,,2,1,2,3
2148_1,,,,2,1,2,3
2148_2,,,,2,1,2,3
2149_0,,,,2,1,2,3
2149_1,,,,2,1,2,3
2149_2,,,,2,1,2,3
2150_0,,,,2,1,2,3
2150_1,,,,2,1,2,3
2150_2,,,,2,1,2,3
2151_0,,,,2,1,2,3
2151_1,,,,2,1,2,3
2151_2,,,,2,1,2,3
2152_0,,,,2,1,2,3
2153_0,,,,2,1,2,3
2153_1,,,,2,1,2,3
2154_0,,,,2,1,2,3
2155_0,,,,2,1,2,3
2155_1,,,,2,1,2,3
2156_0,,,,2,1,2,3
2156_1,,,,2,1,2,3
2158_0,,,,2,1,2,3
C(CC(CNC)=O)=O,,,3,1,4,0,4
2158_1,,,,2,1,2,3
2160_0,,,,2,1,2,3
C(C(C(C)=O)NC)=O,,,3,1,4,0,4
2162_0,,,,2,1,2,3
C(C)(C(CO)NC)=O,,,3,1,2,0,2
2164_0,,,,2,1,2,3
C(CC(C=O)O)(CNC)=O,,,3,1,2,0,2
2164_1,,,,2,1,2,3
2166_0,,,,2,1,2,3
C(CNC)(CCO)=O,,,3,1,2,0,2
2166_1,,,,2,1,2,3
2168_0,,,,2,1,2,3
C(C(C(C=O)O)NC)(C)=O,,,3,1,3,0,3
2169_0,,,,2,1,2,3
2169_1,,,,2,1,2,3
2171_0,,,,2,1,2,3
C(CNC)(C)=O,,,3,1,2,0,2
2171_1,,,,2,1,2,3
2172_0,,,,2,1,2,3
2172_1,,,,2,1,2,3
2174_0,,,,2,1,2,3
C(CN)=O,,,3,1,17,0,17
2174_1,,,,2,1,2,3
2176_0,,,,2,1,2,3
C(C)(CN)=O,,,3,1,12,0,12
2178_0,,,,2,1,2,3
C(CO)(CN)=O,,,3,1,14,0,14
2178_1,,,,2,1,2,3
2180_0,,,,2,1,2,3
C(C)(CC(C=O)=O)=O,,,3,1,2,0,2
2181_0,,,,2,1,2,3
2182_0,,,,2,1,2,3
2184_0,,,,2,1,2,3
C(CC(C=O)=O)=O,,,3,1,5,0,5
2186_0,,,,2,1,2,3
C(CC(C(C)=O)=O)=O,,,3,1,2,0,2
2187_0,,,,2,1,2,3
2189_0,,,,2,1,2,3
C(C(C)=O)(C)=O,,,3,1,2,0,2
2191_0,,,,2,1,2,3
C(CC(C)=O)=O,,,3,1,2,0,2
2193_0,,,,2,1,1,2
C(OC(C(C)=O)C(CO)O)=O,,,3,1,1,0,1
2195_0,,,,2,1,2,3
C1(COC(C1)O)=O,,,3,1,4,0,4
2195_1,,,,2,1,2,3
2197_0,,,,2,1,1,2
C(C(C(OCC(C)=O)O)O)=O,,,3,1,3,0,3
2197_1,,,,2,1,1,2
2199_0,,,,2,1,1,2
C(C(CO)OCC(CO)=O)=O,,,3,1,2,0,2
2199_1,,,,2,1,1,2
2201_0,,,,2,1,1,2
C(C(CO)OC(C(C)=O)O)=O,,,3,1,1,0,1
2203_0,,,,2,1,1,2
C(OC(CO)C(C(C)=O)O)=O,,,3,1,1,0,1
2205_0,,,,2,1,1,2
C(OC(CO)CC(CO)=O)=O,,,3,1,2,0,2
2205_1,,,,2,1,1,2
2207_0,,,,2,1,1,2
C(C)(C(CO)OC(C=O)O)=O,,,3,1,1,0,1
2209_0,,,,2,1,2,3
C1(COC(C(C1)O)O)=O,,,3,1,3,0,3
2209_1,,,,2,1,2,3
2211_0,,,,2,1,1,2
C(C(COCC(CO)=O)O)=O,,,3,1,2,0,2
2211_1,,,,2,1,1,2
2213_0,,,,2,1,1,2
C(C(COC(C(C)=O)O)O)=O,,,3,1,1,0,1
2215_0,,,,2,1,1,2
C(OCC(C(C(C)=O)O)O)=O,,,3,1,1,0,1
2217_0,,,,2,1,1,2
C(CO)(CC(OCC=O)O)=O,,,3,1,2,0,2
2217_1,,,,2,1,1,2
2219_0,,,,2,1,1,2
C(OCC(CC(CO)=O)O)=O,,,3,1,2,0,2
2219_1,,,,2,1,1,2
2221_0,,,,2,1,1,2
C(C)(C(C(OCC=O)O)O)=O,,,3,1,1,0,1
2223_0,,,,2,1,1,2
C(C)(C(COC(C=O)O)O)=O,,,3,1,1,0,1
2225_0,,,,2,1,1,2
C(CO)(CCOC(C=O)O)=O,,,3,1,2,0,2
2225_1,,,,2,1,1,2
2226_0,,,,2,1,1,2
2228_0,,,,2,1,2,3
C(CO)(CCN)=O,,,3,1,16,0,16
2228_1,,,,2,1,2,3
2230_0,,,,2,1,2,3
C(C)(C(CN)O)=O,,,3,1,15,0,15
2231_0,,,,2,1,2,3
2233_0,,,,2,1,2,3
C(CO)(CC(CN)O)=O,,,3,1,14,0,14
2233_1,,,,2,1,2,3
2234_0,,,,2,1,2,3
2234_1,,,,2,1,2,3
2236_0,,,,2,1,2,3
C(C)(C(C(CN)O)O)=O,,,3,1,13,0,13
2238_0,,,,2,1,2,3
C(C(CN)O)=O,,,3,1,16,0,16
2239_0,,,,2,1,2,3
2239_1,,,,2,1,2,3
2241_0,,,,2,1,2,3
C(C(C(CN)O)O)=O,,,3,1,13,0,13
2243_0,,,,2,1,2,3
C(C)(CCO)=O,,,3,1,1,0,1
2245_0,,,,2,1,2,3
C(C(CC(C)=O)O)(O)=O,,,3,1,2,0,2
2246_0,,,,2,1,2,3
2248_0,,,,2,1,2,3
C(C(C(C)=O)=O)=O,,,3,1,2,0,2
2250_0,,,,2,1,2,3
C(CO)(CC(C=O)=O)=O,,,3,1,3,0,3
2250_1,,,,2,1,2,3
2251_0,,,,2,1,2,3
2253_0,,,,2,1,2,3
C(C)(C(C(C=O)=O)O)=O,,,3,1,2,0,2
2254_0,,,,2,1,2,3
2255_0,,,,2,1,2,3
2256_0,,,,2,1,2,3
2257_0,,,,2,1,2,3
2257_1,,,,2,1,2,3
2258_0,,,,2,1,2,3
2258_1,,,,2,1,2,3
2259_0,,,,2,1,2,3
2260_0,,,,2,1,2,3
2260_1,,,,2,1,2,3
2261_0,,,,2,1,2,3
2263_0,,,,2,1,2,3
C(C=CC(CO)=O)=O,,,3,1,3,0,3
2263_1,,,,2,1,2,3
2265_0,,,,2,1,2,3
C=CC(C=O)=O,,,3,1,3,0,3
2265_1,,,,2,1,2,3
2267_0,,,,2,1,2,3
C=CC(CO)=O,,,3,1,4,0,4
2267_1,,,,2,1,2,3
2269_0,,,,2,1,2,3
C(C=CC=O)=O,,,3,1,3,0,3
2269_1,,,,2,1,2,3
2271_0,,,,2,1,2,3
C(CC(C=O)NC)(CO)=O,,,3,1,3,0,3
2271_1,,,,2,1,2,3
2273_0,,,,2,1,2,3
C(C)(C(CNC)O)=O,,,3,1,2,0,2
2274_0,,,,2,1,2,3
2274_1,,,,2,1,2,3
2275_0,,,,2,1,2,3
2277_0,,,,2,1,2,3
C(C(CCNC)=O)=O,,,3,1,3,0,3
2277_1,,,,2,1,2,3
2279_0,,,,2,1,2,3
C(CO)(CCNC)=O,,,3,1,3,0,3
2279_1,,,,2,1,2,3
2280_0,,,,2,1,2,3
2281_0,,,,2,1,2,3
2281_1,,,,2,1,2,3
2282_0,,,,2,1,2,3
2284_0,,,,2,1,2,3
C1(C(C(CO1)O)O)=O,,,3,1,2,0,2
2286_0,,,,2,1,2,3
C1(CC(CO1)O)=O,,,3,1,3,0,3
2286_1,,,,2,1,2,3
2288_0,,,,2,1,1,2
C(CC(CO)(OCC=O)O)=O,,,3,1,2,0,2
2288_1,,,,2,1,1,2
2290_0,,,,2,1,1,2
C(C(C(C)(OCC=O)O)O)=O,,,3,1,2,0,2
2290_1,,,,2,1,1,2
2292_0,,,,2,1,1,2
C(C(C(CO)OC(C=O)O)O)=O,,,3,1,2,0,2
2292_1,,,,2,1,1,2
2294_0,,,,2,1,1,2
C(C(CC(OCC=O)O)O)=O,,,3,1,2,0,2
2294_1,,,,2,1,1,2
2296_0,,,,2,1,1,2
C(C(CO)OC(C(CO)=O)O)=O,,,3,1,2,0,2
2296_1,,,,2,1,1,2
2298_0,,,,2,1,1,2
C(C(C(COC(C=O)O)O)O)=O,,,3,1,2,0,2
2298_1,,,,2,1,1,2
2300_0,,,,2,1,1,2
C(C(COC(C(CO)=O)O)O)=O,,,3,1,2,0,2
2300_1,,,,2,1,1,2
2302_0,,,,2,1,2,3
C(C(CCO)N)=O,,,3,1,14,0,14
2302_1,,,,2,1,2,3
2304_0,,,,2,1,2,3
C(CC(CO)N)=O,,,3,1,14,0,14
2304_1,,,,2,1,2,3
2306_0,,,,2,1,2,3
C(C(C(C)N)O)=O,,,3,1,14,0,14
2306_1,,,,2,1,2,3
2308_0,,,,2,1,2,3
C(C(CCN)O)=O,,,3,1,14,0,14
2308_1,,,,2,1,2,3
2309_0,,,,2,1,2,3
2310_0,,,,2,1,2,3
2310_1,,,,2,1,2,3
2312_0,,,,2,1,1,2
C1(C(C(C(CO)C1O)O)O)=O,,,3,1,1,0,1
2313_0,,,,2,1,1,2
2314_0,,,,2,1,1,2
2315_0,,,,2,1,1,2
2316_0,,,,2,1,1,2
2317_0,,,,2,1,1,2
2318_0,,,,2,1,1,2
2320_0,,,,2,1,1,2
C(C(C(C(CO)C(CO)O)O)=O)=O,,,3,1,1,0,1
2321_0,,,,2,1,1,2
2323_0,,,,2,1,1,2
C(C(C(CO)C(C(CO)=O)O)O)=O,,,3,1,1,0,1
2324_0,,,,2,1,1,2
2326_0,,,,2,1,1,2
C(C(C(C(C(CO)CO)O)=O)O)=O,,,3,1,1,0,1
2327_0,,,,2,1,1,2
2329_0,,,,2,1,1,2
C(C(C(C(CO)C(C=O)O)O)O)=O,,,3,1,1,0,1
2330_0,,,,2,1,1,2
2332_0,,,,2,1,1,2
C(C(C(CC(C(CO)=O)O)O)O)=O,,,3,1,1,0,1
2333_0,,,,2,1,1,2
2335_0,,,,2,1,1,2
C(C(C(C=O)O)O)(C(CCO)O)=O,,,3,1,1,0,1
2336_0,,,,2,1,1,2
2337_0,,,,2,1,1,2
2338_0,,,,2,1,1,2
2339_0,,,,2,1,1,2
2340_0,,,,2,1,1,2
2341_0,,,,2,1,1,2
2342_0,,,,2,1,1,2
2344_0,,,,2,1,1,2
C(C(CC(C=O)O)O)=O,,,3,1,1,0,1
2345_0,,,,2,1,1,2
2346_0,,,,2,1,1,2
2348_0,,,,2,1,1,2
C(C(C(C(C)O)=O)O)=O,,,3,1,1,0,1
2349_0,,,,2,1,1,2
2351_0,,,,2,1,1,2
C(C(C)O)=O,,,3,1,2,0,2
2352_0,,,,2,1,1,2
2353_0,,,,2,1,1,2
2354_0,,,,2,1,1,2
2355_0,,,,2,1,1,2
2356_0,,,,2,1,1,2
2357_0,,,,2,1,1,2
2358_0,,,,2,1,1,2
2359_0,,,,2,1,1,2
2360_0,,,,2,1,1,2
2361_0,,,,2,1,1,2
2362_0,,,,2,1,1,2
2363_0,,,,2,1,1,2
2364_0,,,,2,1,1,2
2365_0,,,,2,1,1,2
2366_0,,,,2,1,1,2
2367_0,,,,2,1,1,2
2368_0,,,,2,1,1,2
2370_0,,,,2,1,1,2
C(C(C(CO)O)=O)(CCO)=O,,,3,1,3,0,3
2372_0,,,,2,1,1,2
C(C(CO)=O)(C(CCO)O)=O,,,3,1,2,0,2
2373_0,,,,2,1,1,2
2375_0,,,,2,1,1,2
C(C(C(C(CCO)O)O)=O)=O,,,3,1,4,0,4
2376_0,,,,2,1,1,2
2377_0,,,,2,1,1,2
2378_0,,,,2,1,1,2
2379_0,,,,2,1,1,2
2380_0,,,,2,1,1,2
2381_0,,,,2,1,1,2
2382_0,,,,2,1,1,2
2384_0,,,,2,1,1,2
C(C(CO)O)(C(C(C)=O)O)=O,,,3,1,3,0,3
2386_0,,,,2,1,1,2
C(C(C)O)(C(C(CO)=O)O)=O,,,3,1,2,0,2
2387_0,,,,2,1,1,2
2389_0,,,,2,1,1,2
C(C(C(C(C(C)O)O)=O)O)=O,,,3,1,2,0,2
2390_0,,,,2,1,1,2
2391_0,,,,2,1,1,2
2392_0,,,,2,1,1,2
2394_0,,,,2,1,1,2
C(C(CO)=O)(C(C(CO)O)O)=O,,,3,1,1,0,1
2395_0,,,,2,1,1,2
2396_0,,,,2,1,1,2
2398_0,,,,2,1,1,2
C(CO)(C(CNC)O)=O,,,3,1,2,0,2
2400_0,,,,2,1,1,2
C(C(CO)O)(C(C(CO)NC)O)=O,,,3,1,3,0,3
2402_0,,,,2,1,1,2
C(CC(C(C(CO)=O)O)NC)=O,,,3,1,4,0,4
2404_0,,,,2,1,1,2
C(CC(C(CO)=O)O)(CNC)=O,,,3,1,2,0,2
2406_0,,,,2,1,1,2
C(CC(C(CO)=O)NC)(CO)=O,,,3,1,6,0,6
2408_0,,,,2,1,1,2
C(C(CC(C(C=O)O)NC)O)=O,,,3,1,3,0,3
2410_0,,,,2,1,1,2
C(C(C(CNC)O)=O)(CCO)=O,,,3,1,1,0,1
2412_0,,,,2,1,1,2
C(C(CNC)=O)(C(CCO)O)=O,,,3,1,2,0,2
2414_0,,,,2,1,1,2
C(C(CO)=O)(C(CCO)NC)=O,,,3,1,2,0,2
2416_0,,,,2,1,1,2
C(C(C(C(CCO)NC)O)=O)=O,,,3,1,1,0,1
2418_0,,,,2,1,1,2
C(C(CNC)O)(CC(CO)=O)=O,,,3,1,3,0,3
2420_0,,,,2,1,1,2
C(C(CC(C(CNC)=O)O)O)=O,,,3,1,3,0,3
2422_0,,,,2,1,1,2
C(C(CC(C(CO)=O)O)NC)=O,,,3,1,3,0,3
2424_0,,,,2,1,1,2
C(C(CNC)O)(C(C(C)=O)O)=O,,,3,1,1,0,1
2426_0,,,,2,1,1,2
C(C(C)O)(C(C(CNC)=O)O)=O,,,3,1,2,0,2
2428_0,,,,2,1,1,2
C(C(C)NC)(C(C(CO)=O)O)=O,,,3,1,2,0,2
2430_0,,,,2,1,1,2
C(C(C(C(C(C)NC)O)=O)O)=O,,,3,1,1,0,1
2432_0,,,,2,1,1,2
C(CC(C(C(CNC)O)=O)O)=O,,,3,1,2,0,2
2433_0,,,,2,1,1,2
2435_0,,,,2,1,1,2
C(CNCC(C(CO)=O)O)(O)=O,,,3,1,2,0,2
2437_0,,,,2,1,1,2
C(C(C(CO)O)O)(C(CNC)O)=O,,,3,1,2,0,2
2438_0,,,,2,1,1,2
2440_0,,,,2,1,1,2
C(C(CCO)O)(C(CO)O)=O,,,3,1,3,0,3
2442_0,,,,2,1,1,2
C(CO)(C(CC(CO)O)O)=O,,,3,1,3,0,3
2444_0,,,,2,1,1,2
C(C(C(CO)O)O)(C(C)O)=O,,,3,1,2,0,2
2446_0,,,,2,1,1,2
C(CO)(C(C(CCO)O)O)=O,,,3,1,2,0,2
2448_0,,,,2,1,1,2
C(CC(C(C(CO)O)=O)O)(O)=O,,,3,1,2,0,2
2450_0,,,,2,1,1,2
C(C(C(CC(CO)O)O)=O)(O)=O,,,3,1,2,0,2
2452_0,,,,2,1,1,2
C(C(CC(C(CO)=O)O)O)(O)=O,,,3,1,3,0,3
2454_0,,,,2,1,1,2
C(C(C(C(CCO)O)=O)O)(O)=O,,,3,1,3,0,3
2456_0,,,,2,1,1,2
C(C(C(CC(C=O)O)O)O)(O)=O,,,3,1,4,0,4
2458_0,,,,2,1,1,2
C(C(C(C(O)=O)O)O)(C(C)O)=O,,,3,1,3,0,3
2460_0,,,,2,1,1,2
C(CC(C(C(CO)=O)O)O)(O)=O,,,3,1,2,0,2
2462_0,,,,2,1,1,2
C(C(C(C(C(CO)O)O)=O)O)(O)=O,,,3,1,3,0,3
2464_0,,,,2,1,1,2
C(C(CO)(CO)O)(CC(CO)=O)=O,,,3,1,3,0,3
2466_0,,,,2,1,1,2
C(C(C(C(CCO)O)=O)(CO)O)=O,,,3,1,3,0,3
2468_0,,,,2,1,1,2
C(CCO)(C(C(CO)=O)(CO)O)=O,,,3,1,3,0,3
2470_0,,,,2,1,1,2
C(C(CO)(C(CC(C=O)O)O)O)=O,,,3,1,5,0,5
2472_0,,,,2,1,1,2
C(C(CO)(C(C(C(C)O)=O)O)O)=O,,,3,1,3,0,3
2474_0,,,,2,1,1,2
C(C)(C(CO)(C(C(CO)=O)O)O)=O,,,3,1,5,0,5
2476_0,,,,2,1,1,2
C(C(CO)(CC(C(CO)=O)O)O)=O,,,3,1,2,0,2
2477_0,,,,2,1,1,2
2479_0,,,,2,1,1,2
C(C(CO)NC)(CC(CO)=O)=O,,,3,1,4,0,4
2481_0,,,,2,1,1,2
C(CCO)(C(C(CO)=O)NC)=O,,,3,1,3,0,3
2483_0,,,,2,1,1,2
C(C(C(C(CO)=O)O)NC)(C)=O,,,3,1,4,0,4
2485_0,,,,2,1,1,2
C(C(C(CO)O)O)(C(CN)O)=O,,,3,1,14,0,14
2487_0,,,,2,1,1,2
C(C(CCC(C=O)=O)O)=O,,,3,1,2,0,2
2489_0,,,,2,1,1,2
C(C(C)O)(CC(C=O)=O)=O,,,3,1,2,0,2
2490_0,,,,2,1,1,2
2492_0,,,,2,1,1,2
C(CC(C(C(C)=O)=O)O)=O,,,3,1,2,0,2
2494_0,,,,2,1,1,2
C(CC(C(C(C)O)=O)=O)=O,,,3,1,2,0,2
2495_0,,,,2,1,1,2
2497_0,,,,2,1,1,2
C(C)(CC(C(CO)=O)=O)=O,,,3,1,3,0,3
2499_0,,,,2,1,1,2
C(C)(CC(C(C=O)=O)O)=O,,,3,1,2,0,2
2501_0,,,,2,1,1,2
C(CCC(C(CO)=O)=O)=O,,,3,1,3,0,3
2503_0,,,,2,1,1,2
C(CCC(C(C=O)=O)O)=O,,,3,1,2,0,2
2505_0,,,,2,1,1,2
C(CO)(CC(C(C)=O)=O)=O,,,3,1,3,0,3
2506_0,,,,2,1,1,2
2508_0,,,,2,1,1,2
C1(C(C(CO)O)OCC1O)=O,,,3,1,1,0,1
2509_0,,,,2,1,1,2
2511_0,,,,2,1,1,2
C1(C(C(CO)OCC1O)O)=O,,,3,1,1,0,1
2512_0,,,,2,1,1,2
2514_0,,,,2,1,1,2
C1(C(CO)OC(CC1O)O)=O,,,3,1,2,0,2
2516_0,,,,2,1,1,2
C1(C(O)OC(CO)CC1O)=O,,,3,1,2,0,2
2518_0,,,,2,1,1,2
C1(C(C(COCC1O)O)O)=O,,,3,1,1,0,1
2519_0,,,,2,1,1,2
2521_0,,,,2,1,1,2
C1(C(CC(O)OCC1O)O)=O,,,3,1,2,0,2
2523_0,,,,2,1,1,2
C1(C(O)OCC(CC1O)O)=O,,,3,1,2,0,2
2525_0,,,,2,1,1,2
C1(COC(C(CC1O)O)O)=O,,,3,1,2,0,2
2527_0,,,,2,1,1,2
C1(C(CCOC(C1O)O)O)=O,,,3,1,2,0,2
2529_0,,,,2,1,1,2
C(C(CCN)O)(C(CO)O)=O,,,3,1,13,0,13
2531_0,,,,2,1,1,2
C(CN)(C(CC(CO)O)O)=O,,,3,1,12,0,12
2533_0,,,,2,1,1,2
C(CO)(C(CC(CN)O)O)=O,,,3,1,13,0,13
2535_0,,,,2,1,1,2
C(C(CCO)O)(C(CN)O)=O,,,3,1,13,0,13
2537_0,,,,2,1,1,2
C(C(CC(C(CN)O)O)O)=O,,,3,1,13,0,13
2539_0,,,,2,1,1,2
C(C(C(CN)O)O)(C(C)O)=O,,,3,1,13,0,13
2541_0,,,,2,1,1,2
C(C(CCC(C=O)O)O)(O)=O,,,3,1,2,0,2
2543_0,,,,2,1,1,2
C(CC(C(O)=O)O)(C(C)O)=O,,,3,1,2,0,2
2544_0,,,,2,1,1,2
2546_0,,,,2,1,1,2
C(C(C(C(CCO)=O)=O)O)=O,,,3,1,2,0,2
2548_0,,,,2,1,1,2
C(C(C(C(CCO)O)=O)=O)=O,,,3,1,1,0,1
2550_0,,,,2,1,1,2
C(C(C=O)O)(CC(CO)=O)=O,,,3,1,2,0,2
2552_0,,,,2,1,1,2
C(C(CC(C(C=O)=O)O)O)=O,,,3,1,2,0,2
2554_0,,,,2,1,1,2
C(C(C(C(C(C)=O)O)=O)O)=O,,,3,1,2,0,2
2556_0,,,,2,1,1,2
C(C(C)O)(C(C(C=O)=O)O)=O,,,3,1,2,0,2
2558_0,,,,2,1,1,2
C(C(C(C(CC=O)O)=O)O)=O,,,3,1,2,0,2
2560_0,,,,2,1,1,2
C(CO)=CC(C(CO)=O)=O,,,3,1,2,0,2
2562_0,,,,2,1,1,2
C(C(C(C=O)=O)O)=CCO,,,3,1,2,0,2
2564_0,,,,2,1,1,2
C(CO)(C(C=CC=O)O)=O,,,3,1,4,0,4
2566_0,,,,2,1,1,2
C(CO)(C(C(C=C)=O)O)=O,,,3,1,2,0,2
2568_0,,,,2,1,1,2
C(C(C(C(C=C)O)=O)O)=O,,,3,1,2,0,2
2570_0,,,,2,1,1,2
C(C=CC(CO)=O)(CO)=O,,,3,1,2,0,2
2572_0,,,,2,1,1,2
C(C(C=CC(C=O)O)O)=O,,,3,1,2,0,2
2573_0,,,,2,1,1,2
2574_0,,,,2,1,1,2
2576_0,,,,2,1,1,2
C(C(C(C(C(CO)O)NC)O)O)=O,,,3,1,6,0,6
2577_0,,,,2,1,1,2
2579_0,,,,2,1,1,2
C(CC(C(C(CO)NC)=O)O)=O,,,3,1,4,0,4
2581_0,,,,2,1,1,2
C(C(CO)=O)(CC(CO)NC)=O,,,3,1,2,0,2
2583_0,,,,2,1,1,2
C(C(C(CC(CO)NC)O)=O)=O,,,3,1,1,0,1
2584_0,,,,2,1,1,2
2585_0,,,,2,1,1,2
2586_0,,,,2,1,1,2
2588_0,,,,2,1,1,2
C(C(C(C(CCO)O)=O)NC)=O,,,3,1,2,0,2
2590_0,,,,2,1,1,2
C(CCNC)(C(C(CO)=O)O)=O,,,3,1,2,0,2
2592_0,,,,2,1,1,2
C(C(C(C(CCNC)O)=O)O)=O,,,3,1,1,0,1
2593_0,,,,2,1,1,2
2594_0,,,,2,1,1,2
2596_0,,,,2,1,1,2
C(C(C(C(C)=O)O)NC)(CO)=O,,,3,1,4,0,4
2598_0,,,,2,1,1,2
C(C(C(C=O)O)NC)(C(C)O)=O,,,3,1,3,0,3
2600_0,,,,2,1,1,2
C(CC(C(C(CO)=O)NC)O)=O,,,3,1,4,0,4
2601_0,,,,2,1,1,2
2603_0,,,,2,1,1,2
C(C(C(C(C(CO)O)NC)=O)O)=O,,,3,1,2,0,2
2605_0,,,,2,1,1,2
C(CNC(C(CO)=O)CO)(O)=O,,,3,1,3,0,3
2606_0,,,,2,1,1,2
2608_0,,,,2,1,1,2
C(CO)(C1(CC(CO1)O)O)=O,,,3,1,2,0,2
2610_0,,,,2,1,1,2
C(CO)(C1C(CC(O1)O)O)=O,,,3,1,2,0,2
2611_0,,,,2,1,1,2
2613_0,,,,2,1,1,2
C1(C(C(CO)O)OC(C1O)O)=O,,,3,1,2,0,2
2614_0,,,,2,1,1,2
2616_0,,,,2,1,1,2
C1(C(C(CO)OC(C1O)O)O)=O,,,3,1,2,0,2
2617_0,,,,2,1,1,2
2619_0,,,,2,1,1,2
C1(C(C(COC(C1O)O)O)O)=O,,,3,1,2,0,2
2621_0,,,,2,1,1,2
C(CO)(C(CC(CO)O)N)=O,,,3,1,13,0,13
2623_0,,,,2,1,1,2
C(CO)(CC(C(CO)O)N)=O,,,3,1,14,0,14
2625_0,,,,2,1,1,2
C(CO)(C(C(CCO)N)O)=O,,,3,1,13,0,13
2627_0,,,,2,1,1,2
C(CO)(C(CC(CO)N)O)=O,,,3,1,13,0,13
2629_0,,,,2,1,1,2
C(CO)(C(C(C(C)N)O)O)=O,,,3,1,13,0,13
2631_0,,,,2,1,1,2
C(CO)(C(C(CCN)O)O)=O,,,3,1,13,0,13
2632_0,,,,2,1,1,2
2633_0,,,,2,1,1,2
2634_0,,,,2,1,1,2
2636_0,,,,2,1,2,3
C1(CC(C(CO)=O)N(C)C1)=O,,,3,1,2,0,2
2637_0,,,,2,1,2,3
2639_0,,,,2,1,2,3
C1(C(CN(C)C1CCO)=O)=O,,,3,1,2,0,2
2640_0,,,,2,1,2,3
2642_0,,,,2,1,2,3
C(C1CC(C(CN1C)=O)O)=O,,,3,1,2,0,2
2643_0,,,,2,1,2,3
2645_0,,,,2,1,2,3
C1(C(C)N(C)CC(C1O)=O)=O,,,3,1,2,0,2
2646_0,,,,2,1,2,3
2648_0,,,,2,1,2,3
C1(C(CO)N(C)CC(C1)=O)=O,,,3,1,2,0,2
2650_0,,,,2,1,2,3
C(C1C(C(CN1C)=O)O)(C)=O,,,3,1,2,0,2
2652_0,,,,2,1,2,3
C(CO)(C1CC(CN1)O)=O,,,3,1,1,0,1
2654_0,,,,2,1,2,3
C1(C(CNC1CCO)O)=O,,,3,1,1,0,1
2656_0,,,,2,1,2,3
C(C1CC(C(CN1)O)O)=O,,,3,1,1,0,1
2658_0,,,,2,1,2,3
C1(C(C(CNC1C)O)O)=O,,,3,1,1,0,1
2660_0,,,,2,1,2,3
C1(C(CN(C)C(CO)C1)=O)=O,,,3,1,2,0,2
2662_0,,,,2,1,2,3
C1(C(CN(C)CC(C1)=O)O)=O,,,3,1,2,0,2
2664_0,,,,2,1,2,3
C1(CCN(C)CC(C1O)=O)=O,,,3,1,2,0,2
2666_0,,,,2,1,2,3
C(CC1C(C(CN1C)=O)O)=O,,,3,1,2,0,2
2668_0,,,,2,1,2,3
C1(CNC(C(CO)O)C1)=O,,,3,1,1,0,1
2670_0,,,,2,1,2,3
C1(CNC(CCO)C1O)=O,,,3,1,1,0,1
2672_0,,,,2,1,2,3
C1(CNC(CO)CC1O)=O,,,3,1,1,0,1
2674_0,,,,2,1,2,3
C1(CNC(C)C(C1O)O)=O,,,3,1,1,0,1
2676_0,,,,2,1,2,3
C1(CNCCC(C1O)O)=O,,,3,1,1,0,1
2678_0,,,,2,2,2,4
C1(C(C(C(CO)C1N)O)O)=O,,,3,1,1,0,1
2680_0,,,,2,2,2,4
C1(C(C(C(CC1N)O)O)O)=O,,,3,1,1,0,1
2682_0,,,,2,2,2,4
C(CN(C)CC(C(O)=O)=O)=O,,,3,1,1,0,1
2684_0,,,,2,2,2,4
C(C(CO)NCC(C(O)=O)=O)(O)=O,,,3,1,1,0,1
2686_0,,,,2,2,2,4
C(C(CN)=O)(O)=O,,,3,1,1,0,1
2688_0,,,,2,2,2,4
C(C(CNCCO)=O)(O)=O,,,3,1,1,0,1
2690_0,,,,2,2,2,4
C(C(C(CN(C)CC=O)=O)O)(O)=O,,,3,1,1,0,1
2692_0,,,,2,2,2,4
C(C(C(CN)=O)O)(O)=O,,,3,1,1,0,1
2694_0,,,,2,2,2,4
C(C(C(CNCCO)=O)O)(O)=O,,,3,1,1,0,1
2696_0,,,,2,2,2,4
C(CN(C)CC(CO)=O)=O,,,3,1,1,0,1
2698_0,,,,2,2,2,4
C(CN(CC=O)CC(CO)=O)(O)=O,,,3,1,1,0,1
2700_0,,,,2,2,2,4
C(C(C(O)=O)NCC(CO)=O)(O)=O,,,3,1,1,0,1
2702_0,,,,2,2,2,4
C(C(CO)NCC(CO)=O)(O)=O,,,3,1,1,0,1
2703_0,,,,2,2,2,4
2705_0,,,,2,2,2,4
C(CO)(CNCCO)=O,,,3,1,1,0,1
2707_0,,,,2,2,2,4
C(CO)(CNCC(C(CO)O)O)=O,,,3,1,1,0,1
2709_0,,,,2,2,2,4
C(C(CO)C(C(C(CO)O)=O)N)=O,,,3,1,1,0,1
2711_0,,,,2,2,2,4
C(C(CN)=O)(C(CO)C(CO)O)=O,,,3,1,1,0,1
2713_0,,,,2,2,2,4
C(C(C(C(CO)C(CO)O)N)=O)=O,,,3,1,1,0,1
2715_0,,,,2,2,2,4
C(C(CO)O)(C(C(CN)=O)CO)=O,,,3,1,1,0,1
2717_0,,,,2,2,2,4
C(C(C(CO)C(C(CO)=O)N)O)=O,,,3,1,1,0,1
2719_0,,,,2,2,2,4
C(C(CO)CO)(C(C(CN)=O)O)=O,,,3,1,1,0,1
2721_0,,,,2,2,2,4
C(C(C(C(C(CO)CO)N)=O)O)=O,,,3,1,1,0,1
2723_0,,,,2,2,2,4
C(CO)(C(CO)C(C(CN)=O)O)=O,,,3,1,1,0,1
2725_0,,,,2,2,2,4
C(C(C(CO)C(C(C=O)O)O)N)=O,,,3,1,1,0,1
2727_0,,,,2,2,2,4
C(CC(C(CN)=O)O)(C(CO)O)=O,,,3,1,1,0,1
2729_0,,,,2,2,2,4
C(C(C(CC(C(CO)=O)N)O)O)=O,,,3,1,1,0,1
2731_0,,,,2,2,2,4
C(C(C(C(CCO)=O)O)O)(CN)=O,,,3,1,1,0,1
2733_0,,,,2,2,2,4
C(C(C(C=O)O)O)(C(CCO)N)=O,,,3,1,1,0,1
2735_0,,,,2,2,2,4
C(C(CO)C(C(C(CN)=O)O)O)=O,,,3,1,1,0,1
2737_0,,,,2,2,2,4
C(C(CO)N(C)CC=O)=O,,,3,1,1,0,1
2739_0,,,,2,2,2,4
C(C(CO)N(CC(O)=O)CC=O)=O,,,3,1,1,0,1
2741_0,,,,2,2,2,4
C(C(C(O)=O)NC(C=O)CO)(O)=O,,,3,1,1,0,1
2743_0,,,,2,2,2,4
C(C(CO)NC(C=O)CO)(O)=O,,,3,1,1,0,1
2745_0,,,,2,2,2,4
C(C(CO)N)=O,,,3,1,12,0,12
2747_0,,,,2,2,2,4
C(C(CO)NCCO)=O,,,3,1,1,0,1
2749_0,,,,2,2,2,4
C(C(CO)NCC(C(CO)O)O)=O,,,3,1,1,0,1
2751_0,,,,2,2,2,4
C(CN(C)C(C=O)CC=O)=O,,,3,1,2,0,2
2753_0,,,,2,2,2,4
C(C(CO)NC(C=O)CC=O)(O)=O,,,3,1,2,0,2
2755_0,,,,2,2,2,4
C(CC(C=O)N)=O,,,3,1,2,0,2
2757_0,,,,2,2,2,4
C(CC(C=O)NCCO)=O,,,3,1,2,0,2
2759_0,,,,2,2,2,4
C(CN(C)CC(C(C)=O)=O)=O,,,3,1,1,0,1
2761_0,,,,2,2,2,4
C(CN(C)C(C(C=O)=O)C)=O,,,3,1,1,0,1
2763_0,,,,2,2,2,4
C(C(CO)NCC(C(C)=O)=O)(O)=O,,,3,1,1,0,1
2765_0,,,,2,2,2,4
C(C(CO)NC(C(C=O)=O)C)(O)=O,,,3,1,1,0,1
2767_0,,,,2,2,2,4
C(C(CN)=O)(C)=O,,,3,1,1,0,1
2769_0,,,,2,2,2,4
C(C(C(C)N)=O)=O,,,3,1,1,0,1
2771_0,,,,2,2,2,4
C(C(CNCCO)=O)(C)=O,,,3,1,1,0,1
2773_0,,,,2,2,2,4
C(C(C(C)NCCO)=O)=O,,,3,1,1,0,1
2775_0,,,,2,2,2,4
C(CN(C)C(C(CO)=O)C)=O,,,3,1,1,0,1
2777_0,,,,2,2,2,4
C(C(CO)NC(C(CO)=O)C)(O)=O,,,3,1,1,0,1
2779_0,,,,2,2,2,4
C(CO)(C(C)N)=O,,,3,1,1,0,1
2781_0,,,,2,2,2,4
C(CO)(C(C)NCCO)=O,,,3,1,1,0,1
2783_0,,,,2,2,2,4
C(CN(C)CC(CC(CO)=O)=O)=O,,,3,1,1,0,1
2785_0,,,,2,2,2,4
C(C(CC(C=O)O)N(C)CC=O)=O,,,3,1,1,0,1
2787_0,,,,2,2,2,4
C(CO)(CC(CN)=O)=O,,,3,1,1,0,1
2789_0,,,,2,2,2,4
C(C(CC(C=O)O)N)=O,,,3,1,1,0,1
2791_0,,,,2,2,2,4
C(CNCCO)(CC(CO)=O)=O,,,3,1,1,0,1
2793_0,,,,2,2,2,4
C(C(CC(C=O)O)NCCO)=O,,,3,1,1,0,1
2795_0,,,,2,2,2,4
C(C(CCO)N(C)CC=O)=O,,,3,1,1,0,1
2797_0,,,,2,2,2,4
C(C(CO)NC(C=O)CCO)(O)=O,,,3,1,1,0,1
2798_0,,,,2,2,2,4
2800_0,,,,2,2,2,4
C(C(CCO)NCCO)=O,,,3,1,1,0,1
2802_0,,,,2,2,2,4
C(C)(C(C(CN(C)CC=O)=O)O)=O,,,3,1,1,0,1
2804_0,,,,2,2,2,4
C(C(C)N(C)CC=O)(C(C=O)O)=O,,,3,1,1,0,1
2806_0,,,,2,2,2,4
C(C)(C(C(CN)=O)O)=O,,,3,1,1,0,1
2808_0,,,,2,2,2,4
C(C(C(C(C)N)=O)O)=O,,,3,1,1,0,1
2810_0,,,,2,2,2,4
C(C)(C(C(CNCCO)=O)O)=O,,,3,1,1,0,1
2812_0,,,,2,2,2,4
C(C(C(C(C)NCCO)=O)O)=O,,,3,1,1,0,1
2814_0,,,,2,2,2,4
C(CN(C)CC(C=O)=O)=O,,,3,1,1,0,1
2816_0,,,,2,2,2,4
C(CN(CC(O)=O)CC(C=O)=O)=O,,,3,1,1,0,1
2818_0,,,,2,2,2,4
C(C(C(O)=O)NCC(C=O)=O)(O)=O,,,3,1,1,0,1
2820_0,,,,2,2,2,4
C(C(CO)NCC(C=O)=O)(O)=O,,,3,1,1,0,1
2822_0,,,,2,2,2,4
C(C(CN)=O)=O,,,3,1,1,0,1
2824_0,,,,2,2,2,4
C(C(CNCCO)=O)=O,,,3,1,1,0,1
2826_0,,,,2,2,2,4
C(C(CNCC(C(CO)O)O)=O)=O,,,3,1,1,0,1
2828_0,,,,2,2,2,4
C(C(C)N(C)CC=O)=O,,,3,1,1,0,1
2830_0,,,,2,2,2,4
C(C(C)N(C)CC(C(CO)O)=O)=O,,,3,1,1,0,1
2832_0,,,,2,2,2,4
C(C(C)N(CC=O)CC(O)=O)=O,,,3,1,1,0,1
2834_0,,,,2,2,2,4
C(C(C(CO)O)NC(C=O)C)(O)=O,,,3,1,1,0,1
2836_0,,,,2,2,2,4
C(C(C)NC(C(O)=O)C(O)=O)=O,,,3,1,1,0,1
2838_0,,,,2,2,2,4
C(C(CO)NC(C=O)C)(O)=O,,,3,1,1,0,1
2840_0,,,,2,2,2,4
C(C(C)N)=O,,,3,1,12,0,12
2842_0,,,,2,2,2,4
C(C(C)N(C)C(CO)C(C=O)O)=O,,,3,1,1,0,1
2844_0,,,,2,2,2,4
C(C(C)NCCO)=O,,,3,1,1,0,1
2846_0,,,,2,2,2,4
C(C(C)NCC(C(CO)O)O)=O,,,3,1,1,0,1
2848_0,,,,2,2,2,4
C(CC(CN(C)CC=O)=O)=O,,,3,1,1,0,1
2850_0,,,,2,2,2,4
C(C(CO)NCC(CC=O)=O)(O)=O,,,3,1,1,0,1
2852_0,,,,2,2,2,4
C(CC(CN)=O)=O,,,3,1,1,0,1
2854_0,,,,2,2,2,4
C(CC(CNCCO)=O)=O,,,3,1,1,0,1
2856_0,,,,2,2,2,4
C(C(C(CN(C)CC=O)=O)O)=O,,,3,1,1,0,1
2858_0,,,,2,2,2,4
C(C(C(CN)=O)O)=O,,,3,1,1,0,1
2860_0,,,,2,2,2,4
C(C(C(CNCCO)=O)O)=O,,,3,1,1,0,1
2862_0,,,,2,2,2,4
C(C(C=O)N(C)CC=O)=O,,,3,1,1,0,1
2864_0,,,,2,2,2,4
C(C(C=O)N(CC(O)=O)CC=O)=O,,,3,1,1,0,1
2866_0,,,,2,2,2,4
C(C(C=O)NC(C(O)=O)C(O)=O)=O,,,3,1,1,0,1
2868_0,,,,2,2,2,4
C(C(C=O)NC(C(O)=O)CO)=O,,,3,1,1,0,1
2870_0,,,,2,2,2,4
C(C(C=O)N)=O,,,3,1,1,0,1
2872_0,,,,2,2,2,4
C(C(C=O)NCCO)=O,,,3,1,1,0,1
2874_0,,,,2,2,2,4
C(C(C=O)NCC(C(CO)O)O)=O,,,3,1,1,0,1
2876_0,,,,2,2,2,4
C(C(C(CO)O)N(C)CC=O)=O,,,3,1,1,0,1
2878_0,,,,2,2,2,4
C(CN(C)C(C(CO)=O)CO)=O,,,3,1,2,0,2
2878_1,,,,2,2,2,4
2880_0,,,,2,2,2,4
C(C(C(CO)O)N)=O,,,3,1,12,0,12
2882_0,,,,2,2,2,4
C(CO)(C(CO)N)=O,,,3,1,2,0,2
2882_1,,,,2,2,2,4
2884_0,,,,2,2,2,4
C(C(C(CO)O)NCCO)=O,,,3,1,1,0,1
2886_0,,,,2,2,2,4
C(CO)(C(CO)NCCO)=O,,,3,1,2,0,2
2886_1,,,,2,2,2,4
2888_0,,,,2,2,2,4
C(CO)(C(C(C(CO)O)O)N)=O,,,3,1,2,0,2
2890_0,,,,2,2,2,4
C(C(CO)O)(C(C(CO)O)N)=O,,,3,1,2,0,2
2890_1,,,,2,2,2,4
2892_0,,,,2,2,2,4
C(CC(C(C(CO)O)N)=O)=O,,,3,1,2,0,2
2894_0,,,,2,2,2,4
C(CC(C(C(CO)=O)N)O)=O,,,3,1,2,0,2
2896_0,,,,2,2,2,4
C(C(C(CC(CO)O)=O)N)=O,,,3,1,10,0,10
2897_0,,,,2,2,2,4
2899_0,,,,2,2,2,4
C(CC(C=O)N)(C(CO)O)=O,,,3,1,16,0,16
2901_0,,,,2,2,2,4
C(CO)(C(CC(CO)=O)N)=O,,,3,1,3,0,3
2903_0,,,,2,2,2,4
C(CO)(C(CC(CN)=O)O)=O,,,3,1,1,0,1
2905_0,,,,2,2,2,4
C(CC(C=O)O)(C(CO)N)=O,,,3,1,2,0,2
2907_0,,,,2,2,2,4
C(C(C(CC(C=O)O)O)N)=O,,,3,1,1,0,1
2909_0,,,,2,2,2,4
C(C(C(C(CCO)=O)O)N)=O,,,3,1,14,0,14
2911_0,,,,2,2,2,4
C(C(C(CO)N)=O)(CCO)=O,,,3,1,1,0,1
2913_0,,,,2,2,2,4
C(C(CO)=O)(C(CCO)N)=O,,,3,1,1,0,1
2915_0,,,,2,2,2,4
C(C(CN)=O)(C(CCO)O)=O,,,3,1,1,0,1
2917_0,,,,2,2,2,4
C(C(C(C(CCO)O)N)=O)=O,,,3,1,1,0,1
2919_0,,,,2,2,2,4
C(C(C(C=O)O)N)(CCO)=O,,,3,1,3,0,3
2921_0,,,,2,2,2,4
C(C(C(CC(CO)=O)O)N)=O,,,3,1,13,0,13
2923_0,,,,2,2,2,4
C(C(CO)N)(CC(CO)=O)=O,,,3,1,2,0,2
2925_0,,,,2,2,2,4
C(C(CC(C(CO)=O)O)N)=O,,,3,1,1,0,1
2927_0,,,,2,2,2,4
C(C(CC(C(CN)=O)O)O)=O,,,3,1,1,0,1
2929_0,,,,2,2,2,4
C(C(C(CC(CN)=O)O)O)=O,,,3,1,1,0,1
2931_0,,,,2,2,2,4
C(C(C(C(C(C)=O)O)O)N)=O,,,3,1,13,0,13
2933_0,,,,2,2,2,4
C(C(CO)N)(C(C(C)=O)O)=O,,,3,1,1,0,1
2935_0,,,,2,2,2,4
C(C(C)N)(C(C(CO)=O)O)=O,,,3,1,1,0,1
2937_0,,,,2,2,2,4
C(C(C)O)(C(C(CN)=O)O)=O,,,3,1,1,0,1
2939_0,,,,2,2,2,4
C(C(C(C(C(C)O)N)=O)O)=O,,,3,1,1,0,1
2941_0,,,,2,2,2,4
C(C(C(C(C(C)=O)N)O)O)=O,,,3,1,2,0,2
2943_0,,,,2,2,2,4
C(CC(C(C(C=O)N)O)O)=O,,,3,1,13,0,13
2945_0,,,,2,2,2,4
C(CC(C(C(CO)N)=O)O)=O,,,3,1,2,0,2
2947_0,,,,2,2,2,4
C(C(CN)=O)(C(C(CO)O)O)=O,,,3,1,1,0,1
2949_0,,,,2,2,2,4
C(C(C(C(C(CO)O)O)N)=O)=O,,,3,1,2,0,2
2951_0,,,,2,2,2,4
C(C(C(C=O)O)N)(C(CO)O)=O,,,3,1,1,0,1
2953_0,,,,2,2,2,4
C(CN(C)C(C(CO)=O)CNC)=O,,,3,1,1,0,1
2955_0,,,,2,2,2,4
C(C(CCC(C=O)=O)N(C)CC=O)=O,,,3,1,1,0,1
2957_0,,,,2,2,2,4
C(C(C)N(C)CC=O)(CC(C=O)=O)=O,,,3,1,1,0,1
2959_0,,,,2,2,2,4
C(CN(C)C(C=O)CC(CC=O)=O)=O,,,3,1,2,0,2
2961_0,,,,2,2,2,4
C(CN(C)C(C(C(C)=O)=O)CC=O)=O,,,3,1,1,0,1
2963_0,,,,2,2,2,4
C(CC(C(C(C)N(C)CC=O)=O)=O)=O,,,3,1,1,0,1
2965_0,,,,2,2,2,4
C(CN(C)C(C(CC=O)=O)CC=O)=O,,,3,1,3,0,3
2965_1,,,,2,2,2,4
2965_2,,,,2,2,2,4
2967_0,,,,2,2,2,4
C(C)(CC(C(CN(C)CC=O)=O)=O)=O,,,3,1,1,0,1
2969_0,,,,2,2,2,4
C(CC(C(C=O)=O)N(C)CC=O)(C)=O,,,3,1,1,0,1
2971_0,,,,2,2,2,4
C(CN(C)CC(C(CCC=O)=O)=O)=O,,,3,1,1,0,1
2973_0,,,,2,2,2,4
C(CCC(C(C=O)=O)N(C)CC=O)=O,,,3,1,1,0,1
2975_0,,,,2,2,2,4
C(CN(C)CC(CC(C(C)=O)=O)=O)=O,,,3,1,1,0,1
2977_0,,,,2,2,2,4
C(CC(CC(CN(C)CC=O)=O)=O)=O,,,3,1,1,0,1
2979_0,,,,2,2,2,4
C(CN(C)CC(C(C=CCO)=O)=O)=O,,,3,1,1,0,1
2981_0,,,,2,2,2,4
C(CN(C)C(C=CCO)C(C=O)=O)=O,,,3,1,1,0,1
2983_0,,,,2,2,2,4
C(CN(C)C(C(CO)=O)C=CC=O)=O,,,3,1,1,0,1
2985_0,,,,2,2,2,4
C(CN(C)CC(C(C(C=C)=O)O)=O)=O,,,3,1,1,0,1
2987_0,,,,2,2,2,4
C(C(C=O)O)(C(C=C)N(C)CC=O)=O,,,3,1,1,0,1
2989_0,,,,2,2,2,4
C(CN(C)CC(C=CC(CO)=O)=O)=O,,,3,1,1,0,1
2991_0,,,,2,2,2,4
C(C(C=CC(C=O)O)N(C)CC=O)=O,,,3,1,1,0,1
2993_0,,,,2,2,2,4
C(CN(C)CC(C(C=CC=O)O)=O)=O,,,3,1,1,0,1
2995_0,,,,2,2,2,4
C(CN(C)CC=O)(C(CO)NC)=O,,,3,1,1,0,1
2997_0,,,,2,2,2,4
C(CN(C)C(C=O)C(CO)=O)=O,,,3,1,1,0,1
2999_0,,,,2,2,2,4
C(CN(C)CC(O)=O)=O,,,3,1,1,0,1
3001_0,,,,2,2,2,4
C(CO)(C(CNC)N)=O,,,3,1,1,0,1
3003_0,,,,2,2,2,4
C(CO)(C(CNC)NCCO)=O,,,3,1,1,0,1
3005_0,,,,2,2,2,4
C(CN(C)CC(O)=O)(C(CO)O)=O,,,3,1,1,0,1
3007_0,,,,2,2,2,4
C(C(CO)O)(C(C(CO)NC)N)=O,,,3,1,1,0,1
3009_0,,,,2,2,2,4
C(CC(C(C(CO)=O)N)NC)=O,,,3,1,1,0,1
3011_0,,,,2,2,2,4
C(CNC)(CC(C(CO)=O)N)=O,,,3,1,1,0,1
3013_0,,,,2,2,2,4
C(CC(C(CO)=O)NC)(CN)=O,,,3,1,1,0,1
3015_0,,,,2,2,2,4
C(C(C(CC(C=O)O)NC)N)=O,,,3,1,1,0,1
3017_0,,,,2,2,2,4
C(C(C(CNC)N)=O)(CCO)=O,,,3,1,1,0,1
3019_0,,,,2,2,2,4
C(C(CNC)=O)(C(CCO)N)=O,,,3,1,1,0,1
3021_0,,,,2,2,2,4
C(C(CN)=O)(C(CCO)NC)=O,,,3,1,1,0,1
3023_0,,,,2,2,2,4
C(C(C(C(CCO)NC)N)=O)=O,,,3,1,1,0,1
3025_0,,,,2,2,2,4
C(C(CNC)N)(CC(CO)=O)=O,,,3,1,1,0,1
3027_0,,,,2,2,2,4
C(C(CC(C(CNC)=O)O)N)=O,,,3,1,1,0,1
3029_0,,,,2,2,2,4
C(C(CC(C(CN)=O)O)NC)=O,,,3,1,1,0,1
3031_0,,,,2,2,2,4
C(C(CNC)N)(C(C(C)=O)O)=O,,,3,1,1,0,1
3033_0,,,,2,2,2,4
C(C(C)N)(C(C(CNC)=O)O)=O,,,3,1,1,0,1
3035_0,,,,2,2,2,4
C(C(C)NC)(C(C(CN)=O)O)=O,,,3,1,1,0,1
3037_0,,,,2,2,2,4
C(C(C(C(C(C)NC)N)=O)O)=O,,,3,1,1,0,1
3039_0,,,,2,2,2,4
C(CC(C(C(CNC)N)=O)O)=O,,,3,1,1,0,1
3041_0,,,,2,2,2,4
C(C(C(C=O)NC)N)(C(CO)O)=O,,,3,1,1,0,1
3043_0,,,,2,2,2,4
C(CN(CC(O)=O)CC(O)=O)=O,,,3,1,1,0,1
3045_0,,,,2,2,2,4
C(CO)(C(CNCC(O)=O)N)=O,,,3,1,1,0,1
3047_0,,,,2,2,2,4
C(C(C(CO)O)O)(C(CNC)N)=O,,,3,1,1,0,1
3048_0,,,,2,2,2,4
3050_0,,,,2,2,2,4
C(C(CO)O)(C(CCO)N)=O,,,3,1,1,0,1
3051_0,,,,2,2,2,4
3053_0,,,,2,2,2,4
C(C(C(CO)O)O)(C(C)N)=O,,,3,1,1,0,1
3055_0,,,,2,2,2,4
C(CN)(C(C(CCO)O)O)=O,,,3,1,1,0,1
3057_0,,,,2,2,2,4
C(CC(C(C(CO)O)=O)N)(O)=O,,,3,1,1,0,1
3059_0,,,,2,2,2,4
C(C(C(CC(CO)O)N)=O)(O)=O,,,3,1,1,0,1
3061_0,,,,2,2,2,4
C(C(CC(C(CO)=O)N)O)(O)=O,,,3,1,1,0,1
3063_0,,,,2,2,2,4
C(C(C(C(CCO)N)=O)O)(O)=O,,,3,1,1,0,1
3065_0,,,,2,2,2,4
C(C(CC(C(C(O)=O)O)O)N)=O,,,3,1,1,0,1
3067_0,,,,2,2,2,4
C(C(C(C(O)=O)O)O)(C(C)N)=O,,,3,1,1,0,1
3069_0,,,,2,2,2,4
C(CC(C(C(CN)=O)O)O)(O)=O,,,3,1,1,0,1
3071_0,,,,2,2,2,4
C(C(C(C(C(CO)O)O)=O)N)(O)=O,,,3,1,1,0,1
3073_0,,,,2,2,2,4
C(C(CO)(CO)O)(CC(CN)=O)=O,,,3,1,1,0,1
3075_0,,,,2,2,2,4
C(C(C(C(CCO)N)=O)(CO)O)=O,,,3,1,1,0,1
3077_0,,,,2,2,2,4
C(CCO)(C(C(CN)=O)(CO)O)=O,,,3,1,1,0,1
3079_0,,,,2,2,2,4
C(C(CO)(C(CC(C=O)N)O)O)=O,,,3,1,1,0,1
3081_0,,,,2,2,2,4
C(C(CO)(C(C(C(C)N)=O)O)O)=O,,,3,1,1,0,1
3083_0,,,,2,2,2,4
C(C)(C(CO)(C(C(CN)=O)O)O)=O,,,3,1,1,0,1
3085_0,,,,2,2,2,4
C(C(CO)(CC(C(CO)=O)N)O)=O,,,3,1,1,0,1
3087_0,,,,2,2,2,4
C(C(C(CO)O)NCC(O)=O)(O)=O,,,3,1,1,0,1
3089_0,,,,2,2,2,4
C(C(C(O)=O)NCC(O)=O)(O)=O,,,3,1,1,0,1
3091_0,,,,2,2,2,4
C(C(CO)NCC(O)=O)(O)=O,,,3,1,1,0,1
3093_0,,,,2,2,2,4
C(C(C(C(C(CO)O)O)NC)N)=O,,,3,1,13,0,13
3095_0,,,,2,2,2,4
C(C(CO)NC)(CC(CN)=O)=O,,,3,1,1,0,1
3097_0,,,,2,2,2,4
C(CCO)(C(C(CN)=O)NC)=O,,,3,1,1,0,1
3099_0,,,,2,2,2,4
C(C(C(C(C)=O)NC)O)(CN)=O,,,3,1,1,0,1
3101_0,,,,2,2,2,4
C(C(C(CO)O)O)(C(CN)N)=O,,,3,1,1,0,1
3103_0,,,,2,2,2,4
C(C(CCC(C=O)=O)N)=O,,,3,1,1,0,1
3105_0,,,,2,2,2,4
C(C(CCC(C=O)=O)NCCO)=O,,,3,1,1,0,1
3107_0,,,,2,2,2,4
C(C(C)N)(CC(C=O)=O)=O,,,3,1,1,0,1
3109_0,,,,2,2,2,4
C(C(C)NCCO)(CC(C=O)=O)=O,,,3,1,1,0,1
3111_0,,,,2,2,2,4
C(CC(CC(C=O)N)=O)=O,,,3,1,2,0,2
3113_0,,,,2,2,2,4
C(CC(C=O)NCCO)(CC=O)=O,,,3,1,2,0,2
3115_0,,,,2,2,2,4
C(CC(C(C(C)=O)=O)N)=O,,,3,1,1,0,1
3117_0,,,,2,2,2,4
C(CC(C(C(C)N)=O)=O)=O,,,3,1,1,0,1
3119_0,,,,2,2,2,4
C(CC(C(C(C)=O)=O)NCCO)=O,,,3,1,1,0,1
3121_0,,,,2,2,2,4
C(CC(C(C(C)NCCO)=O)=O)=O,,,3,1,1,0,1
3123_0,,,,2,2,2,4
C(CC(C(CC=O)N)=O)=O,,,3,1,3,0,3
3123_1,,,,2,2,2,4
3123_2,,,,2,2,2,4
3125_0,,,,2,2,2,4
C(CC(C(CC=O)=O)NCCO)=O,,,3,1,3,0,3
3125_1,,,,2,2,2,4
3125_2,,,,2,2,2,4
3127_0,,,,2,2,2,4
C(C)(CC(C(CN)=O)=O)=O,,,3,1,1,0,1
3129_0,,,,2,2,2,4
C(C)(CC(C(C=O)=O)N)=O,,,3,1,1,0,1
3131_0,,,,2,2,2,4
C(C)(CC(C(CNCCO)=O)=O)=O,,,3,1,1,0,1
3133_0,,,,2,2,2,4
C(CC(C(C=O)=O)NCCO)(C)=O,,,3,1,1,0,1
3135_0,,,,2,2,2,4
C(CCC(C(CN)=O)=O)=O,,,3,1,1,0,1
3137_0,,,,2,2,2,4
C(CCC(C(C=O)=O)N)=O,,,3,1,1,0,1
3139_0,,,,2,2,2,4
C(CCC(C(CNCCO)=O)=O)=O,,,3,1,1,0,1
3141_0,,,,2,2,2,4
C(CCC(C(C=O)=O)NCCO)=O,,,3,1,1,0,1
3143_0,,,,2,2,2,4
C(CN)(CC(C(C)=O)=O)=O,,,3,1,1,0,1
3145_0,,,,2,2,2,4
C(CNCCO)(CC(C(C)=O)=O)=O,,,3,1,1,0,1
3147_0,,,,2,2,2,4
C(CC(CC(CN)=O)=O)=O,,,3,1,1,0,1
3149_0,,,,2,2,2,4
C(CC(CC(CNCCO)=O)=O)=O,,,3,1,1,0,1
3151_0,,,,2,2,2,4
C1(C(C(CO)O)OCC1N)=O,,,3,1,1,0,1
3153_0,,,,2,2,2,4
C1(C(CC(C(CO)O)O1)N)=O,,,3,1,1,0,1
3155_0,,,,2,2,2,4
C1(C(C(CO)OCC1N)O)=O,,,3,1,1,0,1
3157_0,,,,2,2,2,4
C1(C(CC(C(CO)O1)O)N)=O,,,3,1,1,0,1
3159_0,,,,2,2,2,4
C1(C(CO)OC(CC1N)O)=O,,,3,1,1,0,1
3161_0,,,,2,2,2,4
C1(C(O)OC(CO)CC1N)=O,,,3,1,1,0,1
3163_0,,,,2,2,2,4
C1(C(C(COCC1N)O)O)=O,,,3,1,1,0,1
3165_0,,,,2,2,2,4
C1(C(CC(C(CO1)O)O)N)=O,,,3,1,1,0,1
3167_0,,,,2,2,2,4
C1(C(COC(CC1N)O)O)=O,,,3,1,1,0,1
3169_0,,,,2,2,2,4
C1(C(O)OCC(CC1N)O)=O,,,3,1,1,0,1
3171_0,,,,2,2,2,4
C1(COC(C(CC1N)O)O)=O,,,3,1,1,0,1
3173_0,,,,2,2,2,4
C1(C(C(O)OCCC1N)O)=O,,,3,1,1,0,1
3175_0,,,,2,2,2,4
C(C(CO)O)(C(CCN)N)=O,,,3,1,1,0,1
3177_0,,,,2,2,2,4
C(CN)(C(CC(CO)O)N)=O,,,3,1,2,0,2
3179_0,,,,2,2,2,4
C(CO)(C(CC(CN)O)N)=O,,,3,1,1,0,1
3181_0,,,,2,2,2,4
C(C(CN)O)(C(CCO)N)=O,,,3,1,1,0,1
3183_0,,,,2,2,2,4
C(C(CC(C(CN)O)O)N)=O,,,3,1,1,0,1
3185_0,,,,2,2,2,4
C(C(C(CN)O)O)(C(C)N)=O,,,3,1,1,0,1
3187_0,,,,2,2,2,4
C(C(CCC(C(O)=O)O)N)=O,,,3,1,1,0,1
3189_0,,,,2,2,2,4
C(CC(C(O)=O)O)(C(C)N)=O,,,3,1,1,0,1
3191_0,,,,2,2,2,4
C(CO)(C(CC(C=O)=O)N)=O,,,3,1,1,0,1
3193_0,,,,2,2,2,4
C(C(C(C(CCO)=O)=O)N)=O,,,3,1,1,0,1
3195_0,,,,2,2,2,4
C(C(C(C(CCO)N)=O)=O)=O,,,3,1,1,0,1
3197_0,,,,2,2,2,4
C(C(C=O)N)(CC(CO)=O)=O,,,3,1,1,0,1
3199_0,,,,2,2,2,4
C(C(CC(C(C=O)=O)O)N)=O,,,3,1,1,0,1
3201_0,,,,2,2,2,4
C(C(C(C(C(C)=O)O)=O)N)=O,,,3,1,1,0,1
3203_0,,,,2,2,2,4
C(C(C)N)(C(C(C=O)=O)O)=O,,,3,1,1,0,1
3205_0,,,,2,2,2,4
C(C(C(C(CC=O)O)=O)N)=O,,,3,1,1,0,1
3207_0,,,,2,2,2,4
C(CO)=CC(C(CN)=O)=O,,,3,1,1,0,1
3209_0,,,,2,2,2,4
C(C(C(C=O)=O)N)=CCO,,,3,1,1,0,1
3211_0,,,,2,2,2,4
C(CO)=CC(C(CNCCO)=O)=O,,,3,1,1,0,1
3213_0,,,,2,2,2,4
C(C(C(C=O)=O)NCCO)=CCO,,,3,1,1,0,1
3215_0,,,,2,2,2,4
C(CO)(C(C=CC=O)N)=O,,,3,1,1,0,1
3217_0,,,,2,2,2,4
C(CO)(C(C=CC=O)NCCO)=O,,,3,1,1,0,1
3219_0,,,,2,2,2,4
C(CN)(C(C(C=C)=O)O)=O,,,3,1,1,0,1
3221_0,,,,2,2,2,4
C(C(C(C(C=C)N)=O)O)=O,,,3,1,1,0,1
3223_0,,,,2,2,2,4
C(CNCCO)(C(C(C=C)=O)O)=O,,,3,1,1,0,1
3225_0,,,,2,2,2,4
C(C(C=O)O)(C(C=C)NCCO)=O,,,3,1,1,0,1
3227_0,,,,2,2,2,4
C(C=CC(CN)=O)(CO)=O,,,3,1,1,0,1
3229_0,,,,2,2,2,4
C(C(C=CC(C=O)N)O)=O,,,3,1,1,0,1
3231_0,,,,2,2,2,4
C(C=CC(CO)=O)(CNCCO)=O,,,3,1,1,0,1
3233_0,,,,2,2,2,4
C(C(C=CC(C=O)O)NCCO)=O,,,3,1,1,0,1
3235_0,,,,2,2,2,4
C(CN)(C(C=CC=O)O)=O,,,3,1,1,0,1
3237_0,,,,2,2,2,4
C(CNCCO)(C(C=CC=O)O)=O,,,3,1,1,0,1
3239_0,,,,2,2,2,4
C(CN)(C(CO)NC)=O,,,3,1,1,0,1
3241_0,,,,2,2,2,4
C(C(C(C(C(CO)O)NC)O)N)=O,,,3,1,12,0,12
3243_0,,,,2,2,2,4
C(C(C(CO)O)NC)(C(CO)N)=O,,,3,1,1,0,1
3245_0,,,,2,2,2,4
C(CC(C(C(CO)NC)=O)N)=O,,,3,1,1,0,1
3247_0,,,,2,2,2,4
C(C(CN)=O)(CC(CO)NC)=O,,,3,1,1,0,1
3249_0,,,,2,2,2,4
C(C(C(CC(CO)NC)N)=O)=O,,,3,1,1,0,1
3251_0,,,,2,2,2,4
C(C(CC(C(CO)=O)N)NC)=O,,,3,1,1,0,1
3253_0,,,,2,2,2,4
C(C(CNC)O)(CC(CN)=O)=O,,,3,1,1,0,1
3255_0,,,,2,2,2,4
C(C(CC(C(CNC)=O)N)O)=O,,,3,1,1,0,1
3257_0,,,,2,2,2,4
C(C(C(C(CCO)N)=O)NC)=O,,,3,1,1,0,1
3259_0,,,,2,2,2,4
C(CCNC)(C(C(CN)=O)O)=O,,,3,1,1,0,1
3261_0,,,,2,2,2,4
C(C(C(C(CCNC)N)=O)O)=O,,,3,1,1,0,1
3263_0,,,,2,2,2,4
C(CC(C(CN)=O)NC)(CO)=O,,,3,1,1,0,1
3265_0,,,,2,2,2,4
C(C(CC(C(C=O)O)NC)N)=O,,,3,1,1,0,1
3267_0,,,,2,2,2,4
C(C(C(C(CN)=O)NC)O)(C)=O,,,3,1,1,0,1
3269_0,,,,2,2,2,4
C(C(C(C(C(C)N)=O)NC)O)=O,,,3,1,1,0,1
3271_0,,,,2,2,2,4
C(CC(C(C(CN)=O)NC)O)=O,,,3,1,1,0,1
3273_0,,,,2,2,2,4
C(CC(C(C(CN)=O)O)NC)=O,,,3,1,1,0,1
3275_0,,,,2,2,2,4
C(C(C(C(C(CO)O)NC)=O)N)=O,,,3,1,1,0,1
3277_0,,,,2,2,2,4
C(CNC(C(CN)=O)CO)(O)=O,,,3,1,1,0,1
3279_0,,,,2,2,2,4
C(CN)(C(C(C(CO)O)O)NC)=O,,,3,1,13,0,13
3281_0,,,,2,2,2,4
C(CN)(C1(CC(CO1)O)O)=O,,,3,1,1,0,1
3283_0,,,,2,2,2,4
C(CN)(C1C(CC(O1)O)O)=O,,,3,1,1,0,1
3285_0,,,,2,2,2,4
C1(C(C(C(C(CO)O)O1)O)N)=O,,,3,1,2,0,2
3287_0,,,,2,2,2,4
C1(C(C(CO)O)OC(C1N)O)=O,,,3,1,1,0,1
3289_0,,,,2,2,2,4
C1(C(C(C(C(CO)O1)O)O)N)=O,,,3,1,2,0,2
3291_0,,,,2,2,2,4
C1(C(C(CO)OC(C1N)O)O)=O,,,3,1,1,0,1
3293_0,,,,2,2,2,4
C1(C(C(C(C(CO1)O)O)O)N)=O,,,3,1,2,0,2
3295_0,,,,2,2,2,4
C1(C(C(COC(C1N)O)O)O)=O,,,3,1,1,0,1
3296_0,,,,2,2,2,4
3298_0,,,,2,2,2,4
C(CN)(CC(C(CO)O)N)=O,,,3,1,2,0,2
3300_0,,,,2,2,2,4
C(CN)(C(C(CCO)N)O)=O,,,3,1,1,0,1
3302_0,,,,2,2,2,4
C(CN)(C(CC(CO)N)O)=O,,,3,1,1,0,1
3304_0,,,,2,2,2,4
C(CN)(C(C(C(C)N)O)O)=O,,,3,1,1,0,1
3306_0,,,,2,2,2,4
C(CN)(C(C(CCN)O)O)=O,,,3,1,1,0,1
3308_0,,,,2,2,2,4
C(C(C(CO)=O)N)=O,,,3,1,1,0,1
3309_0,,,,2,2,2,4
3310_0,,,,2,2,2,4
3312_0,,,,2,2,2,4
C(CNCCO)(C(CO)NC)=O,,,3,1,1,0,1
3314_0,,,,2,2,2,4
C(C(C(CO)N(C)CC(O)=O)O)=O,,,3,1,1,0,1
3316_0,,,,2,2,2,4
C(C(C(CO)=O)NCCO)=O,,,3,1,1,0,1
3318_0,,,,2,2,2,4
C(CNCCO)(O)=O,,,3,1,2,0,2
3320_0,,,,2,2,2,4
C(CNCC(C(CO)O)O)(O)=O,,,3,1,1,0,1
3322_0,,,,2,2,2,4
C(CNCC(C(O)=O)=O)(O)=O,,,3,1,1,0,1
3324_0,,,,2,2,2,4
C(C(C(CNCC(O)=O)=O)O)(O)=O,,,3,1,1,0,1
3325_0,,,,2,2,2,4
3326_0,,,,2,2,2,4
3328_0,,,,2,2,2,4
C(CC(C=O)NCC(O)=O)=O,,,3,1,2,0,2
3330_0,,,,2,2,2,4
C(CNCC(C(C)=O)=O)(O)=O,,,3,1,2,0,2
3332_0,,,,2,2,2,4
C(CNC(C(C=O)=O)C)(O)=O,,,3,1,1,0,1
3334_0,,,,2,2,2,4
C(CNC(C(CO)=O)C)(O)=O,,,3,1,1,0,1
3336_0,,,,2,2,2,4
C(CNCC(CC(CO)=O)=O)(O)=O,,,3,1,1,0,1
3338_0,,,,2,2,2,4
C(C(CC(C=O)O)NCC(O)=O)=O,,,3,1,1,0,1
3340_0,,,,2,2,2,4
C(C(CCO)NCC(O)=O)=O,,,3,1,1,0,1
3342_0,,,,2,2,2,4
C(CNCC(C(C(C)=O)O)=O)(O)=O,,,3,1,1,0,1
3344_0,,,,2,2,2,4
C(C(C)NCC(O)=O)(C(C=O)O)=O,,,3,1,1,0,1
3346_0,,,,2,2,2,4
C(CNCC(C=O)=O)(O)=O,,,3,1,1,0,1
3348_0,,,,2,2,2,4
C(C(C)NCC(O)=O)=O,,,3,1,1,0,1
3350_0,,,,2,2,2,4
C(CC(CNCC(O)=O)=O)=O,,,3,1,2,0,2
3352_0,,,,2,2,2,4
C(C(C(CNCC(O)=O)=O)O)=O,,,3,1,1,0,1
3354_0,,,,2,2,2,4
C(C(C=O)NCC(O)=O)=O,,,3,1,1,0,1
3355_0,,,,2,2,2,4
3356_0,,,,2,2,2,4
3356_1,,,,2,2,2,4
3358_0,,,,2,2,2,4
C(CNC(C(CO)=O)CNC)(O)=O,,,3,1,1,0,1
3360_0,,,,2,2,2,4
C(CNCC(O)=O)(C(CO)NC)=O,,,3,1,2,0,2
3362_0,,,,2,2,2,4
C(C(C(CO)=O)NCC(O)=O)=O,,,3,1,1,0,1
3364_0,,,,2,2,2,4
C(CNCC(O)=O)(O)=O,,,3,1,2,0,2
3366_0,,,,2,2,2,4
C(CN(C)CC=O)=O,,,3,1,1,0,1
3368_0,,,,2,2,2,4
C(CN(C)CC=O)(C(CO)O)=O,,,3,1,2,0,2
3370_0,,,,2,2,2,4
C(CN(CC=O)CC(O)=O)=O,,,3,1,1,0,1
3372_0,,,,2,2,2,4
C(C(C(CO)O)NCC=O)(O)=O,,,3,1,2,0,2
3374_0,,,,2,2,2,4
C(C(C(O)=O)NCC=O)(O)=O,,,3,1,3,0,3
3376_0,,,,2,2,2,4
C(C(C(C(O)=O)NCC=O)O)(O)=O,,,3,1,2,0,2
3378_0,,,,2,2,2,4
C(C(CO)NCC=O)(O)=O,,,3,1,2,0,2
3379_0,,,,2,2,2,4
3381_0,,,,2,2,2,4
C(C(C(CO)N(C)CC=O)O)=O,,,3,1,2,0,2
3383_0,,,,2,2,2,4
C(CNCCO)=O,,,3,1,2,0,2
3385_0,,,,2,2,2,4
C(CNCC(C(CO)O)O)=O,,,3,1,2,0,2
3386_0,,,,2,2,2,4
3388_0,,,,2,2,2,4
C(CN)(C(CO)O)=O,,,3,1,12,0,12
3390_0,,,,2,2,2,4
C(CNCCO)(C(CO)O)=O,,,3,1,2,0,2
3391_0,,,,2,2,2,4
3393_0,,,,2,2,2,4
C(C(C(CO)O)O)(C(CO)N)=O,,,3,1,2,0,2
3395_0,,,,2,2,2,4
C1(C(C(C(CO)C1NC)O)O)=O,,,3,1,1,0,1
3396_0,,,,2,2,2,4
3398_0,,,,2,2,2,4
C(C(O)=O)(CNC)=O,,,3,1,1,0,1
3400_0,,,,2,2,2,4
C(C(C(CNC)=O)O)(O)=O,,,3,1,1,0,1
3401_0,,,,2,2,2,4
3402_0,,,,2,2,2,4
3403_0,,,,2,2,2,4
3404_0,,,,2,2,2,4
3405_0,,,,2,2,2,4
3406_0,,,,2,2,2,4
3407_0,,,,2,2,2,4
3409_0,,,,2,2,2,4
C(C(CC(C=O)O)NC)=O,,,3,1,1,0,1
3411_0,,,,2,2,2,4
C(C(CCO)NC)=O,,,3,1,1,0,1
3412_0,,,,2,2,2,4
3414_0,,,,2,2,2,4
C(C(C(C(C)NC)=O)O)=O,,,3,1,1,0,1
3415_0,,,,2,2,2,4
3417_0,,,,2,2,2,4
C(C(C)NC)=O,,,3,1,1,0,1
3418_0,,,,2,2,2,4
3419_0,,,,2,2,2,4
3421_0,,,,2,2,2,4
C(C(C=O)NC)=O,,,3,1,1,0,1
3422_0,,,,2,2,2,4
3423_0,,,,2,2,2,4
3423_1,,,,2,2,2,4
3424_0,,,,2,2,2,4
3425_0,,,,2,2,2,4
3425_1,,,,2,2,2,4
3426_0,,,,2,2,2,4
3427_0,,,,2,2,2,4
3428_0,,,,2,2,2,4
3429_0,,,,2,2,2,4
3430_0,,,,2,2,2,4
3431_0,,,,2,2,2,4
3432_0,,,,2,2,2,4
3433_0,,,,2,2,2,4
3434_0,,,,2,2,2,4
3435_0,,,,2,2,2,4
3437_0,,,,2,2,2,4
C(C(C(CO)NC)=O)(CCO)=O,,,3,1,2,0,2
3438_0,,,,2,2,2,4
3439_0,,,,2,2,2,4
3441_0,,,,2,2,2,4
C(C(C(C(CCO)O)NC)=O)=O,,,3,1,1,0,1
3442_0,,,,2,2,2,4
3443_0,,,,2,2,2,4
3444_0,,,,2,2,2,4
3445_0,,,,2,2,2,4
3446_0,,,,2,2,2,4
3448_0,,,,2,2,2,4
C(C(C(CC(CNC)=O)O)O)=O,,,3,1,1,0,1
3449_0,,,,2,2,2,4
3451_0,,,,2,2,2,4
C(C(CO)NC)(C(C(C)=O)O)=O,,,3,1,2,0,2
3452_0,,,,2,2,2,4
3453_0,,,,2,2,2,4
3455_0,,,,2,2,2,4
C(C(C(C(C(C)O)NC)=O)O)=O,,,3,1,1,0,1
3456_0,,,,2,2,2,4
3457_0,,,,2,2,2,4
3458_0,,,,2,2,2,4
3460_0,,,,2,2,2,4
C(C(CNC)=O)(C(C(CO)O)O)=O,,,3,1,1,0,1
3461_0,,,,2,2,2,4
3462_0,,,,2,2,2,4
3464_0,,,,2,2,2,4
C(CO)(C(CNC)NC)=O,,,3,1,1,0,1
3466_0,,,,2,2,2,4
C(CC(C(C(CO)=O)NC)NC)=O,,,3,1,1,0,1
3468_0,,,,2,2,2,4
C(CC(C(CO)=O)NC)(CNC)=O,,,3,1,2,0,2
3469_0,,,,2,2,2,4
3471_0,,,,2,2,2,4
C(C(C(CC(C=O)O)NC)NC)=O,,,3,1,1,0,1
3473_0,,,,2,2,2,4
C(C(C(CNC)NC)=O)(CCO)=O,,,3,1,1,0,1
3475_0,,,,2,2,2,4
C(C(CNC)=O)(C(CCO)NC)=O,,,3,1,2,0,2
3476_0,,,,2,2,2,4
3478_0,,,,2,2,2,4
C(C(C(C(CCO)NC)NC)=O)=O,,,3,1,1,0,1
3480_0,,,,2,2,2,4
C(C(CNC)NC)(CC(CO)=O)=O,,,3,1,1,0,1
3482_0,,,,2,2,2,4
C(C(CC(C(CNC)=O)O)NC)=O,,,3,1,2,0,2
3483_0,,,,2,2,2,4
3485_0,,,,2,2,2,4
C(C(CNC)NC)(C(C(C)=O)O)=O,,,3,1,1,0,1
3487_0,,,,2,2,2,4
C(C(C)NC)(C(C(CNC)=O)O)=O,,,3,1,2,0,2
3488_0,,,,2,2,2,4
3490_0,,,,2,2,2,4
C(C(C(C(C(C)NC)NC)=O)O)=O,,,3,1,1,0,1
3492_0,,,,2,2,2,4
C(CC(C(C(CNC)NC)=O)O)=O,,,3,1,1,0,1
3494_0,,,,2,2,2,4
C(CNCC(C(CO)=O)NC)(O)=O,,,3,1,1,0,1
3496_0,,,,2,2,2,4
C(C(CC(C(CO)O)O)NC)=O,,,3,1,2,0,2
3498_0,,,,2,2,2,4
C(C(CO)O)(C(CCO)NC)=O,,,3,1,3,0,3
3500_0,,,,2,2,2,4
C(CO)(C(CC(CO)O)NC)=O,,,3,1,3,0,3
3502_0,,,,2,2,2,4
C(C(C(CO)O)O)(C(C)NC)=O,,,3,1,2,0,2
3504_0,,,,2,2,2,4
C(CNC)(C(C(CCO)O)O)=O,,,3,1,2,0,2
3506_0,,,,2,2,2,4
C(CC(C(C(CO)O)=O)NC)(O)=O,,,3,1,2,0,2
3508_0,,,,2,2,2,4
C(C(C(CC(CO)O)NC)=O)(O)=O,,,3,1,2,0,2
3510_0,,,,2,2,2,4
C(C(CC(C(CO)=O)NC)O)(O)=O,,,3,1,3,0,3
3512_0,,,,2,2,2,4
C(C(C(C(CCO)NC)=O)O)(O)=O,,,3,1,3,0,3
3514_0,,,,2,2,2,4
C(C(CC(C(C(O)=O)O)O)NC)=O,,,3,1,3,0,3
3516_0,,,,2,2,2,4
C(C(C(C(O)=O)O)O)(C(C)NC)=O,,,3,1,3,0,3
3518_0,,,,2,2,2,4
C(CC(C(C(CNC)=O)O)O)(O)=O,,,3,1,2,0,2
3520_0,,,,2,2,2,4
C(C(CO)NC)(CC(CNC)=O)=O,,,3,1,2,0,2
3522_0,,,,2,2,2,4
C(CCO)(C(C(CNC)=O)NC)=O,,,3,1,2,0,2
3524_0,,,,2,2,2,4
C(C(C(C(CNC)=O)O)NC)(C)=O,,,3,1,3,0,3
3526_0,,,,2,2,2,4
C(C(C(CO)O)O)(C(CN)NC)=O,,,3,1,14,0,14
3528_0,,,,2,2,2,4
C(C(CCC(C=O)=O)NC)=O,,,3,1,2,0,2
3530_0,,,,2,2,2,4
C(C(C)NC)(CC(C=O)=O)=O,,,3,1,2,0,2
3532_0,,,,2,2,2,4
C(CC(C=O)NC)(CC=O)=O,,,3,1,4,0,4
3534_0,,,,2,2,2,4
C(CC(C(C(C)=O)=O)NC)=O,,,3,1,2,0,2
3536_0,,,,2,2,2,4
C(CC(C(C(C)NC)=O)=O)=O,,,3,1,2,0,2
3538_0,,,,2,2,2,4
C(CC(C(CC=O)=O)NC)=O,,,3,1,6,0,6
3538_1,,,,2,2,2,4
3538_2,,,,2,2,2,4
3540_0,,,,2,2,2,4
C(C)(CC(C(CNC)=O)=O)=O,,,3,1,3,0,3
3542_0,,,,2,2,2,4
C(CC(C(C=O)=O)NC)(C)=O,,,3,1,2,0,2
3544_0,,,,2,2,2,4
C(CCC(C(CNC)=O)=O)=O,,,3,1,3,0,3
3546_0,,,,2,2,2,4
C(CCC(C(C=O)=O)NC)=O,,,3,1,2,0,2
3548_0,,,,2,2,2,4
C(CNC)(CC(C(C)=O)=O)=O,,,3,1,3,0,3
3550_0,,,,2,2,2,4
C(CC(CC(CNC)=O)=O)=O,,,3,1,3,0,3
3552_0,,,,2,2,2,4
C1(C(C(CO)O)OCC1NC)=O,,,3,1,1,0,1
3554_0,,,,2,2,2,4
C1(C(CC(C(CO)O)O1)NC)=O,,,3,1,1,0,1
3556_0,,,,2,2,2,4
C1(C(C(CO)OCC1NC)O)=O,,,3,1,1,0,1
3558_0,,,,2,2,2,4
C1(C(CC(C(CO)O1)O)NC)=O,,,3,1,1,0,1
3560_0,,,,2,2,2,4
C1(C(CO)OC(CC1NC)O)=O,,,3,1,2,0,2
3562_0,,,,2,2,2,4
C1(C(O)OC(CO)CC1NC)=O,,,3,1,2,0,2
3564_0,,,,2,2,2,4
C1(C(C(COCC1NC)O)O)=O,,,3,1,1,0,1
3566_0,,,,2,2,2,4
C1(C(CC(C(CO1)O)O)NC)=O,,,3,1,1,0,1
3568_0,,,,2,2,2,4
C1(C(COC(CC1NC)O)O)=O,,,3,1,2,0,2
3570_0,,,,2,2,2,4
C1(C(O)OCC(CC1NC)O)=O,,,3,1,2,0,2
3572_0,,,,2,2,2,4
C1(COC(C(CC1NC)O)O)=O,,,3,1,2,0,2
3574_0,,,,2,2,2,4
C1(C(C(O)OCCC1NC)O)=O,,,3,1,2,0,2
3576_0,,,,2,2,2,4
C(C(CO)O)(C(CCN)NC)=O,,,3,1,13,0,13
3578_0,,,,2,2,2,4
C(CN)(C(CC(CO)O)NC)=O,,,3,1,12,0,12
3580_0,,,,2,2,2,4
C(CO)(C(CC(CN)O)NC)=O,,,3,1,13,0,13
3582_0,,,,2,2,2,4
C(C(CN)O)(C(CCO)NC)=O,,,3,1,13,0,13
3584_0,,,,2,2,2,4
C(C(CC(C(CN)O)O)NC)=O,,,3,1,13,0,13
3586_0,,,,2,2,2,4
C(C(C(CN)O)O)(C(C)NC)=O,,,3,1,13,0,13
3588_0,,,,2,2,2,4
C(C(CCC(C(O)=O)O)NC)=O,,,3,1,2,0,2
3590_0,,,,2,2,2,4
C(CC(C(O)=O)O)(C(C)NC)=O,,,3,1,2,0,2
3592_0,,,,2,2,2,4
C(C(CC(C=O)=O)NC)(CO)=O,,,3,1,2,0,2
3594_0,,,,2,2,2,4
C(C(C(C(CCO)=O)=O)NC)=O,,,3,1,2,0,2
3596_0,,,,2,2,2,4
C(C(C(C(CCO)NC)=O)=O)=O,,,3,1,1,0,1
3598_0,,,,2,2,2,4
C(C(C=O)NC)(CC(CO)=O)=O,,,3,1,2,0,2
3600_0,,,,2,2,2,4
C(C(CC(C(C=O)=O)O)NC)=O,,,3,1,2,0,2
3602_0,,,,2,2,2,4
C(C(C(C(C(C)=O)O)=O)NC)=O,,,3,1,2,0,2
3604_0,,,,2,2,2,4
C(C(C)NC)(C(C(C=O)=O)O)=O,,,3,1,2,0,2
3606_0,,,,2,2,2,4
C(CC(C(C(C=O)NC)=O)O)=O,,,3,1,2,0,2
3608_0,,,,2,2,2,4
C(CO)=CC(C(CNC)=O)=O,,,3,1,2,0,2
3610_0,,,,2,2,2,4
C(C(C(C=O)=O)NC)=CCO,,,3,1,2,0,2
3612_0,,,,2,2,2,4
C(CO)(C(C=CC=O)NC)=O,,,3,1,2,0,2
3614_0,,,,2,2,2,4
C(CNC)(C(C(C=C)=O)O)=O,,,3,1,2,0,2
3616_0,,,,2,2,2,4
C(C(C=O)O)(C(C=C)NC)=O,,,3,1,2,0,2
3618_0,,,,2,2,2,4
C(C=CC(CO)=O)(CNC)=O,,,3,1,2,0,2
3620_0,,,,2,2,2,4
C(C(C=CC(C=O)O)NC)=O,,,3,1,2,0,2
3622_0,,,,2,2,2,4
C(CNC)(C(C=CC=O)O)=O,,,3,1,2,0,2
3624_0,,,,2,2,2,4
C(CNC)(C(CO)NC)=O,,,3,1,2,0,2
3626_0,,,,2,2,2,4
C(CC(C(C(CO)NC)=O)NC)=O,,,3,1,2,0,2
3628_0,,,,2,2,2,4
C(C(CNC)=O)(CC(CO)NC)=O,,,3,1,2,0,2
3630_0,,,,2,2,2,4
C(C(C(CC(CO)NC)NC)=O)=O,,,3,1,1,0,1
3632_0,,,,2,2,2,4
C(C(CC(C(CO)=O)NC)NC)=O,,,3,1,1,0,1
3634_0,,,,2,2,2,4
C(C(CNC)O)(CC(CNC)=O)=O,,,3,1,2,0,2
3636_0,,,,2,2,2,4
C(C(CC(C(CNC)=O)NC)O)=O,,,3,1,1,0,1
3638_0,,,,2,2,2,4
C(C(C(C(CCO)NC)=O)NC)=O,,,3,1,2,0,2
3640_0,,,,2,2,2,4
C(CCNC)(C(C(CNC)=O)O)=O,,,3,1,2,0,2
3642_0,,,,2,2,2,4
C(C(C(C(CCNC)NC)=O)O)=O,,,3,1,1,0,1
3644_0,,,,2,2,2,4
C(CC(C(CNC)=O)NC)(CO)=O,,,3,1,3,0,3
3646_0,,,,2,2,2,4
C(C(CC(C(C=O)O)NC)NC)=O,,,3,1,2,0,2
3648_0,,,,2,2,2,4
C(C(C(C(C)=O)O)NC)(CNC)=O,,,3,1,3,0,3
3650_0,,,,2,2,2,4
C(C(C(C=O)O)NC)(C(C)NC)=O,,,3,1,3,0,3
3652_0,,,,2,2,2,4
C(CC(C(C(CNC)=O)NC)O)=O,,,3,1,2,0,2
3654_0,,,,2,2,2,4
C(CC(C(C(CNC)=O)O)NC)=O,,,3,1,2,0,2
3656_0,,,,2,2,2,4
C(CNC(C(CNC)=O)CO)(O)=O,,,3,1,2,0,2
3658_0,,,,2,2,2,4
C(CNC)(C1(CC(CO1)O)O)=O,,,3,1,2,0,2
3660_0,,,,2,2,2,4
C(CNC)(C1C(CC(O1)O)O)=O,,,3,1,2,0,2
3662_0,,,,2,2,2,4
C1(C(C(C(C(CO)O)O1)O)NC)=O,,,3,1,1,0,1
3664_0,,,,2,2,2,4
C1(C(C(CO)O)OC(C1NC)O)=O,,,3,1,2,0,2
3666_0,,,,2,2,2,4
C1(C(C(C(C(CO)O1)O)O)NC)=O,,,3,1,1,0,1
3668_0,,,,2,2,2,4
C1(C(C(CO)OC(C1NC)O)O)=O,,,3,1,2,0,2
3670_0,,,,2,2,2,4
C1(C(C(C(C(CO1)O)O)O)NC)=O,,,3,1,1,0,1
3672_0,,,,2,2,2,4
C1(C(C(COC(C1NC)O)O)O)=O,,,3,1,2,0,2
3674_0,,,,2,2,2,4
C(CNC)(C(CC(CO)O)N)=O,,,3,1,12,0,12
3676_0,,,,2,2,2,4
C(CNC)(CC(C(CO)O)N)=O,,,3,1,13,0,13
3678_0,,,,2,2,2,4
C(CNC)(C(C(CCO)N)O)=O,,,3,1,13,0,13
3680_0,,,,2,2,2,4
C(CNC)(C(CC(CO)N)O)=O,,,3,1,13,0,13
3682_0,,,,2,2,2,4
C(CNC)(C(C(C(C)N)O)O)=O,,,3,1,13,0,13
3684_0,,,,2,2,2,4
C(CNC)(C(C(CCN)O)O)=O,,,3,1,13,0,13
3685_0,,,,2,2,2,4
3687_0,,,,2,2,2,4
C(CNC)(CC(C(CO)O)O)=O,,,3,1,1,0,1
3689_0,,,,2,2,2,4
C(CNC)(O)=O,,,3,1,2,0,2
3691_0,,,,2,2,2,4
C(CC(C(C(CO)O)=O)N)=O,,,3,1,5,0,5
3693_0,,,,2,2,2,4
C(C(CN)=O)(CC(CO)O)=O,,,3,1,8,0,8
3695_0,,,,2,2,2,4
C(C(C(CC(CO)O)N)=O)=O,,,3,1,10,0,10
3697_0,,,,2,2,2,4
C(C(CO)O)(CC(CN)=O)=O,,,3,1,13,0,13
3699_0,,,,2,2,2,4
C(C(CC(C(CO)=O)N)O)=O,,,3,1,3,0,3
3701_0,,,,2,2,2,4
C(CCO)(C(C(CN)=O)O)=O,,,3,1,13,0,13
3703_0,,,,2,2,2,4
C(C(C(C(CCO)N)=O)O)=O,,,3,1,3,0,3
3705_0,,,,2,2,2,4
C(CN)(C(CC(CO)=O)O)=O,,,3,1,13,0,13
3707_0,,,,2,2,2,4
C(C(CC(C(C=O)O)O)N)=O,,,3,1,2,0,2
3709_0,,,,2,2,2,4
C(C)(C(C(C(CN)=O)O)O)=O,,,3,1,13,0,13
3711_0,,,,2,2,2,4
C(C(C(C=O)O)O)(C(C)N)=O,,,3,1,3,0,3
3713_0,,,,2,2,2,4
C(CC(C(C(CN)=O)O)O)=O,,,3,1,13,0,13
3715_0,,,,2,2,2,4
C(C(C(C(C(CO)O)O)=O)N)=O,,,3,1,2,0,2
3716_0,,,,2,2,2,4
3718_0,,,,2,3,2,5
C(C1C(C(C(C1O)O)O)O)O,,,3,1,1,0,1
3719_0,,,,2,3,2,5
3720_0,,,,2,3,2,5
3722_0,,,,2,3,2,5
C(C(CO)O)O,,,3,1,4,0,4
3723_0,,,,2,3,2,5
3724_0,,,,2,3,2,5
3725_0,,,,2,3,2,5
3726_0,,,,2,3,2,5
3727_0,,,,2,3,2,5
3728_0,,,,2,3,2,5
3729_0,,,,2,3,2,5
3730_0,,,,2,3,2,5
3731_0,,,,2,3,2,5
3733_0,,,,2,3,2,5
C(C(C(C(C(CO)CO)O)O)O)=O,,,3,1,1,0,1
3734_0,,,,2,3,2,5
3735_0,,,,2,3,2,5
3736_0,,,,2,3,2,5
3737_0,,,,2,3,2,5
3738_0,,,,2,3,2,5
3739_0,,,,2,3,2,5
3740_0,,,,2,3,2,5
3741_0,,,,2,3,2,5
3742_0,,,,2,3,2,5
3743_0,,,,2,3,2,5
3744_0,,,,2,3,2,5
3746_0,,,,2,3,2,5
CCO,,,3,1,1,0,1
3747_0,,,,2,3,2,5
3748_0,,,,2,3,2,5
3749_0,,,,2,3,2,5
3750_0,,,,2,3,2,5
3751_0,,,,2,3,2,5
3752_0,,,,2,3,2,5
3754_0,,,,2,3,2,5
C(C(C(CC(CO)O)O)O)=O,,,3,1,3,0,3
3755_0,,,,2,3,2,5
3756_0,,,,2,3,2,5
3757_0,,,,2,3,2,5
3759_0,,,,2,3,2,5
CNCCO,,,3,1,1,0,1
3761_0,,,,2,3,2,5
CNC(CO)C(C(C(CO)O)O)O,,,3,1,1,0,1
3762_0,,,,2,3,2,5
3763_0,,,,2,3,2,5
3764_0,,,,2,3,2,5
3765_0,,,,2,3,2,5
3766_0,,,,2,3,2,5
3768_0,,,,2,3,2,5
C(C(C(CC(CO)NC)O)O)=O,,,3,1,1,0,1
3769_0,,,,2,3,2,5
3770_0,,,,2,3,2,5
3771_0,,,,2,3,2,5
3772_0,,,,2,3,2,5
3774_0,,,,2,3,2,5
C(C(C(C(CCO)O)O)O)O,,,3,1,2,0,2
3775_0,,,,2,3,2,5
3777_0,,,,2,3,2,5
C(C(C(C(CCO)O)O)O)(O)=O,,,3,1,4,0,4
3779_0,,,,2,3,2,5
C(CC(C(C(CO)O)O)O)(O)=O,,,3,1,3,0,3
3781_0,,,,2,3,2,5
C(C1(C(C(CC1O)O)O)O)O,,,3,1,1,0,1
3783_0,,,,2,3,2,5
C(C(C(CO)O)(C(CO)O)O)O,,,3,1,1,0,1
3785_0,,,,2,3,2,5
C(C(CO)(C(CO)O)O)(O)=O,,,3,1,4,0,4
3787_0,,,,2,3,2,5
C(C(C(CO)(C(CO)O)O)O)(O)=O,,,3,1,2,0,2
3789_0,,,,2,3,2,5
C(C(CO)(C(CO)O)O)O,,,3,1,1,0,1
3791_0,,,,2,3,2,5
C(CCO)(C(CO)(C(CO)O)O)=O,,,3,1,4,0,4
3793_0,,,,2,3,2,5
C(CC(CO)O)(C(CO)(CO)O)=O,,,3,1,4,0,4
3794_0,,,,2,3,2,5
3795_0,,,,2,3,2,5
3796_0,,,,2,3,2,5
3798_0,,,,2,3,2,5
C(CO)(CC(C(CO)(CO)O)O)=O,,,3,1,1,0,1
3800_0,,,,2,3,2,5
C(C)(C(C(C(CO)(CO)O)O)O)=O,,,3,1,1,0,1
3802_0,,,,2,3,2,5
C(C)(C(CO)(C(C(CO)O)O)O)=O,,,3,1,5,0,5
3804_0,,,,2,3,2,5
C(CC(C(C(CO)(CO)O)O)O)=O,,,3,1,1,0,1
3806_0,,,,2,3,2,5
C(C(CO)(C(C(CCO)O)O)O)=O,,,3,1,3,0,3
3807_0,,,,2,3,2,5
3809_0,,,,2,3,2,5
C(C(C(CO)O)NC)(CCO)=O,,,3,1,3,0,3
3811_0,,,,2,3,2,5
C(C(CO)NC)(CC(CO)O)=O,,,3,1,3,0,3
3812_0,,,,2,3,2,5
3813_0,,,,2,3,2,5
3815_0,,,,2,3,2,5
C(C)(C(C(C(CO)O)O)NC)=O,,,3,1,2,0,2
3816_0,,,,2,3,2,5
3818_0,,,,2,3,2,5
C(C(C(CC(CO)N)O)O)O,,,3,1,14,0,14
3819_0,,,,2,3,2,5
3821_0,,,,2,3,2,5
C(CCO)(CC(CO)=O)=O,,,3,1,4,0,4
3823_0,,,,2,3,2,5
C(CO)(CCC(CO)=O)=O,,,3,1,2,0,2
3824_0,,,,2,3,2,5
3825_0,,,,2,3,2,5
3827_0,,,,2,3,2,5
C(C(CC(CCO)O)=O)=O,,,3,1,2,0,2
3829_0,,,,2,3,2,5
C(C(CCO)=O)(CCO)=O,,,3,1,2,0,2
3830_0,,,,2,3,2,5
3832_0,,,,2,3,2,5
C(CCO)(C(C(C)=O)O)=O,,,3,1,4,0,4
3833_0,,,,2,3,2,5
3835_0,,,,2,3,2,5
C(CC(C(CCO)O)=O)=O,,,3,1,2,0,2
3837_0,,,,2,3,2,5
C(C(CO)O)(CC(C)=O)=O,,,3,1,4,0,4
3839_0,,,,2,3,2,5
C(CCC=O)(C(CO)O)=O,,,3,1,4,0,4
3841_0,,,,2,3,2,5
C(C(C(CCCO)=O)O)=O,,,3,1,3,0,3
3843_0,,,,2,3,2,5
C(C(C)=O)(CC(CO)O)=O,,,3,1,4,0,4
3845_0,,,,2,3,2,5
C(CC(CC(CO)O)=O)=O,,,3,1,3,0,3
3847_0,,,,2,3,2,5
C(CC(C=O)O)(CCO)=O,,,3,1,4,0,4
3849_0,,,,2,3,2,5
C(CC1C(C(C(O)O1)O)O)O,,,3,1,2,0,2
3851_0,,,,2,3,2,5
C(CC(C(C(CN)O)O)O)O,,,3,1,13,0,13
3853_0,,,,2,3,2,5
C(C(CC(CCO)O)O)(O)=O,,,3,1,2,0,2
3854_0,,,,2,3,2,5
3855_0,,,,2,3,2,5
3856_0,,,,2,3,2,5
3857_0,,,,2,3,2,5
3858_0,,,,2,3,2,5
3859_0,,,,2,3,2,5
3860_0,,,,2,3,2,5
3862_0,,,,2,3,2,5
C(C(CO)O)=CC(CO)=O,,,3,1,3,0,3
3864_0,,,,2,3,2,5
C(CO)=CC(C(CO)O)=O,,,3,1,3,0,3
3865_0,,,,2,3,2,5
3867_0,,,,2,3,2,5
C=CC(C(C(CO)O)O)=O,,,3,1,3,0,3
3868_0,,,,2,3,2,5
3870_0,,,,2,3,2,5
C(C(C(CO)O)O)=CC=O,,,3,1,5,0,5
3872_0,,,,2,3,2,5
C(C(C(C=CCO)O)O)=O,,,3,1,4,0,4
3874_0,,,,2,3,2,5
CNC(CO)C(CO)O,,,3,1,1,0,1
3876_0,,,,2,3,2,5
C(CO)(CC(C(CO)O)NC)=O,,,3,1,3,0,3
3878_0,,,,2,3,2,5
C(C(C(CO)NC)O)(CCO)=O,,,3,1,3,0,3
3880_0,,,,2,3,2,5
C(C(CO)O)(CC(CO)NC)=O,,,3,1,3,0,3
3881_0,,,,2,3,2,5
3883_0,,,,2,3,2,5
C(C(CNC)O)(CC(CO)O)=O,,,3,1,2,0,2
3884_0,,,,2,3,2,5
3886_0,,,,2,3,2,5
C(C(C(CO)O)O)(CCNC)=O,,,3,1,2,0,2
3887_0,,,,2,3,2,5
3889_0,,,,2,3,2,5
C(C)(C(C(C(CO)O)NC)O)=O,,,3,1,2,0,2
3891_0,,,,2,3,2,5
C(CC(C(C(CO)O)NC)O)=O,,,3,1,1,0,1
3893_0,,,,2,3,2,5
C(C(C(C(CCO)O)NC)O)=O,,,3,1,2,0,2
3895_0,,,,2,3,2,5
C(CC(C(C(CO)O)O)NC)=O,,,3,1,2,0,2
3897_0,,,,2,3,2,5
C(C(C(C(CCO)NC)O)O)=O,,,3,1,1,0,1
3898_0,,,,2,3,2,5
3900_0,,,,2,3,2,5
C(CNC(CO)C(CO)O)(O)=O,,,3,1,1,0,1
3902_0,,,,2,3,2,5
CNC(C(C(CO)O)O)C(CO)O,,,3,1,1,0,1
3904_0,,,,2,3,2,5
C(C1(CC(C(CO)O1)O)O)O,,,3,1,3,0,3
3906_0,,,,2,3,2,5
C1C(C(C(CCO)(O)O1)O)O,,,3,1,2,0,2
3908_0,,,,2,3,2,5
C1C(CC(C(CO)O)(O)O1)O,,,3,1,2,0,2
3909_0,,,,2,3,2,5
3911_0,,,,2,3,2,5
CC1(C(C(C(CO)O1)O)O)O,,,3,1,2,0,2
3913_0,,,,2,3,2,5
C(C(C1C(CC(O)O1)O)O)O,,,3,1,2,0,2
3914_0,,,,2,3,2,5
3916_0,,,,2,3,2,5
C1C(C(CC(CO)(O)O1)O)O,,,3,1,2,0,2
3918_0,,,,2,3,2,5
C(C1C(C(CC(O)O1)O)O)O,,,3,1,2,0,2
3919_0,,,,2,3,2,5
3921_0,,,,2,3,2,5
C(C(C(C(CCO)N)O)O)O,,,3,1,14,0,14
3923_0,,,,2,3,2,5
C(C(CC(C(CO)O)N)O)O,,,3,1,14,0,14
3924_0,,,,2,3,2,5
3925_0,,,,2,3,2,5
3926_0,,,,2,3,2,5
3928_0,,,,2,3,2,5
CC(C(C(C(CO)O)O)O)N,,,3,1,13,0,13
3930_0,,,,2,3,2,5
C(C(C(C(CCN)O)O)O)O,,,3,1,13,0,13
3931_0,,,,2,3,2,5
3933_0,,,,2,3,2,5
C(C(C(CC(CO)O)O)O)O,,,3,1,1,0,1
3935_0,,,,2,3,2,5
C(C(O)O)O,,,3,1,1,0,1
3937_0,,,,2,3,2,5
C(C1C(C(C(C1O)O)O)O)(O)=O,,,3,1,2,0,2
3939_0,,,,2,3,2,5
C(C(C(O)=O)O)(O)=O,,,3,1,3,0,3
3941_0,,,,2,3,2,5
C(C(C(C(O)=O)O)O)(O)=O,,,3,1,4,0,4
3942_0,,,,2,3,2,5
3943_0,,,,2,3,2,5
3944_0,,,,2,3,2,5
3945_0,,,,2,3,2,5
3946_0,,,,2,3,2,5
3947_0,,,,2,3,2,5
3949_0,,,,2,3,2,5
C(C(CCO)=O)(O)=O,,,3,1,3,0,3
3950_0,,,,2,3,2,5
3951_0,,,,2,3,2,5
3952_0,,,,2,3,2,5
3953_0,,,,2,3,2,5
3954_0,,,,2,3,2,5
3956_0,,,,2,3,2,5
C(C)(O)=O,,,3,1,1,0,1
3957_0,,,,2,3,2,5
3958_0,,,,2,3,2,5
3959_0,,,,2,3,2,5
3960_0,,,,2,3,2,5
3961_0,,,,2,3,2,5
3962_0,,,,2,3,2,5
3964_0,,,,2,3,2,5
C(C(CC(C(C=O)O)O)O)(O)=O,,,3,1,2,0,2
3965_0,,,,2,3,2,5
3966_0,,,,2,3,2,5
3967_0,,,,2,3,2,5
3968_0,,,,2,3,2,5
3969_0,,,,2,3,2,5
3970_0,,,,2,3,2,5
3971_0,,,,2,3,2,5
3972_0,,,,2,3,2,5
3973_0,,,,2,3,2,5
3975_0,,,,2,3,2,5
C(C(CC(C(C=O)O)O)NC)(O)=O,,,3,1,1,0,1
3976_0,,,,2,3,2,5
3977_0,,,,2,3,2,5
3978_0,,,,2,3,2,5
3979_0,,,,2,3,2,5
3980_0,,,,2,3,2,5
3982_0,,,,2,3,2,5
C(CC(C(C(C(O)=O)O)O)O)(O)=O,,,3,1,3,0,3
3983_0,,,,2,3,2,5
3985_0,,,,2,3,2,5
C(C1(C(C(CC1O)O)O)O)(O)=O,,,3,1,3,0,3
3987_0,,,,2,3,2,5
C(C(C(CO)O)(C(CO)O)O)(O)=O,,,3,1,3,0,3
3989_0,,,,2,3,2,5
C(C(C(O)=O)(C(CO)O)O)(O)=O,,,3,1,3,0,3
3990_0,,,,2,3,2,5
3992_0,,,,2,3,2,5
C(CC(C(C(CO)O)NC)=O)(O)=O,,,3,1,2,0,2
3994_0,,,,2,3,2,5
C(C(C(CC(CO)O)=O)NC)(O)=O,,,3,1,2,0,2
3996_0,,,,2,3,2,5
C(CC(C(O)=O)O)(C(CO)NC)=O,,,3,1,3,0,3
3998_0,,,,2,3,2,5
C(C(C(C(O)=O)O)NC)(CCO)=O,,,3,1,4,0,4
4000_0,,,,2,3,2,5
C(C(C(C(C(C)=O)NC)O)O)(O)=O,,,3,1,3,0,3
4002_0,,,,2,3,2,5
C(C(CC(C(CO)O)O)N)(O)=O,,,3,1,38,0,38
4003_0,,,,2,3,2,5
4005_0,,,,2,3,2,5
C(CCO)(CC(C(O)=O)=O)=O,,,3,1,4,0,4
4007_0,,,,2,3,2,5
C(CO)(CCC(C(O)=O)=O)=O,,,3,1,4,0,4
4009_0,,,,2,3,2,5
C(C)(C(CC(C(O)=O)=O)O)=O,,,3,1,4,0,4
4011_0,,,,2,3,2,5
C(CC(CC(C(O)=O)=O)O)=O,,,3,1,4,0,4
4013_0,,,,2,3,2,5
C(CC(CC(C=O)=O)O)(O)=O,,,3,1,2,0,2
4015_0,,,,2,3,2,5
C(CC(C(CCO)=O)=O)(O)=O,,,3,1,3,0,3
4017_0,,,,2,3,2,5
C(CC(CC(CO)=O)=O)(O)=O,,,3,1,3,0,3
4019_0,,,,2,3,2,5
C(CC(C(C(C)=O)O)=O)(O)=O,,,3,1,3,0,3
4021_0,,,,2,3,2,5
C(CC(C(CC=O)O)=O)(O)=O,,,3,1,3,0,3
4023_0,,,,2,3,2,5
C(CC(C(CC(O)=O)O)=O)=O,,,3,1,2,0,2
4025_0,,,,2,3,2,5
C(C(C(O)=O)O)(CC(C)=O)=O,,,3,1,4,0,4
4027_0,,,,2,3,2,5
C(C(C(CCC=O)=O)O)(O)=O,,,3,1,4,0,4
4029_0,,,,2,3,2,5
C(C(C(CCC(O)=O)=O)O)=O,,,3,1,2,0,2
4031_0,,,,2,3,2,5
C(C(CC(C(C)=O)=O)O)(O)=O,,,3,1,4,0,4
4033_0,,,,2,3,2,5
C(CC(CC(C(O)=O)O)=O)=O,,,3,1,4,0,4
4035_0,,,,2,3,2,5
C(CC(CC(C=O)O)=O)(O)=O,,,3,1,2,0,2
4037_0,,,,2,3,2,5
C(CC1C(C(C(O)O1)O)O)(O)=O,,,3,1,2,0,2
4039_0,,,,2,3,2,5
C(CC(C(C(CN)O)O)O)(O)=O,,,3,1,13,0,13
4041_0,,,,2,3,2,5
C(CC(CC(C(O)=O)O)O)(O)=O,,,3,1,2,0,2
4043_0,,,,2,3,2,5
C(C(C(CC(CO)O)=O)=O)(O)=O,,,3,1,2,0,2
4045_0,,,,2,3,2,5
C(C(CO)O)(CC(C(O)=O)=O)=O,,,3,1,3,0,3
4047_0,,,,2,3,2,5
C(CCO)(C(C(C(O)=O)=O)O)=O,,,3,1,3,0,3
4049_0,,,,2,3,2,5
C(CO)(CC(C(C(O)=O)=O)O)=O,,,3,1,3,0,3
4051_0,,,,2,3,2,5
C(C)(C(C(C(C(O)=O)=O)O)O)=O,,,3,1,3,0,3
4053_0,,,,2,3,2,5
C(CC(C(C(C(O)=O)=O)O)O)=O,,,3,1,3,0,3
4055_0,,,,2,3,2,5
C(CC(C(C(C=O)=O)O)O)(O)=O,,,3,1,2,0,2
4057_0,,,,2,3,2,5
C(C(CO)O)=CC(C(O)=O)=O,,,3,1,3,0,3
4059_0,,,,2,3,2,5
C(C(C(C=CCO)=O)O)(O)=O,,,3,1,3,0,3
4061_0,,,,2,3,2,5
C(C=CC(C(CO)O)=O)(O)=O,,,3,1,2,0,2
4063_0,,,,2,3,2,5
C(C(C(C(C=C)=O)O)O)(O)=O,,,3,1,3,0,3
4065_0,,,,2,3,2,5
C(C(C=CC(CO)=O)O)(O)=O,,,3,1,3,0,3
4067_0,,,,2,3,2,5
C(C(C(C=CC=O)O)O)(O)=O,,,3,1,3,0,3
4069_0,,,,2,3,2,5
C(C(C(C=CC(O)=O)O)O)=O,,,3,1,2,0,2
4071_0,,,,2,3,2,5
C(C(C(CO)NC)O)(O)=O,,,3,1,3,0,3
4073_0,,,,2,3,2,5
C(C(CC(C(CO)O)NC)=O)(O)=O,,,3,1,2,0,2
4075_0,,,,2,3,2,5
C(CC(C(C(CO)NC)O)=O)(O)=O,,,3,1,2,0,2
4077_0,,,,2,3,2,5
C(C(C(CC(CO)NC)=O)O)(O)=O,,,3,1,3,0,3
4079_0,,,,2,3,2,5
C(CC(C(O)=O)NC)(C(CO)O)=O,,,3,1,2,0,2
4081_0,,,,2,3,2,5
C(CC(C(O)=O)O)(C(CNC)O)=O,,,3,1,3,0,3
4083_0,,,,2,3,2,5
C(C(C(C(CCO)=O)O)NC)(O)=O,,,3,1,2,0,2
4085_0,,,,2,3,2,5
C(C(C(C(O)=O)O)O)(CCNC)=O,,,3,1,3,0,3
4087_0,,,,2,3,2,5
C(C(C(CC(CO)=O)NC)O)(O)=O,,,3,1,3,0,3
4089_0,,,,2,3,2,5
C(C(C(C(C(C)=O)O)NC)O)(O)=O,,,3,1,3,0,3
4091_0,,,,2,3,2,5
C(CC(C(C(C(O)=O)O)NC)O)=O,,,3,1,3,0,3
4093_0,,,,2,3,2,5
C(CC(C(C(C=O)O)NC)O)(O)=O,,,3,1,2,0,2
4095_0,,,,2,3,2,5
C(CC(C(C(C(O)=O)O)O)NC)=O,,,3,1,3,0,3
4097_0,,,,2,3,2,5
C(CC(C(C(C=O)O)O)NC)(O)=O,,,3,1,2,0,2
4099_0,,,,2,3,2,5
C(C(C(CO)NCC(O)=O)O)(O)=O,,,3,1,3,0,3
4101_0,,,,2,3,2,5
C(C1(CC(C(CO)O1)O)O)(O)=O,,,3,1,2,0,2
4103_0,,,,2,3,2,5
C(CC1(C(C(CO1)O)O)O)(O)=O,,,3,1,2,0,2
4105_0,,,,2,3,2,5
C(C(C1(CC(CO1)O)O)O)(O)=O,,,3,1,3,0,3
4107_0,,,,2,3,2,5
C(C1C(CC(CO)(O1)O)O)(O)=O,,,3,1,2,0,2
4109_0,,,,2,3,2,5
C(C1C(C(C(C)(O1)O)O)O)(O)=O,,,3,1,2,0,2
4111_0,,,,2,3,2,5
C(C(C1C(CC(O)O1)O)O)(O)=O,,,3,1,3,0,3
4113_0,,,,2,3,2,5
C(C1(C(C(C(CO)O1)O)O)O)(O)=O,,,3,1,2,0,2
4115_0,,,,2,3,2,5
C(C1(CC(C(CO1)O)O)O)(O)=O,,,3,1,2,0,2
4117_0,,,,2,3,2,5
C(C1C(C(CC(O1)O)O)O)(O)=O,,,3,1,2,0,2
4119_0,,,,2,3,2,5
C(C1(C(C(C(CO1)O)O)O)O)(O)=O,,,3,1,2,0,2
4121_0,,,,2,3,2,5
C(CC(C(C(CO)O)O)N)(O)=O,,,3,1,15,0,15
4123_0,,,,2,3,2,5
C(C(C(CC(CO)O)N)O)(O)=O,,,3,1,15,0,15
4125_0,,,,2,3,2,5
C(C(CC(C(CO)O)N)O)(O)=O,,,3,1,15,0,15
4127_0,,,,2,3,2,5
C(C(C(C(CCO)N)O)O)(O)=O,,,3,1,14,0,14
4129_0,,,,2,3,2,5
C(C(C(CC(CO)N)O)O)(O)=O,,,3,1,14,0,14
4131_0,,,,2,3,2,5
C(C(C(C(C(C)N)O)O)O)(O)=O,,,3,1,14,0,14
4133_0,,,,2,3,2,5
C(C(C(C(CCN)O)O)O)(O)=O,,,3,1,14,0,14
4135_0,,,,2,3,2,5
C(C(C(CO)O)=O)(O)=O,,,3,1,343,0,343
4136_0,,,,2,3,2,5
4138_0,,,,2,3,2,5
C(C(O)O)(O)=O,,,3,1,3,0,3
4139_0,,,,2,1,1,2
4139_1,,,,2,1,1,2
4141_0,,,,2,1,1,2
C1(C(C(C(C1(CO)CO)O)O)O)=O,,,3,1,2,0,2
4142_0,,,,2,1,1,2
4142_1,,,,2,1,1,2
4144_0,,,,2,1,1,2
C(C1(C(C(CO)C(C1O)O)O)O)=O,,,3,1,2,0,2
4144_1,,,,2,1,1,2
4146_0,,,,2,1,1,2
C(C1(CO)C(C(C(C1O)O)O)O)=O,,,3,1,2,0,2
4148_0,,,,2,1,1,2
C1(C(CC(C1(CO)O)O)O)=O,,,3,1,2,0,2
4148_1,,,,2,1,1,2
4149_0,,,,2,1,1,2
4149_1,,,,2,1,1,2
4151_0,,,,2,1,1,2
C1(C(CC(C1(CO)O)O)NC)=O,,,3,1,2,0,2
4151_1,,,,2,1,1,2
4153_0,,,,2,1,1,2
C(C1(C(C(CC1O)NC)O)O)=O,,,3,1,4,0,4
4153_1,,,,2,1,1,2
4154_0,,,,2,1,1,2
4154_1,,,,2,1,1,2
4155_0,,,,2,1,1,2
4157_0,,,,2,1,1,2
C1(CC(CO)(C(C1(CO)O)O)O)=O,,,3,1,2,0,2
4157_1,,,,2,1,1,2
4159_0,,,,2,1,1,2
C1(CC(C(C1(CO)NC)O)O)=O,,,3,1,2,0,2
4159_1,,,,2,1,1,2
4161_0,,,,2,1,1,2
C(C1(C(CCC1O)=O)O)=O,,,3,1,3,0,3
4161_1,,,,2,1,1,2
4163_0,,,,2,1,1,2
C1(C(CO)(C(C(C1)=O)O)O)=O,,,3,1,2,0,2
4163_1,,,,2,1,1,2
4165_0,,,,2,1,1,2
C1C(C(C(C=1)=O)(CO)O)O,,,3,1,3,0,3
4165_1,,,,2,1,1,2
4167_0,,,,2,1,1,2
C(C1(C(C=CC1O)O)O)=O,,,3,1,3,0,3
4167_1,,,,2,1,1,2
4169_0,,,,2,1,1,2
C1(CC(C(C1(CO)O)O)NC)=O,,,3,1,3,0,3
4169_1,,,,2,1,1,2
4171_0,,,,2,1,1,2
C1(CC(C(C1(CNC)O)O)O)=O,,,3,1,2,0,2
4171_1,,,,2,1,1,2
4173_0,,,,2,1,1,2
C(C1(C(CC(C1NC)O)O)O)=O,,,3,1,2,0,2
4173_1,,,,2,1,1,2
4174_0,,,,2,1,1,2
4174_1,,,,2,1,1,2
4176_0,,,,2,2,1,3
C(C(CO)(C(C(C(O)=O)O)O)O)=O,,,3,1,2,0,2
4176_1,,,,2,2,1,3
4178_0,,,,2,2,1,3
C(C(C=O)(C(C(CO)O)O)O)(O)=O,,,3,1,2,0,2
4178_1,,,,2,2,1,3
4180_0,,,,2,2,1,3
C(C(C=O)(C(CO)(CO)O)O)(O)=O,,,3,1,2,0,2
4180_1,,,,2,2,1,3
4182_0,,,,2,2,1,3
C(C(C=O)(C(C(C)=O)O)O)(O)=O,,,3,1,4,0,4
4182_1,,,,2,2,1,3
4184_0,,,,2,2,1,3
C(C(C=O)(C(C=O)(C)O)O)(O)=O,,,3,1,2,0,2
4184_1,,,,2,2,1,3
4186_0,,,,2,2,1,3
C(C(C=O)(C(C=O)O)O)(O)=O,,,3,1,4,0,4
4186_1,,,,2,2,1,3
4188_0,,,,2,2,1,3
C(C(C=O)(C(C(C(O)=O)O)O)O)=O,,,3,1,2,0,2
4188_1,,,,2,2,1,3
4190_0,,,,2,2,1,3
C(C(C=O)(C(C(C=O)O)O)O)(O)=O,,,3,1,2,0,2
4190_1,,,,2,2,1,3
4192_0,,,,2,2,1,3
C(C(C=O)(C(CO)(C)O)O)(O)=O,,,3,1,2,0,2
4192_1,,,,2,2,1,3
4194_0,,,,2,2,1,3
C(C(C=O)(C(C)O)O)(O)=O,,,3,1,2,0,2
4194_1,,,,2,2,1,3
4196_0,,,,2,2,1,3
C(C(C=O)(C(C(CO)=O)O)O)(O)=O,,,3,1,2,0,2
4196_1,,,,2,2,1,3
4198_0,,,,2,2,1,3
C(C(C=O)(C(C=O)(CO)O)O)(O)=O,,,3,1,2,0,2
4198_1,,,,2,2,1,3
4200_0,,,,2,2,1,3
C(C(C=O)(C(CNC)O)O)(O)=O,,,3,1,2,0,2
4200_1,,,,2,2,1,3
4202_0,,,,2,2,1,3
C(C(C=O)(C(C(O)O)O)O)(O)=O,,,3,1,2,0,2
4202_1,,,,2,2,1,3
4204_0,,,,2,2,1,3
C(C(C(C=O)(C(C=O)O)O)O)(O)=O,,,3,1,4,0,4
4204_1,,,,2,2,1,3
4206_0,,,,2,2,1,3
C(C(C(C=O)O)(C(C=O)O)O)(O)=O,,,3,1,2,0,2
4206_1,,,,2,2,1,3
4208_0,,,,2,2,1,3
C(C(C(C)O)(C(C(O)=O)O)O)=O,,,3,1,2,0,2
4208_1,,,,2,2,1,3
4210_0,,,,2,2,1,3
C(C(C(C)O)(C(C=O)O)O)(O)=O,,,3,1,2,0,2
4210_1,,,,2,2,1,3
4212_0,,,,2,2,1,3
C(C(CO)(C(C(CO)O)O)O)=O,,,3,1,2,0,2
4212_1,,,,2,2,1,3
4214_0,,,,2,2,1,3
C(C(CO)(C(CO)(CO)O)O)=O,,,3,1,2,0,2
4214_1,,,,2,2,1,3
4215_0,,,,2,2,1,3
4215_1,,,,2,2,1,3
4217_0,,,,2,2,1,3
C(C(CO)(C(C=O)(C)O)O)=O,,,3,1,2,0,2
4217_1,,,,2,2,1,3
4218_0,,,,2,2,1,3
4218_1,,,,2,2,1,3
4220_0,,,,2,2,1,3
C(C(CO)(C(CO)(CC=O)O)O)=O,,,3,1,2,0,2
4220_1,,,,2,2,1,3
4222_0,,,,2,2,1,3
C(C(C(C)=O)(C(C(CO)O)O)O)=O,,,3,1,2,0,2
4222_1,,,,2,2,1,3
4223_0,,,,2,2,1,3
4223_1,,,,2,2,1,3
4225_0,,,,2,2,1,3
C(C(CO)(C(C)(C(C=O)O)O)O)=O,,,3,1,2,0,2
4225_1,,,,2,2,1,3
4226_0,,,,2,2,1,3
4226_1,,,,2,2,1,3
4227_0,,,,2,2,1,3
4227_1,,,,2,2,1,3
4229_0,,,,2,2,1,3
C(C(CO)(C(C)(C(CO)O)O)O)=O,,,3,1,2,0,2
4229_1,,,,2,2,1,3
4230_0,,,,2,2,1,3
4230_1,,,,2,2,1,3
4232_0,,,,2,2,1,3
C(C(CCO)(C(C=O)(CO)O)O)=O,,,3,1,2,0,2
4232_1,,,,2,2,1,3
4234_0,,,,2,2,1,3
C(C(CO)(C(CO)(CCO)O)O)=O,,,3,1,2,0,2
4234_1,,,,2,2,1,3
4236_0,,,,2,2,1,3
C(C(C=O)(C(C(CO)O)O)O)=O,,,3,1,2,0,2
4236_1,,,,2,2,1,3
4238_0,,,,2,2,1,3
C(C(CO)(C(C(C=O)O)O)O)=O,,,3,1,2,0,2
4238_1,,,,2,2,1,3
4240_0,,,,2,2,1,3
C(C(CO)(C(CO)(C)O)O)=O,,,3,1,2,0,2
4240_1,,,,2,2,1,3
4241_0,,,,2,2,1,3
4241_1,,,,2,2,1,3
4242_0,,,,2,2,1,3
4242_1,,,,2,2,1,3
4244_0,,,,2,2,1,3
C(C(CO)(C(C)O)O)=O,,,3,1,2,0,2
4244_1,,,,2,2,1,3
4245_0,,,,2,2,1,3
4245_1,,,,2,2,1,3
4247_0,,,,2,2,1,3
C(C(CO)(C(C=O)(CO)O)O)=O,,,3,1,2,0,2
4247_1,,,,2,2,1,3
4249_0,,,,2,2,1,3
C(C(CO)(C(CNC)O)O)=O,,,3,1,2,0,2
4249_1,,,,2,2,1,3
4251_0,,,,2,2,1,3
C(C(CO)(C(C(CO)O)O)N)(O)=O,,,3,1,2,0,2
4251_1,,,,2,2,1,3
4253_0,,,,2,2,1,3
C(C(CO)(C(C(O)O)O)O)=O,,,3,1,2,0,2
4253_1,,,,2,2,1,3
4255_0,,,,2,2,1,3
C(C(C(C)=O)(C(CO)(CO)O)O)=O,,,3,1,2,0,2
4255_1,,,,2,2,1,3
4257_0,,,,2,2,1,3
C(C)(C(CO)(C(CO)(CO)O)O)=O,,,3,1,2,0,2
4257_1,,,,2,2,1,3
4259_0,,,,2,2,1,3
C(C(C=O)(C(CO)(CO)O)O)=O,,,3,1,2,0,2
4259_1,,,,2,2,1,3
4261_0,,,,2,2,1,3
C(C(CO)(C(CO)(CO)O)N)(O)=O,,,3,1,2,0,2
4261_1,,,,2,2,1,3
4263_0,,,,2,2,1,3
C(C(C(C)=O)(C(C(C)=O)O)O)=O,,,3,1,2,0,2
4263_1,,,,2,2,1,3
4265_0,,,,2,2,1,3
C(C(C)(C(C=O)(C(C)=O)O)O)=O,,,3,1,2,0,2
4265_1,,,,2,2,1,3
4267_0,,,,2,2,1,3
C(C)(C(CO)(C(C(C)=O)O)O)=O,,,3,1,2,0,2
4267_1,,,,2,2,1,3
4269_0,,,,2,2,1,3
C(C(C)(C(C(C)=O)(CO)O)O)=O,,,3,1,2,0,2
4269_1,,,,2,2,1,3
4271_0,,,,2,2,1,3
C(C(C=O)(C(C(C)=O)O)O)=O,,,3,1,2,0,2
4271_1,,,,2,2,1,3
4273_0,,,,2,2,1,3
C(C(C=O)(C(C=O)(C)O)O)=O,,,3,1,2,0,2
4273_1,,,,2,2,1,3
4275_0,,,,2,2,1,3
C(C(C(C=O)(C(C(C)=O)O)O)O)=O,,,3,1,4,0,4
4275_1,,,,2,2,1,3
4277_0,,,,2,2,1,3
C(C(C(C=O)(C(C=O)(C)O)O)O)=O,,,3,1,2,0,2
4277_1,,,,2,2,1,3
4279_0,,,,2,2,1,3
C(CO)(C(CO)(C(C(C)=O)O)O)=O,,,3,1,4,0,4
4279_1,,,,2,2,1,3
4281_0,,,,2,2,1,3
C(C(C)(C(C(CO)=O)(CO)O)O)=O,,,3,1,2,0,2
4281_1,,,,2,2,1,3
4283_0,,,,2,2,1,3
C(C(C(O)=O)(C(C(C)=O)O)N)(O)=O,,,3,1,2,0,2
4283_1,,,,2,2,1,3
4285_0,,,,2,2,1,3
C(C(C(O)=O)(C(C=O)(C)O)N)(O)=O,,,3,1,2,0,2
4285_1,,,,2,2,1,3
4287_0,,,,2,2,1,3
C(C(CO)(C(C(C)=O)O)N)(O)=O,,,3,1,2,0,2
4287_1,,,,2,2,1,3
4289_0,,,,2,2,1,3
C(C(CO)(C(C=O)(C)O)N)(O)=O,,,3,1,2,0,2
4289_1,,,,2,2,1,3
4291_0,,,,2,2,1,3
C(C(C(C(C=O)=O)(CO)O)O)(C)=O,,,3,1,4,0,4
4291_1,,,,2,2,1,3
4293_0,,,,2,2,1,3
C(C(C)(C(C(C=O)=O)(CO)O)O)=O,,,3,1,2,0,2
4293_1,,,,2,2,1,3
4295_0,,,,2,2,1,3
C(C(C=O)(C(CC(CO)=O)O)O)=O,,,3,1,2,0,2
4295_1,,,,2,2,1,3
4297_0,,,,2,2,1,3
C(C(C=O)(C(CO)(CC=O)O)O)=O,,,3,1,2,0,2
4297_1,,,,2,2,1,3
4299_0,,,,2,2,1,3
C(C(C(C)=O)(C(C=O)O)O)=O,,,3,1,2,0,2
4299_1,,,,2,2,1,3
4301_0,,,,2,2,1,3
C(C(C=O)(C(C(C(C)=O)O)O)O)=O,,,3,1,2,0,2
4301_1,,,,2,2,1,3
4303_0,,,,2,2,1,3
C(C(C=O)(C(C)(C(C=O)O)O)O)=O,,,3,1,2,0,2
4303_1,,,,2,2,1,3
4305_0,,,,2,2,1,3
C(C(C(C(C=O)(C(C)=O)O)O)O)=O,,,3,1,2,0,2
4305_1,,,,2,2,1,3
4307_0,,,,2,2,1,3
C(C(C(C)=O)(C(CO)(C)O)O)=O,,,3,1,2,0,2
4307_1,,,,2,2,1,3
4309_0,,,,2,2,1,3
C(C(C(C)=O)(C(C)O)O)=O,,,3,1,2,0,2
4309_1,,,,2,2,1,3
4311_0,,,,2,2,1,3
C(C(C(C)=O)(C(C(CO)=O)O)O)=O,,,3,1,2,0,2
4311_1,,,,2,2,1,3
4313_0,,,,2,2,1,3
C(C(CO)(C(C=O)(C(C)=O)O)O)=O,,,3,1,2,0,2
4313_1,,,,2,2,1,3
4315_0,,,,2,2,1,3
C(C(C(C)=O)(C(CNC)O)O)=O,,,3,1,2,0,2
4315_1,,,,2,2,1,3
4317_0,,,,2,2,1,3
C(C(C(C)=O)(C(C(O)O)O)O)=O,,,3,1,2,0,2
4317_1,,,,2,2,1,3
4318_0,,,,2,2,1,3
4318_1,,,,2,2,1,3
4319_0,,,,2,2,1,3
4319_1,,,,2,2,1,3
4321_0,,,,2,2,1,3
C(C(C(C(C)=O)(C(C=O)O)O)O)=O,,,3,1,2,0,2
4321_1,,,,2,2,1,3
4323_0,,,,2,2,1,3
C(C(C=O)(C(C=O)O)O)=O,,,3,1,2,0,2
4323_1,,,,2,2,1,3
4325_0,,,,2,2,1,3
C(C(C(C=O)(C(C=O)O)O)O)=O,,,3,1,2,0,2
4325_1,,,,2,2,1,3
4327_0,,,,2,2,1,3
C(CO)(C(CO)(C(C=O)O)O)=O,,,3,1,2,0,2
4327_1,,,,2,2,1,3
4329_0,,,,2,2,1,3
C(CNC)(C(CO)(C(C=O)O)O)=O,,,3,1,2,0,2
4329_1,,,,2,2,1,3
4331_0,,,,2,2,1,3
C(C(C(CO)O)(C(C=O)O)O)(O)=O,,,3,1,4,0,4
4331_1,,,,2,2,1,3
4333_0,,,,2,2,1,3
C(C(C(CO)O)(C(C=O)O)N)(O)=O,,,3,1,2,0,2
4333_1,,,,2,2,1,3
4335_0,,,,2,2,1,3
C(C(C(O)=O)(C(C=O)O)N)(O)=O,,,3,1,2,0,2
4335_1,,,,2,2,1,3
4337_0,,,,2,2,1,3
C(C(CO)(C(C=O)O)N)(O)=O,,,3,1,2,0,2
4337_1,,,,2,2,1,3
4339_0,,,,2,2,1,3
C(C(C(CO)NC)(C(C=O)O)O)=O,,,3,1,2,0,2
4339_1,,,,2,2,1,3
4341_0,,,,2,2,1,3
C(C(C(C(C=O)=O)(CO)O)O)=O,,,3,1,2,0,2
4341_1,,,,2,2,1,3
4343_0,,,,2,2,1,3
C(C(C=O)(C(C)(C(CO)O)O)O)=O,,,3,1,2,0,2
4343_1,,,,2,2,1,3
4344_0,,,,2,2,1,3
4344_1,,,,2,2,1,3
4346_0,,,,2,2,1,3
C(C)(C(CO)(C(CO)(C)O)O)=O,,,3,1,2,0,2
4346_1,,,,2,2,1,3
4348_0,,,,2,2,1,3
C(C)(C(CO)(C(C)O)O)=O,,,3,1,2,0,2
4348_1,,,,2,2,1,3
4349_0,,,,2,2,1,3
4349_1,,,,2,2,1,3
4351_0,,,,2,2,1,3
C(C(CO)(C(C(C)=O)(CO)O)O)=O,,,3,1,2,0,2
4351_1,,,,2,2,1,3
4353_0,,,,2,2,1,3
C(C)(C(CO)(C(CNC)O)O)=O,,,3,1,2,0,2
4353_1,,,,2,2,1,3
4355_0,,,,2,2,1,3
C(C)(C(CO)(C(C(O)O)O)O)=O,,,3,1,2,0,2
4355_1,,,,2,2,1,3
4357_0,,,,2,2,1,3
C(C(C=O)(C(C(CCO)=O)O)O)=O,,,3,1,2,0,2
4357_1,,,,2,2,1,3
4359_0,,,,2,2,1,3
C(C(C=O)(C(C=O)(CCO)O)O)=O,,,3,1,2,0,2
4359_1,,,,2,2,1,3
4361_0,,,,2,2,1,3
C(C(C=O)(C(CO)(CCO)O)O)=O,,,3,1,2,0,2
4361_1,,,,2,2,1,3
4363_0,,,,2,2,1,3
C(C(C(C)O)(C(C(C)=O)O)O)=O,,,3,1,2,0,2
4363_1,,,,2,2,1,3
4365_0,,,,2,2,1,3
C(C)(C(C(C)O)(C(C=O)O)O)=O,,,3,1,2,0,2
4365_1,,,,2,2,1,3
4367_0,,,,2,2,1,3
C(C(C=O)(C(C(C=O)O)O)O)=O,,,3,1,2,0,2
4367_1,,,,2,2,1,3
4369_0,,,,2,2,1,3
C(C(C=O)(C(CO)(C)O)O)=O,,,3,1,2,0,2
4369_1,,,,2,2,1,3
4371_0,,,,2,2,1,3
C(C(C=O)(C(C(CC=O)O)O)O)=O,,,3,1,2,0,2
4371_1,,,,2,2,1,3
4373_0,,,,2,2,1,3
C(C(C=O)(C(CC(C=O)O)O)O)=O,,,3,1,2,0,2
4373_1,,,,2,2,1,3
4375_0,,,,2,2,1,3
C(C(C=O)(C(C)O)O)=O,,,3,1,2,0,2
4375_1,,,,2,2,1,3
4377_0,,,,2,2,1,3
C(C(C=O)(C(C(CO)=O)O)O)=O,,,3,1,2,0,2
4377_1,,,,2,2,1,3
4379_0,,,,2,2,1,3
C(C(C=O)(C(C=O)(CO)O)O)=O,,,3,1,2,0,2
4379_1,,,,2,2,1,3
4381_0,,,,2,2,1,3
C(C(C=O)(C(CNC)O)O)=O,,,3,1,2,0,2
4381_1,,,,2,2,1,3
4383_0,,,,2,2,1,3
C(C(CO)(C(C(C=O)O)O)N)(O)=O,,,3,1,2,0,2
4383_1,,,,2,2,1,3
4385_0,,,,2,2,1,3
C(C(C=O)(C(C(O)O)O)O)=O,,,3,1,2,0,2
4385_1,,,,2,2,1,3
4387_0,,,,2,2,1,3
C(C(C(CO)(C)O)(C(C=O)O)O)=O,,,3,1,2,0,2
4387_1,,,,2,2,1,3
4389_0,,,,2,2,1,3
C(CO)(C(CO)(C(CO)(C)O)O)=O,,,3,1,2,0,2
4389_1,,,,2,2,1,3
4391_0,,,,2,2,1,3
C(C(C(O)=O)(C(C)(CO)O)N)(O)=O,,,3,1,2,0,2
4391_1,,,,2,2,1,3
4393_0,,,,2,2,1,3
C(C(CO)(C(C)(CO)O)N)(O)=O,,,3,1,2,0,2
4393_1,,,,2,2,1,3
4395_0,,,,2,2,1,3
C(C(C(CO)(C(CO)(C)O)O)=O)=O,,,3,1,2,0,2
4395_1,,,,2,2,1,3
4397_0,,,,2,2,1,3
C(C(C(C)O)(C(C=O)O)O)=O,,,3,1,2,0,2
4397_1,,,,2,2,1,3
4399_0,,,,2,2,1,3
C(C(C(CNC)O)(C(C=O)O)O)=O,,,3,1,2,0,2
4399_1,,,,2,2,1,3
4401_0,,,,2,2,1,3
C(C(C(C(O)O)O)(C(C=O)O)O)=O,,,3,1,2,0,2
4401_1,,,,2,2,1,3
4403_0,,,,2,2,1,3
C(CO)(C(CO)(C(C)O)O)=O,,,3,1,2,0,2
4403_1,,,,2,2,1,3
4405_0,,,,2,2,1,3
C(CNC)(C(CO)(C(C)O)O)=O,,,3,1,2,0,2
4405_1,,,,2,2,1,3
4407_0,,,,2,2,1,3
C(C(C(CO)O)(C(C)O)O)(O)=O,,,3,1,2,0,2
4407_1,,,,2,2,1,3
4409_0,,,,2,2,1,3
C(C(C(CO)O)(C(C)O)N)(O)=O,,,3,1,2,0,2
4409_1,,,,2,2,1,3
4411_0,,,,2,2,1,3
C(C(C(O)=O)(C(C)O)N)(O)=O,,,3,1,2,0,2
4411_1,,,,2,2,1,3
4413_0,,,,2,2,1,3
C(C(C(C)O)(C(C(O)=O)O)N)(O)=O,,,3,1,2,0,2
4413_1,,,,2,2,1,3
4415_0,,,,2,2,1,3
C(C(C(C)O)(C(C(O)=O)N)O)(O)=O,,,3,1,2,0,2
4415_1,,,,2,2,1,3
4417_0,,,,2,2,1,3
C(C(CO)(C(C)O)N)(O)=O,,,3,1,2,0,2
4417_1,,,,2,2,1,3
4419_0,,,,2,2,1,3
C(CC=O)(C(C(C)=O)(C(C)O)O)=O,,,3,1,2,0,2
4419_1,,,,2,2,1,3
4421_0,,,,2,2,1,3
C(C(C(CC(C)=O)=O)(C(C)O)O)=O,,,3,1,2,0,2
4421_1,,,,2,2,1,3
4423_0,,,,2,2,1,3
C(C(C(CCC=O)=O)(C(C)O)O)=O,,,3,1,2,0,2
4423_1,,,,2,2,1,3
4425_0,,,,2,2,1,3
C(C(C(C=CCO)=O)(C(C)O)O)=O,,,3,1,2,0,2
4425_1,,,,2,2,1,3
4427_0,,,,2,2,1,3
C(C=CC(C(CO)(C(C)O)O)=O)=O,,,3,1,2,0,2
4427_1,,,,2,2,1,3
4429_0,,,,2,2,1,3
C(C(C(C)O)(C(C(C=C)=O)O)O)=O,,,3,1,2,0,2
4429_1,,,,2,2,1,3
4431_0,,,,2,2,1,3
C(C(C(C(C=C)=O)(C(C)O)O)O)=O,,,3,1,2,0,2
4431_1,,,,2,2,1,3
4433_0,,,,2,2,1,3
C(C(C(C)O)(C(C=CC=O)O)O)=O,,,3,1,2,0,2
4433_1,,,,2,2,1,3
4435_0,,,,2,2,1,3
C(C(C(C)O)(C(CO)NC)O)=O,,,3,1,2,0,2
4435_1,,,,2,2,1,3
4437_0,,,,2,2,1,3
C(C(C(CO)(C(C)O)O)=O)=O,,,3,1,2,0,2
4437_1,,,,2,2,1,3
4439_0,,,,2,2,1,3
C(C(CO)(C(C(CO)=O)O)N)(O)=O,,,3,1,2,0,2
4439_1,,,,2,2,1,3
4441_0,,,,2,2,1,3
C(C(CO)(C(C=O)(CO)O)N)(O)=O,,,3,1,2,0,2
4441_1,,,,2,2,1,3
4443_0,,,,2,2,1,3
C(CO)(C(CO)(C(CNC)O)O)=O,,,3,1,2,0,2
4443_1,,,,2,2,1,3
4445_0,,,,2,2,1,3
C(CO)(C(CO)(C(C(O)O)O)O)=O,,,3,1,2,0,2
4445_1,,,,2,2,1,3
4447_0,,,,2,2,1,3
C(C(C(O)=O)(C(CNC)O)N)(O)=O,,,3,1,2,0,2
4447_1,,,,2,2,1,3
4449_0,,,,2,2,1,3
C(C(CO)(C(CNC)O)N)(O)=O,,,3,1,2,0,2
4449_1,,,,2,2,1,3
4451_0,,,,2,2,1,3
C(C(C(CO)(C(CNC)O)O)=O)=O,,,3,1,2,0,2
4451_1,,,,2,2,1,3
4453_0,,,,2,2,1,3
C(C(C(O)=O)(C(C(O)O)O)N)(O)=O,,,3,1,2,0,2
4453_1,,,,2,2,1,3
4455_0,,,,2,2,1,3
C(C(CO)(C(C(O)O)O)N)(O)=O,,,3,1,2,0,2
4455_1,,,,2,2,1,3
4457_0,,,,2,2,1,3
C(C(C(CO)(C(C(O)O)O)O)=O)=O,,,3,1,2,0,2
4457_1,,,,2,2,1,3
4458_0,,,,2,2,1,3
4458_1,,,,2,2,1,3
4459_0,,,,2,2,1,3
4459_1,,,,2,2,1,3
4460_0,,,,2,2,1,3
4460_1,,,,2,2,1,3
4461_0,,,,2,2,1,3
4461_1,,,,2,2,1,3
4463_0,,,,2,2,1,3
C(C(C(C)=O)(C(CO)O)O)=O,,,3,1,3,0,3
4463_1,,,,2,2,1,3
4465_0,,,,2,2,1,3
C(C)(C(CO)(C(CO)O)O)=O,,,3,1,2,0,2
4465_1,,,,2,2,1,3
4466_0,,,,2,2,1,3
4466_1,,,,2,2,1,3
4468_0,,,,2,2,1,3
C(C)(C(C(CO)O)(C(C=O)O)O)=O,,,3,1,2,0,2
4468_1,,,,2,2,1,3
4470_0,,,,2,2,1,3
C(C(C=O)(C(CO)O)O)=O,,,3,1,2,0,2
4470_1,,,,2,2,1,3
4471_0,,,,2,2,1,3
4471_1,,,,2,2,1,3
4473_0,,,,2,2,1,3
C(CO)(C(CO)(C(CO)O)O)=O,,,3,1,2,0,2
4473_1,,,,2,2,1,3
4475_0,,,,2,2,1,3
C(CNC)(C(CO)(C(CO)O)O)=O,,,3,1,2,0,2
4475_1,,,,2,2,1,3
4476_0,,,,2,2,1,3
4476_1,,,,2,2,1,3
4478_0,,,,2,2,1,3
C(C(C(CO)O)(C(CO)O)N)(O)=O,,,3,1,2,0,2
4478_1,,,,2,2,1,3
4480_0,,,,2,2,1,3
C(C(C(O)=O)(C(CO)O)N)(O)=O,,,3,1,4,0,4
4480_1,,,,2,2,1,3
4482_0,,,,2,2,1,3
C(C(CO)(C(CO)O)N)(O)=O,,,3,1,4,0,4
4482_1,,,,2,2,1,3
4484_0,,,,2,2,1,3
C(C(C(CO)O)(C(CO)NC)O)=O,,,3,1,2,0,2
4484_1,,,,2,2,1,3
4486_0,,,,2,2,1,3
C(C(C(CO)(C(CO)O)O)=O)=O,,,3,1,2,0,2
4486_1,,,,2,2,1,3
4487_0,,,,2,2,1,3
4487_1,,,,2,2,1,3
4489_0,,,,2,2,1,3
C(C(C(CO)O)(C(C=O)(C)O)O)=O,,,3,1,2,0,2
4489_1,,,,2,2,1,3
4490_0,,,,2,2,1,3
4490_1,,,,2,2,1,3
4492_0,,,,2,2,1,3
C(C(C(CO)O)(C(CO)(C)O)O)=O,,,3,1,2,0,2
4492_1,,,,2,2,1,3
4494_0,,,,2,2,1,3
C(C(C(CO)O)(C(C)O)O)=O,,,3,1,2,0,2
4494_1,,,,2,2,1,3
4496_0,,,,2,2,1,3
C(C(C(CO)O)(C(CNC)O)O)=O,,,3,1,2,0,2
4496_1,,,,2,2,1,3
4498_0,,,,2,2,1,3
C(C(C(C(O)O)O)(C(CO)O)O)=O,,,3,1,2,0,2
4498_1,,,,2,2,1,3
4500_0,,,,2,2,1,3
C(C(C(O)=O)(C=O)O)(O)=O,,,3,1,2,0,2
4500_1,,,,2,2,1,3
4502_0,,,,2,2,1,3
C(C(C=O)(C(C(O)=O)O)O)(O)=O,,,3,1,4,0,4
4502_1,,,,2,2,1,3
4504_0,,,,2,2,1,3
C(C(C(O)=O)(C(C=O)O)O)(O)=O,,,3,1,2,0,2
4504_1,,,,2,2,1,3
4506_0,,,,2,2,1,3
C(C(C=O)(CO)O)(O)=O,,,3,1,4,0,4
4506_1,,,,2,2,1,3
4508_0,,,,2,2,1,3
C(C(C=O)(C(C)=O)O)(O)=O,,,3,1,3,0,3
4508_1,,,,2,2,1,3
4510_0,,,,2,2,1,3
C(C(C(C)=O)(CO)O)(O)=O,,,3,1,2,0,2
4510_1,,,,2,2,1,3
4511_0,,,,2,2,1,3
4511_1,,,,2,2,1,3
4513_0,,,,2,2,1,3
C(C(C(C)=O)(C(C=O)O)O)(O)=O,,,3,1,2,0,2
4513_1,,,,2,2,1,3
4515_0,,,,2,2,1,3
C(C(C=O)(C=O)O)(O)=O,,,3,1,2,0,2
4515_1,,,,2,2,1,3
4516_0,,,,2,2,1,3
4516_1,,,,2,2,1,3
4518_0,,,,2,2,1,3
C(C(C(CO)=O)(CO)O)(O)=O,,,3,1,2,0,2
4518_1,,,,2,2,1,3
4520_0,,,,2,2,1,3
C(C(C(CNC)=O)(CO)O)(O)=O,,,3,1,2,0,2
4520_1,,,,2,2,1,3
4521_0,,,,2,2,1,3
4521_1,,,,2,2,1,3
4522_0,,,,2,2,1,3
4522_1,,,,2,2,1,3
4524_0,,,,2,2,1,3
C(C(C(O)=O)(C(O)=O)N)(O)=O,,,3,1,2,0,2
4524_1,,,,2,2,1,3
4526_0,,,,2,2,1,3
C(C(C(O)=O)(C(C(O)=O)O)N)(O)=O,,,3,1,4,0,4
4526_1,,,,2,2,1,3
4528_0,,,,2,2,1,3
C(C(C(O)=O)(C(C(O)=O)N)O)(O)=O,,,3,1,2,0,2
4528_1,,,,2,2,1,3
4530_0,,,,2,2,1,3
C(C(C(O)=O)(CO)N)(O)=O,,,3,1,4,0,4
4530_1,,,,2,2,1,3
4532_0,,,,2,2,1,3
C(C(C(CC=O)=O)(C(C)=O)O)(O)=O,,,3,1,2,0,2
4532_1,,,,2,2,1,3
4534_0,,,,2,2,1,3
C(C(C=O)(C(CC(C)=O)=O)O)(O)=O,,,3,1,2,0,2
4534_1,,,,2,2,1,3
4536_0,,,,2,2,1,3
C(C(C=O)(C(CCC=O)=O)O)(O)=O,,,3,1,2,0,2
4536_1,,,,2,2,1,3
4538_0,,,,2,2,1,3
C(C(C=O)(C(C=CCO)=O)O)(O)=O,,,3,1,2,0,2
4538_1,,,,2,2,1,3
4540_0,,,,2,2,1,3
C(C(C(C=CC=O)=O)(CO)O)(O)=O,,,3,1,2,0,2
4540_1,,,,2,2,1,3
4542_0,,,,2,2,1,3
C(C(C=O)(C(C(C=C)=O)O)O)(O)=O,,,3,1,2,0,2
4542_1,,,,2,2,1,3
4544_0,,,,2,2,1,3
C(C(C(C=C)=O)(C(C=O)O)O)(O)=O,,,3,1,2,0,2
4544_1,,,,2,2,1,3
4546_0,,,,2,2,1,3
C(C(C=O)(C(C=CC=O)O)O)(O)=O,,,3,1,2,0,2
4546_1,,,,2,2,1,3
4548_0,,,,2,2,1,3
C(C(C=O)(C(CO)NC)O)(O)=O,,,3,1,2,0,2
4548_1,,,,2,2,1,3
4550_0,,,,2,2,1,3
C(C(C(C=O)=O)(CO)O)(O)=O,,,3,1,2,0,2
4550_1,,,,2,2,1,3
4551_0,,,,2,2,1,3
4551_1,,,,2,2,1,3
4553_0,,,,2,2,1,3
C(C(CO)(C(C(O)=O)O)O)=O,,,3,1,5,0,5
4553_1,,,,2,2,1,3
4555_0,,,,2,2,1,3
C(C(C(C)=O)(C(C(O)=O)O)O)=O,,,3,1,3,0,3
4555_1,,,,2,2,1,3
4557_0,,,,2,2,1,3
C(C)(C(CO)(C(C(O)=O)O)O)=O,,,3,1,2,0,2
4557_1,,,,2,2,1,3
4559_0,,,,2,2,1,3
C(C(C=O)(C(C(O)=O)O)O)=O,,,3,1,2,0,2
4559_1,,,,2,2,1,3
4560_0,,,,2,2,1,3
4560_1,,,,2,2,1,3
4562_0,,,,2,2,1,3
C(CO)(C(CO)(C(C(O)=O)O)O)=O,,,3,1,2,0,2
4562_1,,,,2,2,1,3
4563_0,,,,2,2,1,3
4563_1,,,,2,2,1,3
4565_0,,,,2,2,1,3
C(C(CO)(C(C(O)=O)O)N)(O)=O,,,3,1,4,0,4
4565_1,,,,2,2,1,3
4567_0,,,,2,2,1,3
C(C(C(C(C=O)=O)(CO)O)O)(O)=O,,,3,1,2,0,2
4567_1,,,,2,2,1,3
4568_0,,,,2,2,1,3
4568_1,,,,2,2,1,3
4569_0,,,,2,2,1,3
4570_0,,,,2,2,1,3
4570_1,,,,2,2,1,3
4571_0,,,,2,2,1,3
4572_0,,,,2,2,1,3
4572_1,,,,2,2,1,3
4573_0,,,,2,2,1,3
4573_1,,,,2,2,1,3
4575_0,,,,2,2,1,3
C(C(CO)(C(C=O)O)O)(O)=O,,,3,1,2,0,2
4575_1,,,,2,2,1,3
4577_0,,,,2,2,1,3
C(C(CO)(CO)O)=O,,,3,1,2,0,2
4577_1,,,,2,2,1,3
4578_0,,,,2,2,1,3
4578_1,,,,2,2,1,3
4579_0,,,,2,2,1,3
4579_1,,,,2,2,1,3
4580_0,,,,2,2,1,3
4580_1,,,,2,2,1,3
4581_0,,,,2,2,1,3
4581_1,,,,2,2,1,3
4582_0,,,,2,2,1,3
4582_1,,,,2,2,1,3
4583_0,,,,2,2,1,3
4583_1,,,,2,2,1,3
4585_0,,,,2,2,1,3
C(CO)(C(CO)(CO)O)=O,,,3,1,2,0,2
4585_1,,,,2,2,1,3
4587_0,,,,2,2,1,3
C(CC(C(C(CO)(CO)O)=O)O)=O,,,3,1,2,0,2
4587_1,,,,2,2,1,3
4588_0,,,,2,2,1,3
4588_1,,,,2,2,1,3
4589_0,,,,2,2,1,3
4589_1,,,,2,2,1,3
4590_0,,,,2,2,1,3
4590_1,,,,2,2,1,3
4591_0,,,,2,2,1,3
4591_1,,,,2,2,1,3
4592_0,,,,2,2,1,3
4592_1,,,,2,2,1,3
4593_0,,,,2,2,1,3
4593_1,,,,2,2,1,3
4594_0,,,,2,2,1,3
4594_1,,,,2,2,1,3
4596_0,,,,2,2,1,3
C(C(CO)(C(C=O)O)O)(C(C)O)=O,,,3,1,2,0,2
4596_1,,,,2,2,1,3
4598_0,,,,2,2,1,3
C(CC(C(C(CO)=O)(CO)O)O)=O,,,3,1,2,0,2
4598_1,,,,2,2,1,3
4600_0,,,,2,2,1,3
C(CNC)(C(CO)(CO)O)=O,,,3,1,2,0,2
4600_1,,,,2,2,1,3
4601_0,,,,2,2,1,3
4601_1,,,,2,2,1,3
4602_0,,,,2,2,1,3
4602_1,,,,2,2,1,3
4603_0,,,,2,2,1,3
4603_1,,,,2,2,1,3
4604_0,,,,2,2,1,3
4604_1,,,,2,2,1,3
4605_0,,,,2,2,1,3
4605_1,,,,2,2,1,3
4606_0,,,,2,2,1,3
4606_1,,,,2,2,1,3
4607_0,,,,2,2,1,3
4607_1,,,,2,2,1,3
4608_0,,,,2,2,1,3
4608_1,,,,2,2,1,3
4610_0,,,,2,2,1,3
C(C(CO)(C(C(O)=O)N)O)(O)=O,,,3,1,2,0,2
4610_1,,,,2,2,1,3
4612_0,,,,2,2,1,3
C(C(CO)(CO)N)(O)=O,,,3,1,2,0,2
4612_1,,,,2,2,1,3
4614_0,,,,2,2,1,3
C(CC=O)(C(C(C)=O)(CO)O)=O,,,3,1,4,0,4
4614_1,,,,2,2,1,3
4616_0,,,,2,2,1,3
C(C(C(CC(C)=O)=O)(CO)O)=O,,,3,1,4,0,4
4616_1,,,,2,2,1,3
4618_0,,,,2,2,1,3
C(C(C(CCC=O)=O)(CO)O)=O,,,3,1,4,0,4
4618_1,,,,2,2,1,3
4620_0,,,,2,2,1,3
C1(C(CO)C(C(C(CO)O)O1)O)=O,,,3,1,1,0,1
4622_0,,,,2,2,1,3
C1(COC(C(CO)O)C1(CO)O)=O,,,3,1,2,0,2
4622_1,,,,2,2,1,3
4624_0,,,,2,2,1,3
C1(CC(OC1(CO)C(CO)O)O)=O,,,3,1,3,0,3
4624_1,,,,2,2,1,3
4626_0,,,,2,2,1,3
C(C)(C1(CO)C(C(C(O1)O)O)O)=O,,,3,1,3,0,3
4626_1,,,,2,2,1,3
4628_0,,,,2,2,1,3
C1(C(CO)C(C(C(CO)O1)O)O)=O,,,3,1,1,0,1
4630_0,,,,2,2,1,3
C1(COC(CO)C(C1(CO)O)O)=O,,,3,1,2,0,2
4630_1,,,,2,2,1,3
4632_0,,,,2,2,1,3
C1(CC(O)OC(CO)C1(CO)O)=O,,,3,1,3,0,3
4632_1,,,,2,2,1,3
4634_0,,,,2,2,1,3
C1(CC(CO)OC(C1(CO)O)O)=O,,,3,1,3,0,3
4634_1,,,,2,2,1,3
4636_0,,,,2,2,1,3
C1(CC(C(OC1(CO)CO)O)O)=O,,,3,1,3,0,3
4636_1,,,,2,2,1,3
4638_0,,,,2,2,1,3
C1(C(CO)C(C(C(CO1)O)O)O)=O,,,3,1,1,0,1
4640_0,,,,2,2,1,3
C1(COCC(C(C1(CO)O)O)O)=O,,,3,1,2,0,2
4640_1,,,,2,2,1,3
4642_0,,,,2,2,1,3
C1(CC(O)OCC(C1(CO)O)O)=O,,,3,1,3,0,3
4642_1,,,,2,2,1,3
4644_0,,,,2,2,1,3
C1(CC(COC(C1(CO)O)O)O)=O,,,3,1,3,0,3
4644_1,,,,2,2,1,3
4646_0,,,,2,2,1,3
C1(CC(C(O)OCC1(CO)O)O)=O,,,3,1,3,0,3
4646_1,,,,2,2,1,3
4648_0,,,,2,2,1,3
C1(CCOC(C(C1(CO)O)O)O)=O,,,3,1,3,0,3
4648_1,,,,2,2,1,3
4650_0,,,,2,2,1,3
C(CCN)(C(CO)(C(CO)O)O)=O,,,3,1,14,0,14
4650_1,,,,2,2,1,3
4652_0,,,,2,2,1,3
C(CC(CO)O)(C(CO)(CN)O)=O,,,3,1,14,0,14
4652_1,,,,2,2,1,3
4654_0,,,,2,2,1,3
C(CC(CN)O)(C(CO)(CO)O)=O,,,3,1,14,0,14
4654_1,,,,2,2,1,3
4656_0,,,,2,2,1,3
C(CCO)(C(CO)(C(CN)O)O)=O,,,3,1,14,0,14
4656_1,,,,2,2,1,3
4658_0,,,,2,2,1,3
C(C)(C(CO)(C(C(CN)O)O)O)=O,,,3,1,14,0,14
4658_1,,,,2,2,1,3
4660_0,,,,2,2,1,3
C(C(CO)(CO)O)(CC(C=O)=O)=O,,,3,1,3,0,3
4660_1,,,,2,2,1,3
4662_0,,,,2,2,1,3
C(CCO)(C(C(C=O)=O)(CO)O)=O,,,3,1,3,0,3
4662_1,,,,2,2,1,3
4663_0,,,,2,2,1,3
4663_1,,,,2,2,1,3
4665_0,,,,2,2,1,3
C(C)(C(CO)(C(C(C=O)=O)O)O)=O,,,3,1,3,0,3
4665_1,,,,2,2,1,3
4667_0,,,,2,2,1,3
C(CC(C(C(C=O)=O)(CO)O)O)=O,,,3,1,2,0,2
4667_1,,,,2,2,1,3
4669_0,,,,2,2,1,3
C(C(C(C=CCO)=O)(CO)O)=O,,,3,1,3,0,3
4669_1,,,,2,2,1,3
4671_0,,,,2,2,1,3
C(C=CC(C(CO)(CO)O)=O)=O,,,3,1,3,0,3
4671_1,,,,2,2,1,3
4673_0,,,,2,2,1,3
C(C(CO)(C(C(C=C)=O)O)O)=O,,,3,1,3,0,3
4673_1,,,,2,2,1,3
4675_0,,,,2,2,1,3
C(C(C(C(C=C)=O)(CO)O)O)=O,,,3,1,3,0,3
4675_1,,,,2,2,1,3
4677_0,,,,2,2,1,3
C(C(CO)(C(C=CC=O)O)O)=O,,,3,1,3,0,3
4677_1,,,,2,2,1,3
4679_0,,,,2,2,1,3
C(C(CO)(C(CO)NC)O)=O,,,3,1,2,0,2
4679_1,,,,2,2,1,3
4681_0,,,,2,2,1,3
C(C(CO)(C1(CC(CO1)O)O)O)=O,,,3,1,3,0,3
4681_1,,,,2,2,1,3
4683_0,,,,2,2,1,3
C(C1(CO)C(CC(CO)(O1)O)O)=O,,,3,1,3,0,3
4683_1,,,,2,2,1,3
4685_0,,,,2,2,1,3
C(C1(CO)C(C(C(C)(O1)O)O)O)=O,,,3,1,3,0,3
4685_1,,,,2,2,1,3
4687_0,,,,2,2,1,3
C(C(CO)(C1C(CC(O)O1)O)O)=O,,,3,1,3,0,3
4687_1,,,,2,2,1,3
4689_0,,,,2,2,1,3
C(C1(CO)C(C(CC(O1)O)O)O)=O,,,3,1,3,0,3
4689_1,,,,2,2,1,3
4691_0,,,,2,2,1,3
C(C(CO)(C(CC(CO)O)N)O)=O,,,3,1,14,0,14
4691_1,,,,2,2,1,3
4693_0,,,,2,2,1,3
C(C(CO)(C(C(CCO)N)O)O)=O,,,3,1,14,0,14
4693_1,,,,2,2,1,3
4695_0,,,,2,2,1,3
C(C(CO)(C(CC(CO)N)O)O)=O,,,3,1,14,0,14
4695_1,,,,2,2,1,3
4697_0,,,,2,2,1,3
C(C(CO)(C(C(C(C)N)O)O)O)=O,,,3,1,14,0,14
4697_1,,,,2,2,1,3
4699_0,,,,2,2,1,3
C(C(CO)(C(C(CCN)O)O)O)=O,,,3,1,14,0,14
4699_1,,,,2,2,1,3
4701_0,,,,2,2,1,3
C(C(C(CO)(CO)O)=O)=O,,,3,1,2,0,2
4701_1,,,,2,2,1,3
4703_0,,,,2,1,1,2
C(C1(C(C(C(C1)O)O)O)O)=O,,,3,1,1,0,1
4705_0,,,,2,1,1,2
C1(C(C(C(C1(C)O)O)O)O)=O,,,3,1,1,0,1
4707_0,,,,2,1,1,2
C(C1(CC(C(C1O)O)O)NC)=O,,,3,1,1,0,1
4709_0,,,,2,1,1,2
C1(C(C(C(C1(C)NC)O)O)O)=O,,,3,1,1,0,1
4711_0,,,,2,1,1,2
C(C1(C(CC(C1)=O)O)O)=O,,,3,1,2,0,2
4713_0,,,,2,1,1,2
C(C1(C(CC(C1)O)O)O)(O)=O,,,3,1,1,0,1
4715_0,,,,2,1,1,2
C(C1C(C(C(CO)N1)O)O)(O)=O,,,3,1,1,0,1
4717_0,,,,2,2,1,3
C(C(C(C(C(O)=O)O)O)O)(O)=O,,,3,1,1,0,1
4719_0,,,,2,2,1,3
C(C(C(C(C=O)(O)O)O)O)(O)=O,,,3,1,1,0,1
4721_0,,,,2,2,1,3
C(C(C([C](C(O)=O)O)O)O)(O)=O,,,3,1,1,0,1
4723_0,,,,2,2,1,3
C(C(C(C(CO)O)O)(CC=O)O)=O,,,3,1,1,0,1
4725_0,,,,2,2,1,3
C(C(C(C(CO)O)O)O)(O)=O,,,3,1,1,0,1
4727_0,,,,2,2,1,3
C(C(C(C(CO)O)O)(O)O)=O,,,3,1,1,0,1
4729_0,,,,2,2,1,3
[C](C(O)=O)(C(C(CO)O)O)O,,,3,1,1,0,1
4731_0,,,,2,2,1,3
C(C(C(CO)(CO)O)(CC=O)O)=O,,,3,1,1,0,1
4733_0,,,,2,2,1,3
C(C(C(CO)(CO)O)O)(O)=O,,,3,1,1,0,1
4735_0,,,,2,2,1,3
C(C(C(CO)(CO)O)(O)O)=O,,,3,1,1,0,1
4737_0,,,,2,2,1,3
[C](C(O)=O)(C(CO)(CO)O)O,,,3,1,1,0,1
4739_0,,,,2,2,1,3
C(CC(C=O)(C(C(C)=O)O)O)=O,,,3,1,1,0,1
4741_0,,,,2,2,1,3
C(CC(C=O)(C(C=O)(C)O)O)=O,,,3,1,1,0,1
4743_0,,,,2,2,1,3
C(C(C(C(C)=O)O)NCC=O)(O)=O,,,3,1,1,0,1
4745_0,,,,2,2,1,3
C(CNC(C(O)=O)C(C=O)(C)O)=O,,,3,1,1,0,1
4746_0,,,,2,2,1,3
4748_0,,,,2,2,1,3
C(C(C)(C(C(O)=O)O)O)=O,,,3,1,1,0,1
4750_0,,,,2,2,1,3
C(C(CCO)(C(C(C)=O)O)O)(O)=O,,,3,1,1,0,1
4752_0,,,,2,2,1,3
C(C(CCO)(C(C=O)(C)O)O)(O)=O,,,3,1,1,0,1
4754_0,,,,2,2,1,3
C(C(C(C(C)=O)O)(O)O)=O,,,3,1,1,0,1
4756_0,,,,2,2,1,3
C(C(C)(C(C=O)(O)O)O)=O,,,3,1,1,0,1
4758_0,,,,2,2,1,3
C(C)(C([C](C(O)=O)O)O)=O,,,3,1,1,0,1
4760_0,,,,2,2,1,3
C(C([C](C(O)=O)O)(C)O)=O,,,3,1,1,0,1
4761_0,,,,2,2,1,3
4763_0,,,,2,2,1,3
C(CC(CO)(C(C(O)=O)O)O)=O,,,3,1,1,0,1
4765_0,,,,2,2,1,3
C(C(C(CC(CO)=O)O)(O)O)=O,,,3,1,1,0,1
4767_0,,,,2,2,1,3
C(CC(CO)(C(C=O)(O)O)O)=O,,,3,1,1,0,1
4769_0,,,,2,2,1,3
C(CO)(CC([C](C(O)=O)O)O)=O,,,3,1,1,0,1
4771_0,,,,2,2,1,3
C(CC([C](C(O)=O)O)(CO)O)=O,,,3,1,1,0,1
4772_0,,,,2,2,1,3
4774_0,,,,2,2,1,3
C(C(C(C)(C(C=O)O)O)O)(O)=O,,,3,1,1,0,1
4776_0,,,,2,2,1,3
C(C(C(C(C(C)=O)O)O)(O)O)=O,,,3,1,1,0,1
4778_0,,,,2,2,1,3
C(C(C(C)(C(C=O)(O)O)O)O)=O,,,3,1,1,0,1
4780_0,,,,2,2,1,3
C(C)(C(C([C](C(O)=O)O)O)O)=O,,,3,1,1,0,1
4782_0,,,,2,2,1,3
C(C(C([C](C(O)=O)O)(C)O)O)=O,,,3,1,1,0,1
4784_0,,,,2,2,1,3
C(C(C(C=O)(CC(CO)=O)O)O)=O,,,3,1,1,0,1
4786_0,,,,2,2,1,3
C(CC(C=O)(C(C=O)O)O)=O,,,3,1,1,0,1
4788_0,,,,2,2,1,3
C(C(C(C=O)O)NCC=O)(O)=O,,,3,1,1,0,1
4789_0,,,,2,2,1,3
4791_0,,,,2,2,1,3
C(C(CCO)(C(C=O)O)O)(O)=O,,,3,1,1,0,1
4793_0,,,,2,2,1,3
C(C(C(C=O)(O)O)O)=O,,,3,1,1,0,1
4795_0,,,,2,2,1,3
C(C([C](C(O)=O)O)O)=O,,,3,1,1,0,1
4797_0,,,,2,2,1,3
C(C(C(C)(C(CO)O)O)O)(O)=O,,,3,1,1,0,1
4799_0,,,,2,2,1,3
C(C(C(C)(C(CO)O)O)(O)O)=O,,,3,1,1,0,1
4801_0,,,,2,2,1,3
[C](C(O)=O)(C(C)(C(CO)O)O)O,,,3,1,1,0,1
4803_0,,,,2,2,1,3
C(C(C(C)O)(CC(CO)=O)O)=O,,,3,1,1,0,1
4804_0,,,,2,2,1,3
4806_0,,,,2,2,1,3
C(C(CCO)(C(C(O)=O)O)O)=O,,,3,1,1,0,1
4808_0,,,,2,2,1,3
C(C(C(C=O)(O)O)O)(CCO)=O,,,3,1,1,0,1
4810_0,,,,2,2,1,3
C(C(CCO)(C(C=O)(O)O)O)=O,,,3,1,1,0,1
4812_0,,,,2,2,1,3
C(CCO)(C([C](C(O)=O)O)O)=O,,,3,1,1,0,1
4814_0,,,,2,2,1,3
C(C([C](C(O)=O)O)(CCO)O)=O,,,3,1,1,0,1
4816_0,,,,2,2,1,3
C(C(C(CO)(CCO)O)O)(O)=O,,,3,1,1,0,1
4818_0,,,,2,2,1,3
C(C(C(CO)(CCO)O)(O)O)=O,,,3,1,1,0,1
4820_0,,,,2,2,1,3
[C](C(O)=O)(C(CO)(CCO)O)O,,,3,1,1,0,1
4822_0,,,,2,2,1,3
C(C(C(C(C=O)(CC=O)O)O)O)=O,,,3,1,1,0,1
4823_0,,,,2,2,1,3
4825_0,,,,2,2,1,3
C(C(C(C(C=O)(O)O)O)O)=O,,,3,1,1,0,1
4827_0,,,,2,2,1,3
C(C(C([C](C(O)=O)O)O)O)=O,,,3,1,1,0,1
4829_0,,,,2,2,1,3
C(C(C(CO)(C)O)(CC=O)O)=O,,,3,1,1,0,1
4831_0,,,,2,2,1,3
C(C(C(C)(CO)O)NCC=O)(O)=O,,,3,1,1,0,1
4833_0,,,,2,2,1,3
C(C(C(CO)(C)O)O)(O)=O,,,3,1,1,0,1
4835_0,,,,2,2,1,3
C(C(CCO)(C(CO)(C)O)O)(O)=O,,,3,1,1,0,1
4837_0,,,,2,2,1,3
C(C(C(CO)(C)O)(O)O)=O,,,3,1,1,0,1
4839_0,,,,2,2,1,3
[C](C(O)=O)(C(CO)(C)O)O,,,3,1,1,0,1
4841_0,,,,2,2,1,3
C(C(C(C)O)(CC=O)O)=O,,,3,1,1,0,1
4843_0,,,,2,2,1,3
C(CC(C=O)(C(C(CO)=O)O)O)=O,,,3,1,1,0,1
4845_0,,,,2,2,1,3
C(CC(C=O)(C(C=O)(CO)O)O)=O,,,3,1,1,0,1
4847_0,,,,2,2,1,3
C(C(C(CNC)O)(CC=O)O)=O,,,3,1,1,0,1
4848_0,,,,2,2,1,3
4849_0,,,,2,2,1,3
4851_0,,,,2,2,1,3
C(CC(C(C(C=O)(O)O)O)O)=O,,,3,1,1,0,1
4853_0,,,,2,2,1,3
C(C(CC(C(C=O)(O)O)O)O)=O,,,3,1,1,0,1
4855_0,,,,2,2,1,3
C(C(C(C(O)O)O)(CC=O)O)=O,,,3,1,1,0,1
4857_0,,,,2,2,1,3
C(CC(C([C](C(O)=O)O)O)O)=O,,,3,1,1,0,1
4859_0,,,,2,2,1,3
C(C(CC([C](C(O)=O)O)O)O)=O,,,3,1,1,0,1
4860_0,,,,2,2,1,3
4862_0,,,,2,2,1,3
C(C(C(C(C(C=O)(O)O)O)O)O)=O,,,3,1,1,0,1
4864_0,,,,2,2,1,3
C(C(C(C([C](C(O)=O)O)O)O)O)=O,,,3,1,1,0,1
4866_0,,,,2,2,1,3
C(C(C(C)O)NCC=O)(O)=O,,,3,1,1,0,1
4868_0,,,,2,2,1,3
C(C(C(C)O)O)(O)=O,,,3,1,1,0,1
4870_0,,,,2,2,1,3
C(C)(C(C(C)O)(CC(C=O)=O)O)=O,,,3,1,1,0,1
4872_0,,,,2,2,1,3
C(C(C(C)O)(CC=O)O)(CC=O)=O,,,3,1,1,0,1
4874_0,,,,2,2,1,3
C(C(C(C)O)(CC(C(C)=O)=O)O)=O,,,3,1,1,0,1
4876_0,,,,2,2,1,3
C(C(C(C)O)(CC(CC=O)=O)O)=O,,,3,1,1,0,1
4878_0,,,,2,2,1,3
C(C(C=CC(CO)=O)(C(C)O)O)=O,,,3,1,1,0,1
4880_0,,,,2,2,1,3
C(C(C(C)O)(CCO)O)(O)=O,,,3,1,1,0,1
4882_0,,,,2,2,1,3
C(C(C(C)O)(O)O)=O,,,3,1,1,0,1
4884_0,,,,2,2,1,3
[C](C(O)=O)(C(C)O)O,,,3,1,1,0,1
4885_0,,,,2,2,1,3
4886_0,,,,2,2,1,3
4888_0,,,,2,2,1,3
C(C(C(C(CO)=O)O)(O)O)=O,,,3,1,1,0,1
4890_0,,,,2,2,1,3
C(C(CO)(C(C=O)(O)O)O)=O,,,3,1,1,0,1
4892_0,,,,2,2,1,3
C(CO)(C([C](C(O)=O)O)O)=O,,,3,1,1,0,1
4894_0,,,,2,2,1,3
C(C([C](C(O)=O)O)(CO)O)=O,,,3,1,1,0,1
4895_0,,,,2,2,1,3
4897_0,,,,2,2,1,3
C(C(C(CO)(C(CO)O)O)(O)O)=O,,,3,1,1,0,1
4899_0,,,,2,2,1,3
[C](C(O)=O)(C(CO)(C(CO)O)O)O,,,3,1,1,0,1
4901_0,,,,2,2,1,3
C(C(C(CNC)O)NCC=O)(O)=O,,,3,1,1,0,1
4903_0,,,,2,2,1,3
C(C(C(CNC)O)O)(O)=O,,,3,1,1,0,1
4905_0,,,,2,2,1,3
C(C(C(CNC)O)(CCO)O)(O)=O,,,3,1,1,0,1
4907_0,,,,2,2,1,3
C(C(C(CNC)O)(O)O)=O,,,3,1,1,0,1
4909_0,,,,2,2,1,3
[C](C(O)=O)(C(CNC)O)O,,,3,1,1,0,1
4911_0,,,,2,2,1,3
C(C(C(CNCC(O)=O)O)O)(O)=O,,,3,1,1,0,1
4913_0,,,,2,2,1,3
C(C(C(CNCC(O)=O)O)(O)O)=O,,,3,1,1,0,1
4915_0,,,,2,2,1,3
C(C(C(C(O)O)O)NCC=O)(O)=O,,,3,1,1,0,1
4917_0,,,,2,2,1,3
C(CNCC([C](C(O)=O)O)O)(O)=O,,,3,1,1,0,1
4918_0,,,,2,2,1,3
4919_0,,,,2,2,1,3
4921_0,,,,2,2,1,3
C(C(C(C(O)O)O)O)(O)=O,,,3,1,1,0,1
4923_0,,,,2,2,1,3
C(C(C(C(O)O)O)(CCO)O)(O)=O,,,3,1,1,0,1
4925_0,,,,2,2,1,3
C(C(C(C=O)(O)O)O)(C(CO)O)=O,,,3,1,1,0,1
4927_0,,,,2,2,1,3
C(C(C(CO)O)(C(C=O)(O)O)O)=O,,,3,1,1,0,1
4929_0,,,,2,2,1,3
C(C(CO)O)(C([C](C(O)=O)O)O)=O,,,3,1,1,0,1
4931_0,,,,2,2,1,3
C(C([C](C(O)=O)O)(C(CO)O)O)=O,,,3,1,1,0,1
4933_0,,,,2,2,1,3
C(C(C(C(O)O)O)(O)O)=O,,,3,1,1,0,1
4935_0,,,,2,2,1,3
[C](C(O)=O)(C(C(O)O)O)O,,,3,1,1,0,1
4937_0,,,,2,2,1,3
C(C(C(C(C(O)=O)O)O)N)(O)=O,,,3,1,1,0,1
4939_0,,,,2,2,1,3
C(C(C(C(CO)O)O)N)(O)=O,,,3,1,2,0,2
4941_0,,,,2,2,1,3
C(C(C(CO)(CO)O)N)(O)=O,,,3,1,1,0,1
4943_0,,,,2,2,1,3
C(C(C(C(C)=O)O)N)(O)=O,,,3,1,1,0,1
4945_0,,,,2,2,1,3
C(C(C)(C(C(O)=O)N)O)=O,,,3,1,1,0,1
4947_0,,,,2,2,1,3
C(C(C(CC(CO)=O)O)N)(O)=O,,,3,1,2,0,2
4949_0,,,,2,2,1,3
C(CC(CO)(C(C(O)=O)N)O)=O,,,3,1,1,0,1
4951_0,,,,2,2,1,3
C(C(C(C(C(C)=O)O)O)N)(O)=O,,,3,1,2,0,2
4953_0,,,,2,2,1,3
C(C(C(C)(C(C=O)O)O)N)(O)=O,,,3,1,1,0,1
4955_0,,,,2,2,1,3
C(C(C(C=O)O)N)(O)=O,,,3,1,2,0,2
4957_0,,,,2,2,1,3
C(C(C(C)(C(CO)O)O)N)(O)=O,,,3,1,1,0,1
4959_0,,,,2,2,1,3
C(C(C(C(CCO)=O)O)N)(O)=O,,,3,1,3,0,3
4961_0,,,,2,2,1,3
C(C(CCO)(C(C(O)=O)N)O)=O,,,3,1,1,0,1
4963_0,,,,2,2,1,3
C(C(C(CO)(CCO)O)N)(O)=O,,,3,1,1,0,1
4965_0,,,,2,2,1,3
C(C(C(C(C=O)O)O)N)(O)=O,,,3,1,1,0,1
4967_0,,,,2,2,1,3
C(C(C(C)(CO)O)N)(O)=O,,,3,1,1,0,1
4969_0,,,,2,2,1,3
C(CC(C(C(C(O)=O)N)O)O)=O,,,3,1,2,0,2
4971_0,,,,2,2,1,3
C(C(C(CC(C=O)O)O)N)(O)=O,,,3,1,1,0,1
4973_0,,,,2,2,1,3
C(C(C(C(C(C=O)O)O)O)N)(O)=O,,,3,1,1,0,1
4975_0,,,,2,2,1,3
C(C(C(C)O)N)(O)=O,,,3,1,1,0,1
4977_0,,,,2,2,1,3
C(C(C(C(CO)=O)O)N)(O)=O,,,3,1,1,0,1
4979_0,,,,2,2,1,3
C(C(CO)(C(C(O)=O)N)O)=O,,,3,1,1,0,1
4981_0,,,,2,2,1,3
C(C(C(CO)(C(CO)O)O)N)(O)=O,,,3,1,1,0,1
4983_0,,,,2,2,1,3
C(C(C(CNC)O)N)(O)=O,,,3,1,1,0,1
4985_0,,,,2,2,1,3
C(C(C(CNCC(O)=O)O)N)(O)=O,,,3,1,1,0,1
4987_0,,,,2,2,1,3
C(C(C(C(C(CO)O)=O)O)N)(O)=O,,,3,1,1,0,1
4989_0,,,,2,2,1,3
C(C(C(CO)O)(C(C(O)=O)N)O)=O,,,3,1,1,0,1
4991_0,,,,2,2,1,3
C(C(C(C(O)O)O)N)(O)=O,,,3,1,1,0,1
4992_0,,,,2,2,1,3
4993_0,,,,2,2,1,3
4994_0,,,,2,2,1,3
4995_0,,,,2,2,1,3
4997_0,,,,2,2,1,3
C(C(C(CO)O)(CCO)O)(O)=O,,,3,1,1,0,1
4999_0,,,,2,2,1,3
C(C(C(CO)O)(O)O)=O,,,3,1,1,0,1
5001_0,,,,2,2,1,3
[C](C(O)=O)(C(CO)O)O,,,3,1,1,0,1
5002_0,,,,2,2,1,3
5004_0,,,,2,2,1,3
C(C(C(C(C(CO)O)O)O)(O)O)=O,,,3,1,1,0,1
5006_0,,,,2,2,1,3
[C](C(O)=O)(C(C(C(CO)O)O)O)O,,,3,1,2,0,2
5008_0,,,,2,2,1,3
C(C(C=O)(CC(CO)=O)O)(O)=O,,,3,1,1,0,1
5010_0,,,,2,2,1,3
C(C(C=O)(CC=O)O)(O)=O,,,3,1,2,0,2
5011_0,,,,2,2,1,3
5011_1,,,,2,2,1,3
5012_0,,,,2,2,1,3
5014_0,,,,2,2,1,3
C(C(C(C)=O)(CC(C=O)=O)O)(O)=O,,,3,1,1,0,1
5016_0,,,,2,2,1,3
C(C(C(CC=O)=O)(CC=O)O)(O)=O,,,3,1,1,0,1
5018_0,,,,2,2,1,3
C(C(C=O)(CC(C(C)=O)=O)O)(O)=O,,,3,1,1,0,1
5020_0,,,,2,2,1,3
C(C(C=O)(CC(CC=O)=O)O)(O)=O,,,3,1,1,0,1
5022_0,,,,2,2,1,3
C(C(C=O)(C=CC(CO)=O)O)(O)=O,,,3,1,1,0,1
5024_0,,,,2,2,1,3
C(C(C(O)=O)(CCO)O)(O)=O,,,3,1,1,0,1
5026_0,,,,2,2,1,3
C(C(C=O)(O)O)(O)=O,,,3,1,1,0,1
5028_0,,,,2,2,1,3
C([C](C(O)=O)O)(O)=O,,,3,1,1,0,1
5030_0,,,,2,2,1,3
C(C(C(C=O)(CC=O)O)O)(O)=O,,,3,1,2,0,2
5031_0,,,,2,2,1,3
5032_0,,,,2,2,1,3
5034_0,,,,2,2,1,3
C(C(CCO)(C(C(O)=O)O)O)(O)=O,,,3,1,1,0,1
5036_0,,,,2,2,1,3
C(C(C(C=O)(O)O)O)(O)=O,,,3,1,1,0,1
5038_0,,,,2,2,1,3
C(C([C](C(O)=O)O)O)(O)=O,,,3,1,1,0,1
5039_0,,,,2,2,1,3
5040_0,,,,2,2,1,3
5042_0,,,,2,2,1,3
C(C(CO)(CC=O)O)(C(CO)O)=O,,,3,1,1,0,1
5044_0,,,,2,2,1,3
C(C(C(CO)(CC(CO)O)O)=O)=O,,,3,1,1,0,1
5045_0,,,,2,2,1,3
5047_0,,,,2,2,1,3
C(C(CC(C(CO)=O)(CO)O)O)=O,,,3,1,1,0,1
5049_0,,,,2,2,1,3
C(C(C(C(CO)(CCO)O)=O)O)=O,,,3,1,1,0,1
5051_0,,,,2,2,1,3
C(CO)(C(CO)(CC(CO)=O)O)=O,,,3,1,1,0,1
5053_0,,,,2,2,1,3
C(C(CO)(CC(C(C=O)O)O)O)=O,,,3,1,1,0,1
5055_0,,,,2,2,1,3
C(C(C(C=O)O)O)(C(CO)(C)O)=O,,,3,1,1,0,1
5056_0,,,,2,2,1,3
5057_0,,,,2,2,1,3
5059_0,,,,2,2,1,3
C(C(CO)(CC(C(CO)O)O)N)=O,,,3,1,1,0,1
5061_0,,,,2,2,1,3
C(C)(C(CO)(CC(C=O)=O)O)=O,,,3,1,2,0,2
5063_0,,,,2,2,1,3
C(C(CO)(CC=O)O)(CC=O)=O,,,3,1,2,0,2
5065_0,,,,2,2,1,3
C(C(CO)(CC(C(C)=O)=O)O)=O,,,3,1,3,0,3
5067_0,,,,2,2,1,3
C(C(CO)(CC(CC=O)=O)O)=O,,,3,1,3,0,3
5069_0,,,,2,2,1,3
C1(C(CO)(O)OC(C(CO)O)C1)=O,,,3,1,1,0,1
5071_0,,,,2,2,1,3
C1(C(CO)(O)OC(C(C1)O)CO)=O,,,3,1,1,0,1
5073_0,,,,2,2,1,3
C1(C(CO)(O)OCC(C(C1)O)O)=O,,,3,1,1,0,1
5075_0,,,,2,2,1,3
C(C(CO)(CC(CCO)=O)O)(O)=O,,,3,1,1,0,1
5077_0,,,,2,2,1,3
C(C(CO)(CCC(CO)=O)O)(O)=O,,,3,1,1,0,1
5079_0,,,,2,2,1,3
C(C(CO)(CC(C(C)=O)O)O)(O)=O,,,3,1,1,0,1
5081_0,,,,2,2,1,3
C(C(CC(C(C)=O)(CO)O)O)(O)=O,,,3,1,2,0,2
5083_0,,,,2,2,1,3
C(C(CO)(CC(CC=O)O)O)(O)=O,,,3,1,1,0,1
5085_0,,,,2,2,1,3
C(CC(C(C=O)=O)(CO)O)(CO)=O,,,3,1,1,0,1
5087_0,,,,2,2,1,3
C(C(C=CC(CO)=O)(CO)O)=O,,,3,1,2,0,2
5089_0,,,,2,2,1,3
C(C(C=CC(CO)O)(CO)O)(O)=O,,,3,1,1,0,1
5091_0,,,,2,2,1,3
C(C(CO)(CC(C(CO)O)N)O)=O,,,3,1,13,0,13
5093_0,,,,2,2,1,3
C1(C(CO)(CC(C(CO)O)O1)O)=O,,,3,1,1,0,1
5095_0,,,,2,2,1,3
C1(C(CO)(CC(C(CO)O1)O)O)=O,,,3,1,1,0,1
5097_0,,,,2,2,1,3
C1(C(CO)(CC(C(CO1)O)O)O)=O,,,3,1,1,0,1
5099_0,,,,2,2,1,3
C(C(CO)(CCO)O)(O)=O,,,3,1,1,0,1
5101_0,,,,2,2,1,3
C(C(CO)(CC(C(CO)O)O)O)=O,,,3,1,1,0,1
5103_0,,,,2,2,1,3
C(C(CO)(O)O)=O,,,3,1,1,0,1
5105_0,,,,2,2,1,3
C([C](CO)O)(O)=O,,,3,1,1,0,1
5106_0,,,,2,1,2,3
5107_0,,,,2,1,2,3
5108_0,,,,2,1,2,3
5109_0,,,,2,1,2,3
5110_0,,,,2,1,2,3
5111_0,,,,2,1,2,3
5112_0,,,,2,1,2,3
5113_0,,,,2,1,2,3
5114_0,,,,2,1,2,3
5115_0,,,,2,1,2,3
5116_0,,,,2,1,2,3
5118_0,,,,2,1,1,2
C(C(C(CO)O)OC(CO)=O)=O,,,3,1,1,0,1
5120_0,,,,2,1,1,2
C(C(C(CO)OC(CO)=O)O)=O,,,3,1,1,0,1
5122_0,,,,2,1,1,2
C(C(C(COC(CO)=O)O)O)=O,,,3,1,1,0,1
5123_0,,,,2,1,2,3
5124_0,,,,2,1,2,3
5126_0,,,,2,1,2,3
C(C(CN)O)O,,,3,1,13,0,13
5128_0,,,,2,1,2,3
C(C(C(C(CN)O)O)O)O,,,3,1,1,0,1
5129_0,,,,2,1,2,3
5129_1,,,,2,1,2,3
5131_0,,,,2,1,2,3
C(C(CN)O)(O)=O,,,3,1,13,0,13
5132_0,,,,2,1,2,3
5133_0,,,,2,1,2,3
5134_0,,,,2,1,2,3
5135_0,,,,2,1,2,3
5137_0,,,,2,1,2,3
C1(C(C(CO)O)NCC1)=O,,,3,1,1,0,1
5139_0,,,,2,1,2,3
C1(C(CO)NCC(C1)O)=O,,,3,1,1,0,1
5141_0,,,,2,1,2,3
C(C)(C1C(C(CN1)O)O)=O,,,3,1,1,0,1
5143_0,,,,2,1,2,3
C(C1C(CC(CO)N1C)=O)=O,,,3,1,1,0,1
5145_0,,,,2,1,2,3
C1(CC(C=O)N(C)C1CO)=O,,,3,1,1,0,1
5147_0,,,,2,1,2,3
C1(C(C(C=O)O)N(C)CC1)=O,,,3,1,2,0,2
5147_1,,,,2,1,2,3
5149_0,,,,2,2,2,4
C1(C(C(C(C1CO)O)O)N)=O,,,3,1,1,0,1
5151_0,,,,2,2,2,4
C1(C(C(C(C(C1)O)O)O)N)=O,,,3,1,1,0,1
5153_0,,,,2,2,2,4
C(C(C(C(C(CO)O)N)=O)CO)=O,,,3,1,1,0,1
5155_0,,,,2,2,2,4
C(C(C(C(CO)C(CO)O)=O)N)=O,,,3,1,1,0,1
5157_0,,,,2,2,2,4
C(C(CO)C(C=O)O)(C(CO)N)=O,,,3,1,1,0,1
5159_0,,,,2,2,2,4
C(C(C(C=O)O)N)(C(CO)CO)=O,,,3,1,2,0,2
5159_1,,,,2,2,2,4
5161_0,,,,2,2,2,4
C(C(CO)N)(CC(C(C=O)O)O)=O,,,3,1,1,0,1
5163_0,,,,2,2,2,4
C(C(C(C(C=O)O)O)N)(CCO)=O,,,3,1,1,0,1
5165_0,,,,2,2,2,4
C(C)(C(C=O)N(C)CC=O)=O,,,3,1,1,0,1
5167_0,,,,2,2,2,4
C(C(CO)NC(C=O)C(C)=O)(O)=O,,,3,1,1,0,1
5169_0,,,,2,2,2,4
C(C(C(C)=O)N)=O,,,3,1,1,0,1
5171_0,,,,2,2,2,4
C(C(C(C)=O)NCCO)=O,,,3,1,1,0,1
5173_0,,,,2,2,2,4
C(C)(C(CO)N(C)CC=O)=O,,,3,1,1,0,1
5175_0,,,,2,2,2,4
C(C(CO)NC(C(C)=O)CO)(O)=O,,,3,1,1,0,1
5177_0,,,,2,2,2,4
C(C)(C(CO)N)=O,,,3,1,1,0,1
5179_0,,,,2,2,2,4
C(C)(C(CO)NCCO)=O,,,3,1,1,0,1
5181_0,,,,2,2,2,4
C(C(C(C=O)O)N(C)CC=O)(C)=O,,,3,1,2,0,2
5181_1,,,,2,2,2,4
5183_0,,,,2,2,2,4
C(C(C(C(C)=O)N)O)=O,,,3,1,2,0,2
5183_1,,,,2,2,2,4
5185_0,,,,2,2,2,4
C(C(C(C=O)O)NCCO)(C)=O,,,3,1,2,0,2
5185_1,,,,2,2,2,4
5186_0,,,,2,2,2,4
5187_0,,,,2,2,2,4
5187_1,,,,2,2,2,4
5188_0,,,,2,2,2,4
5189_0,,,,2,2,2,4
5190_0,,,,2,2,2,4
5191_0,,,,2,2,2,4
5193_0,,,,2,2,2,4
C(CCO)(C(C(CO)=O)N)=O,,,3,1,1,0,1
5195_0,,,,2,2,2,4
C(C(C(C(CCO)O)=O)N)=O,,,3,1,1,0,1
5196_0,,,,2,2,2,4
5197_0,,,,2,2,2,4
5197_1,,,,2,2,2,4
5199_0,,,,2,2,2,4
C(CO)(C(C(C(C)=O)O)N)=O,,,3,1,2,0,2
5199_1,,,,2,2,2,4
5201_0,,,,2,2,2,4
C(C)(C(C(C(CO)=O)O)N)=O,,,3,1,2,0,2
5201_1,,,,2,2,2,4
5203_0,,,,2,2,2,4
C(C(C(C=O)O)N)(C(C)O)=O,,,3,1,2,0,2
5203_1,,,,2,2,2,4
5204_0,,,,2,2,2,4
5205_0,,,,2,2,2,4
5206_0,,,,2,2,2,4
5208_0,,,,2,2,2,4
C(C(C(C(C(CO)O)N)=O)O)=O,,,3,1,1,0,1
5210_0,,,,2,2,2,4
C(CN(C)C(C(CNC)=O)CO)=O,,,3,1,1,0,1
5212_0,,,,2,2,2,4
C(CN(C)C(C(C)=O)CC(C=O)=O)=O,,,3,1,2,0,2
5212_1,,,,2,2,2,4
5214_0,,,,2,2,2,4
C(CC(C(C(C)=O)N(C)CC=O)=O)=O,,,3,1,1,0,1
5216_0,,,,2,2,2,4
C(C)(CC(C(C=O)N(C)CC=O)=O)=O,,,3,1,1,0,1
5218_0,,,,2,2,2,4
C(CN(C)C(C=O)C(CCC=O)=O)=O,,,3,1,1,0,1
5220_0,,,,2,2,2,4
C(CN(C)C(C=O)C(C=CCO)=O)=O,,,3,1,1,0,1
5222_0,,,,2,2,2,4
C(CN(C)C(C(C=CC=O)=O)CO)=O,,,3,1,1,0,1
5224_0,,,,2,2,2,4
C(CN(C)C(C(C=C)=O)C(C=O)O)=O,,,3,1,2,0,2
5224_1,,,,2,2,2,4
5226_0,,,,2,2,2,4
C(CN(C)C(C(C=O)=O)CO)=O,,,3,1,1,0,1
5228_0,,,,2,2,2,4
C(CNC)(C(CO)N)=O,,,3,1,1,0,1
5230_0,,,,2,2,2,4
C(CNC)(C(CO)NCCO)=O,,,3,1,1,0,1
5232_0,,,,2,2,2,4
C(C(CO)NC)(C(C(CO)O)N)=O,,,3,1,1,0,1
5234_0,,,,2,2,2,4
C(CC(C(C(CO)N)=O)NC)=O,,,3,1,1,0,1
5236_0,,,,2,2,2,4
C(C(CO)N)(CC(CNC)=O)=O,,,3,1,1,0,1
5238_0,,,,2,2,2,4
C(CCO)(C(C(CNC)=O)N)=O,,,3,1,1,0,1
5240_0,,,,2,2,2,4
C(C(C(C(CCO)NC)=O)N)=O,,,3,1,1,0,1
5242_0,,,,2,2,2,4
C(CC(C(CNC)=O)N)(CO)=O,,,3,1,2,0,2
5242_1,,,,2,2,2,4
5244_0,,,,2,2,2,4
C(C(C(C(C)=O)O)N)(CNC)=O,,,3,1,2,0,2
5244_1,,,,2,2,2,4
5246_0,,,,2,2,2,4
C(C(C(C(CNC)=O)O)N)(C)=O,,,3,1,2,0,2
5246_1,,,,2,2,2,4
5248_0,,,,2,2,2,4
C(C(C(C=O)O)N)(C(C)NC)=O,,,3,1,2,0,2
5248_1,,,,2,2,2,4
5250_0,,,,2,2,2,4
C(CC(C(C(CNC)=O)N)O)=O,,,3,1,1,0,1
5252_0,,,,2,2,2,4
C(C(C(C(C(CO)O)N)=O)NC)=O,,,3,1,1,0,1
5254_0,,,,2,2,2,4
C(CNCC(O)=O)(C(CO)N)=O,,,3,1,1,0,1
5256_0,,,,2,2,2,4
C(CNC)(C(C(C(CO)O)O)N)=O,,,3,1,1,0,1
5258_0,,,,2,2,2,4
C(C(C(CO)O)N)(CCO)=O,,,3,1,1,0,1
5260_0,,,,2,2,2,4
C(C(CO)N)(CC(CO)O)=O,,,3,1,13,0,13
5262_0,,,,2,2,2,4
C(C)(C(C(C(CO)O)O)N)=O,,,3,1,1,0,1
5264_0,,,,2,2,2,4
C(CC(C(C(CO)O)N)=O)(O)=O,,,3,1,1,0,1
5266_0,,,,2,2,2,4
C(C(C(CC(CO)O)=O)N)(O)=O,,,3,1,2,0,2
5268_0,,,,2,2,2,4
C(CC(C(O)=O)O)(C(CO)N)=O,,,3,1,1,0,1
5270_0,,,,2,2,2,4
C(C(C(C(O)=O)O)N)(CCO)=O,,,3,1,2,0,2
5270_1,,,,2,2,2,4
5272_0,,,,2,2,2,4
C(C(C(C(C(C)=O)N)O)O)(O)=O,,,3,1,1,0,1
5274_0,,,,2,2,2,4
C(C(C(C(C(CO)O)O)N)=O)(O)=O,,,3,1,1,0,1
5276_0,,,,2,2,2,4
C(C(CO)(C(C(CCO)=O)N)O)=O,,,3,1,1,0,1
5278_0,,,,2,2,2,4
C(C(CO)(C(C(C(C)=O)N)O)O)=O,,,3,1,1,0,1
5280_0,,,,2,2,2,4
C(C(CO)(CC(C(CO)N)=O)O)=O,,,3,1,1,0,1
5282_0,,,,2,2,2,4
C(CN)(C(C(C(CO)O)O)N)=O,,,3,1,1,0,1
5284_0,,,,2,2,2,4
C(C)(C(CC(C=O)=O)N)=O,,,3,1,2,0,2
5284_1,,,,2,2,2,4
5286_0,,,,2,2,2,4
C(C(CC(C=O)=O)NCCO)(C)=O,,,3,1,2,0,2
5286_1,,,,2,2,2,4
5288_0,,,,2,2,2,4
C(CC(C(C(C)=O)N)=O)=O,,,3,1,1,0,1
5290_0,,,,2,2,2,4
C(CC(C(C(C)=O)NCCO)=O)=O,,,3,1,1,0,1
5292_0,,,,2,2,2,4
C(C(C=O)N)(CC(C)=O)=O,,,3,1,1,0,1
5294_0,,,,2,2,2,4
C(C(C=O)NCCO)(CC(C)=O)=O,,,3,1,1,0,1
5296_0,,,,2,2,2,4
C(C(C(CCC=O)=O)N)=O,,,3,1,1,0,1
5298_0,,,,2,2,2,4
C(C(C(CCC=O)=O)NCCO)=O,,,3,1,1,0,1
5300_0,,,,2,2,2,4
C1(COC(C(CO)O)C1N)=O,,,3,1,1,0,1
5302_0,,,,2,2,2,4
C1(COC(CO)C(C1N)O)=O,,,3,1,1,0,1
5304_0,,,,2,2,2,4
C1(C(C(CO)OC(C1)O)N)=O,,,3,1,1,0,1
5306_0,,,,2,2,2,4
C1(C(C(O)OC(CO)C1)N)=O,,,3,1,1,0,1
5308_0,,,,2,2,2,4
C1(COCC(C(C1N)O)O)=O,,,3,1,1,0,1
5310_0,,,,2,2,2,4
C1(C(C(COC(C1)O)O)N)=O,,,3,1,1,0,1
5312_0,,,,2,2,2,4
C1(C(C(O)OCC(C1)O)N)=O,,,3,1,1,0,1
5314_0,,,,2,2,2,4
C1(C(COC(C(C1)O)O)N)=O,,,3,1,1,0,1
5316_0,,,,2,2,2,4
C1(C(C(C(O)OCC1)O)N)=O,,,3,1,1,0,1
5318_0,,,,2,2,2,4
C(C(C(CO)O)N)(CCN)=O,,,3,1,1,0,1
5320_0,,,,2,2,2,4
C(C(CN)N)(CC(CO)O)=O,,,3,1,1,0,1
5322_0,,,,2,2,2,4
C(C(CO)N)(CC(CN)O)=O,,,3,1,1,0,1
5324_0,,,,2,2,2,4
C(C(C(CN)O)N)(CCO)=O,,,3,1,1,0,1
5326_0,,,,2,2,2,4
C(C)(C(C(C(CN)O)O)N)=O,,,3,1,1,0,1
5328_0,,,,2,2,2,4
C(C(CC(C(C)=O)N)O)(O)=O,,,3,1,1,0,1
5330_0,,,,2,2,2,4
C(C(CO)N)(CC(C=O)=O)=O,,,3,1,1,0,1
5332_0,,,,2,2,2,4
C(CCO)(C(C(C=O)=O)N)=O,,,3,1,1,0,1
5334_0,,,,2,2,2,4
C(CO)(CC(C(C=O)=O)N)=O,,,3,1,2,0,2
5334_1,,,,2,2,2,4
5336_0,,,,2,2,2,4
C(C)(C(C(C(C=O)=O)N)O)=O,,,3,1,2,0,2
5336_1,,,,2,2,2,4
5338_0,,,,2,2,2,4
C(C)(C(C(C(C=O)=O)O)N)=O,,,3,1,2,0,2
5338_1,,,,2,2,2,4
5340_0,,,,2,2,2,4
C(CC(C(C(C=O)=O)N)O)=O,,,3,1,1,0,1
5342_0,,,,2,2,2,4
C(C(C(C=CCO)=O)N)=O,,,3,1,1,0,1
5344_0,,,,2,2,2,4
C(C(C(C=CCO)=O)NCCO)=O,,,3,1,1,0,1
5346_0,,,,2,2,2,4
C(C=CC(C(CO)N)=O)=O,,,3,1,1,0,1
5348_0,,,,2,2,2,4
C(C=CC(C(CO)NCCO)=O)=O,,,3,1,1,0,1
5350_0,,,,2,2,2,4
C(C(C(C(C=C)=O)N)O)=O,,,3,1,2,0,2
5350_1,,,,2,2,2,4
5352_0,,,,2,2,2,4
C(C(C(C(C=C)=O)NCCO)O)=O,,,3,1,2,0,2
5352_1,,,,2,2,2,4
5354_0,,,,2,2,2,4
C(CO)(C(C(C(CO)O)NC)N)=O,,,3,1,1,0,1
5356_0,,,,2,2,2,4
C(CC(C(C(CO)NC)N)=O)=O,,,3,1,1,0,1
5358_0,,,,2,2,2,4
C(C(C(CC(CO)NC)=O)N)=O,,,3,1,1,0,1
5360_0,,,,2,2,2,4
C(CC(C=O)NC)(C(CO)N)=O,,,3,1,1,0,1
5362_0,,,,2,2,2,4
C(CC(C=O)O)(C(CNC)N)=O,,,3,1,1,0,1
5364_0,,,,2,2,2,4
C(C(C(C=O)NC)N)(CCO)=O,,,3,1,2,0,2
5364_1,,,,2,2,2,4
5366_0,,,,2,2,2,4
C(C(C(C=O)O)N)(CCNC)=O,,,3,1,2,0,2
5366_1,,,,2,2,2,4
5368_0,,,,2,2,2,4
C(C(C(C(C(C)=O)N)NC)O)=O,,,3,1,1,0,1
5370_0,,,,2,2,2,4
C(C(C(C(C(CO)O)NC)N)=O)=O,,,3,1,1,0,1
5372_0,,,,2,2,2,4
C1(C(O)OC(C(CO)O)C1N)=O,,,3,1,1,0,1
5374_0,,,,2,2,2,4
C1(C(O)OC(CO)C(C1N)O)=O,,,3,1,1,0,1
5376_0,,,,2,2,2,4
C1(C(O)OCC(C(C1N)O)O)=O,,,3,1,1,0,1
5378_0,,,,2,2,2,4
C(C(C(CO)N)=O)=O,,,3,1,1,0,1
5380_0,,,,2,2,2,4
C(C(C(CO)NCCO)=O)=O,,,3,1,1,0,1
5382_0,,,,2,2,2,4
C(C(C(C)=O)NCC(O)=O)=O,,,3,1,1,0,1
5384_0,,,,2,2,2,4
C(C)(C(CO)NCC(O)=O)=O,,,3,1,1,0,1
5386_0,,,,2,2,2,4
C(CNC(C(C)=O)C(C=O)O)(O)=O,,,3,1,2,0,2
5386_1,,,,2,2,2,4
5387_0,,,,2,2,2,4
5389_0,,,,2,2,2,4
C(CNC(C(C=O)=O)CO)(O)=O,,,3,1,2,0,2
5390_0,,,,2,2,2,4
5391_0,,,,2,2,2,4
5392_0,,,,2,2,2,4
5393_0,,,,2,2,2,4
5394_0,,,,2,2,2,4
5395_0,,,,2,2,2,4
5395_1,,,,2,2,2,4
5396_0,,,,2,2,2,4
5397_0,,,,2,2,2,4
5397_1,,,,2,2,2,4
5398_0,,,,2,2,2,4
5399_0,,,,2,2,2,4
5400_0,,,,2,2,2,4
5401_0,,,,2,2,2,4
5402_0,,,,2,2,2,4
5403_0,,,,2,2,2,4
5404_0,,,,2,2,2,4
5405_0,,,,2,2,2,4
5405_1,,,,2,2,2,4
5406_0,,,,2,2,2,4
5406_1,,,,2,2,2,4
5407_0,,,,2,2,2,4
5407_1,,,,2,2,2,4
5408_0,,,,2,2,2,4
5408_1,,,,2,2,2,4
5409_0,,,,2,2,2,4
5410_0,,,,2,2,2,4
5411_0,,,,2,2,2,4
5412_0,,,,2,2,2,4
5413_0,,,,2,2,2,4
5414_0,,,,2,2,2,4
5415_0,,,,2,2,2,4
5416_0,,,,2,2,2,4
5417_0,,,,2,2,2,4
5418_0,,,,2,2,2,4
5418_1,,,,2,2,2,4
5419_0,,,,2,2,2,4
5419_1,,,,2,2,2,4
5420_0,,,,2,2,2,4
5420_1,,,,2,2,2,4
5421_0,,,,2,2,2,4
5421_1,,,,2,2,2,4
5422_0,,,,2,2,2,4
5423_0,,,,2,2,2,4
5424_0,,,,2,2,2,4
5425_0,,,,2,2,2,4
5426_0,,,,2,2,2,4
5427_0,,,,2,2,2,4
5428_0,,,,2,2,2,4
5429_0,,,,2,2,2,4
5430_0,,,,2,2,2,4
5430_1,,,,2,2,2,4
5431_0,,,,2,2,2,4
5432_0,,,,2,2,2,4
5434_0,,,,2,2,2,4
C(C(CC(C=O)=O)NC)(C)=O,,,3,1,4,0,4
5434_1,,,,2,2,2,4
5436_0,,,,2,2,2,4
C(CC(C(C(C)=O)NC)=O)=O,,,3,1,3,0,3
5438_0,,,,2,2,2,4
C(C(C=O)NC)(CC(C)=O)=O,,,3,1,2,0,2
5440_0,,,,2,2,2,4
C(C(C(CCC=O)=O)NC)=O,,,3,1,2,0,2
5442_0,,,,2,2,2,4
C1(COC(C(CO)O)C1NC)=O,,,3,1,1,0,1
5444_0,,,,2,2,2,4
C1(COC(CO)C(C1NC)O)=O,,,3,1,1,0,1
5446_0,,,,2,2,2,4
C1(C(C(CO)OC(C1)O)NC)=O,,,3,1,2,0,2
5448_0,,,,2,2,2,4
C1(C(C(O)OC(CO)C1)NC)=O,,,3,1,2,0,2
5450_0,,,,2,2,2,4
C1(COCC(C(C1NC)O)O)=O,,,3,1,1,0,1
5452_0,,,,2,2,2,4
C1(C(C(COC(C1)O)O)NC)=O,,,3,1,2,0,2
5454_0,,,,2,2,2,4
C1(C(C(O)OCC(C1)O)NC)=O,,,3,1,2,0,2
5456_0,,,,2,2,2,4
C1(C(COC(C(C1)O)O)NC)=O,,,3,1,2,0,2
5458_0,,,,2,2,2,4
C1(C(C(C(O)OCC1)O)NC)=O,,,3,1,2,0,2
5460_0,,,,2,2,2,4
C(C(C(CO)O)NC)(CCN)=O,,,3,1,13,0,13
5462_0,,,,2,2,2,4
C(C(CN)NC)(CC(CO)O)=O,,,3,1,13,0,13
5464_0,,,,2,2,2,4
C(C(CO)NC)(CC(CN)O)=O,,,3,1,13,0,13
5466_0,,,,2,2,2,4
C(C(C(CN)O)NC)(CCO)=O,,,3,1,13,0,13
5468_0,,,,2,2,2,4
C(C)(C(C(C(CN)O)O)NC)=O,,,3,1,13,0,13
5470_0,,,,2,2,2,4
C(C(CC(C(C)=O)NC)O)(O)=O,,,3,1,2,0,2
5472_0,,,,2,2,2,4
C(C(CO)NC)(CC(C=O)=O)=O,,,3,1,2,0,2
5474_0,,,,2,2,2,4
C(CCO)(C(C(C=O)=O)NC)=O,,,3,1,3,0,3
5476_0,,,,2,2,2,4
C(CC(C(C=O)=O)NC)(CO)=O,,,3,1,4,0,4
5476_1,,,,2,2,2,4
5478_0,,,,2,2,2,4
C(C(C(C(C=O)=O)NC)O)(C)=O,,,3,1,4,0,4
5478_1,,,,2,2,2,4
5480_0,,,,2,2,2,4
C(C(C(C(C=O)=O)O)NC)(C)=O,,,3,1,4,0,4
5480_1,,,,2,2,2,4
5482_0,,,,2,2,2,4
C(CC(C(C(C=O)=O)NC)O)=O,,,3,1,3,0,3
5484_0,,,,2,2,2,4
C(C(C(C=CCO)=O)NC)=O,,,3,1,2,0,2
5486_0,,,,2,2,2,4
C(C=CC(C(CO)NC)=O)=O,,,3,1,2,0,2
5488_0,,,,2,2,2,4
C(C(C(C(C=C)=O)NC)O)=O,,,3,1,3,0,3
5488_1,,,,2,2,2,4
5490_0,,,,2,2,2,4
C(CC(C(C(CO)NC)NC)=O)=O,,,3,1,2,0,2
5492_0,,,,2,2,2,4
C(C(C(CC(CO)NC)=O)NC)=O,,,3,1,2,0,2
5494_0,,,,2,2,2,4
C(CC(C=O)NC)(C(CO)NC)=O,,,3,1,2,0,2
5496_0,,,,2,2,2,4
C(CC(C=O)O)(C(CNC)NC)=O,,,3,1,2,0,2
5498_0,,,,2,2,2,4
C(C(C(C=O)NC)NC)(CCO)=O,,,3,1,3,0,3
5498_1,,,,2,2,2,4
5500_0,,,,2,2,2,4
C(C(C(C=O)O)NC)(CCNC)=O,,,3,1,3,0,3
5500_1,,,,2,2,2,4
5502_0,,,,2,2,2,4
C(C(C(C(C(C)=O)NC)NC)O)=O,,,3,1,2,0,2
5504_0,,,,2,2,2,4
C1(C(O)OC(C(CO)O)C1NC)=O,,,3,1,2,0,2
5506_0,,,,2,2,2,4
C1(C(O)OC(CO)C(C1NC)O)=O,,,3,1,2,0,2
5508_0,,,,2,2,2,4
C1(C(O)OCC(C(C1NC)O)O)=O,,,3,1,2,0,2
5510_0,,,,2,2,2,4
C(C(C(CO)NC)=O)=O,,,3,1,2,0,2
5511_0,,,,2,2,2,4
5512_0,,,,2,2,2,4
5513_0,,,,2,2,2,4
5514_0,,,,2,2,2,4
5514_1,,,,2,2,2,4
5515_0,,,,2,2,2,4
5516_0,,,,2,2,2,4
5517_0,,,,2,2,3,5
5519_0,,,,2,2,3,5
C(C(C(CO)C(C(CO)O)O)N)=O,,,3,1,11,0,11
5520_0,,,,2,2,3,5
5521_0,,,,2,2,3,5
5522_0,,,,2,2,3,5
5524_0,,,,2,2,3,5
C(C(C(CC(CO)O)O)N)=O,,,3,1,11,0,11
5526_0,,,,2,2,3,5
C(C(C(CC(CO)O)NC)N)=O,,,3,1,11,0,11
5527_0,,,,2,2,3,5
5529_0,,,,2,2,3,5
C(CC(C=O)N)(CCO)=O,,,3,1,12,0,12
5531_0,,,,2,2,3,5
C(C(CCC(CO)=O)N)=O,,,3,1,12,0,12
5533_0,,,,2,2,3,5
C(C(CC(C(C)=O)O)N)=O,,,3,1,12,0,12
5535_0,,,,2,2,3,5
C(CC(CC(C=O)N)O)=O,,,3,1,12,0,12
5536_0,,,,2,2,3,5
5537_0,,,,2,2,3,5
5538_0,,,,2,2,3,5
5539_0,,,,2,2,3,5
5540_0,,,,2,2,3,5
5542_0,,,,2,2,3,5
C(C(C=CC(CO)O)N)=O,,,3,1,12,0,12
5544_0,,,,2,2,3,5
C(C(CC(C(CO)O)NC)N)=O,,,3,1,11,0,11
5545_0,,,,2,2,3,5
5546_0,,,,2,2,3,5
5547_0,,,,2,2,3,5
5548_0,,,,2,2,3,5
5550_0,,,,2,2,3,5
C(CN)(CCO)=O,,,3,1,12,0,12
5551_0,,,,2,2,3,5
5552_0,,,,2,2,3,5
5553_0,,,,2,2,3,5
5554_0,,,,2,2,3,5
5556_0,,,,2,2,3,5
C(CCO)(CC(CN)=O)=O,,,3,1,13,0,13
5558_0,,,,2,2,3,5
C(CO)(CCC(CN)=O)=O,,,3,1,13,0,13
5560_0,,,,2,2,3,5
C(C)(C(CC(CN)=O)O)=O,,,3,1,13,0,13
5562_0,,,,2,2,3,5
C(CC(CC(CN)=O)O)=O,,,3,1,13,0,13
5563_0,,,,2,2,3,5
5564_0,,,,2,2,3,5
5565_0,,,,2,2,3,5
5566_0,,,,2,2,3,5
5567_0,,,,2,2,3,5
5569_0,,,,2,2,3,5
C(C(CO)O)=CC(CN)=O,,,3,1,12,0,12
5571_0,,,,2,2,3,5
C(CN)(CC(C(CO)O)NC)=O,,,3,1,12,0,12
5573_0,,,,2,2,3,5
C(CN)(C(C(C(CO)O)NC)O)=O,,,3,1,12,0,12
5574_0,,,,2,2,3,5
5575_0,,,,2,2,3,5
5576_0,,,,2,2,3,5
5577_0,,,,2,2,3,5
5579_0,,,,2,2,3,5
C(C(CNC)N)(CC(CO)O)=O,,,3,1,11,0,11
5581_0,,,,2,2,3,5
C(CC(C(CCO)N)=O)=O,,,3,1,12,0,12
5583_0,,,,2,2,3,5
C(CC(C(CCO)=O)N)=O,,,3,1,12,0,12
5585_0,,,,2,2,3,5
C(CC(C=O)O)(C(C)N)=O,,,3,1,12,0,12
5587_0,,,,2,2,3,5
C(C(CC(C(C)=O)N)O)=O,,,3,1,12,0,12
5589_0,,,,2,2,3,5
C(CNCC=O)=O,,,3,1,1,0,1
5591_0,,,,2,2,3,5
C(CNCC=O)(C(CO)O)=O,,,3,1,2,0,2
5593_0,,,,2,2,3,5
C(C(C(CO)NCC=O)O)=O,,,3,1,1,0,1
5595_0,,,,2,2,3,5
C(C(C)NCC=O)=O,,,3,1,1,0,1
5597_0,,,,2,2,3,5
C(C(C)NCC(C(CO)O)=O)=O,,,3,1,1,0,1
5599_0,,,,2,2,3,5
C(C(C)NC(CO)C(C=O)O)=O,,,3,1,1,0,1
5601_0,,,,2,2,3,5
C(C(CCO)NCC=O)=O,,,3,1,1,0,1
5603_0,,,,2,2,3,5
C(C(CO)NCC=O)=O,,,3,1,1,0,1
5605_0,,,,2,2,3,5
C(C(CO)NCC(C(CO)O)=O)=O,,,3,1,1,0,1
5607_0,,,,2,2,3,5
C(C(CO)NC(CO)C(C=O)O)=O,,,3,1,1,0,1
5609_0,,,,2,2,3,5
C(CC(C=O)NCC=O)(CCO)=O,,,3,1,1,0,1
5611_0,,,,2,2,3,5
C(CNC(C=O)CCC(CO)=O)=O,,,3,1,1,0,1
5613_0,,,,2,2,3,5
C(C)(C(CC(C=O)NCC=O)O)=O,,,3,1,1,0,1
5615_0,,,,2,2,3,5
C(CC(CC(C=O)NCC=O)O)=O,,,3,1,1,0,1
5617_0,,,,2,2,3,5
C(C(C=CC(CO)O)NCC=O)=O,,,3,1,1,0,1
5619_0,,,,2,2,3,5
C(C(C(CO)O)NCC=O)=O,,,3,1,1,0,1
5621_0,,,,2,2,3,5
C(CNCC(C)=O)=O,,,3,1,1,0,1
5623_0,,,,2,2,3,5
C(CNCC(C(CO)O)=O)(C)=O,,,3,1,1,0,1
5625_0,,,,2,2,3,5
C(C(C(CO)NCC(C)=O)O)=O,,,3,1,1,0,1
5627_0,,,,2,2,3,5
C(CNCC=O)(CCO)=O,,,3,1,1,0,1
5629_0,,,,2,2,3,5
C(CNCC(CO)=O)=O,,,3,1,1,0,1
5631_0,,,,2,2,3,5
C(CNCC(CO)=O)(C(CO)O)=O,,,3,1,1,0,1
5633_0,,,,2,2,3,5
C(C(C(CO)NCC(CO)=O)O)=O,,,3,1,1,0,1
5635_0,,,,2,2,3,5
C(CCO)(CC(CNCC=O)=O)=O,,,3,1,1,0,1
5637_0,,,,2,2,3,5
C(CNCC(CCC(CO)=O)=O)=O,,,3,1,1,0,1
5639_0,,,,2,2,3,5
C(CNCC(CC(C(C)=O)O)=O)=O,,,3,1,1,0,1
5641_0,,,,2,2,3,5
C(CC(CC(CNCC=O)=O)O)=O,,,3,1,1,0,1
5643_0,,,,2,2,3,5
C(CNCC(C=CC(CO)O)=O)=O,,,3,1,1,0,1
5644_0,,,,2,2,3,5
5646_0,,,,2,2,3,5
C(C(CCO)NCC=O)(CC=O)=O,,,3,1,1,0,1
5648_0,,,,2,2,3,5
C(CNC(C(CCO)=O)CC=O)=O,,,3,1,1,0,1
5650_0,,,,2,2,3,5
C(CC(C=O)O)(C(C)NCC=O)=O,,,3,1,1,0,1
5652_0,,,,2,2,3,5
C(C)(C(CC(C=O)O)NCC=O)=O,,,3,1,1,0,1
5653_0,,,,2,2,3,5
5654_0,,,,2,2,3,5
5655_0,,,,2,2,3,5
5656_0,,,,2,2,3,5
5657_0,,,,2,2,3,5
5658_0,,,,2,2,3,5
5659_0,,,,2,2,3,5
5660_0,,,,2,2,3,5
5661_0,,,,2,2,3,5
5662_0,,,,2,2,3,5
5663_0,,,,2,2,3,5
5664_0,,,,2,2,3,5
5665_0,,,,2,2,3,5
5666_0,,,,2,2,3,5
5667_0,,,,2,2,3,5
5668_0,,,,2,2,3,5
5669_0,,,,2,2,3,5
5670_0,,,,2,2,3,5
5671_0,,,,2,2,3,5
5672_0,,,,2,2,3,5
5673_0,,,,2,2,3,5
5674_0,,,,2,2,3,5
5675_0,,,,2,2,3,5
5676_0,,,,2,2,3,5
5677_0,,,,2,2,3,5
5678_0,,,,2,2,3,5
5679_0,,,,2,2,3,5
5680_0,,,,2,2,3,5
5681_0,,,,2,2,3,5
5682_0,,,,2,2,3,5
5683_0,,,,2,2,3,5
5684_0,,,,2,2,3,5
5685_0,,,,2,2,3,5
5686_0,,,,2,2,3,5
5687_0,,,,2,2,3,5
5688_0,,,,2,2,3,5
5689_0,,,,2,2,3,5
5690_0,,,,2,2,3,5
5691_0,,,,2,2,3,5
5692_0,,,,2,2,3,5
5693_0,,,,2,2,3,5
5694_0,,,,2,2,3,5
5695_0,,,,2,2,3,5
5696_0,,,,2,2,3,5
5697_0,,,,2,2,3,5
5698_0,,,,2,2,3,5
5699_0,,,,2,2,3,5
5700_0,,,,2,2,3,5
5701_0,,,,2,2,3,5
5702_0,,,,2,2,3,5
5703_0,,,,2,2,3,5
5704_0,,,,2,2,3,5
5705_0,,,,2,2,3,5
5706_0,,,,2,2,3,5
5707_0,,,,2,2,3,5
5708_0,,,,2,2,3,5
5709_0,,,,2,2,3,5
5710_0,,,,2,2,3,5
5711_0,,,,2,2,3,5
5712_0,,,,2,2,3,5
5713_0,,,,2,2,3,5
5714_0,,,,2,2,3,5
5715_0,,,,2,2,3,5
5716_0,,,,2,2,3,5
5717_0,,,,2,2,3,5
5718_0,,,,2,2,3,5
5719_0,,,,2,2,3,5
5720_0,,,,2,2,3,5
5721_0,,,,2,2,3,5
5722_0,,,,2,2,3,5
5723_0,,,,2,2,3,5
5724_0,,,,2,2,3,5
5725_0,,,,2,2,3,5
5726_0,,,,2,2,3,5
5727_0,,,,2,2,3,5
5728_0,,,,2,2,3,5
5729_0,,,,2,2,3,5
5730_0,,,,2,2,3,5
5731_0,,,,2,2,3,5
5732_0,,,,2,2,3,5
5733_0,,,,2,2,3,5
5734_0,,,,2,2,3,5
5735_0,,,,2,2,3,5
5736_0,,,,2,2,3,5
5737_0,,,,2,2,3,5
5738_0,,,,2,2,3,5
5739_0,,,,2,2,3,5
5740_0,,,,2,2,3,5
5741_0,,,,2,2,3,5
5742_0,,,,2,2,3,5
5743_0,,,,2,2,3,5
5744_0,,,,2,2,3,5
5745_0,,,,2,2,3,5
5746_0,,,,2,2,3,5
5747_0,,,,2,2,3,5
5748_0,,,,2,2,3,5
5749_0,,,,2,2,3,5
5750_0,,,,2,2,3,5
5751_0,,,,2,2,3,5
5752_0,,,,2,2,3,5
5753_0,,,,2,2,3,5
5754_0,,,,2,2,3,5
5755_0,,,,2,2,3,5
5756_0,,,,2,2,3,5
5757_0,,,,2,2,3,5
5758_0,,,,2,2,3,5
5759_0,,,,2,2,3,5
5760_0,,,,2,2,3,5
5761_0,,,,2,2,3,5
5762_0,,,,2,2,3,5
5763_0,,,,2,2,3,5
5764_0,,,,2,2,3,5
5765_0,,,,2,2,3,5
5766_0,,,,2,2,3,5
5767_0,,,,2,2,3,5
5768_0,,,,2,2,3,5
5769_0,,,,2,2,3,5
5770_0,,,,2,2,3,5
5771_0,,,,2,2,3,5
5772_0,,,,2,2,3,5
5773_0,,,,2,2,3,5
5774_0,,,,2,2,3,5
5775_0,,,,2,2,3,5
5776_0,,,,2,2,3,5
5777_0,,,,2,2,3,5
5778_0,,,,2,2,3,5
5779_0,,,,2,2,3,5
5780_0,,,,2,2,3,5
5781_0,,,,2,2,3,5
5782_0,,,,2,2,3,5
5783_0,,,,2,2,3,5
5784_0,,,,2,2,3,5
5785_0,,,,2,2,3,5
5786_0,,,,2,2,3,5
5787_0,,,,2,2,3,5
5788_0,,,,2,2,3,5
5789_0,,,,2,2,3,5
5790_0,,,,2,2,3,5
5791_0,,,,2,2,3,5
5792_0,,,,2,2,3,5
5793_0,,,,2,2,3,5
5794_0,,,,2,2,3,5
5795_0,,,,2,2,3,5
5796_0,,,,2,2,3,5
5797_0,,,,2,2,3,5
5798_0,,,,2,2,3,5
5799_0,,,,2,2,3,5
5800_0,,,,2,2,3,5
5801_0,,,,2,2,3,5
5802_0,,,,2,2,3,5
5803_0,,,,2,2,3,5
5804_0,,,,2,2,3,5
5805_0,,,,2,2,3,5
5806_0,,,,2,2,3,5
5807_0,,,,2,2,3,5
5808_0,,,,2,2,3,5
5809_0,,,,2,2,3,5
5810_0,,,,2,2,3,5
5811_0,,,,2,2,3,5
5812_0,,,,2,2,3,5
5813_0,,,,2,2,3,5
5814_0,,,,2,2,3,5
5815_0,,,,2,2,3,5
5816_0,,,,2,2,3,5
5817_0,,,,2,2,3,5
5818_0,,,,2,2,3,5
5819_0,,,,2,2,3,5
5820_0,,,,2,2,3,5
5821_0,,,,2,2,3,5
5822_0,,,,2,2,3,5
5823_0,,,,2,2,3,5
5824_0,,,,2,2,3,5
5825_0,,,,2,2,3,5
5826_0,,,,2,2,3,5
5827_0,,,,2,2,3,5
5828_0,,,,2,2,3,5
5829_0,,,,2,2,3,5
5830_0,,,,2,2,3,5
5831_0,,,,2,2,3,5
5832_0,,,,2,2,3,5
5833_0,,,,2,2,3,5
5834_0,,,,2,2,3,5
5835_0,,,,2,2,3,5
5836_0,,,,2,2,3,5
5837_0,,,,2,2,3,5
5838_0,,,,2,2,3,5
5839_0,,,,2,2,3,5
5840_0,,,,2,2,3,5
5841_0,,,,2,2,3,5
5842_0,,,,2,2,3,5
5843_0,,,,2,2,3,5
5844_0,,,,2,2,3,5
5845_0,,,,2,2,3,5
5846_0,,,,2,2,3,5
5847_0,,,,2,2,3,5
5848_0,,,,2,2,3,5
5849_0,,,,2,2,3,5
5850_0,,,,2,2,3,5
5851_0,,,,2,2,3,5
5852_0,,,,2,2,3,5
5853_0,,,,2,2,3,5
5854_0,,,,2,2,3,5
5855_0,,,,2,2,3,5
5856_0,,,,2,2,3,5
5857_0,,,,2,2,3,5
5858_0,,,,2,2,3,5
5859_0,,,,2,2,3,5
5860_0,,,,2,2,3,5
5861_0,,,,2,2,3,5
5862_0,,,,2,2,3,5
5863_0,,,,2,2,3,5
5864_0,,,,2,2,3,5
5866_0,,,,2,1,2,3
C#CC(C(C(CO)O)O)O,,,3,1,1,0,1
5867_0,,,,2,2,1,3
5868_0,,,,2,2,1,3
5869_0,,,,2,2,1,3
5870_0,,,,2,2,1,3
5871_0,,,,2,2,1,3
5872_0,,,,2,2,2,4
5873_0,,,,2,2,2,4
5873_1,,,,2,2,2,4
5874_0,,,,2,2,2,4
5875_0,,,,2,2,2,4
5876_0,,,,2,2,2,4
5877_0,,,,2,2,2,4
5878_0,,,,2,2,2,4
5879_0,,,,2,2,2,4
5880_0,,,,2,2,2,4
5881_0,,,,2,2,2,4
5882_0,,,,2,2,2,4
5883_0,,,,2,2,2,4
5883_1,,,,2,2,2,4
5884_0,,,,2,2,2,4
5885_0,,,,2,2,2,4
5887_0,,,,2,2,1,3
C(CC(C(C(CO)O)O)O)(N)=O,,,3,1,9,0,9
5887_1,,,,2,2,1,3
5887_2,,,,2,2,1,3
5888_0,,,,2,2,1,3
5888_1,,,,2,2,1,3
5888_2,,,,2,2,1,3
5889_0,,,,2,2,1,3
5889_1,,,,2,2,1,3
5889_2,,,,2,2,1,3
5891_0,,,,2,2,1,3
C(C(C(C(C(CO)O)O)O)O)(N)=O,,,3,1,9,0,9
5891_1,,,,2,2,1,3
5891_2,,,,2,2,1,3
5893_0,,,,2,2,1,3
C(C(CC(C(CO)O)O)O)(N)=O,,,3,1,9,0,9
5893_1,,,,2,2,1,3
5893_2,,,,2,2,1,3
5894_0,,,,2,2,1,3
5894_1,,,,2,2,1,3
5894_2,,,,2,2,1,3
5895_0,,,,2,2,1,3
5895_1,,,,2,2,1,3
5895_2,,,,2,2,1,3
5896_0,,,,2,2,1,3
5896_1,,,,2,2,1,3
5896_2,,,,2,2,1,3
5897_0,,,,2,2,1,3
5897_1,,,,2,2,1,3
5897_2,,,,2,2,1,3
5899_0,,,,2,2,1,3
C(CC(C(C(CO)O)O)O)(NC)=O,,,3,1,9,0,9
5899_1,,,,2,2,1,3
5899_2,,,,2,2,1,3
5900_0,,,,2,2,1,3
5900_1,,,,2,2,1,3
5900_2,,,,2,2,1,3
5901_0,,,,2,2,1,3
5901_1,,,,2,2,1,3
5901_2,,,,2,2,1,3
5903_0,,,,2,2,1,3
C(C(CC(C(CO)O)O)O)(NC)=O,,,3,1,9,0,9
5903_1,,,,2,2,1,3
5903_2,,,,2,2,1,3
5904_0,,,,2,2,1,3
5904_1,,,,2,2,1,3
5904_2,,,,2,2,1,3
5905_0,,,,2,2,1,3
5905_1,,,,2,2,1,3
5905_2,,,,2,2,1,3
5907_0,,,,2,1,2,3
C1(CC(C(C1CO)=O)O)=O,,,3,1,2,0,2
5909_0,,,,2,1,2,3
C1(C(CO)CC(C1O)=O)=O,,,3,1,1,0,1
5910_0,,,,2,1,2,3
5911_0,,,,2,1,2,3
5912_0,,,,2,1,2,3
5913_0,,,,2,1,2,3
5914_0,,,,2,1,2,3
5915_0,,,,2,1,2,3
5916_0,,,,2,1,2,3
5917_0,,,,2,1,2,3
5918_0,,,,2,1,2,3
5919_0,,,,2,1,2,3
5920_0,,,,2,1,2,3
5922_0,,,,2,1,2,3
C(CC(C(O)=O)=O)=O,,,3,1,1,0,1
5923_0,,,,2,1,2,3
5924_0,,,,2,1,2,3
5925_0,,,,2,1,2,3
5926_0,,,,2,1,2,3
5927_0,,,,2,1,2,3
5928_0,,,,2,1,2,3
5929_0,,,,2,1,2,3
5930_0,,,,2,1,2,3
5931_0,,,,2,1,2,3
5932_0,,,,2,1,2,3
5933_0,,,,2,1,2,3
5934_0,,,,2,1,2,3
5935_0,,,,2,1,2,3
5936_0,,,,2,1,2,3
5937_0,,,,2,1,2,3
5938_0,,,,2,1,2,3
5939_0,,,,2,1,2,3
5940_0,,,,2,1,2,3
5941_0,,,,2,1,2,3
5942_0,,,,2,1,2,3
5944_0,,,,2,1,2,3
C(C(C(CC(C(C)=O)=O)O)O)=O,,,3,1,1,0,1
5946_0,,,,2,1,2,3
C(CC(C(C=O)O)O)(CC=O)=O,,,3,1,1,0,1
5947_0,,,,2,1,2,3
5948_0,,,,2,1,2,3
5949_0,,,,2,1,2,3
5950_0,,,,2,1,2,3
5951_0,,,,2,1,2,3
5952_0,,,,2,1,2,3
5953_0,,,,2,1,2,3
5954_0,,,,2,1,2,3
5955_0,,,,2,1,2,3
5956_0,,,,2,1,2,3
5957_0,,,,2,1,2,3
5958_0,,,,2,1,2,3
5959_0,,,,2,1,2,3
5960_0,,,,2,1,2,3
5961_0,,,,2,1,2,3
5962_0,,,,2,1,2,3
5964_0,,,,2,1,2,3
C(C(C)=O)(C(C(CO)O)O)=O,,,3,1,1,0,1
5965_0,,,,2,1,2,3
5966_0,,,,2,1,2,3
5967_0,,,,2,1,2,3
5968_0,,,,2,1,2,3
5969_0,,,,2,1,2,3
5970_0,,,,2,1,2,3
5971_0,,,,2,1,2,3
5972_0,,,,2,1,2,3
5973_0,,,,2,1,2,3
5974_0,,,,2,1,2,3
5975_0,,,,2,1,2,3
5976_0,,,,2,1,2,3
5977_0,,,,2,1,2,3
5978_0,,,,2,1,2,3
5979_0,,,,2,1,2,3
5980_0,,,,2,1,2,3
5981_0,,,,2,1,2,3
5982_0,,,,2,1,2,3
5983_0,,,,2,1,2,3
5984_0,,,,2,1,2,3
5985_0,,,,2,1,2,3
5986_0,,,,2,1,2,3
5987_0,,,,2,1,2,3
5988_0,,,,2,1,2,3
5989_0,,,,2,1,2,3
5990_0,,,,2,1,2,3
5991_0,,,,2,1,2,3
5992_0,,,,2,1,2,3
5993_0,,,,2,1,2,3
5994_0,,,,2,1,2,3
5995_0,,,,2,1,2,3
5996_0,,,,2,1,2,3
5997_0,,,,2,1,2,3
5998_0,,,,2,1,2,3
5999_0,,,,2,1,2,3
6000_0,,,,2,1,2,3
6001_0,,,,2,1,2,3
6002_0,,,,2,1,2,3
6003_0,,,,2,1,2,3
6004_0,,,,2,1,2,3
6005_0,,,,2,1,2,3
6006_0,,,,2,1,2,3
6007_0,,,,2,1,2,3
6008_0,,,,2,1,2,3
6009_0,,,,2,1,2,3
6010_0,,,,2,1,2,3
6011_0,,,,2,1,2,3
6012_0,,,,2,1,2,3
6013_0,,,,2,1,2,3
6014_0,,,,2,1,2,3
6015_0,,,,2,1,2,3
6016_0,,,,2,1,2,3
6017_0,,,,2,1,2,3
6018_0,,,,2,1,2,3
6019_0,,,,2,1,2,3
6020_0,,,,2,1,2,3
6021_0,,,,2,1,2,3
6022_0,,,,2,1,2,3
6023_0,,,,2,1,2,3
6024_0,,,,2,1,2,3
6025_0,,,,2,1,2,3
6026_0,,,,2,1,2,3
6027_0,,,,2,1,2,3
6028_0,,,,2,1,2,3
6029_0,,,,2,1,2,3
6030_0,,,,2,1,2,3
6031_0,,,,2,1,2,3
6032_0,,,,2,1,2,3
6033_0,,,,2,1,2,3
6034_0,,,,2,1,2,3
6035_0,,,,2,1,2,3
6036_0,,,,2,1,2,3
6037_0,,,,2,1,2,3
6038_0,,,,2,1,2,3
6039_0,,,,2,1,2,3
6040_0,,,,2,1,2,3
6041_0,,,,2,1,2,3
6042_0,,,,2,1,2,3
6043_0,,,,2,1,2,3
6044_0,,,,2,1,2,3
6045_0,,,,2,1,2,3
6046_0,,,,2,1,2,3
6047_0,,,,2,1,2,3
6048_0,,,,2,1,2,3
6049_0,,,,2,1,2,3
6050_0,,,,2,1,2,3
6051_0,,,,2,1,2,3
6052_0,,,,2,1,2,3
6053_0,,,,2,1,2,3
6054_0,,,,2,1,2,3
6055_0,,,,2,1,2,3
6056_0,,,,2,1,2,3
6057_0,,,,2,1,2,3
6058_0,,,,2,1,2,3
6059_0,,,,2,1,2,3
6060_0,,,,2,1,2,3
6061_0,,,,2,1,2,3
6062_0,,,,2,1,2,3
6063_0,,,,2,1,2,3
6064_0,,,,2,1,2,3
6065_0,,,,2,1,2,3
6066_0,,,,2,1,2,3
6067_0,,,,2,1,2,3
6068_0,,,,2,1,2,3
6069_0,,,,2,1,2,3
6070_0,,,,2,1,2,3
6071_0,,,,2,1,2,3
6072_0,,,,2,1,2,3
6073_0,,,,2,1,2,3
6074_0,,,,2,1,2,3
6075_0,,,,2,1,2,3
6076_0,,,,2,1,2,3
6077_0,,,,2,1,2,3
6078_0,,,,2,1,2,3
6079_0,,,,2,1,2,3
6080_0,,,,2,1,2,3
6081_0,,,,2,1,2,3
6082_0,,,,2,1,2,3
6083_0,,,,2,1,2,3
6084_0,,,,2,1,2,3
6085_0,,,,2,1,2,3
6086_0,,,,2,1,2,3
6087_0,,,,2,1,2,3
6088_0,,,,2,1,2,3
6089_0,,,,2,1,2,3
6090_0,,,,2,1,2,3
6091_0,,,,2,1,2,3
6092_0,,,,2,1,2,3
6093_0,,,,2,1,2,3
6094_0,,,,2,1,2,3
6095_0,,,,2,1,2,3
6096_0,,,,2,1,2,3
6097_0,,,,2,1,2,3
6098_0,,,,2,1,2,3
6100_0,,,,2,1,2,3
C1(CCC(C1(CO)O)=O)=O,,,3,1,1,0,1
6101_0,,,,2,1,2,3
6103_0,,,,2,1,2,3
C1(C(CO)(CC(C1)=O)O)=O,,,3,1,1,0,1
6104_0,,,,2,1,2,3
6105_0,,,,2,1,2,3
6106_0,,,,2,1,2,3
6107_0,,,,2,1,2,3
6108_0,,,,2,1,2,3
6109_0,,,,2,1,2,3
6110_0,,,,2,1,2,3
6111_0,,,,2,1,2,3
6112_0,,,,2,1,2,3
6113_0,,,,2,1,2,3
6114_0,,,,2,1,2,3
6115_0,,,,2,1,2,3
6116_0,,,,2,1,2,3
6117_0,,,,2,1,2,3
6119_0,,,,2,1,2,3
C(C(C(C(O)=O)=O)C(CO)O)=O,,,3,1,1,0,1
6120_0,,,,2,1,2,3
6121_0,,,,2,1,2,3
6122_0,,,,2,1,2,3
6124_0,,,,2,1,2,3
C(C(C=O)C(CO)O)=O,,,3,1,1,0,1
6125_0,,,,2,1,2,3
6126_0,,,,2,1,2,3
6127_0,,,,2,1,2,3
6129_0,,,,2,1,2,3
C(C(C(CC=O)=O)C(CO)O)=O,,,3,1,1,0,1
6130_0,,,,2,1,2,3
6131_0,,,,2,1,2,3
6133_0,,,,2,1,2,3
C(C(C=O)C(CC(CO)O)=O)=O,,,3,1,1,0,1
6134_0,,,,2,1,2,3
6135_0,,,,2,1,2,3
6137_0,,,,2,1,2,3
C(C(C=O)C(C(CCO)=O)O)=O,,,3,1,1,0,1
6138_0,,,,2,1,2,3
6140_0,,,,2,1,2,3
C(CCO)(C(C=O)C(C=O)O)=O,,,3,1,1,0,1
6141_0,,,,2,1,2,3
6143_0,,,,2,1,2,3
C(C(C=O)C(CC(CO)=O)O)=O,,,3,1,1,0,1
6144_0,,,,2,1,2,3
6145_0,,,,2,1,2,3
6146_0,,,,2,1,2,3
6148_0,,,,2,1,2,3
C(C(C=O)C(C(C(C)=O)O)O)=O,,,3,1,1,0,1
6149_0,,,,2,1,2,3
6150_0,,,,2,1,2,3
6151_0,,,,2,1,2,3
6153_0,,,,2,1,2,3
C(C(C(C(C=O)C(C)=O)O)O)=O,,,3,1,1,0,1
6154_0,,,,2,1,2,3
6155_0,,,,2,1,2,3
6156_0,,,,2,1,2,3
6158_0,,,,2,1,2,3
C(C(C=O)C(C(CC=O)O)O)=O,,,3,1,1,0,1
6159_0,,,,2,1,2,3
6160_0,,,,2,1,2,3
6162_0,,,,2,1,2,3
C(C(C=O)CC(C(CO)O)=O)=O,,,3,1,1,0,1
6164_0,,,,2,1,2,3
C(C(C(C)=O)N)(O)=O,,,3,1,1,0,1
6166_0,,,,2,1,2,3
C(CC(C(O)=O)N)=O,,,3,1,1,0,1
6167_0,,,,2,1,2,3
6169_0,,,,2,1,2,3
C(CC(C(O)=O)N)(C(CO)O)=O,,,3,1,2,0,2
6170_0,,,,2,1,2,3
6171_0,,,,2,1,2,3
6172_0,,,,2,1,2,3
6173_0,,,,2,1,2,3
6174_0,,,,2,1,2,3
6175_0,,,,2,1,2,3
6176_0,,,,2,1,2,3
6177_0,,,,2,1,2,3
6178_0,,,,2,1,2,3
6179_0,,,,2,1,2,3
6180_0,,,,2,1,2,3
6181_0,,,,2,1,2,3
6182_0,,,,2,1,2,3
6183_0,,,,2,1,2,3
6184_0,,,,2,1,2,3
6185_0,,,,2,1,2,3
6186_0,,,,2,1,2,3
6187_0,,,,2,1,2,3
6188_0,,,,2,1,2,3
6189_0,,,,2,1,2,3
6190_0,,,,2,1,2,3
6191_0,,,,2,1,2,3
6192_0,,,,2,1,2,3
6193_0,,,,2,1,2,3
6194_0,,,,2,1,2,3
6195_0,,,,2,1,2,3
6196_0,,,,2,1,2,3
6197_0,,,,2,1,2,3
6198_0,,,,2,1,2,3
6199_0,,,,2,1,2,3
6200_0,,,,2,1,2,3
6201_0,,,,2,1,2,3
6202_0,,,,2,1,2,3
6203_0,,,,2,1,2,3
6204_0,,,,2,1,2,3
6205_0,,,,2,1,2,3
6206_0,,,,2,1,2,3
6207_0,,,,2,1,2,3
6209_0,,,,2,1,2,3
C1(CC(C(C(C)=O)O1)O)=O,,,3,1,2,0,2
6211_0,,,,2,1,2,3
C1(CC(C(CC=O)O1)O)=O,,,3,1,2,0,2
6213_0,,,,2,1,2,3
C1(COC(C(C)=O)C1O)=O,,,3,1,2,0,2
6215_0,,,,2,1,2,3
C(CC1C(C(CO1)=O)O)=O,,,3,1,2,0,2
6217_0,,,,2,1,2,3
C(C)(C1CC(C(O)O1)=O)=O,,,3,1,3,0,3
6219_0,,,,2,1,2,3
C(CC1CC(C(O)O1)=O)=O,,,3,1,3,0,3
6221_0,,,,2,1,2,3
C1(CC(OC1C(C)=O)O)=O,,,3,1,3,0,3
6223_0,,,,2,1,2,3
C(CC1C(CC(O1)O)=O)=O,,,3,1,3,0,3
6224_0,,,,2,1,2,3
6225_0,,,,2,1,2,3
6226_0,,,,2,1,2,3
6227_0,,,,2,1,2,3
6228_0,,,,2,1,2,3
6229_0,,,,2,1,2,3
6230_0,,,,2,1,2,3
6231_0,,,,2,1,2,3
6233_0,,,,2,1,2,3
C1(CC(CC(CO)O1)=O)=O,,,3,1,2,0,2
6235_0,,,,2,1,2,3
C1(CCC(OC1CO)=O)=O,,,3,1,2,0,2
6237_0,,,,2,1,2,3
C1(C(COC(CO)C1)=O)=O,,,3,1,2,0,2
6239_0,,,,2,1,2,3
C1(C(CO)OCC(C1)=O)=O,,,3,1,2,0,2
6240_0,,,,2,1,2,3
6241_0,,,,2,1,2,3
6242_0,,,,2,1,2,3
6243_0,,,,2,1,2,3
6245_0,,,,2,1,2,3
C1(CC(CC(CO1)O)=O)=O,,,3,1,2,0,2
6247_0,,,,2,1,2,3
C1(CCC(OCC1O)=O)=O,,,3,1,2,0,2
6249_0,,,,2,1,2,3
C1(CC(C(CCO1)=O)O)=O,,,3,1,2,0,2
6251_0,,,,2,1,2,3
C1(CC(CC(CO1)=O)O)=O,,,3,1,2,0,2
6253_0,,,,2,1,2,3
C1(C(COCC(C1)O)=O)=O,,,3,1,2,0,2
6255_0,,,,2,1,2,3
C1(C(COCC(C1)=O)O)=O,,,3,1,2,0,2
6257_0,,,,2,1,2,3
C1(CCOCC(C1O)=O)=O,,,3,1,2,0,2
6259_0,,,,2,1,2,3
C1(COCC(CC1O)=O)=O,,,3,1,2,0,2
6261_0,,,,2,1,2,3
C1(CCOC(C(C1)=O)O)=O,,,3,1,3,0,3
6263_0,,,,2,1,2,3
C1(COC(C(CC1)=O)O)=O,,,3,1,3,0,3
6265_0,,,,2,1,2,3
C1(C(CC(O)OCC1)=O)=O,,,3,1,3,0,3
6267_0,,,,2,1,2,3
C1(CC(OCC(C1)=O)O)=O,,,3,1,3,0,3
6268_0,,,,2,1,2,3
6269_0,,,,2,1,2,3
6270_0,,,,2,1,2,3
6271_0,,,,2,1,2,3
6272_0,,,,2,1,2,3
6273_0,,,,2,1,2,3
6274_0,,,,2,1,2,3
6275_0,,,,2,1,2,3
6276_0,,,,2,1,2,3
6277_0,,,,2,1,2,3
6278_0,,,,2,1,2,3
6279_0,,,,2,1,2,3
6281_0,,,,2,1,2,3
C(C(CCN)=O)(CCO)=O,,,3,1,14,0,14
6283_0,,,,2,1,2,3
C(CCN)(CC(CO)=O)=O,,,3,1,14,0,14
6285_0,,,,2,1,2,3
C(CCN)(C(C(C)=O)O)=O,,,3,1,14,0,14
6287_0,,,,2,1,2,3
C(CC(C(CCN)=O)O)=O,,,3,1,14,0,14
6289_0,,,,2,1,2,3
C(C(CN)O)(CC(C)=O)=O,,,3,1,14,0,14
6291_0,,,,2,1,2,3
C(CCC=O)(C(CN)O)=O,,,3,1,14,0,14
6293_0,,,,2,1,2,3
C(C(C)=O)(CC(CN)O)=O,,,3,1,14,0,14
6295_0,,,,2,1,2,3
C(CC(CC(CN)O)=O)=O,,,3,1,14,0,14
6296_0,,,,2,1,2,3
6297_0,,,,2,1,2,3
6298_0,,,,2,1,2,3
6299_0,,,,2,1,2,3
6300_0,,,,2,1,2,3
6301_0,,,,2,1,2,3
6302_0,,,,2,1,2,3
6303_0,,,,2,1,2,3
6304_0,,,,2,1,2,3
6305_0,,,,2,1,2,3
6306_0,,,,2,1,2,3
6307_0,,,,2,1,2,3
6309_0,,,,2,1,2,3
C(C)(CC(C(C=O)=O)=O)=O,,,3,1,2,0,2
6311_0,,,,2,1,2,3
C(CCC(C(C=O)=O)=O)=O,,,3,1,2,0,2
6313_0,,,,2,1,2,3
C(C(CC(C(C)=O)=O)=O)=O,,,3,1,3,0,3
6315_0,,,,2,1,2,3
C(CC(CC(C=O)=O)=O)=O,,,3,1,3,0,3
6316_0,,,,2,1,2,3
6317_0,,,,2,1,2,3
6318_0,,,,2,1,2,3
6319_0,,,,2,1,2,3
6321_0,,,,2,1,2,3
C(C(C=CC(C)=O)=O)=O,,,3,1,2,0,2
6323_0,,,,2,1,2,3
C(CC=CC(C=O)=O)=O,,,3,1,2,0,2
6325_0,,,,2,1,2,3
C(C=CC(C(C)=O)=O)=O,,,3,1,2,0,2
6327_0,,,,2,1,2,3
C(CC(C=CC=O)=O)=O,,,3,1,4,0,4
6329_0,,,,2,1,2,3
C=CC(CC(C=O)=O)=O,,,3,1,2,0,2
6331_0,,,,2,1,2,3
C(CC(C(C=C)=O)=O)=O,,,3,1,2,0,2
6333_0,,,,2,1,2,3
C(CC(C=O)=O)=CC=O,,,3,1,2,0,2
6334_0,,,,2,1,2,3
6336_0,,,,2,1,2,3
C(N)=CC(CC(CO)O)=O,,,3,1,3,0,3
6338_0,,,,2,1,2,3
C(C(CO)O)(CC=CN)=O,,,3,1,3,0,3
6340_0,,,,2,1,2,3
C(CCO)(C(C=CN)O)=O,,,3,1,3,0,3
6342_0,,,,2,1,2,3
C(CO)(CC(C=CN)O)=O,,,3,1,3,0,3
6344_0,,,,2,1,2,3
C(C)(C(C(C=CN)O)O)=O,,,3,1,3,0,3
6346_0,,,,2,1,2,3
C(CC(C(C=CN)O)O)=O,,,3,1,3,0,3
6348_0,,,,2,1,2,3
C(C=CC(CCO)=O)(O)=O,,,3,1,2,0,2
6350_0,,,,2,1,2,3
C(CO)(CC=CC(O)=O)=O,,,3,1,2,0,2
6352_0,,,,2,1,2,3
C(C)(C(C=CC(O)=O)O)=O,,,3,1,2,0,2
6354_0,,,,2,1,2,3
C(CC(C=CC(O)=O)O)=O,,,3,1,2,0,2
6356_0,,,,2,1,2,3
C(C(C=CC(C)=O)O)(O)=O,,,3,1,2,0,2
6358_0,,,,2,1,2,3
C(C(C=CCC=O)O)(O)=O,,,3,1,2,0,2
6359_0,,,,2,1,2,3
6360_0,,,,2,1,2,3
6361_0,,,,2,1,2,3
6363_0,,,,2,1,2,3
C(CC(CC(C=O)=O)NC)=O,,,3,1,3,0,3
6365_0,,,,2,1,2,3
C(C(CC(C(C)=O)=O)NC)=O,,,3,1,2,0,2
6366_0,,,,2,1,2,3
6368_0,,,,2,1,2,3
C(CCNC)(CC(C=O)=O)=O,,,3,1,2,0,2
6370_0,,,,2,1,2,3
C(CC(C(CCNC)=O)=O)=O,,,3,1,2,0,2
6371_0,,,,2,1,2,3
6372_0,,,,2,1,2,3
6373_0,,,,2,1,2,3
6375_0,,,,2,1,2,3
C(CC(C(C(C=O)=O)O)NC)=O,,,3,1,3,0,3
6376_0,,,,2,1,2,3
6377_0,,,,2,1,2,3
6378_0,,,,2,1,2,3
6379_0,,,,2,1,2,3
6380_0,,,,2,1,2,3
6382_0,,,,2,1,2,3
C1(COCC1O)=O,,,3,1,1,0,1
6384_0,,,,2,1,2,3
C1(C(O)OCC1)=O,,,3,1,2,0,2
6385_0,,,,2,1,2,3
6387_0,,,,2,1,2,3
C(C1C(C(C(CO)O1)O)O)=O,,,3,1,1,0,1
6389_0,,,,2,1,2,3
C1(C(CO)OC(CO)C1O)=O,,,3,1,1,0,1
6391_0,,,,2,1,2,3
C1(C(CO)(O)OC(CO)C1)=O,,,3,1,2,0,2
6393_0,,,,2,1,2,3
C1(C(CO)OC(CO)(C1)O)=O,,,3,1,2,0,2
6395_0,,,,2,1,2,3
C(CC1C(C(CO1)O)=O)=O,,,3,1,1,0,1
6397_0,,,,2,1,2,3
C(CC1(C(CCO1)=O)O)=O,,,3,1,2,0,2
6399_0,,,,2,1,2,3
C(CC1(CC(CO1)=O)O)=O,,,3,1,2,0,2
6401_0,,,,2,1,2,3
C(C(C1CC(CO1)O)=O)=O,,,3,1,1,0,1
6403_0,,,,2,1,2,3
C(C1C(CC(C=O)O1)O)=O,,,3,1,1,0,1
6405_0,,,,2,1,2,3
C(C1C(CC(C)(O1)O)=O)=O,,,3,1,2,0,2
6407_0,,,,2,1,2,3
C1(CC(C=O)OC1(C)O)=O,,,3,1,2,0,2
6409_0,,,,2,1,2,3
C(C1C(C(C(C)O1)=O)O)=O,,,3,1,1,0,1
6411_0,,,,2,1,2,3
C1(C(O)OC(C(C)=O)C1O)=O,,,3,1,2,0,2
6413_0,,,,2,1,2,3
C(CC1C(C(C(O)O1)=O)O)=O,,,3,1,2,0,2
6415_0,,,,2,1,2,3
C(C1C(C(C(CO)O1)O)=O)=O,,,3,1,1,0,1
6417_0,,,,2,1,2,3
C(C1(C(CC(CO)O1)=O)O)=O,,,3,1,2,0,2
6419_0,,,,2,1,2,3
C1(CC(C=O)(OC1CO)O)=O,,,3,1,2,0,2
6421_0,,,,2,1,2,3
C(C1C(C(C(CO1)O)O)O)=O,,,3,1,1,0,1
6423_0,,,,2,1,2,3
C1(C(CO)OCC(C1O)O)=O,,,3,1,1,0,1
6425_0,,,,2,1,2,3
C1(C(CO)(O)OCC(C1)O)=O,,,3,1,2,0,2
6427_0,,,,2,1,2,3
C1(C(COC(CO)(C1)O)O)=O,,,3,1,2,0,2
6429_0,,,,2,1,2,3
C1(C(C(CO)(O)OCC1)O)=O,,,3,1,2,0,2
6431_0,,,,2,1,2,3
C1(COC(CO)(C(C1)O)O)=O,,,3,1,2,0,2
6433_0,,,,2,1,2,3
C1(CC(C=O)(O)OCC1)=O,,,3,1,2,0,2
6435_0,,,,2,1,2,3
C(C1(CCC(CO1)=O)O)=O,,,3,1,2,0,2
6437_0,,,,2,1,2,3
C(C1C(CCC(O1)O)=O)=O,,,3,1,2,0,2
6439_0,,,,2,1,2,3
C1(CC(C=O)OC(C1)O)=O,,,3,1,2,0,2
6441_0,,,,2,1,2,3
C1(C(C(O)OC(CO)C1)=O)=O,,,3,1,2,0,2
6443_0,,,,2,1,2,3
C1(C(CO)OC(C(C1)=O)O)=O,,,3,1,2,0,2
6445_0,,,,2,1,2,3
C(C1C(C(C(CO1)O)O)=O)=O,,,3,1,1,0,1
6447_0,,,,2,1,2,3
C(C1(C(CC(CO1)O)=O)O)=O,,,3,1,2,0,2
6449_0,,,,2,1,2,3
C1(CC(C=O)(O)OCC1O)=O,,,3,1,2,0,2
6451_0,,,,2,1,2,3
C1(C(C(C=O)(O)OCC1)O)=O,,,3,1,2,0,2
6453_0,,,,2,1,2,3
C(C1(C(CC(CO1)=O)O)O)=O,,,3,1,2,0,2
6455_0,,,,2,1,2,3
C1(C(C(O)OCC(C1)O)=O)=O,,,3,1,2,0,2
6457_0,,,,2,1,2,3
C1(C(COC(C(C1)=O)O)O)=O,,,3,1,2,0,2
6459_0,,,,2,1,2,3
C1(CCOC(C(C1O)=O)O)=O,,,3,1,2,0,2
6461_0,,,,2,1,2,3
C1(C(O)OCC(CC1O)=O)=O,,,3,1,2,0,2
6462_0,,,,2,1,2,3
6463_0,,,,2,1,2,3
6464_0,,,,2,1,2,3
6466_0,,,,2,1,2,3
C(CC(CN)O)=O,,,3,1,13,0,13
6467_0,,,,2,1,2,3
6469_0,,,,2,1,2,3
C(C(CO)O)(CC(CO)N)=O,,,3,1,14,0,14
6471_0,,,,2,1,2,3
C(C(C(CO)N)O)(CCO)=O,,,3,1,14,0,14
6473_0,,,,2,1,2,3
C(CO)(CC(C(CO)N)O)=O,,,3,1,13,0,13
6475_0,,,,2,1,2,3
C(C)(C(C(C(CO)N)O)O)=O,,,3,1,13,0,13
6477_0,,,,2,1,2,3
C(CC(C(C(CO)N)O)O)=O,,,3,1,13,0,13
6478_0,,,,2,1,2,3
6480_0,,,,2,1,2,3
C(CC(CC(CO)=O)N)=O,,,3,1,13,0,13
6482_0,,,,2,1,2,3
C(CC(C(C(C)=O)O)N)=O,,,3,1,13,0,13
6484_0,,,,2,1,2,3
C(CC(C(CC=O)N)O)=O,,,3,1,13,0,13
6486_0,,,,2,1,2,3
C(C(C(CC(C)=O)N)O)=O,,,3,1,13,0,13
6488_0,,,,2,1,2,3
C(CCC(C(C=O)O)N)=O,,,3,1,13,0,13
6489_0,,,,2,1,2,3
6491_0,,,,2,1,2,3
C(CC(CC(C=O)O)N)=O,,,3,1,13,0,13
6493_0,,,,2,1,2,3
C(C(CC(CCO)N)=O)=O,,,3,1,13,0,13
6494_0,,,,2,1,2,3
6496_0,,,,2,1,2,3
C(C(CCC(CO)N)=O)=O,,,3,1,13,0,13
6498_0,,,,2,1,2,3
C(CC(CC(CO)N)=O)=O,,,3,1,13,0,13
6500_0,,,,2,1,2,3
C(C(CC(C(C)N)O)=O)=O,,,3,1,13,0,13
6502_0,,,,2,1,2,3
C(CC(C(C(C)N)O)=O)=O,,,3,1,13,0,13
6504_0,,,,2,1,2,3
C(C(C(CC(C)N)=O)O)=O,,,3,1,13,0,13
6505_0,,,,2,1,2,3
6507_0,,,,2,1,2,3
C(C(CC(CCN)O)=O)=O,,,3,1,13,0,13
6509_0,,,,2,1,2,3
C(CC(C(CCN)O)=O)=O,,,3,1,13,0,13
6511_0,,,,2,1,2,3
C(C(C(CCCN)=O)O)=O,,,3,1,13,0,13
6513_0,,,,2,1,2,3
C(CC(C=O)O)(CCN)=O,,,3,1,13,0,13
6515_0,,,,2,1,2,3
C1(C(CC(C(CO)O)O1)=O)=O,,,3,1,2,0,2
6517_0,,,,2,1,2,3
C1(CC(C(C(CO)O)O1)=O)=O,,,3,1,2,0,2
6519_0,,,,2,1,2,3
C1(C(C(C(C(C)=O)O1)O)O)=O,,,3,1,2,0,2
6521_0,,,,2,1,2,3
C(CC1C(C(C(O1)=O)O)O)=O,,,3,1,2,0,2
6523_0,,,,2,1,2,3
C1(C(CC(C(C)=O)O1)O)=O,,,3,1,2,0,2
6525_0,,,,2,1,2,3
C(CC1CC(C(O1)=O)O)=O,,,3,1,2,0,2
6527_0,,,,2,1,2,3
C1(C(CC(C(CO)O1)O)=O)=O,,,3,1,2,0,2
6529_0,,,,2,1,2,3
C1(CC(C(C(CO)O1)O)=O)=O,,,3,1,2,0,2
6531_0,,,,2,1,2,3
C1(C(C(CC(CO)O1)=O)O)=O,,,3,1,2,0,2
6533_0,,,,2,1,2,3
C1(CC(C(OC1CO)=O)O)=O,,,3,1,2,0,2
6535_0,,,,2,1,2,3
C1(C(CC(C(CO1)O)O)=O)=O,,,3,1,2,0,2
6537_0,,,,2,1,2,3
C1(CC(C(C(CO1)O)O)=O)=O,,,3,1,2,0,2
6539_0,,,,2,1,2,3
C1(C(C(CC(CO1)O)=O)O)=O,,,3,1,2,0,2
6541_0,,,,2,1,2,3
C1(CC(C(OCC1O)=O)O)=O,,,3,1,2,0,2
6543_0,,,,2,1,2,3
C1(C(C(C(OCC1)=O)O)O)=O,,,3,1,2,0,2
6545_0,,,,2,1,2,3
C1(C(C(CC(CO1)=O)O)O)=O,,,3,1,2,0,2
6547_0,,,,2,1,2,3
C1(CC(C(OCC1)=O)O)=O,,,3,1,2,0,2
6549_0,,,,2,1,2,3
C1(C(CCC(CO1)=O)O)=O,,,3,1,2,0,2
6550_0,,,,2,1,2,3
6551_0,,,,2,1,2,3
6552_0,,,,2,1,2,3
6554_0,,,,2,1,2,3
C(C(CCC(CO)=O)O)=O,,,3,1,3,0,3
6556_0,,,,2,1,2,3
C(C(CC(C(C)=O)O)O)=O,,,3,1,2,0,2
6557_0,,,,2,1,2,3
6559_0,,,,2,1,2,3
C1C(C(C(C=1CO)=O)O)O,,,3,1,1,0,1
6561_0,,,,2,1,2,3
C=C1C(C(C(C1O)O)O)=O,,,3,1,1,0,1
6562_0,,,,2,1,2,3
6564_0,,,,2,1,2,3
C1C(C(C(C=1C=O)O)O)O,,,3,1,1,0,1
6566_0,,,,2,1,2,3
C(C(CO)O)=C(C(C=O)=O)CO,,,3,1,1,0,1
6568_0,,,,2,1,2,3
C=C(C(C=O)=O)C(C(CO)O)O,,,3,1,1,0,1
6570_0,,,,2,1,2,3
C=C(C=O)C(C(C(CO)O)O)=O,,,3,1,1,0,1
6572_0,,,,2,1,2,3
C(C(C(C(CO)=CCO)=O)O)=O,,,3,1,1,0,1
6574_0,,,,2,1,2,3
C(C(C(C(C(CO)O)=C)=O)O)=O,,,3,1,1,0,1
6576_0,,,,2,1,2,3
C(C(CO)=CC=O)(C(CO)O)=O,,,3,1,1,0,1
6578_0,,,,2,1,2,3
C(C(C(C(C(CO)O)=O)=C)O)=O,,,3,1,1,0,1
6580_0,,,,2,1,2,3
C(C(C(C(C(CO)=C)=O)O)O)=O,,,3,1,1,0,1
6582_0,,,,2,1,2,3
C(C(C=C(C(CO)=O)CO)O)=O,,,3,1,1,0,1
6584_0,,,,2,1,2,3
C(C(C(C(C(CO)=O)=C)O)O)=O,,,3,1,1,0,1
6585_0,,,,2,1,2,3
6587_0,,,,2,1,2,3
C(C(C(C(C(C=C)=O)O)O)O)=O,,,3,1,1,0,1
6589_0,,,,2,1,2,3
C(C(C(C=C(C=O)CO)O)O)=O,,,3,1,1,0,1
6591_0,,,,2,1,2,3
C(C(C(C(C(C=O)=C)O)O)O)=O,,,3,1,1,0,1
6592_0,,,,2,1,2,3
6593_0,,,,2,1,2,3
6594_0,,,,2,1,2,3
6595_0,,,,2,1,2,3
6596_0,,,,2,1,2,3
6597_0,,,,2,1,2,3
6598_0,,,,2,1,2,3
6599_0,,,,2,1,2,3
6600_0,,,,2,1,2,3
6601_0,,,,2,1,2,3
6602_0,,,,2,1,2,3
6603_0,,,,2,1,2,3
6604_0,,,,2,1,2,3
6605_0,,,,2,1,2,3
6606_0,,,,2,1,2,3
6607_0,,,,2,1,2,3
6608_0,,,,2,1,2,3
6609_0,,,,2,1,2,3
6611_0,,,,2,1,2,3
C(C(C(CO)O)O)=C(C=O)NC,,,3,1,2,0,2
6611_1,,,,2,1,2,3
6613_0,,,,2,1,2,3
C=C(C(C(C(CO)O)O)=O)NC,,,3,1,2,0,2
6613_1,,,,2,1,2,3
6614_0,,,,2,1,2,3
6615_0,,,,2,1,2,3
6616_0,,,,2,1,2,3
6617_0,,,,2,1,2,3
6618_0,,,,2,1,2,3
6619_0,,,,2,1,2,3
6620_0,,,,2,1,2,3
6621_0,,,,2,1,2,3
6622_0,,,,2,1,2,3
6623_0,,,,2,1,2,3
6624_0,,,,2,1,2,3
6625_0,,,,2,1,2,3
6626_0,,,,2,1,2,3
6628_0,,,,2,1,2,3
C(C(C(C(C=C)O)O)O)=O,,,3,1,3,0,3
6629_0,,,,2,1,2,3
6630_0,,,,2,1,2,3
6631_0,,,,2,1,2,3
6632_0,,,,2,1,2,3
6633_0,,,,2,1,2,3
6634_0,,,,2,1,2,3
6635_0,,,,2,1,2,3
6636_0,,,,2,1,2,3
6637_0,,,,2,1,2,3
6639_0,,,,2,1,2,3
C(C1(C=CC(C1O)O)O)=O,,,3,1,1,0,1
6640_0,,,,2,1,2,3
6641_0,,,,2,1,2,3
6642_0,,,,2,1,2,3
6643_0,,,,2,1,2,3
6644_0,,,,2,1,2,3
6645_0,,,,2,1,2,3
6647_0,,,,2,1,2,3
C(C=C(C=O)CO)(C(CO)O)=O,,,3,1,1,0,1
6649_0,,,,2,1,2,3
C(CO)=C(C(O)=O)N,,,3,1,2,0,2
6649_1,,,,2,1,2,3
6651_0,,,,2,1,2,3
C(C(C(CO)O)O)=C(C(O)=O)N,,,3,1,2,0,2
6651_1,,,,2,1,2,3
6653_0,,,,2,1,2,3
C(C(N)=CC(O)=O)(O)=O,,,3,1,2,0,2
6653_1,,,,2,1,2,3
6655_0,,,,2,1,2,3
C=C(C(O)=O)N,,,3,1,2,0,2
6655_1,,,,2,1,2,3
6657_0,,,,2,1,2,3
C(C(CO)O)=C(C(CO)=O)NC,,,3,1,2,0,2
6657_1,,,,2,1,2,3
6659_0,,,,2,1,2,3
C(CC(C(NC)=CCO)=O)=O,,,3,1,2,0,2
6659_1,,,,2,1,2,3
6660_0,,,,2,1,2,3
6661_0,,,,2,1,2,3
6663_0,,,,2,1,2,3
C(C(CC(C(NC)=C)=O)O)=O,,,3,1,2,0,2
6663_1,,,,2,1,2,3
6665_0,,,,2,1,2,3
C(C(NC)=CC=O)(CCO)=O,,,3,1,2,0,2
6665_1,,,,2,1,2,3
6666_0,,,,2,1,2,3
6668_0,,,,2,1,2,3
C(C(C=C(C(C)=O)NC)O)=O,,,3,1,2,0,2
6668_1,,,,2,1,2,3
6670_0,,,,2,1,2,3
C(C(CO)O)=C(C(C=O)=O)NC,,,3,1,2,0,2
6670_1,,,,2,1,2,3
6671_0,,,,2,1,2,3
6673_0,,,,2,1,2,3
C(C(C(CO)O)O)=C(C=O)N,,,3,1,2,0,2
6673_1,,,,2,1,2,3
6674_0,,,,2,1,2,3
6675_0,,,,2,1,2,3
6676_0,,,,2,1,2,3
6677_0,,,,2,1,2,3
6678_0,,,,2,1,2,3
6679_0,,,,2,1,2,3
6680_0,,,,2,1,2,3
6681_0,,,,2,1,2,3
6682_0,,,,2,1,2,3
6684_0,,,,2,1,2,3
C1C(C(CO)O)OC(C=1)=O,,,3,1,2,0,2
6686_0,,,,2,1,2,3
C1OC(C(C=1)=O)C(CO)O,,,3,1,1,0,1
6688_0,,,,2,1,2,3
C1C(C(CO)OC(C=1)=O)O,,,3,1,2,0,2
6690_0,,,,2,1,2,3
C1C(CO)OC(C(C=1)=O)O,,,3,1,1,0,1
6692_0,,,,2,1,2,3
C1OC(CO)C(C(C=1)=O)O,,,3,1,1,0,1
6694_0,,,,2,1,2,3
C1C(OC(C(C=1)=O)CO)O,,,3,1,1,0,1
6696_0,,,,2,1,2,3
C1C(C(COC(C=1)=O)O)O,,,3,1,2,0,2
6698_0,,,,2,1,2,3
C1C(COC(C(C=1)=O)O)O,,,3,1,1,0,1
6700_0,,,,2,1,2,3
C1OCC(C(C(C=1)=O)O)O,,,3,1,1,0,1
6702_0,,,,2,1,2,3
C1COC(C(C(C=1)=O)O)O,,,3,1,1,0,1
6704_0,,,,2,1,2,3
C1C(O)OCC(C(C=1)=O)O,,,3,1,1,0,1
6706_0,,,,2,1,2,3
C1C(C(OCC(C=1)=O)O)O,,,3,1,1,0,1
6707_0,,,,2,1,2,3
6707_1,,,,2,1,2,3
6709_0,,,,2,1,2,3
C(CO)=CC(C(CN)O)=O,,,3,1,13,0,13
6710_0,,,,2,1,2,3
6710_1,,,,2,1,2,3
6712_0,,,,2,1,2,3
C(CN)=CC(C(CO)O)=O,,,3,1,13,0,13
6713_0,,,,2,1,2,3
6713_1,,,,2,1,2,3
6715_0,,,,2,1,2,3
C=CC(C(C(CN)O)O)=O,,,3,1,13,0,13
6716_0,,,,2,1,2,3
6716_1,,,,2,1,2,3
6718_0,,,,2,1,2,3
C(C(CN)O)=CC(CO)=O,,,3,1,13,0,13
6719_0,,,,2,1,2,3
6719_1,,,,2,1,2,3
6720_0,,,,2,1,2,3
6720_1,,,,2,1,2,3
6722_0,,,,2,1,2,3
C(C(C(CN)O)O)=CC=O,,,3,1,13,0,13
6723_0,,,,2,1,2,3
6725_0,,,,2,1,2,3
C(C(CC(C=C)=O)O)(O)=O,,,3,1,2,0,2
6726_0,,,,2,1,2,3
6727_0,,,,2,1,2,3
6728_0,,,,2,1,2,3
6729_0,,,,2,1,2,3
6730_0,,,,2,1,2,3
6732_0,,,,2,1,2,3
C(C(CC=CC=O)O)(O)=O,,,3,1,2,0,2
6734_0,,,,2,1,2,3
C(CO)=CC(C(C=O)=O)=O,,,3,1,1,0,1
6736_0,,,,2,1,2,3
C=CC(C(C(C=O)=O)O)=O,,,3,1,2,0,2
6738_0,,,,2,1,2,3
C(C(C=CC(CO)=O)=O)=O,,,3,1,2,0,2
6740_0,,,,2,1,2,3
C(C(C(C=O)=O)O)=CC=O,,,3,1,2,0,2
6742_0,,,,2,1,2,3
C(CO)(NC)=CC=O,,,3,1,2,0,2
6742_1,,,,2,1,2,3
6744_0,,,,2,1,2,3
C(C(C(NC)=C)O)=O,,,3,1,2,0,2
6744_1,,,,2,1,2,3
6746_0,,,,2,1,2,3
C(C(CO)O)(NC)=CC(CO)=O,,,3,1,2,0,2
6746_1,,,,2,1,2,3
6748_0,,,,2,1,2,3
C(CO)(C(C(NC)=CCO)O)=O,,,3,1,2,0,2
6748_1,,,,2,1,2,3
6750_0,,,,2,1,2,3
C(CO)=C(CC(C=O)=O)NC,,,3,1,2,0,2
6750_1,,,,2,1,2,3
6752_0,,,,2,1,2,3
C(CC(C=C(CO)NC)=O)=O,,,3,1,2,0,2
6752_1,,,,2,1,2,3
6754_0,,,,2,1,2,3
C(CC(C(C(NC)=C)O)=O)=O,,,3,1,2,0,2
6754_1,,,,2,1,2,3
6756_0,,,,2,1,2,3
C(C(C=O)O)(CC(NC)=C)=O,,,3,1,2,0,2
6756_1,,,,2,1,2,3
6758_0,,,,2,1,2,3
C(C=CC(C(CNC)O)=O)=O,,,3,1,2,0,2
6760_0,,,,2,1,2,3
C(C(CC(C=CNC)=O)O)=O,,,3,1,2,0,2
6760_1,,,,2,1,2,3
6762_0,,,,2,1,2,3
C(C(NC)=CC(CCO)=O)=O,,,3,1,2,0,2
6762_1,,,,2,1,2,3
6764_0,,,,2,1,2,3
C(C(C(C(C=C)=O)O)NC)=O,,,3,1,2,0,2
6766_0,,,,2,1,2,3
C(CO)(CC(NC)=CC=O)=O,,,3,1,2,0,2
6766_1,,,,2,1,2,3
6768_0,,,,2,1,2,3
C(C)(C(C(NC)=CC=O)O)=O,,,3,1,2,0,2
6768_1,,,,2,1,2,3
6770_0,,,,2,1,2,3
C(C(C(NC)=CC(C)=O)O)=O,,,3,1,2,0,2
6770_1,,,,2,1,2,3
6772_0,,,,2,1,2,3
C(CC(C(NC)=CC=O)O)=O,,,3,1,2,0,2
6772_1,,,,2,1,2,3
6774_0,,,,2,1,2,3
C(CC=C(C(C=O)O)NC)=O,,,3,1,2,0,2
6774_1,,,,2,1,2,3
6776_0,,,,2,1,2,3
C(C(C(C=CC=O)NC)O)=O,,,3,1,2,0,2
6778_0,,,,2,1,2,3
C(CC(NC)=CC(C=O)O)=O,,,3,1,2,0,2
6778_1,,,,2,1,2,3
6780_0,,,,2,1,2,3
C(C(CO)O)(NC)=CC(C=O)=O,,,3,1,2,0,2
6780_1,,,,2,1,2,3
6782_0,,,,2,1,2,3
C(CO)=C(C(C(C=O)=O)O)NC,,,3,1,2,0,2
6782_1,,,,2,1,2,3
6784_0,,,,2,1,2,3
C(CNC(CO)=CC=O)(O)=O,,,3,1,2,0,2
6784_1,,,,2,1,2,3
6786_0,,,,2,1,2,3
C(C(C(NCC(O)=O)=C)O)=O,,,3,1,2,0,2
6786_1,,,,2,1,2,3
6788_0,,,,2,1,2,3
C(C(C(CO)O)O)(NC)=CC=O,,,3,1,2,0,2
6788_1,,,,2,1,2,3
6790_0,,,,2,1,2,3
C(C(C(NC)=CC(CO)O)O)=O,,,3,1,2,0,2
6790_1,,,,2,1,2,3
6792_0,,,,2,1,2,3
C1C(C(CO)OC=1C=O)O,,,3,1,1,0,1
6794_0,,,,2,1,2,3
C(C1(C=CC(CO)O1)O)=O,,,3,1,1,0,1
6796_0,,,,2,1,2,3
C1(C(C(CO1)O)O)=CC=O,,,3,1,1,0,1
6798_0,,,,2,1,2,3
C(C(C1OCC(C=1)O)O)=O,,,3,1,1,0,1
6800_0,,,,2,1,2,3
C(C(C1(C=CCO1)O)O)=O,,,3,1,1,0,1
6802_0,,,,2,1,2,3
C(C1C=CC(CO)(O1)O)=O,,,3,1,1,0,1
6804_0,,,,2,1,2,3
C(C1C(C=C(CO)O1)O)=O,,,3,1,1,0,1
6806_0,,,,2,1,2,3
C(C1C(C(C(O1)=C)O)O)=O,,,3,1,1,0,1
6808_0,,,,2,1,2,3
C(C(C1C=CC(O)O1)O)=O,,,3,1,1,0,1
6810_0,,,,2,1,2,3
C(C(C1C(C=CO1)O)O)=O,,,3,1,1,0,1
6812_0,,,,2,1,2,3
C1C(C(COC=1C=O)O)O,,,3,1,1,0,1
6814_0,,,,2,1,2,3
C(C1(C=CC(CO1)O)O)=O,,,3,1,1,0,1
6816_0,,,,2,1,2,3
C(C1C(C=CC(O)O1)O)=O,,,3,1,1,0,1
6818_0,,,,2,1,2,3
C(C1C(C(C=CO1)O)O)=O,,,3,1,1,0,1
6820_0,,,,2,1,2,3
C=CN,,,3,1,2,0,2
6820_1,,,,2,1,2,3
6822_0,,,,2,1,2,3
C(C(CO)O)=CN,,,3,1,2,0,2
6822_1,,,,2,1,2,3
6824_0,,,,2,1,2,3
C=C(C(C(C(CO)O)O)O)N,,,3,1,2,0,2
6824_1,,,,2,1,2,3
6826_0,,,,2,1,2,3
C(C(C(CO)O)O)=C(CO)N,,,3,1,2,0,2
6826_1,,,,2,1,2,3
6828_0,,,,2,1,2,3
C(CC(N)=CC(CO)O)=O,,,3,1,2,0,2
6828_1,,,,2,1,2,3
6830_0,,,,2,1,2,3
C(CC(CO)O)(N)=CC=O,,,3,1,2,0,2
6830_1,,,,2,1,2,3
6832_0,,,,2,1,2,3
C(C(C(C=CCO)N)O)=O,,,3,1,13,0,13
6834_0,,,,2,1,2,3
C(C(CC(N)=CCO)O)=O,,,3,1,2,0,2
6834_1,,,,2,1,2,3
6836_0,,,,2,1,2,3
C(C(C(CO)O)N)=CC=O,,,3,1,13,0,13
6838_0,,,,2,1,2,3
C(C(C=C(CCO)N)O)=O,,,3,1,2,0,2
6838_1,,,,2,1,2,3
6840_0,,,,2,1,2,3
C(C(C(C(C=C)N)O)O)=O,,,3,1,13,0,13
6842_0,,,,2,1,2,3
C(C(C(CC(N)=C)O)O)=O,,,3,1,2,0,2
6842_1,,,,2,1,2,3
6844_0,,,,2,1,2,3
C(C(C=CC(CO)N)O)=O,,,3,1,13,0,13
6846_0,,,,2,1,2,3
C(C(C(C=C(C)N)O)O)=O,,,3,1,2,0,2
6846_1,,,,2,1,2,3
6848_0,,,,2,1,2,3
C(C(C(C=CCN)O)O)=O,,,3,1,13,0,13
6849_0,,,,2,1,2,3
6850_0,,,,2,1,2,3
6852_0,,,,2,1,2,3
C1(C(C=CC(CO)O1)O)=O,,,3,1,1,0,1
6853_0,,,,2,1,2,3
6855_0,,,,2,1,2,3
C1(C(C=CC(CO1)O)O)=O,,,3,1,1,0,1
6857_0,,,,2,1,2,3
C(CO)=CC(O)=O,,,3,1,1,0,1
6859_0,,,,2,1,2,3
C(C(C=C)O)(O)=O,,,3,1,1,0,1
6860_0,,,,2,1,2,3
6862_0,,,,2,1,2,3
C(C(C=CC(CO)O)O)=O,,,3,1,4,0,4
6863_0,,,,2,2,1,3
6863_1,,,,2,2,1,3
6865_0,,,,2,2,1,3
C(C1(C(C(C(C1O)O)O)O)O)O,,,3,1,3,0,3
6867_0,,,,2,2,1,3
C1(C(C(C(C(C1O)O)O)O)O)O,,,3,1,1,0,1
6868_0,,,,2,2,1,3
6869_0,,,,2,2,1,3
6870_0,,,,2,2,1,3
6871_0,,,,2,2,1,3
6872_0,,,,2,2,1,3
6873_0,,,,2,2,1,3
6874_0,,,,2,2,1,3
6875_0,,,,2,2,1,3
6876_0,,,,2,2,1,3
6877_0,,,,2,2,1,3
6878_0,,,,2,2,1,3
6879_0,,,,2,2,1,3
6880_0,,,,2,2,1,3
6881_0,,,,2,2,1,3
6882_0,,,,2,2,1,3
6883_0,,,,2,2,1,3
6884_0,,,,2,2,1,3
6885_0,,,,2,2,1,3
6886_0,,,,2,2,1,3
6887_0,,,,2,2,1,3
6888_0,,,,2,2,1,3
6889_0,,,,2,2,1,3
6890_0,,,,2,2,1,3
6891_0,,,,2,2,1,3
6892_0,,,,2,2,1,3
6893_0,,,,2,2,1,3
6894_0,,,,2,2,1,3
6895_0,,,,2,2,1,3
6896_0,,,,2,2,1,3
6897_0,,,,2,2,1,3
6898_0,,,,2,2,1,3
6899_0,,,,2,2,1,3
6900_0,,,,2,2,1,3
6901_0,,,,2,2,1,3
6902_0,,,,2,2,1,3
6903_0,,,,2,2,1,3
6904_0,,,,2,2,1,3
6905_0,,,,2,2,1,3
6906_0,,,,2,2,1,3
6907_0,,,,2,2,1,3
6908_0,,,,2,2,1,3
6909_0,,,,2,2,1,3
6910_0,,,,2,2,1,3
6911_0,,,,2,2,1,3
6912_0,,,,2,2,1,3
6913_0,,,,2,2,1,3
6914_0,,,,2,2,1,3
6915_0,,,,2,2,1,3
6916_0,,,,2,2,1,3
6917_0,,,,2,2,1,3
6918_0,,,,2,2,1,3
6919_0,,,,2,2,1,3
6920_0,,,,2,2,1,3
6921_0,,,,2,2,1,3
6922_0,,,,2,2,1,3
6923_0,,,,2,2,1,3
6924_0,,,,2,2,1,3
6925_0,,,,2,2,1,3
6926_0,,,,2,2,1,3
6927_0,,,,2,2,1,3
6928_0,,,,2,2,1,3
6929_0,,,,2,2,1,3
6930_0,,,,2,2,1,3
6931_0,,,,2,2,1,3
6932_0,,,,2,2,1,3
6933_0,,,,2,2,1,3
6934_0,,,,2,2,1,3
6935_0,,,,2,2,1,3
6936_0,,,,2,2,1,3
6937_0,,,,2,2,1,3
6938_0,,,,2,2,1,3
6939_0,,,,2,2,1,3
6940_0,,,,2,2,1,3
6941_0,,,,2,2,1,3
6942_0,,,,2,2,1,3
6943_0,,,,2,2,1,3
6944_0,,,,2,2,1,3
6945_0,,,,2,2,1,3
6946_0,,,,2,2,1,3
6947_0,,,,2,2,1,3
6948_0,,,,2,2,1,3
6949_0,,,,2,2,1,3
6950_0,,,,2,2,1,3
6951_0,,,,2,2,1,3
6952_0,,,,2,2,1,3
6953_0,,,,2,2,1,3
6954_0,,,,2,2,1,3
6955_0,,,,2,2,1,3
6956_0,,,,2,2,1,3
6957_0,,,,2,2,1,3
6958_0,,,,2,2,1,3
6959_0,,,,2,2,1,3
6960_0,,,,2,2,1,3
6961_0,,,,2,2,1,3
6962_0,,,,2,2,1,3
6963_0,,,,2,2,1,3
6964_0,,,,2,2,1,3
6965_0,,,,2,2,1,3
6966_0,,,,2,2,1,3
6967_0,,,,2,2,1,3
6968_0,,,,2,2,1,3
6969_0,,,,2,2,1,3
6970_0,,,,2,2,1,3
6971_0,,,,2,2,1,3
6972_0,,,,2,2,1,3
6973_0,,,,2,2,1,3
6974_0,,,,2,2,1,3
6975_0,,,,2,2,1,3
6976_0,,,,2,2,1,3
6977_0,,,,2,2,1,3
6978_0,,,,2,2,1,3
6979_0,,,,2,2,1,3
6980_0,,,,2,2,1,3
6981_0,,,,2,2,1,3
6982_0,,,,2,2,1,3
6983_0,,,,2,2,1,3
6984_0,,,,2,2,1,3
6985_0,,,,2,2,1,3
6986_0,,,,2,2,1,3
6987_0,,,,2,2,1,3
6989_0,,,,2,2,1,3
C(C(C(C(C(CNC)O)O)O)O)=O,,,3,1,2,0,2
6990_0,,,,2,2,1,3
6991_0,,,,2,2,1,3
6992_0,,,,2,2,1,3
6993_0,,,,2,2,1,3
6994_0,,,,2,2,1,3
6995_0,,,,2,2,1,3
6997_0,,,,2,2,1,3
C1C(C(C(C(CO)O)(O)O1)O)O,,,3,1,2,0,2
6999_0,,,,2,2,1,3
C(C(C(C(C(CO)O)N)O)O)O,,,3,1,13,0,13
7000_0,,,,2,2,1,3
7001_0,,,,2,2,1,3
7002_0,,,,2,2,1,3
7003_0,,,,2,2,1,3
7004_0,,,,2,2,1,3
7005_0,,,,2,2,1,3
7006_0,,,,2,2,1,3
7007_0,,,,2,2,1,3
7008_0,,,,2,2,1,3
7009_0,,,,2,2,1,3
7010_0,,,,2,2,1,3
7011_0,,,,2,2,1,3
7012_0,,,,2,2,1,3
7013_0,,,,2,2,1,3
7014_0,,,,2,2,1,3
7015_0,,,,2,2,1,3
7016_0,,,,2,2,2,4
7018_0,,,,2,2,1,3
C(C(C(C(C(CN)N)O)O)O)O,,,3,1,25,0,25
7020_0,,,,2,2,1,3
CNC(CN)C(C(C(CO)O)O)O,,,3,1,13,0,13
7021_0,,,,2,1,2,3
7022_0,,,,2,1,2,3
7023_0,,,,2,1,2,3
7024_0,,,,2,1,2,3
7026_0,,,,2,1,2,3
C(CC(C(O)=O)=O)(O)=O,,,3,1,1,0,1
7027_0,,,,2,1,2,3
7028_0,,,,2,1,2,3
7029_0,,,,2,1,2,3
7030_0,,,,2,1,2,3
7031_0,,,,2,1,2,3
7032_0,,,,2,1,2,3
7033_0,,,,2,1,2,3
7034_0,,,,2,1,2,3
7035_0,,,,2,1,2,3
7036_0,,,,2,1,2,3
7037_0,,,,2,1,2,3
7038_0,,,,2,1,2,3
7039_0,,,,2,1,2,3
7040_0,,,,2,1,2,3
7041_0,,,,2,1,2,3
7042_0,,,,2,1,2,3
7043_0,,,,2,1,2,3
7044_0,,,,2,1,2,3
7045_0,,,,2,1,2,3
7046_0,,,,2,1,2,3
7047_0,,,,2,1,2,3
7048_0,,,,2,1,2,3
7049_0,,,,2,1,2,3
7050_0,,,,2,1,2,3
7051_0,,,,2,1,2,3
7052_0,,,,2,1,2,3
7053_0,,,,2,1,2,3
7054_0,,,,2,1,2,3
7055_0,,,,2,1,2,3
7056_0,,,,2,1,2,3
7057_0,,,,2,1,2,3
7058_0,,,,2,1,2,3
7059_0,,,,2,1,2,3
7060_0,,,,2,1,2,3
7061_0,,,,2,1,2,3
7062_0,,,,2,1,2,3
7063_0,,,,2,1,2,3
7064_0,,,,2,1,2,3
7065_0,,,,2,1,2,3
7066_0,,,,2,1,2,3
7067_0,,,,2,1,2,3
7069_0,,,,2,1,2,3
C(C(CCC(CO)O)=O)=O,,,3,1,1,0,1
7070_0,,,,2,1,2,3
7071_0,,,,2,1,2,3
7073_0,,,,2,1,2,3
C(CCC(C(C=O)O)O)=O,,,3,1,1,0,1
7075_0,,,,2,1,2,3
C(C(C(C=O)O)O)(CC)=O,,,3,1,1,0,1
7076_0,,,,2,1,2,3
7077_0,,,,2,1,2,3
7078_0,,,,2,1,2,3
7079_0,,,,2,1,2,3
7080_0,,,,2,1,2,3
7081_0,,,,2,1,2,3
7082_0,,,,2,1,2,3
7083_0,,,,2,1,2,3
7084_0,,,,2,1,2,3
7085_0,,,,2,1,2,3
7086_0,,,,2,1,2,3
7087_0,,,,2,1,2,3
7088_0,,,,2,1,2,3
7089_0,,,,2,1,2,3
7090_0,,,,2,1,2,3
7091_0,,,,2,1,2,3
7092_0,,,,2,1,2,3
7093_0,,,,2,1,2,3
7094_0,,,,2,1,2,3
7095_0,,,,2,1,2,3
7096_0,,,,2,1,2,3
7098_0,,,,2,2,1,3
C(C(CC(C(CO)O)N)=O)=O,,,3,1,16,0,16
7098_1,,,,2,2,1,3
7099_0,,,,2,2,1,3
7101_0,,,,2,2,1,3
C(C(C(CC(CO)N)=O)O)=O,,,3,1,3,0,3
7101_1,,,,2,2,1,3
7102_0,,,,2,2,1,3
7103_0,,,,2,2,1,3
7103_1,,,,2,2,1,3
7104_0,,,,2,2,1,3
7104_1,,,,2,2,1,3
7106_0,,,,2,2,1,3
C(C(C(C=O)O)O)(CCN)=O,,,3,1,3,0,3
7106_1,,,,2,2,1,3
7107_0,,,,2,2,1,3
7108_0,,,,2,2,1,3
7110_0,,,,2,2,1,3
C(C(C(CC(CO)=O)N)O)=O,,,3,1,3,0,3
7110_1,,,,2,2,1,3
7111_0,,,,2,2,1,3
7113_0,,,,2,2,1,3
C(CC(C(C(C=O)O)O)N)=O,,,3,1,3,0,3
7113_1,,,,2,2,1,3
7114_0,,,,2,2,1,3
7114_1,,,,2,2,1,3
7115_0,,,,2,2,1,3
7116_0,,,,2,2,1,3
7117_0,,,,2,2,1,3
7118_0,,,,2,2,1,3
7118_1,,,,2,2,1,3
7119_0,,,,2,2,1,3
7120_0,,,,2,2,1,3
7120_1,,,,2,2,1,3
7121_0,,,,2,2,1,3
7122_0,,,,2,2,1,3
7122_1,,,,2,2,1,3
7123_0,,,,2,2,1,3
7123_1,,,,2,2,1,3
7124_0,,,,2,2,1,3
7124_1,,,,2,2,1,3
7125_0,,,,2,2,1,3
7126_0,,,,2,2,1,3
7127_0,,,,2,2,1,3
7127_1,,,,2,2,1,3
7128_0,,,,2,2,1,3
7129_0,,,,2,2,1,3
7129_1,,,,2,2,1,3
7131_0,,,,2,2,1,3
C(CC(C(C(CO)O)O)NC)(O)=O,,,3,1,2,0,2
7131_1,,,,2,2,1,3
7133_0,,,,2,2,1,3
C(C(CC(C(CO)O)O)NC)(O)=O,,,3,1,1,0,1
7134_0,,,,2,2,1,3
7135_0,,,,2,2,1,3
7137_0,,,,2,1,2,3
C=CC(C(CO)O)O,,,3,1,1,0,1
7139_0,,,,2,1,2,3
C(C(CO)O)=CCO,,,3,1,1,0,1
7140_0,,,,2,1,2,3
7141_0,,,,2,1,2,3
7142_0,,,,2,1,2,3
7143_0,,,,2,1,2,3
7145_0,,,,2,1,2,3
C1(C(C(CO)NCC1)O)=O,,,3,1,1,0,1
7147_0,,,,2,1,2,3
C1(C(CNC(CO)C1)O)=O,,,3,1,1,0,1
7149_0,,,,2,1,2,3
C1(C(CNCC(C1)O)O)=O,,,3,1,1,0,1
7151_0,,,,2,1,2,3
C1(C(C(CNCC1)O)O)=O,,,3,1,1,0,1
7153_0,,,,2,1,2,3
C(CC1C(C(CN1)O)O)=O,,,3,1,1,0,1
7155_0,,,,2,1,2,3
C1(CC(C=O)N(C)CC1O)=O,,,3,1,2,0,2
7156_0,,,,2,1,2,3
7158_0,,,,2,1,2,3
C(C1C(C(CCN1C)=O)O)=O,,,3,1,2,0,2
7159_0,,,,2,1,2,3
7161_0,,,,2,1,2,3
C(C(C1C(CCN1)O)O)=O,,,3,1,1,0,1
7163_0,,,,2,2,2,4
C1(C(C(C(C1CO)N)O)O)=O,,,3,1,1,0,1
7165_0,,,,2,2,2,4
C1(C(C(C(C1CO)O)N)O)=O,,,3,1,1,0,1
7167_0,,,,2,2,2,4
C1(C(C(C(C1CN)O)O)O)=O,,,3,1,1,0,1
7169_0,,,,2,2,2,4
C1(C(C(C(C(C1)O)O)N)O)=O,,,3,1,1,0,1
7171_0,,,,2,2,2,4
C1(C(C(C(C(C1)N)O)O)O)=O,,,3,1,1,0,1
7173_0,,,,2,2,2,4
C(C1C(C(C(C1N)O)O)O)=O,,,3,1,1,0,1
7175_0,,,,2,2,2,4
C(C(C(C(O)=O)O)N(C)CC=O)=O,,,3,1,1,0,1
7177_0,,,,2,2,2,4
C(C(C(C=O)O)N(C)CC=O)(O)=O,,,3,1,1,0,1
7179_0,,,,2,2,2,4
C(C(C(C=O)N)O)(O)=O,,,3,1,1,0,1
7180_0,,,,2,2,2,4
7182_0,,,,2,2,2,4
C(C(C(C(O)=O)O)NCCO)=O,,,3,1,1,0,1
7184_0,,,,2,2,2,4
C(C(C(C=O)O)NCCO)(O)=O,,,3,1,1,0,1
7186_0,,,,2,2,2,4
C(C(CN(C)CC=O)O)=O,,,3,1,1,0,1
7188_0,,,,2,2,2,4
C(C(CN(CC(O)=O)CC=O)O)=O,,,3,1,1,0,1
7190_0,,,,2,2,2,4
C(C(C(O)=O)NCC(C=O)O)(O)=O,,,3,1,1,0,1
7192_0,,,,2,2,2,4
C(C(CO)NCC(C=O)O)(O)=O,,,3,1,1,0,1
7193_0,,,,2,2,2,4
7195_0,,,,2,2,2,4
C(C(CNCCO)O)=O,,,3,1,1,0,1
7197_0,,,,2,2,2,4
C(C(CNCC(C(CO)O)O)O)=O,,,3,1,1,0,1
7199_0,,,,2,2,2,4
C(C(C(CO)C(C(CO)O)N)=O)=O,,,3,1,1,0,1
7201_0,,,,2,2,2,4
C(C(C(CN)C(C(CO)O)O)=O)=O,,,3,1,1,0,1
7203_0,,,,2,2,2,4
C(C(C(C(C(CO)N)O)=O)CO)=O,,,3,1,1,0,1
7205_0,,,,2,2,2,4
C(C(C(C(C(CO)O)O)=O)CN)=O,,,3,1,1,0,1
7207_0,,,,2,2,2,4
C(C(C(C(CO)C(CO)N)=O)O)=O,,,3,1,1,0,1
7209_0,,,,2,2,2,4
C(C(C(C(CN)C(CO)O)=O)O)=O,,,3,1,1,0,1
7211_0,,,,2,2,2,4
C(C(CO)C(C=O)N)(C(CO)O)=O,,,3,1,1,0,1
7213_0,,,,2,2,2,4
C(C(CO)C(C=O)O)(C(CN)O)=O,,,3,1,1,0,1
7215_0,,,,2,2,2,4
C(C(CN)C(C=O)O)(C(CO)O)=O,,,3,1,1,0,1
7217_0,,,,2,2,2,4
C(C(C(C(C(CO)CO)=O)O)N)=O,,,3,1,1,0,1
7219_0,,,,2,2,2,4
C(C(C(C=O)O)O)(C(CO)CN)=O,,,3,1,1,0,1
7221_0,,,,2,2,2,4
C(C(C(C(C(CO)=O)CO)N)O)=O,,,3,1,1,0,1
7223_0,,,,2,2,2,4
C(C(C(C(C(CO)=O)CN)O)O)=O,,,3,1,1,0,1
7225_0,,,,2,2,2,4
C(C(CO)O)(CC(C(C=O)O)N)=O,,,3,1,1,0,1
7227_0,,,,2,2,2,4
C(C(CN)O)(CC(C(C=O)O)O)=O,,,3,1,1,0,1
7229_0,,,,2,2,2,4
C(C(C(C(C=O)O)N)O)(CCO)=O,,,3,1,1,0,1
7231_0,,,,2,2,2,4
C(C(C(C(C=O)O)O)O)(CCN)=O,,,3,1,1,0,1
7233_0,,,,2,2,2,4
C(C(CO)C(C(C(C=O)O)N)O)=O,,,3,1,1,0,1
7235_0,,,,2,2,2,4
C(C(CO)C(C(C(C=O)O)O)N)=O,,,3,1,1,0,1
7237_0,,,,2,2,2,4
C(C(CN)C(C(C(C=O)O)O)O)=O,,,3,1,1,0,1
7239_0,,,,2,2,2,4
C(C)(C(CN(C)CC=O)O)=O,,,3,1,1,0,1
7241_0,,,,2,2,2,4
C(C(CO)NCC(C(C)=O)O)(O)=O,,,3,1,1,0,1
7242_0,,,,2,2,2,4
7244_0,,,,2,2,2,4
C(C)(C(CNCCO)O)=O,,,3,1,1,0,1
7246_0,,,,2,2,2,4
C(CC(C=O)N(C)CC=O)(CO)=O,,,3,1,1,0,1
7248_0,,,,2,2,2,4
C(C(CC(CO)=O)N)=O,,,3,1,1,0,1
7250_0,,,,2,2,2,4
C(CC(C=O)NCCO)(CO)=O,,,3,1,1,0,1
7252_0,,,,2,2,2,4
C(CN(C)CCC(C=O)=O)=O,,,3,1,1,0,1
7254_0,,,,2,2,2,4
C(C(CO)NCCC(C=O)=O)(O)=O,,,3,1,1,0,1
7256_0,,,,2,2,2,4
C(C(CCN)=O)=O,,,3,1,1,0,1
7258_0,,,,2,2,2,4
C(C(CCNCCO)=O)=O,,,3,1,1,0,1
7260_0,,,,2,2,2,4
C(CN(C)CCC(CO)=O)=O,,,3,1,1,0,1
7262_0,,,,2,2,2,4
C(C(CO)NCCC(CO)=O)(O)=O,,,3,1,1,0,1
7263_0,,,,2,2,2,4
7265_0,,,,2,2,2,4
C(CO)(CCNCCO)=O,,,3,1,1,0,1
7267_0,,,,2,2,2,4
C(C(C(C(C)=O)O)N(C)CC=O)=O,,,3,1,1,0,1
7269_0,,,,2,2,2,4
C(C(C(C(C)=O)O)N)=O,,,3,1,1,0,1
7271_0,,,,2,2,2,4
C(C(C(C(C)=O)O)NCCO)=O,,,3,1,1,0,1
7272_0,,,,2,2,2,4
7273_0,,,,2,2,2,4
7274_0,,,,2,2,2,4
7275_0,,,,2,2,2,4
7277_0,,,,2,2,2,4
C(C(C(C=O)O)N(C)CC=O)=O,,,3,1,1,0,1
7279_0,,,,2,2,2,4
C(C(C(C=O)N)O)=O,,,3,1,1,0,1
7281_0,,,,2,2,2,4
C(C(C(C=O)O)NCCO)=O,,,3,1,1,0,1
7283_0,,,,2,2,2,4
C(CN(C)CC(C(CO)=O)O)=O,,,3,1,1,0,1
7285_0,,,,2,2,2,4
C(CO)(C(CN)O)=O,,,3,1,1,0,1
7287_0,,,,2,2,2,4
C(CO)(C(CNCCO)O)=O,,,3,1,1,0,1
7288_0,,,,2,2,2,4
7290_0,,,,2,2,2,4
C(C(C(CO)N)O)(C(CO)O)=O,,,3,1,1,0,1
7292_0,,,,2,2,2,4
C(CC(C(C(CN)O)=O)O)=O,,,3,1,1,0,1
7294_0,,,,2,2,2,4
C(C(CO)=O)(CC(CO)N)=O,,,3,1,1,0,1
7296_0,,,,2,2,2,4
C(C(CN)O)(CC(CO)=O)=O,,,3,1,1,0,1
7298_0,,,,2,2,2,4
C(CCN)(C(C(CO)=O)O)=O,,,3,1,1,0,1
7300_0,,,,2,2,2,4
C(C(CC(C(C=O)O)N)O)=O,,,3,1,1,0,1
7302_0,,,,2,2,2,4
C(C(C(C(C(C)O)=O)O)N)=O,,,3,1,1,0,1
7304_0,,,,2,2,2,4
C(CC(C(C(CO)=O)O)N)=O,,,3,1,1,0,1
7306_0,,,,2,2,2,4
C(C(C(C(C(CO)N)O)=O)O)=O,,,3,1,1,0,1
7308_0,,,,2,2,2,4
C(CNC)(C(CN(C)CC=O)O)=O,,,3,1,1,0,1
7310_0,,,,2,2,2,4
C(C(C(CO)N(C)CC=O)O)(O)=O,,,3,1,1,0,1
7312_0,,,,2,2,2,4
C(C(C(CO)N(C)CC=O)N)(O)=O,,,3,1,1,0,1
7314_0,,,,2,2,2,4
C(CN(C)CC(C(O)=O)N)=O,,,3,1,1,0,1
7316_0,,,,2,2,2,4
C(CCN(C)CC=O)(CC(C=O)=O)=O,,,3,1,1,0,1
7318_0,,,,2,2,2,4
C(CC(CC(C=O)=O)N(C)CC=O)=O,,,3,1,1,0,1
7320_0,,,,2,2,2,4
C(CC(C(CCN(C)CC=O)=O)=O)=O,,,3,1,1,0,1
7322_0,,,,2,2,2,4
C(CN(C)C(C=O)CC(C(C)=O)=O)=O,,,3,1,1,0,1
7323_0,,,,2,2,2,4
7325_0,,,,2,2,2,4
C(CN(C)CC(C(C=CC=O)=O)O)=O,,,3,1,1,0,1
7327_0,,,,2,2,2,4
C(C(C(C(C=C)=O)O)N(C)CC=O)=O,,,3,1,1,0,1
7329_0,,,,2,2,2,4
C(CN(C)C(C=CC=O)C(C=O)O)=O,,,3,1,1,0,1
7331_0,,,,2,2,2,4
C(CN(C)CC(C(C=O)=O)O)=O,,,3,1,1,0,1
7333_0,,,,2,2,2,4
C(CNC)(C(CN)O)=O,,,3,1,1,0,1
7335_0,,,,2,2,2,4
C(CNC)(C(CNCCO)O)=O,,,3,1,1,0,1
7337_0,,,,2,2,2,4
C(C(C(C(C(CO)O)O)N)NC)=O,,,3,1,13,0,13
7338_0,,,,2,2,2,4
7340_0,,,,2,2,2,4
C(C(C(CO)N)O)(C(CO)NC)=O,,,3,1,1,0,1
7342_0,,,,2,2,2,4
C(CC(C(C(CN)O)=O)NC)=O,,,3,1,1,0,1
7344_0,,,,2,2,2,4
C(C(CNC)=O)(CC(CO)N)=O,,,3,1,1,0,1
7346_0,,,,2,2,2,4
C(C(CN)O)(CC(CNC)=O)=O,,,3,1,1,0,1
7348_0,,,,2,2,2,4
C(CCN)(C(C(CNC)=O)O)=O,,,3,1,1,0,1
7350_0,,,,2,2,2,4
C(C(CC(C(C=O)O)N)NC)=O,,,3,1,1,0,1
7352_0,,,,2,2,2,4
C(C(C(C(C(C)NC)=O)O)N)=O,,,3,1,1,0,1
7354_0,,,,2,2,2,4
C(CC(C(C(CNC)=O)O)N)=O,,,3,1,1,0,1
7356_0,,,,2,2,2,4
C(C(C(C(C(CO)N)O)=O)NC)=O,,,3,1,1,0,1
7358_0,,,,2,2,2,4
C(CNCC(O)=O)(C(CN)O)=O,,,3,1,1,0,1
7360_0,,,,2,2,2,4
C(CNC)(C(C(C(CO)O)N)O)=O,,,3,1,1,0,1
7361_0,,,,2,2,2,4
7362_0,,,,2,2,2,4
7363_0,,,,2,2,2,4
7364_0,,,,2,2,2,4
7365_0,,,,2,2,2,4
7367_0,,,,2,2,2,4
C(C)(C(C(C(CO)O)N)O)=O,,,3,1,1,0,1
7368_0,,,,2,2,2,4
7370_0,,,,2,2,2,4
C(C(C(C(CCO)O)N)O)=O,,,3,1,13,0,13
7372_0,,,,2,2,2,4
C(C(C(CO)N)O)(O)=O,,,3,1,1,0,1
7374_0,,,,2,2,2,4
C(C(C(CO)NCCO)O)(O)=O,,,3,1,1,0,1
7376_0,,,,2,2,2,4
C(C(CC(C(CO)O)N)=O)(O)=O,,,3,1,1,0,1
7378_0,,,,2,2,2,4
C(CC(C(C(CO)N)O)=O)(O)=O,,,3,1,1,0,1
7380_0,,,,2,2,2,4
C(C(C(CC(CO)N)=O)O)(O)=O,,,3,1,1,0,1
7381_0,,,,2,2,2,4
7383_0,,,,2,2,2,4
C(CC(C(O)=O)O)(C(CN)O)=O,,,3,1,1,0,1
7384_0,,,,2,2,2,4
7386_0,,,,2,2,2,4
C(C(C(C(O)=O)O)O)(CCN)=O,,,3,1,1,0,1
7388_0,,,,2,2,2,4
C(C(C(CC(CO)=O)N)O)(O)=O,,,3,1,1,0,1
7390_0,,,,2,2,2,4
C(C(C(C(C(C)=O)O)N)O)(O)=O,,,3,1,1,0,1
7392_0,,,,2,2,2,4
C(CC(C(C(C(O)=O)O)N)O)=O,,,3,1,1,0,1
7394_0,,,,2,2,2,4
C(CC(C(C(C(O)=O)O)O)N)=O,,,3,1,1,0,1
7396_0,,,,2,2,2,4
C(CC(C(C(C=O)O)N)O)(O)=O,,,3,1,1,0,1
7398_0,,,,2,2,2,4
C(CC(C(C(C=O)O)O)N)(O)=O,,,3,1,1,0,1
7400_0,,,,2,2,2,4
C(C(C(C(C(CO)O)N)O)=O)(O)=O,,,3,1,1,0,1
7402_0,,,,2,2,2,4
C1(CC(C(C1(CO)O)O)N)=O,,,3,1,1,0,1
7404_0,,,,2,2,2,4
C(C(C(CC(CO)N)=O)(CO)O)=O,,,3,1,1,0,1
7406_0,,,,2,2,2,4
C(CC(C=O)N)(C(CO)(CO)O)=O,,,3,1,1,0,1
7408_0,,,,2,2,2,4
C(C(CO)(C(C(CCN)=O)O)O)=O,,,3,1,1,0,1
7410_0,,,,2,2,2,4
C(C(CO)(C(C=O)O)O)(CCN)=O,,,3,1,1,0,1
7412_0,,,,2,2,2,4
C(C(CO)(C(CC(CO)=O)N)O)=O,,,3,1,1,0,1
7414_0,,,,2,2,2,4
C(C(CO)(C(C(C(C)=O)O)N)O)=O,,,3,1,1,0,1
7416_0,,,,2,2,2,4
C(C(C(C(C(C)=O)(CO)O)N)O)=O,,,3,1,1,0,1
7418_0,,,,2,2,2,4
C(C(CO)(C(C(CC=O)N)O)O)=O,,,3,1,1,0,1
7420_0,,,,2,2,2,4
C(C(CO)(CC(C(CN)O)=O)O)=O,,,3,1,1,0,1
7422_0,,,,2,2,2,4
C(C(C(CO)N)N)(O)=O,,,3,1,1,0,1
7424_0,,,,2,2,2,4
C(C(C(CO)NCCO)N)(O)=O,,,3,1,1,0,1
7426_0,,,,2,2,2,4
C(C(C(C(C(CO)O)O)N)N)(O)=O,,,3,1,1,0,1
7428_0,,,,2,2,2,4
C(C(C(C(O)=O)N)N)(O)=O,,,3,1,1,0,1
7430_0,,,,2,2,2,4
C(C(C(C(O)=O)NCCO)N)(O)=O,,,3,1,1,0,1
7432_0,,,,2,2,2,4
C(C(CNC(C(O)=O)CO)N)(O)=O,,,3,1,1,0,1
7434_0,,,,2,2,2,4
C(C(CN)N)(O)=O,,,3,1,1,0,1
7436_0,,,,2,2,2,4
C(C(CNCCO)N)(O)=O,,,3,1,1,0,1
7438_0,,,,2,2,2,4
C(CO)(C(C(C(CO)O)N)NC)=O,,,3,1,1,0,1
7440_0,,,,2,2,2,4
C(CC(C(C(CO)N)NC)=O)=O,,,3,1,1,0,1
7442_0,,,,2,2,2,4
C(C(C(CC(CO)N)=O)NC)=O,,,3,1,1,0,1
7444_0,,,,2,2,2,4
C(CC(C=O)N)(C(CO)NC)=O,,,3,1,1,0,1
7446_0,,,,2,2,2,4
C(CC(C=O)O)(C(CN)NC)=O,,,3,1,1,0,1
7448_0,,,,2,2,2,4
C(C(C(C(CCO)=O)NC)N)=O,,,3,1,1,0,1
7450_0,,,,2,2,2,4
C(C(C(C=O)O)NC)(CCN)=O,,,3,1,1,0,1
7452_0,,,,2,2,2,4
C(C(C(C(C(C)=O)NC)N)O)=O,,,3,1,1,0,1
7454_0,,,,2,2,2,4
C(C(C(C(C(CO)O)N)NC)=O)=O,,,3,1,1,0,1
7456_0,,,,2,2,2,4
C(C(C(C(C(CO)O)O)N)N)=O,,,3,1,1,0,1
7457_0,,,,2,2,2,4
7459_0,,,,2,2,2,4
C(CN)(C(C(C(CO)O)N)O)=O,,,3,1,1,0,1
7461_0,,,,2,2,2,4
C(CCN)(CC(C=O)=O)=O,,,3,1,1,0,1
7463_0,,,,2,2,2,4
C(CCNCCO)(CC(C=O)=O)=O,,,3,1,1,0,1
7465_0,,,,2,2,2,4
C(CC(CC(C=O)=O)N)=O,,,3,1,1,0,1
7467_0,,,,2,2,2,4
C(CC(CC(C=O)=O)NCCO)=O,,,3,1,1,0,1
7469_0,,,,2,2,2,4
C(CC(C(CCN)=O)=O)=O,,,3,1,1,0,1
7471_0,,,,2,2,2,4
C(CC(C(CCNCCO)=O)=O)=O,,,3,1,1,0,1
7473_0,,,,2,2,2,4
C(C(CC(C(C)=O)=O)N)=O,,,3,1,1,0,1
7475_0,,,,2,2,2,4
C(C(CC(C(C)=O)=O)NCCO)=O,,,3,1,1,0,1
7476_0,,,,2,2,2,4
7477_0,,,,2,2,2,4
7479_0,,,,2,2,2,4
C1(CC(C(C(CO)O)O1)N)=O,,,3,1,1,0,1
7481_0,,,,2,2,2,4
C1(C(C(CO)O)OC(C1)N)=O,,,3,1,1,0,1
7483_0,,,,2,2,2,4
C1(C(C(CO)N)OC(C1)O)=O,,,3,1,1,0,1
7485_0,,,,2,2,2,4
C(C)(C1C(C(C(O1)O)O)N)=O,,,3,1,1,0,1
7487_0,,,,2,2,2,4
C1(CC(C(C(CO)O1)O)N)=O,,,3,1,1,0,1
7489_0,,,,2,2,2,4
C1(COC(CO)C(C1O)N)=O,,,3,1,1,0,1
7491_0,,,,2,2,2,4
C1(C(O)OC(CO)C(C1)N)=O,,,3,1,1,0,1
7493_0,,,,2,2,2,4
C1(C(C(CO)OC(C1)N)O)=O,,,3,1,1,0,1
7495_0,,,,2,2,2,4
C1(C(C(N)OC(CO)C1)O)=O,,,3,1,1,0,1
7497_0,,,,2,2,2,4
C1(C(CO)OC(C(C1)N)O)=O,,,3,1,1,0,1
7499_0,,,,2,2,2,4
C1(C(CN)OC(C(C1)O)O)=O,,,3,1,1,0,1
7501_0,,,,2,2,2,4
C1(CC(C(C(CO1)O)O)N)=O,,,3,1,1,0,1
7503_0,,,,2,2,2,4
C1(COCC(C(C1O)N)O)=O,,,3,1,1,0,1
7505_0,,,,2,2,2,4
C1(C(O)OCC(C(C1)N)O)=O,,,3,1,1,0,1
7507_0,,,,2,2,2,4
C1(C(C(COC(C1)N)O)O)=O,,,3,1,1,0,1
7509_0,,,,2,2,2,4
C1(C(C(COC(C1)O)N)O)=O,,,3,1,1,0,1
7511_0,,,,2,2,2,4
C1(C(C(N)OCC(C1)O)O)=O,,,3,1,1,0,1
7513_0,,,,2,2,2,4
C1(C(C(O)OCC(C1)N)O)=O,,,3,1,1,0,1
7515_0,,,,2,2,2,4
C1(C(COC(C(C1)N)O)O)=O,,,3,1,1,0,1
7517_0,,,,2,2,2,4
C1(C(C(C(O)OCC1)N)O)=O,,,3,1,1,0,1
7519_0,,,,2,2,2,4
C1(COC(C(C(C1)N)O)O)=O,,,3,1,1,0,1
7521_0,,,,2,2,2,4
C(C(C(CO)N)O)(CCN)=O,,,3,1,1,0,1
7523_0,,,,2,2,2,4
C(C(CN)O)(CC(CO)N)=O,,,3,1,1,0,1
7525_0,,,,2,2,2,4
C(C(CO)O)(CC(CN)N)=O,,,3,1,1,0,1
7527_0,,,,2,2,2,4
C(C(CN)O)(CC(CN)O)=O,,,3,1,1,0,1
7529_0,,,,2,2,2,4
C(C(C(CN)N)O)(CCO)=O,,,3,1,1,0,1
7531_0,,,,2,2,2,4
C(C(C(CN)O)O)(CCN)=O,,,3,1,1,0,1
7533_0,,,,2,2,2,4
C(CO)(CC(C(CN)O)N)=O,,,3,1,1,0,1
7535_0,,,,2,2,2,4
C(C)(C(C(C(CN)O)N)O)=O,,,3,1,1,0,1
7537_0,,,,2,2,2,4
C(CC(C(C(CN)O)O)N)=O,,,3,1,1,0,1
7539_0,,,,2,2,2,4
C(CC(C(O)=O)N)(CCO)=O,,,3,1,1,0,1
7541_0,,,,2,2,2,4
C(CC(C(O)=O)O)(CCN)=O,,,3,1,1,0,1
7543_0,,,,2,2,2,4
C(CC(CC(C(O)=O)O)N)=O,,,3,1,1,0,1
7545_0,,,,2,2,2,4
C(C(C(CC(CO)N)=O)=O)=O,,,3,1,1,0,1
7547_0,,,,2,2,2,4
C(C(CN)O)(CC(C=O)=O)=O,,,3,1,1,0,1
7549_0,,,,2,2,2,4
C(CCN)(C(C(C=O)=O)O)=O,,,3,1,1,0,1
7551_0,,,,2,2,2,4
C(CC(C(C(C=O)=O)O)N)=O,,,3,1,1,0,1
7553_0,,,,2,2,2,4
C(C=CC(C(CN)O)=O)=O,,,3,1,1,0,1
7555_0,,,,2,2,2,4
C(C=CC(C(CNCCO)O)=O)=O,,,3,1,1,0,1
7557_0,,,,2,2,2,4
C(C(C(C(C=C)=O)O)N)=O,,,3,1,1,0,1
7559_0,,,,2,2,2,4
C(C(C(C(C=C)=O)O)NCCO)=O,,,3,1,1,0,1
7561_0,,,,2,2,2,4
C(C(C(C=CC=O)N)O)=O,,,3,1,1,0,1
7563_0,,,,2,2,2,4
C(C(C(C=CC=O)NCCO)O)=O,,,3,1,1,0,1
7565_0,,,,2,2,2,4
C(CC(C=O)NC)(C(CN)O)=O,,,3,1,1,0,1
7567_0,,,,2,2,2,4
C(CC(C=O)N)(C(CNC)O)=O,,,3,1,1,0,1
7569_0,,,,2,2,2,4
C(C(C(C(CCN)=O)O)NC)=O,,,3,1,1,0,1
7571_0,,,,2,2,2,4
C(C(C(C(CCNC)=O)O)N)=O,,,3,1,1,0,1
7573_0,,,,2,2,2,4
C(CC(C(C(C=O)O)NC)N)=O,,,3,1,1,0,1
7575_0,,,,2,2,2,4
C(CC(C(C(C=O)O)N)NC)=O,,,3,1,1,0,1
7577_0,,,,2,2,2,4
C(C1C(CC(CO)(O1)O)N)=O,,,3,1,1,0,1
7579_0,,,,2,2,2,4
C(C1C(C(C(C)(O1)O)O)N)=O,,,3,1,1,0,1
7581_0,,,,2,2,2,4
C(C1C(C(CC(O1)O)O)N)=O,,,3,1,1,0,1
7583_0,,,,2,2,2,4
C1(C(O)OC(CO)C(C1O)N)=O,,,3,1,1,0,1
7585_0,,,,2,2,2,4
C1(C(O)OCC(C(C1O)N)O)=O,,,3,1,1,0,1
7587_0,,,,2,2,2,4
C(C(C(C(CCO)N)N)O)=O,,,3,1,1,0,1
7589_0,,,,2,2,2,4
C(C(C(CC(CO)N)N)O)=O,,,3,1,1,0,1
7591_0,,,,2,2,2,4
C(C(C(C(C(C)N)O)N)O)=O,,,3,1,1,0,1
7593_0,,,,2,2,2,4
C(C(C(C(CCN)O)N)O)=O,,,3,1,1,0,1
7595_0,,,,2,2,2,4
C1(C(C(C(C(CO)O)O1)N)O)=O,,,3,1,1,0,1
7597_0,,,,2,2,2,4
C1(C(C(C(C(CO)O1)O)N)O)=O,,,3,1,1,0,1
7599_0,,,,2,2,2,4
C1(C(C(C(C(CO1)O)O)N)O)=O,,,3,1,1,0,1
7601_0,,,,2,2,2,4
C(C(C(CN)O)=O)=O,,,3,1,1,0,1
7603_0,,,,2,2,2,4
C(C(C(CNCCO)O)=O)=O,,,3,1,1,0,1
7604_0,,,,2,2,2,4
7606_0,,,,2,2,2,4
C(C(C(C=O)O)NCC(O)=O)(O)=O,,,3,1,1,0,1
7608_0,,,,2,2,2,4
C(C(CNCC(O)=O)O)=O,,,3,1,1,0,1
7610_0,,,,2,2,2,4
C(C)(C(CNCC(O)=O)O)=O,,,3,1,1,0,1
7612_0,,,,2,2,2,4
C(CNC(C=O)CC(CO)=O)(O)=O,,,3,1,1,0,1
7614_0,,,,2,2,2,4
C(CNCCC(C=O)=O)(O)=O,,,3,1,1,0,1
7616_0,,,,2,2,2,4
C(CNCCC(CO)=O)(O)=O,,,3,1,1,0,1
7617_0,,,,2,2,2,4
7618_0,,,,2,2,2,4
7619_0,,,,2,2,2,4
7620_0,,,,2,2,2,4
7622_0,,,,2,2,2,4
C(CNC)(C(CNCC(O)=O)O)=O,,,3,1,1,0,1
7623_0,,,,2,2,2,4
7625_0,,,,2,2,2,4
C(C(C(CO)NCC(O)=O)N)(O)=O,,,3,1,1,0,1
7627_0,,,,2,2,2,4
C(C(CNCC(O)=O)N)(O)=O,,,3,1,1,0,1
7629_0,,,,2,2,2,4
C(CNCC(C(C=O)=O)O)(O)=O,,,3,1,1,0,1
7630_0,,,,2,2,2,4
7632_0,,,,2,2,2,4
C(C(C(CO)N)O)=O,,,3,1,1,0,1
7634_0,,,,2,2,2,4
C(C(C(CO)NCCO)O)=O,,,3,1,2,0,2
7636_0,,,,2,2,2,4
C(CO)(C(C(C(CO)O)N)O)=O,,,3,1,1,0,1
7638_0,,,,2,2,2,4
C(C(C(C(C(CO)O)O)N)O)(O)=O,,,3,1,1,0,1
7640_0,,,,2,2,2,4
C1(C(C(C(C1CO)NC)O)O)=O,,,3,1,1,0,1
7641_0,,,,2,2,2,4
7642_0,,,,2,2,2,4
7643_0,,,,2,2,2,4
7644_0,,,,2,2,2,4
7645_0,,,,2,2,2,4
7646_0,,,,2,2,2,4
7648_0,,,,2,2,2,4
C(C(C(C=O)O)NC)(O)=O,,,3,1,1,0,1
7650_0,,,,2,2,2,4
C(C(CNC)O)=O,,,3,1,1,0,1
7651_0,,,,2,2,2,4
7652_0,,,,2,2,2,4
7653_0,,,,2,2,2,4
7654_0,,,,2,2,2,4
7655_0,,,,2,2,2,4
7656_0,,,,2,2,2,4
7657_0,,,,2,2,2,4
7658_0,,,,2,2,2,4
7659_0,,,,2,2,2,4
7660_0,,,,2,2,2,4
7661_0,,,,2,2,2,4
7662_0,,,,2,2,2,4
7663_0,,,,2,2,2,4
7664_0,,,,2,2,2,4
7665_0,,,,2,2,2,4
7667_0,,,,2,2,2,4
C(C(C(C(C(C)O)=O)O)NC)=O,,,3,1,1,0,1
7668_0,,,,2,2,2,4
7670_0,,,,2,2,2,4
C(C(C(C(C(CO)NC)O)=O)O)=O,,,3,1,1,0,1
7672_0,,,,2,2,2,4
C(CNC)(C(CNC)O)=O,,,3,1,1,0,1
7674_0,,,,2,2,2,4
C(CC(C(C(CNC)O)=O)NC)=O,,,3,1,1,0,1
7675_0,,,,2,2,2,4
7676_0,,,,2,2,2,4
7677_0,,,,2,2,2,4
7678_0,,,,2,2,2,4
7680_0,,,,2,2,2,4
C(C(C(C(C(C)NC)=O)O)NC)=O,,,3,1,1,0,1
7681_0,,,,2,2,2,4
7683_0,,,,2,2,2,4
C(CNCC(O)=O)(C(CNC)O)=O,,,3,1,1,0,1
7684_0,,,,2,2,2,4
7685_0,,,,2,2,2,4
7686_0,,,,2,2,2,4
7687_0,,,,2,2,2,4
7688_0,,,,2,2,2,4
7689_0,,,,2,2,2,4
7690_0,,,,2,2,2,4
7691_0,,,,2,2,2,4
7692_0,,,,2,2,2,4
7693_0,,,,2,2,2,4
7694_0,,,,2,2,2,4
7695_0,,,,2,2,2,4
7696_0,,,,2,2,2,4
7697_0,,,,2,2,2,4
7698_0,,,,2,2,2,4
7699_0,,,,2,2,2,4
7700_0,,,,2,2,2,4
7701_0,,,,2,2,2,4
7702_0,,,,2,2,2,4
7703_0,,,,2,2,2,4
7704_0,,,,2,2,2,4
7705_0,,,,2,2,2,4
7706_0,,,,2,2,2,4
7708_0,,,,2,2,2,4
C(C(C(CO)NC)N)(O)=O,,,3,1,1,0,1
7710_0,,,,2,2,2,4
C(C(C(C(O)=O)NC)N)(O)=O,,,3,1,1,0,1
7712_0,,,,2,2,2,4
C(C(CNC)N)(O)=O,,,3,1,1,0,1
7713_0,,,,2,2,2,4
7714_0,,,,2,2,2,4
7715_0,,,,2,2,2,4
7716_0,,,,2,2,2,4
7717_0,,,,2,2,2,4
7718_0,,,,2,2,2,4
7719_0,,,,2,2,2,4
7720_0,,,,2,2,2,4
7721_0,,,,2,2,2,4
7722_0,,,,2,2,2,4
7723_0,,,,2,2,2,4
7724_0,,,,2,2,2,4
7725_0,,,,2,2,2,4
7726_0,,,,2,2,2,4
7727_0,,,,2,2,2,4
7729_0,,,,2,2,2,4
C1(CC(C(C(CO)O)O1)NC)=O,,,3,1,1,0,1
7731_0,,,,2,2,2,4
C1(C(C(CO)O)OC(C1)NC)=O,,,3,1,1,0,1
7733_0,,,,2,2,2,4
C1(C(C(CO)NC)OC(C1)O)=O,,,3,1,2,0,2
7735_0,,,,2,2,2,4
C(C)(C1C(C(C(O1)O)O)NC)=O,,,3,1,2,0,2
7737_0,,,,2,2,2,4
C1(CC(C(C(CO)O1)O)NC)=O,,,3,1,1,0,1
7739_0,,,,2,2,2,4
C1(COC(CO)C(C1O)NC)=O,,,3,1,1,0,1
7741_0,,,,2,2,2,4
C1(C(O)OC(CO)C(C1)NC)=O,,,3,1,2,0,2
7743_0,,,,2,2,2,4
C1(C(C(CO)OC(C1)NC)O)=O,,,3,1,1,0,1
7745_0,,,,2,2,2,4
C1(C(C(NC)OC(CO)C1)O)=O,,,3,1,1,0,1
7747_0,,,,2,2,2,4
C1(C(CO)OC(C(C1)NC)O)=O,,,3,1,2,0,2
7749_0,,,,2,2,2,4
C1(C(CNC)OC(C(C1)O)O)=O,,,3,1,2,0,2
7751_0,,,,2,2,2,4
C1(CC(C(C(CO1)O)O)NC)=O,,,3,1,1,0,1
7753_0,,,,2,2,2,4
C1(COCC(C(C1O)NC)O)=O,,,3,1,1,0,1
7755_0,,,,2,2,2,4
C1(C(O)OCC(C(C1)NC)O)=O,,,3,1,2,0,2
7757_0,,,,2,2,2,4
C1(C(C(COC(C1)NC)O)O)=O,,,3,1,1,0,1
7759_0,,,,2,2,2,4
C1(C(C(COC(C1)O)NC)O)=O,,,3,1,2,0,2
7761_0,,,,2,2,2,4
C1(C(C(NC)OCC(C1)O)O)=O,,,3,1,1,0,1
7763_0,,,,2,2,2,4
C1(C(C(O)OCC(C1)NC)O)=O,,,3,1,2,0,2
7765_0,,,,2,2,2,4
C1(C(COC(C(C1)NC)O)O)=O,,,3,1,2,0,2
7767_0,,,,2,2,2,4
C1(C(C(C(O)OCC1)NC)O)=O,,,3,1,2,0,2
7769_0,,,,2,2,2,4
C1(COC(C(C(C1)NC)O)O)=O,,,3,1,2,0,2
7771_0,,,,2,2,2,4
C(C(C(CO)NC)O)(CCN)=O,,,3,1,13,0,13
7773_0,,,,2,2,2,4
C(C(CN)O)(CC(CO)NC)=O,,,3,1,13,0,13
7775_0,,,,2,2,2,4
C(C(CO)O)(CC(CN)NC)=O,,,3,1,13,0,13
7777_0,,,,2,2,2,4
C(C(CNC)O)(CC(CN)O)=O,,,3,1,13,0,13
7779_0,,,,2,2,2,4
C(C(C(CN)NC)O)(CCO)=O,,,3,1,13,0,13
7781_0,,,,2,2,2,4
C(C(C(CN)O)O)(CCNC)=O,,,3,1,13,0,13
7783_0,,,,2,2,2,4
C(CO)(CC(C(CN)O)NC)=O,,,3,1,13,0,13
7785_0,,,,2,2,2,4
C(C)(C(C(C(CN)O)NC)O)=O,,,3,1,13,0,13
7787_0,,,,2,2,2,4
C(CC(C(C(CN)O)O)NC)=O,,,3,1,13,0,13
7789_0,,,,2,2,2,4
C(CC(C(O)=O)NC)(CCO)=O,,,3,1,1,0,1
7791_0,,,,2,2,2,4
C(CC(C(O)=O)O)(CCNC)=O,,,3,1,2,0,2
7793_0,,,,2,2,2,4
C(CC(CC(C(O)=O)O)NC)=O,,,3,1,2,0,2
7795_0,,,,2,2,2,4
C(C(C(CC(CO)NC)=O)=O)=O,,,3,1,1,0,1
7797_0,,,,2,2,2,4
C(C(CNC)O)(CC(C=O)=O)=O,,,3,1,2,0,2
7799_0,,,,2,2,2,4
C(CCNC)(C(C(C=O)=O)O)=O,,,3,1,2,0,2
7800_0,,,,2,2,2,4
7801_0,,,,2,2,2,4
7802_0,,,,2,2,2,4
7803_0,,,,2,2,2,4
7805_0,,,,2,2,2,4
C(CC(C=O)NC)(C(CNC)O)=O,,,3,1,2,0,2
7806_0,,,,2,2,2,4
7808_0,,,,2,2,2,4
C(C(C(C(CCNC)=O)O)NC)=O,,,3,1,2,0,2
7809_0,,,,2,2,2,4
7811_0,,,,2,2,2,4
C(CC(C(C(C=O)O)NC)NC)=O,,,3,1,2,0,2
7812_0,,,,2,2,2,4
7814_0,,,,2,2,2,4
C(C1C(CC(CO)(O1)O)NC)=O,,,3,1,2,0,2
7816_0,,,,2,2,2,4
C(C1C(C(C(C)(O1)O)O)NC)=O,,,3,1,2,0,2
7818_0,,,,2,2,2,4
C(C1C(C(CC(O1)O)O)NC)=O,,,3,1,2,0,2
7820_0,,,,2,2,2,4
C1(C(O)OC(CO)C(C1O)NC)=O,,,3,1,2,0,2
7822_0,,,,2,2,2,4
C1(C(O)OCC(C(C1O)NC)O)=O,,,3,1,2,0,2
7824_0,,,,2,2,2,4
C(C(C(C(CCO)N)NC)O)=O,,,3,1,13,0,13
7826_0,,,,2,2,2,4
C(C(C(CC(CO)N)NC)O)=O,,,3,1,13,0,13
7828_0,,,,2,2,2,4
C(C(C(C(C(C)N)O)NC)O)=O,,,3,1,13,0,13
7830_0,,,,2,2,2,4
C(C(C(C(CCN)O)NC)O)=O,,,3,1,13,0,13
7832_0,,,,2,2,2,4
C1(C(C(C(C(CO)O)O1)NC)O)=O,,,3,1,1,0,1
7834_0,,,,2,2,2,4
C1(C(C(C(C(CO)O1)O)NC)O)=O,,,3,1,1,0,1
7836_0,,,,2,2,2,4
C1(C(C(C(C(CO1)O)O)NC)O)=O,,,3,1,1,0,1
7838_0,,,,2,2,2,4
C(C(C(CNC)O)=O)=O,,,3,1,1,0,1
7839_0,,,,2,2,2,4
7841_0,,,,2,2,2,4
C(CC(C(C(CO)N)O)=O)=O,,,3,1,1,0,1
7842_0,,,,2,2,2,4
7843_0,,,,2,2,2,4
7845_0,,,,2,2,2,4
C(CC(C=O)O)(C(CN)O)=O,,,3,1,1,0,1
7846_0,,,,2,2,2,4
7847_0,,,,2,2,2,4
7848_0,,,,2,2,2,4
7850_0,,,,2,2,2,4
C(C(C(C(C(C)=O)O)N)O)=O,,,3,1,1,0,1
7852_0,,,,2,2,2,4
C(CC(C(C(C=O)O)N)O)=O,,,3,1,1,0,1
7853_0,,,,2,2,2,4
7855_0,,,,2,2,2,4
C(C(C(C(C(CO)O)N)O)=O)=O,,,3,1,1,0,1
7857_0,,,,2,2,2,4
C(C(C(C(C(CO)O)O)N)O)=O,,,3,1,13,0,13
7858_0,,,,2,2,2,4
7859_0,,,,2,2,2,4
7860_0,,,,2,2,2,4
7861_0,,,,2,2,2,4
7862_0,,,,2,2,2,4
7863_0,,,,2,2,2,4
7864_0,,,,2,2,2,4
7865_0,,,,2,2,2,4
7866_0,,,,2,2,2,4
7867_0,,,,2,2,2,4
7868_0,,,,2,2,2,4
7869_0,,,,2,2,2,4
7870_0,,,,2,2,2,4
7871_0,,,,2,2,2,4
7872_0,,,,2,2,2,4
7873_0,,,,2,2,2,4
7874_0,,,,2,2,2,4
7875_0,,,,2,2,2,4
7876_0,,,,2,2,2,4
7877_0,,,,2,2,2,4
7878_0,,,,2,2,2,4
7880_0,,,,2,1,1,2
C12C(C(C(CC1O)(O)O2)O)O,,,3,1,1,0,1
7882_0,,,,2,1,1,2
C1(C2C(C(C(C2O)O1)O)O)O,,,3,1,2,0,2
7882_1,,,,2,1,1,2
7884_0,,,,2,1,1,2
C1(C(C(C(O)O1)O)O)=O,,,3,1,1,0,1
7886_0,,,,2,1,1,2
C1(C(O)OCC1C(C(CO)O)O)=O,,,3,1,1,0,1
7887_0,,,,2,1,1,2
7889_0,,,,2,1,1,2
C(C1(C(CO)C(C(CO)O1)O)O)=O,,,3,1,1,0,1
7890_0,,,,2,1,1,2
7891_0,,,,2,1,1,2
7893_0,,,,2,1,1,2
C(C(C1(C(CO)C(CO1)O)O)O)=O,,,3,1,1,0,1
7895_0,,,,2,1,1,2
C(C(CO)O)(C1COC(C1O)O)=O,,,3,1,1,0,1
7897_0,,,,2,1,1,2
C(C1C(C(CO)C(CO)(O1)O)O)=O,,,3,1,1,0,1
7899_0,,,,2,1,1,2
C(C1C(CC(C(CO)O)(O1)O)O)=O,,,3,1,1,0,1
7901_0,,,,2,1,1,2
C(C1C(C(C(CCO)(O1)O)O)O)=O,,,3,1,1,0,1
7902_0,,,,2,1,1,2
7904_0,,,,2,1,1,2
C(C(C1C(C(C(O)O1)CO)O)O)=O,,,3,1,1,0,1
7905_0,,,,2,1,1,2
7906_0,,,,2,1,1,2
7907_0,,,,2,1,1,2
7908_0,,,,2,1,1,2
7909_0,,,,2,1,1,2
7910_0,,,,2,1,1,2
7912_0,,,,2,1,1,2
C(C1(C(CC(CO)O1)O)O)=O,,,3,1,1,0,1
7914_0,,,,2,1,1,2
C1(COC(C(CO)O)(C1)O)=O,,,3,1,1,0,1
7915_0,,,,2,1,1,2
7917_0,,,,2,1,1,2
C(C1CC(C(CO)(O1)O)O)=O,,,3,1,1,0,1
7919_0,,,,2,1,1,2
C(CO)(C1CC(C(O1)O)O)=O,,,3,1,1,0,1
7921_0,,,,2,1,1,2
C1(COC(CCO)(C1O)O)=O,,,3,1,1,0,1
7923_0,,,,2,1,1,2
C1(C(CCO)OC(C1O)O)=O,,,3,1,1,0,1
7925_0,,,,2,1,1,2
C(C(C1(C(CCO1)O)O)O)=O,,,3,1,1,0,1
7927_0,,,,2,1,1,2
C(C(C1CC(C(O)O1)O)O)=O,,,3,1,1,0,1
7928_0,,,,2,1,1,2
7929_0,,,,2,1,1,2
7931_0,,,,2,1,1,2
C(C(C1(C(C(CO1)O)O)O)O)=O,,,3,1,1,0,1
7933_0,,,,2,1,1,2
CNC1C(O)OC(C1O)C(CO)O,,,3,1,1,0,1
7935_0,,,,2,1,1,2
CNC(CO)C1(C(C(CO1)O)O)O,,,3,1,1,0,1
7937_0,,,,2,1,1,2
C1(C(CNC)(O)OC(CO)C1)=O,,,3,1,1,0,1
7938_0,,,,2,1,1,2
7940_0,,,,2,1,1,2
C(C1(C(CC(CO)O1)NC)O)=O,,,3,1,1,0,1
7942_0,,,,2,1,1,2
C1(C(CO)OC(CNC)(C1)O)=O,,,3,1,1,0,1
7944_0,,,,2,1,1,2
C(C1CC(C(CO)(O1)O)NC)=O,,,3,1,1,0,1
7946_0,,,,2,1,1,2
C(C(C1(C(CCO1)NC)O)O)=O,,,3,1,1,0,1
7948_0,,,,2,1,1,2
C(C(C1CC(C(O)O1)NC)O)=O,,,3,1,1,0,1
7949_0,,,,2,1,1,2
7950_0,,,,2,1,1,2
7952_0,,,,2,1,1,2
C(C(C1(C(C(CO1)O)O)O)NC)=O,,,3,1,1,0,1
7954_0,,,,2,1,1,2
CNCC1(C(C(C(CO)O1)O)O)O,,,3,1,1,0,1
7955_0,,,,2,1,1,2
7956_0,,,,2,1,1,2
7957_0,,,,2,1,1,2
7958_0,,,,2,1,1,2
7959_0,,,,2,1,1,2
7960_0,,,,2,1,1,2
7961_0,,,,2,1,1,2
7962_0,,,,2,1,1,2
7963_0,,,,2,1,1,2
7965_0,,,,2,1,1,2
C1(C(CC(C(CO)O)(O)O1)O)=O,,,3,1,1,0,1
7967_0,,,,2,1,1,2
C1(C(C(C(CCO)(O)O1)O)O)=O,,,3,1,1,0,1
7968_0,,,,2,1,1,2
7969_0,,,,2,1,1,2
7970_0,,,,2,1,1,2
7971_0,,,,2,1,1,2
7972_0,,,,2,1,1,2
7974_0,,,,2,1,1,2
C1(C2(C(C(CC2O)O1)O)O)O,,,3,1,2,0,2
7974_1,,,,2,1,1,2
7976_0,,,,2,1,1,2
C1C(C(C(O)O1)(C(CO)O)O)O,,,3,1,1,0,1
7978_0,,,,2,1,1,2
C(C1(C(O)OCC1O)O)(O)=O,,,3,1,1,0,1
7980_0,,,,2,1,1,2
C(C(C1(C(O)OCC1O)O)O)(O)=O,,,3,1,1,0,1
7982_0,,,,2,1,1,2
C1(C(C(C(O)O1)(C(CO)O)O)O)=O,,,3,1,1,0,1
7984_0,,,,2,1,1,2
C1C(C(C(O)O1)(CO)O)O,,,3,1,1,0,1
7985_0,,,,2,1,1,2
7987_0,,,,2,1,1,2
C(CC1(C(CO)(C(CO1)O)O)O)=O,,,3,1,1,0,1
7988_0,,,,2,1,1,2
7990_0,,,,2,1,1,2
C(C1(COC(C1O)(CCO)O)O)=O,,,3,1,1,0,1
7992_0,,,,2,1,1,2
C(CCO)(C1(COC(C1O)O)O)=O,,,3,1,1,0,1
7993_0,,,,2,1,1,2
7994_0,,,,2,1,1,2
7996_0,,,,2,1,1,2
C(C)(C1C(C(CO)(C(O1)O)O)O)=O,,,3,1,1,0,1
7998_0,,,,2,1,1,2
C(C1C(C(CO)(C(C)(O1)O)O)O)=O,,,3,1,1,0,1
7999_0,,,,2,1,1,2
8000_0,,,,2,1,1,2
8002_0,,,,2,1,1,2
C(CC1C(C(C(O)O1)(CO)O)O)=O,,,3,1,1,0,1
8004_0,,,,2,1,1,2
C(C1(COC(C1)(C(CO)O)O)O)=O,,,3,1,1,0,1
8006_0,,,,2,1,1,2
CNC1C(C(CO)OC1(CO)O)O,,,3,1,1,0,1
8008_0,,,,2,1,1,2
C(CC1(C(C(CO1)O)NC)O)=O,,,3,1,1,0,1
8010_0,,,,2,1,1,2
C(C(C1(CC(CO1)O)O)NC)=O,,,3,1,1,0,1
8012_0,,,,2,1,1,2
C(C1C(C(C(C)(O1)O)NC)O)=O,,,3,1,1,0,1
8013_0,,,,2,1,1,2
8015_0,,,,2,1,1,2
C(C1(C(C(C(CO)O1)O)NC)O)=O,,,3,1,1,0,1
8017_0,,,,2,1,1,2
C(C(C1CC(C(O)O1)N)O)O,,,3,1,13,0,13
8019_0,,,,2,1,1,2
C(C(C1C(C(C(O)O1)N)O)O)O,,,3,1,13,0,13
8021_0,,,,2,1,1,2
C(C1C(CC(CN)(O)O1)O)O,,,3,1,13,0,13
8023_0,,,,2,1,1,2
C(C1C(C(C(CN)(O)O1)O)O)O,,,3,1,13,0,13
8024_0,,,,2,1,1,2
8025_0,,,,2,1,1,2
8026_0,,,,2,1,1,2
8027_0,,,,2,1,1,2
8028_0,,,,2,1,1,2
8029_0,,,,2,1,1,2
8030_0,,,,2,1,1,2
8031_0,,,,2,1,1,2
8033_0,,,,2,1,1,2
C1C2(C(C(C(CO)O2)O1)O)O,,,3,1,1,0,1
8035_0,,,,2,1,1,2
C(C1C2CC(C(O)O2)(O)O1)O,,,3,1,2,0,2
8037_0,,,,2,1,1,2
C1C(C2C(CC(O)O2)(O)O1)O,,,3,1,2,0,2
8039_0,,,,2,1,1,2
CC1(C2C(C(C(O)O2)O1)O)O,,,3,1,2,0,2
8041_0,,,,2,1,1,2
C1(CC2C(C(C(O)O2)O)O1)O,,,3,1,2,0,2
8043_0,,,,2,1,1,2
C1C2C(C(CC(O)O2)(O)O1)O,,,3,1,2,0,2
8045_0,,,,2,1,1,2
C1C2CC(C(C(O)O2)O)(O)O1,,,3,1,2,0,2
8047_0,,,,2,1,1,2
C1C2(C(C(C(CO1)O2)O)O)O,,,3,1,1,0,1
8049_0,,,,2,1,1,2
C1C2C(CC(C(O)O1)(O)O2)O,,,3,1,2,0,2
8051_0,,,,2,1,1,2
C1C(C2(CC(C(O2)O1)O)O)O,,,3,1,1,0,1
8053_0,,,,2,1,1,2
C1CC2(C(C(C(O2)O1)O)O)O,,,3,1,1,0,1
8055_0,,,,2,1,1,2
C1C2(CC(C(C(O)O1)O2)O)O,,,3,1,2,0,2
8057_0,,,,2,1,1,2
C1C(C(C(CCN)(O)O1)O)O,,,3,1,13,0,13
8059_0,,,,2,1,1,2
C1C(CC(C(CN)O)(O)O1)O,,,3,1,13,0,13
8061_0,,,,2,1,1,2
C(C1(CC(C(CN)O1)O)O)O,,,3,1,13,0,13
8063_0,,,,2,1,1,2
CC1(C(C(C(CN)O1)O)O)O,,,3,1,13,0,13
8065_0,,,,2,1,1,2
C1(CC(C(C(CN)O)O1)O)O,,,3,1,13,0,13
8067_0,,,,2,1,1,2
C1(C(CC(CCO)(O)O1)O)=O,,,3,1,1,0,1
8069_0,,,,2,1,1,2
C(C1CCC(CO)(O1)O)(O)=O,,,3,1,1,0,1
8071_0,,,,2,1,1,2
C(C1CC(C(C)(O1)O)O)(O)=O,,,3,1,1,0,1
8072_0,,,,2,1,1,2
8074_0,,,,2,1,1,2
C(C(C1(CC(CO1)O)O)=O)=O,,,3,1,2,0,2
8075_0,,,,2,1,1,2
8076_0,,,,2,1,1,2
8078_0,,,,2,1,1,2
C(C(C1C(CC(O1)O)O)=O)=O,,,3,1,2,0,2
8079_0,,,,2,1,1,2
8081_0,,,,2,1,1,2
CNC1COC(C1O)O,,,3,1,1,0,1
8083_0,,,,2,1,1,2
CNC1C(CO)OC(CO)(C1O)O,,,3,1,1,0,1
8085_0,,,,2,1,1,2
C(C1(CC(C(CO)O1)NC)O)=O,,,3,1,1,0,1
8086_0,,,,2,1,1,2
8088_0,,,,2,1,1,2
C(CC1(C(C(CO1)NC)O)O)=O,,,3,1,1,0,1
8090_0,,,,2,1,1,2
C(C(C1(CC(CO1)NC)O)O)=O,,,3,1,1,0,1
8091_0,,,,2,1,1,2
8092_0,,,,2,1,1,2
8093_0,,,,2,1,1,2
8095_0,,,,2,1,1,2
C(CC1C(C(C(O)O1)O)NC)=O,,,3,1,1,0,1
8097_0,,,,2,1,1,2
C(C(C1C(CC(O)O1)NC)O)=O,,,3,1,1,0,1
8099_0,,,,2,1,1,2
C(C1(C(C(C(CO)O1)NC)O)O)=O,,,3,1,1,0,1
8101_0,,,,2,1,1,2
C(CNC1COC(C1O)O)(O)=O,,,3,1,1,0,1
8103_0,,,,2,1,1,2
CNC1C(C(CO)O)OC(C1O)O,,,3,1,1,0,1
8104_0,,,,2,1,1,2
8105_0,,,,2,1,1,2
8106_0,,,,2,1,1,2
8107_0,,,,2,1,1,2
8109_0,,,,2,1,1,2
C1(C2(C(C(C(CO)O2)O1)O)O)O,,,3,1,2,0,2
8110_0,,,,2,1,1,2
8112_0,,,,2,1,1,2
C1C(C2CC(C(O)O2)(O)O1)O,,,3,1,2,0,2
8114_0,,,,2,1,1,2
C1(C2C(C(CC(O)O2)O1)O)O,,,3,1,2,0,2
8116_0,,,,2,1,1,2
C1C(C2C(C(C(O)O2)(O)O1)O)O,,,3,1,2,0,2
8118_0,,,,2,1,1,2
C1C2C(C(C(C(O)O1)(O)O2)O)O,,,3,1,2,0,2
8120_0,,,,2,1,1,2
C(C(C1C(CC(O)O1)N)O)O,,,3,1,13,0,13
8122_0,,,,2,1,1,2
CC(C1C(C(C(O)O1)O)O)N,,,3,1,13,0,13
8124_0,,,,2,1,1,2
C1(C(C(C(CCN)O1)O)O)O,,,3,1,13,0,13
8126_0,,,,2,1,1,2
C1(C(O)OCC1O)=O,,,3,1,1,0,1
8128_0,,,,2,1,1,2
C(C(C1CC(C(O)O1)O)O)O,,,3,1,1,0,1
8129_0,,,,2,1,1,2
8131_0,,,,2,1,1,2
C(C1(C(CO)C(C(CO1)O)O)O)=O,,,3,1,1,0,1
8132_0,,,,2,1,1,2
8134_0,,,,2,1,1,2
C1(C(C(O)OCC1C(CO)O)O)=O,,,3,1,1,0,1
8135_0,,,,2,1,1,2
8136_0,,,,2,1,1,2
8138_0,,,,2,1,1,2
C(CO)(C1COC(C(C1O)O)O)=O,,,3,1,1,0,1
8140_0,,,,2,1,1,2
C(C1C(C(C(CO)C(O1)O)O)O)=O,,,3,1,1,0,1
8141_0,,,,2,1,1,2
8142_0,,,,2,1,1,2
8143_0,,,,2,1,1,2
8144_0,,,,2,1,1,2
8146_0,,,,2,1,1,2
C(C1(C(CC(CO1)O)O)O)=O,,,3,1,1,0,1
8147_0,,,,2,1,1,2
8148_0,,,,2,1,1,2
8150_0,,,,2,1,1,2
C1(COC(CO)(CC1O)O)=O,,,3,1,1,0,1
8151_0,,,,2,1,1,2
8153_0,,,,2,1,1,2
C(C1C(CC(C(O1)O)O)O)=O,,,3,1,1,0,1
8155_0,,,,2,1,1,2
C(C1CC(C(C(O1)O)O)O)=O,,,3,1,1,0,1
8157_0,,,,2,1,1,2
C1(COC(C)(C(C1O)O)O)=O,,,3,1,1,0,1
8159_0,,,,2,1,1,2
C1(C(C)OC(C(C1O)O)O)=O,,,3,1,1,0,1
8160_0,,,,2,1,1,2
8162_0,,,,2,1,1,2
CNC1C(O)OC(CO)C(C1O)O,,,3,1,1,0,1
8163_0,,,,2,1,1,2
8165_0,,,,2,1,1,2
C1(C(CNC)(O)OCC(C1)O)=O,,,3,1,1,0,1
8166_0,,,,2,1,1,2
8168_0,,,,2,1,1,2
C(C1(C(CC(CO1)O)NC)O)=O,,,3,1,1,0,1
8170_0,,,,2,1,1,2
C1(C(COC(CNC)(C1)O)O)=O,,,3,1,1,0,1
8172_0,,,,2,1,1,2
C1(C(C(CNC)(O)OCC1)O)=O,,,3,1,1,0,1
8174_0,,,,2,1,1,2
C1(COC(C(C1)O)(CNC)O)=O,,,3,1,1,0,1
8176_0,,,,2,1,1,2
C(C1C(CC(C(O1)O)NC)O)=O,,,3,1,1,0,1
8177_0,,,,2,1,1,2
8179_0,,,,2,1,1,2
CNCC1(C(C(C(CO1)O)O)O)O,,,3,1,1,0,1
8180_0,,,,2,1,1,2
8182_0,,,,2,1,1,2
CC1(C(C(C(CO1)O)O)O)O,,,3,1,1,0,1
8183_0,,,,2,1,1,2
8184_0,,,,2,1,1,2
8186_0,,,,2,1,1,2
C1(C(C(CC(CO)(O)O1)O)O)=O,,,3,1,1,0,1
8188_0,,,,2,1,1,2
C1(C(C(C(C(C)(O)O1)O)O)O)=O,,,3,1,1,0,1
8189_0,,,,2,1,1,2
8190_0,,,,2,1,1,2
8192_0,,,,2,1,1,2
C1(CC(O)OCC1(C(CO)O)O)=O,,,3,1,1,0,1
8193_0,,,,2,1,1,2
8194_0,,,,2,1,1,2
8195_0,,,,2,1,1,2
8197_0,,,,2,1,1,2
C(C1(COC(CO)(CC1O)O)O)=O,,,3,1,1,0,1
8199_0,,,,2,1,1,2
C(C1(COC(C)(C(C1O)O)O)O)=O,,,3,1,1,0,1
8201_0,,,,2,1,1,2
C(C)(C1(COC(C(C1O)O)O)O)=O,,,3,1,1,0,1
8202_0,,,,2,1,1,2
8204_0,,,,2,1,1,2
C1(C(CO)OC(C(CO)(C1)O)O)=O,,,3,1,1,0,1
8206_0,,,,2,1,1,2
CNC1C(CO)(O)OCC(C1O)O,,,3,1,1,0,1
8207_0,,,,2,1,1,2
8208_0,,,,2,1,1,2
8209_0,,,,2,1,1,2
8211_0,,,,2,1,1,2
C(C1(C(C(C(CO1)O)O)NC)O)=O,,,3,1,1,0,1
8213_0,,,,2,1,1,2
C(C1C(CC(C(O)O1)N)O)O,,,3,1,13,0,13
8215_0,,,,2,1,1,2
C(C1C(C(C(C(O)O1)N)O)O)O,,,3,1,13,0,13
8217_0,,,,2,1,1,2
C1C(C(CC(CN)(O)O1)O)O,,,3,1,13,0,13
8219_0,,,,2,1,1,2
C1C(C(C(C(CN)(O)O1)O)O)O,,,3,1,13,0,13
8220_0,,,,2,1,1,2
8221_0,,,,2,1,1,2
8222_0,,,,2,1,1,2
8223_0,,,,2,1,1,2
8225_0,,,,2,1,1,2
C1C2(C(C(C(CO2)O)O1)O)O,,,3,1,1,0,1
8226_0,,,,2,1,1,2
8227_0,,,,2,1,1,2
8229_0,,,,2,1,1,2
C1C2(C(C(C(CO2)O1)O)O)O,,,3,1,1,0,1
8231_0,,,,2,1,1,2
C1C2C(CC(C(O)O2)(O)O1)O,,,3,1,2,0,2
8233_0,,,,2,1,1,2
C1(CC(C(C(CN)O1)O)O)O,,,3,1,13,0,13
8235_0,,,,2,1,1,2
C1(C(CCC(CO)(O)O1)O)=O,,,3,1,1,0,1
8237_0,,,,2,1,1,2
C1(C(CC(C(C)(O)O1)O)O)=O,,,3,1,1,0,1
8239_0,,,,2,1,1,2
C(C1CC(CC(O1)O)O)(O)=O,,,3,1,1,0,1
8240_0,,,,2,1,1,2
8241_0,,,,2,1,1,2
8242_0,,,,2,1,1,2
8243_0,,,,2,1,1,2
8244_0,,,,2,1,1,2
8245_0,,,,2,1,1,2
8247_0,,,,2,1,1,2
CNC1C(C(CO)(O)OCC1O)O,,,3,1,1,0,1
8248_0,,,,2,1,1,2
8250_0,,,,2,1,1,2
C(C1(CC(C(CO1)O)NC)O)=O,,,3,1,1,0,1
8251_0,,,,2,1,1,2
8252_0,,,,2,1,1,2
8253_0,,,,2,1,1,2
8255_0,,,,2,1,1,2
C(C1C(C(CC(O1)O)NC)O)=O,,,3,1,1,0,1
8256_0,,,,2,1,1,2
8258_0,,,,2,1,1,2
C(C1(C(C(C(CO1)O)NC)O)O)=O,,,3,1,1,0,1
8260_0,,,,2,1,1,2
CNC1C(C(CO)OC(C1O)O)O,,,3,1,1,0,1
8261_0,,,,2,1,1,2
8262_0,,,,2,1,1,2
8263_0,,,,2,1,1,2
8264_0,,,,2,1,1,2
8266_0,,,,2,1,1,2
C1C2C(C(C(C(O)O2)(O)O1)O)O,,,3,1,2,0,2
8267_0,,,,2,1,1,2
8269_0,,,,2,1,1,2
C(C1C(C(CC(O)O1)N)O)O,,,3,1,13,0,13
8271_0,,,,2,1,1,2
C(C1CC(C(C(O)O1)O)N)O,,,3,1,13,0,13
8273_0,,,,2,1,1,2
C(C1C(CC(C(O)O1)O)N)O,,,3,1,13,0,13
8275_0,,,,2,1,1,2
C(C1C(CC(C(O)O1)O)O)O,,,3,1,1,0,1
8276_0,,,,2,1,1,2
8277_0,,,,2,1,1,2
8278_0,,,,2,1,1,2
8279_0,,,,2,1,1,2
8280_0,,,,2,1,1,2
8281_0,,,,2,1,1,2
8282_0,,,,2,1,1,2
8284_0,,,,2,1,1,2
C(C1COC(C(C(C1O)O)O)O)=O,,,3,1,1,0,1
8285_0,,,,2,1,1,2
8286_0,,,,2,1,1,2
8287_0,,,,2,1,1,2
8288_0,,,,2,1,1,2
8290_0,,,,2,1,1,2
C1(COC(CC(C1O)O)O)=O,,,3,1,1,0,1
8291_0,,,,2,1,1,2
8293_0,,,,2,1,1,2
CNC1C(O)OCC(C(C1O)O)O,,,3,1,1,0,1
8294_0,,,,2,1,1,2
8295_0,,,,2,1,1,2
8296_0,,,,2,1,1,2
8297_0,,,,2,1,1,2
8298_0,,,,2,1,1,2
8300_0,,,,2,1,1,2
C1C(C(C(CC(O)O1)O)O)O,,,3,1,1,0,1
8302_0,,,,2,1,1,2
C1CC(C(C(C(O)O1)O)O)O,,,3,1,1,0,1
8304_0,,,,2,1,1,2
C1(C(C(C(CC(O)O1)O)O)O)=O,,,3,1,1,0,1
8306_0,,,,2,1,1,2
C1(CC(C(C(C(O)O1)O)O)O)=O,,,3,1,1,0,1
8307_0,,,,2,1,1,2
8308_0,,,,2,1,1,2
8309_0,,,,2,1,1,2
8311_0,,,,2,1,1,2
C1(C(C(C(O)OCC1)(CO)O)O)=O,,,3,1,1,0,1
8312_0,,,,2,1,1,2
8314_0,,,,2,1,1,2
C1(COC(C(CO)(C(C1)O)O)O)=O,,,3,1,1,0,1
8316_0,,,,2,1,1,2
C(C1(COC(CC(C1O)O)O)O)=O,,,3,1,1,0,1
8318_0,,,,2,1,1,2
C1(C(COC(C(CO)(C1)O)O)O)=O,,,3,1,1,0,1
8319_0,,,,2,1,1,2
8320_0,,,,2,1,1,2
8321_0,,,,2,1,1,2
8322_0,,,,2,1,1,2
8323_0,,,,2,1,1,2
8325_0,,,,2,1,1,2
C1C(C(CC(C(O)O1)N)O)O,,,3,1,13,0,13
8327_0,,,,2,1,1,2
C1C(C(C(C(C(O)O1)N)O)O)O,,,3,1,13,0,13
8328_0,,,,2,1,1,2
8329_0,,,,2,1,1,2
8330_0,,,,2,1,1,2
8331_0,,,,2,1,1,2
8333_0,,,,2,1,1,2
C12C(C(C(CC(O)O1)O2)O)O,,,3,1,1,0,1
8335_0,,,,2,1,1,2
C1(C(CC(CC(O)O1)O)O)=O,,,3,1,1,0,1
8336_0,,,,2,1,1,2
8337_0,,,,2,1,1,2
8338_0,,,,2,1,1,2
8339_0,,,,2,1,1,2
8340_0,,,,2,1,1,2
8341_0,,,,2,1,1,2
8342_0,,,,2,1,1,2
8343_0,,,,2,1,1,2
8344_0,,,,2,1,1,2
8345_0,,,,2,1,1,2
8346_0,,,,2,1,1,2
8348_0,,,,2,1,1,2
CNC1C(C(COC(C1O)O)O)O,,,3,1,1,0,1
8349_0,,,,2,1,1,2
8350_0,,,,2,1,1,2
8352_0,,,,2,1,1,2
C12CC(C(C(C(O)O1)O)O2)O,,,3,1,1,0,1
8353_0,,,,2,1,1,2
8355_0,,,,2,1,1,2
C1C(C(C(CC(O)O1)N)O)O,,,3,1,13,0,13
8357_0,,,,2,1,1,2
C1C(CC(C(C(O)O1)O)N)O,,,3,1,13,0,13
8359_0,,,,2,1,1,2
C1C(C(CC(C(O)O1)O)N)O,,,3,1,13,0,13
8361_0,,,,2,1,1,2
C1CC(C(C(C(O)O1)O)O)N,,,3,1,13,0,13
8363_0,,,,2,1,1,2
C1C(CC(C(C(O)O1)O)O)N,,,3,1,13,0,13
8365_0,,,,2,1,1,2
C1C(C(CC(C(O)O1)O)O)O,,,3,1,1,0,1
8366_0,,,,2,1,1,2
8367_0,,,,2,1,1,2
8368_0,,,,2,1,1,2
8369_0,,,,2,1,1,2
8370_0,,,,2,1,1,2
8371_0,,,,2,1,1,2
8372_0,,,,2,1,1,2
8373_0,,,,2,1,1,2
8374_0,,,,2,1,1,2
8375_0,,,,2,1,1,2
8376_0,,,,2,1,1,2
8377_0,,,,2,1,1,2
8378_0,,,,2,1,1,2
8379_0,,,,2,1,1,2
8380_0,,,,2,1,1,2
8381_0,,,,2,1,1,2
8382_0,,,,2,1,1,2
8383_0,,,,2,1,1,2
8384_0,,,,2,1,1,2
8385_0,,,,2,1,1,2
8386_0,,,,2,1,1,2
8387_0,,,,2,1,1,2
8388_0,,,,2,1,1,2
8389_0,,,,2,1,1,2
8390_0,,,,2,1,1,2
8391_0,,,,2,1,1,2
8392_0,,,,2,1,1,2
8393_0,,,,2,1,1,2
8394_0,,,,2,1,1,2
8395_0,,,,2,1,1,2
8396_0,,,,2,2,2,4
8396_1,,,,2,2,2,4
8397_0,,,,2,2,2,4
8397_1,,,,2,2,2,4
8399_0,,,,2,2,2,4
C(C(C(O)=O)=O)(O)=O,,,3,1,341,0,341
8399_1,,,,2,2,2,4
8401_0,,,,2,2,2,4
C(C(C(C(O)=O)=O)O)(O)=O,,,3,1,341,0,341
8401_1,,,,2,2,2,4
8402_0,,,,2,2,2,4
8402_1,,,,2,2,2,4
8403_0,,,,2,2,2,4
8404_0,,,,2,2,2,4
8405_0,,,,2,2,2,4
8406_0,,,,2,2,2,4
8407_0,,,,2,2,2,4
8408_0,,,,2,2,2,4
8409_0,,,,2,2,2,4
8410_0,,,,2,2,2,4
8411_0,,,,2,2,2,4
8412_0,,,,2,2,2,4
8413_0,,,,2,2,2,4
8414_0,,,,2,2,2,4
8415_0,,,,2,2,2,4
8416_0,,,,2,2,2,4
8417_0,,,,2,2,2,4
8418_0,,,,2,2,2,4
8419_0,,,,2,2,2,4
8420_0,,,,2,2,2,4
8421_0,,,,2,2,2,4
8422_0,,,,2,2,2,4
8423_0,,,,2,2,2,4
8424_0,,,,2,2,2,4
8424_1,,,,2,2,2,4
8425_0,,,,2,2,2,4
8425_1,,,,2,2,2,4
8426_0,,,,2,2,2,4
8426_1,,,,2,2,2,4
8427_0,,,,2,2,2,4
8427_1,,,,2,2,2,4
8428_0,,,,2,2,2,4
8428_1,,,,2,2,2,4
8429_0,,,,2,2,2,4
8430_0,,,,2,2,2,4
8431_0,,,,2,2,2,4
8432_0,,,,2,2,2,4
8433_0,,,,2,2,2,4
8434_0,,,,2,2,2,4
8435_0,,,,2,2,2,4
8436_0,,,,2,2,2,4
8437_0,,,,2,2,2,4
8438_0,,,,2,2,2,4
8439_0,,,,2,2,2,4
8440_0,,,,2,2,2,4
8441_0,,,,2,2,2,4
8442_0,,,,2,2,2,4
8443_0,,,,2,2,2,4
8444_0,,,,2,2,2,4
8445_0,,,,2,2,2,4
8446_0,,,,2,2,2,4
8447_0,,,,2,2,2,4
8448_0,,,,2,2,2,4
8449_0,,,,2,2,2,4
8450_0,,,,2,2,2,4
8450_1,,,,2,2,2,4
8451_0,,,,2,2,2,4
8451_1,,,,2,2,2,4
8452_0,,,,2,2,2,4
8453_0,,,,2,2,2,4
8454_0,,,,2,2,2,4
8455_0,,,,2,2,2,4
8456_0,,,,2,2,2,4
8456_1,,,,2,2,2,4
8457_0,,,,2,2,2,4
8457_1,,,,2,2,2,4
8458_0,,,,2,2,2,4
8458_1,,,,2,2,2,4
8459_0,,,,2,2,2,4
8459_1,,,,2,2,2,4
8460_0,,,,2,2,2,4
8460_1,,,,2,2,2,4
8461_0,,,,2,2,2,4
8462_0,,,,2,2,2,4
8463_0,,,,2,2,2,4
8464_0,,,,2,2,2,4
8465_0,,,,2,2,2,4
8466_0,,,,2,2,2,4
8467_0,,,,2,2,2,4
8468_0,,,,2,2,2,4
8469_0,,,,2,2,2,4
8470_0,,,,2,2,2,4
8471_0,,,,2,2,2,4
8472_0,,,,2,2,2,4
8473_0,,,,2,2,2,4
8474_0,,,,2,2,2,4
8475_0,,,,2,2,2,4
8476_0,,,,2,2,2,4
8477_0,,,,2,2,2,4
8478_0,,,,2,2,2,4
8479_0,,,,2,2,2,4
8480_0,,,,2,2,2,4
8481_0,,,,2,2,2,4
8483_0,,,,2,2,2,4
C(C1C(C(C(C1N)O)O)O)O,,,3,1,12,0,12
8484_0,,,,2,2,2,4
8485_0,,,,2,2,2,4
8486_0,,,,2,2,2,4
8487_0,,,,2,2,2,4
8489_0,,,,2,2,2,4
C1C(C(C(C(C1N)O)O)O)O,,,3,1,12,0,12
8490_0,,,,2,2,2,4
8491_0,,,,2,2,2,4
8492_0,,,,2,2,2,4
8493_0,,,,2,2,2,4
8495_0,,,,2,2,2,4
C(C1C(C(C(C1O)O)O)O)N,,,3,1,12,0,12
8496_0,,,,2,2,2,4
8497_0,,,,2,2,2,4
8498_0,,,,2,2,2,4
8499_0,,,,2,2,2,4
8500_0,,,,2,2,2,4
8501_0,,,,2,2,2,4
8502_0,,,,2,2,2,4
8503_0,,,,2,2,2,4
8504_0,,,,2,2,2,4
8506_0,,,,2,2,2,4
C(C(C(CN)O)O)(O)=O,,,3,1,12,0,12
8507_0,,,,2,2,2,4
8508_0,,,,2,2,2,4
8509_0,,,,2,2,2,4
8510_0,,,,2,2,2,4
8511_0,,,,2,2,2,4
8512_0,,,,2,2,2,4
8513_0,,,,2,2,2,4
8514_0,,,,2,2,2,4
8515_0,,,,2,2,2,4
8516_0,,,,2,2,2,4
8517_0,,,,2,2,2,4
8518_0,,,,2,2,2,4
8519_0,,,,2,2,2,4
8520_0,,,,2,2,2,4
8521_0,,,,2,2,2,4
8522_0,,,,2,2,2,4
8523_0,,,,2,2,2,4
8524_0,,,,2,2,2,4
8525_0,,,,2,2,2,4
8526_0,,,,2,2,2,4
8527_0,,,,2,2,2,4
8528_0,,,,2,2,2,4
8529_0,,,,2,2,2,4
8530_0,,,,2,2,2,4
8531_0,,,,2,2,2,4
8532_0,,,,2,2,2,4
8533_0,,,,2,2,2,4
8534_0,,,,2,2,2,4
8535_0,,,,2,2,2,4
8536_0,,,,2,2,2,4
8538_0,,,,2,2,2,4
C(C(C(C(CO)C(CO)O)N)O)=O,,,3,1,12,0,12
8539_0,,,,2,2,2,4
8540_0,,,,2,2,2,4
8541_0,,,,2,2,2,4
8542_0,,,,2,2,2,4
8543_0,,,,2,2,2,4
8544_0,,,,2,2,2,4
8545_0,,,,2,2,2,4
8546_0,,,,2,2,2,4
8547_0,,,,2,2,2,4
8549_0,,,,2,2,2,4
C(C(C(CO)C(C(CO)O)N)O)=O,,,3,1,12,0,12
8550_0,,,,2,2,2,4
8551_0,,,,2,2,2,4
8552_0,,,,2,2,2,4
8553_0,,,,2,2,2,4
8554_0,,,,2,2,2,4
8555_0,,,,2,2,2,4
8556_0,,,,2,2,2,4
8557_0,,,,2,2,2,4
8558_0,,,,2,2,2,4
8560_0,,,,2,2,2,4
C(C(C(C(C(CO)CO)N)O)O)=O,,,3,1,12,0,12
8561_0,,,,2,2,2,4
8562_0,,,,2,2,2,4
8563_0,,,,2,2,2,4
8564_0,,,,2,2,2,4
8565_0,,,,2,2,2,4
8566_0,,,,2,2,2,4
8567_0,,,,2,2,2,4
8568_0,,,,2,2,2,4
8569_0,,,,2,2,2,4
8571_0,,,,2,2,2,4
C(C(C(C(CO)C(CO)N)O)O)=O,,,3,1,12,0,12
8572_0,,,,2,2,2,4
8573_0,,,,2,2,2,4
8574_0,,,,2,2,2,4
8575_0,,,,2,2,2,4
8576_0,,,,2,2,2,4
8577_0,,,,2,2,2,4
8578_0,,,,2,2,2,4
8579_0,,,,2,2,2,4
8580_0,,,,2,2,2,4
8582_0,,,,2,2,2,4
C(C(C(CC(C(CO)O)N)O)O)=O,,,3,1,12,0,12
8583_0,,,,2,2,2,4
8584_0,,,,2,2,2,4
8585_0,,,,2,2,2,4
8586_0,,,,2,2,2,4
8587_0,,,,2,2,2,4
8588_0,,,,2,2,2,4
8589_0,,,,2,2,2,4
8590_0,,,,2,2,2,4
8591_0,,,,2,2,2,4
8593_0,,,,2,2,2,4
C(C(C(C(C(CCO)N)O)O)O)=O,,,3,1,12,0,12
8594_0,,,,2,2,2,4
8595_0,,,,2,2,2,4
8596_0,,,,2,2,2,4
8597_0,,,,2,2,2,4
8598_0,,,,2,2,2,4
8599_0,,,,2,2,2,4
8600_0,,,,2,2,2,4
8601_0,,,,2,2,2,4
8602_0,,,,2,2,2,4
8604_0,,,,2,2,2,4
C(C(C(C(C(CO)CN)O)O)O)=O,,,3,1,12,0,12
8605_0,,,,2,2,2,4
8606_0,,,,2,2,2,4
8607_0,,,,2,2,2,4
8608_0,,,,2,2,2,4
8609_0,,,,2,2,2,4
8610_0,,,,2,2,2,4
8611_0,,,,2,2,2,4
8612_0,,,,2,2,2,4
8614_0,,,,2,2,2,4
C(C(CO)N)O,,,3,1,12,0,12
8615_0,,,,2,2,2,4
8616_0,,,,2,2,2,4
8617_0,,,,2,2,2,4
8618_0,,,,2,2,2,4
8619_0,,,,2,2,2,4
8620_0,,,,2,2,2,4
8621_0,,,,2,2,2,4
8622_0,,,,2,2,2,4
8623_0,,,,2,2,2,4
8624_0,,,,2,2,2,4
8625_0,,,,2,2,2,4
8626_0,,,,2,2,2,4
8627_0,,,,2,2,2,4
8628_0,,,,2,2,2,4
8629_0,,,,2,2,2,4
8630_0,,,,2,2,2,4
8631_0,,,,2,2,2,4
8632_0,,,,2,2,2,4
8633_0,,,,2,2,2,4
8634_0,,,,2,2,2,4
8635_0,,,,2,2,2,4
8636_0,,,,2,2,2,4
8637_0,,,,2,2,2,4
8638_0,,,,2,2,2,4
8639_0,,,,2,2,2,4
8640_0,,,,2,2,2,4
8641_0,,,,2,2,2,4
8642_0,,,,2,2,2,4
8643_0,,,,2,2,2,4
8644_0,,,,2,2,2,4
8645_0,,,,2,2,2,4
8646_0,,,,2,2,2,4
8647_0,,,,2,2,2,4
8648_0,,,,2,2,2,4
8649_0,,,,2,2,2,4
8650_0,,,,2,2,2,4
8651_0,,,,2,2,2,4
8652_0,,,,2,2,2,4
8653_0,,,,2,2,2,4
8655_0,,,,2,2,2,4
CC(C(CO)O)N,,,3,1,12,0,12
8656_0,,,,2,2,2,4
8657_0,,,,2,2,2,4
8658_0,,,,2,2,2,4
8659_0,,,,2,2,2,4
8660_0,,,,2,2,2,4
8662_0,,,,2,2,2,4
C(C(CC(CO)N)O)=O,,,3,1,12,0,12
8663_0,,,,2,2,2,4
8664_0,,,,2,2,2,4
8665_0,,,,2,2,2,4
8666_0,,,,2,2,2,4
8667_0,,,,2,2,2,4
8668_0,,,,2,2,2,4
8669_0,,,,2,2,2,4
8670_0,,,,2,2,2,4
8671_0,,,,2,2,2,4
8672_0,,,,2,2,2,4
8673_0,,,,2,2,2,4
8674_0,,,,2,2,2,4
8675_0,,,,2,2,2,4
8676_0,,,,2,2,2,4
8677_0,,,,2,2,2,4
8678_0,,,,2,2,2,4
8679_0,,,,2,2,2,4
8680_0,,,,2,2,2,4
8682_0,,,,2,2,2,4
C(C(CCO)N)O,,,3,1,12,0,12
8683_0,,,,2,2,2,4
8684_0,,,,2,2,2,4
8685_0,,,,2,2,2,4
8686_0,,,,2,2,2,4
8687_0,,,,2,2,2,4
8689_0,,,,2,2,2,4
C(C(C(C(C)N)O)O)=O,,,3,1,12,0,12
8690_0,,,,2,2,2,4
8691_0,,,,2,2,2,4
8692_0,,,,2,2,2,4
8693_0,,,,2,2,2,4
8694_0,,,,2,2,2,4
8695_0,,,,2,2,2,4
8696_0,,,,2,2,2,4
8697_0,,,,2,2,2,4
8698_0,,,,2,2,2,4
8699_0,,,,2,2,2,4
8700_0,,,,2,2,2,4
8701_0,,,,2,2,2,4
8702_0,,,,2,2,2,4
8704_0,,,,2,2,2,4
CC(CO)N,,,3,1,12,0,12
8705_0,,,,2,2,2,4
8706_0,,,,2,2,2,4
8707_0,,,,2,2,2,4
8708_0,,,,2,2,2,4
8709_0,,,,2,2,2,4
8710_0,,,,2,2,2,4
8711_0,,,,2,2,2,4
8712_0,,,,2,2,2,4
8713_0,,,,2,2,2,4
8714_0,,,,2,2,2,4
8715_0,,,,2,2,2,4
8716_0,,,,2,2,2,4
8717_0,,,,2,2,2,4
8718_0,,,,2,2,2,4
8719_0,,,,2,2,2,4
8720_0,,,,2,2,2,4
8721_0,,,,2,2,2,4
8722_0,,,,2,2,2,4
8723_0,,,,2,2,2,4
8725_0,,,,2,2,2,4
CCN,,,3,1,12,0,12
8726_0,,,,2,2,2,4
8727_0,,,,2,2,2,4
8728_0,,,,2,2,2,4
8729_0,,,,2,2,2,4
8730_0,,,,2,2,2,4
8731_0,,,,2,2,2,4
8732_0,,,,2,2,2,4
8733_0,,,,2,2,2,4
8734_0,,,,2,2,2,4
8735_0,,,,2,2,2,4
8736_0,,,,2,2,2,4
8737_0,,,,2,2,2,4
8738_0,,,,2,2,2,4
8739_0,,,,2,2,2,4
8741_0,,,,2,2,2,4
C(C(C(CO)O)N)O,,,3,1,12,0,12
8742_0,,,,2,2,2,4
8743_0,,,,2,2,2,4
8744_0,,,,2,2,2,4
8745_0,,,,2,2,2,4
8746_0,,,,2,2,2,4
8747_0,,,,2,2,2,4
8748_0,,,,2,2,2,4
8749_0,,,,2,2,2,4
8750_0,,,,2,2,2,4
8751_0,,,,2,2,2,4
8753_0,,,,2,2,2,4
C(CC(C(C(CO)O)N)O)=O,,,3,1,12,0,12
8754_0,,,,2,2,2,4
8755_0,,,,2,2,2,4
8756_0,,,,2,2,2,4
8757_0,,,,2,2,2,4
8758_0,,,,2,2,2,4
8759_0,,,,2,2,2,4
8760_0,,,,2,2,2,4
8761_0,,,,2,2,2,4
8762_0,,,,2,2,2,4
8763_0,,,,2,2,2,4
8764_0,,,,2,2,2,4
8765_0,,,,2,2,2,4
8766_0,,,,2,2,2,4
8767_0,,,,2,2,2,4
8768_0,,,,2,2,2,4
8769_0,,,,2,2,2,4
8770_0,,,,2,2,2,4
8771_0,,,,2,2,2,4
8772_0,,,,2,2,2,4
8773_0,,,,2,2,2,4
8774_0,,,,2,2,2,4
8775_0,,,,2,2,2,4
8776_0,,,,2,2,2,4
8777_0,,,,2,2,2,4
8778_0,,,,2,2,2,4
8779_0,,,,2,2,2,4
8780_0,,,,2,2,2,4
8781_0,,,,2,2,2,4
8782_0,,,,2,2,2,4
8783_0,,,,2,2,2,4
8784_0,,,,2,2,2,4
8785_0,,,,2,2,2,4
8786_0,,,,2,2,2,4
8787_0,,,,2,2,2,4
8788_0,,,,2,2,2,4
8789_0,,,,2,2,2,4
8790_0,,,,2,2,2,4
8791_0,,,,2,2,2,4
8792_0,,,,2,2,2,4
8794_0,,,,2,2,2,4
C(C(CC(C(CO)N)O)O)=O,,,3,1,12,0,12
8795_0,,,,2,2,2,4
8796_0,,,,2,2,2,4
8797_0,,,,2,2,2,4
8798_0,,,,2,2,2,4
8799_0,,,,2,2,2,4
8800_0,,,,2,2,2,4
8801_0,,,,2,2,2,4
8802_0,,,,2,2,2,4
8803_0,,,,2,2,2,4
8804_0,,,,2,2,2,4
8805_0,,,,2,2,2,4
8806_0,,,,2,2,2,4
8807_0,,,,2,2,2,4
8808_0,,,,2,2,2,4
8809_0,,,,2,2,2,4
8810_0,,,,2,2,2,4
8811_0,,,,2,2,2,4
8812_0,,,,2,2,2,4
8813_0,,,,2,2,2,4
8814_0,,,,2,2,2,4
8815_0,,,,2,2,2,4
8816_0,,,,2,2,2,4
8817_0,,,,2,2,2,4
8818_0,,,,2,2,2,4
8819_0,,,,2,2,2,4
8820_0,,,,2,2,2,4
8821_0,,,,2,2,2,4
8822_0,,,,2,2,2,4
8823_0,,,,2,2,2,4
8824_0,,,,2,2,2,4
8825_0,,,,2,2,2,4
8826_0,,,,2,2,2,4
8827_0,,,,2,2,2,4
8828_0,,,,2,2,2,4
8829_0,,,,2,2,2,4
8830_0,,,,2,2,2,4
8831_0,,,,2,2,2,4
8832_0,,,,2,2,2,4
8833_0,,,,2,2,2,4
8835_0,,,,2,2,2,4
C(C(C(CC(CN)O)O)O)=O,,,3,1,12,0,12
8836_0,,,,2,2,2,4
8837_0,,,,2,2,2,4
8838_0,,,,2,2,2,4
8839_0,,,,2,2,2,4
8840_0,,,,2,2,2,4
8841_0,,,,2,2,2,4
8842_0,,,,2,2,2,4
8843_0,,,,2,2,2,4
8844_0,,,,2,2,2,4
8845_0,,,,2,2,2,4
8846_0,,,,2,2,2,4
8847_0,,,,2,2,2,4
8848_0,,,,2,2,2,4
8849_0,,,,2,2,2,4
8850_0,,,,2,2,2,4
8851_0,,,,2,2,2,4
8852_0,,,,2,2,2,4
8853_0,,,,2,2,2,4
8854_0,,,,2,2,2,4
8856_0,,,,2,2,2,4
C(C(C(C(C(C)O)N)O)O)=O,,,3,1,12,0,12
8857_0,,,,2,2,2,4
8858_0,,,,2,2,2,4
8859_0,,,,2,2,2,4
8860_0,,,,2,2,2,4
8861_0,,,,2,2,2,4
8862_0,,,,2,2,2,4
8863_0,,,,2,2,2,4
8864_0,,,,2,2,2,4
8865_0,,,,2,2,2,4
8866_0,,,,2,2,2,4
8867_0,,,,2,2,2,4
8868_0,,,,2,2,2,4
8869_0,,,,2,2,2,4
8870_0,,,,2,2,2,4
8871_0,,,,2,2,2,4
8872_0,,,,2,2,2,4
8873_0,,,,2,2,2,4
8874_0,,,,2,2,2,4
8875_0,,,,2,2,2,4
8876_0,,,,2,2,2,4
8877_0,,,,2,2,2,4
8878_0,,,,2,2,2,4
8879_0,,,,2,2,2,4
8880_0,,,,2,2,2,4
8881_0,,,,2,2,2,4
8882_0,,,,2,2,2,4
8883_0,,,,2,2,2,4
8884_0,,,,2,2,2,4
8886_0,,,,2,2,2,4
CNCCN,,,3,1,12,0,12
8887_0,,,,2,2,2,4
8888_0,,,,2,2,2,4
8889_0,,,,2,2,2,4
8890_0,,,,2,2,2,4
8892_0,,,,2,2,2,4
CNCC(C(CO)O)N,,,3,1,12,0,12
8893_0,,,,2,2,2,4
8894_0,,,,2,2,2,4
8895_0,,,,2,2,2,4
8896_0,,,,2,2,2,4
8897_0,,,,2,2,2,4
8898_0,,,,2,2,2,4
8899_0,,,,2,2,2,4
8900_0,,,,2,2,2,4
8901_0,,,,2,2,2,4
8903_0,,,,2,2,2,4
CNC(CO)C(C(C(CO)O)O)N,,,3,1,12,0,12
8904_0,,,,2,2,2,4
8905_0,,,,2,2,2,4
8906_0,,,,2,2,2,4
8907_0,,,,2,2,2,4
8908_0,,,,2,2,2,4
8910_0,,,,2,2,2,4
C(CC(C(C(CO)O)N)NC)=O,,,3,1,12,0,12
8911_0,,,,2,2,2,4
8912_0,,,,2,2,2,4
8913_0,,,,2,2,2,4
8914_0,,,,2,2,2,4
8915_0,,,,2,2,2,4
8916_0,,,,2,2,2,4
8917_0,,,,2,2,2,4
8918_0,,,,2,2,2,4
8919_0,,,,2,2,2,4
8920_0,,,,2,2,2,4
8921_0,,,,2,2,2,4
8922_0,,,,2,2,2,4
8923_0,,,,2,2,2,4
8924_0,,,,2,2,2,4
8925_0,,,,2,2,2,4
8926_0,,,,2,2,2,4
8927_0,,,,2,2,2,4
8928_0,,,,2,2,2,4
8929_0,,,,2,2,2,4
8930_0,,,,2,2,2,4
8931_0,,,,2,2,2,4
8932_0,,,,2,2,2,4
8933_0,,,,2,2,2,4
8934_0,,,,2,2,2,4
8935_0,,,,2,2,2,4
8936_0,,,,2,2,2,4
8937_0,,,,2,2,2,4
8938_0,,,,2,2,2,4
8940_0,,,,2,2,2,4
C(C(CO)O)(CC(CNC)N)=O,,,3,1,12,0,12
8941_0,,,,2,2,2,4
8942_0,,,,2,2,2,4
8943_0,,,,2,2,2,4
8944_0,,,,2,2,2,4
8945_0,,,,2,2,2,4
8946_0,,,,2,2,2,4
8947_0,,,,2,2,2,4
8948_0,,,,2,2,2,4
8949_0,,,,2,2,2,4
8950_0,,,,2,2,2,4
8952_0,,,,2,2,2,4
C(C(CC(C(CO)N)NC)O)=O,,,3,1,12,0,12
8953_0,,,,2,2,2,4
8954_0,,,,2,2,2,4
8955_0,,,,2,2,2,4
8956_0,,,,2,2,2,4
8957_0,,,,2,2,2,4
8958_0,,,,2,2,2,4
8959_0,,,,2,2,2,4
8960_0,,,,2,2,2,4
8962_0,,,,2,2,2,4
C(C(C(CNC)N)O)(CCO)=O,,,3,1,12,0,12
8963_0,,,,2,2,2,4
8964_0,,,,2,2,2,4
8965_0,,,,2,2,2,4
8966_0,,,,2,2,2,4
8967_0,,,,2,2,2,4
8968_0,,,,2,2,2,4
8969_0,,,,2,2,2,4
8970_0,,,,2,2,2,4
8971_0,,,,2,2,2,4
8972_0,,,,2,2,2,4
8974_0,,,,2,2,2,4
C(C(C(C(CCO)NC)N)O)=O,,,3,1,12,0,12
8975_0,,,,2,2,2,4
8976_0,,,,2,2,2,4
8977_0,,,,2,2,2,4
8978_0,,,,2,2,2,4
8979_0,,,,2,2,2,4
8980_0,,,,2,2,2,4
8981_0,,,,2,2,2,4
8982_0,,,,2,2,2,4
8984_0,,,,2,2,2,4
C(CO)(CC(C(CNC)N)O)=O,,,3,1,12,0,12
8985_0,,,,2,2,2,4
8986_0,,,,2,2,2,4
8987_0,,,,2,2,2,4
8988_0,,,,2,2,2,4
8989_0,,,,2,2,2,4
8990_0,,,,2,2,2,4
8991_0,,,,2,2,2,4
8992_0,,,,2,2,2,4
8993_0,,,,2,2,2,4
8994_0,,,,2,2,2,4
8996_0,,,,2,2,2,4
C(C(C(CC(CN)NC)O)O)=O,,,3,1,12,0,12
8997_0,,,,2,2,2,4
8998_0,,,,2,2,2,4
8999_0,,,,2,2,2,4
9000_0,,,,2,2,2,4
9001_0,,,,2,2,2,4
9002_0,,,,2,2,2,4
9003_0,,,,2,2,2,4
9004_0,,,,2,2,2,4
9006_0,,,,2,2,2,4
C(C)(C(C(C(CNC)N)O)O)=O,,,3,1,12,0,12
9007_0,,,,2,2,2,4
9008_0,,,,2,2,2,4
9009_0,,,,2,2,2,4
9010_0,,,,2,2,2,4
9011_0,,,,2,2,2,4
9012_0,,,,2,2,2,4
9013_0,,,,2,2,2,4
9014_0,,,,2,2,2,4
9015_0,,,,2,2,2,4
9016_0,,,,2,2,2,4
9018_0,,,,2,2,2,4
C(C(C(C(C(C)NC)N)O)O)=O,,,3,1,12,0,12
9019_0,,,,2,2,2,4
9020_0,,,,2,2,2,4
9021_0,,,,2,2,2,4
9022_0,,,,2,2,2,4
9023_0,,,,2,2,2,4
9024_0,,,,2,2,2,4
9025_0,,,,2,2,2,4
9026_0,,,,2,2,2,4
9028_0,,,,2,2,2,4
C(CC(C(C(CNC)N)O)O)=O,,,3,1,12,0,12
9029_0,,,,2,2,2,4
9030_0,,,,2,2,2,4
9031_0,,,,2,2,2,4
9032_0,,,,2,2,2,4
9033_0,,,,2,2,2,4
9034_0,,,,2,2,2,4
9035_0,,,,2,2,2,4
9036_0,,,,2,2,2,4
9037_0,,,,2,2,2,4
9038_0,,,,2,2,2,4
9039_0,,,,2,2,2,4
9040_0,,,,2,2,2,4
9041_0,,,,2,2,2,4
9042_0,,,,2,2,2,4
9043_0,,,,2,2,2,4
9044_0,,,,2,2,2,4
9045_0,,,,2,2,2,4
9046_0,,,,2,2,2,4
9047_0,,,,2,2,2,4
9049_0,,,,2,2,2,4
C(CNCCN)(O)=O,,,3,1,12,0,12
9050_0,,,,2,2,2,4
9051_0,,,,2,2,2,4
9052_0,,,,2,2,2,4
9053_0,,,,2,2,2,4
9055_0,,,,2,2,2,4
C(CNCC(C(CO)O)N)(O)=O,,,3,1,12,0,12
9056_0,,,,2,2,2,4
9057_0,,,,2,2,2,4
9058_0,,,,2,2,2,4
9059_0,,,,2,2,2,4
9061_0,,,,2,2,2,4
CNCC(C(C(C(CO)O)O)O)N,,,3,1,12,0,12
9062_0,,,,2,2,2,4
9063_0,,,,2,2,2,4
9064_0,,,,2,2,2,4
9065_0,,,,2,2,2,4
9066_0,,,,2,2,2,4
9067_0,,,,2,2,2,4
9068_0,,,,2,2,2,4
9069_0,,,,2,2,2,4
9070_0,,,,2,2,2,4
9071_0,,,,2,2,2,4
9072_0,,,,2,2,2,4
9073_0,,,,2,2,2,4
9074_0,,,,2,2,2,4
9075_0,,,,2,2,2,4
9076_0,,,,2,2,2,4
9077_0,,,,2,2,2,4
9078_0,,,,2,2,2,4
9079_0,,,,2,2,2,4
9080_0,,,,2,2,2,4
9081_0,,,,2,2,2,4
9082_0,,,,2,2,2,4
9083_0,,,,2,2,2,4
9084_0,,,,2,2,2,4
9085_0,,,,2,2,2,4
9086_0,,,,2,2,2,4
9087_0,,,,2,2,2,4
9088_0,,,,2,2,2,4
9089_0,,,,2,2,2,4
9090_0,,,,2,2,2,4
9091_0,,,,2,2,2,4
9092_0,,,,2,2,2,4
9093_0,,,,2,2,2,4
9094_0,,,,2,2,2,4
9095_0,,,,2,2,2,4
9096_0,,,,2,2,2,4
9097_0,,,,2,2,2,4
9098_0,,,,2,2,2,4
9099_0,,,,2,2,2,4
9100_0,,,,2,2,2,4
9101_0,,,,2,2,2,4
9102_0,,,,2,2,2,4
9103_0,,,,2,2,2,4
9104_0,,,,2,2,2,4
9105_0,,,,2,2,2,4
9106_0,,,,2,2,2,4
9107_0,,,,2,2,2,4
9108_0,,,,2,2,2,4
9109_0,,,,2,2,2,4
9110_0,,,,2,2,2,4
9111_0,,,,2,2,2,4
9112_0,,,,2,2,2,4
9113_0,,,,2,2,2,4
9114_0,,,,2,2,2,4
9115_0,,,,2,2,2,4
9116_0,,,,2,2,2,4
9117_0,,,,2,2,2,4
9118_0,,,,2,2,2,4
9119_0,,,,2,2,2,4
9120_0,,,,2,2,2,4
9121_0,,,,2,2,2,4
9122_0,,,,2,2,2,4
9123_0,,,,2,2,2,4
9124_0,,,,2,2,2,4
9125_0,,,,2,2,2,4
9126_0,,,,2,2,2,4
9127_0,,,,2,2,2,4
9128_0,,,,2,2,2,4
9129_0,,,,2,2,2,4
9130_0,,,,2,2,2,4
9131_0,,,,2,2,2,4
9132_0,,,,2,2,2,4
9133_0,,,,2,2,2,4
9134_0,,,,2,2,2,4
9135_0,,,,2,2,2,4
9137_0,,,,2,2,2,4
C(C1(C(C(CC1N)O)O)O)O,,,3,1,12,0,12
9138_0,,,,2,2,2,4
9139_0,,,,2,2,2,4
9140_0,,,,2,2,2,4
9141_0,,,,2,2,2,4
9143_0,,,,2,2,2,4
C(C1(C(C(CC1O)O)O)O)N,,,3,1,12,0,12
9144_0,,,,2,2,2,4
9145_0,,,,2,2,2,4
9146_0,,,,2,2,2,4
9147_0,,,,2,2,2,4
9149_0,,,,2,2,2,4
C(C(C(CN)(C(CO)O)O)O)O,,,3,1,12,0,12
9150_0,,,,2,2,2,4
9151_0,,,,2,2,2,4
9152_0,,,,2,2,2,4
9153_0,,,,2,2,2,4
9155_0,,,,2,2,2,4
C(C(CN)(C(CO)O)O)(O)=O,,,3,1,12,0,12
9156_0,,,,2,2,2,4
9157_0,,,,2,2,2,4
9158_0,,,,2,2,2,4
9159_0,,,,2,2,2,4
9161_0,,,,2,2,2,4
C(C(C(CN)(C(CO)O)O)O)(O)=O,,,3,1,12,0,12
9162_0,,,,2,2,2,4
9163_0,,,,2,2,2,4
9164_0,,,,2,2,2,4
9165_0,,,,2,2,2,4
9167_0,,,,2,2,2,4
C(C(CN)(C(CO)O)O)O,,,3,1,12,0,12
9168_0,,,,2,2,2,4
9169_0,,,,2,2,2,4
9170_0,,,,2,2,2,4
9171_0,,,,2,2,2,4
9172_0,,,,2,2,2,4
9174_0,,,,2,2,2,4
C(CC(C(CO)(C(CO)O)O)N)=O,,,3,1,12,0,12
9175_0,,,,2,2,2,4
9176_0,,,,2,2,2,4
9177_0,,,,2,2,2,4
9178_0,,,,2,2,2,4
9179_0,,,,2,2,2,4
9180_0,,,,2,2,2,4
9181_0,,,,2,2,2,4
9182_0,,,,2,2,2,4
9183_0,,,,2,2,2,4
9184_0,,,,2,2,2,4
9185_0,,,,2,2,2,4
9186_0,,,,2,2,2,4
9187_0,,,,2,2,2,4
9188_0,,,,2,2,2,4
9189_0,,,,2,2,2,4
9190_0,,,,2,2,2,4
9191_0,,,,2,2,2,4
9192_0,,,,2,2,2,4
9193_0,,,,2,2,2,4
9195_0,,,,2,2,2,4
C(C(CC(C(CO)(CO)O)N)O)=O,,,3,1,12,0,12
9196_0,,,,2,2,2,4
9197_0,,,,2,2,2,4
9198_0,,,,2,2,2,4
9199_0,,,,2,2,2,4
9200_0,,,,2,2,2,4
9201_0,,,,2,2,2,4
9202_0,,,,2,2,2,4
9203_0,,,,2,2,2,4
9205_0,,,,2,2,2,4
C(C(C(CO)(CN)O)O)(CCO)=O,,,3,1,12,0,12
9206_0,,,,2,2,2,4
9207_0,,,,2,2,2,4
9208_0,,,,2,2,2,4
9209_0,,,,2,2,2,4
9210_0,,,,2,2,2,4
9211_0,,,,2,2,2,4
9212_0,,,,2,2,2,4
9213_0,,,,2,2,2,4
9214_0,,,,2,2,2,4
9215_0,,,,2,2,2,4
9217_0,,,,2,2,2,4
C(C(C(CO)(C(CCO)N)O)O)=O,,,3,1,12,0,12
9218_0,,,,2,2,2,4
9219_0,,,,2,2,2,4
9220_0,,,,2,2,2,4
9221_0,,,,2,2,2,4
9222_0,,,,2,2,2,4
9223_0,,,,2,2,2,4
9224_0,,,,2,2,2,4
9225_0,,,,2,2,2,4
9227_0,,,,2,2,2,4
C(CO)(CC(C(CO)(CN)O)O)=O,,,3,1,12,0,12
9228_0,,,,2,2,2,4
9229_0,,,,2,2,2,4
9230_0,,,,2,2,2,4
9231_0,,,,2,2,2,4
9232_0,,,,2,2,2,4
9233_0,,,,2,2,2,4
9234_0,,,,2,2,2,4
9235_0,,,,2,2,2,4
9236_0,,,,2,2,2,4
9238_0,,,,2,2,2,4
C(C)(C(C(C(CO)(CN)O)O)O)=O,,,3,1,12,0,12
9239_0,,,,2,2,2,4
9240_0,,,,2,2,2,4
9241_0,,,,2,2,2,4
9242_0,,,,2,2,2,4
9243_0,,,,2,2,2,4
9244_0,,,,2,2,2,4
9245_0,,,,2,2,2,4
9246_0,,,,2,2,2,4
9247_0,,,,2,2,2,4
9248_0,,,,2,2,2,4
9250_0,,,,2,2,2,4
C(C(C(C(CO)(C(C)N)O)O)O)=O,,,3,1,12,0,12
9251_0,,,,2,2,2,4
9252_0,,,,2,2,2,4
9253_0,,,,2,2,2,4
9254_0,,,,2,2,2,4
9255_0,,,,2,2,2,4
9256_0,,,,2,2,2,4
9257_0,,,,2,2,2,4
9258_0,,,,2,2,2,4
9260_0,,,,2,2,2,4
C(CC(C(C(CO)(CN)O)O)O)=O,,,3,1,12,0,12
9261_0,,,,2,2,2,4
9262_0,,,,2,2,2,4
9263_0,,,,2,2,2,4
9264_0,,,,2,2,2,4
9265_0,,,,2,2,2,4
9266_0,,,,2,2,2,4
9267_0,,,,2,2,2,4
9268_0,,,,2,2,2,4
9269_0,,,,2,2,2,4
9271_0,,,,2,2,2,4
C(C(CO)O)(CC(CO)(CN)O)=O,,,3,1,12,0,12
9272_0,,,,2,2,2,4
9273_0,,,,2,2,2,4
9274_0,,,,2,2,2,4
9275_0,,,,2,2,2,4
9276_0,,,,2,2,2,4
9277_0,,,,2,2,2,4
9278_0,,,,2,2,2,4
9279_0,,,,2,2,2,4
9280_0,,,,2,2,2,4
9282_0,,,,2,2,2,4
CNC(C(C(CO)O)O)C(CO)N,,,3,1,12,0,12
9283_0,,,,2,2,2,4
9285_0,,,,2,2,2,4
C(CC(C(C(CO)O)NC)N)=O,,,3,1,12,0,12
9286_0,,,,2,2,2,4
9288_0,,,,2,2,2,4
C(C(C(CC(CO)O)N)NC)=O,,,3,1,12,0,12
9289_0,,,,2,2,2,4
9291_0,,,,2,2,2,4
C(C(CC(C(CO)NC)N)O)=O,,,3,1,12,0,12
9292_0,,,,2,2,2,4
9293_0,,,,2,2,2,4
9294_0,,,,2,2,2,4
9296_0,,,,2,2,2,4
C(C(C(C(C(C)N)NC)O)O)=O,,,3,1,12,0,12
9297_0,,,,2,2,2,4
9298_0,,,,2,2,2,4
9300_0,,,,2,2,2,4
C(C(C(CC(CN)N)O)O)O,,,3,1,24,0,24
9301_0,,,,2,2,2,4
9302_0,,,,2,2,2,4
9303_0,,,,2,2,2,4
9304_0,,,,2,2,2,4
9305_0,,,,2,2,2,4
9306_0,,,,2,2,2,4
9307_0,,,,2,2,2,4
9308_0,,,,2,2,2,4
9309_0,,,,2,2,2,4
9310_0,,,,2,2,2,4
9311_0,,,,2,2,2,4
9312_0,,,,2,2,2,4
9313_0,,,,2,2,2,4
9314_0,,,,2,2,2,4
9315_0,,,,2,2,2,4
9316_0,,,,2,2,2,4
9317_0,,,,2,2,2,4
9318_0,,,,2,2,2,4
9319_0,,,,2,2,2,4
9320_0,,,,2,2,2,4
9321_0,,,,2,2,2,4
9322_0,,,,2,2,2,4
9323_0,,,,2,2,2,4
9324_0,,,,2,2,2,4
9325_0,,,,2,2,2,4
9326_0,,,,2,2,2,4
9327_0,,,,2,2,2,4
9328_0,,,,2,2,2,4
9329_0,,,,2,2,2,4
9330_0,,,,2,2,2,4
9331_0,,,,2,2,2,4
9332_0,,,,2,2,2,4
9333_0,,,,2,2,2,4
9334_0,,,,2,2,2,4
9335_0,,,,2,2,2,4
9336_0,,,,2,2,2,4
9337_0,,,,2,2,2,4
9338_0,,,,2,2,2,4
9339_0,,,,2,2,2,4
9341_0,,,,2,2,2,4
C1C(C(C(C(CO)O)O1)O)N,,,3,1,12,0,12
9342_0,,,,2,2,2,4
9343_0,,,,2,2,2,4
9344_0,,,,2,2,2,4
9345_0,,,,2,2,2,4
9347_0,,,,2,2,2,4
C1C(C(C(C(CO)O1)O)O)N,,,3,1,12,0,12
9348_0,,,,2,2,2,4
9349_0,,,,2,2,2,4
9350_0,,,,2,2,2,4
9351_0,,,,2,2,2,4
9353_0,,,,2,2,2,4
C1C(C(C(C(CO1)N)O)O)O,,,3,1,12,0,12
9354_0,,,,2,2,2,4
9355_0,,,,2,2,2,4
9356_0,,,,2,2,2,4
9357_0,,,,2,2,2,4
9358_0,,,,2,2,2,4
9359_0,,,,2,2,2,4
9361_0,,,,2,2,2,4
C(C(C(C(CCN)N)O)O)O,,,3,1,24,0,24
9363_0,,,,2,2,2,4
C(C(CC(C(CN)O)N)O)O,,,3,1,24,0,24
9365_0,,,,2,2,2,4
C(C(C(CC(CN)O)N)O)O,,,3,1,24,0,24
9367_0,,,,2,2,2,4
C(CC(C(C(CN)O)O)N)O,,,3,1,24,0,24
9369_0,,,,2,2,2,4
C(C(CC(C(CN)O)O)N)O,,,3,1,24,0,24
9371_0,,,,2,2,2,4
CC(C(C(C(CN)O)O)O)N,,,3,1,24,0,24
9373_0,,,,2,2,2,4
C(C(C(C(CCN)O)O)O)N,,,3,1,24,0,24
9375_0,,,,2,2,2,4
C(C(CC(CCO)N)O)(O)=O,,,3,1,13,0,13
9377_0,,,,2,2,2,4
C(C(CCC(CO)N)O)(O)=O,,,3,1,13,0,13
9379_0,,,,2,2,2,4
C(C(CC(C(C)N)O)O)(O)=O,,,3,1,13,0,13
9381_0,,,,2,2,2,4
C(C(CC(CCN)O)O)(O)=O,,,3,1,13,0,13
9382_0,,,,2,2,2,4
9383_0,,,,2,2,2,4
9384_0,,,,2,2,2,4
9385_0,,,,2,2,2,4
9386_0,,,,2,2,2,4
9387_0,,,,2,2,2,4
9388_0,,,,2,2,2,4
9389_0,,,,2,2,2,4
9391_0,,,,2,2,2,4
C(C(C(C(CCO)N)O)=O)=O,,,3,1,13,0,13
9392_0,,,,2,2,2,4
9393_0,,,,2,2,2,4
9395_0,,,,2,2,2,4
C(C(C(CC(CO)N)O)=O)=O,,,3,1,13,0,13
9396_0,,,,2,2,2,4
9397_0,,,,2,2,2,4
9399_0,,,,2,2,2,4
C(C(C(C(C(C)N)O)O)=O)=O,,,3,1,13,0,13
9400_0,,,,2,2,2,4
9401_0,,,,2,2,2,4
9403_0,,,,2,2,2,4
C(C(C(C(CCN)O)O)=O)=O,,,3,1,13,0,13
9404_0,,,,2,2,2,4
9405_0,,,,2,2,2,4
9406_0,,,,2,2,2,4
9407_0,,,,2,2,2,4
9408_0,,,,2,2,2,4
9409_0,,,,2,2,2,4
9410_0,,,,2,2,2,4
9411_0,,,,2,2,2,4
9412_0,,,,2,2,2,4
9413_0,,,,2,2,2,4
9414_0,,,,2,2,2,4
9415_0,,,,2,2,2,4
9417_0,,,,2,2,2,4
CNC(CO)C(CN)O,,,3,1,12,0,12
9419_0,,,,2,2,2,4
CNC(C(C(CO)N)O)C(CO)O,,,3,1,12,0,12
9420_0,,,,2,2,2,4
9421_0,,,,2,2,2,4
9422_0,,,,2,2,2,4
9424_0,,,,2,2,2,4
C(CC(C(C(CO)NC)O)N)=O,,,3,1,12,0,12
9425_0,,,,2,2,2,4
9427_0,,,,2,2,2,4
C(C(C(CC(CO)NC)N)O)=O,,,3,1,12,0,12
9428_0,,,,2,2,2,4
9430_0,,,,2,2,2,4
C(C(CC(C(CO)O)N)NC)=O,,,3,1,12,0,12
9431_0,,,,2,2,2,4
9433_0,,,,2,2,2,4
C(C(CC(C(CNC)O)N)O)=O,,,3,1,12,0,12
9434_0,,,,2,2,2,4
9436_0,,,,2,2,2,4
C(C(C(C(CCO)N)O)NC)=O,,,3,1,12,0,12
9437_0,,,,2,2,2,4
9439_0,,,,2,2,2,4
C(C(C(C(CCNC)N)O)O)=O,,,3,1,12,0,12
9440_0,,,,2,2,2,4
9441_0,,,,2,2,2,4
9442_0,,,,2,2,2,4
9443_0,,,,2,2,2,4
9445_0,,,,2,2,2,4
C(CC(C(C(CN)O)NC)O)=O,,,3,1,12,0,12
9446_0,,,,2,2,2,4
9447_0,,,,2,2,2,4
9449_0,,,,2,2,2,4
C(C(C(C(CCN)NC)O)O)=O,,,3,1,12,0,12
9450_0,,,,2,2,2,4
9451_0,,,,2,2,2,4
9453_0,,,,2,2,2,4
C(CNC(CO)C(CN)O)(O)=O,,,3,1,12,0,12
9455_0,,,,2,2,2,4
CNC(C(C(CO)O)O)C(CN)O,,,3,1,12,0,12
9456_0,,,,2,2,2,4
9457_0,,,,2,2,2,4
9458_0,,,,2,2,2,4
9459_0,,,,2,2,2,4
9460_0,,,,2,2,2,4
9461_0,,,,2,2,2,4
9462_0,,,,2,2,2,4
9463_0,,,,2,2,2,4
9464_0,,,,2,2,2,4
9465_0,,,,2,2,2,4
9466_0,,,,2,2,2,4
9467_0,,,,2,2,2,4
9468_0,,,,2,2,2,4
9469_0,,,,2,2,2,4
9470_0,,,,2,2,2,4
9471_0,,,,2,2,2,4
9472_0,,,,2,2,2,4
9473_0,,,,2,2,2,4
9474_0,,,,2,2,2,4
9475_0,,,,2,2,2,4
9476_0,,,,2,2,2,4
9477_0,,,,2,2,2,4
9479_0,,,,2,2,2,4
C(C(C(CC(CN)O)O)O)O,,,3,1,12,0,12
9481_0,,,,2,2,2,4
C(CN)(O)O,,,3,1,12,0,12
9482_0,,,,2,2,2,4
9483_0,,,,2,2,2,4
9484_0,,,,2,2,2,4
9485_0,,,,2,2,2,4
9486_0,,,,2,2,2,4
9487_0,,,,2,2,2,4
9488_0,,,,2,2,2,4
9489_0,,,,2,2,2,4
9490_0,,,,2,2,2,4
9491_0,,,,2,2,2,4
9492_0,,,,2,2,2,4
9493_0,,,,2,2,2,4
9494_0,,,,2,2,2,4
9495_0,,,,2,2,2,4
9496_0,,,,2,2,2,4
9497_0,,,,2,2,2,4
9498_0,,,,2,2,2,4
9499_0,,,,2,2,2,4
9500_0,,,,2,2,2,4
9501_0,,,,2,2,2,4
9502_0,,,,2,2,2,4
9503_0,,,,2,2,2,4
9504_0,,,,2,2,2,4
9505_0,,,,2,2,2,4
9506_0,,,,2,2,2,4
9507_0,,,,2,2,2,4
9508_0,,,,2,2,2,4
9509_0,,,,2,2,2,4
9510_0,,,,2,2,2,4
9511_0,,,,2,2,2,4
9512_0,,,,2,2,2,4
9513_0,,,,2,2,2,4
9514_0,,,,2,2,2,4
9515_0,,,,2,2,2,4
9516_0,,,,2,2,2,4
9517_0,,,,2,2,2,4
9518_0,,,,2,2,2,4
9519_0,,,,2,2,2,4
9520_0,,,,2,2,2,4
9521_0,,,,2,2,2,4
9522_0,,,,2,2,2,4
9523_0,,,,2,2,2,4
9524_0,,,,2,2,2,4
9525_0,,,,2,2,2,4
9526_0,,,,2,2,2,4
9527_0,,,,2,2,2,4
9528_0,,,,2,2,2,4
9529_0,,,,2,2,2,4
9530_0,,,,2,2,2,4
9531_0,,,,2,2,2,4
9532_0,,,,2,2,2,4
9533_0,,,,2,2,2,4
9534_0,,,,2,2,2,4
9535_0,,,,2,2,2,4
9536_0,,,,2,2,2,4
9537_0,,,,2,2,2,4
9538_0,,,,2,2,2,4
9539_0,,,,2,2,2,4
9540_0,,,,2,2,2,4
9541_0,,,,2,2,2,4
9542_0,,,,2,2,2,4
9543_0,,,,2,2,2,4
9544_0,,,,2,2,2,4
9545_0,,,,2,2,2,4
9546_0,,,,2,2,2,4
9547_0,,,,2,2,2,4
9548_0,,,,2,2,2,4
9549_0,,,,2,2,2,4
9550_0,,,,2,2,2,4
9551_0,,,,2,2,2,4
9552_0,,,,2,2,2,4
9553_0,,,,2,2,2,4
9554_0,,,,2,2,2,4
9555_0,,,,2,2,2,4
9556_0,,,,2,2,2,4
9557_0,,,,2,2,2,4
9558_0,,,,2,2,2,4
9559_0,,,,2,2,2,4
9560_0,,,,2,2,2,4
9561_0,,,,2,2,2,4
9562_0,,,,2,2,2,4
9563_0,,,,2,2,2,4
9564_0,,,,2,2,2,4
9565_0,,,,2,2,2,4
9566_0,,,,2,2,2,4
9567_0,,,,2,2,2,4
9568_0,,,,2,2,2,4
9569_0,,,,2,2,2,4
9570_0,,,,2,2,2,4
9571_0,,,,2,2,2,4
9572_0,,,,2,2,2,4
9573_0,,,,2,2,2,4
9574_0,,,,2,2,2,4
9575_0,,,,2,2,2,4
9576_0,,,,2,2,2,4
9577_0,,,,2,2,2,4
9578_0,,,,2,2,2,4
9579_0,,,,2,2,2,4
9580_0,,,,2,2,2,4
9581_0,,,,2,2,2,4
9582_0,,,,2,2,2,4
9583_0,,,,2,2,2,4
9584_0,,,,2,2,2,4
9585_0,,,,2,2,2,4
9586_0,,,,2,2,2,4
9587_0,,,,2,2,2,4
9588_0,,,,2,2,2,4
9589_0,,,,2,2,2,4
9590_0,,,,2,2,2,4
9591_0,,,,2,2,2,4
9592_0,,,,2,2,2,4
9593_0,,,,2,2,2,4
9594_0,,,,2,2,2,4
9595_0,,,,2,2,2,4
9596_0,,,,2,2,2,4
9597_0,,,,2,2,2,4
9598_0,,,,2,2,2,4
9599_0,,,,2,2,2,4
9600_0,,,,2,2,2,4
9601_0,,,,2,2,2,4
9602_0,,,,2,2,2,4
9603_0,,,,2,2,2,4
9604_0,,,,2,2,2,4
9605_0,,,,2,2,2,4
9606_0,,,,2,2,2,4
9607_0,,,,2,2,2,4
9608_0,,,,2,2,2,4
9609_0,,,,2,2,2,4
9610_0,,,,2,2,2,4
9611_0,,,,2,2,2,4
9612_0,,,,2,2,2,4
9613_0,,,,2,2,2,4
9614_0,,,,2,2,2,4
9615_0,,,,2,2,2,4
9616_0,,,,2,2,2,4
9617_0,,,,2,2,2,4
9618_0,,,,2,2,2,4
9619_0,,,,2,2,2,4
9620_0,,,,2,2,2,4
9621_0,,,,2,2,2,4
9622_0,,,,2,2,2,4
9623_0,,,,2,2,2,4
9624_0,,,,2,2,2,4
9625_0,,,,2,2,2,4
9626_0,,,,2,2,2,4
9627_0,,,,2,2,2,4
9628_0,,,,2,2,2,4
9629_0,,,,2,2,2,4
9630_0,,,,2,2,2,4
9631_0,,,,2,2,2,4
9632_0,,,,2,2,2,4
9633_0,,,,2,2,2,4
9634_0,,,,2,2,2,4
9635_0,,,,2,2,2,4
9636_0,,,,2,2,2,4
9637_0,,,,2,2,2,4
9638_0,,,,2,2,2,4
9639_0,,,,2,2,2,4
9640_0,,,,2,2,2,4
9641_0,,,,2,2,2,4
9642_0,,,,2,2,2,4
9643_0,,,,2,2,2,4
9644_0,,,,2,2,2,4
9645_0,,,,2,2,2,4
9646_0,,,,2,2,2,4
9647_0,,,,2,2,2,4
9648_0,,,,2,2,2,4
9649_0,,,,2,2,2,4
9650_0,,,,2,2,2,4
9651_0,,,,2,2,2,4
9652_0,,,,2,2,2,4
9653_0,,,,2,2,2,4
9654_0,,,,2,2,2,4
9655_0,,,,2,2,2,4
9656_0,,,,2,2,2,4
9657_0,,,,2,2,2,4
9658_0,,,,2,2,2,4
9659_0,,,,2,2,2,4
9660_0,,,,2,2,2,4
9661_0,,,,2,2,2,4
9662_0,,,,2,2,2,4
9663_0,,,,2,2,2,4
9664_0,,,,2,2,2,4
9665_0,,,,2,2,2,4
9666_0,,,,2,2,2,4
9667_0,,,,2,2,2,4
9668_0,,,,2,2,2,4
9669_0,,,,2,2,2,4
9670_0,,,,2,2,2,4
9671_0,,,,2,2,2,4
9672_0,,,,2,2,2,4
9673_0,,,,2,2,2,4
9674_0,,,,2,2,2,4
9675_0,,,,2,2,2,4
9676_0,,,,2,2,2,4
9677_0,,,,2,2,2,4
9678_0,,,,2,2,2,4
9679_0,,,,2,2,2,4
9680_0,,,,2,2,2,4
9681_0,,,,2,2,2,4
9682_0,,,,2,2,2,4
9683_0,,,,2,2,2,4
9684_0,,,,2,2,2,4
9685_0,,,,2,2,2,4
9686_0,,,,2,2,2,4
9687_0,,,,2,2,2,4
9688_0,,,,2,2,2,4
9689_0,,,,2,2,2,4
9690_0,,,,2,2,2,4
9691_0,,,,2,2,2,4
9692_0,,,,2,2,2,4
9693_0,,,,2,2,2,4
9694_0,,,,2,2,2,4
9695_0,,,,2,2,2,4
9696_0,,,,2,2,2,4
9697_0,,,,2,2,2,4
9698_0,,,,2,2,2,4
9699_0,,,,2,2,2,4
9700_0,,,,2,2,2,4
9701_0,,,,2,2,2,4
9702_0,,,,2,2,2,4
9703_0,,,,2,2,2,4
9704_0,,,,2,2,2,4
9705_0,,,,2,2,2,4
9706_0,,,,2,2,2,4
9707_0,,,,2,2,2,4
9708_0,,,,2,2,2,4
9709_0,,,,2,2,2,4
9710_0,,,,2,2,2,4
9711_0,,,,2,2,2,4
9712_0,,,,2,2,2,4
9713_0,,,,2,2,2,4
9714_0,,,,2,2,2,4
9715_0,,,,2,2,2,4
9716_0,,,,2,2,2,4
9717_0,,,,2,2,2,4
9718_0,,,,2,2,2,4
9719_0,,,,2,2,2,4
9720_0,,,,2,2,2,4
9721_0,,,,2,2,2,4
9722_0,,,,2,2,2,4
9723_0,,,,2,2,2,4
9724_0,,,,2,2,2,4
9725_0,,,,2,2,2,4
9726_0,,,,2,2,2,4
9727_0,,,,2,2,2,4
9728_0,,,,2,2,2,4
9729_0,,,,2,2,2,4
9730_0,,,,2,2,2,4
9731_0,,,,2,2,2,4
9732_0,,,,2,2,2,4
9733_0,,,,2,2,2,4
9734_0,,,,2,2,2,4
9735_0,,,,2,2,2,4
9736_0,,,,2,2,2,4
9737_0,,,,2,2,2,4
9738_0,,,,2,2,2,4
9739_0,,,,2,2,2,4
9740_0,,,,2,2,2,4
9741_0,,,,2,2,2,4
9742_0,,,,2,2,2,4
9743_0,,,,2,2,2,4
9744_0,,,,2,2,2,4
9745_0,,,,2,2,2,4
9746_0,,,,2,2,2,4
9747_0,,,,2,2,2,4
9748_0,,,,2,2,2,4
9749_0,,,,2,2,2,4
9750_0,,,,2,2,2,4
9751_0,,,,2,2,2,4
9752_0,,,,2,2,2,4
9753_0,,,,2,2,2,4
9754_0,,,,2,2,2,4
9755_0,,,,2,2,2,4
9756_0,,,,2,2,2,4
9757_0,,,,2,2,2,4
9758_0,,,,2,2,2,4
9759_0,,,,2,2,2,4
9760_0,,,,2,2,2,4
9761_0,,,,2,2,2,4
9762_0,,,,2,2,2,4
9763_0,,,,2,2,2,4
9764_0,,,,2,2,2,4
9765_0,,,,2,2,2,4
9766_0,,,,2,2,2,4
9767_0,,,,2,2,2,4
9768_0,,,,2,2,2,4
9769_0,,,,2,2,2,4
9770_0,,,,2,2,2,4
9771_0,,,,2,2,2,4
9772_0,,,,2,2,2,4
9773_0,,,,2,2,2,4
9774_0,,,,2,2,2,4
9775_0,,,,2,2,2,4
9776_0,,,,2,2,2,4
9777_0,,,,2,2,2,4
9778_0,,,,2,2,2,4
9779_0,,,,2,2,2,4
9780_0,,,,2,2,2,4
9781_0,,,,2,2,2,4
9782_0,,,,2,2,2,4
9783_0,,,,2,2,2,4
9784_0,,,,2,2,2,4
9785_0,,,,2,2,2,4
9786_0,,,,2,2,2,4
9787_0,,,,2,2,2,4
9788_0,,,,2,2,2,4
9789_0,,,,2,2,2,4
9790_0,,,,2,2,2,4
9791_0,,,,2,2,2,4
9792_0,,,,2,2,2,4
9793_0,,,,2,2,2,4
9794_0,,,,2,2,2,4
9795_0,,,,2,2,2,4
9796_0,,,,2,2,2,4
9797_0,,,,2,2,2,4
9798_0,,,,2,2,2,4
9799_0,,,,2,2,2,4
9800_0,,,,2,2,2,4
9801_0,,,,2,2,2,4
9802_0,,,,2,2,2,4
9803_0,,,,2,2,2,4
9804_0,,,,2,2,2,4
9805_0,,,,2,2,2,4
9806_0,,,,2,2,2,4
9807_0,,,,2,2,2,4
9808_0,,,,2,2,2,4
9809_0,,,,2,2,2,4
9810_0,,,,2,2,2,4
9811_0,,,,2,2,2,4
9812_0,,,,2,2,2,4
9813_0,,,,2,2,2,4
9814_0,,,,2,2,2,4
9815_0,,,,2,2,2,4
9816_0,,,,2,2,2,4
9817_0,,,,2,2,2,4
9818_0,,,,2,2,2,4
9819_0,,,,2,2,2,4
9820_0,,,,2,2,2,4
9821_0,,,,2,2,2,4
9822_0,,,,2,2,2,4
9823_0,,,,2,2,2,4
9824_0,,,,2,2,2,4
9825_0,,,,2,2,2,4
9826_0,,,,2,2,2,4
9827_0,,,,2,2,2,4
9828_0,,,,2,2,2,4
9829_0,,,,2,2,2,4
9830_0,,,,2,2,2,4
9831_0,,,,2,2,2,4
9832_0,,,,2,2,2,4
9833_0,,,,2,2,2,4
9834_0,,,,2,2,2,4
9835_0,,,,2,2,2,4
9836_0,,,,2,2,2,4
9837_0,,,,2,2,2,4
9838_0,,,,2,2,2,4
9839_0,,,,2,2,2,4
9840_0,,,,2,2,2,4
9841_0,,,,2,2,2,4
9842_0,,,,2,2,2,4
9843_0,,,,2,2,2,4
9844_0,,,,2,2,2,4
9845_0,,,,2,2,2,4
9846_0,,,,2,2,2,4
9847_0,,,,2,2,2,4
9848_0,,,,2,2,2,4
9849_0,,,,2,2,2,4
9850_0,,,,2,2,2,4
9851_0,,,,2,2,2,4
9852_0,,,,2,2,2,4
9853_0,,,,2,2,2,4
9854_0,,,,2,2,2,4
9855_0,,,,2,2,2,4
9856_0,,,,2,2,2,4
9857_0,,,,2,2,2,4
9858_0,,,,2,2,2,4
9859_0,,,,2,2,2,4
9860_0,,,,2,2,2,4
9861_0,,,,2,2,2,4
9862_0,,,,2,2,2,4
9863_0,,,,2,2,2,4
9864_0,,,,2,2,2,4
9865_0,,,,2,2,2,4
9866_0,,,,2,2,2,4
9867_0,,,,2,2,2,4
9868_0,,,,2,2,2,4
9869_0,,,,2,2,2,4
9870_0,,,,2,2,2,4
9871_0,,,,2,2,2,4
9872_0,,,,2,2,2,4
9873_0,,,,2,2,2,4
9874_0,,,,2,2,2,4
9875_0,,,,2,2,2,4
9876_0,,,,2,2,2,4
9877_0,,,,2,2,2,4
9878_0,,,,2,2,2,4
9879_0,,,,2,2,2,4
9880_0,,,,2,2,2,4
9881_0,,,,2,2,2,4
9882_0,,,,2,2,2,4
9883_0,,,,2,2,2,4
9884_0,,,,2,2,2,4
9885_0,,,,2,2,2,4
9886_0,,,,2,2,2,4
9887_0,,,,2,2,2,4
9888_0,,,,2,2,2,4
9889_0,,,,2,2,2,4
9890_0,,,,2,2,2,4
9891_0,,,,2,2,2,4
9892_0,,,,2,2,2,4
9893_0,,,,2,2,2,4
9894_0,,,,2,2,2,4
9895_0,,,,2,2,2,4
9896_0,,,,2,2,2,4
9897_0,,,,2,2,2,4
9898_0,,,,2,2,2,4
9899_0,,,,2,2,2,4
9900_0,,,,2,2,2,4
9901_0,,,,2,2,2,4
9902_0,,,,2,2,2,4
9903_0,,,,2,2,2,4
9904_0,,,,2,2,2,4
9905_0,,,,2,2,2,4
9906_0,,,,2,2,2,4
9907_0,,,,2,2,2,4
9908_0,,,,2,2,2,4
9909_0,,,,2,2,2,4
9910_0,,,,2,2,2,4
9911_0,,,,2,2,2,4
9912_0,,,,2,2,2,4
9913_0,,,,2,2,2,4
9914_0,,,,2,2,2,4
9915_0,,,,2,2,2,4
9916_0,,,,2,2,2,4
9917_0,,,,2,2,2,4
9918_0,,,,2,2,2,4
9919_0,,,,2,2,2,4
9920_0,,,,2,2,2,4
9921_0,,,,2,2,2,4
9922_0,,,,2,2,2,4
9923_0,,,,2,2,2,4
9924_0,,,,2,2,2,4
9925_0,,,,2,2,2,4
9926_0,,,,2,2,2,4
9927_0,,,,2,2,2,4
9928_0,,,,2,2,2,4
9929_0,,,,2,2,2,4
9930_0,,,,2,2,2,4
9931_0,,,,2,2,2,4
9932_0,,,,2,2,2,4
9933_0,,,,2,2,2,4
9934_0,,,,2,2,2,4
9935_0,,,,2,2,2,4
9936_0,,,,2,2,2,4
9937_0,,,,2,2,2,4
9938_0,,,,2,2,2,4
9939_0,,,,2,2,2,4
9940_0,,,,2,2,2,4
9941_0,,,,2,2,2,4
9942_0,,,,2,2,2,4
9943_0,,,,2,2,2,4
9944_0,,,,2,2,2,4
9945_0,,,,2,2,2,4
9946_0,,,,2,2,2,4
9947_0,,,,2,2,2,4
9948_0,,,,2,2,2,4
9949_0,,,,2,2,2,4
9950_0,,,,2,2,2,4
9951_0,,,,2,2,2,4
9952_0,,,,2,2,2,4
9953_0,,,,2,2,2,4
9954_0,,,,2,2,2,4
9955_0,,,,2,2,2,4
9956_0,,,,2,2,2,4
9957_0,,,,2,2,2,4
9958_0,,,,2,2,2,4
9959_0,,,,2,2,2,4
9960_0,,,,2,2,2,4
9961_0,,,,2,2,2,4
9962_0,,,,2,2,2,4
9963_0,,,,2,2,2,4
9964_0,,,,2,2,2,4
9965_0,,,,2,2,2,4
9966_0,,,,2,2,2,4
9967_0,,,,2,2,2,4
9968_0,,,,2,2,2,4
9969_0,,,,2,2,2,4
9970_0,,,,2,2,2,4
9971_0,,,,2,2,2,4
9972_0,,,,2,2,2,4
9973_0,,,,2,2,2,4
9974_0,,,,2,2,2,4
9975_0,,,,2,2,2,4
9976_0,,,,2,2,2,4
9977_0,,,,2,2,2,4
9978_0,,,,2,2,2,4
9979_0,,,,2,2,2,4
9980_0,,,,2,2,2,4
9981_0,,,,2,2,2,4
9982_0,,,,2,2,2,4
9983_0,,,,2,2,2,4
9984_0,,,,2,2,2,4
9985_0,,,,2,2,2,4
9986_0,,,,2,2,2,4
9987_0,,,,2,2,2,4
9988_0,,,,2,2,2,4
9989_0,,,,2,2,2,4
9990_0,,,,2,2,2,4
9991_0,,,,2,2,2,4
9992_0,,,,2,2,2,4
9993_0,,,,2,2,2,4
9994_0,,,,2,2,2,4
9995_0,,,,2,2,2,4
9996_0,,,,2,2,2,4
9997_0,,,,2,2,2,4
9998_0,,,,2,2,2,4
9999_0,,,,2,2,2,4
10000_0,,,,2,2,2,4
10001_0,,,,2,2,2,4
10002_0,,,,2,2,2,4
10003_0,,,,2,2,2,4
10004_0,,,,2,2,2,4
10005_0,,,,2,2,2,4
10006_0,,,,2,2,2,4
10007_0,,,,2,2,2,4
10008_0,,,,2,2,2,4
10009_0,,,,2,2,2,4
10010_0,,,,2,2,2,4
10011_0,,,,2,2,2,4
10012_0,,,,2,2,2,4
10013_0,,,,2,2,2,4
10014_0,,,,2,2,2,4
10015_0,,,,2,2,2,4
10016_0,,,,2,2,2,4
10017_0,,,,2,2,2,4
10018_0,,,,2,2,2,4
10019_0,,,,2,2,2,4
10020_0,,,,2,2,2,4
10021_0,,,,2,2,2,4
10022_0,,,,2,2,2,4
10023_0,,,,2,2,2,4
10024_0,,,,2,2,2,4
10025_0,,,,2,2,2,4
10026_0,,,,2,2,2,4
10027_0,,,,2,2,2,4
10028_0,,,,2,2,2,4
10029_0,,,,2,2,2,4
10030_0,,,,2,2,2,4
10031_0,,,,2,2,2,4
10032_0,,,,2,2,2,4
10033_0,,,,2,2,2,4
10034_0,,,,2,2,2,4
10035_0,,,,2,2,2,4
10036_0,,,,2,2,2,4
10037_0,,,,2,2,2,4
10038_0,,,,2,2,2,4
10039_0,,,,2,2,2,4
10040_0,,,,2,2,2,4
10041_0,,,,2,2,2,4
10042_0,,,,2,2,2,4
10043_0,,,,2,2,2,4
10044_0,,,,2,2,2,4
10045_0,,,,2,2,2,4
10046_0,,,,2,2,2,4
10047_0,,,,2,2,2,4
10048_0,,,,2,2,2,4
10049_0,,,,2,2,2,4
10050_0,,,,2,2,2,4
10051_0,,,,2,2,2,4
10052_0,,,,2,2,2,4
10053_0,,,,2,2,2,4
10054_0,,,,2,2,2,4
10055_0,,,,2,2,2,4
10056_0,,,,2,2,2,4
10057_0,,,,2,2,2,4
10058_0,,,,2,2,2,4
10059_0,,,,2,2,2,4
10060_0,,,,2,2,2,4
10061_0,,,,2,2,2,4
10062_0,,,,2,2,2,4
10063_0,,,,2,2,2,4
10064_0,,,,2,2,2,4
10065_0,,,,2,2,2,4
10066_0,,,,2,2,2,4
10067_0,,,,2,2,2,4
10068_0,,,,2,2,2,4
10069_0,,,,2,2,2,4
10070_0,,,,2,2,2,4
10071_0,,,,2,2,2,4
10072_0,,,,2,2,2,4
10073_0,,,,2,2,2,4
10074_0,,,,2,2,2,4
10075_0,,,,2,2,2,4
10076_0,,,,2,2,2,4
10077_0,,,,2,2,2,4
10078_0,,,,2,2,2,4
10079_0,,,,2,2,2,4
10080_0,,,,2,2,2,4
10081_0,,,,2,2,2,4
10082_0,,,,2,2,2,4
10083_0,,,,2,2,2,4
10084_0,,,,2,2,2,4
10085_0,,,,2,2,2,4
10086_0,,,,2,2,2,4
10087_0,,,,2,2,2,4
10088_0,,,,2,2,2,4
10089_0,,,,2,2,2,4
10090_0,,,,2,2,2,4
10091_0,,,,2,2,2,4
10092_0,,,,2,2,2,4
10093_0,,,,2,2,2,4
10094_0,,,,2,2,2,4
10095_0,,,,2,2,2,4
10096_0,,,,2,2,2,4
10097_0,,,,2,2,2,4
10098_0,,,,2,2,2,4
10099_0,,,,2,2,2,4
10100_0,,,,2,2,2,4
10101_0,,,,2,2,2,4
10102_0,,,,2,2,2,4
10103_0,,,,2,2,2,4
10104_0,,,,2,2,2,4
10105_0,,,,2,2,2,4
10106_0,,,,2,2,2,4
10107_0,,,,2,2,2,4
10108_0,,,,2,2,2,4
10109_0,,,,2,2,2,4
10110_0,,,,2,2,2,4
10111_0,,,,2,2,2,4
10112_0,,,,2,2,2,4
10113_0,,,,2,2,2,4
10114_0,,,,2,2,2,4
10115_0,,,,2,2,2,4
10116_0,,,,2,2,2,4
10117_0,,,,2,2,2,4
10118_0,,,,2,2,2,4
10119_0,,,,2,2,2,4
10120_0,,,,2,2,2,4
10121_0,,,,2,2,2,4
10122_0,,,,2,2,2,4
10123_0,,,,2,2,2,4
10124_0,,,,2,2,2,4
10125_0,,,,2,2,2,4
10126_0,,,,2,2,2,4
10127_0,,,,2,2,2,4
10128_0,,,,2,2,2,4
10129_0,,,,2,2,2,4
10130_0,,,,2,2,2,4
10131_0,,,,2,2,2,4
10132_0,,,,2,2,2,4
10133_0,,,,2,2,2,4
10134_0,,,,2,2,2,4
10135_0,,,,2,2,2,4
10136_0,,,,2,2,2,4
10137_0,,,,2,2,2,4
10138_0,,,,2,2,2,4
10139_0,,,,2,2,2,4
10140_0,,,,2,2,2,4
10141_0,,,,2,2,2,4
10142_0,,,,2,2,2,4
10143_0,,,,2,2,2,4
10144_0,,,,2,2,2,4
10145_0,,,,2,2,2,4
10146_0,,,,2,2,2,4
10147_0,,,,2,2,2,4
10148_0,,,,2,2,2,4
10149_0,,,,2,2,2,4
10150_0,,,,2,2,2,4
10151_0,,,,2,2,2,4
10152_0,,,,2,2,2,4
10153_0,,,,2,2,2,4
10154_0,,,,2,2,2,4
10155_0,,,,2,2,2,4
10156_0,,,,2,2,2,4
10157_0,,,,2,2,2,4
10158_0,,,,2,2,2,4
10159_0,,,,2,2,2,4
10160_0,,,,2,2,2,4
10161_0,,,,2,2,2,4
10162_0,,,,2,2,2,4
10163_0,,,,2,2,2,4
10164_0,,,,2,2,2,4
10165_0,,,,2,2,2,4
10166_0,,,,2,2,2,4
10167_0,,,,2,2,2,4
10168_0,,,,2,2,2,4
10169_0,,,,2,2,2,4
10170_0,,,,2,2,2,4
10171_0,,,,2,2,2,4
10172_0,,,,2,2,2,4
10173_0,,,,2,2,2,4
10174_0,,,,2,2,2,4
10175_0,,,,2,2,2,4
10176_0,,,,2,2,2,4
10177_0,,,,2,2,2,4
10178_0,,,,2,2,2,4
10179_0,,,,2,2,2,4
10180_0,,,,2,2,2,4
10181_0,,,,2,2,2,4
10182_0,,,,2,2,2,4
10183_0,,,,2,2,2,4
10184_0,,,,2,2,2,4
10185_0,,,,2,2,2,4
10186_0,,,,2,2,2,4
10187_0,,,,2,2,2,4
10188_0,,,,2,2,2,4
10189_0,,,,2,2,2,4
10190_0,,,,2,2,2,4
10191_0,,,,2,2,2,4
10192_0,,,,2,2,2,4
10193_0,,,,2,2,2,4
10194_0,,,,2,2,2,4
10195_0,,,,2,2,2,4
10196_0,,,,2,2,2,4
10197_0,,,,2,2,2,4
10198_0,,,,2,2,2,4
10199_0,,,,2,2,2,4
10200_0,,,,2,2,2,4
10201_0,,,,2,2,2,4
10202_0,,,,2,2,2,4
10203_0,,,,2,2,2,4
10204_0,,,,2,2,2,4
10205_0,,,,2,2,2,4
10206_0,,,,2,2,2,4
10207_0,,,,2,2,2,4
10208_0,,,,2,2,2,4
10209_0,,,,2,2,2,4
10210_0,,,,2,2,2,4
10211_0,,,,2,2,2,4
10212_0,,,,2,2,2,4
10213_0,,,,2,2,2,4
10214_0,,,,2,2,2,4
10215_0,,,,2,2,2,4
10216_0,,,,2,2,2,4
10217_0,,,,2,2,2,4
10218_0,,,,2,2,2,4
10219_0,,,,2,2,2,4
10220_0,,,,2,2,2,4
10221_0,,,,2,2,2,4
10222_0,,,,2,2,2,4
10223_0,,,,2,2,2,4
10224_0,,,,2,2,2,4
10225_0,,,,2,2,2,4
10226_0,,,,2,2,2,4
10227_0,,,,2,2,2,4
10228_0,,,,2,2,2,4
10229_0,,,,2,2,2,4
10230_0,,,,2,2,2,4
10231_0,,,,2,2,2,4
10232_0,,,,2,2,2,4
10233_0,,,,2,2,2,4
10234_0,,,,2,2,2,4
10235_0,,,,2,2,2,4
10236_0,,,,2,2,2,4
10237_0,,,,2,2,2,4
10238_0,,,,2,2,2,4
10239_0,,,,2,2,2,4
10240_0,,,,2,2,2,4
10241_0,,,,2,2,2,4
10242_0,,,,2,2,2,4
10243_0,,,,2,2,2,4
10244_0,,,,2,2,2,4
10245_0,,,,2,2,2,4
10246_0,,,,2,2,2,4
10247_0,,,,2,2,2,4
10248_0,,,,2,2,2,4
10249_0,,,,2,2,2,4
10250_0,,,,2,2,2,4
10251_0,,,,2,2,2,4
10252_0,,,,2,2,2,4
10253_0,,,,2,2,2,4
10254_0,,,,2,2,2,4
10255_0,,,,2,2,2,4
10256_0,,,,2,2,2,4
10257_0,,,,2,2,2,4
10258_0,,,,2,2,2,4
10259_0,,,,2,2,2,4
10260_0,,,,2,2,2,4
10261_0,,,,2,2,2,4
10262_0,,,,2,2,2,4
10263_0,,,,2,2,2,4
10264_0,,,,2,2,2,4
10265_0,,,,2,2,2,4
10266_0,,,,2,2,2,4
10267_0,,,,2,2,2,4
10268_0,,,,2,2,2,4
10269_0,,,,2,2,2,4
10270_0,,,,2,2,2,4
10271_0,,,,2,2,2,4
10272_0,,,,2,2,2,4
10273_0,,,,2,2,2,4
10274_0,,,,2,2,2,4
10275_0,,,,2,2,2,4
10276_0,,,,2,2,2,4
10277_0,,,,2,2,2,4
10278_0,,,,2,2,2,4
10279_0,,,,2,2,2,4
10280_0,,,,2,2,2,4
10281_0,,,,2,2,2,4
10282_0,,,,2,2,2,4
10283_0,,,,2,2,2,4
10284_0,,,,2,2,2,4
10285_0,,,,2,2,2,4
10286_0,,,,2,2,2,4
10287_0,,,,2,2,2,4
10288_0,,,,2,2,2,4
10289_0,,,,2,2,2,4
10290_0,,,,2,2,2,4
10291_0,,,,2,2,2,4
10292_0,,,,2,2,2,4
10293_0,,,,2,2,2,4
10294_0,,,,2,2,2,4
10295_0,,,,2,2,2,4
10296_0,,,,2,2,2,4
10297_0,,,,2,2,2,4
10298_0,,,,2,2,2,4
10299_0,,,,2,2,2,4
10300_0,,,,2,2,2,4
10301_0,,,,2,2,2,4
10302_0,,,,2,2,2,4
10303_0,,,,2,2,2,4
10304_0,,,,2,2,2,4
10305_0,,,,2,2,2,4
10306_0,,,,2,2,2,4
10307_0,,,,2,2,2,4
10308_0,,,,2,2,2,4
10309_0,,,,2,2,2,4
10310_0,,,,2,2,2,4
10311_0,,,,2,2,2,4
10312_0,,,,2,2,2,4
10313_0,,,,2,2,2,4
10314_0,,,,2,2,2,4
10315_0,,,,2,2,2,4
10316_0,,,,2,2,2,4
10317_0,,,,2,2,2,4
10318_0,,,,2,2,2,4
10319_0,,,,2,2,2,4
10320_0,,,,2,2,2,4
10321_0,,,,2,2,2,4
10322_0,,,,2,2,2,4
10323_0,,,,2,2,2,4
10324_0,,,,2,2,2,4
10325_0,,,,2,2,2,4
10326_0,,,,2,2,2,4
10327_0,,,,2,2,2,4
10328_0,,,,2,2,2,4
10329_0,,,,2,2,2,4
10330_0,,,,2,2,2,4
10331_0,,,,2,2,2,4
10332_0,,,,2,2,2,4
10333_0,,,,2,2,2,4
10334_0,,,,2,2,2,4
10335_0,,,,2,2,2,4
10336_0,,,,2,2,2,4
10337_0,,,,2,2,2,4
10338_0,,,,2,2,2,4
10339_0,,,,2,2,2,4
10340_0,,,,2,2,2,4
10341_0,,,,2,2,2,4
10342_0,,,,2,2,2,4
10343_0,,,,2,2,2,4
10344_0,,,,2,2,2,4
10345_0,,,,2,2,2,4
10346_0,,,,2,2,2,4
10347_0,,,,2,2,2,4
10348_0,,,,2,2,2,4
10349_0,,,,2,2,2,4
10350_0,,,,2,2,2,4
10351_0,,,,2,2,2,4
10352_0,,,,2,2,2,4
10353_0,,,,2,2,2,4
10354_0,,,,2,2,2,4
10355_0,,,,2,2,2,4
10356_0,,,,2,2,2,4
10357_0,,,,2,2,2,4
10358_0,,,,2,2,2,4
10359_0,,,,2,2,2,4
10360_0,,,,2,2,2,4
10361_0,,,,2,2,2,4
10362_0,,,,2,2,2,4
10363_0,,,,2,2,2,4
10364_0,,,,2,2,2,4
10365_0,,,,2,2,2,4
10366_0,,,,2,2,2,4
10367_0,,,,2,2,2,4
10368_0,,,,2,2,2,4
10369_0,,,,2,2,2,4
10370_0,,,,2,2,2,4
10371_0,,,,2,2,2,4
10372_0,,,,2,2,2,4
10373_0,,,,2,2,2,4
10374_0,,,,2,2,2,4
10375_0,,,,2,2,2,4
10376_0,,,,2,2,2,4
10377_0,,,,2,2,2,4
10378_0,,,,2,2,2,4
10379_0,,,,2,2,2,4
10380_0,,,,2,2,2,4
10381_0,,,,2,2,2,4
10382_0,,,,2,2,2,4
10383_0,,,,2,2,2,4
10384_0,,,,2,2,2,4
10385_0,,,,2,2,2,4
10386_0,,,,2,2,2,4
10387_0,,,,2,2,2,4
10388_0,,,,2,2,2,4
10389_0,,,,2,2,2,4
10390_0,,,,2,2,2,4
10391_0,,,,2,2,2,4
10392_0,,,,2,2,2,4
10393_0,,,,2,2,2,4
10394_0,,,,2,2,2,4
10395_0,,,,2,2,2,4
10396_0,,,,2,2,2,4
10397_0,,,,2,2,2,4
10398_0,,,,2,2,2,4
10399_0,,,,2,2,2,4
10400_0,,,,2,2,2,4
10401_0,,,,2,2,2,4
10402_0,,,,2,2,2,4
10403_0,,,,2,2,2,4
10404_0,,,,2,2,2,4
10405_0,,,,2,2,2,4
10406_0,,,,2,2,2,4
10407_0,,,,2,2,2,4
10408_0,,,,2,2,2,4
10409_0,,,,2,2,2,4
10410_0,,,,2,2,2,4
10411_0,,,,2,2,2,4
10412_0,,,,2,2,2,4
10413_0,,,,2,2,2,4
10414_0,,,,2,2,2,4
10415_0,,,,2,2,2,4
10416_0,,,,2,2,2,4
10417_0,,,,2,2,2,4
10418_0,,,,2,2,2,4
10419_0,,,,2,2,2,4
10420_0,,,,2,2,2,4
10421_0,,,,2,2,2,4
10422_0,,,,2,2,2,4
10423_0,,,,2,2,2,4
10424_0,,,,2,2,2,4
10425_0,,,,2,2,2,4
10426_0,,,,2,2,2,4
10427_0,,,,2,2,2,4
10428_0,,,,2,2,2,4
10429_0,,,,2,2,2,4
10430_0,,,,2,2,2,4
10431_0,,,,2,2,2,4
10432_0,,,,2,2,2,4
10433_0,,,,2,2,2,4
10434_0,,,,2,2,2,4
10435_0,,,,2,2,2,4
10436_0,,,,2,2,2,4
10437_0,,,,2,2,2,4
10438_0,,,,2,2,2,4
10439_0,,,,2,2,2,4
10440_0,,,,2,2,2,4
10441_0,,,,2,2,2,4
10442_0,,,,2,2,2,4
10443_0,,,,2,2,2,4
10444_0,,,,2,2,2,4
10445_0,,,,2,2,2,4
10446_0,,,,2,2,2,4
10447_0,,,,2,2,2,4
10448_0,,,,2,2,2,4
10449_0,,,,2,2,2,4
10450_0,,,,2,2,2,4
10451_0,,,,2,2,2,4
10452_0,,,,2,2,2,4
10453_0,,,,2,2,2,4
10454_0,,,,2,2,2,4
10455_0,,,,2,2,2,4
10456_0,,,,2,2,2,4
10457_0,,,,2,2,2,4
10458_0,,,,2,2,2,4
10459_0,,,,2,2,2,4
10460_0,,,,2,2,2,4
10461_0,,,,2,2,2,4
10462_0,,,,2,2,2,4
10463_0,,,,2,2,2,4
10464_0,,,,2,2,2,4
10465_0,,,,2,2,2,4
10466_0,,,,2,2,2,4
10467_0,,,,2,2,2,4
10468_0,,,,2,2,2,4
10469_0,,,,2,2,2,4
10470_0,,,,2,2,2,4
10471_0,,,,2,2,2,4
10472_0,,,,2,2,2,4
10473_0,,,,2,2,2,4
10474_0,,,,2,2,2,4
10475_0,,,,2,2,2,4
10476_0,,,,2,2,2,4
10477_0,,,,2,2,2,4
10478_0,,,,2,2,2,4
10479_0,,,,2,2,2,4
10480_0,,,,2,2,2,4
10481_0,,,,2,2,2,4
10482_0,,,,2,2,2,4
10483_0,,,,2,2,2,4
10484_0,,,,2,2,2,4
10485_0,,,,2,2,2,4
10486_0,,,,2,2,2,4
10487_0,,,,2,2,2,4
10488_0,,,,2,2,2,4
10489_0,,,,2,2,2,4
10490_0,,,,2,2,2,4
10491_0,,,,2,2,2,4
10492_0,,,,2,2,2,4
10493_0,,,,2,2,2,4
10494_0,,,,2,2,2,4
10495_0,,,,2,2,2,4
10496_0,,,,2,2,2,4
10497_0,,,,2,2,2,4
10498_0,,,,2,2,2,4
10499_0,,,,2,2,2,4
10500_0,,,,2,2,2,4
10501_0,,,,2,2,2,4
10502_0,,,,2,2,2,4
10503_0,,,,2,2,2,4
10504_0,,,,2,2,2,4
10505_0,,,,2,2,2,4
10506_0,,,,2,2,2,4
10507_0,,,,2,2,2,4
10508_0,,,,2,2,2,4
10509_0,,,,2,2,2,4
10510_0,,,,2,2,2,4
10511_0,,,,2,2,2,4
10512_0,,,,2,2,2,4
10513_0,,,,2,2,2,4
10514_0,,,,2,2,2,4
10515_0,,,,2,2,2,4
10516_0,,,,2,2,2,4
10517_0,,,,2,2,2,4
10518_0,,,,2,2,2,4
10519_0,,,,2,2,2,4
10520_0,,,,2,2,2,4
10521_0,,,,2,2,2,4
10522_0,,,,2,2,2,4
10523_0,,,,2,2,2,4
10524_0,,,,2,2,2,4
10525_0,,,,2,2,2,4
10526_0,,,,2,2,2,4
10527_0,,,,2,2,2,4
10528_0,,,,2,2,2,4
10529_0,,,,2,2,2,4
10530_0,,,,2,2,2,4
10531_0,,,,2,2,2,4
10532_0,,,,2,2,2,4
10533_0,,,,2,2,2,4
10534_0,,,,2,2,2,4
10535_0,,,,2,2,2,4
10536_0,,,,2,2,2,4
10537_0,,,,2,2,2,4
10538_0,,,,2,2,2,4
10539_0,,,,2,2,2,4
10540_0,,,,2,2,2,4
10541_0,,,,2,2,2,4
10542_0,,,,2,2,2,4
10543_0,,,,2,2,2,4
10544_0,,,,2,2,2,4
10545_0,,,,2,2,2,4
10546_0,,,,2,2,2,4
10547_0,,,,2,2,2,4
10548_0,,,,2,2,2,4
10549_0,,,,2,2,2,4
10550_0,,,,2,2,2,4
10551_0,,,,2,2,2,4
10552_0,,,,2,2,2,4
10553_0,,,,2,2,2,4
10554_0,,,,2,2,2,4
10555_0,,,,2,2,2,4
10556_0,,,,2,2,2,4
10557_0,,,,2,2,2,4
10558_0,,,,2,2,2,4
10559_0,,,,2,2,2,4
10560_0,,,,2,2,2,4
10561_0,,,,2,1,2,3
10562_0,,,,2,1,2,3
10563_0,,,,2,1,2,3
10564_0,,,,2,1,2,3
10565_0,,,,2,1,2,3
10566_0,,,,2,1,2,3
10567_0,,,,2,1,2,3
10568_0,,,,2,1,2,3
10570_0,,,,2,1,2,3
C1(CC(C(C(C=O)O)O1)O)=O,,,3,1,1,0,1
10572_0,,,,2,1,2,3
C1(C(C(C(C(CO)O)O1)O)=O)=O,,,3,1,1,0,1
10574_0,,,,2,1,2,3
C1(C(C=O)(C(CO1)O)O)=O,,,3,1,1,0,1
10576_0,,,,2,1,2,3
C(C1(C(CO)OC(C1O)=O)O)=O,,,3,1,1,0,1
10578_0,,,,2,1,2,3
C1(C(C(CO1)O)N)=O,,,3,1,1,0,1
10579_0,,,,2,1,2,3
10581_0,,,,2,1,2,3
C1(C(C(C(O1)=O)N)O)=O,,,3,1,1,0,1
10582_0,,,,2,1,1,2
10583_0,,,,2,1,1,2
10584_0,,,,2,1,2,3
10585_0,,,,2,1,2,3
10586_0,,,,2,1,1,2
10587_0,,,,2,1,1,2
10588_0,,,,2,1,1,2
10589_0,,,,2,1,1,2
10591_0,,,,2,1,2,3
C1(C(CCO1)O)=O,,,3,1,1,0,1
10592_0,,,,2,1,2,3
10593_0,,,,2,1,2,3
10594_0,,,,2,1,2,3
10595_0,,,,2,1,2,3
10597_0,,,,2,1,2,3
C1(CC(C(C(C=O)O1)O)O)=O,,,3,1,1,0,1
10599_0,,,,2,1,2,3
C1(C(C(C(C(CO)O1)O)O)=O)=O,,,3,1,1,0,1
10601_0,,,,2,1,2,3
C(C1(C(COC(C1O)=O)O)O)=O,,,3,1,1,0,1
10602_0,,,,2,1,2,3
10603_0,,,,2,1,1,2
10604_0,,,,2,1,1,2
10605_0,,,,2,1,1,2
10606_0,,,,2,1,2,3
10607_0,,,,2,1,2,3
10608_0,,,,2,1,2,3
10609_0,,,,2,1,2,3
10610_0,,,,2,1,2,3
10611_0,,,,2,1,2,3
10613_0,,,,2,1,2,3
C1(C(C(C(C(CO1)O)O)O)=O)=O,,,3,1,1,0,1
10614_0,,,,2,1,2,3
10615_0,,,,2,1,2,3
10616_0,,,,2,1,2,3
10618_0,,,,2,1,2,3
C1C(CC(C(CO)O)N=1)O,,,3,1,1,0,1
10620_0,,,,2,1,2,3
C1C(C(C(CCO)N=1)O)O,,,3,1,1,0,1
10622_0,,,,2,1,2,3
C1(C(CO)O)CC(CN=1)O,,,3,1,1,0,1
10624_0,,,,2,1,2,3
C1(C(C(CN=1)O)O)CCO,,,3,1,1,0,1
10626_0,,,,2,1,2,3
C1C(C(CC(CO)N=1)O)O,,,3,1,1,0,1
10628_0,,,,2,1,2,3
C1C(C(C(C(C)N=1)O)O)O,,,3,1,1,0,1
10630_0,,,,2,1,2,3
C1(CO)CC(C(CN=1)O)O,,,3,1,1,0,1
10632_0,,,,2,1,2,3
C1(C)C(C(C(CN=1)O)O)O,,,3,1,1,0,1
10633_0,,,,2,1,1,2
10634_0,,,,2,1,1,2
10636_0,,,,2,2,1,3
C(CC(C(CO)O)CC(C=O)=O)=O,,,3,1,1,0,1
10638_0,,,,2,2,1,3
C(C(C(CC(CO)CC=O)=O)O)=O,,,3,1,1,0,1
10640_0,,,,2,2,1,3
C(CC(C=O)CC=O)(C(CO)O)=O,,,3,1,1,0,1
10642_0,,,,2,2,1,3
C(CC(C(C(CO)O)=O)CC=O)=O,,,3,1,1,0,1
10644_0,,,,2,2,1,3
C(CCCC(C(C(C=O)O)O)=O)=O,,,3,1,1,0,1
10646_0,,,,2,2,1,3
C(CC(C(C=O)O)CC(CO)=O)=O,,,3,1,1,0,1
10648_0,,,,2,2,1,3
C(CC(C(C(C=O)O)O)CC=O)=O,,,3,1,1,0,1
10650_0,,,,2,2,1,3
C(C(CC(CO)C(CO)O)=O)=O,,,3,1,1,0,1
10652_0,,,,2,2,1,3
C(C(C(CC(CO)CO)=O)O)=O,,,3,1,1,0,1
10654_0,,,,2,2,1,3
C(C(CO)CC(C(CO)O)=O)=O,,,3,1,1,0,1
10656_0,,,,2,2,1,3
C(C(CO)CC=O)(C(CO)O)=O,,,3,1,1,0,1
10658_0,,,,2,2,1,3
C(C(C(C=O)O)O)(CCCO)=O,,,3,1,1,0,1
10660_0,,,,2,2,1,3
C(C(C(CO)CC(CO)=O)O)=O,,,3,1,1,0,1
10662_0,,,,2,2,1,3
C(CC(CO)C(C(C=O)O)O)=O,,,3,1,1,0,1
10664_0,,,,2,2,1,3
C(CC(CO)C(C(CO)O)O)(O)=O,,,3,1,1,0,1
10666_0,,,,2,2,1,3
C(C(CC(CN)C(CO)O)=O)=O,,,3,1,1,0,1
10668_0,,,,2,2,1,3
C(C(C(CC(CO)CN)=O)O)=O,,,3,1,1,0,1
10670_0,,,,2,2,1,3
C(C(CN)CC(C(CO)O)=O)=O,,,3,1,1,0,1
10672_0,,,,2,2,1,3
C(C(CN)CC=O)(C(CO)O)=O,,,3,1,1,0,1
10674_0,,,,2,2,1,3
C(C(C(C=O)O)O)(CCCN)=O,,,3,1,1,0,1
10676_0,,,,2,2,1,3
C(C(C(CN)CC(CO)=O)O)=O,,,3,1,1,0,1
10678_0,,,,2,2,1,3
C(CC(C(C(C=O)O)O)CN)=O,,,3,1,1,0,1
10680_0,,,,2,2,1,3
C(CC(CN)C(C(CO)O)O)(O)=O,,,3,1,1,0,1
10682_0,,,,2,1,2,3
C=C(C(C=O)=O)NC,,,3,1,1,0,1
10684_0,,,,2,1,2,3
C=C(C(CO)=O)NC,,,3,1,1,0,1
10686_0,,,,2,1,2,3
C(C(C(C(NC)=C)=O)O)=O,,,3,1,1,0,1
10688_0,,,,2,1,2,3
C=C(C=O)NC,,,3,1,1,0,1
10690_0,,,,2,1,2,3
C=C(C=O)N,,,3,1,1,0,1
10691_0,,,,2,1,2,3
10693_0,,,,2,1,2,3
C(NC)=CC(C=O)=O,,,3,1,1,0,1
10695_0,,,,2,1,2,3
C(C(C(C=CNC)=O)O)=O,,,3,1,1,0,1
10697_0,,,,2,1,2,3
C(NC)=CC(CO)=O,,,3,1,1,0,1
10699_0,,,,2,1,2,3
C(NC)=CC=O,,,3,1,1,0,1
10701_0,,,,2,1,2,3
C(N)=CC=O,,,3,1,1,0,1
10702_0,,,,2,2,3,5
10703_0,,,,2,2,3,5
10704_0,,,,2,2,3,5
10705_0,,,,2,2,3,5
10706_0,,,,2,2,3,5
10707_0,,,,2,2,3,5
10708_0,,,,2,2,3,5
10709_0,,,,2,2,3,5
10710_0,,,,2,2,3,5
10711_0,,,,2,2,3,5
10712_0,,,,2,2,3,5
10713_0,,,,2,2,3,5
10714_0,,,,2,2,3,5
10716_0,,,,2,2,3,5
C(C(CNCC=O)O)(O)=O,,,3,1,1,0,1
10717_0,,,,2,2,3,5
10718_0,,,,2,2,3,5
10719_0,,,,2,2,3,5
10720_0,,,,2,2,3,5
10721_0,,,,2,2,3,5
10723_0,,,,2,2,3,5
C(C(C(CNCC=O)O)O)(O)=O,,,3,1,1,0,1
10724_0,,,,2,2,3,5
10725_0,,,,2,2,3,5
10726_0,,,,2,2,3,5
10727_0,,,,2,2,3,5
10728_0,,,,2,2,3,5
10730_0,,,,2,2,3,5
C(CNCC(CO)O)=O,,,3,1,1,0,1
10732_0,,,,2,2,3,5
C(CNCC(CO)O)(C(CO)O)=O,,,3,1,1,0,1
10733_0,,,,2,2,3,5
10734_0,,,,2,2,3,5
10735_0,,,,2,2,3,5
10736_0,,,,2,2,3,5
10737_0,,,,2,2,3,5
10739_0,,,,2,2,3,5
C(C(C(CO)NCC(CO)O)O)=O,,,3,1,1,0,1
10740_0,,,,2,2,3,5
10741_0,,,,2,2,3,5
10742_0,,,,2,2,3,5
10743_0,,,,2,2,3,5
10744_0,,,,2,2,3,5
10745_0,,,,2,2,3,5
10746_0,,,,2,2,3,5
10747_0,,,,2,2,3,5
10748_0,,,,2,2,3,5
10749_0,,,,2,2,3,5
10750_0,,,,2,2,3,5
10751_0,,,,2,2,3,5
10752_0,,,,2,2,3,5
10753_0,,,,2,2,3,5
10754_0,,,,2,2,3,5
10755_0,,,,2,2,3,5
10756_0,,,,2,2,3,5
10757_0,,,,2,2,3,5
10758_0,,,,2,2,3,5
10759_0,,,,2,2,3,5
10760_0,,,,2,2,3,5
10761_0,,,,2,2,3,5
10762_0,,,,2,2,3,5
10763_0,,,,2,2,3,5
10764_0,,,,2,2,3,5
10765_0,,,,2,2,3,5
10766_0,,,,2,2,3,5
10767_0,,,,2,2,3,5
10768_0,,,,2,2,3,5
10769_0,,,,2,2,3,5
10770_0,,,,2,2,3,5
10771_0,,,,2,2,3,5
10772_0,,,,2,2,3,5
10773_0,,,,2,2,3,5
10774_0,,,,2,2,3,5
10775_0,,,,2,2,3,5
10776_0,,,,2,2,3,5
10777_0,,,,2,2,3,5
10778_0,,,,2,2,3,5
10779_0,,,,2,2,3,5
10780_0,,,,2,2,3,5
10781_0,,,,2,2,3,5
10782_0,,,,2,2,3,5
10783_0,,,,2,2,3,5
10784_0,,,,2,2,3,5
10786_0,,,,2,2,3,5
C(CNCCC(CO)=O)=O,,,3,1,1,0,1
10787_0,,,,2,2,3,5
10788_0,,,,2,2,3,5
10789_0,,,,2,2,3,5
10790_0,,,,2,2,3,5
10791_0,,,,2,2,3,5
10793_0,,,,2,2,3,5
C(C)(C(CNCC=O)O)=O,,,3,1,1,0,1
10794_0,,,,2,2,3,5
10795_0,,,,2,2,3,5
10796_0,,,,2,2,3,5
10797_0,,,,2,2,3,5
10798_0,,,,2,2,3,5
10800_0,,,,2,2,3,5
C(CNCC(CC(CO)=O)O)=O,,,3,1,1,0,1
10801_0,,,,2,2,3,5
10802_0,,,,2,2,3,5
10803_0,,,,2,2,3,5
10804_0,,,,2,2,3,5
10805_0,,,,2,2,3,5
10807_0,,,,2,2,3,5
C(C)(C(C(CNCC=O)O)O)=O,,,3,1,1,0,1
10808_0,,,,2,2,3,5
10809_0,,,,2,2,3,5
10810_0,,,,2,2,3,5
10811_0,,,,2,2,3,5
10812_0,,,,2,2,3,5
10814_0,,,,2,2,3,5
C(C(CNCC=O)O)=O,,,3,1,1,0,1
10816_0,,,,2,2,3,5
C(C(CNCC(C(CO)O)=O)O)=O,,,3,1,1,0,1
10817_0,,,,2,2,3,5
10818_0,,,,2,2,3,5
10819_0,,,,2,2,3,5
10820_0,,,,2,2,3,5
10821_0,,,,2,2,3,5
10823_0,,,,2,2,3,5
C(C(C(CO)NCC(C=O)O)O)=O,,,3,1,1,0,1
10825_0,,,,2,2,3,5
C(CC(CNCC=O)O)=O,,,3,1,1,0,1
10827_0,,,,2,2,3,5
C(C(CCNCC=O)O)=O,,,3,1,1,0,1
10828_0,,,,2,2,3,5
10829_0,,,,2,2,3,5
10830_0,,,,2,2,3,5
10831_0,,,,2,2,3,5
10832_0,,,,2,2,3,5
10833_0,,,,2,2,3,5
10834_0,,,,2,2,3,5
10835_0,,,,2,2,3,5
10836_0,,,,2,2,3,5
10837_0,,,,2,2,3,5
10839_0,,,,2,2,3,5
C(C(C(CNCC=O)O)O)=O,,,3,1,1,0,1
10840_0,,,,2,2,3,5
10841_0,,,,2,2,3,5
10842_0,,,,2,2,3,5
10843_0,,,,2,2,3,5
10844_0,,,,2,2,3,5
10846_0,,,,2,2,3,5
C(CNCC)=O,,,3,1,1,0,1
10848_0,,,,2,2,3,5
C(CNCC)(C(CO)O)=O,,,3,1,1,0,1
10849_0,,,,2,2,3,5
10850_0,,,,2,2,3,5
10851_0,,,,2,2,3,5
10852_0,,,,2,2,3,5
10853_0,,,,2,2,3,5
10855_0,,,,2,2,3,5
C(C(C(CO)NCC)O)=O,,,3,1,1,0,1
10856_0,,,,2,2,3,5
10857_0,,,,2,2,3,5
10858_0,,,,2,2,3,5
10859_0,,,,2,2,3,5
10860_0,,,,2,2,3,5
10861_0,,,,2,2,3,5
10862_0,,,,2,2,3,5
10863_0,,,,2,2,3,5
10864_0,,,,2,2,3,5
10865_0,,,,2,2,3,5
10866_0,,,,2,2,3,5
10867_0,,,,2,2,3,5
10868_0,,,,2,2,3,5
10869_0,,,,2,2,3,5
10870_0,,,,2,2,3,5
10871_0,,,,2,2,3,5
10872_0,,,,2,2,3,5
10873_0,,,,2,2,3,5
10874_0,,,,2,2,3,5
10875_0,,,,2,2,3,5
10876_0,,,,2,2,3,5
10877_0,,,,2,2,3,5
10878_0,,,,2,2,3,5
10879_0,,,,2,2,3,5
10880_0,,,,2,2,3,5
10881_0,,,,2,2,3,5
10882_0,,,,2,2,3,5
10883_0,,,,2,2,3,5
10884_0,,,,2,2,3,5
10885_0,,,,2,2,3,5
10886_0,,,,2,2,3,5
10887_0,,,,2,2,3,5
10888_0,,,,2,2,3,5
10889_0,,,,2,2,3,5
10890_0,,,,2,2,3,5
10891_0,,,,2,2,3,5
10892_0,,,,2,2,3,5
10893_0,,,,2,2,3,5
10894_0,,,,2,2,3,5
10895_0,,,,2,2,3,5
10897_0,,,,2,2,3,5
C(CNCCNC)=O,,,3,1,1,0,1
10899_0,,,,2,2,3,5
C(CNCCNC)(C(CO)O)=O,,,3,1,1,0,1
10900_0,,,,2,2,3,5
10901_0,,,,2,2,3,5
10902_0,,,,2,2,3,5
10903_0,,,,2,2,3,5
10904_0,,,,2,2,3,5
10906_0,,,,2,2,3,5
C(C(C(CO)NCCNC)O)=O,,,3,1,1,0,1
10907_0,,,,2,2,3,5
10908_0,,,,2,2,3,5
10909_0,,,,2,2,3,5
10910_0,,,,2,2,3,5
10911_0,,,,2,2,3,5
10912_0,,,,2,2,3,5
10913_0,,,,2,2,3,5
10914_0,,,,2,2,3,5
10915_0,,,,2,2,3,5
10916_0,,,,2,2,3,5
10917_0,,,,2,2,3,5
10918_0,,,,2,2,3,5
10919_0,,,,2,2,3,5
10920_0,,,,2,2,3,5
10921_0,,,,2,2,3,5
10922_0,,,,2,2,3,5
10923_0,,,,2,2,3,5
10924_0,,,,2,2,3,5
10925_0,,,,2,2,3,5
10926_0,,,,2,2,3,5
10927_0,,,,2,2,3,5
10928_0,,,,2,2,3,5
10929_0,,,,2,2,3,5
10930_0,,,,2,2,3,5
10931_0,,,,2,2,3,5
10932_0,,,,2,2,3,5
10933_0,,,,2,2,3,5
10934_0,,,,2,2,3,5
10935_0,,,,2,2,3,5
10936_0,,,,2,2,3,5
10937_0,,,,2,2,3,5
10938_0,,,,2,2,3,5
10939_0,,,,2,2,3,5
10940_0,,,,2,2,3,5
10941_0,,,,2,2,3,5
10942_0,,,,2,2,3,5
10943_0,,,,2,2,3,5
10944_0,,,,2,2,3,5
10945_0,,,,2,2,3,5
10946_0,,,,2,2,3,5
10947_0,,,,2,2,3,5
10948_0,,,,2,2,3,5
10949_0,,,,2,2,3,5
10950_0,,,,2,2,3,5
10951_0,,,,2,2,3,5
10953_0,,,,2,2,3,5
C(CNCCNCC(O)=O)=O,,,3,1,1,0,1
10955_0,,,,2,2,3,5
C(CNCC(CO)(C(CO)O)O)=O,,,3,1,1,0,1
10956_0,,,,2,2,3,5
10957_0,,,,2,2,3,5
10958_0,,,,2,2,3,5
10959_0,,,,2,2,3,5
10960_0,,,,2,2,3,5
10962_0,,,,2,2,3,5
C(CNCCC(CC(C=O)=O)O)=O,,,3,1,1,0,1
10964_0,,,,2,2,3,5
C(CNCCC(C(CCO)=O)=O)=O,,,3,1,1,0,1
10966_0,,,,2,2,3,5
C(CNCCC(CC(CO)=O)=O)=O,,,3,1,1,0,1
10968_0,,,,2,2,3,5
C(C)(C(C(CCNCC=O)=O)O)=O,,,3,1,1,0,1
10970_0,,,,2,2,3,5
C(CNCCC(C(CC=O)O)=O)=O,,,3,1,1,0,1
10972_0,,,,2,2,3,5
C(C(CCNCC=O)O)(CC=O)=O,,,3,1,1,0,1
10974_0,,,,2,2,3,5
C(C)(CC(C(CNCC=O)O)=O)=O,,,3,1,1,0,1
10976_0,,,,2,2,3,5
C(CNCC(C(CCC=O)=O)O)=O,,,3,1,1,0,1
10978_0,,,,2,2,3,5
C(CCCNCC=O)(C(C=O)O)=O,,,3,1,1,0,1
10980_0,,,,2,2,3,5
C(CNCC(CC(C(C)=O)=O)O)=O,,,3,1,1,0,1
10982_0,,,,2,2,3,5
C(CC(CNCC=O)O)(CC=O)=O,,,3,1,1,0,1
10984_0,,,,2,2,3,5
C(CC(C=O)O)(CCNCC=O)=O,,,3,1,1,0,1
10986_0,,,,2,2,3,5
C(CNCC(C(C=CCO)=O)O)=O,,,3,1,1,0,1
10988_0,,,,2,2,3,5
C(CNCC=CC(C(CO)O)=O)=O,,,3,1,1,0,1
10990_0,,,,2,2,3,5
C(CNCC(C(C(C=C)=O)O)O)=O,,,3,1,1,0,1
10992_0,,,,2,2,3,5
C(CNCC(C=CC(CO)=O)O)=O,,,3,1,1,0,1
10994_0,,,,2,2,3,5
C(CNCC(C(C=CC=O)O)O)=O,,,3,1,1,0,1
10996_0,,,,2,2,3,5
C(CNCC=CC(C(C=O)O)O)=O,,,3,1,1,0,1
10998_0,,,,2,2,3,5
C(CNCC(C(CO)NC)O)=O,,,3,1,1,0,1
11000_0,,,,2,2,3,5
C(CNCC(O)O)=O,,,3,1,1,0,1
11002_0,,,,2,2,3,5
C(CNCC(O)O)(C(CO)O)=O,,,3,1,1,0,1
11003_0,,,,2,2,3,5
11004_0,,,,2,2,3,5
11005_0,,,,2,2,3,5
11006_0,,,,2,2,3,5
11007_0,,,,2,2,3,5
11008_0,,,,2,2,3,5
11009_0,,,,2,2,3,5
11010_0,,,,2,2,3,5
11011_0,,,,2,2,3,5
11012_0,,,,2,2,3,5
11013_0,,,,2,2,3,5
11014_0,,,,2,2,3,5
11015_0,,,,2,2,3,5
11016_0,,,,2,2,3,5
11017_0,,,,2,2,3,5
11018_0,,,,2,2,3,5
11019_0,,,,2,2,3,5
11020_0,,,,2,2,3,5
11021_0,,,,2,2,3,5
11022_0,,,,2,2,3,5
11023_0,,,,2,2,3,5
11024_0,,,,2,2,3,5
11025_0,,,,2,2,3,5
11026_0,,,,2,2,3,5
11027_0,,,,2,2,3,5
11028_0,,,,2,2,3,5
11029_0,,,,2,2,3,5
11030_0,,,,2,2,3,5
11031_0,,,,2,2,3,5
11032_0,,,,2,2,3,5
11033_0,,,,2,2,3,5
11034_0,,,,2,2,3,5
11035_0,,,,2,2,3,5
11036_0,,,,2,2,3,5
11037_0,,,,2,2,3,5
11038_0,,,,2,2,3,5
11039_0,,,,2,2,3,5
11040_0,,,,2,2,3,5
11041_0,,,,2,2,3,5
11042_0,,,,2,2,3,5
11043_0,,,,2,2,3,5
11044_0,,,,2,2,3,5
11045_0,,,,2,2,3,5
11046_0,,,,2,2,3,5
11047_0,,,,2,2,3,5
11048_0,,,,2,2,3,5
11049_0,,,,2,2,3,5
11050_0,,,,2,2,3,5
11051_0,,,,2,2,3,5
11052_0,,,,2,2,3,5
11053_0,,,,2,2,3,5
11054_0,,,,2,2,3,5
11055_0,,,,2,2,3,5
11056_0,,,,2,2,3,5
11057_0,,,,2,2,3,5
11058_0,,,,2,2,3,5
11059_0,,,,2,2,3,5
11060_0,,,,2,2,3,5
11061_0,,,,2,2,3,5
11062_0,,,,2,2,3,5
11063_0,,,,2,2,3,5
11064_0,,,,2,2,3,5
11065_0,,,,2,2,3,5
11066_0,,,,2,2,3,5
11067_0,,,,2,2,3,5
11068_0,,,,2,2,3,5
11069_0,,,,2,2,3,5
11070_0,,,,2,2,3,5
11071_0,,,,2,2,3,5
11072_0,,,,2,2,3,5
11073_0,,,,2,2,3,5
11074_0,,,,2,2,3,5
11075_0,,,,2,2,3,5
11076_0,,,,2,2,3,5
11077_0,,,,2,2,3,5
11078_0,,,,2,2,3,5
11079_0,,,,2,2,3,5
11080_0,,,,2,2,3,5
11081_0,,,,2,2,3,5
11082_0,,,,2,2,3,5
11083_0,,,,2,2,3,5
11084_0,,,,2,2,3,5
11085_0,,,,2,2,3,5
11086_0,,,,2,2,3,5
11087_0,,,,2,2,3,5
11088_0,,,,2,2,3,5
11089_0,,,,2,2,3,5
11090_0,,,,2,2,3,5
11091_0,,,,2,2,3,5
11092_0,,,,2,2,3,5
11093_0,,,,2,2,3,5
11094_0,,,,2,2,3,5
11095_0,,,,2,2,3,5
11096_0,,,,2,2,3,5
11097_0,,,,2,2,3,5
11098_0,,,,2,2,3,5
11099_0,,,,2,2,3,5
11100_0,,,,2,2,3,5
11101_0,,,,2,2,3,5
11102_0,,,,2,2,3,5
11103_0,,,,2,2,3,5
11104_0,,,,2,2,3,5
11105_0,,,,2,2,3,5
11106_0,,,,2,2,3,5
11107_0,,,,2,2,3,5
11108_0,,,,2,2,3,5
11109_0,,,,2,2,3,5
11110_0,,,,2,2,3,5
11111_0,,,,2,2,3,5
11112_0,,,,2,2,3,5
11113_0,,,,2,2,3,5
11114_0,,,,2,2,3,5
11115_0,,,,2,2,3,5
11116_0,,,,2,2,3,5
11117_0,,,,2,2,3,5
11118_0,,,,2,2,3,5
11119_0,,,,2,2,3,5
11120_0,,,,2,2,3,5
11121_0,,,,2,2,3,5
11122_0,,,,2,2,3,5
11123_0,,,,2,2,3,5
11124_0,,,,2,2,3,5
11125_0,,,,2,2,3,5
11126_0,,,,2,2,3,5
11127_0,,,,2,2,3,5
11128_0,,,,2,2,3,5
11129_0,,,,2,2,3,5
11130_0,,,,2,2,3,5
11131_0,,,,2,2,3,5
11132_0,,,,2,2,3,5
11133_0,,,,2,2,3,5
11134_0,,,,2,2,3,5
11135_0,,,,2,2,3,5
11136_0,,,,2,2,3,5
11137_0,,,,2,2,3,5
11138_0,,,,2,2,3,5
11139_0,,,,2,2,3,5
11140_0,,,,2,2,3,5
11141_0,,,,2,2,3,5
11142_0,,,,2,2,3,5
11143_0,,,,2,2,3,5
11144_0,,,,2,2,3,5
11145_0,,,,2,2,3,5
11146_0,,,,2,2,3,5
11147_0,,,,2,2,3,5
11148_0,,,,2,2,3,5
11149_0,,,,2,2,3,5
11150_0,,,,2,2,3,5
11151_0,,,,2,2,3,5
11152_0,,,,2,2,3,5
11153_0,,,,2,2,3,5
11154_0,,,,2,2,3,5
11155_0,,,,2,2,3,5
11156_0,,,,2,2,3,5
11157_0,,,,2,2,3,5
11158_0,,,,2,2,3,5
11159_0,,,,2,2,3,5
11160_0,,,,2,2,3,5
11161_0,,,,2,2,3,5
11162_0,,,,2,2,3,5
11163_0,,,,2,2,3,5
11164_0,,,,2,2,3,5
11165_0,,,,2,2,3,5
11166_0,,,,2,2,3,5
11167_0,,,,2,2,3,5
11168_0,,,,2,2,3,5
11169_0,,,,2,2,3,5
11170_0,,,,2,2,3,5
11171_0,,,,2,2,3,5
11172_0,,,,2,2,3,5
11173_0,,,,2,2,3,5
11174_0,,,,2,2,3,5
11175_0,,,,2,2,3,5
11176_0,,,,2,2,3,5
11177_0,,,,2,2,3,5
11178_0,,,,2,2,3,5
11179_0,,,,2,2,3,5
11180_0,,,,2,2,3,5
11181_0,,,,2,2,3,5
11182_0,,,,2,2,3,5
11183_0,,,,2,2,3,5
11184_0,,,,2,2,3,5
11185_0,,,,2,2,3,5
11186_0,,,,2,2,3,5
11187_0,,,,2,2,3,5
11188_0,,,,2,2,3,5
11189_0,,,,2,2,3,5
11190_0,,,,2,2,3,5
11191_0,,,,2,2,3,5
11192_0,,,,2,2,3,5
11193_0,,,,2,2,3,5
11194_0,,,,2,2,3,5
11195_0,,,,2,2,3,5
11196_0,,,,2,2,3,5
11197_0,,,,2,2,3,5
11198_0,,,,2,2,3,5
11199_0,,,,2,2,3,5
11200_0,,,,2,2,3,5
11201_0,,,,2,2,3,5
11202_0,,,,2,2,3,5
11203_0,,,,2,2,3,5
11204_0,,,,2,2,3,5
11205_0,,,,2,2,3,5
11206_0,,,,2,2,3,5
11207_0,,,,2,2,3,5
11208_0,,,,2,2,3,5
11209_0,,,,2,2,3,5
11210_0,,,,2,2,3,5
11211_0,,,,2,2,3,5
11212_0,,,,2,2,3,5
11213_0,,,,2,2,3,5
11214_0,,,,2,2,3,5
11215_0,,,,2,2,3,5
11216_0,,,,2,2,3,5
11217_0,,,,2,2,3,5
11218_0,,,,2,2,3,5
11219_0,,,,2,2,3,5
11220_0,,,,2,2,3,5
11221_0,,,,2,2,3,5
11222_0,,,,2,2,3,5
11223_0,,,,2,2,3,5
11224_0,,,,2,2,3,5
11225_0,,,,2,2,3,5
11226_0,,,,2,2,3,5
11227_0,,,,2,2,3,5
11228_0,,,,2,2,3,5
11229_0,,,,2,2,3,5
11230_0,,,,2,2,3,5
11231_0,,,,2,2,3,5
11232_0,,,,2,2,3,5
11233_0,,,,2,2,3,5
11234_0,,,,2,2,3,5
11235_0,,,,2,2,3,5
11236_0,,,,2,2,3,5
11237_0,,,,2,2,3,5
11238_0,,,,2,2,3,5
11239_0,,,,2,2,3,5
11240_0,,,,2,2,3,5
11241_0,,,,2,2,3,5
11242_0,,,,2,2,3,5
11243_0,,,,2,2,3,5
11244_0,,,,2,2,3,5
11245_0,,,,2,2,3,5
11246_0,,,,2,2,3,5
11247_0,,,,2,2,3,5
11248_0,,,,2,2,3,5
11249_0,,,,2,2,3,5
11250_0,,,,2,2,3,5
11251_0,,,,2,2,3,5
11252_0,,,,2,2,3,5
11253_0,,,,2,2,3,5
11254_0,,,,2,2,3,5
11255_0,,,,2,2,3,5
11256_0,,,,2,2,3,5
11257_0,,,,2,2,3,5
11258_0,,,,2,2,3,5
11259_0,,,,2,2,3,5
11260_0,,,,2,2,3,5
11261_0,,,,2,2,3,5
11262_0,,,,2,2,3,5
11263_0,,,,2,2,3,5
11264_0,,,,2,2,3,5
11265_0,,,,2,2,3,5
11266_0,,,,2,2,3,5
11267_0,,,,2,2,3,5
11268_0,,,,2,2,3,5
11269_0,,,,2,2,3,5
11270_0,,,,2,2,3,5
11271_0,,,,2,2,3,5
11272_0,,,,2,2,3,5
11273_0,,,,2,2,3,5
11274_0,,,,2,2,3,5
11275_0,,,,2,2,3,5
11276_0,,,,2,2,3,5
11277_0,,,,2,2,3,5
11278_0,,,,2,2,3,5
11279_0,,,,2,2,3,5
11280_0,,,,2,2,3,5
11281_0,,,,2,2,3,5
11282_0,,,,2,2,3,5
11283_0,,,,2,2,3,5
11284_0,,,,2,2,3,5
11285_0,,,,2,2,3,5
11286_0,,,,2,2,3,5
11287_0,,,,2,2,3,5
11288_0,,,,2,2,3,5
11289_0,,,,2,2,3,5
11290_0,,,,2,2,3,5
11291_0,,,,2,2,3,5
11292_0,,,,2,2,3,5
11293_0,,,,2,2,3,5
11294_0,,,,2,2,3,5
11295_0,,,,2,2,3,5
11296_0,,,,2,2,3,5
11297_0,,,,2,2,3,5
11298_0,,,,2,2,3,5
11299_0,,,,2,2,3,5
11300_0,,,,2,2,3,5
11301_0,,,,2,2,3,5
11302_0,,,,2,2,3,5
11303_0,,,,2,2,3,5
11304_0,,,,2,2,3,5
11305_0,,,,2,2,3,5
11306_0,,,,2,2,3,5
11307_0,,,,2,2,3,5
11308_0,,,,2,2,3,5
11309_0,,,,2,2,3,5
11310_0,,,,2,2,3,5
11311_0,,,,2,2,3,5
11312_0,,,,2,2,3,5
11313_0,,,,2,2,3,5
11314_0,,,,2,2,3,5
11315_0,,,,2,2,3,5
11316_0,,,,2,2,3,5
11317_0,,,,2,2,3,5
11318_0,,,,2,2,3,5
11319_0,,,,2,2,3,5
11320_0,,,,2,2,3,5
11321_0,,,,2,2,3,5
11322_0,,,,2,2,3,5
11323_0,,,,2,2,3,5
11324_0,,,,2,2,3,5
11325_0,,,,2,2,3,5
11326_0,,,,2,2,3,5
11327_0,,,,2,2,3,5
11328_0,,,,2,2,3,5
11329_0,,,,2,2,3,5
11330_0,,,,2,2,3,5
11331_0,,,,2,2,3,5
11332_0,,,,2,2,3,5
11333_0,,,,2,2,3,5
11334_0,,,,2,2,3,5
11335_0,,,,2,2,3,5
11336_0,,,,2,2,3,5
11337_0,,,,2,2,3,5
11338_0,,,,2,2,3,5
11339_0,,,,2,2,3,5
11340_0,,,,2,2,3,5
11341_0,,,,2,2,3,5
11342_0,,,,2,2,3,5
11343_0,,,,2,2,3,5
11344_0,,,,2,2,3,5
11345_0,,,,2,2,3,5
11346_0,,,,2,2,3,5
11347_0,,,,2,2,3,5
11348_0,,,,2,2,3,5
11349_0,,,,2,2,3,5
11350_0,,,,2,2,3,5
11351_0,,,,2,2,3,5
11352_0,,,,2,2,3,5
11353_0,,,,2,2,3,5
11354_0,,,,2,2,3,5
11355_0,,,,2,2,3,5
11356_0,,,,2,2,3,5
11357_0,,,,2,2,3,5
11358_0,,,,2,2,3,5
11359_0,,,,2,2,3,5
11360_0,,,,2,2,3,5
11361_0,,,,2,2,3,5
11362_0,,,,2,2,3,5
11363_0,,,,2,2,3,5
11364_0,,,,2,2,3,5
11365_0,,,,2,2,3,5
11366_0,,,,2,2,3,5
11367_0,,,,2,2,3,5
11368_0,,,,2,2,3,5
11369_0,,,,2,2,3,5
11370_0,,,,2,2,3,5
11371_0,,,,2,2,3,5
11372_0,,,,2,2,3,5
11373_0,,,,2,2,3,5
11374_0,,,,2,2,3,5
11375_0,,,,2,2,3,5
11376_0,,,,2,2,3,5
11377_0,,,,2,2,3,5
11378_0,,,,2,2,3,5
11379_0,,,,2,2,3,5
11380_0,,,,2,2,3,5
11381_0,,,,2,2,3,5
11382_0,,,,2,2,3,5
11383_0,,,,2,2,3,5
11384_0,,,,2,2,3,5
11385_0,,,,2,2,3,5
11386_0,,,,2,2,3,5
11387_0,,,,2,2,3,5
11388_0,,,,2,2,3,5
11389_0,,,,2,2,3,5
11390_0,,,,2,2,3,5
11391_0,,,,2,2,3,5
11392_0,,,,2,2,3,5
11393_0,,,,2,2,3,5
11394_0,,,,2,2,3,5
11395_0,,,,2,2,3,5
11396_0,,,,2,2,3,5
11397_0,,,,2,2,3,5
11398_0,,,,2,2,3,5
11399_0,,,,2,2,3,5
11400_0,,,,2,2,3,5
11401_0,,,,2,2,3,5
11402_0,,,,2,2,3,5
11403_0,,,,2,2,3,5
11404_0,,,,2,2,3,5
11405_0,,,,2,2,3,5
11406_0,,,,2,2,3,5
11407_0,,,,2,2,3,5
11408_0,,,,2,2,3,5
11409_0,,,,2,2,3,5
11410_0,,,,2,2,3,5
11411_0,,,,2,2,3,5
11412_0,,,,2,2,3,5
11413_0,,,,2,2,3,5
11414_0,,,,2,2,3,5
11415_0,,,,2,2,3,5
11416_0,,,,2,2,3,5
11417_0,,,,2,2,3,5
11419_0,,,,2,2,3,5
C(C(C(CO)NCC(O)O)O)=O,,,3,1,1,0,1
11420_0,,,,2,2,3,5
11421_0,,,,2,2,3,5
11422_0,,,,2,2,3,5
11423_0,,,,2,2,3,5
11424_0,,,,2,2,3,5
11425_0,,,,2,2,3,5
11426_0,,,,2,2,3,5
11427_0,,,,2,2,3,5
11428_0,,,,2,2,3,5
11429_0,,,,2,2,3,5
11430_0,,,,2,2,3,5
11431_0,,,,2,2,3,5
11432_0,,,,2,2,3,5
11433_0,,,,2,2,3,5
11434_0,,,,2,2,3,5
11435_0,,,,2,2,3,5
11436_0,,,,2,2,3,5
11437_0,,,,2,2,3,5
11438_0,,,,2,2,3,5
11439_0,,,,2,2,3,5
11440_0,,,,2,2,3,5
11441_0,,,,2,2,3,5
11442_0,,,,2,2,3,5
11443_0,,,,2,2,3,5
11444_0,,,,2,2,3,5
11445_0,,,,2,2,3,5
11446_0,,,,2,2,3,5
11447_0,,,,2,2,3,5
11448_0,,,,2,2,3,5
11449_0,,,,2,2,3,5
11450_0,,,,2,2,3,5
11451_0,,,,2,2,3,5
11452_0,,,,2,2,3,5
11453_0,,,,2,2,3,5
11454_0,,,,2,2,3,5
11455_0,,,,2,2,3,5
11456_0,,,,2,2,3,5
11457_0,,,,2,2,3,5
11458_0,,,,2,2,3,5
11459_0,,,,2,2,3,5
11460_0,,,,2,2,3,5
11461_0,,,,2,2,3,5
11462_0,,,,2,2,3,5
11463_0,,,,2,2,3,5
11464_0,,,,2,2,3,5
11465_0,,,,2,2,3,5
11466_0,,,,2,2,3,5
11467_0,,,,2,2,3,5
11468_0,,,,2,2,3,5
11469_0,,,,2,2,3,5
11470_0,,,,2,2,3,5
11471_0,,,,2,2,3,5
11472_0,,,,2,2,3,5
11473_0,,,,2,2,3,5
11474_0,,,,2,2,3,5
11475_0,,,,2,2,3,5
11476_0,,,,2,2,3,5
11477_0,,,,2,2,3,5
11478_0,,,,2,2,3,5
11479_0,,,,2,2,3,5
11480_0,,,,2,2,3,5
11481_0,,,,2,2,3,5
11482_0,,,,2,2,3,5
11483_0,,,,2,2,3,5
11484_0,,,,2,2,3,5
11485_0,,,,2,2,3,5
11486_0,,,,2,2,3,5
11487_0,,,,2,2,3,5
11488_0,,,,2,2,3,5
11489_0,,,,2,2,3,5
11490_0,,,,2,2,3,5
11491_0,,,,2,2,3,5
11492_0,,,,2,2,3,5
11493_0,,,,2,2,3,5
11494_0,,,,2,2,3,5
11495_0,,,,2,2,3,5
11496_0,,,,2,2,3,5
11497_0,,,,2,2,3,5
11498_0,,,,2,2,3,5
11499_0,,,,2,2,3,5
11500_0,,,,2,2,3,5
11501_0,,,,2,2,3,5
11502_0,,,,2,2,3,5
11503_0,,,,2,2,3,5
11504_0,,,,2,2,3,5
11505_0,,,,2,2,3,5
11506_0,,,,2,2,3,5
11507_0,,,,2,2,3,5
11508_0,,,,2,2,3,5
11509_0,,,,2,2,3,5
11510_0,,,,2,2,3,5
11511_0,,,,2,2,3,5
11512_0,,,,2,2,3,5
11513_0,,,,2,2,3,5
11514_0,,,,2,2,3,5
11515_0,,,,2,2,3,5
11516_0,,,,2,2,3,5
11517_0,,,,2,2,3,5
11518_0,,,,2,2,3,5
11519_0,,,,2,2,3,5
11520_0,,,,2,2,3,5
11521_0,,,,2,2,3,5
11522_0,,,,2,2,3,5
11523_0,,,,2,2,3,5
11524_0,,,,2,2,3,5
11525_0,,,,2,2,3,5
11526_0,,,,2,2,3,5
11527_0,,,,2,2,3,5
11528_0,,,,2,2,3,5
11529_0,,,,2,2,3,5
11530_0,,,,2,2,3,5
11531_0,,,,2,2,3,5
11532_0,,,,2,2,3,5
11533_0,,,,2,2,3,5
11534_0,,,,2,2,3,5
11535_0,,,,2,2,3,5
11536_0,,,,2,2,3,5
11537_0,,,,2,2,3,5
11538_0,,,,2,2,3,5
11539_0,,,,2,2,3,5
11540_0,,,,2,2,3,5
11541_0,,,,2,2,3,5
11542_0,,,,2,2,3,5
11543_0,,,,2,2,3,5
11544_0,,,,2,2,3,5
11545_0,,,,2,2,3,5
11546_0,,,,2,2,3,5
11547_0,,,,2,2,3,5
11548_0,,,,2,2,3,5
11549_0,,,,2,2,3,5
11550_0,,,,2,2,3,5
11551_0,,,,2,2,3,5
11552_0,,,,2,2,3,5
11553_0,,,,2,2,3,5
11554_0,,,,2,2,3,5
11555_0,,,,2,2,3,5
11556_0,,,,2,2,3,5
11557_0,,,,2,2,3,5
11558_0,,,,2,2,3,5
11559_0,,,,2,2,3,5
11560_0,,,,2,2,3,5
11561_0,,,,2,2,3,5
11562_0,,,,2,2,3,5
11563_0,,,,2,2,3,5
11564_0,,,,2,2,3,5
11565_0,,,,2,2,3,5
11566_0,,,,2,2,3,5
11567_0,,,,2,2,3,5
11568_0,,,,2,2,3,5
11569_0,,,,2,2,3,5
11570_0,,,,2,2,3,5
11571_0,,,,2,2,3,5
11572_0,,,,2,2,3,5
11573_0,,,,2,2,3,5
11574_0,,,,2,2,3,5
11575_0,,,,2,2,3,5
11576_0,,,,2,2,3,5
11577_0,,,,2,2,3,5
11578_0,,,,2,2,3,5
11579_0,,,,2,2,3,5
11580_0,,,,2,2,3,5
11581_0,,,,2,2,3,5
11582_0,,,,2,2,3,5
11583_0,,,,2,2,3,5
11584_0,,,,2,2,3,5
11585_0,,,,2,2,3,5
11586_0,,,,2,2,3,5
11587_0,,,,2,2,3,5
11588_0,,,,2,2,3,5
11589_0,,,,2,2,3,5
11590_0,,,,2,2,3,5
11591_0,,,,2,2,3,5
11592_0,,,,2,2,3,5
11593_0,,,,2,2,3,5
11594_0,,,,2,2,3,5
11595_0,,,,2,2,3,5
11596_0,,,,2,2,3,5
11597_0,,,,2,2,3,5
11598_0,,,,2,2,3,5
11599_0,,,,2,2,3,5
11600_0,,,,2,2,3,5
11601_0,,,,2,2,3,5
11602_0,,,,2,2,3,5
11603_0,,,,2,2,3,5
11604_0,,,,2,2,3,5
11605_0,,,,2,2,3,5
11606_0,,,,2,2,3,5
11607_0,,,,2,2,3,5
11608_0,,,,2,2,3,5
11609_0,,,,2,2,3,5
11610_0,,,,2,2,3,5
11611_0,,,,2,2,3,5
11612_0,,,,2,2,3,5
11613_0,,,,2,2,3,5
11614_0,,,,2,2,3,5
11615_0,,,,2,2,3,5
11616_0,,,,2,2,3,5
11617_0,,,,2,2,3,5
11618_0,,,,2,2,3,5
11619_0,,,,2,2,3,5
11620_0,,,,2,2,3,5
11621_0,,,,2,2,3,5
11622_0,,,,2,2,3,5
11623_0,,,,2,2,3,5
11624_0,,,,2,2,3,5
11625_0,,,,2,2,3,5
11626_0,,,,2,2,3,5
11627_0,,,,2,2,3,5
11628_0,,,,2,2,3,5
11629_0,,,,2,2,3,5
11630_0,,,,2,2,3,5
11631_0,,,,2,2,3,5
11632_0,,,,2,2,3,5
11633_0,,,,2,2,3,5
11634_0,,,,2,2,3,5
11635_0,,,,2,2,3,5
11636_0,,,,2,2,3,5
11637_0,,,,2,2,3,5
11638_0,,,,2,2,3,5
11639_0,,,,2,2,3,5
11640_0,,,,2,2,3,5
11641_0,,,,2,2,3,5
11642_0,,,,2,2,3,5
11643_0,,,,2,2,3,5
11644_0,,,,2,2,3,5
11645_0,,,,2,2,3,5
11646_0,,,,2,2,3,5
11647_0,,,,2,2,3,5
11649_0,,,,2,2,3,5
C(CNC(CO)CO)=O,,,3,1,1,0,1
11651_0,,,,2,2,3,5
C(CNC(CO)CO)(C(CO)O)=O,,,3,1,1,0,1
11652_0,,,,2,2,3,5
11653_0,,,,2,2,3,5
11654_0,,,,2,2,3,5
11655_0,,,,2,2,3,5
11656_0,,,,2,2,3,5
11658_0,,,,2,2,3,5
C(C(C(CO)NC(CO)CO)O)=O,,,3,1,1,0,1
11660_0,,,,2,2,3,5
C(CC(CO)NCC=O)=O,,,3,1,1,0,1
11661_0,,,,2,2,3,5
11662_0,,,,2,2,3,5
11663_0,,,,2,2,3,5
11664_0,,,,2,2,3,5
11665_0,,,,2,2,3,5
11667_0,,,,2,2,3,5
C(C(C(C)NCC=O)O)=O,,,3,1,1,0,1
11668_0,,,,2,2,3,5
11669_0,,,,2,2,3,5
11670_0,,,,2,2,3,5
11671_0,,,,2,2,3,5
11672_0,,,,2,2,3,5
11674_0,,,,2,2,3,5
C(CNC(C)C(CO)O)=O,,,3,1,1,0,1
11675_0,,,,2,2,3,5
11676_0,,,,2,2,3,5
11677_0,,,,2,2,3,5
11678_0,,,,2,2,3,5
11679_0,,,,2,2,3,5
11681_0,,,,2,2,3,5
C(C(CC(CO)NCC=O)O)=O,,,3,1,1,0,1
11682_0,,,,2,2,3,5
11683_0,,,,2,2,3,5
11684_0,,,,2,2,3,5
11685_0,,,,2,2,3,5
11686_0,,,,2,2,3,5
11688_0,,,,2,2,3,5
C(CNC(CO)CCO)=O,,,3,1,1,0,1
11689_0,,,,2,2,3,5
11690_0,,,,2,2,3,5
11691_0,,,,2,2,3,5
11692_0,,,,2,2,3,5
11693_0,,,,2,2,3,5
11695_0,,,,2,2,3,5
C(C(C(C(C)NCC=O)O)O)=O,,,3,1,1,0,1
11696_0,,,,2,2,3,5
11697_0,,,,2,2,3,5
11698_0,,,,2,2,3,5
11699_0,,,,2,2,3,5
11700_0,,,,2,2,3,5
11702_0,,,,2,2,3,5
C(CNC(C)CO)=O,,,3,1,1,0,1
11704_0,,,,2,2,3,5
C(CNC(CO)C)(C(CO)O)=O,,,3,1,1,0,1
11705_0,,,,2,2,3,5
11706_0,,,,2,2,3,5
11707_0,,,,2,2,3,5
11708_0,,,,2,2,3,5
11709_0,,,,2,2,3,5
11711_0,,,,2,2,3,5
C(C(C(CO)NC(CO)C)O)=O,,,3,1,1,0,1
11713_0,,,,2,2,3,5
C(CNC(CO)C(CO)O)=O,,,3,1,1,0,1
11714_0,,,,2,2,3,5
11715_0,,,,2,2,3,5
11716_0,,,,2,2,3,5
11717_0,,,,2,2,3,5
11718_0,,,,2,2,3,5
11719_0,,,,2,2,3,5
11720_0,,,,2,2,3,5
11721_0,,,,2,2,3,5
11722_0,,,,2,2,3,5
11723_0,,,,2,2,3,5
11724_0,,,,2,2,3,5
11725_0,,,,2,2,3,5
11726_0,,,,2,2,3,5
11727_0,,,,2,2,3,5
11728_0,,,,2,2,3,5
11729_0,,,,2,2,3,5
11730_0,,,,2,2,3,5
11731_0,,,,2,2,3,5
11732_0,,,,2,2,3,5
11733_0,,,,2,2,3,5
11734_0,,,,2,2,3,5
11735_0,,,,2,2,3,5
11736_0,,,,2,2,3,5
11737_0,,,,2,2,3,5
11738_0,,,,2,2,3,5
11739_0,,,,2,2,3,5
11740_0,,,,2,2,3,5
11741_0,,,,2,2,3,5
11742_0,,,,2,2,3,5
11743_0,,,,2,2,3,5
11744_0,,,,2,2,3,5
11745_0,,,,2,2,3,5
11746_0,,,,2,2,3,5
11747_0,,,,2,2,3,5
11748_0,,,,2,2,3,5
11749_0,,,,2,2,3,5
11750_0,,,,2,2,3,5
11751_0,,,,2,2,3,5
11752_0,,,,2,2,3,5
11753_0,,,,2,2,3,5
11754_0,,,,2,2,3,5
11755_0,,,,2,2,3,5
11756_0,,,,2,2,3,5
11757_0,,,,2,2,3,5
11758_0,,,,2,2,3,5
11759_0,,,,2,2,3,5
11760_0,,,,2,2,3,5
11761_0,,,,2,2,3,5
11762_0,,,,2,2,3,5
11763_0,,,,2,2,3,5
11764_0,,,,2,2,3,5
11765_0,,,,2,2,3,5
11766_0,,,,2,2,3,5
11767_0,,,,2,2,3,5
11768_0,,,,2,2,3,5
11769_0,,,,2,2,3,5
11770_0,,,,2,2,3,5
11771_0,,,,2,2,3,5
11772_0,,,,2,2,3,5
11773_0,,,,2,2,3,5
11774_0,,,,2,2,3,5
11775_0,,,,2,2,3,5
11776_0,,,,2,2,3,5
11777_0,,,,2,2,3,5
11778_0,,,,2,2,3,5
11779_0,,,,2,2,3,5
11780_0,,,,2,2,3,5
11781_0,,,,2,2,3,5
11782_0,,,,2,2,3,5
11783_0,,,,2,2,3,5
11784_0,,,,2,2,3,5
11785_0,,,,2,2,3,5
11786_0,,,,2,2,3,5
11787_0,,,,2,2,3,5
11788_0,,,,2,2,3,5
11789_0,,,,2,2,3,5
11790_0,,,,2,2,3,5
11791_0,,,,2,2,3,5
11792_0,,,,2,2,3,5
11793_0,,,,2,2,3,5
11795_0,,,,2,2,3,5
C(CNC(CNC)C(CO)O)=O,,,3,1,1,0,1
11796_0,,,,2,2,3,5
11797_0,,,,2,2,3,5
11798_0,,,,2,2,3,5
11799_0,,,,2,2,3,5
11800_0,,,,2,2,3,5
11801_0,,,,2,2,3,5
11802_0,,,,2,2,3,5
11803_0,,,,2,2,3,5
11804_0,,,,2,2,3,5
11805_0,,,,2,2,3,5
11806_0,,,,2,2,3,5
11807_0,,,,2,2,3,5
11808_0,,,,2,2,3,5
11809_0,,,,2,2,3,5
11810_0,,,,2,2,3,5
11811_0,,,,2,2,3,5
11812_0,,,,2,2,3,5
11813_0,,,,2,2,3,5
11814_0,,,,2,2,3,5
11815_0,,,,2,2,3,5
11816_0,,,,2,2,3,5
11817_0,,,,2,2,3,5
11818_0,,,,2,2,3,5
11819_0,,,,2,2,3,5
11820_0,,,,2,2,3,5
11821_0,,,,2,2,3,5
11822_0,,,,2,2,3,5
11823_0,,,,2,2,3,5
11824_0,,,,2,2,3,5
11825_0,,,,2,2,3,5
11826_0,,,,2,2,3,5
11827_0,,,,2,2,3,5
11828_0,,,,2,2,3,5
11829_0,,,,2,2,3,5
11830_0,,,,2,2,3,5
11831_0,,,,2,2,3,5
11832_0,,,,2,2,3,5
11833_0,,,,2,2,3,5
11834_0,,,,2,2,3,5
11835_0,,,,2,2,3,5
11836_0,,,,2,2,3,5
11837_0,,,,2,2,3,5
11838_0,,,,2,2,3,5
11839_0,,,,2,2,3,5
11840_0,,,,2,2,3,5
11841_0,,,,2,2,3,5
11842_0,,,,2,2,3,5
11843_0,,,,2,2,3,5
11844_0,,,,2,2,3,5
11845_0,,,,2,2,3,5
11846_0,,,,2,2,3,5
11847_0,,,,2,2,3,5
11848_0,,,,2,2,3,5
11849_0,,,,2,2,3,5
11850_0,,,,2,2,3,5
11851_0,,,,2,2,3,5
11852_0,,,,2,2,3,5
11853_0,,,,2,2,3,5
11854_0,,,,2,2,3,5
11855_0,,,,2,2,3,5
11856_0,,,,2,2,3,5
11857_0,,,,2,2,3,5
11858_0,,,,2,2,3,5
11859_0,,,,2,2,3,5
11860_0,,,,2,2,3,5
11861_0,,,,2,2,3,5
11862_0,,,,2,2,3,5
11863_0,,,,2,2,3,5
11864_0,,,,2,2,3,5
11865_0,,,,2,2,3,5
11866_0,,,,2,2,3,5
11867_0,,,,2,2,3,5
11868_0,,,,2,2,3,5
11869_0,,,,2,2,3,5
11870_0,,,,2,2,3,5
11871_0,,,,2,2,3,5
11872_0,,,,2,2,3,5
11873_0,,,,2,2,3,5
11874_0,,,,2,2,3,5
11875_0,,,,2,2,3,5
11877_0,,,,2,2,3,5
C(CNC(CCO)CC(C=O)=O)=O,,,3,1,1,0,1
11879_0,,,,2,2,3,5
C(CNC(CCC(C=O)=O)CO)=O,,,3,1,1,0,1
11881_0,,,,2,2,3,5
C(CNC(C)C(CC(C=O)=O)O)=O,,,3,1,1,0,1
11883_0,,,,2,2,3,5
C(CNC(CC=O)CC(CO)=O)=O,,,3,1,1,0,1
11885_0,,,,2,2,3,5
C(CC(CO)NCC=O)(CC=O)=O,,,3,1,1,0,1
11887_0,,,,2,2,3,5
C(C)(C(C(CC=O)NCC=O)O)=O,,,3,1,1,0,1
11889_0,,,,2,2,3,5
C(C(C(C)NCC=O)O)(CC=O)=O,,,3,1,1,0,1
11891_0,,,,2,2,3,5
C(CC(C(CC=O)NCC=O)O)=O,,,3,1,1,0,1
11893_0,,,,2,2,3,5
C(C)(CC(C(C=O)O)NCC=O)=O,,,3,1,1,0,1
11895_0,,,,2,2,3,5
C(CC(C)NCC=O)(C(C=O)O)=O,,,3,1,1,0,1
11897_0,,,,2,2,3,5
C(CCC(C(C=O)O)NCC=O)=O,,,3,1,1,0,1
11899_0,,,,2,2,3,5
C(CC(CC(C=O)O)NCC=O)=O,,,3,1,1,0,1
11901_0,,,,2,2,3,5
C(CNC(C=CCO)C(C=O)O)=O,,,3,1,1,0,1
11903_0,,,,2,2,3,5
C(CNC(C=CC=O)C(CO)O)=O,,,3,1,1,0,1
11905_0,,,,2,2,3,5
C(C(C(C(C=C)NCC=O)O)O)=O,,,3,1,1,0,1
11907_0,,,,2,2,3,5
C(C(C=CC(CO)NCC=O)O)=O,,,3,1,1,0,1
11908_0,,,,2,2,3,5
11909_0,,,,2,2,3,5
11910_0,,,,2,2,3,5
11911_0,,,,2,2,3,5
11912_0,,,,2,2,3,5
11913_0,,,,2,2,3,5
11914_0,,,,2,2,3,5
11915_0,,,,2,2,3,5
11916_0,,,,2,2,3,5
11917_0,,,,2,2,3,5
11918_0,,,,2,2,3,5
11919_0,,,,2,2,3,5
11920_0,,,,2,2,3,5
11921_0,,,,2,2,3,5
11922_0,,,,2,2,3,5
11923_0,,,,2,2,3,5
11924_0,,,,2,2,3,5
11925_0,,,,2,2,3,5
11926_0,,,,2,2,3,5
11927_0,,,,2,2,3,5
11928_0,,,,2,2,3,5
11929_0,,,,2,2,3,5
11930_0,,,,2,2,3,5
11931_0,,,,2,2,3,5
11932_0,,,,2,2,3,5
11933_0,,,,2,2,3,5
11934_0,,,,2,2,3,5
11935_0,,,,2,2,3,5
11936_0,,,,2,2,3,5
11937_0,,,,2,2,3,5
11938_0,,,,2,2,3,5
11939_0,,,,2,2,3,5
11940_0,,,,2,2,3,5
11941_0,,,,2,2,3,5
11942_0,,,,2,2,3,5
11943_0,,,,2,2,3,5
11944_0,,,,2,2,3,5
11945_0,,,,2,2,3,5
11946_0,,,,2,2,3,5
11947_0,,,,2,2,3,5
11948_0,,,,2,2,3,5
11949_0,,,,2,2,3,5
11950_0,,,,2,2,3,5
11951_0,,,,2,2,3,5
11952_0,,,,2,2,3,5
11953_0,,,,2,2,3,5
11954_0,,,,2,2,3,5
11955_0,,,,2,2,3,5
11956_0,,,,2,2,3,5
11957_0,,,,2,2,3,5
11958_0,,,,2,2,3,5
11959_0,,,,2,2,3,5
11960_0,,,,2,2,3,5
11961_0,,,,2,2,3,5
11962_0,,,,2,2,3,5
11963_0,,,,2,2,3,5
11964_0,,,,2,2,3,5
11965_0,,,,2,2,3,5
11966_0,,,,2,2,3,5
11967_0,,,,2,2,3,5
11968_0,,,,2,2,3,5
11969_0,,,,2,2,3,5
11970_0,,,,2,2,3,5
11971_0,,,,2,2,3,5
11972_0,,,,2,2,3,5
11973_0,,,,2,2,3,5
11974_0,,,,2,2,3,5
11975_0,,,,2,2,3,5
11976_0,,,,2,2,3,5
11977_0,,,,2,2,3,5
11978_0,,,,2,2,3,5
11979_0,,,,2,2,3,5
11980_0,,,,2,2,3,5
11981_0,,,,2,2,3,5
11982_0,,,,2,2,3,5
11983_0,,,,2,2,3,5
11984_0,,,,2,2,3,5
11985_0,,,,2,2,3,5
11986_0,,,,2,2,3,5
11987_0,,,,2,2,3,5
11988_0,,,,2,2,3,5
11989_0,,,,2,2,3,5
11990_0,,,,2,2,3,5
11991_0,,,,2,2,3,5
11992_0,,,,2,2,3,5
11993_0,,,,2,2,3,5
11994_0,,,,2,2,3,5
11995_0,,,,2,2,3,5
11996_0,,,,2,2,3,5
11997_0,,,,2,2,3,5
11998_0,,,,2,2,3,5
11999_0,,,,2,2,3,5
12000_0,,,,2,2,3,5
12001_0,,,,2,2,3,5
12002_0,,,,2,2,3,5
12003_0,,,,2,2,3,5
12004_0,,,,2,2,3,5
12005_0,,,,2,2,3,5
12006_0,,,,2,2,3,5
12007_0,,,,2,2,3,5
12008_0,,,,2,2,3,5
12009_0,,,,2,2,3,5
12010_0,,,,2,2,3,5
12011_0,,,,2,2,3,5
12012_0,,,,2,2,3,5
12013_0,,,,2,2,3,5
12014_0,,,,2,2,3,5
12015_0,,,,2,2,3,5
12016_0,,,,2,2,3,5
12017_0,,,,2,2,3,5
12018_0,,,,2,2,3,5
12019_0,,,,2,2,3,5
12020_0,,,,2,2,3,5
12021_0,,,,2,2,3,5
12022_0,,,,2,2,3,5
12023_0,,,,2,2,3,5
12024_0,,,,2,2,3,5
12025_0,,,,2,2,3,5
12026_0,,,,2,2,3,5
12027_0,,,,2,2,3,5
12028_0,,,,2,2,3,5
12029_0,,,,2,2,3,5
12030_0,,,,2,2,3,5
12031_0,,,,2,2,3,5
12032_0,,,,2,2,3,5
12033_0,,,,2,2,3,5
12034_0,,,,2,2,3,5
12035_0,,,,2,2,3,5
12036_0,,,,2,2,3,5
12037_0,,,,2,2,3,5
12038_0,,,,2,2,3,5
12039_0,,,,2,2,3,5
12040_0,,,,2,2,3,5
12041_0,,,,2,2,3,5
12042_0,,,,2,2,3,5
12043_0,,,,2,2,3,5
12044_0,,,,2,2,3,5
12045_0,,,,2,2,3,5
12046_0,,,,2,2,3,5
12047_0,,,,2,2,3,5
12048_0,,,,2,2,3,5
12049_0,,,,2,2,3,5
12050_0,,,,2,2,3,5
12051_0,,,,2,2,3,5
12052_0,,,,2,2,3,5
12053_0,,,,2,2,3,5
12054_0,,,,2,2,3,5
12055_0,,,,2,2,3,5
12056_0,,,,2,2,3,5
12057_0,,,,2,2,3,5
12058_0,,,,2,2,3,5
12059_0,,,,2,2,3,5
12060_0,,,,2,2,3,5
12061_0,,,,2,2,3,5
12062_0,,,,2,2,3,5
12063_0,,,,2,2,3,5
12064_0,,,,2,2,3,5
12065_0,,,,2,2,3,5
12066_0,,,,2,2,3,5
12067_0,,,,2,2,3,5
12068_0,,,,2,2,3,5
12069_0,,,,2,2,3,5
12070_0,,,,2,2,3,5
12071_0,,,,2,2,3,5
12072_0,,,,2,2,3,5
12073_0,,,,2,2,3,5
12074_0,,,,2,2,3,5
12075_0,,,,2,2,3,5
12076_0,,,,2,2,3,5
12077_0,,,,2,2,3,5
12078_0,,,,2,2,3,5
12079_0,,,,2,2,3,5
12080_0,,,,2,2,3,5
12081_0,,,,2,2,3,5
12082_0,,,,2,2,3,5
12083_0,,,,2,2,3,5
12084_0,,,,2,2,3,5
12085_0,,,,2,2,3,5
12086_0,,,,2,2,3,5
12087_0,,,,2,2,3,5
12088_0,,,,2,2,3,5
12089_0,,,,2,2,3,5
12090_0,,,,2,2,3,5
12091_0,,,,2,2,3,5
12092_0,,,,2,2,3,5
12093_0,,,,2,2,3,5
12094_0,,,,2,2,3,5
12095_0,,,,2,2,3,5
12096_0,,,,2,2,3,5
12097_0,,,,2,2,3,5
12098_0,,,,2,2,3,5
12099_0,,,,2,2,3,5
12100_0,,,,2,2,3,5
12101_0,,,,2,2,3,5
12102_0,,,,2,2,3,5
12103_0,,,,2,2,3,5
12104_0,,,,2,2,3,5
12105_0,,,,2,2,3,5
12106_0,,,,2,2,3,5
12107_0,,,,2,2,3,5
12108_0,,,,2,2,3,5
12109_0,,,,2,2,3,5
12110_0,,,,2,2,3,5
12111_0,,,,2,2,3,5
12112_0,,,,2,2,3,5
12113_0,,,,2,2,3,5
12114_0,,,,2,2,3,5
12115_0,,,,2,2,3,5
12116_0,,,,2,2,3,5
12117_0,,,,2,2,3,5
12118_0,,,,2,2,3,5
12119_0,,,,2,2,3,5
12120_0,,,,2,2,3,5
12121_0,,,,2,2,3,5
12122_0,,,,2,2,3,5
12123_0,,,,2,2,3,5
12124_0,,,,2,2,3,5
12125_0,,,,2,2,3,5
12126_0,,,,2,2,3,5
12127_0,,,,2,2,3,5
12128_0,,,,2,2,3,5
12129_0,,,,2,2,3,5
12130_0,,,,2,2,3,5
12131_0,,,,2,2,3,5
12132_0,,,,2,2,3,5
12133_0,,,,2,2,3,5
12134_0,,,,2,2,3,5
12135_0,,,,2,2,3,5
12136_0,,,,2,2,3,5
12137_0,,,,2,2,3,5
12138_0,,,,2,2,3,5
12139_0,,,,2,2,3,5
12140_0,,,,2,2,3,5
12141_0,,,,2,2,3,5
12142_0,,,,2,2,3,5
12143_0,,,,2,2,3,5
12144_0,,,,2,2,3,5
12145_0,,,,2,2,3,5
12146_0,,,,2,2,3,5
12147_0,,,,2,2,3,5
12148_0,,,,2,2,3,5
12149_0,,,,2,2,3,5
12150_0,,,,2,2,3,5
12151_0,,,,2,2,3,5
12152_0,,,,2,2,3,5
12153_0,,,,2,2,3,5
12154_0,,,,2,2,3,5
12155_0,,,,2,2,3,5
12156_0,,,,2,2,3,5
12157_0,,,,2,2,3,5
12158_0,,,,2,2,3,5
12159_0,,,,2,2,3,5
12160_0,,,,2,2,3,5
12161_0,,,,2,2,3,5
12162_0,,,,2,2,3,5
12163_0,,,,2,2,3,5
12164_0,,,,2,2,3,5
12165_0,,,,2,2,3,5
12166_0,,,,2,2,3,5
12167_0,,,,2,2,3,5
12168_0,,,,2,2,3,5
12169_0,,,,2,2,3,5
12170_0,,,,2,2,3,5
12171_0,,,,2,2,3,5
12172_0,,,,2,2,3,5
12173_0,,,,2,2,3,5
12174_0,,,,2,2,3,5
12175_0,,,,2,2,3,5
12176_0,,,,2,2,3,5
12177_0,,,,2,2,3,5
12178_0,,,,2,2,3,5
12179_0,,,,2,2,3,5
12180_0,,,,2,2,3,5
12181_0,,,,2,2,3,5
12182_0,,,,2,2,3,5
12183_0,,,,2,2,3,5
12184_0,,,,2,2,3,5
12185_0,,,,2,2,3,5
12186_0,,,,2,2,3,5
12187_0,,,,2,2,3,5
12188_0,,,,2,2,3,5
12189_0,,,,2,2,3,5
12190_0,,,,2,2,3,5
12191_0,,,,2,2,3,5
12192_0,,,,2,2,3,5
12193_0,,,,2,2,3,5
12194_0,,,,2,2,3,5
12195_0,,,,2,2,3,5
12196_0,,,,2,2,3,5
12197_0,,,,2,2,3,5
12198_0,,,,2,2,3,5
12199_0,,,,2,2,3,5
12200_0,,,,2,2,3,5
12201_0,,,,2,2,3,5
12202_0,,,,2,2,3,5
12203_0,,,,2,2,3,5
12204_0,,,,2,2,3,5
12205_0,,,,2,2,3,5
12206_0,,,,2,2,3,5
12207_0,,,,2,2,3,5
12208_0,,,,2,2,3,5
12209_0,,,,2,2,3,5
12210_0,,,,2,2,3,5
12211_0,,,,2,2,3,5
12212_0,,,,2,2,3,5
12213_0,,,,2,2,3,5
12214_0,,,,2,2,3,5
12215_0,,,,2,2,3,5
12216_0,,,,2,2,3,5
12217_0,,,,2,2,3,5
12218_0,,,,2,2,3,5
12219_0,,,,2,2,3,5
12220_0,,,,2,2,3,5
12221_0,,,,2,2,3,5
12222_0,,,,2,2,3,5
12223_0,,,,2,2,3,5
12224_0,,,,2,2,3,5
12225_0,,,,2,2,3,5
12226_0,,,,2,2,3,5
12227_0,,,,2,2,3,5
12228_0,,,,2,2,3,5
12229_0,,,,2,2,3,5
12230_0,,,,2,2,3,5
12231_0,,,,2,2,3,5
12232_0,,,,2,2,3,5
12233_0,,,,2,2,3,5
12234_0,,,,2,2,3,5
12235_0,,,,2,2,3,5
12236_0,,,,2,2,3,5
12237_0,,,,2,2,3,5
12238_0,,,,2,2,3,5
12239_0,,,,2,2,3,5
12240_0,,,,2,2,3,5
12241_0,,,,2,2,3,5
12242_0,,,,2,2,3,5
12243_0,,,,2,2,3,5
12244_0,,,,2,2,3,5
12245_0,,,,2,2,3,5
12246_0,,,,2,2,3,5
12247_0,,,,2,2,3,5
12248_0,,,,2,2,3,5
12249_0,,,,2,2,3,5
12250_0,,,,2,2,3,5
12251_0,,,,2,2,3,5
12252_0,,,,2,2,3,5
12253_0,,,,2,2,3,5
12254_0,,,,2,2,3,5
12255_0,,,,2,2,3,5
12256_0,,,,2,2,3,5
12257_0,,,,2,2,3,5
12258_0,,,,2,2,3,5
12259_0,,,,2,2,3,5
12260_0,,,,2,2,3,5
12261_0,,,,2,2,3,5
12262_0,,,,2,2,3,5
12263_0,,,,2,2,3,5
12264_0,,,,2,2,3,5
12265_0,,,,2,2,3,5
12266_0,,,,2,2,3,5
12267_0,,,,2,2,3,5
12268_0,,,,2,2,3,5
12269_0,,,,2,2,3,5
12270_0,,,,2,2,3,5
12271_0,,,,2,2,3,5
12272_0,,,,2,2,3,5
12273_0,,,,2,2,3,5
12274_0,,,,2,2,3,5
12275_0,,,,2,2,3,5
12276_0,,,,2,2,3,5
12277_0,,,,2,2,3,5
12278_0,,,,2,2,3,5
12279_0,,,,2,2,3,5
12280_0,,,,2,2,3,5
12281_0,,,,2,2,3,5
12282_0,,,,2,2,3,5
12283_0,,,,2,2,3,5
12284_0,,,,2,2,3,5
12285_0,,,,2,2,3,5
12286_0,,,,2,2,3,5
12287_0,,,,2,2,3,5
12288_0,,,,2,2,3,5
12289_0,,,,2,2,3,5
12290_0,,,,2,2,3,5
12291_0,,,,2,2,3,5
12292_0,,,,2,2,3,5
12293_0,,,,2,2,3,5
12294_0,,,,2,2,3,5
12295_0,,,,2,2,3,5
12296_0,,,,2,2,3,5
12297_0,,,,2,2,3,5
12298_0,,,,2,2,3,5
12299_0,,,,2,2,3,5
12300_0,,,,2,2,3,5
12301_0,,,,2,2,3,5
12302_0,,,,2,2,3,5
12303_0,,,,2,2,3,5
12304_0,,,,2,2,3,5
12305_0,,,,2,2,3,5
12306_0,,,,2,2,3,5
12307_0,,,,2,2,3,5
12308_0,,,,2,2,3,5
12309_0,,,,2,2,3,5
12310_0,,,,2,2,3,5
12311_0,,,,2,2,3,5
12312_0,,,,2,2,3,5
12313_0,,,,2,2,3,5
12314_0,,,,2,2,3,5
12315_0,,,,2,2,3,5
12316_0,,,,2,2,3,5
12317_0,,,,2,2,3,5
12318_0,,,,2,2,3,5
12319_0,,,,2,2,3,5
12320_0,,,,2,2,3,5
12321_0,,,,2,2,3,5
12322_0,,,,2,2,3,5
12323_0,,,,2,2,3,5
12324_0,,,,2,2,3,5
12325_0,,,,2,2,3,5
12326_0,,,,2,2,3,5
12327_0,,,,2,2,3,5
12328_0,,,,2,2,3,5
12329_0,,,,2,2,3,5
12330_0,,,,2,2,3,5
12331_0,,,,2,2,3,5
12332_0,,,,2,2,3,5
12333_0,,,,2,2,3,5
12334_0,,,,2,2,3,5
12335_0,,,,2,2,3,5
12336_0,,,,2,2,3,5
12337_0,,,,2,2,3,5
12338_0,,,,2,2,3,5
12339_0,,,,2,2,3,5
12340_0,,,,2,2,3,5
12341_0,,,,2,2,3,5
12342_0,,,,2,2,3,5
12343_0,,,,2,2,3,5
12344_0,,,,2,2,3,5
12345_0,,,,2,2,3,5
12346_0,,,,2,2,3,5
12347_0,,,,2,2,3,5
12348_0,,,,2,2,3,5
12349_0,,,,2,2,3,5
12350_0,,,,2,2,3,5
12351_0,,,,2,2,3,5
12352_0,,,,2,2,3,5
12353_0,,,,2,2,3,5
12354_0,,,,2,2,3,5
12355_0,,,,2,2,3,5
12356_0,,,,2,2,3,5
12357_0,,,,2,2,3,5
12358_0,,,,2,2,3,5
12359_0,,,,2,2,3,5
12360_0,,,,2,2,3,5
12361_0,,,,2,2,3,5
12362_0,,,,2,2,3,5
12363_0,,,,2,2,3,5
12364_0,,,,2,2,3,5
12365_0,,,,2,2,3,5
12366_0,,,,2,2,3,5
12367_0,,,,2,2,3,5
12368_0,,,,2,2,3,5
12369_0,,,,2,2,3,5
12370_0,,,,2,2,3,5
12371_0,,,,2,2,3,5
12372_0,,,,2,2,3,5
12373_0,,,,2,2,3,5
12374_0,,,,2,2,3,5
12375_0,,,,2,2,3,5
12376_0,,,,2,2,3,5
12377_0,,,,2,2,3,5
12378_0,,,,2,2,3,5
12379_0,,,,2,2,3,5
12380_0,,,,2,2,3,5
12381_0,,,,2,2,3,5
12382_0,,,,2,2,3,5
12383_0,,,,2,2,3,5
12384_0,,,,2,2,3,5
12385_0,,,,2,2,3,5
12386_0,,,,2,2,3,5
12387_0,,,,2,2,3,5
12388_0,,,,2,2,3,5
12389_0,,,,2,2,3,5
12390_0,,,,2,2,3,5
12391_0,,,,2,2,3,5
12392_0,,,,2,2,3,5
12393_0,,,,2,2,3,5
12394_0,,,,2,2,3,5
12395_0,,,,2,2,3,5
12396_0,,,,2,2,3,5
12397_0,,,,2,2,3,5
12398_0,,,,2,2,3,5
12399_0,,,,2,2,3,5
12400_0,,,,2,2,3,5
12401_0,,,,2,2,3,5
12402_0,,,,2,2,3,5
12403_0,,,,2,2,3,5
12404_0,,,,2,2,3,5
12405_0,,,,2,2,3,5
12406_0,,,,2,2,3,5
12407_0,,,,2,2,3,5
12408_0,,,,2,2,3,5
12409_0,,,,2,2,3,5
12410_0,,,,2,2,3,5
12411_0,,,,2,2,3,5
12412_0,,,,2,2,3,5
12413_0,,,,2,2,3,5
12414_0,,,,2,2,3,5
12415_0,,,,2,2,3,5
12416_0,,,,2,2,3,5
12417_0,,,,2,2,3,5
12418_0,,,,2,2,3,5
12419_0,,,,2,2,3,5
12420_0,,,,2,2,3,5
12421_0,,,,2,2,3,5
12422_0,,,,2,2,3,5
12423_0,,,,2,2,3,5
12424_0,,,,2,2,3,5
12425_0,,,,2,2,3,5
12426_0,,,,2,2,3,5
12427_0,,,,2,2,3,5
12428_0,,,,2,2,3,5
12429_0,,,,2,2,3,5
12430_0,,,,2,2,3,5
12431_0,,,,2,2,3,5
12432_0,,,,2,2,3,5
12433_0,,,,2,2,3,5
12434_0,,,,2,2,3,5
12435_0,,,,2,2,3,5
12436_0,,,,2,2,3,5
12437_0,,,,2,2,3,5
12438_0,,,,2,2,3,5
12439_0,,,,2,2,3,5
12440_0,,,,2,2,3,5
12441_0,,,,2,2,3,5
12442_0,,,,2,2,3,5
12443_0,,,,2,2,3,5
12444_0,,,,2,2,3,5
12445_0,,,,2,2,3,5
12446_0,,,,2,2,3,5
12447_0,,,,2,2,3,5
12448_0,,,,2,2,3,5
12449_0,,,,2,2,3,5
12450_0,,,,2,2,3,5
12451_0,,,,2,2,3,5
12452_0,,,,2,2,3,5
12453_0,,,,2,2,3,5
12454_0,,,,2,2,3,5
12455_0,,,,2,2,3,5
12456_0,,,,2,2,3,5
12457_0,,,,2,2,3,5
12458_0,,,,2,2,3,5
12459_0,,,,2,2,3,5
12460_0,,,,2,2,3,5
12461_0,,,,2,2,3,5
12462_0,,,,2,2,3,5
12463_0,,,,2,2,3,5
12464_0,,,,2,2,3,5
12465_0,,,,2,2,3,5
12466_0,,,,2,2,3,5
12467_0,,,,2,2,3,5
12468_0,,,,2,2,3,5
12469_0,,,,2,2,3,5
12470_0,,,,2,2,3,5
12471_0,,,,2,2,3,5
12472_0,,,,2,2,3,5
12473_0,,,,2,2,3,5
12474_0,,,,2,2,3,5
12475_0,,,,2,2,3,5
12476_0,,,,2,2,3,5
12477_0,,,,2,2,3,5
12478_0,,,,2,2,3,5
12479_0,,,,2,2,3,5
12480_0,,,,2,2,3,5
12481_0,,,,2,2,3,5
12482_0,,,,2,2,3,5
12483_0,,,,2,2,3,5
12484_0,,,,2,2,3,5
12485_0,,,,2,2,3,5
12486_0,,,,2,2,3,5
12487_0,,,,2,2,3,5
12488_0,,,,2,2,3,5
12489_0,,,,2,2,3,5
12490_0,,,,2,2,3,5
12491_0,,,,2,2,3,5
12492_0,,,,2,2,3,5
12493_0,,,,2,2,3,5
12494_0,,,,2,2,3,5
12495_0,,,,2,2,3,5
12496_0,,,,2,2,3,5
12497_0,,,,2,2,3,5
12498_0,,,,2,2,3,5
12499_0,,,,2,2,3,5
12500_0,,,,2,2,3,5
12501_0,,,,2,2,3,5
12502_0,,,,2,2,3,5
12503_0,,,,2,2,3,5
12504_0,,,,2,2,3,5
12505_0,,,,2,2,3,5
12506_0,,,,2,2,3,5
12507_0,,,,2,2,3,5
12508_0,,,,2,2,3,5
12509_0,,,,2,2,3,5
12510_0,,,,2,2,3,5
12511_0,,,,2,2,3,5
12512_0,,,,2,2,3,5
12513_0,,,,2,2,3,5
12514_0,,,,2,6,4,10
12516_0,,,,2,6,4,10
C(C(N)O)(O)=O,,,3,1,1,0,1
12517_0,,,,2,6,4,10
12518_0,,,,2,6,4,10
12520_0,,,,2,3,5,8
C(C(C(C(O)=O)=O)O)=O,,,3,1,1,0,1
12521_0,,,,2,3,5,8
12522_0,,,,2,3,5,8
12523_0,,,,2,3,5,8
12524_0,,,,2,3,5,8
12525_0,,,,2,3,5,8
12526_0,,,,2,3,5,8
12527_0,,,,2,3,5,8
12529_0,,,,2,3,5,8
C(C(C(C(O)=O)=O)(C(CO)O)O)=O,,,3,1,1,0,1
12531_0,,,,2,3,5,8
C(C(C(C(O)=O)=O)N)(O)=O,,,3,1,1,0,1
12532_0,,,,2,3,5,8
12533_0,,,,2,3,5,8
12534_0,,,,2,3,5,8
12535_0,,,,2,3,5,8
12536_0,,,,2,3,5,8
12537_0,,,,2,3,5,8
12538_0,,,,2,5,3,8
12539_0,,,,2,5,3,8
12540_0,,,,2,5,3,8
12542_0,,,,2,2,2,4
C(CC(C(O)=O)O)(O)=O,,,3,1,1,0,1
12543_0,,,,2,2,2,4
12544_0,,,,2,2,2,4
12545_0,,,,2,2,2,4
12546_0,,,,2,2,2,4
12547_0,,,,2,2,2,4
12548_0,,,,2,2,2,4
12549_0,,,,2,2,2,4
12550_0,,,,2,2,2,4
12551_0,,,,2,2,2,4
12552_0,,,,2,2,2,4
12553_0,,,,2,2,2,4
12554_0,,,,2,2,2,4
12555_0,,,,2,2,2,4
12556_0,,,,2,2,2,4
12557_0,,,,2,2,2,4
12558_0,,,,2,2,2,4
12559_0,,,,2,2,2,4
12560_0,,,,2,2,2,4
12561_0,,,,2,2,2,4
12562_0,,,,2,2,2,4
12563_0,,,,2,2,2,4
12564_0,,,,2,2,2,4
12565_0,,,,2,2,2,4
12566_0,,,,2,2,2,4
12567_0,,,,2,3,5,8
12568_0,,,,2,3,5,8
12569_0,,,,2,3,5,8
12570_0,,,,2,3,5,8
12571_0,,,,2,3,5,8
12572_0,,,,2,3,5,8
12573_0,,,,2,3,5,8
12574_0,,,,2,3,5,8
12575_0,,,,2,3,5,8
12576_0,,,,2,3,5,8
12577_0,,,,2,3,5,8
12578_0,,,,2,3,5,8
12579_0,,,,2,3,5,8
12580_0,,,,2,3,5,8
12581_0,,,,2,3,5,8
12582_0,,,,2,3,5,8
12583_0,,,,2,3,5,8
12584_0,,,,2,3,5,8
12585_0,,,,2,3,5,8
12586_0,,,,2,3,5,8
12587_0,,,,2,3,5,8
12588_0,,,,2,3,5,8
12589_0,,,,2,3,5,8
12590_0,,,,2,3,5,8
12591_0,,,,2,3,5,8
12592_0,,,,2,3,5,8
12593_0,,,,2,3,5,8
12594_0,,,,2,3,5,8
12595_0,,,,2,3,5,8
12596_0,,,,2,3,5,8
12597_0,,,,2,3,5,8
12598_0,,,,2,3,5,8
12599_0,,,,2,3,5,8
12600_0,,,,2,3,5,8
12601_0,,,,2,3,5,8
12602_0,,,,2,3,5,8
12603_0,,,,2,3,5,8
12604_0,,,,2,3,5,8
12605_0,,,,2,3,5,8
12606_0,,,,2,3,5,8
12607_0,,,,2,3,5,8
12608_0,,,,2,3,5,8
12609_0,,,,2,3,5,8
12610_0,,,,2,3,5,8
12611_0,,,,2,3,5,8
12612_0,,,,2,3,5,8
12613_0,,,,2,3,5,8
12614_0,,,,2,3,5,8
12615_0,,,,2,3,5,8
12616_0,,,,2,3,5,8
12617_0,,,,2,3,5,8
12619_0,,,,2,5,3,8
C(C(C(CO)C(C(CO)O)O)O)=O,,,3,1,1,0,1
12620_0,,,,2,5,3,8
12621_0,,,,2,5,3,8
12622_0,,,,2,5,3,8
12623_0,,,,2,5,3,8
12624_0,,,,2,5,3,8
12626_0,,,,2,5,3,8
C(C(C(CC(CO)O)NC)O)=O,,,3,1,1,0,1
12627_0,,,,2,5,3,8
12628_0,,,,2,5,3,8
12629_0,,,,2,5,3,8
12630_0,,,,2,5,3,8
12631_0,,,,2,5,3,8
12632_0,,,,2,5,3,8
12633_0,,,,2,5,3,8
12634_0,,,,2,5,3,8
12635_0,,,,2,5,3,8
12636_0,,,,2,5,3,8
12637_0,,,,2,5,3,8
12639_0,,,,2,5,3,8
C(C(CC(C(CO)O)NC)O)=O,,,3,1,1,0,1
12640_0,,,,2,5,3,8
12641_0,,,,2,5,3,8
12642_0,,,,2,4,4,8
12643_0,,,,2,4,4,8
12644_0,,,,2,4,4,8
12645_0,,,,2,4,4,8
12646_0,,,,2,4,4,8
12647_0,,,,2,4,4,8
12648_0,,,,2,4,4,8
12649_0,,,,2,4,4,8
12650_0,,,,2,4,4,8
12651_0,,,,2,4,4,8
12652_0,,,,2,4,4,8
12653_0,,,,2,4,4,8
12654_0,,,,2,4,4,8
12655_0,,,,2,4,4,8
12656_0,,,,2,4,4,8
12657_0,,,,2,4,4,8
12658_0,,,,2,4,4,8
12659_0,,,,2,4,4,8
12660_0,,,,2,4,4,8
12661_0,,,,2,4,4,8
12662_0,,,,2,4,4,8
12663_0,,,,2,4,4,8
12664_0,,,,2,4,4,8
12665_0,,,,2,4,4,8
12666_0,,,,2,4,4,8
12667_0,,,,2,4,4,8
12668_0,,,,2,4,4,8
12669_0,,,,2,4,4,8
12670_0,,,,2,4,4,8
12671_0,,,,2,4,4,8
12672_0,,,,2,4,4,8
12673_0,,,,2,4,4,8
12674_0,,,,2,4,4,8
12675_0,,,,2,4,4,8
12676_0,,,,2,4,4,8
12677_0,,,,2,4,4,8
12678_0,,,,2,4,4,8
12679_0,,,,2,4,4,8
12680_0,,,,2,4,4,8
12681_0,,,,2,4,4,8
12682_0,,,,2,4,4,8
12683_0,,,,2,4,4,8
12684_0,,,,2,4,4,8
12685_0,,,,2,4,4,8
12686_0,,,,2,4,4,8
12687_0,,,,2,4,4,8
12688_0,,,,2,4,4,8
12689_0,,,,2,4,4,8
12690_0,,,,2,4,4,8
12691_0,,,,2,4,4,8
12692_0,,,,2,4,4,8
12694_0,,,,2,4,3,7
[C](C(O)=O)(CC(C(CO)O)O)O,,,3,1,1,0,1
12696_0,,,,2,4,3,7
[C](C(O)=O)(O)O,,,3,1,1,0,1
12697_0,,,,2,4,3,7
[OH-],,,0,1,0,60,60
