Id,Label,timeset,gen,type,weighted indegree,weighted outdegree,Weighted Degree
5_0,,,,2,1,2,3
C(CO)=O,,,1,1,413,178,591
C(C(C(CO)O)O)=O,,,1,1,31,64,95
5_1,,,,2,1,2,3
7_0,,,,2,1,1,2
C(CO)(C(C(C(CO)O)O)O)=O,,,1,1,17,32,49
10_0,,,,2,3,2,5
C(C(C(C(C(CO)O)O)O)O)(O)=O,,,1,1,154,14,168
C(C(C(C(C(CO)O)O)O)O)O,,,1,1,124,5,129
10_1,,,,2,3,2,5
13_0,,,,2,1,2,3
CN,,,1,1,78,436,514
C(=O)=O,,,1,1,1841,159,2000
15_0,,,,2,1,2,3
O,,,0,1,1961,467,2428
C(C(CC(C(CO)O)O)=O)=O,,,1,1,21,42,63
17_0,,,,2,1,2,3
C(CC(C(C(CO)O)O)=O)=O,,,1,1,26,49,75
19_0,,,,2,1,2,3
C(C(C(CC(CO)O)=O)O)=O,,,1,1,21,48,69
21_0,,,,2,1,2,3
C(CC(C=O)O)(C(CO)O)=O,,,1,1,29,54,83
23_0,,,,2,1,2,3
C(C(C(C=O)O)O)(CCO)=O,,,1,1,30,58,88
25_0,,,,2,1,2,3
C(C(C(CC(CO)=O)O)O)=O,,,1,1,25,51,76
27_0,,,,2,1,2,3
C(C(C(C(C(C)=O)O)O)O)=O,,,1,1,27,53,80
29_0,,,,2,1,2,3
C(CC(C(C(C=O)O)O)O)=O,,,1,1,29,55,84
31_0,,,,2,1,1,2
C(C(C1C(C(C(O)O1)O)O)O)O,,,1,1,5,7,12
33_0,,,,2,1,1,2
C(C1C(C(C(C(O)O1)O)O)O)O,,,1,1,5,7,12
35_0,,,,2,1,1,2
C1C(C(C(C(C(O)O1)O)O)O)O,,,1,1,7,9,16
38_0,,,,2,2,2,4
C(C(C(C(C(CN)O)O)O)O)O,,,1,1,22,13,35
C(C(O)=O)=O,,,1,1,563,89,652
40_0,,,,2,2,3,5
C=O,,,1,1,511,407,918
42_0,,,,2,1,1,2
C1(C(C(C(C1CO)O)O)O)=O,,,2,1,2,39,41
42_1,,,,2,1,1,2
44_0,,,,2,1,1,2
C1(C(C(C(C(C1)O)O)O)O)=O,,,2,1,3,36,39
44_1,,,,2,1,1,2
45_0,,,,2,1,1,2
47_0,,,,2,1,1,2
C(C1C(C(C(C1O)O)O)O)=O,,,2,1,2,26,28
47_1,,,,2,1,1,2
48_0,,,,2,2,1,3
48_1,,,,2,2,1,3
49_0,,,,2,2,1,3
C(C(C(C(C(CO)O)O)O)O)=O,,,0,1,17,292,309
49_1,,,,2,2,1,3
51_0,,,,2,2,1,3
C(C(C=O)O)(O)=O,,,2,1,301,68,369
51_1,,,,2,2,1,3
53_0,,,,2,2,1,3
C(C(C(C=O)O)O)(O)=O,,,2,1,8,61,69
53_1,,,,2,2,1,3
55_0,,,,2,2,1,3
C(C(CO)O)=O,,,2,1,330,128,458
55_1,,,,2,2,1,3
57_0,,,,2,2,1,3
C(C(C(CO)C(C(CO)O)O)=O)=O,,,2,1,4,41,45
57_1,,,,2,2,1,3
59_0,,,,2,2,1,3
C(C(C(C(C(CO)O)O)=O)CO)=O,,,2,1,2,43,45
59_1,,,,2,2,1,3
61_0,,,,2,2,1,3
C(C(C(C(CO)C(CO)O)=O)O)=O,,,2,1,2,44,46
61_1,,,,2,2,1,3
63_0,,,,2,2,1,3
C(C(CO)C(C=O)O)(C(CO)O)=O,,,2,1,2,48,50
63_1,,,,2,2,1,3
65_0,,,,2,2,1,3
C(C(C(C=O)O)O)(C(CO)CO)=O,,,2,1,2,44,46
65_1,,,,2,2,1,3
67_0,,,,2,2,1,3
C(C(C(C(C(CO)=O)CO)O)O)=O,,,2,1,4,46,50
67_1,,,,2,2,1,3
69_0,,,,2,2,1,3
C(C(CO)O)(CC(C(C=O)O)O)=O,,,2,1,3,46,49
69_1,,,,2,2,1,3
71_0,,,,2,2,1,3
C(C(C(C(C=O)O)O)O)(CCO)=O,,,2,1,3,46,49
73_0,,,,2,2,1,3
C(C(CO)C(C(C(C=O)O)O)O)=O,,,2,1,2,50,52
73_1,,,,2,2,1,3
75_0,,,,2,2,1,3
C(C(CC(C(CO)O)O)O)(O)=O,,,2,1,2,10,12
75_1,,,,2,2,1,3
77_0,,,,2,1,2,3
C(C(C(C(C(CO)O)O)O)=O)=O,,,2,1,1,47,48
78_0,,,,2,1,2,3
78_1,,,,2,1,2,3
80_0,,,,2,1,2,3
C(CO)(CO)=O,,,2,1,9,113,122
80_1,,,,2,1,2,3
82_0,,,,2,1,2,3
C(C(C)=O)=O,,,2,1,12,167,179
84_0,,,,2,1,2,3
C(CC(CO)=O)=O,,,2,1,11,124,135
84_1,,,,2,1,2,3
86_0,,,,2,1,2,3
C(C(C(C)=O)O)=O,,,2,1,8,122,130
89_0,,,,2,1,2,3
C(C=O)=O,,,2,1,35,95,130
C(C)(C(CO)O)=O,,,2,1,14,93,107
91_0,,,,2,1,2,3
C(C(CC(CO)=O)O)=O,,,2,1,3,82,85
91_1,,,,2,1,2,3
93_0,,,,2,1,2,3
C(C(CCO)=O)=O,,,2,1,14,98,112
93_1,,,,2,1,2,3
95_0,,,,2,1,2,3
C(CO)(CCO)=O,,,2,1,18,98,116
95_1,,,,2,1,2,3
97_0,,,,2,1,2,3
C(C(C(C(C)=O)O)O)=O,,,2,1,5,94,99
98_0,,,,2,1,2,3
98_1,,,,2,1,2,3
101_0,,,,2,1,2,3
C(C(C=O)O)=O,,,2,1,13,115,128
C(C)(CO)=O,,,2,1,28,166,194
102_0,,,,2,1,2,3
102_1,,,,2,1,2,3
103_0,,,,2,1,2,3
103_1,,,,2,1,2,3
105_0,,,,2,1,2,3
C(CC(C=O)O)=O,,,2,1,13,119,132
105_1,,,,2,1,2,3
108_0,,,,2,1,2,3
C(C(C(C=O)O)O)=O,,,2,1,5,60,65
C(C)=O,,,2,1,15,257,272
109_0,,,,2,1,1,2
111_0,,,,2,1,1,2
C(CO)(C(CO)O)=O,,,2,1,7,90,97
112_0,,,,2,1,1,2
114_0,,,,2,1,1,2
C(C(C(CO)O)O)(C(CO)O)=O,,,2,1,8,37,45
116_0,,,,2,1,1,2
C(CC(C(C(CO)O)=O)O)=O,,,2,1,7,56,63
118_0,,,,2,1,1,2
C(C(CO)=O)(CC(CO)O)=O,,,2,1,3,41,44
120_0,,,,2,1,1,2
C(C(C(CC(CO)O)O)=O)=O,,,2,1,3,41,44
122_0,,,,2,1,1,2
C(C(CO)O)(CC(CO)=O)=O,,,2,1,6,49,55
124_0,,,,2,1,1,2
C(C(CC(C(CO)=O)O)O)=O,,,2,1,5,48,53
126_0,,,,2,1,1,2
C(CCO)(C(C(CO)=O)O)=O,,,2,1,2,48,50
128_0,,,,2,1,1,2
C(C(C(C(CCO)O)=O)O)=O,,,2,1,3,47,50
130_0,,,,2,1,1,2
C(CO)(C(CC(CO)=O)O)=O,,,2,1,5,53,58
132_0,,,,2,1,1,2
C(C(C(CC(C=O)O)O)O)=O,,,2,1,9,51,60
134_0,,,,2,1,1,2
C(C)(C(C(C(CO)=O)O)O)=O,,,2,1,4,59,63
136_0,,,,2,1,1,2
C(C(C(C=O)O)O)(C(C)O)=O,,,2,1,3,57,60
138_0,,,,2,1,1,2
C(CC(C(C(CO)=O)O)O)=O,,,2,1,4,53,57
140_0,,,,2,2,2,4
C(CNC)=O,,,2,1,7,212,219
142_0,,,,2,2,2,4
C(CNC)(C(CO)O)=O,,,2,1,3,60,63
144_0,,,,2,2,2,4
C(C(C(C(C(CO)O)O)O)NC)=O,,,2,1,6,28,34
146_0,,,,2,2,2,4
C(C(C(CO)O)O)(C(CO)NC)=O,,,2,1,2,30,32
148_0,,,,2,2,2,4
C(CC(C(C(CO)O)=O)NC)=O,,,2,1,5,45,50
150_0,,,,2,2,2,4
C(C(CNC)=O)(CC(CO)O)=O,,,2,1,2,34,36
152_0,,,,2,2,2,4
C(C(C(CC(CO)O)NC)=O)=O,,,2,1,3,36,39
154_0,,,,2,2,2,4
C(C(CO)O)(CC(CNC)=O)=O,,,2,1,2,42,44
156_0,,,,2,2,2,4
C(C(CC(C(CO)=O)NC)O)=O,,,2,1,3,41,44
158_0,,,,2,2,2,4
C(CCO)(C(C(CNC)=O)O)=O,,,2,1,2,40,42
160_0,,,,2,2,2,4
C(C(C(C(CCO)NC)=O)O)=O,,,2,1,3,41,44
162_0,,,,2,2,2,4
C(CC(C(CNC)=O)O)(CO)=O,,,2,1,2,43,45
164_0,,,,2,2,2,4
C(C(CC(C(C=O)O)O)NC)=O,,,2,1,2,46,48
166_0,,,,2,2,2,4
C(C(C(C(CNC)=O)O)O)(C)=O,,,2,1,2,50,52
168_0,,,,2,2,2,4
C(C(C(C=O)O)O)(C(C)NC)=O,,,2,1,3,48,51
170_0,,,,2,2,2,4
C(CC(C(C(CNC)=O)O)O)=O,,,2,1,2,44,46
172_0,,,,2,2,2,4
C(CNCC(O)=O)=O,,,2,1,2,147,149
174_0,,,,2,2,2,4
C(CNCC(O)=O)(C(CO)O)=O,,,2,1,2,35,37
176_0,,,,2,2,2,4
C(CNC)(C(C(C(CO)O)O)O)=O,,,2,1,7,26,33
178_0,,,,2,3,2,5
C(CO)O,,,2,1,4,1,5
180_0,,,,2,3,2,5
C(C(C(CO)O)O)O,,,2,1,3,3,6
182_0,,,,2,3,2,5
C(CO)(CC(C(CO)O)O)=O,,,2,1,4,30,34
184_0,,,,2,3,2,5
C(C(C(CO)O)O)(CCO)=O,,,2,1,7,35,42
186_0,,,,2,3,2,5
C(C(CO)O)(CC(CO)O)=O,,,2,1,5,35,40
187_0,,,,2,3,2,5
188_0,,,,2,3,2,5
189_0,,,,2,3,2,5
191_0,,,,2,3,2,5
C(C)(C(C(C(CO)O)O)O)=O,,,2,1,5,33,38
193_0,,,,2,3,2,5
C(CC(C(C(CO)O)O)O)=O,,,2,1,6,30,36
195_0,,,,2,3,2,5
C(C(C(C(CCO)O)O)O)=O,,,2,1,1,31,32
197_0,,,,2,3,2,5
C(CO)(O)=O,,,2,1,12,29,41
199_0,,,,2,3,2,5
CO,,,2,1,3,7,10
200_0,,,,2,3,2,5
202_0,,,,2,3,2,5
C(C(C(CO)O)O)(O)=O,,,2,1,3,22,25
204_0,,,,2,3,2,5
C(C(CC(C(CO)O)O)=O)(O)=O,,,2,1,2,48,50
206_0,,,,2,3,2,5
C(CC(C(C(CO)O)O)=O)(O)=O,,,2,1,3,32,35
208_0,,,,2,3,2,5
C(C(C(CC(CO)O)=O)O)(O)=O,,,2,1,2,30,32
210_0,,,,2,3,2,5
C(CC(C(O)=O)O)(C(CO)O)=O,,,2,1,3,32,35
212_0,,,,2,3,2,5
C(C(C(C(O)=O)O)O)(CCO)=O,,,2,1,5,34,39
214_0,,,,2,3,2,5
C(C(C(CC(CO)=O)O)O)(O)=O,,,2,1,4,27,31
216_0,,,,2,3,2,5
C(C(C(C(C(C)=O)O)O)O)(O)=O,,,2,1,5,31,36
218_0,,,,2,3,2,5
C(CC(C(C(C(O)=O)O)O)O)=O,,,2,1,4,33,37
220_0,,,,2,3,2,5
C(CC(C(C(C=O)O)O)O)(O)=O,,,2,1,1,33,34
222_0,,,,2,3,2,5
C(C(O)=O)(O)=O,,,2,1,1,1,2
224_0,,,,2,3,2,5
C(O)=O,,,2,1,2,0,2
226_0,,,,2,1,1,2
C1(CC(C(C1(CO)O)O)O)=O,,,2,1,2,29,31
226_1,,,,2,1,1,2
228_0,,,,2,1,1,2
C(C1(C(C(CC1O)O)O)O)=O,,,2,1,4,28,32
228_1,,,,2,1,1,2
230_0,,,,2,2,1,3
C(C(C(CO)O)(C(CO)O)O)=O,,,2,1,2,21,23
230_1,,,,2,2,1,3
232_0,,,,2,2,1,3
C(C(C=O)(C(CO)O)O)(O)=O,,,2,1,4,24,28
232_1,,,,2,2,1,3
234_0,,,,2,2,1,3
C(C(C(CO)O)(C(C(O)=O)O)O)=O,,,2,1,4,29,33
234_1,,,,2,2,1,3
236_0,,,,2,2,1,3
C(C(CO)(C(CO)O)O)=O,,,2,1,4,27,31
236_1,,,,2,2,1,3
238_0,,,,2,2,1,3
C(CC(C(CO)(C(CO)O)O)=O)=O,,,2,1,2,40,42
238_1,,,,2,2,1,3
240_0,,,,2,2,1,3
C(C(C(CC(CO)O)=O)(CO)O)=O,,,2,1,2,37,39
240_1,,,,2,2,1,3
242_0,,,,2,2,1,3
C(CC(C=O)O)(C(CO)(CO)O)=O,,,2,1,2,36,38
242_1,,,,2,2,1,3
244_0,,,,2,2,1,3
C(C(CO)(C(C(CCO)=O)O)O)=O,,,2,1,4,45,49
244_1,,,,2,2,1,3
246_0,,,,2,2,1,3
C(C(CO)(C(C=O)O)O)(CCO)=O,,,2,1,2,44,46
246_1,,,,2,2,1,3
248_0,,,,2,2,1,3
C(C(CO)(C(CC(CO)=O)O)O)=O,,,2,1,4,43,47
248_1,,,,2,2,1,3
250_0,,,,2,2,1,3
C(C(CO)(C(C(C(C)=O)O)O)O)=O,,,2,1,4,45,49
250_1,,,,2,2,1,3
252_0,,,,2,2,1,3
C(C(C(C(C(C)=O)(CO)O)O)O)=O,,,2,1,4,44,48
252_1,,,,2,2,1,3
254_0,,,,2,2,1,3
C(C(CO)(C(C(CC=O)O)O)O)=O,,,2,1,4,45,49
254_1,,,,2,2,1,3
256_0,,,,2,2,1,3
C(C(CO)(CC(C(CO)O)=O)O)=O,,,2,1,1,43,44
258_0,,,,2,2,1,3
C(C(C(CO)O)N)(O)=O,,,2,1,1,613,614
260_0,,,,2,2,1,3
C(C(C(C(C(CO)O)O)O)N)(O)=O,,,2,1,1,603,604
262_0,,,,2,2,1,3
C(C(C(O)=O)N)(O)=O,,,2,1,2,581,583
262_1,,,,2,2,1,3
264_0,,,,2,2,1,3
C(C(C(C(O)=O)N)O)(O)=O,,,2,1,1,612,613
266_0,,,,2,2,1,3
C(C(CO)N)(O)=O,,,2,1,2,645,647
267_0,,,,2,1,2,3
269_0,,,,2,2,2,4
C(CO)(C(C(C(CO)O)O)NC)=O,,,2,1,3,27,30
271_0,,,,2,2,2,4
C(CC(C(C(CO)O)NC)=O)=O,,,2,1,2,41,43
273_0,,,,2,2,2,4
C(C(C(CC(CO)O)=O)NC)=O,,,2,1,4,37,41
275_0,,,,2,2,2,4
C(CC(C=O)O)(C(CO)NC)=O,,,2,1,2,46,48
277_0,,,,2,2,2,4
C(C(C(C=O)O)NC)(CCO)=O,,,2,1,4,46,50
277_1,,,,2,2,2,4
279_0,,,,2,2,2,4
C(C(C(C(C(C)=O)NC)O)O)=O,,,2,1,2,45,47
281_0,,,,2,2,3,5
C(C(CC(C(CO)O)O)N)=O,,,2,1,12,27,39
283_0,,,,2,2,3,5
C(CN)(CC(C(CO)O)O)=O,,,2,1,12,29,41
284_0,,,,2,2,1,3
C(CN)(O)=O,,,0,1,43,663,706
285_0,,,,2,1,2,3
286_0,,,,2,1,2,3
287_0,,,,2,1,2,3
288_0,,,,2,1,2,3
289_0,,,,2,1,2,3
290_0,,,,2,1,2,3
291_0,,,,2,1,2,3
292_0,,,,2,1,2,3
293_0,,,,2,1,2,3
294_0,,,,2,1,2,3
295_0,,,,2,1,2,3
296_0,,,,2,1,2,3
297_0,,,,2,1,2,3
298_0,,,,2,1,2,3
299_0,,,,2,1,2,3
300_0,,,,2,1,2,3
301_0,,,,2,1,2,3
302_0,,,,2,1,2,3
303_0,,,,2,1,2,3
304_0,,,,2,1,2,3
305_0,,,,2,1,2,3
306_0,,,,2,1,2,3
307_0,,,,2,1,2,3
309_0,,,,2,1,2,3
C(CCO)(CC(C=O)=O)=O,,,2,1,3,69,72
311_0,,,,2,1,2,3
C(CO)(CCC(C=O)=O)=O,,,2,1,4,69,73
313_0,,,,2,1,2,3
C(C)(C(CC(C=O)=O)O)=O,,,2,1,4,76,80
315_0,,,,2,1,2,3
C(CC(CC(C=O)=O)O)=O,,,2,1,3,71,74
317_0,,,,2,1,2,3
C(CC(C(CCO)=O)=O)=O,,,2,1,4,68,72
319_0,,,,2,1,2,3
C(CC(CC(CO)=O)=O)=O,,,2,1,6,75,81
321_0,,,,2,1,2,3
C(CC(C(C(C)=O)O)=O)=O,,,2,1,2,78,80
323_0,,,,2,1,2,3
C(CC(C(CC=O)O)=O)=O,,,2,1,5,84,89
325_0,,,,2,1,2,3
C(C(C=O)O)(CC(C)=O)=O,,,2,1,3,78,81
327_0,,,,2,1,2,3
C(C(C(CCC=O)=O)O)=O,,,2,1,4,78,82
329_0,,,,2,1,2,3
C(C(CC(C(C)=O)=O)O)=O,,,2,1,4,70,74
331_0,,,,2,1,2,3
C(CC(CC(C=O)O)=O)=O,,,2,1,6,79,85
332_0,,,,2,1,2,3
333_0,,,,2,1,2,3
334_0,,,,2,1,2,3
335_0,,,,2,1,2,3
336_0,,,,2,1,2,3
337_0,,,,2,1,2,3
338_0,,,,2,1,2,3
339_0,,,,2,1,2,3
340_0,,,,2,1,2,3
341_0,,,,2,1,2,3
342_0,,,,2,1,2,3
343_0,,,,2,1,2,3
345_0,,,,2,1,2,3
C1(CC(C(C(CO)O)O1)O)=O,,,2,1,3,12,15
347_0,,,,2,1,2,3
C1(COC(C(CO)O)C1O)=O,,,2,1,1,25,26
349_0,,,,2,1,2,3
C1(C(O)OC(C(CO)O)C1)=O,,,2,1,2,24,26
351_0,,,,2,1,2,3
C1(C(C(CO)O)OC(C1)O)=O,,,2,1,2,29,31
353_0,,,,2,1,2,3
C(C)(C1C(C(C(O1)O)O)O)=O,,,2,1,2,26,28
355_0,,,,2,1,2,3
C(CC1C(C(C(O)O1)O)O)=O,,,2,1,2,25,27
357_0,,,,2,1,2,3
C1(CC(C(C(CO)O1)O)O)=O,,,2,1,2,13,15
359_0,,,,2,1,2,3
C1(COC(CO)C(C1O)O)=O,,,2,1,1,28,29
361_0,,,,2,1,2,3
C1(C(O)OC(CO)C(C1)O)=O,,,2,1,2,25,27
363_0,,,,2,1,2,3
C1(C(C(CO)OC(C1)O)O)=O,,,2,1,2,28,30
365_0,,,,2,1,2,3
C1(C(C(O)OC(CO)C1)O)=O,,,2,1,2,30,32
367_0,,,,2,1,2,3
C1(C(CO)OC(C(C1)O)O)=O,,,2,1,2,28,30
369_0,,,,2,1,2,3
C1(CC(C(C(CO1)O)O)O)=O,,,2,1,1,16,17
371_0,,,,2,1,2,3
C1(COCC(C(C1O)O)O)=O,,,2,1,1,30,31
373_0,,,,2,1,2,3
C1(C(O)OCC(C(C1)O)O)=O,,,2,1,2,27,29
375_0,,,,2,1,2,3
C1(C(C(COC(C1)O)O)O)=O,,,2,1,2,33,35
377_0,,,,2,1,2,3
C1(C(C(O)OCC(C1)O)O)=O,,,2,1,2,33,35
379_0,,,,2,1,2,3
C1(C(COC(C(C1)O)O)O)=O,,,2,1,2,30,32
381_0,,,,2,1,2,3
C1(C(C(C(O)OCC1)O)O)=O,,,2,1,2,32,34
383_0,,,,2,1,2,3
C1(COC(C(C(C1)O)O)O)=O,,,2,1,2,27,29
384_0,,,,2,1,2,3
386_0,,,,2,1,2,3
C(C(C(CO)O)O)(CCN)=O,,,2,1,14,37,51
388_0,,,,2,1,2,3
C(C(CN)O)(CC(CO)O)=O,,,2,1,14,36,50
390_0,,,,2,1,2,3
C(C(CO)O)(CC(CN)O)=O,,,2,1,13,41,54
392_0,,,,2,1,2,3
C(C(C(CN)O)O)(CCO)=O,,,2,1,13,40,53
394_0,,,,2,1,2,3
C(CO)(CC(C(CN)O)O)=O,,,2,1,13,34,47
396_0,,,,2,1,2,3
C(C)(C(C(C(CN)O)O)O)=O,,,2,1,13,38,51
398_0,,,,2,1,2,3
C(CC(C(C(CN)O)O)O)=O,,,2,1,13,33,46
400_0,,,,2,1,2,3
C(C(CO)O)=CC(C=O)=O,,,2,1,4,43,47
402_0,,,,2,1,2,3
C(C(C(C=CCO)=O)O)=O,,,2,1,4,61,65
404_0,,,,2,1,2,3
C(C=CC(C(CO)O)=O)=O,,,2,1,4,72,76
406_0,,,,2,1,2,3
C(C(C(C(C=C)=O)O)O)=O,,,2,1,4,82,86
408_0,,,,2,1,2,3
C(C(C=CC(CO)=O)O)=O,,,2,1,4,62,66
410_0,,,,2,1,2,3
C(C(C(C=CC=O)O)O)=O,,,2,1,4,64,68
412_0,,,,2,1,2,3
C(C(C(C(CO)O)O)O)=CN,,,2,1,2,12,14
412_1,,,,2,1,2,3
413_0,,,,2,2,1,3
414_0,,,,2,2,1,3
415_0,,,,2,2,1,3
416_0,,,,2,2,1,3
417_0,,,,2,2,1,3
418_0,,,,2,2,1,3
419_0,,,,2,2,1,3
420_0,,,,2,2,1,3
421_0,,,,2,2,1,3
423_0,,,,2,1,2,3
N,,,2,1,37,511,548
425_0,,,,2,2,2,4
C(C(C(CO)NC)O)=O,,,2,1,3,45,48
427_0,,,,2,2,2,4
C(CO)(C(C(C(CO)O)NC)O)=O,,,2,1,1,28,29
429_0,,,,2,2,2,4
C(C(CC(C(CO)O)NC)=O)=O,,,2,1,3,39,42
431_0,,,,2,2,2,4
C(CC(C(C(CO)NC)O)=O)=O,,,2,1,1,43,44
433_0,,,,2,2,2,4
C(C(C(CC(CO)NC)=O)O)=O,,,2,1,3,45,48
435_0,,,,2,2,2,4
C(CC(C=O)NC)(C(CO)O)=O,,,2,1,5,46,51
437_0,,,,2,2,2,4
C(CC(C=O)O)(C(CNC)O)=O,,,2,1,1,48,49
439_0,,,,2,2,2,4
C(C(C(C(CCO)=O)O)NC)=O,,,2,1,5,48,53
441_0,,,,2,2,2,4
C(C(C(C=O)O)O)(CCNC)=O,,,2,1,3,53,56
443_0,,,,2,2,2,4
C(C(C(CC(CO)=O)NC)O)=O,,,2,1,4,43,47
445_0,,,,2,2,2,4
C(C(C(C(C(C)=O)O)NC)O)=O,,,2,1,2,45,47
447_0,,,,2,2,2,4
C(CC(C(C(C=O)O)NC)O)=O,,,2,1,2,49,51
449_0,,,,2,2,2,4
C(CC(C(C(C=O)O)O)NC)=O,,,2,1,3,51,54
451_0,,,,2,2,2,4
C(C(C(CO)NCC(O)=O)O)=O,,,2,1,2,38,40
453_0,,,,2,2,2,4
C(C(C(C(C(CO)O)O)NC)O)=O,,,2,1,6,29,35
455_0,,,,2,1,1,2
C1C(C(C(O)O1)O)O,,,2,1,1,5,6
457_0,,,,2,1,1,2
C(C1(C(C(C(CO)O1)O)O)O)O,,,2,1,1,5,6
458_0,,,,2,1,1,2
460_0,,,,2,1,1,2
C(C1(CC(C(CO)O1)O)O)=O,,,2,1,1,19,20
461_0,,,,2,1,1,2
463_0,,,,2,1,1,2
C(CC1(C(C(CO1)O)O)O)=O,,,2,1,1,25,26
465_0,,,,2,1,1,2
C(C(C1(CC(CO1)O)O)O)=O,,,2,1,1,26,27
467_0,,,,2,1,1,2
C(C1C(CC(CO)(O1)O)O)=O,,,2,1,1,25,26
469_0,,,,2,1,1,2
C(C1C(C(C(C)(O1)O)O)O)=O,,,2,1,1,26,27
470_0,,,,2,1,1,2
472_0,,,,2,1,1,2
C(C(C1C(CC(O)O1)O)O)=O,,,2,1,1,24,25
473_0,,,,2,1,1,2
475_0,,,,2,1,1,2
C1C(C(C(C(CO)(O)O1)O)O)O,,,2,1,1,7,8
476_0,,,,2,1,1,2
478_0,,,,2,1,1,2
C(C1(CC(C(CO1)O)O)O)=O,,,2,1,1,21,22
479_0,,,,2,1,1,2
480_0,,,,2,1,1,2
481_0,,,,2,1,1,2
483_0,,,,2,1,1,2
C(C1C(C(CC(O1)O)O)O)=O,,,2,1,1,26,27
484_0,,,,2,1,1,2
485_0,,,,2,1,1,2
486_0,,,,2,1,1,2
487_0,,,,2,1,1,2
488_0,,,,2,1,1,2
489_0,,,,2,1,1,2
490_0,,,,2,1,1,2
491_0,,,,2,1,1,2
492_0,,,,2,1,1,2
493_0,,,,2,2,2,4
494_0,,,,2,2,2,4
495_0,,,,2,2,2,4
495_1,,,,2,2,2,4
497_0,,,,2,2,2,4
C(CN)O,,,2,1,13,91,104
499_0,,,,2,2,2,4
C(C(C(CN)O)O)O,,,2,1,12,16,28
501_0,,,,2,2,2,4
C(C(C(C(C(CO)N)O)O)O)O,,,2,1,12,14,26
502_0,,,,2,2,2,4
503_0,,,,2,2,2,4
504_0,,,,2,2,2,4
506_0,,,,2,2,2,4
C(CC(C(C(CO)O)O)N)=O,,,2,1,13,32,45
507_0,,,,2,2,2,4
509_0,,,,2,2,2,4
C(C(C(CC(CO)O)N)O)=O,,,2,1,12,31,43
510_0,,,,2,2,2,4
512_0,,,,2,2,2,4
C(C(CC(C(CO)O)N)O)=O,,,2,1,12,31,43
513_0,,,,2,2,2,4
515_0,,,,2,2,2,4
C(C(C(C(CCO)N)O)O)=O,,,2,1,12,35,47
516_0,,,,2,2,2,4
518_0,,,,2,2,2,4
C(C(C(CC(CO)N)O)O)=O,,,2,1,12,35,47
519_0,,,,2,2,2,4
521_0,,,,2,2,2,4
C(C(C(C(C(C)N)O)O)O)=O,,,2,1,12,36,48
522_0,,,,2,2,2,4
524_0,,,,2,2,2,4
C(C(C(C(CCN)O)O)O)=O,,,2,1,12,34,46
525_0,,,,2,2,2,4
526_0,,,,2,1,2,3
528_0,,,,2,1,2,3
C1(C(C(C(C(CO)O)O1)O)O)=O,,,2,1,3,10,13
530_0,,,,2,1,2,3
C1(C(C(C(C(CO)O1)O)O)O)=O,,,2,1,2,11,13
532_0,,,,2,1,2,3
C1(C(C(C(C(CO1)O)O)O)O)=O,,,2,1,1,14,15
533_0,,,,2,2,3,5
534_0,,,,2,2,3,5
535_0,,,,2,2,3,5
536_0,,,,2,2,3,5
537_0,,,,2,2,3,5
538_0,,,,2,2,3,5
539_0,,,,2,2,3,5
540_0,,,,2,2,3,5
541_0,,,,2,2,3,5
542_0,,,,2,2,3,5
543_0,,,,2,2,3,5
544_0,,,,2,2,3,5
545_0,,,,2,2,3,5
546_0,,,,2,2,3,5
547_0,,,,2,2,3,5
548_0,,,,2,2,3,5
549_0,,,,2,2,3,5
550_0,,,,2,2,3,5
552_0,,,,2,1,1,2
C1(C(C(C(C(C1CO)O)O)O)O)=O,,,3,1,6,0,6
552_1,,,,2,1,1,2
553_0,,,,2,1,1,2
553_1,,,,2,1,1,2
555_0,,,,2,1,1,2
C1(C(C(C(C1)O)O)O)=O,,,3,1,8,0,8
555_1,,,,2,1,1,2
556_0,,,,2,1,1,2
558_0,,,,2,1,1,2
C1(C(C(C(CC1O)O)O)O)=O,,,3,1,3,0,3
558_1,,,,2,1,1,2
560_0,,,,2,1,1,2
C1(C(C(C(C1)O)(CO)O)O)=O,,,3,1,2,0,2
560_1,,,,2,1,1,2
562_0,,,,2,1,1,2
C1(C(CC(CO)(C1O)O)O)=O,,,3,1,2,0,2
562_1,,,,2,1,1,2
564_0,,,,2,1,1,2
C1(C(C(C(CO)(C1)O)O)O)=O,,,3,1,1,0,1
566_0,,,,2,1,1,2
C1(C(C(C(C)(C1O)O)O)O)=O,,,3,1,2,0,2
566_1,,,,2,1,1,2
568_0,,,,2,1,1,2
C1(C(C(CC(C1O)O)O)O)=O,,,3,1,2,0,2
568_1,,,,2,1,1,2
570_0,,,,2,1,1,2
C1(C(C(C(CC1NC)O)O)O)=O,,,3,1,3,0,3
570_1,,,,2,1,1,2
572_0,,,,2,1,1,2
C1(C(C(C(C1)O)(CNC)O)O)=O,,,3,1,2,0,2
572_1,,,,2,1,1,2
574_0,,,,2,1,1,2
C1(C(CC(CO)(C1NC)O)O)=O,,,3,1,2,0,2
574_1,,,,2,1,1,2
576_0,,,,2,1,1,2
C1(C(C(C(CNC)(C1)O)O)O)=O,,,3,1,1,0,1
578_0,,,,2,1,1,2
C1(C(C(C(C)(C1NC)O)O)O)=O,,,3,1,2,0,2
578_1,,,,2,1,1,2
580_0,,,,2,1,1,2
C1(C(C(CC(C1NC)O)O)O)=O,,,3,1,2,0,2
580_1,,,,2,1,1,2
582_0,,,,2,1,1,2
C1(C(C(CO)(C(C1CO)O)O)O)=O,,,3,1,2,0,2
582_1,,,,2,1,1,2
584_0,,,,2,1,1,2
C1(C(CO)(C(C(C1CO)O)O)O)=O,,,3,1,8,0,8
584_1,,,,2,1,1,2
586_0,,,,2,1,1,2
C1(C(C(C(C(C1)O)(CO)O)O)O)=O,,,3,1,3,0,3
586_1,,,,2,1,1,2
587_0,,,,2,1,1,2
589_0,,,,2,1,1,2
C1(CC(C(C(C1(CO)O)O)O)O)=O,,,3,1,5,0,5
591_0,,,,2,1,1,2
C(C1C(C(CO)(C(C1O)O)O)O)=O,,,3,1,2,0,2
591_1,,,,2,1,1,2
593_0,,,,2,1,1,2
C1(C(C(C(C1CO)O)O)NC)=O,,,3,1,3,0,3
593_1,,,,2,1,1,2
595_0,,,,2,1,1,2
C1(C(C(C(C(C1)O)O)O)NC)=O,,,3,1,2,0,2
597_0,,,,2,1,1,2
C1(C(CO)C(C(C1)=O)O)=O,,,3,1,3,0,3
597_1,,,,2,1,1,2
599_0,,,,2,1,1,2
C1(CCC(C(C1O)O)=O)=O,,,3,1,3,0,3
599_1,,,,2,1,1,2
601_0,,,,2,1,1,2
C(C1(CCC(C1O)=O)O)=O,,,3,1,3,0,3
601_1,,,,2,1,1,2
603_0,,,,2,1,1,2
C1(CC(C(CC1O)=O)O)=O,,,3,1,2,0,2
605_0,,,,2,1,1,2
C(C1(CC(C(C1)=O)O)O)=O,,,3,1,1,0,1
607_0,,,,2,1,1,2
C(C1C(CC(C1O)=O)O)=O,,,3,1,5,0,5
607_1,,,,2,1,1,2
609_0,,,,2,1,1,2
C1(C(CC(C1CO)O)=O)=O,,,3,1,3,0,3
609_1,,,,2,1,1,2
611_0,,,,2,1,1,2
C1(CC(C(C(C1)=O)O)O)=O,,,3,1,4,0,4
611_1,,,,2,1,1,2
613_0,,,,2,1,1,2
C1(CC(CC(C1O)=O)O)=O,,,3,1,2,0,2
614_0,,,,2,1,1,2
614_1,,,,2,1,1,2
616_0,,,,2,1,1,2
C(C1C(C(CC1O)O)=O)=O,,,3,1,3,0,3
616_1,,,,2,1,1,2
617_0,,,,2,1,1,2
619_0,,,,2,1,1,2
C(C1C(C(C(C1)=O)O)O)=O,,,3,1,3,0,3
621_0,,,,2,1,1,2
C1(C(CC(C(C1)O)O)=O)=O,,,3,1,2,0,2
623_0,,,,2,1,1,2
C(C1C(CC(C1O)O)=O)=O,,,3,1,5,0,5
623_1,,,,2,1,1,2
625_0,,,,2,1,1,2
C1C(C(C(C(C=1)=O)O)O)O,,,3,1,3,0,3
625_1,,,,2,1,1,2
627_0,,,,2,1,1,2
C1(C(C(C(C1CO)O)NC)O)=O,,,3,1,3,0,3
627_1,,,,2,1,1,2
629_0,,,,2,1,1,2
C1(C(C(C(C1CNC)O)O)O)=O,,,3,1,3,0,3
629_1,,,,2,1,1,2
631_0,,,,2,1,1,2
C1(C(C(C(C(C1)NC)O)O)O)=O,,,3,1,3,0,3
631_1,,,,2,1,1,2
633_0,,,,2,1,1,2
C1(C(C(C(C(C1)O)O)NC)O)=O,,,3,1,2,0,2
635_0,,,,2,1,1,2
C(C1C(C(C(C1O)O)NC)O)=O,,,3,1,2,0,2
635_1,,,,2,1,1,2
637_0,,,,2,1,1,2
C(C1C(C(C(C1NC)O)O)O)=O,,,3,1,3,0,3
637_1,,,,2,1,1,2
639_0,,,,2,2,1,3
C(C(C(C(C(CO)=O)O)O)O)(O)=O,,,3,1,2,0,2
639_1,,,,2,2,1,3
641_0,,,,2,2,1,3
C(C(C(CC(C=O)=O)O)O)(O)=O,,,3,1,1,0,1
642_0,,,,2,2,1,3
643_0,,,,2,2,1,3
643_1,,,,2,2,1,3
645_0,,,,2,2,1,3
C(CC(C(C(O)=O)O)O)=O,,,3,1,1,0,1
647_0,,,,2,2,1,3
C(C(C(C(C(O)=O)O)O)NC)=O,,,3,1,2,0,2
647_1,,,,2,2,1,3
648_0,,,,2,2,1,3
649_0,,,,2,2,1,3
649_1,,,,2,2,1,3
650_0,,,,2,2,1,3
652_0,,,,2,2,1,3
C(C(C(CO)=O)C(C(CO)O)O)=O,,,3,1,2,0,2
652_1,,,,2,2,1,3
654_0,,,,2,2,1,3
C(CC(C(C(C(CO)O)O)O)=O)=O,,,3,1,2,0,2
654_1,,,,2,2,1,3
656_0,,,,2,2,1,3
C(C(C(CC(C(CO)O)O)=O)O)=O,,,3,1,1,0,1
658_0,,,,2,2,1,3
C(C(CO)O)(CC(C(CO)O)O)=O,,,3,1,4,0,4
659_0,,,,2,2,1,3
659_1,,,,2,2,1,3
661_0,,,,2,2,1,3
C(C(C(C(CO)O)O)O)(CCO)=O,,,3,1,4,0,4
661_1,,,,2,2,1,3
663_0,,,,2,2,1,3
C(CO)(C(CO)C(C(CO)O)O)=O,,,3,1,6,0,6
663_1,,,,2,2,1,3
664_0,,,,2,2,1,3
665_0,,,,2,2,1,3
665_1,,,,2,2,1,3
667_0,,,,2,2,1,3
C(C(C(C(CO)O)O)C(C=O)O)=O,,,3,1,2,0,2
667_1,,,,2,2,1,3
669_0,,,,2,2,1,3
C(CC(C(CO)O)O)=O,,,3,1,2,0,2
671_0,,,,2,2,1,3
C(C(C(C(CO)O)O)NC)=O,,,3,1,2,0,2
671_1,,,,2,2,1,3
673_0,,,,2,2,1,3
C(CO)(C(C(CO)(CO)O)O)=O,,,3,1,2,0,2
673_1,,,,2,2,1,3
674_0,,,,2,2,1,3
674_1,,,,2,2,1,3
676_0,,,,2,2,1,3
C(C(C)(C(C(CO)=O)O)O)=O,,,3,1,2,0,2
676_1,,,,2,2,1,3
678_0,,,,2,2,1,3
C(C(CC(CO)(CO)O)=O)=O,,,3,1,1,0,1
680_0,,,,2,2,1,3
C(CO)(CC(C(C(CO)=O)O)O)=O,,,3,1,2,0,2
680_1,,,,2,2,1,3
682_0,,,,2,2,1,3
C(CC(CO)(C(C(CO)=O)O)O)=O,,,3,1,2,0,2
682_1,,,,2,2,1,3
684_0,,,,2,2,1,3
C(C(C(CO)=O)C(CO)(CO)O)=O,,,3,1,2,0,2
684_1,,,,2,2,1,3
686_0,,,,2,2,1,3
C(CC(C(C(CO)(CO)O)O)=O)=O,,,3,1,2,0,2
686_1,,,,2,2,1,3
688_0,,,,2,2,1,3
C(C)(C(C(C(C(CO)=O)O)O)O)=O,,,3,1,2,0,2
688_1,,,,2,2,1,3
690_0,,,,2,2,1,3
C(C(C(C)(C(C(CO)=O)O)O)O)=O,,,3,1,2,0,2
690_1,,,,2,2,1,3
692_0,,,,2,2,1,3
C(C(C(CC(CO)(CO)O)=O)O)=O,,,3,1,1,0,1
694_0,,,,2,2,1,3
C(C(C(C(CO)=O)O)O)=O,,,3,1,2,0,2
694_1,,,,2,2,1,3
696_0,,,,2,2,1,3
C(CO)(C(C(C)(C(CO)O)O)O)=O,,,3,1,2,0,2
696_1,,,,2,2,1,3
698_0,,,,2,2,1,3
C(C(CO)O)(CC(CO)(CO)O)=O,,,3,1,2,0,2
700_0,,,,2,2,1,3
C(C(C(C(CCO)=O)O)O)(CO)=O,,,3,1,4,0,4
700_1,,,,2,2,1,3
702_0,,,,2,2,1,3
C(C(CCO)(C(C(CO)=O)O)O)=O,,,3,1,2,0,2
702_1,,,,2,2,1,3
704_0,,,,2,2,1,3
C(C(C(CO)C(CO)(CO)O)=O)=O,,,3,1,2,0,2
704_1,,,,2,2,1,3
706_0,,,,2,2,1,3
C(CO)(C(C(CO)(CCO)O)O)=O,,,3,1,2,0,2
706_1,,,,2,2,1,3
708_0,,,,2,2,1,3
C(C(C(CO)(CO)O)O)(CCO)=O,,,3,1,3,0,3
708_1,,,,2,2,1,3
710_0,,,,2,2,1,3
C(CO)(C(CO)C(CO)(CO)O)=O,,,3,1,2,0,2
710_1,,,,2,2,1,3
712_0,,,,2,2,1,3
C(C(C(C(C(CO)=O)O)O)O)=O,,,3,1,2,0,2
712_1,,,,2,2,1,3
714_0,,,,2,2,1,3
C(CO)(C(C(CO)(C)O)O)=O,,,3,1,2,0,2
714_1,,,,2,2,1,3
716_0,,,,2,2,1,3
C(CO)(CC(CO)(CO)O)=O,,,3,1,1,0,1
718_0,,,,2,2,1,3
C(C)(C(C(CO)(CO)O)O)=O,,,3,1,2,0,2
718_1,,,,2,2,1,3
720_0,,,,2,2,1,3
C(CC(C(C(C(CO)=O)O)O)O)=O,,,3,1,2,0,2
720_1,,,,2,2,1,3
722_0,,,,2,2,1,3
C(C(CC(C(C(CO)=O)O)O)O)=O,,,3,1,2,0,2
722_1,,,,2,2,1,3
724_0,,,,2,2,1,3
C(C(C(CO)(CO)O)C(C=O)O)=O,,,3,1,2,0,2
724_1,,,,2,2,1,3
726_0,,,,2,2,1,3
C(CO)(C(C(C)O)O)=O,,,3,1,2,0,2
726_1,,,,2,2,1,3
728_0,,,,2,2,1,3
C(CC(CO)(CO)O)=O,,,3,1,1,0,1
730_0,,,,2,2,1,3
C(CO)(C(C(CNC)O)O)=O,,,3,1,2,0,2
730_1,,,,2,2,1,3
732_0,,,,2,2,1,3
C(C(C(CO)(CO)O)NC)=O,,,3,1,2,0,2
732_1,,,,2,2,1,3
733_0,,,,2,2,1,3
735_0,,,,2,2,1,3
C(C(C)(CC(C=O)=O)O)=O,,,3,1,1,0,1
737_0,,,,2,2,1,3
C(CO)(CC(CC(C=O)=O)O)=O,,,3,1,1,0,1
739_0,,,,2,2,1,3
C(CC(CO)(CC(C=O)=O)O)=O,,,3,1,1,0,1
741_0,,,,2,2,1,3
C(C(C(CO)=O)C(C(C)=O)O)=O,,,3,1,2,0,2
741_1,,,,2,2,1,3
743_0,,,,2,2,1,3
C(C(C)(C(C=O)C(CO)=O)O)=O,,,3,1,2,0,2
743_1,,,,2,2,1,3
745_0,,,,2,2,1,3
C(CC(C(C(C(C)=O)O)O)=O)=O,,,3,1,2,0,2
745_1,,,,2,2,1,3
747_0,,,,2,2,1,3
C(C(C)(C(C(CC=O)=O)O)O)=O,,,3,1,2,0,2
747_1,,,,2,2,1,3
749_0,,,,2,2,1,3
C(C)(C(C(CC(C=O)=O)O)O)=O,,,3,1,1,0,1
751_0,,,,2,2,1,3
C(C(C(C)(CC(C=O)=O)O)O)=O,,,3,1,1,0,1
753_0,,,,2,2,1,3
C(C(C(CC(C(C)=O)O)=O)O)=O,,,3,1,1,0,1
755_0,,,,2,2,1,3
C(C(C)(CC(C(C=O)O)=O)O)=O,,,3,1,1,0,1
757_0,,,,2,2,1,3
C(C(CC(C=O)=O)O)=O,,,3,1,1,0,1
759_0,,,,2,2,1,3
C(C(CC(C)(C(CO)O)O)=O)=O,,,3,1,1,0,1
761_0,,,,2,2,1,3
C(CC(C(C)=O)O)(C(CO)O)=O,,,3,1,1,0,1
763_0,,,,2,2,1,3
C(C(C)(CC(C(CO)O)=O)O)=O,,,3,1,1,0,1
765_0,,,,2,2,1,3
C(C(CC(C=O)=O)O)(CCO)=O,,,3,1,3,0,3
767_0,,,,2,2,1,3
C(C(CCO)(CC(C=O)=O)O)=O,,,3,1,1,0,1
769_0,,,,2,2,1,3
C(C(C(C(C=O)=O)CO)O)(C)=O,,,3,1,5,0,5
769_1,,,,2,2,1,3
771_0,,,,2,2,1,3
C(C(C)(C(C(C=O)=O)CO)O)=O,,,3,1,2,0,2
771_1,,,,2,2,1,3
773_0,,,,2,2,1,3
C(C(CC(CO)(CCO)O)=O)=O,,,3,1,1,0,1
775_0,,,,2,2,1,3
C(C(C(C(CCO)=O)O)O)(C)=O,,,3,1,4,0,4
775_1,,,,2,2,1,3
777_0,,,,2,2,1,3
C(C(C)(C(C(CCO)=O)O)O)=O,,,3,1,2,0,2
777_1,,,,2,2,1,3
779_0,,,,2,2,1,3
C(CO)(C(CO)C(C(C)=O)O)=O,,,3,1,2,0,2
779_1,,,,2,2,1,3
781_0,,,,2,2,1,3
C(C(C)(C(C(CO)=O)CO)O)=O,,,3,1,2,0,2
781_1,,,,2,2,1,3
783_0,,,,2,2,1,3
C(C(C(CC(C=O)=O)O)O)=O,,,3,1,1,0,1
785_0,,,,2,2,1,3
C(C(CC(C)(CO)O)=O)=O,,,3,1,1,0,1
787_0,,,,2,2,1,3
C(C)(C(CC(CO)=O)O)=O,,,3,1,5,0,5
789_0,,,,2,2,1,3
C(C(C)(CC(CO)=O)O)=O,,,3,1,1,0,1
791_0,,,,2,2,1,3
C(C)(C(C(C(C)=O)O)O)=O,,,3,1,4,0,4
791_1,,,,2,2,1,3
793_0,,,,2,2,1,3
C(C(C)(C(C(C)=O)O)O)=O,,,3,1,2,0,2
793_1,,,,2,2,1,3
795_0,,,,2,2,1,3
C(CC(C(CC(C=O)=O)O)O)=O,,,3,1,1,0,1
797_0,,,,2,2,1,3
C(C(CC(CC(C=O)=O)O)O)=O,,,3,1,1,0,1
799_0,,,,2,2,1,3
C(C(C(C=O)C(C(C)=O)O)O)=O,,,3,1,2,0,2
799_1,,,,2,2,1,3
801_0,,,,2,2,1,3
C(C(C(C=O)C(C=O)(C)O)O)=O,,,3,1,2,0,2
801_1,,,,2,2,1,3
803_0,,,,2,2,1,3
C(C(C(C(CC(C=O)=O)O)O)O)=O,,,3,1,1,0,1
805_0,,,,2,2,1,3
C(C(CC(C)O)=O)=O,,,3,1,1,0,1
807_0,,,,2,2,1,3
C(CC(C(C)=O)O)=O,,,3,1,1,0,1
809_0,,,,2,2,1,3
C(C(C)(CC=O)O)=O,,,3,1,1,0,1
811_0,,,,2,2,1,3
C(C(CC(CO)(C(CO)O)O)=O)=O,,,3,1,1,0,1
813_0,,,,2,2,1,3
C(C(C(C(C(CO)O)=O)O)O)(C)=O,,,3,1,4,0,4
813_1,,,,2,2,1,3
815_0,,,,2,2,1,3
C(C(C)(C(C(C(CO)O)=O)O)O)=O,,,3,1,2,0,2
815_1,,,,2,2,1,3
817_0,,,,2,2,1,3
C(C(CC(CNC)O)=O)=O,,,3,1,1,0,1
819_0,,,,2,2,1,3
C(C(C(C(C)=O)O)NC)=O,,,3,1,4,0,4
819_1,,,,2,2,1,3
821_0,,,,2,2,1,3
C(C(C)(C(C=O)NC)O)=O,,,3,1,2,0,2
821_1,,,,2,2,1,3
823_0,,,,2,2,1,3
C(CNCC(CC(C=O)=O)O)(O)=O,,,3,1,1,0,1
825_0,,,,2,2,1,3
C(CNC(C=O)C(C(C)=O)O)(O)=O,,,3,1,3,0,3
825_1,,,,2,2,1,3
827_0,,,,2,2,1,3
C(CNC(C=O)C(C=O)(C)O)(O)=O,,,3,1,2,0,2
827_1,,,,2,2,1,3
829_0,,,,2,2,1,3
C(C(C(CO)=O)C(C=O)O)=O,,,3,1,2,0,2
829_1,,,,2,2,1,3
831_0,,,,2,2,1,3
C(CC(C(C(C=O)O)O)=O)=O,,,3,1,2,0,2
831_1,,,,2,2,1,3
833_0,,,,2,2,1,3
C(C(C(C(C=O)C(CO)=O)O)O)=O,,,3,1,2,0,2
833_1,,,,2,2,1,3
835_0,,,,2,2,1,3
C(CC(C(C(C(C=O)O)O)O)=O)=O,,,3,1,2,0,2
835_1,,,,2,2,1,3
837_0,,,,2,2,1,3
C(C(C(CO)=O)C(CO)(C)O)=O,,,3,1,2,0,2
837_1,,,,2,2,1,3
839_0,,,,2,2,1,3
C(CC(C(C(CO)(C)O)O)=O)=O,,,3,1,2,0,2
839_1,,,,2,2,1,3
841_0,,,,2,2,1,3
C(CO)(CC(CC(CO)=O)O)=O,,,3,1,1,0,1
843_0,,,,2,2,1,3
C(CC(CO)(CC(CO)=O)O)=O,,,3,1,1,0,1
845_0,,,,2,2,1,3
C(C)(C(C(CC(CO)=O)O)O)=O,,,3,1,3,0,3
845_1,,,,2,2,1,3
847_0,,,,2,2,1,3
C(CC(CO)(C(C(C)=O)O)O)=O,,,3,1,2,0,2
847_1,,,,2,2,1,3
849_0,,,,2,2,1,3
C(C(C(CO)=O)C(C)O)=O,,,3,1,2,0,2
849_1,,,,2,2,1,3
851_0,,,,2,2,1,3
C(CC(C(C(C)O)O)=O)=O,,,3,1,2,0,2
851_1,,,,2,2,1,3
853_0,,,,2,2,1,3
C(CC(CC(CO)=O)O)=O,,,3,1,4,0,4
855_0,,,,2,2,1,3
C(CC(CO)(CC=O)O)=O,,,3,1,1,0,1
857_0,,,,2,2,1,3
C(C(C(CO)=O)C(CNC)O)=O,,,3,1,2,0,2
857_1,,,,2,2,1,3
859_0,,,,2,2,1,3
C(CC(C(C(CNC)O)O)=O)=O,,,3,1,2,0,2
859_1,,,,2,2,1,3
861_0,,,,2,2,1,3
C(C(C(CC(CO)=O)O)NC)=O,,,3,1,4,0,4
861_1,,,,2,2,1,3
863_0,,,,2,2,1,3
C(CC(CO)(C(C=O)NC)O)=O,,,3,1,2,0,2
863_1,,,,2,2,1,3
865_0,,,,2,2,1,3
C(C(C(CC(C=O)O)=O)O)=O,,,3,1,1,0,1
867_0,,,,2,2,1,3
C(CC(C(C=O)O)O)(C(C=O)O)=O,,,3,1,1,0,1
869_0,,,,2,2,1,3
C(C(C(CC(CO)(C)O)=O)O)=O,,,3,1,1,0,1
870_0,,,,2,2,1,3
872_0,,,,2,2,1,3
C(C(C(C)(CC(CO)=O)O)O)=O,,,3,1,1,0,1
874_0,,,,2,2,1,3
C(C)(C(C(C(C(C)=O)O)O)O)=O,,,3,1,2,0,2
874_1,,,,2,2,1,3
876_0,,,,2,2,1,3
C(C(C(C)(C(C(C)=O)O)O)O)=O,,,3,1,2,0,2
876_1,,,,2,2,1,3
878_0,,,,2,2,1,3
C(C(C(CC(C)O)=O)O)=O,,,3,1,1,0,1
880_0,,,,2,2,1,3
C(CC(C(C(C)=O)O)O)=O,,,3,1,4,0,4
882_0,,,,2,2,1,3
C(CC(C)(C(C=O)O)O)=O,,,3,1,1,0,1
884_0,,,,2,2,1,3
C(C(C(CC(CNC)O)=O)O)=O,,,3,1,1,0,1
886_0,,,,2,2,1,3
C(C(C(C(C(C)=O)O)O)NC)=O,,,3,1,4,0,4
886_1,,,,2,2,1,3
888_0,,,,2,2,1,3
C(C(C(C)(C(C=O)O)O)NC)=O,,,3,1,2,0,2
888_1,,,,2,2,1,3
889_0,,,,2,2,1,3
891_0,,,,2,2,1,3
C(C(C(C(CO)=O)C(C=O)O)O)=O,,,3,1,2,0,2
891_1,,,,2,2,1,3
893_0,,,,2,2,1,3
C(C(C(C(CC(C=O)O)=O)O)O)=O,,,3,1,3,0,3
893_1,,,,2,2,1,3
895_0,,,,2,2,1,3
C(C(C(C(C=O)=O)CO)O)=O,,,3,1,2,0,2
895_1,,,,2,2,1,3
896_0,,,,2,2,1,3
896_1,,,,2,2,1,3
898_0,,,,2,2,1,3
C(CO)(C(CO)C(C=O)O)=O,,,3,1,8,0,8
898_1,,,,2,2,1,3
899_0,,,,2,2,1,3
900_0,,,,2,2,1,3
901_0,,,,2,2,1,3
901_1,,,,2,2,1,3
903_0,,,,2,2,1,3
C(C(C(C=O)C(C=O)O)O)=O,,,3,1,2,0,2
903_1,,,,2,2,1,3
904_0,,,,2,2,1,3
906_0,,,,2,2,1,3
C(C(C(C=O)O)O)(C(CO)O)=O,,,3,1,2,0,2
906_1,,,,2,2,1,3
908_0,,,,2,2,1,3
C(C(C(C=O)O)NC)=O,,,3,1,4,0,4
908_1,,,,2,2,1,3
910_0,,,,2,2,1,3
C(C(C(C=O)O)NC)(C(CO)O)=O,,,3,1,2,0,2
910_1,,,,2,2,1,3
912_0,,,,2,2,1,3
C(CNC(C=O)C(C=O)O)(O)=O,,,3,1,3,0,3
912_1,,,,2,2,1,3
913_0,,,,2,2,1,3
915_0,,,,2,2,1,3
C(C(CO)O)(CC(CO)(C)O)=O,,,3,1,1,0,1
917_0,,,,2,2,1,3
C(CO)(CC(C)(C(CO)O)O)=O,,,3,1,1,0,1
919_0,,,,2,2,1,3
C(C)(C(C(C)(C(CO)O)O)O)=O,,,3,1,2,0,2
919_1,,,,2,2,1,3
921_0,,,,2,2,1,3
C(C(CO)O)(CC(C)O)=O,,,3,1,1,0,1
923_0,,,,2,2,1,3
C(CC(C)(C(CO)O)O)=O,,,3,1,1,0,1
925_0,,,,2,2,1,3
C(C(CO)O)(CC(CNC)O)=O,,,3,1,1,0,1
927_0,,,,2,2,1,3
C(C(C(C)(C(CO)O)O)NC)=O,,,3,1,2,0,2
927_1,,,,2,2,1,3
929_0,,,,2,2,1,3
C(CO)(C(C(C)O)C(C=O)O)=O,,,3,1,2,0,2
929_1,,,,2,2,1,3
931_0,,,,2,2,1,3
C(CC(C=O)O)(C(C(C)O)O)=O,,,3,1,2,0,2
931_1,,,,2,2,1,3
933_0,,,,2,2,1,3
C(CC(C(CC(CO)=O)O)O)=O,,,3,1,2,0,2
935_0,,,,2,2,1,3
C(CC(CO)(CC(C=O)O)O)=O,,,3,1,1,0,1
937_0,,,,2,2,1,3
C(C(C(C(C(C=O)=O)CO)O)O)=O,,,3,1,2,0,2
937_1,,,,2,2,1,3
939_0,,,,2,2,1,3
C(C(C(CO)C(C)(CO)O)=O)=O,,,3,1,2,0,2
939_1,,,,2,2,1,3
941_0,,,,2,2,1,3
C(CC(C(CCO)=O)O)(CO)=O,,,3,1,1,0,1
943_0,,,,2,2,1,3
C(C(CCO)(CC(CO)=O)O)=O,,,3,1,1,0,1
944_0,,,,2,2,1,3
944_1,,,,2,2,1,3
946_0,,,,2,2,1,3
C(C(CCO)(C(C(C)=O)O)O)=O,,,3,1,2,0,2
946_1,,,,2,2,1,3
948_0,,,,2,2,1,3
C(C(C(CO)C(C)O)=O)=O,,,3,1,2,0,2
948_1,,,,2,2,1,3
950_0,,,,2,2,1,3
C(CC(C(CCO)=O)O)=O,,,3,1,4,0,4
952_0,,,,2,2,1,3
C(C(CCO)(CC=O)O)=O,,,3,1,1,0,1
954_0,,,,2,2,1,3
C(C(C(CO)C(CNC)O)=O)=O,,,3,1,2,0,2
954_1,,,,2,2,1,3
955_0,,,,2,2,1,3
955_1,,,,2,2,1,3
957_0,,,,2,2,1,3
C(C(CCO)(C(C=O)NC)O)=O,,,3,1,2,0,2
957_1,,,,2,2,1,3
958_0,,,,2,2,1,3
958_1,,,,2,2,1,3
959_0,,,,2,2,1,3
959_1,,,,2,2,1,3
961_0,,,,2,2,1,3
C(C(C(CO)(C)O)O)(CCO)=O,,,3,1,2,0,2
961_1,,,,2,2,1,3
963_0,,,,2,2,1,3
C(CO)(C(CO)C(CO)(C)O)=O,,,3,1,2,0,2
963_1,,,,2,2,1,3
965_0,,,,2,2,1,3
C(CO)(CC(CO)(CCO)O)=O,,,3,1,1,0,1
967_0,,,,2,2,1,3
C(C)(C(C(CO)(CCO)O)O)=O,,,3,1,2,0,2
967_1,,,,2,2,1,3
969_0,,,,2,2,1,3
C(C(C(C)O)O)(CCO)=O,,,3,1,2,0,2
969_1,,,,2,2,1,3
971_0,,,,2,2,1,3
C(CO)(C(CO)C(C)O)=O,,,3,1,2,0,2
971_1,,,,2,2,1,3
973_0,,,,2,2,1,3
C(CC(CO)(CCO)O)=O,,,3,1,1,0,1
975_0,,,,2,2,1,3
C(C(C(CNC)O)O)(CCO)=O,,,3,1,2,0,2
975_1,,,,2,2,1,3
977_0,,,,2,2,1,3
C(CO)(C(CO)C(CNC)O)=O,,,3,1,2,0,2
977_1,,,,2,2,1,3
979_0,,,,2,2,1,3
C(C(C(CO)(CCO)O)NC)=O,,,3,1,2,0,2
979_1,,,,2,2,1,3
981_0,,,,2,2,1,3
C(C(C(C=O)O)O)(CC(C)O)=O,,,3,1,1,0,1
983_0,,,,2,2,1,3
C(CC(C(C(C(C)=O)O)O)O)=O,,,3,1,3,0,3
985_0,,,,2,2,1,3
C(CC(C)(C(C(C=O)O)O)O)=O,,,3,1,1,0,1
986_0,,,,2,2,1,3
987_0,,,,2,2,1,3
987_1,,,,2,2,1,3
989_0,,,,2,2,1,3
C(C(C(C(C=O)C(C=O)O)O)O)=O,,,3,1,2,0,2
989_1,,,,2,2,1,3
991_0,,,,2,2,1,3
C(CC(C(C=O)O)O)=O,,,3,1,1,0,1
993_0,,,,2,2,1,3
C(C(C(C(C=O)O)O)NC)=O,,,3,1,2,0,2
993_1,,,,2,2,1,3
995_0,,,,2,2,1,3
C(CO)(CC(CO)(C)O)=O,,,3,1,1,0,1
997_0,,,,2,2,1,3
C(C)(C(C(CO)(C)O)O)=O,,,3,1,2,0,2
997_1,,,,2,2,1,3
998_0,,,,2,2,1,3
999_0,,,,2,2,1,3
999_1,,,,2,2,1,3
1001_0,,,,2,2,1,3
C(C(CC(CC(CO)=O)O)O)=O,,,3,1,1,0,1
1003_0,,,,2,2,1,3
C(C(CC(C(C(C)=O)O)O)O)=O,,,3,1,2,0,2
1003_1,,,,2,2,1,3
1005_0,,,,2,2,1,3
C(C(C(CO)(C)O)C(C=O)O)=O,,,3,1,2,0,2
1005_1,,,,2,2,1,3
1007_0,,,,2,2,1,3
C(C(C(C(CC(CO)=O)O)O)O)=O,,,3,1,3,0,3
1009_0,,,,2,2,1,3
C(C(C(C(C(C(C)=O)O)O)O)O)=O,,,3,1,4,0,4
1009_1,,,,2,2,1,3
1011_0,,,,2,2,1,3
C(CO)(CC(C)O)=O,,,3,1,1,0,1
1013_0,,,,2,2,1,3
C(C)(C(C(C)O)O)=O,,,3,1,2,0,2
1013_1,,,,2,2,1,3
1015_0,,,,2,2,1,3
C(CC(C)(CO)O)=O,,,3,1,1,0,1
1017_0,,,,2,2,1,3
C(CO)(CC(CO)(C(CO)O)O)=O,,,3,1,1,0,1
1019_0,,,,2,2,1,3
C(C)(C(C(CO)(C(CO)O)O)O)=O,,,3,1,2,0,2
1019_1,,,,2,2,1,3
1021_0,,,,2,2,1,3
C(C(C(CO)(C)O)O)(C(CO)O)=O,,,3,1,2,0,2
1021_1,,,,2,2,1,3
1023_0,,,,2,2,1,3
C(CO)(CC(CNC)O)=O,,,3,1,1,0,1
1025_0,,,,2,2,1,3
C(C)(C(C(CNC)O)O)=O,,,3,1,2,0,2
1025_1,,,,2,2,1,3
1027_0,,,,2,2,1,3
C(C(C(C)(CO)O)NC)=O,,,3,1,2,0,2
1027_1,,,,2,2,1,3
1029_0,,,,2,2,1,3
C(CNCC(CC(CO)=O)O)(O)=O,,,3,1,1,0,1
1031_0,,,,2,2,1,3
C(C)(C(C(CNCC(O)=O)O)O)=O,,,3,1,2,0,2
1031_1,,,,2,2,1,3
1033_0,,,,2,2,1,3
C(C(C(C)(CO)O)NCC(O)=O)=O,,,3,1,2,0,2
1033_1,,,,2,2,1,3
1035_0,,,,2,2,1,3
C(C(C(C)O)C(C=O)O)=O,,,3,1,2,0,2
1035_1,,,,2,2,1,3
1037_0,,,,2,2,1,3
C(CC(C(CC=O)O)O)=O,,,3,1,2,0,2
1039_0,,,,2,2,1,3
C(CC(CC(C=O)O)O)=O,,,3,1,1,0,1
1041_0,,,,2,2,1,3
C(C(C(CNC)O)C(C=O)O)=O,,,3,1,2,0,2
1041_1,,,,2,2,1,3
1043_0,,,,2,2,1,3
C(CC(C(C(C=O)NC)O)O)=O,,,3,1,4,0,4
1043_1,,,,2,2,1,3
1045_0,,,,2,2,1,3
C(C(C(CC(C=O)O)O)NC)=O,,,3,1,3,0,3
1045_1,,,,2,2,1,3
1046_0,,,,2,2,1,3
1048_0,,,,2,2,1,3
C(C(C(C(C(C=O)O)O)O)NC)=O,,,3,1,2,0,2
1048_1,,,,2,2,1,3
1050_0,,,,2,2,1,3
C(CC(C)O)=O,,,3,1,1,0,1
1052_0,,,,2,2,1,3
C(CC(CO)(C(CO)O)O)=O,,,3,1,1,0,1
1054_0,,,,2,2,1,3
C(C(C(C)O)O)(C(CO)O)=O,,,3,1,2,0,2
1054_1,,,,2,2,1,3
1056_0,,,,2,2,1,3
C(CC(CNC)O)=O,,,3,1,1,0,1
1058_0,,,,2,2,1,3
C(C(C(C)O)NC)=O,,,3,1,2,0,2
1058_1,,,,2,2,1,3
1060_0,,,,2,2,1,3
C(CC(CNC)(C(CO)O)O)=O,,,3,1,1,0,1
1062_0,,,,2,2,1,3
C(C(CO)O)(C(C(C)O)NC)=O,,,3,1,2,0,2
1062_1,,,,2,2,1,3
1064_0,,,,2,2,1,3
C(CC(CNCC(O)=O)O)=O,,,3,1,1,0,1
1066_0,,,,2,2,1,3
C(C(C(C)O)NCC(O)=O)=O,,,3,1,2,0,2
1066_1,,,,2,2,1,3
1068_0,,,,2,2,1,3
C(CC(C(CO)(C(CO)O)O)O)=O,,,3,1,1,0,1
1070_0,,,,2,2,1,3
C(CC(C(CC(CCO)=O)=O)O)=O,,,3,1,1,0,1
1072_0,,,,2,2,1,3
C(CC(C=O)(CC=O)O)(CCO)=O,,,3,1,1,0,1
1074_0,,,,2,2,1,3
C(CC(CCO)(CC(C=O)=O)O)=O,,,3,1,1,0,1
1076_0,,,,2,2,1,3
C(CCO)(C(C(C=O)=O)C(C)O)=O,,,3,1,2,0,2
1076_1,,,,2,2,1,3
1078_0,,,,2,2,1,3
C(C(CO)C(C)O)(CC(C=O)=O)=O,,,3,1,2,0,2
1078_1,,,,2,2,1,3
1080_0,,,,2,2,1,3
C(CC(C(CCC(CO)=O)=O)O)=O,,,3,1,1,0,1
1082_0,,,,2,2,1,3
C(CO)(CCC(C=O)(CC=O)O)=O,,,3,1,1,0,1
1084_0,,,,2,2,1,3
C(CC(CCC(C=O)=O)(CO)O)=O,,,3,1,1,0,1
1086_0,,,,2,2,1,3
C(CC(C(C=O)=O)C(C)O)(CO)=O,,,3,1,1,0,1
1088_0,,,,2,2,1,3
C(CO)(C(C(C)O)CC(C=O)=O)=O,,,3,1,1,0,1
1090_0,,,,2,2,1,3
C(CCC(C=O)=O)(C(C(C)O)O)=O,,,3,1,2,0,2
1090_1,,,,2,2,1,3
1092_0,,,,2,2,1,3
C(CC(C(CC(C(C)=O)O)=O)O)=O,,,3,1,1,0,1
1094_0,,,,2,2,1,3
C(C)(C(CC(C=O)(CC=O)O)O)=O,,,3,1,1,0,1
1096_0,,,,2,2,1,3
C(CC(C)(C(CC(C=O)=O)O)O)=O,,,3,1,1,0,1
1098_0,,,,2,2,1,3
C(C(C(C(C=O)=O)C(C)O)O)(C)=O,,,3,1,2,0,2
1098_1,,,,2,2,1,3
1100_0,,,,2,2,1,3
C(C(CC(C=O)=O)O)(CC(C)O)=O,,,3,1,1,0,1
1102_0,,,,2,2,1,3
C(CC(C(CC(CC=O)O)=O)O)=O,,,3,1,2,0,2
1104_0,,,,2,2,1,3
C(CC(CC(C=O)(CC=O)O)O)=O,,,3,1,1,0,1
1106_0,,,,2,2,1,3
C(CC(CC(CC(C=O)=O)O)O)=O,,,3,1,1,0,1
1108_0,,,,2,2,1,3
C(CC(C(C(C=O)=O)C(C)O)O)=O,,,3,1,2,0,2
1108_1,,,,2,2,1,3
1110_0,,,,2,2,1,3
C(C(C(CC(C=O)=O)O)C(C)O)=O,,,3,1,2,0,2
1110_1,,,,2,2,1,3
1112_0,,,,2,2,1,3
C(CC(CC(C(CCO)=O)=O)O)=O,,,3,1,1,0,1
1114_0,,,,2,2,1,3
C(CC(C(CCO)=O)(CC=O)O)=O,,,3,1,1,0,1
1116_0,,,,2,2,1,3
C(C(CCO)(CC=O)O)(CC=O)=O,,,3,1,1,0,1
1118_0,,,,2,2,1,3
C(C(C(C(CCO)=O)=O)C(C)O)=O,,,3,1,2,0,2
1118_1,,,,2,2,1,3
1120_0,,,,2,2,1,3
C(CC(C(C(CO)C(C)O)=O)=O)=O,,,3,1,2,0,2
1120_1,,,,2,2,1,3
1122_0,,,,2,2,1,3
C(CC(CC(CC(CO)=O)=O)O)=O,,,3,1,1,0,1
1124_0,,,,2,2,1,3
C(CC(CC=O)(CC(CO)=O)O)=O,,,3,1,1,0,1
1126_0,,,,2,2,1,3
C(CC(CC(CO)(CC=O)O)=O)=O,,,3,1,1,0,1
1128_0,,,,2,2,1,3
C(C(C(CC(CO)=O)=O)C(C)O)=O,,,3,1,2,0,2
1128_1,,,,2,2,1,3
1130_0,,,,2,2,1,3
C(CC=O)(C(C(CO)=O)C(C)O)=O,,,3,1,2,0,2
1130_1,,,,2,2,1,3
1132_0,,,,2,2,1,3
C(CC(CC(C(C(C)O)O)=O)=O)=O,,,3,1,2,0,2
1132_1,,,,2,2,1,3
1134_0,,,,2,2,1,3
C(CC(CC(C(C(C)=O)O)=O)O)=O,,,3,1,1,0,1
1136_0,,,,2,2,1,3
C(CC(C(C(C)=O)O)(CC=O)O)=O,,,3,1,1,0,1
1138_0,,,,2,2,1,3
C(CC(C)(C(C(CC=O)=O)O)O)=O,,,3,1,1,0,1
1140_0,,,,2,2,1,3
C(C(C(C(C(C)=O)O)=O)C(C)O)=O,,,3,1,2,0,2
1140_1,,,,2,2,1,3
1142_0,,,,2,2,1,3
C(CC(C(C(CC(C)O)=O)O)=O)=O,,,3,1,1,0,1
1143_0,,,,2,2,1,3
1145_0,,,,2,2,1,3
C(CC(C(CC=O)O)(CC=O)O)=O,,,3,1,1,0,1
1147_0,,,,2,2,1,3
C(CC(CC(C(CC=O)=O)O)O)=O,,,3,1,1,0,1
1149_0,,,,2,2,1,3
C(CC(C(C(C=O)C(C)O)=O)O)=O,,,3,1,2,0,2
1149_1,,,,2,2,1,3
1151_0,,,,2,2,1,3
C(C(C(C)O)C(C(CC=O)=O)O)=O,,,3,1,2,0,2
1151_1,,,,2,2,1,3
1153_0,,,,2,2,1,3
C(CC(C(C(CC(C)=O)=O)O)O)=O,,,3,1,1,0,1
1155_0,,,,2,2,1,3
C(CC(C(C=O)O)(CC(C)=O)O)=O,,,3,1,1,0,1
1157_0,,,,2,2,1,3
C(C(C(CC(C)(CC=O)O)=O)O)=O,,,3,1,1,0,1
1159_0,,,,2,2,1,3
C(C(C=O)O)(C(C(C)=O)C(C)O)=O,,,3,1,2,0,2
1159_1,,,,2,2,1,3
1161_0,,,,2,2,1,3
C(C(C=O)O)(CC(CC(C)O)=O)=O,,,3,1,1,0,1
1163_0,,,,2,2,1,3
C(CC(C(C(CCC=O)=O)O)O)=O,,,3,1,1,0,1
1165_0,,,,2,2,1,3
C(CCC(C(C=O)O)(CC=O)O)=O,,,3,1,1,0,1
1167_0,,,,2,2,1,3
C(C(C(CCC(CC=O)O)=O)O)=O,,,3,1,1,0,1
1169_0,,,,2,2,1,3
C(C(C(C)O)CC=O)(C(C=O)O)=O,,,3,1,1,0,1
1171_0,,,,2,2,1,3
C(C(C(C)O)CC(C(C=O)O)=O)=O,,,3,1,1,0,1
1173_0,,,,2,2,1,3
C(CC(C(CC(C(C)=O)=O)O)O)=O,,,3,1,1,0,1
1175_0,,,,2,2,1,3
C(C)(C(CC(C=O)O)(CC=O)O)=O,,,3,1,1,0,1
1177_0,,,,2,2,1,3
C(CC(C=O)O)(C(C)(CC=O)O)=O,,,3,1,1,0,1
1179_0,,,,2,2,1,3
C(C(C(C(C(C)=O)=O)C(C)O)O)=O,,,3,1,2,0,2
1179_1,,,,2,2,1,3
1181_0,,,,2,2,1,3
C(C(CC(C(CC(C)O)=O)=O)O)=O,,,3,1,1,0,1
1183_0,,,,2,2,1,3
C(CC(CC(C(CC=O)O)O)=O)=O,,,3,1,1,0,1
1185_0,,,,2,2,1,3
C(CC(CC(C=O)O)(CC=O)O)=O,,,3,1,1,0,1
1187_0,,,,2,2,1,3
C(CC(C=O)O)(CC(CC=O)O)=O,,,3,1,1,0,1
1189_0,,,,2,2,1,3
C(C(C(C)O)C(C=O)O)(CC=O)=O,,,3,1,2,0,2
1189_1,,,,2,2,1,3
1191_0,,,,2,2,1,3
C(CC(C=O)O)(C(C=O)C(C)O)=O,,,3,1,2,0,2
1191_1,,,,2,2,1,3
1193_0,,,,2,2,1,3
C(CC(C(C=CC(CO)O)=O)O)=O,,,3,1,1,0,1
1195_0,,,,2,2,1,3
C(C(C=CC(CO)O)(CC=O)O)=O,,,3,1,1,0,1
1197_0,,,,2,2,1,3
C(CC(C(C(C=CCO)=O)O)O)=O,,,3,1,1,0,1
1199_0,,,,2,2,1,3
C(CC(C=CCO)(C(C=O)O)O)=O,,,3,1,1,0,1
1201_0,,,,2,2,1,3
C(CC(C=CC(C(CO)O)=O)O)=O,,,3,1,1,0,1
1203_0,,,,2,2,1,3
C(CC(C=CC=O)(C(CO)O)O)=O,,,3,1,1,0,1
1205_0,,,,2,2,1,3
C(CC(C(C(C(C=C)=O)O)O)O)=O,,,3,1,1,0,1
1207_0,,,,2,2,1,3
C(C(C(C(C=C)(CC=O)O)O)O)=O,,,3,1,1,0,1
1209_0,,,,2,2,1,3
C(CC(C(C=CC(CO)=O)O)O)=O,,,3,1,1,0,1
1211_0,,,,2,2,1,3
C(C(C=CC(CO)(CC=O)O)O)=O,,,3,1,1,0,1
1213_0,,,,2,2,1,3
C(C(C=CC(C(C(C)O)O)=O)O)=O,,,3,1,2,0,2
1213_1,,,,2,2,1,3
1215_0,,,,2,2,1,3
C(CC(C(C(C=CC=O)O)O)O)=O,,,3,1,1,0,1
1217_0,,,,2,2,1,3
C(C(C(C=CC(CC=O)O)O)O)=O,,,3,1,1,0,1
1219_0,,,,2,2,1,3
C(CC(C(C(CO)NC)O)O)=O,,,3,1,1,0,1
1221_0,,,,2,2,1,3
C(C(CO)O)(C(C(CNC)O)O)=O,,,3,1,3,0,3
1221_1,,,,2,2,1,3
1223_0,,,,2,2,1,3
C(C(C(CO)(C(CO)O)O)NC)=O,,,3,1,2,0,2
1223_1,,,,2,2,1,3
1225_0,,,,2,2,1,3
C(C(C(CNC)O)NC)=O,,,3,1,2,0,2
1225_1,,,,2,2,1,3
1227_0,,,,2,2,1,3
C(C(C(CNCC(O)=O)O)NC)=O,,,3,1,2,0,2
1227_1,,,,2,2,1,3
1229_0,,,,2,2,1,3
C(C(C(CNC)O)NCC(O)=O)=O,,,3,1,2,0,2
1229_1,,,,2,2,1,3
1231_0,,,,2,2,1,3
C(C(C(C(C=O)O)O)O)(O)=O,,,3,1,3,0,3
1231_1,,,,2,2,1,3
1233_0,,,,2,2,1,3
C(C(C(C(C(C=O)O)O)O)O)(O)=O,,,3,1,3,0,3
1233_1,,,,2,2,1,3
1235_0,,,,2,2,1,3
C(C(C(C(CO)O)O)O)=O,,,3,1,296,0,296
1235_1,,,,2,2,1,3
1237_0,,,,2,2,1,3
C(C(C(CO)(CO)O)O)=O,,,3,1,2,0,2
1237_1,,,,2,2,1,3
1239_0,,,,2,2,1,3
C(CO)(C(C(CO)O)O)=O,,,3,1,4,0,4
1239_1,,,,2,2,1,3
1240_0,,,,2,2,1,3
1240_1,,,,2,2,1,3
1242_0,,,,2,2,1,3
C(C(C)(C(C=O)O)O)=O,,,3,1,2,0,2
1242_1,,,,2,2,1,3
1244_0,,,,2,2,1,3
C(C(CC(CO)O)=O)=O,,,3,1,2,0,2
1245_0,,,,2,2,1,3
1245_1,,,,2,2,1,3
1247_0,,,,2,2,1,3
C(CC(CO)(C(C=O)O)O)=O,,,3,1,2,0,2
1247_1,,,,2,2,1,3
1249_0,,,,2,2,1,3
C(C(C(CO)=O)C(CO)O)=O,,,3,1,3,0,3
1249_1,,,,2,2,1,3
1250_0,,,,2,2,1,3
1250_1,,,,2,2,1,3
1251_0,,,,2,2,1,3
1251_1,,,,2,2,1,3
1253_0,,,,2,2,1,3
C(C(C(C)(C(C=O)O)O)O)=O,,,3,1,2,0,2
1253_1,,,,2,2,1,3
1254_0,,,,2,2,1,3
1255_0,,,,2,2,1,3
1255_1,,,,2,2,1,3
1257_0,,,,2,2,1,3
C(C(C(C)(C(CO)O)O)O)=O,,,3,1,2,0,2
1257_1,,,,2,2,1,3
1258_0,,,,2,2,1,3
1259_0,,,,2,2,1,3
1259_1,,,,2,2,1,3
1261_0,,,,2,2,1,3
C(C(CC(CO)(C(C=O)O)O)O)=O,,,3,1,2,0,2
1261_1,,,,2,2,1,3
1263_0,,,,2,2,1,3
C(CO)(C(C(CO)O)C(C=O)O)=O,,,3,1,2,0,2
1263_1,,,,2,2,1,3
1265_0,,,,2,2,1,3
C(CC(C=O)O)(C(C(CO)O)O)=O,,,3,1,2,0,2
1265_1,,,,2,2,1,3
1266_0,,,,2,2,1,3
1266_1,,,,2,2,1,3
1268_0,,,,2,2,1,3
C(C(CCO)(C(C=O)O)O)=O,,,3,1,2,0,2
1268_1,,,,2,2,1,3
1270_0,,,,2,2,1,3
C(C(C(CO)C(CO)O)=O)=O,,,3,1,2,0,2
1270_1,,,,2,2,1,3
1272_0,,,,2,2,1,3
C(C(C(CO)(CCO)O)O)=O,,,3,1,2,0,2
1272_1,,,,2,2,1,3
1273_0,,,,2,2,1,3
1273_1,,,,2,2,1,3
1275_0,,,,2,2,1,3
C(CO)(C(CO)C(CO)O)=O,,,3,1,2,0,2
1275_1,,,,2,2,1,3
1276_0,,,,2,2,1,3
1276_1,,,,2,2,1,3
1278_0,,,,2,2,1,3
C(C(C(C(C)(C(C=O)O)O)O)O)=O,,,3,1,2,0,2
1278_1,,,,2,2,1,3
1280_0,,,,2,2,1,3
C(C(C(C=O)O)O)(CC(CO)O)=O,,,3,1,1,0,1
1282_0,,,,2,2,1,3
C(C(C(C(C=O)O)O)O)=O,,,3,1,2,0,2
1282_1,,,,2,2,1,3
1284_0,,,,2,2,1,3
C(C(C(CO)(C)O)O)=O,,,3,1,2,0,2
1284_1,,,,2,2,1,3
1286_0,,,,2,2,1,3
C(CO)(CC(CO)O)=O,,,3,1,6,0,6
1288_0,,,,2,2,1,3
C(C)(C(C(CO)O)O)=O,,,3,1,6,0,6
1288_1,,,,2,2,1,3
1289_0,,,,2,2,1,3
1289_1,,,,2,2,1,3
1290_0,,,,2,2,1,3
1290_1,,,,2,2,1,3
1292_0,,,,2,2,1,3
C(C(C(CO)O)C(C=O)O)=O,,,3,1,2,0,2
1292_1,,,,2,2,1,3
1294_0,,,,2,2,1,3
C(C(C(C(C(C=O)O)O)O)O)=O,,,3,1,2,0,2
1294_1,,,,2,2,1,3
1296_0,,,,2,2,1,3
C(C(C(C)O)O)=O,,,3,1,2,0,2
1296_1,,,,2,2,1,3
1298_0,,,,2,2,1,3
C(CC(CO)O)=O,,,3,1,4,0,4
1300_0,,,,2,2,1,3
C(C(C(CO)(C(CO)O)O)O)=O,,,3,1,2,0,2
1300_1,,,,2,2,1,3
1301_0,,,,2,2,1,3
1301_1,,,,2,2,1,3
1303_0,,,,2,2,1,3
C(C(C(CNC)O)O)=O,,,3,1,2,0,2
1303_1,,,,2,2,1,3
1305_0,,,,2,2,1,3
C(C(C(CO)O)NC)=O,,,3,1,3,0,3
1305_1,,,,2,2,1,3
1307_0,,,,2,2,1,3
C(C(C(CNC)(C(CO)O)O)O)=O,,,3,1,2,0,2
1307_1,,,,2,2,1,3
1309_0,,,,2,2,1,3
C(C(CO)O)(C(C(CO)O)NC)=O,,,3,1,7,0,7
1309_1,,,,2,2,1,3
1311_0,,,,2,2,1,3
C(C(C(CNCC(O)=O)O)O)=O,,,3,1,2,0,2
1311_1,,,,2,2,1,3
1313_0,,,,2,2,1,3
C(C(C(CO)O)NCC(O)=O)=O,,,3,1,3,0,3
1313_1,,,,2,2,1,3
1315_0,,,,2,2,1,3
C(C(C(C(C(CO)NC)O)O)O)=O,,,3,1,5,0,5
1315_1,,,,2,2,1,3
1317_0,,,,2,2,1,3
C(C(CC(C(C(CO)O)O)O)=O)=O,,,3,1,1,0,1
1319_0,,,,2,2,1,3
C(CO)(CC(C(C(CO)O)O)O)=O,,,3,1,1,0,1
1321_0,,,,2,2,1,3
C(C)(C(C(C(C(CO)O)O)O)O)=O,,,3,1,2,0,2
1321_1,,,,2,2,1,3
1322_0,,,,2,2,1,3
1323_0,,,,2,2,1,3
1323_1,,,,2,2,1,3
1325_0,,,,2,2,1,3
C(C(C(CO)=O)O)(O)=O,,,3,1,3,0,3
1325_1,,,,2,2,1,3
1327_0,,,,2,2,1,3
C(CC(C=O)=O)(O)=O,,,3,1,2,0,2
1329_0,,,,2,2,1,3
C(C(C=O)C(CO)=O)(O)=O,,,3,1,3,0,3
1329_1,,,,2,2,1,3
1331_0,,,,2,2,1,3
C(C(C(CC=O)=O)O)(O)=O,,,3,1,2,0,2
1331_1,,,,2,2,1,3
1333_0,,,,2,2,1,3
C(CC(C(C=O)O)=O)(O)=O,,,3,1,1,0,1
1335_0,,,,2,2,1,3
C(CC(C(CO)O)=O)(O)=O,,,3,1,1,0,1
1337_0,,,,2,2,1,3
C(C(C(CO)=O)C(C=O)O)(O)=O,,,3,1,2,0,2
1337_1,,,,2,2,1,3
1339_0,,,,2,2,1,3
C(C(C(CC(C=O)O)=O)O)(O)=O,,,3,1,2,0,2
1339_1,,,,2,2,1,3
1341_0,,,,2,2,1,3
C(C(C(C=O)=O)CO)(O)=O,,,3,1,2,0,2
1341_1,,,,2,2,1,3
1343_0,,,,2,2,1,3
C(C(C(CCO)=O)O)(O)=O,,,3,1,2,0,2
1343_1,,,,2,2,1,3
1345_0,,,,2,2,1,3
C(C(C(CO)=O)CO)(O)=O,,,3,1,2,0,2
1345_1,,,,2,2,1,3
1347_0,,,,2,2,1,3
C(CC(C(C(C=O)O)O)=O)(O)=O,,,3,1,1,0,1
1349_0,,,,2,2,1,3
C(CC(CO)=O)(O)=O,,,3,1,6,0,6
1351_0,,,,2,2,1,3
C(C(C(C)=O)O)(O)=O,,,3,1,5,0,5
1351_1,,,,2,2,1,3
1353_0,,,,2,2,1,3
C(C(C=O)C(C=O)O)(O)=O,,,3,1,2,0,2
1353_1,,,,2,2,1,3
1355_0,,,,2,2,1,3
C(CC(O)=O)=O,,,3,1,2,0,2
1357_0,,,,2,2,1,3
C(C(C(C(CO)O)=O)O)(O)=O,,,3,1,2,0,2
1357_1,,,,2,2,1,3
1359_0,,,,2,2,1,3
C(C(C(O)=O)NC)=O,,,3,1,3,0,3
1359_1,,,,2,2,1,3
1359_2,,,,2,2,1,3
1361_0,,,,2,2,1,3
C(C(C(C(CO)O)=O)NC)(O)=O,,,3,1,3,0,3
1361_1,,,,2,2,1,3
1361_2,,,,2,2,1,3
1363_0,,,,2,2,1,3
C(C(C(O)=O)NCC(O)=O)=O,,,3,1,3,0,3
1363_1,,,,2,2,1,3
1363_2,,,,2,2,1,3
1365_0,,,,2,2,1,3
C(C(C(CCO)=O)C(C=O)=O)(O)=O,,,3,1,2,0,2
1365_1,,,,2,2,1,3
1367_0,,,,2,2,1,3
C(C(C(CC(C=O)=O)=O)CO)(O)=O,,,3,1,2,0,2
1367_1,,,,2,2,1,3
1369_0,,,,2,2,1,3
C(C(C(C=O)=O)CC(CO)=O)(O)=O,,,3,1,1,0,1
1371_0,,,,2,2,1,3
C(C(C(CO)=O)CC(C=O)=O)(O)=O,,,3,1,1,0,1
1373_0,,,,2,2,1,3
C(C(C(CCC(C=O)=O)=O)O)(O)=O,,,3,1,2,0,2
1373_1,,,,2,2,1,3
1375_0,,,,2,2,1,3
C(C(C(C=O)=O)C(C(C)=O)O)(O)=O,,,3,1,2,0,2
1375_1,,,,2,2,1,3
1377_0,,,,2,2,1,3
C(CC(C(CC(C=O)=O)O)=O)(O)=O,,,3,1,1,0,1
1379_0,,,,2,2,1,3
C(C(C(C=O)=O)C(CC=O)O)(O)=O,,,3,1,2,0,2
1379_1,,,,2,2,1,3
1381_0,,,,2,2,1,3
C(C(C=O)C(CC(C=O)=O)O)(O)=O,,,3,1,2,0,2
1381_1,,,,2,2,1,3
1383_0,,,,2,2,1,3
C(C(C=O)C(C(CCO)=O)=O)(O)=O,,,3,1,2,0,2
1383_1,,,,2,2,1,3
1385_0,,,,2,2,1,3
C(C(C(C(CC=O)=O)=O)CO)(O)=O,,,3,1,2,0,2
1385_1,,,,2,2,1,3
1387_0,,,,2,2,1,3
C(C(C=O)C(CC(CO)=O)=O)(O)=O,,,3,1,2,0,2
1387_1,,,,2,2,1,3
1389_0,,,,2,2,1,3
C(C(C(CC=O)=O)C(CO)=O)(O)=O,,,3,1,2,0,2
1389_1,,,,2,2,1,3
1391_0,,,,2,2,1,3
C(C(C(CC(CC=O)=O)=O)O)(O)=O,,,3,1,2,0,2
1391_1,,,,2,2,1,3
1393_0,,,,2,2,1,3
C(C(C=O)C(C(C(C)=O)O)=O)(O)=O,,,3,1,2,0,2
1393_1,,,,2,2,1,3
1395_0,,,,2,2,1,3
C(CC(C(C(CC=O)=O)O)=O)(O)=O,,,3,1,1,0,1
1397_0,,,,2,2,1,3
C(C(C=O)C(C(CC=O)O)=O)(O)=O,,,3,1,2,0,2
1397_1,,,,2,2,1,3
1399_0,,,,2,2,1,3
C(C(C=O)C(C(CC=O)=O)O)(O)=O,,,3,1,2,0,2
1399_1,,,,2,2,1,3
1401_0,,,,2,2,1,3
C(C(C(C(C=O)O)=O)C(C)=O)(O)=O,,,3,1,2,0,2
1401_1,,,,2,2,1,3
1403_0,,,,2,2,1,3
C(CC(CC(C(C=O)O)=O)=O)(O)=O,,,3,1,1,0,1
1405_0,,,,2,2,1,3
C(C(C(C(C=O)O)=O)CC=O)(O)=O,,,3,1,1,0,1
1407_0,,,,2,2,1,3
C(C(C=O)CC(C(C=O)O)=O)(O)=O,,,3,1,1,0,1
1409_0,,,,2,2,1,3
C(C(C(C(C)=O)=O)C(C=O)O)(O)=O,,,3,1,2,0,2
1409_1,,,,2,2,1,3
1411_0,,,,2,2,1,3
C(CC(C(CC(C=O)O)=O)=O)(O)=O,,,3,1,1,0,1
1413_0,,,,2,2,1,3
C(C(C(CC=O)=O)C(C=O)O)(O)=O,,,3,1,2,0,2
1413_1,,,,2,2,1,3
1415_0,,,,2,2,1,3
C(C(C=O)C(CC(C=O)O)=O)(O)=O,,,3,1,2,0,2
1415_1,,,,2,2,1,3
1417_0,,,,2,2,1,3
C(C(C(C=CC(C=O)O)=O)O)(O)=O,,,3,1,2,0,2
1417_1,,,,2,2,1,3
1419_0,,,,2,2,1,3
C(C(C(C(CO)=O)O)O)(O)=O,,,3,1,2,0,2
1419_1,,,,2,2,1,3
1421_0,,,,2,2,1,3
C(C(CC(C=O)=O)O)(O)=O,,,3,1,1,0,1
1423_0,,,,2,2,1,3
C(C(C(CO)=O)C(C(O)=O)O)=O,,,3,1,3,0,3
1423_1,,,,2,2,1,3
1425_0,,,,2,2,1,3
C(CC(C(C(C(O)=O)O)O)=O)=O,,,3,1,2,0,2
1425_1,,,,2,2,1,3
1427_0,,,,2,2,1,3
C(C(C(CC(C(O)=O)O)=O)O)=O,,,3,1,1,0,1
1428_0,,,,2,2,1,3
1430_0,,,,2,2,1,3
C(C(C(C(C=O)=O)CO)O)(O)=O,,,3,1,2,0,2
1430_1,,,,2,2,1,3
1431_0,,,,2,2,1,3
1431_1,,,,2,2,1,3
1433_0,,,,2,2,1,3
C(CO)(C(CO)C(C(O)=O)O)=O,,,3,1,2,0,2
1433_1,,,,2,2,1,3
1435_0,,,,2,2,1,3
C(C(CC(CO)=O)O)(O)=O,,,3,1,4,0,4
1437_0,,,,2,2,1,3
C(C(C(C(C)=O)O)O)(O)=O,,,3,1,5,0,5
1437_1,,,,2,2,1,3
1439_0,,,,2,2,1,3
C(C(C(C=O)C(C=O)O)O)(O)=O,,,3,1,2,0,2
1439_1,,,,2,2,1,3
1441_0,,,,2,2,1,3
C(C(CC=O)O)(O)=O,,,3,1,3,0,3
1443_0,,,,2,2,1,3
C(C(C(C(O)=O)O)O)(C(CO)O)=O,,,3,1,2,0,2
1443_1,,,,2,2,1,3
1445_0,,,,2,2,1,3
C(C(C(C(O)=O)O)NC)=O,,,3,1,3,0,3
1445_1,,,,2,2,1,3
1447_0,,,,2,2,1,3
C(C(C(C=O)NCC(O)=O)O)(O)=O,,,3,1,3,0,3
1447_1,,,,2,2,1,3
1448_0,,,,2,2,1,3
1448_1,,,,2,2,1,3
1449_0,,,,2,2,1,3
1449_1,,,,2,2,1,3
1450_0,,,,2,2,1,3
1452_0,,,,2,2,1,3
C(C(C(CO)=O)CO)=O,,,3,1,7,0,7
1452_1,,,,2,2,1,3
1454_0,,,,2,2,1,3
C(CC(C(CO)O)=O)=O,,,3,1,7,0,7
1454_1,,,,2,2,1,3
1456_0,,,,2,2,1,3
C(C(C(CCO)=O)O)=O,,,3,1,5,0,5
1458_0,,,,2,2,1,3
C(C(CO)O)(CCO)=O,,,3,1,8,0,8
1459_0,,,,2,2,1,3
1459_1,,,,2,2,1,3
1460_0,,,,2,2,1,3
1460_1,,,,2,2,1,3
1462_0,,,,2,2,1,3
C(C(C(CO)CO)=O)=O,,,3,1,4,0,4
1462_1,,,,2,2,1,3
1463_0,,,,2,2,1,3
1463_1,,,,2,2,1,3
1465_0,,,,2,2,1,3
C(CO)(C(CO)CO)=O,,,3,1,4,0,4
1465_1,,,,2,2,1,3
1466_0,,,,2,2,1,3
1467_0,,,,2,2,1,3
1468_0,,,,2,2,1,3
1468_1,,,,2,2,1,3
1470_0,,,,2,2,1,3
C(C(CO)C(C=O)O)=O,,,3,1,4,0,4
1470_1,,,,2,2,1,3
1472_0,,,,2,2,1,3
C(CCO)=O,,,3,1,3,0,3
1474_0,,,,2,2,1,3
C(C(CO)O)(C(CO)O)=O,,,3,1,2,0,2
1474_1,,,,2,2,1,3
1476_0,,,,2,2,1,3
C(C(CO)C(C(C(CO)O)=O)O)=O,,,3,1,3,0,3
1476_1,,,,2,2,1,3
1478_0,,,,2,2,1,3
C(C(C(CO)O)=O)(CC(CO)O)=O,,,3,1,2,0,2
1478_1,,,,2,2,1,3
1480_0,,,,2,2,1,3
C(C(CO)=O)(C(CO)C(CO)O)=O,,,3,1,3,0,3
1480_1,,,,2,2,1,3
1482_0,,,,2,2,1,3
C(C(CO)O)(CC(C(CO)O)=O)=O,,,3,1,2,0,2
1482_1,,,,2,2,1,3
1484_0,,,,2,2,1,3
C(C(CO)O)(C(C(CO)=O)CO)=O,,,3,1,3,0,3
1484_1,,,,2,2,1,3
1486_0,,,,2,2,1,3
C(C(CC(C(C(CO)O)=O)O)O)=O,,,3,1,2,0,2
1486_1,,,,2,2,1,3
1488_0,,,,2,2,1,3
C(CCO)(C(C(C(CO)O)=O)O)=O,,,3,1,2,0,2
1488_1,,,,2,2,1,3
1490_0,,,,2,2,1,3
C(C(CO)CO)(C(C(CO)=O)O)=O,,,3,1,3,0,3
1490_1,,,,2,2,1,3
1492_0,,,,2,2,1,3
C(CC(C(C(CO)O)=O)O)(CO)=O,,,3,1,2,0,2
1492_1,,,,2,2,1,3
1494_0,,,,2,2,1,3
C(CO)(C(CO)C(C(CO)=O)O)=O,,,3,1,3,0,3
1494_1,,,,2,2,1,3
1496_0,,,,2,2,1,3
C(CC(C(CO)=O)O)(C(CO)O)=O,,,3,1,3,0,3
1496_1,,,,2,2,1,3
1497_0,,,,2,2,1,3
1497_1,,,,2,2,1,3
1498_0,,,,2,2,1,3
1500_0,,,,2,2,1,3
C(CC(C(C(C(CO)O)=O)O)O)=O,,,3,1,2,0,2
1500_1,,,,2,2,1,3
1502_0,,,,2,2,1,3
C(C(CO)C(C(C(CO)=O)O)O)=O,,,3,1,3,0,3
1502_1,,,,2,2,1,3
1504_0,,,,2,2,1,3
C(C(CO)NC)=O,,,3,1,3,0,3
1504_1,,,,2,2,1,3
1506_0,,,,2,2,1,3
C(C(CO)O)(C(CO)NC)=O,,,3,1,2,0,2
1506_1,,,,2,2,1,3
1508_0,,,,2,2,1,3
C(C(CO)NCC(O)=O)=O,,,3,1,3,0,3
1508_1,,,,2,2,1,3
1509_0,,,,2,2,1,3
1509_1,,,,2,2,1,3
1510_0,,,,2,2,1,3
1510_1,,,,2,2,1,3
1512_0,,,,2,2,1,3
C(C(C(CO)O)O)(C(CO)CO)=O,,,3,1,4,0,4
1512_1,,,,2,2,1,3
1514_0,,,,2,2,1,3
C(C(CO)O)(C(CO)C(CO)O)=O,,,3,1,4,0,4
1514_1,,,,2,2,1,3
1515_0,,,,2,2,1,3
1517_0,,,,2,2,1,3
C(C(CO)C(C(C(CO)O)O)O)=O,,,3,1,3,0,3
1517_1,,,,2,2,1,3
1518_0,,,,2,2,1,3
1518_1,,,,2,2,1,3
1520_0,,,,2,2,1,3
C(C(CO)N)(CC(C(CO)O)O)=O,,,3,1,2,0,2
1520_1,,,,2,2,1,3
1522_0,,,,2,2,1,3
C(CN)(C(CO)C(C(CO)O)O)=O,,,3,1,13,0,13
1522_1,,,,2,2,1,3
1524_0,,,,2,2,1,3
C(CCO)(C(C(C=O)=O)CO)=O,,,3,1,4,0,4
1524_1,,,,2,2,1,3
1526_0,,,,2,2,1,3
C(C(CO)CO)(CC(C=O)=O)=O,,,3,1,3,0,3
1526_1,,,,2,2,1,3
1528_0,,,,2,2,1,3
C(CC(C(C=O)=O)CO)(CO)=O,,,3,1,2,0,2
1530_0,,,,2,2,1,3
C(CO)(C(CO)CC(C=O)=O)=O,,,3,1,2,0,2
1532_0,,,,2,2,1,3
C(CCC(C=O)=O)(C(CO)O)=O,,,3,1,3,0,3
1532_1,,,,2,2,1,3
1533_0,,,,2,2,1,3
1533_1,,,,2,2,1,3
1534_0,,,,2,2,1,3
1536_0,,,,2,2,1,3
C(CC(C(C(C=O)=O)CO)O)=O,,,3,1,3,0,3
1536_1,,,,2,2,1,3
1538_0,,,,2,2,1,3
C(C(CO)C(CC(C=O)=O)O)=O,,,3,1,3,0,3
1538_1,,,,2,2,1,3
1540_0,,,,2,2,1,3
C(C(C(C(CCO)=O)=O)CO)=O,,,3,1,4,0,4
1540_1,,,,2,2,1,3
1542_0,,,,2,2,1,3
C(CC(C(C(CO)CO)=O)=O)=O,,,3,1,3,0,3
1542_1,,,,2,2,1,3
1544_0,,,,2,2,1,3
C(C(C(CC(CO)=O)=O)CO)=O,,,3,1,4,0,4
1544_1,,,,2,2,1,3
1546_0,,,,2,2,1,3
C(CC=O)(C(C(CO)=O)CO)=O,,,3,1,4,0,4
1546_1,,,,2,2,1,3
1548_0,,,,2,2,1,3
C(CC(CC(C(CO)O)=O)=O)=O,,,3,1,3,0,3
1548_1,,,,2,2,1,3
1550_0,,,,2,2,1,3
C(C(C(C(C(C)=O)O)=O)CO)=O,,,3,1,4,0,4
1550_1,,,,2,2,1,3
1552_0,,,,2,2,1,3
C(CC(C(C(CCO)=O)O)=O)=O,,,3,1,2,0,2
1554_0,,,,2,2,1,3
C(CC(C(C(C=O)CO)=O)O)=O,,,3,1,4,0,4
1554_1,,,,2,2,1,3
1556_0,,,,2,2,1,3
C(C(CO)C(C(CC=O)=O)O)=O,,,3,1,3,0,3
1556_1,,,,2,2,1,3
1558_0,,,,2,2,1,3
C(C(C=O)O)(C(C(C)=O)CO)=O,,,3,1,4,0,4
1558_1,,,,2,2,1,3
1560_0,,,,2,2,1,3
C(C(C=O)O)(CC(CCO)=O)=O,,,3,1,2,0,2
1562_0,,,,2,2,1,3
C(C(CO)CC=O)(C(C=O)O)=O,,,3,1,2,0,2
1564_0,,,,2,2,1,3
C(C(CO)CC(C(C=O)O)=O)=O,,,3,1,2,0,2
1566_0,,,,2,2,1,3
C(C(C(C(C(C)=O)=O)CO)O)=O,,,3,1,3,0,3
1566_1,,,,2,2,1,3
1568_0,,,,2,2,1,3
C(C(CC(C(CCO)=O)=O)O)=O,,,3,1,2,0,2
1570_0,,,,2,2,1,3
C(C(CO)C(C=O)O)(CC=O)=O,,,3,1,3,0,3
1570_1,,,,2,2,1,3
1572_0,,,,2,2,1,3
C(CC(C=O)O)(C(C=O)CO)=O,,,3,1,4,0,4
1572_1,,,,2,2,1,3
1574_0,,,,2,2,1,3
C1(C(CO)OC(C(CO)O)C1O)=O,,,3,1,2,0,2
1574_1,,,,2,2,1,3
1576_0,,,,2,2,1,3
C1(C(O)OC(C(CO)O)C1CO)=O,,,3,1,3,0,3
1576_1,,,,2,2,1,3
1578_0,,,,2,2,1,3
C1(C(C(CO)O)OC(C1CO)O)=O,,,3,1,3,0,3
1578_1,,,,2,2,1,3
1580_0,,,,2,2,1,3
C(C1C(C(C(O1)O)O)O)(CCO)=O,,,3,1,2,0,2
1582_0,,,,2,2,1,3
C(C(CO)C1C(C(C(O)O1)O)O)=O,,,3,1,3,0,3
1582_1,,,,2,2,1,3
1584_0,,,,2,2,1,3
C1(C(CO)OC(C(C1O)O)CO)=O,,,3,1,2,0,2
1584_1,,,,2,2,1,3
1586_0,,,,2,2,1,3
C1(C(O)OC(CO)C(C1CO)O)=O,,,3,1,3,0,3
1586_1,,,,2,2,1,3
1588_0,,,,2,2,1,3
C1(C(C(CO)OC(C1CO)O)O)=O,,,3,1,3,0,3
1588_1,,,,2,2,1,3
1590_0,,,,2,2,1,3
C1(C(C(O)OC(CO)C1CO)O)=O,,,3,1,3,0,3
1590_1,,,,2,2,1,3
1592_0,,,,2,2,1,3
C1(C(CO)OC(C(C1CO)O)O)=O,,,3,1,3,0,3
1592_1,,,,2,2,1,3
1594_0,,,,2,2,1,3
C1(C(CO)OCC(C(C1O)O)O)=O,,,3,1,2,0,2
1594_1,,,,2,2,1,3
1596_0,,,,2,2,1,3
C1(C(O)OCC(C(C1CO)O)O)=O,,,3,1,3,0,3
1596_1,,,,2,2,1,3
1598_0,,,,2,2,1,3
C1(C(C(COC(C1CO)O)O)O)=O,,,3,1,3,0,3
1598_1,,,,2,2,1,3
1600_0,,,,2,2,1,3
C1(C(C(O)OCC(C1CO)O)O)=O,,,3,1,3,0,3
1600_1,,,,2,2,1,3
1602_0,,,,2,2,1,3
C1(C(COC(C(C1CO)O)O)O)=O,,,3,1,3,0,3
1602_1,,,,2,2,1,3
1604_0,,,,2,2,1,3
C1(C(C(C(O)OCC1CO)O)O)=O,,,3,1,3,0,3
1604_1,,,,2,2,1,3
1606_0,,,,2,2,1,3
C1(COC(C(C(C1CO)O)O)O)=O,,,3,1,3,0,3
1606_1,,,,2,2,1,3
1608_0,,,,2,2,1,3
C1(C(CO)OC(C(C(C1)O)O)O)=O,,,3,1,3,0,3
1608_1,,,,2,2,1,3
1610_0,,,,2,2,1,3
C(C(C(CO)O)O)(C(CO)CN)=O,,,3,1,14,0,14
1610_1,,,,2,2,1,3
1612_0,,,,2,2,1,3
C(C(CN)O)(C(CO)C(CO)O)=O,,,3,1,14,0,14
1612_1,,,,2,2,1,3
1614_0,,,,2,2,1,3
C(C(CO)O)(C(CO)C(CN)O)=O,,,3,1,14,0,14
1614_1,,,,2,2,1,3
1616_0,,,,2,2,1,3
C(C(C(CN)O)O)(C(CO)CO)=O,,,3,1,14,0,14
1616_1,,,,2,2,1,3
1618_0,,,,2,2,1,3
C(CO)(C(CO)C(C(CN)O)O)=O,,,3,1,14,0,14
1618_1,,,,2,2,1,3
1620_0,,,,2,2,1,3
C(C(CO)O)(CC(C(CN)O)O)=O,,,3,1,14,0,14
1620_1,,,,2,2,1,3
1622_0,,,,2,2,1,3
C(C(C(C(CN)O)O)O)(CCO)=O,,,3,1,13,0,13
1624_0,,,,2,2,1,3
C(C(CO)C(C(C(CN)O)O)O)=O,,,3,1,14,0,14
1624_1,,,,2,2,1,3
1626_0,,,,2,2,1,3
C(C(C=CC(C(CO)O)=O)O)=O,,,3,1,3,0,3
1626_1,,,,2,2,1,3
1628_0,,,,2,2,1,3
C(C(CO)C1(C(C(CO1)O)O)O)=O,,,3,1,3,0,3
1628_1,,,,2,2,1,3
1630_0,,,,2,2,1,3
C(C(CO)C(C(C(CO)O)O)N)=O,,,3,1,14,0,14
1630_1,,,,2,2,1,3
1631_0,,,,2,2,1,3
1631_1,,,,2,2,1,3
1633_0,,,,2,2,1,3
C(C(C)O)(O)=O,,,3,1,2,0,2
1633_1,,,,2,2,1,3
1634_0,,,,2,2,1,3
1634_1,,,,2,2,1,3
1636_0,,,,2,2,1,3
C(C(CCO)O)(O)=O,,,3,1,2,0,2
1636_1,,,,2,2,1,3
1638_0,,,,2,2,1,3
C(C(CO)(CC(CO)O)O)(O)=O,,,3,1,1,0,1
1640_0,,,,2,2,1,3
C(C(C(CC(CO)O)O)O)(O)=O,,,3,1,2,0,2
1640_1,,,,2,2,1,3
1642_0,,,,2,2,1,3
C(C(CNC)(CC(CO)O)O)(O)=O,,,3,1,1,0,1
1644_0,,,,2,2,1,3
C(C(C(CC(CO)O)NC)O)(O)=O,,,3,1,2,0,2
1644_1,,,,2,2,1,3
1646_0,,,,2,2,1,3
C(CC(C(O)=O)O)(CCO)=O,,,3,1,3,0,3
1646_1,,,,2,2,1,3
1648_0,,,,2,2,1,3
C(C(CCC(CO)=O)O)(O)=O,,,3,1,3,0,3
1648_1,,,,2,2,1,3
1650_0,,,,2,2,1,3
C(C(CC(C(C)=O)O)O)(O)=O,,,3,1,3,0,3
1650_1,,,,2,2,1,3
1652_0,,,,2,2,1,3
C(CC(CC(C(O)=O)O)O)=O,,,3,1,3,0,3
1652_1,,,,2,2,1,3
1654_0,,,,2,2,1,3
C(C(CCO)(CC=O)O)(O)=O,,,3,1,1,0,1
1656_0,,,,2,2,1,3
C(C(C)(CC(C=O)O)O)(O)=O,,,3,1,1,0,1
1658_0,,,,2,2,1,3
C(C(C=CC(CO)O)O)(O)=O,,,3,1,3,0,3
1658_1,,,,2,2,1,3
1660_0,,,,2,2,1,3
C(C(CC(C(CO)O)NC)O)(O)=O,,,3,1,2,0,2
1660_1,,,,2,2,1,3
1662_0,,,,2,1,2,3
C(C(C=O)=O)=O,,,3,1,1,0,1
1664_0,,,,2,1,2,3
C(C(C(C=O)=O)O)=O,,,3,1,1,0,1
1665_0,,,,2,1,2,3
1666_0,,,,2,1,2,3
1668_0,,,,2,1,2,3
C(C(C(CO)O)=O)=O,,,3,1,3,0,3
1670_0,,,,2,1,2,3
C(C(C(CC(CO)O)=O)=O)=O,,,3,1,2,0,2
1672_0,,,,2,1,2,3
C(C(CO)O)(CC(C=O)=O)=O,,,3,1,2,0,2
1674_0,,,,2,1,2,3
C(CCO)(C(C(C=O)=O)O)=O,,,3,1,2,0,2
1676_0,,,,2,1,2,3
C(CO)(CC(C(C=O)=O)O)=O,,,3,1,2,0,2
1678_0,,,,2,1,2,3
C(C)(C(C(C(C=O)=O)O)O)=O,,,3,1,2,0,2
1680_0,,,,2,1,2,3
C(CC(C(C(C=O)=O)O)O)=O,,,3,1,2,0,2
1682_0,,,,2,1,2,3
C(C(C(C(CO)O)=O)=O)=O,,,3,1,1,0,1
1684_0,,,,2,1,2,3
C(C(C(C=O)=O)(C(CO)O)O)=O,,,3,1,1,0,1
1686_0,,,,2,1,2,3
C(C(C(C=O)=O)N)(O)=O,,,3,1,1,0,1
1687_0,,,,2,1,1,2
1687_1,,,,2,1,1,2
1688_0,,,,2,1,1,2
1688_1,,,,2,1,1,2
1689_0,,,,2,1,2,3
1689_1,,,,2,1,2,3
1690_0,,,,2,1,1,2
1691_0,,,,2,1,1,2
1691_1,,,,2,1,1,2
1692_0,,,,2,1,1,2
1692_1,,,,2,1,1,2
1693_0,,,,2,1,2,3
1693_1,,,,2,1,2,3
1694_0,,,,2,1,2,3
1694_1,,,,2,1,2,3
1695_0,,,,2,1,2,3
1695_1,,,,2,1,2,3
1696_0,,,,2,1,2,3
1696_1,,,,2,1,2,3
1697_0,,,,2,1,2,3
1697_1,,,,2,1,2,3
1698_0,,,,2,1,2,3
1698_1,,,,2,1,2,3
1699_0,,,,2,1,2,3
1699_1,,,,2,1,2,3
1700_0,,,,2,1,2,3
1700_1,,,,2,1,2,3
1701_0,,,,2,1,2,3
1701_1,,,,2,1,2,3
1702_0,,,,2,1,2,3
1702_1,,,,2,1,2,3
1703_0,,,,2,1,2,3
1703_1,,,,2,1,2,3
1704_0,,,,2,1,2,3
1704_1,,,,2,1,2,3
1705_0,,,,2,1,2,3
1705_1,,,,2,1,2,3
1706_0,,,,2,1,2,3
1706_1,,,,2,1,2,3
1707_0,,,,2,1,2,3
1707_1,,,,2,1,2,3
1708_0,,,,2,1,2,3
1708_1,,,,2,1,2,3
1709_0,,,,2,1,2,3
1709_1,,,,2,1,2,3
1710_0,,,,2,1,2,3
1710_1,,,,2,1,2,3
1711_0,,,,2,1,2,3
1711_1,,,,2,1,2,3
1712_0,,,,2,1,2,3
1713_0,,,,2,1,2,3
1713_1,,,,2,1,2,3
1714_0,,,,2,1,2,3
1714_1,,,,2,1,2,3
1715_0,,,,2,1,2,3
1715_1,,,,2,1,2,3
1716_0,,,,2,1,2,3
1717_0,,,,2,1,2,3
1717_1,,,,2,1,2,3
1718_0,,,,2,1,2,3
1718_1,,,,2,1,2,3
1719_0,,,,2,1,2,3
1719_1,,,,2,1,2,3
1721_0,,,,2,1,2,3
C(C(CO)=O)=O,,,3,1,9,0,9
1721_1,,,,2,1,2,3
1722_0,,,,2,1,2,3
1723_0,,,,2,1,2,3
1723_1,,,,2,1,2,3
1724_0,,,,2,1,2,3
1725_0,,,,2,1,2,3
1726_0,,,,2,1,2,3
1727_0,,,,2,1,2,3
1727_1,,,,2,1,2,3
1728_0,,,,2,1,2,3
1728_1,,,,2,1,2,3
1729_0,,,,2,1,2,3
1730_0,,,,2,1,2,3
1730_1,,,,2,1,2,3
1731_0,,,,2,1,2,3
1731_1,,,,2,1,2,3
1732_0,,,,2,1,2,3
1732_1,,,,2,1,2,3
1733_0,,,,2,1,2,3
1733_1,,,,2,1,2,3
1734_0,,,,2,1,2,3
1736_0,,,,2,1,2,3
C(CC(C(CO)=O)O)=O,,,3,1,2,0,2
1736_1,,,,2,1,2,3
1737_0,,,,2,1,2,3
1739_0,,,,2,1,2,3
C(C(CO)=O)(C)=O,,,3,1,3,0,3
1740_0,,,,2,1,2,3
1742_0,,,,2,1,2,3
C(CO)(CC(CO)=O)=O,,,3,1,3,0,3
1742_1,,,,2,1,2,3
1744_0,,,,2,1,2,3
C(CO)(C(C(C)=O)O)=O,,,3,1,2,0,2
1745_0,,,,2,1,2,3
1746_0,,,,2,1,2,3
1746_1,,,,2,1,2,3
1747_0,,,,2,1,2,3
1747_1,,,,2,1,2,3
1748_0,,,,2,1,2,3
1748_1,,,,2,1,2,3
1750_0,,,,2,1,2,3
C(C(C(C)O)=O)=O,,,3,1,3,0,3
1750_1,,,,2,1,2,3
1752_0,,,,2,1,2,3
C(CO)(C(C)O)=O,,,3,1,3,0,3
1752_1,,,,2,1,2,3
1754_0,,,,2,1,2,3
C(CC=O)=O,,,3,1,6,0,6
1754_1,,,,2,1,2,3
1756_0,,,,2,1,2,3
C(C(C(CO)=O)O)=O,,,3,1,2,0,2
1758_0,,,,2,1,2,3
C(CO)(CNC)=O,,,3,1,11,0,11
1758_1,,,,2,1,2,3
1759_0,,,,2,1,2,3
1759_1,,,,2,1,2,3
1761_0,,,,2,1,2,3
C(CNC)(C(C(CO)O)O)=O,,,3,1,2,0,2
1761_1,,,,2,1,2,3
1763_0,,,,2,1,2,3
C(CO)(C(CO)NC)=O,,,3,1,5,0,5
1763_1,,,,2,1,2,3
1765_0,,,,2,1,2,3
C(CC(C(CO)=O)NC)=O,,,3,1,2,0,2
1765_1,,,,2,1,2,3
1767_0,,,,2,1,2,3
C(C(CNC)=O)(C)=O,,,3,1,3,0,3
1769_0,,,,2,1,2,3
C(CNC)(CC(CO)=O)=O,,,3,1,3,0,3
1769_1,,,,2,1,2,3
1771_0,,,,2,1,2,3
C(C)(C(C(CNC)=O)O)=O,,,3,1,2,0,2
1773_0,,,,2,1,2,3
C(C(CNC)=O)=O,,,3,1,4,0,4
1775_0,,,,2,1,2,3
C(CC(C=O)NC)=O,,,3,1,6,0,6
1775_1,,,,2,1,2,3
1776_0,,,,2,1,2,3
1776_1,,,,2,1,2,3
1777_0,,,,2,1,2,3
1777_1,,,,2,1,2,3
1779_0,,,,2,1,2,3
C(C(C(C)NC)=O)=O,,,3,1,3,0,3
1779_1,,,,2,1,2,3
1781_0,,,,2,1,2,3
C(CO)(C(C)NC)=O,,,3,1,3,0,3
1781_1,,,,2,1,2,3
1782_0,,,,2,1,2,3
1782_1,,,,2,1,2,3
1784_0,,,,2,1,2,3
C(C(C(CNC)=O)O)=O,,,3,1,2,0,2
1786_0,,,,2,1,2,3
C(CNCC(CO)=O)(O)=O,,,3,1,3,0,3
1786_1,,,,2,1,2,3
1787_0,,,,2,1,2,3
1787_1,,,,2,1,2,3
1788_0,,,,2,1,2,3
1789_0,,,,2,1,2,3
1790_0,,,,2,1,2,3
1790_1,,,,2,1,2,3
1791_0,,,,2,1,2,3
1791_1,,,,2,1,2,3
1792_0,,,,2,1,2,3
1793_0,,,,2,1,2,3
1793_1,,,,2,1,2,3
1794_0,,,,2,1,2,3
1796_0,,,,2,1,2,3
C(C(CCO)O)=O,,,3,1,4,0,4
1796_1,,,,2,1,2,3
1798_0,,,,2,1,2,3
C(C(C)=O)(O)=O,,,3,1,2,0,2
1799_0,,,,2,1,2,3
1799_1,,,,2,1,2,3
1800_0,,,,2,1,2,3
1800_1,,,,2,1,2,3
1801_0,,,,2,1,2,3
1801_1,,,,2,1,2,3
1802_0,,,,2,1,2,3
1803_0,,,,2,1,2,3
1804_0,,,,2,1,2,3
1804_1,,,,2,1,2,3
1805_0,,,,2,1,2,3
1805_1,,,,2,1,2,3
1806_0,,,,2,1,2,3
1807_0,,,,2,1,2,3
1808_0,,,,2,1,2,3
1808_1,,,,2,1,2,3
1809_0,,,,2,1,2,3
1811_0,,,,2,1,2,3
C(CC(C=O)O)(O)=O,,,3,1,3,0,3
1811_1,,,,2,1,2,3
1813_0,,,,2,1,1,2
C(C)(C(CO)(C(C=O)O)O)=O,,,3,1,6,0,6
1814_0,,,,2,1,1,2
1814_1,,,,2,1,1,2
1814_2,,,,2,1,1,2
1815_0,,,,2,1,2,3
1815_1,,,,2,1,2,3
1815_2,,,,2,1,2,3
1816_0,,,,2,1,1,2
1816_1,,,,2,1,1,2
1816_2,,,,2,1,1,2
1817_0,,,,2,1,1,2
1817_1,,,,2,1,1,2
1817_2,,,,2,1,1,2
1818_0,,,,2,1,2,3
1818_1,,,,2,1,2,3
1818_2,,,,2,1,2,3
1819_0,,,,2,1,2,3
1819_1,,,,2,1,2,3
1819_2,,,,2,1,2,3
1820_0,,,,2,1,2,3
1821_0,,,,2,1,2,3
1821_1,,,,2,1,2,3
1821_2,,,,2,1,2,3
1822_0,,,,2,1,2,3
1822_1,,,,2,1,2,3
1822_2,,,,2,1,2,3
1823_0,,,,2,1,2,3
1823_1,,,,2,1,2,3
1823_2,,,,2,1,2,3
1824_0,,,,2,1,2,3
1824_1,,,,2,1,2,3
1824_2,,,,2,1,2,3
1825_0,,,,2,1,2,3
1825_1,,,,2,1,2,3
1825_2,,,,2,1,2,3
1826_0,,,,2,1,2,3
1826_1,,,,2,1,2,3
1826_2,,,,2,1,2,3
1827_0,,,,2,1,2,3
1827_1,,,,2,1,2,3
1827_2,,,,2,1,2,3
1829_0,,,,2,1,2,3
C(C(C(C)=O)(CO)O)=O,,,3,1,6,0,6
1831_0,,,,2,1,2,3
C(C)(C(CO)(CO)O)=O,,,3,1,3,0,3
1832_0,,,,2,1,2,3
1832_1,,,,2,1,2,3
1832_2,,,,2,1,2,3
1833_0,,,,2,1,2,3
1833_1,,,,2,1,2,3
1833_2,,,,2,1,2,3
1834_0,,,,2,1,2,3
1834_1,,,,2,1,2,3
1834_2,,,,2,1,2,3
1835_0,,,,2,1,2,3
1835_1,,,,2,1,2,3
1837_0,,,,2,1,2,3
C(C(CO)(C(C(C)=O)O)O)=O,,,3,1,5,0,5
1839_0,,,,2,1,2,3
C(C(CO)=O)(CCO)=O,,,3,1,2,0,2
1839_1,,,,2,1,2,3
1840_0,,,,2,1,2,3
1840_1,,,,2,1,2,3
1840_2,,,,2,1,2,3
1841_0,,,,2,1,2,3
1841_1,,,,2,1,2,3
1841_2,,,,2,1,2,3
1842_0,,,,2,1,2,3
1843_0,,,,2,1,2,3
1843_1,,,,2,1,2,3
1843_2,,,,2,1,2,3
1844_0,,,,2,1,2,3
1844_1,,,,2,1,2,3
1844_2,,,,2,1,2,3
1846_0,,,,2,1,2,3
C(C(C=O)(CO)O)=O,,,3,1,5,0,5
1847_0,,,,2,1,2,3
1847_1,,,,2,1,2,3
1847_2,,,,2,1,2,3
1848_0,,,,2,1,2,3
1848_1,,,,2,1,2,3
1848_2,,,,2,1,2,3
1849_0,,,,2,1,2,3
1849_1,,,,2,1,2,3
1850_0,,,,2,1,2,3
1850_1,,,,2,1,2,3
1851_0,,,,2,1,2,3
1851_1,,,,2,1,2,3
1851_2,,,,2,1,2,3
1852_0,,,,2,1,2,3
1852_1,,,,2,1,2,3
1852_2,,,,2,1,2,3
1853_0,,,,2,1,2,3
1853_1,,,,2,1,2,3
1853_2,,,,2,1,2,3
1854_0,,,,2,1,2,3
1854_1,,,,2,1,2,3
1854_2,,,,2,1,2,3
1856_0,,,,2,1,2,3
C(C(CO)(C(C=O)O)O)=O,,,3,1,5,0,5
1857_0,,,,2,1,2,3
1857_1,,,,2,1,2,3
1858_0,,,,2,1,2,3
1860_0,,,,2,1,2,3
C(C(CO)(CC(CO)=O)O)=O,,,3,1,3,0,3
1860_1,,,,2,1,2,3
1861_0,,,,2,1,2,3
1861_1,,,,2,1,2,3
1863_0,,,,2,1,2,3
C(CC(CNC)=O)=O,,,3,1,4,0,4
1863_1,,,,2,1,2,3
1865_0,,,,2,1,2,3
C(C(C(C)=O)NC)=O,,,3,1,4,0,4
1867_0,,,,2,1,2,3
C(C)(C(CO)NC)=O,,,3,1,2,0,2
1869_0,,,,2,1,2,3
C(CC(C=O)O)(CNC)=O,,,3,1,2,0,2
1869_1,,,,2,1,2,3
1871_0,,,,2,1,2,3
C(CNC)(CCO)=O,,,3,1,2,0,2
1871_1,,,,2,1,2,3
1873_0,,,,2,1,2,3
C(C(C(C=O)O)NC)(C)=O,,,3,1,3,0,3
1874_0,,,,2,1,2,3
1874_1,,,,2,1,2,3
1876_0,,,,2,1,2,3
C(CNC)(C)=O,,,3,1,2,0,2
1876_1,,,,2,1,2,3
1878_0,,,,2,1,2,3
C(C)(CN)=O,,,3,1,12,0,12
1880_0,,,,2,1,2,3
C(C)(CC(C=O)=O)=O,,,3,1,2,0,2
1881_0,,,,2,1,2,3
1882_0,,,,2,1,2,3
1884_0,,,,2,1,2,3
C(CC(C=O)=O)=O,,,3,1,3,0,3
1886_0,,,,2,1,2,3
C(CC(C(C)=O)=O)=O,,,3,1,2,0,2
1887_0,,,,2,1,2,3
1889_0,,,,2,1,2,3
C(C(C)=O)(C)=O,,,3,1,2,0,2
1891_0,,,,2,1,2,3
C(CC(C)=O)=O,,,3,1,2,0,2
1893_0,,,,2,1,1,2
C(OC(C(C)=O)C(CO)O)=O,,,3,1,1,0,1
1895_0,,,,2,1,2,3
C1(COC(C1)O)=O,,,3,1,4,0,4
1895_1,,,,2,1,2,3
1897_0,,,,2,1,1,2
C(C(C(OCC(C)=O)O)O)=O,,,3,1,3,0,3
1897_1,,,,2,1,1,2
1899_0,,,,2,1,1,2
C(C(CO)OCC(CO)=O)=O,,,3,1,2,0,2
1899_1,,,,2,1,1,2
1901_0,,,,2,1,1,2
C(C(CO)OC(C(C)=O)O)=O,,,3,1,1,0,1
1903_0,,,,2,1,1,2
C(OC(CO)C(C(C)=O)O)=O,,,3,1,1,0,1
1905_0,,,,2,1,1,2
C(OC(CO)CC(CO)=O)=O,,,3,1,2,0,2
1905_1,,,,2,1,1,2
1907_0,,,,2,1,1,2
C(C)(C(CO)OC(C=O)O)=O,,,3,1,1,0,1
1909_0,,,,2,1,2,3
C1(COC(C(C1)O)O)=O,,,3,1,3,0,3
1909_1,,,,2,1,2,3
1911_0,,,,2,1,1,2
C(C(COCC(CO)=O)O)=O,,,3,1,2,0,2
1911_1,,,,2,1,1,2
1913_0,,,,2,1,1,2
C(C(COC(C(C)=O)O)O)=O,,,3,1,1,0,1
1915_0,,,,2,1,1,2
C(OCC(C(C(C)=O)O)O)=O,,,3,1,1,0,1
1917_0,,,,2,1,1,2
C(CO)(CC(OCC=O)O)=O,,,3,1,2,0,2
1917_1,,,,2,1,1,2
1919_0,,,,2,1,1,2
C(OCC(CC(CO)=O)O)=O,,,3,1,2,0,2
1919_1,,,,2,1,1,2
1921_0,,,,2,1,1,2
C(C)(C(C(OCC=O)O)O)=O,,,3,1,1,0,1
1923_0,,,,2,1,1,2
C(C)(C(COC(C=O)O)O)=O,,,3,1,1,0,1
1925_0,,,,2,1,1,2
C(CO)(CCOC(C=O)O)=O,,,3,1,2,0,2
1925_1,,,,2,1,1,2
1926_0,,,,2,1,1,2
1928_0,,,,2,1,2,3
C(CO)(CCN)=O,,,3,1,16,0,16
1928_1,,,,2,1,2,3
1930_0,,,,2,1,2,3
C(C)(C(CN)O)=O,,,3,1,15,0,15
1932_0,,,,2,1,2,3
C(CN)=O,,,3,1,15,0,15
1934_0,,,,2,1,2,3
C(CO)(CC(CN)O)=O,,,3,1,14,0,14
1934_1,,,,2,1,2,3
1935_0,,,,2,1,2,3
1935_1,,,,2,1,2,3
1937_0,,,,2,1,2,3
C(C)(C(C(CN)O)O)=O,,,3,1,13,0,13
1939_0,,,,2,1,2,3
C(C(CN)O)=O,,,3,1,16,0,16
1940_0,,,,2,1,2,3
1940_1,,,,2,1,2,3
1942_0,,,,2,1,2,3
C(C(C(CN)O)O)=O,,,3,1,13,0,13
1944_0,,,,2,1,2,3
C(C=CC(CO)=O)=O,,,3,1,3,0,3
1944_1,,,,2,1,2,3
1946_0,,,,2,1,2,3
C=CC(C=O)=O,,,3,1,3,0,3
1946_1,,,,2,1,2,3
1948_0,,,,2,1,2,3
C=CC(CO)=O,,,3,1,3,0,3
1948_1,,,,2,1,2,3
1950_0,,,,2,1,2,3
C(C=CC=O)=O,,,3,1,3,0,3
1950_1,,,,2,1,2,3
1952_0,,,,2,1,2,3
C(CC(C=O)NC)(CO)=O,,,3,1,3,0,3
1952_1,,,,2,1,2,3
1954_0,,,,2,1,2,3
C(C)(C(CNC)O)=O,,,3,1,2,0,2
1955_0,,,,2,1,2,3
1955_1,,,,2,1,2,3
1956_0,,,,2,1,2,3
1958_0,,,,2,1,2,3
C(C(CCNC)=O)=O,,,3,1,3,0,3
1958_1,,,,2,1,2,3
1960_0,,,,2,1,2,3
C(CO)(CCNC)=O,,,3,1,3,0,3
1960_1,,,,2,1,2,3
1961_0,,,,2,1,2,3
1962_0,,,,2,1,2,3
1962_1,,,,2,1,2,3
1964_0,,,,2,1,2,3
C1(C(C(CO1)O)O)=O,,,3,1,2,0,2
1966_0,,,,2,1,2,3
C1(CC(CO1)O)=O,,,3,1,3,0,3
1966_1,,,,2,1,2,3
1968_0,,,,2,1,1,2
C(CC(CO)(OCC=O)O)=O,,,3,1,2,0,2
1968_1,,,,2,1,1,2
1970_0,,,,2,1,1,2
C(C(C(C)(OCC=O)O)O)=O,,,3,1,2,0,2
1970_1,,,,2,1,1,2
1972_0,,,,2,1,1,2
C(C(CC(OCC=O)O)O)=O,,,3,1,2,0,2
1972_1,,,,2,1,1,2
1974_0,,,,2,1,2,3
C(C(CCO)N)=O,,,3,1,14,0,14
1974_1,,,,2,1,2,3
1976_0,,,,2,1,2,3
C(CC(CO)N)=O,,,3,1,14,0,14
1976_1,,,,2,1,2,3
1978_0,,,,2,1,2,3
C(C(C(C)N)O)=O,,,3,1,14,0,14
1978_1,,,,2,1,2,3
1980_0,,,,2,1,2,3
C(C(CCN)O)=O,,,3,1,14,0,14
1980_1,,,,2,1,2,3
1982_0,,,,2,1,1,2
C1(C(C(C(CO)C1O)O)O)=O,,,3,1,1,0,1
1983_0,,,,2,1,1,2
1985_0,,,,2,1,1,2
C(C(CO)=O)(O)=O,,,3,1,297,0,297
1986_0,,,,2,1,1,2
1987_0,,,,2,1,1,2
1988_0,,,,2,1,1,2
1989_0,,,,2,1,1,2
1991_0,,,,2,1,1,2
C(C(C(C(CO)C(CO)O)O)=O)=O,,,3,1,1,0,1
1992_0,,,,2,1,1,2
1994_0,,,,2,1,1,2
C(C(C(CO)C(C(CO)=O)O)O)=O,,,3,1,1,0,1
1995_0,,,,2,1,1,2
1997_0,,,,2,1,1,2
C(C(C(C(C(CO)CO)O)=O)O)=O,,,3,1,1,0,1
1998_0,,,,2,1,1,2
2000_0,,,,2,1,1,2
C(C(C(C(CO)C(C=O)O)O)O)=O,,,3,1,1,0,1
2001_0,,,,2,1,1,2
2003_0,,,,2,1,1,2
C(C(C(CC(C(CO)=O)O)O)O)=O,,,3,1,1,0,1
2004_0,,,,2,1,1,2
2006_0,,,,2,1,1,2
C(C(C(C=O)O)O)(C(CCO)O)=O,,,3,1,1,0,1
2007_0,,,,2,1,1,2
2009_0,,,,2,1,1,2
C(C(C(C(C(CO)O)O)=O)O)=O,,,3,1,1,0,1
2010_0,,,,2,1,1,2
2011_0,,,,2,1,1,2
2012_0,,,,2,1,1,2
2013_0,,,,2,1,1,2
2014_0,,,,2,1,1,2
2015_0,,,,2,1,1,2
2017_0,,,,2,1,1,2
C(C(CC(C=O)O)O)=O,,,3,1,1,0,1
2018_0,,,,2,1,1,2
2019_0,,,,2,1,1,2
2021_0,,,,2,1,1,2
C(C(C(C(C)O)=O)O)=O,,,3,1,1,0,1
2022_0,,,,2,1,1,2
2024_0,,,,2,1,1,2
C(C(C)O)=O,,,3,1,1,0,1
2025_0,,,,2,1,1,2
2026_0,,,,2,1,1,2
2027_0,,,,2,1,1,2
2028_0,,,,2,1,1,2
2029_0,,,,2,1,1,2
2030_0,,,,2,1,1,2
2031_0,,,,2,1,1,2
2032_0,,,,2,1,1,2
2033_0,,,,2,1,1,2
2034_0,,,,2,1,1,2
2035_0,,,,2,1,1,2
2036_0,,,,2,1,1,2
2037_0,,,,2,1,1,2
2038_0,,,,2,1,1,2
2039_0,,,,2,1,1,2
2040_0,,,,2,1,1,2
2042_0,,,,2,1,1,2
C(C(C(CO)O)=O)(CCO)=O,,,3,1,3,0,3
2044_0,,,,2,1,1,2
C(C(CO)=O)(C(CCO)O)=O,,,3,1,2,0,2
2045_0,,,,2,1,1,2
2047_0,,,,2,1,1,2
C(C(C(C(CCO)O)O)=O)=O,,,3,1,2,0,2
2048_0,,,,2,1,1,2
2049_0,,,,2,1,1,2
2050_0,,,,2,1,1,2
2051_0,,,,2,1,1,2
2052_0,,,,2,1,1,2
2053_0,,,,2,1,1,2
2054_0,,,,2,1,1,2
2056_0,,,,2,1,1,2
C(C(CO)O)(C(C(C)=O)O)=O,,,3,1,3,0,3
2058_0,,,,2,1,1,2
C(C(C)O)(C(C(CO)=O)O)=O,,,3,1,2,0,2
2059_0,,,,2,1,1,2
2061_0,,,,2,1,1,2
C(C(C(C(C(C)O)O)=O)O)=O,,,3,1,2,0,2
2062_0,,,,2,1,1,2
2063_0,,,,2,1,1,2
2064_0,,,,2,1,1,2
2066_0,,,,2,1,1,2
C(CO)(C(CNC)O)=O,,,3,1,2,0,2
2068_0,,,,2,1,1,2
C(C(CO)O)(C(C(CO)NC)O)=O,,,3,1,3,0,3
2070_0,,,,2,1,1,2
C(CC(C(C(CO)=O)O)NC)=O,,,3,1,4,0,4
2072_0,,,,2,1,1,2
C(CC(C(CO)=O)O)(CNC)=O,,,3,1,2,0,2
2074_0,,,,2,1,1,2
C(CC(C(CO)=O)NC)(CO)=O,,,3,1,6,0,6
2076_0,,,,2,1,1,2
C(C(CC(C(C=O)O)NC)O)=O,,,3,1,3,0,3
2078_0,,,,2,1,1,2
C(C(C(CNC)O)=O)(CCO)=O,,,3,1,1,0,1
2080_0,,,,2,1,1,2
C(C(CNC)=O)(C(CCO)O)=O,,,3,1,2,0,2
2082_0,,,,2,1,1,2
C(C(CO)=O)(C(CCO)NC)=O,,,3,1,2,0,2
2084_0,,,,2,1,1,2
C(C(C(C(CCO)NC)O)=O)=O,,,3,1,1,0,1
2086_0,,,,2,1,1,2
C(C(CNC)O)(CC(CO)=O)=O,,,3,1,3,0,3
2088_0,,,,2,1,1,2
C(C(CC(C(CNC)=O)O)O)=O,,,3,1,3,0,3
2090_0,,,,2,1,1,2
C(C(CC(C(CO)=O)O)NC)=O,,,3,1,3,0,3
2092_0,,,,2,1,1,2
C(C(CNC)O)(C(C(C)=O)O)=O,,,3,1,1,0,1
2094_0,,,,2,1,1,2
C(C(C)O)(C(C(CNC)=O)O)=O,,,3,1,2,0,2
2096_0,,,,2,1,1,2
C(C(C)NC)(C(C(CO)=O)O)=O,,,3,1,2,0,2
2098_0,,,,2,1,1,2
C(C(C(C(C(C)NC)O)=O)O)=O,,,3,1,1,0,1
2100_0,,,,2,1,1,2
C(CC(C(C(CNC)O)=O)O)=O,,,3,1,2,0,2
2102_0,,,,2,1,1,2
C(CNCC(C(CO)=O)O)(O)=O,,,3,1,2,0,2
2104_0,,,,2,1,1,2
C(C(C(CO)O)O)(C(CNC)O)=O,,,3,1,2,0,2
2106_0,,,,2,1,1,2
C(C(CC(C(CO)O)O)O)=O,,,3,1,2,0,2
2108_0,,,,2,1,1,2
C(C(CCO)O)(C(CO)O)=O,,,3,1,3,0,3
2110_0,,,,2,1,1,2
C(CO)(C(CC(CO)O)O)=O,,,3,1,3,0,3
2112_0,,,,2,1,1,2
C(C(C(CO)O)O)(C(C)O)=O,,,3,1,2,0,2
2114_0,,,,2,1,1,2
C(CO)(C(C(CCO)O)O)=O,,,3,1,2,0,2
2116_0,,,,2,1,1,2
C(CC(C(C(CO)O)=O)O)(O)=O,,,3,1,2,0,2
2118_0,,,,2,1,1,2
C(C(C(CC(CO)O)O)=O)(O)=O,,,3,1,2,0,2
2120_0,,,,2,1,1,2
C(C(CC(C(CO)=O)O)O)(O)=O,,,3,1,2,0,2
2122_0,,,,2,1,1,2
C(C(C(C(CCO)O)=O)O)(O)=O,,,3,1,2,0,2
2124_0,,,,2,1,1,2
C(C(C(CC(C=O)O)O)O)(O)=O,,,3,1,3,0,3
2126_0,,,,2,1,1,2
C(C(C(C(O)=O)O)O)(C(C)O)=O,,,3,1,2,0,2
2128_0,,,,2,1,1,2
C(CC(C(C(CO)=O)O)O)(O)=O,,,3,1,2,0,2
2130_0,,,,2,1,1,2
C(C(CO)(CO)O)(CC(CO)=O)=O,,,3,1,3,0,3
2132_0,,,,2,1,1,2
C(C(C(C(CCO)O)=O)(CO)O)=O,,,3,1,3,0,3
2134_0,,,,2,1,1,2
C(CCO)(C(C(CO)=O)(CO)O)=O,,,3,1,3,0,3
2136_0,,,,2,1,1,2
C(C(CO)(C(CC(C=O)O)O)O)=O,,,3,1,5,0,5
2138_0,,,,2,1,1,2
C(C(CO)(C(C(C(C)O)=O)O)O)=O,,,3,1,3,0,3
2140_0,,,,2,1,1,2
C(C)(C(CO)(C(C(CO)=O)O)O)=O,,,3,1,3,0,3
2142_0,,,,2,1,1,2
C(C(CO)(CC(C(CO)=O)O)O)=O,,,3,1,2,0,2
2143_0,,,,2,1,1,2
2145_0,,,,2,1,1,2
C(C(CO)NC)(CC(CO)=O)=O,,,3,1,4,0,4
2147_0,,,,2,1,1,2
C(CCO)(C(C(CO)=O)NC)=O,,,3,1,3,0,3
2149_0,,,,2,1,1,2
C(C(C(C(CO)=O)O)NC)(C)=O,,,3,1,4,0,4
2151_0,,,,2,1,1,2
C(C(CCC(C=O)=O)O)=O,,,3,1,2,0,2
2153_0,,,,2,1,1,2
C(C(C)O)(CC(C=O)=O)=O,,,3,1,2,0,2
2154_0,,,,2,1,1,2
2156_0,,,,2,1,1,2
C(CC(C(C(C)=O)=O)O)=O,,,3,1,2,0,2
2158_0,,,,2,1,1,2
C(CC(C(C(C)O)=O)=O)=O,,,3,1,2,0,2
2159_0,,,,2,1,1,2
2161_0,,,,2,1,1,2
C(C)(CC(C(CO)=O)=O)=O,,,3,1,3,0,3
2163_0,,,,2,1,1,2
C(C)(CC(C(C=O)=O)O)=O,,,3,1,2,0,2
2165_0,,,,2,1,1,2
C(CCC(C(CO)=O)=O)=O,,,3,1,3,0,3
2167_0,,,,2,1,1,2
C(CCC(C(C=O)=O)O)=O,,,3,1,2,0,2
2169_0,,,,2,1,1,2
C(CO)(CC(C(C)=O)=O)=O,,,3,1,3,0,3
2170_0,,,,2,1,1,2
2172_0,,,,2,1,1,2
C1(C(C(CO)O)OCC1O)=O,,,3,1,1,0,1
2174_0,,,,2,1,1,2
C1(C(CC(C(CO)O)O1)O)=O,,,3,1,2,0,2
2176_0,,,,2,1,1,2
C1(C(C(CO)OCC1O)O)=O,,,3,1,1,0,1
2178_0,,,,2,1,1,2
C1(C(CC(C(CO)O1)O)O)=O,,,3,1,2,0,2
2180_0,,,,2,1,1,2
C1(C(CO)OC(CC1O)O)=O,,,3,1,2,0,2
2182_0,,,,2,1,1,2
C1(C(O)OC(CO)CC1O)=O,,,3,1,2,0,2
2184_0,,,,2,1,1,2
C1(C(C(COCC1O)O)O)=O,,,3,1,1,0,1
2186_0,,,,2,1,1,2
C1(C(CC(C(CO1)O)O)O)=O,,,3,1,2,0,2
2188_0,,,,2,1,1,2
C1(C(CC(O)OCC1O)O)=O,,,3,1,2,0,2
2190_0,,,,2,1,1,2
C1(C(O)OCC(CC1O)O)=O,,,3,1,2,0,2
2192_0,,,,2,1,1,2
C1(COC(C(CC1O)O)O)=O,,,3,1,2,0,2
2194_0,,,,2,1,1,2
C1(C(CCOC(C1O)O)O)=O,,,3,1,2,0,2
2196_0,,,,2,1,1,2
C(C(CCN)O)(C(CO)O)=O,,,3,1,13,0,13
2198_0,,,,2,1,1,2
C(CN)(C(CC(CO)O)O)=O,,,3,1,12,0,12
2200_0,,,,2,1,1,2
C(CO)(C(CC(CN)O)O)=O,,,3,1,13,0,13
2202_0,,,,2,1,1,2
C(C(CCO)O)(C(CN)O)=O,,,3,1,13,0,13
2204_0,,,,2,1,1,2
C(C(CC(C(CN)O)O)O)=O,,,3,1,13,0,13
2206_0,,,,2,1,1,2
C(C(C(CN)O)O)(C(C)O)=O,,,3,1,13,0,13
2208_0,,,,2,1,1,2
C(CO)=CC(C(CO)=O)=O,,,3,1,2,0,2
2210_0,,,,2,1,1,2
C(C(C(C=O)=O)O)=CCO,,,3,1,2,0,2
2212_0,,,,2,1,1,2
C(CO)(C(C=CC=O)O)=O,,,3,1,4,0,4
2214_0,,,,2,1,1,2
C(CO)(C(C(C=C)=O)O)=O,,,3,1,2,0,2
2216_0,,,,2,1,1,2
C(C(C(C(C=C)O)=O)O)=O,,,3,1,2,0,2
2218_0,,,,2,1,1,2
C(C=CC(CO)=O)(CO)=O,,,3,1,2,0,2
2220_0,,,,2,1,1,2
C(C(C=CC(C=O)O)O)=O,,,3,1,2,0,2
2221_0,,,,2,1,1,2
2222_0,,,,2,1,1,2
2224_0,,,,2,1,1,2
C(C(C(C(C(CO)O)NC)O)O)=O,,,3,1,5,0,5
2225_0,,,,2,1,1,2
2227_0,,,,2,1,1,2
C(CC(C(C(CO)NC)=O)O)=O,,,3,1,4,0,4
2229_0,,,,2,1,1,2
C(C(CO)=O)(CC(CO)NC)=O,,,3,1,2,0,2
2231_0,,,,2,1,1,2
C(C(C(CC(CO)NC)O)=O)=O,,,3,1,1,0,1
2232_0,,,,2,1,1,2
2233_0,,,,2,1,1,2
2234_0,,,,2,1,1,2
2236_0,,,,2,1,1,2
C(C(C(C(CCO)O)=O)NC)=O,,,3,1,2,0,2
2238_0,,,,2,1,1,2
C(CCNC)(C(C(CO)=O)O)=O,,,3,1,2,0,2
2240_0,,,,2,1,1,2
C(C(C(C(CCNC)O)=O)O)=O,,,3,1,1,0,1
2241_0,,,,2,1,1,2
2242_0,,,,2,1,1,2
2244_0,,,,2,1,1,2
C(C(C(C(C)=O)O)NC)(CO)=O,,,3,1,4,0,4
2246_0,,,,2,1,1,2
C(C(C(C=O)O)NC)(C(C)O)=O,,,3,1,3,0,3
2248_0,,,,2,1,1,2
C(CC(C(C(CO)=O)NC)O)=O,,,3,1,4,0,4
2249_0,,,,2,1,1,2
2251_0,,,,2,1,1,2
C(CNC(C(CO)=O)CO)(O)=O,,,3,1,3,0,3
2252_0,,,,2,1,1,2
2254_0,,,,2,1,1,2
C(CO)(C1(CC(CO1)O)O)=O,,,3,1,2,0,2
2256_0,,,,2,1,1,2
C(CO)(C1C(CC(O1)O)O)=O,,,3,1,2,0,2
2258_0,,,,2,1,1,2
C(CO)(C(CC(CO)O)N)=O,,,3,1,13,0,13
2260_0,,,,2,1,1,2
C(CO)(CC(C(CO)O)N)=O,,,3,1,14,0,14
2262_0,,,,2,1,1,2
C(CO)(C(C(CCO)N)O)=O,,,3,1,13,0,13
2264_0,,,,2,1,1,2
C(CO)(C(CC(CO)N)O)=O,,,3,1,13,0,13
2266_0,,,,2,1,1,2
C(CO)(C(C(C(C)N)O)O)=O,,,3,1,13,0,13
2268_0,,,,2,1,1,2
C(CO)(C(C(CCN)O)O)=O,,,3,1,13,0,13
2270_0,,,,2,1,2,3
C1(CC(C(CO)=O)N(C)C1)=O,,,3,1,2,0,2
2271_0,,,,2,1,2,3
2273_0,,,,2,1,2,3
C1(C(CN(C)C1CCO)=O)=O,,,3,1,2,0,2
2274_0,,,,2,1,2,3
2276_0,,,,2,1,2,3
C(C1CC(C(CN1C)=O)O)=O,,,3,1,2,0,2
2277_0,,,,2,1,2,3
2279_0,,,,2,1,2,3
C1(C(C)N(C)CC(C1O)=O)=O,,,3,1,2,0,2
2280_0,,,,2,1,2,3
2282_0,,,,2,1,2,3
C1(C(CO)N(C)CC(C1)=O)=O,,,3,1,2,0,2
2284_0,,,,2,1,2,3
C(C1C(C(CN1C)=O)O)(C)=O,,,3,1,2,0,2
2286_0,,,,2,1,2,3
C(CO)(C1CC(CN1)O)=O,,,3,1,1,0,1
2288_0,,,,2,1,2,3
C1(C(CNC1CCO)O)=O,,,3,1,1,0,1
2290_0,,,,2,1,2,3
C(C1CC(C(CN1)O)O)=O,,,3,1,1,0,1
2292_0,,,,2,1,2,3
C1(C(C(CNC1C)O)O)=O,,,3,1,1,0,1
2294_0,,,,2,1,2,3
C1(C(CN(C)C(CO)C1)=O)=O,,,3,1,2,0,2
2296_0,,,,2,1,2,3
C1(C(CN(C)CC(C1)=O)O)=O,,,3,1,2,0,2
2298_0,,,,2,1,2,3
C1(CCN(C)CC(C1O)=O)=O,,,3,1,2,0,2
2300_0,,,,2,1,2,3
C(CC1C(C(CN1C)=O)O)=O,,,3,1,2,0,2
2302_0,,,,2,1,2,3
C1(CNC(C(CO)O)C1)=O,,,3,1,1,0,1
2304_0,,,,2,1,2,3
C1(CNC(CCO)C1O)=O,,,3,1,1,0,1
2306_0,,,,2,1,2,3
C1(CNC(CO)CC1O)=O,,,3,1,1,0,1
2308_0,,,,2,1,2,3
C1(CNC(C)C(C1O)O)=O,,,3,1,1,0,1
2310_0,,,,2,1,2,3
C1(CNCCC(C1O)O)=O,,,3,1,1,0,1
2312_0,,,,2,2,2,4
C1(C(C(C(CO)C1N)O)O)=O,,,3,1,1,0,1
2314_0,,,,2,2,2,4
C1(C(C(C(CC1N)O)O)O)=O,,,3,1,1,0,1
2316_0,,,,2,2,2,4
C(CN(C)CC(C(O)=O)=O)=O,,,3,1,1,0,1
2318_0,,,,2,2,2,4
C(C(CO)NCC(C(O)=O)=O)(O)=O,,,3,1,1,0,1
2320_0,,,,2,2,2,4
C(C(CN)=O)(O)=O,,,3,1,1,0,1
2322_0,,,,2,2,2,4
C(C(CNCCO)=O)(O)=O,,,3,1,1,0,1
2324_0,,,,2,2,2,4
C(C(C(CN(C)CC=O)=O)O)(O)=O,,,3,1,1,0,1
2326_0,,,,2,2,2,4
C(C(C(CN)=O)O)(O)=O,,,3,1,1,0,1
2328_0,,,,2,2,2,4
C(C(C(CNCCO)=O)O)(O)=O,,,3,1,1,0,1
2330_0,,,,2,2,2,4
C(CN(C)CC(CO)=O)=O,,,3,1,1,0,1
2332_0,,,,2,2,2,4
C(CN(CC=O)CC(CO)=O)(O)=O,,,3,1,1,0,1
2334_0,,,,2,2,2,4
C(C(C(O)=O)NCC(CO)=O)(O)=O,,,3,1,1,0,1
2336_0,,,,2,2,2,4
C(C(CO)NCC(CO)=O)(O)=O,,,3,1,1,0,1
2338_0,,,,2,2,2,4
C(CO)(CN)=O,,,3,1,1,0,1
2340_0,,,,2,2,2,4
C(CO)(CNCCO)=O,,,3,1,1,0,1
2342_0,,,,2,2,2,4
C(CO)(CNCC(C(CO)O)O)=O,,,3,1,1,0,1
2344_0,,,,2,2,2,4
C(C(CO)C(C(C(CO)O)=O)N)=O,,,3,1,1,0,1
2346_0,,,,2,2,2,4
C(C(CN)=O)(C(CO)C(CO)O)=O,,,3,1,1,0,1
2348_0,,,,2,2,2,4
C(C(C(C(CO)C(CO)O)N)=O)=O,,,3,1,1,0,1
2350_0,,,,2,2,2,4
C(C(CO)O)(C(C(CN)=O)CO)=O,,,3,1,1,0,1
2352_0,,,,2,2,2,4
C(C(C(CO)C(C(CO)=O)N)O)=O,,,3,1,1,0,1
2354_0,,,,2,2,2,4
C(C(CO)CO)(C(C(CN)=O)O)=O,,,3,1,1,0,1
2356_0,,,,2,2,2,4
C(C(C(C(C(CO)CO)N)=O)O)=O,,,3,1,1,0,1
2358_0,,,,2,2,2,4
C(CO)(C(CO)C(C(CN)=O)O)=O,,,3,1,1,0,1
2360_0,,,,2,2,2,4
C(C(C(CO)C(C(C=O)O)O)N)=O,,,3,1,1,0,1
2362_0,,,,2,2,2,4
C(CC(C(CN)=O)O)(C(CO)O)=O,,,3,1,1,0,1
2364_0,,,,2,2,2,4
C(C(C(CC(C(CO)=O)N)O)O)=O,,,3,1,1,0,1
2366_0,,,,2,2,2,4
C(C(C(C(CCO)=O)O)O)(CN)=O,,,3,1,1,0,1
2368_0,,,,2,2,2,4
C(C(C(C=O)O)O)(C(CCO)N)=O,,,3,1,1,0,1
2370_0,,,,2,2,2,4
C(C(CO)C(C(C(CN)=O)O)O)=O,,,3,1,1,0,1
2372_0,,,,2,2,2,4
C(C(C(C(C(CO)O)O)=O)N)=O,,,3,1,1,0,1
2374_0,,,,2,2,2,4
C(C(CO)N(C)CC=O)=O,,,3,1,1,0,1
2376_0,,,,2,2,2,4
C(C(CO)N(CC(O)=O)CC=O)=O,,,3,1,1,0,1
2378_0,,,,2,2,2,4
C(C(C(O)=O)NC(C=O)CO)(O)=O,,,3,1,1,0,1
2380_0,,,,2,2,2,4
C(C(CO)NC(C=O)CO)(O)=O,,,3,1,1,0,1
2382_0,,,,2,2,2,4
C(C(CO)N)=O,,,3,1,1,0,1
2384_0,,,,2,2,2,4
C(C(CO)NCCO)=O,,,3,1,1,0,1
2386_0,,,,2,2,2,4
C(C(CO)NCC(C(CO)O)O)=O,,,3,1,1,0,1
2388_0,,,,2,2,2,4
C(CN(C)C(C=O)CC=O)=O,,,3,1,2,0,2
2390_0,,,,2,2,2,4
C(C(CO)NC(C=O)CC=O)(O)=O,,,3,1,2,0,2
2392_0,,,,2,2,2,4
C(CC(C=O)N)=O,,,3,1,2,0,2
2394_0,,,,2,2,2,4
C(CC(C=O)NCCO)=O,,,3,1,2,0,2
2396_0,,,,2,2,2,4
C(CN(C)CC(C(C)=O)=O)=O,,,3,1,1,0,1
2398_0,,,,2,2,2,4
C(CN(C)C(C(C=O)=O)C)=O,,,3,1,1,0,1
2400_0,,,,2,2,2,4
C(C(CO)NCC(C(C)=O)=O)(O)=O,,,3,1,1,0,1
2402_0,,,,2,2,2,4
C(C(CO)NC(C(C=O)=O)C)(O)=O,,,3,1,1,0,1
2404_0,,,,2,2,2,4
C(C(CN)=O)(C)=O,,,3,1,1,0,1
2406_0,,,,2,2,2,4
C(C(C(C)N)=O)=O,,,3,1,1,0,1
2408_0,,,,2,2,2,4
C(C(CNCCO)=O)(C)=O,,,3,1,1,0,1
2410_0,,,,2,2,2,4
C(C(C(C)NCCO)=O)=O,,,3,1,1,0,1
2412_0,,,,2,2,2,4
C(CN(C)C(C(CO)=O)C)=O,,,3,1,1,0,1
2414_0,,,,2,2,2,4
C(C(CO)NC(C(CO)=O)C)(O)=O,,,3,1,1,0,1
2416_0,,,,2,2,2,4
C(CO)(C(C)N)=O,,,3,1,1,0,1
2418_0,,,,2,2,2,4
C(CO)(C(C)NCCO)=O,,,3,1,1,0,1
2420_0,,,,2,2,2,4
C(CN(C)CC(CC(CO)=O)=O)=O,,,3,1,1,0,1
2422_0,,,,2,2,2,4
C(C(CC(C=O)O)N(C)CC=O)=O,,,3,1,1,0,1
2424_0,,,,2,2,2,4
C(CO)(CC(CN)=O)=O,,,3,1,1,0,1
2426_0,,,,2,2,2,4
C(C(CC(C=O)O)N)=O,,,3,1,1,0,1
2428_0,,,,2,2,2,4
C(CNCCO)(CC(CO)=O)=O,,,3,1,1,0,1
2430_0,,,,2,2,2,4
C(C(CC(C=O)O)NCCO)=O,,,3,1,1,0,1
2432_0,,,,2,2,2,4
C(C(CCO)N(C)CC=O)=O,,,3,1,1,0,1
2434_0,,,,2,2,2,4
C(C(CO)NC(C=O)CCO)(O)=O,,,3,1,1,0,1
2435_0,,,,2,2,2,4
2437_0,,,,2,2,2,4
C(C(CCO)NCCO)=O,,,3,1,1,0,1
2439_0,,,,2,2,2,4
C(C)(C(C(CN(C)CC=O)=O)O)=O,,,3,1,1,0,1
2441_0,,,,2,2,2,4
C(C(C)N(C)CC=O)(C(C=O)O)=O,,,3,1,1,0,1
2443_0,,,,2,2,2,4
C(C)(C(C(CN)=O)O)=O,,,3,1,1,0,1
2445_0,,,,2,2,2,4
C(C(C(C(C)N)=O)O)=O,,,3,1,1,0,1
2447_0,,,,2,2,2,4
C(C)(C(C(CNCCO)=O)O)=O,,,3,1,1,0,1
2449_0,,,,2,2,2,4
C(C(C(C(C)NCCO)=O)O)=O,,,3,1,1,0,1
2451_0,,,,2,2,2,4
C(CN(C)CC(C=O)=O)=O,,,3,1,1,0,1
2453_0,,,,2,2,2,4
C(CN(CC(O)=O)CC(C=O)=O)=O,,,3,1,1,0,1
2455_0,,,,2,2,2,4
C(C(C(O)=O)NCC(C=O)=O)(O)=O,,,3,1,1,0,1
2457_0,,,,2,2,2,4
C(C(CO)NCC(C=O)=O)(O)=O,,,3,1,1,0,1
2459_0,,,,2,2,2,4
C(C(CN)=O)=O,,,3,1,1,0,1
2461_0,,,,2,2,2,4
C(C(CNCCO)=O)=O,,,3,1,1,0,1
2463_0,,,,2,2,2,4
C(C(CNCC(C(CO)O)O)=O)=O,,,3,1,1,0,1
2465_0,,,,2,2,2,4
C(C(C)N(C)CC=O)=O,,,3,1,1,0,1
2467_0,,,,2,2,2,4
C(C(C)N(C)CC(C(CO)O)=O)=O,,,3,1,1,0,1
2469_0,,,,2,2,2,4
C(C(C)N(CC=O)CC(O)=O)=O,,,3,1,1,0,1
2471_0,,,,2,2,2,4
C(C(C(CO)O)NC(C=O)C)(O)=O,,,3,1,1,0,1
2473_0,,,,2,2,2,4
C(C(C)NC(C(O)=O)C(O)=O)=O,,,3,1,1,0,1
2475_0,,,,2,2,2,4
C(C(CO)NC(C=O)C)(O)=O,,,3,1,1,0,1
2477_0,,,,2,2,2,4
C(C(C)N)=O,,,3,1,12,0,12
2479_0,,,,2,2,2,4
C(C(C)N(C)C(CO)C(C=O)O)=O,,,3,1,1,0,1
2481_0,,,,2,2,2,4
C(C(C)NCCO)=O,,,3,1,1,0,1
2483_0,,,,2,2,2,4
C(C(C)NCC(C(CO)O)O)=O,,,3,1,1,0,1
2485_0,,,,2,2,2,4
C(CC(CN(C)CC=O)=O)=O,,,3,1,1,0,1
2487_0,,,,2,2,2,4
C(C(CO)NCC(CC=O)=O)(O)=O,,,3,1,1,0,1
2489_0,,,,2,2,2,4
C(CC(CN)=O)=O,,,3,1,1,0,1
2491_0,,,,2,2,2,4
C(CC(CNCCO)=O)=O,,,3,1,1,0,1
2493_0,,,,2,2,2,4
C(C(C(CN(C)CC=O)=O)O)=O,,,3,1,1,0,1
2495_0,,,,2,2,2,4
C(C(C(CN)=O)O)=O,,,3,1,1,0,1
2497_0,,,,2,2,2,4
C(C(C(CNCCO)=O)O)=O,,,3,1,1,0,1
2499_0,,,,2,2,2,4
C(C(C(CO)O)N(C)CC=O)=O,,,3,1,1,0,1
2501_0,,,,2,2,2,4
C(CN(C)C(C(CO)=O)CO)=O,,,3,1,2,0,2
2501_1,,,,2,2,2,4
2503_0,,,,2,2,2,4
C(C(C(CO)O)N)=O,,,3,1,1,0,1
2505_0,,,,2,2,2,4
C(CO)(C(CO)N)=O,,,3,1,2,0,2
2505_1,,,,2,2,2,4
2507_0,,,,2,2,2,4
C(C(C(CO)O)NCCO)=O,,,3,1,1,0,1
2509_0,,,,2,2,2,4
C(CO)(C(CO)NCCO)=O,,,3,1,2,0,2
2509_1,,,,2,2,2,4
2511_0,,,,2,2,2,4
C(CO)(C(C(C(CO)O)O)N)=O,,,3,1,2,0,2
2513_0,,,,2,2,2,4
C(C(CO)O)(C(C(CO)O)N)=O,,,3,1,2,0,2
2513_1,,,,2,2,2,4
2515_0,,,,2,2,2,4
C(CC(C(C(CO)O)N)=O)=O,,,3,1,2,0,2
2517_0,,,,2,2,2,4
C(CC(C(C(CO)=O)N)O)=O,,,3,1,2,0,2
2519_0,,,,2,2,2,4
C(C(C(CC(CO)O)=O)N)=O,,,3,1,3,0,3
2520_0,,,,2,2,2,4
2522_0,,,,2,2,2,4
C(CC(C=O)N)(C(CO)O)=O,,,3,1,4,0,4
2524_0,,,,2,2,2,4
C(CO)(C(CC(CO)=O)N)=O,,,3,1,3,0,3
2526_0,,,,2,2,2,4
C(CO)(C(CC(CN)=O)O)=O,,,3,1,1,0,1
2528_0,,,,2,2,2,4
C(CC(C=O)O)(C(CO)N)=O,,,3,1,2,0,2
2530_0,,,,2,2,2,4
C(C(C(CC(C=O)O)O)N)=O,,,3,1,1,0,1
2532_0,,,,2,2,2,4
C(C(C(C(CCO)=O)O)N)=O,,,3,1,2,0,2
2534_0,,,,2,2,2,4
C(C(C(CO)N)=O)(CCO)=O,,,3,1,1,0,1
2536_0,,,,2,2,2,4
C(C(CO)=O)(C(CCO)N)=O,,,3,1,1,0,1
2538_0,,,,2,2,2,4
C(C(CN)=O)(C(CCO)O)=O,,,3,1,1,0,1
2540_0,,,,2,2,2,4
C(C(C(C(CCO)O)N)=O)=O,,,3,1,1,0,1
2542_0,,,,2,2,2,4
C(C(C(C=O)O)N)(CCO)=O,,,3,1,3,0,3
2544_0,,,,2,2,2,4
C(C(C(CC(CO)=O)O)N)=O,,,3,1,1,0,1
2546_0,,,,2,2,2,4
C(C(CO)N)(CC(CO)=O)=O,,,3,1,2,0,2
2548_0,,,,2,2,2,4
C(C(CC(C(CO)=O)O)N)=O,,,3,1,1,0,1
2550_0,,,,2,2,2,4
C(C(CC(C(CN)=O)O)O)=O,,,3,1,1,0,1
2552_0,,,,2,2,2,4
C(C(C(CC(CN)=O)O)O)=O,,,3,1,1,0,1
2554_0,,,,2,2,2,4
C(C(C(C(C(C)=O)O)O)N)=O,,,3,1,1,0,1
2556_0,,,,2,2,2,4
C(C(CO)N)(C(C(C)=O)O)=O,,,3,1,1,0,1
2558_0,,,,2,2,2,4
C(C(C)N)(C(C(CO)=O)O)=O,,,3,1,1,0,1
2560_0,,,,2,2,2,4
C(C(C)O)(C(C(CN)=O)O)=O,,,3,1,1,0,1
2562_0,,,,2,2,2,4
C(C(C(C(C(C)O)N)=O)O)=O,,,3,1,1,0,1
2564_0,,,,2,2,2,4
C(C(C(C(C(C)=O)N)O)O)=O,,,3,1,2,0,2
2566_0,,,,2,2,2,4
C(CC(C(C(C=O)N)O)O)=O,,,3,1,1,0,1
2568_0,,,,2,2,2,4
C(CC(C(C(CO)N)=O)O)=O,,,3,1,2,0,2
2570_0,,,,2,2,2,4
C(CN(C)C(C(CO)=O)CNC)=O,,,3,1,1,0,1
2572_0,,,,2,2,2,4
C(C(CCC(C=O)=O)N(C)CC=O)=O,,,3,1,1,0,1
2574_0,,,,2,2,2,4
C(C(C)N(C)CC=O)(CC(C=O)=O)=O,,,3,1,1,0,1
2576_0,,,,2,2,2,4
C(CN(C)C(C=O)CC(CC=O)=O)=O,,,3,1,2,0,2
2578_0,,,,2,2,2,4
C(CN(C)C(C(C(C)=O)=O)CC=O)=O,,,3,1,1,0,1
2580_0,,,,2,2,2,4
C(CC(C(C(C)N(C)CC=O)=O)=O)=O,,,3,1,1,0,1
2582_0,,,,2,2,2,4
C(CN(C)C(C(CC=O)=O)CC=O)=O,,,3,1,3,0,3
2582_1,,,,2,2,2,4
2582_2,,,,2,2,2,4
2584_0,,,,2,2,2,4
C(C)(CC(C(CN(C)CC=O)=O)=O)=O,,,3,1,1,0,1
2586_0,,,,2,2,2,4
C(CC(C(C=O)=O)N(C)CC=O)(C)=O,,,3,1,1,0,1
2588_0,,,,2,2,2,4
C(CN(C)CC(C(CCC=O)=O)=O)=O,,,3,1,1,0,1
2590_0,,,,2,2,2,4
C(CCC(C(C=O)=O)N(C)CC=O)=O,,,3,1,1,0,1
2592_0,,,,2,2,2,4
C(CN(C)CC(CC(C(C)=O)=O)=O)=O,,,3,1,1,0,1
2594_0,,,,2,2,2,4
C(CC(CC(CN(C)CC=O)=O)=O)=O,,,3,1,1,0,1
2596_0,,,,2,2,2,4
C(CN(C)CC(C(C=CCO)=O)=O)=O,,,3,1,1,0,1
2598_0,,,,2,2,2,4
C(CN(C)C(C=CCO)C(C=O)=O)=O,,,3,1,1,0,1
2600_0,,,,2,2,2,4
C(CN(C)C(C(CO)=O)C=CC=O)=O,,,3,1,1,0,1
2602_0,,,,2,2,2,4
C(CN(C)CC(C(C(C=C)=O)O)=O)=O,,,3,1,1,0,1
2604_0,,,,2,2,2,4
C(C(C=O)O)(C(C=C)N(C)CC=O)=O,,,3,1,1,0,1
2606_0,,,,2,2,2,4
C(CN(C)CC(C=CC(CO)=O)=O)=O,,,3,1,1,0,1
2608_0,,,,2,2,2,4
C(C(C=CC(C=O)O)N(C)CC=O)=O,,,3,1,1,0,1
2610_0,,,,2,2,2,4
C(CN(C)CC(C(C=CC=O)O)=O)=O,,,3,1,1,0,1
2612_0,,,,2,2,2,4
C(CN(C)CC=O)(C(CO)NC)=O,,,3,1,1,0,1
2614_0,,,,2,2,2,4
C(CO)(C(CNC)N)=O,,,3,1,1,0,1
2616_0,,,,2,2,2,4
C(CO)(C(CNC)NCCO)=O,,,3,1,1,0,1
2618_0,,,,2,2,2,4
C(C(CO)O)(C(C(CO)NC)N)=O,,,3,1,1,0,1
2620_0,,,,2,2,2,4
C(CC(C(C(CO)=O)N)NC)=O,,,3,1,1,0,1
2622_0,,,,2,2,2,4
C(CNC)(CC(C(CO)=O)N)=O,,,3,1,1,0,1
2624_0,,,,2,2,2,4
C(CC(C(CO)=O)NC)(CN)=O,,,3,1,1,0,1
2626_0,,,,2,2,2,4
C(C(C(CC(C=O)O)NC)N)=O,,,3,1,1,0,1
2628_0,,,,2,2,2,4
C(C(C(CNC)N)=O)(CCO)=O,,,3,1,1,0,1
2630_0,,,,2,2,2,4
C(C(CNC)=O)(C(CCO)N)=O,,,3,1,1,0,1
2632_0,,,,2,2,2,4
C(C(CN)=O)(C(CCO)NC)=O,,,3,1,1,0,1
2634_0,,,,2,2,2,4
C(C(C(C(CCO)NC)N)=O)=O,,,3,1,1,0,1
2636_0,,,,2,2,2,4
C(C(CNC)N)(CC(CO)=O)=O,,,3,1,1,0,1
2638_0,,,,2,2,2,4
C(C(CC(C(CNC)=O)O)N)=O,,,3,1,1,0,1
2640_0,,,,2,2,2,4
C(C(CC(C(CN)=O)O)NC)=O,,,3,1,1,0,1
2642_0,,,,2,2,2,4
C(C(CNC)N)(C(C(C)=O)O)=O,,,3,1,1,0,1
2644_0,,,,2,2,2,4
C(C(C)N)(C(C(CNC)=O)O)=O,,,3,1,1,0,1
2646_0,,,,2,2,2,4
C(C(C)NC)(C(C(CN)=O)O)=O,,,3,1,1,0,1
2648_0,,,,2,2,2,4
C(C(C(C(C(C)NC)N)=O)O)=O,,,3,1,1,0,1
2650_0,,,,2,2,2,4
C(CC(C(C(CNC)N)=O)O)=O,,,3,1,1,0,1
2652_0,,,,2,2,2,4
C(CO)(C(CNCC(O)=O)N)=O,,,3,1,1,0,1
2654_0,,,,2,2,2,4
C(C(C(CO)O)O)(C(CNC)N)=O,,,3,1,1,0,1
2655_0,,,,2,2,2,4
2657_0,,,,2,2,2,4
C(C(CO)O)(C(CCO)N)=O,,,3,1,1,0,1
2658_0,,,,2,2,2,4
2660_0,,,,2,2,2,4
C(C(C(CO)O)O)(C(C)N)=O,,,3,1,1,0,1
2662_0,,,,2,2,2,4
C(CN)(C(C(CCO)O)O)=O,,,3,1,1,0,1
2664_0,,,,2,2,2,4
C(CC(C(C(CO)O)=O)N)(O)=O,,,3,1,1,0,1
2666_0,,,,2,2,2,4
C(C(C(CC(CO)O)N)=O)(O)=O,,,3,1,1,0,1
2668_0,,,,2,2,2,4
C(C(CC(C(CO)=O)N)O)(O)=O,,,3,1,1,0,1
2670_0,,,,2,2,2,4
C(C(C(C(CCO)N)=O)O)(O)=O,,,3,1,1,0,1
2672_0,,,,2,2,2,4
C(C(CC(C(C(O)=O)O)O)N)=O,,,3,1,1,0,1
2674_0,,,,2,2,2,4
C(C(C(C(O)=O)O)O)(C(C)N)=O,,,3,1,1,0,1
2676_0,,,,2,2,2,4
C(CC(C(C(CN)=O)O)O)(O)=O,,,3,1,1,0,1
2678_0,,,,2,2,2,4
C(C(CO)(CO)O)(CC(CN)=O)=O,,,3,1,1,0,1
2680_0,,,,2,2,2,4
C(C(C(C(CCO)N)=O)(CO)O)=O,,,3,1,1,0,1
2682_0,,,,2,2,2,4
C(CCO)(C(C(CN)=O)(CO)O)=O,,,3,1,1,0,1
2684_0,,,,2,2,2,4
C(C(CO)(C(CC(C=O)N)O)O)=O,,,3,1,1,0,1
2686_0,,,,2,2,2,4
C(C(CO)(C(C(C(C)N)=O)O)O)=O,,,3,1,1,0,1
2688_0,,,,2,2,2,4
C(C)(C(CO)(C(C(CN)=O)O)O)=O,,,3,1,1,0,1
2690_0,,,,2,2,2,4
C(C(CO)(CC(C(CO)=O)N)O)=O,,,3,1,1,0,1
2692_0,,,,2,2,2,4
C(C(C(C(C(CO)O)O)NC)N)=O,,,3,1,1,0,1
2694_0,,,,2,2,2,4
C(C(CO)NC)(CC(CN)=O)=O,,,3,1,1,0,1
2696_0,,,,2,2,2,4
C(CCO)(C(C(CN)=O)NC)=O,,,3,1,1,0,1
2698_0,,,,2,2,2,4
C(C(C(C(C)=O)NC)O)(CN)=O,,,3,1,1,0,1
2700_0,,,,2,2,2,4
C(C(CCC(C=O)=O)N)=O,,,3,1,1,0,1
2702_0,,,,2,2,2,4
C(C(CCC(C=O)=O)NCCO)=O,,,3,1,1,0,1
2704_0,,,,2,2,2,4
C(C(C)N)(CC(C=O)=O)=O,,,3,1,1,0,1
2706_0,,,,2,2,2,4
C(C(C)NCCO)(CC(C=O)=O)=O,,,3,1,1,0,1
2708_0,,,,2,2,2,4
C(CC(CC(C=O)N)=O)=O,,,3,1,2,0,2
2710_0,,,,2,2,2,4
C(CC(C=O)NCCO)(CC=O)=O,,,3,1,2,0,2
2712_0,,,,2,2,2,4
C(CC(C(C(C)=O)=O)N)=O,,,3,1,1,0,1
2714_0,,,,2,2,2,4
C(CC(C(C(C)N)=O)=O)=O,,,3,1,1,0,1
2716_0,,,,2,2,2,4
C(CC(C(C(C)=O)=O)NCCO)=O,,,3,1,1,0,1
2718_0,,,,2,2,2,4
C(CC(C(C(C)NCCO)=O)=O)=O,,,3,1,1,0,1
2720_0,,,,2,2,2,4
C(CC(C(CC=O)N)=O)=O,,,3,1,3,0,3
2720_1,,,,2,2,2,4
2720_2,,,,2,2,2,4
2722_0,,,,2,2,2,4
C(CC(C(CC=O)=O)NCCO)=O,,,3,1,3,0,3
2722_1,,,,2,2,2,4
2722_2,,,,2,2,2,4
2724_0,,,,2,2,2,4
C(C)(CC(C(CN)=O)=O)=O,,,3,1,1,0,1
2726_0,,,,2,2,2,4
C(C)(CC(C(C=O)=O)N)=O,,,3,1,1,0,1
2728_0,,,,2,2,2,4
C(C)(CC(C(CNCCO)=O)=O)=O,,,3,1,1,0,1
2730_0,,,,2,2,2,4
C(CC(C(C=O)=O)NCCO)(C)=O,,,3,1,1,0,1
2732_0,,,,2,2,2,4
C(CCC(C(CN)=O)=O)=O,,,3,1,1,0,1
2734_0,,,,2,2,2,4
C(CCC(C(C=O)=O)N)=O,,,3,1,1,0,1
2736_0,,,,2,2,2,4
C(CCC(C(CNCCO)=O)=O)=O,,,3,1,1,0,1
2738_0,,,,2,2,2,4
C(CCC(C(C=O)=O)NCCO)=O,,,3,1,1,0,1
2740_0,,,,2,2,2,4
C(CN)(CC(C(C)=O)=O)=O,,,3,1,1,0,1
2742_0,,,,2,2,2,4
C(CNCCO)(CC(C(C)=O)=O)=O,,,3,1,1,0,1
2744_0,,,,2,2,2,4
C(CC(CC(CN)=O)=O)=O,,,3,1,1,0,1
2746_0,,,,2,2,2,4
C(CC(CC(CNCCO)=O)=O)=O,,,3,1,1,0,1
2748_0,,,,2,2,2,4
C1(C(C(CO)O)OCC1N)=O,,,3,1,1,0,1
2750_0,,,,2,2,2,4
C1(C(CC(C(CO)O)O1)N)=O,,,3,1,1,0,1
2752_0,,,,2,2,2,4
C1(C(C(CO)OCC1N)O)=O,,,3,1,1,0,1
2754_0,,,,2,2,2,4
C1(C(CC(C(CO)O1)O)N)=O,,,3,1,1,0,1
2756_0,,,,2,2,2,4
C1(C(CO)OC(CC1N)O)=O,,,3,1,1,0,1
2758_0,,,,2,2,2,4
C1(C(O)OC(CO)CC1N)=O,,,3,1,1,0,1
2760_0,,,,2,2,2,4
C1(C(C(COCC1N)O)O)=O,,,3,1,1,0,1
2762_0,,,,2,2,2,4
C1(C(CC(C(CO1)O)O)N)=O,,,3,1,1,0,1
2764_0,,,,2,2,2,4
C1(C(COC(CC1N)O)O)=O,,,3,1,1,0,1
2766_0,,,,2,2,2,4
C1(C(O)OCC(CC1N)O)=O,,,3,1,1,0,1
2768_0,,,,2,2,2,4
C1(COC(C(CC1N)O)O)=O,,,3,1,1,0,1
2770_0,,,,2,2,2,4
C1(C(C(O)OCCC1N)O)=O,,,3,1,1,0,1
2772_0,,,,2,2,2,4
C(C(CO)O)(C(CCN)N)=O,,,3,1,1,0,1
2774_0,,,,2,2,2,4
C(CN)(C(CC(CO)O)N)=O,,,3,1,2,0,2
2776_0,,,,2,2,2,4
C(CO)(C(CC(CN)O)N)=O,,,3,1,1,0,1
2778_0,,,,2,2,2,4
C(C(CN)O)(C(CCO)N)=O,,,3,1,1,0,1
2780_0,,,,2,2,2,4
C(C(CC(C(CN)O)O)N)=O,,,3,1,1,0,1
2782_0,,,,2,2,2,4
C(C(C(CN)O)O)(C(C)N)=O,,,3,1,1,0,1
2784_0,,,,2,2,2,4
C(CO)=CC(C(CN)=O)=O,,,3,1,1,0,1
2786_0,,,,2,2,2,4
C(C(C(C=O)=O)N)=CCO,,,3,1,1,0,1
2788_0,,,,2,2,2,4
C(CO)=CC(C(CNCCO)=O)=O,,,3,1,1,0,1
2790_0,,,,2,2,2,4
C(C(C(C=O)=O)NCCO)=CCO,,,3,1,1,0,1
2792_0,,,,2,2,2,4
C(CO)(C(C=CC=O)N)=O,,,3,1,1,0,1
2794_0,,,,2,2,2,4
C(CO)(C(C=CC=O)NCCO)=O,,,3,1,1,0,1
2796_0,,,,2,2,2,4
C(CN)(C(C(C=C)=O)O)=O,,,3,1,1,0,1
2798_0,,,,2,2,2,4
C(C(C(C(C=C)N)=O)O)=O,,,3,1,1,0,1
2800_0,,,,2,2,2,4
C(CNCCO)(C(C(C=C)=O)O)=O,,,3,1,1,0,1
2802_0,,,,2,2,2,4
C(C(C=O)O)(C(C=C)NCCO)=O,,,3,1,1,0,1
2804_0,,,,2,2,2,4
C(C=CC(CN)=O)(CO)=O,,,3,1,1,0,1
2806_0,,,,2,2,2,4
C(C(C=CC(C=O)N)O)=O,,,3,1,1,0,1
2808_0,,,,2,2,2,4
C(C=CC(CO)=O)(CNCCO)=O,,,3,1,1,0,1
2810_0,,,,2,2,2,4
C(C(C=CC(C=O)O)NCCO)=O,,,3,1,1,0,1
2812_0,,,,2,2,2,4
C(CN)(C(C=CC=O)O)=O,,,3,1,1,0,1
2814_0,,,,2,2,2,4
C(CNCCO)(C(C=CC=O)O)=O,,,3,1,1,0,1
2816_0,,,,2,2,2,4
C(CN)(C(CO)NC)=O,,,3,1,1,0,1
2818_0,,,,2,2,2,4
C(C(C(C(C(CO)O)NC)O)N)=O,,,3,1,1,0,1
2820_0,,,,2,2,2,4
C(C(C(CO)O)NC)(C(CO)N)=O,,,3,1,1,0,1
2822_0,,,,2,2,2,4
C(CC(C(C(CO)NC)=O)N)=O,,,3,1,1,0,1
2824_0,,,,2,2,2,4
C(C(CN)=O)(CC(CO)NC)=O,,,3,1,1,0,1
2826_0,,,,2,2,2,4
C(C(C(CC(CO)NC)N)=O)=O,,,3,1,1,0,1
2828_0,,,,2,2,2,4
C(C(CC(C(CO)=O)N)NC)=O,,,3,1,1,0,1
2830_0,,,,2,2,2,4
C(C(CNC)O)(CC(CN)=O)=O,,,3,1,1,0,1
2832_0,,,,2,2,2,4
C(C(CC(C(CNC)=O)N)O)=O,,,3,1,1,0,1
2834_0,,,,2,2,2,4
C(C(C(C(CCO)N)=O)NC)=O,,,3,1,1,0,1
2836_0,,,,2,2,2,4
C(CCNC)(C(C(CN)=O)O)=O,,,3,1,1,0,1
2838_0,,,,2,2,2,4
C(C(C(C(CCNC)N)=O)O)=O,,,3,1,1,0,1
2840_0,,,,2,2,2,4
C(CC(C(CN)=O)NC)(CO)=O,,,3,1,1,0,1
2842_0,,,,2,2,2,4
C(C(CC(C(C=O)O)NC)N)=O,,,3,1,1,0,1
2844_0,,,,2,2,2,4
C(C(C(C(CN)=O)NC)O)(C)=O,,,3,1,1,0,1
2846_0,,,,2,2,2,4
C(C(C(C(C(C)N)=O)NC)O)=O,,,3,1,1,0,1
2848_0,,,,2,2,2,4
C(CC(C(C(CN)=O)NC)O)=O,,,3,1,1,0,1
2850_0,,,,2,2,2,4
C(CC(C(C(CN)=O)O)NC)=O,,,3,1,1,0,1
2852_0,,,,2,2,2,4
C(CNC(C(CN)=O)CO)(O)=O,,,3,1,1,0,1
2854_0,,,,2,2,2,4
C(CN)(C(C(C(CO)O)O)NC)=O,,,3,1,1,0,1
2856_0,,,,2,2,2,4
C(CN)(C1(CC(CO1)O)O)=O,,,3,1,1,0,1
2858_0,,,,2,2,2,4
C(CN)(C1C(CC(O1)O)O)=O,,,3,1,1,0,1
2859_0,,,,2,2,2,4
2861_0,,,,2,2,2,4
C(CN)(CC(C(CO)O)N)=O,,,3,1,2,0,2
2863_0,,,,2,2,2,4
C(CN)(C(C(CCO)N)O)=O,,,3,1,1,0,1
2865_0,,,,2,2,2,4
C(CN)(C(CC(CO)N)O)=O,,,3,1,1,0,1
2867_0,,,,2,2,2,4
C(CN)(C(C(C(C)N)O)O)=O,,,3,1,1,0,1
2869_0,,,,2,2,2,4
C(CN)(C(C(CCN)O)O)=O,,,3,1,1,0,1
2871_0,,,,2,2,2,4
C(CNCCO)(C(CO)NC)=O,,,3,1,1,0,1
2873_0,,,,2,2,2,4
C(CNCC(C(O)=O)=O)(O)=O,,,3,1,1,0,1
2875_0,,,,2,2,2,4
C(C(C(CNCC(O)=O)=O)O)(O)=O,,,3,1,1,0,1
2876_0,,,,2,2,2,4
2877_0,,,,2,2,2,4
2879_0,,,,2,2,2,4
C(CC(C=O)NCC(O)=O)=O,,,3,1,2,0,2
2881_0,,,,2,2,2,4
C(CNCC(C(C)=O)=O)(O)=O,,,3,1,2,0,2
2883_0,,,,2,2,2,4
C(CNC(C(C=O)=O)C)(O)=O,,,3,1,1,0,1
2885_0,,,,2,2,2,4
C(CNC(C(CO)=O)C)(O)=O,,,3,1,1,0,1
2887_0,,,,2,2,2,4
C(CNCC(CC(CO)=O)=O)(O)=O,,,3,1,1,0,1
2889_0,,,,2,2,2,4
C(C(CC(C=O)O)NCC(O)=O)=O,,,3,1,1,0,1
2891_0,,,,2,2,2,4
C(C(CCO)NCC(O)=O)=O,,,3,1,1,0,1
2893_0,,,,2,2,2,4
C(CNCC(C(C(C)=O)O)=O)(O)=O,,,3,1,1,0,1
2895_0,,,,2,2,2,4
C(C(C)NCC(O)=O)(C(C=O)O)=O,,,3,1,1,0,1
2897_0,,,,2,2,2,4
C(CNCC(C=O)=O)(O)=O,,,3,1,1,0,1
2899_0,,,,2,2,2,4
C(C(C)NCC(O)=O)=O,,,3,1,1,0,1
2901_0,,,,2,2,2,4
C(CC(CNCC(O)=O)=O)=O,,,3,1,2,0,2
2903_0,,,,2,2,2,4
C(C(C(CNCC(O)=O)=O)O)=O,,,3,1,1,0,1
2904_0,,,,2,2,2,4
2905_0,,,,2,2,2,4
2905_1,,,,2,2,2,4
2907_0,,,,2,2,2,4
C(CNC(C(CO)=O)CNC)(O)=O,,,3,1,1,0,1
2909_0,,,,2,2,2,4
C(CNCC(O)=O)(C(CO)NC)=O,,,3,1,2,0,2
2911_0,,,,2,2,2,4
C(CN(C)CC=O)=O,,,3,1,1,0,1
2913_0,,,,2,2,2,4
C(CN(C)CC=O)(C(CO)O)=O,,,3,1,2,0,2
2915_0,,,,2,2,2,4
C(CN(CC=O)CC(O)=O)=O,,,3,1,1,0,1
2917_0,,,,2,2,2,4
C(C(C(CO)O)NCC=O)(O)=O,,,3,1,2,0,2
2919_0,,,,2,2,2,4
C(C(C(O)=O)NCC=O)(O)=O,,,3,1,3,0,3
2921_0,,,,2,2,2,4
C(C(C(C(O)=O)NCC=O)O)(O)=O,,,3,1,2,0,2
2923_0,,,,2,2,2,4
C(C(CO)NCC=O)(O)=O,,,3,1,2,0,2
2924_0,,,,2,2,2,4
2926_0,,,,2,2,2,4
C(C(C(CO)N(C)CC=O)O)=O,,,3,1,2,0,2
2928_0,,,,2,2,2,4
C(CNCCO)=O,,,3,1,2,0,2
2930_0,,,,2,2,2,4
C(CNCC(C(CO)O)O)=O,,,3,1,2,0,2
2931_0,,,,2,2,2,4
2933_0,,,,2,2,2,4
C(CN)(C(CO)O)=O,,,3,1,1,0,1
2935_0,,,,2,2,2,4
C(CNCCO)(C(CO)O)=O,,,3,1,2,0,2
2937_0,,,,2,2,2,4
C(C(C(C(C(CO)O)O)O)N)=O,,,3,1,12,0,12
2939_0,,,,2,2,2,4
C(C(C(CO)O)O)(C(CO)N)=O,,,3,1,2,0,2
2941_0,,,,2,2,2,4
C1(C(C(C(CO)C1NC)O)O)=O,,,3,1,1,0,1
2942_0,,,,2,2,2,4
2944_0,,,,2,2,2,4
C(C(O)=O)(CNC)=O,,,3,1,1,0,1
2946_0,,,,2,2,2,4
C(C(C(CNC)=O)O)(O)=O,,,3,1,1,0,1
2947_0,,,,2,2,2,4
2949_0,,,,2,2,2,4
C(C(C(C(C(CO)O)O)=O)NC)=O,,,3,1,1,0,1
2950_0,,,,2,2,2,4
2951_0,,,,2,2,2,4
2952_0,,,,2,2,2,4
2953_0,,,,2,2,2,4
2954_0,,,,2,2,2,4
2955_0,,,,2,2,2,4
2957_0,,,,2,2,2,4
C(C(CC(C=O)O)NC)=O,,,3,1,1,0,1
2959_0,,,,2,2,2,4
C(C(CCO)NC)=O,,,3,1,1,0,1
2960_0,,,,2,2,2,4
2962_0,,,,2,2,2,4
C(C(C(C(C)NC)=O)O)=O,,,3,1,1,0,1
2963_0,,,,2,2,2,4
2965_0,,,,2,2,2,4
C(C(C)NC)=O,,,3,1,1,0,1
2966_0,,,,2,2,2,4
2967_0,,,,2,2,2,4
2968_0,,,,2,2,2,4
2969_0,,,,2,2,2,4
2969_1,,,,2,2,2,4
2970_0,,,,2,2,2,4
2971_0,,,,2,2,2,4
2971_1,,,,2,2,2,4
2972_0,,,,2,2,2,4
2973_0,,,,2,2,2,4
2974_0,,,,2,2,2,4
2975_0,,,,2,2,2,4
2976_0,,,,2,2,2,4
2977_0,,,,2,2,2,4
2978_0,,,,2,2,2,4
2979_0,,,,2,2,2,4
2980_0,,,,2,2,2,4
2981_0,,,,2,2,2,4
2983_0,,,,2,2,2,4
C(C(C(CO)NC)=O)(CCO)=O,,,3,1,2,0,2
2984_0,,,,2,2,2,4
2985_0,,,,2,2,2,4
2987_0,,,,2,2,2,4
C(C(C(C(CCO)O)NC)=O)=O,,,3,1,1,0,1
2988_0,,,,2,2,2,4
2989_0,,,,2,2,2,4
2990_0,,,,2,2,2,4
2991_0,,,,2,2,2,4
2992_0,,,,2,2,2,4
2994_0,,,,2,2,2,4
C(C(C(CC(CNC)=O)O)O)=O,,,3,1,1,0,1
2995_0,,,,2,2,2,4
2997_0,,,,2,2,2,4
C(C(CO)NC)(C(C(C)=O)O)=O,,,3,1,2,0,2
2998_0,,,,2,2,2,4
2999_0,,,,2,2,2,4
3001_0,,,,2,2,2,4
C(C(C(C(C(C)O)NC)=O)O)=O,,,3,1,1,0,1
3002_0,,,,2,2,2,4
3003_0,,,,2,2,2,4
3004_0,,,,2,2,2,4
3006_0,,,,2,2,2,4
C(CO)(C(CNC)NC)=O,,,3,1,1,0,1
3008_0,,,,2,2,2,4
C(CC(C(C(CO)=O)NC)NC)=O,,,3,1,1,0,1
3010_0,,,,2,2,2,4
C(CC(C(CO)=O)NC)(CNC)=O,,,3,1,2,0,2
3011_0,,,,2,2,2,4
3013_0,,,,2,2,2,4
C(C(C(CC(C=O)O)NC)NC)=O,,,3,1,1,0,1
3015_0,,,,2,2,2,4
C(C(C(CNC)NC)=O)(CCO)=O,,,3,1,1,0,1
3017_0,,,,2,2,2,4
C(C(CNC)=O)(C(CCO)NC)=O,,,3,1,2,0,2
3018_0,,,,2,2,2,4
3020_0,,,,2,2,2,4
C(C(C(C(CCO)NC)NC)=O)=O,,,3,1,1,0,1
3022_0,,,,2,2,2,4
C(C(CNC)NC)(CC(CO)=O)=O,,,3,1,1,0,1
3024_0,,,,2,2,2,4
C(C(CC(C(CNC)=O)O)NC)=O,,,3,1,2,0,2
3025_0,,,,2,2,2,4
3027_0,,,,2,2,2,4
C(C(CNC)NC)(C(C(C)=O)O)=O,,,3,1,1,0,1
3029_0,,,,2,2,2,4
C(C(C)NC)(C(C(CNC)=O)O)=O,,,3,1,2,0,2
3030_0,,,,2,2,2,4
3032_0,,,,2,2,2,4
C(C(C(C(C(C)NC)NC)=O)O)=O,,,3,1,1,0,1
3034_0,,,,2,2,2,4
C(CC(C(C(CNC)NC)=O)O)=O,,,3,1,1,0,1
3036_0,,,,2,2,2,4
C(CNCC(C(CO)=O)NC)(O)=O,,,3,1,1,0,1
3038_0,,,,2,2,2,4
C(C(CC(C(CO)O)O)NC)=O,,,3,1,2,0,2
3040_0,,,,2,2,2,4
C(C(CO)O)(C(CCO)NC)=O,,,3,1,3,0,3
3042_0,,,,2,2,2,4
C(CO)(C(CC(CO)O)NC)=O,,,3,1,3,0,3
3044_0,,,,2,2,2,4
C(C(C(CO)O)O)(C(C)NC)=O,,,3,1,2,0,2
3046_0,,,,2,2,2,4
C(CNC)(C(C(CCO)O)O)=O,,,3,1,2,0,2
3048_0,,,,2,2,2,4
C(CC(C(C(CO)O)=O)NC)(O)=O,,,3,1,2,0,2
3050_0,,,,2,2,2,4
C(C(C(CC(CO)O)NC)=O)(O)=O,,,3,1,2,0,2
3052_0,,,,2,2,2,4
C(C(CC(C(CO)=O)NC)O)(O)=O,,,3,1,2,0,2
3054_0,,,,2,2,2,4
C(C(C(C(CCO)NC)=O)O)(O)=O,,,3,1,2,0,2
3056_0,,,,2,2,2,4
C(C(CC(C(C(O)=O)O)O)NC)=O,,,3,1,2,0,2
3058_0,,,,2,2,2,4
C(C(C(C(O)=O)O)O)(C(C)NC)=O,,,3,1,2,0,2
3060_0,,,,2,2,2,4
C(CC(C(C(CNC)=O)O)O)(O)=O,,,3,1,2,0,2
3062_0,,,,2,2,2,4
C(C(CO)NC)(CC(CNC)=O)=O,,,3,1,2,0,2
3064_0,,,,2,2,2,4
C(CCO)(C(C(CNC)=O)NC)=O,,,3,1,2,0,2
3066_0,,,,2,2,2,4
C(C(C(C(CNC)=O)O)NC)(C)=O,,,3,1,3,0,3
3068_0,,,,2,2,2,4
C(C(CCC(C=O)=O)NC)=O,,,3,1,2,0,2
3070_0,,,,2,2,2,4
C(C(C)NC)(CC(C=O)=O)=O,,,3,1,2,0,2
3072_0,,,,2,2,2,4
C(CC(C=O)NC)(CC=O)=O,,,3,1,4,0,4
3074_0,,,,2,2,2,4
C(CC(C(C(C)=O)=O)NC)=O,,,3,1,2,0,2
3076_0,,,,2,2,2,4
C(CC(C(C(C)NC)=O)=O)=O,,,3,1,2,0,2
3078_0,,,,2,2,2,4
C(CC(C(CC=O)=O)NC)=O,,,3,1,6,0,6
3078_1,,,,2,2,2,4
3078_2,,,,2,2,2,4
3080_0,,,,2,2,2,4
C(C)(CC(C(CNC)=O)=O)=O,,,3,1,3,0,3
3082_0,,,,2,2,2,4
C(CC(C(C=O)=O)NC)(C)=O,,,3,1,2,0,2
3084_0,,,,2,2,2,4
C(CCC(C(CNC)=O)=O)=O,,,3,1,3,0,3
3086_0,,,,2,2,2,4
C(CCC(C(C=O)=O)NC)=O,,,3,1,2,0,2
3088_0,,,,2,2,2,4
C(CNC)(CC(C(C)=O)=O)=O,,,3,1,3,0,3
3090_0,,,,2,2,2,4
C(CC(CC(CNC)=O)=O)=O,,,3,1,3,0,3
3092_0,,,,2,2,2,4
C1(C(C(CO)O)OCC1NC)=O,,,3,1,1,0,1
3094_0,,,,2,2,2,4
C1(C(CC(C(CO)O)O1)NC)=O,,,3,1,1,0,1
3096_0,,,,2,2,2,4
C1(C(C(CO)OCC1NC)O)=O,,,3,1,1,0,1
3098_0,,,,2,2,2,4
C1(C(CC(C(CO)O1)O)NC)=O,,,3,1,1,0,1
3100_0,,,,2,2,2,4
C1(C(CO)OC(CC1NC)O)=O,,,3,1,2,0,2
3102_0,,,,2,2,2,4
C1(C(O)OC(CO)CC1NC)=O,,,3,1,2,0,2
3104_0,,,,2,2,2,4
C1(C(C(COCC1NC)O)O)=O,,,3,1,1,0,1
3106_0,,,,2,2,2,4
C1(C(CC(C(CO1)O)O)NC)=O,,,3,1,1,0,1
3108_0,,,,2,2,2,4
C1(C(COC(CC1NC)O)O)=O,,,3,1,2,0,2
3110_0,,,,2,2,2,4
C1(C(O)OCC(CC1NC)O)=O,,,3,1,2,0,2
3112_0,,,,2,2,2,4
C1(COC(C(CC1NC)O)O)=O,,,3,1,2,0,2
3114_0,,,,2,2,2,4
C1(C(C(O)OCCC1NC)O)=O,,,3,1,2,0,2
3116_0,,,,2,2,2,4
C(C(CO)O)(C(CCN)NC)=O,,,3,1,13,0,13
3118_0,,,,2,2,2,4
C(CN)(C(CC(CO)O)NC)=O,,,3,1,12,0,12
3120_0,,,,2,2,2,4
C(CO)(C(CC(CN)O)NC)=O,,,3,1,13,0,13
3122_0,,,,2,2,2,4
C(C(CN)O)(C(CCO)NC)=O,,,3,1,13,0,13
3124_0,,,,2,2,2,4
C(C(CC(C(CN)O)O)NC)=O,,,3,1,13,0,13
3126_0,,,,2,2,2,4
C(C(C(CN)O)O)(C(C)NC)=O,,,3,1,13,0,13
3128_0,,,,2,2,2,4
C(CO)=CC(C(CNC)=O)=O,,,3,1,2,0,2
3130_0,,,,2,2,2,4
C(C(C(C=O)=O)NC)=CCO,,,3,1,2,0,2
3132_0,,,,2,2,2,4
C(CO)(C(C=CC=O)NC)=O,,,3,1,2,0,2
3134_0,,,,2,2,2,4
C(CNC)(C(C(C=C)=O)O)=O,,,3,1,2,0,2
3136_0,,,,2,2,2,4
C(C(C=O)O)(C(C=C)NC)=O,,,3,1,2,0,2
3138_0,,,,2,2,2,4
C(C=CC(CO)=O)(CNC)=O,,,3,1,2,0,2
3140_0,,,,2,2,2,4
C(C(C=CC(C=O)O)NC)=O,,,3,1,2,0,2
3142_0,,,,2,2,2,4
C(CNC)(C(C=CC=O)O)=O,,,3,1,2,0,2
3144_0,,,,2,2,2,4
C(CNC)(C(CO)NC)=O,,,3,1,2,0,2
3146_0,,,,2,2,2,4
C(CC(C(C(CO)NC)=O)NC)=O,,,3,1,2,0,2
3148_0,,,,2,2,2,4
C(C(CNC)=O)(CC(CO)NC)=O,,,3,1,2,0,2
3150_0,,,,2,2,2,4
C(C(C(CC(CO)NC)NC)=O)=O,,,3,1,1,0,1
3152_0,,,,2,2,2,4
C(C(CC(C(CO)=O)NC)NC)=O,,,3,1,1,0,1
3154_0,,,,2,2,2,4
C(C(CNC)O)(CC(CNC)=O)=O,,,3,1,2,0,2
3156_0,,,,2,2,2,4
C(C(CC(C(CNC)=O)NC)O)=O,,,3,1,1,0,1
3158_0,,,,2,2,2,4
C(C(C(C(CCO)NC)=O)NC)=O,,,3,1,2,0,2
3160_0,,,,2,2,2,4
C(CCNC)(C(C(CNC)=O)O)=O,,,3,1,2,0,2
3162_0,,,,2,2,2,4
C(C(C(C(CCNC)NC)=O)O)=O,,,3,1,1,0,1
3164_0,,,,2,2,2,4
C(CC(C(CNC)=O)NC)(CO)=O,,,3,1,3,0,3
3166_0,,,,2,2,2,4
C(C(CC(C(C=O)O)NC)NC)=O,,,3,1,2,0,2
3168_0,,,,2,2,2,4
C(C(C(C(C)=O)O)NC)(CNC)=O,,,3,1,3,0,3
3170_0,,,,2,2,2,4
C(C(C(C=O)O)NC)(C(C)NC)=O,,,3,1,3,0,3
3172_0,,,,2,2,2,4
C(CC(C(C(CNC)=O)NC)O)=O,,,3,1,2,0,2
3174_0,,,,2,2,2,4
C(CC(C(C(CNC)=O)O)NC)=O,,,3,1,2,0,2
3176_0,,,,2,2,2,4
C(CNC(C(CNC)=O)CO)(O)=O,,,3,1,2,0,2
3178_0,,,,2,2,2,4
C(CNC)(C1(CC(CO1)O)O)=O,,,3,1,2,0,2
3180_0,,,,2,2,2,4
C(CNC)(C1C(CC(O1)O)O)=O,,,3,1,2,0,2
3182_0,,,,2,2,2,4
C(CNC)(C(CC(CO)O)N)=O,,,3,1,12,0,12
3184_0,,,,2,2,2,4
C(CNC)(CC(C(CO)O)N)=O,,,3,1,13,0,13
3186_0,,,,2,2,2,4
C(CNC)(C(C(CCO)N)O)=O,,,3,1,13,0,13
3188_0,,,,2,2,2,4
C(CNC)(C(CC(CO)N)O)=O,,,3,1,13,0,13
3190_0,,,,2,2,2,4
C(CNC)(C(C(C(C)N)O)O)=O,,,3,1,13,0,13
3192_0,,,,2,2,2,4
C(CNC)(C(C(CCN)O)O)=O,,,3,1,13,0,13
3194_0,,,,2,2,2,4
C(CC(C(C(CO)O)=O)N)=O,,,3,1,5,0,5
3196_0,,,,2,2,2,4
C(C(CN)=O)(CC(CO)O)=O,,,3,1,1,0,1
3198_0,,,,2,2,2,4
C(C(C(CC(CO)O)N)=O)=O,,,3,1,3,0,3
3200_0,,,,2,2,2,4
C(C(CO)O)(CC(CN)=O)=O,,,3,1,1,0,1
3202_0,,,,2,2,2,4
C(C(CC(C(CO)=O)N)O)=O,,,3,1,3,0,3
3204_0,,,,2,2,2,4
C(CCO)(C(C(CN)=O)O)=O,,,3,1,1,0,1
3206_0,,,,2,2,2,4
C(C(C(C(CCO)N)=O)O)=O,,,3,1,3,0,3
3208_0,,,,2,2,2,4
C(CN)(C(CC(CO)=O)O)=O,,,3,1,1,0,1
3210_0,,,,2,2,2,4
C(C(CC(C(C=O)O)O)N)=O,,,3,1,2,0,2
3212_0,,,,2,2,2,4
C(C)(C(C(C(CN)=O)O)O)=O,,,3,1,1,0,1
3214_0,,,,2,2,2,4
C(C(C(C=O)O)O)(C(C)N)=O,,,3,1,3,0,3
3216_0,,,,2,2,2,4
C(CC(C(C(CN)=O)O)O)=O,,,3,1,1,0,1
3218_0,,,,2,2,2,4
C(CN)(C(C(C(CO)O)O)O)=O,,,3,1,12,0,12
3220_0,,,,2,3,2,5
C(C1C(C(C(C1O)O)O)O)O,,,3,1,1,0,1
3222_0,,,,2,3,2,5
C(C(CO)O)(O)=O,,,3,1,3,0,3
3223_0,,,,2,3,2,5
3225_0,,,,2,3,2,5
C(C(CO)O)O,,,3,1,4,0,4
3226_0,,,,2,3,2,5
3227_0,,,,2,3,2,5
3228_0,,,,2,3,2,5
3229_0,,,,2,3,2,5
3230_0,,,,2,3,2,5
3231_0,,,,2,3,2,5
3232_0,,,,2,3,2,5
3233_0,,,,2,3,2,5
3234_0,,,,2,3,2,5
3236_0,,,,2,3,2,5
C(C(C(C(C(CO)CO)O)O)O)=O,,,3,1,1,0,1
3237_0,,,,2,3,2,5
3238_0,,,,2,3,2,5
3239_0,,,,2,3,2,5
3240_0,,,,2,3,2,5
3241_0,,,,2,3,2,5
3242_0,,,,2,3,2,5
3243_0,,,,2,3,2,5
3244_0,,,,2,3,2,5
3245_0,,,,2,3,2,5
3246_0,,,,2,3,2,5
3247_0,,,,2,3,2,5
3248_0,,,,2,3,2,5
3250_0,,,,2,3,2,5
CCO,,,3,1,1,0,1
3251_0,,,,2,3,2,5
3252_0,,,,2,3,2,5
3253_0,,,,2,3,2,5
3254_0,,,,2,3,2,5
3255_0,,,,2,3,2,5
3257_0,,,,2,3,2,5
C(C(C(CC(CO)O)O)O)=O,,,3,1,2,0,2
3258_0,,,,2,3,2,5
3259_0,,,,2,3,2,5
3261_0,,,,2,3,2,5
CNCCO,,,3,1,1,0,1
3263_0,,,,2,3,2,5
CNC(CO)C(C(C(CO)O)O)O,,,3,1,1,0,1
3264_0,,,,2,3,2,5
3265_0,,,,2,3,2,5
3266_0,,,,2,3,2,5
3267_0,,,,2,3,2,5
3268_0,,,,2,3,2,5
3270_0,,,,2,3,2,5
C(C(C(CC(CO)NC)O)O)=O,,,3,1,1,0,1
3271_0,,,,2,3,2,5
3272_0,,,,2,3,2,5
3274_0,,,,2,3,2,5
C(CNCCO)(O)=O,,,3,1,1,0,1
3276_0,,,,2,3,2,5
C(C(C(C(CCO)O)O)O)O,,,3,1,2,0,2
3277_0,,,,2,3,2,5
3279_0,,,,2,3,2,5
C(C(C(C(CCO)O)O)O)(O)=O,,,3,1,2,0,2
3281_0,,,,2,3,2,5
C(CC(C(C(CO)O)O)O)(O)=O,,,3,1,2,0,2
3283_0,,,,2,3,2,5
C(C1(C(C(CC1O)O)O)O)O,,,3,1,1,0,1
3285_0,,,,2,3,2,5
C(C(C(CO)O)(C(CO)O)O)O,,,3,1,1,0,1
3287_0,,,,2,3,2,5
C(C(CO)(C(CO)O)O)(O)=O,,,3,1,4,0,4
3289_0,,,,2,3,2,5
C(C(C(CO)(C(CO)O)O)O)(O)=O,,,3,1,2,0,2
3291_0,,,,2,3,2,5
C(C(CO)(C(CO)O)O)O,,,3,1,1,0,1
3293_0,,,,2,3,2,5
C(CCO)(C(CO)(C(CO)O)O)=O,,,3,1,4,0,4
3295_0,,,,2,3,2,5
C(CC(CO)O)(C(CO)(CO)O)=O,,,3,1,4,0,4
3296_0,,,,2,3,2,5
3297_0,,,,2,3,2,5
3298_0,,,,2,3,2,5
3300_0,,,,2,3,2,5
C(CO)(CC(C(CO)(CO)O)O)=O,,,3,1,1,0,1
3302_0,,,,2,3,2,5
C(C)(C(C(C(CO)(CO)O)O)O)=O,,,3,1,1,0,1
3304_0,,,,2,3,2,5
C(C)(C(CO)(C(C(CO)O)O)O)=O,,,3,1,5,0,5
3306_0,,,,2,3,2,5
C(CC(C(C(CO)(CO)O)O)O)=O,,,3,1,1,0,1
3308_0,,,,2,3,2,5
C(C(CO)(C(C(CCO)O)O)O)=O,,,3,1,3,0,3
3309_0,,,,2,3,2,5
3311_0,,,,2,3,2,5
C(C(C(CO)O)NC)(CCO)=O,,,3,1,3,0,3
3313_0,,,,2,3,2,5
C(C(CO)NC)(CC(CO)O)=O,,,3,1,3,0,3
3314_0,,,,2,3,2,5
3315_0,,,,2,3,2,5
3317_0,,,,2,3,2,5
C(C)(C(C(C(CO)O)O)NC)=O,,,3,1,2,0,2
3319_0,,,,2,3,2,5
C(C(C(CC(CO)N)O)O)O,,,3,1,14,0,14
3321_0,,,,2,3,2,5
C(CCO)(CC(CO)=O)=O,,,3,1,4,0,4
3323_0,,,,2,3,2,5
C(CO)(CCC(CO)=O)=O,,,3,1,2,0,2
3324_0,,,,2,3,2,5
3325_0,,,,2,3,2,5
3327_0,,,,2,3,2,5
C(C(CC(CCO)O)=O)=O,,,3,1,2,0,2
3329_0,,,,2,3,2,5
C(C(CCO)=O)(CCO)=O,,,3,1,2,0,2
3330_0,,,,2,3,2,5
3332_0,,,,2,3,2,5
C(CCO)(C(C(C)=O)O)=O,,,3,1,4,0,4
3333_0,,,,2,3,2,5
3335_0,,,,2,3,2,5
C(CC(C(CCO)O)=O)=O,,,3,1,2,0,2
3337_0,,,,2,3,2,5
C(C(CO)O)(CC(C)=O)=O,,,3,1,4,0,4
3339_0,,,,2,3,2,5
C(CCC=O)(C(CO)O)=O,,,3,1,4,0,4
3341_0,,,,2,3,2,5
C(C(C(CCCO)=O)O)=O,,,3,1,3,0,3
3343_0,,,,2,3,2,5
C(C(C)=O)(CC(CO)O)=O,,,3,1,4,0,4
3345_0,,,,2,3,2,5
C(CC(CC(CO)O)=O)=O,,,3,1,3,0,3
3347_0,,,,2,3,2,5
C(CC(C=O)O)(CCO)=O,,,3,1,2,0,2
3349_0,,,,2,3,2,5
C(CC1C(C(C(O)O1)O)O)O,,,3,1,2,0,2
3351_0,,,,2,3,2,5
C(CC(C(C(CN)O)O)O)O,,,3,1,13,0,13
3353_0,,,,2,3,2,5
C(C(CO)O)=CC(CO)=O,,,3,1,3,0,3
3355_0,,,,2,3,2,5
C(CO)=CC(C(CO)O)=O,,,3,1,3,0,3
3356_0,,,,2,3,2,5
3358_0,,,,2,3,2,5
C=CC(C(C(CO)O)O)=O,,,3,1,3,0,3
3359_0,,,,2,3,2,5
3361_0,,,,2,3,2,5
C(C(C(CO)O)O)=CC=O,,,3,1,4,0,4
3363_0,,,,2,3,2,5
C(C(C(C=CCO)O)O)=O,,,3,1,4,0,4
3365_0,,,,2,3,2,5
CNC(CO)C(CO)O,,,3,1,1,0,1
3367_0,,,,2,3,2,5
C(CO)(CC(C(CO)O)NC)=O,,,3,1,3,0,3
3369_0,,,,2,3,2,5
C(C(C(CO)NC)O)(CCO)=O,,,3,1,3,0,3
3371_0,,,,2,3,2,5
C(C(CO)O)(CC(CO)NC)=O,,,3,1,3,0,3
3372_0,,,,2,3,2,5
3374_0,,,,2,3,2,5
C(C(CNC)O)(CC(CO)O)=O,,,3,1,2,0,2
3375_0,,,,2,3,2,5
3377_0,,,,2,3,2,5
C(C(C(CO)O)O)(CCNC)=O,,,3,1,2,0,2
3378_0,,,,2,3,2,5
3380_0,,,,2,3,2,5
C(C)(C(C(C(CO)O)NC)O)=O,,,3,1,2,0,2
3382_0,,,,2,3,2,5
C(CC(C(C(CO)O)NC)O)=O,,,3,1,1,0,1
3384_0,,,,2,3,2,5
C(C(C(C(CCO)O)NC)O)=O,,,3,1,2,0,2
3386_0,,,,2,3,2,5
C(CC(C(C(CO)O)O)NC)=O,,,3,1,2,0,2
3388_0,,,,2,3,2,5
C(C(C(C(CCO)NC)O)O)=O,,,3,1,1,0,1
3390_0,,,,2,3,2,5
C(CNC(CO)C(CO)O)(O)=O,,,3,1,1,0,1
3392_0,,,,2,3,2,5
CNC(C(C(CO)O)O)C(CO)O,,,3,1,1,0,1
3394_0,,,,2,3,2,5
C(C1(CC(C(CO)O1)O)O)O,,,3,1,3,0,3
3396_0,,,,2,3,2,5
C1C(C(C(CCO)(O)O1)O)O,,,3,1,2,0,2
3398_0,,,,2,3,2,5
C1C(CC(C(CO)O)(O)O1)O,,,3,1,2,0,2
3399_0,,,,2,3,2,5
3401_0,,,,2,3,2,5
CC1(C(C(C(CO)O1)O)O)O,,,3,1,2,0,2
3403_0,,,,2,3,2,5
C(C(C1C(CC(O)O1)O)O)O,,,3,1,2,0,2
3405_0,,,,2,3,2,5
C1C(C(CC(CO)(O)O1)O)O,,,3,1,2,0,2
3407_0,,,,2,3,2,5
C(C1C(C(CC(O)O1)O)O)O,,,3,1,2,0,2
3409_0,,,,2,3,2,5
C(C(C(C(CCO)N)O)O)O,,,3,1,14,0,14
3411_0,,,,2,3,2,5
C(C(CC(C(CO)O)N)O)O,,,3,1,14,0,14
3412_0,,,,2,3,2,5
3413_0,,,,2,3,2,5
3414_0,,,,2,3,2,5
3416_0,,,,2,3,2,5
CC(C(C(C(CO)O)O)O)N,,,3,1,13,0,13
3418_0,,,,2,3,2,5
C(C(C(C(CCN)O)O)O)O,,,3,1,13,0,13
3420_0,,,,2,3,2,5
C(C1C(C(C(C1O)O)O)O)(O)=O,,,3,1,2,0,2
3422_0,,,,2,3,2,5
C(C(C(O)=O)O)(O)=O,,,3,1,2,0,2
3424_0,,,,2,3,2,5
C(C(C(C(O)=O)O)O)(O)=O,,,3,1,3,0,3
3425_0,,,,2,3,2,5
3427_0,,,,2,3,2,5
C(C(C(C(C(CO)O)O)O)=O)(O)=O,,,3,1,297,0,297
3428_0,,,,2,3,2,5
3429_0,,,,2,3,2,5
3430_0,,,,2,3,2,5
3431_0,,,,2,3,2,5
3432_0,,,,2,3,2,5
3434_0,,,,2,3,2,5
C(C(CCO)=O)(O)=O,,,3,1,2,0,2
3435_0,,,,2,3,2,5
3436_0,,,,2,3,2,5
3437_0,,,,2,3,2,5
3438_0,,,,2,3,2,5
3439_0,,,,2,3,2,5
3441_0,,,,2,3,2,5
C(C)(O)=O,,,3,1,1,0,1
3442_0,,,,2,3,2,5
3443_0,,,,2,3,2,5
3444_0,,,,2,3,2,5
3445_0,,,,2,3,2,5
3446_0,,,,2,3,2,5
3448_0,,,,2,3,2,5
C(C(CC(C(C=O)O)O)O)(O)=O,,,3,1,1,0,1
3449_0,,,,2,3,2,5
3450_0,,,,2,3,2,5
3452_0,,,,2,3,2,5
C(CNC)(O)=O,,,3,1,1,0,1
3453_0,,,,2,3,2,5
3454_0,,,,2,3,2,5
3455_0,,,,2,3,2,5
3456_0,,,,2,3,2,5
3457_0,,,,2,3,2,5
3459_0,,,,2,3,2,5
C(C(CC(C(C=O)O)O)NC)(O)=O,,,3,1,1,0,1
3460_0,,,,2,3,2,5
3461_0,,,,2,3,2,5
3463_0,,,,2,3,2,5
C(CNCC(O)=O)(O)=O,,,3,1,1,0,1
3464_0,,,,2,3,2,5
3465_0,,,,2,3,2,5
3467_0,,,,2,3,2,5
C(CC(C(C(C(O)=O)O)O)O)(O)=O,,,3,1,2,0,2
3468_0,,,,2,3,2,5
3470_0,,,,2,3,2,5
C(C1(C(C(CC1O)O)O)O)(O)=O,,,3,1,3,0,3
3472_0,,,,2,3,2,5
C(C(C(CO)O)(C(CO)O)O)(O)=O,,,3,1,3,0,3
3474_0,,,,2,3,2,5
C(C(C(O)=O)(C(CO)O)O)(O)=O,,,3,1,3,0,3
3475_0,,,,2,3,2,5
3477_0,,,,2,3,2,5
C(CC(C(C(CO)O)NC)=O)(O)=O,,,3,1,2,0,2
3479_0,,,,2,3,2,5
C(C(C(CC(CO)O)=O)NC)(O)=O,,,3,1,2,0,2
3481_0,,,,2,3,2,5
C(CC(C(O)=O)O)(C(CO)NC)=O,,,3,1,2,0,2
3483_0,,,,2,3,2,5
C(C(C(C(O)=O)O)NC)(CCO)=O,,,3,1,3,0,3
3485_0,,,,2,3,2,5
C(C(C(C(C(C)=O)NC)O)O)(O)=O,,,3,1,2,0,2
3487_0,,,,2,3,2,5
C(C(CC(C(CO)O)O)N)(O)=O,,,3,1,34,0,34
3489_0,,,,2,3,2,5
C(CCO)(CC(C(O)=O)=O)=O,,,3,1,3,0,3
3491_0,,,,2,3,2,5
C(CO)(CCC(C(O)=O)=O)=O,,,3,1,3,0,3
3493_0,,,,2,3,2,5
C(C)(C(CC(C(O)=O)=O)O)=O,,,3,1,3,0,3
3495_0,,,,2,3,2,5
C(CC(CC(C(O)=O)=O)O)=O,,,3,1,3,0,3
3497_0,,,,2,3,2,5
C(CC(CC(C=O)=O)O)(O)=O,,,3,1,2,0,2
3499_0,,,,2,3,2,5
C(CC(C(CCO)=O)=O)(O)=O,,,3,1,3,0,3
3501_0,,,,2,3,2,5
C(CC(CC(CO)=O)=O)(O)=O,,,3,1,3,0,3
3503_0,,,,2,3,2,5
C(CC(C(C(C)=O)O)=O)(O)=O,,,3,1,3,0,3
3505_0,,,,2,3,2,5
C(CC(C(CC=O)O)=O)(O)=O,,,3,1,3,0,3
3507_0,,,,2,3,2,5
C(CC(C(CC(O)=O)O)=O)=O,,,3,1,2,0,2
3509_0,,,,2,3,2,5
C(C(C(O)=O)O)(CC(C)=O)=O,,,3,1,3,0,3
3511_0,,,,2,3,2,5
C(C(C(CCC=O)=O)O)(O)=O,,,3,1,3,0,3
3513_0,,,,2,3,2,5
C(C(C(CCC(O)=O)=O)O)=O,,,3,1,2,0,2
3515_0,,,,2,3,2,5
C(C(CC(C(C)=O)=O)O)(O)=O,,,3,1,3,0,3
3517_0,,,,2,3,2,5
C(CC(CC(C(O)=O)O)=O)=O,,,3,1,3,0,3
3519_0,,,,2,3,2,5
C(CC(CC(C=O)O)=O)(O)=O,,,3,1,2,0,2
3521_0,,,,2,3,2,5
C(CC1C(C(C(O)O1)O)O)(O)=O,,,3,1,2,0,2
3523_0,,,,2,3,2,5
C(CC(C(C(CN)O)O)O)(O)=O,,,3,1,13,0,13
3525_0,,,,2,3,2,5
C(C(CO)O)=CC(C(O)=O)=O,,,3,1,2,0,2
3527_0,,,,2,3,2,5
C(C(C(C=CCO)=O)O)(O)=O,,,3,1,2,0,2
3529_0,,,,2,3,2,5
C(C=CC(C(CO)O)=O)(O)=O,,,3,1,2,0,2
3531_0,,,,2,3,2,5
C(C(C(C(C=C)=O)O)O)(O)=O,,,3,1,2,0,2
3533_0,,,,2,3,2,5
C(C(C=CC(CO)=O)O)(O)=O,,,3,1,2,0,2
3535_0,,,,2,3,2,5
C(C(C(C=CC=O)O)O)(O)=O,,,3,1,2,0,2
3537_0,,,,2,3,2,5
C(C(C(C=CC(O)=O)O)O)=O,,,3,1,2,0,2
3539_0,,,,2,3,2,5
C(C(C(CO)NC)O)(O)=O,,,3,1,2,0,2
3541_0,,,,2,3,2,5
C(C(CC(C(CO)O)NC)=O)(O)=O,,,3,1,2,0,2
3543_0,,,,2,3,2,5
C(CC(C(C(CO)NC)O)=O)(O)=O,,,3,1,2,0,2
3545_0,,,,2,3,2,5
C(C(C(CC(CO)NC)=O)O)(O)=O,,,3,1,2,0,2
3547_0,,,,2,3,2,5
C(CC(C(O)=O)NC)(C(CO)O)=O,,,3,1,2,0,2
3549_0,,,,2,3,2,5
C(CC(C(O)=O)O)(C(CNC)O)=O,,,3,1,2,0,2
3551_0,,,,2,3,2,5
C(C(C(C(CCO)=O)O)NC)(O)=O,,,3,1,2,0,2
3553_0,,,,2,3,2,5
C(C(C(C(O)=O)O)O)(CCNC)=O,,,3,1,2,0,2
3555_0,,,,2,3,2,5
C(C(C(CC(CO)=O)NC)O)(O)=O,,,3,1,2,0,2
3557_0,,,,2,3,2,5
C(C(C(C(C(C)=O)O)NC)O)(O)=O,,,3,1,2,0,2
3559_0,,,,2,3,2,5
C(CC(C(C(C(O)=O)O)NC)O)=O,,,3,1,2,0,2
3561_0,,,,2,3,2,5
C(CC(C(C(C=O)O)NC)O)(O)=O,,,3,1,2,0,2
3563_0,,,,2,3,2,5
C(CC(C(C(C(O)=O)O)O)NC)=O,,,3,1,2,0,2
3565_0,,,,2,3,2,5
C(CC(C(C(C=O)O)O)NC)(O)=O,,,3,1,2,0,2
3567_0,,,,2,3,2,5
C(C(C(CO)NCC(O)=O)O)(O)=O,,,3,1,2,0,2
3569_0,,,,2,3,2,5
C(C1(CC(C(CO)O1)O)O)(O)=O,,,3,1,2,0,2
3571_0,,,,2,3,2,5
C(CC1(C(C(CO1)O)O)O)(O)=O,,,3,1,2,0,2
3573_0,,,,2,3,2,5
C(C(C1(CC(CO1)O)O)O)(O)=O,,,3,1,2,0,2
3575_0,,,,2,3,2,5
C(C1C(CC(CO)(O1)O)O)(O)=O,,,3,1,2,0,2
3577_0,,,,2,3,2,5
C(C1C(C(C(C)(O1)O)O)O)(O)=O,,,3,1,2,0,2
3579_0,,,,2,3,2,5
C(C(C1C(CC(O)O1)O)O)(O)=O,,,3,1,2,0,2
3581_0,,,,2,3,2,5
C(C1(CC(C(CO1)O)O)O)(O)=O,,,3,1,2,0,2
3583_0,,,,2,3,2,5
C(C1C(C(CC(O1)O)O)O)(O)=O,,,3,1,2,0,2
3585_0,,,,2,3,2,5
C(CC(C(C(CO)O)O)N)(O)=O,,,3,1,13,0,13
3587_0,,,,2,3,2,5
C(C(C(CC(CO)O)N)O)(O)=O,,,3,1,13,0,13
3589_0,,,,2,3,2,5
C(C(CC(C(CO)O)N)O)(O)=O,,,3,1,13,0,13
3591_0,,,,2,3,2,5
C(C(C(C(CCO)N)O)O)(O)=O,,,3,1,13,0,13
3593_0,,,,2,3,2,5
C(C(C(CC(CO)N)O)O)(O)=O,,,3,1,13,0,13
3595_0,,,,2,3,2,5
C(C(C(C(C(C)N)O)O)O)(O)=O,,,3,1,13,0,13
3597_0,,,,2,3,2,5
C(C(C(C(CCN)O)O)O)(O)=O,,,3,1,13,0,13
3598_0,,,,2,1,1,2
3598_1,,,,2,1,1,2
3600_0,,,,2,1,1,2
C1(C(C(C(C1(CO)CO)O)O)O)=O,,,3,1,2,0,2
3601_0,,,,2,1,1,2
3601_1,,,,2,1,1,2
3603_0,,,,2,1,1,2
C(C1(C(C(CO)C(C1O)O)O)O)=O,,,3,1,2,0,2
3603_1,,,,2,1,1,2
3605_0,,,,2,1,1,2
C(C1(CO)C(C(C(C1O)O)O)O)=O,,,3,1,2,0,2
3607_0,,,,2,1,1,2
C1(C(CC(C1(CO)O)O)O)=O,,,3,1,2,0,2
3607_1,,,,2,1,1,2
3608_0,,,,2,1,1,2
3608_1,,,,2,1,1,2
3610_0,,,,2,1,1,2
C1(C(CC(C1(CO)O)O)NC)=O,,,3,1,2,0,2
3610_1,,,,2,1,1,2
3612_0,,,,2,1,1,2
C(C1(C(C(CC1O)NC)O)O)=O,,,3,1,4,0,4
3612_1,,,,2,1,1,2
3613_0,,,,2,1,1,2
3613_1,,,,2,1,1,2
3614_0,,,,2,1,1,2
3616_0,,,,2,1,1,2
C1(CC(CO)(C(C1(CO)O)O)O)=O,,,3,1,2,0,2
3616_1,,,,2,1,1,2
3618_0,,,,2,1,1,2
C1(CC(C(C1(CO)NC)O)O)=O,,,3,1,2,0,2
3618_1,,,,2,1,1,2
3620_0,,,,2,1,1,2
C(C1(C(CCC1O)=O)O)=O,,,3,1,3,0,3
3620_1,,,,2,1,1,2
3622_0,,,,2,1,1,2
C1C(C(C(C=1)=O)(CO)O)O,,,3,1,3,0,3
3622_1,,,,2,1,1,2
3624_0,,,,2,1,1,2
C(C1(C(C=CC1O)O)O)=O,,,3,1,3,0,3
3624_1,,,,2,1,1,2
3626_0,,,,2,1,1,2
C1(CC(C(C1(CO)O)O)NC)=O,,,3,1,3,0,3
3626_1,,,,2,1,1,2
3628_0,,,,2,1,1,2
C1(CC(C(C1(CNC)O)O)O)=O,,,3,1,2,0,2
3628_1,,,,2,1,1,2
3630_0,,,,2,1,1,2
C(C1(C(CC(C1NC)O)O)O)=O,,,3,1,2,0,2
3630_1,,,,2,1,1,2
3631_0,,,,2,1,1,2
3631_1,,,,2,1,1,2
3633_0,,,,2,2,1,3
C(C(CO)(C(C(C(O)=O)O)O)O)=O,,,3,1,2,0,2
3633_1,,,,2,2,1,3
3635_0,,,,2,2,1,3
C(C(C=O)(C(C(CO)O)O)O)(O)=O,,,3,1,2,0,2
3635_1,,,,2,2,1,3
3637_0,,,,2,2,1,3
C(C(C=O)(C(CO)(CO)O)O)(O)=O,,,3,1,2,0,2
3637_1,,,,2,2,1,3
3639_0,,,,2,2,1,3
C(C(C=O)(C(C(C)=O)O)O)(O)=O,,,3,1,4,0,4
3639_1,,,,2,2,1,3
3641_0,,,,2,2,1,3
C(C(C=O)(C(C=O)(C)O)O)(O)=O,,,3,1,2,0,2
3641_1,,,,2,2,1,3
3643_0,,,,2,2,1,3
C(C(C=O)(C(C=O)O)O)(O)=O,,,3,1,4,0,4
3643_1,,,,2,2,1,3
3645_0,,,,2,2,1,3
C(C(C=O)(C(C(C(O)=O)O)O)O)=O,,,3,1,2,0,2
3645_1,,,,2,2,1,3
3647_0,,,,2,2,1,3
C(C(C=O)(C(C(C=O)O)O)O)(O)=O,,,3,1,2,0,2
3647_1,,,,2,2,1,3
3649_0,,,,2,2,1,3
C(C(C=O)(C(CO)(C)O)O)(O)=O,,,3,1,2,0,2
3649_1,,,,2,2,1,3
3651_0,,,,2,2,1,3
C(C(C=O)(C(C)O)O)(O)=O,,,3,1,2,0,2
3651_1,,,,2,2,1,3
3653_0,,,,2,2,1,3
C(C(C=O)(C(CNC)O)O)(O)=O,,,3,1,2,0,2
3653_1,,,,2,2,1,3
3655_0,,,,2,2,1,3
C(C(C(C=O)(C(C=O)O)O)O)(O)=O,,,3,1,4,0,4
3655_1,,,,2,2,1,3
3657_0,,,,2,2,1,3
C(C(C(C=O)O)(C(C=O)O)O)(O)=O,,,3,1,2,0,2
3657_1,,,,2,2,1,3
3659_0,,,,2,2,1,3
C(C(C(C)O)(C(C(O)=O)O)O)=O,,,3,1,2,0,2
3659_1,,,,2,2,1,3
3661_0,,,,2,2,1,3
C(C(C(C)O)(C(C=O)O)O)(O)=O,,,3,1,2,0,2
3661_1,,,,2,2,1,3
3663_0,,,,2,2,1,3
C(C(CO)(C(C(CO)O)O)O)=O,,,3,1,2,0,2
3663_1,,,,2,2,1,3
3665_0,,,,2,2,1,3
C(C(CO)(C(CO)(CO)O)O)=O,,,3,1,2,0,2
3665_1,,,,2,2,1,3
3666_0,,,,2,2,1,3
3666_1,,,,2,2,1,3
3668_0,,,,2,2,1,3
C(C(CO)(C(C=O)(C)O)O)=O,,,3,1,2,0,2
3668_1,,,,2,2,1,3
3669_0,,,,2,2,1,3
3669_1,,,,2,2,1,3
3671_0,,,,2,2,1,3
C(C(CO)(C(CO)(CC=O)O)O)=O,,,3,1,2,0,2
3671_1,,,,2,2,1,3
3673_0,,,,2,2,1,3
C(C(C(C)=O)(C(C(CO)O)O)O)=O,,,3,1,2,0,2
3673_1,,,,2,2,1,3
3674_0,,,,2,2,1,3
3674_1,,,,2,2,1,3
3676_0,,,,2,2,1,3
C(C(CO)(C(C)(C(C=O)O)O)O)=O,,,3,1,2,0,2
3676_1,,,,2,2,1,3
3677_0,,,,2,2,1,3
3677_1,,,,2,2,1,3
3678_0,,,,2,2,1,3
3678_1,,,,2,2,1,3
3680_0,,,,2,2,1,3
C(C(CO)(C(C)(C(CO)O)O)O)=O,,,3,1,2,0,2
3680_1,,,,2,2,1,3
3681_0,,,,2,2,1,3
3681_1,,,,2,2,1,3
3683_0,,,,2,2,1,3
C(C(CCO)(C(C=O)(CO)O)O)=O,,,3,1,2,0,2
3683_1,,,,2,2,1,3
3685_0,,,,2,2,1,3
C(C(CO)(C(CO)(CCO)O)O)=O,,,3,1,2,0,2
3685_1,,,,2,2,1,3
3687_0,,,,2,2,1,3
C(C(C=O)(C(C(CO)O)O)O)=O,,,3,1,2,0,2
3687_1,,,,2,2,1,3
3689_0,,,,2,2,1,3
C(C(CO)(C(C(C=O)O)O)O)=O,,,3,1,2,0,2
3689_1,,,,2,2,1,3
3691_0,,,,2,2,1,3
C(C(CO)(C(CO)(C)O)O)=O,,,3,1,2,0,2
3691_1,,,,2,2,1,3
3692_0,,,,2,2,1,3
3692_1,,,,2,2,1,3
3693_0,,,,2,2,1,3
3693_1,,,,2,2,1,3
3695_0,,,,2,2,1,3
C(C(CO)(C(C)O)O)=O,,,3,1,2,0,2
3695_1,,,,2,2,1,3
3697_0,,,,2,2,1,3
C(C(CO)(C(CNC)O)O)=O,,,3,1,2,0,2
3697_1,,,,2,2,1,3
3699_0,,,,2,2,1,3
C(C(CO)(C(C(CO)O)O)N)(O)=O,,,3,1,2,0,2
3699_1,,,,2,2,1,3
3701_0,,,,2,2,1,3
C(C(C(C)=O)(C(CO)(CO)O)O)=O,,,3,1,2,0,2
3701_1,,,,2,2,1,3
3703_0,,,,2,2,1,3
C(C)(C(CO)(C(CO)(CO)O)O)=O,,,3,1,2,0,2
3703_1,,,,2,2,1,3
3705_0,,,,2,2,1,3
C(C(C=O)(C(CO)(CO)O)O)=O,,,3,1,2,0,2
3705_1,,,,2,2,1,3
3707_0,,,,2,2,1,3
C(C(CO)(C(CO)(CO)O)N)(O)=O,,,3,1,2,0,2
3707_1,,,,2,2,1,3
3709_0,,,,2,2,1,3
C(C(C(C)=O)(C(C(C)=O)O)O)=O,,,3,1,2,0,2
3709_1,,,,2,2,1,3
3711_0,,,,2,2,1,3
C(C(C)(C(C=O)(C(C)=O)O)O)=O,,,3,1,2,0,2
3711_1,,,,2,2,1,3
3713_0,,,,2,2,1,3
C(C)(C(CO)(C(C(C)=O)O)O)=O,,,3,1,2,0,2
3713_1,,,,2,2,1,3
3715_0,,,,2,2,1,3
C(C(C)(C(C(C)=O)(CO)O)O)=O,,,3,1,2,0,2
3715_1,,,,2,2,1,3
3717_0,,,,2,2,1,3
C(C(C=O)(C(C(C)=O)O)O)=O,,,3,1,2,0,2
3717_1,,,,2,2,1,3
3719_0,,,,2,2,1,3
C(C(C=O)(C(C=O)(C)O)O)=O,,,3,1,2,0,2
3719_1,,,,2,2,1,3
3721_0,,,,2,2,1,3
C(C(C(C=O)(C(C(C)=O)O)O)O)=O,,,3,1,4,0,4
3721_1,,,,2,2,1,3
3723_0,,,,2,2,1,3
C(C(C(C=O)(C(C=O)(C)O)O)O)=O,,,3,1,2,0,2
3723_1,,,,2,2,1,3
3725_0,,,,2,2,1,3
C(CO)(C(CO)(C(C(C)=O)O)O)=O,,,3,1,4,0,4
3725_1,,,,2,2,1,3
3727_0,,,,2,2,1,3
C(C(C)(C(C(CO)=O)(CO)O)O)=O,,,3,1,2,0,2
3727_1,,,,2,2,1,3
3729_0,,,,2,2,1,3
C(C(C(O)=O)(C(C(C)=O)O)N)(O)=O,,,3,1,2,0,2
3729_1,,,,2,2,1,3
3731_0,,,,2,2,1,3
C(C(C(O)=O)(C(C=O)(C)O)N)(O)=O,,,3,1,2,0,2
3731_1,,,,2,2,1,3
3733_0,,,,2,2,1,3
C(C(CO)(C(C(C)=O)O)N)(O)=O,,,3,1,2,0,2
3733_1,,,,2,2,1,3
3735_0,,,,2,2,1,3
C(C(CO)(C(C=O)(C)O)N)(O)=O,,,3,1,2,0,2
3735_1,,,,2,2,1,3
3737_0,,,,2,2,1,3
C(C(C=O)(C(CC(CO)=O)O)O)=O,,,3,1,2,0,2
3737_1,,,,2,2,1,3
3739_0,,,,2,2,1,3
C(C(C=O)(C(CO)(CC=O)O)O)=O,,,3,1,2,0,2
3739_1,,,,2,2,1,3
3741_0,,,,2,2,1,3
C(C(C(C)=O)(C(C=O)O)O)=O,,,3,1,2,0,2
3741_1,,,,2,2,1,3
3743_0,,,,2,2,1,3
C(C(C=O)(C(C(C(C)=O)O)O)O)=O,,,3,1,2,0,2
3743_1,,,,2,2,1,3
3745_0,,,,2,2,1,3
C(C(C=O)(C(C)(C(C=O)O)O)O)=O,,,3,1,2,0,2
3745_1,,,,2,2,1,3
3747_0,,,,2,2,1,3
C(C(C(C(C=O)(C(C)=O)O)O)O)=O,,,3,1,2,0,2
3747_1,,,,2,2,1,3
3749_0,,,,2,2,1,3
C(C(C(C)=O)(C(CO)(C)O)O)=O,,,3,1,2,0,2
3749_1,,,,2,2,1,3
3751_0,,,,2,2,1,3
C(C(C(C)=O)(C(C)O)O)=O,,,3,1,2,0,2
3751_1,,,,2,2,1,3
3753_0,,,,2,2,1,3
C(C(C(C)=O)(C(CNC)O)O)=O,,,3,1,2,0,2
3753_1,,,,2,2,1,3
3754_0,,,,2,2,1,3
3754_1,,,,2,2,1,3
3755_0,,,,2,2,1,3
3755_1,,,,2,2,1,3
3757_0,,,,2,2,1,3
C(C(C(C(C)=O)(C(C=O)O)O)O)=O,,,3,1,2,0,2
3757_1,,,,2,2,1,3
3759_0,,,,2,2,1,3
C(C(C=O)(C(C=O)O)O)=O,,,3,1,2,0,2
3759_1,,,,2,2,1,3
3761_0,,,,2,2,1,3
C(C(C(C=O)(C(C=O)O)O)O)=O,,,3,1,2,0,2
3761_1,,,,2,2,1,3
3763_0,,,,2,2,1,3
C(CO)(C(CO)(C(C=O)O)O)=O,,,3,1,2,0,2
3763_1,,,,2,2,1,3
3765_0,,,,2,2,1,3
C(CNC)(C(CO)(C(C=O)O)O)=O,,,3,1,2,0,2
3765_1,,,,2,2,1,3
3767_0,,,,2,2,1,3
C(C(C(CO)O)(C(C=O)O)O)(O)=O,,,3,1,4,0,4
3767_1,,,,2,2,1,3
3769_0,,,,2,2,1,3
C(C(C(CO)O)(C(C=O)O)N)(O)=O,,,3,1,2,0,2
3769_1,,,,2,2,1,3
3771_0,,,,2,2,1,3
C(C(C(O)=O)(C(C=O)O)N)(O)=O,,,3,1,2,0,2
3771_1,,,,2,2,1,3
3773_0,,,,2,2,1,3
C(C(CO)(C(C=O)O)N)(O)=O,,,3,1,2,0,2
3773_1,,,,2,2,1,3
3775_0,,,,2,2,1,3
C(C(C(CO)NC)(C(C=O)O)O)=O,,,3,1,2,0,2
3775_1,,,,2,2,1,3
3777_0,,,,2,2,1,3
C(C(C=O)(C(C)(C(CO)O)O)O)=O,,,3,1,2,0,2
3777_1,,,,2,2,1,3
3778_0,,,,2,2,1,3
3778_1,,,,2,2,1,3
3780_0,,,,2,2,1,3
C(C)(C(CO)(C(CO)(C)O)O)=O,,,3,1,2,0,2
3780_1,,,,2,2,1,3
3782_0,,,,2,2,1,3
C(C)(C(CO)(C(C)O)O)=O,,,3,1,2,0,2
3782_1,,,,2,2,1,3
3784_0,,,,2,2,1,3
C(C)(C(CO)(C(CNC)O)O)=O,,,3,1,2,0,2
3784_1,,,,2,2,1,3
3786_0,,,,2,2,1,3
C(C(C=O)(C(C(CCO)=O)O)O)=O,,,3,1,2,0,2
3786_1,,,,2,2,1,3
3788_0,,,,2,2,1,3
C(C(C=O)(C(C=O)(CCO)O)O)=O,,,3,1,2,0,2
3788_1,,,,2,2,1,3
3790_0,,,,2,2,1,3
C(C(C=O)(C(CO)(CCO)O)O)=O,,,3,1,2,0,2
3790_1,,,,2,2,1,3
3792_0,,,,2,2,1,3
C(C(C(C)O)(C(C(C)=O)O)O)=O,,,3,1,2,0,2
3792_1,,,,2,2,1,3
3794_0,,,,2,2,1,3
C(C)(C(C(C)O)(C(C=O)O)O)=O,,,3,1,2,0,2
3794_1,,,,2,2,1,3
3796_0,,,,2,2,1,3
C(C(C=O)(C(C(C=O)O)O)O)=O,,,3,1,2,0,2
3796_1,,,,2,2,1,3
3798_0,,,,2,2,1,3
C(C(C=O)(C(CO)(C)O)O)=O,,,3,1,2,0,2
3798_1,,,,2,2,1,3
3800_0,,,,2,2,1,3
C(C(C=O)(C(C(CC=O)O)O)O)=O,,,3,1,2,0,2
3800_1,,,,2,2,1,3
3802_0,,,,2,2,1,3
C(C(C=O)(C(CC(C=O)O)O)O)=O,,,3,1,2,0,2
3802_1,,,,2,2,1,3
3804_0,,,,2,2,1,3
C(C(C=O)(C(C)O)O)=O,,,3,1,2,0,2
3804_1,,,,2,2,1,3
3806_0,,,,2,2,1,3
C(C(C=O)(C(CNC)O)O)=O,,,3,1,2,0,2
3806_1,,,,2,2,1,3
3808_0,,,,2,2,1,3
C(C(CO)(C(C(C=O)O)O)N)(O)=O,,,3,1,2,0,2
3808_1,,,,2,2,1,3
3810_0,,,,2,2,1,3
C(C(C(CO)(C)O)(C(C=O)O)O)=O,,,3,1,2,0,2
3810_1,,,,2,2,1,3
3812_0,,,,2,2,1,3
C(CO)(C(CO)(C(CO)(C)O)O)=O,,,3,1,2,0,2
3812_1,,,,2,2,1,3
3814_0,,,,2,2,1,3
C(C(C(O)=O)(C(C)(CO)O)N)(O)=O,,,3,1,2,0,2
3814_1,,,,2,2,1,3
3816_0,,,,2,2,1,3
C(C(CO)(C(C)(CO)O)N)(O)=O,,,3,1,2,0,2
3816_1,,,,2,2,1,3
3818_0,,,,2,2,1,3
C(C(C(C)O)(C(C=O)O)O)=O,,,3,1,2,0,2
3818_1,,,,2,2,1,3
3820_0,,,,2,2,1,3
C(C(C(CNC)O)(C(C=O)O)O)=O,,,3,1,2,0,2
3820_1,,,,2,2,1,3
3822_0,,,,2,2,1,3
C(CO)(C(CO)(C(C)O)O)=O,,,3,1,2,0,2
3822_1,,,,2,2,1,3
3824_0,,,,2,2,1,3
C(CNC)(C(CO)(C(C)O)O)=O,,,3,1,2,0,2
3824_1,,,,2,2,1,3
3826_0,,,,2,2,1,3
C(C(C(CO)O)(C(C)O)O)(O)=O,,,3,1,2,0,2
3826_1,,,,2,2,1,3
3828_0,,,,2,2,1,3
C(C(C(CO)O)(C(C)O)N)(O)=O,,,3,1,2,0,2
3828_1,,,,2,2,1,3
3830_0,,,,2,2,1,3
C(C(C(O)=O)(C(C)O)N)(O)=O,,,3,1,2,0,2
3830_1,,,,2,2,1,3
3832_0,,,,2,2,1,3
C(C(C(C)O)(C(C(O)=O)O)N)(O)=O,,,3,1,2,0,2
3832_1,,,,2,2,1,3
3834_0,,,,2,2,1,3
C(C(C(C)O)(C(C(O)=O)N)O)(O)=O,,,3,1,2,0,2
3834_1,,,,2,2,1,3
3836_0,,,,2,2,1,3
C(C(CO)(C(C)O)N)(O)=O,,,3,1,2,0,2
3836_1,,,,2,2,1,3
3838_0,,,,2,2,1,3
C(CC=O)(C(C(C)=O)(C(C)O)O)=O,,,3,1,2,0,2
3838_1,,,,2,2,1,3
3840_0,,,,2,2,1,3
C(C(C(CC(C)=O)=O)(C(C)O)O)=O,,,3,1,2,0,2
3840_1,,,,2,2,1,3
3842_0,,,,2,2,1,3
C(C(C(CCC=O)=O)(C(C)O)O)=O,,,3,1,2,0,2
3842_1,,,,2,2,1,3
3844_0,,,,2,2,1,3
C(C(C(C=CCO)=O)(C(C)O)O)=O,,,3,1,2,0,2
3844_1,,,,2,2,1,3
3846_0,,,,2,2,1,3
C(C=CC(C(CO)(C(C)O)O)=O)=O,,,3,1,2,0,2
3846_1,,,,2,2,1,3
3848_0,,,,2,2,1,3
C(C(C(C)O)(C(C(C=C)=O)O)O)=O,,,3,1,2,0,2
3848_1,,,,2,2,1,3
3850_0,,,,2,2,1,3
C(C(C(C(C=C)=O)(C(C)O)O)O)=O,,,3,1,2,0,2
3850_1,,,,2,2,1,3
3852_0,,,,2,2,1,3
C(C(C(C)O)(C(C=CC=O)O)O)=O,,,3,1,2,0,2
3852_1,,,,2,2,1,3
3854_0,,,,2,2,1,3
C(C(C(C)O)(C(CO)NC)O)=O,,,3,1,2,0,2
3854_1,,,,2,2,1,3
3856_0,,,,2,2,1,3
C(CO)(C(CO)(C(CNC)O)O)=O,,,3,1,2,0,2
3856_1,,,,2,2,1,3
3858_0,,,,2,2,1,3
C(C(C(O)=O)(C(CNC)O)N)(O)=O,,,3,1,2,0,2
3858_1,,,,2,2,1,3
3860_0,,,,2,2,1,3
C(C(CO)(C(CNC)O)N)(O)=O,,,3,1,2,0,2
3860_1,,,,2,2,1,3
3861_0,,,,2,2,1,3
3861_1,,,,2,2,1,3
3862_0,,,,2,2,1,3
3862_1,,,,2,2,1,3
3863_0,,,,2,2,1,3
3863_1,,,,2,2,1,3
3864_0,,,,2,2,1,3
3864_1,,,,2,2,1,3
3866_0,,,,2,2,1,3
C(C(C(C)=O)(C(CO)O)O)=O,,,3,1,3,0,3
3866_1,,,,2,2,1,3
3868_0,,,,2,2,1,3
C(C)(C(CO)(C(CO)O)O)=O,,,3,1,2,0,2
3868_1,,,,2,2,1,3
3870_0,,,,2,2,1,3
C(C(C(CO)O)(C(C(C)=O)O)O)=O,,,3,1,4,0,4
3870_1,,,,2,2,1,3
3872_0,,,,2,2,1,3
C(C)(C(C(CO)O)(C(C=O)O)O)=O,,,3,1,2,0,2
3872_1,,,,2,2,1,3
3874_0,,,,2,2,1,3
C(C(C=O)(C(CO)O)O)=O,,,3,1,2,0,2
3874_1,,,,2,2,1,3
3876_0,,,,2,2,1,3
C(C(C(CO)O)(C(C=O)O)O)=O,,,3,1,4,0,4
3876_1,,,,2,2,1,3
3878_0,,,,2,2,1,3
C(CO)(C(CO)(C(CO)O)O)=O,,,3,1,2,0,2
3878_1,,,,2,2,1,3
3880_0,,,,2,2,1,3
C(CNC)(C(CO)(C(CO)O)O)=O,,,3,1,2,0,2
3880_1,,,,2,2,1,3
3881_0,,,,2,2,1,3
3881_1,,,,2,2,1,3
3883_0,,,,2,2,1,3
C(C(C(CO)O)(C(CO)O)N)(O)=O,,,3,1,2,0,2
3883_1,,,,2,2,1,3
3885_0,,,,2,2,1,3
C(C(C(O)=O)(C(CO)O)N)(O)=O,,,3,1,4,0,4
3885_1,,,,2,2,1,3
3887_0,,,,2,2,1,3
C(C(CO)(C(CO)O)N)(O)=O,,,3,1,4,0,4
3887_1,,,,2,2,1,3
3889_0,,,,2,2,1,3
C(C(C(CO)O)(C(CO)NC)O)=O,,,3,1,2,0,2
3889_1,,,,2,2,1,3
3890_0,,,,2,2,1,3
3890_1,,,,2,2,1,3
3892_0,,,,2,2,1,3
C(C(C(CO)O)(C(C=O)(C)O)O)=O,,,3,1,2,0,2
3892_1,,,,2,2,1,3
3893_0,,,,2,2,1,3
3893_1,,,,2,2,1,3
3895_0,,,,2,2,1,3
C(C(C(CO)O)(C(CO)(C)O)O)=O,,,3,1,2,0,2
3895_1,,,,2,2,1,3
3897_0,,,,2,2,1,3
C(C(C(CO)O)(C(C)O)O)=O,,,3,1,2,0,2
3897_1,,,,2,2,1,3
3899_0,,,,2,2,1,3
C(C(C(CO)O)(C(CNC)O)O)=O,,,3,1,2,0,2
3899_1,,,,2,2,1,3
3901_0,,,,2,2,1,3
C(C(C(O)=O)(C=O)O)(O)=O,,,3,1,2,0,2
3901_1,,,,2,2,1,3
3903_0,,,,2,2,1,3
C(C(C=O)(C(C(O)=O)O)O)(O)=O,,,3,1,4,0,4
3903_1,,,,2,2,1,3
3905_0,,,,2,2,1,3
C(C(C(O)=O)(C(C=O)O)O)(O)=O,,,3,1,2,0,2
3905_1,,,,2,2,1,3
3907_0,,,,2,2,1,3
C(C(C=O)(CO)O)(O)=O,,,3,1,4,0,4
3907_1,,,,2,2,1,3
3909_0,,,,2,2,1,3
C(C(C=O)(C(C)=O)O)(O)=O,,,3,1,3,0,3
3909_1,,,,2,2,1,3
3911_0,,,,2,2,1,3
C(C(C(C)=O)(CO)O)(O)=O,,,3,1,2,0,2
3911_1,,,,2,2,1,3
3912_0,,,,2,2,1,3
3912_1,,,,2,2,1,3
3914_0,,,,2,2,1,3
C(C(C(C)=O)(C(C=O)O)O)(O)=O,,,3,1,2,0,2
3914_1,,,,2,2,1,3
3916_0,,,,2,2,1,3
C(C(C=O)(C=O)O)(O)=O,,,3,1,2,0,2
3916_1,,,,2,2,1,3
3917_0,,,,2,2,1,3
3917_1,,,,2,2,1,3
3919_0,,,,2,2,1,3
C(C(C(CO)=O)(CO)O)(O)=O,,,3,1,2,0,2
3919_1,,,,2,2,1,3
3921_0,,,,2,2,1,3
C(C(C(CNC)=O)(CO)O)(O)=O,,,3,1,2,0,2
3921_1,,,,2,2,1,3
3922_0,,,,2,2,1,3
3922_1,,,,2,2,1,3
3923_0,,,,2,2,1,3
3923_1,,,,2,2,1,3
3925_0,,,,2,2,1,3
C(C(C(O)=O)(C(O)=O)N)(O)=O,,,3,1,2,0,2
3925_1,,,,2,2,1,3
3927_0,,,,2,2,1,3
C(C(C(O)=O)(C(C(O)=O)O)N)(O)=O,,,3,1,4,0,4
3927_1,,,,2,2,1,3
3929_0,,,,2,2,1,3
C(C(C(O)=O)(C(C(O)=O)N)O)(O)=O,,,3,1,2,0,2
3929_1,,,,2,2,1,3
3931_0,,,,2,2,1,3
C(C(C(O)=O)(CO)N)(O)=O,,,3,1,4,0,4
3931_1,,,,2,2,1,3
3933_0,,,,2,2,1,3
C(C(C(CC=O)=O)(C(C)=O)O)(O)=O,,,3,1,2,0,2
3933_1,,,,2,2,1,3
3935_0,,,,2,2,1,3
C(C(C=O)(C(CC(C)=O)=O)O)(O)=O,,,3,1,2,0,2
3935_1,,,,2,2,1,3
3937_0,,,,2,2,1,3
C(C(C=O)(C(CCC=O)=O)O)(O)=O,,,3,1,2,0,2
3937_1,,,,2,2,1,3
3939_0,,,,2,2,1,3
C(C(C=O)(C(C=CCO)=O)O)(O)=O,,,3,1,2,0,2
3939_1,,,,2,2,1,3
3941_0,,,,2,2,1,3
C(C(C(C=CC=O)=O)(CO)O)(O)=O,,,3,1,2,0,2
3941_1,,,,2,2,1,3
3943_0,,,,2,2,1,3
C(C(C=O)(C(C(C=C)=O)O)O)(O)=O,,,3,1,2,0,2
3943_1,,,,2,2,1,3
3945_0,,,,2,2,1,3
C(C(C(C=C)=O)(C(C=O)O)O)(O)=O,,,3,1,2,0,2
3945_1,,,,2,2,1,3
3947_0,,,,2,2,1,3
C(C(C=O)(C(C=CC=O)O)O)(O)=O,,,3,1,2,0,2
3947_1,,,,2,2,1,3
3949_0,,,,2,2,1,3
C(C(C=O)(C(CO)NC)O)(O)=O,,,3,1,2,0,2
3949_1,,,,2,2,1,3
3950_0,,,,2,2,1,3
3950_1,,,,2,2,1,3
3952_0,,,,2,2,1,3
C(C(CO)(C(C(O)=O)O)O)=O,,,3,1,4,0,4
3952_1,,,,2,2,1,3
3954_0,,,,2,2,1,3
C(C(C(C)=O)(C(C(O)=O)O)O)=O,,,3,1,3,0,3
3954_1,,,,2,2,1,3
3956_0,,,,2,2,1,3
C(C)(C(CO)(C(C(O)=O)O)O)=O,,,3,1,2,0,2
3956_1,,,,2,2,1,3
3958_0,,,,2,2,1,3
C(C(C=O)(C(C(O)=O)O)O)=O,,,3,1,2,0,2
3958_1,,,,2,2,1,3
3959_0,,,,2,2,1,3
3959_1,,,,2,2,1,3
3961_0,,,,2,2,1,3
C(CO)(C(CO)(C(C(O)=O)O)O)=O,,,3,1,2,0,2
3961_1,,,,2,2,1,3
3962_0,,,,2,2,1,3
3962_1,,,,2,2,1,3
3964_0,,,,2,2,1,3
C(C(CO)(C(C(O)=O)O)N)(O)=O,,,3,1,4,0,4
3964_1,,,,2,2,1,3
3965_0,,,,2,2,1,3
3965_1,,,,2,2,1,3
3966_0,,,,2,2,1,3
3967_0,,,,2,2,1,3
3967_1,,,,2,2,1,3
3968_0,,,,2,2,1,3
3969_0,,,,2,2,1,3
3969_1,,,,2,2,1,3
3970_0,,,,2,2,1,3
3970_1,,,,2,2,1,3
3972_0,,,,2,2,1,3
C(C(CO)(C(C=O)O)O)(O)=O,,,3,1,2,0,2
3972_1,,,,2,2,1,3
3974_0,,,,2,2,1,3
C(C(CO)(CO)O)=O,,,3,1,2,0,2
3974_1,,,,2,2,1,3
3975_0,,,,2,2,1,3
3975_1,,,,2,2,1,3
3976_0,,,,2,2,1,3
3976_1,,,,2,2,1,3
3977_0,,,,2,2,1,3
3977_1,,,,2,2,1,3
3978_0,,,,2,2,1,3
3978_1,,,,2,2,1,3
3979_0,,,,2,2,1,3
3979_1,,,,2,2,1,3
3980_0,,,,2,2,1,3
3980_1,,,,2,2,1,3
3982_0,,,,2,2,1,3
C(CO)(C(CO)(CO)O)=O,,,3,1,2,0,2
3982_1,,,,2,2,1,3
3984_0,,,,2,2,1,3
C(CC(C(C(CO)(CO)O)=O)O)=O,,,3,1,2,0,2
3984_1,,,,2,2,1,3
3985_0,,,,2,2,1,3
3985_1,,,,2,2,1,3
3986_0,,,,2,2,1,3
3986_1,,,,2,2,1,3
3987_0,,,,2,2,1,3
3987_1,,,,2,2,1,3
3988_0,,,,2,2,1,3
3988_1,,,,2,2,1,3
3989_0,,,,2,2,1,3
3989_1,,,,2,2,1,3
3990_0,,,,2,2,1,3
3990_1,,,,2,2,1,3
3991_0,,,,2,2,1,3
3991_1,,,,2,2,1,3
3993_0,,,,2,2,1,3
C(C(CO)(C(C=O)O)O)(C(C)O)=O,,,3,1,2,0,2
3993_1,,,,2,2,1,3
3995_0,,,,2,2,1,3
C(CC(C(C(CO)=O)(CO)O)O)=O,,,3,1,2,0,2
3995_1,,,,2,2,1,3
3997_0,,,,2,2,1,3
C(CNC)(C(CO)(CO)O)=O,,,3,1,2,0,2
3997_1,,,,2,2,1,3
3998_0,,,,2,2,1,3
3998_1,,,,2,2,1,3
3999_0,,,,2,2,1,3
3999_1,,,,2,2,1,3
4000_0,,,,2,2,1,3
4000_1,,,,2,2,1,3
4001_0,,,,2,2,1,3
4001_1,,,,2,2,1,3
4002_0,,,,2,2,1,3
4002_1,,,,2,2,1,3
4003_0,,,,2,2,1,3
4003_1,,,,2,2,1,3
4004_0,,,,2,2,1,3
4004_1,,,,2,2,1,3
4005_0,,,,2,2,1,3
4005_1,,,,2,2,1,3
4007_0,,,,2,2,1,3
C(C(CO)(C(C(O)=O)N)O)(O)=O,,,3,1,2,0,2
4007_1,,,,2,2,1,3
4009_0,,,,2,2,1,3
C(C(CO)(CO)N)(O)=O,,,3,1,2,0,2
4009_1,,,,2,2,1,3
4011_0,,,,2,2,1,3
C(CC=O)(C(C(C)=O)(CO)O)=O,,,3,1,4,0,4
4011_1,,,,2,2,1,3
4013_0,,,,2,2,1,3
C(C(C(CC(C)=O)=O)(CO)O)=O,,,3,1,4,0,4
4013_1,,,,2,2,1,3
4015_0,,,,2,2,1,3
C(C(C(CCC=O)=O)(CO)O)=O,,,3,1,4,0,4
4015_1,,,,2,2,1,3
4017_0,,,,2,2,1,3
C1(C(CO)C(C(C(CO)O)O1)O)=O,,,3,1,1,0,1
4019_0,,,,2,2,1,3
C1(COC(C(CO)O)C1(CO)O)=O,,,3,1,2,0,2
4019_1,,,,2,2,1,3
4021_0,,,,2,2,1,3
C1(CC(OC1(CO)C(CO)O)O)=O,,,3,1,3,0,3
4021_1,,,,2,2,1,3
4023_0,,,,2,2,1,3
C(C)(C1(CO)C(C(C(O1)O)O)O)=O,,,3,1,3,0,3
4023_1,,,,2,2,1,3
4025_0,,,,2,2,1,3
C1(C(CO)C(C(C(CO)O1)O)O)=O,,,3,1,1,0,1
4027_0,,,,2,2,1,3
C1(COC(CO)C(C1(CO)O)O)=O,,,3,1,2,0,2
4027_1,,,,2,2,1,3
4029_0,,,,2,2,1,3
C1(CC(O)OC(CO)C1(CO)O)=O,,,3,1,3,0,3
4029_1,,,,2,2,1,3
4031_0,,,,2,2,1,3
C1(CC(CO)OC(C1(CO)O)O)=O,,,3,1,3,0,3
4031_1,,,,2,2,1,3
4033_0,,,,2,2,1,3
C1(CC(C(OC1(CO)CO)O)O)=O,,,3,1,3,0,3
4033_1,,,,2,2,1,3
4035_0,,,,2,2,1,3
C1(C(CO)C(C(C(CO1)O)O)O)=O,,,3,1,1,0,1
4037_0,,,,2,2,1,3
C1(COCC(C(C1(CO)O)O)O)=O,,,3,1,2,0,2
4037_1,,,,2,2,1,3
4039_0,,,,2,2,1,3
C1(CC(O)OCC(C1(CO)O)O)=O,,,3,1,3,0,3
4039_1,,,,2,2,1,3
4041_0,,,,2,2,1,3
C1(CC(COC(C1(CO)O)O)O)=O,,,3,1,3,0,3
4041_1,,,,2,2,1,3
4043_0,,,,2,2,1,3
C1(CC(C(O)OCC1(CO)O)O)=O,,,3,1,3,0,3
4043_1,,,,2,2,1,3
4045_0,,,,2,2,1,3
C1(CCOC(C(C1(CO)O)O)O)=O,,,3,1,3,0,3
4045_1,,,,2,2,1,3
4047_0,,,,2,2,1,3
C(CCN)(C(CO)(C(CO)O)O)=O,,,3,1,14,0,14
4047_1,,,,2,2,1,3
4049_0,,,,2,2,1,3
C(CC(CO)O)(C(CO)(CN)O)=O,,,3,1,14,0,14
4049_1,,,,2,2,1,3
4051_0,,,,2,2,1,3
C(CC(CN)O)(C(CO)(CO)O)=O,,,3,1,14,0,14
4051_1,,,,2,2,1,3
4053_0,,,,2,2,1,3
C(CCO)(C(CO)(C(CN)O)O)=O,,,3,1,14,0,14
4053_1,,,,2,2,1,3
4055_0,,,,2,2,1,3
C(C)(C(CO)(C(C(CN)O)O)O)=O,,,3,1,14,0,14
4055_1,,,,2,2,1,3
4057_0,,,,2,2,1,3
C(C(C(C=CCO)=O)(CO)O)=O,,,3,1,3,0,3
4057_1,,,,2,2,1,3
4059_0,,,,2,2,1,3
C(C=CC(C(CO)(CO)O)=O)=O,,,3,1,3,0,3
4059_1,,,,2,2,1,3
4061_0,,,,2,2,1,3
C(C(CO)(C(C(C=C)=O)O)O)=O,,,3,1,3,0,3
4061_1,,,,2,2,1,3
4063_0,,,,2,2,1,3
C(C(C(C(C=C)=O)(CO)O)O)=O,,,3,1,3,0,3
4063_1,,,,2,2,1,3
4065_0,,,,2,2,1,3
C(C(CO)(C(C=CC=O)O)O)=O,,,3,1,3,0,3
4065_1,,,,2,2,1,3
4067_0,,,,2,2,1,3
C(C(CO)(C(CO)NC)O)=O,,,3,1,2,0,2
4067_1,,,,2,2,1,3
4069_0,,,,2,2,1,3
C(C(CO)(C1(CC(CO1)O)O)O)=O,,,3,1,3,0,3
4069_1,,,,2,2,1,3
4071_0,,,,2,2,1,3
C(C1(CO)C(CC(CO)(O1)O)O)=O,,,3,1,3,0,3
4071_1,,,,2,2,1,3
4073_0,,,,2,2,1,3
C(C1(CO)C(C(C(C)(O1)O)O)O)=O,,,3,1,3,0,3
4073_1,,,,2,2,1,3
4075_0,,,,2,2,1,3
C(C(CO)(C1C(CC(O)O1)O)O)=O,,,3,1,3,0,3
4075_1,,,,2,2,1,3
4077_0,,,,2,2,1,3
C(C1(CO)C(C(CC(O1)O)O)O)=O,,,3,1,3,0,3
4077_1,,,,2,2,1,3
4079_0,,,,2,2,1,3
C(C(CO)(C(CC(CO)O)N)O)=O,,,3,1,14,0,14
4079_1,,,,2,2,1,3
4081_0,,,,2,2,1,3
C(C(CO)(C(C(CCO)N)O)O)=O,,,3,1,14,0,14
4081_1,,,,2,2,1,3
4083_0,,,,2,2,1,3
C(C(CO)(C(CC(CO)N)O)O)=O,,,3,1,14,0,14
4083_1,,,,2,2,1,3
4085_0,,,,2,2,1,3
C(C(CO)(C(C(C(C)N)O)O)O)=O,,,3,1,14,0,14
4085_1,,,,2,2,1,3
4087_0,,,,2,2,1,3
C(C(CO)(C(C(CCN)O)O)O)=O,,,3,1,14,0,14
4087_1,,,,2,2,1,3
4089_0,,,,2,1,1,2
C(C1(C(C(C(C1)O)O)O)O)=O,,,3,1,1,0,1
4091_0,,,,2,1,1,2
C1(C(C(C(C1(C)O)O)O)O)=O,,,3,1,1,0,1
4093_0,,,,2,1,1,2
C(C1(CC(C(C1O)O)O)NC)=O,,,3,1,1,0,1
4095_0,,,,2,1,1,2
C1(C(C(C(C1(C)NC)O)O)O)=O,,,3,1,1,0,1
4097_0,,,,2,1,1,2
C(C1(C(CC(C1)=O)O)O)=O,,,3,1,2,0,2
4099_0,,,,2,1,1,2
C(C1C(C(C(CO)N1)O)O)(O)=O,,,3,1,1,0,1
4101_0,,,,2,2,1,3
C(C(C(C(C(O)=O)O)O)O)(O)=O,,,3,1,1,0,1
4103_0,,,,2,2,1,3
C(C(C(C(CO)O)O)(CC=O)O)=O,,,3,1,1,0,1
4105_0,,,,2,2,1,3
C(C(C(C(CO)O)O)O)(O)=O,,,3,1,1,0,1
4107_0,,,,2,2,1,3
C(C(C(CO)(CO)O)(CC=O)O)=O,,,3,1,1,0,1
4109_0,,,,2,2,1,3
C(C(C(CO)(CO)O)O)(O)=O,,,3,1,1,0,1
4111_0,,,,2,2,1,3
C(CC(C=O)(C(C(C)=O)O)O)=O,,,3,1,1,0,1
4113_0,,,,2,2,1,3
C(CC(C=O)(C(C=O)(C)O)O)=O,,,3,1,1,0,1
4115_0,,,,2,2,1,3
C(C(C(C(C)=O)O)NCC=O)(O)=O,,,3,1,1,0,1
4117_0,,,,2,2,1,3
C(CNC(C(O)=O)C(C=O)(C)O)=O,,,3,1,1,0,1
4118_0,,,,2,2,1,3
4120_0,,,,2,2,1,3
C(C(C)(C(C(O)=O)O)O)=O,,,3,1,1,0,1
4121_0,,,,2,2,1,3
4123_0,,,,2,2,1,3
C(CC(CO)(C(C(O)=O)O)O)=O,,,3,1,1,0,1
4124_0,,,,2,2,1,3
4126_0,,,,2,2,1,3
C(C(C(C)(C(C=O)O)O)O)(O)=O,,,3,1,1,0,1
4128_0,,,,2,2,1,3
C(C(C(C=O)(CC(CO)=O)O)O)=O,,,3,1,1,0,1
4130_0,,,,2,2,1,3
C(CC(C=O)(C(C=O)O)O)=O,,,3,1,1,0,1
4132_0,,,,2,2,1,3
C(C(C(C=O)O)NCC=O)(O)=O,,,3,1,1,0,1
4133_0,,,,2,2,1,3
4135_0,,,,2,2,1,3
C(C(C(C)(C(CO)O)O)O)(O)=O,,,3,1,1,0,1
4137_0,,,,2,2,1,3
C(C(C(C)O)(CC(CO)=O)O)=O,,,3,1,1,0,1
4138_0,,,,2,2,1,3
4140_0,,,,2,2,1,3
C(C(CCO)(C(C(O)=O)O)O)=O,,,3,1,1,0,1
4142_0,,,,2,2,1,3
C(C(C(CO)(CCO)O)O)(O)=O,,,3,1,1,0,1
4144_0,,,,2,2,1,3
C(C(C(C(C=O)(CC=O)O)O)O)=O,,,3,1,1,0,1
4145_0,,,,2,2,1,3
4147_0,,,,2,2,1,3
C(C(C(CO)(C)O)(CC=O)O)=O,,,3,1,1,0,1
4149_0,,,,2,2,1,3
C(C(C(C)(CO)O)NCC=O)(O)=O,,,3,1,1,0,1
4151_0,,,,2,2,1,3
C(C(C(CO)(C)O)O)(O)=O,,,3,1,1,0,1
4153_0,,,,2,2,1,3
C(C(C(C)O)(CC=O)O)=O,,,3,1,1,0,1
4155_0,,,,2,2,1,3
C(C(C(CNC)O)(CC=O)O)=O,,,3,1,1,0,1
4156_0,,,,2,2,1,3
4157_0,,,,2,2,1,3
4158_0,,,,2,2,1,3
4160_0,,,,2,2,1,3
C(C(C(C)O)NCC=O)(O)=O,,,3,1,1,0,1
4162_0,,,,2,2,1,3
C(C(C(C)O)O)(O)=O,,,3,1,1,0,1
4164_0,,,,2,2,1,3
C(C)(C(C(C)O)(CC(C=O)=O)O)=O,,,3,1,1,0,1
4166_0,,,,2,2,1,3
C(C(C(C)O)(CC=O)O)(CC=O)=O,,,3,1,1,0,1
4168_0,,,,2,2,1,3
C(C(C(C)O)(CC(C(C)=O)=O)O)=O,,,3,1,1,0,1
4170_0,,,,2,2,1,3
C(C(C(C)O)(CC(CC=O)=O)O)=O,,,3,1,1,0,1
4172_0,,,,2,2,1,3
C(C(C=CC(CO)=O)(C(C)O)O)=O,,,3,1,1,0,1
4173_0,,,,2,2,1,3
4175_0,,,,2,2,1,3
C(C(C(CNC)O)NCC=O)(O)=O,,,3,1,1,0,1
4177_0,,,,2,2,1,3
C(C(C(CNC)O)O)(O)=O,,,3,1,1,0,1
4179_0,,,,2,2,1,3
C(C(C(CNCC(O)=O)O)O)(O)=O,,,3,1,1,0,1
4181_0,,,,2,2,1,3
C(C(C(C(C(O)=O)O)O)N)(O)=O,,,3,1,1,0,1
4183_0,,,,2,2,1,3
C(C(C(C(CO)O)O)N)(O)=O,,,3,1,2,0,2
4185_0,,,,2,2,1,3
C(C(C(CO)(CO)O)N)(O)=O,,,3,1,1,0,1
4187_0,,,,2,2,1,3
C(C(C(C(C)=O)O)N)(O)=O,,,3,1,1,0,1
4189_0,,,,2,2,1,3
C(C(C)(C(C(O)=O)N)O)=O,,,3,1,1,0,1
4191_0,,,,2,2,1,3
C(C(C(CC(CO)=O)O)N)(O)=O,,,3,1,2,0,2
4193_0,,,,2,2,1,3
C(CC(CO)(C(C(O)=O)N)O)=O,,,3,1,1,0,1
4195_0,,,,2,2,1,3
C(C(C(C(C(C)=O)O)O)N)(O)=O,,,3,1,2,0,2
4197_0,,,,2,2,1,3
C(C(C(C)(C(C=O)O)O)N)(O)=O,,,3,1,1,0,1
4199_0,,,,2,2,1,3
C(C(C(C=O)O)N)(O)=O,,,3,1,2,0,2
4201_0,,,,2,2,1,3
C(C(C(C)(C(CO)O)O)N)(O)=O,,,3,1,1,0,1
4203_0,,,,2,2,1,3
C(C(C(C(CCO)=O)O)N)(O)=O,,,3,1,3,0,3
4205_0,,,,2,2,1,3
C(C(CCO)(C(C(O)=O)N)O)=O,,,3,1,1,0,1
4207_0,,,,2,2,1,3
C(C(C(CO)(CCO)O)N)(O)=O,,,3,1,1,0,1
4209_0,,,,2,2,1,3
C(C(C(C(C=O)O)O)N)(O)=O,,,3,1,1,0,1
4211_0,,,,2,2,1,3
C(C(C(C)(CO)O)N)(O)=O,,,3,1,1,0,1
4213_0,,,,2,2,1,3
C(CC(C(C(C(O)=O)N)O)O)=O,,,3,1,2,0,2
4215_0,,,,2,2,1,3
C(C(C(CC(C=O)O)O)N)(O)=O,,,3,1,1,0,1
4217_0,,,,2,2,1,3
C(C(C(C(C(C=O)O)O)O)N)(O)=O,,,3,1,1,0,1
4219_0,,,,2,2,1,3
C(C(C(C)O)N)(O)=O,,,3,1,1,0,1
4221_0,,,,2,2,1,3
C(C(C(CO)(C(CO)O)O)N)(O)=O,,,3,1,1,0,1
4223_0,,,,2,2,1,3
C(C(C(CNC)O)N)(O)=O,,,3,1,1,0,1
4225_0,,,,2,2,1,3
C(C(C(CNCC(O)=O)O)N)(O)=O,,,3,1,1,0,1
4227_0,,,,2,2,1,3
C(C(C(CO)O)(CC(CO)=O)O)=O,,,3,1,1,0,1
4229_0,,,,2,2,1,3
C(C(C(CO)O)(CC=O)O)=O,,,3,1,2,0,2
4230_0,,,,2,2,1,3
4231_0,,,,2,2,1,3
4232_0,,,,2,2,1,3
4234_0,,,,2,2,1,3
C(C(C=O)(CC(CO)=O)O)(O)=O,,,3,1,1,0,1
4236_0,,,,2,2,1,3
C(C(C=O)(CC=O)O)(O)=O,,,3,1,2,0,2
4237_0,,,,2,2,1,3
4237_1,,,,2,2,1,3
4238_0,,,,2,2,1,3
4240_0,,,,2,2,1,3
C(C(C(C)=O)(CC(C=O)=O)O)(O)=O,,,3,1,1,0,1
4242_0,,,,2,2,1,3
C(C(C(CC=O)=O)(CC=O)O)(O)=O,,,3,1,1,0,1
4244_0,,,,2,2,1,3
C(C(C=O)(CC(C(C)=O)=O)O)(O)=O,,,3,1,1,0,1
4246_0,,,,2,2,1,3
C(C(C=O)(CC(CC=O)=O)O)(O)=O,,,3,1,1,0,1
4248_0,,,,2,2,1,3
C(C(C=O)(C=CC(CO)=O)O)(O)=O,,,3,1,1,0,1
4250_0,,,,2,2,1,3
C(C(C(C=O)(CC=O)O)O)(O)=O,,,3,1,2,0,2
4251_0,,,,2,2,1,3
4252_0,,,,2,2,1,3
4253_0,,,,2,2,1,3
4255_0,,,,2,2,1,3
C(C(CO)(CC=O)O)=O,,,3,1,2,0,2
4257_0,,,,2,2,1,3
C(C(CO)(CC=O)O)(C(CO)O)=O,,,3,1,1,0,1
4259_0,,,,2,2,1,3
C(C(C(CO)(CC(CO)O)O)=O)=O,,,3,1,1,0,1
4260_0,,,,2,2,1,3
4262_0,,,,2,2,1,3
C(C(CC(C(CO)=O)(CO)O)O)=O,,,3,1,1,0,1
4264_0,,,,2,2,1,3
C(C(C(C(CO)(CCO)O)=O)O)=O,,,3,1,1,0,1
4266_0,,,,2,2,1,3
C(CO)(C(CO)(CC(CO)=O)O)=O,,,3,1,1,0,1
4268_0,,,,2,2,1,3
C(C(CO)(CC(C(C=O)O)O)O)=O,,,3,1,1,0,1
4270_0,,,,2,2,1,3
C(C(C(C=O)O)O)(C(CO)(C)O)=O,,,3,1,1,0,1
4271_0,,,,2,2,1,3
4272_0,,,,2,2,1,3
4274_0,,,,2,2,1,3
C(C(CO)(CC(C(CO)O)O)N)=O,,,3,1,1,0,1
4276_0,,,,2,2,1,3
C(C)(C(CO)(CC(C=O)=O)O)=O,,,3,1,2,0,2
4278_0,,,,2,2,1,3
C(C(CO)(CC=O)O)(CC=O)=O,,,3,1,2,0,2
4280_0,,,,2,2,1,3
C(C(CO)(CC(C(C)=O)=O)O)=O,,,3,1,3,0,3
4282_0,,,,2,2,1,3
C(C(CO)(CC(CC=O)=O)O)=O,,,3,1,3,0,3
4284_0,,,,2,2,1,3
C1(C(CO)(O)OC(C(CO)O)C1)=O,,,3,1,1,0,1
4286_0,,,,2,2,1,3
C1(C(CO)(O)OC(C(C1)O)CO)=O,,,3,1,1,0,1
4288_0,,,,2,2,1,3
C1(C(CO)(O)OCC(C(C1)O)O)=O,,,3,1,1,0,1
4290_0,,,,2,2,1,3
C(C(C=CC(CO)=O)(CO)O)=O,,,3,1,2,0,2
4292_0,,,,2,2,1,3
C(C(CO)(CC(C(CO)O)N)O)=O,,,3,1,13,0,13
4293_0,,,,2,1,2,3
4294_0,,,,2,1,2,3
4295_0,,,,2,1,2,3
4296_0,,,,2,1,2,3
4297_0,,,,2,1,2,3
4298_0,,,,2,1,2,3
4299_0,,,,2,1,2,3
4300_0,,,,2,1,2,3
4301_0,,,,2,1,2,3
4302_0,,,,2,1,2,3
4303_0,,,,2,1,2,3
4305_0,,,,2,1,1,2
C(C(C(CO)O)OC(CO)=O)=O,,,3,1,1,0,1
4307_0,,,,2,1,1,2
C(C(C(CO)OC(CO)=O)O)=O,,,3,1,1,0,1
4309_0,,,,2,1,1,2
C(C(C(COC(CO)=O)O)O)=O,,,3,1,1,0,1
4310_0,,,,2,1,2,3
4311_0,,,,2,1,2,3
4313_0,,,,2,1,2,3
C(C(CN)O)O,,,3,1,13,0,13
4315_0,,,,2,1,2,3
C(C(C(C(CN)O)O)O)O,,,3,1,1,0,1
4316_0,,,,2,1,2,3
4316_1,,,,2,1,2,3
4318_0,,,,2,1,2,3
C(C(CN)O)(O)=O,,,3,1,13,0,13
4319_0,,,,2,1,2,3
4320_0,,,,2,1,2,3
4321_0,,,,2,1,2,3
4322_0,,,,2,1,2,3
4324_0,,,,2,1,2,3
C1(C(C(CO)O)NCC1)=O,,,3,1,1,0,1
4326_0,,,,2,1,2,3
C1(C(CO)NCC(C1)O)=O,,,3,1,1,0,1
4328_0,,,,2,1,2,3
C(C)(C1C(C(CN1)O)O)=O,,,3,1,1,0,1
4330_0,,,,2,1,2,3
C(C1C(CC(CO)N1C)=O)=O,,,3,1,1,0,1
4332_0,,,,2,1,2,3
C1(CC(C=O)N(C)C1CO)=O,,,3,1,1,0,1
4334_0,,,,2,1,2,3
C1(C(C(C=O)O)N(C)CC1)=O,,,3,1,2,0,2
4334_1,,,,2,1,2,3
4336_0,,,,2,2,2,4
C1(C(C(C(C1CO)O)O)N)=O,,,3,1,1,0,1
4338_0,,,,2,2,2,4
C1(C(C(C(C(C1)O)O)O)N)=O,,,3,1,1,0,1
4340_0,,,,2,2,2,4
C(C(C(C(C(CO)O)N)=O)CO)=O,,,3,1,1,0,1
4342_0,,,,2,2,2,4
C(C(C(C(CO)C(CO)O)=O)N)=O,,,3,1,1,0,1
4344_0,,,,2,2,2,4
C(C(CO)C(C=O)O)(C(CO)N)=O,,,3,1,1,0,1
4346_0,,,,2,2,2,4
C(C(C(C=O)O)N)(C(CO)CO)=O,,,3,1,2,0,2
4346_1,,,,2,2,2,4
4348_0,,,,2,2,2,4
C(C(CO)N)(CC(C(C=O)O)O)=O,,,3,1,1,0,1
4350_0,,,,2,2,2,4
C(C(C(C(C=O)O)O)N)(CCO)=O,,,3,1,1,0,1
4352_0,,,,2,2,2,4
C(C(C(C(C(CO)O)O)N)=O)=O,,,3,1,1,0,1
4354_0,,,,2,2,2,4
C(C)(C(C=O)N(C)CC=O)=O,,,3,1,1,0,1
4356_0,,,,2,2,2,4
C(C(CO)NC(C=O)C(C)=O)(O)=O,,,3,1,1,0,1
4358_0,,,,2,2,2,4
C(C(C(C)=O)N)=O,,,3,1,1,0,1
4360_0,,,,2,2,2,4
C(C(C(C)=O)NCCO)=O,,,3,1,1,0,1
4362_0,,,,2,2,2,4
C(C)(C(CO)N(C)CC=O)=O,,,3,1,1,0,1
4364_0,,,,2,2,2,4
C(C(CO)NC(C(C)=O)CO)(O)=O,,,3,1,1,0,1
4366_0,,,,2,2,2,4
C(C)(C(CO)N)=O,,,3,1,1,0,1
4368_0,,,,2,2,2,4
C(C)(C(CO)NCCO)=O,,,3,1,1,0,1
4370_0,,,,2,2,2,4
C(C(C(C=O)O)N(C)CC=O)(C)=O,,,3,1,2,0,2
4370_1,,,,2,2,2,4
4372_0,,,,2,2,2,4
C(C(C(C(C)=O)N)O)=O,,,3,1,2,0,2
4372_1,,,,2,2,2,4
4374_0,,,,2,2,2,4
C(C(C(C=O)O)NCCO)(C)=O,,,3,1,2,0,2
4374_1,,,,2,2,2,4
4375_0,,,,2,2,2,4
4376_0,,,,2,2,2,4
4376_1,,,,2,2,2,4
4377_0,,,,2,2,2,4
4378_0,,,,2,2,2,4
4379_0,,,,2,2,2,4
4380_0,,,,2,2,2,4
4382_0,,,,2,2,2,4
C(CCO)(C(C(CO)=O)N)=O,,,3,1,1,0,1
4384_0,,,,2,2,2,4
C(C(C(C(CCO)O)=O)N)=O,,,3,1,1,0,1
4385_0,,,,2,2,2,4
4386_0,,,,2,2,2,4
4386_1,,,,2,2,2,4
4388_0,,,,2,2,2,4
C(CO)(C(C(C(C)=O)O)N)=O,,,3,1,2,0,2
4388_1,,,,2,2,2,4
4390_0,,,,2,2,2,4
C(C)(C(C(C(CO)=O)O)N)=O,,,3,1,2,0,2
4390_1,,,,2,2,2,4
4392_0,,,,2,2,2,4
C(C(C(C=O)O)N)(C(C)O)=O,,,3,1,2,0,2
4392_1,,,,2,2,2,4
4393_0,,,,2,2,2,4
4394_0,,,,2,2,2,4
4396_0,,,,2,2,2,4
C(CN(C)C(C(CNC)=O)CO)=O,,,3,1,1,0,1
4398_0,,,,2,2,2,4
C(CN(C)C(C(C)=O)CC(C=O)=O)=O,,,3,1,2,0,2
4398_1,,,,2,2,2,4
4400_0,,,,2,2,2,4
C(CC(C(C(C)=O)N(C)CC=O)=O)=O,,,3,1,1,0,1
4402_0,,,,2,2,2,4
C(C)(CC(C(C=O)N(C)CC=O)=O)=O,,,3,1,1,0,1
4404_0,,,,2,2,2,4
C(CN(C)C(C=O)C(CCC=O)=O)=O,,,3,1,1,0,1
4406_0,,,,2,2,2,4
C(CN(C)C(C=O)C(C=CCO)=O)=O,,,3,1,1,0,1
4408_0,,,,2,2,2,4
C(CN(C)C(C(C=CC=O)=O)CO)=O,,,3,1,1,0,1
4410_0,,,,2,2,2,4
C(CN(C)C(C(C=C)=O)C(C=O)O)=O,,,3,1,2,0,2
4410_1,,,,2,2,2,4
4412_0,,,,2,2,2,4
C(CNC)(C(CO)N)=O,,,3,1,1,0,1
4414_0,,,,2,2,2,4
C(CNC)(C(CO)NCCO)=O,,,3,1,1,0,1
4416_0,,,,2,2,2,4
C(C(CO)NC)(C(C(CO)O)N)=O,,,3,1,1,0,1
4418_0,,,,2,2,2,4
C(CC(C(C(CO)N)=O)NC)=O,,,3,1,1,0,1
4420_0,,,,2,2,2,4
C(C(CO)N)(CC(CNC)=O)=O,,,3,1,1,0,1
4422_0,,,,2,2,2,4
C(CCO)(C(C(CNC)=O)N)=O,,,3,1,1,0,1
4424_0,,,,2,2,2,4
C(C(C(C(CCO)NC)=O)N)=O,,,3,1,1,0,1
4426_0,,,,2,2,2,4
C(CC(C(CNC)=O)N)(CO)=O,,,3,1,2,0,2
4426_1,,,,2,2,2,4
4428_0,,,,2,2,2,4
C(C(C(C(C)=O)O)N)(CNC)=O,,,3,1,2,0,2
4428_1,,,,2,2,2,4
4430_0,,,,2,2,2,4
C(C(C(C(CNC)=O)O)N)(C)=O,,,3,1,2,0,2
4430_1,,,,2,2,2,4
4432_0,,,,2,2,2,4
C(C(C(C=O)O)N)(C(C)NC)=O,,,3,1,2,0,2
4432_1,,,,2,2,2,4
4434_0,,,,2,2,2,4
C(CC(C(C(CNC)=O)N)O)=O,,,3,1,1,0,1
4436_0,,,,2,2,2,4
C(CNCC(O)=O)(C(CO)N)=O,,,3,1,1,0,1
4438_0,,,,2,2,2,4
C(CNC)(C(C(C(CO)O)O)N)=O,,,3,1,1,0,1
4440_0,,,,2,2,2,4
C(C(C(CO)O)N)(CCO)=O,,,3,1,1,0,1
4442_0,,,,2,2,2,4
C(C(CO)N)(CC(CO)O)=O,,,3,1,13,0,13
4444_0,,,,2,2,2,4
C(C)(C(C(C(CO)O)O)N)=O,,,3,1,1,0,1
4446_0,,,,2,2,2,4
C(CC(C(C(CO)O)N)=O)(O)=O,,,3,1,1,0,1
4448_0,,,,2,2,2,4
C(C(C(CC(CO)O)=O)N)(O)=O,,,3,1,2,0,2
4450_0,,,,2,2,2,4
C(CC(C(O)=O)O)(C(CO)N)=O,,,3,1,1,0,1
4452_0,,,,2,2,2,4
C(C(C(C(O)=O)O)N)(CCO)=O,,,3,1,2,0,2
4452_1,,,,2,2,2,4
4454_0,,,,2,2,2,4
C(C(C(C(C(C)=O)N)O)O)(O)=O,,,3,1,1,0,1
4456_0,,,,2,2,2,4
C(C(CO)(C(C(CCO)=O)N)O)=O,,,3,1,1,0,1
4458_0,,,,2,2,2,4
C(C(CO)(C(C(C(C)=O)N)O)O)=O,,,3,1,1,0,1
4460_0,,,,2,2,2,4
C(C(CO)(CC(C(CO)N)=O)O)=O,,,3,1,1,0,1
4462_0,,,,2,2,2,4
C(C)(C(CC(C=O)=O)N)=O,,,3,1,2,0,2
4462_1,,,,2,2,2,4
4464_0,,,,2,2,2,4
C(C(CC(C=O)=O)NCCO)(C)=O,,,3,1,2,0,2
4464_1,,,,2,2,2,4
4466_0,,,,2,2,2,4
C(CC(C(C(C)=O)N)=O)=O,,,3,1,1,0,1
4468_0,,,,2,2,2,4
C(CC(C(C(C)=O)NCCO)=O)=O,,,3,1,1,0,1
4470_0,,,,2,2,2,4
C(C(C=O)N)(CC(C)=O)=O,,,3,1,1,0,1
4472_0,,,,2,2,2,4
C(C(C=O)NCCO)(CC(C)=O)=O,,,3,1,1,0,1
4474_0,,,,2,2,2,4
C(C(C(CCC=O)=O)N)=O,,,3,1,1,0,1
4476_0,,,,2,2,2,4
C(C(C(CCC=O)=O)NCCO)=O,,,3,1,1,0,1
4478_0,,,,2,2,2,4
C1(COC(C(CO)O)C1N)=O,,,3,1,1,0,1
4480_0,,,,2,2,2,4
C1(COC(CO)C(C1N)O)=O,,,3,1,1,0,1
4482_0,,,,2,2,2,4
C1(C(C(CO)OC(C1)O)N)=O,,,3,1,1,0,1
4484_0,,,,2,2,2,4
C1(C(C(O)OC(CO)C1)N)=O,,,3,1,1,0,1
4486_0,,,,2,2,2,4
C1(COCC(C(C1N)O)O)=O,,,3,1,1,0,1
4488_0,,,,2,2,2,4
C1(C(C(COC(C1)O)O)N)=O,,,3,1,1,0,1
4490_0,,,,2,2,2,4
C1(C(C(O)OCC(C1)O)N)=O,,,3,1,1,0,1
4492_0,,,,2,2,2,4
C1(C(COC(C(C1)O)O)N)=O,,,3,1,1,0,1
4494_0,,,,2,2,2,4
C1(C(C(C(O)OCC1)O)N)=O,,,3,1,1,0,1
4496_0,,,,2,2,2,4
C(C(C(CO)O)N)(CCN)=O,,,3,1,1,0,1
4498_0,,,,2,2,2,4
C(C(CN)N)(CC(CO)O)=O,,,3,1,1,0,1
4500_0,,,,2,2,2,4
C(C(CO)N)(CC(CN)O)=O,,,3,1,1,0,1
4502_0,,,,2,2,2,4
C(C(C(CN)O)N)(CCO)=O,,,3,1,1,0,1
4504_0,,,,2,2,2,4
C(C)(C(C(C(CN)O)O)N)=O,,,3,1,1,0,1
4506_0,,,,2,2,2,4
C(C(C(C=CCO)=O)N)=O,,,3,1,1,0,1
4508_0,,,,2,2,2,4
C(C(C(C=CCO)=O)NCCO)=O,,,3,1,1,0,1
4510_0,,,,2,2,2,4
C(C=CC(C(CO)N)=O)=O,,,3,1,1,0,1
4512_0,,,,2,2,2,4
C(C=CC(C(CO)NCCO)=O)=O,,,3,1,1,0,1
4514_0,,,,2,2,2,4
C(C(C(C(C=C)=O)N)O)=O,,,3,1,2,0,2
4514_1,,,,2,2,2,4
4516_0,,,,2,2,2,4
C(C(C(C(C=C)=O)NCCO)O)=O,,,3,1,2,0,2
4516_1,,,,2,2,2,4
4518_0,,,,2,2,2,4
C(CO)(C(C(C(CO)O)NC)N)=O,,,3,1,1,0,1
4520_0,,,,2,2,2,4
C(CC(C(C(CO)NC)N)=O)=O,,,3,1,1,0,1
4522_0,,,,2,2,2,4
C(C(C(CC(CO)NC)=O)N)=O,,,3,1,1,0,1
4524_0,,,,2,2,2,4
C(CC(C=O)NC)(C(CO)N)=O,,,3,1,1,0,1
4526_0,,,,2,2,2,4
C(CC(C=O)O)(C(CNC)N)=O,,,3,1,1,0,1
4528_0,,,,2,2,2,4
C(C(C(C=O)NC)N)(CCO)=O,,,3,1,2,0,2
4528_1,,,,2,2,2,4
4530_0,,,,2,2,2,4
C(C(C(C=O)O)N)(CCNC)=O,,,3,1,2,0,2
4530_1,,,,2,2,2,4
4532_0,,,,2,2,2,4
C(C(C(C(C(C)=O)N)NC)O)=O,,,3,1,1,0,1
4534_0,,,,2,2,2,4
C(C(C(C)=O)NCC(O)=O)=O,,,3,1,1,0,1
4536_0,,,,2,2,2,4
C(C)(C(CO)NCC(O)=O)=O,,,3,1,1,0,1
4538_0,,,,2,2,2,4
C(CNC(C(C)=O)C(C=O)O)(O)=O,,,3,1,2,0,2
4538_1,,,,2,2,2,4
4539_0,,,,2,2,2,4
4540_0,,,,2,2,2,4
4541_0,,,,2,2,2,4
4542_0,,,,2,2,2,4
4544_0,,,,2,2,2,4
C(C(C(C(C(CO)O)O)NC)=O)=O,,,3,1,1,0,1
4545_0,,,,2,2,2,4
4546_0,,,,2,2,2,4
4547_0,,,,2,2,2,4
4547_1,,,,2,2,2,4
4548_0,,,,2,2,2,4
4549_0,,,,2,2,2,4
4549_1,,,,2,2,2,4
4550_0,,,,2,2,2,4
4551_0,,,,2,2,2,4
4552_0,,,,2,2,2,4
4553_0,,,,2,2,2,4
4554_0,,,,2,2,2,4
4555_0,,,,2,2,2,4
4556_0,,,,2,2,2,4
4557_0,,,,2,2,2,4
4557_1,,,,2,2,2,4
4558_0,,,,2,2,2,4
4558_1,,,,2,2,2,4
4559_0,,,,2,2,2,4
4559_1,,,,2,2,2,4
4560_0,,,,2,2,2,4
4560_1,,,,2,2,2,4
4561_0,,,,2,2,2,4
4562_0,,,,2,2,2,4
4563_0,,,,2,2,2,4
4564_0,,,,2,2,2,4
4565_0,,,,2,2,2,4
4566_0,,,,2,2,2,4
4567_0,,,,2,2,2,4
4568_0,,,,2,2,2,4
4568_1,,,,2,2,2,4
4569_0,,,,2,2,2,4
4569_1,,,,2,2,2,4
4570_0,,,,2,2,2,4
4570_1,,,,2,2,2,4
4571_0,,,,2,2,2,4
4571_1,,,,2,2,2,4
4572_0,,,,2,2,2,4
4573_0,,,,2,2,2,4
4574_0,,,,2,2,2,4
4575_0,,,,2,2,2,4
4576_0,,,,2,2,2,4
4577_0,,,,2,2,2,4
4578_0,,,,2,2,2,4
4579_0,,,,2,2,2,4
4580_0,,,,2,2,2,4
4580_1,,,,2,2,2,4
4581_0,,,,2,2,2,4
4583_0,,,,2,2,2,4
C(C(CC(C=O)=O)NC)(C)=O,,,3,1,4,0,4
4583_1,,,,2,2,2,4
4585_0,,,,2,2,2,4
C(CC(C(C(C)=O)NC)=O)=O,,,3,1,3,0,3
4587_0,,,,2,2,2,4
C(C(C=O)NC)(CC(C)=O)=O,,,3,1,2,0,2
4589_0,,,,2,2,2,4
C(C(C(CCC=O)=O)NC)=O,,,3,1,2,0,2
4591_0,,,,2,2,2,4
C1(COC(C(CO)O)C1NC)=O,,,3,1,1,0,1
4593_0,,,,2,2,2,4
C1(COC(CO)C(C1NC)O)=O,,,3,1,1,0,1
4595_0,,,,2,2,2,4
C1(C(C(CO)OC(C1)O)NC)=O,,,3,1,2,0,2
4597_0,,,,2,2,2,4
C1(C(C(O)OC(CO)C1)NC)=O,,,3,1,2,0,2
4599_0,,,,2,2,2,4
C1(COCC(C(C1NC)O)O)=O,,,3,1,1,0,1
4601_0,,,,2,2,2,4
C1(C(C(COC(C1)O)O)NC)=O,,,3,1,2,0,2
4603_0,,,,2,2,2,4
C1(C(C(O)OCC(C1)O)NC)=O,,,3,1,2,0,2
4605_0,,,,2,2,2,4
C1(C(COC(C(C1)O)O)NC)=O,,,3,1,2,0,2
4607_0,,,,2,2,2,4
C1(C(C(C(O)OCC1)O)NC)=O,,,3,1,2,0,2
4609_0,,,,2,2,2,4
C(C(C(CO)O)NC)(CCN)=O,,,3,1,13,0,13
4611_0,,,,2,2,2,4
C(C(CN)NC)(CC(CO)O)=O,,,3,1,13,0,13
4613_0,,,,2,2,2,4
C(C(CO)NC)(CC(CN)O)=O,,,3,1,13,0,13
4615_0,,,,2,2,2,4
C(C(C(CN)O)NC)(CCO)=O,,,3,1,13,0,13
4617_0,,,,2,2,2,4
C(C)(C(C(C(CN)O)O)NC)=O,,,3,1,13,0,13
4619_0,,,,2,2,2,4
C(C(C(C=CCO)=O)NC)=O,,,3,1,2,0,2
4621_0,,,,2,2,2,4
C(C=CC(C(CO)NC)=O)=O,,,3,1,2,0,2
4623_0,,,,2,2,2,4
C(C(C(C(C=C)=O)NC)O)=O,,,3,1,3,0,3
4623_1,,,,2,2,2,4
4625_0,,,,2,2,2,4
C(CC(C(C(CO)NC)NC)=O)=O,,,3,1,2,0,2
4627_0,,,,2,2,2,4
C(C(C(CC(CO)NC)=O)NC)=O,,,3,1,2,0,2
4629_0,,,,2,2,2,4
C(CC(C=O)NC)(C(CO)NC)=O,,,3,1,2,0,2
4631_0,,,,2,2,2,4
C(CC(C=O)O)(C(CNC)NC)=O,,,3,1,2,0,2
4633_0,,,,2,2,2,4
C(C(C(C=O)NC)NC)(CCO)=O,,,3,1,3,0,3
4633_1,,,,2,2,2,4
4635_0,,,,2,2,2,4
C(C(C(C=O)O)NC)(CCNC)=O,,,3,1,3,0,3
4635_1,,,,2,2,2,4
4637_0,,,,2,2,2,4
C(C(C(C(C(C)=O)NC)NC)O)=O,,,3,1,2,0,2
4638_0,,,,2,2,2,4
4639_0,,,,2,2,2,4
4640_0,,,,2,2,2,4
4641_0,,,,2,2,2,4
4641_1,,,,2,2,2,4
4642_0,,,,2,2,2,4
4643_0,,,,2,2,3,5
4645_0,,,,2,2,3,5
C(C(C(CO)C(C(CO)O)O)N)=O,,,3,1,11,0,11
4646_0,,,,2,2,3,5
4647_0,,,,2,2,3,5
4648_0,,,,2,2,3,5
4650_0,,,,2,2,3,5
C(C(C(CC(CO)O)O)N)=O,,,3,1,11,0,11
4652_0,,,,2,2,3,5
C(C(C(CC(CO)O)NC)N)=O,,,3,1,11,0,11
4654_0,,,,2,2,3,5
C(CC(C=O)N)(CCO)=O,,,3,1,12,0,12
4656_0,,,,2,2,3,5
C(C(CCC(CO)=O)N)=O,,,3,1,12,0,12
4658_0,,,,2,2,3,5
C(C(CC(C(C)=O)O)N)=O,,,3,1,12,0,12
4660_0,,,,2,2,3,5
C(CC(CC(C=O)N)O)=O,,,3,1,12,0,12
4662_0,,,,2,2,3,5
C(C(C=CC(CO)O)N)=O,,,3,1,12,0,12
4664_0,,,,2,2,3,5
C(C(CC(C(CO)O)NC)N)=O,,,3,1,11,0,11
4665_0,,,,2,2,3,5
4666_0,,,,2,2,3,5
4667_0,,,,2,2,3,5
4669_0,,,,2,2,3,5
C(CN)(CCO)=O,,,3,1,12,0,12
4670_0,,,,2,2,3,5
4671_0,,,,2,2,3,5
4673_0,,,,2,2,3,5
C(CCO)(CC(CN)=O)=O,,,3,1,13,0,13
4675_0,,,,2,2,3,5
C(CO)(CCC(CN)=O)=O,,,3,1,13,0,13
4677_0,,,,2,2,3,5
C(C)(C(CC(CN)=O)O)=O,,,3,1,13,0,13
4679_0,,,,2,2,3,5
C(CC(CC(CN)=O)O)=O,,,3,1,13,0,13
4681_0,,,,2,2,3,5
C(C(CO)O)=CC(CN)=O,,,3,1,12,0,12
4683_0,,,,2,2,3,5
C(CN)(CC(C(CO)O)NC)=O,,,3,1,12,0,12
4684_0,,,,2,2,3,5
4685_0,,,,2,2,3,5
4686_0,,,,2,2,3,5
4688_0,,,,2,2,3,5
C(C(CNC)N)(CC(CO)O)=O,,,3,1,11,0,11
4690_0,,,,2,2,3,5
C(CC(C(CCO)N)=O)=O,,,3,1,12,0,12
4692_0,,,,2,2,3,5
C(CC(C(CCO)=O)N)=O,,,3,1,12,0,12
4694_0,,,,2,2,3,5
C(CC(C=O)O)(C(C)N)=O,,,3,1,12,0,12
4696_0,,,,2,2,3,5
C(C(CC(C(C)=O)N)O)=O,,,3,1,12,0,12
4698_0,,,,2,2,3,5
C(CNCC=O)=O,,,3,1,1,0,1
4700_0,,,,2,2,3,5
C(CNCC=O)(C(CO)O)=O,,,3,1,1,0,1
4702_0,,,,2,2,3,5
C(C(C(CO)NCC=O)O)=O,,,3,1,1,0,1
4704_0,,,,2,2,3,5
C(C(C)NCC=O)=O,,,3,1,1,0,1
4706_0,,,,2,2,3,5
C(C(C)NCC(C(CO)O)=O)=O,,,3,1,1,0,1
4708_0,,,,2,2,3,5
C(C(C)NC(CO)C(C=O)O)=O,,,3,1,1,0,1
4710_0,,,,2,2,3,5
C(C(CCO)NCC=O)=O,,,3,1,1,0,1
4712_0,,,,2,2,3,5
C(CC(C=O)NCC=O)(CCO)=O,,,3,1,1,0,1
4714_0,,,,2,2,3,5
C(CNC(C=O)CCC(CO)=O)=O,,,3,1,1,0,1
4716_0,,,,2,2,3,5
C(C)(C(CC(C=O)NCC=O)O)=O,,,3,1,1,0,1
4718_0,,,,2,2,3,5
C(CC(CC(C=O)NCC=O)O)=O,,,3,1,1,0,1
4720_0,,,,2,2,3,5
C(C(C=CC(CO)O)NCC=O)=O,,,3,1,1,0,1
4722_0,,,,2,2,3,5
C(CNCC(C)=O)=O,,,3,1,1,0,1
4724_0,,,,2,2,3,5
C(CNCC(C(CO)O)=O)(C)=O,,,3,1,1,0,1
4726_0,,,,2,2,3,5
C(C(C(CO)NCC(C)=O)O)=O,,,3,1,1,0,1
4728_0,,,,2,2,3,5
C(CNCC=O)(CCO)=O,,,3,1,1,0,1
4730_0,,,,2,2,3,5
C(CCO)(CC(CNCC=O)=O)=O,,,3,1,1,0,1
4732_0,,,,2,2,3,5
C(CNCC(CCC(CO)=O)=O)=O,,,3,1,1,0,1
4734_0,,,,2,2,3,5
C(CNCC(CC(C(C)=O)O)=O)=O,,,3,1,1,0,1
4736_0,,,,2,2,3,5
C(CC(CC(CNCC=O)=O)O)=O,,,3,1,1,0,1
4738_0,,,,2,2,3,5
C(CNCC(C=CC(CO)O)=O)=O,,,3,1,1,0,1
4740_0,,,,2,2,3,5
C(C(CCO)NCC=O)(CC=O)=O,,,3,1,1,0,1
4742_0,,,,2,2,3,5
C(CNC(C(CCO)=O)CC=O)=O,,,3,1,1,0,1
4744_0,,,,2,2,3,5
C(CC(C=O)O)(C(C)NCC=O)=O,,,3,1,1,0,1
4746_0,,,,2,2,3,5
C(C)(C(CC(C=O)O)NCC=O)=O,,,3,1,1,0,1
4747_0,,,,2,2,3,5
4748_0,,,,2,2,3,5
4749_0,,,,2,2,3,5
4750_0,,,,2,2,3,5
4751_0,,,,2,2,3,5
4752_0,,,,2,2,3,5
4753_0,,,,2,2,3,5
4754_0,,,,2,2,3,5
4755_0,,,,2,2,3,5
4756_0,,,,2,2,3,5
4757_0,,,,2,2,3,5
4758_0,,,,2,2,3,5
4759_0,,,,2,2,3,5
4760_0,,,,2,2,3,5
4761_0,,,,2,2,3,5
4762_0,,,,2,2,3,5
4763_0,,,,2,2,3,5
4764_0,,,,2,2,3,5
4765_0,,,,2,2,3,5
4766_0,,,,2,2,3,5
4767_0,,,,2,2,3,5
4768_0,,,,2,2,3,5
4769_0,,,,2,2,3,5
4770_0,,,,2,2,3,5
4771_0,,,,2,2,3,5
4772_0,,,,2,2,3,5
4773_0,,,,2,2,3,5
4774_0,,,,2,2,3,5
4775_0,,,,2,2,3,5
4776_0,,,,2,2,3,5
4777_0,,,,2,2,3,5
4778_0,,,,2,2,3,5
4779_0,,,,2,2,3,5
4780_0,,,,2,2,3,5
4781_0,,,,2,2,3,5
4782_0,,,,2,2,3,5
4783_0,,,,2,2,3,5
4784_0,,,,2,2,3,5
4785_0,,,,2,2,3,5
4786_0,,,,2,2,3,5
4787_0,,,,2,2,3,5
4788_0,,,,2,2,3,5
4789_0,,,,2,2,3,5
4790_0,,,,2,2,3,5
4791_0,,,,2,2,3,5
4792_0,,,,2,2,3,5
4793_0,,,,2,2,3,5
4794_0,,,,2,2,3,5
4795_0,,,,2,2,3,5
4796_0,,,,2,2,3,5
4797_0,,,,2,2,3,5
4798_0,,,,2,2,3,5
4799_0,,,,2,2,3,5
4800_0,,,,2,2,3,5
4801_0,,,,2,2,3,5
4802_0,,,,2,2,3,5
4803_0,,,,2,2,3,5
4804_0,,,,2,2,3,5
4805_0,,,,2,2,3,5
4806_0,,,,2,2,3,5
4807_0,,,,2,2,3,5
4808_0,,,,2,2,3,5
4809_0,,,,2,2,3,5
4810_0,,,,2,2,3,5
4811_0,,,,2,2,3,5
4812_0,,,,2,2,3,5
4813_0,,,,2,2,3,5
4814_0,,,,2,2,3,5
4815_0,,,,2,2,3,5
4816_0,,,,2,2,3,5
4817_0,,,,2,2,3,5
4818_0,,,,2,2,3,5
4819_0,,,,2,2,3,5
4820_0,,,,2,2,3,5
4821_0,,,,2,2,3,5
4822_0,,,,2,2,3,5
4823_0,,,,2,2,3,5
4824_0,,,,2,2,3,5
4825_0,,,,2,2,3,5
4826_0,,,,2,2,3,5
4827_0,,,,2,2,3,5
4828_0,,,,2,2,3,5
4829_0,,,,2,2,3,5
4830_0,,,,2,2,3,5
4831_0,,,,2,2,3,5
4832_0,,,,2,2,3,5
4833_0,,,,2,2,3,5
4834_0,,,,2,2,3,5
4835_0,,,,2,2,3,5
4836_0,,,,2,2,3,5
4837_0,,,,2,2,3,5
4838_0,,,,2,2,3,5
4839_0,,,,2,2,3,5
4840_0,,,,2,2,3,5
4841_0,,,,2,2,3,5
4842_0,,,,2,2,3,5
4843_0,,,,2,2,3,5
4844_0,,,,2,2,3,5
4845_0,,,,2,2,3,5
4846_0,,,,2,2,3,5
4847_0,,,,2,2,3,5
4848_0,,,,2,2,3,5
4849_0,,,,2,2,3,5
4850_0,,,,2,2,3,5
4851_0,,,,2,2,3,5
4852_0,,,,2,2,3,5
4853_0,,,,2,2,3,5
4854_0,,,,2,2,3,5
4855_0,,,,2,2,3,5
4856_0,,,,2,2,3,5
4857_0,,,,2,2,3,5
4858_0,,,,2,2,3,5
4859_0,,,,2,2,3,5
4860_0,,,,2,2,3,5
4861_0,,,,2,2,3,5
4862_0,,,,2,2,3,5
4863_0,,,,2,2,3,5
4864_0,,,,2,2,3,5
4865_0,,,,2,2,3,5
4866_0,,,,2,2,3,5
4867_0,,,,2,2,3,5
4868_0,,,,2,2,3,5
4869_0,,,,2,2,3,5
4870_0,,,,2,2,3,5
4871_0,,,,2,2,3,5
4872_0,,,,2,2,3,5
4873_0,,,,2,2,3,5
4874_0,,,,2,2,3,5
4875_0,,,,2,2,3,5
4876_0,,,,2,2,3,5
4877_0,,,,2,2,3,5
4878_0,,,,2,2,3,5
4879_0,,,,2,2,3,5
4880_0,,,,2,2,3,5
4881_0,,,,2,2,3,5
4882_0,,,,2,2,3,5
4883_0,,,,2,2,3,5
4884_0,,,,2,2,3,5
4885_0,,,,2,2,3,5
4886_0,,,,2,2,3,5
4888_0,,,,2,1,2,3
C#CC(C(C(CO)O)O)O,,,3,1,1,0,1
4889_0,,,,2,2,1,3
4890_0,,,,2,2,1,3
4891_0,,,,2,2,1,3
4892_0,,,,2,2,1,3
4893_0,,,,2,2,1,3
4894_0,,,,2,2,2,4
4895_0,,,,2,2,2,4
4895_1,,,,2,2,2,4
4896_0,,,,2,2,2,4
4897_0,,,,2,2,2,4
4898_0,,,,2,2,2,4
4899_0,,,,2,2,2,4
4900_0,,,,2,2,2,4
4901_0,,,,2,2,2,4
4902_0,,,,2,2,2,4
4903_0,,,,2,2,2,4
4904_0,,,,2,2,2,4
4904_1,,,,2,2,2,4
4905_0,,,,2,2,2,4
4907_0,,,,2,2,1,3
C(CC(C(C(CO)O)O)O)(N)=O,,,3,1,9,0,9
4907_1,,,,2,2,1,3
4907_2,,,,2,2,1,3
4908_0,,,,2,2,1,3
4908_1,,,,2,2,1,3
4908_2,,,,2,2,1,3
4909_0,,,,2,2,1,3
4909_1,,,,2,2,1,3
4909_2,,,,2,2,1,3
4911_0,,,,2,2,1,3
C(C(C(C(C(CO)O)O)O)O)(N)=O,,,3,1,9,0,9
4911_1,,,,2,2,1,3
4911_2,,,,2,2,1,3
4912_0,,,,2,2,1,3
4912_1,,,,2,2,1,3
4912_2,,,,2,2,1,3
4913_0,,,,2,2,1,3
4913_1,,,,2,2,1,3
4913_2,,,,2,2,1,3
4915_0,,,,2,2,1,3
C(CC(C(C(CO)O)O)O)(NC)=O,,,3,1,9,0,9
4915_1,,,,2,2,1,3
4915_2,,,,2,2,1,3
4916_0,,,,2,2,1,3
4916_1,,,,2,2,1,3
4916_2,,,,2,2,1,3
4917_0,,,,2,2,1,3
4917_1,,,,2,2,1,3
4917_2,,,,2,2,1,3
4919_0,,,,2,1,2,3
C1(CC(C(C1CO)=O)O)=O,,,3,1,2,0,2
4921_0,,,,2,1,2,3
C1(C(CO)CC(C1O)=O)=O,,,3,1,1,0,1
4922_0,,,,2,1,2,3
4923_0,,,,2,1,2,3
4924_0,,,,2,1,2,3
4925_0,,,,2,1,2,3
4926_0,,,,2,1,2,3
4927_0,,,,2,1,2,3
4928_0,,,,2,1,2,3
4929_0,,,,2,1,2,3
4930_0,,,,2,1,2,3
4931_0,,,,2,1,2,3
4932_0,,,,2,1,2,3
4934_0,,,,2,1,2,3
C(CC(C(O)=O)=O)=O,,,3,1,1,0,1
4935_0,,,,2,1,2,3
4936_0,,,,2,1,2,3
4937_0,,,,2,1,2,3
4938_0,,,,2,1,2,3
4939_0,,,,2,1,2,3
4940_0,,,,2,1,2,3
4941_0,,,,2,1,2,3
4942_0,,,,2,1,2,3
4943_0,,,,2,1,2,3
4944_0,,,,2,1,2,3
4945_0,,,,2,1,2,3
4946_0,,,,2,1,2,3
4947_0,,,,2,1,2,3
4948_0,,,,2,1,2,3
4949_0,,,,2,1,2,3
4950_0,,,,2,1,2,3
4951_0,,,,2,1,2,3
4952_0,,,,2,1,2,3
4953_0,,,,2,1,2,3
4954_0,,,,2,1,2,3
4956_0,,,,2,1,2,3
C(C(C(CC(C(C)=O)=O)O)O)=O,,,3,1,1,0,1
4958_0,,,,2,1,2,3
C(CC(C(C=O)O)O)(CC=O)=O,,,3,1,1,0,1
4959_0,,,,2,1,2,3
4960_0,,,,2,1,2,3
4961_0,,,,2,1,2,3
4962_0,,,,2,1,2,3
4963_0,,,,2,1,2,3
4964_0,,,,2,1,2,3
4965_0,,,,2,1,2,3
4966_0,,,,2,1,2,3
4967_0,,,,2,1,2,3
4968_0,,,,2,1,2,3
4969_0,,,,2,1,2,3
4970_0,,,,2,1,2,3
4971_0,,,,2,1,2,3
4972_0,,,,2,1,2,3
4973_0,,,,2,1,2,3
4974_0,,,,2,1,2,3
4975_0,,,,2,1,2,3
4976_0,,,,2,1,2,3
4977_0,,,,2,1,2,3
4978_0,,,,2,1,2,3
4979_0,,,,2,1,2,3
4980_0,,,,2,1,2,3
4981_0,,,,2,1,2,3
4982_0,,,,2,1,2,3
4983_0,,,,2,1,2,3
4984_0,,,,2,1,2,3
4986_0,,,,2,1,2,3
C(C(C)=O)(C(C(CO)O)O)=O,,,3,1,1,0,1
4987_0,,,,2,1,2,3
4988_0,,,,2,1,2,3
4989_0,,,,2,1,2,3
4990_0,,,,2,1,2,3
4991_0,,,,2,1,2,3
4992_0,,,,2,1,2,3
4993_0,,,,2,1,2,3
4994_0,,,,2,1,2,3
4995_0,,,,2,1,2,3
4996_0,,,,2,1,2,3
4997_0,,,,2,1,2,3
4998_0,,,,2,1,2,3
4999_0,,,,2,1,2,3
5000_0,,,,2,1,2,3
5001_0,,,,2,1,2,3
5002_0,,,,2,1,2,3
5003_0,,,,2,1,2,3
5004_0,,,,2,1,2,3
5005_0,,,,2,1,2,3
5006_0,,,,2,1,2,3
5007_0,,,,2,1,2,3
5008_0,,,,2,1,2,3
5009_0,,,,2,1,2,3
5010_0,,,,2,1,2,3
5011_0,,,,2,1,2,3
5012_0,,,,2,1,2,3
5013_0,,,,2,1,2,3
5014_0,,,,2,1,2,3
5015_0,,,,2,1,2,3
5016_0,,,,2,1,2,3
5017_0,,,,2,1,2,3
5018_0,,,,2,1,2,3
5019_0,,,,2,1,2,3
5020_0,,,,2,1,2,3
5021_0,,,,2,1,2,3
5022_0,,,,2,1,2,3
5023_0,,,,2,1,2,3
5024_0,,,,2,1,2,3
5025_0,,,,2,1,2,3
5026_0,,,,2,1,2,3
5027_0,,,,2,1,2,3
5028_0,,,,2,1,2,3
5029_0,,,,2,1,2,3
5030_0,,,,2,1,2,3
5031_0,,,,2,1,2,3
5032_0,,,,2,1,2,3
5033_0,,,,2,1,2,3
5034_0,,,,2,1,2,3
5035_0,,,,2,1,2,3
5036_0,,,,2,1,2,3
5037_0,,,,2,1,2,3
5038_0,,,,2,1,2,3
5039_0,,,,2,1,2,3
5040_0,,,,2,1,2,3
5041_0,,,,2,1,2,3
5042_0,,,,2,1,2,3
5043_0,,,,2,1,2,3
5044_0,,,,2,1,2,3
5045_0,,,,2,1,2,3
5046_0,,,,2,1,2,3
5047_0,,,,2,1,2,3
5048_0,,,,2,1,2,3
5049_0,,,,2,1,2,3
5050_0,,,,2,1,2,3
5051_0,,,,2,1,2,3
5052_0,,,,2,1,2,3
5053_0,,,,2,1,2,3
5054_0,,,,2,1,2,3
5055_0,,,,2,1,2,3
5056_0,,,,2,1,2,3
5057_0,,,,2,1,2,3
5058_0,,,,2,1,2,3
5059_0,,,,2,1,2,3
5060_0,,,,2,1,2,3
5061_0,,,,2,1,2,3
5062_0,,,,2,1,2,3
5063_0,,,,2,1,2,3
5064_0,,,,2,1,2,3
5065_0,,,,2,1,2,3
5066_0,,,,2,1,2,3
5067_0,,,,2,1,2,3
5068_0,,,,2,1,2,3
5069_0,,,,2,1,2,3
5070_0,,,,2,1,2,3
5071_0,,,,2,1,2,3
5072_0,,,,2,1,2,3
5073_0,,,,2,1,2,3
5074_0,,,,2,1,2,3
5075_0,,,,2,1,2,3
5076_0,,,,2,1,2,3
5077_0,,,,2,1,2,3
5078_0,,,,2,1,2,3
5079_0,,,,2,1,2,3
5080_0,,,,2,1,2,3
5081_0,,,,2,1,2,3
5082_0,,,,2,1,2,3
5083_0,,,,2,1,2,3
5084_0,,,,2,1,2,3
5085_0,,,,2,1,2,3
5086_0,,,,2,1,2,3
5087_0,,,,2,1,2,3
5088_0,,,,2,1,2,3
5089_0,,,,2,1,2,3
5090_0,,,,2,1,2,3
5091_0,,,,2,1,2,3
5092_0,,,,2,1,2,3
5093_0,,,,2,1,2,3
5094_0,,,,2,1,2,3
5095_0,,,,2,1,2,3
5096_0,,,,2,1,2,3
5097_0,,,,2,1,2,3
5098_0,,,,2,1,2,3
5099_0,,,,2,1,2,3
5100_0,,,,2,1,2,3
5101_0,,,,2,1,2,3
5102_0,,,,2,1,2,3
5103_0,,,,2,1,2,3
5104_0,,,,2,1,2,3
5105_0,,,,2,1,2,3
5106_0,,,,2,1,2,3
5108_0,,,,2,1,2,3
C1(CCC(C1(CO)O)=O)=O,,,3,1,1,0,1
5109_0,,,,2,1,2,3
5111_0,,,,2,1,2,3
C1(C(CO)(CC(C1)=O)O)=O,,,3,1,1,0,1
5112_0,,,,2,1,2,3
5113_0,,,,2,1,2,3
5114_0,,,,2,1,2,3
5115_0,,,,2,1,2,3
5116_0,,,,2,1,2,3
5117_0,,,,2,1,2,3
5118_0,,,,2,1,2,3
5119_0,,,,2,1,2,3
5120_0,,,,2,1,2,3
5121_0,,,,2,1,2,3
5122_0,,,,2,1,2,3
5123_0,,,,2,1,2,3
5124_0,,,,2,1,2,3
5125_0,,,,2,1,2,3
5127_0,,,,2,1,2,3
C(C(C(C(O)=O)=O)C(CO)O)=O,,,3,1,1,0,1
5128_0,,,,2,1,2,3
5129_0,,,,2,1,2,3
5130_0,,,,2,1,2,3
5132_0,,,,2,1,2,3
C(C(C=O)C(CO)O)=O,,,3,1,1,0,1
5133_0,,,,2,1,2,3
5134_0,,,,2,1,2,3
5135_0,,,,2,1,2,3
5137_0,,,,2,1,2,3
C(C(C(CC=O)=O)C(CO)O)=O,,,3,1,1,0,1
5138_0,,,,2,1,2,3
5139_0,,,,2,1,2,3
5141_0,,,,2,1,2,3
C(C(C=O)C(CC(CO)O)=O)=O,,,3,1,1,0,1
5142_0,,,,2,1,2,3
5143_0,,,,2,1,2,3
5145_0,,,,2,1,2,3
C(C(C=O)C(C(CCO)=O)O)=O,,,3,1,1,0,1
5146_0,,,,2,1,2,3
5148_0,,,,2,1,2,3
C(CCO)(C(C=O)C(C=O)O)=O,,,3,1,1,0,1
5149_0,,,,2,1,2,3
5151_0,,,,2,1,2,3
C(C(C=O)C(CC(CO)=O)O)=O,,,3,1,1,0,1
5152_0,,,,2,1,2,3
5153_0,,,,2,1,2,3
5154_0,,,,2,1,2,3
5156_0,,,,2,1,2,3
C(C(C=O)C(C(C(C)=O)O)O)=O,,,3,1,1,0,1
5157_0,,,,2,1,2,3
5158_0,,,,2,1,2,3
5159_0,,,,2,1,2,3
5161_0,,,,2,1,2,3
C(C(C(C(C=O)C(C)=O)O)O)=O,,,3,1,1,0,1
5162_0,,,,2,1,2,3
5163_0,,,,2,1,2,3
5164_0,,,,2,1,2,3
5166_0,,,,2,1,2,3
C(C(C=O)C(C(CC=O)O)O)=O,,,3,1,1,0,1
5167_0,,,,2,1,2,3
5168_0,,,,2,1,2,3
5170_0,,,,2,1,2,3
C(C(C=O)CC(C(CO)O)=O)=O,,,3,1,1,0,1
5172_0,,,,2,1,2,3
C(C(C(C)=O)N)(O)=O,,,3,1,1,0,1
5174_0,,,,2,1,2,3
C(CC(C(O)=O)N)=O,,,3,1,1,0,1
5175_0,,,,2,1,2,3
5177_0,,,,2,1,2,3
C(CC(C(O)=O)N)(C(CO)O)=O,,,3,1,2,0,2
5178_0,,,,2,1,2,3
5179_0,,,,2,1,2,3
5180_0,,,,2,1,2,3
5181_0,,,,2,1,2,3
5182_0,,,,2,1,2,3
5183_0,,,,2,1,2,3
5184_0,,,,2,1,2,3
5185_0,,,,2,1,2,3
5186_0,,,,2,1,2,3
5187_0,,,,2,1,2,3
5188_0,,,,2,1,2,3
5189_0,,,,2,1,2,3
5190_0,,,,2,1,2,3
5191_0,,,,2,1,2,3
5192_0,,,,2,1,2,3
5193_0,,,,2,1,2,3
5194_0,,,,2,1,2,3
5195_0,,,,2,1,2,3
5196_0,,,,2,1,2,3
5197_0,,,,2,1,2,3
5198_0,,,,2,1,2,3
5199_0,,,,2,1,2,3
5201_0,,,,2,1,2,3
C1(CC(C(C(C)=O)O1)O)=O,,,3,1,2,0,2
5203_0,,,,2,1,2,3
C1(CC(C(CC=O)O1)O)=O,,,3,1,2,0,2
5205_0,,,,2,1,2,3
C1(COC(C(C)=O)C1O)=O,,,3,1,2,0,2
5207_0,,,,2,1,2,3
C(CC1C(C(CO1)=O)O)=O,,,3,1,2,0,2
5209_0,,,,2,1,2,3
C(C)(C1CC(C(O)O1)=O)=O,,,3,1,3,0,3
5211_0,,,,2,1,2,3
C(CC1CC(C(O)O1)=O)=O,,,3,1,3,0,3
5213_0,,,,2,1,2,3
C1(CC(OC1C(C)=O)O)=O,,,3,1,3,0,3
5215_0,,,,2,1,2,3
C(CC1C(CC(O1)O)=O)=O,,,3,1,3,0,3
5216_0,,,,2,1,2,3
5217_0,,,,2,1,2,3
5218_0,,,,2,1,2,3
5219_0,,,,2,1,2,3
5220_0,,,,2,1,2,3
5221_0,,,,2,1,2,3
5222_0,,,,2,1,2,3
5223_0,,,,2,1,2,3
5225_0,,,,2,1,2,3
C1(CC(CC(CO)O1)=O)=O,,,3,1,2,0,2
5227_0,,,,2,1,2,3
C1(CCC(OC1CO)=O)=O,,,3,1,2,0,2
5229_0,,,,2,1,2,3
C1(C(COC(CO)C1)=O)=O,,,3,1,2,0,2
5231_0,,,,2,1,2,3
C1(C(CO)OCC(C1)=O)=O,,,3,1,2,0,2
5232_0,,,,2,1,2,3
5233_0,,,,2,1,2,3
5234_0,,,,2,1,2,3
5235_0,,,,2,1,2,3
5237_0,,,,2,1,2,3
C1(CC(CC(CO1)O)=O)=O,,,3,1,2,0,2
5239_0,,,,2,1,2,3
C1(CCC(OCC1O)=O)=O,,,3,1,2,0,2
5241_0,,,,2,1,2,3
C1(CC(C(CCO1)=O)O)=O,,,3,1,2,0,2
5243_0,,,,2,1,2,3
C1(CC(CC(CO1)=O)O)=O,,,3,1,2,0,2
5245_0,,,,2,1,2,3
C1(C(COCC(C1)O)=O)=O,,,3,1,2,0,2
5247_0,,,,2,1,2,3
C1(C(COCC(C1)=O)O)=O,,,3,1,2,0,2
5249_0,,,,2,1,2,3
C1(CCOCC(C1O)=O)=O,,,3,1,2,0,2
5251_0,,,,2,1,2,3
C1(COCC(CC1O)=O)=O,,,3,1,2,0,2
5253_0,,,,2,1,2,3
C1(CCOC(C(C1)=O)O)=O,,,3,1,3,0,3
5255_0,,,,2,1,2,3
C1(COC(C(CC1)=O)O)=O,,,3,1,3,0,3
5257_0,,,,2,1,2,3
C1(C(CC(O)OCC1)=O)=O,,,3,1,3,0,3
5259_0,,,,2,1,2,3
C1(CC(OCC(C1)=O)O)=O,,,3,1,3,0,3
5260_0,,,,2,1,2,3
5261_0,,,,2,1,2,3
5262_0,,,,2,1,2,3
5263_0,,,,2,1,2,3
5264_0,,,,2,1,2,3
5265_0,,,,2,1,2,3
5266_0,,,,2,1,2,3
5267_0,,,,2,1,2,3
5268_0,,,,2,1,2,3
5269_0,,,,2,1,2,3
5270_0,,,,2,1,2,3
5271_0,,,,2,1,2,3
5273_0,,,,2,1,2,3
C(C(CCN)=O)(CCO)=O,,,3,1,14,0,14
5275_0,,,,2,1,2,3
C(CCN)(CC(CO)=O)=O,,,3,1,14,0,14
5277_0,,,,2,1,2,3
C(CCN)(C(C(C)=O)O)=O,,,3,1,14,0,14
5279_0,,,,2,1,2,3
C(CC(C(CCN)=O)O)=O,,,3,1,14,0,14
5281_0,,,,2,1,2,3
C(C(CN)O)(CC(C)=O)=O,,,3,1,14,0,14
5283_0,,,,2,1,2,3
C(CCC=O)(C(CN)O)=O,,,3,1,14,0,14
5285_0,,,,2,1,2,3
C(C(C)=O)(CC(CN)O)=O,,,3,1,14,0,14
5287_0,,,,2,1,2,3
C(CC(CC(CN)O)=O)=O,,,3,1,14,0,14
5288_0,,,,2,1,2,3
5289_0,,,,2,1,2,3
5290_0,,,,2,1,2,3
5291_0,,,,2,1,2,3
5292_0,,,,2,1,2,3
5293_0,,,,2,1,2,3
5294_0,,,,2,1,2,3
5295_0,,,,2,1,2,3
5296_0,,,,2,1,2,3
5297_0,,,,2,1,2,3
5298_0,,,,2,1,2,3
5299_0,,,,2,1,2,3
5301_0,,,,2,1,2,3
C(C(C=CC(C)=O)=O)=O,,,3,1,2,0,2
5303_0,,,,2,1,2,3
C(CC=CC(C=O)=O)=O,,,3,1,2,0,2
5305_0,,,,2,1,2,3
C(C=CC(C(C)=O)=O)=O,,,3,1,2,0,2
5307_0,,,,2,1,2,3
C(CC(C=CC=O)=O)=O,,,3,1,4,0,4
5309_0,,,,2,1,2,3
C=CC(CC(C=O)=O)=O,,,3,1,2,0,2
5311_0,,,,2,1,2,3
C(CC(C(C=C)=O)=O)=O,,,3,1,2,0,2
5313_0,,,,2,1,2,3
C(CC(C=O)=O)=CC=O,,,3,1,2,0,2
5314_0,,,,2,1,2,3
5316_0,,,,2,1,2,3
C(N)=CC(CC(CO)O)=O,,,3,1,3,0,3
5318_0,,,,2,1,2,3
C(C(CO)O)(CC=CN)=O,,,3,1,3,0,3
5320_0,,,,2,1,2,3
C(CCO)(C(C=CN)O)=O,,,3,1,3,0,3
5322_0,,,,2,1,2,3
C(CO)(CC(C=CN)O)=O,,,3,1,3,0,3
5324_0,,,,2,1,2,3
C(C)(C(C(C=CN)O)O)=O,,,3,1,3,0,3
5326_0,,,,2,1,2,3
C(CC(C(C=CN)O)O)=O,,,3,1,3,0,3
5327_0,,,,2,1,2,3
5328_0,,,,2,1,2,3
5329_0,,,,2,1,2,3
5331_0,,,,2,1,2,3
C(CC(CC(C=O)=O)NC)=O,,,3,1,3,0,3
5333_0,,,,2,1,2,3
C(C(CC(C(C)=O)=O)NC)=O,,,3,1,2,0,2
5334_0,,,,2,1,2,3
5336_0,,,,2,1,2,3
C(CCNC)(CC(C=O)=O)=O,,,3,1,2,0,2
5338_0,,,,2,1,2,3
C(CC(C(CCNC)=O)=O)=O,,,3,1,2,0,2
5339_0,,,,2,1,2,3
5340_0,,,,2,1,2,3
5341_0,,,,2,1,2,3
5342_0,,,,2,1,2,3
5343_0,,,,2,1,2,3
5344_0,,,,2,1,2,3
5345_0,,,,2,1,2,3
5347_0,,,,2,1,2,3
C1(COCC1O)=O,,,3,1,1,0,1
5349_0,,,,2,1,2,3
C1(C(O)OCC1)=O,,,3,1,2,0,2
5350_0,,,,2,1,2,3
5352_0,,,,2,1,2,3
C(C1C(C(C(CO)O1)O)O)=O,,,3,1,1,0,1
5354_0,,,,2,1,2,3
C1(C(CO)OC(CO)C1O)=O,,,3,1,1,0,1
5356_0,,,,2,1,2,3
C1(C(CO)(O)OC(CO)C1)=O,,,3,1,2,0,2
5358_0,,,,2,1,2,3
C1(C(CO)OC(CO)(C1)O)=O,,,3,1,2,0,2
5360_0,,,,2,1,2,3
C(CC1C(C(CO1)O)=O)=O,,,3,1,1,0,1
5362_0,,,,2,1,2,3
C(CC1(C(CCO1)=O)O)=O,,,3,1,2,0,2
5364_0,,,,2,1,2,3
C(CC1(CC(CO1)=O)O)=O,,,3,1,2,0,2
5366_0,,,,2,1,2,3
C(C(C1CC(CO1)O)=O)=O,,,3,1,1,0,1
5368_0,,,,2,1,2,3
C(C1C(CC(C=O)O1)O)=O,,,3,1,1,0,1
5370_0,,,,2,1,2,3
C(C1C(CC(C)(O1)O)=O)=O,,,3,1,2,0,2
5372_0,,,,2,1,2,3
C1(CC(C=O)OC1(C)O)=O,,,3,1,2,0,2
5374_0,,,,2,1,2,3
C(C1C(C(C(C)O1)=O)O)=O,,,3,1,1,0,1
5376_0,,,,2,1,2,3
C(C1C(C(C(CO1)O)O)O)=O,,,3,1,1,0,1
5378_0,,,,2,1,2,3
C1(C(CO)OCC(C1O)O)=O,,,3,1,1,0,1
5380_0,,,,2,1,2,3
C1(C(CO)(O)OCC(C1)O)=O,,,3,1,2,0,2
5382_0,,,,2,1,2,3
C1(C(COC(CO)(C1)O)O)=O,,,3,1,2,0,2
5384_0,,,,2,1,2,3
C1(C(C(CO)(O)OCC1)O)=O,,,3,1,2,0,2
5386_0,,,,2,1,2,3
C1(COC(CO)(C(C1)O)O)=O,,,3,1,2,0,2
5388_0,,,,2,1,2,3
C1(CC(C=O)(O)OCC1)=O,,,3,1,2,0,2
5390_0,,,,2,1,2,3
C(C1(CCC(CO1)=O)O)=O,,,3,1,2,0,2
5392_0,,,,2,1,2,3
C(C1C(CCC(O1)O)=O)=O,,,3,1,2,0,2
5394_0,,,,2,1,2,3
C1(CC(C=O)OC(C1)O)=O,,,3,1,2,0,2
5395_0,,,,2,1,2,3
5396_0,,,,2,1,2,3
5397_0,,,,2,1,2,3
5399_0,,,,2,1,2,3
C(CC(CN)O)=O,,,3,1,13,0,13
5400_0,,,,2,1,2,3
5402_0,,,,2,1,2,3
C(C(CO)O)(CC(CO)N)=O,,,3,1,14,0,14
5404_0,,,,2,1,2,3
C(C(C(CO)N)O)(CCO)=O,,,3,1,14,0,14
5406_0,,,,2,1,2,3
C(CO)(CC(C(CO)N)O)=O,,,3,1,13,0,13
5408_0,,,,2,1,2,3
C(C)(C(C(C(CO)N)O)O)=O,,,3,1,13,0,13
5410_0,,,,2,1,2,3
C(CC(C(C(CO)N)O)O)=O,,,3,1,13,0,13
5411_0,,,,2,1,2,3
5413_0,,,,2,1,2,3
C(CC(CC(CO)=O)N)=O,,,3,1,13,0,13
5415_0,,,,2,1,2,3
C(CC(C(C(C)=O)O)N)=O,,,3,1,13,0,13
5417_0,,,,2,1,2,3
C(CC(C(CC=O)N)O)=O,,,3,1,13,0,13
5419_0,,,,2,1,2,3
C(C(C(CC(C)=O)N)O)=O,,,3,1,13,0,13
5421_0,,,,2,1,2,3
C(CCC(C(C=O)O)N)=O,,,3,1,13,0,13
5422_0,,,,2,1,2,3
5424_0,,,,2,1,2,3
C(CC(CC(C=O)O)N)=O,,,3,1,13,0,13
5426_0,,,,2,1,2,3
C(C(CC(CCO)N)=O)=O,,,3,1,13,0,13
5427_0,,,,2,1,2,3
5429_0,,,,2,1,2,3
C(C(CCC(CO)N)=O)=O,,,3,1,13,0,13
5431_0,,,,2,1,2,3
C(CC(CC(CO)N)=O)=O,,,3,1,13,0,13
5433_0,,,,2,1,2,3
C(C(CC(C(C)N)O)=O)=O,,,3,1,13,0,13
5435_0,,,,2,1,2,3
C(CC(C(C(C)N)O)=O)=O,,,3,1,13,0,13
5437_0,,,,2,1,2,3
C(C(C(CC(C)N)=O)O)=O,,,3,1,13,0,13
5438_0,,,,2,1,2,3
5440_0,,,,2,1,2,3
C(C(CC(CCN)O)=O)=O,,,3,1,13,0,13
5442_0,,,,2,1,2,3
C(CC(C(CCN)O)=O)=O,,,3,1,13,0,13
5444_0,,,,2,1,2,3
C(C(C(CCCN)=O)O)=O,,,3,1,13,0,13
5446_0,,,,2,1,2,3
C(CC(C=O)O)(CCN)=O,,,3,1,13,0,13
5448_0,,,,2,1,2,3
C1(C(CC(C(CO)O)O1)=O)=O,,,3,1,2,0,2
5450_0,,,,2,1,2,3
C1(CC(C(C(CO)O)O1)=O)=O,,,3,1,2,0,2
5452_0,,,,2,1,2,3
C1(C(C(C(C(C)=O)O1)O)O)=O,,,3,1,2,0,2
5454_0,,,,2,1,2,3
C(CC1C(C(C(O1)=O)O)O)=O,,,3,1,2,0,2
5456_0,,,,2,1,2,3
C1(C(CC(C(CO)O1)O)=O)=O,,,3,1,2,0,2
5458_0,,,,2,1,2,3
C1(CC(C(C(CO)O1)O)=O)=O,,,3,1,2,0,2
5460_0,,,,2,1,2,3
C1(C(C(CC(CO)O1)=O)O)=O,,,3,1,2,0,2
5462_0,,,,2,1,2,3
C1(CC(C(OC1CO)=O)O)=O,,,3,1,2,0,2
5464_0,,,,2,1,2,3
C1(C(CC(C(CO1)O)O)=O)=O,,,3,1,2,0,2
5466_0,,,,2,1,2,3
C1(CC(C(C(CO1)O)O)=O)=O,,,3,1,2,0,2
5468_0,,,,2,1,2,3
C1(C(C(CC(CO1)O)=O)O)=O,,,3,1,2,0,2
5470_0,,,,2,1,2,3
C1(CC(C(OCC1O)=O)O)=O,,,3,1,2,0,2
5472_0,,,,2,1,2,3
C1(C(C(C(OCC1)=O)O)O)=O,,,3,1,2,0,2
5474_0,,,,2,1,2,3
C1(C(C(CC(CO1)=O)O)O)=O,,,3,1,2,0,2
5476_0,,,,2,1,2,3
C1C(C(C(C=1CO)=O)O)O,,,3,1,1,0,1
5478_0,,,,2,1,2,3
C=C1C(C(C(C1O)O)O)=O,,,3,1,1,0,1
5479_0,,,,2,1,2,3
5481_0,,,,2,1,2,3
C1C(C(C(C=1C=O)O)O)O,,,3,1,1,0,1
5483_0,,,,2,1,2,3
C(C(CO)O)=C(C(C=O)=O)CO,,,3,1,1,0,1
5485_0,,,,2,1,2,3
C=C(C(C=O)=O)C(C(CO)O)O,,,3,1,1,0,1
5487_0,,,,2,1,2,3
C=C(C=O)C(C(C(CO)O)O)=O,,,3,1,1,0,1
5489_0,,,,2,1,2,3
C(C(C(C(CO)=CCO)=O)O)=O,,,3,1,1,0,1
5491_0,,,,2,1,2,3
C(C(C(C(C(CO)O)=C)=O)O)=O,,,3,1,1,0,1
5493_0,,,,2,1,2,3
C(C(CO)=CC=O)(C(CO)O)=O,,,3,1,1,0,1
5495_0,,,,2,1,2,3
C(C(C(C(C(CO)O)=O)=C)O)=O,,,3,1,1,0,1
5497_0,,,,2,1,2,3
C(C(C(C(C(CO)=C)=O)O)O)=O,,,3,1,1,0,1
5499_0,,,,2,1,2,3
C(C(C=C(C(CO)=O)CO)O)=O,,,3,1,1,0,1
5501_0,,,,2,1,2,3
C(C(C(C(C(CO)=O)=C)O)O)=O,,,3,1,1,0,1
5502_0,,,,2,1,2,3
5504_0,,,,2,1,2,3
C(C(C(C(C(C=C)=O)O)O)O)=O,,,3,1,1,0,1
5506_0,,,,2,1,2,3
C(C(C(C=C(C=O)CO)O)O)=O,,,3,1,1,0,1
5508_0,,,,2,1,2,3
C(C(C(C(C(C=O)=C)O)O)O)=O,,,3,1,1,0,1
5510_0,,,,2,1,2,3
C(C(C(CO)O)O)=CC(O)=O,,,3,1,1,0,1
5511_0,,,,2,1,2,3
5512_0,,,,2,1,2,3
5513_0,,,,2,1,2,3
5514_0,,,,2,1,2,3
5515_0,,,,2,1,2,3
5516_0,,,,2,1,2,3
5517_0,,,,2,1,2,3
5518_0,,,,2,1,2,3
5519_0,,,,2,1,2,3
5520_0,,,,2,1,2,3
5521_0,,,,2,1,2,3
5522_0,,,,2,1,2,3
5523_0,,,,2,1,2,3
5524_0,,,,2,1,2,3
5525_0,,,,2,1,2,3
5526_0,,,,2,1,2,3
5527_0,,,,2,1,2,3
5528_0,,,,2,1,2,3
5529_0,,,,2,1,2,3
5531_0,,,,2,1,2,3
C(C(C(CO)O)O)=C(C=O)NC,,,3,1,2,0,2
5531_1,,,,2,1,2,3
5533_0,,,,2,1,2,3
C=C(C(C(C(CO)O)O)=O)NC,,,3,1,2,0,2
5533_1,,,,2,1,2,3
5534_0,,,,2,1,2,3
5535_0,,,,2,1,2,3
5536_0,,,,2,1,2,3
5537_0,,,,2,1,2,3
5538_0,,,,2,1,2,3
5539_0,,,,2,1,2,3
5540_0,,,,2,1,2,3
5541_0,,,,2,1,2,3
5542_0,,,,2,1,2,3
5543_0,,,,2,1,2,3
5544_0,,,,2,1,2,3
5545_0,,,,2,1,2,3
5546_0,,,,2,1,2,3
5548_0,,,,2,1,2,3
C(C(C(C(C=C)O)O)O)=O,,,3,1,3,0,3
5549_0,,,,2,1,2,3
5550_0,,,,2,1,2,3
5551_0,,,,2,1,2,3
5552_0,,,,2,1,2,3
5553_0,,,,2,1,2,3
5554_0,,,,2,1,2,3
5555_0,,,,2,1,2,3
5556_0,,,,2,1,2,3
5557_0,,,,2,1,2,3
5559_0,,,,2,1,2,3
C(C1(C=CC(C1O)O)O)=O,,,3,1,1,0,1
5560_0,,,,2,1,2,3
5561_0,,,,2,1,2,3
5562_0,,,,2,1,2,3
5563_0,,,,2,1,2,3
5564_0,,,,2,1,2,3
5565_0,,,,2,1,2,3
5567_0,,,,2,1,2,3
C(C=C(C=O)CO)(C(CO)O)=O,,,3,1,1,0,1
5569_0,,,,2,1,2,3
C(CO)=C(C(O)=O)N,,,3,1,2,0,2
5569_1,,,,2,1,2,3
5571_0,,,,2,1,2,3
C(C(C(CO)O)O)=C(C(O)=O)N,,,3,1,2,0,2
5571_1,,,,2,1,2,3
5573_0,,,,2,1,2,3
C(C(N)=CC(O)=O)(O)=O,,,3,1,2,0,2
5573_1,,,,2,1,2,3
5575_0,,,,2,1,2,3
C=C(C(O)=O)N,,,3,1,2,0,2
5575_1,,,,2,1,2,3
5577_0,,,,2,1,2,3
C(C(CO)O)=C(C(CO)=O)NC,,,3,1,2,0,2
5577_1,,,,2,1,2,3
5579_0,,,,2,1,2,3
C(CC(C(NC)=CCO)=O)=O,,,3,1,2,0,2
5579_1,,,,2,1,2,3
5580_0,,,,2,1,2,3
5581_0,,,,2,1,2,3
5583_0,,,,2,1,2,3
C(C(CC(C(NC)=C)=O)O)=O,,,3,1,2,0,2
5583_1,,,,2,1,2,3
5585_0,,,,2,1,2,3
C(C(NC)=CC=O)(CCO)=O,,,3,1,2,0,2
5585_1,,,,2,1,2,3
5586_0,,,,2,1,2,3
5588_0,,,,2,1,2,3
C(C(C=C(C(C)=O)NC)O)=O,,,3,1,2,0,2
5588_1,,,,2,1,2,3
5589_0,,,,2,1,2,3
5590_0,,,,2,1,2,3
5591_0,,,,2,1,2,3
5592_0,,,,2,1,2,3
5593_0,,,,2,1,2,3
5594_0,,,,2,1,2,3
5595_0,,,,2,1,2,3
5596_0,,,,2,1,2,3
5597_0,,,,2,1,2,3
5598_0,,,,2,1,2,3
5600_0,,,,2,1,2,3
C1C(C(CO)O)OC(C=1)=O,,,3,1,1,0,1
5602_0,,,,2,1,2,3
C1OC(C(C=1)=O)C(CO)O,,,3,1,1,0,1
5604_0,,,,2,1,2,3
C1C(C(CO)OC(C=1)=O)O,,,3,1,1,0,1
5606_0,,,,2,1,2,3
C1C(CO)OC(C(C=1)=O)O,,,3,1,1,0,1
5608_0,,,,2,1,2,3
C1OC(CO)C(C(C=1)=O)O,,,3,1,1,0,1
5610_0,,,,2,1,2,3
C1C(OC(C(C=1)=O)CO)O,,,3,1,1,0,1
5612_0,,,,2,1,2,3
C1C(C(COC(C=1)=O)O)O,,,3,1,1,0,1
5614_0,,,,2,1,2,3
C1C(COC(C(C=1)=O)O)O,,,3,1,1,0,1
5616_0,,,,2,1,2,3
C1OCC(C(C(C=1)=O)O)O,,,3,1,1,0,1
5618_0,,,,2,1,2,3
C1COC(C(C(C=1)=O)O)O,,,3,1,1,0,1
5620_0,,,,2,1,2,3
C1C(O)OCC(C(C=1)=O)O,,,3,1,1,0,1
5622_0,,,,2,1,2,3
C1C(C(OCC(C=1)=O)O)O,,,3,1,1,0,1
5623_0,,,,2,1,2,3
5623_1,,,,2,1,2,3
5625_0,,,,2,1,2,3
C(CO)=CC(C(CN)O)=O,,,3,1,13,0,13
5626_0,,,,2,1,2,3
5626_1,,,,2,1,2,3
5628_0,,,,2,1,2,3
C(CN)=CC(C(CO)O)=O,,,3,1,13,0,13
5629_0,,,,2,1,2,3
5629_1,,,,2,1,2,3
5631_0,,,,2,1,2,3
C=CC(C(C(CN)O)O)=O,,,3,1,13,0,13
5632_0,,,,2,1,2,3
5632_1,,,,2,1,2,3
5634_0,,,,2,1,2,3
C(C(CN)O)=CC(CO)=O,,,3,1,13,0,13
5635_0,,,,2,1,2,3
5635_1,,,,2,1,2,3
5636_0,,,,2,1,2,3
5636_1,,,,2,1,2,3
5638_0,,,,2,1,2,3
C(C(C(CN)O)O)=CC=O,,,3,1,13,0,13
5640_0,,,,2,1,2,3
C(CO)(NC)=CC=O,,,3,1,2,0,2
5640_1,,,,2,1,2,3
5642_0,,,,2,1,2,3
C(C(C(NC)=C)O)=O,,,3,1,2,0,2
5642_1,,,,2,1,2,3
5644_0,,,,2,1,2,3
C(C(CO)O)(NC)=CC(CO)=O,,,3,1,2,0,2
5644_1,,,,2,1,2,3
5646_0,,,,2,1,2,3
C(CO)(C(C(NC)=CCO)O)=O,,,3,1,2,0,2
5646_1,,,,2,1,2,3
5648_0,,,,2,1,2,3
C(CO)=C(CC(C=O)=O)NC,,,3,1,2,0,2
5648_1,,,,2,1,2,3
5650_0,,,,2,1,2,3
C(CC(C=C(CO)NC)=O)=O,,,3,1,2,0,2
5650_1,,,,2,1,2,3
5652_0,,,,2,1,2,3
C(CC(C(C(NC)=C)O)=O)=O,,,3,1,2,0,2
5652_1,,,,2,1,2,3
5654_0,,,,2,1,2,3
C(C(C=O)O)(CC(NC)=C)=O,,,3,1,2,0,2
5654_1,,,,2,1,2,3
5656_0,,,,2,1,2,3
C(C=CC(C(CNC)O)=O)=O,,,3,1,2,0,2
5658_0,,,,2,1,2,3
C(C(CC(C=CNC)=O)O)=O,,,3,1,2,0,2
5658_1,,,,2,1,2,3
5660_0,,,,2,1,2,3
C(C(NC)=CC(CCO)=O)=O,,,3,1,2,0,2
5660_1,,,,2,1,2,3
5662_0,,,,2,1,2,3
C(C(C(C(C=C)=O)O)NC)=O,,,3,1,2,0,2
5664_0,,,,2,1,2,3
C(CO)(CC(NC)=CC=O)=O,,,3,1,2,0,2
5664_1,,,,2,1,2,3
5666_0,,,,2,1,2,3
C(C)(C(C(NC)=CC=O)O)=O,,,3,1,2,0,2
5666_1,,,,2,1,2,3
5668_0,,,,2,1,2,3
C(C(C(NC)=CC(C)=O)O)=O,,,3,1,2,0,2
5668_1,,,,2,1,2,3
5670_0,,,,2,1,2,3
C(CC(C(NC)=CC=O)O)=O,,,3,1,2,0,2
5670_1,,,,2,1,2,3
5672_0,,,,2,1,2,3
C(CC=C(C(C=O)O)NC)=O,,,3,1,2,0,2
5672_1,,,,2,1,2,3
5674_0,,,,2,1,2,3
C(C(C(C=CC=O)NC)O)=O,,,3,1,2,0,2
5676_0,,,,2,1,2,3
C(CC(NC)=CC(C=O)O)=O,,,3,1,2,0,2
5676_1,,,,2,1,2,3
5678_0,,,,2,1,2,3
C(CNC(CO)=CC=O)(O)=O,,,3,1,2,0,2
5678_1,,,,2,1,2,3
5680_0,,,,2,1,2,3
C(C(C(NCC(O)=O)=C)O)=O,,,3,1,2,0,2
5680_1,,,,2,1,2,3
5682_0,,,,2,1,2,3
C(C(C(CO)O)O)(NC)=CC=O,,,3,1,2,0,2
5682_1,,,,2,1,2,3
5684_0,,,,2,1,2,3
C(C(C(NC)=CC(CO)O)O)=O,,,3,1,2,0,2
5684_1,,,,2,1,2,3
5686_0,,,,2,1,2,3
C1C(C(CO)OC=1C=O)O,,,3,1,1,0,1
5688_0,,,,2,1,2,3
C(C1(C=CC(CO)O1)O)=O,,,3,1,1,0,1
5690_0,,,,2,1,2,3
C1(C(C(CO1)O)O)=CC=O,,,3,1,1,0,1
5692_0,,,,2,1,2,3
C(C(C1OCC(C=1)O)O)=O,,,3,1,1,0,1
5694_0,,,,2,1,2,3
C(C(C1(C=CCO1)O)O)=O,,,3,1,1,0,1
5696_0,,,,2,1,2,3
C(C1C=CC(CO)(O1)O)=O,,,3,1,1,0,1
5698_0,,,,2,1,2,3
C(C1C(C=C(CO)O1)O)=O,,,3,1,1,0,1
5700_0,,,,2,1,2,3
C(C1C(C(C(O1)=C)O)O)=O,,,3,1,1,0,1
5702_0,,,,2,1,2,3
C(C(C1C=CC(O)O1)O)=O,,,3,1,1,0,1
5704_0,,,,2,1,2,3
C(C(C1C(C=CO1)O)O)=O,,,3,1,1,0,1
5706_0,,,,2,1,2,3
C1C(C(COC=1C=O)O)O,,,3,1,1,0,1
5708_0,,,,2,1,2,3
C(C1(C=CC(CO1)O)O)=O,,,3,1,1,0,1
5710_0,,,,2,1,2,3
C(C1C(C=CC(O)O1)O)=O,,,3,1,1,0,1
5712_0,,,,2,1,2,3
C(C1C(C(C=CO1)O)O)=O,,,3,1,1,0,1
5714_0,,,,2,1,2,3
C=CN,,,3,1,2,0,2
5714_1,,,,2,1,2,3
5716_0,,,,2,1,2,3
C(C(CO)O)=CN,,,3,1,2,0,2
5716_1,,,,2,1,2,3
5718_0,,,,2,1,2,3
C=C(C(C(C(CO)O)O)O)N,,,3,1,2,0,2
5718_1,,,,2,1,2,3
5720_0,,,,2,1,2,3
C(C(C(CO)O)O)=C(CO)N,,,3,1,2,0,2
5720_1,,,,2,1,2,3
5722_0,,,,2,1,2,3
C(CC(N)=CC(CO)O)=O,,,3,1,2,0,2
5722_1,,,,2,1,2,3
5724_0,,,,2,1,2,3
C(CC(CO)O)(N)=CC=O,,,3,1,2,0,2
5724_1,,,,2,1,2,3
5726_0,,,,2,1,2,3
C(C(C(C=CCO)N)O)=O,,,3,1,13,0,13
5728_0,,,,2,1,2,3
C(C(CC(N)=CCO)O)=O,,,3,1,2,0,2
5728_1,,,,2,1,2,3
5730_0,,,,2,1,2,3
C(C(C(CO)O)N)=CC=O,,,3,1,13,0,13
5732_0,,,,2,1,2,3
C(C(C=C(CCO)N)O)=O,,,3,1,2,0,2
5732_1,,,,2,1,2,3
5734_0,,,,2,1,2,3
C(C(C(C(C=C)N)O)O)=O,,,3,1,13,0,13
5736_0,,,,2,1,2,3
C(C(C(CC(N)=C)O)O)=O,,,3,1,2,0,2
5736_1,,,,2,1,2,3
5738_0,,,,2,1,2,3
C(C(C=CC(CO)N)O)=O,,,3,1,13,0,13
5740_0,,,,2,1,2,3
C(C(C(C=C(C)N)O)O)=O,,,3,1,2,0,2
5740_1,,,,2,1,2,3
5742_0,,,,2,1,2,3
C(C(C(C=CCN)O)O)=O,,,3,1,13,0,13
5743_0,,,,2,2,1,3
5743_1,,,,2,2,1,3
5745_0,,,,2,2,1,3
C(C1(C(C(C(C1O)O)O)O)O)O,,,3,1,3,0,3
5747_0,,,,2,2,1,3
C1(C(C(C(C(C1O)O)O)O)O)O,,,3,1,1,0,1
5748_0,,,,2,2,1,3
5749_0,,,,2,2,1,3
5750_0,,,,2,2,1,3
5751_0,,,,2,2,1,3
5752_0,,,,2,2,1,3
5753_0,,,,2,2,1,3
5754_0,,,,2,2,1,3
5755_0,,,,2,2,1,3
5756_0,,,,2,2,1,3
5757_0,,,,2,2,1,3
5758_0,,,,2,2,1,3
5759_0,,,,2,2,1,3
5760_0,,,,2,2,1,3
5761_0,,,,2,2,1,3
5762_0,,,,2,2,1,3
5763_0,,,,2,2,1,3
5764_0,,,,2,2,1,3
5765_0,,,,2,2,1,3
5766_0,,,,2,2,1,3
5767_0,,,,2,2,1,3
5768_0,,,,2,2,1,3
5769_0,,,,2,2,1,3
5770_0,,,,2,2,1,3
5771_0,,,,2,2,1,3
5772_0,,,,2,2,1,3
5773_0,,,,2,2,1,3
5774_0,,,,2,2,1,3
5775_0,,,,2,2,1,3
5776_0,,,,2,2,1,3
5777_0,,,,2,2,1,3
5778_0,,,,2,2,1,3
5779_0,,,,2,2,1,3
5780_0,,,,2,2,1,3
5781_0,,,,2,2,1,3
5782_0,,,,2,2,1,3
5783_0,,,,2,2,1,3
5784_0,,,,2,2,1,3
5785_0,,,,2,2,1,3
5786_0,,,,2,2,1,3
5787_0,,,,2,2,1,3
5788_0,,,,2,2,1,3
5789_0,,,,2,2,1,3
5790_0,,,,2,2,1,3
5791_0,,,,2,2,1,3
5792_0,,,,2,2,1,3
5793_0,,,,2,2,1,3
5794_0,,,,2,2,1,3
5795_0,,,,2,2,1,3
5796_0,,,,2,2,1,3
5797_0,,,,2,2,1,3
5798_0,,,,2,2,1,3
5799_0,,,,2,2,1,3
5800_0,,,,2,2,1,3
5801_0,,,,2,2,1,3
5802_0,,,,2,2,1,3
5803_0,,,,2,2,1,3
5804_0,,,,2,2,1,3
5805_0,,,,2,2,1,3
5806_0,,,,2,2,1,3
5807_0,,,,2,2,1,3
5808_0,,,,2,2,1,3
5809_0,,,,2,2,1,3
5810_0,,,,2,2,1,3
5811_0,,,,2,2,1,3
5812_0,,,,2,2,1,3
5813_0,,,,2,2,1,3
5814_0,,,,2,2,1,3
5815_0,,,,2,2,1,3
5816_0,,,,2,2,1,3
5817_0,,,,2,2,1,3
5818_0,,,,2,2,1,3
5819_0,,,,2,2,1,3
5820_0,,,,2,2,1,3
5821_0,,,,2,2,1,3
5822_0,,,,2,2,1,3
5823_0,,,,2,2,1,3
5824_0,,,,2,2,1,3
5825_0,,,,2,2,1,3
5826_0,,,,2,2,1,3
5827_0,,,,2,2,1,3
5828_0,,,,2,2,1,3
5829_0,,,,2,2,1,3
5830_0,,,,2,2,1,3
5831_0,,,,2,2,1,3
5832_0,,,,2,2,1,3
5833_0,,,,2,2,1,3
5834_0,,,,2,2,1,3
5835_0,,,,2,2,1,3
5836_0,,,,2,2,1,3
5837_0,,,,2,2,1,3
5838_0,,,,2,2,1,3
5839_0,,,,2,2,1,3
5840_0,,,,2,2,1,3
5841_0,,,,2,2,1,3
5842_0,,,,2,2,1,3
5843_0,,,,2,2,1,3
5844_0,,,,2,2,1,3
5845_0,,,,2,2,1,3
5846_0,,,,2,2,1,3
5847_0,,,,2,2,1,3
5848_0,,,,2,2,1,3
5849_0,,,,2,2,1,3
5850_0,,,,2,2,1,3
5851_0,,,,2,2,1,3
5852_0,,,,2,2,1,3
5853_0,,,,2,2,1,3
5854_0,,,,2,2,1,3
5855_0,,,,2,2,1,3
5857_0,,,,2,2,1,3
C(C(C(C(C(CNC)O)O)O)O)=O,,,3,1,2,0,2
5858_0,,,,2,2,1,3
5859_0,,,,2,2,1,3
5860_0,,,,2,2,1,3
5861_0,,,,2,2,1,3
5862_0,,,,2,2,1,3
5863_0,,,,2,2,1,3
5865_0,,,,2,2,1,3
C1C(C(C(C(CO)O)(O)O1)O)O,,,3,1,2,0,2
5867_0,,,,2,2,1,3
C(C(C(C(C(CO)O)N)O)O)O,,,3,1,13,0,13
5868_0,,,,2,2,1,3
5869_0,,,,2,2,1,3
5870_0,,,,2,2,1,3
5871_0,,,,2,2,1,3
5872_0,,,,2,2,1,3
5873_0,,,,2,2,1,3
5874_0,,,,2,2,1,3
5875_0,,,,2,2,1,3
5876_0,,,,2,2,1,3
5877_0,,,,2,2,1,3
5878_0,,,,2,2,1,3
5879_0,,,,2,2,1,3
5880_0,,,,2,2,2,4
5882_0,,,,2,2,1,3
C(C(C(C(C(CN)N)O)O)O)O,,,3,1,1,0,1
5884_0,,,,2,2,1,3
CNC(CN)C(C(C(CO)O)O)O,,,3,1,13,0,13
5885_0,,,,2,1,2,3
5886_0,,,,2,1,2,3
5887_0,,,,2,1,2,3
5888_0,,,,2,1,2,3
5890_0,,,,2,1,2,3
C(CC(C(O)=O)=O)(O)=O,,,3,1,1,0,1
5891_0,,,,2,1,2,3
5892_0,,,,2,1,2,3
5893_0,,,,2,1,2,3
5894_0,,,,2,1,2,3
5895_0,,,,2,1,2,3
5896_0,,,,2,1,2,3
5897_0,,,,2,1,2,3
5898_0,,,,2,1,2,3
5899_0,,,,2,1,2,3
5900_0,,,,2,1,2,3
5901_0,,,,2,1,2,3
5902_0,,,,2,1,2,3
5903_0,,,,2,1,2,3
5904_0,,,,2,1,2,3
5905_0,,,,2,1,2,3
5906_0,,,,2,1,2,3
5907_0,,,,2,1,2,3
5908_0,,,,2,1,2,3
5909_0,,,,2,1,2,3
5910_0,,,,2,1,2,3
5911_0,,,,2,1,2,3
5912_0,,,,2,1,2,3
5913_0,,,,2,1,2,3
5914_0,,,,2,1,2,3
5915_0,,,,2,1,2,3
5916_0,,,,2,1,2,3
5917_0,,,,2,1,2,3
5918_0,,,,2,1,2,3
5919_0,,,,2,1,2,3
5920_0,,,,2,1,2,3
5921_0,,,,2,1,2,3
5922_0,,,,2,1,2,3
5923_0,,,,2,1,2,3
5924_0,,,,2,1,2,3
5925_0,,,,2,1,2,3
5926_0,,,,2,1,2,3
5927_0,,,,2,1,2,3
5929_0,,,,2,1,2,3
C(C(CCC(CO)O)=O)=O,,,3,1,1,0,1
5931_0,,,,2,1,2,3
C(C(CCC(CO)=O)O)=O,,,3,1,1,0,1
5932_0,,,,2,1,2,3
5934_0,,,,2,1,2,3
C(CCC(C(C=O)O)O)=O,,,3,1,1,0,1
5936_0,,,,2,1,2,3
C(C(C(C=O)O)O)(CC)=O,,,3,1,1,0,1
5937_0,,,,2,1,2,3
5938_0,,,,2,1,2,3
5939_0,,,,2,1,2,3
5940_0,,,,2,1,2,3
5941_0,,,,2,1,2,3
5942_0,,,,2,1,2,3
5943_0,,,,2,1,2,3
5944_0,,,,2,1,2,3
5945_0,,,,2,1,2,3
5946_0,,,,2,1,2,3
5947_0,,,,2,1,2,3
5948_0,,,,2,1,2,3
5949_0,,,,2,1,2,3
5950_0,,,,2,1,2,3
5951_0,,,,2,1,2,3
5953_0,,,,2,1,2,3
C(C(C=CC(CO)O)O)=O,,,3,1,2,0,2
5954_0,,,,2,1,2,3
5955_0,,,,2,1,2,3
5956_0,,,,2,1,2,3
5957_0,,,,2,1,2,3
5958_0,,,,2,1,2,3
5960_0,,,,2,2,1,3
C(C(CC(C(CO)O)N)=O)=O,,,3,1,3,0,3
5960_1,,,,2,2,1,3
5961_0,,,,2,2,1,3
5963_0,,,,2,2,1,3
C(C(C(CC(CO)N)=O)O)=O,,,3,1,3,0,3
5963_1,,,,2,2,1,3
5964_0,,,,2,2,1,3
5965_0,,,,2,2,1,3
5965_1,,,,2,2,1,3
5966_0,,,,2,2,1,3
5966_1,,,,2,2,1,3
5968_0,,,,2,2,1,3
C(C(C(C=O)O)O)(CCN)=O,,,3,1,3,0,3
5968_1,,,,2,2,1,3
5969_0,,,,2,2,1,3
5970_0,,,,2,2,1,3
5972_0,,,,2,2,1,3
C(C(C(CC(CO)=O)N)O)=O,,,3,1,3,0,3
5972_1,,,,2,2,1,3
5973_0,,,,2,2,1,3
5975_0,,,,2,2,1,3
C(CC(C(C(C=O)O)O)N)=O,,,3,1,3,0,3
5975_1,,,,2,2,1,3
5976_0,,,,2,2,1,3
5976_1,,,,2,2,1,3
5977_0,,,,2,2,1,3
5978_0,,,,2,2,1,3
5978_1,,,,2,2,1,3
5979_0,,,,2,2,1,3
5980_0,,,,2,2,1,3
5980_1,,,,2,2,1,3
5981_0,,,,2,2,1,3
5981_1,,,,2,2,1,3
5982_0,,,,2,2,1,3
5982_1,,,,2,2,1,3
5983_0,,,,2,2,1,3
5984_0,,,,2,2,1,3
5985_0,,,,2,2,1,3
5985_1,,,,2,2,1,3
5986_0,,,,2,2,1,3
5987_0,,,,2,2,1,3
5987_1,,,,2,2,1,3
5988_0,,,,2,1,2,3
5989_0,,,,2,1,2,3
5990_0,,,,2,1,2,3
5991_0,,,,2,1,2,3
5993_0,,,,2,1,2,3
C1(C(C(CO)NCC1)O)=O,,,3,1,1,0,1
5995_0,,,,2,1,2,3
C1(C(CNC(CO)C1)O)=O,,,3,1,1,0,1
5997_0,,,,2,1,2,3
C1(C(CNCC(C1)O)O)=O,,,3,1,1,0,1
5999_0,,,,2,1,2,3
C1(C(C(CNCC1)O)O)=O,,,3,1,1,0,1
6001_0,,,,2,1,2,3
C(CC1C(C(CN1)O)O)=O,,,3,1,1,0,1
6003_0,,,,2,1,2,3
C1(CC(C=O)N(C)CC1O)=O,,,3,1,2,0,2
6004_0,,,,2,1,2,3
6006_0,,,,2,1,2,3
C(C1C(C(CCN1C)=O)O)=O,,,3,1,2,0,2
6007_0,,,,2,1,2,3
6009_0,,,,2,1,2,3
C(C(C1C(CCN1)O)O)=O,,,3,1,1,0,1
6011_0,,,,2,2,2,4
C1(C(C(C(C1CO)N)O)O)=O,,,3,1,1,0,1
6013_0,,,,2,2,2,4
C1(C(C(C(C1CO)O)N)O)=O,,,3,1,1,0,1
6015_0,,,,2,2,2,4
C1(C(C(C(C1CN)O)O)O)=O,,,3,1,1,0,1
6017_0,,,,2,2,2,4
C1(C(C(C(C(C1)O)O)N)O)=O,,,3,1,1,0,1
6019_0,,,,2,2,2,4
C1(C(C(C(C(C1)N)O)O)O)=O,,,3,1,1,0,1
6021_0,,,,2,2,2,4
C(C1C(C(C(C1N)O)O)O)=O,,,3,1,1,0,1
6023_0,,,,2,2,2,4
C(C(C(C(O)=O)O)N(C)CC=O)=O,,,3,1,1,0,1
6025_0,,,,2,2,2,4
C(C(C(C=O)O)N(C)CC=O)(O)=O,,,3,1,1,0,1
6027_0,,,,2,2,2,4
C(C(C(C=O)N)O)(O)=O,,,3,1,1,0,1
6028_0,,,,2,2,2,4
6030_0,,,,2,2,2,4
C(C(C(C(O)=O)O)NCCO)=O,,,3,1,1,0,1
6032_0,,,,2,2,2,4
C(C(C(C=O)O)NCCO)(O)=O,,,3,1,1,0,1
6034_0,,,,2,2,2,4
C(C(CN(C)CC=O)O)=O,,,3,1,1,0,1
6036_0,,,,2,2,2,4
C(C(CN(CC(O)=O)CC=O)O)=O,,,3,1,1,0,1
6038_0,,,,2,2,2,4
C(C(C(O)=O)NCC(C=O)O)(O)=O,,,3,1,1,0,1
6040_0,,,,2,2,2,4
C(C(CO)NCC(C=O)O)(O)=O,,,3,1,1,0,1
6041_0,,,,2,2,2,4
6043_0,,,,2,2,2,4
C(C(CNCCO)O)=O,,,3,1,1,0,1
6045_0,,,,2,2,2,4
C(C(CNCC(C(CO)O)O)O)=O,,,3,1,1,0,1
6047_0,,,,2,2,2,4
C(C(C(CO)C(C(CO)O)N)=O)=O,,,3,1,1,0,1
6049_0,,,,2,2,2,4
C(C(C(CN)C(C(CO)O)O)=O)=O,,,3,1,1,0,1
6051_0,,,,2,2,2,4
C(C(C(C(C(CO)N)O)=O)CO)=O,,,3,1,1,0,1
6053_0,,,,2,2,2,4
C(C(C(C(C(CO)O)O)=O)CN)=O,,,3,1,1,0,1
6055_0,,,,2,2,2,4
C(C(C(C(CO)C(CO)N)=O)O)=O,,,3,1,1,0,1
6057_0,,,,2,2,2,4
C(C(C(C(CN)C(CO)O)=O)O)=O,,,3,1,1,0,1
6059_0,,,,2,2,2,4
C(C(CO)C(C=O)N)(C(CO)O)=O,,,3,1,1,0,1
6061_0,,,,2,2,2,4
C(C(CO)C(C=O)O)(C(CN)O)=O,,,3,1,1,0,1
6063_0,,,,2,2,2,4
C(C(CN)C(C=O)O)(C(CO)O)=O,,,3,1,1,0,1
6065_0,,,,2,2,2,4
C(C(C(C(C(CO)CO)=O)O)N)=O,,,3,1,1,0,1
6067_0,,,,2,2,2,4
C(C(C(C=O)O)O)(C(CO)CN)=O,,,3,1,1,0,1
6069_0,,,,2,2,2,4
C(C(C(C(C(CO)=O)CO)N)O)=O,,,3,1,1,0,1
6071_0,,,,2,2,2,4
C(C(C(C(C(CO)=O)CN)O)O)=O,,,3,1,1,0,1
6073_0,,,,2,2,2,4
C(C(CO)O)(CC(C(C=O)O)N)=O,,,3,1,1,0,1
6075_0,,,,2,2,2,4
C(C(CN)O)(CC(C(C=O)O)O)=O,,,3,1,1,0,1
6077_0,,,,2,2,2,4
C(C(C(C(C=O)O)N)O)(CCO)=O,,,3,1,1,0,1
6079_0,,,,2,2,2,4
C(C(C(C(C=O)O)O)O)(CCN)=O,,,3,1,1,0,1
6081_0,,,,2,2,2,4
C(C(CO)C(C(C(C=O)O)N)O)=O,,,3,1,1,0,1
6083_0,,,,2,2,2,4
C(C(CO)C(C(C(C=O)O)O)N)=O,,,3,1,1,0,1
6085_0,,,,2,2,2,4
C(C(CN)C(C(C(C=O)O)O)O)=O,,,3,1,1,0,1
6087_0,,,,2,2,2,4
C(C(C(C(C(CO)O)N)O)=O)=O,,,3,1,1,0,1
6089_0,,,,2,2,2,4
C(C)(C(CN(C)CC=O)O)=O,,,3,1,1,0,1
6091_0,,,,2,2,2,4
C(C(CO)NCC(C(C)=O)O)(O)=O,,,3,1,1,0,1
6092_0,,,,2,2,2,4
6094_0,,,,2,2,2,4
C(C)(C(CNCCO)O)=O,,,3,1,1,0,1
6096_0,,,,2,2,2,4
C(CC(C=O)N(C)CC=O)(CO)=O,,,3,1,1,0,1
6098_0,,,,2,2,2,4
C(C(CC(CO)=O)N)=O,,,3,1,1,0,1
6100_0,,,,2,2,2,4
C(CC(C=O)NCCO)(CO)=O,,,3,1,1,0,1
6102_0,,,,2,2,2,4
C(CN(C)CCC(C=O)=O)=O,,,3,1,1,0,1
6104_0,,,,2,2,2,4
C(C(CO)NCCC(C=O)=O)(O)=O,,,3,1,1,0,1
6106_0,,,,2,2,2,4
C(C(CCN)=O)=O,,,3,1,1,0,1
6108_0,,,,2,2,2,4
C(C(CCNCCO)=O)=O,,,3,1,1,0,1
6110_0,,,,2,2,2,4
C(CN(C)CCC(CO)=O)=O,,,3,1,1,0,1
6112_0,,,,2,2,2,4
C(C(CO)NCCC(CO)=O)(O)=O,,,3,1,1,0,1
6113_0,,,,2,2,2,4
6115_0,,,,2,2,2,4
C(CO)(CCNCCO)=O,,,3,1,1,0,1
6117_0,,,,2,2,2,4
C(C(C(C(C)=O)O)N(C)CC=O)=O,,,3,1,1,0,1
6119_0,,,,2,2,2,4
C(C(C(C(C)=O)O)N)=O,,,3,1,1,0,1
6121_0,,,,2,2,2,4
C(C(C(C(C)=O)O)NCCO)=O,,,3,1,1,0,1
6122_0,,,,2,2,2,4
6123_0,,,,2,2,2,4
6124_0,,,,2,2,2,4
6125_0,,,,2,2,2,4
6127_0,,,,2,2,2,4
C(C(C(C=O)O)N(C)CC=O)=O,,,3,1,1,0,1
6129_0,,,,2,2,2,4
C(C(C(C=O)N)O)=O,,,3,1,1,0,1
6131_0,,,,2,2,2,4
C(C(C(C=O)O)NCCO)=O,,,3,1,1,0,1
6133_0,,,,2,2,2,4
C(CN(C)CC(C(CO)=O)O)=O,,,3,1,1,0,1
6135_0,,,,2,2,2,4
C(CO)(C(CN)O)=O,,,3,1,1,0,1
6137_0,,,,2,2,2,4
C(CO)(C(CNCCO)O)=O,,,3,1,1,0,1
6139_0,,,,2,2,2,4
C(C(C(CO)O)O)(C(CN)O)=O,,,3,1,1,0,1
6141_0,,,,2,2,2,4
C(C(C(CO)N)O)(C(CO)O)=O,,,3,1,1,0,1
6143_0,,,,2,2,2,4
C(CC(C(C(CN)O)=O)O)=O,,,3,1,1,0,1
6145_0,,,,2,2,2,4
C(C(CO)=O)(CC(CO)N)=O,,,3,1,1,0,1
6147_0,,,,2,2,2,4
C(C(CN)O)(CC(CO)=O)=O,,,3,1,1,0,1
6149_0,,,,2,2,2,4
C(CCN)(C(C(CO)=O)O)=O,,,3,1,1,0,1
6151_0,,,,2,2,2,4
C(C(CC(C(C=O)O)N)O)=O,,,3,1,1,0,1
6153_0,,,,2,2,2,4
C(C(C(C(C(C)O)=O)O)N)=O,,,3,1,1,0,1
6155_0,,,,2,2,2,4
C(CC(C(C(CO)=O)O)N)=O,,,3,1,1,0,1
6157_0,,,,2,2,2,4
C(CNC)(C(CN(C)CC=O)O)=O,,,3,1,1,0,1
6159_0,,,,2,2,2,4
C(C(C(CO)N(C)CC=O)O)(O)=O,,,3,1,1,0,1
6161_0,,,,2,2,2,4
C(C(C(CO)N(C)CC=O)N)(O)=O,,,3,1,1,0,1
6163_0,,,,2,2,2,4
C(CN(C)CC(C(O)=O)N)=O,,,3,1,1,0,1
6165_0,,,,2,2,2,4
C(CCN(C)CC=O)(CC(C=O)=O)=O,,,3,1,1,0,1
6167_0,,,,2,2,2,4
C(CC(CC(C=O)=O)N(C)CC=O)=O,,,3,1,1,0,1
6169_0,,,,2,2,2,4
C(CC(C(CCN(C)CC=O)=O)=O)=O,,,3,1,1,0,1
6171_0,,,,2,2,2,4
C(CN(C)C(C=O)CC(C(C)=O)=O)=O,,,3,1,1,0,1
6172_0,,,,2,2,2,4
6174_0,,,,2,2,2,4
C(CN(C)CC(C(C=CC=O)=O)O)=O,,,3,1,1,0,1
6176_0,,,,2,2,2,4
C(C(C(C(C=C)=O)O)N(C)CC=O)=O,,,3,1,1,0,1
6178_0,,,,2,2,2,4
C(CN(C)C(C=CC=O)C(C=O)O)=O,,,3,1,1,0,1
6180_0,,,,2,2,2,4
C(CNC)(C(CN)O)=O,,,3,1,1,0,1
6182_0,,,,2,2,2,4
C(CNC)(C(CNCCO)O)=O,,,3,1,1,0,1
6184_0,,,,2,2,2,4
C(C(C(C(C(CO)O)O)N)NC)=O,,,3,1,1,0,1
6186_0,,,,2,2,2,4
C(C(C(CO)O)O)(C(CN)NC)=O,,,3,1,1,0,1
6188_0,,,,2,2,2,4
C(C(C(CO)N)O)(C(CO)NC)=O,,,3,1,1,0,1
6190_0,,,,2,2,2,4
C(CC(C(C(CN)O)=O)NC)=O,,,3,1,1,0,1
6192_0,,,,2,2,2,4
C(C(CNC)=O)(CC(CO)N)=O,,,3,1,1,0,1
6194_0,,,,2,2,2,4
C(C(CN)O)(CC(CNC)=O)=O,,,3,1,1,0,1
6196_0,,,,2,2,2,4
C(CCN)(C(C(CNC)=O)O)=O,,,3,1,1,0,1
6198_0,,,,2,2,2,4
C(C(CC(C(C=O)O)N)NC)=O,,,3,1,1,0,1
6200_0,,,,2,2,2,4
C(C(C(C(C(C)NC)=O)O)N)=O,,,3,1,1,0,1
6202_0,,,,2,2,2,4
C(CC(C(C(CNC)=O)O)N)=O,,,3,1,1,0,1
6204_0,,,,2,2,2,4
C(CNCC(O)=O)(C(CN)O)=O,,,3,1,1,0,1
6206_0,,,,2,2,2,4
C(CNC)(C(C(C(CO)O)N)O)=O,,,3,1,1,0,1
6207_0,,,,2,2,2,4
6208_0,,,,2,2,2,4
6209_0,,,,2,2,2,4
6210_0,,,,2,2,2,4
6211_0,,,,2,2,2,4
6213_0,,,,2,2,2,4
C(C)(C(C(C(CO)O)N)O)=O,,,3,1,1,0,1
6214_0,,,,2,2,2,4
6216_0,,,,2,2,2,4
C(C(C(C(CCO)O)N)O)=O,,,3,1,13,0,13
6218_0,,,,2,2,2,4
C(C(C(CO)N)O)(O)=O,,,3,1,1,0,1
6220_0,,,,2,2,2,4
C(C(C(CO)NCCO)O)(O)=O,,,3,1,1,0,1
6222_0,,,,2,2,2,4
C(C(CC(C(CO)O)N)=O)(O)=O,,,3,1,1,0,1
6224_0,,,,2,2,2,4
C(CC(C(C(CO)N)O)=O)(O)=O,,,3,1,1,0,1
6226_0,,,,2,2,2,4
C(C(C(CC(CO)N)=O)O)(O)=O,,,3,1,1,0,1
6227_0,,,,2,2,2,4
6229_0,,,,2,2,2,4
C(CC(C(O)=O)O)(C(CN)O)=O,,,3,1,1,0,1
6230_0,,,,2,2,2,4
6232_0,,,,2,2,2,4
C(C(C(C(O)=O)O)O)(CCN)=O,,,3,1,1,0,1
6234_0,,,,2,2,2,4
C(C(C(CC(CO)=O)N)O)(O)=O,,,3,1,1,0,1
6236_0,,,,2,2,2,4
C(C(C(C(C(C)=O)O)N)O)(O)=O,,,3,1,1,0,1
6238_0,,,,2,2,2,4
C(CC(C(C(C(O)=O)O)N)O)=O,,,3,1,1,0,1
6240_0,,,,2,2,2,4
C(CC(C(C(C(O)=O)O)O)N)=O,,,3,1,1,0,1
6242_0,,,,2,2,2,4
C(CC(C(C(C=O)O)N)O)(O)=O,,,3,1,1,0,1
6244_0,,,,2,2,2,4
C(CC(C(C(C=O)O)O)N)(O)=O,,,3,1,1,0,1
6246_0,,,,2,2,2,4
C1(CC(C(C1(CO)O)O)N)=O,,,3,1,1,0,1
6248_0,,,,2,2,2,4
C(C(C(CC(CO)N)=O)(CO)O)=O,,,3,1,1,0,1
6250_0,,,,2,2,2,4
C(CC(C=O)N)(C(CO)(CO)O)=O,,,3,1,1,0,1
6252_0,,,,2,2,2,4
C(C(CO)(C(C(CCN)=O)O)O)=O,,,3,1,1,0,1
6254_0,,,,2,2,2,4
C(C(CO)(C(C=O)O)O)(CCN)=O,,,3,1,1,0,1
6256_0,,,,2,2,2,4
C(C(CO)(C(CC(CO)=O)N)O)=O,,,3,1,1,0,1
6258_0,,,,2,2,2,4
C(C(CO)(C(C(C(C)=O)O)N)O)=O,,,3,1,1,0,1
6260_0,,,,2,2,2,4
C(C(C(C(C(C)=O)(CO)O)N)O)=O,,,3,1,1,0,1
6262_0,,,,2,2,2,4
C(C(CO)(C(C(CC=O)N)O)O)=O,,,3,1,1,0,1
6264_0,,,,2,2,2,4
C(C(CO)(CC(C(CN)O)=O)O)=O,,,3,1,1,0,1
6266_0,,,,2,2,2,4
C(C(C(CO)N)N)(O)=O,,,3,1,1,0,1
6268_0,,,,2,2,2,4
C(C(C(CO)NCCO)N)(O)=O,,,3,1,1,0,1
6270_0,,,,2,2,2,4
C(C(C(C(C(CO)O)O)N)N)(O)=O,,,3,1,1,0,1
6272_0,,,,2,2,2,4
C(C(C(C(O)=O)N)N)(O)=O,,,3,1,1,0,1
6274_0,,,,2,2,2,4
C(C(C(C(O)=O)NCCO)N)(O)=O,,,3,1,1,0,1
6276_0,,,,2,2,2,4
C(C(CNC(C(O)=O)CO)N)(O)=O,,,3,1,1,0,1
6278_0,,,,2,2,2,4
C(C(CN)N)(O)=O,,,3,1,1,0,1
6280_0,,,,2,2,2,4
C(C(CNCCO)N)(O)=O,,,3,1,1,0,1
6282_0,,,,2,2,2,4
C(CO)(C(C(C(CO)O)N)NC)=O,,,3,1,1,0,1
6284_0,,,,2,2,2,4
C(CC(C(C(CO)N)NC)=O)=O,,,3,1,1,0,1
6286_0,,,,2,2,2,4
C(C(C(CC(CO)N)=O)NC)=O,,,3,1,1,0,1
6288_0,,,,2,2,2,4
C(CC(C=O)N)(C(CO)NC)=O,,,3,1,1,0,1
6290_0,,,,2,2,2,4
C(CC(C=O)O)(C(CN)NC)=O,,,3,1,1,0,1
6292_0,,,,2,2,2,4
C(C(C(C(CCO)=O)NC)N)=O,,,3,1,1,0,1
6294_0,,,,2,2,2,4
C(C(C(C=O)O)NC)(CCN)=O,,,3,1,1,0,1
6296_0,,,,2,2,2,4
C(C(C(C(C(C)=O)NC)N)O)=O,,,3,1,1,0,1
6297_0,,,,2,2,2,4
6299_0,,,,2,2,2,4
C(CCN)(CC(C=O)=O)=O,,,3,1,1,0,1
6301_0,,,,2,2,2,4
C(CCNCCO)(CC(C=O)=O)=O,,,3,1,1,0,1
6303_0,,,,2,2,2,4
C(CC(CC(C=O)=O)N)=O,,,3,1,1,0,1
6305_0,,,,2,2,2,4
C(CC(CC(C=O)=O)NCCO)=O,,,3,1,1,0,1
6307_0,,,,2,2,2,4
C(CC(C(CCN)=O)=O)=O,,,3,1,1,0,1
6309_0,,,,2,2,2,4
C(CC(C(CCNCCO)=O)=O)=O,,,3,1,1,0,1
6311_0,,,,2,2,2,4
C(C(CC(C(C)=O)=O)N)=O,,,3,1,1,0,1
6313_0,,,,2,2,2,4
C(C(CC(C(C)=O)=O)NCCO)=O,,,3,1,1,0,1
6314_0,,,,2,2,2,4
6315_0,,,,2,2,2,4
6317_0,,,,2,2,2,4
C1(CC(C(C(CO)O)O1)N)=O,,,3,1,1,0,1
6319_0,,,,2,2,2,4
C1(C(C(CO)O)OC(C1)N)=O,,,3,1,1,0,1
6321_0,,,,2,2,2,4
C1(C(C(CO)N)OC(C1)O)=O,,,3,1,1,0,1
6323_0,,,,2,2,2,4
C(C)(C1C(C(C(O1)O)O)N)=O,,,3,1,1,0,1
6325_0,,,,2,2,2,4
C1(CC(C(C(CO)O1)O)N)=O,,,3,1,1,0,1
6327_0,,,,2,2,2,4
C1(COC(CO)C(C1O)N)=O,,,3,1,1,0,1
6329_0,,,,2,2,2,4
C1(C(O)OC(CO)C(C1)N)=O,,,3,1,1,0,1
6331_0,,,,2,2,2,4
C1(C(C(CO)OC(C1)N)O)=O,,,3,1,1,0,1
6333_0,,,,2,2,2,4
C1(C(C(N)OC(CO)C1)O)=O,,,3,1,1,0,1
6335_0,,,,2,2,2,4
C1(C(CO)OC(C(C1)N)O)=O,,,3,1,1,0,1
6337_0,,,,2,2,2,4
C1(C(CN)OC(C(C1)O)O)=O,,,3,1,1,0,1
6339_0,,,,2,2,2,4
C1(CC(C(C(CO1)O)O)N)=O,,,3,1,1,0,1
6341_0,,,,2,2,2,4
C1(COCC(C(C1O)N)O)=O,,,3,1,1,0,1
6343_0,,,,2,2,2,4
C1(C(O)OCC(C(C1)N)O)=O,,,3,1,1,0,1
6345_0,,,,2,2,2,4
C1(C(C(COC(C1)N)O)O)=O,,,3,1,1,0,1
6347_0,,,,2,2,2,4
C1(C(C(COC(C1)O)N)O)=O,,,3,1,1,0,1
6349_0,,,,2,2,2,4
C1(C(C(N)OCC(C1)O)O)=O,,,3,1,1,0,1
6351_0,,,,2,2,2,4
C1(C(C(O)OCC(C1)N)O)=O,,,3,1,1,0,1
6353_0,,,,2,2,2,4
C1(C(COC(C(C1)N)O)O)=O,,,3,1,1,0,1
6355_0,,,,2,2,2,4
C1(C(C(C(O)OCC1)N)O)=O,,,3,1,1,0,1
6357_0,,,,2,2,2,4
C1(COC(C(C(C1)N)O)O)=O,,,3,1,1,0,1
6359_0,,,,2,2,2,4
C(C(C(CO)N)O)(CCN)=O,,,3,1,1,0,1
6361_0,,,,2,2,2,4
C(C(CN)O)(CC(CO)N)=O,,,3,1,1,0,1
6363_0,,,,2,2,2,4
C(C(CO)O)(CC(CN)N)=O,,,3,1,1,0,1
6365_0,,,,2,2,2,4
C(C(CN)O)(CC(CN)O)=O,,,3,1,1,0,1
6367_0,,,,2,2,2,4
C(C(C(CN)N)O)(CCO)=O,,,3,1,1,0,1
6369_0,,,,2,2,2,4
C(C(C(CN)O)O)(CCN)=O,,,3,1,1,0,1
6371_0,,,,2,2,2,4
C(CO)(CC(C(CN)O)N)=O,,,3,1,1,0,1
6373_0,,,,2,2,2,4
C(C)(C(C(C(CN)O)N)O)=O,,,3,1,1,0,1
6375_0,,,,2,2,2,4
C(CC(C(C(CN)O)O)N)=O,,,3,1,1,0,1
6377_0,,,,2,2,2,4
C(C=CC(C(CN)O)=O)=O,,,3,1,1,0,1
6379_0,,,,2,2,2,4
C(C=CC(C(CNCCO)O)=O)=O,,,3,1,1,0,1
6381_0,,,,2,2,2,4
C(C(C(C(C=C)=O)O)N)=O,,,3,1,1,0,1
6383_0,,,,2,2,2,4
C(C(C(C(C=C)=O)O)NCCO)=O,,,3,1,1,0,1
6385_0,,,,2,2,2,4
C(C(C(C=CC=O)N)O)=O,,,3,1,1,0,1
6387_0,,,,2,2,2,4
C(C(C(C=CC=O)NCCO)O)=O,,,3,1,1,0,1
6389_0,,,,2,2,2,4
C(CC(C=O)NC)(C(CN)O)=O,,,3,1,1,0,1
6391_0,,,,2,2,2,4
C(CC(C=O)N)(C(CNC)O)=O,,,3,1,1,0,1
6393_0,,,,2,2,2,4
C(C(C(C(CCN)=O)O)NC)=O,,,3,1,1,0,1
6395_0,,,,2,2,2,4
C(C(C(C(CCNC)=O)O)N)=O,,,3,1,1,0,1
6397_0,,,,2,2,2,4
C(CC(C(C(C=O)O)NC)N)=O,,,3,1,1,0,1
6399_0,,,,2,2,2,4
C(CC(C(C(C=O)O)N)NC)=O,,,3,1,1,0,1
6401_0,,,,2,2,2,4
C(C1C(CC(CO)(O1)O)N)=O,,,3,1,1,0,1
6403_0,,,,2,2,2,4
C(C1C(C(C(C)(O1)O)O)N)=O,,,3,1,1,0,1
6405_0,,,,2,2,2,4
C(C1C(C(CC(O1)O)O)N)=O,,,3,1,1,0,1
6407_0,,,,2,2,2,4
C(C(C(C(CCO)N)N)O)=O,,,3,1,1,0,1
6409_0,,,,2,2,2,4
C(C(C(CC(CO)N)N)O)=O,,,3,1,1,0,1
6411_0,,,,2,2,2,4
C(C(C(C(C(C)N)O)N)O)=O,,,3,1,1,0,1
6413_0,,,,2,2,2,4
C(C(C(C(CCN)O)N)O)=O,,,3,1,1,0,1
6415_0,,,,2,2,2,4
C1(C(C(C(C(CO)O)O1)N)O)=O,,,3,1,1,0,1
6417_0,,,,2,2,2,4
C1(C(C(C(C(CO)O1)O)N)O)=O,,,3,1,1,0,1
6419_0,,,,2,2,2,4
C1(C(C(C(C(CO1)O)O)N)O)=O,,,3,1,1,0,1
6420_0,,,,2,2,2,4
6422_0,,,,2,2,2,4
C(C(C(C=O)O)NCC(O)=O)(O)=O,,,3,1,1,0,1
6424_0,,,,2,2,2,4
C(C(CNCC(O)=O)O)=O,,,3,1,1,0,1
6426_0,,,,2,2,2,4
C(C)(C(CNCC(O)=O)O)=O,,,3,1,1,0,1
6428_0,,,,2,2,2,4
C(CNC(C=O)CC(CO)=O)(O)=O,,,3,1,1,0,1
6430_0,,,,2,2,2,4
C(CNCCC(C=O)=O)(O)=O,,,3,1,1,0,1
6432_0,,,,2,2,2,4
C(CNCCC(CO)=O)(O)=O,,,3,1,1,0,1
6433_0,,,,2,2,2,4
6434_0,,,,2,2,2,4
6435_0,,,,2,2,2,4
6436_0,,,,2,2,2,4
6438_0,,,,2,2,2,4
C(CNC)(C(CNCC(O)=O)O)=O,,,3,1,1,0,1
6439_0,,,,2,2,2,4
6441_0,,,,2,2,2,4
C(C(C(CO)NCC(O)=O)N)(O)=O,,,3,1,1,0,1
6443_0,,,,2,2,2,4
C(C(CNCC(O)=O)N)(O)=O,,,3,1,1,0,1
6444_0,,,,2,2,2,4
6446_0,,,,2,2,2,4
C(C(C(CO)N)O)=O,,,3,1,1,0,1
6448_0,,,,2,2,2,4
C(C(C(CO)NCCO)O)=O,,,3,1,2,0,2
6450_0,,,,2,2,2,4
C(CO)(C(C(C(CO)O)N)O)=O,,,3,1,1,0,1
6452_0,,,,2,2,2,4
C(C(C(C(C(CO)O)O)N)O)(O)=O,,,3,1,1,0,1
6454_0,,,,2,2,2,4
C1(C(C(C(C1CO)NC)O)O)=O,,,3,1,1,0,1
6455_0,,,,2,2,2,4
6456_0,,,,2,2,2,4
6457_0,,,,2,2,2,4
6458_0,,,,2,2,2,4
6459_0,,,,2,2,2,4
6460_0,,,,2,2,2,4
6462_0,,,,2,2,2,4
C(C(C(C=O)O)NC)(O)=O,,,3,1,1,0,1
6464_0,,,,2,2,2,4
C(C(CNC)O)=O,,,3,1,1,0,1
6466_0,,,,2,2,2,4
C(C(C(C(C(CO)O)NC)O)=O)=O,,,3,1,1,0,1
6467_0,,,,2,2,2,4
6468_0,,,,2,2,2,4
6469_0,,,,2,2,2,4
6470_0,,,,2,2,2,4
6471_0,,,,2,2,2,4
6472_0,,,,2,2,2,4
6473_0,,,,2,2,2,4
6474_0,,,,2,2,2,4
6475_0,,,,2,2,2,4
6476_0,,,,2,2,2,4
6477_0,,,,2,2,2,4
6478_0,,,,2,2,2,4
6479_0,,,,2,2,2,4
6480_0,,,,2,2,2,4
6481_0,,,,2,2,2,4
6483_0,,,,2,2,2,4
C(C(C(C(C(C)O)=O)O)NC)=O,,,3,1,1,0,1
6484_0,,,,2,2,2,4
6486_0,,,,2,2,2,4
C(CNC)(C(CNC)O)=O,,,3,1,1,0,1
6488_0,,,,2,2,2,4
C(CC(C(C(CNC)O)=O)NC)=O,,,3,1,1,0,1
6489_0,,,,2,2,2,4
6490_0,,,,2,2,2,4
6491_0,,,,2,2,2,4
6492_0,,,,2,2,2,4
6494_0,,,,2,2,2,4
C(C(C(C(C(C)NC)=O)O)NC)=O,,,3,1,1,0,1
6495_0,,,,2,2,2,4
6497_0,,,,2,2,2,4
C(CNCC(O)=O)(C(CNC)O)=O,,,3,1,1,0,1
6498_0,,,,2,2,2,4
6499_0,,,,2,2,2,4
6500_0,,,,2,2,2,4
6501_0,,,,2,2,2,4
6502_0,,,,2,2,2,4
6503_0,,,,2,2,2,4
6504_0,,,,2,2,2,4
6505_0,,,,2,2,2,4
6506_0,,,,2,2,2,4
6507_0,,,,2,2,2,4
6508_0,,,,2,2,2,4
6509_0,,,,2,2,2,4
6510_0,,,,2,2,2,4
6511_0,,,,2,2,2,4
6512_0,,,,2,2,2,4
6513_0,,,,2,2,2,4
6514_0,,,,2,2,2,4
6515_0,,,,2,2,2,4
6516_0,,,,2,2,2,4
6517_0,,,,2,2,2,4
6518_0,,,,2,2,2,4
6519_0,,,,2,2,2,4
6520_0,,,,2,2,2,4
6522_0,,,,2,2,2,4
C(C(C(CO)NC)N)(O)=O,,,3,1,1,0,1
6524_0,,,,2,2,2,4
C(C(C(C(O)=O)NC)N)(O)=O,,,3,1,1,0,1
6526_0,,,,2,2,2,4
C(C(CNC)N)(O)=O,,,3,1,1,0,1
6527_0,,,,2,2,2,4
6528_0,,,,2,2,2,4
6529_0,,,,2,2,2,4
6530_0,,,,2,2,2,4
6531_0,,,,2,2,2,4
6532_0,,,,2,2,2,4
6533_0,,,,2,2,2,4
6534_0,,,,2,2,2,4
6535_0,,,,2,2,2,4
6536_0,,,,2,2,2,4
6537_0,,,,2,2,2,4
6538_0,,,,2,2,2,4
6539_0,,,,2,2,2,4
6541_0,,,,2,2,2,4
C1(CC(C(C(CO)O)O1)NC)=O,,,3,1,1,0,1
6543_0,,,,2,2,2,4
C1(C(C(CO)O)OC(C1)NC)=O,,,3,1,1,0,1
6545_0,,,,2,2,2,4
C1(C(C(CO)NC)OC(C1)O)=O,,,3,1,2,0,2
6547_0,,,,2,2,2,4
C(C)(C1C(C(C(O1)O)O)NC)=O,,,3,1,2,0,2
6549_0,,,,2,2,2,4
C1(CC(C(C(CO)O1)O)NC)=O,,,3,1,1,0,1
6551_0,,,,2,2,2,4
C1(COC(CO)C(C1O)NC)=O,,,3,1,1,0,1
6553_0,,,,2,2,2,4
C1(C(O)OC(CO)C(C1)NC)=O,,,3,1,2,0,2
6555_0,,,,2,2,2,4
C1(C(C(CO)OC(C1)NC)O)=O,,,3,1,1,0,1
6557_0,,,,2,2,2,4
C1(C(C(NC)OC(CO)C1)O)=O,,,3,1,1,0,1
6559_0,,,,2,2,2,4
C1(C(CO)OC(C(C1)NC)O)=O,,,3,1,2,0,2
6561_0,,,,2,2,2,4
C1(C(CNC)OC(C(C1)O)O)=O,,,3,1,2,0,2
6563_0,,,,2,2,2,4
C1(CC(C(C(CO1)O)O)NC)=O,,,3,1,1,0,1
6565_0,,,,2,2,2,4
C1(COCC(C(C1O)NC)O)=O,,,3,1,1,0,1
6567_0,,,,2,2,2,4
C1(C(O)OCC(C(C1)NC)O)=O,,,3,1,2,0,2
6569_0,,,,2,2,2,4
C1(C(C(COC(C1)NC)O)O)=O,,,3,1,1,0,1
6571_0,,,,2,2,2,4
C1(C(C(COC(C1)O)NC)O)=O,,,3,1,2,0,2
6573_0,,,,2,2,2,4
C1(C(C(NC)OCC(C1)O)O)=O,,,3,1,1,0,1
6575_0,,,,2,2,2,4
C1(C(C(O)OCC(C1)NC)O)=O,,,3,1,2,0,2
6577_0,,,,2,2,2,4
C1(C(COC(C(C1)NC)O)O)=O,,,3,1,2,0,2
6579_0,,,,2,2,2,4
C1(C(C(C(O)OCC1)NC)O)=O,,,3,1,2,0,2
6581_0,,,,2,2,2,4
C1(COC(C(C(C1)NC)O)O)=O,,,3,1,2,0,2
6583_0,,,,2,2,2,4
C(C(C(CO)NC)O)(CCN)=O,,,3,1,13,0,13
6585_0,,,,2,2,2,4
C(C(CN)O)(CC(CO)NC)=O,,,3,1,13,0,13
6587_0,,,,2,2,2,4
C(C(CO)O)(CC(CN)NC)=O,,,3,1,13,0,13
6589_0,,,,2,2,2,4
C(C(CNC)O)(CC(CN)O)=O,,,3,1,13,0,13
6591_0,,,,2,2,2,4
C(C(C(CN)NC)O)(CCO)=O,,,3,1,13,0,13
6593_0,,,,2,2,2,4
C(C(C(CN)O)O)(CCNC)=O,,,3,1,13,0,13
6595_0,,,,2,2,2,4
C(CO)(CC(C(CN)O)NC)=O,,,3,1,13,0,13
6597_0,,,,2,2,2,4
C(C)(C(C(C(CN)O)NC)O)=O,,,3,1,13,0,13
6599_0,,,,2,2,2,4
C(CC(C(C(CN)O)O)NC)=O,,,3,1,13,0,13
6600_0,,,,2,2,2,4
6601_0,,,,2,2,2,4
6602_0,,,,2,2,2,4
6604_0,,,,2,2,2,4
C(CC(C=O)NC)(C(CNC)O)=O,,,3,1,2,0,2
6605_0,,,,2,2,2,4
6607_0,,,,2,2,2,4
C(C(C(C(CCNC)=O)O)NC)=O,,,3,1,2,0,2
6608_0,,,,2,2,2,4
6610_0,,,,2,2,2,4
C(CC(C(C(C=O)O)NC)NC)=O,,,3,1,2,0,2
6611_0,,,,2,2,2,4
6613_0,,,,2,2,2,4
C(C1C(CC(CO)(O1)O)NC)=O,,,3,1,2,0,2
6615_0,,,,2,2,2,4
C(C1C(C(C(C)(O1)O)O)NC)=O,,,3,1,2,0,2
6617_0,,,,2,2,2,4
C(C1C(C(CC(O1)O)O)NC)=O,,,3,1,2,0,2
6619_0,,,,2,2,2,4
C(C(C(C(CCO)N)NC)O)=O,,,3,1,13,0,13
6621_0,,,,2,2,2,4
C(C(C(CC(CO)N)NC)O)=O,,,3,1,13,0,13
6623_0,,,,2,2,2,4
C(C(C(C(C(C)N)O)NC)O)=O,,,3,1,13,0,13
6625_0,,,,2,2,2,4
C(C(C(C(CCN)O)NC)O)=O,,,3,1,13,0,13
6627_0,,,,2,2,2,4
C1(C(C(C(C(CO)O)O1)NC)O)=O,,,3,1,1,0,1
6629_0,,,,2,2,2,4
C1(C(C(C(C(CO)O1)O)NC)O)=O,,,3,1,1,0,1
6631_0,,,,2,2,2,4
C1(C(C(C(C(CO1)O)O)NC)O)=O,,,3,1,1,0,1
6632_0,,,,2,2,2,4
6634_0,,,,2,2,2,4
C(CC(C(C(CO)N)O)=O)=O,,,3,1,1,0,1
6635_0,,,,2,2,2,4
6636_0,,,,2,2,2,4
6638_0,,,,2,2,2,4
C(CC(C=O)O)(C(CN)O)=O,,,3,1,1,0,1
6639_0,,,,2,2,2,4
6640_0,,,,2,2,2,4
6641_0,,,,2,2,2,4
6643_0,,,,2,2,2,4
C(C(C(C(C(C)=O)O)N)O)=O,,,3,1,1,0,1
6645_0,,,,2,2,2,4
C(CC(C(C(C=O)O)N)O)=O,,,3,1,1,0,1
6646_0,,,,2,2,2,4
6648_0,,,,2,2,2,4
C(C(C(C(C(CO)O)O)N)O)=O,,,3,1,1,0,1
6649_0,,,,2,2,2,4
6650_0,,,,2,2,2,4
6651_0,,,,2,2,2,4
6652_0,,,,2,2,2,4
6653_0,,,,2,2,2,4
6654_0,,,,2,2,2,4
6655_0,,,,2,2,2,4
6656_0,,,,2,2,2,4
6657_0,,,,2,2,2,4
6658_0,,,,2,2,2,4
6659_0,,,,2,2,2,4
6660_0,,,,2,2,2,4
6661_0,,,,2,2,2,4
6662_0,,,,2,2,2,4
6663_0,,,,2,2,2,4
6664_0,,,,2,2,2,4
6665_0,,,,2,2,2,4
6666_0,,,,2,2,2,4
6667_0,,,,2,2,2,4
6668_0,,,,2,2,2,4
6670_0,,,,2,1,1,2
C12C(C(C(CC1O)(O)O2)O)O,,,3,1,1,0,1
6672_0,,,,2,1,1,2
C1(C2C(C(C(C2O)O1)O)O)O,,,3,1,2,0,2
6672_1,,,,2,1,1,2
6674_0,,,,2,1,1,2
C1(C(C(C(O)O1)O)O)=O,,,3,1,1,0,1
6676_0,,,,2,1,1,2
C1(C(O)OCC1C(C(CO)O)O)=O,,,3,1,1,0,1
6677_0,,,,2,1,1,2
6679_0,,,,2,1,1,2
C(C1(C(CO)C(C(CO)O1)O)O)=O,,,3,1,1,0,1
6680_0,,,,2,1,1,2
6681_0,,,,2,1,1,2
6683_0,,,,2,1,1,2
C(C(C1(C(CO)C(CO1)O)O)O)=O,,,3,1,1,0,1
6685_0,,,,2,1,1,2
C(C(CO)O)(C1COC(C1O)O)=O,,,3,1,1,0,1
6687_0,,,,2,1,1,2
C(C1C(C(CO)C(CO)(O1)O)O)=O,,,3,1,1,0,1
6689_0,,,,2,1,1,2
C(C1C(CC(C(CO)O)(O1)O)O)=O,,,3,1,1,0,1
6691_0,,,,2,1,1,2
C(C1C(C(C(CCO)(O1)O)O)O)=O,,,3,1,1,0,1
6692_0,,,,2,1,1,2
6694_0,,,,2,1,1,2
C(C(C1C(C(C(O)O1)CO)O)O)=O,,,3,1,1,0,1
6695_0,,,,2,1,1,2
6697_0,,,,2,1,1,2
C1(C(O)OC(C(CO)O)C1O)=O,,,3,1,1,0,1
6699_0,,,,2,1,1,2
C(C1(C(C(C(CO)O1)O)O)O)=O,,,3,1,1,0,1
6700_0,,,,2,1,1,2
6701_0,,,,2,1,1,2
6702_0,,,,2,1,1,2
6703_0,,,,2,1,1,2
6704_0,,,,2,1,1,2
6706_0,,,,2,1,1,2
C(C1(C(CC(CO)O1)O)O)=O,,,3,1,1,0,1
6708_0,,,,2,1,1,2
C1(COC(C(CO)O)(C1)O)=O,,,3,1,1,0,1
6709_0,,,,2,1,1,2
6711_0,,,,2,1,1,2
C(C1CC(C(CO)(O1)O)O)=O,,,3,1,1,0,1
6713_0,,,,2,1,1,2
C(CO)(C1CC(C(O1)O)O)=O,,,3,1,1,0,1
6715_0,,,,2,1,1,2
C1(COC(CCO)(C1O)O)=O,,,3,1,1,0,1
6717_0,,,,2,1,1,2
C1(C(CCO)OC(C1O)O)=O,,,3,1,1,0,1
6719_0,,,,2,1,1,2
C(C(C1(C(CCO1)O)O)O)=O,,,3,1,1,0,1
6721_0,,,,2,1,1,2
C(C(C1CC(C(O)O1)O)O)=O,,,3,1,1,0,1
6722_0,,,,2,1,1,2
6724_0,,,,2,1,1,2
CNC1C(O)OC(C1O)C(CO)O,,,3,1,1,0,1
6726_0,,,,2,1,1,2
CNC(CO)C1(C(C(CO1)O)O)O,,,3,1,1,0,1
6728_0,,,,2,1,1,2
C1(C(CNC)(O)OC(CO)C1)=O,,,3,1,1,0,1
6729_0,,,,2,1,1,2
6731_0,,,,2,1,1,2
C(C1(C(CC(CO)O1)NC)O)=O,,,3,1,1,0,1
6733_0,,,,2,1,1,2
C1(C(CO)OC(CNC)(C1)O)=O,,,3,1,1,0,1
6735_0,,,,2,1,1,2
C(C1CC(C(CO)(O1)O)NC)=O,,,3,1,1,0,1
6737_0,,,,2,1,1,2
C(C(C1(C(CCO1)NC)O)O)=O,,,3,1,1,0,1
6739_0,,,,2,1,1,2
C(C(C1CC(C(O)O1)NC)O)=O,,,3,1,1,0,1
6740_0,,,,2,1,1,2
6742_0,,,,2,1,1,2
CNCC1(C(C(C(CO)O1)O)O)O,,,3,1,1,0,1
6743_0,,,,2,1,1,2
6744_0,,,,2,1,1,2
6745_0,,,,2,1,1,2
6746_0,,,,2,1,1,2
6747_0,,,,2,1,1,2
6748_0,,,,2,1,1,2
6749_0,,,,2,1,1,2
6750_0,,,,2,1,1,2
6751_0,,,,2,1,1,2
6753_0,,,,2,1,1,2
C1(C(CC(C(CO)O)(O)O1)O)=O,,,3,1,1,0,1
6755_0,,,,2,1,1,2
C1(C(C(C(CCO)(O)O1)O)O)=O,,,3,1,1,0,1
6756_0,,,,2,1,1,2
6757_0,,,,2,1,1,2
6758_0,,,,2,1,1,2
6759_0,,,,2,1,1,2
6761_0,,,,2,1,1,2
C1(C2(C(C(CC2O)O1)O)O)O,,,3,1,2,0,2
6761_1,,,,2,1,1,2
6763_0,,,,2,1,1,2
C1C(C(C(O)O1)(C(CO)O)O)O,,,3,1,1,0,1
6765_0,,,,2,1,1,2
C(C1(C(O)OCC1O)O)(O)=O,,,3,1,1,0,1
6767_0,,,,2,1,1,2
C(C(C1(C(O)OCC1O)O)O)(O)=O,,,3,1,1,0,1
6769_0,,,,2,1,1,2
C1(C(C(C(O)O1)(C(CO)O)O)O)=O,,,3,1,1,0,1
6771_0,,,,2,1,1,2
C1C(C(C(O)O1)(CO)O)O,,,3,1,1,0,1
6772_0,,,,2,1,1,2
6774_0,,,,2,1,1,2
C(CC1(C(CO)(C(CO1)O)O)O)=O,,,3,1,1,0,1
6775_0,,,,2,1,1,2
6777_0,,,,2,1,1,2
C(C1(COC(C1O)(CCO)O)O)=O,,,3,1,1,0,1
6779_0,,,,2,1,1,2
C(CCO)(C1(COC(C1O)O)O)=O,,,3,1,1,0,1
6780_0,,,,2,1,1,2
6781_0,,,,2,1,1,2
6783_0,,,,2,1,1,2
C(C)(C1C(C(CO)(C(O1)O)O)O)=O,,,3,1,1,0,1
6785_0,,,,2,1,1,2
C(C1C(C(CO)(C(C)(O1)O)O)O)=O,,,3,1,1,0,1
6786_0,,,,2,1,1,2
6787_0,,,,2,1,1,2
6789_0,,,,2,1,1,2
C(CC1C(C(C(O)O1)(CO)O)O)=O,,,3,1,1,0,1
6791_0,,,,2,1,1,2
C(C1(COC(C1)(C(CO)O)O)O)=O,,,3,1,1,0,1
6793_0,,,,2,1,1,2
CNC1C(C(CO)OC1(CO)O)O,,,3,1,1,0,1
6795_0,,,,2,1,1,2
C(CC1(C(C(CO1)O)NC)O)=O,,,3,1,1,0,1
6797_0,,,,2,1,1,2
C(C(C1(CC(CO1)O)O)NC)=O,,,3,1,1,0,1
6799_0,,,,2,1,1,2
C(C1C(C(C(C)(O1)O)NC)O)=O,,,3,1,1,0,1
6801_0,,,,2,1,1,2
C(C(C1CC(C(O)O1)N)O)O,,,3,1,13,0,13
6803_0,,,,2,1,1,2
C(C1C(CC(CN)(O)O1)O)O,,,3,1,13,0,13
6804_0,,,,2,1,1,2
6805_0,,,,2,1,1,2
6806_0,,,,2,1,1,2
6807_0,,,,2,1,1,2
6808_0,,,,2,1,1,2
6809_0,,,,2,1,1,2
6810_0,,,,2,1,1,2
6811_0,,,,2,1,1,2
6813_0,,,,2,1,1,2
C1C2(C(C(C(CO)O2)O1)O)O,,,3,1,1,0,1
6815_0,,,,2,1,1,2
C(C1C2CC(C(O)O2)(O)O1)O,,,3,1,2,0,2
6817_0,,,,2,1,1,2
C1C(C2C(CC(O)O2)(O)O1)O,,,3,1,2,0,2
6819_0,,,,2,1,1,2
CC1(C2C(C(C(O)O2)O1)O)O,,,3,1,2,0,2
6821_0,,,,2,1,1,2
C1(CC2C(C(C(O)O2)O)O1)O,,,3,1,2,0,2
6823_0,,,,2,1,1,2
C1C2C(C(CC(O)O2)(O)O1)O,,,3,1,2,0,2
6825_0,,,,2,1,1,2
C1C2CC(C(C(O)O2)O)(O)O1,,,3,1,2,0,2
6827_0,,,,2,1,1,2
C1C2(C(C(C(CO1)O2)O)O)O,,,3,1,1,0,1
6829_0,,,,2,1,1,2
C1C2C(CC(C(O)O1)(O)O2)O,,,3,1,2,0,2
6831_0,,,,2,1,1,2
C1C(C2(CC(C(O2)O1)O)O)O,,,3,1,1,0,1
6833_0,,,,2,1,1,2
C1CC2(C(C(C(O2)O1)O)O)O,,,3,1,1,0,1
6835_0,,,,2,1,1,2
C1C2(CC(C(C(O)O1)O2)O)O,,,3,1,2,0,2
6837_0,,,,2,1,1,2
C1C(C(C(CCN)(O)O1)O)O,,,3,1,13,0,13
6839_0,,,,2,1,1,2
C1C(CC(C(CN)O)(O)O1)O,,,3,1,13,0,13
6841_0,,,,2,1,1,2
C(C1(CC(C(CN)O1)O)O)O,,,3,1,13,0,13
6843_0,,,,2,1,1,2
CC1(C(C(C(CN)O1)O)O)O,,,3,1,13,0,13
6845_0,,,,2,1,1,2
C1(CC(C(C(CN)O)O1)O)O,,,3,1,13,0,13
6847_0,,,,2,1,1,2
CNC1COC(C1O)O,,,3,1,1,0,1
6849_0,,,,2,1,1,2
CNC1C(CO)OC(CO)(C1O)O,,,3,1,1,0,1
6851_0,,,,2,1,1,2
C(C1(CC(C(CO)O1)NC)O)=O,,,3,1,1,0,1
6852_0,,,,2,1,1,2
6854_0,,,,2,1,1,2
C(CC1(C(C(CO1)NC)O)O)=O,,,3,1,1,0,1
6856_0,,,,2,1,1,2
C(C(C1(CC(CO1)NC)O)O)=O,,,3,1,1,0,1
6857_0,,,,2,1,1,2
6858_0,,,,2,1,1,2
6859_0,,,,2,1,1,2
6861_0,,,,2,1,1,2
C(CC1C(C(C(O)O1)O)NC)=O,,,3,1,1,0,1
6863_0,,,,2,1,1,2
C(C(C1C(CC(O)O1)NC)O)=O,,,3,1,1,0,1
6865_0,,,,2,1,1,2
C(CNC1COC(C1O)O)(O)=O,,,3,1,1,0,1
6867_0,,,,2,1,1,2
CNC1C(C(CO)O)OC(C1O)O,,,3,1,1,0,1
6868_0,,,,2,1,1,2
6869_0,,,,2,1,1,2
6870_0,,,,2,1,1,2
6871_0,,,,2,1,1,2
6873_0,,,,2,1,1,2
C1C(C2CC(C(O)O2)(O)O1)O,,,3,1,2,0,2
6875_0,,,,2,1,1,2
C1(C2C(C(CC(O)O2)O1)O)O,,,3,1,2,0,2
6877_0,,,,2,1,1,2
C(C(C1C(CC(O)O1)N)O)O,,,3,1,13,0,13
6879_0,,,,2,1,1,2
CC(C1C(C(C(O)O1)O)O)N,,,3,1,13,0,13
6881_0,,,,2,1,1,2
C1(C(C(C(CCN)O1)O)O)O,,,3,1,13,0,13
6882_0,,,,2,1,1,2
6884_0,,,,2,1,1,2
C(C1(C(CO)C(C(CO1)O)O)O)=O,,,3,1,1,0,1
6885_0,,,,2,1,1,2
6887_0,,,,2,1,1,2
C1(C(C(O)OCC1C(CO)O)O)=O,,,3,1,1,0,1
6888_0,,,,2,1,1,2
6889_0,,,,2,1,1,2
6891_0,,,,2,1,1,2
C(CO)(C1COC(C(C1O)O)O)=O,,,3,1,1,0,1
6893_0,,,,2,1,1,2
C(C1C(C(C(CO)C(O1)O)O)O)=O,,,3,1,1,0,1
6895_0,,,,2,1,1,2
C1(C(O)OC(CO)C(C1O)O)=O,,,3,1,1,0,1
6897_0,,,,2,1,1,2
C(C1(C(C(C(CO1)O)O)O)O)=O,,,3,1,1,0,1
6898_0,,,,2,1,1,2
6899_0,,,,2,1,1,2
6900_0,,,,2,1,1,2
6901_0,,,,2,1,1,2
6903_0,,,,2,1,1,2
C(C1(C(CC(CO1)O)O)O)=O,,,3,1,1,0,1
6904_0,,,,2,1,1,2
6905_0,,,,2,1,1,2
6907_0,,,,2,1,1,2
C1(COC(CO)(CC1O)O)=O,,,3,1,1,0,1
6908_0,,,,2,1,1,2
6910_0,,,,2,1,1,2
C(C1C(CC(C(O1)O)O)O)=O,,,3,1,1,0,1
6912_0,,,,2,1,1,2
C(C1CC(C(C(O1)O)O)O)=O,,,3,1,1,0,1
6914_0,,,,2,1,1,2
C1(COC(C)(C(C1O)O)O)=O,,,3,1,1,0,1
6916_0,,,,2,1,1,2
C1(C(C)OC(C(C1O)O)O)=O,,,3,1,1,0,1
6918_0,,,,2,1,1,2
CNC1C(O)OC(CO)C(C1O)O,,,3,1,1,0,1
6919_0,,,,2,1,1,2
6921_0,,,,2,1,1,2
C1(C(CNC)(O)OCC(C1)O)=O,,,3,1,1,0,1
6922_0,,,,2,1,1,2
6924_0,,,,2,1,1,2
C(C1(C(CC(CO1)O)NC)O)=O,,,3,1,1,0,1
6926_0,,,,2,1,1,2
C1(C(COC(CNC)(C1)O)O)=O,,,3,1,1,0,1
6928_0,,,,2,1,1,2
C1(C(C(CNC)(O)OCC1)O)=O,,,3,1,1,0,1
6930_0,,,,2,1,1,2
C1(COC(C(C1)O)(CNC)O)=O,,,3,1,1,0,1
6932_0,,,,2,1,1,2
C(C1C(CC(C(O1)O)NC)O)=O,,,3,1,1,0,1
6934_0,,,,2,1,1,2
CNCC1(C(C(C(CO1)O)O)O)O,,,3,1,1,0,1
6935_0,,,,2,1,1,2
6937_0,,,,2,1,1,2
CC1(C(C(C(CO1)O)O)O)O,,,3,1,1,0,1
6938_0,,,,2,1,1,2
6939_0,,,,2,1,1,2
6941_0,,,,2,1,1,2
C1(C(C(CC(CO)(O)O1)O)O)=O,,,3,1,1,0,1
6943_0,,,,2,1,1,2
C1(C(C(C(C(C)(O)O1)O)O)O)=O,,,3,1,1,0,1
6944_0,,,,2,1,1,2
6946_0,,,,2,1,1,2
C1(CC(O)OCC1(C(CO)O)O)=O,,,3,1,1,0,1
6947_0,,,,2,1,1,2
6948_0,,,,2,1,1,2
6949_0,,,,2,1,1,2
6951_0,,,,2,1,1,2
C(C1(COC(CO)(CC1O)O)O)=O,,,3,1,1,0,1
6953_0,,,,2,1,1,2
C(C1(COC(C)(C(C1O)O)O)O)=O,,,3,1,1,0,1
6955_0,,,,2,1,1,2
C(C)(C1(COC(C(C1O)O)O)O)=O,,,3,1,1,0,1
6956_0,,,,2,1,1,2
6958_0,,,,2,1,1,2
C1(C(CO)OC(C(CO)(C1)O)O)=O,,,3,1,1,0,1
6960_0,,,,2,1,1,2
CNC1C(CO)(O)OCC(C1O)O,,,3,1,1,0,1
6961_0,,,,2,1,1,2
6962_0,,,,2,1,1,2
6964_0,,,,2,1,1,2
C(C1C(CC(C(O)O1)N)O)O,,,3,1,13,0,13
6966_0,,,,2,1,1,2
C1C(C(CC(CN)(O)O1)O)O,,,3,1,13,0,13
6967_0,,,,2,1,1,2
6968_0,,,,2,1,1,2
6969_0,,,,2,1,1,2
6970_0,,,,2,1,1,2
6972_0,,,,2,1,1,2
C1C2(C(C(C(CO2)O)O1)O)O,,,3,1,1,0,1
6973_0,,,,2,1,1,2
6974_0,,,,2,1,1,2
6976_0,,,,2,1,1,2
C1C2(C(C(C(CO2)O1)O)O)O,,,3,1,1,0,1
6978_0,,,,2,1,1,2
C1C2C(CC(C(O)O2)(O)O1)O,,,3,1,2,0,2
6980_0,,,,2,1,1,2
C1(CC(C(C(CN)O1)O)O)O,,,3,1,13,0,13
6982_0,,,,2,1,1,2
CNC1C(C(CO)(O)OCC1O)O,,,3,1,1,0,1
6983_0,,,,2,1,1,2
6985_0,,,,2,1,1,2
C(C1(CC(C(CO1)O)NC)O)=O,,,3,1,1,0,1
6986_0,,,,2,1,1,2
6987_0,,,,2,1,1,2
6988_0,,,,2,1,1,2
6990_0,,,,2,1,1,2
C(C1C(C(CC(O1)O)NC)O)=O,,,3,1,1,0,1
6992_0,,,,2,1,1,2
CNC1C(C(CO)OC(C1O)O)O,,,3,1,1,0,1
6993_0,,,,2,1,1,2
6994_0,,,,2,1,1,2
6995_0,,,,2,1,1,2
6997_0,,,,2,1,1,2
C(C1C(C(CC(O)O1)N)O)O,,,3,1,13,0,13
6999_0,,,,2,1,1,2
C(C1CC(C(C(O)O1)O)N)O,,,3,1,13,0,13
7001_0,,,,2,1,1,2
C(C1C(CC(C(O)O1)O)N)O,,,3,1,13,0,13
7002_0,,,,2,1,1,2
7003_0,,,,2,1,1,2
7004_0,,,,2,1,1,2
7005_0,,,,2,1,1,2
7006_0,,,,2,1,1,2
7007_0,,,,2,1,1,2
7008_0,,,,2,1,1,2
7010_0,,,,2,1,1,2
C(C1COC(C(C(C1O)O)O)O)=O,,,3,1,1,0,1
7012_0,,,,2,1,1,2
C1(C(O)OCC(C(C1O)O)O)=O,,,3,1,1,0,1
7013_0,,,,2,1,1,2
7014_0,,,,2,1,1,2
7015_0,,,,2,1,1,2
7016_0,,,,2,1,1,2
7018_0,,,,2,1,1,2
C1(COC(CC(C1O)O)O)=O,,,3,1,1,0,1
7020_0,,,,2,1,1,2
CNC1C(O)OCC(C(C1O)O)O,,,3,1,1,0,1
7021_0,,,,2,1,1,2
7022_0,,,,2,1,1,2
7023_0,,,,2,1,1,2
7024_0,,,,2,1,1,2
7026_0,,,,2,1,1,2
C1C(C(C(CC(O)O1)O)O)O,,,3,1,1,0,1
7028_0,,,,2,1,1,2
C1CC(C(C(C(O)O1)O)O)O,,,3,1,1,0,1
7030_0,,,,2,1,1,2
C1(C(C(C(CC(O)O1)O)O)O)=O,,,3,1,1,0,1
7032_0,,,,2,1,1,2
C1(CC(C(C(C(O)O1)O)O)O)=O,,,3,1,1,0,1
7033_0,,,,2,1,1,2
7034_0,,,,2,1,1,2
7035_0,,,,2,1,1,2
7037_0,,,,2,1,1,2
C1(C(C(C(O)OCC1)(CO)O)O)=O,,,3,1,1,0,1
7038_0,,,,2,1,1,2
7040_0,,,,2,1,1,2
C1(COC(C(CO)(C(C1)O)O)O)=O,,,3,1,1,0,1
7042_0,,,,2,1,1,2
C(C1(COC(CC(C1O)O)O)O)=O,,,3,1,1,0,1
7044_0,,,,2,1,1,2
C1(C(COC(C(CO)(C1)O)O)O)=O,,,3,1,1,0,1
7045_0,,,,2,1,1,2
7046_0,,,,2,1,1,2
7047_0,,,,2,1,1,2
7048_0,,,,2,1,1,2
7050_0,,,,2,1,1,2
C1C(C(CC(C(O)O1)N)O)O,,,3,1,13,0,13
7051_0,,,,2,1,1,2
7052_0,,,,2,1,1,2
7053_0,,,,2,1,1,2
7054_0,,,,2,1,1,2
7056_0,,,,2,1,1,2
C12C(C(C(CC(O)O1)O2)O)O,,,3,1,1,0,1
7057_0,,,,2,1,1,2
7058_0,,,,2,1,1,2
7059_0,,,,2,1,1,2
7060_0,,,,2,1,1,2
7061_0,,,,2,1,1,2
7062_0,,,,2,1,1,2
7064_0,,,,2,1,1,2
CNC1C(C(COC(C1O)O)O)O,,,3,1,1,0,1
7065_0,,,,2,1,1,2
7066_0,,,,2,1,1,2
7068_0,,,,2,1,1,2
C12CC(C(C(C(O)O1)O)O2)O,,,3,1,1,0,1
7070_0,,,,2,1,1,2
C1C(C(C(CC(O)O1)N)O)O,,,3,1,13,0,13
7072_0,,,,2,1,1,2
C1C(CC(C(C(O)O1)O)N)O,,,3,1,13,0,13
7074_0,,,,2,1,1,2
C1C(C(CC(C(O)O1)O)N)O,,,3,1,13,0,13
7076_0,,,,2,1,1,2
C1CC(C(C(C(O)O1)O)O)N,,,3,1,13,0,13
7078_0,,,,2,1,1,2
C1C(CC(C(C(O)O1)O)O)N,,,3,1,13,0,13
7079_0,,,,2,1,1,2
7080_0,,,,2,1,1,2
7081_0,,,,2,1,1,2
7082_0,,,,2,1,1,2
7083_0,,,,2,1,1,2
7084_0,,,,2,1,1,2
7085_0,,,,2,1,1,2
7086_0,,,,2,1,1,2
7087_0,,,,2,1,1,2
7088_0,,,,2,1,1,2
7089_0,,,,2,1,1,2
7090_0,,,,2,1,1,2
7091_0,,,,2,1,1,2
7092_0,,,,2,1,1,2
7093_0,,,,2,1,1,2
7094_0,,,,2,1,1,2
7095_0,,,,2,1,1,2
7096_0,,,,2,1,1,2
7097_0,,,,2,1,1,2
7098_0,,,,2,1,1,2
7099_0,,,,2,1,1,2
7100_0,,,,2,1,1,2
7101_0,,,,2,1,1,2
7102_0,,,,2,1,1,2
7103_0,,,,2,1,1,2
7105_0,,,,2,2,2,4
C(C(C(CO)O)=O)(O)=O,,,3,1,296,0,296
7105_1,,,,2,2,2,4
7106_0,,,,2,2,2,4
7106_1,,,,2,2,2,4
7108_0,,,,2,2,2,4
C(C(C(O)=O)=O)(O)=O,,,3,1,296,0,296
7108_1,,,,2,2,2,4
7110_0,,,,2,2,2,4
C(C(C(C(O)=O)=O)O)(O)=O,,,3,1,296,0,296
7110_1,,,,2,2,2,4
7111_0,,,,2,2,2,4
7111_1,,,,2,2,2,4
7112_0,,,,2,2,2,4
7113_0,,,,2,2,2,4
7114_0,,,,2,2,2,4
7115_0,,,,2,2,2,4
7116_0,,,,2,2,2,4
7117_0,,,,2,2,2,4
7118_0,,,,2,2,2,4
7119_0,,,,2,2,2,4
7120_0,,,,2,2,2,4
7121_0,,,,2,2,2,4
7122_0,,,,2,2,2,4
7123_0,,,,2,2,2,4
7124_0,,,,2,2,2,4
7125_0,,,,2,2,2,4
7126_0,,,,2,2,2,4
7127_0,,,,2,2,2,4
7128_0,,,,2,2,2,4
7129_0,,,,2,2,2,4
7130_0,,,,2,2,2,4
7131_0,,,,2,2,2,4
7131_1,,,,2,2,2,4
7132_0,,,,2,2,2,4
7133_0,,,,2,2,2,4
7134_0,,,,2,2,2,4
7134_1,,,,2,2,2,4
7135_0,,,,2,2,2,4
7135_1,,,,2,2,2,4
7136_0,,,,2,2,2,4
7136_1,,,,2,2,2,4
7137_0,,,,2,2,2,4
7137_1,,,,2,2,2,4
7138_0,,,,2,2,2,4
7138_1,,,,2,2,2,4
7139_0,,,,2,2,2,4
7140_0,,,,2,2,2,4
7141_0,,,,2,2,2,4
7142_0,,,,2,2,2,4
7143_0,,,,2,2,2,4
7144_0,,,,2,2,2,4
7145_0,,,,2,2,2,4
7146_0,,,,2,2,2,4
7147_0,,,,2,2,2,4
7148_0,,,,2,2,2,4
7149_0,,,,2,2,2,4
7150_0,,,,2,2,2,4
7151_0,,,,2,2,2,4
7152_0,,,,2,2,2,4
7153_0,,,,2,2,2,4
7154_0,,,,2,2,2,4
7155_0,,,,2,2,2,4
7156_0,,,,2,2,2,4
7157_0,,,,2,2,2,4
7159_0,,,,2,2,2,4
C(C1C(C(C(C1N)O)O)O)O,,,3,1,12,0,12
7160_0,,,,2,2,2,4
7161_0,,,,2,2,2,4
7162_0,,,,2,2,2,4
7163_0,,,,2,2,2,4
7165_0,,,,2,2,2,4
C1C(C(C(C(C1N)O)O)O)O,,,3,1,12,0,12
7166_0,,,,2,2,2,4
7167_0,,,,2,2,2,4
7168_0,,,,2,2,2,4
7169_0,,,,2,2,2,4
7171_0,,,,2,2,2,4
C(C1C(C(C(C1O)O)O)O)N,,,3,1,12,0,12
7172_0,,,,2,2,2,4
7173_0,,,,2,2,2,4
7174_0,,,,2,2,2,4
7175_0,,,,2,2,2,4
7176_0,,,,2,2,2,4
7177_0,,,,2,2,2,4
7178_0,,,,2,2,2,4
7179_0,,,,2,2,2,4
7180_0,,,,2,2,2,4
7182_0,,,,2,2,2,4
C(C(C(CN)O)O)(O)=O,,,3,1,12,0,12
7183_0,,,,2,2,2,4
7184_0,,,,2,2,2,4
7185_0,,,,2,2,2,4
7186_0,,,,2,2,2,4
7187_0,,,,2,2,2,4
7188_0,,,,2,2,2,4
7189_0,,,,2,2,2,4
7190_0,,,,2,2,2,4
7191_0,,,,2,2,2,4
7192_0,,,,2,2,2,4
7193_0,,,,2,2,2,4
7194_0,,,,2,2,2,4
7195_0,,,,2,2,2,4
7196_0,,,,2,2,2,4
7197_0,,,,2,2,2,4
7198_0,,,,2,2,2,4
7199_0,,,,2,2,2,4
7200_0,,,,2,2,2,4
7201_0,,,,2,2,2,4
7202_0,,,,2,2,2,4
7203_0,,,,2,2,2,4
7204_0,,,,2,2,2,4
7205_0,,,,2,2,2,4
7206_0,,,,2,2,2,4
7207_0,,,,2,2,2,4
7208_0,,,,2,2,2,4
7209_0,,,,2,2,2,4
7210_0,,,,2,2,2,4
7211_0,,,,2,2,2,4
7212_0,,,,2,2,2,4
7214_0,,,,2,2,2,4
C(C(C(C(CO)C(CO)O)N)O)=O,,,3,1,12,0,12
7215_0,,,,2,2,2,4
7216_0,,,,2,2,2,4
7217_0,,,,2,2,2,4
7218_0,,,,2,2,2,4
7219_0,,,,2,2,2,4
7220_0,,,,2,2,2,4
7221_0,,,,2,2,2,4
7222_0,,,,2,2,2,4
7223_0,,,,2,2,2,4
7225_0,,,,2,2,2,4
C(C(C(CO)C(C(CO)O)N)O)=O,,,3,1,12,0,12
7226_0,,,,2,2,2,4
7227_0,,,,2,2,2,4
7228_0,,,,2,2,2,4
7229_0,,,,2,2,2,4
7230_0,,,,2,2,2,4
7231_0,,,,2,2,2,4
7232_0,,,,2,2,2,4
7233_0,,,,2,2,2,4
7234_0,,,,2,2,2,4
7236_0,,,,2,2,2,4
C(C(C(C(C(CO)CO)N)O)O)=O,,,3,1,12,0,12
7237_0,,,,2,2,2,4
7238_0,,,,2,2,2,4
7239_0,,,,2,2,2,4
7240_0,,,,2,2,2,4
7241_0,,,,2,2,2,4
7242_0,,,,2,2,2,4
7243_0,,,,2,2,2,4
7244_0,,,,2,2,2,4
7245_0,,,,2,2,2,4
7247_0,,,,2,2,2,4
C(C(C(C(CO)C(CO)N)O)O)=O,,,3,1,12,0,12
7248_0,,,,2,2,2,4
7249_0,,,,2,2,2,4
7250_0,,,,2,2,2,4
7251_0,,,,2,2,2,4
7252_0,,,,2,2,2,4
7253_0,,,,2,2,2,4
7254_0,,,,2,2,2,4
7255_0,,,,2,2,2,4
7256_0,,,,2,2,2,4
7258_0,,,,2,2,2,4
C(C(C(CC(C(CO)O)N)O)O)=O,,,3,1,12,0,12
7259_0,,,,2,2,2,4
7260_0,,,,2,2,2,4
7261_0,,,,2,2,2,4
7262_0,,,,2,2,2,4
7263_0,,,,2,2,2,4
7264_0,,,,2,2,2,4
7265_0,,,,2,2,2,4
7266_0,,,,2,2,2,4
7267_0,,,,2,2,2,4
7269_0,,,,2,2,2,4
C(C(C(C(C(CCO)N)O)O)O)=O,,,3,1,12,0,12
7270_0,,,,2,2,2,4
7271_0,,,,2,2,2,4
7272_0,,,,2,2,2,4
7273_0,,,,2,2,2,4
7274_0,,,,2,2,2,4
7275_0,,,,2,2,2,4
7276_0,,,,2,2,2,4
7277_0,,,,2,2,2,4
7278_0,,,,2,2,2,4
7280_0,,,,2,2,2,4
C(C(C(C(C(CO)CN)O)O)O)=O,,,3,1,12,0,12
7281_0,,,,2,2,2,4
7282_0,,,,2,2,2,4
7283_0,,,,2,2,2,4
7284_0,,,,2,2,2,4
7285_0,,,,2,2,2,4
7286_0,,,,2,2,2,4
7287_0,,,,2,2,2,4
7288_0,,,,2,2,2,4
7289_0,,,,2,2,2,4
7290_0,,,,2,2,2,4
7291_0,,,,2,2,2,4
7292_0,,,,2,2,2,4
7293_0,,,,2,2,2,4
7294_0,,,,2,2,2,4
7295_0,,,,2,2,2,4
7296_0,,,,2,2,2,4
7297_0,,,,2,2,2,4
7298_0,,,,2,2,2,4
7300_0,,,,2,2,2,4
C(C(CO)N)O,,,3,1,12,0,12
7301_0,,,,2,2,2,4
7302_0,,,,2,2,2,4
7303_0,,,,2,2,2,4
7304_0,,,,2,2,2,4
7305_0,,,,2,2,2,4
7306_0,,,,2,2,2,4
7307_0,,,,2,2,2,4
7308_0,,,,2,2,2,4
7309_0,,,,2,2,2,4
7310_0,,,,2,2,2,4
7311_0,,,,2,2,2,4
7312_0,,,,2,2,2,4
7313_0,,,,2,2,2,4
7314_0,,,,2,2,2,4
7315_0,,,,2,2,2,4
7316_0,,,,2,2,2,4
7317_0,,,,2,2,2,4
7318_0,,,,2,2,2,4
7319_0,,,,2,2,2,4
7320_0,,,,2,2,2,4
7321_0,,,,2,2,2,4
7322_0,,,,2,2,2,4
7323_0,,,,2,2,2,4
7324_0,,,,2,2,2,4
7325_0,,,,2,2,2,4
7326_0,,,,2,2,2,4
7327_0,,,,2,2,2,4
7328_0,,,,2,2,2,4
7329_0,,,,2,2,2,4
7330_0,,,,2,2,2,4
7331_0,,,,2,2,2,4
7332_0,,,,2,2,2,4
7333_0,,,,2,2,2,4
7334_0,,,,2,2,2,4
7335_0,,,,2,2,2,4
7336_0,,,,2,2,2,4
7337_0,,,,2,2,2,4
7338_0,,,,2,2,2,4
7339_0,,,,2,2,2,4
7341_0,,,,2,2,2,4
CC(C(CO)O)N,,,3,1,12,0,12
7342_0,,,,2,2,2,4
7343_0,,,,2,2,2,4
7344_0,,,,2,2,2,4
7345_0,,,,2,2,2,4
7346_0,,,,2,2,2,4
7348_0,,,,2,2,2,4
C(C(CC(CO)N)O)=O,,,3,1,12,0,12
7349_0,,,,2,2,2,4
7350_0,,,,2,2,2,4
7351_0,,,,2,2,2,4
7352_0,,,,2,2,2,4
7353_0,,,,2,2,2,4
7354_0,,,,2,2,2,4
7355_0,,,,2,2,2,4
7356_0,,,,2,2,2,4
7357_0,,,,2,2,2,4
7358_0,,,,2,2,2,4
7359_0,,,,2,2,2,4
7360_0,,,,2,2,2,4
7361_0,,,,2,2,2,4
7362_0,,,,2,2,2,4
7363_0,,,,2,2,2,4
7364_0,,,,2,2,2,4
7365_0,,,,2,2,2,4
7366_0,,,,2,2,2,4
7368_0,,,,2,2,2,4
C(C(CCO)N)O,,,3,1,12,0,12
7369_0,,,,2,2,2,4
7370_0,,,,2,2,2,4
7371_0,,,,2,2,2,4
7372_0,,,,2,2,2,4
7373_0,,,,2,2,2,4
7375_0,,,,2,2,2,4
C(C(C(C(C)N)O)O)=O,,,3,1,12,0,12
7376_0,,,,2,2,2,4
7377_0,,,,2,2,2,4
7378_0,,,,2,2,2,4
7379_0,,,,2,2,2,4
7380_0,,,,2,2,2,4
7381_0,,,,2,2,2,4
7382_0,,,,2,2,2,4
7383_0,,,,2,2,2,4
7384_0,,,,2,2,2,4
7385_0,,,,2,2,2,4
7386_0,,,,2,2,2,4
7387_0,,,,2,2,2,4
7388_0,,,,2,2,2,4
7390_0,,,,2,2,2,4
CC(CO)N,,,3,1,12,0,12
7391_0,,,,2,2,2,4
7392_0,,,,2,2,2,4
7393_0,,,,2,2,2,4
7394_0,,,,2,2,2,4
7395_0,,,,2,2,2,4
7396_0,,,,2,2,2,4
7397_0,,,,2,2,2,4
7398_0,,,,2,2,2,4
7399_0,,,,2,2,2,4
7400_0,,,,2,2,2,4
7401_0,,,,2,2,2,4
7402_0,,,,2,2,2,4
7403_0,,,,2,2,2,4
7404_0,,,,2,2,2,4
7405_0,,,,2,2,2,4
7406_0,,,,2,2,2,4
7407_0,,,,2,2,2,4
7408_0,,,,2,2,2,4
7409_0,,,,2,2,2,4
7411_0,,,,2,2,2,4
CCN,,,3,1,12,0,12
7412_0,,,,2,2,2,4
7413_0,,,,2,2,2,4
7414_0,,,,2,2,2,4
7415_0,,,,2,2,2,4
7417_0,,,,2,2,2,4
C(C(C(CO)O)N)O,,,3,1,12,0,12
7418_0,,,,2,2,2,4
7419_0,,,,2,2,2,4
7420_0,,,,2,2,2,4
7421_0,,,,2,2,2,4
7422_0,,,,2,2,2,4
7423_0,,,,2,2,2,4
7424_0,,,,2,2,2,4
7425_0,,,,2,2,2,4
7426_0,,,,2,2,2,4
7427_0,,,,2,2,2,4
7429_0,,,,2,2,2,4
C(CC(C(C(CO)O)N)O)=O,,,3,1,12,0,12
7430_0,,,,2,2,2,4
7431_0,,,,2,2,2,4
7432_0,,,,2,2,2,4
7433_0,,,,2,2,2,4
7434_0,,,,2,2,2,4
7435_0,,,,2,2,2,4
7436_0,,,,2,2,2,4
7437_0,,,,2,2,2,4
7438_0,,,,2,2,2,4
7439_0,,,,2,2,2,4
7440_0,,,,2,2,2,4
7441_0,,,,2,2,2,4
7442_0,,,,2,2,2,4
7443_0,,,,2,2,2,4
7444_0,,,,2,2,2,4
7445_0,,,,2,2,2,4
7446_0,,,,2,2,2,4
7447_0,,,,2,2,2,4
7448_0,,,,2,2,2,4
7449_0,,,,2,2,2,4
7450_0,,,,2,2,2,4
7451_0,,,,2,2,2,4
7452_0,,,,2,2,2,4
7453_0,,,,2,2,2,4
7454_0,,,,2,2,2,4
7455_0,,,,2,2,2,4
7456_0,,,,2,2,2,4
7457_0,,,,2,2,2,4
7458_0,,,,2,2,2,4
7459_0,,,,2,2,2,4
7460_0,,,,2,2,2,4
7461_0,,,,2,2,2,4
7462_0,,,,2,2,2,4
7463_0,,,,2,2,2,4
7464_0,,,,2,2,2,4
7465_0,,,,2,2,2,4
7466_0,,,,2,2,2,4
7467_0,,,,2,2,2,4
7468_0,,,,2,2,2,4
7470_0,,,,2,2,2,4
C(C(CC(C(CO)N)O)O)=O,,,3,1,12,0,12
7471_0,,,,2,2,2,4
7472_0,,,,2,2,2,4
7473_0,,,,2,2,2,4
7474_0,,,,2,2,2,4
7475_0,,,,2,2,2,4
7476_0,,,,2,2,2,4
7477_0,,,,2,2,2,4
7478_0,,,,2,2,2,4
7479_0,,,,2,2,2,4
7480_0,,,,2,2,2,4
7481_0,,,,2,2,2,4
7482_0,,,,2,2,2,4
7483_0,,,,2,2,2,4
7484_0,,,,2,2,2,4
7485_0,,,,2,2,2,4
7486_0,,,,2,2,2,4
7487_0,,,,2,2,2,4
7488_0,,,,2,2,2,4
7489_0,,,,2,2,2,4
7490_0,,,,2,2,2,4
7491_0,,,,2,2,2,4
7492_0,,,,2,2,2,4
7493_0,,,,2,2,2,4
7494_0,,,,2,2,2,4
7495_0,,,,2,2,2,4
7496_0,,,,2,2,2,4
7497_0,,,,2,2,2,4
7498_0,,,,2,2,2,4
7499_0,,,,2,2,2,4
7500_0,,,,2,2,2,4
7501_0,,,,2,2,2,4
7502_0,,,,2,2,2,4
7503_0,,,,2,2,2,4
7504_0,,,,2,2,2,4
7505_0,,,,2,2,2,4
7506_0,,,,2,2,2,4
7507_0,,,,2,2,2,4
7508_0,,,,2,2,2,4
7509_0,,,,2,2,2,4
7511_0,,,,2,2,2,4
C(C(C(CC(CN)O)O)O)=O,,,3,1,12,0,12
7512_0,,,,2,2,2,4
7513_0,,,,2,2,2,4
7514_0,,,,2,2,2,4
7515_0,,,,2,2,2,4
7516_0,,,,2,2,2,4
7517_0,,,,2,2,2,4
7518_0,,,,2,2,2,4
7519_0,,,,2,2,2,4
7520_0,,,,2,2,2,4
7521_0,,,,2,2,2,4
7522_0,,,,2,2,2,4
7523_0,,,,2,2,2,4
7524_0,,,,2,2,2,4
7525_0,,,,2,2,2,4
7526_0,,,,2,2,2,4
7527_0,,,,2,2,2,4
7528_0,,,,2,2,2,4
7529_0,,,,2,2,2,4
7530_0,,,,2,2,2,4
7532_0,,,,2,2,2,4
C(C(C(C(C(C)O)N)O)O)=O,,,3,1,12,0,12
7533_0,,,,2,2,2,4
7534_0,,,,2,2,2,4
7535_0,,,,2,2,2,4
7536_0,,,,2,2,2,4
7537_0,,,,2,2,2,4
7538_0,,,,2,2,2,4
7539_0,,,,2,2,2,4
7540_0,,,,2,2,2,4
7541_0,,,,2,2,2,4
7542_0,,,,2,2,2,4
7543_0,,,,2,2,2,4
7544_0,,,,2,2,2,4
7545_0,,,,2,2,2,4
7546_0,,,,2,2,2,4
7547_0,,,,2,2,2,4
7548_0,,,,2,2,2,4
7549_0,,,,2,2,2,4
7550_0,,,,2,2,2,4
7552_0,,,,2,2,2,4
CNCCN,,,3,1,12,0,12
7553_0,,,,2,2,2,4
7554_0,,,,2,2,2,4
7555_0,,,,2,2,2,4
7556_0,,,,2,2,2,4
7558_0,,,,2,2,2,4
CNCC(C(CO)O)N,,,3,1,12,0,12
7559_0,,,,2,2,2,4
7560_0,,,,2,2,2,4
7561_0,,,,2,2,2,4
7562_0,,,,2,2,2,4
7563_0,,,,2,2,2,4
7564_0,,,,2,2,2,4
7565_0,,,,2,2,2,4
7566_0,,,,2,2,2,4
7567_0,,,,2,2,2,4
7569_0,,,,2,2,2,4
CNC(CO)C(C(C(CO)O)O)N,,,3,1,12,0,12
7570_0,,,,2,2,2,4
7571_0,,,,2,2,2,4
7572_0,,,,2,2,2,4
7573_0,,,,2,2,2,4
7574_0,,,,2,2,2,4
7576_0,,,,2,2,2,4
C(CC(C(C(CO)O)N)NC)=O,,,3,1,12,0,12
7577_0,,,,2,2,2,4
7578_0,,,,2,2,2,4
7579_0,,,,2,2,2,4
7580_0,,,,2,2,2,4
7581_0,,,,2,2,2,4
7582_0,,,,2,2,2,4
7583_0,,,,2,2,2,4
7584_0,,,,2,2,2,4
7585_0,,,,2,2,2,4
7586_0,,,,2,2,2,4
7587_0,,,,2,2,2,4
7588_0,,,,2,2,2,4
7589_0,,,,2,2,2,4
7590_0,,,,2,2,2,4
7591_0,,,,2,2,2,4
7592_0,,,,2,2,2,4
7593_0,,,,2,2,2,4
7594_0,,,,2,2,2,4
7595_0,,,,2,2,2,4
7596_0,,,,2,2,2,4
7597_0,,,,2,2,2,4
7598_0,,,,2,2,2,4
7599_0,,,,2,2,2,4
7600_0,,,,2,2,2,4
7601_0,,,,2,2,2,4
7602_0,,,,2,2,2,4
7603_0,,,,2,2,2,4
7604_0,,,,2,2,2,4
7606_0,,,,2,2,2,4
C(C(CO)O)(CC(CNC)N)=O,,,3,1,12,0,12
7607_0,,,,2,2,2,4
7608_0,,,,2,2,2,4
7609_0,,,,2,2,2,4
7610_0,,,,2,2,2,4
7611_0,,,,2,2,2,4
7612_0,,,,2,2,2,4
7613_0,,,,2,2,2,4
7614_0,,,,2,2,2,4
7615_0,,,,2,2,2,4
7616_0,,,,2,2,2,4
7618_0,,,,2,2,2,4
C(C(CC(C(CO)N)NC)O)=O,,,3,1,12,0,12
7619_0,,,,2,2,2,4
7620_0,,,,2,2,2,4
7621_0,,,,2,2,2,4
7622_0,,,,2,2,2,4
7623_0,,,,2,2,2,4
7624_0,,,,2,2,2,4
7625_0,,,,2,2,2,4
7626_0,,,,2,2,2,4
7628_0,,,,2,2,2,4
C(C(C(CNC)N)O)(CCO)=O,,,3,1,12,0,12
7629_0,,,,2,2,2,4
7630_0,,,,2,2,2,4
7631_0,,,,2,2,2,4
7632_0,,,,2,2,2,4
7633_0,,,,2,2,2,4
7634_0,,,,2,2,2,4
7635_0,,,,2,2,2,4
7636_0,,,,2,2,2,4
7637_0,,,,2,2,2,4
7638_0,,,,2,2,2,4
7640_0,,,,2,2,2,4
C(C(C(C(CCO)NC)N)O)=O,,,3,1,12,0,12
7641_0,,,,2,2,2,4
7642_0,,,,2,2,2,4
7643_0,,,,2,2,2,4
7644_0,,,,2,2,2,4
7645_0,,,,2,2,2,4
7646_0,,,,2,2,2,4
7647_0,,,,2,2,2,4
7648_0,,,,2,2,2,4
7650_0,,,,2,2,2,4
C(CO)(CC(C(CNC)N)O)=O,,,3,1,12,0,12
7651_0,,,,2,2,2,4
7652_0,,,,2,2,2,4
7653_0,,,,2,2,2,4
7654_0,,,,2,2,2,4
7655_0,,,,2,2,2,4
7656_0,,,,2,2,2,4
7657_0,,,,2,2,2,4
7658_0,,,,2,2,2,4
7659_0,,,,2,2,2,4
7660_0,,,,2,2,2,4
7662_0,,,,2,2,2,4
C(C(C(CC(CN)NC)O)O)=O,,,3,1,12,0,12
7663_0,,,,2,2,2,4
7664_0,,,,2,2,2,4
7665_0,,,,2,2,2,4
7666_0,,,,2,2,2,4
7667_0,,,,2,2,2,4
7668_0,,,,2,2,2,4
7669_0,,,,2,2,2,4
7670_0,,,,2,2,2,4
7672_0,,,,2,2,2,4
C(C)(C(C(C(CNC)N)O)O)=O,,,3,1,12,0,12
7673_0,,,,2,2,2,4
7674_0,,,,2,2,2,4
7675_0,,,,2,2,2,4
7676_0,,,,2,2,2,4
7677_0,,,,2,2,2,4
7678_0,,,,2,2,2,4
7679_0,,,,2,2,2,4
7680_0,,,,2,2,2,4
7681_0,,,,2,2,2,4
7682_0,,,,2,2,2,4
7684_0,,,,2,2,2,4
C(C(C(C(C(C)NC)N)O)O)=O,,,3,1,12,0,12
7685_0,,,,2,2,2,4
7686_0,,,,2,2,2,4
7687_0,,,,2,2,2,4
7688_0,,,,2,2,2,4
7689_0,,,,2,2,2,4
7690_0,,,,2,2,2,4
7691_0,,,,2,2,2,4
7692_0,,,,2,2,2,4
7694_0,,,,2,2,2,4
C(CC(C(C(CNC)N)O)O)=O,,,3,1,12,0,12
7695_0,,,,2,2,2,4
7696_0,,,,2,2,2,4
7697_0,,,,2,2,2,4
7698_0,,,,2,2,2,4
7699_0,,,,2,2,2,4
7700_0,,,,2,2,2,4
7701_0,,,,2,2,2,4
7702_0,,,,2,2,2,4
7703_0,,,,2,2,2,4
7705_0,,,,2,2,2,4
C(CNCCN)(O)=O,,,3,1,12,0,12
7706_0,,,,2,2,2,4
7707_0,,,,2,2,2,4
7708_0,,,,2,2,2,4
7709_0,,,,2,2,2,4
7711_0,,,,2,2,2,4
C(CNCC(C(CO)O)N)(O)=O,,,3,1,12,0,12
7712_0,,,,2,2,2,4
7713_0,,,,2,2,2,4
7714_0,,,,2,2,2,4
7715_0,,,,2,2,2,4
7717_0,,,,2,2,2,4
CNCC(C(C(C(CO)O)O)O)N,,,3,1,12,0,12
7718_0,,,,2,2,2,4
7719_0,,,,2,2,2,4
7720_0,,,,2,2,2,4
7721_0,,,,2,2,2,4
7722_0,,,,2,2,2,4
7723_0,,,,2,2,2,4
7724_0,,,,2,2,2,4
7725_0,,,,2,2,2,4
7726_0,,,,2,2,2,4
7727_0,,,,2,2,2,4
7728_0,,,,2,2,2,4
7729_0,,,,2,2,2,4
7730_0,,,,2,2,2,4
7731_0,,,,2,2,2,4
7732_0,,,,2,2,2,4
7733_0,,,,2,2,2,4
7734_0,,,,2,2,2,4
7735_0,,,,2,2,2,4
7736_0,,,,2,2,2,4
7737_0,,,,2,2,2,4
7738_0,,,,2,2,2,4
7739_0,,,,2,2,2,4
7740_0,,,,2,2,2,4
7741_0,,,,2,2,2,4
7742_0,,,,2,2,2,4
7743_0,,,,2,2,2,4
7744_0,,,,2,2,2,4
7745_0,,,,2,2,2,4
7746_0,,,,2,2,2,4
7747_0,,,,2,2,2,4
7748_0,,,,2,2,2,4
7749_0,,,,2,2,2,4
7750_0,,,,2,2,2,4
7751_0,,,,2,2,2,4
7752_0,,,,2,2,2,4
7753_0,,,,2,2,2,4
7754_0,,,,2,2,2,4
7755_0,,,,2,2,2,4
7756_0,,,,2,2,2,4
7757_0,,,,2,2,2,4
7758_0,,,,2,2,2,4
7759_0,,,,2,2,2,4
7760_0,,,,2,2,2,4
7761_0,,,,2,2,2,4
7762_0,,,,2,2,2,4
7763_0,,,,2,2,2,4
7764_0,,,,2,2,2,4
7765_0,,,,2,2,2,4
7766_0,,,,2,2,2,4
7767_0,,,,2,2,2,4
7768_0,,,,2,2,2,4
7769_0,,,,2,2,2,4
7770_0,,,,2,2,2,4
7771_0,,,,2,2,2,4
7772_0,,,,2,2,2,4
7773_0,,,,2,2,2,4
7774_0,,,,2,2,2,4
7775_0,,,,2,2,2,4
7776_0,,,,2,2,2,4
7777_0,,,,2,2,2,4
7778_0,,,,2,2,2,4
7779_0,,,,2,2,2,4
7780_0,,,,2,2,2,4
7781_0,,,,2,2,2,4
7782_0,,,,2,2,2,4
7783_0,,,,2,2,2,4
7784_0,,,,2,2,2,4
7785_0,,,,2,2,2,4
7786_0,,,,2,2,2,4
7787_0,,,,2,2,2,4
7788_0,,,,2,2,2,4
7789_0,,,,2,2,2,4
7790_0,,,,2,2,2,4
7791_0,,,,2,2,2,4
7793_0,,,,2,2,2,4
C(C1(C(C(CC1N)O)O)O)O,,,3,1,12,0,12
7794_0,,,,2,2,2,4
7795_0,,,,2,2,2,4
7796_0,,,,2,2,2,4
7797_0,,,,2,2,2,4
7799_0,,,,2,2,2,4
C(C1(C(C(CC1O)O)O)O)N,,,3,1,12,0,12
7800_0,,,,2,2,2,4
7801_0,,,,2,2,2,4
7802_0,,,,2,2,2,4
7803_0,,,,2,2,2,4
7805_0,,,,2,2,2,4
C(C(C(CN)(C(CO)O)O)O)O,,,3,1,12,0,12
7806_0,,,,2,2,2,4
7807_0,,,,2,2,2,4
7808_0,,,,2,2,2,4
7809_0,,,,2,2,2,4
7811_0,,,,2,2,2,4
C(C(CN)(C(CO)O)O)(O)=O,,,3,1,12,0,12
7812_0,,,,2,2,2,4
7813_0,,,,2,2,2,4
7814_0,,,,2,2,2,4
7815_0,,,,2,2,2,4
7817_0,,,,2,2,2,4
C(C(C(CN)(C(CO)O)O)O)(O)=O,,,3,1,12,0,12
7818_0,,,,2,2,2,4
7819_0,,,,2,2,2,4
7820_0,,,,2,2,2,4
7821_0,,,,2,2,2,4
7823_0,,,,2,2,2,4
C(C(CN)(C(CO)O)O)O,,,3,1,12,0,12
7824_0,,,,2,2,2,4
7825_0,,,,2,2,2,4
7826_0,,,,2,2,2,4
7827_0,,,,2,2,2,4
7828_0,,,,2,2,2,4
7830_0,,,,2,2,2,4
C(CC(C(CO)(C(CO)O)O)N)=O,,,3,1,12,0,12
7831_0,,,,2,2,2,4
7832_0,,,,2,2,2,4
7833_0,,,,2,2,2,4
7834_0,,,,2,2,2,4
7835_0,,,,2,2,2,4
7836_0,,,,2,2,2,4
7837_0,,,,2,2,2,4
7838_0,,,,2,2,2,4
7839_0,,,,2,2,2,4
7840_0,,,,2,2,2,4
7841_0,,,,2,2,2,4
7842_0,,,,2,2,2,4
7843_0,,,,2,2,2,4
7844_0,,,,2,2,2,4
7845_0,,,,2,2,2,4
7846_0,,,,2,2,2,4
7847_0,,,,2,2,2,4
7848_0,,,,2,2,2,4
7849_0,,,,2,2,2,4
7851_0,,,,2,2,2,4
C(C(CC(C(CO)(CO)O)N)O)=O,,,3,1,12,0,12
7852_0,,,,2,2,2,4
7853_0,,,,2,2,2,4
7854_0,,,,2,2,2,4
7855_0,,,,2,2,2,4
7856_0,,,,2,2,2,4
7857_0,,,,2,2,2,4
7858_0,,,,2,2,2,4
7859_0,,,,2,2,2,4
7861_0,,,,2,2,2,4
C(C(C(CO)(CN)O)O)(CCO)=O,,,3,1,12,0,12
7862_0,,,,2,2,2,4
7863_0,,,,2,2,2,4
7864_0,,,,2,2,2,4
7865_0,,,,2,2,2,4
7866_0,,,,2,2,2,4
7867_0,,,,2,2,2,4
7868_0,,,,2,2,2,4
7869_0,,,,2,2,2,4
7870_0,,,,2,2,2,4
7871_0,,,,2,2,2,4
7873_0,,,,2,2,2,4
C(C(C(CO)(C(CCO)N)O)O)=O,,,3,1,12,0,12
7874_0,,,,2,2,2,4
7875_0,,,,2,2,2,4
7876_0,,,,2,2,2,4
7877_0,,,,2,2,2,4
7878_0,,,,2,2,2,4
7879_0,,,,2,2,2,4
7880_0,,,,2,2,2,4
7881_0,,,,2,2,2,4
7883_0,,,,2,2,2,4
C(CO)(CC(C(CO)(CN)O)O)=O,,,3,1,12,0,12
7884_0,,,,2,2,2,4
7885_0,,,,2,2,2,4
7886_0,,,,2,2,2,4
7887_0,,,,2,2,2,4
7888_0,,,,2,2,2,4
7889_0,,,,2,2,2,4
7890_0,,,,2,2,2,4
7891_0,,,,2,2,2,4
7892_0,,,,2,2,2,4
7894_0,,,,2,2,2,4
C(C)(C(C(C(CO)(CN)O)O)O)=O,,,3,1,12,0,12
7895_0,,,,2,2,2,4
7896_0,,,,2,2,2,4
7897_0,,,,2,2,2,4
7898_0,,,,2,2,2,4
7899_0,,,,2,2,2,4
7900_0,,,,2,2,2,4
7901_0,,,,2,2,2,4
7902_0,,,,2,2,2,4
7903_0,,,,2,2,2,4
7904_0,,,,2,2,2,4
7906_0,,,,2,2,2,4
C(C(C(C(CO)(C(C)N)O)O)O)=O,,,3,1,12,0,12
7907_0,,,,2,2,2,4
7908_0,,,,2,2,2,4
7909_0,,,,2,2,2,4
7910_0,,,,2,2,2,4
7911_0,,,,2,2,2,4
7912_0,,,,2,2,2,4
7913_0,,,,2,2,2,4
7914_0,,,,2,2,2,4
7916_0,,,,2,2,2,4
C(CC(C(C(CO)(CN)O)O)O)=O,,,3,1,12,0,12
7917_0,,,,2,2,2,4
7918_0,,,,2,2,2,4
7919_0,,,,2,2,2,4
7920_0,,,,2,2,2,4
7921_0,,,,2,2,2,4
7922_0,,,,2,2,2,4
7923_0,,,,2,2,2,4
7924_0,,,,2,2,2,4
7925_0,,,,2,2,2,4
7927_0,,,,2,2,2,4
C(C(CO)O)(CC(CO)(CN)O)=O,,,3,1,12,0,12
7928_0,,,,2,2,2,4
7929_0,,,,2,2,2,4
7930_0,,,,2,2,2,4
7931_0,,,,2,2,2,4
7932_0,,,,2,2,2,4
7933_0,,,,2,2,2,4
7934_0,,,,2,2,2,4
7935_0,,,,2,2,2,4
7936_0,,,,2,2,2,4
7938_0,,,,2,2,2,4
CNC(C(C(CO)O)O)C(CO)N,,,3,1,12,0,12
7939_0,,,,2,2,2,4
7941_0,,,,2,2,2,4
C(CC(C(C(CO)O)NC)N)=O,,,3,1,12,0,12
7942_0,,,,2,2,2,4
7944_0,,,,2,2,2,4
C(C(C(CC(CO)O)N)NC)=O,,,3,1,12,0,12
7945_0,,,,2,2,2,4
7947_0,,,,2,2,2,4
C(C(CC(C(CO)NC)N)O)=O,,,3,1,12,0,12
7948_0,,,,2,2,2,4
7949_0,,,,2,2,2,4
7950_0,,,,2,2,2,4
7952_0,,,,2,2,2,4
C(C(C(C(C(C)N)NC)O)O)=O,,,3,1,12,0,12
7954_0,,,,2,2,2,4
C(C(C(CC(CN)N)O)O)O,,,3,1,24,0,24
7955_0,,,,2,2,2,4
7956_0,,,,2,2,2,4
7957_0,,,,2,2,2,4
7958_0,,,,2,2,2,4
7959_0,,,,2,2,2,4
7960_0,,,,2,2,2,4
7961_0,,,,2,2,2,4
7962_0,,,,2,2,2,4
7963_0,,,,2,2,2,4
7964_0,,,,2,2,2,4
7965_0,,,,2,2,2,4
7966_0,,,,2,2,2,4
7967_0,,,,2,2,2,4
7968_0,,,,2,2,2,4
7969_0,,,,2,2,2,4
7970_0,,,,2,2,2,4
7971_0,,,,2,2,2,4
7972_0,,,,2,2,2,4
7973_0,,,,2,2,2,4
7974_0,,,,2,2,2,4
7975_0,,,,2,2,2,4
7976_0,,,,2,2,2,4
7977_0,,,,2,2,2,4
7978_0,,,,2,2,2,4
7979_0,,,,2,2,2,4
7980_0,,,,2,2,2,4
7981_0,,,,2,2,2,4
7982_0,,,,2,2,2,4
7983_0,,,,2,2,2,4
7984_0,,,,2,2,2,4
7985_0,,,,2,2,2,4
7986_0,,,,2,2,2,4
7987_0,,,,2,2,2,4
7988_0,,,,2,2,2,4
7989_0,,,,2,2,2,4
7990_0,,,,2,2,2,4
7991_0,,,,2,2,2,4
7993_0,,,,2,2,2,4
C1C(C(C(C(CO)O)O1)O)N,,,3,1,12,0,12
7994_0,,,,2,2,2,4
7995_0,,,,2,2,2,4
7996_0,,,,2,2,2,4
7997_0,,,,2,2,2,4
7999_0,,,,2,2,2,4
C1C(C(C(C(CO)O1)O)O)N,,,3,1,12,0,12
8000_0,,,,2,2,2,4
8001_0,,,,2,2,2,4
8002_0,,,,2,2,2,4
8003_0,,,,2,2,2,4
8005_0,,,,2,2,2,4
C1C(C(C(C(CO1)N)O)O)O,,,3,1,12,0,12
8006_0,,,,2,2,2,4
8007_0,,,,2,2,2,4
8008_0,,,,2,2,2,4
8009_0,,,,2,2,2,4
8010_0,,,,2,2,2,4
8011_0,,,,2,2,2,4
8013_0,,,,2,2,2,4
C(C(C(C(CCN)N)O)O)O,,,3,1,24,0,24
8015_0,,,,2,2,2,4
C(C(CC(C(CN)O)N)O)O,,,3,1,24,0,24
8017_0,,,,2,2,2,4
C(C(C(CC(CN)O)N)O)O,,,3,1,24,0,24
8019_0,,,,2,2,2,4
C(CC(C(C(CN)O)O)N)O,,,3,1,24,0,24
8021_0,,,,2,2,2,4
C(C(CC(C(CN)O)O)N)O,,,3,1,24,0,24
8023_0,,,,2,2,2,4
CC(C(C(C(CN)O)O)O)N,,,3,1,24,0,24
8025_0,,,,2,2,2,4
C(C(C(C(CCN)O)O)O)N,,,3,1,24,0,24
8026_0,,,,2,2,2,4
8027_0,,,,2,2,2,4
8028_0,,,,2,2,2,4
8029_0,,,,2,2,2,4
8030_0,,,,2,2,2,4
8031_0,,,,2,2,2,4
8032_0,,,,2,2,2,4
8033_0,,,,2,2,2,4
8034_0,,,,2,2,2,4
8035_0,,,,2,2,2,4
8036_0,,,,2,2,2,4
8037_0,,,,2,2,2,4
8039_0,,,,2,2,2,4
CNC(CO)C(CN)O,,,3,1,12,0,12
8041_0,,,,2,2,2,4
CNC(C(C(CO)N)O)C(CO)O,,,3,1,12,0,12
8042_0,,,,2,2,2,4
8043_0,,,,2,2,2,4
8044_0,,,,2,2,2,4
8046_0,,,,2,2,2,4
C(CC(C(C(CO)NC)O)N)=O,,,3,1,12,0,12
8047_0,,,,2,2,2,4
8049_0,,,,2,2,2,4
C(C(C(CC(CO)NC)N)O)=O,,,3,1,12,0,12
8050_0,,,,2,2,2,4
8052_0,,,,2,2,2,4
C(C(CC(C(CO)O)N)NC)=O,,,3,1,12,0,12
8053_0,,,,2,2,2,4
8055_0,,,,2,2,2,4
C(C(CC(C(CNC)O)N)O)=O,,,3,1,12,0,12
8056_0,,,,2,2,2,4
8058_0,,,,2,2,2,4
C(C(C(C(CCO)N)O)NC)=O,,,3,1,12,0,12
8059_0,,,,2,2,2,4
8061_0,,,,2,2,2,4
C(C(C(C(CCNC)N)O)O)=O,,,3,1,12,0,12
8062_0,,,,2,2,2,4
8063_0,,,,2,2,2,4
8064_0,,,,2,2,2,4
8065_0,,,,2,2,2,4
8067_0,,,,2,2,2,4
C(CC(C(C(CN)O)NC)O)=O,,,3,1,12,0,12
8068_0,,,,2,2,2,4
8069_0,,,,2,2,2,4
8071_0,,,,2,2,2,4
C(C(C(C(CCN)NC)O)O)=O,,,3,1,12,0,12
8073_0,,,,2,2,2,4
C(CNC(CO)C(CN)O)(O)=O,,,3,1,12,0,12
8075_0,,,,2,2,2,4
CNC(C(C(CO)O)O)C(CN)O,,,3,1,12,0,12
8076_0,,,,2,2,2,4
8077_0,,,,2,2,2,4
8078_0,,,,2,2,2,4
8079_0,,,,2,2,2,4
8080_0,,,,2,2,2,4
8081_0,,,,2,2,2,4
8082_0,,,,2,2,2,4
8083_0,,,,2,2,2,4
8084_0,,,,2,2,2,4
8085_0,,,,2,2,2,4
8086_0,,,,2,2,2,4
8087_0,,,,2,2,2,4
8088_0,,,,2,2,2,4
8089_0,,,,2,2,2,4
8090_0,,,,2,2,2,4
8091_0,,,,2,2,2,4
8092_0,,,,2,2,2,4
8093_0,,,,2,2,2,4
8094_0,,,,2,2,2,4
8095_0,,,,2,2,2,4
8096_0,,,,2,2,2,4
8097_0,,,,2,2,2,4
8098_0,,,,2,2,2,4
8099_0,,,,2,2,2,4
8100_0,,,,2,2,2,4
8101_0,,,,2,2,2,4
8102_0,,,,2,2,2,4
8103_0,,,,2,2,2,4
8104_0,,,,2,2,2,4
8105_0,,,,2,2,2,4
8106_0,,,,2,2,2,4
8107_0,,,,2,2,2,4
8108_0,,,,2,2,2,4
8109_0,,,,2,2,2,4
8110_0,,,,2,2,2,4
8111_0,,,,2,2,2,4
8112_0,,,,2,2,2,4
8113_0,,,,2,2,2,4
8114_0,,,,2,2,2,4
8115_0,,,,2,2,2,4
8116_0,,,,2,2,2,4
8117_0,,,,2,2,2,4
8118_0,,,,2,2,2,4
8119_0,,,,2,2,2,4
8120_0,,,,2,2,2,4
8121_0,,,,2,2,2,4
8122_0,,,,2,2,2,4
8123_0,,,,2,2,2,4
8124_0,,,,2,2,2,4
8125_0,,,,2,2,2,4
8126_0,,,,2,2,2,4
8127_0,,,,2,2,2,4
8128_0,,,,2,2,2,4
8129_0,,,,2,2,2,4
8130_0,,,,2,2,2,4
8131_0,,,,2,2,2,4
8132_0,,,,2,2,2,4
8133_0,,,,2,2,2,4
8134_0,,,,2,2,2,4
8135_0,,,,2,2,2,4
8136_0,,,,2,2,2,4
8137_0,,,,2,2,2,4
8138_0,,,,2,2,2,4
8139_0,,,,2,2,2,4
8140_0,,,,2,2,2,4
8141_0,,,,2,2,2,4
8142_0,,,,2,2,2,4
8143_0,,,,2,2,2,4
8144_0,,,,2,2,2,4
8145_0,,,,2,2,2,4
8146_0,,,,2,2,2,4
8147_0,,,,2,2,2,4
8148_0,,,,2,2,2,4
8149_0,,,,2,2,2,4
8150_0,,,,2,2,2,4
8151_0,,,,2,2,2,4
8152_0,,,,2,2,2,4
8153_0,,,,2,2,2,4
8154_0,,,,2,2,2,4
8155_0,,,,2,2,2,4
8156_0,,,,2,2,2,4
8157_0,,,,2,2,2,4
8158_0,,,,2,2,2,4
8159_0,,,,2,2,2,4
8160_0,,,,2,2,2,4
8161_0,,,,2,2,2,4
8162_0,,,,2,2,2,4
8163_0,,,,2,2,2,4
8164_0,,,,2,2,2,4
8165_0,,,,2,2,2,4
8166_0,,,,2,2,2,4
8167_0,,,,2,2,2,4
8168_0,,,,2,2,2,4
8169_0,,,,2,2,2,4
8170_0,,,,2,2,2,4
8171_0,,,,2,2,2,4
8172_0,,,,2,2,2,4
8173_0,,,,2,2,2,4
8174_0,,,,2,2,2,4
8175_0,,,,2,2,2,4
8176_0,,,,2,2,2,4
8177_0,,,,2,2,2,4
8178_0,,,,2,2,2,4
8179_0,,,,2,2,2,4
8180_0,,,,2,2,2,4
8181_0,,,,2,2,2,4
8182_0,,,,2,2,2,4
8183_0,,,,2,2,2,4
8184_0,,,,2,2,2,4
8185_0,,,,2,2,2,4
8186_0,,,,2,2,2,4
8187_0,,,,2,2,2,4
8188_0,,,,2,2,2,4
8189_0,,,,2,2,2,4
8190_0,,,,2,2,2,4
8191_0,,,,2,2,2,4
8192_0,,,,2,2,2,4
8193_0,,,,2,2,2,4
8194_0,,,,2,2,2,4
8195_0,,,,2,2,2,4
8196_0,,,,2,2,2,4
8197_0,,,,2,2,2,4
8198_0,,,,2,2,2,4
8199_0,,,,2,2,2,4
8200_0,,,,2,2,2,4
8201_0,,,,2,2,2,4
8202_0,,,,2,2,2,4
8203_0,,,,2,2,2,4
8204_0,,,,2,2,2,4
8205_0,,,,2,2,2,4
8206_0,,,,2,2,2,4
8207_0,,,,2,2,2,4
8208_0,,,,2,2,2,4
8209_0,,,,2,2,2,4
8210_0,,,,2,2,2,4
8211_0,,,,2,2,2,4
8212_0,,,,2,2,2,4
8213_0,,,,2,2,2,4
8214_0,,,,2,2,2,4
8215_0,,,,2,2,2,4
8216_0,,,,2,2,2,4
8217_0,,,,2,2,2,4
8218_0,,,,2,2,2,4
8219_0,,,,2,2,2,4
8220_0,,,,2,2,2,4
8221_0,,,,2,2,2,4
8222_0,,,,2,2,2,4
8223_0,,,,2,2,2,4
8224_0,,,,2,2,2,4
8225_0,,,,2,2,2,4
8226_0,,,,2,2,2,4
8227_0,,,,2,2,2,4
8228_0,,,,2,2,2,4
8229_0,,,,2,2,2,4
8230_0,,,,2,2,2,4
8231_0,,,,2,2,2,4
8232_0,,,,2,2,2,4
8233_0,,,,2,2,2,4
8234_0,,,,2,2,2,4
8235_0,,,,2,2,2,4
8236_0,,,,2,2,2,4
8237_0,,,,2,2,2,4
8238_0,,,,2,2,2,4
8239_0,,,,2,2,2,4
8240_0,,,,2,2,2,4
8241_0,,,,2,2,2,4
8242_0,,,,2,2,2,4
8243_0,,,,2,2,2,4
8244_0,,,,2,2,2,4
8245_0,,,,2,2,2,4
8246_0,,,,2,2,2,4
8247_0,,,,2,2,2,4
8248_0,,,,2,2,2,4
8249_0,,,,2,2,2,4
8250_0,,,,2,2,2,4
8251_0,,,,2,2,2,4
8252_0,,,,2,2,2,4
8253_0,,,,2,2,2,4
8254_0,,,,2,2,2,4
8255_0,,,,2,2,2,4
8256_0,,,,2,2,2,4
8257_0,,,,2,2,2,4
8258_0,,,,2,2,2,4
8259_0,,,,2,2,2,4
8260_0,,,,2,2,2,4
8261_0,,,,2,2,2,4
8262_0,,,,2,2,2,4
8263_0,,,,2,2,2,4
8264_0,,,,2,2,2,4
8265_0,,,,2,2,2,4
8266_0,,,,2,2,2,4
8267_0,,,,2,2,2,4
8268_0,,,,2,2,2,4
8269_0,,,,2,2,2,4
8270_0,,,,2,2,2,4
8271_0,,,,2,2,2,4
8272_0,,,,2,2,2,4
8273_0,,,,2,2,2,4
8274_0,,,,2,2,2,4
8275_0,,,,2,2,2,4
8276_0,,,,2,2,2,4
8277_0,,,,2,2,2,4
8278_0,,,,2,2,2,4
8279_0,,,,2,2,2,4
8280_0,,,,2,2,2,4
8281_0,,,,2,2,2,4
8282_0,,,,2,2,2,4
8283_0,,,,2,2,2,4
8284_0,,,,2,2,2,4
8285_0,,,,2,2,2,4
8286_0,,,,2,2,2,4
8287_0,,,,2,2,2,4
8288_0,,,,2,2,2,4
8289_0,,,,2,2,2,4
8290_0,,,,2,2,2,4
8291_0,,,,2,2,2,4
8292_0,,,,2,2,2,4
8293_0,,,,2,2,2,4
8294_0,,,,2,2,2,4
8295_0,,,,2,2,2,4
8296_0,,,,2,2,2,4
8297_0,,,,2,2,2,4
8298_0,,,,2,2,2,4
8299_0,,,,2,2,2,4
8300_0,,,,2,2,2,4
8301_0,,,,2,2,2,4
8302_0,,,,2,2,2,4
8303_0,,,,2,2,2,4
8304_0,,,,2,2,2,4
8305_0,,,,2,2,2,4
8306_0,,,,2,2,2,4
8307_0,,,,2,2,2,4
8308_0,,,,2,2,2,4
8309_0,,,,2,2,2,4
8310_0,,,,2,2,2,4
8311_0,,,,2,2,2,4
8312_0,,,,2,2,2,4
8313_0,,,,2,2,2,4
8314_0,,,,2,2,2,4
8315_0,,,,2,2,2,4
8316_0,,,,2,2,2,4
8317_0,,,,2,2,2,4
8318_0,,,,2,2,2,4
8319_0,,,,2,2,2,4
8320_0,,,,2,2,2,4
8321_0,,,,2,2,2,4
8322_0,,,,2,2,2,4
8323_0,,,,2,2,2,4
8324_0,,,,2,2,2,4
8325_0,,,,2,2,2,4
8326_0,,,,2,2,2,4
8327_0,,,,2,2,2,4
8328_0,,,,2,2,2,4
8329_0,,,,2,2,2,4
8330_0,,,,2,2,2,4
8331_0,,,,2,2,2,4
8332_0,,,,2,2,2,4
8333_0,,,,2,2,2,4
8334_0,,,,2,2,2,4
8335_0,,,,2,2,2,4
8336_0,,,,2,2,2,4
8337_0,,,,2,2,2,4
8338_0,,,,2,2,2,4
8339_0,,,,2,2,2,4
8340_0,,,,2,2,2,4
8341_0,,,,2,2,2,4
8342_0,,,,2,2,2,4
8343_0,,,,2,2,2,4
8344_0,,,,2,2,2,4
8345_0,,,,2,2,2,4
8346_0,,,,2,2,2,4
8347_0,,,,2,2,2,4
8348_0,,,,2,2,2,4
8349_0,,,,2,2,2,4
8350_0,,,,2,2,2,4
8351_0,,,,2,2,2,4
8352_0,,,,2,2,2,4
8353_0,,,,2,2,2,4
8354_0,,,,2,2,2,4
8355_0,,,,2,2,2,4
8356_0,,,,2,2,2,4
8357_0,,,,2,2,2,4
8358_0,,,,2,2,2,4
8359_0,,,,2,2,2,4
8360_0,,,,2,2,2,4
8361_0,,,,2,2,2,4
8362_0,,,,2,2,2,4
8363_0,,,,2,2,2,4
8364_0,,,,2,2,2,4
8365_0,,,,2,2,2,4
8366_0,,,,2,2,2,4
8367_0,,,,2,2,2,4
8368_0,,,,2,2,2,4
8369_0,,,,2,2,2,4
8370_0,,,,2,2,2,4
8371_0,,,,2,2,2,4
8372_0,,,,2,2,2,4
8373_0,,,,2,2,2,4
8374_0,,,,2,2,2,4
8375_0,,,,2,2,2,4
8376_0,,,,2,2,2,4
8377_0,,,,2,2,2,4
8378_0,,,,2,2,2,4
8379_0,,,,2,2,2,4
8380_0,,,,2,2,2,4
8381_0,,,,2,2,2,4
8382_0,,,,2,2,2,4
8383_0,,,,2,2,2,4
8384_0,,,,2,2,2,4
8385_0,,,,2,2,2,4
8386_0,,,,2,2,2,4
8387_0,,,,2,2,2,4
8388_0,,,,2,2,2,4
8389_0,,,,2,2,2,4
8390_0,,,,2,2,2,4
8391_0,,,,2,2,2,4
8392_0,,,,2,2,2,4
8393_0,,,,2,2,2,4
8394_0,,,,2,2,2,4
8395_0,,,,2,2,2,4
8396_0,,,,2,2,2,4
8397_0,,,,2,2,2,4
8398_0,,,,2,2,2,4
8399_0,,,,2,2,2,4
8400_0,,,,2,2,2,4
8401_0,,,,2,2,2,4
8402_0,,,,2,2,2,4
8403_0,,,,2,2,2,4
8404_0,,,,2,2,2,4
8405_0,,,,2,2,2,4
8406_0,,,,2,2,2,4
8407_0,,,,2,2,2,4
8408_0,,,,2,2,2,4
8409_0,,,,2,2,2,4
8410_0,,,,2,2,2,4
8411_0,,,,2,2,2,4
8412_0,,,,2,2,2,4
8413_0,,,,2,2,2,4
8414_0,,,,2,2,2,4
8415_0,,,,2,2,2,4
8416_0,,,,2,2,2,4
8417_0,,,,2,2,2,4
8418_0,,,,2,2,2,4
8419_0,,,,2,2,2,4
8420_0,,,,2,2,2,4
8421_0,,,,2,2,2,4
8422_0,,,,2,2,2,4
8423_0,,,,2,2,2,4
8424_0,,,,2,2,2,4
8425_0,,,,2,2,2,4
8426_0,,,,2,2,2,4
8427_0,,,,2,2,2,4
8428_0,,,,2,2,2,4
8429_0,,,,2,2,2,4
8430_0,,,,2,2,2,4
8431_0,,,,2,2,2,4
8432_0,,,,2,2,2,4
8433_0,,,,2,2,2,4
8434_0,,,,2,2,2,4
8435_0,,,,2,2,2,4
8436_0,,,,2,2,2,4
8437_0,,,,2,2,2,4
8438_0,,,,2,2,2,4
8439_0,,,,2,2,2,4
8440_0,,,,2,2,2,4
8441_0,,,,2,2,2,4
8442_0,,,,2,2,2,4
8443_0,,,,2,2,2,4
8444_0,,,,2,2,2,4
8445_0,,,,2,2,2,4
8446_0,,,,2,2,2,4
8447_0,,,,2,2,2,4
8448_0,,,,2,2,2,4
8449_0,,,,2,2,2,4
8450_0,,,,2,2,2,4
8451_0,,,,2,2,2,4
8452_0,,,,2,2,2,4
8453_0,,,,2,2,2,4
8454_0,,,,2,2,2,4
8455_0,,,,2,2,2,4
8456_0,,,,2,2,2,4
8457_0,,,,2,2,2,4
8458_0,,,,2,2,2,4
8459_0,,,,2,2,2,4
8460_0,,,,2,2,2,4
8461_0,,,,2,2,2,4
8462_0,,,,2,2,2,4
8463_0,,,,2,2,2,4
8464_0,,,,2,2,2,4
8465_0,,,,2,2,2,4
8466_0,,,,2,2,2,4
8467_0,,,,2,2,2,4
8468_0,,,,2,2,2,4
8469_0,,,,2,2,2,4
8470_0,,,,2,2,2,4
8471_0,,,,2,2,2,4
8472_0,,,,2,2,2,4
8473_0,,,,2,2,2,4
8474_0,,,,2,2,2,4
8475_0,,,,2,2,2,4
8476_0,,,,2,2,2,4
8477_0,,,,2,2,2,4
8478_0,,,,2,2,2,4
8479_0,,,,2,2,2,4
8480_0,,,,2,2,2,4
8481_0,,,,2,2,2,4
8482_0,,,,2,2,2,4
8483_0,,,,2,2,2,4
8484_0,,,,2,2,2,4
8485_0,,,,2,2,2,4
8486_0,,,,2,2,2,4
8487_0,,,,2,2,2,4
8488_0,,,,2,2,2,4
8489_0,,,,2,2,2,4
8490_0,,,,2,2,2,4
8491_0,,,,2,2,2,4
8492_0,,,,2,2,2,4
8493_0,,,,2,2,2,4
8494_0,,,,2,2,2,4
8495_0,,,,2,2,2,4
8496_0,,,,2,2,2,4
8497_0,,,,2,2,2,4
8498_0,,,,2,2,2,4
8499_0,,,,2,2,2,4
8500_0,,,,2,2,2,4
8501_0,,,,2,2,2,4
8502_0,,,,2,2,2,4
8503_0,,,,2,2,2,4
8504_0,,,,2,2,2,4
8505_0,,,,2,2,2,4
8506_0,,,,2,2,2,4
8507_0,,,,2,2,2,4
8508_0,,,,2,2,2,4
8509_0,,,,2,2,2,4
8510_0,,,,2,2,2,4
8511_0,,,,2,2,2,4
8512_0,,,,2,2,2,4
8513_0,,,,2,2,2,4
8514_0,,,,2,2,2,4
8515_0,,,,2,2,2,4
8516_0,,,,2,2,2,4
8517_0,,,,2,2,2,4
8518_0,,,,2,2,2,4
8519_0,,,,2,2,2,4
8520_0,,,,2,2,2,4
8521_0,,,,2,2,2,4
8522_0,,,,2,2,2,4
8523_0,,,,2,2,2,4
8524_0,,,,2,2,2,4
8525_0,,,,2,2,2,4
8526_0,,,,2,2,2,4
8527_0,,,,2,2,2,4
8528_0,,,,2,2,2,4
8529_0,,,,2,2,2,4
8530_0,,,,2,2,2,4
8531_0,,,,2,2,2,4
8532_0,,,,2,2,2,4
8533_0,,,,2,2,2,4
8534_0,,,,2,2,2,4
8535_0,,,,2,2,2,4
8536_0,,,,2,2,2,4
8537_0,,,,2,2,2,4
8538_0,,,,2,2,2,4
8539_0,,,,2,2,2,4
8540_0,,,,2,2,2,4
8541_0,,,,2,2,2,4
8542_0,,,,2,2,2,4
8543_0,,,,2,2,2,4
8544_0,,,,2,2,2,4
8545_0,,,,2,2,2,4
8546_0,,,,2,2,2,4
8547_0,,,,2,2,2,4
8548_0,,,,2,2,2,4
8549_0,,,,2,2,2,4
8550_0,,,,2,2,2,4
8551_0,,,,2,2,2,4
8552_0,,,,2,2,2,4
8553_0,,,,2,2,2,4
8554_0,,,,2,2,2,4
8555_0,,,,2,2,2,4
8556_0,,,,2,2,2,4
8557_0,,,,2,2,2,4
8558_0,,,,2,2,2,4
8559_0,,,,2,2,2,4
8560_0,,,,2,2,2,4
8561_0,,,,2,2,2,4
8562_0,,,,2,2,2,4
8563_0,,,,2,2,2,4
8564_0,,,,2,2,2,4
8565_0,,,,2,2,2,4
8566_0,,,,2,2,2,4
8567_0,,,,2,2,2,4
8568_0,,,,2,2,2,4
8569_0,,,,2,2,2,4
8570_0,,,,2,2,2,4
8571_0,,,,2,2,2,4
8572_0,,,,2,2,2,4
8573_0,,,,2,2,2,4
8574_0,,,,2,2,2,4
8575_0,,,,2,2,2,4
8576_0,,,,2,2,2,4
8577_0,,,,2,2,2,4
8578_0,,,,2,2,2,4
8579_0,,,,2,2,2,4
8580_0,,,,2,2,2,4
8581_0,,,,2,2,2,4
8582_0,,,,2,2,2,4
8583_0,,,,2,2,2,4
8584_0,,,,2,2,2,4
8585_0,,,,2,2,2,4
8586_0,,,,2,2,2,4
8587_0,,,,2,2,2,4
8588_0,,,,2,2,2,4
8589_0,,,,2,2,2,4
8590_0,,,,2,2,2,4
8591_0,,,,2,2,2,4
8592_0,,,,2,2,2,4
8593_0,,,,2,2,2,4
8594_0,,,,2,2,2,4
8595_0,,,,2,2,2,4
8596_0,,,,2,2,2,4
8597_0,,,,2,2,2,4
8598_0,,,,2,2,2,4
8599_0,,,,2,2,2,4
8600_0,,,,2,2,2,4
8601_0,,,,2,2,2,4
8602_0,,,,2,2,2,4
8603_0,,,,2,2,2,4
8604_0,,,,2,2,2,4
8605_0,,,,2,2,2,4
8606_0,,,,2,2,2,4
8607_0,,,,2,2,2,4
8608_0,,,,2,2,2,4
8609_0,,,,2,2,2,4
8610_0,,,,2,2,2,4
8611_0,,,,2,2,2,4
8612_0,,,,2,2,2,4
8613_0,,,,2,2,2,4
8614_0,,,,2,2,2,4
8615_0,,,,2,2,2,4
8616_0,,,,2,2,2,4
8617_0,,,,2,2,2,4
8618_0,,,,2,2,2,4
8619_0,,,,2,2,2,4
8620_0,,,,2,2,2,4
8621_0,,,,2,2,2,4
8622_0,,,,2,2,2,4
8623_0,,,,2,2,2,4
8624_0,,,,2,2,2,4
8625_0,,,,2,2,2,4
8626_0,,,,2,2,2,4
8627_0,,,,2,2,2,4
8628_0,,,,2,2,2,4
8629_0,,,,2,2,2,4
8630_0,,,,2,2,2,4
8631_0,,,,2,2,2,4
8632_0,,,,2,2,2,4
8633_0,,,,2,2,2,4
8634_0,,,,2,2,2,4
8635_0,,,,2,2,2,4
8636_0,,,,2,2,2,4
8637_0,,,,2,2,2,4
8638_0,,,,2,2,2,4
8639_0,,,,2,2,2,4
8640_0,,,,2,2,2,4
8641_0,,,,2,2,2,4
8642_0,,,,2,2,2,4
8643_0,,,,2,2,2,4
8644_0,,,,2,2,2,4
8645_0,,,,2,2,2,4
8646_0,,,,2,2,2,4
8647_0,,,,2,2,2,4
8648_0,,,,2,2,2,4
8649_0,,,,2,2,2,4
8650_0,,,,2,2,2,4
8651_0,,,,2,2,2,4
8652_0,,,,2,2,2,4
8653_0,,,,2,2,2,4
8654_0,,,,2,2,2,4
8655_0,,,,2,2,2,4
8656_0,,,,2,2,2,4
8657_0,,,,2,2,2,4
8658_0,,,,2,2,2,4
8659_0,,,,2,2,2,4
8660_0,,,,2,2,2,4
8661_0,,,,2,2,2,4
8662_0,,,,2,2,2,4
8663_0,,,,2,2,2,4
8664_0,,,,2,2,2,4
8665_0,,,,2,2,2,4
8666_0,,,,2,2,2,4
8667_0,,,,2,2,2,4
8668_0,,,,2,2,2,4
8669_0,,,,2,2,2,4
8670_0,,,,2,2,2,4
8671_0,,,,2,2,2,4
8672_0,,,,2,2,2,4
8673_0,,,,2,2,2,4
8674_0,,,,2,2,2,4
8675_0,,,,2,2,2,4
8676_0,,,,2,2,2,4
8677_0,,,,2,2,2,4
8678_0,,,,2,2,2,4
8679_0,,,,2,2,2,4
8680_0,,,,2,2,2,4
8681_0,,,,2,2,2,4
8682_0,,,,2,2,2,4
8683_0,,,,2,2,2,4
8684_0,,,,2,2,2,4
8685_0,,,,2,2,2,4
8686_0,,,,2,2,2,4
8687_0,,,,2,2,2,4
8688_0,,,,2,2,2,4
8689_0,,,,2,2,2,4
8690_0,,,,2,2,2,4
8691_0,,,,2,2,2,4
8692_0,,,,2,2,2,4
8693_0,,,,2,2,2,4
8694_0,,,,2,2,2,4
8695_0,,,,2,2,2,4
8696_0,,,,2,2,2,4
8697_0,,,,2,2,2,4
8698_0,,,,2,2,2,4
8699_0,,,,2,2,2,4
8700_0,,,,2,2,2,4
8701_0,,,,2,2,2,4
8702_0,,,,2,2,2,4
8703_0,,,,2,2,2,4
8704_0,,,,2,2,2,4
8705_0,,,,2,2,2,4
8706_0,,,,2,2,2,4
8707_0,,,,2,2,2,4
8708_0,,,,2,2,2,4
8709_0,,,,2,2,2,4
8710_0,,,,2,2,2,4
8711_0,,,,2,2,2,4
8712_0,,,,2,2,2,4
8713_0,,,,2,2,2,4
8714_0,,,,2,2,2,4
8715_0,,,,2,2,2,4
8716_0,,,,2,2,2,4
8717_0,,,,2,2,2,4
8718_0,,,,2,2,2,4
8719_0,,,,2,2,2,4
8720_0,,,,2,2,2,4
8721_0,,,,2,2,2,4
8722_0,,,,2,2,2,4
8723_0,,,,2,2,2,4
8724_0,,,,2,2,2,4
8725_0,,,,2,2,2,4
8726_0,,,,2,2,2,4
8727_0,,,,2,2,2,4
8728_0,,,,2,2,2,4
8729_0,,,,2,2,2,4
8730_0,,,,2,2,2,4
8731_0,,,,2,2,2,4
8732_0,,,,2,2,2,4
8733_0,,,,2,2,2,4
8734_0,,,,2,2,2,4
8735_0,,,,2,2,2,4
8736_0,,,,2,2,2,4
8737_0,,,,2,2,2,4
8738_0,,,,2,2,2,4
8739_0,,,,2,2,2,4
8740_0,,,,2,2,2,4
8741_0,,,,2,2,2,4
8742_0,,,,2,2,2,4
8743_0,,,,2,2,2,4
8744_0,,,,2,2,2,4
8745_0,,,,2,2,2,4
8746_0,,,,2,2,2,4
8747_0,,,,2,2,2,4
8748_0,,,,2,2,2,4
8749_0,,,,2,2,2,4
8750_0,,,,2,2,2,4
8751_0,,,,2,2,2,4
8752_0,,,,2,2,2,4
8753_0,,,,2,2,2,4
8754_0,,,,2,2,2,4
8755_0,,,,2,2,2,4
8756_0,,,,2,2,2,4
8757_0,,,,2,2,2,4
8758_0,,,,2,2,2,4
8759_0,,,,2,2,2,4
8760_0,,,,2,2,2,4
8761_0,,,,2,2,2,4
8762_0,,,,2,2,2,4
8763_0,,,,2,2,2,4
8764_0,,,,2,2,2,4
8765_0,,,,2,2,2,4
8766_0,,,,2,2,2,4
8767_0,,,,2,2,2,4
8768_0,,,,2,2,2,4
8769_0,,,,2,2,2,4
8770_0,,,,2,2,2,4
8771_0,,,,2,2,2,4
8772_0,,,,2,2,2,4
8773_0,,,,2,2,2,4
8774_0,,,,2,2,2,4
8775_0,,,,2,2,2,4
8776_0,,,,2,2,2,4
8777_0,,,,2,2,2,4
8778_0,,,,2,2,2,4
8779_0,,,,2,2,2,4
8780_0,,,,2,2,2,4
8781_0,,,,2,2,2,4
8782_0,,,,2,2,2,4
8783_0,,,,2,2,2,4
8784_0,,,,2,2,2,4
8785_0,,,,2,2,2,4
8786_0,,,,2,2,2,4
8787_0,,,,2,2,2,4
8788_0,,,,2,2,2,4
8789_0,,,,2,2,2,4
8790_0,,,,2,2,2,4
8791_0,,,,2,2,2,4
8792_0,,,,2,2,2,4
8793_0,,,,2,2,2,4
8794_0,,,,2,2,2,4
8795_0,,,,2,2,2,4
8796_0,,,,2,2,2,4
8797_0,,,,2,2,2,4
8798_0,,,,2,2,2,4
8799_0,,,,2,2,2,4
8800_0,,,,2,2,2,4
8801_0,,,,2,2,2,4
8802_0,,,,2,2,2,4
8803_0,,,,2,2,2,4
8804_0,,,,2,2,2,4
8805_0,,,,2,2,2,4
8806_0,,,,2,2,2,4
8807_0,,,,2,2,2,4
8808_0,,,,2,2,2,4
8809_0,,,,2,2,2,4
8810_0,,,,2,2,2,4
8811_0,,,,2,2,2,4
8812_0,,,,2,2,2,4
8813_0,,,,2,2,2,4
8814_0,,,,2,2,2,4
8815_0,,,,2,2,2,4
8816_0,,,,2,2,2,4
8817_0,,,,2,2,2,4
8818_0,,,,2,2,2,4
8819_0,,,,2,2,2,4
8820_0,,,,2,2,2,4
8821_0,,,,2,2,2,4
8822_0,,,,2,2,2,4
8823_0,,,,2,2,2,4
8824_0,,,,2,2,2,4
8825_0,,,,2,2,2,4
8826_0,,,,2,2,2,4
8827_0,,,,2,2,2,4
8828_0,,,,2,2,2,4
8829_0,,,,2,2,2,4
8830_0,,,,2,2,2,4
8831_0,,,,2,2,2,4
8832_0,,,,2,2,2,4
8833_0,,,,2,2,2,4
8834_0,,,,2,2,2,4
8835_0,,,,2,2,2,4
8836_0,,,,2,2,2,4
8837_0,,,,2,2,2,4
8838_0,,,,2,2,2,4
8839_0,,,,2,2,2,4
8840_0,,,,2,2,2,4
8841_0,,,,2,2,2,4
8842_0,,,,2,2,2,4
8843_0,,,,2,2,2,4
8844_0,,,,2,2,2,4
8845_0,,,,2,2,2,4
8846_0,,,,2,2,2,4
8847_0,,,,2,2,2,4
8848_0,,,,2,2,2,4
8849_0,,,,2,2,2,4
8850_0,,,,2,2,2,4
8851_0,,,,2,2,2,4
8852_0,,,,2,2,2,4
8853_0,,,,2,2,2,4
8854_0,,,,2,2,2,4
8855_0,,,,2,2,2,4
8856_0,,,,2,2,2,4
8857_0,,,,2,2,2,4
8858_0,,,,2,2,2,4
8859_0,,,,2,2,2,4
8860_0,,,,2,2,2,4
8861_0,,,,2,2,2,4
8862_0,,,,2,2,2,4
8863_0,,,,2,2,2,4
8864_0,,,,2,2,2,4
8865_0,,,,2,2,2,4
8866_0,,,,2,2,2,4
8867_0,,,,2,2,2,4
8868_0,,,,2,2,2,4
8869_0,,,,2,2,2,4
8870_0,,,,2,2,2,4
8871_0,,,,2,2,2,4
8872_0,,,,2,2,2,4
8873_0,,,,2,2,2,4
8874_0,,,,2,2,2,4
8875_0,,,,2,2,2,4
8876_0,,,,2,2,2,4
8877_0,,,,2,2,2,4
8878_0,,,,2,2,2,4
8879_0,,,,2,2,2,4
8880_0,,,,2,2,2,4
8881_0,,,,2,2,2,4
8882_0,,,,2,2,2,4
8883_0,,,,2,2,2,4
8884_0,,,,2,2,2,4
8885_0,,,,2,2,2,4
8886_0,,,,2,2,2,4
8887_0,,,,2,2,2,4
8888_0,,,,2,2,2,4
8889_0,,,,2,2,2,4
8890_0,,,,2,2,2,4
8891_0,,,,2,2,2,4
8892_0,,,,2,2,2,4
8893_0,,,,2,2,2,4
8894_0,,,,2,2,2,4
8895_0,,,,2,2,2,4
8896_0,,,,2,2,2,4
8897_0,,,,2,2,2,4
8898_0,,,,2,2,2,4
8899_0,,,,2,2,2,4
8900_0,,,,2,2,2,4
8901_0,,,,2,2,2,4
8902_0,,,,2,2,2,4
8903_0,,,,2,2,2,4
8904_0,,,,2,2,2,4
8905_0,,,,2,2,2,4
8906_0,,,,2,2,2,4
8907_0,,,,2,2,2,4
8908_0,,,,2,2,2,4
8909_0,,,,2,2,2,4
8910_0,,,,2,2,2,4
8911_0,,,,2,2,2,4
8912_0,,,,2,2,2,4
8913_0,,,,2,2,2,4
8914_0,,,,2,2,2,4
8915_0,,,,2,2,2,4
8916_0,,,,2,2,2,4
8917_0,,,,2,2,2,4
8918_0,,,,2,2,2,4
8919_0,,,,2,2,2,4
8920_0,,,,2,2,2,4
8921_0,,,,2,2,2,4
8922_0,,,,2,2,2,4
8923_0,,,,2,2,2,4
8924_0,,,,2,2,2,4
8925_0,,,,2,2,2,4
8926_0,,,,2,2,2,4
8927_0,,,,2,2,2,4
8928_0,,,,2,2,2,4
8929_0,,,,2,2,2,4
8930_0,,,,2,2,2,4
8931_0,,,,2,2,2,4
8932_0,,,,2,2,2,4
8933_0,,,,2,2,2,4
8934_0,,,,2,2,2,4
8935_0,,,,2,2,2,4
8936_0,,,,2,2,2,4
8937_0,,,,2,2,2,4
8938_0,,,,2,2,2,4
8939_0,,,,2,2,2,4
8940_0,,,,2,2,2,4
8941_0,,,,2,2,2,4
8942_0,,,,2,2,2,4
8943_0,,,,2,2,2,4
8944_0,,,,2,2,2,4
8945_0,,,,2,2,2,4
8946_0,,,,2,2,2,4
8947_0,,,,2,2,2,4
8948_0,,,,2,2,2,4
8949_0,,,,2,2,2,4
8950_0,,,,2,2,2,4
8951_0,,,,2,2,2,4
8952_0,,,,2,2,2,4
8953_0,,,,2,2,2,4
8954_0,,,,2,2,2,4
8955_0,,,,2,2,2,4
8956_0,,,,2,2,2,4
8957_0,,,,2,2,2,4
8958_0,,,,2,2,2,4
8959_0,,,,2,2,2,4
8960_0,,,,2,2,2,4
8961_0,,,,2,2,2,4
8962_0,,,,2,2,2,4
8963_0,,,,2,2,2,4
8964_0,,,,2,2,2,4
8965_0,,,,2,2,2,4
8966_0,,,,2,2,2,4
8967_0,,,,2,2,2,4
8968_0,,,,2,2,2,4
8969_0,,,,2,2,2,4
8970_0,,,,2,2,2,4
8971_0,,,,2,1,2,3
8972_0,,,,2,1,2,3
8973_0,,,,2,1,2,3
8974_0,,,,2,1,2,3
8975_0,,,,2,1,2,3
8976_0,,,,2,1,2,3
8977_0,,,,2,1,2,3
8978_0,,,,2,1,2,3
8980_0,,,,2,1,2,3
C1(CC(C(C(C=O)O)O1)O)=O,,,3,1,1,0,1
8982_0,,,,2,1,2,3
C1(C(C=O)(C(CO1)O)O)=O,,,3,1,1,0,1
8984_0,,,,2,1,2,3
C(C1(C(CO)OC(C1O)=O)O)=O,,,3,1,1,0,1
8986_0,,,,2,1,2,3
C1(C(C(CO1)O)N)=O,,,3,1,1,0,1
8988_0,,,,2,1,2,3
C1(C(C(C(C(CO)O)O1)O)N)=O,,,3,1,1,0,1
8990_0,,,,2,1,2,3
C1(C(C(C(O1)=O)N)O)=O,,,3,1,1,0,1
8991_0,,,,2,1,1,2
8992_0,,,,2,1,1,2
8993_0,,,,2,1,1,2
8994_0,,,,2,1,1,2
8995_0,,,,2,1,2,3
8996_0,,,,2,1,2,3
8997_0,,,,2,1,2,3
8998_0,,,,2,1,2,3
8999_0,,,,2,1,2,3
9001_0,,,,2,1,2,3
C1(CC(C(C(C=O)O1)O)O)=O,,,3,1,1,0,1
9003_0,,,,2,1,2,3
C(C1(C(COC(C1O)=O)O)O)=O,,,3,1,1,0,1
9005_0,,,,2,1,2,3
C1(C(C(C(C(CO)O1)O)O)N)=O,,,3,1,1,0,1
9006_0,,,,2,1,1,2
9007_0,,,,2,1,1,2
9008_0,,,,2,1,2,3
9009_0,,,,2,1,2,3
9010_0,,,,2,1,2,3
9011_0,,,,2,1,2,3
9012_0,,,,2,1,2,3
9013_0,,,,2,1,2,3
9014_0,,,,2,1,2,3
9016_0,,,,2,1,2,3
C1(C(C(C(C(CO1)O)O)O)N)=O,,,3,1,1,0,1
9018_0,,,,2,1,2,3
C1C(CC(C(CO)O)N=1)O,,,3,1,1,0,1
9020_0,,,,2,1,2,3
C1C(C(C(CCO)N=1)O)O,,,3,1,1,0,1
9022_0,,,,2,1,2,3
C1(C(CO)O)CC(CN=1)O,,,3,1,1,0,1
9024_0,,,,2,1,2,3
C1(C(C(CN=1)O)O)CCO,,,3,1,1,0,1
9026_0,,,,2,1,2,3
C1C(C(CC(CO)N=1)O)O,,,3,1,1,0,1
9028_0,,,,2,1,2,3
C1C(C(C(C(C)N=1)O)O)O,,,3,1,1,0,1
9030_0,,,,2,1,2,3
C1(CO)CC(C(CN=1)O)O,,,3,1,1,0,1
9032_0,,,,2,1,2,3
C1(C)C(C(C(CN=1)O)O)O,,,3,1,1,0,1
9033_0,,,,2,1,1,2
9034_0,,,,2,1,1,2
9036_0,,,,2,2,1,3
C(CC(C(CO)O)CC(C=O)=O)=O,,,3,1,1,0,1
9038_0,,,,2,2,1,3
C(C(C(CC(CO)CC=O)=O)O)=O,,,3,1,1,0,1
9040_0,,,,2,2,1,3
C(CC(C=O)CC=O)(C(CO)O)=O,,,3,1,1,0,1
9042_0,,,,2,2,1,3
C(CC(C(C(CO)O)=O)CC=O)=O,,,3,1,1,0,1
9044_0,,,,2,2,1,3
C(CCCC(C(C(C=O)O)O)=O)=O,,,3,1,1,0,1
9046_0,,,,2,2,1,3
C(CC(C(C=O)O)CC(CO)=O)=O,,,3,1,1,0,1
9048_0,,,,2,2,1,3
C(CC(C(C(C=O)O)O)CC=O)=O,,,3,1,1,0,1
9050_0,,,,2,2,1,3
C(C(CC(CO)C(CO)O)=O)=O,,,3,1,1,0,1
9052_0,,,,2,2,1,3
C(C(C(CC(CO)CO)=O)O)=O,,,3,1,1,0,1
9054_0,,,,2,2,1,3
C(C(CO)CC(C(CO)O)=O)=O,,,3,1,1,0,1
9056_0,,,,2,2,1,3
C(C(CO)CC=O)(C(CO)O)=O,,,3,1,1,0,1
9058_0,,,,2,2,1,3
C(C(C(C=O)O)O)(CCCO)=O,,,3,1,1,0,1
9060_0,,,,2,2,1,3
C(C(C(CO)CC(CO)=O)O)=O,,,3,1,1,0,1
9062_0,,,,2,2,1,3
C(CC(CO)C(C(C=O)O)O)=O,,,3,1,1,0,1
9064_0,,,,2,2,1,3
C(C(CC(CN)C(CO)O)=O)=O,,,3,1,1,0,1
9066_0,,,,2,2,1,3
C(C(C(CC(CO)CN)=O)O)=O,,,3,1,1,0,1
9068_0,,,,2,2,1,3
C(C(CN)CC(C(CO)O)=O)=O,,,3,1,1,0,1
9070_0,,,,2,2,1,3
C(C(CN)CC=O)(C(CO)O)=O,,,3,1,1,0,1
9072_0,,,,2,2,1,3
C(C(C(C=O)O)O)(CCCN)=O,,,3,1,1,0,1
9074_0,,,,2,2,1,3
C(C(C(CN)CC(CO)=O)O)=O,,,3,1,1,0,1
9076_0,,,,2,2,1,3
C(CC(C(C(C=O)O)O)CN)=O,,,3,1,1,0,1
9078_0,,,,2,1,2,3
C=C(C(C=O)=O)NC,,,3,1,1,0,1
9080_0,,,,2,1,2,3
C=C(C(CO)=O)NC,,,3,1,1,0,1
9082_0,,,,2,1,2,3
C(C(C(C(NC)=C)=O)O)=O,,,3,1,1,0,1
9084_0,,,,2,1,2,3
C=C(C=O)NC,,,3,1,1,0,1
9086_0,,,,2,1,2,3
C=C(C=O)N,,,3,1,1,0,1
9088_0,,,,2,1,2,3
C(NC)=CC(C=O)=O,,,3,1,1,0,1
9090_0,,,,2,1,2,3
C(C(C(C=CNC)=O)O)=O,,,3,1,1,0,1
9092_0,,,,2,1,2,3
C(NC)=CC(CO)=O,,,3,1,1,0,1
9094_0,,,,2,1,2,3
C(NC)=CC=O,,,3,1,1,0,1
9096_0,,,,2,1,2,3
C(N)=CC=O,,,3,1,1,0,1
9097_0,,,,2,2,3,5
9098_0,,,,2,2,3,5
9099_0,,,,2,2,3,5
9100_0,,,,2,2,3,5
9101_0,,,,2,2,3,5
9102_0,,,,2,2,3,5
9103_0,,,,2,2,3,5
9104_0,,,,2,2,3,5
9105_0,,,,2,2,3,5
9106_0,,,,2,2,3,5
9107_0,,,,2,2,3,5
9108_0,,,,2,2,3,5
9109_0,,,,2,2,3,5
9111_0,,,,2,2,3,5
C(C(CNCC=O)O)(O)=O,,,3,1,1,0,1
9112_0,,,,2,2,3,5
9113_0,,,,2,2,3,5
9114_0,,,,2,2,3,5
9115_0,,,,2,2,3,5
9116_0,,,,2,2,3,5
9118_0,,,,2,2,3,5
C(C(C(CNCC=O)O)O)(O)=O,,,3,1,1,0,1
9119_0,,,,2,2,3,5
9120_0,,,,2,2,3,5
9121_0,,,,2,2,3,5
9122_0,,,,2,2,3,5
9123_0,,,,2,2,3,5
9125_0,,,,2,2,3,5
C(CNCC(CO)O)=O,,,3,1,1,0,1
9127_0,,,,2,2,3,5
C(CNCC(CO)O)(C(CO)O)=O,,,3,1,1,0,1
9128_0,,,,2,2,3,5
9129_0,,,,2,2,3,5
9130_0,,,,2,2,3,5
9131_0,,,,2,2,3,5
9132_0,,,,2,2,3,5
9134_0,,,,2,2,3,5
C(C(C(CO)NCC(CO)O)O)=O,,,3,1,1,0,1
9135_0,,,,2,2,3,5
9136_0,,,,2,2,3,5
9137_0,,,,2,2,3,5
9138_0,,,,2,2,3,5
9139_0,,,,2,2,3,5
9140_0,,,,2,2,3,5
9141_0,,,,2,2,3,5
9142_0,,,,2,2,3,5
9143_0,,,,2,2,3,5
9144_0,,,,2,2,3,5
9145_0,,,,2,2,3,5
9146_0,,,,2,2,3,5
9147_0,,,,2,2,3,5
9148_0,,,,2,2,3,5
9149_0,,,,2,2,3,5
9150_0,,,,2,2,3,5
9151_0,,,,2,2,3,5
9152_0,,,,2,2,3,5
9153_0,,,,2,2,3,5
9154_0,,,,2,2,3,5
9155_0,,,,2,2,3,5
9156_0,,,,2,2,3,5
9157_0,,,,2,2,3,5
9158_0,,,,2,2,3,5
9159_0,,,,2,2,3,5
9160_0,,,,2,2,3,5
9161_0,,,,2,2,3,5
9162_0,,,,2,2,3,5
9163_0,,,,2,2,3,5
9164_0,,,,2,2,3,5
9165_0,,,,2,2,3,5
9166_0,,,,2,2,3,5
9167_0,,,,2,2,3,5
9168_0,,,,2,2,3,5
9169_0,,,,2,2,3,5
9170_0,,,,2,2,3,5
9171_0,,,,2,2,3,5
9172_0,,,,2,2,3,5
9173_0,,,,2,2,3,5
9174_0,,,,2,2,3,5
9175_0,,,,2,2,3,5
9176_0,,,,2,2,3,5
9177_0,,,,2,2,3,5
9178_0,,,,2,2,3,5
9179_0,,,,2,2,3,5
9181_0,,,,2,2,3,5
C(CNCCC(CO)=O)=O,,,3,1,1,0,1
9182_0,,,,2,2,3,5
9183_0,,,,2,2,3,5
9184_0,,,,2,2,3,5
9185_0,,,,2,2,3,5
9186_0,,,,2,2,3,5
9188_0,,,,2,2,3,5
C(C)(C(CNCC=O)O)=O,,,3,1,1,0,1
9189_0,,,,2,2,3,5
9190_0,,,,2,2,3,5
9191_0,,,,2,2,3,5
9192_0,,,,2,2,3,5
9193_0,,,,2,2,3,5
9195_0,,,,2,2,3,5
C(CNCC(CC(CO)=O)O)=O,,,3,1,1,0,1
9196_0,,,,2,2,3,5
9197_0,,,,2,2,3,5
9198_0,,,,2,2,3,5
9199_0,,,,2,2,3,5
9200_0,,,,2,2,3,5
9202_0,,,,2,2,3,5
C(C)(C(C(CNCC=O)O)O)=O,,,3,1,1,0,1
9203_0,,,,2,2,3,5
9204_0,,,,2,2,3,5
9205_0,,,,2,2,3,5
9206_0,,,,2,2,3,5
9207_0,,,,2,2,3,5
9209_0,,,,2,2,3,5
C(C(CNCC=O)O)=O,,,3,1,1,0,1
9211_0,,,,2,2,3,5
C(C(CNCC(C(CO)O)=O)O)=O,,,3,1,1,0,1
9212_0,,,,2,2,3,5
9213_0,,,,2,2,3,5
9214_0,,,,2,2,3,5
9215_0,,,,2,2,3,5
9216_0,,,,2,2,3,5
9218_0,,,,2,2,3,5
C(C(C(CO)NCC(C=O)O)O)=O,,,3,1,1,0,1
9220_0,,,,2,2,3,5
C(CC(CNCC=O)O)=O,,,3,1,1,0,1
9222_0,,,,2,2,3,5
C(C(CCNCC=O)O)=O,,,3,1,1,0,1
9223_0,,,,2,2,3,5
9224_0,,,,2,2,3,5
9225_0,,,,2,2,3,5
9226_0,,,,2,2,3,5
9227_0,,,,2,2,3,5
9228_0,,,,2,2,3,5
9229_0,,,,2,2,3,5
9230_0,,,,2,2,3,5
9231_0,,,,2,2,3,5
9232_0,,,,2,2,3,5
9234_0,,,,2,2,3,5
C(C(C(CNCC=O)O)O)=O,,,3,1,1,0,1
9235_0,,,,2,2,3,5
9236_0,,,,2,2,3,5
9237_0,,,,2,2,3,5
9238_0,,,,2,2,3,5
9239_0,,,,2,2,3,5
9241_0,,,,2,2,3,5
C(CNCC)=O,,,3,1,1,0,1
9243_0,,,,2,2,3,5
C(CNCC)(C(CO)O)=O,,,3,1,1,0,1
9244_0,,,,2,2,3,5
9245_0,,,,2,2,3,5
9246_0,,,,2,2,3,5
9247_0,,,,2,2,3,5
9248_0,,,,2,2,3,5
9250_0,,,,2,2,3,5
C(C(C(CO)NCC)O)=O,,,3,1,1,0,1
9251_0,,,,2,2,3,5
9252_0,,,,2,2,3,5
9253_0,,,,2,2,3,5
9254_0,,,,2,2,3,5
9255_0,,,,2,2,3,5
9256_0,,,,2,2,3,5
9257_0,,,,2,2,3,5
9258_0,,,,2,2,3,5
9259_0,,,,2,2,3,5
9260_0,,,,2,2,3,5
9261_0,,,,2,2,3,5
9262_0,,,,2,2,3,5
9263_0,,,,2,2,3,5
9264_0,,,,2,2,3,5
9265_0,,,,2,2,3,5
9266_0,,,,2,2,3,5
9267_0,,,,2,2,3,5
9268_0,,,,2,2,3,5
9269_0,,,,2,2,3,5
9270_0,,,,2,2,3,5
9271_0,,,,2,2,3,5
9272_0,,,,2,2,3,5
9273_0,,,,2,2,3,5
9274_0,,,,2,2,3,5
9275_0,,,,2,2,3,5
9276_0,,,,2,2,3,5
9277_0,,,,2,2,3,5
9278_0,,,,2,2,3,5
9279_0,,,,2,2,3,5
9280_0,,,,2,2,3,5
9281_0,,,,2,2,3,5
9282_0,,,,2,2,3,5
9283_0,,,,2,2,3,5
9284_0,,,,2,2,3,5
9285_0,,,,2,2,3,5
9287_0,,,,2,2,3,5
C(CNCCNC)=O,,,3,1,1,0,1
9289_0,,,,2,2,3,5
C(CNCCNC)(C(CO)O)=O,,,3,1,1,0,1
9290_0,,,,2,2,3,5
9291_0,,,,2,2,3,5
9292_0,,,,2,2,3,5
9293_0,,,,2,2,3,5
9294_0,,,,2,2,3,5
9296_0,,,,2,2,3,5
C(C(C(CO)NCCNC)O)=O,,,3,1,1,0,1
9297_0,,,,2,2,3,5
9298_0,,,,2,2,3,5
9299_0,,,,2,2,3,5
9300_0,,,,2,2,3,5
9301_0,,,,2,2,3,5
9302_0,,,,2,2,3,5
9303_0,,,,2,2,3,5
9304_0,,,,2,2,3,5
9305_0,,,,2,2,3,5
9306_0,,,,2,2,3,5
9307_0,,,,2,2,3,5
9308_0,,,,2,2,3,5
9309_0,,,,2,2,3,5
9310_0,,,,2,2,3,5
9311_0,,,,2,2,3,5
9312_0,,,,2,2,3,5
9313_0,,,,2,2,3,5
9314_0,,,,2,2,3,5
9315_0,,,,2,2,3,5
9316_0,,,,2,2,3,5
9317_0,,,,2,2,3,5
9318_0,,,,2,2,3,5
9319_0,,,,2,2,3,5
9320_0,,,,2,2,3,5
9321_0,,,,2,2,3,5
9322_0,,,,2,2,3,5
9323_0,,,,2,2,3,5
9324_0,,,,2,2,3,5
9325_0,,,,2,2,3,5
9326_0,,,,2,2,3,5
9327_0,,,,2,2,3,5
9328_0,,,,2,2,3,5
9329_0,,,,2,2,3,5
9330_0,,,,2,2,3,5
9331_0,,,,2,2,3,5
9332_0,,,,2,2,3,5
9333_0,,,,2,2,3,5
9334_0,,,,2,2,3,5
9335_0,,,,2,2,3,5
9336_0,,,,2,2,3,5
9338_0,,,,2,2,3,5
C(CNCCNCC(O)=O)=O,,,3,1,1,0,1
9340_0,,,,2,2,3,5
C(CNCC(CO)(C(CO)O)O)=O,,,3,1,1,0,1
9341_0,,,,2,2,3,5
9342_0,,,,2,2,3,5
9343_0,,,,2,2,3,5
9344_0,,,,2,2,3,5
9345_0,,,,2,2,3,5
9347_0,,,,2,2,3,5
C(CNCCC(CC(C=O)=O)O)=O,,,3,1,1,0,1
9349_0,,,,2,2,3,5
C(CNCCC(C(CCO)=O)=O)=O,,,3,1,1,0,1
9351_0,,,,2,2,3,5
C(CNCCC(CC(CO)=O)=O)=O,,,3,1,1,0,1
9353_0,,,,2,2,3,5
C(C)(C(C(CCNCC=O)=O)O)=O,,,3,1,1,0,1
9355_0,,,,2,2,3,5
C(CNCCC(C(CC=O)O)=O)=O,,,3,1,1,0,1
9357_0,,,,2,2,3,5
C(C(CCNCC=O)O)(CC=O)=O,,,3,1,1,0,1
9359_0,,,,2,2,3,5
C(C)(CC(C(CNCC=O)O)=O)=O,,,3,1,1,0,1
9361_0,,,,2,2,3,5
C(CNCC(C(CCC=O)=O)O)=O,,,3,1,1,0,1
9363_0,,,,2,2,3,5
C(CCCNCC=O)(C(C=O)O)=O,,,3,1,1,0,1
9365_0,,,,2,2,3,5
C(CNCC(CC(C(C)=O)=O)O)=O,,,3,1,1,0,1
9367_0,,,,2,2,3,5
C(CC(CNCC=O)O)(CC=O)=O,,,3,1,1,0,1
9369_0,,,,2,2,3,5
C(CC(C=O)O)(CCNCC=O)=O,,,3,1,1,0,1
9371_0,,,,2,2,3,5
C(CNCC(C(C=CCO)=O)O)=O,,,3,1,1,0,1
9373_0,,,,2,2,3,5
C(CNCC=CC(C(CO)O)=O)=O,,,3,1,1,0,1
9375_0,,,,2,2,3,5
C(CNCC(C(C(C=C)=O)O)O)=O,,,3,1,1,0,1
9377_0,,,,2,2,3,5
C(CNCC(C=CC(CO)=O)O)=O,,,3,1,1,0,1
9379_0,,,,2,2,3,5
C(CNCC(C(C=CC=O)O)O)=O,,,3,1,1,0,1
9381_0,,,,2,2,3,5
C(CNCC=CC(C(C=O)O)O)=O,,,3,1,1,0,1
9383_0,,,,2,2,3,5
C(CNCC(C(CO)NC)O)=O,,,3,1,1,0,1
9384_0,,,,2,2,3,5
9385_0,,,,2,2,3,5
9386_0,,,,2,2,3,5
9387_0,,,,2,2,3,5
9388_0,,,,2,2,3,5
9389_0,,,,2,2,3,5
9390_0,,,,2,2,3,5
9391_0,,,,2,2,3,5
9392_0,,,,2,2,3,5
9393_0,,,,2,2,3,5
9394_0,,,,2,2,3,5
9395_0,,,,2,2,3,5
9396_0,,,,2,2,3,5
9397_0,,,,2,2,3,5
9398_0,,,,2,2,3,5
9399_0,,,,2,2,3,5
9400_0,,,,2,2,3,5
9401_0,,,,2,2,3,5
9402_0,,,,2,2,3,5
9403_0,,,,2,2,3,5
9404_0,,,,2,2,3,5
9405_0,,,,2,2,3,5
9406_0,,,,2,2,3,5
9407_0,,,,2,2,3,5
9408_0,,,,2,2,3,5
9409_0,,,,2,2,3,5
9410_0,,,,2,2,3,5
9411_0,,,,2,2,3,5
9412_0,,,,2,2,3,5
9413_0,,,,2,2,3,5
9414_0,,,,2,2,3,5
9415_0,,,,2,2,3,5
9416_0,,,,2,2,3,5
9417_0,,,,2,2,3,5
9418_0,,,,2,2,3,5
9419_0,,,,2,2,3,5
9420_0,,,,2,2,3,5
9421_0,,,,2,2,3,5
9422_0,,,,2,2,3,5
9423_0,,,,2,2,3,5
9424_0,,,,2,2,3,5
9425_0,,,,2,2,3,5
9426_0,,,,2,2,3,5
9427_0,,,,2,2,3,5
9428_0,,,,2,2,3,5
9429_0,,,,2,2,3,5
9430_0,,,,2,2,3,5
9431_0,,,,2,2,3,5
9432_0,,,,2,2,3,5
9433_0,,,,2,2,3,5
9434_0,,,,2,2,3,5
9435_0,,,,2,2,3,5
9436_0,,,,2,2,3,5
9437_0,,,,2,2,3,5
9438_0,,,,2,2,3,5
9439_0,,,,2,2,3,5
9440_0,,,,2,2,3,5
9441_0,,,,2,2,3,5
9442_0,,,,2,2,3,5
9443_0,,,,2,2,3,5
9444_0,,,,2,2,3,5
9445_0,,,,2,2,3,5
9446_0,,,,2,2,3,5
9447_0,,,,2,2,3,5
9448_0,,,,2,2,3,5
9449_0,,,,2,2,3,5
9450_0,,,,2,2,3,5
9451_0,,,,2,2,3,5
9452_0,,,,2,2,3,5
9453_0,,,,2,2,3,5
9454_0,,,,2,2,3,5
9455_0,,,,2,2,3,5
9456_0,,,,2,2,3,5
9457_0,,,,2,2,3,5
9458_0,,,,2,2,3,5
9459_0,,,,2,2,3,5
9460_0,,,,2,2,3,5
9461_0,,,,2,2,3,5
9462_0,,,,2,2,3,5
9463_0,,,,2,2,3,5
9464_0,,,,2,2,3,5
9465_0,,,,2,2,3,5
9466_0,,,,2,2,3,5
9467_0,,,,2,2,3,5
9468_0,,,,2,2,3,5
9469_0,,,,2,2,3,5
9470_0,,,,2,2,3,5
9471_0,,,,2,2,3,5
9472_0,,,,2,2,3,5
9473_0,,,,2,2,3,5
9474_0,,,,2,2,3,5
9475_0,,,,2,2,3,5
9476_0,,,,2,2,3,5
9477_0,,,,2,2,3,5
9478_0,,,,2,2,3,5
9479_0,,,,2,2,3,5
9480_0,,,,2,2,3,5
9481_0,,,,2,2,3,5
9482_0,,,,2,2,3,5
9483_0,,,,2,2,3,5
9484_0,,,,2,2,3,5
9485_0,,,,2,2,3,5
9486_0,,,,2,2,3,5
9487_0,,,,2,2,3,5
9488_0,,,,2,2,3,5
9489_0,,,,2,2,3,5
9490_0,,,,2,2,3,5
9491_0,,,,2,2,3,5
9492_0,,,,2,2,3,5
9493_0,,,,2,2,3,5
9494_0,,,,2,2,3,5
9495_0,,,,2,2,3,5
9496_0,,,,2,2,3,5
9497_0,,,,2,2,3,5
9498_0,,,,2,2,3,5
9499_0,,,,2,2,3,5
9500_0,,,,2,2,3,5
9501_0,,,,2,2,3,5
9502_0,,,,2,2,3,5
9503_0,,,,2,2,3,5
9504_0,,,,2,2,3,5
9505_0,,,,2,2,3,5
9506_0,,,,2,2,3,5
9507_0,,,,2,2,3,5
9508_0,,,,2,2,3,5
9509_0,,,,2,2,3,5
9510_0,,,,2,2,3,5
9511_0,,,,2,2,3,5
9512_0,,,,2,2,3,5
9513_0,,,,2,2,3,5
9514_0,,,,2,2,3,5
9515_0,,,,2,2,3,5
9516_0,,,,2,2,3,5
9517_0,,,,2,2,3,5
9518_0,,,,2,2,3,5
9519_0,,,,2,2,3,5
9520_0,,,,2,2,3,5
9521_0,,,,2,2,3,5
9522_0,,,,2,2,3,5
9523_0,,,,2,2,3,5
9524_0,,,,2,2,3,5
9525_0,,,,2,2,3,5
9526_0,,,,2,2,3,5
9527_0,,,,2,2,3,5
9528_0,,,,2,2,3,5
9529_0,,,,2,2,3,5
9530_0,,,,2,2,3,5
9531_0,,,,2,2,3,5
9532_0,,,,2,2,3,5
9533_0,,,,2,2,3,5
9534_0,,,,2,2,3,5
9535_0,,,,2,2,3,5
9536_0,,,,2,2,3,5
9537_0,,,,2,2,3,5
9538_0,,,,2,2,3,5
9539_0,,,,2,2,3,5
9540_0,,,,2,2,3,5
9541_0,,,,2,2,3,5
9542_0,,,,2,2,3,5
9543_0,,,,2,2,3,5
9544_0,,,,2,2,3,5
9545_0,,,,2,2,3,5
9546_0,,,,2,2,3,5
9547_0,,,,2,2,3,5
9548_0,,,,2,2,3,5
9549_0,,,,2,2,3,5
9550_0,,,,2,2,3,5
9551_0,,,,2,2,3,5
9552_0,,,,2,2,3,5
9553_0,,,,2,2,3,5
9554_0,,,,2,2,3,5
9555_0,,,,2,2,3,5
9556_0,,,,2,2,3,5
9557_0,,,,2,2,3,5
9558_0,,,,2,2,3,5
9559_0,,,,2,2,3,5
9560_0,,,,2,2,3,5
9561_0,,,,2,2,3,5
9562_0,,,,2,2,3,5
9563_0,,,,2,2,3,5
9564_0,,,,2,2,3,5
9565_0,,,,2,2,3,5
9566_0,,,,2,2,3,5
9567_0,,,,2,2,3,5
9568_0,,,,2,2,3,5
9569_0,,,,2,2,3,5
9570_0,,,,2,2,3,5
9571_0,,,,2,2,3,5
9572_0,,,,2,2,3,5
9573_0,,,,2,2,3,5
9574_0,,,,2,2,3,5
9575_0,,,,2,2,3,5
9576_0,,,,2,2,3,5
9577_0,,,,2,2,3,5
9578_0,,,,2,2,3,5
9579_0,,,,2,2,3,5
9580_0,,,,2,2,3,5
9581_0,,,,2,2,3,5
9582_0,,,,2,2,3,5
9583_0,,,,2,2,3,5
9584_0,,,,2,2,3,5
9585_0,,,,2,2,3,5
9586_0,,,,2,2,3,5
9587_0,,,,2,2,3,5
9588_0,,,,2,2,3,5
9589_0,,,,2,2,3,5
9590_0,,,,2,2,3,5
9591_0,,,,2,2,3,5
9592_0,,,,2,2,3,5
9593_0,,,,2,2,3,5
9594_0,,,,2,2,3,5
9595_0,,,,2,2,3,5
9596_0,,,,2,2,3,5
9597_0,,,,2,2,3,5
9598_0,,,,2,2,3,5
9599_0,,,,2,2,3,5
9600_0,,,,2,2,3,5
9601_0,,,,2,2,3,5
9602_0,,,,2,2,3,5
9603_0,,,,2,2,3,5
9604_0,,,,2,2,3,5
9605_0,,,,2,2,3,5
9606_0,,,,2,2,3,5
9607_0,,,,2,2,3,5
9608_0,,,,2,2,3,5
9609_0,,,,2,2,3,5
9610_0,,,,2,2,3,5
9611_0,,,,2,2,3,5
9612_0,,,,2,2,3,5
9613_0,,,,2,2,3,5
9614_0,,,,2,2,3,5
9615_0,,,,2,2,3,5
9616_0,,,,2,2,3,5
9617_0,,,,2,2,3,5
9618_0,,,,2,2,3,5
9619_0,,,,2,2,3,5
9620_0,,,,2,2,3,5
9621_0,,,,2,2,3,5
9622_0,,,,2,2,3,5
9623_0,,,,2,2,3,5
9624_0,,,,2,2,3,5
9625_0,,,,2,2,3,5
9626_0,,,,2,2,3,5
9627_0,,,,2,2,3,5
9628_0,,,,2,2,3,5
9629_0,,,,2,2,3,5
9630_0,,,,2,2,3,5
9631_0,,,,2,2,3,5
9632_0,,,,2,2,3,5
9633_0,,,,2,2,3,5
9634_0,,,,2,2,3,5
9635_0,,,,2,2,3,5
9636_0,,,,2,2,3,5
9637_0,,,,2,2,3,5
9638_0,,,,2,2,3,5
9639_0,,,,2,2,3,5
9640_0,,,,2,2,3,5
9641_0,,,,2,2,3,5
9642_0,,,,2,2,3,5
9643_0,,,,2,2,3,5
9644_0,,,,2,2,3,5
9645_0,,,,2,2,3,5
9646_0,,,,2,2,3,5
9647_0,,,,2,2,3,5
9648_0,,,,2,2,3,5
9649_0,,,,2,2,3,5
9650_0,,,,2,2,3,5
9651_0,,,,2,2,3,5
9652_0,,,,2,2,3,5
9653_0,,,,2,2,3,5
9654_0,,,,2,2,3,5
9655_0,,,,2,2,3,5
9656_0,,,,2,2,3,5
9657_0,,,,2,2,3,5
9658_0,,,,2,2,3,5
9659_0,,,,2,2,3,5
9660_0,,,,2,2,3,5
9661_0,,,,2,2,3,5
9662_0,,,,2,2,3,5
9663_0,,,,2,2,3,5
9664_0,,,,2,2,3,5
9665_0,,,,2,2,3,5
9666_0,,,,2,2,3,5
9667_0,,,,2,2,3,5
9668_0,,,,2,2,3,5
9669_0,,,,2,2,3,5
9670_0,,,,2,2,3,5
9671_0,,,,2,2,3,5
9672_0,,,,2,2,3,5
9673_0,,,,2,2,3,5
9674_0,,,,2,2,3,5
9675_0,,,,2,2,3,5
9676_0,,,,2,2,3,5
9677_0,,,,2,2,3,5
9678_0,,,,2,2,3,5
9679_0,,,,2,2,3,5
9680_0,,,,2,2,3,5
9681_0,,,,2,2,3,5
9682_0,,,,2,2,3,5
9683_0,,,,2,2,3,5
9684_0,,,,2,2,3,5
9685_0,,,,2,2,3,5
9686_0,,,,2,2,3,5
9687_0,,,,2,2,3,5
9688_0,,,,2,2,3,5
9689_0,,,,2,2,3,5
9690_0,,,,2,2,3,5
9691_0,,,,2,2,3,5
9692_0,,,,2,2,3,5
9693_0,,,,2,2,3,5
9694_0,,,,2,2,3,5
9695_0,,,,2,2,3,5
9696_0,,,,2,2,3,5
9697_0,,,,2,2,3,5
9698_0,,,,2,2,3,5
9699_0,,,,2,2,3,5
9700_0,,,,2,2,3,5
9701_0,,,,2,2,3,5
9702_0,,,,2,2,3,5
9703_0,,,,2,2,3,5
9704_0,,,,2,2,3,5
9705_0,,,,2,2,3,5
9706_0,,,,2,2,3,5
9707_0,,,,2,2,3,5
9708_0,,,,2,2,3,5
9709_0,,,,2,2,3,5
9710_0,,,,2,2,3,5
9711_0,,,,2,2,3,5
9712_0,,,,2,2,3,5
9713_0,,,,2,2,3,5
9714_0,,,,2,2,3,5
9715_0,,,,2,2,3,5
9716_0,,,,2,2,3,5
9717_0,,,,2,2,3,5
9718_0,,,,2,2,3,5
9719_0,,,,2,2,3,5
9720_0,,,,2,2,3,5
9721_0,,,,2,2,3,5
9722_0,,,,2,2,3,5
9723_0,,,,2,2,3,5
9724_0,,,,2,2,3,5
9725_0,,,,2,2,3,5
9726_0,,,,2,2,3,5
9727_0,,,,2,2,3,5
9728_0,,,,2,2,3,5
9729_0,,,,2,2,3,5
9730_0,,,,2,2,3,5
9731_0,,,,2,2,3,5
9732_0,,,,2,2,3,5
9733_0,,,,2,2,3,5
9734_0,,,,2,2,3,5
9735_0,,,,2,2,3,5
9736_0,,,,2,2,3,5
9737_0,,,,2,2,3,5
9738_0,,,,2,2,3,5
9739_0,,,,2,2,3,5
9740_0,,,,2,2,3,5
9741_0,,,,2,2,3,5
9742_0,,,,2,2,3,5
9743_0,,,,2,2,3,5
9744_0,,,,2,2,3,5
9745_0,,,,2,2,3,5
9746_0,,,,2,2,3,5
9747_0,,,,2,2,3,5
9748_0,,,,2,2,3,5
9749_0,,,,2,2,3,5
9750_0,,,,2,2,3,5
9751_0,,,,2,2,3,5
9752_0,,,,2,2,3,5
9753_0,,,,2,2,3,5
9754_0,,,,2,2,3,5
9755_0,,,,2,2,3,5
9756_0,,,,2,2,3,5
9757_0,,,,2,2,3,5
9758_0,,,,2,2,3,5
9759_0,,,,2,2,3,5
9760_0,,,,2,2,3,5
9761_0,,,,2,2,3,5
9762_0,,,,2,2,3,5
9763_0,,,,2,2,3,5
9764_0,,,,2,2,3,5
9765_0,,,,2,2,3,5
9766_0,,,,2,2,3,5
9767_0,,,,2,2,3,5
9768_0,,,,2,2,3,5
9769_0,,,,2,2,3,5
9770_0,,,,2,2,3,5
9771_0,,,,2,2,3,5
9772_0,,,,2,2,3,5
9773_0,,,,2,2,3,5
9774_0,,,,2,2,3,5
9775_0,,,,2,2,3,5
9776_0,,,,2,2,3,5
9777_0,,,,2,2,3,5
9778_0,,,,2,2,3,5
9779_0,,,,2,2,3,5
9780_0,,,,2,2,3,5
9781_0,,,,2,2,3,5
9782_0,,,,2,2,3,5
9783_0,,,,2,2,3,5
9784_0,,,,2,2,3,5
9785_0,,,,2,2,3,5
9786_0,,,,2,2,3,5
9787_0,,,,2,2,3,5
9788_0,,,,2,2,3,5
9789_0,,,,2,2,3,5
9790_0,,,,2,2,3,5
9791_0,,,,2,2,3,5
9792_0,,,,2,2,3,5
9793_0,,,,2,2,3,5
9794_0,,,,2,2,3,5
9795_0,,,,2,2,3,5
9796_0,,,,2,2,3,5
9797_0,,,,2,2,3,5
9798_0,,,,2,2,3,5
9799_0,,,,2,2,3,5
9800_0,,,,2,2,3,5
9801_0,,,,2,2,3,5
9802_0,,,,2,2,3,5
9803_0,,,,2,2,3,5
9804_0,,,,2,2,3,5
9805_0,,,,2,2,3,5
9806_0,,,,2,2,3,5
9807_0,,,,2,2,3,5
9808_0,,,,2,2,3,5
9809_0,,,,2,2,3,5
9810_0,,,,2,2,3,5
9811_0,,,,2,2,3,5
9812_0,,,,2,2,3,5
9813_0,,,,2,2,3,5
9814_0,,,,2,2,3,5
9815_0,,,,2,2,3,5
9816_0,,,,2,2,3,5
9817_0,,,,2,2,3,5
9818_0,,,,2,2,3,5
9819_0,,,,2,2,3,5
9820_0,,,,2,2,3,5
9821_0,,,,2,2,3,5
9822_0,,,,2,2,3,5
9823_0,,,,2,2,3,5
9824_0,,,,2,2,3,5
9825_0,,,,2,2,3,5
9826_0,,,,2,2,3,5
9827_0,,,,2,2,3,5
9828_0,,,,2,2,3,5
9829_0,,,,2,2,3,5
9830_0,,,,2,2,3,5
9831_0,,,,2,2,3,5
9832_0,,,,2,2,3,5
9833_0,,,,2,2,3,5
9834_0,,,,2,2,3,5
9835_0,,,,2,2,3,5
9836_0,,,,2,2,3,5
9837_0,,,,2,2,3,5
9838_0,,,,2,2,3,5
9839_0,,,,2,2,3,5
9840_0,,,,2,2,3,5
9841_0,,,,2,2,3,5
9842_0,,,,2,2,3,5
9843_0,,,,2,2,3,5
9844_0,,,,2,2,3,5
9845_0,,,,2,2,3,5
9846_0,,,,2,2,3,5
9847_0,,,,2,2,3,5
9848_0,,,,2,2,3,5
9849_0,,,,2,2,3,5
9850_0,,,,2,2,3,5
9851_0,,,,2,2,3,5
9852_0,,,,2,2,3,5
9853_0,,,,2,2,3,5
9854_0,,,,2,2,3,5
9855_0,,,,2,2,3,5
9856_0,,,,2,2,3,5
9857_0,,,,2,2,3,5
9858_0,,,,2,2,3,5
9859_0,,,,2,2,3,5
9860_0,,,,2,2,3,5
9861_0,,,,2,2,3,5
9862_0,,,,2,2,3,5
9863_0,,,,2,2,3,5
9864_0,,,,2,2,3,5
9865_0,,,,2,2,3,5
9866_0,,,,2,2,3,5
9867_0,,,,2,2,3,5
9868_0,,,,2,2,3,5
9869_0,,,,2,2,3,5
9870_0,,,,2,2,3,5
9871_0,,,,2,2,3,5
9872_0,,,,2,2,3,5
9873_0,,,,2,2,3,5
9874_0,,,,2,2,3,5
9875_0,,,,2,2,3,5
9876_0,,,,2,2,3,5
9877_0,,,,2,2,3,5
9878_0,,,,2,2,3,5
9879_0,,,,2,2,3,5
9880_0,,,,2,2,3,5
9881_0,,,,2,2,3,5
9882_0,,,,2,2,3,5
9883_0,,,,2,2,3,5
9884_0,,,,2,2,3,5
9885_0,,,,2,2,3,5
9886_0,,,,2,2,3,5
9887_0,,,,2,2,3,5
9888_0,,,,2,2,3,5
9889_0,,,,2,2,3,5
9890_0,,,,2,2,3,5
9891_0,,,,2,2,3,5
9892_0,,,,2,2,3,5
9893_0,,,,2,2,3,5
9894_0,,,,2,2,3,5
9895_0,,,,2,2,3,5
9896_0,,,,2,2,3,5
9897_0,,,,2,2,3,5
9898_0,,,,2,2,3,5
9899_0,,,,2,2,3,5
9900_0,,,,2,2,3,5
9901_0,,,,2,2,3,5
9902_0,,,,2,2,3,5
9903_0,,,,2,2,3,5
9904_0,,,,2,2,3,5
9905_0,,,,2,2,3,5
9906_0,,,,2,2,3,5
9907_0,,,,2,2,3,5
9908_0,,,,2,2,3,5
9909_0,,,,2,2,3,5
9910_0,,,,2,2,3,5
9911_0,,,,2,2,3,5
9912_0,,,,2,2,3,5
9913_0,,,,2,2,3,5
9914_0,,,,2,2,3,5
9915_0,,,,2,2,3,5
9916_0,,,,2,2,3,5
9917_0,,,,2,2,3,5
9918_0,,,,2,2,3,5
9919_0,,,,2,2,3,5
9920_0,,,,2,2,3,5
9921_0,,,,2,2,3,5
9922_0,,,,2,2,3,5
9923_0,,,,2,2,3,5
9924_0,,,,2,2,3,5
9925_0,,,,2,2,3,5
9926_0,,,,2,2,3,5
9927_0,,,,2,2,3,5
9928_0,,,,2,2,3,5
9929_0,,,,2,2,3,5
9930_0,,,,2,2,3,5
9931_0,,,,2,2,3,5
9932_0,,,,2,2,3,5
9933_0,,,,2,2,3,5
9934_0,,,,2,2,3,5
9935_0,,,,2,2,3,5
9936_0,,,,2,2,3,5
9937_0,,,,2,2,3,5
9938_0,,,,2,2,3,5
9939_0,,,,2,2,3,5
9940_0,,,,2,2,3,5
9941_0,,,,2,2,3,5
9942_0,,,,2,2,3,5
9943_0,,,,2,2,3,5
9944_0,,,,2,2,3,5
9945_0,,,,2,2,3,5
9946_0,,,,2,2,3,5
9947_0,,,,2,2,3,5
9948_0,,,,2,2,3,5
9949_0,,,,2,2,3,5
9950_0,,,,2,2,3,5
9951_0,,,,2,2,3,5
9952_0,,,,2,2,3,5
9953_0,,,,2,2,3,5
9954_0,,,,2,2,3,5
9955_0,,,,2,2,3,5
9956_0,,,,2,2,3,5
9957_0,,,,2,2,3,5
9958_0,,,,2,2,3,5
9959_0,,,,2,2,3,5
9960_0,,,,2,2,3,5
9961_0,,,,2,2,3,5
9962_0,,,,2,2,3,5
9963_0,,,,2,2,3,5
9964_0,,,,2,2,3,5
9965_0,,,,2,2,3,5
9966_0,,,,2,2,3,5
9967_0,,,,2,2,3,5
9968_0,,,,2,2,3,5
9969_0,,,,2,2,3,5
9970_0,,,,2,2,3,5
9971_0,,,,2,2,3,5
9972_0,,,,2,2,3,5
9973_0,,,,2,2,3,5
9974_0,,,,2,2,3,5
9975_0,,,,2,2,3,5
9976_0,,,,2,2,3,5
9977_0,,,,2,2,3,5
9978_0,,,,2,2,3,5
9979_0,,,,2,2,3,5
9980_0,,,,2,2,3,5
9981_0,,,,2,2,3,5
9982_0,,,,2,2,3,5
9984_0,,,,2,2,3,5
C(CNC(CO)CO)=O,,,3,1,1,0,1
9986_0,,,,2,2,3,5
C(CNC(CO)CO)(C(CO)O)=O,,,3,1,1,0,1
9987_0,,,,2,2,3,5
9988_0,,,,2,2,3,5
9989_0,,,,2,2,3,5
9990_0,,,,2,2,3,5
9991_0,,,,2,2,3,5
9993_0,,,,2,2,3,5
C(C(C(CO)NC(CO)CO)O)=O,,,3,1,1,0,1
9995_0,,,,2,2,3,5
C(CC(CO)NCC=O)=O,,,3,1,1,0,1
9996_0,,,,2,2,3,5
9997_0,,,,2,2,3,5
9998_0,,,,2,2,3,5
9999_0,,,,2,2,3,5
10000_0,,,,2,2,3,5
10002_0,,,,2,2,3,5
C(C(C(C)NCC=O)O)=O,,,3,1,1,0,1
10003_0,,,,2,2,3,5
10004_0,,,,2,2,3,5
10005_0,,,,2,2,3,5
10006_0,,,,2,2,3,5
10007_0,,,,2,2,3,5
10009_0,,,,2,2,3,5
C(CNC(C)C(CO)O)=O,,,3,1,1,0,1
10010_0,,,,2,2,3,5
10011_0,,,,2,2,3,5
10012_0,,,,2,2,3,5
10013_0,,,,2,2,3,5
10014_0,,,,2,2,3,5
10016_0,,,,2,2,3,5
C(C(CC(CO)NCC=O)O)=O,,,3,1,1,0,1
10017_0,,,,2,2,3,5
10018_0,,,,2,2,3,5
10019_0,,,,2,2,3,5
10020_0,,,,2,2,3,5
10021_0,,,,2,2,3,5
10023_0,,,,2,2,3,5
C(CNC(CO)CCO)=O,,,3,1,1,0,1
10024_0,,,,2,2,3,5
10025_0,,,,2,2,3,5
10026_0,,,,2,2,3,5
10027_0,,,,2,2,3,5
10028_0,,,,2,2,3,5
10030_0,,,,2,2,3,5
C(C(C(C(C)NCC=O)O)O)=O,,,3,1,1,0,1
10031_0,,,,2,2,3,5
10032_0,,,,2,2,3,5
10033_0,,,,2,2,3,5
10034_0,,,,2,2,3,5
10035_0,,,,2,2,3,5
10037_0,,,,2,2,3,5
C(CNC(C)CO)=O,,,3,1,1,0,1
10039_0,,,,2,2,3,5
C(CNC(CO)C)(C(CO)O)=O,,,3,1,1,0,1
10040_0,,,,2,2,3,5
10041_0,,,,2,2,3,5
10042_0,,,,2,2,3,5
10043_0,,,,2,2,3,5
10044_0,,,,2,2,3,5
10046_0,,,,2,2,3,5
C(C(C(CO)NC(CO)C)O)=O,,,3,1,1,0,1
10048_0,,,,2,2,3,5
C(CNC(CO)C(CO)O)=O,,,3,1,1,0,1
10049_0,,,,2,2,3,5
10050_0,,,,2,2,3,5
10051_0,,,,2,2,3,5
10052_0,,,,2,2,3,5
10053_0,,,,2,2,3,5
10054_0,,,,2,2,3,5
10055_0,,,,2,2,3,5
10056_0,,,,2,2,3,5
10057_0,,,,2,2,3,5
10058_0,,,,2,2,3,5
10059_0,,,,2,2,3,5
10060_0,,,,2,2,3,5
10061_0,,,,2,2,3,5
10062_0,,,,2,2,3,5
10063_0,,,,2,2,3,5
10064_0,,,,2,2,3,5
10065_0,,,,2,2,3,5
10066_0,,,,2,2,3,5
10067_0,,,,2,2,3,5
10068_0,,,,2,2,3,5
10069_0,,,,2,2,3,5
10070_0,,,,2,2,3,5
10071_0,,,,2,2,3,5
10072_0,,,,2,2,3,5
10073_0,,,,2,2,3,5
10074_0,,,,2,2,3,5
10075_0,,,,2,2,3,5
10076_0,,,,2,2,3,5
10077_0,,,,2,2,3,5
10078_0,,,,2,2,3,5
10079_0,,,,2,2,3,5
10080_0,,,,2,2,3,5
10081_0,,,,2,2,3,5
10082_0,,,,2,2,3,5
10083_0,,,,2,2,3,5
10084_0,,,,2,2,3,5
10085_0,,,,2,2,3,5
10086_0,,,,2,2,3,5
10087_0,,,,2,2,3,5
10088_0,,,,2,2,3,5
10089_0,,,,2,2,3,5
10090_0,,,,2,2,3,5
10091_0,,,,2,2,3,5
10092_0,,,,2,2,3,5
10093_0,,,,2,2,3,5
10094_0,,,,2,2,3,5
10095_0,,,,2,2,3,5
10096_0,,,,2,2,3,5
10097_0,,,,2,2,3,5
10098_0,,,,2,2,3,5
10099_0,,,,2,2,3,5
10100_0,,,,2,2,3,5
10101_0,,,,2,2,3,5
10102_0,,,,2,2,3,5
10103_0,,,,2,2,3,5
10104_0,,,,2,2,3,5
10105_0,,,,2,2,3,5
10106_0,,,,2,2,3,5
10107_0,,,,2,2,3,5
10108_0,,,,2,2,3,5
10109_0,,,,2,2,3,5
10110_0,,,,2,2,3,5
10111_0,,,,2,2,3,5
10112_0,,,,2,2,3,5
10113_0,,,,2,2,3,5
10114_0,,,,2,2,3,5
10115_0,,,,2,2,3,5
10116_0,,,,2,2,3,5
10117_0,,,,2,2,3,5
10118_0,,,,2,2,3,5
10119_0,,,,2,2,3,5
10120_0,,,,2,2,3,5
10121_0,,,,2,2,3,5
10122_0,,,,2,2,3,5
10123_0,,,,2,2,3,5
10125_0,,,,2,2,3,5
C(CNC(CNC)C(CO)O)=O,,,3,1,1,0,1
10126_0,,,,2,2,3,5
10127_0,,,,2,2,3,5
10128_0,,,,2,2,3,5
10129_0,,,,2,2,3,5
10130_0,,,,2,2,3,5
10131_0,,,,2,2,3,5
10132_0,,,,2,2,3,5
10133_0,,,,2,2,3,5
10134_0,,,,2,2,3,5
10135_0,,,,2,2,3,5
10136_0,,,,2,2,3,5
10137_0,,,,2,2,3,5
10138_0,,,,2,2,3,5
10139_0,,,,2,2,3,5
10140_0,,,,2,2,3,5
10141_0,,,,2,2,3,5
10142_0,,,,2,2,3,5
10143_0,,,,2,2,3,5
10144_0,,,,2,2,3,5
10145_0,,,,2,2,3,5
10146_0,,,,2,2,3,5
10147_0,,,,2,2,3,5
10148_0,,,,2,2,3,5
10149_0,,,,2,2,3,5
10150_0,,,,2,2,3,5
10151_0,,,,2,2,3,5
10152_0,,,,2,2,3,5
10153_0,,,,2,2,3,5
10154_0,,,,2,2,3,5
10155_0,,,,2,2,3,5
10156_0,,,,2,2,3,5
10157_0,,,,2,2,3,5
10158_0,,,,2,2,3,5
10159_0,,,,2,2,3,5
10160_0,,,,2,2,3,5
10161_0,,,,2,2,3,5
10162_0,,,,2,2,3,5
10163_0,,,,2,2,3,5
10164_0,,,,2,2,3,5
10165_0,,,,2,2,3,5
10166_0,,,,2,2,3,5
10167_0,,,,2,2,3,5
10168_0,,,,2,2,3,5
10169_0,,,,2,2,3,5
10170_0,,,,2,2,3,5
10171_0,,,,2,2,3,5
10172_0,,,,2,2,3,5
10173_0,,,,2,2,3,5
10174_0,,,,2,2,3,5
10175_0,,,,2,2,3,5
10176_0,,,,2,2,3,5
10177_0,,,,2,2,3,5
10178_0,,,,2,2,3,5
10179_0,,,,2,2,3,5
10180_0,,,,2,2,3,5
10181_0,,,,2,2,3,5
10182_0,,,,2,2,3,5
10183_0,,,,2,2,3,5
10184_0,,,,2,2,3,5
10185_0,,,,2,2,3,5
10186_0,,,,2,2,3,5
10187_0,,,,2,2,3,5
10188_0,,,,2,2,3,5
10189_0,,,,2,2,3,5
10190_0,,,,2,2,3,5
10191_0,,,,2,2,3,5
10192_0,,,,2,2,3,5
10193_0,,,,2,2,3,5
10194_0,,,,2,2,3,5
10195_0,,,,2,2,3,5
10196_0,,,,2,2,3,5
10197_0,,,,2,2,3,5
10198_0,,,,2,2,3,5
10199_0,,,,2,2,3,5
10200_0,,,,2,2,3,5
10202_0,,,,2,2,3,5
C(CNC(CCO)CC(C=O)=O)=O,,,3,1,1,0,1
10204_0,,,,2,2,3,5
C(CNC(CCC(C=O)=O)CO)=O,,,3,1,1,0,1
10206_0,,,,2,2,3,5
C(CNC(C)C(CC(C=O)=O)O)=O,,,3,1,1,0,1
10208_0,,,,2,2,3,5
C(CNC(CC=O)CC(CO)=O)=O,,,3,1,1,0,1
10210_0,,,,2,2,3,5
C(CC(CO)NCC=O)(CC=O)=O,,,3,1,1,0,1
10212_0,,,,2,2,3,5
C(C)(C(C(CC=O)NCC=O)O)=O,,,3,1,1,0,1
10214_0,,,,2,2,3,5
C(C(C(C)NCC=O)O)(CC=O)=O,,,3,1,1,0,1
10216_0,,,,2,2,3,5
C(CC(C(CC=O)NCC=O)O)=O,,,3,1,1,0,1
10218_0,,,,2,2,3,5
C(C)(CC(C(C=O)O)NCC=O)=O,,,3,1,1,0,1
10220_0,,,,2,2,3,5
C(CC(C)NCC=O)(C(C=O)O)=O,,,3,1,1,0,1
10222_0,,,,2,2,3,5
C(CCC(C(C=O)O)NCC=O)=O,,,3,1,1,0,1
10224_0,,,,2,2,3,5
C(CC(CC(C=O)O)NCC=O)=O,,,3,1,1,0,1
10226_0,,,,2,2,3,5
C(CNC(C=CCO)C(C=O)O)=O,,,3,1,1,0,1
10228_0,,,,2,2,3,5
C(CNC(C=CC=O)C(CO)O)=O,,,3,1,1,0,1
10230_0,,,,2,2,3,5
C(C(C(C(C=C)NCC=O)O)O)=O,,,3,1,1,0,1
10232_0,,,,2,2,3,5
C(C(C=CC(CO)NCC=O)O)=O,,,3,1,1,0,1
10233_0,,,,2,2,3,5
10234_0,,,,2,2,3,5
10235_0,,,,2,2,3,5
10236_0,,,,2,2,3,5
10237_0,,,,2,2,3,5
10238_0,,,,2,2,3,5
10239_0,,,,2,2,3,5
10240_0,,,,2,2,3,5
10241_0,,,,2,2,3,5
10242_0,,,,2,2,3,5
10243_0,,,,2,2,3,5
10244_0,,,,2,2,3,5
10245_0,,,,2,2,3,5
10246_0,,,,2,2,3,5
10247_0,,,,2,2,3,5
10248_0,,,,2,2,3,5
10249_0,,,,2,2,3,5
10250_0,,,,2,2,3,5
10251_0,,,,2,2,3,5
10252_0,,,,2,2,3,5
10253_0,,,,2,2,3,5
10254_0,,,,2,2,3,5
10255_0,,,,2,2,3,5
10256_0,,,,2,2,3,5
10257_0,,,,2,2,3,5
10258_0,,,,2,2,3,5
10259_0,,,,2,2,3,5
10260_0,,,,2,2,3,5
10261_0,,,,2,2,3,5
10262_0,,,,2,2,3,5
10263_0,,,,2,2,3,5
10264_0,,,,2,2,3,5
10265_0,,,,2,2,3,5
10266_0,,,,2,2,3,5
10267_0,,,,2,2,3,5
10268_0,,,,2,2,3,5
10269_0,,,,2,2,3,5
10270_0,,,,2,2,3,5
10271_0,,,,2,2,3,5
10272_0,,,,2,2,3,5
10273_0,,,,2,2,3,5
10274_0,,,,2,2,3,5
10275_0,,,,2,2,3,5
10276_0,,,,2,2,3,5
10277_0,,,,2,2,3,5
10278_0,,,,2,2,3,5
10279_0,,,,2,2,3,5
10280_0,,,,2,2,3,5
10281_0,,,,2,2,3,5
10282_0,,,,2,2,3,5
10283_0,,,,2,2,3,5
10284_0,,,,2,2,3,5
10285_0,,,,2,2,3,5
10286_0,,,,2,2,3,5
10287_0,,,,2,2,3,5
10288_0,,,,2,2,3,5
10289_0,,,,2,2,3,5
10290_0,,,,2,2,3,5
10291_0,,,,2,2,3,5
10292_0,,,,2,2,3,5
10293_0,,,,2,2,3,5
10294_0,,,,2,2,3,5
10295_0,,,,2,2,3,5
10296_0,,,,2,2,3,5
10297_0,,,,2,2,3,5
10298_0,,,,2,2,3,5
10299_0,,,,2,2,3,5
10300_0,,,,2,2,3,5
10301_0,,,,2,2,3,5
10302_0,,,,2,2,3,5
10303_0,,,,2,2,3,5
10304_0,,,,2,2,3,5
10305_0,,,,2,2,3,5
10306_0,,,,2,2,3,5
10307_0,,,,2,2,3,5
10308_0,,,,2,2,3,5
10309_0,,,,2,2,3,5
10310_0,,,,2,2,3,5
10311_0,,,,2,2,3,5
10312_0,,,,2,2,3,5
10313_0,,,,2,2,3,5
10314_0,,,,2,2,3,5
10315_0,,,,2,2,3,5
10316_0,,,,2,2,3,5
10317_0,,,,2,2,3,5
10318_0,,,,2,2,3,5
10319_0,,,,2,2,3,5
10320_0,,,,2,2,3,5
10321_0,,,,2,2,3,5
10322_0,,,,2,2,3,5
10323_0,,,,2,2,3,5
10324_0,,,,2,2,3,5
10325_0,,,,2,2,3,5
10326_0,,,,2,2,3,5
10327_0,,,,2,2,3,5
10328_0,,,,2,2,3,5
10329_0,,,,2,2,3,5
10330_0,,,,2,2,3,5
10331_0,,,,2,2,3,5
10332_0,,,,2,2,3,5
10333_0,,,,2,2,3,5
10334_0,,,,2,2,3,5
10335_0,,,,2,2,3,5
10336_0,,,,2,2,3,5
10337_0,,,,2,2,3,5
10338_0,,,,2,2,3,5
10339_0,,,,2,2,3,5
10340_0,,,,2,2,3,5
10341_0,,,,2,2,3,5
10342_0,,,,2,2,3,5
10343_0,,,,2,2,3,5
10344_0,,,,2,2,3,5
10345_0,,,,2,2,3,5
10346_0,,,,2,2,3,5
10347_0,,,,2,2,3,5
10348_0,,,,2,2,3,5
10349_0,,,,2,2,3,5
10350_0,,,,2,2,3,5
10351_0,,,,2,2,3,5
10352_0,,,,2,2,3,5
10353_0,,,,2,2,3,5
10354_0,,,,2,2,3,5
10355_0,,,,2,2,3,5
10356_0,,,,2,2,3,5
10357_0,,,,2,2,3,5
10358_0,,,,2,2,3,5
10359_0,,,,2,2,3,5
10360_0,,,,2,2,3,5
10361_0,,,,2,2,3,5
10362_0,,,,2,2,3,5
10363_0,,,,2,2,3,5
10364_0,,,,2,2,3,5
10365_0,,,,2,2,3,5
10366_0,,,,2,2,3,5
10367_0,,,,2,2,3,5
10368_0,,,,2,2,3,5
10369_0,,,,2,2,3,5
10370_0,,,,2,2,3,5
10371_0,,,,2,2,3,5
10372_0,,,,2,2,3,5
10373_0,,,,2,2,3,5
10374_0,,,,2,2,3,5
10375_0,,,,2,2,3,5
10376_0,,,,2,2,3,5
10377_0,,,,2,2,3,5
10378_0,,,,2,2,3,5
10379_0,,,,2,2,3,5
10380_0,,,,2,2,3,5
10381_0,,,,2,2,3,5
10382_0,,,,2,2,3,5
10383_0,,,,2,2,3,5
10384_0,,,,2,2,3,5
10385_0,,,,2,2,3,5
10386_0,,,,2,2,3,5
10387_0,,,,2,2,3,5
10388_0,,,,2,2,3,5
10389_0,,,,2,2,3,5
10390_0,,,,2,2,3,5
10391_0,,,,2,2,3,5
10392_0,,,,2,2,3,5
10393_0,,,,2,2,3,5
10394_0,,,,2,2,3,5
10395_0,,,,2,2,3,5
10396_0,,,,2,2,3,5
10397_0,,,,2,2,3,5
10398_0,,,,2,2,3,5
10399_0,,,,2,2,3,5
10400_0,,,,2,2,3,5
10401_0,,,,2,2,3,5
10402_0,,,,2,2,3,5
10403_0,,,,2,2,3,5
10404_0,,,,2,2,3,5
10405_0,,,,2,2,3,5
10406_0,,,,2,2,3,5
10407_0,,,,2,2,3,5
10408_0,,,,2,2,3,5
10409_0,,,,2,2,3,5
10410_0,,,,2,2,3,5
10411_0,,,,2,2,3,5
10412_0,,,,2,2,3,5
10413_0,,,,2,2,3,5
10414_0,,,,2,2,3,5
10415_0,,,,2,2,3,5
10416_0,,,,2,2,3,5
10417_0,,,,2,2,3,5
10418_0,,,,2,2,3,5
10419_0,,,,2,2,3,5
10420_0,,,,2,2,3,5
10421_0,,,,2,2,3,5
10422_0,,,,2,2,3,5
10423_0,,,,2,2,3,5
10424_0,,,,2,2,3,5
10425_0,,,,2,2,3,5
10426_0,,,,2,2,3,5
10427_0,,,,2,2,3,5
10428_0,,,,2,2,3,5
10429_0,,,,2,2,3,5
10430_0,,,,2,2,3,5
10431_0,,,,2,2,3,5
10432_0,,,,2,2,3,5
10433_0,,,,2,2,3,5
10434_0,,,,2,2,3,5
10435_0,,,,2,2,3,5
10436_0,,,,2,2,3,5
10437_0,,,,2,2,3,5
10438_0,,,,2,2,3,5
10439_0,,,,2,2,3,5
10440_0,,,,2,2,3,5
10441_0,,,,2,2,3,5
10442_0,,,,2,2,3,5
10443_0,,,,2,2,3,5
10444_0,,,,2,2,3,5
10445_0,,,,2,2,3,5
10446_0,,,,2,2,3,5
10447_0,,,,2,2,3,5
10448_0,,,,2,2,3,5
10449_0,,,,2,2,3,5
10450_0,,,,2,2,3,5
10451_0,,,,2,2,3,5
10452_0,,,,2,2,3,5
10453_0,,,,2,2,3,5
10454_0,,,,2,2,3,5
10455_0,,,,2,2,3,5
10456_0,,,,2,2,3,5
10457_0,,,,2,2,3,5
10458_0,,,,2,2,3,5
10459_0,,,,2,2,3,5
10460_0,,,,2,2,3,5
10461_0,,,,2,2,3,5
10462_0,,,,2,2,3,5
10463_0,,,,2,2,3,5
10464_0,,,,2,2,3,5
10465_0,,,,2,2,3,5
10466_0,,,,2,2,3,5
10467_0,,,,2,2,3,5
10468_0,,,,2,2,3,5
10469_0,,,,2,2,3,5
10470_0,,,,2,2,3,5
10471_0,,,,2,2,3,5
10472_0,,,,2,2,3,5
10473_0,,,,2,2,3,5
10474_0,,,,2,2,3,5
10475_0,,,,2,2,3,5
10476_0,,,,2,2,3,5
10477_0,,,,2,2,3,5
10478_0,,,,2,2,3,5
10479_0,,,,2,2,3,5
10480_0,,,,2,2,3,5
10481_0,,,,2,2,3,5
10482_0,,,,2,2,3,5
10483_0,,,,2,2,3,5
10484_0,,,,2,2,3,5
10485_0,,,,2,2,3,5
10486_0,,,,2,2,3,5
10487_0,,,,2,2,3,5
10488_0,,,,2,2,3,5
10489_0,,,,2,2,3,5
10490_0,,,,2,2,3,5
10491_0,,,,2,2,3,5
10492_0,,,,2,2,3,5
10493_0,,,,2,2,3,5
10494_0,,,,2,2,3,5
10495_0,,,,2,2,3,5
10496_0,,,,2,2,3,5
10497_0,,,,2,2,3,5
10498_0,,,,2,2,3,5
10499_0,,,,2,2,3,5
10500_0,,,,2,2,3,5
10501_0,,,,2,2,3,5
10502_0,,,,2,2,3,5
10503_0,,,,2,2,3,5
10504_0,,,,2,2,3,5
10505_0,,,,2,2,3,5
10506_0,,,,2,2,3,5
10507_0,,,,2,2,3,5
10508_0,,,,2,2,3,5
10509_0,,,,2,2,3,5
10510_0,,,,2,2,3,5
10511_0,,,,2,2,3,5
10512_0,,,,2,2,3,5
10513_0,,,,2,2,3,5
10514_0,,,,2,2,3,5
10515_0,,,,2,2,3,5
10516_0,,,,2,2,3,5
10517_0,,,,2,2,3,5
10518_0,,,,2,2,3,5
10519_0,,,,2,2,3,5
10520_0,,,,2,2,3,5
10521_0,,,,2,2,3,5
10522_0,,,,2,2,3,5
10523_0,,,,2,2,3,5
10524_0,,,,2,2,3,5
10525_0,,,,2,2,3,5
10526_0,,,,2,2,3,5
10527_0,,,,2,2,3,5
10528_0,,,,2,2,3,5
10529_0,,,,2,2,3,5
10530_0,,,,2,2,3,5
10531_0,,,,2,2,3,5
10532_0,,,,2,2,3,5
10533_0,,,,2,2,3,5
10534_0,,,,2,2,3,5
10535_0,,,,2,2,3,5
10536_0,,,,2,2,3,5
10537_0,,,,2,2,3,5
10538_0,,,,2,2,3,5
10539_0,,,,2,2,3,5
10540_0,,,,2,2,3,5
10541_0,,,,2,2,3,5
10542_0,,,,2,2,3,5
10543_0,,,,2,2,3,5
10544_0,,,,2,2,3,5
10545_0,,,,2,2,3,5
10546_0,,,,2,2,3,5
10547_0,,,,2,2,3,5
10548_0,,,,2,2,3,5
10549_0,,,,2,2,3,5
10550_0,,,,2,2,3,5
10551_0,,,,2,2,3,5
10552_0,,,,2,2,3,5
10553_0,,,,2,2,3,5
10554_0,,,,2,2,3,5
10555_0,,,,2,2,3,5
10556_0,,,,2,2,3,5
10557_0,,,,2,2,3,5
10558_0,,,,2,2,3,5
10559_0,,,,2,2,3,5
10560_0,,,,2,2,3,5
10561_0,,,,2,2,3,5
10562_0,,,,2,2,3,5
10563_0,,,,2,2,3,5
10564_0,,,,2,2,3,5
10565_0,,,,2,2,3,5
10566_0,,,,2,2,3,5
10567_0,,,,2,2,3,5
10568_0,,,,2,2,3,5
10569_0,,,,2,2,3,5
10570_0,,,,2,2,3,5
10571_0,,,,2,2,3,5
10572_0,,,,2,2,3,5
10573_0,,,,2,2,3,5
10574_0,,,,2,2,3,5
10575_0,,,,2,2,3,5
10576_0,,,,2,2,3,5
10577_0,,,,2,2,3,5
10578_0,,,,2,2,3,5
10579_0,,,,2,2,3,5
10580_0,,,,2,2,3,5
10581_0,,,,2,2,3,5
10582_0,,,,2,2,3,5
10583_0,,,,2,2,3,5
10584_0,,,,2,2,3,5
10585_0,,,,2,2,3,5
10586_0,,,,2,2,3,5
10587_0,,,,2,2,3,5
10588_0,,,,2,2,3,5
10589_0,,,,2,2,3,5
10590_0,,,,2,2,3,5
10591_0,,,,2,2,3,5
10592_0,,,,2,2,3,5
10593_0,,,,2,2,3,5
10594_0,,,,2,2,3,5
10595_0,,,,2,2,3,5
10596_0,,,,2,2,3,5
10597_0,,,,2,2,3,5
10598_0,,,,2,2,3,5
10599_0,,,,2,2,3,5
10600_0,,,,2,2,3,5
10601_0,,,,2,2,3,5
10602_0,,,,2,2,3,5
10603_0,,,,2,2,3,5
10604_0,,,,2,2,3,5
10605_0,,,,2,2,3,5
10606_0,,,,2,2,3,5
10607_0,,,,2,2,3,5
10608_0,,,,2,2,3,5
10609_0,,,,2,2,3,5
10610_0,,,,2,2,3,5
10611_0,,,,2,2,3,5
10612_0,,,,2,2,3,5
10613_0,,,,2,2,3,5
10614_0,,,,2,2,3,5
10615_0,,,,2,2,3,5
10616_0,,,,2,2,3,5
10617_0,,,,2,2,3,5
10618_0,,,,2,2,3,5
10619_0,,,,2,2,3,5
10620_0,,,,2,2,3,5
10621_0,,,,2,2,3,5
10622_0,,,,2,2,3,5
10623_0,,,,2,2,3,5
10624_0,,,,2,2,3,5
10625_0,,,,2,2,3,5
10626_0,,,,2,2,3,5
10627_0,,,,2,2,3,5
10628_0,,,,2,2,3,5
10629_0,,,,2,2,3,5
10630_0,,,,2,2,3,5
10631_0,,,,2,2,3,5
10632_0,,,,2,2,3,5
10633_0,,,,2,2,3,5
10634_0,,,,2,2,3,5
10635_0,,,,2,2,3,5
10636_0,,,,2,2,3,5
10637_0,,,,2,2,3,5
10638_0,,,,2,2,3,5
10639_0,,,,2,2,3,5
10640_0,,,,2,2,3,5
10641_0,,,,2,2,3,5
10642_0,,,,2,2,3,5
10643_0,,,,2,2,3,5
10644_0,,,,2,2,3,5
10645_0,,,,2,2,3,5
10646_0,,,,2,2,3,5
10647_0,,,,2,2,3,5
10648_0,,,,2,2,3,5
10649_0,,,,2,2,3,5
10650_0,,,,2,2,3,5
10651_0,,,,2,2,3,5
10652_0,,,,2,2,3,5
10653_0,,,,2,2,3,5
10654_0,,,,2,2,3,5
10655_0,,,,2,2,3,5
10656_0,,,,2,2,3,5
10657_0,,,,2,2,3,5
10658_0,,,,2,2,3,5
10659_0,,,,2,2,3,5
10660_0,,,,2,2,3,5
10661_0,,,,2,2,3,5
10662_0,,,,2,2,3,5
10663_0,,,,2,2,3,5
10664_0,,,,2,2,3,5
10665_0,,,,2,2,3,5
10666_0,,,,2,2,3,5
10667_0,,,,2,2,3,5
10668_0,,,,2,2,3,5
10669_0,,,,2,2,3,5
10670_0,,,,2,2,3,5
10671_0,,,,2,2,3,5
10672_0,,,,2,2,3,5
10673_0,,,,2,2,3,5
10674_0,,,,2,2,3,5
10675_0,,,,2,2,3,5
10676_0,,,,2,2,3,5
10677_0,,,,2,2,3,5
10678_0,,,,2,2,3,5
10679_0,,,,2,2,3,5
10680_0,,,,2,2,3,5
10681_0,,,,2,2,3,5
10682_0,,,,2,2,3,5
10683_0,,,,2,2,3,5
10684_0,,,,2,2,3,5
10685_0,,,,2,2,3,5
10686_0,,,,2,2,3,5
10687_0,,,,2,2,3,5
10688_0,,,,2,2,3,5
10689_0,,,,2,2,3,5
10690_0,,,,2,2,3,5
10691_0,,,,2,2,3,5
10692_0,,,,2,2,3,5
10693_0,,,,2,2,3,5
10694_0,,,,2,2,3,5
10695_0,,,,2,2,3,5
10696_0,,,,2,2,3,5
10697_0,,,,2,2,3,5
10698_0,,,,2,2,3,5
10699_0,,,,2,2,3,5
10700_0,,,,2,2,3,5
10701_0,,,,2,2,3,5
10702_0,,,,2,2,3,5
10703_0,,,,2,2,3,5
10704_0,,,,2,2,3,5
10705_0,,,,2,2,3,5
10706_0,,,,2,2,3,5
10707_0,,,,2,2,3,5
10708_0,,,,2,2,3,5
10709_0,,,,2,2,3,5
10710_0,,,,2,2,3,5
10711_0,,,,2,2,3,5
10712_0,,,,2,2,3,5
10713_0,,,,2,2,3,5
10714_0,,,,2,2,3,5
10715_0,,,,2,2,3,5
10716_0,,,,2,2,3,5
10717_0,,,,2,2,3,5
10718_0,,,,2,2,3,5
10719_0,,,,2,2,3,5
10720_0,,,,2,2,3,5
10721_0,,,,2,2,3,5
10722_0,,,,2,2,3,5
10723_0,,,,2,2,3,5
10724_0,,,,2,2,3,5
10725_0,,,,2,2,3,5
10726_0,,,,2,2,3,5
10727_0,,,,2,2,3,5
10728_0,,,,2,2,3,5
10729_0,,,,2,2,3,5
10730_0,,,,2,2,3,5
10731_0,,,,2,2,3,5
10732_0,,,,2,2,3,5
10733_0,,,,2,2,3,5
10734_0,,,,2,2,3,5
10735_0,,,,2,2,3,5
10736_0,,,,2,2,3,5
10737_0,,,,2,2,3,5
10738_0,,,,2,2,3,5
10739_0,,,,2,2,3,5
10740_0,,,,2,2,3,5
10741_0,,,,2,2,3,5
10742_0,,,,2,2,3,5
10743_0,,,,2,2,3,5
10744_0,,,,2,2,3,5
10745_0,,,,2,2,3,5
10746_0,,,,2,2,3,5
10747_0,,,,2,2,3,5
10748_0,,,,2,2,3,5
10749_0,,,,2,2,3,5
10750_0,,,,2,2,3,5
10751_0,,,,2,2,3,5
10752_0,,,,2,2,3,5
10753_0,,,,2,2,3,5
10754_0,,,,2,2,3,5
10755_0,,,,2,2,3,5
10756_0,,,,2,2,3,5
10757_0,,,,2,2,3,5
10758_0,,,,2,2,3,5
10759_0,,,,2,2,3,5
10760_0,,,,2,2,3,5
10761_0,,,,2,2,3,5
10762_0,,,,2,2,3,5
10763_0,,,,2,2,3,5
10764_0,,,,2,2,3,5
10765_0,,,,2,2,3,5
10766_0,,,,2,2,3,5
10767_0,,,,2,2,3,5
10768_0,,,,2,2,3,5
10769_0,,,,2,2,3,5
10770_0,,,,2,2,3,5
