Id,Label,timeset,gen,type,weighted indegree,weighted outdegree,Weighted Degree
3_0,,,,2,2,1,3
C(C(C)(CC(C(O)=O)=O)O)(O)=O,,,1,1,6,9,15
5_0,,,,2,2,1,3
C(C(CO)O)(O)=O,,,1,1,43,70,113
8_0,,,,2,1,2,3
C(C)=O,,,1,1,280,755,1035
C(=O)=O,,,1,1,400,415,815
10_0,,,,2,2,1,3
C(CC(C)O)=O,,,2,1,76,205,281
12_0,,,,2,2,1,3
C(C(CC(C)O)=O)(O)=O,,,2,1,13,24,37
14_0,,,,2,2,1,3
C(CC(O)=O)=O,,,2,1,71,188,259
16_0,,,,2,2,1,3
C(C(C)(CC=O)O)(O)=O,,,2,1,16,25,41
18_0,,,,2,2,1,3
C(CC(C(O)=O)=O)(O)=O,,,2,1,11,21,32
20_0,,,,2,1,2,3
O,,,0,1,2684,2115,4799
C(C(O)=O)(CC(C(C)=O)=O)=O,,,2,1,10,11,21
22_0,,,,2,1,2,3
C(C(CO)=O)=O,,,2,1,121,254,375
23_0,,,,2,1,2,3
C(C(C)=O)(O)=O,,,0,1,69,130,199
25_0,,,,2,2,1,3
C(C(CO)(C(C)O)O)(O)=O,,,2,1,9,8,17
25_1,,,,2,2,1,3
27_0,,,,2,2,1,3
C(C(C(O)=O)(CO)O)(O)=O,,,2,1,8,4,12
27_1,,,,2,2,1,3
29_0,,,,2,2,1,3
C(C(CO)(C(C(O)=O)(C)O)O)(O)=O,,,2,1,11,11,22
29_1,,,,2,2,1,3
32_0,,,,2,1,2,3
C=O,,,2,1,468,1933,2401
C(CO)(O)=O,,,2,1,67,144,211
33_0,,,,2,1,2,3
34_0,,,,2,1,2,3
36_0,,,,2,1,2,3
C(C(C)=CC(C(O)=O)=O)(O)=O,,,2,1,4,5,9
38_0,,,,2,1,2,3
C=C(C(O)=O)CC(C(O)=O)=O,,,2,1,6,8,14
40_0,,,,2,2,1,3
C(C(C)(C(C(C(O)=O)O)O)O)(O)=O,,,2,1,10,11,21
42_0,,,,2,2,1,3
C(CO)O,,,2,1,7,32,39
44_0,,,,2,1,1,2
C1(C(C)(CC(C(O)=O)(O)O1)O)=O,,,2,1,3,6,9
45_0,,,,2,1,2,3
47_0,,,,2,1,2,3
C(C1(C)CC(C(O1)=O)=O)(O)=O,,,2,1,6,4,10
49_0,,,,2,1,2,3
C1(C(C)(CC(C(O1)=O)=O)O)=O,,,2,1,8,7,15
51_0,,,,2,1,1,2
C(C1(CC(C(C1)=O)=O)O)(O)=O,,,3,1,8,8,16
53_0,,,,2,2,1,3
C(C(C(C)O)C(CC(C)O)O)=O,,,3,1,12,14,26
53_1,,,,2,2,1,3
55_0,,,,2,2,1,3
C(C(C=O)C(CC(C)O)O)(O)=O,,,3,1,10,13,23
55_1,,,,2,2,1,3
57_0,,,,2,2,1,3
C(C(C(C(CC(C)O)O)O)=O)=O,,,3,1,12,16,28
57_1,,,,2,2,1,3
59_0,,,,2,2,1,3
C(CC(CC(C)O)O)=O,,,3,1,17,29,46
61_0,,,,2,2,1,3
C(C(CC(CC(C)O)O)=O)(O)=O,,,3,1,7,10,17
63_0,,,,2,2,1,3
C(C(C(CC(O)=O)O)C(C)O)=O,,,3,1,10,13,23
63_1,,,,2,2,1,3
65_0,,,,2,2,1,3
C(C(C(C)O)C(C(CO)=O)O)=O,,,3,1,14,16,30
65_1,,,,2,2,1,3
67_0,,,,2,2,1,3
C(C(C(C)O)C(C=O)(CO)O)=O,,,3,1,12,17,29
67_1,,,,2,2,1,3
69_0,,,,2,2,1,3
C(C(CO)C(C)O)=O,,,3,1,31,48,79
69_1,,,,2,2,1,3
71_0,,,,2,2,1,3
C(C(C(C)O)C(C)O)=O,,,3,1,14,19,33
71_1,,,,2,2,1,3
73_0,,,,2,2,1,3
C(C(C=O)C(C)O)(O)=O,,,3,1,18,21,39
73_1,,,,2,2,1,3
75_0,,,,2,2,1,3
C(C(C(C)O)C(C(O)=O)(C)O)=O,,,3,1,11,14,25
75_1,,,,2,2,1,3
77_0,,,,2,2,1,3
C(C(CC(C)O)(CC=O)O)(O)=O,,,3,1,9,12,21
79_0,,,,2,2,1,3
C(C(C(CO)C(C)O)=O)(O)=O,,,3,1,10,12,22
79_1,,,,2,2,1,3
81_0,,,,2,2,1,3
C(C(C(C(C)O)C(C)O)=O)(O)=O,,,3,1,5,7,12
81_1,,,,2,2,1,3
83_0,,,,2,2,1,3
C(C(C(C(O)=O)=O)C(C)O)(O)=O,,,3,1,7,10,17
83_1,,,,2,2,1,3
85_0,,,,2,2,1,3
C(C(C=O)C(CC(O)=O)O)(O)=O,,,3,1,8,11,19
85_1,,,,2,2,1,3
87_0,,,,2,2,1,3
C(CC(C(C(C=O)=O)O)O)(O)=O,,,3,1,11,16,27
87_1,,,,2,2,1,3
89_0,,,,2,2,1,3
C(CC(CC=O)O)(O)=O,,,3,1,19,31,50
91_0,,,,2,2,1,3
C(CC(CC(C(O)=O)=O)O)(O)=O,,,3,1,5,8,13
93_0,,,,2,2,1,3
C(C(C=O)C(C(CO)=O)O)(O)=O,,,3,1,12,15,27
93_1,,,,2,2,1,3
95_0,,,,2,2,1,3
C(C(C=O)C(C=O)(CO)O)(O)=O,,,3,1,10,16,26
95_1,,,,2,2,1,3
97_0,,,,2,2,1,3
C(C(C=O)CO)(O)=O,,,3,1,29,40,69
97_1,,,,2,2,1,3
98_0,,,,2,2,1,3
98_1,,,,2,2,1,3
100_0,,,,2,2,1,3
C(C(C(O)=O)C(O)=O)=O,,,3,1,14,14,28
100_1,,,,2,2,1,3
102_0,,,,2,2,1,3
C(C(C=O)C(C(O)=O)(C)O)(O)=O,,,3,1,9,12,21
102_1,,,,2,2,1,3
104_0,,,,2,2,1,3
C(C(C)(CC(CC=O)O)O)(O)=O,,,3,1,9,12,21
106_0,,,,2,2,1,3
C(C(CO)C(C(O)=O)(C)O)=O,,,3,1,12,14,26
106_1,,,,2,2,1,3
107_0,,,,2,2,1,3
107_1,,,,2,2,1,3
108_0,,,,2,2,1,3
108_1,,,,2,2,1,3
110_0,,,,2,2,1,3
C(CC(C(O)=O)(CC=O)O)(O)=O,,,3,1,7,10,17
112_0,,,,2,2,1,3
C(C(C(C(O)=O)=O)CO)(O)=O,,,3,1,9,10,19
112_1,,,,2,2,1,3
113_0,,,,2,2,1,3
113_1,,,,2,2,1,3
115_0,,,,2,2,1,3
C(C(C(O)=O)C(C(O)=O)=O)(O)=O,,,3,1,3,5,8
115_1,,,,2,2,1,3
117_0,,,,2,2,1,3
C(C(C(C(C(C)=O)=O)CO)=O)(O)=O,,,3,1,7,9,16
117_1,,,,2,2,1,3
119_0,,,,2,2,1,3
C(C(CC(C(CCO)=O)=O)=O)(O)=O,,,3,1,8,9,17
121_0,,,,2,2,1,3
C(CO)(C(C(C(C=O)=O)O)O)=O,,,3,1,17,21,38
121_1,,,,2,2,1,3
123_0,,,,2,2,1,3
C(CC(C(CO)=O)O)=O,,,3,1,34,49,83
125_0,,,,2,2,1,3
C(CO)(C(CC(C(O)=O)=O)O)=O,,,3,1,9,12,21
127_0,,,,2,2,1,3
C(C(CO)(C(C(C=O)=O)O)O)=O,,,3,1,13,21,34
127_1,,,,2,2,1,3
129_0,,,,2,2,1,3
C(C(CO)(CC=O)O)=O,,,3,1,18,31,49
131_0,,,,2,2,1,3
C(C(CO)(CC(C(O)=O)=O)O)=O,,,3,1,7,13,20
133_0,,,,2,2,1,3
C(C(C(CO)O)=O)=O,,,3,1,42,69,111
133_1,,,,2,2,1,3
135_0,,,,2,2,1,3
C(C(C(C(C)O)O)=O)=O,,,3,1,23,33,56
135_1,,,,2,2,1,3
137_0,,,,2,2,1,3
C(C(C(C=O)=O)O)(O)=O,,,3,1,22,29,51
137_1,,,,2,2,1,3
139_0,,,,2,2,1,3
C(C(C)(C(C(C=O)=O)O)O)(O)=O,,,3,1,11,15,26
139_1,,,,2,2,1,3
141_0,,,,2,2,1,3
C=C(C(O)=O)C(C(C(O)=O)=O)CO,,,3,1,3,7,10
143_0,,,,2,2,1,3
C(C1(C)C(C(C(O1)=O)=O)CO)(O)=O,,,3,1,6,6,12
143_1,,,,2,2,1,3
145_0,,,,2,2,1,3
C1(C(C)(C(C(C(O1)=O)=O)CO)O)=O,,,3,1,9,10,19
145_1,,,,2,2,1,3
147_0,,,,2,2,1,3
C(CCO)=O,,,3,1,130,424,554
149_0,,,,2,2,1,3
C(C(CCO)=O)(O)=O,,,3,1,24,51,75
150_0,,,,2,2,1,3
151_0,,,,2,2,1,3
151_1,,,,2,2,1,3
153_0,,,,2,1,2,3
C(CC(C(C)=O)=O)=O,,,3,1,45,91,136
155_0,,,,2,1,2,3
C(C(CO)=O)(C(C)O)=O,,,3,1,21,33,54
157_0,,,,2,1,2,3
C(C(C(CO)=O)=O)(O)=O,,,3,1,12,25,37
159_0,,,,2,1,2,3
C(C(C(C(C)=O)=O)(CO)O)(O)=O,,,3,1,10,11,21
161_0,,,,2,1,2,3
C(C(C(C(CO)=O)=O)(C)O)(O)=O,,,3,1,6,9,15
163_0,,,,2,1,2,3
C(C=O)=O,,,3,1,141,279,420
164_0,,,,2,1,2,3
166_0,,,,2,1,2,3
C(C(C(C(C(C)=O)=O)O)O)(O)=O,,,3,1,13,13,26
167_0,,,,2,1,2,3
168_0,,,,2,1,2,3
169_0,,,,2,1,2,3
170_0,,,,2,1,2,3
170_1,,,,2,1,2,3
171_0,,,,2,1,2,3
172_0,,,,2,1,2,3
172_1,,,,2,1,2,3
173_0,,,,2,1,2,3
175_0,,,,2,1,1,2
C(C(C)=O)(OC(C(C)=O)=O)=O,,,3,1,4,3,7
177_0,,,,2,1,1,2
C(C(C=O)O)=O,,,3,1,80,186,266
180_0,,,,2,3,2,5
C(O)=O,,,3,1,663,0,663
CC(CCO)O,,,3,1,8,35,43
182_0,,,,2,3,2,5
C(CCO)(O)=O,,,3,1,26,72,98
184_0,,,,2,3,2,5
C(C(C)(CCO)O)(O)=O,,,3,1,5,8,13
186_0,,,,2,3,2,5
C(CO)(CO)=O,,,3,1,78,184,262
188_0,,,,2,3,2,5
CO,,,3,1,491,106,597
188_1,,,,2,3,2,5
190_0,,,,2,3,2,5
CCO,,,3,1,24,99,123
192_0,,,,2,3,2,5
C(CC(C)O)(O)=O,,,3,1,21,43,64
194_0,,,,2,3,2,5
C(CC(O)=O)(O)=O,,,3,1,17,34,51
196_0,,,,2,3,2,5
C(C(C)(CC(O)=O)O)(O)=O,,,3,1,7,7,14
198_0,,,,2,3,2,5
C(C(CO)=O)(O)=O,,,3,1,64,101,165
200_0,,,,2,3,2,5
C(C)(O)=O,,,3,1,7,31,38
202_0,,,,2,2,1,3
C(C(CO)(C(CC(C)O)O)O)(O)=O,,,3,1,11,11,22
202_1,,,,2,2,1,3
204_0,,,,2,2,1,3
C(C(CO)(C(CC(O)=O)O)O)(O)=O,,,3,1,9,11,20
204_1,,,,2,2,1,3
206_0,,,,2,2,1,3
C(C(CO)(C(C(CO)=O)O)O)(O)=O,,,3,1,16,14,30
206_1,,,,2,2,1,3
208_0,,,,2,2,1,3
C(C(CO)(C(C=O)(CO)O)O)(O)=O,,,3,1,15,17,32
208_1,,,,2,2,1,3
210_0,,,,2,2,1,3
C(C(CO)(CO)O)(O)=O,,,3,1,5,5,10
210_1,,,,2,2,1,3
212_0,,,,2,2,1,3
C(C(C(CC(C)O)O)O)(O)=O,,,3,1,10,10,20
214_0,,,,2,2,1,3
C(CC(C(C(O)=O)O)O)(O)=O,,,3,1,10,10,20
216_0,,,,2,2,1,3
C(C(C(C(CO)=O)O)O)(O)=O,,,3,1,18,16,34
218_0,,,,2,2,1,3
C(C(CO)(C(C(O)=O)O)O)=O,,,3,1,12,16,28
219_0,,,,2,2,1,3
221_0,,,,2,2,1,3
C(C(C(C)O)O)(O)=O,,,3,1,25,42,67
223_0,,,,2,2,1,3
C(C(C(O)=O)O)(O)=O,,,3,1,21,33,54
225_0,,,,2,2,1,3
C(C(C)(C(C(O)=O)O)O)(O)=O,,,3,1,10,9,19
226_0,,,,2,1,2,3
226_1,,,,2,1,2,3
227_0,,,,2,1,2,3
227_1,,,,2,1,2,3
228_0,,,,2,1,2,3
228_1,,,,2,1,2,3
229_0,,,,2,1,2,3
229_1,,,,2,1,2,3
230_0,,,,2,1,2,3
230_1,,,,2,1,2,3
232_0,,,,2,1,2,3
C(C(C)O)(O)=O,,,3,1,32,73,105
234_0,,,,2,1,2,3
C(C(C=O)(C)O)(O)=O,,,3,1,12,20,32
236_0,,,,2,1,2,3
C(C(C=O)O)(O)=O,,,3,1,74,105,179
238_0,,,,2,1,2,3
C(C(C(C)=O)CO)(O)=O,,,3,1,20,25,45
239_0,,,,2,1,2,3
240_0,,,,2,1,2,3
241_0,,,,2,1,2,3
243_0,,,,2,1,2,3
C(C(C(CC(O)=O)=O)(C)O)(O)=O,,,3,1,5,8,13
245_0,,,,2,1,2,3
C(C(C(C(C(O)=O)O)=O)C)(O)=O,,,3,1,7,9,16
246_0,,,,2,1,2,3
247_0,,,,2,1,2,3
249_0,,,,2,1,2,3
C(C)=CC=O,,,3,1,131,389,520
251_0,,,,2,1,2,3
C(CC=C)=O,,,3,1,93,285,378
253_0,,,,2,1,2,3
C(C)=CC(C(O)=O)=O,,,3,1,23,43,66
255_0,,,,2,1,2,3
C=CCC(C(O)=O)=O,,,3,1,19,33,52
257_0,,,,2,1,2,3
C(CC(C(O)=O)=C)=O,,,3,1,32,60,92
259_0,,,,2,1,2,3
C(C=C(C(O)=O)C)=O,,,3,1,35,69,104
261_0,,,,2,1,2,3
C(C(C=C)(CO)O)(O)=O,,,3,1,6,7,13
263_0,,,,2,1,2,3
C(C(C(C(O)=O)=C)(CO)O)(O)=O,,,3,1,5,8,13
265_0,,,,2,1,2,3
C(C(C(C(C(O)=O)=C)O)O)(O)=O,,,3,1,7,8,15
267_0,,,,2,1,2,3
C1(C(C=C(C(O)=O)O1)(C)O)=O,,,3,1,2,2,4
269_0,,,,2,1,2,3
C(C1(C=C(C(O1)=O)C)O)(O)=O,,,3,1,3,4,7
271_0,,,,2,1,2,3
C(C1(CC(C(O1)=O)=C)O)(O)=O,,,3,1,4,6,10
273_0,,,,2,1,2,3
C1(C(C)=CC(C(O1)=O)=O)=O,,,3,1,13,12,25
275_0,,,,2,1,2,3
C=C1C(OC(C(C1)=O)=O)=O,,,3,1,16,14,30
277_0,,,,2,2,1,3
CC(C(CO)O)O,,,3,1,9,21,30
279_0,,,,2,2,1,3
C(C(C(C(C)O)O)O)(O)=O,,,3,1,12,14,26
280_0,,,,2,2,1,3
282_0,,,,2,2,1,3
C(C(C)(C(CO)O)O)(O)=O,,,3,1,7,7,14
284_0,,,,2,2,1,3
C(C(C(C(O)=O)O)O)(O)=O,,,3,1,9,10,19
285_0,,,,2,2,1,3
287_0,,,,2,2,1,3
C(C(CO)O)(CC(C(O)=O)=O)=O,,,3,1,10,13,23
289_0,,,,2,2,1,3
C(C)(C(C(C(C(O)=O)=O)O)O)=O,,,3,1,11,13,24
290_0,,,,2,2,1,3
292_0,,,,2,2,1,3
C(C1(C)C(C(C(O1)=O)O)O)(O)=O,,,3,1,7,5,12
294_0,,,,2,2,1,3
C1(C(C)(C(C(C(O1)=O)O)O)O)=O,,,3,1,8,8,16
295_0,,,,2,2,1,3
297_0,,,,2,2,1,3
C(C(C)C(C(C(O)=O)=O)O)(O)=O,,,3,1,3,5,8
298_0,,,,2,2,1,3
300_0,,,,2,2,1,3
C(C(CO)CC(C(O)=O)=O)(O)=O,,,3,1,5,8,13
302_0,,,,2,1,1,2
C1(C(C)(CC(O)O1)O)=O,,,3,1,3,7,10
304_0,,,,2,1,1,2
C(C)(C1(CC(C(O1)=O)=O)O)=O,,,3,1,7,9,16
305_0,,,,2,1,1,2
307_0,,,,2,1,1,2
C1(C2(C)CC(C(O2)=O)(O)O1)=O,,,3,1,2,1,3
309_0,,,,2,1,1,2
C1(C(C)(O)OC(C(C1)=O)=O)=O,,,3,1,5,6,11
310_0,,,,2,1,1,2
311_0,,,,2,1,2,3
312_0,,,,2,1,2,3
313_0,,,,2,1,2,3
314_0,,,,2,1,2,3
315_0,,,,2,1,2,3
317_0,,,,2,1,2,3
C1(C(OC(C)C1)=O)=O,,,3,1,24,50,74
319_0,,,,2,1,2,3
C1(CC(C(O1)=O)=O)=O,,,3,1,22,48,70
321_0,,,,2,1,2,3
C1(C(C)(C(C(O)=O)(CO1)O)O)=O,,,3,1,7,6,13
323_0,,,,2,1,2,3
C1(C(CO)(C(C(O1)=O)(C)O)O)=O,,,3,1,9,8,17
324_0,,,,2,1,2,3
326_0,,,,2,1,2,3
C1(C(C)(C(C(C(O)=O)O1)O)O)=O,,,3,1,7,5,12
327_0,,,,2,1,2,3
328_0,,,,2,1,1,2
329_0,,,,2,1,2,3
330_0,,,,2,1,2,3
332_0,,,,2,1,1,2
C1(C(C(C(C1O)O)C(C)O)O)=O,,,4,1,3,12,15
332_1,,,,2,1,1,2
334_0,,,,2,1,1,2
C(C1C(C(C(C1O)=O)O)O)(O)=O,,,4,1,5,14,19
334_1,,,,2,1,1,2
336_0,,,,2,1,1,2
C(C1(CC(C(C1CO)=O)=O)O)(O)=O,,,4,1,5,16,21
337_0,,,,2,1,1,2
337_1,,,,2,1,1,2
339_0,,,,2,1,1,2
C1(C(C(C(C(C1O)O)=O)O)O)=O,,,4,1,2,4,6
339_1,,,,2,1,1,2
341_0,,,,2,1,1,2
C(C1(C(C(C(C1O)=O)O)O)O)=O,,,4,1,7,20,27
341_1,,,,2,1,1,2
343_0,,,,2,1,1,2
C1(C(C(CC1O)O)O)=O,,,4,1,3,33,36
343_1,,,,2,1,1,2
345_0,,,,2,1,1,2
C(C1(CC(C(C1O)=O)O)O)(O)=O,,,4,1,3,13,16
345_1,,,,2,1,1,2
347_0,,,,2,1,1,2
C1(C(CC(C1)O)=O)=O,,,4,1,1,49,50
348_0,,,,2,1,1,2
350_0,,,,2,1,1,2
C(C1(C(C(C(C1)=O)O)O)O)(O)=O,,,4,1,3,15,18
352_0,,,,2,1,1,2
C1(C2(CC(C(C2)=O)(O)O1)O)=O,,,4,1,3,6,9
353_0,,,,2,2,1,3
353_1,,,,2,2,1,3
355_0,,,,2,2,1,3
C(CC(CC(CC(C)O)O)O)=O,,,4,1,1,11,12
357_0,,,,2,2,1,3
C(C(C(CC(C)O)O)C(C=O)O)=O,,,4,1,4,15,19
357_1,,,,2,2,1,3
358_0,,,,2,2,1,3
358_1,,,,2,2,1,3
359_0,,,,2,2,1,3
359_1,,,,2,2,1,3
361_0,,,,2,2,1,3
C(C(CO)C(CC(C)O)O)=O,,,4,1,6,14,20
361_1,,,,2,2,1,3
363_0,,,,2,2,1,3
C(C(CO)C(C(CO)C(C)O)O)=O,,,4,1,4,13,17
363_1,,,,2,2,1,3
365_0,,,,2,2,1,3
C(C(C=C)C(C(CO)C(C)O)O)=O,,,4,1,1,9,10
367_0,,,,2,2,1,3
C(CC(C(CO)C(C)O)O)=O,,,4,1,3,13,16
369_0,,,,2,2,1,3
C(CC(C(C(C)O)C(C)O)O)=O,,,4,1,1,9,10
371_0,,,,2,2,1,3
C(C(C(CC=O)O)C(C)O)(O)=O,,,4,1,2,12,14
373_0,,,,2,2,1,3
C(CC(CC(CC=O)O)O)(O)=O,,,4,1,1,11,12
375_0,,,,2,2,1,3
C(CC(C(C=O)C(C=O)O)O)(O)=O,,,4,1,4,15,19
375_1,,,,2,2,1,3
376_0,,,,2,2,1,3
376_1,,,,2,2,1,3
377_0,,,,2,2,1,3
377_1,,,,2,2,1,3
379_0,,,,2,2,1,3
C(C(CO)C(CC(O)=O)O)=O,,,4,1,5,14,19
379_1,,,,2,2,1,3
381_0,,,,2,2,1,3
C(C(CO)C(C(C=O)CO)O)(O)=O,,,4,1,5,14,19
381_1,,,,2,2,1,3
383_0,,,,2,2,1,3
C(C(C=C)C(C(C(O)=O)CO)O)=O,,,4,1,2,9,11
385_0,,,,2,2,1,3
C(C(CO)C(CC=O)O)(O)=O,,,4,1,4,14,18
387_0,,,,2,2,1,3
C(C(C(O)=O)C(CC=O)O)(O)=O,,,4,1,2,9,11
389_0,,,,2,2,1,3
C(CC(CC(C(CO)=O)O)O)=O,,,4,1,1,16,17
391_0,,,,2,2,1,3
C(CC(C(CO)(CC=O)O)O)=O,,,4,1,2,20,22
393_0,,,,2,2,1,3
C(C(C(C=O)C(C(CO)=O)O)O)=O,,,4,1,4,19,23
393_1,,,,2,2,1,3
394_0,,,,2,2,1,3
394_1,,,,2,2,1,3
395_0,,,,2,2,1,3
395_1,,,,2,2,1,3
397_0,,,,2,2,1,3
C(C(CO)C(C(CO)=O)O)=O,,,4,1,8,19,27
397_1,,,,2,2,1,3
399_0,,,,2,2,1,3
C(C(C(C(C(CC=O)O)=O)O)O)=O,,,4,1,3,23,26
399_1,,,,2,2,1,3
401_0,,,,2,2,1,3
C(CC(C(C(C(C)O)O)=O)O)=O,,,4,1,3,16,19
401_1,,,,2,2,1,3
403_0,,,,2,2,1,3
C(C(C(C(CC=O)O)=O)O)(O)=O,,,4,1,3,15,18
403_1,,,,2,2,1,3
405_0,,,,2,2,1,3
C(CC(C(C(CO)O)=O)O)=O,,,4,1,5,20,25
405_1,,,,2,2,1,3
407_0,,,,2,2,1,3
C(C(CO)(CC(CC=O)O)O)=O,,,4,1,1,17,18
408_0,,,,2,2,1,3
410_0,,,,2,2,1,3
C(C(C(C=O)C(C=O)(CO)O)O)=O,,,4,1,4,17,21
410_1,,,,2,2,1,3
411_0,,,,2,2,1,3
411_1,,,,2,2,1,3
412_0,,,,2,2,1,3
412_1,,,,2,2,1,3
414_0,,,,2,2,1,3
C(C(CO)C(C=O)(CO)O)=O,,,4,1,5,17,22
414_1,,,,2,2,1,3
416_0,,,,2,2,1,3
C(C(CO)C(C(C(CO)O)=O)O)=O,,,4,1,6,18,24
416_1,,,,2,2,1,3
418_0,,,,2,2,1,3
C(C(C=C)C(C(C(CO)O)=O)O)=O,,,4,1,3,13,16
419_0,,,,2,2,1,3
421_0,,,,2,2,1,3
C(C(CO)C(C=O)(C(CO)O)O)=O,,,4,1,5,17,22
421_1,,,,2,2,1,3
423_0,,,,2,2,1,3
C(C(C=C)C(C=O)(C(CO)O)O)=O,,,4,1,2,12,14
425_0,,,,2,2,1,3
C(C(C(CO)O)(CC=O)O)=O,,,4,1,4,17,21
426_0,,,,2,2,1,3
428_0,,,,2,2,1,3
C(C(C(C(C)O)O)(CC=O)O)=O,,,4,1,2,16,18
429_0,,,,2,2,1,3
431_0,,,,2,2,1,3
C(C(C(C=O)(CC=O)O)O)(O)=O,,,4,1,4,15,19
433_0,,,,2,2,1,3
C(C(CO)C(CCO)O)=O,,,4,1,8,16,24
433_1,,,,2,2,1,3
435_0,,,,2,2,1,3
C(C(C(CO)C(CCO)O)=O)(O)=O,,,4,1,4,13,17
435_1,,,,2,2,1,3
437_0,,,,2,2,1,3
C(C(C(C(C)=O)=O)C(CCO)O)=O,,,4,1,2,11,13
437_1,,,,2,2,1,3
439_0,,,,2,2,1,3
C(CC(C(CC(CCO)O)=O)=O)=O,,,4,1,1,11,12
441_0,,,,2,2,1,3
C(CO)(C(C(CCO)O)O)=O,,,4,1,3,13,16
441_1,,,,2,2,1,3
443_0,,,,2,2,1,3
C(C(C(C(CCO)O)O)=O)(O)=O,,,4,1,3,11,14
443_1,,,,2,2,1,3
445_0,,,,2,2,1,3
C(C(C=C)C(CCO)O)=O,,,4,1,3,14,17
447_0,,,,2,2,1,3
C=CC(C(C(O)=O)=O)C(CCO)O,,,4,1,1,8,9
449_0,,,,2,2,1,3
C(C(C(C(O)=O)=C)C(CCO)O)=O,,,4,1,1,11,12
451_0,,,,2,2,1,3
C1(C(C(C(C)O1)C(CCO)O)=O)=O,,,4,1,2,8,10
451_1,,,,2,2,1,3
453_0,,,,2,2,1,3
C1(C(C(C(O1)=O)=O)C(CCO)O)=O,,,4,1,2,9,11
453_1,,,,2,2,1,3
455_0,,,,2,2,1,3
C(CC(CCO)O)=O,,,4,1,8,60,68
457_0,,,,2,2,1,3
C(C(C(C)O)C(CCO)O)=O,,,4,1,7,14,21
457_1,,,,2,2,1,3
459_0,,,,2,2,1,3
C(C(C=O)C(CCO)O)(O)=O,,,4,1,7,13,20
459_1,,,,2,2,1,3
461_0,,,,2,2,1,3
C(C(C(C(CCO)O)O)=O)=O,,,4,1,5,17,22
461_1,,,,2,2,1,3
463_0,,,,2,2,1,3
C(C(CC(CCO)O)=O)(O)=O,,,4,1,3,11,14
465_0,,,,2,2,1,3
C(C(CO)C(C(O)=O)(CCO)O)=O,,,4,1,4,14,18
465_1,,,,2,2,1,3
467_0,,,,2,2,1,3
C(CC(C(C)=O)(C(C=O)CO)O)=O,,,4,1,5,14,19
467_1,,,,2,2,1,3
469_0,,,,2,2,1,3
C(C(CO)C(C(CC=O)=O)(C)O)=O,,,4,1,4,15,19
469_1,,,,2,2,1,3
471_0,,,,2,2,1,3
C(C(CO)C(CC(C(C)=O)=O)O)=O,,,4,1,4,14,18
471_1,,,,2,2,1,3
473_0,,,,2,2,1,3
C(C(CO)C(C=O)O)=O,,,4,1,13,34,47
473_1,,,,2,2,1,3
475_0,,,,2,2,1,3
C(C(CO)C(C(C=O)O)O)=O,,,4,1,5,21,26
475_1,,,,2,2,1,3
477_0,,,,2,2,1,3
C(C(CO)C(CO)(CO)O)=O,,,4,1,5,12,17
477_1,,,,2,2,1,3
479_0,,,,2,2,1,3
C(C(CO)C(C(O)=O)(CO)O)=O,,,4,1,7,15,22
479_1,,,,2,2,1,3
481_0,,,,2,2,1,3
C(C(CO)C(C(C(O)=O)(C)O)O)=O,,,4,1,4,14,18
481_1,,,,2,2,1,3
483_0,,,,2,2,1,3
C(C(CO)C(C(C(O)=O)O)O)=O,,,4,1,5,16,21
483_1,,,,2,2,1,3
485_0,,,,2,2,1,3
C(C(CO)C(C=CC)O)=O,,,4,1,10,15,25
485_1,,,,2,2,1,3
487_0,,,,2,2,1,3
C(C(CO)C(CC=C)O)=O,,,4,1,9,16,25
487_1,,,,2,2,1,3
489_0,,,,2,2,1,3
C(C(CO)C(C(O)=O)(C=CC)O)=O,,,4,1,4,11,15
489_1,,,,2,2,1,3
491_0,,,,2,2,1,3
C(C(CO)C(C(O)=O)(CC=C)O)=O,,,4,1,4,11,15
491_1,,,,2,2,1,3
493_0,,,,2,2,1,3
C(C(CO)C(CC(C(O)=O)=C)O)=O,,,4,1,4,13,17
493_1,,,,2,2,1,3
495_0,,,,2,2,1,3
C(C(CO)C(C=C(C(O)=O)C)O)=O,,,4,1,4,7,11
495_1,,,,2,2,1,3
497_0,,,,2,2,1,3
C(C(CO)C1(C(OC(C)C1)=O)O)=O,,,4,1,4,9,13
497_1,,,,2,2,1,3
499_0,,,,2,2,1,3
C1(CC(C(O1)=O)(C(C=O)CO)O)=O,,,4,1,4,10,14
499_1,,,,2,2,1,3
500_0,,,,2,2,1,3
500_1,,,,2,2,1,3
501_0,,,,2,2,1,3
501_1,,,,2,2,1,3
502_0,,,,2,2,1,3
502_1,,,,2,2,1,3
503_0,,,,2,2,1,3
503_1,,,,2,2,1,3
504_0,,,,2,2,1,3
504_1,,,,2,2,1,3
505_0,,,,2,2,1,3
505_1,,,,2,2,1,3
507_0,,,,2,2,1,3
C(C(CO)CO)=O,,,4,1,8,80,88
507_1,,,,2,2,1,3
508_0,,,,2,2,1,3
508_1,,,,2,2,1,3
510_0,,,,2,2,1,3
C(C(C=C)C(C(O)=O)(CCO)O)=O,,,4,1,1,9,10
512_0,,,,2,2,1,3
C(C(CCO)(CC=O)O)(O)=O,,,4,1,4,13,17
514_0,,,,2,2,1,3
C(C(C(C(C(O)=O)=O)CO)O)=O,,,4,1,4,15,19
514_1,,,,2,2,1,3
516_0,,,,2,2,1,3
C(C)=CC(C(C(C(O)=O)=O)CO)O,,,4,1,4,9,13
516_1,,,,2,2,1,3
518_0,,,,2,2,1,3
C=CCC(C(C(C(O)=O)=O)CO)O,,,4,1,4,10,14
518_1,,,,2,2,1,3
519_0,,,,2,2,1,3
519_1,,,,2,2,1,3
520_0,,,,2,2,1,3
520_1,,,,2,2,1,3
522_0,,,,2,2,1,3
C(C(C(CO)CO)=O)(O)=O,,,4,1,7,10,17
522_1,,,,2,2,1,3
524_0,,,,2,2,1,3
C(C(C=C)C(C(C)=O)(CC=O)O)=O,,,4,1,1,8,9
526_0,,,,2,2,1,3
C(CC(C(C)=O)(CC=O)O)=O,,,4,1,3,10,13
528_0,,,,2,2,1,3
C(CC(C(C)(C(C=O)C=C)O)=O)=O,,,4,1,1,9,10
530_0,,,,2,2,1,3
C(C(C)(CC=O)O)(CC=O)=O,,,4,1,3,19,22
532_0,,,,2,2,1,3
C(C(C=C)C(CC(C(C)=O)=O)O)=O,,,4,1,1,8,9
534_0,,,,2,2,1,3
C(CC(CC(C(C)=O)=O)O)=O,,,4,1,4,19,23
536_0,,,,2,2,1,3
C(C(C(C(C)=O)=O)C(C=O)O)=O,,,4,1,3,15,18
536_1,,,,2,2,1,3
538_0,,,,2,2,1,3
C(C(C(C(C)=O)=O)C(C=CC)O)=O,,,4,1,2,6,8
538_1,,,,2,2,1,3
540_0,,,,2,2,1,3
C(C(C(C(C)=O)=O)C(CC=C)O)=O,,,4,1,2,7,9
540_1,,,,2,2,1,3
542_0,,,,2,2,1,3
C(C(C(C(C)=O)=O)C(C)O)=O,,,4,1,4,14,18
542_1,,,,2,2,1,3
544_0,,,,2,2,1,3
C(C(C(O)=O)C(C(C)=O)=O)=O,,,4,1,5,12,17
544_1,,,,2,2,1,3
546_0,,,,2,2,1,3
C(C(C(C(C)=O)=O)CO)=O,,,4,1,5,20,25
546_1,,,,2,2,1,3
548_0,,,,2,2,1,3
C(CC(C(CC(C=O)O)=O)=O)=O,,,4,1,1,18,19
550_0,,,,2,2,1,3
C(CC(C(CC(C=CC)O)=O)=O)=O,,,4,1,1,7,8
552_0,,,,2,2,1,3
C(CC(C(CC(CC=C)O)=O)=O)=O,,,4,1,1,8,9
554_0,,,,2,2,1,3
C(CC(C(CC(C)O)=O)=O)=O,,,4,1,2,17,19
556_0,,,,2,2,1,3
C(CC(C(CC(O)=O)=O)=O)=O,,,4,1,2,16,18
558_0,,,,2,2,1,3
C(CC(C(CCO)=O)=O)=O,,,4,1,3,27,30
560_0,,,,2,2,1,3
C(C(CO)(CC=O)O)(C(C)O)=O,,,4,1,1,13,14
562_0,,,,2,2,1,3
C(CO)(C(C(C)O)(CC=O)O)=O,,,4,1,2,14,16
564_0,,,,2,2,1,3
C(C(C(C(C(C(C)O)=O)=O)O)O)=O,,,4,1,2,16,18
564_1,,,,2,2,1,3
566_0,,,,2,2,1,3
C(C(C(C)O)=O)(C(C(C)O)O)=O,,,4,1,3,12,15
566_1,,,,2,2,1,3
568_0,,,,2,2,1,3
C(C(C(C(C(C)O)=O)=O)O)(O)=O,,,4,1,5,11,16
568_1,,,,2,2,1,3
570_0,,,,2,2,1,3
C(C(C(C)O)=O)(C(CO)O)=O,,,4,1,2,14,16
570_1,,,,2,2,1,3
572_0,,,,2,2,1,3
C(CC(C(C(O)=O)=O)(CO)O)=O,,,4,1,1,12,13
574_0,,,,2,2,1,3
C(C(C(CO)=O)(CC=O)O)(O)=O,,,4,1,2,13,15
576_0,,,,2,2,1,3
C(C(C(C(C(C(O)=O)=O)=O)O)O)=O,,,4,1,2,16,18
576_1,,,,2,2,1,3
578_0,,,,2,2,1,3
C(C(C(C(C(C)O)O)=O)=O)(O)=O,,,4,1,5,13,18
578_1,,,,2,2,1,3
580_0,,,,2,2,1,3
C(C(C(C(C(O)=O)=O)=O)O)(O)=O,,,4,1,3,11,14
580_1,,,,2,2,1,3
582_0,,,,2,2,1,3
C(C(C(C(CO)O)=O)=O)(O)=O,,,4,1,2,14,16
582_1,,,,2,2,1,3
584_0,,,,2,2,1,3
C(C(C(C(CO)=O)O)O)=O,,,4,1,10,34,44
584_1,,,,2,2,1,3
586_0,,,,2,2,1,3
C(C(C(C(C(O)=O)=O)O)O)=O,,,4,1,8,17,25
586_1,,,,2,2,1,3
588_0,,,,2,2,1,3
C(CC(C=O)O)(C(C(O)=O)CO)=O,,,4,1,1,13,14
590_0,,,,2,2,1,3
C(C(C=C)C(C=O)O)=O,,,4,1,7,38,45
592_0,,,,2,2,1,3
C(C(C(C=C)C(C(O)=O)=O)O)=O,,,4,1,2,11,13
594_0,,,,2,2,1,3
C(C(C(C(O)=O)=C)C(C=O)O)=O,,,4,1,2,13,15
596_0,,,,2,2,1,3
C(C(C1C(C(OC(C1=C)=O)=O)=O)O)=O,,,4,1,1,5,6
598_0,,,,2,2,1,3
C(C(C1C(C(OC1C)=O)=O)O)=O,,,4,1,3,8,11
598_1,,,,2,2,1,3
600_0,,,,2,2,1,3
C1(C(C(C(O1)=O)=O)C(C=O)O)=O,,,4,1,3,8,11
600_1,,,,2,2,1,3
602_0,,,,2,2,1,3
C(CC(C=O)O)=O,,,4,1,26,177,203
604_0,,,,2,2,1,3
C(C(C(C)O)C(C=O)O)=O,,,4,1,13,22,35
604_1,,,,2,2,1,3
606_0,,,,2,2,1,3
C(C(C(C(C(O)=O)=O)C(C)O)O)=O,,,4,1,5,14,19
606_1,,,,2,2,1,3
608_0,,,,2,2,1,3
C(C(C=O)C(C=O)O)(O)=O,,,4,1,14,20,34
608_1,,,,2,2,1,3
610_0,,,,2,2,1,3
C(C(C)(C(C=O)C(C=O)O)O)(O)=O,,,4,1,6,15,21
610_1,,,,2,2,1,3
612_0,,,,2,2,1,3
C(C(C(C(O)=O)=O)C(C=O)O)(O)=O,,,4,1,4,12,16
612_1,,,,2,2,1,3
614_0,,,,2,2,1,3
C(C(C(C(C=O)=O)O)O)=O,,,4,1,20,31,51
614_1,,,,2,2,1,3
616_0,,,,2,2,1,3
C(C(CC(C(O)=O)=O)O)=O,,,4,1,11,20,31
618_0,,,,2,2,1,3
C(C(OC(C(C)=O)=O)=O)(CCO)=O,,,4,1,6,6,12
620_0,,,,2,2,1,3
C(C(C(C(C(CO)=O)O)O)O)=O,,,4,1,6,18,24
620_1,,,,2,2,1,3
622_0,,,,2,2,1,3
C(C(C(C(C(C(O)=O)=O)O)O)O)=O,,,4,1,6,17,23
622_1,,,,2,2,1,3
624_0,,,,2,2,1,3
C(C(C=C)C(C(C=O)O)O)=O,,,4,1,3,18,21
626_0,,,,2,2,1,3
C(CC(C(C=O)O)O)=O,,,4,1,9,46,55
628_0,,,,2,2,1,3
C(C(C(C(C=O)O)O)C(C)O)=O,,,4,1,6,19,25
628_1,,,,2,2,1,3
630_0,,,,2,2,1,3
C(C(C=O)C(C(C=O)O)O)(O)=O,,,4,1,6,18,24
630_1,,,,2,2,1,3
632_0,,,,2,2,1,3
C(C(C(C(C(C=O)=O)O)O)O)=O,,,4,1,6,23,29
632_1,,,,2,2,1,3
634_0,,,,2,2,1,3
C(C(C(CC(C(O)=O)=O)O)O)=O,,,4,1,3,15,18
636_0,,,,2,2,1,3
C(CO)(C(C(CO)(CO)O)O)=O,,,4,1,5,7,12
636_1,,,,2,2,1,3
638_0,,,,2,2,1,3
C(C(C(C(CO)(CO)O)O)=O)(O)=O,,,4,1,4,9,13
638_1,,,,2,2,1,3
640_0,,,,2,2,1,3
C(C(C=C)C(CO)(CO)O)=O,,,4,1,3,10,13
642_0,,,,2,2,1,3
C(CC(CO)(CO)O)=O,,,4,1,9,24,33
644_0,,,,2,2,1,3
C(C(C(C)O)C(CO)(CO)O)=O,,,4,1,6,12,18
644_1,,,,2,2,1,3
646_0,,,,2,2,1,3
C(C(C=O)C(CO)(CO)O)(O)=O,,,4,1,6,11,17
646_1,,,,2,2,1,3
648_0,,,,2,2,1,3
C(C(C(C(CO)(CO)O)O)=O)=O,,,4,1,3,13,16
648_1,,,,2,2,1,3
650_0,,,,2,2,1,3
C(C(CC(CO)(CO)O)=O)(O)=O,,,4,1,2,8,10
651_0,,,,2,2,1,3
651_1,,,,2,2,1,3
653_0,,,,2,2,1,3
C(C(C(C(C(CO)=O)O)O)O)(O)=O,,,4,1,9,14,23
653_1,,,,2,2,1,3
655_0,,,,2,2,1,3
C(CO)(C(C(C=CC)O)O)=O,,,4,1,4,12,16
655_1,,,,2,2,1,3
657_0,,,,2,2,1,3
C(CO)(C(C(CC=C)O)O)=O,,,4,1,4,13,17
657_1,,,,2,2,1,3
659_0,,,,2,2,1,3
C(CO)(C(C(C)O)O)=O,,,4,1,3,38,41
659_1,,,,2,2,1,3
661_0,,,,2,2,1,3
C(C(C(CO)=O)O)(O)=O,,,4,1,8,35,43
661_1,,,,2,2,1,3
663_0,,,,2,2,1,3
C(CO)(C(C(CC(C)O)O)O)=O,,,4,1,5,10,15
663_1,,,,2,2,1,3
665_0,,,,2,2,1,3
C(CC(C(C(CO)=O)O)O)(O)=O,,,4,1,3,10,13
665_1,,,,2,2,1,3
667_0,,,,2,2,1,3
C(CO)(C(C(C(CO)=O)O)O)=O,,,4,1,4,8,12
667_1,,,,2,2,1,3
669_0,,,,2,2,1,3
C(C(CO)(C(C(CO)=O)O)O)=O,,,4,1,8,18,26
669_1,,,,2,2,1,3
671_0,,,,2,2,1,3
C(CO)(C(CO)O)=O,,,4,1,13,83,96
671_1,,,,2,2,1,3
673_0,,,,2,2,1,3
C(C(C)(C(C(CO)=O)O)O)(O)=O,,,4,1,5,10,15
673_1,,,,2,2,1,3
675_0,,,,2,2,1,3
C(C(C=C)C(C(O)=O)(CO)O)=O,,,4,1,3,12,15
677_0,,,,2,2,1,3
C(C(CO)(CC=O)O)(O)=O,,,4,1,9,17,26
679_0,,,,2,2,1,3
C(C(C(C)O)C(C(O)=O)(CO)O)=O,,,4,1,6,14,20
679_1,,,,2,2,1,3
681_0,,,,2,2,1,3
C(C(C=O)C(C(O)=O)(CO)O)(O)=O,,,4,1,6,13,19
681_1,,,,2,2,1,3
683_0,,,,2,2,1,3
C(C(CO)(C(C(C=O)=O)O)O)(O)=O,,,4,1,5,17,22
683_1,,,,2,2,1,3
685_0,,,,2,2,1,3
C(C(CO)(CC(C(O)=O)=O)O)(O)=O,,,4,1,2,11,13
687_0,,,,2,2,1,3
C(C(C(C(C(O)=O)=O)O)O)=CC,,,4,1,4,9,13
687_1,,,,2,2,1,3
689_0,,,,2,2,1,3
C(CC(C(C(C(O)=O)=O)O)O)=C,,,4,1,4,10,14
689_1,,,,2,2,1,3
691_0,,,,2,2,1,3
C(C(C(C(C)O)O)=O)(O)=O,,,4,1,3,15,18
691_1,,,,2,2,1,3
693_0,,,,2,2,1,3
C(C(C(C(O)=O)=O)O)(O)=O,,,4,1,5,13,18
693_1,,,,2,2,1,3
695_0,,,,2,2,1,3
C(C(C(C(CC(C)O)O)O)=O)(O)=O,,,4,1,5,12,17
695_1,,,,2,2,1,3
697_0,,,,2,2,1,3
C(CC(C(C(C(O)=O)=O)O)O)(O)=O,,,4,1,3,11,14
697_1,,,,2,2,1,3
699_0,,,,2,2,1,3
C(CO)(C(C(C(C(O)=O)=O)O)O)=O,,,4,1,6,16,22
699_1,,,,2,2,1,3
701_0,,,,2,2,1,3
C(C(CO)(C(C(C(O)=O)=O)O)O)=O,,,4,1,7,17,24
701_1,,,,2,2,1,3
703_0,,,,2,2,1,3
C(C(C(CO)O)=O)(O)=O,,,4,1,5,24,29
703_1,,,,2,2,1,3
705_0,,,,2,2,1,3
C(C(C)(C(C(C(O)=O)=O)O)O)(O)=O,,,4,1,4,11,15
705_1,,,,2,2,1,3
707_0,,,,2,2,1,3
C(C(C(C(O)=O)O)O)(C(CO)O)=O,,,4,1,10,15,25
707_1,,,,2,2,1,3
709_0,,,,2,2,1,3
C(C(C=C)C(C(C(O)=O)(C)O)O)=O,,,4,1,1,9,10
711_0,,,,2,2,1,3
C(C(C)(C(CC=O)O)O)(O)=O,,,4,1,3,13,16
713_0,,,,2,2,1,3
C(C(C=C)C(C(C(O)=O)O)O)=O,,,4,1,3,13,16
715_0,,,,2,2,1,3
C(CC(C(C(O)=O)O)O)=O,,,4,1,9,24,33
717_0,,,,2,2,1,3
C(C(C(C(C(O)=O)O)O)C(C)O)=O,,,4,1,6,15,21
717_1,,,,2,2,1,3
719_0,,,,2,2,1,3
C(C(C=O)C(C(C(O)=O)O)O)(O)=O,,,4,1,5,14,19
719_1,,,,2,2,1,3
721_0,,,,2,2,1,3
C(C(C(C(C(C=O)=O)O)O)O)(O)=O,,,4,1,3,19,22
721_1,,,,2,2,1,3
723_0,,,,2,2,1,3
C(C(C(CC(C(O)=O)=O)O)O)(O)=O,,,4,1,2,12,14
725_0,,,,2,2,1,3
C(C(CO)C(C)(CC=O)O)(O)=O,,,4,1,1,12,13
727_0,,,,2,2,1,3
C(C(C(CC(C)O)=O)CO)(O)=O,,,4,1,4,11,15
729_0,,,,2,2,1,3
C(C(C(CC(O)=O)=O)CO)(O)=O,,,4,1,6,11,17
731_0,,,,2,2,1,3
C(C(C(CCO)=O)CO)(O)=O,,,4,1,2,13,15
733_0,,,,2,2,1,3
C(C(C=C)C(C=CC)O)=O,,,4,1,5,18,23
735_0,,,,2,2,1,3
C=CC(C(C(O)=O)=O)C(C=CC)O,,,4,1,1,4,5
737_0,,,,2,2,1,3
C(C(C(C(O)=O)=C)C(C=CC)O)=O,,,4,1,1,6,7
739_0,,,,2,2,1,3
C(C)=CC(C1C(C(OC1C)=O)=O)O,,,4,1,2,4,6
739_1,,,,2,2,1,3
741_0,,,,2,2,1,3
C1(C(C(C(O1)=O)=O)C(C=CC)O)=O,,,4,1,2,4,6
741_1,,,,2,2,1,3
743_0,,,,2,2,1,3
C(CC(C=CC)O)=O,,,4,1,10,56,66
745_0,,,,2,2,1,3
C(C(C(C)O)C(C=CC)O)=O,,,4,1,8,13,21
745_1,,,,2,2,1,3
747_0,,,,2,2,1,3
C(C(C=O)C(C=CC)O)(O)=O,,,4,1,8,11,19
747_1,,,,2,2,1,3
749_0,,,,2,2,1,3
C(C(C(C(C=O)=O)O)O)=CC,,,4,1,6,15,21
749_1,,,,2,2,1,3
751_0,,,,2,2,1,3
C(C(CC(C(O)=O)=O)O)=CC,,,4,1,4,9,13
753_0,,,,2,2,1,3
C(C(C=C)C(CC=C)O)=O,,,4,1,4,19,23
755_0,,,,2,2,1,3
C=CC(C(C(O)=O)=O)C(CC=C)O,,,4,1,1,5,6
757_0,,,,2,2,1,3
C(C(C(C(O)=O)=C)C(CC=C)O)=O,,,4,1,1,7,8
759_0,,,,2,2,1,3
C=CCC(C1C(C(OC1C)=O)=O)O,,,4,1,2,5,7
759_1,,,,2,2,1,3
761_0,,,,2,2,1,3
C1(C(C(C(O1)=O)=O)C(CC=C)O)=O,,,4,1,2,5,7
761_1,,,,2,2,1,3
763_0,,,,2,2,1,3
C(CC(CC=C)O)=O,,,4,1,9,57,66
765_0,,,,2,2,1,3
C(C(C(CC=C)O)C(C)O)=O,,,4,1,8,14,22
765_1,,,,2,2,1,3
767_0,,,,2,2,1,3
C(C(C=O)C(CC=C)O)(O)=O,,,4,1,8,12,20
767_1,,,,2,2,1,3
769_0,,,,2,2,1,3
C(CC(C(C(C=O)=O)O)O)=C,,,4,1,6,16,22
769_1,,,,2,2,1,3
771_0,,,,2,2,1,3
C=CCC(CC(C(O)=O)=O)O,,,4,1,4,10,14
773_0,,,,2,2,1,3
C(C(C=C)C(C(O)=O)(C=CC)O)=O,,,4,1,1,6,7
775_0,,,,2,2,1,3
C(C(C=C)C(C(O)=O)(CC=C)O)=O,,,4,1,1,6,7
777_0,,,,2,2,1,3
C(C(C=C)C(CC(C(O)=O)=C)O)=O,,,4,1,1,7,8
779_0,,,,2,2,1,3
C(C(C=C)C(C=C(C(O)=O)C)O)=O,,,4,1,1,3,4
781_0,,,,2,2,1,3
C(C(C=C)C1(C(OC(C)C1)=O)O)=O,,,4,1,1,4,5
783_0,,,,2,2,1,3
C(C(C=C)C1(C(OC(C1)=O)=O)O)=O,,,4,1,1,4,5
785_0,,,,2,2,1,3
C(C(C=C)C(C)O)=O,,,4,1,4,43,47
787_0,,,,2,2,1,3
C(C(C(O)=O)C=C)=O,,,4,1,5,37,42
789_0,,,,2,2,1,3
C(C(C=C)C(CC(C)O)O)=O,,,4,1,4,12,16
791_0,,,,2,2,1,3
C(C(C=C)C(CC(O)=O)O)=O,,,4,1,3,11,14
793_0,,,,2,2,1,3
C(C(C=C)C(C(CO)=O)O)=O,,,4,1,5,16,21
795_0,,,,2,2,1,3
C(C(C=C)C(C=O)(CO)O)=O,,,4,1,3,14,17
797_0,,,,2,2,1,3
C(C(C=C)CO)=O,,,4,1,3,81,84
799_0,,,,2,2,1,3
C(C(C=C)C(C(O)=O)(C)O)=O,,,4,1,2,11,13
801_0,,,,2,2,1,3
C(C(C=CC)(CC=O)O)(O)=O,,,4,1,4,12,16
803_0,,,,2,2,1,3
C(C(CC=O)(CC=C)O)(O)=O,,,4,1,4,12,16
805_0,,,,2,2,1,3
C=CC(C(C(O)=O)=O)C(C)O,,,4,1,2,9,11
807_0,,,,2,2,1,3
C(C(C=C)C(C(O)=O)=O)(O)=O,,,4,1,2,9,11
809_0,,,,2,2,1,3
C=CC(C(C(O)=O)=O)CO,,,4,1,2,11,13
811_0,,,,2,2,1,3
C(CC(CC(C(O)=O)=C)O)=O,,,4,1,4,14,18
813_0,,,,2,2,1,3
C(C(C(C(O)=O)=C)C(C)O)=O,,,4,1,2,13,15
815_0,,,,2,2,1,3
C(C(C(O)=O)C(C(O)=O)=C)=O,,,4,1,3,12,15
817_0,,,,2,2,1,3
C(C(C(C(O)=O)=C)CO)=O,,,4,1,3,17,20
819_0,,,,2,2,1,3
C(CC(C=C(C(O)=O)C)O)=O,,,4,1,4,10,14
821_0,,,,2,2,1,3
C1(C(C=C(C(O1)=O)C)(CC=O)O)=O,,,4,1,1,3,4
823_0,,,,2,2,1,3
C1(C(CC=O)(CC(C(O1)=O)=C)O)=O,,,4,1,1,6,7
825_0,,,,2,2,1,3
C=C1C(OC(C(C1C(C)O)=O)=O)=O,,,4,1,1,6,7
827_0,,,,2,2,1,3
C(C1C(C(OC(C1=C)=O)=O)=O)(O)=O,,,4,1,1,5,6
829_0,,,,2,2,1,3
C=C1C(OC(C(C1CO)=O)=O)=O,,,4,1,6,7,13
831_0,,,,2,2,1,3
C(C1(C(C(C(O1)=O)=O)CO)O)(C)=O,,,4,1,3,9,12
831_1,,,,2,2,1,3
833_0,,,,2,2,1,3
C(C1(CC(C(O1)=O)=O)O)(CCO)=O,,,4,1,2,8,10
835_0,,,,2,2,1,3
C1(C(C)(O)OC(C(C1CO)=O)=O)=O,,,4,1,3,5,8
835_1,,,,2,2,1,3
837_0,,,,2,2,1,3
C1(C(CC(C)O1)(CC=O)O)=O,,,4,1,4,8,12
839_0,,,,2,2,1,3
C1(C(C(C(C)O1)C(C)O)=O)=O,,,4,1,4,7,11
839_1,,,,2,2,1,3
841_0,,,,2,2,1,3
C(C1C(C(OC1C)=O)=O)(O)=O,,,4,1,4,5,9
841_1,,,,2,2,1,3
843_0,,,,2,2,1,3
C1(C(C(CO)C(C)O1)=O)=O,,,4,1,4,9,13
843_1,,,,2,2,1,3
845_0,,,,2,2,1,3
C1(CC(C(O1)=O)(CC=O)O)=O,,,4,1,4,9,13
847_0,,,,2,2,1,3
C1(C(C(C(O1)=O)=O)C(C)O)=O,,,4,1,4,7,11
847_1,,,,2,2,1,3
849_0,,,,2,2,1,3
C1(C(C(O)=O)C(C(O1)=O)=O)=O,,,4,1,4,5,9
849_1,,,,2,2,1,3
851_0,,,,2,2,1,3
C1(C(C(C(O1)=O)=O)CO)=O,,,4,1,4,9,13
851_1,,,,2,2,1,3
853_0,,,,2,2,1,3
C(C(C(C(CC(C)O)O)O)O)(O)=O,,,4,1,4,11,15
853_1,,,,2,2,1,3
855_0,,,,2,2,1,3
C(CC(C(C(C(O)=O)O)O)O)(O)=O,,,4,1,4,11,15
855_1,,,,2,2,1,3
856_0,,,,2,2,1,3
856_1,,,,2,2,1,3
858_0,,,,2,2,1,3
C(C(CO)(C(C(C(O)=O)O)O)O)=O,,,4,1,9,17,26
858_1,,,,2,2,1,3
860_0,,,,2,2,1,3
C(C(C(CO)O)O)(O)=O,,,4,1,5,22,27
860_1,,,,2,2,1,3
861_0,,,,2,2,1,3
861_1,,,,2,2,1,3
862_0,,,,2,2,1,3
862_1,,,,2,2,1,3
863_0,,,,2,2,1,3
863_1,,,,2,2,1,3
864_0,,,,2,2,1,3
865_0,,,,2,2,1,3
866_0,,,,2,2,1,3
867_0,,,,2,2,1,3
868_0,,,,2,2,1,3
869_0,,,,2,2,1,3
869_1,,,,2,2,1,3
870_0,,,,2,2,1,3
872_0,,,,2,1,2,3
C1(C(CC(C(C1)=O)=O)=O)=O,,,4,1,1,14,15
873_0,,,,2,1,2,3
874_0,,,,2,1,2,3
875_0,,,,2,1,2,3
876_0,,,,2,1,2,3
877_0,,,,2,1,2,3
878_0,,,,2,1,2,3
880_0,,,,2,1,2,3
C(C(C(C=O)=O)=O)=O,,,4,1,2,29,31
882_0,,,,2,1,2,3
C(C(C(C(C(C)=O)=O)O)=O)=O,,,4,1,3,15,18
884_0,,,,2,1,2,3
C(C(C(C(CO)=O)=O)=O)(C)=O,,,4,1,2,14,16
885_0,,,,2,1,2,3
886_0,,,,2,1,2,3
888_0,,,,2,1,2,3
C(C(C)=O)(CCO)=O,,,4,1,2,81,83
890_0,,,,2,1,2,3
C(CC(C(C)=O)=O)(O)=O,,,4,1,2,32,34
892_0,,,,2,1,2,3
C(C(CO)=O)(C(CC(C)O)O)=O,,,4,1,2,10,12
894_0,,,,2,1,2,3
C(CC(C(C(CO)=O)=O)O)(O)=O,,,4,1,2,9,11
896_0,,,,2,1,2,3
C(CO)(C(C(C(CO)=O)=O)O)=O,,,4,1,3,14,17
898_0,,,,2,1,2,3
C(C(C(C(CO)=O)=O)(CO)O)=O,,,4,1,2,14,16
900_0,,,,2,1,2,3
C(C(CO)=O)(CO)=O,,,4,1,4,46,50
902_0,,,,2,1,2,3
C(C(C(CC(C)O)O)=O)=O,,,4,1,2,16,18
904_0,,,,2,1,2,3
C(CC(C(C=O)=O)O)(O)=O,,,4,1,2,17,19
906_0,,,,2,1,2,3
C(CO)(C(C(C=O)=O)O)=O,,,4,1,5,27,32
908_0,,,,2,1,2,3
C(C(C(C=O)=O)(CO)O)=O,,,4,1,2,15,17
910_0,,,,2,1,2,3
C(C(C(C)O)=O)=O,,,4,1,7,118,125
912_0,,,,2,1,2,3
C(C(C(O)=O)=O)=O,,,4,1,25,80,105
914_0,,,,2,1,2,3
C(C(C(C(C)=O)=O)O)(O)=O,,,4,1,8,19,27
916_0,,,,2,1,2,3
C(C(C(C=O)=O)(C)O)(O)=O,,,4,1,3,11,14
918_0,,,,2,1,2,3
C(C(C)=O)=O,,,4,1,12,414,426
920_0,,,,2,1,2,3
C(C(C(C)=O)=O)=O,,,4,1,4,150,154
922_0,,,,2,1,2,3
C(C(C=O)=O)=O,,,4,1,24,142,166
924_0,,,,2,1,2,3
C(CC(C(C(C)=O)=O)=O)(O)=O,,,4,1,2,11,13
926_0,,,,2,1,2,3
C(C(C(C(C=O)=O)=O)C)(O)=O,,,4,1,3,11,14
928_0,,,,2,1,2,3
C=CC(C(CO)=O)=O,,,4,1,3,86,89
930_0,,,,2,1,2,3
C=C(C(O)=O)C(C(CO)=O)=O,,,4,1,3,12,15
932_0,,,,2,1,2,3
C=C(C(O)=O)C(C(C=O)=O)O,,,4,1,2,12,14
933_0,,,,2,1,2,3
934_0,,,,2,1,2,3
935_0,,,,2,1,2,3
937_0,,,,2,1,2,3
C(C(C)=O)(C(CO)O)=O,,,4,1,6,36,42
938_0,,,,2,1,2,3
940_0,,,,2,1,2,3
C1(C(C(C(CO1)=O)=O)(C)O)=O,,,4,1,2,5,7
941_0,,,,2,1,1,2
942_0,,,,2,1,2,3
942_1,,,,2,1,2,3
943_0,,,,2,1,2,3
943_1,,,,2,1,2,3
944_0,,,,2,1,2,3
944_1,,,,2,1,2,3
945_0,,,,2,1,2,3
945_1,,,,2,1,2,3
947_0,,,,2,1,2,3
C(C(CC(C)O)O)=O,,,4,1,2,45,47
948_0,,,,2,1,2,3
948_1,,,,2,1,2,3
949_0,,,,2,1,2,3
950_0,,,,2,1,2,3
951_0,,,,2,1,2,3
951_1,,,,2,1,2,3
952_0,,,,2,1,2,3
952_1,,,,2,1,2,3
953_0,,,,2,1,2,3
953_1,,,,2,1,2,3
954_0,,,,2,1,2,3
954_1,,,,2,1,2,3
955_0,,,,2,1,2,3
955_1,,,,2,1,2,3
956_0,,,,2,1,2,3
956_1,,,,2,1,2,3
957_0,,,,2,1,2,3
957_1,,,,2,1,2,3
958_0,,,,2,1,2,3
958_1,,,,2,1,2,3
959_0,,,,2,1,2,3
959_1,,,,2,1,2,3
960_0,,,,2,1,2,3
960_1,,,,2,1,2,3
961_0,,,,2,1,2,3
961_1,,,,2,1,2,3
962_0,,,,2,1,2,3
962_1,,,,2,1,2,3
963_0,,,,2,1,2,3
963_1,,,,2,1,2,3
964_0,,,,2,1,2,3
964_1,,,,2,1,2,3
965_0,,,,2,1,2,3
966_0,,,,2,1,2,3
966_1,,,,2,1,2,3
967_0,,,,2,1,2,3
967_1,,,,2,1,2,3
968_0,,,,2,1,2,3
968_1,,,,2,1,2,3
969_0,,,,2,1,2,3
969_1,,,,2,1,2,3
970_0,,,,2,1,2,3
970_1,,,,2,1,2,3
971_0,,,,2,1,2,3
971_1,,,,2,1,2,3
972_0,,,,2,1,2,3
972_1,,,,2,1,2,3
974_0,,,,2,1,2,3
C(CC(C=O)O)(O)=O,,,4,1,9,51,60
975_0,,,,2,1,2,3
975_1,,,,2,1,2,3
976_0,,,,2,1,2,3
977_0,,,,2,1,2,3
978_0,,,,2,1,2,3
978_1,,,,2,1,2,3
979_0,,,,2,1,2,3
979_1,,,,2,1,2,3
980_0,,,,2,1,2,3
980_1,,,,2,1,2,3
981_0,,,,2,1,2,3
981_1,,,,2,1,2,3
982_0,,,,2,1,2,3
982_1,,,,2,1,2,3
983_0,,,,2,1,2,3
983_1,,,,2,1,2,3
984_0,,,,2,1,2,3
984_1,,,,2,1,2,3
985_0,,,,2,1,2,3
985_1,,,,2,1,2,3
986_0,,,,2,1,2,3
986_1,,,,2,1,2,3
987_0,,,,2,1,2,3
987_1,,,,2,1,2,3
988_0,,,,2,1,2,3
989_0,,,,2,1,2,3
989_1,,,,2,1,2,3
990_0,,,,2,1,2,3
990_1,,,,2,1,2,3
991_0,,,,2,1,2,3
992_0,,,,2,1,2,3
992_1,,,,2,1,2,3
993_0,,,,2,1,2,3
993_1,,,,2,1,2,3
994_0,,,,2,1,2,3
994_1,,,,2,1,2,3
995_0,,,,2,1,2,3
995_1,,,,2,1,2,3
996_0,,,,2,1,2,3
998_0,,,,2,1,2,3
C(C(C(CO)=O)O)=O,,,4,1,7,92,99
999_0,,,,2,1,2,3
999_1,,,,2,1,2,3
1000_0,,,,2,1,2,3
1000_1,,,,2,1,2,3
1001_0,,,,2,1,2,3
1002_0,,,,2,1,2,3
1004_0,,,,2,1,2,3
C(C(C=O)(CO)O)=O,,,4,1,4,21,25
1005_0,,,,2,1,2,3
1005_1,,,,2,1,2,3
1007_0,,,,2,1,2,3
C(C(CO)O)=O,,,4,1,42,198,240
1007_1,,,,2,1,2,3
1007_2,,,,2,1,2,3
1008_0,,,,2,1,2,3
1008_1,,,,2,1,2,3
1008_2,,,,2,1,2,3
1009_0,,,,2,1,2,3
1010_0,,,,2,1,2,3
1010_1,,,,2,1,2,3
1011_0,,,,2,1,2,3
1012_0,,,,2,1,2,3
1012_1,,,,2,1,2,3
1014_0,,,,2,1,2,3
C(CO)=O,,,4,1,103,664,767
1015_0,,,,2,1,2,3
1015_1,,,,2,1,2,3
1017_0,,,,2,1,2,3
C(C(C)O)=O,,,4,1,15,307,322
1018_0,,,,2,1,2,3
1018_1,,,,2,1,2,3
1020_0,,,,2,1,2,3
C(C(O)=O)=O,,,4,1,45,136,181
1021_0,,,,2,1,2,3
1021_1,,,,2,1,2,3
1022_0,,,,2,1,2,3
1023_0,,,,2,1,2,3
1023_1,,,,2,1,2,3
1024_0,,,,2,1,2,3
1025_0,,,,2,1,2,3
1025_1,,,,2,1,2,3
1026_0,,,,2,1,1,2
1026_1,,,,2,1,1,2
1027_0,,,,2,1,2,3
1027_1,,,,2,1,2,3
1028_0,,,,2,1,2,3
1029_0,,,,2,1,2,3
1030_0,,,,2,1,2,3
1031_0,,,,2,1,2,3
1032_0,,,,2,1,2,3
1032_1,,,,2,1,2,3
1033_0,,,,2,1,2,3
1034_0,,,,2,1,2,3
1034_1,,,,2,1,2,3
1034_2,,,,2,1,2,3
1035_0,,,,2,1,2,3
1036_0,,,,2,1,2,3
1037_0,,,,2,1,2,3
1038_0,,,,2,1,2,3
1039_0,,,,2,1,2,3
1040_0,,,,2,1,2,3
1042_0,,,,2,1,2,3
C(C(CO)=O)(C)=O,,,4,1,11,173,184
1042_1,,,,2,1,2,3
1043_0,,,,2,1,2,3
1043_1,,,,2,1,2,3
1044_0,,,,2,1,2,3
1044_1,,,,2,1,2,3
1044_2,,,,2,1,2,3
1046_0,,,,2,1,2,3
C(C(CO)(C(C=O)O)O)(O)=O,,,4,1,11,16,27
1046_1,,,,2,1,2,3
1046_2,,,,2,1,2,3
1047_0,,,,2,1,2,3
1047_1,,,,2,1,2,3
1048_0,,,,2,1,2,3
1048_1,,,,2,1,2,3
1048_2,,,,2,1,2,3
1050_0,,,,2,1,2,3
C(C(C(C=O)O)O)(O)=O,,,4,1,15,39,54
1050_1,,,,2,1,2,3
1050_2,,,,2,1,2,3
1051_0,,,,2,1,2,3
1052_0,,,,2,1,2,3
1052_1,,,,2,1,2,3
1054_0,,,,2,1,2,3
C(CC(C)=O)(O)=O,,,4,1,6,136,142
1054_1,,,,2,1,2,3
1056_0,,,,2,1,2,3
C(C)(CCO)=O,,,4,1,3,258,261
1056_1,,,,2,1,2,3
1058_0,,,,2,1,2,3
C(C(C(C)=O)(C)O)(O)=O,,,4,1,5,15,20
1058_1,,,,2,1,2,3
1060_0,,,,2,1,2,3
C(CC(C(C)O)=O)(O)=O,,,4,1,3,30,33
1062_0,,,,2,1,2,3
C(C(C(CO)=O)C)(O)=O,,,4,1,5,29,34
1062_1,,,,2,1,2,3
1064_0,,,,2,1,2,3
C(C(C(CC)=O)O)(O)=O,,,4,1,8,29,37
1064_1,,,,2,1,2,3
1066_0,,,,2,1,2,3
C(CO)(CC(C(O)=O)=O)=O,,,4,1,4,21,25
1066_1,,,,2,1,2,3
1067_0,,,,2,1,2,3
1067_1,,,,2,1,2,3
1069_0,,,,2,1,2,3
C(C)(CO)=O,,,4,1,8,537,545
1069_1,,,,2,1,2,3
1070_0,,,,2,1,1,2
1072_0,,,,2,1,1,2
C(C(C(C(CC(C)O)O)=O)O)=O,,,4,1,2,11,13
1073_0,,,,2,1,1,2
1075_0,,,,2,1,1,2
C(C(C(C(CO)O)=O)C(C)O)=O,,,4,1,4,15,19
1077_0,,,,2,1,1,2
C(C(C(C(CC(O)=O)O)=O)O)=O,,,4,1,3,11,14
1078_0,,,,2,1,1,2
1080_0,,,,2,1,1,2
C(C(C=O)C(C(CO)O)=O)(O)=O,,,4,1,5,15,20
1082_0,,,,2,1,1,2
C(C(C(C(C(CO)=O)O)=O)O)=O,,,4,1,2,13,15
1083_0,,,,2,1,1,2
1085_0,,,,2,1,1,2
C(C(CO)O)(C(C(C=O)=O)O)=O,,,4,1,5,18,23
1086_0,,,,2,1,1,2
1088_0,,,,2,1,1,2
C(CC(C(CO)O)=O)=O,,,4,1,7,44,51
1089_0,,,,2,1,1,2
1090_0,,,,2,1,1,2
1092_0,,,,2,1,1,2
C(C(C(C(C=O)O)=O)(CO)O)=O,,,4,1,2,13,15
1093_0,,,,2,1,1,2
1095_0,,,,2,1,1,2
C(C(C(C(C)O)=O)O)=O,,,4,1,6,34,40
1097_0,,,,2,1,1,2
C(C(C(C(O)=O)=O)O)=O,,,4,1,5,25,30
1099_0,,,,2,1,1,2
C(C(C(C(C=O)O)=O)(C)O)(O)=O,,,4,1,3,10,13
1101_0,,,,2,1,1,2
C(CO)(C(C(C)=O)O)=O,,,4,1,6,44,50
1102_0,,,,2,1,1,2
1103_0,,,,2,1,1,2
1104_0,,,,2,1,1,2
1106_0,,,,2,1,1,2
C(C(C(C(C(C)=O)O)=O)O)(O)=O,,,4,1,5,10,15
1107_0,,,,2,1,1,2
1108_0,,,,2,1,1,2
1109_0,,,,2,1,1,2
1111_0,,,,2,1,1,2
C(C(CO)(C(C(C=O)O)O)O)(O)=O,,,4,1,9,17,26
1113_0,,,,2,1,1,2
C(C(C(C(CO)O)=O)(CO)O)(O)=O,,,4,1,5,13,18
1115_0,,,,2,1,1,2
C(C(C(C(C=O)O)O)O)(O)=O,,,4,1,12,18,30
1117_0,,,,2,1,1,2
C(C(C(C(CO)O)=O)O)(O)=O,,,4,1,9,15,24
1118_0,,,,2,1,1,2
1119_0,,,,2,1,1,2
1120_0,,,,2,1,1,2
1121_0,,,,2,1,1,2
1123_0,,,,2,1,1,2
C(C(C)O)(C(C(C(O)=O)=O)O)=O,,,4,1,3,8,11
1124_0,,,,2,1,1,2
1126_0,,,,2,3,2,5
CC(CC(C(CO)C(C)O)O)O,,,4,1,1,7,8
1128_0,,,,2,3,2,5
C(C(CO)C(CC(C)O)O)(O)=O,,,4,1,6,8,14
1129_0,,,,2,3,2,5
1131_0,,,,2,3,2,5
CC(CC(CCO)O)O,,,4,1,1,11,12
1133_0,,,,2,3,2,5
C(CC(C(CO)C(C)O)O)(O)=O,,,4,1,2,7,9
1135_0,,,,2,3,2,5
C(CO)(C(C(CO)C(C)O)O)=O,,,4,1,1,8,9
1136_0,,,,2,3,2,5
1138_0,,,,2,3,2,5
C(C(CO)(C(CO)C(C)O)O)=O,,,4,1,1,11,12
1140_0,,,,2,3,2,5
CC(C(CO)CO)O,,,4,1,1,15,16
1142_0,,,,2,3,2,5
CC(C(CO)C(C)O)O,,,4,1,1,7,8
1144_0,,,,2,3,2,5
C(C(CO)C(C)O)(O)=O,,,4,1,4,15,19
1146_0,,,,2,3,2,5
C(C(C)(C(CO)C(C)O)O)(O)=O,,,4,1,1,8,9
1148_0,,,,2,3,2,5
C(C(CCO)(CC(C)O)O)(O)=O,,,4,1,1,8,9
1150_0,,,,2,3,2,5
C(C(CO)C(CC(O)=O)O)(O)=O,,,4,1,5,7,12
1151_0,,,,2,3,2,5
1153_0,,,,2,3,2,5
C(CC(CCO)O)(O)=O,,,4,1,5,14,19
1155_0,,,,2,3,2,5
C(C(CO)C(C(CO)=O)O)(O)=O,,,4,1,5,9,14
1156_0,,,,2,3,2,5
1158_0,,,,2,3,2,5
C(C(CO)C(C=O)(CO)O)(O)=O,,,4,1,5,12,17
1160_0,,,,2,3,2,5
C(C(CO)CO)(O)=O,,,4,1,3,22,25
1162_0,,,,2,3,2,5
C(C(C(O)=O)CO)(O)=O,,,4,1,4,11,15
1164_0,,,,2,3,2,5
C(C(CO)C(C(O)=O)(C)O)(O)=O,,,4,1,4,8,12
1166_0,,,,2,3,2,5
C(C(C)(CC(CCO)O)O)(O)=O,,,4,1,1,8,9
1168_0,,,,2,3,2,5
C(C(C)(C(CO)CO)O)(O)=O,,,4,1,1,5,6
1170_0,,,,2,3,2,5
C(C(CCO)(CC(O)=O)O)(O)=O,,,4,1,2,7,9
1171_0,,,,2,3,2,5
1173_0,,,,2,3,2,5
C(CO)(C(CCO)O)=O,,,4,1,2,30,32
1174_0,,,,2,3,2,5
1175_0,,,,2,3,2,5
1177_0,,,,2,3,2,5
C(C(CO)(CCO)O)=O,,,4,1,1,14,15
1178_0,,,,2,3,2,5
1179_0,,,,2,3,2,5
1180_0,,,,2,3,2,5
1181_0,,,,2,3,2,5
1182_0,,,,2,3,2,5
1183_0,,,,2,3,2,5
1185_0,,,,2,3,2,5
C(CCO)O,,,4,1,1,55,56
1186_0,,,,2,3,2,5
1187_0,,,,2,3,2,5
1188_0,,,,2,3,2,5
1190_0,,,,2,3,2,5
C(C(CO)(C(CO)(CO)O)O)(O)=O,,,4,1,8,8,16
1192_0,,,,2,3,2,5
C(C(C(CO)(CO)O)O)(O)=O,,,4,1,7,7,14
1194_0,,,,2,3,2,5
C(C(CO)(C)O)(O)=O,,,4,1,3,10,13
1195_0,,,,2,3,2,5
1197_0,,,,2,3,2,5
C(C)=CCO,,,4,1,2,56,58
1199_0,,,,2,3,2,5
C=CCCO,,,4,1,2,57,59
1201_0,,,,2,3,2,5
C=C(C(O)=O)CCO,,,4,1,2,35,37
1203_0,,,,2,3,2,5
C(CO)=C(C(O)=O)C,,,4,1,2,33,35
1205_0,,,,2,3,2,5
C(C(C(C)O)C(CC(C)O)O)(O)=O,,,4,1,5,9,14
1207_0,,,,2,3,2,5
C(C(C(O)=O)C(CC(C)O)O)(O)=O,,,4,1,5,7,12
1208_0,,,,2,3,2,5
1210_0,,,,2,3,2,5
C(CC(CC(C)O)O)(O)=O,,,4,1,4,8,12
1212_0,,,,2,3,2,5
C(C(C(CC(O)=O)O)C(C)O)(O)=O,,,4,1,4,8,12
1214_0,,,,2,3,2,5
C(C(C(C)O)C(C(CO)=O)O)(O)=O,,,4,1,4,10,14
1215_0,,,,2,3,2,5
1217_0,,,,2,3,2,5
C(C(C(C)O)C(C=O)(CO)O)(O)=O,,,4,1,4,12,16
1218_0,,,,2,3,2,5
1220_0,,,,2,3,2,5
C(C(C(C)O)C(C)O)(O)=O,,,4,1,2,6,8
1222_0,,,,2,3,2,5
C(C(C(O)=O)C(C)O)(O)=O,,,4,1,3,7,10
1224_0,,,,2,3,2,5
C(C(C(C)O)C(C(O)=O)(C)O)(O)=O,,,4,1,3,9,12
1226_0,,,,2,3,2,5
C(C(CC(C)O)(CC(O)=O)O)(O)=O,,,4,1,1,8,9
1228_0,,,,2,3,2,5
C(C(C(O)=O)C(CC(O)=O)O)(O)=O,,,4,1,4,5,9
1229_0,,,,2,3,2,5
1231_0,,,,2,3,2,5
C(CC(CC(O)=O)O)(O)=O,,,4,1,4,5,9
1233_0,,,,2,3,2,5
C(C(C(O)=O)C(C(CO)=O)O)(O)=O,,,4,1,4,7,11
1234_0,,,,2,3,2,5
1236_0,,,,2,3,2,5
C(C(C(O)=O)C(C=O)(CO)O)(O)=O,,,4,1,4,9,13
1237_0,,,,2,3,2,5
1239_0,,,,2,3,2,5
C(C(C(O)=O)C(O)=O)(O)=O,,,4,1,2,4,6
1241_0,,,,2,3,2,5
C(C(C(O)=O)C(C(O)=O)(C)O)(O)=O,,,4,1,3,6,9
1243_0,,,,2,3,2,5
C(C(C)(CC(CC(O)=O)O)O)(O)=O,,,4,1,1,8,9
1244_0,,,,2,3,2,5
1246_0,,,,2,3,2,5
C(CC(C(O)=O)(CC(O)=O)O)(O)=O,,,4,1,1,4,5
1247_0,,,,2,3,2,5
1249_0,,,,2,3,2,5
C(CC(C(CO)=O)O)(O)=O,,,4,1,5,18,23
1250_0,,,,2,3,2,5
1251_0,,,,2,3,2,5
1253_0,,,,2,3,2,5
C(C(CO)(CC(O)=O)O)=O,,,4,1,5,12,17
1254_0,,,,2,3,2,5
1255_0,,,,2,3,2,5
1256_0,,,,2,3,2,5
1257_0,,,,2,3,2,5
1258_0,,,,2,3,2,5
1259_0,,,,2,3,2,5
1260_0,,,,2,3,2,5
1261_0,,,,2,3,2,5
1262_0,,,,2,3,2,5
1263_0,,,,2,3,2,5
1265_0,,,,2,3,2,5
C(C(CO)(C(C(O)=O)O)O)(O)=O,,,4,1,10,11,21
1267_0,,,,2,3,2,5
C(C(C(O)=O)(C)O)(O)=O,,,4,1,2,3,5
1268_0,,,,2,3,2,5
1270_0,,,,2,3,2,5
C(C)=CC(O)=O,,,4,1,4,114,118
1272_0,,,,2,3,2,5
C(CC=C)(O)=O,,,4,1,2,11,13
1274_0,,,,2,3,2,5
C(CC(C(O)=O)=C)(O)=O,,,4,1,2,12,14
1276_0,,,,2,3,2,5
C(C(C)=CC(O)=O)(O)=O,,,4,1,3,18,21
1277_0,,,,2,1,1,2
1279_0,,,,2,2,1,3
C(C(CO)(C(C)O)C(CCO)O)=O,,,4,1,3,11,14
1281_0,,,,2,2,1,3
C(C(CO)(C(C)O)C(C=O)O)=O,,,4,1,3,14,17
1283_0,,,,2,2,1,3
C(C(CO)(C(C)O)C(C=CC)O)=O,,,4,1,3,8,11
1285_0,,,,2,2,1,3
C(C(CO)(C(CC=C)O)C(C)O)=O,,,4,1,3,9,12
1287_0,,,,2,2,1,3
C(C(CO)(C(C)O)C(C)O)=O,,,4,1,2,7,9
1289_0,,,,2,2,1,3
C(C(C=O)(CO)C(C)O)(O)=O,,,4,1,3,8,11
1291_0,,,,2,2,1,3
C(C(CO)(CO)C(C)O)=O,,,4,1,3,8,11
1293_0,,,,2,2,1,3
C(C(C(C)O)(C(C)O)C(C=O)O)=O,,,4,1,2,9,11
1295_0,,,,2,2,1,3
C(C(C(C)O)(C(C)O)C(C)O)=O,,,4,1,1,5,6
1297_0,,,,2,2,1,3
C(C(C=O)(C(C)O)C(C)O)(O)=O,,,4,1,2,6,8
1298_0,,,,2,2,1,3
1300_0,,,,2,2,1,3
C(C(C=O)(C(C)O)C(C=O)O)(O)=O,,,4,1,3,11,14
1301_0,,,,2,2,1,3
1303_0,,,,2,2,1,3
C(C(C(O)=O)(C=O)C(C)O)(O)=O,,,4,1,2,6,8
1304_0,,,,2,2,1,3
1306_0,,,,2,2,1,3
C(C(C(CO)(CO)C(C)O)=O)(O)=O,,,4,1,2,8,10
1308_0,,,,2,2,1,3
C(C(C(CC=O)O)C(C=O)O)(O)=O,,,4,1,2,16,18
1309_0,,,,2,2,1,3
1310_0,,,,2,2,1,3
1311_0,,,,2,2,1,3
1313_0,,,,2,2,1,3
C(C(C=O)(CO)C(CCO)O)(O)=O,,,4,1,3,10,13
1315_0,,,,2,2,1,3
C(C(C=O)(CO)C(C=O)O)(O)=O,,,4,1,3,12,15
1317_0,,,,2,2,1,3
C(C(C=O)(CO)C(C=CC)O)(O)=O,,,4,1,3,6,9
1319_0,,,,2,2,1,3
C(C(C=O)(CO)C(CC=C)O)(O)=O,,,4,1,3,7,10
1320_0,,,,2,2,1,3
1322_0,,,,2,2,1,3
C(C(C(O)=O)(C=O)CO)(O)=O,,,4,1,2,5,7
1324_0,,,,2,2,1,3
C(C(C=O)(CO)CO)(O)=O,,,4,1,3,6,9
1326_0,,,,2,2,1,3
C(C(C(O)=O)(C=O)C(C=O)O)(O)=O,,,4,1,2,7,9
1327_0,,,,2,2,1,3
1329_0,,,,2,2,1,3
C(C(C(O)=O)(C(O)=O)C(O)=O)=O,,,4,1,1,3,4
1330_0,,,,2,2,1,3
1332_0,,,,2,2,1,3
C(C(CO)(CO)C(C(O)=O)(C)O)=O,,,4,1,2,9,11
1334_0,,,,2,2,1,3
C(C(C(C(O)=O)=O)(CO)CO)(O)=O,,,4,1,2,6,8
1336_0,,,,2,2,1,3
C(C(C(CO)(C(CCO)O)O)=O)=O,,,4,1,4,16,20
1336_1,,,,2,2,1,3
1338_0,,,,2,2,1,3
C(C(C(C(C=O)=O)(CO)O)O)=O,,,4,1,4,21,25
1338_1,,,,2,2,1,3
1340_0,,,,2,2,1,3
C(C)=CC(C(C(C=O)=O)(CO)O)O,,,4,1,4,12,16
1340_1,,,,2,2,1,3
1342_0,,,,2,2,1,3
C=CCC(C(C(C=O)=O)(CO)O)O,,,4,1,4,13,17
1342_1,,,,2,2,1,3
1344_0,,,,2,2,1,3
C(C(C(CO)(C(C)O)O)=O)=O,,,4,1,5,16,21
1344_1,,,,2,2,1,3
1346_0,,,,2,2,1,3
C(C(C(C=O)=O)(CO)O)(O)=O,,,4,1,6,13,19
1346_1,,,,2,2,1,3
1348_0,,,,2,2,1,3
C(C(C(CO)(CO)O)=O)=O,,,4,1,4,12,16
1348_1,,,,2,2,1,3
1350_0,,,,2,2,1,3
C(C(C(C(C=O)=O)(C(C)O)O)O)=O,,,4,1,4,18,22
1350_1,,,,2,2,1,3
1352_0,,,,2,2,1,3
C(C(C(C(C)O)(C(C)O)O)=O)=O,,,4,1,3,11,14
1352_1,,,,2,2,1,3
1354_0,,,,2,2,1,3
C(C(C(C=O)=O)(C(C)O)O)(O)=O,,,4,1,5,14,19
1354_1,,,,2,2,1,3
1355_0,,,,2,2,1,3
1355_1,,,,2,2,1,3
1357_0,,,,2,2,1,3
C(C(C(C=O)=O)(C(C=O)O)O)(O)=O,,,4,1,4,15,19
1357_1,,,,2,2,1,3
1358_0,,,,2,2,1,3
1358_1,,,,2,2,1,3
1360_0,,,,2,2,1,3
C(C(C(O)=O)(C(C=O)=O)O)(O)=O,,,4,1,3,8,11
1360_1,,,,2,2,1,3
1361_0,,,,2,2,1,3
1361_1,,,,2,2,1,3
1363_0,,,,2,2,1,3
C(C(C=O)(C(CCO)O)O)=O,,,4,1,2,9,11
1363_1,,,,2,2,1,3
1365_0,,,,2,2,1,3
C(C(CO)C(CCO)O)(O)=O,,,4,1,5,8,13
1367_0,,,,2,2,1,3
C(C(C(C)O)C(CCO)O)(O)=O,,,4,1,4,8,12
1369_0,,,,2,2,1,3
C(C(C(O)=O)C(CCO)O)(O)=O,,,4,1,4,6,10
1371_0,,,,2,2,1,3
C(C(C(C)O)(C(CCO)O)O)(O)=O,,,4,1,4,11,15
1371_1,,,,2,2,1,3
1373_0,,,,2,2,1,3
C(C(C(O)=O)(C(CCO)O)O)(O)=O,,,4,1,5,7,12
1373_1,,,,2,2,1,3
1375_0,,,,2,2,1,3
C(C(C=O)(C(CCO)O)O)(O)=O,,,4,1,3,12,15
1375_1,,,,2,2,1,3
1377_0,,,,2,2,1,3
C(C(CO)(C(CCO)O)O)(O)=O,,,4,1,7,10,17
1377_1,,,,2,2,1,3
1379_0,,,,2,2,1,3
C(C(C=O)(C(C=O)O)O)=O,,,4,1,7,19,26
1379_1,,,,2,2,1,3
1381_0,,,,2,2,1,3
C(C(CO)C(C=O)O)(O)=O,,,4,1,6,16,22
1383_0,,,,2,2,1,3
C(C(C(C)O)C(C=O)O)(O)=O,,,4,1,5,12,17
1385_0,,,,2,2,1,3
C(C(C(O)=O)C(C=O)O)(O)=O,,,4,1,5,9,14
1387_0,,,,2,2,1,3
C(C(C(C)O)(C(C=O)O)O)(O)=O,,,4,1,4,15,19
1387_1,,,,2,2,1,3
1389_0,,,,2,2,1,3
C(C(C(O)=O)(C(C=O)O)O)(O)=O,,,4,1,5,10,15
1389_1,,,,2,2,1,3
1391_0,,,,2,2,1,3
C(C(C=O)(C(C=O)O)O)(O)=O,,,4,1,8,16,24
1391_1,,,,2,2,1,3
1393_0,,,,2,2,1,3
C(C)(C(C(O)=O)(CO)C(C=O)O)=O,,,4,1,1,10,11
1394_0,,,,2,2,1,3
1394_1,,,,2,2,1,3
1396_0,,,,2,2,1,3
C(C(C=O)(C(C(C=O)O)O)O)=O,,,4,1,3,15,18
1396_1,,,,2,2,1,3
1398_0,,,,2,2,1,3
C(C(C=O)(C(CO)(CO)O)O)=O,,,4,1,3,7,10
1398_1,,,,2,2,1,3
1400_0,,,,2,2,1,3
C(C(C=O)(C(C(O)=O)(CO)O)O)=O,,,4,1,5,12,17
1400_1,,,,2,2,1,3
1402_0,,,,2,2,1,3
C(C(C=O)(C(C(C(O)=O)O)O)O)=O,,,4,1,3,12,15
1402_1,,,,2,2,1,3
1404_0,,,,2,2,1,3
C(C(C=O)(C(C=CC)O)O)=O,,,4,1,3,8,11
1404_1,,,,2,2,1,3
1406_0,,,,2,2,1,3
C(C(C=O)(C(CC=C)O)O)=O,,,4,1,3,9,12
1406_1,,,,2,2,1,3
1408_0,,,,2,2,1,3
C(C(C=O)(C(C)O)O)=O,,,4,1,2,12,14
1408_1,,,,2,2,1,3
1410_0,,,,2,2,1,3
C(C(C=O)(C=O)O)(O)=O,,,4,1,5,7,12
1410_1,,,,2,2,1,3
1412_0,,,,2,2,1,3
C(C(C=O)(C(CC(C)O)O)O)=O,,,4,1,4,10,14
1412_1,,,,2,2,1,3
1414_0,,,,2,2,1,3
C(C(C=O)(C(CC(O)=O)O)O)=O,,,4,1,2,9,11
1414_1,,,,2,2,1,3
1416_0,,,,2,2,1,3
C(C(C=O)(C(C(CO)=O)O)O)=O,,,4,1,7,13,20
1416_1,,,,2,2,1,3
1418_0,,,,2,2,1,3
C(C(C=O)(C(C=O)(CO)O)O)=O,,,4,1,6,15,21
1418_1,,,,2,2,1,3
1419_0,,,,2,2,1,3
1419_1,,,,2,2,1,3
1421_0,,,,2,2,1,3
C(C(C=O)(C(C(O)=O)(C)O)O)=O,,,4,1,3,9,12
1421_1,,,,2,2,1,3
1423_0,,,,2,2,1,3
C(C(CO)C(C(C=O)O)O)(O)=O,,,4,1,6,14,20
1425_0,,,,2,2,1,3
C(C(C(C(C=O)O)O)C(C)O)(O)=O,,,4,1,5,14,19
1427_0,,,,2,2,1,3
C(C(C(O)=O)C(C(C=O)O)O)(O)=O,,,4,1,5,11,16
1429_0,,,,2,2,1,3
C(C(C=O)(C(C(C=O)O)O)O)(O)=O,,,4,1,6,17,23
1429_1,,,,2,2,1,3
1430_0,,,,2,2,1,3
1430_1,,,,2,2,1,3
1432_0,,,,2,2,1,3
C(C(CO)C(CO)(CO)O)(O)=O,,,4,1,4,6,10
1434_0,,,,2,2,1,3
C(C(CO)C(C(O)=O)(CO)O)(O)=O,,,4,1,6,10,16
1436_0,,,,2,2,1,3
C(C(CO)C(C(C(O)=O)O)O)(O)=O,,,4,1,9,11,20
1438_0,,,,2,2,1,3
C(C(CO)C(C=CC)O)(O)=O,,,4,1,4,7,11
1440_0,,,,2,2,1,3
C(C(CO)C(CC=C)O)(O)=O,,,4,1,4,8,12
1441_0,,,,2,2,1,3
1442_0,,,,2,2,1,3
1443_0,,,,2,2,1,3
1444_0,,,,2,2,1,3
1445_0,,,,2,2,1,3
1446_0,,,,2,2,1,3
1447_0,,,,2,2,1,3
1448_0,,,,2,2,1,3
1450_0,,,,2,2,1,3
C(C(C(C)O)C(CO)(CO)O)(O)=O,,,4,1,3,7,10
1452_0,,,,2,2,1,3
C(C(C(O)=O)C(CO)(CO)O)(O)=O,,,4,1,3,5,8
1454_0,,,,2,2,1,3
C(C(C=O)(C(CO)(CO)O)O)(O)=O,,,4,1,4,9,13
1454_1,,,,2,2,1,3
1455_0,,,,2,2,1,3
1455_1,,,,2,2,1,3
1457_0,,,,2,2,1,3
C(C(C(C)O)C(C=CC)O)(O)=O,,,4,1,3,7,10
1459_0,,,,2,2,1,3
C(C(C(CC=C)O)C(C)O)(O)=O,,,4,1,3,8,11
1460_0,,,,2,2,1,3
1461_0,,,,2,2,1,3
1462_0,,,,2,2,1,3
1463_0,,,,2,2,1,3
1464_0,,,,2,2,1,3
1465_0,,,,2,2,1,3
1466_0,,,,2,2,1,3
1467_0,,,,2,2,1,3
1469_0,,,,2,2,1,3
C(C(C(O)=O)C(C=CC)O)(O)=O,,,4,1,3,5,8
1471_0,,,,2,2,1,3
C(C(C(O)=O)C(CC=C)O)(O)=O,,,4,1,3,6,9
1472_0,,,,2,2,1,3
1473_0,,,,2,2,1,3
1474_0,,,,2,2,1,3
1475_0,,,,2,2,1,3
1476_0,,,,2,2,1,3
1477_0,,,,2,2,1,3
1478_0,,,,2,2,1,3
1479_0,,,,2,2,1,3
1480_0,,,,2,2,1,3
1481_0,,,,2,2,1,3
1482_0,,,,2,2,1,3
1483_0,,,,2,2,1,3
1483_1,,,,2,2,1,3
1484_0,,,,2,2,1,3
1484_1,,,,2,2,1,3
1485_0,,,,2,2,1,3
1486_0,,,,2,2,1,3
1486_1,,,,2,2,1,3
1488_0,,,,2,2,1,3
C(CO)(C(CO)(C(C(O)=O)O)O)=O,,,4,1,5,14,19
1488_1,,,,2,2,1,3
1489_0,,,,2,2,1,3
1489_1,,,,2,2,1,3
1491_0,,,,2,2,1,3
C(C(C(C)O)(C(C=CC)O)O)(O)=O,,,4,1,4,8,12
1491_1,,,,2,2,1,3
1493_0,,,,2,2,1,3
C(C(C(CC=C)O)(C(C)O)O)(O)=O,,,4,1,4,9,13
1493_1,,,,2,2,1,3
1495_0,,,,2,2,1,3
C(C(C(C)O)(C(C)O)O)(O)=O,,,4,1,2,5,7
1495_1,,,,2,2,1,3
1497_0,,,,2,2,1,3
C(C(C(O)=O)(C(C)O)O)(O)=O,,,4,1,5,5,10
1497_1,,,,2,2,1,3
1498_0,,,,2,2,1,3
1498_1,,,,2,2,1,3
1500_0,,,,2,2,1,3
C(C(C(O)=O)(C(C=CC)O)O)(O)=O,,,4,1,5,4,9
1500_1,,,,2,2,1,3
1502_0,,,,2,2,1,3
C(C(C(O)=O)(C(CC=C)O)O)(O)=O,,,4,1,5,5,10
1502_1,,,,2,2,1,3
1503_0,,,,2,2,1,3
1503_1,,,,2,2,1,3
1505_0,,,,2,2,1,3
C(C(C(O)=O)(C(O)=O)O)(O)=O,,,4,1,3,1,4
1505_1,,,,2,2,1,3
1506_0,,,,2,2,1,3
1506_1,,,,2,2,1,3
1507_0,,,,2,2,1,3
1507_1,,,,2,2,1,3
1509_0,,,,2,2,1,3
C(C(C=O)(C(C=CC)O)O)(O)=O,,,4,1,4,10,14
1509_1,,,,2,2,1,3
1511_0,,,,2,2,1,3
C(C(C=O)(C(CC=C)O)O)(O)=O,,,4,1,4,11,15
1511_1,,,,2,2,1,3
1513_0,,,,2,2,1,3
C(C(C=O)(C(C)O)O)(O)=O,,,4,1,3,10,13
1513_1,,,,2,2,1,3
1515_0,,,,2,2,1,3
C(C(C(O)=O)(C=O)O)(O)=O,,,4,1,3,5,8
1515_1,,,,2,2,1,3
1517_0,,,,2,2,1,3
C(C(C=O)(C(CC(C)O)O)O)(O)=O,,,4,1,5,12,17
1517_1,,,,2,2,1,3
1519_0,,,,2,2,1,3
C(C(C=O)(C(CC(O)=O)O)O)(O)=O,,,4,1,3,11,14
1519_1,,,,2,2,1,3
1521_0,,,,2,2,1,3
C(C(C=O)(C(C(CO)=O)O)O)(O)=O,,,4,1,8,16,24
1521_1,,,,2,2,1,3
1523_0,,,,2,2,1,3
C(C(C=O)(C(C=O)(CO)O)O)(O)=O,,,4,1,7,17,24
1523_1,,,,2,2,1,3
1525_0,,,,2,2,1,3
C(C(C=O)(CO)O)(O)=O,,,4,1,9,12,21
1525_1,,,,2,2,1,3
1527_0,,,,2,2,1,3
C(C(C=O)(C(C(O)=O)(C)O)O)(O)=O,,,4,1,6,11,17
1527_1,,,,2,2,1,3
1529_0,,,,2,2,1,3
C(C(C(C)=O)(CO)C(C)O)(O)=O,,,4,1,1,7,8
1531_0,,,,2,2,1,3
C(C(C(O)=O)(C(C)=O)CO)(O)=O,,,4,1,1,4,5
1533_0,,,,2,2,1,3
C(C(C(C)=O)(CO)CO)(O)=O,,,4,1,1,5,6
1535_0,,,,2,2,1,3
C(C(CO)(C(C=CC)O)O)(O)=O,,,4,1,7,9,16
1535_1,,,,2,2,1,3
1537_0,,,,2,2,1,3
C(C(CO)(C(CC=C)O)O)(O)=O,,,4,1,7,10,17
1537_1,,,,2,2,1,3
1539_0,,,,2,2,1,3
C(C(C(C)O)(C(C(C)O)O)O)(O)=O,,,4,1,5,12,17
1539_1,,,,2,2,1,3
1541_0,,,,2,2,1,3
C(C(C(O)=O)(C(C(C)O)O)O)(O)=O,,,4,1,5,8,13
1541_1,,,,2,2,1,3
1543_0,,,,2,2,1,3
C(C(CO)(C(C(C)O)O)O)(O)=O,,,4,1,4,11,15
1543_1,,,,2,2,1,3
1545_0,,,,2,2,1,3
C(C(C(C)O)(C(C(O)=O)O)O)(O)=O,,,4,1,9,12,21
1545_1,,,,2,2,1,3
1547_0,,,,2,2,1,3
C(C(C(O)=O)(C(C(O)=O)O)O)(O)=O,,,4,1,9,7,16
1547_1,,,,2,2,1,3
1548_0,,,,2,2,1,3
1548_1,,,,2,2,1,3
1550_0,,,,2,2,1,3
C(C(C(C(CO)C(C)O)O)O)(O)=O,,,4,1,2,10,12
1551_0,,,,2,2,1,3
1553_0,,,,2,2,1,3
C(CC(C(CO)=O)(C(C=O)O)O)=O,,,4,1,1,18,19
1554_0,,,,2,2,1,3
1555_0,,,,2,2,1,3
1557_0,,,,2,2,1,3
C(CO)(C(CO)(CC=O)O)=O,,,4,1,2,17,19
1558_0,,,,2,2,1,3
1560_0,,,,2,2,1,3
C(C(C(CO)O)(C(C(O)=O)O)O)=O,,,4,1,4,17,21
1562_0,,,,2,2,1,3
C(C(C)(C(CCO)O)O)(O)=O,,,4,1,2,7,9
1564_0,,,,2,2,1,3
C(C(C(CCO)O)O)(O)=O,,,4,1,8,13,21
1566_0,,,,2,2,1,3
C(C(CCO)(C(C(O)=O)O)O)(O)=O,,,4,1,1,10,11
1568_0,,,,2,2,1,3
C(C(C(C(C)=O)(CC=O)O)O)(O)=O,,,4,1,2,12,14
1570_0,,,,2,2,1,3
C(C(C)(C(C(O)=O)O)O)(CC=O)=O,,,4,1,1,13,14
1572_0,,,,2,2,1,3
C(C(C(CC(C(C)=O)=O)O)O)(O)=O,,,4,1,1,13,14
1574_0,,,,2,2,1,3
C(C(C(C(C(CO)=O)=O)(C)O)O)=O,,,4,1,1,15,16
1576_0,,,,2,2,1,3
C(C(CO)=O)(C(C)(C(C)O)O)=O,,,4,1,1,10,11
1577_0,,,,2,2,1,3
1579_0,,,,2,2,1,3
C(C(CO)=O)(C(CO)(C)O)=O,,,4,1,1,11,12
1581_0,,,,2,2,1,3
C(C(C)(C(C=O)O)O)(O)=O,,,4,1,8,17,25
1582_0,,,,2,2,1,3
1584_0,,,,2,2,1,3
C(C(C)(C(C(C=O)O)O)O)(O)=O,,,4,1,4,14,18
1585_0,,,,2,2,1,3
1587_0,,,,2,2,1,3
C(C(C)(C(CO)(CO)O)O)(O)=O,,,4,1,3,5,8
1588_0,,,,2,2,1,3
1589_0,,,,2,2,1,3
1590_0,,,,2,2,1,3
1591_0,,,,2,2,1,3
1593_0,,,,2,2,1,3
C(C(C)(C(C=CC)O)O)(O)=O,,,4,1,2,6,8
1595_0,,,,2,2,1,3
C(C(C)(C(CC=C)O)O)(O)=O,,,4,1,2,7,9
1597_0,,,,2,2,1,3
C(C(C)(C(C)O)O)(O)=O,,,4,1,2,8,10
1598_0,,,,2,2,1,3
1600_0,,,,2,2,1,3
C(C(C)(C(CC(C)O)O)O)(O)=O,,,4,1,3,8,11
1602_0,,,,2,2,1,3
C(C(C)(C(CC(O)=O)O)O)(O)=O,,,4,1,2,7,9
1603_0,,,,2,2,1,3
1605_0,,,,2,2,1,3
C(C(C)(C(C=O)(CO)O)O)(O)=O,,,4,1,6,14,20
1606_0,,,,2,2,1,3
1608_0,,,,2,2,1,3
C(C(C)(C(C(O)=O)(C)O)O)(O)=O,,,4,1,1,4,5
1609_0,,,,2,2,1,3
1611_0,,,,2,2,1,3
C(C(C(C(C(O)=O)O)O)O)(O)=O,,,4,1,2,6,8
1613_0,,,,2,2,1,3
C(C(C(C=CC)O)O)(O)=O,,,4,1,7,12,19
1615_0,,,,2,2,1,3
C(C(C(CC=C)O)O)(O)=O,,,4,1,6,13,19
1617_0,,,,2,2,1,3
C(C(C=CC)(C(C(O)=O)O)O)(O)=O,,,4,1,1,7,8
1619_0,,,,2,2,1,3
C(C(C(C(O)=O)(CC=C)O)O)(O)=O,,,4,1,1,7,8
1621_0,,,,2,2,1,3
C(C(C(CC(C(O)=O)=C)O)O)(O)=O,,,4,1,1,9,10
1623_0,,,,2,2,1,3
C(C(C(C=C(C(O)=O)C)O)O)(O)=O,,,4,1,1,4,5
1625_0,,,,2,2,1,3
C1(C(CC(C)O1)(C(C(O)=O)O)O)=O,,,4,1,1,6,7
1627_0,,,,2,2,1,3
C1(CC(C(O1)=O)(C(C(O)=O)O)O)=O,,,4,1,1,8,9
1628_0,,,,2,1,2,3
1628_1,,,,2,1,2,3
1629_0,,,,2,1,2,3
1629_1,,,,2,1,2,3
1630_0,,,,2,1,2,3
1630_1,,,,2,1,2,3
1631_0,,,,2,1,2,3
1631_1,,,,2,1,2,3
1632_0,,,,2,1,2,3
1632_1,,,,2,1,2,3
1633_0,,,,2,1,2,3
1633_1,,,,2,1,2,3
1634_0,,,,2,1,2,3
1634_1,,,,2,1,2,3
1635_0,,,,2,1,2,3
1635_1,,,,2,1,2,3
1636_0,,,,2,1,2,3
1636_1,,,,2,1,2,3
1638_0,,,,2,1,1,2
C(C(COC(C(C)=O)=O)O)(O)=O,,,4,1,2,4,6
1638_1,,,,2,1,1,2
1640_0,,,,2,1,1,2
C(C(CO)O)(OC(C(C)=O)=O)=O,,,4,1,4,6,10
1640_1,,,,2,1,1,2
1642_0,,,,2,1,2,3
C1(C(C)(C(C(O1)=O)O)O)=O,,,4,1,3,10,13
1642_1,,,,2,1,2,3
1643_0,,,,2,1,2,3
1644_0,,,,2,1,2,3
1645_0,,,,2,1,2,3
1646_0,,,,2,1,2,3
1647_0,,,,2,1,2,3
1648_0,,,,2,1,2,3
1649_0,,,,2,1,2,3
1650_0,,,,2,1,2,3
1651_0,,,,2,1,2,3
1653_0,,,,2,1,2,3
C(C(C=C)O)(O)=O,,,4,1,3,37,40
1655_0,,,,2,1,2,3
C(C(C(C(O)=O)=C)O)(O)=O,,,4,1,2,12,14
1657_0,,,,2,1,2,3
C=C(C=O)C(O)=O,,,4,1,5,106,111
1658_0,,,,2,1,2,3
1659_0,,,,2,1,2,3
1660_0,,,,2,1,2,3
1662_0,,,,2,1,1,2
C(C(C=O)(C)OC(CO)=O)(O)=O,,,4,1,1,4,5
1664_0,,,,2,1,1,2
C(C(C=O)O)(OC(C(O)=O)C)=O,,,4,1,1,4,5
1666_0,,,,2,1,1,2
C(C(C=O)(C)O)(OC(CO)=O)=O,,,4,1,1,4,5
1668_0,,,,2,1,1,2
C(C(C=O)O)(OC(C(C)O)=O)=O,,,4,1,2,5,7
1670_0,,,,2,1,1,2
C(C(C)O)(OCC(C(O)=O)=O)=O,,,4,1,1,3,4
1672_0,,,,2,1,1,2
C(C(C)O)(OC(C(CO)=O)=O)=O,,,4,1,2,3,5
1674_0,,,,2,1,1,2
C(C(C=O)(C)O)(OCC(O)=O)=O,,,4,1,1,4,5
1676_0,,,,2,1,1,2
C(C(C=O)OC(C(C)O)=O)(O)=O,,,4,1,1,6,7
1678_0,,,,2,1,2,3
C(C(C(CCC(C)O)=O)=O)=O,,,4,1,1,13,14
1680_0,,,,2,1,2,3
C(CC(C)O)(CC(C=O)=O)=O,,,4,1,2,18,20
1682_0,,,,2,1,2,3
C(C(C=O)C(C=O)C(C)O)=O,,,4,1,2,13,15
1684_0,,,,2,1,2,3
C(CCC(C(C=O)=O)=O)(O)=O,,,4,1,1,10,11
1686_0,,,,2,1,2,3
C(CC(CC(C=O)=O)=O)(O)=O,,,4,1,2,17,19
1688_0,,,,2,1,2,3
C(C(C=O)C(C=O)C(O)=O)=O,,,4,1,3,11,14
1690_0,,,,2,1,2,3
C(CO)(CC(C(C=O)=O)=O)=O,,,4,1,1,19,20
1692_0,,,,2,1,2,3
C(C(CC(C(CO)=O)=O)=O)=O,,,4,1,1,19,20
1694_0,,,,2,1,2,3
C(C(C(C(C=O)=O)=O)CO)=O,,,4,1,1,15,16
1696_0,,,,2,1,2,3
C(C(C=O)C(C(C=O)=O)O)=O,,,4,1,1,14,15
1698_0,,,,2,1,2,3
C(C(C=O)CC=O)=O,,,4,1,5,64,69
1700_0,,,,2,1,2,3
C(C(C=O)CC(C(O)=O)=O)=O,,,4,1,1,8,9
1702_0,,,,2,1,2,3
C(CC(C=O)=O)=O,,,4,1,2,181,183
1703_0,,,,2,1,2,3
1705_0,,,,2,1,2,3
C(C)(CC(C=O)=O)=O,,,4,1,8,92,100
1707_0,,,,2,1,2,3
C(C(C(CC)=O)=O)=O,,,4,1,4,62,66
1708_0,,,,2,1,2,3
1709_0,,,,2,1,2,3
1710_0,,,,2,1,2,3
1711_0,,,,2,1,2,3
1712_0,,,,2,1,2,3
1713_0,,,,2,1,2,3
1714_0,,,,2,1,2,3
1715_0,,,,2,1,2,3
1716_0,,,,2,1,2,3
1718_0,,,,2,1,2,3
C(C(C(C(CO)=O)=O)CO)(O)=O,,,4,1,5,12,17
1719_0,,,,2,1,2,3
1721_0,,,,2,1,2,3
C(C(C=O)C(C(O)=O)(CO)O)=O,,,4,1,3,11,14
1722_0,,,,2,1,2,3
1724_0,,,,2,1,2,3
C(C(CCC(C)O)=O)(O)=O,,,4,1,2,11,13
1726_0,,,,2,1,2,3
C(CC(CC(C)O)=O)(O)=O,,,4,1,4,21,25
1728_0,,,,2,1,2,3
C(CCC(C(O)=O)=O)(O)=O,,,4,1,1,8,9
1730_0,,,,2,1,2,3
C(CC(CC(O)=O)=O)(O)=O,,,4,1,4,11,15
1731_0,,,,2,1,2,3
1733_0,,,,2,1,2,3
C(CC(C(CO)=O)=O)(O)=O,,,4,1,4,22,26
1735_0,,,,2,1,2,3
C(C(C(C(O)=O)=O)CO)=O,,,4,1,1,15,16
1737_0,,,,2,1,2,3
C(C(C=O)C(C(O)=O)O)=O,,,4,1,2,15,17
1738_0,,,,2,1,2,3
1740_0,,,,2,1,2,3
C(C(O)=O)(CC)=O,,,4,1,3,76,79
1742_0,,,,2,1,2,3
C(C(C(C(O)=O)=O)C)(O)=O,,,4,1,2,9,11
1743_0,,,,2,1,2,3
1744_0,,,,2,1,2,3
1746_0,,,,2,1,2,3
C(CC(C(C(O)=O)=C)=O)(O)=O,,,4,1,4,10,14
1747_0,,,,2,1,2,3
1749_0,,,,2,1,2,3
C(C)(C(C)O)=O,,,4,1,6,202,208
1751_0,,,,2,1,2,3
C(CO)(CC)=O,,,4,1,6,256,262
1752_0,,,,2,1,2,3
1753_0,,,,2,1,2,3
1754_0,,,,2,1,2,3
1755_0,,,,2,1,2,3
1756_0,,,,2,1,2,3
1758_0,,,,2,1,2,3
C(C(CC(C)=O)O)(O)=O,,,4,1,3,36,39
1759_0,,,,2,1,2,3
1760_0,,,,2,1,2,3
1761_0,,,,2,1,2,3
1762_0,,,,2,1,2,3
1764_0,,,,2,1,2,3
C(CC(CC(C(O)=O)=O)=O)=O,,,4,1,2,13,15
1765_0,,,,2,1,2,3
1767_0,,,,2,1,2,3
C(C)(CC(C(C(O)=O)=O)=O)=O,,,4,1,2,11,13
1768_0,,,,2,1,2,3
1770_0,,,,2,1,2,3
C(C1(C(CC(O1)=O)=O)C)(O)=O,,,4,1,3,4,7
1771_0,,,,2,1,2,3
1773_0,,,,2,1,2,3
C1(C(C(CC(O1)=O)=O)(C)O)=O,,,4,1,2,5,7
1775_0,,,,2,1,2,3
C1(C(C(C(C(O1)=O)O)=O)C)=O,,,4,1,3,6,9
1776_0,,,,2,1,2,3
1778_0,,,,2,1,2,3
C1(C(C=O)C(C(O1)=O)(C)O)=O,,,4,1,2,8,10
1780_0,,,,2,1,2,3
C(C1C(C(C(O1)=O)C)=O)(O)=O,,,4,1,4,6,10
1782_0,,,,2,1,2,3
C(C1CC(C(C=1)=O)=O)(O)=O,,,4,1,1,19,20
1784_0,,,,2,1,2,3
C(C)=C(C=O)C(CC(C)O)O,,,4,1,1,12,13
1786_0,,,,2,1,2,3
C(CC(C)O)=C(C=O)C(C)O,,,4,1,1,9,10
1787_0,,,,2,1,2,3
1789_0,,,,2,1,2,3
C(C(C=CC(C)O)C(C)O)=O,,,4,1,2,10,12
1790_0,,,,2,1,2,3
1791_0,,,,2,1,2,3
1793_0,,,,2,1,2,3
C(CC(C)O)=C(C(O)=O)C=O,,,4,1,1,8,9
1795_0,,,,2,1,2,3
C(C(C=O)C=CC(C)O)(O)=O,,,4,1,3,10,13
1796_0,,,,2,1,2,3
1797_0,,,,2,1,2,3
1799_0,,,,2,1,2,3
C(C(C(C=O)=O)O)=CC(C)O,,,4,1,1,10,11
1800_0,,,,2,1,2,3
1801_0,,,,2,1,2,3
1803_0,,,,2,1,2,3
C(CC(C)O)=CC=O,,,4,1,4,52,56
1805_0,,,,2,1,2,3
C(CC=CC(C)O)=O,,,4,1,7,41,48
1806_0,,,,2,1,2,3
1807_0,,,,2,1,2,3
1809_0,,,,2,1,2,3
C(CC(C)O)=CC(C(O)=O)=O,,,4,1,1,6,7
1811_0,,,,2,1,2,3
C(CC(C(O)=O)=O)=CC(C)O,,,4,1,1,6,7
1812_0,,,,2,1,2,3
1813_0,,,,2,1,2,3
1815_0,,,,2,1,2,3
C(C(C=CC(O)=O)C(C)O)=O,,,4,1,2,11,13
1817_0,,,,2,1,2,3
C(CC=C(C=O)C(C)O)(O)=O,,,4,1,1,7,8
1819_0,,,,2,1,2,3
C(CC(C(C=O)=CC)O)(O)=O,,,4,1,1,9,10
1820_0,,,,2,1,2,3
1822_0,,,,2,1,2,3
C(C(C(C)O)=CC(CO)=O)=O,,,4,1,1,13,14
1824_0,,,,2,1,2,3
C(CO)(C(C(C=O)=CC)O)=O,,,4,1,1,15,16
1825_0,,,,2,1,2,3
1827_0,,,,2,1,2,3
C(C(C(C)O)=C(C=O)CO)=O,,,4,1,1,11,12
1829_0,,,,2,1,2,3
C(C(C(C=O)=CC)(CO)O)=O,,,4,1,1,12,13
1830_0,,,,2,1,2,3
1832_0,,,,2,1,2,3
C=C(C=O)C(C)O,,,4,1,3,115,118
1834_0,,,,2,1,2,3
C(C)=C(C=O)CO,,,4,1,4,114,118
1835_0,,,,2,1,2,3
1836_0,,,,2,1,2,3
1838_0,,,,2,1,2,3
C(C)=C(C=O)C(C)O,,,4,1,4,52,56
1840_0,,,,2,1,2,3
C(C)=C(C=O)C(O)=O,,,4,1,3,45,48
1841_0,,,,2,1,2,3
1842_0,,,,2,1,2,3
1844_0,,,,2,1,2,3
C(C(C)=C(C=O)C(C)O)(O)=O,,,4,1,1,8,9
1846_0,,,,2,1,2,3
C(C(C(C=O)=CC)(C)O)(O)=O,,,4,1,1,10,11
1847_0,,,,2,1,2,3
1849_0,,,,2,1,2,3
C(C(CC(C)O)=CC=O)(O)=O,,,4,1,1,10,11
1851_0,,,,2,1,2,3
C(CC(C(O)=O)=CC(C)O)=O,,,4,1,1,9,10
1852_0,,,,2,1,2,3
1853_0,,,,2,1,2,3
1855_0,,,,2,1,2,3
C=C(C(C(O)=O)=O)C(C)O,,,4,1,1,11,12
1857_0,,,,2,1,2,3
C(C)=C(C(C(O)=O)=O)CO,,,4,1,2,10,12
1858_0,,,,2,1,2,3
1859_0,,,,2,1,2,3
1861_0,,,,2,1,2,3
C(C)=C(C(C(O)=O)=O)C(C)O,,,4,1,1,7,8
1863_0,,,,2,1,2,3
C(C)=C(C(O)=O)C(C(O)=O)=O,,,4,1,1,6,7
1864_0,,,,2,1,2,3
1866_0,,,,2,1,2,3
C(CC=C(C=O)C(O)=O)(O)=O,,,4,1,1,6,7
1868_0,,,,2,1,2,3
C(C(C(O)=O)C=CC(O)=O)=O,,,4,1,3,11,14
1870_0,,,,2,1,2,3
C(C(C(C=O)=O)O)=CC(O)=O,,,4,1,1,11,12
1872_0,,,,2,1,2,3
C(CC=CC=O)(O)=O,,,4,1,5,45,50
1874_0,,,,2,1,2,3
C(CC=CC(O)=O)=O,,,4,1,7,60,67
1876_0,,,,2,1,2,3
C(CC=CC(C(O)=O)=O)(O)=O,,,4,1,2,5,7
1878_0,,,,2,1,2,3
C(CC(C(O)=O)=O)=CC(O)=O,,,4,1,2,7,9
1880_0,,,,2,1,2,3
C(C(C=O)=CC(CO)=O)(O)=O,,,4,1,1,12,13
1882_0,,,,2,1,2,3
C(C(C=O)=C(C=O)CO)(O)=O,,,4,1,1,10,11
1883_0,,,,2,1,2,3
1884_0,,,,2,1,2,3
1886_0,,,,2,1,2,3
C(C(C(O)=O)=C(C(O)=O)C)=O,,,4,1,1,7,8
1888_0,,,,2,1,2,3
C(C(C)(CC=CC=O)O)(O)=O,,,4,1,1,8,9
1889_0,,,,2,1,2,3
1890_0,,,,2,1,2,3
1892_0,,,,2,1,2,3
C(C(C=CCC=O)(C)O)(O)=O,,,4,1,1,9,10
1893_0,,,,2,1,2,3
1895_0,,,,2,1,2,3
C(C(C(C=O)=C)(C)O)(O)=O,,,4,1,1,14,15
1897_0,,,,2,1,2,3
C(C(C)=C(C=O)CO)(O)=O,,,4,1,2,14,16
1899_0,,,,2,1,2,3
C(CC(C(O)=O)=CC=O)(O)=O,,,4,1,2,8,10
1901_0,,,,2,1,2,3
C(CC(C(O)=O)=CC(O)=O)=O,,,4,1,2,10,12
1903_0,,,,2,1,2,3
C=C(C(O)=O)C(C(O)=O)=O,,,4,1,1,10,11
1905_0,,,,2,1,2,3
C=C(C(C(O)=O)=O)C(C(C)=O)=O,,,4,1,1,9,10
1907_0,,,,2,1,2,3
C=CC(C(CC(C(O)=O)=O)=O)=O,,,4,1,1,9,10
1909_0,,,,2,1,2,3
C(C=CC(CO)=O)=O,,,4,1,4,112,116
1911_0,,,,2,1,2,3
C(C(C=CC(CO)=O)=O)(O)=O,,,4,1,1,10,11
1913_0,,,,2,1,2,3
C(C(CO)=CC=O)=O,,,4,1,6,84,90
1915_0,,,,2,1,2,3
C(C(CO)=CC(C(O)=O)=O)=O,,,4,1,1,8,9
1917_0,,,,2,1,2,3
C=CC(C(C=O)=O)O,,,4,1,3,49,52
1918_0,,,,2,1,2,3
1920_0,,,,2,1,2,3
C=C(C(O)=O)C(C(C(O)=O)=O)=C,,,4,1,1,7,8
1922_0,,,,2,1,2,3
C(C1(C(C(C(O1)=O)=O)=C)C)(O)=O,,,4,1,2,4,6
1924_0,,,,2,1,2,3
C1(C(C(CO)=C(C(O1)=O)C)=O)=O,,,4,1,1,4,5
1926_0,,,,2,1,2,3
C1(C(C(C(C(O1)=O)=O)=C)(C)O)=O,,,4,1,1,5,6
1927_0,,,,2,1,2,3
1929_0,,,,2,1,2,3
C=CC=O,,,4,1,11,720,731
1931_0,,,,2,1,2,3
C=CC(C(O)=O)=O,,,4,1,6,104,110
1932_0,,,,2,1,2,3
1933_0,,,,2,1,2,3
1935_0,,,,2,1,2,3
C=CC(C)O,,,4,1,2,57,59
1936_0,,,,2,1,2,3
1937_0,,,,2,1,2,3
1939_0,,,,2,1,2,3
C=CC(O)=O,,,4,1,4,224,228
1940_0,,,,2,1,2,3
1941_0,,,,2,1,2,3
1943_0,,,,2,1,2,3
C(C(C=C)(C)O)(O)=O,,,4,1,2,8,10
1945_0,,,,2,1,2,3
C=C,,,4,1,2,1,3
1946_0,,,,2,1,2,3
1947_0,,,,2,1,2,3
1948_0,,,,2,1,2,3
1949_0,,,,2,1,2,3
1951_0,,,,2,1,2,3
C(C(C=CC(C)O)(CO)O)(O)=O,,,4,1,3,7,10
1952_0,,,,2,1,2,3
1953_0,,,,2,1,2,3
1955_0,,,,2,1,2,3
C(C(C=CC(O)=O)(CO)O)(O)=O,,,4,1,3,7,10
1957_0,,,,2,1,2,3
C(C(C=CC(C)O)O)(O)=O,,,4,1,2,8,10
1958_0,,,,2,1,2,3
1959_0,,,,2,1,2,3
1961_0,,,,2,1,2,3
C(C(C=CC(O)=O)O)(O)=O,,,4,1,2,12,14
1962_0,,,,2,1,2,3
1963_0,,,,2,1,2,3
1964_0,,,,2,1,2,3
1965_0,,,,2,1,2,3
1967_0,,,,2,1,2,3
C=C(C(O)=O)C(C)=O,,,4,1,5,58,63
1968_0,,,,2,1,2,3
1970_0,,,,2,1,2,3
C=C1C(OC(C(O)=O)=C1)=O,,,4,1,2,7,9
1971_0,,,,2,1,2,3
1973_0,,,,2,1,2,3
C=CC(CO)O,,,4,1,3,20,23
1975_0,,,,2,1,2,3
C(C(C(C=C)O)O)(O)=O,,,4,1,6,20,26
1977_0,,,,2,1,2,3
C=C(C(O)=O)C(CO)O,,,4,1,5,14,19
1979_0,,,,2,1,2,3
C1(C(C(C(C(O1)=O)=C)O)O)=O,,,4,1,3,9,12
1980_0,,,,2,1,2,3
1981_0,,,,2,1,2,3
1983_0,,,,2,1,2,3
C=C1C(OC(C1)O)=O,,,4,1,2,35,37
1985_0,,,,2,1,2,3
C1C(O)OC(C=1C)=O,,,4,1,1,33,34
1987_0,,,,2,1,2,3
C1(C(C=CO1)(C)O)=O,,,4,1,1,5,6
1989_0,,,,2,1,2,3
C1(C(C=C(C(C)=O)O1)=O)=O,,,4,1,1,10,11
1991_0,,,,2,1,2,3
C=C1C(CC(C(O1)=O)=O)=O,,,4,1,1,16,17
1993_0,,,,2,1,2,3
C(C1(C(C(OC1)=O)=C)O)(O)=O,,,4,1,3,6,9
1995_0,,,,2,1,2,3
C1(C(C(C(O1)=O)=C)(CO)O)=O,,,4,1,3,6,9
1997_0,,,,2,1,2,3
C(C1C(C(C(O1)=O)=C)O)(O)=O,,,4,1,4,6,10
1998_0,,,,2,2,1,3
2000_0,,,,2,2,1,3
CC(CC(C(CO)(C(C)O)O)O)O,,,4,1,1,7,8
2001_0,,,,2,2,1,3
2003_0,,,,2,2,1,3
CC(CC(C(CO)O)O)O,,,4,1,1,7,8
2004_0,,,,2,2,1,3
2006_0,,,,2,2,1,3
C(CC(C(CO)(C(C)O)O)O)(O)=O,,,4,1,1,8,9
2008_0,,,,2,2,1,3
C(CO)(C(C(CO)(C(C)O)O)O)=O,,,4,1,1,10,11
2010_0,,,,2,2,1,3
C(C(CO)(C(CO)(C(C)O)O)O)=O,,,4,1,1,13,14
2012_0,,,,2,2,1,3
CC(C(CO)(CO)O)O,,,4,1,1,6,7
2014_0,,,,2,2,1,3
CC(C(CO)(C(C)O)O)O,,,4,1,1,3,4
2015_0,,,,2,2,1,3
2017_0,,,,2,2,1,3
C(C(C)(C(CO)(C(C)O)O)O)(O)=O,,,4,1,1,8,9
2019_0,,,,2,2,1,3
C(C(C(CO)O)(CC(C)O)O)(O)=O,,,4,1,1,10,11
2021_0,,,,2,2,1,3
C(C(C(CO)(C(C)O)O)O)(O)=O,,,4,1,3,8,11
2023_0,,,,2,2,1,3
C(C(C(C(C)O)(C(C)O)O)O)(O)=O,,,4,1,3,6,9
2024_0,,,,2,2,1,3
2025_0,,,,2,2,1,3
2027_0,,,,2,2,1,3
C(CC(C(CO)O)O)(O)=O,,,4,1,1,10,11
2028_0,,,,2,2,1,3
2029_0,,,,2,2,1,3
2030_0,,,,2,2,1,3
2031_0,,,,2,2,1,3
2032_0,,,,2,2,1,3
2033_0,,,,2,2,1,3
2035_0,,,,2,2,1,3
C(C(C)(CC(C(CO)O)O)O)(O)=O,,,4,1,1,11,12
2036_0,,,,2,2,1,3
2038_0,,,,2,2,1,3
C(C(C(CO)O)(CC(O)=O)O)(O)=O,,,4,1,1,10,11
2039_0,,,,2,2,1,3
2040_0,,,,2,2,1,3
2042_0,,,,2,2,1,3
C(CO)(C(C(CO)O)O)=O,,,4,1,5,22,27
2043_0,,,,2,2,1,3
2045_0,,,,2,2,1,3
C(C(CO)(C(CO)O)O)=O,,,4,1,3,14,17
2046_0,,,,2,2,1,3
2048_0,,,,2,2,1,3
C(C(CO)O)O,,,4,1,3,18,21
2049_0,,,,2,2,1,3
2051_0,,,,2,2,1,3
C(C(C(C(C)=O)O)O)=O,,,4,1,9,51,60
2052_0,,,,2,2,1,3
2053_0,,,,2,2,1,3
2054_0,,,,2,2,1,3
2055_0,,,,2,2,1,3
2056_0,,,,2,2,1,3
2058_0,,,,2,2,1,3
C(C(CO)C(CO)O)(O)=O,,,4,1,5,10,15
2059_0,,,,2,2,1,3
2060_0,,,,2,2,1,3
2061_0,,,,2,2,1,3
2062_0,,,,2,2,1,3
2063_0,,,,2,2,1,3
2064_0,,,,2,2,1,3
2065_0,,,,2,2,1,3
2066_0,,,,2,2,1,3
2068_0,,,,2,2,1,3
C(C(C(C(C(CO)O)O)O)=O)(O)=O,,,4,1,5,15,20
2069_0,,,,2,2,1,3
2070_0,,,,2,2,1,3
2072_0,,,,2,2,1,3
C1(C(C(C(C(C)=O)(O)O1)O)O)=O,,,4,1,2,9,11
2074_0,,,,2,2,1,3
C1(C(CC(C(CO)O)(O)O1)=O)=O,,,4,1,2,9,11
2076_0,,,,2,2,1,3
C1(C(C(C(OC1(C)O)=O)O)O)=O,,,4,1,2,8,10
2078_0,,,,2,2,1,3
C1(C(C(C(C(C)(O)O1)O)O)=O)=O,,,4,1,2,8,10
2080_0,,,,2,2,1,3
C1(C(C(C(C)O1)O)O)=O,,,4,1,3,19,22
2082_0,,,,2,2,1,3
C1(C(C(C(O1)=O)O)O)=O,,,4,1,3,15,18
2083_0,,,,2,2,1,3
2085_0,,,,2,2,1,3
C(C(CC)O)=O,,,4,1,3,148,151
2086_0,,,,2,2,1,3
2088_0,,,,2,2,1,3
C(CCCO)=O,,,4,1,3,150,153
2089_0,,,,2,2,1,3
2091_0,,,,2,2,1,3
C(C(C(CC)O)=O)(O)=O,,,4,1,2,15,17
2092_0,,,,2,2,1,3
2094_0,,,,2,2,1,3
C(C(CCCO)=O)(O)=O,,,4,1,3,18,21
2095_0,,,,2,2,1,3
2097_0,,,,2,2,1,3
C(C(CO)CC=O)(O)=O,,,4,1,3,25,28
2099_0,,,,2,2,1,3
C(C(C)C(C=O)O)(O)=O,,,4,1,3,23,26
2100_0,,,,2,2,1,3
2101_0,,,,2,2,1,3
2103_0,,,,2,2,1,3
C(C(CO)(CCO)O)(O)=O,,,4,1,3,6,9
2104_0,,,,2,2,1,3
2105_0,,,,2,2,1,3
2106_0,,,,2,2,1,3
2107_0,,,,2,2,1,3
2108_0,,,,2,2,1,3
2109_0,,,,2,2,1,3
2111_0,,,,2,2,1,3
C1(C(C)C(C(C(O)=O)(O)O1)O)=O,,,4,1,2,5,7
2112_0,,,,2,2,1,3
2114_0,,,,2,2,1,3
C1(C(CO)CC(C(O)=O)(O)O1)=O,,,4,1,2,6,8
2115_0,,,,2,2,1,3
2117_0,,,,2,2,1,3
C1(C(C)C(C(C(O1)=O)=O)O)=O,,,4,1,4,4,8
2118_0,,,,2,2,1,3
2120_0,,,,2,2,1,3
C1(C(CO)CC(C(O1)=O)=O)=O,,,4,1,5,7,12
2121_0,,,,2,1,2,3
2122_0,,,,2,1,2,3
2123_0,,,,2,1,1,2
2123_1,,,,2,1,1,2
2125_0,,,,2,1,1,2
C1(C(O)OC(CC(C)O)C1O)=O,,,4,1,1,6,7
2127_0,,,,2,1,1,2
C(C1C(C)OC(CO)(C1O)O)=O,,,4,1,1,11,12
2129_0,,,,2,1,1,2
C(C1(COC(C1C(C)O)O)O)=O,,,4,1,1,9,10
2131_0,,,,2,1,1,2
C(C1C(C)OC(C1(CO)O)O)=O,,,4,1,1,11,12
2133_0,,,,2,1,1,2
C1(C(C)(C(C(O)O1)C(C)O)O)=O,,,4,1,1,6,7
2135_0,,,,2,1,1,2
C1(C(CC(O)O1)(CC(C)O)O)=O,,,4,1,1,6,7
2137_0,,,,2,1,1,2
C(CC1C(C(C(O)O1)=O)O)(O)=O,,,4,1,1,6,7
2139_0,,,,2,1,1,2
C1(C(C=O)C(C(CO)(O)O1)O)=O,,,4,1,2,11,13
2141_0,,,,2,1,1,2
C(C1C(O)OCC1(C=O)O)(O)=O,,,4,1,1,9,10
2143_0,,,,2,1,1,2
C1(C(C=O)C(CO)(C(O)O1)O)=O,,,4,1,2,11,13
2145_0,,,,2,1,1,2
C(C1C(O)OC(C1(C)O)=O)(O)=O,,,4,1,1,6,7
2147_0,,,,2,1,1,2
C1(C(C)(C(CO)C(O)O1)O)=O,,,4,1,1,5,6
2149_0,,,,2,1,1,2
C1(C(CC(O)O1)(CC(O)=O)O)=O,,,4,1,1,5,6
2151_0,,,,2,1,1,2
C1(C(C)(O)OCC1C(C(O)=O)=O)=O,,,4,1,1,6,7
2152_0,,,,2,1,1,2
2153_0,,,,2,1,1,2
2155_0,,,,2,1,1,2
C1(C(CC(C(O)=O)=O)(O)OCC1)=O,,,4,1,1,8,9
2157_0,,,,2,1,1,2
C1(C(O)OC(C(CO)=O)C1O)=O,,,4,1,1,9,10
2159_0,,,,2,1,1,2
C(C1(CO)C(C(C(O1)O)=O)O)=O,,,4,1,1,12,13
2161_0,,,,2,1,1,2
C(C1(COC(C=O)(C1O)O)O)=O,,,4,1,1,14,15
2163_0,,,,2,1,1,2
C(C1(COC(C1)O)O)=O,,,4,1,1,12,13
2165_0,,,,2,1,1,2
C(C1(COC(C(O)=O)(C1)O)O)=O,,,4,1,1,9,10
2167_0,,,,2,1,1,2
C1(C(O)OCC1O)=O,,,4,1,1,66,67
2169_0,,,,2,1,1,2
C1(C(O)OC(C)C1O)=O,,,4,1,1,28,29
2171_0,,,,2,1,1,2
C1(C(C(C(O)O1)=O)O)=O,,,4,1,1,26,27
2173_0,,,,2,1,1,2
C1(C(C)(C(C(C=O)(O)O1)O)O)=O,,,4,1,1,10,11
2175_0,,,,2,1,1,2
C(C1(C)C(C(C(O1)O)=O)O)(O)=O,,,4,1,1,6,7
2177_0,,,,2,1,1,2
C(C1(C(C(C(O1)=O)=C)CO)O)(O)=O,,,4,1,1,5,6
2179_0,,,,2,1,1,2
C1(C2(C)C(CO)C(C(O2)=O)(O)O1)=O,,,4,1,1,3,4
2181_0,,,,2,1,1,2
C(C1(C(C(C)(O)OC1)=O)O)(O)=O,,,4,1,1,5,6
2183_0,,,,2,1,1,2
C1(C(C(C(C)(O)O1)=O)(CO)O)=O,,,4,1,1,6,7
2185_0,,,,2,1,1,2
C1(C(C(C(CO)(O)O1)=O)(C)O)=O,,,4,1,1,5,6
2187_0,,,,2,1,1,2
C(C1C(C(C(C)(O1)O)=O)O)(O)=O,,,4,1,1,6,7
2188_0,,,,2,1,1,2
2190_0,,,,2,1,1,2
C(C1(COC(CO)(C1O)O)O)(O)=O,,,4,1,1,9,10
2192_0,,,,2,1,1,2
C1(C(CO)(C(C(CO)(O)O1)O)O)=O,,,4,1,4,9,13
2194_0,,,,2,1,1,2
C(C1(COC(C1(CO)O)O)O)(O)=O,,,4,1,1,8,9
2196_0,,,,2,1,1,2
C1(C(CO)(C(CO)(C(O)O1)O)O)=O,,,4,1,4,8,12
2198_0,,,,2,1,1,2
C1(C(C(C(CO)(O)O1)O)O)=O,,,4,1,3,8,11
2200_0,,,,2,1,1,2
C1(C(C(CO)(C(O)O1)O)O)=O,,,4,1,3,7,10
2201_0,,,,2,1,1,2
2203_0,,,,2,1,1,2
C1(CC(C(O)=O)(OC1CO)O)=O,,,4,1,1,9,10
2204_0,,,,2,1,1,2
2205_0,,,,2,1,1,2
2207_0,,,,2,1,1,2
C(C1COC(C(O)=O)(C1)O)(O)=O,,,4,1,1,6,7
2208_0,,,,2,1,1,2
2210_0,,,,2,1,1,2
CC(C1C(O)OC(C)CC1O)O,,,4,1,1,6,7
2212_0,,,,2,1,1,2
C(C1C(O)OC(C)CC1O)(O)=O,,,4,1,1,6,7
2214_0,,,,2,1,1,2
C(C1(C(C(CC(C)O1)O)O)O)=O,,,4,1,1,10,11
2216_0,,,,2,1,1,2
CC1CC(CC(O)O1)O,,,4,1,1,10,11
2218_0,,,,2,1,1,2
C(C1(CC(CC(C)O1)O)O)(O)=O,,,4,1,1,6,7
2220_0,,,,2,1,1,2
C1(CC(C(C(O)O1)C(C)O)O)=O,,,4,1,1,6,7
2222_0,,,,2,1,1,2
C1(COC(C(C(C)O)C1O)O)=O,,,4,1,1,7,8
2224_0,,,,2,1,1,2
C(C1(CC(O)OC(C)C1)O)(O)=O,,,4,1,1,6,7
2226_0,,,,2,1,1,2
C(C1C(O)OC(CC1O)=O)(O)=O,,,4,1,1,6,7
2228_0,,,,2,1,1,2
C1(CC(C(C(C=O)(O)O1)O)O)=O,,,4,1,1,11,12
2230_0,,,,2,1,1,2
C1(CC(CC(O)O1)O)=O,,,4,1,1,14,15
2232_0,,,,2,1,1,2
C1(CC(CC(C(O)=O)(O)O1)O)=O,,,4,1,1,6,7
2234_0,,,,2,1,1,2
C(C1C(OCC(C1O)=O)O)(O)=O,,,4,1,1,7,8
2236_0,,,,2,1,1,2
C(C1(C)CC(CC(O1)O)O)(O)=O,,,4,1,1,6,7
2238_0,,,,2,1,1,2
C(C1(CC(O)OC(C1)=O)O)(O)=O,,,4,1,1,6,7
2239_0,,,,2,1,1,2
2241_0,,,,2,1,1,2
C1(C(CCO)(O)OC(C(C1)=O)=O)=O,,,4,1,1,5,6
2243_0,,,,2,1,1,2
C(C1(C(C(C(CO1)=O)O)O)O)=O,,,4,1,1,12,13
2245_0,,,,2,1,1,2
C1(COC(CC1O)O)=O,,,4,1,1,29,30
2247_0,,,,2,1,1,2
C1(C(CC(C(CO)(O)O1)O)=O)=O,,,4,1,1,7,8
2249_0,,,,2,1,1,2
C(C1(CC(C(CO1)=O)O)O)(O)=O,,,4,1,2,7,9
2251_0,,,,2,1,1,2
C(C1(COC(C(C1O)=O)O)O)=O,,,4,1,1,13,14
2253_0,,,,2,1,1,2
C1(C(CC(CO)(C(O)O1)O)=O)=O,,,4,1,1,7,8
2255_0,,,,2,1,1,2
C1(C(C)(C(C(C(O)O1)=O)O)O)=O,,,4,1,1,8,9
2256_0,,,,2,1,1,2
2258_0,,,,2,1,1,2
C1(CC(C(O)=O)(O)OCC1O)=O,,,4,1,2,8,10
2259_0,,,,2,1,1,2
2261_0,,,,2,1,1,2
C1(C(O)OC(C)CC(C1O)O)=O,,,4,1,1,8,9
2263_0,,,,2,1,1,2
C1(CC(C(C(C(O)O1)=O)O)O)=O,,,4,1,1,8,9
2265_0,,,,2,1,1,2
C1(C(C)(CC(CC(O)O1)O)O)=O,,,4,1,1,6,7
2267_0,,,,2,1,1,2
C(C1(CC(C(CCO1)=O)=O)O)(O)=O,,,4,1,1,7,8
2269_0,,,,2,1,1,2
C1(COC(C(C(C1O)O)=O)O)=O,,,4,1,1,10,11
2270_0,,,,2,1,1,2
2271_0,,,,2,1,1,2
2272_0,,,,2,1,1,2
2273_0,,,,2,1,1,2
2274_0,,,,2,1,1,2
2275_0,,,,2,1,2,3
2276_0,,,,2,1,2,3
2277_0,,,,2,1,2,3
2278_0,,,,2,1,2,3
2279_0,,,,2,1,2,3
2280_0,,,,2,1,2,3
2281_0,,,,2,1,2,3
2282_0,,,,2,1,2,3
2283_0,,,,2,1,2,3
2284_0,,,,2,1,2,3
2285_0,,,,2,1,2,3
2286_0,,,,2,1,2,3
2287_0,,,,2,1,2,3
2288_0,,,,2,1,2,3
2289_0,,,,2,1,2,3
2290_0,,,,2,1,2,3
2291_0,,,,2,1,2,3
2292_0,,,,2,1,2,3
2293_0,,,,2,1,2,3
2294_0,,,,2,1,2,3
2295_0,,,,2,1,2,3
2296_0,,,,2,1,2,3
2298_0,,,,2,1,2,3
C1(C(CC(CC(C)O)O1)=O)=O,,,4,1,2,6,8
2300_0,,,,2,1,2,3
C(C1C(C)OC(C1(C)O)=O)=O,,,4,1,1,8,9
2301_0,,,,2,1,2,3
2303_0,,,,2,1,2,3
C1(C(C(CO1)C(C)O)=O)=O,,,4,1,4,10,14
2304_0,,,,2,1,2,3
2305_0,,,,2,1,2,3
2306_0,,,,2,1,2,3
2307_0,,,,2,1,2,3
2309_0,,,,2,1,2,3
C1(CC(C(C(C=O)=O)O1)O)=O,,,4,1,1,12,13
2311_0,,,,2,1,2,3
C(CC1CC(C(O1)=O)=O)(O)=O,,,4,1,2,5,7
2313_0,,,,2,1,2,3
C1(C(C=O)C(C=O)(CO1)O)=O,,,4,1,2,9,11
2314_0,,,,2,1,2,3
2316_0,,,,2,1,2,3
C1(C(C)(CC(CC=O)O1)O)=O,,,4,1,1,8,9
2318_0,,,,2,1,2,3
C(C1COC(C1(C)O)=O)=O,,,4,1,2,11,13
2319_0,,,,2,1,2,3
2321_0,,,,2,1,2,3
C(C1C(C(OC1)=O)=O)(O)=O,,,4,1,4,8,12
2322_0,,,,2,1,2,3
2323_0,,,,2,1,2,3
2325_0,,,,2,1,2,3
C(C(C)=O)(C1C(C(OC1)=O)=O)=O,,,4,1,2,5,7
2327_0,,,,2,1,2,3
C(CO)(C1CC(C(O1)=O)=O)=O,,,4,1,3,10,13
2329_0,,,,2,1,2,3
C(C1(CO)CC(C(O1)=O)=O)=O,,,4,1,2,8,10
2331_0,,,,2,1,2,3
C=C(C(O)=O)C1C(C(OC1)=O)=O,,,4,1,3,5,8
2333_0,,,,2,1,2,3
C=C1C(OCC1C(C(O)=O)=O)=O,,,4,1,3,5,8
2335_0,,,,2,1,1,2
C(C(C)(C1C(C(OC1)=O)=O)O)(O)=O,,,4,1,6,8,14
2337_0,,,,2,1,2,3
C1(C2(C)C(C(C(O2)=O)=O)CO1)=O,,,4,1,2,1,3
2338_0,,,,2,1,1,2
2339_0,,,,2,1,1,2
2341_0,,,,2,1,1,2
C1(C(C)(C(C(C(O)=O)=O)CO1)O)=O,,,4,1,2,7,9
2343_0,,,,2,1,2,3
C1(C(OCC1)=O)=O,,,4,1,9,104,113
2345_0,,,,2,1,2,3
C1(C(C(CO1)=O)=O)=O,,,4,1,1,59,60
2347_0,,,,2,1,2,3
C1(C(C)(CCO1)O)=O,,,4,1,1,11,12
2349_0,,,,2,1,2,3
C1(C(C)(CC(O1)=O)O)=O,,,4,1,1,10,11
2351_0,,,,2,1,2,3
C(C1(CO)C(CC(O1)=O)O)(O)=O,,,4,1,5,5,10
2353_0,,,,2,1,2,3
C1(C(CO)(C(C=O)(CO1)O)O)=O,,,4,1,4,11,15
2355_0,,,,2,1,2,3
C1(CC(C(C(O)=O)O1)O)=O,,,4,1,4,11,15
2357_0,,,,2,1,2,3
C(C1(COC(C1O)=O)O)=O,,,4,1,3,14,17
2358_0,,,,2,1,2,3
2359_0,,,,2,1,2,3
2360_0,,,,2,1,2,3
2361_0,,,,2,1,2,3
2362_0,,,,2,1,2,3
2363_0,,,,2,1,2,3
2364_0,,,,2,1,2,3
2366_0,,,,2,1,2,3
C1(C(C)(C(CO1)O)O)=O,,,4,1,2,6,8
2367_0,,,,2,1,2,3
2369_0,,,,2,1,2,3
C(C)(C1C(C(C(O1)=O)=O)O)=O,,,4,1,2,10,12
2371_0,,,,2,1,2,3
C1(C2(C)C(C(C(O2)=O)O1)O)=O,,,4,1,2,4,6
2372_0,,,,2,1,1,2
2373_0,,,,2,1,1,2
2374_0,,,,2,1,1,2
2375_0,,,,2,1,1,2
2376_0,,,,2,1,2,3
2378_0,,,,2,1,2,3
C1(C(C=O)C(CC(C)O1)O)=O,,,4,1,2,8,10
2380_0,,,,2,1,2,3
C(C1C(CC(OC1C)=O)O)=O,,,4,1,1,9,10
2382_0,,,,2,1,2,3
C1(C(C=O)C(CC(O1)=O)O)=O,,,4,1,2,9,11
2384_0,,,,2,1,2,3
C1(C(C=O)C(C(CO1)=O)O)=O,,,4,1,2,13,15
2386_0,,,,2,1,2,3
C(C1(COC(C(C1)=O)=O)O)=O,,,4,1,2,8,10
2387_0,,,,2,1,2,3
2388_0,,,,2,1,2,3
2390_0,,,,2,1,2,3
C1(C(CO)(C(CC(C)O1)O)O)=O,,,4,1,4,7,11
2392_0,,,,2,1,2,3
C1(C(CO)(C(CC(O1)=O)O)O)=O,,,4,1,5,9,14
2394_0,,,,2,1,2,3
C(C1(COC(CC1O)=O)O)(O)=O,,,4,1,2,7,9
2396_0,,,,2,1,2,3
C1(C(CO)(C(C(CO1)=O)O)O)=O,,,4,1,4,10,14
2398_0,,,,2,1,2,3
C1(C(C(CC(C)O1)O)O)=O,,,4,1,3,10,13
2400_0,,,,2,1,2,3
C1(CC(C(C(O1)=O)O)O)=O,,,4,1,3,14,17
2402_0,,,,2,1,2,3
C1(C(C(C(CO1)=O)O)O)=O,,,4,1,3,25,28
2403_0,,,,2,1,2,3
2404_0,,,,2,1,2,3
2405_0,,,,2,1,2,3
2407_0,,,,2,1,2,3
C1(C(CO)OC(C(C1)=O)=O)=O,,,4,1,5,9,14
2408_0,,,,2,1,2,3
2410_0,,,,2,1,2,3
C(C1COC(C(C1)=O)=O)(O)=O,,,4,1,3,6,9
2411_0,,,,2,1,2,3
2413_0,,,,2,1,2,3
C1(C(CC(CC(C)O1)O)=O)=O,,,4,1,2,7,9
2415_0,,,,2,1,2,3
C1(CC(CC(C(O1)=O)=O)O)=O,,,4,1,2,8,10
2417_0,,,,2,1,2,3
C1(COC(C(CC1O)=O)=O)=O,,,4,1,3,10,13
2419_0,,,,2,1,2,3
C1(C(COC(C(C1)=O)=O)O)=O,,,4,1,3,9,12
2421_0,,,,2,2,1,3
C(C(C(C)O)C(C(C)CC=O)O)=O,,,4,1,3,16,19
2423_0,,,,2,2,1,3
C(C(CO)(C(C)CC=O)C(C)O)=O,,,4,1,3,11,14
2425_0,,,,2,2,1,3
C(C(CO)C(CC(C)CC=O)O)=O,,,4,1,5,14,19
2427_0,,,,2,2,1,3
C(C(CO)C(C)(C(C)CC=O)O)=O,,,4,1,3,16,19
2429_0,,,,2,2,1,3
C(C(C=O)C(C(C)CC=O)O)(O)=O,,,4,1,3,14,17
2431_0,,,,2,2,1,3
C(C(C=O)(CO)C(C)CC=O)(O)=O,,,4,1,3,9,12
2433_0,,,,2,2,1,3
C(CC(C)C(C(C(C=O)=O)O)O)=O,,,4,1,1,18,19
2435_0,,,,2,2,1,3
C(CC(C)C(C(C=O)=O)(CO)O)=O,,,4,1,2,13,15
2437_0,,,,2,2,1,3
C(C(CO)C(C)CC=O)=O,,,4,1,8,21,29
2439_0,,,,2,2,1,3
C(C(CO)C(C)CC(C(O)=O)=O)=O,,,4,1,3,11,14
2441_0,,,,2,2,1,3
C(C(CC(C=O)CO)CC=O)(O)=O,,,4,1,2,13,15
2443_0,,,,2,2,1,3
C(C(C)(CC=O)C(C=O)CO)(O)=O,,,4,1,3,12,15
2445_0,,,,2,2,1,3
C(C(C)C(C=O)C(C=O)CO)(O)=O,,,4,1,2,12,14
2447_0,,,,2,2,1,3
C(CC(C(C)CC=O)O)=O,,,4,1,7,26,33
2449_0,,,,2,2,1,3
C(CC(C(C)CC(C(O)=O)=O)O)=O,,,4,1,1,12,13
2451_0,,,,2,2,1,3
C(C(CC(CC=O)O)CC=O)(O)=O,,,4,1,1,14,15
2453_0,,,,2,2,1,3
C(C(C)(C(CC=O)O)CC=O)(O)=O,,,4,1,1,12,13
2455_0,,,,2,2,1,3
C(CC(C(C=O)C(C(O)=O)C)O)=O,,,4,1,1,11,12
2457_0,,,,2,2,1,3
C(CC(C)C(C(C(O)=O)=O)CO)=O,,,4,1,3,11,14
2459_0,,,,2,2,1,3
C(CC(C)C(CC(C(O)=O)=O)O)=O,,,4,1,1,12,13
2461_0,,,,2,2,1,3
C(CC(C(CC(C)CC=O)=O)=O)=O,,,4,1,1,11,12
2463_0,,,,2,2,1,3
C(CC(C)C(C=O)C(C(C)=O)=O)=O,,,4,1,1,9,10
2465_0,,,,2,2,1,3
C(C(C=O)(C(C)CC=O)O)=O,,,4,1,1,10,11
2467_0,,,,2,2,1,3
C(CC(C)C(CO)C(C)O)=O,,,4,1,2,11,13
2469_0,,,,2,2,1,3
C(CC(C)C(CC(C)O)O)=O,,,4,1,1,12,13
2471_0,,,,2,2,1,3
C(CC(C)CC(CCO)O)=O,,,4,1,2,10,12
2473_0,,,,2,2,1,3
C(CC(C)C(C)(CCO)O)=O,,,4,1,2,12,14
2475_0,,,,2,2,1,3
C(C(CO)C(C)CC=O)(O)=O,,,4,1,3,12,15
2477_0,,,,2,2,1,3
C(CC(C(C)CC=O)O)(O)=O,,,4,1,2,12,14
2479_0,,,,2,2,1,3
C(CC(C)C(C(CO)=O)O)=O,,,4,1,2,16,18
2481_0,,,,2,2,1,3
C(CC(C)CO)=O,,,4,1,2,89,91
2483_0,,,,2,2,1,3
C(C(CC(C)CO)=O)(O)=O,,,4,1,1,11,12
2485_0,,,,2,2,1,3
C(C(CCO)CC=O)(O)=O,,,4,1,2,13,15
2487_0,,,,2,2,1,3
C(C(C)(CO)CC=O)(O)=O,,,4,1,2,11,13
2489_0,,,,2,2,1,3
C(C(C)C(C=O)CO)(O)=O,,,4,1,2,13,15
2491_0,,,,2,2,1,3
C1(C(C)C(CO)C(C(O)=O)(O)O1)=O,,,4,1,2,7,9
2493_0,,,,2,2,1,3
C1(C(CC(C(O)=O)(O)O1)CCO)=O,,,4,1,2,7,9
2495_0,,,,2,2,1,3
C1(C(C)C(C(C(O1)=O)=O)CO)=O,,,4,1,3,7,10
2497_0,,,,2,2,1,3
C1(C(C)(CO)CC(C(O1)=O)=O)=O,,,4,1,2,5,7
2499_0,,,,2,2,1,3
C1(C(CCO)CC(C(O1)=O)=O)=O,,,4,1,3,7,10
2501_0,,,,2,2,1,3
C(C(C)C(C(C(O)=O)=O)CO)(O)=O,,,4,1,2,9,11
2503_0,,,,2,2,1,3
C(C(C)(CO)CC(C(O)=O)=O)(O)=O,,,4,1,1,7,8
2505_0,,,,2,2,1,3
C(C(CCO)CC(C(O)=O)=O)(O)=O,,,4,1,3,9,12
2507_0,,,,2,2,1,3
C(CC(C)CCO)=O,,,4,1,3,48,51
2509_0,,,,2,2,1,3
C(C(CC(C)CCO)=O)(O)=O,,,4,1,2,8,10
2511_0,,,,2,2,1,3
C(C(CCCO)CC=O)(O)=O,,,4,1,2,10,12
2513_0,,,,2,2,1,3
C(C(C)(CCO)CC=O)(O)=O,,,4,1,2,10,12
2515_0,,,,2,2,1,3
C(C(C)C(C=O)CCO)(O)=O,,,4,1,2,10,12
2517_0,,,,2,2,1,3
C1(C(C)C(C(C(O1)=O)=O)CCO)=O,,,4,1,2,7,9
2519_0,,,,2,2,1,3
C1(C(C)(CCO)CC(C(O1)=O)=O)=O,,,4,1,2,6,8
2521_0,,,,2,2,1,3
C1(C(CCCO)CC(C(O1)=O)=O)=O,,,4,1,2,5,7
2523_0,,,,2,2,1,3
C(CC(C)C(C)O)=O,,,4,1,2,49,51
2525_0,,,,2,2,1,3
C(C(CC(C)C(C)O)=O)(O)=O,,,4,1,1,9,10
2527_0,,,,2,2,1,3
C(C(CC(C)O)CC=O)(O)=O,,,4,1,1,11,12
2529_0,,,,2,2,1,3
C(C(C)(C(C)O)CC=O)(O)=O,,,4,1,1,9,10
2531_0,,,,2,2,1,3
C(C(C)C(C=O)C(C)O)(O)=O,,,4,1,1,11,12
2533_0,,,,2,2,1,3
C1(C(C)C(C(C(O1)=O)=O)C(C)O)=O,,,4,1,1,7,8
2535_0,,,,2,2,1,3
C1(C(C)(C(C)O)CC(C(O1)=O)=O)=O,,,4,1,1,5,6
2537_0,,,,2,2,1,3
C1(C(CC(C)O)CC(C(O1)=O)=O)=O,,,4,1,1,7,8
2539_0,,,,2,2,1,3
C(C(C(C)CC=O)C(C)O)(O)=O,,,4,1,2,11,13
2541_0,,,,2,2,1,3
C(CC(CC(C)CC=O)O)(O)=O,,,4,1,2,9,11
2543_0,,,,2,2,1,3
C(CC(C)(C(C)CC=O)O)(O)=O,,,4,1,2,11,13
2545_0,,,,2,2,1,3
C(CC(C)C(C(O)=O)C(O)=O)=O,,,4,1,2,9,11
2547_0,,,,2,2,1,3
C(CC(C)C(C(C(O)=O)=O)O)=O,,,4,1,2,10,12
2549_0,,,,2,2,1,3
C(CC(C)CC(O)=O)=O,,,4,1,5,21,26
2551_0,,,,2,2,1,3
C(CC(C)CC(C(O)=O)=O)(O)=O,,,4,1,3,8,11
2553_0,,,,2,2,1,3
C(CC(C(O)=O)CCC(O)=O)=O,,,4,1,2,9,11
2555_0,,,,2,2,1,3
C(CC(C(O)=O)(C)CC(O)=O)=O,,,4,1,3,10,13
2557_0,,,,2,2,1,3
C(C(CC(O)=O)C(C(O)=O)C)=O,,,4,1,2,9,11
2559_0,,,,2,2,1,3
C(CC(C)CC(C(C(O)=O)O)O)=O,,,4,1,2,12,14
2561_0,,,,2,2,1,3
C(CC(C)C(C)(C(C(O)=O)O)O)=O,,,4,1,1,13,14
2563_0,,,,2,2,1,3
C(C(C(C)O)(C(C)CC=O)O)(O)=O,,,4,1,2,11,13
2565_0,,,,2,2,1,3
C(C(C(O)=O)(C(C)CC=O)O)(O)=O,,,4,1,3,7,10
2567_0,,,,2,2,1,3
C(CC(C)CC(C(O)=O)O)=O,,,4,1,1,12,13
2569_0,,,,2,2,1,3
C(C(C)(C(C)CC=O)O)(O)=O,,,4,1,1,11,12
2571_0,,,,2,2,1,3
C(C(C=O)(CC(C)CC=O)O)(O)=O,,,4,1,1,10,11
2573_0,,,,2,2,1,3
C(C(C=O)(C(C)CC=O)O)(O)=O,,,4,1,2,12,14
2575_0,,,,2,2,1,3
C(CC(C)CC=CC=O)=O,,,4,1,4,25,29
2577_0,,,,2,2,1,3
C(CC(C)CC(C(O)=O)=O)=CC=O,,,4,1,1,5,6
2579_0,,,,2,2,1,3
C(CC(C(O)=O)CCC=CC=O)=O,,,4,1,1,7,8
2581_0,,,,2,2,1,3
C(CC(C(O)=O)(C)CC=CC=O)=O,,,4,1,1,6,7
2583_0,,,,2,2,1,3
C(C(CC=CC=O)C(C(O)=O)C)=O,,,4,1,1,6,7
2585_0,,,,2,2,1,3
C(C(C=C)C(C)CC=O)=O,,,4,1,4,23,27
2587_0,,,,2,2,1,3
C(CC(C)CC=CC(C(O)=O)=O)=O,,,4,1,1,5,6
2589_0,,,,2,2,1,3
C(CC(C)C(C=C)C(C(O)=O)=O)=O,,,4,1,1,7,8
2591_0,,,,2,2,1,3
C(C(C(C(O)=O)=C)C(C)CC=O)=O,,,4,1,1,10,11
2593_0,,,,2,2,1,3
C(CC(C)CC(C(O)=O)=CC=O)=O,,,4,1,1,8,9
2595_0,,,,2,2,1,3
C(CC(C)C(CO)(C(C)O)O)=O,,,4,1,2,12,14
2597_0,,,,2,2,1,3
C(CC(C)C(C(C(C)O)O)O)=O,,,4,1,1,14,15
2599_0,,,,2,2,1,3
C(CC(C)CC(C(CO)O)O)=O,,,4,1,2,12,14
2601_0,,,,2,2,1,3
C(CC(C)C(C)(C(CO)O)O)=O,,,4,1,2,13,15
2603_0,,,,2,2,1,3
C(CC(C)C1C(C(OC1C)=O)=O)=O,,,4,1,1,5,6
2605_0,,,,2,2,1,3
C(CC(C)CC1CC(C(O1)=O)=O)=O,,,4,1,1,6,7
2607_0,,,,2,2,1,3
C(CC(C)C1(C)CC(C(O1)=O)=O)=O,,,4,1,1,6,7
2609_0,,,,2,2,1,3
C(CC(C)C1C(OC(C1=O)=O)=O)=O,,,4,1,1,5,6
2611_0,,,,2,2,1,3
C(CC(C)C(C(C(O)=O)O)O)=O,,,4,1,4,15,19
2613_0,,,,2,2,1,3
C(C(CO)(C(C)CC=O)O)(O)=O,,,4,1,4,12,16
2615_0,,,,2,2,1,3
C(CC(C)CC=O)=O,,,4,1,11,40,51
2617_0,,,,2,2,1,3
C(C(C(C)CC=O)C(C)O)=O,,,4,1,7,16,23
2619_0,,,,2,2,1,3
C(CC(C)CC(CC=O)O)=O,,,4,1,6,18,24
2621_0,,,,2,2,1,3
C(CC(C)(C(C)CC=O)O)=O,,,4,1,4,19,23
2623_0,,,,2,2,1,3
C(C(C(O)=O)C(C)CC=O)=O,,,4,1,6,15,21
2625_0,,,,2,2,1,3
C(CC(C)C(C(C=O)=O)O)=O,,,4,1,4,16,20
2627_0,,,,2,2,1,3
C(CC(C)C(C(O)=O)O)=O,,,4,1,4,16,20
2629_0,,,,2,2,1,3
C(CC(C)C(CO)O)=O,,,4,1,3,24,27
2631_0,,,,2,2,1,3
C(CC(C)CC(C(O)=O)=O)=O,,,4,1,6,12,18
2633_0,,,,2,2,1,3
C(C(C=C)C(C)CC(C(O)=O)=O)=O,,,4,1,1,7,8
2635_0,,,,2,2,1,3
C(C(C=C)CC(C(O)=O)CC=O)=O,,,4,1,1,8,9
2637_0,,,,2,2,1,3
C(C(C=C)C(C(O)=O)(C)CC=O)=O,,,4,1,1,8,9
2639_0,,,,2,2,1,3
C(C(C=C)C(C=O)C(C(O)=O)C)=O,,,4,1,1,7,8
2640_0,,,,2,2,1,3
2642_0,,,,2,2,1,3
C(C(C(C)CC(C(O)=O)=O)O)(O)=O,,,4,1,1,9,10
2644_0,,,,2,2,1,3
C(C(CC(C)C(CO)O)=O)(O)=O,,,4,1,2,11,13
2646_0,,,,2,2,1,3
C(CCC(C(O)=O)CC=O)=O,,,4,1,3,15,18
2648_0,,,,2,2,1,3
C(C(CC(C(O)=O)CC=O)O)(O)=O,,,4,1,1,11,12
2650_0,,,,2,2,1,3
C(C(CC(CO)O)CC=O)(O)=O,,,4,1,2,13,15
2652_0,,,,2,2,1,3
C(CC(C(O)=O)(C)CC=O)=O,,,4,1,3,7,10
2654_0,,,,2,2,1,3
C(C(C)(C(C(O)=O)O)CC=O)(O)=O,,,4,1,1,8,9
2656_0,,,,2,2,1,3
C(C(C)(C(CO)O)CC=O)(O)=O,,,4,1,2,11,13
2658_0,,,,2,2,1,3
C(CC(C=O)C(C(O)=O)C)=O,,,4,1,3,12,15
2660_0,,,,2,2,1,3
C(C(C(C=O)C(C(O)=O)C)O)(O)=O,,,4,1,1,10,11
2662_0,,,,2,2,1,3
C(C(C)C(C=O)C(CO)O)(O)=O,,,4,1,2,13,15
2664_0,,,,2,2,1,3
C(CC1C(C(OC(C1C)=O)=O)=O)=O,,,4,1,1,4,5
2666_0,,,,2,2,1,3
C(CC1(C(OC(C(C1)=O)=O)=O)C)=O,,,4,1,1,5,6
2668_0,,,,2,2,1,3
C(CCC1C(OC(C(C1)=O)=O)=O)=O,,,4,1,1,6,7
2670_0,,,,2,1,2,3
C(C(C=CC(O)=O)=O)(O)=O,,,4,1,2,13,15
2672_0,,,,2,1,1,2
C1(C(C(CC(CC1O)O)O)O)=O,,,5,1,2,0,2
2672_1,,,,2,1,1,2
2674_0,,,,2,1,1,2
C(C1C(CC(C1(CO)O)O)O)=O,,,5,1,4,0,4
2674_1,,,,2,1,1,2
2676_0,,,,2,1,1,2
C(C1C(C(CO)(CC1O)O)O)=O,,,5,1,4,0,4
2676_1,,,,2,1,1,2
2677_0,,,,2,1,1,2
2677_1,,,,2,1,1,2
2679_0,,,,2,1,1,2
C(C1C(C(C(C(C1O)=O)O)O)O)=O,,,5,1,4,0,4
2679_1,,,,2,1,1,2
2681_0,,,,2,1,1,2
C(C(C1C(C(C(C1O)=O)O)O)O)=O,,,5,1,2,0,2
2681_1,,,,2,1,1,2
2683_0,,,,2,1,1,2
C1(C(C(C(CO)C1O)O)O)=O,,,5,1,2,0,2
2683_1,,,,2,1,1,2
2684_0,,,,2,1,1,2
2684_1,,,,2,1,1,2
2685_0,,,,2,1,1,2
2685_1,,,,2,1,1,2
2687_0,,,,2,1,1,2
C1(C(CC(C1C(CCO)O)O)=O)=O,,,5,1,5,0,5
2688_0,,,,2,1,1,2
2688_1,,,,2,1,1,2
2690_0,,,,2,1,1,2
C(C(CO)C1(C(CC(C1)O)=O)O)=O,,,5,1,3,0,3
2692_0,,,,2,1,1,2
C1(C(C(C(C1)O)CO)(CC=O)O)=O,,,5,1,1,0,1
2694_0,,,,2,1,1,2
C(C1C(C(C)(C(CO)C1O)O)=O)=O,,,5,1,2,0,2
2694_1,,,,2,1,1,2
2696_0,,,,2,1,1,2
C1(C(CC(C(CO)C(C1)O)O)=O)=O,,,5,1,1,0,1
2698_0,,,,2,1,1,2
C(CC1(C(CC(C1C=C)O)=O)O)=O,,,5,1,1,0,1
2700_0,,,,2,1,1,2
C(C(C=C)C1(C(CC(C1)O)=O)O)=O,,,5,1,2,0,2
2702_0,,,,2,1,1,2
C1(C(CC(C1)O)(CC=O)O)=O,,,5,1,2,0,2
2704_0,,,,2,1,1,2
C(C1C(C(C)(C(C=C)C1O)O)=O)=O,,,5,1,2,0,2
2704_1,,,,2,1,1,2
2706_0,,,,2,1,1,2
C(C1C(C(C)(CC1O)O)=O)=O,,,5,1,2,0,2
2706_1,,,,2,1,1,2
2708_0,,,,2,1,1,2
C(C1C(CC(C1(C)O)=O)O)=O,,,5,1,4,0,4
2708_1,,,,2,1,1,2
2710_0,,,,2,1,1,2
C(C1C(CC(C(CC1O)=O)=O)O)=C,,,5,1,1,0,1
2712_0,,,,2,1,1,2
C1(C(CC(CC(C1)O)O)=O)=O,,,5,1,1,0,1
2713_0,,,,2,1,1,2
2713_1,,,,2,1,1,2
2715_0,,,,2,1,1,2
C(C1C(C(CC(C1O)O)=O)=O)=O,,,5,1,3,0,3
2717_0,,,,2,1,1,2
C(C(C1C(C(CC1O)=O)=O)O)=O,,,5,1,5,0,5
2719_0,,,,2,1,1,2
C(C)=CC(C1C(C(CC1O)=O)=O)O,,,5,1,5,0,5
2721_0,,,,2,1,1,2
C=CCC(C1C(C(CC1O)=O)=O)O,,,5,1,5,0,5
2723_0,,,,2,1,1,2
C1(C(CC(C1C(C)O)O)=O)=O,,,5,1,5,0,5
2725_0,,,,2,1,1,2
C(C1C(C(CC1O)=O)=O)(O)=O,,,5,1,5,0,5
2727_0,,,,2,1,1,2
C1(C(CC(C1CO)O)=O)=O,,,5,1,5,0,5
2728_0,,,,2,1,1,2
2728_1,,,,2,1,1,2
2729_0,,,,2,1,1,2
2729_1,,,,2,1,1,2
2730_0,,,,2,1,1,2
2730_1,,,,2,1,1,2
2731_0,,,,2,1,1,2
2731_1,,,,2,1,1,2
2732_0,,,,2,1,1,2
2732_1,,,,2,1,1,2
2733_0,,,,2,1,1,2
2733_1,,,,2,1,1,2
2734_0,,,,2,1,1,2
2734_1,,,,2,1,1,2
2736_0,,,,2,1,1,2
C1(C(C(CC1(C(C)O)O)O)O)=O,,,5,1,3,0,3
2736_1,,,,2,1,1,2
2738_0,,,,2,1,1,2
C(C1(C(C(C(C1)O)O)=O)O)(O)=O,,,5,1,4,0,4
2738_1,,,,2,1,1,2
2740_0,,,,2,1,1,2
C1(C(C(C(C1O)O)O)O)=O,,,5,1,2,0,2
2740_1,,,,2,1,1,2
2742_0,,,,2,1,1,2
C1(C(CCO)(CC(C(O1)=O)=O)O)=O,,,5,1,1,0,1
2743_0,,,,2,1,1,2
2743_1,,,,2,1,1,2
2745_0,,,,2,1,1,2
C1(C(C(C(C(C1O)O)O)O)O)=O,,,5,1,2,0,2
2745_1,,,,2,1,1,2
2747_0,,,,2,1,1,2
C1(C(C(C(CO)(C1O)O)O)O)=O,,,5,1,5,0,5
2747_1,,,,2,1,1,2
2748_0,,,,2,1,1,2
2748_1,,,,2,1,1,2
2750_0,,,,2,1,1,2
C(C1(C(C(C(C1O)=O)O)O)O)(O)=O,,,5,1,7,0,7
2750_1,,,,2,1,1,2
2752_0,,,,2,1,1,2
C1(C(C(C=C)C(C1O)O)O)=O,,,5,1,3,0,3
2752_1,,,,2,1,1,2
2754_0,,,,2,1,1,2
C1(C2(C(CO)C(C(C2)=O)(O)O1)O)=O,,,5,1,3,0,3
2756_0,,,,2,1,1,2
C1(C2(CC(C(O2)=O)(C1CO)O)O)=O,,,5,1,6,0,6
2756_1,,,,2,1,1,2
2758_0,,,,2,1,1,2
C1(C(CC(C(C1O)=O)=O)O)=O,,,5,1,2,0,2
2760_0,,,,2,1,1,2
C(C1(CC(C(C1O)=O)=O)O)=O,,,5,1,4,0,4
2762_0,,,,2,1,1,2
C1(C(C(C(C1(C)O)O)=O)=O)=O,,,5,1,2,0,2
2762_1,,,,2,1,1,2
2764_0,,,,2,1,1,2
C1(C(C(CC1(CO)O)=O)=O)=O,,,5,1,1,0,1
2766_0,,,,2,1,1,2
C1(C(CO)(C(C(C1O)=O)O)O)=O,,,5,1,4,0,4
2766_1,,,,2,1,1,2
2768_0,,,,2,1,1,2
C1(C(C(C(CO)(C1O)O)O)=O)=O,,,5,1,2,0,2
2768_1,,,,2,1,1,2
2770_0,,,,2,1,1,2
C1(C(C(C(C1(CO)O)O)O)=O)=O,,,5,1,2,0,2
2770_1,,,,2,1,1,2
2772_0,,,,2,1,1,2
C1(C(C(C(C1O)=O)O)O)=O,,,5,1,2,0,2
2772_1,,,,2,1,1,2
2774_0,,,,2,1,1,2
C1(C(C(C(C(C1O)=O)O)O)O)=O,,,5,1,3,0,3
2774_1,,,,2,1,1,2
2776_0,,,,2,1,1,2
C(C1C(C(C=O)C(C1O)O)O)(O)=O,,,5,1,3,0,3
2776_1,,,,2,1,1,2
2778_0,,,,2,1,1,2
C(C1(C(CC(C1O)O)=O)CO)(O)=O,,,5,1,2,0,2
2779_0,,,,2,1,1,2
2779_1,,,,2,1,1,2
2780_0,,,,2,1,1,2
2780_1,,,,2,1,1,2
2782_0,,,,2,1,1,2
C1(C(C(C(C1O)O)O)(CC=O)O)=O,,,5,1,3,0,3
2782_1,,,,2,1,1,2
2784_0,,,,2,1,1,2
C1(C(CC(C1O)O)(C(C=O)O)O)=O,,,5,1,3,0,3
2784_1,,,,2,1,1,2
2786_0,,,,2,1,1,2
C1(C(C(CC1(CO)O)O)O)=O,,,5,1,3,0,3
2786_1,,,,2,1,1,2
2788_0,,,,2,1,1,2
C1(C(CC(C1)O)(C(C(O)=O)O)O)=O,,,5,1,2,0,2
2790_0,,,,2,1,1,2
C1(C(C(C(C(C1(C)O)O)O)O)=O)=O,,,5,1,3,0,3
2790_1,,,,2,1,1,2
2792_0,,,,2,1,1,2
C1(C(C(C)O)C(C(C1)=O)O)=O,,,5,1,3,0,3
2792_1,,,,2,1,1,2
2794_0,,,,2,1,1,2
C(C1C(CC(C1O)=O)=O)(O)=O,,,5,1,3,0,3
2794_1,,,,2,1,1,2
2796_0,,,,2,1,1,2
C1(C(C(C(C(C1)=O)=O)O)O)=O,,,5,1,7,0,7
2796_1,,,,2,1,1,2
2798_0,,,,2,1,1,2
C(C1(C(CC(C1O)=O)=O)O)=O,,,5,1,3,0,3
2798_1,,,,2,1,1,2
2799_0,,,,2,1,1,2
2799_1,,,,2,1,1,2
2800_0,,,,2,1,1,2
2800_1,,,,2,1,1,2
2802_0,,,,2,1,1,2
C1(CC(C(C1)=O)O)=O,,,5,1,2,0,2
2804_0,,,,2,1,1,2
C(C1(C(CC(C1)=O)=O)O)(O)=O,,,5,1,2,0,2
2806_0,,,,2,1,1,2
C1(C(C(C(C=1)=O)O)O)C(C)O,,,5,1,3,0,3
2806_1,,,,2,1,1,2
2808_0,,,,2,1,1,2
C1(C(C(C(C1O)=CC)O)O)=O,,,5,1,3,0,3
2808_1,,,,2,1,1,2
2810_0,,,,2,1,1,2
C(C1C(C(C(C=1)=O)O)O)(O)=O,,,5,1,5,0,5
2810_1,,,,2,1,1,2
2812_0,,,,2,1,1,2
C(C1(C(C(C(C1)=O)=O)=C)O)(O)=O,,,5,1,2,0,2
2814_0,,,,2,1,1,2
C1C(C(C(C=1)=O)O)O,,,5,1,3,0,3
2814_1,,,,2,1,1,2
2816_0,,,,2,1,1,2
C(C1(C=CC(C1O)=O)O)(O)=O,,,5,1,3,0,3
2816_1,,,,2,1,1,2
2818_0,,,,2,1,1,2
C1(C(C(C(C1)O)O)O)=O,,,5,1,3,0,3
2820_0,,,,2,1,1,2
C1(C2(CC(C(O)=O)(C1CO2)O)O)=O,,,5,1,4,0,4
2820_1,,,,2,1,1,2
2822_0,,,,2,1,1,2
C1(C2C(C(C(O2)O)(C1O)O)O)=O,,,5,1,4,0,4
2822_1,,,,2,1,1,2
2824_0,,,,2,1,1,2
C1(C2(CC(C(C2CO1)=O)=O)O)=O,,,5,1,2,0,2
2826_0,,,,2,1,1,2
C1(C2(CC(C(C2O)=O)O1)O)=O,,,5,1,4,0,4
2826_1,,,,2,1,1,2
2828_0,,,,2,1,1,2
C1(C2(C(C(C(C2)=O)O1)O)O)=O,,,5,1,3,0,3
2830_0,,,,2,1,1,2
C1(C2C(C(C(C2O)=O)O1)O)=O,,,5,1,5,0,5
2830_1,,,,2,1,1,2
2832_0,,,,2,1,1,2
C(C1C(C(C(C)O)C(C1C)O)O)=O,,,5,1,1,0,1
2834_0,,,,2,1,1,2
C(C1C(C(CO)C(CC1C)O)O)=O,,,5,1,1,0,1
2836_0,,,,2,1,1,2
C(C1C(C(CO)C(C)(C1C)O)O)=O,,,5,1,1,0,1
2838_0,,,,2,1,1,2
C(C1C(C(C=O)C(C)C1O)O)(O)=O,,,5,1,1,0,1
2840_0,,,,2,1,1,2
C(C1C(C(C(C(C1O)=O)O)O)C)=O,,,5,1,1,0,1
2842_0,,,,2,1,1,2
C(C1C(C)C(C(C1(C=O)O)O)O)=O,,,5,1,1,0,1
2844_0,,,,2,1,1,2
C(C1C(C)C(C(C1O)=O)(CO)O)=O,,,5,1,1,0,1
2846_0,,,,2,1,1,2
C(C1CC(CO)C(C1C=O)O)(O)=O,,,5,1,2,0,2
2848_0,,,,2,1,1,2
C(C1C(C(C)CC1O)O)=O,,,5,1,2,0,2
2848_1,,,,2,1,1,2
2850_0,,,,2,1,1,2
C(C1C(CC(C1C)O)O)=O,,,5,1,1,0,1
2852_0,,,,2,1,1,2
C(C1C(C(C)CC1(C(O)=O)O)O)=O,,,5,1,2,0,2
2852_1,,,,2,1,1,2
2854_0,,,,2,1,1,2
C(C(C1C(CC(C1C)O)O)=O)(O)=O,,,5,1,1,0,1
2856_0,,,,2,1,1,2
C(C1CC(C(C=O)C(C1)O)O)(O)=O,,,5,1,3,0,3
2856_1,,,,2,1,1,2
2858_0,,,,2,1,1,2
C(C1CC(CC(C1C=O)O)O)(O)=O,,,5,1,2,0,2
2860_0,,,,2,1,1,2
C(C1(C)C(C(C=O)C(C1)O)O)(O)=O,,,5,1,2,0,2
2860_1,,,,2,1,1,2
2862_0,,,,2,1,1,2
C(C1(C)C(CC(C1C=O)O)O)(O)=O,,,5,1,1,0,1
2864_0,,,,2,1,1,2
C(C(C1C(C(C)CC1O)O)=O)(O)=O,,,5,1,2,0,2
2864_1,,,,2,1,1,2
2866_0,,,,2,1,1,2
C(C1C(C)C(CC1(C(O)=O)O)O)=O,,,5,1,1,0,1
2868_0,,,,2,1,1,2
C(C1C(C(CC(C)CC1O)=O)=O)=O,,,5,1,2,0,2
2868_1,,,,2,1,1,2
2870_0,,,,2,1,1,2
C(CC1(C(CC(C)C1C=O)=O)O)=O,,,5,1,1,0,1
2872_0,,,,2,1,1,2
C(C1C(CC(C(CC1C)=O)=O)O)=O,,,5,1,1,0,1
2874_0,,,,2,1,1,2
C(CC(C)C1C(C(CC1O)=O)=O)=O,,,5,1,3,0,3
2876_0,,,,2,1,1,2
C(C1C(C(CC(CC1C)O)=O)=O)=O,,,5,1,1,0,1
2878_0,,,,2,1,1,2
C(C1C(C)C(C=O)C(C1(C)O)=O)=O,,,5,1,1,0,1
2879_0,,,,2,1,1,2
2881_0,,,,2,1,1,2
C1(C(C(C)CC(C1O)O)O)=O,,,5,1,2,0,2
2881_1,,,,2,1,1,2
2883_0,,,,2,1,1,2
C(C1C(C(C(O)=O)(CC1C)O)O)=O,,,5,1,1,0,1
2885_0,,,,2,1,1,2
C(C1C(C)CC=CC1O)=O,,,5,1,1,0,1
2887_0,,,,2,1,1,2
C1CC(C)C(C(C(O)=O)=O)C(C=1)O,,,5,1,1,0,1
2889_0,,,,2,1,1,2
C(C1CCC=CC(C1C=O)O)(O)=O,,,5,1,2,0,2
2891_0,,,,2,1,1,2
C(C1(C)C(C=O)C(C=CC1)O)(O)=O,,,5,1,1,0,1
2893_0,,,,2,1,1,2
C(C1(C=CCC(C)C1C=O)O)(O)=O,,,5,1,1,0,1
2895_0,,,,2,1,1,2
C(C1C(C)CC(C(O)=O)=CC1O)=O,,,5,1,1,0,1
2897_0,,,,2,1,1,2
C(C1C(C)CC2CC1(C(O2)=O)O)=O,,,5,1,1,0,1
2899_0,,,,2,1,1,2
C1(C(C2C(CC(C)CC2O)O1)=O)=O,,,5,1,2,0,2
2899_1,,,,2,1,1,2
2901_0,,,,2,1,1,2
C(C1C(C)C2(C)CC1(C(O2)=O)O)=O,,,5,1,1,0,1
2903_0,,,,2,1,1,2
C1(C(C2C(CC(C)C2(C)O1)O)=O)=O,,,5,1,2,0,2
2903_1,,,,2,1,1,2
2905_0,,,,2,1,1,2
C(C1C(CC(CC1C)O)O)=O,,,5,1,2,0,2
2907_0,,,,2,1,1,2
C(C1C(CC(C)CC1O)O)=O,,,5,1,2,0,2
2907_1,,,,2,1,1,2
2909_0,,,,2,1,1,2
C(C1C(CC(C)(C1C)O)O)=O,,,5,1,2,0,2
2911_0,,,,2,1,1,2
C(C1C(CC(C)C1(C)O)O)=O,,,5,1,2,0,2
2911_1,,,,2,1,1,2
2913_0,,,,2,1,1,2
C(C1C(C)C(C(C1O)=O)O)=O,,,5,1,2,0,2
2915_0,,,,2,1,1,2
C(C1CC(C=C)C(C1C=O)O)(O)=O,,,5,1,2,0,2
2917_0,,,,2,1,1,2
C(C1CCC(C1C=O)O)(O)=O,,,5,1,2,0,2
2919_0,,,,2,1,1,2
C(C1CC(C=O)C(C1)O)(O)=O,,,5,1,2,0,2
2921_0,,,,2,1,1,2
C1(C2CCC(C2C(C(O1)=O)=O)O)=O,,,5,1,2,0,2
2923_0,,,,2,1,1,2
C1(C2CC(C=O)C(C(O1)=O)(C2)O)=O,,,5,1,2,0,2
2925_0,,,,2,2,1,3
C(C(C1(C(C(CC1O)O)O)O)O)=O,,,5,1,2,0,2
2925_1,,,,2,2,1,3
2927_0,,,,2,2,1,3
C(CC1(C(C(CC1O)O)O)O)=O,,,5,1,1,0,1
2929_0,,,,2,2,1,3
C1(C(CC(C1)O)(CC(C=O)=O)O)=O,,,5,1,1,0,1
2931_0,,,,2,2,1,3
C1(C(CC(C1)O)(C(C=O)O)O)=O,,,5,1,2,0,2
2931_1,,,,2,2,1,3
2933_0,,,,2,2,1,3
C1(C(CC(C1)O)(CC(CO)=O)O)=O,,,5,1,1,0,1
2935_0,,,,2,2,1,3
C1(C(CC(C1)O)(C(C(C)=O)O)O)=O,,,5,1,2,0,2
2935_1,,,,2,2,1,3
2936_0,,,,2,2,1,3
2937_0,,,,2,2,1,3
2937_1,,,,2,2,1,3
2938_0,,,,2,2,1,3
2940_0,,,,2,2,1,3
C(C(C1C(C(CC1O)=O)=O)O)(C)=O,,,5,1,2,0,2
2940_1,,,,2,2,1,3
2942_0,,,,2,2,1,3
C(C(C)(C1C(C(CC1O)=O)=O)O)=O,,,5,1,2,0,2
2942_1,,,,2,2,1,3
2944_0,,,,2,2,1,3
C1(C(CC(C1C(CO)O)O)=O)=O,,,5,1,2,0,2
2944_1,,,,2,2,1,3
2946_0,,,,2,2,1,3
C1(C(CC(C1C(C(C)O)O)O)=O)=O,,,5,1,2,0,2
2946_1,,,,2,2,1,3
2948_0,,,,2,2,1,3
C(C(C1C(C(CC1O)=O)=O)O)(O)=O,,,5,1,2,0,2
2948_1,,,,2,2,1,3
2950_0,,,,2,2,1,3
C1(C(CC(C1C(C)(CO)O)O)=O)=O,,,5,1,2,0,2
2950_1,,,,2,2,1,3
2952_0,,,,2,2,1,3
C=CC(C1C(C(CC1O)=O)=O)O,,,5,1,2,0,2
2952_1,,,,2,2,1,3
2953_0,,,,2,2,1,3
2953_1,,,,2,2,1,3
2954_0,,,,2,2,1,3
2954_1,,,,2,2,1,3
2955_0,,,,2,2,1,3
2955_1,,,,2,2,1,3
2956_0,,,,2,2,1,3
2956_1,,,,2,2,1,3
2957_0,,,,2,2,1,3
2957_1,,,,2,2,1,3
2958_0,,,,2,2,1,3
2958_1,,,,2,2,1,3
2959_0,,,,2,2,1,3
2959_1,,,,2,2,1,3
2960_0,,,,2,2,1,3
2960_1,,,,2,2,1,3
2961_0,,,,2,2,1,3
2961_1,,,,2,2,1,3
2962_0,,,,2,2,1,3
2962_1,,,,2,2,1,3
2963_0,,,,2,2,1,3
2963_1,,,,2,2,1,3
2964_0,,,,2,2,1,3
2964_1,,,,2,2,1,3
2965_0,,,,2,2,1,3
2965_1,,,,2,2,1,3
2967_0,,,,2,2,1,3
C(CC(C(CO)C(CCO)O)O)=O,,,5,1,1,0,1
2969_0,,,,2,2,1,3
C(C(C(CCO)O)O)(C(CO)O)=O,,,5,1,4,0,4
2969_1,,,,2,2,1,3
2971_0,,,,2,2,1,3
C(CC(C(C=C)C(CCO)O)O)=O,,,5,1,1,0,1
2973_0,,,,2,2,1,3
C(C(CC(CC(CCO)O)O)=O)=O,,,5,1,1,0,1
2975_0,,,,2,2,1,3
C(C(C(CC(CCO)O)O)O)=O,,,5,1,2,0,2
2975_1,,,,2,2,1,3
2977_0,,,,2,2,1,3
C(CO)(CC(CC(CCO)O)O)=O,,,5,1,1,0,1
2979_0,,,,2,2,1,3
C(C)(C(C(CC(CCO)O)O)O)=O,,,5,1,2,0,2
2979_1,,,,2,2,1,3
2981_0,,,,2,2,1,3
C(CC(CC(CCO)O)O)=O,,,5,1,1,0,1
2983_0,,,,2,2,1,3
C(C(CO)C(CC(CCO)O)O)=O,,,5,1,2,0,2
2983_1,,,,2,2,1,3
2985_0,,,,2,2,1,3
C(C(C=C)C(CC(CCO)O)O)=O,,,5,1,1,0,1
2987_0,,,,2,2,1,3
C(C(C(CCO)O)C(C(C)=O)O)=O,,,5,1,2,0,2
2987_1,,,,2,2,1,3
2989_0,,,,2,2,1,3
C(C(C(CCO)O)C(C=O)(C)O)=O,,,5,1,2,0,2
2989_1,,,,2,2,1,3
2991_0,,,,2,2,1,3
C(C(C(CO)O)C(CCO)O)=O,,,5,1,2,0,2
2991_1,,,,2,2,1,3
2993_0,,,,2,2,1,3
C(C(C(C(C)O)O)C(CCO)O)=O,,,5,1,2,0,2
2993_1,,,,2,2,1,3
2995_0,,,,2,2,1,3
C(C(C(CCO)O)C(C(O)=O)O)=O,,,5,1,2,0,2
2995_1,,,,2,2,1,3
2997_0,,,,2,2,1,3
C(C(C(CCO)O)C(C)(CO)O)=O,,,5,1,2,0,2
2997_1,,,,2,2,1,3
2999_0,,,,2,2,1,3
C(C(C(CCO)O)C(C=C)O)=O,,,5,1,2,0,2
2999_1,,,,2,2,1,3
3000_0,,,,2,2,1,3
3000_1,,,,2,2,1,3
3001_0,,,,2,2,1,3
3001_1,,,,2,2,1,3
3002_0,,,,2,2,1,3
3002_1,,,,2,2,1,3
3004_0,,,,2,2,1,3
C(C(C(CCO)O)C(CCO)O)=O,,,5,1,2,0,2
3004_1,,,,2,2,1,3
3006_0,,,,2,2,1,3
C(C(C(CCO)O)C(C=O)O)=O,,,5,1,4,0,4
3006_1,,,,2,2,1,3
3008_0,,,,2,2,1,3
C(C(C(CCO)O)C(C=CC)O)=O,,,5,1,4,0,4
3008_1,,,,2,2,1,3
3010_0,,,,2,2,1,3
C(C(C(CC=C)O)C(CCO)O)=O,,,5,1,4,0,4
3010_1,,,,2,2,1,3
3011_0,,,,2,2,1,3
3011_1,,,,2,2,1,3
3013_0,,,,2,2,1,3
C(C(CO)C(C(C(C=O)O)O)O)=O,,,5,1,2,0,2
3013_1,,,,2,2,1,3
3015_0,,,,2,2,1,3
C(C(CO)C(C(CC=O)O)O)=O,,,5,1,3,0,3
3017_0,,,,2,2,1,3
C(C(C(C(CO)C(C=O)O)O)O)=O,,,5,1,2,0,2
3017_1,,,,2,2,1,3
3019_0,,,,2,2,1,3
C(CC(C(CO)C(C=O)O)O)=O,,,5,1,1,0,1
3021_0,,,,2,2,1,3
C(CC(C(CO)C(C=CC)O)O)=O,,,5,1,1,0,1
3023_0,,,,2,2,1,3
C(CC(C(CO)C(CC=C)O)O)=O,,,5,1,1,0,1
3025_0,,,,2,2,1,3
C(C(CC(C(CO)CO)O)=O)=O,,,5,1,1,0,1
3027_0,,,,2,2,1,3
C(C(C(C(CO)CO)O)O)=O,,,5,1,3,0,3
3027_1,,,,2,2,1,3
3029_0,,,,2,2,1,3
C(CC(C(CO)CO)O)(CCO)=O,,,5,1,1,0,1
3031_0,,,,2,2,1,3
C(C)(C(CO)C(C(CO)CO)O)=O,,,5,1,2,0,2
3031_1,,,,2,2,1,3
3033_0,,,,2,2,1,3
C(CO)(CC(C(CO)CO)O)=O,,,5,1,1,0,1
3035_0,,,,2,2,1,3
C(C)(C(C(C(CO)CO)O)O)=O,,,5,1,2,0,2
3035_1,,,,2,2,1,3
3037_0,,,,2,2,1,3
C(C(C)O)(CC(C(CO)CO)O)=O,,,5,1,1,0,1
3039_0,,,,2,2,1,3
C(C(C(C(CO)CO)O)O)(CC)=O,,,5,1,2,0,2
3039_1,,,,2,2,1,3
3041_0,,,,2,2,1,3
C(CO)(C(C)C(C(CO)CO)O)=O,,,5,1,1,0,1
3043_0,,,,2,2,1,3
C(C(CCO)C(C(CO)CO)O)=O,,,5,1,1,0,1
3045_0,,,,2,2,1,3
C(CC(C(CO)CO)O)=O,,,5,1,1,0,1
3047_0,,,,2,2,1,3
C(C(C(C)O)C(C(CO)CO)O)=O,,,5,1,2,0,2
3047_1,,,,2,2,1,3
3049_0,,,,2,2,1,3
C(C(C=O)C(C(CO)CO)O)(O)=O,,,5,1,2,0,2
3049_1,,,,2,2,1,3
3051_0,,,,2,2,1,3
C(C(C(C(C(CO)CO)O)O)=O)=O,,,5,1,2,0,2
3051_1,,,,2,2,1,3
3053_0,,,,2,2,1,3
C(C(CO)C(C(CO)CO)O)=O,,,5,1,2,0,2
3053_1,,,,2,2,1,3
3055_0,,,,2,2,1,3
C(CO)(C(C(C(CO)CO)O)O)=O,,,5,1,2,0,2
3055_1,,,,2,2,1,3
3057_0,,,,2,2,1,3
C(C(C=C)C(C(CO)CO)O)=O,,,5,1,1,0,1
3059_0,,,,2,2,1,3
C(C(CC(C(CO)CO)O)=O)(O)=O,,,5,1,1,0,1
3060_0,,,,2,2,1,3
3060_1,,,,2,2,1,3
3062_0,,,,2,2,1,3
C(C(C(CO)CO)(CC=O)O)(O)=O,,,5,1,1,0,1
3063_0,,,,2,2,1,3
3063_1,,,,2,2,1,3
3065_0,,,,2,2,1,3
C(CC(C(CCO)=O)(CC=O)O)=O,,,5,1,2,0,2
3066_0,,,,2,2,1,3
3066_1,,,,2,2,1,3
3068_0,,,,2,2,1,3
C(C(C)(CC=O)O)(C(C=O)CO)=O,,,5,1,3,0,3
3068_1,,,,2,2,1,3
3069_0,,,,2,2,1,3
3069_1,,,,2,2,1,3
3071_0,,,,2,2,1,3
C(CC(C(C(C(C)=O)=O)CO)O)=O,,,5,1,3,0,3
3071_1,,,,2,2,1,3
3073_0,,,,2,2,1,3
C(CC(CC(C(CCO)=O)=O)O)=O,,,5,1,2,0,2
3075_0,,,,2,2,1,3
C(C(C(C(CCO)=O)=O)C(C)O)=O,,,5,1,3,0,3
3077_0,,,,2,2,1,3
C(C(C=O)C(C(CCO)=O)=O)(O)=O,,,5,1,3,0,3
3078_0,,,,2,2,1,3
3079_0,,,,2,2,1,3
3080_0,,,,2,2,1,3
3082_0,,,,2,2,1,3
C(C(C(C(CC(C)O)=O)=O)CO)=O,,,5,1,3,0,3
3084_0,,,,2,2,1,3
C(C(C(C(CC(O)=O)=O)=O)CO)=O,,,5,1,3,0,3
3086_0,,,,2,2,1,3
C(C(C(C(CCO)=O)=O)CO)=O,,,5,1,4,0,4
3087_0,,,,2,2,1,3
3087_1,,,,2,2,1,3
3089_0,,,,2,2,1,3
C(CC(C(C(CO)C(C)O)=O)=O)=O,,,5,1,4,0,4
3089_1,,,,2,2,1,3
3090_0,,,,2,2,1,3
3090_1,,,,2,2,1,3
3092_0,,,,2,2,1,3
C(C(C(C(CC=O)=O)=O)CO)(O)=O,,,5,1,4,0,4
3092_1,,,,2,2,1,3
3093_0,,,,2,2,1,3
3095_0,,,,2,2,1,3
C(C(CCO)(CC=O)O)(CC=O)=O,,,5,1,1,0,1
3096_0,,,,2,2,1,3
3097_0,,,,2,2,1,3
3097_1,,,,2,2,1,3
3098_0,,,,2,2,1,3
3098_1,,,,2,2,1,3
3099_0,,,,2,2,1,3
3099_1,,,,2,2,1,3
3100_0,,,,2,2,1,3
3100_1,,,,2,2,1,3
3101_0,,,,2,2,1,3
3101_1,,,,2,2,1,3
3103_0,,,,2,2,1,3
C(CC(C(C(CO)CO)=O)=O)=O,,,5,1,2,0,2
3103_1,,,,2,2,1,3
3105_0,,,,2,2,1,3
C(CC(CO)(C(C(C=O)O)O)O)=O,,,5,1,3,0,3
3107_0,,,,2,2,1,3
C(CC(C(C(C(CO)=O)O)O)O)=O,,,5,1,3,0,3
3109_0,,,,2,2,1,3
C(C(C(C=O)O)O)(C(C(C)O)O)=O,,,5,1,6,0,6
3109_1,,,,2,2,1,3
3111_0,,,,2,2,1,3
C(C(C(C(C(C=O)O)O)=O)O)(O)=O,,,5,1,7,0,7
3111_1,,,,2,2,1,3
3113_0,,,,2,2,1,3
C(C(C(C=O)O)O)(C(CO)O)=O,,,5,1,7,0,7
3113_1,,,,2,2,1,3
3115_0,,,,2,2,1,3
C(C(C(C(C=C)C(C=O)O)O)O)=O,,,5,1,2,0,2
3115_1,,,,2,2,1,3
3117_0,,,,2,2,1,3
C(CC(C(C=C)C(C=O)O)O)=O,,,5,1,1,0,1
3119_0,,,,2,2,1,3
C(C(C=C)C(C(C=C)C(C=O)O)O)=O,,,5,1,1,0,1
3121_0,,,,2,2,1,3
C(C(C=C)C(C(C(C=O)O)O)O)=O,,,5,1,2,0,2
3121_1,,,,2,2,1,3
3123_0,,,,2,2,1,3
C(C(C=C)C(C(CC=O)O)O)=O,,,5,1,2,0,2
3125_0,,,,2,2,1,3
C(C(C=C)C(C(C(C=O)C=C)O)O)=O,,,5,1,1,0,1
3127_0,,,,2,2,1,3
C(C(CC(CC(C=O)=O)O)O)=O,,,5,1,1,0,1
3129_0,,,,2,2,1,3
C(C(C(CC(C=O)O)O)O)=O,,,5,1,2,0,2
3129_1,,,,2,2,1,3
3131_0,,,,2,2,1,3
C(CC(CC(C=O)O)O)(CCO)=O,,,5,1,1,0,1
3133_0,,,,2,2,1,3
C(C(CC(C(C(C)=O)CO)O)O)=O,,,5,1,2,0,2
3133_1,,,,2,2,1,3
3135_0,,,,2,2,1,3
C(C(CC(CC(CO)=O)O)O)=O,,,5,1,1,0,1
3137_0,,,,2,2,1,3
C(C(CC(C(C(C)=O)O)O)O)=O,,,5,1,2,0,2
3137_1,,,,2,2,1,3
3139_0,,,,2,2,1,3
C(C(C)O)(CC(CC(C=O)O)O)=O,,,5,1,1,0,1
3141_0,,,,2,2,1,3
C(C(C(CC(C=O)O)O)O)(CC)=O,,,5,1,2,0,2
3141_1,,,,2,2,1,3
3143_0,,,,2,2,1,3
C(C(CC(C(C(CO)=O)C)O)O)=O,,,5,1,1,0,1
3145_0,,,,2,2,1,3
C(C(C(CC(C=O)O)O)CCO)=O,,,5,1,1,0,1
3147_0,,,,2,2,1,3
C(CC(CC(C=O)O)O)=O,,,5,1,3,0,3
3149_0,,,,2,2,1,3
C(C(C(C)O)C(CC(C=O)O)O)=O,,,5,1,2,0,2
3149_1,,,,2,2,1,3
3151_0,,,,2,2,1,3
C(C(C=O)C(CC(C=O)O)O)(O)=O,,,5,1,2,0,2
3151_1,,,,2,2,1,3
3153_0,,,,2,2,1,3
C(C(CC(C(C(C=O)=O)O)O)O)=O,,,5,1,2,0,2
3153_1,,,,2,2,1,3
3155_0,,,,2,2,1,3
C(C(CO)C(CC(C=O)O)O)=O,,,5,1,2,0,2
3155_1,,,,2,2,1,3
3157_0,,,,2,2,1,3
C(C(CC(C(C(CO)=O)O)O)O)=O,,,5,1,2,0,2
3157_1,,,,2,2,1,3
3159_0,,,,2,2,1,3
C(C(C=C)C(CC(C=O)O)O)=O,,,5,1,1,0,1
3161_0,,,,2,2,1,3
C(C(CC(CC(C(O)=O)=O)O)O)=O,,,5,1,1,0,1
3163_0,,,,2,2,1,3
C(CC(C(CC(C=O)=O)O)O)=O,,,5,1,1,0,1
3165_0,,,,2,2,1,3
C(CC(C(C(C=O)O)O)O)=O,,,5,1,2,0,2
3165_1,,,,2,2,1,3
3167_0,,,,2,2,1,3
C(CC(C(CC(CCO)=O)O)O)=O,,,5,1,1,0,1
3169_0,,,,2,2,1,3
C(CC(C(C(C(C)=O)CO)O)O)=O,,,5,1,2,0,2
3169_1,,,,2,2,1,3
3171_0,,,,2,2,1,3
C(CC(C(CC(CO)=O)O)O)=O,,,5,1,1,0,1
3173_0,,,,2,2,1,3
C(CC(C(C(C(C)=O)O)O)O)=O,,,5,1,4,0,4
3173_1,,,,2,2,1,3
3175_0,,,,2,2,1,3
C(CC(C(CC(C(C)O)=O)O)O)=O,,,5,1,1,0,1
3177_0,,,,2,2,1,3
C(CC(C(C(C(CC)=O)O)O)O)=O,,,5,1,2,0,2
3177_1,,,,2,2,1,3
3179_0,,,,2,2,1,3
C(CC(C(C(C(CO)=O)C)O)O)=O,,,5,1,1,0,1
3181_0,,,,2,2,1,3
C(C(CCO)C(C(CC=O)O)O)=O,,,5,1,1,0,1
3183_0,,,,2,2,1,3
C(CC(C(CC=O)O)O)=O,,,5,1,1,0,1
3185_0,,,,2,2,1,3
C(C(C(C(CC=O)O)O)C(C)O)=O,,,5,1,3,0,3
3185_1,,,,2,2,1,3
3187_0,,,,2,2,1,3
C(C(C=O)C(C(CC=O)O)O)(O)=O,,,5,1,3,0,3
3187_1,,,,2,2,1,3
3189_0,,,,2,2,1,3
C(CC(C(C(C(C=O)=O)O)O)O)=O,,,5,1,3,0,3
3189_1,,,,2,2,1,3
3190_0,,,,2,2,1,3
3190_1,,,,2,2,1,3
3191_0,,,,2,2,1,3
3191_1,,,,2,2,1,3
3192_0,,,,2,2,1,3
3194_0,,,,2,2,1,3
C(CC(C(CC(C(O)=O)=O)O)O)=O,,,5,1,2,0,2
3196_0,,,,2,2,1,3
C(C(C(C=O)C(C(C)=O)O)O)=O,,,5,1,2,0,2
3196_1,,,,2,2,1,3
3198_0,,,,2,2,1,3
C(C(C(C=O)C(C=O)(C)O)O)=O,,,5,1,2,0,2
3198_1,,,,2,2,1,3
3200_0,,,,2,2,1,3
C(C(C(C=O)C(C(C=O)=O)O)O)=O,,,5,1,2,0,2
3200_1,,,,2,2,1,3
3202_0,,,,2,2,1,3
C(C(C=O)(C(C=O)C(C=O)O)O)=O,,,5,1,2,0,2
3202_1,,,,2,2,1,3
3204_0,,,,2,2,1,3
C(C(C(C(CO)O)O)C(C=O)O)=O,,,5,1,2,0,2
3204_1,,,,2,2,1,3
3206_0,,,,2,2,1,3
C(C(C(CO)O)C(C=O)O)=O,,,5,1,2,0,2
3206_1,,,,2,2,1,3
3208_0,,,,2,2,1,3
C(C(C(C(C)O)O)C(C=O)O)=O,,,5,1,2,0,2
3208_1,,,,2,2,1,3
3210_0,,,,2,2,1,3
C(C(C(C=O)C(C=O)O)O)(O)=O,,,5,1,2,0,2
3210_1,,,,2,2,1,3
3212_0,,,,2,2,1,3
C(C(C(C)(CCO)O)C(C=O)O)=O,,,5,1,2,0,2
3212_1,,,,2,2,1,3
3214_0,,,,2,2,1,3
C(C(C(CO)(C)O)C(C=O)O)=O,,,5,1,2,0,2
3214_1,,,,2,2,1,3
3216_0,,,,2,2,1,3
C(C(C(C)(C(C)O)O)C(C=O)O)=O,,,5,1,2,0,2
3216_1,,,,2,2,1,3
3218_0,,,,2,2,1,3
C(C(C(CO)(CC)O)C(C=O)O)=O,,,5,1,2,0,2
3218_1,,,,2,2,1,3
3220_0,,,,2,2,1,3
C(C(C(C=O)C(C=C)O)O)=O,,,5,1,2,0,2
3220_1,,,,2,2,1,3
3222_0,,,,2,2,1,3
C(C(C(C(CC)O)O)C(C=O)O)=O,,,5,1,2,0,2
3222_1,,,,2,2,1,3
3224_0,,,,2,2,1,3
C(C(C(CCCO)O)C(C=O)O)=O,,,5,1,2,0,2
3224_1,,,,2,2,1,3
3225_0,,,,2,2,1,3
3225_1,,,,2,2,1,3
3226_0,,,,2,2,1,3
3226_1,,,,2,2,1,3
3227_0,,,,2,2,1,3
3227_1,,,,2,2,1,3
3228_0,,,,2,2,1,3
3228_1,,,,2,2,1,3
3229_0,,,,2,2,1,3
3229_1,,,,2,2,1,3
3230_0,,,,2,2,1,3
3230_1,,,,2,2,1,3
3231_0,,,,2,2,1,3
3231_1,,,,2,2,1,3
3232_0,,,,2,2,1,3
3232_1,,,,2,2,1,3
3234_0,,,,2,2,1,3
C(C(C(C=O)C(C=O)O)O)=O,,,5,1,4,0,4
3234_1,,,,2,2,1,3
3236_0,,,,2,2,1,3
C(C(C(C(C=O)C(C=O)O)O)O)=O,,,5,1,5,0,5
3236_1,,,,2,2,1,3
3238_0,,,,2,2,1,3
C(C(C(CO)(CO)O)C(C=O)O)=O,,,5,1,5,0,5
3238_1,,,,2,2,1,3
3240_0,,,,2,2,1,3
C(C(C(C=O)C(C=CC)O)O)=O,,,5,1,5,0,5
3240_1,,,,2,2,1,3
3242_0,,,,2,2,1,3
C(C(C(CC=C)O)C(C=O)O)=O,,,5,1,5,0,5
3242_1,,,,2,2,1,3
3243_0,,,,2,2,1,3
3243_1,,,,2,2,1,3
3245_0,,,,2,2,1,3
C(CC(C(C(C)O)C(C=O)O)O)=O,,,5,1,1,0,1
3246_0,,,,2,2,1,3
3247_0,,,,2,2,1,3
3248_0,,,,2,2,1,3
3249_0,,,,2,2,1,3
3251_0,,,,2,2,1,3
C(C(C(C(C=O)(CC=O)O)O)O)=O,,,5,1,2,0,2
3252_0,,,,2,2,1,3
3254_0,,,,2,2,1,3
C(C(CC(C=O)O)(CC=O)O)(O)=O,,,5,1,2,0,2
3255_0,,,,2,2,1,3
3256_0,,,,2,2,1,3
3256_1,,,,2,2,1,3
3257_0,,,,2,2,1,3
3257_1,,,,2,2,1,3
3258_0,,,,2,2,1,3
3258_1,,,,2,2,1,3
3260_0,,,,2,2,1,3
C(C(C(CC(C(C=O)O)O)O)O)=O,,,5,1,2,0,2
3260_1,,,,2,2,1,3
3262_0,,,,2,2,1,3
C(CC(CC(C(C=O)O)O)O)=O,,,5,1,2,0,2
3264_0,,,,2,2,1,3
C(CC(C(C(C(C=O)O)O)O)O)=O,,,5,1,2,0,2
3264_1,,,,2,2,1,3
3266_0,,,,2,2,1,3
C(CC(C(C(CC=O)O)O)O)=O,,,5,1,1,0,1
3268_0,,,,2,2,1,3
C(C(C(C(C=O)O)O)C(CO)O)=O,,,5,1,2,0,2
3268_1,,,,2,2,1,3
3270_0,,,,2,2,1,3
C(C(C(C(C=O)C(C=C)O)O)O)=O,,,5,1,2,0,2
3270_1,,,,2,2,1,3
3271_0,,,,2,2,1,3
3271_1,,,,2,2,1,3
3272_0,,,,2,2,1,3
3272_1,,,,2,2,1,3
3273_0,,,,2,2,1,3
3273_1,,,,2,2,1,3
3274_0,,,,2,2,1,3
3274_1,,,,2,2,1,3
3276_0,,,,2,2,1,3
C(C(C(CC(CO)(CO)O)O)O)=O,,,5,1,2,0,2
3276_1,,,,2,2,1,3
3278_0,,,,2,2,1,3
C(CC(CC(CO)(CO)O)O)=O,,,5,1,2,0,2
3280_0,,,,2,2,1,3
C(C(C(CO)O)C(CO)(CO)O)=O,,,5,1,2,0,2
3280_1,,,,2,2,1,3
3282_0,,,,2,2,1,3
C(C(C(CO)(CO)O)C(C=C)O)=O,,,5,1,2,0,2
3282_1,,,,2,2,1,3
3283_0,,,,2,2,1,3
3283_1,,,,2,2,1,3
3284_0,,,,2,2,1,3
3284_1,,,,2,2,1,3
3285_0,,,,2,2,1,3
3285_1,,,,2,2,1,3
3286_0,,,,2,2,1,3
3286_1,,,,2,2,1,3
3288_0,,,,2,2,1,3
C(C(C(C=CC)O)O)(C(CO)O)=O,,,5,1,4,0,4
3288_1,,,,2,2,1,3
3290_0,,,,2,2,1,3
C(C(C(CC=C)O)O)(C(CO)O)=O,,,5,1,4,0,4
3290_1,,,,2,2,1,3
3292_0,,,,2,2,1,3
C(C(C(CO)(C(C(C)O)O)O)O)=O,,,5,1,2,0,2
3292_1,,,,2,2,1,3
3294_0,,,,2,2,1,3
C(CC(CO)(C(C(C)O)O)O)=O,,,5,1,2,0,2
3296_0,,,,2,2,1,3
C(C(C(CO)O)O)(C(C(C)O)O)=O,,,5,1,5,0,5
3296_1,,,,2,2,1,3
3298_0,,,,2,2,1,3
C(C(C(C=C)O)O)(C(C(C)O)O)=O,,,5,1,2,0,2
3298_1,,,,2,2,1,3
3300_0,,,,2,2,1,3
C(C(C(C)O)O)(C(C(C)O)O)=O,,,5,1,2,0,2
3300_1,,,,2,2,1,3
3302_0,,,,2,2,1,3
C(C(C(C(C(C)O)O)=O)O)(O)=O,,,5,1,4,0,4
3302_1,,,,2,2,1,3
3304_0,,,,2,2,1,3
C(C(C(C)O)O)(C(CO)O)=O,,,5,1,4,0,4
3304_1,,,,2,2,1,3
3305_0,,,,2,2,1,3
3305_1,,,,2,2,1,3
3307_0,,,,2,2,1,3
C(C(C(CO)(C(C=O)O)O)O)(O)=O,,,5,1,7,0,7
3307_1,,,,2,2,1,3
3309_0,,,,2,2,1,3
C(CC(CO)(C(C(O)=O)O)O)=O,,,5,1,2,0,2
3311_0,,,,2,2,1,3
C(C(C(C(C(CO)O)O)=O)O)(O)=O,,,5,1,8,0,8
3311_1,,,,2,2,1,3
3313_0,,,,2,2,1,3
C(C(C(C(C(C=C)O)O)=O)O)(O)=O,,,5,1,2,0,2
3313_1,,,,2,2,1,3
3314_0,,,,2,2,1,3
3314_1,,,,2,2,1,3
3316_0,,,,2,2,1,3
C(C(C(C(C(O)=O)O)=O)O)(O)=O,,,5,1,2,0,2
3316_1,,,,2,2,1,3
3317_0,,,,2,2,1,3
3317_1,,,,2,2,1,3
3318_0,,,,2,2,1,3
3318_1,,,,2,2,1,3
3320_0,,,,2,2,1,3
C(C(CC(CO)(C(CO)O)O)=O)=O,,,5,1,1,0,1
3322_0,,,,2,2,1,3
C(C(C(CO)(C(CO)O)O)O)=O,,,5,1,2,0,2
3322_1,,,,2,2,1,3
3324_0,,,,2,2,1,3
C(CO)(CC(CO)(C(CO)O)O)=O,,,5,1,1,0,1
3326_0,,,,2,2,1,3
C(C)(C(C(CO)(C(CO)O)O)O)=O,,,5,1,2,0,2
3326_1,,,,2,2,1,3
3328_0,,,,2,2,1,3
C(CC(CO)(C(CO)O)O)=O,,,5,1,2,0,2
3330_0,,,,2,2,1,3
C(C(CO)C(CO)(C(CO)O)O)=O,,,5,1,3,0,3
3330_1,,,,2,2,1,3
3332_0,,,,2,2,1,3
C(C(C=C)C(CO)(C(CO)O)O)=O,,,5,1,2,0,2
3334_0,,,,2,2,1,3
C(C(C(C(C(CO)O)=O)O)O)(C)=O,,,5,1,4,0,4
3334_1,,,,2,2,1,3
3336_0,,,,2,2,1,3
C(C(C)(C(C(C(CO)O)=O)O)O)=O,,,5,1,3,0,3
3336_1,,,,2,2,1,3
3338_0,,,,2,2,1,3
C(C(C(CO)O)O)(C(CO)O)=O,,,5,1,5,0,5
3338_1,,,,2,2,1,3
3340_0,,,,2,2,1,3
C(C(C(C(C)O)O)O)(C(CO)O)=O,,,5,1,2,0,2
3340_1,,,,2,2,1,3
3341_0,,,,2,2,1,3
3341_1,,,,2,2,1,3
3343_0,,,,2,2,1,3
C(C(C(CO)(C)O)O)(C(CO)O)=O,,,5,1,2,0,2
3343_1,,,,2,2,1,3
3345_0,,,,2,2,1,3
C(C(C(C=C)O)O)(C(CO)O)=O,,,5,1,2,0,2
3345_1,,,,2,2,1,3
3346_0,,,,2,2,1,3
3346_1,,,,2,2,1,3
3347_0,,,,2,2,1,3
3347_1,,,,2,2,1,3
3349_0,,,,2,2,1,3
C(C(CO)O)(C(CO)O)=O,,,5,1,6,0,6
3349_1,,,,2,2,1,3
3350_0,,,,2,2,1,3
3350_1,,,,2,2,1,3
3351_0,,,,2,2,1,3
3351_1,,,,2,2,1,3
3352_0,,,,2,2,1,3
3352_1,,,,2,2,1,3
3353_0,,,,2,2,1,3
3353_1,,,,2,2,1,3
3355_0,,,,2,2,1,3
C(C(CO)(CC(CC=O)O)O)(O)=O,,,5,1,2,0,2
3356_0,,,,2,2,1,3
3356_1,,,,2,2,1,3
3357_0,,,,2,2,1,3
3357_1,,,,2,2,1,3
3358_0,,,,2,2,1,3
3358_1,,,,2,2,1,3
3360_0,,,,2,2,1,3
C(C(C(C(C)O)O)(CC=O)O)(O)=O,,,5,1,2,0,2
3362_0,,,,2,2,1,3
C(C(C(C(O)=O)(CC=O)O)O)(O)=O,,,5,1,2,0,2
3364_0,,,,2,2,1,3
C(C(C(CO)O)(C(C=O)O)O)(O)=O,,,5,1,6,0,6
3364_1,,,,2,2,1,3
3366_0,,,,2,2,1,3
C(C(C(CO)O)(CC=O)O)(O)=O,,,5,1,2,0,2
3367_0,,,,2,2,1,3
3367_1,,,,2,2,1,3
3369_0,,,,2,2,1,3
C(CC(CC(C(C(O)=O)O)O)O)=O,,,5,1,1,0,1
3370_0,,,,2,2,1,3
3370_1,,,,2,2,1,3
3371_0,,,,2,2,1,3
3371_1,,,,2,2,1,3
3372_0,,,,2,2,1,3
3372_1,,,,2,2,1,3
3374_0,,,,2,2,1,3
C(C(C(C(CO)CO)=O)CO)(O)=O,,,5,1,2,0,2
3374_1,,,,2,2,1,3
3376_0,,,,2,2,1,3
C(CC(C(C=C)C(C=CC)O)O)=O,,,5,1,1,0,1
3378_0,,,,2,2,1,3
C(C(CC(CC(C=O)=O)O)O)=CC,,,5,1,1,0,1
3380_0,,,,2,2,1,3
C(C(C(CC(C=CC)O)O)O)=O,,,5,1,2,0,2
3380_1,,,,2,2,1,3
3382_0,,,,2,2,1,3
C(CO)(CC(CC(C=CC)O)O)=O,,,5,1,1,0,1
3384_0,,,,2,2,1,3
C(C)(C(C(CC(C=CC)O)O)O)=O,,,5,1,2,0,2
3384_1,,,,2,2,1,3
3386_0,,,,2,2,1,3
C(CC(CC(C=CC)O)O)=O,,,5,1,2,0,2
3388_0,,,,2,2,1,3
C(C(CO)C(CC(C=CC)O)O)=O,,,5,1,2,0,2
3388_1,,,,2,2,1,3
3390_0,,,,2,2,1,3
C(C(C=C)C(CC(C=CC)O)O)=O,,,5,1,1,0,1
3392_0,,,,2,2,1,3
C(C(C(C(C)=O)O)C(C=CC)O)=O,,,5,1,2,0,2
3392_1,,,,2,2,1,3
3394_0,,,,2,2,1,3
C(C(C)(C(C=O)C(C=CC)O)O)=O,,,5,1,2,0,2
3394_1,,,,2,2,1,3
3396_0,,,,2,2,1,3
C(C(C(CO)O)C(C=CC)O)=O,,,5,1,2,0,2
3396_1,,,,2,2,1,3
3398_0,,,,2,2,1,3
C(C(C(C(C)O)O)C(C=CC)O)=O,,,5,1,2,0,2
3398_1,,,,2,2,1,3
3400_0,,,,2,2,1,3
C(C(C(C=O)C(C=CC)O)O)(O)=O,,,5,1,2,0,2
3400_1,,,,2,2,1,3
3402_0,,,,2,2,1,3
C(C(C(CO)(C)O)C(C=CC)O)=O,,,5,1,2,0,2
3402_1,,,,2,2,1,3
3404_0,,,,2,2,1,3
C(C(C(C=CC)O)C(C=C)O)=O,,,5,1,2,0,2
3404_1,,,,2,2,1,3
3405_0,,,,2,2,1,3
3405_1,,,,2,2,1,3
3406_0,,,,2,2,1,3
3406_1,,,,2,2,1,3
3407_0,,,,2,2,1,3
3407_1,,,,2,2,1,3
3408_0,,,,2,2,1,3
3408_1,,,,2,2,1,3
3409_0,,,,2,2,1,3
3409_1,,,,2,2,1,3
3411_0,,,,2,2,1,3
C(C(C(C=CC)O)C(C=CC)O)=O,,,5,1,2,0,2
3411_1,,,,2,2,1,3
3413_0,,,,2,2,1,3
C(C(C(CC=C)O)C(C=CC)O)=O,,,5,1,4,0,4
3413_1,,,,2,2,1,3
3414_0,,,,2,2,1,3
3414_1,,,,2,2,1,3
3416_0,,,,2,2,1,3
C(CC(C(C=C)C(CC=C)O)O)=O,,,5,1,1,0,1
3418_0,,,,2,2,1,3
C=CCC(CC(CC(C=O)=O)O)O,,,5,1,1,0,1
3420_0,,,,2,2,1,3
C(C(C(CC(CC=C)O)O)O)=O,,,5,1,2,0,2
3420_1,,,,2,2,1,3
3422_0,,,,2,2,1,3
C(CO)(CC(CC(CC=C)O)O)=O,,,5,1,1,0,1
3424_0,,,,2,2,1,3
C(C)(C(C(CC(CC=C)O)O)O)=O,,,5,1,2,0,2
3424_1,,,,2,2,1,3
3426_0,,,,2,2,1,3
C(CC(CC(CC=C)O)O)=O,,,5,1,2,0,2
3428_0,,,,2,2,1,3
C(C(CO)C(CC(CC=C)O)O)=O,,,5,1,2,0,2
3428_1,,,,2,2,1,3
3430_0,,,,2,2,1,3
C(C(C=C)C(CC(CC=C)O)O)=O,,,5,1,1,0,1
3432_0,,,,2,2,1,3
C(C(C(CC=C)O)C(C(C)=O)O)=O,,,5,1,2,0,2
3432_1,,,,2,2,1,3
3434_0,,,,2,2,1,3
C(C(C(CC=C)O)C(C=O)(C)O)=O,,,5,1,2,0,2
3434_1,,,,2,2,1,3
3436_0,,,,2,2,1,3
C(C(C(CC=C)O)C(CO)O)=O,,,5,1,2,0,2
3436_1,,,,2,2,1,3
3438_0,,,,2,2,1,3
C(C(C(CC=C)O)C(C(C)O)O)=O,,,5,1,2,0,2
3438_1,,,,2,2,1,3
3440_0,,,,2,2,1,3
C(C(C(CC=C)O)C(C(O)=O)O)=O,,,5,1,2,0,2
3440_1,,,,2,2,1,3
3442_0,,,,2,2,1,3
C(C(C(CC=C)O)C(C)(CO)O)=O,,,5,1,2,0,2
3442_1,,,,2,2,1,3
3444_0,,,,2,2,1,3
C(C(C(CC=C)O)C(C=C)O)=O,,,5,1,2,0,2
3444_1,,,,2,2,1,3
3445_0,,,,2,2,1,3
3445_1,,,,2,2,1,3
3446_0,,,,2,2,1,3
3446_1,,,,2,2,1,3
3447_0,,,,2,2,1,3
3447_1,,,,2,2,1,3
3448_0,,,,2,2,1,3
3448_1,,,,2,2,1,3
3449_0,,,,2,2,1,3
3449_1,,,,2,2,1,3
3450_0,,,,2,2,1,3
3450_1,,,,2,2,1,3
3452_0,,,,2,2,1,3
C(C(C(CC=C)O)C(CC=C)O)=O,,,5,1,2,0,2
3452_1,,,,2,2,1,3
3453_0,,,,2,2,1,3
3453_1,,,,2,2,1,3
3455_0,,,,2,2,1,3
C(C(C(CC(C=O)=O)O)C(C)O)=C,,,5,1,1,0,1
3457_0,,,,2,2,1,3
C(C(C(C(C=C)C(C)O)O)O)=O,,,5,1,2,0,2
3457_1,,,,2,2,1,3
3459_0,,,,2,2,1,3
C(CO)(CC(C(C=C)C(C)O)O)=O,,,5,1,1,0,1
3461_0,,,,2,2,1,3
C(C)(C(C(C(C=C)C(C)O)O)O)=O,,,5,1,2,0,2
3461_1,,,,2,2,1,3
3463_0,,,,2,2,1,3
C(CC(C(C=C)C(C)O)O)=O,,,5,1,2,0,2
3465_0,,,,2,2,1,3
C(C(CO)C(C(C=C)C(C)O)O)=O,,,5,1,2,0,2
3465_1,,,,2,2,1,3
3467_0,,,,2,2,1,3
C(C(C=C)C(C(C=C)C(C)O)O)=O,,,5,1,1,0,1
3469_0,,,,2,2,1,3
C(C(C=C)C(CC(C=O)=O)O)(O)=O,,,5,1,1,0,1
3471_0,,,,2,2,1,3
C(C(C=C)C(C(C=O)O)O)(O)=O,,,5,1,4,0,4
3471_1,,,,2,2,1,3
3473_0,,,,2,2,1,3
C(C(C=C)C(CC(CO)=O)O)(O)=O,,,5,1,1,0,1
3475_0,,,,2,2,1,3
C(C(C=C)C(C(C(C)=O)O)O)(O)=O,,,5,1,2,0,2
3475_1,,,,2,2,1,3
3477_0,,,,2,2,1,3
C(C(C=C)C(CC=O)O)(O)=O,,,5,1,2,0,2
3479_0,,,,2,2,1,3
C(C(C=C)C(C(C=O)CO)O)(O)=O,,,5,1,2,0,2
3479_1,,,,2,2,1,3
3481_0,,,,2,2,1,3
C(C(C=C)C(C(C(O)=O)C=C)O)=O,,,5,1,1,0,1
3482_0,,,,2,2,1,3
3482_1,,,,2,2,1,3
3484_0,,,,2,2,1,3
C(C(CO)C(CC(C=O)=O)O)=C,,,5,1,1,0,1
3486_0,,,,2,2,1,3
C(C(C(C(C=C)CO)O)O)=O,,,5,1,3,0,3
3486_1,,,,2,2,1,3
3488_0,,,,2,2,1,3
C(CCO)(CC(C(C=C)CO)O)=O,,,5,1,1,0,1
3490_0,,,,2,2,1,3
C(C)(C(CO)C(C(C=C)CO)O)=O,,,5,1,2,0,2
3490_1,,,,2,2,1,3
3492_0,,,,2,2,1,3
C(CO)(CC(C(C=C)CO)O)=O,,,5,1,1,0,1
3494_0,,,,2,2,1,3
C(C)(C(C(C(C=C)CO)O)O)=O,,,5,1,2,0,2
3494_1,,,,2,2,1,3
3496_0,,,,2,2,1,3
C(C(C)O)(CC(C(C=C)CO)O)=O,,,5,1,1,0,1
3498_0,,,,2,2,1,3
C(C(C(C(C=C)CO)O)O)(CC)=O,,,5,1,2,0,2
3498_1,,,,2,2,1,3
3500_0,,,,2,2,1,3
C(CO)(C(C)C(C(C=C)CO)O)=O,,,5,1,1,0,1
3502_0,,,,2,2,1,3
C(C(C(C(C=C)CO)O)CCO)=O,,,5,1,1,0,1
3504_0,,,,2,2,1,3
C(CC(C(C=C)CO)O)=O,,,5,1,2,0,2
3506_0,,,,2,2,1,3
C(C(C(C(C=C)CO)O)C(C)O)=O,,,5,1,2,0,2
3506_1,,,,2,2,1,3
3508_0,,,,2,2,1,3
C(C(C=O)C(C(C=C)CO)O)(O)=O,,,5,1,2,0,2
3508_1,,,,2,2,1,3
3510_0,,,,2,2,1,3
C(C(CO)C(C(C(C=O)=O)O)O)=C,,,5,1,2,0,2
3510_1,,,,2,2,1,3
3512_0,,,,2,2,1,3
C(C(CO)C(C(C=C)CO)O)=O,,,5,1,3,0,3
3512_1,,,,2,2,1,3
3514_0,,,,2,2,1,3
C(CO)(C(C(C(C=C)CO)O)O)=O,,,5,1,2,0,2
3514_1,,,,2,2,1,3
3516_0,,,,2,2,1,3
C(C(C=C)C(C(C=C)CO)O)=O,,,5,1,2,0,2
3518_0,,,,2,2,1,3
C(C(CO)C(CC(C(O)=O)=O)O)=C,,,5,1,1,0,1
3519_0,,,,2,2,1,3
3519_1,,,,2,2,1,3
3520_0,,,,2,2,1,3
3520_1,,,,2,2,1,3
3522_0,,,,2,2,1,3
C(CC(C(O)=O)(C(C=C)CO)O)=O,,,5,1,1,0,1
3523_0,,,,2,2,1,3
3523_1,,,,2,2,1,3
3525_0,,,,2,2,1,3
C(CC(C(C(C(O)=O)=C)CO)O)=O,,,5,1,1,0,1
3526_0,,,,2,2,1,3
3526_1,,,,2,2,1,3
3527_0,,,,2,2,1,3
3527_1,,,,2,2,1,3
3529_0,,,,2,2,1,3
C1(C(C(CO)C(C)O1)(CC=O)O)=O,,,5,1,1,0,1
3530_0,,,,2,2,1,3
3530_1,,,,2,2,1,3
3532_0,,,,2,2,1,3
C1(C(CO)C(C(O1)=O)(CC=O)O)=O,,,5,1,2,0,2
3534_0,,,,2,2,1,3
C(CC1(C(CC(C(C1)=O)=O)=O)O)=O,,,5,1,1,0,1
3536_0,,,,2,2,1,3
C=CC(C1C(C(CC(C1=O)=O)=O)=O)O,,,5,1,2,0,2
3536_1,,,,2,2,1,3
3538_0,,,,2,2,1,3
C1(C(CC(C(C1C(C)O)=O)=O)=O)=O,,,5,1,2,0,2
3538_1,,,,2,2,1,3
3540_0,,,,2,2,1,3
C(C1C(C(CC(C1=O)=O)=O)=O)(O)=O,,,5,1,2,0,2
3540_1,,,,2,2,1,3
3542_0,,,,2,2,1,3
C1(C(CC(C(C1CO)=O)=O)=O)=O,,,5,1,3,0,3
3542_1,,,,2,2,1,3
3544_0,,,,2,2,1,3
C(C(C1C(C(CC(C1=O)=O)=O)=O)O)=O,,,5,1,2,0,2
3544_1,,,,2,2,1,3
3546_0,,,,2,2,1,3
C(C(C(C=O)=O)(CC(C=O)=O)O)=O,,,5,1,1,0,1
3548_0,,,,2,2,1,3
C(C(C(C=O)=O)(C(C=O)O)O)=O,,,5,1,2,0,2
3548_1,,,,2,2,1,3
3550_0,,,,2,2,1,3
C(C(C(C=O)=O)(CC(CO)=O)O)=O,,,5,1,1,0,1
3552_0,,,,2,2,1,3
C(C(C(C=O)=O)(C(C(C)=O)O)O)=O,,,5,1,2,0,2
3552_1,,,,2,2,1,3
3554_0,,,,2,2,1,3
C(C(C(C=O)=O)(CC=O)O)=O,,,5,1,2,0,2
3556_0,,,,2,2,1,3
C(C(C(C=O)=O)(C(C=O)CO)O)=O,,,5,1,2,0,2
3556_1,,,,2,2,1,3
3558_0,,,,2,2,1,3
C(C(C=C)C(C=O)(C(C=O)=O)O)=O,,,5,1,1,0,1
3560_0,,,,2,2,1,3
C(C(CC(C(C(C=O)=O)=O)O)=O)=O,,,5,1,1,0,1
3562_0,,,,2,2,1,3
C(C(C(C(C(C=O)=O)=O)O)O)=O,,,5,1,3,0,3
3562_1,,,,2,2,1,3
3564_0,,,,2,2,1,3
C(CO)(CC(C(C(C=O)=O)=O)O)=O,,,5,1,1,0,1
3566_0,,,,2,2,1,3
C(C)(C(C(C(C(C=O)=O)=O)O)O)=O,,,5,1,2,0,2
3566_1,,,,2,2,1,3
3568_0,,,,2,2,1,3
C(CC(C(C(C=O)=O)=O)O)=O,,,5,1,2,0,2
3570_0,,,,2,2,1,3
C(C(CO)C(C(C(C=O)=O)=O)O)=O,,,5,1,2,0,2
3570_1,,,,2,2,1,3
3572_0,,,,2,2,1,3
C(C(C=C)C(C(C(C=O)=O)=O)O)=O,,,5,1,1,0,1
3574_0,,,,2,2,1,3
C(C(C(C(C(CCO)=O)=O)O)=O)=O,,,5,1,1,0,1
3576_0,,,,2,2,1,3
C(C(C(C(CO)=O)=O)=O)(CCO)=O,,,5,1,1,0,1
3578_0,,,,2,2,1,3
C(C(C(C(C)=O)=O)=O)(C(CO)O)=O,,,5,1,2,0,2
3578_1,,,,2,2,1,3
3580_0,,,,2,2,1,3
C(C)(C(CCO)(CC(C=O)=O)O)=O,,,5,1,1,0,1
3582_0,,,,2,2,1,3
C(C)(C(CCO)(C(C=O)O)O)=O,,,5,1,2,0,2
3582_1,,,,2,2,1,3
3584_0,,,,2,2,1,3
C(C)(C(CCO)(CC(CO)=O)O)=O,,,5,1,1,0,1
3586_0,,,,2,2,1,3
C(C)(C(CCO)(C(C(C)=O)O)O)=O,,,5,1,2,0,2
3586_1,,,,2,2,1,3
3588_0,,,,2,2,1,3
C(C)(C(CCO)(CC=O)O)=O,,,5,1,2,0,2
3590_0,,,,2,2,1,3
C(C(CO)C(C(C)=O)(CCO)O)=O,,,5,1,3,0,3
3590_1,,,,2,2,1,3
3592_0,,,,2,2,1,3
C(C(C=C)C(C(C)=O)(CCO)O)=O,,,5,1,2,0,2
3594_0,,,,2,2,1,3
C(C(C)(CC(C=O)=O)O)(CCO)=O,,,5,1,1,0,1
3596_0,,,,2,2,1,3
C(C(C)(C(C=O)O)O)(CCO)=O,,,5,1,2,0,2
3596_1,,,,2,2,1,3
3598_0,,,,2,2,1,3
C(C(C)(CC(CO)=O)O)(CCO)=O,,,5,1,1,0,1
3600_0,,,,2,2,1,3
C(C(C)(C(C(C)=O)O)O)(CCO)=O,,,5,1,2,0,2
3600_1,,,,2,2,1,3
3602_0,,,,2,2,1,3
C(C(C)(CC=O)O)(CCO)=O,,,5,1,2,0,2
3604_0,,,,2,2,1,3
C(C(CO)C(C(CCO)=O)(C)O)=O,,,5,1,3,0,3
3604_1,,,,2,2,1,3
3606_0,,,,2,2,1,3
C(C(C=C)C(C(CCO)=O)(C)O)=O,,,5,1,2,0,2
3608_0,,,,2,2,1,3
C(C(C(C(C(C)=O)=O)CO)O)(C)=O,,,5,1,2,0,2
3608_1,,,,2,2,1,3
3610_0,,,,2,2,1,3
C(C(C)(C(C(C(C)=O)=O)CO)O)=O,,,5,1,2,0,2
3610_1,,,,2,2,1,3
3612_0,,,,2,2,1,3
C(C(C)=O)(C(CO)C(CO)O)=O,,,5,1,2,0,2
3612_1,,,,2,2,1,3
3614_0,,,,2,2,1,3
C(C(C)=O)(C(CO)C(C(C)O)O)=O,,,5,1,2,0,2
3614_1,,,,2,2,1,3
3616_0,,,,2,2,1,3
C(C(C(C(C(C)=O)=O)CO)O)(O)=O,,,5,1,2,0,2
3616_1,,,,2,2,1,3
3618_0,,,,2,2,1,3
C(C(C)=O)(C(CO)C(C)(CO)O)=O,,,5,1,2,0,2
3618_1,,,,2,2,1,3
3620_0,,,,2,2,1,3
C=CC(C(C(C(C)=O)=O)CO)O,,,5,1,2,0,2
3620_1,,,,2,2,1,3
3622_0,,,,2,2,1,3
C(C(C)=O)(C(CO)C(C)O)=O,,,5,1,4,0,4
3622_1,,,,2,2,1,3
3624_0,,,,2,2,1,3
C(C(C(C(C)=O)=O)CO)(O)=O,,,5,1,7,0,7
3624_1,,,,2,2,1,3
3626_0,,,,2,2,1,3
C(C(C)=O)(C(CO)CO)=O,,,5,1,4,0,4
3626_1,,,,2,2,1,3
3628_0,,,,2,2,1,3
C(C(C)=O)(C(CO)C(CCO)O)=O,,,5,1,3,0,3
3628_1,,,,2,2,1,3
3630_0,,,,2,2,1,3
C(C(C(C(C(C)=O)=O)CO)O)=O,,,5,1,3,0,3
3630_1,,,,2,2,1,3
3632_0,,,,2,2,1,3
C(C)=CC(C(C(C(C)=O)=O)CO)O,,,5,1,3,0,3
3632_1,,,,2,2,1,3
3634_0,,,,2,2,1,3
C(CC(C(C(C(C)=O)=O)CO)O)=C,,,5,1,3,0,3
3634_1,,,,2,2,1,3
3636_0,,,,2,2,1,3
C(C(CC(C(CCO)=O)=O)O)(C)=O,,,5,1,1,0,1
3638_0,,,,2,2,1,3
C(C(C)(CC(C(CCO)=O)=O)O)=O,,,5,1,1,0,1
3640_0,,,,2,2,1,3
C(C(CCO)=O)(CC(CO)O)=O,,,5,1,1,0,1
3642_0,,,,2,2,1,3
C(C(CCO)=O)(CC(C(C)O)O)=O,,,5,1,1,0,1
3644_0,,,,2,2,1,3
C(C(CC(C(CCO)=O)=O)O)(O)=O,,,5,1,1,0,1
3646_0,,,,2,2,1,3
C(C(CCO)=O)(CC(C)(CO)O)=O,,,5,1,1,0,1
3648_0,,,,2,2,1,3
C=CC(CC(C(CCO)=O)=O)O,,,5,1,1,0,1
3650_0,,,,2,2,1,3
C(C(CCO)=O)(CC(C)O)=O,,,5,1,3,0,3
3652_0,,,,2,2,1,3
C(CC(C(CCO)=O)=O)(O)=O,,,5,1,5,0,5
3654_0,,,,2,2,1,3
C(C(CCO)=O)(CCO)=O,,,5,1,2,0,2
3656_0,,,,2,2,1,3
C(C(CCO)=O)(CC(CCO)O)=O,,,5,1,2,0,2
3658_0,,,,2,2,1,3
C(C(CC(C(CCO)=O)=O)O)=O,,,5,1,2,0,2
3660_0,,,,2,2,1,3
C(C)=CC(CC(C(CCO)=O)=O)O,,,5,1,2,0,2
3662_0,,,,2,2,1,3
C=CCC(CC(C(CCO)=O)=O)O,,,5,1,2,0,2
3664_0,,,,2,2,1,3
C(CC(C(C)=O)(C(C=O)O)O)(O)=O,,,5,1,2,0,2
3664_1,,,,2,2,1,3
3666_0,,,,2,2,1,3
C(CC(C(C)=O)(CC=O)O)(O)=O,,,5,1,2,0,2
3668_0,,,,2,2,1,3
C(C(C)(C(C=O)O)O)(CC(O)=O)=O,,,5,1,3,0,3
3668_1,,,,2,2,1,3
3670_0,,,,2,2,1,3
C(C(C)(CC=O)O)(CC(O)=O)=O,,,5,1,2,0,2
3672_0,,,,2,2,1,3
C(C(C(C(C)=O)=O)C(CO)O)(O)=O,,,5,1,2,0,2
3672_1,,,,2,2,1,3
3674_0,,,,2,2,1,3
C(C(C(C(C)=O)=O)C(C=C)O)(O)=O,,,5,1,2,0,2
3674_1,,,,2,2,1,3
3676_0,,,,2,2,1,3
C(C(C(C(C)=O)=O)C(C)O)(O)=O,,,5,1,4,0,4
3676_1,,,,2,2,1,3
3678_0,,,,2,2,1,3
C(C(C(O)=O)C(C(C)=O)=O)(O)=O,,,5,1,4,0,4
3678_1,,,,2,2,1,3
3679_0,,,,2,2,1,3
3679_1,,,,2,2,1,3
3681_0,,,,2,2,1,3
C(C(C(C(C)=O)=O)C(C=O)O)(O)=O,,,5,1,3,0,3
3681_1,,,,2,2,1,3
3683_0,,,,2,2,1,3
C(CC(C(CC(CO)O)=O)=O)(O)=O,,,5,1,1,0,1
3685_0,,,,2,2,1,3
C(CC(C(CC(C=C)O)=O)=O)(O)=O,,,5,1,1,0,1
3687_0,,,,2,2,1,3
C(CC(C(CC(C)O)=O)=O)(O)=O,,,5,1,3,0,3
3689_0,,,,2,2,1,3
C(CC(C(CC(O)=O)=O)=O)(O)=O,,,5,1,3,0,3
3690_0,,,,2,2,1,3
3692_0,,,,2,2,1,3
C(CC(C(CC(C=O)O)=O)=O)(O)=O,,,5,1,2,0,2
3694_0,,,,2,2,1,3
C(CO)(C(CO)(CC(C=O)=O)O)=O,,,5,1,1,0,1
3696_0,,,,2,2,1,3
C(CO)(C(CO)(C(C=O)O)O)=O,,,5,1,7,0,7
3696_1,,,,2,2,1,3
3698_0,,,,2,2,1,3
C(CO)(C(CO)(CC(CO)=O)O)=O,,,5,1,1,0,1
3700_0,,,,2,2,1,3
C(CO)(C(CO)(C(C(C)=O)O)O)=O,,,5,1,4,0,4
3700_1,,,,2,2,1,3
3701_0,,,,2,2,1,3
3703_0,,,,2,2,1,3
C(C(CO)C(C(CO)=O)(CO)O)=O,,,5,1,5,0,5
3703_1,,,,2,2,1,3
3705_0,,,,2,2,1,3
C(C(C=C)C(C(CO)=O)(CO)O)=O,,,5,1,2,0,2
3707_0,,,,2,2,1,3
C(C)(C(C(C(C(CO)=O)=O)O)O)=O,,,5,1,2,0,2
3707_1,,,,2,2,1,3
3709_0,,,,2,2,1,3
C(C(C)(C(C(C(CO)=O)=O)O)O)=O,,,5,1,2,0,2
3709_1,,,,2,2,1,3
3711_0,,,,2,2,1,3
C(C(CO)=O)(C(C(CO)O)O)=O,,,5,1,2,0,2
3711_1,,,,2,2,1,3
3713_0,,,,2,2,1,3
C(C(CO)=O)(C(C(C(C)O)O)O)=O,,,5,1,2,0,2
3713_1,,,,2,2,1,3
3715_0,,,,2,2,1,3
C(C(C(C(C(CO)=O)=O)O)O)(O)=O,,,5,1,2,0,2
3715_1,,,,2,2,1,3
3717_0,,,,2,2,1,3
C(C(CO)=O)(C(C(CO)(C)O)O)=O,,,5,1,2,0,2
3717_1,,,,2,2,1,3
3719_0,,,,2,2,1,3
C=CC(C(C(C(CO)=O)=O)O)O,,,5,1,2,0,2
3719_1,,,,2,2,1,3
3721_0,,,,2,2,1,3
C(C(CO)=O)(C(C(C)O)O)=O,,,5,1,3,0,3
3721_1,,,,2,2,1,3
3723_0,,,,2,2,1,3
C(C(C(C(CO)=O)=O)O)(O)=O,,,5,1,3,0,3
3723_1,,,,2,2,1,3
3725_0,,,,2,2,1,3
C(C(CO)=O)(C(CO)O)=O,,,5,1,2,0,2
3725_1,,,,2,2,1,3
3727_0,,,,2,2,1,3
C(C(CO)=O)(C(C(CCO)O)O)=O,,,5,1,2,0,2
3727_1,,,,2,2,1,3
3729_0,,,,2,2,1,3
C(C(C(C(C(CO)=O)=O)O)O)=O,,,5,1,6,0,6
3729_1,,,,2,2,1,3
3731_0,,,,2,2,1,3
C(C)=CC(C(C(C(CO)=O)=O)O)O,,,5,1,2,0,2
3731_1,,,,2,2,1,3
3733_0,,,,2,2,1,3
C(CC(C(C(C(CO)=O)=O)O)O)=C,,,5,1,2,0,2
3733_1,,,,2,2,1,3
3735_0,,,,2,2,1,3
C(C(C(CC(C)O)O)(CC=O)O)=O,,,5,1,2,0,2
3737_0,,,,2,2,1,3
C(CC(C(C(CC(C)O)O)=O)O)=O,,,5,1,1,0,1
3739_0,,,,2,2,1,3
C(CC(C(C=O)(CC=O)O)O)(O)=O,,,5,1,2,0,2
3741_0,,,,2,2,1,3
C(CC(C(C(CC=O)O)=O)O)(O)=O,,,5,1,1,0,1
3743_0,,,,2,2,1,3
C(CC(C=O)(C(C(CO)=O)O)O)=O,,,5,1,4,0,4
3745_0,,,,2,2,1,3
C(CC(C(C(C(CO)=O)O)=O)O)=O,,,5,1,2,0,2
3747_0,,,,2,2,1,3
C(CC(CO)(C(C(C=O)=O)O)O)=O,,,5,1,1,0,1
3749_0,,,,2,2,1,3
C(C(C(C)O)O)(C(C(C=O)=O)O)=O,,,5,1,2,0,2
3749_1,,,,2,2,1,3
3751_0,,,,2,2,1,3
C(C(C(C(C(C=O)=O)O)=O)O)(O)=O,,,5,1,2,0,2
3751_1,,,,2,2,1,3
3752_0,,,,2,2,1,3
3752_1,,,,2,2,1,3
3754_0,,,,2,2,1,3
C(CC(C=O)(C(C=O)(CO)O)O)=O,,,5,1,4,0,4
3756_0,,,,2,2,1,3
C(CC(C(C(C=O)(CO)O)=O)O)=O,,,5,1,1,0,1
3758_0,,,,2,2,1,3
C(CC(C(C(C=O)=O)(CO)O)O)=O,,,5,1,1,0,1
3760_0,,,,2,2,1,3
C(C(CC(C=O)=O)O)(C(C)O)=O,,,5,1,1,0,1
3762_0,,,,2,2,1,3
C(C(C(C=O)O)O)(C(C)O)=O,,,5,1,2,0,2
3762_1,,,,2,2,1,3
3764_0,,,,2,2,1,3
C(CC(C(C(C)O)=O)O)(CCO)=O,,,5,1,1,0,1
3766_0,,,,2,2,1,3
C(C)(C(CO)C(C(C(C)O)=O)O)=O,,,5,1,2,0,2
3766_1,,,,2,2,1,3
3768_0,,,,2,2,1,3
C(CC(C(C(C)O)=O)O)(CO)=O,,,5,1,1,0,1
3770_0,,,,2,2,1,3
C(C(C(C(C(C)O)=O)O)O)(C)=O,,,5,1,2,0,2
3770_1,,,,2,2,1,3
3772_0,,,,2,2,1,3
C(CC(C(C(C)O)=O)O)(C(C)O)=O,,,5,1,1,0,1
3774_0,,,,2,2,1,3
C(C(C(C(C(C)O)=O)O)O)(CC)=O,,,5,1,2,0,2
3774_1,,,,2,2,1,3
3776_0,,,,2,2,1,3
C(CO)(C(C)C(C(C(C)O)=O)O)=O,,,5,1,1,0,1
3778_0,,,,2,2,1,3
C(C(CCO)C(C(C(C)O)=O)O)=O,,,5,1,1,0,1
3780_0,,,,2,2,1,3
C(CC(C(C(C)O)=O)O)=O,,,5,1,3,0,3
3782_0,,,,2,2,1,3
C(C(C(C)O)C(C(C(C)O)=O)O)=O,,,5,1,2,0,2
3782_1,,,,2,2,1,3
3784_0,,,,2,2,1,3
C(C(C=O)C(C(C(C)O)=O)O)(O)=O,,,5,1,2,0,2
3784_1,,,,2,2,1,3
3786_0,,,,2,2,1,3
C(C(C(C(C=O)=O)O)O)(C(C)O)=O,,,5,1,2,0,2
3786_1,,,,2,2,1,3
3788_0,,,,2,2,1,3
C(C(CO)C(C(C(C)O)=O)O)=O,,,5,1,2,0,2
3788_1,,,,2,2,1,3
3790_0,,,,2,2,1,3
C(C(C(C(C(C)O)=O)O)O)(CO)=O,,,5,1,2,0,2
3790_1,,,,2,2,1,3
3792_0,,,,2,2,1,3
C(C(C=C)C(C(C(C)O)=O)O)=O,,,5,1,1,0,1
3794_0,,,,2,2,1,3
C(C(CC(C(O)=O)=O)O)(C(C)O)=O,,,5,1,1,0,1
3796_0,,,,2,2,1,3
C(C(C(C)O)(CC(C=O)=O)O)=O,,,5,1,1,0,1
3798_0,,,,2,2,1,3
C(C(C(C)O)(C(C=O)O)O)=O,,,5,1,2,0,2
3798_1,,,,2,2,1,3
3800_0,,,,2,2,1,3
C(C(C(C)O)(CC(CCO)=O)O)=O,,,5,1,1,0,1
3802_0,,,,2,2,1,3
C(C(C(C)O)(C(C(C)=O)CO)O)=O,,,5,1,2,0,2
3802_1,,,,2,2,1,3
3804_0,,,,2,2,1,3
C(C(C(C)O)(CC(CO)=O)O)=O,,,5,1,2,0,2
3806_0,,,,2,2,1,3
C(C(C(C)O)(C(C(C)=O)O)O)=O,,,5,1,5,0,5
3806_1,,,,2,2,1,3
3808_0,,,,2,2,1,3
C(C(C(C)O)(CC(C(C)O)=O)O)=O,,,5,1,1,0,1
3810_0,,,,2,2,1,3
C(C(C(C)O)(C(C(CC)=O)O)O)=O,,,5,1,2,0,2
3810_1,,,,2,2,1,3
3812_0,,,,2,2,1,3
C(C(C(C)O)(C(C(CO)=O)C)O)=O,,,5,1,1,0,1
3814_0,,,,2,2,1,3
C(C(CCO)C(C=O)(C(C)O)O)=O,,,5,1,1,0,1
3816_0,,,,2,2,1,3
C(C(C(C)O)(CC=O)O)=O,,,5,1,2,0,2
3818_0,,,,2,2,1,3
C(C(C(C)O)C(C=O)(C(C)O)O)=O,,,5,1,3,0,3
3818_1,,,,2,2,1,3
3820_0,,,,2,2,1,3
C(C(C=O)C(C=O)(C(C)O)O)(O)=O,,,5,1,3,0,3
3820_1,,,,2,2,1,3
3822_0,,,,2,2,1,3
C(C(C(C)O)(C(C(C=O)=O)O)O)=O,,,5,1,4,0,4
3822_1,,,,2,2,1,3
3824_0,,,,2,2,1,3
C(C(CO)C(C=O)(C(C)O)O)=O,,,5,1,4,0,4
3824_1,,,,2,2,1,3
3826_0,,,,2,2,1,3
C(C(C(C)O)(C(C(CO)=O)O)O)=O,,,5,1,4,0,4
3826_1,,,,2,2,1,3
3828_0,,,,2,2,1,3
C(C(C=C)C(C=O)(C(C)O)O)=O,,,5,1,2,0,2
3830_0,,,,2,2,1,3
C(C(C(C)O)(CC(C(O)=O)=O)O)=O,,,5,1,2,0,2
3832_0,,,,2,2,1,3
C(C(C=O)(CC(C=O)=O)O)(O)=O,,,5,1,2,0,2
3833_0,,,,2,2,1,3
3833_1,,,,2,2,1,3
3835_0,,,,2,2,1,3
C(C(C=O)(CC(CCO)=O)O)(O)=O,,,5,1,1,0,1
3837_0,,,,2,2,1,3
C(C(C=O)(C(C(C)=O)CO)O)(O)=O,,,5,1,2,0,2
3837_1,,,,2,2,1,3
3839_0,,,,2,2,1,3
C(C(C=O)(CC(CO)=O)O)(O)=O,,,5,1,5,0,5
3841_0,,,,2,2,1,3
C(C(C=O)(C(C(C)=O)O)O)(O)=O,,,5,1,7,0,7
3841_1,,,,2,2,1,3
3843_0,,,,2,2,1,3
C(C(C=O)(CC(C(C)O)=O)O)(O)=O,,,5,1,1,0,1
3845_0,,,,2,2,1,3
C(C(C=O)(C(C(CC)=O)O)O)(O)=O,,,5,1,2,0,2
3845_1,,,,2,2,1,3
3847_0,,,,2,2,1,3
C(C(C=O)(C(C(CO)=O)C)O)(O)=O,,,5,1,1,0,1
3849_0,,,,2,2,1,3
C(C(C=O)(C(C=O)CCO)O)(O)=O,,,5,1,1,0,1
3851_0,,,,2,2,1,3
C(C(C=O)(CC=O)O)(O)=O,,,5,1,2,0,2
3853_0,,,,2,2,1,3
C(C(C=O)(C(C=O)C(C)O)O)(O)=O,,,5,1,3,0,3
3853_1,,,,2,2,1,3
3855_0,,,,2,2,1,3
C(C(C=O)C(C(O)=O)(C=O)O)(O)=O,,,5,1,3,0,3
3855_1,,,,2,2,1,3
3857_0,,,,2,2,1,3
C(C(C=O)(C(C(C=O)=O)O)O)(O)=O,,,5,1,6,0,6
3857_1,,,,2,2,1,3
3859_0,,,,2,2,1,3
C(C(C=O)(C(C=O)CO)O)(O)=O,,,5,1,6,0,6
3859_1,,,,2,2,1,3
3860_0,,,,2,2,1,3
3860_1,,,,2,2,1,3
3862_0,,,,2,2,1,3
C(C(C=O)(C(C=O)C=C)O)(O)=O,,,5,1,2,0,2
3864_0,,,,2,2,1,3
C(C(C=O)(CC(C(O)=O)=O)O)(O)=O,,,5,1,2,0,2
3866_0,,,,2,2,1,3
C(C(C(CC(C=O)=O)O)=O)(O)=O,,,5,1,2,0,2
3867_0,,,,2,2,1,3
3867_1,,,,2,2,1,3
3869_0,,,,2,2,1,3
C(CC(C(C(O)=O)=O)O)(CCO)=O,,,5,1,1,0,1
3871_0,,,,2,2,1,3
C(C)(C(CO)C(C(C(O)=O)=O)O)=O,,,5,1,2,0,2
3871_1,,,,2,2,1,3
3873_0,,,,2,2,1,3
C(CO)(CC(C(C(O)=O)=O)O)=O,,,5,1,3,0,3
3874_0,,,,2,2,1,3
3874_1,,,,2,2,1,3
3876_0,,,,2,2,1,3
C(CC(C(C(O)=O)=O)O)(C(C)O)=O,,,5,1,1,0,1
3878_0,,,,2,2,1,3
C(C(C(C(C(O)=O)=O)O)O)(CC)=O,,,5,1,2,0,2
3878_1,,,,2,2,1,3
3880_0,,,,2,2,1,3
C(CO)(C(C)C(C(C(O)=O)=O)O)=O,,,5,1,1,0,1
3882_0,,,,2,2,1,3
C(C(CCO)C(C(C(O)=O)=O)O)=O,,,5,1,1,0,1
3884_0,,,,2,2,1,3
C(CC(C(C(O)=O)=O)O)=O,,,5,1,3,0,3
3886_0,,,,2,2,1,3
C(C(C(C)O)C(C(C(O)=O)=O)O)=O,,,5,1,2,0,2
3886_1,,,,2,2,1,3
3888_0,,,,2,2,1,3
C(C(C=O)C(C(C(O)=O)=O)O)(O)=O,,,5,1,2,0,2
3888_1,,,,2,2,1,3
3890_0,,,,2,2,1,3
C(C(C(C(C(C=O)=O)O)O)=O)(O)=O,,,5,1,4,0,4
3890_1,,,,2,2,1,3
3892_0,,,,2,2,1,3
C(C(CO)C(C(C(O)=O)=O)O)=O,,,5,1,4,0,4
3892_1,,,,2,2,1,3
3893_0,,,,2,2,1,3
3893_1,,,,2,2,1,3
3895_0,,,,2,2,1,3
C(C(C=C)C(C(C(O)=O)=O)O)=O,,,5,1,1,0,1
3897_0,,,,2,2,1,3
C(C(CC(C(C(O)=O)=O)O)=O)(O)=O,,,5,1,1,0,1
3898_0,,,,2,2,1,3
3900_0,,,,2,2,1,3
C(C(C)(CC=O)O)(C(C(O)=O)O)=O,,,5,1,1,0,1
3902_0,,,,2,2,1,3
C(C(C(C(CC(C)O)=O)=O)O)(O)=O,,,5,1,1,0,1
3904_0,,,,2,2,1,3
C(CC(C(C(C(O)=O)O)=O)=O)(O)=O,,,5,1,3,0,3
3906_0,,,,2,2,1,3
C(C(C(C(CCO)=O)=O)O)(O)=O,,,5,1,2,0,2
3908_0,,,,2,2,1,3
C(CC(C(C(C(O)=O)(C)O)=O)O)=O,,,5,1,1,0,1
3910_0,,,,2,2,1,3
C(C(C)(C(C=O)(CC=O)O)O)(O)=O,,,5,1,3,0,3
3912_0,,,,2,2,1,3
C(C)(C(CC(C=O)=O)O)=O,,,5,1,1,0,1
3914_0,,,,2,2,1,3
C(C)(C(CC(C(C=O)=O)=O)O)=O,,,5,1,1,0,1
3916_0,,,,2,2,1,3
C(C)(C(C(C(C(C=C)=O)=O)O)O)=O,,,5,1,2,0,2
3916_1,,,,2,2,1,3
3918_0,,,,2,2,1,3
C(C(C(C(C(C(C)=O)O)O)=O)O)=O,,,5,1,2,0,2
3918_1,,,,2,2,1,3
3919_0,,,,2,2,1,3
3919_1,,,,2,2,1,3
3921_0,,,,2,2,1,3
C(C)(C(CC(C(CO)=O)=O)O)=O,,,5,1,1,0,1
3923_0,,,,2,2,1,3
C(C)(C(C(C(C(C)=O)=O)O)O)=O,,,5,1,4,0,4
3923_1,,,,2,2,1,3
3925_0,,,,2,2,1,3
C(CC(CC(C(C)=O)O)=O)(O)=O,,,5,1,1,0,1
3927_0,,,,2,2,1,3
C(C(C(C)=O)C(C(C)=O)O)(O)=O,,,5,1,2,0,2
3927_1,,,,2,2,1,3
3929_0,,,,2,2,1,3
C(CC(C(C)=O)O)(CCO)=O,,,5,1,1,0,1
3931_0,,,,2,2,1,3
C(C)(C(CO)C(C(C)=O)O)=O,,,5,1,2,0,2
3931_1,,,,2,2,1,3
3933_0,,,,2,2,1,3
C(C)(C(CC(CO)=O)O)=O,,,5,1,1,0,1
3935_0,,,,2,2,1,3
C(C)(C(C(C(C)=O)O)O)=O,,,5,1,2,0,2
3935_1,,,,2,2,1,3
3937_0,,,,2,2,1,3
C(C(C=O)C(C=O)C(C(C)=O)O)=O,,,5,1,1,0,1
3939_0,,,,2,2,1,3
C(C(C(C=O)=O)C(C(C)=O)O)=O,,,5,1,2,0,2
3939_1,,,,2,2,1,3
3941_0,,,,2,2,1,3
C(CC(C(C)=O)O)(CC(C=O)=O)=O,,,5,1,1,0,1
3943_0,,,,2,2,1,3
C(C)(C(C(C=O)=O)C(C(C)=O)O)=O,,,5,1,2,0,2
3943_1,,,,2,2,1,3
3945_0,,,,2,2,1,3
C(C(C(C(C(C=O)=O)=O)C)O)(C)=O,,,5,1,1,0,1
3947_0,,,,2,2,1,3
C(C(C(C(C(O)=O)=O)C)O)(C)=O,,,5,1,1,0,1
3949_0,,,,2,2,1,3
C(CC(C(C)=O)O)(C(C)O)=O,,,5,1,1,0,1
3951_0,,,,2,2,1,3
C(C(C(C(CC)=O)O)O)(C)=O,,,5,1,2,0,2
3951_1,,,,2,2,1,3
3953_0,,,,2,2,1,3
C(CO)(C(C)C(C(C)=O)O)=O,,,5,1,1,0,1
3955_0,,,,2,2,1,3
C(C(C=CC(C)O)C(C(C)=O)O)=O,,,5,1,1,0,1
3957_0,,,,2,2,1,3
C(C(C=CC(O)=O)C(C(C)=O)O)=O,,,5,1,1,0,1
3959_0,,,,2,2,1,3
C(C)(C(C(C(C=CC=O)=O)O)O)=O,,,5,1,2,0,2
3959_1,,,,2,2,1,3
3961_0,,,,2,2,1,3
C(C)(C(CC(C(C(O)=O)=C)=O)O)=O,,,5,1,1,0,1
3963_0,,,,2,2,1,3
C(C(CCO)C(C(C)=O)O)=O,,,5,1,1,0,1
3965_0,,,,2,2,1,3
C(C(C1C(C(OC1)=O)=O)O)(C)=O,,,5,1,2,0,2
3965_1,,,,2,2,1,3
3967_0,,,,2,2,1,3
C(C)(C(C1C(C(C(O1)=O)=O)=O)O)=O,,,5,1,2,0,2
3967_1,,,,2,2,1,3
3969_0,,,,2,2,1,3
C(C(C(CO)C)C(C(C)=O)O)=O,,,5,1,1,0,1
3971_0,,,,2,2,1,3
C(C(C(C)CCO)C(C(C)=O)O)=O,,,5,1,1,0,1
3973_0,,,,2,2,1,3
C(C(C(C)C(C)O)C(C(C)=O)O)=O,,,5,1,1,0,1
3975_0,,,,2,2,1,3
C(CC(C)C(C=O)C(C(C)=O)O)=O,,,5,1,1,0,1
3977_0,,,,2,2,1,3
C(CC(C(C)=O)O)=O,,,5,1,3,0,3
3979_0,,,,2,2,1,3
C(C(C(C)O)C(C(C)=O)O)=O,,,5,1,2,0,2
3979_1,,,,2,2,1,3
3981_0,,,,2,2,1,3
C(C(C=O)C(C(C)=O)O)(O)=O,,,5,1,2,0,2
3981_1,,,,2,2,1,3
3983_0,,,,2,2,1,3
C(C)(C(C(C(C=O)=O)O)O)=O,,,5,1,4,0,4
3983_1,,,,2,2,1,3
3985_0,,,,2,2,1,3
C(C(CO)C(C(C)=O)O)=O,,,5,1,2,0,2
3985_1,,,,2,2,1,3
3987_0,,,,2,2,1,3
C(C(C(C(C(O)=O)=O)CO)O)(C)=O,,,5,1,2,0,2
3987_1,,,,2,2,1,3
3989_0,,,,2,2,1,3
C(C(C(C(C)=O)=O)C(C(C)=O)O)=O,,,5,1,2,0,2
3989_1,,,,2,2,1,3
3991_0,,,,2,2,1,3
C(CC(C(CC(C(C)=O)O)=O)=O)=O,,,5,1,1,0,1
3993_0,,,,2,2,1,3
C(C)(C(C(C(CO)=O)O)O)=O,,,5,1,4,0,4
3993_1,,,,2,2,1,3
3994_0,,,,2,2,1,3
3994_1,,,,2,2,1,3
3996_0,,,,2,2,1,3
C(C(C=C)C(C(C)=O)O)=O,,,5,1,1,0,1
3998_0,,,,2,2,1,3
C(C)(C(C(C=C)C(C(O)=O)=O)O)=O,,,5,1,1,0,1
4000_0,,,,2,2,1,3
C(C(C(C(O)=O)=C)C(C(C)=O)O)=O,,,5,1,1,0,1
4002_0,,,,2,2,1,3
C(C(C1C(C(OC1C)=O)=O)O)(C)=O,,,5,1,2,0,2
4002_1,,,,2,2,1,3
4004_0,,,,2,2,1,3
C1(C(C(C(O1)=O)=O)C(C(C)=O)O)=O,,,5,1,2,0,2
4004_1,,,,2,2,1,3
4006_0,,,,2,2,1,3
C(C)(C(CC(C(O)=O)=O)O)=O,,,5,1,1,0,1
4008_0,,,,2,2,1,3
C(C(C)(CC(C=O)=O)O)=O,,,5,1,1,0,1
4010_0,,,,2,2,1,3
C(C(C)(CC(C(C=O)=O)=O)O)=O,,,5,1,1,0,1
4012_0,,,,2,2,1,3
C(C(C)(C(C(C(C=C)=O)=O)O)O)=O,,,5,1,2,0,2
4012_1,,,,2,2,1,3
4014_0,,,,2,2,1,3
C(C(C)(C(C(C(C=O)O)=O)O)O)=O,,,5,1,2,0,2
4014_1,,,,2,2,1,3
4016_0,,,,2,2,1,3
C(C(C)(C(C=O)O)O)=O,,,5,1,3,0,3
4016_1,,,,2,2,1,3
4018_0,,,,2,2,1,3
C(C(C)(CC(C(CO)=O)=O)O)=O,,,5,1,1,0,1
4020_0,,,,2,2,1,3
C(C(C)(C(C(C(C)=O)=O)O)O)=O,,,5,1,3,0,3
4020_1,,,,2,2,1,3
4022_0,,,,2,2,1,3
C(C(C)(CC(CC(O)=O)=O)O)=O,,,5,1,1,0,1
4024_0,,,,2,2,1,3
C(C(C)(C(C(O)=O)C(C)=O)O)=O,,,5,1,2,0,2
4024_1,,,,2,2,1,3
4026_0,,,,2,2,1,3
C(C(C)(CC(CCO)=O)O)=O,,,5,1,1,0,1
4028_0,,,,2,2,1,3
C(C(C)(C(C(C)=O)CO)O)=O,,,5,1,2,0,2
4028_1,,,,2,2,1,3
4030_0,,,,2,2,1,3
C(C(C)(CC(CO)=O)O)=O,,,5,1,1,0,1
4032_0,,,,2,2,1,3
C(C(C)(C(C(C)=O)O)O)=O,,,5,1,3,0,3
4032_1,,,,2,2,1,3
4034_0,,,,2,2,1,3
C(C(C)(C(C=O)C(C=O)C=O)O)=O,,,5,1,1,0,1
4036_0,,,,2,2,1,3
C(C(C(C=O)=O)C(C=O)(C)O)=O,,,5,1,2,0,2
4036_1,,,,2,2,1,3
4038_0,,,,2,2,1,3
C(C(C)(CC(CC(C=O)=O)=O)O)=O,,,5,1,1,0,1
4040_0,,,,2,2,1,3
C(C(C)(C(C(C)=O)C(C=O)=O)O)=O,,,5,1,2,0,2
4040_1,,,,2,2,1,3
4042_0,,,,2,2,1,3
C(C(C)(C(C(C(C=O)=O)=O)C)O)=O,,,5,1,1,0,1
4044_0,,,,2,2,1,3
C(C(C)(C(C(C(O)=O)=O)C)O)=O,,,5,1,1,0,1
4046_0,,,,2,2,1,3
C(C(C)(CC(C(C)O)=O)O)=O,,,5,1,1,0,1
4048_0,,,,2,2,1,3
C(C(C)(C(C(CC)=O)O)O)=O,,,5,1,2,0,2
4048_1,,,,2,2,1,3
4050_0,,,,2,2,1,3
C(C(C)(C(C(CO)=O)C)O)=O,,,5,1,1,0,1
4052_0,,,,2,2,1,3
C(C(C=CC(C)O)C(C=O)(C)O)=O,,,5,1,1,0,1
4054_0,,,,2,2,1,3
C(C(C=CC(O)=O)C(C=O)(C)O)=O,,,5,1,1,0,1
4056_0,,,,2,2,1,3
C(C(C)(C(C(C=CC=O)=O)O)O)=O,,,5,1,2,0,2
4056_1,,,,2,2,1,3
4058_0,,,,2,2,1,3
C(C(C)(CC(C(C(O)=O)=C)=O)O)=O,,,5,1,1,0,1
4060_0,,,,2,2,1,3
C(C(CCO)C(C=O)(C)O)=O,,,5,1,1,0,1
4062_0,,,,2,2,1,3
C(C(C)(C1C(C(OC1)=O)=O)O)=O,,,5,1,2,0,2
4062_1,,,,2,2,1,3
4064_0,,,,2,2,1,3
C(C(C)(C1C(C(C(O1)=O)=O)=O)O)=O,,,5,1,2,0,2
4064_1,,,,2,2,1,3
4066_0,,,,2,2,1,3
C(C(C(CO)C)C(C=O)(C)O)=O,,,5,1,1,0,1
4068_0,,,,2,2,1,3
C(C(C(C)CCO)C(C=O)(C)O)=O,,,5,1,1,0,1
4070_0,,,,2,2,1,3
C(C(C(C)C(C)O)C(C=O)(C)O)=O,,,5,1,1,0,1
4072_0,,,,2,2,1,3
C(CC(C)C(C=O)C(C=O)(C)O)=O,,,5,1,1,0,1
4074_0,,,,2,2,1,3
C(C(C)(CC=O)O)=O,,,5,1,1,0,1
4076_0,,,,2,2,1,3
C(C(C(C)O)C(C=O)(C)O)=O,,,5,1,2,0,2
4076_1,,,,2,2,1,3
4078_0,,,,2,2,1,3
C(C(C=O)C(C=O)(C)O)(O)=O,,,5,1,2,0,2
4078_1,,,,2,2,1,3
4080_0,,,,2,2,1,3
C(C(C)(C(C(C=O)=O)O)O)=O,,,5,1,3,0,3
4080_1,,,,2,2,1,3
4082_0,,,,2,2,1,3
C(C(CO)C(C=O)(C)O)=O,,,5,1,2,0,2
4082_1,,,,2,2,1,3
4084_0,,,,2,2,1,3
C(C(C)(C(C(C(O)=O)=O)CO)O)=O,,,5,1,2,0,2
4084_1,,,,2,2,1,3
4086_0,,,,2,2,1,3
C(C(C)(C(C=O)C(C(C)=O)=O)O)=O,,,5,1,2,0,2
4086_1,,,,2,2,1,3
4088_0,,,,2,2,1,3
C(C(C)(CC(C(CC=O)=O)=O)O)=O,,,5,1,1,0,1
4090_0,,,,2,2,1,3
C(C(C)(C(C(CO)=O)O)O)=O,,,5,1,3,0,3
4090_1,,,,2,2,1,3
4092_0,,,,2,2,1,3
C(C(C)(C(C(C(O)=O)=O)O)O)=O,,,5,1,3,0,3
4092_1,,,,2,2,1,3
4094_0,,,,2,2,1,3
C(C(C=C)C(C=O)(C)O)=O,,,5,1,1,0,1
4096_0,,,,2,2,1,3
C(C(C)(C(C=C)C(C(O)=O)=O)O)=O,,,5,1,1,0,1
4098_0,,,,2,2,1,3
C(C(C(C(O)=O)=C)C(C=O)(C)O)=O,,,5,1,1,0,1
4100_0,,,,2,2,1,3
C(C(C)(C1C(C(OC1C)=O)=O)O)=O,,,5,1,2,0,2
4100_1,,,,2,2,1,3
4102_0,,,,2,2,1,3
C1(C(C(C(O1)=O)=O)C(C=O)(C)O)=O,,,5,1,2,0,2
4102_1,,,,2,2,1,3
4104_0,,,,2,2,1,3
C(C(C)(CC(C(O)=O)=O)O)=O,,,5,1,1,0,1
4106_0,,,,2,2,1,3
C(C(CC(C(C(C)=O)=O)O)=O)=O,,,5,1,1,0,1
4108_0,,,,2,2,1,3
C(C=O)(C(C)(CC(C=O)=O)O)=O,,,5,1,1,0,1
4110_0,,,,2,2,1,3
C(C(C(C)=O)(CC(C=O)=O)O)=O,,,5,1,1,0,1
4112_0,,,,2,2,1,3
C(C(CC(C(C=O)=O)O)=O)=O,,,5,1,2,0,2
4114_0,,,,2,2,1,3
C(C(C=O)(CC(C=O)=O)O)=O,,,5,1,2,0,2
4116_0,,,,2,2,1,3
C=CC(C(CO)(CC(C=O)=O)O)=O,,,5,1,1,0,1
4118_0,,,,2,2,1,3
C(CO)(C(C=C)(CC(C=O)=O)O)=O,,,5,1,1,0,1
4120_0,,,,2,2,1,3
C(C(CC(C(CC(C)O)O)O)=O)=O,,,5,1,1,0,1
4122_0,,,,2,2,1,3
C(CC(C(CC(C=O)=O)O)O)(O)=O,,,5,1,1,0,1
4124_0,,,,2,2,1,3
C(CO)(C(C(CC(C=O)=O)O)O)=O,,,5,1,3,0,3
4126_0,,,,2,2,1,3
C(C(C(CO)(CC(C=O)=O)O)O)=O,,,5,1,1,0,1
4128_0,,,,2,2,1,3
C(C(CO)(C(CC(C=O)=O)O)O)=O,,,5,1,3,0,3
4130_0,,,,2,2,1,3
C(C(CC(C(CO)O)O)=O)=O,,,5,1,1,0,1
4132_0,,,,2,2,1,3
C(C(CC(CO)O)=O)=O,,,5,1,2,0,2
4134_0,,,,2,2,1,3
C(C(CC(C(C)O)O)=O)=O,,,5,1,1,0,1
4136_0,,,,2,2,1,3
C(C(CC(C=O)=O)O)(O)=O,,,5,1,2,0,2
4138_0,,,,2,2,1,3
C(CO)(C(C)(CC(C=O)=O)O)=O,,,5,1,1,0,1
4140_0,,,,2,2,1,3
C(C)(C(CO)(CC(C=O)=O)O)=O,,,5,1,1,0,1
4142_0,,,,2,2,1,3
C(CC(C)(CC(C=O)=O)O)(O)=O,,,5,1,1,0,1
4144_0,,,,2,2,1,3
C(C(CC(C)(CCO)O)=O)=O,,,5,1,1,0,1
4146_0,,,,2,2,1,3
C(C(CC(C)(CO)O)=O)=O,,,5,1,1,0,1
4148_0,,,,2,2,1,3
C=C(C(O)=O)C(CC(C=O)=O)O,,,5,1,1,0,1
4150_0,,,,2,2,1,3
C(C(C=O)CC(CC(C=O)=O)O)=O,,,5,1,1,0,1
4152_0,,,,2,2,1,3
C(C(C(CC(C=O)=O)O)CC=O)=O,,,5,1,1,0,1
4154_0,,,,2,2,1,3
C(C(CC(CC(C=O)=O)O)=O)=O,,,5,1,1,0,1
4156_0,,,,2,2,1,3
C(CC(C(CC(C=O)=O)O)=O)=O,,,5,1,1,0,1
4158_0,,,,2,2,1,3
C(CC(C=O)(CC(C=O)=O)O)=O,,,5,1,1,0,1
4160_0,,,,2,2,1,3
C(C(CC(C)(CC(C=O)=O)O)=O)=O,,,5,1,1,0,1
4162_0,,,,2,2,1,3
C(C(CC(C=O)=O)O)(CC(C)=O)=O,,,5,1,1,0,1
4164_0,,,,2,2,1,3
C(C(CC(C=O)=O)(CC(C)=O)O)=O,,,5,1,1,0,1
4166_0,,,,2,2,1,3
C(C=O)(C(CC)(CC(C=O)=O)O)=O,,,5,1,1,0,1
4168_0,,,,2,2,1,3
C(C=O)(CC(C(C(CC)=O)=O)O)=O,,,5,1,1,0,1
4170_0,,,,2,2,1,3
C(CC)(C(C=O)(CC(C=O)=O)O)=O,,,5,1,1,0,1
4172_0,,,,2,2,1,3
C(C(CC)(CC(C=O)=O)O)(O)=O,,,5,1,1,0,1
4174_0,,,,2,2,1,3
C(C(CC(C)(C(C)O)O)=O)=O,,,5,1,1,0,1
4176_0,,,,2,2,1,3
C(C(CC(CO)(CC)O)=O)=O,,,5,1,1,0,1
4178_0,,,,2,2,1,3
C(CC(C)O)=CC(CC(C=O)=O)O,,,5,1,1,0,1
4180_0,,,,2,2,1,3
C(CC(CC(C=O)=O)O)=CC(C)O,,,5,1,1,0,1
4182_0,,,,2,2,1,3
C=C(C(CC(C=O)=O)O)C(C)O,,,5,1,1,0,1
4184_0,,,,2,2,1,3
C(C)=C(CO)C(CC(C=O)=O)O,,,5,1,1,0,1
4186_0,,,,2,2,1,3
C(C)=C(C(CC(C=O)=O)O)C(C)O,,,5,1,1,0,1
4188_0,,,,2,2,1,3
C(C)=C(C(O)=O)C(CC(C=O)=O)O,,,5,1,1,0,1
4190_0,,,,2,2,1,3
C(CC=CC(CC(C=O)=O)O)(O)=O,,,5,1,1,0,1
4192_0,,,,2,2,1,3
C(CC(CC(C=O)=O)O)=CC(O)=O,,,5,1,1,0,1
4194_0,,,,2,2,1,3
C(C(CC(C=O)=O)O)=CC(CO)=O,,,5,1,1,0,1
4196_0,,,,2,2,1,3
C(C(CO)(CC(C=O)=O)O)=CC=O,,,5,1,1,0,1
4198_0,,,,2,2,1,3
C(C(CC(C=O)=O)O)=C(C=O)CO,,,5,1,1,0,1
4200_0,,,,2,2,1,3
C(CO)(C(CC(C=O)=O)O)=CC=O,,,5,1,1,0,1
4202_0,,,,2,2,1,3
C(C(CC(C=O)=O)O)(C(C=C)O)=O,,,5,1,1,0,1
4204_0,,,,2,2,1,3
C(C(CC(C=O)=O)(C(C=C)O)O)=O,,,5,1,1,0,1
4206_0,,,,2,2,1,3
C=CC(CC(C=O)=O)O,,,5,1,1,0,1
4208_0,,,,2,2,1,3
C(C(C=C)(CC(C=O)=O)O)(O)=O,,,5,1,1,0,1
4210_0,,,,2,2,1,3
C=C(C(O)=O)C(C)(CC(C=O)=O)O,,,5,1,1,0,1
4212_0,,,,2,2,1,3
C(C(CC(C(CC)O)O)=O)=O,,,5,1,1,0,1
4214_0,,,,2,2,1,3
C(C(CC(CCCO)O)=O)=O,,,5,1,1,0,1
4216_0,,,,2,2,1,3
C(C(CC1(C(O)OCC1O)O)=O)=O,,,5,1,1,0,1
4218_0,,,,2,2,1,3
C1(C(CCO1)(CC(C=O)=O)O)=O,,,5,1,1,0,1
4220_0,,,,2,2,1,3
C1(C(OCC1(CC(C=O)=O)O)=O)=O,,,5,1,1,0,1
4222_0,,,,2,2,1,3
C1(C(C(CO1)=O)(CC(C=O)=O)O)=O,,,5,1,1,0,1
4224_0,,,,2,2,1,3
C(C(CC(CC(C)CO)O)=O)=O,,,5,1,1,0,1
4226_0,,,,2,2,1,3
C(C(CC(CC(C)CCO)O)=O)=O,,,5,1,1,0,1
4228_0,,,,2,2,1,3
C(C(CC(CC(C)C(C)O)O)=O)=O,,,5,1,1,0,1
4230_0,,,,2,2,1,3
C(CC(C)CC(CC(C=O)=O)O)=O,,,5,1,1,0,1
4232_0,,,,2,2,1,3
C(C(CC(C)O)=O)=O,,,5,1,1,0,1
4234_0,,,,2,2,1,3
C(CC(C=O)=O)(O)=O,,,5,1,4,0,4
4236_0,,,,2,2,1,3
C(C(CC(CC(C)O)O)=O)=O,,,5,1,1,0,1
4238_0,,,,2,2,1,3
C(CC(CC(C=O)=O)O)(O)=O,,,5,1,1,0,1
4240_0,,,,2,2,1,3
C(CO)(C(CC(C=O)=O)O)=O,,,5,1,2,0,2
4242_0,,,,2,2,1,3
C(C(CO)(CC(C=O)=O)O)=O,,,5,1,1,0,1
4244_0,,,,2,2,1,3
C(C(CCO)=O)=O,,,5,1,2,0,2
4246_0,,,,2,2,1,3
C(C(CC(C(CO)C(C)O)O)=O)=O,,,5,1,1,0,1
4248_0,,,,2,2,1,3
C(C(CO)C(CC(C=O)=O)O)(O)=O,,,5,1,2,0,2
4250_0,,,,2,2,1,3
C(C(CC(C=O)=O)O)(C(CO)O)=O,,,5,1,1,0,1
4252_0,,,,2,2,1,3
C(C(C(CO)O)(CC(C=O)=O)O)=O,,,5,1,1,0,1
4254_0,,,,2,2,1,3
C(C(CC(CCO)O)=O)=O,,,5,1,1,0,1
4256_0,,,,2,2,1,3
C(C(CCO)(CC(C=O)=O)O)(O)=O,,,5,1,1,0,1
4258_0,,,,2,2,1,3
C(CC(C(C)=O)(CC(C=O)=O)O)=O,,,5,1,1,0,1
4260_0,,,,2,2,1,3
C(C(C)(CC(C=O)=O)O)(CC=O)=O,,,5,1,1,0,1
4262_0,,,,2,2,1,3
C(C=O)(CC(CC(C(C)=O)=O)O)=O,,,5,1,1,0,1
4264_0,,,,2,2,1,3
C(C(CC(C=O)=O)O)=O,,,5,1,1,0,1
4266_0,,,,2,2,1,3
C(C(C(CC(C=O)=O)O)O)=O,,,5,1,3,0,3
4268_0,,,,2,2,1,3
C(C(CC(CO)(CO)O)=O)=O,,,5,1,1,0,1
4270_0,,,,2,2,1,3
C(C(CO)(CC(C=O)=O)O)(O)=O,,,5,1,3,0,3
4272_0,,,,2,2,1,3
C(C(C)(C(CC(C=O)=O)O)O)(O)=O,,,5,1,2,0,2
4274_0,,,,2,2,1,3
C(C(C(CC(C=O)=O)O)O)(O)=O,,,5,1,3,0,3
4276_0,,,,2,2,1,3
C(C(CC(C=O)=O)O)=CC,,,5,1,1,0,1
4278_0,,,,2,2,1,3
C=CCC(CC(C=O)=O)O,,,5,1,1,0,1
4280_0,,,,2,2,1,3
C(C(C=CC)(CC(C=O)=O)O)(O)=O,,,5,1,1,0,1
4282_0,,,,2,2,1,3
C(C(CC(C=O)=O)(CC=C)O)(O)=O,,,5,1,1,0,1
4284_0,,,,2,2,1,3
C=C(C(O)=O)CC(CC(C=O)=O)O,,,5,1,1,0,1
4286_0,,,,2,2,1,3
C(C(CC(C=O)=O)O)=C(C(O)=O)C,,,5,1,1,0,1
4288_0,,,,2,2,1,3
C1(C(CC(C)O1)(CC(C=O)=O)O)=O,,,5,1,1,0,1
4290_0,,,,2,2,1,3
C1(CC(C(O1)=O)(CC(C=O)=O)O)=O,,,5,1,1,0,1
4292_0,,,,2,2,1,3
C(C(C)(CC(C=O)=O)O)(O)=O,,,5,1,2,0,2
4294_0,,,,2,2,1,3
C(C(C(C(C(C)=O)=O)O)O)=O,,,5,1,5,0,5
4294_1,,,,2,2,1,3
4296_0,,,,2,2,1,3
C(CC(C(C(C)=O)=O)O)(CCO)=O,,,5,1,1,0,1
4298_0,,,,2,2,1,3
C(C)(C(CO)C(C(C(C)=O)=O)O)=O,,,5,1,2,0,2
4298_1,,,,2,2,1,3
4300_0,,,,2,2,1,3
C(CO)(CC(C(C(C)=O)=O)O)=O,,,5,1,1,0,1
4301_0,,,,2,2,1,3
4301_1,,,,2,2,1,3
4303_0,,,,2,2,1,3
C(CC(C(C(C)=O)=O)O)(C(C)O)=O,,,5,1,1,0,1
4305_0,,,,2,2,1,3
C(C(C(C(C(C)=O)=O)O)O)(CC)=O,,,5,1,2,0,2
4305_1,,,,2,2,1,3
4307_0,,,,2,2,1,3
C(CO)(C(C)C(C(C(C)=O)=O)O)=O,,,5,1,1,0,1
4309_0,,,,2,2,1,3
C(C(CCO)C(C(C(C)=O)=O)O)=O,,,5,1,1,0,1
4311_0,,,,2,2,1,3
C(CC(C(C(C)=O)=O)O)=O,,,5,1,3,0,3
4313_0,,,,2,2,1,3
C(C(C(C)O)C(C(C(C)=O)=O)O)=O,,,5,1,2,0,2
4313_1,,,,2,2,1,3
4315_0,,,,2,2,1,3
C(C(C=O)C(C(C(C)=O)=O)O)(O)=O,,,5,1,2,0,2
4315_1,,,,2,2,1,3
4317_0,,,,2,2,1,3
C(C(C(C(C(C(C)=O)=O)O)O)=O)=O,,,5,1,4,0,4
4317_1,,,,2,2,1,3
4319_0,,,,2,2,1,3
C(C(CO)C(C(C(C)=O)=O)O)=O,,,5,1,4,0,4
4319_1,,,,2,2,1,3
4321_0,,,,2,2,1,3
C(CO)(C(C(C(C(C)=O)=O)O)O)=O,,,5,1,4,0,4
4321_1,,,,2,2,1,3
4323_0,,,,2,2,1,3
C(C(C=C)C(C(C(C)=O)=O)O)=O,,,5,1,3,0,3
4325_0,,,,2,2,1,3
C(C(CC(C(C(C)=O)=O)O)=O)(O)=O,,,5,1,1,0,1
4327_0,,,,2,2,1,3
C(C(C(C(C=O)=O)(C)O)O)=O,,,5,1,4,0,4
4327_1,,,,2,2,1,3
4329_0,,,,2,2,1,3
C(CC(C(C=O)=O)(C)O)(CCO)=O,,,5,1,1,0,1
4331_0,,,,2,2,1,3
C(C)(C(CO)C(C(C=O)=O)(C)O)=O,,,5,1,2,0,2
4331_1,,,,2,2,1,3
4333_0,,,,2,2,1,3
C(CC(C(C=O)=O)(C)O)(CO)=O,,,5,1,1,0,1
4335_0,,,,2,2,1,3
C(C(C(C(C=O)=O)(C)O)O)(C)=O,,,5,1,3,0,3
4335_1,,,,2,2,1,3
4337_0,,,,2,2,1,3
C(CC(C(C=O)=O)(C)O)(C(C)O)=O,,,5,1,1,0,1
4339_0,,,,2,2,1,3
C(C(C(C(C=O)=O)(C)O)O)(CC)=O,,,5,1,2,0,2
4339_1,,,,2,2,1,3
4341_0,,,,2,2,1,3
C(CO)(C(C)C(C(C=O)=O)(C)O)=O,,,5,1,1,0,1
4343_0,,,,2,2,1,3
C(C(CCO)C(C(C=O)=O)(C)O)=O,,,5,1,1,0,1
4345_0,,,,2,2,1,3
C(CC(C(C=O)=O)(C)O)=O,,,5,1,1,0,1
4347_0,,,,2,2,1,3
C(C(C(C)O)C(C(C=O)=O)(C)O)=O,,,5,1,2,0,2
4347_1,,,,2,2,1,3
4349_0,,,,2,2,1,3
C(C(C=O)C(C(C=O)=O)(C)O)(O)=O,,,5,1,2,0,2
4349_1,,,,2,2,1,3
4351_0,,,,2,2,1,3
C(C=O)(C(C)(C(C(C=O)=O)O)O)=O,,,5,1,3,0,3
4351_1,,,,2,2,1,3
4353_0,,,,2,2,1,3
C(C(CO)C(C(C=O)=O)(C)O)=O,,,5,1,2,0,2
4353_1,,,,2,2,1,3
4355_0,,,,2,2,1,3
C(C(C(C(C=O)=O)(C)O)O)(CO)=O,,,5,1,3,0,3
4355_1,,,,2,2,1,3
4357_0,,,,2,2,1,3
C(C(C=C)C(C(C=O)=O)(C)O)=O,,,5,1,1,0,1
4359_0,,,,2,2,1,3
C(C=O)(C(C)(CC(C(O)=O)=O)O)=O,,,5,1,1,0,1
4361_0,,,,2,2,1,3
C(C(C(C)=O)(C(C=O)O)O)=O,,,5,1,2,0,2
4361_1,,,,2,2,1,3
4363_0,,,,2,2,1,3
C(C)(C(C=O)(CC(CCO)=O)O)=O,,,5,1,1,0,1
4365_0,,,,2,2,1,3
C(C(C(C)=O)(C(C(C)=O)CO)O)=O,,,5,1,2,0,2
4365_1,,,,2,2,1,3
4367_0,,,,2,2,1,3
C(C(C(C)=O)(CC(CO)=O)O)=O,,,5,1,1,0,1
4369_0,,,,2,2,1,3
C(C(C(C)=O)(C(C(C)=O)O)O)=O,,,5,1,2,0,2
4369_1,,,,2,2,1,3
4371_0,,,,2,2,1,3
C(C)(C(C=O)(CC(C(C)O)=O)O)=O,,,5,1,1,0,1
4373_0,,,,2,2,1,3
C(C)(C(C=O)(C(C(CC)=O)O)O)=O,,,5,1,2,0,2
4373_1,,,,2,2,1,3
4375_0,,,,2,2,1,3
C(C)(C(C=O)(C(C(CO)=O)C)O)=O,,,5,1,1,0,1
4377_0,,,,2,2,1,3
C(C(CCO)C(C=O)(C(C)=O)O)=O,,,5,1,1,0,1
4379_0,,,,2,2,1,3
C(C(C(C)=O)(CC=O)O)=O,,,5,1,2,0,2
4381_0,,,,2,2,1,3
C(C(C(C)O)C(C=O)(C(C)=O)O)=O,,,5,1,2,0,2
4381_1,,,,2,2,1,3
4383_0,,,,2,2,1,3
C(C(C=O)C(C=O)(C(C)=O)O)(O)=O,,,5,1,2,0,2
4383_1,,,,2,2,1,3
4385_0,,,,2,2,1,3
C(C(C(C)=O)(C(C(C=O)=O)O)O)=O,,,5,1,2,0,2
4385_1,,,,2,2,1,3
4387_0,,,,2,2,1,3
C(C(CO)C(C=O)(C(C)=O)O)=O,,,5,1,3,0,3
4387_1,,,,2,2,1,3
4389_0,,,,2,2,1,3
C(C(C(C)=O)(C(C(CO)=O)O)O)=O,,,5,1,2,0,2
4389_1,,,,2,2,1,3
4391_0,,,,2,2,1,3
C(C(C=C)C(C=O)(C(C)=O)O)=O,,,5,1,2,0,2
4393_0,,,,2,2,1,3
C(C(C(C)=O)(CC(C(O)=O)=O)O)=O,,,5,1,1,0,1
4395_0,,,,2,2,1,3
C(C(C(CC(C(C=O)=O)=O)O)=O)=O,,,5,1,1,0,1
4397_0,,,,2,2,1,3
C(C(C=O)(CC(C(C=O)=O)=O)O)=O,,,5,1,1,0,1
4399_0,,,,2,2,1,3
C(C(C(CC(C(CO)O)O)=O)=O)=O,,,5,1,1,0,1
4401_0,,,,2,2,1,3
C(C(C(CC(CO)O)=O)=O)=O,,,5,1,1,0,1
4403_0,,,,2,2,1,3
C(C(C(CC(C(C)O)O)=O)=O)=O,,,5,1,1,0,1
4405_0,,,,2,2,1,3
C(C(CC(C(C=O)=O)=O)O)(O)=O,,,5,1,2,0,2
4407_0,,,,2,2,1,3
C(C(C(CC(C)(CCO)O)=O)=O)=O,,,5,1,1,0,1
4409_0,,,,2,2,1,3
C(C(C(CC(C)(CO)O)=O)=O)=O,,,5,1,1,0,1
4411_0,,,,2,2,1,3
C(C(C(CC(C)(C(C)O)O)=O)=O)=O,,,5,1,1,0,1
4413_0,,,,2,2,1,3
C(C(C(CC(CO)(CC)O)=O)=O)=O,,,5,1,1,0,1
4415_0,,,,2,2,1,3
C=CC(CC(C(C=O)=O)=O)O,,,5,1,1,0,1
4417_0,,,,2,2,1,3
C(C(C(CC(C(CC)O)O)=O)=O)=O,,,5,1,1,0,1
4419_0,,,,2,2,1,3
C(C(C(CC(CCCO)O)=O)=O)=O,,,5,1,1,0,1
4421_0,,,,2,2,1,3
C(C(C(CC(C)O)=O)=O)=O,,,5,1,1,0,1
4423_0,,,,2,2,1,3
C(CC(C(C=O)=O)=O)(O)=O,,,5,1,1,0,1
4425_0,,,,2,2,1,3
C(C(C(CC(CC(C)O)O)=O)=O)=O,,,5,1,1,0,1
4427_0,,,,2,2,1,3
C(CC(CC(C(C=O)=O)=O)O)(O)=O,,,5,1,1,0,1
4429_0,,,,2,2,1,3
C(CO)(C(CC(C(C=O)=O)=O)O)=O,,,5,1,1,0,1
4431_0,,,,2,2,1,3
C(C(CO)(CC(C(C=O)=O)=O)O)=O,,,5,1,1,0,1
4433_0,,,,2,2,1,3
C(C(C(CCO)=O)=O)=O,,,5,1,1,0,1
4435_0,,,,2,2,1,3
C(C(C(CC(CCO)O)=O)=O)=O,,,5,1,1,0,1
4437_0,,,,2,2,1,3
C(C(CC(C(C=O)=O)=O)O)=O,,,5,1,3,0,3
4439_0,,,,2,2,1,3
C(C(C(CC(C(C=O)=O)=O)O)O)=O,,,5,1,1,0,1
4441_0,,,,2,2,1,3
C(C(C(CC(CO)(CO)O)=O)=O)=O,,,5,1,1,0,1
4443_0,,,,2,2,1,3
C(C(CC(C(C=O)=O)=O)O)=CC,,,5,1,1,0,1
4445_0,,,,2,2,1,3
C=CCC(CC(C(C=O)=O)=O)O,,,5,1,1,0,1
4447_0,,,,2,2,1,3
C(C(C)(CC(C(C=O)=O)=O)O)(O)=O,,,5,1,1,0,1
4448_0,,,,2,2,1,3
4448_1,,,,2,2,1,3
4450_0,,,,2,2,1,3
C(C(C(CC(C(CO)=O)=O)O)=O)=O,,,5,1,1,0,1
4451_0,,,,2,2,1,3
4451_1,,,,2,2,1,3
4453_0,,,,2,2,1,3
C(CC(CC(C(C=O)=O)O)=O)(O)=O,,,5,1,1,0,1
4455_0,,,,2,2,1,3
C(C(C(C)=O)C(C(C=O)=O)O)(O)=O,,,5,1,2,0,2
4455_1,,,,2,2,1,3
4457_0,,,,2,2,1,3
C(CC(C(C=O)=O)O)(CCO)=O,,,5,1,1,0,1
4459_0,,,,2,2,1,3
C(C)(C(CO)C(C(C=O)=O)O)=O,,,5,1,2,0,2
4459_1,,,,2,2,1,3
4461_0,,,,2,2,1,3
C(CO)(CC(C(C=O)=O)O)=O,,,5,1,1,0,1
4462_0,,,,2,2,1,3
4462_1,,,,2,2,1,3
4464_0,,,,2,2,1,3
C(C(C(C=O)=O)C(C(C=O)=O)O)=O,,,5,1,2,0,2
4464_1,,,,2,2,1,3
4466_0,,,,2,2,1,3
C(C(O)=O)(C(C)C(C(C=O)=O)O)=O,,,5,1,1,0,1
4468_0,,,,2,2,1,3
C(CC(C(C=O)=O)O)(C(C)O)=O,,,5,1,1,0,1
4470_0,,,,2,2,1,3
C(C(C(C(C=O)=O)O)O)(CC)=O,,,5,1,2,0,2
4470_1,,,,2,2,1,3
4472_0,,,,2,2,1,3
C(CO)(C(C)C(C(C=O)=O)O)=O,,,5,1,1,0,1
4474_0,,,,2,2,1,3
C(C(CCO)C(C(C=O)=O)O)=O,,,5,1,1,0,1
4476_0,,,,2,2,1,3
C1(C(OCC1C(C(C=O)=O)O)=O)=O,,,5,1,2,0,2
4476_1,,,,2,2,1,3
4478_0,,,,2,2,1,3
C(C(C(C1C(C(C(O1)=O)=O)=O)O)=O)=O,,,5,1,2,0,2
4478_1,,,,2,2,1,3
4480_0,,,,2,2,1,3
C(C(C(CO)C)C(C(C=O)=O)O)=O,,,5,1,1,0,1
4482_0,,,,2,2,1,3
C(CC(C(C=O)=O)O)=O,,,5,1,4,0,4
4484_0,,,,2,2,1,3
C(C(C(C)O)C(C(C=O)=O)O)=O,,,5,1,3,0,3
4484_1,,,,2,2,1,3
4486_0,,,,2,2,1,3
C(C(C=O)C(C(C=O)=O)O)(O)=O,,,5,1,5,0,5
4486_1,,,,2,2,1,3
4488_0,,,,2,2,1,3
C(C(C(C(C(C=O)=O)O)O)=O)=O,,,5,1,3,0,3
4488_1,,,,2,2,1,3
4490_0,,,,2,2,1,3
C(C(CO)C(C(C=O)=O)O)=O,,,5,1,5,0,5
4490_1,,,,2,2,1,3
4491_0,,,,2,2,1,3
4491_1,,,,2,2,1,3
4492_0,,,,2,2,1,3
4492_1,,,,2,2,1,3
4494_0,,,,2,2,1,3
C(C(C=C)C(C(C=O)=O)O)=O,,,5,1,2,0,2
4496_0,,,,2,2,1,3
C1(C(C(C(O1)=O)=O)C(C(C=O)=O)O)=O,,,5,1,2,0,2
4496_1,,,,2,2,1,3
4498_0,,,,2,2,1,3
C(C(CC(C(C=O)=O)O)=O)(O)=O,,,5,1,3,0,3
4499_0,,,,2,2,1,3
4499_1,,,,2,2,1,3
4501_0,,,,2,2,1,3
C(C(C=O)(CC(C(CO)=O)=O)O)=O,,,5,1,1,0,1
4503_0,,,,2,2,1,3
C(C(C=O)(C(C(C(C)=O)=O)O)O)=O,,,5,1,4,0,4
4503_1,,,,2,2,1,3
4505_0,,,,2,2,1,3
C(C(C=O)(CC(CC(O)=O)=O)O)=O,,,5,1,1,0,1
4507_0,,,,2,2,1,3
C(C(C(C)=O)C(C=O)(C=O)O)(O)=O,,,5,1,2,0,2
4507_1,,,,2,2,1,3
4509_0,,,,2,2,1,3
C(C(C=O)(CC(CCO)=O)O)=O,,,5,1,1,0,1
4511_0,,,,2,2,1,3
C(C(C=O)(C(C(C)=O)CO)O)=O,,,5,1,2,0,2
4511_1,,,,2,2,1,3
4513_0,,,,2,2,1,3
C(C(C=O)(CC(CO)=O)O)=O,,,5,1,1,0,1
4515_0,,,,2,2,1,3
C(C(C=O)(C(C(C)=O)O)O)=O,,,5,1,4,0,4
4515_1,,,,2,2,1,3
4517_0,,,,2,2,1,3
C(C(C(C=O)=O)C(C=O)(C=O)O)=O,,,5,1,2,0,2
4517_1,,,,2,2,1,3
4519_0,,,,2,2,1,3
C(C(C=O)(C(C(C(O)=O)=O)C)O)=O,,,5,1,1,0,1
4521_0,,,,2,2,1,3
C(C(C=O)(CC(C(C)O)=O)O)=O,,,5,1,1,0,1
4523_0,,,,2,2,1,3
C(C(C=O)(C(C(CC)=O)O)O)=O,,,5,1,2,0,2
4523_1,,,,2,2,1,3
4525_0,,,,2,2,1,3
C(C(C=O)(C(C(CO)=O)C)O)=O,,,5,1,1,0,1
4527_0,,,,2,2,1,3
C(C(C=O)(C(C=O)CCO)O)=O,,,5,1,1,0,1
4529_0,,,,2,2,1,3
C(C(C=O)(C1C(C(OC1)=O)=O)O)=O,,,5,1,2,0,2
4529_1,,,,2,2,1,3
4531_0,,,,2,2,1,3
C(C(C=O)(C1C(C(C(O1)=O)=O)=O)O)=O,,,5,1,2,0,2
4531_1,,,,2,2,1,3
4533_0,,,,2,2,1,3
C(C(C=O)(C(C=O)C(CO)C)O)=O,,,5,1,1,0,1
4535_0,,,,2,2,1,3
C(C(C=O)(CC=O)O)=O,,,5,1,1,0,1
4537_0,,,,2,2,1,3
C(C(C=O)(C(C=O)C(C)O)O)=O,,,5,1,2,0,2
4537_1,,,,2,2,1,3
4539_0,,,,2,2,1,3
C(C(C=O)C(C=O)(C=O)O)(O)=O,,,5,1,3,0,3
4539_1,,,,2,2,1,3
4541_0,,,,2,2,1,3
C(C(C=O)(C(C(C=O)=O)O)O)=O,,,5,1,5,0,5
4541_1,,,,2,2,1,3
4543_0,,,,2,2,1,3
C(C(C=O)(C(C=O)CO)O)=O,,,5,1,3,0,3
4543_1,,,,2,2,1,3
4544_0,,,,2,2,1,3
4544_1,,,,2,2,1,3
4546_0,,,,2,2,1,3
C(C(C=O)(C(C(C(O)=O)=O)O)O)=O,,,5,1,4,0,4
4546_1,,,,2,2,1,3
4548_0,,,,2,2,1,3
C(C(C=C)C(C=O)(C=O)O)=O,,,5,1,1,0,1
4550_0,,,,2,2,1,3
C1(C(C(C(O1)=O)=O)C(C=O)(C=O)O)=O,,,5,1,2,0,2
4550_1,,,,2,2,1,3
4552_0,,,,2,2,1,3
C(C(C=O)(CC(C(O)=O)=O)O)=O,,,5,1,2,0,2
4554_0,,,,2,2,1,3
C(C(C(C(C(C)=O)=O)=O)CO)(O)=O,,,5,1,2,0,2
4554_1,,,,2,2,1,3
4556_0,,,,2,2,1,3
C(CC(C(C(CCO)=O)=O)=O)(O)=O,,,5,1,1,0,1
4558_0,,,,2,2,1,3
C(C(C(C(C=C)=O)(CO)O)O)=O,,,5,1,2,0,2
4558_1,,,,2,2,1,3
4560_0,,,,2,2,1,3
C(CC(C(C=C)=O)(CO)O)(CO)=O,,,5,1,1,0,1
4562_0,,,,2,2,1,3
C(C(C(C(C=C)=O)(CO)O)O)(C)=O,,,5,1,2,0,2
4562_1,,,,2,2,1,3
4564_0,,,,2,2,1,3
C(CC(C(C=C)=O)(CO)O)=O,,,5,1,2,0,2
4566_0,,,,2,2,1,3
C(C(CO)C(C(C=C)=O)(CO)O)=O,,,5,1,2,0,2
4566_1,,,,2,2,1,3
4568_0,,,,2,2,1,3
C(C(C=C)C(C(C=C)=O)(CO)O)=O,,,5,1,1,0,1
4570_0,,,,2,2,1,3
C(C(C(C(CO)=O)(C=C)O)O)=O,,,5,1,2,0,2
4570_1,,,,2,2,1,3
4572_0,,,,2,2,1,3
C(CO)(C(C=C)(CC(CO)=O)O)=O,,,5,1,1,0,1
4574_0,,,,2,2,1,3
C(CO)(C(C=C)(C(C(C)=O)O)O)=O,,,5,1,2,0,2
4574_1,,,,2,2,1,3
4576_0,,,,2,2,1,3
C(CC(C(CO)=O)(C=C)O)=O,,,5,1,2,0,2
4578_0,,,,2,2,1,3
C(C(CO)C(C(CO)=O)(C=C)O)=O,,,5,1,2,0,2
4578_1,,,,2,2,1,3
4580_0,,,,2,2,1,3
C(C(C=C)C(C(CO)=O)(C=C)O)=O,,,5,1,1,0,1
4582_0,,,,2,2,1,3
C=CC(C(C(C(CO)O)O)=O)=O,,,5,1,2,0,2
4582_1,,,,2,2,1,3
4584_0,,,,2,2,1,3
C=CC(C(C(C(C(C)O)O)O)=O)=O,,,5,1,2,0,2
4584_1,,,,2,2,1,3
4586_0,,,,2,2,1,3
C(C(C(C(C(C=C)=O)=O)O)O)(O)=O,,,5,1,3,0,3
4586_1,,,,2,2,1,3
4588_0,,,,2,2,1,3
C=CC(C(C(C(CO)(C)O)O)=O)=O,,,5,1,2,0,2
4588_1,,,,2,2,1,3
4590_0,,,,2,2,1,3
C=CC(C(C(C(C=C)=O)=O)O)O,,,5,1,2,0,2
4590_1,,,,2,2,1,3
4592_0,,,,2,2,1,3
C=CC(C(C(C(C)O)O)=O)=O,,,5,1,3,0,3
4592_1,,,,2,2,1,3
4594_0,,,,2,2,1,3
C(C(C(C(C=C)=O)=O)O)(O)=O,,,5,1,3,0,3
4594_1,,,,2,2,1,3
4596_0,,,,2,2,1,3
C=CC(C(C(CO)O)=O)=O,,,5,1,3,0,3
4596_1,,,,2,2,1,3
4598_0,,,,2,2,1,3
C=CC(C(C(C(CCO)O)O)=O)=O,,,5,1,2,0,2
4598_1,,,,2,2,1,3
4600_0,,,,2,2,1,3
C(C(C(C(C(C=C)=O)=O)O)O)=O,,,5,1,3,0,3
4600_1,,,,2,2,1,3
4602_0,,,,2,2,1,3
C=CC(C(C(C(C=CC)O)O)=O)=O,,,5,1,2,0,2
4602_1,,,,2,2,1,3
4604_0,,,,2,2,1,3
C(CC(C(C(C(C=C)=O)=O)O)O)=C,,,5,1,2,0,2
4604_1,,,,2,2,1,3
4606_0,,,,2,2,1,3
C=C(C(O)=O)C(C(C(CO)O)=O)=O,,,5,1,2,0,2
4606_1,,,,2,2,1,3
4608_0,,,,2,2,1,3
C(C)(C(C(CO)O)(C(C=O)O)O)=O,,,5,1,4,0,4
4608_1,,,,2,2,1,3
4610_0,,,,2,2,1,3
C(C)(C(C(CO)O)(CC=O)O)=O,,,5,1,2,0,2
4612_0,,,,2,2,1,3
C(C(C)(C(C=O)O)O)(C(CO)O)=O,,,5,1,2,0,2
4612_1,,,,2,2,1,3
4614_0,,,,2,2,1,3
C(C(C)(CC=O)O)(C(CO)O)=O,,,5,1,2,0,2
4616_0,,,,2,2,1,3
C(C(C(CO)O)=O)(CC(CO)O)=O,,,5,1,1,0,1
4618_0,,,,2,2,1,3
C=CC(CC(C(C(CO)O)=O)=O)O,,,5,1,1,0,1
4620_0,,,,2,2,1,3
C(C(C(CO)O)=O)(CC(C)O)=O,,,5,1,3,0,3
4622_0,,,,2,2,1,3
C(CC(C(C(CO)O)=O)=O)(O)=O,,,5,1,7,0,7
4624_0,,,,2,2,1,3
C(C(C(CO)O)=O)(CCO)=O,,,5,1,2,0,2
4626_0,,,,2,2,1,3
C(C(CC(C(C(CO)O)=O)=O)O)=O,,,5,1,2,0,2
4628_0,,,,2,2,1,3
C1(C(C(C(C(CO)O1)=O)=O)(C)O)=O,,,5,1,2,0,2
4628_1,,,,2,2,1,3
4630_0,,,,2,2,1,3
C(C(C(C(CC(C)O)O)O)O)=O,,,5,1,3,0,3
4630_1,,,,2,2,1,3
4632_0,,,,2,2,1,3
C(CO)(CC(C(CC(C)O)O)O)=O,,,5,1,1,0,1
4634_0,,,,2,2,1,3
C(C)(C(C(C(CC(C)O)O)O)O)=O,,,5,1,2,0,2
4634_1,,,,2,2,1,3
4636_0,,,,2,2,1,3
C(CC(C(CC(C)O)O)O)=O,,,5,1,1,0,1
4638_0,,,,2,2,1,3
C(C(CO)C(C(CC(C)O)O)O)=O,,,5,1,2,0,2
4638_1,,,,2,2,1,3
4640_0,,,,2,2,1,3
C(C(C=C)C(C(CC(C)O)O)O)=O,,,5,1,1,0,1
4642_0,,,,2,2,1,3
C(CC(C(C(C=O)O)O)O)(O)=O,,,5,1,3,0,3
4642_1,,,,2,2,1,3
4644_0,,,,2,2,1,3
C(CC(C(CC(CO)=O)O)O)(O)=O,,,5,1,1,0,1
4646_0,,,,2,2,1,3
C(CC(C(C(C(C)=O)O)O)O)(O)=O,,,5,1,2,0,2
4646_1,,,,2,2,1,3
4648_0,,,,2,2,1,3
C(CC(C(CC=O)O)O)(O)=O,,,5,1,1,0,1
4650_0,,,,2,2,1,3
C(C(CO)C(C(CC(O)=O)O)O)=O,,,5,1,2,0,2
4650_1,,,,2,2,1,3
4652_0,,,,2,2,1,3
C(C(C=C)C(C(CC(O)=O)O)O)=O,,,5,1,1,0,1
4653_0,,,,2,2,1,3
4653_1,,,,2,2,1,3
4655_0,,,,2,2,1,3
C(CO)(CC(C(C(CO)=O)O)O)=O,,,5,1,1,0,1
4657_0,,,,2,2,1,3
C(C)(C(C(C(C(CO)=O)O)O)O)=O,,,5,1,2,0,2
4657_1,,,,2,2,1,3
4659_0,,,,2,2,1,3
C(CC(C(C(CO)=O)O)O)=O,,,5,1,2,0,2
4661_0,,,,2,2,1,3
C(C(CO)C(C(C(CO)=O)O)O)=O,,,5,1,3,0,3
4661_1,,,,2,2,1,3
4663_0,,,,2,2,1,3
C(C(C=C)C(C(C(CO)=O)O)O)=O,,,5,1,2,0,2
4665_0,,,,2,2,1,3
C(C(C(CO)(C(C=O)O)O)O)=O,,,5,1,2,0,2
4665_1,,,,2,2,1,3
4667_0,,,,2,2,1,3
C(C(C(CO)(CC(CO)=O)O)O)=O,,,5,1,1,0,1
4669_0,,,,2,2,1,3
C(C(C(CO)(C(C(C)=O)O)O)O)=O,,,5,1,4,0,4
4669_1,,,,2,2,1,3
4671_0,,,,2,2,1,3
C(CC(CO)(C(C=O)O)O)=O,,,5,1,2,0,2
4673_0,,,,2,2,1,3
C(C(CO)C(CO)(C(C=O)O)O)=O,,,5,1,2,0,2
4673_1,,,,2,2,1,3
4675_0,,,,2,2,1,3
C(C(C=C)C(CO)(C(C=O)O)O)=O,,,5,1,1,0,1
4677_0,,,,2,2,1,3
C(C(C(C(C(CO)O)O)=O)O)=O,,,5,1,2,0,2
4677_1,,,,2,2,1,3
4679_0,,,,2,2,1,3
C(C(C(C(C(C(C)O)O)O)=O)O)=O,,,5,1,2,0,2
4679_1,,,,2,2,1,3
4681_0,,,,2,2,1,3
C(C(C(C(C(C(O)=O)O)O)=O)O)=O,,,5,1,3,0,3
4681_1,,,,2,2,1,3
4683_0,,,,2,2,1,3
C(C(C(C(C(CO)(C)O)O)=O)O)=O,,,5,1,2,0,2
4683_1,,,,2,2,1,3
4685_0,,,,2,2,1,3
C(C(C(C(C(C=C)O)O)=O)O)=O,,,5,1,2,0,2
4685_1,,,,2,2,1,3
4687_0,,,,2,2,1,3
C(C(C(C(C(C)O)O)=O)O)=O,,,5,1,2,0,2
4687_1,,,,2,2,1,3
4689_0,,,,2,2,1,3
C(C(C(C(C=O)O)=O)O)(O)=O,,,5,1,3,0,3
4689_1,,,,2,2,1,3
4691_0,,,,2,2,1,3
C(C(C(C(CO)O)=O)O)=O,,,5,1,3,0,3
4691_1,,,,2,2,1,3
4693_0,,,,2,2,1,3
C(C(C(C(C(CCO)O)O)=O)O)=O,,,5,1,2,0,2
4693_1,,,,2,2,1,3
4695_0,,,,2,2,1,3
C(C(C(C(C(C=O)O)O)=O)O)=O,,,5,1,7,0,7
4695_1,,,,2,2,1,3
4697_0,,,,2,2,1,3
C(C(C(C(C(C=CC)O)O)=O)O)=O,,,5,1,2,0,2
4697_1,,,,2,2,1,3
4699_0,,,,2,2,1,3
C(C(C(C(C(CC=C)O)O)=O)O)=O,,,5,1,2,0,2
4699_1,,,,2,2,1,3
4701_0,,,,2,2,1,3
C(C(CO)(C(C(C=O)O)O)O)=O,,,5,1,6,0,6
4701_1,,,,2,2,1,3
4703_0,,,,2,2,1,3
C(C(CO)(C(CC(CO)=O)O)O)=O,,,5,1,1,0,1
4705_0,,,,2,2,1,3
C(C(CO)(C(C(C(C)=O)O)O)O)=O,,,5,1,2,0,2
4705_1,,,,2,2,1,3
4707_0,,,,2,2,1,3
C(C(CO)(C(CC=O)O)O)=O,,,5,1,3,0,3
4709_0,,,,2,2,1,3
C(C(CO)C(C(C=O)(CO)O)O)=O,,,5,1,4,0,4
4709_1,,,,2,2,1,3
4711_0,,,,2,2,1,3
C(C(C=C)C(C(C=O)(CO)O)O)=O,,,5,1,3,0,3
4713_0,,,,2,2,1,3
C(C(C(C(CO)O)O)O)=O,,,5,1,7,0,7
4713_1,,,,2,2,1,3
4715_0,,,,2,2,1,3
C(C(CO)=O)(CC(C(CO)O)O)=O,,,5,1,1,0,1
4717_0,,,,2,2,1,3
C(C(C)=O)(C(C(C(CO)O)O)O)=O,,,5,1,2,0,2
4717_1,,,,2,2,1,3
4719_0,,,,2,2,1,3
C(CC(CC(C(CO)O)O)=O)(O)=O,,,5,1,1,0,1
4721_0,,,,2,2,1,3
C(C(C(C)=O)C(C(CO)O)O)(O)=O,,,5,1,2,0,2
4721_1,,,,2,2,1,3
4723_0,,,,2,2,1,3
C(CC(C(CO)O)O)(CCO)=O,,,5,1,1,0,1
4725_0,,,,2,2,1,3
C(C)(C(CO)C(C(CO)O)O)=O,,,5,1,2,0,2
4725_1,,,,2,2,1,3
4727_0,,,,2,2,1,3
C(CO)(CC(C(CO)O)O)=O,,,5,1,1,0,1
4729_0,,,,2,2,1,3
C(C)(C(C(C(CO)O)O)O)=O,,,5,1,2,0,2
4729_1,,,,2,2,1,3
4731_0,,,,2,2,1,3
C(C(C(C=O)=O)C(C(CO)O)O)=O,,,5,1,2,0,2
4731_1,,,,2,2,1,3
4733_0,,,,2,2,1,3
C(C(C(C)C(C(CO)O)O)=O)(O)=O,,,5,1,1,0,1
4735_0,,,,2,2,1,3
C(C(C)O)(CC(C(CO)O)O)=O,,,5,1,1,0,1
4737_0,,,,2,2,1,3
C(C(C(C(CO)O)O)O)(CC)=O,,,5,1,2,0,2
4737_1,,,,2,2,1,3
4739_0,,,,2,2,1,3
C(CO)(C(C)C(C(CO)O)O)=O,,,5,1,1,0,1
4741_0,,,,2,2,1,3
C(C(CCO)C(C(CO)O)O)=O,,,5,1,1,0,1
4743_0,,,,2,2,1,3
C1(C(C(CO1)C(C(CO)O)O)=O)=O,,,5,1,2,0,2
4743_1,,,,2,2,1,3
4745_0,,,,2,2,1,3
C(C(C(C(CO)O)O)C(C)CO)=O,,,5,1,1,0,1
4747_0,,,,2,2,1,3
C(CC(C(CO)O)O)=O,,,5,1,2,0,2
4749_0,,,,2,2,1,3
C(C(C(C)O)C(C(CO)O)O)=O,,,5,1,3,0,3
4749_1,,,,2,2,1,3
4751_0,,,,2,2,1,3
C(C(C=O)C(C(CO)O)O)(O)=O,,,5,1,3,0,3
4751_1,,,,2,2,1,3
4753_0,,,,2,2,1,3
C(C(C(C(C(CO)O)O)O)=O)=O,,,5,1,3,0,3
4753_1,,,,2,2,1,3
4755_0,,,,2,2,1,3
C(C(CO)C(C(CO)O)O)=O,,,5,1,3,0,3
4755_1,,,,2,2,1,3
4757_0,,,,2,2,1,3
C(CO)(C(C(C(CO)O)O)O)=O,,,5,1,3,0,3
4757_1,,,,2,2,1,3
4758_0,,,,2,2,1,3
4758_1,,,,2,2,1,3
4760_0,,,,2,2,1,3
C(C(C=C)C(C(CO)O)O)=O,,,5,1,2,0,2
4762_0,,,,2,2,1,3
C(C(CC(C(CO)O)O)=O)(O)=O,,,5,1,2,0,2
4764_0,,,,2,2,1,3
C(C(C(CO)O)O)=O,,,5,1,10,0,10
4764_1,,,,2,2,1,3
4766_0,,,,2,2,1,3
C(C(CO)=O)(CC(CO)O)=O,,,5,1,1,0,1
4768_0,,,,2,2,1,3
C(C(C)=O)(C(C(CO)O)O)=O,,,5,1,2,0,2
4768_1,,,,2,2,1,3
4770_0,,,,2,2,1,3
C(CC(CC(CO)O)=O)(O)=O,,,5,1,1,0,1
4772_0,,,,2,2,1,3
C(C(C(C)=O)C(CO)O)(O)=O,,,5,1,2,0,2
4772_1,,,,2,2,1,3
4774_0,,,,2,2,1,3
C(CC(CO)O)(CCO)=O,,,5,1,1,0,1
4776_0,,,,2,2,1,3
C(C)(C(CO)C(CO)O)=O,,,5,1,2,0,2
4776_1,,,,2,2,1,3
4778_0,,,,2,2,1,3
C(C(C(CC(CO)O)=O)(C)O)(O)=O,,,5,1,1,0,1
4780_0,,,,2,2,1,3
C(C(C(C(C)O)=O)C(CO)O)(O)=O,,,5,1,2,0,2
4780_1,,,,2,2,1,3
4782_0,,,,2,2,1,3
C(C(C(C(C(CO)O)O)=O)C)(O)=O,,,5,1,2,0,2
4782_1,,,,2,2,1,3
4784_0,,,,2,2,1,3
C(C(C(C(C)C(CO)O)=O)O)(O)=O,,,5,1,1,0,1
4786_0,,,,2,2,1,3
C(CO)(CC(CO)O)=O,,,5,1,1,0,1
4788_0,,,,2,2,1,3
C(C)(C(C(CO)O)O)=O,,,5,1,4,0,4
4788_1,,,,2,2,1,3
4790_0,,,,2,2,1,3
C(C(C(C(CO)O)=O)C(CO)O)=O,,,5,1,2,0,2
4790_1,,,,2,2,1,3
4792_0,,,,2,2,1,3
C(CC(CO)O)(C(C(CO)=O)O)=O,,,5,1,1,0,1
4794_0,,,,2,2,1,3
C(C(C(CO)O)O)(C(C(C)=O)O)=O,,,5,1,2,0,2
4794_1,,,,2,2,1,3
4796_0,,,,2,2,1,3
C(C(CCO)O)(C(C(CO)O)O)=O,,,5,1,2,0,2
4796_1,,,,2,2,1,3
4798_0,,,,2,2,1,3
C(C(C=O)C(C=O)C(CO)O)=O,,,5,1,1,0,1
4800_0,,,,2,2,1,3
C(C(C(C=O)=O)C(CO)O)=O,,,5,1,2,0,2
4800_1,,,,2,2,1,3
4802_0,,,,2,2,1,3
C(CC(CO)O)(CC(C=O)=O)=O,,,5,1,1,0,1
4804_0,,,,2,2,1,3
C(C)(C(C(C=O)=O)C(CO)O)=O,,,5,1,2,0,2
4804_1,,,,2,2,1,3
4806_0,,,,2,2,1,3
C(C(C(C(C)C(CO)O)=O)=O)=O,,,5,1,1,0,1
4808_0,,,,2,2,1,3
C(C(C(C)C(CO)O)=O)(O)=O,,,5,1,1,0,1
4810_0,,,,2,2,1,3
C(C(C)O)(CC(CO)O)=O,,,5,1,1,0,1
4812_0,,,,2,2,1,3
C(C(C(CO)O)O)(CC)=O,,,5,1,2,0,2
4812_1,,,,2,2,1,3
4814_0,,,,2,2,1,3
C(CO)(C(C)C(CO)O)=O,,,5,1,1,0,1
4816_0,,,,2,2,1,3
C(C)(C(C(CO)O)C(C(O)=O)O)=O,,,5,1,2,0,2
4816_1,,,,2,2,1,3
4818_0,,,,2,2,1,3
C(CC(C(O)=O)O)(CC(CO)O)=O,,,5,1,1,0,1
4820_0,,,,2,2,1,3
C(C(C=CC(C)O)C(CO)O)=O,,,5,1,1,0,1
4822_0,,,,2,2,1,3
C(C(C=CC(O)=O)C(CO)O)=O,,,5,1,1,0,1
4824_0,,,,2,2,1,3
C(C=CC(C(C(CO)O)O)=O)=O,,,5,1,2,0,2
4824_1,,,,2,2,1,3
4826_0,,,,2,2,1,3
C=C(C(O)=O)C(CC(CO)O)=O,,,5,1,1,0,1
4828_0,,,,2,2,1,3
C(C(C(C=O)O)O)(CC(CO)O)=O,,,5,1,1,0,1
4830_0,,,,2,2,1,3
C(C(CCO)C(CO)O)=O,,,5,1,1,0,1
4832_0,,,,2,2,1,3
C(C(C(CCO)C(CO)O)=O)(O)=O,,,5,1,1,0,1
4834_0,,,,2,2,1,3
C(C(CO)C(C=O)C(CO)O)(O)=O,,,5,1,1,0,1
4836_0,,,,2,2,1,3
C1(C(C(CO)O)OC(CC1O)O)=O,,,5,1,2,0,2
4836_1,,,,2,2,1,3
4838_0,,,,2,2,1,3
C1(C(C(CO1)C(CO)O)=O)=O,,,5,1,2,0,2
4838_1,,,,2,2,1,3
4840_0,,,,2,2,1,3
C1(C(C(C(C(CO)O)O1)=O)=O)=O,,,5,1,2,0,2
4840_1,,,,2,2,1,3
4842_0,,,,2,2,1,3
C(C(C(CO)O)C(C)CO)=O,,,5,1,1,0,1
4844_0,,,,2,2,1,3
C(C(C(CO)O)C(C)CCO)=O,,,5,1,1,0,1
4846_0,,,,2,2,1,3
C(C(C(CO)O)C(C)C(C)O)=O,,,5,1,1,0,1
4848_0,,,,2,2,1,3
C(C(C(C)CC(O)=O)C(CO)O)=O,,,5,1,1,0,1
4850_0,,,,2,2,1,3
C(C(C(C)CC=O)C(CO)O)=O,,,5,1,1,0,1
4852_0,,,,2,2,1,3
C(C(C(CO)O)C(C)C(CO)O)=O,,,5,1,1,0,1
4854_0,,,,2,2,1,3
C(CC(CO)O)=O,,,5,1,2,0,2
4856_0,,,,2,2,1,3
C(C(C(CO)O)C(C)O)=O,,,5,1,3,0,3
4856_1,,,,2,2,1,3
4858_0,,,,2,2,1,3
C(C(C(C(CO)O)C(C)O)=O)(O)=O,,,5,1,3,0,3
4858_1,,,,2,2,1,3
4860_0,,,,2,2,1,3
C(C(C=O)C(CO)O)(O)=O,,,5,1,3,0,3
4860_1,,,,2,2,1,3
4862_0,,,,2,2,1,3
C(C(C(CO)O)C(C(O)=O)(C)O)=O,,,5,1,3,0,3
4862_1,,,,2,2,1,3
4864_0,,,,2,2,1,3
C(C(C(C(O)=O)=O)C(CO)O)(O)=O,,,5,1,3,0,3
4864_1,,,,2,2,1,3
4866_0,,,,2,2,1,3
C(C(C(C(CO)O)O)=O)=O,,,5,1,3,0,3
4866_1,,,,2,2,1,3
4868_0,,,,2,2,1,3
C(C(C(CO)O)C(CC(C)O)O)=O,,,5,1,3,0,3
4868_1,,,,2,2,1,3
4870_0,,,,2,2,1,3
C(C(C(CC(O)=O)O)C(CO)O)=O,,,5,1,3,0,3
4870_1,,,,2,2,1,3
4872_0,,,,2,2,1,3
C(C(C(CO)O)C(C(CO)=O)O)=O,,,5,1,3,0,3
4872_1,,,,2,2,1,3
4874_0,,,,2,2,1,3
C(CC(C(C(C(CO)O)O)=O)O)=O,,,5,1,3,0,3
4874_1,,,,2,2,1,3
4876_0,,,,2,2,1,3
C(C(C(CO)O)C(C=O)(CO)O)=O,,,5,1,3,0,3
4876_1,,,,2,2,1,3
4878_0,,,,2,2,1,3
C(C(CO)C(CO)O)=O,,,5,1,3,0,3
4878_1,,,,2,2,1,3
4880_0,,,,2,2,1,3
C(C(C(CO)C(CO)O)=O)(O)=O,,,5,1,3,0,3
4880_1,,,,2,2,1,3
4882_0,,,,2,2,1,3
C(C(C(C(C)=O)=O)C(CO)O)=O,,,5,1,3,0,3
4882_1,,,,2,2,1,3
4884_0,,,,2,2,1,3
C(CC(C(CC(CO)O)=O)=O)=O,,,5,1,2,0,2
4886_0,,,,2,2,1,3
C(C(C(C)O)=O)(C(C(CO)O)O)=O,,,5,1,3,0,3
4886_1,,,,2,2,1,3
4888_0,,,,2,2,1,3
C(C(C(C(C(CO)O)O)=O)=O)(O)=O,,,5,1,3,0,3
4888_1,,,,2,2,1,3
4889_0,,,,2,2,1,3
4889_1,,,,2,2,1,3
4891_0,,,,2,2,1,3
C(C(C(C(CO)O)O)=O)(O)=O,,,5,1,5,0,5
4891_1,,,,2,2,1,3
4893_0,,,,2,2,1,3
C(C(C(CC(CO)O)=O)CO)(O)=O,,,5,1,2,0,2
4895_0,,,,2,2,1,3
C(C(C=C)C(CO)O)=O,,,5,1,2,0,2
4897_0,,,,2,2,1,3
C=CC(C(C(O)=O)=O)C(CO)O,,,5,1,2,0,2
4899_0,,,,2,2,1,3
C(C(C(C(O)=O)=C)C(CO)O)=O,,,5,1,2,0,2
4901_0,,,,2,2,1,3
C1(C(C(C(C)O1)C(CO)O)=O)=O,,,5,1,3,0,3
4901_1,,,,2,2,1,3
4903_0,,,,2,2,1,3
C1(C(C(C(O1)=O)=O)C(CO)O)=O,,,5,1,3,0,3
4903_1,,,,2,2,1,3
4905_0,,,,2,2,1,3
C(C(CC(CO)O)=O)(O)=O,,,5,1,2,0,2
4907_0,,,,2,2,1,3
C(C(C(C(C)O)O)O)=O,,,5,1,3,0,3
4907_1,,,,2,2,1,3
4908_0,,,,2,2,1,3
4908_1,,,,2,2,1,3
4910_0,,,,2,2,1,3
C(CO)(C(C)(C(C=O)O)O)=O,,,5,1,2,0,2
4910_1,,,,2,2,1,3
4912_0,,,,2,2,1,3
C(C)(C(CO)(C(C=O)O)O)=O,,,5,1,4,0,4
4912_1,,,,2,2,1,3
4914_0,,,,2,2,1,3
C(C(C(C(C(C=O)O)O)O)O)(O)=O,,,5,1,6,0,6
4914_1,,,,2,2,1,3
4916_0,,,,2,2,1,3
C(CC(C)(C(C=O)O)O)(O)=O,,,5,1,2,0,2
4916_1,,,,2,2,1,3
4918_0,,,,2,2,1,3
C(C(C(C)(CCO)O)O)=O,,,5,1,2,0,2
4918_1,,,,2,2,1,3
4920_0,,,,2,2,1,3
C(C(C)(C(C)(C(C=O)O)O)O)(O)=O,,,5,1,2,0,2
4920_1,,,,2,2,1,3
4922_0,,,,2,2,1,3
C(CC(C(C)O)(C(C=O)O)O)(O)=O,,,5,1,2,0,2
4922_1,,,,2,2,1,3
4924_0,,,,2,2,1,3
C(C(C)C(CO)(C(C=O)O)O)(O)=O,,,5,1,2,0,2
4924_1,,,,2,2,1,3
4926_0,,,,2,2,1,3
C(C(C(CC)(C(C=O)O)O)O)(O)=O,,,5,1,2,0,2
4926_1,,,,2,2,1,3
4928_0,,,,2,2,1,3
C(C(C(CO)(C)O)O)=O,,,5,1,2,0,2
4928_1,,,,2,2,1,3
4930_0,,,,2,2,1,3
C(C(CO)O)(CC(C(C=O)O)O)=O,,,5,1,2,0,2
4930_1,,,,2,2,1,3
4932_0,,,,2,2,1,3
C(CC(C(CO)O)(C(C=O)O)O)=O,,,5,1,2,0,2
4932_1,,,,2,2,1,3
4934_0,,,,2,2,1,3
C(C(C(C(C)O)(C(C=O)O)O)O)=O,,,5,1,2,0,2
4934_1,,,,2,2,1,3
4936_0,,,,2,2,1,3
C(C(C(C(C(C(C)O)=O)O)O)O)=O,,,5,1,2,0,2
4936_1,,,,2,2,1,3
4938_0,,,,2,2,1,3
C(C(C(C=O)O)(C(C=O)O)O)(O)=O,,,5,1,4,0,4
4938_1,,,,2,2,1,3
4939_0,,,,2,2,1,3
4939_1,,,,2,2,1,3
4941_0,,,,2,2,1,3
C(C(C(C)(C(C(CO)=O)O)O)O)=O,,,5,1,2,0,2
4941_1,,,,2,2,1,3
4942_0,,,,2,2,1,3
4942_1,,,,2,2,1,3
4944_0,,,,2,2,1,3
C(C(C(CO)(C(CCO)O)O)O)=O,,,5,1,2,0,2
4944_1,,,,2,2,1,3
4946_0,,,,2,2,1,3
C(C(C(C(CO)(CCO)O)O)O)=O,,,5,1,2,0,2
4946_1,,,,2,2,1,3
4948_0,,,,2,2,1,3
C(C(C(C(C=O)O)O)(C(C)O)O)=O,,,5,1,2,0,2
4948_1,,,,2,2,1,3
4949_0,,,,2,2,1,3
4949_1,,,,2,2,1,3
4950_0,,,,2,2,1,3
4950_1,,,,2,2,1,3
4952_0,,,,2,2,1,3
C(C(C(C(C(O)=O)=C)O)O)=O,,,5,1,4,0,4
4952_1,,,,2,2,1,3
4954_0,,,,2,2,1,3
C(C(C=O)CC(C(C=O)O)O)=O,,,5,1,2,0,2
4954_1,,,,2,2,1,3
4956_0,,,,2,2,1,3
C(C(C(C(C=O)CC=O)O)O)=O,,,5,1,2,0,2
4956_1,,,,2,2,1,3
4957_0,,,,2,2,1,3
4957_1,,,,2,2,1,3
4959_0,,,,2,2,1,3
C(CC(C(C(C=O)O)O)=O)=O,,,5,1,2,0,2
4959_1,,,,2,2,1,3
4961_0,,,,2,2,1,3
C(CC(C=O)(C(C=O)O)O)=O,,,5,1,3,0,3
4961_1,,,,2,2,1,3
4963_0,,,,2,2,1,3
C(C(C(C)(CC(C=O)=O)O)O)=O,,,5,1,2,0,2
4963_1,,,,2,2,1,3
4965_0,,,,2,2,1,3
C(C(C(C(CC(C)=O)=O)O)O)=O,,,5,1,2,0,2
4965_1,,,,2,2,1,3
4967_0,,,,2,2,1,3
C(C(C(C=O)(CC(C)=O)O)O)=O,,,5,1,2,0,2
4967_1,,,,2,2,1,3
4969_0,,,,2,2,1,3
C(C(C(C(C=O)=O)(CC)O)O)=O,,,5,1,2,0,2
4969_1,,,,2,2,1,3
4971_0,,,,2,2,1,3
C(C(C(C(C(CC)=O)=O)O)O)=O,,,5,1,2,0,2
4971_1,,,,2,2,1,3
4973_0,,,,2,2,1,3
C(CC)(C(C=O)(C(C=O)O)O)=O,,,5,1,2,0,2
4973_1,,,,2,2,1,3
4975_0,,,,2,2,1,3
C(C(CC)(C(C=O)O)O)(O)=O,,,5,1,2,0,2
4975_1,,,,2,2,1,3
4977_0,,,,2,2,1,3
C(C(C(C)(C(C)O)O)O)=O,,,5,1,2,0,2
4977_1,,,,2,2,1,3
4979_0,,,,2,2,1,3
C(C(C(CO)(CC)O)O)=O,,,5,1,2,0,2
4979_1,,,,2,2,1,3
4981_0,,,,2,2,1,3
C(C(CC(C)(C(C=O)O)O)O)(O)=O,,,5,1,2,0,2
4981_1,,,,2,2,1,3
4983_0,,,,2,2,1,3
C(C(C(C=CCC(C)O)O)O)=O,,,5,1,2,0,2
4983_1,,,,2,2,1,3
4985_0,,,,2,2,1,3
C(C(C(CC=CC(C)O)O)O)=O,,,5,1,2,0,2
4985_1,,,,2,2,1,3
4987_0,,,,2,2,1,3
C(C(C(C(C(C)O)=C)O)O)=O,,,5,1,2,0,2
4987_1,,,,2,2,1,3
4989_0,,,,2,2,1,3
C(C(C(C(CO)=CC)O)O)=O,,,5,1,2,0,2
4989_1,,,,2,2,1,3
4991_0,,,,2,2,1,3
C(C(C(C(C(C)O)=CC)O)O)=O,,,5,1,2,0,2
4991_1,,,,2,2,1,3
4993_0,,,,2,2,1,3
C(C(C(C(C(O)=O)=CC)O)O)=O,,,5,1,3,0,3
4993_1,,,,2,2,1,3
4995_0,,,,2,2,1,3
C(CC=CC(C(C=O)O)O)(O)=O,,,5,1,2,0,2
4995_1,,,,2,2,1,3
4997_0,,,,2,2,1,3
C(C(C(CC=CC(O)=O)O)O)=O,,,5,1,2,0,2
4997_1,,,,2,2,1,3
4999_0,,,,2,2,1,3
C(C(C(C=CC(CO)=O)O)O)=O,,,5,1,2,0,2
4999_1,,,,2,2,1,3
5001_0,,,,2,2,1,3
C(C(C(C=CC=O)(CO)O)O)=O,,,5,1,2,0,2
5001_1,,,,2,2,1,3
5003_0,,,,2,2,1,3
C(C(C(C=C(C=O)CO)O)O)=O,,,5,1,2,0,2
5003_1,,,,2,2,1,3
5005_0,,,,2,2,1,3
C(C(C(C(CO)=CC=O)O)O)=O,,,5,1,2,0,2
5005_1,,,,2,2,1,3
5007_0,,,,2,2,1,3
C(C(C(C(C(C=C)O)=O)O)O)=O,,,5,1,2,0,2
5007_1,,,,2,2,1,3
5009_0,,,,2,2,1,3
C(C(C(C=O)(C(C=C)O)O)O)=O,,,5,1,2,0,2
5009_1,,,,2,2,1,3
5011_0,,,,2,2,1,3
C(C(C(C=C)O)O)=O,,,5,1,2,0,2
5011_1,,,,2,2,1,3
5013_0,,,,2,2,1,3
C(C(C=C)(C(C=O)O)O)(O)=O,,,5,1,4,0,4
5013_1,,,,2,2,1,3
5015_0,,,,2,2,1,3
C(C(C(C(C(O)=O)=C)(C)O)O)=O,,,5,1,2,0,2
5015_1,,,,2,2,1,3
5017_0,,,,2,2,1,3
C(C(C(C(C)(C(C=O)O)O)O)O)=O,,,5,1,2,0,2
5017_1,,,,2,2,1,3
5019_0,,,,2,2,1,3
C(C(C(C(C(C(C)=O)O)O)O)O)=O,,,5,1,2,0,2
5019_1,,,,2,2,1,3
5021_0,,,,2,2,1,3
C(C(C(C(CC)O)O)O)=O,,,5,1,2,0,2
5021_1,,,,2,2,1,3
5023_0,,,,2,2,1,3
C(C(C(CCCO)O)O)=O,,,5,1,2,0,2
5023_1,,,,2,2,1,3
5025_0,,,,2,2,1,3
C(C(C(CC)O)(C(C=O)O)O)(O)=O,,,5,1,2,0,2
5025_1,,,,2,2,1,3
5027_0,,,,2,2,1,3
C(C(CCCO)(C(C=O)O)O)(O)=O,,,5,1,2,0,2
5027_1,,,,2,2,1,3
5029_0,,,,2,2,1,3
C(C(CO)CC(C(C=O)O)O)(O)=O,,,5,1,2,0,2
5029_1,,,,2,2,1,3
5031_0,,,,2,2,1,3
C(C(C)C(C(C(C=O)O)O)O)(O)=O,,,5,1,2,0,2
5031_1,,,,2,2,1,3
5033_0,,,,2,2,1,3
C(C(C(C1(COC(C1)O)O)O)O)=O,,,5,1,2,0,2
5033_1,,,,2,2,1,3
5035_0,,,,2,2,1,3
C(C(C1(C(O)OCC1O)O)O)=O,,,5,1,2,0,2
5035_1,,,,2,2,1,3
5037_0,,,,2,2,1,3
C(C(C1(C(O)OC(C)C1O)O)O)=O,,,5,1,2,0,2
5037_1,,,,2,2,1,3
5039_0,,,,2,2,1,3
C1(C(C(C(O)O1)(C(C=O)O)O)O)=O,,,5,1,2,0,2
5039_1,,,,2,2,1,3
5041_0,,,,2,2,1,3
C(C(C1(COC(CC1O)O)O)O)=O,,,5,1,2,0,2
5041_1,,,,2,2,1,3
5043_0,,,,2,2,1,3
C1(C(CCO1)(C(C=O)O)O)=O,,,5,1,2,0,2
5043_1,,,,2,2,1,3
5045_0,,,,2,2,1,3
C(C(C1(C(C(OC1)=O)=O)O)O)=O,,,5,1,2,0,2
5045_1,,,,2,2,1,3
5047_0,,,,2,2,1,3
C1(C(C(CO1)=O)(C(C=O)O)O)=O,,,5,1,2,0,2
5047_1,,,,2,2,1,3
5049_0,,,,2,2,1,3
C(C(C(CC(CO)C)O)O)=O,,,5,1,2,0,2
5049_1,,,,2,2,1,3
5051_0,,,,2,2,1,3
C(C(C(CC(C)CCO)O)O)=O,,,5,1,2,0,2
5051_1,,,,2,2,1,3
5053_0,,,,2,2,1,3
C(C(C(CC(C)C(C)O)O)O)=O,,,5,1,2,0,2
5053_1,,,,2,2,1,3
5055_0,,,,2,2,1,3
C(CC(C)CC(C(C=O)O)O)(O)=O,,,5,1,2,0,2
5055_1,,,,2,2,1,3
5057_0,,,,2,2,1,3
C(CC(C)CC(C(C=O)O)O)=O,,,5,1,2,0,2
5057_1,,,,2,2,1,3
5059_0,,,,2,2,1,3
C(C(C(CC(C)C(CO)O)O)O)=O,,,5,1,2,0,2
5059_1,,,,2,2,1,3
5061_0,,,,2,2,1,3
C(C(C(C)O)O)=O,,,5,1,4,0,4
5061_1,,,,2,2,1,3
5062_0,,,,2,2,1,3
5062_1,,,,2,2,1,3
5064_0,,,,2,2,1,3
C(C(C(CC(C)O)O)O)=O,,,5,1,4,0,4
5064_1,,,,2,2,1,3
5066_0,,,,2,2,1,3
C(C(CC(C)O)(C(C=O)O)O)(O)=O,,,5,1,2,0,2
5066_1,,,,2,2,1,3
5068_0,,,,2,2,1,3
C(CC(C(C=O)O)O)(O)=O,,,5,1,9,0,9
5068_1,,,,2,2,1,3
5070_0,,,,2,2,1,3
C(C(C)(CC(C(C=O)O)O)O)(O)=O,,,5,1,2,0,2
5070_1,,,,2,2,1,3
5072_0,,,,2,2,1,3
C(CC(C(O)=O)(C(C=O)O)O)(O)=O,,,5,1,2,0,2
5072_1,,,,2,2,1,3
5073_0,,,,2,2,1,3
5073_1,,,,2,2,1,3
5075_0,,,,2,2,1,3
C(C(CO)(C(C=O)O)O)=O,,,5,1,7,0,7
5075_1,,,,2,2,1,3
5076_0,,,,2,2,1,3
5076_1,,,,2,2,1,3
5078_0,,,,2,2,1,3
C(C(C(CC(CC(C)O)O)O)O)=O,,,5,1,2,0,2
5078_1,,,,2,2,1,3
5080_0,,,,2,2,1,3
C(C(C(C(CO)C(C)O)O)O)=O,,,5,1,4,0,4
5080_1,,,,2,2,1,3
5082_0,,,,2,2,1,3
C(C(C(C(C(C)O)C(C)O)O)O)=O,,,5,1,2,0,2
5082_1,,,,2,2,1,3
5083_0,,,,2,2,1,3
5083_1,,,,2,2,1,3
5085_0,,,,2,2,1,3
C(CC(CC(C(C=O)O)O)O)(O)=O,,,5,1,2,0,2
5085_1,,,,2,2,1,3
5086_0,,,,2,2,1,3
5086_1,,,,2,2,1,3
5087_0,,,,2,2,1,3
5087_1,,,,2,2,1,3
5089_0,,,,2,2,1,3
C(C(C(CC(C(CO)=O)O)O)O)=O,,,5,1,2,0,2
5089_1,,,,2,2,1,3
5091_0,,,,2,2,1,3
C(CC(C(CO)(C(C=O)O)O)O)=O,,,5,1,2,0,2
5091_1,,,,2,2,1,3
5093_0,,,,2,2,1,3
C(C(CO)(CC(C(C=O)O)O)O)=O,,,5,1,2,0,2
5093_1,,,,2,2,1,3
5094_0,,,,2,2,1,3
5094_1,,,,2,2,1,3
5095_0,,,,2,2,1,3
5095_1,,,,2,2,1,3
5097_0,,,,2,2,1,3
C(C(C(CO)O)(C(C=O)O)O)=O,,,5,1,2,0,2
5097_1,,,,2,2,1,3
5098_0,,,,2,2,1,3
5098_1,,,,2,2,1,3
5100_0,,,,2,2,1,3
C(C(C(C(C)O)O)(C(C=O)O)O)=O,,,5,1,2,0,2
5100_1,,,,2,2,1,3
5101_0,,,,2,2,1,3
5101_1,,,,2,2,1,3
5103_0,,,,2,2,1,3
C(C(C(C=O)(C(C=O)O)O)O)(O)=O,,,5,1,4,0,4
5103_1,,,,2,2,1,3
5105_0,,,,2,2,1,3
C(C(C(CCO)O)O)=O,,,5,1,6,0,6
5105_1,,,,2,2,1,3
5107_0,,,,2,2,1,3
C(C(CCO)(C(C=O)O)O)(O)=O,,,5,1,2,0,2
5107_1,,,,2,2,1,3
5109_0,,,,2,2,1,3
C(CC(C(C)=O)(C(C=O)O)O)=O,,,5,1,2,0,2
5109_1,,,,2,2,1,3
5111_0,,,,2,2,1,3
C(C(C)(C(C=O)O)O)(CC=O)=O,,,5,1,2,0,2
5111_1,,,,2,2,1,3
5113_0,,,,2,2,1,3
C(C(C(CC(C(C)=O)=O)O)O)=O,,,5,1,2,0,2
5113_1,,,,2,2,1,3
5115_0,,,,2,2,1,3
C(C(CO)(C(C=O)O)O)(C(C)O)=O,,,5,1,2,0,2
5115_1,,,,2,2,1,3
5117_0,,,,2,2,1,3
C(CO)(C(C(C)O)(C(C=O)O)O)=O,,,5,1,7,0,7
5117_1,,,,2,2,1,3
5119_0,,,,2,2,1,3
C(C(C(C(C(O)=O)=O)(CO)O)O)=O,,,5,1,7,0,7
5119_1,,,,2,2,1,3
5121_0,,,,2,2,1,3
C(C(C(CO)=O)(C(C=O)O)O)(O)=O,,,5,1,7,0,7
5121_1,,,,2,2,1,3
5123_0,,,,2,2,1,3
C(C(C(C=O)O)O)=O,,,5,1,7,0,7
5123_1,,,,2,2,1,3
5125_0,,,,2,2,1,3
C(C(C(C(C=O)O)O)O)=O,,,5,1,5,0,5
5125_1,,,,2,2,1,3
5127_0,,,,2,2,1,3
C(C(C(CO)(CO)O)O)=O,,,5,1,5,0,5
5127_1,,,,2,2,1,3
5128_0,,,,2,2,1,3
5128_1,,,,2,2,1,3
5129_0,,,,2,2,1,3
5129_1,,,,2,2,1,3
5130_0,,,,2,2,1,3
5130_1,,,,2,2,1,3
5132_0,,,,2,2,1,3
C(C(CO)C(C)(C(C=O)O)O)(O)=O,,,5,1,2,0,2
5132_1,,,,2,2,1,3
5134_0,,,,2,2,1,3
C(C(C(C=CC)O)O)=O,,,5,1,4,0,4
5134_1,,,,2,2,1,3
5136_0,,,,2,2,1,3
C(C(C(CC=C)O)O)=O,,,5,1,4,0,4
5136_1,,,,2,2,1,3
5138_0,,,,2,2,1,3
C(C(C=CC)(C(C=O)O)O)(O)=O,,,5,1,2,0,2
5138_1,,,,2,2,1,3
5140_0,,,,2,2,1,3
C(C(CC=C)(C(C=O)O)O)(O)=O,,,5,1,2,0,2
5140_1,,,,2,2,1,3
5142_0,,,,2,2,1,3
C(C(C(CC(C(O)=O)=C)O)O)=O,,,5,1,2,0,2
5142_1,,,,2,2,1,3
5144_0,,,,2,2,1,3
C(C(C(C=C(C(O)=O)C)O)O)=O,,,5,1,2,0,2
5144_1,,,,2,2,1,3
5146_0,,,,2,2,1,3
C1(C(CC(C)O1)(C(C=O)O)O)=O,,,5,1,2,0,2
5146_1,,,,2,2,1,3
5148_0,,,,2,2,1,3
C1(CC(C(O1)=O)(C(C=O)O)O)=O,,,5,1,2,0,2
5148_1,,,,2,2,1,3
5149_0,,,,2,2,1,3
5149_1,,,,2,2,1,3
5151_0,,,,2,2,1,3
C(C(CO)=O)(CC(C(C)O)O)=O,,,5,1,1,0,1
5153_0,,,,2,2,1,3
C(C(C)=O)(C(C(C(C)O)O)O)=O,,,5,1,2,0,2
5153_1,,,,2,2,1,3
5155_0,,,,2,2,1,3
C(CC(CC(C(C)O)O)=O)(O)=O,,,5,1,1,0,1
5157_0,,,,2,2,1,3
C(C(C(C)=O)C(C(C)O)O)(O)=O,,,5,1,3,0,3
5157_1,,,,2,2,1,3
5159_0,,,,2,2,1,3
C(CC(C(C)O)O)(CCO)=O,,,5,1,1,0,1
5161_0,,,,2,2,1,3
C(C)(C(CO)C(C(C)O)O)=O,,,5,1,2,0,2
5161_1,,,,2,2,1,3
5163_0,,,,2,2,1,3
C(CO)(CC(C(C)O)O)=O,,,5,1,1,0,1
5165_0,,,,2,2,1,3
C(C)(C(C(C(C)O)O)O)=O,,,5,1,2,0,2
5165_1,,,,2,2,1,3
5167_0,,,,2,2,1,3
C(C(C=O)C(C=O)C(C(C)O)O)=O,,,5,1,1,0,1
5169_0,,,,2,2,1,3
C(C(C(C=O)=O)C(C(C)O)O)=O,,,5,1,2,0,2
5169_1,,,,2,2,1,3
5171_0,,,,2,2,1,3
C(CC(C(C)O)O)(CC(C=O)=O)=O,,,5,1,1,0,1
5173_0,,,,2,2,1,3
C(C)(C(C(C=O)=O)C(C(C)O)O)=O,,,5,1,2,0,2
5173_1,,,,2,2,1,3
5175_0,,,,2,2,1,3
C(C(C(C(C)C(C(C)O)O)=O)=O)=O,,,5,1,1,0,1
5177_0,,,,2,2,1,3
C(C(C(C)C(C(C)O)O)=O)(O)=O,,,5,1,1,0,1
5179_0,,,,2,2,1,3
C(C(C)O)(CC(C(C)O)O)=O,,,5,1,1,0,1
5181_0,,,,2,2,1,3
C(C(C(C(C)O)O)O)(CC)=O,,,5,1,2,0,2
5181_1,,,,2,2,1,3
5183_0,,,,2,2,1,3
C(CO)(C(C)C(C(C)O)O)=O,,,5,1,1,0,1
5185_0,,,,2,2,1,3
C(C(C=CC(C)O)C(C(C)O)O)=O,,,5,1,1,0,1
5187_0,,,,2,2,1,3
C(C(C=CC(O)=O)C(C(C)O)O)=O,,,5,1,1,0,1
5189_0,,,,2,2,1,3
C(C=CC(C(C(C(C)O)O)O)=O)=O,,,5,1,2,0,2
5189_1,,,,2,2,1,3
5191_0,,,,2,2,1,3
C=C(C(O)=O)C(CC(C(C)O)O)=O,,,5,1,1,0,1
5193_0,,,,2,2,1,3
C(C(CCO)C(C(C)O)O)=O,,,5,1,1,0,1
5195_0,,,,2,2,1,3
C1(C(C(CO1)C(C(C)O)O)=O)=O,,,5,1,2,0,2
5195_1,,,,2,2,1,3
5197_0,,,,2,2,1,3
C1(C(C(C(C(C(C)O)O)O1)=O)=O)=O,,,5,1,2,0,2
5197_1,,,,2,2,1,3
5199_0,,,,2,2,1,3
C(C(C(C(C)O)O)C(C)CO)=O,,,5,1,1,0,1
5201_0,,,,2,2,1,3
C(C(C(C(C)O)O)C(C)CCO)=O,,,5,1,1,0,1
5203_0,,,,2,2,1,3
C(C(C(C(C)O)O)C(C)C(C)O)=O,,,5,1,1,0,1
5205_0,,,,2,2,1,3
C(C(C(C)CC=O)C(C(C)O)O)=O,,,5,1,1,0,1
5207_0,,,,2,2,1,3
C(CC(C(C)O)O)=O,,,5,1,1,0,1
5209_0,,,,2,2,1,3
C(C(C(C)O)C(C(C)O)O)=O,,,5,1,2,0,2
5209_1,,,,2,2,1,3
5211_0,,,,2,2,1,3
C(C(C=O)C(C(C)O)O)(O)=O,,,5,1,3,0,3
5211_1,,,,2,2,1,3
5213_0,,,,2,2,1,3
C(C(C(C(C(C)O)O)O)=O)=O,,,5,1,2,0,2
5213_1,,,,2,2,1,3
5215_0,,,,2,2,1,3
C(C(CO)C(C(C)O)O)=O,,,5,1,2,0,2
5215_1,,,,2,2,1,3
5217_0,,,,2,2,1,3
C(C(C(CO)C(C(C)O)O)=O)(O)=O,,,5,1,2,0,2
5217_1,,,,2,2,1,3
5219_0,,,,2,2,1,3
C(C(C(C(C)=O)=O)C(C(C)O)O)=O,,,5,1,2,0,2
5219_1,,,,2,2,1,3
5221_0,,,,2,2,1,3
C(CC(C(CC(C(C)O)O)=O)=O)=O,,,5,1,1,0,1
5223_0,,,,2,2,1,3
C(CO)(C(C(C(C)O)O)O)=O,,,5,1,2,0,2
5223_1,,,,2,2,1,3
5225_0,,,,2,2,1,3
C(C(C(C(C(C)O)O)O)=O)(O)=O,,,5,1,2,0,2
5225_1,,,,2,2,1,3
5227_0,,,,2,2,1,3
C(C(C=C)C(C(C)O)O)=O,,,5,1,1,0,1
5229_0,,,,2,2,1,3
C=CC(C(C(O)=O)=O)C(C(C)O)O,,,5,1,1,0,1
5231_0,,,,2,2,1,3
C(C(C(C(O)=O)=C)C(C(C)O)O)=O,,,5,1,1,0,1
5233_0,,,,2,2,1,3
C1(C(C(C(C)O1)C(C(C)O)O)=O)=O,,,5,1,2,0,2
5233_1,,,,2,2,1,3
5235_0,,,,2,2,1,3
C1(C(C(C(O1)=O)=O)C(C(C)O)O)=O,,,5,1,2,0,2
5235_1,,,,2,2,1,3
5237_0,,,,2,2,1,3
C(C(CC(C(C)O)O)=O)(O)=O,,,5,1,1,0,1
5239_0,,,,2,2,1,3
C(C(CC(C(CO)=O)=O)O)(O)=O,,,5,1,4,0,4
5240_0,,,,2,2,1,3
5240_1,,,,2,2,1,3
5242_0,,,,2,2,1,3
C(CC(CC(C(O)=O)O)=O)(O)=O,,,5,1,5,0,5
5244_0,,,,2,2,1,3
C(C(C(C)=O)C(C(O)=O)O)(O)=O,,,5,1,5,0,5
5244_1,,,,2,2,1,3
5246_0,,,,2,2,1,3
C(CC(C(O)=O)O)(CCO)=O,,,5,1,2,0,2
5248_0,,,,2,2,1,3
C(C)(C(CO)C(C(O)=O)O)=O,,,5,1,5,0,5
5248_1,,,,2,2,1,3
5250_0,,,,2,2,1,3
C(C(CC(CO)=O)O)(O)=O,,,5,1,1,0,1
5252_0,,,,2,2,1,3
C(C(C(C(C)=O)O)O)(O)=O,,,5,1,5,0,5
5252_1,,,,2,2,1,3
5254_0,,,,2,2,1,3
C(C(C=O)C(C=O)C(C(O)=O)O)=O,,,5,1,1,0,1
5256_0,,,,2,2,1,3
C(C(C(C=O)=O)C(C(O)=O)O)=O,,,5,1,2,0,2
5256_1,,,,2,2,1,3
5258_0,,,,2,2,1,3
C(C(CC(CC(C=O)=O)=O)O)(O)=O,,,5,1,1,0,1
5260_0,,,,2,2,1,3
C(C(C(C(C)=O)C(C=O)=O)O)(O)=O,,,5,1,2,0,2
5260_1,,,,2,2,1,3
5262_0,,,,2,2,1,3
C(C(C(C(C(C=O)=O)=O)C)O)(O)=O,,,5,1,1,0,1
5264_0,,,,2,2,1,3
C(C(C(C(C(O)=O)=O)C)O)(O)=O,,,5,1,1,0,1
5266_0,,,,2,2,1,3
C(CC(C(O)=O)O)(C(C)O)=O,,,5,1,1,0,1
5268_0,,,,2,2,1,3
C(C(C(C(O)=O)O)O)(CC)=O,,,5,1,2,0,2
5268_1,,,,2,2,1,3
5270_0,,,,2,2,1,3
C(CO)(C(C)C(C(O)=O)O)=O,,,5,1,1,0,1
5272_0,,,,2,2,1,3
C(C(C=CC(C)O)C(C(O)=O)O)=O,,,5,1,1,0,1
5274_0,,,,2,2,1,3
C(C(C=CC(O)=O)C(C(O)=O)O)=O,,,5,1,1,0,1
5276_0,,,,2,2,1,3
C(C(C(C(C=CC=O)=O)O)O)(O)=O,,,5,1,2,0,2
5276_1,,,,2,2,1,3
5278_0,,,,2,2,1,3
C(C(CC(C(C(O)=O)=C)=O)O)(O)=O,,,5,1,1,0,1
5280_0,,,,2,2,1,3
C(C(CCO)C(C(O)=O)O)=O,,,5,1,1,0,1
5282_0,,,,2,2,1,3
C(C(C1C(C(OC1)=O)=O)O)(O)=O,,,5,1,2,0,2
5282_1,,,,2,2,1,3
5284_0,,,,2,2,1,3
C(C(C1C(C(C(O1)=O)=O)=O)O)(O)=O,,,5,1,2,0,2
5284_1,,,,2,2,1,3
5286_0,,,,2,2,1,3
C(C(C(CO)C)C(C(O)=O)O)=O,,,5,1,1,0,1
5288_0,,,,2,2,1,3
C(C(C(C)CCO)C(C(O)=O)O)=O,,,5,1,1,0,1
5290_0,,,,2,2,1,3
C(C(C(C)C(C)O)C(C(O)=O)O)=O,,,5,1,1,0,1
5292_0,,,,2,2,1,3
C(CC(C)C(C=O)C(C(O)=O)O)=O,,,5,1,1,0,1
5294_0,,,,2,2,1,3
C(C(CC=O)O)(O)=O,,,5,1,6,0,6
5296_0,,,,2,2,1,3
C(C(C(C)O)C(C(O)=O)O)=O,,,5,1,5,0,5
5296_1,,,,2,2,1,3
5298_0,,,,2,2,1,3
C(C(C=O)C(C(O)=O)O)(O)=O,,,5,1,6,0,6
5298_1,,,,2,2,1,3
5300_0,,,,2,2,1,3
C(C(C(C(C=O)=O)O)O)(O)=O,,,5,1,7,0,7
5300_1,,,,2,2,1,3
5302_0,,,,2,2,1,3
C(C(CO)C(C(O)=O)O)=O,,,5,1,6,0,6
5302_1,,,,2,2,1,3
5304_0,,,,2,2,1,3
C(C(C(C(C(O)=O)=O)CO)O)(O)=O,,,5,1,3,0,3
5304_1,,,,2,2,1,3
5306_0,,,,2,2,1,3
C(C(C(C(C)=O)=O)C(C(O)=O)O)=O,,,5,1,3,0,3
5306_1,,,,2,2,1,3
5308_0,,,,2,2,1,3
C(CC(C(CC(C(O)=O)O)=O)=O)=O,,,5,1,2,0,2
5309_0,,,,2,2,1,3
5309_1,,,,2,2,1,3
5311_0,,,,2,2,1,3
C(C(C(C(C(O)=O)=O)O)O)(O)=O,,,5,1,4,0,4
5311_1,,,,2,2,1,3
5313_0,,,,2,2,1,3
C(C(C=C)C(C(O)=O)O)=O,,,5,1,3,0,3
5315_0,,,,2,2,1,3
C(C(C(C=C)C(C(O)=O)=O)O)(O)=O,,,5,1,2,0,2
5317_0,,,,2,2,1,3
C(C(C(C(O)=O)=C)C(C(O)=O)O)=O,,,5,1,2,0,2
5319_0,,,,2,2,1,3
C(C(C1C(C(OC1C)=O)=O)O)(O)=O,,,5,1,3,0,3
5319_1,,,,2,2,1,3
5321_0,,,,2,2,1,3
C1(C(C(C(O1)=O)=O)C(C(O)=O)O)=O,,,5,1,3,0,3
5321_1,,,,2,2,1,3
5323_0,,,,2,2,1,3
C(C(CC(C(O)=O)=O)O)(O)=O,,,5,1,5,0,5
5325_0,,,,2,2,1,3
C(CO)(C(C)(CC(CCO)=O)O)=O,,,5,1,1,0,1
5327_0,,,,2,2,1,3
C(C)(C(CO)C(C(CO)=O)(C)O)=O,,,5,1,2,0,2
5327_1,,,,2,2,1,3
5329_0,,,,2,2,1,3
C(CO)(C(C)(CC(CO)=O)O)=O,,,5,1,1,0,1
5331_0,,,,2,2,1,3
C(CO)(C(C)(C(C(C)=O)O)O)=O,,,5,1,2,0,2
5331_1,,,,2,2,1,3
5333_0,,,,2,2,1,3
C(CO)(C(C)(CC(C(C)O)=O)O)=O,,,5,1,1,0,1
5335_0,,,,2,2,1,3
C(CO)(C(C)(C(C(CC)=O)O)O)=O,,,5,1,2,0,2
5335_1,,,,2,2,1,3
5337_0,,,,2,2,1,3
C(CO)(C(C)C(C(CO)=O)(C)O)=O,,,5,1,1,0,1
5339_0,,,,2,2,1,3
C(C(CCO)C(C(CO)=O)(C)O)=O,,,5,1,1,0,1
5341_0,,,,2,2,1,3
C(CO)(C(C)(CC=O)O)=O,,,5,1,1,0,1
5343_0,,,,2,2,1,3
C(C(C(C)O)C(C(CO)=O)(C)O)=O,,,5,1,2,0,2
5343_1,,,,2,2,1,3
5345_0,,,,2,2,1,3
C(C(C=O)C(C(CO)=O)(C)O)(O)=O,,,5,1,2,0,2
5345_1,,,,2,2,1,3
5347_0,,,,2,2,1,3
C(CO)(C(C)(C(C(C=O)=O)O)O)=O,,,5,1,2,0,2
5347_1,,,,2,2,1,3
5349_0,,,,2,2,1,3
C(C(CO)C(C(CO)=O)(C)O)=O,,,5,1,2,0,2
5349_1,,,,2,2,1,3
5351_0,,,,2,2,1,3
C(CO)(C(C)(C(C(CO)=O)O)O)=O,,,5,1,2,0,2
5351_1,,,,2,2,1,3
5353_0,,,,2,2,1,3
C(C(C=C)C(C(CO)=O)(C)O)=O,,,5,1,1,0,1
5355_0,,,,2,2,1,3
C(CO)(C(C)(CC(C(O)=O)=O)O)=O,,,5,1,1,0,1
5357_0,,,,2,2,1,3
C(C)(C(CO)(CC(CCO)=O)O)=O,,,5,1,1,0,1
5359_0,,,,2,2,1,3
C(C)(C(CO)C(C(C)=O)(CO)O)=O,,,5,1,2,0,2
5359_1,,,,2,2,1,3
5361_0,,,,2,2,1,3
C(C)(C(CO)(CC(CO)=O)O)=O,,,5,1,1,0,1
5363_0,,,,2,2,1,3
C(C)(C(CO)(C(C(C)=O)O)O)=O,,,5,1,2,0,2
5363_1,,,,2,2,1,3
5365_0,,,,2,2,1,3
C(C)(C(CO)(CC(C(C)O)=O)O)=O,,,5,1,1,0,1
5367_0,,,,2,2,1,3
C(C)(C(CO)(C(C(CC)=O)O)O)=O,,,5,1,2,0,2
5367_1,,,,2,2,1,3
5369_0,,,,2,2,1,3
C(C)(C(CO)(C(C(CO)=O)C)O)=O,,,5,1,1,0,1
5371_0,,,,2,2,1,3
C(C(CCO)C(C(C)=O)(CO)O)=O,,,5,1,1,0,1
5373_0,,,,2,2,1,3
C(C)(C(CO)(CC=O)O)=O,,,5,1,1,0,1
5375_0,,,,2,2,1,3
C(C(C(C)O)C(C(C)=O)(CO)O)=O,,,5,1,2,0,2
5375_1,,,,2,2,1,3
5377_0,,,,2,2,1,3
C(C(C=O)C(C(C)=O)(CO)O)(O)=O,,,5,1,2,0,2
5377_1,,,,2,2,1,3
5379_0,,,,2,2,1,3
C(C)(C(CO)(C(C(C=O)=O)O)O)=O,,,5,1,2,0,2
5379_1,,,,2,2,1,3
5381_0,,,,2,2,1,3
C(C(CO)C(C(C)=O)(CO)O)=O,,,5,1,2,0,2
5381_1,,,,2,2,1,3
5383_0,,,,2,2,1,3
C(C)(C(CO)(C(C(CO)=O)O)O)=O,,,5,1,2,0,2
5383_1,,,,2,2,1,3
5385_0,,,,2,2,1,3
C(C(C=C)C(C(C)=O)(CO)O)=O,,,5,1,1,0,1
5387_0,,,,2,2,1,3
C(C)(C(CO)(CC(C(O)=O)=O)O)=O,,,5,1,1,0,1
5389_0,,,,2,2,1,3
C(C(CO)=O)(CC(C)(CCO)O)=O,,,5,1,1,0,1
5391_0,,,,2,2,1,3
C(C(CO)=O)(CC(CO)(C)O)=O,,,5,1,1,0,1
5393_0,,,,2,2,1,3
C(C(CO)=O)(CC(C)(C(C)O)O)=O,,,5,1,1,0,1
5395_0,,,,2,2,1,3
C(C(CO)=O)(CC(CO)(CC)O)=O,,,5,1,1,0,1
5397_0,,,,2,2,1,3
C=CC(CC(C(CO)=O)=O)O,,,5,1,1,0,1
5399_0,,,,2,2,1,3
C(C(CO)=O)(CC(C(CC)O)O)=O,,,5,1,1,0,1
5401_0,,,,2,2,1,3
C(C(CO)=O)(CC(CCCO)O)=O,,,5,1,1,0,1
5403_0,,,,2,2,1,3
C(C(CO)=O)(CC(C)O)=O,,,5,1,1,0,1
5404_0,,,,2,2,1,3
5406_0,,,,2,2,1,3
C(C(CO)=O)(CC(CC(C)O)O)=O,,,5,1,1,0,1
5408_0,,,,2,2,1,3
C(CC(CC(C(CO)=O)=O)O)(O)=O,,,5,1,1,0,1
5410_0,,,,2,2,1,3
C(CO)(C(CC(C(CO)=O)=O)O)=O,,,5,1,1,0,1
5412_0,,,,2,2,1,3
C(C(CO)(CC(C(CO)=O)=O)O)=O,,,5,1,1,0,1
5414_0,,,,2,2,1,3
C(C(CO)=O)(CCO)=O,,,5,1,6,0,6
5416_0,,,,2,2,1,3
C(C(CO)=O)(CC(CCO)O)=O,,,5,1,1,0,1
5418_0,,,,2,2,1,3
C(C(CC(C(CO)=O)=O)O)=O,,,5,1,2,0,2
5420_0,,,,2,2,1,3
C(C(C(CC(C(CO)=O)=O)O)O)=O,,,5,1,1,0,1
5422_0,,,,2,2,1,3
C(C(CO)=O)(CC(CO)(CO)O)=O,,,5,1,1,0,1
5424_0,,,,2,2,1,3
C(C)=CC(CC(C(CO)=O)=O)O,,,5,1,1,0,1
5426_0,,,,2,2,1,3
C(CC(CC(C(CO)=O)=O)O)=C,,,5,1,1,0,1
5428_0,,,,2,2,1,3
C(C(C)(CC(C(CO)=O)=O)O)(O)=O,,,5,1,1,0,1
5430_0,,,,2,2,1,3
C(C(C)=O)(C(C(C)(CCO)O)O)=O,,,5,1,2,0,2
5430_1,,,,2,2,1,3
5432_0,,,,2,2,1,3
C(C(C)=O)(C(C(CO)(C)O)O)=O,,,5,1,2,0,2
5432_1,,,,2,2,1,3
5434_0,,,,2,2,1,3
C(C(C)=O)(C(C(C)(C(C)O)O)O)=O,,,5,1,2,0,2
5434_1,,,,2,2,1,3
5436_0,,,,2,2,1,3
C(C(C)=O)(C(C(CO)(CC)O)O)=O,,,5,1,2,0,2
5436_1,,,,2,2,1,3
5438_0,,,,2,2,1,3
C=CC(C(C(C(C)=O)=O)O)O,,,5,1,2,0,2
5438_1,,,,2,2,1,3
5440_0,,,,2,2,1,3
C(C(C)=O)(C(C(C(CC)O)O)O)=O,,,5,1,2,0,2
5440_1,,,,2,2,1,3
5442_0,,,,2,2,1,3
C(C(C)=O)(C(C(CCCO)O)O)=O,,,5,1,2,0,2
5442_1,,,,2,2,1,3
5444_0,,,,2,2,1,3
C(C(C)=O)(C(C(C)O)O)=O,,,5,1,2,0,2
5444_1,,,,2,2,1,3
5445_0,,,,2,2,1,3
5445_1,,,,2,2,1,3
5447_0,,,,2,2,1,3
C(C(C)=O)(C(C(CC(C)O)O)O)=O,,,5,1,2,0,2
5447_1,,,,2,2,1,3
5449_0,,,,2,2,1,3
C(CC(C(C(C(C)=O)=O)O)O)(O)=O,,,5,1,2,0,2
5449_1,,,,2,2,1,3
5450_0,,,,2,2,1,3
5450_1,,,,2,2,1,3
5452_0,,,,2,2,1,3
C(C(CO)(C(C(C(C)=O)=O)O)O)=O,,,5,1,4,0,4
5452_1,,,,2,2,1,3
5453_0,,,,2,2,1,3
5453_1,,,,2,2,1,3
5455_0,,,,2,2,1,3
C(C(C)=O)(C(C(CCO)O)O)=O,,,5,1,2,0,2
5455_1,,,,2,2,1,3
5456_0,,,,2,2,1,3
5456_1,,,,2,2,1,3
5458_0,,,,2,2,1,3
C(C(C(C(C(C(C)=O)=O)O)O)O)=O,,,5,1,2,0,2
5458_1,,,,2,2,1,3
5460_0,,,,2,2,1,3
C(C(C)=O)(C(C(CO)(CO)O)O)=O,,,5,1,2,0,2
5460_1,,,,2,2,1,3
5462_0,,,,2,2,1,3
C(C)=CC(C(C(C(C)=O)=O)O)O,,,5,1,2,0,2
5462_1,,,,2,2,1,3
5464_0,,,,2,2,1,3
C(CC(C(C(C(C)=O)=O)O)O)=C,,,5,1,2,0,2
5464_1,,,,2,2,1,3
5466_0,,,,2,2,1,3
C(C(C)(C(C(C(C)=O)=O)O)O)(O)=O,,,5,1,3,0,3
5466_1,,,,2,2,1,3
5468_0,,,,2,2,1,3
C(CC(C(C(C(O)=O)O)O)O)=O,,,5,1,2,0,2
5470_0,,,,2,2,1,3
C(CC(C)(CC(CCO)=O)O)(O)=O,,,5,1,1,0,1
5472_0,,,,2,2,1,3
C(CC(C)(C(C(C)=O)CO)O)(O)=O,,,5,1,2,0,2
5472_1,,,,2,2,1,3
5474_0,,,,2,2,1,3
C(CC(C)(CC(CO)=O)O)(O)=O,,,5,1,1,0,1
5476_0,,,,2,2,1,3
C(CC(C)(C(C(C)=O)O)O)(O)=O,,,5,1,2,0,2
5476_1,,,,2,2,1,3
5478_0,,,,2,2,1,3
C(CC(C)(CC(C(C)O)=O)O)(O)=O,,,5,1,1,0,1
5480_0,,,,2,2,1,3
C(CC(C)(C(C(CC)=O)O)O)(O)=O,,,5,1,2,0,2
5480_1,,,,2,2,1,3
5482_0,,,,2,2,1,3
C(CC(C)(C(C(CO)=O)C)O)(O)=O,,,5,1,1,0,1
5484_0,,,,2,2,1,3
C(C(CCO)C(C)(CC(O)=O)O)=O,,,5,1,1,0,1
5486_0,,,,2,2,1,3
C(CC(C)(CC=O)O)(O)=O,,,5,1,2,0,2
5488_0,,,,2,2,1,3
C(C(C(C)O)C(C)(CC(O)=O)O)=O,,,5,1,2,0,2
5488_1,,,,2,2,1,3
5490_0,,,,2,2,1,3
C(C(C=O)C(C)(CC(O)=O)O)(O)=O,,,5,1,2,0,2
5490_1,,,,2,2,1,3
5492_0,,,,2,2,1,3
C(CC(C)(C(C(C=O)=O)O)O)(O)=O,,,5,1,2,0,2
5492_1,,,,2,2,1,3
5494_0,,,,2,2,1,3
C(C(CO)C(C)(CC(O)=O)O)=O,,,5,1,2,0,2
5494_1,,,,2,2,1,3
5496_0,,,,2,2,1,3
C(CC(C)(C(C(CO)=O)O)O)(O)=O,,,5,1,2,0,2
5496_1,,,,2,2,1,3
5498_0,,,,2,2,1,3
C(C(C=C)C(C)(CC(O)=O)O)=O,,,5,1,1,0,1
5500_0,,,,2,2,1,3
C(CC(C)(CC(C(O)=O)=O)O)(O)=O,,,5,1,1,0,1
5502_0,,,,2,2,1,3
C(CC(CC(C)(CCO)O)=O)(O)=O,,,5,1,1,0,1
5504_0,,,,2,2,1,3
C(CC(CC(C)(CO)O)=O)(O)=O,,,5,1,1,0,1
5506_0,,,,2,2,1,3
C(CC(CC(C)(C(C)O)O)=O)(O)=O,,,5,1,1,0,1
5508_0,,,,2,2,1,3
C(CC(CC(CO)(CC)O)=O)(O)=O,,,5,1,1,0,1
5510_0,,,,2,2,1,3
C(CC(CC(C=C)O)=O)(O)=O,,,5,1,1,0,1
5512_0,,,,2,2,1,3
C(CC(CC(C(CC)O)O)=O)(O)=O,,,5,1,1,0,1
5514_0,,,,2,2,1,3
C(CC(CC(CCCO)O)=O)(O)=O,,,5,1,1,0,1
5515_0,,,,2,2,1,3
5516_0,,,,2,2,1,3
5518_0,,,,2,2,1,3
C(CC(CC(CC(C)O)O)=O)(O)=O,,,5,1,1,0,1
5520_0,,,,2,2,1,3
C(CC(CC(CC(O)=O)O)=O)(O)=O,,,5,1,1,0,1
5522_0,,,,2,2,1,3
C(CC(CC(C(CO)=O)O)=O)(O)=O,,,5,1,1,0,1
5524_0,,,,2,2,1,3
C(C(CO)(CC(CC(O)=O)=O)O)=O,,,5,1,1,0,1
5526_0,,,,2,2,1,3
C(CC(CCO)=O)(O)=O,,,5,1,8,0,8
5528_0,,,,2,2,1,3
C(CC(CC(CCO)O)=O)(O)=O,,,5,1,1,0,1
5530_0,,,,2,2,1,3
C(CC(CC(C=O)O)=O)(O)=O,,,5,1,3,0,3
5532_0,,,,2,2,1,3
C(CC(C(C=O)O)O)(CC(O)=O)=O,,,5,1,1,0,1
5534_0,,,,2,2,1,3
C(CC(CC(CO)(CO)O)=O)(O)=O,,,5,1,1,0,1
5536_0,,,,2,2,1,3
C(CC(CC(C=CC)O)=O)(O)=O,,,5,1,1,0,1
5538_0,,,,2,2,1,3
C(CC(CC(CC=C)O)=O)(O)=O,,,5,1,1,0,1
5540_0,,,,2,2,1,3
C(C(C)(CC(CC(O)=O)=O)O)(O)=O,,,5,1,1,0,1
5542_0,,,,2,2,1,3
C(C(C(C)=O)C(C)(CCO)O)(O)=O,,,5,1,2,0,2
5542_1,,,,2,2,1,3
5544_0,,,,2,2,1,3
C(C(C(C)=O)C(C)(CO)O)(O)=O,,,5,1,2,0,2
5544_1,,,,2,2,1,3
5546_0,,,,2,2,1,3
C(C(C(C)=O)C(C)(C(C)O)O)(O)=O,,,5,1,2,0,2
5546_1,,,,2,2,1,3
5548_0,,,,2,2,1,3
C(C(C(C)=O)C(CO)(CC)O)(O)=O,,,5,1,2,0,2
5548_1,,,,2,2,1,3
5550_0,,,,2,2,1,3
C(C(C(C)=O)C(C=C)O)(O)=O,,,5,1,2,0,2
5550_1,,,,2,2,1,3
5552_0,,,,2,2,1,3
C(C(C(C)=O)C(C(CC)O)O)(O)=O,,,5,1,2,0,2
5552_1,,,,2,2,1,3
5554_0,,,,2,2,1,3
C(C(C(C)=O)C(CCCO)O)(O)=O,,,5,1,2,0,2
5554_1,,,,2,2,1,3
5556_0,,,,2,2,1,3
C(C(C(C)=O)C(C)O)(O)=O,,,5,1,5,0,5
5556_1,,,,2,2,1,3
5558_0,,,,2,2,1,3
C(C(C(O)=O)C(C)=O)(O)=O,,,5,1,5,0,5
5558_1,,,,2,2,1,3
5560_0,,,,2,2,1,3
C(C(C(C)=O)C(CC(C)O)O)(O)=O,,,5,1,2,0,2
5560_1,,,,2,2,1,3
5562_0,,,,2,2,1,3
C(CC(C(C(O)=O)C(C)=O)O)(O)=O,,,5,1,2,0,2
5562_1,,,,2,2,1,3
5564_0,,,,2,2,1,3
C(C(C(C)=O)C(C(CO)=O)O)(O)=O,,,5,1,2,0,2
5564_1,,,,2,2,1,3
5566_0,,,,2,2,1,3
C(C(CO)(C(C(O)=O)C(C)=O)O)=O,,,5,1,2,0,2
5566_1,,,,2,2,1,3
5567_0,,,,2,2,1,3
5567_1,,,,2,2,1,3
5569_0,,,,2,2,1,3
C(C(C(C)=O)C(CCO)O)(O)=O,,,5,1,3,0,3
5569_1,,,,2,2,1,3
5571_0,,,,2,2,1,3
C(C(C(C)=O)C(C=O)O)(O)=O,,,5,1,5,0,5
5571_1,,,,2,2,1,3
5573_0,,,,2,2,1,3
C(C(C(C(C(O)=O)C(C)=O)O)O)=O,,,5,1,2,0,2
5573_1,,,,2,2,1,3
5575_0,,,,2,2,1,3
C(C(C(C)=O)C(CO)(CO)O)(O)=O,,,5,1,2,0,2
5575_1,,,,2,2,1,3
5577_0,,,,2,2,1,3
C(C(C(C)=O)C(C=CC)O)(O)=O,,,5,1,3,0,3
5577_1,,,,2,2,1,3
5579_0,,,,2,2,1,3
C(C(C(C)=O)C(CC=C)O)(O)=O,,,5,1,3,0,3
5579_1,,,,2,2,1,3
5581_0,,,,2,2,1,3
C(C(C)(C(C(O)=O)C(C)=O)O)(O)=O,,,5,1,2,0,2
5581_1,,,,2,2,1,3
5583_0,,,,2,2,1,3
C(CC(C)(CCO)O)(CCO)=O,,,5,1,1,0,1
5585_0,,,,2,2,1,3
C(C)(C(CO)C(C)(CCO)O)=O,,,5,1,2,0,2
5585_1,,,,2,2,1,3
5587_0,,,,2,2,1,3
C(CO)(CC(C)(CCO)O)=O,,,5,1,1,0,1
5589_0,,,,2,2,1,3
C(C)(C(C(C)(CCO)O)O)=O,,,5,1,2,0,2
5589_1,,,,2,2,1,3
5591_0,,,,2,2,1,3
C(C(C(C=O)=O)C(C)(CCO)O)=O,,,5,1,2,0,2
5591_1,,,,2,2,1,3
5593_0,,,,2,2,1,3
C(C(C(C)C(C)(CCO)O)=O)(O)=O,,,5,1,1,0,1
5595_0,,,,2,2,1,3
C(C(C)O)(CC(C)(CCO)O)=O,,,5,1,1,0,1
5597_0,,,,2,2,1,3
C(C(C(C)(CCO)O)O)(CC)=O,,,5,1,2,0,2
5597_1,,,,2,2,1,3
5599_0,,,,2,2,1,3
C(CO)(C(C)C(C)(CCO)O)=O,,,5,1,1,0,1
5601_0,,,,2,2,1,3
C(C(CCO)C(C)(CCO)O)=O,,,5,1,1,0,1
5603_0,,,,2,2,1,3
C1(C(C(CO1)C(C)(CCO)O)=O)=O,,,5,1,2,0,2
5603_1,,,,2,2,1,3
5605_0,,,,2,2,1,3
C(C(C(C)CO)C(C)(CCO)O)=O,,,5,1,1,0,1
5607_0,,,,2,2,1,3
C(CC(C)(CCO)O)=O,,,5,1,1,0,1
5609_0,,,,2,2,1,3
C(C(C(C)O)C(C)(CCO)O)=O,,,5,1,2,0,2
5609_1,,,,2,2,1,3
5611_0,,,,2,2,1,3
C(C(C=O)C(C)(CCO)O)(O)=O,,,5,1,2,0,2
5611_1,,,,2,2,1,3
5613_0,,,,2,2,1,3
C(C(C(C(C)(CCO)O)O)=O)=O,,,5,1,2,0,2
5613_1,,,,2,2,1,3
5615_0,,,,2,2,1,3
C(C(CO)C(C)(CCO)O)=O,,,5,1,2,0,2
5615_1,,,,2,2,1,3
5617_0,,,,2,2,1,3
C(CO)(C(C(C)(CCO)O)O)=O,,,5,1,2,0,2
5617_1,,,,2,2,1,3
5619_0,,,,2,2,1,3
C(C(C(C(C)(CCO)O)O)=O)(O)=O,,,5,1,2,0,2
5619_1,,,,2,2,1,3
5621_0,,,,2,2,1,3
C(C(C=C)C(C)(CCO)O)=O,,,5,1,1,0,1
5623_0,,,,2,2,1,3
C(C(CC(C)(CCO)O)=O)(O)=O,,,5,1,1,0,1
5625_0,,,,2,2,1,3
C(CC(C)(CO)O)(CCO)=O,,,5,1,1,0,1
5627_0,,,,2,2,1,3
C(CC(C(C(O)=O)=C)O)(CCO)=O,,,5,1,1,0,1
5629_0,,,,2,2,1,3
C(CCO)(CC(CC(C=O)=O)O)=O,,,5,1,1,0,1
5631_0,,,,2,2,1,3
C(CC(C(CC=O)=O)O)(CCO)=O,,,5,1,1,0,1
5633_0,,,,2,2,1,3
C(CC(C=O)(CC=O)O)(CCO)=O,,,5,1,1,0,1
5635_0,,,,2,2,1,3
C(C(CC)(CC(CCO)=O)O)(O)=O,,,5,1,1,0,1
5637_0,,,,2,2,1,3
C(CC(C)(C(C)O)O)(CCO)=O,,,5,1,1,0,1
5639_0,,,,2,2,1,3
C(CC(CO)(CC)O)(CCO)=O,,,5,1,1,0,1
5641_0,,,,2,2,1,3
C(CC(C(C(C)O)=C)O)(CCO)=O,,,5,1,1,0,1
5643_0,,,,2,2,1,3
C(CC(C(CO)=CC)O)(CCO)=O,,,5,1,1,0,1
5645_0,,,,2,2,1,3
C(CC(C=C)O)(CCO)=O,,,5,1,1,0,1
5647_0,,,,2,2,1,3
C(C(C=C)(CC(CCO)=O)O)(O)=O,,,5,1,1,0,1
5649_0,,,,2,2,1,3
C(CC(C(CC)O)O)(CCO)=O,,,5,1,1,0,1
5651_0,,,,2,2,1,3
C(CC(CCCO)O)(CCO)=O,,,5,1,1,0,1
5653_0,,,,2,2,1,3
C1(C(CCO1)(CC(CCO)=O)O)=O,,,5,1,1,0,1
5655_0,,,,2,2,1,3
C(CC(CC(C)CO)O)(CCO)=O,,,5,1,1,0,1
5657_0,,,,2,2,1,3
C(CC(C)O)(CCO)=O,,,5,1,4,0,4
5658_0,,,,2,2,1,3
5660_0,,,,2,2,1,3
C(CC(CC(C)O)O)(CCO)=O,,,5,1,1,0,1
5662_0,,,,2,2,1,3
C(CC(CC(CCO)=O)O)(O)=O,,,5,1,1,0,1
5664_0,,,,2,2,1,3
C(CC(C(CO)=O)O)(CCO)=O,,,5,1,1,0,1
5666_0,,,,2,2,1,3
C(C(CO)(CC(CCO)=O)O)=O,,,5,1,1,0,1
5668_0,,,,2,2,1,3
C(CCO)(CCO)=O,,,5,1,3,0,3
5670_0,,,,2,2,1,3
C(CC(CCO)O)(CCO)=O,,,5,1,1,0,1
5672_0,,,,2,2,1,3
C(CC(C=O)O)(CCO)=O,,,5,1,3,0,3
5674_0,,,,2,2,1,3
C(CCO)(CC(C(C=O)O)O)=O,,,5,1,1,0,1
5676_0,,,,2,2,1,3
C(CC(CO)(CO)O)(CCO)=O,,,5,1,1,0,1
5678_0,,,,2,2,1,3
C(C(CO)(CC(CCO)=O)O)(O)=O,,,5,1,1,0,1
5680_0,,,,2,2,1,3
C(CCO)(CC(C(C(O)=O)O)O)=O,,,5,1,1,0,1
5682_0,,,,2,2,1,3
C(CC(C=CC)O)(CCO)=O,,,5,1,1,0,1
5684_0,,,,2,2,1,3
C(CCO)(CC(CC=C)O)=O,,,5,1,1,0,1
5686_0,,,,2,2,1,3
C(C(C)(CC(CCO)=O)O)(O)=O,,,5,1,2,0,2
5688_0,,,,2,2,1,3
C(C)(C(CO)C(C)(CO)O)=O,,,5,1,2,0,2
5688_1,,,,2,2,1,3
5690_0,,,,2,2,1,3
C(C)(C(CO)C(C(C(O)=O)=C)O)=O,,,5,1,2,0,2
5690_1,,,,2,2,1,3
5692_0,,,,2,2,1,3
C(C)(C(CO)C(CC(C=O)=O)O)=O,,,5,1,2,0,2
5692_1,,,,2,2,1,3
5694_0,,,,2,2,1,3
C(C)(C(CO)C(C(CC=O)=O)O)=O,,,5,1,2,0,2
5694_1,,,,2,2,1,3
5696_0,,,,2,2,1,3
C(C)(C(CO)C(C=O)(CC=O)O)=O,,,5,1,2,0,2
5696_1,,,,2,2,1,3
5698_0,,,,2,2,1,3
C(C(CC)(C(C(C)=O)CO)O)(O)=O,,,5,1,2,0,2
5698_1,,,,2,2,1,3
5700_0,,,,2,2,1,3
C(C)(C(CO)C(C)(C(C)O)O)=O,,,5,1,2,0,2
5700_1,,,,2,2,1,3
5702_0,,,,2,2,1,3
C(C)(C(CO)C(CO)(CC)O)=O,,,5,1,2,0,2
5702_1,,,,2,2,1,3
5704_0,,,,2,2,1,3
C(C)(C(CO)C(C(C(C)O)=C)O)=O,,,5,1,2,0,2
5704_1,,,,2,2,1,3
5706_0,,,,2,2,1,3
C(C)(C(CO)C(C(CO)=CC)O)=O,,,5,1,2,0,2
5706_1,,,,2,2,1,3
5708_0,,,,2,2,1,3
C(C)(C(CO)C(C=C)O)=O,,,5,1,2,0,2
5708_1,,,,2,2,1,3
5710_0,,,,2,2,1,3
C(C(C=C)(C(C(C)=O)CO)O)(O)=O,,,5,1,2,0,2
5710_1,,,,2,2,1,3
5712_0,,,,2,2,1,3
C(C)(C(CO)C(C(CC)O)O)=O,,,5,1,2,0,2
5712_1,,,,2,2,1,3
5714_0,,,,2,2,1,3
C(C)(C(CO)C(CCCO)O)=O,,,5,1,2,0,2
5714_1,,,,2,2,1,3
5716_0,,,,2,2,1,3
C1(C(CCO1)(C(C(C)=O)CO)O)=O,,,5,1,2,0,2
5716_1,,,,2,2,1,3
5718_0,,,,2,2,1,3
C(C)(C(CO)C(CC(C)CO)O)=O,,,5,1,2,0,2
5718_1,,,,2,2,1,3
5720_0,,,,2,2,1,3
C(C)(C(CO)C(C)O)=O,,,5,1,4,0,4
5720_1,,,,2,2,1,3
5721_0,,,,2,2,1,3
5721_1,,,,2,2,1,3
5723_0,,,,2,2,1,3
C(C)(C(CO)C(CC(C)O)O)=O,,,5,1,3,0,3
5723_1,,,,2,2,1,3
5725_0,,,,2,2,1,3
C(CC(C(C(C)=O)CO)O)(O)=O,,,5,1,3,0,3
5725_1,,,,2,2,1,3
5727_0,,,,2,2,1,3
C(C)(C(CO)C(C(CO)=O)O)=O,,,5,1,3,0,3
5727_1,,,,2,2,1,3
5729_0,,,,2,2,1,3
C(C(CO)(C(C(C)=O)CO)O)=O,,,5,1,3,0,3
5729_1,,,,2,2,1,3
5731_0,,,,2,2,1,3
C(C)(C(CO)CO)=O,,,5,1,4,0,4
5731_1,,,,2,2,1,3
5733_0,,,,2,2,1,3
C(C)(C(CO)C(CCO)O)=O,,,5,1,2,0,2
5733_1,,,,2,2,1,3
5735_0,,,,2,2,1,3
C(C)(C(CO)C(C=O)O)=O,,,5,1,3,0,3
5735_1,,,,2,2,1,3
5737_0,,,,2,2,1,3
C(C(C(C(C(C)=O)CO)O)O)=O,,,5,1,2,0,2
5737_1,,,,2,2,1,3
5739_0,,,,2,2,1,3
C(C)(C(CO)C(CO)(CO)O)=O,,,5,1,2,0,2
5739_1,,,,2,2,1,3
5741_0,,,,2,2,1,3
C(C(CO)(C(C(C)=O)CO)O)(O)=O,,,5,1,2,0,2
5741_1,,,,2,2,1,3
5743_0,,,,2,2,1,3
C(C(C(C(C(C)=O)CO)O)O)(O)=O,,,5,1,2,0,2
5743_1,,,,2,2,1,3
5745_0,,,,2,2,1,3
C(C)(C(CO)C(C=CC)O)=O,,,5,1,2,0,2
5745_1,,,,2,2,1,3
5747_0,,,,2,2,1,3
C(C)(C(CO)C(CC=C)O)=O,,,5,1,2,0,2
5747_1,,,,2,2,1,3
5749_0,,,,2,2,1,3
C(C(C)(C(C(C)=O)CO)O)(O)=O,,,5,1,3,0,3
5749_1,,,,2,2,1,3
5751_0,,,,2,2,1,3
C(C(C)(C(C)(CC=O)O)O)(O)=O,,,5,1,1,0,1
5753_0,,,,2,2,1,3
C(CC(C=C)O)(C(C(O)=O)(C)O)=O,,,5,1,1,0,1
5755_0,,,,2,2,1,3
C(C(C(CC(C)O)=O)(C)O)(O)=O,,,5,1,1,0,1
5756_0,,,,2,2,1,3
5758_0,,,,2,2,1,3
C(C(C(CCO)=O)(C)O)(O)=O,,,5,1,1,0,1
5760_0,,,,2,2,1,3
C(CC(C=O)O)(C(C(O)=O)(C)O)=O,,,5,1,1,0,1
5762_0,,,,2,2,1,3
C(CC(C(C)O)(CC=O)O)(O)=O,,,5,1,1,0,1
5764_0,,,,2,2,1,3
C(C(C)O)(C(C(O)=O)C(C=C)O)=O,,,5,1,2,0,2
5764_1,,,,2,2,1,3
5766_0,,,,2,2,1,3
C(C(C(C(C)O)=O)C(C)O)(O)=O,,,5,1,3,0,3
5766_1,,,,2,2,1,3
5768_0,,,,2,2,1,3
C(C(C(O)=O)C(C(C)O)=O)(O)=O,,,5,1,3,0,3
5768_1,,,,2,2,1,3
5770_0,,,,2,2,1,3
C(C(C(C(C)O)=O)CO)(O)=O,,,5,1,3,0,3
5770_1,,,,2,2,1,3
5772_0,,,,2,2,1,3
C(C(C)O)(C(C(O)=O)C(C=O)O)=O,,,5,1,2,0,2
5772_1,,,,2,2,1,3
5774_0,,,,2,2,1,3
C(C(C)C(CO)(CC=O)O)(O)=O,,,5,1,2,0,2
5776_0,,,,2,2,1,3
C(C(C(C(C(C=C)O)O)=O)C)(O)=O,,,5,1,2,0,2
5776_1,,,,2,2,1,3
5778_0,,,,2,2,1,3
C(C(C(C(C(C)O)O)=O)C)(O)=O,,,5,1,2,0,2
5778_1,,,,2,2,1,3
5779_0,,,,2,2,1,3
5779_1,,,,2,2,1,3
5781_0,,,,2,2,1,3
C(C(C(C(CO)O)=O)C)(O)=O,,,5,1,2,0,2
5781_1,,,,2,2,1,3
5783_0,,,,2,2,1,3
C(C(C(C(C(C=O)O)O)=O)C)(O)=O,,,5,1,2,0,2
5783_1,,,,2,2,1,3
5785_0,,,,2,2,1,3
C(CC(CC)(C(C(O)=O)O)O)=O,,,5,1,1,0,1
5787_0,,,,2,2,1,3
C(C(C)C(C=C)O)(C(C(O)=O)O)=O,,,5,1,1,0,1
5789_0,,,,2,2,1,3
C(C(C(C(C)C(C)O)=O)O)(O)=O,,,5,1,1,0,1
5790_0,,,,2,2,1,3
5792_0,,,,2,2,1,3
C(C(C(C(CO)C)=O)O)(O)=O,,,5,1,1,0,1
5794_0,,,,2,2,1,3
C(C(C)C(C=O)O)(C(C(O)=O)O)=O,,,5,1,1,0,1
5796_0,,,,2,2,1,3
C(C(CC=O)(CC(CO)=O)O)(O)=O,,,5,1,1,0,1
5798_0,,,,2,2,1,3
C(CC(CO)(CC(C(O)=O)=O)O)=O,,,5,1,1,0,1
5800_0,,,,2,2,1,3
C(CO)(C(C(C(O)=O)=O)C(C)O)=O,,,5,1,3,0,3
5800_1,,,,2,2,1,3
5802_0,,,,2,2,1,3
C(C(C(CO)=O)C(C(O)=O)=O)(O)=O,,,5,1,3,0,3
5802_1,,,,2,2,1,3
5804_0,,,,2,2,1,3
C(CO)(C(C(C(O)=O)=O)CO)=O,,,5,1,4,0,4
5804_1,,,,2,2,1,3
5806_0,,,,2,2,1,3
C(C(C(C)O)O)(CC(C(O)=O)=O)=O,,,5,1,2,0,2
5806_1,,,,2,2,1,3
5808_0,,,,2,2,1,3
C(C(C(CC(C(O)=O)=O)=O)O)(O)=O,,,5,1,2,0,2
5808_1,,,,2,2,1,3
5809_0,,,,2,2,1,3
5809_1,,,,2,2,1,3
5811_0,,,,2,2,1,3
C(CO)(CC(CO)(C)O)=O,,,5,1,1,0,1
5813_0,,,,2,2,1,3
C(C)(C(C(CO)(C)O)O)=O,,,5,1,2,0,2
5813_1,,,,2,2,1,3
5815_0,,,,2,2,1,3
C(C(C=O)C(C=O)C(C)(CO)O)=O,,,5,1,1,0,1
5817_0,,,,2,2,1,3
C(C(C(C=O)=O)C(C)(CO)O)=O,,,5,1,2,0,2
5817_1,,,,2,2,1,3
5819_0,,,,2,2,1,3
C(CC(C)(CO)O)(CC(C=O)=O)=O,,,5,1,1,0,1
5821_0,,,,2,2,1,3
C(C)(C(C(C=O)=O)C(C)(CO)O)=O,,,5,1,2,0,2
5821_1,,,,2,2,1,3
5823_0,,,,2,2,1,3
C(C(C(C(C)C(C)(CO)O)=O)=O)=O,,,5,1,1,0,1
5825_0,,,,2,2,1,3
C(C(C(C)C(C)(CO)O)=O)(O)=O,,,5,1,1,0,1
5827_0,,,,2,2,1,3
C(C(C)O)(CC(CO)(C)O)=O,,,5,1,1,0,1
5829_0,,,,2,2,1,3
C(C(C(CO)(C)O)O)(CC)=O,,,5,1,2,0,2
5829_1,,,,2,2,1,3
5831_0,,,,2,2,1,3
C(CO)(C(C)C(CO)(C)O)=O,,,5,1,1,0,1
5833_0,,,,2,2,1,3
C(C(C=CC(C)O)C(CO)(C)O)=O,,,5,1,1,0,1
5835_0,,,,2,2,1,3
C(C(C=CC(O)=O)C(C)(CO)O)=O,,,5,1,1,0,1
5837_0,,,,2,2,1,3
C(C=CC(C(C(CO)(C)O)O)=O)=O,,,5,1,2,0,2
5837_1,,,,2,2,1,3
5839_0,,,,2,2,1,3
C=C(C(O)=O)C(CC(C)(CO)O)=O,,,5,1,1,0,1
5841_0,,,,2,2,1,3
C(C(CCO)C(C)(CO)O)=O,,,5,1,1,0,1
5843_0,,,,2,2,1,3
C1(C(C(CO1)C(C)(CO)O)=O)=O,,,5,1,2,0,2
5843_1,,,,2,2,1,3
5845_0,,,,2,2,1,3
C1(C(C(C(C(C)(CO)O)O1)=O)=O)=O,,,5,1,2,0,2
5845_1,,,,2,2,1,3
5847_0,,,,2,2,1,3
C(C(C(C)CO)C(C)(CO)O)=O,,,5,1,1,0,1
5849_0,,,,2,2,1,3
C(C(C(C)CCO)C(C)(CO)O)=O,,,5,1,1,0,1
5851_0,,,,2,2,1,3
C(C(C(C)C(C)O)C(C)(CO)O)=O,,,5,1,1,0,1
5853_0,,,,2,2,1,3
C(C(C(C)CC=O)C(C)(CO)O)=O,,,5,1,1,0,1
5855_0,,,,2,2,1,3
C(CC(C)(CO)O)=O,,,5,1,1,0,1
5857_0,,,,2,2,1,3
C(C(C(C)O)C(C)(CO)O)=O,,,5,1,2,0,2
5857_1,,,,2,2,1,3
5859_0,,,,2,2,1,3
C(C(C=O)C(C)(CO)O)(O)=O,,,5,1,2,0,2
5859_1,,,,2,2,1,3
5861_0,,,,2,2,1,3
C(C(C(C(CO)(C)O)O)=O)=O,,,5,1,2,0,2
5861_1,,,,2,2,1,3
5863_0,,,,2,2,1,3
C(C(CO)C(C)(CO)O)=O,,,5,1,2,0,2
5863_1,,,,2,2,1,3
5865_0,,,,2,2,1,3
C(C(C(CO)C(C)(CO)O)=O)(O)=O,,,5,1,2,0,2
5865_1,,,,2,2,1,3
5867_0,,,,2,2,1,3
C(C(C(C(C)=O)=O)C(C)(CO)O)=O,,,5,1,2,0,2
5867_1,,,,2,2,1,3
5869_0,,,,2,2,1,3
C(CC(C(CC(C)(CO)O)=O)=O)=O,,,5,1,1,0,1
5871_0,,,,2,2,1,3
C(CO)(C(C(CO)(C)O)O)=O,,,5,1,2,0,2
5871_1,,,,2,2,1,3
5873_0,,,,2,2,1,3
C(C(C(C(CO)(C)O)O)=O)(O)=O,,,5,1,2,0,2
5873_1,,,,2,2,1,3
5875_0,,,,2,2,1,3
C(C(C=C)C(C)(CO)O)=O,,,5,1,1,0,1
5877_0,,,,2,2,1,3
C=CC(C(C(O)=O)=O)C(C)(CO)O,,,5,1,1,0,1
5879_0,,,,2,2,1,3
C(C(C(C(O)=O)=C)C(C)(CO)O)=O,,,5,1,1,0,1
5881_0,,,,2,2,1,3
C1(C(C(C(C)O1)C(C)(CO)O)=O)=O,,,5,1,2,0,2
5881_1,,,,2,2,1,3
5883_0,,,,2,2,1,3
C1(C(C(C(O1)=O)=O)C(C)(CO)O)=O,,,5,1,2,0,2
5883_1,,,,2,2,1,3
5885_0,,,,2,2,1,3
C(C(CC(C)(CO)O)=O)(O)=O,,,5,1,1,0,1
5887_0,,,,2,2,1,3
C(CO)(CC(C(C(O)=O)=C)O)=O,,,5,1,1,0,1
5889_0,,,,2,2,1,3
C(C(C=O)CC(CC(CO)=O)O)=O,,,5,1,1,0,1
5891_0,,,,2,2,1,3
C(CO)(CC(C(C=O)CC=O)O)=O,,,5,1,1,0,1
5893_0,,,,2,2,1,3
C(CO)(CC(CC(C=O)=O)O)=O,,,5,1,1,0,1
5895_0,,,,2,2,1,3
C(CC(C(CC(CO)=O)O)=O)=O,,,5,1,1,0,1
5897_0,,,,2,2,1,3
C(CC(C=O)(CC(CO)=O)O)=O,,,5,1,1,0,1
5899_0,,,,2,2,1,3
C(CO)(CC(C)(CC(C=O)=O)O)=O,,,5,1,1,0,1
5901_0,,,,2,2,1,3
C(C)(CC(C(CC(CO)=O)O)=O)=O,,,5,1,1,0,1
5903_0,,,,2,2,1,3
C(C(CC(C)=O)(CC(CO)=O)O)=O,,,5,1,1,0,1
5905_0,,,,2,2,1,3
C(CC(C(C=O)=O)(CC)O)(CO)=O,,,5,1,1,0,1
5907_0,,,,2,2,1,3
C(CC(C(C(CC)=O)=O)O)(CO)=O,,,5,1,1,0,1
5909_0,,,,2,2,1,3
C(CC)(C(C=O)(CC(CO)=O)O)=O,,,5,1,1,0,1
5911_0,,,,2,2,1,3
C(C(CC)(CC(CO)=O)O)(O)=O,,,5,1,1,0,1
5913_0,,,,2,2,1,3
C(CO)(CC(C)(C(C)O)O)=O,,,5,1,1,0,1
5915_0,,,,2,2,1,3
C(CO)(CC(CO)(CC)O)=O,,,5,1,1,0,1
5917_0,,,,2,2,1,3
C(CC(C=CCC(C)O)O)(CO)=O,,,5,1,1,0,1
5919_0,,,,2,2,1,3
C(CO)(CC(CC=CC(C)O)O)=O,,,5,1,1,0,1
5921_0,,,,2,2,1,3
C(CC(C(C(C)O)=C)O)(CO)=O,,,5,1,1,0,1
5923_0,,,,2,2,1,3
C(CO)(CC(C(CO)=CC)O)=O,,,5,1,1,0,1
5925_0,,,,2,2,1,3
C(CC(C(C(C)O)=CC)O)(CO)=O,,,5,1,1,0,1
5927_0,,,,2,2,1,3
C(CO)(CC(C(C(O)=O)=CC)O)=O,,,5,1,1,0,1
5929_0,,,,2,2,1,3
C(CC=CC(CC(CO)=O)O)(O)=O,,,5,1,1,0,1
5931_0,,,,2,2,1,3
C(CO)(CC(CC=CC(O)=O)O)=O,,,5,1,1,0,1
5933_0,,,,2,2,1,3
C(CO)(CC(C=CC(CO)=O)O)=O,,,5,1,1,0,1
5935_0,,,,2,2,1,3
C(CC(C=CC=O)(CO)O)(CO)=O,,,5,1,1,0,1
5937_0,,,,2,2,1,3
C(CO)(CC(C=C(C=O)CO)O)=O,,,5,1,1,0,1
5939_0,,,,2,2,1,3
C(CO)(CC(C(CO)=CC=O)O)=O,,,5,1,1,0,1
5941_0,,,,2,2,1,3
C(C(CC(CO)=O)O)(C(C=C)O)=O,,,5,1,1,0,1
5943_0,,,,2,2,1,3
C(C(CC(CO)=O)(C(C=C)O)O)=O,,,5,1,1,0,1
5945_0,,,,2,2,1,3
C(CO)(CC(C=C)O)=O,,,5,1,1,0,1
5947_0,,,,2,2,1,3
C(C(C=C)(CC(CO)=O)O)(O)=O,,,5,1,1,0,1
5949_0,,,,2,2,1,3
C(CC(C(C(O)=O)=C)(C)O)(CO)=O,,,5,1,1,0,1
5951_0,,,,2,2,1,3
C(CO)(CC(C(CC)O)O)=O,,,5,1,1,0,1
5953_0,,,,2,2,1,3
C(CO)(CC(CCCO)O)=O,,,5,1,1,0,1
5955_0,,,,2,2,1,3
C(CO)(CC1(C(O)OCC1O)O)=O,,,5,1,1,0,1
5957_0,,,,2,2,1,3
C1(C(CCO1)(CC(CO)=O)O)=O,,,5,1,1,0,1
5959_0,,,,2,2,1,3
C(CC1(C(C(OC1)=O)=O)O)(CO)=O,,,5,1,1,0,1
5961_0,,,,2,2,1,3
C1(C(C(CO1)=O)(CC(CO)=O)O)=O,,,5,1,1,0,1
5963_0,,,,2,2,1,3
C(CO)(CC(CC(CO)C)O)=O,,,5,1,1,0,1
5965_0,,,,2,2,1,3
C(CO)(CC(CC(C)CCO)O)=O,,,5,1,1,0,1
5967_0,,,,2,2,1,3
C(CO)(CC(CC(C)C(C)O)O)=O,,,5,1,1,0,1
5969_0,,,,2,2,1,3
C(CC(C)CC(CC(CO)=O)O)=O,,,5,1,1,0,1
5971_0,,,,2,2,1,3
C(CO)(CC(C)O)=O,,,5,1,2,0,2
5973_0,,,,2,2,1,3
C(CC(CO)=O)(O)=O,,,5,1,3,0,3
5975_0,,,,2,2,1,3
C(CO)(CC(CC(C)O)O)=O,,,5,1,1,0,1
5977_0,,,,2,2,1,3
C(CC(CC(CO)=O)O)(O)=O,,,5,1,1,0,1
5979_0,,,,2,2,1,3
C(CO)(C(CC(CO)=O)O)=O,,,5,1,1,0,1
5981_0,,,,2,2,1,3
C(C(CO)(CC(CO)=O)O)=O,,,5,1,1,0,1
5983_0,,,,2,2,1,3
C(CO)(CCO)=O,,,5,1,1,0,1
5985_0,,,,2,2,1,3
C(CO)(CC(C(CO)C(C)O)O)=O,,,5,1,1,0,1
5987_0,,,,2,2,1,3
C(C(CO)C(CC(CO)=O)O)(O)=O,,,5,1,1,0,1
5989_0,,,,2,2,1,3
C(CC(C(C(CO)O)=O)O)(CO)=O,,,5,1,1,0,1
5991_0,,,,2,2,1,3
C(C(C(CO)O)(CC(CO)=O)O)=O,,,5,1,1,0,1
5993_0,,,,2,2,1,3
C(CO)(CC(CCO)O)=O,,,5,1,1,0,1
5995_0,,,,2,2,1,3
C(C(CCO)(CC(CO)=O)O)(O)=O,,,5,1,1,0,1
5997_0,,,,2,2,1,3
C(CC(C(C)=O)(CC(CO)=O)O)=O,,,5,1,1,0,1
5999_0,,,,2,2,1,3
C(C(C)(CC(CO)=O)O)(CC=O)=O,,,5,1,1,0,1
6001_0,,,,2,2,1,3
C(CO)(CC(CC(C(C)=O)=O)O)=O,,,5,1,1,0,1
6003_0,,,,2,2,1,3
C(C(CC(CO)=O)O)=O,,,5,1,2,0,2
6005_0,,,,2,2,1,3
C(C(C(CC(CO)=O)O)O)=O,,,5,1,1,0,1
6007_0,,,,2,2,1,3
C(CO)(CC(CO)(CO)O)=O,,,5,1,1,0,1
6009_0,,,,2,2,1,3
C(C(CO)(CC(CO)=O)O)(O)=O,,,5,1,1,0,1
6011_0,,,,2,2,1,3
C(C(C)(C(CC(CO)=O)O)O)(O)=O,,,5,1,1,0,1
6013_0,,,,2,2,1,3
C(C(C(CC(CO)=O)O)O)(O)=O,,,5,1,1,0,1
6015_0,,,,2,2,1,3
C(CO)(CC(C=CC)O)=O,,,5,1,1,0,1
6017_0,,,,2,2,1,3
C(CO)(CC(CC=C)O)=O,,,5,1,1,0,1
6019_0,,,,2,2,1,3
C(C(C=CC)(CC(CO)=O)O)(O)=O,,,5,1,1,0,1
6021_0,,,,2,2,1,3
C(C(CC=C)(CC(CO)=O)O)(O)=O,,,5,1,1,0,1
6023_0,,,,2,2,1,3
C(CO)(CC(CC(C(O)=O)=C)O)=O,,,5,1,1,0,1
6025_0,,,,2,2,1,3
C(CO)(CC(C=C(C(O)=O)C)O)=O,,,5,1,1,0,1
6027_0,,,,2,2,1,3
C1(C(CC(C)O1)(CC(CO)=O)O)=O,,,5,1,1,0,1
6029_0,,,,2,2,1,3
C1(CC(C(O1)=O)(CC(CO)=O)O)=O,,,5,1,1,0,1
6031_0,,,,2,2,1,3
C(C(C)(CC(CO)=O)O)(O)=O,,,5,1,1,0,1
6033_0,,,,2,2,1,3
C(C)(C(C(C(C(O)=O)=C)O)O)=O,,,5,1,2,0,2
6033_1,,,,2,2,1,3
6035_0,,,,2,2,1,3
C(C(C=O)CC(C(C(C)=O)O)O)=O,,,5,1,2,0,2
6035_1,,,,2,2,1,3
6037_0,,,,2,2,1,3
C(C)(C(C(C(C=O)CC=O)O)O)=O,,,5,1,2,0,2
6037_1,,,,2,2,1,3
6039_0,,,,2,2,1,3
C(C)(C(C(CC(C=O)=O)O)O)=O,,,5,1,2,0,2
6039_1,,,,2,2,1,3
6041_0,,,,2,2,1,3
C(CC(C(C(C(C)=O)O)O)=O)=O,,,5,1,2,0,2
6041_1,,,,2,2,1,3
6043_0,,,,2,2,1,3
C(CC(C=O)(C(C(C)=O)O)O)=O,,,5,1,3,0,3
6043_1,,,,2,2,1,3
6045_0,,,,2,2,1,3
C(C)(C(C(C)(CC(C=O)=O)O)O)=O,,,5,1,2,0,2
6045_1,,,,2,2,1,3
6047_0,,,,2,2,1,3
C(C)(CC(C(C(C(C)=O)O)O)=O)=O,,,5,1,2,0,2
6047_1,,,,2,2,1,3
6049_0,,,,2,2,1,3
C(C(CC(C)=O)(C(C(C)=O)O)O)=O,,,5,1,2,0,2
6049_1,,,,2,2,1,3
6051_0,,,,2,2,1,3
C(C(C(C(C=O)=O)(CC)O)O)(C)=O,,,5,1,2,0,2
6051_1,,,,2,2,1,3
6053_0,,,,2,2,1,3
C(C(C(C(C(CC)=O)=O)O)O)(C)=O,,,5,1,2,0,2
6053_1,,,,2,2,1,3
6055_0,,,,2,2,1,3
C(CC)(C(C=O)(C(C(C)=O)O)O)=O,,,5,1,2,0,2
6055_1,,,,2,2,1,3
6057_0,,,,2,2,1,3
C(C(CC)(C(C(C)=O)O)O)(O)=O,,,5,1,2,0,2
6057_1,,,,2,2,1,3
6059_0,,,,2,2,1,3
C(C)(C(C(C)(C(C)O)O)O)=O,,,5,1,2,0,2
6059_1,,,,2,2,1,3
6061_0,,,,2,2,1,3
C(C)(C(C(CO)(CC)O)O)=O,,,5,1,2,0,2
6061_1,,,,2,2,1,3
6063_0,,,,2,2,1,3
C(C(C(C=CCC(C)O)O)O)(C)=O,,,5,1,2,0,2
6063_1,,,,2,2,1,3
6065_0,,,,2,2,1,3
C(C)(C(C(CC=CC(C)O)O)O)=O,,,5,1,2,0,2
6065_1,,,,2,2,1,3
6067_0,,,,2,2,1,3
C(C(C(C(C(C)O)=C)O)O)(C)=O,,,5,1,2,0,2
6067_1,,,,2,2,1,3
6069_0,,,,2,2,1,3
C(C)(C(C(C(CO)=CC)O)O)=O,,,5,1,2,0,2
6069_1,,,,2,2,1,3
6071_0,,,,2,2,1,3
C(C(C(C(C(C)O)=CC)O)O)(C)=O,,,5,1,2,0,2
6071_1,,,,2,2,1,3
6073_0,,,,2,2,1,3
C(C)(C(C(C(C(O)=O)=CC)O)O)=O,,,5,1,2,0,2
6073_1,,,,2,2,1,3
6075_0,,,,2,2,1,3
C(CC=CC(C(C(C)=O)O)O)(O)=O,,,5,1,2,0,2
6075_1,,,,2,2,1,3
6077_0,,,,2,2,1,3
C(C)(C(C(CC=CC(O)=O)O)O)=O,,,5,1,2,0,2
6077_1,,,,2,2,1,3
6079_0,,,,2,2,1,3
C(C)(C(C(C=CC(CO)=O)O)O)=O,,,5,1,2,0,2
6079_1,,,,2,2,1,3
6081_0,,,,2,2,1,3
C(C(C(C=CC=O)(CO)O)O)(C)=O,,,5,1,2,0,2
6081_1,,,,2,2,1,3
6083_0,,,,2,2,1,3
C(C)(C(C(C=C(C=O)CO)O)O)=O,,,5,1,2,0,2
6083_1,,,,2,2,1,3
6085_0,,,,2,2,1,3
C(C)(C(C(C(CO)=CC=O)O)O)=O,,,5,1,2,0,2
6085_1,,,,2,2,1,3
6087_0,,,,2,2,1,3
C(C(C(C(C)=O)O)O)(C(C=C)O)=O,,,5,1,2,0,2
6087_1,,,,2,2,1,3
6089_0,,,,2,2,1,3
C(C(C(C=C)O)(C(C(C)=O)O)O)=O,,,5,1,4,0,4
6089_1,,,,2,2,1,3
6091_0,,,,2,2,1,3
C(C)(C(C(C=C)O)O)=O,,,5,1,2,0,2
6091_1,,,,2,2,1,3
6093_0,,,,2,2,1,3
C(C(C=C)(C(C(C)=O)O)O)(O)=O,,,5,1,3,0,3
6093_1,,,,2,2,1,3
6095_0,,,,2,2,1,3
C(C(C(C(C(O)=O)=C)(C)O)O)(C)=O,,,5,1,2,0,2
6095_1,,,,2,2,1,3
6097_0,,,,2,2,1,3
C(C)(C(C(C(CC)O)O)O)=O,,,5,1,2,0,2
6097_1,,,,2,2,1,3
6099_0,,,,2,2,1,3
C(C)(C(C(CCCO)O)O)=O,,,5,1,2,0,2
6099_1,,,,2,2,1,3
6101_0,,,,2,2,1,3
C(C)(C(C1(C(O)OCC1O)O)O)=O,,,5,1,2,0,2
6101_1,,,,2,2,1,3
6103_0,,,,2,2,1,3
C1(C(CCO1)(C(C(C)=O)O)O)=O,,,5,1,2,0,2
6103_1,,,,2,2,1,3
6105_0,,,,2,2,1,3
C(C(C1(C(C(OC1)=O)=O)O)O)(C)=O,,,5,1,3,0,3
6105_1,,,,2,2,1,3
6107_0,,,,2,2,1,3
C1(C(C(CO1)=O)(C(C(C)=O)O)O)=O,,,5,1,2,0,2
6107_1,,,,2,2,1,3
6109_0,,,,2,2,1,3
C(C)(C(C(CC(CO)C)O)O)=O,,,5,1,2,0,2
6109_1,,,,2,2,1,3
6111_0,,,,2,2,1,3
C(C)(C(C(CC(C)CCO)O)O)=O,,,5,1,2,0,2
6111_1,,,,2,2,1,3
6113_0,,,,2,2,1,3
C(C)(C(C(CC(C)C(C)O)O)O)=O,,,5,1,2,0,2
6113_1,,,,2,2,1,3
6115_0,,,,2,2,1,3
C(CC(C)CC(C(C(C)=O)O)O)=O,,,5,1,2,0,2
6115_1,,,,2,2,1,3
6117_0,,,,2,2,1,3
C(C)(C(C(C)O)O)=O,,,5,1,2,0,2
6117_1,,,,2,2,1,3
6119_0,,,,2,2,1,3
C(C(C(C)=O)O)(O)=O,,,5,1,5,0,5
6119_1,,,,2,2,1,3
6121_0,,,,2,2,1,3
C(C)(C(C(CC(C)O)O)O)=O,,,5,1,2,0,2
6121_1,,,,2,2,1,3
6123_0,,,,2,2,1,3
C(CC(C(C(C)=O)O)O)(O)=O,,,5,1,2,0,2
6123_1,,,,2,2,1,3
6124_0,,,,2,2,1,3
6124_1,,,,2,2,1,3
6126_0,,,,2,2,1,3
C(C(CO)(C(C(C)=O)O)O)=O,,,5,1,7,0,7
6126_1,,,,2,2,1,3
6128_0,,,,2,2,1,3
C(C)(C(CO)O)=O,,,5,1,2,0,2
6128_1,,,,2,2,1,3
6130_0,,,,2,2,1,3
C(C)(C(C(C(CO)C(C)O)O)O)=O,,,5,1,2,0,2
6130_1,,,,2,2,1,3
6132_0,,,,2,2,1,3
C(C(CO)C(C(C(C)=O)O)O)(O)=O,,,5,1,2,0,2
6132_1,,,,2,2,1,3
6133_0,,,,2,2,1,3
6133_1,,,,2,2,1,3
6135_0,,,,2,2,1,3
C(C(C(CO)O)(C(C(C)=O)O)O)=O,,,5,1,4,0,4
6135_1,,,,2,2,1,3
6137_0,,,,2,2,1,3
C(C)(C(C(CCO)O)O)=O,,,5,1,2,0,2
6137_1,,,,2,2,1,3
6139_0,,,,2,2,1,3
C(C(CCO)(C(C(C)=O)O)O)(O)=O,,,5,1,2,0,2
6139_1,,,,2,2,1,3
6141_0,,,,2,2,1,3
C(CC(C(C)=O)(C(C(C)=O)O)O)=O,,,5,1,2,0,2
6141_1,,,,2,2,1,3
6143_0,,,,2,2,1,3
C(C(C)(C(C(C)=O)O)O)(CC=O)=O,,,5,1,2,0,2
6143_1,,,,2,2,1,3
6145_0,,,,2,2,1,3
C(C)(C(C(CC(C(C)=O)=O)O)O)=O,,,5,1,2,0,2
6145_1,,,,2,2,1,3
6146_0,,,,2,2,1,3
6146_1,,,,2,2,1,3
6148_0,,,,2,2,1,3
C(C(C(C(C(C)=O)O)O)O)=O,,,5,1,2,0,2
6148_1,,,,2,2,1,3
6150_0,,,,2,2,1,3
C(C)(C(C(CO)(CO)O)O)=O,,,5,1,2,0,2
6150_1,,,,2,2,1,3
6152_0,,,,2,2,1,3
C(C(CO)(C(C(C)=O)O)O)(O)=O,,,5,1,4,0,4
6152_1,,,,2,2,1,3
6154_0,,,,2,2,1,3
C(C(C)(C(C(C(C)=O)O)O)O)(O)=O,,,5,1,2,0,2
6154_1,,,,2,2,1,3
6156_0,,,,2,2,1,3
C(C(C(C(C(C)=O)O)O)O)(O)=O,,,5,1,2,0,2
6156_1,,,,2,2,1,3
6158_0,,,,2,2,1,3
C(C)(C(C(C=CC)O)O)=O,,,5,1,2,0,2
6158_1,,,,2,2,1,3
6160_0,,,,2,2,1,3
C(C)(C(C(CC=C)O)O)=O,,,5,1,2,0,2
6160_1,,,,2,2,1,3
6162_0,,,,2,2,1,3
C(C(C=CC)(C(C(C)=O)O)O)(O)=O,,,5,1,2,0,2
6162_1,,,,2,2,1,3
6164_0,,,,2,2,1,3
C(C(CC=C)(C(C(C)=O)O)O)(O)=O,,,5,1,2,0,2
6164_1,,,,2,2,1,3
6166_0,,,,2,2,1,3
C(C)(C(C(CC(C(O)=O)=C)O)O)=O,,,5,1,2,0,2
6166_1,,,,2,2,1,3
6168_0,,,,2,2,1,3
C(C)(C(C(C=C(C(O)=O)C)O)O)=O,,,5,1,2,0,2
6168_1,,,,2,2,1,3
6170_0,,,,2,2,1,3
C1(C(CC(C)O1)(C(C(C)=O)O)O)=O,,,5,1,2,0,2
6170_1,,,,2,2,1,3
6172_0,,,,2,2,1,3
C1(CC(C(O1)=O)(C(C(C)=O)O)O)=O,,,5,1,2,0,2
6172_1,,,,2,2,1,3
6174_0,,,,2,2,1,3
C(C(C)(C(C(C)=O)O)O)(O)=O,,,5,1,3,0,3
6174_1,,,,2,2,1,3
6176_0,,,,2,2,1,3
C(CC(CC(C(CO)O)=O)O)=O,,,5,1,3,0,3
6178_0,,,,2,2,1,3
C(CC(C(CO)O)(CC=O)O)=O,,,5,1,2,0,2
6180_0,,,,2,2,1,3
C(C(CO)O)(C(C=O)C(C=C)O)=O,,,5,1,2,0,2
6180_1,,,,2,2,1,3
6181_0,,,,2,2,1,3
6181_1,,,,2,2,1,3
6182_0,,,,2,2,1,3
6182_1,,,,2,2,1,3
6184_0,,,,2,2,1,3
C(C(C(C(CO)O)=O)CO)=O,,,5,1,4,0,4
6184_1,,,,2,2,1,3
6186_0,,,,2,2,1,3
C(C(CO)O)(C(C=O)C(C=O)O)=O,,,5,1,4,0,4
6186_1,,,,2,2,1,3
6188_0,,,,2,2,1,3
C(CC(C(C)O)(C(C=O)O)O)=O,,,5,1,2,0,2
6190_0,,,,2,2,1,3
C(CC(C(C(C(C)O)=O)O)O)=O,,,5,1,2,0,2
6192_0,,,,2,2,1,3
C(C(CC=O)(C(C=O)O)O)(O)=O,,,5,1,2,0,2
6194_0,,,,2,2,1,3
C(CC(C(C(C(O)=O)=O)O)O)=O,,,5,1,4,0,4
6196_0,,,,2,2,1,3
C(CC(C)(C(C(CO)=O)O)O)=O,,,5,1,1,0,1
6198_0,,,,2,2,1,3
C(CC(CO)(C(C(C)=O)O)O)=O,,,5,1,2,0,2
6200_0,,,,2,2,1,3
C(CC(C=C)O)(C(C(CO)=O)O)=O,,,5,1,1,0,1
6202_0,,,,2,2,1,3
C(CC(C)O)(C(C(CO)=O)O)=O,,,5,1,2,0,2
6204_0,,,,2,2,1,3
C(CC(C(C(CO)=O)O)=O)(O)=O,,,5,1,3,0,3
6206_0,,,,2,2,1,3
C(CCO)(C(C(CO)=O)O)=O,,,5,1,1,0,1
6208_0,,,,2,2,1,3
C(C(CC(C(C(CO)=O)O)=O)O)=O,,,5,1,1,0,1
6210_0,,,,2,2,1,3
C(C(C(C=C)O)O)(C(C(C)=O)O)=O,,,5,1,2,0,2
6210_1,,,,2,2,1,3
6212_0,,,,2,2,1,3
C(C(C(C)O)O)(C(C(C)=O)O)=O,,,5,1,3,0,3
6212_1,,,,2,2,1,3
6213_0,,,,2,2,1,3
6213_1,,,,2,2,1,3
6215_0,,,,2,2,1,3
C(C(CO)O)(C(C(C)=O)O)=O,,,5,1,3,0,3
6215_1,,,,2,2,1,3
6217_0,,,,2,2,1,3
C(C(C(C(C(C(C)=O)O)=O)O)O)=O,,,5,1,3,0,3
6217_1,,,,2,2,1,3
6219_0,,,,2,2,1,3
C(CC(CO)(C(CCO)O)O)=O,,,5,1,2,0,2
6221_0,,,,2,2,1,3
C(C(C(C=C)O)O)(C(CCO)O)=O,,,5,1,2,0,2
6221_1,,,,2,2,1,3
6223_0,,,,2,2,1,3
C(C(CCO)O)(C(C(C)O)O)=O,,,5,1,3,0,3
6223_1,,,,2,2,1,3
6225_0,,,,2,2,1,3
C(C(C(C(CCO)O)=O)O)(O)=O,,,5,1,4,0,4
6225_1,,,,2,2,1,3
6227_0,,,,2,2,1,3
C(C(CCO)O)(C(CO)O)=O,,,5,1,4,0,4
6227_1,,,,2,2,1,3
6229_0,,,,2,2,1,3
C(C(C(C=O)O)O)(C(CCO)O)=O,,,5,1,3,0,3
6229_1,,,,2,2,1,3
6231_0,,,,2,2,1,3
C(CC(C(CO)(CCO)O)O)=O,,,5,1,2,0,2
6233_0,,,,2,2,1,3
C(CC(C(CO)(CC=O)O)O)(O)=O,,,5,1,2,0,2
6235_0,,,,2,2,1,3
C(CC(C(C(C(C)O)O)=O)O)(O)=O,,,5,1,3,0,3
6235_1,,,,2,2,1,3
6237_0,,,,2,2,1,3
C(C(C(C(CC(O)=O)O)=O)O)(O)=O,,,5,1,5,0,5
6237_1,,,,2,2,1,3
6239_0,,,,2,2,1,3
C(CC(C(C(CO)O)=O)O)(O)=O,,,5,1,5,0,5
6239_1,,,,2,2,1,3
6241_0,,,,2,2,1,3
C(CC(CO)(C(CC=O)O)O)(O)=O,,,5,1,2,0,2
6243_0,,,,2,2,1,3
C(CC(C(CO)(CO)C(C)O)O)=O,,,5,1,1,0,1
6245_0,,,,2,2,1,3
C(C(CO)(CO)C(CC=O)O)(O)=O,,,5,1,2,0,2
6247_0,,,,2,2,1,3
C(CC(C(C(CO)(CO)O)=O)O)=O,,,5,1,3,0,3
6249_0,,,,2,2,1,3
C(C(C(CO)(CO)O)(CC=O)O)=O,,,5,1,2,0,2
6251_0,,,,2,2,1,3
C(CC(C(C=O)(C(C=O)O)O)O)=O,,,5,1,3,0,3
6253_0,,,,2,2,1,3
C(C(C=O)(C(C(CC=O)O)O)O)=O,,,5,1,3,0,3
6255_0,,,,2,2,1,3
C(C(CO)C(C(CC=O)O)O)(O)=O,,,5,1,2,0,2
6257_0,,,,2,2,1,3
C(C(C(CC=O)O)(C(C)O)O)=O,,,5,1,3,0,3
6259_0,,,,2,2,1,3
C(C(C=O)(C(CC=O)O)O)(O)=O,,,5,1,3,0,3
6261_0,,,,2,2,1,3
C(C(C(CC=O)O)(C(C)O)O)(O)=O,,,5,1,3,0,3
6263_0,,,,2,2,1,3
C(C(C(O)=O)(C(CC=O)O)O)(O)=O,,,5,1,3,0,3
6265_0,,,,2,2,1,3
C(C(CO)(C(CC=O)O)O)(O)=O,,,5,1,3,0,3
6267_0,,,,2,2,1,3
C(C(C(CCO)=O)(CO)CO)(O)=O,,,5,1,2,0,2
6268_0,,,,2,2,1,3
6268_1,,,,2,2,1,3
6270_0,,,,2,2,1,3
C(C(CO)(CC=O)O)(C(CO)O)=O,,,5,1,3,0,3
6270_1,,,,2,2,1,3
6272_0,,,,2,2,1,3
C(C(C(CO)O)=O)(C(CO)(C)O)=O,,,5,1,3,0,3
6272_1,,,,2,2,1,3
6274_0,,,,2,2,1,3
C(C(C)(C(C(CC=O)O)O)O)(O)=O,,,5,1,2,0,2
6276_0,,,,2,2,1,3
C(CC(C(C(O)=O)=C)O)(C(C)O)=O,,,5,1,1,0,1
6278_0,,,,2,2,1,3
C(C(C(C(C(O)=O)=C)O)O)(CC)=O,,,5,1,2,0,2
6278_1,,,,2,2,1,3
6280_0,,,,2,2,1,3
C(CO)(C(C)C(C(C(O)=O)=C)O)=O,,,5,1,1,0,1
6282_0,,,,2,2,1,3
C(C(CCO)C(C(C(O)=O)=C)O)=O,,,5,1,1,0,1
6284_0,,,,2,2,1,3
C(CC(C(C(O)=O)=C)O)=O,,,5,1,3,0,3
6286_0,,,,2,2,1,3
C(C(C(C)O)C(C(C(O)=O)=C)O)=O,,,5,1,2,0,2
6286_1,,,,2,2,1,3
6288_0,,,,2,2,1,3
C(C(C=O)C(C(C(O)=O)=C)O)(O)=O,,,5,1,2,0,2
6288_1,,,,2,2,1,3
6290_0,,,,2,2,1,3
C=C(C(O)=O)C(C(C(C=O)=O)O)O,,,5,1,2,0,2
6290_1,,,,2,2,1,3
6292_0,,,,2,2,1,3
C(C(CO)C(C(C(O)=O)=C)O)=O,,,5,1,4,0,4
6292_1,,,,2,2,1,3
6294_0,,,,2,2,1,3
C(CO)(C(C(C(C(O)=O)=C)O)O)=O,,,5,1,2,0,2
6294_1,,,,2,2,1,3
6296_0,,,,2,2,1,3
C(C(C=C)C(C(C(O)=O)=C)O)=O,,,5,1,3,0,3
6298_0,,,,2,2,1,3
C=C(C(O)=O)C(CC(C(O)=O)=O)O,,,5,1,1,0,1
6300_0,,,,2,2,1,3
C(C(C(C(CO)CC(C)O)=O)=O)=O,,,5,1,1,0,1
6302_0,,,,2,2,1,3
C(CC(C)O)(C(C(C=O)=O)CO)=O,,,5,1,2,0,2
6302_1,,,,2,2,1,3
6304_0,,,,2,2,1,3
C(C(CO)C(C)O)(CC(C=O)=O)=O,,,5,1,2,0,2
6304_1,,,,2,2,1,3
6306_0,,,,2,2,1,3
C(CC(C(C(C=O)=O)=O)CO)(O)=O,,,5,1,1,0,1
6308_0,,,,2,2,1,3
C(CC(O)=O)(C(C(C=O)=O)CO)=O,,,5,1,2,0,2
6308_1,,,,2,2,1,3
6310_0,,,,2,2,1,3
C(C(C(CC(C=O)=O)=O)CO)(O)=O,,,5,1,2,0,2
6310_1,,,,2,2,1,3
6312_0,,,,2,2,1,3
C(CO)(C(C(C(C=O)=O)=O)CO)=O,,,5,1,2,0,2
6312_1,,,,2,2,1,3
6314_0,,,,2,2,1,3
C(C(CO)O)(CC(C(C=O)=O)=O)=O,,,5,1,2,0,2
6314_1,,,,2,2,1,3
6316_0,,,,2,2,1,3
C(C(C(C(C(CO)=O)=O)CO)=O)=O,,,5,1,2,0,2
6316_1,,,,2,2,1,3
6318_0,,,,2,2,1,3
C(C(CC(C(C(CO)O)=O)=O)=O)=O,,,5,1,2,0,2
6318_1,,,,2,2,1,3
6320_0,,,,2,2,1,3
C(C(C=O)CC(CC=O)O)=O,,,5,1,2,0,2
6322_0,,,,2,2,1,3
C(C(C=O)CC(C(C=O)CO)O)=O,,,5,1,2,0,2
6322_1,,,,2,2,1,3
6324_0,,,,2,2,1,3
C(C(C=C)C(CC(C=O)C=O)O)=O,,,5,1,1,0,1
6326_0,,,,2,2,1,3
C(CC(C(C=O)CC=O)O)=O,,,5,1,2,0,2
6328_0,,,,2,2,1,3
C(C(CO)C(C(C=O)CC=O)O)=O,,,5,1,2,0,2
6328_1,,,,2,2,1,3
6330_0,,,,2,2,1,3
C(C(C(C(C=O)C=C)O)CC=O)=O,,,5,1,1,0,1
6332_0,,,,2,2,1,3
C(C(C=O)C(C=O)C(C=C)O)=O,,,5,1,1,0,1
6333_0,,,,2,2,1,3
6334_0,,,,2,2,1,3
6336_0,,,,2,2,1,3
C(C(C=O)C(C=O)CO)=O,,,5,1,2,0,2
6338_0,,,,2,2,1,3
C(C(C=O)C(C=O)C(CCO)O)=O,,,5,1,1,0,1
6340_0,,,,2,2,1,3
C(C(C=O)C(C=O)C(C=O)O)=O,,,5,1,2,0,2
6342_0,,,,2,2,1,3
C(C(C=O)C(C=O)C(C=CC)O)=O,,,5,1,1,0,1
6344_0,,,,2,2,1,3
C(C(C=O)C(C=O)C(CC=C)O)=O,,,5,1,1,0,1
6346_0,,,,2,2,1,3
C(C(C=O)C(C(C(O)=O)=O)CO)=O,,,5,1,1,0,1
6348_0,,,,2,2,1,3
C(C(C)O)(CC(CC(C=O)=O)O)=O,,,5,1,1,0,1
6350_0,,,,2,2,1,3
C(C(C(CC(C=O)=O)O)O)(CC)=O,,,5,1,2,0,2
6350_1,,,,2,2,1,3
6352_0,,,,2,2,1,3
C(CO)(C(C)C(CC(C=O)=O)O)=O,,,5,1,1,0,1
6354_0,,,,2,2,1,3
C(C(C(CC(C=O)=O)O)CCO)=O,,,5,1,1,0,1
6356_0,,,,2,2,1,3
C(CC(CC(C=O)=O)O)=O,,,5,1,1,0,1
6358_0,,,,2,2,1,3
C(C(C(CC(C=O)=O)O)C(C)O)=O,,,5,1,2,0,2
6358_1,,,,2,2,1,3
6360_0,,,,2,2,1,3
C(C(C=O)C(CC(C=O)=O)O)(O)=O,,,5,1,2,0,2
6360_1,,,,2,2,1,3
6362_0,,,,2,2,1,3
C(C=O)(CC(C(C(C=O)=O)O)O)=O,,,5,1,2,0,2
6362_1,,,,2,2,1,3
6364_0,,,,2,2,1,3
C(C(CO)C(CC(C=O)=O)O)=O,,,5,1,2,0,2
6364_1,,,,2,2,1,3
6365_0,,,,2,2,1,3
6365_1,,,,2,2,1,3
6367_0,,,,2,2,1,3
C(C(C=C)C(CC(C=O)=O)O)=O,,,5,1,1,0,1
6369_0,,,,2,2,1,3
C(C(CC(CC(C=O)=O)O)=O)(O)=O,,,5,1,1,0,1
6371_0,,,,2,2,1,3
C(CC(C(CC=O)=O)O)(C(C)O)=O,,,5,1,1,0,1
6373_0,,,,2,2,1,3
C(CC(C(C(C(CC)=O)O)O)=O)=O,,,5,1,2,0,2
6373_1,,,,2,2,1,3
6375_0,,,,2,2,1,3
C(CO)(C(C)C(C(CC=O)=O)O)=O,,,5,1,1,0,1
6377_0,,,,2,2,1,3
C(C(CCO)C(C(CC=O)=O)O)=O,,,5,1,1,0,1
6379_0,,,,2,2,1,3
C(CC(C(CC=O)O)=O)=O,,,5,1,2,0,2
6381_0,,,,2,2,1,3
C(C(C(C)O)C(C(CC=O)=O)O)=O,,,5,1,2,0,2
6381_1,,,,2,2,1,3
6383_0,,,,2,2,1,3
C(C(C=O)C(C(CC=O)=O)O)(O)=O,,,5,1,2,0,2
6383_1,,,,2,2,1,3
6385_0,,,,2,2,1,3
C(CC(C(C(C(C=O)=O)O)O)=O)=O,,,5,1,2,0,2
6385_1,,,,2,2,1,3
6387_0,,,,2,2,1,3
C(C(CO)C(C(CC=O)=O)O)=O,,,5,1,3,0,3
6387_1,,,,2,2,1,3
6389_0,,,,2,2,1,3
C(CC(C(C(C(CO)=O)O)O)=O)=O,,,5,1,2,0,2
6389_1,,,,2,2,1,3
6391_0,,,,2,2,1,3
C(C(C=C)C(C(CC=O)=O)O)=O,,,5,1,2,0,2
6393_0,,,,2,2,1,3
C(CC(C(CC(C(O)=O)=O)O)=O)=O,,,5,1,1,0,1
6395_0,,,,2,2,1,3
C(CC(C=O)(CC=O)O)(C(C)O)=O,,,5,1,1,0,1
6397_0,,,,2,2,1,3
C(C(C(C=O)(CC=O)O)O)(CC)=O,,,5,1,2,0,2
6397_1,,,,2,2,1,3
6399_0,,,,2,2,1,3
C(CO)(C(C)C(C=O)(CC=O)O)=O,,,5,1,1,0,1
6401_0,,,,2,2,1,3
C(CC(C=O)(C(C=O)CCO)O)=O,,,5,1,1,0,1
6403_0,,,,2,2,1,3
C(CC(C=O)(CC=O)O)=O,,,5,1,2,0,2
6405_0,,,,2,2,1,3
C(CC(C=O)(C(C=O)C(C)O)O)=O,,,5,1,2,0,2
6405_1,,,,2,2,1,3
6407_0,,,,2,2,1,3
C(C(C=O)C(C=O)(CC=O)O)(O)=O,,,5,1,2,0,2
6407_1,,,,2,2,1,3
6409_0,,,,2,2,1,3
C(CC(C=O)(C(C(C=O)=O)O)O)=O,,,5,1,3,0,3
6409_1,,,,2,2,1,3
6411_0,,,,2,2,1,3
C(CC(C=O)(C(C=O)CO)O)=O,,,5,1,3,0,3
6411_1,,,,2,2,1,3
6412_0,,,,2,2,1,3
6412_1,,,,2,2,1,3
6414_0,,,,2,2,1,3
C(C(C=C)C(C=O)(CC=O)O)=O,,,5,1,2,0,2
6416_0,,,,2,2,1,3
C(CC(C=O)(CC(C(O)=O)=O)O)=O,,,5,1,1,0,1
6418_0,,,,2,2,1,3
C(C(C(C=O)=O)C(C)(C(C)O)O)=O,,,5,1,2,0,2
6418_1,,,,2,2,1,3
6420_0,,,,2,2,1,3
C(C(C(C=O)=O)C(CO)(CC)O)=O,,,5,1,2,0,2
6420_1,,,,2,2,1,3
6422_0,,,,2,2,1,3
C(C(C(C=O)=O)C(C=C)O)=O,,,5,1,2,0,2
6422_1,,,,2,2,1,3
6424_0,,,,2,2,1,3
C(C(C(C=O)=O)C(C(CC)O)O)=O,,,5,1,2,0,2
6424_1,,,,2,2,1,3
6426_0,,,,2,2,1,3
C(C(C(C=O)=O)C(CCCO)O)=O,,,5,1,2,0,2
6426_1,,,,2,2,1,3
6428_0,,,,2,2,1,3
C(C(C(C=O)=O)C(C)O)=O,,,5,1,3,0,3
6428_1,,,,2,2,1,3
6430_0,,,,2,2,1,3
C(C(C(O)=O)C(C=O)=O)=O,,,5,1,4,0,4
6430_1,,,,2,2,1,3
6432_0,,,,2,2,1,3
C(C(C(C=O)=O)C(CC(C)O)O)=O,,,5,1,2,0,2
6432_1,,,,2,2,1,3
6434_0,,,,2,2,1,3
C(C(C(C=O)=O)C(CC(O)=O)O)=O,,,5,1,2,0,2
6434_1,,,,2,2,1,3
6436_0,,,,2,2,1,3
C(C(C(C=O)=O)C(C(CO)=O)O)=O,,,5,1,2,0,2
6436_1,,,,2,2,1,3
6438_0,,,,2,2,1,3
C(C(C(C=O)=O)C(C=O)(CO)O)=O,,,5,1,2,0,2
6438_1,,,,2,2,1,3
6440_0,,,,2,2,1,3
C(C(C(C=O)=O)CO)=O,,,5,1,3,0,3
6440_1,,,,2,2,1,3
6442_0,,,,2,2,1,3
C(C(C(C=O)=O)C(CCO)O)=O,,,5,1,3,0,3
6442_1,,,,2,2,1,3
6444_0,,,,2,2,1,3
C(C(C(C=O)=O)C(C=O)O)=O,,,5,1,3,0,3
6444_1,,,,2,2,1,3
6446_0,,,,2,2,1,3
C(C(C(C=O)=O)C(C(C=O)O)O)=O,,,5,1,2,0,2
6446_1,,,,2,2,1,3
6448_0,,,,2,2,1,3
C(C(C(C=O)=O)C(CO)(CO)O)=O,,,5,1,2,0,2
6448_1,,,,2,2,1,3
6450_0,,,,2,2,1,3
C(C(C(C=O)=O)C(C=CC)O)=O,,,5,1,3,0,3
6450_1,,,,2,2,1,3
6452_0,,,,2,2,1,3
C(C(C(C=O)=O)C(CC=C)O)=O,,,5,1,3,0,3
6452_1,,,,2,2,1,3
6454_0,,,,2,2,1,3
C(C(C(C=O)=O)C(C(O)=O)(C)O)=O,,,5,1,2,0,2
6454_1,,,,2,2,1,3
6456_0,,,,2,2,1,3
C(CC(C)(CC(C=O)=O)O)=O,,,5,1,1,0,1
6458_0,,,,2,2,1,3
C(C(CO)C(C)(CC(C=O)=O)O)=O,,,5,1,2,0,2
6458_1,,,,2,2,1,3
6460_0,,,,2,2,1,3
C(C(C=C)C(C)(CC(C=O)=O)O)=O,,,5,1,1,0,1
6462_0,,,,2,2,1,3
C(CC(C(CC(C)=O)=O)O)=O,,,5,1,2,0,2
6464_0,,,,2,2,1,3
C(C(CO)C(C(CC(C)=O)=O)O)=O,,,5,1,2,0,2
6464_1,,,,2,2,1,3
6466_0,,,,2,2,1,3
C(C(C=C)C(C(CC(C)=O)=O)O)=O,,,5,1,1,0,1
6468_0,,,,2,2,1,3
C(CC(C=O)(CC(C)=O)O)=O,,,5,1,2,0,2
6470_0,,,,2,2,1,3
C(CC(C=O)(C(C=O)CO)O)(C)=O,,,5,1,2,0,2
6470_1,,,,2,2,1,3
6472_0,,,,2,2,1,3
C(C(C=C)C(C=O)(CC(C)=O)O)=O,,,5,1,1,0,1
6474_0,,,,2,2,1,3
C(CC(C=C)O)(CC(C=O)=O)=O,,,5,1,1,0,1
6475_0,,,,2,2,1,3
6476_0,,,,2,2,1,3
6478_0,,,,2,2,1,3
C(CCO)(CC(C=O)=O)=O,,,5,1,2,0,2
6480_0,,,,2,2,1,3
C(CC(CCO)O)(CC(C=O)=O)=O,,,5,1,1,0,1
6482_0,,,,2,2,1,3
C(C(CC(CC(C=O)=O)=O)O)=O,,,5,1,1,0,1
6484_0,,,,2,2,1,3
C(CC(C=CC)O)(CC(C=O)=O)=O,,,5,1,1,0,1
6486_0,,,,2,2,1,3
C(CC(CC=C)O)(CC(C=O)=O)=O,,,5,1,1,0,1
6488_0,,,,2,2,1,3
C(C)(C(C(C=O)=O)C(C=C)O)=O,,,5,1,2,0,2
6488_1,,,,2,2,1,3
6490_0,,,,2,2,1,3
C(C)(C(C(C=O)=O)C(C)O)=O,,,5,1,3,0,3
6490_1,,,,2,2,1,3
6492_0,,,,2,2,1,3
C(C(C(C)=O)C(C=O)=O)(O)=O,,,5,1,3,0,3
6492_1,,,,2,2,1,3
6494_0,,,,2,2,1,3
C(C)(C(C(C=O)=O)CO)=O,,,5,1,3,0,3
6494_1,,,,2,2,1,3
6496_0,,,,2,2,1,3
C(C)(C(C(C=O)=O)C(CCO)O)=O,,,5,1,2,0,2
6496_1,,,,2,2,1,3
6498_0,,,,2,2,1,3
C(C(C(C(C)=O)C(C=O)=O)O)=O,,,5,1,3,0,3
6498_1,,,,2,2,1,3
6500_0,,,,2,2,1,3
C(C)(C(C(C=O)=O)C(C=CC)O)=O,,,5,1,2,0,2
6500_1,,,,2,2,1,3
6502_0,,,,2,2,1,3
C(C)(C(C(C=O)=O)C(CC=C)O)=O,,,5,1,2,0,2
6502_1,,,,2,2,1,3
6504_0,,,,2,2,1,3
C(CC(C(C=O)=O)(CC)O)=O,,,5,1,1,0,1
6506_0,,,,2,2,1,3
C(C(CO)C(C(C=O)=O)(CC)O)=O,,,5,1,2,0,2
6506_1,,,,2,2,1,3
6508_0,,,,2,2,1,3
C(C(C=C)C(C(C=O)=O)(CC)O)=O,,,5,1,1,0,1
6510_0,,,,2,2,1,3
C(CC(C(C(CC)=O)=O)O)=O,,,5,1,2,0,2
6512_0,,,,2,2,1,3
C(C(CO)C(C(C(CC)=O)=O)O)=O,,,5,1,2,0,2
6512_1,,,,2,2,1,3
6514_0,,,,2,2,1,3
C(C(C=C)C(C(C(CC)=O)=O)O)=O,,,5,1,1,0,1
6516_0,,,,2,2,1,3
C(CC)(C(C=O)(CC=O)O)=O,,,5,1,2,0,2
6518_0,,,,2,2,1,3
C(CC)(C(C=O)(C(C=O)CO)O)=O,,,5,1,2,0,2
6518_1,,,,2,2,1,3
6520_0,,,,2,2,1,3
C(C(C=C)C(C=O)(C(CC)=O)O)=O,,,5,1,1,0,1
6522_0,,,,2,2,1,3
C=CC(C(C(C(C=O)=O)=O)C)O,,,5,1,1,0,1
6524_0,,,,2,2,1,3
C(C(C(C(C)C(C)O)=O)=O)=O,,,5,1,1,0,1
6525_0,,,,2,2,1,3
6527_0,,,,2,2,1,3
C(C(C(C(C)CO)=O)=O)=O,,,5,1,1,0,1
6529_0,,,,2,2,1,3
C(C(C(C(C)C(CCO)O)=O)=O)=O,,,5,1,1,0,1
6531_0,,,,2,2,1,3
C(C(C(C(C(C=O)=O)=O)C)O)=O,,,5,1,1,0,1
6533_0,,,,2,2,1,3
C(C)=CC(C(C(C(C=O)=O)=O)C)O,,,5,1,1,0,1
6535_0,,,,2,2,1,3
C=CCC(C(C(C(C=O)=O)=O)C)O,,,5,1,1,0,1
6537_0,,,,2,2,1,3
C(C(CCC(C)O)(CC=O)O)(O)=O,,,5,1,1,0,1
6539_0,,,,2,2,1,3
C(C(C(CC(C)O)C(C)O)=O)(O)=O,,,5,1,2,0,2
6541_0,,,,2,2,1,3
C(C(C(C(O)=O)=O)CC(C)O)(O)=O,,,5,1,2,0,2
6543_0,,,,2,2,1,3
C(C(C(CO)CC(C)O)=O)(O)=O,,,5,1,1,0,1
6545_0,,,,2,2,1,3
C(CC(CC(C)O)(CC=O)O)(O)=O,,,5,1,1,0,1
6547_0,,,,2,2,1,3
C(C(C(CC(C)O)=O)C(C)O)(O)=O,,,5,1,2,0,2
6547_1,,,,2,2,1,3
6549_0,,,,2,2,1,3
C(C(C(O)=O)C(CC(C)O)=O)(O)=O,,,5,1,2,0,2
6549_1,,,,2,2,1,3
6550_0,,,,2,2,1,3
6550_1,,,,2,2,1,3
6552_0,,,,2,2,1,3
C(CC(C(C(C)O)C(C)O)=O)(O)=O,,,5,1,2,0,2
6552_1,,,,2,2,1,3
6554_0,,,,2,2,1,3
C(C(C(CC(O)=O)=O)C(C)O)(O)=O,,,5,1,4,0,4
6554_1,,,,2,2,1,3
6556_0,,,,2,2,1,3
C(CC(C(CO)C(C)O)=O)(O)=O,,,5,1,4,0,4
6556_1,,,,2,2,1,3
6558_0,,,,2,2,1,3
C(CCC(C(O)=O)(CC=O)O)(O)=O,,,5,1,1,0,1
6560_0,,,,2,2,1,3
C(CC(C(C(O)=O)=O)C(C)O)(O)=O,,,5,1,2,0,2
6562_0,,,,2,2,1,3
C(C(C(C(O)=O)=O)CC(O)=O)(O)=O,,,5,1,1,0,1
6564_0,,,,2,2,1,3
C(CC(C(C(O)=O)=O)CO)(O)=O,,,5,1,2,0,2
6566_0,,,,2,2,1,3
C(CC(CC(O)=O)(CC=O)O)(O)=O,,,5,1,1,0,1
6567_0,,,,2,2,1,3
6567_1,,,,2,2,1,3
6569_0,,,,2,2,1,3
C(C(C(O)=O)C(CC(O)=O)=O)(O)=O,,,5,1,2,0,2
6569_1,,,,2,2,1,3
6570_0,,,,2,2,1,3
6570_1,,,,2,2,1,3
6572_0,,,,2,2,1,3
C(CC(C(CO)=O)(CC=O)O)(O)=O,,,5,1,1,0,1
6574_0,,,,2,2,1,3
C(C(CO)(CC=O)O)(CC(O)=O)=O,,,5,1,1,0,1
6576_0,,,,2,2,1,3
C(C(C(C(CO)=O)=O)C(C)O)(O)=O,,,5,1,2,0,2
6576_1,,,,2,2,1,3
6578_0,,,,2,2,1,3
C(C(C(O)=O)C(C(CO)=O)=O)(O)=O,,,5,1,2,0,2
6578_1,,,,2,2,1,3
6579_0,,,,2,2,1,3
6579_1,,,,2,2,1,3
6581_0,,,,2,2,1,3
C(CC(C(C(C(C)O)O)=O)=O)(O)=O,,,5,1,2,0,2
6581_1,,,,2,2,1,3
6582_0,,,,2,2,1,3
6582_1,,,,2,2,1,3
6583_0,,,,2,2,1,3
6583_1,,,,2,2,1,3
6585_0,,,,2,2,1,3
C(CC(C(O)=O)(C(C=O)CO)O)=O,,,5,1,1,0,1
6587_0,,,,2,2,1,3
C(CC(C(C(C(O)=O)=O)CO)O)=O,,,5,1,1,0,1
6589_0,,,,2,2,1,3
C(CC(C(C=O)C(C(O)=O)O)O)=O,,,5,1,1,0,1
6591_0,,,,2,2,1,3
C(C(CC)(CC(C(C)O)=O)O)(O)=O,,,5,1,1,0,1
6593_0,,,,2,2,1,3
C(C(CC)(C(C(CC)=O)O)O)(O)=O,,,5,1,2,0,2
6593_1,,,,2,2,1,3
6595_0,,,,2,2,1,3
C(C(CC)(C(C(CO)=O)C)O)(O)=O,,,5,1,1,0,1
6597_0,,,,2,2,1,3
C(C(CCO)C(C(O)=O)(CC)O)=O,,,5,1,1,0,1
6599_0,,,,2,2,1,3
C(C(CC)(CC=O)O)(O)=O,,,5,1,1,0,1
6601_0,,,,2,2,1,3
C(C(C(C)O)C(C(O)=O)(CC)O)=O,,,5,1,2,0,2
6601_1,,,,2,2,1,3
6603_0,,,,2,2,1,3
C(C(C=O)C(C(O)=O)(CC)O)(O)=O,,,5,1,2,0,2
6603_1,,,,2,2,1,3
6605_0,,,,2,2,1,3
C(C(CC)(C(C(C=O)=O)O)O)(O)=O,,,5,1,2,0,2
6605_1,,,,2,2,1,3
6607_0,,,,2,2,1,3
C(C(CO)C(C(O)=O)(CC)O)=O,,,5,1,2,0,2
6607_1,,,,2,2,1,3
6609_0,,,,2,2,1,3
C(C(CC)(C(C(CO)=O)O)O)(O)=O,,,5,1,2,0,2
6609_1,,,,2,2,1,3
6611_0,,,,2,2,1,3
C(C(C=C)C(C(O)=O)(CC)O)=O,,,5,1,1,0,1
6613_0,,,,2,2,1,3
C(C(CC)(CC(C(O)=O)=O)O)(O)=O,,,5,1,1,0,1
6615_0,,,,2,2,1,3
C(C(C(C)C(C)(C(C)O)O)=O)(O)=O,,,5,1,1,0,1
6617_0,,,,2,2,1,3
C(C(C(C)C(CO)(CC)O)=O)(O)=O,,,5,1,1,0,1
6619_0,,,,2,2,1,3
C=CC(C(C(C(O)=O)=O)C)O,,,5,1,1,0,1
6621_0,,,,2,2,1,3
C(C(C(C)C(C(CC)O)O)=O)(O)=O,,,5,1,1,0,1
6623_0,,,,2,2,1,3
C(C(C(C)C(CCCO)O)=O)(O)=O,,,5,1,1,0,1
6625_0,,,,2,2,1,3
C(C(C(C)C(C)O)=O)(O)=O,,,5,1,1,0,1
6626_0,,,,2,2,1,3
6628_0,,,,2,2,1,3
C(C(C(C)C(CC(C)O)O)=O)(O)=O,,,5,1,1,0,1
6630_0,,,,2,2,1,3
C(CC(C(C(C(O)=O)=O)C)O)(O)=O,,,5,1,1,0,1
6632_0,,,,2,2,1,3
C(C(C(C(C(O)=O)=O)C)O)(CO)=O,,,5,1,1,0,1
6634_0,,,,2,2,1,3
C(C(CO)(C(C(C(O)=O)=O)C)O)=O,,,5,1,1,0,1
6636_0,,,,2,2,1,3
C(C(C(C)CO)=O)(O)=O,,,5,1,1,0,1
6638_0,,,,2,2,1,3
C(C(C(C)C(CCO)O)=O)(O)=O,,,5,1,1,0,1
6640_0,,,,2,2,1,3
C(C(C(C(C(O)=O)=O)C)O)=O,,,5,1,1,0,1
6642_0,,,,2,2,1,3
C(C(C(C(C(C(O)=O)=O)C)O)O)=O,,,5,1,1,0,1
6644_0,,,,2,2,1,3
C(C(C(C)C(CO)(CO)O)=O)(O)=O,,,5,1,1,0,1
6646_0,,,,2,2,1,3
C(C)=CC(C(C(C(O)=O)=O)C)O,,,5,1,1,0,1
6648_0,,,,2,2,1,3
C=CCC(C(C(C(O)=O)=O)C)O,,,5,1,1,0,1
6650_0,,,,2,2,1,3
C(C(C)(C(C(C(O)=O)=O)C)O)(O)=O,,,5,1,1,0,1
6652_0,,,,2,2,1,3
C(C(C)C(C(O)=O)(CC=O)O)(O)=O,,,5,1,1,0,1
6654_0,,,,2,2,1,3
C(C(C(C(C(O)=O)=C)=O)CO)(O)=O,,,5,1,2,0,2
6654_1,,,,2,2,1,3
6656_0,,,,2,2,1,3
C(C(C)O)(CC(C)(C(C)O)O)=O,,,5,1,1,0,1
6658_0,,,,2,2,1,3
C(C(C(C)(C(C)O)O)O)(CC)=O,,,5,1,2,0,2
6658_1,,,,2,2,1,3
6660_0,,,,2,2,1,3
C(CO)(C(C)C(C)(C(C)O)O)=O,,,5,1,1,0,1
6662_0,,,,2,2,1,3
C(C(CCO)C(C)(C(C)O)O)=O,,,5,1,1,0,1
6664_0,,,,2,2,1,3
C1(C(C(CO1)C(C)(C(C)O)O)=O)=O,,,5,1,2,0,2
6664_1,,,,2,2,1,3
6666_0,,,,2,2,1,3
C(C(C(C)CO)C(C)(C(C)O)O)=O,,,5,1,1,0,1
6668_0,,,,2,2,1,3
C(CC(C)(C(C)O)O)=O,,,5,1,1,0,1
6670_0,,,,2,2,1,3
C(C(C(C)O)C(C)(C(C)O)O)=O,,,5,1,2,0,2
6670_1,,,,2,2,1,3
6672_0,,,,2,2,1,3
C(C(C=O)C(C)(C(C)O)O)(O)=O,,,5,1,2,0,2
6672_1,,,,2,2,1,3
6674_0,,,,2,2,1,3
C(C(C(C(C)(C(C)O)O)O)=O)=O,,,5,1,2,0,2
6674_1,,,,2,2,1,3
6676_0,,,,2,2,1,3
C(C(CO)C(C)(C(C)O)O)=O,,,5,1,2,0,2
6676_1,,,,2,2,1,3
6678_0,,,,2,2,1,3
C(CO)(C(C(C)(C(C)O)O)O)=O,,,5,1,2,0,2
6678_1,,,,2,2,1,3
6680_0,,,,2,2,1,3
C(C(C(C(C)(C(C)O)O)O)=O)(O)=O,,,5,1,2,0,2
6680_1,,,,2,2,1,3
6682_0,,,,2,2,1,3
C(C(C=C)C(C)(C(C)O)O)=O,,,5,1,1,0,1
6684_0,,,,2,2,1,3
C(C(CC(C)(C(C)O)O)=O)(O)=O,,,5,1,1,0,1
6686_0,,,,2,2,1,3
C(C(C)O)(CC(CO)(CC)O)=O,,,5,1,1,0,1
6688_0,,,,2,2,1,3
C(CC(C(C(C)O)=C)O)(C(C)O)=O,,,5,1,1,0,1
6690_0,,,,2,2,1,3
C(CC(C(CO)=CC)O)(C(C)O)=O,,,5,1,1,0,1
6692_0,,,,2,2,1,3
C(CC(C=C)O)(C(C)O)=O,,,5,1,1,0,1
6694_0,,,,2,2,1,3
C(C(C=C)(CC(C(C)O)=O)O)(O)=O,,,5,1,1,0,1
6696_0,,,,2,2,1,3
C(C(C)O)(CC(C(CC)O)O)=O,,,5,1,1,0,1
6698_0,,,,2,2,1,3
C(C(C)O)(CC(CCCO)O)=O,,,5,1,1,0,1
6700_0,,,,2,2,1,3
C1(C(CCO1)(CC(C(C)O)=O)O)=O,,,5,1,1,0,1
6702_0,,,,2,2,1,3
C(C(C)O)(CC(CC(CO)C)O)=O,,,5,1,1,0,1
6704_0,,,,2,2,1,3
C(C(C)O)(CC(C)O)=O,,,5,1,1,0,1
6705_0,,,,2,2,1,3
6707_0,,,,2,2,1,3
C(C(C)O)(CC(CC(C)O)O)=O,,,5,1,1,0,1
6709_0,,,,2,2,1,3
C(CC(CC(C(C)O)=O)O)(O)=O,,,5,1,1,0,1
6711_0,,,,2,2,1,3
C(CC(C(CO)=O)O)(C(C)O)=O,,,5,1,1,0,1
6713_0,,,,2,2,1,3
C(C(CO)(CC(C(C)O)=O)O)=O,,,5,1,1,0,1
6715_0,,,,2,2,1,3
C(C(C)O)(CCO)=O,,,5,1,1,0,1
6717_0,,,,2,2,1,3
C(C(C)O)(CC(CCO)O)=O,,,5,1,1,0,1
6719_0,,,,2,2,1,3
C(CC(C=O)O)(C(C)O)=O,,,5,1,1,0,1
6721_0,,,,2,2,1,3
C(C(C)O)(CC(C(C=O)O)O)=O,,,5,1,1,0,1
6723_0,,,,2,2,1,3
C(C(C)O)(CC(CO)(CO)O)=O,,,5,1,1,0,1
6725_0,,,,2,2,1,3
C(C(CO)(CC(C(C)O)=O)O)(O)=O,,,5,1,1,0,1
6727_0,,,,2,2,1,3
C(C(C)O)(CC(C(C(O)=O)O)O)=O,,,5,1,1,0,1
6729_0,,,,2,2,1,3
C(CC(C=CC)O)(C(C)O)=O,,,5,1,1,0,1
6731_0,,,,2,2,1,3
C(C(C)O)(CC(CC=C)O)=O,,,5,1,1,0,1
6733_0,,,,2,2,1,3
C(C(C)(CC(C(C)O)=O)O)(O)=O,,,5,1,1,0,1
6735_0,,,,2,2,1,3
C(C(C(CO)(CC)O)O)(CC)=O,,,5,1,2,0,2
6735_1,,,,2,2,1,3
6737_0,,,,2,2,1,3
C(CO)(C(C)C(CO)(CC)O)=O,,,5,1,1,0,1
6739_0,,,,2,2,1,3
C(C(CCO)C(CO)(CC)O)=O,,,5,1,1,0,1
6741_0,,,,2,2,1,3
C1(C(C(CO1)C(CO)(CC)O)=O)=O,,,5,1,2,0,2
6741_1,,,,2,2,1,3
6743_0,,,,2,2,1,3
C(C(C(C)CO)C(CO)(CC)O)=O,,,5,1,1,0,1
6745_0,,,,2,2,1,3
C(CC(CO)(CC)O)=O,,,5,1,1,0,1
6747_0,,,,2,2,1,3
C(C(C(C)O)C(CO)(CC)O)=O,,,5,1,2,0,2
6747_1,,,,2,2,1,3
6749_0,,,,2,2,1,3
C(C(C=O)C(CO)(CC)O)(O)=O,,,5,1,2,0,2
6749_1,,,,2,2,1,3
6751_0,,,,2,2,1,3
C(C(C(C(CO)(CC)O)O)=O)=O,,,5,1,2,0,2
6751_1,,,,2,2,1,3
6753_0,,,,2,2,1,3
C(C(CO)C(CO)(CC)O)=O,,,5,1,2,0,2
6753_1,,,,2,2,1,3
6755_0,,,,2,2,1,3
C(CO)(C(C(CO)(CC)O)O)=O,,,5,1,2,0,2
6755_1,,,,2,2,1,3
6757_0,,,,2,2,1,3
C(C(C(C(CO)(CC)O)O)=O)(O)=O,,,5,1,2,0,2
6757_1,,,,2,2,1,3
6759_0,,,,2,2,1,3
C(C(C=C)C(CO)(CC)O)=O,,,5,1,1,0,1
6761_0,,,,2,2,1,3
C(C(CC(CO)(CC)O)=O)(O)=O,,,5,1,1,0,1
6763_0,,,,2,2,1,3
C(C(C(C(C(C)O)=C)O)O)(CC)=O,,,5,1,2,0,2
6763_1,,,,2,2,1,3
6765_0,,,,2,2,1,3
C(C(C(C(CO)=CC)O)O)(CC)=O,,,5,1,2,0,2
6765_1,,,,2,2,1,3
6767_0,,,,2,2,1,3
C(C(C(C=C)O)O)(CC)=O,,,5,1,2,0,2
6767_1,,,,2,2,1,3
6769_0,,,,2,2,1,3
C(C(C=C)(C(C(CC)=O)O)O)(O)=O,,,5,1,2,0,2
6769_1,,,,2,2,1,3
6771_0,,,,2,2,1,3
C(C(C(C(CC)O)O)O)(CC)=O,,,5,1,2,0,2
6771_1,,,,2,2,1,3
6773_0,,,,2,2,1,3
C(C(C(CCCO)O)O)(CC)=O,,,5,1,2,0,2
6773_1,,,,2,2,1,3
6775_0,,,,2,2,1,3
C1(C(CCO1)(C(C(CC)=O)O)O)=O,,,5,1,2,0,2
6775_1,,,,2,2,1,3
6777_0,,,,2,2,1,3
C(C(C(CC(CO)C)O)O)(CC)=O,,,5,1,2,0,2
6777_1,,,,2,2,1,3
6779_0,,,,2,2,1,3
C(C(C(C)O)O)(CC)=O,,,5,1,2,0,2
6779_1,,,,2,2,1,3
6780_0,,,,2,2,1,3
6780_1,,,,2,2,1,3
6782_0,,,,2,2,1,3
C(C(C(CC(C)O)O)O)(CC)=O,,,5,1,2,0,2
6782_1,,,,2,2,1,3
6784_0,,,,2,2,1,3
C(CC(C(C(CC)=O)O)O)(O)=O,,,5,1,2,0,2
6784_1,,,,2,2,1,3
6786_0,,,,2,2,1,3
C(C(C(C(CC)=O)O)O)(CO)=O,,,5,1,2,0,2
6786_1,,,,2,2,1,3
6788_0,,,,2,2,1,3
C(C(CO)(C(C(CC)=O)O)O)=O,,,5,1,2,0,2
6788_1,,,,2,2,1,3
6790_0,,,,2,2,1,3
C(C(CO)O)(CC)=O,,,5,1,2,0,2
6790_1,,,,2,2,1,3
6792_0,,,,2,2,1,3
C(C(C(CCO)O)O)(CC)=O,,,5,1,2,0,2
6792_1,,,,2,2,1,3
6794_0,,,,2,2,1,3
C(C(C(C=O)O)O)(CC)=O,,,5,1,2,0,2
6794_1,,,,2,2,1,3
6796_0,,,,2,2,1,3
C(C(C(C(C=O)O)O)O)(CC)=O,,,5,1,2,0,2
6796_1,,,,2,2,1,3
6798_0,,,,2,2,1,3
C(C(C(CO)(CO)O)O)(CC)=O,,,5,1,2,0,2
6798_1,,,,2,2,1,3
6800_0,,,,2,2,1,3
C(C(CO)(C(C(CC)=O)O)O)(O)=O,,,5,1,2,0,2
6800_1,,,,2,2,1,3
6802_0,,,,2,2,1,3
C(C(C(C(C(O)=O)O)O)O)(CC)=O,,,5,1,2,0,2
6802_1,,,,2,2,1,3
6804_0,,,,2,2,1,3
C(C(C(C=CC)O)O)(CC)=O,,,5,1,2,0,2
6804_1,,,,2,2,1,3
6806_0,,,,2,2,1,3
C(C(C(CC=C)O)O)(CC)=O,,,5,1,2,0,2
6806_1,,,,2,2,1,3
6808_0,,,,2,2,1,3
C(C(C)(C(C(CC)=O)O)O)(O)=O,,,5,1,2,0,2
6808_1,,,,2,2,1,3
6810_0,,,,2,2,1,3
C(CO)(C(C)C(C(C(C)O)=C)O)=O,,,5,1,1,0,1
6812_0,,,,2,2,1,3
C(CO)(C(C)C(C(CO)=CC)O)=O,,,5,1,1,0,1
6814_0,,,,2,2,1,3
C(CO)(C(C)C(C=C)O)=O,,,5,1,1,0,1
6816_0,,,,2,2,1,3
C(C(C=C)(C(C(CO)=O)C)O)(O)=O,,,5,1,1,0,1
6818_0,,,,2,2,1,3
C(CO)(C(C)C(C(CC)O)O)=O,,,5,1,1,0,1
6820_0,,,,2,2,1,3
C(CO)(C(C)C(CCCO)O)=O,,,5,1,1,0,1
6822_0,,,,2,2,1,3
C1(C(CCO1)(C(C(CO)=O)C)O)=O,,,5,1,1,0,1
6824_0,,,,2,2,1,3
C(CO)(C(C)C(CC(CO)C)O)=O,,,5,1,1,0,1
6826_0,,,,2,2,1,3
C(CO)(C(C)C(C)O)=O,,,5,1,1,0,1
6827_0,,,,2,2,1,3
6829_0,,,,2,2,1,3
C(CO)(C(C)C(CC(C)O)O)=O,,,5,1,1,0,1
6831_0,,,,2,2,1,3
C(CC(C(C(CO)=O)C)O)(O)=O,,,5,1,1,0,1
6833_0,,,,2,2,1,3
C(CO)(C(C)C(C(CO)=O)O)=O,,,5,1,1,0,1
6835_0,,,,2,2,1,3
C(C(CO)(C(C(CO)=O)C)O)=O,,,5,1,1,0,1
6837_0,,,,2,2,1,3
C(CO)(C(CO)C)=O,,,5,1,1,0,1
6839_0,,,,2,2,1,3
C(CO)(C(C)C(CCO)O)=O,,,5,1,1,0,1
6841_0,,,,2,2,1,3
C(CO)(C(C)C(C=O)O)=O,,,5,1,1,0,1
6843_0,,,,2,2,1,3
C(C(C(C(C(CO)=O)C)O)O)=O,,,5,1,1,0,1
6845_0,,,,2,2,1,3
C(CO)(C(C)C(CO)(CO)O)=O,,,5,1,1,0,1
6847_0,,,,2,2,1,3
C(C(CO)(C(C(CO)=O)C)O)(O)=O,,,5,1,1,0,1
6849_0,,,,2,2,1,3
C(C(C(C(C(CO)=O)C)O)O)(O)=O,,,5,1,1,0,1
6851_0,,,,2,2,1,3
C(CO)(C(C)C(C=CC)O)=O,,,5,1,1,0,1
6853_0,,,,2,2,1,3
C(CO)(C(C)C(CC=C)O)=O,,,5,1,1,0,1
6855_0,,,,2,2,1,3
C(C(C)(C(C(CO)=O)C)O)(O)=O,,,5,1,1,0,1
6857_0,,,,2,2,1,3
C(CC(C)(CC(C(O)=O)O)O)=O,,,5,1,1,0,1
6859_0,,,,2,2,1,3
C(C(C(C(C)=O)C(C=C)O)O)(O)=O,,,5,1,2,0,2
6859_1,,,,2,2,1,3
6861_0,,,,2,2,1,3
C(C)(C(C(C)O)C(C(O)=O)O)=O,,,5,1,3,0,3
6861_1,,,,2,2,1,3
6862_0,,,,2,2,1,3
6862_1,,,,2,2,1,3
6863_0,,,,2,2,1,3
6863_1,,,,2,2,1,3
6865_0,,,,2,2,1,3
C(C(C(C(C)=O)C(C=O)O)O)(O)=O,,,5,1,2,0,2
6865_1,,,,2,2,1,3
6867_0,,,,2,2,1,3
C(C(CC(CC(C=C)O)=O)O)(O)=O,,,5,1,1,0,1
6869_0,,,,2,2,1,3
C(CC(C(O)=O)O)(CC(C)O)=O,,,5,1,4,0,4
6870_0,,,,2,2,1,3
6871_0,,,,2,2,1,3
6873_0,,,,2,2,1,3
C(C(CC(CC(C=O)O)=O)O)(O)=O,,,5,1,1,0,1
6875_0,,,,2,2,1,3
C(CC=O)(C(C(C(O)=O)=O)CO)=O,,,5,1,2,0,2
6875_1,,,,2,2,1,3
6877_0,,,,2,2,1,3
C(C(C(CC(C(O)=O)=O)=O)CO)=O,,,5,1,2,0,2
6877_1,,,,2,2,1,3
6879_0,,,,2,2,1,3
C(C)(C(C(C(C(O)=O)=O)=O)CO)=O,,,5,1,2,0,2
6879_1,,,,2,2,1,3
6881_0,,,,2,2,1,3
C(CCO)(CC(C(C(O)=O)=O)=O)=O,,,5,1,1,0,1
6883_0,,,,2,2,1,3
C1(C(C(C(C(O)=O)(C)O1)=O)CO)=O,,,5,1,2,0,2
6883_1,,,,2,2,1,3
6885_0,,,,2,2,1,3
C1(C(C(C(C(O1)=O)(C)O)=O)CO)=O,,,5,1,2,0,2
6885_1,,,,2,2,1,3
6887_0,,,,2,2,1,3
C(CC1(C(C=C(C(O)=O)C1)=O)O)=O,,,5,1,1,0,1
6889_0,,,,2,2,1,3
C1(CC(C(O)=O)=CC1(CC=O)O)=O,,,5,1,1,0,1
6891_0,,,,2,2,1,3
C=CC(C1C(C(C=C1C(O)=O)=O)=O)O,,,5,1,1,0,1
6893_0,,,,2,2,1,3
C1(C(C=C(C(O)=O)C1C(C)O)=O)=O,,,5,1,1,0,1
6895_0,,,,2,2,1,3
C(C1C(C(C=C1C(O)=O)=O)=O)(O)=O,,,5,1,1,0,1
6897_0,,,,2,2,1,3
C1(C(C=C(C(O)=O)C1CO)=O)=O,,,5,1,2,0,2
6899_0,,,,2,2,1,3
C(C(C1C(C(C=C1C(O)=O)=O)=O)O)=O,,,5,1,1,0,1
6901_0,,,,2,2,1,3
C(CC(C=CCC(C)O)O)=O,,,5,1,2,0,2
6903_0,,,,2,2,1,3
C(C(CO)C(C=CCC(C)O)O)=O,,,5,1,2,0,2
6903_1,,,,2,2,1,3
6905_0,,,,2,2,1,3
C(C(C=C)C(C=CCC(C)O)O)=O,,,5,1,1,0,1
6907_0,,,,2,2,1,3
C(CC(CC=CC(C)O)O)=O,,,5,1,2,0,2
6909_0,,,,2,2,1,3
C(C(C(CC=CC(C)O)O)CO)=O,,,5,1,2,0,2
6909_1,,,,2,2,1,3
6911_0,,,,2,2,1,3
C(C(C=C)C(CC=CC(C)O)O)=O,,,5,1,1,0,1
6913_0,,,,2,2,1,3
C(C(C=CC(C)O)C(C=C)O)=O,,,5,1,1,0,1
6914_0,,,,2,2,1,3
6915_0,,,,2,2,1,3
6917_0,,,,2,2,1,3
C(C(C=CC(C)O)CO)=O,,,5,1,2,0,2
6919_0,,,,2,2,1,3
C(C(C=CC(C)O)C(CCO)O)=O,,,5,1,1,0,1
6921_0,,,,2,2,1,3
C(C(C=CC(C)O)C(C=O)O)=O,,,5,1,2,0,2
6923_0,,,,2,2,1,3
C(C(C=CC(C)O)C(C=CC)O)=O,,,5,1,1,0,1
6925_0,,,,2,2,1,3
C(C(C=CC(C)O)C(CC=C)O)=O,,,5,1,1,0,1
6927_0,,,,2,2,1,3
C(C(C(C(O)=O)=O)CO)=CC(C)O,,,5,1,1,0,1
6929_0,,,,2,2,1,3
C(C(C(C)O)=CC(C(CO)O)=O)=O,,,5,1,2,0,2
6929_1,,,,2,2,1,3
6931_0,,,,2,2,1,3
C(C(CO)O)(C(C(C=O)=CC)O)=O,,,5,1,2,0,2
6931_1,,,,2,2,1,3
6933_0,,,,2,2,1,3
C(C(CCO)C(C(C(C)O)=C)O)=O,,,5,1,1,0,1
6935_0,,,,2,2,1,3
C(CC(C(C(C)O)=C)O)=O,,,5,1,2,0,2
6937_0,,,,2,2,1,3
C(C(C(C)O)C(C(C(C)O)=C)O)=O,,,5,1,2,0,2
6937_1,,,,2,2,1,3
6939_0,,,,2,2,1,3
C(C(C=O)C(C(C(C)O)=C)O)(O)=O,,,5,1,2,0,2
6939_1,,,,2,2,1,3
6941_0,,,,2,2,1,3
C=C(C(C(C(C=O)=O)O)O)C(C)O,,,5,1,2,0,2
6941_1,,,,2,2,1,3
6943_0,,,,2,2,1,3
C(C(CO)C(C(C(C)O)=C)O)=O,,,5,1,3,0,3
6943_1,,,,2,2,1,3
6945_0,,,,2,2,1,3
C(C(C(C(C(C)O)=C)O)O)(CO)=O,,,5,1,2,0,2
6945_1,,,,2,2,1,3
6947_0,,,,2,2,1,3
C(C(C=C)C(C(C(C)O)=C)O)=O,,,5,1,2,0,2
6949_0,,,,2,2,1,3
C=C(C(CC(C(O)=O)=O)O)C(C)O,,,5,1,1,0,1
6951_0,,,,2,2,1,3
C(C(CCO)C(C(CO)=CC)O)=O,,,5,1,1,0,1
6953_0,,,,2,2,1,3
C(CC(C(CO)=CC)O)=O,,,5,1,2,0,2
6955_0,,,,2,2,1,3
C(C(C(C)O)C(C(CO)=CC)O)=O,,,5,1,2,0,2
6955_1,,,,2,2,1,3
6957_0,,,,2,2,1,3
C(C(C=O)C(C(CO)=CC)O)(O)=O,,,5,1,2,0,2
6957_1,,,,2,2,1,3
6959_0,,,,2,2,1,3
C(C)=C(CO)C(C(C(C=O)=O)O)O,,,5,1,2,0,2
6959_1,,,,2,2,1,3
6961_0,,,,2,2,1,3
C(C(CO)C(C(CO)=CC)O)=O,,,5,1,3,0,3
6961_1,,,,2,2,1,3
6963_0,,,,2,2,1,3
C(CO)(C(C(C(CO)=CC)O)O)=O,,,5,1,2,0,2
6963_1,,,,2,2,1,3
6965_0,,,,2,2,1,3
C(C(C=C)C(C(CO)=CC)O)=O,,,5,1,2,0,2
6967_0,,,,2,2,1,3
C(C)=C(CO)C(CC(C(O)=O)=O)O,,,5,1,1,0,1
6969_0,,,,2,2,1,3
C(CC(C(C(C)O)=CC)O)=O,,,5,1,2,0,2
6971_0,,,,2,2,1,3
C(C(CO)C(C(C(C)O)=CC)O)=O,,,5,1,2,0,2
6971_1,,,,2,2,1,3
6973_0,,,,2,2,1,3
C(C(C=C)C(C(C(C)O)=CC)O)=O,,,5,1,1,0,1
6975_0,,,,2,2,1,3
C(CC(C(C(O)=O)=CC)O)=O,,,5,1,2,0,2
6977_0,,,,2,2,1,3
C(C(CO)C(C(C(O)=O)=CC)O)=O,,,5,1,2,0,2
6977_1,,,,2,2,1,3
6979_0,,,,2,2,1,3
C(C(C=C)C(C(C(O)=O)=CC)O)=O,,,5,1,1,0,1
6981_0,,,,2,2,1,3
C(C(C(C(O)=O)=CC(C)O)CO)=O,,,5,1,1,0,1
6983_0,,,,2,2,1,3
C(C(C(C(C)O)=C)(CC=O)O)(O)=O,,,5,1,1,0,1
6985_0,,,,2,2,1,3
C(C(C(CO)=CC)(CC=O)O)(O)=O,,,5,1,1,0,1
6987_0,,,,2,2,1,3
C(CC=CC(CC=O)O)(O)=O,,,5,1,2,0,2
6989_0,,,,2,2,1,3
C(C(CO)C(C=CCC(O)=O)O)=O,,,5,1,2,0,2
6989_1,,,,2,2,1,3
6991_0,,,,2,2,1,3
C(C(C=C)C(C=CCC(O)=O)O)=O,,,5,1,1,0,1
6993_0,,,,2,2,1,3
C(CC(CC=CC(O)=O)O)=O,,,5,1,2,0,2
6995_0,,,,2,2,1,3
C(C(CO)C(CC=CC(O)=O)O)=O,,,5,1,2,0,2
6995_1,,,,2,2,1,3
6997_0,,,,2,2,1,3
C(C(C=C)C(CC=CC(O)=O)O)=O,,,5,1,1,0,1
6999_0,,,,2,2,1,3
C(C(C=CC(O)=O)C(C=C)O)=O,,,5,1,1,0,1
7000_0,,,,2,2,1,3
7001_0,,,,2,2,1,3
7003_0,,,,2,2,1,3
C(C(C=CC(O)=O)CO)=O,,,5,1,2,0,2
7005_0,,,,2,2,1,3
C(C(C=CC(O)=O)C(CCO)O)=O,,,5,1,1,0,1
7007_0,,,,2,2,1,3
C(C(C=CC(O)=O)C(C=O)O)=O,,,5,1,2,0,2
7009_0,,,,2,2,1,3
C(C(C=CC(O)=O)C(C=CC)O)=O,,,5,1,1,0,1
7011_0,,,,2,2,1,3
C(C(C=CC(O)=O)C(CC=C)O)=O,,,5,1,1,0,1
7013_0,,,,2,2,1,3
C(C(C(C(O)=O)=O)CO)=CC(O)=O,,,5,1,1,0,1
7015_0,,,,2,2,1,3
C(C(C=O)=CC(C(CO)O)=O)(O)=O,,,5,1,2,0,2
7015_1,,,,2,2,1,3
7017_0,,,,2,2,1,3
C(C(C=CC(C(O)=O)(C)O)CO)=O,,,5,1,1,0,1
7019_0,,,,2,2,1,3
C(CC(C(C(C(O)=O)(C)O)=C)O)=O,,,5,1,1,0,1
7021_0,,,,2,2,1,3
C(CC(C(CO)=C(C(O)=O)C)O)=O,,,5,1,1,0,1
7023_0,,,,2,2,1,3
C(C(C(C(O)=O)=CC(O)=O)CO)=O,,,5,1,1,0,1
7025_0,,,,2,2,1,3
C(C(C(C(O)=O)=C)(CC=O)O)(O)=O,,,5,1,1,0,1
7027_0,,,,2,2,1,3
C(CC(C=CC(CO)=O)O)=O,,,5,1,2,0,2
7029_0,,,,2,2,1,3
C(C(CO)C(C=CC(CO)=O)O)=O,,,5,1,2,0,2
7029_1,,,,2,2,1,3
7031_0,,,,2,2,1,3
C(C(C=C)C(C=CC(CO)=O)O)=O,,,5,1,1,0,1
7033_0,,,,2,2,1,3
C(CC(C=CC=O)(CO)O)=O,,,5,1,2,0,2
7035_0,,,,2,2,1,3
C(C(CO)C(C=CC=O)(CO)O)=O,,,5,1,2,0,2
7035_1,,,,2,2,1,3
7037_0,,,,2,2,1,3
C(C(C=C)C(C=CC=O)(CO)O)=O,,,5,1,1,0,1
7039_0,,,,2,2,1,3
C=CC(C(C(C=CC=O)=O)O)O,,,5,1,2,0,2
7039_1,,,,2,2,1,3
7041_0,,,,2,2,1,3
C(C=CC(C(C(C)O)O)=O)=O,,,5,1,3,0,3
7041_1,,,,2,2,1,3
7043_0,,,,2,2,1,3
C(C(C(C=CC=O)=O)O)(O)=O,,,5,1,3,0,3
7043_1,,,,2,2,1,3
7045_0,,,,2,2,1,3
C(C=CC(C(CO)O)=O)=O,,,5,1,3,0,3
7045_1,,,,2,2,1,3
7047_0,,,,2,2,1,3
C(C=CC(C(C(CCO)O)O)=O)=O,,,5,1,2,0,2
7047_1,,,,2,2,1,3
7049_0,,,,2,2,1,3
C(C(C(C(C=CC=O)=O)O)O)=O,,,5,1,3,0,3
7049_1,,,,2,2,1,3
7051_0,,,,2,2,1,3
C(C(C(C(C=CC=O)=O)O)O)=CC,,,5,1,2,0,2
7051_1,,,,2,2,1,3
7053_0,,,,2,2,1,3
C(CC(C(C(C=CC=O)=O)O)O)=C,,,5,1,2,0,2
7053_1,,,,2,2,1,3
7055_0,,,,2,2,1,3
C(C(C=CC(C(CO)O)=O)=O)(O)=O,,,5,1,2,0,2
7055_1,,,,2,2,1,3
7057_0,,,,2,2,1,3
C(CC(C=C(C=O)CO)O)=O,,,5,1,2,0,2
7059_0,,,,2,2,1,3
C(C(CO)C(C=C(C=O)CO)O)=O,,,5,1,2,0,2
7059_1,,,,2,2,1,3
7061_0,,,,2,2,1,3
C(C(C=C)C(C=C(C=O)CO)O)=O,,,5,1,1,0,1
7063_0,,,,2,2,1,3
C(CC(C(CO)=CC=O)O)=O,,,5,1,2,0,2
7065_0,,,,2,2,1,3
C(C(CO)C(C(CO)=CC=O)O)=O,,,5,1,2,0,2
7065_1,,,,2,2,1,3
7067_0,,,,2,2,1,3
C(C(C=C)C(C(CO)=CC=O)O)=O,,,5,1,1,0,1
7069_0,,,,2,2,1,3
C(CC(C(C(C=C)O)=O)O)=O,,,5,1,2,0,2
7071_0,,,,2,2,1,3
C(C(CO)C(C(C(C=C)O)=O)O)=O,,,5,1,2,0,2
7071_1,,,,2,2,1,3
7073_0,,,,2,2,1,3
C(C(C=C)C(C(C(C=C)O)=O)O)=O,,,5,1,1,0,1
7075_0,,,,2,2,1,3
C(CC(C=O)(C(C=C)O)O)=O,,,5,1,3,0,3
7077_0,,,,2,2,1,3
C(C(CO)C(C=O)(C(C=C)O)O)=O,,,5,1,3,0,3
7077_1,,,,2,2,1,3
7079_0,,,,2,2,1,3
C(C(C=C)C(C=O)(C(C=C)O)O)=O,,,5,1,2,0,2
7081_0,,,,2,2,1,3
C=CC(CC(C(C(O)=O)=C)=O)O,,,5,1,1,0,1
7083_0,,,,2,2,1,3
C=CC(CC(C1OC(C(C=1)=O)=O)=O)O,,,5,1,1,0,1
7085_0,,,,2,2,1,3
C=CC(C1C(C(OC(C1=O)=O)=C)=O)O,,,5,1,2,0,2
7085_1,,,,2,2,1,3
7087_0,,,,2,2,1,3
C(C(C(C(CC(C=C)O)=O)O)O)=O,,,5,1,1,0,1
7089_0,,,,2,2,1,3
C(C(CCO)C(C=C)O)=O,,,5,1,1,0,1
7091_0,,,,2,2,1,3
C=CC(C(C(C(O)=O)=O)CCO)O,,,5,1,1,0,1
7093_0,,,,2,2,1,3
C(C(CO)C(C=O)C(C=C)O)(O)=O,,,5,1,1,0,1
7095_0,,,,2,2,1,3
C1(C(C(C=C)O)OC(CC1O)O)=O,,,5,1,2,0,2
7095_1,,,,2,2,1,3
7097_0,,,,2,2,1,3
C=CC(C1C(C(OC1)=O)=O)O,,,5,1,2,0,2
7097_1,,,,2,2,1,3
7099_0,,,,2,2,1,3
C=CC(C1C(C(C(O1)=O)=O)=O)O,,,5,1,2,0,2
7099_1,,,,2,2,1,3
7101_0,,,,2,2,1,3
C(C(C(CO)C)C(C=C)O)=O,,,5,1,1,0,1
7103_0,,,,2,2,1,3
C(C(C(C)CCO)C(C=C)O)=O,,,5,1,1,0,1
7105_0,,,,2,2,1,3
C(C(C(C)C(C)O)C(C=C)O)=O,,,5,1,1,0,1
7107_0,,,,2,2,1,3
C(CC(C)C(C=O)C(C=C)O)(O)=O,,,5,1,1,0,1
7109_0,,,,2,2,1,3
C(C(C(C)CC=CC=O)C(C=C)O)=O,,,5,1,1,0,1
7111_0,,,,2,2,1,3
C(C(C(C)C(C=O)C=C)C(C=C)O)=O,,,5,1,1,0,1
7113_0,,,,2,2,1,3
C(CC(C)C(C=O)C(C=C)O)=O,,,5,1,1,0,1
7115_0,,,,2,2,1,3
C(C(C(C)C(CO)O)C(C=C)O)=O,,,5,1,1,0,1
7117_0,,,,2,2,1,3
C(CC(C=C)O)=O,,,5,1,2,0,2
7119_0,,,,2,2,1,3
C(C(C(C)O)C(C=C)O)=O,,,5,1,3,0,3
7119_1,,,,2,2,1,3
7121_0,,,,2,2,1,3
C=CC(C(C(C(O)=O)=O)C(C)O)O,,,5,1,2,0,2
7121_1,,,,2,2,1,3
7123_0,,,,2,2,1,3
C(C(C=O)C(C=C)O)(O)=O,,,5,1,3,0,3
7123_1,,,,2,2,1,3
7125_0,,,,2,2,1,3
C(C(C)(C(C=O)C(C=C)O)O)(O)=O,,,5,1,2,0,2
7125_1,,,,2,2,1,3
7127_0,,,,2,2,1,3
C(C(C(C(O)=O)=O)C(C=C)O)(O)=O,,,5,1,2,0,2
7127_1,,,,2,2,1,3
7129_0,,,,2,2,1,3
C=CC(C(C(C=O)=O)O)O,,,5,1,3,0,3
7129_1,,,,2,2,1,3
7131_0,,,,2,2,1,3
C(C(C(CC(C)O)O)C(C=C)O)=O,,,5,1,2,0,2
7131_1,,,,2,2,1,3
7133_0,,,,2,2,1,3
C(CC(C(C=O)C(C=C)O)O)(O)=O,,,5,1,2,0,2
7133_1,,,,2,2,1,3
7135_0,,,,2,2,1,3
C(C(C(C=C)O)C(C(CO)=O)O)=O,,,5,1,2,0,2
7135_1,,,,2,2,1,3
7137_0,,,,2,2,1,3
C(CC(C(C(C(C=C)O)O)=O)O)=O,,,5,1,2,0,2
7137_1,,,,2,2,1,3
7139_0,,,,2,2,1,3
C(C(CO)(C(C=O)C(C=C)O)O)=O,,,5,1,2,0,2
7139_1,,,,2,2,1,3
7141_0,,,,2,2,1,3
C(C(CO)C(C=C)O)=O,,,5,1,3,0,3
7141_1,,,,2,2,1,3
7143_0,,,,2,2,1,3
C=CC(C(C(C(O)=O)=O)CO)O,,,5,1,3,0,3
7143_1,,,,2,2,1,3
7145_0,,,,2,2,1,3
C(C(C(C(C)=O)=O)C(C=C)O)=O,,,5,1,3,0,3
7145_1,,,,2,2,1,3
7147_0,,,,2,2,1,3
C(CC(C(CC(C=C)O)=O)=O)=O,,,5,1,2,0,2
7149_0,,,,2,2,1,3
C=CC(C(C(C(C(C)O)=O)=O)O)O,,,5,1,2,0,2
7149_1,,,,2,2,1,3
7151_0,,,,2,2,1,3
C=CC(C(C(C(C(O)=O)=O)=O)O)O,,,5,1,2,0,2
7151_1,,,,2,2,1,3
7153_0,,,,2,2,1,3
C(CO)(C(C(C=C)O)O)=O,,,5,1,3,0,3
7153_1,,,,2,2,1,3
7155_0,,,,2,2,1,3
C=CC(C(C(C(O)=O)=O)O)O,,,5,1,3,0,3
7155_1,,,,2,2,1,3
7157_0,,,,2,2,1,3
C(CC(C=C)O)(C(C(O)=O)CO)=O,,,5,1,1,0,1
7159_0,,,,2,2,1,3
C(C(C=C)C(C=C)O)=O,,,5,1,2,0,2
7161_0,,,,2,2,1,3
C=CC(C(C(O)=O)=O)C(C=C)O,,,5,1,2,0,2
7163_0,,,,2,2,1,3
C(C(C(C(O)=O)=C)C(C=C)O)=O,,,5,1,2,0,2
7165_0,,,,2,2,1,3
C=CC(C1C(C(OC(C1=C)=O)=O)=O)O,,,5,1,1,0,1
7167_0,,,,2,2,1,3
C=CC(C1C(C(OC1C)=O)=O)O,,,5,1,3,0,3
7167_1,,,,2,2,1,3
7169_0,,,,2,2,1,3
C1(C(C(C(O1)=O)=O)C(C=C)O)=O,,,5,1,3,0,3
7169_1,,,,2,2,1,3
7171_0,,,,2,2,1,3
C=CC(CC(C(O)=O)=O)O,,,5,1,2,0,2
7173_0,,,,2,2,1,3
C(C(C=C)(C(C=O)CCO)O)(O)=O,,,5,1,1,0,1
7175_0,,,,2,2,1,3
C(C(C=C)(CC=O)O)(O)=O,,,5,1,2,0,2
7177_0,,,,2,2,1,3
C(C(C=C)(C(C=O)C(C)O)O)(O)=O,,,5,1,2,0,2
7177_1,,,,2,2,1,3
7179_0,,,,2,2,1,3
C(C(C=O)C(C(O)=O)(C=C)O)(O)=O,,,5,1,2,0,2
7179_1,,,,2,2,1,3
7181_0,,,,2,2,1,3
C(C(C=C)(C(C(C=O)=O)O)O)(O)=O,,,5,1,3,0,3
7181_1,,,,2,2,1,3
7183_0,,,,2,2,1,3
C(C(C=C)(C(C=O)CO)O)(O)=O,,,5,1,3,0,3
7183_1,,,,2,2,1,3
7185_0,,,,2,2,1,3
C(C(C=C)(C(C(CO)=O)O)O)(O)=O,,,5,1,3,0,3
7185_1,,,,2,2,1,3
7187_0,,,,2,2,1,3
C(C(C=C)C(C(O)=O)(C=C)O)=O,,,5,1,2,0,2
7189_0,,,,2,2,1,3
C(C(C=C)(CC(C(O)=O)=O)O)(O)=O,,,5,1,2,0,2
7191_0,,,,2,2,1,3
C(CC(C(C(O)=O)=C)(C)O)=O,,,5,1,2,0,2
7193_0,,,,2,2,1,3
C(C(CO)C(C(C(O)=O)=C)(C)O)=O,,,5,1,2,0,2
7193_1,,,,2,2,1,3
7195_0,,,,2,2,1,3
C(C(C=C)C(C(C(O)=O)=C)(C)O)=O,,,5,1,1,0,1
7197_0,,,,2,2,1,3
C=C(C(O)=O)C(CC(C)O)=O,,,5,1,2,0,2
7198_0,,,,2,2,1,3
7200_0,,,,2,2,1,3
C=C(C(O)=O)C(CCO)=O,,,5,1,2,0,2
7202_0,,,,2,2,1,3
C=C(C(O)=O)C(CC(CCO)O)=O,,,5,1,1,0,1
7204_0,,,,2,2,1,3
C(C(CC(C(C(O)=O)=C)=O)O)=O,,,5,1,2,0,2
7206_0,,,,2,2,1,3
C=C(C(O)=O)C(CC(C=CC)O)=O,,,5,1,1,0,1
7208_0,,,,2,2,1,3
C=CCC(CC(C(C(O)=O)=C)=O)O,,,5,1,1,0,1
7210_0,,,,2,2,1,3
C1(C(C=C(C(C)=O)O1)(CC=O)O)=O,,,5,1,1,0,1
7212_0,,,,2,2,1,3
C(CC(C1OC(C(C=1)=O)=O)(C)O)=O,,,5,1,1,0,1
7214_0,,,,2,2,1,3
C1(C(C=C(C(CC(C)O)=O)O1)=O)=O,,,5,1,1,0,1
7216_0,,,,2,2,1,3
C(CC(C1OC(C(C=1)=O)=O)=O)(O)=O,,,5,1,1,0,1
7218_0,,,,2,2,1,3
C1(C(C=C(C(CCO)=O)O1)=O)=O,,,5,1,2,0,2
7220_0,,,,2,2,1,3
C(C(CC(C1OC(C(C=1)=O)=O)=O)O)=O,,,5,1,1,0,1
7222_0,,,,2,2,1,3
C1(C(CC=O)(CC(C(O1)=C)=O)O)=O,,,5,1,1,0,1
7224_0,,,,2,2,1,3
C(CC1(C(OC(C(C1)=O)=O)=C)O)=O,,,5,1,1,0,1
7226_0,,,,2,2,1,3
C=C1C(C(C(C(O1)=O)=O)C(C)O)=O,,,5,1,2,0,2
7226_1,,,,2,2,1,3
7228_0,,,,2,2,1,3
C(C1C(C(OC(C1=O)=C)=O)=O)(O)=O,,,5,1,2,0,2
7228_1,,,,2,2,1,3
7230_0,,,,2,2,1,3
C=C1C(C(C(C(O1)=O)=O)CO)=O,,,5,1,3,0,3
7230_1,,,,2,2,1,3
7232_0,,,,2,2,1,3
C(C(C1C(C(OC(C1=O)=C)=O)=O)O)=O,,,5,1,2,0,2
7232_1,,,,2,2,1,3
7234_0,,,,2,2,1,3
C(CC(CO)(C(C(CO)O)O)O)=O,,,5,1,2,0,2
7235_0,,,,2,2,1,3
7235_1,,,,2,2,1,3
7236_0,,,,2,2,1,3
7236_1,,,,2,2,1,3
7237_0,,,,2,2,1,3
7237_1,,,,2,2,1,3
7239_0,,,,2,2,1,3
C(CC(C(CO)(C(CO)O)O)O)=O,,,5,1,2,0,2
7241_0,,,,2,2,1,3
C(CC(C)(C(C(C=O)O)O)O)=O,,,5,1,2,0,2
7242_0,,,,2,2,1,3
7244_0,,,,2,2,1,3
C(C(C(C=O)O)O)(CC(C)O)=O,,,5,1,4,0,4
7246_0,,,,2,2,1,3
C(CC(C(C(C=O)O)O)=O)(O)=O,,,5,1,4,0,4
7248_0,,,,2,2,1,3
C(C(C(C=O)O)O)(CCO)=O,,,5,1,2,0,2
7250_0,,,,2,2,1,3
C(C(C(C(CC(C=O)O)=O)O)O)=O,,,5,1,2,0,2
7252_0,,,,2,2,1,3
C(C(CCO)C(C(CC)O)O)=O,,,5,1,1,0,1
7254_0,,,,2,2,1,3
C1(C(C(CO1)C(C(CC)O)O)=O)=O,,,5,1,2,0,2
7254_1,,,,2,2,1,3
7256_0,,,,2,2,1,3
C(C(C(C(CC)O)O)C(C)CO)=O,,,5,1,1,0,1
7258_0,,,,2,2,1,3
C(CC(C(CC)O)O)=O,,,5,1,2,0,2
7260_0,,,,2,2,1,3
C(C(C(C)O)C(C(CC)O)O)=O,,,5,1,3,0,3
7260_1,,,,2,2,1,3
7262_0,,,,2,2,1,3
C(C(C=O)C(C(CC)O)O)(O)=O,,,5,1,3,0,3
7262_1,,,,2,2,1,3
7264_0,,,,2,2,1,3
C(C(C(C(C(CC)O)O)O)=O)=O,,,5,1,3,0,3
7264_1,,,,2,2,1,3
7266_0,,,,2,2,1,3
C(C(CO)C(C(CC)O)O)=O,,,5,1,3,0,3
7266_1,,,,2,2,1,3
7268_0,,,,2,2,1,3
C(CO)(C(C(C(CC)O)O)O)=O,,,5,1,3,0,3
7268_1,,,,2,2,1,3
7270_0,,,,2,2,1,3
C(C(C(C(C(CC)O)O)O)=O)(O)=O,,,5,1,3,0,3
7270_1,,,,2,2,1,3
7272_0,,,,2,2,1,3
C(C(C=C)C(C(CC)O)O)=O,,,5,1,2,0,2
7274_0,,,,2,2,1,3
C(C(CC(C(CC)O)O)=O)(O)=O,,,5,1,2,0,2
7276_0,,,,2,2,1,3
C(C(CCO)C(CCCO)O)=O,,,5,1,1,0,1
7278_0,,,,2,2,1,3
C1(C(C(CO1)C(CCCO)O)=O)=O,,,5,1,2,0,2
7278_1,,,,2,2,1,3
7280_0,,,,2,2,1,3
C(C(C(CCCO)O)C(C)CO)=O,,,5,1,1,0,1
7282_0,,,,2,2,1,3
C(CC(CCCO)O)=O,,,5,1,2,0,2
7284_0,,,,2,2,1,3
C(C(C(C)O)C(CCCO)O)=O,,,5,1,3,0,3
7284_1,,,,2,2,1,3
7286_0,,,,2,2,1,3
C(C(C=O)C(CCCO)O)(O)=O,,,5,1,3,0,3
7286_1,,,,2,2,1,3
7288_0,,,,2,2,1,3
C(C(C(C(CCCO)O)O)=O)=O,,,5,1,3,0,3
7288_1,,,,2,2,1,3
7290_0,,,,2,2,1,3
C(C(CO)C(CCCO)O)=O,,,5,1,3,0,3
7290_1,,,,2,2,1,3
7292_0,,,,2,2,1,3
C(CO)(C(C(CCCO)O)O)=O,,,5,1,3,0,3
7292_1,,,,2,2,1,3
7294_0,,,,2,2,1,3
C(C(C(C(CCCO)O)O)=O)(O)=O,,,5,1,3,0,3
7294_1,,,,2,2,1,3
7296_0,,,,2,2,1,3
C(C(C=C)C(CCCO)O)=O,,,5,1,2,0,2
7298_0,,,,2,2,1,3
C(C(CC(CCCO)O)=O)(O)=O,,,5,1,2,0,2
7300_0,,,,2,2,1,3
C(C(CCO)C1(C(OCC1)=O)O)=O,,,5,1,1,0,1
7302_0,,,,2,2,1,3
C(C(CCO)C(CC(C)CO)O)=O,,,5,1,1,0,1
7304_0,,,,2,2,1,3
C(C(CCO)C(C)O)=O,,,5,1,3,0,3
7306_0,,,,2,2,1,3
C(C(C=O)CCO)(O)=O,,,5,1,4,0,4
7308_0,,,,2,2,1,3
C(C(CCO)C(CC(C)O)O)=O,,,5,1,2,0,2
7310_0,,,,2,2,1,3
C(C(C(CC(O)=O)O)CCO)=O,,,5,1,2,0,2
7312_0,,,,2,2,1,3
C(C(CCO)C(C(CO)=O)O)=O,,,5,1,2,0,2
7314_0,,,,2,2,1,3
C(C(CCO)C(C=O)(CO)O)=O,,,5,1,2,0,2
7316_0,,,,2,2,1,3
C(C(CO)CCO)=O,,,5,1,2,0,2
7318_0,,,,2,2,1,3
C(C(CCO)C(CCO)O)=O,,,5,1,2,0,2
7320_0,,,,2,2,1,3
C(C(CCO)C(C=O)O)=O,,,5,1,2,0,2
7322_0,,,,2,2,1,3
C(C(C(C(C=O)O)O)CCO)=O,,,5,1,2,0,2
7324_0,,,,2,2,1,3
C(C(CCO)C(CO)(CO)O)=O,,,5,1,2,0,2
7326_0,,,,2,2,1,3
C(C(CCO)C(C(O)=O)(CO)O)=O,,,5,1,2,0,2
7328_0,,,,2,2,1,3
C(C(C(C(C(O)=O)O)O)CCO)=O,,,5,1,2,0,2
7330_0,,,,2,2,1,3
C(C(CCO)C(C=CC)O)=O,,,5,1,2,0,2
7332_0,,,,2,2,1,3
C(C(C(CC=C)O)CCO)=O,,,5,1,2,0,2
7334_0,,,,2,2,1,3
C(C(CCO)C(C(O)=O)(C)O)=O,,,5,1,3,0,3
7336_0,,,,2,2,1,3
C(C(C(CC)O)(CC=O)O)(O)=O,,,5,1,2,0,2
7338_0,,,,2,2,1,3
C(C(CCCO)(CC=O)O)(O)=O,,,5,1,2,0,2
7340_0,,,,2,2,1,3
C(C(C(CCO)C(C)O)=O)(O)=O,,,5,1,3,0,3
7342_0,,,,2,2,1,3
C(C(C(C(O)=O)=O)CCO)(O)=O,,,5,1,4,0,4
7344_0,,,,2,2,1,3
C(C(C(CO)CCO)=O)(O)=O,,,5,1,2,0,2
7346_0,,,,2,2,1,3
C(C(C(C(C(O)=O)=O)CCO)O)=O,,,5,1,2,0,2
7348_0,,,,2,2,1,3
C(C(CO)CC(CC=O)O)(O)=O,,,5,1,2,0,2
7350_0,,,,2,2,1,3
C(C(CO)C(C=O)C(C)O)(O)=O,,,5,1,2,0,2
7352_0,,,,2,2,1,3
C(C(C=O)C(C(O)=O)CO)(O)=O,,,5,1,3,0,3
7354_0,,,,2,2,1,3
C(C(CO)C(C=O)CO)(O)=O,,,5,1,3,0,3
7356_0,,,,2,2,1,3
C(C(CO)C(C=O)C(C=O)O)(O)=O,,,5,1,2,0,2
7358_0,,,,2,2,1,3
C(C(C)C(C(CC=O)O)O)(O)=O,,,5,1,2,0,2
7360_0,,,,2,2,1,3
C1(C(CO)C(C(C(O1)=O)=O)CO)=O,,,5,1,2,0,2
7362_0,,,,2,2,1,3
C(CC(C1(COC(C1)O)O)O)=O,,,5,1,2,0,2
7364_0,,,,2,2,1,3
C(CC1(C(O)OCC1O)O)=O,,,5,1,2,0,2
7366_0,,,,2,2,1,3
C(C(CO)C1(C(O)OCC1O)O)=O,,,5,1,3,0,3
7366_1,,,,2,2,1,3
7368_0,,,,2,2,1,3
C(C(C=C)C1(C(O)OCC1O)O)=O,,,5,1,2,0,2
7370_0,,,,2,2,1,3
C(CC1(C(O)OC(C)C1O)O)=O,,,5,1,2,0,2
7372_0,,,,2,2,1,3
C(CC1(C(O)OC(C1O)=O)O)=O,,,5,1,2,0,2
7374_0,,,,2,2,1,3
C(CC1(COC(CC1O)O)O)=O,,,5,1,2,0,2
7376_0,,,,2,2,1,3
C1(C(C(C)O)OC(CC1O)O)=O,,,5,1,3,0,3
7376_1,,,,2,2,1,3
7378_0,,,,2,2,1,3
C(C1C(C(CC(O1)O)O)=O)(O)=O,,,5,1,3,0,3
7378_1,,,,2,2,1,3
7380_0,,,,2,2,1,3
C1(C(CO)OC(CC1O)O)=O,,,5,1,3,0,3
7380_1,,,,2,2,1,3
7382_0,,,,2,2,1,3
C(C(C1C(C(CC(O1)O)O)=O)O)=O,,,5,1,3,0,3
7382_1,,,,2,2,1,3
7384_0,,,,2,2,1,3
C1(C(C(CO)C(CC(C)O)O1)=O)=O,,,5,1,2,0,2
7384_1,,,,2,2,1,3
7386_0,,,,2,2,1,3
C1(C(C(CO1)C(C)O)(CC=O)O)=O,,,5,1,1,0,1
7388_0,,,,2,2,1,3
C(CC1C(C(C(O1)=O)=O)CO)(O)=O,,,5,1,2,0,2
7388_1,,,,2,2,1,3
7390_0,,,,2,2,1,3
C(C(CO)C1CC(C(O1)=O)(C)O)=O,,,5,1,2,0,2
7390_1,,,,2,2,1,3
7392_0,,,,2,2,1,3
C1(C(C)(C(CO1)C(CC=O)O)O)=O,,,5,1,1,0,1
7394_0,,,,2,2,1,3
C(C1COC(C1(CC=O)O)=O)(O)=O,,,5,1,1,0,1
7396_0,,,,2,2,1,3
C(C1C(C(C(O1)=O)=O)CO)(CO)=O,,,5,1,2,0,2
7396_1,,,,2,2,1,3
7398_0,,,,2,2,1,3
C(C1CC(C(O1)=O)=O)(C(CO)O)=O,,,5,1,2,0,2
7398_1,,,,2,2,1,3
7400_0,,,,2,2,1,3
C(C1(CO)C(C(C(O1)=O)=O)CO)=O,,,5,1,2,0,2
7400_1,,,,2,2,1,3
7402_0,,,,2,2,1,3
C1(C(CCO1)(CC=O)O)=O,,,5,1,2,0,2
7404_0,,,,2,2,1,3
C(C(C(C)O)C1(C(OCC1)=O)O)=O,,,5,1,2,0,2
7404_1,,,,2,2,1,3
7406_0,,,,2,2,1,3
C(C(C=O)C1(C(OCC1)=O)O)(O)=O,,,5,1,2,0,2
7406_1,,,,2,2,1,3
7408_0,,,,2,2,1,3
C1(C(CCO1)(C(C(C=O)=O)O)O)=O,,,5,1,2,0,2
7408_1,,,,2,2,1,3
7410_0,,,,2,2,1,3
C(C(CO)C1(C(OCC1)=O)O)=O,,,5,1,3,0,3
7410_1,,,,2,2,1,3
7412_0,,,,2,2,1,3
C1(C(CCO1)(C(C(CO)=O)O)O)=O,,,5,1,2,0,2
7412_1,,,,2,2,1,3
7414_0,,,,2,2,1,3
C(C(C=C)C1(C(OCC1)=O)O)=O,,,5,1,2,0,2
7416_0,,,,2,2,1,3
C1(C(CCO1)(CC(C(O)=O)=O)O)=O,,,5,1,1,0,1
7417_0,,,,2,2,1,3
7417_1,,,,2,2,1,3
7418_0,,,,2,2,1,3
7418_1,,,,2,2,1,3
7420_0,,,,2,2,1,3
C1(C(C(CO1)C(CC(C)O)O)=O)=O,,,5,1,2,0,2
7420_1,,,,2,2,1,3
7422_0,,,,2,2,1,3
C(CC(C1C(C(OC1)=O)=O)O)(O)=O,,,5,1,2,0,2
7422_1,,,,2,2,1,3
7424_0,,,,2,2,1,3
C(C(C1C(C(OC1)=O)=O)O)(CO)=O,,,5,1,2,0,2
7424_1,,,,2,2,1,3
7426_0,,,,2,2,1,3
C(C(CO)(C1C(C(OC1)=O)=O)O)=O,,,5,1,2,0,2
7426_1,,,,2,2,1,3
7428_0,,,,2,2,1,3
C1(C(C(CO1)CO)=O)=O,,,5,1,3,0,3
7428_1,,,,2,2,1,3
7430_0,,,,2,2,1,3
C1(C(C(CO1)C(CCO)O)=O)=O,,,5,1,3,0,3
7430_1,,,,2,2,1,3
7432_0,,,,2,2,1,3
C(C(C1C(C(OC1)=O)=O)O)=O,,,5,1,3,0,3
7432_1,,,,2,2,1,3
7434_0,,,,2,2,1,3
C(C(C(C1C(C(OC1)=O)=O)O)O)=O,,,5,1,2,0,2
7434_1,,,,2,2,1,3
7436_0,,,,2,2,1,3
C1(C(C(CO1)C(CO)(CO)O)=O)=O,,,5,1,2,0,2
7436_1,,,,2,2,1,3
7438_0,,,,2,2,1,3
C(C)=CC(C1C(C(OC1)=O)=O)O,,,5,1,3,0,3
7438_1,,,,2,2,1,3
7440_0,,,,2,2,1,3
C=CCC(C1C(C(OC1)=O)=O)O,,,5,1,3,0,3
7440_1,,,,2,2,1,3
7441_0,,,,2,2,1,3
7441_1,,,,2,2,1,3
7443_0,,,,2,2,1,3
C(CC1(C(C(OC1)=O)=O)O)=O,,,5,1,2,0,2
7445_0,,,,2,2,1,3
C(C(CO)C1(C(C(OC1)=O)=O)O)=O,,,5,1,2,0,2
7445_1,,,,2,2,1,3
7447_0,,,,2,2,1,3
C(C(C=C)C1(C(C(OC1)=O)=O)O)=O,,,5,1,1,0,1
7449_0,,,,2,2,1,3
C1(C(C(CO1)=O)(CC=O)O)=O,,,5,1,2,0,2
7451_0,,,,2,2,1,3
C(C(CO)C1(C(OCC1=O)=O)O)=O,,,5,1,2,0,2
7451_1,,,,2,2,1,3
7453_0,,,,2,2,1,3
C(C(C=C)C1(C(OCC1=O)=O)O)=O,,,5,1,1,0,1
7455_0,,,,2,2,1,3
C1(C(C(C(C(C)O)O1)=O)=O)=O,,,5,1,3,0,3
7455_1,,,,2,2,1,3
7457_0,,,,2,2,1,3
C(C1C(C(C(O1)=O)=O)=O)(O)=O,,,5,1,3,0,3
7457_1,,,,2,2,1,3
7459_0,,,,2,2,1,3
C1(C(C(C(CO)O1)=O)=O)=O,,,5,1,3,0,3
7459_1,,,,2,2,1,3
7461_0,,,,2,2,1,3
C1(C(C(C(C(CCO)O)O1)=O)=O)=O,,,5,1,2,0,2
7461_1,,,,2,2,1,3
7463_0,,,,2,2,1,3
C(C(C1C(C(C(O1)=O)=O)=O)O)=O,,,5,1,3,0,3
7463_1,,,,2,2,1,3
7465_0,,,,2,2,1,3
C(C(C1C(C(C(O1)=O)=O)=O)O)=CC,,,5,1,2,0,2
7465_1,,,,2,2,1,3
7467_0,,,,2,2,1,3
C(CC(C1C(C(C(O1)=O)=O)=O)O)=C,,,5,1,2,0,2
7467_1,,,,2,2,1,3
7469_0,,,,2,2,1,3
C(CC(C1(COC(C1O)=O)O)O)=O,,,5,1,1,0,1
7471_0,,,,2,2,1,3
C(C1C(C(C(O1)=O)=O)O)(CCO)=O,,,5,1,1,0,1
7473_0,,,,2,2,1,3
C1(C(C=O)C(C(C(CO)O1)=O)O)=O,,,5,1,2,0,2
7473_1,,,,2,2,1,3
7475_0,,,,2,2,1,3
C(C1(COC(C(C1CO)=O)=O)O)=O,,,5,1,2,0,2
7475_1,,,,2,2,1,3
7477_0,,,,2,2,1,3
C(CC1(COC(C(C1O)O)=O)O)=O,,,5,1,1,0,1
7479_0,,,,2,2,1,3
C1(C(C(C(OC1C(C)O)=O)O)O)=O,,,5,1,2,0,2
7479_1,,,,2,2,1,3
7481_0,,,,2,2,1,3
C(C1C(C(C(C(O1)=O)O)O)=O)(O)=O,,,5,1,2,0,2
7481_1,,,,2,2,1,3
7483_0,,,,2,2,1,3
C1(C(C(C(OC1CO)=O)O)O)=O,,,5,1,4,0,4
7483_1,,,,2,2,1,3
7485_0,,,,2,2,1,3
C1(C(CO)OC(C(C1CO)=O)=O)=O,,,5,1,2,0,2
7485_1,,,,2,2,1,3
7487_0,,,,2,2,1,3
C(C1COC(C(C1CO)=O)=O)(O)=O,,,5,1,1,0,1
7489_0,,,,2,2,1,3
C1(C(C(CO)C(CC(C)O1)O)=O)=O,,,5,1,2,0,2
7489_1,,,,2,2,1,3
7491_0,,,,2,2,1,3
C1(CC(C(C(C(O1)=O)=O)CO)O)=O,,,5,1,2,0,2
7491_1,,,,2,2,1,3
7493_0,,,,2,2,1,3
C1(C(C(C(C(OC1)=O)=O)CO)O)=O,,,5,1,2,0,2
7493_1,,,,2,2,1,3
7495_0,,,,2,2,1,3
C1(C(CC(C(OC1CO)=O)=O)O)=O,,,5,1,2,0,2
7495_1,,,,2,2,1,3
7497_0,,,,2,2,1,3
C1(C(COC(C(C1CO)=O)=O)O)=O,,,5,1,2,0,2
7497_1,,,,2,2,1,3
7499_0,,,,2,2,1,3
C(C(CO)C(C)CC(CC=O)O)=O,,,5,1,3,0,3
7501_0,,,,2,2,1,3
C(CC(C(CO)C(C)CC=O)O)=O,,,5,1,2,0,2
7503_0,,,,2,2,1,3
C(C(C(C)C(C=O)CO)C(C)O)=O,,,5,1,4,0,4
7505_0,,,,2,2,1,3
C(C(C=O)C(C)C(C=O)CO)(O)=O,,,5,1,4,0,4
7507_0,,,,2,2,1,3
C(C(CO)C(C)C(C=O)CO)=O,,,5,1,2,0,2
7509_0,,,,2,2,1,3
C(CC(C(C)CC(CC=O)O)O)=O,,,5,1,1,0,1
7511_0,,,,2,2,1,3
C(CC(C)C(CC(CC=O)O)O)=O,,,5,1,2,0,2
7513_0,,,,2,2,1,3
C(C(C(C)O)C(C)C(CC=O)O)=O,,,5,1,2,0,2
7515_0,,,,2,2,1,3
C(C(C=O)C(C)C(CC=O)O)(O)=O,,,5,1,2,0,2
7517_0,,,,2,2,1,3
C(C(CO)C(C)C(CC=O)O)=O,,,5,1,2,0,2
7518_0,,,,2,2,1,3
7518_1,,,,2,2,1,3
7519_0,,,,2,2,1,3
7519_1,,,,2,2,1,3
7521_0,,,,2,2,1,3
C(C(CO)C(C(C)CC=O)O)=O,,,5,1,3,0,3
7521_1,,,,2,2,1,3
7523_0,,,,2,2,1,3
C(C(C=O)(C(C)C(C=O)CO)O)=O,,,5,1,2,0,2
7525_0,,,,2,2,1,3
C(C(CO)C(C)C(CO)C(C)O)=O,,,5,1,2,0,2
7527_0,,,,2,2,1,3
C(C(CO)C(C)C(CC(C)O)O)=O,,,5,1,2,0,2
7529_0,,,,2,2,1,3
C(C(CO)C(C)CC(CCO)O)=O,,,5,1,2,0,2
7531_0,,,,2,2,1,3
C(C(CO)C(C)C(C)(CCO)O)=O,,,5,1,2,0,2
7533_0,,,,2,2,1,3
C(C(CO)C(C)C(C=O)CO)(O)=O,,,5,1,2,0,2
7535_0,,,,2,2,1,3
C(C(CO)C(C)C(CC(O)=O)O)=O,,,5,1,2,0,2
7537_0,,,,2,2,1,3
C(C(CO)C(C)C(C(CO)=O)O)=O,,,5,1,2,0,2
7539_0,,,,2,2,1,3
C(CC(C)C(C(C(CO)O)=O)O)=O,,,5,1,3,0,3
7539_1,,,,2,2,1,3
7541_0,,,,2,2,1,3
C(CC(CC(C)CO)O)=O,,,5,1,1,0,1
7543_0,,,,2,2,1,3
C(C(C(C)O)C(CC(C)CO)O)=O,,,5,1,2,0,2
7543_1,,,,2,2,1,3
7545_0,,,,2,2,1,3
C(C(C=O)C(CC(C)CO)O)(O)=O,,,5,1,2,0,2
7545_1,,,,2,2,1,3
7547_0,,,,2,2,1,3
C(C(C(C(CC(CO)C)O)O)=O)=O,,,5,1,2,0,2
7547_1,,,,2,2,1,3
7549_0,,,,2,2,1,3
C(C(CO)C(CC(C)CO)O)=O,,,5,1,2,0,2
7549_1,,,,2,2,1,3
7551_0,,,,2,2,1,3
C(CO)(C(C(CC(CO)C)O)O)=O,,,5,1,2,0,2
7551_1,,,,2,2,1,3
7553_0,,,,2,2,1,3
C(C(C=C)C(CC(C)CO)O)=O,,,5,1,1,0,1
7555_0,,,,2,2,1,3
C(C(CC(CC(C)CO)O)=O)(O)=O,,,5,1,1,0,1
7557_0,,,,2,2,1,3
C(C(C(C)O)C(C)CO)=O,,,5,1,2,0,2
7559_0,,,,2,2,1,3
C(C(C=O)C(C)CO)(O)=O,,,5,1,2,0,2
7561_0,,,,2,2,1,3
C(C(C(CC(C)O)O)C(C)CO)=O,,,5,1,2,0,2
7563_0,,,,2,2,1,3
C(C(C(CC(O)=O)O)C(C)CO)=O,,,5,1,2,0,2
7565_0,,,,2,2,1,3
C(C(C(CO)C)C(C(CO)=O)O)=O,,,5,1,2,0,2
7567_0,,,,2,2,1,3
C(C(C(CO)C)C(C=O)(CO)O)=O,,,5,1,2,0,2
7569_0,,,,2,2,1,3
C(C(CO)C(C)CO)=O,,,5,1,2,0,2
7571_0,,,,2,2,1,3
C(C(C(CCO)O)C(C)CO)=O,,,5,1,1,0,1
7573_0,,,,2,2,1,3
C(C(C(CO)C)C(C=O)O)=O,,,5,1,1,0,1
7575_0,,,,2,2,1,3
C(C(C(C(C=O)O)O)C(CO)C)=O,,,5,1,1,0,1
7577_0,,,,2,2,1,3
C(C(C(C)CO)C(CO)(CO)O)=O,,,5,1,1,0,1
7579_0,,,,2,2,1,3
C(C(C(CO)C)C(C=CC)O)=O,,,5,1,1,0,1
7581_0,,,,2,2,1,3
C(C(C(CC=C)O)C(C)CO)=O,,,5,1,1,0,1
7583_0,,,,2,2,1,3
C(C(C(CO)C)C(C(O)=O)(C)O)=O,,,5,1,2,0,2
7585_0,,,,2,2,1,3
C(C(CC(CO)C)(CC=O)O)(O)=O,,,5,1,1,0,1
7587_0,,,,2,2,1,3
C(C(C(C(C)O)C(C)CO)=O)(O)=O,,,5,1,2,0,2
7589_0,,,,2,2,1,3
C(C(C(C(O)=O)=O)C(C)CO)(O)=O,,,5,1,2,0,2
7591_0,,,,2,2,1,3
C(C(C(CO)C(C)CO)=O)(O)=O,,,5,1,2,0,2
7593_0,,,,2,2,1,3
C(C(CC(CC=O)O)CCO)(O)=O,,,5,1,4,0,4
7595_0,,,,2,2,1,3
C(C(CCO)C(C=O)C(C)O)(O)=O,,,5,1,2,0,2
7597_0,,,,2,2,1,3
C(C(C=O)C(C(O)=O)CCO)(O)=O,,,5,1,2,0,2
7599_0,,,,2,2,1,3
C(C(CCO)C(C=O)CO)(O)=O,,,5,1,2,0,2
7601_0,,,,2,2,1,3
C(C(C)(CO)CC(CC=O)O)(O)=O,,,5,1,1,0,1
7603_0,,,,2,2,1,3
C(C(C)(CO)C(C=O)C(C)O)(O)=O,,,5,1,2,0,2
7605_0,,,,2,2,1,3
C(C(C=O)C(C(O)=O)(C)CO)(O)=O,,,5,1,2,0,2
7607_0,,,,2,2,1,3
C(C(C)(CO)C(C=O)CO)(O)=O,,,5,1,2,0,2
7609_0,,,,2,2,1,3
C(C(C)C(CO)C(CC=O)O)(O)=O,,,5,1,4,0,4
7611_0,,,,2,2,1,3
C(CC(CC(C)CCO)O)=O,,,5,1,2,0,2
7613_0,,,,2,2,1,3
C(C(CO)C(CC(C)CCO)O)=O,,,5,1,3,0,3
7613_1,,,,2,2,1,3
7615_0,,,,2,2,1,3
C(C(C=C)C(CC(C)CCO)O)=O,,,5,1,1,0,1
7617_0,,,,2,2,1,3
C(C(C(C)O)C(C)CCO)=O,,,5,1,3,0,3
7619_0,,,,2,2,1,3
C(C(C=O)C(C)CCO)(O)=O,,,5,1,3,0,3
7621_0,,,,2,2,1,3
C(C(CO)C(C)CCO)=O,,,5,1,3,0,3
7623_0,,,,2,2,1,3
C(C(C(CCO)O)C(C)CCO)=O,,,5,1,1,0,1
7625_0,,,,2,2,1,3
C(C(C(C)CCO)C(C=O)O)=O,,,5,1,1,0,1
7627_0,,,,2,2,1,3
C(C(C(C)CCO)C(C=CC)O)=O,,,5,1,1,0,1
7629_0,,,,2,2,1,3
C(C(C(CC=C)O)C(C)CCO)=O,,,5,1,1,0,1
7631_0,,,,2,2,1,3
C(C(C(CO)C(C)CCO)=O)(O)=O,,,5,1,3,0,3
7633_0,,,,2,2,1,3
C(C(CCCO)C(C=O)CO)(O)=O,,,5,1,2,0,2
7635_0,,,,2,2,1,3
C(C(C)(CCO)C(C=O)CO)(O)=O,,,5,1,3,0,3
7637_0,,,,2,2,1,3
C(CC(CC(C)C(C)O)O)=O,,,5,1,1,0,1
7639_0,,,,2,2,1,3
C(C(CO)C(CC(C)C(C)O)O)=O,,,5,1,2,0,2
7639_1,,,,2,2,1,3
7641_0,,,,2,2,1,3
C(C(C=C)C(CC(C)C(C)O)O)=O,,,5,1,1,0,1
7643_0,,,,2,2,1,3
C(C(C(C)O)C(C)C(C)O)=O,,,5,1,2,0,2
7645_0,,,,2,2,1,3
C(C(C=O)C(C)C(C)O)(O)=O,,,5,1,2,0,2
7647_0,,,,2,2,1,3
C(C(CO)C(C)C(C)O)=O,,,5,1,2,0,2
7649_0,,,,2,2,1,3
C(C(C(CCO)O)C(C)C(C)O)=O,,,5,1,1,0,1
7651_0,,,,2,2,1,3
C(C(C(C)C(C)O)C(C=O)O)=O,,,5,1,1,0,1
7653_0,,,,2,2,1,3
C(C(C(C)C(C)O)C(C=CC)O)=O,,,5,1,1,0,1
7655_0,,,,2,2,1,3
C(C(C(CC=C)O)C(C)C(C)O)=O,,,5,1,1,0,1
7657_0,,,,2,2,1,3
C(C(C(CO)C(C)C(C)O)=O)(O)=O,,,5,1,2,0,2
7659_0,,,,2,2,1,3
C(C(CC(C)O)C(C=O)CO)(O)=O,,,5,1,3,0,3
7661_0,,,,2,2,1,3
C(C(C)(C(C)O)C(C=O)CO)(O)=O,,,5,1,2,0,2
7663_0,,,,2,2,1,3
C(CC(C)CC(CC=O)O)(O)=O,,,5,1,3,0,3
7665_0,,,,2,2,1,3
C(C(C(C)CC(O)=O)C(C)O)=O,,,5,1,4,0,4
7667_0,,,,2,2,1,3
C(C(C(O)=O)C(C)CC(O)=O)=O,,,5,1,4,0,4
7669_0,,,,2,2,1,3
C(C(CO)C(C)CC(O)=O)=O,,,5,1,4,0,4
7671_0,,,,2,2,1,3
C(CC(C)C(C=O)C(C=O)O)(O)=O,,,5,1,2,0,2
7673_0,,,,2,2,1,3
C(C(CO)C(C)CC(C(O)=O)O)=O,,,5,1,2,0,2
7675_0,,,,2,2,1,3
C(C(CO)C(C)C(C(O)=O)(C)O)=O,,,5,1,2,0,2
7677_0,,,,2,2,1,3
C(CC(CC(C)CC=CC=O)O)=O,,,5,1,1,0,1
7679_0,,,,2,2,1,3
C(CC(C=CCC(C)CC=O)O)=O,,,5,1,2,0,2
7681_0,,,,2,2,1,3
C(C(C(C)CC=CC=O)C(C)O)=O,,,5,1,2,0,2
7683_0,,,,2,2,1,3
C(C(C(O)=O)C(C)CC=CC=O)=O,,,5,1,2,0,2
7685_0,,,,2,2,1,3
C(C(CO)C(C)CC=CC=O)=O,,,5,1,2,0,2
7687_0,,,,2,2,1,3
C(C(C(C)CC=CC=O)C(C=O)O)=O,,,5,1,1,0,1
7689_0,,,,2,2,1,3
C(CC(C)C(C=C)C(CC=O)O)=O,,,5,1,2,0,2
7691_0,,,,2,2,1,3
C(C(C=C)C(C)CC(CC=O)O)=O,,,5,1,1,0,1
7693_0,,,,2,2,1,3
C(C(C=C)C(C)C(C=O)C(C)O)=O,,,5,1,2,0,2
7695_0,,,,2,2,1,3
C(C(C=C)C(C)C(C=O)C(O)=O)=O,,,5,1,2,0,2
7697_0,,,,2,2,1,3
C(C(C=C)C(C)C(C=O)CO)=O,,,5,1,2,0,2
7699_0,,,,2,2,1,3
C(C(C(C)C(C=O)C=C)C(C=O)O)=O,,,5,1,1,0,1
7700_0,,,,2,2,1,3
7701_0,,,,2,2,1,3
7701_1,,,,2,2,1,3
7703_0,,,,2,2,1,3
C(C(C=C)C(CC(C)CC=O)O)=O,,,5,1,2,0,2
7704_0,,,,2,2,1,3
7705_0,,,,2,2,1,3
7706_0,,,,2,2,1,3
7708_0,,,,2,2,1,3
C(C(C(C)CC=O)C(CCO)O)=O,,,5,1,2,0,2
7710_0,,,,2,2,1,3
C(CC(C)C(C=O)C(C=O)O)=O,,,5,1,2,0,2
7712_0,,,,2,2,1,3
C(CC(C)C(C=O)C(C=CC)O)=O,,,5,1,2,0,2
7714_0,,,,2,2,1,3
C(C(C(CC=C)O)C(C)CC=O)=O,,,5,1,2,0,2
7715_0,,,,2,2,1,3
7716_0,,,,2,2,1,3
7716_1,,,,2,2,1,3
7717_0,,,,2,2,1,3
7718_0,,,,2,2,1,3
7718_1,,,,2,2,1,3
7720_0,,,,2,2,1,3
C(C(CO)C(C)C(C)(CC=O)O)=O,,,5,1,2,0,2
7721_0,,,,2,2,1,3
7723_0,,,,2,2,1,3
C(C(CO)C(C)C(C(C=O)=O)O)=O,,,5,1,2,0,2
7725_0,,,,2,2,1,3
C(CC(CC(C)C(C(O)=O)O)O)=O,,,5,1,1,0,1
7727_0,,,,2,2,1,3
C(C(C(C)O)C(C)C(C(O)=O)O)=O,,,5,1,2,0,2
7729_0,,,,2,2,1,3
C(C(C=O)C(C)C(C(O)=O)O)(O)=O,,,5,1,2,0,2
7731_0,,,,2,2,1,3
C(C(CO)C(C)C(C(O)=O)O)=O,,,5,1,2,0,2
7733_0,,,,2,2,1,3
C(CC(CC(C)C(CO)O)O)=O,,,5,1,2,0,2
7735_0,,,,2,2,1,3
C(C(C(C)O)C(C)C(CO)O)=O,,,5,1,3,0,3
7737_0,,,,2,2,1,3
C(C(C=O)C(C)C(CO)O)(O)=O,,,5,1,3,0,3
7739_0,,,,2,2,1,3
C(C(CO)C(C)C(CO)O)=O,,,5,1,3,0,3
7741_0,,,,2,2,1,3
C(C(C(C)C(CO)O)C(C=O)O)=O,,,5,1,1,0,1
7742_0,,,,2,2,1,3
7743_0,,,,2,2,1,3
7744_0,,,,2,2,1,3
7746_0,,,,2,2,1,3
C(CCC(C(O)=O)C(C=O)CO)=O,,,5,1,2,0,2
7747_0,,,,2,2,1,3
7748_0,,,,2,2,1,3
7750_0,,,,2,2,1,3
C(C(C=CC(O)=O)(CC=O)O)(O)=O,,,5,1,1,0,1
7752_0,,,,2,2,1,3
C(C(C(C(CCO)O)O)O)(O)=O,,,5,1,3,0,3
7752_1,,,,2,2,1,3
7753_0,,,,2,2,1,3
7754_0,,,,2,2,1,3
7755_0,,,,2,2,1,3
7756_0,,,,2,2,1,3
7757_0,,,,2,2,1,3
7758_0,,,,2,2,1,3
7759_0,,,,2,2,1,3
7760_0,,,,2,2,1,3
7761_0,,,,2,2,1,3
7762_0,,,,2,2,1,3
7763_0,,,,2,2,1,3
7765_0,,,,2,2,1,3
C(C(C(CO)O)(C(C)O)O)(O)=O,,,5,1,6,0,6
7766_0,,,,2,2,1,3
7767_0,,,,2,2,1,3
7769_0,,,,2,2,1,3
C(C(C(O)=O)(C(CO)O)O)(O)=O,,,5,1,6,0,6
7770_0,,,,2,2,1,3
7770_1,,,,2,2,1,3
7771_0,,,,2,2,1,3
7771_1,,,,2,2,1,3
7773_0,,,,2,2,1,3
C(C(C(C(CO)(CO)O)O)O)(O)=O,,,5,1,5,0,5
7773_1,,,,2,2,1,3
7775_0,,,,2,2,1,3
C(C(C(C(C=CC)O)O)O)(O)=O,,,5,1,4,0,4
7775_1,,,,2,2,1,3
7777_0,,,,2,2,1,3
C(C(C(C(CC=C)O)O)O)(O)=O,,,5,1,4,0,4
7777_1,,,,2,2,1,3
7778_0,,,,2,2,1,3
7779_0,,,,2,2,1,3
7779_1,,,,2,2,1,3
7780_0,,,,2,2,1,3
7781_0,,,,2,2,1,3
7782_0,,,,2,2,1,3
7782_1,,,,2,2,1,3
7783_0,,,,2,2,1,3
7785_0,,,,2,2,1,3
C(C(C(CO)=O)(C(C)=O)O)(O)=O,,,5,1,3,0,3
7786_0,,,,2,2,1,3
7787_0,,,,2,2,1,3
7788_0,,,,2,2,1,3
7789_0,,,,2,2,1,3
7790_0,,,,2,2,1,3
7791_0,,,,2,2,1,3
7792_0,,,,2,2,1,3
7793_0,,,,2,2,1,3
7794_0,,,,2,2,1,3
7794_1,,,,2,2,1,3
7795_0,,,,2,2,1,3
7795_1,,,,2,2,1,3
7796_0,,,,2,2,1,3
7796_1,,,,2,2,1,3
7797_0,,,,2,2,1,3
7797_1,,,,2,2,1,3
7798_0,,,,2,2,1,3
7798_1,,,,2,2,1,3
7799_0,,,,2,2,1,3
7799_1,,,,2,2,1,3
7800_0,,,,2,2,1,3
7801_0,,,,2,2,1,3
7801_1,,,,2,2,1,3
7802_0,,,,2,2,1,3
7802_1,,,,2,2,1,3
7803_0,,,,2,2,1,3
7803_1,,,,2,2,1,3
7804_0,,,,2,2,1,3
7805_0,,,,2,2,1,3
7805_1,,,,2,2,1,3
7807_0,,,,2,2,1,3
C(C(C(C)=O)(CC(O)=O)O)(O)=O,,,5,1,2,0,2
7808_0,,,,2,2,1,3
7810_0,,,,2,2,1,3
C(C(C=O)(C(C(O)=O)C)O)(O)=O,,,5,1,3,0,3
7811_0,,,,2,2,1,3
7811_1,,,,2,2,1,3
7812_0,,,,2,2,1,3
7813_0,,,,2,2,1,3
7814_0,,,,2,2,1,3
7814_1,,,,2,2,1,3
7815_0,,,,2,2,1,3
7816_0,,,,2,2,1,3
7817_0,,,,2,2,1,3
7818_0,,,,2,2,1,3
7818_1,,,,2,2,1,3
7819_0,,,,2,2,1,3
7819_1,,,,2,2,1,3
7820_0,,,,2,2,1,3
7820_1,,,,2,2,1,3
7821_0,,,,2,2,1,3
7821_1,,,,2,2,1,3
7822_0,,,,2,2,1,3
7822_1,,,,2,2,1,3
7823_0,,,,2,2,1,3
7823_1,,,,2,2,1,3
7824_0,,,,2,2,1,3
7824_1,,,,2,2,1,3
7825_0,,,,2,2,1,3
7825_1,,,,2,2,1,3
7827_0,,,,2,2,1,3
C(C(CO)(C(C)(C(C)O)O)O)(O)=O,,,5,1,3,0,3
7829_0,,,,2,2,1,3
C(C(CO)(C(CO)(C)O)O)(O)=O,,,5,1,3,0,3
7831_0,,,,2,2,1,3
C(C(C=O)(CCC(C)O)O)(O)=O,,,5,1,2,0,2
7833_0,,,,2,2,1,3
C(C(C(CCC(C)O)=O)O)(O)=O,,,5,1,3,0,3
7833_1,,,,2,2,1,3
7834_0,,,,2,2,1,3
7834_1,,,,2,2,1,3
7836_0,,,,2,2,1,3
C(C(C=O)(CCC(O)=O)O)(O)=O,,,5,1,3,0,3
7838_0,,,,2,2,1,3
C(C(C(CCC(O)=O)=O)O)(O)=O,,,5,1,3,0,3
7838_1,,,,2,2,1,3
7839_0,,,,2,2,1,3
7839_1,,,,2,2,1,3
7840_0,,,,2,2,1,3
7842_0,,,,2,2,1,3
C(C(C(O)=O)O)(CC(CO)=O)=O,,,5,1,3,0,3
7842_1,,,,2,2,1,3
7843_0,,,,2,2,1,3
7843_1,,,,2,2,1,3
7844_0,,,,2,2,1,3
7845_0,,,,2,2,1,3
7847_0,,,,2,2,1,3
C(C(C(C(C(O)=O)O)=O)CO)=O,,,5,1,3,0,3
7847_1,,,,2,2,1,3
7849_0,,,,2,2,1,3
C(C(C=O)C(C(C(O)=O)O)O)=O,,,5,1,4,0,4
7849_1,,,,2,2,1,3
7850_0,,,,2,2,1,3
7850_1,,,,2,2,1,3
7851_0,,,,2,2,1,3
7851_1,,,,2,2,1,3
7853_0,,,,2,2,1,3
C(C(C=O)(CC)O)(O)=O,,,5,1,3,0,3
7854_0,,,,2,2,1,3
7854_1,,,,2,2,1,3
7855_0,,,,2,2,1,3
7857_0,,,,2,2,1,3
C(C(CO)(CC(O)=O)O)(O)=O,,,5,1,4,0,4
7859_0,,,,2,2,1,3
C(C(C(O)=O)(CC(C)=O)O)(O)=O,,,5,1,3,0,3
7861_0,,,,2,2,1,3
C(C(C(C=CC(C)O)O)O)(O)=O,,,5,1,4,0,4
7861_1,,,,2,2,1,3
7863_0,,,,2,2,1,3
C(C(C(C=CC(O)=O)O)O)(O)=O,,,5,1,4,0,4
7863_1,,,,2,2,1,3
7865_0,,,,2,2,1,3
C(C(C(C(C(O)=O)=O)=C)(C)O)(O)=O,,,5,1,2,0,2
7866_0,,,,2,2,1,3
7867_0,,,,2,2,1,3
7867_1,,,,2,2,1,3
7869_0,,,,2,2,1,3
C1(CC(C(C(C(O)=O)O)O1)O)=O,,,5,1,3,0,3
7869_1,,,,2,2,1,3
7870_0,,,,2,2,1,3
7871_0,,,,2,2,1,3
7871_1,,,,2,2,1,3
7872_0,,,,2,1,2,3
7873_0,,,,2,1,2,3
7874_0,,,,2,1,2,3
7875_0,,,,2,1,2,3
7876_0,,,,2,1,2,3
7877_0,,,,2,1,2,3
7879_0,,,,2,1,2,3
C(C(C(C(CO)=O)=O)CO)=O,,,5,1,3,0,3
7880_0,,,,2,1,2,3
7881_0,,,,2,1,2,3
7883_0,,,,2,1,2,3
C(C(C(C(C=CC)=O)=O)CO)=O,,,5,1,1,0,1
7885_0,,,,2,1,2,3
C(C(C(C(CC=C)=O)=O)CO)=O,,,5,1,1,0,1
7887_0,,,,2,1,2,3
C(C(C=C)C(C(CCO)=O)=O)=O,,,5,1,1,0,1
7888_0,,,,2,1,2,3
7890_0,,,,2,1,2,3
C(C(C(C(C(C)O)=O)=O)=O)=O,,,5,1,2,0,2
7892_0,,,,2,1,2,3
C(CC(C(C(CO)=O)=O)=O)=O,,,5,1,1,0,1
7894_0,,,,2,1,2,3
C(C(C(C(C(O)=O)=O)=O)=O)=O,,,5,1,2,0,2
7895_0,,,,2,1,2,3
7896_0,,,,2,1,2,3
7898_0,,,,2,1,2,3
C(C(C(CO)=O)=O)=O,,,5,1,5,0,5
7900_0,,,,2,1,2,3
C(CO)(C(C(C(C)=O)=O)O)=O,,,5,1,2,0,2
7902_0,,,,2,1,2,3
C(C(C=C)C(C(CO)=O)=O)=O,,,5,1,1,0,1
7904_0,,,,2,1,2,3
C(CC(C(CO)=O)=O)=O,,,5,1,4,0,4
7906_0,,,,2,1,2,3
C(C(C(C(CO)=O)=O)C(C)O)=O,,,5,1,1,0,1
7908_0,,,,2,1,2,3
C(C(C=O)C(C(CO)=O)=O)(O)=O,,,5,1,2,0,2
7910_0,,,,2,1,2,3
C(C(C(C(C(CO)=O)=O)O)=O)=O,,,5,1,1,0,1
7912_0,,,,2,1,2,3
C(C(CC(C(CO)=O)=O)=O)(O)=O,,,5,1,3,0,3
7914_0,,,,2,1,2,3
C(C(C(C(O)=O)=O)=O)=O,,,5,1,7,0,7
7916_0,,,,2,1,2,3
C(C(C(C(C(C)=O)=O)O)=O)(O)=O,,,5,1,2,0,2
7917_0,,,,2,1,2,3
7918_0,,,,2,1,2,3
7919_0,,,,2,1,2,3
7920_0,,,,2,1,2,3
7921_0,,,,2,1,2,3
7922_0,,,,2,1,2,3
7923_0,,,,2,1,2,3
7924_0,,,,2,1,2,3
7925_0,,,,2,1,2,3
7927_0,,,,2,1,2,3
C(C(C=C)C(C(C=CC)=O)=O)=O,,,5,1,1,0,1
7929_0,,,,2,1,2,3
C(C(C=C)C(C(CC=C)=O)=O)=O,,,5,1,1,0,1
7931_0,,,,2,1,2,3
C(C(C=C)C(C(C)=O)=O)=O,,,5,1,3,0,3
7933_0,,,,2,1,2,3
C(CC(C(C=CC)=O)=O)=O,,,5,1,3,0,3
7935_0,,,,2,1,2,3
C(CC(C(CC=C)=O)=O)=O,,,5,1,2,0,2
7936_0,,,,2,1,2,3
7937_0,,,,2,1,2,3
7938_0,,,,2,1,2,3
7939_0,,,,2,1,2,3
7941_0,,,,2,1,2,3
C(C(C(C(C)=O)=O)=O)=O,,,5,1,3,0,3
7942_0,,,,2,1,2,3
7944_0,,,,2,1,2,3
C(C(C(C(CO)=O)=O)O)=O,,,5,1,6,0,6
7946_0,,,,2,1,2,3
C(C(C(C=O)=O)O)=O,,,5,1,7,0,7
7948_0,,,,2,1,2,3
C(C(C(C)=O)=O)(C)=O,,,5,1,4,0,4
7949_0,,,,2,1,2,3
7951_0,,,,2,1,2,3
C(C(C(C(C(C)=O)=O)=O)O)=O,,,5,1,3,0,3
7953_0,,,,2,1,2,3
C(C)(C(C(C(C=O)=O)=O)O)=O,,,5,1,2,0,2
7954_0,,,,2,1,2,3
7956_0,,,,2,1,2,3
C(C(C(CO)=O)=O)(C(CO)O)=O,,,5,1,3,0,3
7957_0,,,,2,1,2,3
7959_0,,,,2,1,2,3
C(C(C(C(CO)O)=O)=O)=O,,,5,1,2,0,2
7960_0,,,,2,1,2,3
7961_0,,,,2,1,2,3
7962_0,,,,2,1,2,3
7964_0,,,,2,1,2,3
C(C(C)=O)(CC(CCO)O)=O,,,5,1,2,0,2
7965_0,,,,2,1,2,3
7966_0,,,,2,1,2,3
7968_0,,,,2,1,2,3
C(C(CO)=O)(C(CO)(CO)O)=O,,,5,1,2,0,2
7969_0,,,,2,1,2,3
7970_0,,,,2,1,2,3
7971_0,,,,2,1,2,3
7972_0,,,,2,1,2,3
7973_0,,,,2,1,2,3
7975_0,,,,2,1,2,3
C(CC(CC(C(C)=O)=O)O)(O)=O,,,5,1,2,0,2
7976_0,,,,2,1,2,3
7977_0,,,,2,1,2,3
7978_0,,,,2,1,2,3
7980_0,,,,2,1,2,3
C(C(C(C)=O)=O)(O)=O,,,5,1,3,0,3
7982_0,,,,2,1,2,3
C(C(C(C(C)=O)=O)(CO)CO)=O,,,5,1,2,0,2
7984_0,,,,2,1,2,3
C(C(C(C(CO)=O)=O)=O)=O,,,5,1,1,0,1
7985_0,,,,2,1,2,3
7987_0,,,,2,1,2,3
C(C(C(C(C(C=O)=O)=O)=O)O)=O,,,5,1,1,0,1
7988_0,,,,2,1,2,3
7990_0,,,,2,1,2,3
C(C(C(C)O)=O)(C(CCO)O)=O,,,5,1,1,0,1
7992_0,,,,2,1,2,3
C(C(C(C(CCO)O)=O)=O)(O)=O,,,5,1,1,0,1
7994_0,,,,2,1,2,3
C(C(C(C(CCO)O)=O)=O)=O,,,5,1,1,0,1
7996_0,,,,2,1,2,3
C(C(CO)=O)(C(CCO)O)=O,,,5,1,1,0,1
7998_0,,,,2,1,2,3
C(C(C(C(C(C)O)=O)=O)O)=O,,,5,1,1,0,1
8000_0,,,,2,1,2,3
C(C(C(C(C(O)=O)=O)=O)O)=O,,,5,1,1,0,1
8002_0,,,,2,1,2,3
C(C(C(C(C=O)=O)=O)O)=O,,,5,1,1,0,1
8004_0,,,,2,1,2,3
C(C(C=O)(C(C(CO)=O)=O)O)=O,,,5,1,1,0,1
8005_0,,,,2,1,2,3
8006_0,,,,2,1,2,3
8008_0,,,,2,1,2,3
C(C(C=O)(C(C(C)=O)=O)O)=O,,,5,1,1,0,1
8009_0,,,,2,1,2,3
8010_0,,,,2,1,2,3
8012_0,,,,2,1,2,3
C(C(CO)C(C(C=O)=O)O)(O)=O,,,5,1,4,0,4
8014_0,,,,2,1,2,3
C(C(C(C(CO)(CO)O)=O)=O)=O,,,5,1,2,0,2
8016_0,,,,2,1,2,3
C(CO)(C(C(C=O)=O)(CO)O)=O,,,5,1,4,0,4
8018_0,,,,2,1,2,3
C(C(C(C(C(C)O)=O)=O)O)=CC,,,5,1,1,0,1
8020_0,,,,2,1,2,3
C(CC(C(C(C(C)O)=O)=O)O)=C,,,5,1,1,0,1
8022_0,,,,2,1,2,3
C(C(C(C)O)=O)(C(C)O)=O,,,5,1,1,0,1
8024_0,,,,2,1,2,3
C(C(C(C(C)O)=O)=O)(O)=O,,,5,1,1,0,1
8026_0,,,,2,1,2,3
C(C(C(C(C(O)=O)=O)=O)O)=CC,,,5,1,1,0,1
8028_0,,,,2,1,2,3
C=CCC(C(C(C(O)=O)=O)=O)O,,,5,1,1,0,1
8030_0,,,,2,1,2,3
C(C(C(C(O)=O)=O)=O)(O)=O,,,5,1,1,0,1
8032_0,,,,2,1,2,3
C(C(C(C(C=O)=O)=O)O)=CC,,,5,1,1,0,1
8034_0,,,,2,1,2,3
C=CCC(C(C(C=O)=O)=O)O,,,5,1,1,0,1
8036_0,,,,2,1,2,3
C(C(C(C(C)O)=O)=O)=O,,,5,1,5,0,5
8037_0,,,,2,1,2,3
8039_0,,,,2,1,2,3
C(C(C(C(CC(C)O)O)=O)=O)=O,,,5,1,1,0,1
8041_0,,,,2,1,2,3
C(CC(C(C(C=O)=O)=O)O)(O)=O,,,5,1,1,0,1
8043_0,,,,2,1,2,3
C(CO)(C(C(C(C=O)=O)=O)O)=O,,,5,1,1,0,1
8045_0,,,,2,1,2,3
C(C(C(C(C=O)=O)=O)(CO)O)=O,,,5,1,1,0,1
8046_0,,,,2,1,2,3
8048_0,,,,2,1,2,3
C(C(C=O)(C(C(C)=O)=O)O)(O)=O,,,5,1,1,0,1
8050_0,,,,2,1,2,3
C(C(C(C(C=O)=O)=O)(C)O)(O)=O,,,5,1,1,0,1
8052_0,,,,2,1,2,3
C(C(C(C(CO)=O)=O)O)=CC,,,5,1,2,0,2
8054_0,,,,2,1,2,3
C=CCC(C(C(CO)=O)=O)O,,,5,1,2,0,2
8055_0,,,,2,1,2,3
8056_0,,,,2,1,2,3
8057_0,,,,2,1,2,3
8058_0,,,,2,1,2,3
8059_0,,,,2,1,2,3
8060_0,,,,2,1,2,3
8061_0,,,,2,1,2,3
8063_0,,,,2,1,2,3
C(C(C(C(CO)C(C)O)O)=O)=O,,,5,1,1,0,1
8065_0,,,,2,1,2,3
C(C(C(C=O)=O)(C(CO)O)O)=O,,,5,1,1,0,1
8067_0,,,,2,1,2,3
C(C(C)=O)(C(CCO)O)=O,,,5,1,1,0,1
8069_0,,,,2,1,2,3
C(C(C(CCO)O)=O)=O,,,5,1,2,0,2
8071_0,,,,2,1,2,3
C(C(C(C=O)=O)(CCO)O)(O)=O,,,5,1,1,0,1
8072_0,,,,2,1,2,3
8074_0,,,,2,1,2,3
C(CC(C(C)=O)(C(C=O)=O)O)=O,,,5,1,1,0,1
8076_0,,,,2,1,2,3
C(CC=O)(C(C(C=O)=O)(C)O)=O,,,5,1,1,0,1
8078_0,,,,2,1,2,3
C(C(C(CC(C(C)=O)=O)O)=O)=O,,,5,1,1,0,1
8080_0,,,,2,1,2,3
C(C(C(C(C)=O)=O)O)=O,,,5,1,1,0,1
8081_0,,,,2,1,2,3
8083_0,,,,2,1,2,3
C(C(C)=O)(C(CO)(CO)O)=O,,,5,1,4,0,4
8085_0,,,,2,1,2,3
C(C(C(C(C)=O)=O)O)=CC,,,5,1,1,0,1
8087_0,,,,2,1,2,3
C=CCC(C(C(C)=O)=O)O,,,5,1,1,0,1
8089_0,,,,2,1,2,3
C(C(C)=O)(C(C)O)=O,,,5,1,1,0,1
8091_0,,,,2,1,2,3
C(C(C)=O)(C(CC(C)O)O)=O,,,5,1,1,0,1
8093_0,,,,2,1,2,3
C(CC(C(C(C)=O)=O)O)(O)=O,,,5,1,1,0,1
8095_0,,,,2,1,2,3
C(C(C(C(C)=O)=O)(CO)O)=O,,,5,1,1,0,1
8097_0,,,,2,1,2,3
C(C(C(C(C)=O)=O)(C)O)(O)=O,,,5,1,1,0,1
8098_0,,,,2,1,2,3
8100_0,,,,2,1,2,3
C(C(C(C=O)=O)O)=CC,,,5,1,2,0,2
8102_0,,,,2,1,2,3
C=CCC(C(C=O)=O)O,,,5,1,2,0,2
8104_0,,,,2,1,2,3
C(C(C=CC)(C(C=O)=O)O)(O)=O,,,5,1,1,0,1
8106_0,,,,2,1,2,3
C(C(C(C(C=CC)=O)=O)O)(O)=O,,,5,1,1,0,1
8108_0,,,,2,1,2,3
C(C(C(C=O)=O)(CC=C)O)(O)=O,,,5,1,1,0,1
8110_0,,,,2,1,2,3
C(C(C(C(CC=C)=O)=O)O)(O)=O,,,5,1,1,0,1
8112_0,,,,2,1,2,3
C=C(C(O)=O)CC(C(C=O)=O)O,,,5,1,1,0,1
8114_0,,,,2,1,2,3
C(C(C(C=O)=O)O)=C(C(O)=O)C,,,5,1,1,0,1
8116_0,,,,2,1,2,3
C1(C(C(C=O)=O)(CC(C)O1)O)=O,,,5,1,1,0,1
8118_0,,,,2,1,2,3
C1(C(C(C=O)=O)(CC(O1)=O)O)=O,,,5,1,1,0,1
8120_0,,,,2,1,2,3
C(C(COC(C(C)=O)=O)=O)=O,,,5,1,4,0,4
8122_0,,,,2,1,2,3
C=CC(C=O)=O,,,5,1,3,0,3
8124_0,,,,2,1,2,3
C=C(C(O)=O)C(C=O)=O,,,5,1,3,0,3
8126_0,,,,2,1,2,3
C(C(C=O)C(C(CO)=O)=O)=O,,,5,1,3,0,3
8128_0,,,,2,1,2,3
C(C(C=O)C(C=O)=O)=O,,,5,1,3,0,3
8129_0,,,,2,1,2,3
8131_0,,,,2,1,2,3
C(C)=C(C=O)C(C(C)=O)=O,,,5,1,3,0,3
8133_0,,,,2,1,2,3
C(CC(C(C)=O)=O)=CC=O,,,5,1,2,0,2
8135_0,,,,2,1,2,3
C(CC=CC(C(C)=O)=O)=O,,,5,1,2,0,2
8137_0,,,,2,1,2,3
C=C(C=O)C(C(C)=O)=O,,,5,1,3,0,3
8139_0,,,,2,1,2,3
C=CC(C(C)=O)=O,,,5,1,2,0,2
8141_0,,,,2,1,2,3
C(C(C)O)=CC(C(CO)=O)=O,,,5,1,2,0,2
8143_0,,,,2,1,2,3
C(C=CC(C(CO)=O)=O)(O)=O,,,5,1,2,0,2
8145_0,,,,2,1,2,3
C(C(C)O)=CC(C=O)=O,,,5,1,2,0,2
8147_0,,,,2,1,2,3
C(C(C=CC(O)=O)=O)=O,,,5,1,2,0,2
8148_0,,,,2,1,2,3
8150_0,,,,2,1,2,3
C=C1C(OCC(C1=O)=O)=O,,,5,1,3,0,3
8152_0,,,,2,1,2,3
C(C(C)=O)(C(CO)(C(C)O)O)=O,,,5,1,4,0,4
8153_0,,,,2,1,2,3
8154_0,,,,2,1,2,3
8155_0,,,,2,1,2,3
8157_0,,,,2,1,2,3
C(C(C)=O)(CC(C(CO)O)O)=O,,,5,1,2,0,2
8158_0,,,,2,1,2,3
8159_0,,,,2,1,2,3
8160_0,,,,2,1,2,3
8161_0,,,,2,1,2,3
8162_0,,,,2,1,2,3
8163_0,,,,2,1,2,3
8165_0,,,,2,1,2,3
C1(C(C(COC1(C)O)=O)=O)=O,,,5,1,2,0,2
8167_0,,,,2,1,2,3
C1(C(COC(CO)(C1O)O)=O)=O,,,5,1,2,0,2
8169_0,,,,2,1,2,3
C1(C(COC(C1(CO)O)O)=O)=O,,,5,1,2,0,2
8170_0,,,,2,1,2,3
8171_0,,,,2,1,2,3
8172_0,,,,2,1,2,3
8174_0,,,,2,1,2,3
C1(C(CC(O)OC(C)C1)=O)=O,,,5,1,2,0,2
8175_0,,,,2,1,2,3
8177_0,,,,2,1,2,3
C1(CC(C(CC(O)O1)=O)=O)=O,,,5,1,2,0,2
8178_0,,,,2,1,2,3
8179_0,,,,2,1,2,3
8181_0,,,,2,1,2,3
C1(C(CCOC(C(C1)=O)=O)=O)=O,,,5,1,1,0,1
8182_0,,,,2,1,2,3
8184_0,,,,2,1,2,3
C1(CC(C(C(CO1)=O)=O)O)=O,,,5,1,2,0,2
8185_0,,,,2,1,2,3
8186_0,,,,2,1,2,3
8188_0,,,,2,1,2,3
C(CC(C)CC(C(C=O)=O)O)=O,,,5,1,2,0,2
8190_0,,,,2,1,2,3
C(CC(C)C(C(C=O)=O)(C)O)=O,,,5,1,2,0,2
8192_0,,,,2,1,2,3
C(CC(C(C(C(C)O)=O)=O)C)=O,,,5,1,1,0,1
8194_0,,,,2,1,2,3
C(CC(C(C(C(O)=O)=O)=O)C)=O,,,5,1,1,0,1
8196_0,,,,2,1,2,3
C(CC(C)CC(C=O)=O)=O,,,5,1,2,0,2
8198_0,,,,2,1,2,3
C(CC(C(C(C)=O)=O)C)=O,,,5,1,1,0,1
8200_0,,,,2,1,2,3
C(CC(C)CC(C(C=O)=O)=O)=O,,,5,1,3,0,3
8202_0,,,,2,1,2,3
C(CC(C(C(C=O)=O)=O)C)=O,,,5,1,1,0,1
8203_0,,,,2,1,2,3
8205_0,,,,2,1,2,3
C(CC(C(C(CO)=O)=O)C)=O,,,5,1,1,0,1
8207_0,,,,2,1,2,3
C(CC(C(C=O)=O)C)=O,,,5,1,1,0,1
8209_0,,,,2,1,2,3
C(C=O)(C(C)CC(C(O)=O)=O)=O,,,5,1,1,0,1
8211_0,,,,2,1,2,3
C(CC(C(O)=O)CC(C=O)=O)=O,,,5,1,1,0,1
8213_0,,,,2,1,2,3
C(CC(C(O)=O)(C(C=O)=O)C)=O,,,5,1,1,0,1
8215_0,,,,2,1,2,3
C(C(C(C=O)=O)C(C(O)=O)C)=O,,,5,1,1,0,1
8216_0,,,,2,1,1,2
8216_1,,,,2,1,1,2
8217_0,,,,2,1,1,2
8217_1,,,,2,1,1,2
8218_0,,,,2,1,1,2
8219_0,,,,2,1,2,3
8219_1,,,,2,1,2,3
8220_0,,,,2,1,1,2
8220_1,,,,2,1,1,2
8221_0,,,,2,1,1,2
8221_1,,,,2,1,1,2
8222_0,,,,2,1,1,2
8222_1,,,,2,1,1,2
8222_2,,,,2,1,1,2
8223_0,,,,2,1,1,2
8223_1,,,,2,1,1,2
8223_2,,,,2,1,1,2
8224_0,,,,2,1,1,2
8224_1,,,,2,1,1,2
8225_0,,,,2,1,1,2
8225_1,,,,2,1,1,2
8226_0,,,,2,1,1,2
8226_1,,,,2,1,1,2
8227_0,,,,2,1,1,2
8227_1,,,,2,1,1,2
8228_0,,,,2,1,1,2
8229_0,,,,2,1,1,2
8230_0,,,,2,1,1,2
8230_1,,,,2,1,1,2
8231_0,,,,2,1,1,2
8232_0,,,,2,1,2,3
8233_0,,,,2,1,2,3
8233_1,,,,2,1,2,3
8234_0,,,,2,1,2,3
8234_1,,,,2,1,2,3
8235_0,,,,2,1,2,3
8235_1,,,,2,1,2,3
8236_0,,,,2,1,2,3
8236_1,,,,2,1,2,3
8237_0,,,,2,1,2,3
8237_1,,,,2,1,2,3
8238_0,,,,2,1,2,3
8238_1,,,,2,1,2,3
8239_0,,,,2,1,2,3
8240_0,,,,2,1,2,3
8241_0,,,,2,1,2,3
8242_0,,,,2,1,2,3
8243_0,,,,2,1,2,3
8244_0,,,,2,1,2,3
8244_1,,,,2,1,2,3
8245_0,,,,2,1,2,3
8245_1,,,,2,1,2,3
8246_0,,,,2,1,2,3
8246_1,,,,2,1,2,3
8247_0,,,,2,1,2,3
8247_1,,,,2,1,2,3
8248_0,,,,2,1,2,3
8248_1,,,,2,1,2,3
8249_0,,,,2,1,2,3
8249_1,,,,2,1,2,3
8250_0,,,,2,1,2,3
8251_0,,,,2,1,2,3
8252_0,,,,2,1,2,3
8253_0,,,,2,1,2,3
8254_0,,,,2,1,2,3
8255_0,,,,2,1,2,3
8256_0,,,,2,1,2,3
8256_1,,,,2,1,2,3
8257_0,,,,2,1,2,3
8257_1,,,,2,1,2,3
8258_0,,,,2,1,2,3
8258_1,,,,2,1,2,3
8259_0,,,,2,1,2,3
8259_1,,,,2,1,2,3
8260_0,,,,2,1,2,3
8260_1,,,,2,1,2,3
8261_0,,,,2,1,2,3
8262_0,,,,2,1,2,3
8262_1,,,,2,1,2,3
8263_0,,,,2,1,2,3
8264_0,,,,2,1,2,3
8264_1,,,,2,1,2,3
8265_0,,,,2,1,2,3
8266_0,,,,2,1,2,3
8266_1,,,,2,1,2,3
8267_0,,,,2,1,2,3
8268_0,,,,2,1,2,3
8268_1,,,,2,1,2,3
8269_0,,,,2,1,2,3
8270_0,,,,2,1,2,3
8270_1,,,,2,1,2,3
8271_0,,,,2,1,2,3
8271_1,,,,2,1,2,3
8272_0,,,,2,1,2,3
8272_1,,,,2,1,2,3
8273_0,,,,2,1,2,3
8273_1,,,,2,1,2,3
8274_0,,,,2,1,2,3
8274_1,,,,2,1,2,3
8275_0,,,,2,1,2,3
8275_1,,,,2,1,2,3
8276_0,,,,2,1,2,3
8276_1,,,,2,1,2,3
8277_0,,,,2,1,2,3
8277_1,,,,2,1,2,3
8278_0,,,,2,1,2,3
8278_1,,,,2,1,2,3
8279_0,,,,2,1,2,3
8279_1,,,,2,1,2,3
8280_0,,,,2,1,2,3
8281_0,,,,2,1,2,3
8281_1,,,,2,1,2,3
8282_0,,,,2,1,2,3
8282_1,,,,2,1,2,3
8283_0,,,,2,1,2,3
8283_1,,,,2,1,2,3
8284_0,,,,2,1,2,3
8284_1,,,,2,1,2,3
8285_0,,,,2,1,2,3
8286_0,,,,2,1,2,3
8286_1,,,,2,1,2,3
8287_0,,,,2,1,2,3
8288_0,,,,2,1,2,3
8288_1,,,,2,1,2,3
8289_0,,,,2,1,2,3
8290_0,,,,2,1,2,3
8290_1,,,,2,1,2,3
8291_0,,,,2,1,2,3
8292_0,,,,2,1,2,3
8292_1,,,,2,1,2,3
8293_0,,,,2,1,2,3
8293_1,,,,2,1,2,3
8294_0,,,,2,1,2,3
8294_1,,,,2,1,2,3
8295_0,,,,2,1,2,3
8295_1,,,,2,1,2,3
8296_0,,,,2,1,2,3
8296_1,,,,2,1,2,3
8297_0,,,,2,1,2,3
8297_1,,,,2,1,2,3
8298_0,,,,2,1,2,3
8299_0,,,,2,1,2,3
8299_1,,,,2,1,2,3
8300_0,,,,2,1,2,3
8300_1,,,,2,1,2,3
8301_0,,,,2,1,2,3
8302_0,,,,2,1,2,3
8303_0,,,,2,1,2,3
8304_0,,,,2,1,2,3
8304_1,,,,2,1,2,3
8305_0,,,,2,1,2,3
8305_1,,,,2,1,2,3
8306_0,,,,2,1,2,3
8307_0,,,,2,1,2,3
8307_1,,,,2,1,2,3
8308_0,,,,2,1,2,3
8308_1,,,,2,1,2,3
8309_0,,,,2,1,2,3
8309_1,,,,2,1,2,3
8310_0,,,,2,1,2,3
8310_1,,,,2,1,2,3
8312_0,,,,2,1,2,3
C(C(CCO)O)=O,,,5,1,4,0,4
8313_0,,,,2,1,2,3
8313_1,,,,2,1,2,3
8314_0,,,,2,1,2,3
8315_0,,,,2,1,2,3
8315_1,,,,2,1,2,3
8316_0,,,,2,1,2,3
8316_1,,,,2,1,2,3
8317_0,,,,2,1,2,3
8318_0,,,,2,1,2,3
8318_1,,,,2,1,2,3
8319_0,,,,2,1,2,3
8319_1,,,,2,1,2,3
8320_0,,,,2,1,2,3
8320_1,,,,2,1,2,3
8321_0,,,,2,1,2,3
8321_1,,,,2,1,2,3
8324_0,,,,2,1,2,3
C(C(C)=O)(C)=O,,,5,1,7,0,7
C(C(C=O)CO)=O,,,5,1,7,0,7
8325_0,,,,2,1,2,3
8325_1,,,,2,1,2,3
8326_0,,,,2,1,2,3
8326_1,,,,2,1,2,3
8327_0,,,,2,1,2,3
8327_1,,,,2,1,2,3
8328_0,,,,2,1,2,3
8328_1,,,,2,1,2,3
8329_0,,,,2,1,2,3
8329_1,,,,2,1,2,3
8330_0,,,,2,1,2,3
8330_1,,,,2,1,2,3
8331_0,,,,2,1,2,3
8331_1,,,,2,1,2,3
8332_0,,,,2,1,2,3
8332_1,,,,2,1,2,3
8333_0,,,,2,1,2,3
8333_1,,,,2,1,2,3
8334_0,,,,2,1,2,3
8334_1,,,,2,1,2,3
8335_0,,,,2,1,2,3
8335_1,,,,2,1,2,3
8336_0,,,,2,1,2,3
8336_1,,,,2,1,2,3
8337_0,,,,2,1,2,3
8337_1,,,,2,1,2,3
8338_0,,,,2,1,2,3
8338_1,,,,2,1,2,3
8339_0,,,,2,1,2,3
8339_1,,,,2,1,2,3
8340_0,,,,2,1,2,3
8340_1,,,,2,1,2,3
8341_0,,,,2,1,2,3
8341_1,,,,2,1,2,3
8342_0,,,,2,1,2,3
8342_1,,,,2,1,2,3
8343_0,,,,2,1,2,3
8343_1,,,,2,1,2,3
8344_0,,,,2,1,2,3
8344_1,,,,2,1,2,3
8345_0,,,,2,1,2,3
8345_1,,,,2,1,2,3
8346_0,,,,2,1,2,3
8346_1,,,,2,1,2,3
8347_0,,,,2,1,2,3
8347_1,,,,2,1,2,3
8348_0,,,,2,1,2,3
8348_1,,,,2,1,2,3
8349_0,,,,2,1,2,3
8349_1,,,,2,1,2,3
8350_0,,,,2,1,2,3
8350_1,,,,2,1,2,3
8351_0,,,,2,1,2,3
8351_1,,,,2,1,2,3
8352_0,,,,2,1,2,3
8352_1,,,,2,1,2,3
8353_0,,,,2,1,2,3
8353_1,,,,2,1,2,3
8354_0,,,,2,1,2,3
8354_1,,,,2,1,2,3
8355_0,,,,2,1,2,3
8355_1,,,,2,1,2,3
8356_0,,,,2,1,2,3
8356_1,,,,2,1,2,3
8357_0,,,,2,1,2,3
8358_0,,,,2,1,2,3
8359_0,,,,2,1,2,3
8359_1,,,,2,1,2,3
8360_0,,,,2,1,2,3
8360_1,,,,2,1,2,3
8361_0,,,,2,1,2,3
8361_1,,,,2,1,2,3
8362_0,,,,2,1,2,3
8362_1,,,,2,1,2,3
8363_0,,,,2,1,2,3
8363_1,,,,2,1,2,3
8364_0,,,,2,1,2,3
8364_1,,,,2,1,2,3
8365_0,,,,2,1,2,3
8365_1,,,,2,1,2,3
8366_0,,,,2,1,2,3
8367_0,,,,2,1,2,3
8368_0,,,,2,1,2,3
8369_0,,,,2,1,2,3
8370_0,,,,2,1,2,3
8371_0,,,,2,1,2,3
8373_0,,,,2,1,2,3
C(C(C=O)C=C)=O,,,5,1,6,0,6
8374_0,,,,2,1,2,3
8376_0,,,,2,1,2,3
C(CC=O)=O,,,5,1,17,0,17
8377_0,,,,2,1,2,3
8377_1,,,,2,1,2,3
8378_0,,,,2,1,2,3
8378_1,,,,2,1,2,3
8379_0,,,,2,1,2,3
8379_1,,,,2,1,2,3
8380_0,,,,2,1,2,3
8380_1,,,,2,1,2,3
8381_0,,,,2,1,2,3
8381_1,,,,2,1,2,3
8382_0,,,,2,1,2,3
8382_1,,,,2,1,2,3
8383_0,,,,2,1,2,3
8384_0,,,,2,1,2,3
8385_0,,,,2,1,2,3
8386_0,,,,2,1,2,3
8387_0,,,,2,1,2,3
8387_1,,,,2,1,2,3
8388_0,,,,2,1,2,3
8389_0,,,,2,1,2,3
8390_0,,,,2,1,2,3
8390_1,,,,2,1,2,3
8391_0,,,,2,1,2,3
8392_0,,,,2,1,2,3
8392_1,,,,2,1,2,3
8393_0,,,,2,1,2,3
8393_1,,,,2,1,2,3
8394_0,,,,2,1,2,3
8394_1,,,,2,1,2,3
8395_0,,,,2,1,2,3
8396_0,,,,2,1,2,3
8397_0,,,,2,1,2,3
8397_1,,,,2,1,2,3
8398_0,,,,2,1,2,3
8399_0,,,,2,1,2,3
8400_0,,,,2,1,2,3
8400_1,,,,2,1,2,3
8401_0,,,,2,1,2,3
8402_0,,,,2,1,2,3
8403_0,,,,2,1,2,3
8403_1,,,,2,1,2,3
8404_0,,,,2,1,2,3
8405_0,,,,2,1,2,3
8406_0,,,,2,1,2,3
8407_0,,,,2,1,2,3
8407_1,,,,2,1,2,3
8408_0,,,,2,1,2,3
8409_0,,,,2,1,2,3
8410_0,,,,2,1,2,3
8410_1,,,,2,1,2,3
8411_0,,,,2,1,2,3
8411_1,,,,2,1,2,3
8412_0,,,,2,1,2,3
8412_1,,,,2,1,2,3
8413_0,,,,2,1,2,3
8414_0,,,,2,1,2,3
8414_1,,,,2,1,2,3
8415_0,,,,2,1,2,3
8415_1,,,,2,1,2,3
8416_0,,,,2,1,2,3
8417_0,,,,2,1,2,3
8417_1,,,,2,1,2,3
8418_0,,,,2,1,2,3
8418_1,,,,2,1,2,3
8419_0,,,,2,1,2,3
8420_0,,,,2,1,2,3
8420_1,,,,2,1,2,3
8421_0,,,,2,1,2,3
8421_1,,,,2,1,2,3
8422_0,,,,2,1,2,3
8423_0,,,,2,1,2,3
8423_1,,,,2,1,2,3
8424_0,,,,2,1,2,3
8424_1,,,,2,1,2,3
8425_0,,,,2,1,2,3
8425_1,,,,2,1,2,3
8426_0,,,,2,1,2,3
8426_1,,,,2,1,2,3
8427_0,,,,2,1,2,3
8428_0,,,,2,1,2,3
8428_1,,,,2,1,2,3
8429_0,,,,2,1,2,3
8429_1,,,,2,1,2,3
8430_0,,,,2,1,2,3
8431_0,,,,2,1,2,3
8432_0,,,,2,1,2,3
8433_0,,,,2,1,2,3
8434_0,,,,2,1,2,3
8434_1,,,,2,1,2,3
8435_0,,,,2,1,2,3
8435_1,,,,2,1,2,3
8436_0,,,,2,1,2,3
8437_0,,,,2,1,2,3
8437_1,,,,2,1,2,3
8438_0,,,,2,1,2,3
8438_1,,,,2,1,2,3
8439_0,,,,2,1,2,3
8439_1,,,,2,1,2,3
8440_0,,,,2,1,2,3
8440_1,,,,2,1,2,3
8441_0,,,,2,1,2,3
8441_1,,,,2,1,2,3
8442_0,,,,2,1,2,3
8442_1,,,,2,1,2,3
8443_0,,,,2,1,2,3
8443_1,,,,2,1,2,3
8444_0,,,,2,1,2,3
8444_1,,,,2,1,2,3
8445_0,,,,2,1,2,3
8445_1,,,,2,1,2,3
8446_0,,,,2,1,2,3
8446_1,,,,2,1,2,3
8447_0,,,,2,1,2,3
8448_0,,,,2,1,2,3
8448_1,,,,2,1,2,3
8449_0,,,,2,1,2,3
8449_1,,,,2,1,2,3
8450_0,,,,2,1,2,3
8451_0,,,,2,1,2,3
8452_0,,,,2,1,2,3
8452_1,,,,2,1,2,3
8453_0,,,,2,1,2,3
8453_1,,,,2,1,2,3
8454_0,,,,2,1,2,3
8454_1,,,,2,1,2,3
8455_0,,,,2,1,2,3
8455_1,,,,2,1,2,3
8456_0,,,,2,1,2,3
8457_0,,,,2,1,2,3
8457_1,,,,2,1,2,3
8458_0,,,,2,1,2,3
8459_0,,,,2,1,2,3
8459_1,,,,2,1,2,3
8460_0,,,,2,1,2,3
8460_1,,,,2,1,2,3
8461_0,,,,2,1,2,3
8461_1,,,,2,1,2,3
8463_0,,,,2,1,2,3
C(C(C=O)C(C)O)=O,,,5,1,3,0,3
8463_1,,,,2,1,2,3
8464_0,,,,2,1,2,3
8464_1,,,,2,1,2,3
8465_0,,,,2,1,2,3
8465_1,,,,2,1,2,3
8467_0,,,,2,1,2,3
C(C(C=O)C(O)=O)=O,,,5,1,4,0,4
8467_1,,,,2,1,2,3
8468_0,,,,2,1,2,3
8469_0,,,,2,1,2,3
8469_1,,,,2,1,2,3
8470_0,,,,2,1,2,3
8470_1,,,,2,1,2,3
8471_0,,,,2,1,2,3
8473_0,,,,2,1,2,3
C(CC(C(O)=O)=O)=O,,,5,1,8,0,8
8473_1,,,,2,1,2,3
8474_0,,,,2,1,2,3
8474_1,,,,2,1,2,3
8475_0,,,,2,1,2,3
8475_1,,,,2,1,2,3
8476_0,,,,2,1,2,3
8477_0,,,,2,1,2,3
8478_0,,,,2,1,2,3
8478_1,,,,2,1,2,3
8479_0,,,,2,1,2,3
8479_1,,,,2,1,2,3
8480_0,,,,2,1,2,3
8480_1,,,,2,1,2,3
8481_0,,,,2,1,2,3
8481_1,,,,2,1,2,3
8483_0,,,,2,1,2,3
C(C(CO)(CO)O)=O,,,5,1,4,0,4
8484_0,,,,2,1,2,3
8484_1,,,,2,1,2,3
8485_0,,,,2,1,2,3
8486_0,,,,2,1,2,3
8486_1,,,,2,1,2,3
8487_0,,,,2,1,2,3
8487_1,,,,2,1,2,3
8488_0,,,,2,1,2,3
8488_1,,,,2,1,2,3
8489_0,,,,2,1,2,3
8489_1,,,,2,1,2,3
8490_0,,,,2,1,2,3
8490_1,,,,2,1,2,3
8491_0,,,,2,1,2,3
8491_1,,,,2,1,2,3
8492_0,,,,2,1,2,3
8492_1,,,,2,1,2,3
8493_0,,,,2,1,2,3
8493_1,,,,2,1,2,3
8494_0,,,,2,1,2,3
8494_1,,,,2,1,2,3
8494_2,,,,2,1,2,3
8495_0,,,,2,1,2,3
8495_1,,,,2,1,2,3
8495_2,,,,2,1,2,3
8496_0,,,,2,1,2,3
8496_1,,,,2,1,2,3
8497_0,,,,2,1,2,3
8497_1,,,,2,1,2,3
8498_0,,,,2,1,2,3
8498_1,,,,2,1,2,3
8499_0,,,,2,1,2,3
8500_0,,,,2,1,2,3
8501_0,,,,2,1,2,3
8501_1,,,,2,1,2,3
8502_0,,,,2,1,2,3
8502_1,,,,2,1,2,3
8503_0,,,,2,1,2,3
8503_1,,,,2,1,2,3
8504_0,,,,2,1,2,3
8504_1,,,,2,1,2,3
8505_0,,,,2,1,2,3
8506_0,,,,2,1,2,3
8506_1,,,,2,1,2,3
8507_0,,,,2,1,2,3
8508_0,,,,2,1,2,3
8508_1,,,,2,1,2,3
8509_0,,,,2,1,2,3
8509_1,,,,2,1,2,3
8510_0,,,,2,1,2,3
8510_1,,,,2,1,2,3
8511_0,,,,2,1,2,3
8511_1,,,,2,1,2,3
8512_0,,,,2,1,2,3
8512_1,,,,2,1,2,3
8513_0,,,,2,1,2,3
8513_1,,,,2,1,2,3
8514_0,,,,2,1,2,3
8514_1,,,,2,1,2,3
8515_0,,,,2,1,2,3
8515_1,,,,2,1,2,3
8516_0,,,,2,1,2,3
8516_1,,,,2,1,2,3
8516_2,,,,2,1,2,3
8517_0,,,,2,1,2,3
8517_1,,,,2,1,2,3
8517_2,,,,2,1,2,3
8518_0,,,,2,1,2,3
8518_1,,,,2,1,2,3
8519_0,,,,2,1,2,3
8519_1,,,,2,1,2,3
8520_0,,,,2,1,2,3
8520_1,,,,2,1,2,3
8521_0,,,,2,1,2,3
8521_1,,,,2,1,2,3
8522_0,,,,2,1,2,3
8522_1,,,,2,1,2,3
8523_0,,,,2,1,2,3
8524_0,,,,2,1,2,3
8525_0,,,,2,1,2,3
8526_0,,,,2,1,2,3
8527_0,,,,2,1,2,3
8527_1,,,,2,1,2,3
8528_0,,,,2,1,2,3
8528_1,,,,2,1,2,3
8529_0,,,,2,1,2,3
8529_1,,,,2,1,2,3
8530_0,,,,2,1,2,3
8530_1,,,,2,1,2,3
8531_0,,,,2,1,2,3
8532_0,,,,2,1,2,3
8532_1,,,,2,1,2,3
8533_0,,,,2,1,2,3
8534_0,,,,2,1,2,3
8535_0,,,,2,1,2,3
8536_0,,,,2,1,2,3
8536_1,,,,2,1,2,3
8537_0,,,,2,1,2,3
8537_1,,,,2,1,2,3
8538_0,,,,2,1,2,3
8538_1,,,,2,1,2,3
8539_0,,,,2,1,2,3
8539_1,,,,2,1,2,3
8540_0,,,,2,1,2,3
8540_1,,,,2,1,2,3
8541_0,,,,2,1,2,3
8542_0,,,,2,1,2,3
8542_1,,,,2,1,2,3
8543_0,,,,2,1,2,3
8543_1,,,,2,1,2,3
8544_0,,,,2,1,2,3
8545_0,,,,2,1,2,3
8546_0,,,,2,1,2,3
8547_0,,,,2,1,2,3
8547_1,,,,2,1,2,3
8548_0,,,,2,1,2,3
8548_1,,,,2,1,2,3
8549_0,,,,2,1,2,3
8550_0,,,,2,1,2,3
8550_1,,,,2,1,2,3
8551_0,,,,2,1,2,3
8551_1,,,,2,1,2,3
8552_0,,,,2,1,2,3
8552_1,,,,2,1,2,3
8553_0,,,,2,1,2,3
8553_1,,,,2,1,2,3
8555_0,,,,2,1,2,3
C(C(C=CC)O)=O,,,5,1,2,0,2
8556_0,,,,2,1,2,3
8556_1,,,,2,1,2,3
8557_0,,,,2,1,2,3
8558_0,,,,2,1,2,3
8559_0,,,,2,1,2,3
8560_0,,,,2,1,2,3
8561_0,,,,2,1,2,3
8561_1,,,,2,1,2,3
8562_0,,,,2,1,2,3
8562_1,,,,2,1,2,3
8563_0,,,,2,1,2,3
8564_0,,,,2,1,2,3
8564_1,,,,2,1,2,3
8565_0,,,,2,1,2,3
8565_1,,,,2,1,2,3
8566_0,,,,2,1,2,3
8566_1,,,,2,1,2,3
8567_0,,,,2,1,2,3
8567_1,,,,2,1,2,3
8569_0,,,,2,1,2,3
C(C(CC=C)O)=O,,,5,1,2,0,2
8570_0,,,,2,1,2,3
8570_1,,,,2,1,2,3
8571_0,,,,2,1,2,3
8572_0,,,,2,1,2,3
8573_0,,,,2,1,2,3
8574_0,,,,2,1,2,3
8575_0,,,,2,1,2,3
8576_0,,,,2,1,2,3
8577_0,,,,2,1,2,3
8578_0,,,,2,1,2,3
8579_0,,,,2,1,2,3
8579_1,,,,2,1,2,3
8579_2,,,,2,1,2,3
8580_0,,,,2,1,2,3
8581_0,,,,2,1,2,3
8582_0,,,,2,1,2,3
8583_0,,,,2,1,2,3
8583_1,,,,2,1,2,3
8584_0,,,,2,1,2,3
8585_0,,,,2,1,2,3
8586_0,,,,2,1,2,3
8587_0,,,,2,1,2,3
8588_0,,,,2,1,2,3
8589_0,,,,2,1,2,3
8590_0,,,,2,1,2,3
8590_1,,,,2,1,2,3
8590_2,,,,2,1,2,3
8591_0,,,,2,1,2,3
8592_0,,,,2,1,2,3
8593_0,,,,2,1,2,3
8594_0,,,,2,1,2,3
8594_1,,,,2,1,2,3
8594_2,,,,2,1,2,3
8595_0,,,,2,1,2,3
8596_0,,,,2,1,2,3
8597_0,,,,2,1,2,3
8598_0,,,,2,1,2,3
8599_0,,,,2,1,2,3
8600_0,,,,2,1,2,3
8600_1,,,,2,1,2,3
8600_2,,,,2,1,2,3
8601_0,,,,2,1,2,3
8602_0,,,,2,1,2,3
8602_1,,,,2,1,2,3
8603_0,,,,2,1,1,2
8603_1,,,,2,1,1,2
8604_0,,,,2,1,1,2
8605_0,,,,2,1,2,3
8606_0,,,,2,1,2,3
8606_1,,,,2,1,2,3
8607_0,,,,2,1,2,3
8608_0,,,,2,1,2,3
8608_1,,,,2,1,2,3
8609_0,,,,2,1,2,3
8609_1,,,,2,1,2,3
8610_0,,,,2,1,2,3
8610_1,,,,2,1,2,3
8611_0,,,,2,1,2,3
8612_0,,,,2,1,2,3
8612_1,,,,2,1,2,3
8613_0,,,,2,1,2,3
8613_1,,,,2,1,2,3
8614_0,,,,2,1,2,3
8614_1,,,,2,1,2,3
8615_0,,,,2,1,2,3
8615_1,,,,2,1,2,3
8615_2,,,,2,1,2,3
8616_0,,,,2,1,2,3
8616_1,,,,2,1,2,3
8616_2,,,,2,1,2,3
8617_0,,,,2,1,2,3
8618_0,,,,2,1,2,3
8619_0,,,,2,1,2,3
8620_0,,,,2,1,2,3
8621_0,,,,2,1,2,3
8621_1,,,,2,1,2,3
8622_0,,,,2,1,2,3
8623_0,,,,2,1,2,3
8624_0,,,,2,1,2,3
8625_0,,,,2,1,2,3
8626_0,,,,2,1,2,3
8627_0,,,,2,1,2,3
8628_0,,,,2,1,2,3
8629_0,,,,2,1,2,3
8629_1,,,,2,1,2,3
8629_2,,,,2,1,2,3
8630_0,,,,2,1,2,3
8631_0,,,,2,1,2,3
8632_0,,,,2,1,2,3
8633_0,,,,2,1,2,3
8634_0,,,,2,1,2,3
8635_0,,,,2,1,2,3
8635_1,,,,2,1,2,3
8635_2,,,,2,1,2,3
8636_0,,,,2,1,2,3
8637_0,,,,2,1,2,3
8638_0,,,,2,1,2,3
8638_1,,,,2,1,2,3
8639_0,,,,2,1,2,3
8639_1,,,,2,1,2,3
8640_0,,,,2,1,2,3
8641_0,,,,2,1,2,3
8642_0,,,,2,1,2,3
8643_0,,,,2,1,2,3
8643_1,,,,2,1,2,3
8644_0,,,,2,1,2,3
8644_1,,,,2,1,2,3
8645_0,,,,2,1,2,3
8646_0,,,,2,1,2,3
8647_0,,,,2,1,2,3
8648_0,,,,2,1,2,3
8649_0,,,,2,1,2,3
8649_1,,,,2,1,2,3
8650_0,,,,2,1,2,3
8651_0,,,,2,1,1,2
8652_0,,,,2,1,2,3
8652_1,,,,2,1,2,3
8652_2,,,,2,1,2,3
8653_0,,,,2,1,2,3
8653_1,,,,2,1,2,3
8654_0,,,,2,1,2,3
8655_0,,,,2,1,2,3
8655_1,,,,2,1,2,3
8656_0,,,,2,1,2,3
8656_1,,,,2,1,2,3
8658_0,,,,2,1,2,3
C(C)(C)=O,,,5,1,4,0,4
8658_1,,,,2,1,2,3
8659_0,,,,2,1,2,3
8660_0,,,,2,1,2,3
8661_0,,,,2,1,2,3
8661_1,,,,2,1,2,3
8662_0,,,,2,1,2,3
8662_1,,,,2,1,2,3
8663_0,,,,2,1,2,3
8663_1,,,,2,1,2,3
8665_0,,,,2,1,2,3
C(C(C(CO)=O)C(C)O)=O,,,5,1,3,0,3
8665_1,,,,2,1,2,3
8666_0,,,,2,1,2,3
8666_1,,,,2,1,2,3
8668_0,,,,2,1,2,3
C(C(C=O)C(CO)=O)(O)=O,,,5,1,3,0,3
8668_1,,,,2,1,2,3
8669_0,,,,2,1,2,3
8669_1,,,,2,1,2,3
8670_0,,,,2,1,2,3
8671_0,,,,2,1,2,3
8671_1,,,,2,1,2,3
8673_0,,,,2,1,2,3
C(CC(CO)=O)=O,,,5,1,6,0,6
8673_1,,,,2,1,2,3
8675_0,,,,2,1,2,3
C(C(C(C(C=O)O)=O)O)=O,,,5,1,4,0,4
8675_1,,,,2,1,2,3
8675_2,,,,2,1,2,3
8676_0,,,,2,1,2,3
8677_0,,,,2,1,2,3
8677_1,,,,2,1,2,3
8678_0,,,,2,1,2,3
8678_1,,,,2,1,2,3
8679_0,,,,2,1,2,3
8679_1,,,,2,1,2,3
8679_2,,,,2,1,2,3
8680_0,,,,2,1,2,3
8682_0,,,,2,1,2,3
C(C(C(CO)=O)(CO)O)(O)=O,,,5,1,8,0,8
8682_1,,,,2,1,2,3
8683_0,,,,2,1,2,3
8683_1,,,,2,1,2,3
8684_0,,,,2,1,2,3
8684_1,,,,2,1,2,3
8685_0,,,,2,1,2,3
8685_1,,,,2,1,2,3
8687_0,,,,2,1,2,3
C(C(C(CO)C(C)O)O)=O,,,5,1,3,0,3
8687_1,,,,2,1,2,3
8688_0,,,,2,1,2,3
8688_1,,,,2,1,2,3
8689_0,,,,2,1,2,3
8689_1,,,,2,1,2,3
8690_0,,,,2,1,2,3
8690_1,,,,2,1,2,3
8691_0,,,,2,1,2,3
8691_1,,,,2,1,2,3
8692_0,,,,2,1,2,3
8692_1,,,,2,1,2,3
8693_0,,,,2,1,2,3
8693_1,,,,2,1,2,3
8694_0,,,,2,1,2,3
8694_1,,,,2,1,2,3
8695_0,,,,2,1,2,3
8695_1,,,,2,1,2,3
8696_0,,,,2,1,2,3
8696_1,,,,2,1,2,3
8697_0,,,,2,1,2,3
8697_1,,,,2,1,2,3
8698_0,,,,2,1,2,3
8698_1,,,,2,1,2,3
8699_0,,,,2,1,2,3
8699_1,,,,2,1,2,3
8700_0,,,,2,1,2,3
8700_1,,,,2,1,2,3
8701_0,,,,2,1,2,3
8701_1,,,,2,1,2,3
8702_0,,,,2,1,2,3
8702_1,,,,2,1,2,3
8703_0,,,,2,1,2,3
8703_1,,,,2,1,2,3
8704_0,,,,2,1,2,3
8704_1,,,,2,1,2,3
8705_0,,,,2,1,2,3
8705_1,,,,2,1,2,3
8706_0,,,,2,1,2,3
8706_1,,,,2,1,2,3
8707_0,,,,2,1,2,3
8708_0,,,,2,1,2,3
8708_1,,,,2,1,2,3
8709_0,,,,2,1,2,3
8709_1,,,,2,1,2,3
8710_0,,,,2,1,2,3
8710_1,,,,2,1,2,3
8711_0,,,,2,1,2,3
8711_1,,,,2,1,2,3
8712_0,,,,2,1,2,3
8712_1,,,,2,1,2,3
8713_0,,,,2,1,2,3
8713_1,,,,2,1,2,3
8714_0,,,,2,1,2,3
8714_1,,,,2,1,2,3
8715_0,,,,2,1,2,3
8716_0,,,,2,1,2,3
8716_1,,,,2,1,2,3
8717_0,,,,2,1,2,3
8717_1,,,,2,1,2,3
8718_0,,,,2,1,2,3
8719_0,,,,2,1,2,3
8719_1,,,,2,1,2,3
8720_0,,,,2,1,2,3
8721_0,,,,2,1,2,3
8721_1,,,,2,1,2,3
8722_0,,,,2,1,2,3
8722_1,,,,2,1,2,3
8723_0,,,,2,1,2,3
8723_1,,,,2,1,2,3
8724_0,,,,2,1,2,3
8725_0,,,,2,1,2,3
8725_1,,,,2,1,2,3
8726_0,,,,2,1,2,3
8726_1,,,,2,1,2,3
8727_0,,,,2,1,2,3
8728_0,,,,2,1,2,3
8728_1,,,,2,1,2,3
8729_0,,,,2,1,2,3
8729_1,,,,2,1,2,3
8730_0,,,,2,1,2,3
8731_0,,,,2,1,2,3
8731_1,,,,2,1,2,3
8732_0,,,,2,1,2,3
8732_1,,,,2,1,2,3
8733_0,,,,2,1,2,3
8734_0,,,,2,1,2,3
8734_1,,,,2,1,2,3
8735_0,,,,2,1,2,3
8735_1,,,,2,1,2,3
8736_0,,,,2,1,2,3
8737_0,,,,2,1,2,3
8738_0,,,,2,1,2,3
8738_1,,,,2,1,2,3
8739_0,,,,2,1,2,3
8739_1,,,,2,1,2,3
8740_0,,,,2,1,2,3
8741_0,,,,2,1,2,3
8741_1,,,,2,1,2,3
8742_0,,,,2,1,2,3
8743_0,,,,2,1,2,3
8744_0,,,,2,1,2,3
8744_1,,,,2,1,2,3
8745_0,,,,2,1,2,3
8745_1,,,,2,1,2,3
8746_0,,,,2,1,2,3
8746_1,,,,2,1,2,3
8747_0,,,,2,1,2,3
8748_0,,,,2,1,2,3
8749_0,,,,2,1,2,3
8749_1,,,,2,1,2,3
8749_2,,,,2,1,2,3
8750_0,,,,2,1,2,3
8750_1,,,,2,1,2,3
8750_2,,,,2,1,2,3
8751_0,,,,2,1,2,3
8751_1,,,,2,1,2,3
8752_0,,,,2,1,2,3
8753_0,,,,2,1,2,3
8753_1,,,,2,1,2,3
8753_2,,,,2,1,2,3
8754_0,,,,2,1,2,3
8754_1,,,,2,1,2,3
8754_2,,,,2,1,2,3
8756_0,,,,2,1,2,3
C(CO)(C(C=CC)O)=O,,,5,1,1,0,1
8757_0,,,,2,1,2,3
8757_1,,,,2,1,2,3
8757_2,,,,2,1,2,3
8758_0,,,,2,1,2,3
8758_1,,,,2,1,2,3
8758_2,,,,2,1,2,3
8760_0,,,,2,1,2,3
C(CO)(C(CC=C)O)=O,,,5,1,1,0,1
8761_0,,,,2,1,2,3
8761_1,,,,2,1,2,3
8761_2,,,,2,1,2,3
8762_0,,,,2,1,2,3
8762_1,,,,2,1,2,3
8762_2,,,,2,1,2,3
8764_0,,,,2,1,2,3
C(CO)(C(C)O)=O,,,5,1,9,0,9
8765_0,,,,2,1,2,3
8765_1,,,,2,1,2,3
8765_2,,,,2,1,2,3
8766_0,,,,2,1,2,3
8766_1,,,,2,1,2,3
8766_2,,,,2,1,2,3
8767_0,,,,2,1,2,3
8768_0,,,,2,1,2,3
8769_0,,,,2,1,2,3
8769_1,,,,2,1,2,3
8769_2,,,,2,1,2,3
8770_0,,,,2,1,2,3
8771_0,,,,2,1,2,3
8771_1,,,,2,1,2,3
8771_2,,,,2,1,2,3
8772_0,,,,2,1,2,3
8772_1,,,,2,1,2,3
8773_0,,,,2,1,2,3
8774_0,,,,2,1,2,3
8774_1,,,,2,1,2,3
8774_2,,,,2,1,2,3
8775_0,,,,2,1,2,3
8775_1,,,,2,1,2,3
8775_2,,,,2,1,2,3
8777_0,,,,2,1,2,3
C(C(C)O)(C(C)O)=O,,,5,1,2,0,2
8778_0,,,,2,1,2,3
8778_1,,,,2,1,2,3
8778_2,,,,2,1,2,3
8780_0,,,,2,1,2,3
C(C(C(C)O)=O)(O)=O,,,5,1,6,0,6
8781_0,,,,2,1,2,3
8782_0,,,,2,1,2,3
8782_1,,,,2,1,2,3
8782_2,,,,2,1,2,3
8783_0,,,,2,1,2,3
8783_1,,,,2,1,2,3
8784_0,,,,2,1,2,3
8785_0,,,,2,1,2,3
8785_1,,,,2,1,2,3
8785_2,,,,2,1,2,3
8786_0,,,,2,1,2,3
8788_0,,,,2,1,2,3
C(C(C(O)=O)=O)(O)=O,,,5,1,5,0,5
8789_0,,,,2,1,2,3
8790_0,,,,2,1,2,3
8790_1,,,,2,1,2,3
8790_2,,,,2,1,2,3
8791_0,,,,2,1,2,3
8792_0,,,,2,1,2,3
8792_1,,,,2,1,2,3
8792_2,,,,2,1,2,3
8793_0,,,,2,1,2,3
8793_1,,,,2,1,2,3
8793_2,,,,2,1,2,3
8794_0,,,,2,1,2,3
8794_1,,,,2,1,2,3
8795_0,,,,2,1,2,3
8795_1,,,,2,1,2,3
8796_0,,,,2,1,2,3
8796_1,,,,2,1,2,3
8797_0,,,,2,1,2,3
8798_0,,,,2,1,2,3
8798_1,,,,2,1,2,3
8798_2,,,,2,1,2,3
8799_0,,,,2,1,2,3
8799_1,,,,2,1,2,3
8800_0,,,,2,1,2,3
8800_1,,,,2,1,2,3
8801_0,,,,2,1,2,3
8802_0,,,,2,1,2,3
8802_1,,,,2,1,2,3
8804_0,,,,2,1,2,3
C(C(C=O)(C=O)O)=O,,,5,1,3,0,3
8804_1,,,,2,1,2,3
8805_0,,,,2,1,2,3
8805_1,,,,2,1,2,3
8805_2,,,,2,1,2,3
8806_0,,,,2,1,2,3
8806_1,,,,2,1,2,3
8806_2,,,,2,1,2,3
8807_0,,,,2,1,2,3
8807_1,,,,2,1,2,3
8807_2,,,,2,1,2,3
8808_0,,,,2,1,2,3
8808_1,,,,2,1,2,3
8808_2,,,,2,1,2,3
8809_0,,,,2,1,2,3
8809_1,,,,2,1,2,3
8809_2,,,,2,1,2,3
8810_0,,,,2,1,2,3
8810_1,,,,2,1,2,3
8810_2,,,,2,1,2,3
8811_0,,,,2,1,2,3
8811_1,,,,2,1,2,3
8811_2,,,,2,1,2,3
8812_0,,,,2,1,2,3
8813_0,,,,2,1,2,3
8813_1,,,,2,1,2,3
8813_2,,,,2,1,2,3
8814_0,,,,2,1,2,3
8814_1,,,,2,1,2,3
8814_2,,,,2,1,2,3
8815_0,,,,2,1,2,3
8815_1,,,,2,1,2,3
8816_0,,,,2,1,2,3
8816_1,,,,2,1,2,3
8816_2,,,,2,1,2,3
8817_0,,,,2,1,2,3
8817_1,,,,2,1,2,3
8817_2,,,,2,1,2,3
8818_0,,,,2,1,2,3
8818_1,,,,2,1,2,3
8818_2,,,,2,1,2,3
8819_0,,,,2,1,2,3
8819_1,,,,2,1,2,3
8819_2,,,,2,1,2,3
8820_0,,,,2,1,2,3
8820_1,,,,2,1,2,3
8820_2,,,,2,1,2,3
8821_0,,,,2,1,2,3
8821_1,,,,2,1,2,3
8822_0,,,,2,1,2,3
8822_1,,,,2,1,2,3
8823_0,,,,2,1,2,3
8823_1,,,,2,1,2,3
8824_0,,,,2,1,2,3
8825_0,,,,2,1,2,3
8825_1,,,,2,1,2,3
8825_2,,,,2,1,2,3
8826_0,,,,2,1,2,3
8826_1,,,,2,1,2,3
8827_0,,,,2,1,2,3
8828_0,,,,2,1,2,3
8828_1,,,,2,1,2,3
8828_2,,,,2,1,2,3
8829_0,,,,2,1,2,3
8829_1,,,,2,1,2,3
8829_2,,,,2,1,2,3
8830_0,,,,2,1,2,3
8830_1,,,,2,1,2,3
8830_2,,,,2,1,2,3
8831_0,,,,2,1,2,3
8831_1,,,,2,1,2,3
8831_2,,,,2,1,2,3
8832_0,,,,2,1,2,3
8833_0,,,,2,1,2,3
8833_1,,,,2,1,2,3
8833_2,,,,2,1,2,3
8834_0,,,,2,1,2,3
8835_0,,,,2,1,2,3
8835_1,,,,2,1,2,3
8835_2,,,,2,1,2,3
8836_0,,,,2,1,2,3
8837_0,,,,2,1,2,3
8838_0,,,,2,1,2,3
8838_1,,,,2,1,2,3
8838_2,,,,2,1,2,3
8839_0,,,,2,1,2,3
8840_0,,,,2,1,2,3
8840_1,,,,2,1,2,3
8840_2,,,,2,1,2,3
8841_0,,,,2,1,2,3
8842_0,,,,2,1,2,3
8842_1,,,,2,1,2,3
8843_0,,,,2,1,2,3
8843_1,,,,2,1,2,3
8843_2,,,,2,1,2,3
8844_0,,,,2,1,2,3
8845_0,,,,2,1,2,3
8845_1,,,,2,1,2,3
8845_2,,,,2,1,2,3
8846_0,,,,2,1,2,3
8846_1,,,,2,1,2,3
8846_2,,,,2,1,2,3
8847_0,,,,2,1,2,3
8847_1,,,,2,1,2,3
8847_2,,,,2,1,2,3
8848_0,,,,2,1,2,3
8849_0,,,,2,1,2,3
8849_1,,,,2,1,2,3
8849_2,,,,2,1,2,3
8850_0,,,,2,1,2,3
8851_0,,,,2,1,2,3
8851_1,,,,2,1,2,3
8851_2,,,,2,1,2,3
8852_0,,,,2,1,2,3
8853_0,,,,2,1,2,3
8853_1,,,,2,1,2,3
8854_0,,,,2,1,2,3
8854_1,,,,2,1,2,3
8855_0,,,,2,1,2,3
8856_0,,,,2,1,2,3
8857_0,,,,2,1,2,3
8857_1,,,,2,1,2,3
8858_0,,,,2,1,2,3
8858_1,,,,2,1,2,3
8859_0,,,,2,1,2,3
8860_0,,,,2,1,2,3
8860_1,,,,2,1,2,3
8861_0,,,,2,1,2,3
8862_0,,,,2,1,2,3
8862_1,,,,2,1,2,3
8863_0,,,,2,1,2,3
8864_0,,,,2,1,2,3
8864_1,,,,2,1,2,3
8865_0,,,,2,1,2,3
8865_1,,,,2,1,2,3
8865_2,,,,2,1,2,3
8866_0,,,,2,1,2,3
8866_1,,,,2,1,2,3
8866_2,,,,2,1,2,3
8867_0,,,,2,1,2,3
8867_1,,,,2,1,2,3
8868_0,,,,2,1,2,3
8870_0,,,,2,1,2,3
C(CC(C(C)O)=O)=O,,,5,1,2,0,2
8870_1,,,,2,1,2,3
8871_0,,,,2,1,2,3
8873_0,,,,2,1,2,3
C(C(C(CO)=O)=O)(C)=O,,,5,1,2,0,2
8873_1,,,,2,1,2,3
8875_0,,,,2,1,2,3
C(C(C(C)=O)O)=O,,,5,1,3,0,3
8876_0,,,,2,1,2,3
8876_1,,,,2,1,2,3
8877_0,,,,2,1,2,3
8878_0,,,,2,1,2,3
8879_0,,,,2,1,2,3
8879_1,,,,2,1,2,3
8881_0,,,,2,1,2,3
C(C(C(C)(C(C)O)O)=O)=O,,,5,1,2,0,2
8882_0,,,,2,1,2,3
8883_0,,,,2,1,2,3
8883_1,,,,2,1,2,3
8885_0,,,,2,1,2,3
C(C(C(CO)(C)O)=O)=O,,,5,1,2,0,2
8886_0,,,,2,1,2,3
8886_1,,,,2,1,2,3
8887_0,,,,2,1,2,3
8887_1,,,,2,1,2,3
8888_0,,,,2,1,2,3
8888_1,,,,2,1,2,3
8888_2,,,,2,1,2,3
8889_0,,,,2,1,2,3
8889_1,,,,2,1,2,3
8889_2,,,,2,1,2,3
8890_0,,,,2,1,2,3
8892_0,,,,2,1,2,3
C(C(C)OC(CO)=O)=O,,,5,1,2,0,2
8894_0,,,,2,1,2,3
C(C(C)O)(OCC=O)=O,,,5,1,4,0,4
8894_1,,,,2,1,2,3
8895_0,,,,2,1,2,3
8896_0,,,,2,1,2,3
8897_0,,,,2,1,2,3
8897_1,,,,2,1,2,3
8898_0,,,,2,1,2,3
8898_1,,,,2,1,2,3
8900_0,,,,2,1,2,3
C(C(CC(C=O)=O)=O)=O,,,5,1,2,0,2
8902_0,,,,2,1,2,3
C(CC(C(C=O)=O)=O)=O,,,5,1,3,0,3
8902_1,,,,2,1,2,3
8904_0,,,,2,1,2,3
C(C(C=O)C=O)=O,,,5,1,2,0,2
8905_0,,,,2,1,2,3
8905_1,,,,2,1,2,3
8906_0,,,,2,1,2,3
8906_1,,,,2,1,2,3
8907_0,,,,2,1,2,3
8907_1,,,,2,1,2,3
8909_0,,,,2,1,2,3
C(C(C(C=O)=O)CO)(O)=O,,,5,1,2,0,2
8910_0,,,,2,1,2,3
8910_1,,,,2,1,2,3
8912_0,,,,2,1,2,3
C(C)(CC(C)O)=O,,,5,1,2,0,2
8912_1,,,,2,1,2,3
8913_0,,,,2,1,2,3
8914_0,,,,2,1,2,3
8914_1,,,,2,1,2,3
8915_0,,,,2,1,2,3
8915_1,,,,2,1,2,3
8916_0,,,,2,1,2,3
8917_0,,,,2,1,2,3
8917_1,,,,2,1,2,3
8918_0,,,,2,1,2,3
8918_1,,,,2,1,2,3
8919_0,,,,2,1,2,3
8919_1,,,,2,1,2,3
8920_0,,,,2,1,2,3
8920_1,,,,2,1,2,3
8922_0,,,,2,1,2,3
C(CC(C=C)=O)(O)=O,,,5,1,3,0,3
8923_0,,,,2,1,2,3
8924_0,,,,2,1,2,3
8924_1,,,,2,1,2,3
8926_0,,,,2,1,2,3
C1(C(C)OC(C1)=O)=O,,,5,1,3,0,3
8928_0,,,,2,1,1,2
C(CC(OC(C(C)=O)=O)=O)=O,,,5,1,4,0,4
8928_1,,,,2,1,1,2
8930_0,,,,2,1,2,3
C1(COC(C1C)=O)=O,,,5,1,4,0,4
8930_1,,,,2,1,2,3
8931_0,,,,2,1,2,3
8932_0,,,,2,1,2,3
8933_0,,,,2,1,2,3
8934_0,,,,2,1,2,3
8935_0,,,,2,1,2,3
8935_1,,,,2,1,2,3
8935_2,,,,2,1,2,3
8937_0,,,,2,1,2,3
C(C(C)O)=CC=O,,,5,1,3,0,3
8938_0,,,,2,1,2,3
8939_0,,,,2,1,2,3
8940_0,,,,2,1,2,3
8941_0,,,,2,1,2,3
8942_0,,,,2,1,2,3
8944_0,,,,2,1,2,3
C(C=C(C=O)C(C)O)=O,,,5,1,2,0,2
8945_0,,,,2,1,2,3
8947_0,,,,2,1,2,3
C(C(C(C=O)=CC)O)=O,,,5,1,3,0,3
8947_1,,,,2,1,2,3
8948_0,,,,2,1,2,3
8949_0,,,,2,1,2,3
8950_0,,,,2,1,2,3
8951_0,,,,2,1,2,3
8952_0,,,,2,1,2,3
8953_0,,,,2,1,2,3
8954_0,,,,2,1,2,3
8955_0,,,,2,1,2,3
8956_0,,,,2,1,2,3
8957_0,,,,2,1,2,3
8958_0,,,,2,1,2,3
8959_0,,,,2,1,2,3
8960_0,,,,2,1,2,3
8960_1,,,,2,1,2,3
8960_2,,,,2,1,2,3
8962_0,,,,2,1,2,3
C(C=CC(O)=O)=O,,,5,1,16,0,16
8963_0,,,,2,1,2,3
8965_0,,,,2,1,2,3
C(C(C(O)=O)=CC=O)=O,,,5,1,2,0,2
8966_0,,,,2,1,2,3
8967_0,,,,2,1,2,3
8968_0,,,,2,1,2,3
8969_0,,,,2,1,2,3
8970_0,,,,2,1,2,3
8972_0,,,,2,1,2,3
C(C=CC=O)=O,,,5,1,3,0,3
8974_0,,,,2,1,2,3
C(C=CC(C(O)=O)=O)=O,,,5,1,2,0,2
8975_0,,,,2,1,2,3
8976_0,,,,2,1,2,3
8978_0,,,,2,1,1,2
C=CC(C(OC(C(C)=O)=O)=O)=O,,,5,1,2,0,2
8980_0,,,,2,1,2,3
C=CC(C)=O,,,5,1,4,0,4
8981_0,,,,2,1,2,3
8981_1,,,,2,1,2,3
8983_0,,,,2,1,2,3
C(C(C(CO)(C(C)O)O)O)=O,,,5,1,4,0,4
8983_1,,,,2,1,2,3
8983_2,,,,2,1,2,3
8984_0,,,,2,1,2,3
8984_1,,,,2,1,2,3
8984_2,,,,2,1,2,3
8985_0,,,,2,1,2,3
8985_1,,,,2,1,2,3
8986_0,,,,2,1,2,3
8986_1,,,,2,1,2,3
8986_2,,,,2,1,2,3
8987_0,,,,2,1,2,3
8987_1,,,,2,1,2,3
8987_2,,,,2,1,2,3
8988_0,,,,2,1,2,3
8988_1,,,,2,1,2,3
8989_0,,,,2,1,2,3
8989_1,,,,2,1,2,3
8990_0,,,,2,1,2,3
8990_1,,,,2,1,2,3
8992_0,,,,2,1,1,2
C(C(C=O)O)(OC(C(C)=O)O)=O,,,5,1,2,0,2
8992_1,,,,2,1,1,2
8993_0,,,,2,1,1,2
8995_0,,,,2,1,1,2
C(CO)(C(C)(O)OC(C=O)=O)=O,,,5,1,2,0,2
8995_1,,,,2,1,1,2
8997_0,,,,2,1,1,2
C(C(C)(O)OC(C(CO)=O)=O)=O,,,5,1,2,0,2
8997_1,,,,2,1,1,2
8999_0,,,,2,1,1,2
C(CC(C)OC(C=O)(CO)O)=O,,,5,1,2,0,2
8999_1,,,,2,1,1,2
9001_0,,,,2,1,1,2
C(CC(C)OC(C(CO)=O)O)=O,,,5,1,4,0,4
9001_1,,,,2,1,1,2
9003_0,,,,2,1,1,2
C(CC=O)(OC(C=O)(CO)O)=O,,,5,1,2,0,2
9003_1,,,,2,1,1,2
9005_0,,,,2,1,1,2
C(CC=O)(OC(C(CO)=O)O)=O,,,5,1,4,0,4
9005_1,,,,2,1,1,2
9006_0,,,,2,1,2,3
9008_0,,,,2,1,1,2
C(COC(C(C=O)=O)O)(CO)=O,,,5,1,4,0,4
9008_1,,,,2,1,1,2
9010_0,,,,2,1,1,2
C(C(CO)OC(C(C=O)=O)O)=O,,,5,1,3,0,3
9010_1,,,,2,1,1,2
9010_2,,,,2,1,1,2
9012_0,,,,2,1,2,3
C(C1C(C(C(O)O1)=O)O)=O,,,5,1,4,0,4
9012_1,,,,2,1,2,3
9012_2,,,,2,1,2,3
9014_0,,,,2,1,1,2
C(C(C=O)(COC(C=O)O)O)=O,,,5,1,2,0,2
9014_1,,,,2,1,1,2
9016_0,,,,2,1,1,2
C(C(C=O)(O)OCC(C=O)O)=O,,,5,1,3,0,3
9016_1,,,,2,1,1,2
9016_2,,,,2,1,1,2
9018_0,,,,2,1,1,2
C(C(C=O)(C)O)(OC(C=O)O)=O,,,5,1,2,0,2
9018_1,,,,2,1,1,2
9020_0,,,,2,1,2,3
C1(C(C)(O)OCC1O)=O,,,5,1,2,0,2
9022_0,,,,2,1,2,3
C1(C(C(C(C)(O)O1)=O)O)=O,,,5,1,4,0,4
9022_1,,,,2,1,2,3
9022_2,,,,2,1,2,3
9024_0,,,,2,1,2,3
C1(C(C(C(O)O1)=O)(C)O)=O,,,5,1,3,0,3
9024_1,,,,2,1,2,3
9026_0,,,,2,1,1,2
C(C)(C(CO)OC(C(O)=O)=O)=O,,,5,1,1,0,1
9028_0,,,,2,1,2,3
C(C1(CC(CO1)=O)O)(O)=O,,,5,1,3,0,3
9028_1,,,,2,1,2,3
9030_0,,,,2,1,1,2
C(C(CC(C)OC(C=O)O)O)=O,,,5,1,2,0,2
9030_1,,,,2,1,1,2
9032_0,,,,2,1,1,2
C(CC(C=O)O)(OC(C=O)O)=O,,,5,1,2,0,2
9032_1,,,,2,1,1,2
9034_0,,,,2,1,1,2
C(C(C(COC(C=O)O)=O)O)=O,,,5,1,2,0,2
9034_1,,,,2,1,1,2
9036_0,,,,2,1,1,2
C(C(C=O)(O)OCC(CO)=O)=O,,,5,1,2,0,2
9036_1,,,,2,1,1,2
9038_0,,,,2,1,1,2
C(C(CO)(O)OC(C(C)=O)=O)=O,,,5,1,1,0,1
9040_0,,,,2,1,1,2
C(C(O)OCC(C=O)=O)(CO)=O,,,5,1,4,0,4
9040_1,,,,2,1,1,2
9042_0,,,,2,1,1,2
C(C(COC(C(C=O)=O)O)O)=O,,,5,1,3,0,3
9042_1,,,,2,1,1,2
9042_2,,,,2,1,1,2
9044_0,,,,2,1,1,2
C(CO)(C(O)OC(C(C)=O)=O)=O,,,5,1,3,0,3
9045_0,,,,2,1,1,2
9045_1,,,,2,1,1,2
9047_0,,,,2,1,1,2
C(C)(C(COC(C(O)=O)=O)O)=O,,,5,1,1,0,1
9048_0,,,,2,1,1,2
9048_1,,,,2,1,1,2
9049_0,,,,2,1,1,2
9049_1,,,,2,1,1,2
9051_0,,,,2,1,1,2
C(C(O)=O)(OCCC(C(C)=O)=O)=O,,,5,1,1,0,1
9052_0,,,,2,1,1,2
9052_1,,,,2,1,1,2
9053_0,,,,2,1,1,2
9053_1,,,,2,1,1,2
9055_0,,,,2,1,1,2
C(CC(C)OC(C(C)=O)=O)=O,,,5,1,3,0,3
9055_1,,,,2,1,1,2
9056_0,,,,2,1,2,3
9056_1,,,,2,1,2,3
9058_0,,,,2,1,1,2
C(CC(OCC(C=O)=O)=O)=O,,,5,1,6,0,6
9058_1,,,,2,1,1,2
9059_0,,,,2,1,1,2
9059_1,,,,2,1,1,2
9061_0,,,,2,1,1,2
C(CCOC(C(C)=O)=O)=O,,,5,1,2,0,2
9061_1,,,,2,1,1,2
9062_0,,,,2,1,2,3
9062_1,,,,2,1,2,3
9064_0,,,,2,1,2,3
C(C1CC(C(O1)=O)=O)=O,,,5,1,3,0,3
9064_1,,,,2,1,2,3
9065_0,,,,2,1,2,3
9065_1,,,,2,1,2,3
9067_0,,,,2,1,1,2
C(C(C)=O)(OCCC(C(O)=O)=O)=O,,,5,1,2,0,2
9067_1,,,,2,1,1,2
9069_0,,,,2,1,1,2
C(C(COC(C(CO)=O)=O)O)=O,,,5,1,3,0,3
9069_1,,,,2,1,1,2
9069_2,,,,2,1,1,2
9071_0,,,,2,1,1,2
C(C(COC(C=O)=O)O)=O,,,5,1,3,0,3
9071_1,,,,2,1,1,2
9071_2,,,,2,1,1,2
9073_0,,,,2,1,1,2
C(COC(C(C=O)=O)=O)(C)=O,,,5,1,2,0,2
9073_1,,,,2,1,1,2
9075_0,,,,2,1,1,2
C(CC(OC(C)CC=O)=O)=O,,,5,1,4,0,4
9075_1,,,,2,1,1,2
9076_0,,,,2,1,1,2
9076_1,,,,2,1,1,2
9078_0,,,,2,1,1,2
C(CC(OC(CC=O)=O)=O)=O,,,5,1,2,0,2
9078_1,,,,2,1,1,2
9079_0,,,,2,1,1,2
9079_1,,,,2,1,1,2
9080_0,,,,2,1,1,2
9082_0,,,,2,1,1,2
C(COC(C(CO)=O)=O)(CO)=O,,,5,1,2,0,2
9082_1,,,,2,1,1,2
9084_0,,,,2,1,1,2
C(COC(C=O)=O)(CO)=O,,,5,1,2,0,2
9084_1,,,,2,1,1,2
9086_0,,,,2,1,2,3
C1(COC(C(C1)=O)=O)=O,,,5,1,4,0,4
9086_1,,,,2,1,2,3
9087_0,,,,2,1,1,2
9088_0,,,,2,1,1,2
9089_0,,,,2,1,1,2
9091_0,,,,2,1,2,3
C(C(C)CC=O)=O,,,5,1,10,0,10
9091_1,,,,2,1,2,3
9092_0,,,,2,1,2,3
9092_1,,,,2,1,2,3
9093_0,,,,2,1,2,3
9093_1,,,,2,1,2,3
9094_0,,,,2,1,2,3
9094_1,,,,2,1,2,3
9095_0,,,,2,1,2,3
9095_1,,,,2,1,2,3
9096_0,,,,2,1,2,3
9096_1,,,,2,1,2,3
9097_0,,,,2,1,2,3
9097_1,,,,2,1,2,3
9099_0,,,,2,1,2,3
C(C)(C(C)CC=O)=O,,,5,1,5,0,5
9099_1,,,,2,1,2,3
9100_0,,,,2,1,2,3
9100_1,,,,2,1,2,3
9101_0,,,,2,1,2,3
9101_1,,,,2,1,2,3
9102_0,,,,2,1,2,3
9102_1,,,,2,1,2,3
9103_0,,,,2,1,2,3
9105_0,,,,2,1,2,3
C(CC(C)C(C=O)O)=O,,,5,1,4,0,4
9106_0,,,,2,1,2,3
9106_1,,,,2,1,2,3
9108_0,,,,2,1,2,3
C(CO)(C(C)CC=O)=O,,,5,1,1,0,1
9109_0,,,,2,1,2,3
9109_1,,,,2,1,2,3
9110_0,,,,2,1,2,3
9111_0,,,,2,1,2,3
9112_0,,,,2,1,2,3
9113_0,,,,2,1,2,3
9114_0,,,,2,1,2,3
9115_0,,,,2,1,2,3
9117_0,,,,2,1,2,3
C(C(C)CC(C(O)=O)=O)=O,,,5,1,1,0,1
9119_0,,,,2,1,2,3
C(CC(C(O)=O)CC=O)=O,,,5,1,1,0,1
9121_0,,,,2,1,2,3
C(C(C(O)=O)(C)CC=O)=O,,,5,1,1,0,1
9123_0,,,,2,1,2,3
C(CC(C(O)=O)C)=O,,,5,1,5,0,5
9125_0,,,,2,1,2,3
C(C(C=O)C(C(O)=O)C)=O,,,5,1,1,0,1
9126_0,,,,2,1,2,3
9127_0,,,,2,1,2,3
9128_0,,,,2,1,2,3
9130_0,,,,2,1,2,3
C1(C(C)CC(C(O1)=O)=O)=O,,,5,1,2,0,2
9132_0,,,,2,1,2,3
C(C(C)CC(C(O)=O)=O)(O)=O,,,5,1,1,0,1
9133_0,,,,2,1,2,3
9134_0,,,,2,1,2,3
9136_0,,,,2,1,2,3
C(CC(C)CC(C=O)O)=O,,,5,1,2,0,2
9137_0,,,,2,1,2,3
9138_0,,,,2,1,2,3
9139_0,,,,2,1,2,3
9140_0,,,,2,1,2,3
9141_0,,,,2,1,2,3
9141_1,,,,2,1,2,3
9142_0,,,,2,1,2,3
9143_0,,,,2,1,2,3
9144_0,,,,2,1,2,3
9145_0,,,,2,1,1,2
9147_0,,,,2,1,1,2
C1(C(C(C(C1C(C)O)O)O)O)=O,,,5,1,1,0,1
9148_0,,,,2,1,1,2
9150_0,,,,2,1,1,2
C(C1C(C(C(C1O)O)O)=O)(O)=O,,,5,1,1,0,1
9151_0,,,,2,1,1,2
9153_0,,,,2,1,1,2
C(C1(C(C(C(C1O)O)O)=O)O)=O,,,5,1,1,0,1
9154_0,,,,2,1,1,2
9155_0,,,,2,1,1,2
9156_0,,,,2,1,1,2
9157_0,,,,2,1,1,2
9158_0,,,,2,1,1,2
9159_0,,,,2,1,1,2
9161_0,,,,2,1,1,2
C(C(C(CO)=O)C(CC(C)O)O)=O,,,5,1,1,0,1
9163_0,,,,2,1,1,2
C(CC(C(C=O)C(CO)=O)O)(O)=O,,,5,1,1,0,1
9164_0,,,,2,1,1,2
9165_0,,,,2,1,1,2
9167_0,,,,2,1,1,2
C(C(C(CO)=O)C(C(CO)=O)O)=O,,,5,1,1,0,1
9168_0,,,,2,1,1,2
9169_0,,,,2,1,1,2
9170_0,,,,2,1,1,2
9171_0,,,,2,1,1,2
9172_0,,,,2,1,1,2
9174_0,,,,2,1,1,2
C(CC(C(C(C(C=O)O)=O)O)O)=O,,,5,1,1,0,1
9176_0,,,,2,1,1,2
C(CC(C(C(C(C=O)O)O)O)=O)=O,,,5,1,2,0,2
9177_0,,,,2,1,1,2
9179_0,,,,2,1,1,2
C(CC(C(C(C(C)O)O)O)=O)=O,,,5,1,2,0,2
9180_0,,,,2,1,1,2
9182_0,,,,2,1,1,2
C(CC(C(C(C(O)=O)O)O)=O)=O,,,5,1,5,0,5
9183_0,,,,2,1,1,2
9185_0,,,,2,1,1,2
C(CC(C(C(CO)O)O)=O)=O,,,5,1,2,0,2
9187_0,,,,2,1,1,2
C(C(CO)(C(C=O)C(CO)=O)O)=O,,,5,1,1,0,1
9188_0,,,,2,1,1,2
9190_0,,,,2,1,1,2
C(C(C(C(C(CO)O)O)=O)CO)=O,,,5,1,1,0,1
9191_0,,,,2,1,1,2
9193_0,,,,2,1,1,2
C(C(C(C(C(CO)O)O)=O)C=C)=O,,,5,1,1,0,1
9194_0,,,,2,1,1,2
9196_0,,,,2,1,1,2
C(C(C(C(CCO)O)O)O)=O,,,5,1,1,0,1
9197_0,,,,2,1,1,2
9199_0,,,,2,1,1,2
C(C(C(C(CCO)O)=O)O)=O,,,5,1,1,0,1
9201_0,,,,2,1,1,2
C(C(C(CO)=O)CO)=O,,,5,1,2,0,2
9202_0,,,,2,1,1,2
9203_0,,,,2,1,1,2
9205_0,,,,2,1,1,2
C(C(C(CO)=O)C(C(C)=O)=O)=O,,,5,1,1,0,1
9207_0,,,,2,1,1,2
C(CC(C(CC(CO)=O)=O)=O)=O,,,5,1,1,0,1
9208_0,,,,2,1,1,2
9209_0,,,,2,1,1,2
9211_0,,,,2,1,1,2
C(CO)(C(C(C(C(C)O)=O)=O)O)=O,,,5,1,1,0,1
9212_0,,,,2,1,1,2
9214_0,,,,2,1,1,2
C(C(C(C(C(C(C)O)=O)O)=O)O)=O,,,5,1,1,0,1
9215_0,,,,2,1,1,2
9217_0,,,,2,1,1,2
C(C(C)O)(C(C(C(C)O)=O)O)=O,,,5,1,1,0,1
9218_0,,,,2,1,1,2
9219_0,,,,2,1,1,2
9220_0,,,,2,1,1,2
9222_0,,,,2,1,1,2
C(C(C)O)(C(C(CO)=O)O)=O,,,5,1,1,0,1
9223_0,,,,2,1,1,2
9225_0,,,,2,1,1,2
C(CO)(C(C(C(C(O)=O)=O)=O)O)=O,,,5,1,1,0,1
9227_0,,,,2,1,1,2
C(C(C(C(C(C(O)=O)=O)O)=O)O)=O,,,5,1,1,0,1
9228_0,,,,2,1,1,2
9230_0,,,,2,1,1,2
C(C(C(C(C(O)=O)=O)O)=O)(O)=O,,,5,1,1,0,1
9232_0,,,,2,1,1,2
C(CO)(C(C(C(O)=O)=O)O)=O,,,5,1,3,0,3
9233_0,,,,2,1,1,2
9234_0,,,,2,1,1,2
9236_0,,,,2,1,1,2
C(CO)(C(C(CO)=O)O)=O,,,5,1,2,0,2
9237_0,,,,2,1,1,2
9238_0,,,,2,1,1,2
9240_0,,,,2,1,1,2
C(C(C(CC(CO)=O)=O)CO)(O)=O,,,5,1,1,0,1
9242_0,,,,2,1,1,2
C(C(C(CO)=O)C=C)=O,,,5,1,1,0,1
9244_0,,,,2,1,1,2
C(CO)(C(C=C)C(C(O)=O)=O)=O,,,5,1,1,0,1
9246_0,,,,2,1,1,2
C(C(C(CO)=O)C(C(O)=O)=C)=O,,,5,1,1,0,1
9248_0,,,,2,1,1,2
C(CO)(C1C(C(OC(C1=C)=O)=O)=O)=O,,,5,1,1,0,1
9250_0,,,,2,1,1,2
C(CO)(C1C(C(OC1C)=O)=O)=O,,,5,1,1,0,1
9252_0,,,,2,1,1,2
C1(C(C(CO)=O)C(C(O1)=O)=O)=O,,,5,1,1,0,1
9253_0,,,,2,1,1,2
9254_0,,,,2,1,1,2
9255_0,,,,2,1,1,2
9256_0,,,,2,1,1,2
9258_0,,,,2,1,1,2
C(C(C)(C(C=O)C(CO)=O)O)(O)=O,,,5,1,1,0,1
9259_0,,,,2,1,1,2
9260_0,,,,2,1,1,2
9261_0,,,,2,1,1,2
9262_0,,,,2,1,1,2
9263_0,,,,2,1,1,2
9265_0,,,,2,1,1,2
C(C(C(C(C(C=O)O)O)O)O)=O,,,5,1,1,0,1
9266_0,,,,2,1,1,2
9267_0,,,,2,1,1,2
9268_0,,,,2,1,1,2
9269_0,,,,2,1,1,2
9270_0,,,,2,1,1,2
9271_0,,,,2,1,1,2
9272_0,,,,2,1,1,2
9273_0,,,,2,1,1,2
9274_0,,,,2,1,1,2
9275_0,,,,2,1,1,2
9277_0,,,,2,1,1,2
C(C(CO)O)(C(CO)(CO)O)=O,,,5,1,1,0,1
9279_0,,,,2,1,1,2
C(C(C(C(CO)(CO)O)O)O)=O,,,5,1,2,0,2
9281_0,,,,2,1,1,2
C(C(C(C(CO)(CO)O)=O)O)(O)=O,,,5,1,3,0,3
9283_0,,,,2,1,1,2
C(C(C(C(CO)(CO)O)=O)O)=O,,,5,1,2,0,2
9284_0,,,,2,1,1,2
9285_0,,,,2,1,1,2
9287_0,,,,2,1,1,2
C(C(CO)O)(C(C=CC)O)=O,,,5,1,1,0,1
9289_0,,,,2,1,1,2
C(C(C(C(C=CC)O)O)O)=O,,,5,1,1,0,1
9291_0,,,,2,1,1,2
C(C(CC=C)O)(C(CO)O)=O,,,5,1,1,0,1
9293_0,,,,2,1,1,2
C(C(C(C(CC=C)O)O)O)=O,,,5,1,1,0,1
9295_0,,,,2,1,1,2
C(C(CO)O)(C(C)O)=O,,,5,1,2,0,2
9296_0,,,,2,1,1,2
9297_0,,,,2,1,1,2
9298_0,,,,2,1,1,2
9300_0,,,,2,1,1,2
C(C(CC(C)O)O)(C(CO)O)=O,,,5,1,2,0,2
9301_0,,,,2,1,1,2
9302_0,,,,2,1,1,2
9303_0,,,,2,1,1,2
9304_0,,,,2,1,1,2
9306_0,,,,2,1,1,2
C(C(CO)O)(C(C(CO)=O)O)=O,,,5,1,3,0,3
9308_0,,,,2,1,1,2
C(C(C(C(CO)O)=O)(CO)O)=O,,,5,1,2,0,2
9309_0,,,,2,1,1,2
9310_0,,,,2,1,1,2
9311_0,,,,2,1,1,2
9313_0,,,,2,1,1,2
C(C(C(C(CO)O)=O)(C)O)(O)=O,,,5,1,2,0,2
9314_0,,,,2,1,1,2
9316_0,,,,2,1,1,2
C(C(C(C(C=O)O)=O)(CO)O)(O)=O,,,5,1,2,0,2
9318_0,,,,2,1,1,2
C(C(C(O)=O)O)(C(C=CC)O)=O,,,5,1,1,0,1
9320_0,,,,2,1,1,2
C(C(C(C(CC=C)O)=O)O)(O)=O,,,5,1,1,0,1
9322_0,,,,2,1,1,2
C(C(C(C(C)O)=O)O)(O)=O,,,5,1,2,0,2
9323_0,,,,2,1,1,2
9325_0,,,,2,1,1,2
C(C(C(C(CC(C)O)O)=O)O)(O)=O,,,5,1,2,0,2
9326_0,,,,2,1,1,2
9327_0,,,,2,1,1,2
9329_0,,,,2,1,1,2
C(C(CO)O)(C(C(C(O)=O)=O)O)=O,,,5,1,2,0,2
9331_0,,,,2,1,1,2
C(C(C(C(C(CO)=O)O)=O)O)(O)=O,,,5,1,2,0,2
9333_0,,,,2,1,1,2
C(C(C(C(C(O)=O)O)=O)(CO)O)=O,,,5,1,2,0,2
9334_0,,,,2,1,1,2
9336_0,,,,2,1,1,2
C(C(C(C(C(O)=O)O)=O)(C)O)(O)=O,,,5,1,2,0,2
9337_0,,,,2,1,1,2
9338_0,,,,2,1,1,2
9339_0,,,,2,1,1,2
9341_0,,,,2,1,1,2
C(C(C=O)O)(C(C=CC)O)=O,,,5,1,2,0,2
9343_0,,,,2,1,1,2
C(C(C(C(CC=C)O)=O)O)=O,,,5,1,2,0,2
9344_0,,,,2,1,1,2
9346_0,,,,2,1,1,2
C(C(C(C(CO)O)=O)C=C)=O,,,5,1,2,0,2
9347_0,,,,2,1,1,2
9348_0,,,,2,1,1,2
9349_0,,,,2,1,1,2
9350_0,,,,2,1,1,2
9351_0,,,,2,1,1,2
9352_0,,,,2,1,1,2
9353_0,,,,2,1,1,2
9354_0,,,,2,1,1,2
9355_0,,,,2,1,1,2
9356_0,,,,2,1,1,2
9357_0,,,,2,1,1,2
9358_0,,,,2,1,1,2
9359_0,,,,2,1,1,2
9361_0,,,,2,1,1,2
C(C(C(CC(C)O)=O)O)=O,,,5,1,1,0,1
9363_0,,,,2,1,1,2
C(CC(C(C=O)O)=O)(O)=O,,,5,1,3,0,3
9364_0,,,,2,1,1,2
9365_0,,,,2,1,1,2
9366_0,,,,2,1,1,2
9367_0,,,,2,1,1,2
9369_0,,,,2,1,1,2
C(C)(C(C(C(O)=O)=O)O)=O,,,5,1,1,0,1
9371_0,,,,2,1,1,2
C(C(C(C=C)=O)O)=O,,,5,1,3,0,3
9373_0,,,,2,1,1,2
C(C(C(C(C(O)=O)=C)=O)O)=O,,,5,1,3,0,3
9374_0,,,,2,1,1,2
9375_0,,,,2,1,1,2
9376_0,,,,2,1,1,2
9377_0,,,,2,1,1,2
9378_0,,,,2,1,1,2
9379_0,,,,2,1,1,2
9380_0,,,,2,1,1,2
9381_0,,,,2,1,1,2
9382_0,,,,2,1,1,2
9383_0,,,,2,1,1,2
9384_0,,,,2,1,1,2
9385_0,,,,2,1,1,2
9386_0,,,,2,1,1,2
9388_0,,,,2,1,1,2
C(CC(C(C)=O)O)(O)=O,,,5,1,2,0,2
9389_0,,,,2,1,1,2
9390_0,,,,2,1,1,2
9391_0,,,,2,1,1,2
9392_0,,,,2,1,1,2
9393_0,,,,2,1,1,2
9394_0,,,,2,1,1,2
9395_0,,,,2,1,1,2
9396_0,,,,2,1,1,2
9397_0,,,,2,1,1,2
9398_0,,,,2,1,1,2
9399_0,,,,2,1,1,2
9400_0,,,,2,1,1,2
9401_0,,,,2,1,1,2
9402_0,,,,2,1,1,2
9403_0,,,,2,1,1,2
9404_0,,,,2,1,1,2
9406_0,,,,2,1,1,2
C(C(C(C(C(CO)O)=O)=O)O)=O,,,5,1,2,0,2
9407_0,,,,2,1,1,2
9409_0,,,,2,1,1,2
C(C(C(C(C(CO)O)O)=O)=O)=O,,,5,1,2,0,2
9410_0,,,,2,1,1,2
9411_0,,,,2,1,1,2
9412_0,,,,2,1,1,2
9413_0,,,,2,1,1,2
9414_0,,,,2,1,1,2
9415_0,,,,2,1,1,2
9416_0,,,,2,1,1,2
9417_0,,,,2,1,1,2
9418_0,,,,2,1,1,2
9419_0,,,,2,1,1,2
9420_0,,,,2,1,1,2
9421_0,,,,2,1,1,2
9422_0,,,,2,1,1,2
9423_0,,,,2,1,1,2
9424_0,,,,2,1,1,2
9425_0,,,,2,1,1,2
9426_0,,,,2,1,1,2
9427_0,,,,2,1,1,2
9428_0,,,,2,1,1,2
9429_0,,,,2,1,1,2
9430_0,,,,2,1,1,2
9431_0,,,,2,1,1,2
9432_0,,,,2,1,1,2
9433_0,,,,2,1,1,2
9434_0,,,,2,1,1,2
9435_0,,,,2,1,1,2
9437_0,,,,2,1,1,2
C(C(CO)O)(C(CO)C(C)O)=O,,,5,1,2,0,2
9438_0,,,,2,1,1,2
9440_0,,,,2,1,1,2
C(C(C(C(CO)O)=O)CO)(O)=O,,,5,1,2,0,2
9441_0,,,,2,1,1,2
9443_0,,,,2,1,1,2
C(C(CO)O)(CCO)=O,,,5,1,3,0,3
9444_0,,,,2,1,1,2
9446_0,,,,2,1,1,2
C(C(C(C(CO)O)=O)C(C)O)(O)=O,,,5,1,2,0,2
9447_0,,,,2,1,1,2
9449_0,,,,2,1,1,2
C(C(C(O)=O)C(C(CO)O)=O)(O)=O,,,5,1,2,0,2
9450_0,,,,2,1,1,2
9452_0,,,,2,1,1,2
C(CC(C(CO)O)=O)(O)=O,,,5,1,3,0,3
9454_0,,,,2,1,1,2
C(C(C(CO)=O)(CO)C(C)O)=O,,,5,1,1,0,1
9456_0,,,,2,1,1,2
C(C(C(CO)=O)(C(C)O)C(C)O)=O,,,5,1,1,0,1
9458_0,,,,2,1,1,2
C(C(C=O)(C(CO)=O)C(C)O)(O)=O,,,5,1,1,0,1
9460_0,,,,2,1,1,2
C(CC(C(C(O)=O)C(CO)=O)O)=O,,,5,1,1,0,1
9462_0,,,,2,1,1,2
C(C(C=O)(C(CO)=O)CO)(O)=O,,,5,1,1,0,1
9464_0,,,,2,1,1,2
C(C(C(O)=O)(C=O)C(CO)=O)(O)=O,,,5,1,1,0,1
9465_0,,,,2,1,1,2
9467_0,,,,2,1,1,2
C(CO)(C(C(C=O)=O)(C(C)O)O)=O,,,5,1,3,0,3
9469_0,,,,2,1,1,2
C(C(C(CO)=O)(C(C=O)=O)O)(O)=O,,,5,1,3,0,3
9471_0,,,,2,1,1,2
C(C(C=O)(C(CO)=O)O)=O,,,5,1,1,0,1
9473_0,,,,2,1,1,2
C(C(C(CO)=O)CO)(O)=O,,,5,1,1,0,1
9475_0,,,,2,1,1,2
C(C(C(CO)=O)C(C)O)(O)=O,,,5,1,1,0,1
9477_0,,,,2,1,1,2
C(C(C(O)=O)C(CO)=O)(O)=O,,,5,1,1,0,1
9479_0,,,,2,1,1,2
C(C(C(CO)=O)(C(C)O)O)(O)=O,,,5,1,6,0,6
9481_0,,,,2,1,1,2
C(C(C(O)=O)(C(CO)=O)O)(O)=O,,,5,1,4,0,4
9483_0,,,,2,1,1,2
C(C(C=O)(C(CO)=O)O)(O)=O,,,5,1,3,0,3
9485_0,,,,2,1,1,2
C(C)(C(C(O)=O)(C(CO)=O)CO)=O,,,5,1,1,0,1
9486_0,,,,2,1,1,2
9487_0,,,,2,1,1,2
9489_0,,,,2,1,1,2
C(C(C=O)(C(C(CO)O)=O)O)=O,,,5,1,1,0,1
9490_0,,,,2,1,1,2
9491_0,,,,2,1,1,2
9492_0,,,,2,1,1,2
9493_0,,,,2,1,1,2
9494_0,,,,2,1,1,2
9495_0,,,,2,1,1,2
9497_0,,,,2,1,1,2
C(C(C=O)(C(C(CO)O)=O)O)(O)=O,,,5,1,1,0,1
9499_0,,,,2,1,1,2
C(CC(C(CO)=O)(C(CO)=O)O)=O,,,5,1,1,0,1
9501_0,,,,2,1,1,2
C(CC(C(C=O)O)(C(C=O)O)O)=O,,,5,1,1,0,1
9502_0,,,,2,1,1,2
9504_0,,,,2,1,1,2
C(CO)(C(C(C(CO)=O)=O)(C)O)=O,,,5,1,1,0,1
9506_0,,,,2,1,1,2
C(C(C)(C(C=O)O)O)(C(C=O)O)=O,,,5,1,2,0,2
9508_0,,,,2,1,1,2
C(C(C(C(C)(C(C)O)O)=O)O)=O,,,5,1,2,0,2
9510_0,,,,2,1,1,2
C(C(C(C(CO)(C)O)=O)O)=O,,,5,1,2,0,2
9512_0,,,,2,1,1,2
C(C(C(CO)=O)(C)O)(O)=O,,,5,1,2,0,2
9513_0,,,,2,1,1,2
9515_0,,,,2,1,1,2
C(C(C)OC(C(CO)=O)=O)(O)=O,,,5,1,1,0,1
9516_0,,,,2,1,1,2
9517_0,,,,2,1,1,2
9518_0,,,,2,1,1,2
9520_0,,,,2,1,1,2
C(C(C(CC(C=O)=O)=O)O)=O,,,5,1,2,0,2
9522_0,,,,2,1,1,2
C(C(C=O)C(C(C=O)O)=O)=O,,,5,1,3,0,3
9524_0,,,,2,1,1,2
C(C(C(C(C=O)O)=O)CO)(O)=O,,,5,1,2,0,2
9525_0,,,,2,1,1,2
9526_0,,,,2,1,1,2
9527_0,,,,2,1,1,2
9528_0,,,,2,1,1,2
9530_0,,,,2,1,1,2
C(C(C(C=CC(C)O)=O)O)=O,,,5,1,2,0,2
9532_0,,,,2,1,1,2
C(C(C=C(C=O)C(C)O)O)=O,,,5,1,2,0,2
9534_0,,,,2,1,1,2
C(C(C(C(C=O)=CC)O)O)=O,,,5,1,2,0,2
9536_0,,,,2,1,1,2
C(C)=C(C(C(CO)O)=O)C=O,,,5,1,2,0,2
9538_0,,,,2,1,1,2
C(C(C(C=CC(O)=O)=O)O)=O,,,5,1,2,0,2
9540_0,,,,2,1,1,2
C(C(C=C(C(O)=O)C=O)O)=O,,,5,1,2,0,2
9542_0,,,,2,1,1,2
C(C(C=CC=O)O)=O,,,5,1,2,0,2
9544_0,,,,2,1,1,2
C(C(C=CC(C(O)=O)=O)O)=O,,,5,1,2,0,2
9545_0,,,,2,1,1,2
9547_0,,,,2,1,1,2
C(C(C(C(CO)(C(C)O)O)O)O)=O,,,5,1,2,0,2
9549_0,,,,2,1,1,2
C(C(CO)O)(C(CO)(C(C)O)O)=O,,,5,1,2,0,2
9550_0,,,,2,1,1,2
9551_0,,,,2,1,1,2
9552_0,,,,2,1,1,2
9553_0,,,,2,1,1,2
9554_0,,,,2,1,1,2
9556_0,,,,2,1,1,2
C1(C(C(C(C(C)(O)O1)O)=O)O)=O,,,5,1,3,0,3
9557_0,,,,2,1,1,2
9558_0,,,,2,1,1,2
9559_0,,,,2,1,1,2
9560_0,,,,2,1,1,2
9561_0,,,,2,1,1,2
9563_0,,,,2,1,1,2
C1(C(CC(C)O)OC(C1O)O)=O,,,5,1,2,0,2
9565_0,,,,2,1,1,2
C1(C(C(C(CC(C)O)O1)O)O)=O,,,5,1,3,0,3
9567_0,,,,2,1,1,2
C(CC1C(C(C(O1)O)O)=O)(O)=O,,,5,1,2,0,2
9569_0,,,,2,1,1,2
C(CC1C(C(C(O1)=O)O)O)(O)=O,,,5,1,3,0,3
9571_0,,,,2,1,1,2
C1(C(C(OC1C(CO)=O)O)O)=O,,,5,1,2,0,2
9573_0,,,,2,1,1,2
C1(C(C(C(C(CO)=O)O1)O)O)=O,,,5,1,3,0,3
9575_0,,,,2,1,1,2
C(C(C1C(C(C(O)O1)=O)O)O)=O,,,5,1,2,0,2
9577_0,,,,2,1,1,2
C(C1(C(C(C(O1)O)O)=O)CO)=O,,,5,1,2,0,2
9579_0,,,,2,1,1,2
C(C1(CO)C(C(C(O1)=O)O)O)=O,,,5,1,3,0,3
9581_0,,,,2,1,1,2
C1(COC(C1O)O)=O,,,5,1,2,0,2
9583_0,,,,2,1,1,2
C1(C(C(CO1)O)O)=O,,,5,1,3,0,3
9585_0,,,,2,1,1,2
C1(C(C)OC(C1O)O)=O,,,5,1,2,0,2
9586_0,,,,2,1,1,2
9588_0,,,,2,1,1,2
C1(C(C(C(O)O1)O)=O)=O,,,5,1,2,0,2
9589_0,,,,2,1,1,2
9591_0,,,,2,1,1,2
C(C1(C(C(C(O1)O)O)=O)C)(O)=O,,,5,1,2,0,2
9592_0,,,,2,1,1,2
9594_0,,,,2,1,1,2
C(C1C(C(C(C)(O1)O)O)=O)(O)=O,,,5,1,2,0,2
9596_0,,,,2,1,1,2
C1(C(COC(C1C(C)O)O)O)=O,,,5,1,2,0,2
9598_0,,,,2,1,1,2
C(C1C(C(COC1O)O)=O)(O)=O,,,5,1,2,0,2
9600_0,,,,2,1,1,2
C1(C(C(C=O)(O)OCC1O)O)=O,,,5,1,2,0,2
9602_0,,,,2,1,1,2
C1(C(COC(C1)O)O)=O,,,5,1,2,0,2
9603_0,,,,2,1,1,2
9605_0,,,,2,1,1,2
C(C1(C(C(C(O)OC1)O)=O)O)=O,,,5,1,2,0,2
9607_0,,,,2,1,1,2
C(C1(COC(C(C1O)O)=O)O)=O,,,5,1,3,0,3
9609_0,,,,2,1,1,2
C1(C(C(C(C(O)O1)O)=O)(C)O)=O,,,5,1,2,0,2
9610_0,,,,2,1,1,2
9611_0,,,,2,1,1,2
9613_0,,,,2,1,1,2
C1(C(CC(C)OC(C1O)O)O)=O,,,5,1,2,0,2
9615_0,,,,2,1,1,2
C1(C(C(C(CC(C)O1)O)O)O)=O,,,5,1,3,0,3
9617_0,,,,2,1,1,2
C1(CC(C(C(C(O)O1)O)=O)O)=O,,,5,1,2,0,2
9619_0,,,,2,1,1,2
C1(CC(C(C(C(O1)=O)O)O)O)=O,,,5,1,3,0,3
9621_0,,,,2,1,1,2
C1(C(C(OCC(C1O)=O)O)O)=O,,,5,1,2,0,2
9623_0,,,,2,1,1,2
C1(C(C(C(C(CO1)=O)O)O)O)=O,,,5,1,3,0,3
9625_0,,,,2,1,1,2
C1(C(COC(C(C1O)=O)O)O)=O,,,5,1,2,0,2
9627_0,,,,2,1,1,2
C(C(C1CC(C(O1)=O)=O)O)=O,,,5,1,2,0,2
9629_0,,,,2,1,1,2
C1(C(C(C(C(C)=O)O1)=O)O)=O,,,5,1,3,0,3
9631_0,,,,2,1,1,2
C1(C(C=O)C(C(CO1)O)=O)=O,,,5,1,2,0,2
9633_0,,,,2,1,1,2
C1(C(C(C(CO1)O)=O)(CO)O)=O,,,5,1,2,0,2
9635_0,,,,2,1,1,2
C1(C(C(C(CO1)O)=O)O)=O,,,5,1,2,0,2
9636_0,,,,2,1,1,2
9637_0,,,,2,1,1,2
9639_0,,,,2,1,1,2
C(CC(C)C(C(C(C=O)O)=O)O)=O,,,5,1,2,0,2
9641_0,,,,2,1,1,2
C(C(C)CC=O)(C(CO)O)=O,,,5,1,1,0,1
9643_0,,,,2,1,1,2
C(CC(C)C(C(C=O)O)O)=O,,,5,1,2,0,2
9645_0,,,,2,1,1,2
C(C(C)CC=O)(C(C(O)=O)O)=O,,,5,1,1,0,1
9647_0,,,,2,1,1,2
C(C(C)CC=O)(C(C=O)O)=O,,,5,1,1,0,1
9648_0,,,,2,3,2,5
9650_0,,,,2,3,2,5
CC(CC(CC(CCO)O)O)O,,,5,1,1,0,1
9651_0,,,,2,3,2,5
9653_0,,,,2,3,2,5
C(C(C(CO)C(CC(C)O)O)O)=O,,,5,1,1,0,1
9655_0,,,,2,3,2,5
CC(CC(C(CO)CO)O)O,,,5,1,1,0,1
9657_0,,,,2,3,2,5
CC(C(CO)C(C(CO)CO)O)O,,,5,1,1,0,1
9659_0,,,,2,3,2,5
C=CC(CO)C(C(CO)C(C)O)O,,,5,1,1,0,1
9661_0,,,,2,3,2,5
CC(C(CO)C(CCO)O)O,,,5,1,2,0,2
9663_0,,,,2,3,2,5
CC(C(C(CCO)O)C(C)O)O,,,5,1,1,0,1
9664_0,,,,2,3,2,5
9666_0,,,,2,3,2,5
C(CC(CC(CCO)O)O)(O)=O,,,5,1,1,0,1
9667_0,,,,2,3,2,5
9669_0,,,,2,3,2,5
C(CC(C(CO)C(C=O)O)O)(O)=O,,,5,1,1,0,1
9671_0,,,,2,3,2,5
C(CC(C(CO)CO)O)(O)=O,,,5,1,1,0,1
9673_0,,,,2,3,2,5
C(C(CO)C(C(CO)CO)O)(O)=O,,,5,1,2,0,2
9675_0,,,,2,3,2,5
C(C(CO)C(C(C=C)CO)O)(O)=O,,,5,1,2,0,2
9676_0,,,,2,3,2,5
9677_0,,,,2,3,2,5
9679_0,,,,2,3,2,5
C(CO)(C(CC(CCO)O)O)=O,,,5,1,1,0,1
9680_0,,,,2,3,2,5
9681_0,,,,2,3,2,5
9682_0,,,,2,3,2,5
9684_0,,,,2,3,2,5
C(C(C(CO)C(C(CO)=O)O)O)=O,,,5,1,1,0,1
9686_0,,,,2,3,2,5
C(CO)(C(C(CO)CO)O)=O,,,5,1,1,0,1
9687_0,,,,2,3,2,5
9688_0,,,,2,3,2,5
9689_0,,,,2,3,2,5
9690_0,,,,2,3,2,5
9691_0,,,,2,3,2,5
9693_0,,,,2,3,2,5
C(C(CO)(CC(CCO)O)O)=O,,,5,1,1,0,1
9694_0,,,,2,3,2,5
9695_0,,,,2,3,2,5
9697_0,,,,2,3,2,5
C(C(CO)(C(CO)C(C=O)O)O)=O,,,5,1,1,0,1
9698_0,,,,2,3,2,5
9700_0,,,,2,3,2,5
C(C(CO)(C(CO)CO)O)=O,,,5,1,1,0,1
9701_0,,,,2,3,2,5
9703_0,,,,2,3,2,5
C(C(C(CO)CO)O)(C(CO)O)=O,,,5,1,1,0,1
9705_0,,,,2,3,2,5
C(C(C(C=C)CO)O)(C(CO)O)=O,,,5,1,1,0,1
9707_0,,,,2,3,2,5
C(C(C(CO)O)(C(CO)CO)O)=O,,,5,1,1,0,1
9708_0,,,,2,3,2,5
9710_0,,,,2,3,2,5
C(C(C(CO)O)(C(C=C)CO)O)=O,,,5,1,1,0,1
9711_0,,,,2,3,2,5
9713_0,,,,2,3,2,5
C(C(C(CO)O)(CCO)O)=O,,,5,1,1,0,1
9714_0,,,,2,3,2,5
9716_0,,,,2,3,2,5
C(C(CCO)(C(C(C)O)O)O)=O,,,5,1,1,0,1
9717_0,,,,2,3,2,5
9719_0,,,,2,3,2,5
C(C(CCO)(C(C(O)=O)O)O)=O,,,5,1,1,0,1
9720_0,,,,2,3,2,5
9722_0,,,,2,3,2,5
C(C(CO)C(CCO)O)O,,,5,1,1,0,1
9723_0,,,,2,3,2,5
9724_0,,,,2,3,2,5
9726_0,,,,2,3,2,5
C=CC(CO)C(CCO)O,,,5,1,1,0,1
9728_0,,,,2,3,2,5
C=C(C(O)=O)C(CO)C(CCO)O,,,5,1,1,0,1
9730_0,,,,2,3,2,5
C(CC(CCO)O)O,,,5,1,1,0,1
9731_0,,,,2,3,2,5
9732_0,,,,2,3,2,5
9733_0,,,,2,3,2,5
9735_0,,,,2,3,2,5
C(C(CCO)(C(CO)CO)O)(O)=O,,,5,1,1,0,1
9736_0,,,,2,3,2,5
9738_0,,,,2,3,2,5
C(C)(C(C(CO)CO)(CC=O)O)=O,,,5,1,1,0,1
9739_0,,,,2,3,2,5
9741_0,,,,2,3,2,5
C(CC(C(C)(C(CO)CO)O)=O)=O,,,5,1,1,0,1
9743_0,,,,2,3,2,5
C(C(C)=O)(CC(C(CO)CO)O)=O,,,5,1,1,0,1
9744_0,,,,2,3,2,5
9746_0,,,,2,3,2,5
C(C(C(CO)CO)O)=O,,,5,1,1,0,1
9747_0,,,,2,3,2,5
9748_0,,,,2,3,2,5
9750_0,,,,2,3,2,5
C(C(CO)(C(CO)CO)O)O,,,5,1,1,0,1
9752_0,,,,2,3,2,5
C(C(CO)(C(CO)CO)O)(O)=O,,,5,1,1,0,1
9754_0,,,,2,3,2,5
C(C(C)(C(C(CO)CO)O)O)(O)=O,,,5,1,2,0,2
9756_0,,,,2,3,2,5
C(C(C(C(CO)CO)O)O)(O)=O,,,5,1,2,0,2
9758_0,,,,2,3,2,5
C(C(C(CO)CO)O)=CC,,,5,1,1,0,1
9760_0,,,,2,3,2,5
C=CCC(C(CO)CO)O,,,5,1,1,0,1
9762_0,,,,2,3,2,5
C(C(C=CC)(C(CO)CO)O)(O)=O,,,5,1,1,0,1
9764_0,,,,2,3,2,5
C(C(C(CO)CO)(CC=C)O)(O)=O,,,5,1,1,0,1
9766_0,,,,2,3,2,5
C=C(C(O)=O)CC(C(CO)CO)O,,,5,1,1,0,1
9768_0,,,,2,3,2,5
C(C(C(CO)CO)O)=C(C(O)=O)C,,,5,1,1,0,1
9770_0,,,,2,3,2,5
C1(C(CC(C)O1)(C(CO)CO)O)=O,,,5,1,1,0,1
9772_0,,,,2,3,2,5
C1(C(C(CO)CO)(CC(O1)=O)O)=O,,,5,1,1,0,1
9774_0,,,,2,3,2,5
C(C(CO)CO)O,,,5,1,1,0,1
9776_0,,,,2,3,2,5
C(C(CCO)(C(C=C)CO)O)(O)=O,,,5,1,1,0,1
9778_0,,,,2,3,2,5
C(C(CCO)(CCO)O)(O)=O,,,5,1,1,0,1
9779_0,,,,2,3,2,5
9781_0,,,,2,3,2,5
C(CC(C(C)=O)(C(C=C)CO)O)=O,,,5,1,1,0,1
9782_0,,,,2,3,2,5
9783_0,,,,2,3,2,5
9785_0,,,,2,3,2,5
C(CC(C(C)(C(C=C)CO)O)=O)=O,,,5,1,1,0,1
9786_0,,,,2,3,2,5
9788_0,,,,2,3,2,5
C(CC(C(C)(CCO)O)=O)=O,,,5,1,1,0,1
9789_0,,,,2,3,2,5
9791_0,,,,2,3,2,5
C(C(CO)C(CC(C(C)=O)=O)O)=C,,,5,1,1,0,1
9792_0,,,,2,3,2,5
9793_0,,,,2,3,2,5
9794_0,,,,2,3,2,5
9795_0,,,,2,3,2,5
9796_0,,,,2,3,2,5
9797_0,,,,2,3,2,5
9798_0,,,,2,3,2,5
9799_0,,,,2,3,2,5
9800_0,,,,2,3,2,5
9801_0,,,,2,3,2,5
9802_0,,,,2,3,2,5
9803_0,,,,2,3,2,5
9804_0,,,,2,3,2,5
9805_0,,,,2,3,2,5
9806_0,,,,2,3,2,5
9808_0,,,,2,3,2,5
C(C(C)O)(C(CO)(CCO)O)=O,,,5,1,1,0,1
9810_0,,,,2,3,2,5
C(CO)(C(C(C)O)(CCO)O)=O,,,5,1,2,0,2
9811_0,,,,2,3,2,5
9813_0,,,,2,3,2,5
C(C(C(CO)(CCO)O)=O)(O)=O,,,5,1,1,0,1
9815_0,,,,2,3,2,5
C(C(C(CO)=O)(CCO)O)(O)=O,,,5,1,2,0,2
9816_0,,,,2,3,2,5
9817_0,,,,2,3,2,5
9818_0,,,,2,3,2,5
9819_0,,,,2,3,2,5
9821_0,,,,2,3,2,5
C(C(C(C=C)CO)O)=O,,,5,1,1,0,1
9822_0,,,,2,3,2,5
9823_0,,,,2,3,2,5
9825_0,,,,2,3,2,5
C(C(C(C(C(O)=O)=C)CO)O)=O,,,5,1,1,0,1
9826_0,,,,2,3,2,5
9827_0,,,,2,3,2,5
9828_0,,,,2,3,2,5
9829_0,,,,2,3,2,5
9830_0,,,,2,3,2,5
9831_0,,,,2,3,2,5
9832_0,,,,2,3,2,5
9833_0,,,,2,3,2,5
9834_0,,,,2,3,2,5
9835_0,,,,2,3,2,5
9837_0,,,,2,3,2,5
C(C(C)(C(CO)C(C=O)O)O)(O)=O,,,5,1,1,0,1
9838_0,,,,2,3,2,5
9839_0,,,,2,3,2,5
9840_0,,,,2,3,2,5
9841_0,,,,2,3,2,5
9842_0,,,,2,3,2,5
9843_0,,,,2,3,2,5
9844_0,,,,2,3,2,5
9845_0,,,,2,3,2,5
9846_0,,,,2,3,2,5
9847_0,,,,2,3,2,5
9848_0,,,,2,3,2,5
9849_0,,,,2,3,2,5
9850_0,,,,2,3,2,5
9851_0,,,,2,3,2,5
9852_0,,,,2,3,2,5
9853_0,,,,2,3,2,5
9854_0,,,,2,3,2,5
9855_0,,,,2,3,2,5
9857_0,,,,2,3,2,5
C=CC(CO)C(CO)(CO)O,,,5,1,1,0,1
9859_0,,,,2,3,2,5
C(C(CO)(CCO)O)O,,,5,1,2,0,2
9861_0,,,,2,3,2,5
CC(C(CO)C(CO)(CO)O)O,,,5,1,2,0,2
9862_0,,,,2,3,2,5
9863_0,,,,2,3,2,5
9864_0,,,,2,3,2,5
9866_0,,,,2,3,2,5
C(C(CO)(C(C=C)CO)O)(O)=O,,,5,1,1,0,1
9867_0,,,,2,3,2,5
9869_0,,,,2,3,2,5
C(C(CO)(C(CO)C(C)O)O)(O)=O,,,5,1,2,0,2
9870_0,,,,2,3,2,5
9871_0,,,,2,3,2,5
9872_0,,,,2,3,2,5
9874_0,,,,2,3,2,5
C(C(C(C(C=C)CO)O)(C)O)(O)=O,,,5,1,2,0,2
9875_0,,,,2,3,2,5
9877_0,,,,2,3,2,5
C(C(C(C(C=C)CO)O)O)(O)=O,,,5,1,3,0,3
9878_0,,,,2,3,2,5
9879_0,,,,2,3,2,5
9880_0,,,,2,3,2,5
9881_0,,,,2,3,2,5
9883_0,,,,2,3,2,5
C(C(CO)C(C)(CCO)O)(O)=O,,,5,1,2,0,2
9885_0,,,,2,3,2,5
C(C)=CC(C(C=C)CO)O,,,5,1,1,0,1
9887_0,,,,2,3,2,5
C(C)=CC(C(C(C(O)=O)=C)CO)O,,,5,1,1,0,1
9889_0,,,,2,3,2,5
C(C(CCO)O)=CC,,,5,1,2,0,2
9891_0,,,,2,3,2,5
C(C(C(CO)C(C)O)O)=CC,,,5,1,2,0,2
9892_0,,,,2,3,2,5
9893_0,,,,2,3,2,5
9895_0,,,,2,3,2,5
C(C(CO)C(CC=C)O)=C,,,5,1,1,0,1
9897_0,,,,2,3,2,5
C=CCC(C(C(C(O)=O)=C)CO)O,,,5,1,1,0,1
9899_0,,,,2,3,2,5
C=CCC(CCO)O,,,5,1,2,0,2
9901_0,,,,2,3,2,5
C=CCC(C(CO)C(C)O)O,,,5,1,2,0,2
9902_0,,,,2,3,2,5
9903_0,,,,2,3,2,5
9905_0,,,,2,3,2,5
C(C(C=CC)(C(C=C)CO)O)(O)=O,,,5,1,1,0,1
9907_0,,,,2,3,2,5
C(C(CC=C)(C(C=C)CO)O)(O)=O,,,5,1,1,0,1
9909_0,,,,2,3,2,5
C(C(CO)C(CC(C(O)=O)=C)O)=C,,,5,1,1,0,1
9911_0,,,,2,3,2,5
C(C(CO)C(C=C(C(O)=O)C)O)=C,,,5,1,1,0,1
9913_0,,,,2,3,2,5
C1(C(CC(C)O1)(C(C=C)CO)O)=O,,,5,1,1,0,1
9915_0,,,,2,3,2,5
C1(CC(C(O1)=O)(C(C=C)CO)O)=O,,,5,1,1,0,1
9917_0,,,,2,3,2,5
C=CC(CO)C(C)O,,,5,1,2,0,2
9919_0,,,,2,3,2,5
C(C(C=C)CO)(O)=O,,,5,1,3,0,3
9921_0,,,,2,3,2,5
C=CC(CO)C(CC(C)O)O,,,5,1,2,0,2
9923_0,,,,2,3,2,5
C(CC(C(C=C)CO)O)(O)=O,,,5,1,2,0,2
9925_0,,,,2,3,2,5
C(C(C(C=C)CO)O)(CO)=O,,,5,1,2,0,2
9926_0,,,,2,3,2,5
9928_0,,,,2,3,2,5
C(C(CO)(C(C=C)CO)O)=O,,,5,1,2,0,2
9930_0,,,,2,3,2,5
C=CC(CO)CO,,,5,1,2,0,2
9932_0,,,,2,3,2,5
C(C(C)(C(C=C)CO)O)(O)=O,,,5,1,2,0,2
9934_0,,,,2,3,2,5
C(C(C=CC)(CCO)O)(O)=O,,,5,1,2,0,2
9936_0,,,,2,3,2,5
C(C(CCO)(CC=C)O)(O)=O,,,5,1,2,0,2
9938_0,,,,2,3,2,5
C=C(C(O)=O)CC(CCO)O,,,5,1,2,0,2
9940_0,,,,2,3,2,5
C=C(C(O)=O)C(CO)C(C)O,,,5,1,2,0,2
9942_0,,,,2,3,2,5
C(C(C(C(O)=O)=C)CO)(O)=O,,,5,1,3,0,3
9944_0,,,,2,3,2,5
C=C(C(O)=O)C(CO)CO,,,5,1,2,0,2
9946_0,,,,2,3,2,5
C(C(CCO)O)=C(C(O)=O)C,,,5,1,2,0,2
9948_0,,,,2,3,2,5
C1(C(C=C(C(O1)=O)C)(CCO)O)=O,,,5,1,1,0,1
9950_0,,,,2,3,2,5
C1(C(CCO)(CC(C(O1)=O)=C)O)=O,,,5,1,1,0,1
9952_0,,,,2,3,2,5
C1(C(CCO)(CC(C)O1)O)=O,,,5,1,2,0,2
9954_0,,,,2,3,2,5
C1(C(CCO)(CC(O1)=O)O)=O,,,5,1,2,0,2
9955_0,,,,2,3,2,5
9956_0,,,,2,3,2,5
9957_0,,,,2,3,2,5
9958_0,,,,2,3,2,5
9960_0,,,,2,3,2,5
C(CO)(C(CC(C)O)O)=O,,,5,1,1,0,1
9961_0,,,,2,3,2,5
9962_0,,,,2,3,2,5
9964_0,,,,2,3,2,5
C(C(C(CO)=O)(CO)O)=O,,,5,1,3,0,3
9965_0,,,,2,3,2,5
9966_0,,,,2,3,2,5
9967_0,,,,2,3,2,5
9968_0,,,,2,3,2,5
9969_0,,,,2,3,2,5
9970_0,,,,2,3,2,5
9971_0,,,,2,3,2,5
9973_0,,,,2,3,2,5
C(C(C(C(CO)=O)=O)C)(O)=O,,,5,1,2,0,2
9975_0,,,,2,3,2,5
C(CO)(C(C(C(O)=O)=C)O)=O,,,5,1,3,0,3
9977_0,,,,2,3,2,5
CC(CC(CO)O)O,,,5,1,1,0,1
9979_0,,,,2,3,2,5
C(CC(CO)O)(O)=O,,,5,1,3,0,3
9980_0,,,,2,3,2,5
9981_0,,,,2,3,2,5
9982_0,,,,2,3,2,5
9983_0,,,,2,3,2,5
9985_0,,,,2,3,2,5
CC(CO)O,,,5,1,2,0,2
9986_0,,,,2,3,2,5
9988_0,,,,2,3,2,5
C(C(CO)(C(CO)O)O)(O)=O,,,5,1,7,0,7
9989_0,,,,2,3,2,5
9990_0,,,,2,3,2,5
9991_0,,,,2,3,2,5
9992_0,,,,2,3,2,5
9993_0,,,,2,3,2,5
9994_0,,,,2,3,2,5
9995_0,,,,2,3,2,5
9996_0,,,,2,3,2,5
9997_0,,,,2,3,2,5
9998_0,,,,2,3,2,5
9999_0,,,,2,3,2,5
10000_0,,,,2,3,2,5
10001_0,,,,2,3,2,5
10003_0,,,,2,3,2,5
C(C(CO)(C(C(CO)O)O)O)(O)=O,,,5,1,3,0,3
10005_0,,,,2,3,2,5
C(C(C(C(CO)O)O)O)(O)=O,,,5,1,3,0,3
10006_0,,,,2,3,2,5
10007_0,,,,2,3,2,5
10008_0,,,,2,3,2,5
10009_0,,,,2,3,2,5
10010_0,,,,2,3,2,5
10012_0,,,,2,3,2,5
C(CC(CO)(CO)O)(O)=O,,,5,1,5,0,5
10014_0,,,,2,3,2,5
CC(C(CO)(CO)C(CCO)O)O,,,5,1,1,0,1
10016_0,,,,2,3,2,5
C(C(CO)(C(CO)O)C(C)O)=O,,,5,1,2,0,2
10018_0,,,,2,3,2,5
C(C(C(CO)(CO)C(C)O)O)=O,,,5,1,1,0,1
10020_0,,,,2,3,2,5
C(C(C(CO)(CO)C(C)O)O)=CC,,,5,1,1,0,1
10022_0,,,,2,3,2,5
C=CCC(C(CO)(CO)C(C)O)O,,,5,1,1,0,1
10024_0,,,,2,3,2,5
CC(C(CO)(CO)C(C)O)O,,,5,1,1,0,1
10026_0,,,,2,3,2,5
C(C(CO)(CO)C(C)O)(O)=O,,,5,1,4,0,4
10028_0,,,,2,3,2,5
CC(C(CO)(CO)CO)O,,,5,1,1,0,1
10030_0,,,,2,3,2,5
C(C(C(CO)O)(C(C)O)C(C)O)=O,,,5,1,2,0,2
10032_0,,,,2,3,2,5
C(C(C(CO)(C(C)O)C(C)O)O)=O,,,5,1,1,0,1
10034_0,,,,2,3,2,5
CC(C(CO)(C(C)O)C(C)O)O,,,5,1,1,0,1
10036_0,,,,2,3,2,5
C(C(CO)(C(C)O)C(C)O)(O)=O,,,5,1,4,0,4
10038_0,,,,2,3,2,5
C(C(C=O)(C(CO)O)C(C)O)(O)=O,,,5,1,2,0,2
10040_0,,,,2,3,2,5
C(C(CO)(C(C)O)C(C=O)O)(O)=O,,,5,1,5,0,5
10042_0,,,,2,3,2,5
C(C(C(O)=O)(CO)C(C)O)(O)=O,,,5,1,5,0,5
10044_0,,,,2,3,2,5
C(C(C(CC=O)O)C(CO)O)(O)=O,,,5,1,2,0,2
10046_0,,,,2,3,2,5
C(C(C(CCO)O)C(C=O)O)(O)=O,,,5,1,3,0,3
10048_0,,,,2,3,2,5
C(C(CO)(CO)C(CCO)O)(O)=O,,,5,1,3,0,3
10050_0,,,,2,3,2,5
C(C(C=O)(CO)C(CO)O)(O)=O,,,5,1,2,0,2
10052_0,,,,2,3,2,5
C(C(CO)(CO)C(C=O)O)(O)=O,,,5,1,3,0,3
10054_0,,,,2,3,2,5
C(C(CO)(CO)C(C=CC)O)(O)=O,,,5,1,3,0,3
10056_0,,,,2,3,2,5
C(C(CO)(CO)C(CC=C)O)(O)=O,,,5,1,3,0,3
10058_0,,,,2,3,2,5
C(C(C(O)=O)(CO)CO)(O)=O,,,5,1,4,0,4
10060_0,,,,2,3,2,5
C(C(CO)(CO)CO)(O)=O,,,5,1,2,0,2
10062_0,,,,2,3,2,5
C(C(C(O)=O)(C=O)C(CO)O)(O)=O,,,5,1,2,0,2
10064_0,,,,2,3,2,5
C(C(C(O)=O)(CO)C(C=O)O)(O)=O,,,5,1,5,0,5
10066_0,,,,2,3,2,5
C(C(C(O)=O)(C(O)=O)CO)(O)=O,,,5,1,4,0,4
10068_0,,,,2,3,2,5
C(C(C)(C(CO)(CO)CO)O)(O)=O,,,5,1,1,0,1
10070_0,,,,2,3,2,5
C(CO)(C(CO)(C(CCO)O)O)=O,,,5,1,5,0,5
10072_0,,,,2,3,2,5
C(C(C(CO)(C(CO)O)O)=O)=O,,,5,1,3,0,3
10073_0,,,,2,3,2,5
10075_0,,,,2,3,2,5
C(CO)(C(CO)(C(C=CC)O)O)=O,,,5,1,5,0,5
10077_0,,,,2,3,2,5
C(CO)(C(CO)(C(CC=C)O)O)=O,,,5,1,5,0,5
10079_0,,,,2,3,2,5
C(CO)(C(CO)(C(C)O)O)=O,,,5,1,5,0,5
10080_0,,,,2,3,2,5
10082_0,,,,2,3,2,5
C(CO)(C(CO)(CO)O)=O,,,5,1,3,0,3
10084_0,,,,2,3,2,5
C(C(C(C(CO)O)(C(C)O)O)=O)=O,,,5,1,3,0,3
10085_0,,,,2,3,2,5
10087_0,,,,2,3,2,5
C(CO)(C(C(C)O)(C(C)O)O)=O,,,5,1,3,0,3
10088_0,,,,2,3,2,5
10090_0,,,,2,3,2,5
C(C(C(C=O)=O)(C(CO)O)O)(O)=O,,,5,1,3,0,3
10091_0,,,,2,3,2,5
10092_0,,,,2,3,2,5
10094_0,,,,2,3,2,5
C(C(CO)(C(CCO)O)O)=O,,,5,1,3,0,3
10095_0,,,,2,3,2,5
10096_0,,,,2,3,2,5
10098_0,,,,2,3,2,5
C(C(C=O)(C(CO)O)O)=O,,,5,1,3,0,3
10099_0,,,,2,3,2,5
10101_0,,,,2,3,2,5
C(C(C(CO)O)C(C)O)(O)=O,,,5,1,2,0,2
10103_0,,,,2,3,2,5
C(C(C(O)=O)C(CO)O)(O)=O,,,5,1,2,0,2
10104_0,,,,2,3,2,5
10105_0,,,,2,3,2,5
10106_0,,,,2,3,2,5
10108_0,,,,2,3,2,5
C(C(C=O)(C(CO)O)O)(O)=O,,,5,1,3,0,3
10110_0,,,,2,3,2,5
C(C(C(C)=O)(CO)C(CO)O)(O)=O,,,5,1,2,0,2
10112_0,,,,2,3,2,5
C(C(C=O)(C(C(CO)O)O)O)=O,,,5,1,3,0,3
10113_0,,,,2,3,2,5
10115_0,,,,2,3,2,5
C(C(CO)(C(CO)(CO)O)O)=O,,,5,1,4,0,4
10116_0,,,,2,3,2,5
10117_0,,,,2,3,2,5
10119_0,,,,2,3,2,5
C(C(CO)(C(C=CC)O)O)=O,,,5,1,3,0,3
10121_0,,,,2,3,2,5
C(C(CO)(C(CC=C)O)O)=O,,,5,1,3,0,3
10123_0,,,,2,3,2,5
C(C(CO)(C(C)O)O)=O,,,5,1,3,0,3
10124_0,,,,2,3,2,5
10126_0,,,,2,3,2,5
C(C(CO)(C(CC(C)O)O)O)=O,,,5,1,3,0,3
10128_0,,,,2,3,2,5
C(C(CO)(C(CC(O)=O)O)O)=O,,,5,1,3,0,3
10129_0,,,,2,3,2,5
10130_0,,,,2,3,2,5
10132_0,,,,2,3,2,5
C(C(CO)(C(C=O)(CO)O)O)=O,,,5,1,3,0,3
10133_0,,,,2,3,2,5
10135_0,,,,2,3,2,5
C(C(CO)C(C(CO)O)O)(O)=O,,,5,1,5,0,5
10137_0,,,,2,3,2,5
C(C(C(C)O)C(C(CO)O)O)(O)=O,,,5,1,4,0,4
10139_0,,,,2,3,2,5
C(C(C(O)=O)C(C(CO)O)O)(O)=O,,,5,1,4,0,4
10140_0,,,,2,3,2,5
10142_0,,,,2,3,2,5
C(C(C=O)(C(C(CO)O)O)O)(O)=O,,,5,1,4,0,4
10143_0,,,,2,3,2,5
10144_0,,,,2,3,2,5
10145_0,,,,2,3,2,5
10146_0,,,,2,3,2,5
10147_0,,,,2,3,2,5
10148_0,,,,2,3,2,5
10149_0,,,,2,3,2,5
10150_0,,,,2,3,2,5
10151_0,,,,2,3,2,5
10152_0,,,,2,3,2,5
10153_0,,,,2,3,2,5
10154_0,,,,2,3,2,5
10156_0,,,,2,3,2,5
C(CO)(C(C(CO)O)(CC=O)O)=O,,,5,1,2,0,2
10158_0,,,,2,3,2,5
C(CO)(C(CCO)(C(C=O)O)O)=O,,,5,1,2,0,2
10160_0,,,,2,3,2,5
C(CO)(C(CO)(CCO)O)=O,,,5,1,2,0,2
10162_0,,,,2,3,2,5
C(C(C(CO)(C(CO)O)O)O)(O)=O,,,5,1,2,0,2
10164_0,,,,2,3,2,5
C(C)(C(CCO)(C(C(O)=O)O)O)=O,,,5,1,2,0,2
10166_0,,,,2,3,2,5
C(C(C)(C(C(O)=O)O)O)(CCO)=O,,,5,1,2,0,2
10168_0,,,,2,3,2,5
C(C(CO)=O)(C(C)(C(CO)O)O)=O,,,5,1,2,0,2
10169_0,,,,2,3,2,5
10171_0,,,,2,3,2,5
C(C(C)(C(C(CO)O)O)O)(O)=O,,,5,1,3,0,3
10172_0,,,,2,3,2,5
10174_0,,,,2,3,2,5
C=C(C(O)=O)CO,,,5,1,4,0,4
10176_0,,,,2,3,2,5
C(C(CO)(C)OC(CO)=O)(O)=O,,,5,1,1,0,1
10178_0,,,,2,3,2,5
C(C(CO)O)(OC(C(O)=O)C)=O,,,5,1,1,0,1
10180_0,,,,2,3,2,5
C(C(CO)(C)O)(OC(CO)=O)=O,,,5,1,1,0,1
10182_0,,,,2,3,2,5
C(C(CO)O)(OC(C(C)O)=O)=O,,,5,1,1,0,1
10184_0,,,,2,3,2,5
C(C(CO)(C)O)(OCC(O)=O)=O,,,5,1,1,0,1
10186_0,,,,2,3,2,5
C(C(C)O)(OC(C(O)=O)CO)=O,,,5,1,1,0,1
10188_0,,,,2,3,2,5
C(C(CO)=O)(CCC(C)O)=O,,,5,1,3,0,3
10190_0,,,,2,3,2,5
C(CC(C)O)(CC(CO)=O)=O,,,5,1,2,0,2
10192_0,,,,2,3,2,5
C(C(C(C)O)C(C=O)CO)=O,,,5,1,3,0,3
10194_0,,,,2,3,2,5
C(C(C=O)C(CO)C(C)O)=O,,,5,1,2,0,2
10196_0,,,,2,3,2,5
C(CCC(C(CO)=O)=O)(O)=O,,,5,1,2,0,2
10198_0,,,,2,3,2,5
C(CC(CC(CO)=O)=O)(O)=O,,,5,1,2,0,2
10200_0,,,,2,3,2,5
C(C(C=O)C(C=O)CO)(O)=O,,,5,1,3,0,3
10202_0,,,,2,3,2,5
C(C(C=O)C(C(O)=O)CO)=O,,,5,1,2,0,2
10204_0,,,,2,3,2,5
C(CO)(CC(C(CO)=O)=O)=O,,,5,1,3,0,3
10205_0,,,,2,3,2,5
10206_0,,,,2,3,2,5
10208_0,,,,2,3,2,5
C(C(C(C(CO)CO)=O)=O)=O,,,5,1,2,0,2
10210_0,,,,2,3,2,5
C(C(C=O)C(C(CO)=O)O)=O,,,5,1,2,0,2
10211_0,,,,2,3,2,5
10213_0,,,,2,3,2,5
C(C(C=O)CCO)=O,,,5,1,2,0,2
10215_0,,,,2,3,2,5
C(C(CO)CC=O)=O,,,5,1,2,0,2
10217_0,,,,2,3,2,5
C(C(CO)CC(C(O)=O)=O)=O,,,5,1,3,0,3
10218_0,,,,2,3,2,5
10219_0,,,,2,3,2,5
10221_0,,,,2,3,2,5
C(C)(CC(CO)=O)=O,,,5,1,2,0,2
10223_0,,,,2,3,2,5
C(C(CO)=O)(CC)=O,,,5,1,2,0,2
10224_0,,,,2,3,2,5
10225_0,,,,2,3,2,5
10226_0,,,,2,3,2,5
10228_0,,,,2,3,2,5
C(CCO)(CC(C(O)=O)=O)=O,,,5,1,2,0,2
10230_0,,,,2,3,2,5
C1(C(CO)C(C(O1)=O)(C)O)=O,,,5,1,3,0,3
10232_0,,,,2,3,2,5
C(C)=C(CO)C(CC(C)O)O,,,5,1,2,0,2
10234_0,,,,2,3,2,5
C(CC(C)O)=C(CO)C(C)O,,,5,1,2,0,2
10236_0,,,,2,3,2,5
C(C(CO)C(C)O)=CC(C)O,,,5,1,2,0,2
10238_0,,,,2,3,2,5
C(CC(C)O)=C(C(O)=O)CO,,,5,1,2,0,2
10240_0,,,,2,3,2,5
C(C(C=CC(C)O)CO)(O)=O,,,5,1,2,0,2
10242_0,,,,2,3,2,5
C(CO)(C(C=CC(C)O)O)=O,,,5,1,2,0,2
10244_0,,,,2,3,2,5
C(CC(C)O)=CCO,,,5,1,2,0,2
10246_0,,,,2,3,2,5
C(CCO)=CC(C)O,,,5,1,2,0,2
10248_0,,,,2,3,2,5
C(C(CO)C(C)O)=CC(O)=O,,,5,1,2,0,2
10250_0,,,,2,3,2,5
C(CC=C(CO)C(C)O)(O)=O,,,5,1,2,0,2
10252_0,,,,2,3,2,5
C(CC(C(CO)=CC)O)(O)=O,,,5,1,2,0,2
10254_0,,,,2,3,2,5
C(CO)(C(C)O)=CC(CO)=O,,,5,1,2,0,2
10256_0,,,,2,3,2,5
C(CO)(C(C(CO)=CC)O)=O,,,5,1,2,0,2
10258_0,,,,2,3,2,5
C(CO)(CO)=C(C=O)C(C)O,,,5,1,2,0,2
10260_0,,,,2,3,2,5
C(CO)(C(C)O)=C(C=O)CO,,,5,1,2,0,2
10262_0,,,,2,3,2,5
C(C)=C(C=O)C(CO)(CO)O,,,5,1,2,0,2
10264_0,,,,2,3,2,5
C(C(C(CO)=CC)(CO)O)=O,,,5,1,2,0,2
10266_0,,,,2,3,2,5
C=C(CO)C(C)O,,,5,1,2,0,2
10268_0,,,,2,3,2,5
C(C)=C(CO)CO,,,5,1,2,0,2
10270_0,,,,2,3,2,5
C(C)=C(CO)C(C)O,,,5,1,2,0,2
10272_0,,,,2,3,2,5
C(C)=C(C(O)=O)CO,,,5,1,4,0,4
10274_0,,,,2,3,2,5
C(CO)(C(C)O)=C(C(O)=O)C,,,5,1,2,0,2
10276_0,,,,2,3,2,5
C(C(C(CO)=CC)(C)O)(O)=O,,,5,1,2,0,2
10278_0,,,,2,3,2,5
C(CO)=C(C(O)=O)CC(C)O,,,5,1,2,0,2
10280_0,,,,2,3,2,5
C(C(C)O)=C(C(O)=O)CCO,,,5,1,2,0,2
10282_0,,,,2,3,2,5
C(CC=C(C(O)=O)CO)(O)=O,,,5,1,2,0,2
10284_0,,,,2,3,2,5
C(C(C=CC(O)=O)CO)(O)=O,,,5,1,2,0,2
10286_0,,,,2,3,2,5
C(CO)(C(C=CC(O)=O)O)=O,,,5,1,2,0,2
10288_0,,,,2,3,2,5
C(CC=CCO)(O)=O,,,5,1,2,0,2
10290_0,,,,2,3,2,5
C(CCO)=CC(O)=O,,,5,1,2,0,2
10292_0,,,,2,3,2,5
C(C(CO)=CC(CO)=O)(O)=O,,,5,1,2,0,2
10294_0,,,,2,3,2,5
C(CO)(CO)=C(C(O)=O)C=O,,,5,1,2,0,2
10296_0,,,,2,3,2,5
C(C(CO)=C(C=O)CO)(O)=O,,,5,1,3,0,3
10298_0,,,,2,3,2,5
C(C(C)=C(C(O)=O)CO)(O)=O,,,5,1,3,0,3
10300_0,,,,2,3,2,5
C(C(C)(CC=CCO)O)(O)=O,,,5,1,2,0,2
10302_0,,,,2,3,2,5
C(C(C=CCCO)(C)O)(O)=O,,,5,1,2,0,2
10304_0,,,,2,3,2,5
C(C(C(CO)=C)(C)O)(O)=O,,,5,1,2,0,2
10306_0,,,,2,3,2,5
C(CO)(CO)=C(C(O)=O)C,,,5,1,2,0,2
10308_0,,,,2,3,2,5
C(CC(C(O)=O)=CCO)(O)=O,,,5,1,2,0,2
10310_0,,,,2,3,2,5
C(C=C(C(O)=O)CCO)(O)=O,,,5,1,2,0,2
10312_0,,,,2,3,2,5
C(CO)=CC(CO)=O,,,5,1,2,0,2
10314_0,,,,2,3,2,5
C(CO)=C(C=O)CO,,,5,1,2,0,2
10316_0,,,,2,3,2,5
C(CO)(CO)=CC=O,,,5,1,2,0,2
10318_0,,,,2,3,2,5
C(CO)(CO)=CC(C(O)=O)=O,,,5,1,2,0,2
10320_0,,,,2,3,2,5
C(CO)(C(C=C)O)=O,,,5,1,3,0,3
10322_0,,,,2,3,2,5
C=CCO,,,5,1,3,0,3
10324_0,,,,2,3,2,5
CC(C(CO)(C(CO)(CO)O)O)O,,,5,1,2,0,2
10326_0,,,,2,3,2,5
C(C(CO)(C(CO)O)O)O,,,5,1,2,0,2
10327_0,,,,2,3,2,5
10329_0,,,,2,3,2,5
CCC(CO)O,,,5,1,2,0,2
10331_0,,,,2,3,2,5
C(CCCO)O,,,5,1,2,0,2
10333_0,,,,2,3,2,5
C(C(CO)CCO)(O)=O,,,5,1,2,0,2
10335_0,,,,2,3,2,5
C(C(C)C(CO)O)(O)=O,,,5,1,2,0,2
10337_0,,,,2,3,2,5
CC1C(CO)C(C(CO)(O)O1)O,,,5,1,2,0,2
10339_0,,,,2,3,2,5
C1C(CO)(C(C(O)O1)C(C)O)O,,,5,1,2,0,2
10341_0,,,,2,3,2,5
CC1C(CO)C(C(O)O1)(CO)O,,,5,1,2,0,2
10343_0,,,,2,3,2,5
C1(C(CO)C(C(CO)(O)O1)O)=O,,,5,1,2,0,2
10345_0,,,,2,3,2,5
C(C1C(O)OCC1(CO)O)(O)=O,,,5,1,2,0,2
10347_0,,,,2,3,2,5
C1(C(CO)C(CO)(C(O)O1)O)=O,,,5,1,2,0,2
10349_0,,,,2,3,2,5
C1(C(O)OC(CO)(CO)C1O)=O,,,5,1,2,0,2
10351_0,,,,2,3,2,5
C(C1(COC(CO)(C1O)O)O)=O,,,5,1,2,0,2
10353_0,,,,2,3,2,5
C(C1(C(C(CO)(CO1)O)O)O)=O,,,5,1,2,0,2
10355_0,,,,2,3,2,5
C1C(CO)(CC(O)O1)O,,,5,1,2,0,2
10357_0,,,,2,3,2,5
C(C1(CC(CO)(CO1)O)O)(O)=O,,,5,1,2,0,2
10359_0,,,,2,3,2,5
C1(C(C)(C(C(CO)(O)O1)O)O)=O,,,5,1,2,0,2
10361_0,,,,2,3,2,5
CC1CC(C(C(CO)(O)O1)O)O,,,5,1,2,0,2
10363_0,,,,2,3,2,5
C1(CC(C(C(CO)(O)O1)O)O)=O,,,5,1,2,0,2
10365_0,,,,2,3,2,5
C1(COC(CO)(C(C1O)O)O)=O,,,5,1,2,0,2
10367_0,,,,2,3,2,5
C1(C(O)OCC(CO)(C1O)O)=O,,,5,1,2,0,2
10369_0,,,,2,3,2,5
C1(C(C)(C(CO)C(C)O1)O)=O,,,5,1,2,0,2
10371_0,,,,2,3,2,5
C1(CC(C(C(CO)=O)O1)O)=O,,,5,1,2,0,2
10373_0,,,,2,3,2,5
C1(C(C=O)C(CO1)(CO)O)=O,,,5,1,2,0,2
10375_0,,,,2,3,2,5
C1(C(CO)C(C=O)(CO1)O)=O,,,5,1,2,0,2
10377_0,,,,2,3,2,5
C1(C(C)(CC(CCO)O1)O)=O,,,5,1,2,0,2
10379_0,,,,2,3,2,5
C1(C(C)(C(CO)CO1)O)=O,,,5,1,2,0,2
10381_0,,,,2,3,2,5
C1(C(CC(CO)(CO)O1)=O)=O,,,5,1,2,0,2
10383_0,,,,2,3,2,5
C1(C(CO)(C(CO)(CO1)O)O)=O,,,5,1,2,0,2
10385_0,,,,2,3,2,5
C1(C(C(CO)(CO1)O)O)=O,,,5,1,2,0,2
10387_0,,,,2,3,2,5
C1(C(CO)C(CC(C)O1)O)=O,,,5,1,2,0,2
10389_0,,,,2,3,2,5
C1(CC(C(CO)C(C)O1)O)=O,,,5,1,2,0,2
10391_0,,,,2,3,2,5
C1(C(CO)C(CC(O1)=O)O)=O,,,5,1,2,0,2
10393_0,,,,2,3,2,5
C1(C(CO)C(C(CO1)=O)O)=O,,,5,1,2,0,2
10395_0,,,,2,3,2,5
C1(C(CC(CO1)(CO)O)=O)=O,,,5,1,2,0,2
10397_0,,,,2,3,2,5
C(C(C(C)O)C(C(C)CCO)O)=O,,,5,1,1,0,1
10399_0,,,,2,3,2,5
C(CC(C)C(C(CO)C(C)O)O)=O,,,5,1,2,0,2
10401_0,,,,2,3,2,5
C(C(CO)(C(C)O)C(C)CCO)=O,,,5,1,1,0,1
10403_0,,,,2,3,2,5
C(CC(C)C(CO)(CO)C(C)O)=O,,,5,1,2,0,2
10404_0,,,,2,3,2,5
10406_0,,,,2,3,2,5
C(CC(C)CC(C(CO)CO)O)=O,,,5,1,2,0,2
10408_0,,,,2,3,2,5
C(C(CO)C(C)(C(C)CCO)O)=O,,,5,1,1,0,1
10410_0,,,,2,3,2,5
C(CC(C)C(C)(C(CO)CO)O)=O,,,5,1,2,0,2
10412_0,,,,2,3,2,5
C(C(C=O)C(C(C)CCO)O)(O)=O,,,5,1,1,0,1
10414_0,,,,2,3,2,5
C(C(CO)C(C(C)CC=O)O)(O)=O,,,5,1,3,0,3
10416_0,,,,2,3,2,5
C(C(C=O)(CO)C(C)CCO)(O)=O,,,5,1,1,0,1
10418_0,,,,2,3,2,5
C(C(CO)(CO)C(C)CC=O)(O)=O,,,5,1,3,0,3
10420_0,,,,2,3,2,5
C(C(C(C(C(C)CCO)O)O)=O)=O,,,5,1,1,0,1
10422_0,,,,2,3,2,5
C(CC(C)C(C(C(CO)=O)O)O)=O,,,5,1,2,0,2
10424_0,,,,2,3,2,5
C(C(C(CO)(C(C)CCO)O)=O)=O,,,5,1,1,0,1
10426_0,,,,2,3,2,5
C(CC(C)C(C(CO)=O)(CO)O)=O,,,5,1,3,0,3
10427_0,,,,2,3,2,5
10429_0,,,,2,3,2,5
C(CC(C)C(CO)CO)=O,,,5,1,2,0,2
10431_0,,,,2,3,2,5
C(C(CC(C)C(CO)CO)=O)(O)=O,,,5,1,2,0,2
10433_0,,,,2,3,2,5
C(C(CC(C=O)CO)CCO)(O)=O,,,5,1,2,0,2
10435_0,,,,2,3,2,5
C(C(CC(CO)CO)CC=O)(O)=O,,,5,1,2,0,2
10436_0,,,,2,3,2,5
10438_0,,,,2,3,2,5
C(C(C)(C(CO)CO)CC=O)(O)=O,,,5,1,2,0,2
10440_0,,,,2,3,2,5
C(C(C)C(CO)C(C=O)CO)(O)=O,,,5,1,2,0,2
10442_0,,,,2,3,2,5
C(C(C)C(C=O)C(CO)CO)(O)=O,,,5,1,2,0,2
10444_0,,,,2,3,2,5
C(CC(C(C)CCO)O)=O,,,5,1,1,0,1
10446_0,,,,2,3,2,5
C(CC(C)C(CCO)O)=O,,,5,1,2,0,2
10448_0,,,,2,3,2,5
C(C(CC(C)C(CCO)O)=O)(O)=O,,,5,1,2,0,2
10449_0,,,,2,3,2,5
10451_0,,,,2,3,2,5
C(C(CC(CCO)O)CC=O)(O)=O,,,5,1,2,0,2
10453_0,,,,2,3,2,5
C(C(C)(C(CC=O)O)CCO)(O)=O,,,5,1,1,0,1
10455_0,,,,2,3,2,5
C(C(C)(C(CCO)O)CC=O)(O)=O,,,5,1,2,0,2
10456_0,,,,2,3,2,5
10458_0,,,,2,3,2,5
C(C(C)C(C=O)C(CCO)O)(O)=O,,,5,1,2,0,2
10459_0,,,,2,3,2,5
10461_0,,,,2,3,2,5
C(C(CC(C(C)CCO)O)=O)(O)=O,,,5,1,1,0,1
10463_0,,,,2,3,2,5
C(CC(C(CC(C)CCO)=O)=O)=O,,,5,1,1,0,1
10465_0,,,,2,3,2,5
C(CC(C)CC(C(CCO)=O)=O)=O,,,5,1,2,0,2
10467_0,,,,2,3,2,5
C(C(C(C(C)=O)=O)C(C)CCO)=O,,,5,1,1,0,1
10469_0,,,,2,3,2,5
C(CC(C)C(C(C(C)=O)=O)CO)=O,,,5,1,2,0,2
10471_0,,,,2,3,2,5
C(C(C=O)(C(C)CCO)O)=O,,,5,1,1,0,1
10473_0,,,,2,3,2,5
C(C(CO)(C(C)CC=O)O)=O,,,5,1,2,0,2
10475_0,,,,2,3,2,5
CC(CCO)C(CO)C(C)O,,,5,1,1,0,1
10477_0,,,,2,3,2,5
CC(CC(C(C)CCO)O)O,,,5,1,1,0,1
10479_0,,,,2,3,2,5
CC(CC(CCO)O)CCO,,,5,1,1,0,1
10481_0,,,,2,3,2,5
CC(CCO)(C(C)CCO)O,,,5,1,1,0,1
10483_0,,,,2,3,2,5
C(C(CO)C(C)CCO)(O)=O,,,5,1,1,0,1
10485_0,,,,2,3,2,5
C(CC(C(C)CCO)O)(O)=O,,,5,1,1,0,1
10487_0,,,,2,3,2,5
C(CO)(C(C(C)CCO)O)=O,,,5,1,1,0,1
10489_0,,,,2,3,2,5
CC(CO)CCO,,,5,1,1,0,1
10491_0,,,,2,3,2,5
C(C(CCO)CCO)(O)=O,,,5,1,2,0,2
10493_0,,,,2,3,2,5
C(C(C)(CO)CCO)(O)=O,,,5,1,1,0,1
10495_0,,,,2,3,2,5
C(C(C)C(CO)CO)(O)=O,,,5,1,2,0,2
10497_0,,,,2,3,2,5
CC(CCO)CCO,,,5,1,1,0,1
10499_0,,,,2,3,2,5
C(C(CCO)CCCO)(O)=O,,,5,1,2,0,2
10501_0,,,,2,3,2,5
C(C(C)(CCO)CCO)(O)=O,,,5,1,1,0,1
10503_0,,,,2,3,2,5
C(C(C)C(CO)CCO)(O)=O,,,5,1,2,0,2
10505_0,,,,2,3,2,5
CC(C(C)CCO)O,,,5,1,1,0,1
10507_0,,,,2,3,2,5
C(C(CCO)CC(C)O)(O)=O,,,5,1,2,0,2
10509_0,,,,2,3,2,5
C(C(C)(CCO)C(C)O)(O)=O,,,5,1,1,0,1
10511_0,,,,2,3,2,5
C(C(C)C(CO)C(C)O)(O)=O,,,5,1,2,0,2
10513_0,,,,2,3,2,5
C(C(C(C)O)C(C)CCO)(O)=O,,,5,1,1,0,1
10515_0,,,,2,3,2,5
C(CC(CC(C)CCO)O)(O)=O,,,5,1,1,0,1
10517_0,,,,2,3,2,5
C(CC(C)(C(C)CCO)O)(O)=O,,,5,1,1,0,1
10519_0,,,,2,3,2,5
C(C(C(O)=O)C(C)CCO)(O)=O,,,5,1,1,0,1
10521_0,,,,2,3,2,5
C(C(C(C(C)CCO)O)=O)(O)=O,,,5,1,1,0,1
10523_0,,,,2,3,2,5
C(CC(C)CCO)(O)=O,,,5,1,3,0,3
10525_0,,,,2,3,2,5
C(C(CCC(O)=O)CCO)(O)=O,,,5,1,2,0,2
10527_0,,,,2,3,2,5
C(C(C)(CCO)CC(O)=O)(O)=O,,,5,1,3,0,3
10529_0,,,,2,3,2,5
C(C(C)C(CO)CC(O)=O)(O)=O,,,5,1,2,0,2
10531_0,,,,2,3,2,5
C(C(C(CC(C)CCO)O)O)(O)=O,,,5,1,2,0,2
10533_0,,,,2,3,2,5
C(C(C(C)(C(C)CCO)O)O)(O)=O,,,5,1,1,0,1
10535_0,,,,2,3,2,5
C(C(C(C)O)(C(C)CCO)O)(O)=O,,,5,1,1,0,1
10537_0,,,,2,3,2,5
C(C(C(O)=O)(C(C)CCO)O)(O)=O,,,5,1,1,0,1
10539_0,,,,2,3,2,5
C(C(CC(C)CCO)O)(O)=O,,,5,1,1,0,1
10541_0,,,,2,3,2,5
C(C(C)(C(C)CCO)O)(O)=O,,,5,1,1,0,1
10543_0,,,,2,3,2,5
C(C(C=O)(CC(C)CCO)O)(O)=O,,,5,1,1,0,1
10545_0,,,,2,3,2,5
C(C(CO)(CC(C)CC=O)O)(O)=O,,,5,1,3,0,3
10547_0,,,,2,3,2,5
C(C(C=O)(C(C)CCO)O)(O)=O,,,5,1,1,0,1
10548_0,,,,2,3,2,5
10550_0,,,,2,3,2,5
C(CC(C)CCO)=CC=O,,,5,1,1,0,1
10552_0,,,,2,3,2,5
C(CC(C)CC=CCO)=O,,,5,1,3,0,3
10554_0,,,,2,3,2,5
C(CC(C)CC(C(O)=O)=O)=CCO,,,5,1,2,0,2
10556_0,,,,2,3,2,5
C(C(CCC=CC=O)CCO)(O)=O,,,5,1,2,0,2
10558_0,,,,2,3,2,5
C(C(CCC=CCO)CC=O)(O)=O,,,5,1,2,0,2
10560_0,,,,2,3,2,5
C(C(C)(CCO)CC=CC=O)(O)=O,,,5,1,1,0,1
10562_0,,,,2,3,2,5
C(C(C)(CC=O)CC=CCO)(O)=O,,,5,1,2,0,2
10564_0,,,,2,3,2,5
C(C(C)C(CO)CC=CC=O)(O)=O,,,5,1,2,0,2
10566_0,,,,2,3,2,5
C(C(C)C(C=O)CC=CCO)(O)=O,,,5,1,2,0,2
10568_0,,,,2,3,2,5
C(CC(C)C(C=C)CO)=O,,,5,1,3,0,3
10570_0,,,,2,3,2,5
C(C(C=C)C(C)CCO)=O,,,5,1,1,0,1
10572_0,,,,2,3,2,5
C(CC(C)CCO)=CC(C(O)=O)=O,,,5,1,1,0,1
10574_0,,,,2,3,2,5
C=CC(C(C(O)=O)=O)C(C)CCO,,,5,1,1,0,1
10576_0,,,,2,3,2,5
C(CC(C)C(C(C(O)=O)=C)CO)=O,,,5,1,2,0,2
10578_0,,,,2,3,2,5
C(C(C(C(O)=O)=C)C(C)CCO)=O,,,5,1,1,0,1
10580_0,,,,2,3,2,5
C(CC(C)CC(C(O)=O)=CCO)=O,,,5,1,2,0,2
10582_0,,,,2,3,2,5
C(C(CC(C)CCO)=CC=O)(O)=O,,,5,1,1,0,1
10584_0,,,,2,3,2,5
CC(C(CO)(C(C)CCO)O)O,,,5,1,1,0,1
10586_0,,,,2,3,2,5
CC(C(C(C(C)CCO)O)O)O,,,5,1,1,0,1
10588_0,,,,2,3,2,5
CC(CC(C(CO)O)O)CCO,,,5,1,1,0,1
10590_0,,,,2,3,2,5
CC(C(CO)O)(C(C)CCO)O,,,5,1,1,0,1
10592_0,,,,2,3,2,5
C1(C(C(C(C)O1)C(C)CCO)=O)=O,,,5,1,1,0,1
10594_0,,,,2,3,2,5
C1(C(CC(CC(C)CCO)O1)=O)=O,,,5,1,1,0,1
10596_0,,,,2,3,2,5
C1(C(CC(C)(C(C)CCO)O1)=O)=O,,,5,1,1,0,1
10598_0,,,,2,3,2,5
C1(C(C(C(O1)=O)=O)C(C)CCO)=O,,,5,1,1,0,1
10600_0,,,,2,3,2,5
C(C(C(C(C)CCO)O)O)(O)=O,,,5,1,2,0,2
10602_0,,,,2,3,2,5
C(C(CO)(C(C)CCO)O)(O)=O,,,5,1,1,0,1
10603_0,,,,2,3,2,5
10604_0,,,,2,3,2,5
10605_0,,,,2,3,2,5
10606_0,,,,2,3,2,5
10607_0,,,,2,3,2,5
10608_0,,,,2,3,2,5
10610_0,,,,2,3,2,5
C(CC(C)(C(C)CCO)O)=O,,,5,1,1,0,1
10611_0,,,,2,3,2,5
10612_0,,,,2,3,2,5
10613_0,,,,2,3,2,5
10615_0,,,,2,3,2,5
C(C(C(C(C)CCO)O)=O)=O,,,5,1,1,0,1
10617_0,,,,2,3,2,5
C(C(C(C)CCO)O)(O)=O,,,5,1,1,0,1
10619_0,,,,2,3,2,5
CC(CCO)C(CO)O,,,5,1,2,0,2
10620_0,,,,2,3,2,5
10622_0,,,,2,3,2,5
C(C(CO)C(C)CC(C(O)=O)=O)=C,,,5,1,2,0,2
10624_0,,,,2,3,2,5
C(C(C=C)CC(C(O)=O)CCO)=O,,,5,1,2,0,2
10626_0,,,,2,3,2,5
C(C(CC(C=C)CO)CC=O)(O)=O,,,5,1,2,0,2
10628_0,,,,2,3,2,5
C(C(C=C)C(C(O)=O)(C)CCO)=O,,,5,1,1,0,1
10630_0,,,,2,3,2,5
C(C(C)(CC=O)C(C=C)CO)(O)=O,,,5,1,2,0,2
10632_0,,,,2,3,2,5
C(C(C=C)C(CO)C(C(O)=O)C)=O,,,5,1,2,0,2
10634_0,,,,2,3,2,5
C(C(C)C(C=O)C(C=C)CO)(O)=O,,,5,1,2,0,2
10635_0,,,,2,3,2,5
10637_0,,,,2,3,2,5
C(C(CCC=O)CCO)(O)=O,,,5,1,2,0,2
10639_0,,,,2,3,2,5
C(C(CC(C(O)=O)O)CCO)(O)=O,,,5,1,2,0,2
10641_0,,,,2,3,2,5
C(C(CCO)CC(CO)O)(O)=O,,,5,1,2,0,2
10642_0,,,,2,3,2,5
10644_0,,,,2,3,2,5
C(C(C)(CCO)C(C(O)=O)O)(O)=O,,,5,1,1,0,1
10646_0,,,,2,3,2,5
C(C(C)(CCO)C(CO)O)(O)=O,,,5,1,2,0,2
10647_0,,,,2,3,2,5
10649_0,,,,2,3,2,5
C(C(C)C(CO)CC=O)(O)=O,,,5,1,2,0,2
10651_0,,,,2,3,2,5
C(C(C)C(CO)C(C(O)=O)O)(O)=O,,,5,1,2,0,2
10653_0,,,,2,3,2,5
C(C(C)C(CO)C(CO)O)(O)=O,,,5,1,2,0,2
10654_0,,,,2,3,2,5
10655_0,,,,2,3,2,5
10656_0,,,,2,3,2,5
10657_0,,,,2,3,2,5
10659_0,,,,2,3,2,5
C(CC(CC(CC(C)O)O)O)(O)=O,,,5,1,1,0,1
10660_0,,,,2,3,2,5
10661_0,,,,2,3,2,5
10663_0,,,,2,3,2,5
C(CC(C(C(C)O)C(C)O)O)(O)=O,,,5,1,1,0,1
10664_0,,,,2,3,2,5
10666_0,,,,2,3,2,5
C(CC(CC(CC(O)=O)O)O)(O)=O,,,5,1,1,0,1
10667_0,,,,2,3,2,5
10668_0,,,,2,3,2,5
10669_0,,,,2,3,2,5
10671_0,,,,2,3,2,5
C(CC(CC(C(CO)=O)O)O)(O)=O,,,5,1,1,0,1
10672_0,,,,2,3,2,5
10673_0,,,,2,3,2,5
10674_0,,,,2,3,2,5
10675_0,,,,2,3,2,5
10676_0,,,,2,3,2,5
10677_0,,,,2,3,2,5
10679_0,,,,2,3,2,5
C(C(CO)(CC(CC(O)=O)O)O)=O,,,5,1,1,0,1
10680_0,,,,2,3,2,5
10681_0,,,,2,3,2,5
10682_0,,,,2,3,2,5
10684_0,,,,2,3,2,5
C(C(C(CO)O)(CC(O)=O)O)=O,,,5,1,2,0,2
10685_0,,,,2,3,2,5
10687_0,,,,2,3,2,5
C(C(C(C(C)O)O)(CC(O)=O)O)=O,,,5,1,2,0,2
10688_0,,,,2,3,2,5
10690_0,,,,2,3,2,5
C(CC(C=O)(C(C(O)=O)O)O)(O)=O,,,5,1,2,0,2
10691_0,,,,2,3,2,5
10692_0,,,,2,3,2,5
10694_0,,,,2,3,2,5
C(C(C=C)C(CCO)O)(O)=O,,,5,1,2,0,2
10695_0,,,,2,3,2,5
10696_0,,,,2,3,2,5
10697_0,,,,2,3,2,5
10698_0,,,,2,3,2,5
10699_0,,,,2,3,2,5
10700_0,,,,2,3,2,5
10701_0,,,,2,3,2,5
10702_0,,,,2,3,2,5
10703_0,,,,2,3,2,5
10704_0,,,,2,3,2,5
10705_0,,,,2,3,2,5
10706_0,,,,2,3,2,5
10707_0,,,,2,3,2,5
10708_0,,,,2,3,2,5
10709_0,,,,2,3,2,5
10710_0,,,,2,3,2,5
10711_0,,,,2,3,2,5
10713_0,,,,2,3,2,5
C(C(C)(CC(O)=O)O)(CC=O)=O,,,5,1,1,0,1
10714_0,,,,2,3,2,5
10715_0,,,,2,3,2,5
10716_0,,,,2,3,2,5
10717_0,,,,2,3,2,5
10718_0,,,,2,3,2,5
10719_0,,,,2,3,2,5
10720_0,,,,2,3,2,5
10721_0,,,,2,3,2,5
10722_0,,,,2,3,2,5
10723_0,,,,2,3,2,5
10724_0,,,,2,3,2,5
10725_0,,,,2,3,2,5
10727_0,,,,2,3,2,5
C(C(CO)(CC(O)=O)O)(C(C)O)=O,,,5,1,1,0,1
10729_0,,,,2,3,2,5
C(CO)(C(C(C)O)(CC(O)=O)O)=O,,,5,1,2,0,2
10731_0,,,,2,3,2,5
C(CC(C(C(O)=O)=O)(CO)O)(O)=O,,,5,1,1,0,1
10733_0,,,,2,3,2,5
C(C(C(CO)=O)(CC(O)=O)O)(O)=O,,,5,1,2,0,2
10734_0,,,,2,3,2,5
10735_0,,,,2,3,2,5
10737_0,,,,2,3,2,5
C(C(C=C)C(C=O)O)(O)=O,,,5,1,2,0,2
10738_0,,,,2,3,2,5
10739_0,,,,2,3,2,5
10741_0,,,,2,3,2,5
C(C(C(C(O)=O)=C)C(C=O)O)(O)=O,,,5,1,1,0,1
10742_0,,,,2,3,2,5
10743_0,,,,2,3,2,5
10744_0,,,,2,3,2,5
10745_0,,,,2,3,2,5
10746_0,,,,2,3,2,5
10747_0,,,,2,3,2,5
10748_0,,,,2,3,2,5
10749_0,,,,2,3,2,5
10750_0,,,,2,3,2,5
10751_0,,,,2,3,2,5
10752_0,,,,2,3,2,5
10753_0,,,,2,3,2,5
10754_0,,,,2,3,2,5
10755_0,,,,2,3,2,5
10756_0,,,,2,3,2,5
10757_0,,,,2,3,2,5
10758_0,,,,2,3,2,5
10759_0,,,,2,3,2,5
10760_0,,,,2,3,2,5
10761_0,,,,2,3,2,5
10762_0,,,,2,3,2,5
10763_0,,,,2,3,2,5
10764_0,,,,2,3,2,5
10765_0,,,,2,3,2,5
10767_0,,,,2,3,2,5
C(C(C=C)C(CO)(CO)O)(O)=O,,,5,1,2,0,2
10768_0,,,,2,3,2,5
10769_0,,,,2,3,2,5
10770_0,,,,2,3,2,5
10771_0,,,,2,3,2,5
10772_0,,,,2,3,2,5
10774_0,,,,2,3,2,5
C(C(C=C)C(C(O)=O)(CO)O)(O)=O,,,5,1,1,0,1
10775_0,,,,2,3,2,5
10776_0,,,,2,3,2,5
10778_0,,,,2,3,2,5
C(C(C=C)C(C(C(O)=O)O)O)(O)=O,,,5,1,2,0,2
10779_0,,,,2,3,2,5
10781_0,,,,2,3,2,5
C(C(CO)C(C)(CC(O)=O)O)(O)=O,,,5,1,2,0,2
10783_0,,,,2,3,2,5
C(C(C=C)C(C=CC)O)(O)=O,,,5,1,2,0,2
10785_0,,,,2,3,2,5
C(CC(C=CC)O)(O)=O,,,5,1,5,0,5
10786_0,,,,2,3,2,5
10787_0,,,,2,3,2,5
10788_0,,,,2,3,2,5
10790_0,,,,2,3,2,5
C(C(C=C)C(CC=C)O)(O)=O,,,5,1,2,0,2
10792_0,,,,2,3,2,5
C(CC(CC=C)O)(O)=O,,,5,1,5,0,5
10793_0,,,,2,3,2,5
10794_0,,,,2,3,2,5
10795_0,,,,2,3,2,5
10797_0,,,,2,3,2,5
C(C(C=C)C(C)O)(O)=O,,,5,1,2,0,2
10799_0,,,,2,3,2,5
C(C(C(O)=O)C=C)(O)=O,,,5,1,2,0,2
10801_0,,,,2,3,2,5
C(C(C=C)C(CC(C)O)O)(O)=O,,,5,1,2,0,2
10803_0,,,,2,3,2,5
C(C(C=C)C(CC(O)=O)O)(O)=O,,,5,1,2,0,2
10805_0,,,,2,3,2,5
C(C(C=C)C(C(CO)=O)O)(O)=O,,,5,1,2,0,2
10806_0,,,,2,3,2,5
10808_0,,,,2,3,2,5
C(C(C=C)C(C=O)(CO)O)(O)=O,,,5,1,2,0,2
10809_0,,,,2,3,2,5
10811_0,,,,2,3,2,5
C(C(C=C)C(C(O)=O)(C)O)(O)=O,,,5,1,2,0,2
10813_0,,,,2,3,2,5
C(C(C=CC)(CC(O)=O)O)(O)=O,,,5,1,2,0,2
10815_0,,,,2,3,2,5
C(CC(C(O)=O)(CC=C)O)(O)=O,,,5,1,2,0,2
10817_0,,,,2,3,2,5
C(CC(CC(C(O)=O)=C)O)(O)=O,,,5,1,2,0,2
10819_0,,,,2,3,2,5
C(C(C(C(O)=O)=C)C(C)O)(O)=O,,,5,1,2,0,2
10821_0,,,,2,3,2,5
C(C(C(O)=O)C(C(O)=O)=C)(O)=O,,,5,1,2,0,2
10822_0,,,,2,3,2,5
10824_0,,,,2,3,2,5
C(CC(C=C(C(O)=O)C)O)(O)=O,,,5,1,2,0,2
10826_0,,,,2,3,2,5
C1(C(CC(C)O1)(CC(O)=O)O)=O,,,5,1,2,0,2
10828_0,,,,2,3,2,5
C1(CC(C(O1)=O)(CC(O)=O)O)=O,,,5,1,2,0,2
10829_0,,,,2,3,2,5
10830_0,,,,2,3,2,5
10832_0,,,,2,3,2,5
C(C(C(C(CO)=O)=O)(CO)O)(O)=O,,,5,1,1,0,1
10834_0,,,,2,3,2,5
C(C(C(CC(C)O)O)=O)(O)=O,,,5,1,1,0,1
10836_0,,,,2,3,2,5
C(CC(C(C(O)=O)=O)O)(O)=O,,,5,1,2,0,2
10837_0,,,,2,3,2,5
10839_0,,,,2,3,2,5
C(C(C(C(O)=O)=O)(CO)O)=O,,,5,1,3,0,3
10840_0,,,,2,3,2,5
10841_0,,,,2,3,2,5
10842_0,,,,2,3,2,5
10844_0,,,,2,3,2,5
C(C(C(C(O)=O)=O)(C)O)(O)=O,,,5,1,2,0,2
10845_0,,,,2,3,2,5
10846_0,,,,2,3,2,5
10847_0,,,,2,3,2,5
10849_0,,,,2,3,2,5
C(C(C(C(C(O)=O)=O)=O)C)(O)=O,,,5,1,2,0,2
10851_0,,,,2,3,2,5
C=C(C(O)=O)C(C(C(O)=O)=O)O,,,5,1,2,0,2
10853_0,,,,2,3,2,5
C(C(CC(C)O)O)(O)=O,,,5,1,2,0,2
10855_0,,,,2,3,2,5
C(CC(C(O)=O)O)(O)=O,,,5,1,2,0,2
10856_0,,,,2,3,2,5
10857_0,,,,2,3,2,5
10858_0,,,,2,3,2,5
10859_0,,,,2,3,2,5
10860_0,,,,2,3,2,5
10862_0,,,,2,3,2,5
C(C(O)=O)(O)=O,,,5,1,1,0,1
10863_0,,,,2,3,2,5
10864_0,,,,2,3,2,5
10865_0,,,,2,3,2,5
10866_0,,,,2,3,2,5
10867_0,,,,2,3,2,5
10868_0,,,,2,3,2,5
10869_0,,,,2,3,2,5
10870_0,,,,2,3,2,5
10871_0,,,,2,3,2,5
10872_0,,,,2,3,2,5
10873_0,,,,2,3,2,5
10874_0,,,,2,3,2,5
10875_0,,,,2,3,2,5
10876_0,,,,2,3,2,5
10877_0,,,,2,3,2,5
10878_0,,,,2,3,2,5
10879_0,,,,2,3,2,5
10880_0,,,,2,3,2,5
10881_0,,,,2,3,2,5
10883_0,,,,2,3,2,5
C(C(CO)(C(C)O)C(C(O)=O)O)=O,,,5,1,2,0,2
10884_0,,,,2,3,2,5
10885_0,,,,2,3,2,5
10886_0,,,,2,3,2,5
10887_0,,,,2,3,2,5
10889_0,,,,2,3,2,5
C(C(C(C)O)(C(C)O)C(C)O)(O)=O,,,5,1,2,0,2
10891_0,,,,2,3,2,5
C(C(C(O)=O)(C(C)O)C(C)O)(O)=O,,,5,1,3,0,3
10893_0,,,,2,3,2,5
C(C(C(O)=O)(C(O)=O)C(C)O)(O)=O,,,5,1,3,0,3
10895_0,,,,2,3,2,5
C(C(C=O)(CO)C(C(O)=O)O)(O)=O,,,5,1,2,0,2
10896_0,,,,2,3,2,5
10897_0,,,,2,3,2,5
10898_0,,,,2,3,2,5
10900_0,,,,2,3,2,5
C(C(C(O)=O)(C(O)=O)C(O)=O)(O)=O,,,5,1,2,0,2
10902_0,,,,2,3,2,5
C(C(C(C(C=O)=O)(CO)O)O)(O)=O,,,5,1,3,0,3
10903_0,,,,2,3,2,5
10905_0,,,,2,3,2,5
C(C(C(CO)(C(C)O)O)=O)(O)=O,,,5,1,5,0,5
10907_0,,,,2,3,2,5
C(C(C(C(O)=O)=O)(CO)O)(O)=O,,,5,1,5,0,5
10909_0,,,,2,3,2,5
C(C(C(CO)(CO)O)=O)(O)=O,,,5,1,4,0,4
10911_0,,,,2,3,2,5
C(C(C(C(C)O)(C(C)O)O)=O)(O)=O,,,5,1,3,0,3
10913_0,,,,2,3,2,5
C(C(C(C(O)=O)=O)(C(C)O)O)(O)=O,,,5,1,5,0,5
10915_0,,,,2,3,2,5
C(C(C(O)=O)(C(C(O)=O)=O)O)(O)=O,,,5,1,3,0,3
10916_0,,,,2,3,2,5
10917_0,,,,2,3,2,5
10918_0,,,,2,3,2,5
10920_0,,,,2,3,2,5
C(C(C=O)(C(C(O)=O)O)O)=O,,,5,1,6,0,6
10922_0,,,,2,3,2,5
C(C(CO)C(C(O)=O)O)(O)=O,,,5,1,4,0,4
10924_0,,,,2,3,2,5
C(C(C(C)O)C(C(O)=O)O)(O)=O,,,5,1,2,0,2
10926_0,,,,2,3,2,5
C(C(C(O)=O)C(C(O)=O)O)(O)=O,,,5,1,2,0,2
10927_0,,,,2,3,2,5
10928_0,,,,2,3,2,5
10929_0,,,,2,3,2,5
10931_0,,,,2,3,2,5
C(C(C=O)(C(C(O)=O)O)O)(O)=O,,,5,1,6,0,6
10932_0,,,,2,3,2,5
10933_0,,,,2,3,2,5
10934_0,,,,2,3,2,5
10935_0,,,,2,3,2,5
10936_0,,,,2,3,2,5
10937_0,,,,2,3,2,5
10938_0,,,,2,3,2,5
10939_0,,,,2,3,2,5
10940_0,,,,2,3,2,5
10941_0,,,,2,3,2,5
10942_0,,,,2,3,2,5
10943_0,,,,2,3,2,5
10944_0,,,,2,3,2,5
10945_0,,,,2,3,2,5
10946_0,,,,2,3,2,5
10947_0,,,,2,3,2,5
10948_0,,,,2,3,2,5
10949_0,,,,2,3,2,5
10950_0,,,,2,3,2,5
10952_0,,,,2,3,2,5
C(CO)(C(CO)(CC(O)=O)O)=O,,,5,1,2,0,2
10953_0,,,,2,3,2,5
10954_0,,,,2,3,2,5
10955_0,,,,2,3,2,5
10957_0,,,,2,3,2,5
C=C(C(O)=O)C(O)=O,,,5,1,3,0,3
10959_0,,,,2,3,2,5
C(C(C(O)=O)(C)OC(CO)=O)(O)=O,,,5,1,1,0,1
10961_0,,,,2,3,2,5
C(C(C(OC(C(O)=O)C)=O)O)(O)=O,,,5,1,1,0,1
10963_0,,,,2,3,2,5
C(C(C(O)=O)(C)O)(OC(CO)=O)=O,,,5,1,1,0,1
10965_0,,,,2,3,2,5
C(C(C(O)=O)O)(OC(C(C)O)=O)=O,,,5,1,1,0,1
10967_0,,,,2,3,2,5
C(C(C(OCC(O)=O)=O)(C)O)(O)=O,,,5,1,1,0,1
10969_0,,,,2,3,2,5
C(C(C(O)=O)OC(C(C)O)=O)(O)=O,,,5,1,1,0,1
10971_0,,,,2,3,2,5
C(C(C(CCC(C)O)=O)=O)(O)=O,,,5,1,2,0,2
10973_0,,,,2,3,2,5
C(CC(C)O)(CC(C(O)=O)=O)=O,,,5,1,2,0,2
10975_0,,,,2,3,2,5
C(C(C=O)C(C=O)C(C)O)(O)=O,,,5,1,2,0,2
10977_0,,,,2,3,2,5
C(C(C=O)C(C(O)=O)C(C)O)=O,,,5,1,2,0,2
10979_0,,,,2,3,2,5
C(CCC(C(C(O)=O)=O)=O)(O)=O,,,5,1,2,0,2
10981_0,,,,2,3,2,5
C(CC(CC(C(O)=O)=O)=O)(O)=O,,,5,1,4,0,4
10983_0,,,,2,3,2,5
C(C(C(O)=O)C(C=O)C(O)=O)=O,,,5,1,2,0,2
10985_0,,,,2,3,2,5
C(C(C=O)C(C(O)=O)C(O)=O)=O,,,5,1,2,0,2
10987_0,,,,2,3,2,5
C(CO)(CC(C(C(O)=O)=O)=O)=O,,,5,1,2,0,2
10988_0,,,,2,3,2,5
10990_0,,,,2,3,2,5
C(C(C(C(C(O)=O)=O)=O)CO)=O,,,5,1,2,0,2
10992_0,,,,2,3,2,5
C(C(C(C(C=O)=O)=O)CO)(O)=O,,,5,1,2,0,2
10994_0,,,,2,3,2,5
C(C(C=O)C(C(C(O)=O)=O)O)=O,,,5,1,2,0,2
10995_0,,,,2,3,2,5
10997_0,,,,2,3,2,5
C(C(C=O)CC(O)=O)=O,,,5,1,2,0,2
10999_0,,,,2,3,2,5
C(C(C(O)=O)CC=O)=O,,,5,1,2,0,2
11001_0,,,,2,3,2,5
C(C(C(O)=O)CC(C(O)=O)=O)=O,,,5,1,3,0,3
11002_0,,,,2,3,2,5
11003_0,,,,2,3,2,5
11005_0,,,,2,3,2,5
C(C)(CC(C(O)=O)=O)=O,,,5,1,2,0,2
11007_0,,,,2,3,2,5
C(C(C(O)=O)=O)(CC)=O,,,5,1,2,0,2
11008_0,,,,2,3,2,5
11009_0,,,,2,3,2,5
11010_0,,,,2,3,2,5
11011_0,,,,2,3,2,5
11013_0,,,,2,3,2,5
C1(C(C(O)=O)C(C(O1)=O)(C)O)=O,,,5,1,3,0,3
11015_0,,,,2,3,2,5
C(C)=C(C(O)=O)C(CC(C)O)O,,,5,1,2,0,2
11017_0,,,,2,3,2,5
C(CC(C)O)=C(C(O)=O)C(C)O,,,5,1,2,0,2
11019_0,,,,2,3,2,5
C(C(C=CC(C)O)C(C)O)(O)=O,,,5,1,2,0,2
11021_0,,,,2,3,2,5
C(CC(C)O)=C(C(O)=O)C(O)=O,,,5,1,2,0,2
11023_0,,,,2,3,2,5
C(C(C(O)=O)C=CC(C)O)(O)=O,,,5,1,2,0,2
11025_0,,,,2,3,2,5
C(C(C(C(O)=O)=O)O)=CC(C)O,,,5,1,2,0,2
11027_0,,,,2,3,2,5
C(CC(C)O)=CC(O)=O,,,5,1,2,0,2
11029_0,,,,2,3,2,5
C(CC=CC(C)O)(O)=O,,,5,1,2,0,2
11031_0,,,,2,3,2,5
C(C(C=CC(O)=O)C(C)O)(O)=O,,,5,1,2,0,2
11033_0,,,,2,3,2,5
C(CC=C(C(O)=O)C(C)O)(O)=O,,,5,1,2,0,2
11035_0,,,,2,3,2,5
C(CC(C(C(O)=O)=CC)O)(O)=O,,,5,1,2,0,2
11037_0,,,,2,3,2,5
C(C(C(C)O)=CC(CO)=O)(O)=O,,,5,1,2,0,2
11039_0,,,,2,3,2,5
C(CO)(C(C(C(O)=O)=CC)O)=O,,,5,1,2,0,2
11041_0,,,,2,3,2,5
C(C(CO)=C(C=O)C(C)O)(O)=O,,,5,1,2,0,2
11043_0,,,,2,3,2,5
C(C(C(C)O)=C(C=O)CO)(O)=O,,,5,1,2,0,2
11045_0,,,,2,3,2,5
C(C(C(C=O)=CC)(CO)O)(O)=O,,,5,1,2,0,2
11047_0,,,,2,3,2,5
C(C(C(C(O)=O)=CC)(CO)O)=O,,,5,1,2,0,2
11049_0,,,,2,3,2,5
C=C(C(O)=O)C(C)O,,,5,1,3,0,3
11050_0,,,,2,3,2,5
11052_0,,,,2,3,2,5
C(C)=C(C(O)=O)C(C)O,,,5,1,3,0,3
11054_0,,,,2,3,2,5
C(C)=C(C(O)=O)C(O)=O,,,5,1,3,0,3
11056_0,,,,2,3,2,5
C(C(C(C)O)=C(C(O)=O)C)(O)=O,,,5,1,2,0,2
11058_0,,,,2,3,2,5
C(C(C(C(O)=O)=CC)(C)O)(O)=O,,,5,1,2,0,2
11060_0,,,,2,3,2,5
C(C=C(C(O)=O)CC(C)O)(O)=O,,,5,1,2,0,2
11062_0,,,,2,3,2,5
C(CC(C(O)=O)=CC(C)O)(O)=O,,,5,1,2,0,2
11064_0,,,,2,3,2,5
C(CC=C(C(O)=O)C(O)=O)(O)=O,,,5,1,2,0,2
11066_0,,,,2,3,2,5
C(C(C(O)=O)C=CC(O)=O)(O)=O,,,5,1,2,0,2
11068_0,,,,2,3,2,5
C(C(C(C(O)=O)=O)O)=CC(O)=O,,,5,1,2,0,2
11070_0,,,,2,3,2,5
C(CC=CC(O)=O)(O)=O,,,5,1,3,0,3
11071_0,,,,2,3,2,5
11073_0,,,,2,3,2,5
C(C(C(O)=O)=CC(CO)=O)(O)=O,,,5,1,2,0,2
11075_0,,,,2,3,2,5
C(C(C=O)=C(C(O)=O)CO)(O)=O,,,5,1,2,0,2
11077_0,,,,2,3,2,5
C(C(C(O)=O)=C(C=O)CO)(O)=O,,,5,1,2,0,2
11079_0,,,,2,3,2,5
C(C(C(O)=O)=C(C(O)=O)C)(O)=O,,,5,1,2,0,2
11081_0,,,,2,3,2,5
C(C(C)(CC=CC(O)=O)O)(O)=O,,,5,1,2,0,2
11083_0,,,,2,3,2,5
C(C(C=CCC(O)=O)(C)O)(O)=O,,,5,1,2,0,2
11085_0,,,,2,3,2,5
C(C(C(C(O)=O)=C)(C)O)(O)=O,,,5,1,3,0,3
11086_0,,,,2,3,2,5
11088_0,,,,2,3,2,5
C(CC(C(O)=O)=CC(O)=O)(O)=O,,,5,1,3,0,3
11089_0,,,,2,3,2,5
11091_0,,,,2,3,2,5
C(C=CC(CO)=O)(O)=O,,,5,1,2,0,2
11093_0,,,,2,3,2,5
C(C(CO)=CC(O)=O)=O,,,5,1,3,0,3
11095_0,,,,2,3,2,5
C(C(CO)=CC=O)(O)=O,,,5,1,4,0,4
11097_0,,,,2,3,2,5
C(C(CO)=CC(C(O)=O)=O)(O)=O,,,5,1,3,0,3
11099_0,,,,2,3,2,5
C=CC(C(C(O)=O)=O)O,,,5,1,2,0,2
11100_0,,,,2,3,2,5
11101_0,,,,2,3,2,5
11102_0,,,,2,3,2,5
11104_0,,,,2,3,2,5
C(C(CC)O)(O)=O,,,5,1,2,0,2
11106_0,,,,2,3,2,5
C(CCCO)(O)=O,,,5,1,3,0,3
11108_0,,,,2,3,2,5
C(C(CO)CC(O)=O)(O)=O,,,5,1,2,0,2
11110_0,,,,2,3,2,5
C(C(C)C(C(O)=O)O)(O)=O,,,5,1,2,0,2
11112_0,,,,2,3,2,5
C(C1C(C)OC(CO)(C1O)O)(O)=O,,,5,1,2,0,2
11114_0,,,,2,3,2,5
C(C1(COC(C1C(C)O)O)O)(O)=O,,,5,1,2,0,2
11116_0,,,,2,3,2,5
C(C1C(C)OC(C1(CO)O)O)(O)=O,,,5,1,2,0,2
11118_0,,,,2,3,2,5
C1(C(C(O)=O)C(C(CO)(O)O1)O)=O,,,5,1,2,0,2
11120_0,,,,2,3,2,5
C(C1C(O)OCC1(C(O)=O)O)(O)=O,,,5,1,2,0,2
11122_0,,,,2,3,2,5
C1(C(C(O)=O)C(C(O)O1)(CO)O)=O,,,5,1,2,0,2
11124_0,,,,2,3,2,5
C(C1(CO)C(C(C(O1)O)=O)O)(O)=O,,,5,1,2,0,2
11126_0,,,,2,3,2,5
C(C1(COC(C(O)=O)(C1O)O)O)=O,,,5,1,2,0,2
11128_0,,,,2,3,2,5
C(C1(COC(C=O)(C1O)O)O)(O)=O,,,5,1,2,0,2
11130_0,,,,2,3,2,5
C(C1(COC(C1)O)O)(O)=O,,,5,1,2,0,2
11132_0,,,,2,3,2,5
C(C1(COC(C(O)=O)(C1)O)O)(O)=O,,,5,1,2,0,2
11134_0,,,,2,3,2,5
C1(C(C)(C(C(C(O)=O)(O)O1)O)O)=O,,,5,1,2,0,2
11136_0,,,,2,3,2,5
C(C1(C(C(CC(C)O1)O)O)O)(O)=O,,,5,1,2,0,2
11138_0,,,,2,3,2,5
C1(CC(C(C(C(O)=O)(O)O1)O)O)=O,,,5,1,2,0,2
11140_0,,,,2,3,2,5
C(C1(C(C(C(CO1)=O)O)O)O)(O)=O,,,5,1,2,0,2
11142_0,,,,2,3,2,5
C(C1(COC(C(C1O)=O)O)O)(O)=O,,,5,1,2,0,2
11144_0,,,,2,3,2,5
C(C1C(C)OC(C1(C)O)=O)(O)=O,,,5,1,2,0,2
11146_0,,,,2,3,2,5
C1(CC(C(C(C(O)=O)=O)O1)O)=O,,,5,1,2,0,2
11148_0,,,,2,3,2,5
C1(C(C=O)C(C(O)=O)(CO1)O)=O,,,5,1,2,0,2
11150_0,,,,2,3,2,5
C1(C(C(O)=O)C(C=O)(CO1)O)=O,,,5,1,2,0,2
11152_0,,,,2,3,2,5
C1(C(C)(CC(CC(O)=O)O1)O)=O,,,5,1,2,0,2
11154_0,,,,2,3,2,5
C(C1COC(C1(C)O)=O)(O)=O,,,5,1,2,0,2
11156_0,,,,2,3,2,5
C(C1(CO)CC(C(O1)=O)=O)(O)=O,,,5,1,2,0,2
11158_0,,,,2,3,2,5
C1(C(CO)(C(C(O)=O)(CO1)O)O)=O,,,5,1,1,0,1
11160_0,,,,2,3,2,5
C(C1(COC(C1O)=O)O)(O)=O,,,5,1,3,0,3
11162_0,,,,2,3,2,5
C1(C(C(O)=O)C(CC(C)O1)O)=O,,,5,1,2,0,2
11164_0,,,,2,3,2,5
C(C1C(CC(OC1C)=O)O)(O)=O,,,5,1,2,0,2
11166_0,,,,2,3,2,5
C1(C(C(O)=O)C(CC(O1)=O)O)=O,,,5,1,2,0,2
11168_0,,,,2,3,2,5
C1(C(C(O)=O)C(C(CO1)=O)O)=O,,,5,1,2,0,2
11170_0,,,,2,3,2,5
C(C1(COC(C(C1)=O)=O)O)(O)=O,,,5,1,2,0,2
11171_0,,,,2,3,2,5
11172_0,,,,2,3,2,5
11174_0,,,,2,3,2,5
C(CC(C)C(CC=O)O)(O)=O,,,5,1,2,0,2
11175_0,,,,2,3,2,5
11177_0,,,,2,3,2,5
C(C(C=O)(C(C)CC(O)=O)O)=O,,,5,1,2,0,2
11178_0,,,,2,3,2,5
11180_0,,,,2,3,2,5
C(CC(C)C(CO)C(C)O)(O)=O,,,5,1,2,0,2
11182_0,,,,2,3,2,5
C(CC(C)C(CC(C)O)O)(O)=O,,,5,1,2,0,2
11184_0,,,,2,3,2,5
C(CC(C)CC(CCO)O)(O)=O,,,5,1,2,0,2
11186_0,,,,2,3,2,5
C(CC(C)C(C)(CCO)O)(O)=O,,,5,1,2,0,2
11188_0,,,,2,3,2,5
C(C(CO)C(C)CC(O)=O)(O)=O,,,5,1,2,0,2
11190_0,,,,2,3,2,5
C(CC(C(C)CC(O)=O)O)(O)=O,,,5,1,2,0,2
11192_0,,,,2,3,2,5
C(CC(C)C(C(CO)=O)O)(O)=O,,,5,1,2,0,2
11194_0,,,,2,3,2,5
C(CC(C)CO)(O)=O,,,5,1,2,0,2
11196_0,,,,2,3,2,5
C(C(CCO)CC(O)=O)(O)=O,,,5,1,2,0,2
11198_0,,,,2,3,2,5
C(C(C)(CO)CC(O)=O)(O)=O,,,5,1,2,0,2
11200_0,,,,2,3,2,5
C(C(C)C(C(O)=O)CO)(O)=O,,,5,1,2,0,2
11201_0,,,,2,3,2,5
11203_0,,,,2,3,2,5
C(C(CCCO)CC(O)=O)(O)=O,,,5,1,2,0,2
11204_0,,,,2,3,2,5
11206_0,,,,2,3,2,5
C(C(CCO)C(C(O)=O)C)(O)=O,,,5,1,2,0,2
11208_0,,,,2,3,2,5
C(CC(C)C(C)O)(O)=O,,,5,1,2,0,2
11210_0,,,,2,3,2,5
C(C(CC(C)O)CC(O)=O)(O)=O,,,5,1,2,0,2
11212_0,,,,2,3,2,5
C(C(C)(C(C)O)CC(O)=O)(O)=O,,,5,1,2,0,2
11214_0,,,,2,3,2,5
C(C(C(C)O)C(C(O)=O)C)(O)=O,,,5,1,2,0,2
11216_0,,,,2,3,2,5
C(C(C(C)CC(O)=O)C(C)O)(O)=O,,,5,1,2,0,2
11218_0,,,,2,3,2,5
C(CC(C)CC(CC(O)=O)O)(O)=O,,,5,1,2,0,2
11220_0,,,,2,3,2,5
C(CC(C)(C(C)CC(O)=O)O)(O)=O,,,5,1,2,0,2
11222_0,,,,2,3,2,5
C(C(C(O)=O)C(C)CC(O)=O)(O)=O,,,5,1,2,0,2
11224_0,,,,2,3,2,5
C(CC(C)C(C(C(O)=O)=O)O)(O)=O,,,5,1,2,0,2
11226_0,,,,2,3,2,5
C(CC(C)CC(O)=O)(O)=O,,,5,1,2,0,2
11228_0,,,,2,3,2,5
C(CCC(C(O)=O)CC(O)=O)(O)=O,,,5,1,2,0,2
11230_0,,,,2,3,2,5
C(C(C)(CC(O)=O)CC(O)=O)(O)=O,,,5,1,2,0,2
11232_0,,,,2,3,2,5
C(CC(C(O)=O)C(C(O)=O)C)(O)=O,,,5,1,2,0,2
11234_0,,,,2,3,2,5
C(CC(C)CC(C(O)=O)O)(O)=O,,,5,1,2,0,2
11236_0,,,,2,3,2,5
C(C(C)(C(C)CC(O)=O)O)(O)=O,,,5,1,2,0,2
11238_0,,,,2,3,2,5
C(C(C=O)(C(C)CC(O)=O)O)(O)=O,,,5,1,2,0,2
11239_0,,,,2,3,2,5
11241_0,,,,2,3,2,5
C(CC(C)CC=CC=O)(O)=O,,,5,1,2,0,2
11243_0,,,,2,3,2,5
C(CC(C)CC=CC(O)=O)=O,,,5,1,3,0,3
11245_0,,,,2,3,2,5
C(CC(C)C(C(O)=O)C=C)=O,,,5,1,3,0,3
11247_0,,,,2,3,2,5
C(C(C=C)C(C)CC(O)=O)=O,,,5,1,2,0,2
11249_0,,,,2,3,2,5
C(CC(C)C(CO)(C(C)O)O)(O)=O,,,5,1,2,0,2
11251_0,,,,2,3,2,5
C(CC(C)C(C(C(C)O)O)O)(O)=O,,,5,1,2,0,2
11253_0,,,,2,3,2,5
C(CC(C)CC(C(CO)O)O)(O)=O,,,5,1,2,0,2
11255_0,,,,2,3,2,5
C(CC(C)C(C)(C(CO)O)O)(O)=O,,,5,1,2,0,2
11257_0,,,,2,3,2,5
C(CC(C)C(C(C(O)=O)O)O)(O)=O,,,5,1,3,0,3
11259_0,,,,2,3,2,5
C(C(CO)(C(C)CC(O)=O)O)(O)=O,,,5,1,2,0,2
11260_0,,,,2,3,2,5
11261_0,,,,2,3,2,5
11262_0,,,,2,3,2,5
11263_0,,,,2,3,2,5
11264_0,,,,2,3,2,5
11265_0,,,,2,3,2,5
11267_0,,,,2,3,2,5
C(CC(C)C(C)(CC=O)O)(O)=O,,,5,1,2,0,2
11268_0,,,,2,3,2,5
11269_0,,,,2,3,2,5
11270_0,,,,2,3,2,5
11272_0,,,,2,3,2,5
C(CC(C)C(C(C=O)=O)O)(O)=O,,,5,1,2,0,2
11274_0,,,,2,3,2,5
C(CC(C)C(C(O)=O)O)(O)=O,,,5,1,2,0,2
11276_0,,,,2,3,2,5
C(CC(C)C(CO)O)(O)=O,,,5,1,3,0,3
11277_0,,,,2,3,2,5
11278_0,,,,2,3,2,5
11280_0,,,,2,3,2,5
C(CCC(C(O)=O)CC(O)=O)=O,,,5,1,2,0,2
11282_0,,,,2,3,2,5
C(C(CC(CO)O)CC(O)=O)(O)=O,,,5,1,2,0,2
11283_0,,,,2,3,2,5
11285_0,,,,2,3,2,5
C(C(C)(C(CO)O)CC(O)=O)(O)=O,,,5,1,3,0,3
11286_0,,,,2,3,2,5
11288_0,,,,2,3,2,5
C(CC(C(O)=O)C(C(O)=O)C)=O,,,5,1,2,0,2
11290_0,,,,2,3,2,5
C(C(C(CO)O)C(C(O)=O)C)(O)=O,,,5,1,2,0,2
11292_0,,,,2,1,1,2
C(C1C(CC(CC1O)O)O)(O)=O,,,5,1,1,0,1
11293_0,,,,2,1,1,2
11295_0,,,,2,1,1,2
C(C1(C(CC(C(C1O)=O)O)O)O)=O,,,5,1,2,0,2
11295_1,,,,2,1,1,2
11297_0,,,,2,1,1,2
C1(C(C(CC1O)O)(C(C=O)O)O)=O,,,5,1,4,0,4
11297_1,,,,2,1,1,2
11299_0,,,,2,1,1,2
C1(C(CC(C1(C(C)O)O)O)O)=O,,,5,1,4,0,4
11299_1,,,,2,1,1,2
11301_0,,,,2,1,1,2
C(C1(C(C(CC1O)O)=O)O)(O)=O,,,5,1,4,0,4
11301_1,,,,2,1,1,2
11303_0,,,,2,1,1,2
C1(C(CC(C1(CO)O)O)O)=O,,,5,1,4,0,4
11303_1,,,,2,1,1,2
11305_0,,,,2,1,1,2
C1(C(C(CO)C(C1(CO)O)O)O)=O,,,5,1,2,0,2
11305_1,,,,2,1,1,2
11307_0,,,,2,1,1,2
C1(C(C(C=C)C(C1(CO)O)O)O)=O,,,5,1,2,0,2
11307_1,,,,2,1,1,2
11309_0,,,,2,1,1,2
C(C1(C(CC(C1(C)O)=O)O)CO)=O,,,5,1,2,0,2
11310_0,,,,2,1,1,2
11312_0,,,,2,1,1,2
C(C1(C=C)C(CC(C1(C)O)=O)O)=O,,,5,1,2,0,2
11313_0,,,,2,1,1,2
11314_0,,,,2,1,1,2
11315_0,,,,2,1,1,2
11315_1,,,,2,1,1,2
11316_0,,,,2,1,1,2
11316_1,,,,2,1,1,2
11317_0,,,,2,1,1,2
11318_0,,,,2,1,1,2
11318_1,,,,2,1,1,2
11320_0,,,,2,1,1,2
C1(C(C)(C(C(O)=O)(C(C1)O)O)O)=O,,,5,1,4,0,4
11320_1,,,,2,1,1,2
11321_0,,,,2,1,1,2
11321_1,,,,2,1,1,2
11322_0,,,,2,1,1,2
11322_1,,,,2,1,1,2
11323_0,,,,2,1,1,2
11323_1,,,,2,1,1,2
11325_0,,,,2,1,1,2
C1(C2C(C(C(C2O)O)(O)O1)O)=O,,,5,1,3,0,3
11326_0,,,,2,1,1,2
11328_0,,,,2,1,1,2
C(C1(C(C)O)C(C(C)CC1O)O)=O,,,5,1,1,0,1
11330_0,,,,2,1,1,2
C(C1(CO)C(CC(C)CC1O)O)=O,,,5,1,1,0,1
11332_0,,,,2,1,1,2
C(C1(CO)C(CC(C)C1(C)O)O)=O,,,5,1,1,0,1
11334_0,,,,2,1,1,2
C(C1(C=O)C(C(C)CC1O)O)(O)=O,,,5,1,1,0,1
11336_0,,,,2,1,1,2
C(C(C1(C(C(C)CC1O)O)O)=O)=O,,,5,1,2,0,2
11336_1,,,,2,1,1,2
11338_0,,,,2,1,1,2
C(C1(CC(C(O)=O)CC1O)CO)=O,,,5,1,2,0,2
11340_0,,,,2,1,1,2
C(C1C(C(C)CC1O)O)(O)=O,,,5,1,1,0,1
11342_0,,,,2,1,1,2
C(C1C(CC(C)CC1O)O)(O)=O,,,5,1,1,0,1
11344_0,,,,2,1,1,2
C(C1C(CC(C)C1(C)O)O)(O)=O,,,5,1,1,0,1
11346_0,,,,2,1,1,2
C(C1(C(CC(C)CC1O)O)O)(O)=O,,,5,1,2,0,2
11346_1,,,,2,1,1,2
11348_0,,,,2,1,1,2
C(C1(C(CC(C)C1(C)O)O)O)(O)=O,,,5,1,2,0,2
11348_1,,,,2,1,1,2
11350_0,,,,2,1,1,2
C(C1(C(C(C)CC1O)O)O)(O)=O,,,5,1,2,0,2
11350_1,,,,2,1,1,2
11352_0,,,,2,2,1,3
C1(C(CC(C1(C(CO)O)O)O)O)=O,,,5,1,2,0,2
11352_1,,,,2,2,1,3
11354_0,,,,2,2,1,3
C1(C(C(CC1O)O)(C(C=C)O)O)=O,,,5,1,2,0,2
11354_1,,,,2,2,1,3
11355_0,,,,2,2,1,3
11355_1,,,,2,2,1,3
11356_0,,,,2,2,1,3
11356_1,,,,2,2,1,3
11357_0,,,,2,2,1,3
11357_1,,,,2,2,1,3
11358_0,,,,2,2,1,3
11358_1,,,,2,2,1,3
11360_0,,,,2,2,1,3
C(C(CO)(CO)C(CC(C)O)O)=O,,,5,1,2,0,2
11362_0,,,,2,2,1,3
C(C(CO)(CO)C(CC(O)=O)O)=O,,,5,1,2,0,2
11363_0,,,,2,2,1,3
11364_0,,,,2,2,1,3
11366_0,,,,2,2,1,3
C(C(CO)(CO)C(C(CO)=O)O)=O,,,5,1,2,0,2
11367_0,,,,2,2,1,3
11367_1,,,,2,2,1,3
11369_0,,,,2,2,1,3
C(C(CO)(CO)C(C=O)(CO)O)=O,,,5,1,2,0,2
11370_0,,,,2,2,1,3
11371_0,,,,2,2,1,3
11373_0,,,,2,2,1,3
C(C(CO)(CO)C(CCO)O)=O,,,5,1,2,0,2
11374_0,,,,2,2,1,3
11374_1,,,,2,2,1,3
11376_0,,,,2,2,1,3
C(C(C=C)(C(C)O)C(CCO)O)=O,,,5,1,2,0,2
11378_0,,,,2,2,1,3
C(C(C=O)(C=C)C(CCO)O)(O)=O,,,5,1,2,0,2
11380_0,,,,2,2,1,3
C(C(C=C)(CO)C(CCO)O)=O,,,5,1,3,0,3
11381_0,,,,2,2,1,3
11382_0,,,,2,2,1,3
11383_0,,,,2,2,1,3
11383_1,,,,2,2,1,3
11385_0,,,,2,2,1,3
C(C(CO)(C(CO)O)C(C=O)O)=O,,,5,1,1,0,1
11387_0,,,,2,2,1,3
C(C(CO)(C(C=O)O)C(C=C)O)=O,,,5,1,1,0,1
11388_0,,,,2,2,1,3
11389_0,,,,2,2,1,3
11391_0,,,,2,2,1,3
C(C(CO)(CO)C(C=O)O)=O,,,5,1,2,0,2
11393_0,,,,2,2,1,3
C(C(CO)(C(C=O)O)C(C=O)O)=O,,,5,1,1,0,1
11394_0,,,,2,2,1,3
11394_1,,,,2,2,1,3
11396_0,,,,2,2,1,3
C(C(CO)(CO)C(C(C=O)O)O)=O,,,5,1,2,0,2
11398_0,,,,2,2,1,3
C(C(CO)(CO)C(CO)(CO)O)=O,,,5,1,2,0,2
11399_0,,,,2,2,1,3
11400_0,,,,2,2,1,3
11402_0,,,,2,2,1,3
C(C(CO)(CO)C(C=CC)O)=O,,,5,1,2,0,2
11403_0,,,,2,2,1,3
11404_0,,,,2,2,1,3
11406_0,,,,2,2,1,3
C(C(CO)(CO)C(CC=C)O)=O,,,5,1,2,0,2
11408_0,,,,2,2,1,3
C(C(CO)(CO)C(C(C)=O)O)=O,,,5,1,1,0,1
11410_0,,,,2,2,1,3
C(C(CO)(CO)C(C=O)(C)O)=O,,,5,1,1,0,1
11412_0,,,,2,2,1,3
C(C(CO)(CO)C(C(C=O)=O)O)=O,,,5,1,1,0,1
11414_0,,,,2,2,1,3
C(C(C=O)(C(C=O)(CO)CO)O)=O,,,5,1,1,0,1
11416_0,,,,2,2,1,3
C(C(CO)(CO)C(C(CO)O)O)=O,,,5,1,1,0,1
11418_0,,,,2,2,1,3
C(C(CO)(CO)C(CO)O)=O,,,5,1,1,0,1
11420_0,,,,2,2,1,3
C(C(CO)(CO)C(C(C)O)O)=O,,,5,1,1,0,1
11422_0,,,,2,2,1,3
C(C(CO)(CO)C(C(O)=O)O)=O,,,5,1,1,0,1
11424_0,,,,2,2,1,3
C(C(CO)(CO)C(C)(CCO)O)=O,,,5,1,1,0,1
11426_0,,,,2,2,1,3
C(C(CO)(CO)C(C)(CO)O)=O,,,5,1,1,0,1
11428_0,,,,2,2,1,3
C(C(CO)(CO)C(C)(C(C)O)O)=O,,,5,1,1,0,1
11430_0,,,,2,2,1,3
C(C(CO)(CO)C(CO)(CC)O)=O,,,5,1,1,0,1
11432_0,,,,2,2,1,3
C(C(CO)(CO)C(C=C)O)=O,,,5,1,1,0,1
11434_0,,,,2,2,1,3
C(C(CO)(CO)C(C(CC)O)O)=O,,,5,1,1,0,1
11436_0,,,,2,2,1,3
C(C(CO)(CO)C(CCCO)O)=O,,,5,1,1,0,1
11437_0,,,,2,2,1,3
11438_0,,,,2,2,1,3
11439_0,,,,2,2,1,3
11440_0,,,,2,2,1,3
11441_0,,,,2,2,1,3
11442_0,,,,2,2,1,3
11444_0,,,,2,2,1,3
C(C(CO)(CO)CO)=O,,,5,1,1,0,1
11445_0,,,,2,2,1,3
11446_0,,,,2,2,1,3
11447_0,,,,2,2,1,3
11448_0,,,,2,2,1,3
11449_0,,,,2,2,1,3
11450_0,,,,2,2,1,3
11451_0,,,,2,2,1,3
11453_0,,,,2,2,1,3
C(C(CO)(C(C(CO)CO)O)O)=O,,,5,1,2,0,2
11453_1,,,,2,2,1,3
11455_0,,,,2,2,1,3
C(C(C=O)(C(C(CO)CO)O)O)=O,,,5,1,2,0,2
11455_1,,,,2,2,1,3
11456_0,,,,2,2,1,3
11457_0,,,,2,2,1,3
11458_0,,,,2,2,1,3
11460_0,,,,2,2,1,3
C(C(C(CO)(CO)CO)=O)(O)=O,,,5,1,1,0,1
11462_0,,,,2,2,1,3
C(C(C(C(C)=O)=O)(CO)C(C)O)=O,,,5,1,2,0,2
11464_0,,,,2,2,1,3
C(C(C=O)(C(C(C)=O)=O)CO)(O)=O,,,5,1,2,0,2
11465_0,,,,2,2,1,3
11466_0,,,,2,2,1,3
11467_0,,,,2,2,1,3
11469_0,,,,2,2,1,3
C(C(C(C)O)=O)(C(CO)(CO)O)=O,,,5,1,2,0,2
11469_1,,,,2,2,1,3
11471_0,,,,2,2,1,3
C(C(C(C(CO)(CO)O)=O)=O)(O)=O,,,5,1,2,0,2
11471_1,,,,2,2,1,3
11472_0,,,,2,2,1,3
11472_1,,,,2,2,1,3
11473_0,,,,2,2,1,3
11473_1,,,,2,2,1,3
11474_0,,,,2,2,1,3
11474_1,,,,2,2,1,3
11475_0,,,,2,2,1,3
11475_1,,,,2,2,1,3
11476_0,,,,2,2,1,3
11476_1,,,,2,2,1,3
11477_0,,,,2,2,1,3
11477_1,,,,2,2,1,3
11478_0,,,,2,2,1,3
11478_1,,,,2,2,1,3
11479_0,,,,2,2,1,3
11479_1,,,,2,2,1,3
11481_0,,,,2,2,1,3
C(C(C=C)(C(CO)O)C(C=O)O)=O,,,5,1,1,0,1
11483_0,,,,2,2,1,3
C(C(C=C)(C(C=C)O)C(C=O)O)=O,,,5,1,1,0,1
11485_0,,,,2,2,1,3
C(C(C=C)(C(C)O)C(C=O)O)=O,,,5,1,3,0,3
11487_0,,,,2,2,1,3
C(C(C=O)(C=C)C(C=O)O)(O)=O,,,5,1,3,0,3
11489_0,,,,2,2,1,3
C(C(C=C)(CO)C(C=O)O)=O,,,5,1,3,0,3
11491_0,,,,2,2,1,3
C(C(C=C)(C(C=O)O)C(C=O)O)=O,,,5,1,1,0,1
11493_0,,,,2,2,1,3
C(C(C=C)(C(C=CC)O)C(C=O)O)=O,,,5,1,2,0,2
11495_0,,,,2,2,1,3
C(C(C=C)(C(CC=C)O)C(C=O)O)=O,,,5,1,2,0,2
11497_0,,,,2,2,1,3
C(C(CO)(C(CC(C=O)O)O)O)=O,,,5,1,2,0,2
11497_1,,,,2,2,1,3
11499_0,,,,2,2,1,3
C(C(C=O)(C(CC(C=O)O)O)O)=O,,,5,1,2,0,2
11499_1,,,,2,2,1,3
11501_0,,,,2,2,1,3
C(C(CO)C(CC(C=O)O)O)(O)=O,,,5,1,1,0,1
11503_0,,,,2,2,1,3
C(C(CO)(C(C(CC=O)O)O)O)=O,,,5,1,2,0,2
11503_1,,,,2,2,1,3
11504_0,,,,2,2,1,3
11504_1,,,,2,2,1,3
11505_0,,,,2,2,1,3
11506_0,,,,2,2,1,3
11507_0,,,,2,2,1,3
11508_0,,,,2,2,1,3
11509_0,,,,2,2,1,3
11510_0,,,,2,2,1,3
11511_0,,,,2,2,1,3
11512_0,,,,2,2,1,3
11512_1,,,,2,2,1,3
11513_0,,,,2,2,1,3
11513_1,,,,2,2,1,3
11514_0,,,,2,2,1,3
11514_1,,,,2,2,1,3
11515_0,,,,2,2,1,3
11515_1,,,,2,2,1,3
11516_0,,,,2,2,1,3
11516_1,,,,2,2,1,3
11517_0,,,,2,2,1,3
11517_1,,,,2,2,1,3
11519_0,,,,2,2,1,3
C(C(C=C)(CO)C(C(C=O)O)O)=O,,,5,1,2,0,2
11520_0,,,,2,2,1,3
11520_1,,,,2,2,1,3
11522_0,,,,2,2,1,3
C(C(C(CC=O)O)(C(CO)O)O)=O,,,5,1,2,0,2
11522_1,,,,2,2,1,3
11524_0,,,,2,2,1,3
C(CC(C(C=O)(C(C=C)O)O)O)=O,,,5,1,2,0,2
11524_1,,,,2,2,1,3
11525_0,,,,2,2,1,3
11525_1,,,,2,2,1,3
11526_0,,,,2,2,1,3
11526_1,,,,2,2,1,3
11527_0,,,,2,2,1,3
11527_1,,,,2,2,1,3
11528_0,,,,2,2,1,3
11528_1,,,,2,2,1,3
11530_0,,,,2,2,1,3
C(C(C=C)(CO)C(CO)(CO)O)=O,,,5,1,2,0,2
11531_0,,,,2,2,1,3
11531_1,,,,2,2,1,3
11532_0,,,,2,2,1,3
11532_1,,,,2,2,1,3
11534_0,,,,2,2,1,3
C(CO)(C(C(CO)O)(C(C)O)O)=O,,,5,1,5,0,5
11534_1,,,,2,2,1,3
11536_0,,,,2,2,1,3
C(CO)(C(C(C)O)(C(C=C)O)O)=O,,,5,1,2,0,2
11536_1,,,,2,2,1,3
11537_0,,,,2,2,1,3
11537_1,,,,2,2,1,3
11538_0,,,,2,2,1,3
11538_1,,,,2,2,1,3
11539_0,,,,2,2,1,3
11539_1,,,,2,2,1,3
11540_0,,,,2,2,1,3
11540_1,,,,2,2,1,3
11542_0,,,,2,2,1,3
C(C(C(CO)=O)(C(CO)O)O)(O)=O,,,5,1,5,0,5
11542_1,,,,2,2,1,3
11544_0,,,,2,2,1,3
C(C(C(CO)=O)(C(C=C)O)O)(O)=O,,,5,1,2,0,2
11544_1,,,,2,2,1,3
11545_0,,,,2,2,1,3
11545_1,,,,2,2,1,3
11546_0,,,,2,2,1,3
11546_1,,,,2,2,1,3
11547_0,,,,2,2,1,3
11547_1,,,,2,2,1,3
11548_0,,,,2,2,1,3
11548_1,,,,2,2,1,3
11549_0,,,,2,2,1,3
11549_1,,,,2,2,1,3
11551_0,,,,2,2,1,3
C(C(C)(C(C(CO)=O)(CO)O)O)=O,,,5,1,3,0,3
11551_1,,,,2,2,1,3
11553_0,,,,2,2,1,3
C(CO)(C(CO)(C(CO)O)O)=O,,,5,1,5,0,5
11553_1,,,,2,2,1,3
11555_0,,,,2,2,1,3
C(CO)(C(CO)(C(C(C)O)O)O)=O,,,5,1,2,0,2
11555_1,,,,2,2,1,3
11556_0,,,,2,2,1,3
11556_1,,,,2,2,1,3
11558_0,,,,2,2,1,3
C(CO)(C(CO)(C(CO)(C)O)O)=O,,,5,1,2,0,2
11558_1,,,,2,2,1,3
11560_0,,,,2,2,1,3
C(CO)(C(CO)(C(C=C)O)O)=O,,,5,1,2,0,2
11560_1,,,,2,2,1,3
11561_0,,,,2,2,1,3
11561_1,,,,2,2,1,3
11562_0,,,,2,2,1,3
11562_1,,,,2,2,1,3
11563_0,,,,2,2,1,3
11563_1,,,,2,2,1,3
11564_0,,,,2,2,1,3
11564_1,,,,2,2,1,3
11565_0,,,,2,2,1,3
11565_1,,,,2,2,1,3
11566_0,,,,2,2,1,3
11566_1,,,,2,2,1,3
11567_0,,,,2,2,1,3
11567_1,,,,2,2,1,3
11568_0,,,,2,2,1,3
11568_1,,,,2,2,1,3
11569_0,,,,2,2,1,3
11569_1,,,,2,2,1,3
11570_0,,,,2,2,1,3
11570_1,,,,2,2,1,3
11571_0,,,,2,2,1,3
11571_1,,,,2,2,1,3
11572_0,,,,2,2,1,3
11572_1,,,,2,2,1,3
11573_0,,,,2,2,1,3
11573_1,,,,2,2,1,3
11575_0,,,,2,2,1,3
C(C(C(CO)(C(CO)O)O)=O)(O)=O,,,5,1,3,0,3
11575_1,,,,2,2,1,3
11577_0,,,,2,2,1,3
C=CC(C(C(C(O)=O)=O)(CO)O)O,,,5,1,2,0,2
11577_1,,,,2,2,1,3
11578_0,,,,2,2,1,3
11578_1,,,,2,2,1,3
11579_0,,,,2,2,1,3
11579_1,,,,2,2,1,3
11580_0,,,,2,2,1,3
11580_1,,,,2,2,1,3
11581_0,,,,2,2,1,3
11581_1,,,,2,2,1,3
11582_0,,,,2,2,1,3
11582_1,,,,2,2,1,3
11583_0,,,,2,2,1,3
11583_1,,,,2,2,1,3
11584_0,,,,2,2,1,3
11584_1,,,,2,2,1,3
11585_0,,,,2,2,1,3
11587_0,,,,2,2,1,3
C(C(C=C)(C(C=CC)O)C(C=C)O)=O,,,5,1,1,0,1
11589_0,,,,2,2,1,3
C(C(C=C)(C(C)O)C(C=CC)O)=O,,,5,1,2,0,2
11591_0,,,,2,2,1,3
C(C(C(O)=O)(C=C)C(C=CC)O)=O,,,5,1,2,0,2
11593_0,,,,2,2,1,3
C(C(C=C)(CO)C(C=CC)O)=O,,,5,1,3,0,3
11594_0,,,,2,2,1,3
11595_0,,,,2,2,1,3
11596_0,,,,2,2,1,3
11597_0,,,,2,2,1,3
11597_1,,,,2,2,1,3
11599_0,,,,2,2,1,3
C(C(C=C)(C(CC=C)O)C(C=C)O)=O,,,5,1,1,0,1
11601_0,,,,2,2,1,3
C(C(C=C)(C(CC=C)O)C(C)O)=O,,,5,1,2,0,2
11603_0,,,,2,2,1,3
C(C(C(O)=O)(C=C)C(CC=C)O)=O,,,5,1,2,0,2
11605_0,,,,2,2,1,3
C(C(C=C)(CO)C(CC=C)O)=O,,,5,1,3,0,3
11606_0,,,,2,2,1,3
11607_0,,,,2,2,1,3
11608_0,,,,2,2,1,3
11609_0,,,,2,2,1,3
11609_1,,,,2,2,1,3
11611_0,,,,2,2,1,3
C(C(C=C)(C(C)O)C(C(C)=O)O)=O,,,5,1,1,0,1
11613_0,,,,2,2,1,3
C(C(C=C)(C(C)O)C(C=O)(C)O)=O,,,5,1,1,0,1
11615_0,,,,2,2,1,3
C(C(C=C)(C(CO)O)C(C)O)=O,,,5,1,1,0,1
11617_0,,,,2,2,1,3
C(C(C=C)(C(C)O)C(C(C)O)O)=O,,,5,1,1,0,1
11619_0,,,,2,2,1,3
C(C(C=C)(C(C)O)C(C(O)=O)O)=O,,,5,1,1,0,1
11621_0,,,,2,2,1,3
C(C(C=C)(C(C)O)C(C)(CO)O)=O,,,5,1,1,0,1
11623_0,,,,2,2,1,3
C(C(C=C)(C(C)O)C(C=C)O)=O,,,5,1,1,0,1
11625_0,,,,2,2,1,3
C(C(C=C)(C(C)O)C(C)O)=O,,,5,1,2,0,2
11627_0,,,,2,2,1,3
C(C(C=O)(C=C)C(C)O)(O)=O,,,5,1,3,0,3
11629_0,,,,2,2,1,3
C(C(C=C)(CO)C(C)O)=O,,,5,1,3,0,3
11630_0,,,,2,2,1,3
11631_0,,,,2,2,1,3
11632_0,,,,2,2,1,3
11633_0,,,,2,2,1,3
11635_0,,,,2,2,1,3
C(C(C=O)(C=C)C(C(C)=O)O)(O)=O,,,5,1,1,0,1
11637_0,,,,2,2,1,3
C(C(C=O)(C=C)C(C=O)(C)O)(O)=O,,,5,1,1,0,1
11639_0,,,,2,2,1,3
C(C(C=O)(C=C)C(CO)O)(O)=O,,,5,1,1,0,1
11641_0,,,,2,2,1,3
C(C(C=O)(C=C)C(C(C)O)O)(O)=O,,,5,1,1,0,1
11643_0,,,,2,2,1,3
C(C(C=O)(C=C)C(C(O)=O)O)(O)=O,,,5,1,1,0,1
11645_0,,,,2,2,1,3
C(C(C=O)(C=C)C(C)(CO)O)(O)=O,,,5,1,1,0,1
11647_0,,,,2,2,1,3
C(C(C(O)=O)(C=C)C(C=C)O)=O,,,5,1,1,0,1
11648_0,,,,2,2,1,3
11650_0,,,,2,2,1,3
C(C(C(O)=O)(C(O)=O)C=C)=O,,,5,1,2,0,2
11652_0,,,,2,2,1,3
C(C(C=O)(C=C)CO)(O)=O,,,5,1,3,0,3
11653_0,,,,2,2,1,3
11654_0,,,,2,2,1,3
11655_0,,,,2,2,1,3
11656_0,,,,2,2,1,3
11658_0,,,,2,2,1,3
C(C(C=C)(CO)C(CC(C)O)O)=O,,,5,1,2,0,2
11659_0,,,,2,2,1,3
11661_0,,,,2,2,1,3
C(C(C=C)(CO)C(CC(O)=O)O)=O,,,5,1,2,0,2
11663_0,,,,2,2,1,3
C(C(C=C)(CO)C(C(CO)=O)O)=O,,,5,1,2,0,2
11665_0,,,,2,2,1,3
C(C(C=C)(CO)C(C=O)(CO)O)=O,,,5,1,2,0,2
11667_0,,,,2,2,1,3
C(C(C=C)(CO)C(C(C)=O)O)=O,,,5,1,1,0,1
11669_0,,,,2,2,1,3
C(C(C=C)(CO)C(C=O)(C)O)=O,,,5,1,1,0,1
11671_0,,,,2,2,1,3
C(C(C=C)(CO)C(C(C=O)=O)O)=O,,,5,1,1,0,1
11673_0,,,,2,2,1,3
C(C(C=C)(CO)C(C=O)(C=O)O)=O,,,5,1,1,0,1
11675_0,,,,2,2,1,3
C(C(C=C)(CO)C(C(CO)O)O)=O,,,5,1,1,0,1
11677_0,,,,2,2,1,3
C(C(C=C)(CO)C(CO)O)=O,,,5,1,1,0,1
11679_0,,,,2,2,1,3
C(C(C=C)(CO)C(C(C)O)O)=O,,,5,1,1,0,1
11681_0,,,,2,2,1,3
C(C(C=C)(CO)C(C(O)=O)O)=O,,,5,1,1,0,1
11683_0,,,,2,2,1,3
C(C(C=C)(CO)C(C)(CCO)O)=O,,,5,1,1,0,1
11685_0,,,,2,2,1,3
C(C(C=C)(CO)C(C)(CO)O)=O,,,5,1,1,0,1
11687_0,,,,2,2,1,3
C(C(C=C)(CO)C(C)(C(C)O)O)=O,,,5,1,1,0,1
11689_0,,,,2,2,1,3
C(C(C=C)(CO)C(CO)(CC)O)=O,,,5,1,1,0,1
11691_0,,,,2,2,1,3
C(C(C=C)(CO)C(C=C)O)=O,,,5,1,1,0,1
11693_0,,,,2,2,1,3
C(C(C=C)(CO)C(C(CC)O)O)=O,,,5,1,1,0,1
11695_0,,,,2,2,1,3
C(C(C=C)(CO)C(CCCO)O)=O,,,5,1,1,0,1
11696_0,,,,2,2,1,3
11697_0,,,,2,2,1,3
11698_0,,,,2,2,1,3
11699_0,,,,2,2,1,3
11700_0,,,,2,2,1,3
11701_0,,,,2,2,1,3
11703_0,,,,2,2,1,3
C(C(C=C)(CO)CO)=O,,,5,1,2,0,2
11704_0,,,,2,2,1,3
11705_0,,,,2,2,1,3
11706_0,,,,2,2,1,3
11707_0,,,,2,2,1,3
11708_0,,,,2,2,1,3
11709_0,,,,2,2,1,3
11711_0,,,,2,2,1,3
C(C(C=C)(CO)C(C(O)=O)(C)O)=O,,,5,1,2,0,2
11713_0,,,,2,2,1,3
C(C(C(C(C=C)CO)O)(CO)O)=O,,,5,1,2,0,2
11713_1,,,,2,2,1,3
11715_0,,,,2,2,1,3
C(C(C=O)(C(C(C=C)CO)O)O)=O,,,5,1,2,0,2
11715_1,,,,2,2,1,3
11716_0,,,,2,2,1,3
11717_0,,,,2,2,1,3
11719_0,,,,2,2,1,3
C=CC(C(C(O)=O)=O)(CO)C(C)O,,,5,1,2,0,2
11721_0,,,,2,2,1,3
C(C(C=C)(C(C(O)=O)=O)CO)(O)=O,,,5,1,2,0,2
11722_0,,,,2,2,1,3
11723_0,,,,2,2,1,3
11725_0,,,,2,2,1,3
C=CC(C(C(O)=O)=O)(CO)CO,,,5,1,2,0,2
11727_0,,,,2,2,1,3
C(C(C(C(O)=O)=C)(CO)C(C)O)=O,,,5,1,2,0,2
11729_0,,,,2,2,1,3
C(C(C=O)(C(C(O)=O)=C)CO)(O)=O,,,5,1,2,0,2
11730_0,,,,2,2,1,3
11731_0,,,,2,2,1,3
11733_0,,,,2,2,1,3
C(C(C(C(O)=O)=C)(CO)CO)=O,,,5,1,2,0,2
11735_0,,,,2,2,1,3
C1(C(C(CO)(C(C)O1)C(C)O)=O)=O,,,5,1,2,0,2
11737_0,,,,2,2,1,3
C(C1(C(C(OC1C)=O)=O)CO)(O)=O,,,5,1,2,0,2
11738_0,,,,2,2,1,3
11739_0,,,,2,2,1,3
11741_0,,,,2,2,1,3
C1(C(C(CO)(CO)C(C)O1)=O)=O,,,5,1,2,0,2
11742_0,,,,2,2,1,3
11744_0,,,,2,2,1,3
C1(C(C(C(O1)=O)=O)(CO)C(C)O)=O,,,5,1,2,0,2
11746_0,,,,2,2,1,3
C1(C(C(O)=O)(C(C(O1)=O)=O)CO)=O,,,5,1,2,0,2
11747_0,,,,2,2,1,3
11748_0,,,,2,2,1,3
11750_0,,,,2,2,1,3
C1(C(C(C(O1)=O)=O)(CO)CO)=O,,,5,1,2,0,2
11752_0,,,,2,2,1,3
C(C(C(CO)O)(C(CO)O)O)(O)=O,,,5,1,2,0,2
11752_1,,,,2,2,1,3
11754_0,,,,2,2,1,3
C(C(C(CO)O)(C(C=C)O)O)(O)=O,,,5,1,4,0,4
11754_1,,,,2,2,1,3
11755_0,,,,2,2,1,3
11755_1,,,,2,2,1,3
11756_0,,,,2,2,1,3
11756_1,,,,2,2,1,3
11757_0,,,,2,2,1,3
11757_1,,,,2,2,1,3
11758_0,,,,2,2,1,3
11758_1,,,,2,2,1,3
11760_0,,,,2,2,1,3
C(C(C(C(C(C)=O)=O)(CO)O)=O)=O,,,5,1,2,0,2
11760_1,,,,2,2,1,3
11762_0,,,,2,2,1,3
C(C(C(C)O)C(C(C=O)=O)O)(O)=O,,,5,1,2,0,2
11764_0,,,,2,2,1,3
C(C(C(O)=O)C(C(C=O)=O)O)(O)=O,,,5,1,2,0,2
11765_0,,,,2,2,1,3
11766_0,,,,2,2,1,3
11766_1,,,,2,2,1,3
11767_0,,,,2,2,1,3
11767_1,,,,2,2,1,3
11768_0,,,,2,2,1,3
11768_1,,,,2,2,1,3
11770_0,,,,2,2,1,3
C(C(CO)(C(C(C(C)O)=O)O)O)=O,,,5,1,2,0,2
11770_1,,,,2,2,1,3
11772_0,,,,2,2,1,3
C(C(C=O)(C(C(C(C)O)=O)O)O)=O,,,5,1,2,0,2
11772_1,,,,2,2,1,3
11774_0,,,,2,2,1,3
C(C(CO)C(C(C(C)O)=O)O)(O)=O,,,5,1,1,0,1
11776_0,,,,2,2,1,3
C(C(C(C)O)(C(C=O)(CO)O)O)=O,,,5,1,2,0,2
11776_1,,,,2,2,1,3
11778_0,,,,2,2,1,3
C(C(C=O)(C(C=O)(C(C)O)O)O)=O,,,5,1,4,0,4
11778_1,,,,2,2,1,3
11780_0,,,,2,2,1,3
C(C(CO)C(C=O)(C(C)O)O)(O)=O,,,5,1,2,0,2
11781_0,,,,2,2,1,3
11781_1,,,,2,2,1,3
11783_0,,,,2,2,1,3
C(C(C=O)(C(C=O)(C=O)O)O)(O)=O,,,5,1,6,0,6
11783_1,,,,2,2,1,3
11785_0,,,,2,2,1,3
C(C(C=O)(C(C(O)=O)CO)O)(O)=O,,,5,1,2,0,2
11786_0,,,,2,2,1,3
11786_1,,,,2,2,1,3
11787_0,,,,2,2,1,3
11787_1,,,,2,2,1,3
11789_0,,,,2,2,1,3
C(C(CO)C(C(C(O)=O)=O)O)(O)=O,,,5,1,1,0,1
11791_0,,,,2,2,1,3
C(C(C(C(C)=O)=O)(C(C)O)O)(O)=O,,,5,1,2,0,2
11791_1,,,,2,2,1,3
11793_0,,,,2,2,1,3
C(C(C(O)=O)(C(C(C)=O)=O)O)(O)=O,,,5,1,2,0,2
11793_1,,,,2,2,1,3
11794_0,,,,2,2,1,3
11794_1,,,,2,2,1,3
11796_0,,,,2,2,1,3
C(C(C(C=O)O)C(C(C)=O)O)(O)=O,,,5,1,1,0,1
11798_0,,,,2,2,1,3
C(C(C(CO)=O)(C(C(C)=O)O)O)=O,,,5,1,2,0,2
11798_1,,,,2,2,1,3
11799_0,,,,2,2,1,3
11799_1,,,,2,2,1,3
11801_0,,,,2,2,1,3
C(C(CO)(CO)C(C(C)=O)O)(O)=O,,,5,1,1,0,1
11803_0,,,,2,2,1,3
C(C(C=O)(CC=O)C(C(C)=O)O)=O,,,5,1,1,0,1
11805_0,,,,2,2,1,3
C(C(C1(C(C(O)OC1)=O)O)O)(C)=O,,,5,1,2,0,2
11805_1,,,,2,2,1,3
11806_0,,,,2,2,1,3
11806_1,,,,2,2,1,3
11808_0,,,,2,2,1,3
C(C(CO)(C(C)O)C(C(C)=O)O)=O,,,5,1,1,0,1
11810_0,,,,2,2,1,3
C(C(C=O)(CO)C(C(C)=O)O)(O)=O,,,5,1,1,0,1
11812_0,,,,2,2,1,3
C(C(C(C(C=O)=O)(CO)O)O)(C)=O,,,5,1,2,0,2
11812_1,,,,2,2,1,3
11813_0,,,,2,2,1,3
11813_1,,,,2,2,1,3
11815_0,,,,2,2,1,3
C(C(CO)C(C(C)=O)O)(O)=O,,,5,1,1,0,1
11817_0,,,,2,2,1,3
C(C(C(C)O)C(C(C)=O)O)(O)=O,,,5,1,1,0,1
11819_0,,,,2,2,1,3
C(C(C(O)=O)C(C(C)=O)O)(O)=O,,,5,1,1,0,1
11821_0,,,,2,2,1,3
C(C(C(C)O)(C(C(C)=O)O)O)(O)=O,,,5,1,2,0,2
11821_1,,,,2,2,1,3
11823_0,,,,2,2,1,3
C(C(C(O)=O)(C(C(C)=O)O)O)(O)=O,,,5,1,2,0,2
11823_1,,,,2,2,1,3
11824_0,,,,2,2,1,3
11824_1,,,,2,2,1,3
11826_0,,,,2,2,1,3
C(C(C(C(O)=O)C(C=O)(C)O)O)=O,,,5,1,1,0,1
11828_0,,,,2,2,1,3
C(C(C)(C(C=O)(C(CO)=O)O)O)=O,,,5,1,2,0,2
11828_1,,,,2,2,1,3
11830_0,,,,2,2,1,3
C(C(CO)(C(C=O)(C)O)O)=O,,,5,1,3,0,3
11830_1,,,,2,2,1,3
11832_0,,,,2,2,1,3
C(C(CO)(CO)C(C=O)(C)O)(O)=O,,,5,1,1,0,1
11834_0,,,,2,2,1,3
C(C(C)(C(C=O)(C=O)CC=O)O)=O,,,5,1,1,0,1
11836_0,,,,2,2,1,3
C(C(C)(C1(C(C(O)OC1)=O)O)O)=O,,,5,1,2,0,2
11836_1,,,,2,2,1,3
11838_0,,,,2,2,1,3
C(C(CO)(C(C=O)(C)O)O)(O)=O,,,5,1,3,0,3
11838_1,,,,2,2,1,3
11840_0,,,,2,2,1,3
C(C(CO)(C(C)O)C(C=O)(C)O)=O,,,5,1,1,0,1
11842_0,,,,2,2,1,3
C(C(C=O)(CO)C(C=O)(C)O)(O)=O,,,5,1,1,0,1
11844_0,,,,2,2,1,3
C(C(C)(C(C(C=O)=O)(CO)O)O)=O,,,5,1,2,0,2
11844_1,,,,2,2,1,3
11846_0,,,,2,2,1,3
C(C(C=O)(C(C=O)(C)O)O)=O,,,5,1,3,0,3
11846_1,,,,2,2,1,3
11848_0,,,,2,2,1,3
C(C(CO)C(C=O)(C)O)(O)=O,,,5,1,1,0,1
11850_0,,,,2,2,1,3
C(C(C(C)O)C(C=O)(C)O)(O)=O,,,5,1,1,0,1
11852_0,,,,2,2,1,3
C(C(C(O)=O)C(C=O)(C)O)(O)=O,,,5,1,1,0,1
11854_0,,,,2,2,1,3
C(C(C(C)O)(C(C=O)(C)O)O)(O)=O,,,5,1,2,0,2
11854_1,,,,2,2,1,3
11856_0,,,,2,2,1,3
C(C(C(O)=O)(C(C=O)(C)O)O)(O)=O,,,5,1,2,0,2
11856_1,,,,2,2,1,3
11858_0,,,,2,2,1,3
C(C(C=O)(C(C=O)(C)O)O)(O)=O,,,5,1,3,0,3
11858_1,,,,2,2,1,3
11859_0,,,,2,2,1,3
11859_1,,,,2,2,1,3
11860_0,,,,2,2,1,3
11860_1,,,,2,2,1,3
11862_0,,,,2,2,1,3
C(C(CO)C(C(C(C)=O)=O)O)(O)=O,,,5,1,1,0,1
11864_0,,,,2,2,1,3
C(C(CO)(C(C(C=O)=O)(C)O)O)=O,,,5,1,3,0,3
11864_1,,,,2,2,1,3
11866_0,,,,2,2,1,3
C(C(C=O)(C(C(C=O)=O)(C)O)O)=O,,,5,1,3,0,3
11866_1,,,,2,2,1,3
11868_0,,,,2,2,1,3
C(C(CO)C(C(C=O)=O)(C)O)(O)=O,,,5,1,1,0,1
11870_0,,,,2,2,1,3
C(C(CO)(C(C=O)(C(C)=O)O)O)=O,,,5,1,2,0,2
11870_1,,,,2,2,1,3
11872_0,,,,2,2,1,3
C(C(C=O)(C(C=O)(C(C)=O)O)O)=O,,,5,1,2,0,2
11872_1,,,,2,2,1,3
11874_0,,,,2,2,1,3
C(C(CO)C(C=O)(C(C)=O)O)(O)=O,,,5,1,1,0,1
11875_0,,,,2,2,1,3
11875_1,,,,2,2,1,3
11876_0,,,,2,2,1,3
11876_1,,,,2,2,1,3
11877_0,,,,2,2,1,3
11877_1,,,,2,2,1,3
11878_0,,,,2,2,1,3
11879_0,,,,2,2,1,3
11880_0,,,,2,2,1,3
11881_0,,,,2,2,1,3
11881_1,,,,2,2,1,3
11882_0,,,,2,2,1,3
11882_1,,,,2,2,1,3
11883_0,,,,2,2,1,3
11883_1,,,,2,2,1,3
11885_0,,,,2,2,1,3
C(C(C=O)(C(C=O)(C=O)O)O)=O,,,5,1,2,0,2
11885_1,,,,2,2,1,3
11887_0,,,,2,2,1,3
C(C(C=O)(C(C(O)=O)CO)O)=O,,,5,1,1,0,1
11889_0,,,,2,2,1,3
C(C(C=O)(C(C(O)=O)C(C)O)O)=O,,,5,1,1,0,1
11891_0,,,,2,2,1,3
C(C(C(O)=O)C(C=O)(C=O)O)(O)=O,,,5,1,1,0,1
11892_0,,,,2,2,1,3
11892_1,,,,2,2,1,3
11894_0,,,,2,2,1,3
C(C(C(C(C=O)=O)=O)(C)CO)(O)=O,,,5,1,1,0,1
11896_0,,,,2,2,1,3
C(C(C)=O)(C(CO)(C(CO)O)O)=O,,,5,1,2,0,2
11896_1,,,,2,2,1,3
11898_0,,,,2,2,1,3
C=CC(C(C(C(C)=O)=O)(CO)O)O,,,5,1,2,0,2
11898_1,,,,2,2,1,3
11899_0,,,,2,2,1,3
11899_1,,,,2,2,1,3
11900_0,,,,2,2,1,3
11900_1,,,,2,2,1,3
11901_0,,,,2,2,1,3
11901_1,,,,2,2,1,3
11903_0,,,,2,2,1,3
C(C(C(C(C(C)=O)=O)(CO)O)O)=O,,,5,1,3,0,3
11903_1,,,,2,2,1,3
11905_0,,,,2,2,1,3
C(C(C(CO)O)C(C=O)O)(O)=O,,,5,1,1,0,1
11907_0,,,,2,2,1,3
C(C(C(C(C)O)O)C(C=O)O)(O)=O,,,5,1,1,0,1
11909_0,,,,2,2,1,3
C(C(C(C(O)=O)C(C=O)O)O)(O)=O,,,5,1,1,0,1
11911_0,,,,2,2,1,3
C(C(C(CO)(C)O)C(C=O)O)(O)=O,,,5,1,1,0,1
11913_0,,,,2,2,1,3
C(C(C(C=O)O)C(C=C)O)(O)=O,,,5,1,1,0,1
11914_0,,,,2,2,1,3
11915_0,,,,2,2,1,3
11916_0,,,,2,2,1,3
11917_0,,,,2,2,1,3
11919_0,,,,2,2,1,3
C(C(C(C=O)O)C(C=O)O)(O)=O,,,5,1,1,0,1
11921_0,,,,2,2,1,3
C(C(C(C=O)O)C(C=CC)O)(O)=O,,,5,1,1,0,1
11923_0,,,,2,2,1,3
C(C(C(CC=C)O)C(C=O)O)(O)=O,,,5,1,1,0,1
11925_0,,,,2,2,1,3
C(C(C(CO)=O)(C(CO)O)O)=O,,,5,1,2,0,2
11925_1,,,,2,2,1,3
11927_0,,,,2,2,1,3
C(C(C(CO)=O)(C(C(C)O)O)O)=O,,,5,1,2,0,2
11927_1,,,,2,2,1,3
11929_0,,,,2,2,1,3
C(C(C(CO)=O)(C(C(O)=O)O)O)=O,,,5,1,2,0,2
11929_1,,,,2,2,1,3
11931_0,,,,2,2,1,3
C(C(C(CO)=O)(C(CO)(C)O)O)=O,,,5,1,2,0,2
11931_1,,,,2,2,1,3
11933_0,,,,2,2,1,3
C(C(C(CO)=O)(C(C=C)O)O)=O,,,5,1,2,0,2
11933_1,,,,2,2,1,3
11935_0,,,,2,2,1,3
C(C(C(CO)=O)(C(C)O)O)=O,,,5,1,2,0,2
11935_1,,,,2,2,1,3
11936_0,,,,2,2,1,3
11936_1,,,,2,2,1,3
11937_0,,,,2,2,1,3
11937_1,,,,2,2,1,3
11939_0,,,,2,2,1,3
C(C(C(CO)=O)(C(CCO)O)O)=O,,,5,1,2,0,2
11939_1,,,,2,2,1,3
11941_0,,,,2,2,1,3
C(C(C(CO)=O)(C(C=O)O)O)=O,,,5,1,2,0,2
11941_1,,,,2,2,1,3
11943_0,,,,2,2,1,3
C(C(C(CO)=O)(C(C=CC)O)O)=O,,,5,1,2,0,2
11943_1,,,,2,2,1,3
11945_0,,,,2,2,1,3
C(C(C(CO)=O)(C(CC=C)O)O)=O,,,5,1,2,0,2
11945_1,,,,2,2,1,3
11947_0,,,,2,2,1,3
C(C(CO)(C(C(CO)O)O)O)=O,,,5,1,2,0,2
11947_1,,,,2,2,1,3
11948_0,,,,2,2,1,3
11948_1,,,,2,2,1,3
11950_0,,,,2,2,1,3
C(C(CO)(C(C(C)O)O)O)=O,,,5,1,2,0,2
11950_1,,,,2,2,1,3
11951_0,,,,2,2,1,3
11951_1,,,,2,2,1,3
11953_0,,,,2,2,1,3
C(C(CO)(C(C(CO)=O)(C)O)O)=O,,,5,1,2,0,2
11953_1,,,,2,2,1,3
11955_0,,,,2,2,1,3
C(C(CO)(C(C(C)=O)(CO)O)O)=O,,,5,1,2,0,2
11955_1,,,,2,2,1,3
11957_0,,,,2,2,1,3
C(C(CO)(C(C)(CC(O)=O)O)O)=O,,,5,1,2,0,2
11957_1,,,,2,2,1,3
11959_0,,,,2,2,1,3
C(C(CO)(C(C)(CCO)O)O)=O,,,5,1,2,0,2
11959_1,,,,2,2,1,3
11961_0,,,,2,2,1,3
C(C(CO)(C(CO)(C)O)O)=O,,,5,1,2,0,2
11961_1,,,,2,2,1,3
11963_0,,,,2,2,1,3
C(C(CO)(C(C(C(O)=O)=C)O)O)=O,,,5,1,2,0,2
11963_1,,,,2,2,1,3
11964_0,,,,2,2,1,3
11964_1,,,,2,2,1,3
11966_0,,,,2,2,1,3
C(C(CO)(C(C(CC=O)=O)O)O)=O,,,5,1,2,0,2
11966_1,,,,2,2,1,3
11967_0,,,,2,2,1,3
11967_1,,,,2,2,1,3
11969_0,,,,2,2,1,3
C(C(CC)(C(C=O)(CO)O)O)(O)=O,,,5,1,2,0,2
11969_1,,,,2,2,1,3
11971_0,,,,2,2,1,3
C(C(CO)(C(C)(C(C)O)O)O)=O,,,5,1,2,0,2
11971_1,,,,2,2,1,3
11973_0,,,,2,2,1,3
C(C(CO)(C(CO)(CC)O)O)=O,,,5,1,2,0,2
11973_1,,,,2,2,1,3
11975_0,,,,2,2,1,3
C(C(CO)(C(C(C(C)O)=C)O)O)=O,,,5,1,2,0,2
11975_1,,,,2,2,1,3
11977_0,,,,2,2,1,3
C(C(CO)(C(C(CO)=CC)O)O)=O,,,5,1,2,0,2
11977_1,,,,2,2,1,3
11979_0,,,,2,2,1,3
C(C(CO)(C(C=C)O)O)=O,,,5,1,2,0,2
11979_1,,,,2,2,1,3
11981_0,,,,2,2,1,3
C(C(C=C)(C(C=O)(CO)O)O)(O)=O,,,5,1,3,0,3
11981_1,,,,2,2,1,3
11983_0,,,,2,2,1,3
C(C(CO)(C(C(CC)O)O)O)=O,,,5,1,2,0,2
11983_1,,,,2,2,1,3
11985_0,,,,2,2,1,3
C(C(CO)(C(CCCO)O)O)=O,,,5,1,2,0,2
11985_1,,,,2,2,1,3
11987_0,,,,2,2,1,3
C1(C(CCO1)(C(C=O)(CO)O)O)=O,,,5,1,2,0,2
11987_1,,,,2,2,1,3
11989_0,,,,2,2,1,3
C(C(CO)(C(CC(CO)C)O)O)=O,,,5,1,2,0,2
11989_1,,,,2,2,1,3
11990_0,,,,2,2,1,3
11990_1,,,,2,2,1,3
11991_0,,,,2,2,1,3
11991_1,,,,2,2,1,3
11992_0,,,,2,2,1,3
11992_1,,,,2,2,1,3
11993_0,,,,2,2,1,3
11993_1,,,,2,2,1,3
11994_0,,,,2,2,1,3
11994_1,,,,2,2,1,3
11995_0,,,,2,2,1,3
11995_1,,,,2,2,1,3
11996_0,,,,2,2,1,3
11996_1,,,,2,2,1,3
11997_0,,,,2,2,1,3
11997_1,,,,2,2,1,3
11998_0,,,,2,2,1,3
11998_1,,,,2,2,1,3
11999_0,,,,2,2,1,3
11999_1,,,,2,2,1,3
12000_0,,,,2,2,1,3
12000_1,,,,2,2,1,3
12001_0,,,,2,2,1,3
12001_1,,,,2,2,1,3
12002_0,,,,2,2,1,3
12002_1,,,,2,2,1,3
12003_0,,,,2,2,1,3
12003_1,,,,2,2,1,3
12004_0,,,,2,2,1,3
12004_1,,,,2,2,1,3
12005_0,,,,2,2,1,3
12005_1,,,,2,2,1,3
12006_0,,,,2,2,1,3
12006_1,,,,2,2,1,3
12007_0,,,,2,2,1,3
12007_1,,,,2,2,1,3
12008_0,,,,2,2,1,3
12009_0,,,,2,2,1,3
12010_0,,,,2,2,1,3
12011_0,,,,2,2,1,3
12011_1,,,,2,2,1,3
12012_0,,,,2,2,1,3
12012_1,,,,2,2,1,3
12013_0,,,,2,2,1,3
12013_1,,,,2,2,1,3
12015_0,,,,2,2,1,3
C(C(C(CO)=O)(C)C(CO)O)(O)=O,,,5,1,1,0,1
12017_0,,,,2,2,1,3
C(C(C(CC)=O)(C(CO)O)O)(O)=O,,,5,1,2,0,2
12017_1,,,,2,2,1,3
12019_0,,,,2,2,1,3
C(CC(C(CO)(C(CO)O)O)=O)=O,,,5,1,2,0,2
12019_1,,,,2,2,1,3
12021_0,,,,2,2,1,3
C(C(C(C(C)O)=O)(C(CO)O)O)=O,,,5,1,2,0,2
12021_1,,,,2,2,1,3
12023_0,,,,2,2,1,3
C(C(C(C(O)=O)=O)(C(CO)O)O)=O,,,5,1,2,0,2
12023_1,,,,2,2,1,3
12025_0,,,,2,2,1,3
C(C)(C(C(CO)=O)(C(CO)O)O)=O,,,5,1,2,0,2
12025_1,,,,2,2,1,3
12027_0,,,,2,2,1,3
C(C(CO)(C(CO)O)C(C)O)(O)=O,,,5,1,3,0,3
12029_0,,,,2,2,1,3
C(C(C(CO)O)C(CCO)O)(O)=O,,,5,1,1,0,1
12031_0,,,,2,2,1,3
C(C(CO)(CO)C(CO)O)(O)=O,,,5,1,3,0,3
12033_0,,,,2,2,1,3
C(C(C(O)=O)(CO)C(CO)O)(O)=O,,,5,1,3,0,3
12035_0,,,,2,2,1,3
C(C(C=O)(C(CO)O)CC=O)=O,,,5,1,1,0,1
12036_0,,,,2,2,1,3
12036_1,,,,2,2,1,3
12037_0,,,,2,2,1,3
12037_1,,,,2,2,1,3
12038_0,,,,2,2,1,3
12038_1,,,,2,2,1,3
12040_0,,,,2,2,1,3
C1(C(C(CO)O)(C(C(C)O1)O)O)=O,,,5,1,2,0,2
12040_1,,,,2,2,1,3
12042_0,,,,2,2,1,3
C1(C(C(CO)O)(C(C(O1)=O)O)O)=O,,,5,1,2,0,2
12042_1,,,,2,2,1,3
12044_0,,,,2,2,1,3
C(C(CO)(C(CO)O)CC=O)(O)=O,,,5,1,1,0,1
12046_0,,,,2,2,1,3
C(C(C)(C(CO)O)C(C=O)O)(O)=O,,,5,1,1,0,1
12048_0,,,,2,2,1,3
C1(C(O)OCC1(C(CO)O)O)=O,,,5,1,2,0,2
12048_1,,,,2,2,1,3
12050_0,,,,2,2,1,3
C1(C(O)OC(C)C1(C(CO)O)O)=O,,,5,1,2,0,2
12050_1,,,,2,2,1,3
12052_0,,,,2,2,1,3
C1(C(C(C(O)O1)=O)(C(CO)O)O)=O,,,5,1,2,0,2
12052_1,,,,2,2,1,3
12054_0,,,,2,2,1,3
C1(C(C(CO)O)C(CC(O)O1)O)=O,,,5,1,1,0,1
12056_0,,,,2,2,1,3
C1(C(C(CO)O)C(C(O1)=O)(C)O)=O,,,5,1,1,0,1
12057_0,,,,2,2,1,3
12057_1,,,,2,2,1,3
12058_0,,,,2,2,1,3
12059_0,,,,2,2,1,3
12060_0,,,,2,2,1,3
12061_0,,,,2,2,1,3
12062_0,,,,2,2,1,3
12063_0,,,,2,2,1,3
12064_0,,,,2,2,1,3
12064_1,,,,2,2,1,3
12065_0,,,,2,2,1,3
12065_1,,,,2,2,1,3
12066_0,,,,2,2,1,3
12066_1,,,,2,2,1,3
12067_0,,,,2,2,1,3
12067_1,,,,2,2,1,3
12068_0,,,,2,2,1,3
12069_0,,,,2,2,1,3
12070_0,,,,2,2,1,3
12071_0,,,,2,2,1,3
12071_1,,,,2,2,1,3
12072_0,,,,2,2,1,3
12072_1,,,,2,2,1,3
12073_0,,,,2,2,1,3
12073_1,,,,2,2,1,3
12074_0,,,,2,2,1,3
12076_0,,,,2,2,1,3
C(C(CO)(CO)C(C(C)O)O)(O)=O,,,5,1,1,0,1
12078_0,,,,2,2,1,3
C(C(C=O)(C(C(C)O)O)CC=O)=O,,,5,1,1,0,1
12080_0,,,,2,2,1,3
C1(C(O)OCC1(C(C(C)O)O)O)=O,,,5,1,2,0,2
12080_1,,,,2,2,1,3
12081_0,,,,2,2,1,3
12081_1,,,,2,2,1,3
12083_0,,,,2,2,1,3
C(C(CO)(C(C)O)C(C(C)O)O)=O,,,5,1,1,0,1
12085_0,,,,2,2,1,3
C(C(C=O)(CO)C(C(C)O)O)(O)=O,,,5,1,1,0,1
12087_0,,,,2,2,1,3
C(C(C(CO)(C(C(C)O)O)O)=O)=O,,,5,1,2,0,2
12087_1,,,,2,2,1,3
12089_0,,,,2,2,1,3
C(C(C=O)(C(C(C)O)O)O)=O,,,5,1,2,0,2
12089_1,,,,2,2,1,3
12091_0,,,,2,2,1,3
C(C(CO)C(C(C)O)O)(O)=O,,,5,1,1,0,1
12093_0,,,,2,2,1,3
C(C(C(C)O)C(C(C)O)O)(O)=O,,,5,1,1,0,1
12095_0,,,,2,2,1,3
C(C(C(O)=O)C(C(C)O)O)(O)=O,,,5,1,1,0,1
12096_0,,,,2,2,1,3
12096_1,,,,2,2,1,3
12097_0,,,,2,2,1,3
12097_1,,,,2,2,1,3
12099_0,,,,2,2,1,3
C(C(C=O)(C(C(C)O)O)O)(O)=O,,,5,1,2,0,2
12099_1,,,,2,2,1,3
12101_0,,,,2,2,1,3
C(C(CO)(CO)C(C(O)=O)O)(O)=O,,,5,1,1,0,1
12103_0,,,,2,2,1,3
C(C(C=O)(CC=O)C(C(O)=O)O)=O,,,5,1,1,0,1
12105_0,,,,2,2,1,3
C1(C(O)OCC1(C(C(O)=O)O)O)=O,,,5,1,2,0,2
12105_1,,,,2,2,1,3
12106_0,,,,2,2,1,3
12106_1,,,,2,2,1,3
12107_0,,,,2,2,1,3
12108_0,,,,2,2,1,3
12109_0,,,,2,2,1,3
12109_1,,,,2,2,1,3
12110_0,,,,2,2,1,3
12110_1,,,,2,2,1,3
12111_0,,,,2,2,1,3
12112_0,,,,2,2,1,3
12113_0,,,,2,2,1,3
12114_0,,,,2,2,1,3
12114_1,,,,2,2,1,3
12115_0,,,,2,2,1,3
12115_1,,,,2,2,1,3
12116_0,,,,2,2,1,3
12116_1,,,,2,2,1,3
12118_0,,,,2,2,1,3
C(C(C=O)(C(C(CO)=O)(C)O)O)=O,,,5,1,2,0,2
12118_1,,,,2,2,1,3
12120_0,,,,2,2,1,3
C(C(CO)C(C(CO)=O)(C)O)(O)=O,,,5,1,1,0,1
12122_0,,,,2,2,1,3
C(C(C=O)(C(C(C)=O)(CO)O)O)=O,,,5,1,2,0,2
12122_1,,,,2,2,1,3
12124_0,,,,2,2,1,3
C(C(CO)C(C(C)=O)(CO)O)(O)=O,,,5,1,1,0,1
12125_0,,,,2,2,1,3
12125_1,,,,2,2,1,3
12127_0,,,,2,2,1,3
C(C(C(C=O)O)(C(C=C)O)O)(O)=O,,,5,1,4,0,4
12127_1,,,,2,2,1,3
12128_0,,,,2,2,1,3
12128_1,,,,2,2,1,3
12129_0,,,,2,2,1,3
12129_1,,,,2,2,1,3
12130_0,,,,2,2,1,3
12130_1,,,,2,2,1,3
12131_0,,,,2,2,1,3
12131_1,,,,2,2,1,3
12133_0,,,,2,2,1,3
C(C(C(C=O)(C(C=C)O)O)O)(O)=O,,,5,1,3,0,3
12133_1,,,,2,2,1,3
12135_0,,,,2,2,1,3
C(C(C(C)O)(C(C(O)=O)O)O)=O,,,5,1,3,0,3
12135_1,,,,2,2,1,3
12136_0,,,,2,2,1,3
12136_1,,,,2,2,1,3
12137_0,,,,2,2,1,3
12137_1,,,,2,2,1,3
12138_0,,,,2,2,1,3
12138_1,,,,2,2,1,3
12140_0,,,,2,2,1,3
C(C(C=O)(C(C)(CC(O)=O)O)O)=O,,,5,1,2,0,2
12140_1,,,,2,2,1,3
12141_0,,,,2,2,1,3
12143_0,,,,2,2,1,3
C(C(CO)(C(C)(CCO)O)O)(O)=O,,,5,1,2,0,2
12143_1,,,,2,2,1,3
12145_0,,,,2,2,1,3
C(C(C=O)(C(C)(CCO)O)O)=O,,,5,1,2,0,2
12145_1,,,,2,2,1,3
12146_0,,,,2,2,1,3
12148_0,,,,2,2,1,3
C(C(C(C)O)C(C)(CCO)O)(O)=O,,,5,1,1,0,1
12150_0,,,,2,2,1,3
C(C(C(O)=O)C(C)(CCO)O)(O)=O,,,5,1,1,0,1
12152_0,,,,2,2,1,3
C(C(C=O)(C(C)(CCO)O)O)(O)=O,,,5,1,2,0,2
12152_1,,,,2,2,1,3
12154_0,,,,2,2,1,3
C(CO)(C(C(O)=O)(C)C(C=C)O)=O,,,5,1,1,0,1
12156_0,,,,2,2,1,3
C(C(C(CO)=O)(C)C(C)O)(O)=O,,,5,1,1,0,1
12158_0,,,,2,2,1,3
C(C(C(O)=O)(C(CO)=O)C)(O)=O,,,5,1,1,0,1
12160_0,,,,2,2,1,3
C(C(C(CO)=O)(CO)C)(O)=O,,,5,1,1,0,1
12162_0,,,,2,2,1,3
C(CO)(C(C(O)=O)(C)C(C=O)O)=O,,,5,1,1,0,1
12164_0,,,,2,2,1,3
C(CC)(C(C(O)=O)(C(C=C)O)O)=O,,,5,1,2,0,2
12164_1,,,,2,2,1,3
12166_0,,,,2,2,1,3
C(C(C(CC)=O)(C(C)O)O)(O)=O,,,5,1,3,0,3
12166_1,,,,2,2,1,3
12168_0,,,,2,2,1,3
C(C(C(O)=O)(C(CC)=O)O)(O)=O,,,5,1,3,0,3
12168_1,,,,2,2,1,3
12170_0,,,,2,2,1,3
C(C(C(CC)=O)(CO)O)(O)=O,,,5,1,3,0,3
12170_1,,,,2,2,1,3
12172_0,,,,2,2,1,3
C(CC)(C(C(O)=O)(C(C=O)O)O)=O,,,5,1,2,0,2
12172_1,,,,2,2,1,3
12174_0,,,,2,2,1,3
C(C(CO)(CO)C(C)(CO)O)(O)=O,,,5,1,1,0,1
12176_0,,,,2,2,1,3
C(C(C=O)(C(C)(CO)O)CC=O)=O,,,5,1,1,0,1
12178_0,,,,2,2,1,3
C1(C(O)OCC1(C(CO)(C)O)O)=O,,,5,1,2,0,2
12178_1,,,,2,2,1,3
12179_0,,,,2,2,1,3
12179_1,,,,2,2,1,3
12181_0,,,,2,2,1,3
C(C(CO)(C(C)O)C(C)(CO)O)=O,,,5,1,1,0,1
12183_0,,,,2,2,1,3
C(C(C=O)(CO)C(C)(CO)O)(O)=O,,,5,1,1,0,1
12185_0,,,,2,2,1,3
C(C(C(CO)(C(CO)(C)O)O)=O)=O,,,5,1,2,0,2
12185_1,,,,2,2,1,3
12187_0,,,,2,2,1,3
C(C(C=O)(C(CO)(C)O)O)=O,,,5,1,2,0,2
12187_1,,,,2,2,1,3
12189_0,,,,2,2,1,3
C(C(CO)C(C)(CO)O)(O)=O,,,5,1,1,0,1
12191_0,,,,2,2,1,3
C(C(C(C)O)C(C)(CO)O)(O)=O,,,5,1,1,0,1
12193_0,,,,2,2,1,3
C(C(C(O)=O)C(C)(CO)O)(O)=O,,,5,1,1,0,1
12195_0,,,,2,2,1,3
C(C(C(C)O)(C(CO)(C)O)O)(O)=O,,,5,1,2,0,2
12195_1,,,,2,2,1,3
12197_0,,,,2,2,1,3
C(C(C(O)=O)(C(CO)(C)O)O)(O)=O,,,5,1,2,0,2
12197_1,,,,2,2,1,3
12199_0,,,,2,2,1,3
C(C(C=O)(C(CO)(C)O)O)(O)=O,,,5,1,2,0,2
12199_1,,,,2,2,1,3
12201_0,,,,2,2,1,3
C(C(CO)(C(C=C)O)O)(CC=O)=O,,,5,1,2,0,2
12201_1,,,,2,2,1,3
12203_0,,,,2,2,1,3
C(CC(C(CO)(C(C)O)O)=O)=O,,,5,1,2,0,2
12203_1,,,,2,2,1,3
12205_0,,,,2,2,1,3
C(C(C(CC=O)=O)(CO)O)(O)=O,,,5,1,4,0,4
12205_1,,,,2,2,1,3
12207_0,,,,2,2,1,3
C(CC(C(CO)(CO)O)=O)=O,,,5,1,2,0,2
12207_1,,,,2,2,1,3
12209_0,,,,2,2,1,3
C(C(CO)(C(C=O)O)O)(CC=O)=O,,,5,1,2,0,2
12209_1,,,,2,2,1,3
12211_0,,,,2,2,1,3
C(C(C)O)(C(C=O)(C(C=C)O)O)=O,,,5,1,2,0,2
12211_1,,,,2,2,1,3
12213_0,,,,2,2,1,3
C(C(C(C(C)O)=O)(C(C)O)O)=O,,,5,1,2,0,2
12213_1,,,,2,2,1,3
12215_0,,,,2,2,1,3
C(C(C=O)(C(C(C)O)=O)O)(O)=O,,,5,1,2,0,2
12215_1,,,,2,2,1,3
12217_0,,,,2,2,1,3
C(C(C(C(C)O)=O)(CO)O)=O,,,5,1,2,0,2
12217_1,,,,2,2,1,3
12219_0,,,,2,2,1,3
C(C(C)O)(C(C=O)(C(C=O)O)O)=O,,,5,1,2,0,2
12219_1,,,,2,2,1,3
12221_0,,,,2,2,1,3
C(C(C(C(O)=O)=O)(C(C=C)O)O)=O,,,5,1,2,0,2
12221_1,,,,2,2,1,3
12223_0,,,,2,2,1,3
C(C(C(C(O)=O)=O)(C(C)O)O)=O,,,5,1,2,0,2
12223_1,,,,2,2,1,3
12225_0,,,,2,2,1,3
C(C(C=O)(C(C(O)=O)=O)O)(O)=O,,,5,1,2,0,2
12225_1,,,,2,2,1,3
12226_0,,,,2,2,1,3
12226_1,,,,2,2,1,3
12228_0,,,,2,2,1,3
C(C(C(C(O)=O)=O)(C(C=O)O)O)=O,,,5,1,2,0,2
12228_1,,,,2,2,1,3
12230_0,,,,2,2,1,3
C(CO)(C(C(C)=O)(C(C=C)O)O)=O,,,5,1,2,0,2
12230_1,,,,2,2,1,3
12232_0,,,,2,2,1,3
C(C)(C(C(CO)=O)(C(C)O)O)=O,,,5,1,2,0,2
12232_1,,,,2,2,1,3
12233_0,,,,2,2,1,3
12233_1,,,,2,2,1,3
12235_0,,,,2,2,1,3
C(C)(C(C(CO)=O)(CO)O)=O,,,5,1,2,0,2
12235_1,,,,2,2,1,3
12237_0,,,,2,2,1,3
C(C(C(C(CO)=O)(C(C)=O)O)O)=O,,,5,1,2,0,2
12237_1,,,,2,2,1,3
12238_0,,,,2,2,1,3
12238_1,,,,2,2,1,3
12239_0,,,,2,2,1,3
12239_1,,,,2,2,1,3
12240_0,,,,2,2,1,3
12240_1,,,,2,2,1,3
12241_0,,,,2,2,1,3
12241_1,,,,2,2,1,3
12243_0,,,,2,2,1,3
C(C(CO)(C(C)O)C(C=C)O)(O)=O,,,5,1,1,0,1
12244_0,,,,2,2,1,3
12245_0,,,,2,2,1,3
12246_0,,,,2,2,1,3
12247_0,,,,2,2,1,3
12249_0,,,,2,2,1,3
C(C(C(CCO)O)C(C=C)O)(O)=O,,,5,1,1,0,1
12250_0,,,,2,2,1,3
12251_0,,,,2,2,1,3
12252_0,,,,2,2,1,3
12253_0,,,,2,2,1,3
12255_0,,,,2,2,1,3
C(C(CO)(CO)C(C=C)O)(O)=O,,,5,1,1,0,1
12256_0,,,,2,2,1,3
12257_0,,,,2,2,1,3
12258_0,,,,2,2,1,3
12259_0,,,,2,2,1,3
12260_0,,,,2,2,1,3
12261_0,,,,2,2,1,3
12262_0,,,,2,2,1,3
12264_0,,,,2,2,1,3
C(C(C(O)=O)(CO)C(C=C)O)(O)=O,,,5,1,1,0,1
12265_0,,,,2,2,1,3
12266_0,,,,2,2,1,3
12267_0,,,,2,2,1,3
12268_0,,,,2,2,1,3
12269_0,,,,2,2,1,3
12269_1,,,,2,2,1,3
12270_0,,,,2,2,1,3
12271_0,,,,2,2,1,3
12272_0,,,,2,2,1,3
12273_0,,,,2,2,1,3
12274_0,,,,2,2,1,3
12275_0,,,,2,2,1,3
12276_0,,,,2,2,1,3
12277_0,,,,2,2,1,3
12278_0,,,,2,2,1,3
12279_0,,,,2,2,1,3
12280_0,,,,2,2,1,3
12281_0,,,,2,2,1,3
12282_0,,,,2,2,1,3
12283_0,,,,2,2,1,3
12284_0,,,,2,2,1,3
12285_0,,,,2,2,1,3
12286_0,,,,2,2,1,3
12287_0,,,,2,2,1,3
12288_0,,,,2,2,1,3
12289_0,,,,2,2,1,3
12290_0,,,,2,2,1,3
12291_0,,,,2,2,1,3
12292_0,,,,2,2,1,3
12292_1,,,,2,2,1,3
12293_0,,,,2,2,1,3
12293_1,,,,2,2,1,3
12294_0,,,,2,2,1,3
12294_1,,,,2,2,1,3
12295_0,,,,2,2,1,3
12296_0,,,,2,2,1,3
12297_0,,,,2,2,1,3
12298_0,,,,2,2,1,3
12299_0,,,,2,2,1,3
12300_0,,,,2,2,1,3
12300_1,,,,2,2,1,3
12301_0,,,,2,2,1,3
12302_0,,,,2,2,1,3
12303_0,,,,2,2,1,3
12303_1,,,,2,2,1,3
12304_0,,,,2,2,1,3
12304_1,,,,2,2,1,3
12305_0,,,,2,2,1,3
12305_1,,,,2,2,1,3
12307_0,,,,2,2,1,3
C(C(C)(C(C=O)(C(C)O)O)O)(O)=O,,,5,1,3,0,3
12307_1,,,,2,2,1,3
12308_0,,,,2,2,1,3
12308_1,,,,2,2,1,3
12309_0,,,,2,2,1,3
12309_1,,,,2,2,1,3
12310_0,,,,2,2,1,3
12310_1,,,,2,2,1,3
12311_0,,,,2,2,1,3
12311_1,,,,2,2,1,3
12312_0,,,,2,2,1,3
12312_1,,,,2,2,1,3
12313_0,,,,2,2,1,3
12313_1,,,,2,2,1,3
12314_0,,,,2,2,1,3
12314_1,,,,2,2,1,3
12315_0,,,,2,2,1,3
12315_1,,,,2,2,1,3
12317_0,,,,2,2,1,3
C1(C(C(C)O)(C(C(O1)=O)(C)O)O)=O,,,5,1,2,0,2
12317_1,,,,2,2,1,3
12319_0,,,,2,2,1,3
C1(C(C(O)=O)(C(C(O1)=O)(C)O)O)=O,,,5,1,2,0,2
12319_1,,,,2,2,1,3
12320_0,,,,2,2,1,3
12320_1,,,,2,2,1,3
12322_0,,,,2,2,1,3
C(C(C=O)(C(C(C(O)=O)=C)O)O)=O,,,5,1,2,0,2
12322_1,,,,2,2,1,3
12324_0,,,,2,2,1,3
C(C(CO)C(C(C(O)=O)=C)O)(O)=O,,,5,1,1,0,1
12326_0,,,,2,2,1,3
C(C(C=O)(CO)C(C=O)C(C)O)=O,,,5,1,1,0,1
12328_0,,,,2,2,1,3
C(C(C=O)C(C=O)(CO)C(C)O)=O,,,5,1,1,0,1
12330_0,,,,2,2,1,3
C(C(C=O)(CO)C(C(O)=O)C=O)=O,,,5,1,1,0,1
12332_0,,,,2,2,1,3
C(C(C=O)(CO)C(C=O)C=O)(O)=O,,,5,1,1,0,1
12334_0,,,,2,2,1,3
C(C(C(C(C=O)=O)=O)(CO)CO)=O,,,5,1,1,0,1
12336_0,,,,2,2,1,3
C(C(C=O)(CO)C(C(C=O)=O)O)=O,,,5,1,1,0,1
12338_0,,,,2,2,1,3
C(C(C=O)(CC=O)C(C=C)O)=O,,,5,1,1,0,1
12340_0,,,,2,2,1,3
C(C(C=O)(C(C)O)CC=O)=O,,,5,1,1,0,1
12342_0,,,,2,2,1,3
C(C(C=O)(C(O)=O)CC=O)=O,,,5,1,1,0,1
12344_0,,,,2,2,1,3
C(C(C=O)(CO)CC=O)=O,,,5,1,1,0,1
12346_0,,,,2,2,1,3
C(C(C=O)(C(CCO)O)CC=O)=O,,,5,1,1,0,1
12348_0,,,,2,2,1,3
C(C(C=O)(CC=O)C(C=O)O)=O,,,5,1,1,0,1
12350_0,,,,2,2,1,3
C(C(C=O)(CC=O)C(C=CC)O)=O,,,5,1,1,0,1
12352_0,,,,2,2,1,3
C(C(C=O)(C(CC=C)O)CC=O)=O,,,5,1,1,0,1
12354_0,,,,2,2,1,3
C(C(C=O)(CO)CC(C(O)=O)=O)=O,,,5,1,1,0,1
12356_0,,,,2,2,1,3
C(C(C=O)(C(CC(C=O)=O)O)O)=O,,,5,1,2,0,2
12356_1,,,,2,2,1,3
12357_0,,,,2,2,1,3
12359_0,,,,2,2,1,3
C(C(C=O)(C(C(CC=O)=O)O)O)=O,,,5,1,2,0,2
12359_1,,,,2,2,1,3
12361_0,,,,2,2,1,3
C(C(CO)C(C(CC=O)=O)O)(O)=O,,,5,1,1,0,1
12363_0,,,,2,2,1,3
C(C(C=O)(C(C=O)(CC=O)O)O)=O,,,5,1,3,0,3
12363_1,,,,2,2,1,3
12365_0,,,,2,2,1,3
C(C(CO)C(C=O)(CC=O)O)(O)=O,,,5,1,1,0,1
12367_0,,,,2,2,1,3
C(C(C(C(O)=O)=O)(CO)C(C)O)=O,,,5,1,1,0,1
12369_0,,,,2,2,1,3
C(C(C=O)(C(C(O)=O)=O)CO)(O)=O,,,5,1,1,0,1
12371_0,,,,2,2,1,3
C(C(C(C(O)=O)=O)(CO)CO)=O,,,5,1,1,0,1
12373_0,,,,2,2,1,3
C(C(C=O)(C(C)O)C(C(O)=O)O)=O,,,5,1,1,0,1
12375_0,,,,2,2,1,3
C(C(C=O)(C=O)C(C(O)=O)O)(O)=O,,,5,1,1,0,1
12377_0,,,,2,2,1,3
C(C(C=O)(CO)C(C(O)=O)O)=O,,,5,1,1,0,1
12379_0,,,,2,2,1,3
C(C(C=O)(C(C(O)=O)(CC)O)O)=O,,,5,1,2,0,2
12379_1,,,,2,2,1,3
12381_0,,,,2,2,1,3
C(C(CO)C(C(O)=O)(CC)O)(O)=O,,,5,1,1,0,1
12383_0,,,,2,2,1,3
C(C(C(C(O)=O)=O)(C)C(C)O)(O)=O,,,5,1,1,0,1
12385_0,,,,2,2,1,3
C(C(C(O)=O)(C(C(O)=O)=O)C)(O)=O,,,5,1,1,0,1
12387_0,,,,2,2,1,3
C(C(C(C(O)=O)=O)(C)CO)(O)=O,,,5,1,1,0,1
12388_0,,,,2,2,1,3
12388_1,,,,2,2,1,3
12390_0,,,,2,2,1,3
C(C(C=O)(C(C)(C(C)O)O)O)=O,,,5,1,2,0,2
12390_1,,,,2,2,1,3
12392_0,,,,2,2,1,3
C(C(CO)C(C)(C(C)O)O)(O)=O,,,5,1,1,0,1
12394_0,,,,2,2,1,3
C(C(C(C)O)C(C)(C(C)O)O)(O)=O,,,5,1,1,0,1
12396_0,,,,2,2,1,3
C(C(C(O)=O)C(C)(C(C)O)O)(O)=O,,,5,1,1,0,1
12398_0,,,,2,2,1,3
C(C(C=O)(C(C)(C(C)O)O)O)(O)=O,,,5,1,2,0,2
12398_1,,,,2,2,1,3
12400_0,,,,2,2,1,3
C(C(CO)(C(CO)(CC)O)O)(O)=O,,,5,1,2,0,2
12400_1,,,,2,2,1,3
12402_0,,,,2,2,1,3
C(C(C=O)(C(CO)(CC)O)O)=O,,,5,1,2,0,2
12402_1,,,,2,2,1,3
12404_0,,,,2,2,1,3
C(C(CO)C(CO)(CC)O)(O)=O,,,5,1,1,0,1
12406_0,,,,2,2,1,3
C(C(C(C)O)C(CO)(CC)O)(O)=O,,,5,1,1,0,1
12408_0,,,,2,2,1,3
C(C(C(O)=O)C(CO)(CC)O)(O)=O,,,5,1,1,0,1
12410_0,,,,2,2,1,3
C(C(C=O)(C(CO)(CC)O)O)(O)=O,,,5,1,2,0,2
12410_1,,,,2,2,1,3
12412_0,,,,2,2,1,3
C1(C(C(C(C(O1)=O)(CO)O)=O)C)=O,,,5,1,2,0,2
12412_1,,,,2,2,1,3
12414_0,,,,2,2,1,3
C1(C(C(C(C(O1)=O)O)=O)(CO)C)=O,,,5,1,1,0,1
12416_0,,,,2,2,1,3
C1(C(C=O)(CO)C(C(O1)=O)(C)O)=O,,,5,1,1,0,1
12418_0,,,,2,2,1,3
C1(C(C(C(C(O)=O)(CO)O1)=O)C)=O,,,5,1,2,0,2
12418_1,,,,2,2,1,3
12420_0,,,,2,2,1,3
C1(C(C(C(C(O)=O)O1)=O)(C)CO)=O,,,5,1,1,0,1
12422_0,,,,2,2,1,3
C(C(C=CC(C)O)(CO)C(C)O)=O,,,5,1,1,0,1
12424_0,,,,2,2,1,3
C(C(C=O)(C=CC(C)O)CO)(O)=O,,,5,1,1,0,1
12426_0,,,,2,2,1,3
C(C(C=CC(O)=O)(CO)C(C)O)=O,,,5,1,1,0,1
12428_0,,,,2,2,1,3
C(C(CO)C(C(C=O)=CC)O)(O)=O,,,5,1,1,0,1
12430_0,,,,2,2,1,3
C(C(C=O)(C(C(C(C)O)=C)O)O)=O,,,5,1,2,0,2
12430_1,,,,2,2,1,3
12432_0,,,,2,2,1,3
C(C(CO)C(C(C(C)O)=C)O)(O)=O,,,5,1,1,0,1
12434_0,,,,2,2,1,3
C(C(C=O)(C(C(CO)=CC)O)O)=O,,,5,1,2,0,2
12434_1,,,,2,2,1,3
12436_0,,,,2,2,1,3
C(C(CO)C(C(CO)=CC)O)(O)=O,,,5,1,1,0,1
12438_0,,,,2,2,1,3
C(C(C=O)(C=CC(O)=O)CO)(O)=O,,,5,1,1,0,1
12440_0,,,,2,2,1,3
C(C(C(C=C)O)(C(C=C)O)O)(O)=O,,,5,1,2,0,2
12440_1,,,,2,2,1,3
12442_0,,,,2,2,1,3
C(C(C(C(C)=O)(C(C=C)O)O)O)=O,,,5,1,2,0,2
12442_1,,,,2,2,1,3
12443_0,,,,2,2,1,3
12443_1,,,,2,2,1,3
12445_0,,,,2,2,1,3
C1(C(C(C(C)O1)O)(C(C=C)O)O)=O,,,5,1,2,0,2
12445_1,,,,2,2,1,3
12447_0,,,,2,2,1,3
C1(C(C(C(O1)=O)(C(C=C)O)O)O)=O,,,5,1,2,0,2
12447_1,,,,2,2,1,3
12449_0,,,,2,2,1,3
C(C(CO)(C(C=C)O)CC=O)(O)=O,,,5,1,1,0,1
12451_0,,,,2,2,1,3
C(C(C)(C(C=O)O)C(C=C)O)(O)=O,,,5,1,1,0,1
12453_0,,,,2,2,1,3
C1(C(O)OCC1(C(C=C)O)O)=O,,,5,1,2,0,2
12453_1,,,,2,2,1,3
12455_0,,,,2,2,1,3
C1(C(O)OC(C)C1(C(C=C)O)O)=O,,,5,1,2,0,2
12455_1,,,,2,2,1,3
12457_0,,,,2,2,1,3
C1(C(C(C(O)O1)=O)(C(C=C)O)O)=O,,,5,1,2,0,2
12457_1,,,,2,2,1,3
12459_0,,,,2,2,1,3
C1(C(C(CC(O)O1)O)C(C=C)O)=O,,,5,1,1,0,1
12461_0,,,,2,2,1,3
C1(C(C)(C(C(O1)=O)C(C=C)O)O)=O,,,5,1,1,0,1
12463_0,,,,2,2,1,3
C(C(CO)(C(C=C)O)O)(O)=O,,,5,1,6,0,6
12463_1,,,,2,2,1,3
12465_0,,,,2,2,1,3
C(C(CO)(C(C)O)C(C=C)O)=O,,,5,1,2,0,2
12467_0,,,,2,2,1,3
C(C(C(C)O)(C(C)O)C(C=C)O)=O,,,5,1,1,0,1
12469_0,,,,2,2,1,3
C(C(C=O)(C(C)O)C(C=C)O)(O)=O,,,5,1,1,0,1
12471_0,,,,2,2,1,3
C(C(C(CC=O)O)C(C=C)O)(O)=O,,,5,1,1,0,1
12473_0,,,,2,2,1,3
C(C(C=O)(CO)C(C=C)O)(O)=O,,,5,1,2,0,2
12475_0,,,,2,2,1,3
C(C(C(O)=O)(C=O)C(C=C)O)(O)=O,,,5,1,1,0,1
12477_0,,,,2,2,1,3
C=CC(C(C(C=O)=O)(CO)O)O,,,5,1,3,0,3
12477_1,,,,2,2,1,3
12479_0,,,,2,2,1,3
C=CC(C(C(C=O)=O)(C(C)O)O)O,,,5,1,2,0,2
12479_1,,,,2,2,1,3
12481_0,,,,2,2,1,3
C(C(C(C=O)=O)(C(C=C)O)O)(O)=O,,,5,1,2,0,2
12481_1,,,,2,2,1,3
12483_0,,,,2,2,1,3
C(C(C=O)(C(C=C)O)O)=O,,,5,1,3,0,3
12483_1,,,,2,2,1,3
12485_0,,,,2,2,1,3
C(C(CO)C(C=C)O)(O)=O,,,5,1,2,0,2
12487_0,,,,2,2,1,3
C(C(C(C)O)C(C=C)O)(O)=O,,,5,1,2,0,2
12489_0,,,,2,2,1,3
C(C(C(O)=O)C(C=C)O)(O)=O,,,5,1,2,0,2
12491_0,,,,2,2,1,3
C(C(C(C)O)(C(C=C)O)O)(O)=O,,,5,1,6,0,6
12491_1,,,,2,2,1,3
12493_0,,,,2,2,1,3
C(C(C(O)=O)(C(C=C)O)O)(O)=O,,,5,1,6,0,6
12493_1,,,,2,2,1,3
12495_0,,,,2,2,1,3
C(C(C=O)(C(C=C)O)O)(O)=O,,,5,1,3,0,3
12495_1,,,,2,2,1,3
12497_0,,,,2,2,1,3
C(C)(C(C(O)=O)(CO)C(C=C)O)=O,,,5,1,1,0,1
12499_0,,,,2,2,1,3
C(C(C=C)(C(C=O)(C=O)O)O)(O)=O,,,5,1,3,0,3
12499_1,,,,2,2,1,3
12501_0,,,,2,2,1,3
C(C(C=C)(C(C(O)=O)CO)O)(O)=O,,,5,1,1,0,1
12502_0,,,,2,2,1,3
12502_1,,,,2,2,1,3
12503_0,,,,2,2,1,3
12503_1,,,,2,2,1,3
12504_0,,,,2,2,1,3
12504_1,,,,2,2,1,3
12505_0,,,,2,2,1,3
12505_1,,,,2,2,1,3
12507_0,,,,2,2,1,3
C1(C(CO)(C(C(C(O1)=O)=C)O)O)=O,,,5,1,2,0,2
12507_1,,,,2,2,1,3
12509_0,,,,2,2,1,3
C(C1(CO)C(C(C(O1)=O)=C)O)(O)=O,,,5,1,2,0,2
12509_1,,,,2,2,1,3
12510_0,,,,2,2,1,3
12511_0,,,,2,2,1,3
12512_0,,,,2,2,1,3
12513_0,,,,2,2,1,3
12513_1,,,,2,2,1,3
12514_0,,,,2,2,1,3
12514_1,,,,2,2,1,3
12515_0,,,,2,2,1,3
12515_1,,,,2,2,1,3
12517_0,,,,2,2,1,3
C(C)(C(C(C)O)(C(C=O)O)O)=O,,,5,1,2,0,2
12517_1,,,,2,2,1,3
12519_0,,,,2,2,1,3
C(C(C(C)=O)(C(C=O)O)O)(O)=O,,,5,1,2,0,2
12519_1,,,,2,2,1,3
12520_0,,,,2,2,1,3
12520_1,,,,2,2,1,3
12522_0,,,,2,2,1,3
C(C(C(C(C)=O)(C(C=O)O)O)O)=O,,,5,1,2,0,2
12522_1,,,,2,2,1,3
12523_0,,,,2,2,1,3
12523_1,,,,2,2,1,3
12524_0,,,,2,2,1,3
12524_1,,,,2,2,1,3
12525_0,,,,2,2,1,3
12525_1,,,,2,2,1,3
12527_0,,,,2,2,1,3
C(C(C(C=O)(C(C(C)=O)O)O)O)=O,,,5,1,3,0,3
12527_1,,,,2,2,1,3
12528_0,,,,2,2,1,3
12529_0,,,,2,2,1,3
12530_0,,,,2,2,1,3
12532_0,,,,2,2,1,3
C1(C(C(C)O)(C(C(C)O1)O)O)=O,,,5,1,3,0,3
12532_1,,,,2,2,1,3
12534_0,,,,2,2,1,3
C1(C(C(O)=O)(C(C(C)O1)O)O)=O,,,5,1,3,0,3
12534_1,,,,2,2,1,3
12536_0,,,,2,2,1,3
C1(C(CO)(C(C(C)O1)O)O)=O,,,5,1,3,0,3
12536_1,,,,2,2,1,3
12538_0,,,,2,2,1,3
C1(C(C(C(C)O1)O)(C(C=O)O)O)=O,,,5,1,2,0,2
12538_1,,,,2,2,1,3
12540_0,,,,2,2,1,3
C1(C(C(C)O)(C(C(O1)=O)O)O)=O,,,5,1,4,0,4
12540_1,,,,2,2,1,3
12542_0,,,,2,2,1,3
C1(C(C(O)=O)(C(C(O1)=O)O)O)=O,,,5,1,4,0,4
12542_1,,,,2,2,1,3
12544_0,,,,2,2,1,3
C1(C(CO)(C(C(O1)=O)O)O)=O,,,5,1,4,0,4
12544_1,,,,2,2,1,3
12546_0,,,,2,2,1,3
C1(C(C(C(O1)=O)(C(C=O)O)O)O)=O,,,5,1,3,0,3
12546_1,,,,2,2,1,3
12548_0,,,,2,2,1,3
C(C(CO)(C(C(CC)O)O)O)(O)=O,,,5,1,3,0,3
12548_1,,,,2,2,1,3
12550_0,,,,2,2,1,3
C(C(C=O)(C(C(CC)O)O)O)=O,,,5,1,3,0,3
12550_1,,,,2,2,1,3
12552_0,,,,2,2,1,3
C(C(CO)C(C(CC)O)O)(O)=O,,,5,1,2,0,2
12554_0,,,,2,2,1,3
C(C(C(C)O)C(C(CC)O)O)(O)=O,,,5,1,2,0,2
12556_0,,,,2,2,1,3
C(C(C(O)=O)C(C(CC)O)O)(O)=O,,,5,1,2,0,2
12558_0,,,,2,2,1,3
C(C(C=O)(C(C(CC)O)O)O)(O)=O,,,5,1,3,0,3
12558_1,,,,2,2,1,3
12560_0,,,,2,2,1,3
C(C(CO)(C(CCCO)O)O)(O)=O,,,5,1,3,0,3
12560_1,,,,2,2,1,3
12562_0,,,,2,2,1,3
C(C(C=O)(C(CCCO)O)O)=O,,,5,1,3,0,3
12562_1,,,,2,2,1,3
12564_0,,,,2,2,1,3
C(C(CO)C(CCCO)O)(O)=O,,,5,1,2,0,2
12566_0,,,,2,2,1,3
C(C(C(C)O)C(CCCO)O)(O)=O,,,5,1,2,0,2
12568_0,,,,2,2,1,3
C(C(C(O)=O)C(CCCO)O)(O)=O,,,5,1,2,0,2
12570_0,,,,2,2,1,3
C(C(C=O)(C(CCCO)O)O)(O)=O,,,5,1,3,0,3
12570_1,,,,2,2,1,3
12572_0,,,,2,2,1,3
C(C(CO)(C(C)O)CC=O)(O)=O,,,5,1,1,0,1
12574_0,,,,2,2,1,3
C(C(C(O)=O)(CO)CC=O)(O)=O,,,5,1,1,0,1
12576_0,,,,2,2,1,3
C(C(CO)(CO)CC=O)(O)=O,,,5,1,1,0,1
12578_0,,,,2,2,1,3
C(C(CO)(C(C=O)O)CC=O)(O)=O,,,5,1,1,0,1
12580_0,,,,2,2,1,3
C(C(C)(C(C)O)C(C=O)O)(O)=O,,,5,1,1,0,1
12582_0,,,,2,2,1,3
C(C(C(O)=O)(C)C(C=O)O)(O)=O,,,5,1,1,0,1
12584_0,,,,2,2,1,3
C(C(CO)(C)C(C=O)O)(O)=O,,,5,1,1,0,1
12586_0,,,,2,2,1,3
C(C(C)(C(C=O)O)C(C=O)O)(O)=O,,,5,1,1,0,1
12588_0,,,,2,2,1,3
C1(C(CO)(C)C(C(C(O1)=O)=O)O)=O,,,5,1,1,0,1
12590_0,,,,2,2,1,3
C1(C(CO)(CO)CC(C(O1)=O)=O)=O,,,5,1,1,0,1
12592_0,,,,2,2,1,3
C1(C(O)OCC1(C(C)O)O)=O,,,5,1,3,0,3
12592_1,,,,2,2,1,3
12594_0,,,,2,2,1,3
C(C1(C(C(O)OC1)=O)O)(O)=O,,,5,1,3,0,3
12594_1,,,,2,2,1,3
12596_0,,,,2,2,1,3
C1(C(O)OCC1(CO)O)=O,,,5,1,3,0,3
12596_1,,,,2,2,1,3
12598_0,,,,2,2,1,3
C1(C(O)OCC1(C(CCO)O)O)=O,,,5,1,3,0,3
12598_1,,,,2,2,1,3
12600_0,,,,2,2,1,3
C1(C(O)OCC1(C(C=O)O)O)=O,,,5,1,3,0,3
12600_1,,,,2,2,1,3
12602_0,,,,2,2,1,3
C1(C(O)OCC1(C(C=CC)O)O)=O,,,5,1,3,0,3
12602_1,,,,2,2,1,3
12604_0,,,,2,2,1,3
C1(C(O)OCC1(C(CC=C)O)O)=O,,,5,1,3,0,3
12604_1,,,,2,2,1,3
12606_0,,,,2,2,1,3
C1(C(O)OC(C)C1(C(C)O)O)=O,,,5,1,3,0,3
12606_1,,,,2,2,1,3
12608_0,,,,2,2,1,3
C(C1(C(C(O)OC1C)=O)O)(O)=O,,,5,1,3,0,3
12608_1,,,,2,2,1,3
12610_0,,,,2,2,1,3
C1(C(O)OC(C)C1(CO)O)=O,,,5,1,3,0,3
12610_1,,,,2,2,1,3
12612_0,,,,2,2,1,3
C1(C(O)OC(C)C1(C(C=O)O)O)=O,,,5,1,3,0,3
12612_1,,,,2,2,1,3
12614_0,,,,2,2,1,3
C1(C(C(C(O)O1)=O)(C(C)O)O)=O,,,5,1,3,0,3
12614_1,,,,2,2,1,3
12616_0,,,,2,2,1,3
C1(C(C(O)=O)(C(C(O)O1)=O)O)=O,,,5,1,3,0,3
12616_1,,,,2,2,1,3
12618_0,,,,2,2,1,3
C1(C(C(C(O)O1)=O)(CO)O)=O,,,5,1,3,0,3
12618_1,,,,2,2,1,3
12620_0,,,,2,2,1,3
C1(C(C(C(O)O1)=O)(C(C=O)O)O)=O,,,5,1,3,0,3
12620_1,,,,2,2,1,3
12621_0,,,,2,2,1,3
12621_1,,,,2,2,1,3
12622_0,,,,2,2,1,3
12622_1,,,,2,2,1,3
12624_0,,,,2,2,1,3
C1(C(C(C)O)C(CC(O)O1)O)=O,,,5,1,2,0,2
12626_0,,,,2,2,1,3
C1(C(C(O)=O)C(CC(O)O1)O)=O,,,5,1,2,0,2
12628_0,,,,2,2,1,3
C1(C(CO)C(CC(O)O1)O)=O,,,5,1,2,0,2
12630_0,,,,2,2,1,3
C1(C(C(CC(O)O1)O)C(C=O)O)=O,,,5,1,2,0,2
12632_0,,,,2,2,1,3
C(C1(CO)C(C)OC(C1(C)O)=O)=O,,,5,1,1,0,1
12634_0,,,,2,2,1,3
C1(C(C(CO1)(C(C)O)C(C)O)=O)=O,,,5,1,1,0,1
12636_0,,,,2,2,1,3
C(C1(C(C(OC1)=O)=O)C(C)O)(O)=O,,,5,1,2,0,2
12638_0,,,,2,2,1,3
C1(C(C(CO1)(CO)C(C)O)=O)=O,,,5,1,2,0,2
12640_0,,,,2,2,1,3
C1(CC(C(C(C=O)=O)(CO)O1)O)=O,,,5,1,2,0,2
12640_1,,,,2,2,1,3
12642_0,,,,2,2,1,3
C1(C(CO)C(C(C(C=O)=O)O1)O)=O,,,5,1,1,0,1
12644_0,,,,2,2,1,3
C(C(C1CC(C(O1)=O)=O)CO)(O)=O,,,5,1,1,0,1
12646_0,,,,2,2,1,3
C1(C(C=O)(CO)C(C=O)(CO1)O)=O,,,5,1,1,0,1
12648_0,,,,2,2,1,3
C(C1(COC(C1(C)O)=O)C(C)O)=O,,,5,1,1,0,1
12650_0,,,,2,2,1,3
C(C1(C=O)COC(C1(C)O)=O)(O)=O,,,5,1,1,0,1
12652_0,,,,2,2,1,3
C(C1(CO)COC(C1(C)O)=O)=O,,,5,1,2,0,2
12653_0,,,,2,2,1,3
12655_0,,,,2,2,1,3
C(C1(C(O)=O)C(C(OC1)=O)=O)(O)=O,,,5,1,1,0,1
12657_0,,,,2,2,1,3
C(C1(C(C(OC1)=O)=O)CO)(O)=O,,,5,1,2,0,2
12659_0,,,,2,2,1,3
C(C(C=O)(C1(C(OCC1)=O)O)O)=O,,,5,1,2,0,2
12659_1,,,,2,2,1,3
12661_0,,,,2,2,1,3
C(C(CO)C1(C(OCC1)=O)O)(O)=O,,,5,1,1,0,1
12663_0,,,,2,2,1,3
C1(C(C(C)O)C(C(O1)=O)(C)O)=O,,,5,1,2,0,2
12664_0,,,,2,2,1,3
12665_0,,,,2,2,1,3
12667_0,,,,2,2,1,3
C1(C(C)(C(C(O1)=O)C(C=O)O)O)=O,,,5,1,1,0,1
12669_0,,,,2,2,1,3
C(C1(C(CC(O1)=O)O)C(C)O)(O)=O,,,5,1,2,0,2
12669_1,,,,2,2,1,3
12671_0,,,,2,2,1,3
C(C1(C(O)=O)C(CC(O1)=O)O)(O)=O,,,5,1,2,0,2
12671_1,,,,2,2,1,3
12672_0,,,,2,2,1,3
12672_1,,,,2,2,1,3
12674_0,,,,2,2,1,3
C1(C(C(C(C(O)=O)O1)O)C(C)O)=O,,,5,1,1,0,1
12676_0,,,,2,2,1,3
C(C1C(OC(C(O)=O)C1O)=O)(O)=O,,,5,1,1,0,1
12678_0,,,,2,2,1,3
C1(C(CO)C(C(C(O)=O)O1)O)=O,,,5,1,3,0,3
12680_0,,,,2,2,1,3
C1(C(C(C)O)(C(C=O)(CO1)O)O)=O,,,5,1,2,0,2
12680_1,,,,2,2,1,3
12682_0,,,,2,2,1,3
C1(C(C(O)=O)(C(C=O)(CO1)O)O)=O,,,5,1,2,0,2
12682_1,,,,2,2,1,3
12683_0,,,,2,2,1,3
12683_1,,,,2,2,1,3
12685_0,,,,2,2,1,3
C(C1C(C(C(O1)=O)=O)(CO)O)(C)=O,,,5,1,2,0,2
12685_1,,,,2,2,1,3
12687_0,,,,2,2,1,3
C(C)(C1(CO)C(C(C(O1)=O)=O)O)=O,,,5,1,2,0,2
12687_1,,,,2,2,1,3
12689_0,,,,2,2,1,3
C1(C2(CO)C(C(C(O2)=O)(C)O1)O)=O,,,5,1,2,0,2
12689_1,,,,2,2,1,3
12691_0,,,,2,2,1,3
C1(C(C=O)(CO)C(CC(C)O1)O)=O,,,5,1,1,0,1
12693_0,,,,2,2,1,3
C1(C(CO)C(C(C=O)C(C)O1)O)=O,,,5,1,1,0,1
12695_0,,,,2,2,1,3
C(C1(CO)C(CC(OC1C)=O)O)=O,,,5,1,1,0,1
12697_0,,,,2,2,1,3
C1(C(C=O)(CO)C(CC(O1)=O)O)=O,,,5,1,1,0,1
12699_0,,,,2,2,1,3
C1(C(C=O)C(C(C(O1)=O)CO)O)=O,,,5,1,1,0,1
12701_0,,,,2,2,1,3
C1(C(C=O)(CO)C(C(CO1)=O)O)=O,,,5,1,1,0,1
12703_0,,,,2,2,1,3
C1(C(C(C)O)(C(CC(C)O1)O)O)=O,,,5,1,2,0,2
12703_1,,,,2,2,1,3
12705_0,,,,2,2,1,3
C1(C(C(O)=O)(C(CC(C)O1)O)O)=O,,,5,1,2,0,2
12705_1,,,,2,2,1,3
12706_0,,,,2,2,1,3
12706_1,,,,2,2,1,3
12708_0,,,,2,2,1,3
C1(C(C(CC(O1)=O)O)(C(C)O)O)=O,,,5,1,2,0,2
12708_1,,,,2,2,1,3
12710_0,,,,2,2,1,3
C1(C(C(O)=O)(C(CC(O1)=O)O)O)=O,,,5,1,2,0,2
12710_1,,,,2,2,1,3
12711_0,,,,2,2,1,3
12711_1,,,,2,2,1,3
12713_0,,,,2,2,1,3
C1(C(C(C(C(O1)=O)O)O)C(C)O)=O,,,5,1,1,0,1
12715_0,,,,2,2,1,3
C1(C(C(O)=O)C(C(C(O1)=O)O)O)=O,,,5,1,1,0,1
12717_0,,,,2,2,1,3
C1(C(CO)C(C(C(O1)=O)O)O)=O,,,5,1,4,0,4
12719_0,,,,2,2,1,3
C1(C(C(C)O)(C(C(CO1)=O)O)O)=O,,,5,1,2,0,2
12719_1,,,,2,2,1,3
12721_0,,,,2,2,1,3
C1(C(C(O)=O)(C(C(CO1)=O)O)O)=O,,,5,1,2,0,2
12721_1,,,,2,2,1,3
12722_0,,,,2,2,1,3
12722_1,,,,2,2,1,3
12724_0,,,,2,2,1,3
C1(COC(C(C1(C(C)O)O)O)=O)=O,,,5,1,2,0,2
12724_1,,,,2,2,1,3
12726_0,,,,2,2,1,3
C(C1(C(COC(C1O)=O)=O)O)(O)=O,,,5,1,2,0,2
12726_1,,,,2,2,1,3
12728_0,,,,2,2,1,3
C1(COC(C(C1(CO)O)O)=O)=O,,,5,1,3,0,3
12728_1,,,,2,2,1,3
12730_0,,,,2,2,1,3
C1(C(CO)(CO)OC(C(C1)=O)=O)=O,,,5,1,2,0,2
12730_1,,,,2,2,1,3
12732_0,,,,2,2,1,3
C(C1(COC(C(C1)=O)=O)CO)(O)=O,,,5,1,1,0,1
12734_0,,,,2,2,1,3
C1(C(CO)C(CC(C(O1)=O)=O)O)=O,,,5,1,1,0,1
12736_0,,,,2,2,1,3
C1(C(CO)(COC(C(C1)=O)=O)O)=O,,,5,1,2,0,2
12736_1,,,,2,2,1,3
12737_0,,,,2,2,1,3
12738_0,,,,2,2,1,3
12740_0,,,,2,2,1,3
C(C(CO)(CO)C(C)CC=O)=O,,,5,1,2,0,2
12741_0,,,,2,2,1,3
12742_0,,,,2,2,1,3
12744_0,,,,2,2,1,3
C(C(C=O)(C(CC(CO)C)O)O)=O,,,5,1,2,0,2
12744_1,,,,2,2,1,3
12746_0,,,,2,2,1,3
C(C(CO)C(CC(C)CO)O)(O)=O,,,5,1,1,0,1
12748_0,,,,2,2,1,3
C(C(CO)(C(C)O)C(C(O)=O)C)=O,,,5,1,4,0,4
12750_0,,,,2,2,1,3
C(C(C=O)(CO)C(C(O)=O)C)(O)=O,,,5,1,2,0,2
12752_0,,,,2,2,1,3
C(C(CO)(CO)C(C(O)=O)C)=O,,,5,1,2,0,2
12753_0,,,,2,2,1,3
12754_0,,,,2,2,1,3
12755_0,,,,2,2,1,3
12757_0,,,,2,1,1,2
C(CO)(C1(C(CC(C1)O)O)O)=O,,,5,1,1,0,1
12758_0,,,,2,1,1,2
12760_0,,,,2,1,1,2
C(C1(C(CC(C(C1)=O)=O)O)O)=O,,,5,1,1,0,1
12762_0,,,,2,1,1,2
C1(C(CO)(CC(C1(C)O)O)O)=O,,,5,1,1,0,1
12763_0,,,,2,1,1,2
12765_0,,,,2,1,1,2
C(C1C(CC(C1(C=O)O)O)O)(O)=O,,,5,1,1,0,1
12766_0,,,,2,1,1,2
12767_0,,,,2,1,1,2
12768_0,,,,2,1,1,2
12769_0,,,,2,1,1,2
12770_0,,,,2,1,1,2
12771_0,,,,2,1,1,2
12772_0,,,,2,1,1,2
12773_0,,,,2,1,1,2
12775_0,,,,2,1,1,2
C1(C2(C(C(CO2)(C1O)O)O)O)=O,,,5,1,1,0,1
12777_0,,,,2,1,1,2
C(C1(CC(C)CC1O)O)(O)=O,,,5,1,1,0,1
12779_0,,,,2,1,1,2
C(C1CC(C(O)=O)(C(C1)O)O)(O)=O,,,5,1,2,0,2
12781_0,,,,2,2,1,3
C1(C(C(CC1(C(CO)O)O)O)O)=O,,,5,1,1,0,1
12783_0,,,,2,2,1,3
C1(C(CC(C1O)O)(C(C=C)O)O)=O,,,5,1,1,0,1
12784_0,,,,2,2,1,3
12785_0,,,,2,2,1,3
12786_0,,,,2,2,1,3
12787_0,,,,2,2,1,3
12789_0,,,,2,2,1,3
C1(C(CC(C1)O)(C(C=O)(C)O)O)=O,,,5,1,1,0,1
12790_0,,,,2,2,1,3
12791_0,,,,2,2,1,3
12792_0,,,,2,2,1,3
12794_0,,,,2,2,1,3
C(C(C)(C(CC(CCO)O)O)O)=O,,,5,1,1,0,1
12796_0,,,,2,2,1,3
C(C(C(CC(CCO)O)O)O)(O)=O,,,5,1,1,0,1
12797_0,,,,2,2,1,3
12798_0,,,,2,2,1,3
12799_0,,,,2,2,1,3
12800_0,,,,2,2,1,3
12801_0,,,,2,2,1,3
12803_0,,,,2,2,1,3
C(C(C(C=O)(C(C=O)CO)O)O)=O,,,5,1,1,0,1
12805_0,,,,2,2,1,3
C(C(C)(C(C(CO)CO)O)O)=O,,,5,1,1,0,1
12807_0,,,,2,2,1,3
C(C)(C(C)(C(C(CO)CO)O)O)=O,,,5,1,1,0,1
12809_0,,,,2,2,1,3
C(C(CC)(C(C(CO)CO)O)O)=O,,,5,1,1,0,1
12810_0,,,,2,2,1,3
12811_0,,,,2,2,1,3
12812_0,,,,2,2,1,3
12813_0,,,,2,2,1,3
12814_0,,,,2,2,1,3
12815_0,,,,2,2,1,3
12816_0,,,,2,2,1,3
12817_0,,,,2,2,1,3
12819_0,,,,2,2,1,3
C(C(C=C)C(C=O)(C(C=O)O)O)=O,,,5,1,1,0,1
12821_0,,,,2,2,1,3
C(C(C=C)C(C=O)(C(C=CC)O)O)=O,,,5,1,1,0,1
12823_0,,,,2,2,1,3
C(C(C=C)C(C=O)(C(CC=C)O)O)=O,,,5,1,1,0,1
12824_0,,,,2,2,1,3
12826_0,,,,2,2,1,3
C(CC(C=O)(C(C=O)(C)O)O)=O,,,5,1,2,0,2
12827_0,,,,2,2,1,3
12828_0,,,,2,2,1,3
12830_0,,,,2,2,1,3
C(C(C(C(CO)O)O)(CC=O)O)=O,,,5,1,1,0,1
12831_0,,,,2,2,1,3
12832_0,,,,2,2,1,3
12833_0,,,,2,2,1,3
12835_0,,,,2,2,1,3
C(C(C(C)(CCO)O)(CC=O)O)=O,,,5,1,1,0,1
12837_0,,,,2,2,1,3
C(C(C(CO)(C)O)(CC=O)O)=O,,,5,1,1,0,1
12839_0,,,,2,2,1,3
C(C(C(C)(C(C)O)O)(CC=O)O)=O,,,5,1,1,0,1
12841_0,,,,2,2,1,3
C(C(C(CO)(CC)O)(CC=O)O)=O,,,5,1,1,0,1
12842_0,,,,2,2,1,3
12844_0,,,,2,2,1,3
C(C(C(C(CC)O)O)(CC=O)O)=O,,,5,1,1,0,1
12846_0,,,,2,2,1,3
C(C(C(CCCO)O)(CC=O)O)=O,,,5,1,1,0,1
12847_0,,,,2,2,1,3
12848_0,,,,2,2,1,3
12849_0,,,,2,2,1,3
12850_0,,,,2,2,1,3
12851_0,,,,2,2,1,3
12852_0,,,,2,2,1,3
12853_0,,,,2,2,1,3
12855_0,,,,2,2,1,3
C(C(C(CCO)O)(CC=O)O)=O,,,5,1,1,0,1
12856_0,,,,2,2,1,3
12857_0,,,,2,2,1,3
12858_0,,,,2,2,1,3
12860_0,,,,2,2,1,3
C(CC(C=O)(C(C=CC)O)O)=O,,,5,1,1,0,1
12862_0,,,,2,2,1,3
C(C(C(CC=C)O)(CC=O)O)=O,,,5,1,1,0,1
12863_0,,,,2,2,1,3
12865_0,,,,2,2,1,3
C(C(C)(C(CC(C=O)O)O)O)=O,,,5,1,1,0,1
12867_0,,,,2,2,1,3
C(C(CC(C(C(C)=O)(C)O)O)O)=O,,,5,1,1,0,1
12869_0,,,,2,2,1,3
C(C(C(CC(C=O)O)O)(CC)O)=O,,,5,1,1,0,1
12871_0,,,,2,2,1,3
C(C(C(CC(C=O)O)O)O)(O)=O,,,5,1,1,0,1
12873_0,,,,2,2,1,3
C(C(C)(C(CC(C=O)O)O)O)(O)=O,,,5,1,1,0,1
12875_0,,,,2,2,1,3
C(C(C)(C(C(CC=O)O)O)O)=O,,,5,1,1,0,1
12877_0,,,,2,2,1,3
C(CC(C(C(C(C)=O)(C)O)O)O)=O,,,5,1,1,0,1
12879_0,,,,2,2,1,3
C(C(C(C(CC=O)O)O)(CC)O)=O,,,5,1,1,0,1
12880_0,,,,2,2,1,3
12881_0,,,,2,2,1,3
12882_0,,,,2,2,1,3
12883_0,,,,2,2,1,3
12884_0,,,,2,2,1,3
12885_0,,,,2,2,1,3
12886_0,,,,2,2,1,3
12887_0,,,,2,2,1,3
12888_0,,,,2,2,1,3
12889_0,,,,2,2,1,3
12890_0,,,,2,2,1,3
12892_0,,,,2,2,1,3
C(C(C)(C(CO)(C(CO)O)O)O)=O,,,5,1,1,0,1
12893_0,,,,2,2,1,3
12895_0,,,,2,2,1,3
C(C(C)(C(CC(C=CC)O)O)O)=O,,,5,1,1,0,1
12897_0,,,,2,2,1,3
C(C(C(CC(C=CC)O)O)O)(O)=O,,,5,1,1,0,1
12899_0,,,,2,2,1,3
C(C(C)(C(CC(CC=C)O)O)O)=O,,,5,1,1,0,1
12901_0,,,,2,2,1,3
C(C(C(CC(CC=C)O)O)O)(O)=O,,,5,1,1,0,1
12903_0,,,,2,2,1,3
C(C(C(C(C=C)C(C)O)O)(C)O)=O,,,5,1,1,0,1
12905_0,,,,2,2,1,3
C(C(C(C(C=C)C(C)O)O)O)(O)=O,,,5,1,1,0,1
12907_0,,,,2,2,1,3
C(C(C=C)C(C(C=O)(C)O)O)(O)=O,,,5,1,1,0,1
12908_0,,,,2,2,1,3
12909_0,,,,2,2,1,3
12911_0,,,,2,2,1,3
C(C(C(C(C=C)CO)O)(C)O)=O,,,5,1,1,0,1
12913_0,,,,2,2,1,3
C(C)(C(C(C(C=C)CO)O)(C)O)=O,,,5,1,1,0,1
12915_0,,,,2,2,1,3
C(C(C(C(C=C)CO)O)(CC)O)=O,,,5,1,1,0,1
12916_0,,,,2,2,1,3
12917_0,,,,2,2,1,3
12919_0,,,,2,2,1,3
C(C(C(C=O)=O)(C(C=O)(C)O)O)=O,,,5,1,1,0,1
12921_0,,,,2,2,1,3
C(C(C(C=O)=O)(C(C(O)=O)O)O)=O,,,5,1,1,0,1
12923_0,,,,2,2,1,3
C(C(C)(C(C(C(C=O)=O)=O)O)O)=O,,,5,1,1,0,1
12925_0,,,,2,2,1,3
C(C(C(C(C(C=O)=O)=O)O)O)(O)=O,,,5,1,1,0,1
12927_0,,,,2,2,1,3
C(C(C)(C(C(C)=O)(CCO)O)O)=O,,,5,1,1,0,1
12928_0,,,,2,2,1,3
12930_0,,,,2,2,1,3
C(C(C)(C(C=O)(C)O)O)(CCO)=O,,,5,1,1,0,1
12931_0,,,,2,2,1,3
12932_0,,,,2,2,1,3
12933_0,,,,2,2,1,3
12935_0,,,,2,2,1,3
C(C(C(C(C)O)(CC(C)O)O)=O)=O,,,5,1,1,0,1
12937_0,,,,2,2,1,3
C(C(C(C=O)=O)(CC(C)O)O)(O)=O,,,5,1,1,0,1
12939_0,,,,2,2,1,3
C(C(C(CO)(CC(C)O)O)=O)=O,,,5,1,1,0,1
12941_0,,,,2,2,1,3
C(CC(C(C=O)=O)(C(C)O)O)(O)=O,,,5,1,1,0,1
12943_0,,,,2,2,1,3
C(C(C(C=O)=O)(CC(O)=O)O)(O)=O,,,5,1,1,0,1
12945_0,,,,2,2,1,3
C(CC(C(C=O)=O)(CO)O)(O)=O,,,5,1,1,0,1
12946_0,,,,2,2,1,3
12948_0,,,,2,2,1,3
C(C(C)(C(C(C=O)=O)(C)O)O)=O,,,5,1,2,0,2
12949_0,,,,2,2,1,3
12950_0,,,,2,2,1,3
12952_0,,,,2,2,1,3
C(C(C(C)(C(C(CO)O)O)O)=O)=O,,,5,1,1,0,1
12954_0,,,,2,2,1,3
C(C(C(C)(C(CO)O)O)=O)=O,,,5,1,1,0,1
12956_0,,,,2,2,1,3
C(C(C(C)(C(C(C)O)O)O)=O)=O,,,5,1,1,0,1
12958_0,,,,2,2,1,3
C(C(C(C(C=O)=O)(C)O)O)(O)=O,,,5,1,2,0,2
12960_0,,,,2,2,1,3
C(C(C(C)(C(C)(CCO)O)O)=O)=O,,,5,1,1,0,1
12962_0,,,,2,2,1,3
C(C(C(C)(C(CO)(C)O)O)=O)=O,,,5,1,1,0,1
12964_0,,,,2,2,1,3
C(C(C(C)(C(C)(C(C)O)O)O)=O)=O,,,5,1,1,0,1
12966_0,,,,2,2,1,3
C(C(C(C)(C(CO)(CC)O)O)=O)=O,,,5,1,1,0,1
12968_0,,,,2,2,1,3
C=CC(C(C(C=O)=O)(C)O)O,,,5,1,1,0,1
12970_0,,,,2,2,1,3
C(C(C(C)(C(C(CC)O)O)O)=O)=O,,,5,1,1,0,1
12972_0,,,,2,2,1,3
C(C(C(C)(C(CCCO)O)O)=O)=O,,,5,1,1,0,1
12973_0,,,,2,2,1,3
12974_0,,,,2,2,1,3
12976_0,,,,2,2,1,3
C(C(C(C)(C(CC(C)O)O)O)=O)=O,,,5,1,1,0,1
12978_0,,,,2,2,1,3
C(CC(C(C(C=O)=O)(C)O)O)(O)=O,,,5,1,1,0,1
12979_0,,,,2,2,1,3
12980_0,,,,2,2,1,3
12981_0,,,,2,2,1,3
12983_0,,,,2,2,1,3
C(C(C(C)(C(CCO)O)O)=O)=O,,,5,1,1,0,1
12984_0,,,,2,2,1,3
12986_0,,,,2,2,1,3
C(C(C(C(C(C=O)=O)(C)O)O)O)=O,,,5,1,1,0,1
12988_0,,,,2,2,1,3
C(C(C(C)(C(CO)(CO)O)O)=O)=O,,,5,1,1,0,1
12990_0,,,,2,2,1,3
C(C)=CC(C(C(C=O)=O)(C)O)O,,,5,1,1,0,1
12992_0,,,,2,2,1,3
C=CCC(C(C(C=O)=O)(C)O)O,,,5,1,1,0,1
12994_0,,,,2,2,1,3
C(C(C)(C(C(C=O)=O)(C)O)O)(O)=O,,,5,1,2,0,2
12996_0,,,,2,2,1,3
C(C(C)(C(C(C(C)O)=O)O)O)=O,,,5,1,1,0,1
12998_0,,,,2,2,1,3
C(C)(C(C)(C(C(C(C)O)=O)O)O)=O,,,5,1,1,0,1
13000_0,,,,2,2,1,3
C(C(CC)(C(C(C(C)O)=O)O)O)=O,,,5,1,1,0,1
13002_0,,,,2,2,1,3
C(C(C(C(O)=O)O)O)(C(C)O)=O,,,5,1,1,0,1
13004_0,,,,2,2,1,3
C(C(C)(C(C(C(C)O)=O)O)O)(O)=O,,,5,1,1,0,1
13006_0,,,,2,2,1,3
C(C(C(C)O)(C(C=O)(C)O)O)=O,,,5,1,1,0,1
13008_0,,,,2,2,1,3
C(C(C(C)O)(C(C(C)=O)(C)O)O)=O,,,5,1,1,0,1
13010_0,,,,2,2,1,3
C(C(CC)(C(C=O)(C(C)O)O)O)=O,,,5,1,1,0,1
13011_0,,,,2,2,1,3
13012_0,,,,2,2,1,3
13013_0,,,,2,2,1,3
13015_0,,,,2,2,1,3
C(C(C=O)(C(C(C)=O)(C)O)O)(O)=O,,,5,1,1,0,1
13017_0,,,,2,2,1,3
C(C(C=O)(C(C=O)(CC)O)O)(O)=O,,,5,1,1,0,1
13018_0,,,,2,2,1,3
13019_0,,,,2,2,1,3
13020_0,,,,2,2,1,3
13022_0,,,,2,2,1,3
C(C)(C(C)(C(C(C(O)=O)=O)O)O)=O,,,5,1,1,0,1
13024_0,,,,2,2,1,3
C(C(CC)(C(C(C(O)=O)=O)O)O)=O,,,5,1,1,0,1
13025_0,,,,2,2,1,3
13026_0,,,,2,2,1,3
13028_0,,,,2,2,1,3
C(C(CC(C)O)(C(C(C)=O)O)O)=O,,,5,1,1,0,1
13030_0,,,,2,2,1,3
C(CC(C=O)(C(C(C)=O)O)O)(O)=O,,,5,1,1,0,1
13031_0,,,,2,2,1,3
13032_0,,,,2,2,1,3
13034_0,,,,2,2,1,3
C(C)(C(C)(C(C(C)=O)O)O)=O,,,5,1,1,0,1
13036_0,,,,2,2,1,3
C(C)(C(C(C=C)(C(C=O)=O)O)O)=O,,,5,1,1,0,1
13038_0,,,,2,2,1,3
C(C(CC)(C(C(C)=O)O)O)=O,,,5,1,1,0,1
13040_0,,,,2,2,1,3
C(C(C1(C(C(CO1)O)=O)O)O)(C)=O,,,5,1,1,0,1
13041_0,,,,2,2,1,3
13042_0,,,,2,2,1,3
13044_0,,,,2,2,1,3
C(C(CC(C)O)(C(C=O)(C)O)O)=O,,,5,1,1,0,1
13046_0,,,,2,2,1,3
C(CC(C=O)(C(C=O)(C)O)O)(O)=O,,,5,1,1,0,1
13048_0,,,,2,2,1,3
C(C(C)(C(C=O)(C)O)O)=O,,,5,1,1,0,1
13050_0,,,,2,2,1,3
C(C(C=C)(C(C=O)(C)O)O)(O)=O,,,5,1,2,0,2
13052_0,,,,2,2,1,3
C(C(C)(C(C(C)=O)(C)O)O)=O,,,5,1,1,0,1
13054_0,,,,2,2,1,3
C(C(C)(C(C=C)(C(C=O)=O)O)O)=O,,,5,1,1,0,1
13056_0,,,,2,2,1,3
C(C(CC)(C(C=O)(C)O)O)=O,,,5,1,1,0,1
13058_0,,,,2,2,1,3
C(C(C)(C1(C(C(CO1)O)=O)O)O)=O,,,5,1,1,0,1
13060_0,,,,2,2,1,3
C(C(C)(C(C(O)=O)O)O)=O,,,5,1,2,0,2
13062_0,,,,2,2,1,3
C(C(C)(C(C=O)(C)O)O)(O)=O,,,5,1,3,0,3
13063_0,,,,2,2,1,3
13065_0,,,,2,2,1,3
C(C)(C(C)(C(C(C(C)=O)=O)O)O)=O,,,5,1,1,0,1
13067_0,,,,2,2,1,3
C(C(CC)(C(C(C(C)=O)=O)O)O)=O,,,5,1,1,0,1
13068_0,,,,2,2,1,3
13069_0,,,,2,2,1,3
13070_0,,,,2,2,1,3
13072_0,,,,2,2,1,3
C(C)(C(C)(C(C(C=O)=O)(C)O)O)=O,,,5,1,1,0,1
13074_0,,,,2,2,1,3
C(C(CC)(C(C(C=O)=O)(C)O)O)=O,,,5,1,1,0,1
13075_0,,,,2,2,1,3
13076_0,,,,2,2,1,3
13078_0,,,,2,2,1,3
C(C(C)(C(C=O)(C(C)=O)O)O)=O,,,5,1,1,0,1
13080_0,,,,2,2,1,3
C(C(C(C)=O)(C(C(C)=O)(C)O)O)=O,,,5,1,1,0,1
13082_0,,,,2,2,1,3
C(C(CC)(C(C=O)(C(C)=O)O)O)=O,,,5,1,1,0,1
13084_0,,,,2,2,1,3
C(C(C(C)=O)(C(C(O)=O)O)O)=O,,,5,1,2,0,2
13086_0,,,,2,2,1,3
C(C(C)(C(C=O)(C(C)=O)O)O)(O)=O,,,5,1,1,0,1
13087_0,,,,2,2,1,3
13088_0,,,,2,2,1,3
13090_0,,,,2,2,1,3
C(C)(C(C)(C(C(C=O)=O)O)O)=O,,,5,1,1,0,1
13092_0,,,,2,2,1,3
C(C(CC)(C(C(C=O)=O)O)O)=O,,,5,1,1,0,1
13093_0,,,,2,2,1,3
13094_0,,,,2,2,1,3
13095_0,,,,2,2,1,3
13096_0,,,,2,2,1,3
13098_0,,,,2,2,1,3
C(C(C=O)(C(C(C)=O)(C)O)O)=O,,,5,1,1,0,1
13100_0,,,,2,2,1,3
C(C(C=O)(C(C=O)(CC)O)O)=O,,,5,1,1,0,1
13101_0,,,,2,2,1,3
13102_0,,,,2,2,1,3
13104_0,,,,2,2,1,3
C(C(C)(C(C(C=C)=O)(CO)O)O)=O,,,5,1,1,0,1
13106_0,,,,2,2,1,3
C(C(C(C(C=C)=O)(CO)O)O)(O)=O,,,5,1,1,0,1
13108_0,,,,2,2,1,3
C(C(C)(C(C(CO)=O)(C=C)O)O)=O,,,5,1,1,0,1
13110_0,,,,2,2,1,3
C(C(C(C(CO)=O)(C=C)O)O)(O)=O,,,5,1,1,0,1
13112_0,,,,2,2,1,3
C=C(C(O)=O)C(C(C=O)=O)(CO)O,,,5,1,1,0,1
13114_0,,,,2,2,1,3
C(C(C(CO)O)(CC(C)O)O)=O,,,5,1,1,0,1
13116_0,,,,2,2,1,3
C(C(C(C(C)O)O)(CC(C)O)O)=O,,,5,1,1,0,1
13118_0,,,,2,2,1,3
C(C(CC(C)O)(C(C(O)=O)O)O)=O,,,5,1,1,0,1
13120_0,,,,2,2,1,3
C(C(CC(C)O)(C(CO)(C)O)O)=O,,,5,1,1,0,1
13122_0,,,,2,2,1,3
C(C(CC(C)O)(C(C=C)O)O)=O,,,5,1,1,0,1
13124_0,,,,2,2,1,3
C(C(C(C)O)(CC(C)O)O)=O,,,5,1,1,0,1
13126_0,,,,2,2,1,3
C(C(C=O)(CC(C)O)O)(O)=O,,,5,1,1,0,1
13128_0,,,,2,2,1,3
C(C(CO)(CC(C)O)O)=O,,,5,1,1,0,1
13130_0,,,,2,2,1,3
C(C(C(CCO)O)(CC(C)O)O)=O,,,5,1,1,0,1
13132_0,,,,2,2,1,3
C(C(CC(C)O)(C(C=O)O)O)=O,,,5,1,1,0,1
13134_0,,,,2,2,1,3
C(C(CC(C)O)(C(C=CC)O)O)=O,,,5,1,1,0,1
13136_0,,,,2,2,1,3
C(C(C(CC=C)O)(CC(C)O)O)=O,,,5,1,1,0,1
13138_0,,,,2,2,1,3
C(C(C)(C(C(CC(C)O)O)O)O)=O,,,5,1,1,0,1
13139_0,,,,2,2,1,3
13140_0,,,,2,2,1,3
13141_0,,,,2,2,1,3
13142_0,,,,2,2,1,3
13144_0,,,,2,2,1,3
C(C(C(CO)(C)O)(CC(O)=O)O)=O,,,5,1,1,0,1
13146_0,,,,2,2,1,3
C(CC(C=O)(C(C=C)O)O)(O)=O,,,5,1,1,0,1
13148_0,,,,2,2,1,3
C(C(C(C)O)(CC(O)=O)O)=O,,,5,1,1,0,1
13150_0,,,,2,2,1,3
C(C(C=O)(CC(O)=O)O)(O)=O,,,5,1,1,0,1
13151_0,,,,2,2,1,3
13153_0,,,,2,2,1,3
C(C(C(CCO)O)(CC(O)=O)O)=O,,,5,1,1,0,1
13155_0,,,,2,2,1,3
C(CC(C=O)(C(C=O)O)O)(O)=O,,,5,1,1,0,1
13157_0,,,,2,2,1,3
C(CC(C=O)(C(C=CC)O)O)(O)=O,,,5,1,1,0,1
13159_0,,,,2,2,1,3
C(C(C(CC=C)O)(CC(O)=O)O)=O,,,5,1,1,0,1
13161_0,,,,2,2,1,3
C(C(C)(C(C(CC(O)=O)O)O)O)=O,,,5,1,1,0,1
13162_0,,,,2,2,1,3
13164_0,,,,2,2,1,3
C(C(C)(C(C(C(CO)=O)O)O)O)=O,,,5,1,1,0,1
13165_0,,,,2,2,1,3
13167_0,,,,2,2,1,3
C(C(C)(C(CO)(C(C=O)O)O)O)=O,,,5,1,1,0,1
13168_0,,,,2,2,1,3
13170_0,,,,2,2,1,3
C(C(CO)(C(C(C=O)(C)O)O)O)=O,,,5,1,1,0,1
13171_0,,,,2,2,1,3
13173_0,,,,2,2,1,3
C(C(C)(C(C(CO)O)O)O)=O,,,5,1,1,0,1
13175_0,,,,2,2,1,3
C(C(C=C)(C(C(CO)O)O)O)(O)=O,,,5,1,1,0,1
13177_0,,,,2,2,1,3
C(C)(C(C)(C(C(CO)O)O)O)=O,,,5,1,1,0,1
13179_0,,,,2,2,1,3
C(C(CC)(C(C(CO)O)O)O)=O,,,5,1,1,0,1
13180_0,,,,2,2,1,3
13181_0,,,,2,2,1,3
13183_0,,,,2,2,1,3
C(C(C)(C(CO)O)O)=O,,,5,1,1,0,1
13185_0,,,,2,2,1,3
C(CC(C(C)(C(CO)O)O)=O)(O)=O,,,5,1,1,0,1
13187_0,,,,2,2,1,3
C(C(C(C(C)(C(CO)O)O)=O)O)=O,,,5,1,1,0,1
13189_0,,,,2,2,1,3
C(CO)(C(C(CO)O)(CCO)O)=O,,,5,1,1,0,1
13191_0,,,,2,2,1,3
C(C(C=C)(C(CO)O)O)(O)=O,,,5,1,1,0,1
13193_0,,,,2,2,1,3
C(C)(C(C)(C(CO)O)O)=O,,,5,1,1,0,1
13195_0,,,,2,2,1,3
C(C(C(CO)O)(CC(C)=O)O)(O)=O,,,5,1,1,0,1
13197_0,,,,2,2,1,3
C=CC(C(C=O)=O)(C(CO)O)O,,,5,1,1,0,1
13199_0,,,,2,2,1,3
C(C(C(CO)O)(CC)O)=O,,,5,1,1,0,1
13201_0,,,,2,2,1,3
C(C(C(C(CO)O)(CC)O)=O)(O)=O,,,5,1,1,0,1
13203_0,,,,2,2,1,3
C(C(C)C(C=O)(C(CO)O)O)(O)=O,,,5,1,1,0,1
13205_0,,,,2,2,1,3
C1(C(C(CO)O)(O)OCC1O)=O,,,5,1,1,0,1
13207_0,,,,2,2,1,3
C1(C(C(CO)O)(O)OC(C)C1O)=O,,,5,1,1,0,1
13209_0,,,,2,2,1,3
C1(C(C(C(C(CO)O)(O)O1)=O)O)=O,,,5,1,1,0,1
13211_0,,,,2,2,1,3
C1(COC(CC1(C(CO)O)O)O)=O,,,5,1,1,0,1
13212_0,,,,2,2,1,3
13213_0,,,,2,2,1,3
13214_0,,,,2,2,1,3
13215_0,,,,2,2,1,3
13217_0,,,,2,2,1,3
C(C(C)(C(C(C)O)O)O)=O,,,5,1,1,0,1
13218_0,,,,2,2,1,3
13220_0,,,,2,2,1,3
C(C(C)(C(C(CO)=O)(C)O)O)=O,,,5,1,1,0,1
13222_0,,,,2,2,1,3
C(C(C)(C(C(C)=O)(CO)O)O)=O,,,5,1,1,0,1
13224_0,,,,2,2,1,3
C(C(C)(C(C)(CC(O)=O)O)O)=O,,,5,1,1,0,1
13226_0,,,,2,2,1,3
C(C(C)(C(C)(CCO)O)O)=O,,,5,1,1,0,1
13228_0,,,,2,2,1,3
C(C(C)(C(CO)(C)O)O)=O,,,5,1,1,0,1
13230_0,,,,2,2,1,3
C(C(C)(C(C(C(O)=O)=C)O)O)=O,,,5,1,1,0,1
13232_0,,,,2,2,1,3
C(C(C=O)CC(C(C=O)(C)O)O)=O,,,5,1,1,0,1
13234_0,,,,2,2,1,3
C(C(C)(C(C(C=O)CC=O)O)O)=O,,,5,1,1,0,1
13236_0,,,,2,2,1,3
C(C(C)(C(CC(C=O)=O)O)O)=O,,,5,1,1,0,1
13238_0,,,,2,2,1,3
C(C(C)(C(C(CC=O)=O)O)O)=O,,,5,1,1,0,1
13239_0,,,,2,2,1,3
13241_0,,,,2,2,1,3
C(C(C)(C(C)(CC(C=O)=O)O)O)=O,,,5,1,1,0,1
13243_0,,,,2,2,1,3
C(C(C)(C(C(CC(C)=O)=O)O)O)=O,,,5,1,1,0,1
13245_0,,,,2,2,1,3
C(CC(C=O)(C(C=O)(C)O)O)(C)=O,,,5,1,1,0,1
13247_0,,,,2,2,1,3
C(C(C)(C(C(C=O)=O)(CC)O)O)=O,,,5,1,1,0,1
13249_0,,,,2,2,1,3
C(C(C)(C(C(C(CC)=O)=O)O)O)=O,,,5,1,1,0,1
13251_0,,,,2,2,1,3
C(CC)(C(C=O)(C(C=O)(C)O)O)=O,,,5,1,1,0,1
13253_0,,,,2,2,1,3
C(C(CC)(C(C=O)(C)O)O)(O)=O,,,5,1,1,0,1
13255_0,,,,2,2,1,3
C(C(C)(C(C)(C(C)O)O)O)=O,,,5,1,1,0,1
13257_0,,,,2,2,1,3
C(C(C)(C(CO)(CC)O)O)=O,,,5,1,1,0,1
13259_0,,,,2,2,1,3
C(C(C)(C(C=CCC(C)O)O)O)=O,,,5,1,1,0,1
13261_0,,,,2,2,1,3
C(C(C(CC=CC(C)O)O)(C)O)=O,,,5,1,1,0,1
13263_0,,,,2,2,1,3
C(C(C)(C(C(C(C)O)=C)O)O)=O,,,5,1,1,0,1
13265_0,,,,2,2,1,3
C(C(C)(C(C(CO)=CC)O)O)=O,,,5,1,1,0,1
13267_0,,,,2,2,1,3
C(C(C)(C(C(C(C)O)=CC)O)O)=O,,,5,1,1,0,1
13269_0,,,,2,2,1,3
C(C(C)(C(C(C(O)=O)=CC)O)O)=O,,,5,1,1,0,1
13271_0,,,,2,2,1,3
C(C(C)(C(C=CCC(O)=O)O)O)=O,,,5,1,1,0,1
13273_0,,,,2,2,1,3
C(C(C)(C(CC=CC(O)=O)O)O)=O,,,5,1,1,0,1
13275_0,,,,2,2,1,3
C(C(C)(C(C=CC(CO)=O)O)O)=O,,,5,1,1,0,1
13277_0,,,,2,2,1,3
C(C(C)(C(C=CC=O)(CO)O)O)=O,,,5,1,1,0,1
13279_0,,,,2,2,1,3
C(C(C)(C(C=C(C=O)CO)O)O)=O,,,5,1,1,0,1
13281_0,,,,2,2,1,3
C(C(C)(C(C(CO)=CC=O)O)O)=O,,,5,1,1,0,1
13283_0,,,,2,2,1,3
C(C(C)(C(C(C(C=C)O)=O)O)O)=O,,,5,1,1,0,1
13285_0,,,,2,2,1,3
C(C(C)(C(C=O)(C(C=C)O)O)O)=O,,,5,1,1,0,1
13287_0,,,,2,2,1,3
C(C(C)(C(C=C)O)O)=O,,,5,1,1,0,1
13288_0,,,,2,2,1,3
13290_0,,,,2,2,1,3
C(C(C)(C(C(C(O)=O)=C)(C)O)O)=O,,,5,1,1,0,1
13292_0,,,,2,2,1,3
C(C(C)(C(C(CC)O)O)O)=O,,,5,1,1,0,1
13294_0,,,,2,2,1,3
C(C(C)(C(CCCO)O)O)=O,,,5,1,1,0,1
13296_0,,,,2,2,1,3
C(C(C)(C1(C(O)OCC1O)O)O)=O,,,5,1,1,0,1
13298_0,,,,2,2,1,3
C1(C(CCO1)(C(C=O)(C)O)O)=O,,,5,1,1,0,1
13300_0,,,,2,2,1,3
C(C(C)(C1(C(C(OC1)=O)=O)O)O)=O,,,5,1,1,0,1
13302_0,,,,2,2,1,3
C(C(C)(C1(C(OCC1=O)=O)O)O)=O,,,5,1,1,0,1
13304_0,,,,2,2,1,3
C(C(C)(C(CC(CO)C)O)O)=O,,,5,1,1,0,1
13306_0,,,,2,2,1,3
C(C(C)(C(CC(C)CCO)O)O)=O,,,5,1,1,0,1
13308_0,,,,2,2,1,3
C(C(C)(C(CC(C)C(C)O)O)O)=O,,,5,1,1,0,1
13310_0,,,,2,2,1,3
C(C(C)(C(CC(C)CC=O)O)O)=O,,,5,1,1,0,1
13312_0,,,,2,2,1,3
C(C(C)(C(C)O)O)=O,,,5,1,2,0,2
13313_0,,,,2,2,1,3
13315_0,,,,2,2,1,3
C(C(C)(C(CC(C)O)O)O)=O,,,5,1,1,0,1
13317_0,,,,2,2,1,3
C(C(C)(C(CC(O)=O)O)O)=O,,,5,1,1,0,1
13318_0,,,,2,2,1,3
13319_0,,,,2,2,1,3
13321_0,,,,2,2,1,3
C(C(CO)(C)O)=O,,,5,1,1,0,1
13323_0,,,,2,2,1,3
C(C(C)(C(C(CO)C(C)O)O)O)=O,,,5,1,1,0,1
13325_0,,,,2,2,1,3
C(C(CO)C(C(C=O)(C)O)O)(O)=O,,,5,1,1,0,1
13326_0,,,,2,2,1,3
13328_0,,,,2,2,1,3
C(C(C(CO)O)(C(C=O)(C)O)O)=O,,,5,1,1,0,1
13330_0,,,,2,2,1,3
C(C(C)(C(CCO)O)O)=O,,,5,1,1,0,1
13332_0,,,,2,2,1,3
C(C(CCO)(C(C=O)(C)O)O)(O)=O,,,5,1,1,0,1
13334_0,,,,2,2,1,3
C(CC(C(C)=O)(C(C=O)(C)O)O)=O,,,5,1,1,0,1
13336_0,,,,2,2,1,3
C(CC(C(C)(C(C=O)(C)O)O)=O)=O,,,5,1,1,0,1
13338_0,,,,2,2,1,3
C(C(C)(C(CC(C(C)=O)=O)O)O)=O,,,5,1,1,0,1
13339_0,,,,2,2,1,3
13341_0,,,,2,2,1,3
C(C(C)(C(C(C=O)O)O)O)=O,,,5,1,1,0,1
13343_0,,,,2,2,1,3
C(C(C)(C(CO)(CO)O)O)=O,,,5,1,1,0,1
13344_0,,,,2,2,1,3
13346_0,,,,2,2,1,3
C(C(C)(C(C(C=O)(C)O)O)O)(O)=O,,,5,1,1,0,1
13348_0,,,,2,2,1,3
C(C(C)(C(C(C(O)=O)O)O)O)=O,,,5,1,1,0,1
13350_0,,,,2,2,1,3
C(C(C)(C(C=CC)O)O)=O,,,5,1,1,0,1
13352_0,,,,2,2,1,3
C(C(C)(C(CC=C)O)O)=O,,,5,1,1,0,1
13354_0,,,,2,2,1,3
C(C(C)(C(C(O)=O)(C=CC)O)O)=O,,,5,1,1,0,1
13356_0,,,,2,2,1,3
C(C(C)(C(C(O)=O)(CC=C)O)O)=O,,,5,1,1,0,1
13358_0,,,,2,2,1,3
C(C(C)(C(CC(C(O)=O)=C)O)O)=O,,,5,1,1,0,1
13360_0,,,,2,2,1,3
C(C(C)(C(C=C(C(O)=O)C)O)O)=O,,,5,1,1,0,1
13362_0,,,,2,2,1,3
C1(C(CC(C)O1)(C(C=O)(C)O)O)=O,,,5,1,1,0,1
13364_0,,,,2,2,1,3
C1(CC(C(O1)=O)(C(C=O)(C)O)O)=O,,,5,1,1,0,1
13365_0,,,,2,2,1,3
13367_0,,,,2,2,1,3
C(C(C=C)(C(C(C)O)O)O)(O)=O,,,5,1,2,0,2
13369_0,,,,2,2,1,3
C(C)(C(C)(C(C(C)O)O)O)=O,,,5,1,1,0,1
13371_0,,,,2,2,1,3
C=CC(C(C=O)=O)(C(C(C)O)O)O,,,5,1,1,0,1
13373_0,,,,2,2,1,3
C(C(CC)(C(C(C)O)O)O)=O,,,5,1,1,0,1
13375_0,,,,2,2,1,3
C1(C(C(C(C)O)O)(O)OCC1O)=O,,,5,1,1,0,1
13376_0,,,,2,2,1,3
13378_0,,,,2,2,1,3
C(C(C)(C(C(C)O)O)O)(O)=O,,,5,1,1,0,1
13380_0,,,,2,2,1,3
C(C(C=C)(C(C(O)=O)O)O)(O)=O,,,5,1,5,0,5
13382_0,,,,2,2,1,3
C(C)(C(C)(C(C(O)=O)O)O)=O,,,5,1,1,0,1
13384_0,,,,2,2,1,3
C(C(C(C=C)(C(C=O)=O)O)O)(O)=O,,,5,1,1,0,1
13386_0,,,,2,2,1,3
C(C(CC)(C(C(O)=O)O)O)=O,,,5,1,1,0,1
13388_0,,,,2,2,1,3
C(C(C1(C(C(CO1)O)=O)O)O)(O)=O,,,5,1,1,0,1
13389_0,,,,2,2,1,3
13390_0,,,,2,2,1,3
13392_0,,,,2,2,1,3
C(C)(C(C)(C(C(CO)=O)(C)O)O)=O,,,5,1,1,0,1
13394_0,,,,2,2,1,3
C(C(CC)(C(C(CO)=O)(C)O)O)=O,,,5,1,1,0,1
13396_0,,,,2,2,1,3
C(CO)(C(C)(C(C(O)=O)O)O)=O,,,5,1,1,0,1
13398_0,,,,2,2,1,3
C(C(C)(C(C(CO)=O)(C)O)O)(O)=O,,,5,1,1,0,1
13400_0,,,,2,2,1,3
C(C)(C(CO)(C(C(C)=O)(C)O)O)=O,,,5,1,1,0,1
13402_0,,,,2,2,1,3
C(C(CC)(C(C(C)=O)(CO)O)O)=O,,,5,1,1,0,1
13404_0,,,,2,2,1,3
C(C)(C(CO)(C(C(O)=O)O)O)=O,,,5,1,1,0,1
13406_0,,,,2,2,1,3
C(C(C)(C(C(C)=O)(CO)O)O)(O)=O,,,5,1,1,0,1
13408_0,,,,2,2,1,3
C(CC(C)(C(C(C)=O)(C)O)O)(O)=O,,,5,1,1,0,1
13410_0,,,,2,2,1,3
C(C(CC)(C(C)(CC(O)=O)O)O)=O,,,5,1,1,0,1
13412_0,,,,2,2,1,3
C(CC(C)(C(C(O)=O)O)O)(O)=O,,,5,1,1,0,1
13414_0,,,,2,2,1,3
C(C(C)(C(C)(CC(O)=O)O)O)(O)=O,,,5,1,1,0,1
13416_0,,,,2,2,1,3
C(C(C=C)(C(C)(CCO)O)O)(O)=O,,,5,1,1,0,1
13418_0,,,,2,2,1,3
C(C)(C(C)(C(C)(CCO)O)O)=O,,,5,1,1,0,1
13420_0,,,,2,2,1,3
C(C(CC)(C(C)(CCO)O)O)=O,,,5,1,1,0,1
13422_0,,,,2,2,1,3
C(C(C(C)(CCO)O)O)(O)=O,,,5,1,1,0,1
13424_0,,,,2,2,1,3
C(C(C)(C(C)(CCO)O)O)(O)=O,,,5,1,1,0,1
13426_0,,,,2,2,1,3
C(C(C)(C(C=C)O)O)(CC(O)=O)=O,,,5,1,1,0,1
13428_0,,,,2,2,1,3
C(CC(C(C)(C(C)O)O)=O)(O)=O,,,5,1,1,0,1
13429_0,,,,2,2,1,3
13431_0,,,,2,2,1,3
C(CC(C(CO)(C)O)=O)(O)=O,,,5,1,1,0,1
13432_0,,,,2,2,1,3
13434_0,,,,2,2,1,3
C(C(C=C)(C(CO)(C)O)O)(O)=O,,,5,1,1,0,1
13436_0,,,,2,2,1,3
C(C)(C(C)(C(CO)(C)O)O)=O,,,5,1,1,0,1
13438_0,,,,2,2,1,3
C=CC(C(C=O)=O)(C(CO)(C)O)O,,,5,1,1,0,1
13440_0,,,,2,2,1,3
C(C(CC)(C(CO)(C)O)O)=O,,,5,1,1,0,1
13442_0,,,,2,2,1,3
C1(C(C(CO)(C)O)(O)OCC1O)=O,,,5,1,1,0,1
13444_0,,,,2,2,1,3
C(C(C(CO)(C)O)O)(O)=O,,,5,1,1,0,1
13446_0,,,,2,2,1,3
C(C(C)(C(CO)(C)O)O)(O)=O,,,5,1,1,0,1
13448_0,,,,2,2,1,3
C(C(C)(C(C=C)O)O)(C(C=O)O)=O,,,5,1,1,0,1
13449_0,,,,2,2,1,3
13450_0,,,,2,2,1,3
13451_0,,,,2,2,1,3
13452_0,,,,2,2,1,3
13454_0,,,,2,2,1,3
C(CO)(C(CCO)(C(C=C)O)O)=O,,,5,1,1,0,1
13455_0,,,,2,2,1,3
13456_0,,,,2,2,1,3
13457_0,,,,2,2,1,3
13458_0,,,,2,2,1,3
13459_0,,,,2,2,1,3
13460_0,,,,2,2,1,3
13461_0,,,,2,2,1,3
13462_0,,,,2,2,1,3
13463_0,,,,2,2,1,3
13464_0,,,,2,2,1,3
13465_0,,,,2,2,1,3
13466_0,,,,2,2,1,3
13468_0,,,,2,2,1,3
C(C(C=C)(C(C)(C(C)O)O)O)(O)=O,,,5,1,1,0,1
13470_0,,,,2,2,1,3
C(C(C=C)(C(CO)(CC)O)O)(O)=O,,,5,1,1,0,1
13472_0,,,,2,2,1,3
C(C(C=C)(C(C=C)O)O)(O)=O,,,5,1,1,0,1
13474_0,,,,2,2,1,3
C(C(C=C)(C(C(CC)O)O)O)(O)=O,,,5,1,1,0,1
13476_0,,,,2,2,1,3
C(C(C=C)(C(CCCO)O)O)(O)=O,,,5,1,1,0,1
13478_0,,,,2,2,1,3
C(C(C=C)(C(C)O)O)(O)=O,,,5,1,2,0,2
13480_0,,,,2,2,1,3
C(C(C(O)=O)(C=C)O)(O)=O,,,5,1,2,0,2
13482_0,,,,2,2,1,3
C(C(C=C)(C(CC(C)O)O)O)(O)=O,,,5,1,1,0,1
13484_0,,,,2,2,1,3
C(C(C=C)(C(CC(O)=O)O)O)(O)=O,,,5,1,1,0,1
13485_0,,,,2,2,1,3
13486_0,,,,2,2,1,3
13487_0,,,,2,2,1,3
13489_0,,,,2,2,1,3
C(C(C=C)(C(CCO)O)O)(O)=O,,,5,1,2,0,2
13490_0,,,,2,2,1,3
13492_0,,,,2,2,1,3
C(C(C=C)(C(C(C=O)O)O)O)(O)=O,,,5,1,1,0,1
13494_0,,,,2,2,1,3
C(C(C=C)(C(CO)(CO)O)O)(O)=O,,,5,1,1,0,1
13496_0,,,,2,2,1,3
C(C(C=C)(C(C=CC)O)O)(O)=O,,,5,1,2,0,2
13498_0,,,,2,2,1,3
C(C(C=C)(C(CC=C)O)O)(O)=O,,,5,1,2,0,2
13500_0,,,,2,2,1,3
C(C(C=C)(C(C(O)=O)(C)O)O)(O)=O,,,5,1,2,0,2
13502_0,,,,2,2,1,3
C(C(C(C(O)=O)=C)(C(C)O)O)(O)=O,,,5,1,1,0,1
13504_0,,,,2,2,1,3
C(C(C(O)=O)(C(C(O)=O)=C)O)(O)=O,,,5,1,1,0,1
13505_0,,,,2,2,1,3
13507_0,,,,2,2,1,3
C(C)(C(C)(C(C(C(O)=O)=C)O)O)=O,,,5,1,1,0,1
13509_0,,,,2,2,1,3
C(C(CC)(C(C(C(O)=O)=C)O)O)=O,,,5,1,1,0,1
13510_0,,,,2,2,1,3
13512_0,,,,2,2,1,3
C(C(C)(C(C(C(O)=O)=C)O)O)(O)=O,,,5,1,1,0,1
13514_0,,,,2,2,1,3
C(C(C=O)C(C(C=O)=O)(CO)O)=O,,,5,1,1,0,1
13516_0,,,,2,2,1,3
C(C(C=O)CC(C(C(O)=O)O)O)=O,,,5,1,1,0,1
13518_0,,,,2,2,1,3
C(C(C(C(C=O)CC=O)O)O)(O)=O,,,5,1,1,0,1
13520_0,,,,2,2,1,3
C(C)(C(C)(C(CC(C=O)=O)O)O)=O,,,5,1,1,0,1
13522_0,,,,2,2,1,3
C(C(C(CC(C=O)=O)O)(CC)O)=O,,,5,1,1,0,1
13523_0,,,,2,2,1,3
13524_0,,,,2,2,1,3
13526_0,,,,2,2,1,3
C(C)(C(C)(C(C(CC=O)=O)O)O)=O,,,5,1,1,0,1
13528_0,,,,2,2,1,3
C(C(CC)(C(C(CC=O)=O)O)O)=O,,,5,1,1,0,1
13529_0,,,,2,2,1,3
13531_0,,,,2,2,1,3
C(C(C)(C(C(CC=O)=O)O)O)(O)=O,,,5,1,1,0,1
13533_0,,,,2,2,1,3
C(C)(C(C)(C(C=O)(CC=O)O)O)=O,,,5,1,1,0,1
13535_0,,,,2,2,1,3
C(CC(C=O)(C(C=O)(CC)O)O)=O,,,5,1,1,0,1
13536_0,,,,2,2,1,3
13537_0,,,,2,2,1,3
13539_0,,,,2,2,1,3
C(C(C(C)(CC(C=O)=O)O)O)(O)=O,,,5,1,1,0,1
13541_0,,,,2,2,1,3
C(C(C(C(CC(C)=O)=O)O)O)(O)=O,,,5,1,1,0,1
13543_0,,,,2,2,1,3
C(C(C(C=O)(CC(C)=O)O)O)(O)=O,,,5,1,1,0,1
13545_0,,,,2,2,1,3
C(C(C(C(C=O)=O)(CC)O)O)(O)=O,,,5,1,1,0,1
13547_0,,,,2,2,1,3
C(C(C(C(C(CC)=O)=O)O)O)(O)=O,,,5,1,1,0,1
13549_0,,,,2,2,1,3
C(CC)(C(C=O)(C(C(O)=O)O)O)=O,,,5,1,1,0,1
13551_0,,,,2,2,1,3
C(C(C=O)C(C(O)=O)(C(C)O)O)=O,,,5,1,1,0,1
13553_0,,,,2,2,1,3
C(C(C(O)=O)(C(C=O)C=O)O)(O)=O,,,5,1,1,0,1
13554_0,,,,2,2,1,3
13556_0,,,,2,2,1,3
C(C(CC)(C(C(C)=O)(C)O)O)(O)=O,,,5,1,1,0,1
13558_0,,,,2,2,1,3
C(C(CC)(C(C=O)(CC)O)O)(O)=O,,,5,1,1,0,1
13560_0,,,,2,2,1,3
C(C(CC)(C(C(O)=O)O)O)(O)=O,,,5,1,1,0,1
13562_0,,,,2,2,1,3
C(C(CC)(C(C(O)=O)(C)O)O)(O)=O,,,5,1,1,0,1
13564_0,,,,2,2,1,3
C(C)(C(C)(C(C)(C(C)O)O)O)=O,,,5,1,1,0,1
13566_0,,,,2,2,1,3
C(C)(C(C)(C(CO)(CC)O)O)=O,,,5,1,1,0,1
13568_0,,,,2,2,1,3
C(C)(C(C)(C(C(C(C)O)=C)O)O)=O,,,5,1,1,0,1
13570_0,,,,2,2,1,3
C(C)(C(C)(C(C(CO)=CC)O)O)=O,,,5,1,1,0,1
13572_0,,,,2,2,1,3
C(C)(C(C)(C(C=C)O)O)=O,,,5,1,1,0,1
13574_0,,,,2,2,1,3
C(C(C=C)(C(C(C)=O)(C)O)O)(O)=O,,,5,1,1,0,1
13576_0,,,,2,2,1,3
C(C)(C(C)(C(C(CC)O)O)O)=O,,,5,1,1,0,1
13578_0,,,,2,2,1,3
C(C)(C(C)(C(CCCO)O)O)=O,,,5,1,1,0,1
13580_0,,,,2,2,1,3
C1(C(CCO1)(C(C(C)=O)(C)O)O)=O,,,5,1,1,0,1
13582_0,,,,2,2,1,3
C(C)(C(C)(C(CC(CO)C)O)O)=O,,,5,1,1,0,1
13584_0,,,,2,2,1,3
C(C)(C(C)(C(C)O)O)=O,,,5,1,1,0,1
13585_0,,,,2,2,1,3
13587_0,,,,2,2,1,3
C(C)(C(C)(C(CC(C)O)O)O)=O,,,5,1,1,0,1
13589_0,,,,2,2,1,3
C(CC(C(C(C)=O)(C)O)O)(O)=O,,,5,1,1,0,1
13591_0,,,,2,2,1,3
C(C)(C(C)(C(C(CO)=O)O)O)=O,,,5,1,1,0,1
13593_0,,,,2,2,1,3
C(C(CO)(C(C(C)=O)(C)O)O)=O,,,5,1,1,0,1
13595_0,,,,2,2,1,3
C(C)(C(CO)(C)O)=O,,,5,1,1,0,1
13597_0,,,,2,2,1,3
C(C)(C(C)(C(CCO)O)O)=O,,,5,1,1,0,1
13599_0,,,,2,2,1,3
C(C)(C(C)(C(C=O)O)O)=O,,,5,1,1,0,1
13601_0,,,,2,2,1,3
C(C(C(C(C(C)=O)(C)O)O)O)=O,,,5,1,1,0,1
13603_0,,,,2,2,1,3
C(C)(C(C)(C(CO)(CO)O)O)=O,,,5,1,1,0,1
13605_0,,,,2,2,1,3
C(C(CO)(C(C(C)=O)(C)O)O)(O)=O,,,5,1,1,0,1
13607_0,,,,2,2,1,3
C(C(C(C(C(C)=O)(C)O)O)O)(O)=O,,,5,1,1,0,1
13609_0,,,,2,2,1,3
C(C)(C(C)(C(C=CC)O)O)=O,,,5,1,1,0,1
13611_0,,,,2,2,1,3
C(C)(C(C)(C(CC=C)O)O)=O,,,5,1,1,0,1
13613_0,,,,2,2,1,3
C(C(C)(C(C(C)=O)(C)O)O)(O)=O,,,5,1,1,0,1
13615_0,,,,2,2,1,3
C(C(CC)(C(C)(C(C)O)O)O)=O,,,5,1,1,0,1
13617_0,,,,2,2,1,3
C(C(C(C)(C(C)O)O)O)(O)=O,,,5,1,1,0,1
13619_0,,,,2,2,1,3
C(C(C)(C(C)(C(C)O)O)O)(O)=O,,,5,1,1,0,1
13621_0,,,,2,2,1,3
C(C(CC)(C(CO)(CC)O)O)=O,,,5,1,1,0,1
13623_0,,,,2,2,1,3
C(C(C(CO)(CC)O)O)(O)=O,,,5,1,1,0,1
13625_0,,,,2,2,1,3
C(C(C)(C(CO)(CC)O)O)(O)=O,,,5,1,1,0,1
13627_0,,,,2,2,1,3
C(C(CC(C)=O)(C(C=C)O)O)(O)=O,,,5,1,1,0,1
13629_0,,,,2,2,1,3
C(C(C(C)O)(CC(C)=O)O)(O)=O,,,5,1,2,0,2
13630_0,,,,2,2,1,3
13632_0,,,,2,2,1,3
C(C(CO)(CC(C)=O)O)(O)=O,,,5,1,2,0,2
13634_0,,,,2,2,1,3
C(C(CC(C)=O)(C(C=O)O)O)(O)=O,,,5,1,1,0,1
13636_0,,,,2,2,1,3
C(C(C(C=O)=O)(CO)O)=CC(C)O,,,5,1,1,0,1
13638_0,,,,2,2,1,3
C(C(C(C=CCC(C)O)O)O)(O)=O,,,5,1,1,0,1
13640_0,,,,2,2,1,3
C(C(C(CC=CC(C)O)O)O)(O)=O,,,5,1,1,0,1
13642_0,,,,2,2,1,3
C(CO)(C(C(C=O)=CC)(CO)O)=O,,,5,1,1,0,1
13644_0,,,,2,2,1,3
C(C(CC)(C(C(C(C)O)=C)O)O)=O,,,5,1,1,0,1
13646_0,,,,2,2,1,3
C(C(C(C(C(C)O)=C)O)O)(O)=O,,,5,1,2,0,2
13648_0,,,,2,2,1,3
C(C(C)(C(C(C(C)O)=C)O)O)(O)=O,,,5,1,1,0,1
13650_0,,,,2,2,1,3
C(C(CC)(C(C(CO)=CC)O)O)=O,,,5,1,1,0,1
13652_0,,,,2,2,1,3
C(C(C(C(CO)=CC)O)O)(O)=O,,,5,1,2,0,2
13654_0,,,,2,2,1,3
C(C(C)(C(C(CO)=CC)O)O)(O)=O,,,5,1,1,0,1
13656_0,,,,2,2,1,3
C(C(C(C(C(C)O)=CC)O)O)(O)=O,,,5,1,1,0,1
13658_0,,,,2,2,1,3
C(C(C(C(C(O)=O)=CC)O)O)(O)=O,,,5,1,1,0,1
13660_0,,,,2,2,1,3
C(C(C(C=O)=O)(CO)O)=CC(O)=O,,,5,1,1,0,1
13662_0,,,,2,2,1,3
C(CC=CC(C(C(O)=O)O)O)(O)=O,,,5,1,1,0,1
13664_0,,,,2,2,1,3
C(C(C(CC=CC(O)=O)O)O)(O)=O,,,5,1,1,0,1
13666_0,,,,2,2,1,3
C(C(C(C=CC(CO)=O)O)O)(O)=O,,,5,1,1,0,1
13668_0,,,,2,2,1,3
C(C(C(C=CC=O)(CO)O)O)(O)=O,,,5,1,1,0,1
13670_0,,,,2,2,1,3
C(C(C(C=C(C=O)CO)O)O)(O)=O,,,5,1,1,0,1
13672_0,,,,2,2,1,3
C(C(C(C(CO)=CC=O)O)O)(O)=O,,,5,1,1,0,1
13674_0,,,,2,2,1,3
C=CC(C(C=O)=O)(C(C=C)O)O,,,5,1,1,0,1
13676_0,,,,2,2,1,3
C=CC(C(C=O)=O)(C(C)O)O,,,5,1,2,0,2
13678_0,,,,2,2,1,3
C(C(C=C)(C(C=O)=O)O)(O)=O,,,5,1,2,0,2
13680_0,,,,2,2,1,3
C=CC(C(C=O)=O)(CO)O,,,5,1,2,0,2
13682_0,,,,2,2,1,3
C=CC(C(C=O)=O)(C(CCO)O)O,,,5,1,1,0,1
13684_0,,,,2,2,1,3
C(C(C(C=C)(C(C=O)=O)O)O)=O,,,5,1,2,0,2
13686_0,,,,2,2,1,3
C=CC(C(C=O)=O)(C(C=CC)O)O,,,5,1,1,0,1
13688_0,,,,2,2,1,3
C=CC(C(C=O)=O)(C(CC=C)O)O,,,5,1,1,0,1
13690_0,,,,2,2,1,3
C(C(C(C(C(C=C)O)=O)O)O)(O)=O,,,5,1,1,0,1
13691_0,,,,2,2,1,3
13693_0,,,,2,2,1,3
C(C(CC)(C(C=C)O)O)=O,,,5,1,1,0,1
13695_0,,,,2,2,1,3
C=CC(C(C(C(O)=O)=O)(CC)O)O,,,5,1,1,0,1
13697_0,,,,2,2,1,3
C(C(C)C(C=O)(C(C=C)O)O)(O)=O,,,5,1,1,0,1
13699_0,,,,2,2,1,3
C1(C(C(C=C)O)(O)OCC1O)=O,,,5,1,1,0,1
13701_0,,,,2,2,1,3
C1(C(C(C=C)O)(O)OC(C)C1O)=O,,,5,1,1,0,1
13703_0,,,,2,2,1,3
C1(C(C(C(C(C=C)O)(O)O1)=O)O)=O,,,5,1,1,0,1
13705_0,,,,2,2,1,3
C1(COC(CC1(C(C=C)O)O)O)=O,,,5,1,1,0,1
13706_0,,,,2,2,1,3
13708_0,,,,2,2,1,3
C(CC(C(CO)=O)(C(C=C)O)O)=O,,,5,1,1,0,1
13710_0,,,,2,2,1,3
C=CC(C(C(C(CO)=O)=O)(C)O)O,,,5,1,1,0,1
13712_0,,,,2,2,1,3
C(C(C)(C(C=C)O)O)(O)=O,,,5,1,2,0,2
13714_0,,,,2,2,1,3
C(C(C=C)(C(C=O)(CC)O)O)(O)=O,,,5,1,1,0,1
13715_0,,,,2,2,1,3
13716_0,,,,2,2,1,3
13718_0,,,,2,2,1,3
C(C(C=CC(C)O)(C(C)O)O)(O)=O,,,5,1,1,0,1
13720_0,,,,2,2,1,3
C(C(C(O)=O)(C=CC(C)O)O)(O)=O,,,5,1,1,0,1
13721_0,,,,2,2,1,3
13723_0,,,,2,2,1,3
C(C(C=CC(O)=O)(C(C)O)O)(O)=O,,,5,1,1,0,1
13725_0,,,,2,2,1,3
C(C(C(O)=O)(C=CC(O)=O)O)(O)=O,,,5,1,1,0,1
13726_0,,,,2,2,1,3
13728_0,,,,2,2,1,3
C(C(C(C(C(O)=O)=C)(C)O)O)(O)=O,,,5,1,1,0,1
13730_0,,,,2,2,1,3
C(C(CC)(C(C(CC)O)O)O)=O,,,5,1,1,0,1
13732_0,,,,2,2,1,3
C(C(CC)(C(CCCO)O)O)=O,,,5,1,1,0,1
13734_0,,,,2,2,1,3
C1(C(CCO1)(C(C=O)(CC)O)O)=O,,,5,1,1,0,1
13736_0,,,,2,2,1,3
C(C(CC)(C(CC(CO)C)O)O)=O,,,5,1,1,0,1
13738_0,,,,2,2,1,3
C(C(C(C)O)(CC)O)=O,,,5,1,2,0,2
13739_0,,,,2,2,1,3
13741_0,,,,2,2,1,3
C(C(CC)(C(CC(C)O)O)O)=O,,,5,1,2,0,2
13743_0,,,,2,2,1,3
C(C(C(CC(O)=O)O)(CC)O)=O,,,5,1,2,0,2
13745_0,,,,2,2,1,3
C(C(CC)(C(C(CO)=O)O)O)=O,,,5,1,2,0,2
13747_0,,,,2,2,1,3
C(C(CC)(C(C=O)(CO)O)O)=O,,,5,1,2,0,2
13749_0,,,,2,2,1,3
C(C(CO)(CC)O)=O,,,5,1,2,0,2
13751_0,,,,2,2,1,3
C(C(CC)(C(CCO)O)O)=O,,,5,1,1,0,1
13753_0,,,,2,2,1,3
C(C(CC)(C(C=O)O)O)=O,,,5,1,1,0,1
13755_0,,,,2,2,1,3
C(C(C(C(C=O)O)O)(CC)O)=O,,,5,1,1,0,1
13757_0,,,,2,2,1,3
C(C(CC)(C(CO)(CO)O)O)=O,,,5,1,1,0,1
13759_0,,,,2,2,1,3
C(C(CO)(C(C=O)(CC)O)O)(O)=O,,,5,1,1,0,1
13761_0,,,,2,2,1,3
C(C(C(C(C(O)=O)O)O)(CC)O)=O,,,5,1,1,0,1
13763_0,,,,2,2,1,3
C(C(CC)(C(C=CC)O)O)=O,,,5,1,1,0,1
13765_0,,,,2,2,1,3
C(C(C(CC=C)O)(CC)O)=O,,,5,1,1,0,1
13767_0,,,,2,2,1,3
C(C(C)(C(C=O)(CC)O)O)(O)=O,,,5,1,2,0,2
13769_0,,,,2,2,1,3
C(C(C(C(CC)O)O)O)(O)=O,,,5,1,2,0,2
13771_0,,,,2,2,1,3
C(C(C)(C(C(CC)O)O)O)(O)=O,,,5,1,2,0,2
13773_0,,,,2,2,1,3
C(C(C(CCCO)O)O)(O)=O,,,5,1,2,0,2
13775_0,,,,2,2,1,3
C(C(C)(C(CCCO)O)O)(O)=O,,,5,1,2,0,2
13777_0,,,,2,2,1,3
C(C(C(C(C)O)(CC)O)=O)(O)=O,,,5,1,2,0,2
13779_0,,,,2,2,1,3
C(C(C(C(O)=O)=O)(CC)O)(O)=O,,,5,1,2,0,2
13781_0,,,,2,2,1,3
C(C(C(CO)(CC)O)=O)(O)=O,,,5,1,2,0,2
13783_0,,,,2,2,1,3
C(C(C(C(C(O)=O)=O)(CC)O)O)=O,,,5,1,1,0,1
13785_0,,,,2,2,1,3
C(C(C)C(C=O)(C(C)O)O)(O)=O,,,5,1,2,0,2
13786_0,,,,2,2,1,3
13788_0,,,,2,2,1,3
C(C(C)C(C=O)(CO)O)(O)=O,,,5,1,2,0,2
13790_0,,,,2,2,1,3
C(C(C)C(C=O)(C(C=O)O)O)(O)=O,,,5,1,1,0,1
13792_0,,,,2,2,1,3
C1(C(C)C(C(C(O1)=O)=O)(CO)O)=O,,,5,1,2,0,2
13794_0,,,,2,2,1,3
C1(C(C(C)O)(O)OCC1O)=O,,,5,1,2,0,2
13796_0,,,,2,2,1,3
C(C1(C(C(CO1)O)=O)O)(O)=O,,,5,1,2,0,2
13798_0,,,,2,2,1,3
C1(C(CO)(O)OCC1O)=O,,,5,1,1,0,1
13800_0,,,,2,2,1,3
C1(C(C(CCO)O)(O)OCC1O)=O,,,5,1,1,0,1
13802_0,,,,2,2,1,3
C(C(C1(C(C(CO1)O)=O)O)O)=O,,,5,1,1,0,1
13804_0,,,,2,2,1,3
C1(C(C(C=CC)O)(O)OCC1O)=O,,,5,1,1,0,1
13806_0,,,,2,2,1,3
C1(C(C(CC=C)O)(O)OCC1O)=O,,,5,1,1,0,1
13808_0,,,,2,2,1,3
C(C(C1(C(O)OCC1O)O)O)(O)=O,,,5,1,2,0,2
13810_0,,,,2,2,1,3
C1(C(C(C)O)(O)OC(C)C1O)=O,,,5,1,2,0,2
13812_0,,,,2,2,1,3
C(C1(C(C(C(C)O1)O)=O)O)(O)=O,,,5,1,2,0,2
13814_0,,,,2,2,1,3
C1(C(CO)(O)OC(C)C1O)=O,,,5,1,1,0,1
13816_0,,,,2,2,1,3
C(C(C1(C(C(C(C)O1)O)=O)O)O)=O,,,5,1,1,0,1
13818_0,,,,2,2,1,3
C1(C(C(C(C(C)O)(O)O1)=O)O)=O,,,5,1,2,0,2
13820_0,,,,2,2,1,3
C1(C(C(C(C(O)=O)(O)O1)=O)O)=O,,,5,1,2,0,2
13822_0,,,,2,2,1,3
C1(C(C(C(CO)(O)O1)=O)O)=O,,,5,1,1,0,1
13824_0,,,,2,2,1,3
C1(C(C(C(C(C=O)O)(O)O1)=O)O)=O,,,5,1,1,0,1
13826_0,,,,2,2,1,3
C1(COC(CC1(C(C)O)O)O)=O,,,5,1,2,0,2
13828_0,,,,2,2,1,3
C(C1(C(COC(C1)O)=O)O)(O)=O,,,5,1,2,0,2
13830_0,,,,2,2,1,3
C1(COC(CC1(CO)O)O)=O,,,5,1,2,0,2
13832_0,,,,2,2,1,3
C1(COC(CC1(C(C=O)O)O)O)=O,,,5,1,2,0,2
13834_0,,,,2,2,1,3
C(CO)(C1(CO)CC(C(O1)=O)=O)=O,,,5,1,1,0,1
13836_0,,,,2,2,1,3
C1(C(CCO1)(C(C(O)=O)O)O)=O,,,5,1,2,0,2
13838_0,,,,2,2,1,3
C1(C(CCO1)(C(C(O)=O)(C)O)O)=O,,,5,1,1,0,1
13840_0,,,,2,2,1,3
C(C(C1(C(C(OC1)=O)=O)O)O)(O)=O,,,5,1,1,0,1
13842_0,,,,2,2,1,3
C1(C(C(CO1)=O)(C(C(O)=O)O)O)=O,,,5,1,1,0,1
13844_0,,,,2,2,1,3
C1(C(C=O)C(C(CO1)=O)(CO)O)=O,,,5,1,1,0,1
13846_0,,,,2,2,1,3
C1(COC(C(CC1(CO)O)=O)=O)=O,,,5,1,1,0,1
13847_0,,,,2,2,1,3
13849_0,,,,2,2,1,3
C(C(C(CC(CO)C)O)O)(O)=O,,,5,1,1,0,1
13851_0,,,,2,2,1,3
C(C(C)(C(CC(CO)C)O)O)(O)=O,,,5,1,1,0,1
13852_0,,,,2,2,1,3
13854_0,,,,2,2,1,3
C(C(C(CC(C)C(C)O)O)O)(O)=O,,,5,1,1,0,1
13855_0,,,,2,2,1,3
13856_0,,,,2,2,1,3
13857_0,,,,2,2,1,3
13858_0,,,,2,2,1,3
13859_0,,,,2,2,1,3
13860_0,,,,2,2,1,3
13861_0,,,,2,1,1,2
13862_0,,,,2,1,1,2
13863_0,,,,2,1,2,3
13864_0,,,,2,1,2,3
13865_0,,,,2,1,2,3
13866_0,,,,2,1,2,3
13867_0,,,,2,1,2,3
13868_0,,,,2,1,2,3
13869_0,,,,2,1,2,3
13870_0,,,,2,1,2,3
13871_0,,,,2,1,2,3
13872_0,,,,2,1,2,3
13872_1,,,,2,1,2,3
13873_0,,,,2,1,2,3
13873_1,,,,2,1,2,3
13875_0,,,,2,1,2,3
C(CC(C)=O)=O,,,5,1,1,0,1
13876_0,,,,2,1,2,3
13877_0,,,,2,1,2,3
13877_1,,,,2,1,2,3
13878_0,,,,2,1,2,3
13878_1,,,,2,1,2,3
13879_0,,,,2,1,2,3
13879_1,,,,2,1,2,3
13880_0,,,,2,1,2,3
13880_1,,,,2,1,2,3
13881_0,,,,2,1,2,3
13882_0,,,,2,1,2,3
13883_0,,,,2,1,2,3
13884_0,,,,2,1,2,3
13885_0,,,,2,1,2,3
13886_0,,,,2,1,2,3
13887_0,,,,2,1,2,3
13888_0,,,,2,1,2,3
13889_0,,,,2,1,2,3
13890_0,,,,2,1,2,3
13891_0,,,,2,1,2,3
13892_0,,,,2,1,2,3
13893_0,,,,2,1,2,3
13894_0,,,,2,1,2,3
13895_0,,,,2,1,2,3
13895_1,,,,2,1,2,3
13896_0,,,,2,1,2,3
13896_1,,,,2,1,2,3
13897_0,,,,2,1,2,3
13898_0,,,,2,1,2,3
13899_0,,,,2,1,2,3
13900_0,,,,2,1,2,3
13901_0,,,,2,1,2,3
13902_0,,,,2,1,2,3
13903_0,,,,2,1,2,3
13904_0,,,,2,1,2,3
13905_0,,,,2,1,2,3
13906_0,,,,2,1,2,3
13907_0,,,,2,1,2,3
13908_0,,,,2,1,2,3
13909_0,,,,2,1,2,3
13910_0,,,,2,1,2,3
13911_0,,,,2,1,2,3
13912_0,,,,2,1,2,3
13913_0,,,,2,1,2,3
13914_0,,,,2,1,2,3
13914_1,,,,2,1,2,3
13915_0,,,,2,1,2,3
13915_1,,,,2,1,2,3
13916_0,,,,2,1,2,3
13917_0,,,,2,1,2,3
13918_0,,,,2,1,2,3
13919_0,,,,2,1,2,3
13920_0,,,,2,1,2,3
13921_0,,,,2,1,2,3
13922_0,,,,2,1,2,3
13923_0,,,,2,1,2,3
13923_1,,,,2,1,2,3
13924_0,,,,2,1,2,3
13924_1,,,,2,1,2,3
13925_0,,,,2,1,2,3
13925_1,,,,2,1,2,3
13926_0,,,,2,1,2,3
13926_1,,,,2,1,2,3
13927_0,,,,2,1,2,3
13927_1,,,,2,1,2,3
13928_0,,,,2,1,2,3
13929_0,,,,2,1,2,3
13930_0,,,,2,1,2,3
13931_0,,,,2,1,2,3
13932_0,,,,2,1,2,3
13933_0,,,,2,1,2,3
13933_1,,,,2,1,2,3
13934_0,,,,2,1,2,3
13934_1,,,,2,1,2,3
13935_0,,,,2,1,2,3
13935_1,,,,2,1,2,3
13936_0,,,,2,1,2,3
13936_1,,,,2,1,2,3
13937_0,,,,2,1,2,3
13937_1,,,,2,1,2,3
13938_0,,,,2,1,2,3
13939_0,,,,2,1,2,3
13940_0,,,,2,1,2,3
13941_0,,,,2,1,2,3
13942_0,,,,2,1,2,3
13943_0,,,,2,1,2,3
13944_0,,,,2,1,2,3
13945_0,,,,2,1,2,3
13946_0,,,,2,1,2,3
13947_0,,,,2,1,2,3
13948_0,,,,2,1,2,3
13949_0,,,,2,1,2,3
13950_0,,,,2,1,2,3
13951_0,,,,2,1,2,3
13952_0,,,,2,1,2,3
13953_0,,,,2,1,2,3
13954_0,,,,2,1,2,3
13955_0,,,,2,1,2,3
13956_0,,,,2,1,2,3
13957_0,,,,2,1,2,3
13958_0,,,,2,1,2,3
13959_0,,,,2,1,2,3
13960_0,,,,2,1,2,3
13961_0,,,,2,1,2,3
13962_0,,,,2,1,2,3
13962_1,,,,2,1,2,3
13963_0,,,,2,1,2,3
13963_1,,,,2,1,2,3
13964_0,,,,2,1,2,3
13964_1,,,,2,1,2,3
13965_0,,,,2,1,2,3
13965_1,,,,2,1,2,3
13966_0,,,,2,1,2,3
13966_1,,,,2,1,2,3
13967_0,,,,2,1,2,3
13967_1,,,,2,1,2,3
13968_0,,,,2,1,2,3
13968_1,,,,2,1,2,3
13969_0,,,,2,1,2,3
13969_1,,,,2,1,2,3
13970_0,,,,2,1,2,3
13970_1,,,,2,1,2,3
13971_0,,,,2,1,2,3
13971_1,,,,2,1,2,3
13972_0,,,,2,1,2,3
13972_1,,,,2,1,2,3
13973_0,,,,2,1,2,3
13973_1,,,,2,1,2,3
13974_0,,,,2,1,2,3
13974_1,,,,2,1,2,3
13975_0,,,,2,1,2,3
13975_1,,,,2,1,2,3
13976_0,,,,2,1,2,3
13976_1,,,,2,1,2,3
13977_0,,,,2,1,2,3
13977_1,,,,2,1,2,3
13978_0,,,,2,1,2,3
13978_1,,,,2,1,2,3
13979_0,,,,2,1,2,3
13979_1,,,,2,1,2,3
13980_0,,,,2,1,2,3
13980_1,,,,2,1,2,3
13981_0,,,,2,1,2,3
13981_1,,,,2,1,2,3
13982_0,,,,2,1,2,3
13983_0,,,,2,1,2,3
13985_0,,,,2,1,1,2
C(CC(OCC(C=O)=O)O)(O)=O,,,5,1,2,0,2
13987_0,,,,2,1,1,2
C(OCC(C=O)(CC(O)=O)O)=O,,,5,1,1,0,1
13989_0,,,,2,1,1,2
C(CC(O)OC(C(C)=O)=O)(O)=O,,,5,1,1,0,1
13991_0,,,,2,1,1,2
C(C(C)(CC(O)=O)O)(OC=O)=O,,,5,1,1,0,1
13993_0,,,,2,1,1,2
C(C(COC(C=O)(CO)O)O)(O)=O,,,5,1,2,0,2
13993_1,,,,2,1,1,2
13994_0,,,,2,1,2,3
13994_1,,,,2,1,2,3
13996_0,,,,2,1,1,2
C(C(CO)O)(OC(C=O)(CO)O)=O,,,5,1,2,0,2
13996_1,,,,2,1,1,2
13998_0,,,,2,1,1,2
C(C(COC(C(CO)=O)O)O)(O)=O,,,5,1,2,0,2
13998_1,,,,2,1,1,2
13999_0,,,,2,1,2,3
13999_1,,,,2,1,2,3
14001_0,,,,2,1,1,2
C(C(CO)O)(OC(C(CO)=O)O)=O,,,5,1,2,0,2
14001_1,,,,2,1,1,2
14003_0,,,,2,1,1,2
C(OC(C)CC(CC(O)=O)O)=O,,,5,1,1,0,1
14005_0,,,,2,1,1,2
C(CC(O)OC(C)CC=O)(O)=O,,,5,1,1,0,1
14007_0,,,,2,1,1,2
C(OC(CC(CC(O)=O)O)=O)=O,,,5,1,1,0,1
14009_0,,,,2,1,1,2
C(CC=O)(OC(CC(O)=O)O)=O,,,5,1,1,0,1
14010_0,,,,2,1,1,2
14012_0,,,,2,1,1,2
C(OCC(C(CC(O)=O)O)=O)=O,,,5,1,1,0,1
14013_0,,,,2,1,2,3
14013_1,,,,2,1,2,3
14015_0,,,,2,1,1,2
C(CC=O)(OC(C(O)=O)CO)=O,,,5,1,2,0,2
14015_1,,,,2,1,1,2
14016_0,,,,2,1,2,3
14016_1,,,,2,1,2,3
14018_0,,,,2,1,1,2
C(C(CO)O)(OCC(C=O)=O)=O,,,5,1,4,0,4
14018_1,,,,2,1,1,2
14019_0,,,,2,1,2,3
14019_1,,,,2,1,2,3
14021_0,,,,2,1,1,2
C(CC(C)OC(C(CO)O)=O)=O,,,5,1,2,0,2
14021_1,,,,2,1,1,2
14022_0,,,,2,1,2,3
14022_1,,,,2,1,2,3
14024_0,,,,2,1,1,2
C(CC=O)(OC(C(CO)O)=O)=O,,,5,1,2,0,2
14024_1,,,,2,1,1,2
14026_0,,,,2,1,1,2
C(CC=O)(OCC(C(O)=O)O)=O,,,5,1,2,0,2
14026_1,,,,2,1,1,2
14027_0,,,,2,1,2,3
14027_1,,,,2,1,2,3
14028_0,,,,2,1,1,2
14028_1,,,,2,1,1,2
14030_0,,,,2,1,1,2
C(C(CC(C(C=O)=O)O)O)(O)=O,,,5,1,2,0,2
14032_0,,,,2,1,1,2
C(C(C(CC(C(O)=O)O)=O)O)=O,,,5,1,1,0,1
14033_0,,,,2,1,2,3
14034_0,,,,2,1,2,3
14035_0,,,,2,1,2,3
14036_0,,,,2,1,2,3
14037_0,,,,2,1,2,3
14038_0,,,,2,1,2,3
14039_0,,,,2,1,2,3
14040_0,,,,2,1,2,3
14041_0,,,,2,1,2,3
14042_0,,,,2,1,2,3
14043_0,,,,2,1,2,3
14044_0,,,,2,1,2,3
14045_0,,,,2,1,2,3
14046_0,,,,2,1,2,3
14047_0,,,,2,1,2,3
14048_0,,,,2,1,2,3
14049_0,,,,2,1,2,3
14050_0,,,,2,1,2,3
14051_0,,,,2,1,2,3
14052_0,,,,2,1,2,3
14053_0,,,,2,1,2,3
14054_0,,,,2,1,2,3
14055_0,,,,2,1,2,3
14056_0,,,,2,1,2,3
14057_0,,,,2,1,2,3
14058_0,,,,2,1,2,3
14059_0,,,,2,1,2,3
14060_0,,,,2,1,2,3
14061_0,,,,2,1,2,3
14062_0,,,,2,1,2,3
14063_0,,,,2,1,2,3
14064_0,,,,2,1,2,3
14065_0,,,,2,1,2,3
14066_0,,,,2,1,2,3
14067_0,,,,2,1,2,3
14068_0,,,,2,1,2,3
14069_0,,,,2,1,2,3
14070_0,,,,2,1,2,3
14071_0,,,,2,1,2,3
14072_0,,,,2,1,2,3
14073_0,,,,2,1,2,3
14074_0,,,,2,1,2,3
14075_0,,,,2,1,2,3
14077_0,,,,2,1,2,3
C(C(CCO)O)(O)=O,,,5,1,3,0,3
14078_0,,,,2,1,2,3
14079_0,,,,2,1,2,3
14080_0,,,,2,1,2,3
14081_0,,,,2,1,2,3
14082_0,,,,2,1,2,3
14083_0,,,,2,1,2,3
14084_0,,,,2,1,2,3
14085_0,,,,2,1,2,3
14086_0,,,,2,1,2,3
14087_0,,,,2,1,2,3
14088_0,,,,2,1,2,3
14089_0,,,,2,1,2,3
14090_0,,,,2,1,2,3
14091_0,,,,2,1,2,3
14092_0,,,,2,1,2,3
14093_0,,,,2,1,2,3
14094_0,,,,2,1,2,3
14096_0,,,,2,1,2,3
C(C(C=CC)O)(O)=O,,,5,1,1,0,1
14097_0,,,,2,1,2,3
14099_0,,,,2,1,2,3
C(C(CC=C)O)(O)=O,,,5,1,1,0,1
14100_0,,,,2,1,2,3
14101_0,,,,2,1,2,3
14102_0,,,,2,1,2,3
14104_0,,,,2,1,2,3
C1(C(CC(C)O1)O)=O,,,5,1,1,0,1
14105_0,,,,2,1,2,3
14107_0,,,,2,1,2,3
C1(CC(C(O1)=O)O)=O,,,5,1,1,0,1
14109_0,,,,2,1,2,3
C(CO)(OC(C(C)=O)=O)=O,,,5,1,2,0,2
14111_0,,,,2,1,1,2
C(C(C)O)(OC(C=O)=O)=O,,,5,1,1,0,1
14112_0,,,,2,1,1,2
14113_0,,,,2,1,2,3
14114_0,,,,2,1,2,3
14115_0,,,,2,1,2,3
14116_0,,,,2,1,2,3
14118_0,,,,2,1,1,2
C(CO)(OC(C(C=O)=C)=O)=O,,,5,1,2,0,2
14120_0,,,,2,1,2,3
C1(C(C(C(O1)=O)=C)O)=O,,,5,1,3,0,3
14122_0,,,,2,1,1,2
C(COC(C(C=O)=C)=O)(O)=O,,,5,1,2,0,2
14123_0,,,,2,1,2,3
14124_0,,,,2,1,2,3
14125_0,,,,2,1,2,3
14126_0,,,,2,1,2,3
14127_0,,,,2,1,2,3
14129_0,,,,2,1,1,2
C(C(C(C)=O)(O)OC(CO)=O)=O,,,5,1,1,0,1
14131_0,,,,2,1,1,2
C(CO)(OC(C(C=O)=O)(C)O)=O,,,5,1,1,0,1
14132_0,,,,2,1,1,2
14134_0,,,,2,1,1,2
C(CO)(OC(C=O)=O)=O,,,5,1,1,0,1
14135_0,,,,2,1,2,3
14137_0,,,,2,1,1,2
C(C(C=O)C)(OC(C(O)=O)O)=O,,,5,1,1,0,1
14139_0,,,,2,1,1,2
C(C(C=O)(O)OC(C(C)O)=O)=O,,,5,1,1,0,1
14141_0,,,,2,1,1,2
C(C(C)OC(C(C=O)=O)O)(O)=O,,,5,1,1,0,1
14143_0,,,,2,1,1,2
C(COC(C(C=O)=O)(C)O)(O)=O,,,5,1,1,0,1
14145_0,,,,2,1,1,2
C(C(CO)(O)OC(CO)=O)=O,,,5,1,1,0,1
14147_0,,,,2,1,1,2
C(CO)(OC(C(CO)=O)O)=O,,,5,1,1,0,1
14149_0,,,,2,1,1,2
C(C(C)O)(OC(C(C=O)=O)O)=O,,,5,1,1,0,1
14151_0,,,,2,1,1,2
C(CC=O)(OCC(O)=O)=O,,,5,1,1,0,1
14153_0,,,,2,1,1,2
C(CO)(OCC(C=O)=O)=O,,,5,1,2,0,2
14154_0,,,,2,1,1,2
14156_0,,,,2,1,1,2
C(C1(C(OCC(O1)=O)=O)C)=O,,,5,1,1,0,1
14158_0,,,,2,1,1,2
C(C1C(OC(C(O1)=O)C)=O)=O,,,5,1,1,0,1
14160_0,,,,2,1,1,2
C(CC(C)OC(CO)=O)=O,,,5,1,1,0,1
14162_0,,,,2,1,1,2
C(CC=O)(OC(CO)=O)=O,,,5,1,1,0,1
14163_0,,,,2,1,1,2
14164_0,,,,2,1,2,3
14165_0,,,,2,1,2,3
14166_0,,,,2,1,2,3
14167_0,,,,2,1,2,3
14168_0,,,,2,1,2,3
14170_0,,,,2,1,2,3
C1(C(C(C(C(C)O)C1)O)=O)=O,,,5,1,1,0,1
14171_0,,,,2,1,2,3
14173_0,,,,2,1,2,3
C(C1CC(C(C1O)=O)=O)(O)=O,,,5,1,2,0,2
14174_0,,,,2,1,2,3
14175_0,,,,2,1,2,3
14177_0,,,,2,1,2,3
C(C1C(C(C(C1O)=O)O)=O)=O,,,5,1,1,0,1
14178_0,,,,2,1,2,3
14180_0,,,,2,1,2,3
C(C1C(C(C(C1O)O)=O)=O)=O,,,5,1,1,0,1
14181_0,,,,2,1,2,3
14182_0,,,,2,1,2,3
14184_0,,,,2,1,2,3
C1(C(C(CC1)O)=O)=O,,,5,1,2,0,2
14186_0,,,,2,1,2,3
C(C1C(C(C(C1)O)=O)=O)(O)=O,,,5,1,2,0,2
14188_0,,,,2,1,2,3
C(C1C(C(C(C1)=O)O)=O)(O)=O,,,5,1,1,0,1
14189_0,,,,2,1,2,3
14190_0,,,,2,1,2,3
14191_0,,,,2,1,2,3
14193_0,,,,2,1,2,3
C(C(CO)CC=O)(CC=O)=O,,,5,1,1,0,1
14195_0,,,,2,1,2,3
C(CC(C(CC(C=O)=O)=O)O)=O,,,5,1,1,0,1
14197_0,,,,2,1,2,3
C(CC(C(C(CC=O)O)=O)=O)=O,,,5,1,1,0,1
14198_0,,,,2,1,2,3
14199_0,,,,2,1,2,3
14200_0,,,,2,1,2,3
14201_0,,,,2,1,2,3
14202_0,,,,2,1,2,3
14203_0,,,,2,1,2,3
14204_0,,,,2,1,2,3
14205_0,,,,2,1,2,3
14206_0,,,,2,1,2,3
14207_0,,,,2,1,2,3
14208_0,,,,2,1,2,3
14209_0,,,,2,1,2,3
14210_0,,,,2,1,2,3
14212_0,,,,2,1,2,3
C(C(CO)C(C=O)C(CO)=O)=O,,,5,1,1,0,1
14213_0,,,,2,1,2,3
14214_0,,,,2,1,2,3
14216_0,,,,2,1,2,3
C(C(C=C)C(C=O)C(CO)=O)=O,,,5,1,1,0,1
14217_0,,,,2,1,2,3
14218_0,,,,2,1,2,3
14220_0,,,,2,1,2,3
C(C(C(CO)=O)CC=O)=O,,,5,1,2,0,2
14221_0,,,,2,1,2,3
14222_0,,,,2,1,2,3
14224_0,,,,2,1,2,3
C(C(C)O)(C(C=O)CC=O)=O,,,5,1,2,0,2
14226_0,,,,2,1,2,3
C(C(C(C(O)=O)=O)CC=O)=O,,,5,1,2,0,2
14228_0,,,,2,1,2,3
C(C(CO)=O)(CCCO)=O,,,5,1,2,0,2
14230_0,,,,2,1,2,3
C(CCO)(CC(CO)=O)=O,,,5,1,1,0,1
14232_0,,,,2,1,2,3
C(C(C(CCCO)=O)=O)(O)=O,,,5,1,1,0,1
14233_0,,,,2,1,2,3
14235_0,,,,2,1,2,3
C(C(C(CCCO)=O)=O)=O,,,5,1,1,0,1
14236_0,,,,2,1,2,3
14238_0,,,,2,1,2,3
C(C(C(CC=O)=O)CO)=O,,,5,1,1,0,1
14240_0,,,,2,1,2,3
C(C(CO)CC(C=O)=O)=O,,,5,1,1,0,1
14242_0,,,,2,1,2,3
C(C(CO)C(C=O)CO)=O,,,5,1,2,0,2
14243_0,,,,2,1,2,3
14245_0,,,,2,1,2,3
C(C(C(C(C=O)CO)=O)C)(O)=O,,,5,1,1,0,1
14247_0,,,,2,1,2,3
C(C(C(CC(O)=O)=O)CO)=O,,,5,1,1,0,1
14248_0,,,,2,1,2,3
14249_0,,,,2,1,2,3
14251_0,,,,2,1,2,3
C(CC(C(C)=O)C(CO)=O)=O,,,5,1,1,0,1
14253_0,,,,2,1,2,3
C(C(CC(C(C(C)O)=O)=O)=O)=O,,,5,1,1,0,1
14255_0,,,,2,1,2,3
C(CC(C(C(C(C)O)=O)=O)=O)=O,,,5,1,1,0,1
14257_0,,,,2,1,2,3
C(C)(CC(C(C(C)O)=O)=O)=O,,,5,1,1,0,1
14259_0,,,,2,1,2,3
C(C(C(C(C)O)=O)=O)(CC)=O,,,5,1,1,0,1
14261_0,,,,2,1,2,3
C(CC(C(C(C)O)=O)=O)=O,,,5,1,1,0,1
14263_0,,,,2,1,2,3
C(C(C(C)=O)=O)(C(C)O)=O,,,5,1,1,0,1
14264_0,,,,2,1,2,3
14266_0,,,,2,1,2,3
C(C(CC(C(C(O)=O)=O)=O)=O)=O,,,5,1,1,0,1
14268_0,,,,2,1,2,3
C(CC(C(C(C(O)=O)=O)=O)=O)=O,,,5,1,1,0,1
14269_0,,,,2,1,2,3
14271_0,,,,2,1,2,3
C(C(C(C(O)=O)=O)=O)(CC)=O,,,5,1,1,0,1
14273_0,,,,2,1,2,3
C(CC(C(C(O)=O)=O)=O)=O,,,5,1,2,0,2
14275_0,,,,2,1,2,3
C(C(C(C(C)=O)=O)=O)(O)=O,,,5,1,1,0,1
14276_0,,,,2,1,2,3
14278_0,,,,2,1,2,3
C(CO)(CC(C=O)=O)=O,,,5,1,1,0,1
14279_0,,,,2,1,2,3
14281_0,,,,2,1,2,3
C(C(CC(C(O)=O)=O)=O)=O,,,5,1,1,0,1
14282_0,,,,2,1,2,3
14283_0,,,,2,1,2,3
14284_0,,,,2,1,2,3
14286_0,,,,2,1,2,3
C(C(C=O)O)(CC(CO)=O)=O,,,5,1,1,0,1
14288_0,,,,2,1,2,3
C(CC(C(C(CO)=O)O)=O)=O,,,5,1,1,0,1
14289_0,,,,2,1,2,3
14291_0,,,,2,1,2,3
C(C(CC(C(C(O)=O)=O)=O)O)=O,,,5,1,1,0,1
14293_0,,,,2,1,2,3
C(C(C(CC(C(O)=O)=O)=O)O)=O,,,5,1,1,0,1
14295_0,,,,2,1,2,3
C(CC(C(C(C(O)=O)=O)O)=O)=O,,,5,1,1,0,1
14296_0,,,,2,1,2,3
14298_0,,,,2,1,2,3
C(C(C(CC=O)=O)C=C)=O,,,5,1,1,0,1
14300_0,,,,2,1,2,3
C(C(C=C)CC(C=O)=O)=O,,,5,1,1,0,1
14302_0,,,,2,1,2,3
C(CC(CC=O)=O)=O,,,5,1,3,0,3
14304_0,,,,2,1,2,3
C(CCC(C=O)=O)=O,,,5,1,1,0,1
14306_0,,,,2,1,2,3
C(C(C(CC=O)=O)C(C)O)=O,,,5,1,2,0,2
14308_0,,,,2,1,2,3
C(C(C(C)O)CC(C=O)=O)=O,,,5,1,1,0,1
14310_0,,,,2,1,2,3
C(C(C(O)=O)C(CC=O)=O)=O,,,5,1,2,0,2
14312_0,,,,2,1,2,3
C(C(C(O)=O)CC(C=O)=O)=O,,,5,1,1,0,1
14313_0,,,,2,1,2,3
14314_0,,,,2,1,2,3
14316_0,,,,2,1,2,3
C(CC(C(C(C=O)=O)O)=O)=O,,,5,1,2,0,2
14317_0,,,,2,1,2,3
14318_0,,,,2,1,2,3
14320_0,,,,2,1,2,3
C(C(CCC(C(O)=O)=O)=O)=O,,,5,1,1,0,1
14322_0,,,,2,1,2,3
C(C(CO)=O)(C(CO)CO)=O,,,5,1,1,0,1
14323_0,,,,2,1,2,3
14325_0,,,,2,1,2,3
C(C(C(C(CO)CO)=O)=O)(O)=O,,,5,1,1,0,1
14326_0,,,,2,1,2,3
14328_0,,,,2,1,2,3
C(C(C=C)C(C=O)CO)=O,,,5,1,1,0,1
14329_0,,,,2,1,2,3
14330_0,,,,2,1,2,3
14331_0,,,,2,1,2,3
14332_0,,,,2,1,2,3
14333_0,,,,2,1,2,3
14334_0,,,,2,1,2,3
14335_0,,,,2,1,2,3
14336_0,,,,2,1,2,3
14337_0,,,,2,1,2,3
14338_0,,,,2,1,2,3
14340_0,,,,2,1,2,3
C(CO)(CC(C=CC)=O)=O,,,5,1,1,0,1
14342_0,,,,2,1,2,3
C(CC(C(CO)=O)=O)=CC,,,5,1,1,0,1
14344_0,,,,2,1,2,3
C(CC(CO)=O)(CC=C)=O,,,5,1,1,0,1
14346_0,,,,2,1,2,3
C=CCCC(C(CO)=O)=O,,,5,1,1,0,1
14347_0,,,,2,1,2,3
14348_0,,,,2,1,2,3
14349_0,,,,2,1,2,3
14350_0,,,,2,1,2,3
14351_0,,,,2,1,2,3
14352_0,,,,2,1,2,3
14353_0,,,,2,1,2,3
14354_0,,,,2,1,2,3
14355_0,,,,2,1,2,3
14356_0,,,,2,1,2,3
14357_0,,,,2,1,2,3
14358_0,,,,2,1,2,3
14360_0,,,,2,1,2,3
C(C(C(O)=O)C(C=O)C=C)=O,,,5,1,1,0,1
14361_0,,,,2,1,2,3
14362_0,,,,2,1,2,3
14363_0,,,,2,1,2,3
14364_0,,,,2,1,2,3
14365_0,,,,2,1,2,3
14366_0,,,,2,1,2,3
14368_0,,,,2,1,2,3
C(C)=CC(CC(C(O)=O)=O)=O,,,5,1,1,0,1
14370_0,,,,2,1,2,3
C(CC(C(C(O)=O)=O)=O)=CC,,,5,1,1,0,1
14372_0,,,,2,1,2,3
C(CC(C(O)=O)=O)(CC=C)=O,,,5,1,1,0,1
14374_0,,,,2,1,2,3
C=CCCC(C(C(O)=O)=O)=O,,,5,1,1,0,1
14375_0,,,,2,1,2,3
14376_0,,,,2,1,2,3
14377_0,,,,2,1,2,3
14378_0,,,,2,1,2,3
14379_0,,,,2,1,2,3
14380_0,,,,2,1,2,3
14381_0,,,,2,1,2,3
14382_0,,,,2,1,2,3
14383_0,,,,2,1,2,3
14384_0,,,,2,1,2,3
14385_0,,,,2,1,2,3
14386_0,,,,2,1,2,3
14387_0,,,,2,1,2,3
14388_0,,,,2,1,2,3
14389_0,,,,2,1,2,3
14390_0,,,,2,1,2,3
14391_0,,,,2,1,2,3
14393_0,,,,2,1,2,3
C(C(C(C(C(O)=O)C)=O)C=C)=O,,,5,1,1,0,1
14395_0,,,,2,1,2,3
C(CC=O)(C(C(O)=O)C)=O,,,5,1,1,0,1
14397_0,,,,2,1,2,3
C(C(C(CC(O)=O)=O)C=C)=O,,,5,1,1,0,1
14399_0,,,,2,1,2,3
C(C(C=C)CC(C(O)=O)=O)=O,,,5,1,1,0,1
14401_0,,,,2,1,2,3
C(CC(CC(O)=O)=O)=O,,,5,1,1,0,1
14403_0,,,,2,1,2,3
C(CCC(C(O)=O)=O)=O,,,5,1,1,0,1
14405_0,,,,2,1,2,3
C(C(C(CC(O)=O)=O)C(C)O)=O,,,5,1,1,0,1
14407_0,,,,2,1,2,3
C(C(C(C)O)CC(C(O)=O)=O)=O,,,5,1,1,0,1
14409_0,,,,2,1,2,3
C(C(C(O)=O)C(CC(O)=O)=O)=O,,,5,1,2,0,2
14410_0,,,,2,1,2,3
14411_0,,,,2,1,2,3
14413_0,,,,2,1,2,3
C(C(C(CC(C=O)=O)=O)O)(O)=O,,,5,1,1,0,1
14415_0,,,,2,1,2,3
C(CC(C(C(C=O)=O)O)=O)(O)=O,,,5,1,1,0,1
14416_0,,,,2,1,2,3
14417_0,,,,2,1,2,3
14419_0,,,,2,1,2,3
C(C(CCC(C(O)=O)=O)=O)(O)=O,,,5,1,1,0,1
14421_0,,,,2,1,2,3
C(CC(C(C=O)=O)=O)=CC,,,5,1,2,0,2
14423_0,,,,2,1,2,3
C(C)=CC(CC(C=O)=O)=O,,,5,1,2,0,2
14425_0,,,,2,1,2,3
C=CCCC(C(C=O)=O)=O,,,5,1,2,0,2
14427_0,,,,2,1,2,3
C(CC(C=O)=O)(CC=C)=O,,,5,1,2,0,2
14429_0,,,,2,1,2,3
C(C(C=O)C(C=O)C=C)=O,,,5,1,2,0,2
14431_0,,,,2,1,2,3
C(CC(C(CC(C)O)O)=O)(O)=O,,,5,1,1,0,1
14432_0,,,,2,1,2,3
14433_0,,,,2,1,2,3
14434_0,,,,2,1,2,3
14436_0,,,,2,1,2,3
C(CC(C(CC(O)=O)O)=O)(O)=O,,,5,1,1,0,1
14437_0,,,,2,1,2,3
14438_0,,,,2,1,2,3
14439_0,,,,2,1,2,3
14441_0,,,,2,1,2,3
C(C(C(CC(O)=O)=O)(CO)O)=O,,,5,1,1,0,1
14442_0,,,,2,1,2,3
14443_0,,,,2,1,2,3
14444_0,,,,2,1,2,3
14445_0,,,,2,1,2,3
14446_0,,,,2,1,2,3
14447_0,,,,2,1,2,3
14448_0,,,,2,1,2,3
14449_0,,,,2,1,2,3
14450_0,,,,2,1,2,3
14451_0,,,,2,1,2,3
14452_0,,,,2,1,2,3
14453_0,,,,2,1,2,3
14454_0,,,,2,1,2,3
14455_0,,,,2,1,2,3
14456_0,,,,2,1,2,3
14457_0,,,,2,1,2,3
14458_0,,,,2,1,2,3
14459_0,,,,2,1,2,3
14460_0,,,,2,1,2,3
14461_0,,,,2,1,2,3
14462_0,,,,2,1,2,3
14463_0,,,,2,1,2,3
14464_0,,,,2,1,2,3
14465_0,,,,2,1,2,3
14466_0,,,,2,1,2,3
14467_0,,,,2,1,2,3
14468_0,,,,2,1,2,3
14469_0,,,,2,1,2,3
14470_0,,,,2,1,2,3
14471_0,,,,2,1,2,3
14472_0,,,,2,1,2,3
14473_0,,,,2,1,2,3
14474_0,,,,2,1,2,3
14475_0,,,,2,1,2,3
14476_0,,,,2,1,2,3
14477_0,,,,2,1,2,3
14479_0,,,,2,1,2,3
C(C(C(CC=O)=O)O)(O)=O,,,5,1,2,0,2
14480_0,,,,2,1,2,3
14481_0,,,,2,1,2,3
14482_0,,,,2,1,2,3
14483_0,,,,2,1,2,3
14484_0,,,,2,1,2,3
14485_0,,,,2,1,2,3
14486_0,,,,2,1,2,3
14487_0,,,,2,1,2,3
14488_0,,,,2,1,2,3
14489_0,,,,2,1,2,3
14491_0,,,,2,1,2,3
C(C(C(O)=O)C)=O,,,5,1,2,0,2
14492_0,,,,2,1,2,3
14493_0,,,,2,1,2,3
14494_0,,,,2,1,2,3
14495_0,,,,2,1,2,3
14496_0,,,,2,1,2,3
14498_0,,,,2,1,2,3
C(CCO)(C(C(C=O)=O)CO)=O,,,5,1,1,0,1
14499_0,,,,2,1,2,3
14501_0,,,,2,1,2,3
C(C(C(C(C=O)=O)CO)=O)=O,,,5,1,1,0,1
14502_0,,,,2,1,2,3
14504_0,,,,2,1,2,3
C(C)=CC(C(C(C=O)=O)CO)=O,,,5,1,1,0,1
14505_0,,,,2,1,2,3
14507_0,,,,2,1,2,3
C(CC=C)(C(C(C=O)=O)CO)=O,,,5,1,1,0,1
14508_0,,,,2,1,2,3
14509_0,,,,2,1,2,3
14510_0,,,,2,1,2,3
14511_0,,,,2,1,2,3
14512_0,,,,2,1,2,3
14514_0,,,,2,1,2,3
C(C(C(C(C=O)=O)C(C)O)=O)=O,,,5,1,1,0,1
14515_0,,,,2,1,2,3
14516_0,,,,2,1,2,3
14517_0,,,,2,1,2,3
14519_0,,,,2,1,2,3
C(C(C(C=O)=O)C(C=O)=O)(O)=O,,,5,1,1,0,1
14521_0,,,,2,1,2,3
C(C(C=O)C(CCO)=O)=O,,,5,1,1,0,1
14522_0,,,,2,1,2,3
14524_0,,,,2,1,2,3
C(C(C(CCO)=O)C(C)O)(O)=O,,,5,1,1,0,1
14526_0,,,,2,1,2,3
C(C(C(O)=O)C(CCO)=O)(O)=O,,,5,1,1,0,1
14528_0,,,,2,1,2,3
C(C(C=O)C(CCO)=O)(O)=O,,,5,1,1,0,1
14529_0,,,,2,1,2,3
14530_0,,,,2,1,2,3
14531_0,,,,2,1,2,3
14532_0,,,,2,1,2,3
14534_0,,,,2,1,2,3
C(C(C(C=O)=O)C(C)O)(O)=O,,,5,1,1,0,1
14536_0,,,,2,1,2,3
C(C(C(O)=O)C(C=O)=O)(O)=O,,,5,1,1,0,1
14537_0,,,,2,1,2,3
14539_0,,,,2,1,2,3
C(C(C=O)(C(CC=O)=O)O)=O,,,5,1,1,0,1
14540_0,,,,2,1,2,3
14541_0,,,,2,1,2,3
14542_0,,,,2,1,2,3
14543_0,,,,2,1,2,3
14545_0,,,,2,1,2,3
C(C(C=O)(C(CC(O)=O)=O)O)=O,,,5,1,1,0,1
14547_0,,,,2,1,2,3
C(C(C=O)C(C(C(O)=O)O)=O)=O,,,5,1,1,0,1
14548_0,,,,2,1,2,3
14550_0,,,,2,1,2,3
C(C(C=O)C(C=CC)=O)=O,,,5,1,1,0,1
14552_0,,,,2,1,2,3
C(C(C=O)C(CC=C)=O)=O,,,5,1,1,0,1
14554_0,,,,2,1,2,3
C(C(C=O)C(C)=O)=O,,,5,1,1,0,1
14556_0,,,,2,1,2,3
C(C(C=O)C(CC(C)O)=O)=O,,,5,1,1,0,1
14558_0,,,,2,1,2,3
C(C(C=O)C(CC(O)=O)=O)=O,,,5,1,1,0,1
14559_0,,,,2,1,2,3
14561_0,,,,2,1,2,3
C(C(C=O)C(C=O)(C=O)O)=O,,,5,1,1,0,1
14563_0,,,,2,1,2,3
C(C(C(CC=O)=O)CO)(O)=O,,,5,1,1,0,1
14565_0,,,,2,1,2,3
C(C(CO)CC(C=O)=O)(O)=O,,,5,1,1,0,1
14567_0,,,,2,1,2,3
C(C(C(CC=O)=O)C(C)O)(O)=O,,,5,1,1,0,1
14569_0,,,,2,1,2,3
C(C(C(C)O)CC(C=O)=O)(O)=O,,,5,1,1,0,1
14571_0,,,,2,1,2,3
C(C(C(O)=O)C(CC=O)=O)(O)=O,,,5,1,1,0,1
14573_0,,,,2,1,2,3
C(C(C(O)=O)CC(C=O)=O)(O)=O,,,5,1,1,0,1
14575_0,,,,2,1,2,3
C(C(C=O)C(C(C=O)O)=O)(O)=O,,,5,1,1,0,1
14577_0,,,,2,1,2,3
C(C(C=O)(C(CC=O)=O)O)(O)=O,,,5,1,1,0,1
14578_0,,,,2,1,2,3
14579_0,,,,2,1,2,3
14580_0,,,,2,1,2,3
14581_0,,,,2,1,2,3
14582_0,,,,2,1,2,3
14584_0,,,,2,1,2,3
C(C(C(C)O)C(C=O)CO)(O)=O,,,5,1,1,0,1
14586_0,,,,2,1,2,3
C(C(C(O)=O)C(C=O)CO)(O)=O,,,5,1,1,0,1
14587_0,,,,2,1,2,3
14589_0,,,,2,1,2,3
C(C(C(CO)=O)C(C(O)=O)O)=O,,,5,1,2,0,2
14590_0,,,,2,1,2,3
14592_0,,,,2,1,2,3
C(C(C(C=CC)=O)C(C)O)(O)=O,,,5,1,1,0,1
14593_0,,,,2,1,2,3
14595_0,,,,2,1,2,3
C(C(C(CC=C)=O)C(C)O)(O)=O,,,5,1,1,0,1
14596_0,,,,2,1,2,3
14597_0,,,,2,1,2,3
14598_0,,,,2,1,2,3
14600_0,,,,2,1,2,3
C(C(C(O)=O)C(C=CC)=O)(O)=O,,,5,1,1,0,1
14602_0,,,,2,1,2,3
C(C(C(O)=O)C(CC=C)=O)(O)=O,,,5,1,1,0,1
14604_0,,,,2,1,2,3
C(C(C(O)=O)C(C=CC)=O)=O,,,5,1,1,0,1
14606_0,,,,2,1,2,3
C(C(C(O)=O)C(CC=C)=O)=O,,,5,1,1,0,1
14608_0,,,,2,1,2,3
C(C(C(O)=O)C(C)=O)=O,,,5,1,1,0,1
14610_0,,,,2,1,2,3
C(C(C=O)C(CC(C)O)=O)(O)=O,,,5,1,1,0,1
14611_0,,,,2,1,2,3
14612_0,,,,2,1,2,3
14614_0,,,,2,1,2,3
C(C(C=O)(C(C=O)C=O)O)(O)=O,,,5,1,1,0,1
14615_0,,,,2,1,2,3
14616_0,,,,2,1,2,3
14618_0,,,,2,1,2,3
C(C(C(C=CC)=O)CO)(O)=O,,,5,1,2,0,2
14619_0,,,,2,1,2,3
14621_0,,,,2,1,2,3
C(C(C(CC=C)=O)CO)(O)=O,,,5,1,2,0,2
14622_0,,,,2,1,2,3
14623_0,,,,2,1,2,3
14624_0,,,,2,1,2,3
14625_0,,,,2,1,2,3
14626_0,,,,2,1,2,3
14627_0,,,,2,1,2,3
14628_0,,,,2,1,2,3
14629_0,,,,2,1,2,3
14630_0,,,,2,1,2,3
14631_0,,,,2,1,2,3
14632_0,,,,2,1,2,3
14633_0,,,,2,1,2,3
14634_0,,,,2,1,2,3
14635_0,,,,2,1,2,3
14637_0,,,,2,1,2,3
C(C(CC(CO)C(C)O)=O)(O)=O,,,5,1,1,0,1
14638_0,,,,2,1,2,3
14640_0,,,,2,1,2,3
C(CC(C(CO)=O)C(C=O)=O)=O,,,5,1,1,0,1
14641_0,,,,2,1,2,3
14643_0,,,,2,1,2,3
C(C(C(C(O)=O)=O)C(CO)O)=O,,,5,1,1,0,1
14644_0,,,,2,1,2,3
14645_0,,,,2,1,2,3
14646_0,,,,2,1,2,3
14648_0,,,,2,1,2,3
C(C(C(CCO)=O)C)(O)=O,,,5,1,1,0,1
14649_0,,,,2,1,2,3
14650_0,,,,2,1,2,3
14651_0,,,,2,1,2,3
14653_0,,,,2,1,2,3
C(CC(C(C)=O)C(C(O)=O)=O)=O,,,5,1,1,0,1
14655_0,,,,2,1,2,3
C(CC=O)(C(C(C(O)=O)=O)C)=O,,,5,1,1,0,1
14657_0,,,,2,1,2,3
C(C(CCC(C(C)=O)=O)=O)(O)=O,,,5,1,1,0,1
14659_0,,,,2,1,2,3
C(CC(O)=O)(CC(C(C)=O)=O)=O,,,5,1,1,0,1
14661_0,,,,2,1,2,3
C(C(C(C(C(CO)=O)=O)C)=O)=O,,,5,1,1,0,1
14663_0,,,,2,1,2,3
C(C)(C(C(C(CO)=O)=O)C)=O,,,5,1,1,0,1
14665_0,,,,2,1,2,3
C(C(C(C(CO)=O)=O)C)=O,,,5,1,1,0,1
14667_0,,,,2,1,2,3
C(C(C(C=O)=O)C)(O)=O,,,5,1,1,0,1
14669_0,,,,2,1,2,3
C(C(C(C(C=O)O)=O)C)(O)=O,,,5,1,1,0,1
14671_0,,,,2,1,2,3
C(C(C(CC=O)=O)(C)O)(O)=O,,,5,1,1,0,1
14672_0,,,,2,1,2,3
14673_0,,,,2,1,2,3
14675_0,,,,2,1,2,3
C(C(C(C=CC)=O)C)(O)=O,,,5,1,1,0,1
14677_0,,,,2,1,2,3
C(CC=C)(C(C(O)=O)C)=O,,,5,1,1,0,1
14679_0,,,,2,1,2,3
C(C)(C(C(O)=O)C)=O,,,5,1,1,0,1
14681_0,,,,2,1,2,3
C(C(C(CC(C)O)=O)C)(O)=O,,,5,1,1,0,1
14683_0,,,,2,1,2,3
C(CC(O)=O)(C(C(O)=O)C)=O,,,5,1,1,0,1
14685_0,,,,2,1,2,3
C(C(C=O)C(C(O)=O)(C)O)=O,,,5,1,1,0,1
14686_0,,,,2,1,2,3
14688_0,,,,2,1,2,3
C(CC(C(C(O)=O)O)=O)(O)=O,,,5,1,1,0,1
14690_0,,,,2,1,2,3
C(CC(C(O)=O)=O)=CC,,,5,1,2,0,2
14692_0,,,,2,1,2,3
C(CC(C=CC)=O)(O)=O,,,5,1,2,0,2
14694_0,,,,2,1,2,3
C=CCCC(C(O)=O)=O,,,5,1,2,0,2
14696_0,,,,2,1,2,3
C(CC(CC=C)=O)(O)=O,,,5,1,2,0,2
14698_0,,,,2,1,2,3
C(C(C=CC)C(C(O)=O)=O)(O)=O,,,5,1,1,0,1
14700_0,,,,2,1,2,3
C(C(C(C(O)=O)=O)CC=C)(O)=O,,,5,1,1,0,1
14702_0,,,,2,1,2,3
C=C(C(O)=O)CCC(C(O)=O)=O,,,5,1,1,0,1
14704_0,,,,2,1,2,3
C(CC(CC(C(O)=O)=C)=O)(O)=O,,,5,1,1,0,1
14706_0,,,,2,1,2,3
C(CC(C(O)=O)=O)=C(C(O)=O)C,,,5,1,1,0,1
14708_0,,,,2,1,2,3
C(CC(C=C(C(O)=O)C)=O)(O)=O,,,5,1,1,0,1
14710_0,,,,2,1,2,3
C1(C(C(C(O)=O)=O)CC(C)O1)=O,,,5,1,1,0,1
14712_0,,,,2,1,2,3
C1(C(C(C(O)=O)=O)CC(O1)=O)=O,,,5,1,1,0,1
14713_0,,,,2,1,2,3
14714_0,,,,2,1,2,3
14716_0,,,,2,1,2,3
C1(C(C(C(O1)=O)=O)C)=O,,,5,1,2,0,2
14717_0,,,,2,1,2,3
14719_0,,,,2,1,2,3
C(C(C=O)C(C=O)=CC)=O,,,5,1,2,0,2
14720_0,,,,2,1,2,3
14721_0,,,,2,1,2,3
14722_0,,,,2,1,2,3
14723_0,,,,2,1,2,3
14724_0,,,,2,1,2,3
14725_0,,,,2,1,2,3
14726_0,,,,2,1,2,3
14727_0,,,,2,1,2,3
14729_0,,,,2,1,2,3
C1(CC(C(C(O1)=O)=C)=O)=O,,,5,1,3,0,3
14730_0,,,,2,1,2,3
14732_0,,,,2,1,2,3
C(C1C(OC(C1=C)=O)=O)=O,,,5,1,3,0,3
14733_0,,,,2,1,2,3
14734_0,,,,2,1,2,3
14736_0,,,,2,1,2,3
C(CC(C)O)(C(CO)C(C)O)=O,,,5,1,1,0,1
14738_0,,,,2,1,2,3
C(C)(C(CC(C)O)O)=O,,,5,1,1,0,1
14740_0,,,,2,1,2,3
C(CO)(CCC(C)O)=O,,,5,1,1,0,1
14741_0,,,,2,1,2,3
14742_0,,,,2,1,2,3
14743_0,,,,2,1,2,3
14744_0,,,,2,1,2,3
14745_0,,,,2,1,2,3
14747_0,,,,2,1,2,3
C(C(CO)=O)(C(CO)C(C)O)=O,,,5,1,1,0,1
14748_0,,,,2,1,2,3
14749_0,,,,2,1,2,3
14751_0,,,,2,1,2,3
C(C(C=O)C(CO)(C(C)O)O)=O,,,5,1,2,0,2
14752_0,,,,2,1,2,3
14753_0,,,,2,1,2,3
14754_0,,,,2,1,2,3
14755_0,,,,2,1,2,3
14756_0,,,,2,1,2,3
14757_0,,,,2,1,2,3
14758_0,,,,2,1,2,3
14759_0,,,,2,1,2,3
14761_0,,,,2,1,2,3
C(C(C(C)=O)(CC(C)O)O)(O)=O,,,5,1,1,0,1
14763_0,,,,2,1,2,3
C(C(C(CO)=O)CC(C)O)(O)=O,,,5,1,1,0,1
14764_0,,,,2,1,2,3
14765_0,,,,2,1,2,3
14766_0,,,,2,1,2,3
14767_0,,,,2,1,2,3
14768_0,,,,2,1,2,3
14769_0,,,,2,1,2,3
14770_0,,,,2,1,2,3
14772_0,,,,2,1,2,3
C(CCC(CO)=O)(O)=O,,,5,1,1,0,1
14773_0,,,,2,1,2,3
14774_0,,,,2,1,2,3
14776_0,,,,2,1,2,3
C(C(C)(CC(C(C)=O)O)O)(O)=O,,,5,1,1,0,1
14778_0,,,,2,1,2,3
C(C(C)(CCC(CO)=O)O)(O)=O,,,5,1,1,0,1
14779_0,,,,2,1,2,3
14780_0,,,,2,1,2,3
14781_0,,,,2,1,2,3
14783_0,,,,2,1,2,3
C(C(C(CO)=O)CC(O)=O)(O)=O,,,5,1,1,0,1
14784_0,,,,2,1,2,3
14785_0,,,,2,1,2,3
14787_0,,,,2,1,2,3
C(CO)(CC(CO)=O)=O,,,5,1,1,0,1
14788_0,,,,2,1,2,3
14789_0,,,,2,1,2,3
14791_0,,,,2,1,2,3
C(C(C(C)=O)(CO)O)=O,,,5,1,1,0,1
14792_0,,,,2,1,2,3
14793_0,,,,2,1,2,3
14795_0,,,,2,1,2,3
C(C(C=O)C(CO)O)=O,,,5,1,2,0,2
14796_0,,,,2,1,2,3
14797_0,,,,2,1,2,3
14798_0,,,,2,1,2,3
14799_0,,,,2,1,2,3
14800_0,,,,2,1,2,3
14801_0,,,,2,1,2,3
14803_0,,,,2,1,2,3
C(C(C(CC(CO)O)=O)=O)(O)=O,,,5,1,2,0,2
14804_0,,,,2,1,2,3
14805_0,,,,2,1,2,3
14806_0,,,,2,1,2,3
14807_0,,,,2,1,2,3
14809_0,,,,2,1,2,3
C(CCO)(C(C(C(O)=O)=O)O)=O,,,5,1,1,0,1
14811_0,,,,2,1,2,3
C1(CC(C(C(C)=O)(O)O1)=O)=O,,,5,1,2,0,2
14812_0,,,,2,1,2,3
14813_0,,,,2,1,2,3
14815_0,,,,2,1,2,3
C(CC1(CC(C(O1)=O)=O)O)=O,,,5,1,2,0,2
14816_0,,,,2,1,2,3
14817_0,,,,2,1,2,3
14819_0,,,,2,1,2,3
C1(CC(C(C(C)(O)O1)=O)=O)=O,,,5,1,2,0,2
14820_0,,,,2,1,2,3
14822_0,,,,2,1,2,3
C1(C(C(CC(C)(O)O1)=O)=O)=O,,,5,1,2,0,2
14823_0,,,,2,1,2,3
14825_0,,,,2,1,2,3
C1(C(C)OC(C(C1O)=O)=O)=O,,,5,1,2,0,2
14826_0,,,,2,1,2,3
14827_0,,,,2,1,2,3
14828_0,,,,2,1,2,3
14829_0,,,,2,1,2,3
14830_0,,,,2,1,2,3
14832_0,,,,2,1,2,3
C(C1C(C(C=O)OC1C)O)=O,,,5,1,1,0,1
14834_0,,,,2,1,2,3
C(C1C(C(CO)OC1C)=O)=O,,,5,1,1,0,1
14836_0,,,,2,1,2,3
C(C1C(C)OC(C1C=O)O)=O,,,5,1,2,0,2
14838_0,,,,2,1,2,3
C1(C(CO)C(C=O)C(C)O1)=O,,,5,1,1,0,1
14840_0,,,,2,1,2,3
C1(C(C=O)C(C(C=O)O1)O)=O,,,5,1,2,0,2
14842_0,,,,2,1,2,3
C1(C(C=O)C(C(CO)O1)=O)=O,,,5,1,2,0,2
14844_0,,,,2,1,2,3
C1(C(C=O)C(C=O)C(O)O1)=O,,,5,1,2,0,2
14846_0,,,,2,1,2,3
C1(C(C=O)C(C(O1)=O)CO)=O,,,5,1,1,0,1
14848_0,,,,2,1,2,3
C(C1(C(C(C=O)OC1)=O)O)=O,,,5,1,1,0,1
14850_0,,,,2,1,2,3
C(C1C(C(C=O)(O)OC1)=O)=O,,,5,1,2,0,2
14852_0,,,,2,1,2,3
C1(C(C(C(C=O)(O)O1)=O)C)=O,,,5,1,2,0,2
14854_0,,,,2,1,2,3
C1(C(C(C(C=O)O1)=O)(C)O)=O,,,5,1,3,0,3
14856_0,,,,2,1,2,3
C1(C(C=O)C(C(C)(O)O1)=O)=O,,,5,1,2,0,2
14857_0,,,,2,1,2,3
14859_0,,,,2,1,2,3
C(C1(COC(C=O)C1O)O)(O)=O,,,5,1,1,0,1
14861_0,,,,2,1,2,3
C(C1C(C(CO)(O)OC1)=O)(O)=O,,,5,1,2,0,2
14863_0,,,,2,1,2,3
C(C1(C(C(CO)OC1)=O)O)(O)=O,,,5,1,1,0,1
14864_0,,,,2,1,2,3
14866_0,,,,2,1,2,3
C1(C(CO)(C(C(C=O)O1)O)O)=O,,,5,1,2,0,2
14868_0,,,,2,1,2,3
C1(C(C(C(CO)(O)O1)=O)CO)=O,,,5,1,2,0,2
14870_0,,,,2,1,2,3
C1(C(C(C(CO)O1)=O)(CO)O)=O,,,5,1,2,0,2
14872_0,,,,2,1,2,3
C(C1C(O)OCC1(C(O)=O)O)=O,,,5,1,2,0,2
14874_0,,,,2,1,2,3
C1(C(CO)C(C(O)=O)(CO1)O)=O,,,5,1,3,0,3
14875_0,,,,2,1,2,3
14877_0,,,,2,1,2,3
C(C1C(O)OC(C1(CO)O)=O)=O,,,5,1,2,0,2
14879_0,,,,2,1,2,3
C1(C(CO)C(C(O1)=O)(CO)O)=O,,,5,1,3,0,3
14881_0,,,,2,1,2,3
C1(C(CC(CO)(O)O1)=O)=O,,,5,1,2,0,2
14883_0,,,,2,1,2,3
C1(C(C(C(C=O)O1)O)O)=O,,,5,1,2,0,2
14885_0,,,,2,1,2,3
C1(CC(C(CO)(O)O1)=O)=O,,,5,1,2,0,2
14887_0,,,,2,1,2,3
C1(C(C(C(CO)O1)=O)O)=O,,,5,1,2,0,2
14889_0,,,,2,1,2,3
C1(C(C(CO)C(O)O1)=O)=O,,,5,1,2,0,2
14891_0,,,,2,1,2,3
C(C1C(O)OC(C1O)=O)=O,,,5,1,2,0,2
14893_0,,,,2,1,2,3
C1(C(CO)C(C(O1)=O)O)=O,,,5,1,1,0,1
14895_0,,,,2,1,2,3
C(C1C(C(CC(C)O1)O)=O)=O,,,5,1,1,0,1
14897_0,,,,2,1,2,3
C(C1(C(CCC(C)O1)=O)O)=O,,,5,1,2,0,2
14899_0,,,,2,1,2,3
C1(CC(C=O)(O)OC(C)C1)=O,,,5,1,2,0,2
14901_0,,,,2,1,2,3
C(C1C(C(CC(O1)=O)O)=O)=O,,,5,1,2,0,2
14903_0,,,,2,1,2,3
C(C1(C(CCC(O1)=O)=O)O)=O,,,5,1,2,0,2
14905_0,,,,2,1,2,3
C1(CC(CC(C=O)(O)O1)=O)=O,,,5,1,2,0,2
14907_0,,,,2,1,2,3
C1(C(C=O)OCC(C1O)=O)=O,,,5,1,1,0,1
14909_0,,,,2,1,2,3
C1(C(C=O)(O)OCC(C1)=O)=O,,,5,1,2,0,2
14911_0,,,,2,1,2,3
C(C1(CC(C(CO1)=O)=O)O)=O,,,5,1,2,0,2
14913_0,,,,2,1,2,3
C(C1C(CC(C(O1)=O)=O)O)=O,,,5,1,2,0,2
14914_0,,,,2,1,2,3
14916_0,,,,2,1,2,3
C(C1C(C(C(O)OC1)=O)=O)=O,,,5,1,2,0,2
14918_0,,,,2,1,2,3
C(C1C(O)OC(C(C1)=O)=O)=O,,,5,1,2,0,2
14919_0,,,,2,1,2,3
14921_0,,,,2,1,2,3
C1(C(C(C(C(O)O1)=O)=O)C)=O,,,5,1,2,0,2
14923_0,,,,2,1,2,3
C1(C(C(O)OC(C)CC1)=O)=O,,,5,1,2,0,2
14925_0,,,,2,1,2,3
C1(CC(C)OC(C(C1)=O)O)=O,,,5,1,2,0,2
14927_0,,,,2,1,2,3
C1(CCC(C(C(O)O1)=O)=O)=O,,,5,1,2,0,2
14929_0,,,,2,1,2,3
C1(CC(CC(C(O)O1)=O)=O)=O,,,5,1,2,0,2
14931_0,,,,2,1,2,3
C1(COC(C(C(C1)=O)=O)O)=O,,,5,1,2,0,2
14933_0,,,,2,1,2,3
C1(C(O)OCC(C(C1)=O)=O)=O,,,5,1,2,0,2
14934_0,,,,2,1,2,3
14936_0,,,,2,1,2,3
C(C1C(C(OC1)=O)=O)=O,,,5,1,2,0,2
14937_0,,,,2,1,2,3
14938_0,,,,2,1,2,3
14940_0,,,,2,1,2,3
C1(C(C(CC(C)O1)=O)CO)=O,,,5,1,2,0,2
14941_0,,,,2,1,2,3
14943_0,,,,2,1,2,3
C1(C(C(CC(O1)=O)=O)CO)=O,,,5,1,2,0,2
14945_0,,,,2,1,2,3
C1(CC(C(C(O)=O)CO1)=O)=O,,,5,1,2,0,2
14946_0,,,,2,1,2,3
14948_0,,,,2,1,2,3
C1(C(C(C(CO1)=O)=O)CO)=O,,,5,1,2,0,2
14950_0,,,,2,1,2,3
C1(C(OC(C)CC1)=O)=O,,,5,1,2,0,2
14952_0,,,,2,1,2,3
C1(CC(C)OC(C1)=O)=O,,,5,1,2,0,2
14954_0,,,,2,1,2,3
C1(CCC(C(O1)=O)=O)=O,,,5,1,3,0,3
14956_0,,,,2,1,2,3
C1(CC(CC(O1)=O)=O)=O,,,5,1,2,0,2
14957_0,,,,2,1,2,3
14959_0,,,,2,1,2,3
C1(CC(C(CO1)=O)=O)=O,,,5,1,2,0,2
14961_0,,,,2,1,2,3
C(C(C)CC=O)(CC(C=O)=O)=O,,,5,1,1,0,1
14962_0,,,,2,1,2,3
14964_0,,,,2,1,2,3
C(C(C(C=O)=O)C(C)CC=O)=O,,,5,1,2,0,2
14966_0,,,,2,1,2,3
C(CC(C)CC(CC(O)=O)=O)=O,,,5,1,2,0,2
14968_0,,,,2,1,2,3
C(CC(C)CCC(C(O)=O)=O)=O,,,5,1,2,0,2
14970_0,,,,2,1,2,3
C(CC(C)C(C(C(O)=O)=O)C)=O,,,5,1,2,0,2
14972_0,,,,2,1,2,3
C(CC(C)C(C(C)=O)C(O)=O)=O,,,5,1,2,0,2
14973_0,,,,2,1,2,3
14975_0,,,,2,1,2,3
C(CC(C)C(C(C)=O)CO)=O,,,5,1,2,0,2
14977_0,,,,2,1,2,3
C(CC(C)CC(C(C)O)=O)=O,,,5,1,2,0,2
14979_0,,,,2,1,2,3
C(CC(C)C(C(CC)=O)O)=O,,,5,1,2,0,2
14981_0,,,,2,1,2,3
C(C(C)CC=O)(CC(C)O)=O,,,5,1,1,0,1
14983_0,,,,2,1,2,3
C(CC(C)C(CC(C)=O)O)=O,,,5,1,2,0,2
14985_0,,,,2,1,2,3
C(CC(C)CC(C(C)=O)O)=O,,,5,1,2,0,2
14987_0,,,,2,1,2,3
C(CC(C)CCC(CO)=O)=O,,,5,1,2,0,2
14988_0,,,,2,1,2,3
14990_0,,,,2,1,2,3
C(CC(C)CC(CCO)=O)=O,,,5,1,2,0,2
14992_0,,,,2,1,2,3
C(CC(C)C(C(C)=O)(C)O)=O,,,5,1,2,0,2
14994_0,,,,2,1,2,3
C(CC(C)C(C(CO)=O)C)=O,,,5,1,2,0,2
14995_0,,,,2,1,2,3
14997_0,,,,2,1,2,3
C(C(C)CC=O)(CC(O)=O)=O,,,5,1,1,0,1
14998_0,,,,2,1,2,3
14999_0,,,,2,1,2,3
15000_0,,,,2,1,2,3
15001_0,,,,2,1,2,3
15003_0,,,,2,1,2,3
C(C)(C(C)CC(C(O)=O)=O)=O,,,5,1,1,0,1
15004_0,,,,2,1,2,3
15006_0,,,,2,1,2,3
C(CC(C(O)=O)CC(C)=O)=O,,,5,1,1,0,1
15007_0,,,,2,1,2,3
15009_0,,,,2,1,2,3
C(C)(C(C(O)=O)(C)CC=O)=O,,,5,1,1,0,1
15010_0,,,,2,1,2,3
15012_0,,,,2,1,2,3
C(C(C(C)=O)C(C(O)=O)C)=O,,,5,1,1,0,1
15013_0,,,,2,1,2,3
15014_0,,,,2,1,2,3
15016_0,,,,2,1,2,3
C1(C(C=C(C(C)O)C1O)O)=O,,,5,1,1,0,1
15017_0,,,,2,1,2,3
15018_0,,,,2,1,2,3
15019_0,,,,2,1,2,3
15021_0,,,,2,1,2,3
C1(C(C(C(O)=O)=CC1O)O)=O,,,5,1,2,0,2
15022_0,,,,2,1,2,3
15024_0,,,,2,1,2,3
C1(C(C(CO)=C(C(O)=O)C1)=O)=O,,,5,1,1,0,1
15025_0,,,,2,1,2,3
15027_0,,,,2,1,2,3
C1(C(C=CC1O)O)=O,,,5,1,1,0,1
15028_0,,,,2,1,2,3
15029_0,,,,2,1,2,3
15030_0,,,,2,1,2,3
15032_0,,,,2,1,2,3
C1CC(C(C=1)=O)=O,,,5,1,1,0,1
15033_0,,,,2,1,2,3
15035_0,,,,2,1,2,3
C(CC(CC(C)O)O)=CC=O,,,5,1,1,0,1
15037_0,,,,2,1,2,3
C(CC=CC(CC(C)O)O)=O,,,5,1,1,0,1
15038_0,,,,2,1,2,3
15039_0,,,,2,1,2,3
15040_0,,,,2,1,2,3
15041_0,,,,2,1,2,3
15043_0,,,,2,1,2,3
C(C=C(C=O)C(CC(C)O)O)=O,,,5,1,1,0,1
15045_0,,,,2,1,2,3
C(C(C(C=O)=CCC(C)O)O)=O,,,5,1,1,0,1
15046_0,,,,2,1,2,3
15047_0,,,,2,1,2,3
15048_0,,,,2,1,2,3
15050_0,,,,2,1,2,3
C=C(C=O)C(CC(C)O)O,,,5,1,1,0,1
15052_0,,,,2,1,2,3
C(CC(C)O)=C(C=O)CO,,,5,1,1,0,1
15053_0,,,,2,1,2,3
15054_0,,,,2,1,2,3
15055_0,,,,2,1,2,3
15057_0,,,,2,1,2,3
C=C(C=O)C(C(CO)C(C)O)O,,,5,1,1,0,1
15059_0,,,,2,1,2,3
C(C(CO)C(C)O)=C(C=O)CO,,,5,1,1,0,1
15060_0,,,,2,1,2,3
15062_0,,,,2,1,2,3
C(C(C=C(CO)C(C)O)CO)=O,,,5,1,1,0,1
15063_0,,,,2,1,2,3
15064_0,,,,2,1,2,3
15066_0,,,,2,1,2,3
C(C(CO)C(C)O)=C(C=O)C=C,,,5,1,1,0,1
15067_0,,,,2,1,2,3
15069_0,,,,2,1,2,3
C(C(C=C)C=C(CO)C(C)O)=O,,,5,1,1,0,1
15070_0,,,,2,1,2,3
15071_0,,,,2,1,2,3
15073_0,,,,2,1,2,3
C(C(CO)C(C)O)=CC=O,,,5,1,2,0,2
15074_0,,,,2,1,2,3
15076_0,,,,2,1,2,3
C(CC=C(CO)C(C)O)=O,,,5,1,1,0,1
15077_0,,,,2,1,2,3
15078_0,,,,2,1,2,3
15080_0,,,,2,1,2,3
C(C(C(C)O)C(C)O)=CC=O,,,5,1,1,0,1
15081_0,,,,2,1,2,3
15082_0,,,,2,1,2,3
15084_0,,,,2,1,2,3
C(CC=C(C(C)O)C(C)O)=O,,,5,1,1,0,1
15086_0,,,,2,1,2,3
C(C(C=CC=O)C(C)O)(O)=O,,,5,1,2,0,2
15088_0,,,,2,1,2,3
C(CC=C(C(O)=O)C(C)O)=O,,,5,1,2,0,2
15089_0,,,,2,1,2,3
15090_0,,,,2,1,2,3
15092_0,,,,2,1,2,3
C(CC(CC=CC=O)O)(O)=O,,,5,1,2,0,2
15094_0,,,,2,1,2,3
C(CC=CC(CC(O)=O)O)=O,,,5,1,1,0,1
15095_0,,,,2,1,2,3
15096_0,,,,2,1,2,3
15098_0,,,,2,1,2,3
C(CC(C(C=O)=CC=O)O)(O)=O,,,5,1,1,0,1
15100_0,,,,2,1,2,3
C(CC=C(C=O)C(C=O)O)(O)=O,,,5,1,1,0,1
15101_0,,,,2,1,2,3
15103_0,,,,2,1,2,3
C(CC(C(C=O)=C)O)(O)=O,,,5,1,1,0,1
15105_0,,,,2,1,2,3
C(CC=C(C=O)CO)(O)=O,,,5,1,1,0,1
15106_0,,,,2,1,2,3
15108_0,,,,2,1,2,3
C(C(CO)C(C(C=O)=C)O)(O)=O,,,5,1,1,0,1
15110_0,,,,2,1,2,3
C(C(C=C(C=O)CO)CO)(O)=O,,,5,1,1,0,1
15111_0,,,,2,1,2,3
15113_0,,,,2,1,2,3
C(C(C=C(C(O)=O)CO)CO)=O,,,5,1,1,0,1
15115_0,,,,2,1,2,3
C(C(C=C(C=O)C=C)CO)(O)=O,,,5,1,1,0,1
15116_0,,,,2,1,2,3
15118_0,,,,2,1,2,3
C(C(C=C)C=C(C(O)=O)CO)=O,,,5,1,1,0,1
15120_0,,,,2,1,2,3
C(C(C=CC=O)CO)(O)=O,,,5,1,2,0,2
15121_0,,,,2,1,2,3
15123_0,,,,2,1,2,3
C(CC=C(C(O)=O)CO)=O,,,5,1,2,0,2
15125_0,,,,2,1,2,3
C(C(C(O)=O)C=CC=O)(O)=O,,,5,1,2,0,2
15127_0,,,,2,1,2,3
C(CC=C(C(O)=O)C(O)=O)=O,,,5,1,2,0,2
15129_0,,,,2,1,2,3
C(CO)(C(CC=CC=O)O)=O,,,5,1,1,0,1
15131_0,,,,2,1,2,3
C(CC=CC(C(CO)=O)O)=O,,,5,1,1,0,1
15132_0,,,,2,1,2,3
15133_0,,,,2,1,2,3
15134_0,,,,2,1,2,3
15136_0,,,,2,1,2,3
C(CO)(C(C(C=O)=CC=O)O)=O,,,5,1,1,0,1
15138_0,,,,2,1,2,3
C(C(C(C=O)=CC(CO)=O)O)=O,,,5,1,1,0,1
15140_0,,,,2,1,2,3
C(CO)(C(C(C=O)=C)O)=O,,,5,1,1,0,1
15142_0,,,,2,1,2,3
C(C(CO)=CC(CO)=O)=O,,,5,1,1,0,1
15143_0,,,,2,1,2,3
15144_0,,,,2,1,2,3
15145_0,,,,2,1,2,3
15146_0,,,,2,1,2,3
15147_0,,,,2,1,2,3
15149_0,,,,2,1,2,3
C(C(CO)(CC=CC=O)O)=O,,,5,1,1,0,1
15151_0,,,,2,1,2,3
C(C(C=CCC=O)(CO)O)=O,,,5,1,1,0,1
15152_0,,,,2,1,2,3
15154_0,,,,2,1,2,3
C(C(C(C=O)=CC=O)(CO)O)=O,,,5,1,1,0,1
15156_0,,,,2,1,2,3
C(C(C(C=O)=C(C=O)CO)O)=O,,,5,1,1,0,1
15158_0,,,,2,1,2,3
C(C(C(C=O)=C)(CO)O)=O,,,5,1,1,0,1
15160_0,,,,2,1,2,3
C(C(CO)=C(C=O)CO)=O,,,5,1,1,0,1
15162_0,,,,2,1,2,3
C(C(CO)O)(C(C(C=O)=C)O)=O,,,5,1,1,0,1
15164_0,,,,2,1,2,3
C(C=C(C=O)CO)(C(CO)O)=O,,,5,1,1,0,1
15166_0,,,,2,1,2,3
C=CC(C=O)=CC(C(CO)O)=O,,,5,1,1,0,1
15168_0,,,,2,1,2,3
C(C(C(C=O)=C)(C(CO)O)O)=O,,,5,1,1,0,1
15170_0,,,,2,1,2,3
C(C(C(CO)O)=C(C=O)CO)=O,,,5,1,1,0,1
15172_0,,,,2,1,2,3
C=CC(C=O)=C(C=O)C(CO)O,,,5,1,1,0,1
15174_0,,,,2,1,2,3
C(C=C(C=O)C(CO)O)=O,,,5,1,1,0,1
15176_0,,,,2,1,2,3
C(C=C(C=O)C(C(C)O)O)=O,,,5,1,1,0,1
15177_0,,,,2,1,2,3
15179_0,,,,2,1,2,3
C(C(C(C=O)=CC=O)O)(O)=O,,,5,1,1,0,1
15181_0,,,,2,1,2,3
C=C(C=O)C(CCO)O,,,5,1,1,0,1
15183_0,,,,2,1,2,3
C(CCO)=C(C=O)CO,,,5,1,1,0,1
15185_0,,,,2,1,2,3
C(C(C=CCO)CO)=O,,,5,1,1,0,1
15186_0,,,,2,1,2,3
15188_0,,,,2,1,2,3
C=C(C(C(O)=O)=O)C(CCO)O,,,5,1,1,0,1
15190_0,,,,2,1,2,3
C(CCO)=C(C(C(O)=O)=O)CO,,,5,1,1,0,1
15192_0,,,,2,1,2,3
C(C(C(C(O)=O)=O)CO)=CCO,,,5,1,1,0,1
15193_0,,,,2,1,2,3
15195_0,,,,2,1,2,3
C(CCO)=C(C=O)C(C(C)=O)=O,,,5,1,1,0,1
15197_0,,,,2,1,2,3
C(C(C=CCO)C(C(C)=O)=O)=O,,,5,1,1,0,1
15198_0,,,,2,1,2,3
15200_0,,,,2,1,2,3
C(CC(C(C=CCCO)=O)=O)=O,,,5,1,1,0,1
15202_0,,,,2,1,2,3
C(CC(C(CC=CCO)=O)=O)=O,,,5,1,1,0,1
15203_0,,,,2,1,2,3
15205_0,,,,2,1,2,3
C(CO)(C(C=CCO)O)=O,,,5,1,1,0,1
15206_0,,,,2,1,2,3
15208_0,,,,2,1,2,3
C(C(C(C(O)=O)=O)O)=CCO,,,5,1,1,0,1
15209_0,,,,2,1,2,3
15211_0,,,,2,1,2,3
C(CCO)=C(C=O)C=C,,,5,1,1,0,1
15213_0,,,,2,1,2,3
C(C(C=C)C=CCO)=O,,,5,1,1,0,1
15214_0,,,,2,1,2,3
15216_0,,,,2,1,2,3
C(CCO)=C(C=C)C(C(O)=O)=O,,,5,1,1,0,1
15218_0,,,,2,1,2,3
C=CC(C=CCO)C(C(O)=O)=O,,,5,1,1,0,1
15219_0,,,,2,1,2,3
15221_0,,,,2,1,2,3
C=C(C(O)=O)C(C=O)=CCCO,,,5,1,1,0,1
15223_0,,,,2,1,2,3
C(C(C=CCO)C(C(O)=O)=C)=O,,,5,1,1,0,1
15224_0,,,,2,1,2,3
15226_0,,,,2,1,2,3
C(CCO)=C1C(C(OC1C)=O)=O,,,5,1,1,0,1
15228_0,,,,2,1,2,3
C(C1C(C(OC1C)=O)=O)=CCO,,,5,1,1,0,1
15229_0,,,,2,1,2,3
15231_0,,,,2,1,2,3
C(CCO)=C1C(OC(C1=O)=O)=O,,,5,1,1,0,1
15233_0,,,,2,1,2,3
C1(C(C=CCO)C(C(O1)=O)=O)=O,,,5,1,1,0,1
15234_0,,,,2,1,2,3
15236_0,,,,2,1,2,3
C(CCO)=CC=O,,,5,1,2,0,2
15238_0,,,,2,1,2,3
C(CC=CCO)=O,,,5,1,1,0,1
15239_0,,,,2,1,2,3
15241_0,,,,2,1,2,3
C(C)=C(C=O)C(CCO)O,,,5,1,1,0,1
15243_0,,,,2,1,2,3
C(CCO)=C(C=O)C(C)O,,,5,1,1,0,1
15244_0,,,,2,1,2,3
15246_0,,,,2,1,2,3
C(C(C=CCO)C(C)O)=O,,,5,1,1,0,1
15247_0,,,,2,1,2,3
15249_0,,,,2,1,2,3
C(CCO)=C(C(O)=O)C=O,,,5,1,1,0,1
15251_0,,,,2,1,2,3
C(C(C=O)C=CCO)(O)=O,,,5,1,1,0,1
15252_0,,,,2,1,2,3
15254_0,,,,2,1,2,3
C(C(C(C=O)=O)O)=CCO,,,5,1,1,0,1
15255_0,,,,2,1,2,3
15257_0,,,,2,1,2,3
C(CCO)=CC(C(O)=O)=O,,,5,1,2,0,2
15259_0,,,,2,1,2,3
C(CC(C(O)=O)=O)=CCO,,,5,1,1,0,1
15260_0,,,,2,1,2,3
15262_0,,,,2,1,2,3
C(C(C(C(O)=O)=CCO)CO)=O,,,5,1,1,0,1
15263_0,,,,2,1,2,3
15265_0,,,,2,1,2,3
C(C(CCO)=C(C=O)CO)(O)=O,,,5,1,1,0,1
15267_0,,,,2,1,2,3
C(C(C(C=O)=C)(CCO)O)(O)=O,,,5,1,1,0,1
15269_0,,,,2,1,2,3
C(C(C(C(C)=O)=CC=O)CO)=O,,,5,1,1,0,1
15271_0,,,,2,1,2,3
C(CC(C(C)=O)=C(C=O)CO)=O,,,5,1,1,0,1
15273_0,,,,2,1,2,3
C(CC(C(C)=O)(C(C=O)=C)O)=O,,,5,1,1,0,1
15275_0,,,,2,1,2,3
C(C(C(C(CC=O)=O)=C)CO)=O,,,5,1,1,0,1
15277_0,,,,2,1,2,3
C(CC(C(C)=C(C=O)CO)=O)=O,,,5,1,1,0,1
15279_0,,,,2,1,2,3
C(CC=O)(C(C(C=O)=C)(C)O)=O,,,5,1,1,0,1
15281_0,,,,2,1,2,3
C(C(C=CC(C(C)=O)=O)CO)=O,,,5,1,1,0,1
15283_0,,,,2,1,2,3
C(CC(C(C)=O)=O)=C(C=O)CO,,,5,1,1,0,1
15285_0,,,,2,1,2,3
C=C(C=O)C(CC(C(C)=O)=O)O,,,5,1,1,0,1
15286_0,,,,2,1,2,3
15288_0,,,,2,1,2,3
C(C(C(C=O)=C)O)=O,,,5,1,1,0,1
15290_0,,,,2,1,2,3
C(C(C=C(C=O)CO)O)=O,,,5,1,1,0,1
15292_0,,,,2,1,2,3
C(C(C(C(C=O)=C)O)O)=O,,,5,1,1,0,1
15294_0,,,,2,1,2,3
C(CO)(CO)=C(C=O)CO,,,5,1,1,0,1
15296_0,,,,2,1,2,3
C=C(C=O)C(CO)(CO)O,,,5,1,1,0,1
15297_0,,,,2,1,2,3
15299_0,,,,2,1,2,3
C(C(C(C=O)=C)(CO)O)(O)=O,,,5,1,1,0,1
15300_0,,,,2,1,2,3
15302_0,,,,2,1,2,3
C(C(C=C(C=O)CO)(C)O)(O)=O,,,5,1,1,0,1
15304_0,,,,2,1,2,3
C(C(C)(C(C(C=O)=C)O)O)(O)=O,,,5,1,1,0,1
15306_0,,,,2,1,2,3
C(C(C=C(C=O)CO)O)(O)=O,,,5,1,1,0,1
15308_0,,,,2,1,2,3
C(C(C(C(C=O)=C)O)O)(O)=O,,,5,1,1,0,1
15310_0,,,,2,1,2,3
C(C)=CC=C(C=O)CO,,,5,1,1,0,1
15312_0,,,,2,1,2,3
C(C(C(C=O)=C)O)=CC,,,5,1,1,0,1
15314_0,,,,2,1,2,3
C(C(C=CC=C)CO)=O,,,5,1,1,0,1
15316_0,,,,2,1,2,3
C=CCC=C(C=O)CO,,,5,1,1,0,1
15318_0,,,,2,1,2,3
C=CCC(C(C=O)=C)O,,,5,1,1,0,1
15320_0,,,,2,1,2,3
C(C)=CC(C(O)=O)=C(C=O)CO,,,5,1,1,0,1
15322_0,,,,2,1,2,3
C(C(C=CC)(C(C=O)=C)O)(O)=O,,,5,1,1,0,1
15324_0,,,,2,1,2,3
C(C(C(C(O)=O)=CC=C)CO)=O,,,5,1,1,0,1
15326_0,,,,2,1,2,3
C=CCC(C(O)=O)=C(C=O)CO,,,5,1,1,0,1
15328_0,,,,2,1,2,3
C(C(C(C=O)=C)(CC=C)O)(O)=O,,,5,1,1,0,1
15330_0,,,,2,1,2,3
C(C(C=CC(C(O)=O)=C)CO)=O,,,5,1,1,0,1
15332_0,,,,2,1,2,3
C(CC(C(O)=O)=C)=C(C=O)CO,,,5,1,1,0,1
15334_0,,,,2,1,2,3
C=C(C(O)=O)CC(C(C=O)=C)O,,,5,1,1,0,1
15336_0,,,,2,1,2,3
C(C(CO)=CC=C(C(O)=O)C)=O,,,5,1,1,0,1
15338_0,,,,2,1,2,3
C(C(C(C=O)=C)O)=C(C(O)=O)C,,,5,1,1,0,1
15340_0,,,,2,1,2,3
C(C(C1C(OC(C=1)C)=O)CO)=O,,,5,1,1,0,1
15342_0,,,,2,1,2,3
C1(C(CC(C)O1)=C(C=O)CO)=O,,,5,1,1,0,1
15344_0,,,,2,1,2,3
C1(C(C(C=O)=C)(CC(C)O1)O)=O,,,5,1,1,0,1
15346_0,,,,2,1,2,3
C(C(C1C(OC(C=1)=O)=O)CO)=O,,,5,1,1,0,1
15348_0,,,,2,1,2,3
C1(CC(C(O1)=O)=C(C=O)CO)=O,,,5,1,1,0,1
15350_0,,,,2,1,2,3
C1(C(C(C=O)=C)(CC(O1)=O)O)=O,,,5,1,1,0,1
15352_0,,,,2,1,2,3
C=C(C=O)CO,,,5,1,2,0,2
15354_0,,,,2,1,2,3
C=CC(C=O)=C(C(O)=O)CCO,,,5,1,1,0,1
15356_0,,,,2,1,2,3
C(C(C=C)C(C(O)=O)=CCO)=O,,,5,1,1,0,1
15357_0,,,,2,1,2,3
15359_0,,,,2,1,2,3
C(C(CCO)=CC=O)(O)=O,,,5,1,2,0,2
15361_0,,,,2,1,2,3
C(CC(C(O)=O)=CCO)=O,,,5,1,1,0,1
15362_0,,,,2,1,2,3
15364_0,,,,2,1,2,3
C(C(C(CO)=CC=O)=O)(O)=O,,,5,1,2,0,2
15366_0,,,,2,1,2,3
C(C(C(C(C(O)=O)=O)=C)O)=O,,,5,1,1,0,1
15368_0,,,,2,1,2,3
C(C)=CC=C(C(C(O)=O)=O)CO,,,5,1,1,0,1
15370_0,,,,2,1,2,3
C(C(C(C(C(O)=O)=O)=C)O)=CC,,,5,1,1,0,1
15372_0,,,,2,1,2,3
C=CC=CC(C(C(O)=O)=O)CO,,,5,1,1,0,1
15374_0,,,,2,1,2,3
C=CCC=C(C(C(O)=O)=O)CO,,,5,1,1,0,1
15376_0,,,,2,1,2,3
C=CCC(C(C(C(O)=O)=O)=C)O,,,5,1,1,0,1
15378_0,,,,2,1,2,3
C=C(C(C(O)=O)=O)CO,,,5,1,1,0,1
15380_0,,,,2,1,2,3
C(CC(C(C)=O)=C(C=O)C=C)=O,,,5,1,1,0,1
15382_0,,,,2,1,2,3
C(C(C=C)C(C(C)=O)=CC=O)=O,,,5,1,1,0,1
15384_0,,,,2,1,2,3
C(CC(C(C)=O)=CC=O)=O,,,5,1,1,0,1
15386_0,,,,2,1,2,3
C(CC(C(C)=C(C=O)C=C)=O)=O,,,5,1,1,0,1
15388_0,,,,2,1,2,3
C(C(C=C)C(C(CC=O)=O)=C)=O,,,5,1,1,0,1
15390_0,,,,2,1,2,3
C(CC(C(C)=CC=O)=O)=O,,,5,1,1,0,1
15392_0,,,,2,1,2,3
C(CC(C(CC=O)=O)=C)=O,,,5,1,1,0,1
15394_0,,,,2,1,2,3
C(CC(C(C)=O)=O)=C(C=O)C=C,,,5,1,1,0,1
15396_0,,,,2,1,2,3
C(C(C=C)C=CC(C(C)=O)=O)=O,,,5,1,1,0,1
15397_0,,,,2,1,2,3
15398_0,,,,2,1,2,3
15400_0,,,,2,1,2,3
C(C(C(C(C)=O)=O)=CC=O)=O,,,5,1,1,0,1
15402_0,,,,2,1,2,3
C(C)=CC=C(C=O)C(C(C)=O)=O,,,5,1,1,0,1
15404_0,,,,2,1,2,3
C(C(C=CC=C)C(C(C)=O)=O)=O,,,5,1,1,0,1
15406_0,,,,2,1,2,3
C=CCC=C(C=O)C(C(C)=O)=O,,,5,1,1,0,1
15407_0,,,,2,1,2,3
15408_0,,,,2,1,2,3
15409_0,,,,2,1,2,3
15411_0,,,,2,1,2,3
C(CC(C(C=CC=O)=O)=O)=O,,,5,1,1,0,1
15413_0,,,,2,1,2,3
C(CC(C(C=CC=CC)=O)=O)=O,,,5,1,1,0,1
15415_0,,,,2,1,2,3
C(CC(C(CC=CC=C)=O)=O)=O,,,5,1,1,0,1
15417_0,,,,2,1,2,3
C(CC(C(C=CCC=C)=O)=O)=O,,,5,1,1,0,1
15418_0,,,,2,1,2,3
15419_0,,,,2,1,2,3
15421_0,,,,2,1,2,3
C(CC(C(C=C)=O)=O)=O,,,5,1,2,0,2
15423_0,,,,2,1,2,3
C(C(CO)=CC=O)(C(C)O)=O,,,5,1,1,0,1
15424_0,,,,2,1,2,3
15426_0,,,,2,1,2,3
C(C=C(C(CO)=O)C(C)O)=O,,,5,1,1,0,1
15427_0,,,,2,1,2,3
15428_0,,,,2,1,2,3
15430_0,,,,2,1,2,3
C=CC(C(C(C(C)O)=O)=O)O,,,5,1,1,0,1
15431_0,,,,2,1,2,3
15432_0,,,,2,1,2,3
15433_0,,,,2,1,2,3
15434_0,,,,2,1,2,3
15436_0,,,,2,1,2,3
C(C(C(CO)=O)=CC=O)(O)=O,,,5,1,1,0,1
15438_0,,,,2,1,2,3
C=CC(C(C(C(O)=O)=O)=O)O,,,5,1,1,0,1
15440_0,,,,2,1,2,3
C(C(C(C=CC=O)=O)CO)(O)=O,,,5,1,1,0,1
15441_0,,,,2,1,2,3
15443_0,,,,2,1,2,3
C=CC(C=O)=CC=O,,,5,1,2,0,2
15445_0,,,,2,1,2,3
C=CC(C(C(O)=O)=O)=CC=O,,,5,1,1,0,1
15447_0,,,,2,1,2,3
C=C(C(O)=O)C(C=O)=CC=O,,,5,1,1,0,1
15449_0,,,,2,1,2,3
C=C1C(OC(C(C1=CC=O)=O)=O)=O,,,5,1,1,0,1
15451_0,,,,2,1,2,3
C(C=C1C(C(OC1C)=O)=O)=O,,,5,1,1,0,1
15453_0,,,,2,1,2,3
C1(C(C(C(O1)=O)=O)=CC=O)=O,,,5,1,1,0,1
15454_0,,,,2,1,2,3
15455_0,,,,2,1,2,3
15456_0,,,,2,1,2,3
15457_0,,,,2,1,2,3
15459_0,,,,2,1,2,3
C(C(C(C(C(O)=O)=O)=CC)O)=O,,,5,1,1,0,1
15461_0,,,,2,1,2,3
C(C(C(C(C)O)=CC=O)=O)(O)=O,,,5,1,1,0,1
15462_0,,,,2,1,2,3
15463_0,,,,2,1,2,3
15464_0,,,,2,1,2,3
15466_0,,,,2,1,2,3
C(C(C(C=O)=C(C(O)=O)C)O)=O,,,5,1,1,0,1
15468_0,,,,2,1,2,3
C(C(C(C=O)=CC=O)(C)O)(O)=O,,,5,1,1,0,1
15470_0,,,,2,1,2,3
C(C=C(C(O)=O)C(C(O)=O)=O)=O,,,5,1,1,0,1
15471_0,,,,2,1,2,3
15472_0,,,,2,1,2,3
15474_0,,,,2,1,2,3
C(C(C=C(C=O)C=C)O)=O,,,5,1,1,0,1
15475_0,,,,2,1,2,3
15476_0,,,,2,1,2,3
15477_0,,,,2,1,2,3
15478_0,,,,2,1,2,3
15479_0,,,,2,1,2,3
15480_0,,,,2,1,2,3
15482_0,,,,2,1,2,3
C=CC(C=O)=C(CO)CO,,,5,1,1,0,1
15483_0,,,,2,1,2,3
15484_0,,,,2,1,2,3
15485_0,,,,2,1,2,3
15486_0,,,,2,1,2,3
15487_0,,,,2,1,2,3
15488_0,,,,2,1,2,3
15490_0,,,,2,1,2,3
C(CO)(C(C=CC=C)O)=O,,,5,1,1,0,1
15491_0,,,,2,1,2,3
15492_0,,,,2,1,2,3
15493_0,,,,2,1,2,3
15494_0,,,,2,1,2,3
15495_0,,,,2,1,2,3
15496_0,,,,2,1,2,3
15498_0,,,,2,1,2,3
C=CC(C=O)=C(C(O)=O)CO,,,5,1,1,0,1
15499_0,,,,2,1,2,3
15500_0,,,,2,1,2,3
15501_0,,,,2,1,2,3
15502_0,,,,2,1,2,3
15503_0,,,,2,1,2,3
15504_0,,,,2,1,2,3
15506_0,,,,2,1,2,3
C=CC=CC(C(C(O)=O)=O)O,,,5,1,1,0,1
15507_0,,,,2,1,2,3
15508_0,,,,2,1,2,3
15509_0,,,,2,1,2,3
15510_0,,,,2,1,2,3
15511_0,,,,2,1,2,3
15512_0,,,,2,1,2,3
15514_0,,,,2,1,2,3
C(C(C=C(C=O)C=C)(C)O)(O)=O,,,5,1,1,0,1
15515_0,,,,2,1,2,3
15517_0,,,,2,1,2,3
C(C(C=CC=O)(C)O)(O)=O,,,5,1,2,0,2
15518_0,,,,2,1,2,3
15520_0,,,,2,1,2,3
C(C(C=C(C=O)C=C)O)(O)=O,,,5,1,1,0,1
15522_0,,,,2,1,2,3
C(C(C=CC=O)O)(O)=O,,,5,1,2,0,2
15524_0,,,,2,1,2,3
C(C(C(C(C=O)=CC)O)O)(O)=O,,,5,1,1,0,1
15526_0,,,,2,1,2,3
C(C(C=C(C=O)C(C)O)O)(O)=O,,,5,1,1,0,1
15527_0,,,,2,1,2,3
15529_0,,,,2,1,2,3
C(C(C=C(C(O)=O)C=O)O)(O)=O,,,5,1,1,0,1
15531_0,,,,2,1,2,3
C(C(C=CC(C(O)=O)=O)O)(O)=O,,,5,1,2,0,2
15533_0,,,,2,1,2,3
C(C(C(C)=CC=O)CO)(O)=O,,,5,1,1,0,1
15535_0,,,,2,1,2,3
C(C(C(CC=O)=C)CO)(O)=O,,,5,1,1,0,1
15537_0,,,,2,1,2,3
C(CC(C)=C(C(O)=O)CO)=O,,,5,1,2,0,2
15538_0,,,,2,1,2,3
15539_0,,,,2,1,2,3
15540_0,,,,2,1,2,3
15541_0,,,,2,1,2,3
15542_0,,,,2,1,2,3
15544_0,,,,2,1,2,3
C(C(C(C=C)=O)CO)(O)=O,,,5,1,1,0,1
15545_0,,,,2,1,2,3
15547_0,,,,2,1,2,3
C=CC(C=O)=CC=CC,,,5,1,1,0,1
15549_0,,,,2,1,2,3
C=CC(C(C(O)=O)=O)=CC=CC,,,5,1,1,0,1
15551_0,,,,2,1,2,3
C=C(C(O)=O)C(C=O)=CC=CC,,,5,1,1,0,1
15553_0,,,,2,1,2,3
C(C)=CC=C1C(C(OC1C)=O)=O,,,5,1,1,0,1
15555_0,,,,2,1,2,3
C(C)=CC=C1C(OC(C1=O)=O)=O,,,5,1,1,0,1
15557_0,,,,2,1,2,3
C(C)=CC=CC=O,,,5,1,2,0,2
15559_0,,,,2,1,2,3
C(C(C(C=O)=CC)O)=CC,,,5,1,2,0,2
15561_0,,,,2,1,2,3
C(C)=CC=C(C=O)C(C)O,,,5,1,2,0,2
15562_0,,,,2,1,2,3
15564_0,,,,2,1,2,3
C(C)=CC=C(C=O)C(O)=O,,,5,1,2,0,2
15566_0,,,,2,1,2,3
C(C)=CC=CC(C(O)=O)=O,,,5,1,2,0,2
15568_0,,,,2,1,2,3
C=CCC=C(C=O)C=C,,,5,1,1,0,1
15570_0,,,,2,1,2,3
C(C(C=C)C=CC=C)=O,,,5,1,1,0,1
15572_0,,,,2,1,2,3
C=CCC=C(C=C)C(C(O)=O)=O,,,5,1,1,0,1
15574_0,,,,2,1,2,3
C=CC(C=CC=C)C(C(O)=O)=O,,,5,1,1,0,1
15576_0,,,,2,1,2,3
C=CCC=C(C=O)C(C(O)=O)=C,,,5,1,1,0,1
15578_0,,,,2,1,2,3
C(C(C=CC=C)C(C(O)=O)=C)=O,,,5,1,1,0,1
15580_0,,,,2,1,2,3
C=CCC=C1C(C(OC1C)=O)=O,,,5,1,1,0,1
15582_0,,,,2,1,2,3
C=CC=CC1C(C(OC1C)=O)=O,,,5,1,1,0,1
15584_0,,,,2,1,2,3
C=CCC=C1C(OC(C1=O)=O)=O,,,5,1,1,0,1
15586_0,,,,2,1,2,3
C1(C(C=CC=C)C(C(O1)=O)=O)=O,,,5,1,1,0,1
15588_0,,,,2,1,2,3
C=CCC=CC=O,,,5,1,2,0,2
15590_0,,,,2,1,2,3
C(CC=CC=C)=O,,,5,1,2,0,2
15592_0,,,,2,1,2,3
C=CCC(C(C=O)=CC)O,,,5,1,2,0,2
15594_0,,,,2,1,2,3
C=CCC=C(C=O)C(C)O,,,5,1,2,0,2
15595_0,,,,2,1,2,3
15597_0,,,,2,1,2,3
C(C(C=CC=C)C(C)O)=O,,,5,1,2,0,2
15599_0,,,,2,1,2,3
C=CCC=C(C=O)C(O)=O,,,5,1,2,0,2
15601_0,,,,2,1,2,3
C(C(C(O)=O)C=CC=C)=O,,,5,1,2,0,2
15603_0,,,,2,1,2,3
C=CC=CC(C(C=O)=O)O,,,5,1,2,0,2
15605_0,,,,2,1,2,3
C=CCC=CC(C(O)=O)=O,,,5,1,2,0,2
15607_0,,,,2,1,2,3
C=CC=CCC(C(O)=O)=O,,,5,1,2,0,2
15609_0,,,,2,1,2,3
C=CC(C=O)=C(C(O)=O)C=CC,,,5,1,1,0,1
15611_0,,,,2,1,2,3
C(C(C=C)C(C(O)=O)=CC=C)=O,,,5,1,1,0,1
15613_0,,,,2,1,2,3
C=CCC(C(O)=O)=C(C=O)C=C,,,5,1,1,0,1
15615_0,,,,2,1,2,3
C(C(C=C)C=CC(C(O)=O)=C)=O,,,5,1,1,0,1
15617_0,,,,2,1,2,3
C=C(C(O)=O)CC=C(C=O)C=C,,,5,1,1,0,1
15619_0,,,,2,1,2,3
C=CC(C=O)=CC=C(C(O)=O)C,,,5,1,1,0,1
15621_0,,,,2,1,2,3
C(C(C=C)C1C(OC(C=1)C)=O)=O,,,5,1,1,0,1
15623_0,,,,2,1,2,3
C=CC(C=O)=C1C(OC(C)C1)=O,,,5,1,1,0,1
15625_0,,,,2,1,2,3
C(C(C=C)C1C(OC(C=1)=O)=O)=O,,,5,1,1,0,1
15627_0,,,,2,1,2,3
C1(CC(C(O1)=O)=C(C=O)C=C)=O,,,5,1,1,0,1
15629_0,,,,2,1,2,3
C(C(C=C)C=C)=O,,,5,1,1,0,1
15631_0,,,,2,1,2,3
C=CC(C=O)=CC,,,5,1,4,0,4
15633_0,,,,2,1,2,3
C(C(C=C)C=CC(C)O)=O,,,5,1,2,0,2
15634_0,,,,2,1,2,3
15635_0,,,,2,1,2,3
15637_0,,,,2,1,2,3
C(CC(C)O)=C(C=O)C=C,,,5,1,2,0,2
15639_0,,,,2,1,2,3
C(C(C=C)C=CC(O)=O)=O,,,5,1,2,0,2
15641_0,,,,2,1,2,3
C(CC=C(C=O)C=C)(O)=O,,,5,1,2,0,2
15643_0,,,,2,1,2,3
C=CC(C=O)=CC(CO)=O,,,5,1,2,0,2
15645_0,,,,2,1,2,3
C=CC(C=O)=C(C=O)CO,,,5,1,2,0,2
15647_0,,,,2,1,2,3
C=C(C=O)C=C,,,5,1,3,0,3
15649_0,,,,2,1,2,3
C(C(C=C)C(C(O)=O)=C)=O,,,5,1,2,0,2
15651_0,,,,2,1,2,3
C=CC(C=O)=C(C(O)=O)C,,,5,1,3,0,3
15653_0,,,,2,1,2,3
C(C)=CC(C(O)=O)=CC=O,,,5,1,2,0,2
15655_0,,,,2,1,2,3
C=CCC(C(O)=O)=CC=O,,,5,1,2,0,2
15657_0,,,,2,1,2,3
C(CC(C(O)=O)=CC=C)=O,,,5,1,2,0,2
15659_0,,,,2,1,2,3
C=CC(C=C)C(C(O)=O)=O,,,5,1,1,0,1
15661_0,,,,2,1,2,3
C=CC(C(C(O)=O)=O)=CC,,,5,1,3,0,3
15663_0,,,,2,1,2,3
C=C(C=C)C(C(O)=O)=O,,,5,1,2,0,2
15665_0,,,,2,1,2,3
C=C(C(O)=O)CC=CC=O,,,5,1,2,0,2
15667_0,,,,2,1,2,3
C(CC=CC(C(O)=O)=C)=O,,,5,1,2,0,2
15668_0,,,,2,1,2,3
15670_0,,,,2,1,2,3
C=C(C(O)=O)C(C=O)=CC,,,5,1,3,0,3
15672_0,,,,2,1,2,3
C=C(C=O)C(C(O)=O)=C,,,5,1,3,0,3
15674_0,,,,2,1,2,3
C(C=CC=C(C(O)=O)C)=O,,,5,1,2,0,2
15676_0,,,,2,1,2,3
C(C=C1C(OC(C(C)=C1)=O)=O)=O,,,5,1,1,0,1
15678_0,,,,2,1,2,3
C=C1C(OC(C(C1)=CC=O)=O)=O,,,5,1,1,0,1
15680_0,,,,2,1,2,3
C(CC1C(OC(C(C=1)=C)=O)=O)=O,,,5,1,1,0,1
15682_0,,,,2,1,2,3
C=CC1C(C(OC(C1=C)=O)=O)=O,,,5,1,1,0,1
15684_0,,,,2,1,2,3
C=C1C(OC(C(C1=CC)=O)=O)=O,,,5,1,1,0,1
15686_0,,,,2,1,2,3
C=C1C(OC(C(C1=C)=O)=O)=O,,,5,1,3,0,3
15688_0,,,,2,1,2,3
C(C)(C1(C(C(C(O1)=O)=O)=C)O)=O,,,5,1,2,0,2
15690_0,,,,2,1,2,3
C1(C(C(CO)=C(C(C)=O)O1)=O)=O,,,5,1,1,0,1
15691_0,,,,2,1,2,3
15693_0,,,,2,1,2,3
C=CC(C1(CC(C(O1)=O)=O)O)=O,,,5,1,2,0,2
15695_0,,,,2,1,2,3
C=C1C(C(C)(O)OC(C1=O)=O)=O,,,5,1,2,0,2
15696_0,,,,2,1,2,3
15698_0,,,,2,1,2,3
C(C=C1C(OC(C)C1)=O)=O,,,5,1,2,0,2
15700_0,,,,2,1,2,3
C(CC1C(OC(C=1)C)=O)=O,,,5,1,1,0,1
15702_0,,,,2,1,2,3
C=CC1C(C(OC1C)=O)=O,,,5,1,2,0,2
15704_0,,,,2,1,2,3
C(C)=C1C(C(OC1C)=O)=O,,,5,1,3,0,3
15706_0,,,,2,1,2,3
C=C1C(C(OC1C)=O)=O,,,5,1,3,0,3
15708_0,,,,2,1,2,3
C1(CC(C(O1)=O)=CC=O)=O,,,5,1,2,0,2
15710_0,,,,2,1,2,3
C(CC1C(OC(C=1)=O)=O)=O,,,5,1,1,0,1
15712_0,,,,2,1,2,3
C1(C(C=C)C(C(O1)=O)=O)=O,,,5,1,2,0,2
15714_0,,,,2,1,2,3
C(C)=C1C(OC(C1=O)=O)=O,,,5,1,3,0,3
15716_0,,,,2,1,2,3
C=C1C(OC(C1=O)=O)=O,,,5,1,2,0,2
15717_0,,,,2,1,2,3
15718_0,,,,2,1,2,3
15719_0,,,,2,1,2,3
15720_0,,,,2,1,2,3
15721_0,,,,2,1,2,3
15722_0,,,,2,1,2,3
15723_0,,,,2,1,2,3
15724_0,,,,2,1,2,3
15725_0,,,,2,1,2,3
15726_0,,,,2,1,2,3
15727_0,,,,2,1,2,3
15728_0,,,,2,1,2,3
15729_0,,,,2,1,2,3
15730_0,,,,2,1,2,3
15731_0,,,,2,1,2,3
15732_0,,,,2,1,2,3
15733_0,,,,2,1,2,3
15734_0,,,,2,1,2,3
15735_0,,,,2,1,2,3
15736_0,,,,2,1,2,3
15737_0,,,,2,1,2,3
15738_0,,,,2,1,2,3
15739_0,,,,2,1,2,3
15740_0,,,,2,1,2,3
15741_0,,,,2,1,2,3
15742_0,,,,2,1,2,3
15743_0,,,,2,1,2,3
15744_0,,,,2,1,2,3
15745_0,,,,2,1,2,3
15746_0,,,,2,1,2,3
15747_0,,,,2,1,2,3
15748_0,,,,2,1,2,3
15750_0,,,,2,1,2,3
C=CC(C(C(C(O)=O)=O)O)=O,,,5,1,1,0,1
15752_0,,,,2,1,2,3
C=C(C(CC(C)O)O)C(C)O,,,5,1,1,0,1
15753_0,,,,2,1,2,3
15754_0,,,,2,1,2,3
15755_0,,,,2,1,2,3
15756_0,,,,2,1,2,3
15757_0,,,,2,1,2,3
15758_0,,,,2,1,2,3
15760_0,,,,2,1,2,3
C=C(C(O)=O)C(CC(C)O)O,,,5,1,2,0,2
15761_0,,,,2,1,2,3
15762_0,,,,2,1,2,3
15763_0,,,,2,1,2,3
15764_0,,,,2,1,2,3
15766_0,,,,2,1,2,3
C=CC(CC(C)O)O,,,5,1,1,0,1
15767_0,,,,2,1,2,3
15768_0,,,,2,1,2,3
15769_0,,,,2,1,2,3
15770_0,,,,2,1,2,3
15771_0,,,,2,1,2,3
15772_0,,,,2,1,2,3
15774_0,,,,2,1,2,3
C(CC(C(C(C)O)=C)O)(O)=O,,,5,1,1,0,1
15775_0,,,,2,1,2,3
15776_0,,,,2,1,2,3
15777_0,,,,2,1,2,3
15779_0,,,,2,1,2,3
C(CO)(C(C(C(C)O)=C)O)=O,,,5,1,1,0,1
15780_0,,,,2,1,2,3
15781_0,,,,2,1,2,3
15782_0,,,,2,1,2,3
15784_0,,,,2,1,2,3
C(C(C(C(C)O)=C)(CO)O)=O,,,5,1,1,0,1
15785_0,,,,2,1,2,3
15786_0,,,,2,1,2,3
15787_0,,,,2,1,2,3
15788_0,,,,2,1,2,3
15789_0,,,,2,1,2,3
15790_0,,,,2,1,2,3
15791_0,,,,2,1,2,3
15793_0,,,,2,1,2,3
C=C(C(C)O)C(C)O,,,5,1,1,0,1
15794_0,,,,2,1,2,3
15795_0,,,,2,1,2,3
15796_0,,,,2,1,2,3
15797_0,,,,2,1,2,3
15798_0,,,,2,1,2,3
15800_0,,,,2,1,2,3
C(C(C(C(C)O)=C)(C)O)(O)=O,,,5,1,1,0,1
15801_0,,,,2,1,2,3
15802_0,,,,2,1,2,3
15804_0,,,,2,1,2,3
C(C(C=C)(CC(C)O)O)(O)=O,,,5,1,1,0,1
15805_0,,,,2,1,2,3
15806_0,,,,2,1,2,3
15807_0,,,,2,1,2,3
15808_0,,,,2,1,2,3
15810_0,,,,2,1,2,3
C(CC(C(C(O)=O)=C)O)(O)=O,,,5,1,2,0,2
15811_0,,,,2,1,2,3
15812_0,,,,2,1,2,3
15814_0,,,,2,1,2,3
C(CC(C=C)O)(O)=O,,,5,1,1,0,1
15815_0,,,,2,1,2,3
15816_0,,,,2,1,2,3
15817_0,,,,2,1,2,3
15818_0,,,,2,1,2,3
15819_0,,,,2,1,2,3
15821_0,,,,2,1,2,3
C(C(C(C(O)=O)=C)(CO)O)=O,,,5,1,2,0,2
15822_0,,,,2,1,2,3
15823_0,,,,2,1,2,3
15824_0,,,,2,1,2,3
15825_0,,,,2,1,2,3
15826_0,,,,2,1,2,3
15828_0,,,,2,1,2,3
C(C(C)(CC(C=C)O)O)(O)=O,,,5,1,1,0,1
15829_0,,,,2,1,2,3
15830_0,,,,2,1,2,3
15831_0,,,,2,1,2,3
15832_0,,,,2,1,2,3
15833_0,,,,2,1,2,3
15834_0,,,,2,1,2,3
15835_0,,,,2,1,2,3
15837_0,,,,2,1,2,3
C(C(C=C)(CC(O)=O)O)(O)=O,,,5,1,1,0,1
15838_0,,,,2,1,2,3
15839_0,,,,2,1,2,3
15840_0,,,,2,1,2,3
15841_0,,,,2,1,2,3
15843_0,,,,2,1,2,3
C(C(C=C)(CO)O)=O,,,5,1,1,0,1
15844_0,,,,2,1,2,3
15845_0,,,,2,1,2,3
15846_0,,,,2,1,2,3
15848_0,,,,2,1,2,3
C=CC=C,,,5,1,2,0,2
15850_0,,,,2,1,2,3
C=C(C(O)=O)C=C,,,5,1,2,0,2
15851_0,,,,2,1,2,3
15852_0,,,,2,1,2,3
15853_0,,,,2,1,2,3
15854_0,,,,2,1,2,3
15855_0,,,,2,1,2,3
15856_0,,,,2,1,2,3
15857_0,,,,2,1,2,3
15858_0,,,,2,1,2,3
15859_0,,,,2,1,2,3
15860_0,,,,2,1,2,3
15861_0,,,,2,1,2,3
15862_0,,,,2,1,2,3
15863_0,,,,2,1,2,3
15864_0,,,,2,1,2,3
15865_0,,,,2,1,2,3
15866_0,,,,2,1,2,3
15867_0,,,,2,1,2,3
15868_0,,,,2,1,2,3
15869_0,,,,2,1,2,3
15870_0,,,,2,1,2,3
15871_0,,,,2,1,2,3
15872_0,,,,2,1,2,3
15873_0,,,,2,1,2,3
15874_0,,,,2,1,2,3
15875_0,,,,2,1,2,3
15876_0,,,,2,1,2,3
15877_0,,,,2,1,2,3
15878_0,,,,2,1,2,3
15879_0,,,,2,1,2,3
15880_0,,,,2,1,2,3
15881_0,,,,2,1,2,3
15882_0,,,,2,1,2,3
15883_0,,,,2,1,2,3
15884_0,,,,2,1,2,3
15885_0,,,,2,1,2,3
15886_0,,,,2,1,2,3
15887_0,,,,2,1,2,3
15888_0,,,,2,1,2,3
15889_0,,,,2,1,2,3
15890_0,,,,2,1,2,3
15891_0,,,,2,1,2,3
15892_0,,,,2,1,2,3
15893_0,,,,2,1,2,3
15894_0,,,,2,1,2,3
15895_0,,,,2,1,2,3
15896_0,,,,2,1,2,3
15897_0,,,,2,1,2,3
15898_0,,,,2,1,2,3
15899_0,,,,2,1,2,3
15900_0,,,,2,1,2,3
15901_0,,,,2,1,2,3
15903_0,,,,2,1,2,3
C(C(C=CCO)(CO)C(C)O)=O,,,5,1,1,0,1
15904_0,,,,2,1,2,3
15905_0,,,,2,1,2,3
15906_0,,,,2,1,2,3
15907_0,,,,2,1,2,3
15909_0,,,,2,1,2,3
C(C(C=CC=C)(CO)C(C)O)=O,,,5,1,1,0,1
15910_0,,,,2,1,2,3
15911_0,,,,2,1,2,3
15912_0,,,,2,1,2,3
15913_0,,,,2,1,2,3
15914_0,,,,2,1,2,3
15915_0,,,,2,1,2,3
15916_0,,,,2,1,2,3
15917_0,,,,2,1,2,3
15918_0,,,,2,1,2,3
15919_0,,,,2,1,2,3
15921_0,,,,2,1,2,3
C(C(C=CC=O)C(C=O)O)(O)=O,,,5,1,1,0,1
15923_0,,,,2,1,2,3
C(CC(C(C(O)=O)=CC=O)O)=O,,,5,1,2,0,2
15925_0,,,,2,1,2,3
C(CC=C(C(O)=O)C(C=O)O)=O,,,5,1,1,0,1
15927_0,,,,2,1,2,3
C(C(C=O)(C=CCO)CO)(O)=O,,,5,1,1,0,1
15928_0,,,,2,1,2,3
15930_0,,,,2,1,2,3
C(C(C=O)(C=CC=C)CO)(O)=O,,,5,1,1,0,1
15931_0,,,,2,1,2,3
15933_0,,,,2,1,2,3
C(C(C(C=O)=O)(CO)O)=CCO,,,5,1,1,0,1
15934_0,,,,2,1,2,3
15936_0,,,,2,1,2,3
C=CC=CC(C(C=O)=O)(CO)O,,,5,1,1,0,1
15937_0,,,,2,1,2,3
15938_0,,,,2,1,2,3
15939_0,,,,2,1,2,3
15940_0,,,,2,1,2,3
15942_0,,,,2,1,2,3
C(C(C=O)(C=CCO)O)=O,,,5,1,1,0,1
15943_0,,,,2,1,2,3
15945_0,,,,2,1,2,3
C=C(C(O)=O)C(CCO)O,,,5,1,2,0,2
15947_0,,,,2,1,2,3
C(CCO)=C(C(O)=O)CO,,,5,1,1,0,1
15949_0,,,,2,1,2,3
C(C(C=CCO)CO)(O)=O,,,5,1,1,0,1
15950_0,,,,2,1,2,3
15952_0,,,,2,1,2,3
C(C)=C(C(O)=O)C(CCO)O,,,5,1,1,0,1
15954_0,,,,2,1,2,3
C(CCO)=C(C(O)=O)C(C)O,,,5,1,1,0,1
15955_0,,,,2,1,2,3
15957_0,,,,2,1,2,3
C(C(C=CCO)C(C)O)(O)=O,,,5,1,1,0,1
15958_0,,,,2,1,2,3
15960_0,,,,2,1,2,3
C(CCO)=C(C(O)=O)C(O)=O,,,5,1,1,0,1
15962_0,,,,2,1,2,3
C(C(C(O)=O)C=CCO)(O)=O,,,5,1,1,0,1
15963_0,,,,2,1,2,3
15964_0,,,,2,1,2,3
15966_0,,,,2,1,2,3
C(C(C=CCO)(C(C)O)O)(O)=O,,,5,1,1,0,1
15967_0,,,,2,1,2,3
15969_0,,,,2,1,2,3
C(C(C(O)=O)(C=CCO)O)(O)=O,,,5,1,1,0,1
15970_0,,,,2,1,2,3
15972_0,,,,2,1,2,3
C(C(C=O)(C=CCO)O)(O)=O,,,5,1,1,0,1
15973_0,,,,2,1,2,3
15975_0,,,,2,1,2,3
C(C(C=CCO)(CO)O)(O)=O,,,5,1,1,0,1
15976_0,,,,2,1,2,3
15978_0,,,,2,1,2,3
C(C(C(C(O)=O)=C)O)=O,,,5,1,2,0,2
15979_0,,,,2,1,2,3
15981_0,,,,2,1,2,3
C(C(C(C(O)=O)=CC)O)=O,,,5,1,1,0,1
15983_0,,,,2,1,2,3
C(C(C(C)O)=CC=O)(O)=O,,,5,1,2,0,2
15984_0,,,,2,1,2,3
15986_0,,,,2,1,2,3
C(C=C(C(O)=O)C(O)=O)=O,,,5,1,1,0,1
15987_0,,,,2,1,2,3
15989_0,,,,2,1,2,3
C(C(C=O)(C=CC=C)O)=O,,,5,1,1,0,1
15991_0,,,,2,1,2,3
C(C(C=O)(C=C)O)=O,,,5,1,1,0,1
15993_0,,,,2,1,2,3
C(C(C=O)(C=CC(C)O)O)=O,,,5,1,1,0,1
15994_0,,,,2,1,2,3
15995_0,,,,2,1,2,3
15997_0,,,,2,1,2,3
C(C(C=O)(C=CC(O)=O)O)=O,,,5,1,1,0,1
15999_0,,,,2,1,2,3
C(C(C=O)(C(C(O)=O)=C)O)=O,,,5,1,1,0,1
16000_0,,,,2,1,2,3
16002_0,,,,2,1,2,3
C(C(C=C(C(O)=O)CO)O)=O,,,5,1,1,0,1
16003_0,,,,2,1,2,3
16005_0,,,,2,1,2,3
C(C(C=C(C(O)=O)C(C)O)O)=O,,,5,1,1,0,1
16006_0,,,,2,1,2,3
16008_0,,,,2,1,2,3
C(C(C=C(C(O)=O)C(O)=O)O)=O,,,5,1,1,0,1
16010_0,,,,2,1,2,3
C(CO)(CO)=C(C(O)=O)CO,,,5,1,1,0,1
16012_0,,,,2,1,2,3
C=C(C(O)=O)C(CO)(CO)O,,,5,1,3,0,3
16014_0,,,,2,1,2,3
C(C(CO)=C(C(O)=O)CO)(O)=O,,,5,1,1,0,1
16015_0,,,,2,1,2,3
16017_0,,,,2,1,2,3
C(C(C=C(C(O)=O)CO)O)(O)=O,,,5,1,1,0,1
16018_0,,,,2,1,2,3
16020_0,,,,2,1,2,3
C(C)=CC=C(C(O)=O)CO,,,5,1,1,0,1
16022_0,,,,2,1,2,3
C(C(C(C(O)=O)=C)O)=CC,,,5,1,2,0,2
16024_0,,,,2,1,2,3
C(C(C=CC=C)CO)(O)=O,,,5,1,1,0,1
16026_0,,,,2,1,2,3
C=CCC=C(C(O)=O)CO,,,5,1,1,0,1
16028_0,,,,2,1,2,3
C=CCC(C(C(O)=O)=C)O,,,5,1,2,0,2
16030_0,,,,2,1,2,3
C(C)=C(C(O)=O)C(CO)(CO)O,,,5,1,1,0,1
16032_0,,,,2,1,2,3
C(CO)(CO)=C(C(O)=O)C(C)O,,,5,1,1,0,1
16033_0,,,,2,1,2,3
16035_0,,,,2,1,2,3
C(CO)(CO)=C(C(O)=O)C(O)=O,,,5,1,1,0,1
16037_0,,,,2,1,2,3
C(C)=CC=C(C(O)=O)C(C)O,,,5,1,1,0,1
16039_0,,,,2,1,2,3
C(C(C(C(O)=O)=CC)O)=CC,,,5,1,1,0,1
16040_0,,,,2,1,2,3
16042_0,,,,2,1,2,3
C(C(C=CC=C)C(C)O)(O)=O,,,5,1,1,0,1
16044_0,,,,2,1,2,3
C=CCC=C(C(O)=O)C(C)O,,,5,1,1,0,1
16046_0,,,,2,1,2,3
C=CCC(C(C(O)=O)=CC)O,,,5,1,1,0,1
16047_0,,,,2,1,2,3
16049_0,,,,2,1,2,3
C(C)=CC=C(C(O)=O)C(O)=O,,,5,1,1,0,1
16051_0,,,,2,1,2,3
C(C(C(O)=O)C=CC=C)(O)=O,,,5,1,1,0,1
16053_0,,,,2,1,2,3
C=CCC=C(C(O)=O)C(O)=O,,,5,1,1,0,1
16054_0,,,,2,1,2,3
16056_0,,,,2,1,2,3
C(C(C=CC=C)(C(C)O)O)(O)=O,,,5,1,1,0,1
16057_0,,,,2,1,2,3
16058_0,,,,2,1,2,3
16059_0,,,,2,1,2,3
16061_0,,,,2,1,2,3
C(C(C(O)=O)(C=CC=C)O)(O)=O,,,5,1,1,0,1
16063_0,,,,2,1,2,3
C(C(C=O)(C=CC=C)O)(O)=O,,,5,1,1,0,1
16065_0,,,,2,1,2,3
C(C(C=O)(C=C)O)(O)=O,,,5,1,1,0,1
16067_0,,,,2,1,2,3
C(C(C=O)(C=CC(C)O)O)(O)=O,,,5,1,1,0,1
16068_0,,,,2,1,2,3
16069_0,,,,2,1,2,3
16071_0,,,,2,1,2,3
C(C(C=O)(C=CC(O)=O)O)(O)=O,,,5,1,1,0,1
16073_0,,,,2,1,2,3
C(C(C=O)(C(C(O)=O)=C)O)(O)=O,,,5,1,1,0,1
16075_0,,,,2,1,2,3
C(C(C(C)=O)(C=C)CO)(O)=O,,,5,1,1,0,1
16077_0,,,,2,1,2,3
C(C(C=CC=C)(CO)O)(O)=O,,,5,1,2,0,2
16078_0,,,,2,1,2,3
16079_0,,,,2,1,2,3
16080_0,,,,2,1,2,3
16081_0,,,,2,1,2,3
16082_0,,,,2,1,2,3
16083_0,,,,2,1,2,3
16085_0,,,,2,1,2,3
C(C(C=C(CO)C(C)O)O)(O)=O,,,5,1,1,0,1
16086_0,,,,2,1,2,3
16087_0,,,,2,1,2,3
16089_0,,,,2,1,2,3
C(C(C(C(CO)=O)=CC=O)O)=O,,,5,1,1,0,1
16091_0,,,,2,1,2,3
C(C=C(C(CO)=O)CO)=O,,,5,1,1,0,1
16092_0,,,,2,1,2,3
16094_0,,,,2,1,2,3
C(C(C=CCO)(C)O)(O)=O,,,5,1,1,0,1
16095_0,,,,2,1,2,3
16097_0,,,,2,1,2,3
C(C(C=CCO)O)(O)=O,,,5,1,1,0,1
16098_0,,,,2,1,2,3
16100_0,,,,2,1,2,3
C(C(C(C(O)=O)=CCO)O)(O)=O,,,5,1,1,0,1
16101_0,,,,2,1,2,3
16103_0,,,,2,1,2,3
C(C(C(C(C)=O)=CC=O)O)(O)=O,,,5,1,1,0,1
16105_0,,,,2,1,2,3
C(C(C(C(CC=O)=O)=C)O)(O)=O,,,5,1,1,0,1
16107_0,,,,2,1,2,3
C(C(C=CC(C(C)=O)=O)O)(O)=O,,,5,1,1,0,1
16109_0,,,,2,1,2,3
C(C(C(C(C(CO)=O)=O)=C)O)=O,,,5,1,1,0,1
16111_0,,,,2,1,2,3
C=CC(C(C(CO)=O)=O)(C)O,,,5,1,1,0,1
16113_0,,,,2,1,2,3
C=C(C(C(CO)=O)=O)C(C)O,,,5,1,1,0,1
16115_0,,,,2,1,2,3
C=C(C(C(CO)=O)=O)CO,,,5,1,1,0,1
16116_0,,,,2,1,2,3
16117_0,,,,2,1,2,3
16118_0,,,,2,1,2,3
16119_0,,,,2,1,2,3
16121_0,,,,2,1,2,3
C(C(C=CC=C)(C)O)(O)=O,,,5,1,1,0,1
16122_0,,,,2,1,2,3
16123_0,,,,2,1,2,3
16124_0,,,,2,1,2,3
16126_0,,,,2,1,2,3
C(C(C=CC(C)O)(C)O)(O)=O,,,5,1,1,0,1
16127_0,,,,2,1,2,3
16128_0,,,,2,1,2,3
16129_0,,,,2,1,2,3
16131_0,,,,2,1,2,3
C(C(C=CC(O)=O)(C)O)(O)=O,,,5,1,1,0,1
16132_0,,,,2,1,2,3
16133_0,,,,2,1,2,3
16134_0,,,,2,1,2,3
16136_0,,,,2,1,2,3
C(C(C=CC=C)O)(O)=O,,,5,1,2,0,2
16138_0,,,,2,1,2,3
C(C(C(C(O)=O)=CC=C)O)(O)=O,,,5,1,1,0,1
16140_0,,,,2,1,2,3
C(C(C=CC(C(O)=O)=C)O)(O)=O,,,5,1,1,0,1
16142_0,,,,2,1,2,3
C(C(C1C(OC(C=1)C)=O)O)(O)=O,,,5,1,1,0,1
16144_0,,,,2,1,2,3
C(C(C1C(OC(C=1)=O)=O)O)(O)=O,,,5,1,1,0,1
16145_0,,,,2,1,2,3
16146_0,,,,2,1,2,3
16148_0,,,,2,1,2,3
C(C(C=O)O)(OC(C=C)=O)=O,,,5,1,1,0,1
16150_0,,,,2,1,2,3
C=CC(OCC(C(O)=O)=O)=O,,,5,1,1,0,1
16152_0,,,,2,1,2,3
C=CC(OC(C(CO)=O)=O)=O,,,5,1,1,0,1
16153_0,,,,2,1,2,3
16155_0,,,,2,1,2,3
C(C(C(O)=O)OC(C=C)=O)=O,,,5,1,1,0,1
16156_0,,,,2,1,2,3
16157_0,,,,2,1,2,3
16158_0,,,,2,1,2,3
16159_0,,,,2,1,2,3
16160_0,,,,2,1,2,3
16161_0,,,,2,1,2,3
16163_0,,,,2,1,2,3
C=C(C=O)C(C(C=O)=O)=O,,,5,1,1,0,1
16165_0,,,,2,1,2,3
C(C(C=O)=CC(C=O)=O)=O,,,5,1,1,0,1
16166_0,,,,2,1,2,3
16168_0,,,,2,1,2,3
C(C(C=O)=C(C(O)=O)CO)=O,,,5,1,1,0,1
16169_0,,,,2,1,2,3
16170_0,,,,2,1,2,3
16171_0,,,,2,1,2,3
16172_0,,,,2,1,2,3
16174_0,,,,2,1,2,3
C=C(C=O)C(C(O)=O)=O,,,5,1,1,0,1
16176_0,,,,2,1,2,3
C(C(C=O)=CC(O)=O)=O,,,5,1,1,0,1
16177_0,,,,2,1,2,3
16179_0,,,,2,1,2,3
C(C=CC(C)=O)(O)=O,,,5,1,1,0,1
16180_0,,,,2,1,2,3
16181_0,,,,2,1,2,3
16183_0,,,,2,1,2,3
C(C1C(OC(C=1C)=O)=O)=O,,,5,1,1,0,1
16185_0,,,,2,1,2,3
C(C)=C(C=O)C=CC(C)O,,,5,1,2,0,2
16186_0,,,,2,1,2,3
16187_0,,,,2,1,2,3
16188_0,,,,2,1,2,3
16189_0,,,,2,1,2,3
16190_0,,,,2,1,2,3
16191_0,,,,2,1,2,3
16192_0,,,,2,1,2,3
16193_0,,,,2,1,2,3
16194_0,,,,2,1,2,3
16195_0,,,,2,1,2,3
16196_0,,,,2,1,2,3
16197_0,,,,2,1,2,3
16198_0,,,,2,1,2,3
16199_0,,,,2,1,2,3
16200_0,,,,2,1,2,3
16201_0,,,,2,1,2,3
16202_0,,,,2,1,2,3
16203_0,,,,2,1,2,3
16205_0,,,,2,1,2,3
C(C)=C(C=O)C=CC(O)=O,,,5,1,2,0,2
16206_0,,,,2,1,2,3
16207_0,,,,2,1,2,3
16208_0,,,,2,1,2,3
16209_0,,,,2,1,2,3
16210_0,,,,2,1,2,3
16211_0,,,,2,1,2,3
16212_0,,,,2,1,2,3
16213_0,,,,2,1,2,3
16214_0,,,,2,1,2,3
16215_0,,,,2,1,2,3
16216_0,,,,2,1,2,3
16217_0,,,,2,1,2,3
16218_0,,,,2,1,2,3
16219_0,,,,2,1,2,3
16220_0,,,,2,1,2,3
16221_0,,,,2,1,2,3
16222_0,,,,2,1,2,3
16223_0,,,,2,1,2,3
16224_0,,,,2,1,2,3
16225_0,,,,2,1,2,3
16226_0,,,,2,1,2,3
16227_0,,,,2,1,2,3
16228_0,,,,2,1,2,3
16230_0,,,,2,1,2,3
C1OC(C(C=1)=C)=O,,,5,1,2,0,2
16231_0,,,,2,1,2,3
16233_0,,,,2,1,2,3
C=CC(CO)(C(CC(C)O)O)O,,,5,1,2,0,2
16235_0,,,,2,1,2,3
C(C(CO)(C(C)O)O)=CC(C)O,,,5,1,2,0,2
16237_0,,,,2,1,2,3
C(C(C(CO)(C(C)O)O)O)=CC,,,5,1,2,0,2
16239_0,,,,2,1,2,3
C=CCC(C(CO)(C(C)O)O)O,,,5,1,2,0,2
16241_0,,,,2,1,2,3
C(C(CO)O)=CC(C)O,,,5,1,3,0,3
16243_0,,,,2,1,2,3
C(C(C(CO)O)O)=CC,,,5,1,2,0,2
16245_0,,,,2,1,2,3
C=CCC(C(CO)O)O,,,5,1,2,0,2
16247_0,,,,2,1,2,3
C(C(CO)(C(C)O)O)=CC(O)=O,,,5,1,2,0,2
16249_0,,,,2,1,2,3
C(CC(C(C=C)(CO)O)O)(O)=O,,,5,1,2,0,2
16251_0,,,,2,1,2,3
C(C(C(C=C)(CO)O)O)(CO)=O,,,5,1,2,0,2
16253_0,,,,2,1,2,3
C(C(CO)(C(C=C)(CO)O)O)=O,,,5,1,2,0,2
16255_0,,,,2,1,2,3
C=CC(CO)(CO)O,,,5,1,2,0,2
16257_0,,,,2,1,2,3
C=CC(CO)(C(C)O)O,,,5,1,2,0,2
16259_0,,,,2,1,2,3
C=C(C(O)=O)C(CO)(C(C)O)O,,,5,1,2,0,2
16261_0,,,,2,1,2,3
C(C(C)(C(C=C)(CO)O)O)(O)=O,,,5,1,2,0,2
16263_0,,,,2,1,2,3
C(C(C)O)=C(C(O)=O)C(CO)O,,,5,1,2,0,2
16265_0,,,,2,1,2,3
C(C(C=CC)(C(CO)O)O)(O)=O,,,5,1,2,0,2
16267_0,,,,2,1,2,3
C(C(C(CO)O)(CC=C)O)(O)=O,,,5,1,2,0,2
16269_0,,,,2,1,2,3
C(C(C(C=C)(CO)O)O)(O)=O,,,5,1,2,0,2
16271_0,,,,2,1,2,3
C(C(C(C=C)(C(C)O)O)O)(O)=O,,,5,1,2,0,2
16273_0,,,,2,1,2,3
C(C(CO)O)=CC(O)=O,,,5,1,3,0,3
16275_0,,,,2,1,2,3
C=C(C(O)=O)CC(C(CO)O)O,,,5,1,2,0,2
16277_0,,,,2,1,2,3
C(C(C(CO)O)O)=C(C(O)=O)C,,,5,1,2,0,2
16279_0,,,,2,1,2,3
C(C(C=CC(CO)O)(C)O)(O)=O,,,5,1,2,0,2
16281_0,,,,2,1,2,3
C(C=C(C(O)=O)C(CO)O)(O)=O,,,5,1,2,0,2
16283_0,,,,2,1,2,3
C(CO)=C(C(O)=O)CO,,,5,1,2,0,2
16284_0,,,,2,1,2,3
16286_0,,,,2,1,2,3
C1(C(CO)O)OC(C(C=1)=O)=O,,,5,1,2,0,2
16288_0,,,,2,1,2,3
C1(C(C(C(C(O1)=C)=O)O)O)=O,,,5,1,2,0,2
16290_0,,,,2,1,2,3
C=C1C(C(C(C(O1)=O)=O)O)O,,,5,1,2,0,2
16291_0,,,,2,1,2,3
16292_0,,,,2,1,2,3
16293_0,,,,2,1,2,3
16294_0,,,,2,1,2,3
16295_0,,,,2,1,2,3
16296_0,,,,2,1,2,3
16297_0,,,,2,1,2,3
16298_0,,,,2,1,2,3
16299_0,,,,2,1,2,3
16300_0,,,,2,1,2,3
16302_0,,,,2,1,2,3
C1(C(C=C(C(O)=O)O1)CO)=O,,,5,1,2,0,2
16303_0,,,,2,1,2,3
16304_0,,,,2,1,2,3
16306_0,,,,2,1,2,3
C1(C(O)OC(C=CC)C1O)=O,,,5,1,2,0,2
16308_0,,,,2,1,2,3
C1(C(O)OC(C1O)CC=C)=O,,,5,1,2,0,2
16310_0,,,,2,1,2,3
C1C(CO)(OC(C=1C=O)C)O,,,5,1,1,0,1
16312_0,,,,2,1,2,3
C1(C(OCC=1C=O)O)C(C)O,,,5,1,1,0,1
16314_0,,,,2,1,2,3
C(C1(C(C(C)O)=COC1)O)=O,,,5,1,1,0,1
16316_0,,,,2,1,2,3
C(C1(C(C(O)OC1)=CC)O)=O,,,5,1,2,0,2
16318_0,,,,2,1,2,3
C(C1(COC(C1C=C)O)O)=O,,,5,1,2,0,2
16320_0,,,,2,1,2,3
C1(C(OC(C=1C=O)C)O)CO,,,5,1,1,0,1
16322_0,,,,2,1,2,3
C=C1C(OC(C1C(C)O)O)=O,,,5,1,2,0,2
16324_0,,,,2,1,2,3
C1(C(O)OC(C=1C)=O)C(C)O,,,5,1,1,0,1
16326_0,,,,2,1,2,3
C1(C(C(C(C)O)=CO1)(C)O)=O,,,5,1,1,0,1
16328_0,,,,2,1,2,3
C1(C(C(C(O)O1)=CC)(C)O)=O,,,5,1,2,0,2
16330_0,,,,2,1,2,3
C1(C(C)(C(C=C)C(O)O1)O)=O,,,5,1,2,0,2
16332_0,,,,2,1,2,3
C1(C(C=CO1)(CC(C)O)O)=O,,,5,1,1,0,1
16334_0,,,,2,1,2,3
C1C(O)OC(C=1CC(C)O)=O,,,5,1,1,0,1
16336_0,,,,2,1,2,3
C(C(C)O)=C1C(OC(C1)O)=O,,,5,1,2,0,2
16338_0,,,,2,1,2,3
C1(C(C=CC)(CC(O)O1)O)=O,,,5,1,2,0,2
16340_0,,,,2,1,2,3
C1(C(CC(O)O1)(CC=C)O)=O,,,5,1,2,0,2
16342_0,,,,2,1,2,3
C1C(CO)(O)OC(C=1C=O)=O,,,5,1,1,0,1
16344_0,,,,2,1,2,3
C(C1C(O)OCC=1C=O)(O)=O,,,5,1,1,0,1
16346_0,,,,2,1,2,3
C(C1(C(C(O)=O)=COC1)O)=O,,,5,1,1,0,1
16348_0,,,,2,1,2,3
C1(CO)C(O)OC(C=1C=O)=O,,,5,1,1,0,1
16350_0,,,,2,1,2,3
C(C1C(C(OC1O)=O)=C)(O)=O,,,5,1,2,0,2
16352_0,,,,2,1,2,3
C1(C(C)=C(C(O)=O)C(O)O1)=O,,,5,1,1,0,1
16354_0,,,,2,1,2,3
C1(C(C(C(O)=O)=CO1)(C)O)=O,,,5,1,1,0,1
16356_0,,,,2,1,2,3
C=C1C(OC(C1CO)O)=O,,,5,1,2,0,2
16358_0,,,,2,1,2,3
C1(C(C(C(O)O1)=C)(C)O)=O,,,5,1,2,0,2
16360_0,,,,2,1,2,3
C1(CO)C(O)OC(C=1C)=O,,,5,1,1,0,1
16362_0,,,,2,1,2,3
C1(C(C(CO)=CO1)(C)O)=O,,,5,1,1,0,1
16364_0,,,,2,1,2,3
C1(C(C=CO1)(CC(O)=O)O)=O,,,5,1,1,0,1
16366_0,,,,2,1,2,3
C(CC1C(OC(C=1)O)=O)(O)=O,,,5,1,1,0,1
16368_0,,,,2,1,2,3
C1(C(CC(O)O1)=CC(O)=O)=O,,,5,1,2,0,2
16370_0,,,,2,1,2,3
C=C1C(C(C(C(O)=O)=O)CO1)=O,,,5,1,1,0,1
16372_0,,,,2,1,2,3
C1(C(OCC1)=CC(C(O)=O)=O)=O,,,5,1,1,0,1
16374_0,,,,2,1,2,3
C(C1(C=COC1)O)=O,,,5,1,1,0,1
16376_0,,,,2,1,2,3
C1C(O)OCC=1C=O,,,5,1,1,0,1
16378_0,,,,2,1,2,3
C(C1(C=C(C(O)=O)OC1)O)=O,,,5,1,1,0,1
16380_0,,,,2,1,2,3
C(C1(C=C(C=O)CO1)O)(O)=O,,,5,1,1,0,1
16382_0,,,,2,1,2,3
C(C1(C(C(C(O1)=O)=C)O)O)=O,,,5,1,2,0,2
16384_0,,,,2,1,2,3
C=C1C(OC(C(O)=O)=C1CO)=O,,,5,1,1,0,1
16386_0,,,,2,1,2,3
C(C1(C(C(C(O1)=O)=C)=C)O)(O)=O,,,5,1,2,0,2
16388_0,,,,2,1,2,3
C1(C2(C(C(C(O2)=O)(O)O1)=C)C)=O,,,5,1,2,0,2
16390_0,,,,2,1,2,3
C(C1(C(C(OC1)=C)=O)O)(O)=O,,,5,1,1,0,1
16392_0,,,,2,1,2,3
C1(C(C(C(O1)=C)=O)(CO)O)=O,,,5,1,1,0,1
16394_0,,,,2,1,2,3
C=C1C(OC(C1=O)(CO)O)=O,,,5,1,2,0,2
16396_0,,,,2,1,2,3
C(C1C(C(C(O1)=C)=O)O)(O)=O,,,5,1,1,0,1
16398_0,,,,2,1,2,3
C(C1OC(C(C=1)=O)CO)(O)=O,,,5,1,1,0,1
16400_0,,,,2,1,2,3
C(C1C=C(C(O)=O)OC1)(O)=O,,,5,1,1,0,1
16402_0,,,,2,1,2,3
C1OC(C)CC(C=1C(C)O)O,,,5,1,1,0,1
16404_0,,,,2,1,2,3
C(C)=C1C(O)OC(C)CC1O,,,5,1,2,0,2
16406_0,,,,2,1,2,3
C1CC(C)OC(C=1C(C)O)O,,,5,1,1,0,1
16408_0,,,,2,1,2,3
C=CC1C(O)OC(C)CC1O,,,5,1,2,0,2
16410_0,,,,2,1,2,3
C1C(C(OC(C=1)C)O)C(C)O,,,5,1,1,0,1
16412_0,,,,2,1,2,3
C1OC(C)CC(C=1C(O)=O)O,,,5,1,1,0,1
16414_0,,,,2,1,2,3
C1CC(C)OC(C=1C(O)=O)O,,,5,1,1,0,1
16416_0,,,,2,1,2,3
C(C1C=CC(C)OC1O)(O)=O,,,5,1,1,0,1
16418_0,,,,2,1,2,3
C(C1(C(C=CC(C)O1)O)O)=O,,,5,1,1,0,1
16420_0,,,,2,1,2,3
C1OC(C)CC(C=1)O,,,5,1,1,0,1
16422_0,,,,2,1,2,3
C1CC(C)OC(C=1)O,,,5,1,1,0,1
16424_0,,,,2,1,2,3
C1CC(OC(C=1)C)O,,,5,1,1,0,1
16426_0,,,,2,1,2,3
C1C(CC(C)OC=1C(O)=O)O,,,5,1,1,0,1
16428_0,,,,2,1,2,3
C(C1(C=CCC(C)O1)O)(O)=O,,,5,1,1,0,1
16430_0,,,,2,1,2,3
C(C1(CC=CC(C)O1)O)(O)=O,,,5,1,1,0,1
16432_0,,,,2,1,2,3
C1C(C(O)OC(C=1)=O)C(C)O,,,5,1,1,0,1
16434_0,,,,2,1,2,3
C1(CC=C(C(O)O1)C(C)O)=O,,,5,1,1,0,1
16436_0,,,,2,1,2,3
C1(CC(C(C(C)O)=CO1)O)=O,,,5,1,1,0,1
16438_0,,,,2,1,2,3
C1(CC(C(C(O)O1)=CC)O)=O,,,5,1,2,0,2
16440_0,,,,2,1,2,3
C1(CC(C(C=C)C(O)O1)O)=O,,,5,1,2,0,2
16442_0,,,,2,1,2,3
C1(C(OCC(C=1)=O)O)C(C)O,,,5,1,1,0,1
16444_0,,,,2,1,2,3
C1(COC=C(C(C)O)C1O)=O,,,5,1,1,0,1
16446_0,,,,2,1,2,3
C1(COC(C(C1O)=CC)O)=O,,,5,1,2,0,2
16448_0,,,,2,1,2,3
C1(C(C(C=C)C(OC1)O)O)=O,,,5,1,2,0,2
16450_0,,,,2,1,2,3
C(C1(C=COC(C)C1)O)(O)=O,,,5,1,1,0,1
16452_0,,,,2,1,2,3
C1C(O)OC(C)CC=1C(O)=O,,,5,1,1,0,1
16454_0,,,,2,1,2,3
C1C(C)OC(CC=1C(O)=O)O,,,5,1,1,0,1
16456_0,,,,2,1,2,3
C1(CC(C(C(O)=O)=CO1)O)=O,,,5,1,1,0,1
16458_0,,,,2,1,2,3
C1(CC=C(C(O)=O)C(O)O1)=O,,,5,1,1,0,1
16460_0,,,,2,1,2,3
C(C1C=CC(OC1O)=O)(O)=O,,,5,1,1,0,1
16462_0,,,,2,1,2,3
C(C1(C(C=CC(O1)=O)O)O)=O,,,5,1,1,0,1
16464_0,,,,2,1,2,3
C1(CC(C=CO1)O)=O,,,5,1,1,0,1
16466_0,,,,2,1,2,3
C1(CC=CC(O)O1)=O,,,5,1,1,0,1
16468_0,,,,2,1,2,3
C1CC(O)OC(C=1)=O,,,5,1,1,0,1
16470_0,,,,2,1,2,3
C1(CC(C=C(C(O)=O)O1)O)=O,,,5,1,1,0,1
16472_0,,,,2,1,2,3
C1(CC=CC(C(O)=O)(O)O1)=O,,,5,1,1,0,1
16474_0,,,,2,1,2,3
C(C1(CC=CC(O1)=O)O)(O)=O,,,5,1,1,0,1
16476_0,,,,2,1,2,3
C(C1C(O)OCC(C=1)=O)(O)=O,,,5,1,1,0,1
16478_0,,,,2,1,2,3
C1(COC=C(C(O)=O)C1O)=O,,,5,1,1,0,1
16480_0,,,,2,1,2,3
C(C1(C)CC(C=CO1)O)(O)=O,,,5,1,1,0,1
16482_0,,,,2,1,2,3
C(C1(C)CC=CC(O1)O)(O)=O,,,5,1,1,0,1
16484_0,,,,2,1,2,3
C(C1(C=CCC(O1)O)C)(O)=O,,,5,1,1,0,1
16486_0,,,,2,1,2,3
C(C1(C=COC(C1)=O)O)(O)=O,,,5,1,1,0,1
16488_0,,,,2,1,2,3
C1(CC(C(O)=O)=CC(O)O1)=O,,,5,1,1,0,1
16490_0,,,,2,1,2,3
C1(C=C(C(O)=O)CC(O)O1)=O,,,5,1,1,0,1
16492_0,,,,2,1,2,3
C1(CC(C(OC1(C=C)O)=O)=O)=O,,,5,1,2,0,2
16494_0,,,,2,1,2,3
C(CO)=C1C(CC(C(O1)=O)=O)=O,,,5,1,1,0,1
16496_0,,,,2,1,2,3
C1(COC=CC1O)=O,,,5,1,1,0,1
16498_0,,,,2,1,2,3
C1C(O)OCC(C=1)=O,,,5,1,1,0,1
16500_0,,,,2,1,2,3
C1C(CO)(O)OC(C(C=1)=O)=O,,,5,1,1,0,1
16502_0,,,,2,1,2,3
C1(COC(C(O)=O)=CC1O)=O,,,5,1,1,0,1
16504_0,,,,2,1,2,3
C(C1(C=CC(CO1)=O)O)(O)=O,,,5,1,1,0,1
16506_0,,,,2,1,2,3
C1(CO)C(O)OC(C(C=1)=O)=O,,,5,1,1,0,1
16508_0,,,,2,1,2,3
C1(C(O)OC(C(C1O)=C)=O)=O,,,5,1,2,0,2
16510_0,,,,2,1,2,3
C(C1OCC(C(C=1)=O)O)(O)=O,,,5,1,1,0,1
16512_0,,,,2,1,2,3
C1(C(OC(C=CC1O)C)O)=O,,,5,1,1,0,1
16514_0,,,,2,1,2,3
C1(C(O)OC(C=CC1O)=O)=O,,,5,1,1,0,1
16516_0,,,,2,1,2,3
C1(C(C)(CC(C=CO1)O)O)=O,,,5,1,1,0,1
16518_0,,,,2,1,2,3
C1(C(C)(CC=CC(O)O1)O)=O,,,5,1,1,0,1
16520_0,,,,2,1,2,3
C=C1C(OC(CC(C1)O)O)=O,,,5,1,2,0,2
16522_0,,,,2,1,2,3
C1C(CC(O)OC(C=1C)=O)O,,,5,1,1,0,1
16524_0,,,,2,1,2,3
C1(C(C=CCC(O)O1)(C)O)=O,,,5,1,1,0,1
16526_0,,,,2,1,2,3
C1(C(C=C(C(O)=O)OCC1)=O)=O,,,5,1,1,0,1
16528_0,,,,2,1,2,3
C(C1CC(C(O1)=O)=O)=CC,,,5,1,2,0,2
16530_0,,,,2,1,2,3
C=CCC1CC(C(O1)=O)=O,,,5,1,2,0,2
16532_0,,,,2,1,2,3
C(C1C(C(OC1C)=O)=C)=O,,,5,1,2,0,2
16534_0,,,,2,1,2,3
C(C1C(C)OC(C=1C)=O)=O,,,5,1,1,0,1
16536_0,,,,2,1,2,3
C(C)=C1C(C(OC1)=O)=O,,,5,1,2,0,2
16538_0,,,,2,1,2,3
C=CC1C(C(OC1)=O)=O,,,5,1,2,0,2
16540_0,,,,2,1,2,3
C1C(C(C=O)=O)OC(C=1)=O,,,5,1,1,0,1
16542_0,,,,2,1,2,3
C(C1C(OCC=1C=O)=O)=O,,,5,1,1,0,1
16544_0,,,,2,1,2,3
C(CC1CC(C(O1)=O)=C)=O,,,5,1,2,0,2
16546_0,,,,2,1,2,3
C(CC1C=C(C(O1)=O)C)=O,,,5,1,1,0,1
16548_0,,,,2,1,2,3
C(C1C(C(OC1)=O)=C)=O,,,5,1,3,0,3
16550_0,,,,2,1,2,3
C(C1COC(C=1C)=O)=O,,,5,1,1,0,1
16552_0,,,,2,1,2,3
C1(C(C(CO1)=C(C(O)=O)C)=O)=O,,,5,1,2,0,2
16553_0,,,,2,1,2,3
16555_0,,,,2,1,2,3
C1(C(C)=C(C(C(O)=O)=O)CO1)=O,,,5,1,1,0,1
16556_0,,,,2,1,2,3
16558_0,,,,2,1,2,3
C=C1C(OCC1)=O,,,5,1,2,0,2
16560_0,,,,2,1,2,3
C1COC(C=1C)=O,,,5,1,1,0,1
16562_0,,,,2,1,2,3
C1(CC(C(O1)=O)=C)=O,,,5,1,2,0,2
16564_0,,,,2,1,2,3
C1(C(C)=CC(O1)=O)=O,,,5,1,1,0,1
16566_0,,,,2,1,2,3
C(C1(C=CC(O1)=O)CO)(O)=O,,,5,1,1,0,1
16568_0,,,,2,1,2,3
C(C1C=CC(O1)=O)(O)=O,,,5,1,1,0,1
16570_0,,,,2,1,2,3
C=C1C(OCC1O)=O,,,5,1,3,0,3
16572_0,,,,2,1,2,3
C1CC(C)OC(C=1C=O)=O,,,5,1,1,0,1
16574_0,,,,2,1,2,3
C(C1C(OC(C=C1)C)=O)=O,,,5,1,1,0,1
16576_0,,,,2,1,2,3
C(C1C=CC(OC1C)=O)=O,,,5,1,1,0,1
16578_0,,,,2,1,2,3
C1(CC=C(C=O)C(C)O1)=O,,,5,1,1,0,1
16580_0,,,,2,1,2,3
C1(CC=C(C=O)C(O1)=O)=O,,,5,1,1,0,1
16582_0,,,,2,1,2,3
C(C1C(OC(C=C1)=O)=O)=O,,,5,1,1,0,1
16584_0,,,,2,1,2,3
C(C1C(OCC(C=1)=O)=O)=O,,,5,1,1,0,1
16586_0,,,,2,1,2,3
C(C1COC(C(C=1)=O)=O)=O,,,5,1,1,0,1
16588_0,,,,2,1,2,3
C1(C(C=CC(C)O1)(CO)O)=O,,,5,1,1,0,1
16590_0,,,,2,1,2,3
C1(C(C=CC(O1)=O)(CO)O)=O,,,5,1,1,0,1
16592_0,,,,2,1,2,3
C(C1(C=CC(OC1)=O)O)(O)=O,,,5,1,1,0,1
16594_0,,,,2,1,2,3
C1(C(C=CC(C)O1)O)=O,,,5,1,1,0,1
16596_0,,,,2,1,2,3
C1(C(C=CC(O1)=O)O)=O,,,5,1,1,0,1
16598_0,,,,2,1,2,3
C1CC(C)OC(C(C=1)=O)=O,,,5,1,1,0,1
16600_0,,,,2,1,2,3
C1CC(C(OC(C=1)C)=O)=O,,,5,1,1,0,1
16602_0,,,,2,1,2,3
C1(CC=CC(C(O1)=O)=O)=O,,,5,1,1,0,1
16604_0,,,,2,1,2,3
C1CC(C(OC(C=1)=O)=O)=O,,,5,1,1,0,1
16606_0,,,,2,1,2,3
C1(C(C=CC(CO1)=O)=O)=O,,,5,1,1,0,1
16608_0,,,,2,1,2,3
C(C(C=C(C)CC=O)C(C)O)=O,,,5,1,1,0,1
16610_0,,,,2,1,2,3
C(CC(C=C(C=O)C(C)O)C)=O,,,5,1,1,0,1
16612_0,,,,2,1,2,3
C(CC(C)C(C(C=O)=CC)O)=O,,,5,1,2,0,2
16614_0,,,,2,1,2,3
C(C(C=C)C(C(C)CC=O)O)=O,,,5,1,2,0,2
16616_0,,,,2,1,2,3
C(C(C=C)(CO)C(C)CC=O)=O,,,5,1,2,0,2
16618_0,,,,2,1,2,3
C(CC(C)CC(C(C=O)=C)O)=O,,,5,1,2,0,2
16620_0,,,,2,1,2,3
C(CC(C)CC=C(C=O)CO)=O,,,5,1,2,0,2
16622_0,,,,2,1,2,3
C(C(C=CC(C)CC=O)CO)=O,,,5,1,1,0,1
16624_0,,,,2,1,2,3
C(C(C(C)=C(C)CC=O)CO)=O,,,5,1,1,0,1
16626_0,,,,2,1,2,3
C(CC(C)C(C(C=O)=C)(C)O)=O,,,5,1,2,0,2
16628_0,,,,2,1,2,3
C(CC(C(C)=C(C=O)CO)C)=O,,,5,1,1,0,1
16630_0,,,,2,1,2,3
C(C(C(C(C)CC=O)=C)CO)=O,,,5,1,1,0,1
16632_0,,,,2,1,2,3
C(C(C(O)=O)C=C(C)CC=O)=O,,,5,1,1,0,1
16634_0,,,,2,1,2,3
C(CC(C=C(C=O)C(O)=O)C)=O,,,5,1,2,0,2
16636_0,,,,2,1,2,3
C(CC(C)=CC(C(C=O)=O)O)=O,,,5,1,1,0,1
16638_0,,,,2,1,2,3
C(CC(C)=C(C(C=O)=O)CO)=O,,,5,1,1,0,1
16640_0,,,,2,1,2,3
C(CC(C(C=O)=C)C)=O,,,5,1,1,0,1
16642_0,,,,2,1,2,3
C=C(C=O)C(C)CC(C(O)=O)=O,,,5,1,1,0,1
16644_0,,,,2,1,2,3
C(CC(C(O)=O)CC(C=O)=C)=O,,,5,1,1,0,1
16646_0,,,,2,1,2,3
C(CC(C(O)=O)(C(C=O)=C)C)=O,,,5,1,1,0,1
16648_0,,,,2,1,2,3
C(C(C(C=O)=C)C(C(O)=O)C)=O,,,5,1,1,0,1
16650_0,,,,2,1,2,3
C(CC=C(C)CC=O)=O,,,5,1,1,0,1
16652_0,,,,2,1,2,3
C(CC(C=CC=O)C)=O,,,5,1,1,0,1
16654_0,,,,2,1,2,3
C(CC=C(C)CC(C(O)=O)=O)=O,,,5,1,1,0,1
16656_0,,,,2,1,2,3
C(C(C)CC(C(O)=O)=O)=CC=O,,,5,1,1,0,1
16658_0,,,,2,1,2,3
C(CC=CC(C(O)=O)CC=O)=O,,,5,1,1,0,1
16660_0,,,,2,1,2,3
C(CC(C(O)=O)CC=CC=O)=O,,,5,1,1,0,1
16662_0,,,,2,1,2,3
C(CC(C(O)=O)(C=CC=O)C)=O,,,5,1,1,0,1
16664_0,,,,2,1,2,3
C(CC=C(C=O)C(C(O)=O)C)=O,,,5,1,1,0,1
16666_0,,,,2,1,2,3
C(C(C=CC=O)C(C(O)=O)C)=O,,,5,1,1,0,1
16668_0,,,,2,1,2,3
C(CC(C(C(C(O)=O)=O)=C)C)=O,,,5,1,1,0,1
16670_0,,,,2,1,2,3
C(CC(C)=CCC(C(O)=O)=O)=O,,,5,1,1,0,1
16672_0,,,,2,1,2,3
C(CC(C=CC(C(O)=O)=O)C)=O,,,5,1,1,0,1
16674_0,,,,2,1,2,3
C(CC(C)=C(C=O)C=O)=O,,,5,1,1,0,1
16676_0,,,,2,1,2,3
C(CC(C(C(C)O)=C)C)=O,,,5,1,1,0,1
16678_0,,,,2,1,2,3
C(CC(C(CO)=CC)C)=O,,,5,1,1,0,1
16679_0,,,,2,1,2,3
16681_0,,,,2,1,2,3
C(CC(C)=CCC(C)O)=O,,,5,1,1,0,1
16683_0,,,,2,1,2,3
C(CC(C=CC(C)O)C)=O,,,5,1,1,0,1
16685_0,,,,2,1,2,3
C(CC(C)C(C=CC)O)=O,,,5,1,2,0,2
16687_0,,,,2,1,2,3
C(CC(C)C(CC=C)O)=O,,,5,1,2,0,2
16689_0,,,,2,1,2,3
C(CC(C)CC(C=C)O)=O,,,5,1,2,0,2
16690_0,,,,2,1,2,3
16692_0,,,,2,1,2,3
C(CC(C=CCCO)C)=O,,,5,1,1,0,1
16694_0,,,,2,1,2,3
C(CC(C)=C(C)CCO)=O,,,5,1,1,0,1
16696_0,,,,2,1,2,3
C(CC(C)C(C=C)(C)O)=O,,,5,1,2,0,2
16698_0,,,,2,1,2,3
C(CC(C(C)=CCO)C)=O,,,5,1,1,0,1
16700_0,,,,2,1,2,3
C(CC(C(CCO)=C)C)=O,,,5,1,1,0,1
16702_0,,,,2,1,2,3
C(CC(C(C(O)=O)=C)C)=O,,,5,1,2,0,2
16704_0,,,,2,1,2,3
C(CC(C)=CCC(O)=O)=O,,,5,1,1,0,1
16706_0,,,,2,1,2,3
C(CC(C=CC(O)=O)C)=O,,,5,1,2,0,2
16708_0,,,,2,1,2,3
C(CC(C)=CC(CO)=O)=O,,,5,1,1,0,1
16710_0,,,,2,1,2,3
C(CC(C)=C)=O,,,5,1,1,0,1
16712_0,,,,2,1,2,3
C=C(C)CC(C(O)=O)=O,,,5,1,1,0,1
16714_0,,,,2,1,2,3
C(C(C=C)CC=O)(O)=O,,,5,1,1,0,1
16716_0,,,,2,1,2,3
C(C(C(C=O)=C)C)(O)=O,,,5,1,2,0,2
16718_0,,,,2,1,2,3
C1(C(C(CO)=C(C(O)=O)O1)C)=O,,,5,1,1,0,1
16720_0,,,,2,1,2,3
C1(C(C(C(C(O)=O)(O)O1)=C)C)=O,,,5,1,1,0,1
16722_0,,,,2,1,2,3
C1(C(C=C(C(O)=O)O1)CCO)=O,,,5,1,2,0,2
16724_0,,,,2,1,2,3
C1(C(C=C)CC(C(O)=O)(O)O1)=O,,,5,1,1,0,1
16726_0,,,,2,1,2,3
C1(C(C(C(C(O1)=O)=O)=C)C)=O,,,5,1,2,0,2
16728_0,,,,2,1,2,3
C1(C(C=C)CC(C(O1)=O)=O)=O,,,5,1,1,0,1
16730_0,,,,2,1,2,3
C(C(C(C(C(O)=O)=O)=C)C)(O)=O,,,5,1,1,0,1
16732_0,,,,2,1,2,3
C(C(C=C)CC(C(O)=O)=O)(O)=O,,,5,1,1,0,1
16734_0,,,,2,1,2,3
C(CC(C=C)C)=O,,,5,1,2,0,2
16736_0,,,,2,1,2,3
C(C(C)CC(C(O)=O)=O)=C,,,5,1,2,0,2
16738_0,,,,2,1,2,3
C(CC(C(O)=O)CC=C)=O,,,5,1,2,0,2
16740_0,,,,2,1,2,3
C(CC(C(O)=O)(C=C)C)=O,,,5,1,2,0,2
16742_0,,,,2,1,2,3
C(C(C=C)C(C(O)=O)C)=O,,,5,1,2,0,2
16744_0,,,,2,1,2,3
C1(C(C)C(C=C)C(C(O1)=O)=O)=O,,,5,1,2,0,2
16746_0,,,,2,1,2,3
C1(C(C=C)(C)CC(C(O1)=O)=O)=O,,,5,1,2,0,2
16748_0,,,,2,1,2,3
C1(C(CC(C(O1)=O)=O)CC=C)=O,,,5,1,2,0,2
16750_0,,,,2,1,2,3
C(CC(C)=CC)=O,,,5,1,1,0,1
16751_0,,,,2,1,2,3
16753_0,,,,2,1,2,3
C(C)=C(C)CC(C(O)=O)=O,,,5,1,1,0,1
16754_0,,,,2,1,2,3
16756_0,,,,2,1,2,3
C(C(C=CC)CC=O)(O)=O,,,5,1,1,0,1
16757_0,,,,2,1,2,3
16758_0,,,,2,1,2,3
16760_0,,,,2,1,2,3
C(C(C(C=O)=CC)C)(O)=O,,,5,1,1,0,1
16761_0,,,,2,1,2,3
16763_0,,,,2,1,2,3
C1(C(C(C(C(O1)=O)=O)=CC)C)=O,,,5,1,1,0,1
16764_0,,,,2,1,2,3
16765_0,,,,2,1,2,3
16767_0,,,,2,1,2,3
C1(C(C=CC)CC(C(O1)=O)=O)=O,,,5,1,1,0,1
16768_0,,,,2,1,2,3
16770_0,,,,2,1,2,3
C(CC(C(C(O)=O)=CC)C)=O,,,5,1,1,0,1
16771_0,,,,2,1,2,3
16772_0,,,,2,1,2,3
16774_0,,,,2,1,2,3
C(CC(C=CCC(O)=O)C)=O,,,5,1,1,0,1
16776_0,,,,2,1,2,3
C(CC(C)=C(C)CC(O)=O)=O,,,5,1,1,0,1
16778_0,,,,2,1,2,3
C(CC(C(C)=CC(O)=O)C)=O,,,5,1,1,0,1
16780_0,,,,2,1,2,3
C(CC(C(CC(O)=O)=C)C)=O,,,5,1,1,0,1
16782_0,,,,2,1,2,3
C(CC(C)=CC(C(O)=O)=O)=O,,,5,1,1,0,1
16784_0,,,,2,1,2,3
C(C(C=CC(C)CC=O)O)(O)=O,,,5,1,1,0,1
16786_0,,,,2,1,2,3
C(CC(C)=C(C)C(C(O)=O)O)=O,,,5,1,1,0,1
16788_0,,,,2,1,2,3
C(C(C(C(C)CC=O)=C)O)(O)=O,,,5,1,1,0,1
16790_0,,,,2,1,2,3
C(CC(C)=C(C(O)=O)C(C)O)=O,,,5,1,1,0,1
16792_0,,,,2,1,2,3
C(C(C=C)(C(C)CC=O)O)(O)=O,,,5,1,2,0,2
16794_0,,,,2,1,2,3
C(CC(C)=C(C(O)=O)C(O)=O)=O,,,5,1,1,0,1
16795_0,,,,2,1,2,3
16797_0,,,,2,1,2,3
C(CC(C)=C(C(O)=O)C)=O,,,5,1,1,0,1
16798_0,,,,2,1,2,3
16799_0,,,,2,1,2,3
16801_0,,,,2,1,2,3
C(CC(C)=C(C=O)C(O)=O)=O,,,5,1,1,0,1
16803_0,,,,2,1,2,3
C(CC(C)C(C=C)(CO)O)=O,,,5,1,3,0,3
16805_0,,,,2,1,2,3
C(CC(C)=C(CO)C(C)O)=O,,,5,1,1,0,1
16807_0,,,,2,1,2,3
C(CC(C)C(C(C=C)O)O)=O,,,5,1,2,0,2
16809_0,,,,2,1,2,3
C(CC(C)=CC(C(C)O)O)=O,,,5,1,1,0,1
16811_0,,,,2,1,2,3
C(CC(C=CC(CO)O)C)=O,,,5,1,1,0,1
16813_0,,,,2,1,2,3
C(CC(C(C(CO)O)=C)C)=O,,,5,1,1,0,1
16815_0,,,,2,1,2,3
C(CC(C)=C(C)C(CO)O)=O,,,5,1,1,0,1
16817_0,,,,2,1,2,3
C(CC(C)=CC(C(O)=O)O)=O,,,5,1,1,0,1
16818_0,,,,2,1,2,3
16820_0,,,,2,1,2,3
C(CC(C(C=O)=CC)C)=O,,,5,1,1,0,1
16821_0,,,,2,1,2,3
16822_0,,,,2,1,2,3
16824_0,,,,2,1,2,3
C(CC=CC(C)CC=O)=O,,,5,1,1,0,1
16826_0,,,,2,1,2,3
C(CC(C(C)=CC=O)C)=O,,,5,1,1,0,1
16828_0,,,,2,1,2,3
C(CC(C(C)CC=O)=C)=O,,,5,1,1,0,1
16830_0,,,,2,1,2,3
C(CC(C)=C(C)CC=O)=O,,,5,1,1,0,1
16832_0,,,,2,1,2,3
C(CC(C)=CC(C=O)=O)=O,,,5,1,1,0,1
16834_0,,,,2,1,2,3
C(CC(C)=CC(O)=O)=O,,,5,1,1,0,1
16836_0,,,,2,1,2,3
C(CC(C)=CCO)=O,,,5,1,1,0,1
16838_0,,,,2,1,2,3
C(C)(CC(C(O)=O)=O)=CC(O)=O,,,5,1,1,0,1
16840_0,,,,2,1,2,3
C(CO)=C(C)CC(C(O)=O)=O,,,5,1,1,0,1
16842_0,,,,2,1,2,3
C(C(C=CC(O)=O)CC=O)(O)=O,,,5,1,1,0,1
16844_0,,,,2,1,2,3
C(C(C=CCO)CC=O)(O)=O,,,5,1,1,0,1
16846_0,,,,2,1,2,3
C(C(C(C=O)=CC(O)=O)C)(O)=O,,,5,1,1,0,1
16848_0,,,,2,1,2,3
C(C(C(C=O)=CCO)C)(O)=O,,,5,1,1,0,1
16849_0,,,,2,2,1,3
16851_0,,,,2,2,1,3
C(C1(C(C(C(C1O)O)O)O)O)(O)=O,,,5,1,1,0,1
16853_0,,,,2,2,1,3
C1(C2(CC(C(C2O)O)(O)O1)O)=O,,,5,1,3,0,3
16855_0,,,,2,2,1,3
CC(CC(CC(C(CO)O)O)O)O,,,5,1,1,0,1
16857_0,,,,2,2,1,3
CC(CC(C(CO)(CO)O)O)O,,,5,1,1,0,1
16859_0,,,,2,2,1,3
CC(C(CO)C(C(CO)O)O)O,,,5,1,1,0,1
16861_0,,,,2,2,1,3
CC(C(C(C(CO)O)O)C(C)O)O,,,5,1,1,0,1
16862_0,,,,2,2,1,3
16864_0,,,,2,2,1,3
C(CC(CC(C(CO)O)O)O)(O)=O,,,5,1,1,0,1
16866_0,,,,2,2,1,3
C(CC(C(CO)(CO)O)O)(O)=O,,,5,1,1,0,1
16867_0,,,,2,2,1,3
16868_0,,,,2,2,1,3
16870_0,,,,2,2,1,3
C(CO)(C(CC(C(CO)O)O)O)=O,,,5,1,1,0,1
16871_0,,,,2,2,1,3
16872_0,,,,2,2,1,3
16873_0,,,,2,2,1,3
16874_0,,,,2,2,1,3
16875_0,,,,2,2,1,3
16876_0,,,,2,2,1,3
16878_0,,,,2,2,1,3
C(C(CO)(CC(C(CO)O)O)O)=O,,,5,1,1,0,1
16879_0,,,,2,2,1,3
16881_0,,,,2,2,1,3
C(C(C(CO)O)(C(CO)O)O)=O,,,5,1,1,0,1
16883_0,,,,2,2,1,3
C(C(C(CO)O)(C(C(C)O)O)O)=O,,,5,1,1,0,1
16884_0,,,,2,2,1,3
16886_0,,,,2,2,1,3
C(C(CO)(C(CCO)O)O)O,,,5,1,1,0,1
16888_0,,,,2,2,1,3
C=CC(CO)(C(CCO)O)O,,,5,1,1,0,1
16890_0,,,,2,2,1,3
C(C(C(CCO)O)O)O,,,5,1,1,0,1
16892_0,,,,2,2,1,3
CC(C(CO)(C(CCO)O)O)O,,,5,1,1,0,1
16893_0,,,,2,2,1,3
16894_0,,,,2,2,1,3
16895_0,,,,2,2,1,3
16896_0,,,,2,2,1,3
16898_0,,,,2,2,1,3
C(C(CO)(C(CO)(CO)O)O)O,,,5,1,1,0,1
16899_0,,,,2,2,1,3
16900_0,,,,2,2,1,3
16902_0,,,,2,2,1,3
C(C(C(CO)(CO)O)O)=CC,,,5,1,1,0,1
16904_0,,,,2,2,1,3
C=CCC(C(CO)(CO)O)O,,,5,1,1,0,1
16906_0,,,,2,2,1,3
C(C(CO)(CO)O)O,,,5,1,1,0,1
16908_0,,,,2,2,1,3
C(C(C(CO)O)(CCO)O)(O)=O,,,5,1,1,0,1
16909_0,,,,2,2,1,3
16910_0,,,,2,2,1,3
16911_0,,,,2,2,1,3
16912_0,,,,2,2,1,3
16914_0,,,,2,2,1,3
C(CC(C(C)(C(CO)O)O)=O)=O,,,5,1,1,0,1
16915_0,,,,2,2,1,3
16916_0,,,,2,2,1,3
16917_0,,,,2,2,1,3
16918_0,,,,2,2,1,3
16919_0,,,,2,2,1,3
16920_0,,,,2,2,1,3
16921_0,,,,2,2,1,3
16922_0,,,,2,2,1,3
16923_0,,,,2,2,1,3
16924_0,,,,2,2,1,3
16925_0,,,,2,2,1,3
16926_0,,,,2,2,1,3
16927_0,,,,2,2,1,3
16928_0,,,,2,2,1,3
16929_0,,,,2,2,1,3
16930_0,,,,2,2,1,3
16931_0,,,,2,2,1,3
16932_0,,,,2,2,1,3
16933_0,,,,2,2,1,3
16934_0,,,,2,2,1,3
16935_0,,,,2,2,1,3
16936_0,,,,2,2,1,3
16937_0,,,,2,2,1,3
16938_0,,,,2,2,1,3
16939_0,,,,2,2,1,3
16940_0,,,,2,2,1,3
16941_0,,,,2,2,1,3
16942_0,,,,2,2,1,3
16943_0,,,,2,2,1,3
16945_0,,,,2,2,1,3
C(C(C)O)(C(CO)(C(CO)O)O)=O,,,5,1,1,0,1
16946_0,,,,2,2,1,3
16947_0,,,,2,2,1,3
16948_0,,,,2,2,1,3
16950_0,,,,2,2,1,3
C(C(C(C=C)(CO)O)O)=O,,,5,1,1,0,1
16952_0,,,,2,2,1,3
C(C(C(C=C)(C(C=O)O)O)O)(O)=O,,,5,1,1,0,1
16954_0,,,,2,2,1,3
C(C(C(C(C(O)=O)=C)(CO)O)O)=O,,,5,1,1,0,1
16956_0,,,,2,2,1,3
C1(C(C(C(C)O1)(C(C=O)O)O)O)=O,,,5,1,1,0,1
16957_0,,,,2,2,1,3
16958_0,,,,2,2,1,3
16959_0,,,,2,2,1,3
16960_0,,,,2,2,1,3
16961_0,,,,2,2,1,3
16963_0,,,,2,2,1,3
C(C(C(C(C=C)(CO)O)O)O)=O,,,5,1,1,0,1
16964_0,,,,2,2,1,3
16965_0,,,,2,2,1,3
16966_0,,,,2,2,1,3
16967_0,,,,2,2,1,3
16969_0,,,,2,2,1,3
C=CC(CO)(C(CO)(CO)O)O,,,5,1,1,0,1
16970_0,,,,2,2,1,3
16971_0,,,,2,2,1,3
16972_0,,,,2,2,1,3
16973_0,,,,2,2,1,3
16975_0,,,,2,2,1,3
C(C(CO)(C(C=C)(CO)O)O)(O)=O,,,5,1,1,0,1
16976_0,,,,2,2,1,3
16977_0,,,,2,2,1,3
16979_0,,,,2,2,1,3
C(C(C(C(C=C)(CO)O)O)O)(O)=O,,,5,1,1,0,1
16980_0,,,,2,2,1,3
16982_0,,,,2,2,1,3
C(C(CO)C(C)(C(CO)O)O)(O)=O,,,5,1,1,0,1
16984_0,,,,2,2,1,3
C(C(CO)C(C(C(C)O)O)O)(O)=O,,,5,1,1,0,1
16985_0,,,,2,2,1,3
16986_0,,,,2,2,1,3
16987_0,,,,2,2,1,3
16988_0,,,,2,2,1,3
16989_0,,,,2,2,1,3
16991_0,,,,2,2,1,3
C(C)=CC(C(C=C)(CO)O)O,,,5,1,1,0,1
16992_0,,,,2,2,1,3
16993_0,,,,2,2,1,3
16994_0,,,,2,2,1,3
16995_0,,,,2,2,1,3
16997_0,,,,2,2,1,3
C(C(CO)(C(CC=C)O)O)=C,,,5,1,1,0,1
16998_0,,,,2,2,1,3
16999_0,,,,2,2,1,3
17000_0,,,,2,2,1,3
17001_0,,,,2,2,1,3
17002_0,,,,2,2,1,3
17003_0,,,,2,2,1,3
17004_0,,,,2,2,1,3
17005_0,,,,2,2,1,3
17006_0,,,,2,2,1,3
17007_0,,,,2,2,1,3
17008_0,,,,2,2,1,3
17009_0,,,,2,2,1,3
17010_0,,,,2,2,1,3
17011_0,,,,2,2,1,3
17012_0,,,,2,2,1,3
17013_0,,,,2,2,1,3
17014_0,,,,2,2,1,3
17015_0,,,,2,2,1,3
17016_0,,,,2,2,1,3
17017_0,,,,2,2,1,3
17018_0,,,,2,2,1,3
17019_0,,,,2,2,1,3
17021_0,,,,2,2,1,3
C1(C(C(C(C(O1)=O)=C)(CO)O)O)=O,,,5,1,1,0,1
17023_0,,,,2,2,1,3
C1(C(C(CO)O)(CC(C)O1)O)=O,,,5,1,2,0,2
17025_0,,,,2,2,1,3
C1(C(C(C(C)O)(C(C)O1)O)O)=O,,,5,1,2,0,2
17027_0,,,,2,2,1,3
C(C1(C(C)OC(C1O)=O)O)(O)=O,,,5,1,2,0,2
17029_0,,,,2,2,1,3
C1(C(C(CO)(C(C)O1)O)O)=O,,,5,1,2,0,2
17031_0,,,,2,2,1,3
C1(C(C(CO)O)(CC(O1)=O)O)=O,,,5,1,2,0,2
17032_0,,,,2,2,1,3
17033_0,,,,2,2,1,3
17034_0,,,,2,2,1,3
17035_0,,,,2,2,1,3
17036_0,,,,2,2,1,3
17037_0,,,,2,2,1,3
17038_0,,,,2,2,1,3
17039_0,,,,2,2,1,3
17040_0,,,,2,2,1,3
17041_0,,,,2,2,1,3
17042_0,,,,2,2,1,3
17043_0,,,,2,2,1,3
17044_0,,,,2,2,1,3
17045_0,,,,2,2,1,3
17046_0,,,,2,2,1,3
17047_0,,,,2,2,1,3
17048_0,,,,2,2,1,3
17049_0,,,,2,2,1,3
17050_0,,,,2,2,1,3
17051_0,,,,2,2,1,3
17053_0,,,,2,2,1,3
C(C(CCO)O)O,,,5,1,3,0,3
17054_0,,,,2,2,1,3
17055_0,,,,2,2,1,3
17056_0,,,,2,2,1,3
17057_0,,,,2,2,1,3
17058_0,,,,2,2,1,3
17059_0,,,,2,2,1,3
17060_0,,,,2,2,1,3
17061_0,,,,2,2,1,3
17063_0,,,,2,2,1,3
C(C(C(C)O)(C(C(CO)O)O)O)=O,,,5,1,1,0,1
17064_0,,,,2,2,1,3
17065_0,,,,2,2,1,3
17066_0,,,,2,2,1,3
17067_0,,,,2,2,1,3
17068_0,,,,2,2,1,3
17069_0,,,,2,2,1,3
17070_0,,,,2,2,1,3
17071_0,,,,2,2,1,3
17072_0,,,,2,2,1,3
17073_0,,,,2,2,1,3
17074_0,,,,2,2,1,3
17076_0,,,,2,2,1,3
C(C(CO)O)(OCC(C(O)=O)O)=O,,,5,1,1,0,1
17078_0,,,,2,2,1,3
C(C(CO)O)(OC(C(CO)O)=O)=O,,,5,1,1,0,1
17079_0,,,,2,2,1,3
17080_0,,,,2,2,1,3
17081_0,,,,2,2,1,3
17083_0,,,,2,2,1,3
C(C(CC(C(C(C)O)O)O)=O)=O,,,5,1,1,0,1
17084_0,,,,2,2,1,3
17085_0,,,,2,2,1,3
17086_0,,,,2,2,1,3
17087_0,,,,2,2,1,3
17088_0,,,,2,2,1,3
17089_0,,,,2,2,1,3
17090_0,,,,2,2,1,3
17091_0,,,,2,2,1,3
17092_0,,,,2,2,1,3
17093_0,,,,2,2,1,3
17094_0,,,,2,2,1,3
17095_0,,,,2,2,1,3
17096_0,,,,2,2,1,3
17097_0,,,,2,2,1,3
17098_0,,,,2,2,1,3
17099_0,,,,2,2,1,3
17100_0,,,,2,2,1,3
17101_0,,,,2,2,1,3
17102_0,,,,2,2,1,3
17103_0,,,,2,2,1,3
17104_0,,,,2,2,1,3
17105_0,,,,2,2,1,3
17106_0,,,,2,2,1,3
17107_0,,,,2,2,1,3
17108_0,,,,2,2,1,3
17109_0,,,,2,2,1,3
17110_0,,,,2,2,1,3
17111_0,,,,2,2,1,3
17112_0,,,,2,2,1,3
17114_0,,,,2,2,1,3
C(CC(C(C(C)O)O)O)(O)=O,,,5,1,1,0,1
17115_0,,,,2,2,1,3
17116_0,,,,2,2,1,3
17117_0,,,,2,2,1,3
17118_0,,,,2,2,1,3
17119_0,,,,2,2,1,3
17120_0,,,,2,2,1,3
17121_0,,,,2,2,1,3
17122_0,,,,2,2,1,3
17123_0,,,,2,2,1,3
17124_0,,,,2,2,1,3
17125_0,,,,2,2,1,3
17126_0,,,,2,2,1,3
17128_0,,,,2,2,1,3
C(C(CC(CO)O)O)(O)=O,,,5,1,1,0,1
17129_0,,,,2,2,1,3
17130_0,,,,2,2,1,3
17131_0,,,,2,2,1,3
17132_0,,,,2,2,1,3
17133_0,,,,2,2,1,3
17134_0,,,,2,2,1,3
17135_0,,,,2,2,1,3
17136_0,,,,2,2,1,3
17137_0,,,,2,2,1,3
17138_0,,,,2,2,1,3
17139_0,,,,2,2,1,3
17140_0,,,,2,2,1,3
17141_0,,,,2,2,1,3
17142_0,,,,2,2,1,3
17143_0,,,,2,2,1,3
17144_0,,,,2,2,1,3
17145_0,,,,2,2,1,3
17146_0,,,,2,2,1,3
17147_0,,,,2,2,1,3
17148_0,,,,2,2,1,3
17149_0,,,,2,2,1,3
17150_0,,,,2,2,1,3
17151_0,,,,2,2,1,3
17152_0,,,,2,2,1,3
17154_0,,,,2,2,1,3
C=C(C(C(CO)O)=O)C(C(O)=O)=O,,,5,1,1,0,1
17155_0,,,,2,2,1,3
17157_0,,,,2,2,1,3
C=CC(C(C(C(C(O)=O)=O)O)O)=O,,,5,1,1,0,1
17158_0,,,,2,2,1,3
17159_0,,,,2,2,1,3
17160_0,,,,2,2,1,3
17161_0,,,,2,2,1,3
17162_0,,,,2,2,1,3
17164_0,,,,2,2,1,3
C1(C(C(C(C(CO)O)(O)O1)O)O)=O,,,5,1,3,0,3
17165_0,,,,2,2,1,3
17166_0,,,,2,2,1,3
17167_0,,,,2,2,1,3
17168_0,,,,2,2,1,3
17169_0,,,,2,2,1,3
17171_0,,,,2,2,1,3
CC1C(CO)(C(C(CO)(O)O1)O)O,,,5,1,2,0,2
17173_0,,,,2,2,1,3
CC1C(CO)(C(C(O)O1)(CO)O)O,,,5,1,2,0,2
17174_0,,,,2,2,1,3
17175_0,,,,2,2,1,3
17177_0,,,,2,2,1,3
C(C1(C(C(C(CO)O1)O)O)O)(O)=O,,,5,1,2,0,2
17179_0,,,,2,2,1,3
C1(C(C(C(C(CO)(O)O1)O)O)O)=O,,,5,1,2,0,2
17181_0,,,,2,2,1,3
C1(C(C(C(CO)(C(O)O1)O)O)O)=O,,,5,1,2,0,2
17183_0,,,,2,2,1,3
C(C1(C(C(C(CO1)O)O)O)O)(O)=O,,,5,1,2,0,2
17184_0,,,,2,2,1,3
17186_0,,,,2,2,1,3
C1(C(C)(C(CO)(C(C)O1)O)O)=O,,,5,1,2,0,2
17188_0,,,,2,2,1,3
C1(C(C(CO1)(C(C)O)O)O)=O,,,5,1,2,0,2
17189_0,,,,2,2,1,3
17190_0,,,,2,2,1,3
17192_0,,,,2,2,1,3
C1(C(C)(CC(C(CO)O)O1)O)=O,,,5,1,2,0,2
17194_0,,,,2,2,1,3
C1(C(C)(C(CO)(CO1)O)O)=O,,,5,1,2,0,2
17195_0,,,,2,2,1,3
17197_0,,,,2,2,1,3
C1(C(C(C(C(C)=O)=O)(CO1)O)O)=O,,,5,1,1,0,1
17199_0,,,,2,2,1,3
C(C(CO)O)(C1C(C(OC1)=O)=O)=O,,,5,1,1,0,1
17200_0,,,,2,2,1,3
17201_0,,,,2,2,1,3
17202_0,,,,2,2,1,3
17204_0,,,,2,2,1,3
C1(C(C(C(C(O)=O)=C)(CO1)O)O)=O,,,5,1,1,0,1
17206_0,,,,2,2,1,3
C(C(C1(C(C(OC1)=O)=C)O)O)(O)=O,,,5,1,1,0,1
17208_0,,,,2,2,1,3
C1(C2(C)C(CO1)(C(C(O2)=O)O)O)=O,,,5,1,1,0,1
17209_0,,,,2,2,1,3
17211_0,,,,2,2,1,3
C1(C(C(C(C(CO)O)O1)O)=O)=O,,,5,1,2,0,2
17212_0,,,,2,2,1,3
17214_0,,,,2,2,1,3
C1(CC(C(CO)(C(C)O1)O)O)=O,,,5,1,2,0,2
17215_0,,,,2,2,1,3
17216_0,,,,2,2,1,3
17217_0,,,,2,2,1,3
17218_0,,,,2,2,1,3
17220_0,,,,2,2,1,3
C1(C(C(C(C(CO)O1)O)O)=O)=O,,,5,1,2,0,2
17222_0,,,,2,2,1,3
C(C1COC(C(C1O)O)=O)(O)=O,,,5,1,2,0,2
17223_0,,,,2,2,1,3
17224_0,,,,2,2,1,3
17225_0,,,,2,2,1,3
17227_0,,,,2,2,1,3
C1(C(C(C(OCC1O)=O)O)O)=O,,,5,1,2,0,2
17229_0,,,,2,2,1,3
C1(C(C(C(C(CO1)O)O)O)=O)=O,,,5,1,2,0,2
17230_0,,,,2,2,1,3
17232_0,,,,2,2,1,3
C(CC(C)C(CO)(CO)O)=O,,,5,1,2,0,2
17234_0,,,,2,2,1,3
C(CC(C(C)C(CO)O)O)=O,,,5,1,1,0,1
17236_0,,,,2,2,1,3
C(CC(C)C(C(CO)O)O)=O,,,5,1,2,0,2
17238_0,,,,2,2,1,3
C(C(C=O)(C(C)C(CO)O)O)=O,,,5,1,1,0,1
17240_0,,,,2,2,1,3
CC(C(CO)O)C(CO)C(C)O,,,5,1,1,0,1
17242_0,,,,2,2,1,3
CC(CC(C(C)C(CO)O)O)O,,,5,1,1,0,1
17244_0,,,,2,2,1,3
CC(CC(CCO)O)C(CO)O,,,5,1,1,0,1
17246_0,,,,2,2,1,3
CC(CCO)(C(C)C(CO)O)O,,,5,1,1,0,1
17248_0,,,,2,2,1,3
C(C(CO)C(C)C(CO)O)(O)=O,,,5,1,1,0,1
17250_0,,,,2,2,1,3
C(CC(C(C)C(CO)O)O)(O)=O,,,5,1,1,0,1
17252_0,,,,2,2,1,3
C(CO)(C(C(C)C(CO)O)O)=O,,,5,1,1,0,1
17254_0,,,,2,2,1,3
CC(CO)C(CO)O,,,5,1,1,0,1
17256_0,,,,2,2,1,3
C(C(C(C(CO)C)O)O)(O)=O,,,5,1,1,0,1
17258_0,,,,2,2,1,3
C(C(CCO)C(CO)O)(O)=O,,,5,1,2,0,2
17260_0,,,,2,2,1,3
C(C(C)(CO)C(CO)O)(O)=O,,,5,1,1,0,1
17262_0,,,,2,2,1,3
C(C(C)C(CO)(CO)O)(O)=O,,,5,1,1,0,1
17264_0,,,,2,2,1,3
C1(C(C)C(CO)(C(C(O1)=O)O)O)=O,,,5,1,1,0,1
17266_0,,,,2,2,1,3
C1(C(CO)(C)C(C(C(O1)=O)O)O)=O,,,5,1,1,0,1
17268_0,,,,2,2,1,3
C1(C(C(C(C(O1)=O)O)O)CCO)=O,,,5,1,2,0,2
17269_0,,,,2,2,1,3
17270_0,,,,2,2,1,3
17272_0,,,,2,2,1,3
C(C(CCCO)C(CO)O)(O)=O,,,5,1,2,0,2
17273_0,,,,2,2,1,3
17275_0,,,,2,2,1,3
C(C(C)C(CO)(CCO)O)(O)=O,,,5,1,1,0,1
17277_0,,,,2,2,1,3
CC(C(C)O)C(CO)O,,,5,1,1,0,1
17279_0,,,,2,2,1,3
C(C(C(C(C)C(C)O)O)O)(O)=O,,,5,1,1,0,1
17281_0,,,,2,2,1,3
C(C(CC(C)O)C(CO)O)(O)=O,,,5,1,2,0,2
17283_0,,,,2,2,1,3
C(C(C)(C(CO)O)C(C)O)(O)=O,,,5,1,1,0,1
17285_0,,,,2,2,1,3
C(C(C)C(CO)(C(C)O)O)(O)=O,,,5,1,1,0,1
17287_0,,,,2,2,1,3
C(C(C(C)O)C(C)C(CO)O)(O)=O,,,5,1,1,0,1
17289_0,,,,2,2,1,3
C(CC(CC(C)C(CO)O)O)(O)=O,,,5,1,1,0,1
17291_0,,,,2,2,1,3
C(CC(C)(C(C)C(CO)O)O)(O)=O,,,5,1,1,0,1
17293_0,,,,2,2,1,3
C(C(C(O)=O)C(C)C(CO)O)(O)=O,,,5,1,1,0,1
17295_0,,,,2,2,1,3
C(C(C(C(C)C(CO)O)O)=O)(O)=O,,,5,1,1,0,1
17296_0,,,,2,2,1,3
17297_0,,,,2,2,1,3
17299_0,,,,2,2,1,3
C(C(CCC(O)=O)C(CO)O)(O)=O,,,5,1,2,0,2
17300_0,,,,2,2,1,3
17302_0,,,,2,2,1,3
C(C(C)C(CO)(CC(O)=O)O)(O)=O,,,5,1,1,0,1
17304_0,,,,2,2,1,3
C(C(CC(C)C(CO)O)O)(O)=O,,,5,1,1,0,1
17306_0,,,,2,2,1,3
C(C(C)(C(C)C(CO)O)O)(O)=O,,,5,1,1,0,1
17308_0,,,,2,2,1,3
C(C(C=O)(C(C)C(CO)O)O)(O)=O,,,5,1,1,0,1
17310_0,,,,2,2,1,3
C(CC(C)C(CO)O)=CC=O,,,5,1,1,0,1
17311_0,,,,2,2,1,3
17313_0,,,,2,2,1,3
C(C(C=C)C(C)C(CO)O)=O,,,5,1,1,0,1
17315_0,,,,2,2,1,3
CC(C(CO)O)C(CO)(C(C)O)O,,,5,1,1,0,1
17317_0,,,,2,2,1,3
CC(C(C(C(C)C(CO)O)O)O)O,,,5,1,1,0,1
17319_0,,,,2,2,1,3
CC(CC(C(CO)O)O)C(CO)O,,,5,1,1,0,1
17321_0,,,,2,2,1,3
CC(C(CO)O)(C(C)C(CO)O)O,,,5,1,1,0,1
17323_0,,,,2,2,1,3
C(C(C(C(C)C(CO)O)O)O)(O)=O,,,5,1,2,0,2
17325_0,,,,2,2,1,3
C(C(CO)(C(C)C(CO)O)O)(O)=O,,,5,1,1,0,1
17326_0,,,,2,2,1,3
17327_0,,,,2,2,1,3
17328_0,,,,2,2,1,3
17329_0,,,,2,2,1,3
17330_0,,,,2,2,1,3
17331_0,,,,2,2,1,3
17333_0,,,,2,2,1,3
C(CC(C)(C(C)C(CO)O)O)=O,,,5,1,1,0,1
17334_0,,,,2,2,1,3
17335_0,,,,2,2,1,3
17337_0,,,,2,2,1,3
C(C(C(C(C)C(CO)O)O)=O)=O,,,5,1,1,0,1
17339_0,,,,2,2,1,3
C(C(C(C)C(CO)O)O)(O)=O,,,5,1,1,0,1
17341_0,,,,2,2,1,3
CC(C(CO)O)C(CO)O,,,5,1,1,0,1
17342_0,,,,2,2,1,3
17343_0,,,,2,2,1,3
17344_0,,,,2,2,1,3
17345_0,,,,2,2,1,3
17347_0,,,,2,2,1,3
C(C(CCC=O)C(CO)O)(O)=O,,,5,1,2,0,2
17349_0,,,,2,2,1,3
C(C(CC(CO)O)C(CO)O)(O)=O,,,5,1,2,0,2
17350_0,,,,2,2,1,3
17352_0,,,,2,2,1,3
C(C(C)(C(CO)O)C(CO)O)(O)=O,,,5,1,1,0,1
17353_0,,,,2,2,1,3
17354_0,,,,2,2,1,3
17356_0,,,,2,2,1,3
C(C(C)C(CO)(C(CO)O)O)(O)=O,,,5,1,1,0,1
17357_0,,,,2,2,1,3
17358_0,,,,2,2,1,3
17359_0,,,,2,2,1,3
17360_0,,,,2,2,1,3
17361_0,,,,2,2,1,3
17362_0,,,,2,2,1,3
17363_0,,,,2,2,1,3
17364_0,,,,2,2,1,3
17365_0,,,,2,2,1,3
17366_0,,,,2,2,1,3
17367_0,,,,2,2,1,3
17368_0,,,,2,2,1,3
17369_0,,,,2,2,1,3
17370_0,,,,2,2,1,3
17371_0,,,,2,2,1,3
17372_0,,,,2,2,1,3
17373_0,,,,2,2,1,3
17374_0,,,,2,2,1,3
17375_0,,,,2,2,1,3
17376_0,,,,2,2,1,3
17377_0,,,,2,2,1,3
17378_0,,,,2,2,1,3
17379_0,,,,2,2,1,3
17380_0,,,,2,2,1,3
17381_0,,,,2,2,1,3
17382_0,,,,2,2,1,3
17383_0,,,,2,2,1,3
17384_0,,,,2,2,1,3
17385_0,,,,2,2,1,3
17386_0,,,,2,2,1,3
17387_0,,,,2,2,1,3
17388_0,,,,2,2,1,3
17389_0,,,,2,2,1,3
17390_0,,,,2,2,1,3
17391_0,,,,2,2,1,3
17392_0,,,,2,2,1,3
17393_0,,,,2,2,1,3
17394_0,,,,2,2,1,3
17395_0,,,,2,2,1,3
17396_0,,,,2,2,1,3
17397_0,,,,2,2,1,3
17398_0,,,,2,2,1,3
17399_0,,,,2,2,1,3
17400_0,,,,2,2,1,3
17401_0,,,,2,2,1,3
17402_0,,,,2,2,1,3
17403_0,,,,2,2,1,3
17404_0,,,,2,2,1,3
17405_0,,,,2,2,1,3
17406_0,,,,2,2,1,3
17407_0,,,,2,2,1,3
17408_0,,,,2,2,1,3
17409_0,,,,2,2,1,3
17410_0,,,,2,2,1,3
17411_0,,,,2,2,1,3
17412_0,,,,2,2,1,3
17413_0,,,,2,2,1,3
17414_0,,,,2,2,1,3
17415_0,,,,2,2,1,3
17416_0,,,,2,2,1,3
17417_0,,,,2,2,1,3
17418_0,,,,2,2,1,3
17419_0,,,,2,2,1,3
17420_0,,,,2,2,1,3
17421_0,,,,2,2,1,3
17422_0,,,,2,2,1,3
17423_0,,,,2,2,1,3
17424_0,,,,2,2,1,3
17425_0,,,,2,2,1,3
17426_0,,,,2,2,1,3
17427_0,,,,2,2,1,3
17428_0,,,,2,2,1,3
17429_0,,,,2,2,1,3
17430_0,,,,2,2,1,3
17431_0,,,,2,2,1,3
17432_0,,,,2,2,1,3
17433_0,,,,2,2,1,3
17434_0,,,,2,2,1,3
17435_0,,,,2,2,1,3
17436_0,,,,2,2,1,3
17437_0,,,,2,2,1,3
17438_0,,,,2,2,1,3
17439_0,,,,2,2,1,3
17440_0,,,,2,2,1,3
17441_0,,,,2,2,1,3
17442_0,,,,2,2,1,3
17443_0,,,,2,2,1,3
17444_0,,,,2,2,1,3
17445_0,,,,2,2,1,3
17446_0,,,,2,2,1,3
17447_0,,,,2,2,1,3
17448_0,,,,2,2,1,3
17449_0,,,,2,2,1,3
17450_0,,,,2,2,1,3
17451_0,,,,2,2,1,3
17452_0,,,,2,2,1,3
17453_0,,,,2,2,1,3
17454_0,,,,2,2,1,3
17455_0,,,,2,2,1,3
17456_0,,,,2,2,1,3
17457_0,,,,2,2,1,3
17458_0,,,,2,2,1,3
17459_0,,,,2,2,1,3
17460_0,,,,2,2,1,3
17461_0,,,,2,2,1,3
17462_0,,,,2,2,1,3
17463_0,,,,2,2,1,3
17464_0,,,,2,2,1,3
17465_0,,,,2,2,1,3
17466_0,,,,2,2,1,3
17467_0,,,,2,2,1,3
17468_0,,,,2,2,1,3
17469_0,,,,2,2,1,3
17470_0,,,,2,2,1,3
17471_0,,,,2,2,1,3
17472_0,,,,2,2,1,3
17473_0,,,,2,2,1,3
17474_0,,,,2,2,1,3
17475_0,,,,2,2,1,3
17476_0,,,,2,2,1,3
17477_0,,,,2,2,1,3
17478_0,,,,2,2,1,3
17479_0,,,,2,2,1,3
17480_0,,,,2,2,1,3
17481_0,,,,2,2,1,3
17482_0,,,,2,2,1,3
17483_0,,,,2,2,1,3
17484_0,,,,2,2,1,3
17485_0,,,,2,2,1,3
17486_0,,,,2,2,1,3
17487_0,,,,2,2,1,3
17488_0,,,,2,2,1,3
17489_0,,,,2,2,1,3
17490_0,,,,2,2,1,3
17491_0,,,,2,2,1,3
17492_0,,,,2,2,1,3
17493_0,,,,2,2,1,3
17494_0,,,,2,2,1,3
17495_0,,,,2,2,1,3
17496_0,,,,2,2,1,3
17497_0,,,,2,2,1,3
17498_0,,,,2,2,1,3
17499_0,,,,2,2,1,3
17500_0,,,,2,2,1,3
17501_0,,,,2,2,1,3
17502_0,,,,2,2,1,3
17503_0,,,,2,2,1,3
17504_0,,,,2,2,1,3
17505_0,,,,2,2,1,3
17506_0,,,,2,2,1,3
17507_0,,,,2,2,1,3
17508_0,,,,2,2,1,3
17509_0,,,,2,2,1,3
17510_0,,,,2,2,1,3
17511_0,,,,2,2,1,3
17512_0,,,,2,2,1,3
17513_0,,,,2,2,1,3
17514_0,,,,2,2,1,3
17515_0,,,,2,2,1,3
17516_0,,,,2,2,1,3
17517_0,,,,2,2,1,3
17519_0,,,,2,2,1,3
C(C(C(C)O)(CCC(C)O)O)=O,,,5,1,1,0,1
17520_0,,,,2,2,1,3
17522_0,,,,2,2,1,3
C(C(CC(C(C)O)O)C(C)O)=O,,,5,1,1,0,1
17523_0,,,,2,2,1,3
17524_0,,,,2,2,1,3
17525_0,,,,2,2,1,3
17527_0,,,,2,2,1,3
C(C(C=O)CC(C(C)O)O)(O)=O,,,5,1,1,0,1
17528_0,,,,2,2,1,3
17530_0,,,,2,2,1,3
C(C(C(CC(C(C)O)O)O)=O)=O,,,5,1,1,0,1
17531_0,,,,2,2,1,3
17533_0,,,,2,2,1,3
C(C(CCC(C)O)O)=O,,,5,1,1,0,1
17534_0,,,,2,2,1,3
17536_0,,,,2,2,1,3
C(CCC(C(C)O)O)=O,,,5,1,1,0,1
17537_0,,,,2,2,1,3
17539_0,,,,2,2,1,3
C(C(C(CCC(C)O)O)=O)(O)=O,,,5,1,1,0,1
17540_0,,,,2,2,1,3
17542_0,,,,2,2,1,3
C(C(CCC(C(C)O)O)=O)(O)=O,,,5,1,1,0,1
17543_0,,,,2,2,1,3
17545_0,,,,2,2,1,3
C(C(CC(C(O)=O)O)C(C)O)=O,,,5,1,2,0,2
17547_0,,,,2,2,1,3
C(C(CCC(O)=O)(C(C)O)O)=O,,,5,1,1,0,1
17548_0,,,,2,2,1,3
17549_0,,,,2,2,1,3
17550_0,,,,2,2,1,3
17551_0,,,,2,2,1,3
17552_0,,,,2,2,1,3
17553_0,,,,2,2,1,3
17554_0,,,,2,2,1,3
17555_0,,,,2,2,1,3
17556_0,,,,2,2,1,3
17557_0,,,,2,2,1,3
17558_0,,,,2,2,1,3
17559_0,,,,2,2,1,3
17560_0,,,,2,2,1,3
17561_0,,,,2,2,1,3
17562_0,,,,2,2,1,3
17563_0,,,,2,2,1,3
17564_0,,,,2,2,1,3
17565_0,,,,2,2,1,3
17566_0,,,,2,2,1,3
17567_0,,,,2,2,1,3
17568_0,,,,2,2,1,3
17569_0,,,,2,2,1,3
17570_0,,,,2,2,1,3
17571_0,,,,2,2,1,3
17573_0,,,,2,2,1,3
C(C(CC(C)O)C(C=O)O)(O)=O,,,5,1,1,0,1
17574_0,,,,2,2,1,3
17576_0,,,,2,2,1,3
C(C(C(C(C)O)O)CC=O)(O)=O,,,5,1,1,0,1
17578_0,,,,2,2,1,3
C(C(C(C)(C(C)O)O)=O)(O)=O,,,5,1,1,0,1
17579_0,,,,2,2,1,3
17580_0,,,,2,2,1,3
17581_0,,,,2,2,1,3
17582_0,,,,2,2,1,3
17583_0,,,,2,2,1,3
17584_0,,,,2,2,1,3
17585_0,,,,2,2,1,3
17586_0,,,,2,2,1,3
17587_0,,,,2,2,1,3
17588_0,,,,2,2,1,3
17590_0,,,,2,2,1,3
C(C(C=O)CC(C(O)=O)O)(O)=O,,,5,1,2,0,2
17591_0,,,,2,2,1,3
17592_0,,,,2,2,1,3
17593_0,,,,2,2,1,3
17595_0,,,,2,2,1,3
C(CCC(C=O)O)(O)=O,,,5,1,2,0,2
17596_0,,,,2,2,1,3
17598_0,,,,2,2,1,3
C(CCC(C(O)=O)O)=O,,,5,1,2,0,2
17599_0,,,,2,2,1,3
17601_0,,,,2,2,1,3
C(CCC(C(C(O)=O)=O)O)(O)=O,,,5,1,2,0,2
17602_0,,,,2,2,1,3
17604_0,,,,2,2,1,3
C(C(CCC(C(O)=O)=O)O)(O)=O,,,5,1,2,0,2
17605_0,,,,2,2,1,3
17606_0,,,,2,2,1,3
17607_0,,,,2,2,1,3
17608_0,,,,2,2,1,3
17609_0,,,,2,2,1,3
17610_0,,,,2,2,1,3
17611_0,,,,2,2,1,3
17613_0,,,,2,2,1,3
C(C(C)(CCC(C=O)O)O)(O)=O,,,5,1,1,0,1
17614_0,,,,2,2,1,3
17616_0,,,,2,2,1,3
C(C(C)(C(CCC=O)O)O)(O)=O,,,5,1,2,0,2
17617_0,,,,2,2,1,3
17618_0,,,,2,2,1,3
17619_0,,,,2,2,1,3
17620_0,,,,2,2,1,3
17621_0,,,,2,2,1,3
17623_0,,,,2,2,1,3
C(CC(C(O)=O)C(C=O)O)(O)=O,,,5,1,1,0,1
17624_0,,,,2,2,1,3
17626_0,,,,2,2,1,3
C(C(C(C(O)=O)CC=O)O)(O)=O,,,5,1,1,0,1
17627_0,,,,2,2,1,3
17628_0,,,,2,2,1,3
17630_0,,,,2,2,1,3
C(C(C(C(C(C)=O)=O)(C)O)=O)(O)=O,,,5,1,1,0,1
17631_0,,,,2,2,1,3
17633_0,,,,2,2,1,3
C(C(CC(C(C(C)O)=O)=O)=O)(O)=O,,,5,1,1,0,1
17634_0,,,,2,2,1,3
17635_0,,,,2,2,1,3
17636_0,,,,2,2,1,3
17637_0,,,,2,2,1,3
17638_0,,,,2,2,1,3
17639_0,,,,2,2,1,3
17640_0,,,,2,2,1,3
17641_0,,,,2,2,1,3
17642_0,,,,2,2,1,3
17643_0,,,,2,2,1,3
17644_0,,,,2,2,1,3
17645_0,,,,2,2,1,3
17646_0,,,,2,2,1,3
17648_0,,,,2,2,1,3
C(C(C(C(C(O)=O)=O)=C)CO)(O)=O,,,5,1,1,0,1
17650_0,,,,2,2,1,3
C=C(C(O)=O)C(C(C(O)=O)=O)(C)O,,,5,1,1,0,1
17651_0,,,,2,2,1,3
17653_0,,,,2,2,1,3
C(C1(C)C(C(C(O1)=O)=O)(C)O)(O)=O,,,5,1,1,0,1
17654_0,,,,2,2,1,3
17655_0,,,,2,2,1,3
17656_0,,,,2,2,1,3
17658_0,,,,2,2,1,3
C1(C(C)(C(C(C(O1)=O)=O)(C)O)O)=O,,,5,1,1,0,1
17659_0,,,,2,2,1,3
17660_0,,,,2,2,1,3
17661_0,,,,2,2,1,3
17662_0,,,,2,2,1,3
17663_0,,,,2,2,1,3
17665_0,,,,2,2,1,3
CC(C(C)O)O,,,5,1,1,0,1
17666_0,,,,2,2,1,3
17667_0,,,,2,2,1,3
17668_0,,,,2,2,1,3
17669_0,,,,2,2,1,3
17670_0,,,,2,2,1,3
17671_0,,,,2,2,1,3
17673_0,,,,2,2,1,3
C(C(CO)(CC(C(C)O)O)O)(O)=O,,,5,1,1,0,1
17674_0,,,,2,2,1,3
17676_0,,,,2,2,1,3
C(C(CO)(CC(C(O)=O)O)O)(O)=O,,,5,1,1,0,1
17677_0,,,,2,2,1,3
17679_0,,,,2,2,1,3
C(C(CC(C(C)O)O)O)(O)=O,,,5,1,1,0,1
17680_0,,,,2,2,1,3
17682_0,,,,2,2,1,3
C(C(CC(C(O)=O)O)O)(O)=O,,,5,1,1,0,1
17683_0,,,,2,2,1,3
17684_0,,,,2,2,1,3
17685_0,,,,2,2,1,3
17686_0,,,,2,2,1,3
17687_0,,,,2,2,1,3
17688_0,,,,2,2,1,3
17689_0,,,,2,2,1,3
17690_0,,,,2,2,1,3
17691_0,,,,2,2,1,3
17692_0,,,,2,2,1,3
17693_0,,,,2,2,1,3
17694_0,,,,2,2,1,3
17695_0,,,,2,2,1,3
17696_0,,,,2,2,1,3
17698_0,,,,2,2,1,3
C1(C(CO)CC(O)O1)=O,,,5,1,2,0,2
17700_0,,,,2,2,1,3
C1(C(C)C(C(O)O1)O)=O,,,5,1,2,0,2
17701_0,,,,2,2,1,3
17702_0,,,,2,2,1,3
17703_0,,,,2,2,1,3
17704_0,,,,2,2,1,3
17705_0,,,,2,2,1,3
17706_0,,,,2,2,1,3
17707_0,,,,2,2,1,3
17708_0,,,,2,2,1,3
17709_0,,,,2,2,1,3
17710_0,,,,2,2,1,3
17711_0,,,,2,2,1,3
17713_0,,,,2,2,1,3
C(C(CO)C1C(C(OC1)=O)=O)(O)=O,,,5,1,1,0,1
17714_0,,,,2,2,1,3
17716_0,,,,2,2,1,3
C1(C(CO)C(C(C(O)=O)=O)CO1)=O,,,5,1,1,0,1
17717_0,,,,2,2,1,3
17719_0,,,,2,2,1,3
C(CC(C)CCC(C=O)O)=O,,,5,1,2,0,2
17720_0,,,,2,2,1,3
17722_0,,,,2,2,1,3
C(C(CCO)C(C)CC=O)=O,,,5,1,2,0,2
17723_0,,,,2,2,1,3
17724_0,,,,2,2,1,3
17726_0,,,,2,1,2,3
C=CC,,,5,1,2,0,2
17728_0,,,,2,1,2,3
C=C(C(O)=O)C,,,5,1,2,0,2
17729_0,,,,2,1,2,3
17730_0,,,,2,1,2,3
17731_0,,,,2,1,2,3
17732_0,,,,2,1,2,3
17733_0,,,,2,1,2,3
17734_0,,,,2,1,2,3
17735_0,,,,2,1,2,3
17736_0,,,,2,1,2,3
17737_0,,,,2,1,2,3
17738_0,,,,2,1,2,3
17739_0,,,,2,1,2,3
17740_0,,,,2,1,2,3
17741_0,,,,2,1,2,3
17742_0,,,,2,1,2,3
17743_0,,,,2,1,2,3
17744_0,,,,2,1,2,3
17745_0,,,,2,1,2,3
17746_0,,,,2,1,2,3
17747_0,,,,2,1,2,3
17748_0,,,,2,1,2,3
17749_0,,,,2,1,2,3
17750_0,,,,2,1,2,3
17751_0,,,,2,1,2,3
17752_0,,,,2,1,2,3
17753_0,,,,2,1,2,3
17754_0,,,,2,1,2,3
17755_0,,,,2,1,2,3
17756_0,,,,2,1,2,3
17758_0,,,,2,1,2,3
C(C(C)O)=CCO,,,5,1,1,0,1
17760_0,,,,2,1,2,3
C(CO)=CC(O)=O,,,5,1,1,0,1
17761_0,,,,2,1,2,3
17763_0,,,,2,1,1,2
CC1C2C(C(C(C2O)O)(O)O1)O,,,5,1,2,0,2
17763_1,,,,2,1,1,2
17764_0,,,,2,1,1,2
17764_1,,,,2,1,1,2
17765_0,,,,2,1,1,2
17765_1,,,,2,1,1,2
17766_0,,,,2,1,1,2
17766_1,,,,2,1,1,2
17767_0,,,,2,1,1,2
17767_1,,,,2,1,1,2
17768_0,,,,2,1,1,2
17768_1,,,,2,1,1,2
17770_0,,,,2,1,1,2
C1(C2(C(C(C(C2)O)(O)O1)O)O)=O,,,5,1,2,0,2
17770_1,,,,2,1,1,2
17771_0,,,,2,1,1,2
17771_1,,,,2,1,1,2
17773_0,,,,2,1,1,2
C(C1C(CC(C)O)OC(C1O)O)=O,,,5,1,1,0,1
17775_0,,,,2,1,1,2
C(C1C(CC(O)=O)OC(C1O)O)=O,,,5,1,1,0,1
17777_0,,,,2,1,1,2
C(CC1CC(C(CO)(O)O1)O)=O,,,5,1,1,0,1
17779_0,,,,2,1,1,2
C(CC1(CO)C(CC(O)O1)O)=O,,,5,1,1,0,1
17781_0,,,,2,1,1,2
C(CC1C(CO)(CC(O)O1)O)=O,,,5,1,1,0,1
17782_0,,,,2,1,1,2
17784_0,,,,2,1,1,2
C(C1C(C(OC1C(CO)=O)O)O)=O,,,5,1,1,0,1
17786_0,,,,2,1,1,2
C(C1C(C(CO)(OC1C=O)O)O)=O,,,5,1,1,0,1
17788_0,,,,2,1,1,2
C(C1COC(CO)(C1O)O)=O,,,5,1,1,0,1
17790_0,,,,2,1,1,2
C(CC1CC(C(O)O1)(CO)O)=O,,,5,1,1,0,1
17792_0,,,,2,1,1,2
C(C1C(C(OC1(C=O)CO)O)O)=O,,,5,1,1,0,1
17794_0,,,,2,1,1,2
C(C1C(CO)(C(OC1C=O)O)O)=O,,,5,1,1,0,1
17796_0,,,,2,1,1,2
C(C1(COC(C1C(C=O)O)O)O)=O,,,5,1,1,0,1
17798_0,,,,2,1,1,2
C(C1COC(C1(CO)O)O)=O,,,5,1,1,0,1
17800_0,,,,2,1,1,2
C(C1(COC(C1CO)O)O)=O,,,5,1,1,0,1
17802_0,,,,2,1,1,2
C(C1COC(C1O)(C(CO)O)O)=O,,,5,1,1,0,1
17804_0,,,,2,1,1,2
C(C1COC(C1(C(CO)O)O)O)=O,,,5,1,1,0,1
17806_0,,,,2,1,1,2
C(C1(C(CO)OC(C1CO)O)O)=O,,,5,1,1,0,1
17807_0,,,,2,1,1,2
17809_0,,,,2,1,1,2
C(C1(C(CO)OC(C1C=C)O)O)=O,,,5,1,1,0,1
17810_0,,,,2,1,1,2
17812_0,,,,2,1,1,2
C(C1(C(CO)OC(C1)O)O)=O,,,5,1,1,0,1
17813_0,,,,2,1,1,2
17815_0,,,,2,1,1,2
C(C1(CC(O)OC1C(C)O)O)=O,,,5,1,1,0,1
17816_0,,,,2,1,1,2
17818_0,,,,2,1,1,2
C(C1(CC(OC1C(O)=O)O)O)=O,,,5,1,1,0,1
17819_0,,,,2,1,1,2
17821_0,,,,2,1,1,2
C(C1C(C(C)(O)OC1CCO)=O)=O,,,5,1,1,0,1
17823_0,,,,2,1,1,2
C(CC1(C(CC(CCO)O1)=O)O)=O,,,5,1,1,0,1
17825_0,,,,2,1,1,2
C=C1C(OC(C1C(CCO)O)O)=O,,,5,1,1,0,1
17827_0,,,,2,1,1,2
C1(C(O)OC(CCO)C1O)=O,,,5,1,1,0,1
17829_0,,,,2,1,1,2
C1(C(CCO)(C(CO)C(O)O1)O)=O,,,5,1,1,0,1
17831_0,,,,2,1,1,2
C(C1COC(C)(C1(CC=O)O)O)=O,,,5,1,1,0,1
17833_0,,,,2,1,1,2
C(C1COC(C1(C)O)(CC=O)O)=O,,,5,1,1,0,1
17835_0,,,,2,1,1,2
C(C(CO)C1(C(CC(O1)O)=O)C)=O,,,5,1,1,0,1
17837_0,,,,2,1,1,2
C(C(C1CC(C(C)(O)O1)=O)CO)=O,,,5,1,1,0,1
17839_0,,,,2,1,1,2
C(C1COC(C1O)O)=O,,,5,1,1,0,1
17841_0,,,,2,1,1,2
C(C1C(C(CO)C(O1)O)O)=O,,,5,1,1,0,1
17843_0,,,,2,1,1,2
C1C(CO)(C(C(O)O1)CO)O,,,5,1,1,0,1
17845_0,,,,2,1,1,2
C1(C(CO)(C(CO)C(O)O1)O)=O,,,5,1,1,0,1
17847_0,,,,2,1,1,2
C(C1(COC(C1CO)O)O)(O)=O,,,5,1,1,0,1
17849_0,,,,2,1,1,2
C(C1(C)C(C(CO)C(O1)O)O)(O)=O,,,5,1,1,0,1
17851_0,,,,2,1,1,2
C(C1C(C(CO)C(O1)O)O)(O)=O,,,5,1,1,0,1
17853_0,,,,2,1,1,2
C1(C(C=CC)(C(CO)C(O)O1)O)=O,,,5,1,1,0,1
17855_0,,,,2,1,1,2
C1(C(C(CO)C(O)O1)(CC=C)O)=O,,,5,1,1,0,1
17857_0,,,,2,1,1,2
C1(C(CCO)(C(C=C)C(O)O1)O)=O,,,5,1,1,0,1
17859_0,,,,2,1,1,2
C1(C(CCO)(CC(O)O1)O)=O,,,5,1,1,0,1
17861_0,,,,2,1,1,2
C(C(C1COC(C1O)O)=O)(O)=O,,,5,1,1,0,1
17863_0,,,,2,1,1,2
C(C(C=C)C1(C(CC(O1)O)=O)C)=O,,,5,1,1,0,1
17865_0,,,,2,1,1,2
C1(C(C)(CC=O)OC(C1)O)=O,,,5,1,1,0,1
17867_0,,,,2,1,1,2
C(C(C=C)C1CC(C(C)(O)O1)=O)=O,,,5,1,1,0,1
17869_0,,,,2,1,1,2
C(CC1CC(C(C)(O)O1)=O)=O,,,5,1,1,0,1
17871_0,,,,2,1,1,2
C1(C(C)(OC(C=O)C1C=O)O)=O,,,5,1,1,0,1
17873_0,,,,2,1,1,2
C1(C(C)(OC(C=CC)C1C=O)O)=O,,,5,1,1,0,1
17875_0,,,,2,1,1,2
C(C1C(C(C)(O)OC1CC=C)=O)=O,,,5,1,1,0,1
17877_0,,,,2,1,1,2
C(C1C(C(C)(O)OC1C)=O)=O,,,5,1,1,0,1
17878_0,,,,2,1,1,2
17880_0,,,,2,1,1,2
C(C1C(C(C)(O)OC1)=O)=O,,,5,1,2,0,2
17882_0,,,,2,1,1,2
C(C1CC(C(CC=O)(O)O1)=O)=O,,,5,1,1,0,1
17884_0,,,,2,1,1,2
C(CC1(C(CC(C=CC)O1)=O)O)=O,,,5,1,1,0,1
17886_0,,,,2,1,1,2
C(CC1(C(CC(CC=C)O1)=O)O)=O,,,5,1,1,0,1
17888_0,,,,2,1,1,2
C(CC1(C(CC(C)O1)=O)O)=O,,,5,1,1,0,1
17890_0,,,,2,1,1,2
C1(CC(C(CC=O)(O)O1)=O)=O,,,5,1,1,0,1
17892_0,,,,2,1,1,2
C(CC1(C(CCO1)=O)O)=O,,,5,1,2,0,2
17894_0,,,,2,1,1,2
C(C(C)O)(C1(COC(C1)O)O)=O,,,5,1,1,0,1
17896_0,,,,2,1,1,2
C(CO)(C1(C(C)OC(C1)O)O)=O,,,5,1,1,0,1
17898_0,,,,2,1,1,2
C(C1C(C(C(C(C)O)(O1)O)=O)O)=O,,,5,1,1,0,1
17899_0,,,,2,1,1,2
17900_0,,,,2,1,1,2
17901_0,,,,2,1,1,2
17903_0,,,,2,1,1,2
C(C(C1(COC(C1)O)O)=O)(O)=O,,,5,1,1,0,1
17905_0,,,,2,1,1,2
C1(C(C(CO)=O)(CC(O)O1)O)=O,,,5,1,1,0,1
17907_0,,,,2,1,1,2
C(C1(C(C(C(C=O)O1)O)=O)O)(O)=O,,,5,1,1,0,1
17908_0,,,,2,1,1,2
17909_0,,,,2,1,1,2
17910_0,,,,2,1,1,2
17912_0,,,,2,1,1,2
C(C(C1C(C(OC1O)=O)=C)O)=O,,,5,1,1,0,1
17914_0,,,,2,1,1,2
C(C1C(C)OC(C1O)O)=O,,,5,1,1,0,1
17916_0,,,,2,1,1,2
C(C(C1C(C)OC(C1O)O)=O)(O)=O,,,5,1,1,0,1
17918_0,,,,2,1,1,2
C1(C(C=O)C(C(O)O1)O)=O,,,5,1,1,0,1
17920_0,,,,2,1,1,2
C1(C(C)(C(C(O)O1)C(C=O)O)O)=O,,,5,1,1,0,1
17922_0,,,,2,1,1,2
C(C1C(C(OC1(C(O)=O)C)O)O)=O,,,5,1,1,0,1
17924_0,,,,2,1,1,2
C1(C(C(C(O)=O)=O)C(C(O)O1)O)=O,,,5,1,1,0,1
17925_0,,,,2,1,1,2
17927_0,,,,2,1,1,2
C(CO)(C1C(C(C(O1)O)O)O)=O,,,5,1,1,0,1
17929_0,,,,2,1,1,2
C(C1C(C(C(CO)(O1)O)O)O)=O,,,5,1,1,0,1
17931_0,,,,2,1,1,2
C(C(C1C(C(C(O1)O)O)O)=O)(O)=O,,,5,1,1,0,1
17933_0,,,,2,1,1,2
C(C1C(C(C(C(O)=O)(O1)O)O)O)=O,,,5,1,1,0,1
17935_0,,,,2,1,1,2
C(C1C(C(C=C)C(O1)O)O)=O,,,5,1,1,0,1
17937_0,,,,2,1,1,2
C(C1C(CC(O1)O)O)=O,,,5,1,1,0,1
17939_0,,,,2,1,1,2
C(C1C(C(C(O1)O)C(C)O)O)=O,,,5,1,1,0,1
17941_0,,,,2,1,1,2
C(C1C(C(C=O)OC1O)O)(O)=O,,,5,1,1,0,1
17943_0,,,,2,1,1,2
C(C(C1C(C(C(O1)O)O)O)=O)=O,,,5,1,1,0,1
17944_0,,,,2,1,1,2
17946_0,,,,2,1,1,2
C(C1C(C(C(C=O)(O1)O)O)O)=O,,,5,1,1,0,1
17948_0,,,,2,1,1,2
C(C1C(CC(C(O)=O)(O1)O)O)=O,,,5,1,1,0,1
17950_0,,,,2,1,1,2
C1C(CO)(C(C(CO)(O)O1)O)O,,,5,1,1,0,1
17952_0,,,,2,1,1,2
C(C1(C(C(CO)(CO1)O)O)O)(O)=O,,,5,1,1,0,1
17954_0,,,,2,1,1,2
C=CC1C(O)OCC1(CO)O,,,5,1,1,0,1
17955_0,,,,2,1,1,2
17956_0,,,,2,1,1,2
17957_0,,,,2,1,1,2
17958_0,,,,2,1,1,2
17959_0,,,,2,1,1,2
17960_0,,,,2,1,1,2
17962_0,,,,2,1,1,2
C(C1C(C(C(CO)(O1)O)O)O)(O)=O,,,5,1,1,0,1
17963_0,,,,2,1,1,2
17964_0,,,,2,1,1,2
17966_0,,,,2,1,1,2
C1(C(CO)(C(C=C)C(O)O1)O)=O,,,5,1,1,0,1
17968_0,,,,2,1,1,2
C(C1(COC(C1C=C)O)O)(O)=O,,,5,1,1,0,1
17970_0,,,,2,1,1,2
C1(C(CO)(CC(O)O1)O)=O,,,5,1,1,0,1
17971_0,,,,2,1,1,2
17973_0,,,,2,1,1,2
C1(C(CO)(C(C(O)O1)C(C)O)O)=O,,,5,1,1,0,1
17974_0,,,,2,1,1,2
17976_0,,,,2,1,1,2
C(C1C(O)OC(C1(CO)O)=O)(O)=O,,,5,1,1,0,1
17977_0,,,,2,1,1,2
17978_0,,,,2,1,1,2
17980_0,,,,2,1,1,2
C1(C(CO)(C(C(C=O)(O)O1)O)O)=O,,,5,1,1,0,1
17981_0,,,,2,1,1,2
17983_0,,,,2,1,1,2
C1(C(CO)(CC(C(O)=O)(O)O1)O)=O,,,5,1,1,0,1
17984_0,,,,2,1,1,2
17985_0,,,,2,1,1,2
17986_0,,,,2,1,1,2
17987_0,,,,2,1,1,2
17989_0,,,,2,1,1,2
C(C1(C(C(C=C)C(O1)O)O)C)(O)=O,,,5,1,1,0,1
17991_0,,,,2,1,1,2
C(C1(C)C(CC(O1)O)O)(O)=O,,,5,1,1,0,1
17993_0,,,,2,1,1,2
C(C1C(C(C=C)C(O1)O)O)(O)=O,,,5,1,1,0,1
17995_0,,,,2,1,1,2
C(C1C(CC(O1)O)O)(O)=O,,,5,1,1,0,1
17997_0,,,,2,1,1,2
C(C1C(C(C(O1)O)C(C)O)O)(O)=O,,,5,1,1,0,1
17999_0,,,,2,1,1,2
C(C1C(C(C(O)=O)OC1O)O)(O)=O,,,5,1,1,0,1
18001_0,,,,2,1,1,2
C(C(C1C(C(C(O)O1)=O)O)O)(O)=O,,,5,1,1,0,1
18003_0,,,,2,1,1,2
C(C1C(C(C(C=O)(O1)O)O)O)(O)=O,,,5,1,1,0,1
18005_0,,,,2,1,1,2
C(C1C(CC(C(O)=O)(O1)O)O)(O)=O,,,5,1,1,0,1
18007_0,,,,2,1,1,2
C(C)=CC(C1C(C(OC1O)=O)=C)O,,,5,1,1,0,1
18008_0,,,,2,1,1,2
18010_0,,,,2,1,1,2
C=CCC(C1C(C(OC1O)=O)=C)O,,,5,1,1,0,1
18011_0,,,,2,1,1,2
18013_0,,,,2,1,1,2
C1(C(C=CC)(C(C=C)C(O)O1)O)=O,,,5,1,1,0,1
18015_0,,,,2,1,1,2
C1(C(CC=C)(C(C=C)C(O)O1)O)=O,,,5,1,1,0,1
18016_0,,,,2,1,1,2
18017_0,,,,2,1,1,2
18018_0,,,,2,1,1,2
18019_0,,,,2,1,1,2
18020_0,,,,2,1,1,2
18021_0,,,,2,1,1,2
18022_0,,,,2,1,1,2
18024_0,,,,2,1,1,2
C1(C(C2COC(C)(C2(O)O1)O)=O)=O,,,5,1,2,0,2
18026_0,,,,2,1,1,2
C(C1C(C(CO)(C(O1)O)O)O)(O)=O,,,5,1,1,0,1
18028_0,,,,2,1,1,2
C(C)(C1(C(C(CO1)=O)=O)O)=O,,,5,1,1,0,1
18030_0,,,,2,1,1,2
C1(C(C)(O)OCC1)=O,,,5,1,1,0,1
18032_0,,,,2,1,1,2
C1(CC(C(C)(O)O1)=O)=O,,,5,1,1,0,1
18034_0,,,,2,1,1,2
C(CO)(C1(C(CC(C)O1)O)O)=O,,,5,1,1,0,1
18036_0,,,,2,1,1,2
C1(CC(C(C(CO)=O)(O)O1)O)=O,,,5,1,1,0,1
18038_0,,,,2,1,1,2
C1(COC(C(CO)=O)(C1O)O)=O,,,5,1,1,0,1
18040_0,,,,2,1,1,2
C(C1(C(C(CO)(O)OC1)=O)O)=O,,,5,1,1,0,1
18042_0,,,,2,1,1,2
C(C1(C(CC(C)O1)O)O)=O,,,5,1,1,0,1
18044_0,,,,2,1,1,2
C1(CC(C(C=O)(O)O1)O)=O,,,5,1,1,0,1
18046_0,,,,2,1,1,2
C(C1(C(C(CO1)=O)O)O)=O,,,5,1,1,0,1
18048_0,,,,2,1,1,2
C(C1(C(C(O)OC1)=O)O)=O,,,5,1,1,0,1
18049_0,,,,2,1,1,2
18050_0,,,,2,1,1,2
18051_0,,,,2,1,1,2
18052_0,,,,2,1,1,2
18053_0,,,,2,1,1,2
18054_0,,,,2,1,1,2
18055_0,,,,2,1,1,2
18057_0,,,,2,1,1,2
CC1CC(C(O)O1)O,,,5,1,1,0,1
18059_0,,,,2,1,1,2
C1(CC(C(O)O1)O)=O,,,5,1,1,0,1
18060_0,,,,2,1,1,2
18062_0,,,,2,1,1,2
C(C1(COC(C1O)O)O)(O)=O,,,5,1,1,0,1
18064_0,,,,2,1,1,2
C1(C(CO)(C(C(O)O1)O)O)=O,,,5,1,1,0,1
18066_0,,,,2,1,1,2
C1(C(C(C(O)O1)O)O)=O,,,5,1,1,0,1
18067_0,,,,2,1,1,2
18068_0,,,,2,1,1,2
18069_0,,,,2,1,1,2
18071_0,,,,2,1,1,2
C(C(C1(C(CC(C)O1)O)O)O)=O,,,5,1,1,0,1
18073_0,,,,2,1,1,2
C1(C(CO)OC(C1C(C)O)O)=O,,,5,1,1,0,1
18074_0,,,,2,1,1,2
18076_0,,,,2,1,1,2
C1(CC(C(C(C=O)O)(O)O1)O)=O,,,5,1,1,0,1
18078_0,,,,2,1,1,2
C(C1C(C(CO)OC1O)=O)(O)=O,,,5,1,1,0,1
18080_0,,,,2,1,1,2
C(C1C(C(C(CO)(O1)O)O)=O)=O,,,5,1,1,0,1
18081_0,,,,2,1,1,2
18083_0,,,,2,1,1,2
C(C(C1(C(C(CO1)=O)O)O)O)=O,,,5,1,1,0,1
18085_0,,,,2,1,1,2
C1(C(C(C=O)(OC1CO)O)O)=O,,,5,1,1,0,1
18087_0,,,,2,1,1,2
C1(C(CO)OC(C1)O)=O,,,5,1,1,0,1
18089_0,,,,2,1,1,2
C(C1C(C(C(O1)O)(CO)O)=O)=O,,,5,1,1,0,1
18090_0,,,,2,1,1,2
18091_0,,,,2,1,1,2
18092_0,,,,2,1,1,2
18093_0,,,,2,1,1,2
18095_0,,,,2,1,1,2
C1(COC(C)(C1O)O)=O,,,5,1,1,0,1
18096_0,,,,2,1,1,2
18098_0,,,,2,1,1,2
C(C1(CO)C(C(C(O1)O)O)O)(O)=O,,,5,1,1,0,1
18100_0,,,,2,1,1,2
C(C1C(C(C(O1)O)O)O)(O)=O,,,5,1,1,0,1
18102_0,,,,2,1,1,2
C1(C(C(C(O)=O)(OC1C)O)O)=O,,,5,1,1,0,1
18104_0,,,,2,1,1,2
C1(C(C(C(C(C)O)(O)O1)O)=O)=O,,,5,1,1,0,1
18106_0,,,,2,1,1,2
C1C(C(C)O)C(C(CO)(O)O1)O,,,5,1,1,0,1
18107_0,,,,2,1,1,2
18109_0,,,,2,1,1,2
C1C(C(C)O)C(C(O)O1)(CO)O,,,5,1,1,0,1
18110_0,,,,2,1,1,2
18112_0,,,,2,1,1,2
C(C1COC(CO)(C1O)O)(O)=O,,,5,1,1,0,1
18113_0,,,,2,1,1,2
18115_0,,,,2,1,1,2
C(C1COC(C1(CO)O)O)(O)=O,,,5,1,1,0,1
18116_0,,,,2,1,1,2
18118_0,,,,2,1,1,2
C1CC(C(CO)(O)O1)O,,,5,1,1,0,1
18120_0,,,,2,1,1,2
C1CC(C(O)O1)(CO)O,,,5,1,1,0,1
18122_0,,,,2,1,1,2
C1(C(C(C)O)C(C(CO)(O)O1)O)=O,,,5,1,1,0,1
18123_0,,,,2,1,1,2
18125_0,,,,2,1,1,2
C1(C(C(C)O)C(CO)(C(O)O1)O)=O,,,5,1,1,0,1
18126_0,,,,2,1,1,2
18127_0,,,,2,1,1,2
18128_0,,,,2,1,1,2
18130_0,,,,2,1,1,2
C1(CC(C(CO)(O)O1)O)=O,,,5,1,1,0,1
18132_0,,,,2,1,1,2
C1(CC(CO)(C(O)O1)O)=O,,,5,1,1,0,1
18134_0,,,,2,1,1,2
C(C1(CO)C(C)OC(C1O)O)=O,,,5,1,1,0,1
18136_0,,,,2,1,1,2
C(C1(COC(C1O)O)C(C)O)=O,,,5,1,1,0,1
18138_0,,,,2,1,1,2
C(C1(C(C)OC(C1O)O)C(C)O)=O,,,5,1,1,0,1
18140_0,,,,2,1,1,2
C(C1(C=O)C(C)OC(C1O)O)(O)=O,,,5,1,1,0,1
18142_0,,,,2,1,1,2
C1(C(C=O)(C(C(O)O1)O)C(C)O)=O,,,5,1,1,0,1
18144_0,,,,2,1,1,2
C(C1C(CC=O)OC(C1O)O)(O)=O,,,5,1,1,0,1
18146_0,,,,2,1,1,2
C1(C(C(CC=O)O)C(C(O)O1)O)=O,,,5,1,1,0,1
18148_0,,,,2,1,1,2
C1(C(C=O)(CO)C(C(O)O1)O)=O,,,5,1,1,0,1
18150_0,,,,2,1,1,2
C(C1(C=O)COC(C1O)O)(O)=O,,,5,1,1,0,1
18152_0,,,,2,1,1,2
C1(C(C(O)=O)(C=O)C(C(O)O1)O)=O,,,5,1,1,0,1
18154_0,,,,2,1,1,2
C1(C(C)(C(CO)(CO)C(O)O1)O)=O,,,5,1,1,0,1
18155_0,,,,2,1,1,2
18157_0,,,,2,1,1,2
C1(C(O)OC(CCO)C1(CO)O)=O,,,5,1,1,0,1
18159_0,,,,2,1,1,2
C(C(C1(COC(C1O)O)O)=O)=O,,,5,1,1,0,1
18160_0,,,,2,1,1,2
18162_0,,,,2,1,1,2
C1(C(OC(C=O)C1(CO)O)O)=O,,,5,1,1,0,1
18163_0,,,,2,1,1,2
18165_0,,,,2,1,1,2
C1(C(OC(C=CC)C1(CO)O)O)=O,,,5,1,1,0,1
18166_0,,,,2,1,1,2
18168_0,,,,2,1,1,2
C1(C(O)OC(CC=C)C1(CO)O)=O,,,5,1,1,0,1
18169_0,,,,2,1,1,2
18170_0,,,,2,1,1,2
18171_0,,,,2,1,1,2
18172_0,,,,2,1,1,2
18173_0,,,,2,1,1,2
18175_0,,,,2,1,1,2
C(C(C1(C(C)OC(C1O)O)O)=O)=O,,,5,1,1,0,1
18176_0,,,,2,1,1,2
18178_0,,,,2,1,1,2
C1(C(OC(C=O)C1(C(C)O)O)O)=O,,,5,1,1,0,1
18179_0,,,,2,1,1,2
18180_0,,,,2,1,1,2
18181_0,,,,2,1,1,2
18183_0,,,,2,1,1,2
C1(C(C(C=O)=O)(C(C(O)O1)O)O)=O,,,5,1,1,0,1
18184_0,,,,2,1,1,2
18186_0,,,,2,1,1,2
C(C1(C(C(O)OC1C=O)=O)O)(O)=O,,,5,1,1,0,1
18187_0,,,,2,1,1,2
18189_0,,,,2,1,1,2
C(C1COC(C1O)O)(O)=O,,,5,1,1,0,1
18191_0,,,,2,1,1,2
C1(C(CO)C(C(O)O1)O)=O,,,5,1,1,0,1
18193_0,,,,2,1,1,2
C1(C(C(C(O)O1)O)C(C)O)=O,,,5,1,1,0,1
18195_0,,,,2,1,1,2
C(C1C(C)OC(C1O)O)(O)=O,,,5,1,1,0,1
18197_0,,,,2,1,1,2
C1(C(C(O)=O)C(C(O)O1)O)=O,,,5,1,1,0,1
18199_0,,,,2,1,1,2
C(C1(C(C)OC(C1O)O)O)(O)=O,,,5,1,1,0,1
18201_0,,,,2,1,1,2
C1(C(C(C)O)(C(C(O)O1)O)O)=O,,,5,1,1,0,1
18203_0,,,,2,1,1,2
C1(C(C(O)=O)(C(C(O)O1)O)O)=O,,,5,1,1,0,1
18205_0,,,,2,1,1,2
C1(C(C=O)(C(C(O)O1)O)O)=O,,,5,1,1,0,1
18207_0,,,,2,1,1,2
C(C1(C(C)=O)COC(C1O)O)(O)=O,,,5,1,1,0,1
18209_0,,,,2,1,1,2
C1(C(C(C)=O)(CO)C(C(O)O1)O)=O,,,5,1,1,0,1
18211_0,,,,2,1,1,2
C(C1(C(OC(C=O)C1O)O)O)=O,,,5,1,1,0,1
18213_0,,,,2,1,1,2
C(C1(C=O)C(C(C(O1)O)O)O)=O,,,5,1,1,0,1
18215_0,,,,2,1,1,2
C(C1(C(O)OCC1(CO)O)O)=O,,,5,1,1,0,1
18217_0,,,,2,1,1,2
C1(C(CO)(C(C=O)(C(O)O1)O)O)=O,,,5,1,1,0,1
18219_0,,,,2,1,1,2
C(C1(COC(C1(C=O)O)O)O)(O)=O,,,5,1,1,0,1
18221_0,,,,2,1,1,2
C(C1(C(OC(C(O)=O)C1O)O)O)=O,,,5,1,1,0,1
18223_0,,,,2,1,1,2
C(C1(C(O)OCC1(C=O)O)O)=O,,,5,1,1,0,1
18225_0,,,,2,1,1,2
C1(C(C)(C(C=O)(C(O)O1)O)O)=O,,,5,1,1,0,1
18227_0,,,,2,1,1,2
C(C1(C=O)C(C(C(O1)O)O)O)(O)=O,,,5,1,1,0,1
18229_0,,,,2,1,1,2
C(C1(C(OC(C=O)C1O)O)O)(O)=O,,,5,1,1,0,1
18231_0,,,,2,1,1,2
C(C1(C(O)OCC1(CO)O)O)(O)=O,,,5,1,1,0,1
18233_0,,,,2,1,1,2
C1(C(C(CO)(C(CO)(O)O1)O)O)=O,,,5,1,1,0,1
18235_0,,,,2,1,1,2
C1(C(C=O)(C(C(CO)(O)O1)O)O)=O,,,5,1,1,0,1
18237_0,,,,2,1,1,2
C(C1(C(O)OCC1(C=O)O)O)(O)=O,,,5,1,1,0,1
18239_0,,,,2,1,1,2
C1(C(C=O)(C(CO)(C(O)O1)O)O)=O,,,5,1,1,0,1
18241_0,,,,2,1,1,2
C1(C(C)(C(C(O)=O)(C(O)O1)O)O)=O,,,5,1,1,0,1
18243_0,,,,2,1,1,2
C(CO)(C1(CC(OC1C=O)O)O)=O,,,5,1,1,0,1
18245_0,,,,2,1,1,2
C(CO)(C1(COC(C1)O)O)=O,,,5,1,1,0,1
18247_0,,,,2,1,1,2
C1(C(C(C(O)O1)(C(CO)O)O)O)=O,,,5,1,1,0,1
18248_0,,,,2,1,1,2
18250_0,,,,2,1,1,2
C(C)(C1(CC(OC1C(O)=O)O)O)=O,,,5,1,1,0,1
18252_0,,,,2,1,1,2
C(CC1(C(C)(O)OC(C1O)=O)O)=O,,,5,1,1,0,1
18254_0,,,,2,1,1,2
C1(C(C)(C(C(O)=O)O)OC(C1)O)=O,,,5,1,1,0,1
18256_0,,,,2,1,1,2
C(CC1(C(C)(C(C(O1)=O)O)O)O)=O,,,5,1,1,0,1
18258_0,,,,2,1,1,2
C(C1C(CC(C(C)=O)(O1)O)O)(O)=O,,,5,1,1,0,1
18260_0,,,,2,1,1,2
C(C(C1CC(C(C)(O)O1)=O)O)(O)=O,,,5,1,1,0,1
18262_0,,,,2,1,1,2
C1(C(C)(C(C=O)OC1(CO)O)O)=O,,,5,1,1,0,1
18264_0,,,,2,1,1,2
C1(C(CO)(O)OC(C)C1(C)O)=O,,,5,1,1,0,1
18266_0,,,,2,1,1,2
C1(C(CO)(O)OCC1(C)O)=O,,,5,1,1,0,1
18268_0,,,,2,1,1,2
C1(C(C)(C(C(O)O1)O)O)=O,,,5,1,1,0,1
18270_0,,,,2,1,1,2
C(C1(C)C(C(C(O1)O)O)O)(O)=O,,,5,1,1,0,1
18272_0,,,,2,1,1,2
C1(C(C)(C(CO)(C(O)O1)O)O)=O,,,5,1,1,0,1
18274_0,,,,2,1,1,2
C(C(C1(CCC(C)O1)O)=O)=O,,,5,1,1,0,1
18275_0,,,,2,1,1,2
18277_0,,,,2,1,1,2
C1(CCC(C(C=O)=O)(O)O1)=O,,,5,1,1,0,1
18278_0,,,,2,1,1,2
18280_0,,,,2,1,1,2
C1(COC(C(C=O)=O)(C1)O)=O,,,5,1,1,0,1
18281_0,,,,2,1,1,2
18282_0,,,,2,1,1,2
18283_0,,,,2,1,1,2
18284_0,,,,2,1,1,2
18285_0,,,,2,1,1,2
18287_0,,,,2,1,1,2
C(C1(CCC(C)O1)O)(O)=O,,,5,1,1,0,1
18289_0,,,,2,1,1,2
C1(CCC(C(O)=O)(O)O1)=O,,,5,1,1,0,1
18290_0,,,,2,1,1,2
18291_0,,,,2,1,1,2
18292_0,,,,2,1,1,2
18294_0,,,,2,1,1,2
C1(C(CC(C)(O)O1)O)=O,,,5,1,1,0,1
18295_0,,,,2,1,1,2
18296_0,,,,2,1,1,2
18297_0,,,,2,1,1,2
18298_0,,,,2,1,1,2
18299_0,,,,2,1,1,2
18300_0,,,,2,1,1,2
18301_0,,,,2,1,1,2
18302_0,,,,2,1,1,2
18303_0,,,,2,1,1,2
18304_0,,,,2,1,1,2
18306_0,,,,2,1,1,2
C1C(C(C)O)(C(C(CO)(O)O1)O)O,,,5,1,1,0,1
18307_0,,,,2,1,1,2
18309_0,,,,2,1,1,2
C1C(C(C)O)(C(C(O)O1)(CO)O)O,,,5,1,1,0,1
18310_0,,,,2,1,1,2
18312_0,,,,2,1,1,2
C1C(C(C(CO)(O)O1)O)O,,,5,1,1,0,1
18314_0,,,,2,1,1,2
C1C(C(C(O)O1)(CO)O)O,,,5,1,1,0,1
18315_0,,,,2,1,1,2
18317_0,,,,2,1,1,2
C1(C2C(C(C(C)(O2)O)(O)O1)O)=O,,,5,1,2,0,2
18319_0,,,,2,1,1,2
C1(C2(CC(C(CO)O2)(O)O1)O)=O,,,5,1,2,0,2
18321_0,,,,2,1,1,2
C1CCC(O)O1,,,5,1,1,0,1
18323_0,,,,2,1,1,2
C(C1(CCCO1)O)(O)=O,,,5,1,1,0,1
18325_0,,,,2,1,1,2
C(C1COC(C1)O)(O)=O,,,5,1,1,0,1
18326_0,,,,2,1,1,2
18327_0,,,,2,1,1,2
18329_0,,,,2,1,1,2
C1(C2COC(C(O1)=O)(C2)O)=O,,,5,1,2,0,2
18331_0,,,,2,1,1,2
CC1C2C(O)OC(CO)(C2O)O1,,,5,1,1,0,1
18333_0,,,,2,1,1,2
C1C2(C(O)OC(C2C(C)O)O1)O,,,5,1,1,0,1
18335_0,,,,2,1,1,2
C1C2(C(O)OC(C)C2C(O)O1)O,,,5,1,2,0,2
18336_0,,,,2,1,1,2
18338_0,,,,2,1,1,2
C12C(CO)(C(C(O)O1)C(C)O2)O,,,5,1,1,0,1
18340_0,,,,2,1,1,2
C1(C2C(O)OC(CO)(C2O)O1)=O,,,5,1,1,0,1
18342_0,,,,2,1,1,2
C(C1C2OCC1(C(O)O2)O)(O)=O,,,5,1,1,0,1
18344_0,,,,2,1,1,2
C1(C2C(O)OCC2(C(O)O1)O)=O,,,5,1,2,0,2
18345_0,,,,2,1,1,2
18347_0,,,,2,1,1,2
C1(C2C(O)OC(C2(CO)O)O1)=O,,,5,1,1,0,1
18349_0,,,,2,1,1,2
C1(C2(C)OC(C(O)=O)(C1CO2)O)=O,,,5,1,1,0,1
18350_0,,,,2,1,1,2
18352_0,,,,2,1,1,2
C(C12COC(C1O)(C(O2)O)O)=O,,,5,1,2,0,2
18353_0,,,,2,1,1,2
18355_0,,,,2,1,1,2
C(C12C(C(C(O1)O)(CO2)O)O)=O,,,5,1,1,0,1
18357_0,,,,2,1,1,2
C1C2(C(O)OC(C2)O1)O,,,5,1,1,0,1
18359_0,,,,2,1,1,2
C(C12CC(C(O1)O)(CO2)O)(O)=O,,,5,1,1,0,1
18361_0,,,,2,1,1,2
C1(C2(C)C(C(C(O2)O)(O)O1)O)=O,,,5,1,2,0,2
18362_0,,,,2,1,1,2
18363_0,,,,2,1,1,2
18364_0,,,,2,1,1,2
18366_0,,,,2,1,1,2
CC1CC2C(C(C(O)O2)(O)O1)O,,,5,1,2,0,2
18368_0,,,,2,1,1,2
C1C2(C(C(C(O)O1)C(C)O2)O)O,,,5,1,2,0,2
18370_0,,,,2,1,1,2
C1(CC2C(C(C(O)O2)(O)O1)O)=O,,,5,1,2,0,2
18372_0,,,,2,1,1,2
C1(C2C(O)OCC(C2O)(O)O1)=O,,,5,1,2,0,2
18374_0,,,,2,1,1,2
C1(C(CC2(C(CCO2)(O)O1)O)=O)=O,,,5,1,2,0,2
18376_0,,,,2,1,1,2
C1(COC2(C(C1OC2O)O)O)=O,,,5,1,2,0,2
18378_0,,,,2,1,1,2
C1(C2(CC(CO2)(C(O)O1)O)O)=O,,,5,1,2,0,2
18380_0,,,,2,1,1,2
C1(C2(CC(C(CO2)O)(O)O1)O)=O,,,5,1,2,0,2
18382_0,,,,2,1,1,2
C1(C2(CC(C(O2)=O)(O)OCC1)O)=O,,,5,1,2,0,2
18384_0,,,,2,1,1,2
C1(CC2(C(O)=O)OC1(CCO2)O)=O,,,5,1,1,0,1
18386_0,,,,2,1,1,2
C1(CC2C(C(C(O)O2)=O)O1)=O,,,5,1,2,0,2
18388_0,,,,2,1,1,2
C(C12COC(C(O1)=O)(C2)O)=O,,,5,1,2,0,2
18390_0,,,,2,1,1,2
C1(C2(C(C(C(O2)=O)=C)CO1)O)=O,,,5,1,2,0,2
18392_0,,,,2,1,1,2
C1(C(C)(C2COC(C2(O)O1)=O)O)=O,,,5,1,2,0,2
18394_0,,,,2,1,1,2
C1(C2(COC(C2(CO1)O)O)O)=O,,,5,1,2,0,2
18396_0,,,,2,1,1,2
C1(C2(COC(CO1)(C2O)O)O)=O,,,5,1,2,0,2
18398_0,,,,2,1,1,2
C1(C2COC(C(C2)(O)O1)=O)=O,,,5,1,2,0,2
18400_0,,,,2,1,1,2
C1(CC2(C(OCC1O2)=O)O)=O,,,5,1,2,0,2
18402_0,,,,2,1,1,2
C(C(C1C(C)CC(O)O1)C(C)O)=O,,,5,1,1,0,1
18404_0,,,,2,1,1,2
C(C(CO)C1(C)C(C)CC(O)O1)=O,,,5,1,1,0,1
18406_0,,,,2,1,1,2
C(C(C=O)C1C(C)CC(O)O1)(O)=O,,,5,1,1,0,1
18408_0,,,,2,1,1,2
C(C(C(C1C(C)CC(O)O1)O)=O)=O,,,5,1,1,0,1
18410_0,,,,2,1,1,2
C(CC(C)C1C(C(C(O)O1)=O)O)=O,,,5,1,2,0,2
18412_0,,,,2,1,1,2
C(C(C1(CO)C(C)CC(O1)O)=O)=O,,,5,1,1,0,1
18414_0,,,,2,1,1,2
C(CC(C)C1(C(C(O)OC1)=O)O)=O,,,5,1,2,0,2
18416_0,,,,2,1,1,2
C1(C(CC(C=O)CO)CC(O)O1)=O,,,5,1,2,0,2
18418_0,,,,2,1,1,2
C1(C(C)(CC(O)O1)C(C=O)CO)=O,,,5,1,1,0,1
18420_0,,,,2,1,1,2
C1(C(C)(C(CO)C(O)O1)CC=O)=O,,,5,1,1,0,1
18422_0,,,,2,1,1,2
C1(C(C)C(C(O)O1)C(C=O)CO)=O,,,5,1,2,0,2
18424_0,,,,2,1,1,2
C(C(C)C1C(O)OCC1C=O)(O)=O,,,5,1,1,0,1
18426_0,,,,2,1,1,2
C(CC1C(C)CC(O)O1)=O,,,5,1,1,0,1
18428_0,,,,2,1,1,2
C(CC1C(C)CC(C(O)=O)(O)O1)=O,,,5,1,1,0,1
18430_0,,,,2,1,1,2
C1(C(CC(CC=O)O)CC(O)O1)=O,,,5,1,2,0,2
18432_0,,,,2,1,1,2
C1(C(C)(C(CC=O)O)CC(O)O1)=O,,,5,1,1,0,1
18434_0,,,,2,1,1,2
C(C1(C)C(CC=O)OC(C1)O)(O)=O,,,5,1,1,0,1
18436_0,,,,2,1,1,2
C1(C(C)C(C(O)O1)C(CC=O)O)=O,,,5,1,2,0,2
18438_0,,,,2,1,1,2
C(C(CC1C(C)CC(O)O1)=O)(O)=O,,,5,1,1,0,1
18440_0,,,,2,1,1,2
C(C1(C=O)C(C)CC(O1)O)=O,,,5,1,1,0,1
18442_0,,,,2,1,1,2
CC(CC1C(C)CC(O)O1)O,,,5,1,1,0,1
18444_0,,,,2,1,1,2
CC1CC(O)OC1(C)CCO,,,5,1,1,0,1
18446_0,,,,2,1,1,2
C(CC1C(C)CC(O)O1)(O)=O,,,5,1,1,0,1
18448_0,,,,2,1,1,2
C(CO)(C1C(C)CC(O1)O)=O,,,5,1,1,0,1
18450_0,,,,2,1,1,2
C1C(C)CC(O)O1,,,5,1,1,0,1
18452_0,,,,2,1,1,2
C(C1(CC(CO1)C)O)(O)=O,,,5,1,1,0,1
18454_0,,,,2,1,1,2
C1(C(CC(O)O1)CCO)=O,,,5,1,2,0,2
18456_0,,,,2,1,1,2
C1(C(C)(CO)CC(O)O1)=O,,,5,1,1,0,1
18458_0,,,,2,1,1,2
C(C1(COC(C1)O)C)(O)=O,,,5,1,1,0,1
18460_0,,,,2,1,1,2
C1(C(C)C(CO)C(O)O1)=O,,,5,1,2,0,2
18462_0,,,,2,1,1,2
C1(C2(COC(C(O1)=O)(C2)O)C)=O,,,5,1,1,0,1
18463_0,,,,2,1,1,2
18465_0,,,,2,1,1,2
C1(C(CO)(C)CC(C(O)=O)(O)O1)=O,,,5,1,1,0,1
18467_0,,,,2,1,1,2
C(C1(COC(C(O)=O)(C1)O)C)(O)=O,,,5,1,1,0,1
18468_0,,,,2,1,1,2
18470_0,,,,2,1,1,2
C1(C(CC(O)O1)CCCO)=O,,,5,1,2,0,2
18472_0,,,,2,1,1,2
C1(C(C)(CC(O)O1)CCO)=O,,,5,1,1,0,1
18474_0,,,,2,1,1,2
C1(C(C)C(C(O)O1)CCO)=O,,,5,1,2,0,2
18476_0,,,,2,1,1,2
C(C(C)C1C(O)OCC1)(O)=O,,,5,1,1,0,1
18478_0,,,,2,1,1,2
C1(C(C)C2CCOC2(C(O1)=O)O)=O,,,5,1,1,0,1
18480_0,,,,2,1,1,2
CC1CC(O)OC1C,,,5,1,1,0,1
18482_0,,,,2,1,1,2
C(C1(CC(C)C(C)O1)O)(O)=O,,,5,1,1,0,1
18484_0,,,,2,1,1,2
C1(C(CC(O)O1)CC(C)O)=O,,,5,1,2,0,2
18486_0,,,,2,1,1,2
C1(C(C)(CC(O)O1)C(C)O)=O,,,5,1,1,0,1
18488_0,,,,2,1,1,2
C(C1(C)C(C)OC(C1)O)(O)=O,,,5,1,1,0,1
18490_0,,,,2,1,1,2
C1(C(C)C(C(O)O1)C(C)O)=O,,,5,1,2,0,2
18492_0,,,,2,1,1,2
C1(C2(C)CC(C(O1)=O)(O)OC2C)=O,,,5,1,1,0,1
18494_0,,,,2,1,1,2
C(CC1(C)C(C)CC(O)O1)(O)=O,,,5,1,1,0,1
18496_0,,,,2,1,1,2
C(C(C1C(C)CC(O1)O)=O)(O)=O,,,5,1,1,0,1
18498_0,,,,2,1,1,2
C1(C(CCC(O)=O)CC(O)O1)=O,,,5,1,2,0,2
18500_0,,,,2,1,1,2
C1(C(C)(CC(O)O1)CC(O)=O)=O,,,5,1,1,0,1
18502_0,,,,2,1,1,2
C1(C(C)C(C(O)O1)CC(O)=O)=O,,,5,1,2,0,2
18504_0,,,,2,1,1,2
C(C(C)C1C(O)OC(C1)=O)(O)=O,,,5,1,1,0,1
18506_0,,,,2,1,1,2
C(C(C1(C)C(C)CC(O)O1)O)(O)=O,,,5,1,1,0,1
18508_0,,,,2,1,1,2
C(C1(C(C)O)C(C)CC(O1)O)(O)=O,,,5,1,1,0,1
18510_0,,,,2,1,1,2
C(C1(C(O)=O)C(C)CC(O1)O)(O)=O,,,5,1,1,0,1
18512_0,,,,2,1,1,2
C(C1(C)C(C)CC(O1)O)(O)=O,,,5,1,1,0,1
18514_0,,,,2,1,1,2
C(C1(C=O)C(C)CC(O1)O)(O)=O,,,5,1,1,0,1
18516_0,,,,2,1,1,2
C1(C(CCC=CC=O)CC(O)O1)=O,,,5,1,2,0,2
18518_0,,,,2,1,1,2
C1(C(C)(CC(O)O1)CC=CC=O)=O,,,5,1,1,0,1
18520_0,,,,2,1,1,2
C1(C(C)C(C(O)O1)CC=CC=O)=O,,,5,1,2,0,2
18522_0,,,,2,1,1,2
C(CC(C)C1C(C(OC1O)=O)=C)=O,,,5,1,2,0,2
18524_0,,,,2,1,1,2
CC1CC(O)OC1(CO)C(C)O,,,5,1,1,0,1
18526_0,,,,2,1,1,2
CC(C(C1C(C)CC(O)O1)O)O,,,5,1,1,0,1
18528_0,,,,2,1,1,2
CC1CC(O)OC1(C)C(CO)O,,,5,1,1,0,1
18530_0,,,,2,1,1,2
C(C(C1C(C)CC(O)O1)O)(O)=O,,,5,1,1,0,1
18532_0,,,,2,1,1,2
C(C1(CO)C(C)CC(O1)O)(O)=O,,,5,1,1,0,1
18534_0,,,,2,1,1,2
C(CC1(C)C(C)CC(O)O1)=O,,,5,1,1,0,1
18536_0,,,,2,1,1,2
C(C(C1C(C)CC(O1)O)=O)=O,,,5,1,1,0,1
18538_0,,,,2,1,1,2
C(C1C(C)CC(O1)O)(O)=O,,,5,1,1,0,1
18540_0,,,,2,1,1,2
CC1CC(O)OC1CO,,,5,1,1,0,1
18542_0,,,,2,1,1,2
C(C(C=C)CC1C(OC(C1)O)=O)=O,,,5,1,2,0,2
18544_0,,,,2,1,1,2
C(C(C=C)C1(C(OC(C1)O)=O)C)=O,,,5,1,1,0,1
18546_0,,,,2,1,1,2
C1(C(C)(CC=O)C(C=C)C(O)O1)=O,,,5,1,1,0,1
18548_0,,,,2,1,1,2
C(C(C=C)C1C(O)OC(C1C)=O)=O,,,5,1,2,0,2
18550_0,,,,2,1,1,2
C(C1C(C)CC(C(O)=O)(O1)O)(O)=O,,,5,1,1,0,1
18552_0,,,,2,1,1,2
C(C1(CC(C)C(CO)O1)O)(O)=O,,,5,1,1,0,1
18554_0,,,,2,1,1,2
C1(C(CCC=O)CC(O)O1)=O,,,5,1,2,0,2
18556_0,,,,2,1,1,2
C1(C(CC(C(O)=O)O)CC(O)O1)=O,,,5,1,2,0,2
18558_0,,,,2,1,1,2
C1(C(CC(O)O1)CC(CO)O)=O,,,5,1,2,0,2
18560_0,,,,2,1,1,2
C1(C(C)(CC(O)O1)CC=O)=O,,,5,1,1,0,1
18562_0,,,,2,1,1,2
C(C1(C)CC(OC1C(O)=O)O)(O)=O,,,5,1,1,0,1
18564_0,,,,2,1,1,2
C1(C(C)(CC(O)O1)C(C(O)=O)O)=O,,,5,1,1,0,1
18566_0,,,,2,1,1,2
C(C1(C)C(CO)OC(C1)O)(O)=O,,,5,1,1,0,1
18568_0,,,,2,1,1,2
C1(C(C)(CC(O)O1)C(CO)O)=O,,,5,1,1,0,1
18570_0,,,,2,1,1,2
C1(C(C)C(C(O)O1)CC=O)=O,,,5,1,2,0,2
18572_0,,,,2,1,1,2
C(C(C)C1C(O)OC(C1O)=O)(O)=O,,,5,1,1,0,1
18574_0,,,,2,1,1,2
C1(C(C)C(C(O)O1)C(C(O)=O)O)=O,,,5,1,2,0,2
18576_0,,,,2,1,1,2
C(C(C)C1C(O)OCC1O)(O)=O,,,5,1,1,0,1
18578_0,,,,2,1,1,2
C1(C(C)C(C(O)O1)C(CO)O)=O,,,5,1,2,0,2
18580_0,,,,2,1,1,2
CC(CC1CC(CC(O)O1)O)O,,,5,1,1,0,1
18582_0,,,,2,1,1,2
C(C(C1C(O)OC(C)CC1O)O)=O,,,5,1,1,0,1
18584_0,,,,2,1,1,2
CC1CC(C(C(O)O1)CO)O,,,5,1,1,0,1
18586_0,,,,2,1,1,2
CC1C(CO)C(C(C(O)O1)CO)O,,,5,1,1,0,1
18588_0,,,,2,1,1,2
C1C(C(C)O)C(C(C(O)O1)CO)O,,,5,1,1,0,1
18590_0,,,,2,1,1,2
C=CC1C(O)OC(C)C(CO)C1O,,,5,1,1,0,1
18592_0,,,,2,1,1,2
C=CC1C(O)OCC(C1O)C(C)O,,,5,1,1,0,1
18594_0,,,,2,1,1,2
CC1C(CO)C(CC(O)O1)O,,,5,1,1,0,1
18596_0,,,,2,1,1,2
CC(C1COC(CC1O)O)O,,,5,1,1,0,1
18598_0,,,,2,1,1,2
CC(C1C(C)OC(CC1O)O)O,,,5,1,1,0,1
18600_0,,,,2,1,1,2
C(C1C(C)OC(CC1O)O)(O)=O,,,5,1,1,0,1
18601_0,,,,2,1,1,2
18603_0,,,,2,1,1,2
C(CC1CC(CC(O)O1)O)(O)=O,,,5,1,1,0,1
18605_0,,,,2,1,1,2
C1(CC(C(C(O)O1)C(C=O)O)O)=O,,,5,1,1,0,1
18607_0,,,,2,1,1,2
C1(CC(C(CO)C(O)O1)O)=O,,,5,1,1,0,1
18609_0,,,,2,1,1,2
C1(C(CO)C(C(CO)C(O)O1)O)=O,,,5,1,1,0,1
18611_0,,,,2,1,1,2
C(C1COC(C(CO)C1O)O)(O)=O,,,5,1,1,0,1
18613_0,,,,2,1,1,2
C1(C(CO)C(C(C=C)C(O)O1)O)=O,,,5,1,1,0,1
18615_0,,,,2,1,1,2
C(C1COC(C(C=C)C1O)O)(O)=O,,,5,1,1,0,1
18616_0,,,,2,1,1,2
18618_0,,,,2,1,1,2
C(C1COC(CC1O)O)(O)=O,,,5,1,1,0,1
18619_0,,,,2,1,1,2
18621_0,,,,2,1,1,2
C(CO)(C1CC(CC(O1)O)O)=O,,,5,1,1,0,1
18622_0,,,,2,1,1,2
18624_0,,,,2,1,1,2
C(C(C1C(OCC(C1O)=O)O)O)=O,,,5,1,1,0,1
18626_0,,,,2,1,1,2
C1(COC(C(CO)C1O)O)=O,,,5,1,1,0,1
18628_0,,,,2,1,1,2
C(CC1C(C(C(C(O1)O)O)O)=O)=O,,,5,1,1,0,1
18629_0,,,,2,1,1,2
18630_0,,,,2,1,1,2
18631_0,,,,2,1,1,2
18632_0,,,,2,1,1,2
18634_0,,,,2,1,1,2
C(C1(CO)CC(CC(O1)O)O)=O,,,5,1,1,0,1
18636_0,,,,2,1,1,2
C(C1C(C(O)OCC1(C=O)O)O)=O,,,5,1,1,0,1
18638_0,,,,2,1,1,2
C1(C(CO)OC(C(CO)C1O)O)=O,,,5,1,1,0,1
18640_0,,,,2,1,1,2
C1(C(C(C=C)C(OC1CO)O)O)=O,,,5,1,1,0,1
18642_0,,,,2,1,1,2
C(C1(C(COC(C1CO)O)O)O)=O,,,5,1,1,0,1
18644_0,,,,2,1,1,2
C(C1(C(COC(C1C=C)O)O)O)=O,,,5,1,1,0,1
18646_0,,,,2,1,1,2
C(C1(C(COC(C1)O)O)O)=O,,,5,1,1,0,1
18648_0,,,,2,1,1,2
C(C1(CC(O)OC(C)C1O)O)=O,,,5,1,1,0,1
18650_0,,,,2,1,1,2
C(C1(CC(O)OC(C1O)=O)O)=O,,,5,1,1,0,1
18652_0,,,,2,1,1,2
C1CC(C(C(O)O1)CO)O,,,5,1,1,0,1
18654_0,,,,2,1,1,2
C(C1(C(CO)C(CCO1)O)O)(O)=O,,,5,1,1,0,1
18656_0,,,,2,1,1,2
C(C1C(CCOC1(C(C)=O)O)O)=O,,,5,1,1,0,1
18658_0,,,,2,1,1,2
C(C(C)=O)(C1C(O)OCCC1O)=O,,,5,1,1,0,1
18660_0,,,,2,1,1,2
C(CC(C1(CC(CCO1)O)O)=O)=O,,,5,1,1,0,1
18662_0,,,,2,1,1,2
C1CC(C(C(CO)(O)O1)O)O,,,5,1,1,0,1
18664_0,,,,2,1,1,2
C(C1(C(C(CCO1)O)O)O)(O)=O,,,5,1,1,0,1
18666_0,,,,2,1,1,2
C=CC1C(O)OCCC1O,,,5,1,1,0,1
18668_0,,,,2,1,1,2
C(C1(C(C=C)C(CCO1)O)O)(O)=O,,,5,1,1,0,1
18670_0,,,,2,1,1,2
C=C(C(O)=O)C1C(O)OCCC1O,,,5,1,1,0,1
18672_0,,,,2,1,1,2
C1(C2(C(C(CCO2)O)C(C)O1)O)=O,,,5,1,1,0,1
18674_0,,,,2,1,1,2
C1(C2C(CCOC2(C(O1)=O)O)O)=O,,,5,1,1,0,1
18676_0,,,,2,1,1,2
C1CC(CC(O)O1)O,,,5,1,1,0,1
18678_0,,,,2,1,1,2
CC(C1C(O)OCCC1O)O,,,5,1,1,0,1
18680_0,,,,2,1,1,2
C(C1C(O)OCCC1O)(O)=O,,,5,1,1,0,1
18682_0,,,,2,1,1,2
C(C1(C(C(CCO1)O)O)O)=O,,,5,1,1,0,1
18684_0,,,,2,1,1,2
C(C1(CC(CCO1)O)O)(O)=O,,,5,1,1,0,1
18686_0,,,,2,1,1,2
C(C1(CCOC(C1CO)O)O)(O)=O,,,5,1,1,0,1
18688_0,,,,2,1,1,2
C(C1COC(CC1(C(C)=O)O)O)=O,,,5,1,1,0,1
18690_0,,,,2,1,1,2
C(C1COC(C(C)=O)(CC1O)O)=O,,,5,1,1,0,1
18692_0,,,,2,1,1,2
C(C1COC(C(C1O)O)O)=O,,,5,1,1,0,1
18694_0,,,,2,1,1,2
C1(C(C)(C(C(CO)C(O)O1)O)O)=O,,,5,1,1,0,1
18696_0,,,,2,1,1,2
C1(C(C(C(CO)C(O)O1)O)O)=O,,,5,1,1,0,1
18698_0,,,,2,1,1,2
C(C1(CCOC(C1C=C)O)O)(O)=O,,,5,1,1,0,1
18700_0,,,,2,1,1,2
C(C1(CC(O)OCC1)O)(O)=O,,,5,1,1,0,1
18702_0,,,,2,1,1,2
C1(C(C(CO)C(C(O)O1)O)=O)=O,,,5,1,1,0,1
18704_0,,,,2,1,1,2
C1(C(C)OC(CC1(CO)O)O)=O,,,5,1,1,0,1
18705_0,,,,2,1,1,2
18707_0,,,,2,1,1,2
C1(C(C(CO)(CC(O)O1)O)=O)=O,,,5,1,1,0,1
18708_0,,,,2,1,1,2
18710_0,,,,2,1,1,2
C1(COC(C(C1O)O)O)=O,,,5,1,1,0,1
18712_0,,,,2,1,1,2
C1(C(C(C(C(O)O1)O)O)=O)=O,,,5,1,1,0,1
18714_0,,,,2,1,1,2
C=CC1C(C(OC(C1O)O)=O)=O,,,5,1,1,0,1
18716_0,,,,2,1,1,2
C(C1C(C(OC(C1O)O)=O)=C)=O,,,5,1,1,0,1
18718_0,,,,2,1,1,2
C1(C(C(C(C(O)O1)O)C(C)O)=O)=O,,,5,1,1,0,1
18720_0,,,,2,1,1,2
C(C1C(C(O)OC(C1(C)O)=O)O)=O,,,5,1,1,0,1
18722_0,,,,2,1,1,2
C(C1C(C(OC(C1O)O)=O)=O)(O)=O,,,5,1,1,0,1
18724_0,,,,2,1,1,2
C1(C(CC(C(O)O1)O)=O)=O,,,5,1,1,0,1
18726_0,,,,2,1,1,2
C(C1C(C)OC(C(C1O)O)O)=O,,,5,1,1,0,1
18728_0,,,,2,1,1,2
C1(C(C=O)C(C(C(O)O1)O)O)=O,,,5,1,1,0,1
18730_0,,,,2,1,1,2
C(C1C(C(C(C(O1)O)=O)O)O)=O,,,5,1,1,0,1
18731_0,,,,2,1,1,2
18732_0,,,,2,1,1,2
18733_0,,,,2,1,1,2
18734_0,,,,2,1,1,2
18735_0,,,,2,1,1,2
18737_0,,,,2,1,1,2
C1(COC(C(CO)(C1O)O)O)=O,,,5,1,1,0,1
18739_0,,,,2,1,1,2
C1(C(CO)(C(C(C(O)O1)=O)O)O)=O,,,5,1,1,0,1
18740_0,,,,2,1,1,2
18741_0,,,,2,1,1,2
18742_0,,,,2,1,1,2
18743_0,,,,2,1,1,2
18745_0,,,,2,1,1,2
C1(C(C(C(C(CO)(O)O1)O)O)=O)=O,,,5,1,1,0,1
18747_0,,,,2,1,1,2
C1(C(C(C(CO)(C(O)O1)O)O)=O)=O,,,5,1,1,0,1
18749_0,,,,2,1,1,2
C1(C(C(C(C=C)C(O)O1)O)(C)O)=O,,,5,1,1,0,1
18751_0,,,,2,1,1,2
C1(C(C)(C(CC(O)O1)O)O)=O,,,5,1,1,0,1
18753_0,,,,2,1,1,2
C1(C(C(C(C=C)C(O)O1)O)O)=O,,,5,1,1,0,1
18755_0,,,,2,1,1,2
C1(C(C(CC(O)O1)O)O)=O,,,5,1,1,0,1
18757_0,,,,2,1,1,2
C1(C(C(C(C(O)O1)C(C)O)O)O)=O,,,5,1,1,0,1
18759_0,,,,2,1,1,2
C(C1C(O)OC(C(C1O)O)=O)(O)=O,,,5,1,1,0,1
18761_0,,,,2,1,1,2
C(C1C(C(C(C(O1)O)=O)O)O)(O)=O,,,5,1,1,0,1
18763_0,,,,2,1,1,2
C1(C(C(C(C(C=O)(O)O1)O)O)O)=O,,,5,1,1,0,1
18765_0,,,,2,1,1,2
C1(C(C(CC(C(O)=O)(O)O1)O)O)=O,,,5,1,1,0,1
18767_0,,,,2,1,1,2
C(C1COC(CC1(C)O)O)(O)=O,,,5,1,1,0,1
18769_0,,,,2,1,1,2
C1(C(CO)C(C)(CC(O)O1)O)=O,,,5,1,1,0,1
18770_0,,,,2,1,1,2
18771_0,,,,2,1,1,2
18772_0,,,,2,1,1,2
18773_0,,,,2,1,1,2
18774_0,,,,2,1,1,2
18776_0,,,,2,1,1,2
C1(C(CO)(O)OC(CC1O)C)=O,,,5,1,1,0,1
18778_0,,,,2,1,1,2
C1(CC(C(C(CO)(O)O1)=O)O)=O,,,5,1,1,0,1
18779_0,,,,2,1,1,2
18781_0,,,,2,1,1,2
C1(C(CO)(OCC(C1O)=O)O)=O,,,5,1,1,0,1
18782_0,,,,2,1,1,2
18784_0,,,,2,1,1,2
C1(C(O)OC(C)CC1O)=O,,,5,1,1,0,1
18786_0,,,,2,1,1,2
C1(CC(C(C(O)O1)=O)O)=O,,,5,1,1,0,1
18788_0,,,,2,1,1,2
C1(C(O)OCC(C1O)=O)=O,,,5,1,1,0,1
18789_0,,,,2,1,1,2
18790_0,,,,2,1,1,2
18791_0,,,,2,1,1,2
18792_0,,,,2,1,1,2
18793_0,,,,2,1,1,2
18795_0,,,,2,1,1,2
C1(C(CO)OC(C(C1O)=O)O)=O,,,5,1,1,0,1
18796_0,,,,2,1,1,2
18797_0,,,,2,1,1,2
18798_0,,,,2,1,1,2
18799_0,,,,2,1,1,2
18800_0,,,,2,1,1,2
18802_0,,,,2,1,1,2
C(C1(COC(C(C1O)O)O)O)(O)=O,,,5,1,1,0,1
18804_0,,,,2,1,1,2
C1(C(CO)(C(C(C(O)O1)O)O)O)=O,,,5,1,1,0,1
18806_0,,,,2,1,1,2
C1(C(C(C(C(O)O1)O)O)O)=O,,,5,1,1,0,1
18808_0,,,,2,1,1,2
CC(C1(C(O)OCCC1O)CO)O,,,5,1,1,0,1
18809_0,,,,2,1,1,2
18811_0,,,,2,1,1,2
C(C1C(CC(OC1C=O)O)O)(O)=O,,,5,1,1,0,1
18813_0,,,,2,1,1,2
C(C1(C(O)OCCC1O)CO)(O)=O,,,5,1,1,0,1
18815_0,,,,2,1,1,2
C(C1(C(CO)(C(CCO1)O)O)O)=O,,,5,1,1,0,1
18817_0,,,,2,1,1,2
C(C1(C(O)OCCC1O)O)=O,,,5,1,1,0,1
18819_0,,,,2,1,1,2
C(C1(C(O)OCCC1O)O)(O)=O,,,5,1,1,0,1
18821_0,,,,2,1,1,2
C(C1(C(O)OC(C(C1O)O)=O)O)=O,,,5,1,1,0,1
18823_0,,,,2,1,1,2
C(C1(C(O)OC(C)CC1O)O)=O,,,5,1,1,0,1
18825_0,,,,2,1,1,2
C(C1(C(O)OC(CC1O)=O)O)=O,,,5,1,1,0,1
18827_0,,,,2,1,1,2
C(C1(C(OCC(C1O)=O)O)O)=O,,,5,1,1,0,1
18829_0,,,,2,1,1,2
C(C1COC(C(C1O)O)O)(O)=O,,,5,1,1,0,1
18831_0,,,,2,1,1,2
C1(C(CO)C(C(C(O)O1)O)O)=O,,,5,1,1,0,1
18833_0,,,,2,1,1,2
C1(C(C(C)O)C(C(C(O)O1)O)O)=O,,,5,1,1,0,1
18835_0,,,,2,1,1,2
C(C1C(C)OC(C(C1O)O)O)(O)=O,,,5,1,1,0,1
18837_0,,,,2,1,1,2
C1(C(C(O)=O)C(C(C(O)O1)O)O)=O,,,5,1,1,0,1
18839_0,,,,2,1,1,2
C1(C(C=O)(C(C(C(O)O1)O)O)O)=O,,,5,1,1,0,1
18841_0,,,,2,1,1,2
C(C1(C(O)OC(C)CC1O)O)(O)=O,,,5,1,1,0,1
18843_0,,,,2,1,1,2
C(C1(C(O)OC(CC1O)=O)O)(O)=O,,,5,1,1,0,1
18845_0,,,,2,1,1,2
C(C1(C(OCC(C1O)=O)O)O)(O)=O,,,5,1,1,0,1
18847_0,,,,2,1,1,2
C1(COC(C(C1(CC=O)O)O)O)=O,,,5,1,1,0,1
18848_0,,,,2,1,1,2
18849_0,,,,2,1,1,2
18851_0,,,,2,1,1,2
C(C)(C1(CC(O)OC(C1O)=O)O)=O,,,5,1,1,0,1
18853_0,,,,2,1,1,2
C1(C(C)(C(C(O)=O)OC(C1)O)O)=O,,,5,1,1,0,1
18855_0,,,,2,1,1,2
C(C1C(CC(C(C)(O1)O)=O)O)(O)=O,,,5,1,1,0,1
18857_0,,,,2,1,1,2
C1(C(C(CC(C(C)=O)(O)O1)O)O)=O,,,5,1,1,0,1
18859_0,,,,2,1,1,2
C1(C(C)(C(C(C(O)O1)O)O)O)=O,,,5,1,1,0,1
18860_0,,,,2,1,1,2
18861_0,,,,2,1,1,2
18862_0,,,,2,1,1,2
18863_0,,,,2,1,1,2
18864_0,,,,2,1,1,2
18865_0,,,,2,1,1,2
18866_0,,,,2,1,1,2
18867_0,,,,2,1,1,2
18868_0,,,,2,1,1,2
18869_0,,,,2,1,1,2
18870_0,,,,2,1,1,2
18871_0,,,,2,1,1,2
18872_0,,,,2,1,1,2
18873_0,,,,2,1,1,2
18874_0,,,,2,1,1,2
18875_0,,,,2,1,1,2
18876_0,,,,2,1,1,2
18877_0,,,,2,1,1,2
18878_0,,,,2,1,1,2
18879_0,,,,2,1,1,2
18880_0,,,,2,1,1,2
18881_0,,,,2,1,1,2
18882_0,,,,2,1,1,2
18884_0,,,,2,1,1,2
C1(C2(CC(C(CO2)(O)O1)O)O)=O,,,5,1,2,0,2
18885_0,,,,2,1,1,2
18887_0,,,,2,1,1,2
C1(C2OC(C(CO2)(C1O)O)O)=O,,,5,1,1,0,1
18889_0,,,,2,1,1,2
C1(CC2(C(OC1(CCO2)O)=O)O)=O,,,5,1,2,0,2
18891_0,,,,2,1,1,2
C1(C2(CC(CC(C)O2)O1)O)=O,,,5,1,2,0,2
18893_0,,,,2,1,1,2
C1(CC2CC(C(O2)=O)(O)O1)=O,,,5,1,2,0,2
18895_0,,,,2,1,1,2
C1(C2(C)CC(CC(O2)O)O1)=O,,,5,1,2,0,2
18897_0,,,,2,1,1,2
C1(C2(CC(C(CO2)=O)O1)O)=O,,,5,1,2,0,2
18899_0,,,,2,1,1,2
C1(CC2(C(OC1CO2)=O)O)=O,,,5,1,2,0,2
18901_0,,,,2,1,1,2
C(C1(CO)C(C)OC(CC1C)O)=O,,,5,1,1,0,1
18903_0,,,,2,1,1,2
C(C1(COC(CC1C)O)C(C)O)=O,,,5,1,1,0,1
18905_0,,,,2,1,1,2
C(C(CO)C1CC(C)CC(O)O1)=O,,,5,1,1,0,1
18907_0,,,,2,1,1,2
C1(C(C=O)(CO)C(C)CC(O)O1)=O,,,5,1,1,0,1
18909_0,,,,2,1,1,2
C(C1(C=O)COC(CC1C)O)(O)=O,,,5,1,1,0,1
18911_0,,,,2,1,1,2
C(C(C1C(C(C)CC(O1)O)O)=O)=O,,,5,1,1,0,1
18913_0,,,,2,1,1,2
C(C(C1(COC(CC1C)O)O)=O)=O,,,5,1,1,0,1
18915_0,,,,2,1,1,2
C(C1COC(CC1C)O)=O,,,5,1,1,0,1
18917_0,,,,2,1,1,2
C(C1COC(C(O)=O)(CC1C)O)=O,,,5,1,1,0,1
18919_0,,,,2,1,1,2
C1(C(CC(CO)C(O)O1)CC=O)=O,,,5,1,1,0,1
18921_0,,,,2,1,1,2
C(C1(C)CC(O)OCC1C=O)(O)=O,,,5,1,1,0,1
18923_0,,,,2,1,1,2
C1(C(C)C(C=O)C(CO)C(O)O1)=O,,,5,1,1,0,1
18925_0,,,,2,1,1,2
C(C1CC(CC=O)OC(C1)O)(O)=O,,,5,1,1,0,1
18927_0,,,,2,1,1,2
C1(C(C)(C(CC(O)O1)O)CC=O)=O,,,5,1,1,0,1
18929_0,,,,2,1,1,2
C(C(C1COC(CC1C)O)=O)(O)=O,,,5,1,1,0,1
18931_0,,,,2,1,1,2
CC1CC(O)OCC1C(C)O,,,5,1,1,0,1
18933_0,,,,2,1,1,2
CC1CC(O)OC(C)C1CO,,,5,1,1,0,1
18935_0,,,,2,1,1,2
CC1CC(CCO)OC(C1)O,,,5,1,1,0,1
18937_0,,,,2,1,1,2
C(C1COC(CC1C)O)(O)=O,,,5,1,1,0,1
18939_0,,,,2,1,1,2
C1(C(CO)C(C)CC(O)O1)=O,,,5,1,1,0,1
18941_0,,,,2,1,1,2
C(C1CCOC(C1)O)(O)=O,,,5,1,1,0,1
18943_0,,,,2,1,1,2
C1(C2CC(C(O1)=O)(O)OCC2)=O,,,5,1,1,0,1
18945_0,,,,2,1,1,2
C(C1CC(C(O)=O)(O)OCC1)(O)=O,,,5,1,1,0,1
18947_0,,,,2,1,1,2
CC1CCOC(C1)O,,,5,1,1,0,1
18949_0,,,,2,1,1,2
C(C1(CC(C)CCO1)O)(O)=O,,,5,1,1,0,1
18951_0,,,,2,1,1,2
C(C1(C)CCOC(C1)O)(O)=O,,,5,1,1,0,1
18953_0,,,,2,1,1,2
C1(C2(C)CC(C(O1)=O)(O)OCC2)=O,,,5,1,1,0,1
18955_0,,,,2,1,1,2
C(C1CC(O)OC(C)C1)(O)=O,,,5,1,1,0,1
18957_0,,,,2,1,1,2
C1(C2CC(C(O1)=O)(O)OC(C)C2)=O,,,5,1,1,0,1
18959_0,,,,2,1,1,2
C1(C(C(C)O)C(C)CC(O)O1)=O,,,5,1,1,0,1
18961_0,,,,2,1,1,2
C(C1C(C)OC(CC1C)O)(O)=O,,,5,1,1,0,1
18963_0,,,,2,1,1,2
C(CC1CC(C)CC(O)O1)(O)=O,,,5,1,1,0,1
18965_0,,,,2,1,1,2
C1(C(C(O)=O)C(C)CC(O)O1)=O,,,5,1,1,0,1
18967_0,,,,2,1,1,2
C1(CC(C)CC(O)O1)=O,,,5,1,1,0,1
18969_0,,,,2,1,1,2
C1(CC(C)CC(C(O)=O)(O)O1)=O,,,5,1,1,0,1
18971_0,,,,2,1,1,2
C(C1(C)CC(O)OC(C1)=O)(O)=O,,,5,1,1,0,1
18973_0,,,,2,1,1,2
C(C(C1CC(C)CC(O)O1)O)(O)=O,,,5,1,1,0,1
18975_0,,,,2,1,1,2
C(C1C(C)(C(C)CC(O1)O)O)(O)=O,,,5,1,1,0,1
18977_0,,,,2,1,1,2
C(C1(C(C)OC(CC1C)O)O)(O)=O,,,5,1,1,0,1
18979_0,,,,2,1,1,2
C1(C(C(C)O)(C(C)CC(O)O1)O)=O,,,5,1,1,0,1
18981_0,,,,2,1,1,2
C1(C(C(O)=O)(C(C)CC(O)O1)O)=O,,,5,1,1,0,1
18983_0,,,,2,1,1,2
C(C1CC(C)CC(O1)O)(O)=O,,,5,1,1,0,1
18985_0,,,,2,1,1,2
C1(C(C)(C(C)CC(O)O1)O)=O,,,5,1,1,0,1
18987_0,,,,2,1,1,2
C(C1(C=O)CC(C)CC(O1)O)(O)=O,,,5,1,1,0,1
18989_0,,,,2,1,1,2
C1(C(C=O)(C(C)CC(O)O1)O)=O,,,5,1,1,0,1
18991_0,,,,2,1,1,2
C1C(C(C)O)(C(C)CC(O)O1)O,,,5,1,1,0,1
18993_0,,,,2,1,1,2
CC1CC(O)OC(C)C1(CO)O,,,5,1,1,0,1
18995_0,,,,2,1,1,2
CC(C1C(C(C)CC(O)O1)O)O,,,5,1,1,0,1
18997_0,,,,2,1,1,2
CC1CC(C(CO)O)OC(C1)O,,,5,1,1,0,1
18999_0,,,,2,1,1,2
CC1(C(CO)OC(CC1C)O)O,,,5,1,1,0,1
19001_0,,,,2,1,1,2
C(C1C(C(C)CC(O1)O)O)(O)=O,,,5,1,1,0,1
19003_0,,,,2,1,1,2
C(C1(COC(CC1C)O)O)(O)=O,,,5,1,1,0,1
19005_0,,,,2,1,1,2
C1(C(CO)(C(C)CC(O)O1)O)=O,,,5,1,1,0,1
19007_0,,,,2,1,1,2
C(C1C(C)OC(CC1C)O)=O,,,5,1,1,0,1
19009_0,,,,2,1,1,2
C(CC1CC(C)CC(O)O1)=O,,,5,1,1,0,1
19011_0,,,,2,1,1,2
C1(C(C=O)C(C)CC(O)O1)=O,,,5,1,1,0,1
19013_0,,,,2,1,1,2
C1(C(C(C)CC(O)O1)O)=O,,,5,1,1,0,1
19015_0,,,,2,1,1,2
C1C(C(C)CC(O)O1)O,,,5,1,1,0,1
19017_0,,,,2,1,1,2
C1(C(CC(C=C)C(O)O1)CC=O)=O,,,5,1,1,0,1
19019_0,,,,2,1,1,2
C1(C(C)C(C=O)C(C=C)C(O)O1)=O,,,5,1,1,0,1
19021_0,,,,2,1,1,2
C1(C(C(C)CC(C(O)=O)(O)O1)O)=O,,,5,1,1,0,1
19023_0,,,,2,1,1,2
C(C1(CC(C)C(CO1)O)O)(O)=O,,,5,1,1,0,1
19025_0,,,,2,1,1,2
C1(C(CCC(O)O1)CC=O)=O,,,5,1,1,0,1
19027_0,,,,2,1,1,2
C(C1CC(C(O)=O)OC(C1)O)(O)=O,,,5,1,1,0,1
19029_0,,,,2,1,1,2
C(C1CC(O)OC(C1)CO)(O)=O,,,5,1,1,0,1
19031_0,,,,2,1,1,2
C(C1(C)CC(O)OC(C1O)=O)(O)=O,,,5,1,1,0,1
19033_0,,,,2,1,1,2
C(C1(C)CC(O)OCC1O)(O)=O,,,5,1,1,0,1
19035_0,,,,2,1,1,2
C1(C(C)C(C=O)CC(O)O1)=O,,,5,1,1,0,1
19037_0,,,,2,1,1,2
C(C1C(C(O)OC(C)CC1O)O)=O,,,5,1,1,0,1
19039_0,,,,2,1,1,2
C(C1C(CC(OC(C1O)O)=O)O)=O,,,5,1,1,0,1
19041_0,,,,2,1,1,2
C(C1C(C(OCC(C1O)=O)O)O)=O,,,5,1,1,0,1
19043_0,,,,2,1,1,2
C1(C(C(C=O)OC(CC1O)O)O)=O,,,5,1,1,0,1
19045_0,,,,2,1,1,2
C1(C(CC(O)OC(C)C1O)O)=O,,,5,1,1,0,1
19047_0,,,,2,1,1,2
C1(C(C(C(CC(O)O1)O)=O)O)=O,,,5,1,1,0,1
19049_0,,,,2,1,1,2
C1(C(CC(O)OCC1O)O)=O,,,5,1,1,0,1
19051_0,,,,2,1,1,2
C(C1(COC(CC(C1)O)O)O)=O,,,5,1,1,0,1
19053_0,,,,2,1,1,2
C1(C(C(C(O)OCC1O)CO)O)=O,,,5,1,1,0,1
19055_0,,,,2,1,1,2
C1(C(C(C=C)C(O)OCC1O)O)=O,,,5,1,1,0,1
19057_0,,,,2,1,1,2
C(C1C(C(C)(O)OCCC1O)=O)=O,,,5,1,1,0,1
19059_0,,,,2,1,1,2
C1(C(CC(O)OC(CCO)C1)=O)=O,,,5,1,1,0,1
19061_0,,,,2,1,1,2
C(CC1(C(CC(CCO1)O)=O)O)=O,,,5,1,1,0,1
19063_0,,,,2,1,1,2
C1(C(O)OCCC(C1O)O)=O,,,5,1,1,0,1
19065_0,,,,2,1,1,2
C(C1COC(CC(C1(C)O)=O)O)=O,,,5,1,1,0,1
19067_0,,,,2,1,1,2
C(C1C(CC(C(C)(O)OC1)=O)O)=O,,,5,1,1,0,1
19069_0,,,,2,1,1,2
C=C1C(OC(C(CO)C(C1)O)O)=O,,,5,1,1,0,1
19071_0,,,,2,1,1,2
C(C1CC(C(CC(O1)O)=O)=O)=O,,,5,1,1,0,1
19073_0,,,,2,1,1,2
C(C)=CC1CC(C(CC(O1)O)=O)=O,,,5,1,1,0,1
19075_0,,,,2,1,1,2
C=CCC1CC(C(CC(O)O1)=O)=O,,,5,1,1,0,1
19076_0,,,,2,1,1,2
19077_0,,,,2,1,1,2
19079_0,,,,2,1,1,2
C1(C(CC(O)OCC1)=O)=O,,,5,1,1,0,1
19081_0,,,,2,1,1,2
C1(C(C(C)OC(C(C1O)O)O)=O)=O,,,5,1,1,0,1
19083_0,,,,2,1,1,2
C1(C(C(C(C(C(O)O1)O)O)=O)=O)=O,,,5,1,1,0,1
19085_0,,,,2,1,1,2
C(C1C(CC(C(O)OC1)O)=O)(O)=O,,,5,1,1,0,1
19087_0,,,,2,1,1,2
C1(C(C(CC(C(O)O1)O)=O)CO)=O,,,5,1,1,0,1
19089_0,,,,2,1,1,2
C1(COC(C(C(C1O)O)O)O)=O,,,5,1,1,0,1
19091_0,,,,2,1,1,2
C1(C(C(C(C(C(O)O1)O)O)O)=O)=O,,,5,1,1,0,1
19093_0,,,,2,1,1,2
C1(C(CC(C(C(O)O1)O)O)=O)=O,,,5,1,1,0,1
19095_0,,,,2,1,1,2
C1(C(C(C(C(C(O)O1)=O)O)O)O)=O,,,5,1,1,0,1
19097_0,,,,2,1,1,2
C(C1C(O)OC(C(CC1O)=C)=O)=C,,,5,1,1,0,1
19098_0,,,,2,1,1,2
19099_0,,,,2,1,1,2
19100_0,,,,2,1,1,2
19101_0,,,,2,1,1,2
19102_0,,,,2,1,1,2
19103_0,,,,2,1,1,2
19105_0,,,,2,1,1,2
C1(C(O)OCCC(C1(CO)O)O)=O,,,5,1,1,0,1
19107_0,,,,2,1,1,2
C1(C(C)(C(C(OC(C1)O)=O)O)O)=O,,,5,1,1,0,1
19109_0,,,,2,1,1,2
C1(C(C(CC(C(C)(O)O1)=O)O)O)=O,,,5,1,1,0,1
19111_0,,,,2,1,1,2
C1(C(COC(C(C1(C)O)O)O)=O)=O,,,5,1,1,0,1
19112_0,,,,2,1,1,2
19113_0,,,,2,1,1,2
19114_0,,,,2,1,1,2
19115_0,,,,2,1,1,2
19116_0,,,,2,1,1,2
19117_0,,,,2,1,1,2
19119_0,,,,2,1,1,2
C1(CC(O)OC(C(C1)=O)=O)=O,,,5,1,1,0,1
19120_0,,,,2,1,1,2
19122_0,,,,2,1,1,2
C(C1C(C)OC(CC(C)C1O)O)=O,,,5,1,1,0,1
19124_0,,,,2,1,1,2
C(C1COC(CC(C)C1(C)O)O)=O,,,5,1,1,0,1
19126_0,,,,2,1,1,2
C1(C(C=O)C(C(C)CC(O)O1)O)=O,,,5,1,1,0,1
19128_0,,,,2,1,1,2
C1(C(CC(C)C(CO)C(O)O1)=O)=O,,,5,1,1,0,1
19130_0,,,,2,1,1,2
C(C1CC(C=O)COC(C1)O)(O)=O,,,5,1,1,0,1
19132_0,,,,2,1,1,2
C1(C(CC(CC(O)O1)O)CC=O)=O,,,5,1,1,0,1
19134_0,,,,2,1,1,2
C1(C(C)C(C=O)C(CC(O)O1)O)=O,,,5,1,1,0,1
19136_0,,,,2,1,1,2
C1(C(C(CO)C(C)CC(O)O1)=O)=O,,,5,1,1,0,1
19138_0,,,,2,1,1,2
CC1CC(C(C)CC(O)O1)O,,,5,1,1,0,1
19140_0,,,,2,1,1,2
CC1(CCOC(CC1C)O)O,,,5,1,1,0,1
19142_0,,,,2,1,1,2
C1(CC(C(C)CC(O)O1)O)=O,,,5,1,1,0,1
19144_0,,,,2,1,1,2
C1(COC(CC(C)C1O)O)=O,,,5,1,1,0,1
19146_0,,,,2,1,1,2
C(C1CC(O)OCCC1)(O)=O,,,5,1,1,0,1
19148_0,,,,2,1,1,2
C1(C2CC(C(O1)=O)(O)OCCC2)=O,,,5,1,1,0,1
19150_0,,,,2,1,1,2
C1(CC(C)(C(C)CC(O)O1)O)=O,,,5,1,1,0,1
19152_0,,,,2,1,1,2
C1(C(C(C(C)CC(O)O1)O)=O)=O,,,5,1,1,0,1
19154_0,,,,2,1,1,2
C(C1CCC(OC(C1)O)=O)(O)=O,,,5,1,1,0,1
19156_0,,,,2,1,1,2
C(C1C(CC(C)CC(O1)O)O)(O)=O,,,5,1,1,0,1
19158_0,,,,2,1,1,2
C1(C(C(C)(C(C)CC(O)O1)O)O)=O,,,5,1,1,0,1
19160_0,,,,2,1,1,2
C1(C(CC(C)CC(O)O1)O)=O,,,5,1,1,0,1
19162_0,,,,2,1,1,2
C1(C(C=O)(CC(C)CC(O)O1)O)=O,,,5,1,1,0,1
19164_0,,,,2,1,1,2
C=CC1C(C(OC(CC1C)O)=O)=O,,,5,1,1,0,1
19166_0,,,,2,1,1,2
C(C1C(C(OC(CC1C)O)=O)=C)=O,,,5,1,1,0,1
19168_0,,,,2,1,1,2
C1(C(CC(C)CC(O)O1)=CC=O)=O,,,5,1,1,0,1
19170_0,,,,2,1,1,2
CC1C(C(C(C)CC(O)O1)O)O,,,5,1,1,0,1
19172_0,,,,2,1,1,2
CC1CC(C(CO)OC(C1)O)O,,,5,1,1,0,1
19174_0,,,,2,1,1,2
C1C(C(C)(C(C)CC(O)O1)O)O,,,5,1,1,0,1
19176_0,,,,2,1,1,2
C1(C(C(C(C)CC(O)O1)O)O)=O,,,5,1,1,0,1
19178_0,,,,2,1,1,2
C1(C(CC(C)CC(O)O1)=O)=O,,,5,1,1,0,1
19180_0,,,,2,1,1,2
C(C1C(O)OC(C(CC1C)=O)=O)=C,,,5,1,1,0,1
19182_0,,,,2,1,1,2
C(C1CC(C(OC(C1)O)=O)O)(O)=O,,,5,1,1,0,1
19184_0,,,,2,1,1,2
C(C1CC(O)OCC(C1)O)(O)=O,,,5,1,1,0,1
19185_0,,,,2,1,1,2
19185_1,,,,2,1,1,2
19186_0,,,,2,1,1,2
19187_0,,,,2,1,1,2
19188_0,,,,2,1,1,2
19189_0,,,,2,1,1,2
19190_0,,,,2,1,1,2
19191_0,,,,2,1,1,2
19192_0,,,,2,1,1,2
19193_0,,,,2,1,1,2
19194_0,,,,2,1,1,2
19195_0,,,,2,1,1,2
19196_0,,,,2,1,1,2
19197_0,,,,2,1,1,2
19198_0,,,,2,1,1,2
19199_0,,,,2,1,1,2
19200_0,,,,2,1,1,2
19201_0,,,,2,1,1,2
19202_0,,,,2,1,1,2
19203_0,,,,2,1,1,2
19204_0,,,,2,1,1,2
19205_0,,,,2,1,1,2
19206_0,,,,2,1,1,2
19207_0,,,,2,1,1,2
19208_0,,,,2,1,1,2
19209_0,,,,2,1,1,2
19210_0,,,,2,1,1,2
19211_0,,,,2,1,1,2
19212_0,,,,2,1,1,2
19213_0,,,,2,1,1,2
19214_0,,,,2,1,1,2
19215_0,,,,2,1,1,2
19216_0,,,,2,1,1,2
19217_0,,,,2,1,1,2
19218_0,,,,2,1,1,2
19219_0,,,,2,1,1,2
19220_0,,,,2,1,1,2
19221_0,,,,2,1,1,2
19222_0,,,,2,1,1,2
19223_0,,,,2,1,1,2
19224_0,,,,2,1,1,2
19225_0,,,,2,1,1,2
19226_0,,,,2,1,1,2
19227_0,,,,2,1,1,2
19228_0,,,,2,1,1,2
19229_0,,,,2,1,1,2
19230_0,,,,2,1,1,2
19231_0,,,,2,1,1,2
19232_0,,,,2,1,1,2
19233_0,,,,2,1,1,2
19234_0,,,,2,1,1,2
19235_0,,,,2,1,1,2
19236_0,,,,2,1,1,2
19237_0,,,,2,1,1,2
19238_0,,,,2,1,1,2
19239_0,,,,2,1,1,2
19240_0,,,,2,1,1,2
19241_0,,,,2,1,1,2
19242_0,,,,2,1,1,2
19243_0,,,,2,1,1,2
19244_0,,,,2,1,1,2
19245_0,,,,2,1,1,2
19246_0,,,,2,1,1,2
19247_0,,,,2,1,1,2
19248_0,,,,2,1,1,2
19249_0,,,,2,1,1,2
19250_0,,,,2,1,1,2
19251_0,,,,2,1,1,2
19252_0,,,,2,1,1,2
19253_0,,,,2,1,1,2
19254_0,,,,2,1,1,2
19255_0,,,,2,1,1,2
19256_0,,,,2,1,1,2
19257_0,,,,2,1,1,2
19258_0,,,,2,1,1,2
19259_0,,,,2,1,1,2
19260_0,,,,2,1,1,2
19261_0,,,,2,1,1,2
19262_0,,,,2,1,1,2
19263_0,,,,2,1,1,2
19264_0,,,,2,1,1,2
19265_0,,,,2,1,1,2
19266_0,,,,2,1,2,3
19267_0,,,,2,1,2,3
19268_0,,,,2,1,2,3
19269_0,,,,2,1,2,3
19270_0,,,,2,1,2,3
19271_0,,,,2,1,2,3
19272_0,,,,2,1,2,3
19273_0,,,,2,1,2,3
19274_0,,,,2,1,2,3
19275_0,,,,2,1,2,3
19276_0,,,,2,1,2,3
19277_0,,,,2,1,2,3
19278_0,,,,2,1,2,3
19279_0,,,,2,1,2,3
19280_0,,,,2,1,2,3
19281_0,,,,2,1,2,3
19282_0,,,,2,1,2,3
19283_0,,,,2,1,2,3
19284_0,,,,2,1,2,3
19285_0,,,,2,1,2,3
19286_0,,,,2,1,2,3
19287_0,,,,2,1,2,3
19288_0,,,,2,1,2,3
19289_0,,,,2,1,2,3
19290_0,,,,2,1,2,3
19291_0,,,,2,1,2,3
19292_0,,,,2,1,2,3
19293_0,,,,2,1,2,3
19294_0,,,,2,1,2,3
19295_0,,,,2,1,2,3
19296_0,,,,2,1,2,3
19297_0,,,,2,1,2,3
19298_0,,,,2,1,2,3
19299_0,,,,2,1,2,3
19300_0,,,,2,1,2,3
19301_0,,,,2,1,2,3
19302_0,,,,2,1,2,3
19303_0,,,,2,1,2,3
19304_0,,,,2,1,2,3
19305_0,,,,2,1,2,3
19306_0,,,,2,1,2,3
19307_0,,,,2,1,2,3
19308_0,,,,2,1,2,3
19309_0,,,,2,1,2,3
19310_0,,,,2,1,2,3
19312_0,,,,2,1,2,3
C(CCC(C)O)=O,,,5,1,2,0,2
19314_0,,,,2,1,2,3
C(CCC(O)=O)=O,,,5,1,5,0,5
19315_0,,,,2,1,2,3
19317_0,,,,2,1,2,3
C(CC)=O,,,5,1,3,0,3
19318_0,,,,2,1,2,3
19319_0,,,,2,1,2,3
19320_0,,,,2,1,2,3
19321_0,,,,2,1,2,3
19322_0,,,,2,1,2,3
19323_0,,,,2,1,2,3
19324_0,,,,2,1,2,3
19325_0,,,,2,1,2,3
19326_0,,,,2,1,2,3
19327_0,,,,2,1,2,3
19328_0,,,,2,1,2,3
19329_0,,,,2,1,2,3
19330_0,,,,2,1,2,3
19331_0,,,,2,1,2,3
19332_0,,,,2,1,2,3
19333_0,,,,2,1,2,3
19334_0,,,,2,1,2,3
19335_0,,,,2,1,2,3
19336_0,,,,2,1,2,3
19337_0,,,,2,1,2,3
19338_0,,,,2,1,2,3
19339_0,,,,2,1,2,3
19340_0,,,,2,1,2,3
19341_0,,,,2,1,2,3
19342_0,,,,2,1,2,3
19343_0,,,,2,1,2,3
19344_0,,,,2,1,2,3
19345_0,,,,2,1,2,3
19346_0,,,,2,1,2,3
19347_0,,,,2,1,2,3
19348_0,,,,2,1,2,3
19349_0,,,,2,1,2,3
19350_0,,,,2,1,2,3
19351_0,,,,2,1,2,3
19352_0,,,,2,1,2,3
19353_0,,,,2,1,2,3
19354_0,,,,2,1,2,3
19355_0,,,,2,1,2,3
19356_0,,,,2,1,2,3
19357_0,,,,2,1,2,3
19358_0,,,,2,1,2,3
19359_0,,,,2,1,2,3
19360_0,,,,2,1,2,3
19361_0,,,,2,1,2,3
19362_0,,,,2,1,2,3
19363_0,,,,2,1,2,3
19364_0,,,,2,1,2,3
19365_0,,,,2,1,2,3
19366_0,,,,2,1,2,3
19367_0,,,,2,1,2,3
19368_0,,,,2,1,2,3
19369_0,,,,2,1,2,3
19370_0,,,,2,1,2,3
19371_0,,,,2,1,2,3
19372_0,,,,2,1,2,3
19373_0,,,,2,1,2,3
19374_0,,,,2,1,2,3
19375_0,,,,2,1,2,3
19376_0,,,,2,1,2,3
19377_0,,,,2,1,2,3
19378_0,,,,2,1,2,3
19378_1,,,,2,1,2,3
19379_0,,,,2,1,2,3
19380_0,,,,2,1,2,3
19380_1,,,,2,1,2,3
19381_0,,,,2,1,2,3
19381_1,,,,2,1,2,3
19383_0,,,,2,1,2,3
C1(C(C(C(CC=O)O1)=O)O)=O,,,5,1,1,0,1
19384_0,,,,2,1,2,3
19386_0,,,,2,1,2,3
C1(C(C(CO)C(CCO)O1)=O)=O,,,5,1,1,0,1
19388_0,,,,2,1,2,3
C1(C(C(C(CCO)O1)O)=O)=O,,,5,1,1,0,1
19390_0,,,,2,1,2,3
C=CC1C(C(OC1CCO)=O)=O,,,5,1,1,0,1
19392_0,,,,2,1,2,3
C(C1C(C(OC1CCO)=O)=C)=O,,,5,1,1,0,1
19394_0,,,,2,1,1,2
C1(C(C(C(CCO)O1)C(C)O)=O)=O,,,5,1,1,0,1
19396_0,,,,2,1,1,2
C(C1C(C(OC1CCO)=O)=O)(O)=O,,,5,1,1,0,1
19398_0,,,,2,1,2,3
C1(C(CC(CCO)O1)=O)=O,,,5,1,1,0,1
19399_0,,,,2,1,2,3
19401_0,,,,2,1,2,3
C(C1COC(C1(CCO)O)=O)=O,,,5,1,1,0,1
19403_0,,,,2,1,2,3
C(C1COC(C1(CO)O)=O)=O,,,5,1,1,0,1
19405_0,,,,2,1,2,3
C(C1COC(C1(C=CC)O)=O)=O,,,5,1,1,0,1
19407_0,,,,2,1,2,3
C(C1COC(C1(CC=C)O)=O)=O,,,5,1,1,0,1
19409_0,,,,2,1,2,3
C(C(C1CC(C(O1)=O)=C)CO)=O,,,5,1,1,0,1
19411_0,,,,2,1,1,2
C(C1COC(C1(CC(C)O)O)=O)=O,,,5,1,1,0,1
19413_0,,,,2,1,1,2
C(CC1(C(OCC1C=O)=O)O)(O)=O,,,5,1,1,0,1
19414_0,,,,2,1,2,3
19415_0,,,,2,1,2,3
19417_0,,,,2,1,2,3
C(C1C(C(C(O1)=O)=O)CO)=O,,,5,1,1,0,1
19418_0,,,,2,1,2,3
19420_0,,,,2,1,2,3
C(C)=CC1C(C(C(O1)=O)=O)CO,,,5,1,1,0,1
19421_0,,,,2,1,2,3
19423_0,,,,2,1,2,3
C=CCC1C(C(C(O1)=O)=O)CO,,,5,1,1,0,1
19424_0,,,,2,1,2,3
19425_0,,,,2,1,2,3
19426_0,,,,2,1,2,3
19427_0,,,,2,1,2,3
19428_0,,,,2,1,2,3
19429_0,,,,2,1,2,3
19430_0,,,,2,1,2,3
19431_0,,,,2,1,2,3
19433_0,,,,2,1,2,3
C(C1C(C(C(O1)=O)=O)O)=O,,,5,1,1,0,1
19435_0,,,,2,1,2,3
C(C1C(C=C)C(C(O1)=O)=O)=O,,,5,1,1,0,1
19437_0,,,,2,1,2,3
C(C1C(C(OC1C=O)=O)=C)=O,,,5,1,1,0,1
19439_0,,,,2,1,1,2
C(C1C(C(C(O1)=O)=O)C(C(O)=O)=C)=O,,,5,1,1,0,1
19441_0,,,,2,1,1,2
C(C1C(C(C(O)=O)=O)C(C(O1)=O)=C)=O,,,5,1,1,0,1
19443_0,,,,2,1,1,2
C(C1C(C(C(O1)=O)=O)C(C)O)=O,,,5,1,2,0,2
19445_0,,,,2,1,1,2
C(C1C(C(OC1C=O)=O)=O)(O)=O,,,5,1,2,0,2
19446_0,,,,2,1,2,3
19447_0,,,,2,1,2,3
19449_0,,,,2,1,2,3
C1(C(C)(C(C=O)C(C=O)O1)O)=O,,,5,1,1,0,1
19450_0,,,,2,1,2,3
19451_0,,,,2,1,2,3
19452_0,,,,2,1,2,3
19453_0,,,,2,1,2,3
19455_0,,,,2,1,2,3
C(C(C1C(C(C(O1)=O)=O)O)O)=O,,,5,1,1,0,1
19456_0,,,,2,1,2,3
19457_0,,,,2,1,2,3
19459_0,,,,2,1,2,3
C1(C(C(C(CO)(CO)O1)O)=O)=O,,,5,1,1,0,1
19460_0,,,,2,1,2,3
19461_0,,,,2,1,2,3
19462_0,,,,2,1,2,3
19464_0,,,,2,1,2,3
C1(C(C(CO1)=O)O)=O,,,5,1,1,0,1
19465_0,,,,2,1,2,3
19467_0,,,,2,1,2,3
C(C1C(C)OC(C1(CO)O)=O)=O,,,5,1,1,0,1
19468_0,,,,2,1,2,3
19470_0,,,,2,1,2,3
C1(C(C=O)C(C(O1)=O)(CO)O)=O,,,5,1,1,0,1
19471_0,,,,2,1,2,3
19473_0,,,,2,1,2,3
C(C1C(C(C(O1)=O)=O)O)=CC,,,5,1,1,0,1
19475_0,,,,2,1,2,3
C(CC1C(C(C(O1)=O)=O)O)=C,,,5,1,1,0,1
19477_0,,,,2,1,2,3
C1(C(C(C(C)O1)O)=O)=O,,,5,1,1,0,1
19479_0,,,,2,1,2,3
C1(C(C(C(O1)=O)=O)O)=O,,,5,1,1,0,1
19481_0,,,,2,1,2,3
C1(C(C(C(CC(C)O)O1)O)=O)=O,,,5,1,1,0,1
19482_0,,,,2,1,2,3
19484_0,,,,2,1,2,3
C(CC1C(C(C(O1)=O)=O)O)(O)=O,,,5,1,1,0,1
19486_0,,,,2,1,2,3
C(CO)(C1C(C(C(O1)=O)=O)O)=O,,,5,1,1,0,1
19488_0,,,,2,1,2,3
C(C1(CO)C(C(C(O1)=O)=O)O)=O,,,5,1,1,0,1
19490_0,,,,2,1,2,3
C1(C(C(CO1)O)=O)=O,,,5,1,1,0,1
19492_0,,,,2,1,2,3
C(C1(C)C(C(C(O1)=O)=O)O)(O)=O,,,5,1,1,0,1
19494_0,,,,2,1,2,3
C1(C(C=O)C(C(C(O)=O)O1)O)=O,,,5,1,1,0,1
19496_0,,,,2,1,2,3
C1(C(C(C(C(C=O)=O)O1)O)O)=O,,,5,1,1,0,1
19498_0,,,,2,1,2,3
C(C(C1CC(C(O1)=O)=O)O)(O)=O,,,5,1,1,0,1
19500_0,,,,2,1,2,3
C=CC1C(C(OC1C=CC)=O)=O,,,5,1,1,0,1
19502_0,,,,2,1,2,3
C(C1C(C(OC1C=CC)=O)=C)=O,,,5,1,1,0,1
19504_0,,,,2,1,1,2
C(C)=CC1C(C(C(O1)=O)=O)C(C)O,,,5,1,1,0,1
19506_0,,,,2,1,1,2
C(C1C(C(OC1C=CC)=O)=O)(O)=O,,,5,1,1,0,1
19507_0,,,,2,1,2,3
19509_0,,,,2,1,2,3
C=CC1C(C(OC1CC=C)=O)=O,,,5,1,1,0,1
19511_0,,,,2,1,2,3
C(C1C(C(OC1CC=C)=O)=C)=O,,,5,1,1,0,1
19513_0,,,,2,1,1,2
C=CCC1C(C(C(O1)=O)=O)C(C)O,,,5,1,1,0,1
19515_0,,,,2,1,1,2
C(C1C(C(OC1CC=C)=O)=O)(O)=O,,,5,1,1,0,1
19516_0,,,,2,1,2,3
19518_0,,,,2,1,2,3
C(C(C=C)C1CC(C(O1)=O)=C)=O,,,5,1,1,0,1
19519_0,,,,2,1,2,3
19520_0,,,,2,1,2,3
19521_0,,,,2,1,2,3
19522_0,,,,2,1,2,3
19523_0,,,,2,1,2,3
19524_0,,,,2,1,2,3
19525_0,,,,2,1,2,3
19527_0,,,,2,1,1,2
C(CC1(C(O)=O)CC(C(O1)=O)=C)=O,,,5,1,1,0,1
19529_0,,,,2,1,1,2
C=C(C(O)=O)C1C(C(OC1C)=O)=O,,,5,1,1,0,1
19531_0,,,,2,1,1,2
C=C1C(OC(C)C1C(C(O)=O)=O)=O,,,5,1,1,0,1
19533_0,,,,2,1,1,2
C1(C(C(C(O1)=O)=O)C(C(O)=O)=C)=O,,,5,1,1,0,1
19535_0,,,,2,1,1,2
C1(C(C(C(O)=O)=O)C(C(O1)=O)=C)=O,,,5,1,1,0,1
19536_0,,,,2,1,1,2
19537_0,,,,2,1,1,2
19538_0,,,,2,1,1,2
19539_0,,,,2,1,1,2
19540_0,,,,2,1,1,2
19541_0,,,,2,1,1,2
19542_0,,,,2,1,1,2
19543_0,,,,2,1,1,2
19544_0,,,,2,1,2,3
19545_0,,,,2,1,2,3
19546_0,,,,2,1,2,3
19547_0,,,,2,1,2,3
19548_0,,,,2,1,2,3
19549_0,,,,2,1,2,3
19550_0,,,,2,1,2,3
19551_0,,,,2,1,2,3
19552_0,,,,2,1,2,3
19553_0,,,,2,1,2,3
19554_0,,,,2,1,2,3
19555_0,,,,2,1,2,3
19556_0,,,,2,1,2,3
19557_0,,,,2,1,2,3
19559_0,,,,2,1,2,3
C1(C(C)(C(CO1)C(C)O)O)=O,,,5,1,1,0,1
19560_0,,,,2,1,2,3
19562_0,,,,2,1,2,3
C1(C(CCO1)(CC(C)O)O)=O,,,5,1,1,0,1
19563_0,,,,2,1,2,3
19564_0,,,,2,1,2,3
19565_0,,,,2,1,2,3
19566_0,,,,2,1,2,3
19567_0,,,,2,1,2,3
19568_0,,,,2,1,2,3
19570_0,,,,2,1,2,3
C1(C(CCO1)(CC(O)=O)O)=O,,,5,1,1,0,1
19571_0,,,,2,1,2,3
19572_0,,,,2,1,2,3
19573_0,,,,2,1,2,3
19574_0,,,,2,1,2,3
19576_0,,,,2,1,2,3
C1(C(C(C)O)C(C=O)(CO1)O)=O,,,5,1,1,0,1
19577_0,,,,2,1,2,3
19578_0,,,,2,1,2,3
19580_0,,,,2,1,2,3
C1(C(CC(C)O)(CC(O1)=O)O)=O,,,5,1,1,0,1
19581_0,,,,2,1,2,3
19582_0,,,,2,1,2,3
19583_0,,,,2,1,2,3
19584_0,,,,2,1,2,3
19585_0,,,,2,1,2,3
19587_0,,,,2,1,2,3
C(C1(COC(C1)=O)O)=O,,,5,1,1,0,1
19588_0,,,,2,1,2,3
19589_0,,,,2,1,2,3
19590_0,,,,2,1,2,3
19591_0,,,,2,1,2,3
19592_0,,,,2,1,2,3
19593_0,,,,2,1,2,3
19594_0,,,,2,1,2,3
19595_0,,,,2,1,2,3
19597_0,,,,2,1,2,3
C(C1(C=O)C(C(C(O1)=O)O)O)=O,,,5,1,1,0,1
19599_0,,,,2,1,2,3
C(C1(C=O)C(CC(O1)=O)O)=O,,,5,1,1,0,1
19601_0,,,,2,1,2,3
C1(C(CO)C(C(C=O)O1)O)=O,,,5,1,1,0,1
19603_0,,,,2,1,2,3
C1(C(C(C(C=O)O1)O)C(C)O)=O,,,5,1,1,0,1
19605_0,,,,2,1,2,3
C(C1C(OC(C=O)C1O)=O)(O)=O,,,5,1,1,0,1
19607_0,,,,2,1,2,3
C1(C(C=O)(C(C(C=O)O1)O)O)=O,,,5,1,1,0,1
19609_0,,,,2,1,2,3
C1(C(CO)C(CO1)(CO)O)=O,,,5,1,1,0,1
19610_0,,,,2,1,2,3
19612_0,,,,2,1,2,3
C(C1COC(C1(CO)O)=O)(O)=O,,,5,1,1,0,1
19613_0,,,,2,1,2,3
19614_0,,,,2,1,2,3
19616_0,,,,2,1,2,3
C1(C(C(C)O)C(CO1)(CO)O)=O,,,5,1,1,0,1
19618_0,,,,2,1,2,3
C1(C(C(O)=O)C(CO1)(CO)O)=O,,,5,1,1,0,1
19620_0,,,,2,1,2,3
C1(C(C=O)(C(CO)(CO1)O)O)=O,,,5,1,1,0,1
19622_0,,,,2,1,2,3
C(CO)(C1(COC(C1O)=O)O)=O,,,5,1,1,0,1
19624_0,,,,2,1,2,3
C(C1(C=O)C(CC(O1)=O)O)(O)=O,,,5,1,1,0,1
19626_0,,,,2,1,2,3
C1(C(C=O)(C(C=O)(CO1)O)O)=O,,,5,1,1,0,1
19628_0,,,,2,1,2,3
C1(C(C=O)(C(C(O1)=O)(C)O)O)=O,,,5,1,1,0,1
19629_0,,,,2,1,2,3
19630_0,,,,2,1,2,3
19631_0,,,,2,1,2,3
19632_0,,,,2,1,2,3
19633_0,,,,2,1,2,3
19634_0,,,,2,1,2,3
19636_0,,,,2,1,2,3
C(C1(C(CO)OC(C1O)=O)O)=O,,,5,1,1,0,1
19638_0,,,,2,1,2,3
C1(C(CCO)(C(C(O1)=O)O)O)=O,,,5,1,1,0,1
19639_0,,,,2,1,2,3
19641_0,,,,2,1,2,3
C1(C(C)(C(C(C=O)O1)O)O)=O,,,5,1,1,0,1
19642_0,,,,2,1,2,3
19644_0,,,,2,1,2,3
C(C1(C)C(CC(O1)=O)O)(O)=O,,,5,1,1,0,1
19646_0,,,,2,1,2,3
C1(C(C)(C(C=O)(CO1)O)O)=O,,,5,1,1,0,1
19648_0,,,,2,1,2,3
C1(C(C)(C(C(O1)=O)(C)O)O)=O,,,5,1,1,0,1
19650_0,,,,2,1,2,3
C1(C(C(C(C(O)=O)O1)O)O)=O,,,5,1,1,0,1
19652_0,,,,2,1,2,3
C1(C(C=CC)(C(C(O1)=O)O)O)=O,,,5,1,1,0,1
19654_0,,,,2,1,2,3
C1(C(C(C(O1)=O)(CC=C)O)O)=O,,,5,1,1,0,1
19656_0,,,,2,1,2,3
C(C(C1CC(C(O1)=O)=C)O)(O)=O,,,5,1,1,0,1
19658_0,,,,2,1,1,2
C1(C(CC(C)O)(C(C(O1)=O)O)O)=O,,,5,1,1,0,1
19660_0,,,,2,1,1,2
C1(C(C(C(O1)=O)(CC(O)=O)O)O)=O,,,5,1,1,0,1
19662_0,,,,2,1,1,2
C1(CC(C(O)=O)(C(C(O)=O)O1)O)=O,,,5,1,1,0,1
19663_0,,,,2,1,2,3
19664_0,,,,2,1,2,3
19665_0,,,,2,1,2,3
19666_0,,,,2,1,1,2
19667_0,,,,2,1,1,2
19668_0,,,,2,1,2,3
19669_0,,,,2,1,2,3
19670_0,,,,2,1,2,3
19671_0,,,,2,1,2,3
19672_0,,,,2,1,2,3
19673_0,,,,2,1,2,3
19674_0,,,,2,1,2,3
19675_0,,,,2,1,1,2
19676_0,,,,2,1,1,2
19677_0,,,,2,1,2,3
19678_0,,,,2,1,1,2
19679_0,,,,2,1,1,2
19680_0,,,,2,1,1,2
19682_0,,,,2,1,2,3
C1(CC(C(CO)(C(C)O)O1)O)=O,,,5,1,1,0,1
19684_0,,,,2,1,2,3
C1(C(C)(C(CO1)(C(C)O)O)O)=O,,,5,1,1,0,1
19685_0,,,,2,1,2,3
19687_0,,,,2,1,2,3
C1(C(C(CO1)O)(CC(C)O)O)=O,,,5,1,1,0,1
19688_0,,,,2,1,2,3
19689_0,,,,2,1,2,3
19690_0,,,,2,1,2,3
19691_0,,,,2,1,2,3
19693_0,,,,2,1,2,3
C1(CC(C(CO)O1)O)=O,,,5,1,1,0,1
19694_0,,,,2,1,2,3
19696_0,,,,2,1,2,3
C1(C(C(CO1)O)(CC(O)=O)O)=O,,,5,1,1,0,1
19697_0,,,,2,1,2,3
19699_0,,,,2,1,2,3
C(C1(C(CO)OC(C1)=O)O)(O)=O,,,5,1,1,0,1
19701_0,,,,2,1,2,3
C1(C(CO)C(CO1)O)=O,,,5,1,1,0,1
19702_0,,,,2,1,2,3
19704_0,,,,2,1,2,3
C1(C(CO)(CCO1)O)=O,,,5,1,1,0,1
19705_0,,,,2,1,2,3
19707_0,,,,2,1,2,3
C1(C2(CC(C(O2)=O)=O)OCC1)=O,,,5,1,1,0,1
19708_0,,,,2,1,2,3
19709_0,,,,2,1,2,3
19710_0,,,,2,1,1,2
19712_0,,,,2,1,2,3
C1(C2(C(C(C)(OC2)O1)=O)O)=O,,,5,1,1,0,1
19714_0,,,,2,1,2,3
C1(C2(COC(CO)(C2O)O1)O)=O,,,5,1,1,0,1
19715_0,,,,2,1,2,3
19717_0,,,,2,1,2,3
C1(C2(COC(C2(CO)O)O1)O)=O,,,5,1,1,0,1
19719_0,,,,2,1,2,3
C1(C2CC(C(O)=O)(OC2)O1)=O,,,5,1,1,0,1
19720_0,,,,2,1,2,3
19722_0,,,,2,1,2,3
C1(C2(CC(OC(C)C2)O1)O)=O,,,5,1,1,0,1
19723_0,,,,2,1,2,3
19724_0,,,,2,1,2,3
19726_0,,,,2,1,2,3
C1(C2(CC(O1)OC(C2)=O)O)=O,,,5,1,2,0,2
19727_0,,,,2,1,2,3
19728_0,,,,2,1,1,2
19729_0,,,,2,1,1,2
19730_0,,,,2,1,1,2
19731_0,,,,2,1,2,3
19732_0,,,,2,1,1,2
19733_0,,,,2,1,1,2
19734_0,,,,2,1,1,2
19735_0,,,,2,1,1,2
19736_0,,,,2,1,1,2
19737_0,,,,2,1,1,2
19738_0,,,,2,1,1,2
19740_0,,,,2,1,2,3
C(C1COC(C1(C)CC=O)=O)=O,,,5,1,1,0,1
19742_0,,,,2,1,2,3
C(CC1CC(C(O1)=O)CC=O)=O,,,5,1,1,0,1
19744_0,,,,2,1,2,3
C(CC1C(C=O)C(C(O1)=O)C)=O,,,5,1,1,0,1
19746_0,,,,2,1,2,3
C(CC(C)C1C(C(OC1)=O)=O)=O,,,5,1,2,0,2
19748_0,,,,2,1,2,3
C(CC(C)C1CC(C(O1)=O)=O)=O,,,5,1,2,0,2
19750_0,,,,2,1,2,3
C(CC1C(OCC1)=O)=O,,,5,1,1,0,1
19752_0,,,,2,1,2,3
C(C1COC(C1C)=O)=O,,,5,1,1,0,1
19754_0,,,,2,1,2,3
C1(C(C)C2COC(C2(O)O1)=O)=O,,,5,1,1,0,1
19756_0,,,,2,1,1,2
C(C(C)C1C(C(OC1)=O)=O)(O)=O,,,5,1,2,0,2
19758_0,,,,2,1,1,2
C1(C(C)C(C(C(O)=O)=O)CO1)=O,,,5,1,2,0,2
19760_0,,,,2,1,1,2
C1(C(CCO1)CC(C(O)=O)=O)=O,,,5,1,2,0,2
19761_0,,,,2,1,2,3
19762_0,,,,2,1,2,3
19763_0,,,,2,1,2,3
19765_0,,,,2,1,2,3
C(CC1(C(OCC1)=O)C)=O,,,5,1,1,0,1
19767_0,,,,2,1,1,2
C1(C(C)(CCO1)CC(C(O)=O)=O)=O,,,5,1,1,0,1
19769_0,,,,2,1,2,3
C(CC1C(OC(C)C1)=O)=O,,,5,1,1,0,1
19771_0,,,,2,1,2,3
C(C1C(C)OC(C1C)=O)=O,,,5,1,1,0,1
19773_0,,,,2,1,1,2
C(C(C)C1C(C(OC1C)=O)=O)(O)=O,,,5,1,1,0,1
19775_0,,,,2,1,1,2
C1(C(C)C(C(C(O)=O)=O)C(C)O1)=O,,,5,1,1,0,1
19777_0,,,,2,1,1,2
C1(C(CC(C)O1)CC(C(O)=O)=O)=O,,,5,1,1,0,1
19779_0,,,,2,1,2,3
C(CC1(C(OC(C1)=O)=O)C)=O,,,5,1,1,0,1
19781_0,,,,2,1,2,3
C(C1CC(C(O1)=O)CC=O)(O)=O,,,5,1,1,0,1
19783_0,,,,2,1,2,3
C1(C(CC(CO)O1)CC=O)=O,,,5,1,1,0,1
19785_0,,,,2,1,2,3
C1(C(C)(C(C(O1)=O)O)CC=O)=O,,,5,1,1,0,1
19787_0,,,,2,1,2,3
C1(C(C)(C(CO1)O)CC=O)=O,,,5,1,1,0,1
19789_0,,,,2,1,2,3
C(C1C(C=O)C(C(O1)=O)C)(O)=O,,,5,1,1,0,1
19791_0,,,,2,1,2,3
C1(C(C)C(C=O)C(CO)O1)=O,,,5,1,1,0,1
19793_0,,,,2,1,2,3
C1(CC(CC(CC=O)O1)O)=O,,,5,1,1,0,1
19795_0,,,,2,1,2,3
C1(CC(C(C=O)C(C=O)O1)O)=O,,,5,1,1,0,1
19797_0,,,,2,1,2,3
C(C1COC(CC1O)=O)=O,,,5,1,1,0,1
19799_0,,,,2,1,2,3
C1(C(CO)C(C(C=O)CO1)O)=O,,,5,1,1,0,1
19801_0,,,,2,1,1,2
C1(C(C(C(O)=O)=O)C(CCO1)O)=O,,,5,1,1,0,1
19803_0,,,,2,1,2,3
C1(C(C=O)C(CCO1)O)=O,,,5,1,1,0,1
19805_0,,,,2,1,2,3
C(C1COC(C(C1O)(C)O)=O)=O,,,5,1,1,0,1
19807_0,,,,2,1,2,3
C(C1COC(C(C1O)O)=O)=O,,,5,1,1,0,1
19809_0,,,,2,1,1,2
C1(CC(C(O)=O)(C(C=O)CO1)O)=O,,,5,1,1,0,1
19811_0,,,,2,1,2,3
C1(C(C(C(C(C)O1)=O)=O)O)=O,,,5,1,1,0,1
19813_0,,,,2,1,2,3
C(C1C(C(C(C(O1)=O)=O)=O)O)=O,,,5,1,1,0,1
19815_0,,,,2,1,2,3
C1(C(C(C(C(C)O1)O)=O)=O)=O,,,5,1,1,0,1
19817_0,,,,2,1,2,3
C1(C(C(C(C(O1)=O)=O)=O)O)=O,,,5,1,1,0,1
19819_0,,,,2,1,2,3
C1(C(C(C(CO1)O)=O)=O)=O,,,5,1,1,0,1
19821_0,,,,2,1,2,3
C1(CC(C=O)OC(C1CO)=O)=O,,,5,1,1,0,1
19823_0,,,,2,1,2,3
C(C1C(C(C(C(O1)=O)=O)O)O)=O,,,5,1,1,0,1
19824_0,,,,2,1,2,3
19826_0,,,,2,1,2,3
C1(C(C(C(CO)(CO1)O)O)=O)=O,,,5,1,1,0,1
19827_0,,,,2,1,2,3
19829_0,,,,2,1,2,3
C1(C(C)(C(C(CO1)=O)O)O)=O,,,5,1,1,0,1
19830_0,,,,2,1,2,3
19832_0,,,,2,1,2,3
C1(C(CO)(CC(C(O1)=O)=O)O)=O,,,5,1,1,0,1
19834_0,,,,2,1,2,3
C(C1(COC(C(C1O)=O)=O)O)=O,,,5,1,1,0,1
19836_0,,,,2,1,2,3
C1(C(C)(C(C(C(O1)=O)=O)O)O)=O,,,5,1,1,0,1
19837_0,,,,2,1,2,3
19839_0,,,,2,1,2,3
C(C1C(C(C(OC1C)=O)O)O)=O,,,5,1,1,0,1
19841_0,,,,2,1,2,3
C1(C(C=O)C(C(C(O1)=O)O)O)=O,,,5,1,1,0,1
19843_0,,,,2,1,2,3
C(C1C(CC(C(O1)=O)=O)O)(O)=O,,,5,1,1,0,1
19844_0,,,,2,1,2,3
19845_0,,,,2,1,2,3
19846_0,,,,2,1,2,3
19848_0,,,,2,1,2,3
C1(C(C(CCO1)=O)CO)=O,,,5,1,1,0,1
19850_0,,,,2,1,2,3
C1(CC(C(C(C(O)=O)O1)O)O)=O,,,5,1,1,0,1
19851_0,,,,2,1,2,3
19852_0,,,,2,1,2,3
19853_0,,,,2,1,2,3
19854_0,,,,2,1,2,3
19855_0,,,,2,1,2,3
19856_0,,,,2,1,2,3
19857_0,,,,2,1,2,3
19858_0,,,,2,1,2,3
19859_0,,,,2,1,2,3
19861_0,,,,2,1,2,3
C1(CC(C(CO1)C(C)O)O)=O,,,5,1,1,0,1
19862_0,,,,2,1,2,3
19863_0,,,,2,1,2,3
19865_0,,,,2,1,2,3
C(C1COC(CC1O)=O)(O)=O,,,5,1,1,0,1
19867_0,,,,2,1,2,3
C1(CC(CCO1)O)=O,,,5,1,1,0,1
19868_0,,,,2,1,2,3
19870_0,,,,2,1,2,3
C(C1(CCOC(C1)=O)O)(O)=O,,,5,1,1,0,1
19872_0,,,,2,1,2,3
C1(C(C(C)O)C(CC(C)O1)O)=O,,,5,1,1,0,1
19873_0,,,,2,1,2,3
19875_0,,,,2,1,2,3
C1(CC(CC(C)O1)O)=O,,,5,1,1,0,1
19877_0,,,,2,1,2,3
C1(C(C(CC(O1)=O)O)C(C)O)=O,,,5,1,1,0,1
19878_0,,,,2,1,2,3
19880_0,,,,2,1,2,3
C1(C(C(C)O)C(C(CO1)=O)O)=O,,,5,1,1,0,1
19882_0,,,,2,1,2,3
C(C1(CC(C)OC(C1)=O)O)(O)=O,,,5,1,1,0,1
19883_0,,,,2,1,2,3
19885_0,,,,2,1,2,3
C1(CC(CC(O1)=O)O)=O,,,5,1,1,0,1
19886_0,,,,2,1,2,3
19888_0,,,,2,1,2,3
C(C1(C)CC(CC(O1)=O)O)(O)=O,,,5,1,1,0,1
19890_0,,,,2,1,2,3
C1(CC(C(O)=O)(CC(O1)=O)O)=O,,,5,1,1,0,1
19892_0,,,,2,1,2,3
C1(CC(C(CO1)=O)O)=O,,,5,1,1,0,1
19894_0,,,,2,1,2,3
C1(C(C=O)(CO)C(CCO1)O)=O,,,5,1,1,0,1
19896_0,,,,2,1,2,3
C1(C(CO)C(CCO1)O)=O,,,5,1,1,0,1
19898_0,,,,2,1,2,3
C1(C(C(C)O)C(CCO1)O)=O,,,5,1,1,0,1
19900_0,,,,2,1,2,3
C1(C(C(O)=O)C(CCO1)O)=O,,,5,1,1,0,1
19902_0,,,,2,1,2,3
C1(C(C(C)O)(C(CCO1)O)O)=O,,,5,1,1,0,1
19904_0,,,,2,1,2,3
C1(C(C(O)=O)(C(CCO1)O)O)=O,,,5,1,1,0,1
19906_0,,,,2,1,2,3
C1(C(C=O)(C(CCO1)O)O)=O,,,5,1,1,0,1
19908_0,,,,2,1,2,3
C1(C(CO)(C(CCO1)O)O)=O,,,5,1,1,0,1
19909_0,,,,2,1,2,3
19910_0,,,,2,1,2,3
19911_0,,,,2,1,2,3
19913_0,,,,2,1,2,3
C1(C(C=O)(C(CC(C)O1)O)O)=O,,,5,1,1,0,1
19915_0,,,,2,1,2,3
C1(C(C=O)(C(CC(O1)=O)O)O)=O,,,5,1,1,0,1
19917_0,,,,2,1,2,3
C1(C(C=O)(C(C(CO1)=O)O)O)=O,,,5,1,1,0,1
19919_0,,,,2,1,2,3
C1(C(C(C(CO1)C(C)O)O)O)=O,,,5,1,1,0,1
19921_0,,,,2,1,2,3
C1(C(C(C(CO)C(C)O1)O)O)=O,,,5,1,1,0,1
19923_0,,,,2,1,2,3
C(C1(C(COC(C1O)=O)O)O)=O,,,5,1,1,0,1
19925_0,,,,2,1,2,3
C1(C(C)(C(CCO1)O)O)=O,,,5,1,1,0,1
19927_0,,,,2,1,2,3
C1(C(C(CCO1)O)O)=O,,,5,1,1,0,1
19929_0,,,,2,1,2,3
C(C1(CCOC(C1O)=O)O)(O)=O,,,5,1,1,0,1
19931_0,,,,2,1,2,3
C1(C(C)(C(CC(C)O1)O)O)=O,,,5,1,1,0,1
19933_0,,,,2,1,2,3
C1(C(C)(C(CC(O1)=O)O)O)=O,,,5,1,1,0,1
19935_0,,,,2,1,2,3
C1(C(C(C(C(O1)=O)O)O)O)=O,,,5,1,1,0,1
19937_0,,,,2,1,2,3
C(C1C(CC(C(O1)=O)=C)O)(O)=O,,,5,1,1,0,1
19939_0,,,,2,1,1,2
C1(CC(C(O)=O)(C(C(O1)=O)O)O)=O,,,5,1,1,0,1
19940_0,,,,2,1,2,3
19941_0,,,,2,1,2,3
19942_0,,,,2,1,2,3
19943_0,,,,2,1,2,3
19944_0,,,,2,1,2,3
19945_0,,,,2,1,2,3
19946_0,,,,2,1,2,3
19947_0,,,,2,1,2,3
19949_0,,,,2,1,2,3
C1(CC(C(CO1)(C(C)O)O)O)=O,,,5,1,1,0,1
19950_0,,,,2,1,2,3
19952_0,,,,2,1,2,3
C1(CC(C(CO1)O)O)=O,,,5,1,1,0,1
19954_0,,,,2,1,2,3
C1(C(C)(CC(C(CO)O1)O)O)=O,,,5,1,1,0,1
19956_0,,,,2,1,2,3
C(C1(C(COC(C1)=O)O)O)(O)=O,,,5,1,1,0,1
19957_0,,,,2,1,2,3
19959_0,,,,2,1,2,3
C1(C(OCCC1)=O)=O,,,5,1,1,0,1
19960_0,,,,2,1,2,3
19961_0,,,,2,1,1,2
19962_0,,,,2,1,2,3
19964_0,,,,2,1,2,3
C1(C2(C)OCC1C(C(O2)=O)=O)=O,,,5,1,1,0,1
19966_0,,,,2,1,2,3
C1(C2(C)C(C(C(O2)O1)=O)O)=O,,,5,1,1,0,1
19968_0,,,,2,1,2,3
C1(C2C(C(C(C)(O2)O1)=O)O)=O,,,5,1,1,0,1
19969_0,,,,2,1,2,3
19970_0,,,,2,1,2,3
19971_0,,,,2,1,2,3
19972_0,,,,2,1,1,2
19973_0,,,,2,1,1,2
19974_0,,,,2,1,1,2
19975_0,,,,2,1,1,2
19976_0,,,,2,1,1,2
19977_0,,,,2,1,1,2
19978_0,,,,2,1,1,2
19979_0,,,,2,1,1,2
19981_0,,,,2,1,2,3
C(C1CC(C(OC1)=O)CC=O)=O,,,5,1,1,0,1
19983_0,,,,2,1,2,3
C(C1COC(C(C)C1C=O)=O)=O,,,5,1,1,0,1
19985_0,,,,2,1,2,3
C(CC1C(C)CC(C(O1)=O)=O)=O,,,5,1,1,0,1
19987_0,,,,2,1,2,3
C1(C(OCC(C)C1)=O)=O,,,5,1,1,0,1
19989_0,,,,2,1,1,2
C(C1(COC(C(C1)=O)=O)C)(O)=O,,,5,1,2,0,2
19990_0,,,,2,1,2,3
19991_0,,,,2,1,2,3
19992_0,,,,2,1,2,3
19993_0,,,,2,1,2,3
19995_0,,,,2,1,2,3
C(CC1C(OCCC1)=O)=O,,,5,1,1,0,1
19997_0,,,,2,1,2,3
C(C1CCOC(C1C)=O)=O,,,5,1,1,0,1
19999_0,,,,2,1,1,2
C(C(C)C1C(C(OCC1)=O)=O)(O)=O,,,5,1,1,0,1
20001_0,,,,2,1,1,2
C1(C(C)C(C(C(O)=O)=O)CCO1)=O,,,5,1,1,0,1
20003_0,,,,2,1,1,2
C1(C(CCCO1)CC(C(O)=O)=O)=O,,,5,1,1,0,1
20005_0,,,,2,1,2,3
C1(C(OC(C)C(C)C1)=O)=O,,,5,1,1,0,1
20007_0,,,,2,1,1,2
C(C1(C)C(C)OC(C(C1)=O)=O)(O)=O,,,5,1,1,0,1
20009_0,,,,2,1,2,3
C(CC1C(OC(CC1)=O)=O)=O,,,5,1,1,0,1
20011_0,,,,2,1,2,3
C(C1CC(OC(C1C)=O)=O)=O,,,5,1,1,0,1
20013_0,,,,2,1,2,3
C(C1C(C)CC(C(O1)=O)=O)(O)=O,,,5,1,1,0,1
20015_0,,,,2,1,2,3
C1(C(CC(C)C(CO)O1)=O)=O,,,5,1,1,0,1
20017_0,,,,2,1,2,3
C1(C(CC(C(O1)=O)CC=O)O)=O,,,5,1,1,0,1
20019_0,,,,2,1,2,3
C1(C(CC(CO1)O)CC=O)=O,,,5,1,1,0,1
20021_0,,,,2,1,2,3
C1(C(C(C=O)C(C(O1)=O)C)O)=O,,,5,1,1,0,1
20023_0,,,,2,1,2,3
C1(C(C)C(C=O)C(CO1)O)=O,,,5,1,1,0,1
20025_0,,,,2,1,2,3
C1(C(C(CO)C(CCO1)O)=O)=O,,,5,1,1,0,1
20027_0,,,,2,1,2,3
C1(C(C(C(CCO1)O)O)=O)=O,,,5,1,1,0,1
20029_0,,,,2,1,2,3
C=CC1C(C(OCCC1O)=O)=O,,,5,1,1,0,1
20031_0,,,,2,1,2,3
C(C1C(C(OCCC1O)=O)=C)=O,,,5,1,1,0,1
20033_0,,,,2,1,1,2
C1(C(C(C(C)O)C(CCO1)O)=O)=O,,,5,1,1,0,1
20035_0,,,,2,1,1,2
C(C1C(C(OCCC1O)=O)=O)(O)=O,,,5,1,1,0,1
20037_0,,,,2,1,2,3
C1(C(CC(CCO1)O)=O)=O,,,5,1,1,0,1
20039_0,,,,2,1,2,3
C(C1COC(C(CC1O)=C)=O)=O,,,5,1,1,0,1
20040_0,,,,2,1,2,3
20042_0,,,,2,1,2,3
C1(CC(C(C(CO1)=O)O)O)=O,,,5,1,1,0,1
20044_0,,,,2,1,2,3
C1(C(C(C(CC(C)O1)O)O)=O)=O,,,5,1,1,0,1
20046_0,,,,2,1,2,3
C1(CC(C(C(C(O1)=O)=O)O)O)=O,,,5,1,1,0,1
20048_0,,,,2,1,2,3
C1(COC(C(C(C1O)O)=O)=O)=O,,,5,1,1,0,1
20049_0,,,,2,1,2,3
20051_0,,,,2,1,2,3
C1(C(C(CC(C(O1)=O)=O)O)O)=O,,,5,1,1,0,1
20052_0,,,,2,1,2,3
20053_0,,,,2,1,2,3
20054_0,,,,2,1,2,3
20056_0,,,,2,1,2,3
C1(C(C)(CC(CCO1)O)O)=O,,,5,1,1,0,1
20058_0,,,,2,1,2,3
C1(C(C)(CC(CC(O1)=O)O)O)=O,,,5,1,1,0,1
20060_0,,,,2,1,2,3
C1(C(C(CC(C(O1)=O)=C)O)O)=O,,,5,1,1,0,1
20062_0,,,,2,1,2,3
C1(C(C)(CC(C(CO1)O)O)O)=O,,,5,1,1,0,1
20063_0,,,,2,1,2,3
20065_0,,,,2,1,2,3
C1(CC2C(C(C(O2)O1)=O)O)=O,,,5,1,1,0,1
20066_0,,,,2,1,2,3
20068_0,,,,2,1,2,3
C1(C2(C)CC(CC(O2)O1)O)=O,,,5,1,1,0,1
20070_0,,,,2,1,2,3
C(C1COC(C(CC1C)=O)=O)=O,,,5,1,1,0,1
20072_0,,,,2,1,2,3
C1(C2CC(C(OCC2)=O)(O)O1)=O,,,5,1,1,0,1
20074_0,,,,2,1,1,2
C(C1CCOC(C(C1)=O)=O)(O)=O,,,5,1,2,0,2
20075_0,,,,2,1,2,3
20077_0,,,,2,1,2,3
C1(C(OCCC(C)C1)=O)=O,,,5,1,1,0,1
20079_0,,,,2,1,1,2
C(C1(C)CCOC(C(C1)=O)=O)(O)=O,,,5,1,1,0,1
20081_0,,,,2,1,1,2
C(C1CC(C)OC(C(C1)=O)=O)(O)=O,,,5,1,1,0,1
20083_0,,,,2,1,2,3
C1(CC(C)CC(C(O1)=O)=O)=O,,,5,1,1,0,1
20085_0,,,,2,1,2,3
C1(C(C(C)CC(C(O1)=O)=O)O)=O,,,5,1,1,0,1
20087_0,,,,2,1,2,3
C1(C(CC(C)C(CO1)O)=O)=O,,,5,1,1,0,1
20088_0,,,,2,1,1,2
20089_0,,,,2,1,1,2
20090_0,,,,2,1,1,2
20091_0,,,,2,1,1,2
20092_0,,,,2,1,1,2
20093_0,,,,2,1,1,2
20095_0,,,,2,1,1,2
C(C1(C=C)CC(C(O)=O)CC1O)=O,,,5,1,1,0,1
20096_0,,,,2,1,1,2
20097_0,,,,2,1,1,2
20098_0,,,,2,1,1,2
20099_0,,,,2,1,1,2
20100_0,,,,2,1,1,2
20101_0,,,,2,1,1,2
20102_0,,,,2,1,1,2
20103_0,,,,2,1,1,2
20104_0,,,,2,1,1,2
20105_0,,,,2,1,1,2
20107_0,,,,2,1,1,2
C(C1CC(CC1C=O)O)(O)=O,,,5,1,1,0,1
20109_0,,,,2,1,1,2
C1(C(CCC1C(C(O)=O)=O)=O)=O,,,5,1,2,0,2
20110_0,,,,2,1,1,2
20112_0,,,,2,1,1,2
C(CC1CCC(C(O)=O)C1C=O)=O,,,5,1,2,0,2
20114_0,,,,2,1,1,2
C(CC1CC(C=O)C(C(O)=O)C1)=O,,,5,1,2,0,2
20116_0,,,,2,1,1,2
C(C1CC(C(O)=O)C(C=O)C1C)=O,,,5,1,1,0,1
20117_0,,,,2,1,1,2
20119_0,,,,2,1,1,2
C(C1C(C)CC(C(O)=O)C1C=O)=O,,,5,1,1,0,1
20120_0,,,,2,1,1,2
20122_0,,,,2,2,1,3
C(CCC1C(C(C(C1O)=O)O)O)=O,,,5,1,1,0,1
20124_0,,,,2,2,1,3
C(CCC1(CC(C(C1O)=O)O)O)=O,,,5,1,1,0,1
20126_0,,,,2,2,1,3
C(CCC1(C(C(CC1O)O)=O)O)=O,,,5,1,1,0,1
20128_0,,,,2,2,1,3
C(CCC1(C(C(C(C1)O)O)=O)O)=O,,,5,1,1,0,1
20130_0,,,,2,2,1,3
C(CCC1C(C(CC1O)=O)=O)=O,,,5,1,1,0,1
20132_0,,,,2,2,1,3
C(CCC1C(C(CC1O)=O)=O)(O)=O,,,5,1,1,0,1
20133_0,,,,2,2,1,3
20135_0,,,,2,2,1,3
C(CCC1(CC(C(C1)=O)=O)O)=O,,,5,1,1,0,1
20137_0,,,,2,2,1,3
C(CCC1(CC(C(C1)=O)=O)O)(O)=O,,,5,1,1,0,1
20139_0,,,,2,2,1,3
C(CC(C)C1(CC(C(C1)=O)=O)O)=O,,,5,1,1,0,1
20141_0,,,,2,2,1,3
C(C(CCC=O)C(CCO)O)=O,,,5,1,1,0,1
20143_0,,,,2,2,1,3
C(C(CCC(O)=O)C(CCO)O)=O,,,5,1,1,0,1
20144_0,,,,2,2,1,3
20146_0,,,,2,2,1,3
C(CC(C(CCC=O)CO)O)=O,,,5,1,1,0,1
20148_0,,,,2,2,1,3
C(CCC(CO)C(CC=O)O)(O)=O,,,5,1,1,0,1
20149_0,,,,2,2,1,3
20151_0,,,,2,2,1,3
C(CCC(CCO)(CC=O)O)=O,,,5,1,1,0,1
20153_0,,,,2,2,1,3
C(CCC(CCO)(CC=O)O)(O)=O,,,5,1,1,0,1
20155_0,,,,2,2,1,3
C(CC(C)C(CCO)(CC=O)O)=O,,,5,1,1,0,1
20157_0,,,,2,2,1,3
C(CCC(CC(CC=O)O)O)=O,,,5,1,1,0,1
20159_0,,,,2,2,1,3
C(CCC(CC(CC=O)O)O)(O)=O,,,5,1,1,0,1
20160_0,,,,2,2,1,3
20162_0,,,,2,2,1,3
C(CCC(C=O)(C(C=O)CO)O)=O,,,5,1,1,0,1
20164_0,,,,2,2,1,3
C(C(CO)(CCC=O)C(C=O)O)=O,,,5,1,1,0,1
20166_0,,,,2,2,1,3
C(CCC(C(C=O)C(C=O)O)O)=O,,,5,1,1,0,1
20168_0,,,,2,2,1,3
C(C(CO)C(C(C)CC(O)=O)O)=O,,,5,1,1,0,1
20170_0,,,,2,2,1,3
C(C(CO)C(CCC=O)O)=O,,,5,1,1,0,1
20172_0,,,,2,2,1,3
C(C(CO)C(CCC(O)=O)O)=O,,,5,1,1,0,1
20173_0,,,,2,2,1,3
20175_0,,,,2,2,1,3
C(C(CO)(CO)C(C)CC(O)=O)=O,,,5,1,1,0,1
20177_0,,,,2,2,1,3
C(C(CCC=O)(CO)CO)=O,,,5,1,1,0,1
20179_0,,,,2,2,1,3
C(C(CCC(O)=O)(CO)CO)=O,,,5,1,1,0,1
20180_0,,,,2,2,1,3
20182_0,,,,2,2,1,3
C(CCC(C=O)(C=C)C(C=O)O)=O,,,5,1,1,0,1
20184_0,,,,2,2,1,3
C(CC(C)C(C=O)(C=C)C(C=O)O)=O,,,5,1,1,0,1
20186_0,,,,2,2,1,3
C(CCC(C=O)(C(C=O)C=C)O)=O,,,5,1,1,0,1
20188_0,,,,2,2,1,3
C(CC(C)C(C=O)(C(C=O)C=C)O)=O,,,5,1,1,0,1
20189_0,,,,2,2,1,3
20191_0,,,,2,2,1,3
C(CCC(C=O)C(C=O)O)=O,,,5,1,1,0,1
20193_0,,,,2,2,1,3
C(CCC(C=O)C(C=O)O)(O)=O,,,5,1,1,0,1
20194_0,,,,2,2,1,3
20196_0,,,,2,2,1,3
C(CC(C)C(C=O)(CC=O)O)(O)=O,,,5,1,1,0,1
20198_0,,,,2,2,1,3
C(CCC(C=O)(CC=O)O)=O,,,5,1,1,0,1
20200_0,,,,2,2,1,3
C(CCC(C=O)(CC=O)O)(O)=O,,,5,1,1,0,1
20202_0,,,,2,2,1,3
C(CC(C)C(C=O)(CC=O)O)=O,,,5,1,1,0,1
20204_0,,,,2,2,1,3
C(CCC(C=O)C(C(C=O)O)O)=O,,,5,1,1,0,1
20206_0,,,,2,2,1,3
C(CCC(C(C=O)O)(CC=O)O)=O,,,5,1,1,0,1
20208_0,,,,2,2,1,3
C(C(C(CC=O)O)(CCC=O)O)=O,,,5,1,1,0,1
20210_0,,,,2,2,1,3
C(C(CCC=O)C(CO)(CO)O)=O,,,5,1,1,0,1
20212_0,,,,2,2,1,3
C(CCC(C(CO)(CC=O)O)O)=O,,,5,1,1,0,1
20214_0,,,,2,2,1,3
C(CCCC(C(C(CO)=O)O)O)=O,,,5,1,1,0,1
20216_0,,,,2,2,1,3
C(CCC(C)(C(C(CO)=O)O)O)=O,,,5,1,1,0,1
20218_0,,,,2,2,1,3
C(CCC(C(CO)=O)(C(C)O)O)=O,,,5,1,1,0,1
20220_0,,,,2,2,1,3
C(CCC(C(C(C(C)O)O)=O)O)=O,,,5,1,1,0,1
20222_0,,,,2,2,1,3
C(CCC(C(O)=O)(C(CO)=O)O)=O,,,5,1,1,0,1
20224_0,,,,2,2,1,3
C(CCC(C(C(C(O)=O)O)=O)O)=O,,,5,1,1,0,1
20226_0,,,,2,2,1,3
C(CCC(C(C(CO)=O)O)O)=O,,,5,1,1,0,1
20228_0,,,,2,2,1,3
C(CCC(C(C(CO)=O)O)O)(O)=O,,,5,1,1,0,1
20229_0,,,,2,2,1,3
20231_0,,,,2,2,1,3
C(CCC(C(CO)=O)(CO)O)=O,,,5,1,1,0,1
20233_0,,,,2,2,1,3
C(CCC(C(CO)=O)(CO)O)(O)=O,,,5,1,1,0,1
20234_0,,,,2,2,1,3
20236_0,,,,2,2,1,3
C(CCC(C(C(CO)O)=O)O)=O,,,5,1,1,0,1
20238_0,,,,2,2,1,3
C(CCC(C(C(CO)O)=O)O)(O)=O,,,5,1,1,0,1
20239_0,,,,2,2,1,3
20241_0,,,,2,2,1,3
C(CCC(C(C(C(O)=O)=O)O)O)=O,,,5,1,1,0,1
20243_0,,,,2,2,1,3
C(CCC(C(C(O)=O)=O)(CO)O)=O,,,5,1,1,0,1
20245_0,,,,2,2,1,3
C(CCC(C=O)(C=C)C(C=CC)O)=O,,,5,1,1,0,1
20247_0,,,,2,2,1,3
C(CCC(C=CC)(C(C=O)C=C)O)=O,,,5,1,1,0,1
20249_0,,,,2,2,1,3
C(CCCC=CC(C(C=O)C=C)O)=O,,,5,1,1,0,1
20251_0,,,,2,2,1,3
C(CCC(C=O)C(C=CC)O)=O,,,5,1,1,0,1
20253_0,,,,2,2,1,3
C(CCC(C=O)C(C=CC)O)(O)=O,,,5,1,1,0,1
20254_0,,,,2,2,1,3
20256_0,,,,2,2,1,3
C(CCC(C=CC)(CC=O)O)=O,,,5,1,1,0,1
20258_0,,,,2,2,1,3
C(CCC(C=CC)(CC=O)O)(O)=O,,,5,1,1,0,1
20260_0,,,,2,2,1,3
C(CC(C)C(C=CC)(CC=O)O)=O,,,5,1,1,0,1
20262_0,,,,2,2,1,3
C(CC(C=CCCCC=O)O)=O,,,5,1,1,0,1
20264_0,,,,2,2,1,3
C(CCCC=CC(CC=O)O)(O)=O,,,5,1,1,0,1
20265_0,,,,2,2,1,3
20267_0,,,,2,2,1,3
C(CCC(C=O)(C=C)C(CC=C)O)=O,,,5,1,1,0,1
20269_0,,,,2,2,1,3
C(C(C=C)C(C(C=C)CCC=O)O)=O,,,5,1,1,0,1
20271_0,,,,2,2,1,3
C(CCC(CC=C)(C(C=O)C=C)O)=O,,,5,1,1,0,1
20273_0,,,,2,2,1,3
C(C(CCC=O)C(CC=C)O)=O,,,5,1,1,0,1
20275_0,,,,2,2,1,3
C(C(CCC(O)=O)C(CC=C)O)=O,,,5,1,1,0,1
20276_0,,,,2,2,1,3
20278_0,,,,2,2,1,3
C(CCC(C=C)C(CC=O)O)=O,,,5,1,1,0,1
20280_0,,,,2,2,1,3
C(CCC(C=C)C(CC=O)O)(O)=O,,,5,1,1,0,1
20281_0,,,,2,2,1,3
20283_0,,,,2,2,1,3
C(CCC(CC=O)(CC=C)O)=O,,,5,1,1,0,1
20285_0,,,,2,2,1,3
C(CCC(CC=O)(CC=C)O)(O)=O,,,5,1,1,0,1
20287_0,,,,2,2,1,3
C(CC(C(C)CC=O)(CC=C)O)=O,,,5,1,1,0,1
20289_0,,,,2,2,1,3
C(C(C=C)C(CCCC=O)O)=O,,,5,1,1,0,1
20291_0,,,,2,2,1,3
C(C(C=C)C(CCCC(O)=O)O)=O,,,5,1,1,0,1
20292_0,,,,2,2,1,3
20294_0,,,,2,2,1,3
C(C(C=C)C(C)(CCC=O)O)=O,,,5,1,1,0,1
20296_0,,,,2,2,1,3
C(C(C=C)C(C)(CCC(O)=O)O)=O,,,5,1,1,0,1
20298_0,,,,2,2,1,3
C(C(C=C)C(C)(C(C)CC=O)O)=O,,,5,1,1,0,1
20300_0,,,,2,2,1,3
C(C(C=C)(CCC=O)C(C)O)=O,,,5,1,1,0,1
20302_0,,,,2,2,1,3
C(C(C=C)(CCC(O)=O)C(C)O)=O,,,5,1,1,0,1
20304_0,,,,2,2,1,3
C(C(C=C)(C(C)CC=O)C(C)O)=O,,,5,1,1,0,1
20306_0,,,,2,2,1,3
C(C(C(O)=O)(C=C)CCC=O)=O,,,5,1,1,0,1
20308_0,,,,2,2,1,3
C(C(C(O)=O)(C=C)CCC(O)=O)=O,,,5,1,1,0,1
20310_0,,,,2,2,1,3
C(C(C(O)=O)(C=C)C(C)CC=O)=O,,,5,1,1,0,1
20312_0,,,,2,2,1,3
C(C(C=C)C(C(C)CC(O)=O)O)=O,,,5,1,1,0,1
20314_0,,,,2,2,1,3
C(C(C=C)C(CCC=O)O)=O,,,5,1,1,0,1
20316_0,,,,2,2,1,3
C(C(C=C)C(CCC(O)=O)O)=O,,,5,1,1,0,1
20317_0,,,,2,2,1,3
20319_0,,,,2,2,1,3
C(C(C=C)(CO)C(C)CC(O)=O)=O,,,5,1,1,0,1
20321_0,,,,2,2,1,3
C(C(C=C)(CCC=O)CO)=O,,,5,1,1,0,1
20323_0,,,,2,2,1,3
C(C(C=C)(CCC(O)=O)CO)=O,,,5,1,1,0,1
20324_0,,,,2,2,1,3
20325_0,,,,2,2,1,3
20326_0,,,,2,2,1,3
20327_0,,,,2,2,1,3
20328_0,,,,2,2,1,3
20329_0,,,,2,2,1,3
20330_0,,,,2,2,1,3
20331_0,,,,2,2,1,3
20332_0,,,,2,2,1,3
20334_0,,,,2,2,1,3
C(CCC(C(C(C(O)=O)O)O)O)=O,,,5,1,1,0,1
20336_0,,,,2,2,1,3
C(CCC(CO)(C(C(O)=O)O)O)=O,,,5,1,1,0,1
20338_0,,,,2,2,1,3
C(C(CCC=O)(C(CO)O)O)(O)=O,,,5,1,1,0,1
20340_0,,,,2,2,1,3
C(CCC1C(C(CC(C1=O)=O)=O)=O)=O,,,5,1,1,0,1
20342_0,,,,2,2,1,3
C(CCCC(C(CCO)=O)=O)=O,,,5,1,1,0,1
20344_0,,,,2,2,1,3
C(CCCC(C(CCO)=O)=O)(O)=O,,,5,1,1,0,1
20345_0,,,,2,2,1,3
20347_0,,,,2,2,1,3
C(CCC(C(C(C)=O)=O)CO)=O,,,5,1,1,0,1
20349_0,,,,2,2,1,3
C(CCC(C(C(C)=O)=O)CO)(O)=O,,,5,1,1,0,1
20350_0,,,,2,2,1,3
20352_0,,,,2,2,1,3
C(CCC(CC(C(C)=O)=O)O)=O,,,5,1,1,0,1
20354_0,,,,2,2,1,3
C(CCC(CC(C(C)=O)=O)O)(O)=O,,,5,1,1,0,1
20356_0,,,,2,2,1,3
C(CC(C)C(CC(C(C)=O)=O)O)=O,,,5,1,1,0,1
20358_0,,,,2,2,1,3
C(CCCC(C(CC(O)=O)=O)=O)=O,,,5,1,1,0,1
20360_0,,,,2,2,1,3
C(CCC(C(O)=O)C(C(C)=O)=O)=O,,,5,1,1,0,1
20362_0,,,,2,2,1,3
C(CCC(C(C(CO)=O)=O)O)=O,,,5,1,1,0,1
20364_0,,,,2,2,1,3
C(CCC(C(C(CO)=O)=O)O)(O)=O,,,5,1,1,0,1
20366_0,,,,2,2,1,3
C(CC(C)C(C(C(CO)=O)=O)O)=O,,,5,1,1,0,1
20368_0,,,,2,2,1,3
C(CC(C)CC(C(C=O)=O)O)(O)=O,,,5,1,1,0,1
20370_0,,,,2,2,1,3
C(CCCC(C(C=O)=O)O)=O,,,5,1,1,0,1
20372_0,,,,2,2,1,3
C(CCCC(C(C=O)=O)O)(O)=O,,,5,1,1,0,1
20373_0,,,,2,2,1,3
20375_0,,,,2,2,1,3
C(CC(C)C(C(C=O)=O)(C)O)(O)=O,,,5,1,1,0,1
20377_0,,,,2,2,1,3
C(CCC(C(C=O)=O)(C)O)=O,,,5,1,1,0,1
20379_0,,,,2,2,1,3
C(CCC(C(C=O)=O)(C)O)(O)=O,,,5,1,1,0,1
20380_0,,,,2,2,1,3
20382_0,,,,2,2,1,3
C(C=O)(CCCC(C(CO)=O)=O)=O,,,5,1,1,0,1
20384_0,,,,2,2,1,3
C(C(CCC(C=O)=O)CCO)(O)=O,,,5,1,1,0,1
20386_0,,,,2,2,1,3
C(C(C)C(CO)CC(C=O)=O)(O)=O,,,5,1,1,0,1
20388_0,,,,2,2,1,3
C(CC(C)CC(C=O)=O)(O)=O,,,5,1,1,0,1
20390_0,,,,2,2,1,3
C(C(C(O)=O)CCC(C=O)=O)=O,,,5,1,1,0,1
20392_0,,,,2,2,1,3
C(CC(CC(C)O)CC(C=O)=O)=O,,,5,1,1,0,1
20394_0,,,,2,2,1,3
C(C(CCC(C=O)=O)C(C)O)=O,,,5,1,1,0,1
20396_0,,,,2,2,1,3
C(C(CO)C(C)CC(C=O)=O)=O,,,5,1,1,0,1
20398_0,,,,2,2,1,3
C(C(C(C)CC(C=O)=O)C(C)O)=O,,,5,1,1,0,1
20400_0,,,,2,2,1,3
C(C(C(O)=O)C(C)CC(C=O)=O)=O,,,5,1,1,0,1
20402_0,,,,2,2,1,3
C(CC(CC(O)=O)CC(C=O)=O)=O,,,5,1,2,0,2
20403_0,,,,2,2,1,3
20405_0,,,,2,2,1,3
C(C(CC(C=O)=O)CC(CO)=O)=O,,,5,1,1,0,1
20407_0,,,,2,2,1,3
C(CC(C(CO)=O)CC(C=O)=O)=O,,,5,1,1,0,1
20409_0,,,,2,2,1,3
C(C(CO)C(C=O)CC(C=O)=O)=O,,,5,1,1,0,1
20411_0,,,,2,2,1,3
C(C(CO)(CC=O)CC(C=O)=O)=O,,,5,1,1,0,1
20413_0,,,,2,2,1,3
C(CCCC(C=O)=O)=O,,,5,1,1,0,1
20415_0,,,,2,2,1,3
C(C(CCCC(C(O)=O)=O)=O)=O,,,5,1,1,0,1
20417_0,,,,2,2,1,3
C(CCCC(C=O)=O)(O)=O,,,5,1,1,0,1
20419_0,,,,2,2,1,3
C(C)(C(C(O)=O)CCC(C=O)=O)=O,,,5,1,1,0,1
20421_0,,,,2,2,1,3
C1(C(CCC(C=O)=O)CC(O)O1)=O,,,5,1,1,0,1
20423_0,,,,2,2,1,3
C1(C(C)C(C(O)O1)CC(C=O)=O)=O,,,5,1,1,0,1
20424_0,,,,2,2,1,3
20426_0,,,,2,2,1,3
C(C(CC(C)CC(C(O)=O)=O)=O)=O,,,5,1,1,0,1
20428_0,,,,2,2,1,3
C(CC(C(O)=O)CCC(C=O)=O)=O,,,5,1,1,0,1
20430_0,,,,2,2,1,3
C(CC(C(O)=O)(C)CC(C=O)=O)=O,,,5,1,1,0,1
20432_0,,,,2,2,1,3
C(C(CC(C=O)=O)C(C(O)=O)C)=O,,,5,1,1,0,1
20434_0,,,,2,2,1,3
C(CC(C)CC(C(C=O)=O)=O)(O)=O,,,5,1,1,0,1
20436_0,,,,2,2,1,3
C(CCCC(C(C=O)=O)=O)=O,,,5,1,1,0,1
20438_0,,,,2,2,1,3
C(CCCC(C(C=O)=O)=O)(O)=O,,,5,1,1,0,1
20439_0,,,,2,2,1,3
20441_0,,,,2,2,1,3
C(CCC(C(C(C=C)=O)=O)O)=O,,,5,1,1,0,1
20443_0,,,,2,2,1,3
C(CCC(C(C(C=C)=O)=O)O)(O)=O,,,5,1,1,0,1
20445_0,,,,2,2,1,3
C(CC(C)C(C(C(C=C)=O)=O)O)=O,,,5,1,1,0,1
20447_0,,,,2,2,1,3
C(C(CCC(C(CO)=O)=O)O)=O,,,5,1,1,0,1
20449_0,,,,2,2,1,3
C(C(CCCC(C(CO)=O)=O)O)=O,,,5,1,1,0,1
20451_0,,,,2,2,1,3
C(C(C)(CCC(C(CO)=O)=O)O)=O,,,5,1,1,0,1
20453_0,,,,2,2,1,3
C(CO)(CCCC(C(CO)=O)=O)=O,,,5,1,1,0,1
20455_0,,,,2,2,1,3
C(C)(C(CCC(C(CO)=O)=O)O)=O,,,5,1,1,0,1
20457_0,,,,2,2,1,3
C(C(CO)=O)(CCC(CO)CO)=O,,,5,1,1,0,1
20459_0,,,,2,2,1,3
C(C(CO)=O)(CCC(CCO)O)=O,,,5,1,1,0,1
20461_0,,,,2,2,1,3
C(C)=CC(CCC(C(CO)=O)=O)O,,,5,1,1,0,1
20463_0,,,,2,2,1,3
C(CCCC(C(CO)=O)=O)=CCO,,,5,1,1,0,1
20465_0,,,,2,2,1,3
C(C(CO)CCC(C(CO)=O)=O)=C,,,5,1,1,0,1
20467_0,,,,2,2,1,3
C(CC(CCC(C(CO)=O)=O)O)=C,,,5,1,1,0,1
20469_0,,,,2,2,1,3
C(C(CCCC(C(CO)=O)=O)O)=C,,,5,1,1,0,1
20471_0,,,,2,2,1,3
C(C(C)(CCC(C(CO)=O)=O)O)=C,,,5,1,1,0,1
20473_0,,,,2,2,1,3
C(CCCC(C(CO)=O)=O)=O,,,5,1,2,0,2
20475_0,,,,2,2,1,3
C(C(CCC(C(CO)=O)=O)O)(O)=O,,,5,1,1,0,1
20477_0,,,,2,2,1,3
C(C(CO)=O)(CCC(CO)O)=O,,,5,1,1,0,1
20479_0,,,,2,2,1,3
C(C(CO)CCC(C(CO)=O)=O)=O,,,5,1,1,0,1
20481_0,,,,2,2,1,3
C(CC(CCC(C(CO)=O)=O)O)=O,,,5,1,1,0,1
20482_0,,,,2,2,1,3
20484_0,,,,2,2,1,3
C(C(CO)=O)(CCCCO)=O,,,5,1,1,0,1
20485_0,,,,2,2,1,3
20487_0,,,,2,2,1,3
C(CCCC(C(CO)=O)=O)(O)=O,,,5,1,2,0,2
20489_0,,,,2,2,1,3
C(CCCC(C(CO)=O)=O)=CC=O,,,5,1,1,0,1
20491_0,,,,2,2,1,3
C(C(C=C)CCC(C(CO)=O)=O)=O,,,5,1,1,0,1
20493_0,,,,2,2,1,3
C(C(C(C(CO)=O)=O)CCO)(O)=O,,,5,1,1,0,1
20495_0,,,,2,2,1,3
C(C(CCO)C(C(C=O)=O)O)(O)=O,,,5,1,1,0,1
20497_0,,,,2,2,1,3
C(CCCC(C(C(CO)O)=O)=O)=O,,,5,1,1,0,1
20499_0,,,,2,2,1,3
C(CCC(C(C(C)=O)=O)(CO)O)=O,,,5,1,1,0,1
20501_0,,,,2,2,1,3
C(CCC(C(C(C(C)=O)=O)O)O)=O,,,5,1,1,0,1
20503_0,,,,2,2,1,3
C(CCC(C(C)O)C(C=O)O)=O,,,5,1,1,0,1
20505_0,,,,2,2,1,3
C(CCC(C(C)O)C(C=O)O)(O)=O,,,5,1,1,0,1
20507_0,,,,2,2,1,3
C(CC(C)C(C(C)O)C(C=O)O)=O,,,5,1,1,0,1
20509_0,,,,2,2,1,3
C(C(CCC=O)(CC(C)O)O)=O,,,5,1,1,0,1
20511_0,,,,2,2,1,3
C(C(CCC(O)=O)(CC(C)O)O)=O,,,5,1,1,0,1
20513_0,,,,2,2,1,3
C(C(CC(C)O)(C(C)CC=O)O)=O,,,5,1,1,0,1
20515_0,,,,2,2,1,3
C(CCCC(CC(C=O)O)O)=O,,,5,1,1,0,1
20517_0,,,,2,2,1,3
C(CCCC(CC(C=O)O)O)(O)=O,,,5,1,1,0,1
20519_0,,,,2,2,1,3
C(CC(C)CC(CC(C=O)O)O)=O,,,5,1,1,0,1
20521_0,,,,2,2,1,3
C(CCC(C)(CC(C=O)O)O)=O,,,5,1,1,0,1
20523_0,,,,2,2,1,3
C(CCC(C)(CC(C=O)O)O)(O)=O,,,5,1,1,0,1
20525_0,,,,2,2,1,3
C(CC(C)C(C)(CC(C=O)O)O)=O,,,5,1,1,0,1
20527_0,,,,2,2,1,3
C(C(CCC=O)C(C=O)O)(O)=O,,,5,1,1,0,1
20529_0,,,,2,2,1,3
C(CCC(C(O)=O)C(C=O)O)(O)=O,,,5,1,1,0,1
20531_0,,,,2,2,1,3
C(C(C(C)CC=O)C(C=O)O)(O)=O,,,5,1,1,0,1
20533_0,,,,2,2,1,3
C(CCC(C=O)(CC(O)=O)O)=O,,,5,1,1,0,1
20535_0,,,,2,2,1,3
C(CCC(C=O)(CC(O)=O)O)(O)=O,,,5,1,1,0,1
20537_0,,,,2,2,1,3
C(CC(C)C(C=O)(CC(O)=O)O)=O,,,5,1,1,0,1
20539_0,,,,2,2,1,3
C(CCC(C(C(C=O)O)=O)O)=O,,,5,1,1,0,1
20541_0,,,,2,2,1,3
C(CCC(C(C(C=O)O)=O)O)(O)=O,,,5,1,1,0,1
20542_0,,,,2,2,1,3
20544_0,,,,2,2,1,3
C(CCC(C=O)(C(CO)=O)O)=O,,,5,1,1,0,1
20546_0,,,,2,2,1,3
C(CCC(C=O)(C(CO)=O)O)(O)=O,,,5,1,1,0,1
20548_0,,,,2,2,1,3
C(CC(C)C(C=O)(C(CO)=O)O)=O,,,5,1,1,0,1
20550_0,,,,2,2,1,3
C(C(C=O)(C(CCC=O)O)O)=O,,,5,1,1,0,1
20552_0,,,,2,2,1,3
C(C(C=O)(C(CCC(O)=O)O)O)=O,,,5,1,1,0,1
20554_0,,,,2,2,1,3
C(C(C=O)(C(C(C)CC=O)O)O)=O,,,5,1,1,0,1
20556_0,,,,2,2,1,3
C(CC(C)C(C(C=O)O)O)(O)=O,,,5,1,1,0,1
20558_0,,,,2,2,1,3
C(C(C=O)CC(C(C=O)O)O)(O)=O,,,5,1,1,0,1
20560_0,,,,2,2,1,3
C(C(C(C)O)CC(C(C=O)O)O)=O,,,5,1,1,0,1
20562_0,,,,2,2,1,3
C(C(CO)C(C)C(C(C=O)O)O)=O,,,5,1,1,0,1
20564_0,,,,2,2,1,3
C(CCC(C(C=O)O)O)=O,,,5,1,1,0,1
20566_0,,,,2,2,1,3
C(C(C(CCC(C(O)=O)=O)O)O)=O,,,5,1,1,0,1
20568_0,,,,2,2,1,3
C(CCC(C(C=O)O)O)(O)=O,,,5,1,1,0,1
20569_0,,,,2,2,1,3
20571_0,,,,2,2,1,3
C(C(CO)(C(C)CC(O)=O)O)=O,,,5,1,1,0,1
20573_0,,,,2,2,1,3
C(C(C=O)CC(C=O)(CO)O)(O)=O,,,5,1,1,0,1
20575_0,,,,2,2,1,3
C(C(CC(C=O)(CO)O)C(C)O)=O,,,5,1,1,0,1
20577_0,,,,2,2,1,3
C(C(CO)C(C)C(C=O)(CO)O)=O,,,5,1,1,0,1
20579_0,,,,2,2,1,3
C(C(CO)(CCC=O)O)=O,,,5,1,1,0,1
20581_0,,,,2,2,1,3
C(C(CO)(CCC(C(O)=O)=O)O)=O,,,5,1,1,0,1
20583_0,,,,2,2,1,3
C(C(CO)(CCC(O)=O)O)=O,,,5,1,1,0,1
20584_0,,,,2,2,1,3
20586_0,,,,2,2,1,3
C(C(CC(C=O)O)CCO)(O)=O,,,5,1,1,0,1
20588_0,,,,2,2,1,3
C(C(C)C(CO)C(C=O)O)(O)=O,,,5,1,1,0,1
20590_0,,,,2,2,1,3
C(CC(C)C(C=O)O)(O)=O,,,5,1,1,0,1
20592_0,,,,2,2,1,3
C(C(CC(C=O)O)CC(O)=O)(O)=O,,,5,1,1,0,1
20594_0,,,,2,2,1,3
C(CC(C(O)=O)(C)C(C=O)O)(O)=O,,,5,1,1,0,1
20596_0,,,,2,2,1,3
C(C(C)C(C(O)=O)C(C=O)O)(O)=O,,,5,1,1,0,1
20598_0,,,,2,2,1,3
C(C(C=O)CC(C=O)O)(O)=O,,,5,1,1,0,1
20600_0,,,,2,2,1,3
C(CC(CC(C)O)C(C=O)O)=O,,,5,1,1,0,1
20602_0,,,,2,2,1,3
C(C(CC(C=O)O)C(C)O)=O,,,5,1,1,0,1
20604_0,,,,2,2,1,3
C(C(CO)C(C)C(C=O)O)=O,,,5,1,1,0,1
20606_0,,,,2,2,1,3
C(C(C(C)O)C(C)C(C=O)O)=O,,,5,1,1,0,1
20608_0,,,,2,2,1,3
C(C(C=O)C(C)C(C=O)O)(O)=O,,,5,1,1,0,1
20610_0,,,,2,2,1,3
C(CC(C(C=O)O)CC=O)(O)=O,,,5,1,2,0,2
20611_0,,,,2,2,1,3
20613_0,,,,2,2,1,3
C(C(C(C=O)CC(CO)=O)O)=O,,,5,1,1,0,1
20615_0,,,,2,2,1,3
C(CC(C(CO)=O)C(C=O)O)=O,,,5,1,1,0,1
20617_0,,,,2,2,1,3
C(C(C(C=O)C(C=O)CO)O)=O,,,5,1,1,0,1
20619_0,,,,2,2,1,3
C(CC(C=O)(CO)C(C=O)O)=O,,,5,1,1,0,1
20621_0,,,,2,2,1,3
C(CCC(C=O)O)=O,,,5,1,1,0,1
20623_0,,,,2,2,1,3
C(C(CCC(C(O)=O)=O)O)=O,,,5,1,1,0,1
20624_0,,,,2,2,1,3
20626_0,,,,2,2,1,3
C(C(CC(C(O)=O)C(C)=O)O)=O,,,5,1,1,0,1
20628_0,,,,2,2,1,3
C(C(CC(C=O)O)C(CO)O)(O)=O,,,5,1,1,0,1
20630_0,,,,2,2,1,3
C1(C(CC(C=O)O)CC(O)O1)=O,,,5,1,1,0,1
20632_0,,,,2,2,1,3
C1(C(C)C(C(O)O1)C(C=O)O)=O,,,5,1,1,0,1
20633_0,,,,2,2,1,3
20635_0,,,,2,2,1,3
C(C(C(C)CC(C(O)=O)=O)O)=O,,,5,1,1,0,1
20637_0,,,,2,2,1,3
C(C(CC(C=O)O)CC=O)(O)=O,,,5,1,1,0,1
20639_0,,,,2,2,1,3
C(C(C)(C(C=O)O)CC=O)(O)=O,,,5,1,1,0,1
20641_0,,,,2,2,1,3
C(C(C)C(C=O)C(C=O)O)(O)=O,,,5,1,1,0,1
20643_0,,,,2,2,1,3
C(C(CCO)CCC(C=O)O)(O)=O,,,5,1,1,0,1
20645_0,,,,2,2,1,3
C(C(C)C(CO)CC(C=O)O)(O)=O,,,5,1,1,0,1
20647_0,,,,2,2,1,3
C(CC(C)CC(C=O)O)(O)=O,,,5,1,1,0,1
20649_0,,,,2,2,1,3
C(C(C=O)CCC(C=O)O)(O)=O,,,5,1,1,0,1
20651_0,,,,2,2,1,3
C(CC(CC(C=O)O)CC(C)O)=O,,,5,1,1,0,1
20653_0,,,,2,2,1,3
C(C(C(C)O)CCC(C=O)O)=O,,,5,1,1,0,1
20655_0,,,,2,2,1,3
C(C(CO)C(C)CC(C=O)O)=O,,,5,1,1,0,1
20657_0,,,,2,2,1,3
C(C(C(C)O)C(C)CC(C=O)O)=O,,,5,1,1,0,1
20659_0,,,,2,2,1,3
C(C(C=O)C(C)CC(C=O)O)(O)=O,,,5,1,1,0,1
20661_0,,,,2,2,1,3
C(CC(CC(C=O)O)CC=O)(O)=O,,,5,1,2,0,2
20662_0,,,,2,2,1,3
20664_0,,,,2,2,1,3
C(C(CC(C=O)CC(CO)=O)O)=O,,,5,1,1,0,1
20666_0,,,,2,2,1,3
C(CO)(C(CC(C=O)O)CC=O)=O,,,5,1,1,0,1
20668_0,,,,2,2,1,3
C(C(CC(C=O)C(C=O)CO)O)=O,,,5,1,1,0,1
20670_0,,,,2,2,1,3
C(C(CO)(CC(C=O)O)CC=O)=O,,,5,1,1,0,1
20672_0,,,,2,2,1,3
C(CCCC(C=O)O)=O,,,5,1,1,0,1
20674_0,,,,2,2,1,3
C(C(CCCC(C(O)=O)=O)O)=O,,,5,1,1,0,1
20676_0,,,,2,2,1,3
C(CCCC(C=O)O)(O)=O,,,5,1,1,0,1
20678_0,,,,2,2,1,3
C(C(CCC(C(O)=O)C(C)=O)O)=O,,,5,1,1,0,1
20680_0,,,,2,2,1,3
C1(C(CC(O)O1)CCC(C=O)O)=O,,,5,1,1,0,1
20682_0,,,,2,2,1,3
C1(C(C)C(C(O)O1)CC(C=O)O)=O,,,5,1,1,0,1
20683_0,,,,2,2,1,3
20685_0,,,,2,2,1,3
C(C(CC(C)CC(C(O)=O)=O)O)=O,,,5,1,1,0,1
20687_0,,,,2,2,1,3
C(C(CCC(C=O)O)CC=O)(O)=O,,,5,1,1,0,1
20689_0,,,,2,2,1,3
C(C(C)(CC(C=O)O)CC=O)(O)=O,,,5,1,1,0,1
20691_0,,,,2,2,1,3
C(C(CC(C=O)C(C(O)=O)C)O)=O,,,5,1,1,0,1
20693_0,,,,2,2,1,3
C(C(CC(C=O)(C)O)CCO)(O)=O,,,5,1,1,0,1
20695_0,,,,2,2,1,3
C(C(C)C(CO)C(C=O)(C)O)(O)=O,,,5,1,1,0,1
20697_0,,,,2,2,1,3
C(C(C)(C(C)CC(O)=O)O)=O,,,5,1,1,0,1
20699_0,,,,2,2,1,3
C(C(C=O)CC(C=O)(C)O)(O)=O,,,5,1,1,0,1
20701_0,,,,2,2,1,3
C(C(C)(C(CC(C)O)CC=O)O)=O,,,5,1,1,0,1
20703_0,,,,2,2,1,3
C(C(CC(C=O)(C)O)C(C)O)=O,,,5,1,1,0,1
20705_0,,,,2,2,1,3
C(C(CO)C(C)C(C=O)(C)O)=O,,,5,1,1,0,1
20707_0,,,,2,2,1,3
C(C(C(C)O)C(C)C(C=O)(C)O)=O,,,5,1,1,0,1
20709_0,,,,2,2,1,3
C(C(C=O)C(C)C(C=O)(C)O)(O)=O,,,5,1,1,0,1
20711_0,,,,2,2,1,3
C(C(C)(C(CC(O)=O)CC=O)O)=O,,,5,1,2,0,2
20712_0,,,,2,2,1,3
20714_0,,,,2,2,1,3
C(CC(C=O)C(C=O)(C)O)(CO)=O,,,5,1,1,0,1
20716_0,,,,2,2,1,3
C(CC(C(CO)=O)C(C=O)(C)O)=O,,,5,1,1,0,1
20718_0,,,,2,2,1,3
C(C(CO)C(C=O)C(C=O)(C)O)=O,,,5,1,1,0,1
20720_0,,,,2,2,1,3
C(C(C)(C(C=O)(CO)CC=O)O)=O,,,5,1,1,0,1
20722_0,,,,2,2,1,3
C(C(C)(CCC=O)O)=O,,,5,1,1,0,1
20724_0,,,,2,2,1,3
C(C(C)(CCC(C(O)=O)=O)O)=O,,,5,1,1,0,1
20726_0,,,,2,2,1,3
C(C(C)(CCC(O)=O)O)=O,,,5,1,1,0,1
20728_0,,,,2,2,1,3
C(C(C)(CC(C(O)=O)C(C)=O)O)=O,,,5,1,1,0,1
20730_0,,,,2,2,1,3
C1(C(CC(C=O)(C)O)CC(O)O1)=O,,,5,1,1,0,1
20732_0,,,,2,2,1,3
C1(C(C)C(C(O)O1)C(C=O)(C)O)=O,,,5,1,1,0,1
20734_0,,,,2,2,1,3
C(C(C)(C(C)CC=O)O)=O,,,5,1,1,0,1
20736_0,,,,2,2,1,3
C(C(C)(C(C)CC(C(O)=O)=O)O)=O,,,5,1,1,0,1
20738_0,,,,2,2,1,3
C(C(CC(C=O)(C)O)CC=O)(O)=O,,,5,1,1,0,1
20740_0,,,,2,2,1,3
C(C(C)(CC=O)C(C=O)(C)O)(O)=O,,,5,1,1,0,1
20742_0,,,,2,2,1,3
C(C(C)C(C=O)C(C=O)(C)O)(O)=O,,,5,1,1,0,1
20744_0,,,,2,2,1,3
C(CC(C)C(C(C(C)=O)=O)O)(O)=O,,,5,1,1,0,1
20746_0,,,,2,2,1,3
C(CCC(C(C(C)=O)=O)O)=O,,,5,1,1,0,1
20748_0,,,,2,2,1,3
C(CCC(C(C(C)=O)=O)O)(O)=O,,,5,1,1,0,1
20750_0,,,,2,2,1,3
C(CC(C)C(C(C(C)=O)=O)O)=O,,,5,1,1,0,1
20752_0,,,,2,2,1,3
C(CC(C)CC(C(CO)=O)=O)(O)=O,,,5,1,1,0,1
20753_0,,,,2,2,1,3
20754_0,,,,2,2,1,3
20756_0,,,,2,2,1,3
C(CC(C)CC(C(CO)=O)=O)=O,,,5,1,1,0,1
20758_0,,,,2,2,1,3
C(C(CCC=O)(C(C=O)O)O)(O)=O,,,5,1,1,0,1
20760_0,,,,2,2,1,3
C(CCC(C=O)(C(C(O)=O)O)O)=O,,,5,1,1,0,1
20762_0,,,,2,2,1,3
C(CC(C)CC(O)=O)(CC(O)=O)=O,,,5,1,1,0,1
20764_0,,,,2,2,1,3
C(CCCC(CC(O)=O)=O)=O,,,5,1,1,0,1
20766_0,,,,2,2,1,3
C(CCCC(O)=O)(CC(O)=O)=O,,,5,1,1,0,1
20767_0,,,,2,2,1,3
20769_0,,,,2,2,1,3
C(C)(C(C(O)=O)C(C)CC(O)=O)=O,,,5,1,1,0,1
20771_0,,,,2,2,1,3
C(CCC(C(C)=O)C(O)=O)=O,,,5,1,2,0,2
20773_0,,,,2,2,1,3
C(C)(C(C(O)=O)CCC(O)=O)=O,,,5,1,2,0,2
20774_0,,,,2,2,1,3
20776_0,,,,2,2,1,3
C(CC(C)CC(CCO)=O)(O)=O,,,5,1,1,0,1
20778_0,,,,2,2,1,3
C(C(C=O)CCC(CCO)=O)(O)=O,,,5,1,1,0,1
20780_0,,,,2,2,1,3
C(C(CCC(CCO)=O)C(C)O)=O,,,5,1,1,0,1
20782_0,,,,2,2,1,3
C(C(CO)C(C)CC(CCO)=O)=O,,,5,1,1,0,1
20784_0,,,,2,2,1,3
C(CCCC(CCO)=O)=O,,,5,1,1,0,1
20786_0,,,,2,2,1,3
C(CCCC(C(O)=O)=O)(CCO)=O,,,5,1,1,0,1
20788_0,,,,2,2,1,3
C(CCCC(CCO)=O)(O)=O,,,5,1,1,0,1
20789_0,,,,2,2,1,3
20791_0,,,,2,2,1,3
C(CC(C)C(CC(C)=O)O)(O)=O,,,5,1,1,0,1
20793_0,,,,2,2,1,3
C(C(C=O)CC(CC(C)=O)O)(O)=O,,,5,1,1,0,1
20795_0,,,,2,2,1,3
C(C(CC(CC(C)=O)O)C(C)O)=O,,,5,1,1,0,1
20797_0,,,,2,2,1,3
C(C(CO)C(C)C(CC(C)=O)O)=O,,,5,1,1,0,1
20799_0,,,,2,2,1,3
C(CCC(CC(C)=O)O)=O,,,5,1,1,0,1
20801_0,,,,2,2,1,3
C(C)(CC(CCC(C(O)=O)=O)O)=O,,,5,1,1,0,1
20803_0,,,,2,2,1,3
C(CCC(CC(C)=O)O)(O)=O,,,5,1,1,0,1
20804_0,,,,2,2,1,3
20806_0,,,,2,2,1,3
C(CC(C)C(C(C)=O)CO)(O)=O,,,5,1,1,0,1
20808_0,,,,2,2,1,3
C(C(C=O)CC(C(C)=O)CO)(O)=O,,,5,1,1,0,1
20810_0,,,,2,2,1,3
C(C(CC(C(C)=O)CO)C(C)O)=O,,,5,1,1,0,1
20812_0,,,,2,2,1,3
C(C(CO)C(C)C(C(C)=O)CO)=O,,,5,1,1,0,1
20814_0,,,,2,2,1,3
C(CCC(C(C)=O)CO)=O,,,5,1,1,0,1
20816_0,,,,2,2,1,3
C(C)(C(CCC(C(O)=O)=O)CO)=O,,,5,1,1,0,1
20818_0,,,,2,2,1,3
C(CCC(C(C)=O)CO)(O)=O,,,5,1,1,0,1
20819_0,,,,2,2,1,3
20821_0,,,,2,2,1,3
C(C(C(CCCC=O)=O)(C)O)(O)=O,,,5,1,1,0,1
20823_0,,,,2,2,1,3
C(CCCC(C(O)=O)(C(C)=O)O)=O,,,5,1,1,0,1
20825_0,,,,2,2,1,3
C(CCC(C(O)=O)C(C(C)O)=O)=O,,,5,1,1,0,1
20827_0,,,,2,2,1,3
C(CCCC(C(CC(O)=O)=O)O)=O,,,5,1,1,0,1
20829_0,,,,2,2,1,3
C(C(C)(CCC=O)O)(CC(O)=O)=O,,,5,1,1,0,1
20831_0,,,,2,2,1,3
C(CCC(C(C(C(O)=O)C)=O)O)=O,,,5,1,1,0,1
20833_0,,,,2,2,1,3
C(CCCC(C(O)=O)C(CO)=O)=O,,,5,1,1,0,1
20835_0,,,,2,2,1,3
C(CCC(C(O)=O)(C(CO)=O)C)=O,,,5,1,1,0,1
20837_0,,,,2,2,1,3
C(C(C(CC)=O)(CCC=O)O)(O)=O,,,5,1,1,0,1
20839_0,,,,2,2,1,3
C(C(C(CCCCC=O)=O)O)(O)=O,,,5,1,1,0,1
20841_0,,,,2,2,1,3
C(C(C)CCC=O)(C(C(O)=O)O)=O,,,5,1,1,0,1
20843_0,,,,2,2,1,3
C(C(CCC(CO)=O)CCO)(O)=O,,,5,1,1,0,1
20845_0,,,,2,2,1,3
C(C(C)C(CO)CC(CO)=O)(O)=O,,,5,1,1,0,1
20847_0,,,,2,2,1,3
C(CC(C)CC(CO)=O)(O)=O,,,5,1,1,0,1
20849_0,,,,2,2,1,3
C(C(C=O)CCC(CO)=O)(O)=O,,,5,1,1,0,1
20851_0,,,,2,2,1,3
C(CC(CC(C)O)CC(CO)=O)=O,,,5,1,1,0,1
20853_0,,,,2,2,1,3
C(C(CCC(CO)=O)C(C)O)=O,,,5,1,1,0,1
20855_0,,,,2,2,1,3
C(C(CO)C(C)CC(CO)=O)=O,,,5,1,1,0,1
20857_0,,,,2,2,1,3
C(C(C(C)O)C(C)CC(CO)=O)=O,,,5,1,1,0,1
20859_0,,,,2,2,1,3
C(C(C=O)C(C)CC(CO)=O)(O)=O,,,5,1,1,0,1
20861_0,,,,2,2,1,3
C(CC(CC=O)CC(CO)=O)(O)=O,,,5,1,2,0,2
20862_0,,,,2,2,1,3
20864_0,,,,2,2,1,3
C(C(CC(CO)=O)CC(CO)=O)=O,,,5,1,1,0,1
20866_0,,,,2,2,1,3
C(CC(C(CO)=O)CC(CO)=O)=O,,,5,1,1,0,1
20868_0,,,,2,2,1,3
C(CC(C=O)C(C=O)CO)(CO)=O,,,5,1,2,0,2
20870_0,,,,2,2,1,3
C(C(CO)(CC(CO)=O)CC=O)=O,,,5,1,1,0,1
20872_0,,,,2,2,1,3
C(CCCC(CO)=O)=O,,,5,1,1,0,1
20874_0,,,,2,2,1,3
C(CO)(CCCC(C(O)=O)=O)=O,,,5,1,1,0,1
20876_0,,,,2,2,1,3
C(CCCC(CO)=O)(O)=O,,,5,1,1,0,1
20878_0,,,,2,2,1,3
C(C)(C(C(O)=O)CCC(CO)=O)=O,,,5,1,1,0,1
20880_0,,,,2,2,1,3
C1(C(CCC(CO)=O)CC(O)O1)=O,,,5,1,1,0,1
20882_0,,,,2,2,1,3
C1(C(C)C(C(O)O1)CC(CO)=O)=O,,,5,1,1,0,1
20884_0,,,,2,2,1,3
C(CC(C)CC(CO)=O)=O,,,5,1,1,0,1
20886_0,,,,2,2,1,3
C(CO)(CC(C)CC(C(O)=O)=O)=O,,,5,1,1,0,1
20888_0,,,,2,2,1,3
C(CO)(CCC(C(O)=O)CC=O)=O,,,5,1,1,0,1
20890_0,,,,2,2,1,3
C(C(C)(CC(CO)=O)CC=O)(O)=O,,,5,1,1,0,1
20892_0,,,,2,2,1,3
C(CC(C=O)C(C(O)=O)C)(CO)=O,,,5,1,1,0,1
20894_0,,,,2,2,1,3
C(C(CC(C(C)=O)O)CCO)(O)=O,,,5,1,1,0,1
20896_0,,,,2,2,1,3
C(C(C)C(CO)C(C(C)=O)O)(O)=O,,,5,1,1,0,1
20898_0,,,,2,2,1,3
C(CC(C)C(C(C)=O)O)(O)=O,,,5,1,1,0,1
20900_0,,,,2,2,1,3
C(C(C=O)CC(C(C)=O)O)(O)=O,,,5,1,1,0,1
20902_0,,,,2,2,1,3
C(CC(CC(C)O)C(C(C)=O)O)=O,,,5,1,1,0,1
20904_0,,,,2,2,1,3
C(C(CC(C(C)=O)O)C(C)O)=O,,,5,1,1,0,1
20906_0,,,,2,2,1,3
C(C(CO)C(C)C(C(C)=O)O)=O,,,5,1,1,0,1
20908_0,,,,2,2,1,3
C(C(C(C)O)C(C)C(C(C)=O)O)=O,,,5,1,1,0,1
20910_0,,,,2,2,1,3
C(C(C=O)C(C)C(C(C)=O)O)(O)=O,,,5,1,1,0,1
20912_0,,,,2,2,1,3
C(CC(C(C(C)=O)O)CC=O)(O)=O,,,5,1,2,0,2
20913_0,,,,2,2,1,3
20915_0,,,,2,2,1,3
C(C(CC(CO)=O)C(C(C)=O)O)=O,,,5,1,1,0,1
20917_0,,,,2,2,1,3
C(CC(C(CO)=O)C(C(C)=O)O)=O,,,5,1,1,0,1
20919_0,,,,2,2,1,3
C(C(C(C=O)C(C=O)CO)O)(C)=O,,,5,1,1,0,1
20921_0,,,,2,2,1,3
C(CC(C=O)(CO)C(C(C)=O)O)=O,,,5,1,1,0,1
20923_0,,,,2,2,1,3
C(CCC(C(C)=O)O)=O,,,5,1,1,0,1
20925_0,,,,2,2,1,3
C(C)(C(CCC(C(O)=O)=O)O)=O,,,5,1,1,0,1
20927_0,,,,2,2,1,3
C(CCC(C(C)=O)O)(O)=O,,,5,1,1,0,1
20929_0,,,,2,2,1,3
C(C(C(C)=O)CC(C(C)=O)O)(O)=O,,,5,1,1,0,1
20931_0,,,,2,2,1,3
C1(C(CC(C(C)=O)O)CC(O)O1)=O,,,5,1,1,0,1
20933_0,,,,2,2,1,3
C1(C(C)C(C(O)O1)C(C(C)=O)O)=O,,,5,1,1,0,1
20935_0,,,,2,2,1,3
C(CC(C)C(C(C)=O)O)=O,,,5,1,1,0,1
20937_0,,,,2,2,1,3
C(C)(C(C(C)CC(C(O)=O)=O)O)=O,,,5,1,1,0,1
20939_0,,,,2,2,1,3
C(C)(C(CC(C(O)=O)CC=O)O)=O,,,5,1,1,0,1
20941_0,,,,2,2,1,3
C(C(C)(C(C(C)=O)O)CC=O)(O)=O,,,5,1,1,0,1
20943_0,,,,2,2,1,3
C(C(C(C=O)C(C(O)=O)C)O)(C)=O,,,5,1,1,0,1
20945_0,,,,2,2,1,3
C(CCC(C=O)C(C(CO)O)=O)=O,,,5,1,1,0,1
20947_0,,,,2,2,1,3
C(CCC(C(C(CC=O)=O)O)O)=O,,,5,1,1,0,1
20949_0,,,,2,2,1,3
C(C(CO)(CCC=O)O)(CC=O)=O,,,5,1,1,0,1
20951_0,,,,2,2,1,3
C(CCCC(C(C(C=O)O)=O)O)=O,,,5,1,1,0,1
20953_0,,,,2,2,1,3
C(C(C)(CCC=O)O)(C(C=O)O)=O,,,5,1,1,0,1
20955_0,,,,2,2,1,3
C(CCC(C=O)(C(C(C)O)=O)O)=O,,,5,1,1,0,1
20957_0,,,,2,2,1,3
C(C(C(C(O)=O)=O)(CCC=O)O)=O,,,5,1,1,0,1
20959_0,,,,2,2,1,3
C(CCCC(C(C(CO)=O)O)=O)=O,,,5,1,1,0,1
20961_0,,,,2,2,1,3
C(CCC(C(C(C(C)=O)O)=O)O)=O,,,5,1,1,0,1
20963_0,,,,2,2,1,3
C(CCC(C(C)=O)(C(CO)=O)O)=O,,,5,1,1,0,1
20965_0,,,,2,2,1,3
C(CCC(CO)C(CC(C)O)O)=O,,,5,1,1,0,1
20967_0,,,,2,2,1,3
C(CCC(CC(CC(C)O)O)O)=O,,,5,1,1,0,1
20969_0,,,,2,2,1,3
C(CCC(C(C)O)C(CCO)O)=O,,,5,1,1,0,1
20971_0,,,,2,2,1,3
C(CCC(CC(C)O)(CCO)O)=O,,,5,1,1,0,1
20973_0,,,,2,2,1,3
C(CCCC(CC(CCO)O)O)=O,,,5,1,1,0,1
20975_0,,,,2,2,1,3
C(CCC(C)(CC(CCO)O)O)=O,,,5,1,1,0,1
20977_0,,,,2,2,1,3
C(CCC(C(CO)C(C)O)O)=O,,,5,1,1,0,1
20979_0,,,,2,2,1,3
C(CCC(C(CO)C(C)O)O)(O)=O,,,5,1,1,0,1
20980_0,,,,2,2,1,3
20982_0,,,,2,2,1,3
C(CCC(CO)(CO)C(C)O)=O,,,5,1,1,0,1
20984_0,,,,2,2,1,3
C(CCC(CO)(CO)C(C)O)(O)=O,,,5,1,1,0,1
20985_0,,,,2,2,1,3
20987_0,,,,2,2,1,3
C(CCCC(C(CO)CO)O)=O,,,5,1,1,0,1
20989_0,,,,2,2,1,3
C(CCCC(C(CO)CO)O)(O)=O,,,5,1,1,0,1
20990_0,,,,2,2,1,3
20992_0,,,,2,2,1,3
C(CCC(C)(C(CO)CO)O)=O,,,5,1,1,0,1
20994_0,,,,2,2,1,3
C(CCC(C)(C(CO)CO)O)(O)=O,,,5,1,1,0,1
20995_0,,,,2,2,1,3
20997_0,,,,2,2,1,3
C(CCCC(C(CO)C(C)O)O)=O,,,5,1,1,0,1
20999_0,,,,2,2,1,3
C(CCC(C)(C(CO)C(C)O)O)=O,,,5,1,1,0,1
21001_0,,,,2,2,1,3
C(CCC(CO)(C(C)O)C(C)O)=O,,,5,1,1,0,1
21003_0,,,,2,2,1,3
C(CCC(C(C(C)O)C(C)O)O)=O,,,5,1,1,0,1
21005_0,,,,2,2,1,3
C(C(CCC=O)(CO)C(C)O)(O)=O,,,5,1,1,0,1
21007_0,,,,2,2,1,3
C(C(C(C)O)C(CCC=O)O)(O)=O,,,5,1,1,0,1
21009_0,,,,2,2,1,3
C(C(CO)C(CCCC=O)O)(O)=O,,,5,1,1,0,1
21011_0,,,,2,2,1,3
C(C(CO)C(C)(CCC=O)O)(O)=O,,,5,1,1,0,1
21013_0,,,,2,2,1,3
C(CC(C(CCC=O)CO)O)(O)=O,,,5,1,1,0,1
21015_0,,,,2,2,1,3
C(CC(CC(CCC=O)O)O)(O)=O,,,5,1,1,0,1
21017_0,,,,2,2,1,3
C(C(CCC=O)C(CCO)O)(O)=O,,,5,1,1,0,1
21019_0,,,,2,2,1,3
C(CC(CCC=O)(CCO)O)(O)=O,,,5,1,1,0,1
21021_0,,,,2,2,1,3
C(C(CO)C(CCC=O)O)(O)=O,,,5,1,1,0,1
21023_0,,,,2,2,1,3
C(C(CO)C(CCC(O)=O)O)(O)=O,,,5,1,1,0,1
21024_0,,,,2,2,1,3
21026_0,,,,2,2,1,3
C(C(CCC=O)(CO)CO)(O)=O,,,5,1,1,0,1
21028_0,,,,2,2,1,3
C(C(CCC(O)=O)(CO)CO)(O)=O,,,5,1,1,0,1
21029_0,,,,2,2,1,3
21031_0,,,,2,2,1,3
C(C(C(O)=O)(CCC=O)CO)(O)=O,,,5,1,1,0,1
21033_0,,,,2,2,1,3
C(C(C(O)=O)C(CCC=O)O)(O)=O,,,5,1,1,0,1
21035_0,,,,2,2,1,3
C(CCC(CO)C(C(CO)=O)O)=O,,,5,1,1,0,1
21037_0,,,,2,2,1,3
C(CCC(CC(C(CO)=O)O)O)=O,,,5,1,1,0,1
21039_0,,,,2,2,1,3
C(CCC(C(C(CCO)O)=O)O)=O,,,5,1,1,0,1
21041_0,,,,2,2,1,3
C(CCC(C(CO)=O)(CCO)O)=O,,,5,1,1,0,1
21043_0,,,,2,2,1,3
C(C(CO)(C(CO)CCC=O)O)=O,,,5,1,1,0,1
21045_0,,,,2,2,1,3
C(C(CO)(CC(CCC=O)O)O)=O,,,5,1,1,0,1
21047_0,,,,2,2,1,3
C(C(C(CCC=O)O)(CCO)O)=O,,,5,1,1,0,1
21049_0,,,,2,2,1,3
C(C(CCO)CC(CO)CO)(O)=O,,,5,1,1,0,1
21051_0,,,,2,2,1,3
C(C(C)C(CO)C(CO)CO)(O)=O,,,5,1,1,0,1
21053_0,,,,2,2,1,3
C(CC(C)C(CO)CO)(O)=O,,,5,1,1,0,1
21055_0,,,,2,2,1,3
C(C(C=O)CC(CO)CO)(O)=O,,,5,1,1,0,1
21057_0,,,,2,2,1,3
C(CC(CC(C)O)C(CO)CO)=O,,,5,1,1,0,1
21059_0,,,,2,2,1,3
C(C(CC(CO)CO)C(C)O)=O,,,5,1,1,0,1
21061_0,,,,2,2,1,3
C(C(CO)C(C)C(CO)CO)=O,,,5,1,1,0,1
21063_0,,,,2,2,1,3
C(C(C(C)O)C(C)C(CO)CO)=O,,,5,1,1,0,1
21065_0,,,,2,2,1,3
C(C(C=O)C(C)C(CO)CO)(O)=O,,,5,1,1,0,1
21067_0,,,,2,2,1,3
C(CC(C(CO)CO)CC=O)(O)=O,,,5,1,2,0,2
21068_0,,,,2,2,1,3
21070_0,,,,2,2,1,3
C(C(C(CO)CO)CC(CO)=O)=O,,,5,1,1,0,1
21072_0,,,,2,2,1,3
C(CO)(C(C(CO)CO)CC=O)=O,,,5,1,1,0,1
21074_0,,,,2,2,1,3
C(C(C(CO)CO)C(C=O)CO)=O,,,5,1,1,0,1
21076_0,,,,2,2,1,3
C(C(CO)(C(CO)CO)CC=O)=O,,,5,1,1,0,1
21078_0,,,,2,2,1,3
C(CCC(CO)CO)=O,,,5,1,1,0,1
21080_0,,,,2,2,1,3
C(C(CCC(CO)CO)=O)(O)=O,,,5,1,1,0,1
21082_0,,,,2,2,1,3
C(CCC(CO)CO)(O)=O,,,5,1,1,0,1
21084_0,,,,2,2,1,3
C(C(C(C)=O)CC(CO)CO)(O)=O,,,5,1,1,0,1
21086_0,,,,2,2,1,3
C1(C(CC(O)O1)CC(CO)CO)=O,,,5,1,1,0,1
21088_0,,,,2,2,1,3
C1(C(C)C(C(O)O1)C(CO)CO)=O,,,5,1,1,0,1
21089_0,,,,2,2,1,3
21090_0,,,,2,2,1,3
21091_0,,,,2,2,1,3
21092_0,,,,2,2,1,3
21093_0,,,,2,2,1,3
21095_0,,,,2,2,1,3
C(C(CC(CCO)O)CCO)(O)=O,,,5,1,1,0,1
21097_0,,,,2,2,1,3
C(C(C)C(CO)C(CCO)O)(O)=O,,,5,1,1,0,1
21099_0,,,,2,2,1,3
C(CC(C)C(CCO)O)(O)=O,,,5,1,1,0,1
21101_0,,,,2,2,1,3
C(C(C=O)CC(CCO)O)(O)=O,,,5,1,1,0,1
21103_0,,,,2,2,1,3
C(CC(CC(C)O)C(CCO)O)=O,,,5,1,1,0,1
21105_0,,,,2,2,1,3
C(C(CC(CCO)O)C(C)O)=O,,,5,1,1,0,1
21107_0,,,,2,2,1,3
C(C(CO)C(C)C(CCO)O)=O,,,5,1,1,0,1
21109_0,,,,2,2,1,3
C(C(C(C)O)C(C)C(CCO)O)=O,,,5,1,1,0,1
21111_0,,,,2,2,1,3
C(C(C=O)C(C)C(CCO)O)(O)=O,,,5,1,1,0,1
21113_0,,,,2,2,1,3
C(CC(C(CCO)O)CC=O)(O)=O,,,5,1,2,0,2
21114_0,,,,2,2,1,3
21116_0,,,,2,2,1,3
C(C(C(CCO)O)CC(CO)=O)=O,,,5,1,1,0,1
21118_0,,,,2,2,1,3
C(CO)(C(C(CCO)O)CC=O)=O,,,5,1,1,0,1
21120_0,,,,2,2,1,3
C(C(C(CCO)O)C(C=O)CO)=O,,,5,1,1,0,1
21122_0,,,,2,2,1,3
C(C(CO)(C(CCO)O)CC=O)=O,,,5,1,1,0,1
21124_0,,,,2,2,1,3
C(CCC(CCO)O)=O,,,5,1,1,0,1
21126_0,,,,2,2,1,3
C(C(CCC(CCO)O)=O)(O)=O,,,5,1,1,0,1
21128_0,,,,2,2,1,3
C(CCC(CCO)O)(O)=O,,,5,1,1,0,1
21130_0,,,,2,2,1,3
C(C(C(C)=O)CC(CCO)O)(O)=O,,,5,1,1,0,1
21132_0,,,,2,2,1,3
C1(C(CC(O)O1)CC(CCO)O)=O,,,5,1,1,0,1
21134_0,,,,2,2,1,3
C1(C(C)C(C(O)O1)C(CCO)O)=O,,,5,1,1,0,1
21135_0,,,,2,2,1,3
21136_0,,,,2,2,1,3
21137_0,,,,2,2,1,3
21138_0,,,,2,2,1,3
21139_0,,,,2,2,1,3
21140_0,,,,2,2,1,3
21142_0,,,,2,2,1,3
C(C(C)(C(CCC(O)=O)O)O)(O)=O,,,5,1,1,0,1
21144_0,,,,2,2,1,3
C(C(C)(C(C(C)CC=O)O)O)(O)=O,,,5,1,1,0,1
21146_0,,,,2,2,1,3
C(C(CO)(CCCC=O)O)(O)=O,,,5,1,1,0,1
21148_0,,,,2,2,1,3
C(C(CO)(CCCC(O)=O)O)(O)=O,,,5,1,1,0,1
21149_0,,,,2,2,1,3
21151_0,,,,2,2,1,3
C(C(CC(C=CC)O)CCO)(O)=O,,,5,1,1,0,1
21153_0,,,,2,2,1,3
C(C(C)C(CO)C(C=CC)O)(O)=O,,,5,1,1,0,1
21155_0,,,,2,2,1,3
C(CC(C)C(C=CC)O)(O)=O,,,5,1,1,0,1
21157_0,,,,2,2,1,3
C(C(C=O)CC(C=CC)O)(O)=O,,,5,1,1,0,1
21159_0,,,,2,2,1,3
C(CC(CC(C)O)C(C=CC)O)=O,,,5,1,1,0,1
21161_0,,,,2,2,1,3
C(C(CC(C=CC)O)C(C)O)=O,,,5,1,1,0,1
21163_0,,,,2,2,1,3
C(C(CO)C(C)C(C=CC)O)=O,,,5,1,1,0,1
21165_0,,,,2,2,1,3
C(C(C(C)O)C(C)C(C=CC)O)=O,,,5,1,1,0,1
21167_0,,,,2,2,1,3
C(C(C=O)C(C)C(C=CC)O)(O)=O,,,5,1,1,0,1
21169_0,,,,2,2,1,3
C(CC(C(C=CC)O)CC=O)(O)=O,,,5,1,2,0,2
21170_0,,,,2,2,1,3
21172_0,,,,2,2,1,3
C(C(CC(CO)=O)C(C=CC)O)=O,,,5,1,1,0,1
21174_0,,,,2,2,1,3
C(CC(C(CO)=O)C(C=CC)O)=O,,,5,1,1,0,1
21176_0,,,,2,2,1,3
C(C(CO)C(C=O)C(C=CC)O)=O,,,5,1,1,0,1
21178_0,,,,2,2,1,3
C(CC(C=O)(CO)C(C=CC)O)=O,,,5,1,1,0,1
21180_0,,,,2,2,1,3
C(CCC(C=CC)O)=O,,,5,1,1,0,1
21182_0,,,,2,2,1,3
C(C(CCC(C(O)=O)=O)O)=CC,,,5,1,1,0,1
21184_0,,,,2,2,1,3
C(CCC(C=CC)O)(O)=O,,,5,1,1,0,1
21186_0,,,,2,2,1,3
C(C(C(C)=O)CC(C=CC)O)(O)=O,,,5,1,1,0,1
21188_0,,,,2,2,1,3
C1(C(CC(C=CC)O)CC(O)O1)=O,,,5,1,1,0,1
21190_0,,,,2,2,1,3
C1(C(C)C(C(O)O1)C(C=CC)O)=O,,,5,1,1,0,1
21191_0,,,,2,2,1,3
21193_0,,,,2,2,1,3
C(C(C(C)CC(C(O)=O)=O)O)=CC,,,5,1,1,0,1
21195_0,,,,2,2,1,3
C(C(CC(C=CC)O)CC=O)(O)=O,,,5,1,1,0,1
21197_0,,,,2,2,1,3
C(C(C)(C(C=CC)O)CC=O)(O)=O,,,5,1,1,0,1
21199_0,,,,2,2,1,3
C(C(C)C(C=O)C(C=CC)O)(O)=O,,,5,1,1,0,1
21201_0,,,,2,2,1,3
C(C(CCC=CCO)CCO)(O)=O,,,5,1,1,0,1
21203_0,,,,2,2,1,3
C(C(C)C(CO)CC=CCO)(O)=O,,,5,1,1,0,1
21205_0,,,,2,2,1,3
C(CC(C)CC=CCO)(O)=O,,,5,1,1,0,1
21207_0,,,,2,2,1,3
C(C(C=O)CCC=CCO)(O)=O,,,5,1,1,0,1
21209_0,,,,2,2,1,3
C(CC(CC(C)O)CC=CCO)=O,,,5,1,1,0,1
21211_0,,,,2,2,1,3
C(C(CCC=CCO)C(C)O)=O,,,5,1,1,0,1
21213_0,,,,2,2,1,3
C(C(CO)C(C)CC=CCO)=O,,,5,1,1,0,1
21215_0,,,,2,2,1,3
C(C(C(C)O)C(C)CC=CCO)=O,,,5,1,1,0,1
21217_0,,,,2,2,1,3
C(C(C=O)C(C)CC=CCO)(O)=O,,,5,1,1,0,1
21219_0,,,,2,2,1,3
C(CC(CC=O)CC=CCO)(O)=O,,,5,1,2,0,2
21220_0,,,,2,2,1,3
21222_0,,,,2,2,1,3
C(C(CC(CO)=O)CC=CCO)=O,,,5,1,1,0,1
21224_0,,,,2,2,1,3
C(CC(C(CO)=O)CC=CCO)=O,,,5,1,1,0,1
21226_0,,,,2,2,1,3
C(C(CO)C(C=O)CC=CCO)=O,,,5,1,1,0,1
21228_0,,,,2,2,1,3
C(C(CO)(CC=O)CC=CCO)=O,,,5,1,1,0,1
21230_0,,,,2,2,1,3
C(CCCC=CCO)=O,,,5,1,1,0,1
21232_0,,,,2,2,1,3
C(CCCC(C(O)=O)=O)=CCO,,,5,1,1,0,1
21234_0,,,,2,2,1,3
C(CCCC=CCO)(O)=O,,,5,1,1,0,1
21236_0,,,,2,2,1,3
C(C)(C(C(O)=O)CCC=CCO)=O,,,5,1,1,0,1
21238_0,,,,2,2,1,3
C1(C(CCC=CCO)CC(O)O1)=O,,,5,1,1,0,1
21240_0,,,,2,2,1,3
C1(C(C)C(C(O)O1)CC=CCO)=O,,,5,1,1,0,1
21241_0,,,,2,2,1,3
21242_0,,,,2,2,1,3
21243_0,,,,2,2,1,3
21244_0,,,,2,2,1,3
21245_0,,,,2,2,1,3
21247_0,,,,2,2,1,3
C(C(CC(C=C)CO)CCO)(O)=O,,,5,1,1,0,1
21249_0,,,,2,2,1,3
C(C(C)C(CO)C(C=C)CO)(O)=O,,,5,1,1,0,1
21251_0,,,,2,2,1,3
C(CC(C)C(C=C)CO)(O)=O,,,5,1,1,0,1
21253_0,,,,2,2,1,3
C(C(C=O)CC(C=C)CO)(O)=O,,,5,1,1,0,1
21255_0,,,,2,2,1,3
C(CC(CC(C)O)C(C=C)CO)=O,,,5,1,1,0,1
21257_0,,,,2,2,1,3
C(C(CC(C=C)CO)C(C)O)=O,,,5,1,1,0,1
21259_0,,,,2,2,1,3
C(C(CO)C(C)C(C=C)CO)=O,,,5,1,1,0,1
21261_0,,,,2,2,1,3
C(C(C(C)C(C=C)CO)C(C)O)=O,,,5,1,1,0,1
21263_0,,,,2,2,1,3
C(C(C=O)C(C)C(C=C)CO)(O)=O,,,5,1,1,0,1
21265_0,,,,2,2,1,3
C(CC(CC=O)C(C=C)CO)(O)=O,,,5,1,2,0,2
21266_0,,,,2,2,1,3
21268_0,,,,2,2,1,3
C(CC(C=O)C(C=C)CO)(CO)=O,,,5,1,1,0,1
21270_0,,,,2,2,1,3
C(CC(C(CO)=O)C(C=C)CO)=O,,,5,1,1,0,1
21272_0,,,,2,2,1,3
C(C(CO)C(C=O)C(C=C)CO)=O,,,5,1,1,0,1
21274_0,,,,2,2,1,3
C(C(CO)(CC=O)C(C=C)CO)=O,,,5,1,1,0,1
21276_0,,,,2,2,1,3
C(CCC(C=C)CO)=O,,,5,1,1,0,1
21278_0,,,,2,2,1,3
C(C(CCC(C(O)=O)=O)CO)=C,,,5,1,1,0,1
21280_0,,,,2,2,1,3
C(CCC(C=C)CO)(O)=O,,,5,1,1,0,1
21282_0,,,,2,2,1,3
C(C(C(C)=O)CC(C=C)CO)(O)=O,,,5,1,1,0,1
21284_0,,,,2,2,1,3
C1(C(CC(C=C)CO)CC(O)O1)=O,,,5,1,1,0,1
21286_0,,,,2,2,1,3
C1(C(C)C(C(O)O1)C(C=C)CO)=O,,,5,1,1,0,1
21287_0,,,,2,2,1,3
21288_0,,,,2,2,1,3
21289_0,,,,2,2,1,3
21290_0,,,,2,2,1,3
21291_0,,,,2,2,1,3
21293_0,,,,2,2,1,3
C(C(CC(CC=C)O)CCO)(O)=O,,,5,1,1,0,1
21295_0,,,,2,2,1,3
C(C(C)C(CO)C(CC=C)O)(O)=O,,,5,1,1,0,1
21297_0,,,,2,2,1,3
C(CC(C)C(CC=C)O)(O)=O,,,5,1,1,0,1
21299_0,,,,2,2,1,3
C(C(C=O)CC(CC=C)O)(O)=O,,,5,1,1,0,1
21301_0,,,,2,2,1,3
C(CC(C(CC=C)O)CC(C)O)=O,,,5,1,1,0,1
21303_0,,,,2,2,1,3
C(C(CC(CC=C)O)C(C)O)=O,,,5,1,1,0,1
21305_0,,,,2,2,1,3
C(C(CO)C(C)C(CC=C)O)=O,,,5,1,1,0,1
21307_0,,,,2,2,1,3
C(C(C(C)O)C(C)C(CC=C)O)=O,,,5,1,1,0,1
21309_0,,,,2,2,1,3
C(C(C=O)C(C)C(CC=C)O)(O)=O,,,5,1,1,0,1
21311_0,,,,2,2,1,3
C(CC(C(CC=C)O)CC=O)(O)=O,,,5,1,2,0,2
21312_0,,,,2,2,1,3
21314_0,,,,2,2,1,3
C(C(C(CC=C)O)CC(CO)=O)=O,,,5,1,1,0,1
21316_0,,,,2,2,1,3
C(CO)(C(C(CC=C)O)CC=O)=O,,,5,1,1,0,1
21318_0,,,,2,2,1,3
C(C(C(CC=C)O)C(C=O)CO)=O,,,5,1,1,0,1
21320_0,,,,2,2,1,3
C(C(CO)(C(CC=C)O)CC=O)=O,,,5,1,1,0,1
21322_0,,,,2,2,1,3
C(CCC(CC=C)O)=O,,,5,1,1,0,1
21324_0,,,,2,2,1,3
C=CCC(CCC(C(O)=O)=O)O,,,5,1,1,0,1
21326_0,,,,2,2,1,3
C(CCC(CC=C)O)(O)=O,,,5,1,1,0,1
21328_0,,,,2,2,1,3
C(C(C(C)=O)CC(CC=C)O)(O)=O,,,5,1,1,0,1
21330_0,,,,2,2,1,3
C1(C(CC(CC=C)O)CC(O)O1)=O,,,5,1,1,0,1
21332_0,,,,2,2,1,3
C1(C(C)C(C(O)O1)C(CC=C)O)=O,,,5,1,1,0,1
21333_0,,,,2,2,1,3
21335_0,,,,2,2,1,3
C=CCC(C(C)CC(C(O)=O)=O)O,,,5,1,1,0,1
21337_0,,,,2,2,1,3
C(C(CC(CC=C)O)CC=O)(O)=O,,,5,1,1,0,1
21339_0,,,,2,2,1,3
C(C(C)(C(CC=C)O)CC=O)(O)=O,,,5,1,1,0,1
21341_0,,,,2,2,1,3
C(C(C)C(C=O)C(CC=C)O)(O)=O,,,5,1,1,0,1
21343_0,,,,2,2,1,3
C(CCC(C(C(O)=O)=C)CO)=O,,,5,1,1,0,1
21345_0,,,,2,2,1,3
C(CCC(C(C(O)=O)=C)CO)(O)=O,,,5,1,1,0,1
21346_0,,,,2,2,1,3
21348_0,,,,2,2,1,3
C(CCC(CC(C(O)=O)=C)O)=O,,,5,1,1,0,1
21350_0,,,,2,2,1,3
C(CCC(CC(C(O)=O)=C)O)(O)=O,,,5,1,1,0,1
21352_0,,,,2,2,1,3
C(CC(C)C(CC(C(O)=O)=C)O)=O,,,5,1,1,0,1
21354_0,,,,2,2,1,3
C(C(CCO)CCC(C=C)O)(O)=O,,,5,1,1,0,1
21356_0,,,,2,2,1,3
C(C(CC(C=C)(C)O)CCO)(O)=O,,,5,1,1,0,1
21357_0,,,,2,2,1,3
21358_0,,,,2,2,1,3
21359_0,,,,2,2,1,3
21360_0,,,,2,2,1,3
21361_0,,,,2,2,1,3
21362_0,,,,2,2,1,3
21363_0,,,,2,2,1,3
21364_0,,,,2,2,1,3
21365_0,,,,2,2,1,3
21366_0,,,,2,2,1,3
21367_0,,,,2,2,1,3
21369_0,,,,2,2,1,3
C(CCCC(C(O)=O)=CCO)=O,,,5,1,1,0,1
21371_0,,,,2,2,1,3
C(CCCC(C(O)=O)=CCO)(O)=O,,,5,1,1,0,1
21372_0,,,,2,2,1,3
21374_0,,,,2,2,1,3
C(CCC(C=C(C(O)=O)C)O)=O,,,5,1,1,0,1
21376_0,,,,2,2,1,3
C(CCC(C=C(C(O)=O)C)O)(O)=O,,,5,1,1,0,1
21378_0,,,,2,2,1,3
C(CC(C)C(C=C(C(O)=O)C)O)=O,,,5,1,1,0,1
21380_0,,,,2,2,1,3
C(C(C)C(CO)CC(C=C)O)(O)=O,,,5,1,1,0,1
21382_0,,,,2,2,1,3
C(C(C)C(CO)C(C=C)(C)O)(O)=O,,,5,1,1,0,1
21383_0,,,,2,2,1,3
21384_0,,,,2,2,1,3
21385_0,,,,2,2,1,3
21386_0,,,,2,2,1,3
21387_0,,,,2,2,1,3
21388_0,,,,2,2,1,3
21389_0,,,,2,2,1,3
21390_0,,,,2,2,1,3
21391_0,,,,2,2,1,3
21392_0,,,,2,2,1,3
21393_0,,,,2,2,1,3
21395_0,,,,2,2,1,3
C(C(C(O)=O)(CCCC=O)O)(O)=O,,,5,1,1,0,1
21397_0,,,,2,2,1,3
C(CC(C)CC=CC(O)=O)(O)=O,,,5,1,1,0,1
21399_0,,,,2,2,1,3
C(C(C(O)=O)CCC=CC(O)=O)=O,,,5,1,1,0,1
21401_0,,,,2,2,1,3
C(C(CCC=CC(O)=O)C(C)O)=O,,,5,1,1,0,1
21403_0,,,,2,2,1,3
C(C(CO)C(C)CC=CC(O)=O)=O,,,5,1,1,0,1
21405_0,,,,2,2,1,3
C(CCCC=CC(O)=O)=O,,,5,1,1,0,1
21407_0,,,,2,2,1,3
C(CCCC(C(O)=O)=O)=CC(O)=O,,,5,1,1,0,1
21409_0,,,,2,2,1,3
C(CCCC=CC(O)=O)(O)=O,,,5,1,1,0,1
21410_0,,,,2,2,1,3
21412_0,,,,2,2,1,3
C(C(C=C)C(C)CC(O)=O)(O)=O,,,5,1,1,0,1
21414_0,,,,2,2,1,3
C(C(C=C)(C(C)CC(O)=O)O)(O)=O,,,5,1,1,0,1
21416_0,,,,2,2,1,3
C(C(C(C=O)=O)C(C)CC(O)=O)=O,,,5,1,1,0,1
21418_0,,,,2,2,1,3
C(CC(C)CCC(C(O)=O)=O)(O)=O,,,5,1,1,0,1
21420_0,,,,2,2,1,3
C(CC(C)C(C(C(O)=O)=O)C)(O)=O,,,5,1,1,0,1
21422_0,,,,2,2,1,3
C(CC(C)CC(C(C)O)=O)(O)=O,,,5,1,1,0,1
21424_0,,,,2,2,1,3
C(CC(C)CC(C(C)=O)O)(O)=O,,,5,1,1,0,1
21426_0,,,,2,2,1,3
C(CC(C)C(C(C)=O)(C)O)(O)=O,,,5,1,1,0,1
21428_0,,,,2,2,1,3
C(CC(C)C(C(CC)=O)O)(O)=O,,,5,1,1,0,1
21430_0,,,,2,2,1,3
C(CC(C)CCC(CO)=O)(O)=O,,,5,1,1,0,1
21432_0,,,,2,2,1,3
C(CC(C)C(C(CO)=O)C)(O)=O,,,5,1,1,0,1
21434_0,,,,2,2,1,3
C(CC(C)CC(C(C=O)=C)O)(O)=O,,,5,1,1,0,1
21436_0,,,,2,2,1,3
C(CC(C)C(C(C=O)=C)(C)O)(O)=O,,,5,1,1,0,1
21438_0,,,,2,2,1,3
C(CC(C)C(C(C=O)=CC)O)(O)=O,,,5,1,1,0,1
21440_0,,,,2,2,1,3
C(CC(C)CC=C(C=O)CO)(O)=O,,,5,1,1,0,1
21442_0,,,,2,2,1,3
C(CC(C)CC(C=C)O)(O)=O,,,5,1,1,0,1
21444_0,,,,2,2,1,3
C(CC(C)C(C=C)(C)O)(O)=O,,,5,1,1,0,1
21446_0,,,,2,2,1,3
C(CC(C)C(C=C)(CO)O)(O)=O,,,5,1,1,0,1
21448_0,,,,2,2,1,3
C(CC(C)C(C(C=C)O)O)(O)=O,,,5,1,1,0,1
21450_0,,,,2,2,1,3
C(CC(C)C(CO)(CO)O)(O)=O,,,5,1,1,0,1
21452_0,,,,2,2,1,3
C(CC(C)C(C(CO)O)O)(O)=O,,,5,1,1,0,1
21454_0,,,,2,2,1,3
C(C(CC)(C(C)CC(O)=O)O)=O,,,5,1,1,0,1
21456_0,,,,2,2,1,3
C(CC(C)CCC(C=O)O)(O)=O,,,5,1,1,0,1
21458_0,,,,2,2,1,3
C(CC(C)C(C)C(C=O)O)(O)=O,,,5,1,1,0,1
21460_0,,,,2,2,1,3
C(C(CCO)C(C)CC(O)=O)=O,,,5,1,1,0,1
21462_0,,,,2,2,1,3
C(CC(C)C(CCC=O)O)(O)=O,,,5,1,1,0,1
21464_0,,,,2,2,1,3
C(CC(C)C(CO)CC=O)(O)=O,,,5,1,1,0,1
21466_0,,,,2,2,1,3
C(CC(C)C1C(C(OC1)=O)=O)(O)=O,,,5,1,1,0,1
21468_0,,,,2,2,1,3
C(CC(C)C1CC(C(O1)=O)=O)(O)=O,,,5,1,1,0,1
21470_0,,,,2,2,1,3
C(C(C(C)CC(O)=O)C(C)CO)=O,,,5,1,1,0,1
21472_0,,,,2,2,1,3
C(CC(C)CC(CO)CC=O)(O)=O,,,5,1,1,0,1
21474_0,,,,2,2,1,3
C(CC(C)C(C)(CO)CC=O)(O)=O,,,5,1,1,0,1
21476_0,,,,2,2,1,3
C(CC(C)C(C(C)CC=O)O)(O)=O,,,5,1,1,0,1
21477_0,,,,2,2,1,3
21478_0,,,,2,2,1,3
21479_0,,,,2,2,1,3
21480_0,,,,2,2,1,3
21481_0,,,,2,2,1,3
21482_0,,,,2,2,1,3
21483_0,,,,2,2,1,3
21484_0,,,,2,2,1,3
21485_0,,,,2,2,1,3
21486_0,,,,2,2,1,3
21487_0,,,,2,2,1,3
21488_0,,,,2,2,1,3
21489_0,,,,2,2,1,3
21490_0,,,,2,2,1,3
21491_0,,,,2,2,1,3
21492_0,,,,2,2,1,3
21493_0,,,,2,2,1,3
21494_0,,,,2,2,1,3
21495_0,,,,2,2,1,3
21496_0,,,,2,2,1,3
21497_0,,,,2,2,1,3
21498_0,,,,2,2,1,3
21499_0,,,,2,2,1,3
21500_0,,,,2,2,1,3
21501_0,,,,2,2,1,3
21502_0,,,,2,2,1,3
21503_0,,,,2,2,1,3
21504_0,,,,2,2,1,3
21505_0,,,,2,2,1,3
21506_0,,,,2,2,1,3
21507_0,,,,2,2,1,3
21508_0,,,,2,2,1,3
21509_0,,,,2,2,1,3
21510_0,,,,2,2,1,3
21511_0,,,,2,2,1,3
21512_0,,,,2,2,1,3
21513_0,,,,2,2,1,3
21514_0,,,,2,2,1,3
21515_0,,,,2,2,1,3
21517_0,,,,2,2,1,3
C(C(C(O)=O)CC(C(O)=O)C=C)=O,,,5,1,1,0,1
21519_0,,,,2,2,1,3
C(C(C=C)CC(C=O)C(C)O)(O)=O,,,5,1,1,0,1
21521_0,,,,2,2,1,3
C(C(C=C)C(C)C(C=O)CO)(O)=O,,,5,1,1,0,1
21523_0,,,,2,2,1,3
C(CCC(C(O)=O)C=C)=O,,,5,1,1,0,1
21525_0,,,,2,2,1,3
C(C(C=C)CCC(C(O)=O)=O)(O)=O,,,5,1,1,0,1
21527_0,,,,2,2,1,3
C(C(C=C)CCC(O)=O)(O)=O,,,5,1,1,0,1
21528_0,,,,2,2,1,3
21530_0,,,,2,2,1,3
C(CCC(C(O)=O)C(C(O)=O)=C)=O,,,5,1,1,0,1
21531_0,,,,2,2,1,3
21532_0,,,,2,2,1,3
21533_0,,,,2,2,1,3
21534_0,,,,2,2,1,3
21535_0,,,,2,2,1,3
21536_0,,,,2,2,1,3
21538_0,,,,2,2,1,3
C(CCCC(C(O)=O)=CC(O)=O)=O,,,5,1,1,0,1
21539_0,,,,2,2,1,3
21540_0,,,,2,2,1,3
21541_0,,,,2,2,1,3
21542_0,,,,2,2,1,3
21543_0,,,,2,2,1,3
21544_0,,,,2,2,1,3
21545_0,,,,2,2,1,3
21546_0,,,,2,2,1,3
21547_0,,,,2,2,1,3
21548_0,,,,2,2,1,3
21549_0,,,,2,2,1,3
21550_0,,,,2,2,1,3
21552_0,,,,2,2,1,3
C(C(C=O)(C(CCCC=O)O)O)=O,,,5,1,1,0,1
21554_0,,,,2,2,1,3
C(C(C=O)(C(C)(CCC=O)O)O)=O,,,5,1,1,0,1
21556_0,,,,2,2,1,3
C(C(C=O)(C(CCC=O)O)O)(O)=O,,,5,1,1,0,1
21558_0,,,,2,2,1,3
C(C(C)(C(CCCC=O)O)O)(O)=O,,,5,1,1,0,1
21560_0,,,,2,2,1,3
C(C(C)(C(C)(CCC=O)O)O)(O)=O,,,5,1,1,0,1
21562_0,,,,2,2,1,3
C(C(C(C)O)(CCCC=O)O)(O)=O,,,5,1,1,0,1
21564_0,,,,2,2,1,3
C(C(C=C)(CCC=O)O)(O)=O,,,5,1,1,0,1
21566_0,,,,2,2,1,3
C(C(C=C)(CCC(O)=O)O)(O)=O,,,5,1,1,0,1
21567_0,,,,2,2,1,3
21569_0,,,,2,2,1,3
C(C(CCC=O)C(C(O)=O)O)(O)=O,,,5,1,1,0,1
21571_0,,,,2,2,1,3
C(C(CCO)C(C(O)=O)O)(O)=O,,,5,1,1,0,1
21573_0,,,,2,2,1,3
C(C(CCCO)C(C(O)=O)O)(O)=O,,,5,1,1,0,1
21575_0,,,,2,2,1,3
C(C(CC(C)O)C(C(O)=O)O)(O)=O,,,5,1,1,0,1
21577_0,,,,2,2,1,3
C(C(C=O)CCC(C(C)O)=O)(O)=O,,,5,1,1,0,1
21579_0,,,,2,2,1,3
C(C(C=O)CCC(C(C)=O)O)(O)=O,,,5,1,1,0,1
21581_0,,,,2,2,1,3
C(C(C=O)CC(C(C)=O)(C)O)(O)=O,,,5,1,1,0,1
21583_0,,,,2,2,1,3
C(C(C=O)CC(C(CC)=O)O)(O)=O,,,5,1,1,0,1
21585_0,,,,2,2,1,3
C(C(C=O)CCCC(CO)=O)(O)=O,,,5,1,1,0,1
21587_0,,,,2,2,1,3
C(C(C=O)CC(C(CO)=O)C)(O)=O,,,5,1,1,0,1
21589_0,,,,2,2,1,3
C(C(C=O)CCC(C=C)O)(O)=O,,,5,1,1,0,1
21591_0,,,,2,2,1,3
C(C(C=O)CC(C=C)(C)O)(O)=O,,,5,1,1,0,1
21593_0,,,,2,2,1,3
C(C(C=O)CC(C=C)(CO)O)(O)=O,,,5,1,1,0,1
21595_0,,,,2,2,1,3
C(C(C=O)CC(C(C=C)O)O)(O)=O,,,5,1,1,0,1
21597_0,,,,2,2,1,3
C(C(C=O)CC(CO)(CO)O)(O)=O,,,5,1,1,0,1
21599_0,,,,2,2,1,3
C(C(C=O)CC(C(CO)O)O)(O)=O,,,5,1,1,0,1
21601_0,,,,2,2,1,3
C(C(C=O)CC(C=O)(CC)O)(O)=O,,,5,1,1,0,1
21603_0,,,,2,2,1,3
C(C(C=O)CCCC(C=O)O)(O)=O,,,5,1,1,0,1
21605_0,,,,2,2,1,3
C(C(C=O)CC(C)C(C=O)O)(O)=O,,,5,1,1,0,1
21607_0,,,,2,2,1,3
C(C(C=O)CC(C=O)CCO)(O)=O,,,5,1,1,0,1
21609_0,,,,2,2,1,3
C(C(C=O)CC(CCC=O)O)(O)=O,,,5,1,1,0,1
21611_0,,,,2,2,1,3
C(C(C=O)CC(CO)CC=O)(O)=O,,,5,1,1,0,1
21613_0,,,,2,2,1,3
C(C(C(O)=O)CCC=O)=O,,,5,1,2,0,2
21615_0,,,,2,2,1,3
C(C(C=O)CC(C=O)C(C)O)(O)=O,,,5,1,2,0,2
21617_0,,,,2,2,1,3
C(C(C=O)CCC(CC=O)O)(O)=O,,,5,1,1,0,1
21619_0,,,,2,2,1,3
C(C(C=O)CC(C)(CC=O)O)(O)=O,,,5,1,1,0,1
21621_0,,,,2,2,1,3
C(C(C(O)=O)CC(C=O)C(O)=O)=O,,,5,1,1,0,1
21623_0,,,,2,2,1,3
C(C(C=O)CC(C(C=O)=O)O)(O)=O,,,5,1,1,0,1
21624_0,,,,2,2,1,3
21626_0,,,,2,2,1,3
C(C(C=O)CC(CO)O)(O)=O,,,5,1,1,0,1
21628_0,,,,2,2,1,3
C(C(C=O)CC(C=O)CO)(O)=O,,,5,1,1,0,1
21630_0,,,,2,2,1,3
C(C(C=O)CC(CC=O)O)(O)=O,,,5,1,1,0,1
21632_0,,,,2,2,1,3
C(C(C=O)CC(C=O)(C=O)O)(O)=O,,,5,1,1,0,1
21634_0,,,,2,2,1,3
C(C(C=O)CC(CO)C(C)O)(O)=O,,,5,1,1,0,1
21636_0,,,,2,2,1,3
C(C(C=O)CC(CC(C)O)O)(O)=O,,,5,1,1,0,1
21638_0,,,,2,2,1,3
C(C(C=O)CCC(CCO)O)(O)=O,,,5,1,1,0,1
21640_0,,,,2,2,1,3
C(C(C=O)CC(C)(CCO)O)(O)=O,,,5,1,1,0,1
21642_0,,,,2,2,1,3
C(C(C=O)CC(C(O)=O)CO)(O)=O,,,5,1,1,0,1
21644_0,,,,2,2,1,3
C(C(C=O)CC(CC(O)=O)O)(O)=O,,,5,1,1,0,1
21646_0,,,,2,2,1,3
C(C(C=O)CC(C(CO)=O)O)(O)=O,,,5,1,1,0,1
21647_0,,,,2,2,1,3
21649_0,,,,2,2,1,3
C(C(C=O)CCCO)(O)=O,,,5,1,1,0,1
21651_0,,,,2,2,1,3
C(C(C=O)CC(C)O)(O)=O,,,5,1,1,0,1
21653_0,,,,2,2,1,3
C(C(C(O)=O)CCC(O)=O)=O,,,5,1,2,0,2
21655_0,,,,2,2,1,3
C(C(C=O)CCC(C(O)=O)O)(O)=O,,,5,1,1,0,1
21657_0,,,,2,2,1,3
C(C(C=O)CC(C(O)=O)(C)O)(O)=O,,,5,1,1,0,1
21659_0,,,,2,2,1,3
C(C(C(O)=O)CCC=CC=O)=O,,,5,1,1,0,1
21661_0,,,,2,2,1,3
C(C(C=C)CC(C=O)C(O)=O)=O,,,5,1,1,0,1
21663_0,,,,2,2,1,3
C(C(C(O)=O)CCC(C(O)=O)=O)=O,,,5,1,2,0,2
21665_0,,,,2,2,1,3
C(CCC(C=O)C(C=O)C=O)=O,,,5,1,1,0,1
21667_0,,,,2,2,1,3
C(C(C=O)C(C=O)CCC(O)=O)=O,,,5,1,1,0,1
21669_0,,,,2,2,1,3
C(CC(C)C(C=O)C(C=O)C=O)=O,,,5,1,1,0,1
21671_0,,,,2,2,1,3
C(CCC(C=O)(C=O)CC=O)=O,,,5,1,1,0,1
21673_0,,,,2,2,1,3
C(C(C=O)(CCC(O)=O)CC=O)=O,,,5,1,1,0,1
21675_0,,,,2,2,1,3
C(CC(C)C(C=O)(C=O)CC=O)=O,,,5,1,1,0,1
21677_0,,,,2,2,1,3
C(C(C(C=O)=O)CCC=O)=O,,,5,1,1,0,1
21679_0,,,,2,2,1,3
C(C(C(C=O)=O)CCC(O)=O)=O,,,5,1,1,0,1
21680_0,,,,2,2,1,3
21682_0,,,,2,2,1,3
C(CCCC(CC(C=O)=O)=O)=O,,,5,1,1,0,1
21684_0,,,,2,2,1,3
C(CCCC(O)=O)(CC(C=O)=O)=O,,,5,1,1,0,1
21686_0,,,,2,2,1,3
C(CC(C)CC(CC(C=O)=O)=O)=O,,,5,1,1,0,1
21688_0,,,,2,2,1,3
C(CCC(C(C)=O)C(C=O)=O)=O,,,5,1,1,0,1
21690_0,,,,2,2,1,3
C(C)(C(C(C=O)=O)CCC(O)=O)=O,,,5,1,1,0,1
21692_0,,,,2,2,1,3
C(CC(C)C(C(C)=O)C(C=O)=O)=O,,,5,1,1,0,1
21694_0,,,,2,2,1,3
C(CCCCC(C(C=O)=O)=O)=O,,,5,1,1,0,1
21696_0,,,,2,2,1,3
C(CCCCC(C(C=O)=O)=O)(O)=O,,,5,1,1,0,1
21698_0,,,,2,2,1,3
C(CC(C)CCC(C(C=O)=O)=O)=O,,,5,1,1,0,1
21700_0,,,,2,2,1,3
C(CCC(C(C(C=O)=O)=O)C)=O,,,5,1,1,0,1
21702_0,,,,2,2,1,3
C(CCC(C(C(C=O)=O)=O)C)(O)=O,,,5,1,1,0,1
21704_0,,,,2,2,1,3
C(CC(C)C(C(C(C=O)=O)=O)C)=O,,,5,1,1,0,1
21706_0,,,,2,2,1,3
C(CCCCC(C(O)=O)=O)=O,,,5,1,1,0,1
21708_0,,,,2,2,1,3
C(CCCCC(C(O)=O)=O)(O)=O,,,5,1,1,0,1
21709_0,,,,2,2,1,3
21711_0,,,,2,2,1,3
C(CCC(C(C(O)=O)=O)C)=O,,,5,1,1,0,1
21713_0,,,,2,2,1,3
C(CCC(C(C(O)=O)=O)C)(O)=O,,,5,1,1,0,1
21714_0,,,,2,2,1,3
21716_0,,,,2,2,1,3
C(C(C(CC(O)=O)=O)CCO)(O)=O,,,5,1,1,0,1
21718_0,,,,2,2,1,3
C(C(CCC(C(C)O)=O)C(C)O)=O,,,5,1,1,0,1
21720_0,,,,2,2,1,3
C(C(CO)C(C)CC(C(C)O)=O)=O,,,5,1,1,0,1
21722_0,,,,2,2,1,3
C(CCCC(C(C)O)=O)=O,,,5,1,1,0,1
21724_0,,,,2,2,1,3
C(C(C)O)(CCCC(C(O)=O)=O)=O,,,5,1,1,0,1
21726_0,,,,2,2,1,3
C(CCCC(C(C)O)=O)(O)=O,,,5,1,1,0,1
21727_0,,,,2,2,1,3
21729_0,,,,2,2,1,3
C(C(C(C)O)CCC(C(C)=O)O)=O,,,5,1,1,0,1
21731_0,,,,2,2,1,3
C(C(CO)C(C)CC(C(C)=O)O)=O,,,5,1,1,0,1
21733_0,,,,2,2,1,3
C(CCCC(C(C)=O)O)=O,,,5,1,1,0,1
21735_0,,,,2,2,1,3
C(C)(C(CCCC(C(O)=O)=O)O)=O,,,5,1,1,0,1
21737_0,,,,2,2,1,3
C(CCCC(C(C)=O)O)(O)=O,,,5,1,1,0,1
21738_0,,,,2,2,1,3
21740_0,,,,2,2,1,3
C(C(CC(C(C)=O)(C)O)C(C)O)=O,,,5,1,1,0,1
21742_0,,,,2,2,1,3
C(C(CO)C(C)C(C(C)=O)(C)O)=O,,,5,1,1,0,1
21744_0,,,,2,2,1,3
C(CCC(C(C)=O)(C)O)=O,,,5,1,1,0,1
21746_0,,,,2,2,1,3
C(C)(C(C)(CCC(C(O)=O)=O)O)=O,,,5,1,1,0,1
21748_0,,,,2,2,1,3
C(CCC(C(C)=O)(C)O)(O)=O,,,5,1,1,0,1
21749_0,,,,2,2,1,3
21751_0,,,,2,2,1,3
C(C(CC(C(CC)=O)O)C(C)O)=O,,,5,1,1,0,1
21753_0,,,,2,2,1,3
C(C(CO)C(C)C(C(CC)=O)O)=O,,,5,1,1,0,1
21755_0,,,,2,2,1,3
C(CCC(C(CC)=O)O)=O,,,5,1,1,0,1
21757_0,,,,2,2,1,3
C(C(CCC(C(O)=O)=O)O)(CC)=O,,,5,1,1,0,1
21759_0,,,,2,2,1,3
C(CCC(C(CC)=O)O)(O)=O,,,5,1,1,0,1
21760_0,,,,2,2,1,3
21762_0,,,,2,2,1,3
C(C(C(C)O)CCCC(CO)=O)=O,,,5,1,1,0,1
21764_0,,,,2,2,1,3
C(C(CO)C(C)CCC(CO)=O)=O,,,5,1,1,0,1
21766_0,,,,2,2,1,3
C(CCCCC(CO)=O)=O,,,5,1,1,0,1
21768_0,,,,2,2,1,3
C(CO)(CCCCC(C(O)=O)=O)=O,,,5,1,1,0,1
21770_0,,,,2,2,1,3
C(CCCCC(CO)=O)(O)=O,,,5,1,1,0,1
21771_0,,,,2,2,1,3
21773_0,,,,2,2,1,3
C(C(CC(C(CO)=O)C)C(C)O)=O,,,5,1,1,0,1
21775_0,,,,2,2,1,3
C(C(CO)C(C)C(C(CO)=O)C)=O,,,5,1,1,0,1
21777_0,,,,2,2,1,3
C(CCC(C(CO)=O)C)=O,,,5,1,1,0,1
21779_0,,,,2,2,1,3
C(CO)(C(C)CCC(C(O)=O)=O)=O,,,5,1,1,0,1
21781_0,,,,2,2,1,3
C(CCC(C(CO)=O)C)(O)=O,,,5,1,1,0,1
21782_0,,,,2,2,1,3
21784_0,,,,2,2,1,3
C(C)(C(CCC=O)C(C(O)=O)O)=O,,,5,1,1,0,1
21786_0,,,,2,2,1,3
C(C(CCC=O)(CC(C)=O)O)(O)=O,,,5,1,1,0,1
21788_0,,,,2,2,1,3
C(CC(C(O)=O)O)(CCCC=O)=O,,,5,1,1,0,1
21790_0,,,,2,2,1,3
C(CCC1C(C(C=C1C(O)=O)=O)=O)=O,,,5,1,1,0,1
21792_0,,,,2,2,1,3
C(CC1C(C(CC1C(O)=O)=O)=O)=O,,,5,1,1,0,1
21794_0,,,,2,2,1,3
C(C1CC(C(C1CO)=O)=O)(O)=O,,,5,1,1,0,1
21796_0,,,,2,2,1,3
C(C1CC(C(C1CCO)=O)=O)(O)=O,,,5,1,1,0,1
21798_0,,,,2,2,1,3
C(C1CC(C(C1C(C)O)=O)=O)(O)=O,,,5,1,1,0,1
21800_0,,,,2,2,1,3
C(CC1(C(O)=O)CC(C(C1)=O)=O)=O,,,5,1,1,0,1
21802_0,,,,2,2,1,3
C(C1(CO)CC(C(C1)=O)=O)(O)=O,,,5,1,1,0,1
21804_0,,,,2,2,1,3
C(C1(CCO)CC(C(C1)=O)=O)(O)=O,,,5,1,1,0,1
21806_0,,,,2,2,1,3
C(C1(C(C)O)CC(C(C1)=O)=O)(O)=O,,,5,1,1,0,1
21807_0,,,,2,2,1,3
21809_0,,,,2,2,1,3
C(C(C(C)O)C(CO)CC(C)O)=O,,,5,1,1,0,1
21811_0,,,,2,2,1,3
C(C(C=O)C(CO)CC(C)O)(O)=O,,,5,1,1,0,1
21813_0,,,,2,2,1,3
C(CCC(C=CC=O)C(C)O)=O,,,5,1,1,0,1
21815_0,,,,2,2,1,3
C(CCC(C=CC=O)C(C)O)(O)=O,,,5,1,1,0,1
21817_0,,,,2,2,1,3
C(CC(C)C(C=CC=O)C(C)O)=O,,,5,1,1,0,1
21819_0,,,,2,2,1,3
C(CCCC(CC=CC=O)O)=O,,,5,1,1,0,1
21821_0,,,,2,2,1,3
C(CCCC(CC=CC=O)O)(O)=O,,,5,1,1,0,1
21823_0,,,,2,2,1,3
C(CC(C)CC(CC=CC=O)O)=O,,,5,1,1,0,1
21825_0,,,,2,2,1,3
C(CCC(C)(CC=CC=O)O)=O,,,5,1,1,0,1
21827_0,,,,2,2,1,3
C(CCC(C)(CC=CC=O)O)(O)=O,,,5,1,1,0,1
21829_0,,,,2,2,1,3
C(CC(C)C(C)(CC=CC=O)O)=O,,,5,1,1,0,1
21831_0,,,,2,2,1,3
C(CC(CC(C=C)O)CC(C)O)=O,,,5,1,1,0,1
21833_0,,,,2,2,1,3
C(CC(CC(C)O)C(C=C)(C)O)=O,,,5,1,1,0,1
21835_0,,,,2,2,1,3
C(CC(CC(C)O)CC=O)=O,,,5,1,1,0,1
21837_0,,,,2,2,1,3
C(CC(CC(C)O)C(C(O)=O)O)=O,,,5,1,1,0,1
21839_0,,,,2,2,1,3
C(CC(CC(C)O)C(CO)O)=O,,,5,1,1,0,1
21841_0,,,,2,2,1,3
C(C(CO)C(CC(C)O)CC=O)=O,,,5,1,1,0,1
21843_0,,,,2,2,1,3
C(CC(C(CC=O)O)CC(C)O)=O,,,5,1,1,0,1
21845_0,,,,2,2,1,3
C(CC(CO)CC(C)O)=O,,,5,1,1,0,1
21847_0,,,,2,2,1,3
C(CC(CC(C)O)CCO)=O,,,5,1,1,0,1
21849_0,,,,2,2,1,3
C(CC(CC(C)O)C(C)O)=O,,,5,1,1,0,1
21851_0,,,,2,2,1,3
C(CC(CC(C)O)CC=O)(O)=O,,,5,1,1,0,1
21853_0,,,,2,2,1,3
C(CC(CC(C)O)CC=CC=O)=O,,,5,1,1,0,1
21855_0,,,,2,2,1,3
C(C(C=C)C(CC(C)O)CC=O)=O,,,5,1,1,0,1
21857_0,,,,2,2,1,3
C(CCC(C=O)C=CC(C)O)=O,,,5,1,1,0,1
21859_0,,,,2,2,1,3
C(CCC(C=O)C=CC(C)O)(O)=O,,,5,1,1,0,1
21861_0,,,,2,2,1,3
C(CC(C)C(C=O)C=CC(C)O)=O,,,5,1,1,0,1
21863_0,,,,2,2,1,3
C(CCCC(C=CCC=O)O)=O,,,5,1,1,0,1
21865_0,,,,2,2,1,3
C(CCCC(C=CCC=O)O)(O)=O,,,5,1,1,0,1
21867_0,,,,2,2,1,3
C(CC(C)CC(C=CCC=O)O)=O,,,5,1,1,0,1
21869_0,,,,2,2,1,3
C(CC=CC(C)(CCC=O)O)=O,,,5,1,1,0,1
21871_0,,,,2,2,1,3
C(CC=CC(C)(CCC(O)=O)O)=O,,,5,1,1,0,1
21873_0,,,,2,2,1,3
C(CC=CC(C)(C(C)CC=O)O)=O,,,5,1,1,0,1
21875_0,,,,2,2,1,3
C(C(CC(CO)CC(C)O)=O)(O)=O,,,5,1,1,0,1
21877_0,,,,2,2,1,3
C(C(C(CO)CC(O)=O)C(C)O)=O,,,5,1,2,0,2
21878_0,,,,2,2,1,3
21879_0,,,,2,2,1,3
21881_0,,,,2,2,1,3
C(C(C(C)O)C(C(CO)=O)CO)=O,,,5,1,1,0,1
21883_0,,,,2,2,1,3
C(C(CO)(C(C)O)CC(CO)=O)=O,,,5,1,1,0,1
21884_0,,,,2,2,1,3
21886_0,,,,2,2,1,3
C(C(CO)(CO)C(C=O)C(C)O)=O,,,5,1,1,0,1
21888_0,,,,2,2,1,3
C(C(CO)(C(C)O)C(C=O)CO)=O,,,5,1,1,0,1
21889_0,,,,2,2,1,3
21891_0,,,,2,2,1,3
C(CCCC(C(C=O)=C)O)=O,,,5,1,1,0,1
21893_0,,,,2,2,1,3
C(CCCC(C(C=O)=C)O)(O)=O,,,5,1,1,0,1
21894_0,,,,2,2,1,3
21896_0,,,,2,2,1,3
C(CCC(C(C=O)=C)(C)O)=O,,,5,1,1,0,1
21898_0,,,,2,2,1,3
C(CCC(C(C=O)=C)(C)O)(O)=O,,,5,1,1,0,1
21899_0,,,,2,2,1,3
21901_0,,,,2,2,1,3
C(C(C(C)O)CCC(C=C)O)=O,,,5,1,1,0,1
21903_0,,,,2,2,1,3
C(C(CC(C=C)(C)O)C(C)O)=O,,,5,1,1,0,1
21905_0,,,,2,2,1,3
C(C(CC(C=C)(CO)O)C(C)O)=O,,,5,1,1,0,1
21907_0,,,,2,2,1,3
C(C(C(C)O)CC(C(C=C)O)O)=O,,,5,1,1,0,1
21909_0,,,,2,2,1,3
C(C(CC(CO)(CO)O)C(C)O)=O,,,5,1,1,0,1
21911_0,,,,2,2,1,3
C(C(CC(C(CO)O)O)C(C)O)=O,,,5,1,1,0,1
21913_0,,,,2,2,1,3
C(C(CC(C=O)(CC)O)C(C)O)=O,,,5,1,1,0,1
21915_0,,,,2,2,1,3
C(C(C(C)O)CCCC(C=O)O)=O,,,5,1,1,0,1
21917_0,,,,2,2,1,3
C(C(C(C)O)CC(C)C(C=O)O)=O,,,5,1,1,0,1
21919_0,,,,2,2,1,3
C(C(CC(C=O)CCO)C(C)O)=O,,,5,1,1,0,1
21921_0,,,,2,2,1,3
C(C(CC(CCC=O)O)C(C)O)=O,,,5,1,1,0,1
21923_0,,,,2,2,1,3
C(C(CC(CO)CC=O)C(C)O)=O,,,5,1,1,0,1
21925_0,,,,2,2,1,3
C(C(CCC=O)C(C)O)=O,,,5,1,2,0,2
21927_0,,,,2,2,1,3
C(C(CC(C=O)C(C)O)C(C)O)=O,,,5,1,1,0,1
21929_0,,,,2,2,1,3
C(C(CCC(CC=O)O)C(C)O)=O,,,5,1,1,0,1
21931_0,,,,2,2,1,3
C(C(CC(C)(CC=O)O)C(C)O)=O,,,5,1,1,0,1
21932_0,,,,2,2,1,3
21934_0,,,,2,2,1,3
C(C(CC(C(C=O)=O)O)C(C)O)=O,,,5,1,1,0,1
21935_0,,,,2,2,1,3
21937_0,,,,2,2,1,3
C(C(CC(CO)O)C(C)O)=O,,,5,1,1,0,1
21939_0,,,,2,2,1,3
C(C(CC(C=O)CO)C(C)O)=O,,,5,1,1,0,1
21941_0,,,,2,2,1,3
C(C(CC(CC=O)O)C(C)O)=O,,,5,1,1,0,1
21943_0,,,,2,2,1,3
C(C(C=O)(CC(C=O)C(C)O)O)=O,,,5,1,1,0,1
21945_0,,,,2,2,1,3
C(C(CC(CO)C(C)O)C(C)O)=O,,,5,1,1,0,1
21947_0,,,,2,2,1,3
C(C(CC(CC(C)O)O)C(C)O)=O,,,5,1,1,0,1
21949_0,,,,2,2,1,3
C(C(CCC(CCO)O)C(C)O)=O,,,5,1,1,0,1
21951_0,,,,2,2,1,3
C(C(CC(C)(CCO)O)C(C)O)=O,,,5,1,1,0,1
21953_0,,,,2,2,1,3
C(C(CC(C=O)C(C)O)CO)(O)=O,,,5,1,1,0,1
21955_0,,,,2,2,1,3
C(C(CC(CC(O)=O)O)C(C)O)=O,,,5,1,1,0,1
21957_0,,,,2,2,1,3
C(C(CC(C(CO)=O)O)C(C)O)=O,,,5,1,1,0,1
21958_0,,,,2,2,1,3
21960_0,,,,2,2,1,3
C(C(CCCO)C(C)O)=O,,,5,1,1,0,1
21962_0,,,,2,2,1,3
C(C(CC(C)O)C(C)O)=O,,,5,1,1,0,1
21964_0,,,,2,2,1,3
C(C(CCC(O)=O)C(C)O)=O,,,5,1,2,0,2
21966_0,,,,2,2,1,3
C(C(C(C)O)CCC(C(O)=O)O)=O,,,5,1,1,0,1
21968_0,,,,2,2,1,3
C(C(CC(C(O)=O)(C)O)C(C)O)=O,,,5,1,1,0,1
21970_0,,,,2,2,1,3
C(C(CCC=CC=O)C(C)O)=O,,,5,1,1,0,1
21972_0,,,,2,2,1,3
C(C(C=C)CC(C=O)C(C)O)=O,,,5,1,1,0,1
21974_0,,,,2,2,1,3
C(C(CCC(C(O)=O)=O)C(C)O)=O,,,5,1,2,0,2
21976_0,,,,2,2,1,3
C(CCC(C(C=O)=CC)O)=O,,,5,1,1,0,1
21978_0,,,,2,2,1,3
C(CCC(C(C=O)=CC)O)(O)=O,,,5,1,1,0,1
21979_0,,,,2,2,1,3
21981_0,,,,2,2,1,3
C(CCCC=C(C=O)CO)=O,,,5,1,1,0,1
21983_0,,,,2,2,1,3
C(CCCC=C(C=O)CO)(O)=O,,,5,1,1,0,1
21984_0,,,,2,2,1,3
21986_0,,,,2,2,1,3
C(C(CO)C(C)CC(C=C)O)=O,,,5,1,1,0,1
21988_0,,,,2,2,1,3
C(C(CO)C(C)C(C=C)(C)O)=O,,,5,1,1,0,1
21990_0,,,,2,2,1,3
C(C(CO)C(C)C(C=C)(CO)O)=O,,,5,1,1,0,1
21992_0,,,,2,2,1,3
C(C(CO)C(C)C(C(C=C)O)O)=O,,,5,1,1,0,1
21994_0,,,,2,2,1,3
C(C(CO)C(C)C(CO)(CO)O)=O,,,5,1,1,0,1
21996_0,,,,2,2,1,3
C(C(CO)C(C)C(C(CO)O)O)=O,,,5,1,1,0,1
21998_0,,,,2,2,1,3
C(C(CO)C(C)C(C=O)(CC)O)=O,,,5,1,1,0,1
22000_0,,,,2,2,1,3
C(C(CO)C(C)CCC(C=O)O)=O,,,5,1,1,0,1
22002_0,,,,2,2,1,3
C(C(CO)C(C)C(C)C(C=O)O)=O,,,5,1,1,0,1
22004_0,,,,2,2,1,3
C(C(CCO)C(C)C(C=O)CO)=O,,,5,1,1,0,1
22006_0,,,,2,2,1,3
C(C(CO)C(C)C(CCC=O)O)=O,,,5,1,1,0,1
22008_0,,,,2,2,1,3
C(C(CO)C(C)C(CO)CC=O)=O,,,5,1,1,0,1
22009_0,,,,2,2,1,3
22010_0,,,,2,2,1,3
22011_0,,,,2,2,1,3
22012_0,,,,2,2,1,3
22013_0,,,,2,2,1,3
22014_0,,,,2,2,1,3
22015_0,,,,2,2,1,3
22016_0,,,,2,2,1,3
22017_0,,,,2,2,1,3
22018_0,,,,2,2,1,3
22019_0,,,,2,2,1,3
22020_0,,,,2,2,1,3
22021_0,,,,2,2,1,3
22022_0,,,,2,2,1,3
22023_0,,,,2,2,1,3
22024_0,,,,2,2,1,3
22025_0,,,,2,2,1,3
22026_0,,,,2,2,1,3
22027_0,,,,2,2,1,3
22028_0,,,,2,2,1,3
22029_0,,,,2,2,1,3
22030_0,,,,2,2,1,3
22031_0,,,,2,2,1,3
22032_0,,,,2,2,1,3
22033_0,,,,2,2,1,3
22034_0,,,,2,2,1,3
22035_0,,,,2,2,1,3
22037_0,,,,2,2,1,3
C(CCCC=C(C=O)C(C)O)=O,,,5,1,1,0,1
22039_0,,,,2,2,1,3
C(CCCC=C(C=O)C(C)O)(O)=O,,,5,1,1,0,1
22041_0,,,,2,2,1,3
C(CC(C)CC=C(C=O)C(C)O)=O,,,5,1,1,0,1
22043_0,,,,2,2,1,3
C(CCCC(C(C=O)=CC)O)=O,,,5,1,1,0,1
22045_0,,,,2,2,1,3
C(CCCC(C(C=O)=CC)O)(O)=O,,,5,1,1,0,1
22047_0,,,,2,2,1,3
C(CC(C)CC(C(C=O)=CC)O)=O,,,5,1,1,0,1
22049_0,,,,2,2,1,3
C(CCC(C(C=O)=CC)(C)O)=O,,,5,1,1,0,1
22051_0,,,,2,2,1,3
C(CCC(C(C=O)=CC)(C)O)(O)=O,,,5,1,1,0,1
22053_0,,,,2,2,1,3
C(CC(C)C(C(C=O)=CC)(C)O)=O,,,5,1,1,0,1
22055_0,,,,2,2,1,3
C(C(C(C)O)C(C)CC(C=C)O)=O,,,5,1,1,0,1
22057_0,,,,2,2,1,3
C(C(C(C)O)C(C)C(C=C)(C)O)=O,,,5,1,1,0,1
22058_0,,,,2,2,1,3
22059_0,,,,2,2,1,3
22060_0,,,,2,2,1,3
22061_0,,,,2,2,1,3
22062_0,,,,2,2,1,3
22063_0,,,,2,2,1,3
22064_0,,,,2,2,1,3
22065_0,,,,2,2,1,3
22066_0,,,,2,2,1,3
22067_0,,,,2,2,1,3
22068_0,,,,2,2,1,3
22070_0,,,,2,2,1,3
C(CCCC=C(C=O)C(O)=O)=O,,,5,1,1,0,1
22072_0,,,,2,2,1,3
C(CCCC=C(C=O)C(O)=O)(O)=O,,,5,1,1,0,1
22074_0,,,,2,2,1,3
C(CC(C)CC=C(C=O)C(O)=O)=O,,,5,1,1,0,1
22076_0,,,,2,2,1,3
C(C(C=O)C(C)CC(C=C)O)(O)=O,,,5,1,1,0,1
22078_0,,,,2,2,1,3
C(C(C=O)C(C)C(C=C)(C)O)(O)=O,,,5,1,1,0,1
22079_0,,,,2,2,1,3
22080_0,,,,2,2,1,3
22081_0,,,,2,2,1,3
22082_0,,,,2,2,1,3
22083_0,,,,2,2,1,3
22084_0,,,,2,2,1,3
22085_0,,,,2,2,1,3
22086_0,,,,2,2,1,3
22087_0,,,,2,2,1,3
22088_0,,,,2,2,1,3
22089_0,,,,2,2,1,3
22090_0,,,,2,2,1,3
22091_0,,,,2,2,1,3
22092_0,,,,2,2,1,3
22093_0,,,,2,2,1,3
22095_0,,,,2,2,1,3
C(C(CO)(CC(C)O)CC=O)(O)=O,,,5,1,1,0,1
22097_0,,,,2,2,1,3
C(C(C(CO)C(C)O)CC=O)(O)=O,,,5,1,1,0,1
22099_0,,,,2,2,1,3
C(CCC(C(C(O)=O)=O)C(C)O)=O,,,5,1,2,0,2
22100_0,,,,2,2,1,3
22102_0,,,,2,2,1,3
C(C(C(CCCO)C(C)O)=O)(O)=O,,,5,1,1,0,1
22103_0,,,,2,2,1,3
22104_0,,,,2,2,1,3
22105_0,,,,2,2,1,3
22106_0,,,,2,2,1,3
22107_0,,,,2,2,1,3
22108_0,,,,2,2,1,3
22109_0,,,,2,2,1,3
22111_0,,,,2,2,1,3
C(C(C=O)C(CO)CC(O)=O)(O)=O,,,5,1,2,0,2
22112_0,,,,2,2,1,3
22114_0,,,,2,2,1,3
C(CC(CO)C(C(C=O)=O)O)(O)=O,,,5,1,1,0,1
22116_0,,,,2,2,1,3
C(CCC(C(O)=O)C=CC=O)=O,,,5,1,1,0,1
22118_0,,,,2,2,1,3
C(C(C=CC=O)CCC(O)=O)(O)=O,,,5,1,1,0,1
22120_0,,,,2,2,1,3
C(CC(C)C(C(O)=O)C=CC=O)=O,,,5,1,1,0,1
22122_0,,,,2,2,1,3
C(CC(CC(C=C)O)CC=O)(O)=O,,,5,1,2,0,2
22124_0,,,,2,2,1,3
C(CC(CC=O)C(C=C)(C)O)(O)=O,,,5,1,2,0,2
22126_0,,,,2,2,1,3
C(CC(CC=O)CC(O)=O)=O,,,5,1,2,0,2
22128_0,,,,2,2,1,3
C(CC(C(C(O)=O)O)CC=O)(O)=O,,,5,1,3,0,3
22130_0,,,,2,2,1,3
C(CC(C(CO)O)CC=O)(O)=O,,,5,1,2,0,2
22132_0,,,,2,2,1,3
C(C(C(CC(O)=O)CC=O)CO)=O,,,5,1,2,0,2
22134_0,,,,2,2,1,3
C(CC(C(CC=O)O)CC=O)(O)=O,,,5,1,2,0,2
22136_0,,,,2,2,1,3
C(CC(CO)CC=O)(O)=O,,,5,1,2,0,2
22138_0,,,,2,2,1,3
C(CC(CCO)CC=O)(O)=O,,,5,1,2,0,2
22140_0,,,,2,2,1,3
C(CC(C(C)O)CC=O)(O)=O,,,5,1,2,0,2
22142_0,,,,2,2,1,3
C(CC(CC(O)=O)CC(O)=O)=O,,,5,1,2,0,2
22144_0,,,,2,2,1,3
C(CC(CC(O)=O)CC=CC=O)=O,,,5,1,2,0,2
22146_0,,,,2,2,1,3
C(C(C=C)C(CC=O)CC(O)=O)=O,,,5,1,2,0,2
22148_0,,,,2,2,1,3
C(C(C=CC(O)=O)CCC=O)=O,,,5,1,1,0,1
22150_0,,,,2,2,1,3
C(C(C=CC(O)=O)CCC(O)=O)=O,,,5,1,1,0,1
22152_0,,,,2,2,1,3
C(C(C=CC(O)=O)C(C)CC=O)=O,,,5,1,1,0,1
22153_0,,,,2,2,1,3
22154_0,,,,2,2,1,3
22155_0,,,,2,2,1,3
22156_0,,,,2,2,1,3
22157_0,,,,2,2,1,3
22158_0,,,,2,2,1,3
22159_0,,,,2,2,1,3
22160_0,,,,2,2,1,3
22161_0,,,,2,2,1,3
22162_0,,,,2,2,1,3
22163_0,,,,2,2,1,3
22164_0,,,,2,2,1,3
22165_0,,,,2,2,1,3
22167_0,,,,2,2,1,3
C(CC(CO)CC(C(O)=O)=O)(O)=O,,,5,1,2,0,2
22168_0,,,,2,2,1,3
22170_0,,,,2,2,1,3
C(C(C=O)C(C(CO)=O)CO)(O)=O,,,5,1,1,0,1
22172_0,,,,2,2,1,3
C(C(C=O)(CO)CC(CO)=O)(O)=O,,,5,1,1,0,1
22174_0,,,,2,2,1,3
C(C(C=O)C(C=O)(CO)CO)(O)=O,,,5,1,1,0,1
22176_0,,,,2,2,1,3
C(C(C=O)(CO)C(C=O)CO)(O)=O,,,5,1,1,0,1
22177_0,,,,2,2,1,3
22178_0,,,,2,2,1,3
22180_0,,,,2,2,1,3
C(C(C)(CC(CO)CC=O)O)(O)=O,,,5,1,1,0,1
22182_0,,,,2,2,1,3
C(CCC(C=O)C(C(O)=O)(C)O)=O,,,5,1,2,0,2
22183_0,,,,2,2,1,3
22185_0,,,,2,2,1,3
C(C(CCCO)C(C(O)=O)(C)O)=O,,,5,1,1,0,1
22187_0,,,,2,2,1,3
C(C(CC(C)O)C(C(O)=O)(C)O)=O,,,5,1,1,0,1
22188_0,,,,2,2,1,3
22189_0,,,,2,2,1,3
22190_0,,,,2,2,1,3
22191_0,,,,2,2,1,3
22193_0,,,,2,2,1,3
C(C(C)C(C=O)(CO)CC=O)(O)=O,,,5,1,1,0,1
22194_0,,,,2,2,1,3
22196_0,,,,2,2,1,3
C(C(CO)(CCO)C(C(O)=O)C)=O,,,5,1,1,0,1
22197_0,,,,2,2,1,3
22199_0,,,,2,2,1,3
C(CC(C(O)=O)C(C=O)CO)(O)=O,,,5,1,1,0,1
22201_0,,,,2,2,1,3
C(C(CO)(CC(O)=O)CC=O)(O)=O,,,5,1,2,0,2
22203_0,,,,2,2,1,3
C(C(CO)C(C(O)=O)CC=O)(O)=O,,,5,1,1,0,1
22204_0,,,,2,2,1,3
22206_0,,,,2,2,1,3
C(CCC(C(O)=O)C(C(O)=O)=O)=O,,,5,1,2,0,2
22207_0,,,,2,2,1,3
22209_0,,,,2,2,1,3
C(C(C(C(O)=O)=O)CCCO)(O)=O,,,5,1,1,0,1
22210_0,,,,2,2,1,3
22212_0,,,,2,2,1,3
C(CCC(C(C=CC=O)=O)O)=O,,,5,1,1,0,1
22214_0,,,,2,2,1,3
C(CCC(C(C=CC=O)=O)O)(O)=O,,,5,1,1,0,1
22216_0,,,,2,2,1,3
C(CC(C)C(C(C=CC=O)=O)O)=O,,,5,1,1,0,1
22218_0,,,,2,2,1,3
C(C(CC(C=C)O)CC(CO)=O)=O,,,5,1,1,0,1
22220_0,,,,2,2,1,3
C(CC(C=O)C(C=C)(C)O)(CO)=O,,,5,1,1,0,1
22222_0,,,,2,2,1,3
C(CC(C=O)CC(CO)=O)=O,,,5,1,1,0,1
22224_0,,,,2,2,1,3
C(C(C(C=O)CC(CO)=O)O)(O)=O,,,5,1,1,0,1
22226_0,,,,2,2,1,3
C(C(C(CO)O)CC(CO)=O)=O,,,5,1,1,0,1
22227_0,,,,2,2,1,3
22229_0,,,,2,2,1,3
C(CC(C(C=O)CC(CO)=O)O)=O,,,5,1,1,0,1
22231_0,,,,2,2,1,3
C(C(CO)CC(CO)=O)=O,,,5,1,1,0,1
22233_0,,,,2,2,1,3
C(C(CCO)CC(CO)=O)=O,,,5,1,1,0,1
22235_0,,,,2,2,1,3
C(C(C(C)O)CC(CO)=O)=O,,,5,1,1,0,1
22237_0,,,,2,2,1,3
C(CC(C=O)CC(CO)=O)(O)=O,,,5,1,1,0,1
22239_0,,,,2,2,1,3
C(C(CC(CO)=O)CC=CC=O)=O,,,5,1,1,0,1
22241_0,,,,2,2,1,3
C(C(C=C)C(C=O)CC(CO)=O)=O,,,5,1,1,0,1
22243_0,,,,2,2,1,3
C(CO)(C(CC(C=C)O)CC=O)=O,,,5,1,1,0,1
22245_0,,,,2,2,1,3
C(CC(C(CO)=O)C(C=C)(C)O)=O,,,5,1,1,0,1
22247_0,,,,2,2,1,3
C(CC(C(CO)=O)CC=O)=O,,,5,1,1,0,1
22249_0,,,,2,2,1,3
C(C(C(C(CO)=O)CC=O)O)(O)=O,,,5,1,1,0,1
22251_0,,,,2,2,1,3
C(CO)(C(C(CO)O)CC=O)=O,,,5,1,1,0,1
22253_0,,,,2,2,1,3
C(CC(C(CO)=O)C(C=O)CO)=O,,,5,1,1,0,1
22255_0,,,,2,2,1,3
C(CO)(C(C(CC=O)O)CC=O)=O,,,5,1,1,0,1
22257_0,,,,2,2,1,3
C(CO)(C(CO)CC=O)=O,,,5,1,1,0,1
22259_0,,,,2,2,1,3
C(CO)(C(CCO)CC=O)=O,,,5,1,1,0,1
22261_0,,,,2,2,1,3
C(CO)(C(C(C)O)CC=O)=O,,,5,1,1,0,1
22263_0,,,,2,2,1,3
C(CC(C(CO)=O)CC=O)(O)=O,,,5,1,1,0,1
22265_0,,,,2,2,1,3
C(CC(C(CO)=O)CC=CC=O)=O,,,5,1,1,0,1
22267_0,,,,2,2,1,3
C(C(C=C)C(C(CO)=O)CC=O)=O,,,5,1,1,0,1
22269_0,,,,2,2,1,3
C(CC(C(C(O)=O)=O)CO)(CO)=O,,,5,1,1,0,1
22271_0,,,,2,2,1,3
C(CO)(C(CO)CC(C(O)=O)=O)=O,,,5,1,1,0,1
22273_0,,,,2,2,1,3
C(CCC(C(C=O)=CC=O)O)=O,,,5,1,1,0,1
22275_0,,,,2,2,1,3
C(CCC(C(C=O)=CC=O)O)(O)=O,,,5,1,1,0,1
22277_0,,,,2,2,1,3
C(CC(C)C(C(C=O)=CC=O)O)=O,,,5,1,1,0,1
22279_0,,,,2,2,1,3
C(C(CC(C=C)O)C(C=O)CO)=O,,,5,1,1,0,1
22281_0,,,,2,2,1,3
C(C(CO)C(C=O)C(C=C)(C)O)=O,,,5,1,1,0,1
22283_0,,,,2,2,1,3
C(CC(C=O)C(C=O)CO)=O,,,5,1,1,0,1
22285_0,,,,2,2,1,3
C(C(C(C=O)C(C=O)CO)O)(O)=O,,,5,1,1,0,1
22287_0,,,,2,2,1,3
C(C(C(CO)O)C(C=O)CO)=O,,,5,1,1,0,1
22289_0,,,,2,2,1,3
C(C(CO)C(C=O)C(C=O)CO)=O,,,5,1,1,0,1
22291_0,,,,2,2,1,3
C(CC(C(C=O)C(C=O)CO)O)=O,,,5,1,1,0,1
22292_0,,,,2,2,1,3
22294_0,,,,2,2,1,3
C(C(CCO)C(C=O)CO)=O,,,5,1,1,0,1
22295_0,,,,2,2,1,3
22297_0,,,,2,2,1,3
C(CC(C=O)C(C=O)CO)(O)=O,,,5,1,1,0,1
22299_0,,,,2,2,1,3
C(C(CO)C(C=O)CC=CC=O)=O,,,5,1,1,0,1
22301_0,,,,2,2,1,3
C(C(CO)C(C=O)C(C=O)C=C)=O,,,5,1,1,0,1
22303_0,,,,2,2,1,3
C(C(CO)(CC(C=C)O)CC=O)=O,,,5,1,1,0,1
22305_0,,,,2,2,1,3
C(C(CO)(CC=O)C(C=C)(C)O)=O,,,5,1,1,0,1
22307_0,,,,2,2,1,3
C(C(CO)(CC=O)CC=O)=O,,,5,1,1,0,1
22309_0,,,,2,2,1,3
C(CC(C=O)(CO)C(C(O)=O)O)=O,,,5,1,1,0,1
22311_0,,,,2,2,1,3
C(C(CO)(C(CO)O)CC=O)=O,,,5,1,1,0,1
22313_0,,,,2,2,1,3
C(C(CO)C(C=O)(CO)CC=O)=O,,,5,1,1,0,1
22315_0,,,,2,2,1,3
C(C(CO)(C(CC=O)O)CC=O)=O,,,5,1,1,0,1
22317_0,,,,2,2,1,3
C(C(CO)(CO)CC=O)=O,,,5,1,1,0,1
22319_0,,,,2,2,1,3
C(C(CO)(CCO)CC=O)=O,,,5,1,1,0,1
22321_0,,,,2,2,1,3
C(C(CO)(C(C)O)CC=O)=O,,,5,1,1,0,1
22323_0,,,,2,2,1,3
C(C(CO)(CC(O)=O)CC=O)=O,,,5,1,1,0,1
22325_0,,,,2,2,1,3
C(C(CO)(CC=O)CC=CC=O)=O,,,5,1,1,0,1
22327_0,,,,2,2,1,3
C(C(CO)(CC=O)C(C=O)C=C)=O,,,5,1,1,0,1
22329_0,,,,2,2,1,3
C(C(CO)C(C(C(O)=O)=O)CO)=O,,,5,1,1,0,1
22331_0,,,,2,2,1,3
C(C(CO)(CO)CC(C(O)=O)=O)=O,,,5,1,1,0,1
22333_0,,,,2,2,1,3
C(CCC(C=C)(C(C=O)=O)O)=O,,,5,1,1,0,1
22335_0,,,,2,2,1,3
C(CCC(C=C)(C(C=O)=O)O)(O)=O,,,5,1,1,0,1
22337_0,,,,2,2,1,3
C(CC(C)C(C=C)(C(C=O)=O)O)=O,,,5,1,1,0,1
22339_0,,,,2,2,1,3
C(CCCC(C=C)O)=O,,,5,1,1,0,1
22341_0,,,,2,2,1,3
C(CCC(C=C)(C)O)=O,,,5,1,1,0,1
22343_0,,,,2,2,1,3
C(C(C=C)(CCCC=O)O)(O)=O,,,5,1,1,0,1
22345_0,,,,2,2,1,3
C(CCCC(C(C(O)=O)=C)=O)=O,,,5,1,1,0,1
22347_0,,,,2,2,1,3
C(CCC(C=C)(CO)O)=O,,,5,1,1,0,1
22349_0,,,,2,2,1,3
C(CCC(C(C=C)O)O)=O,,,5,1,1,0,1
22351_0,,,,2,2,1,3
C(CCC(C=C)(C(C(O)=O)O)O)=O,,,5,1,1,0,1
22353_0,,,,2,2,1,3
C(C(CCC=O)(C(C=C)O)O)(O)=O,,,5,1,1,0,1
22355_0,,,,2,2,1,3
C(CCC(C(C(O)=O)=C)(CO)O)=O,,,5,1,1,0,1
22357_0,,,,2,2,1,3
C(CCC(C(C(C(O)=O)=C)O)O)=O,,,5,1,1,0,1
22359_0,,,,2,2,1,3
C(CCC1C(C(OC1O)=O)=C)=O,,,5,1,1,0,1
22361_0,,,,2,2,1,3
C(CCC1(CC(C(O1)=O)=C)O)=O,,,5,1,1,0,1
22363_0,,,,2,2,1,3
C(CCCC1C(OC(C=1)O)=O)=O,,,5,1,1,0,1
22365_0,,,,2,2,1,3
C(CCC1(C=C(C(O1)=O)C)O)=O,,,5,1,1,0,1
22367_0,,,,2,2,1,3
C1(C(C=CO1)(CCCC=O)O)=O,,,5,1,1,0,1
22369_0,,,,2,2,1,3
C(CCCC(C1OC(C(C=1)=O)=O)=O)=O,,,5,1,1,0,1
22371_0,,,,2,2,1,3
C(CCC1C(C(OC(C1=O)=C)=O)=O)=O,,,5,1,1,0,1
22373_0,,,,2,2,1,3
C(CCC(C(CO)(C(C)O)O)O)=O,,,5,1,1,0,1
22375_0,,,,2,2,1,3
C(CCCC(C(CO)(CO)O)O)=O,,,5,1,1,0,1
22377_0,,,,2,2,1,3
C(CCC(C)(C(CO)(CO)O)O)=O,,,5,1,1,0,1
22379_0,,,,2,2,1,3
C(CCC(CO)(CO)O)=O,,,5,1,1,0,1
22381_0,,,,2,2,1,3
C(CCC(C(CO)O)O)=O,,,5,1,1,0,1
22383_0,,,,2,2,1,3
C(CCCC(C(C(C=O)O)O)=O)=O,,,5,1,1,0,1
22385_0,,,,2,2,1,3
C(C)(C(CCC=O)(C(C=O)O)O)=O,,,5,1,1,0,1
22387_0,,,,2,2,1,3
C(CCC(C=O)(C(C(C)=O)O)O)=O,,,5,1,1,0,1
22389_0,,,,2,2,1,3
C(CCC1(C(C)OC(C1O)=O)O)=O,,,5,1,1,0,1
22391_0,,,,2,2,1,3
C1(C(CCC=O)(C(C(C)O1)O)O)=O,,,5,1,1,0,1
22393_0,,,,2,2,1,3
C(CCCC1C(C(C(O1)=O)O)O)=O,,,5,1,1,0,1
22395_0,,,,2,2,1,3
C(CCC1(C)C(C(C(O1)=O)O)O)=O,,,5,1,1,0,1
22397_0,,,,2,2,1,3
C1(C(CCC=O)(C(C(O1)=O)O)O)=O,,,5,1,1,0,1
22399_0,,,,2,2,1,3
C(C(CCC=O)(CC)O)=O,,,5,1,1,0,1
22401_0,,,,2,2,1,3
C(CCCCC(C=O)O)=O,,,5,1,1,0,1
22403_0,,,,2,2,1,3
C(CCC(C)C(C=O)O)=O,,,5,1,1,0,1
22405_0,,,,2,2,1,3
C(C(CCC=O)CCO)=O,,,5,1,1,0,1
22407_0,,,,2,2,1,3
C(CCC(CCC=O)O)=O,,,5,1,1,0,1
22409_0,,,,2,2,1,3
C(CCC(CO)CC=O)=O,,,5,1,1,0,1
22411_0,,,,2,2,1,3
C(CCC(C(C(O)=O)=O)(CC)O)=O,,,5,1,1,0,1
22413_0,,,,2,2,1,3
C(CCCCC(C(C(O)=O)=O)O)=O,,,5,1,1,0,1
22415_0,,,,2,2,1,3
C(CCC(C)C(C(C(O)=O)=O)O)=O,,,5,1,1,0,1
22417_0,,,,2,2,1,3
C(CCC(C(C(O)=O)=O)CCO)=O,,,5,1,1,0,1
22419_0,,,,2,2,1,3
C(CCC(CCC(C(O)=O)=O)O)=O,,,5,1,2,0,2
22421_0,,,,2,2,1,3
C(CCC(CO)CC(C(O)=O)=O)=O,,,5,1,1,0,1
22423_0,,,,2,2,1,3
C(C(C(CCC=O)O)CC=O)(O)=O,,,5,1,1,0,1
22425_0,,,,2,2,1,3
C(C(CCC=O)(CO)CC=O)(O)=O,,,5,1,1,0,1
22427_0,,,,2,2,1,3
C(CCC(C=O)C(C(O)=O)CO)=O,,,5,1,1,0,1
22429_0,,,,2,2,1,3
C(C(CCCC=O)C(C=O)O)(O)=O,,,5,1,1,0,1
22431_0,,,,2,2,1,3
C(C(C)(CCC=O)C(C=O)O)(O)=O,,,5,1,1,0,1
22433_0,,,,2,2,1,3
C(C(C)C(C=O)(CCC=O)O)(O)=O,,,5,1,1,0,1
22435_0,,,,2,2,1,3
C(C1(COC(C1CCC=O)O)O)=O,,,5,1,1,0,1
22437_0,,,,2,2,1,3
C(C1(COC(C1)(CCC=O)O)O)=O,,,5,1,1,0,1
22439_0,,,,2,2,1,3
C(C1(C(CCC=O)OC(C1)O)O)=O,,,5,1,1,0,1
22441_0,,,,2,2,1,3
C(CCC1C(C(C(O)O1)=O)O)=O,,,5,1,1,0,1
22443_0,,,,2,2,1,3
C(CCC1(C(C(O)OC1)=O)O)=O,,,5,1,1,0,1
22445_0,,,,2,2,1,3
C(CCC1(C(C(CO1)O)=O)O)=O,,,5,1,1,0,1
22447_0,,,,2,2,1,3
C(CCCC1C(C(C(O)O1)=O)O)=O,,,5,1,1,0,1
22449_0,,,,2,2,1,3
C(CCC1(C)C(C(C(O)O1)=O)O)=O,,,5,1,1,0,1
22451_0,,,,2,2,1,3
C(CCC1(C(C(O)OC1C)=O)O)=O,,,5,1,1,0,1
22453_0,,,,2,2,1,3
C(CCC1(C(C(C(C)O1)O)=O)O)=O,,,5,1,1,0,1
22455_0,,,,2,2,1,3
C(CCC1(C(OC(C1=O)O)=O)O)=O,,,5,1,1,0,1
22457_0,,,,2,2,1,3
C(CCC1(C(C(C(O1)=O)O)=O)O)=O,,,5,1,1,0,1
22459_0,,,,2,2,1,3
C(CCC1C(O)OC(C)CC1O)=O,,,5,1,1,0,1
22461_0,,,,2,2,1,3
C(CCC1(CC(CC(C)O1)O)O)=O,,,5,1,1,0,1
22463_0,,,,2,2,1,3
C(CCC1C(C)OC(CC1O)O)=O,,,5,1,1,0,1
22465_0,,,,2,2,1,3
C(CCC1(CC(O)OC(C)C1)O)=O,,,5,1,1,0,1
22467_0,,,,2,2,1,3
C(CCCC1CC(CC(O)O1)O)=O,,,5,1,1,0,1
22469_0,,,,2,2,1,3
C(CCC1(C)CC(CC(O)O1)O)=O,,,5,1,1,0,1
22471_0,,,,2,2,1,3
C1(CC(C(CCC=O)C(O)O1)O)=O,,,5,1,1,0,1
22473_0,,,,2,2,1,3
C1(CC(CC(CCC=O)(O)O1)O)=O,,,5,1,1,0,1
22475_0,,,,2,2,1,3
C1(C(CCC=O)C(CC(O)O1)O)=O,,,5,1,1,0,1
22477_0,,,,2,2,1,3
C1(CC(CCC=O)(CC(O)O1)O)=O,,,5,1,1,0,1
22479_0,,,,2,2,1,3
C(CCC1C(OCC(C1O)=O)O)=O,,,5,1,1,0,1
22481_0,,,,2,2,1,3
C(CCC1(CC(C(CO1)=O)O)O)=O,,,5,1,1,0,1
22483_0,,,,2,2,1,3
C(CCC1C(C(CC(O1)O)O)=O)=O,,,5,1,1,0,1
22485_0,,,,2,2,1,3
C(CCC1(C(COC(C1)O)=O)O)=O,,,5,1,1,0,1
22487_0,,,,2,2,1,3
C(CCC1C(C(OC1)=O)=O)=O,,,5,1,1,0,1
22489_0,,,,2,2,1,3
C(CCC1CC(C(O1)=O)=O)=O,,,5,1,1,0,1
22491_0,,,,2,2,1,3
C(CCC1C(C(C(O1)=O)=O)=O)=O,,,5,1,1,0,1
22493_0,,,,2,2,1,3
C1(C(CCO1)(CCCC=O)O)=O,,,5,1,1,0,1
22495_0,,,,2,2,1,3
C1(C(C)(C(CO1)CCC=O)O)=O,,,5,1,1,0,1
22497_0,,,,2,2,1,3
C1(C(C)(CC(CCC=O)O1)O)=O,,,5,1,1,0,1
22499_0,,,,2,2,1,3
C1(C(CCCC=O)(CC(O1)=O)O)=O,,,5,1,1,0,1
22501_0,,,,2,2,1,3
C1(C(CCC=O)C(C(O1)=O)(C)O)=O,,,5,1,1,0,1
22503_0,,,,2,2,1,3
C1(C(C(CO1)O)(CCCC=O)O)=O,,,5,1,1,0,1
22505_0,,,,2,2,1,3
C1(C(C)(C(CO1)(CCC=O)O)O)=O,,,5,1,1,0,1
22507_0,,,,2,2,1,3
C1(C(C)(C(C(CCC=O)O1)O)O)=O,,,5,1,1,0,1
22509_0,,,,2,2,1,3
C(C(CCC=O)C(C)CO)=O,,,5,1,1,0,1
22511_0,,,,2,2,1,3
C(CCCC(CO)CC=O)=O,,,5,1,1,0,1
22513_0,,,,2,2,1,3
C(CCC(C)(CO)CC=O)=O,,,5,1,1,0,1
22515_0,,,,2,2,1,3
C(CCC(C(C)CC=O)O)=O,,,5,1,2,0,2
22517_0,,,,2,2,1,3
C(C(CCC=O)C(C)CCO)=O,,,5,1,1,0,1
22519_0,,,,2,2,1,3
C(CC(CCO)CCCC=O)=O,,,5,1,1,0,1
22521_0,,,,2,2,1,3
C(CCC(C)(CCO)CC=O)=O,,,5,1,1,0,1
22523_0,,,,2,2,1,3
C(CCC(CO)C(C)CC=O)=O,,,5,1,1,0,1
22525_0,,,,2,2,1,3
C(CC(C)CC(CCC=O)O)=O,,,5,1,1,0,1
22527_0,,,,2,2,1,3
C(C(CCC=O)C(C)C(C)O)=O,,,5,1,1,0,1
22529_0,,,,2,2,1,3
C(CC(CCCC=O)C(C)O)=O,,,5,1,1,0,1
22531_0,,,,2,2,1,3
C(CCC(C)(C(C)O)CC=O)=O,,,5,1,1,0,1
22533_0,,,,2,2,1,3
C(CC(C)C(CCCC=O)O)=O,,,5,1,1,0,1
22535_0,,,,2,2,1,3
C(CCC(C)(C(C)CC=O)O)=O,,,5,1,1,0,1
22537_0,,,,2,2,1,3
C(C(CCC=O)C(C)CC(O)=O)=O,,,5,1,1,0,1
22539_0,,,,2,2,1,3
C(CCCC(CC=O)CC(O)=O)=O,,,5,1,1,0,1
22541_0,,,,2,2,1,3
C(CC(C)(CCC=O)CC(O)=O)=O,,,5,1,1,0,1
22543_0,,,,2,2,1,3
C(CC(C)C(C(O)=O)CCC=O)=O,,,5,1,1,0,1
22545_0,,,,2,2,1,3
C(C(CCC=O)C(C)CC=CC=O)=O,,,5,1,1,0,1
22547_0,,,,2,2,1,3
C(CC(CCCC=O)CC=CC=O)=O,,,5,1,1,0,1
22549_0,,,,2,2,1,3
C(CCC(C)(CC=O)CC=CC=O)=O,,,5,1,1,0,1
22551_0,,,,2,2,1,3
C(CC(C)C(C=CC=O)CCC=O)=O,,,5,1,1,0,1
22553_0,,,,2,2,1,3
C(C(C=C)(CCC=O)C(C)CC=O)=O,,,5,1,1,0,1
22555_0,,,,2,2,1,3
C(C(CCC=O)C(C)C(C=O)C=C)=O,,,5,1,1,0,1
22557_0,,,,2,2,1,3
C(C(C=C)C(CCCC=O)CC=O)=O,,,5,1,1,0,1
22559_0,,,,2,2,1,3
C(C(C=C)C(C)(CCC=O)CC=O)=O,,,5,1,1,0,1
22561_0,,,,2,2,1,3
C(C(CCC=O)C(C)CC=O)=O,,,5,1,1,0,1
22563_0,,,,2,2,1,3
C(CC(CCCC=O)CC=O)=O,,,5,1,1,0,1
22565_0,,,,2,2,1,3
C(CC(C)(CCC=O)CC=O)=O,,,5,1,1,0,1
22567_0,,,,2,2,1,3
C(CCC(CO)(C(C)CC=O)O)=O,,,5,1,1,0,1
22569_0,,,,2,2,1,3
C(CCC(C(C(C)CC=O)O)O)=O,,,5,1,1,0,1
22571_0,,,,2,2,1,3
C(C(CCC=O)C(C)C(CO)O)=O,,,5,1,1,0,1
22573_0,,,,2,2,1,3
C(CC(CCCC=O)C(CO)O)=O,,,5,1,1,0,1
22575_0,,,,2,2,1,3
C(CCC(C)(C(CO)O)CC=O)=O,,,5,1,1,0,1
22577_0,,,,2,2,1,3
C(CCC(C(C(O)=O)O)O)=O,,,5,1,1,0,1
22579_0,,,,2,2,1,3
C(C(CO)(CCC=O)O)(O)=O,,,5,1,1,0,1
22581_0,,,,2,2,1,3
C(CCCC=O)=O,,,5,1,1,0,1
22582_0,,,,2,2,1,3
22584_0,,,,2,2,1,3
C(CCCC(CC=O)O)=O,,,5,1,1,0,1
22586_0,,,,2,2,1,3
C(CCC(C)(CC=O)O)=O,,,5,1,1,0,1
22587_0,,,,2,2,1,3
22589_0,,,,2,2,1,3
C(CCCC(CC(C(O)=O)=O)O)=O,,,5,1,1,0,1
22591_0,,,,2,2,1,3
C(CCC(C)(CC(C(O)=O)=O)O)=O,,,5,1,1,0,1
22592_0,,,,2,2,1,3
22594_0,,,,2,2,1,3
C(C(CCCC=O)(CC=O)O)(O)=O,,,5,1,1,0,1
22595_0,,,,2,2,1,3
22596_0,,,,2,2,1,3
22598_0,,,,2,2,1,3
C(CCC(C(C=O)=O)O)=O,,,5,1,1,0,1
22599_0,,,,2,2,1,3
22601_0,,,,2,2,1,3
C(CCC(CO)O)=O,,,5,1,1,0,1
22603_0,,,,2,2,1,3
C(C(CCC=O)C(CC(C)O)O)=O,,,5,1,1,0,1
22605_0,,,,2,2,1,3
C(CCC(C(CC=O)O)C(C)O)=O,,,5,1,1,0,1
22607_0,,,,2,2,1,3
C(CC(CCC=O)(CC(C)O)O)=O,,,5,1,1,0,1
22609_0,,,,2,2,1,3
C(CC(CC(CCCC=O)O)O)=O,,,5,1,1,0,1
22611_0,,,,2,2,1,3
C(CCC(C)(CC(CC=O)O)O)=O,,,5,1,1,0,1
22613_0,,,,2,2,1,3
C(C(C(C)O)C(CCC=O)O)=O,,,5,1,1,0,1
22615_0,,,,2,2,1,3
C(C(CCC=O)(CO)C(C)O)=O,,,5,1,1,0,1
22617_0,,,,2,2,1,3
C(C(CO)C(CCCC=O)O)=O,,,5,1,1,0,1
22619_0,,,,2,2,1,3
C(C(CO)C(C)(CCC=O)O)=O,,,5,1,1,0,1
22621_0,,,,2,2,1,3
C(C(C(C)O)C(CCCC=O)O)=O,,,5,1,1,0,1
22623_0,,,,2,2,1,3
C(C(C(C)O)C(C)(CCC=O)O)=O,,,5,1,1,0,1
22625_0,,,,2,2,1,3
C(C(CCC=O)(C(C)O)C(C)O)=O,,,5,1,1,0,1
22627_0,,,,2,2,1,3
C(C(C=O)(CCC=O)C(C)O)(O)=O,,,5,1,1,0,1
22629_0,,,,2,2,1,3
C(C(C=O)C(CCCC=O)O)(O)=O,,,5,1,1,0,1
22631_0,,,,2,2,1,3
C(C(C=O)C(C)(CCC=O)O)(O)=O,,,5,1,1,0,1
22633_0,,,,2,2,1,3
C(C(CCC=O)C(CC(O)=O)O)=O,,,5,1,1,0,1
22635_0,,,,2,2,1,3
C(C(CCC=O)C(CC=O)O)(O)=O,,,5,1,1,0,1
22637_0,,,,2,2,1,3
C(CC(CCC=O)(CC=O)O)(O)=O,,,5,1,1,0,1
22639_0,,,,2,2,1,3
C(C(C=O)C(CCC=O)O)(O)=O,,,5,1,1,0,1
22641_0,,,,2,2,1,3
C(C(C=O)(CCC=O)CO)(O)=O,,,5,1,1,0,1
22643_0,,,,2,2,1,3
C(CCC(C=O)C(C(CO)=O)O)=O,,,5,1,1,0,1
22645_0,,,,2,2,1,3
C(CCC(C(C(CC=O)O)=O)O)=O,,,5,1,1,0,1
22647_0,,,,2,2,1,3
C(CO)(C(CCC=O)(CC=O)O)=O,,,5,1,1,0,1
22649_0,,,,2,2,1,3
C(CCC(C=O)C(C=O)(CO)O)=O,,,5,1,1,0,1
22651_0,,,,2,2,1,3
C(CCC(C(C=O)(CC=O)O)O)=O,,,5,1,1,0,1
22653_0,,,,2,2,1,3
C(CCC(C(C(C=O)=O)O)O)=O,,,5,1,1,0,1
22655_0,,,,2,2,1,3
C(CCC(C(C=O)=O)(CO)O)=O,,,5,1,1,0,1
22657_0,,,,2,2,1,3
C(CCCC(C(C(C=O)=O)O)O)=O,,,5,1,1,0,1
22659_0,,,,2,2,1,3
C(CCC(C)(C(C(C=O)=O)O)O)=O,,,5,1,1,0,1
22661_0,,,,2,2,1,3
C(CCC(C(C=O)=O)(C(C)O)O)=O,,,5,1,1,0,1
22663_0,,,,2,2,1,3
C(C(C(C=O)=O)(CCC=O)O)(O)=O,,,5,1,1,0,1
22665_0,,,,2,2,1,3
C(C(CCC=O)CO)=O,,,5,1,1,0,1
22667_0,,,,2,2,1,3
C(CCC(CC=O)O)=O,,,5,1,1,0,1
22669_0,,,,2,2,1,3
C(CCC(C(C(O)=O)=O)CO)=O,,,5,1,1,0,1
22671_0,,,,2,2,1,3
C(CCC(CC(C(O)=O)=O)O)=O,,,5,1,1,0,1
22673_0,,,,2,2,1,3
C(CC(C(CCCC=O)=O)=O)=O,,,5,1,1,0,1
22675_0,,,,2,2,1,3
C(CCC(C=O)C(C(C)=O)=O)=O,,,5,1,1,0,1
22677_0,,,,2,2,1,3
C(CCCC(C(C(CO)=O)=O)O)=O,,,5,1,1,0,1
22679_0,,,,2,2,1,3
C(CCC(C(C(CO)=O)=O)(C)O)=O,,,5,1,1,0,1
22681_0,,,,2,2,1,3
C(CCC(C(C(C(C)O)=O)=O)O)=O,,,5,1,1,0,1
22683_0,,,,2,2,1,3
C(CCC(C(C(C(O)=O)=O)=O)O)=O,,,5,1,1,0,1
22685_0,,,,2,2,1,3
C(C(C=O)(CCC=O)O)=O,,,5,1,1,0,1
22687_0,,,,2,2,1,3
C(CCC(CO)C(C)O)=O,,,5,1,1,0,1
22689_0,,,,2,2,1,3
C(CCC(CC(C)O)O)=O,,,5,1,1,0,1
22691_0,,,,2,2,1,3
C(CCCC(CCO)O)=O,,,5,1,1,0,1
22693_0,,,,2,2,1,3
C(CCC(C)(CCO)O)=O,,,5,1,1,0,1
22695_0,,,,2,2,1,3
C(C(CCC=O)CO)(O)=O,,,5,1,1,0,1
22697_0,,,,2,2,1,3
C(CC(CCC=O)O)(O)=O,,,5,1,1,0,1
22699_0,,,,2,2,1,3
C(C(CCO)(CCCC=O)O)(O)=O,,,5,1,1,0,1
22701_0,,,,2,2,1,3
C(C(C)(C(CO)CCC=O)O)(O)=O,,,5,1,1,0,1
22703_0,,,,2,2,1,3
C(C(C)(CC(CCC=O)O)O)(O)=O,,,5,1,1,0,1
22705_0,,,,2,2,1,3
C(CCC(C(CO)=O)O)=O,,,5,1,1,0,1
22706_0,,,,2,2,1,3
22708_0,,,,2,2,1,3
C(CCCCO)=O,,,5,1,1,0,1
22709_0,,,,2,2,1,3
22711_0,,,,2,2,1,3
C(C(CCC=O)C(C)O)(O)=O,,,5,1,1,0,1
22713_0,,,,2,2,1,3
C(CC(CCCC=O)O)(O)=O,,,5,1,1,0,1
22715_0,,,,2,2,1,3
C(CC(C)(CCC=O)O)(O)=O,,,5,1,1,0,1
22717_0,,,,2,2,1,3
C(CCC(C(O)=O)C(O)=O)=O,,,5,1,1,0,1
22719_0,,,,2,2,1,3
C(CCC(C(C(O)=O)=O)O)=O,,,5,1,1,0,1
22721_0,,,,2,2,1,3
C(CCCC(O)=O)=O,,,5,1,2,0,2
22723_0,,,,2,2,1,3
C(C(CO)(C(CCC=O)O)O)(O)=O,,,5,1,1,0,1
22725_0,,,,2,2,1,3
C(CCCC(C(C(O)=O)O)O)=O,,,5,1,1,0,1
22727_0,,,,2,2,1,3
C(CCC(C)(C(C(O)=O)O)O)=O,,,5,1,1,0,1
22729_0,,,,2,2,1,3
C(C(CCC=O)(C(C)O)O)(O)=O,,,5,1,1,0,1
22731_0,,,,2,2,1,3
C(C(C(O)=O)(CCC=O)O)(O)=O,,,5,1,1,0,1
22733_0,,,,2,2,1,3
C(CCCC(C(O)=O)O)=O,,,5,1,1,0,1
22735_0,,,,2,2,1,3
C(C(C)(CCC=O)O)(O)=O,,,5,1,1,0,1
22737_0,,,,2,2,1,3
C(C(C=O)(CCCC=O)O)(O)=O,,,5,1,1,0,1
22739_0,,,,2,2,1,3
C(C(C=O)(CCC=O)O)(O)=O,,,5,1,1,0,1
22741_0,,,,2,2,1,3
C(C(C(CCCC=O)=O)CO)(O)=O,,,5,1,1,0,1
22743_0,,,,2,2,1,3
C(CCC(C(C(O)=O)C(C)=O)O)=O,,,5,1,1,0,1
22745_0,,,,2,2,1,3
C(CCC(C(O)=O)(C(C)=O)CO)=O,,,5,1,1,0,1
22747_0,,,,2,2,1,3
C(CCCC=CC=O)=O,,,5,1,1,0,1
22749_0,,,,2,2,1,3
C(C(C=C)CCC=O)=O,,,5,1,1,0,1
22751_0,,,,2,2,1,3
C(CCCC=CC(C(O)=O)=O)=O,,,5,1,1,0,1
22753_0,,,,2,2,1,3
C(CCC(C=C)C(C(O)=O)=O)=O,,,5,1,1,0,1
22755_0,,,,2,2,1,3
C(C(C(C(O)=O)=C)CCC=O)=O,,,5,1,1,0,1
22757_0,,,,2,2,1,3
C(CCCC(C(O)=O)=CC=O)=O,,,5,1,1,0,1
22759_0,,,,2,2,1,3
C(C(C=C)(C(CCC=O)O)O)(O)=O,,,5,1,1,0,1
22761_0,,,,2,2,1,3
C(CCCC1C(OC(C(C=1)=O)=O)=O)=O,,,5,1,1,0,1
22763_0,,,,2,2,1,3
C(CCC1C(C(OC(C1=C)=O)=O)=O)=O,,,5,1,1,0,1
22765_0,,,,2,2,1,3
C(CCC(CO)(C(C)O)O)=O,,,5,1,1,0,1
22767_0,,,,2,2,1,3
C(CCC(C(C(C)O)O)O)=O,,,5,1,1,0,1
22769_0,,,,2,2,1,3
C(CCCC(C(CO)O)O)=O,,,5,1,1,0,1
22771_0,,,,2,2,1,3
C(CCC(C)(C(CO)O)O)=O,,,5,1,1,0,1
22773_0,,,,2,2,1,3
C1(C(CC(O)O1)(CCCC=O)O)=O,,,5,1,1,0,1
22775_0,,,,2,2,1,3
C1(C(C)(C(C(O)O1)CCC=O)O)=O,,,5,1,1,0,1
22777_0,,,,2,2,1,3
C1(C(C)(CC(CCC=O)(O)O1)O)=O,,,5,1,1,0,1
22779_0,,,,2,2,1,3
C(CCC1C(C(OC1C)=O)=O)=O,,,5,1,1,0,1
22781_0,,,,2,2,1,3
C(CCCC1CC(C(O1)=O)=O)=O,,,5,1,1,0,1
22783_0,,,,2,2,1,3
C(CCC1(C)CC(C(O1)=O)=O)=O,,,5,1,1,0,1
22785_0,,,,2,2,1,3
C(CCC1C(OC(C1=O)=O)=O)=O,,,5,1,1,0,1
22787_0,,,,2,2,1,3
C(CCCC(C(O)=O)=O)=O,,,5,1,2,0,2
22789_0,,,,2,2,1,3
C=CC(CCCC(C(O)=O)=O)O,,,5,1,1,0,1
22791_0,,,,2,2,1,3
C(C(C)(CCC(C(O)=O)=O)O)=C,,,5,1,1,0,1
22793_0,,,,2,2,1,3
C(C(CO)(CCC(C(O)=O)=O)O)=C,,,5,1,1,0,1
22795_0,,,,2,2,1,3
C=CC(C(CCC(C(O)=O)=O)O)O,,,5,1,1,0,1
22797_0,,,,2,2,1,3
C(C(CCC(CO)(CO)O)=O)(O)=O,,,5,1,1,0,1
22799_0,,,,2,2,1,3
C(C(CCC(C(CO)O)O)=O)(O)=O,,,5,1,1,0,1
22801_0,,,,2,2,1,3
C(C(CCC(C(O)=O)=O)(CC)O)=O,,,5,1,1,0,1
22803_0,,,,2,2,1,3
C(C(CCCCC(C(O)=O)=O)O)=O,,,5,1,1,0,1
22805_0,,,,2,2,1,3
C(C(C(CCC(C(O)=O)=O)C)O)=O,,,5,1,1,0,1
22807_0,,,,2,2,1,3
C(C(CCC(C(O)=O)=O)CCO)=O,,,5,1,1,0,1
22808_0,,,,2,2,1,3
22810_0,,,,2,2,1,3
C(CC(CCC(C(O)=O)=O)CO)=O,,,5,1,1,0,1
22811_0,,,,2,2,1,3
22812_0,,,,2,2,1,3
22814_0,,,,2,2,1,3
C(CC(CCCC(C(O)=O)=O)O)=O,,,5,1,1,0,1
22816_0,,,,2,2,1,3
C(CC(C)(CCC(C(O)=O)=O)O)=O,,,5,1,1,0,1
22817_0,,,,2,2,1,3
22819_0,,,,2,2,1,3
C(C(O)=O)(CCC(C(C=O)=O)O)=O,,,5,1,1,0,1
22820_0,,,,2,2,1,3
22822_0,,,,2,2,1,3
C(C(CCC(CO)O)=O)(O)=O,,,5,1,1,0,1
22824_0,,,,2,2,1,3
C(C(CCC(C(O)=O)=O)CO)=O,,,5,1,1,0,1
22826_0,,,,2,2,1,3
C(CC(CCC(C(O)=O)=O)O)=O,,,5,1,1,0,1
22828_0,,,,2,2,1,3
C(C(C=O)(CCC(C(O)=O)=O)O)=O,,,5,1,1,0,1
22830_0,,,,2,2,1,3
C(C(CCC(CO)C(C)O)=O)(O)=O,,,5,1,1,0,1
22832_0,,,,2,2,1,3
C(C(CCC(CC(C)O)O)=O)(O)=O,,,5,1,1,0,1
22834_0,,,,2,2,1,3
C(C(CCCC(CCO)O)=O)(O)=O,,,5,1,1,0,1
22836_0,,,,2,2,1,3
C(C(CCC(C)(CCO)O)=O)(O)=O,,,5,1,1,0,1
22838_0,,,,2,2,1,3
C(C(CCC(C(O)=O)=O)CO)(O)=O,,,5,1,1,0,1
22840_0,,,,2,2,1,3
C(CC(CCC(C(O)=O)=O)O)(O)=O,,,5,1,1,0,1
22842_0,,,,2,2,1,3
C(CO)(C(CCC(C(O)=O)=O)O)=O,,,5,1,1,0,1
22843_0,,,,2,2,1,3
22845_0,,,,2,2,1,3
C(C(CCCCO)=O)(O)=O,,,5,1,1,0,1
22846_0,,,,2,2,1,3
22848_0,,,,2,2,1,3
C(CCCC(C(O)=O)=O)(O)=O,,,5,1,2,0,2
22850_0,,,,2,2,1,3
C(C(CCCC(C(O)=O)=O)O)(O)=O,,,5,1,1,0,1
22852_0,,,,2,2,1,3
C(C(C)(CCC(C(O)=O)=O)O)(O)=O,,,5,1,1,0,1
22854_0,,,,2,2,1,3
C(CCCC(C(O)=O)=O)=CC=O,,,5,1,1,0,1
22856_0,,,,2,2,1,3
C(C(C=C)CCC(C(O)=O)=O)=O,,,5,1,1,0,1
22858_0,,,,2,2,1,3
C(C(O)=O)(CCCC(C(O)=O)=O)=O,,,5,1,1,0,1
22860_0,,,,2,2,1,3
C(CCCC(C=C)O)(O)=O,,,5,1,1,0,1
22862_0,,,,2,2,1,3
C(C(C(C)=O)CCC(C=C)O)(O)=O,,,5,1,1,0,1
22864_0,,,,2,2,1,3
C1(C(CC(O)O1)CCC(C=C)O)=O,,,5,1,1,0,1
22866_0,,,,2,2,1,3
C1(C(C)C(C(O)O1)CC(C=C)O)=O,,,5,1,1,0,1
22867_0,,,,2,2,1,3
22869_0,,,,2,2,1,3
C=CC(CC(C)CC(C(O)=O)=O)O,,,5,1,1,0,1
22871_0,,,,2,2,1,3
C(C(CCC(C=C)O)CC=O)(O)=O,,,5,1,1,0,1
22873_0,,,,2,2,1,3
C(C(C)(CC(C=C)O)CC=O)(O)=O,,,5,1,1,0,1
22875_0,,,,2,2,1,3
C(C(C)C(C=O)CC(C=C)O)(O)=O,,,5,1,1,0,1
22877_0,,,,2,2,1,3
C(CCC(C=C)(C)O)(O)=O,,,5,1,1,0,1
22879_0,,,,2,2,1,3
C(C(C(C)=O)CC(C=C)(C)O)(O)=O,,,5,1,1,0,1
22881_0,,,,2,2,1,3
C1(C(CC(C=C)(C)O)CC(O)O1)=O,,,5,1,1,0,1
22883_0,,,,2,2,1,3
C1(C(C)C(C(O)O1)C(C=C)(C)O)=O,,,5,1,1,0,1
22884_0,,,,2,2,1,3
22886_0,,,,2,2,1,3
C(C(C)(C(C)CC(C(O)=O)=O)O)=C,,,5,1,1,0,1
22888_0,,,,2,2,1,3
C(C(CC(C=C)(C)O)CC=O)(O)=O,,,5,1,1,0,1
22890_0,,,,2,2,1,3
C(C(C)(CC=O)C(C=C)(C)O)(O)=O,,,5,1,1,0,1
22892_0,,,,2,2,1,3
C(C(C)C(C=O)C(C=C)(C)O)(O)=O,,,5,1,1,0,1
22894_0,,,,2,2,1,3
C(C(C=C)(CCCC(O)=O)O)(O)=O,,,5,1,1,0,1
22896_0,,,,2,2,1,3
C(CCCC(C(C(O)=O)=C)=O)(O)=O,,,5,1,1,0,1
22898_0,,,,2,2,1,3
C(CCC(C=C)(CO)O)(O)=O,,,5,1,1,0,1
22900_0,,,,2,2,1,3
C(CCC(C(C=C)O)O)(O)=O,,,5,1,1,0,1
22902_0,,,,2,2,1,3
C(CCC1C(C(OC1O)=O)=C)(O)=O,,,5,1,1,0,1
22904_0,,,,2,2,1,3
C(CCC1(CC(C(O1)=O)=C)O)(O)=O,,,5,1,1,0,1
22906_0,,,,2,2,1,3
C(CCCC1C(OC(C=1)O)=O)(O)=O,,,5,1,1,0,1
22908_0,,,,2,2,1,3
C(CCC1(C=C(C(O1)=O)C)O)(O)=O,,,5,1,1,0,1
22910_0,,,,2,2,1,3
C1(C(C=CO1)(CCCC(O)=O)O)=O,,,5,1,1,0,1
22912_0,,,,2,2,1,3
C(CCC(CO)(CO)O)(O)=O,,,5,1,1,0,1
22914_0,,,,2,2,1,3
C(CCC(C(CO)O)O)(O)=O,,,5,1,1,0,1
22916_0,,,,2,2,1,3
C(C(CCC(O)=O)(CC)O)=O,,,5,1,1,0,1
22918_0,,,,2,2,1,3
C(CCCCC(C=O)O)(O)=O,,,5,1,1,0,1
22920_0,,,,2,2,1,3
C(CCC(C)C(C=O)O)(O)=O,,,5,1,1,0,1
22922_0,,,,2,2,1,3
C(C(CCC(O)=O)CCO)=O,,,5,1,1,0,1
22924_0,,,,2,2,1,3
C(CCC(CCC=O)O)(O)=O,,,5,1,1,0,1
22926_0,,,,2,2,1,3
C(CCC(CO)CC=O)(O)=O,,,5,1,1,0,1
22928_0,,,,2,2,1,3
C(CCC1C(C(C(O)O1)=O)O)(O)=O,,,5,1,1,0,1
22930_0,,,,2,2,1,3
C(CCC1(C(C(O)OC1)=O)O)(O)=O,,,5,1,1,0,1
22932_0,,,,2,2,1,3
C(CCC1(C(C(CO1)O)=O)O)(O)=O,,,5,1,1,0,1
22934_0,,,,2,2,1,3
C(CCC1C(C(OC1)=O)=O)(O)=O,,,5,1,1,0,1
22936_0,,,,2,2,1,3
C(CCC1CC(C(O1)=O)=O)(O)=O,,,5,1,1,0,1
22938_0,,,,2,2,1,3
C(CCC1C(C(C(O1)=O)=O)=O)(O)=O,,,5,1,1,0,1
22940_0,,,,2,2,1,3
C1(C(CCO1)(CCCC(O)=O)O)=O,,,5,1,1,0,1
22942_0,,,,2,2,1,3
C1(C(C)(C(CO1)CCC(O)=O)O)=O,,,5,1,1,0,1
22944_0,,,,2,2,1,3
C1(C(C)(CC(CCC(O)=O)O1)O)=O,,,5,1,1,0,1
22946_0,,,,2,2,1,3
C(C(CCC(O)=O)C(C)CO)=O,,,5,1,1,0,1
22948_0,,,,2,2,1,3
C(CCCC(CO)CC=O)(O)=O,,,5,1,1,0,1
22950_0,,,,2,2,1,3
C(CCC(C)(CO)CC=O)(O)=O,,,5,1,1,0,1
22952_0,,,,2,2,1,3
C(CCC(C(C)CC=O)O)(O)=O,,,5,1,1,0,1
22954_0,,,,2,2,1,3
C(C(CCC(O)=O)C(C)CCO)=O,,,5,1,1,0,1
22956_0,,,,2,2,1,3
C(CCCC(CCO)CC=O)(O)=O,,,5,1,1,0,1
22958_0,,,,2,2,1,3
C(CCC(C)(CCO)CC=O)(O)=O,,,5,1,1,0,1
22960_0,,,,2,2,1,3
C(CCC(CO)C(C)CC=O)(O)=O,,,5,1,1,0,1
22962_0,,,,2,2,1,3
C(CCC(CC(C)CC=O)O)(O)=O,,,5,1,1,0,1
22964_0,,,,2,2,1,3
C(C(CCC(O)=O)C(C)C(C)O)=O,,,5,1,1,0,1
22966_0,,,,2,2,1,3
C(CCCC(C(C)O)CC=O)(O)=O,,,5,1,1,0,1
22968_0,,,,2,2,1,3
C(CCC(C)(C(C)O)CC=O)(O)=O,,,5,1,1,0,1
22970_0,,,,2,2,1,3
C(CCCC(C(C)CC=O)O)(O)=O,,,5,1,1,0,1
22972_0,,,,2,2,1,3
C(CCC(C)(C(C)CC=O)O)(O)=O,,,5,1,1,0,1
22974_0,,,,2,2,1,3
C(C(CCC(O)=O)C(C)CC=O)=O,,,5,1,1,0,1
22976_0,,,,2,2,1,3
C(CC(CCCC(O)=O)CC=O)=O,,,5,1,1,0,1
22978_0,,,,2,2,1,3
C(CC(C)(CCC(O)=O)CC=O)=O,,,5,1,1,0,1
22980_0,,,,2,2,1,3
C(CCC(C(C(O)=O)O)O)(O)=O,,,5,1,1,0,1
22982_0,,,,2,2,1,3
C(C(CO)(CCC(O)=O)O)(O)=O,,,5,1,1,0,1
22983_0,,,,2,2,1,3
22984_0,,,,2,2,1,3
22986_0,,,,2,2,1,3
C(CCCC(CC=O)O)(O)=O,,,5,1,1,0,1
22988_0,,,,2,2,1,3
C(CCC(C)(CC=O)O)(O)=O,,,5,1,1,0,1
22989_0,,,,2,2,1,3
22991_0,,,,2,2,1,3
C(CCC(C(C=O)=O)O)(O)=O,,,5,1,1,0,1
22993_0,,,,2,2,1,3
C(CCC(C(O)=O)O)(O)=O,,,5,1,1,0,1
22995_0,,,,2,2,1,3
C(CCC(CO)O)(O)=O,,,5,1,1,0,1
22997_0,,,,2,2,1,3
C(C(C(C)O)C(CCC(O)=O)O)=O,,,5,1,1,0,1
22999_0,,,,2,2,1,3
C(C(CCC(O)=O)(CO)C(C)O)=O,,,5,1,1,0,1
23001_0,,,,2,2,1,3
C(C(CO)C(CCCC(O)=O)O)=O,,,5,1,1,0,1
23003_0,,,,2,2,1,3
C(C(CO)C(C)(CCC(O)=O)O)=O,,,5,1,1,0,1
23005_0,,,,2,2,1,3
C(C(C=O)C(CCC(O)=O)O)(O)=O,,,5,1,1,0,1
23007_0,,,,2,2,1,3
C(C(C=O)(CCC(O)=O)CO)(O)=O,,,5,1,1,0,1
23009_0,,,,2,2,1,3
C(CCC(C(C(C=O)=O)O)O)(O)=O,,,5,1,1,0,1
23011_0,,,,2,2,1,3
C(CCC(C(C=O)=O)(CO)O)(O)=O,,,5,1,1,0,1
23013_0,,,,2,2,1,3
C(C(CCC(O)=O)CO)=O,,,5,1,1,0,1
23015_0,,,,2,2,1,3
C(CCC(CC=O)O)(O)=O,,,5,1,1,0,1
23017_0,,,,2,2,1,3
C(CCC(C(C(O)=O)=O)CO)(O)=O,,,5,1,1,0,1
23019_0,,,,2,2,1,3
C(CCC(CC(C(O)=O)=O)O)(O)=O,,,5,1,1,0,1
23021_0,,,,2,2,1,3
C(CC(C(CCCC(O)=O)=O)=O)=O,,,5,1,1,0,1
23023_0,,,,2,2,1,3
C(C(C(C(C)=O)=O)CCC(O)=O)=O,,,5,1,1,0,1
23025_0,,,,2,2,1,3
C(C(C=O)(CCC(O)=O)O)=O,,,5,1,1,0,1
23027_0,,,,2,2,1,3
C(CCC(CO)C(C)O)(O)=O,,,5,1,1,0,1
23029_0,,,,2,2,1,3
C(CCC(CC(C)O)O)(O)=O,,,5,1,1,0,1
23031_0,,,,2,2,1,3
C(CCCC(CCO)O)(O)=O,,,5,1,1,0,1
23033_0,,,,2,2,1,3
C(CCC(C)(CCO)O)(O)=O,,,5,1,1,0,1
23035_0,,,,2,2,1,3
C(C(CCC(O)=O)CO)(O)=O,,,5,1,1,0,1
23037_0,,,,2,2,1,3
C(CCC(CC(O)=O)O)(O)=O,,,5,1,1,0,1
23039_0,,,,2,2,1,3
C(CCC(C(CO)=O)O)(O)=O,,,5,1,1,0,1
23040_0,,,,2,2,1,3
23042_0,,,,2,2,1,3
C(CCCCO)(O)=O,,,5,1,1,0,1
23044_0,,,,2,2,1,3
C(CCC(C)O)(O)=O,,,5,1,1,0,1
23046_0,,,,2,2,1,3
C(C(CCC(O)=O)C(C)O)(O)=O,,,5,1,1,0,1
23048_0,,,,2,2,1,3
C(CCCC(CC(O)=O)O)(O)=O,,,5,1,1,0,1
23050_0,,,,2,2,1,3
C(CCC(C)(CC(O)=O)O)(O)=O,,,5,1,1,0,1
23052_0,,,,2,2,1,3
C(C(C(O)=O)CCC(O)=O)(O)=O,,,5,1,1,0,1
23053_0,,,,2,2,1,3
23055_0,,,,2,2,1,3
C(CCCC(O)=O)(O)=O,,,5,1,1,0,1
23057_0,,,,2,2,1,3
C(CCCC(C(C(O)=O)O)O)(O)=O,,,5,1,1,0,1
23059_0,,,,2,2,1,3
C(CCC(C)(C(C(O)=O)O)O)(O)=O,,,5,1,1,0,1
23061_0,,,,2,2,1,3
C(C(CCC(O)=O)(C(C)O)O)(O)=O,,,5,1,1,0,1
23063_0,,,,2,2,1,3
C(C(C(O)=O)(CCC(O)=O)O)(O)=O,,,5,1,1,0,1
23065_0,,,,2,2,1,3
C(CCCC(C(O)=O)O)(O)=O,,,5,1,1,0,1
23067_0,,,,2,2,1,3
C(C(C)(CCC(O)=O)O)(O)=O,,,5,1,1,0,1
23069_0,,,,2,2,1,3
C(C(C=O)(CCCC(O)=O)O)(O)=O,,,5,1,1,0,1
23070_0,,,,2,2,1,3
23072_0,,,,2,2,1,3
C(CCCC=CC=O)(O)=O,,,5,1,1,0,1
23074_0,,,,2,2,1,3
C(C(C=C)CCC(O)=O)=O,,,5,1,1,0,1
23076_0,,,,2,2,1,3
C(CCCC=CC(C(O)=O)=O)(O)=O,,,5,1,1,0,1
23078_0,,,,2,2,1,3
C(CCC(C=C)C(C(O)=O)=O)(O)=O,,,5,1,1,0,1
23080_0,,,,2,2,1,3
C(C(C(C(O)=O)=C)CCC(O)=O)=O,,,5,1,1,0,1
23082_0,,,,2,2,1,3
C(CCCC(C(O)=O)=CC=O)(O)=O,,,5,1,1,0,1
23084_0,,,,2,2,1,3
C(CCC(CO)(C(C)O)O)(O)=O,,,5,1,1,0,1
23086_0,,,,2,2,1,3
C(CCC(C(C(C)O)O)O)(O)=O,,,5,1,1,0,1
23088_0,,,,2,2,1,3
C(CCCC(C(CO)O)O)(O)=O,,,5,1,1,0,1
23090_0,,,,2,2,1,3
C(CCC(C)(C(CO)O)O)(O)=O,,,5,1,1,0,1
23092_0,,,,2,2,1,3
C(CCC1C(C(OC1C)=O)=O)(O)=O,,,5,1,1,0,1
23094_0,,,,2,2,1,3
C(CCCC1CC(C(O1)=O)=O)(O)=O,,,5,1,1,0,1
23096_0,,,,2,2,1,3
C(CCC1(C)CC(C(O1)=O)=O)(O)=O,,,5,1,1,0,1
23098_0,,,,2,2,1,3
C1(C(C(C(O1)=O)=O)CCC(O)=O)=O,,,5,1,1,0,1
23099_0,,,,2,2,1,3
23101_0,,,,2,2,1,3
C(C(C=C)(CC(C)CC=O)O)(O)=O,,,5,1,1,0,1
23102_0,,,,2,2,1,3
23104_0,,,,2,2,1,3
C(CC(CO)C(C(O)=O)O)(O)=O,,,5,1,1,0,1
23106_0,,,,2,2,1,3
C(CC(CCO)C(C(O)=O)O)(O)=O,,,5,1,1,0,1
23108_0,,,,2,2,1,3
C(CC(C(C)O)C(C(O)=O)O)(O)=O,,,5,1,1,0,1
23110_0,,,,2,2,1,3
C(CC(C)CC(C(C(O)=O)=C)=O)=O,,,5,1,1,0,1
23111_0,,,,2,2,1,3
23113_0,,,,2,2,1,3
C(C(CC(C(O)=O)C(C)=O)O)(O)=O,,,5,1,1,0,1
23115_0,,,,2,2,1,3
C(C(C(C)=O)CC(CO)O)(O)=O,,,5,1,1,0,1
23117_0,,,,2,2,1,3
C(C(CC(C(O)=O)C(C)=O)CO)=O,,,5,1,1,0,1
23119_0,,,,2,2,1,3
C(CC(CC(C(O)=O)C(C)=O)O)=O,,,5,1,1,0,1
23121_0,,,,2,2,1,3
C(C(C(C)=O)CCO)(O)=O,,,5,1,1,0,1
23123_0,,,,2,2,1,3
C(C(C(C)=O)CCCO)(O)=O,,,5,1,1,0,1
23125_0,,,,2,2,1,3
C(C(C(C)=O)CC(C)O)(O)=O,,,5,1,1,0,1
23126_0,,,,2,2,1,3
23128_0,,,,2,2,1,3
C(C)(C(C(O)=O)CCC=CC=O)=O,,,5,1,1,0,1
23130_0,,,,2,2,1,3
C(C(C=C)CC(C(C)=O)C(O)=O)=O,,,5,1,1,0,1
23132_0,,,,2,2,1,3
C1(C(C=C(C(O)=O)O1)CCC=O)=O,,,5,1,1,0,1
23133_0,,,,2,2,1,3
23135_0,,,,2,2,1,3
C1(C(C=C(C(O)=O)O1)CCCO)=O,,,5,1,1,0,1
23137_0,,,,2,2,1,3
C1(C(C=C(C(O)=O)O1)CC(C)O)=O,,,5,1,1,0,1
23138_0,,,,2,2,1,3
23139_0,,,,2,2,1,3
23140_0,,,,2,2,1,3
23141_0,,,,2,2,1,3
23142_0,,,,2,2,1,3
23143_0,,,,2,2,1,3
23144_0,,,,2,2,1,3
23145_0,,,,2,2,1,3
23146_0,,,,2,2,1,3
23147_0,,,,2,2,1,3
23149_0,,,,2,2,1,3
C(CC(C)C1(CC(C(O1)=O)=C)O)=O,,,5,1,1,0,1
23150_0,,,,2,2,1,3
23151_0,,,,2,2,1,3
23152_0,,,,2,2,1,3
23153_0,,,,2,2,1,3
23154_0,,,,2,2,1,3
23155_0,,,,2,2,1,3
23156_0,,,,2,2,1,3
23157_0,,,,2,2,1,3
23158_0,,,,2,2,1,3
23159_0,,,,2,2,1,3
23160_0,,,,2,2,1,3
23162_0,,,,2,2,1,3
C(CC(C)CC1C(OC(C=1)O)=O)=O,,,5,1,1,0,1
23164_0,,,,2,2,1,3
C(CC(C)C1(C=C(C(O1)=O)C)O)=O,,,5,1,1,0,1
23165_0,,,,2,2,1,3
23166_0,,,,2,2,1,3
23167_0,,,,2,2,1,3
23168_0,,,,2,2,1,3
23169_0,,,,2,2,1,3
23170_0,,,,2,2,1,3
23171_0,,,,2,2,1,3
23172_0,,,,2,2,1,3
23173_0,,,,2,2,1,3
23174_0,,,,2,2,1,3
23175_0,,,,2,2,1,3
23177_0,,,,2,2,1,3
C1(C(C=CO1)(CC(C)CC=O)O)=O,,,5,1,1,0,1
23179_0,,,,2,2,1,3
C1(C(CCO)C(C(O)=O)(CO1)O)=O,,,5,1,1,0,1
23181_0,,,,2,2,1,3
C1(C(CCO)C(C(O1)=O)(CO)O)=O,,,5,1,1,0,1
23183_0,,,,2,2,1,3
C1(C(C(C(C(O)=O)O1)O)CCO)=O,,,5,1,1,0,1
23184_0,,,,2,2,1,3
23185_0,,,,2,2,1,3
23187_0,,,,2,2,1,3
C(C(CC)(C(C)CC=O)O)=O,,,5,1,1,0,1
23188_0,,,,2,2,1,3
23190_0,,,,2,2,1,3
C(CC(C)C(C)C(C=O)O)=O,,,5,1,1,0,1
23191_0,,,,2,2,1,3
23192_0,,,,2,2,1,3
23194_0,,,,2,2,1,3
C(CC(C)C(CO)CC=O)=O,,,5,1,1,0,1
23195_0,,,,2,2,1,3
23196_0,,,,2,2,1,3
23198_0,,,,2,2,1,3
C(CC(C)C1(C(C(CO1)O)=O)O)=O,,,5,1,1,0,1
23199_0,,,,2,2,1,3
23200_0,,,,2,2,1,3
23202_0,,,,2,2,1,3
C(CC(C)C1C(C(C(O1)=O)=O)=O)=O,,,5,1,1,0,1
23204_0,,,,2,2,1,3
C1(C(CCO1)(CC(C)CC=O)O)=O,,,5,1,1,0,1
23206_0,,,,2,2,1,3
C1(C(C)(C(CO1)C(C)CC=O)O)=O,,,5,1,1,0,1
23208_0,,,,2,2,1,3
C1(C(C)(CC(C(C)CC=O)O1)O)=O,,,5,1,1,0,1
23210_0,,,,2,2,1,3
C(C(C(C)CC=O)C(C)CO)=O,,,5,1,1,0,1
23212_0,,,,2,2,1,3
C(CC(CO)CC(C)CC=O)=O,,,5,1,2,0,2
23214_0,,,,2,2,1,3
C(CC(C)(CO)C(C)CC=O)=O,,,5,1,1,0,1
23216_0,,,,2,2,1,3
C(CC(C)C(C(C)CC=O)O)=O,,,5,1,1,0,1
23218_0,,,,2,2,1,3
C(C(C(C)CC=O)C(C)CCO)=O,,,5,1,1,0,1
23220_0,,,,2,2,1,3
C(CC(C)CC(CCO)CC=O)=O,,,5,1,2,0,2
23222_0,,,,2,2,1,3
C(CC(C)C(C)(CCO)CC=O)=O,,,5,1,1,0,1
23224_0,,,,2,2,1,3
C(CC(C)C(CO)C(C)CC=O)=O,,,5,1,1,0,1
23226_0,,,,2,2,1,3
C(CC(C)CC(C(C)CC=O)O)=O,,,5,1,2,0,2
23228_0,,,,2,2,1,3
C(C(C(C)CC=O)C(C)C(C)O)=O,,,5,1,1,0,1
23230_0,,,,2,2,1,3
C(CC(CC(C)CC=O)C(C)O)=O,,,5,1,2,0,2
23232_0,,,,2,2,1,3
C(CC(C)(C(C)CC=O)C(C)O)=O,,,5,1,1,0,1
23233_0,,,,2,2,1,3
23235_0,,,,2,2,1,3
C(CC(C)C(C)(C(C)CC=O)O)=O,,,5,1,1,0,1
23237_0,,,,2,2,1,3
C(CC(CC(C)CC=O)CC=O)=O,,,5,1,2,0,2
23238_0,,,,2,2,1,3
23239_0,,,,2,2,1,3
23240_0,,,,2,2,1,3
23242_0,,,,2,2,1,3
C(C(C(C)CC=O)C(C)CC=O)=O,,,5,1,1,0,1
23243_0,,,,2,2,1,3
23245_0,,,,2,2,1,3
C(CC(C)(C(C)CC=O)CC=O)=O,,,5,1,1,0,1
23247_0,,,,2,2,1,3
C(CC(C(C(O)=O)=O)CC(O)=O)=O,,,5,1,1,0,1
23248_0,,,,2,2,1,3
23250_0,,,,2,2,1,3
C(CC(C(C(O)=O)=O)CCO)(O)=O,,,5,1,1,0,1
23251_0,,,,2,2,1,3
23253_0,,,,2,2,1,3
C(CC(C(O)=O)CC(C(O)=O)=O)=O,,,5,1,1,0,1
23254_0,,,,2,2,1,3
23255_0,,,,2,2,1,3
23257_0,,,,2,2,1,3
C(C(C(C)O)CC(C(O)=O)=O)(O)=O,,,5,1,1,0,1
23259_0,,,,2,1,2,3
C=CC(C(C=O)=O)=O,,,5,1,1,0,1
23261_0,,,,2,1,2,3
C(C(C=O)=CC=O)=O,,,5,1,1,0,1
23262_0,,,,2,1,2,3
23263_0,,,,2,1,2,3
23264_0,,,,2,1,2,3
23265_0,,,,2,1,2,3
23267_0,,,,2,1,1,2
C(C(O)OC(C(CO)=C)=O)(O)=O,,,5,1,1,0,1
23269_0,,,,2,1,2,3
C1(C(C=CC(O1)=O)=O)=O,,,5,1,5,0,5
23271_0,,,,2,1,1,2
C(C(O)OCC(C(O)=O)=C)(O)=O,,,5,1,1,0,1
23273_0,,,,2,1,1,2
C(C(C=CC(O)=O)=O)(OC)=O,,,5,1,1,0,1
23276_0,,,,2,1,2,3
C(C(C(C)O)C(C=CC=O)O)=O,,,5,1,1,0,1
C,,,5,1,129,0,129
23277_0,,,,2,1,2,3
23279_0,,,,2,1,2,3
C(C(C=CC=O)(CO)C(C)O)=O,,,5,1,1,0,1
23280_0,,,,2,1,2,3
23282_0,,,,2,1,2,3
C(C(CO)C(CC=CC=O)O)=O,,,5,1,1,0,1
23283_0,,,,2,1,2,3
23285_0,,,,2,1,2,3
C(C(CO)C(C=CC=O)(C)O)=O,,,5,1,1,0,1
23286_0,,,,2,1,2,3
23288_0,,,,2,1,2,3
C(C(C=O)C(C=CC=O)O)(O)=O,,,5,1,1,0,1
23289_0,,,,2,1,2,3
23291_0,,,,2,1,2,3
C(C(C=O)(C=CC=O)CO)(O)=O,,,5,1,1,0,1
23292_0,,,,2,1,2,3
23294_0,,,,2,1,2,3
C(C(C(C(C=O)=O)O)O)=CC=O,,,5,1,1,0,1
23295_0,,,,2,1,2,3
23297_0,,,,2,1,2,3
C(C(C(C=O)=O)(CO)O)=CC=O,,,5,1,1,0,1
23298_0,,,,2,1,2,3
23300_0,,,,2,1,2,3
C(C(C=CC=O)CO)=O,,,5,1,1,0,1
23301_0,,,,2,1,2,3
23302_0,,,,2,1,2,3
23304_0,,,,2,1,2,3
C(CC=C(C=O)CO)=O,,,5,1,1,0,1
23306_0,,,,2,1,2,3
C(C(C=CC(C(O)=O)=O)CO)=O,,,5,1,1,0,1
23307_0,,,,2,1,2,3
23308_0,,,,2,1,2,3
23310_0,,,,2,1,2,3
C(CC(C(O)=O)=O)=C(C=O)CO,,,5,1,1,0,1
23311_0,,,,2,1,2,3
23312_0,,,,2,1,2,3
23314_0,,,,2,1,2,3
C(C(C)CO)=O,,,5,1,1,0,1
23316_0,,,,2,1,2,3
C(C(C(C(O)=O)=CC=O)CO)=O,,,5,1,1,0,1
23317_0,,,,2,1,2,3
23319_0,,,,2,1,2,3
C(CC(C(O)=O)=C(C=O)CO)=O,,,5,1,1,0,1
23320_0,,,,2,1,2,3
23322_0,,,,2,1,2,3
C(C(C(C=O)=CC(O)=O)CO)=O,,,5,1,1,0,1
23323_0,,,,2,1,2,3
23325_0,,,,2,1,2,3
C(CC)(O)=O,,,5,1,5,0,5
23327_0,,,,2,1,2,3
C(C(C(C=O)=CC=O)C)(O)=O,,,5,1,1,0,1
23329_0,,,,2,1,2,3
C(CC(C=CC=O)O)=O,,,5,1,1,0,1
23330_0,,,,2,1,2,3
23332_0,,,,2,1,2,3
C(CC(C=CC(C(O)=O)=O)O)=O,,,5,1,1,0,1
23333_0,,,,2,1,2,3
23334_0,,,,2,1,2,3
23335_0,,,,2,1,2,3
23336_0,,,,2,1,2,3
23337_0,,,,2,1,2,3
23339_0,,,,2,1,2,3
C(CC(C(C=O)=CC(O)=O)O)=O,,,5,1,1,0,1
23340_0,,,,2,1,2,3
23342_0,,,,2,1,2,3
C(C(C(C(O)=O)=O)CO)=CC=O,,,5,1,1,0,1
23343_0,,,,2,1,2,3
23344_0,,,,2,1,2,3
23346_0,,,,2,1,2,3
C(CC=C(C(C(O)=O)=O)CO)=O,,,5,1,1,0,1
23348_0,,,,2,1,2,3
C(C(CC(C(O)=O)=O)O)=CC=O,,,5,1,1,0,1
23349_0,,,,2,1,2,3
23351_0,,,,2,1,2,3
C(CC(C(CC=CC=O)=O)=O)=O,,,5,1,1,0,1
23352_0,,,,2,1,2,3
23353_0,,,,2,1,2,3
23355_0,,,,2,1,2,3
C(CC(C(C=CCC=O)=O)=O)=O,,,5,1,1,0,1
23357_0,,,,2,1,2,3
C(C(C=CC=O)C(C(C)=O)=O)=O,,,5,1,1,0,1
23358_0,,,,2,1,2,3
23359_0,,,,2,1,2,3
23361_0,,,,2,1,2,3
C(CC=C(C=O)C(C(C)=O)=O)=O,,,5,1,1,0,1
23363_0,,,,2,1,2,3
C(C(C=O)(C=CC=O)O)=O,,,5,1,1,0,1
23364_0,,,,2,1,2,3
23365_0,,,,2,1,2,3
23366_0,,,,2,1,2,3
23368_0,,,,2,1,2,3
C(C(CC(C)O)O)=CC=O,,,5,1,1,0,1
23369_0,,,,2,1,2,3
23371_0,,,,2,1,2,3
C(CC(CCO)O)=CC=O,,,5,1,1,0,1
23372_0,,,,2,1,2,3
23374_0,,,,2,1,2,3
C(C(C)(CCO)O)=CC=O,,,5,1,1,0,1
23375_0,,,,2,1,2,3
23376_0,,,,2,1,2,3
23377_0,,,,2,1,2,3
23378_0,,,,2,1,2,3
23379_0,,,,2,1,2,3
23381_0,,,,2,1,2,3
C(CC(C=CC=O)O)(O)=O,,,5,1,1,0,1
23382_0,,,,2,1,2,3
23384_0,,,,2,1,2,3
C(CO)(C(C=CC=O)O)=O,,,5,1,1,0,1
23385_0,,,,2,1,2,3
23387_0,,,,2,1,2,3
C(CO)=CC=O,,,5,1,1,0,1
23388_0,,,,2,1,2,3
23390_0,,,,2,1,2,3
C(CO)=CC(C(O)=O)=O,,,5,1,1,0,1
23391_0,,,,2,1,2,3
23392_0,,,,2,1,2,3
23393_0,,,,2,1,2,3
23394_0,,,,2,1,2,3
23395_0,,,,2,1,2,3
23396_0,,,,2,1,2,3
23397_0,,,,2,1,2,3
23399_0,,,,2,1,1,2
C(C(O)OC(C(C)=CCO)=O)(O)=O,,,5,1,1,0,1
23400_0,,,,2,1,2,3
23402_0,,,,2,1,1,2
C(C(O)OC(C(CCO)=C)=O)(O)=O,,,5,1,1,0,1
23403_0,,,,2,1,2,3
23404_0,,,,2,1,2,3
23406_0,,,,2,1,2,3
C1(C(C(CO)=CC(O1)=O)=O)=O,,,5,1,1,0,1
23408_0,,,,2,1,2,3
C1(C(CO)=CC(C(O1)=O)=O)=O,,,5,1,1,0,1
23409_0,,,,2,1,2,3
23410_0,,,,2,1,2,3
23411_0,,,,2,1,2,3
23412_0,,,,2,1,2,3
23414_0,,,,2,1,2,3
C(C(C(CO)=CC(O)=O)=O)(O)=O,,,5,1,1,0,1
23415_0,,,,2,1,2,3
23416_0,,,,2,1,2,3
23417_0,,,,2,1,2,3
23418_0,,,,2,1,2,3
23419_0,,,,2,1,2,3
23420_0,,,,2,1,2,3
23421_0,,,,2,1,2,3
23422_0,,,,2,1,2,3
23423_0,,,,2,1,2,3
23425_0,,,,2,1,2,3
CCCO,,,5,1,2,0,2
23426_0,,,,2,1,2,3
23427_0,,,,2,1,2,3
23429_0,,,,2,1,2,3
C(C=C(C=O)CCO)(O)=O,,,5,1,1,0,1
23430_0,,,,2,1,2,3
23431_0,,,,2,1,2,3
23432_0,,,,2,1,2,3
23434_0,,,,2,1,2,3
C1(C(C(CCO)=CC(O1)=O)=O)=O,,,5,1,1,0,1
23435_0,,,,2,1,2,3
23437_0,,,,2,1,2,3
C1(C(C=C(C(O1)=O)CCO)=O)=O,,,5,1,1,0,1
23438_0,,,,2,1,2,3
23439_0,,,,2,1,2,3
23440_0,,,,2,1,2,3
23441_0,,,,2,1,2,3
23442_0,,,,2,1,2,3
23444_0,,,,2,1,2,3
C(C(C)O)=CC(C(O)=O)=O,,,5,1,1,0,1
23445_0,,,,2,1,2,3
23446_0,,,,2,1,2,3
23448_0,,,,2,1,2,3
CC(C)O,,,5,1,2,0,2
23449_0,,,,2,1,2,3
23450_0,,,,2,1,2,3
23452_0,,,,2,1,2,3
C(C=C(C=O)C(C)O)(O)=O,,,5,1,1,0,1
23453_0,,,,2,1,2,3
23454_0,,,,2,1,2,3
23456_0,,,,2,1,2,3
C1(C(C(C(C)O)=CC(O1)=O)=O)=O,,,5,1,1,0,1
23458_0,,,,2,1,2,3
C1(C(C=C(C(O1)=O)C(C)O)=O)=O,,,5,1,1,0,1
23459_0,,,,2,1,2,3
23460_0,,,,2,1,2,3
23461_0,,,,2,1,2,3
23462_0,,,,2,1,2,3
23463_0,,,,2,1,2,3
23464_0,,,,2,1,2,3
23465_0,,,,2,1,2,3
23466_0,,,,2,1,2,3
23467_0,,,,2,1,2,3
23469_0,,,,2,1,2,3
C(CC(C=CC=O)(C)O)(O)=O,,,5,1,1,0,1
23470_0,,,,2,1,2,3
23471_0,,,,2,1,2,3
23472_0,,,,2,1,2,3
23473_0,,,,2,1,2,3
23474_0,,,,2,1,2,3
23476_0,,,,2,1,2,3
C(C(C(C(O)=O)=O)O)=CC=O,,,5,1,1,0,1
23477_0,,,,2,1,2,3
23478_0,,,,2,1,2,3
23479_0,,,,2,1,2,3
23480_0,,,,2,1,2,3
23481_0,,,,2,1,2,3
23482_0,,,,2,1,2,3
23483_0,,,,2,1,2,3
23484_0,,,,2,1,2,3
23485_0,,,,2,1,2,3
23486_0,,,,2,1,2,3
23487_0,,,,2,1,2,3
23488_0,,,,2,1,2,3
23489_0,,,,2,1,2,3
23490_0,,,,2,1,2,3
23491_0,,,,2,1,2,3
23492_0,,,,2,1,2,3
23494_0,,,,2,1,2,3
C(CC(C=O)=CC(O)=O)(O)=O,,,5,1,1,0,1
23495_0,,,,2,1,2,3
23496_0,,,,2,1,2,3
23498_0,,,,2,1,2,3
C(C(C(CC=CC=O)O)O)(O)=O,,,5,1,1,0,1
23499_0,,,,2,1,2,3
23501_0,,,,2,1,2,3
C(C(C(C=CC=O)(C)O)O)(O)=O,,,5,1,1,0,1
23502_0,,,,2,1,2,3
23504_0,,,,2,1,2,3
C(C(C=CC=O)(C(C)O)O)(O)=O,,,5,1,1,0,1
23505_0,,,,2,1,2,3
23507_0,,,,2,1,2,3
C(C(C(O)=O)(C=CC=O)O)(O)=O,,,5,1,1,0,1
23508_0,,,,2,1,2,3
23510_0,,,,2,1,2,3
C(C(CC=CC=O)O)(O)=O,,,5,1,1,0,1
23511_0,,,,2,1,2,3
23512_0,,,,2,1,2,3
23513_0,,,,2,1,2,3
23515_0,,,,2,1,2,3
C(C(C=O)(CC=CC=O)O)(O)=O,,,5,1,1,0,1
23516_0,,,,2,1,2,3
23518_0,,,,2,1,2,3
C(C(C=O)(C=CC=O)O)(O)=O,,,5,1,1,0,1
23519_0,,,,2,1,2,3
23521_0,,,,2,1,2,3
C(CC=CC=O)=CC=O,,,5,1,1,0,1
23522_0,,,,2,1,2,3
23524_0,,,,2,1,2,3
C(CC=CC(C(O)=O)=O)=CC=O,,,5,1,2,0,2
23525_0,,,,2,1,2,3
23526_0,,,,2,1,2,3
23528_0,,,,2,1,2,3
C(CC)=CC=O,,,5,1,1,0,1
23530_0,,,,2,1,2,3
C(CC(C(O)=O)=CC=O)=CC=O,,,5,1,2,0,2
23531_0,,,,2,1,2,3
23533_0,,,,2,1,2,3
C(CC(C=O)=CC(O)=O)=CC=O,,,5,1,1,0,1
23534_0,,,,2,1,2,3
23535_0,,,,2,1,2,3
23537_0,,,,2,1,2,3
C(CC=C(C=O)C=C)=O,,,5,1,1,0,1
23538_0,,,,2,1,2,3
23540_0,,,,2,1,2,3
C(C(C=C)C=CC=O)=O,,,5,1,1,0,1
23541_0,,,,2,1,2,3
23542_0,,,,2,1,2,3
23543_0,,,,2,1,2,3
23545_0,,,,2,1,2,3
C(CC=C(C=C)C(C(O)=O)=O)=O,,,5,1,1,0,1
23546_0,,,,2,1,2,3
23548_0,,,,2,1,2,3
C=CC(C=CC=O)C(C(O)=O)=O,,,5,1,1,0,1
23549_0,,,,2,1,2,3
23551_0,,,,2,1,2,3
C(CC=C(C=O)C(C(O)=O)=C)=O,,,5,1,1,0,1
23552_0,,,,2,1,2,3
23554_0,,,,2,1,2,3
C(C(C=CC=O)C(C(O)=O)=C)=O,,,5,1,1,0,1
23555_0,,,,2,1,2,3
23556_0,,,,2,1,2,3
23557_0,,,,2,1,2,3
23559_0,,,,2,1,2,3
C(C(CO)(C(C)O)O)=CC=O,,,5,1,1,0,1
23560_0,,,,2,1,2,3
23562_0,,,,2,1,2,3
C(C(C(C(C)O)O)O)=CC=O,,,5,1,1,0,1
23563_0,,,,2,1,2,3
23565_0,,,,2,1,2,3
C(CC(C(CO)O)O)=CC=O,,,5,1,1,0,1
23566_0,,,,2,1,2,3
23568_0,,,,2,1,2,3
C(C(C)(C(CO)O)O)=CC=O,,,5,1,1,0,1
23569_0,,,,2,1,2,3
23571_0,,,,2,1,2,3
C(CC=C1C(C(OC1C)=O)=O)=O,,,5,1,1,0,1
23572_0,,,,2,1,2,3
23574_0,,,,2,1,2,3
C(C1C(C(OC1C)=O)=O)=CC=O,,,5,1,1,0,1
23575_0,,,,2,1,2,3
23577_0,,,,2,1,2,3
C(CC1CC(C(O1)=O)=O)=CC=O,,,5,1,1,0,1
23578_0,,,,2,1,2,3
23580_0,,,,2,1,2,3
C(C1(C)CC(C(O1)=O)=O)=CC=O,,,5,1,1,0,1
23581_0,,,,2,1,2,3
23583_0,,,,2,1,2,3
C(CC=C1C(OC(C1=O)=O)=O)=O,,,5,1,1,0,1
23584_0,,,,2,1,2,3
23586_0,,,,2,1,2,3
C1(C(C=CC=O)C(C(O1)=O)=O)=O,,,5,1,1,0,1
23587_0,,,,2,1,2,3
23589_0,,,,2,1,2,3
C(C(C(C=CC=O)O)O)(O)=O,,,5,1,1,0,1
23590_0,,,,2,1,2,3
23592_0,,,,2,1,2,3
C(C(C=CC=O)(CO)O)(O)=O,,,5,1,1,0,1
23593_0,,,,2,1,2,3
23595_0,,,,2,1,2,3
C(CC=CC=O)=O,,,5,1,1,0,1
23596_0,,,,2,1,2,3
23598_0,,,,2,1,2,3
C(CC=C(C=O)C(C)O)=O,,,5,1,1,0,1
23599_0,,,,2,1,2,3
23601_0,,,,2,1,2,3
C(C(C=CC=O)C(C)O)=O,,,5,1,1,0,1
23602_0,,,,2,1,2,3
23604_0,,,,2,1,2,3
C(CC(CC=CC=O)O)=O,,,5,1,1,0,1
23605_0,,,,2,1,2,3
23607_0,,,,2,1,2,3
C(CC(C=CC=O)(C)O)=O,,,5,1,1,0,1
23608_0,,,,2,1,2,3
23610_0,,,,2,1,2,3
C(CC=C(C=O)C(O)=O)=O,,,5,1,1,0,1
23611_0,,,,2,1,2,3
23613_0,,,,2,1,2,3
C(C(C(O)=O)C=CC=O)=O,,,5,1,1,0,1
23614_0,,,,2,1,2,3
23616_0,,,,2,1,2,3
C(C(C(C=O)=O)O)=CC=O,,,5,1,1,0,1
23617_0,,,,2,1,2,3
23618_0,,,,2,1,2,3
23619_0,,,,2,1,2,3
23621_0,,,,2,1,2,3
C(C(CO)O)=CC=O,,,5,1,1,0,1
23622_0,,,,2,1,2,3
23624_0,,,,2,1,2,3
C(CC=CC(C(O)=O)=O)=O,,,5,1,1,0,1
23625_0,,,,2,1,2,3
23627_0,,,,2,1,2,3
C(CC(C(O)=O)=O)=CC=O,,,5,1,1,0,1
23629_0,,,,2,1,2,3
C(C(C=C)C=CC(C(O)=O)=O)=O,,,5,1,1,0,1
23630_0,,,,2,1,2,3
23631_0,,,,2,1,2,3
23633_0,,,,2,1,2,3
C=CC(C=O)=CCC(C(O)=O)=O,,,5,1,1,0,1
23634_0,,,,2,1,2,3
23635_0,,,,2,1,2,3
23637_0,,,,2,1,2,3
C(C(C=C)C)=O,,,5,1,1,0,1
23639_0,,,,2,1,2,3
C(C(C=C)C(C(O)=O)=CC=O)=O,,,5,1,1,0,1
23640_0,,,,2,1,2,3
23642_0,,,,2,1,2,3
C(CC(C(O)=O)=C(C=O)C=C)=O,,,5,1,1,0,1
23643_0,,,,2,1,2,3
23645_0,,,,2,1,2,3
C(C(C=C)C(C=O)=CC(O)=O)=O,,,5,1,1,0,1
23646_0,,,,2,1,2,3
23647_0,,,,2,1,2,3
23648_0,,,,2,1,2,3
23649_0,,,,2,1,2,3
23650_0,,,,2,1,2,3
23652_0,,,,2,1,2,3
C(C(CO)O)=CC(C(O)=O)=O,,,5,1,1,0,1
23653_0,,,,2,1,2,3
23654_0,,,,2,1,2,3
23655_0,,,,2,1,2,3
23656_0,,,,2,1,2,3
23657_0,,,,2,1,2,3
23658_0,,,,2,1,2,3
23659_0,,,,2,1,2,3
23661_0,,,,2,1,2,3
C(CC(C(O)=O)=CC=O)=O,,,5,1,1,0,1
23662_0,,,,2,1,2,3
23663_0,,,,2,1,2,3
23665_0,,,,2,1,2,3
C(C(C(C(O)=O)=CC=O)O)(O)=O,,,5,1,1,0,1
23666_0,,,,2,1,2,3
23668_0,,,,2,1,2,3
C(C(C(CO)O)=CC=O)(O)=O,,,5,1,1,0,1
23670_0,,,,2,1,2,3
C(CC(C=O)=CC(O)=O)=O,,,5,1,1,0,1
23671_0,,,,2,1,2,3
23672_0,,,,2,1,2,3
23674_0,,,,2,1,2,3
C(C(C(C=O)=CC(O)=O)O)(O)=O,,,5,1,1,0,1
23675_0,,,,2,1,2,3
23677_0,,,,2,1,2,3
C(C=C(C=O)C(CO)O)(O)=O,,,5,1,1,0,1
23678_0,,,,2,1,2,3
23680_0,,,,2,1,1,2
C(CC)(OC(C(C=CC=O)=O)=O)=O,,,5,1,1,0,1
23681_0,,,,2,1,2,3
23683_0,,,,2,1,2,3
C(CC1C(C(OC(C=1)=O)=O)=O)=O,,,5,1,1,0,1
23685_0,,,,2,1,1,2
C(C=C(C(OC(C(C)=O)=O)=O)C)=O,,,5,1,1,0,1
23687_0,,,,2,1,2,3
C(C=C1C(OC(C(C1)=O)=O)=O)=O,,,5,1,1,0,1
23688_0,,,,2,1,2,3
23690_0,,,,2,1,2,3
C(CC1C(OC(C(C=1)=O)=O)=O)=O,,,5,1,1,0,1
23691_0,,,,2,1,2,3
23692_0,,,,2,1,2,3
23693_0,,,,2,1,2,3
