Id,Label,timeset,gen,type,weighted indegree,weighted outdegree,Weighted Degree
7_0,,,,2,2,1,3
C(C(C)(CC(C(O)=O)=O)O)(O)=O,,,1,1,9,11,20
9_0,,,,2,2,1,3
C(C(CO)O)(O)=O,,,1,1,59,91,150
12_0,,,,2,1,2,3
C(C)=O,,,1,1,588,1732,2320
C(=O)=O,,,1,1,869,897,1766
14_0,,,,2,4,3,7
[Fe+3],,,0,1,1478,1142,2620
C([C](C)O)(O)=O,,,1,1,5,20,25
16_0,,,,2,5,3,8
C(C(C)O)(O)=O,,,1,1,58,131,189
18_0,,,,2,2,1,3
C(CC(C)O)=O,,,2,1,122,342,464
20_0,,,,2,2,1,3
C(C(CC(C)O)=O)(O)=O,,,2,1,19,26,45
22_0,,,,2,2,1,3
C(CC(O)=O)=O,,,2,1,116,303,419
24_0,,,,2,2,1,3
C(C(C)(CC=O)O)(O)=O,,,2,1,21,25,46
26_0,,,,2,2,1,3
C(CC(C(O)=O)=O)(O)=O,,,2,1,18,23,41
28_0,,,,2,1,2,3
O,,,0,1,7172,4774,11946
C(C(O)=O)(CC(C(C)=O)=O)=O,,,2,1,12,13,25
30_0,,,,2,1,2,3
C(C(CO)=O)=O,,,2,1,188,404,592
32_0,,,,2,1,2,3
C(C(C)=O)=O,,,2,1,390,747,1137
33_0,,,,2,1,2,3
C(C(C)=O)(O)=O,,,0,1,107,212,319
35_0,,,,2,2,1,3
C(C(CO)(C(C)O)O)(O)=O,,,2,1,10,8,18
35_1,,,,2,2,1,3
37_0,,,,2,2,1,3
C(C(C(O)=O)(CO)O)(O)=O,,,2,1,8,4,12
37_1,,,,2,2,1,3
39_0,,,,2,2,1,3
C(C(CO)(C(C(O)=O)(C)O)O)(O)=O,,,2,1,12,11,23
39_1,,,,2,2,1,3
41_0,,,,2,2,1,3
C(C(C)(C(C)O)O)(O)=O,,,2,1,6,8,14
43_0,,,,2,2,1,3
C(C(C(O)=O)(C)O)(O)=O,,,2,1,4,3,7
45_0,,,,2,2,1,3
C(C(C)(C(C(O)=O)(C)O)O)(O)=O,,,2,1,4,4,8
48_0,,,,2,1,2,3
C=O,,,2,1,934,4511,5445
C(CO)(O)=O,,,2,1,117,239,356
49_0,,,,2,1,2,3
50_0,,,,2,1,2,3
52_0,,,,2,1,2,3
C(C(C)=CC(C(O)=O)=O)(O)=O,,,2,1,7,7,14
54_0,,,,2,1,2,3
C=C(C(O)=O)CC(C(O)=O)=O,,,2,1,9,10,19
56_0,,,,2,1,2,3
[C](C(O)=O)=C,,,2,1,121,443,564
58_0,,,,2,1,2,3
C=CC(O)=O,,,2,1,125,442,567
60_0,,,,2,2,1,3
C(C(C)(C(C(C(O)=O)O)O)O)(O)=O,,,2,1,13,12,25
62_0,,,,2,2,1,3
C(CO)O,,,2,1,11,60,71
64_0,,,,2,1,1,2
C1(C(C)(CC(C(O)=O)(O)O1)O)=O,,,2,1,4,6,10
65_0,,,,2,1,2,3
67_0,,,,2,1,2,3
C(C1(C)CC(C(O1)=O)=O)(O)=O,,,2,1,7,4,11
69_0,,,,2,1,2,3
C1(C(C)(CC(C(O1)=O)=O)O)=O,,,2,1,8,7,15
71_0,,,,2,4,3,7
C(C(C)(C[C](C(O)=O)O)O)(O)=O,,,2,1,6,7,13
73_0,,,,2,3,5,8
[H+],,,0,1,914,1157,2071
[Fe+2],,,0,1,1072,1408,2480
C(C(CO)=O)(O)=O,,,2,1,86,128,214
74_0,,,,2,3,5,8
76_0,,,,2,5,3,8
C(C(C)(CC(C(O)=O)O)O)(O)=O,,,2,1,11,9,20
78_0,,,,2,1,1,2
C(C1(CC(C(C1)=O)=O)O)(O)=O,,,3,1,8,8,16
80_0,,,,2,2,1,3
C(C(C(C)O)C(CC(C)O)O)=O,,,3,1,12,14,26
80_1,,,,2,2,1,3
82_0,,,,2,2,1,3
C(C(C=O)C(CC(C)O)O)(O)=O,,,3,1,10,13,23
82_1,,,,2,2,1,3
84_0,,,,2,2,1,3
C(C(C(C(CC(C)O)O)O)=O)=O,,,3,1,13,17,30
84_1,,,,2,2,1,3
86_0,,,,2,2,1,3
C(C(CC(CC(C)O)O)=O)=O,,,3,1,13,16,29
88_0,,,,2,2,1,3
C(C(C(C(CC(C)O)O)O)=O)(O)=O,,,3,1,11,14,25
88_1,,,,2,2,1,3
90_0,,,,2,2,1,3
C(CC(CC(C)O)O)=O,,,3,1,21,29,50
92_0,,,,2,2,1,3
C(C(CC(CC(C)O)O)=O)(O)=O,,,3,1,9,12,21
94_0,,,,2,2,1,3
C(C(C(CC(O)=O)O)C(C)O)=O,,,3,1,10,13,23
94_1,,,,2,2,1,3
96_0,,,,2,2,1,3
C(C(C(C)O)C(C(CO)=O)O)=O,,,3,1,14,16,30
96_1,,,,2,2,1,3
98_0,,,,2,2,1,3
C(C(C(C)O)C(C=O)(CO)O)=O,,,3,1,12,17,29
98_1,,,,2,2,1,3
100_0,,,,2,2,1,3
C(C(C(C)O)C(C=O)(C)O)=O,,,3,1,12,15,27
100_1,,,,2,2,1,3
102_0,,,,2,2,1,3
C(C(C(C)O)C(C(C)=O)O)=O,,,3,1,17,17,34
102_1,,,,2,2,1,3
104_0,,,,2,2,1,3
C(C(CO)C(C)O)=O,,,3,1,59,62,121
104_1,,,,2,2,1,3
106_0,,,,2,2,1,3
C(C(C(C)O)C(C(O)=O)(CO)O)=O,,,3,1,13,14,27
106_1,,,,2,2,1,3
108_0,,,,2,2,1,3
C(C(C(C)O)C(C)O)=O,,,3,1,18,19,37
108_1,,,,2,2,1,3
110_0,,,,2,2,1,3
C(C(C=O)C(C)O)(O)=O,,,3,1,20,21,41
110_1,,,,2,2,1,3
112_0,,,,2,2,1,3
C(C(C(C)O)C(C(O)=O)(C)O)=O,,,3,1,12,14,26
112_1,,,,2,2,1,3
114_0,,,,2,2,1,3
C(C(CC(C)O)(CC=O)O)(O)=O,,,3,1,10,12,22
116_0,,,,2,2,1,3
C(C(C(CO)C(C)O)=O)(O)=O,,,3,1,12,14,26
116_1,,,,2,2,1,3
118_0,,,,2,2,1,3
C(C(C(C(C)O)C(C)O)=O)(O)=O,,,3,1,7,9,16
118_1,,,,2,2,1,3
120_0,,,,2,2,1,3
C(C(C(C(O)=O)=O)C(C)O)(O)=O,,,3,1,9,12,21
120_1,,,,2,2,1,3
122_0,,,,2,2,1,3
C(C(C=O)C(CC(O)=O)O)(O)=O,,,3,1,8,11,19
122_1,,,,2,2,1,3
124_0,,,,2,2,1,3
C(CC(C(C(C=O)=O)O)O)(O)=O,,,3,1,12,17,29
124_1,,,,2,2,1,3
126_0,,,,2,2,1,3
C(CC(CC(C=O)=O)O)(O)=O,,,3,1,13,16,29
128_0,,,,2,2,1,3
C(CC(C(C(C(O)=O)=O)O)O)(O)=O,,,3,1,9,13,22
128_1,,,,2,2,1,3
130_0,,,,2,2,1,3
C(CC(CC=O)O)(O)=O,,,3,1,24,31,55
132_0,,,,2,2,1,3
C(CC(CC(C(O)=O)=O)O)(O)=O,,,3,1,7,10,17
134_0,,,,2,2,1,3
C(C(C=O)C(C(CO)=O)O)(O)=O,,,3,1,13,15,28
134_1,,,,2,2,1,3
136_0,,,,2,2,1,3
C(C(C=O)C(C=O)(CO)O)(O)=O,,,3,1,10,16,26
136_1,,,,2,2,1,3
138_0,,,,2,2,1,3
C(C(C=O)C(C=O)(C)O)(O)=O,,,3,1,10,13,23
138_1,,,,2,2,1,3
140_0,,,,2,2,1,3
C(C(C=O)C(C(C)=O)O)(O)=O,,,3,1,15,15,30
140_1,,,,2,2,1,3
142_0,,,,2,2,1,3
C(C(C=O)CO)(O)=O,,,3,1,51,52,103
142_1,,,,2,2,1,3
144_0,,,,2,2,1,3
C(C(C=O)C(C(O)=O)(CO)O)(O)=O,,,3,1,12,13,25
144_1,,,,2,2,1,3
145_0,,,,2,2,1,3
145_1,,,,2,2,1,3
147_0,,,,2,2,1,3
C(C(C(O)=O)C(O)=O)=O,,,3,1,16,14,30
147_1,,,,2,2,1,3
149_0,,,,2,2,1,3
C(C(C=O)C(C(O)=O)(C)O)(O)=O,,,3,1,11,12,23
149_1,,,,2,2,1,3
151_0,,,,2,2,1,3
C(C(C)(CC(CC=O)O)O)(O)=O,,,3,1,10,12,22
153_0,,,,2,2,1,3
C(C(CO)C(C(O)=O)(C)O)=O,,,3,1,14,14,28
153_1,,,,2,2,1,3
154_0,,,,2,2,1,3
154_1,,,,2,2,1,3
155_0,,,,2,2,1,3
155_1,,,,2,2,1,3
157_0,,,,2,2,1,3
C(CC(C(O)=O)(CC=O)O)(O)=O,,,3,1,8,10,18
159_0,,,,2,2,1,3
C(C(C(C(O)=O)=O)CO)(O)=O,,,3,1,11,12,23
159_1,,,,2,2,1,3
160_0,,,,2,2,1,3
160_1,,,,2,2,1,3
162_0,,,,2,2,1,3
C(C(C(O)=O)C(C(O)=O)=O)(O)=O,,,3,1,5,7,12
162_1,,,,2,2,1,3
164_0,,,,2,2,1,3
C(C(C(C(C(C)=O)=O)CO)=O)(O)=O,,,3,1,8,11,19
164_1,,,,2,2,1,3
166_0,,,,2,2,1,3
C(C(CC(C(CCO)=O)=O)=O)(O)=O,,,3,1,9,11,20
168_0,,,,2,2,1,3
C(CO)(C(C(C(C=O)=O)O)O)=O,,,3,1,18,22,40
168_1,,,,2,2,1,3
170_0,,,,2,2,1,3
C(CO)(C(CC(C=O)=O)O)=O,,,3,1,20,22,42
172_0,,,,2,2,1,3
C(CO)(C(C(C(C(O)=O)=O)O)O)=O,,,3,1,15,18,33
172_1,,,,2,2,1,3
174_0,,,,2,2,1,3
C(CC(C(CO)=O)O)=O,,,3,1,44,49,93
176_0,,,,2,2,1,3
C(CO)(C(CC(C(O)=O)=O)O)=O,,,3,1,11,14,25
178_0,,,,2,2,1,3
C(C(CO)(C(C(C=O)=O)O)O)=O,,,3,1,14,22,36
178_1,,,,2,2,1,3
180_0,,,,2,2,1,3
C(C(CO)(CC(C=O)=O)O)=O,,,3,1,12,18,30
182_0,,,,2,2,1,3
C(C(CO)(C(C(C(O)=O)=O)O)O)=O,,,3,1,13,19,32
182_1,,,,2,2,1,3
184_0,,,,2,2,1,3
C(C(CO)(CC=O)O)=O,,,3,1,24,31,55
186_0,,,,2,2,1,3
C(C(CO)(CC(C(O)=O)=O)O)=O,,,3,1,9,15,24
188_0,,,,2,2,1,3
C(C(C)(C(C(C=O)=O)O)O)=O,,,3,1,12,18,30
188_1,,,,2,2,1,3
190_0,,,,2,2,1,3
C(C)(C(C(C(C=O)=O)O)O)=O,,,3,1,21,23,44
190_1,,,,2,2,1,3
192_0,,,,2,2,1,3
C(C(C(CO)O)=O)=O,,,3,1,81,92,173
192_1,,,,2,2,1,3
194_0,,,,2,2,1,3
C(C(CO)(C(C(C=O)=O)O)O)(O)=O,,,3,1,17,18,35
194_1,,,,2,2,1,3
196_0,,,,2,2,1,3
C(C(C(C(C)O)O)=O)=O,,,3,1,31,34,65
196_1,,,,2,2,1,3
198_0,,,,2,2,1,3
C(C(C(C=O)=O)O)(O)=O,,,3,1,31,30,61
198_1,,,,2,2,1,3
200_0,,,,2,2,1,3
C(C(C)(C(C(C=O)=O)O)O)(O)=O,,,3,1,13,16,29
200_1,,,,2,2,1,3
202_0,,,,2,2,1,3
C(C(C)(CC(C=O)=O)O)=O,,,3,1,20,21,41
204_0,,,,2,2,1,3
C(C(C)(C(C(C(O)=O)=O)O)O)=O,,,3,1,9,14,23
204_1,,,,2,2,1,3
206_0,,,,2,2,1,3
C(C(C)(CC=O)O)=O,,,3,1,64,88,152
208_0,,,,2,2,1,3
C(C(C)(CC(C(O)=O)=O)O)=O,,,3,1,9,13,22
210_0,,,,2,2,1,3
C(C)(C(CC(C=O)=O)O)=O,,,3,1,31,28,59
212_0,,,,2,2,1,3
C(C)(C(C(C(C(O)=O)=O)O)O)=O,,,3,1,13,15,28
212_1,,,,2,2,1,3
214_0,,,,2,2,1,3
C(CC(C(C)=O)O)=O,,,3,1,107,128,235
216_0,,,,2,2,1,3
C(C)(C(CC(C(O)=O)=O)O)=O,,,3,1,14,15,29
218_0,,,,2,2,1,3
C(C(CCO)=O)=O,,,3,1,119,183,302
220_0,,,,2,2,1,3
C(C(CO)(CC(C=O)=O)O)(O)=O,,,3,1,14,16,30
222_0,,,,2,2,1,3
C(C(CC(C)O)=O)=O,,,3,1,71,94,165
224_0,,,,2,2,1,3
C(CC(C=O)=O)(O)=O,,,3,1,65,85,150
226_0,,,,2,2,1,3
C(C(C)(CC(C=O)=O)O)(O)=O,,,3,1,13,15,28
228_0,,,,2,2,1,3
C=C(C(O)=O)C(C(C(O)=O)=O)CO,,,3,1,4,9,13
230_0,,,,2,2,1,3
C(C1(C)C(C(C(O1)=O)=O)CO)(O)=O,,,3,1,6,6,12
230_1,,,,2,2,1,3
232_0,,,,2,2,1,3
C1(C(C)(C(C(C(O1)=O)=O)CO)O)=O,,,3,1,9,10,19
232_1,,,,2,2,1,3
234_0,,,,2,2,1,3
C(C(C(CO)O)=O)(O)=O,,,3,1,25,26,51
234_1,,,,2,2,1,3
236_0,,,,2,2,1,3
C(CCO)=O,,,3,1,224,722,946
238_0,,,,2,2,1,3
C(C(CCO)=O)(O)=O,,,3,1,51,69,120
240_0,,,,2,2,1,3
C(C(CO)(CC=O)O)(O)=O,,,3,1,17,17,34
242_0,,,,2,2,1,3
C(C(CO)(CC(C(O)=O)=O)O)(O)=O,,,3,1,10,13,23
244_0,,,,2,2,1,3
C(C(C(C(C)O)O)=O)(O)=O,,,3,1,16,17,33
244_1,,,,2,2,1,3
246_0,,,,2,2,1,3
C(C(C(C(O)=O)=O)O)(O)=O,,,3,1,17,15,32
246_1,,,,2,2,1,3
248_0,,,,2,2,1,3
C(C(C)(C(C(C(O)=O)=O)O)O)(O)=O,,,3,1,11,13,24
248_1,,,,2,2,1,3
249_0,,,,2,2,1,3
250_0,,,,2,2,1,3
250_1,,,,2,2,1,3
251_0,,,,2,2,1,3
251_1,,,,2,2,1,3
253_0,,,,2,1,2,3
C(CC(C(C)=O)=O)=O,,,3,1,91,131,222
255_0,,,,2,1,2,3
C(C(CO)=O)(C(C)O)=O,,,3,1,29,33,62
257_0,,,,2,1,2,3
C(C(C(CO)=O)=O)(O)=O,,,3,1,19,26,45
259_0,,,,2,1,2,3
C(C(C(C(C)=O)=O)(CO)O)(O)=O,,,3,1,11,11,22
261_0,,,,2,1,2,3
C(C(C(C(CO)=O)=O)(C)O)(O)=O,,,3,1,7,9,16
263_0,,,,2,1,2,3
C(C(C)=O)(C(C)O)=O,,,3,1,78,89,167
265_0,,,,2,1,2,3
C(C(C(C)=O)=O)(O)=O,,,3,1,46,63,109
267_0,,,,2,1,2,3
C(C(C(C(C)=O)=O)(C)O)(O)=O,,,3,1,8,8,16
269_0,,,,2,1,2,3
C(C=O)=O,,,3,1,266,482,748
270_0,,,,2,1,2,3
272_0,,,,2,1,2,3
C(C(C(C(C(C)=O)=O)O)O)(O)=O,,,3,1,14,14,28
273_0,,,,2,1,2,3
275_0,,,,2,1,2,3
[C](C(O)=O)(CC(C(C)=O)=O)O,,,3,1,12,11,23
276_0,,,,2,1,2,3
278_0,,,,2,1,2,3
C(C(CC(C(C)=O)=O)O)(O)=O,,,3,1,15,14,29
279_0,,,,2,1,2,3
280_0,,,,2,1,2,3
281_0,,,,2,1,2,3
281_1,,,,2,1,2,3
282_0,,,,2,1,2,3
283_0,,,,2,1,2,3
283_1,,,,2,1,2,3
284_0,,,,2,1,2,3
286_0,,,,2,1,1,2
C(C(C)=O)(OC(C(C)=O)=O)=O,,,3,1,4,3,7
288_0,,,,2,1,1,2
C(C(C=O)O)=O,,,3,1,123,302,425
290_0,,,,2,1,1,2
C(C(C=O)O)(O)=O,,,3,1,105,131,236
293_0,,,,2,3,2,5
C(O)=O,,,3,1,1682,0,1682
CC(CCO)O,,,3,1,16,79,95
295_0,,,,2,3,2,5
C(CCO)(O)=O,,,3,1,44,129,173
297_0,,,,2,3,2,5
C(C(C)(CCO)O)(O)=O,,,3,1,6,8,14
299_0,,,,2,3,2,5
C(CO)(CO)=O,,,3,1,109,299,408
301_0,,,,2,3,2,5
C(C)(CO)=O,,,3,1,292,911,1203
303_0,,,,2,3,2,5
CO,,,3,1,1040,220,1260
303_1,,,,2,3,2,5
305_0,,,,2,3,2,5
CCO,,,3,1,34,291,325
307_0,,,,2,3,2,5
C(CC(C)O)(O)=O,,,3,1,40,57,97
309_0,,,,2,3,2,5
C(CC(O)=O)(O)=O,,,3,1,32,44,76
311_0,,,,2,3,2,5
C(C(C)(CC(O)=O)O)(O)=O,,,3,1,8,7,15
312_0,,,,2,3,2,5
313_0,,,,2,3,2,5
315_0,,,,2,3,2,5
C(C)(O)=O,,,3,1,51,59,110
317_0,,,,2,2,1,3
C(C(CO)(C(CC(C)O)O)O)(O)=O,,,3,1,12,11,23
317_1,,,,2,2,1,3
319_0,,,,2,2,1,3
C(C(CO)(C(CC(O)=O)O)O)(O)=O,,,3,1,10,11,21
319_1,,,,2,2,1,3
321_0,,,,2,2,1,3
C(C(CO)(C(C(CO)=O)O)O)(O)=O,,,3,1,16,14,30
321_1,,,,2,2,1,3
323_0,,,,2,2,1,3
C(C(CO)(C(C=O)(CO)O)O)(O)=O,,,3,1,16,17,33
323_1,,,,2,2,1,3
325_0,,,,2,2,1,3
C(C(CO)(C(C=O)(C)O)O)(O)=O,,,3,1,12,13,25
325_1,,,,2,2,1,3
327_0,,,,2,2,1,3
C(C(CO)(C(C(C)=O)O)O)(O)=O,,,3,1,15,13,28
327_1,,,,2,2,1,3
329_0,,,,2,2,1,3
C(C(CO)(CO)O)(O)=O,,,3,1,6,5,11
329_1,,,,2,2,1,3
331_0,,,,2,2,1,3
C(C(C(CC(C)O)O)O)(O)=O,,,3,1,13,11,24
333_0,,,,2,2,1,3
C(C(C)(C(CC(C)O)O)O)(O)=O,,,3,1,8,8,16
335_0,,,,2,2,1,3
C(CC(C(C(O)=O)O)O)(O)=O,,,3,1,13,11,24
337_0,,,,2,2,1,3
C(C(C)(C(CC(O)=O)O)O)(O)=O,,,3,1,7,7,14
339_0,,,,2,2,1,3
C(C(C(C(CO)=O)O)O)(O)=O,,,3,1,21,17,38
341_0,,,,2,2,1,3
C(C(C)(C(C(CO)=O)O)O)(O)=O,,,3,1,11,10,21
343_0,,,,2,2,1,3
C(C(CO)(C(C(O)=O)O)O)=O,,,3,1,16,17,33
345_0,,,,2,2,1,3
C(C(C)(C(C=O)(CO)O)O)(O)=O,,,3,1,11,14,25
347_0,,,,2,2,1,3
C(C(C)(C(C(O)=O)O)O)=O,,,3,1,16,17,33
349_0,,,,2,2,1,3
C(C(C)(C(C=O)(C)O)O)(O)=O,,,3,1,7,9,16
351_0,,,,2,2,1,3
C(C(C(C(C)=O)O)O)(O)=O,,,3,1,29,26,55
353_0,,,,2,2,1,3
C(C(C)(C(C(C)=O)O)O)(O)=O,,,3,1,14,12,26
354_0,,,,2,2,1,3
356_0,,,,2,2,1,3
C(C(CO)(C)O)(O)=O,,,3,1,12,12,24
358_0,,,,2,2,1,3
C(C(CO)(C(C(O)=O)O)O)(O)=O,,,3,1,15,12,27
360_0,,,,2,2,1,3
C(C(C(C)O)O)(O)=O,,,3,1,42,54,96
362_0,,,,2,2,1,3
C(C(C(O)=O)O)(O)=O,,,3,1,32,42,74
364_0,,,,2,2,1,3
C(C(C)(C(C(O)=O)O)O)(O)=O,,,3,1,13,10,23
365_0,,,,2,2,1,3
366_0,,,,2,1,2,3
366_1,,,,2,1,2,3
367_0,,,,2,1,2,3
367_1,,,,2,1,2,3
368_0,,,,2,1,2,3
368_1,,,,2,1,2,3
369_0,,,,2,1,2,3
369_1,,,,2,1,2,3
370_0,,,,2,1,2,3
370_1,,,,2,1,2,3
371_0,,,,2,1,2,3
372_0,,,,2,1,2,3
373_0,,,,2,1,2,3
375_0,,,,2,1,2,3
C(C(C=O)(C)O)(O)=O,,,3,1,23,27,50
376_0,,,,2,1,2,3
378_0,,,,2,1,2,3
C(C(C(C)=O)CO)(O)=O,,,3,1,25,25,50
379_0,,,,2,1,2,3
380_0,,,,2,1,2,3
381_0,,,,2,1,2,3
383_0,,,,2,1,2,3
C(C)(C(C(O)=O)C)=O,,,3,1,64,70,134
385_0,,,,2,1,2,3
C(C(C(CC(O)=O)=O)(C)O)(O)=O,,,3,1,5,8,13
387_0,,,,2,1,2,3
C(C(C(C(C(O)=O)O)=O)C)(O)=O,,,3,1,7,9,16
388_0,,,,2,1,2,3
389_0,,,,2,1,2,3
391_0,,,,2,1,2,3
C(C)=CC=O,,,3,1,212,755,967
393_0,,,,2,1,2,3
C(CC=C)=O,,,3,1,154,511,665
395_0,,,,2,1,2,3
C(C)=CC(C(O)=O)=O,,,3,1,41,63,104
397_0,,,,2,1,2,3
C=CCC(C(O)=O)=O,,,3,1,37,49,86
399_0,,,,2,1,2,3
C(CC(C(O)=O)=C)=O,,,3,1,55,84,139
401_0,,,,2,1,2,3
C(C=C(C(O)=O)C)=O,,,3,1,58,97,155
403_0,,,,2,1,2,3
C(C(C=C)(CO)O)(O)=O,,,3,1,6,7,13
405_0,,,,2,1,2,3
C(C(C(C(O)=O)=C)(CO)O)(O)=O,,,3,1,7,8,15
407_0,,,,2,1,2,3
C=C(C(O)=O)C(C)O,,,3,1,29,46,75
409_0,,,,2,1,2,3
C(C(C=C)(C)O)(O)=O,,,3,1,8,9,17
411_0,,,,2,1,2,3
C=C(C(O)=O)C(O)=O,,,3,1,21,37,58
413_0,,,,2,1,2,3
C(C(C(C(O)=O)=C)(C)O)(O)=O,,,3,1,7,7,14
415_0,,,,2,1,2,3
C(C(C(C(C(O)=O)=C)O)O)(O)=O,,,3,1,8,9,17
417_0,,,,2,1,2,3
C1(C(C=C(C(O)=O)O1)(C)O)=O,,,3,1,2,2,4
419_0,,,,2,1,2,3
C(C1(C=C(C(O1)=O)C)O)(O)=O,,,3,1,3,4,7
421_0,,,,2,1,2,3
C(C1(CC(C(O1)=O)=C)O)(O)=O,,,3,1,4,6,10
423_0,,,,2,1,2,3
C1(C(C)=CC(C(O1)=O)=O)=O,,,3,1,13,14,27
425_0,,,,2,1,2,3
C=C1C(OC(C(C1)=O)=O)=O,,,3,1,16,15,31
427_0,,,,2,1,2,3
[C](C(O)=O)=CC(C(O)=O)(C)O,,,3,1,5,5,10
429_0,,,,2,1,2,3
C(C(C)=C[C](C(O)=O)O)(O)=O,,,3,1,4,3,7
431_0,,,,2,1,2,3
C=C(C(O)=O)C[C](C(O)=O)O,,,3,1,5,6,11
433_0,,,,2,1,2,3
C(C(C=CC(O)=O)(C)O)(O)=O,,,3,1,5,7,12
435_0,,,,2,1,2,3
C(C(C=C(C(O)=O)C)O)(O)=O,,,3,1,7,6,13
437_0,,,,2,1,2,3
C(C(CC(C(O)=O)=C)O)(O)=O,,,3,1,8,9,17
439_0,,,,2,2,1,3
CC(C(CO)O)O,,,3,1,18,29,47
441_0,,,,2,2,1,3
C(C(C(C(C)O)O)O)(O)=O,,,3,1,15,15,30
442_0,,,,2,2,1,3
444_0,,,,2,2,1,3
C(C(C)(C(CO)O)O)(O)=O,,,3,1,8,7,15
446_0,,,,2,2,1,3
C(C(C(C(O)=O)O)O)(O)=O,,,3,1,11,11,22
447_0,,,,2,2,1,3
449_0,,,,2,2,1,3
C(C(CO)O)(CC(C(O)=O)=O)=O,,,3,1,12,15,27
450_0,,,,2,2,1,3
452_0,,,,2,2,1,3
C(C(CO)O)=O,,,3,1,149,327,476
453_0,,,,2,2,1,3
455_0,,,,2,2,1,3
C(C1(C)C(C(C(O1)=O)O)O)(O)=O,,,3,1,7,5,12
457_0,,,,2,2,1,3
C1(C(C)(C(C(C(O1)=O)O)O)O)=O,,,3,1,8,8,16
458_0,,,,2,2,1,3
460_0,,,,2,2,1,3
C(C(C)C(C(C(O)=O)=O)O)(O)=O,,,3,1,4,7,11
461_0,,,,2,2,1,3
463_0,,,,2,2,1,3
C(C(CO)CC(C(O)=O)=O)(O)=O,,,3,1,7,10,17
464_0,,,,2,2,1,3
466_0,,,,2,2,1,3
C([CH]CO)(O)=O,,,3,1,8,39,47
467_0,,,,2,2,1,3
468_0,,,,2,2,1,3
470_0,,,,2,1,2,3
C=C,,,3,1,2,1,3
472_0,,,,2,1,1,2
C1(C(C)(CC(O)O1)O)=O,,,3,1,3,7,10
474_0,,,,2,1,1,2
C(C)(C1(CC(C(O1)=O)=O)O)=O,,,3,1,7,9,16
475_0,,,,2,1,1,2
477_0,,,,2,1,1,2
C1(C2(C)CC(C(O2)=O)(O)O1)=O,,,3,1,2,1,3
479_0,,,,2,1,1,2
C1(C(C)(O)OC(C(C1)=O)=O)=O,,,3,1,5,6,11
480_0,,,,2,1,1,2
481_0,,,,2,1,2,3
482_0,,,,2,1,2,3
483_0,,,,2,1,2,3
484_0,,,,2,1,2,3
485_0,,,,2,1,2,3
487_0,,,,2,1,2,3
C(CO)=O,,,3,1,405,1174,1579
489_0,,,,2,1,2,3
C1(C(OC(C)C1)=O)=O,,,3,1,50,74,124
491_0,,,,2,1,2,3
C1(CC(C(O1)=O)=O)=O,,,3,1,44,68,112
493_0,,,,2,1,2,3
C1(C(C)(C(C(O)=O)(CO1)O)O)=O,,,3,1,8,6,14
495_0,,,,2,1,2,3
C1(C(CO)(C(C(O1)=O)(C)O)O)=O,,,3,1,9,8,17
497_0,,,,2,1,2,3
C1(C(C)(C(C(O1)=O)(C)O)O)=O,,,3,1,3,2,5
498_0,,,,2,1,2,3
500_0,,,,2,1,2,3
C1(C(C)(C(C(C(O)=O)O1)O)O)=O,,,3,1,7,5,12
501_0,,,,2,1,2,3
502_0,,,,2,1,1,2
504_0,,,,2,1,2,3
C(C1(C)C[C](C(O1)=O)O)(O)=O,,,3,1,3,2,5
506_0,,,,2,1,2,3
C1(C(C)(C[C](C(O)=O)O1)O)=O,,,3,1,4,3,7
508_0,,,,2,1,2,3
C(C1(C)CC(C(O1)=O)O)(O)=O,,,3,1,5,3,8
510_0,,,,2,1,2,3
C1(C(C)(CC(C(O)=O)O1)O)=O,,,3,1,5,4,9
511_0,,,,2,1,2,3
512_0,,,,2,1,2,3
514_0,,,,2,1,2,3
C1(C(C)(C[C](C(O1)=O)O)O)=O,,,3,1,4,5,9
516_0,,,,2,1,2,3
C1(C(C)(CC(C(O1)=O)O)O)=O,,,3,1,6,6,12
518_0,,,,2,2,1,3
C(C(C(C)O)C[CH]C(O)=O)=O,,,3,1,9,11,20
520_0,,,,2,2,1,3
C(C(CCC(O)=O)C(C)O)=O,,,3,1,9,11,20
522_0,,,,2,2,1,3
C(CC(CC[CH]C(O)=O)O)=O,,,3,1,7,10,17
524_0,,,,2,2,1,3
C(CCCC(CC=O)O)(O)=O,,,3,1,7,10,17
526_0,,,,2,2,1,3
C(CC(C)(C[CH]C(O)=O)O)=O,,,3,1,9,12,21
528_0,,,,2,2,1,3
C(CCC(C)(CC=O)O)(O)=O,,,3,1,9,12,21
530_0,,,,2,2,1,3
C(C(C(O)=O)C[CH]C(O)=O)=O,,,3,1,7,10,17
532_0,,,,2,2,1,3
C(C(C(O)=O)CCC(O)=O)=O,,,3,1,7,10,17
534_0,,,,2,2,1,3
C([CH]CC(C(C=O)=O)O)(O)=O,,,3,1,9,13,22
536_0,,,,2,2,1,3
C(CCC(C(C=O)=O)O)(O)=O,,,3,1,9,13,22
538_0,,,,2,2,1,3
C(C(CC[CH]C(O)=O)=O)=O,,,3,1,16,19,35
540_0,,,,2,2,1,3
C(CCCC(C=O)=O)(O)=O,,,3,1,17,15,32
542_0,,,,2,2,1,3
C(C(C[CH]C(O)=O)O)(O)=O,,,3,1,9,9,18
544_0,,,,2,2,1,3
C(CCC(C(O)=O)O)(O)=O,,,3,1,11,9,20
546_0,,,,2,2,1,3
[CH](C(O)=O)CC(CO)O,,,3,1,5,10,15
548_0,,,,2,2,1,3
C(C(C(C[CH]C(O)=O)O)=O)(O)=O,,,3,1,6,9,15
550_0,,,,2,2,1,3
C(C(C(C[CH]C(O)=O)O)O)(O)=O,,,3,1,10,10,20
552_0,,,,2,2,1,3
C(C(CO)(C[CH]C(O)=O)O)(O)=O,,,3,1,7,8,15
554_0,,,,2,2,1,3
C(CC[CH]C(O)=O)=O,,,3,1,42,59,101
556_0,,,,2,2,1,3
C([C](CC[CH]C(O)=O)O)(O)=O,,,3,1,3,4,7
558_0,,,,2,2,1,3
C(C(CC[CH]C(O)=O)O)(O)=O,,,3,1,9,7,16
560_0,,,,2,2,1,3
C(C(C)(C[CH]C(O)=O)O)(O)=O,,,3,1,5,6,11
562_0,,,,2,2,1,3
C(C(CC[CH]C(O)=O)=O)(O)=O,,,3,1,7,9,16
564_0,,,,2,2,1,3
C(CCC(CO)O)(O)=O,,,3,1,6,10,16
566_0,,,,2,2,1,3
C(CCC(C(C(O)=O)=O)O)(O)=O,,,3,1,6,9,15
568_0,,,,2,2,1,3
C(CCC(C(C(O)=O)O)O)(O)=O,,,3,1,10,10,20
570_0,,,,2,2,1,3
C(C(CO)(CCC(O)=O)O)(O)=O,,,3,1,7,8,15
572_0,,,,2,2,1,3
C(CCCC(O)=O)=O,,,3,1,43,54,97
574_0,,,,2,2,1,3
C(CCC[C](C(O)=O)O)(O)=O,,,3,1,3,4,7
576_0,,,,2,2,1,3
C(CCCC(C(O)=O)O)(O)=O,,,3,1,9,7,16
578_0,,,,2,2,1,3
C(C(C)(CCC(O)=O)O)(O)=O,,,3,1,5,6,11
580_0,,,,2,2,1,3
C(CCCC(C(O)=O)=O)(O)=O,,,3,1,7,9,16
582_0,,,,2,4,3,7
[C](C(O)=O)(CC(C)O)O,,,3,1,4,7,11
584_0,,,,2,4,3,7
C(C[C](C(O)=O)O)(O)=O,,,3,1,7,9,16
585_0,,,,2,4,3,7
586_0,,,,2,4,3,7
587_0,,,,2,4,3,7
589_0,,,,2,4,3,7
C([C](CO)O)(O)=O,,,3,1,6,8,14
590_0,,,,2,5,3,8
592_0,,,,2,5,3,8
C(C(C)O)=O,,,3,1,245,531,776
594_0,,,,2,3,5,8
C(C(O)=O)=O,,,3,1,152,249,401
595_0,,,,2,3,5,8
596_0,,,,2,3,5,8
598_0,,,,2,5,3,8
C(C(CC(C)O)O)(O)=O,,,3,1,13,16,29
600_0,,,,2,5,3,8
C(CC(C(O)=O)O)(O)=O,,,3,1,17,18,35
601_0,,,,2,5,3,8
602_0,,,,2,5,3,8
603_0,,,,2,5,3,8
604_0,,,,2,5,3,8
606_0,,,,2,1,1,2
C1(C(C(C(C1O)O)C(C)O)O)=O,,,4,1,3,12,15
606_1,,,,2,1,1,2
608_0,,,,2,1,1,2
C1(C(C(C(C1)O)C(C)O)O)=O,,,4,1,1,13,14
610_0,,,,2,1,1,2
C(C1C(C(C(C1O)=O)O)O)(O)=O,,,4,1,5,14,19
610_1,,,,2,1,1,2
612_0,,,,2,1,1,2
C(C1C(CC(C1O)=O)O)(O)=O,,,4,1,2,14,16
614_0,,,,2,1,1,2
C(C1(CC(C(C1CO)=O)=O)O)(O)=O,,,4,1,5,16,21
615_0,,,,2,1,1,2
615_1,,,,2,1,1,2
617_0,,,,2,1,1,2
C1(C(C(C(C(C1O)O)=O)O)O)=O,,,4,1,2,4,6
617_1,,,,2,1,1,2
619_0,,,,2,1,1,2
C(C1(C(C(C(C1O)=O)O)O)O)=O,,,4,1,7,20,27
619_1,,,,2,1,1,2
621_0,,,,2,1,1,2
C(C1(CC(C(C1O)=O)O)O)=O,,,4,1,3,16,19
621_1,,,,2,1,1,2
623_0,,,,2,1,1,2
C1(C(C(C(CC1O)=O)O)O)=O,,,4,1,3,19,22
623_1,,,,2,1,1,2
625_0,,,,2,1,1,2
C(C1(C(C(C(C1O)=O)O)O)O)(O)=O,,,4,1,8,19,27
625_1,,,,2,1,1,2
627_0,,,,2,1,1,2
C1(C(C(CC1O)O)O)=O,,,4,1,3,33,36
627_1,,,,2,1,1,2
629_0,,,,2,1,1,2
C(C1(CC(C(C1O)=O)O)O)(O)=O,,,4,1,4,13,17
629_1,,,,2,1,1,2
630_0,,,,2,1,1,2
632_0,,,,2,1,1,2
C(C1(C(C(C(C1)=O)O)O)O)=O,,,4,1,2,19,21
634_0,,,,2,1,1,2
C(C1(CC(C(C1)=O)O)O)=O,,,4,1,2,21,23
636_0,,,,2,1,1,2
C1(CC(C(CC1O)=O)O)=O,,,4,1,1,14,15
638_0,,,,2,1,1,2
C(C1(C(C(C(C1)=O)O)O)O)(O)=O,,,4,1,4,15,19
640_0,,,,2,1,1,2
C1(C(CC(C1)O)O)=O,,,4,1,2,94,96
642_0,,,,2,1,1,2
C(C1(CC(C(C1)=O)O)O)(O)=O,,,4,1,3,14,17
644_0,,,,2,1,1,2
C1(C(CC(C1)O)=O)=O,,,4,1,1,71,72
645_0,,,,2,1,1,2
647_0,,,,2,1,1,2
C1(C2(CC(C(C2)=O)(O)O1)O)=O,,,4,1,3,6,9
648_0,,,,2,2,1,3
648_1,,,,2,2,1,3
650_0,,,,2,2,1,3
C(C(C(CO)C(CC(C)O)O)=O)=O,,,4,1,6,15,21
650_1,,,,2,2,1,3
652_0,,,,2,2,1,3
C(C(C(CC(CC(C)O)O)O)O)=O,,,4,1,2,14,16
652_1,,,,2,2,1,3
654_0,,,,2,2,1,3
C(CC(CC(CC(C)O)O)O)=O,,,4,1,1,11,12
656_0,,,,2,2,1,3
C(C(C(CC(C)O)O)C(C=O)O)=O,,,4,1,4,16,20
656_1,,,,2,2,1,3
658_0,,,,2,2,1,3
C(C(C(CO)O)C(CC(C)O)O)=O,,,4,1,5,14,19
658_1,,,,2,2,1,3
659_0,,,,2,2,1,3
659_1,,,,2,2,1,3
660_0,,,,2,2,1,3
660_1,,,,2,2,1,3
662_0,,,,2,2,1,3
C(C(CO)C(CC(C)O)O)=O,,,4,1,6,14,20
662_1,,,,2,2,1,3
664_0,,,,2,2,1,3
C(C(C(C)O)C(C(CCO)=O)O)=O,,,4,1,6,15,21
666_0,,,,2,2,1,3
C(C(CO)C(C(CO)C(C)O)O)=O,,,4,1,4,13,17
666_1,,,,2,2,1,3
668_0,,,,2,2,1,3
C(CO)(CC(C(CO)C(C)O)O)=O,,,4,1,2,9,11
670_0,,,,2,2,1,3
C(C)(C(C(C(CO)C(C)O)O)O)=O,,,4,1,2,11,13
670_1,,,,2,2,1,3
672_0,,,,2,2,1,3
C(C(C=C)C(C(CO)C(C)O)O)=O,,,4,1,1,9,10
674_0,,,,2,2,1,3
C(C(C(C(CO)C(C)O)O)O)=O,,,4,1,4,16,20
674_1,,,,2,2,1,3
676_0,,,,2,2,1,3
C(CC(C(CO)C(C)O)O)=O,,,4,1,3,13,16
678_0,,,,2,2,1,3
C(C(CC(C(CO)C(C)O)O)=O)=O,,,4,1,1,13,14
680_0,,,,2,2,1,3
C(C(C(C(C(C)O)C(C)O)O)O)=O,,,4,1,2,12,14
680_1,,,,2,2,1,3
682_0,,,,2,2,1,3
C(CC(C(C(C)O)C(C)O)O)=O,,,4,1,1,9,10
684_0,,,,2,2,1,3
C(C(C(C(C=O)O)O)C(C)O)(O)=O,,,4,1,6,16,22
684_1,,,,2,2,1,3
686_0,,,,2,2,1,3
C(C(C(CC=O)O)C(C)O)(O)=O,,,4,1,4,12,16
688_0,,,,2,2,1,3
C(CC(C(C(C=O)=O)CO)O)(O)=O,,,4,1,4,15,19
688_1,,,,2,2,1,3
690_0,,,,2,2,1,3
C(CC(CC(C(C=O)O)O)O)(O)=O,,,4,1,2,15,17
690_1,,,,2,2,1,3
692_0,,,,2,2,1,3
C(CC(CC(CC=O)O)O)(O)=O,,,4,1,1,11,12
694_0,,,,2,2,1,3
C(CC(C(C=O)C(C=O)O)O)(O)=O,,,4,1,4,16,20
694_1,,,,2,2,1,3
696_0,,,,2,2,1,3
C(C(C(CC(O)=O)O)C(CO)O)=O,,,4,1,5,14,19
696_1,,,,2,2,1,3
697_0,,,,2,2,1,3
697_1,,,,2,2,1,3
698_0,,,,2,2,1,3
698_1,,,,2,2,1,3
700_0,,,,2,2,1,3
C(C(CO)C(CC(O)=O)O)=O,,,4,1,5,14,19
700_1,,,,2,2,1,3
702_0,,,,2,2,1,3
C(C(C=O)C(C(CCO)=O)O)(O)=O,,,4,1,5,14,19
704_0,,,,2,2,1,3
C(C(CO)C(C(C=O)CO)O)(O)=O,,,4,1,5,14,19
704_1,,,,2,2,1,3
706_0,,,,2,2,1,3
C(C(CO)C(CC(CO)=O)O)(O)=O,,,4,1,3,10,13
708_0,,,,2,2,1,3
C(C(CO)C(C(C(C)=O)O)O)(O)=O,,,4,1,4,12,16
708_1,,,,2,2,1,3
710_0,,,,2,2,1,3
C(C(C=C)C(C(C(O)=O)CO)O)=O,,,4,1,2,9,11
712_0,,,,2,2,1,3
C(C(CO)C(C(C=O)O)O)(O)=O,,,4,1,7,17,24
712_1,,,,2,2,1,3
714_0,,,,2,2,1,3
C(C(CO)C(CC=O)O)(O)=O,,,4,1,6,14,20
716_0,,,,2,2,1,3
C(C(CO)C(CC(C=O)=O)O)(O)=O,,,4,1,3,14,17
718_0,,,,2,2,1,3
C(C(C(O)=O)C(C(C=O)O)O)(O)=O,,,4,1,6,13,19
718_1,,,,2,2,1,3
720_0,,,,2,2,1,3
C(C(C(O)=O)C(CC=O)O)(O)=O,,,4,1,4,9,13
722_0,,,,2,2,1,3
C(C(C(C(C=O)=O)CO)O)(CO)=O,,,4,1,5,19,24
722_1,,,,2,2,1,3
724_0,,,,2,2,1,3
C(C(CC(C=O)=O)O)(C(CO)O)=O,,,4,1,3,18,21
724_1,,,,2,2,1,3
726_0,,,,2,2,1,3
C(C(C(CC(C(CO)=O)O)O)O)=O,,,4,1,2,20,22
726_1,,,,2,2,1,3
728_0,,,,2,2,1,3
C(CC(CC(C(CO)=O)O)O)=O,,,4,1,1,16,17
730_0,,,,2,2,1,3
C(CC(C(CO)(C(C=O)O)O)O)=O,,,4,1,3,20,23
730_1,,,,2,2,1,3
732_0,,,,2,2,1,3
C(CC(C(CO)(CC=O)O)O)=O,,,4,1,2,20,22
734_0,,,,2,2,1,3
C(C(C(C=O)C(C(CO)=O)O)O)=O,,,4,1,4,20,24
734_1,,,,2,2,1,3
736_0,,,,2,2,1,3
C(C(C(CO)O)C(C(CO)=O)O)=O,,,4,1,5,17,22
736_1,,,,2,2,1,3
737_0,,,,2,2,1,3
737_1,,,,2,2,1,3
738_0,,,,2,2,1,3
738_1,,,,2,2,1,3
740_0,,,,2,2,1,3
C(C(CO)C(C(CO)=O)O)=O,,,4,1,8,19,27
740_1,,,,2,2,1,3
742_0,,,,2,2,1,3
C(C(C(C(C(CC=O)O)=O)O)O)=O,,,4,1,3,25,28
742_1,,,,2,2,1,3
744_0,,,,2,2,1,3
C(CC(C(C(C(CO)O)O)=O)O)=O,,,4,1,4,16,20
744_1,,,,2,2,1,3
746_0,,,,2,2,1,3
C(CC(C(C(C(C)O)O)=O)O)=O,,,4,1,3,16,19
746_1,,,,2,2,1,3
748_0,,,,2,2,1,3
C(C(C(C(CC=O)O)=O)O)(O)=O,,,4,1,3,15,18
748_1,,,,2,2,1,3
750_0,,,,2,2,1,3
C(CC(C(C(CO)O)=O)O)=O,,,4,1,5,20,25
750_1,,,,2,2,1,3
752_0,,,,2,2,1,3
C(C(CO)(C(C(C=O)=O)CO)O)=O,,,4,1,5,17,22
752_1,,,,2,2,1,3
754_0,,,,2,2,1,3
C(C(CO)(CC(C(C=O)O)O)O)=O,,,4,1,2,20,22
754_1,,,,2,2,1,3
756_0,,,,2,2,1,3
C(C(CO)(CC(CC=O)O)O)=O,,,4,1,1,17,18
758_0,,,,2,2,1,3
C(CC(CO)(C(C(C=O)O)O)O)=O,,,4,1,3,22,25
758_1,,,,2,2,1,3
759_0,,,,2,2,1,3
761_0,,,,2,2,1,3
C(C(C(C=O)C(C=O)(CO)O)O)=O,,,4,1,4,18,22
761_1,,,,2,2,1,3
763_0,,,,2,2,1,3
C(C(C(CO)O)C(C=O)(CO)O)=O,,,4,1,5,17,22
763_1,,,,2,2,1,3
764_0,,,,2,2,1,3
764_1,,,,2,2,1,3
765_0,,,,2,2,1,3
765_1,,,,2,2,1,3
767_0,,,,2,2,1,3
C(C(CO)C(C=O)(CO)O)=O,,,4,1,6,17,23
767_1,,,,2,2,1,3
769_0,,,,2,2,1,3
C(C(C(C(C=O)=O)O)O)(CCO)=O,,,4,1,5,19,24
771_0,,,,2,2,1,3
C(C(CO)C(C(C(CO)O)=O)O)=O,,,4,1,6,18,24
771_1,,,,2,2,1,3
773_0,,,,2,2,1,3
C(CC(C(C(CO)O)=O)O)(CO)=O,,,4,1,4,16,20
775_0,,,,2,2,1,3
C(C(C(C(C(CO)O)=O)O)O)(C)=O,,,4,1,6,18,24
775_1,,,,2,2,1,3
777_0,,,,2,2,1,3
C(C(C=C)C(C(C(CO)O)=O)O)=O,,,4,1,3,13,16
779_0,,,,2,2,1,3
C(C(C(C=O)O)O)(C(CO)O)=O,,,4,1,9,22,31
779_1,,,,2,2,1,3
780_0,,,,2,2,1,3
781_0,,,,2,2,1,3
783_0,,,,2,2,1,3
C(C(CO)C(C=O)(C(CO)O)O)=O,,,4,1,5,17,22
783_1,,,,2,2,1,3
785_0,,,,2,2,1,3
C(C(C(CO)O)(CC(CO)=O)O)=O,,,4,1,3,15,18
787_0,,,,2,2,1,3
C(C(C(CO)O)(C(C(C)=O)O)O)=O,,,4,1,7,18,25
787_1,,,,2,2,1,3
789_0,,,,2,2,1,3
C(C(C=C)C(C=O)(C(CO)O)O)=O,,,4,1,2,12,14
791_0,,,,2,2,1,3
C(C(C(CO)O)(C(C=O)O)O)=O,,,4,1,6,22,28
791_1,,,,2,2,1,3
793_0,,,,2,2,1,3
C(C(C(CO)O)(CC=O)O)=O,,,4,1,4,17,21
795_0,,,,2,2,1,3
C(C(C(CO)O)(CC(C=O)=O)O)=O,,,4,1,2,16,18
797_0,,,,2,2,1,3
C(C(C(C=O)O)O)(C(C(C)O)O)=O,,,4,1,6,21,27
797_1,,,,2,2,1,3
798_0,,,,2,2,1,3
800_0,,,,2,2,1,3
C(C(C(C(C)O)O)(C(C=O)O)O)=O,,,4,1,6,20,26
800_1,,,,2,2,1,3
802_0,,,,2,2,1,3
C(C(C(C(C)O)O)(CC=O)O)=O,,,4,1,2,16,18
804_0,,,,2,2,1,3
C(C(C(C(C(C=O)O)O)=O)O)(O)=O,,,4,1,8,21,29
804_1,,,,2,2,1,3
805_0,,,,2,2,1,3
807_0,,,,2,2,1,3
C(C(C(C=O)(C(C=O)O)O)O)(O)=O,,,4,1,6,21,27
807_1,,,,2,2,1,3
809_0,,,,2,2,1,3
C(C(C(C=O)(CC=O)O)O)(O)=O,,,4,1,4,16,20
811_0,,,,2,2,1,3
C(C(C)(CC(C=O)(CC=O)O)O)=O,,,4,1,1,13,14
813_0,,,,2,2,1,3
C(CC(C(CC(C=O)(C)O)=O)O)=O,,,4,1,2,15,17
815_0,,,,2,2,1,3
C(CC(C(C)(CC(C=O)=O)O)O)=O,,,4,1,2,19,21
817_0,,,,2,2,1,3
C(C(C)(C(C(C=O)=O)C(C)O)O)=O,,,4,1,4,14,18
817_1,,,,2,2,1,3
819_0,,,,2,2,1,3
C(C(C(C=O)=O)C(C=O)(C)O)(O)=O,,,4,1,4,12,16
819_1,,,,2,2,1,3
821_0,,,,2,2,1,3
C(C(C)(C(C(C=O)=O)CO)O)=O,,,4,1,4,18,22
821_1,,,,2,2,1,3
823_0,,,,2,2,1,3
C(C(CO)C(CC(C=O)(C)O)O)=O,,,4,1,4,15,19
823_1,,,,2,2,1,3
825_0,,,,2,2,1,3
C(C(C)(CC(CC(CO)=O)O)O)=O,,,4,1,2,13,15
827_0,,,,2,2,1,3
C(C(C)(CC(C(C(C)=O)O)O)O)=O,,,4,1,2,15,17
827_1,,,,2,2,1,3
829_0,,,,2,2,1,3
C(C(C=C)C(CC(C=O)(C)O)O)=O,,,4,1,1,10,11
831_0,,,,2,2,1,3
C(C(C)(CC(C(C=O)O)O)O)=O,,,4,1,2,20,22
831_1,,,,2,2,1,3
833_0,,,,2,2,1,3
C(C(C)(CC(CC=O)O)O)=O,,,4,1,3,16,19
835_0,,,,2,2,1,3
C(C(C)(CC(CC(C=O)=O)O)O)=O,,,4,1,1,14,15
837_0,,,,2,2,1,3
C(C(CO)C(C(C)(CC=O)O)O)=O,,,4,1,5,18,23
837_1,,,,2,2,1,3
839_0,,,,2,2,1,3
C(CC(C)(C(CC(CO)=O)O)O)=O,,,4,1,3,16,19
841_0,,,,2,2,1,3
C(CC(C)(C(C(C(C)=O)O)O)O)=O,,,4,1,3,18,21
841_1,,,,2,2,1,3
843_0,,,,2,2,1,3
C(C(C=C)C(C(C)(CC=O)O)O)=O,,,4,1,2,13,15
845_0,,,,2,2,1,3
C(CC(C)(C(C(C=O)O)O)O)=O,,,4,1,4,24,28
845_1,,,,2,2,1,3
847_0,,,,2,2,1,3
C(CC(C(C)(CC=O)O)O)=O,,,4,1,6,22,28
849_0,,,,2,2,1,3
C(CC(C)(C(CC(C=O)=O)O)O)=O,,,4,1,2,19,21
851_0,,,,2,2,1,3
C(C(C(CCO)O)C(C=O)(C)O)=O,,,4,1,4,14,18
851_1,,,,2,2,1,3
853_0,,,,2,2,1,3
C(C(C(C=O)C(C=O)(C)O)O)=O,,,4,1,4,19,23
853_1,,,,2,2,1,3
855_0,,,,2,2,1,3
C(C(C(CO)(C)O)C(C=O)(C)O)=O,,,4,1,5,14,19
855_1,,,,2,2,1,3
857_0,,,,2,2,1,3
C(C(C)(C(C=O)C(C=CC)O)O)=O,,,4,1,4,10,14
857_1,,,,2,2,1,3
859_0,,,,2,2,1,3
C(C(C(CC=C)O)C(C=O)(C)O)=O,,,4,1,4,11,15
859_1,,,,2,2,1,3
861_0,,,,2,2,1,3
C(C(C(CO)O)C(C=O)(C)O)=O,,,4,1,5,17,22
861_1,,,,2,2,1,3
863_0,,,,2,2,1,3
C(C(C(C(C)O)O)C(C=O)(C)O)=O,,,4,1,4,15,19
863_1,,,,2,2,1,3
865_0,,,,2,2,1,3
C(C(C(C=O)C(C=O)(C)O)O)(O)=O,,,4,1,6,15,21
865_1,,,,2,2,1,3
866_0,,,,2,2,1,3
866_1,,,,2,2,1,3
867_0,,,,2,2,1,3
867_1,,,,2,2,1,3
869_0,,,,2,2,1,3
C(C(C)(C(C=O)C(C=O)(C)O)O)=O,,,4,1,2,7,9
869_1,,,,2,2,1,3
871_0,,,,2,2,1,3
C(C(C(C=O)C(C=O)(C)O)O)(C)=O,,,4,1,4,14,18
871_1,,,,2,2,1,3
873_0,,,,2,2,1,3
C(C(CO)C(C=O)(C)O)=O,,,4,1,11,18,29
873_1,,,,2,2,1,3
875_0,,,,2,2,1,3
C(C(C)(C(C(C(O)=O)=O)CO)O)=O,,,4,1,5,15,20
875_1,,,,2,2,1,3
877_0,,,,2,2,1,3
C(C)(C(CC(C=O)(CC=O)O)O)=O,,,4,1,1,15,16
879_0,,,,2,2,1,3
C(CC(C(CC(C(C)=O)O)=O)O)=O,,,4,1,2,17,19
880_0,,,,2,2,1,3
882_0,,,,2,2,1,3
C(C(C(C(C=O)=O)C(C)O)O)(C)=O,,,4,1,4,15,19
882_1,,,,2,2,1,3
884_0,,,,2,2,1,3
C(C(C(C=O)=O)C(C(C)=O)O)(O)=O,,,4,1,4,13,17
884_1,,,,2,2,1,3
886_0,,,,2,2,1,3
C(C(C(C(C=O)=O)CO)O)(C)=O,,,4,1,5,19,24
886_1,,,,2,2,1,3
888_0,,,,2,2,1,3
C(C(CC(C=O)=O)O)(CC(C)O)=O,,,4,1,2,14,16
890_0,,,,2,2,1,3
C(CC(C(CC(C=O)=O)O)=O)(O)=O,,,4,1,2,14,16
892_0,,,,2,2,1,3
C(C(CC(C=O)=O)O)(CCO)=O,,,4,1,2,18,20
894_0,,,,2,2,1,3
C(C(CO)C(CC(C(C)=O)O)O)=O,,,4,1,4,16,20
894_1,,,,2,2,1,3
896_0,,,,2,2,1,3
C(C)(C(CC(CC(CO)=O)O)O)=O,,,4,1,2,14,16
898_0,,,,2,2,1,3
C(C)(C(C(CC(C(C)=O)O)O)O)=O,,,4,1,2,16,18
898_1,,,,2,2,1,3
900_0,,,,2,2,1,3
C(C(C=C)C(CC(C(C)=O)O)O)=O,,,4,1,1,11,12
902_0,,,,2,2,1,3
C(C(C(CC(C(C)=O)O)O)O)=O,,,4,1,2,21,23
902_1,,,,2,2,1,3
904_0,,,,2,2,1,3
C(CC(CC(C(C)=O)O)O)=O,,,4,1,3,19,22
906_0,,,,2,2,1,3
C(C)(C(CC(CC(C=O)=O)O)O)=O,,,4,1,1,17,18
908_0,,,,2,2,1,3
C(C(CO)C(C)(C(CC=O)O)O)=O,,,4,1,5,18,23
908_1,,,,2,2,1,3
910_0,,,,2,2,1,3
C(CC(C(C)(CC(CO)=O)O)O)=O,,,4,1,3,16,19
912_0,,,,2,2,1,3
C(CC(C(C)(C(C(C)=O)O)O)O)=O,,,4,1,3,17,20
912_1,,,,2,2,1,3
914_0,,,,2,2,1,3
C(C(C=C)C(C)(C(CC=O)O)O)=O,,,4,1,2,13,15
916_0,,,,2,2,1,3
C(CC(C(C)(C(C=O)O)O)O)=O,,,4,1,3,22,25
916_1,,,,2,2,1,3
917_0,,,,2,2,1,3
918_0,,,,2,2,1,3
920_0,,,,2,2,1,3
C(C(C(CCO)O)C(C(C)=O)O)=O,,,4,1,4,14,18
920_1,,,,2,2,1,3
922_0,,,,2,2,1,3
C(C(C(C=O)C(C(C)=O)O)O)=O,,,4,1,4,20,24
922_1,,,,2,2,1,3
924_0,,,,2,2,1,3
C(C(C(CO)(C)O)C(C(C)=O)O)=O,,,4,1,5,14,19
924_1,,,,2,2,1,3
926_0,,,,2,2,1,3
C(C(C(C(C)=O)O)C(C=CC)O)=O,,,4,1,4,10,14
926_1,,,,2,2,1,3
928_0,,,,2,2,1,3
C(C(C(CC=C)O)C(C(C)=O)O)=O,,,4,1,4,11,15
928_1,,,,2,2,1,3
930_0,,,,2,2,1,3
C(C(C(CO)O)C(C(C)=O)O)=O,,,4,1,5,17,22
930_1,,,,2,2,1,3
932_0,,,,2,2,1,3
C(C(C(C(C)O)O)C(C(C)=O)O)=O,,,4,1,4,15,19
932_1,,,,2,2,1,3
934_0,,,,2,2,1,3
C(C(C(C=O)C(C(C)=O)O)O)(O)=O,,,4,1,6,15,21
934_1,,,,2,2,1,3
935_0,,,,2,2,1,3
935_1,,,,2,2,1,3
936_0,,,,2,2,1,3
936_1,,,,2,2,1,3
937_0,,,,2,2,1,3
937_1,,,,2,2,1,3
939_0,,,,2,2,1,3
C(C(C(C(C)=O)O)C(C(C)=O)O)=O,,,4,1,2,8,10
939_1,,,,2,2,1,3
941_0,,,,2,2,1,3
C(C(CO)C(C(C)=O)O)=O,,,4,1,18,24,42
941_1,,,,2,2,1,3
943_0,,,,2,2,1,3
C(CC(C(CC(CCO)O)=O)O)=O,,,4,1,2,12,14
945_0,,,,2,2,1,3
C(CC(C(CC(C=O)O)=O)O)=O,,,4,1,2,22,24
947_0,,,,2,2,1,3
C(CC(C(CC(CO)(C)O)=O)O)=O,,,4,1,3,12,15
949_0,,,,2,2,1,3
C(CC(C(CC(C=CC)O)=O)O)=O,,,4,1,2,9,11
951_0,,,,2,2,1,3
C(CC(C(CC(CC=C)O)=O)O)=O,,,4,1,2,10,12
953_0,,,,2,2,1,3
C(CC(C(CC(CO)O)=O)O)=O,,,4,1,3,15,18
955_0,,,,2,2,1,3
C(CC(C(CC(C(C)O)O)=O)O)=O,,,4,1,2,13,15
957_0,,,,2,2,1,3
C(C(CC(C(CC=O)O)=O)O)(O)=O,,,4,1,5,14,19
959_0,,,,2,2,1,3
C(CC(C(CC(C)O)=O)O)=O,,,4,1,4,18,22
961_0,,,,2,2,1,3
C(CC(C(CC=O)O)=O)(O)=O,,,4,1,4,18,22
962_0,,,,2,2,1,3
963_0,,,,2,2,1,3
965_0,,,,2,2,1,3
C(CC(C(CCO)=O)O)=O,,,4,1,9,29,38
967_0,,,,2,2,1,3
C(C(C(C(C(O)=O)=O)CO)O)(C)=O,,,4,1,5,15,20
967_1,,,,2,2,1,3
969_0,,,,2,2,1,3
C(C(CC(C(O)=O)=O)O)(CCO)=O,,,4,1,3,13,16
971_0,,,,2,2,1,3
C(C(CO)C(C=O)(CCO)O)=O,,,4,1,4,16,20
971_1,,,,2,2,1,3
973_0,,,,2,2,1,3
C(C(CCO)(C(C(CO)=O)O)O)=O,,,4,1,4,15,19
973_1,,,,2,2,1,3
975_0,,,,2,2,1,3
C(C(CCO)(CC(CO)=O)O)=O,,,4,1,2,13,15
977_0,,,,2,2,1,3
C(C(CCO)(C(C(C)=O)O)O)=O,,,4,1,3,14,17
977_1,,,,2,2,1,3
979_0,,,,2,2,1,3
C(C(C=C)C(C=O)(CCO)O)=O,,,4,1,2,13,15
981_0,,,,2,2,1,3
C(C(CCO)(C(C=O)O)O)=O,,,4,1,6,18,24
981_1,,,,2,2,1,3
983_0,,,,2,2,1,3
C(C(CCO)(CC=O)O)=O,,,4,1,8,19,27
985_0,,,,2,2,1,3
C(C(C(C)O)C(C=O)(CCO)O)=O,,,4,1,5,14,19
985_1,,,,2,2,1,3
987_0,,,,2,2,1,3
C(C(C=O)C(C=O)(CCO)O)(O)=O,,,4,1,4,13,17
987_1,,,,2,2,1,3
989_0,,,,2,2,1,3
C(C(CCO)(C(C(C=O)=O)O)O)=O,,,4,1,3,16,19
989_1,,,,2,2,1,3
991_0,,,,2,2,1,3
C(C(CCO)(CC(C=O)=O)O)=O,,,4,1,1,16,17
993_0,,,,2,2,1,3
C(C(CCO)(CC(C(O)=O)=O)O)=O,,,4,1,2,13,15
995_0,,,,2,2,1,3
C(C(CO)C(C(CCO)=O)O)=O,,,4,1,5,17,22
995_1,,,,2,2,1,3
997_0,,,,2,2,1,3
C(C(C(C(CCO)=O)O)O)(CO)=O,,,4,1,6,17,23
997_1,,,,2,2,1,3
999_0,,,,2,2,1,3
C(CC(C(CCO)=O)O)(CO)=O,,,4,1,3,14,17
1001_0,,,,2,2,1,3
C(C(C(C(CCO)=O)O)O)(C)=O,,,4,1,5,16,21
1001_1,,,,2,2,1,3
1003_0,,,,2,2,1,3
C(C(C=C)C(C(CCO)=O)O)=O,,,4,1,3,14,17
1005_0,,,,2,2,1,3
C(C(C(C=O)O)O)(CCO)=O,,,4,1,9,25,34
1005_1,,,,2,2,1,3
1006_0,,,,2,2,1,3
1007_0,,,,2,2,1,3
1007_1,,,,2,2,1,3
1008_0,,,,2,2,1,3
1008_1,,,,2,2,1,3
1009_0,,,,2,2,1,3
1009_1,,,,2,2,1,3
1010_0,,,,2,2,1,3
1011_0,,,,2,2,1,3
1013_0,,,,2,2,1,3
C(C(C(CO)C(CCO)O)=O)=O,,,4,1,4,18,22
1013_1,,,,2,2,1,3
1015_0,,,,2,2,1,3
C(C(C(C(C=O)=O)CO)O)=O,,,4,1,6,22,28
1015_1,,,,2,2,1,3
1017_0,,,,2,2,1,3
C(C(C(C(C(C=O)=O)CO)O)O)=O,,,4,1,5,23,28
1017_1,,,,2,2,1,3
1019_0,,,,2,2,1,3
C(C(C(CO)C(CO)(CO)O)=O)=O,,,4,1,5,13,18
1019_1,,,,2,2,1,3
1021_0,,,,2,2,1,3
C(C(C(CO)C(C)(CO)O)=O)=O,,,4,1,5,18,23
1021_1,,,,2,2,1,3
1023_0,,,,2,2,1,3
C(C)=CC(C(C(C=O)=O)CO)O,,,4,1,5,16,21
1023_1,,,,2,2,1,3
1025_0,,,,2,2,1,3
C=CCC(C(C(C=O)=O)CO)O,,,4,1,5,17,22
1025_1,,,,2,2,1,3
1027_0,,,,2,2,1,3
C(C(C(CO)C(C(CO)O)O)=O)=O,,,4,1,6,18,24
1027_1,,,,2,2,1,3
1029_0,,,,2,2,1,3
C(C(C(CO)C(CO)O)=O)=O,,,4,1,5,19,24
1029_1,,,,2,2,1,3
1031_0,,,,2,2,1,3
C(C(C(CO)C(C(C)O)O)=O)=O,,,4,1,4,19,23
1031_1,,,,2,2,1,3
1033_0,,,,2,2,1,3
C(C(C(C(C=O)=O)CO)O)(O)=O,,,4,1,6,19,25
1033_1,,,,2,2,1,3
1035_0,,,,2,2,1,3
C(C(C(CO)C(C)O)=O)=O,,,4,1,5,20,25
1035_1,,,,2,2,1,3
1037_0,,,,2,2,1,3
C(C(C(C=O)=O)CO)(O)=O,,,4,1,8,18,26
1037_1,,,,2,2,1,3
1038_0,,,,2,2,1,3
1038_1,,,,2,2,1,3
1039_0,,,,2,2,1,3
1039_1,,,,2,2,1,3
1040_0,,,,2,2,1,3
1040_1,,,,2,2,1,3
1041_0,,,,2,2,1,3
1041_1,,,,2,2,1,3
1042_0,,,,2,2,1,3
1042_1,,,,2,2,1,3
1043_0,,,,2,2,1,3
1043_1,,,,2,2,1,3
1045_0,,,,2,2,1,3
C(C(C(CO)CO)=O)=O,,,4,1,3,24,27
1045_1,,,,2,2,1,3
1047_0,,,,2,2,1,3
C(C(C)(C(C(C=O)=O)CO)O)(O)=O,,,4,1,5,15,20
1047_1,,,,2,2,1,3
1049_0,,,,2,2,1,3
C(C(CO)C(C=O)(CC(C)O)O)=O,,,4,1,4,14,18
1049_1,,,,2,2,1,3
1051_0,,,,2,2,1,3
C(C(CC(C)O)(CC(CO)=O)O)=O,,,4,1,2,12,14
1053_0,,,,2,2,1,3
C(C(CC(C)O)(C(C(C)=O)O)O)=O,,,4,1,3,13,16
1053_1,,,,2,2,1,3
1055_0,,,,2,2,1,3
C(C(C=C)C(C=O)(CC(C)O)O)=O,,,4,1,1,9,10
1057_0,,,,2,2,1,3
C(C(CC(C)O)(C(C=O)O)O)=O,,,4,1,3,17,20
1057_1,,,,2,2,1,3
1059_0,,,,2,2,1,3
C(C(CC(C)O)(CC=O)O)=O,,,4,1,3,14,17
1061_0,,,,2,2,1,3
C(C(CC(C)O)(CC(C=O)=O)O)=O,,,4,1,1,12,13
1063_0,,,,2,2,1,3
C(C(CO)C(C(CC(C)O)=O)O)=O,,,4,1,5,15,20
1063_1,,,,2,2,1,3
1065_0,,,,2,2,1,3
C(CC(C(CC(C)O)=O)O)(CO)=O,,,4,1,3,13,16
1067_0,,,,2,2,1,3
C(C(C(C(CC(C)O)=O)O)O)(C)=O,,,4,1,5,15,20
1067_1,,,,2,2,1,3
1069_0,,,,2,2,1,3
C(C(C=C)C(C(CC(C)O)=O)O)=O,,,4,1,2,10,12
1071_0,,,,2,2,1,3
C(C(C(C=O)O)O)(CC(C)O)=O,,,4,1,8,20,28
1071_1,,,,2,2,1,3
1072_0,,,,2,2,1,3
1073_0,,,,2,2,1,3
1075_0,,,,2,2,1,3
C(C(C(C(C)O)C(CCO)O)=O)=O,,,4,1,4,15,19
1075_1,,,,2,2,1,3
1077_0,,,,2,2,1,3
C(C(C(C(C=O)=O)C(C)O)O)=O,,,4,1,4,21,25
1077_1,,,,2,2,1,3
1079_0,,,,2,2,1,3
C(C(C(C(C)O)C(C)(CO)O)=O)=O,,,4,1,5,15,20
1079_1,,,,2,2,1,3
1081_0,,,,2,2,1,3
C(C)=CC(C(C(C=O)=O)C(C)O)O,,,4,1,4,11,15
1081_1,,,,2,2,1,3
1083_0,,,,2,2,1,3
C=CCC(C(C(C=O)=O)C(C)O)O,,,4,1,4,12,16
1083_1,,,,2,2,1,3
1085_0,,,,2,2,1,3
C(C(C(C(CO)O)C(C)O)=O)=O,,,4,1,5,19,24
1085_1,,,,2,2,1,3
1087_0,,,,2,2,1,3
C(C(C(C(C)O)C(C(C)O)O)=O)=O,,,4,1,4,16,20
1087_1,,,,2,2,1,3
1089_0,,,,2,2,1,3
C(C(C(C(C=O)=O)C(C)O)O)(O)=O,,,4,1,6,16,22
1089_1,,,,2,2,1,3
1091_0,,,,2,2,1,3
C(C(C(C(C)O)C(C)O)=O)=O,,,4,1,3,12,15
1091_1,,,,2,2,1,3
1093_0,,,,2,2,1,3
C(C(C(C=O)=O)C(C)O)(O)=O,,,4,1,7,15,22
1093_1,,,,2,2,1,3
1094_0,,,,2,2,1,3
1094_1,,,,2,2,1,3
1095_0,,,,2,2,1,3
1095_1,,,,2,2,1,3
1096_0,,,,2,2,1,3
1096_1,,,,2,2,1,3
1098_0,,,,2,2,1,3
C(CC(C=O)(C(C=O)CO)O)(O)=O,,,4,1,4,13,17
1098_1,,,,2,2,1,3
1100_0,,,,2,2,1,3
C(CC(C=O)(CC(CO)=O)O)(O)=O,,,4,1,2,11,13
1102_0,,,,2,2,1,3
C(CC(C=O)(C(C(C)=O)O)O)(O)=O,,,4,1,3,12,15
1102_1,,,,2,2,1,3
1104_0,,,,2,2,1,3
C(C(C=C)C(C=O)(CC(O)=O)O)=O,,,4,1,1,7,8
1106_0,,,,2,2,1,3
C(CC(C=O)(C(C=O)O)O)(O)=O,,,4,1,3,16,19
1106_1,,,,2,2,1,3
1108_0,,,,2,2,1,3
C(CC(C=O)(CC=O)O)(O)=O,,,4,1,3,13,16
1110_0,,,,2,2,1,3
C(CC(C=O)(CC(C=O)=O)O)(O)=O,,,4,1,1,11,12
1112_0,,,,2,2,1,3
C(C(CO)C(C(CC(O)=O)=O)O)=O,,,4,1,5,16,21
1112_1,,,,2,2,1,3
1114_0,,,,2,2,1,3
C(CC(C(CC(CO)=O)O)=O)(O)=O,,,4,1,3,13,16
1116_0,,,,2,2,1,3
C(CC(C(C(C(C)=O)O)O)=O)(O)=O,,,4,1,5,16,21
1116_1,,,,2,2,1,3
1118_0,,,,2,2,1,3
C(C(C=C)C(C(CC(O)=O)=O)O)=O,,,4,1,2,10,12
1120_0,,,,2,2,1,3
C(CC(C(C(C=O)O)O)=O)(O)=O,,,4,1,8,21,29
1120_1,,,,2,2,1,3
1121_0,,,,2,2,1,3
1122_0,,,,2,2,1,3
1124_0,,,,2,2,1,3
C(C(C(C=O)=O)C(CCO)O)(O)=O,,,4,1,4,14,18
1124_1,,,,2,2,1,3
1126_0,,,,2,2,1,3
C(C(C(C=O)=O)C(C=O)O)(O)=O,,,4,1,5,19,24
1126_1,,,,2,2,1,3
1128_0,,,,2,2,1,3
C(C(C(C=O)=O)C(C)(CO)O)(O)=O,,,4,1,5,14,19
1128_1,,,,2,2,1,3
1130_0,,,,2,2,1,3
C(C(C(C=O)=O)C(C=CC)O)(O)=O,,,4,1,4,9,13
1130_1,,,,2,2,1,3
1132_0,,,,2,2,1,3
C(C(C(C=O)=O)C(CC=C)O)(O)=O,,,4,1,4,10,14
1132_1,,,,2,2,1,3
1134_0,,,,2,2,1,3
C(C(C(C=O)=O)C(CO)O)(O)=O,,,4,1,7,18,25
1134_1,,,,2,2,1,3
1136_0,,,,2,2,1,3
C(C(C(C=O)=O)C(C(C)O)O)(O)=O,,,4,1,4,15,19
1136_1,,,,2,2,1,3
1138_0,,,,2,2,1,3
C(C(C(C=O)=O)C(C(O)=O)O)(O)=O,,,4,1,7,14,21
1138_1,,,,2,2,1,3
1139_0,,,,2,2,1,3
1139_1,,,,2,2,1,3
1141_0,,,,2,2,1,3
C(C(C(O)=O)C(C=O)=O)(O)=O,,,4,1,5,10,15
1141_1,,,,2,2,1,3
1142_0,,,,2,2,1,3
1142_1,,,,2,2,1,3
1143_0,,,,2,2,1,3
1143_1,,,,2,2,1,3
1144_0,,,,2,2,1,3
1144_1,,,,2,2,1,3
1145_0,,,,2,2,1,3
1145_1,,,,2,2,1,3
1147_0,,,,2,2,1,3
C(C(C(CO)O)(C(C=O)O)O)(O)=O,,,4,1,10,18,28
1147_1,,,,2,2,1,3
1149_0,,,,2,2,1,3
C(C(C(CO)O)(CC=O)O)(O)=O,,,4,1,4,14,18
1151_0,,,,2,2,1,3
C(C(CO)C(CCO)O)=O,,,4,1,8,16,24
1151_1,,,,2,2,1,3
1153_0,,,,2,2,1,3
C(C(C(CO)C(CCO)O)=O)(O)=O,,,4,1,5,15,20
1153_1,,,,2,2,1,3
1155_0,,,,2,2,1,3
C(C(C(C(C)=O)=O)C(CCO)O)=O,,,4,1,2,11,13
1155_1,,,,2,2,1,3
1157_0,,,,2,2,1,3
C(CC(C(CC(CCO)O)=O)=O)=O,,,4,1,1,11,12
1159_0,,,,2,2,1,3
C(C(C(C)O)=O)(CC(CCO)O)=O,,,4,1,1,10,11
1161_0,,,,2,2,1,3
C(C(C(CC(CCO)O)=O)=O)(O)=O,,,4,1,1,11,12
1163_0,,,,2,2,1,3
C(CO)(C(C(CCO)O)O)=O,,,4,1,3,13,16
1163_1,,,,2,2,1,3
1165_0,,,,2,2,1,3
C(CO)(CC(CCO)O)=O,,,4,1,2,20,22
1167_0,,,,2,2,1,3
C(C)(C(C(CCO)O)O)=O,,,4,1,2,19,21
1167_1,,,,2,2,1,3
1169_0,,,,2,2,1,3
C(C(C(CC(CCO)O)=O)C)(O)=O,,,4,1,1,8,9
1171_0,,,,2,2,1,3
C(C(C=C)C(CCO)O)=O,,,4,1,3,14,17
1173_0,,,,2,2,1,3
C=CC(C(C(O)=O)=O)C(CCO)O,,,4,1,1,10,11
1175_0,,,,2,2,1,3
C(C(C(C(O)=O)=C)C(CCO)O)=O,,,4,1,1,11,12
1177_0,,,,2,2,1,3
C(C(C(CCO)O)O)=O,,,4,1,9,32,41
1177_1,,,,2,2,1,3
1179_0,,,,2,2,1,3
C1(C(C(C(C)O1)C(CCO)O)=O)=O,,,4,1,2,8,10
1179_1,,,,2,2,1,3
1181_0,,,,2,2,1,3
C1(C(C(C(O1)=O)=O)C(CCO)O)=O,,,4,1,2,9,11
1181_1,,,,2,2,1,3
1183_0,,,,2,2,1,3
C(C(C(CCO)O)C[CH]C(O)=O)=O,,,4,1,2,10,12
1185_0,,,,2,2,1,3
C(C(CCC(O)=O)C(CCO)O)=O,,,4,1,2,10,12
1187_0,,,,2,2,1,3
C(CC(CCO)O)=O,,,4,1,14,78,92
1189_0,,,,2,2,1,3
C(C(C(C)O)C(CCO)O)=O,,,4,1,7,14,21
1189_1,,,,2,2,1,3
1191_0,,,,2,2,1,3
C(C(C=O)C(CCO)O)(O)=O,,,4,1,7,13,20
1191_1,,,,2,2,1,3
1193_0,,,,2,2,1,3
C(C(C(C(CCO)O)O)=O)=O,,,4,1,5,18,23
1193_1,,,,2,2,1,3
1195_0,,,,2,2,1,3
C(C(CC(CCO)O)=O)=O,,,4,1,11,21,32
1197_0,,,,2,2,1,3
C(C(C(C(CCO)O)O)=O)(O)=O,,,4,1,3,13,16
1197_1,,,,2,2,1,3
1199_0,,,,2,2,1,3
C(C(CC(CCO)O)=O)(O)=O,,,4,1,4,13,17
1201_0,,,,2,2,1,3
C(C(CO)C(C(O)=O)(CCO)O)=O,,,4,1,5,14,19
1201_1,,,,2,2,1,3
1203_0,,,,2,2,1,3
C(CC(C(C)=O)(C(C=O)CO)O)=O,,,4,1,5,14,19
1203_1,,,,2,2,1,3
1205_0,,,,2,2,1,3
C(C(CO)C(C(CC=O)=O)(C)O)=O,,,4,1,4,15,19
1205_1,,,,2,2,1,3
1207_0,,,,2,2,1,3
C(C(CO)C(CC(C(C)=O)=O)O)=O,,,4,1,4,14,18
1207_1,,,,2,2,1,3
1209_0,,,,2,2,1,3
C(C(CO)C(C(C)=O)(C(C)O)O)=O,,,4,1,5,14,19
1209_1,,,,2,2,1,3
1211_0,,,,2,2,1,3
C(C(CO)C(C(C(C)O)=O)(C)O)=O,,,4,1,4,13,17
1211_1,,,,2,2,1,3
1213_0,,,,2,2,1,3
C(C(CO)C(C(O)=O)(C(C)=O)O)=O,,,4,1,5,13,18
1213_1,,,,2,2,1,3
1215_0,,,,2,2,1,3
C(C(CO)C(C(C(O)=O)=O)(C)O)=O,,,4,1,4,14,18
1215_1,,,,2,2,1,3
1217_0,,,,2,2,1,3
C(C(CO)C(C=O)O)=O,,,4,1,14,36,50
1217_1,,,,2,2,1,3
1219_0,,,,2,2,1,3
C(C(CO)C(C(C=O)O)O)=O,,,4,1,5,24,29
1219_1,,,,2,2,1,3
1221_0,,,,2,2,1,3
C(C(CO)C(C(C(O)=O)O)O)=O,,,4,1,6,17,23
1221_1,,,,2,2,1,3
1223_0,,,,2,2,1,3
C(C(CO)C(CO)(CO)O)=O,,,4,1,5,12,17
1223_1,,,,2,2,1,3
1225_0,,,,2,2,1,3
C(C(CO)C(C)(CO)O)=O,,,4,1,9,16,25
1225_1,,,,2,2,1,3
1227_0,,,,2,2,1,3
C(C(CO)C(C(C(O)=O)(C)O)O)=O,,,4,1,4,14,18
1227_1,,,,2,2,1,3
1229_0,,,,2,2,1,3
C(C(C)C(C)(C(C=O)CO)O)(O)=O,,,4,1,4,11,15
1229_1,,,,2,2,1,3
1231_0,,,,2,2,1,3
C(C(CO)C(C=CC)O)=O,,,4,1,10,15,25
1231_1,,,,2,2,1,3
1233_0,,,,2,2,1,3
C(C(CO)C(CC=C)O)=O,,,4,1,9,16,25
1233_1,,,,2,2,1,3
1235_0,,,,2,2,1,3
C(C(CO)C(C(O)=O)(C=CC)O)=O,,,4,1,4,11,15
1235_1,,,,2,2,1,3
1237_0,,,,2,2,1,3
C(C(CO)C(C(O)=O)(CC=C)O)=O,,,4,1,4,11,15
1237_1,,,,2,2,1,3
1239_0,,,,2,2,1,3
C(C(CO)C(CC(C(O)=O)=C)O)=O,,,4,1,4,13,17
1239_1,,,,2,2,1,3
1241_0,,,,2,2,1,3
C(C(CO)C(C=C(C(O)=O)C)O)=O,,,4,1,4,7,11
1241_1,,,,2,2,1,3
1243_0,,,,2,2,1,3
C(C(CO)C(C(CO)O)O)=O,,,4,1,6,16,22
1243_1,,,,2,2,1,3
1245_0,,,,2,2,1,3
C(C(CO)C(CO)O)=O,,,4,1,9,25,34
1245_1,,,,2,2,1,3
1247_0,,,,2,2,1,3
C(C(CO)C1(C(OC(C)C1)=O)O)=O,,,4,1,4,9,13
1247_1,,,,2,2,1,3
1249_0,,,,2,2,1,3
C1(CC(C(O1)=O)(C(C=O)CO)O)=O,,,4,1,4,10,14
1249_1,,,,2,2,1,3
1251_0,,,,2,2,1,3
C(C(CO)C(CC[CH]C(O)=O)O)=O,,,4,1,5,10,15
1251_1,,,,2,2,1,3
1253_0,,,,2,2,1,3
C(C(CO)C(CCCC(O)=O)O)=O,,,4,1,5,10,15
1253_1,,,,2,2,1,3
1255_0,,,,2,2,1,3
C(C(CO)C(C(C)O)O)=O,,,4,1,8,17,25
1255_1,,,,2,2,1,3
1257_0,,,,2,2,1,3
C(C(CO)C(C(O)=O)O)=O,,,4,1,15,20,35
1257_1,,,,2,2,1,3
1258_0,,,,2,2,1,3
1258_1,,,,2,2,1,3
1259_0,,,,2,2,1,3
1259_1,,,,2,2,1,3
1260_0,,,,2,2,1,3
1260_1,,,,2,2,1,3
1261_0,,,,2,2,1,3
1261_1,,,,2,2,1,3
1262_0,,,,2,2,1,3
1262_1,,,,2,2,1,3
1263_0,,,,2,2,1,3
1263_1,,,,2,2,1,3
1264_0,,,,2,2,1,3
1264_1,,,,2,2,1,3
1265_0,,,,2,2,1,3
1265_1,,,,2,2,1,3
1267_0,,,,2,2,1,3
C(C(CO)CO)=O,,,4,1,8,99,107
1267_1,,,,2,2,1,3
1269_0,,,,2,2,1,3
C(C(CO)C(C(O)=O)(CO)O)=O,,,4,1,9,15,24
1269_1,,,,2,2,1,3
1270_0,,,,2,2,1,3
1270_1,,,,2,2,1,3
1272_0,,,,2,2,1,3
C(C(CCO)(CC(CO)=O)O)(O)=O,,,4,1,3,10,13
1274_0,,,,2,2,1,3
C(C(CCO)(C(C(C)=O)O)O)(O)=O,,,4,1,4,11,15
1274_1,,,,2,2,1,3
1276_0,,,,2,2,1,3
C(C(C=C)C(C(O)=O)(CCO)O)=O,,,4,1,2,9,11
1278_0,,,,2,2,1,3
C(C(CCO)(C(C=O)O)O)(O)=O,,,4,1,4,15,19
1278_1,,,,2,2,1,3
1280_0,,,,2,2,1,3
C(C(CCO)(CC=O)O)(O)=O,,,4,1,5,13,18
1282_0,,,,2,2,1,3
C(C(CCO)(CC(C=O)=O)O)(O)=O,,,4,1,2,13,15
1284_0,,,,2,2,1,3
C(C(C(C(C(O)=O)=O)CO)O)=O,,,4,1,5,19,24
1284_1,,,,2,2,1,3
1286_0,,,,2,2,1,3
C(C(C(CO)C(C)(CO)O)=O)(O)=O,,,4,1,6,15,21
1286_1,,,,2,2,1,3
1288_0,,,,2,2,1,3
C(C)=CC(C(C(C(O)=O)=O)CO)O,,,4,1,5,11,16
1288_1,,,,2,2,1,3
1290_0,,,,2,2,1,3
C=CCC(C(C(C(O)=O)=O)CO)O,,,4,1,5,12,17
1290_1,,,,2,2,1,3
1292_0,,,,2,2,1,3
C(C(C(CO)C(CO)O)=O)(O)=O,,,4,1,6,16,22
1292_1,,,,2,2,1,3
1294_0,,,,2,2,1,3
C(C(C(CO)C(C(C)O)O)=O)(O)=O,,,4,1,5,16,21
1294_1,,,,2,2,1,3
1296_0,,,,2,2,1,3
C(C(C(C(C(O)=O)=O)CO)O)(O)=O,,,4,1,7,16,23
1296_1,,,,2,2,1,3
1297_0,,,,2,2,1,3
1297_1,,,,2,2,1,3
1298_0,,,,2,2,1,3
1298_1,,,,2,2,1,3
1299_0,,,,2,2,1,3
1299_1,,,,2,2,1,3
1300_0,,,,2,2,1,3
1300_1,,,,2,2,1,3
1302_0,,,,2,2,1,3
C(C(C(CO)CO)=O)(O)=O,,,4,1,8,12,20
1302_1,,,,2,2,1,3
1304_0,,,,2,2,1,3
C(C(CO)(CC(CC=O)O)O)(O)=O,,,4,1,2,12,14
1305_0,,,,2,2,1,3
1305_1,,,,2,2,1,3
1306_0,,,,2,2,1,3
1306_1,,,,2,2,1,3
1307_0,,,,2,2,1,3
1307_1,,,,2,2,1,3
1309_0,,,,2,2,1,3
C(C(C(C(C)O)O)(CC=O)O)(O)=O,,,4,1,3,13,16
1311_0,,,,2,2,1,3
C(C(C(C(O)=O)(CC=O)O)O)(O)=O,,,4,1,4,13,17
1313_0,,,,2,2,1,3
C(CC(C(C)=O)(CC(CO)=O)O)=O,,,4,1,2,14,16
1315_0,,,,2,2,1,3
C(CC(C(C)=O)(C(C(C)=O)O)O)=O,,,4,1,4,14,18
1315_1,,,,2,2,1,3
1317_0,,,,2,2,1,3
C(C(C=C)C(C(C)=O)(CC=O)O)=O,,,4,1,1,8,9
1319_0,,,,2,2,1,3
C(CC(C(C)=O)(C(C=O)O)O)=O,,,4,1,3,19,22
1319_1,,,,2,2,1,3
1321_0,,,,2,2,1,3
C(CC(C(C)=O)(CC=O)O)=O,,,4,1,4,10,14
1323_0,,,,2,2,1,3
C(CC(C(C)=O)(CC(C=O)=O)O)=O,,,4,1,2,13,15
1325_0,,,,2,2,1,3
C(C(C)(CC(CO)=O)O)(CC=O)=O,,,4,1,2,15,17
1327_0,,,,2,2,1,3
C(C(C)(C(C(C)=O)O)O)(CC=O)=O,,,4,1,3,16,19
1327_1,,,,2,2,1,3
1329_0,,,,2,2,1,3
C(CC(C(C)(C(C=O)C=C)O)=O)=O,,,4,1,1,9,10
1331_0,,,,2,2,1,3
C(C(C)(C(C=O)O)O)(CC=O)=O,,,4,1,3,21,24
1331_1,,,,2,2,1,3
1333_0,,,,2,2,1,3
C(C(C)(CC=O)O)(CC=O)=O,,,4,1,4,19,23
1335_0,,,,2,2,1,3
C(C(C)(CC(C=O)=O)O)(CC=O)=O,,,4,1,1,14,15
1337_0,,,,2,2,1,3
C(CO)(CC(CC(C(C)=O)=O)O)=O,,,4,1,2,14,16
1339_0,,,,2,2,1,3
C(C)(C(C(CC(C(C)=O)=O)O)O)=O,,,4,1,3,15,18
1339_1,,,,2,2,1,3
1341_0,,,,2,2,1,3
C(C(C=C)C(CC(C(C)=O)=O)O)=O,,,4,1,1,8,9
1343_0,,,,2,2,1,3
C(C(C(CC(C(C)=O)=O)O)O)=O,,,4,1,4,21,25
1343_1,,,,2,2,1,3
1345_0,,,,2,2,1,3
C(CC(CC(C(C)=O)=O)O)=O,,,4,1,5,19,24
1347_0,,,,2,2,1,3
C(C=O)(CC(CC(C(C)=O)=O)O)=O,,,4,1,2,14,16
1349_0,,,,2,2,1,3
C(C(C(C(C)=O)=O)C(C=O)O)=O,,,4,1,3,17,20
1349_1,,,,2,2,1,3
1351_0,,,,2,2,1,3
C(C(C(C(C)=O)=O)C(C)(CO)O)=O,,,4,1,3,11,14
1351_1,,,,2,2,1,3
1353_0,,,,2,2,1,3
C(C(C(C(C)=O)=O)C(C=CC)O)=O,,,4,1,2,6,8
1353_1,,,,2,2,1,3
1355_0,,,,2,2,1,3
C(C(C(C(C)=O)=O)C(CC=C)O)=O,,,4,1,2,7,9
1355_1,,,,2,2,1,3
1357_0,,,,2,2,1,3
C(C(C(C(C)=O)=O)C(CO)O)=O,,,4,1,5,16,21
1357_1,,,,2,2,1,3
1359_0,,,,2,2,1,3
C(C(C(C(C)=O)=O)C(C(C)O)O)=O,,,4,1,2,12,14
1359_1,,,,2,2,1,3
1361_0,,,,2,2,1,3
C(C(C(C(C)=O)=O)C(C(O)=O)O)=O,,,4,1,4,11,15
1361_1,,,,2,2,1,3
1363_0,,,,2,2,1,3
C(C(C(C(C)=O)=O)C(C)O)=O,,,4,1,4,14,18
1363_1,,,,2,2,1,3
1365_0,,,,2,2,1,3
C(C(C(O)=O)C(C(C)=O)=O)=O,,,4,1,6,12,18
1365_1,,,,2,2,1,3
1367_0,,,,2,2,1,3
C(C(C)(C(C=O)C(C(C)=O)=O)O)=O,,,4,1,2,9,11
1367_1,,,,2,2,1,3
1369_0,,,,2,2,1,3
C(C(C(C(C)=O)=O)C(C(C)=O)O)=O,,,4,1,2,11,13
1369_1,,,,2,2,1,3
1371_0,,,,2,2,1,3
C(C(C(C(C)=O)=O)CO)=O,,,4,1,6,20,26
1371_1,,,,2,2,1,3
1373_0,,,,2,2,1,3
C(CC(C(CC(C=O)O)=O)=O)=O,,,4,1,1,20,21
1375_0,,,,2,2,1,3
C(CC(C(CC(C)(CO)O)=O)=O)=O,,,4,1,2,11,13
1377_0,,,,2,2,1,3
C(CC(C(CC(C=CC)O)=O)=O)=O,,,4,1,1,7,8
1379_0,,,,2,2,1,3
C(CC(C(CC(CC=C)O)=O)=O)=O,,,4,1,1,8,9
1381_0,,,,2,2,1,3
C(CC(C(CC(CO)O)=O)=O)=O,,,4,1,2,16,18
1383_0,,,,2,2,1,3
C(CC(C(CC(C(C)O)O)=O)=O)=O,,,4,1,1,12,13
1385_0,,,,2,2,1,3
C(CC(C(CC(C(O)=O)O)=O)=O)=O,,,4,1,3,12,15
1387_0,,,,2,2,1,3
C(CC(C(CC(C)O)=O)=O)=O,,,4,1,3,17,20
1389_0,,,,2,2,1,3
C(CC(C(CC(O)=O)=O)=O)=O,,,4,1,3,16,19
1391_0,,,,2,2,1,3
C(C(C)(CC(C(CC=O)=O)=O)O)=O,,,4,1,1,11,12
1393_0,,,,2,2,1,3
C(CC(C(CC(C(C)=O)O)=O)=O)=O,,,4,1,1,14,15
1395_0,,,,2,2,1,3
C(CC(C(CCO)=O)=O)=O,,,4,1,4,27,31
1397_0,,,,2,2,1,3
C(C(CO)(C(C=O)O)O)(C(C)O)=O,,,4,1,4,18,22
1397_1,,,,2,2,1,3
1399_0,,,,2,2,1,3
C(C(CO)(CC=O)O)(C(C)O)=O,,,4,1,1,13,14
1401_0,,,,2,2,1,3
C(CO)(C(C(C)O)(C(C=O)O)O)=O,,,4,1,7,19,26
1401_1,,,,2,2,1,3
1403_0,,,,2,2,1,3
C(CO)(C(C(C)O)(CC=O)O)=O,,,4,1,2,14,16
1405_0,,,,2,2,1,3
C(C(C(C(C(C(C)O)=O)=O)O)O)=O,,,4,1,2,18,20
1405_1,,,,2,2,1,3
1407_0,,,,2,2,1,3
C(C(C(C)O)=O)(C(C(CO)O)O)=O,,,4,1,3,14,17
1407_1,,,,2,2,1,3
1409_0,,,,2,2,1,3
C(C(C(C)O)=O)(C(C(C)O)O)=O,,,4,1,3,12,15
1409_1,,,,2,2,1,3
1411_0,,,,2,2,1,3
C(C(C(C(C(C)O)=O)=O)O)(O)=O,,,4,1,5,11,16
1411_1,,,,2,2,1,3
1413_0,,,,2,2,1,3
C(C(C(C)O)=O)(C(CO)O)=O,,,4,1,3,14,17
1413_1,,,,2,2,1,3
1415_0,,,,2,2,1,3
C(C(C(C(C(O)=O)=O)(CO)O)O)=O,,,4,1,7,20,27
1415_1,,,,2,2,1,3
1417_0,,,,2,2,1,3
C(CC(C(C(O)=O)=O)(CO)O)=O,,,4,1,2,14,16
1419_0,,,,2,2,1,3
C(C(C(CO)=O)(C(C=O)O)O)(O)=O,,,4,1,7,17,24
1419_1,,,,2,2,1,3
1421_0,,,,2,2,1,3
C(C(C(CO)=O)(CC=O)O)(O)=O,,,4,1,2,13,15
1423_0,,,,2,2,1,3
C(C(C(C(C(C(O)=O)=O)=O)O)O)=O,,,4,1,4,19,23
1423_1,,,,2,2,1,3
1425_0,,,,2,2,1,3
C(C(C(C(C(CO)O)O)=O)=O)(O)=O,,,4,1,5,17,22
1425_1,,,,2,2,1,3
1427_0,,,,2,2,1,3
C(C(C(C(C(C)O)O)=O)=O)(O)=O,,,4,1,5,14,19
1427_1,,,,2,2,1,3
1429_0,,,,2,2,1,3
C(C(C(C(C(O)=O)=O)=O)O)(O)=O,,,4,1,3,12,15
1429_1,,,,2,2,1,3
1431_0,,,,2,2,1,3
C(C(C(C(CO)O)=O)=O)(O)=O,,,4,1,4,15,19
1431_1,,,,2,2,1,3
1433_0,,,,2,2,1,3
C(C)(C(C(C)O)(CC(CO)=O)O)=O,,,4,1,3,12,15
1435_0,,,,2,2,1,3
C(C)(C(C(C)O)(C(C(C)=O)O)O)=O,,,4,1,6,15,21
1435_1,,,,2,2,1,3
1437_0,,,,2,2,1,3
C(C(C=C)C(C(C)=O)(C(C)O)O)=O,,,4,1,2,9,11
1439_0,,,,2,2,1,3
C(C)(C(C(C)O)(C(C=O)O)O)=O,,,4,1,6,19,25
1439_1,,,,2,2,1,3
1441_0,,,,2,2,1,3
C(C)(C(C(C)O)(CC=O)O)=O,,,4,1,4,15,19
1443_0,,,,2,2,1,3
C(C)(C(C(C)O)(CC(C=O)=O)O)=O,,,4,1,2,13,15
1445_0,,,,2,2,1,3
C(C(C)(CC(CO)=O)O)(C(C)O)=O,,,4,1,2,11,13
1447_0,,,,2,2,1,3
C(C(C)(C(C(C)=O)O)O)(C(C)O)=O,,,4,1,2,12,14
1447_1,,,,2,2,1,3
1449_0,,,,2,2,1,3
C(C(C=C)C(C(C(C)O)=O)(C)O)=O,,,4,1,1,8,9
1451_0,,,,2,2,1,3
C(C(C)(C(C=O)O)O)(C(C)O)=O,,,4,1,2,15,17
1451_1,,,,2,2,1,3
1453_0,,,,2,2,1,3
C(C(C)(CC=O)O)(C(C)O)=O,,,4,1,3,13,16
1455_0,,,,2,2,1,3
C(C(C)(CC(C=O)=O)O)(C(C)O)=O,,,4,1,1,12,13
1457_0,,,,2,2,1,3
C(C(CC(C(C(C)O)=O)=O)O)=O,,,4,1,1,15,16
1459_0,,,,2,2,1,3
C(C(C(C)O)=O)(CC(CO)(C)O)=O,,,4,1,2,10,12
1461_0,,,,2,2,1,3
C(C)=CC(CC(C(C(C)O)=O)=O)O,,,4,1,1,6,7
1463_0,,,,2,2,1,3
C(CC(CC(C(C(C)O)=O)=O)O)=C,,,4,1,1,7,8
1465_0,,,,2,2,1,3
C(C(C(C)O)=O)(CC(CO)O)=O,,,4,1,2,12,14
1467_0,,,,2,2,1,3
C(C(C(C)O)=O)(CC(C(C)O)O)=O,,,4,1,1,11,12
1469_0,,,,2,2,1,3
C(C(CC(C(C(C)O)=O)=O)O)(O)=O,,,4,1,4,11,15
1471_0,,,,2,2,1,3
C(C(C(C)O)=O)(CC(C)O)=O,,,4,1,2,12,14
1473_0,,,,2,2,1,3
C(CC(C(C(C)O)=O)=O)(O)=O,,,4,1,2,12,14
1475_0,,,,2,2,1,3
C(C(C)(CC(C(C(C)O)=O)=O)O)=O,,,4,1,1,10,11
1477_0,,,,2,2,1,3
C(C(CC(C(C(C)O)=O)=O)O)(C)=O,,,4,1,1,11,12
1479_0,,,,2,2,1,3
C(C(C(C)O)=O)(CCO)=O,,,4,1,2,19,21
1481_0,,,,2,2,1,3
C(C(C(C)=O)(CC(CO)=O)O)(O)=O,,,4,1,3,11,14
1483_0,,,,2,2,1,3
C(C(C(C)=O)(C(C(C)=O)O)O)(O)=O,,,4,1,6,12,18
1483_1,,,,2,2,1,3
1485_0,,,,2,2,1,3
C(C(C=C)C(C(O)=O)(C(C)=O)O)=O,,,4,1,2,7,9
1487_0,,,,2,2,1,3
C(C(C(C)=O)(C(C=O)O)O)(O)=O,,,4,1,7,16,23
1487_1,,,,2,2,1,3
1489_0,,,,2,2,1,3
C(C(C(C)=O)(CC=O)O)(O)=O,,,4,1,5,13,18
1491_0,,,,2,2,1,3
C(C(C(C)=O)(CC(C=O)=O)O)(O)=O,,,4,1,2,11,13
1493_0,,,,2,2,1,3
C(CC(C(C(O)=O)=O)(C)O)(CO)=O,,,4,1,2,12,14
1495_0,,,,2,2,1,3
C(C(C(C(C(O)=O)=O)(C)O)O)(C)=O,,,4,1,3,13,16
1495_1,,,,2,2,1,3
1497_0,,,,2,2,1,3
C(C(C=C)C(C(C(O)=O)=O)(C)O)=O,,,4,1,1,8,9
1499_0,,,,2,2,1,3
C(C(C(C(C(O)=O)=O)(C)O)O)=O,,,4,1,3,16,19
1499_1,,,,2,2,1,3
1501_0,,,,2,2,1,3
C(CC(C(C(O)=O)=O)(C)O)=O,,,4,1,3,12,15
1503_0,,,,2,2,1,3
C(C(O)=O)(C(C)(CC(C=O)=O)O)=O,,,4,1,1,11,12
1505_0,,,,2,2,1,3
C(C(CC(C(C(O)=O)=O)=O)O)=O,,,4,1,3,15,18
1507_0,,,,2,2,1,3
C(C(C(CC(C)(CO)O)=O)=O)(O)=O,,,4,1,2,12,14
1509_0,,,,2,2,1,3
C(C(CC(C(C(O)=O)=O)=O)O)=CC,,,4,1,1,7,8
1511_0,,,,2,2,1,3
C=CCC(CC(C(C(O)=O)=O)=O)O,,,4,1,1,8,9
1513_0,,,,2,2,1,3
C(C(C(CC(CO)O)=O)=O)(O)=O,,,4,1,4,14,18
1515_0,,,,2,2,1,3
C(C(C(CC(C(C)O)O)=O)=O)(O)=O,,,4,1,1,13,14
1517_0,,,,2,2,1,3
C(C(CC(C(C(O)=O)=O)=O)O)(O)=O,,,4,1,4,12,16
1519_0,,,,2,2,1,3
C(C(C(CC(C)O)=O)=O)(O)=O,,,4,1,3,12,15
1521_0,,,,2,2,1,3
C(CC(C(C(O)=O)=O)=O)(O)=O,,,4,1,3,11,14
1523_0,,,,2,2,1,3
C(C(C)(CC(C(C(O)=O)=O)=O)O)=O,,,4,1,1,10,11
1525_0,,,,2,2,1,3
C(C)(C(CC(C(C(O)=O)=O)=O)O)=O,,,4,1,1,11,12
1527_0,,,,2,2,1,3
C(C(C(CCO)=O)=O)(O)=O,,,4,1,2,17,19
1529_0,,,,2,2,1,3
C(C(C(C(CCO)=O)=O)(C)O)(O)=O,,,4,1,2,9,11
1531_0,,,,2,2,1,3
C(C(C(C(CO)=O)O)O)=O,,,4,1,24,37,61
1531_1,,,,2,2,1,3
1533_0,,,,2,2,1,3
C(C(CC(CO)=O)O)=O,,,4,1,8,51,59
1535_0,,,,2,2,1,3
C(C(C(C(C)=O)O)O)=O,,,4,1,27,54,81
1535_1,,,,2,2,1,3
1537_0,,,,2,2,1,3
C(CC(C=O)O)(C(C(O)=O)CO)=O,,,4,1,1,14,15
1539_0,,,,2,2,1,3
C(CC(C=O)O)(C(C(O)=O)C)=O,,,4,1,1,14,15
1541_0,,,,2,2,1,3
C(C(C=C)C(C=O)O)=O,,,4,1,7,42,49
1543_0,,,,2,2,1,3
C(C(C(C=C)C(C(O)=O)=O)O)=O,,,4,1,2,15,17
1545_0,,,,2,2,1,3
C(C(C(C(O)=O)=C)C(C=O)O)=O,,,4,1,2,15,17
1547_0,,,,2,2,1,3
C(C(C1C(C(OC(C1=C)=O)=O)=O)O)=O,,,4,1,1,6,7
1549_0,,,,2,2,1,3
C(C(C(C=O)O)O)=O,,,4,1,19,67,86
1549_1,,,,2,2,1,3
1551_0,,,,2,2,1,3
C(C(C1C(C(OC1C)=O)=O)O)=O,,,4,1,3,10,13
1551_1,,,,2,2,1,3
1553_0,,,,2,2,1,3
C1(C(C(C(O1)=O)=O)C(C=O)O)=O,,,4,1,3,10,13
1553_1,,,,2,2,1,3
1555_0,,,,2,2,1,3
C(C(C(C=O)C[CH]C(O)=O)O)=O,,,4,1,2,15,17
1557_0,,,,2,2,1,3
C(CCC(C=O)C(C=O)O)(O)=O,,,4,1,2,15,17
1559_0,,,,2,2,1,3
C(CC(C=O)O)=O,,,4,1,34,221,255
1561_0,,,,2,2,1,3
C(C(C(C)O)C(C=O)O)=O,,,4,1,13,24,37
1561_1,,,,2,2,1,3
1563_0,,,,2,2,1,3
C(C(C(C(C(O)=O)=O)C(C)O)O)=O,,,4,1,6,17,23
1563_1,,,,2,2,1,3
1565_0,,,,2,2,1,3
C(C(C=O)C(C=O)O)(O)=O,,,4,1,14,22,36
1565_1,,,,2,2,1,3
1567_0,,,,2,2,1,3
C(C(C)(C(C=O)C(C=O)O)O)(O)=O,,,4,1,7,16,23
1567_1,,,,2,2,1,3
1569_0,,,,2,2,1,3
C(C(C(C(O)=O)=O)C(C=O)O)(O)=O,,,4,1,6,15,21
1569_1,,,,2,2,1,3
1571_0,,,,2,2,1,3
C(C(C(C(C=O)=O)O)O)=O,,,4,1,21,35,56
1571_1,,,,2,2,1,3
1573_0,,,,2,2,1,3
C(C(CC(C=O)=O)O)=O,,,4,1,16,43,59
1575_0,,,,2,2,1,3
C(C(C(C(C(O)=O)=O)O)O)=O,,,4,1,13,22,35
1575_1,,,,2,2,1,3
1577_0,,,,2,2,1,3
C(C(CC(C(O)=O)=O)O)=O,,,4,1,12,24,36
1579_0,,,,2,2,1,3
[C](C(O)=O)(CC(C(CCO)=O)=O)O,,,4,1,3,8,11
1581_0,,,,2,2,1,3
[C](C(O)=O)(C(C(C(C)=O)=O)CO)O,,,4,1,5,11,16
1581_1,,,,2,2,1,3
1583_0,,,,2,2,1,3
C(C(CC(C(CCO)=O)=O)O)(O)=O,,,4,1,4,10,14
1585_0,,,,2,2,1,3
C(C(C(C(C(C)=O)=O)CO)O)(O)=O,,,4,1,6,13,19
1585_1,,,,2,2,1,3
1587_0,,,,2,2,1,3
C(C(OC(C(C)=O)=O)=O)(CCO)=O,,,4,1,6,6,12
1589_0,,,,2,2,1,3
C(C(C(C(C(CO)=O)O)O)O)=O,,,4,1,9,21,30
1589_1,,,,2,2,1,3
1591_0,,,,2,2,1,3
C(C(C(CC(CO)=O)O)O)=O,,,4,1,3,24,27
1593_0,,,,2,2,1,3
C(C(C(C(C(C)=O)O)O)O)=O,,,4,1,7,24,31
1593_1,,,,2,2,1,3
1595_0,,,,2,2,1,3
C(C(C=C)C(C(C=O)O)O)=O,,,4,1,3,21,24
1597_0,,,,2,2,1,3
C(C(C(C(C=O)O)O)O)=O,,,4,1,10,18,28
1597_1,,,,2,2,1,3
1599_0,,,,2,2,1,3
C(CC(C(C=O)O)O)=O,,,4,1,12,49,61
1601_0,,,,2,2,1,3
C(C(C(C(C=O)O)O)C(C)O)=O,,,4,1,6,22,28
1601_1,,,,2,2,1,3
1603_0,,,,2,2,1,3
C(C(C=O)C(C(C=O)O)O)(O)=O,,,4,1,8,21,29
1603_1,,,,2,2,1,3
1605_0,,,,2,2,1,3
C(C(C(C(C(C=O)=O)O)O)O)=O,,,4,1,6,27,33
1605_1,,,,2,2,1,3
1607_0,,,,2,2,1,3
C(C(C(CC(C=O)=O)O)O)=O,,,4,1,6,27,33
1609_0,,,,2,2,1,3
C(C(C(C(C(C(O)=O)=O)O)O)O)=O,,,4,1,8,21,29
1609_1,,,,2,2,1,3
1611_0,,,,2,2,1,3
C(C(C(CC(C(O)=O)=O)O)O)=O,,,4,1,6,20,26
1613_0,,,,2,2,1,3
C(C(C(C(C(CO)=O)O)O)O)(O)=O,,,4,1,11,15,26
1613_1,,,,2,2,1,3
1615_0,,,,2,2,1,3
C(C(C(CC(CO)=O)O)O)(O)=O,,,4,1,4,12,16
1617_0,,,,2,2,1,3
C(C(C(C(C(C)=O)O)O)O)(O)=O,,,4,1,10,14,24
1617_1,,,,2,2,1,3
1619_0,,,,2,2,1,3
C(C(C=C)C(C(C(O)=O)O)O)=O,,,4,1,4,14,18
1621_0,,,,2,2,1,3
C(C(C(C(C=O)O)O)O)(O)=O,,,4,1,17,22,39
1621_1,,,,2,2,1,3
1623_0,,,,2,2,1,3
C(CC(C(C(O)=O)O)O)=O,,,4,1,12,25,37
1625_0,,,,2,2,1,3
C(C(C(C(C(O)=O)O)O)C(C)O)=O,,,4,1,7,16,23
1625_1,,,,2,2,1,3
1627_0,,,,2,2,1,3
C(C(C=O)C(C(C(O)=O)O)O)(O)=O,,,4,1,9,15,24
1627_1,,,,2,2,1,3
1629_0,,,,2,2,1,3
C(C(C(C(C(C=O)=O)O)O)O)(O)=O,,,4,1,6,21,27
1629_1,,,,2,2,1,3
1631_0,,,,2,2,1,3
C(C(C(CC(C=O)=O)O)O)(O)=O,,,4,1,5,20,25
1633_0,,,,2,2,1,3
C(C(C(CC(C(O)=O)=O)O)O)(O)=O,,,4,1,6,15,21
1635_0,,,,2,2,1,3
C(CO)(C(C(CO)(CO)O)O)=O,,,4,1,5,7,12
1635_1,,,,2,2,1,3
1637_0,,,,2,2,1,3
C(CO)(CC(CO)(CO)O)=O,,,4,1,3,10,13
1639_0,,,,2,2,1,3
C(C)(C(C(CO)(CO)O)O)=O,,,4,1,4,10,14
1639_1,,,,2,2,1,3
1641_0,,,,2,2,1,3
C(C(C=C)C(CO)(CO)O)=O,,,4,1,3,10,13
1643_0,,,,2,2,1,3
C(C(C(CO)(CO)O)O)=O,,,4,1,11,17,28
1643_1,,,,2,2,1,3
1645_0,,,,2,2,1,3
C(CC(CO)(CO)O)=O,,,4,1,9,24,33
1647_0,,,,2,2,1,3
C(C(C(C)O)C(CO)(CO)O)=O,,,4,1,6,12,18
1647_1,,,,2,2,1,3
1649_0,,,,2,2,1,3
C(C(C=O)C(CO)(CO)O)(O)=O,,,4,1,6,11,17
1649_1,,,,2,2,1,3
1651_0,,,,2,2,1,3
C(C(C(C(CO)(CO)O)O)=O)=O,,,4,1,3,14,17
1651_1,,,,2,2,1,3
1653_0,,,,2,2,1,3
C(C(CC(CO)(CO)O)=O)=O,,,4,1,4,14,18
1655_0,,,,2,2,1,3
C(C(C(C(CO)(CO)O)O)=O)(O)=O,,,4,1,4,11,15
1655_1,,,,2,2,1,3
1657_0,,,,2,2,1,3
C(C(CC(CO)(CO)O)=O)(O)=O,,,4,1,3,10,13
1659_0,,,,2,2,1,3
C(CO)(C(C(CO)(C)O)O)=O,,,4,1,4,12,16
1659_1,,,,2,2,1,3
1661_0,,,,2,2,1,3
C(CO)(C(C(C=CC)O)O)=O,,,4,1,4,12,16
1661_1,,,,2,2,1,3
1663_0,,,,2,2,1,3
C(CO)(C(C(CC=C)O)O)=O,,,4,1,4,13,17
1663_1,,,,2,2,1,3
1665_0,,,,2,2,1,3
C(CO)(C(C(C(CO)O)O)O)=O,,,4,1,6,12,18
1665_1,,,,2,2,1,3
1667_0,,,,2,2,1,3
C(CO)(C(C(CO)O)O)=O,,,4,1,7,22,29
1667_1,,,,2,2,1,3
1669_0,,,,2,2,1,3
C(CO)(C(C(C(C)O)O)O)=O,,,4,1,3,14,17
1669_1,,,,2,2,1,3
1670_0,,,,2,2,1,3
1670_1,,,,2,2,1,3
1672_0,,,,2,2,1,3
C(CO)(C(C(C)O)O)=O,,,4,1,11,38,49
1672_1,,,,2,2,1,3
1674_0,,,,2,2,1,3
C(C(C(CO)=O)O)(O)=O,,,4,1,15,35,50
1674_1,,,,2,2,1,3
1676_0,,,,2,2,1,3
C(CO)(C(C(CC(C)O)O)O)=O,,,4,1,6,10,16
1676_1,,,,2,2,1,3
1678_0,,,,2,2,1,3
C(CC(C(C(CO)=O)O)O)(O)=O,,,4,1,5,10,15
1678_1,,,,2,2,1,3
1680_0,,,,2,2,1,3
C(CO)(C(C(C(CO)=O)O)O)=O,,,4,1,4,8,12
1680_1,,,,2,2,1,3
1682_0,,,,2,2,1,3
C(C(CO)(C(C(CO)=O)O)O)=O,,,4,1,9,18,27
1682_1,,,,2,2,1,3
1684_0,,,,2,2,1,3
C(C(C)(C(C(CO)=O)O)O)=O,,,4,1,7,17,24
1684_1,,,,2,2,1,3
1686_0,,,,2,2,1,3
C(C)(C(C(C(CO)=O)O)O)=O,,,4,1,10,21,31
1686_1,,,,2,2,1,3
1688_0,,,,2,2,1,3
C(CO)(C(CO)O)=O,,,4,1,21,108,129
1688_1,,,,2,2,1,3
1689_0,,,,2,2,1,3
1689_1,,,,2,2,1,3
1690_0,,,,2,2,1,3
1690_1,,,,2,2,1,3
1692_0,,,,2,2,1,3
C(CO)(CC(CO)(C)O)=O,,,4,1,3,20,23
1694_0,,,,2,2,1,3
C(C)(C(C(CO)(C)O)O)=O,,,4,1,3,18,21
1694_1,,,,2,2,1,3
1696_0,,,,2,2,1,3
C(C(C(CC(C)(CO)O)=O)C)(O)=O,,,4,1,2,9,11
1698_0,,,,2,2,1,3
C(C(C=C)C(C)(CO)O)=O,,,4,1,4,14,18
1700_0,,,,2,2,1,3
C=CC(C(C(O)=O)=O)C(C)(CO)O,,,4,1,2,10,12
1702_0,,,,2,2,1,3
C(C(C(C(O)=O)=C)C(C)(CO)O)=O,,,4,1,2,11,13
1704_0,,,,2,2,1,3
C(C(C(CO)(C)O)O)=O,,,4,1,8,29,37
1704_1,,,,2,2,1,3
1706_0,,,,2,2,1,3
C1(C(C(C(C)O1)C(C)(CO)O)=O)=O,,,4,1,3,8,11
1706_1,,,,2,2,1,3
1708_0,,,,2,2,1,3
C1(C(C(C(O1)=O)=O)C(C)(CO)O)=O,,,4,1,3,9,12
1708_1,,,,2,2,1,3
1710_0,,,,2,2,1,3
C(C(C(C)(CO)O)C[CH]C(O)=O)=O,,,4,1,3,11,14
1712_0,,,,2,2,1,3
C(C(CCC(O)=O)C(C)(CO)O)=O,,,4,1,3,11,14
1714_0,,,,2,2,1,3
C(CC(C)(CO)O)=O,,,4,1,15,74,89
1716_0,,,,2,2,1,3
C(C(C(C)O)C(C)(CO)O)=O,,,4,1,8,14,22
1716_1,,,,2,2,1,3
1718_0,,,,2,2,1,3
C(C(C=O)C(C)(CO)O)(O)=O,,,4,1,8,13,21
1718_1,,,,2,2,1,3
1720_0,,,,2,2,1,3
C(C(C(C(CO)(C)O)O)=O)=O,,,4,1,6,17,23
1720_1,,,,2,2,1,3
1722_0,,,,2,2,1,3
C(C(CC(C)(CO)O)=O)=O,,,4,1,12,21,33
1724_0,,,,2,2,1,3
C(C(C(C(CO)(C)O)O)=O)(O)=O,,,4,1,4,12,16
1724_1,,,,2,2,1,3
1726_0,,,,2,2,1,3
C(C(CC(C)(CO)O)=O)(O)=O,,,4,1,5,13,18
1728_0,,,,2,2,1,3
C(C(C)(C(CC(CO)=O)O)O)(O)=O,,,4,1,2,10,12
1730_0,,,,2,2,1,3
C(C(C)C(C)(CC(CO)=O)O)(O)=O,,,4,1,2,7,9
1732_0,,,,2,2,1,3
C(CO)(CC(C=CC)O)=O,,,4,1,4,19,23
1734_0,,,,2,2,1,3
C(CO)(CC(CC=C)O)=O,,,4,1,3,20,23
1736_0,,,,2,2,1,3
C(C(C=CC)(CC(CO)=O)O)(O)=O,,,4,1,2,7,9
1738_0,,,,2,2,1,3
C(C(CC=C)(CC(CO)=O)O)(O)=O,,,4,1,2,7,9
1740_0,,,,2,2,1,3
C(CO)(CC(CC(C(O)=O)=C)O)=O,,,4,1,2,8,10
1742_0,,,,2,2,1,3
C(CO)(CC(C=C(C(O)=O)C)O)=O,,,4,1,2,4,6
1744_0,,,,2,2,1,3
C(CO)(CC(C(CO)O)O)=O,,,4,1,4,14,18
1746_0,,,,2,2,1,3
C(CO)(CC(CO)O)=O,,,4,1,3,38,41
1748_0,,,,2,2,1,3
C1(C(CC(C)O1)(CC(CO)=O)O)=O,,,4,1,2,5,7
1750_0,,,,2,2,1,3
C1(CC(C(O1)=O)(CC(CO)=O)O)=O,,,4,1,2,6,8
1752_0,,,,2,2,1,3
C(CO)(CC(CC[CH]C(O)=O)O)=O,,,4,1,3,6,9
1754_0,,,,2,2,1,3
C(CCCC(CC(CO)=O)O)(O)=O,,,4,1,3,6,9
1756_0,,,,2,2,1,3
C(CO)(CC(C(C)O)O)=O,,,4,1,2,21,23
1758_0,,,,2,2,1,3
C(C(CC(CO)=O)O)(O)=O,,,4,1,10,24,34
1760_0,,,,2,2,1,3
C(CO)(CC(C)O)=O,,,4,1,13,111,124
1762_0,,,,2,2,1,3
C(CC(CO)=O)(O)=O,,,4,1,12,103,115
1764_0,,,,2,2,1,3
C(CO)(CC(CC(C)O)O)=O,,,4,1,5,12,17
1766_0,,,,2,2,1,3
C(CC(CC(CO)=O)O)(O)=O,,,4,1,4,12,16
1768_0,,,,2,2,1,3
C(CO)(C(CC(CO)=O)O)=O,,,4,1,7,19,26
1770_0,,,,2,2,1,3
C(C(CO)(CC(CO)=O)O)=O,,,4,1,5,17,22
1772_0,,,,2,2,1,3
C(C(C)(CC(CO)=O)O)=O,,,4,1,6,24,30
1774_0,,,,2,2,1,3
C(C)(C(CC(CO)=O)O)=O,,,4,1,13,30,43
1776_0,,,,2,2,1,3
C(CO)(CCO)=O,,,4,1,21,214,235
1778_0,,,,2,2,1,3
C(C(CO)(CC(CO)=O)O)(O)=O,,,4,1,6,10,16
1780_0,,,,2,2,1,3
C(C(C)(CC(CO)=O)O)(O)=O,,,4,1,5,12,17
1782_0,,,,2,2,1,3
C(C(C)(C(C(C(C)=O)O)O)O)(O)=O,,,4,1,3,12,15
1782_1,,,,2,2,1,3
1784_0,,,,2,2,1,3
C(C(C)C(C)(C(C(C)=O)O)O)(O)=O,,,4,1,2,8,10
1784_1,,,,2,2,1,3
1786_0,,,,2,2,1,3
C(C)(C(C(C=CC)O)O)=O,,,4,1,4,18,22
1786_1,,,,2,2,1,3
1788_0,,,,2,2,1,3
C(C)(C(C(CC=C)O)O)=O,,,4,1,3,19,22
1788_1,,,,2,2,1,3
1790_0,,,,2,2,1,3
C(C(C=CC)(C(C(C)=O)O)O)(O)=O,,,4,1,3,8,11
1790_1,,,,2,2,1,3
1792_0,,,,2,2,1,3
C(C(CC=C)(C(C(C)=O)O)O)(O)=O,,,4,1,3,8,11
1792_1,,,,2,2,1,3
1794_0,,,,2,2,1,3
C(C)(C(C(CC(C(O)=O)=C)O)O)=O,,,4,1,2,11,13
1794_1,,,,2,2,1,3
1796_0,,,,2,2,1,3
C(C)(C(C(C=C(C(O)=O)C)O)O)=O,,,4,1,2,6,8
1796_1,,,,2,2,1,3
1798_0,,,,2,2,1,3
C(C)(C(C(C(CO)O)O)O)=O,,,4,1,5,15,20
1798_1,,,,2,2,1,3
1800_0,,,,2,2,1,3
C(C)(C(C(CO)O)O)=O,,,4,1,7,34,41
1800_1,,,,2,2,1,3
1802_0,,,,2,2,1,3
C1(C(CC(C)O1)(C(C(C)=O)O)O)=O,,,4,1,3,6,9
1802_1,,,,2,2,1,3
1804_0,,,,2,2,1,3
C1(CC(C(O1)=O)(C(C(C)=O)O)O)=O,,,4,1,3,7,10
1804_1,,,,2,2,1,3
1806_0,,,,2,2,1,3
C(C)(C(C(CC[CH]C(O)=O)O)O)=O,,,4,1,3,9,12
1806_1,,,,2,2,1,3
1808_0,,,,2,2,1,3
C(CCCC(C(C(C)=O)O)O)(O)=O,,,4,1,3,9,12
1808_1,,,,2,2,1,3
1810_0,,,,2,2,1,3
C(C)(C(C(C(C)O)O)O)=O,,,4,1,2,20,22
1810_1,,,,2,2,1,3
1811_0,,,,2,2,1,3
1811_1,,,,2,2,1,3
1813_0,,,,2,2,1,3
C(C)(C(C(C)O)O)=O,,,4,1,17,95,112
1813_1,,,,2,2,1,3
1815_0,,,,2,2,1,3
C(C(C(C)=O)O)(O)=O,,,4,1,21,85,106
1815_1,,,,2,2,1,3
1817_0,,,,2,2,1,3
C(C)(C(C(CC(C)O)O)O)=O,,,4,1,4,13,17
1817_1,,,,2,2,1,3
1819_0,,,,2,2,1,3
C(CC(C(C(C)=O)O)O)(O)=O,,,4,1,4,13,17
1819_1,,,,2,2,1,3
1820_0,,,,2,2,1,3
1820_1,,,,2,2,1,3
1822_0,,,,2,2,1,3
C(C(CO)(C(C(C)=O)O)O)=O,,,4,1,10,19,29
1822_1,,,,2,2,1,3
1824_0,,,,2,2,1,3
C(C(C)(C(C(C)=O)O)O)=O,,,4,1,15,22,37
1824_1,,,,2,2,1,3
1826_0,,,,2,2,1,3
C(C)(C(C(C(C)=O)O)O)=O,,,4,1,12,16,28
1826_1,,,,2,2,1,3
1828_0,,,,2,2,1,3
C(C)(C(CO)O)=O,,,4,1,17,179,196
1828_1,,,,2,2,1,3
1829_0,,,,2,2,1,3
1829_1,,,,2,2,1,3
1830_0,,,,2,2,1,3
1830_1,,,,2,2,1,3
1832_0,,,,2,2,1,3
C(C(C(C(O)=O)O)O)(C(CO)O)=O,,,4,1,13,16,29
1832_1,,,,2,2,1,3
1834_0,,,,2,2,1,3
C(CC(C(C)(C(C(O)=O)O)O)O)=O,,,4,1,4,15,19
1836_0,,,,2,2,1,3
C(CC(C)(C(C(C(O)=O)O)O)O)=O,,,4,1,4,16,20
1838_0,,,,2,2,1,3
C(C(C(C(O)=O)O)O)(CC(C)O)=O,,,4,1,8,13,21
1840_0,,,,2,2,1,3
C(CC(C(C(C(O)=O)O)O)=O)(O)=O,,,4,1,8,14,22
1842_0,,,,2,2,1,3
C(C(C(C(O)=O)O)O)(CCO)=O,,,4,1,6,13,19
1844_0,,,,2,2,1,3
C(C(C)(C(C(CCO)=O)O)O)(O)=O,,,4,1,5,11,16
1846_0,,,,2,2,1,3
C(C(C=C)C(C(C(O)=O)(C)O)O)=O,,,4,1,1,9,10
1848_0,,,,2,2,1,3
C(C(C)(C(C(C=O)O)O)O)(O)=O,,,4,1,7,17,24
1848_1,,,,2,2,1,3
1850_0,,,,2,2,1,3
C(C(C)(C(CC=O)O)O)(O)=O,,,4,1,5,13,18
1852_0,,,,2,2,1,3
C(C(C)(C(CC(C=O)=O)O)O)(O)=O,,,4,1,2,13,15
1854_0,,,,2,2,1,3
C(C(CO)C(C)(C(C=O)O)O)(O)=O,,,4,1,3,14,17
1854_1,,,,2,2,1,3
1856_0,,,,2,2,1,3
C(C(CO)C(C)(CC=O)O)(O)=O,,,4,1,1,12,13
1858_0,,,,2,2,1,3
C(C(C(CC(CO)O)=O)CO)(O)=O,,,4,1,2,12,14
1860_0,,,,2,2,1,3
C(C(C(CC(C)O)=O)CO)(O)=O,,,4,1,4,11,15
1862_0,,,,2,2,1,3
C(C(C(CC(O)=O)=O)CO)(O)=O,,,4,1,6,11,17
1864_0,,,,2,2,1,3
C(C(C(CCO)=O)CO)(O)=O,,,4,1,3,13,16
1866_0,,,,2,2,1,3
C(C(C=C)C(C)(C(C(O)=O)C)O)=O,,,4,1,1,6,7
1868_0,,,,2,2,1,3
C(C(C)C(C)(C(C=O)O)O)(O)=O,,,4,1,2,12,14
1868_1,,,,2,2,1,3
1870_0,,,,2,2,1,3
C(C(C)C(C)(CC=O)O)(O)=O,,,4,1,3,11,14
1872_0,,,,2,2,1,3
C(C(C)C(C)(CC(C=O)=O)O)(O)=O,,,4,1,1,10,11
1874_0,,,,2,2,1,3
C(CC(C=CC)O)(C(C(O)=O)C)=O,,,4,1,1,5,6
1876_0,,,,2,2,1,3
C(C(C(CC(CC=C)O)=O)C)(O)=O,,,4,1,1,6,7
1878_0,,,,2,2,1,3
C(C(C(CC(CO)O)=O)C)(O)=O,,,4,1,2,11,13
1880_0,,,,2,2,1,3
C(C(C(CC(C(C)O)O)=O)C)(O)=O,,,4,1,1,10,11
1882_0,,,,2,2,1,3
C(CC(C(O)=O)O)(C(C(O)=O)C)=O,,,4,1,3,9,12
1884_0,,,,2,2,1,3
C(C(C(CC(C)O)=O)C)(O)=O,,,4,1,2,11,13
1886_0,,,,2,2,1,3
C(CC(O)=O)(C(C(O)=O)C)=O,,,4,1,3,10,13
1888_0,,,,2,2,1,3
C(C(C)(CC(C(C(O)=O)C)=O)O)=O,,,4,1,1,9,10
1890_0,,,,2,2,1,3
C(CC(C(C)=O)O)(C(C(O)=O)C)=O,,,4,1,1,9,10
1892_0,,,,2,2,1,3
C(C(C(CCO)=O)C)(O)=O,,,4,1,2,17,19
1894_0,,,,2,2,1,3
C(C(C=C)C(C=CC)O)=O,,,4,1,5,18,23
1896_0,,,,2,2,1,3
C=CC(C(C(O)=O)=O)C(C=CC)O,,,4,1,1,6,7
1898_0,,,,2,2,1,3
C(C(C(C(O)=O)=C)C(C=CC)O)=O,,,4,1,1,6,7
1900_0,,,,2,2,1,3
C(C(C(C=CC)O)O)=O,,,4,1,9,30,39
1900_1,,,,2,2,1,3
1902_0,,,,2,2,1,3
C(C)=CC(C1C(C(OC1C)=O)=O)O,,,4,1,2,4,6
1902_1,,,,2,2,1,3
1904_0,,,,2,2,1,3
C1(C(C(C(O1)=O)=O)C(C=CC)O)=O,,,4,1,2,4,6
1904_1,,,,2,2,1,3
1906_0,,,,2,2,1,3
C(C(C[CH]C(O)=O)C(C=CC)O)=O,,,4,1,2,7,9
1908_0,,,,2,2,1,3
C(CCC(C=O)C(C=CC)O)(O)=O,,,4,1,2,7,9
1910_0,,,,2,2,1,3
C(CC(C=CC)O)=O,,,4,1,16,80,96
1912_0,,,,2,2,1,3
C(C(C(C)O)C(C=CC)O)=O,,,4,1,8,13,21
1912_1,,,,2,2,1,3
1914_0,,,,2,2,1,3
C(C(C=O)C(C=CC)O)(O)=O,,,4,1,8,11,19
1914_1,,,,2,2,1,3
1916_0,,,,2,2,1,3
C(C(C(C(C=O)=O)O)O)=CC,,,4,1,6,16,22
1916_1,,,,2,2,1,3
1918_0,,,,2,2,1,3
C(C(CC(C=O)=O)O)=CC,,,4,1,13,24,37
1920_0,,,,2,2,1,3
C(C(C(C(C(O)=O)=O)O)O)=CC,,,4,1,4,11,15
1920_1,,,,2,2,1,3
1922_0,,,,2,2,1,3
C(C(CC(C(O)=O)=O)O)=CC,,,4,1,5,11,16
1924_0,,,,2,2,1,3
C(C(C=C)C(CC=C)O)=O,,,4,1,4,19,23
1926_0,,,,2,2,1,3
C=CC(C(C(O)=O)=O)C(CC=C)O,,,4,1,1,7,8
1928_0,,,,2,2,1,3
C(C(C(C(O)=O)=C)C(CC=C)O)=O,,,4,1,1,7,8
1930_0,,,,2,2,1,3
C(C(C(CC=C)O)O)=O,,,4,1,8,31,39
1930_1,,,,2,2,1,3
1932_0,,,,2,2,1,3
C=CCC(C1C(C(OC1C)=O)=O)O,,,4,1,2,5,7
1932_1,,,,2,2,1,3
1934_0,,,,2,2,1,3
C1(C(C(C(O1)=O)=O)C(CC=C)O)=O,,,4,1,2,5,7
1934_1,,,,2,2,1,3
1936_0,,,,2,2,1,3
C(C(C(CC=C)O)C[CH]C(O)=O)=O,,,4,1,2,8,10
1938_0,,,,2,2,1,3
C(C(CCC(O)=O)C(CC=C)O)=O,,,4,1,2,8,10
1940_0,,,,2,2,1,3
C(CC(CC=C)O)=O,,,4,1,15,81,96
1942_0,,,,2,2,1,3
C(C(C(CC=C)O)C(C)O)=O,,,4,1,8,14,22
1942_1,,,,2,2,1,3
1944_0,,,,2,2,1,3
C(C(C=O)C(CC=C)O)(O)=O,,,4,1,8,12,20
1944_1,,,,2,2,1,3
1946_0,,,,2,2,1,3
C(CC(C(C(C=O)=O)O)O)=C,,,4,1,6,17,23
1946_1,,,,2,2,1,3
1948_0,,,,2,2,1,3
C=CCC(CC(C=O)=O)O,,,4,1,12,25,37
1950_0,,,,2,2,1,3
C(CC(C(C(C(O)=O)=O)O)O)=C,,,4,1,4,12,16
1950_1,,,,2,2,1,3
1952_0,,,,2,2,1,3
C=CCC(CC(C(O)=O)=O)O,,,4,1,5,12,17
1954_0,,,,2,2,1,3
C(C(C=C)C(C(O)=O)(C=CC)O)=O,,,4,1,1,6,7
1956_0,,,,2,2,1,3
C(C(C=C)C(C(O)=O)(CC=C)O)=O,,,4,1,1,6,7
1958_0,,,,2,2,1,3
C(C(C=C)C(CC(C(O)=O)=C)O)=O,,,4,1,1,7,8
1960_0,,,,2,2,1,3
C(C(C=C)C(C=C(C(O)=O)C)O)=O,,,4,1,1,3,4
1962_0,,,,2,2,1,3
C(C(C=C)C(C(CO)O)O)=O,,,4,1,4,14,18
1964_0,,,,2,2,1,3
C(C(C=C)C(CO)O)=O,,,4,1,4,22,26
1966_0,,,,2,2,1,3
C(C(C=C)C1(C(OC(C)C1)=O)O)=O,,,4,1,1,4,5
1968_0,,,,2,2,1,3
C(C(C=C)C1(C(OC(C1)=O)=O)O)=O,,,4,1,1,4,5
1970_0,,,,2,2,1,3
C(C(C=C)C(CC[CH]C(O)=O)O)=O,,,4,1,2,6,8
1972_0,,,,2,2,1,3
C(C(C=C)C(CCCC(O)=O)O)=O,,,4,1,2,6,8
1974_0,,,,2,2,1,3
C(C(C=C)C(C(C)O)O)=O,,,4,1,3,15,18
1976_0,,,,2,2,1,3
C(C(C=C)C(C(O)=O)O)=O,,,4,1,6,17,23
1978_0,,,,2,2,1,3
C(C(C=C)C(C)O)=O,,,4,1,6,61,67
1980_0,,,,2,2,1,3
C(C(C(O)=O)C=C)=O,,,4,1,5,51,56
1982_0,,,,2,2,1,3
C(C(C=C)C(CC(C)O)O)=O,,,4,1,4,12,16
1984_0,,,,2,2,1,3
C(C(C=C)C(CC(O)=O)O)=O,,,4,1,3,11,14
1986_0,,,,2,2,1,3
C(C(C=C)C(C(CO)=O)O)=O,,,4,1,5,16,21
1988_0,,,,2,2,1,3
C(C(C=C)C(C=O)(CO)O)=O,,,4,1,3,14,17
1990_0,,,,2,2,1,3
C(C(C=C)C(C=O)(C)O)=O,,,4,1,5,18,23
1992_0,,,,2,2,1,3
C(C(C=C)C(C(C)=O)O)=O,,,4,1,12,27,39
1994_0,,,,2,2,1,3
C(C(C=C)CO)=O,,,4,1,3,132,135
1996_0,,,,2,2,1,3
C(C(C=C)C(C(O)=O)(CO)O)=O,,,4,1,4,12,16
1998_0,,,,2,2,1,3
C(C(C=C)C(C(O)=O)(C)O)=O,,,4,1,3,11,14
2000_0,,,,2,2,1,3
C(C(C=CC)(C(C=O)O)O)(O)=O,,,4,1,4,14,18
2000_1,,,,2,2,1,3
2002_0,,,,2,2,1,3
C(C(C=CC)(CC=O)O)(O)=O,,,4,1,4,12,16
2004_0,,,,2,2,1,3
C(C(C=CC)(CC(C=O)=O)O)(O)=O,,,4,1,1,9,10
2006_0,,,,2,2,1,3
C(C(CC=C)(C(C=O)O)O)(O)=O,,,4,1,4,14,18
2006_1,,,,2,2,1,3
2008_0,,,,2,2,1,3
C(C(CC=O)(CC=C)O)(O)=O,,,4,1,4,12,16
2010_0,,,,2,2,1,3
C(C(CC(C=O)=O)(CC=C)O)(O)=O,,,4,1,1,9,10
2012_0,,,,2,2,1,3
C=CC(C(C(O)=O)=O)C(CO)O,,,4,1,3,13,16
2014_0,,,,2,2,1,3
C=CC(C(C(O)=O)=O)C(C(C)O)O,,,4,1,1,11,12
2016_0,,,,2,2,1,3
C(C(C(C=C)C(C(O)=O)=O)O)(O)=O,,,4,1,3,10,13
2018_0,,,,2,2,1,3
C=CC(C(C(O)=O)=O)C(C)O,,,4,1,2,11,13
2020_0,,,,2,2,1,3
C(C(C=C)C(C(O)=O)=O)(O)=O,,,4,1,2,11,13
2022_0,,,,2,2,1,3
C(C(C)(C(C=C)C(C(O)=O)=O)O)=O,,,4,1,1,9,10
2024_0,,,,2,2,1,3
C(C)(C(C(C=C)C(C(O)=O)=O)O)=O,,,4,1,1,9,10
2026_0,,,,2,2,1,3
C=CC(C(C(O)=O)=O)CO,,,4,1,2,13,15
2028_0,,,,2,2,1,3
C(C(C(CC(C(O)=O)=C)O)O)=O,,,4,1,3,17,20
2028_1,,,,2,2,1,3
2030_0,,,,2,2,1,3
C(CC(CC(C(O)=O)=C)O)=O,,,4,1,4,14,18
2032_0,,,,2,2,1,3
C=C(C(O)=O)CC(CC(C=O)=O)O,,,4,1,1,9,10
2034_0,,,,2,2,1,3
C(C(C(C(O)=O)=C)C(CO)O)=O,,,4,1,3,14,17
2036_0,,,,2,2,1,3
C(C(C(C(O)=O)=C)C(C(C)O)O)=O,,,4,1,1,12,13
2038_0,,,,2,2,1,3
C(C(C(C(O)=O)=C)C(C(O)=O)O)=O,,,4,1,3,9,12
2040_0,,,,2,2,1,3
C(C(C(C(O)=O)=C)C(C)O)=O,,,4,1,3,13,16
2042_0,,,,2,2,1,3
C(C(C(O)=O)C(C(O)=O)=C)=O,,,4,1,4,12,16
2044_0,,,,2,2,1,3
C(C(C(C(O)=O)=C)C(C=O)(C)O)=O,,,4,1,1,9,10
2046_0,,,,2,2,1,3
C(C(C(C(O)=O)=C)C(C(C)=O)O)=O,,,4,1,1,9,10
2048_0,,,,2,2,1,3
C(C(C(C(O)=O)=C)CO)=O,,,4,1,3,17,20
2050_0,,,,2,2,1,3
C(C(C(C=C(C(O)=O)C)O)O)=O,,,4,1,3,12,15
2050_1,,,,2,2,1,3
2052_0,,,,2,2,1,3
C(CC(C=C(C(O)=O)C)O)=O,,,4,1,4,10,14
2054_0,,,,2,2,1,3
C(C(CC(C=O)=O)O)=C(C(O)=O)C,,,4,1,1,5,6
2056_0,,,,2,2,1,3
C1(C(C=C(C(O1)=O)C)(CC=O)O)=O,,,4,1,1,3,4
2058_0,,,,2,2,1,3
C1(C(CC=O)(CC(C(O1)=O)=C)O)=O,,,4,1,1,6,7
2060_0,,,,2,2,1,3
C=C1C(OC(C(C1C(C)O)=O)=O)=O,,,4,1,1,6,7
2062_0,,,,2,2,1,3
C(C1C(C(OC(C1=C)=O)=O)=O)(O)=O,,,4,1,1,5,6
2064_0,,,,2,2,1,3
C=C1C(OC(C(C1CO)=O)=O)=O,,,4,1,6,7,13
2066_0,,,,2,2,1,3
C(C(C(C(CO)O)O)O)=O,,,4,1,15,23,38
2066_1,,,,2,2,1,3
2068_0,,,,2,2,1,3
C(CC(C(CO)O)O)=O,,,4,1,10,30,40
2070_0,,,,2,2,1,3
C(C(C(C)O)C(C(CO)O)O)=O,,,4,1,7,16,23
2070_1,,,,2,2,1,3
2072_0,,,,2,2,1,3
C(C(C=O)C(C(CO)O)O)(O)=O,,,4,1,7,16,23
2072_1,,,,2,2,1,3
2074_0,,,,2,2,1,3
C(C(C(C(C(CO)O)O)O)=O)=O,,,4,1,5,20,25
2074_1,,,,2,2,1,3
2076_0,,,,2,2,1,3
C(C(CC(C(CO)O)O)=O)=O,,,4,1,5,19,24
2078_0,,,,2,2,1,3
C(C(C(C(C(CO)O)O)O)=O)(O)=O,,,4,1,7,17,24
2078_1,,,,2,2,1,3
2080_0,,,,2,2,1,3
C(C(CC(C(CO)O)O)=O)(O)=O,,,4,1,4,15,19
2082_0,,,,2,2,1,3
C(C1(C(C(C(O1)=O)=O)CO)O)(C)=O,,,4,1,3,9,12
2082_1,,,,2,2,1,3
2084_0,,,,2,2,1,3
C(C1(CC(C(O1)=O)=O)O)(CCO)=O,,,4,1,2,8,10
2086_0,,,,2,2,1,3
C1(C(C)(O)OC(C(C1CO)=O)=O)=O,,,4,1,3,5,8
2086_1,,,,2,2,1,3
2088_0,,,,2,2,1,3
C(C(C(CO)O)O)=O,,,4,1,26,79,105
2088_1,,,,2,2,1,3
2090_0,,,,2,2,1,3
C1(C(C(C(C)O1)C(CO)O)=O)=O,,,4,1,4,9,13
2090_1,,,,2,2,1,3
2092_0,,,,2,2,1,3
C1(C(C(C(O1)=O)=O)C(CO)O)=O,,,4,1,4,10,14
2092_1,,,,2,2,1,3
2094_0,,,,2,2,1,3
C(C(C(CO)O)C[CH]C(O)=O)=O,,,4,1,3,13,16
2096_0,,,,2,2,1,3
C(C(CCC(O)=O)C(CO)O)=O,,,4,1,3,13,16
2098_0,,,,2,2,1,3
C(CC(CO)O)=O,,,4,1,25,144,169
2100_0,,,,2,2,1,3
C(C(C(CO)O)C(C)O)=O,,,4,1,12,17,29
2100_1,,,,2,2,1,3
2102_0,,,,2,2,1,3
C(C(C(C(CO)O)C(C)O)=O)(O)=O,,,4,1,7,16,23
2102_1,,,,2,2,1,3
2104_0,,,,2,2,1,3
C(C(C=O)C(CO)O)(O)=O,,,4,1,14,16,30
2104_1,,,,2,2,1,3
2106_0,,,,2,2,1,3
C(C(C(CO)O)C(C(O)=O)(C)O)=O,,,4,1,8,15,23
2106_1,,,,2,2,1,3
2108_0,,,,2,2,1,3
C(C(C(C(O)=O)=O)C(CO)O)(O)=O,,,4,1,7,15,22
2108_1,,,,2,2,1,3
2110_0,,,,2,2,1,3
C(C(C(C(CO)O)O)=O)=O,,,4,1,17,24,41
2110_1,,,,2,2,1,3
2112_0,,,,2,2,1,3
C(C(CC(CO)O)=O)=O,,,4,1,14,34,48
2114_0,,,,2,2,1,3
C(C(C(C(CO)O)O)=O)(O)=O,,,4,1,12,15,27
2114_1,,,,2,2,1,3
2116_0,,,,2,2,1,3
C(C(CC(CO)O)=O)(O)=O,,,4,1,11,18,29
2118_0,,,,2,2,1,3
C1(C(CC(C)O1)(C(C=O)O)O)=O,,,4,1,4,10,14
2118_1,,,,2,2,1,3
2120_0,,,,2,2,1,3
C1(CC(C(O1)=O)(C(C=O)O)O)=O,,,4,1,4,11,15
2120_1,,,,2,2,1,3
2122_0,,,,2,2,1,3
C(C(C(CC[CH]C(O)=O)O)O)=O,,,4,1,3,14,17
2122_1,,,,2,2,1,3
2124_0,,,,2,2,1,3
C(CCCC(C(C=O)O)O)(O)=O,,,4,1,3,14,17
2124_1,,,,2,2,1,3
2126_0,,,,2,2,1,3
C(C(C(C(C)O)O)O)=O,,,4,1,14,33,47
2126_1,,,,2,2,1,3
2128_0,,,,2,2,1,3
C(C(C(C=O)O)O)(O)=O,,,4,1,28,43,71
2128_1,,,,2,2,1,3
2130_0,,,,2,2,1,3
C(C(C(C)O)O)=O,,,4,1,11,147,158
2130_1,,,,2,2,1,3
2131_0,,,,2,2,1,3
2131_1,,,,2,2,1,3
2133_0,,,,2,2,1,3
C(C(C(CC(C)O)O)O)=O,,,4,1,10,21,31
2133_1,,,,2,2,1,3
2135_0,,,,2,2,1,3
C(C(CC(C)O)(C(C=O)O)O)(O)=O,,,4,1,6,14,20
2135_1,,,,2,2,1,3
2137_0,,,,2,2,1,3
C(CC(C(C=O)O)O)(O)=O,,,4,1,14,23,37
2137_1,,,,2,2,1,3
2139_0,,,,2,2,1,3
C(C(C)(CC(C(C=O)O)O)O)(O)=O,,,4,1,6,16,22
2139_1,,,,2,2,1,3
2141_0,,,,2,2,1,3
C(CC(C(O)=O)(C(C=O)O)O)(O)=O,,,4,1,4,13,17
2141_1,,,,2,2,1,3
2142_0,,,,2,2,1,3
2142_1,,,,2,2,1,3
2144_0,,,,2,2,1,3
C(C(CO)(C(C=O)O)O)=O,,,4,1,15,26,41
2144_1,,,,2,2,1,3
2146_0,,,,2,2,1,3
C(C(C)(C(C=O)O)O)=O,,,4,1,14,33,47
2146_1,,,,2,2,1,3
2147_0,,,,2,2,1,3
2147_1,,,,2,2,1,3
2148_0,,,,2,2,1,3
2148_1,,,,2,2,1,3
2150_0,,,,2,2,1,3
C(C(CO)(C(C=O)O)O)(O)=O,,,4,1,14,18,32
2150_1,,,,2,2,1,3
2152_0,,,,2,2,1,3
C(C(C)(C(C=O)O)O)(O)=O,,,4,1,10,19,29
2152_1,,,,2,2,1,3
2154_0,,,,2,2,1,3
C1(C(CC(C)O1)(CC=O)O)=O,,,4,1,4,8,12
2156_0,,,,2,2,1,3
C1(C(CC(C)O1)(CC(C=O)=O)O)=O,,,4,1,1,6,7
2158_0,,,,2,2,1,3
C1(C(C(C(C)O1)C(C(C)O)O)=O)=O,,,4,1,2,9,11
2158_1,,,,2,2,1,3
2160_0,,,,2,2,1,3
C(C(C1C(C(OC1C)=O)=O)O)(O)=O,,,4,1,4,8,12
2160_1,,,,2,2,1,3
2162_0,,,,2,2,1,3
C1(C(C(C(C)O1)C(C)O)=O)=O,,,4,1,4,7,11
2162_1,,,,2,2,1,3
2164_0,,,,2,2,1,3
C(C1C(C(OC1C)=O)=O)(O)=O,,,4,1,4,5,9
2164_1,,,,2,2,1,3
2166_0,,,,2,2,1,3
C(C(C)(C1C(C(OC1C)=O)=O)O)=O,,,4,1,2,6,8
2166_1,,,,2,2,1,3
2168_0,,,,2,2,1,3
C(C(C1C(C(OC1C)=O)=O)O)(C)=O,,,4,1,2,6,8
2168_1,,,,2,2,1,3
2170_0,,,,2,2,1,3
C1(C(C(CO)C(C)O1)=O)=O,,,4,1,4,9,13
2170_1,,,,2,2,1,3
2172_0,,,,2,2,1,3
C1(CC(C(O1)=O)(CC=O)O)=O,,,4,1,4,9,13
2174_0,,,,2,2,1,3
C1(CC(C(O1)=O)(CC(C=O)=O)O)=O,,,4,1,1,7,8
2176_0,,,,2,2,1,3
C1(C(C(C(O1)=O)=O)C(C(C)O)O)=O,,,4,1,2,10,12
2176_1,,,,2,2,1,3
2178_0,,,,2,2,1,3
C1(C(C(C(O1)=O)=O)C(C(O)=O)O)=O,,,4,1,4,9,13
2178_1,,,,2,2,1,3
2180_0,,,,2,2,1,3
C1(C(C(C(O1)=O)=O)C(C)O)=O,,,4,1,4,7,11
2180_1,,,,2,2,1,3
2182_0,,,,2,2,1,3
C1(C(C(O)=O)C(C(O1)=O)=O)=O,,,4,1,4,5,9
2182_1,,,,2,2,1,3
2184_0,,,,2,2,1,3
C1(C(C(C(O1)=O)=O)C(C=O)(C)O)=O,,,4,1,2,6,8
2184_1,,,,2,2,1,3
2186_0,,,,2,2,1,3
C1(C(C(C(O1)=O)=O)C(C(C)=O)O)=O,,,4,1,2,6,8
2186_1,,,,2,2,1,3
2188_0,,,,2,2,1,3
C1(C(C(C(O1)=O)=O)CO)=O,,,4,1,5,9,14
2188_1,,,,2,2,1,3
2189_0,,,,2,2,1,3
2189_1,,,,2,2,1,3
2190_0,,,,2,2,1,3
2190_1,,,,2,2,1,3
2192_0,,,,2,2,1,3
C(C(CO)C(C)(C[CH]C(O)=O)O)=O,,,4,1,5,13,18
2192_1,,,,2,2,1,3
2194_0,,,,2,2,1,3
C(C(CO)C(C)(CCC(O)=O)O)=O,,,4,1,5,13,18
2194_1,,,,2,2,1,3
2196_0,,,,2,2,1,3
C(C(CC[CH]C(O)=O)(CC=O)O)=O,,,4,1,2,8,10
2198_0,,,,2,2,1,3
C(CC(C(CC[CH]C(O)=O)=O)O)=O,,,4,1,2,9,11
2200_0,,,,2,2,1,3
[CH](C(O)=O)CC(C(C=O)=O)C(C)O,,,4,1,2,11,13
2202_0,,,,2,2,1,3
C(C(C(C=O)=O)C[CH]C(O)=O)(O)=O,,,4,1,2,10,12
2204_0,,,,2,2,1,3
[CH](C(O)=O)CC(C(C=O)=O)CO,,,4,1,2,14,16
2206_0,,,,2,2,1,3
C(CCCC(C=O)(CC=O)O)(O)=O,,,4,1,2,8,10
2208_0,,,,2,2,1,3
C(CCCC(C(CC=O)O)=O)(O)=O,,,4,1,2,9,11
2210_0,,,,2,2,1,3
C(CCC(C(C=O)=O)C(C)O)(O)=O,,,4,1,2,11,13
2212_0,,,,2,2,1,3
C(C(C(C=O)=O)CCC(O)=O)(O)=O,,,4,1,2,10,12
2214_0,,,,2,2,1,3
C(CCC(C(C=O)=O)CO)(O)=O,,,4,1,2,14,16
2215_0,,,,2,2,1,3
2217_0,,,,2,2,1,3
[CH](C(O)=O)CCC(CC(C=O)=O)O,,,4,1,2,8,10
2219_0,,,,2,2,1,3
C(C(C(C(C)O)O)C[CH]C(O)=O)=O,,,4,1,2,12,14
2221_0,,,,2,2,1,3
C(C(C(C=O)C[CH]C(O)=O)O)(O)=O,,,4,1,5,11,16
2222_0,,,,2,2,1,3
2223_0,,,,2,2,1,3
2225_0,,,,2,2,1,3
C(C(C)(C(C=O)C[CH]C(O)=O)O)=O,,,4,1,2,10,12
2227_0,,,,2,2,1,3
C(C(C[CH]C(O)=O)C(C(C)=O)O)=O,,,4,1,2,10,12
2229_0,,,,2,2,1,3
C(C(CO)C[CH]C(O)=O)=O,,,4,1,6,13,19
2231_0,,,,2,2,1,3
[CH](C(O)=O)CC(C(C(O)=O)=O)CO,,,4,1,3,11,14
2232_0,,,,2,2,1,3
2234_0,,,,2,2,1,3
C(CCCC(CC(C=O)=O)O)(O)=O,,,4,1,2,8,10
2236_0,,,,2,2,1,3
C(C(CCC(O)=O)C(C(C)O)O)=O,,,4,1,2,12,14
2238_0,,,,2,2,1,3
C(CCC(C=O)C(C(O)=O)O)(O)=O,,,4,1,5,11,16
2239_0,,,,2,2,1,3
2240_0,,,,2,2,1,3
2242_0,,,,2,2,1,3
C(CCC(C=O)C(C=O)(C)O)(O)=O,,,4,1,2,10,12
2244_0,,,,2,2,1,3
C(CCC(C=O)C(C(C)=O)O)(O)=O,,,4,1,2,10,12
2246_0,,,,2,2,1,3
C(C(CCC(O)=O)CO)=O,,,4,1,7,13,20
2248_0,,,,2,2,1,3
C(CCC(C(C(O)=O)=O)CO)(O)=O,,,4,1,3,11,14
2250_0,,,,2,2,1,3
C(CC(C(C)O)O)=O,,,4,1,14,79,93
2252_0,,,,2,2,1,3
C(C(C(C)O)C(C(C)O)O)=O,,,4,1,7,15,22
2252_1,,,,2,2,1,3
2254_0,,,,2,2,1,3
C(C(C=O)C(C(C)O)O)(O)=O,,,4,1,7,14,21
2254_1,,,,2,2,1,3
2256_0,,,,2,2,1,3
C(C(C(C(C(C)O)O)O)=O)=O,,,4,1,6,19,25
2256_1,,,,2,2,1,3
2258_0,,,,2,2,1,3
C(C(CC(C(C)O)O)=O)=O,,,4,1,11,22,33
2260_0,,,,2,2,1,3
C(C(C(C(C(C)O)O)O)=O)(O)=O,,,4,1,5,14,19
2260_1,,,,2,2,1,3
2262_0,,,,2,2,1,3
C(C(CC(C(C)O)O)=O)(O)=O,,,4,1,4,14,18
2264_0,,,,2,2,1,3
C(C(CC=O)O)(O)=O,,,4,1,25,88,113
2266_0,,,,2,2,1,3
C(C(C(C)O)C(C(O)=O)O)=O,,,4,1,11,16,27
2266_1,,,,2,2,1,3
2268_0,,,,2,2,1,3
C(C(C=O)C(C(O)=O)O)(O)=O,,,4,1,11,14,25
2268_1,,,,2,2,1,3
2270_0,,,,2,2,1,3
C(C(C(C(C=O)=O)O)O)(O)=O,,,4,1,12,21,33
2270_1,,,,2,2,1,3
2272_0,,,,2,2,1,3
C(C(CC(C=O)=O)O)(O)=O,,,4,1,16,24,40
2274_0,,,,2,2,1,3
C(C(C(C(C(O)=O)=O)O)O)(O)=O,,,4,1,8,14,22
2274_1,,,,2,2,1,3
2276_0,,,,2,2,1,3
C(C(CC(C(O)=O)=O)O)(O)=O,,,4,1,10,14,24
2278_0,,,,2,2,1,3
C(C(C(C(CC(C)O)O)O)O)(O)=O,,,4,1,7,12,19
2278_1,,,,2,2,1,3
2280_0,,,,2,2,1,3
C(C(CC(CC(C)O)O)O)(O)=O,,,4,1,6,9,15
2280_1,,,,2,2,1,3
2282_0,,,,2,2,1,3
C(CC(C(C(C(O)=O)O)O)O)(O)=O,,,4,1,8,12,20
2282_1,,,,2,2,1,3
2284_0,,,,2,2,1,3
C(CC(CC(C(O)=O)O)O)(O)=O,,,4,1,7,8,15
2284_1,,,,2,2,1,3
2285_0,,,,2,2,1,3
2285_1,,,,2,2,1,3
2287_0,,,,2,2,1,3
C(C(CC(C(CO)=O)O)O)(O)=O,,,4,1,7,10,17
2287_1,,,,2,2,1,3
2289_0,,,,2,2,1,3
C(C(CO)(C(C(C(O)=O)O)O)O)=O,,,4,1,12,18,30
2289_1,,,,2,2,1,3
2291_0,,,,2,2,1,3
C(C(CO)(CC(C(O)=O)O)O)=O,,,4,1,6,13,19
2291_1,,,,2,2,1,3
2293_0,,,,2,2,1,3
C(C(C)(C(C(C(O)=O)O)O)O)=O,,,4,1,8,14,22
2293_1,,,,2,2,1,3
2294_0,,,,2,2,1,3
2294_1,,,,2,2,1,3
2296_0,,,,2,2,1,3
C(C(C(CO)O)O)(O)=O,,,4,1,17,23,40
2296_1,,,,2,2,1,3
2297_0,,,,2,2,1,3
2297_1,,,,2,2,1,3
2298_0,,,,2,2,1,3
2298_1,,,,2,2,1,3
2299_0,,,,2,2,1,3
2299_1,,,,2,2,1,3
2301_0,,,,2,2,1,3
C(C(C)(CC(C(O)=O)O)O)=O,,,4,1,6,11,17
2301_1,,,,2,2,1,3
2303_0,,,,2,2,1,3
C(C(CC(C(C)=O)O)O)(O)=O,,,4,1,6,12,18
2303_1,,,,2,2,1,3
2305_0,,,,2,2,1,3
C(C(CCO)O)(O)=O,,,4,1,13,35,48
2305_1,,,,2,2,1,3
2307_0,,,,2,2,1,3
C(C(CO)(CC(C(O)=O)O)O)(O)=O,,,4,1,8,11,19
2307_1,,,,2,2,1,3
2308_0,,,,2,2,1,3
2308_1,,,,2,2,1,3
2309_0,,,,2,2,1,3
2309_1,,,,2,2,1,3
2310_0,,,,2,2,1,3
2310_1,,,,2,2,1,3
2311_0,,,,2,2,1,3
2312_0,,,,2,2,1,3
2313_0,,,,2,2,1,3
2314_0,,,,2,2,1,3
2315_0,,,,2,2,1,3
2316_0,,,,2,2,1,3
2317_0,,,,2,2,1,3
2318_0,,,,2,2,1,3
2319_0,,,,2,2,1,3
2319_1,,,,2,2,1,3
2320_0,,,,2,2,1,3
2321_0,,,,2,2,1,3
2322_0,,,,2,2,1,3
2323_0,,,,2,2,1,3
2323_1,,,,2,2,1,3
2324_0,,,,2,2,1,3
2324_1,,,,2,2,1,3
2325_0,,,,2,2,1,3
2325_1,,,,2,2,1,3
2326_0,,,,2,2,1,3
2326_1,,,,2,2,1,3
2328_0,,,,2,1,2,3
C1(C(CC(C(C1)=O)=O)=O)=O,,,4,1,1,14,15
2330_0,,,,2,1,2,3
C(C(C(C(CO)=O)=O)C(C)O)=O,,,4,1,3,15,18
2331_0,,,,2,1,2,3
2332_0,,,,2,1,2,3
2334_0,,,,2,1,2,3
C(C(C=O)C(C(CO)=O)=O)(O)=O,,,4,1,4,14,18
2335_0,,,,2,1,2,3
2336_0,,,,2,1,2,3
2337_0,,,,2,1,2,3
2338_0,,,,2,1,2,3
2340_0,,,,2,1,2,3
C(C(C(C(C(CO)=O)=O)O)=O)=O,,,4,1,1,18,19
2342_0,,,,2,1,2,3
C(C(C(C=O)=O)=O)=O,,,4,1,2,41,43
2344_0,,,,2,1,2,3
C(C(C(C(C(C)=O)=O)O)=O)=O,,,4,1,3,16,19
2346_0,,,,2,1,2,3
C(C(CC(C(CO)=O)=O)=O)=O,,,4,1,2,20,22
2348_0,,,,2,1,2,3
C(C(CC(C(C)=O)=O)=O)=O,,,4,1,5,29,34
2350_0,,,,2,1,2,3
C(CC(C(CO)=O)=O)=O,,,4,1,9,45,54
2352_0,,,,2,1,2,3
C(C(CC(C(CO)=O)=O)=O)(O)=O,,,4,1,3,14,17
2354_0,,,,2,1,2,3
C(C(C(C(O)=O)=O)=O)=O,,,4,1,7,18,25
2356_0,,,,2,1,2,3
C(C(C(C(C(C)=O)=O)O)=O)(O)=O,,,4,1,4,11,15
2358_0,,,,2,1,2,3
C(C(C(C(CO)=O)=O)=O)(C)=O,,,4,1,2,14,16
2359_0,,,,2,1,2,3
2361_0,,,,2,1,2,3
C(C(C(C(C)=O)=O)=O)(C)=O,,,4,1,1,11,12
2362_0,,,,2,1,2,3
2363_0,,,,2,1,2,3
2365_0,,,,2,1,2,3
C(C(C=O)=O)=O,,,4,1,51,210,261
2367_0,,,,2,1,2,3
C(C(C)=O)(CCO)=O,,,4,1,13,108,121
2369_0,,,,2,1,2,3
C(CC(C(C)=O)=O)(O)=O,,,4,1,6,32,38
2371_0,,,,2,1,2,3
C(C(CO)=O)(C(CC(C)O)O)=O,,,4,1,2,10,12
2373_0,,,,2,1,2,3
C(CC(C(C(CO)=O)=O)O)(O)=O,,,4,1,2,9,11
2375_0,,,,2,1,2,3
C(CO)(C(C(C(CO)=O)=O)O)=O,,,4,1,4,14,18
2377_0,,,,2,1,2,3
C(C(C(C(CO)=O)=O)(CO)O)=O,,,4,1,2,14,16
2379_0,,,,2,1,2,3
C(C(C(C(CO)=O)=O)(C)O)=O,,,4,1,2,12,14
2381_0,,,,2,1,2,3
C(C)(C(C(C(CO)=O)=O)O)=O,,,4,1,3,16,19
2383_0,,,,2,1,2,3
C(C(CO)=O)(CO)=O,,,4,1,7,61,68
2385_0,,,,2,1,2,3
C(C(C(CC(C)O)O)=O)=O,,,4,1,3,17,20
2387_0,,,,2,1,2,3
C(C(C)=O)(C(CC(C)O)O)=O,,,4,1,1,11,12
2389_0,,,,2,1,2,3
C(CC(C(C=O)=O)O)(O)=O,,,4,1,3,18,21
2391_0,,,,2,1,2,3
C(CC(C(C(C)=O)=O)O)(O)=O,,,4,1,2,10,12
2393_0,,,,2,1,2,3
C(CO)(C(C(C=O)=O)O)=O,,,4,1,6,28,34
2395_0,,,,2,1,2,3
C(CO)(C(C(C(C)=O)=O)O)=O,,,4,1,3,16,19
2397_0,,,,2,1,2,3
C(C(C(C=O)=O)(CO)O)=O,,,4,1,3,16,19
2399_0,,,,2,1,2,3
C(C(C(C(C)=O)=O)(CO)O)=O,,,4,1,1,12,13
2401_0,,,,2,1,2,3
C(C(C(C=O)=O)(C)O)=O,,,4,1,3,19,22
2403_0,,,,2,1,2,3
C(C(C(C(C)=O)=O)(C)O)=O,,,4,1,2,13,15
2405_0,,,,2,1,2,3
C(C)(C(C(C=O)=O)O)=O,,,4,1,4,39,43
2407_0,,,,2,1,2,3
C(C)(C(C(C(C)=O)=O)O)=O,,,4,1,3,23,26
2409_0,,,,2,1,2,3
C(C(CO)=O)(C)=O,,,4,1,23,215,238
2411_0,,,,2,1,2,3
C(C(C(C(CO)=O)=O)O)(O)=O,,,4,1,4,14,18
2413_0,,,,2,1,2,3
C(C(C(C=O)=O)(CO)O)(O)=O,,,4,1,7,14,21
2415_0,,,,2,1,2,3
C(C(C(C)O)=O)=O,,,4,1,12,145,157
2417_0,,,,2,1,2,3
C(C(C(O)=O)=O)=O,,,4,1,38,95,133
2419_0,,,,2,1,2,3
C(C(C(C(C)=O)=O)O)(O)=O,,,4,1,9,19,28
2421_0,,,,2,1,2,3
C(C(C(C=O)=O)(C)O)(O)=O,,,4,1,5,12,17
2423_0,,,,2,1,2,3
C(C(C(C)=O)=O)=O,,,4,1,5,213,218
2425_0,,,,2,1,2,3
C(CC(C(C(C)=O)=O)=O)(O)=O,,,4,1,2,11,13
2427_0,,,,2,1,2,3
C(C(C(C(C=O)=O)=O)C)(O)=O,,,4,1,4,11,15
2429_0,,,,2,1,2,3
C=CC(C(CO)=O)=O,,,4,1,3,122,125
2431_0,,,,2,1,2,3
C=C(C(O)=O)C(C(CO)=O)=O,,,4,1,3,12,15
2433_0,,,,2,1,2,3
C=CC(C(C)=O)=O,,,4,1,5,291,296
2435_0,,,,2,1,2,3
C=C(C(O)=O)C(C(C)=O)=O,,,4,1,3,18,21
2437_0,,,,2,1,2,3
C=C(C(O)=O)C(C(C=O)=O)O,,,4,1,3,13,16
2438_0,,,,2,1,2,3
2439_0,,,,2,1,2,3
2441_0,,,,2,1,2,3
[C](C(O)=O)=CC(C(C)=O)=O,,,4,1,2,21,23
2443_0,,,,2,1,2,3
C(C=CC(C(C)=O)=O)(O)=O,,,4,1,3,21,24
2445_0,,,,2,1,2,3
C(C(C=C(C(O)=O)C)=O)=O,,,4,1,4,18,22
2447_0,,,,2,1,2,3
C=C(C(O)=O)CC(C=O)=O,,,4,1,3,21,24
2448_0,,,,2,1,2,3
2450_0,,,,2,1,2,3
C(C(C)=O)(C(CO)O)=O,,,4,1,7,36,43
2451_0,,,,2,1,2,3
2453_0,,,,2,1,2,3
C1(C(C(C(CO1)=O)=O)(C)O)=O,,,4,1,2,5,7
2455_0,,,,2,1,2,3
C(C(C[CH]C(O)=O)=O)=O,,,4,1,3,28,31
2457_0,,,,2,1,2,3
C(CCC(C=O)=O)(O)=O,,,4,1,6,22,28
2458_0,,,,2,1,2,3
2460_0,,,,2,1,2,3
[CH](C(O)=O)CC(C(CO)=O)=O,,,4,1,2,10,12
2461_0,,,,2,1,2,3
2463_0,,,,2,1,2,3
[CH](C(O)=O)CC(C(C)=O)=O,,,4,1,2,18,20
2464_0,,,,2,1,2,3
2466_0,,,,2,1,2,3
C(CCC(C(CO)=O)=O)(O)=O,,,4,1,4,10,14
2467_0,,,,2,1,2,3
2469_0,,,,2,1,2,3
C(CCC(C(C)=O)=O)(O)=O,,,4,1,3,13,16
2470_0,,,,2,1,2,3
2471_0,,,,2,1,2,3
2472_0,,,,2,1,1,2
2473_0,,,,2,1,2,3
2473_1,,,,2,1,2,3
2474_0,,,,2,1,2,3
2474_1,,,,2,1,2,3
2475_0,,,,2,1,2,3
2475_1,,,,2,1,2,3
2476_0,,,,2,1,2,3
2476_1,,,,2,1,2,3
2478_0,,,,2,1,2,3
C(C(CC(C)O)O)=O,,,4,1,16,61,77
2479_0,,,,2,1,2,3
2479_1,,,,2,1,2,3
2480_0,,,,2,1,2,3
2481_0,,,,2,1,2,3
2481_1,,,,2,1,2,3
2482_0,,,,2,1,2,3
2483_0,,,,2,1,2,3
2484_0,,,,2,1,2,3
2484_1,,,,2,1,2,3
2485_0,,,,2,1,2,3
2485_1,,,,2,1,2,3
2486_0,,,,2,1,2,3
2486_1,,,,2,1,2,3
2487_0,,,,2,1,2,3
2487_1,,,,2,1,2,3
2488_0,,,,2,1,2,3
2488_1,,,,2,1,2,3
2489_0,,,,2,1,2,3
2489_1,,,,2,1,2,3
2490_0,,,,2,1,2,3
2490_1,,,,2,1,2,3
2491_0,,,,2,1,2,3
2491_1,,,,2,1,2,3
2492_0,,,,2,1,2,3
2492_1,,,,2,1,2,3
2493_0,,,,2,1,2,3
2493_1,,,,2,1,2,3
2494_0,,,,2,1,2,3
2494_1,,,,2,1,2,3
2495_0,,,,2,1,2,3
2495_1,,,,2,1,2,3
2496_0,,,,2,1,2,3
2496_1,,,,2,1,2,3
2497_0,,,,2,1,2,3
2497_1,,,,2,1,2,3
2498_0,,,,2,1,2,3
2498_1,,,,2,1,2,3
2499_0,,,,2,1,2,3
2499_1,,,,2,1,2,3
2500_0,,,,2,1,2,3
2500_1,,,,2,1,2,3
2501_0,,,,2,1,2,3
2501_1,,,,2,1,2,3
2502_0,,,,2,1,2,3
2502_1,,,,2,1,2,3
2503_0,,,,2,1,2,3
2503_1,,,,2,1,2,3
2504_0,,,,2,1,2,3
2505_0,,,,2,1,2,3
2505_1,,,,2,1,2,3
2506_0,,,,2,1,2,3
2506_1,,,,2,1,2,3
2507_0,,,,2,1,2,3
2507_1,,,,2,1,2,3
2508_0,,,,2,1,2,3
2508_1,,,,2,1,2,3
2509_0,,,,2,1,2,3
2509_1,,,,2,1,2,3
2510_0,,,,2,1,2,3
2510_1,,,,2,1,2,3
2511_0,,,,2,1,2,3
2511_1,,,,2,1,2,3
2513_0,,,,2,1,2,3
C(CC(C=O)O)(O)=O,,,4,1,25,69,94
2514_0,,,,2,1,2,3
2514_1,,,,2,1,2,3
2515_0,,,,2,1,2,3
2516_0,,,,2,1,2,3
2516_1,,,,2,1,2,3
2517_0,,,,2,1,2,3
2518_0,,,,2,1,2,3
2519_0,,,,2,1,2,3
2519_1,,,,2,1,2,3
2520_0,,,,2,1,2,3
2520_1,,,,2,1,2,3
2521_0,,,,2,1,2,3
2521_1,,,,2,1,2,3
2522_0,,,,2,1,2,3
2522_1,,,,2,1,2,3
2523_0,,,,2,1,2,3
2523_1,,,,2,1,2,3
2524_0,,,,2,1,2,3
2524_1,,,,2,1,2,3
2525_0,,,,2,1,2,3
2525_1,,,,2,1,2,3
2526_0,,,,2,1,2,3
2526_1,,,,2,1,2,3
2527_0,,,,2,1,2,3
2527_1,,,,2,1,2,3
2528_0,,,,2,1,2,3
2528_1,,,,2,1,2,3
2529_0,,,,2,1,2,3
2529_1,,,,2,1,2,3
2530_0,,,,2,1,2,3
2530_1,,,,2,1,2,3
2531_0,,,,2,1,2,3
2531_1,,,,2,1,2,3
2532_0,,,,2,1,2,3
2532_1,,,,2,1,2,3
2533_0,,,,2,1,2,3
2533_1,,,,2,1,2,3
2534_0,,,,2,1,2,3
2534_1,,,,2,1,2,3
2535_0,,,,2,1,2,3
2536_0,,,,2,1,2,3
2536_1,,,,2,1,2,3
2537_0,,,,2,1,2,3
2537_1,,,,2,1,2,3
2538_0,,,,2,1,2,3
2539_0,,,,2,1,2,3
2539_1,,,,2,1,2,3
2540_0,,,,2,1,2,3
2540_1,,,,2,1,2,3
2541_0,,,,2,1,2,3
2541_1,,,,2,1,2,3
2542_0,,,,2,1,2,3
2542_1,,,,2,1,2,3
2543_0,,,,2,1,2,3
2545_0,,,,2,1,2,3
C(C(C(CO)=O)O)=O,,,4,1,10,123,133
2546_0,,,,2,1,2,3
2546_1,,,,2,1,2,3
2547_0,,,,2,1,2,3
2547_1,,,,2,1,2,3
2548_0,,,,2,1,2,3
2549_0,,,,2,1,2,3
2549_1,,,,2,1,2,3
2550_0,,,,2,1,2,3
2550_1,,,,2,1,2,3
2551_0,,,,2,1,2,3
2552_0,,,,2,1,2,3
2554_0,,,,2,1,2,3
C(C(C=O)(CO)O)=O,,,4,1,8,28,36
2555_0,,,,2,1,2,3
2555_1,,,,2,1,2,3
2556_0,,,,2,1,2,3
2556_1,,,,2,1,2,3
2556_2,,,,2,1,2,3
2557_0,,,,2,1,2,3
2557_1,,,,2,1,2,3
2557_2,,,,2,1,2,3
2558_0,,,,2,1,2,3
2559_0,,,,2,1,2,3
2559_1,,,,2,1,2,3
2560_0,,,,2,1,2,3
2560_1,,,,2,1,2,3
2561_0,,,,2,1,2,3
2561_1,,,,2,1,2,3
2561_2,,,,2,1,2,3
2562_0,,,,2,1,2,3
2562_1,,,,2,1,2,3
2562_2,,,,2,1,2,3
2563_0,,,,2,1,2,3
2564_0,,,,2,1,2,3
2564_1,,,,2,1,2,3
2565_0,,,,2,1,2,3
2566_0,,,,2,1,2,3
2566_1,,,,2,1,2,3
2567_0,,,,2,1,2,3
2567_1,,,,2,1,2,3
2569_0,,,,2,1,2,3
C(C(C=O)(C)O)=O,,,4,1,9,53,62
2570_0,,,,2,1,2,3
2570_1,,,,2,1,2,3
2571_0,,,,2,1,2,3
2571_1,,,,2,1,2,3
2573_0,,,,2,1,2,3
C(C(C(C)=O)O)=O,,,4,1,15,217,232
2574_0,,,,2,1,2,3
2574_1,,,,2,1,2,3
2575_0,,,,2,1,2,3
2576_0,,,,2,1,2,3
2576_1,,,,2,1,2,3
2578_0,,,,2,1,2,3
C(C(C=O)(CO)O)(O)=O,,,4,1,10,12,22
2579_0,,,,2,1,2,3
2579_1,,,,2,1,2,3
2580_0,,,,2,1,2,3
2581_0,,,,2,1,2,3
2581_1,,,,2,1,2,3
2582_0,,,,2,1,2,3
2583_0,,,,2,1,2,3
2583_1,,,,2,1,2,3
2584_0,,,,2,1,2,3
2585_0,,,,2,1,2,3
2585_1,,,,2,1,2,3
2586_0,,,,2,1,2,3
2587_0,,,,2,1,2,3
2587_1,,,,2,1,2,3
2588_0,,,,2,1,2,3
2588_1,,,,2,1,2,3
2589_0,,,,2,1,2,3
2590_0,,,,2,1,2,3
2591_0,,,,2,1,2,3
2592_0,,,,2,1,2,3
2592_1,,,,2,1,2,3
2593_0,,,,2,1,2,3
2593_1,,,,2,1,2,3
2594_0,,,,2,1,2,3
2595_0,,,,2,1,2,3
2596_0,,,,2,1,2,3
2597_0,,,,2,1,2,3
2598_0,,,,2,1,2,3
2599_0,,,,2,1,2,3
2599_1,,,,2,1,2,3
2600_0,,,,2,1,2,3
2601_0,,,,2,1,2,3
2602_0,,,,2,1,2,3
2602_1,,,,2,1,2,3
2603_0,,,,2,1,1,2
2603_1,,,,2,1,1,2
2604_0,,,,2,1,2,3
2604_1,,,,2,1,2,3
2605_0,,,,2,1,2,3
2605_1,,,,2,1,2,3
2606_0,,,,2,1,2,3
2607_0,,,,2,1,2,3
2608_0,,,,2,1,2,3
2609_0,,,,2,1,2,3
2610_0,,,,2,1,2,3
2610_1,,,,2,1,2,3
2611_0,,,,2,1,2,3
2611_1,,,,2,1,2,3
2612_0,,,,2,1,2,3
2612_1,,,,2,1,2,3
2613_0,,,,2,1,2,3
2614_0,,,,2,1,2,3
2615_0,,,,2,1,2,3
2615_1,,,,2,1,2,3
2616_0,,,,2,1,2,3
2617_0,,,,2,1,2,3
2617_1,,,,2,1,2,3
2617_2,,,,2,1,2,3
2618_0,,,,2,1,2,3
2619_0,,,,2,1,2,3
2620_0,,,,2,1,2,3
2621_0,,,,2,1,2,3
2622_0,,,,2,1,2,3
2623_0,,,,2,1,2,3
2624_0,,,,2,1,2,3
2624_1,,,,2,1,2,3
2625_0,,,,2,1,2,3
2626_0,,,,2,1,2,3
2627_0,,,,2,1,2,3
2628_0,,,,2,1,2,3
2628_1,,,,2,1,2,3
2631_0,,,,2,1,2,3
C(C(C)=O)(C)=O,,,4,1,16,210,226
[C](C(O)=O)=O,,,4,1,11,245,256
2632_0,,,,2,1,2,3
2633_0,,,,2,1,2,3
2633_1,,,,2,1,2,3
2634_0,,,,2,1,2,3
2634_1,,,,2,1,2,3
2635_0,,,,2,1,2,3
2635_1,,,,2,1,2,3
2635_2,,,,2,1,2,3
2636_0,,,,2,1,2,3
2636_1,,,,2,1,2,3
2636_2,,,,2,1,2,3
2637_0,,,,2,1,2,3
2637_1,,,,2,1,2,3
2638_0,,,,2,1,2,3
2638_1,,,,2,1,2,3
2639_0,,,,2,1,2,3
2639_1,,,,2,1,2,3
2640_0,,,,2,1,2,3
2640_1,,,,2,1,2,3
2641_0,,,,2,1,2,3
2641_1,,,,2,1,2,3
2641_2,,,,2,1,2,3
2642_0,,,,2,1,2,3
2642_1,,,,2,1,2,3
2642_2,,,,2,1,2,3
2643_0,,,,2,1,2,3
2643_1,,,,2,1,2,3
2643_2,,,,2,1,2,3
2644_0,,,,2,1,2,3
2644_1,,,,2,1,2,3
2644_2,,,,2,1,2,3
2645_0,,,,2,1,2,3
2645_1,,,,2,1,2,3
2646_0,,,,2,1,2,3
2646_1,,,,2,1,2,3
2647_0,,,,2,1,2,3
2647_1,,,,2,1,2,3
2648_0,,,,2,1,2,3
2648_1,,,,2,1,2,3
2649_0,,,,2,1,2,3
2651_0,,,,2,1,2,3
C(CC(C)=O)(O)=O,,,4,1,6,171,177
2651_1,,,,2,1,2,3
2653_0,,,,2,1,2,3
C(C)(CCO)=O,,,4,1,3,430,433
2653_1,,,,2,1,2,3
2655_0,,,,2,1,2,3
C(C)(CC)=O,,,4,1,2,799,801
2655_1,,,,2,1,2,3
2657_0,,,,2,1,2,3
C(C(C(C)=O)(C)O)(O)=O,,,4,1,5,15,20
2657_1,,,,2,1,2,3
2659_0,,,,2,1,2,3
C(CC(C(C)O)=O)(O)=O,,,4,1,5,30,35
2661_0,,,,2,1,2,3
C(C(C(CO)=O)C)(O)=O,,,4,1,5,29,34
2661_1,,,,2,1,2,3
2663_0,,,,2,1,2,3
C(C(C(CC)=O)O)(O)=O,,,4,1,8,29,37
2663_1,,,,2,1,2,3
2665_0,,,,2,1,2,3
C(CO)(CC(C(O)=O)=O)=O,,,4,1,6,23,29
2665_1,,,,2,1,2,3
2666_0,,,,2,1,2,3
2666_1,,,,2,1,2,3
2667_0,,,,2,1,1,2
2668_0,,,,2,1,2,3
2669_0,,,,2,1,2,3
2670_0,,,,2,1,2,3
2671_0,,,,2,1,2,3
2673_0,,,,2,1,2,3
C(C)(C[CH]C(O)=O)=O,,,4,1,9,76,85
2675_0,,,,2,1,2,3
C(CCC(C)=O)(O)=O,,,4,1,9,69,78
2676_0,,,,2,1,2,3
2676_1,,,,2,1,2,3
2677_0,,,,2,1,2,3
2677_1,,,,2,1,2,3
2679_0,,,,2,1,2,3
C(C[CH]C(O)=O)=O,,,4,1,16,129,145
2681_0,,,,2,1,2,3
C(CCC(O)=O)=O,,,4,1,22,97,119
2683_0,,,,2,1,1,2
C(C(C(C(CC(C)O)O)=O)O)=O,,,4,1,3,12,15
2685_0,,,,2,1,1,2
C(C(C(C(CC(C)O)O)=O)O)(O)=O,,,4,1,4,11,15
2686_0,,,,2,1,1,2
2688_0,,,,2,1,1,2
C(C(C(C(CO)O)=O)C(C)O)=O,,,4,1,4,15,19
2690_0,,,,2,1,1,2
C(C(C(C(C)O)=O)C(C)O)=O,,,4,1,3,13,16
2692_0,,,,2,1,1,2
C(C(C(C(CC(O)=O)O)=O)O)=O,,,4,1,4,12,16
2694_0,,,,2,1,1,2
C(C(C(C(CC(O)=O)O)=O)O)(O)=O,,,4,1,7,10,17
2695_0,,,,2,1,1,2
2697_0,,,,2,1,1,2
C(C(C=O)C(C(CO)O)=O)(O)=O,,,4,1,6,15,21
2699_0,,,,2,1,1,2
C(C(C=O)C(C(C)O)=O)(O)=O,,,4,1,5,12,17
2701_0,,,,2,1,1,2
C(C(C(C(C(CO)=O)O)=O)O)=O,,,4,1,2,14,16
2702_0,,,,2,1,1,2
2704_0,,,,2,1,1,2
C(C(CO)O)(C(C(C=O)=O)O)=O,,,4,1,6,19,25
2705_0,,,,2,1,1,2
2707_0,,,,2,1,1,2
C(C(CO)O)(CC(C=O)=O)=O,,,4,1,5,22,27
2709_0,,,,2,1,1,2
C(C(C(C(C(CO)=O)O)=O)O)(O)=O,,,4,1,4,12,16
2710_0,,,,2,1,1,2
2712_0,,,,2,1,1,2
C(C(CO)O)(C(C(C(O)=O)=O)O)=O,,,4,1,7,15,22
2713_0,,,,2,1,1,2
2715_0,,,,2,1,1,2
C(CC(C(CO)O)=O)=O,,,4,1,8,44,52
2716_0,,,,2,1,1,2
2717_0,,,,2,1,1,2
2719_0,,,,2,1,1,2
C(C(C(C(C=O)O)=O)(CO)O)=O,,,4,1,2,14,16
2721_0,,,,2,1,1,2
C(C(C(C(C(O)=O)O)=O)(CO)O)=O,,,4,1,3,13,16
2723_0,,,,2,1,1,2
C(C(C(C(C=O)O)=O)(C)O)=O,,,4,1,2,12,14
2725_0,,,,2,1,1,2
C(C(C)O)(C(C(C=O)=O)O)=O,,,4,1,1,16,17
2727_0,,,,2,1,1,2
C(C(C(C(C(C)=O)O)=O)O)=O,,,4,1,2,16,18
2728_0,,,,2,1,1,2
2730_0,,,,2,1,1,2
C(C(C(C(C=O)O)=O)(CO)O)(O)=O,,,4,1,2,13,15
2732_0,,,,2,1,1,2
C(C(C(C(C)O)=O)O)=O,,,4,1,6,35,41
2734_0,,,,2,1,1,2
C(C(C(C(O)=O)=O)O)=O,,,4,1,9,28,37
2736_0,,,,2,1,1,2
C(C(C(C(C=O)O)=O)(C)O)(O)=O,,,4,1,4,11,15
2738_0,,,,2,1,1,2
C(C(C(C(C(O)=O)O)=O)(C)O)=O,,,4,1,3,10,13
2740_0,,,,2,1,1,2
C(C(C)O)(CC(C=O)=O)=O,,,4,1,2,24,26
2742_0,,,,2,1,1,2
C(C(C(C(C(C)=O)O)=O)O)(O)=O,,,4,1,7,10,17
2744_0,,,,2,1,1,2
C(C(C)O)(C(C(C(O)=O)=O)O)=O,,,4,1,4,10,14
2746_0,,,,2,1,1,2
C(CC(C(C)O)=O)=O,,,4,1,16,109,125
2748_0,,,,2,1,1,2
C(C(C)O)(CC(C(O)=O)=O)=O,,,4,1,3,13,16
2749_0,,,,2,1,1,2
2751_0,,,,2,1,1,2
C(C(C(C(C)O)=O)O)(O)=O,,,4,1,8,17,25
2752_0,,,,2,1,1,2
2754_0,,,,2,1,1,2
C(C(C(C(C(O)=O)O)=O)(C)O)(O)=O,,,4,1,5,10,15
2756_0,,,,2,1,1,2
C(CO)(C(C(C)=O)O)=O,,,4,1,8,44,52
2757_0,,,,2,1,1,2
2758_0,,,,2,1,1,2
2759_0,,,,2,1,1,2
2761_0,,,,2,1,1,2
C(C)(C(C(C)=O)O)=O,,,4,1,3,82,85
2762_0,,,,2,1,1,2
2763_0,,,,2,1,1,2
2764_0,,,,2,1,1,2
2765_0,,,,2,1,1,2
2766_0,,,,2,1,1,2
2768_0,,,,2,1,1,2
C(C(CO)(C(C(C=O)O)O)O)(O)=O,,,4,1,12,19,31
2770_0,,,,2,1,1,2
C(C(C(C(CO)O)=O)(CO)O)(O)=O,,,4,1,6,13,19
2772_0,,,,2,1,1,2
C(C(C(C(C)O)=O)(CO)O)(O)=O,,,4,1,6,9,15
2773_0,,,,2,1,1,2
2775_0,,,,2,1,1,2
C(C(C(C(CO)O)=O)O)(O)=O,,,4,1,10,15,25
2776_0,,,,2,1,1,2
2778_0,,,,2,1,1,2
C(C(C(C(CO)O)=O)(C)O)(O)=O,,,4,1,4,10,14
2779_0,,,,2,1,1,2
2781_0,,,,2,1,1,2
C(C(C(C(C)O)=O)(C)O)(O)=O,,,4,1,1,7,8
2782_0,,,,2,1,1,2
2783_0,,,,2,1,1,2
2784_0,,,,2,1,1,2
2785_0,,,,2,1,1,2
2786_0,,,,2,1,1,2
2788_0,,,,2,1,1,2
C(C(C(C[CH]C(O)=O)=O)O)=O,,,4,1,2,12,14
2790_0,,,,2,1,1,2
C(C(C(CCC(O)=O)=O)O)=O,,,4,1,3,12,15
2792_0,,,,2,1,1,2
C(C(C(C[CH]C(O)=O)=O)O)(O)=O,,,4,1,3,8,11
2794_0,,,,2,1,1,2
C(C(C(CCC(O)=O)=O)O)(O)=O,,,4,1,6,8,14
2795_0,,,,2,1,1,2
2797_0,,,,2,3,2,5
CC(CC(C(CO)C(C)O)O)O,,,4,1,1,7,8
2799_0,,,,2,3,2,5
C(C(CO)C(CC(C)O)O)(O)=O,,,4,1,7,8,15
2800_0,,,,2,3,2,5
2801_0,,,,2,3,2,5
2803_0,,,,2,3,2,5
CC(CC(CCO)O)O,,,4,1,1,11,12
2805_0,,,,2,3,2,5
C(CC(C(CO)C(C)O)O)(O)=O,,,4,1,2,7,9
2807_0,,,,2,3,2,5
C(CO)(C(C(CO)C(C)O)O)=O,,,4,1,2,8,10
2808_0,,,,2,3,2,5
2810_0,,,,2,3,2,5
C(C(CO)(C(CO)C(C)O)O)=O,,,4,1,1,11,12
2811_0,,,,2,3,2,5
2813_0,,,,2,3,2,5
C(C(C)(C(CO)C(C)O)O)=O,,,4,1,1,9,10
2815_0,,,,2,3,2,5
C(C)(C(C(CO)C(C)O)O)=O,,,4,1,1,10,11
2817_0,,,,2,3,2,5
CC(C(CO)CO)O,,,4,1,1,19,20
2819_0,,,,2,3,2,5
C(C(CO)(C(CO)C(C)O)O)(O)=O,,,4,1,3,9,12
2821_0,,,,2,3,2,5
CC(C(CO)C(C)O)O,,,4,1,1,7,8
2823_0,,,,2,3,2,5
C(C(CO)C(C)O)(O)=O,,,4,1,5,15,20
2825_0,,,,2,3,2,5
C(C(C)(C(CO)C(C)O)O)(O)=O,,,4,1,2,8,10
2827_0,,,,2,3,2,5
C(C(CCO)(CC(C)O)O)(O)=O,,,4,1,1,8,9
2829_0,,,,2,3,2,5
C(C(CO)C(CC(O)=O)O)(O)=O,,,4,1,7,7,14
2830_0,,,,2,3,2,5
2831_0,,,,2,3,2,5
2833_0,,,,2,3,2,5
C(CC(CCO)O)(O)=O,,,4,1,6,14,20
2835_0,,,,2,3,2,5
C(C(CO)C(C(CO)=O)O)(O)=O,,,4,1,6,9,15
2836_0,,,,2,3,2,5
2838_0,,,,2,3,2,5
C(C(CO)C(C=O)(CO)O)(O)=O,,,4,1,6,12,18
2839_0,,,,2,3,2,5
2841_0,,,,2,3,2,5
C(C(CO)C(C=O)(C)O)(O)=O,,,4,1,5,10,15
2843_0,,,,2,3,2,5
C(C(CO)C(C(C)=O)O)(O)=O,,,4,1,7,11,18
2845_0,,,,2,3,2,5
C(C(CO)CO)(O)=O,,,4,1,4,28,32
2847_0,,,,2,3,2,5
C(C(CO)C(C(O)=O)(CO)O)(O)=O,,,4,1,8,10,18
2849_0,,,,2,3,2,5
C(C(C(O)=O)CO)(O)=O,,,4,1,5,11,16
2851_0,,,,2,3,2,5
C(C(CO)C(C(O)=O)(C)O)(O)=O,,,4,1,7,8,15
2853_0,,,,2,3,2,5
C(C(C)(CC(CCO)O)O)(O)=O,,,4,1,1,8,9
2855_0,,,,2,3,2,5
C(C(C)(C(CO)CO)O)(O)=O,,,4,1,1,5,6
2857_0,,,,2,3,2,5
C(C(CCO)(CC(O)=O)O)(O)=O,,,4,1,2,7,9
2858_0,,,,2,3,2,5
2859_0,,,,2,3,2,5
2861_0,,,,2,3,2,5
C(CO)(C(CCO)O)=O,,,4,1,3,30,33
2862_0,,,,2,3,2,5
2863_0,,,,2,3,2,5
2864_0,,,,2,3,2,5
2865_0,,,,2,3,2,5
2866_0,,,,2,3,2,5
2868_0,,,,2,3,2,5
C(C(CO)(CCO)O)=O,,,4,1,2,14,16
2869_0,,,,2,3,2,5
2870_0,,,,2,3,2,5
2871_0,,,,2,3,2,5
2872_0,,,,2,3,2,5
2873_0,,,,2,3,2,5
2874_0,,,,2,3,2,5
2875_0,,,,2,3,2,5
2876_0,,,,2,3,2,5
2877_0,,,,2,3,2,5
2878_0,,,,2,3,2,5
2879_0,,,,2,3,2,5
2880_0,,,,2,3,2,5
2881_0,,,,2,3,2,5
2883_0,,,,2,3,2,5
C(C(C)(CCO)O)=O,,,4,1,1,36,37
2884_0,,,,2,3,2,5
2885_0,,,,2,3,2,5
2886_0,,,,2,3,2,5
2888_0,,,,2,3,2,5
C(C)(C(CCO)O)=O,,,4,1,2,75,77
2889_0,,,,2,3,2,5
2890_0,,,,2,3,2,5
2891_0,,,,2,3,2,5
2892_0,,,,2,3,2,5
2893_0,,,,2,3,2,5
2895_0,,,,2,3,2,5
C(CCO)O,,,4,1,1,91,92
2897_0,,,,2,3,2,5
C(C(CO)(CCO)O)(O)=O,,,4,1,4,6,10
2898_0,,,,2,3,2,5
2899_0,,,,2,3,2,5
2900_0,,,,2,3,2,5
2901_0,,,,2,3,2,5
2903_0,,,,2,3,2,5
C(C(CO)(C(CO)(CO)O)O)(O)=O,,,4,1,9,8,17
2905_0,,,,2,3,2,5
C(C(CO)(C(CO)(C)O)O)(O)=O,,,4,1,9,9,18
2907_0,,,,2,3,2,5
C(C(C(CO)(CO)O)O)(O)=O,,,4,1,11,8,19
2909_0,,,,2,3,2,5
C(C(C)(C(CO)(CO)O)O)(O)=O,,,4,1,4,5,9
2911_0,,,,2,3,2,5
C(C(C(CO)(C)O)O)(O)=O,,,4,1,8,13,21
2913_0,,,,2,3,2,5
C(C(C)(C(CO)(C)O)O)(O)=O,,,4,1,4,6,10
2914_0,,,,2,3,2,5
2916_0,,,,2,3,2,5
C(C)=CCO,,,4,1,4,102,106
2918_0,,,,2,3,2,5
C=CCCO,,,4,1,2,103,105
2920_0,,,,2,3,2,5
C=C(C(O)=O)CCO,,,4,1,5,47,52
2922_0,,,,2,3,2,5
C(CO)=C(C(O)=O)C,,,4,1,5,45,50
2924_0,,,,2,3,2,5
C(C(CO)O)O,,,4,1,3,40,43
2925_0,,,,2,3,2,5
2927_0,,,,2,3,2,5
[CH](C(O)=O)CC(CO)C(C)O,,,4,1,2,6,8
2929_0,,,,2,3,2,5
C(CCC(CO)C(C)O)(O)=O,,,4,1,2,6,8
2931_0,,,,2,3,2,5
[CH](C(O)=O)CCC(CCO)O,,,4,1,2,5,7
2933_0,,,,2,3,2,5
C(CCCC(CCO)O)(O)=O,,,4,1,2,5,7
2935_0,,,,2,3,2,5
[CH](C(O)=O)CC(C)(CCO)O,,,4,1,2,7,9
2937_0,,,,2,3,2,5
C(CCC(C)(CCO)O)(O)=O,,,4,1,2,7,9
2939_0,,,,2,3,2,5
C(C(CO)C[CH]C(O)=O)(O)=O,,,4,1,5,6,11
2941_0,,,,2,3,2,5
C(C(CCC(O)=O)CO)(O)=O,,,4,1,5,6,11
2943_0,,,,2,3,2,5
C(CO)(C(C[CH]C(O)=O)O)=O,,,4,1,3,10,13
2945_0,,,,2,3,2,5
C(CCC(C(CO)=O)O)(O)=O,,,4,1,3,10,13
2947_0,,,,2,3,2,5
C(CO)(CC[CH]C(O)=O)=O,,,4,1,3,16,19
2949_0,,,,2,3,2,5
C(CCCC(CO)=O)(O)=O,,,4,1,4,16,20
2951_0,,,,2,3,2,5
[CH](C(O)=O)CCCO,,,4,1,2,19,21
2953_0,,,,2,3,2,5
C(CCCCO)(O)=O,,,4,1,3,19,22
2955_0,,,,2,3,2,5
CC(CO)O,,,4,1,2,138,140
2956_0,,,,2,3,2,5
2958_0,,,,2,3,2,5
C(C(C(C)O)C(CC(C)O)O)(O)=O,,,4,1,5,9,14
2960_0,,,,2,3,2,5
C(C(C(O)=O)C(CC(C)O)O)(O)=O,,,4,1,5,7,12
2961_0,,,,2,3,2,5
2962_0,,,,2,3,2,5
2964_0,,,,2,3,2,5
C(CC(CC(C)O)O)(O)=O,,,4,1,4,8,12
2966_0,,,,2,3,2,5
C(C(C(CC(O)=O)O)C(C)O)(O)=O,,,4,1,4,8,12
2968_0,,,,2,3,2,5
C(C(C(C)O)C(C(CO)=O)O)(O)=O,,,4,1,4,10,14
2969_0,,,,2,3,2,5
2971_0,,,,2,3,2,5
C(C(C(C)O)C(C=O)(CO)O)(O)=O,,,4,1,4,12,16
2972_0,,,,2,3,2,5
2974_0,,,,2,3,2,5
C(C(C(C)O)C(C=O)(C)O)(O)=O,,,4,1,3,10,13
2976_0,,,,2,3,2,5
C(C(C(C)O)C(C(C)=O)O)(O)=O,,,4,1,4,9,13
2977_0,,,,2,3,2,5
2979_0,,,,2,3,2,5
C(C(C(C)O)C(C)O)(O)=O,,,4,1,2,6,8
2981_0,,,,2,3,2,5
C(C(C(O)=O)C(C)O)(O)=O,,,4,1,3,7,10
2983_0,,,,2,3,2,5
C(C(C(C)O)C(C(O)=O)(C)O)(O)=O,,,4,1,4,9,13
2985_0,,,,2,3,2,5
C(C(CC(C)O)(CC(O)=O)O)(O)=O,,,4,1,1,8,9
2987_0,,,,2,3,2,5
C(C(C(O)=O)C(CC(O)=O)O)(O)=O,,,4,1,4,5,9
2988_0,,,,2,3,2,5
2989_0,,,,2,3,2,5
2991_0,,,,2,3,2,5
C(CC(CC(O)=O)O)(O)=O,,,4,1,5,5,10
2993_0,,,,2,3,2,5
C(C(C(O)=O)C(C(CO)=O)O)(O)=O,,,4,1,4,7,11
2994_0,,,,2,3,2,5
2996_0,,,,2,3,2,5
C(C(C(O)=O)C(C=O)(CO)O)(O)=O,,,4,1,4,9,13
2997_0,,,,2,3,2,5
2999_0,,,,2,3,2,5
C(C(C(O)=O)C(C=O)(C)O)(O)=O,,,4,1,3,7,10
3001_0,,,,2,3,2,5
C(C(C(O)=O)C(C(C)=O)O)(O)=O,,,4,1,4,6,10
3002_0,,,,2,3,2,5
3004_0,,,,2,3,2,5
C(C(C(O)=O)C(O)=O)(O)=O,,,4,1,2,4,6
3006_0,,,,2,3,2,5
C(C(C(O)=O)C(C(O)=O)(C)O)(O)=O,,,4,1,4,6,10
3008_0,,,,2,3,2,5
C(C(C)(CC(CC(O)=O)O)O)(O)=O,,,4,1,1,8,9
3009_0,,,,2,3,2,5
3011_0,,,,2,3,2,5
C(CC(C(O)=O)(CC(O)=O)O)(O)=O,,,4,1,1,4,5
3012_0,,,,2,3,2,5
3013_0,,,,2,3,2,5
3015_0,,,,2,3,2,5
C(CC(C(CO)=O)O)(O)=O,,,4,1,8,18,26
3016_0,,,,2,3,2,5
3017_0,,,,2,3,2,5
3018_0,,,,2,3,2,5
3019_0,,,,2,3,2,5
3021_0,,,,2,3,2,5
C(C(CO)(CC(O)=O)O)=O,,,4,1,5,12,17
3022_0,,,,2,3,2,5
3023_0,,,,2,3,2,5
3024_0,,,,2,3,2,5
3025_0,,,,2,3,2,5
3026_0,,,,2,3,2,5
3027_0,,,,2,3,2,5
3028_0,,,,2,3,2,5
3029_0,,,,2,3,2,5
3030_0,,,,2,3,2,5
3031_0,,,,2,3,2,5
3032_0,,,,2,3,2,5
3033_0,,,,2,3,2,5
3035_0,,,,2,3,2,5
C(C(C)(CC(O)=O)O)=O,,,4,1,4,16,20
3036_0,,,,2,3,2,5
3037_0,,,,2,3,2,5
3038_0,,,,2,3,2,5
3040_0,,,,2,3,2,5
C(CC(C(C)=O)O)(O)=O,,,4,1,6,28,34
3041_0,,,,2,3,2,5
3042_0,,,,2,3,2,5
3043_0,,,,2,3,2,5
3044_0,,,,2,3,2,5
3045_0,,,,2,3,2,5
3046_0,,,,2,3,2,5
3048_0,,,,2,3,2,5
C(C(CO)(CC(O)=O)O)(O)=O,,,4,1,5,7,12
3049_0,,,,2,3,2,5
3050_0,,,,2,3,2,5
3051_0,,,,2,3,2,5
3052_0,,,,2,3,2,5
3053_0,,,,2,3,2,5
3054_0,,,,2,3,2,5
3055_0,,,,2,3,2,5
3056_0,,,,2,3,2,5
3057_0,,,,2,3,2,5
3058_0,,,,2,3,2,5
3060_0,,,,2,3,2,5
C(C)=CC(O)=O,,,4,1,5,184,189
3062_0,,,,2,3,2,5
C(CC=C)(O)=O,,,4,1,4,22,26
3064_0,,,,2,3,2,5
C(CC(C(O)=O)=C)(O)=O,,,4,1,2,13,15
3066_0,,,,2,3,2,5
C(C(C)=CC(O)=O)(O)=O,,,4,1,3,20,23
3067_0,,,,2,3,2,5
3068_0,,,,2,3,2,5
3070_0,,,,2,3,2,5
C(C(C(C)O)C[CH]C(O)=O)(O)=O,,,4,1,3,6,9
3072_0,,,,2,3,2,5
C(C(CCC(O)=O)C(C)O)(O)=O,,,4,1,4,6,10
3074_0,,,,2,3,2,5
C(CC(CC[CH]C(O)=O)O)(O)=O,,,4,1,2,4,6
3076_0,,,,2,3,2,5
C(CCCC(CC(O)=O)O)(O)=O,,,4,1,2,4,6
3078_0,,,,2,3,2,5
C(CC(C)(C[CH]C(O)=O)O)(O)=O,,,4,1,2,6,8
3080_0,,,,2,3,2,5
C(CCC(C)(CC(O)=O)O)(O)=O,,,4,1,2,6,8
3082_0,,,,2,3,2,5
C(C(C(O)=O)C[CH]C(O)=O)(O)=O,,,4,1,3,4,7
3084_0,,,,2,3,2,5
C(C(C(O)=O)CCC(O)=O)(O)=O,,,4,1,4,4,8
3085_0,,,,2,3,2,5
3086_0,,,,2,3,2,5
3087_0,,,,2,3,2,5
3088_0,,,,2,3,2,5
3090_0,,,,2,3,2,5
C(CC[CH]C(O)=O)(O)=O,,,4,1,6,6,12
3092_0,,,,2,3,2,5
C(CCCC(O)=O)(O)=O,,,4,1,4,4,8
3093_0,,,,2,3,2,5
3095_0,,,,2,3,2,5
C(C(O)=O)(O)=O,,,4,1,1,3,4
3096_0,,,,2,1,1,2
3097_0,,,,2,1,1,2
3099_0,,,,2,2,1,3
C(C(CO)(C(C)O)C(C=O)(C)O)=O,,,4,1,3,12,15
3101_0,,,,2,2,1,3
C(C(CO)(C(C)O)C(C(C)=O)O)=O,,,4,1,3,12,15
3103_0,,,,2,2,1,3
C(C(CO)(C(C)O)C(CCO)O)=O,,,4,1,3,11,14
3105_0,,,,2,2,1,3
C(C(CO)(C(C)O)C(C=O)O)=O,,,4,1,3,16,19
3107_0,,,,2,2,1,3
C(C(CO)(C(C)O)C(C)(CO)O)=O,,,4,1,4,11,15
3109_0,,,,2,2,1,3
C(C(CO)(C(C)O)C(C=CC)O)=O,,,4,1,3,8,11
3111_0,,,,2,2,1,3
C(C(CO)(C(CC=C)O)C(C)O)=O,,,4,1,3,9,12
3113_0,,,,2,2,1,3
C(C(CO)(C(CO)O)C(C)O)=O,,,4,1,4,12,16
3115_0,,,,2,2,1,3
C(C(CO)(C(C)O)C(C(C)O)O)=O,,,4,1,3,12,15
3117_0,,,,2,2,1,3
C(C(CO)(C(C)O)C(C(O)=O)O)=O,,,4,1,5,13,18
3119_0,,,,2,2,1,3
C(C(CO)(C(C)O)C(C)O)=O,,,4,1,2,7,9
3121_0,,,,2,2,1,3
C(C(C=O)(CO)C(C)O)(O)=O,,,4,1,3,8,11
3122_0,,,,2,2,1,3
3123_0,,,,2,2,1,3
3125_0,,,,2,2,1,3
C(C(CO)(CO)C(C)O)=O,,,4,1,3,8,11
3127_0,,,,2,2,1,3
C(C(C(C)O)(C(C)O)C(C=O)O)=O,,,4,1,2,10,12
3129_0,,,,2,2,1,3
C(C(C(CO)O)(C(C)O)C(C)O)=O,,,4,1,3,9,12
3131_0,,,,2,2,1,3
C(C(C(C)O)(C(C)O)C(C)O)=O,,,4,1,1,5,6
3133_0,,,,2,2,1,3
C(C(C=O)(C(C)O)C(C)O)(O)=O,,,4,1,2,6,8
3134_0,,,,2,2,1,3
3136_0,,,,2,2,1,3
C(C(C=O)(C(C)O)C(C=O)O)(O)=O,,,4,1,3,12,15
3138_0,,,,2,2,1,3
C(C(C=O)(C(CO)O)C(C)O)(O)=O,,,4,1,4,11,15
3139_0,,,,2,2,1,3
3141_0,,,,2,2,1,3
C(C(C(O)=O)(C=O)C(C)O)(O)=O,,,4,1,2,6,8
3142_0,,,,2,2,1,3
3144_0,,,,2,2,1,3
C(C(C(CO)(CO)C(C)O)=O)(O)=O,,,4,1,2,10,12
3145_0,,,,2,2,1,3
3147_0,,,,2,2,1,3
C(C(C(CC=O)O)C(C=O)O)(O)=O,,,4,1,3,17,20
3149_0,,,,2,2,1,3
C(C(C(CC=O)O)C(CO)O)(O)=O,,,4,1,3,13,16
3150_0,,,,2,2,1,3
3151_0,,,,2,2,1,3
3152_0,,,,2,2,1,3
3154_0,,,,2,2,1,3
C(C(C=O)(CO)C(C=O)(C)O)(O)=O,,,4,1,3,10,13
3156_0,,,,2,2,1,3
C(C(C=O)(CO)C(C(C)=O)O)(O)=O,,,4,1,3,10,13
3158_0,,,,2,2,1,3
C(C(C=O)(CO)C(CCO)O)(O)=O,,,4,1,3,10,13
3160_0,,,,2,2,1,3
C(C(C=O)(CO)C(C=O)O)(O)=O,,,4,1,3,14,17
3162_0,,,,2,2,1,3
C(C(C=O)(CO)C(C)(CO)O)(O)=O,,,4,1,4,10,14
3164_0,,,,2,2,1,3
C(C(C=O)(CO)C(C=CC)O)(O)=O,,,4,1,3,6,9
3166_0,,,,2,2,1,3
C(C(C=O)(CO)C(CC=C)O)(O)=O,,,4,1,3,7,10
3168_0,,,,2,2,1,3
C(C(C=O)(CO)C(CO)O)(O)=O,,,4,1,4,11,15
3170_0,,,,2,2,1,3
C(C(C=O)(CO)C(C(C)O)O)(O)=O,,,4,1,3,11,14
3172_0,,,,2,2,1,3
C(C(C=O)(CO)C(C(O)=O)O)(O)=O,,,4,1,5,11,16
3173_0,,,,2,2,1,3
3175_0,,,,2,2,1,3
C(C(C(O)=O)(C=O)CO)(O)=O,,,4,1,2,5,7
3176_0,,,,2,2,1,3
3177_0,,,,2,2,1,3
3179_0,,,,2,2,1,3
C(C(C=O)(CO)CO)(O)=O,,,4,1,3,6,9
3181_0,,,,2,2,1,3
C(C(C(O)=O)(C=O)C(C=O)O)(O)=O,,,4,1,2,8,10
3183_0,,,,2,2,1,3
C(C(C(O)=O)(C=O)C(CO)O)(O)=O,,,4,1,3,8,11
3184_0,,,,2,2,1,3
3186_0,,,,2,2,1,3
C(C(C(O)=O)(C(O)=O)C(O)=O)=O,,,4,1,1,3,4
3187_0,,,,2,2,1,3
3189_0,,,,2,2,1,3
C(C(CO)(CO)C(C(O)=O)(C)O)=O,,,4,1,2,9,11
3191_0,,,,2,2,1,3
C(C(C(C(O)=O)=O)(CO)CO)(O)=O,,,4,1,2,8,10
3193_0,,,,2,2,1,3
C(C(C)(C(C(C=O)=O)(CO)O)O)=O,,,4,1,4,17,21
3193_1,,,,2,2,1,3
3195_0,,,,2,2,1,3
C(C)(C(CO)(C(C(C=O)=O)O)O)=O,,,4,1,6,19,25
3195_1,,,,2,2,1,3
3197_0,,,,2,2,1,3
C(C(C(C(C=O)=O)(CO)O)O)(C)=O,,,4,1,4,19,23
3197_1,,,,2,2,1,3
3199_0,,,,2,2,1,3
C(C(C(CO)(C(CCO)O)O)=O)=O,,,4,1,4,17,21
3199_1,,,,2,2,1,3
3201_0,,,,2,2,1,3
C(C(C(C(C=O)=O)(CO)O)O)=O,,,4,1,4,24,28
3201_1,,,,2,2,1,3
3203_0,,,,2,2,1,3
C(C(C(CO)(C(CO)(C)O)O)=O)=O,,,4,1,5,16,21
3203_1,,,,2,2,1,3
3205_0,,,,2,2,1,3
C(C)=CC(C(C(C=O)=O)(CO)O)O,,,4,1,4,13,17
3205_1,,,,2,2,1,3
3207_0,,,,2,2,1,3
C=CCC(C(C(C=O)=O)(CO)O)O,,,4,1,4,14,18
3207_1,,,,2,2,1,3
3209_0,,,,2,2,1,3
C(C(C(CO)(C(CO)O)O)=O)=O,,,4,1,5,20,25
3209_1,,,,2,2,1,3
3211_0,,,,2,2,1,3
C(C(C(CO)(C(C(C)O)O)O)=O)=O,,,4,1,4,18,22
3211_1,,,,2,2,1,3
3213_0,,,,2,2,1,3
C(C(C(C(C=O)=O)(CO)O)O)(O)=O,,,4,1,6,19,25
3213_1,,,,2,2,1,3
3215_0,,,,2,2,1,3
C(C(C(CO)(C(C)O)O)=O)=O,,,4,1,5,17,22
3215_1,,,,2,2,1,3
3216_0,,,,2,2,1,3
3216_1,,,,2,2,1,3
3217_0,,,,2,2,1,3
3217_1,,,,2,2,1,3
3218_0,,,,2,2,1,3
3218_1,,,,2,2,1,3
3220_0,,,,2,2,1,3
C(C(C(CO)(CO)O)=O)=O,,,4,1,5,13,18
3220_1,,,,2,2,1,3
3222_0,,,,2,2,1,3
C(C(C(C(C=O)=O)(C(C)O)O)O)=O,,,4,1,4,20,24
3222_1,,,,2,2,1,3
3224_0,,,,2,2,1,3
C(C(C(C(CO)O)(C(C)O)O)=O)=O,,,4,1,5,18,23
3224_1,,,,2,2,1,3
3226_0,,,,2,2,1,3
C(C(C(C(C)O)(C(C)O)O)=O)=O,,,4,1,3,12,15
3226_1,,,,2,2,1,3
3228_0,,,,2,2,1,3
C(C(C(C=O)=O)(C(C)O)O)(O)=O,,,4,1,6,15,21
3228_1,,,,2,2,1,3
3229_0,,,,2,2,1,3
3229_1,,,,2,2,1,3
3231_0,,,,2,2,1,3
C(C(C(C=O)=O)(C(C=O)O)O)(O)=O,,,4,1,6,17,23
3231_1,,,,2,2,1,3
3233_0,,,,2,2,1,3
C(C(C(C=O)=O)(C(CO)O)O)(O)=O,,,4,1,6,16,22
3233_1,,,,2,2,1,3
3234_0,,,,2,2,1,3
3234_1,,,,2,2,1,3
3236_0,,,,2,2,1,3
C(C(C(O)=O)(C(C=O)=O)O)(O)=O,,,4,1,4,9,13
3236_1,,,,2,2,1,3
3237_0,,,,2,2,1,3
3237_1,,,,2,2,1,3
3239_0,,,,2,2,1,3
C(C(C=O)(C(C=O)(CCO)O)O)=O,,,4,1,3,11,14
3239_1,,,,2,2,1,3
3241_0,,,,2,2,1,3
C(C(CO)C(C=O)(CCO)O)(O)=O,,,4,1,3,11,14
3243_0,,,,2,2,1,3
C(C(CCO)(C(C=O)(CO)O)O)=O,,,4,1,6,16,22
3243_1,,,,2,2,1,3
3245_0,,,,2,2,1,3
C(C(C=O)(C(C(CCO)=O)O)O)=O,,,4,1,5,13,18
3245_1,,,,2,2,1,3
3247_0,,,,2,2,1,3
C(C(CO)C(C(CCO)=O)O)(O)=O,,,4,1,4,10,14
3249_0,,,,2,2,1,3
C(C(CO)(C(C(CCO)=O)O)O)=O,,,4,1,8,18,26
3249_1,,,,2,2,1,3
3250_0,,,,2,2,1,3
3250_1,,,,2,2,1,3
3252_0,,,,2,2,1,3
C(C(C(CO)(C(CO)O)O)=O)(O)=O,,,4,1,7,17,24
3252_1,,,,2,2,1,3
3254_0,,,,2,2,1,3
C(C(C(CO)(C(C)O)O)=O)(O)=O,,,4,1,6,14,20
3254_1,,,,2,2,1,3
3256_0,,,,2,2,1,3
C(C(C(C(O)=O)=O)(CO)O)(O)=O,,,4,1,7,11,18
3256_1,,,,2,2,1,3
3258_0,,,,2,2,1,3
C(C(C(CO)(CO)O)=O)(O)=O,,,4,1,6,8,14
3258_1,,,,2,2,1,3
3260_0,,,,2,2,1,3
C(C(C=O)(C(CCO)O)O)=O,,,4,1,2,9,11
3260_1,,,,2,2,1,3
3262_0,,,,2,2,1,3
C(C(C=O)(C(CCO)O)O)(O)=O,,,4,1,5,12,17
3262_1,,,,2,2,1,3
3264_0,,,,2,2,1,3
C(C(CO)C(CCO)O)(O)=O,,,4,1,5,8,13
3266_0,,,,2,2,1,3
C(C(C(C)O)C(CCO)O)(O)=O,,,4,1,4,8,12
3268_0,,,,2,2,1,3
C(C(C(O)=O)C(CCO)O)(O)=O,,,4,1,4,6,10
3270_0,,,,2,2,1,3
C(C(C(C)O)(C(CCO)O)O)(O)=O,,,4,1,4,11,15
3270_1,,,,2,2,1,3
3272_0,,,,2,2,1,3
C(C(C(O)=O)(C(CCO)O)O)(O)=O,,,4,1,5,7,12
3272_1,,,,2,2,1,3
3274_0,,,,2,2,1,3
C(C(C(C)=O)(C)C(CCO)O)(O)=O,,,4,1,1,7,8
3276_0,,,,2,2,1,3
C(C(CO)(C(CCO)O)O)=O,,,4,1,5,13,18
3276_1,,,,2,2,1,3
3278_0,,,,2,2,1,3
C(C(CO)(C(CCO)O)O)(O)=O,,,4,1,8,10,18
3278_1,,,,2,2,1,3
3280_0,,,,2,2,1,3
C(C(C(C(C)O)(C(C)O)O)=O)(O)=O,,,4,1,4,9,13
3280_1,,,,2,2,1,3
3282_0,,,,2,2,1,3
C(C(C(C(O)=O)=O)(C(C)O)O)(O)=O,,,4,1,6,12,18
3282_1,,,,2,2,1,3
3283_0,,,,2,2,1,3
3283_1,,,,2,2,1,3
3284_0,,,,2,2,1,3
3284_1,,,,2,2,1,3
3286_0,,,,2,2,1,3
C(C(C(O)=O)(C(C(O)=O)=O)O)(O)=O,,,4,1,4,6,10
3286_1,,,,2,2,1,3
3287_0,,,,2,2,1,3
3287_1,,,,2,2,1,3
3289_0,,,,2,2,1,3
C(C(C=O)(C(C=O)O)O)=O,,,4,1,7,21,28
3289_1,,,,2,2,1,3
3291_0,,,,2,2,1,3
C(C(C=O)(C(C=O)O)O)(O)=O,,,4,1,10,18,28
3291_1,,,,2,2,1,3
3293_0,,,,2,2,1,3
C(C(CO)C(C=O)O)(O)=O,,,4,1,8,18,26
3295_0,,,,2,2,1,3
C(C(C(C)O)C(C=O)O)(O)=O,,,4,1,6,14,20
3297_0,,,,2,2,1,3
C(C(C(O)=O)C(C=O)O)(O)=O,,,4,1,6,11,17
3299_0,,,,2,2,1,3
C(C(C(C)O)(C(C=O)O)O)(O)=O,,,4,1,8,17,25
3299_1,,,,2,2,1,3
3301_0,,,,2,2,1,3
C(C(C(O)=O)(C(C=O)O)O)(O)=O,,,4,1,7,12,19
3301_1,,,,2,2,1,3
3303_0,,,,2,2,1,3
C(C)(C(C(O)=O)(CO)C(C=O)O)=O,,,4,1,1,11,12
3305_0,,,,2,2,1,3
C(C)(C(C(O)=O)(C)C(C=O)O)=O,,,4,1,1,11,12
3306_0,,,,2,2,1,3
3306_1,,,,2,2,1,3
3308_0,,,,2,2,1,3
C(C([C](C(O)=O)O)C(C=O)O)(O)=O,,,4,1,3,12,15
3310_0,,,,2,2,1,3
C(C(C(C(O)=O)C(C=O)O)O)(O)=O,,,4,1,6,14,20
3311_0,,,,2,2,1,3
3311_1,,,,2,2,1,3
3313_0,,,,2,2,1,3
C(C(C=O)(C(C(C=O)O)O)O)=O,,,4,1,3,18,21
3313_1,,,,2,2,1,3
3315_0,,,,2,2,1,3
C(C(C=O)(C(C(C(O)=O)O)O)O)=O,,,4,1,4,13,17
3315_1,,,,2,2,1,3
3317_0,,,,2,2,1,3
C(C(C=O)(C(CO)(CO)O)O)=O,,,4,1,3,7,10
3317_1,,,,2,2,1,3
3319_0,,,,2,2,1,3
C(C(C=O)(C(CO)(C)O)O)=O,,,4,1,3,8,11
3319_1,,,,2,2,1,3
3321_0,,,,2,2,1,3
C(C(C=O)(C(C=CC)O)O)=O,,,4,1,3,8,11
3321_1,,,,2,2,1,3
3323_0,,,,2,2,1,3
C(C(C=O)(C(CC=C)O)O)=O,,,4,1,3,9,12
3323_1,,,,2,2,1,3
3325_0,,,,2,2,1,3
C(C(C=O)(C(C(CO)O)O)O)=O,,,4,1,4,12,16
3325_1,,,,2,2,1,3
3327_0,,,,2,2,1,3
C(C(C=O)(C(CO)O)O)=O,,,4,1,3,10,13
3327_1,,,,2,2,1,3
3329_0,,,,2,2,1,3
C(C(C=O)(C(C(C)O)O)O)=O,,,4,1,2,10,12
3329_1,,,,2,2,1,3
3331_0,,,,2,2,1,3
C(C(C=O)(C(C(O)=O)O)O)=O,,,4,1,7,12,19
3331_1,,,,2,2,1,3
3333_0,,,,2,2,1,3
C(C(C=O)(C(C)O)O)=O,,,4,1,2,12,14
3333_1,,,,2,2,1,3
3335_0,,,,2,2,1,3
C(C(C=O)(C=O)O)(O)=O,,,4,1,5,7,12
3335_1,,,,2,2,1,3
3337_0,,,,2,2,1,3
C(C(C=O)(C(CC(C)O)O)O)=O,,,4,1,4,10,14
3337_1,,,,2,2,1,3
3339_0,,,,2,2,1,3
C(C(C=O)(C(CC(O)=O)O)O)=O,,,4,1,2,9,11
3339_1,,,,2,2,1,3
3341_0,,,,2,2,1,3
C(C(C=O)(C(C(CO)=O)O)O)=O,,,4,1,7,13,20
3341_1,,,,2,2,1,3
3343_0,,,,2,2,1,3
C(C(C=O)(C(C=O)(CO)O)O)=O,,,4,1,6,15,21
3343_1,,,,2,2,1,3
3345_0,,,,2,2,1,3
C(C(C=O)(C(C=O)(C)O)O)=O,,,4,1,3,10,13
3345_1,,,,2,2,1,3
3347_0,,,,2,2,1,3
C(C(C=O)(C(C(C)=O)O)O)=O,,,4,1,6,14,20
3347_1,,,,2,2,1,3
3348_0,,,,2,2,1,3
3348_1,,,,2,2,1,3
3350_0,,,,2,2,1,3
C(C(C=O)(C(C(O)=O)(CO)O)O)=O,,,4,1,7,12,19
3350_1,,,,2,2,1,3
3352_0,,,,2,2,1,3
C(C(C=O)(C(C(O)=O)(C)O)O)=O,,,4,1,4,9,13
3352_1,,,,2,2,1,3
3354_0,,,,2,2,1,3
C(C(C=O)(C(C(C=O)O)O)O)(O)=O,,,4,1,8,19,27
3354_1,,,,2,2,1,3
3355_0,,,,2,2,1,3
3356_0,,,,2,2,1,3
3357_0,,,,2,2,1,3
3359_0,,,,2,2,1,3
C(C(CO)(C(C(C=O)O)O)O)=O,,,4,1,10,23,33
3359_1,,,,2,2,1,3
3360_0,,,,2,2,1,3
3360_1,,,,2,2,1,3
3362_0,,,,2,2,1,3
C(C(C=O)(C(CO)(CO)O)O)(O)=O,,,4,1,6,9,15
3362_1,,,,2,2,1,3
3364_0,,,,2,2,1,3
C(C(C=O)(C(CO)(C)O)O)(O)=O,,,4,1,6,11,17
3364_1,,,,2,2,1,3
3366_0,,,,2,2,1,3
C(C(C=O)(C(C=CC)O)O)(O)=O,,,4,1,6,10,16
3366_1,,,,2,2,1,3
3368_0,,,,2,2,1,3
C(C(C=O)(C(CC=C)O)O)(O)=O,,,4,1,6,11,17
3368_1,,,,2,2,1,3
3370_0,,,,2,2,1,3
C(C(C=O)(C(C(CO)O)O)O)(O)=O,,,4,1,8,15,23
3370_1,,,,2,2,1,3
3372_0,,,,2,2,1,3
C(C(C=O)(C(CO)O)O)(O)=O,,,4,1,6,12,18
3372_1,,,,2,2,1,3
3374_0,,,,2,2,1,3
C(C(C=O)(C(C(C)O)O)O)(O)=O,,,4,1,6,13,19
3374_1,,,,2,2,1,3
3376_0,,,,2,2,1,3
C(C(C=O)(C(C(O)=O)O)O)(O)=O,,,4,1,8,13,21
3376_1,,,,2,2,1,3
3378_0,,,,2,2,1,3
C(C(C=O)(C(C)O)O)(O)=O,,,4,1,6,10,16
3378_1,,,,2,2,1,3
3380_0,,,,2,2,1,3
C(C(C(O)=O)(C=O)O)(O)=O,,,4,1,5,5,10
3380_1,,,,2,2,1,3
3382_0,,,,2,2,1,3
C(C(C=O)(C(CC(C)O)O)O)(O)=O,,,4,1,7,12,19
3382_1,,,,2,2,1,3
3384_0,,,,2,2,1,3
C(C(C=O)(C(CC(O)=O)O)O)(O)=O,,,4,1,5,11,16
3384_1,,,,2,2,1,3
3386_0,,,,2,2,1,3
C(C(C=O)(C(C(CO)=O)O)O)(O)=O,,,4,1,11,16,27
3386_1,,,,2,2,1,3
3388_0,,,,2,2,1,3
C(C(C=O)(C(C=O)(CO)O)O)(O)=O,,,4,1,9,17,26
3388_1,,,,2,2,1,3
3390_0,,,,2,2,1,3
C(C(C=O)(C(C=O)(C)O)O)(O)=O,,,4,1,6,13,19
3390_1,,,,2,2,1,3
3392_0,,,,2,2,1,3
C(C(C=O)(C(C(C)=O)O)O)(O)=O,,,4,1,9,14,23
3392_1,,,,2,2,1,3
3393_0,,,,2,2,1,3
3393_1,,,,2,2,1,3
3395_0,,,,2,2,1,3
C(C(C=O)(C(C(O)=O)(C)O)O)(O)=O,,,4,1,7,11,18
3395_1,,,,2,2,1,3
3397_0,,,,2,2,1,3
C(C(CO)C(C(C(O)=O)O)O)(O)=O,,,4,1,10,12,22
3398_0,,,,2,2,1,3
3398_1,,,,2,2,1,3
3400_0,,,,2,2,1,3
C(C(CO)C(CO)(CO)O)(O)=O,,,4,1,4,6,10
3402_0,,,,2,2,1,3
C(C(CO)C(C)(CO)O)(O)=O,,,4,1,4,8,12
3404_0,,,,2,2,1,3
C(C(CO)C(C=CC)O)(O)=O,,,4,1,4,7,11
3406_0,,,,2,2,1,3
C(C(CO)C(CC=C)O)(O)=O,,,4,1,4,8,12
3408_0,,,,2,2,1,3
C(C(CO)C(C(CO)O)O)(O)=O,,,4,1,8,10,18
3410_0,,,,2,2,1,3
C(C(CO)C(CO)O)(O)=O,,,4,1,7,10,17
3412_0,,,,2,2,1,3
C(C(CO)C(C(C)O)O)(O)=O,,,4,1,3,9,12
3414_0,,,,2,2,1,3
C(C(CO)C(C(O)=O)O)(O)=O,,,4,1,11,10,21
3415_0,,,,2,2,1,3
3416_0,,,,2,2,1,3
3417_0,,,,2,2,1,3
3418_0,,,,2,2,1,3
3419_0,,,,2,2,1,3
3420_0,,,,2,2,1,3
3421_0,,,,2,2,1,3
3422_0,,,,2,2,1,3
3423_0,,,,2,2,1,3
3424_0,,,,2,2,1,3
3425_0,,,,2,2,1,3
3427_0,,,,2,2,1,3
C(C(C(C)O)C(CO)(CO)O)(O)=O,,,4,1,3,7,10
3429_0,,,,2,2,1,3
C(C(C(O)=O)C(CO)(CO)O)(O)=O,,,4,1,3,5,8
3431_0,,,,2,2,1,3
C(C(CO)(C(CO)(CO)O)O)=O,,,4,1,7,11,18
3431_1,,,,2,2,1,3
3432_0,,,,2,2,1,3
3432_1,,,,2,2,1,3
3434_0,,,,2,2,1,3
C(C(C(C)O)C(C)(CO)O)(O)=O,,,4,1,3,8,11
3436_0,,,,2,2,1,3
C(C(C(O)=O)C(C)(CO)O)(O)=O,,,4,1,3,6,9
3438_0,,,,2,2,1,3
C(C(C(C)O)(C(CO)(C)O)O)(O)=O,,,4,1,5,10,15
3438_1,,,,2,2,1,3
3440_0,,,,2,2,1,3
C(C(C(O)=O)(C(CO)(C)O)O)(O)=O,,,4,1,6,6,12
3440_1,,,,2,2,1,3
3442_0,,,,2,2,1,3
C(C(C(C)=O)(C)C(C)(CO)O)(O)=O,,,4,1,2,7,9
3444_0,,,,2,2,1,3
C(C(CO)(C(CO)(C)O)O)=O,,,4,1,6,12,18
3444_1,,,,2,2,1,3
3445_0,,,,2,2,1,3
3445_1,,,,2,2,1,3
3447_0,,,,2,2,1,3
C(C(C(C)O)C(C=CC)O)(O)=O,,,4,1,3,7,10
3449_0,,,,2,2,1,3
C(C(C(CC=C)O)C(C)O)(O)=O,,,4,1,3,8,11
3451_0,,,,2,2,1,3
C(C(C(C)O)C(C(CO)O)O)(O)=O,,,4,1,6,11,17
3453_0,,,,2,2,1,3
C(C(C(CO)O)C(C)O)(O)=O,,,4,1,3,9,12
3455_0,,,,2,2,1,3
C(C(C(C)O)C(C(C)O)O)(O)=O,,,4,1,2,9,11
3457_0,,,,2,2,1,3
C(C(C(C)O)C(C(O)=O)O)(O)=O,,,4,1,8,9,17
3458_0,,,,2,2,1,3
3459_0,,,,2,2,1,3
3460_0,,,,2,2,1,3
3461_0,,,,2,2,1,3
3462_0,,,,2,2,1,3
3463_0,,,,2,2,1,3
3464_0,,,,2,2,1,3
3465_0,,,,2,2,1,3
3466_0,,,,2,2,1,3
3467_0,,,,2,2,1,3
3469_0,,,,2,2,1,3
C(C(C(O)=O)C(C=CC)O)(O)=O,,,4,1,3,5,8
3471_0,,,,2,2,1,3
C(C(C(O)=O)C(CC=C)O)(O)=O,,,4,1,3,6,9
3473_0,,,,2,2,1,3
C(C(C(O)=O)C(C(CO)O)O)(O)=O,,,4,1,6,9,15
3475_0,,,,2,2,1,3
C(C(C(O)=O)C(CO)O)(O)=O,,,4,1,3,7,10
3477_0,,,,2,2,1,3
C(C(C(O)=O)C(C(C)O)O)(O)=O,,,4,1,2,7,9
3479_0,,,,2,2,1,3
C(C(C(O)=O)C(C(O)=O)O)(O)=O,,,4,1,8,6,14
3480_0,,,,2,2,1,3
3481_0,,,,2,2,1,3
3482_0,,,,2,2,1,3
3483_0,,,,2,2,1,3
3484_0,,,,2,2,1,3
3485_0,,,,2,2,1,3
3486_0,,,,2,2,1,3
3487_0,,,,2,2,1,3
3488_0,,,,2,2,1,3
3489_0,,,,2,2,1,3
3490_0,,,,2,2,1,3
3491_0,,,,2,2,1,3
3492_0,,,,2,2,1,3
3493_0,,,,2,2,1,3
3493_1,,,,2,2,1,3
3494_0,,,,2,2,1,3
3494_1,,,,2,2,1,3
3495_0,,,,2,2,1,3
3496_0,,,,2,2,1,3
3496_1,,,,2,2,1,3
3498_0,,,,2,2,1,3
C(CO)(C(CO)(C(C(O)=O)O)O)=O,,,4,1,6,15,21
3498_1,,,,2,2,1,3
3499_0,,,,2,2,1,3
3499_1,,,,2,2,1,3
3501_0,,,,2,2,1,3
C(C(C(C)O)(C(C=O)(C)O)O)(O)=O,,,4,1,5,13,18
3501_1,,,,2,2,1,3
3503_0,,,,2,2,1,3
C(C(C(O)=O)(C(C=O)(C)O)O)(O)=O,,,4,1,5,8,13
3503_1,,,,2,2,1,3
3504_0,,,,2,2,1,3
3504_1,,,,2,2,1,3
3506_0,,,,2,2,1,3
C(C(C(C)O)(C(C(C)=O)O)O)(O)=O,,,4,1,6,13,19
3506_1,,,,2,2,1,3
3508_0,,,,2,2,1,3
C(C(C(O)=O)(C(C(C)=O)O)O)(O)=O,,,4,1,5,8,13
3508_1,,,,2,2,1,3
3509_0,,,,2,2,1,3
3509_1,,,,2,2,1,3
3511_0,,,,2,2,1,3
C(C)(C(C(C)O)(C(C(O)=O)O)O)=O,,,4,1,7,14,21
3511_1,,,,2,2,1,3
3513_0,,,,2,2,1,3
C(C(C(C)=O)(C(C(O)=O)O)O)(O)=O,,,4,1,7,11,18
3513_1,,,,2,2,1,3
3515_0,,,,2,2,1,3
C(C)(C(CO)(C(C(O)=O)O)O)=O,,,4,1,5,14,19
3515_1,,,,2,2,1,3
3517_0,,,,2,2,1,3
C(C(C)(C(C(C)=O)(CO)O)O)(O)=O,,,4,1,5,12,17
3517_1,,,,2,2,1,3
3519_0,,,,2,2,1,3
C(C(C(C)O)(C(C=CC)O)O)(O)=O,,,4,1,4,8,12
3519_1,,,,2,2,1,3
3521_0,,,,2,2,1,3
C(C(C(CC=C)O)(C(C)O)O)(O)=O,,,4,1,4,9,13
3521_1,,,,2,2,1,3
3523_0,,,,2,2,1,3
C(C(C(CO)O)(C(C)O)O)(O)=O,,,4,1,6,11,17
3523_1,,,,2,2,1,3
3525_0,,,,2,2,1,3
C(C(C(C)O)(C(C(C)O)O)O)(O)=O,,,4,1,5,12,17
3525_1,,,,2,2,1,3
3527_0,,,,2,2,1,3
C(C(C(C)O)(C(C(O)=O)O)O)(O)=O,,,4,1,12,13,25
3527_1,,,,2,2,1,3
3529_0,,,,2,2,1,3
C(C(C(C)O)(C(C)O)O)(O)=O,,,4,1,2,5,7
3529_1,,,,2,2,1,3
3531_0,,,,2,2,1,3
C(C(C(O)=O)(C(C)O)O)(O)=O,,,4,1,5,5,10
3531_1,,,,2,2,1,3
3532_0,,,,2,2,1,3
3532_1,,,,2,2,1,3
3533_0,,,,2,2,1,3
3533_1,,,,2,2,1,3
3534_0,,,,2,2,1,3
3534_1,,,,2,2,1,3
3536_0,,,,2,2,1,3
C(C(C(O)=O)(C(C=CC)O)O)(O)=O,,,4,1,5,4,9
3536_1,,,,2,2,1,3
3538_0,,,,2,2,1,3
C(C(C(O)=O)(C(CC=C)O)O)(O)=O,,,4,1,5,5,10
3538_1,,,,2,2,1,3
3540_0,,,,2,2,1,3
C(C(C(O)=O)(C(CO)O)O)(O)=O,,,4,1,7,7,14
3540_1,,,,2,2,1,3
3542_0,,,,2,2,1,3
C(C(C(O)=O)(C(C(C)O)O)O)(O)=O,,,4,1,6,8,14
3542_1,,,,2,2,1,3
3544_0,,,,2,2,1,3
C(C(C(O)=O)(C(C(O)=O)O)O)(O)=O,,,4,1,12,8,20
3544_1,,,,2,2,1,3
3545_0,,,,2,2,1,3
3545_1,,,,2,2,1,3
3547_0,,,,2,2,1,3
C(C(C(O)=O)(C(O)=O)O)(O)=O,,,4,1,3,1,4
3547_1,,,,2,2,1,3
3548_0,,,,2,2,1,3
3548_1,,,,2,2,1,3
3549_0,,,,2,2,1,3
3549_1,,,,2,2,1,3
3550_0,,,,2,2,1,3
3550_1,,,,2,2,1,3
3551_0,,,,2,2,1,3
3551_1,,,,2,2,1,3
3553_0,,,,2,2,1,3
C(C(C(C)=O)(CO)C(CO)O)(O)=O,,,4,1,2,9,11
3555_0,,,,2,2,1,3
C(C(C(C)=O)(CO)C(C)O)(O)=O,,,4,1,1,7,8
3557_0,,,,2,2,1,3
C(C(C(O)=O)(C(C)=O)CO)(O)=O,,,4,1,1,4,5
3559_0,,,,2,2,1,3
C(C(C(C)=O)(CO)CO)(O)=O,,,4,1,1,5,6
3561_0,,,,2,2,1,3
C(C)(C(C(O)=O)(C)C(C=CC)O)=O,,,4,1,1,3,4
3563_0,,,,2,2,1,3
C(C(C(C)=O)(C)C(CC=C)O)(O)=O,,,4,1,1,4,5
3565_0,,,,2,2,1,3
C(C(C(C)=O)(C)C(CO)O)(O)=O,,,4,1,2,8,10
3567_0,,,,2,2,1,3
C(C(C(C)=O)(C)C(C(C)O)O)(O)=O,,,4,1,1,8,9
3569_0,,,,2,2,1,3
C(C)(C(C(O)=O)(C)C(C(O)=O)O)=O,,,4,1,3,7,10
3571_0,,,,2,2,1,3
C(C(C(C)=O)(C)C(C)O)(O)=O,,,4,1,1,6,7
3573_0,,,,2,2,1,3
C(C)(C(C(O)=O)(C(O)=O)C)=O,,,4,1,1,3,4
3575_0,,,,2,2,1,3
C(C(C)(C(C(O)=O)(C(C)=O)C)O)=O,,,4,1,1,7,8
3577_0,,,,2,2,1,3
C(C)(C(C(O)=O)(C)C(C(C)=O)O)=O,,,4,1,1,7,8
3579_0,,,,2,2,1,3
C(C(C(C)=O)(C)CO)(O)=O,,,4,1,1,8,9
3581_0,,,,2,2,1,3
C(C(CO)(C(C=CC)O)O)=O,,,4,1,6,12,18
3581_1,,,,2,2,1,3
3583_0,,,,2,2,1,3
C(C(CO)(C(C=CC)O)O)(O)=O,,,4,1,8,9,17
3583_1,,,,2,2,1,3
3585_0,,,,2,2,1,3
C(C(CO)(C(CC=C)O)O)=O,,,4,1,6,13,19
3585_1,,,,2,2,1,3
3587_0,,,,2,2,1,3
C(C(CO)(C(CC=C)O)O)(O)=O,,,4,1,8,10,18
3587_1,,,,2,2,1,3
3588_0,,,,2,2,1,3
3588_1,,,,2,2,1,3
3589_0,,,,2,2,1,3
3589_1,,,,2,2,1,3
3591_0,,,,2,2,1,3
C(C(CO)(C(C(C)O)O)O)(O)=O,,,4,1,7,11,18
3591_1,,,,2,2,1,3
3592_0,,,,2,2,1,3
3592_1,,,,2,2,1,3
3593_0,,,,2,2,1,3
3593_1,,,,2,2,1,3
3594_0,,,,2,2,1,3
3594_1,,,,2,2,1,3
3596_0,,,,2,2,1,3
C(C(CO)(C(C(CO)O)O)O)=O,,,4,1,8,16,24
3596_1,,,,2,2,1,3
3598_0,,,,2,2,1,3
C(C(CO)(C(CO)O)O)=O,,,4,1,8,14,22
3598_1,,,,2,2,1,3
3600_0,,,,2,2,1,3
C(C(CO)(C(C(C)O)O)O)=O,,,4,1,5,14,19
3600_1,,,,2,2,1,3
3601_0,,,,2,2,1,3
3601_1,,,,2,2,1,3
3603_0,,,,2,2,1,3
C(C(CO)(C(C)O)O)=O,,,4,1,6,17,23
3603_1,,,,2,2,1,3
3604_0,,,,2,2,1,3
3604_1,,,,2,2,1,3
3606_0,,,,2,2,1,3
C(C(CO)(C(CC(C)O)O)O)=O,,,4,1,7,14,21
3606_1,,,,2,2,1,3
3608_0,,,,2,2,1,3
C(C(CO)(C(CC(O)=O)O)O)=O,,,4,1,5,14,19
3608_1,,,,2,2,1,3
3609_0,,,,2,2,1,3
3609_1,,,,2,2,1,3
3611_0,,,,2,2,1,3
C(C(CO)(C(C=O)(CO)O)O)=O,,,4,1,5,10,15
3611_1,,,,2,2,1,3
3613_0,,,,2,2,1,3
C(C(CO)(C(C=O)(C)O)O)=O,,,4,1,6,15,21
3613_1,,,,2,2,1,3
3614_0,,,,2,2,1,3
3614_1,,,,2,2,1,3
3616_0,,,,2,2,1,3
C(C(CO)(CO)O)=O,,,4,1,5,28,33
3616_1,,,,2,2,1,3
3617_0,,,,2,2,1,3
3617_1,,,,2,2,1,3
3618_0,,,,2,2,1,3
3618_1,,,,2,2,1,3
3620_0,,,,2,2,1,3
C(C(CO)(C(C(CO)O)O)O)(O)=O,,,4,1,10,13,23
3620_1,,,,2,2,1,3
3622_0,,,,2,2,1,3
C(C([C](C(O)=O)O)C(CO)O)(O)=O,,,4,1,3,10,13
3624_0,,,,2,2,1,3
C(C(C(CO)O)C(C(O)=O)O)(O)=O,,,4,1,5,12,17
3626_0,,,,2,2,1,3
C(C(CO)(C(CO)O)O)(O)=O,,,4,1,9,10,19
3626_1,,,,2,2,1,3
3628_0,,,,2,2,1,3
C(C(CO)(C(C)O)C[CH]C(O)=O)=O,,,4,1,3,10,13
3630_0,,,,2,2,1,3
C(C(CCC(O)=O)(CO)C(C)O)=O,,,4,1,3,10,13
3632_0,,,,2,2,1,3
C(C(C=O)(CO)C[CH]C(O)=O)(O)=O,,,4,1,3,8,11
3634_0,,,,2,2,1,3
C(C(C=O)(CCC(O)=O)CO)(O)=O,,,4,1,3,8,11
3636_0,,,,2,2,1,3
C(C([C](C(O)=O)O)C(C)O)(O)=O,,,4,1,3,7,10
3638_0,,,,2,2,1,3
C(C(C(O)=O)[C](C(O)=O)O)(O)=O,,,4,1,3,4,7
3640_0,,,,2,2,1,3
C(C([C](C(O)=O)O)CO)(O)=O,,,4,1,3,7,10
3641_0,,,,2,2,1,3
3641_1,,,,2,2,1,3
3642_0,,,,2,2,1,3
3642_1,,,,2,2,1,3
3643_0,,,,2,2,1,3
3644_0,,,,2,2,1,3
3645_0,,,,2,2,1,3
3647_0,,,,2,2,1,3
C(C(C(C)O)C(C(C)=O)(CO)O)=O,,,4,1,5,14,19
3649_0,,,,2,2,1,3
C(C(C)(C(C(CO)C(C)O)O)O)=O,,,4,1,1,11,12
3651_0,,,,2,2,1,3
C(C(C(C(CO)C(C)O)O)O)(O)=O,,,4,1,4,11,15
3653_0,,,,2,2,1,3
C(C(C=O)C(C(C)=O)(CO)O)(O)=O,,,4,1,5,13,18
3655_0,,,,2,2,1,3
C(C(CO)C(C(C=O)(C)O)O)(O)=O,,,4,1,3,12,15
3656_0,,,,2,2,1,3
3658_0,,,,2,2,1,3
C(CO)(C(CO)(CC(C=O)=O)O)=O,,,4,1,2,17,19
3660_0,,,,2,2,1,3
C(CC(C(CO)=O)(C(C=O)O)O)=O,,,4,1,3,19,22
3662_0,,,,2,2,1,3
C(CO)(C(C(CO)O)(CC=O)O)=O,,,4,1,2,15,17
3663_0,,,,2,2,1,3
3664_0,,,,2,2,1,3
3666_0,,,,2,2,1,3
C(CO)(C(CO)(CC=O)O)=O,,,4,1,2,17,19
3668_0,,,,2,2,1,3
C(C(C)(C(C(C(CO)O)=O)O)O)=O,,,4,1,5,17,22
3669_0,,,,2,2,1,3
3671_0,,,,2,2,1,3
C(C(C(CO)O)(C(C=O)(C)O)O)=O,,,4,1,5,17,22
3673_0,,,,2,2,1,3
C(C(C(CO)O)(C(C(O)=O)O)O)=O,,,4,1,9,18,27
3675_0,,,,2,2,1,3
C(C(C)(CC(C(C=O)(C)O)O)O)=O,,,4,1,1,12,13
3677_0,,,,2,2,1,3
C(C(C)(CC(C(C(O)=O)O)O)O)=O,,,4,1,3,15,18
3679_0,,,,2,2,1,3
C(C(C)(C(C(C)(CC=O)O)O)O)=O,,,4,1,2,15,17
3680_0,,,,2,2,1,3
3681_0,,,,2,2,1,3
3682_0,,,,2,2,1,3
3684_0,,,,2,2,1,3
C(C)(C(CO)(CC(C=O)=O)O)=O,,,4,1,2,17,19
3686_0,,,,2,2,1,3
C(C)(C(C(CCO)O)(CC=O)O)=O,,,4,1,1,12,13
3687_0,,,,2,2,1,3
3689_0,,,,2,2,1,3
C(C)(C(C(CO)(C)O)(CC=O)O)=O,,,4,1,3,11,14
3691_0,,,,2,2,1,3
C(CC(C(C)=O)(C(C=CC)O)O)=O,,,4,1,1,8,9
3693_0,,,,2,2,1,3
C(C)(C(C(CC=C)O)(CC=O)O)=O,,,4,1,1,9,10
3695_0,,,,2,2,1,3
C(C)(C(C(CO)O)(CC=O)O)=O,,,4,1,4,15,19
3697_0,,,,2,2,1,3
C(C)(C(C(C(C)O)O)(CC=O)O)=O,,,4,1,1,13,14
3699_0,,,,2,2,1,3
C(C(C(C(C)=O)(CC=O)O)O)(O)=O,,,4,1,5,13,18
3700_0,,,,2,2,1,3
3701_0,,,,2,2,1,3
3703_0,,,,2,2,1,3
C(CC(C(C)=O)(C(C=O)(C)O)O)=O,,,4,1,3,12,15
3704_0,,,,2,2,1,3
3706_0,,,,2,2,1,3
C(C)(C(CO)(CC=O)O)=O,,,4,1,7,22,29
3708_0,,,,2,2,1,3
C(C(C)(C(CC(C(C)=O)O)O)O)=O,,,4,1,1,13,14
3710_0,,,,2,2,1,3
C(C(C(CC(C(C)=O)O)O)O)(O)=O,,,4,1,3,14,17
3712_0,,,,2,2,1,3
C(C(C)(C(C)(C(CC=O)O)O)O)=O,,,4,1,2,14,16
3713_0,,,,2,2,1,3
3715_0,,,,2,2,1,3
C(C)(C(CO)(CC(C(O)=O)=O)O)=O,,,4,1,3,13,16
3717_0,,,,2,2,1,3
C(C(CCO)(C(C=O)(C)O)O)=O,,,4,1,2,13,15
3719_0,,,,2,2,1,3
C(C(C)(C(C=O)(CCO)O)O)(O)=O,,,4,1,3,11,14
3721_0,,,,2,2,1,3
C(C(CCO)(C(C(O)=O)O)O)=O,,,4,1,5,13,18
3723_0,,,,2,2,1,3
C(C(C)(C(C(CCO)=O)O)O)=O,,,4,1,4,15,19
3724_0,,,,2,2,1,3
3725_0,,,,2,2,1,3
3727_0,,,,2,2,1,3
C(C(CC(C)O)(C(C=O)(C)O)O)=O,,,4,1,2,12,14
3729_0,,,,2,2,1,3
C(C(CC(C)O)(C(C(O)=O)O)O)=O,,,4,1,4,13,17
3731_0,,,,2,2,1,3
C(C(C)(C(C(CC(C)O)=O)O)O)=O,,,4,1,4,14,18
3732_0,,,,2,2,1,3
3734_0,,,,2,2,1,3
C(CC(C=O)(C(C=O)(C)O)O)(O)=O,,,4,1,2,11,13
3736_0,,,,2,2,1,3
C(CC(C=O)(C(C(O)=O)O)O)(O)=O,,,4,1,5,12,17
3738_0,,,,2,2,1,3
C(C(C)(C(C(CC(O)=O)=O)O)O)=O,,,4,1,4,15,19
3739_0,,,,2,2,1,3
3741_0,,,,2,2,1,3
C(C(C)=O)(C(C)(C(CCO)O)O)=O,,,4,1,1,10,11
3743_0,,,,2,2,1,3
C(C(C)(C(CCO)O)O)=O,,,4,1,1,10,11
3745_0,,,,2,2,1,3
C(C(C)(C(CCO)O)O)(O)=O,,,4,1,4,7,11
3747_0,,,,2,2,1,3
C(C(C(CCO)O)O)(O)=O,,,4,1,10,14,24
3749_0,,,,2,2,1,3
C(C(CCO)(C(C=O)(C)O)O)(O)=O,,,4,1,3,11,14
3751_0,,,,2,2,1,3
C(C(CCO)(C(C(O)=O)O)O)(O)=O,,,4,1,6,11,17
3752_0,,,,2,2,1,3
3753_0,,,,2,2,1,3
3755_0,,,,2,2,1,3
C(CC(C(C)(C(C=O)(C)O)O)=O)=O,,,4,1,2,12,14
3757_0,,,,2,2,1,3
C(C(C)(C(C(O)=O)O)O)(CC=O)=O,,,4,1,4,14,18
3759_0,,,,2,2,1,3
C(C(C)(C(CC(C(C)=O)=O)O)O)=O,,,4,1,2,11,13
3761_0,,,,2,2,1,3
C(C(C(CC(C(C)=O)=O)O)O)(O)=O,,,4,1,4,14,18
3763_0,,,,2,2,1,3
C(C(C(C(C(CO)=O)=O)(C)O)O)=O,,,4,1,1,16,17
3765_0,,,,2,2,1,3
C(C(CO)=O)(C(C)(C(CO)O)O)=O,,,4,1,2,12,14
3767_0,,,,2,2,1,3
C(C(CO)=O)(C(C)(C(C)O)O)=O,,,4,1,1,10,11
3768_0,,,,2,2,1,3
3770_0,,,,2,2,1,3
C(C(CO)=O)(C(CO)(C)O)=O,,,4,1,3,11,14
3772_0,,,,2,2,1,3
C(C(C(C(C(C)=O)=O)(C)O)O)=O,,,4,1,1,16,17
3774_0,,,,2,2,1,3
C(C(C)=O)(C(C)(C(CO)(C)O)O)=O,,,4,1,2,9,11
3776_0,,,,2,2,1,3
C(C)=CC(C(C(C(C)=O)=O)(C)O)O,,,4,1,1,6,7
3778_0,,,,2,2,1,3
C(CC(C(C(C(C)=O)=O)(C)O)O)=C,,,4,1,1,7,8
3780_0,,,,2,2,1,3
C(C(C)=O)(C(C)(C(CO)O)O)=O,,,4,1,2,12,14
3782_0,,,,2,2,1,3
C(C(C)=O)(C(C)(C(C(C)O)O)O)=O,,,4,1,1,11,12
3784_0,,,,2,2,1,3
C(C(C(C(C(C)=O)=O)(C)O)O)(O)=O,,,4,1,3,11,14
3786_0,,,,2,2,1,3
C(C(C)=O)(C(C)(C(C)O)O)=O,,,4,1,1,10,11
3787_0,,,,2,2,1,3
3789_0,,,,2,2,1,3
C(C(C)(C(C(C(C)=O)=O)(C)O)O)=O,,,4,1,1,10,11
3791_0,,,,2,2,1,3
C(C(C(C(C(C)=O)=O)(C)O)O)(C)=O,,,4,1,1,12,13
3793_0,,,,2,2,1,3
C(C(C)=O)(C(CO)(C)O)=O,,,4,1,4,13,17
3795_0,,,,2,2,1,3
C(C(C)(C(C(C)=O)(C(C)O)O)O)=O,,,4,1,5,14,19
3796_0,,,,2,2,1,3
3798_0,,,,2,2,1,3
C(C(C)(C(C=O)(C)O)O)(C(C)O)=O,,,4,1,1,11,12
3800_0,,,,2,2,1,3
C(C(C)(C(C(O)=O)O)O)(C(C)O)=O,,,4,1,3,11,14
3802_0,,,,2,2,1,3
C(C(C)(C(C(O)=O)(C(C)=O)O)O)=O,,,4,1,5,11,16
3803_0,,,,2,2,1,3
3805_0,,,,2,2,1,3
C(C(C)(C(C(C(O)=O)=O)(C)O)O)=O,,,4,1,2,12,14
3807_0,,,,2,2,1,3
C(C(C(C(C(O)=O)=O)(C)O)O)(O)=O,,,4,1,4,13,17
3808_0,,,,2,2,1,3
3809_0,,,,2,2,1,3
3810_0,,,,2,2,1,3
3811_0,,,,2,2,1,3
3812_0,,,,2,2,1,3
3814_0,,,,2,2,1,3
C(C(CO)(CC(C(C)=O)=O)O)(O)=O,,,4,1,2,10,12
3816_0,,,,2,2,1,3
C(C(C)(C(C(C=O)O)O)O)=O,,,4,1,6,20,26
3817_0,,,,2,2,1,3
3818_0,,,,2,2,1,3
3819_0,,,,2,2,1,3
3820_0,,,,2,2,1,3
3822_0,,,,2,2,1,3
C(C(C(C(C(O)=O)O)O)O)(O)=O,,,4,1,7,7,14
3824_0,,,,2,2,1,3
C(C(C)(C(CO)(CO)O)O)=O,,,4,1,3,7,10
3825_0,,,,2,2,1,3
3826_0,,,,2,2,1,3
3828_0,,,,2,2,1,3
C(C(C)(C(CO)(C)O)O)=O,,,4,1,2,9,11
3829_0,,,,2,2,1,3
3830_0,,,,2,2,1,3
3832_0,,,,2,2,1,3
C(C(C)(C(C(C=O)(C)O)O)O)(O)=O,,,4,1,2,12,14
3833_0,,,,2,2,1,3
3835_0,,,,2,2,1,3
C(C(C)C(C)(C(C=O)(C)O)O)(O)=O,,,4,1,1,8,9
3837_0,,,,2,2,1,3
C(C(C)C(C)(C(C(O)=O)O)O)(O)=O,,,4,1,3,8,11
3839_0,,,,2,2,1,3
C(C(C)(C(C=CC)O)O)=O,,,4,1,3,9,12
3841_0,,,,2,2,1,3
C(C(C)(C(C=CC)O)O)(O)=O,,,4,1,3,6,9
3843_0,,,,2,2,1,3
C(C(C(C=CC)O)O)(O)=O,,,4,1,9,13,22
3845_0,,,,2,2,1,3
C(C(C)(C(CC=C)O)O)=O,,,4,1,2,10,12
3847_0,,,,2,2,1,3
C(C(C)(C(CC=C)O)O)(O)=O,,,4,1,3,7,10
3849_0,,,,2,2,1,3
C(C(C(CC=C)O)O)(O)=O,,,4,1,8,14,22
3851_0,,,,2,2,1,3
C(C(C)(C(C(O)=O)(C=CC)O)O)=O,,,4,1,2,8,10
3853_0,,,,2,2,1,3
C(C(C=CC)(C(C(O)=O)O)O)(O)=O,,,4,1,4,8,12
3855_0,,,,2,2,1,3
C(C(C)(C(C(O)=O)(CC=C)O)O)=O,,,4,1,2,8,10
3857_0,,,,2,2,1,3
C(C(C(C(O)=O)(CC=C)O)O)(O)=O,,,4,1,4,8,12
3859_0,,,,2,2,1,3
C(C(C)(C(CC(C(O)=O)=C)O)O)=O,,,4,1,1,10,11
3861_0,,,,2,2,1,3
C(C(C(CC(C(O)=O)=C)O)O)(O)=O,,,4,1,3,10,13
3863_0,,,,2,2,1,3
C(C(C)(C(C=C(C(O)=O)C)O)O)=O,,,4,1,1,5,6
3865_0,,,,2,2,1,3
C(C(C(C=C(C(O)=O)C)O)O)(O)=O,,,4,1,3,5,8
3867_0,,,,2,2,1,3
C(C(C=C(C(O)=O)C)(CO)O)(O)=O,,,4,1,1,3,4
3869_0,,,,2,2,1,3
C(C(CO)(CC(C(O)=O)=C)O)(O)=O,,,4,1,1,8,9
3871_0,,,,2,2,1,3
C(C(C)(C(C(CO)O)O)O)=O,,,4,1,4,12,16
3873_0,,,,2,2,1,3
C(C(C)(C(C(CO)O)O)O)(O)=O,,,4,1,6,10,16
3875_0,,,,2,2,1,3
C(C(C(C(CO)O)O)O)(O)=O,,,4,1,13,13,26
3877_0,,,,2,2,1,3
C(C(C)(C(CO)O)O)=O,,,4,1,3,15,18
3879_0,,,,2,2,1,3
C(C(C(CO)O)(CC(C)O)O)(O)=O,,,4,1,3,10,13
3881_0,,,,2,2,1,3
C(C(C(CO)O)(CC(O)=O)O)(O)=O,,,4,1,4,10,14
3882_0,,,,2,2,1,3
3883_0,,,,2,2,1,3
3885_0,,,,2,2,1,3
C1(C(CC(C)O1)(C(C=O)(C)O)O)=O,,,4,1,2,6,8
3887_0,,,,2,2,1,3
C1(C(CC(C)O1)(C(C(O)=O)O)O)=O,,,4,1,4,7,11
3889_0,,,,2,2,1,3
C1(CC(C(O1)=O)(C(C=O)(C)O)O)=O,,,4,1,2,7,9
3891_0,,,,2,2,1,3
C1(CC(C(O1)=O)(C(C(O)=O)O)O)=O,,,4,1,4,9,13
3893_0,,,,2,2,1,3
C1(C(CO)(CC(C(O)=O)(C)O1)O)=O,,,4,1,2,5,7
3895_0,,,,2,2,1,3
C1(C(C)(CC(C(O)=O)(CO)O1)O)=O,,,4,1,2,4,6
3897_0,,,,2,2,1,3
C1(C(CO)(CC(C(O1)=O)(C)O)O)=O,,,4,1,1,8,9
3899_0,,,,2,2,1,3
[CH](C(O)=O)CC(C(C=O)=O)(CO)O,,,4,1,2,13,15
3901_0,,,,2,2,1,3
C(CCC(C(C=O)=O)(CO)O)(O)=O,,,4,1,2,13,15
3903_0,,,,2,2,1,3
C(C(C(C)O)(C[CH]C(O)=O)O)(O)=O,,,4,1,2,9,11
3905_0,,,,2,2,1,3
C(C(C(O)=O)(C[CH]C(O)=O)O)(O)=O,,,4,1,3,5,8
3906_0,,,,2,2,1,3
3908_0,,,,2,2,1,3
C(C(CCC(O)=O)(C(C)O)O)(O)=O,,,4,1,2,9,11
3910_0,,,,2,2,1,3
C(C(C(O)=O)(CCC(O)=O)O)(O)=O,,,4,1,4,5,9
3911_0,,,,2,2,1,3
3913_0,,,,2,2,1,3
C(C(C)(C(CC[CH]C(O)=O)O)O)=O,,,4,1,2,9,11
3915_0,,,,2,2,1,3
C(C(C(CC[CH]C(O)=O)O)O)(O)=O,,,4,1,4,9,13
3917_0,,,,2,2,1,3
C(C(CO)(CC[CH]C(O)=O)O)(O)=O,,,4,1,3,8,11
3919_0,,,,2,2,1,3
C(C(C)(C(CCCC(O)=O)O)O)=O,,,4,1,2,9,11
3921_0,,,,2,2,1,3
C(CCCC(C(C(O)=O)O)O)(O)=O,,,4,1,4,9,13
3923_0,,,,2,2,1,3
C(C(CO)(CCCC(O)=O)O)(O)=O,,,4,1,3,8,11
3925_0,,,,2,2,1,3
C(C(C)(C(C(C)O)O)O)=O,,,4,1,1,11,12
3926_0,,,,2,2,1,3
3928_0,,,,2,2,1,3
C(C(C)(C(C)O)O)=O,,,4,1,4,37,41
3929_0,,,,2,2,1,3
3931_0,,,,2,2,1,3
C(C(C)(C(CC(C)O)O)O)=O,,,4,1,3,10,13
3933_0,,,,2,2,1,3
C(C(C)(C(CC(O)=O)O)O)=O,,,4,1,2,10,12
3934_0,,,,2,2,1,3
3935_0,,,,2,2,1,3
3937_0,,,,2,2,1,3
C(C(C)(C(C=O)(C)O)O)=O,,,4,1,3,6,9
3938_0,,,,2,2,1,3
3940_0,,,,2,2,1,3
C(C(CO)(C)O)=O,,,4,1,3,62,65
3941_0,,,,2,2,1,3
3942_0,,,,2,2,1,3
3944_0,,,,2,2,1,3
C(C(C)(C(C(C)O)O)O)(O)=O,,,4,1,2,8,10
3945_0,,,,2,2,1,3
3946_0,,,,2,2,1,3
3947_0,,,,2,2,1,3
3949_0,,,,2,2,1,3
C(C(C(C)O)(CC(C)O)O)(O)=O,,,4,1,2,8,10
3951_0,,,,2,2,1,3
C(C(C(O)=O)(CC(C)O)O)(O)=O,,,4,1,2,5,7
3953_0,,,,2,2,1,3
C(C(CO)(CC(C)O)O)(O)=O,,,4,1,1,7,8
3955_0,,,,2,2,1,3
C(C(C(C)O)(CC(O)=O)O)(O)=O,,,4,1,2,7,9
3957_0,,,,2,2,1,3
C(C(C(O)=O)(CC(O)=O)O)(O)=O,,,4,1,2,3,5
3958_0,,,,2,2,1,3
3959_0,,,,2,1,2,3
3959_1,,,,2,1,2,3
3960_0,,,,2,1,2,3
3960_1,,,,2,1,2,3
3961_0,,,,2,1,2,3
3961_1,,,,2,1,2,3
3962_0,,,,2,1,2,3
3962_1,,,,2,1,2,3
3963_0,,,,2,1,2,3
3963_1,,,,2,1,2,3
3964_0,,,,2,1,2,3
3964_1,,,,2,1,2,3
3965_0,,,,2,1,2,3
3965_1,,,,2,1,2,3
3966_0,,,,2,1,2,3
3966_1,,,,2,1,2,3
3967_0,,,,2,1,2,3
3967_1,,,,2,1,2,3
3968_0,,,,2,1,2,3
3968_1,,,,2,1,2,3
3969_0,,,,2,1,2,3
3969_1,,,,2,1,2,3
3970_0,,,,2,1,2,3
3970_1,,,,2,1,2,3
3971_0,,,,2,1,2,3
3971_1,,,,2,1,2,3
3972_0,,,,2,1,2,3
3972_1,,,,2,1,2,3
3973_0,,,,2,1,2,3
3973_1,,,,2,1,2,3
3974_0,,,,2,1,2,3
3974_1,,,,2,1,2,3
3975_0,,,,2,1,2,3
3975_1,,,,2,1,2,3
3977_0,,,,2,1,1,2
C(C(COC(C(C)=O)=O)O)(O)=O,,,4,1,2,5,7
3977_1,,,,2,1,1,2
3979_0,,,,2,1,1,2
C(C(CO)O)(OC(C(C)=O)=O)=O,,,4,1,4,6,10
3979_1,,,,2,1,1,2
3981_0,,,,2,1,2,3
C1(C(C)(C(C(O1)=O)O)O)=O,,,4,1,3,10,13
3981_1,,,,2,1,2,3
3982_0,,,,2,1,2,3
3983_0,,,,2,1,2,3
3984_0,,,,2,1,2,3
3985_0,,,,2,1,2,3
3986_0,,,,2,1,2,3
3987_0,,,,2,1,2,3
3988_0,,,,2,1,2,3
3989_0,,,,2,1,2,3
3990_0,,,,2,1,2,3
3991_0,,,,2,1,2,3
3992_0,,,,2,1,2,3
3993_0,,,,2,1,2,3
3994_0,,,,2,1,2,3
3995_0,,,,2,1,2,3
3996_0,,,,2,1,2,3
3997_0,,,,2,1,2,3
3998_0,,,,2,1,2,3
3999_0,,,,2,1,2,3
4000_0,,,,2,1,2,3
4001_0,,,,2,1,2,3
4002_0,,,,2,1,2,3
4003_0,,,,2,1,2,3
4004_0,,,,2,1,2,3
4005_0,,,,2,1,2,3
4006_0,,,,2,1,2,3
4008_0,,,,2,1,2,3
C(C(C=C)O)(O)=O,,,4,1,7,48,55
4010_0,,,,2,1,2,3
C(C(C(C(O)=O)=C)O)(O)=O,,,4,1,5,13,18
4012_0,,,,2,1,2,3
C=C(C=O)C(O)=O,,,4,1,7,137,144
4013_0,,,,2,1,2,3
4014_0,,,,2,1,2,3
4015_0,,,,2,1,2,3
4017_0,,,,2,1,1,2
C(C(C=O)(C)OC(CO)=O)(O)=O,,,4,1,1,4,5
4019_0,,,,2,1,1,2
C(C(C=O)O)(OC(C(O)=O)C)=O,,,4,1,1,5,6
4021_0,,,,2,1,1,2
C(C(C=O)(C)O)(OC(CO)=O)=O,,,4,1,1,4,5
4023_0,,,,2,1,1,2
C(C(C=O)O)(OC(C(C)O)=O)=O,,,4,1,2,6,8
4025_0,,,,2,1,1,2
C(C(C)O)(OCC(C(O)=O)=O)=O,,,4,1,1,5,6
4027_0,,,,2,1,1,2
C(C(C)O)(OC(C(CO)=O)=O)=O,,,4,1,2,3,5
4029_0,,,,2,1,1,2
C(C(C)O)(OC(C(C)=O)=O)=O,,,4,1,1,5,6
4031_0,,,,2,1,1,2
C(C(C=O)(C)O)(OCC(O)=O)=O,,,4,1,1,4,5
4033_0,,,,2,1,1,2
C(C(C=O)OC(C(C)O)=O)(O)=O,,,4,1,1,6,7
4034_0,,,,2,1,2,3
4035_0,,,,2,1,2,3
4036_0,,,,2,1,2,3
4037_0,,,,2,1,2,3
4039_0,,,,2,1,2,3
[CH](C(O)=O)O,,,4,1,19,237,256
4041_0,,,,2,1,2,3
C(C(C(CCC(C)O)=O)=O)=O,,,4,1,1,13,14
4043_0,,,,2,1,2,3
C(CC(C)O)(CC(C=O)=O)=O,,,4,1,3,19,22
4045_0,,,,2,1,2,3
C(C(C(CCC(C)O)=O)=O)(O)=O,,,4,1,2,11,13
4047_0,,,,2,1,2,3
C(CC(C)O)(CC(C(O)=O)=O)=O,,,4,1,4,12,16
4049_0,,,,2,1,2,3
C(C(C=O)C(C=O)C(C)O)=O,,,4,1,2,13,15
4051_0,,,,2,1,2,3
C(C(C=O)C(C=O)C(C)O)(O)=O,,,4,1,3,15,18
4053_0,,,,2,1,2,3
C(CCC(C(C=O)=O)=O)(O)=O,,,4,1,3,10,13
4055_0,,,,2,1,2,3
C(CC(CC(C=O)=O)=O)(O)=O,,,4,1,4,18,22
4057_0,,,,2,1,2,3
C(CCC(C(C(O)=O)=O)=O)(O)=O,,,4,1,3,8,11
4059_0,,,,2,1,2,3
C(CC(CC(C(O)=O)=O)=O)(O)=O,,,4,1,6,11,17
4061_0,,,,2,1,2,3
C(C(C=O)C(C=O)C(O)=O)=O,,,4,1,3,11,14
4063_0,,,,2,1,2,3
C(C(C(O)=O)C(C=O)C(O)=O)=O,,,4,1,3,7,10
4065_0,,,,2,1,2,3
C(CO)(CC(C(C=O)=O)=O)=O,,,4,1,1,19,20
4066_0,,,,2,1,2,3
4068_0,,,,2,1,2,3
C(CO)(CC(C(C(O)=O)=O)=O)=O,,,4,1,4,13,17
4069_0,,,,2,1,2,3
4071_0,,,,2,1,2,3
C(C(C(C(C=O)=O)=O)CO)=O,,,4,1,1,15,16
4073_0,,,,2,1,2,3
C(C(C=O)C(C(C=O)=O)O)=O,,,4,1,3,15,18
4075_0,,,,2,1,2,3
C(C(C=O)CC(C=O)=O)=O,,,4,1,1,22,23
4077_0,,,,2,1,2,3
C(C(C(C(C(O)=O)=O)=O)CO)=O,,,4,1,2,14,16
4079_0,,,,2,1,2,3
C(C(C=O)C(C(C(O)=O)=O)O)=O,,,4,1,4,11,15
4081_0,,,,2,1,2,3
C(C(C=O)CC=O)=O,,,4,1,5,92,97
4083_0,,,,2,1,2,3
C(C(C=O)CC(C(O)=O)=O)=O,,,4,1,2,10,12
4085_0,,,,2,1,2,3
C(C(C(C(C=O)=O)=O)C)=O,,,4,1,1,19,20
4086_0,,,,2,1,2,3
4088_0,,,,2,1,2,3
C(C)(CC(C(C=O)=O)=O)=O,,,4,1,1,28,29
4090_0,,,,2,1,2,3
C(CC(C=O)=O)=O,,,4,1,12,265,277
4091_0,,,,2,1,2,3
4093_0,,,,2,1,2,3
C(C(C=O)C(C(C=O)=O)O)(O)=O,,,4,1,6,17,23
4095_0,,,,2,1,2,3
C(C(C(C(C=O)=O)=O)CO)(O)=O,,,4,1,2,15,17
4097_0,,,,2,1,2,3
C(C)(CC(C=O)=O)=O,,,4,1,9,133,142
4099_0,,,,2,1,2,3
C(C(C(CC)=O)=O)=O,,,4,1,4,90,94
4100_0,,,,2,1,2,3
4102_0,,,,2,1,2,3
C(C(C(C(C(O)=O)=O)=O)C)=O,,,4,1,2,10,12
4104_0,,,,2,1,2,3
C(C)(CC(C(C(O)=O)=O)=O)=O,,,4,1,4,12,16
4105_0,,,,2,1,2,3
4107_0,,,,2,1,2,3
C(C(C(O)=O)CC(C=O)=O)=O,,,4,1,3,15,18
4108_0,,,,2,1,2,3
4110_0,,,,2,1,2,3
C(CC(C(O)=O)=O)=O,,,4,1,10,84,94
4112_0,,,,2,1,2,3
C(C(C(O)=O)CC=O)=O,,,4,1,7,29,36
4114_0,,,,2,1,2,3
C(C(C(O)=O)CC(C(O)=O)=O)=O,,,4,1,4,12,16
4116_0,,,,2,1,2,3
C(C)(CC(C(O)=O)=O)=O,,,4,1,8,33,41
4118_0,,,,2,1,2,3
C(C(C(O)=O)=O)(CC)=O,,,4,1,4,19,23
4120_0,,,,2,1,2,3
C(C(C(C(C(O)=O)=O)=O)C)(O)=O,,,4,1,4,9,13
4121_0,,,,2,1,2,3
4122_0,,,,2,1,2,3
4123_0,,,,2,1,2,3
4124_0,,,,2,1,2,3
4125_0,,,,2,1,2,3
4126_0,,,,2,1,2,3
4127_0,,,,2,1,2,3
4128_0,,,,2,1,2,3
4130_0,,,,2,1,2,3
C(C(C(C(CO)=O)=O)CO)(O)=O,,,4,1,7,12,19
4131_0,,,,2,1,2,3
4133_0,,,,2,1,2,3
C(C(C=O)C(C(O)=O)(CO)O)=O,,,4,1,5,11,16
4134_0,,,,2,1,2,3
4135_0,,,,2,1,2,3
4137_0,,,,2,1,2,3
C(C(C(C(C)=O)=O)CO)(O)=O,,,4,1,9,12,21
4138_0,,,,2,1,2,3
4140_0,,,,2,1,2,3
C(C(CCC(C)O)=O)(O)=O,,,4,1,2,13,15
4142_0,,,,2,1,2,3
C(CC(CC(C)O)=O)(O)=O,,,4,1,4,21,25
4143_0,,,,2,1,2,3
4145_0,,,,2,1,2,3
C(CCC(C(O)=O)=O)(O)=O,,,4,1,3,10,13
4147_0,,,,2,1,2,3
C(CC(CC(O)=O)=O)(O)=O,,,4,1,4,11,15
4148_0,,,,2,1,2,3
4149_0,,,,2,1,2,3
4151_0,,,,2,1,2,3
C(CC(C(CO)=O)=O)(O)=O,,,4,1,6,22,28
4153_0,,,,2,1,2,3
C(C(C(C(CO)=O)=O)C)(O)=O,,,4,1,2,11,13
4155_0,,,,2,1,2,3
C(C(C(C(O)=O)=O)CO)=O,,,4,1,5,17,22
4157_0,,,,2,1,2,3
C(C(C=O)C(C(O)=O)O)=O,,,4,1,4,16,20
4159_0,,,,2,1,2,3
C(C(C=O)C(C(O)=O)(C)O)=O,,,4,1,3,10,13
4161_0,,,,2,1,2,3
C(C(C(C(O)=O)=O)C)=O,,,4,1,1,22,23
4162_0,,,,2,1,2,3
4163_0,,,,2,1,2,3
4165_0,,,,2,1,2,3
C(C(C(C(C)=O)=O)C)(O)=O,,,4,1,1,14,15
4167_0,,,,2,1,2,3
C(C(C(O)=O)C)=O,,,4,1,4,98,102
4168_0,,,,2,1,2,3
4169_0,,,,2,1,2,3
4170_0,,,,2,1,2,3
4172_0,,,,2,1,2,3
C(C(O)=O)(CC)=O,,,4,1,3,97,100
4174_0,,,,2,1,2,3
C(C(C(C(O)=O)=O)C)(O)=O,,,4,1,3,11,14
4175_0,,,,2,1,2,3
4176_0,,,,2,1,2,3
4178_0,,,,2,1,2,3
C(CC(C(C(O)=O)=C)=O)(O)=O,,,4,1,4,10,14
4179_0,,,,2,1,2,3
4181_0,,,,2,1,2,3
C(C)(C(C)O)=O,,,4,1,8,339,347
4183_0,,,,2,1,2,3
C(CO)(CC)=O,,,4,1,7,428,435
4184_0,,,,2,1,2,3
4185_0,,,,2,1,2,3
4186_0,,,,2,1,2,3
4187_0,,,,2,1,2,3
4188_0,,,,2,1,2,3
4190_0,,,,2,1,2,3
C(C(CC(C)=O)O)(O)=O,,,4,1,5,37,42
4191_0,,,,2,1,2,3
4192_0,,,,2,1,2,3
4193_0,,,,2,1,2,3
4194_0,,,,2,1,2,3
4196_0,,,,2,1,2,3
C(CC(CC(C(O)=O)=O)=O)=O,,,4,1,2,15,17
4197_0,,,,2,1,2,3
4199_0,,,,2,1,2,3
C(CC=O)=O,,,4,1,23,700,723
4200_0,,,,2,1,2,3
4202_0,,,,2,1,2,3
C(C1(C(CC(O1)=O)=O)C)(O)=O,,,4,1,3,4,7
4203_0,,,,2,1,2,3
4205_0,,,,2,1,2,3
C1(C(C(CC(O1)=O)=O)(C)O)=O,,,4,1,2,5,7
4207_0,,,,2,1,2,3
C1(C(C(C(C(O1)=O)O)=O)C)=O,,,4,1,3,6,9
4208_0,,,,2,1,2,3
4210_0,,,,2,1,2,3
C1(C(C=O)C(C(O1)=O)(C)O)=O,,,4,1,2,8,10
4212_0,,,,2,1,2,3
C(C1C(C(C(O1)=O)C)=O)(O)=O,,,4,1,4,6,10
4213_0,,,,2,1,2,3
4214_0,,,,2,1,2,3
4216_0,,,,2,1,2,3
C(CC(C[CH]C(O)=O)=O)(O)=O,,,4,1,2,9,11
4217_0,,,,2,1,2,3
4218_0,,,,2,1,2,3
4219_0,,,,2,1,2,3
4220_0,,,,2,1,2,3
4222_0,,,,2,1,2,3
C(CC(CCC(O)=O)=O)(O)=O,,,4,1,2,9,11
4223_0,,,,2,1,2,3
4224_0,,,,2,1,2,3
4226_0,,,,2,1,2,3
C([CH]C(O)=O)=O,,,4,1,2,103,105
4228_0,,,,2,1,2,3
C(C1CC(C(C=1)=O)=O)(O)=O,,,4,1,1,21,22
4230_0,,,,2,1,2,3
C(C)=C(C=O)C(CC(C)O)O,,,4,1,1,12,13
4232_0,,,,2,1,2,3
C(CC(C)O)=C(C=O)C(C)O,,,4,1,1,9,10
4233_0,,,,2,1,2,3
4235_0,,,,2,1,2,3
C(C(C=CC(C)O)C(C)O)=O,,,4,1,2,10,12
4236_0,,,,2,1,2,3
4237_0,,,,2,1,2,3
4239_0,,,,2,1,2,3
C(CC(C)O)=C(C(O)=O)C=O,,,4,1,1,8,9
4241_0,,,,2,1,2,3
C(C(C=O)C=CC(C)O)(O)=O,,,4,1,3,10,13
4242_0,,,,2,1,2,3
4243_0,,,,2,1,2,3
4245_0,,,,2,1,2,3
C(C(C(C=O)=O)O)=CC(C)O,,,4,1,1,11,12
4246_0,,,,2,1,2,3
4247_0,,,,2,1,2,3
4249_0,,,,2,1,2,3
C(CC(C)O)=CC(C=O)=O,,,4,1,1,18,19
4251_0,,,,2,1,2,3
C(CC(C=O)=O)=CC(C)O,,,4,1,1,18,19
4252_0,,,,2,1,2,3
4253_0,,,,2,1,2,3
4255_0,,,,2,1,2,3
C(C(C(C(O)=O)=O)O)=CC(C)O,,,4,1,2,7,9
4256_0,,,,2,1,2,3
4257_0,,,,2,1,2,3
4259_0,,,,2,1,2,3
C(CC(C)O)=CC=O,,,4,1,4,74,78
4261_0,,,,2,1,2,3
C(CC=CC(C)O)=O,,,4,1,7,59,66
4262_0,,,,2,1,2,3
4263_0,,,,2,1,2,3
4265_0,,,,2,1,2,3
C(CC(C)O)=CC(C(O)=O)=O,,,4,1,2,8,10
4267_0,,,,2,1,2,3
C(CC(C(O)=O)=O)=CC(C)O,,,4,1,2,8,10
4268_0,,,,2,1,2,3
4269_0,,,,2,1,2,3
4271_0,,,,2,1,2,3
C(C(C=CC(O)=O)C(C)O)=O,,,4,1,2,11,13
4273_0,,,,2,1,2,3
C(CC=C(C=O)C(C)O)(O)=O,,,4,1,1,7,8
4275_0,,,,2,1,2,3
C(CC(C(C=O)=CC)O)(O)=O,,,4,1,1,9,10
4276_0,,,,2,1,2,3
4278_0,,,,2,1,2,3
C(C(C(C)O)=CC(CO)=O)=O,,,4,1,1,13,14
4280_0,,,,2,1,2,3
C(CO)(C(C(C=O)=CC)O)=O,,,4,1,1,15,16
4281_0,,,,2,1,2,3
4283_0,,,,2,1,2,3
C(C(C(C)O)=C(C=O)CO)=O,,,4,1,1,11,12
4285_0,,,,2,1,2,3
C(C(C(C=O)=CC)(CO)O)=O,,,4,1,1,12,13
4286_0,,,,2,1,2,3
4288_0,,,,2,1,2,3
C(C(C(C=O)=C)C(C)O)=O,,,4,1,2,25,27
4290_0,,,,2,1,2,3
C(C(C(C)O)=C(C=O)C)=O,,,4,1,1,21,22
4292_0,,,,2,1,2,3
C(C(C(C=O)=CC)(C)O)=O,,,4,1,2,16,18
4293_0,,,,2,1,2,3
4295_0,,,,2,1,2,3
C(C(C(C)O)=CC(C)=O)=O,,,4,1,1,25,26
4297_0,,,,2,1,2,3
C(C)(C(C(C=O)=CC)O)=O,,,4,1,2,26,28
4298_0,,,,2,1,2,3
4300_0,,,,2,1,2,3
C=C(C=O)C(C)O,,,4,1,6,166,172
4302_0,,,,2,1,2,3
C(C)=C(C=O)CO,,,4,1,4,165,169
4303_0,,,,2,1,2,3
4305_0,,,,2,1,2,3
C(C(CO)=C(C=O)C(C)O)(O)=O,,,4,1,2,6,8
4307_0,,,,2,1,2,3
C(C(C(C=O)=CC)(CO)O)(O)=O,,,4,1,2,11,13
4308_0,,,,2,1,2,3
4309_0,,,,2,1,2,3
4311_0,,,,2,1,2,3
C(C)=C(C=O)C(C)O,,,4,1,4,74,78
4313_0,,,,2,1,2,3
C(C)=C(C=O)C(O)=O,,,4,1,3,63,66
4314_0,,,,2,1,2,3
4315_0,,,,2,1,2,3
4317_0,,,,2,1,2,3
C(C(C)=C(C=O)C(C)O)(O)=O,,,4,1,2,8,10
4319_0,,,,2,1,2,3
C(C(C(C=O)=CC)(C)O)(O)=O,,,4,1,2,10,12
4320_0,,,,2,1,2,3
4322_0,,,,2,1,2,3
C(C(CC(C)O)=CC=O)(O)=O,,,4,1,1,10,11
4324_0,,,,2,1,2,3
C(CC(C(O)=O)=CC(C)O)=O,,,4,1,1,9,10
4325_0,,,,2,1,2,3
4326_0,,,,2,1,2,3
4328_0,,,,2,1,2,3
C=C(C(C(O)=O)=O)C(C)O,,,4,1,1,13,14
4330_0,,,,2,1,2,3
C(C)=C(C(C(O)=O)=O)CO,,,4,1,2,12,14
4331_0,,,,2,1,2,3
4332_0,,,,2,1,2,3
4334_0,,,,2,1,2,3
C(C)=C(C(C(O)=O)=O)C(C)O,,,4,1,1,9,10
4336_0,,,,2,1,2,3
C(C)=C(C(O)=O)C(C(O)=O)=O,,,4,1,1,8,9
4337_0,,,,2,1,2,3
4339_0,,,,2,1,2,3
C(CC=C(C=O)C(O)=O)(O)=O,,,4,1,2,6,8
4341_0,,,,2,1,2,3
C(C(C(O)=O)C=CC(O)=O)=O,,,4,1,3,11,14
4343_0,,,,2,1,2,3
C(C(C(C=O)=O)O)=CC(O)=O,,,4,1,1,12,13
4345_0,,,,2,1,2,3
C(CC=CC(C=O)=O)(O)=O,,,4,1,3,15,18
4347_0,,,,2,1,2,3
C(CC(C=O)=O)=CC(O)=O,,,4,1,1,20,21
4349_0,,,,2,1,2,3
C(C(C(C(O)=O)=O)O)=CC(O)=O,,,4,1,2,7,9
4351_0,,,,2,1,2,3
C(CC=CC=O)(O)=O,,,4,1,9,63,72
4353_0,,,,2,1,2,3
C(CC=CC(O)=O)=O,,,4,1,10,84,94
4355_0,,,,2,1,2,3
C(CC=CC(C(O)=O)=O)(O)=O,,,4,1,5,7,12
4357_0,,,,2,1,2,3
C(CC(C(O)=O)=O)=CC(O)=O,,,4,1,3,9,12
4359_0,,,,2,1,2,3
C(C(C=O)=CC(CO)=O)(O)=O,,,4,1,1,12,13
4361_0,,,,2,1,2,3
C(C(C=O)=C(C=O)CO)(O)=O,,,4,1,1,10,11
4363_0,,,,2,1,2,3
C(C(C(O)=O)C(C=O)=C)=O,,,4,1,3,22,25
4365_0,,,,2,1,2,3
C(C(C(O)=O)=C(C=O)C)=O,,,4,1,1,18,19
4367_0,,,,2,1,2,3
C(C(C(O)=O)=CC(C)=O)=O,,,4,1,1,22,23
4368_0,,,,2,1,2,3
4370_0,,,,2,1,2,3
C(C(C=O)=C(C(O)=O)CO)(O)=O,,,4,1,2,5,7
4371_0,,,,2,1,2,3
4373_0,,,,2,1,2,3
C(C(C(O)=O)=C(C(O)=O)C)=O,,,4,1,2,7,9
4375_0,,,,2,1,2,3
C(C(C)(CC=CC=O)O)(O)=O,,,4,1,1,8,9
4376_0,,,,2,1,2,3
4377_0,,,,2,1,2,3
4379_0,,,,2,1,2,3
C(C(C=CCC=O)(C)O)(O)=O,,,4,1,1,9,10
4380_0,,,,2,1,2,3
4382_0,,,,2,1,2,3
C(C(C(C=O)=C)(C)O)(O)=O,,,4,1,2,14,16
4384_0,,,,2,1,2,3
C(C(C)=C(C=O)CO)(O)=O,,,4,1,2,14,16
4386_0,,,,2,1,2,3
C(CC(C(O)=O)=CC=O)(O)=O,,,4,1,2,8,10
4388_0,,,,2,1,2,3
C(CC(C(O)=O)=CC(O)=O)=O,,,4,1,2,10,12
4390_0,,,,2,1,2,3
C=C(C(O)=O)C(C(O)=O)=O,,,4,1,3,12,15
4392_0,,,,2,1,2,3
C=C(C(C(O)=O)=O)C(C(C)=O)=O,,,4,1,1,11,12
4394_0,,,,2,1,2,3
C=CC(C(CC(C(O)=O)=O)=O)=O,,,4,1,1,11,12
4396_0,,,,2,1,2,3
C(C(C=CC(CO)=O)=O)=O,,,4,1,1,32,33
4398_0,,,,2,1,2,3
C(C=CC(CO)=O)=O,,,4,1,6,158,164
4400_0,,,,2,1,2,3
C(C(C=CC(CO)=O)=O)(O)=O,,,4,1,2,12,14
4402_0,,,,2,1,2,3
C(C(CO)=CC(C=O)=O)=O,,,4,1,1,22,23
4404_0,,,,2,1,2,3
C(C(CO)=CC=O)=O,,,4,1,6,118,124
4406_0,,,,2,1,2,3
C(C(CO)=CC(C(O)=O)=O)=O,,,4,1,2,10,12
4408_0,,,,2,1,2,3
C=C(C=O)C(C(C=O)=O)O,,,4,1,1,24,25
4410_0,,,,2,1,2,3
C=CC(C(C=O)=O)O,,,4,1,3,70,73
4411_0,,,,2,1,2,3
4413_0,,,,2,1,2,3
C(C(C)=CC(C=O)=O)=O,,,4,1,1,82,83
4415_0,,,,2,1,2,3
C=C(C=O)CC(C=O)=O,,,4,1,1,75,76
4417_0,,,,2,1,2,3
C=C(C=O)C(C(C(O)=O)=O)O,,,4,1,2,12,14
4419_0,,,,2,1,2,3
C(C(C)=CC=O)=O,,,4,1,4,326,330
4421_0,,,,2,1,2,3
C(CC(C=O)=C)=O,,,4,1,6,293,299
4423_0,,,,2,1,2,3
C(C(C)=CC(C(O)=O)=O)=O,,,4,1,2,18,20
4425_0,,,,2,1,2,3
C=C(C=O)CC(C(O)=O)=O,,,4,1,2,20,22
4427_0,,,,2,1,2,3
C(C(C=CC(C)=O)=O)=O,,,4,1,1,96,97
4429_0,,,,2,1,2,3
C(C=CC(C)=O)=O,,,4,1,4,388,392
4431_0,,,,2,1,2,3
C(C(C=CC(C)=O)=O)(O)=O,,,4,1,2,22,24
4433_0,,,,2,1,2,3
C=CC(C=O)=O,,,4,1,9,525,534
4435_0,,,,2,1,2,3
C(C(CO)=CC(C=O)=O)(O)=O,,,4,1,2,9,11
4437_0,,,,2,1,2,3
C=CCC(C=O)=O,,,4,1,3,198,201
4439_0,,,,2,1,2,3
C(C)=CC(C=O)=O,,,4,1,5,231,236
4440_0,,,,2,1,2,3
4441_0,,,,2,1,2,3
4443_0,,,,2,1,2,3
C=C(C(O)=O)C(C(C(O)=O)=O)=C,,,4,1,1,9,10
4445_0,,,,2,1,2,3
C(C1(C(C(C(O1)=O)=O)=C)C)(O)=O,,,4,1,2,4,6
4447_0,,,,2,1,2,3
C1(C(C(CO)=C(C(O1)=O)C)=O)=O,,,4,1,1,4,5
4449_0,,,,2,1,2,3
C1(C(C(C(C(O1)=O)=O)=C)(C)O)=O,,,4,1,1,5,6
4450_0,,,,2,1,2,3
4452_0,,,,2,1,2,3
C=CC=O,,,4,1,25,1571,1596
4454_0,,,,2,1,2,3
C=CC(C(O)=O)=O,,,4,1,11,137,148
4456_0,,,,2,1,2,3
C(C(CO)=CC=O)(O)=O,,,4,1,7,24,31
4458_0,,,,2,1,2,3
C(C(CO)=CC(C(O)=O)=O)(O)=O,,,4,1,4,5,9
4460_0,,,,2,1,2,3
C=CC(C(C(O)=O)=O)O,,,4,1,4,16,20
4462_0,,,,2,1,2,3
C=C(C(O)=O)C(C(C(O)=O)=O)O,,,4,1,4,8,12
4463_0,,,,2,1,2,3
4464_0,,,,2,1,2,3
4465_0,,,,2,1,2,3
4466_0,,,,2,1,2,3
4467_0,,,,2,1,2,3
4468_0,,,,2,1,2,3
4470_0,,,,2,1,2,3
C=CC(C)O,,,4,1,3,103,106
4471_0,,,,2,1,2,3
4472_0,,,,2,1,2,3
4473_0,,,,2,1,2,3
4474_0,,,,2,1,2,3
4475_0,,,,2,1,2,3
4476_0,,,,2,1,2,3
4477_0,,,,2,1,2,3
4478_0,,,,2,1,2,3
4479_0,,,,2,1,2,3
4480_0,,,,2,1,2,3
4481_0,,,,2,1,2,3
4483_0,,,,2,1,2,3
C(C(C=CC(C)O)(CO)O)(O)=O,,,4,1,3,7,10
4484_0,,,,2,1,2,3
4485_0,,,,2,1,2,3
4487_0,,,,2,1,2,3
C(C(C=CC(O)=O)(CO)O)(O)=O,,,4,1,4,7,11
4489_0,,,,2,1,2,3
C(C(C(C=O)=C)(CO)O)(O)=O,,,4,1,4,12,16
4491_0,,,,2,1,2,3
C(C(C=CC(C)O)O)(O)=O,,,4,1,2,9,11
4492_0,,,,2,1,2,3
4493_0,,,,2,1,2,3
4495_0,,,,2,1,2,3
C=C(C(O)=O)C(CC(C)O)O,,,4,1,2,9,11
4497_0,,,,2,1,2,3
C(C(C=CC(C)O)(C)O)(O)=O,,,4,1,1,6,7
4498_0,,,,2,1,2,3
4499_0,,,,2,1,2,3
4501_0,,,,2,1,2,3
C(C(C=CC(O)=O)O)(O)=O,,,4,1,3,13,16
4503_0,,,,2,1,2,3
C(CC(C(C(O)=O)=C)O)(O)=O,,,4,1,3,6,9
4504_0,,,,2,1,2,3
4506_0,,,,2,1,2,3
C(CO)(C(C(C(O)=O)=C)O)=O,,,4,1,3,11,14
4508_0,,,,2,1,2,3
C(C(C(C(O)=O)=C)(CO)O)=O,,,4,1,2,10,12
4510_0,,,,2,1,2,3
C(C(C(C=O)=C)O)(O)=O,,,4,1,5,27,32
4512_0,,,,2,1,2,3
C(C(C(C(O)=O)=C)(C)O)=O,,,4,1,2,11,13
4513_0,,,,2,1,2,3
4515_0,,,,2,1,2,3
C(C)(C(C(C(O)=O)=C)O)=O,,,4,1,2,17,19
4517_0,,,,2,1,2,3
C=C(C(O)=O)CO,,,4,1,8,86,94
4518_0,,,,2,1,2,3
4519_0,,,,2,1,2,3
4520_0,,,,2,1,2,3
4522_0,,,,2,1,2,3
C=C(C(O)=O)C(C)=O,,,4,1,8,82,90
4523_0,,,,2,1,2,3
4525_0,,,,2,1,2,3
C=C(C(O)=O)C=C,,,4,1,4,100,104
4526_0,,,,2,1,2,3
4528_0,,,,2,1,2,3
C=C(C(O)=O)C(C(O)=O)=C,,,4,1,1,7,8
4530_0,,,,2,1,2,3
C=C1C(OC(C(O)=O)=C1)=O,,,4,1,2,8,10
4531_0,,,,2,1,2,3
4533_0,,,,2,1,2,3
[C](C(O)=O)=CC(C(O)=O)=C,,,4,1,2,12,14
4534_0,,,,2,1,2,3
4536_0,,,,2,1,2,3
C=C(C(O)=O)C=CC(O)=O,,,4,1,3,13,16
4537_0,,,,2,1,2,3
4539_0,,,,2,1,2,3
C=CC(CO)O,,,4,1,3,42,45
4541_0,,,,2,1,2,3
C(C(C(C=C)O)O)(O)=O,,,4,1,7,21,28
4543_0,,,,2,1,2,3
C=C(C(O)=O)C(CO)O,,,4,1,5,15,20
4545_0,,,,2,1,2,3
C1(C(C(C(C(O1)=O)=C)O)O)=O,,,4,1,3,9,12
4546_0,,,,2,1,2,3
4547_0,,,,2,1,2,3
4548_0,,,,2,1,2,3
4550_0,,,,2,1,2,3
C=C1C(OC(C1)O)=O,,,4,1,2,49,51
4552_0,,,,2,1,2,3
C1C(O)OC(C=1C)=O,,,4,1,1,47,48
4554_0,,,,2,1,2,3
C1(C(C=CO1)(C)O)=O,,,4,1,1,7,8
4556_0,,,,2,1,2,3
C1(C(C=C(C(C)=O)O1)=O)=O,,,4,1,1,10,11
4558_0,,,,2,1,2,3
C=C1C(CC(C(O1)=O)=O)=O,,,4,1,1,16,17
4560_0,,,,2,1,2,3
C(C1(C(C(OC1)=O)=C)O)(O)=O,,,4,1,3,6,9
4562_0,,,,2,1,2,3
C1(C(C(C(O1)=O)=C)(CO)O)=O,,,4,1,3,6,9
4564_0,,,,2,1,2,3
C1(C(C(C(O1)=O)=C)(C)O)=O,,,4,1,2,8,10
4566_0,,,,2,1,2,3
C(C1C(C(C(O1)=O)=C)O)(O)=O,,,4,1,4,6,10
4568_0,,,,2,1,2,3
[C]1C(OC(C(O)=O)(C=1)C)=O,,,4,1,1,7,8
4570_0,,,,2,1,2,3
C1(C(C)=C[C](C(O)=O)O1)=O,,,4,1,1,7,8
4572_0,,,,2,1,2,3
C=C1C(O[C](C(O)=O)C1)=O,,,4,1,3,7,10
4574_0,,,,2,1,2,3
C(C1(C=CC(O1)=O)C)(O)=O,,,4,1,2,8,10
4576_0,,,,2,1,2,3
C(C1C=C(C(O1)=O)C)(O)=O,,,4,1,1,12,13
4578_0,,,,2,1,2,3
C(C1CC(C(O1)=O)=C)(O)=O,,,4,1,3,12,15
4580_0,,,,2,1,2,3
[C]1C(OC(C(C=1)(C)O)=O)=O,,,4,1,1,8,9
4582_0,,,,2,1,2,3
C1(C(C)=C[C](C(O1)=O)O)=O,,,4,1,1,7,8
4584_0,,,,2,1,2,3
C=C1C(OC([C](C1)O)=O)=O,,,4,1,2,9,11
4586_0,,,,2,1,2,3
C1(C(C=CC(O1)=O)(C)O)=O,,,4,1,2,8,10
4588_0,,,,2,1,2,3
C1(C(C=C(C(O1)=O)C)O)=O,,,4,1,1,12,13
4590_0,,,,2,1,2,3
C1(C(CC(C(O1)=O)=C)O)=O,,,4,1,2,14,16
4592_0,,,,2,1,2,3
C(C)=C(C=O)C[CH]C(O)=O,,,4,1,2,13,15
4594_0,,,,2,1,2,3
C(C(C=C)C[CH]C(O)=O)=O,,,4,1,3,12,15
4596_0,,,,2,1,2,3
C(CCC(C=O)=CC)(O)=O,,,4,1,2,13,15
4598_0,,,,2,1,2,3
C(C(C=C)CCC(O)=O)=O,,,4,1,4,12,16
4600_0,,,,2,1,2,3
C(CC[CH]C(O)=O)=CC=O,,,4,1,3,13,16
4602_0,,,,2,1,2,3
C(CC=CC[CH]C(O)=O)=O,,,4,1,1,14,15
4604_0,,,,2,1,2,3
C(CCCC=CC=O)(O)=O,,,4,1,4,13,17
4606_0,,,,2,1,2,3
C(CC=CCCC(O)=O)=O,,,4,1,1,13,14
4608_0,,,,2,1,2,3
C(CC(C)=C[CH]C(O)=O)=O,,,4,1,2,14,16
4610_0,,,,2,1,2,3
C(C)(C[CH]C(O)=O)=CC=O,,,4,1,1,12,13
4612_0,,,,2,1,2,3
C(CC(C[CH]C(O)=O)=C)=O,,,4,1,1,15,16
4614_0,,,,2,1,2,3
C(CC(C)=CCC(O)=O)=O,,,4,1,2,13,15
4616_0,,,,2,1,2,3
C(CCC(C)=CC=O)(O)=O,,,4,1,1,12,13
4618_0,,,,2,1,2,3
C(CC(CCC(O)=O)=C)=O,,,4,1,1,14,15
4620_0,,,,2,1,2,3
C(C(C=C[CH]C(O)=O)=O)=O,,,4,1,2,14,16
4621_0,,,,2,1,2,3
4623_0,,,,2,1,2,3
C([CH]C=CC(O)=O)(O)=O,,,4,1,1,15,16
4625_0,,,,2,1,2,3
C(CC=CC(O)=O)(O)=O,,,4,1,4,13,17
4627_0,,,,2,1,2,3
C(CO)=C[CH]C(O)=O,,,4,1,2,12,14
4629_0,,,,2,1,2,3
C(C(C=C[CH]C(O)=O)=O)(O)=O,,,4,1,3,6,9
4631_0,,,,2,1,2,3
C(C(C=C[CH]C(O)=O)O)(O)=O,,,4,1,4,6,10
4633_0,,,,2,1,2,3
C(C(CO)=C[CH]C(O)=O)(O)=O,,,4,1,1,3,4
4635_0,,,,2,1,2,3
[C](C(O)=O)=CC[CH]C(O)=O,,,4,1,3,8,11
4637_0,,,,2,1,2,3
C(C[CH]C(O)=O)=CC(O)=O,,,4,1,3,9,12
4639_0,,,,2,1,2,3
C=C(C(O)=O)C[CH]C(O)=O,,,4,1,3,9,12
4641_0,,,,2,1,2,3
C(C(C)=C[CH]C(O)=O)(O)=O,,,4,1,1,8,9
4643_0,,,,2,1,2,3
C(CC=CCO)(O)=O,,,4,1,4,11,15
4644_0,,,,2,1,2,3
4646_0,,,,2,1,2,3
C(CC=CC(C(O)=O)O)(O)=O,,,4,1,5,7,12
4648_0,,,,2,1,2,3
C(CC=C(C(O)=O)CO)(O)=O,,,4,1,3,3,6
4650_0,,,,2,1,2,3
[C](C(O)=O)=CCCC(O)=O,,,4,1,3,8,11
4652_0,,,,2,1,2,3
C(CCC=CC(O)=O)(O)=O,,,4,1,3,7,10
4654_0,,,,2,1,2,3
C(CCC(C(O)=O)=C)(O)=O,,,4,1,3,7,10
4656_0,,,,2,1,2,3
C(CC=C(C(O)=O)C)(O)=O,,,4,1,1,6,7
4658_0,,,,2,1,2,3
[C](C(O)=O)=CC(C)O,,,4,1,1,48,49
4660_0,,,,2,1,2,3
C(C)=C[C](C(O)=O)O,,,4,1,2,7,9
4662_0,,,,2,1,2,3
C=CC[C](C(O)=O)O,,,4,1,2,8,10
4664_0,,,,2,1,2,3
[C](C(O)=O)=CC(O)=O,,,4,1,1,72,73
4665_0,,,,2,1,2,3
4667_0,,,,2,1,2,3
C(C(C)O)=CC(O)=O,,,4,1,2,47,49
4669_0,,,,2,1,2,3
C(C(C=CC)O)(O)=O,,,4,1,9,31,40
4671_0,,,,2,1,2,3
C(C(CC=C)O)(O)=O,,,4,1,8,31,39
4673_0,,,,2,1,2,3
C(C=CC(O)=O)(O)=O,,,4,1,1,37,38
4674_0,,,,2,2,1,3
4676_0,,,,2,2,1,3
CC(CC(C(CO)(C(C)O)O)O)O,,,4,1,1,7,8
4677_0,,,,2,2,1,3
4679_0,,,,2,2,1,3
C(C(C(C(CC(C)O)O)O)O)=O,,,4,1,5,17,22
4681_0,,,,2,2,1,3
CC(CC(C(CO)O)O)O,,,4,1,2,7,9
4682_0,,,,2,2,1,3
4684_0,,,,2,2,1,3
C(CC(C(CO)(C(C)O)O)O)(O)=O,,,4,1,1,8,9
4686_0,,,,2,2,1,3
C(CO)(C(C(CO)(C(C)O)O)O)=O,,,4,1,1,10,11
4688_0,,,,2,2,1,3
C(C(CO)(C(CO)(C(C)O)O)O)=O,,,4,1,1,13,14
4690_0,,,,2,2,1,3
C(C(C)(C(CO)(C(C)O)O)O)=O,,,4,1,1,10,11
4691_0,,,,2,2,1,3
4693_0,,,,2,2,1,3
C(C)(C(C(CO)(C(C)O)O)O)=O,,,4,1,1,10,11
4695_0,,,,2,2,1,3
CC(C(CO)(CO)O)O,,,4,1,2,6,8
4697_0,,,,2,2,1,3
CC(C(CO)(C(C)O)O)O,,,4,1,1,3,4
4698_0,,,,2,2,1,3
4700_0,,,,2,2,1,3
C(C(C)(C(CO)(C(C)O)O)O)(O)=O,,,4,1,2,8,10
4701_0,,,,2,2,1,3
4703_0,,,,2,2,1,3
C(C(C(CO)(C(C)O)O)O)(O)=O,,,4,1,5,9,14
4705_0,,,,2,2,1,3
C(C(C(C(C)O)(C(C)O)O)O)(O)=O,,,4,1,4,7,11
4706_0,,,,2,2,1,3
4707_0,,,,2,2,1,3
4709_0,,,,2,2,1,3
C(CC(C(C(C=O)O)O)O)(O)=O,,,4,1,6,18,24
4711_0,,,,2,2,1,3
C(CC(C(CO)O)O)(O)=O,,,4,1,7,10,17
4712_0,,,,2,2,1,3
4713_0,,,,2,2,1,3
4714_0,,,,2,2,1,3
4715_0,,,,2,2,1,3
4716_0,,,,2,2,1,3
4717_0,,,,2,2,1,3
4718_0,,,,2,2,1,3
4719_0,,,,2,2,1,3
4720_0,,,,2,2,1,3
4722_0,,,,2,2,1,3
C(C(C)(CC(C(CO)O)O)O)(O)=O,,,4,1,2,11,13
4723_0,,,,2,2,1,3
4724_0,,,,2,2,1,3
4725_0,,,,2,2,1,3
4726_0,,,,2,2,1,3
4727_0,,,,2,2,1,3
4728_0,,,,2,2,1,3
4729_0,,,,2,2,1,3
4730_0,,,,2,2,1,3
4731_0,,,,2,2,1,3
4732_0,,,,2,2,1,3
4733_0,,,,2,2,1,3
4734_0,,,,2,2,1,3
4735_0,,,,2,2,1,3
4736_0,,,,2,2,1,3
4737_0,,,,2,2,1,3
4738_0,,,,2,2,1,3
4739_0,,,,2,2,1,3
4740_0,,,,2,2,1,3
4741_0,,,,2,2,1,3
4742_0,,,,2,2,1,3
4743_0,,,,2,2,1,3
4744_0,,,,2,2,1,3
4745_0,,,,2,2,1,3
4746_0,,,,2,2,1,3
4747_0,,,,2,2,1,3
4748_0,,,,2,2,1,3
4749_0,,,,2,2,1,3
4750_0,,,,2,2,1,3
4751_0,,,,2,2,1,3
4752_0,,,,2,2,1,3
4753_0,,,,2,2,1,3
4754_0,,,,2,2,1,3
4755_0,,,,2,2,1,3
4757_0,,,,2,2,1,3
C(C(CO)O)(C(C)O)=O,,,4,1,11,32,43
4758_0,,,,2,2,1,3
4759_0,,,,2,2,1,3
4760_0,,,,2,2,1,3
4762_0,,,,2,2,1,3
C(C(CO)O)(C[C](C(O)=O)O)=O,,,4,1,4,11,15
4764_0,,,,2,2,1,3
C(C)(C(C([C](C(O)=O)O)O)O)=O,,,4,1,3,11,14
4766_0,,,,2,2,1,3
C(CC(C(O)=O)O)(C(CO)O)=O,,,4,1,9,13,22
4767_0,,,,2,2,1,3
4768_0,,,,2,2,1,3
4769_0,,,,2,2,1,3
4770_0,,,,2,2,1,3
4771_0,,,,2,2,1,3
4772_0,,,,2,2,1,3
4773_0,,,,2,2,1,3
4774_0,,,,2,2,1,3
4775_0,,,,2,2,1,3
4777_0,,,,2,2,1,3
C(C(C)C(CO)O)(O)=O,,,4,1,3,14,17
4778_0,,,,2,2,1,3
4779_0,,,,2,2,1,3
4780_0,,,,2,2,1,3
4781_0,,,,2,2,1,3
4782_0,,,,2,2,1,3
4783_0,,,,2,2,1,3
4784_0,,,,2,2,1,3
4785_0,,,,2,2,1,3
4786_0,,,,2,2,1,3
4788_0,,,,2,2,1,3
C1(C(C(C(C(C)=O)(O)O1)O)O)=O,,,4,1,2,9,11
4790_0,,,,2,2,1,3
C1(C(CC(C(CO)O)(O)O1)=O)=O,,,4,1,2,9,11
4792_0,,,,2,2,1,3
C1(C(C(C(OC1(C)O)=O)O)O)=O,,,4,1,2,8,10
4794_0,,,,2,2,1,3
C1(C(C(C(C(C)(O)O1)O)O)=O)=O,,,4,1,2,8,10
4796_0,,,,2,2,1,3
C1(C(C(C(C)O1)O)O)=O,,,4,1,3,19,22
4798_0,,,,2,2,1,3
C1(C(C(C(O1)=O)O)O)=O,,,4,1,5,15,20
4800_0,,,,2,2,1,3
[CH](C(O)=O)CC(CO)(C(C)O)O,,,4,1,2,8,10
4802_0,,,,2,2,1,3
C(CCC(CO)(C(C)O)O)(O)=O,,,4,1,2,8,10
4804_0,,,,2,2,1,3
[CH](C(O)=O)CCC(C(CO)O)O,,,4,1,3,8,11
4806_0,,,,2,2,1,3
C(CCCC(C(CO)O)O)(O)=O,,,4,1,3,8,11
4808_0,,,,2,2,1,3
[CH](C(O)=O)CC(C)(C(CO)O)O,,,4,1,2,9,11
4810_0,,,,2,2,1,3
C(CCC(C)(C(CO)O)O)(O)=O,,,4,1,2,9,11
4811_0,,,,2,2,1,3
4812_0,,,,2,2,1,3
4814_0,,,,2,2,1,3
C(C(C(C[CH]C(O)=O)O)O)=O,,,4,1,6,17,23
4816_0,,,,2,2,1,3
C(CCC(C(C=O)O)O)(O)=O,,,4,1,6,17,23
4817_0,,,,2,2,1,3
4818_0,,,,2,2,1,3
4819_0,,,,2,2,1,3
4820_0,,,,2,2,1,3
4821_0,,,,2,2,1,3
4823_0,,,,2,2,1,3
C(C(CC)O)=O,,,4,1,4,252,256
4824_0,,,,2,2,1,3
4826_0,,,,2,2,1,3
C(CCCO)=O,,,4,1,3,252,255
4827_0,,,,2,2,1,3
4829_0,,,,2,2,1,3
C(C(C(CC)O)=O)(O)=O,,,4,1,2,17,19
4830_0,,,,2,2,1,3
4832_0,,,,2,2,1,3
C(C(CCCO)=O)(O)=O,,,4,1,3,20,23
4833_0,,,,2,2,1,3
4835_0,,,,2,2,1,3
C(C(CO)CC=O)(O)=O,,,4,1,4,25,29
4837_0,,,,2,2,1,3
C(C(C)C(C=O)O)(O)=O,,,4,1,3,25,28
4838_0,,,,2,2,1,3
4839_0,,,,2,2,1,3
4840_0,,,,2,2,1,3
4841_0,,,,2,2,1,3
4842_0,,,,2,2,1,3
4843_0,,,,2,2,1,3
4844_0,,,,2,2,1,3
4845_0,,,,2,2,1,3
4846_0,,,,2,2,1,3
4847_0,,,,2,2,1,3
4848_0,,,,2,2,1,3
4849_0,,,,2,2,1,3
4850_0,,,,2,2,1,3
4851_0,,,,2,2,1,3
4852_0,,,,2,2,1,3
4853_0,,,,2,2,1,3
4854_0,,,,2,2,1,3
4856_0,,,,2,2,1,3
C1(C(C)C(C(C(O)=O)(O)O1)O)=O,,,4,1,2,5,7
4857_0,,,,2,2,1,3
4859_0,,,,2,2,1,3
C1(C(CO)CC(C(O)=O)(O)O1)=O,,,4,1,2,6,8
4860_0,,,,2,2,1,3
4862_0,,,,2,2,1,3
C1(C(C)C(C(C(O1)=O)=O)O)=O,,,4,1,5,4,9
4863_0,,,,2,2,1,3
4865_0,,,,2,2,1,3
C1(C(CO)CC(C(O1)=O)=O)=O,,,4,1,5,7,12
4866_0,,,,2,2,1,3
4868_0,,,,2,2,1,3
C(C(C)(C([CH]C(O)=O)O)O)(O)=O,,,4,1,2,7,9
4869_0,,,,2,2,1,3
4871_0,,,,2,2,1,3
C(C(C)C([C](C(O)=O)O)O)(O)=O,,,4,1,3,5,8
4872_0,,,,2,2,1,3
4874_0,,,,2,2,1,3
C(C(CO)C[C](C(O)=O)O)(O)=O,,,4,1,3,6,9
4875_0,,,,2,2,1,3
4876_0,,,,2,2,1,3
4877_0,,,,2,2,1,3
4879_0,,,,2,2,1,3
C(C(C)C(C(C(O)=O)O)O)(O)=O,,,4,1,4,8,12
4880_0,,,,2,2,1,3
4882_0,,,,2,2,1,3
C(C(CO)CC(C(O)=O)O)(O)=O,,,4,1,4,8,12
4883_0,,,,2,2,1,3
4884_0,,,,2,1,2,3
4885_0,,,,2,1,2,3
4886_0,,,,2,1,2,3
4887_0,,,,2,1,2,3
4888_0,,,,2,1,2,3
4889_0,,,,2,1,2,3
4890_0,,,,2,1,1,2
4890_1,,,,2,1,1,2
4892_0,,,,2,1,1,2
C1(C(O)OC(CC(C)O)C1O)=O,,,4,1,1,6,7
4894_0,,,,2,1,1,2
C1(C(O)OC(CC(C)O)C1)=O,,,4,1,1,9,10
4896_0,,,,2,1,1,2
C(C1C(C)OC(CO)(C1O)O)=O,,,4,1,1,11,12
4898_0,,,,2,1,1,2
C(C1(COC(C1C(C)O)O)O)=O,,,4,1,1,9,10
4900_0,,,,2,1,1,2
C(C1C(C)OC(C1(CO)O)O)=O,,,4,1,1,11,12
4902_0,,,,2,1,1,2
C(C1C(C)OC(C1(C)O)O)=O,,,4,1,1,11,12
4904_0,,,,2,1,1,2
C(C1C(C)OC(C)(C1O)O)=O,,,4,1,1,11,12
4906_0,,,,2,1,1,2
C(C1(COC(C1C(C)O)O)O)(O)=O,,,4,1,2,8,10
4908_0,,,,2,1,1,2
C1(C(CO)(C(C(O)O1)C(C)O)O)=O,,,4,1,1,7,8
4910_0,,,,2,1,1,2
C1(C(C)(C(C(O)O1)C(C)O)O)=O,,,4,1,1,6,7
4912_0,,,,2,1,1,2
C1(C(CC(O)O1)(CC(C)O)O)=O,,,4,1,1,6,7
4914_0,,,,2,1,1,2
C(CC1C(C(C(O)O1)=O)O)(O)=O,,,4,1,1,6,7
4916_0,,,,2,1,1,2
C(CC1CC(C(O)O1)=O)(O)=O,,,4,1,1,9,10
4918_0,,,,2,1,1,2
C1(C(C=O)C(C(CO)(O)O1)O)=O,,,4,1,2,11,13
4920_0,,,,2,1,1,2
C(C1C(O)OCC1(C=O)O)(O)=O,,,4,1,1,9,10
4922_0,,,,2,1,1,2
C1(C(C=O)C(CO)(C(O)O1)O)=O,,,4,1,2,11,13
4924_0,,,,2,1,1,2
C1(C(C=O)C(C)(C(O)O1)O)=O,,,4,1,2,11,13
4926_0,,,,2,1,1,2
C1(C(C=O)C(C(C)(O)O1)O)=O,,,4,1,2,11,13
4928_0,,,,2,1,1,2
C(C1C(O)OCC1(C(O)=O)O)(O)=O,,,4,1,2,8,10
4930_0,,,,2,1,1,2
C(C1C(O)OC(C1(CO)O)=O)(O)=O,,,4,1,1,8,9
4932_0,,,,2,1,1,2
C(C1C(O)OC(C1(C)O)=O)(O)=O,,,4,1,1,6,7
4934_0,,,,2,1,1,2
C1(C(C)(C(CO)C(O)O1)O)=O,,,4,1,1,5,6
4936_0,,,,2,1,1,2
C1(C(CC(O)O1)(CC(O)=O)O)=O,,,4,1,1,5,6
4938_0,,,,2,1,1,2
C1(C(C)(O)OCC1C(C(O)=O)=O)=O,,,4,1,1,8,9
4939_0,,,,2,1,1,2
4940_0,,,,2,1,1,2
4942_0,,,,2,1,1,2
C1(C(CC(C(O)=O)=O)(O)OCC1)=O,,,4,1,1,10,11
4944_0,,,,2,1,1,2
C1(C(O)OC(C(CO)=O)C1O)=O,,,4,1,1,9,10
4946_0,,,,2,1,1,2
C1(C(O)OC(C(CO)=O)C1)=O,,,4,1,1,13,14
4948_0,,,,2,1,1,2
C(C1(CO)C(C(C(O1)O)=O)O)=O,,,4,1,1,12,13
4950_0,,,,2,1,1,2
C(C1(COC(C=O)(C1O)O)O)=O,,,4,1,1,14,15
4952_0,,,,2,1,1,2
C(C1(CO)CC(C(O1)O)=O)=O,,,4,1,1,11,12
4954_0,,,,2,1,1,2
C(C1(COC(C=O)(C1)O)O)=O,,,4,1,1,9,10
4956_0,,,,2,1,1,2
C(C1(COC(C(O)=O)(C1O)O)O)=O,,,4,1,2,12,14
4958_0,,,,2,1,1,2
C(C1(COC(C1)O)O)=O,,,4,1,1,12,13
4960_0,,,,2,1,1,2
C(C1(COC(C(O)=O)(C1)O)O)=O,,,4,1,2,9,11
4962_0,,,,2,1,1,2
C(C1(C)C(C(C(O1)O)=O)O)=O,,,4,1,1,10,11
4964_0,,,,2,1,1,2
C1(C(O)OC(C(C)=O)C1O)=O,,,4,1,1,13,14
4966_0,,,,2,1,1,2
C1(C(O)OCC1O)=O,,,4,1,1,87,88
4968_0,,,,2,1,1,2
C(C1(COC(C=O)(C1O)O)O)(O)=O,,,4,1,2,12,14
4970_0,,,,2,1,1,2
C1(C(CO)(C(C(C=O)(O)O1)O)O)=O,,,4,1,1,13,14
4972_0,,,,2,1,1,2
C(C1(CO)C(C(C(O1)O)=O)O)(O)=O,,,4,1,2,10,12
4974_0,,,,2,1,1,2
C1(C(O)OC(C)C1O)=O,,,4,1,1,28,29
4976_0,,,,2,1,1,2
C1(C(C(C(O)O1)=O)O)=O,,,4,1,1,26,27
4978_0,,,,2,1,1,2
C1(C(C)(C(C(C=O)(O)O1)O)O)=O,,,4,1,1,10,11
4980_0,,,,2,1,1,2
C(C1(C)C(C(C(O1)O)=O)O)(O)=O,,,4,1,2,6,8
4982_0,,,,2,1,1,2
C(C1(C)CC(C(O1)O)=O)=O,,,4,1,1,16,17
4984_0,,,,2,1,1,2
C(C)(C1CC(C(O)O1)=O)=O,,,4,1,1,22,23
4986_0,,,,2,1,1,2
C1(C(O)OCC1)=O,,,4,1,1,176,177
4988_0,,,,2,1,1,2
C(C1(COC(C=O)(C1)O)O)(O)=O,,,4,1,2,9,11
4990_0,,,,2,1,1,2
C1(C(CO)(CC(C=O)(O)O1)O)=O,,,4,1,1,9,10
4992_0,,,,2,1,1,2
C(C1(CO)CC(C(O1)O)=O)(O)=O,,,4,1,2,7,9
4994_0,,,,2,1,1,2
C1(C(O)OC(C)C1)=O,,,4,1,1,91,92
4996_0,,,,2,1,1,2
C1(CC(C(O)O1)=O)=O,,,4,1,1,83,84
4998_0,,,,2,1,1,2
C1(C(C)(CC(C=O)(O)O1)O)=O,,,4,1,1,7,8
5000_0,,,,2,1,1,2
C(C1(C)CC(C(O1)O)=O)(O)=O,,,4,1,2,8,10
5002_0,,,,2,1,1,2
C(C1(C(C(C(O1)=O)=C)CO)O)(O)=O,,,4,1,1,5,6
5004_0,,,,2,1,1,2
C1(C2(C)C(CO)C(C(O2)=O)(O)O1)=O,,,4,1,1,3,4
5006_0,,,,2,1,1,2
C(C1(COC(C1)O)O)(O)=O,,,4,1,2,5,7
5008_0,,,,2,1,1,2
C1(C(CO)(CC(O)O1)O)=O,,,4,1,1,5,6
5010_0,,,,2,1,1,2
C(C1(COC(C(O)=O)(C1)O)O)(O)=O,,,4,1,3,8,11
5012_0,,,,2,1,1,2
C1(C(CO)(CC(C(O)=O)(O)O1)O)=O,,,4,1,2,8,10
5014_0,,,,2,1,1,2
C1(C(C)(C(C(C(O)=O)(O)O1)O)O)=O,,,4,1,2,8,10
5016_0,,,,2,1,1,2
C(C1(C(C(C)(O)OC1)=O)O)(O)=O,,,4,1,1,5,6
5018_0,,,,2,1,1,2
C1(C(C(C(C)(O)O1)=O)(CO)O)=O,,,4,1,1,6,7
5020_0,,,,2,1,1,2
C1(C(C(C(CO)(O)O1)=O)(C)O)=O,,,4,1,1,5,6
5022_0,,,,2,1,1,2
C1(C(C(C(C)(O)O1)=O)(C)O)=O,,,4,1,1,3,4
5024_0,,,,2,1,1,2
C(C1C(C(C(C)(O1)O)=O)O)(O)=O,,,4,1,1,6,7
5025_0,,,,2,1,1,2
5027_0,,,,2,1,1,2
C1(C(C)(O)O[C](C(O)=O)C1)=O,,,4,1,1,7,8
5029_0,,,,2,1,1,2
C(C)(C1(C[C](C(O1)=O)O)O)=O,,,4,1,1,6,7
5031_0,,,,2,1,1,2
C1(CC(C(O)=O)OC1(C)O)=O,,,4,1,1,8,9
5033_0,,,,2,1,1,2
C1(C(CC(C(C)=O)(O)O1)O)=O,,,4,1,1,7,8
5035_0,,,,2,1,1,2
C(C1(COC(CO)(C1O)O)O)(O)=O,,,4,1,2,9,11
5037_0,,,,2,1,1,2
C1(C(CO)(C(C(CO)(O)O1)O)O)=O,,,4,1,5,9,14
5039_0,,,,2,1,1,2
C(C1(COC(C1(CO)O)O)O)(O)=O,,,4,1,1,8,9
5041_0,,,,2,1,1,2
C1(C(CO)(C(CO)(C(O)O1)O)O)=O,,,4,1,4,8,12
5043_0,,,,2,1,1,2
C(C1(COC(C1(C)O)O)O)(O)=O,,,4,1,1,7,8
5045_0,,,,2,1,1,2
C1(C(CO)(C(C)(C(O)O1)O)O)=O,,,4,1,4,8,12
5047_0,,,,2,1,1,2
C(C1(COC(C)(C1O)O)O)(O)=O,,,4,1,1,8,9
5049_0,,,,2,1,1,2
C1(C(CO)(C(C(C)(O)O1)O)O)=O,,,4,1,4,9,13
5051_0,,,,2,1,1,2
C1(C(C(C(CO)(O)O1)O)O)=O,,,4,1,3,8,11
5053_0,,,,2,1,1,2
C1(C(C)(C(C(CO)(O)O1)O)O)=O,,,4,1,2,6,8
5055_0,,,,2,1,1,2
C1(C(C(CO)(C(O)O1)O)O)=O,,,4,1,3,7,10
5057_0,,,,2,1,1,2
C1(C(C)(C(CO)(C(O)O1)O)O)=O,,,4,1,1,5,6
5059_0,,,,2,1,1,2
C1(C(C(C)(C(O)O1)O)O)=O,,,4,1,3,11,14
5061_0,,,,2,1,1,2
C1(C(C)(C(C)(C(O)O1)O)O)=O,,,4,1,1,5,6
5063_0,,,,2,1,1,2
C1(C(C(C(C)(O)O1)O)O)=O,,,4,1,3,12,15
5065_0,,,,2,1,1,2
C1(C(C)(C(C(C)(O)O1)O)O)=O,,,4,1,1,6,7
5066_0,,,,2,1,1,2
5068_0,,,,2,1,1,2
C1(CC(C(O)=O)(OC1CO)O)=O,,,4,1,1,9,10
5069_0,,,,2,1,1,2
5070_0,,,,2,1,1,2
5072_0,,,,2,1,1,2
C(C1COC(C(O)=O)(C1)O)(O)=O,,,4,1,1,6,7
5073_0,,,,2,1,1,2
5075_0,,,,2,1,1,2
CC(C1C(O)OC(C)CC1O)O,,,4,1,1,6,7
5077_0,,,,2,1,1,2
C(C1C(O)OC(C)CC1O)(O)=O,,,4,1,1,6,7
5079_0,,,,2,1,1,2
C(C1(C(C(CC(C)O1)O)O)O)=O,,,4,1,1,10,11
5081_0,,,,2,1,1,2
C(C1(CC(CC(C)O1)O)O)=O,,,4,1,1,7,8
5083_0,,,,2,1,1,2
C(C1(C(C(CC(C)O1)O)O)O)(O)=O,,,4,1,2,8,10
5085_0,,,,2,1,1,2
CC1CC(CC(O)O1)O,,,4,1,1,10,11
5087_0,,,,2,1,1,2
C(C1(CC(CC(C)O1)O)O)(O)=O,,,4,1,2,6,8
5089_0,,,,2,1,1,2
C1(CC(C(C(O)O1)C(C)O)O)=O,,,4,1,1,6,7
5091_0,,,,2,1,1,2
C1(COC(C(C(C)O)C1O)O)=O,,,4,1,1,7,8
5093_0,,,,2,1,1,2
C(C1(CC(O)OC(C)C1)O)(O)=O,,,4,1,1,6,7
5095_0,,,,2,1,1,2
C(C1C(O)OC(CC1O)=O)(O)=O,,,4,1,1,6,7
5097_0,,,,2,1,1,2
C1(CC(C(C(C=O)(O)O1)O)O)=O,,,4,1,1,11,12
5099_0,,,,2,1,1,2
C1(CC(CC(C=O)(O)O1)O)=O,,,4,1,1,9,10
5101_0,,,,2,1,1,2
C1(CC(C(C(C(O)=O)(O)O1)O)O)=O,,,4,1,2,8,10
5103_0,,,,2,1,1,2
C1(CC(CC(O)O1)O)=O,,,4,1,1,14,15
5105_0,,,,2,1,1,2
C1(CC(CC(C(O)=O)(O)O1)O)=O,,,4,1,2,6,8
5107_0,,,,2,1,1,2
C(C1C(OCC(C1O)=O)O)(O)=O,,,4,1,1,7,8
5109_0,,,,2,1,1,2
C(C1(C)CC(CC(O1)O)O)(O)=O,,,4,1,1,6,7
5111_0,,,,2,1,1,2
C(C1(CC(O)OC(C1)=O)O)(O)=O,,,4,1,1,6,7
5112_0,,,,2,1,1,2
5114_0,,,,2,1,1,2
C1(C(CCO)(O)OC(C(C1)=O)=O)=O,,,4,1,1,5,6
5116_0,,,,2,1,1,2
C(C1(C(C(C(CO1)=O)O)O)O)=O,,,4,1,1,12,13
5118_0,,,,2,1,1,2
C(C1(CC(C(CO1)=O)O)O)=O,,,4,1,1,10,11
5120_0,,,,2,1,1,2
C1(C(C(C(C(CO)(O)O1)O)O)=O)=O,,,4,1,1,9,10
5122_0,,,,2,1,1,2
C(C1(C(C(C(CO1)=O)O)O)O)(O)=O,,,4,1,2,11,13
5124_0,,,,2,1,1,2
C1(COC(CC1O)O)=O,,,4,1,1,29,30
5126_0,,,,2,1,1,2
C1(C(CC(C(CO)(O)O1)O)=O)=O,,,4,1,1,7,8
5128_0,,,,2,1,1,2
C(C1(CC(C(CO1)=O)O)O)(O)=O,,,4,1,3,7,10
5130_0,,,,2,1,1,2
C(C1(COC(C(C1O)=O)O)O)=O,,,4,1,1,13,14
5132_0,,,,2,1,1,2
C(C1(COC(C(C1)=O)O)O)=O,,,4,1,1,12,13
5134_0,,,,2,1,1,2
C1(C(C(C(CO)(C(O)O1)O)O)=O)=O,,,4,1,1,8,9
5136_0,,,,2,1,1,2
C1(C(CC(CO)(C(O)O1)O)=O)=O,,,4,1,1,7,8
5138_0,,,,2,1,1,2
C(C1(COC(C(C1O)=O)O)O)(O)=O,,,4,1,2,11,13
5140_0,,,,2,1,1,2
C1(C(CO)(C(C(C(O)O1)=O)O)O)=O,,,4,1,1,12,13
5142_0,,,,2,1,1,2
C1(C(C)(C(C(C(O)O1)=O)O)O)=O,,,4,1,1,8,9
5144_0,,,,2,1,1,2
C1(C(C(C(C)(C(O)O1)O)O)=O)=O,,,4,1,1,7,8
5146_0,,,,2,1,1,2
C1(C(CC(C)(C(O)O1)O)=O)=O,,,4,1,1,8,9
5147_0,,,,2,1,1,2
5149_0,,,,2,1,1,2
C1(C(CC(C(C)(O)O1)O)=O)=O,,,4,1,1,8,9
5151_0,,,,2,1,1,2
C(C1(COC(C(C1)=O)O)O)(O)=O,,,4,1,2,8,10
5153_0,,,,2,1,1,2
C1(C(CO)(CC(C(O)O1)=O)O)=O,,,4,1,1,8,9
5155_0,,,,2,1,1,2
C1(C(C)(CC(C(O)O1)=O)O)=O,,,4,1,1,9,10
5156_0,,,,2,1,1,2
5158_0,,,,2,1,1,2
C1(C(C)(O)OC([C](C1)O)=O)=O,,,4,1,1,7,8
5160_0,,,,2,1,1,2
C1(CC(C(OC1(C)O)=O)O)=O,,,4,1,1,8,9
5162_0,,,,2,1,1,2
C1(CC(C(O)=O)(O)OCC1O)=O,,,4,1,2,8,10
5164_0,,,,2,1,1,2
[CH]1C(OC(C(C(C)O)C1)O)=O,,,4,1,1,5,6
5166_0,,,,2,1,1,2
C1(CCC(C(O)O1)C(C)O)=O,,,4,1,1,5,6
5168_0,,,,2,1,1,2
C(C1C(O)OC([CH]C1)=O)(O)=O,,,4,1,1,5,6
5170_0,,,,2,1,1,2
C(C1CCC(OC1O)=O)(O)=O,,,4,1,1,5,6
5172_0,,,,2,1,1,2
C(C1(C(C[CH]C(O1)=O)O)O)=O,,,4,1,1,8,9
5174_0,,,,2,1,1,2
C1(CCC(C(C=O)(O)O1)O)=O,,,4,1,1,8,9
5176_0,,,,2,1,1,2
C(C1(CC[CH]C(O1)=O)O)=O,,,4,1,1,9,10
5178_0,,,,2,1,1,2
C1(CCCC(C=O)(O)O1)=O,,,4,1,1,6,7
5180_0,,,,2,1,1,2
C(C1(C(C[CH]C(O1)=O)O)O)(O)=O,,,4,1,2,6,8
5182_0,,,,2,1,1,2
[CH]1C(OC(CC1)O)=O,,,4,1,1,23,24
5184_0,,,,2,1,1,2
C(C1(CC[CH]C(O1)=O)O)(O)=O,,,4,1,2,4,6
5186_0,,,,2,1,1,2
C1(CCC(C(C(O)=O)(O)O1)O)=O,,,4,1,2,6,8
5188_0,,,,2,1,1,2
C1(CCCC(O)O1)=O,,,4,1,1,19,20
5190_0,,,,2,1,1,2
C1(CCCC(C(O)=O)(O)O1)=O,,,4,1,2,4,6
5192_0,,,,2,1,1,2
C1(C(O)OC(C)CC(C1O)O)=O,,,4,1,1,8,9
5194_0,,,,2,1,1,2
C1(C(O)OC(C)CC(C1)O)=O,,,4,1,1,9,10
5196_0,,,,2,1,1,2
C1(CC(C(C(C(O)O1)=O)O)O)=O,,,4,1,1,8,9
5198_0,,,,2,1,1,2
C1(CC(CC(C(O)O1)=O)O)=O,,,4,1,1,10,11
5200_0,,,,2,1,1,2
C1(C(C)(CC(CC(O)O1)O)O)=O,,,4,1,1,6,7
5202_0,,,,2,1,1,2
C(C1(CC(C(CCO1)=O)=O)O)(O)=O,,,4,1,1,7,8
5204_0,,,,2,1,1,2
C1(COC(C(C(C1O)O)=O)O)=O,,,4,1,1,10,11
5206_0,,,,2,1,1,2
C1(COC(C(CC1O)=O)O)=O,,,4,1,1,12,13
5208_0,,,,2,1,1,2
[CH]1C(OC(CC(C)(C1)O)O)=O,,,4,1,1,6,7
5210_0,,,,2,1,1,2
C1(CCC(C)(CC(O)O1)O)=O,,,4,1,1,6,7
5212_0,,,,2,1,1,2
C1(C(O)OC([CH]CC1O)=O)=O,,,4,1,1,7,8
5214_0,,,,2,1,1,2
C1(CCC(C(C(O)O1)=O)O)=O,,,4,1,1,7,8
5216_0,,,,2,1,1,2
C1(C(O)OC([CH]CC1)=O)=O,,,4,1,1,18,19
5218_0,,,,2,1,1,2
C1(CCCC(C(O)O1)=O)=O,,,4,1,1,12,13
5219_0,,,,2,1,1,2
5220_0,,,,2,1,1,2
5221_0,,,,2,1,1,2
5222_0,,,,2,1,1,2
5223_0,,,,2,1,1,2
5224_0,,,,2,1,2,3
5225_0,,,,2,1,2,3
5226_0,,,,2,1,2,3
5227_0,,,,2,1,2,3
5228_0,,,,2,1,2,3
5229_0,,,,2,1,2,3
5230_0,,,,2,1,2,3
5231_0,,,,2,1,2,3
5232_0,,,,2,1,2,3
5233_0,,,,2,1,2,3
5234_0,,,,2,1,2,3
5235_0,,,,2,1,2,3
5236_0,,,,2,1,2,3
5237_0,,,,2,1,2,3
5238_0,,,,2,1,2,3
5239_0,,,,2,1,2,3
5240_0,,,,2,1,2,3
5241_0,,,,2,1,2,3
5242_0,,,,2,1,2,3
5243_0,,,,2,1,2,3
5244_0,,,,2,1,2,3
5245_0,,,,2,1,2,3
5246_0,,,,2,1,2,3
5247_0,,,,2,1,2,3
5248_0,,,,2,1,2,3
5249_0,,,,2,1,2,3
5250_0,,,,2,1,2,3
5251_0,,,,2,1,2,3
5252_0,,,,2,1,2,3
5253_0,,,,2,1,2,3
5254_0,,,,2,1,2,3
5256_0,,,,2,1,2,3
C(C(C[CH]C(O)=O)O)=O,,,4,1,7,21,28
5257_0,,,,2,1,2,3
5259_0,,,,2,1,2,3
C(CCC(C=O)O)(O)=O,,,4,1,9,21,30
5260_0,,,,2,1,2,3
5261_0,,,,2,1,2,3
5262_0,,,,2,1,2,3
5263_0,,,,2,1,2,3
5265_0,,,,2,1,2,3
C1(C(C(C(CC(C)O)O1)O)=O)=O,,,4,1,2,4,6
5267_0,,,,2,1,2,3
C1(C(CC(CC(C)O)O1)=O)=O,,,4,1,2,6,8
5269_0,,,,2,1,2,3
C(C1C(C)OC(C1(CO)O)=O)=O,,,4,1,1,9,10
5271_0,,,,2,1,2,3
C(C1C(C)OC(C1(C)O)=O)=O,,,4,1,1,8,9
5272_0,,,,2,1,2,3
5274_0,,,,2,1,2,3
C1(C(C(CO1)C(C)O)=O)=O,,,4,1,4,10,14
5275_0,,,,2,1,2,3
5276_0,,,,2,1,2,3
5277_0,,,,2,1,2,3
5278_0,,,,2,1,2,3
5280_0,,,,2,1,2,3
C1(CC(C(C(C=O)=O)O1)O)=O,,,4,1,1,13,14
5282_0,,,,2,1,2,3
C(CC1C(C(C(O1)=O)=O)O)(O)=O,,,4,1,2,3,5
5284_0,,,,2,1,2,3
C1(CC(C(C(C(O)=O)=O)O1)O)=O,,,4,1,3,7,10
5286_0,,,,2,1,2,3
C(CC1CC(C(O1)=O)=O)(O)=O,,,4,1,2,5,7
5288_0,,,,2,1,2,3
C1(C(C=O)C(C=O)(CO1)O)=O,,,4,1,2,9,11
5290_0,,,,2,1,2,3
C1(C(C=O)C(C(O1)=O)(CO)O)=O,,,4,1,2,10,12
5292_0,,,,2,1,2,3
C1(C(C=O)C(C(O)=O)(CO1)O)=O,,,4,1,3,9,12
5293_0,,,,2,1,2,3
5295_0,,,,2,1,2,3
C1(C(C)(CC(CC=O)O1)O)=O,,,4,1,1,8,9
5297_0,,,,2,1,2,3
C(C1COC(C1(C)O)=O)=O,,,4,1,2,11,13
5298_0,,,,2,1,2,3
5300_0,,,,2,1,2,3
C(C1C(C(OC1)=O)=O)(O)=O,,,4,1,5,8,13
5301_0,,,,2,1,2,3
5302_0,,,,2,1,2,3
5304_0,,,,2,1,2,3
C(C(C)=O)(C1C(C(OC1)=O)=O)=O,,,4,1,2,5,7
5306_0,,,,2,1,2,3
C(CO)(C1C(C(C(O1)=O)=O)O)=O,,,4,1,2,7,9
5308_0,,,,2,1,2,3
C(CO)(C1CC(C(O1)=O)=O)=O,,,4,1,3,10,13
5310_0,,,,2,1,2,3
C(C1(CO)C(C(C(O1)=O)=O)O)=O,,,4,1,2,10,12
5312_0,,,,2,1,2,3
C(C1(CO)CC(C(O1)=O)=O)=O,,,4,1,2,8,10
5314_0,,,,2,1,2,3
C(C1(C)C(C(C(O1)=O)=O)O)=O,,,4,1,1,7,8
5316_0,,,,2,1,2,3
C(C1(C)CC(C(O1)=O)=O)=O,,,4,1,1,15,16
5318_0,,,,2,1,2,3
C(C)(C1C(C(C(O1)=O)=O)O)=O,,,4,1,2,10,12
5320_0,,,,2,1,2,3
C(C)(C1CC(C(O1)=O)=O)=O,,,4,1,1,24,25
5322_0,,,,2,1,2,3
C=C(C(O)=O)C1C(C(OC1)=O)=O,,,4,1,3,5,8
5324_0,,,,2,1,2,3
C=C1C(OCC1C(C(O)=O)=O)=O,,,4,1,3,7,10
5326_0,,,,2,1,1,2
C(C(C)(C1C(C(OC1)=O)=O)O)(O)=O,,,4,1,6,8,14
5328_0,,,,2,1,2,3
C1(C2(C)C(C(C(O2)=O)=O)CO1)=O,,,4,1,2,1,3
5329_0,,,,2,1,1,2
5330_0,,,,2,1,1,2
5332_0,,,,2,1,1,2
C1(C(C)(C(C(C(O)=O)=O)CO1)O)=O,,,4,1,2,9,11
5334_0,,,,2,1,2,3
C1(C(C(CO1)O)=O)=O,,,4,1,1,63,64
5336_0,,,,2,1,2,3
C1(C(OCC1)=O)=O,,,4,1,9,175,184
5338_0,,,,2,1,2,3
C(C1(CO)CC(C(O1)=O)=O)(O)=O,,,4,1,4,4,8
5340_0,,,,2,1,2,3
C1(C(C(C(C)O1)O)=O)=O,,,4,1,1,19,20
5342_0,,,,2,1,2,3
C1(C(C(C(O1)=O)=O)O)=O,,,4,1,2,17,19
5344_0,,,,2,1,2,3
C(C1(C)C(C(C(O1)=O)=O)O)(O)=O,,,4,1,3,3,6
5346_0,,,,2,1,2,3
C1(C(C(CO1)=O)=O)=O,,,4,1,1,85,86
5348_0,,,,2,1,2,3
C1(C(C)(CCO1)O)=O,,,4,1,1,14,15
5350_0,,,,2,1,2,3
C1(C(C)(CC(O1)=O)O)=O,,,4,1,1,10,11
5352_0,,,,2,1,2,3
C(C1(CO)C(CC(O1)=O)O)(O)=O,,,4,1,5,5,10
5354_0,,,,2,1,2,3
C1(C(CO)(C(C=O)(CO1)O)O)=O,,,4,1,4,11,15
5356_0,,,,2,1,2,3
C1(CC(C(C(O)=O)O1)O)=O,,,4,1,4,11,15
5358_0,,,,2,1,2,3
C(C1(C)C(CC(O1)=O)O)(O)=O,,,4,1,3,3,6
5360_0,,,,2,1,2,3
C(C1(COC(C1O)=O)O)=O,,,4,1,3,14,17
5362_0,,,,2,1,2,3
C1(C(C)(C(C=O)(CO1)O)O)=O,,,4,1,1,7,8
5364_0,,,,2,1,2,3
C1(C(CO)(C(C(O1)=O)O)O)=O,,,4,1,5,10,15
5366_0,,,,2,1,2,3
C(C1(COC(C1O)=O)O)(O)=O,,,4,1,4,8,12
5367_0,,,,2,1,2,3
5368_0,,,,2,1,2,3
5369_0,,,,2,1,2,3
5370_0,,,,2,1,2,3
5371_0,,,,2,1,2,3
5372_0,,,,2,1,2,3
5373_0,,,,2,1,2,3
5374_0,,,,2,1,2,3
5375_0,,,,2,1,2,3
5376_0,,,,2,1,2,3
5378_0,,,,2,1,2,3
C1(C(C)(C(CO1)O)O)=O,,,4,1,2,6,8
5379_0,,,,2,1,2,3
5381_0,,,,2,1,2,3
C1(C2(C)C(C(C(O2)=O)O1)O)=O,,,4,1,2,4,6
5382_0,,,,2,1,1,2
5383_0,,,,2,1,1,2
5384_0,,,,2,1,1,2
5385_0,,,,2,1,1,2
5386_0,,,,2,1,2,3
5388_0,,,,2,1,2,3
C1(C2(C)C[C](C(O2)=O)O1)=O,,,4,1,2,2,4
5389_0,,,,2,1,2,3
5391_0,,,,2,1,2,3
C1(C2(C)CC(C(O2)=O)O1)=O,,,4,1,2,7,9
5392_0,,,,2,1,2,3
5393_0,,,,2,1,1,2
5394_0,,,,2,1,1,2
5395_0,,,,2,1,1,2
5396_0,,,,2,1,1,2
5398_0,,,,2,1,2,3
C(CC1(C)C[CH]C(O1)=O)=O,,,4,1,1,19,20
5400_0,,,,2,1,2,3
C(CC1(C)CCC(O1)=O)=O,,,4,1,1,17,18
5402_0,,,,2,1,2,3
C(C(C1C[CH]C(O1)=O)=O)=O,,,4,1,2,16,18
5404_0,,,,2,1,2,3
C1(CCC(C(C=O)=O)O1)=O,,,4,1,2,15,17
5406_0,,,,2,1,2,3
C(C1C[CH]C(O1)=O)(O)=O,,,4,1,3,15,18
5408_0,,,,2,1,2,3
C(C1CCC(O1)=O)(O)=O,,,4,1,3,10,13
5410_0,,,,2,1,2,3
[CH]1C(OC(CO)C1)=O,,,4,1,2,21,23
5412_0,,,,2,1,2,3
C1([CH]CC(C(C(O)=O)=O)O1)=O,,,4,1,4,5,9
5414_0,,,,2,1,2,3
C(C(C1C[CH]C(O1)=O)O)(O)=O,,,4,1,6,5,11
5416_0,,,,2,1,2,3
C(C1(CO)C[CH]C(O1)=O)(O)=O,,,4,1,4,2,6
5418_0,,,,2,1,2,3
C(C1(C)C[CH]C(O1)=O)(O)=O,,,4,1,2,4,6
5420_0,,,,2,1,2,3
C1(CCC(CO)O1)=O,,,4,1,2,17,19
5422_0,,,,2,1,2,3
C1(CCC(C(C(O)=O)=O)O1)=O,,,4,1,4,5,9
5424_0,,,,2,1,2,3
C1(CCC(C(C(O)=O)O)O1)=O,,,4,1,6,5,11
5426_0,,,,2,1,2,3
C(C1(CCC(O1)=O)CO)(O)=O,,,4,1,4,2,6
5428_0,,,,2,1,2,3
C(C1(C)CCC(O1)=O)(O)=O,,,4,1,2,1,3
5430_0,,,,2,1,2,3
[C]1(C(OC(C)C1)=O)O,,,4,1,1,16,17
5432_0,,,,2,1,2,3
C1(C[C](C(O1)=O)O)=O,,,4,1,1,26,27
5434_0,,,,2,1,2,3
C1(C(CC(C)O1)O)=O,,,4,1,6,35,41
5436_0,,,,2,1,2,3
C1(CC(C(O1)=O)O)=O,,,4,1,6,45,51
5438_0,,,,2,1,2,3
C1(C(C=O)C(CC(C)O1)O)=O,,,4,1,2,8,10
5440_0,,,,2,1,2,3
C(C1C(CC(OC1C)=O)O)=O,,,4,1,1,9,10
5442_0,,,,2,1,2,3
C1(C(C=O)C(CC(O1)=O)O)=O,,,4,1,2,9,11
5444_0,,,,2,1,2,3
C1(C(C=O)C(C(CO1)=O)O)=O,,,4,1,2,13,15
5446_0,,,,2,1,2,3
C(C1(COC(C(C1O)=O)=O)O)=O,,,4,1,2,10,12
5448_0,,,,2,1,2,3
C(C1(COC(C(C1)=O)=O)O)=O,,,4,1,2,8,10
5449_0,,,,2,1,2,3
5451_0,,,,2,1,2,3
C(C1(COC(C(C1)=O)=O)O)(O)=O,,,4,1,4,7,11
5453_0,,,,2,1,2,3
C1(C(CO)(CC(C(O1)=O)=O)O)=O,,,4,1,3,8,11
5455_0,,,,2,1,2,3
C1(C(C)(C(C(C(O1)=O)=O)O)O)=O,,,4,1,2,7,9
5456_0,,,,2,1,2,3
5458_0,,,,2,1,2,3
C1(C(CO)(C(CC(C)O1)O)O)=O,,,4,1,4,7,11
5460_0,,,,2,1,2,3
C1(C(CO)(C(CC(O1)=O)O)O)=O,,,4,1,5,9,14
5462_0,,,,2,1,2,3
C(C1(COC(CC1O)=O)O)(O)=O,,,4,1,2,7,9
5464_0,,,,2,1,2,3
C1(C(CO)(C(C(CO1)=O)O)O)=O,,,4,1,4,10,14
5466_0,,,,2,1,2,3
C1(C(C(CC(C)O1)O)O)=O,,,4,1,3,10,13
5468_0,,,,2,1,2,3
C1(C(C)(C(CC(C)O1)O)O)=O,,,4,1,1,4,5
5470_0,,,,2,1,2,3
C1(CC(C(C(O1)=O)O)O)=O,,,4,1,3,14,17
5472_0,,,,2,1,2,3
C1(C(C)(C(CC(O1)=O)O)O)=O,,,4,1,2,6,8
5474_0,,,,2,1,2,3
C1(C(C(C(CO1)=O)O)O)=O,,,4,1,3,25,28
5476_0,,,,2,1,2,3
C1(C(C)(C(C(CO1)=O)O)O)=O,,,4,1,1,10,11
5477_0,,,,2,1,2,3
5478_0,,,,2,1,2,3
5479_0,,,,2,1,2,3
5480_0,,,,2,1,2,3
5481_0,,,,2,1,2,3
5483_0,,,,2,1,2,3
C1(C(CO)OC(C(C1)=O)=O)=O,,,4,1,5,9,14
5484_0,,,,2,1,2,3
5486_0,,,,2,1,2,3
C(C1COC(C(C1)=O)=O)(O)=O,,,4,1,3,6,9
5487_0,,,,2,1,2,3
5489_0,,,,2,1,2,3
C(C1C(C)OC([CH]C1)=O)=O,,,4,1,1,16,17
5491_0,,,,2,1,2,3
C(C1CCC(OC1C)=O)=O,,,4,1,1,15,16
5493_0,,,,2,1,2,3
C(CC1CC[CH]C(O1)=O)=O,,,4,1,1,20,21
5495_0,,,,2,1,2,3
C(CC1CCCC(O1)=O)=O,,,4,1,1,18,19
5497_0,,,,2,1,2,3
C(C1C(OC([CH]C1)=O)=O)=O,,,4,1,2,14,16
5499_0,,,,2,1,2,3
C(C1C(OC(CC1)=O)=O)=O,,,4,1,2,13,15
5501_0,,,,2,1,2,3
C1(C(C[CH]C(O1)=O)O)=O,,,4,1,2,17,19
5503_0,,,,2,1,2,3
C1(CCC(C(O1)=O)O)=O,,,4,1,2,12,14
5505_0,,,,2,1,2,3
[CH]1C(OCC(C1)O)=O,,,4,1,1,23,24
5507_0,,,,2,1,2,3
C(C1C(C[CH]C(O1)=O)O)(O)=O,,,4,1,2,6,8
5509_0,,,,2,1,2,3
C1(C(CO)(C[CH]C(O1)=O)O)=O,,,4,1,4,6,10
5511_0,,,,2,1,2,3
C(C1(COC([CH]C1)=O)O)(O)=O,,,4,1,2,5,7
5513_0,,,,2,1,2,3
C1([CH]CC[C](C(O)=O)O1)=O,,,4,1,2,4,6
5515_0,,,,2,1,2,3
C(C1CC[CH]C(O1)=O)(O)=O,,,4,1,2,9,11
5517_0,,,,2,1,2,3
C1(C(C)(C[CH]C(O1)=O)O)=O,,,4,1,1,7,8
5519_0,,,,2,1,2,3
C1(CCC(CO1)O)=O,,,4,1,1,19,20
5521_0,,,,2,1,2,3
C1(CCC(C(C(O)=O)O1)O)=O,,,4,1,2,6,8
5523_0,,,,2,1,2,3
C1(C(CO)(CCC(O1)=O)O)=O,,,4,1,4,6,10
5525_0,,,,2,1,2,3
C(C1(COC(CC1)=O)O)(O)=O,,,4,1,2,5,7
5527_0,,,,2,1,2,3
C1(CCC[C](C(O)=O)O1)=O,,,4,1,2,4,6
5529_0,,,,2,1,2,3
C(C1CCCC(O1)=O)(O)=O,,,4,1,2,4,6
5531_0,,,,2,1,2,3
C1(C(C)(CCC(O1)=O)O)=O,,,4,1,1,4,5
5533_0,,,,2,1,2,3
C1(C(C(C(CC(C)O1)O)O)=O)=O,,,4,1,2,7,9
5535_0,,,,2,1,2,3
C1(C(CC(CC(C)O1)O)=O)=O,,,4,1,2,7,9
5537_0,,,,2,1,2,3
C1(CC(C(C(C(O1)=O)=O)O)O)=O,,,4,1,2,8,10
5539_0,,,,2,1,2,3
C1(CC(CC(C(O1)=O)=O)O)=O,,,4,1,2,8,10
5541_0,,,,2,1,2,3
C1(COC(C(C(C1O)O)=O)=O)=O,,,4,1,2,9,11
5543_0,,,,2,1,2,3
C1(COC(C(CC1O)=O)=O)=O,,,4,1,3,10,13
5545_0,,,,2,1,2,3
C1(C(COC(C(C1)=O)=O)O)=O,,,4,1,3,9,12
5547_0,,,,2,1,2,3
C1(C(C(C[CH]C(O1)=O)O)=O)=O,,,4,1,2,5,7
5549_0,,,,2,1,2,3
C1(C(C(C[CH]C(O1)=O)O)O)=O,,,4,1,3,9,12
5551_0,,,,2,1,2,3
C1([C](CC[CH]C(O1)=O)O)=O,,,4,1,1,6,7
5553_0,,,,2,1,2,3
C1(C(CC[CH]C(O1)=O)O)=O,,,4,1,2,11,13
5555_0,,,,2,1,2,3
C1(C(CC[CH]C(O1)=O)=O)=O,,,4,1,3,12,15
5557_0,,,,2,1,2,3
C1(CCC(C(C(O1)=O)=O)O)=O,,,4,1,2,5,7
5559_0,,,,2,1,2,3
C1(CCC(C(C(O1)=O)O)O)=O,,,4,1,3,9,12
5561_0,,,,2,1,2,3
C1(CCC[C](C(O1)=O)O)=O,,,4,1,1,6,7
5563_0,,,,2,1,2,3
C1(CCCC(C(O1)=O)O)=O,,,4,1,2,6,8
5565_0,,,,2,1,2,3
C1(CCCC(C(O1)=O)=O)=O,,,4,1,3,11,14
5567_0,,,,2,2,1,3
C(C(C(C)O)C(C(C)CC=O)O)=O,,,4,1,3,16,19
5569_0,,,,2,2,1,3
C(C(C(C[CH]C(O)=O)O)C(C)O)=O,,,4,1,5,13,18
5571_0,,,,2,2,1,3
C(C(C(C)O)C(CCC(O)=O)O)=O,,,4,1,5,13,18
5573_0,,,,2,2,1,3
C(C(CO)(C(C)CC=O)C(C)O)=O,,,4,1,3,11,14
5574_0,,,,2,2,1,3
5575_0,,,,2,2,1,3
5577_0,,,,2,2,1,3
C(C(CO)C(CC(C)CC=O)O)=O,,,4,1,5,14,19
5578_0,,,,2,2,1,3
5579_0,,,,2,2,1,3
5581_0,,,,2,2,1,3
C(C(CO)C(C)(C(C)CC=O)O)=O,,,4,1,3,16,19
5582_0,,,,2,2,1,3
5583_0,,,,2,2,1,3
5585_0,,,,2,2,1,3
C(C(C=O)C(C(C)CC=O)O)(O)=O,,,4,1,3,14,17
5587_0,,,,2,2,1,3
C(C(C=O)C(C[CH]C(O)=O)O)(O)=O,,,4,1,5,11,16
5589_0,,,,2,2,1,3
C(C(C=O)C(CCC(O)=O)O)(O)=O,,,4,1,5,11,16
5591_0,,,,2,2,1,3
C(C(C=O)(CO)C(C)CC=O)(O)=O,,,4,1,3,9,12
5592_0,,,,2,2,1,3
5593_0,,,,2,2,1,3
5595_0,,,,2,2,1,3
C(CC(C)C(C(C(C=O)=O)O)O)=O,,,4,1,1,19,20
5597_0,,,,2,2,1,3
[CH](C(O)=O)CC(C(C(C=O)=O)O)O,,,4,1,3,14,17
5599_0,,,,2,2,1,3
C(CCC(C(C(C=O)=O)O)O)(O)=O,,,4,1,3,14,17
5601_0,,,,2,2,1,3
C(CC(C)C(C(C=O)=O)(CO)O)=O,,,4,1,2,14,16
5602_0,,,,2,2,1,3
5603_0,,,,2,2,1,3
5605_0,,,,2,2,1,3
C(CC(C)C(C=O)C(C=O)(C)O)=O,,,4,1,3,12,15
5606_0,,,,2,2,1,3
5607_0,,,,2,2,1,3
5609_0,,,,2,2,1,3
C(CC(C)CC(C=O)(CC=O)O)=O,,,4,1,2,13,15
5610_0,,,,2,2,1,3
5611_0,,,,2,2,1,3
5613_0,,,,2,2,1,3
C(CC(C)C(C=O)C(C(C)=O)O)=O,,,4,1,3,14,17
5614_0,,,,2,2,1,3
5615_0,,,,2,2,1,3
5617_0,,,,2,2,1,3
C(CC(C(CC(C)CC=O)=O)O)=O,,,4,1,2,15,17
5618_0,,,,2,2,1,3
5619_0,,,,2,2,1,3
5621_0,,,,2,2,1,3
C(C)(C(C(C)CC=O)(CC=O)O)=O,,,4,1,1,13,14
5623_0,,,,2,2,1,3
C(CC(C(C)=O)(C[CH]C(O)=O)O)=O,,,4,1,2,9,11
5625_0,,,,2,2,1,3
C(C)(C(CCC(O)=O)(CC=O)O)=O,,,4,1,2,9,11
5627_0,,,,2,2,1,3
C(CC(C)C(CC(C=O)=O)O)=O,,,4,1,1,20,21
5629_0,,,,2,2,1,3
[CH](C(O)=O)CC(CC(C=O)=O)O,,,4,1,2,13,15
5631_0,,,,2,2,1,3
C(CCC(CC(C=O)=O)O)(O)=O,,,4,1,2,13,15
5633_0,,,,2,2,1,3
C(CC(C)C(C(C=O)=O)CO)=O,,,4,1,2,18,20
5634_0,,,,2,2,1,3
5635_0,,,,2,2,1,3
5637_0,,,,2,2,1,3
C(CC(C)CC(CC(C=O)=O)O)=O,,,4,1,2,14,16
5638_0,,,,2,2,1,3
5639_0,,,,2,2,1,3
5641_0,,,,2,2,1,3
C(CC(C)C(C)(CC(C=O)=O)O)=O,,,4,1,1,15,16
5643_0,,,,2,2,1,3
[CH](C(O)=O)CC(C)(CC(C=O)=O)O,,,4,1,2,10,12
5645_0,,,,2,2,1,3
C(CCC(C)(CC(C=O)=O)O)(O)=O,,,4,1,2,10,12
5647_0,,,,2,2,1,3
C(CC(C)C(C(C=O)=O)C(C)O)=O,,,4,1,2,13,15
5648_0,,,,2,2,1,3
5649_0,,,,2,2,1,3
5651_0,,,,2,2,1,3
C(CC(C)C(C(O)=O)C(C=O)=O)=O,,,4,1,2,12,14
5652_0,,,,2,2,1,3
5653_0,,,,2,2,1,3
5655_0,,,,2,2,1,3
C(C(CO)C(C)CC=O)=O,,,4,1,8,21,29
5657_0,,,,2,2,1,3
C(C(CO)C(C)CC(C(O)=O)=O)=O,,,4,1,3,13,16
5659_0,,,,2,2,1,3
C(C(CC(C=O)CO)CC=O)(O)=O,,,4,1,2,13,15
5661_0,,,,2,2,1,3
C(C(C)(CC=O)C(C=O)CO)(O)=O,,,4,1,3,12,15
5663_0,,,,2,2,1,3
C(C(C)C(C=O)C(C=O)CO)(O)=O,,,4,1,2,12,14
5665_0,,,,2,2,1,3
C(C(CC(C=O)CO)C(C)O)(O)=O,,,4,1,2,10,12
5667_0,,,,2,2,1,3
C(C(C(O)=O)CC(C=O)CO)(O)=O,,,4,1,2,8,10
5668_0,,,,2,2,1,3
5669_0,,,,2,2,1,3
5671_0,,,,2,2,1,3
C(CC(C(C)CC=O)O)=O,,,4,1,7,26,33
5673_0,,,,2,2,1,3
C(CC(C(C)CC(C(O)=O)=O)O)=O,,,4,1,1,14,15
5675_0,,,,2,2,1,3
C(C(CC(CC=O)O)CC=O)(O)=O,,,4,1,1,14,15
5677_0,,,,2,2,1,3
C(C(C)(C(CC=O)O)CC=O)(O)=O,,,4,1,1,12,13
5679_0,,,,2,2,1,3
C(CC(C(C=O)C(C(O)=O)C)O)=O,,,4,1,1,11,12
5681_0,,,,2,2,1,3
C(C(CC(CC=O)O)C(C)O)(O)=O,,,4,1,1,11,12
5683_0,,,,2,2,1,3
C(C(C(O)=O)CC(CC=O)O)(O)=O,,,4,1,1,9,10
5685_0,,,,2,2,1,3
C(CC(C[CH]C(O)=O)O)=O,,,4,1,7,16,23
5687_0,,,,2,2,1,3
C(CCC(CC=O)O)(O)=O,,,4,1,8,16,24
5689_0,,,,2,2,1,3
C(CC(C)C(C(C(O)=O)=O)CO)=O,,,4,1,4,13,17
5690_0,,,,2,2,1,3
5691_0,,,,2,2,1,3
5693_0,,,,2,2,1,3
C(CC(C)C(CC(C(O)=O)=O)O)=O,,,4,1,2,14,16
5695_0,,,,2,2,1,3
[CH](C(O)=O)CC(CC(C(O)=O)=O)O,,,4,1,3,10,13
5697_0,,,,2,2,1,3
C(CCC(CC(C(O)=O)=O)O)(O)=O,,,4,1,3,10,13
5699_0,,,,2,2,1,3
C(CC(C(CC(C)CC=O)=O)=O)=O,,,4,1,1,11,12
5701_0,,,,2,2,1,3
C(CC(C(CC[CH]C(O)=O)=O)=O)=O,,,4,1,1,6,7
5703_0,,,,2,2,1,3
C(CC(C(CCCC(O)=O)=O)=O)=O,,,4,1,1,6,7
5705_0,,,,2,2,1,3
C(CC(C)C(C=O)C(C(C)=O)=O)=O,,,4,1,1,9,10
5707_0,,,,2,2,1,3
C(C(C(C(C)=O)=O)C[CH]C(O)=O)=O,,,4,1,1,7,8
5709_0,,,,2,2,1,3
C(C(C(C(C)=O)=O)CCC(O)=O)=O,,,4,1,1,7,8
5711_0,,,,2,2,1,3
C(CC(C)CC(C(C(C)O)=O)=O)=O,,,4,1,1,10,11
5713_0,,,,2,2,1,3
[CH](C(O)=O)CCC(C(C(C)O)=O)=O,,,4,1,1,7,8
5715_0,,,,2,2,1,3
C(CCCC(C(C(C)O)=O)=O)(O)=O,,,4,1,1,7,8
5717_0,,,,2,2,1,3
C(CC(C)CC(C(C(C)=O)=O)O)=O,,,4,1,1,11,12
5719_0,,,,2,2,1,3
[CH](C(O)=O)CCC(C(C(C)=O)=O)O,,,4,1,1,6,7
5721_0,,,,2,2,1,3
C(CCCC(C(C(C)=O)=O)O)(O)=O,,,4,1,1,6,7
5723_0,,,,2,2,1,3
C(CC(C)C(C(C(C)=O)=O)(C)O)=O,,,4,1,1,9,10
5725_0,,,,2,2,1,3
[CH](C(O)=O)CC(C(C(C)=O)=O)(C)O,,,4,1,1,7,8
5727_0,,,,2,2,1,3
C(CCC(C(C(C)=O)=O)(C)O)(O)=O,,,4,1,1,7,8
5729_0,,,,2,2,1,3
C(CC(C)CC(C(C(O)=O)=O)=O)=O,,,4,1,1,9,10
5731_0,,,,2,2,1,3
C([CH]CCC(C(C(O)=O)=O)=O)(O)=O,,,4,1,1,7,8
5733_0,,,,2,2,1,3
C(CCCC(C(C(O)=O)=O)=O)(O)=O,,,4,1,1,7,8
5735_0,,,,2,2,1,3
C(C(C=O)(C(C)CC=O)O)=O,,,4,1,1,10,11
5737_0,,,,2,2,1,3
C(C(C=O)(C[CH]C(O)=O)O)=O,,,4,1,1,6,7
5739_0,,,,2,2,1,3
C(C(C=O)(CCC(O)=O)O)=O,,,4,1,1,6,7
5741_0,,,,2,2,1,3
C(C(C=O)(C(C)CC=O)O)(O)=O,,,4,1,3,12,15
5743_0,,,,2,2,1,3
C(C(C=O)(C[CH]C(O)=O)O)(O)=O,,,4,1,3,9,12
5745_0,,,,2,2,1,3
C(C(C=O)(CCC(O)=O)O)(O)=O,,,4,1,5,9,14
5747_0,,,,2,2,1,3
C(CC(C)C(CO)C(C)O)=O,,,4,1,2,11,13
5748_0,,,,2,2,1,3
5749_0,,,,2,2,1,3
5751_0,,,,2,2,1,3
C(CC(C)C(CC(C)O)O)=O,,,4,1,1,12,13
5753_0,,,,2,2,1,3
[CH](C(O)=O)CC(CC(C)O)O,,,4,1,1,7,8
5755_0,,,,2,2,1,3
C(CCC(CC(C)O)O)(O)=O,,,4,1,1,7,8
5757_0,,,,2,2,1,3
C(CC(C)CC(CCO)O)=O,,,4,1,2,10,12
5758_0,,,,2,2,1,3
5759_0,,,,2,2,1,3
5761_0,,,,2,2,1,3
C(CC(C)C(C)(CCO)O)=O,,,4,1,2,12,14
5762_0,,,,2,2,1,3
5763_0,,,,2,2,1,3
5765_0,,,,2,2,1,3
C(C(CO)C(C)CC=O)(O)=O,,,4,1,3,12,15
5766_0,,,,2,2,1,3
5767_0,,,,2,2,1,3
5769_0,,,,2,2,1,3
C(CC(C(C)CC=O)O)(O)=O,,,4,1,3,12,15
5771_0,,,,2,2,1,3
C(CC(C[CH]C(O)=O)O)(O)=O,,,4,1,3,6,9
5773_0,,,,2,2,1,3
C(CCC(CC(O)=O)O)(O)=O,,,4,1,3,6,9
5775_0,,,,2,2,1,3
C(CC(C)C(C(CO)=O)O)=O,,,4,1,3,16,19
5776_0,,,,2,2,1,3
5777_0,,,,2,2,1,3
5779_0,,,,2,2,1,3
C(CC(C)CC(CO)=O)=O,,,4,1,4,26,30
5781_0,,,,2,2,1,3
C(CO)(CC(C)CC(C(O)=O)=O)=O,,,4,1,3,12,15
5783_0,,,,2,2,1,3
C(CO)(CCC(C(O)=O)CC=O)=O,,,4,1,3,12,15
5785_0,,,,2,2,1,3
C(C(C)(CC(CO)=O)CC=O)(O)=O,,,4,1,3,12,15
5787_0,,,,2,2,1,3
C(CC(C=O)C(C(O)=O)C)(CO)=O,,,4,1,3,11,14
5789_0,,,,2,2,1,3
C(C(CCC(CO)=O)C(C)O)(O)=O,,,4,1,3,8,11
5791_0,,,,2,2,1,3
C(C(C(O)=O)CCC(CO)=O)(O)=O,,,4,1,3,6,9
5792_0,,,,2,2,1,3
5793_0,,,,2,2,1,3
5795_0,,,,2,2,1,3
C(CC(C)C(C(C)=O)O)=O,,,4,1,2,21,23
5797_0,,,,2,2,1,3
C(C)(C(C(C)CC(C(O)=O)=O)O)=O,,,4,1,1,11,12
5799_0,,,,2,2,1,3
C(C)(C(CC(C(O)=O)CC=O)O)=O,,,4,1,1,12,13
5801_0,,,,2,2,1,3
C(C(C)(C(C(C)=O)O)CC=O)(O)=O,,,4,1,1,8,9
5803_0,,,,2,2,1,3
C(C(C(C=O)C(C(O)=O)C)O)(C)=O,,,4,1,1,10,11
5805_0,,,,2,2,1,3
C(C(CC(C(C)=O)O)C(C)O)(O)=O,,,4,1,1,8,9
5807_0,,,,2,2,1,3
C(C(C(O)=O)CC(C(C)=O)O)(O)=O,,,4,1,1,6,7
5809_0,,,,2,2,1,3
C(C)(C(C[CH]C(O)=O)O)=O,,,4,1,1,13,14
5811_0,,,,2,2,1,3
C(CCC(C(C)=O)O)(O)=O,,,4,1,2,13,15
5813_0,,,,2,2,1,3
C(CC(C)CO)=O,,,4,1,2,112,114
5815_0,,,,2,2,1,3
C(C(CC(C)CO)=O)(O)=O,,,4,1,1,13,14
5817_0,,,,2,2,1,3
C(C(CCO)CC=O)(O)=O,,,4,1,2,13,15
5819_0,,,,2,2,1,3
C(C(C)(CO)CC=O)(O)=O,,,4,1,2,11,13
5821_0,,,,2,2,1,3
C(C(C)C(C=O)CO)(O)=O,,,4,1,2,13,15
5823_0,,,,2,2,1,3
C(C(CCO)C(C)O)(O)=O,,,4,1,1,8,9
5825_0,,,,2,2,1,3
C(C(C(O)=O)CCO)(O)=O,,,4,1,1,7,8
5827_0,,,,2,2,1,3
C(C(CCO)C(C(O)=O)(C)O)(O)=O,,,4,1,1,8,9
5829_0,,,,2,2,1,3
C1(C(C)C(CO)C(C(O)=O)(O)O1)=O,,,4,1,2,7,9
5831_0,,,,2,2,1,3
C1(C(CC(C(O)=O)(O)O1)CCO)=O,,,4,1,2,7,9
5833_0,,,,2,2,1,3
C1(C(C)C(C(C(O1)=O)=O)CO)=O,,,4,1,3,7,10
5835_0,,,,2,2,1,3
C1(C(C)(CO)CC(C(O1)=O)=O)=O,,,4,1,2,5,7
5837_0,,,,2,2,1,3
C1(C(CCO)CC(C(O1)=O)=O)=O,,,4,1,3,7,10
5839_0,,,,2,2,1,3
C(C(C)(C([CH]C(O)=O)CO)O)(O)=O,,,4,1,1,10,11
5841_0,,,,2,2,1,3
C(C(C)C([C](C(O)=O)O)CO)(O)=O,,,4,1,3,8,11
5843_0,,,,2,2,1,3
C(C(CCO)C[C](C(O)=O)O)(O)=O,,,4,1,3,8,11
5845_0,,,,2,2,1,3
C(C(C)(C(CO)CC(O)=O)O)(O)=O,,,4,1,1,10,11
5847_0,,,,2,2,1,3
C(C(C)C(CO)C(C(O)=O)O)(O)=O,,,4,1,4,10,14
5849_0,,,,2,2,1,3
C(C(CC(C(O)=O)O)CCO)(O)=O,,,4,1,4,10,14
5851_0,,,,2,2,1,3
C(C(C)C(C(C(O)=O)=O)CO)(O)=O,,,4,1,3,11,14
5853_0,,,,2,2,1,3
C(C(C)(CO)CC(C(O)=O)=O)(O)=O,,,4,1,1,9,10
5855_0,,,,2,2,1,3
C(C(CCO)CC(C(O)=O)=O)(O)=O,,,4,1,4,11,15
5857_0,,,,2,2,1,3
[CH](C(O)=O)CCO,,,4,1,2,21,23
5859_0,,,,2,2,1,3
C(CCCO)(O)=O,,,4,1,5,21,26
5861_0,,,,2,2,1,3
C(CC(C)CCO)=O,,,4,1,3,63,66
5863_0,,,,2,2,1,3
C(C(CC(C)CCO)=O)(O)=O,,,4,1,2,10,12
5865_0,,,,2,2,1,3
C(C(CCCO)CC=O)(O)=O,,,4,1,2,10,12
5867_0,,,,2,2,1,3
C(C(C)(CCO)CC=O)(O)=O,,,4,1,2,10,12
5869_0,,,,2,2,1,3
C(C(C)C(C=O)CCO)(O)=O,,,4,1,2,10,12
5871_0,,,,2,2,1,3
C(C(CCCO)C(C)O)(O)=O,,,4,1,2,6,8
5873_0,,,,2,2,1,3
C(C(C(O)=O)CCCO)(O)=O,,,4,1,2,5,7
5875_0,,,,2,2,1,3
C1(C(C)C(C(C(O1)=O)=O)CCO)=O,,,4,1,2,7,9
5877_0,,,,2,2,1,3
C1(C(C)(CCO)CC(C(O1)=O)=O)=O,,,4,1,2,6,8
5879_0,,,,2,2,1,3
C1(C(CCCO)CC(C(O1)=O)=O)=O,,,4,1,2,5,7
5880_0,,,,2,2,1,3
5881_0,,,,2,2,1,3
5883_0,,,,2,2,1,3
C(CC(C)C(C)O)=O,,,4,1,2,64,66
5885_0,,,,2,2,1,3
C(C(CC(C)C(C)O)=O)(O)=O,,,4,1,1,11,12
5887_0,,,,2,2,1,3
C(C(CC(C)O)CC=O)(O)=O,,,4,1,1,11,12
5889_0,,,,2,2,1,3
C(C(C)(C(C)O)CC=O)(O)=O,,,4,1,1,9,10
5891_0,,,,2,2,1,3
C(C(C)C(C=O)C(C)O)(O)=O,,,4,1,1,11,12
5893_0,,,,2,2,1,3
C(C(CC(C)O)C(C)O)(O)=O,,,4,1,1,7,8
5895_0,,,,2,2,1,3
C(C(C(O)=O)CC(C)O)(O)=O,,,4,1,1,6,7
5897_0,,,,2,2,1,3
C1(C(C)C(C(C(O1)=O)=O)C(C)O)=O,,,4,1,1,7,8
5899_0,,,,2,2,1,3
C1(C(C)(C(C)O)CC(C(O1)=O)=O)=O,,,4,1,1,5,6
5901_0,,,,2,2,1,3
C1(C(CC(C)O)CC(C(O1)=O)=O)=O,,,4,1,1,7,8
5903_0,,,,2,2,1,3
[CH](C(O)=O)CC(C)O,,,4,1,1,20,21
5905_0,,,,2,2,1,3
C(CCC(C)O)(O)=O,,,4,1,2,20,22
5907_0,,,,2,2,1,3
C(C(C(C)CC=O)C(C)O)(O)=O,,,4,1,2,11,13
5908_0,,,,2,2,1,3
5909_0,,,,2,2,1,3
5911_0,,,,2,2,1,3
C(CC(CC(C)CC=O)O)(O)=O,,,4,1,2,9,11
5912_0,,,,2,2,1,3
5913_0,,,,2,2,1,3
5915_0,,,,2,2,1,3
C(CC(C)(C(C)CC=O)O)(O)=O,,,4,1,2,11,13
5916_0,,,,2,2,1,3
5917_0,,,,2,2,1,3
5919_0,,,,2,2,1,3
C(CC(C)C(C(O)=O)C(O)=O)=O,,,4,1,2,9,11
5920_0,,,,2,2,1,3
5921_0,,,,2,2,1,3
5923_0,,,,2,2,1,3
C(CC(C)CC(O)=O)=O,,,4,1,6,21,27
5925_0,,,,2,2,1,3
C(CC(C)CC(C(O)=O)=O)(O)=O,,,4,1,3,10,13
5927_0,,,,2,2,1,3
C(CC(C(O)=O)CCC(O)=O)=O,,,4,1,3,9,12
5929_0,,,,2,2,1,3
C(CC(C(O)=O)(C)CC(O)=O)=O,,,4,1,3,10,13
5931_0,,,,2,2,1,3
C(C(CC(O)=O)C(C(O)=O)C)=O,,,4,1,2,9,11
5932_0,,,,2,2,1,3
5933_0,,,,2,2,1,3
5934_0,,,,2,2,1,3
5935_0,,,,2,2,1,3
5937_0,,,,2,2,1,3
C(C(CO)(CC(C)CC=O)O)(O)=O,,,4,1,3,10,13
5938_0,,,,2,2,1,3
5939_0,,,,2,2,1,3
5941_0,,,,2,2,1,3
C(C(C)(C(C(C)CC=O)O)O)(O)=O,,,4,1,1,11,12
5943_0,,,,2,2,1,3
C(C(C)(C(C[CH]C(O)=O)O)O)(O)=O,,,4,1,2,9,11
5945_0,,,,2,2,1,3
C(C(C)(C(CCC(O)=O)O)O)(O)=O,,,4,1,2,9,11
5947_0,,,,2,2,1,3
C(CC(C)CC(C(C(O)=O)O)O)=O,,,4,1,2,13,15
5948_0,,,,2,2,1,3
5949_0,,,,2,2,1,3
5951_0,,,,2,2,1,3
C(CC(C)C(C)(C(C(O)=O)O)O)=O,,,4,1,1,14,15
5953_0,,,,2,2,1,3
C(C(C(C)(C[CH]C(O)=O)O)O)(O)=O,,,4,1,2,10,12
5955_0,,,,2,2,1,3
C(CCC(C)(C(C(O)=O)O)O)(O)=O,,,4,1,2,10,12
5957_0,,,,2,2,1,3
C(C(C(C)O)(C(C)CC=O)O)(O)=O,,,4,1,2,11,13
5958_0,,,,2,2,1,3
5959_0,,,,2,2,1,3
5961_0,,,,2,2,1,3
C(C(C(O)=O)(C(C)CC=O)O)(O)=O,,,4,1,3,7,10
5962_0,,,,2,2,1,3
5963_0,,,,2,2,1,3
5965_0,,,,2,2,1,3
C(C(C=O)(CC(C)CC=O)O)(O)=O,,,4,1,2,10,12
5967_0,,,,2,2,1,3
C(C(C=O)(CC[CH]C(O)=O)O)(O)=O,,,4,1,2,8,10
5969_0,,,,2,2,1,3
C(C(C=O)(CCCC(O)=O)O)(O)=O,,,4,1,2,8,10
5971_0,,,,2,2,1,3
C(CC(C)CC(C(C)=O)C(O)=O)=O,,,4,1,1,10,11
5973_0,,,,2,2,1,3
C(C)(C(C(O)=O)CC[CH]C(O)=O)=O,,,4,1,1,6,7
5975_0,,,,2,2,1,3
C(C)(C(C(O)=O)CCCC(O)=O)=O,,,4,1,1,6,7
5977_0,,,,2,2,1,3
C(CC(C)C(C(C)=O)(C(O)=O)C)=O,,,4,1,1,6,7
5979_0,,,,2,2,1,3
C(C)(C(C(O)=O)(C)C[CH]C(O)=O)=O,,,4,1,1,4,5
5981_0,,,,2,2,1,3
C(C)(C(C(O)=O)(C)CCC(O)=O)=O,,,4,1,1,4,5
5983_0,,,,2,2,1,3
C(CC(C)CC(C(C(O)=O)C)=O)=O,,,4,1,1,8,9
5985_0,,,,2,2,1,3
C(CC[CH]C(O)=O)(C(C(O)=O)C)=O,,,4,1,1,5,6
5987_0,,,,2,2,1,3
C(CCCC(O)=O)(C(C(O)=O)C)=O,,,4,1,1,5,6
5989_0,,,,2,2,1,3
C(CC(C)CC=CC=O)=O,,,4,1,4,26,30
5991_0,,,,2,2,1,3
C(CC(C)CC(C(O)=O)=O)=CC=O,,,4,1,1,7,8
5993_0,,,,2,2,1,3
C(CC(C(O)=O)CCC=CC=O)=O,,,4,1,1,7,8
5995_0,,,,2,2,1,3
C(CC(C(O)=O)(C)CC=CC=O)=O,,,4,1,1,6,7
5997_0,,,,2,2,1,3
C(C(CC=CC=O)C(C(O)=O)C)=O,,,4,1,1,6,7
5999_0,,,,2,2,1,3
C(C(CCC=CC=O)C(C)O)(O)=O,,,4,1,1,7,8
6001_0,,,,2,2,1,3
C(C(C(O)=O)CCC=CC=O)(O)=O,,,4,1,1,4,5
6002_0,,,,2,2,1,3
6003_0,,,,2,2,1,3
6005_0,,,,2,2,1,3
C(C(C=C)C(C)CC=O)=O,,,4,1,4,23,27
6007_0,,,,2,2,1,3
C(CC(C)CC=CC(C(O)=O)=O)=O,,,4,1,1,7,8
6009_0,,,,2,2,1,3
C(CC(C)C(C=C)C(C(O)=O)=O)=O,,,4,1,1,9,10
6011_0,,,,2,2,1,3
C(C(C(C(O)=O)=C)C(C)CC=O)=O,,,4,1,1,10,11
6013_0,,,,2,2,1,3
C(CC(C)CC(C(O)=O)=CC=O)=O,,,4,1,1,8,9
6015_0,,,,2,2,1,3
C(CC(C)CC(C(C(O)=O)=C)O)=O,,,4,1,1,8,9
6017_0,,,,2,2,1,3
C(CC(C)C(C(C(O)=O)=C)(C)O)=O,,,4,1,1,9,10
6019_0,,,,2,2,1,3
C(C(C=C)(CC(C)CC=O)O)(O)=O,,,4,1,1,8,9
6021_0,,,,2,2,1,3
C(CC(C)C(CO)(C(C)O)O)=O,,,4,1,2,12,14
6023_0,,,,2,2,1,3
C(CC(C)C(C(C(C)O)O)O)=O,,,4,1,1,14,15
6025_0,,,,2,2,1,3
C(CC(C)CC(C(CO)O)O)=O,,,4,1,2,12,14
6027_0,,,,2,2,1,3
C(CC(C)C(C)(C(CO)O)O)=O,,,4,1,2,13,15
6029_0,,,,2,2,1,3
C(CC(C)C(C(C=O)O)O)=O,,,4,1,4,24,28
6031_0,,,,2,2,1,3
C(C(CO)(C(C)CC=O)O)=O,,,4,1,3,14,17
6033_0,,,,2,2,1,3
C(CC(C)C([CH]C(O)=O)O)=O,,,4,1,2,10,12
6035_0,,,,2,2,1,3
C(CC([C](C(O)=O)CO)C)=O,,,4,1,1,8,9
6037_0,,,,2,2,1,3
C(CC(C)C(C=O)O)=O,,,4,1,7,34,41
6039_0,,,,2,2,1,3
C(CC(C)C1C(C(OC1C)=O)=O)=O,,,4,1,1,5,6
6041_0,,,,2,2,1,3
C(CC(C)CC1CC(C(O1)=O)=O)=O,,,4,1,1,6,7
6043_0,,,,2,2,1,3
C(CC(C)C1(C)CC(C(O1)=O)=O)=O,,,4,1,1,6,7
6045_0,,,,2,2,1,3
C(CC(C)C1C(OC(C1=O)=O)=O)=O,,,4,1,1,5,6
6047_0,,,,2,2,1,3
C(CC(C)C(C=O)C[CH]C(O)=O)=O,,,4,1,3,9,12
6049_0,,,,2,2,1,3
C(CC(C)C([CH]C(O)=O)CC=O)=O,,,4,1,1,12,13
6051_0,,,,2,2,1,3
C(CC[C](C(O)=O)C(C)CC=O)=O,,,4,1,1,9,10
6053_0,,,,2,2,1,3
C(C(CCC(O)=O)C(C)CC=O)=O,,,4,1,3,9,12
6055_0,,,,2,2,1,3
C(CC(C(C)CC=O)CC(O)=O)=O,,,4,1,1,12,13
6057_0,,,,2,2,1,3
C(CC(C)C(C(O)=O)CCC=O)=O,,,4,1,2,12,14
6059_0,,,,2,2,1,3
C(CC(C)C([C](C(O)=O)O)O)=O,,,4,1,2,11,13
6061_0,,,,2,2,1,3
C(CC(C)CC(C=O)O)=O,,,4,1,5,22,27
6063_0,,,,2,2,1,3
C(C(C)(C(C)CC=O)O)=O,,,4,1,2,15,17
6065_0,,,,2,2,1,3
C(CC(C)C(C(C(O)=O)O)O)=O,,,4,1,7,16,23
6067_0,,,,2,2,1,3
C(C(CO)(C(C)CC=O)O)(O)=O,,,4,1,5,12,17
6069_0,,,,2,2,1,3
C(CC(C)CC=O)=O,,,4,1,17,58,75
6071_0,,,,2,2,1,3
C(CC(C)C[C](C(O)=O)O)=O,,,4,1,2,9,11
6073_0,,,,2,2,1,3
C(CC(C)CC(C(O)=O)O)=O,,,4,1,8,13,21
6075_0,,,,2,2,1,3
C(C(C)(C(C)CC=O)O)(O)=O,,,4,1,2,11,13
6077_0,,,,2,2,1,3
C(C(C(C)CC=O)C(C)O)=O,,,4,1,7,16,23
6079_0,,,,2,2,1,3
C(CC(C)CC(CC=O)O)=O,,,4,1,6,18,24
6081_0,,,,2,2,1,3
C(CC(C)(C(C)CC=O)O)=O,,,4,1,4,19,23
6083_0,,,,2,2,1,3
C(C(C(O)=O)C(C)CC=O)=O,,,4,1,6,15,21
6085_0,,,,2,2,1,3
C(CC(C)C(C(C=O)=O)O)=O,,,4,1,5,17,22
6087_0,,,,2,2,1,3
C(CC(C)CC(C=O)=O)=O,,,4,1,15,29,44
6089_0,,,,2,2,1,3
C(CC(C)C(C(O)=O)O)=O,,,4,1,6,17,23
6091_0,,,,2,2,1,3
C(CC(C)C(CO)O)=O,,,4,1,4,24,28
6093_0,,,,2,2,1,3
C(CC(C)C(C(C(O)=O)=O)O)=O,,,4,1,3,12,15
6095_0,,,,2,2,1,3
C(CC(C)CC(C(O)=O)=O)=O,,,4,1,8,14,22
6097_0,,,,2,2,1,3
C(C(C=C)C(C)CC(C(O)=O)=O)=O,,,4,1,1,9,10
6099_0,,,,2,2,1,3
C(C(C=C)CC(C(O)=O)CC=O)=O,,,4,1,1,8,9
6101_0,,,,2,2,1,3
C(C(C=C)C(C(O)=O)(C)CC=O)=O,,,4,1,1,8,9
6103_0,,,,2,2,1,3
C(C(C=C)C(C=O)C(C(O)=O)C)=O,,,4,1,1,7,8
6105_0,,,,2,2,1,3
C(C(C=C)CC(C(O)=O)C(C)O)=O,,,4,1,1,7,8
6107_0,,,,2,2,1,3
C(C(C=C)CC(C(O)=O)C(O)=O)=O,,,4,1,1,5,6
6108_0,,,,2,2,1,3
6109_0,,,,2,2,1,3
6111_0,,,,2,2,1,3
C(CC[CH]C(O)=O)=CC(C(O)=O)=O,,,4,1,1,4,5
6113_0,,,,2,2,1,3
C(CCCC=CC(C(O)=O)=O)(O)=O,,,4,1,1,4,5
6115_0,,,,2,2,1,3
C(C(C(C)CC(C(O)=O)=O)O)=O,,,4,1,1,15,16
6117_0,,,,2,2,1,3
C(C(CC(C)CC(C(O)=O)=O)O)=O,,,4,1,3,13,16
6119_0,,,,2,2,1,3
C(C(C)(C(C)CC(C(O)=O)=O)O)=O,,,4,1,1,11,12
6120_0,,,,2,2,1,3
6122_0,,,,2,2,1,3
C(C(CC(C)CC(C(O)=O)=O)=O)=O,,,4,1,3,11,14
6124_0,,,,2,2,1,3
C(C(C(C)CC(C(O)=O)=O)O)(O)=O,,,4,1,3,12,15
6126_0,,,,2,2,1,3
C(C(CC(C)C(CO)O)=O)(O)=O,,,4,1,3,13,16
6128_0,,,,2,2,1,3
C=CC(C(C(O)=O)=O)C[CH]C(O)=O,,,4,1,1,7,8
6130_0,,,,2,2,1,3
C(CCC(C=C)C(C(O)=O)=O)(O)=O,,,4,1,1,7,8
6132_0,,,,2,2,1,3
C(C(C(C(O)=O)=C)C[CH]C(O)=O)=O,,,4,1,1,7,8
6134_0,,,,2,2,1,3
C(C(C(C(O)=O)=C)CCC(O)=O)=O,,,4,1,1,7,8
6136_0,,,,2,2,1,3
C(C(CC(C=O)O)CC=O)(O)=O,,,4,1,1,17,18
6138_0,,,,2,2,1,3
C(C(CCC(C=O)O)CC=O)(O)=O,,,4,1,3,13,16
6140_0,,,,2,2,1,3
C(C(CC(C=O)(C)O)CC=O)(O)=O,,,4,1,1,11,12
6142_0,,,,2,2,1,3
C(CCC(C(O)=O)CC=O)=O,,,4,1,4,15,19
6144_0,,,,2,2,1,3
C(CC(C(O)=O)CCC(C=O)=O)=O,,,4,1,3,12,15
6146_0,,,,2,2,1,3
C(C(CC(C(O)=O)CC=O)O)(O)=O,,,4,1,3,12,15
6148_0,,,,2,2,1,3
C(C(CC(CO)O)CC=O)(O)=O,,,4,1,3,13,16
6150_0,,,,2,2,1,3
C(C=C(C(O)=O)CC[CH]C(O)=O)=O,,,4,1,1,4,5
6152_0,,,,2,2,1,3
C(CCCC(C(O)=O)=CC=O)(O)=O,,,4,1,1,4,5
6154_0,,,,2,2,1,3
C(C(C)(C(C=O)O)CC=O)(O)=O,,,4,1,1,13,14
6156_0,,,,2,2,1,3
C(C(C)(CC(C=O)O)CC=O)(O)=O,,,4,1,3,13,16
6158_0,,,,2,2,1,3
C(C(C)(CC=O)C(C=O)(C)O)(O)=O,,,4,1,1,8,9
6160_0,,,,2,2,1,3
C(CC(C(O)=O)(C)CC=O)=O,,,4,1,3,7,10
6162_0,,,,2,2,1,3
C(CC(C(O)=O)(C)CC(C=O)=O)=O,,,4,1,3,11,14
6164_0,,,,2,2,1,3
C(C(C)(C(C(O)=O)O)CC=O)(O)=O,,,4,1,3,9,12
6166_0,,,,2,2,1,3
C(C(C)(C(CO)O)CC=O)(O)=O,,,4,1,3,11,14
6168_0,,,,2,2,1,3
C(C(C)C(C=O)C(C=O)O)(O)=O,,,4,1,1,15,16
6170_0,,,,2,2,1,3
C(C(CC(C=O)C(C(O)=O)C)O)=O,,,4,1,3,12,15
6172_0,,,,2,2,1,3
C(C(C)C(C=O)C(C=O)(C)O)(O)=O,,,4,1,1,10,11
6174_0,,,,2,2,1,3
C(CC(C=O)C(C(O)=O)C)=O,,,4,1,3,12,15
6176_0,,,,2,2,1,3
C(C(CC(C=O)=O)C(C(O)=O)C)=O,,,4,1,2,9,11
6178_0,,,,2,2,1,3
C(C(C(C=O)C(C(O)=O)C)O)(O)=O,,,4,1,3,11,14
6180_0,,,,2,2,1,3
C(C(C)C(C=O)C(CO)O)(O)=O,,,4,1,3,13,16
6182_0,,,,2,2,1,3
C=C(C(O)=O)C(CC[CH]C(O)=O)O,,,4,1,1,5,6
6184_0,,,,2,2,1,3
C(CCCC(C(C(O)=O)=C)O)(O)=O,,,4,1,1,5,6
6186_0,,,,2,2,1,3
C=C(C(O)=O)C(C)(C[CH]C(O)=O)O,,,4,1,1,6,7
6188_0,,,,2,2,1,3
C(CCC(C(C(O)=O)=C)(C)O)(O)=O,,,4,1,1,6,7
6190_0,,,,2,2,1,3
C(C(CC(C=O)O)C(C)O)(O)=O,,,4,1,1,12,13
6192_0,,,,2,2,1,3
C(C(C(C)O)CCC(C=O)O)(O)=O,,,4,1,3,11,14
6194_0,,,,2,2,1,3
C(C(CC(C=O)(C)O)C(C)O)(O)=O,,,4,1,1,9,10
6196_0,,,,2,2,1,3
C(C(CCC=O)C(C)O)(O)=O,,,4,1,4,11,15
6198_0,,,,2,2,1,3
C(C(CCC(C=O)=O)C(C)O)(O)=O,,,4,1,3,11,14
6200_0,,,,2,2,1,3
C(C(CC(C(O)=O)O)C(C)O)(O)=O,,,4,1,4,9,13
6202_0,,,,2,2,1,3
C(C(CC(CO)O)C(C)O)(O)=O,,,4,1,3,8,11
6204_0,,,,2,2,1,3
C(C(C=C)(CC[CH]C(O)=O)O)(O)=O,,,4,1,1,6,7
6206_0,,,,2,2,1,3
C(C(C=C)(CCCC(O)=O)O)(O)=O,,,4,1,1,6,7
6208_0,,,,2,2,1,3
C(C(C(O)=O)CC(C=O)O)(O)=O,,,4,1,1,10,11
6210_0,,,,2,2,1,3
C(C(C(O)=O)CCC(C=O)O)(O)=O,,,4,1,3,9,12
6212_0,,,,2,2,1,3
C(C(C(O)=O)CC(C=O)(C)O)(O)=O,,,4,1,1,7,8
6214_0,,,,2,2,1,3
C(CCC(C(O)=O)C(O)=O)=O,,,4,1,4,9,13
6216_0,,,,2,2,1,3
C(C(C(O)=O)CCC(C=O)=O)(O)=O,,,4,1,3,8,11
6218_0,,,,2,2,1,3
C(C(C(O)=O)CC(C(O)=O)O)(O)=O,,,4,1,4,7,11
6220_0,,,,2,2,1,3
C(C(C(O)=O)CC(CO)O)(O)=O,,,4,1,3,7,10
6222_0,,,,2,2,1,3
C(CC1C(C(OC(C1C)=O)=O)=O)=O,,,4,1,1,4,5
6224_0,,,,2,2,1,3
C(CC1(C(OC(C(C1)=O)=O)=O)C)=O,,,4,1,1,5,6
6226_0,,,,2,2,1,3
C(CCC1C(OC(C(C1)=O)=O)=O)=O,,,4,1,1,6,7
6227_0,,,,2,2,1,3
6228_0,,,,2,2,1,3
6230_0,,,,2,2,1,3
[CH](C(O)=O)CC(C(C(C)O)O)O,,,4,1,1,10,11
6232_0,,,,2,2,1,3
C(CCC(C(C(C)O)O)O)(O)=O,,,4,1,1,10,11
6233_0,,,,2,2,1,3
6234_0,,,,2,2,1,3
6235_0,,,,2,2,1,3
6236_0,,,,2,2,1,3
6237_0,,,,2,2,1,3
6238_0,,,,2,2,1,3
6240_0,,,,2,2,1,3
C(C(CO)(C[CH]C(O)=O)O)=O,,,4,1,3,10,13
6242_0,,,,2,2,1,3
C(C(CO)(CCC(O)=O)O)=O,,,4,1,3,10,13
6244_0,,,,2,2,1,3
C([CH]CC([CH]C(O)=O)O)(O)=O,,,4,1,2,5,7
6246_0,,,,2,2,1,3
C(CCC([CH]C(O)=O)O)(O)=O,,,4,1,2,5,7
6248_0,,,,2,2,1,3
[CH](C(O)=O)C[C](C(O)=O)CO,,,4,1,1,3,4
6250_0,,,,2,2,1,3
C(CC[C](C(O)=O)CO)(O)=O,,,4,1,1,3,4
6251_0,,,,2,2,1,3
6252_0,,,,2,2,1,3
6254_0,,,,2,2,1,3
[CH](C(O)=O)CC1C(C(OC1C)=O)=O,,,4,1,1,4,5
6256_0,,,,2,2,1,3
C(CCC1C(C(OC1C)=O)=O)(O)=O,,,4,1,1,4,5
6258_0,,,,2,2,1,3
[CH](C(O)=O)CCC1CC(C(O1)=O)=O,,,4,1,1,1,2
6260_0,,,,2,2,1,3
C(CCCC1CC(C(O1)=O)=O)(O)=O,,,4,1,1,1,2
6262_0,,,,2,2,1,3
[CH](C(O)=O)CC1(C)CC(C(O1)=O)=O,,,4,1,1,2,3
6264_0,,,,2,2,1,3
C(CCC1(C)CC(C(O1)=O)=O)(O)=O,,,4,1,1,2,3
6266_0,,,,2,2,1,3
C1(C(C(C(O1)=O)=O)C[CH]C(O)=O)=O,,,4,1,1,5,6
6268_0,,,,2,2,1,3
C1(C(C(C(O1)=O)=O)CCC(O)=O)=O,,,4,1,1,5,6
6270_0,,,,2,2,1,3
C(C(C[CH]C(O)=O)C[CH]C(O)=O)=O,,,4,1,1,4,5
6272_0,,,,2,2,1,3
C(C(CCC(O)=O)C[CH]C(O)=O)=O,,,4,1,2,7,9
6274_0,,,,2,2,1,3
C(CC([CH]C(O)=O)C[CH]C(O)=O)=O,,,4,1,2,9,11
6276_0,,,,2,2,1,3
C(CC([CH]C(O)=O)CCC(O)=O)=O,,,4,1,2,9,11
6278_0,,,,2,2,1,3
C(CC[C](C(O)=O)C[CH]C(O)=O)=O,,,4,1,1,5,6
6280_0,,,,2,2,1,3
C(CC[C](C(O)=O)CCC(O)=O)=O,,,4,1,2,5,7
6281_0,,,,2,2,1,3
6283_0,,,,2,2,1,3
C(C(CCC(O)=O)CCC(O)=O)=O,,,4,1,1,4,5
6285_0,,,,2,2,1,3
C(CC(CC(O)=O)C[CH]C(O)=O)=O,,,4,1,2,9,11
6287_0,,,,2,2,1,3
C(CC(CCC(O)=O)CC(O)=O)=O,,,4,1,2,9,11
6289_0,,,,2,2,1,3
C(CCC(C(O)=O)C[CH]C(O)=O)=O,,,4,1,3,7,10
6291_0,,,,2,2,1,3
C(CCC(C(O)=O)CCC(O)=O)=O,,,4,1,3,7,10
6293_0,,,,2,2,1,3
C([CH]CC([C](C(O)=O)O)O)(O)=O,,,4,1,3,7,10
6295_0,,,,2,2,1,3
C(CCC([C](C(O)=O)O)O)(O)=O,,,4,1,3,7,10
6297_0,,,,2,2,1,3
C(C(CC[CH]C(O)=O)O)=O,,,4,1,4,13,17
6299_0,,,,2,2,1,3
C(CCCC(C=O)O)(O)=O,,,4,1,5,13,18
6301_0,,,,2,2,1,3
C(C(C)(C[CH]C(O)=O)O)=O,,,4,1,1,8,9
6303_0,,,,2,2,1,3
C(C(C)(CCC(O)=O)O)=O,,,4,1,2,8,10
6305_0,,,,2,1,2,3
C(C(C=CC(O)=O)=O)(O)=O,,,4,1,5,15,20
6306_0,,,,2,1,2,3
6308_0,,,,2,1,2,3
[CH2]C(O)=O,,,4,1,43,66,109
6309_0,,,,2,1,2,3
6310_0,,,,2,1,2,3
6311_0,,,,2,1,2,3
6312_0,,,,2,1,2,3
6313_0,,,,2,1,2,3
6314_0,,,,2,1,2,3
6315_0,,,,2,1,2,3
6316_0,,,,2,1,2,3
6317_0,,,,2,1,2,3
6318_0,,,,2,1,2,3
6319_0,,,,2,1,2,3
6320_0,,,,2,1,2,3
6321_0,,,,2,1,2,3
6322_0,,,,2,1,2,3
6323_0,,,,2,1,2,3
6324_0,,,,2,1,2,3
6325_0,,,,2,1,2,3
6326_0,,,,2,1,2,3
6327_0,,,,2,1,2,3
6328_0,,,,2,1,2,3
6329_0,,,,2,1,2,3
6330_0,,,,2,1,2,3
6331_0,,,,2,1,2,3
6332_0,,,,2,1,2,3
6333_0,,,,2,1,2,3
6334_0,,,,2,1,2,3
6335_0,,,,2,1,2,3
6336_0,,,,2,1,2,3
6337_0,,,,2,1,2,3
6338_0,,,,2,1,2,3
6339_0,,,,2,1,2,3
6340_0,,,,2,1,2,3
6341_0,,,,2,1,2,3
6342_0,,,,2,1,2,3
6343_0,,,,2,1,2,3
6344_0,,,,2,1,2,3
6345_0,,,,2,1,2,3
6346_0,,,,2,1,2,3
6347_0,,,,2,1,2,3
6348_0,,,,2,1,2,3
6350_0,,,,2,4,3,7
[C](C(O)=O)(C(C(CC(C)O)O)O)O,,,4,1,2,9,11
6352_0,,,,2,4,3,7
[C](C(O)=O)(CC(CC(C)O)O)O,,,4,1,1,7,8
6354_0,,,,2,4,3,7
[C](C(O)=O)(C(CO)C(C)O)O,,,4,1,1,6,7
6356_0,,,,2,4,3,7
[C](C(O)=O)(C(C(C)O)C(C)O)O,,,4,1,1,4,5
6357_0,,,,2,4,3,7
6359_0,,,,2,4,3,7
C(CC(C([C](C(O)=O)O)O)O)(O)=O,,,4,1,2,9,11
6361_0,,,,2,4,3,7
C(CC(C[C](C(O)=O)O)O)(O)=O,,,4,1,1,6,7
6362_0,,,,2,4,3,7
6363_0,,,,2,4,3,7
6364_0,,,,2,4,3,7
6365_0,,,,2,4,3,7
6367_0,,,,2,4,3,7
C(CO)(C(C([C](C(O)=O)O)O)O)=O,,,4,1,2,12,14
6369_0,,,,2,4,3,7
C(CO)(C(C[C](C(O)=O)O)O)=O,,,4,1,2,8,10
6371_0,,,,2,4,3,7
C(C(CO)(C([C](C(O)=O)O)O)O)=O,,,4,1,2,15,17
6373_0,,,,2,4,3,7
C(C(CO)(C[C](C(O)=O)O)O)=O,,,4,1,1,11,12
6375_0,,,,2,4,3,7
C(C(C)(C([C](C(O)=O)O)O)O)=O,,,4,1,2,11,13
6377_0,,,,2,4,3,7
C(C(C)(C[C](C(O)=O)O)O)=O,,,4,1,1,8,9
6378_0,,,,2,4,3,7
6380_0,,,,2,4,3,7
C(C)(C(C[C](C(O)=O)O)O)=O,,,4,1,1,9,10
6382_0,,,,2,4,3,7
C=C(C(O)=O)C([C](C(O)=O)O)CO,,,4,1,1,6,7
6384_0,,,,2,4,3,7
[C](C(O)=O)(C(CO)O)O,,,4,1,3,7,10
6386_0,,,,2,4,3,7
[C](C(O)=O)(CCO)O,,,4,1,1,11,12
6388_0,,,,2,4,3,7
C(C(CO)(C[C](C(O)=O)O)O)(O)=O,,,4,1,2,9,11
6390_0,,,,2,4,3,7
[C](C(O)=O)(C(C(C)O)O)O,,,4,1,2,6,8
6392_0,,,,2,4,3,7
C(C([C](C(O)=O)O)O)(O)=O,,,4,1,3,12,15
6394_0,,,,2,4,3,7
C(C(C)(C([C](C(O)=O)O)O)O)(O)=O,,,4,1,3,9,12
6396_0,,,,2,4,3,7
C([C](C(CO)=O)O)(O)=O,,,4,1,1,19,20
6398_0,,,,2,4,3,7
C([C](C(C)=O)O)(O)=O,,,4,1,2,42,44
6399_0,,,,2,4,3,7
6400_0,,,,2,4,3,7
6401_0,,,,2,4,3,7
6402_0,,,,2,4,3,7
6403_0,,,,2,4,3,7
6404_0,,,,2,4,3,7
6405_0,,,,2,4,3,7
6406_0,,,,2,4,3,7
6407_0,,,,2,4,3,7
6408_0,,,,2,4,3,7
6409_0,,,,2,4,4,8
6410_0,,,,2,4,4,8
6411_0,,,,2,4,4,8
6412_0,,,,2,4,4,8
6413_0,,,,2,4,4,8
6414_0,,,,2,2,2,4
6415_0,,,,2,3,5,8
6416_0,,,,2,3,5,8
6417_0,,,,2,3,5,8
6418_0,,,,2,5,3,8
6420_0,,,,2,5,3,8
C(C(CC(CC(C)O)O)O)=O,,,4,1,2,13,15
6421_0,,,,2,5,3,8
6423_0,,,,2,5,3,8
C(CC(CC(C=O)O)O)(O)=O,,,4,1,2,14,16
6424_0,,,,2,5,3,8
6426_0,,,,2,5,3,8
C(C(CC(C(CO)=O)O)O)=O,,,4,1,2,18,20
6427_0,,,,2,5,3,8
6429_0,,,,2,5,3,8
C(C(CO)(CC(C=O)O)O)=O,,,4,1,2,16,18
6430_0,,,,2,5,3,8
6431_0,,,,2,5,3,8
6432_0,,,,2,5,3,8
6433_0,,,,2,5,3,8
6434_0,,,,2,5,3,8
6435_0,,,,2,5,3,8
6436_0,,,,2,5,3,8
6438_0,,,,2,5,3,8
C(C(C)(CC(C=O)O)O)=O,,,4,1,2,17,19
6440_0,,,,2,5,3,8
C(C(CC(C(C)=O)O)O)=O,,,4,1,2,23,25
6442_0,,,,2,5,3,8
C(C(CCO)O)=O,,,4,1,24,107,131
6444_0,,,,2,5,3,8
C(C(CO)(CC(C=O)O)O)(O)=O,,,4,1,3,14,17
6445_0,,,,2,5,3,8
6446_0,,,,2,5,3,8
6448_0,,,,2,5,3,8
C(C(C)(CC(C=O)O)O)(O)=O,,,4,1,3,13,16
6449_0,,,,2,5,3,8
6450_0,,,,2,5,3,8
6451_0,,,,2,5,3,8
6452_0,,,,2,5,3,8
6453_0,,,,2,5,3,8
6455_0,,,,2,5,3,8
C(C(O)O)=O,,,4,1,1,485,486
6456_0,,,,2,3,5,8
6457_0,,,,2,3,5,8
6459_0,,,,2,3,5,8
C(C(C(CC(C)O)O)=O)(O)=O,,,4,1,2,10,12
6461_0,,,,2,3,5,8
C(CC(C(C(O)=O)=O)O)(O)=O,,,4,1,3,9,12
6463_0,,,,2,3,5,8
C(CO)(C(C(C(O)=O)=O)O)=O,,,4,1,7,13,20
6465_0,,,,2,3,5,8
C(C(C(C(O)=O)=O)(CO)O)=O,,,4,1,4,11,15
6467_0,,,,2,3,5,8
C(C(C(C(O)=O)=O)(C)O)=O,,,4,1,2,9,11
6469_0,,,,2,3,5,8
C(C)(C(C(C(O)=O)=O)O)=O,,,4,1,4,18,22
6470_0,,,,2,3,5,8
6472_0,,,,2,3,5,8
C(C(C(C)O)=O)(O)=O,,,4,1,21,49,70
6474_0,,,,2,3,5,8
C(C(C(C(O)=O)=O)(C)O)(O)=O,,,4,1,5,7,12
6475_0,,,,2,3,5,8
6476_0,,,,2,3,5,8
6477_0,,,,2,3,5,8
6478_0,,,,2,3,5,8
6479_0,,,,2,3,5,8
6481_0,,,,2,3,5,8
C(C(C[CH]C(O)=O)=O)(O)=O,,,4,1,2,10,12
6482_0,,,,2,3,5,8
6483_0,,,,2,3,5,8
6484_0,,,,2,3,5,8
6485_0,,,,2,3,5,8
6486_0,,,,2,3,5,8
6487_0,,,,2,3,5,8
6488_0,,,,2,3,5,8
6489_0,,,,2,5,3,8
6490_0,,,,2,5,3,8
6492_0,,,,2,5,3,8
C(C(C(CO)C(C)O)O)(O)=O,,,4,1,5,9,14
6494_0,,,,2,5,3,8
C(C(C(C(C)O)C(C)O)O)(O)=O,,,4,1,3,6,9
6495_0,,,,2,5,3,8
6496_0,,,,2,5,3,8
6497_0,,,,2,5,3,8
6498_0,,,,2,5,3,8
6499_0,,,,2,5,3,8
6500_0,,,,2,5,3,8
6501_0,,,,2,5,3,8
6502_0,,,,2,5,3,8
6503_0,,,,2,5,3,8
6504_0,,,,2,5,3,8
6505_0,,,,2,5,3,8
6506_0,,,,2,5,3,8
6507_0,,,,2,5,3,8
6508_0,,,,2,5,3,8
6509_0,,,,2,5,3,8
6511_0,,,,2,5,3,8
C(C(C(C(C(O)=O)=C)CO)O)(O)=O,,,4,1,2,8,10
6512_0,,,,2,5,3,8
6513_0,,,,2,5,3,8
6514_0,,,,2,5,3,8
6515_0,,,,2,5,3,8
6516_0,,,,2,5,3,8
6517_0,,,,2,5,3,8
6518_0,,,,2,5,3,8
6519_0,,,,2,5,3,8
6520_0,,,,2,5,3,8
6521_0,,,,2,5,3,8
6522_0,,,,2,5,3,8
6523_0,,,,2,5,3,8
6524_0,,,,2,5,3,8
6525_0,,,,2,5,3,8
6526_0,,,,2,5,3,8
6527_0,,,,2,5,3,8
6529_0,,,,2,1,1,2
C1(C(C(C(C1CO)O)C(C)O)O)=O,,,5,1,4,0,4
6529_1,,,,2,1,1,2
6531_0,,,,2,1,1,2
C(C1C(C(C(C1O)=O)CO)O)(O)=O,,,5,1,5,0,5
6531_1,,,,2,1,1,2
6533_0,,,,2,1,1,2
C(C1(C(CO)C(C(C1O)=O)O)O)=O,,,5,1,2,0,2
6533_1,,,,2,1,1,2
6535_0,,,,2,1,1,2
C1(C(C(C(C(C1CO)O)=O)O)O)=O,,,5,1,6,0,6
6535_1,,,,2,1,1,2
6537_0,,,,2,1,1,2
C1(C(C(C(C(CC1O)O)O)O)O)=O,,,5,1,2,0,2
6537_1,,,,2,1,1,2
6539_0,,,,2,1,1,2
C1(C(C(CC(CC1O)O)O)O)=O,,,5,1,2,0,2
6539_1,,,,2,1,1,2
6541_0,,,,2,1,1,2
C(C1C(CC(C1(CO)O)O)O)=O,,,5,1,4,0,4
6541_1,,,,2,1,1,2
6543_0,,,,2,1,1,2
C(C1C(C(CO)(C(C1O)O)O)O)=O,,,5,1,2,0,2
6543_1,,,,2,1,1,2
6545_0,,,,2,1,1,2
C(C1C(C(CO)(CC1O)O)O)=O,,,5,1,4,0,4
6545_1,,,,2,1,1,2
6546_0,,,,2,1,1,2
6546_1,,,,2,1,1,2
6548_0,,,,2,1,1,2
C(C1C(C(C(C(C1O)=O)O)O)O)=O,,,5,1,4,0,4
6548_1,,,,2,1,1,2
6550_0,,,,2,1,1,2
C(C(C1C(C(C(C1O)=O)O)O)O)=O,,,5,1,2,0,2
6550_1,,,,2,1,1,2
6552_0,,,,2,1,1,2
C1(C(C(C(C1O)O)C(CO)O)O)=O,,,5,1,2,0,2
6552_1,,,,2,1,1,2
6554_0,,,,2,1,1,2
C1(C(C(C(CO)C1O)O)O)=O,,,5,1,2,0,2
6554_1,,,,2,1,1,2
6555_0,,,,2,1,1,2
6555_1,,,,2,1,1,2
6556_0,,,,2,1,1,2
6556_1,,,,2,1,1,2
6558_0,,,,2,1,1,2
C(C1C(C(C(C1(CO)O)O)O)O)=O,,,5,1,2,0,2
6558_1,,,,2,1,1,2
6559_0,,,,2,1,1,2
6559_1,,,,2,1,1,2
6561_0,,,,2,1,1,2
C1(C(CO)C(C=O)(C(C1O)O)O)=O,,,5,1,4,0,4
6561_1,,,,2,1,1,2
6563_0,,,,2,1,1,2
C1(C(C(C(C1)O)(C(CO)O)O)O)=O,,,5,1,3,0,3
6563_1,,,,2,1,1,2
6565_0,,,,2,1,1,2
C1(C(C(C(C(CO)O)(C1)O)O)O)=O,,,5,1,3,0,3
6566_0,,,,2,1,1,2
6566_1,,,,2,1,1,2
6567_0,,,,2,1,1,2
6569_0,,,,2,1,1,2
C(C1C(C(C)(CC1(C=O)O)O)O)=O,,,5,1,4,0,4
6569_1,,,,2,1,1,2
6571_0,,,,2,1,1,2
C1(C(C(CC1O)O)C(C=O)(C)O)=O,,,5,1,4,0,4
6571_1,,,,2,1,1,2
6573_0,,,,2,1,1,2
C(C1C(C(C)(CC(C1O)=O)O)O)=O,,,5,1,5,0,5
6573_1,,,,2,1,1,2
6575_0,,,,2,1,1,2
C(C(C1C(CC(C1(C)O)O)O)=O)=O,,,5,1,4,0,4
6575_1,,,,2,1,1,2
6576_0,,,,2,1,1,2
6576_1,,,,2,1,1,2
6577_0,,,,2,1,1,2
6577_1,,,,2,1,1,2
6579_0,,,,2,1,1,2
C(CO)(C1C(C(C)(CC1O)O)O)=O,,,5,1,4,0,4
6579_1,,,,2,1,1,2
6581_0,,,,2,1,1,2
C1(C(C(C(C)(CC(C1)O)O)O)O)=O,,,5,1,3,0,3
6581_1,,,,2,1,1,2
6583_0,,,,2,1,1,2
C1(C(C(CC(C(C1)O)(C)O)O)O)=O,,,5,1,3,0,3
6585_0,,,,2,1,1,2
C(C1C(C(C)(CC1O)O)O)=O,,,5,1,4,0,4
6585_1,,,,2,1,1,2
6587_0,,,,2,1,1,2
C(C(C1C(C(C)(CC1O)O)O)=O)=O,,,5,1,4,0,4
6587_1,,,,2,1,1,2
6589_0,,,,2,1,1,2
C(C1C(C(CO)C(C1(C)O)O)O)=O,,,5,1,2,0,2
6589_1,,,,2,1,1,2
6591_0,,,,2,1,1,2
C(C1C(CO)(CC(C1(C)O)O)O)=O,,,5,1,2,0,2
6591_1,,,,2,1,1,2
6592_0,,,,2,1,1,2
6592_1,,,,2,1,1,2
6593_0,,,,2,1,1,2
6593_1,,,,2,1,1,2
6595_0,,,,2,1,1,2
C(C1C(C)(C(C(C1(C)O)O)O)O)=O,,,5,1,2,0,2
6595_1,,,,2,1,1,2
6596_0,,,,2,1,1,2
6598_0,,,,2,1,1,2
C(C1C(C(C=C)C(C1(C)O)O)O)=O,,,5,1,2,0,2
6598_1,,,,2,1,1,2
6600_0,,,,2,1,1,2
C(C1C(C(C(C1(C)O)O)O)O)=O,,,5,1,2,0,2
6600_1,,,,2,1,1,2
6602_0,,,,2,1,1,2
C(C1C(CC(C1(C)O)O)O)=O,,,5,1,4,0,4
6602_1,,,,2,1,1,2
6603_0,,,,2,1,1,2
6603_1,,,,2,1,1,2
6605_0,,,,2,1,1,2
C(C1C(C)(C(CC1(C=O)O)O)O)=O,,,5,1,4,0,4
6605_1,,,,2,1,1,2
6607_0,,,,2,1,1,2
C(C1C(C(CC(C1O)=O)O)(C)O)=O,,,5,1,5,0,5
6607_1,,,,2,1,1,2
6608_0,,,,2,1,1,2
6608_1,,,,2,1,1,2
6610_0,,,,2,1,1,2
C(C(C)(C1C(CC(C1O)=O)O)O)=O,,,5,1,1,0,1
6611_0,,,,2,1,1,2
6613_0,,,,2,1,1,2
C(C1(CC(C(CC(C1)O)=O)O)O)=O,,,5,1,1,0,1
6615_0,,,,2,1,1,2
C(CC1(C(CC(C(C1)O)=O)O)O)=O,,,5,1,2,0,2
6616_0,,,,2,1,1,2
6616_1,,,,2,1,1,2
6618_0,,,,2,1,1,2
C1(C(C(CC1O)O)C(C(C)=O)O)=O,,,5,1,4,0,4
6618_1,,,,2,1,1,2
6620_0,,,,2,1,1,2
C1(CC(C(CC(CC1O)O)=O)O)=O,,,5,1,2,0,2
6622_0,,,,2,1,1,2
C(CC(C1(CC(C(C1)=O)O)O)O)=O,,,5,1,2,0,2
6623_0,,,,2,1,1,2
6623_1,,,,2,1,1,2
6625_0,,,,2,1,1,2
C(C1(C(C(C)O)C(C(C1)=O)O)O)=O,,,5,1,1,0,1
6627_0,,,,2,1,1,2
C1(C(C(C(C(C1)O)=O)C(C)O)O)=O,,,5,1,5,0,5
6629_0,,,,2,1,1,2
C(C1C(C(CC1(C=O)O)=O)O)(O)=O,,,5,1,2,0,2
6631_0,,,,2,1,1,2
C(C1C(C(CC(C1O)=O)O)=O)(O)=O,,,5,1,5,0,5
6633_0,,,,2,1,1,2
C(C1(C(CO)C(C(C1)=O)O)O)=O,,,5,1,1,0,1
6635_0,,,,2,1,1,2
C1(C(C(C(C(C1)O)=O)CO)O)=O,,,5,1,5,0,5
6637_0,,,,2,1,1,2
C1(C(C(C)O)C(C=O)(CC1O)O)=O,,,5,1,4,0,4
6637_1,,,,2,1,1,2
6638_0,,,,2,1,1,2
6638_1,,,,2,1,1,2
6640_0,,,,2,1,1,2
C1(C(CC(C=O)(C1C(O)=O)O)O)=O,,,5,1,4,0,4
6640_1,,,,2,1,1,2
6641_0,,,,2,1,1,2
6641_1,,,,2,1,1,2
6643_0,,,,2,1,1,2
C1(C(CO)C(C=O)(CC1O)O)=O,,,5,1,4,0,4
6643_1,,,,2,1,1,2
6644_0,,,,2,1,1,2
6644_1,,,,2,1,1,2
6646_0,,,,2,1,1,2
C1(C(CC(C(C(C1)O)CO)O)O)=O,,,5,1,1,0,1
6648_0,,,,2,1,1,2
C1(C(CC(CC(CO)(C1)O)O)O)=O,,,5,1,1,0,1
6650_0,,,,2,1,1,2
C(CO)(C1C(CC(C1(C)O)O)O)=O,,,5,1,4,0,4
6650_1,,,,2,1,1,2
6652_0,,,,2,1,1,2
C1(C(C(C)(C(CC(C1)O)O)O)O)=O,,,5,1,3,0,3
6652_1,,,,2,1,1,2
6654_0,,,,2,1,1,2
C1(C(CC(C(C(C)(C1)O)O)O)O)=O,,,5,1,1,0,1
6656_0,,,,2,1,1,2
C1(C(C(CC(C(C)(C1)O)O)O)O)=O,,,5,1,3,0,3
6658_0,,,,2,1,1,2
C1(C(CC(C(C=C)C(C1)O)O)O)=O,,,5,1,1,0,1
6660_0,,,,2,1,1,2
C1(C(CC(C(C(C1)O)O)O)O)=O,,,5,1,1,0,1
6662_0,,,,2,1,1,2
C1(C(CC(CC(C1)O)O)O)=O,,,5,1,1,0,1
6663_0,,,,2,1,1,2
6663_1,,,,2,1,1,2
6665_0,,,,2,1,1,2
C(C1(CC(CC(C(C1)=O)O)O)O)=O,,,5,1,1,0,1
6666_0,,,,2,1,1,2
6667_0,,,,2,1,1,2
6667_1,,,,2,1,1,2
6669_0,,,,2,1,1,2
C(C1C(C(C)(C(CO)C1O)O)O)=O,,,5,1,2,0,2
6669_1,,,,2,1,1,2
6671_0,,,,2,1,1,2
C(C1C(C(C)(CC1(CO)O)O)O)=O,,,5,1,2,0,2
6671_1,,,,2,1,1,2
6672_0,,,,2,1,1,2
6672_1,,,,2,1,1,2
6673_0,,,,2,1,1,2
6673_1,,,,2,1,1,2
6675_0,,,,2,1,1,2
C(C1C(C(C)(C(C1(C)O)O)O)O)=O,,,5,1,4,0,4
6675_1,,,,2,1,1,2
6676_0,,,,2,1,1,2
6678_0,,,,2,1,1,2
C(C1C(C(C=C)C(C)(C1O)O)O)=O,,,5,1,2,0,2
6678_1,,,,2,1,1,2
6680_0,,,,2,1,1,2
C(C1C(C(C)(C(C1O)O)O)O)=O,,,5,1,2,0,2
6680_1,,,,2,1,1,2
6682_0,,,,2,1,1,2
C1(C(C(C(C1)O)C(CCO)O)O)=O,,,5,1,1,0,1
6684_0,,,,2,1,1,2
C(C1C(C(CC(C1O)=O)O)O)=O,,,5,1,3,0,3
6686_0,,,,2,1,1,2
C1(C(C(C(C1)O)C(C=O)O)O)=O,,,5,1,1,0,1
6688_0,,,,2,1,1,2
C1(C(C(C(C1)O)C(CO)(C)O)O)=O,,,5,1,1,0,1
6690_0,,,,2,1,1,2
C1(C(C(C(C1)O)C(C=CC)O)O)=O,,,5,1,1,0,1
6692_0,,,,2,1,1,2
C1(C(C(C(C1)O)C(CC=C)O)O)=O,,,5,1,1,0,1
6694_0,,,,2,1,1,2
C1(C(C(C(C1)O)C(CO)O)O)=O,,,5,1,1,0,1
6696_0,,,,2,1,1,2
C1(C(C(C(C1)O)C(C(C)O)O)O)=O,,,5,1,1,0,1
6698_0,,,,2,1,1,2
C1(C(C(C(C1)O)C(C(O)=O)O)O)=O,,,5,1,1,0,1
6699_0,,,,2,1,1,2
6701_0,,,,2,1,1,2
C1(C(C(C(C1)O)C(C(C)=O)O)O)=O,,,5,1,1,0,1
6703_0,,,,2,1,1,2
C1(C(C(C(C1)O)CO)O)=O,,,5,1,1,0,1
6705_0,,,,2,1,1,2
C1(C(CC(C1C(CCO)O)O)O)=O,,,5,1,4,0,4
6705_1,,,,2,1,1,2
6706_0,,,,2,1,1,2
6706_1,,,,2,1,1,2
6708_0,,,,2,1,1,2
C1(C(C(CC1O)O)C(C=O)O)=O,,,5,1,4,0,4
6708_1,,,,2,1,1,2
6710_0,,,,2,1,1,2
C1(C(CC(C1C(CO)(C)O)O)O)=O,,,5,1,4,0,4
6710_1,,,,2,1,1,2
6712_0,,,,2,1,1,2
C1(C(C(CC1O)O)C(C=CC)O)=O,,,5,1,4,0,4
6712_1,,,,2,1,1,2
6714_0,,,,2,1,1,2
C1(C(CC(C1C(CC=C)O)O)O)=O,,,5,1,4,0,4
6714_1,,,,2,1,1,2
6716_0,,,,2,1,1,2
C1(C(CC(C1C(CO)O)O)O)=O,,,5,1,4,0,4
6716_1,,,,2,1,1,2
6718_0,,,,2,1,1,2
C1(C(CC(C1C(C(C)O)O)O)O)=O,,,5,1,4,0,4
6718_1,,,,2,1,1,2
6720_0,,,,2,1,1,2
C1(C(C(CC1O)O)C(C(O)=O)O)=O,,,5,1,4,0,4
6720_1,,,,2,1,1,2
6722_0,,,,2,1,1,2
C1(C(CC(C1C(C)O)O)O)=O,,,5,1,5,0,5
6722_1,,,,2,1,1,2
6724_0,,,,2,1,1,2
C(C1C(C(CC1O)O)=O)(O)=O,,,5,1,5,0,5
6724_1,,,,2,1,1,2
6726_0,,,,2,1,1,2
C1(C(CC(C1CO)O)O)=O,,,5,1,4,0,4
6726_1,,,,2,1,1,2
6728_0,,,,2,1,1,2
C(C1(C(CO)C(C(C1)=O)O)O)(O)=O,,,5,1,1,0,1
6730_0,,,,2,1,1,2
C1(C(CO)C(C(O)=O)(CC1O)O)=O,,,5,1,4,0,4
6730_1,,,,2,1,1,2
6732_0,,,,2,1,1,2
C1(C(C(C(C1O)O)(CCO)O)O)=O,,,5,1,4,0,4
6732_1,,,,2,1,1,2
6734_0,,,,2,1,1,2
C1(C(C(C(CCO)(C1)O)O)O)=O,,,5,1,3,0,3
6734_1,,,,2,1,1,2
6736_0,,,,2,1,1,2
C1(C(C(C(C1)O)(CCO)O)O)=O,,,5,1,3,0,3
6738_0,,,,2,1,1,2
C1(C(C(CO)C(C1CO)O)O)=O,,,5,1,2,0,2
6738_1,,,,2,1,1,2
6740_0,,,,2,1,1,2
C1(C(C(C(CO)(C1CO)O)O)O)=O,,,5,1,2,0,2
6740_1,,,,2,1,1,2
6741_0,,,,2,1,1,2
6741_1,,,,2,1,1,2
6743_0,,,,2,1,1,2
C1(C(CC(CO)(C1CO)O)O)=O,,,5,1,2,0,2
6743_1,,,,2,1,1,2
6744_0,,,,2,1,1,2
6744_1,,,,2,1,1,2
6746_0,,,,2,1,1,2
C1(C(C(C(C)(C1CO)O)O)O)=O,,,5,1,2,0,2
6746_1,,,,2,1,1,2
6747_0,,,,2,1,1,2
6749_0,,,,2,1,1,2
C1(C(C(C=C)C(C1CO)O)O)=O,,,5,1,2,0,2
6749_1,,,,2,1,1,2
6751_0,,,,2,1,1,2
C1(C(C(C(C1CO)O)O)O)=O,,,5,1,2,0,2
6751_1,,,,2,1,1,2
6753_0,,,,2,1,1,2
C1(C(C(C(CC(C)O)(C1)O)O)O)=O,,,5,1,3,0,3
6753_1,,,,2,1,1,2
6755_0,,,,2,1,1,2
C1(C(C(C(C1)O)(CC(C)O)O)O)=O,,,5,1,3,0,3
6757_0,,,,2,1,1,2
C1(C(C(CO)C(C1C(C)O)O)O)=O,,,5,1,2,0,2
6757_1,,,,2,1,1,2
6759_0,,,,2,1,1,2
C1(C(CC(CO)(C1C(C)O)O)O)=O,,,5,1,2,0,2
6759_1,,,,2,1,1,2
6760_0,,,,2,1,1,2
6760_1,,,,2,1,1,2
6762_0,,,,2,1,1,2
C1(C(C(C(C)(C1C(C)O)O)O)O)=O,,,5,1,2,0,2
6762_1,,,,2,1,1,2
6763_0,,,,2,1,1,2
6765_0,,,,2,1,1,2
C1(C(C(C=C)C(C1C(C)O)O)O)=O,,,5,1,2,0,2
6765_1,,,,2,1,1,2
6767_0,,,,2,1,1,2
C1(C(C(C(C1C(C)O)O)O)O)=O,,,5,1,3,0,3
6767_1,,,,2,1,1,2
6769_0,,,,2,1,1,2
C(CC1(C(C(C(C1)=O)O)O)O)(O)=O,,,5,1,3,0,3
6769_1,,,,2,1,1,2
6771_0,,,,2,1,1,2
C(CC1(C(CC(C1O)=O)O)O)(O)=O,,,5,1,3,0,3
6773_0,,,,2,1,1,2
C(C1C(C(C(CO)C1O)O)=O)(O)=O,,,5,1,2,0,2
6773_1,,,,2,1,1,2
6775_0,,,,2,1,1,2
C(C1C(C(CC1(CO)O)O)=O)(O)=O,,,5,1,2,0,2
6775_1,,,,2,1,1,2
6776_0,,,,2,1,1,2
6776_1,,,,2,1,1,2
6778_0,,,,2,1,1,2
C(C1C(C(C(C1(C)O)O)O)=O)(O)=O,,,5,1,2,0,2
6778_1,,,,2,1,1,2
6779_0,,,,2,1,1,2
6781_0,,,,2,1,1,2
C(C1C(C(C(C=C)C1O)O)=O)(O)=O,,,5,1,2,0,2
6781_1,,,,2,1,1,2
6783_0,,,,2,1,1,2
C(C1C(C(C(C1O)O)O)=O)(O)=O,,,5,1,3,0,3
6783_1,,,,2,1,1,2
6785_0,,,,2,1,1,2
C1(C(CC(C1C(CCO)O)O)=O)=O,,,5,1,5,0,5
6786_0,,,,2,1,1,2
6786_1,,,,2,1,1,2
6788_0,,,,2,1,1,2
C(C(CO)C1(C(CC(C1)O)=O)O)=O,,,5,1,3,0,3
6790_0,,,,2,1,1,2
C1(C(C(C(C1)O)CO)(CC=O)O)=O,,,5,1,1,0,1
6792_0,,,,2,1,1,2
C(C1C(C(C)(C(CO)C1O)O)=O)=O,,,5,1,2,0,2
6792_1,,,,2,1,1,2
6794_0,,,,2,1,1,2
C1(C(CC(C(CO)C(C1)O)O)=O)=O,,,5,1,1,0,1
6796_0,,,,2,1,1,2
C1(CC(C(CO)C1(C(C)O)O)O)=O,,,5,1,1,0,1
6798_0,,,,2,1,1,2
C(C1(C(CC(C1CO)O)=O)O)(O)=O,,,5,1,1,0,1
6800_0,,,,2,1,1,2
C1(C(CC(CO)(C1)O)(CC=O)O)=O,,,5,1,1,0,1
6802_0,,,,2,1,1,2
C(CC1(C(C)(C(C(C1)=O)O)O)O)=O,,,5,1,3,0,3
6802_1,,,,2,1,1,2
6804_0,,,,2,1,1,2
C(C)(C1(CC(C(C(C1)=O)O)O)O)=O,,,5,1,3,0,3
6804_1,,,,2,1,1,2
6806_0,,,,2,1,1,2
C1(C(CC(C1)O)(CC(CO)=O)O)=O,,,5,1,2,0,2
6808_0,,,,2,1,1,2
C1(C(C(C(C)(C1)O)O)(CC=O)O)=O,,,5,1,2,0,2
6810_0,,,,2,1,1,2
C(CC1(C(C)(CC(C1O)=O)O)O)=O,,,5,1,3,0,3
6812_0,,,,2,1,1,2
C(C)(C1(CC(CC(C1O)=O)O)O)=O,,,5,1,4,0,4
6814_0,,,,2,1,1,2
C1(C(CC(C1)O)(C(C(C)=O)O)O)=O,,,5,1,4,0,4
6816_0,,,,2,1,1,2
C(CC1(C(CC(C1C=C)O)=O)O)=O,,,5,1,1,0,1
6818_0,,,,2,1,1,2
C(C(C=C)C1(C(CC(C1)O)=O)O)=O,,,5,1,2,0,2
6820_0,,,,2,1,1,2
C1(C(C(C(C1)O)O)(CC=O)O)=O,,,5,1,2,0,2
6822_0,,,,2,1,1,2
C1(C(CC(C1)O)(C(C=O)O)O)=O,,,5,1,4,0,4
6824_0,,,,2,1,1,2
C1(C(CC(C1)O)(CC=O)O)=O,,,5,1,2,0,2
6826_0,,,,2,1,1,2
C(C1(CC(C(C1)=O)(CC=O)O)O)=O,,,5,1,1,0,1
6828_0,,,,2,1,1,2
C(CC1(C(CC(C(C1)=O)O)=O)O)=O,,,5,1,2,0,2
6830_0,,,,2,1,1,2
C(C1C(C(CC1(C(C)=O)O)=O)O)=O,,,5,1,3,0,3
6830_1,,,,2,1,1,2
6832_0,,,,2,1,1,2
C1(C(CC(C1)O)(CC(C=O)=O)O)=O,,,5,1,2,0,2
6834_0,,,,2,1,1,2
C(C1C(C(C)(CC1(CO)O)O)=O)=O,,,5,1,2,0,2
6834_1,,,,2,1,1,2
6835_0,,,,2,1,1,2
6835_1,,,,2,1,1,2
6837_0,,,,2,1,1,2
C1(C(C)(C(C(CO)=O)C(C1)O)O)=O,,,5,1,4,0,4
6837_1,,,,2,1,1,2
6839_0,,,,2,1,1,2
C1(C(C)(CC(C(C(C1)O)O)=O)O)=O,,,5,1,3,0,3
6839_1,,,,2,1,1,2
6841_0,,,,2,1,1,2
C(C1C(C(C)(C(C1(C)O)O)O)=O)=O,,,5,1,2,0,2
6841_1,,,,2,1,1,2
6842_0,,,,2,1,1,2
6844_0,,,,2,1,1,2
C1(C(C)(C(C(CC(C1)O)=O)O)O)=O,,,5,1,3,0,3
6846_0,,,,2,1,1,2
C(C1C(C(C)(C(C=C)C1O)O)=O)=O,,,5,1,2,0,2
6846_1,,,,2,1,1,2
6848_0,,,,2,1,1,2
C(C1C(C(C)(C(C1O)O)O)=O)=O,,,5,1,2,0,2
6848_1,,,,2,1,1,2
6850_0,,,,2,1,1,2
C(C1C(C(C)(CC1O)O)=O)=O,,,5,1,2,0,2
6850_1,,,,2,1,1,2
6852_0,,,,2,1,1,2
C(C1C(CC(C1(C)O)=O)O)=O,,,5,1,4,0,4
6852_1,,,,2,1,1,2
6854_0,,,,2,1,1,2
C1(C(C)(CC(C=O)(C1C=O)O)O)=O,,,5,1,2,0,2
6854_1,,,,2,1,1,2
6856_0,,,,2,1,1,2
C1(C(C)(CC(C(C1C=O)O)=O)O)=O,,,5,1,3,0,3
6856_1,,,,2,1,1,2
6858_0,,,,2,1,1,2
C1(C(C)(C(C(C=O)=O)C(C1)O)O)=O,,,5,1,4,0,4
6858_1,,,,2,1,1,2
6860_0,,,,2,1,1,2
C1(C(CC(CO)(CC(C1)O)O)=O)=O,,,5,1,1,0,1
6861_0,,,,2,1,1,2
6861_1,,,,2,1,1,2
6862_0,,,,2,1,1,2
6862_1,,,,2,1,1,2
6863_0,,,,2,1,1,2
6863_1,,,,2,1,1,2
6865_0,,,,2,1,1,2
C1(C(CC(C(C(C)(C1)O)O)O)=O)=O,,,5,1,1,0,1
6866_0,,,,2,1,1,2
6867_0,,,,2,1,1,2
6869_0,,,,2,1,1,2
C(C1C(CC(C(CC1O)=O)=O)O)=C,,,5,1,1,0,1
6871_0,,,,2,1,1,2
C1(C(CC(C(C(C1)O)O)O)=O)=O,,,5,1,1,0,1
6873_0,,,,2,1,1,2
C1(C(CC(CC(C1)O)O)=O)=O,,,5,1,1,0,1
6874_0,,,,2,1,1,2
6874_1,,,,2,1,1,2
6876_0,,,,2,1,1,2
C(C1(CC(CC(C(C1)=O)=O)O)O)=O,,,5,1,1,0,1
6878_0,,,,2,1,1,2
C1(C(C(C(C(C)=O)=O)C(C1)O)O)=O,,,5,1,3,0,3
6878_1,,,,2,1,1,2
6880_0,,,,2,1,1,2
C1(C(CC(C(CC(C1)O)=O)=O)O)=O,,,5,1,2,0,2
6881_0,,,,2,1,1,2
6881_1,,,,2,1,1,2
6883_0,,,,2,1,1,2
C(C1C(C(CC(C1O)O)=O)=O)=O,,,5,1,3,0,3
6885_0,,,,2,1,1,2
C(C(C1C(C(CC1O)=O)=O)O)=O,,,5,1,5,0,5
6887_0,,,,2,1,1,2
C1(C(CC(C1C(C)(CO)O)O)=O)=O,,,5,1,5,0,5
6889_0,,,,2,1,1,2
C(C)=CC(C1C(C(CC1O)=O)=O)O,,,5,1,5,0,5
6891_0,,,,2,1,1,2
C=CCC(C1C(C(CC1O)=O)=O)O,,,5,1,5,0,5
6893_0,,,,2,1,1,2
C1(C(CC(C1C(CO)O)O)=O)=O,,,5,1,5,0,5
6895_0,,,,2,1,1,2
C1(C(CC(C1C(C(C)O)O)O)=O)=O,,,5,1,5,0,5
6897_0,,,,2,1,1,2
C(C(C1C(C(CC1O)=O)=O)O)(O)=O,,,5,1,5,0,5
6899_0,,,,2,1,1,2
C1(C(CC(C1C(C)O)O)=O)=O,,,5,1,5,0,5
6901_0,,,,2,1,1,2
C(C1C(C(CC1O)=O)=O)(O)=O,,,5,1,5,0,5
6903_0,,,,2,1,1,2
C(C1C(C(CC(C1(C)O)O)=O)=O)=O,,,5,1,3,0,3
6905_0,,,,2,1,1,2
C(C(C)(C1C(C(CC1O)=O)=O)O)=O,,,5,1,5,0,5
6907_0,,,,2,1,1,2
C(C1C(C(CC(C)(C1O)O)=O)=O)=O,,,5,1,3,0,3
6908_0,,,,2,1,1,2
6909_0,,,,2,1,1,2
6910_0,,,,2,1,1,2
6912_0,,,,2,1,1,2
C(C(C1C(C(CC1O)=O)=O)O)(C)=O,,,5,1,5,0,5
6914_0,,,,2,1,1,2
C1(C(CC(C1CO)O)=O)=O,,,5,1,5,0,5
6915_0,,,,2,1,1,2
6915_1,,,,2,1,1,2
6916_0,,,,2,1,1,2
6916_1,,,,2,1,1,2
6917_0,,,,2,1,1,2
6917_1,,,,2,1,1,2
6918_0,,,,2,1,1,2
6918_1,,,,2,1,1,2
6919_0,,,,2,1,1,2
6919_1,,,,2,1,1,2
6920_0,,,,2,1,1,2
6920_1,,,,2,1,1,2
6921_0,,,,2,1,1,2
6921_1,,,,2,1,1,2
6922_0,,,,2,1,1,2
6922_1,,,,2,1,1,2
6923_0,,,,2,1,1,2
6923_1,,,,2,1,1,2
6924_0,,,,2,1,1,2
6924_1,,,,2,1,1,2
6925_0,,,,2,1,1,2
6925_1,,,,2,1,1,2
6926_0,,,,2,1,1,2
6926_1,,,,2,1,1,2
6927_0,,,,2,1,1,2
6927_1,,,,2,1,1,2
6928_0,,,,2,1,1,2
6930_0,,,,2,1,1,2
C(C1(CC(C(C1)=O)O)O)(CC=O)=O,,,5,1,1,0,1
6931_0,,,,2,1,1,2
6932_0,,,,2,1,1,2
6932_1,,,,2,1,1,2
6933_0,,,,2,1,1,2
6933_1,,,,2,1,1,2
6935_0,,,,2,1,1,2
C1(C(C(C(C1(C(C)O)O)O)O)O)=O,,,5,1,4,0,4
6935_1,,,,2,1,1,2
6937_0,,,,2,1,1,2
C1(C(C(CC1(C(C)O)O)O)O)=O,,,5,1,3,0,3
6937_1,,,,2,1,1,2
6939_0,,,,2,1,1,2
C(C1(C(C(C(C1O)O)O)=O)O)(O)=O,,,5,1,5,0,5
6939_1,,,,2,1,1,2
6941_0,,,,2,1,1,2
C(C1(C(C(C(C1)O)O)=O)O)(O)=O,,,5,1,4,0,4
6941_1,,,,2,1,1,2
6943_0,,,,2,1,1,2
C1(CC(CO)(CC1(C(C)O)O)O)=O,,,5,1,1,0,1
6945_0,,,,2,1,1,2
C1(C(C(C)(C(C(C)O)(C1)O)O)O)=O,,,5,1,3,0,3
6945_1,,,,2,1,1,2
6947_0,,,,2,1,1,2
C1(CC(C)(C(C1(C(C)O)O)O)O)=O,,,5,1,1,0,1
6949_0,,,,2,1,1,2
C1(C(C(C(C)(C1)O)(C(C)O)O)O)=O,,,5,1,3,0,3
6951_0,,,,2,1,1,2
C1(C(C(C)O)(C(C=C)C(C1)O)O)=O,,,5,1,1,0,1
6953_0,,,,2,1,1,2
C1(CC(C(C1(C(C)O)O)O)O)=O,,,5,1,1,0,1
6955_0,,,,2,1,1,2
C1(CC(CC1(C(C)O)O)O)=O,,,5,1,2,0,2
6957_0,,,,2,1,1,2
C(C1(CC(C(C1)=O)(C(C)O)O)O)=O,,,5,1,2,0,2
6959_0,,,,2,1,1,2
C1(CC(C(CC1(C(C)O)O)=O)O)=O,,,5,1,3,0,3
6960_0,,,,2,1,1,2
6960_1,,,,2,1,1,2
6961_0,,,,2,1,1,2
6962_0,,,,2,1,1,2
6964_0,,,,2,1,1,2
C(C1(CC(C(C1)=O)O)O)(C(C)O)=O,,,5,1,1,0,1
6966_0,,,,2,1,1,2
C(C1(C(CC(CO)(C1)O)=O)O)(O)=O,,,5,1,1,0,1
6968_0,,,,2,1,1,2
C(C1(C(C)(C(C(C1)=O)O)O)O)(O)=O,,,5,1,3,0,3
6968_1,,,,2,1,1,2
6970_0,,,,2,1,1,2
C(C1(C(CC(C)(C1O)O)=O)O)(O)=O,,,5,1,1,0,1
6972_0,,,,2,1,1,2
C(C1(C(C)(CC(C1O)=O)O)O)(O)=O,,,5,1,3,0,3
6974_0,,,,2,1,1,2
C1(CC(C(C=C)C1(C(O)=O)O)O)=O,,,5,1,1,0,1
6976_0,,,,2,1,1,2
C(C1(C(CC(C1O)O)=O)O)(O)=O,,,5,1,1,0,1
6978_0,,,,2,1,1,2
C(C1(C(CC(C1)O)=O)O)(O)=O,,,5,1,2,0,2
6980_0,,,,2,1,1,2
C(C1(CC(C(O)=O)(C(C1)=O)O)O)=O,,,5,1,2,0,2
6982_0,,,,2,1,1,2
C(C1(C(CC(C(C1)=O)O)=O)O)(O)=O,,,5,1,3,0,3
6983_0,,,,2,1,1,2
6983_1,,,,2,1,1,2
6984_0,,,,2,1,1,2
6985_0,,,,2,1,1,2
6987_0,,,,2,1,1,2
C1(CC(C(C(O)=O)=O)(CC1O)O)=O,,,5,1,1,0,1
6989_0,,,,2,1,1,2
C1(C(C(C(C1O)O)O)O)=O,,,5,1,2,0,2
6989_1,,,,2,1,1,2
6991_0,,,,2,1,1,2
C1(C(C(C(C1)O)O)O)=O,,,5,1,5,0,5
6991_1,,,,2,1,1,2
6992_0,,,,2,1,1,2
6994_0,,,,2,1,1,2
C1(C(CCO)(CC(C(O1)=O)=O)O)=O,,,5,1,1,0,1
6995_0,,,,2,1,1,2
6995_1,,,,2,1,1,2
6997_0,,,,2,1,1,2
C1(C(C(C(C(C1O)O)O)O)O)=O,,,5,1,3,0,3
6997_1,,,,2,1,1,2
6999_0,,,,2,1,1,2
C1(C(C(C(C(C1)O)O)O)O)=O,,,5,1,4,0,4
6999_1,,,,2,1,1,2
7000_0,,,,2,1,1,2
7002_0,,,,2,1,1,2
C1(C(C(C(CO)(C1O)O)O)O)=O,,,5,1,5,0,5
7002_1,,,,2,1,1,2
7003_0,,,,2,1,1,2
7003_1,,,,2,1,1,2
7005_0,,,,2,1,1,2
C1(C(C(C(C)(C1O)O)O)O)=O,,,5,1,4,0,4
7005_1,,,,2,1,1,2
7006_0,,,,2,1,1,2
7006_1,,,,2,1,1,2
7008_0,,,,2,1,1,2
C1(C(C(C(CO)(C1)O)O)O)=O,,,5,1,4,0,4
7010_0,,,,2,1,1,2
C1(C(C(C(C1)O)(CO)O)O)=O,,,5,1,3,0,3
7010_1,,,,2,1,1,2
7012_0,,,,2,1,1,2
C1(C(CC(CO)(C1O)O)O)=O,,,5,1,3,0,3
7012_1,,,,2,1,1,2
7013_0,,,,2,1,1,2
7013_1,,,,2,1,1,2
7015_0,,,,2,1,1,2
C1(C(C(C(C)(C1)O)O)O)=O,,,5,1,3,0,3
7015_1,,,,2,1,1,2
7017_0,,,,2,1,1,2
C1(C(C(C(C1)O)(C)O)O)=O,,,5,1,3,0,3
7017_1,,,,2,1,1,2
7019_0,,,,2,1,1,2
C1(C(CC(CO)(C1)O)O)=O,,,5,1,2,0,2
7020_0,,,,2,1,1,2
7021_0,,,,2,1,1,2
7022_0,,,,2,1,1,2
7024_0,,,,2,1,1,2
C(C(C)C1(CC(C(C1)=O)O)O)(O)=O,,,5,1,1,0,1
7026_0,,,,2,1,1,2
C1(C(C(C=C)C(C1O)O)O)=O,,,5,1,3,0,3
7026_1,,,,2,1,1,2
7028_0,,,,2,1,1,2
C1(C(C(C=C)C(C1)O)O)=O,,,5,1,2,0,2
7030_0,,,,2,1,1,2
C(C1(CC(C(C1C=C)O)=O)O)(O)=O,,,5,1,1,0,1
7032_0,,,,2,1,1,2
C1(C(C(C(C(O)=O)=C)C(C1)O)O)=O,,,5,1,1,0,1
7034_0,,,,2,1,1,2
C1(C2(C(CO)C(C(C2)=O)(O)O1)O)=O,,,5,1,3,0,3
7036_0,,,,2,1,1,2
C1(C2(CC(C(O2)=O)(C1CO)O)O)=O,,,5,1,6,0,6
7036_1,,,,2,1,1,2
7038_0,,,,2,1,1,2
C1(C2(C(C(C)O1)C(C(C2)=O)O)O)=O,,,5,1,1,0,1
7040_0,,,,2,1,1,2
C1(C2(CC(C(C2C(O1)=O)O)=O)O)=O,,,5,1,2,0,2
7042_0,,,,2,1,1,2
C1(C(C(CC1O)O)C[CH]C(O)=O)=O,,,5,1,2,0,2
7044_0,,,,2,1,1,2
C(CCC1C(C(CC1O)O)=O)(O)=O,,,5,1,2,0,2
7046_0,,,,2,1,1,2
C1(C(C(C(C1)O)C[CH]C(O)=O)O)=O,,,5,1,2,0,2
7048_0,,,,2,1,1,2
C(CCC1C(CC(C1O)=O)O)(O)=O,,,5,1,2,0,2
7050_0,,,,2,1,1,2
C1(C(C(C(C1C(C)O)O)O)=O)=O,,,5,1,2,0,2
7050_1,,,,2,1,1,2
7052_0,,,,2,1,1,2
C(C1C(C(C(C1O)O)=O)=O)(O)=O,,,5,1,3,0,3
7052_1,,,,2,1,1,2
7054_0,,,,2,1,1,2
C1(C(C(C(C(C1O)=O)=O)O)O)=O,,,5,1,3,0,3
7054_1,,,,2,1,1,2
7056_0,,,,2,1,1,2
C(C1(C(C(C(C1O)=O)=O)O)O)=O,,,5,1,2,0,2
7056_1,,,,2,1,1,2
7058_0,,,,2,1,1,2
C1(C(CC(C(C1O)=O)=O)O)=O,,,5,1,2,0,2
7060_0,,,,2,1,1,2
C(C1(CC(C(C1O)=O)=O)O)=O,,,5,1,4,0,4
7061_0,,,,2,1,1,2
7061_1,,,,2,1,1,2
7063_0,,,,2,1,1,2
C1(C(C(C(C(C1)=O)=O)O)O)=O,,,5,1,7,0,7
7063_1,,,,2,1,1,2
7065_0,,,,2,1,1,2
C(C1(CC(C(C1)=O)=O)O)=O,,,5,1,2,0,2
7067_0,,,,2,1,1,2
C1(C(CC(C(C1)=O)=O)O)=O,,,5,1,3,0,3
7069_0,,,,2,1,1,2
C1(C(C(C(C1)O)O)=O)=O,,,5,1,2,0,2
7069_1,,,,2,1,1,2
7071_0,,,,2,1,1,2
C(C1(CC(C(C1O)=O)=O)O)(O)=O,,,5,1,4,0,4
7071_1,,,,2,1,1,2
7072_0,,,,2,1,1,2
7074_0,,,,2,1,1,2
C1(C(C(C(C1(C)O)O)=O)=O)=O,,,5,1,2,0,2
7074_1,,,,2,1,1,2
7076_0,,,,2,1,1,2
C1(C(C(CC1(CO)O)=O)=O)=O,,,5,1,1,0,1
7078_0,,,,2,1,1,2
C1(C(C(CC1(C)O)=O)=O)=O,,,5,1,1,0,1
7080_0,,,,2,1,1,2
C1(C(CO)(C(C(C1O)=O)O)O)=O,,,5,1,4,0,4
7080_1,,,,2,1,1,2
7082_0,,,,2,1,1,2
C1(C(C(C(CO)(C1O)O)O)=O)=O,,,5,1,2,0,2
7082_1,,,,2,1,1,2
7084_0,,,,2,1,1,2
C1(C(C(C(C1(CO)O)O)O)=O)=O,,,5,1,2,0,2
7084_1,,,,2,1,1,2
7086_0,,,,2,1,1,2
C1(C(C(C(C1(C)O)O)O)=O)=O,,,5,1,2,0,2
7086_1,,,,2,1,1,2
7088_0,,,,2,1,1,2
C1(C(CO)(CC(C1O)=O)O)=O,,,5,1,1,0,1
7090_0,,,,2,1,1,2
C1(C(C(C(C)(C1O)O)O)=O)=O,,,5,1,2,0,2
7090_1,,,,2,1,1,2
7092_0,,,,2,1,1,2
C1(C(C(C(C1O)=O)O)O)=O,,,5,1,2,0,2
7092_1,,,,2,1,1,2
7094_0,,,,2,1,1,2
C1(C(C)(C(C(C1O)=O)O)O)=O,,,5,1,3,0,3
7094_1,,,,2,1,1,2
7096_0,,,,2,1,1,2
C1(C(C(C(CO)(C1)O)O)=O)=O,,,5,1,1,0,1
7098_0,,,,2,1,1,2
C1(C(CC(C1(CO)O)O)=O)=O,,,5,1,1,0,1
7100_0,,,,2,1,1,2
C1(C(CC(C1(C)O)O)=O)=O,,,5,1,1,0,1
7102_0,,,,2,1,1,2
C1(C(CC(C1O)=O)O)=O,,,5,1,1,0,1
7104_0,,,,2,1,1,2
C1(C(C)(CC(C1O)=O)O)=O,,,5,1,1,0,1
7106_0,,,,2,1,1,2
C1(C(C(C(C)(C1)O)O)=O)=O,,,5,1,1,0,1
7108_0,,,,2,1,1,2
C1(C(C(C(C(C1O)=O)O)O)O)=O,,,5,1,3,0,3
7108_1,,,,2,1,1,2
7110_0,,,,2,1,1,2
C1(CC(C(C(C1O)=O)O)O)=O,,,5,1,2,0,2
7112_0,,,,2,1,1,2
C1(C(C(C(C1)O)(CO)C(C)O)O)=O,,,5,1,1,0,1
7114_0,,,,2,1,1,2
C(C1C(C(C=O)C(C1O)O)O)(O)=O,,,5,1,3,0,3
7114_1,,,,2,1,1,2
7116_0,,,,2,1,1,2
C(C1(CO)C(CC(C1O)=O)O)(O)=O,,,5,1,3,0,3
7118_0,,,,2,1,1,2
C1(CC(C(C(C1(CO)O)O)=O)O)=O,,,5,1,3,0,3
7120_0,,,,2,1,1,2
C(C1(C(C(C(C1)=O)(CO)O)O)O)=O,,,5,1,3,0,3
7122_0,,,,2,1,1,2
C1(C(C(C(C(C1)O)=O)(CO)O)O)=O,,,5,1,5,0,5
7124_0,,,,2,1,1,2
C(C1(C(CO)(C(C(C1)=O)O)O)O)=O,,,5,1,1,0,1
7126_0,,,,2,1,1,2
C(C1(C(C(C(C1O)=O)CO)O)O)=O,,,5,1,4,0,4
7126_1,,,,2,1,1,2
7128_0,,,,2,1,1,2
C1(C(C(CO)(C(C1CO)O)O)O)=O,,,5,1,2,0,2
7128_1,,,,2,1,1,2
7130_0,,,,2,1,1,2
C(C1(C(CC(C1O)O)=O)CO)(O)=O,,,5,1,2,0,2
7132_0,,,,2,1,1,2
C(C1(C(CC(C1O)O)=O)C)(O)=O,,,5,1,2,0,2
7133_0,,,,2,1,1,2
7133_1,,,,2,1,1,2
7135_0,,,,2,1,1,2
C(C1(C(CC(C1O)=O)O)O)=O,,,5,1,3,0,3
7136_0,,,,2,1,1,2
7136_1,,,,2,1,1,2
7138_0,,,,2,1,1,2
C(C1(C(CC(C1O)=O)O)O)(O)=O,,,5,1,3,0,3
7140_0,,,,2,1,1,2
C(C1(C(CC(C1(C)O)O)=O)C)(O)=O,,,5,1,2,0,2
7142_0,,,,2,1,1,2
C(C1(C(CC(C)(C1O)O)=O)C)(O)=O,,,5,1,2,0,2
7144_0,,,,2,1,1,2
C(C1(C)C(C)(CC(C1O)=O)O)(O)=O,,,5,1,2,0,2
7146_0,,,,2,1,1,2
C1(CC(C(C(C)O)C1(CO)O)O)=O,,,5,1,2,0,2
7148_0,,,,2,1,1,2
C(C1C(CC(C1(CO)O)=O)O)(O)=O,,,5,1,2,0,2
7150_0,,,,2,1,1,2
C(C1(CC(C(C1O)=O)(CO)O)O)=O,,,5,1,3,0,3
7150_1,,,,2,1,1,2
7152_0,,,,2,1,1,2
C1(C(C(C(C(CO)(C1)O)=O)O)O)=O,,,5,1,3,0,3
7152_1,,,,2,1,1,2
7154_0,,,,2,1,1,2
C1(C(C(C(C1O)O)O)(CC=O)O)=O,,,5,1,3,0,3
7154_1,,,,2,1,1,2
7156_0,,,,2,1,1,2
C1(C(CC(C1O)O)(C(C=O)O)O)=O,,,5,1,3,0,3
7156_1,,,,2,1,1,2
7158_0,,,,2,1,1,2
C1(C(C(CC1(C(CO)O)O)O)O)=O,,,5,1,3,0,3
7158_1,,,,2,1,1,2
7160_0,,,,2,1,1,2
C1(C(C(CC1(CO)O)O)O)=O,,,5,1,3,0,3
7160_1,,,,2,1,1,2
7161_0,,,,2,1,1,2
7161_1,,,,2,1,1,2
7163_0,,,,2,1,1,2
C(C1(CC(C(C1)=O)(CO)O)O)=O,,,5,1,2,0,2
7165_0,,,,2,1,1,2
C1(CC(C(CC1(CO)O)=O)O)=O,,,5,1,2,0,2
7167_0,,,,2,1,1,2
C1(CC(CC1(C(CCO)O)O)O)=O,,,5,1,2,0,2
7169_0,,,,2,1,1,2
C1(CC(CC1(C(CO)(C)O)O)O)=O,,,5,1,2,0,2
7171_0,,,,2,1,1,2
C1(C(CC(C1)O)(C(C=CC)O)O)=O,,,5,1,2,0,2
7173_0,,,,2,1,1,2
C1(CC(CC1(C(CC=C)O)O)O)=O,,,5,1,2,0,2
7175_0,,,,2,1,1,2
C1(CC(CC1(C(CO)O)O)O)=O,,,5,1,2,0,2
7177_0,,,,2,1,1,2
C1(CC(CC1(C(C(C)O)O)O)O)=O,,,5,1,2,0,2
7179_0,,,,2,1,1,2
C1(C(CC(C1)O)(C(C(O)=O)O)O)=O,,,5,1,3,0,3
7181_0,,,,2,1,1,2
C1(C(C(C(C1)O)(C)O)(CC=O)O)=O,,,5,1,2,0,2
7183_0,,,,2,1,1,2
C1(C(CC(C1)O)(C(C=O)(C)O)O)=O,,,5,1,3,0,3
7185_0,,,,2,1,1,2
C1(CC(CC1(CO)O)O)=O,,,5,1,2,0,2
7187_0,,,,2,1,1,2
C1(C(CC(C(C(C1)O)(C)O)O)O)=O,,,5,1,1,0,1
7189_0,,,,2,1,1,2
C(C1C(C(C)(C(C)(C1O)O)O)O)=O,,,5,1,2,0,2
7189_1,,,,2,1,1,2
7191_0,,,,2,1,1,2
C(C1(CC(C(C1)=O)(CO)O)O)(O)=O,,,5,1,2,0,2
7193_0,,,,2,1,1,2
C1(C(C(C)(C(C1CO)O)O)O)=O,,,5,1,2,0,2
7193_1,,,,2,1,1,2
7195_0,,,,2,1,1,2
C1(C(C(C)(C(C1C(C)O)O)O)O)=O,,,5,1,2,0,2
7195_1,,,,2,1,1,2
7197_0,,,,2,1,1,2
C(C1C(C(C(C)(C1O)O)O)=O)(O)=O,,,5,1,2,0,2
7197_1,,,,2,1,1,2
7199_0,,,,2,1,1,2
C(C1C(C(C)(C(C)(C1O)O)O)=O)=O,,,5,1,2,0,2
7199_1,,,,2,1,1,2
7201_0,,,,2,1,1,2
C1(C(CC(C(C)(C(C1)O)O)O)=O)=O,,,5,1,1,0,1
7203_0,,,,2,1,1,2
C1(C(C(C(C(C1(C)O)O)O)O)=O)=O,,,5,1,3,0,3
7203_1,,,,2,1,1,2
7205_0,,,,2,1,1,2
C1(C(CC(C(C1(C)O)O)O)=O)=O,,,5,1,2,0,2
7207_0,,,,2,1,1,2
C1(C(CC(C(C)(C1(C)O)O)O)=O)=O,,,5,1,2,0,2
7209_0,,,,2,1,1,2
C1(C(CC(C)(C(C1(C)O)O)O)=O)=O,,,5,1,2,0,2
7211_0,,,,2,1,1,2
C(C)(C1(C(C)(C(C(C1)=O)O)O)O)=O,,,5,1,1,0,1
7213_0,,,,2,1,1,2
C1(C(C)(CC(C(C1(C)O)O)=O)O)=O,,,5,1,2,0,2
7215_0,,,,2,1,1,2
C1(CC(C(C)(C1(C(C)O)O)O)O)=O,,,5,1,1,0,1
7217_0,,,,2,1,1,2
C(C1(C(CC(C1(C)O)O)=O)O)(O)=O,,,5,1,1,0,1
7219_0,,,,2,1,1,2
C1(C(C(C)O)C(C(C1)=O)O)=O,,,5,1,3,0,3
7219_1,,,,2,1,1,2
7221_0,,,,2,1,1,2
C(C1C(CC(C1O)=O)=O)(O)=O,,,5,1,3,0,3
7221_1,,,,2,1,1,2
7222_0,,,,2,1,1,2
7222_1,,,,2,1,1,2
7224_0,,,,2,1,1,2
C(C1(C(CC(C1O)=O)=O)O)=O,,,5,1,3,0,3
7224_1,,,,2,1,1,2
7226_0,,,,2,1,1,2
C(C1(C(CC(C1O)=O)=O)O)(O)=O,,,5,1,3,0,3
7226_1,,,,2,1,1,2
7228_0,,,,2,1,1,2
C1(CC(C(C(C1)=O)=O)O)=O,,,5,1,2,0,2
7230_0,,,,2,1,1,2
C(C1(C(CC(C1)=O)=O)O)=O,,,5,1,2,0,2
7232_0,,,,2,1,1,2
C1(CC(C(C1)=O)O)=O,,,5,1,2,0,2
7234_0,,,,2,1,1,2
C(C1(C(CC(C1)=O)=O)O)(O)=O,,,5,1,2,0,2
7236_0,,,,2,1,1,2
C1(C(C(C(C=1)=O)O)O)C(C)O,,,5,1,3,0,3
7236_1,,,,2,1,1,2
7238_0,,,,2,1,1,2
C1(C(C(C(C1O)=CC)O)O)=O,,,5,1,3,0,3
7238_1,,,,2,1,1,2
7240_0,,,,2,1,1,2
C1(C(CC(C=1)=O)O)C(C)O,,,5,1,2,0,2
7242_0,,,,2,1,1,2
C1(CC(C(C1O)=CC)O)=O,,,5,1,2,0,2
7244_0,,,,2,1,1,2
C(C1C(C(C(C=1)=O)O)O)(O)=O,,,5,1,5,0,5
7244_1,,,,2,1,1,2
7246_0,,,,2,1,1,2
C(C1C(CC(C=1)=O)O)(O)=O,,,5,1,2,0,2
7248_0,,,,2,1,1,2
C(C1(C(C(C(C1)=O)=O)=C)O)(O)=O,,,5,1,2,0,2
7250_0,,,,2,1,1,2
C(C1(C=CC(C1O)=O)O)=O,,,5,1,3,0,3
7250_1,,,,2,1,1,2
7252_0,,,,2,1,1,2
C1(C=CC(C(C1O)O)=O)=O,,,5,1,3,0,3
7252_1,,,,2,1,1,2
7254_0,,,,2,1,1,2
C1C(C(C(C=1)=O)O)O,,,5,1,3,0,3
7254_1,,,,2,1,1,2
7256_0,,,,2,1,1,2
C(C1(C=CC(C1O)=O)O)(O)=O,,,5,1,3,0,3
7256_1,,,,2,1,1,2
7258_0,,,,2,1,1,2
C(C1(C=CC(C1)=O)O)=O,,,5,1,2,0,2
7260_0,,,,2,1,1,2
C1(C=CC(C(C1)O)=O)=O,,,5,1,2,0,2
7262_0,,,,2,1,1,2
C1C(CC(C=1)=O)O,,,5,1,2,0,2
7264_0,,,,2,1,1,2
C(C1(C=CC(C1)=O)O)(O)=O,,,5,1,2,0,2
7266_0,,,,2,1,1,2
C1(C2(CC(C(O)=O)(C1CO2)O)O)=O,,,5,1,4,0,4
7266_1,,,,2,1,1,2
7268_0,,,,2,1,1,2
C1(C2C(C(C(O2)O)(C1O)O)O)=O,,,5,1,4,0,4
7268_1,,,,2,1,1,2
7270_0,,,,2,1,1,2
C1(C2CC(C(O2)O)(C1O)O)=O,,,5,1,4,0,4
7270_1,,,,2,1,1,2
7272_0,,,,2,1,1,2
C1(C2C(C(C(O2)O)(C1)O)O)=O,,,5,1,3,0,3
7274_0,,,,2,1,1,2
C1(C2CC(C(O2)O)(C1)O)=O,,,5,1,3,0,3
7276_0,,,,2,1,1,2
C1(C2(CC(C(C2CO1)=O)=O)O)=O,,,5,1,2,0,2
7278_0,,,,2,1,1,2
C1(C2(C(C(C(C2O)=O)O1)O)O)=O,,,5,1,4,0,4
7278_1,,,,2,1,1,2
7280_0,,,,2,1,1,2
C1(C2(CC(C(C2O)=O)O1)O)=O,,,5,1,4,0,4
7280_1,,,,2,1,1,2
7282_0,,,,2,1,1,2
C1(C2(C(C(C(C2)=O)O1)O)O)=O,,,5,1,3,0,3
7284_0,,,,2,1,1,2
C1(C2(CC(C(C2)=O)O1)O)=O,,,5,1,3,0,3
7286_0,,,,2,1,1,2
C1(C2C(C(C(C2O)=O)O1)O)=O,,,5,1,5,0,5
7286_1,,,,2,1,1,2
7288_0,,,,2,1,1,2
C(C1C(C(C(C)O)C(C1C)O)O)=O,,,5,1,1,0,1
7290_0,,,,2,1,1,2
C(C1C(C(CO)C(CC1C)O)O)=O,,,5,1,1,0,1
7292_0,,,,2,1,1,2
C(C1C(C(CO)C(C)(C1C)O)O)=O,,,5,1,1,0,1
7294_0,,,,2,1,1,2
C(C1C(C(C=O)C(C)C1O)O)(O)=O,,,5,1,1,0,1
7296_0,,,,2,1,1,2
C(C1C(C(C(C(C1O)=O)O)O)C)=O,,,5,1,1,0,1
7298_0,,,,2,1,1,2
C(C1C(C)C(C(C1(C=O)O)O)O)=O,,,5,1,1,0,1
7300_0,,,,2,1,1,2
C(C1C(C)C(C(C1O)=O)(CO)O)=O,,,5,1,1,0,1
7302_0,,,,2,1,1,2
C(C1C(C)C(C=O)C(C)(C1O)O)=O,,,5,1,2,0,2
7304_0,,,,2,1,1,2
C(C1C(CC(C)CC1(C=O)O)O)=O,,,5,1,2,0,2
7304_1,,,,2,1,1,2
7306_0,,,,2,1,1,2
C(C1C(CC(C=O)(CC1C)O)O)=O,,,5,1,1,0,1
7308_0,,,,2,1,1,2
C(C1C(C(CC1C)(CC=O)O)O)=O,,,5,1,1,0,1
7310_0,,,,2,1,1,2
C(C1C(C)CC(CC(C1O)=O)O)=O,,,5,1,2,0,2
7312_0,,,,2,1,1,2
C(CC(C)C1C(CC(C1O)=O)O)=O,,,5,1,2,0,2
7313_0,,,,2,1,1,2
7315_0,,,,2,1,1,2
C(C1C(CC(C)CC(C1O)=O)O)=O,,,5,1,2,0,2
7315_1,,,,2,1,1,2
7317_0,,,,2,1,1,2
C(C1C(C)CC(C(CC1O)O)=O)=O,,,5,1,1,0,1
7319_0,,,,2,1,1,2
C(CC(C)C1C(C(CC1O)O)=O)=O,,,5,1,2,0,2
7321_0,,,,2,1,1,2
C(C1C(CC(C)C1(C(C)=O)O)O)=O,,,5,1,2,0,2
7321_1,,,,2,1,1,2
7323_0,,,,2,1,1,2
C1(C(C(C)CC(C1)O)(CC=O)O)=O,,,5,1,1,0,1
7325_0,,,,2,1,1,2
C(C1C(CC(C(C)=O)(C1C)O)O)=O,,,5,1,1,0,1
7327_0,,,,2,1,1,2
C1(CC(CC1(C(C)CC=O)O)O)=O,,,5,1,2,0,2
7329_0,,,,2,1,1,2
C1(C(CC(C1)O)(C[CH]C(O)=O)O)=O,,,5,1,2,0,2
7331_0,,,,2,1,1,2
C1(CC(CC1(CCC(O)=O)O)O)=O,,,5,1,2,0,2
7333_0,,,,2,1,1,2
C(C(C1C(C(C)CC1O)O)=O)=O,,,5,1,2,0,2
7333_1,,,,2,1,1,2
7335_0,,,,2,1,1,2
C(C1C(C)C(CC1(C=O)O)O)=O,,,5,1,1,0,1
7337_0,,,,2,1,1,2
C(C1C(C(CC(C1O)=O)O)C)=O,,,5,1,1,0,1
7339_0,,,,2,1,1,2
C(C1C(C)C(C(C1O)=O)CO)=O,,,5,1,1,0,1
7341_0,,,,2,1,1,2
C(C(C1C(CC(C)CC1O)O)=O)=O,,,5,1,2,0,2
7341_1,,,,2,1,1,2
7343_0,,,,2,1,1,2
C(C1C(C)CC(CC1(C=O)O)O)=O,,,5,1,1,0,1
7344_0,,,,2,1,1,2
7346_0,,,,2,1,1,2
C(C(C1C(CC(C)C1(C)O)O)=O)=O,,,5,1,2,0,2
7346_1,,,,2,1,1,2
7348_0,,,,2,1,1,2
C(C1C(C)C(C)(CC1(C=O)O)O)=O,,,5,1,1,0,1
7350_0,,,,2,1,1,2
C(C1C(C)C(C)(CC(C1O)=O)O)=O,,,5,1,1,0,1
7352_0,,,,2,1,1,2
C(C1C(C)C(C(C1O)=O)C(C)O)=O,,,5,1,1,0,1
7354_0,,,,2,1,1,2
C(C1C(C)C(C(O)=O)C(C1O)=O)=O,,,5,1,1,0,1
7356_0,,,,2,1,1,2
C(C1CC(CO)C(C1C=O)O)(O)=O,,,5,1,2,0,2
7358_0,,,,2,1,1,2
C(C1C(C(C)CC1O)O)=O,,,5,1,2,0,2
7358_1,,,,2,1,1,2
7360_0,,,,2,1,1,2
C(C1C(CC(C1C)O)O)=O,,,5,1,1,0,1
7362_0,,,,2,1,1,2
C(C1C(C(C)CC1(C(O)=O)O)O)=O,,,5,1,2,0,2
7362_1,,,,2,1,1,2
7364_0,,,,2,1,1,2
C(C(C1C(CC(C1C)O)O)=O)(O)=O,,,5,1,1,0,1
7366_0,,,,2,1,1,2
C(C1CC(C(C=O)C(C1)O)O)(O)=O,,,5,1,3,0,3
7366_1,,,,2,1,1,2
7368_0,,,,2,1,1,2
C(C1CC(CC(C1C=O)O)O)(O)=O,,,5,1,2,0,2
7370_0,,,,2,1,1,2
C(C1(C)C(C(C=O)C(C1)O)O)(O)=O,,,5,1,2,0,2
7370_1,,,,2,1,1,2
7372_0,,,,2,1,1,2
C(C1(C)C(CC(C1C=O)O)O)(O)=O,,,5,1,1,0,1
7374_0,,,,2,1,1,2
C(C(C1C(C(C)CC1O)O)=O)(O)=O,,,5,1,2,0,2
7374_1,,,,2,1,1,2
7376_0,,,,2,1,1,2
C(C1C(C)C(CC1(C(O)=O)O)O)=O,,,5,1,1,0,1
7378_0,,,,2,1,1,2
C(C1C(C(CC(C)CC1O)=O)=O)=O,,,5,1,2,0,2
7378_1,,,,2,1,1,2
7380_0,,,,2,1,1,2
C(CC1(C(CC(C)C1C=O)=O)O)=O,,,5,1,1,0,1
7382_0,,,,2,1,1,2
C(C1C(CC(C(CC1C)=O)=O)O)=O,,,5,1,1,0,1
7384_0,,,,2,1,1,2
C(CC(C)C1C(C(CC1O)=O)=O)=O,,,5,1,3,0,3
7386_0,,,,2,1,1,2
[CH](C(O)=O)CC1C(C(CC1O)=O)=O,,,5,1,3,0,3
7388_0,,,,2,1,1,2
C(CCC1C(C(CC1O)=O)=O)(O)=O,,,5,1,3,0,3
7390_0,,,,2,1,1,2
C(C1C(C(CC(CC1C)O)=O)=O)=O,,,5,1,1,0,1
7392_0,,,,2,1,1,2
C(C1C(C)C(C=O)C(C1(C)O)=O)=O,,,5,1,1,0,1
7393_0,,,,2,1,1,2
7394_0,,,,2,1,1,2
7395_0,,,,2,1,1,2
7397_0,,,,2,1,1,2
C(C1C(C)CC(C1(C(C)O)O)=O)=O,,,5,1,1,0,1
7399_0,,,,2,1,1,2
C1(C(C(CC(C)CC(C1)O)O)=O)=O,,,5,1,1,0,1
7401_0,,,,2,1,1,2
C(C1C(C)CC(C1(C(C)=O)O)O)=O,,,5,1,2,0,2
7403_0,,,,2,1,1,2
C(C1C(CC(C(C1(C)O)=O)O)C)=O,,,5,1,1,0,1
7405_0,,,,2,1,1,2
C1(C(CC(CC(C)C1(C)O)O)=O)=O,,,5,1,1,0,1
7407_0,,,,2,1,1,2
C(C1C(C)C(C(C1(C)O)=O)(C)O)=O,,,5,1,1,0,1
7409_0,,,,2,1,1,2
C1(CC(C)C(C=O)C1(C(O)=O)O)=O,,,5,1,1,0,1
7411_0,,,,2,1,1,2
C1(C(C(C)CC(C1O)O)O)=O,,,5,1,2,0,2
7411_1,,,,2,1,1,2
7413_0,,,,2,1,1,2
C1(C(C(CC(C)C1)O)O)=O,,,5,1,2,0,2
7413_1,,,,2,1,1,2
7415_0,,,,2,1,1,2
C(C1(CC(C)CC(C1O)=O)O)(O)=O,,,5,1,2,0,2
7415_1,,,,2,1,1,2
7417_0,,,,2,1,1,2
C(C1CC(C(CO)=O)C(C1)O)(O)=O,,,5,1,2,0,2
7419_0,,,,2,1,1,2
C(C1CCC(C(C(C1)O)O)=O)(O)=O,,,5,1,3,0,3
7419_1,,,,2,1,1,2
7421_0,,,,2,1,1,2
C(C1CCC(CO)(C1C=O)O)(O)=O,,,5,1,2,0,2
7423_0,,,,2,1,1,2
C(C1(C)CC(C(C(C1)=O)O)O)(O)=O,,,5,1,2,0,2
7423_1,,,,2,1,1,2
7425_0,,,,2,1,1,2
C(C(C)C1C(C(C(C1)=O)O)O)(O)=O,,,5,1,3,0,3
7425_1,,,,2,1,1,2
7427_0,,,,2,1,1,2
C1(C(C(C)CC(C1)O)O)=O,,,5,1,1,0,1
7429_0,,,,2,1,1,2
C(C1(CC(C)C(C(C1)=O)O)O)(O)=O,,,5,1,1,0,1
7431_0,,,,2,1,1,2
C(C1CC(C(CC(C1)O)=O)O)(O)=O,,,5,1,2,0,2
7433_0,,,,2,1,1,2
C(C1CC(C(C)(C1C=O)O)O)(O)=O,,,5,1,2,0,2
7435_0,,,,2,1,1,2
C(C1(C)CC(CC(C1O)=O)O)(O)=O,,,5,1,1,0,1
7437_0,,,,2,1,1,2
C(C(C)C1C(CC(C1O)=O)O)(O)=O,,,5,1,2,0,2
7439_0,,,,2,1,1,2
C(C1C(C(C(O)=O)(CC1C)O)O)=O,,,5,1,1,0,1
7441_0,,,,2,1,1,2
C(C1C(CC(CC(C)C1)O)=O)(O)=O,,,5,1,1,0,1
7443_0,,,,2,1,1,2
C(C1CC(C)C(C=O)C1(C)O)(O)=O,,,5,1,1,0,1
7445_0,,,,2,1,1,2
C(C1(C(CC(CC1C)O)=O)C)(O)=O,,,5,1,1,0,1
7447_0,,,,2,1,1,2
C(C1C(C)CC=CC1O)=O,,,5,1,1,0,1
7449_0,,,,2,1,1,2
C1CC(C)C(C(C(O)=O)=O)C(C=1)O,,,5,1,1,0,1
7451_0,,,,2,1,1,2
C(C1CCC=CC(C1C=O)O)(O)=O,,,5,1,2,0,2
7453_0,,,,2,1,1,2
C(C1(C)C(C=O)C(C=CC1)O)(O)=O,,,5,1,1,0,1
7455_0,,,,2,1,1,2
C(C1(C=CCC(C)C1C=O)O)(O)=O,,,5,1,1,0,1
7457_0,,,,2,1,1,2
C(C1C(C)CC(C(O)=O)=CC1O)=O,,,5,1,1,0,1
7459_0,,,,2,1,1,2
C(C1C(C(C(C1C)O)O)O)=O,,,5,1,1,0,1
7461_0,,,,2,1,1,2
C(C1C(C)CC2CC1(C(O2)=O)O)=O,,,5,1,1,0,1
7463_0,,,,2,1,1,2
C1(C(C2C(CC(C)CC2O)O1)=O)=O,,,5,1,2,0,2
7463_1,,,,2,1,1,2
7465_0,,,,2,1,1,2
C(C1C(C)C2(C)CC1(C(O2)=O)O)=O,,,5,1,1,0,1
7467_0,,,,2,1,1,2
C1(C(C2C(CC(C)C2(C)O1)O)=O)=O,,,5,1,2,0,2
7467_1,,,,2,1,1,2
7469_0,,,,2,1,1,2
C(C1C(C)C([CH]C(O)=O)CC1O)=O,,,5,1,1,0,1
7471_0,,,,2,1,1,2
C(C1C(CC(C)C1[CH]C(O)=O)O)=O,,,5,1,1,0,1
7473_0,,,,2,1,1,2
C(C1C(CC[C](C(O)=O)C1C)O)=O,,,5,1,1,0,1
7475_0,,,,2,1,1,2
C(C1C(CC([C](C(O)=O)C1)C)O)=O,,,5,1,1,0,1
7477_0,,,,2,1,1,2
C(C1C(CC(C1C)CC(O)=O)O)=O,,,5,1,1,0,1
7479_0,,,,2,1,1,2
C(C1C(C(C)CC1O)CC(O)=O)=O,,,5,1,1,0,1
7481_0,,,,2,1,1,2
C(C1CCC(C(C=O)C1C)O)(O)=O,,,5,1,1,0,1
7483_0,,,,2,1,1,2
C(C1CC(C=O)C(CC1C)O)(O)=O,,,5,1,1,0,1
7485_0,,,,2,1,1,2
C(C1C(C(CC1C)O)O)=O,,,5,1,1,0,1
7487_0,,,,2,1,1,2
C(C1C(CC(CC1C)O)O)=O,,,5,1,2,0,2
7489_0,,,,2,1,1,2
C(C1C(CC(C)CC1O)O)=O,,,5,1,2,0,2
7489_1,,,,2,1,1,2
7491_0,,,,2,1,1,2
C(C1C(CC(C)(C1C)O)O)=O,,,5,1,2,0,2
7493_0,,,,2,1,1,2
C(C1C(CC(C)C1(C)O)O)=O,,,5,1,2,0,2
7493_1,,,,2,1,1,2
7495_0,,,,2,1,1,2
C(C1C(C)C(C(C1O)=O)O)=O,,,5,1,2,0,2
7497_0,,,,2,1,1,2
C(C1C(C)CC(C1O)=O)=O,,,5,1,2,0,2
7499_0,,,,2,1,1,2
C(C1CC(C=C)C(C1C=O)O)(O)=O,,,5,1,2,0,2
7501_0,,,,2,1,1,2
C(C(C1C(C(CC1C)O)O)=O)(O)=O,,,5,1,1,0,1
7503_0,,,,2,1,1,2
C1(C(C(C(C(O)=O)=O)C(C)C1)O)=O,,,5,1,1,0,1
7505_0,,,,2,1,1,2
C(C1CC(C(C1C=O)O)O)(O)=O,,,5,1,2,0,2
7507_0,,,,2,1,1,2
C(C1CCC(C(C1C=O)O)O)(O)=O,,,5,1,2,0,2
7509_0,,,,2,1,1,2
C(C1CC(C)(C(C1C=O)O)O)(O)=O,,,5,1,2,0,2
7511_0,,,,2,1,1,2
C(C1CCC(C1C=O)O)(O)=O,,,5,1,2,0,2
7513_0,,,,2,1,1,2
C(C1CC(C=O)C(C1)O)(O)=O,,,5,1,2,0,2
7515_0,,,,2,1,1,2
C(C1CCC(C=O)(C1C=O)O)(O)=O,,,5,1,2,0,2
7517_0,,,,2,1,1,2
C1(C(C(C=O)C(C(O)=O)CC1)O)=O,,,5,1,2,0,2
7519_0,,,,2,1,1,2
C(C1CC(C(C=O)=O)C(C1)O)(O)=O,,,5,1,2,0,2
7521_0,,,,2,1,1,2
C(C1(C)CC(C(C1C=O)O)O)(O)=O,,,5,1,1,0,1
7523_0,,,,2,1,1,2
C1(C(C(C=O)C(C(O)=O)(C)C1)O)=O,,,5,1,1,0,1
7525_0,,,,2,1,1,2
C1(C2CCC(C2C(C(O1)=O)=O)O)=O,,,5,1,2,0,2
7527_0,,,,2,1,1,2
C1(C2CC(C=O)C(C(O1)=O)(C2)O)=O,,,5,1,2,0,2
7529_0,,,,2,1,1,2
C1(C(C(C(CC1O)O)O)O)=O,,,5,1,2,0,2
7529_1,,,,2,1,1,2
7531_0,,,,2,1,1,2
C1(C(CC(C(C1)O)O)O)=O,,,5,1,1,0,1
7532_0,,,,2,2,1,3
7532_1,,,,2,2,1,3
7533_0,,,,2,2,1,3
7533_1,,,,2,2,1,3
7534_0,,,,2,2,1,3
7534_1,,,,2,2,1,3
7536_0,,,,2,2,1,3
C(CC1(C(C(CC1O)O)O)O)=O,,,5,1,1,0,1
7538_0,,,,2,2,1,3
C(C(C1(C(C(CC1O)O)O)O)O)=O,,,5,1,2,0,2
7538_1,,,,2,2,1,3
7539_0,,,,2,2,1,3
7539_1,,,,2,2,1,3
7540_0,,,,2,2,1,3
7542_0,,,,2,2,1,3
C(C1(CC(C(C1)O)(CC=O)O)O)=O,,,5,1,1,0,1
7543_0,,,,2,2,1,3
7543_1,,,,2,2,1,3
7544_0,,,,2,2,1,3
7544_1,,,,2,2,1,3
7545_0,,,,2,2,1,3
7545_1,,,,2,2,1,3
7546_0,,,,2,2,1,3
7547_0,,,,2,2,1,3
7547_1,,,,2,2,1,3
7548_0,,,,2,2,1,3
7548_1,,,,2,2,1,3
7549_0,,,,2,2,1,3
7549_1,,,,2,2,1,3
7551_0,,,,2,2,1,3
C(C)(C(C)C1(CC(CC1O)O)O)=O,,,5,1,1,0,1
7553_0,,,,2,2,1,3
C(CC1(CC(CC1O)O)O)(CC)=O,,,5,1,1,0,1
7555_0,,,,2,2,1,3
C(C(C=O)C1(CC(CC1O)O)O)=O,,,5,1,2,0,2
7555_1,,,,2,2,1,3
7557_0,,,,2,2,1,3
C(CC1(CC(CC1O)O)O)=O,,,5,1,1,0,1
7559_0,,,,2,2,1,3
C(C(CC1(CC(CC1O)O)O)=O)=O,,,5,1,1,0,1
7561_0,,,,2,2,1,3
C(C(CO)C1(CC(CC1O)O)O)=O,,,5,1,2,0,2
7561_1,,,,2,2,1,3
7563_0,,,,2,2,1,3
C(CO)(CC1(C(CC(C1)O)O)O)=O,,,5,1,1,0,1
7565_0,,,,2,2,1,3
C(C)(C(C1(C(CC(C1)O)O)O)O)=O,,,5,1,2,0,2
7565_1,,,,2,2,1,3
7567_0,,,,2,2,1,3
C(C(C=C)C1(CC(CC1O)O)O)=O,,,5,1,1,0,1
7569_0,,,,2,2,1,3
C(C(C1(C(CC(C1)O)O)O)O)=O,,,5,1,2,0,2
7569_1,,,,2,2,1,3
7571_0,,,,2,2,1,3
C1(C(CC(C1[C](C(O)=O)O)O)O)=O,,,5,1,2,0,2
7571_1,,,,2,2,1,3
7573_0,,,,2,2,1,3
C1(C(CC(C1C(C)(CC)O)O)O)=O,,,5,1,2,0,2
7573_1,,,,2,2,1,3
7575_0,,,,2,2,1,3
C(CC(C1C(C(CC1O)O)=O)O)=O,,,5,1,2,0,2
7575_1,,,,2,2,1,3
7577_0,,,,2,2,1,3
C1(C(C(CC1O)O)C(C=C)O)=O,,,5,1,2,0,2
7577_1,,,,2,2,1,3
7579_0,,,,2,2,1,3
C1(C(CC(C1C(C(O)O)O)O)O)=O,,,5,1,2,0,2
7579_1,,,,2,2,1,3
7580_0,,,,2,2,1,3
7580_1,,,,2,2,1,3
7581_0,,,,2,2,1,3
7581_1,,,,2,2,1,3
7582_0,,,,2,2,1,3
7582_1,,,,2,2,1,3
7583_0,,,,2,2,1,3
7583_1,,,,2,2,1,3
7584_0,,,,2,2,1,3
7584_1,,,,2,2,1,3
7585_0,,,,2,2,1,3
7585_1,,,,2,2,1,3
7586_0,,,,2,2,1,3
7586_1,,,,2,2,1,3
7587_0,,,,2,2,1,3
7587_1,,,,2,2,1,3
7588_0,,,,2,2,1,3
7588_1,,,,2,2,1,3
7589_0,,,,2,2,1,3
7589_1,,,,2,2,1,3
7590_0,,,,2,2,1,3
7590_1,,,,2,2,1,3
7591_0,,,,2,2,1,3
7591_1,,,,2,2,1,3
7592_0,,,,2,2,1,3
7592_1,,,,2,2,1,3
7593_0,,,,2,2,1,3
7593_1,,,,2,2,1,3
7595_0,,,,2,2,1,3
C1(C(CC(C1)O)(C(C(C)=O)C)O)=O,,,5,1,1,0,1
7597_0,,,,2,2,1,3
C1(C(CC(C1)O)(CC(CC)=O)O)=O,,,5,1,1,0,1
7599_0,,,,2,2,1,3
C(C(C=O)C1(C(CC(C1)O)=O)O)=O,,,5,1,2,0,2
7599_1,,,,2,2,1,3
7600_0,,,,2,2,1,3
7601_0,,,,2,2,1,3
7602_0,,,,2,2,1,3
7602_1,,,,2,2,1,3
7603_0,,,,2,2,1,3
7604_0,,,,2,2,1,3
7604_1,,,,2,2,1,3
7605_0,,,,2,2,1,3
7606_0,,,,2,2,1,3
7606_1,,,,2,2,1,3
7608_0,,,,2,2,1,3
[C](C(O)=O)(C1C(C(CC1O)=O)=O)O,,,5,1,2,0,2
7608_1,,,,2,2,1,3
7610_0,,,,2,2,1,3
C1(C(CC(C1C(C)(CC)O)O)=O)=O,,,5,1,2,0,2
7610_1,,,,2,2,1,3
7612_0,,,,2,2,1,3
C(CC(C1C(C(CC1O)=O)=O)O)=O,,,5,1,2,0,2
7612_1,,,,2,2,1,3
7614_0,,,,2,2,1,3
C(C(C=C)(C1C(C(CC1O)=O)=O)O)=O,,,5,1,2,0,2
7614_1,,,,2,2,1,3
7616_0,,,,2,2,1,3
C=CC(C(C1C(C(CC1O)=O)=O)O)=O,,,5,1,2,0,2
7616_1,,,,2,2,1,3
7618_0,,,,2,2,1,3
C=CC(C1C(C(CC1O)=O)=O)O,,,5,1,2,0,2
7618_1,,,,2,2,1,3
7620_0,,,,2,2,1,3
C1(C(CC(C1C(C(O)O)O)O)=O)=O,,,5,1,2,0,2
7620_1,,,,2,2,1,3
7621_0,,,,2,2,1,3
7621_1,,,,2,2,1,3
7622_0,,,,2,2,1,3
7622_1,,,,2,2,1,3
7623_0,,,,2,2,1,3
7623_1,,,,2,2,1,3
7624_0,,,,2,2,1,3
7624_1,,,,2,2,1,3
7625_0,,,,2,2,1,3
7625_1,,,,2,2,1,3
7626_0,,,,2,2,1,3
7626_1,,,,2,2,1,3
7627_0,,,,2,2,1,3
7627_1,,,,2,2,1,3
7628_0,,,,2,2,1,3
7628_1,,,,2,2,1,3
7629_0,,,,2,2,1,3
7629_1,,,,2,2,1,3
7630_0,,,,2,2,1,3
7630_1,,,,2,2,1,3
7631_0,,,,2,2,1,3
7631_1,,,,2,2,1,3
7632_0,,,,2,2,1,3
7632_1,,,,2,2,1,3
7633_0,,,,2,2,1,3
7633_1,,,,2,2,1,3
7634_0,,,,2,2,1,3
7634_1,,,,2,2,1,3
7635_0,,,,2,2,1,3
7635_1,,,,2,2,1,3
7636_0,,,,2,2,1,3
7636_1,,,,2,2,1,3
7637_0,,,,2,2,1,3
7637_1,,,,2,2,1,3
7638_0,,,,2,2,1,3
7638_1,,,,2,2,1,3
7639_0,,,,2,2,1,3
7639_1,,,,2,2,1,3
7640_0,,,,2,2,1,3
7640_1,,,,2,2,1,3
7641_0,,,,2,2,1,3
7641_1,,,,2,2,1,3
7642_0,,,,2,2,1,3
7642_1,,,,2,2,1,3
7644_0,,,,2,2,1,3
C(C(C)(C(CO)C(CC=O)O)O)=O,,,5,1,1,0,1
7645_0,,,,2,2,1,3
7646_0,,,,2,2,1,3
7646_1,,,,2,2,1,3
7648_0,,,,2,2,1,3
C(CC(CC(C(CCO)=O)O)O)=O,,,5,1,2,0,2
7650_0,,,,2,2,1,3
C(CC(C(CO)C(C(C)=O)O)O)=O,,,5,1,1,0,1
7651_0,,,,2,2,1,3
7652_0,,,,2,2,1,3
7653_0,,,,2,2,1,3
7654_0,,,,2,2,1,3
7655_0,,,,2,2,1,3
7655_1,,,,2,2,1,3
7657_0,,,,2,2,1,3
C(CC(C(C(CO)C(C)O)=O)O)=O,,,5,1,5,0,5
7657_1,,,,2,2,1,3
7658_0,,,,2,2,1,3
7658_1,,,,2,2,1,3
7660_0,,,,2,2,1,3
C(CC(C(C(C(O)=O)CO)=O)O)=O,,,5,1,5,0,5
7660_1,,,,2,2,1,3
7661_0,,,,2,2,1,3
7663_0,,,,2,2,1,3
C(CC(C(CCO)(CC=O)O)O)=O,,,5,1,2,0,2
7664_0,,,,2,2,1,3
7664_1,,,,2,2,1,3
7665_0,,,,2,2,1,3
7665_1,,,,2,2,1,3
7666_0,,,,2,2,1,3
7666_1,,,,2,2,1,3
7667_0,,,,2,2,1,3
7667_1,,,,2,2,1,3
7668_0,,,,2,2,1,3
7668_1,,,,2,2,1,3
7670_0,,,,2,2,1,3
C(CC(C(C(CO)CO)=O)O)=O,,,5,1,3,0,3
7670_1,,,,2,2,1,3
7672_0,,,,2,2,1,3
C(C(CCO)(CC(CC=O)O)O)=O,,,5,1,1,0,1
7673_0,,,,2,2,1,3
7674_0,,,,2,2,1,3
7674_1,,,,2,2,1,3
7675_0,,,,2,2,1,3
7675_1,,,,2,2,1,3
7676_0,,,,2,2,1,3
7676_1,,,,2,2,1,3
7678_0,,,,2,2,1,3
C(C(C(C=O)O)O)(C(CO)CO)=O,,,5,1,4,0,4
7678_1,,,,2,2,1,3
7680_0,,,,2,2,1,3
C(C(C(CO)C(C)O)(CC=O)O)=O,,,5,1,1,0,1
7681_0,,,,2,2,1,3
7683_0,,,,2,2,1,3
C(C(CO)C(C=O)(CC=O)O)(O)=O,,,5,1,3,0,3
7684_0,,,,2,2,1,3
7686_0,,,,2,2,1,3
C(C(C(CO)CO)(CC=O)O)=O,,,5,1,1,0,1
7688_0,,,,2,2,1,3
C(C(C(CO)CO)(C(C=O)O)O)=O,,,5,1,2,0,2
7688_1,,,,2,2,1,3
7689_0,,,,2,2,1,3
7690_0,,,,2,2,1,3
7690_1,,,,2,2,1,3
7691_0,,,,2,2,1,3
7691_1,,,,2,2,1,3
7692_0,,,,2,2,1,3
7692_1,,,,2,2,1,3
7694_0,,,,2,2,1,3
C(CC(C(CO)C(CCO)O)O)=O,,,5,1,1,0,1
7696_0,,,,2,2,1,3
C(C(C(CCO)O)O)(C(CO)O)=O,,,5,1,4,0,4
7696_1,,,,2,2,1,3
7698_0,,,,2,2,1,3
C(CC(CO)(CC(CCO)O)O)=O,,,5,1,1,0,1
7700_0,,,,2,2,1,3
C(CO)(C(C(C)O)C(CCO)O)=O,,,5,1,5,0,5
7700_1,,,,2,2,1,3
7702_0,,,,2,2,1,3
C(C(C(CO)=O)C(CCO)O)(O)=O,,,5,1,5,0,5
7702_1,,,,2,2,1,3
7704_0,,,,2,2,1,3
C(CO)(C(CO)C(CCO)O)=O,,,5,1,5,0,5
7704_1,,,,2,2,1,3
7706_0,,,,2,2,1,3
C(C(C(C)O)O)(CC(CCO)O)=O,,,5,1,3,0,3
7706_1,,,,2,2,1,3
7708_0,,,,2,2,1,3
C(C(C(CC(CCO)O)=O)O)(O)=O,,,5,1,3,0,3
7708_1,,,,2,2,1,3
7710_0,,,,2,2,1,3
C(C(CO)O)(CC(CCO)O)=O,,,5,1,3,0,3
7710_1,,,,2,2,1,3
7712_0,,,,2,2,1,3
C(CC(C)(C(C(CCO)O)O)O)=O,,,5,1,1,0,1
7714_0,,,,2,2,1,3
C(C(C(CCO)O)O)(CC(C)O)=O,,,5,1,3,0,3
7716_0,,,,2,2,1,3
C(CC(C(C(CCO)O)O)=O)(O)=O,,,5,1,3,0,3
7718_0,,,,2,2,1,3
C(C(C(CCO)O)O)(CCO)=O,,,5,1,3,0,3
7720_0,,,,2,2,1,3
C(CC(C(C=C)C(CCO)O)O)=O,,,5,1,1,0,1
7722_0,,,,2,2,1,3
C(CC(C(C(CCO)O)O)O)=O,,,5,1,1,0,1
7724_0,,,,2,2,1,3
C(C(C(C(C(CCO)O)O)O)O)=O,,,5,1,2,0,2
7724_1,,,,2,2,1,3
7726_0,,,,2,2,1,3
C(C)(C(C)C(CC(CCO)O)O)=O,,,5,1,1,0,1
7728_0,,,,2,2,1,3
C(CC(CC(CCO)O)O)(CC)=O,,,5,1,1,0,1
7730_0,,,,2,2,1,3
C(C(C=O)C(CC(CCO)O)O)=O,,,5,1,2,0,2
7730_1,,,,2,2,1,3
7732_0,,,,2,2,1,3
C(CC(CC(CCO)O)O)=O,,,5,1,1,0,1
7734_0,,,,2,2,1,3
C(C(CC(CC(CCO)O)O)=O)=O,,,5,1,1,0,1
7736_0,,,,2,2,1,3
C(C(CO)C(CC(CCO)O)O)=O,,,5,1,2,0,2
7736_1,,,,2,2,1,3
7738_0,,,,2,2,1,3
C(CO)(CC(CC(CCO)O)O)=O,,,5,1,1,0,1
7740_0,,,,2,2,1,3
C(C)(C(C(CC(CCO)O)O)O)=O,,,5,1,2,0,2
7740_1,,,,2,2,1,3
7742_0,,,,2,2,1,3
C(C(C=C)C(CC(CCO)O)O)=O,,,5,1,1,0,1
7744_0,,,,2,2,1,3
C(C(C(CC(CCO)O)O)O)=O,,,5,1,2,0,2
7744_1,,,,2,2,1,3
7746_0,,,,2,2,1,3
C(C([C](C(O)=O)O)C(CCO)O)=O,,,5,1,2,0,2
7746_1,,,,2,2,1,3
7748_0,,,,2,2,1,3
C(C(C(CCO)O)C(C)(CC)O)=O,,,5,1,2,0,2
7748_1,,,,2,2,1,3
7750_0,,,,2,2,1,3
C(C(C(CC=O)O)C(CCO)O)=O,,,5,1,2,0,2
7750_1,,,,2,2,1,3
7752_0,,,,2,2,1,3
C(C(C(CCO)O)C(C=C)O)=O,,,5,1,2,0,2
7752_1,,,,2,2,1,3
7754_0,,,,2,2,1,3
C(C(C(C(O)O)O)C(CCO)O)=O,,,5,1,2,0,2
7754_1,,,,2,2,1,3
7755_0,,,,2,2,1,3
7755_1,,,,2,2,1,3
7756_0,,,,2,2,1,3
7756_1,,,,2,2,1,3
7757_0,,,,2,2,1,3
7757_1,,,,2,2,1,3
7758_0,,,,2,2,1,3
7758_1,,,,2,2,1,3
7759_0,,,,2,2,1,3
7759_1,,,,2,2,1,3
7761_0,,,,2,2,1,3
C(C(C(CCO)O)C(CCO)O)=O,,,5,1,2,0,2
7761_1,,,,2,2,1,3
7763_0,,,,2,2,1,3
C(C(C(CCO)O)C(C=O)O)=O,,,5,1,4,0,4
7763_1,,,,2,2,1,3
7765_0,,,,2,2,1,3
C(C(C(CCO)O)C(C)(CO)O)=O,,,5,1,5,0,5
7765_1,,,,2,2,1,3
7767_0,,,,2,2,1,3
C(C(C(CCO)O)C(C=CC)O)=O,,,5,1,4,0,4
7767_1,,,,2,2,1,3
7769_0,,,,2,2,1,3
C(C(C(CC=C)O)C(CCO)O)=O,,,5,1,4,0,4
7769_1,,,,2,2,1,3
7771_0,,,,2,2,1,3
C(C(C(CO)O)C(CCO)O)=O,,,5,1,4,0,4
7771_1,,,,2,2,1,3
7773_0,,,,2,2,1,3
C(C(C(C(C)O)O)C(CCO)O)=O,,,5,1,4,0,4
7773_1,,,,2,2,1,3
7775_0,,,,2,2,1,3
C(C(C(CCO)O)C(C(O)=O)O)=O,,,5,1,4,0,4
7775_1,,,,2,2,1,3
7777_0,,,,2,2,1,3
C(C(CC(CCO)O)(CC=O)O)=O,,,5,1,1,0,1
7778_0,,,,2,2,1,3
7779_0,,,,2,2,1,3
7779_1,,,,2,2,1,3
7780_0,,,,2,2,1,3
7780_1,,,,2,2,1,3
7781_0,,,,2,2,1,3
7781_1,,,,2,2,1,3
7782_0,,,,2,2,1,3
7782_1,,,,2,2,1,3
7784_0,,,,2,2,1,3
C(C(CO)C(C(CC=O)O)O)=O,,,5,1,3,0,3
7786_0,,,,2,2,1,3
C(C(CO)C(C(C(C=O)O)O)O)=O,,,5,1,4,0,4
7786_1,,,,2,2,1,3
7788_0,,,,2,2,1,3
C(CC(C(CO)C(C=O)O)O)=O,,,5,1,1,0,1
7790_0,,,,2,2,1,3
C(C(C(C(CO)C(C=O)O)O)O)=O,,,5,1,3,0,3
7790_1,,,,2,2,1,3
7792_0,,,,2,2,1,3
C(CC(C(CO)C(C)(CO)O)O)=O,,,5,1,1,0,1
7794_0,,,,2,2,1,3
C(CC(C(CO)C(C=CC)O)O)=O,,,5,1,1,0,1
7796_0,,,,2,2,1,3
C(CC(C(CO)C(CC=C)O)O)=O,,,5,1,1,0,1
7798_0,,,,2,2,1,3
C(CC(C(CO)C(CO)O)O)=O,,,5,1,1,0,1
7800_0,,,,2,2,1,3
C(C(C(C(CO)C(CO)O)O)O)=O,,,5,1,2,0,2
7800_1,,,,2,2,1,3
7802_0,,,,2,2,1,3
C(CC(C(CO)C(C(C)O)O)O)=O,,,5,1,1,0,1
7804_0,,,,2,2,1,3
C(CC(C(CO)C(C(O)=O)O)O)=O,,,5,1,1,0,1
7806_0,,,,2,2,1,3
C(C(C)=O)(CC(C(CO)CO)O)=O,,,5,1,2,0,2
7808_0,,,,2,2,1,3
C(CC(C(CO)CO)O)(CCO)=O,,,5,1,1,0,1
7810_0,,,,2,2,1,3
C(C)(C(CO)C(C(CO)CO)O)=O,,,5,1,2,0,2
7810_1,,,,2,2,1,3
7812_0,,,,2,2,1,3
C(C)(C(C)C(C(CO)CO)O)=O,,,5,1,1,0,1
7814_0,,,,2,2,1,3
C(CC(C(CO)CO)O)(CC)=O,,,5,1,1,0,1
7816_0,,,,2,2,1,3
C(C(C)O)(CC(C(CO)CO)O)=O,,,5,1,1,0,1
7818_0,,,,2,2,1,3
C(C(C(C(CO)CO)O)O)(CC)=O,,,5,1,2,0,2
7818_1,,,,2,2,1,3
7820_0,,,,2,2,1,3
C(CO)(C(C)C(C(CO)CO)O)=O,,,5,1,1,0,1
7822_0,,,,2,2,1,3
C(C(C=O)C(C(CO)CO)O)=O,,,5,1,2,0,2
7822_1,,,,2,2,1,3
7824_0,,,,2,2,1,3
C(C(CCO)C(C(CO)CO)O)=O,,,5,1,1,0,1
7826_0,,,,2,2,1,3
C(CC(C(CO)CO)O)=O,,,5,1,1,0,1
7828_0,,,,2,2,1,3
C(C(C(C)O)C(C(CO)CO)O)=O,,,5,1,2,0,2
7828_1,,,,2,2,1,3
7830_0,,,,2,2,1,3
C(C(C=O)C(C(CO)CO)O)(O)=O,,,5,1,2,0,2
7830_1,,,,2,2,1,3
7832_0,,,,2,2,1,3
C(C(C(C(C(CO)CO)O)O)=O)=O,,,5,1,2,0,2
7832_1,,,,2,2,1,3
7834_0,,,,2,2,1,3
C(C(CC(C(CO)CO)O)=O)=O,,,5,1,1,0,1
7836_0,,,,2,2,1,3
C(C(CO)C(C(CO)CO)O)=O,,,5,1,2,0,2
7836_1,,,,2,2,1,3
7838_0,,,,2,2,1,3
C(CO)(C(C(C(CO)CO)O)O)=O,,,5,1,2,0,2
7838_1,,,,2,2,1,3
7840_0,,,,2,2,1,3
C(CO)(CC(C(CO)CO)O)=O,,,5,1,1,0,1
7842_0,,,,2,2,1,3
C(C)(C(C(C(CO)CO)O)O)=O,,,5,1,2,0,2
7842_1,,,,2,2,1,3
7844_0,,,,2,2,1,3
C(C(C=C)C(C(CO)CO)O)=O,,,5,1,1,0,1
7846_0,,,,2,2,1,3
C(C(C(C(CO)CO)O)O)=O,,,5,1,3,0,3
7846_1,,,,2,2,1,3
7848_0,,,,2,2,1,3
C(C(CC(C(CO)CO)O)=O)(O)=O,,,5,1,1,0,1
7849_0,,,,2,2,1,3
7849_1,,,,2,2,1,3
7851_0,,,,2,2,1,3
C(C(C(CO)CO)(CC=O)O)(O)=O,,,5,1,1,0,1
7852_0,,,,2,2,1,3
7852_1,,,,2,2,1,3
7854_0,,,,2,2,1,3
C(CC(C(CCO)=O)(CC=O)O)=O,,,5,1,2,0,2
7855_0,,,,2,2,1,3
7855_1,,,,2,2,1,3
7857_0,,,,2,2,1,3
C(C(C)(CC=O)O)(C(C=O)CO)=O,,,5,1,3,0,3
7857_1,,,,2,2,1,3
7858_0,,,,2,2,1,3
7858_1,,,,2,2,1,3
7860_0,,,,2,2,1,3
C(CC(C(C(C(C)=O)=O)CO)O)=O,,,5,1,5,0,5
7860_1,,,,2,2,1,3
7862_0,,,,2,2,1,3
C(CC(CC(C(CCO)=O)=O)O)=O,,,5,1,3,0,3
7864_0,,,,2,2,1,3
C(C(C(C(CCO)=O)=O)C(C)O)=O,,,5,1,3,0,3
7866_0,,,,2,2,1,3
C(C(C=O)C(C(CCO)=O)=O)(O)=O,,,5,1,3,0,3
7867_0,,,,2,2,1,3
7868_0,,,,2,2,1,3
7869_0,,,,2,2,1,3
7871_0,,,,2,2,1,3
C(C(C(C(CC(C)O)=O)=O)CO)=O,,,5,1,3,0,3
7873_0,,,,2,2,1,3
C(C(C(C(CC(O)=O)=O)=O)CO)=O,,,5,1,3,0,3
7875_0,,,,2,2,1,3
C(C(C(C(CCO)=O)=O)CO)=O,,,5,1,5,0,5
7876_0,,,,2,2,1,3
7876_1,,,,2,2,1,3
7878_0,,,,2,2,1,3
C(CC(C(C(CO)C(C)O)=O)=O)=O,,,5,1,4,0,4
7878_1,,,,2,2,1,3
7879_0,,,,2,2,1,3
7879_1,,,,2,2,1,3
7881_0,,,,2,2,1,3
C(C(C(C(CC=O)=O)=O)CO)(O)=O,,,5,1,4,0,4
7881_1,,,,2,2,1,3
7882_0,,,,2,2,1,3
7884_0,,,,2,2,1,3
C(C(CCO)(CC=O)O)(CC=O)=O,,,5,1,1,0,1
7885_0,,,,2,2,1,3
7886_0,,,,2,2,1,3
7886_1,,,,2,2,1,3
7887_0,,,,2,2,1,3
7887_1,,,,2,2,1,3
7888_0,,,,2,2,1,3
7888_1,,,,2,2,1,3
7889_0,,,,2,2,1,3
7889_1,,,,2,2,1,3
7890_0,,,,2,2,1,3
7890_1,,,,2,2,1,3
7892_0,,,,2,2,1,3
C(CC(C(C(CO)CO)=O)=O)=O,,,5,1,2,0,2
7892_1,,,,2,2,1,3
7893_0,,,,2,2,1,3
7893_1,,,,2,2,1,3
7895_0,,,,2,2,1,3
C(C(C(C)O)(CC=O)O)(CCO)=O,,,5,1,3,0,3
7896_0,,,,2,2,1,3
7896_1,,,,2,2,1,3
7898_0,,,,2,2,1,3
C(C(C(C)O)=O)(C(CO)C(C)O)=O,,,5,1,4,0,4
7898_1,,,,2,2,1,3
7900_0,,,,2,2,1,3
C(C(C(C(C(C)O)=O)=O)CO)(O)=O,,,5,1,4,0,4
7900_1,,,,2,2,1,3
7901_0,,,,2,2,1,3
7903_0,,,,2,2,1,3
C(C(CCO)(CC=O)O)(C(C)O)=O,,,5,1,1,0,1
7904_0,,,,2,2,1,3
7904_1,,,,2,2,1,3
7905_0,,,,2,2,1,3
7905_1,,,,2,2,1,3
7907_0,,,,2,2,1,3
C(C(C(C)O)=O)(C(CO)CO)=O,,,5,1,2,0,2
7907_1,,,,2,2,1,3
7908_0,,,,2,2,1,3
7908_1,,,,2,2,1,3
7910_0,,,,2,2,1,3
C(CCO)(C(C(O)=O)(CC=O)O)=O,,,5,1,3,0,3
7911_0,,,,2,2,1,3
7911_1,,,,2,2,1,3
7913_0,,,,2,2,1,3
C(C(C(C(CO)C(C)O)=O)=O)(O)=O,,,5,1,4,0,4
7913_1,,,,2,2,1,3
7915_0,,,,2,2,1,3
C(C(C(C(C(O)=O)=O)=O)CO)(O)=O,,,5,1,6,0,6
7915_1,,,,2,2,1,3
7916_0,,,,2,2,1,3
7918_0,,,,2,2,1,3
C(CC(C(C(O)=O)=O)(CCO)O)=O,,,5,1,1,0,1
7919_0,,,,2,2,1,3
7919_1,,,,2,2,1,3
7920_0,,,,2,2,1,3
7920_1,,,,2,2,1,3
7922_0,,,,2,2,1,3
C(C(C(C(CO)CO)=O)=O)(O)=O,,,5,1,4,0,4
7922_1,,,,2,2,1,3
7923_0,,,,2,2,1,3
7925_0,,,,2,2,1,3
C(CC(C(C(C(CO)=O)O)O)O)=O,,,5,1,3,0,3
7926_0,,,,2,2,1,3
7926_1,,,,2,2,1,3
7927_0,,,,2,2,1,3
7927_1,,,,2,2,1,3
7928_0,,,,2,2,1,3
7928_1,,,,2,2,1,3
7930_0,,,,2,2,1,3
C(CC(CO)(CC(C=O)O)O)=O,,,5,1,1,0,1
7932_0,,,,2,2,1,3
C(C(CC(CO)(C(C=O)O)O)O)=O,,,5,1,2,0,2
7932_1,,,,2,2,1,3
7934_0,,,,2,2,1,3
C(CC(C(CC(CO)=O)O)O)=O,,,5,1,2,0,2
7936_0,,,,2,2,1,3
C(C(C(C(CC(CO)=O)O)O)O)=O,,,5,1,3,0,3
7936_1,,,,2,2,1,3
7938_0,,,,2,2,1,3
C(C(C(C(CO)=O)C(C=C)O)O)=O,,,5,1,2,0,2
7938_1,,,,2,2,1,3
7940_0,,,,2,2,1,3
C(CO)(C(C(C)O)C(C=O)O)=O,,,5,1,5,0,5
7940_1,,,,2,2,1,3
7942_0,,,,2,2,1,3
C(C(C(CO)=O)C(C=O)O)(O)=O,,,5,1,6,0,6
7942_1,,,,2,2,1,3
7944_0,,,,2,2,1,3
C(CO)(C(CO)C(C=O)O)=O,,,5,1,5,0,5
7944_1,,,,2,2,1,3
7946_0,,,,2,2,1,3
C(C(C(C(CO)=O)C(C=O)O)O)=O,,,5,1,2,0,2
7946_1,,,,2,2,1,3
7948_0,,,,2,2,1,3
C(CO)(C(C(CO)O)C(C=O)O)=O,,,5,1,4,0,4
7948_1,,,,2,2,1,3
7950_0,,,,2,2,1,3
C(C(CC(C(C(C=C)O)O)=O)O)=O,,,5,1,2,0,2
7950_1,,,,2,2,1,3
7952_0,,,,2,2,1,3
C(CC(C=O)O)(C(C(C)O)O)=O,,,5,1,3,0,3
7952_1,,,,2,2,1,3
7954_0,,,,2,2,1,3
C(C(C(CC(C=O)O)=O)O)(O)=O,,,5,1,3,0,3
7954_1,,,,2,2,1,3
7956_0,,,,2,2,1,3
C(CC(C=O)O)(C(CO)O)=O,,,5,1,5,0,5
7956_1,,,,2,2,1,3
7958_0,,,,2,2,1,3
C(C(C(C(CC(C=O)O)=O)O)O)=O,,,5,1,6,0,6
7958_1,,,,2,2,1,3
7960_0,,,,2,2,1,3
C(CC(C=O)O)(C(C(CO)O)O)=O,,,5,1,4,0,4
7960_1,,,,2,2,1,3
7961_0,,,,2,2,1,3
7963_0,,,,2,2,1,3
C(C(C(C(C)(C(C=O)O)O)O)O)=O,,,5,1,5,0,5
7963_1,,,,2,2,1,3
7965_0,,,,2,2,1,3
C(CC(C(C(C(C)=O)O)O)O)=O,,,5,1,4,0,4
7967_0,,,,2,2,1,3
C(C(C(C(C(C(C)=O)O)O)O)O)=O,,,5,1,5,0,5
7967_1,,,,2,2,1,3
7969_0,,,,2,2,1,3
C(C(C(C(CC(C=C)O)=O)O)O)=O,,,5,1,1,0,1
7970_0,,,,2,2,1,3
7971_0,,,,2,2,1,3
7972_0,,,,2,2,1,3
7973_0,,,,2,2,1,3
7975_0,,,,2,2,1,3
C(C(C(C=O)O)O)(CC(CO)O)=O,,,5,1,6,0,6
7977_0,,,,2,2,1,3
C(CC(C(C=C)C(C=O)O)O)=O,,,5,1,1,0,1
7979_0,,,,2,2,1,3
C(C(C=C)C(C(C=C)C(C=O)O)O)=O,,,5,1,1,0,1
7981_0,,,,2,2,1,3
C(C(C(C(C=C)C(C=O)O)O)O)=O,,,5,1,2,0,2
7981_1,,,,2,2,1,3
7983_0,,,,2,2,1,3
C(C(C=C)C(C(CC=O)O)O)=O,,,5,1,2,0,2
7985_0,,,,2,2,1,3
C(C(C=C)C(C(C(C=O)C=C)O)O)=O,,,5,1,1,0,1
7987_0,,,,2,2,1,3
C(C(C=C)C(C(C(C=O)O)O)O)=O,,,5,1,3,0,3
7987_1,,,,2,2,1,3
7989_0,,,,2,2,1,3
C(C(C(C(C(C(C)=O)C)O)O)O)=O,,,5,1,1,0,1
7991_0,,,,2,2,1,3
C(CC(C(C(C=O)O)O)O)(CC)=O,,,5,1,1,0,1
7993_0,,,,2,2,1,3
C(C(C=O)C(C(C(C=O)O)O)O)=O,,,5,1,2,0,2
7993_1,,,,2,2,1,3
7995_0,,,,2,2,1,3
C(CC(C(C(C=O)O)O)O)=O,,,5,1,3,0,3
7997_0,,,,2,2,1,3
C(C(C(C(CC(C=O)=O)O)O)O)=O,,,5,1,3,0,3
7998_0,,,,2,2,1,3
7998_1,,,,2,2,1,3
7999_0,,,,2,2,1,3
8000_0,,,,2,2,1,3
8000_1,,,,2,2,1,3
8001_0,,,,2,2,1,3
8003_0,,,,2,2,1,3
C(C(C(C(C(C=O)O)O)O)O)=O,,,5,1,5,0,5
8003_1,,,,2,2,1,3
8005_0,,,,2,2,1,3
C(C(CC(CC(C(C)=O)=O)O)O)=O,,,5,1,3,0,3
8007_0,,,,2,2,1,3
C(CC(CC(C=O)O)O)(CCO)=O,,,5,1,1,0,1
8009_0,,,,2,2,1,3
C(C(CC(C(C(C)=O)CO)O)O)=O,,,5,1,2,0,2
8009_1,,,,2,2,1,3
8011_0,,,,2,2,1,3
C(C(CC(C(C(C)=O)C)O)O)=O,,,5,1,1,0,1
8013_0,,,,2,2,1,3
C(CC(CC(C=O)O)O)(CC)=O,,,5,1,1,0,1
8015_0,,,,2,2,1,3
C(C(C)O)(CC(CC(C=O)O)O)=O,,,5,1,1,0,1
8017_0,,,,2,2,1,3
C(C(C(CC(C=O)O)O)O)(CC)=O,,,5,1,2,0,2
8017_1,,,,2,2,1,3
8019_0,,,,2,2,1,3
C(C(CC(C(C(CO)=O)C)O)O)=O,,,5,1,1,0,1
8021_0,,,,2,2,1,3
C(C(C=O)C(CC(C=O)O)O)=O,,,5,1,2,0,2
8021_1,,,,2,2,1,3
8023_0,,,,2,2,1,3
C(C(C(CC(C=O)O)O)CCO)=O,,,5,1,1,0,1
8025_0,,,,2,2,1,3
C(CC(CC(C=O)O)O)=O,,,5,1,3,0,3
8027_0,,,,2,2,1,3
C(C(C(C)O)C(CC(C=O)O)O)=O,,,5,1,2,0,2
8027_1,,,,2,2,1,3
8029_0,,,,2,2,1,3
C(C(C=O)C(CC(C=O)O)O)(O)=O,,,5,1,2,0,2
8029_1,,,,2,2,1,3
8031_0,,,,2,2,1,3
C(C(CC(C(C(C=O)=O)O)O)O)=O,,,5,1,2,0,2
8031_1,,,,2,2,1,3
8033_0,,,,2,2,1,3
C(C(CC(CC(C=O)=O)O)O)=O,,,5,1,1,0,1
8035_0,,,,2,2,1,3
C(C(CO)C(CC(C=O)O)O)=O,,,5,1,2,0,2
8035_1,,,,2,2,1,3
8037_0,,,,2,2,1,3
C(C(CC(C(C(CO)=O)O)O)O)=O,,,5,1,2,0,2
8037_1,,,,2,2,1,3
8039_0,,,,2,2,1,3
C(C(CC(CC(CO)=O)O)O)=O,,,5,1,1,0,1
8041_0,,,,2,2,1,3
C(C(CC(C(C(C)=O)O)O)O)=O,,,5,1,2,0,2
8041_1,,,,2,2,1,3
8043_0,,,,2,2,1,3
C(C(C=C)C(CC(C=O)O)O)=O,,,5,1,1,0,1
8045_0,,,,2,2,1,3
C(C(C(CC(C=O)O)O)O)=O,,,5,1,7,0,7
8045_1,,,,2,2,1,3
8047_0,,,,2,2,1,3
C(C(CC(CC(C(O)=O)=O)O)O)=O,,,5,1,1,0,1
8049_0,,,,2,2,1,3
C(CC(C(CC(C(C)=O)=O)O)O)=O,,,5,1,1,0,1
8051_0,,,,2,2,1,3
C(CC(C(CC(CCO)=O)O)O)=O,,,5,1,1,0,1
8053_0,,,,2,2,1,3
C(CC(C(C(C(C)=O)CO)O)O)=O,,,5,1,2,0,2
8053_1,,,,2,2,1,3
8055_0,,,,2,2,1,3
C(CC(C(C(C(C)=O)C)O)O)=O,,,5,1,1,0,1
8057_0,,,,2,2,1,3
C(CC(C(CC(CC)=O)O)O)=O,,,5,1,1,0,1
8059_0,,,,2,2,1,3
C(CC(C(CC(C(C)O)=O)O)O)=O,,,5,1,1,0,1
8061_0,,,,2,2,1,3
C(CC(C(C(C(CC)=O)O)O)O)=O,,,5,1,2,0,2
8061_1,,,,2,2,1,3
8063_0,,,,2,2,1,3
C(CC(C(C(C(CO)=O)C)O)O)=O,,,5,1,1,0,1
8065_0,,,,2,2,1,3
C(C(C=O)C(C(CC=O)O)O)=O,,,5,1,2,0,2
8065_1,,,,2,2,1,3
8067_0,,,,2,2,1,3
C(C(CCO)C(C(CC=O)O)O)=O,,,5,1,1,0,1
8069_0,,,,2,2,1,3
C(CC(C(CC=O)O)O)=O,,,5,1,1,0,1
8071_0,,,,2,2,1,3
C(C(C(C(CC=O)O)O)C(C)O)=O,,,5,1,3,0,3
8071_1,,,,2,2,1,3
8073_0,,,,2,2,1,3
C(C(C=O)C(C(CC=O)O)O)(O)=O,,,5,1,3,0,3
8073_1,,,,2,2,1,3
8075_0,,,,2,2,1,3
C(CC(C(C(C(C=O)=O)O)O)O)=O,,,5,1,3,0,3
8075_1,,,,2,2,1,3
8077_0,,,,2,2,1,3
C(CC(C(CC(C=O)=O)O)O)=O,,,5,1,2,0,2
8078_0,,,,2,2,1,3
8078_1,,,,2,2,1,3
8079_0,,,,2,2,1,3
8079_1,,,,2,2,1,3
8080_0,,,,2,2,1,3
8081_0,,,,2,2,1,3
8081_1,,,,2,2,1,3
8082_0,,,,2,2,1,3
8083_0,,,,2,2,1,3
8083_1,,,,2,2,1,3
8085_0,,,,2,2,1,3
C(CC(C(CC(C(O)=O)=O)O)O)=O,,,5,1,2,0,2
8087_0,,,,2,2,1,3
C(C(C(C=O)C(C(C=O)=O)O)O)=O,,,5,1,2,0,2
8087_1,,,,2,2,1,3
8089_0,,,,2,2,1,3
C(C(C=O)(C(C=O)C(C=O)O)O)=O,,,5,1,2,0,2
8089_1,,,,2,2,1,3
8091_0,,,,2,2,1,3
C(C)(C(C)(C(C=O)C(C=O)O)O)=O,,,5,1,2,0,2
8091_1,,,,2,2,1,3
8093_0,,,,2,2,1,3
C(C([C](C(O)=O)O)C(C=O)O)=O,,,5,1,2,0,2
8093_1,,,,2,2,1,3
8095_0,,,,2,2,1,3
C(C(C(C)(CCO)O)C(C=O)O)=O,,,5,1,2,0,2
8095_1,,,,2,2,1,3
8097_0,,,,2,2,1,3
C(C(C(C)(CC)O)C(C=O)O)=O,,,5,1,2,0,2
8097_1,,,,2,2,1,3
8099_0,,,,2,2,1,3
C(C(C(C)(C(C)O)O)C(C=O)O)=O,,,5,1,2,0,2
8099_1,,,,2,2,1,3
8101_0,,,,2,2,1,3
C(C(C(CO)(CC)O)C(C=O)O)=O,,,5,1,2,0,2
8101_1,,,,2,2,1,3
8103_0,,,,2,2,1,3
C(CC(C(C=O)C(C=O)O)O)=O,,,5,1,3,0,3
8103_1,,,,2,2,1,3
8105_0,,,,2,2,1,3
C(C(C(C=O)C([CH]C(O)=O)O)O)=O,,,5,1,2,0,2
8105_1,,,,2,2,1,3
8107_0,,,,2,2,1,3
C(C(C=C)(C(C=O)C(C=O)O)O)=O,,,5,1,2,0,2
8107_1,,,,2,2,1,3
8109_0,,,,2,2,1,3
C(C(C(C=O)C(C(C=C)=O)O)O)=O,,,5,1,2,0,2
8109_1,,,,2,2,1,3
8111_0,,,,2,2,1,3
C(C(C(C=O)C(C=C)O)O)=O,,,5,1,2,0,2
8111_1,,,,2,2,1,3
8113_0,,,,2,2,1,3
C(C(C(C(CC)O)O)C(C=O)O)=O,,,5,1,2,0,2
8113_1,,,,2,2,1,3
8115_0,,,,2,2,1,3
C(C(C(CCCO)O)C(C=O)O)=O,,,5,1,2,0,2
8115_1,,,,2,2,1,3
8117_0,,,,2,2,1,3
C(C(C(C(O)O)O)C(C=O)O)=O,,,5,1,2,0,2
8117_1,,,,2,2,1,3
8118_0,,,,2,2,1,3
8118_1,,,,2,2,1,3
8119_0,,,,2,2,1,3
8119_1,,,,2,2,1,3
8120_0,,,,2,2,1,3
8120_1,,,,2,2,1,3
8121_0,,,,2,2,1,3
8121_1,,,,2,2,1,3
8122_0,,,,2,2,1,3
8122_1,,,,2,2,1,3
8123_0,,,,2,2,1,3
8123_1,,,,2,2,1,3
8124_0,,,,2,2,1,3
8124_1,,,,2,2,1,3
8125_0,,,,2,2,1,3
8125_1,,,,2,2,1,3
8126_0,,,,2,2,1,3
8126_1,,,,2,2,1,3
8127_0,,,,2,2,1,3
8127_1,,,,2,2,1,3
8129_0,,,,2,2,1,3
C(C(C(C=O)C(C=O)O)O)=O,,,5,1,4,0,4
8129_1,,,,2,2,1,3
8131_0,,,,2,2,1,3
C(C(C(C(C=O)C(C=O)O)O)O)=O,,,5,1,5,0,5
8131_1,,,,2,2,1,3
8133_0,,,,2,2,1,3
C(C(C(CO)(CO)O)C(C=O)O)=O,,,5,1,5,0,5
8133_1,,,,2,2,1,3
8135_0,,,,2,2,1,3
C(C(C(CO)(C)O)C(C=O)O)=O,,,5,1,5,0,5
8135_1,,,,2,2,1,3
8137_0,,,,2,2,1,3
C(C(C(C=O)C(C=CC)O)O)=O,,,5,1,5,0,5
8137_1,,,,2,2,1,3
8139_0,,,,2,2,1,3
C(C(C(CC=C)O)C(C=O)O)=O,,,5,1,5,0,5
8139_1,,,,2,2,1,3
8141_0,,,,2,2,1,3
C(C(C(C(CO)O)O)C(C=O)O)=O,,,5,1,5,0,5
8141_1,,,,2,2,1,3
8143_0,,,,2,2,1,3
C(C(C(CO)O)C(C=O)O)=O,,,5,1,6,0,6
8143_1,,,,2,2,1,3
8145_0,,,,2,2,1,3
C(C(C(C(C)O)O)C(C=O)O)=O,,,5,1,4,0,4
8145_1,,,,2,2,1,3
8147_0,,,,2,2,1,3
C(C(C(C=O)C(C=O)O)O)(O)=O,,,5,1,4,0,4
8147_1,,,,2,2,1,3
8148_0,,,,2,2,1,3
8148_1,,,,2,2,1,3
8150_0,,,,2,2,1,3
C(CC(C(C(C)O)C(C=O)O)O)=O,,,5,1,1,0,1
8151_0,,,,2,2,1,3
8152_0,,,,2,2,1,3
8153_0,,,,2,2,1,3
8154_0,,,,2,2,1,3
8156_0,,,,2,2,1,3
C(C(C(C(C=O)(CC=O)O)O)O)=O,,,5,1,2,0,2
8157_0,,,,2,2,1,3
8159_0,,,,2,2,1,3
C(C(CC(C=O)(CC=O)O)O)=O,,,5,1,1,0,1
8161_0,,,,2,2,1,3
C(C(CC(C=O)(C(C=O)O)O)O)=O,,,5,1,2,0,2
8161_1,,,,2,2,1,3
8162_0,,,,2,2,1,3
8163_0,,,,2,2,1,3
8163_1,,,,2,2,1,3
8164_0,,,,2,2,1,3
8165_0,,,,2,2,1,3
8165_1,,,,2,2,1,3
8167_0,,,,2,2,1,3
C(C(C(C(C=O)=O)C(C=C)O)O)=O,,,5,1,2,0,2
8167_1,,,,2,2,1,3
8168_0,,,,2,2,1,3
8168_1,,,,2,2,1,3
8169_0,,,,2,2,1,3
8169_1,,,,2,2,1,3
8170_0,,,,2,2,1,3
8170_1,,,,2,2,1,3
8172_0,,,,2,2,1,3
C(C(C(C(C=O)=O)C(C=O)O)O)=O,,,5,1,2,0,2
8172_1,,,,2,2,1,3
8174_0,,,,2,2,1,3
C(C(C(C(C=O)=O)C(CO)O)O)=O,,,5,1,4,0,4
8174_1,,,,2,2,1,3
8176_0,,,,2,2,1,3
C(C(CC(C=O)O)(CC=O)O)(O)=O,,,5,1,2,0,2
8177_0,,,,2,2,1,3
8178_0,,,,2,2,1,3
8178_1,,,,2,2,1,3
8179_0,,,,2,2,1,3
8179_1,,,,2,2,1,3
8180_0,,,,2,2,1,3
8180_1,,,,2,2,1,3
8182_0,,,,2,2,1,3
C(C(C(C(C(CO)=O)CO)O)O)=O,,,5,1,5,0,5
8182_1,,,,2,2,1,3
8184_0,,,,2,2,1,3
C(C(CO)O)(CC(C(C=O)O)O)=O,,,5,1,7,0,7
8184_1,,,,2,2,1,3
8186_0,,,,2,2,1,3
C(C(C(C(C=O)O)O)O)(CCO)=O,,,5,1,6,0,6
8188_0,,,,2,2,1,3
C(CC(C(C(C(C=O)O)O)O)O)=O,,,5,1,4,0,4
8190_0,,,,2,2,1,3
C(CC(CC(C(C=O)O)O)O)=O,,,5,1,2,0,2
8192_0,,,,2,2,1,3
C(C(C(CC(C(C=O)O)O)O)O)=O,,,5,1,3,0,3
8192_1,,,,2,2,1,3
8194_0,,,,2,2,1,3
C(CC(C(C(CC=O)O)O)O)=O,,,5,1,1,0,1
8195_0,,,,2,2,1,3
8195_1,,,,2,2,1,3
8197_0,,,,2,2,1,3
C(C(C(C(C=O)C(C=C)O)O)O)=O,,,5,1,2,0,2
8197_1,,,,2,2,1,3
8198_0,,,,2,2,1,3
8198_1,,,,2,2,1,3
8199_0,,,,2,2,1,3
8199_1,,,,2,2,1,3
8200_0,,,,2,2,1,3
8200_1,,,,2,2,1,3
8201_0,,,,2,2,1,3
8201_1,,,,2,2,1,3
8203_0,,,,2,2,1,3
C(C(C(C(C=O)O)O)C(CO)O)=O,,,5,1,5,0,5
8203_1,,,,2,2,1,3
8204_0,,,,2,2,1,3
8204_1,,,,2,2,1,3
8206_0,,,,2,2,1,3
C(CC(CC(C(C(O)=O)O)O)O)=O,,,5,1,1,0,1
8207_0,,,,2,2,1,3
8207_1,,,,2,2,1,3
8208_0,,,,2,2,1,3
8208_1,,,,2,2,1,3
8209_0,,,,2,2,1,3
8209_1,,,,2,2,1,3
8211_0,,,,2,2,1,3
C(CO)(C(CO)C(CO)(CO)O)=O,,,5,1,5,0,5
8211_1,,,,2,2,1,3
8213_0,,,,2,2,1,3
C(C(CO)O)(CC(CO)(CO)O)=O,,,5,1,3,0,3
8213_1,,,,2,2,1,3
8215_0,,,,2,2,1,3
C(C(C(CO)(CO)O)O)(CCO)=O,,,5,1,5,0,5
8217_0,,,,2,2,1,3
C(CC(C(C(CO)(CO)O)O)O)=O,,,5,1,1,0,1
8219_0,,,,2,2,1,3
C(CC(CC(CO)(CO)O)O)=O,,,5,1,2,0,2
8221_0,,,,2,2,1,3
C(C(C(CC(CO)(CO)O)O)O)=O,,,5,1,3,0,3
8221_1,,,,2,2,1,3
8223_0,,,,2,2,1,3
C(C(C(CO)(CO)O)C(C=C)O)=O,,,5,1,2,0,2
8223_1,,,,2,2,1,3
8224_0,,,,2,2,1,3
8224_1,,,,2,2,1,3
8225_0,,,,2,2,1,3
8225_1,,,,2,2,1,3
8226_0,,,,2,2,1,3
8226_1,,,,2,2,1,3
8227_0,,,,2,2,1,3
8227_1,,,,2,2,1,3
8229_0,,,,2,2,1,3
C(C(C(CO)O)C(CO)(CO)O)=O,,,5,1,5,0,5
8229_1,,,,2,2,1,3
8230_0,,,,2,2,1,3
8230_1,,,,2,2,1,3
8232_0,,,,2,2,1,3
C(C(C(CO)(C)O)O)(C(CO)O)=O,,,5,1,5,0,5
8232_1,,,,2,2,1,3
8234_0,,,,2,2,1,3
C(C(C(C=CC)O)O)(C(CO)O)=O,,,5,1,4,0,4
8234_1,,,,2,2,1,3
8236_0,,,,2,2,1,3
C(C(C(CC=C)O)O)(C(CO)O)=O,,,5,1,4,0,4
8236_1,,,,2,2,1,3
8238_0,,,,2,2,1,3
C(CC(CO)(C(C(CO)O)O)O)=O,,,5,1,3,0,3
8240_0,,,,2,2,1,3
C(C(C(CO)O)O)(C(C(C)O)O)=O,,,5,1,6,0,6
8240_1,,,,2,2,1,3
8242_0,,,,2,2,1,3
C(C(C(C(C(CO)O)O)=O)O)(O)=O,,,5,1,9,0,9
8242_1,,,,2,2,1,3
8244_0,,,,2,2,1,3
C(C(C(CO)O)O)(C(CO)O)=O,,,5,1,7,0,7
8244_1,,,,2,2,1,3
8246_0,,,,2,2,1,3
C(C(C(C(C)O)O)O)(C(CO)O)=O,,,5,1,4,0,4
8246_1,,,,2,2,1,3
8248_0,,,,2,2,1,3
C(CC(CO)(C(C(C)O)O)O)=O,,,5,1,2,0,2
8250_0,,,,2,2,1,3
C(C(C(CO)(C(C(C)O)O)O)O)=O,,,5,1,5,0,5
8250_1,,,,2,2,1,3
8252_0,,,,2,2,1,3
C(C(C(C=C)O)O)(C(C(C)O)O)=O,,,5,1,2,0,2
8252_1,,,,2,2,1,3
8254_0,,,,2,2,1,3
C(C(C(C)O)O)(C(C(C)O)O)=O,,,5,1,2,0,2
8254_1,,,,2,2,1,3
8256_0,,,,2,2,1,3
C(C(C(C(C(C)O)O)=O)O)(O)=O,,,5,1,5,0,5
8256_1,,,,2,2,1,3
8258_0,,,,2,2,1,3
C(C(C(C)O)O)(C(CO)O)=O,,,5,1,5,0,5
8258_1,,,,2,2,1,3
8259_0,,,,2,2,1,3
8259_1,,,,2,2,1,3
8260_0,,,,2,2,1,3
8260_1,,,,2,2,1,3
8262_0,,,,2,2,1,3
C(CC(CO)(C(C(O)=O)O)O)=O,,,5,1,3,0,3
8264_0,,,,2,2,1,3
C(C(C(CO)(C(C=O)O)O)O)(O)=O,,,5,1,11,0,11
8264_1,,,,2,2,1,3
8266_0,,,,2,2,1,3
C(C(C(C(C(C=C)O)O)=O)O)(O)=O,,,5,1,2,0,2
8266_1,,,,2,2,1,3
8267_0,,,,2,2,1,3
8267_1,,,,2,2,1,3
8269_0,,,,2,2,1,3
C(C(C(C(C(O)=O)O)=O)O)(O)=O,,,5,1,3,0,3
8269_1,,,,2,2,1,3
8270_0,,,,2,2,1,3
8270_1,,,,2,2,1,3
8271_0,,,,2,2,1,3
8271_1,,,,2,2,1,3
8272_0,,,,2,2,1,3
8272_1,,,,2,2,1,3
8273_0,,,,2,2,1,3
8273_1,,,,2,2,1,3
8274_0,,,,2,2,1,3
8275_0,,,,2,2,1,3
8275_1,,,,2,2,1,3
8277_0,,,,2,2,1,3
C(C)(C(C)C(CO)(C(CO)O)O)=O,,,5,1,1,0,1
8279_0,,,,2,2,1,3
C(CC(CO)(C(CO)O)O)(CC)=O,,,5,1,1,0,1
8281_0,,,,2,2,1,3
C(C(C=O)C(CO)(C(CO)O)O)=O,,,5,1,2,0,2
8281_1,,,,2,2,1,3
8283_0,,,,2,2,1,3
C(CC(CO)(C(CO)O)O)=O,,,5,1,3,0,3
8285_0,,,,2,2,1,3
C(C(CC(CO)(C(CO)O)O)=O)=O,,,5,1,3,0,3
8287_0,,,,2,2,1,3
C(C(CO)C(CO)(C(CO)O)O)=O,,,5,1,3,0,3
8287_1,,,,2,2,1,3
8289_0,,,,2,2,1,3
C(CO)(CC(CO)(C(CO)O)O)=O,,,5,1,2,0,2
8291_0,,,,2,2,1,3
C(C)(C(C(CO)(C(CO)O)O)O)=O,,,5,1,4,0,4
8291_1,,,,2,2,1,3
8293_0,,,,2,2,1,3
C(C(C=C)C(CO)(C(CO)O)O)=O,,,5,1,2,0,2
8295_0,,,,2,2,1,3
C(C(C(CO)(C(CO)O)O)O)=O,,,5,1,5,0,5
8295_1,,,,2,2,1,3
8297_0,,,,2,2,1,3
C(C(CO)O)(C([C](C(O)=O)O)O)=O,,,5,1,5,0,5
8297_1,,,,2,2,1,3
8299_0,,,,2,2,1,3
C(C(C(C)(CC)O)O)(C(CO)O)=O,,,5,1,2,0,2
8299_1,,,,2,2,1,3
8301_0,,,,2,2,1,3
C(CC(C(C(C(CO)O)=O)O)O)=O,,,5,1,3,0,3
8301_1,,,,2,2,1,3
8303_0,,,,2,2,1,3
C(C(C(C=C)O)O)(C(CO)O)=O,,,5,1,2,0,2
8303_1,,,,2,2,1,3
8305_0,,,,2,2,1,3
C(C(C(C(O)O)O)O)(C(CO)O)=O,,,5,1,2,0,2
8305_1,,,,2,2,1,3
8306_0,,,,2,2,1,3
8306_1,,,,2,2,1,3
8307_0,,,,2,2,1,3
8307_1,,,,2,2,1,3
8308_0,,,,2,2,1,3
8308_1,,,,2,2,1,3
8309_0,,,,2,2,1,3
8309_1,,,,2,2,1,3
8311_0,,,,2,2,1,3
C(C(CO)O)(C(CO)O)=O,,,5,1,6,0,6
8311_1,,,,2,2,1,3
8312_0,,,,2,2,1,3
8312_1,,,,2,2,1,3
8313_0,,,,2,2,1,3
8313_1,,,,2,2,1,3
8314_0,,,,2,2,1,3
8314_1,,,,2,2,1,3
8315_0,,,,2,2,1,3
8315_1,,,,2,2,1,3
8316_0,,,,2,2,1,3
8316_1,,,,2,2,1,3
8317_0,,,,2,2,1,3
8317_1,,,,2,2,1,3
8318_0,,,,2,2,1,3
8318_1,,,,2,2,1,3
8319_0,,,,2,2,1,3
8319_1,,,,2,2,1,3
8321_0,,,,2,2,1,3
C(CC(CO)(CC(C)(CO)O)O)=O,,,5,1,1,0,1
8323_0,,,,2,2,1,3
C(CO)(C(C(C)O)C(CO)(C)O)=O,,,5,1,5,0,5
8323_1,,,,2,2,1,3
8325_0,,,,2,2,1,3
C(C(C(CO)=O)C(CO)(C)O)(O)=O,,,5,1,5,0,5
8325_1,,,,2,2,1,3
8327_0,,,,2,2,1,3
C(CO)(C(CO)C(CO)(C)O)=O,,,5,1,5,0,5
8327_1,,,,2,2,1,3
8329_0,,,,2,2,1,3
C(C(C(C)O)O)(CC(CO)(C)O)=O,,,5,1,3,0,3
8329_1,,,,2,2,1,3
8331_0,,,,2,2,1,3
C(C(C(CC(CO)(C)O)=O)O)(O)=O,,,5,1,3,0,3
8331_1,,,,2,2,1,3
8333_0,,,,2,2,1,3
C(C(CO)O)(CC(CO)(C)O)=O,,,5,1,3,0,3
8333_1,,,,2,2,1,3
8335_0,,,,2,2,1,3
C(CC(C)(C(C(C)(CO)O)O)O)=O,,,5,1,2,0,2
8337_0,,,,2,2,1,3
C(C(C(CO)(C)O)O)(CC(C)O)=O,,,5,1,4,0,4
8339_0,,,,2,2,1,3
C(CC(C(C(CO)(C)O)O)=O)(O)=O,,,5,1,4,0,4
8341_0,,,,2,2,1,3
C(C(C(CO)(C)O)O)(CCO)=O,,,5,1,4,0,4
8343_0,,,,2,2,1,3
C(CC(C(C=C)C(C)(CO)O)O)=O,,,5,1,1,0,1
8345_0,,,,2,2,1,3
C(CC(C(C(C)(CO)O)O)O)=O,,,5,1,1,0,1
8347_0,,,,2,2,1,3
C(C(C(C(C(CO)(C)O)O)O)O)=O,,,5,1,2,0,2
8347_1,,,,2,2,1,3
8349_0,,,,2,2,1,3
C(C)(C(C)C(CC(C)(CO)O)O)=O,,,5,1,1,0,1
8351_0,,,,2,2,1,3
C(CC(CC(C)(CO)O)O)(CC)=O,,,5,1,1,0,1
8353_0,,,,2,2,1,3
C(C(C=O)C(CC(C)(CO)O)O)=O,,,5,1,2,0,2
8353_1,,,,2,2,1,3
8355_0,,,,2,2,1,3
C(CC(CC(C)(CO)O)O)=O,,,5,1,2,0,2
8357_0,,,,2,2,1,3
C(C(CC(CC(C)(CO)O)O)=O)=O,,,5,1,2,0,2
8359_0,,,,2,2,1,3
C(C(CO)C(CC(C)(CO)O)O)=O,,,5,1,3,0,3
8359_1,,,,2,2,1,3
8361_0,,,,2,2,1,3
C(CO)(CC(CC(CO)(C)O)O)=O,,,5,1,2,0,2
8363_0,,,,2,2,1,3
C(C)(C(C(CC(CO)(C)O)O)O)=O,,,5,1,3,0,3
8363_1,,,,2,2,1,3
8365_0,,,,2,2,1,3
C(C(C=C)C(CC(C)(CO)O)O)=O,,,5,1,2,0,2
8367_0,,,,2,2,1,3
C(C(C(CC(CO)(C)O)O)O)=O,,,5,1,3,0,3
8367_1,,,,2,2,1,3
8369_0,,,,2,2,1,3
C(C([C](C(O)=O)O)C(C)(CO)O)=O,,,5,1,2,0,2
8369_1,,,,2,2,1,3
8371_0,,,,2,2,1,3
C(C(C(C)(CO)O)C(C)(CC)O)=O,,,5,1,2,0,2
8371_1,,,,2,2,1,3
8373_0,,,,2,2,1,3
C(C(C(CC=O)O)C(C)(CO)O)=O,,,5,1,2,0,2
8373_1,,,,2,2,1,3
8375_0,,,,2,2,1,3
C(C(C(CO)(C)O)C(C=C)O)=O,,,5,1,2,0,2
8375_1,,,,2,2,1,3
8377_0,,,,2,2,1,3
C(C(C(C(O)O)O)C(C)(CO)O)=O,,,5,1,2,0,2
8377_1,,,,2,2,1,3
8378_0,,,,2,2,1,3
8378_1,,,,2,2,1,3
8379_0,,,,2,2,1,3
8379_1,,,,2,2,1,3
8380_0,,,,2,2,1,3
8380_1,,,,2,2,1,3
8381_0,,,,2,2,1,3
8381_1,,,,2,2,1,3
8382_0,,,,2,2,1,3
8382_1,,,,2,2,1,3
8383_0,,,,2,2,1,3
8383_1,,,,2,2,1,3
8384_0,,,,2,2,1,3
8384_1,,,,2,2,1,3
8386_0,,,,2,2,1,3
C(C(C(C)(CO)O)C(C)(CO)O)=O,,,5,1,3,0,3
8386_1,,,,2,2,1,3
8388_0,,,,2,2,1,3
C(C(C(CO)(C)O)C(C=CC)O)=O,,,5,1,5,0,5
8388_1,,,,2,2,1,3
8390_0,,,,2,2,1,3
C(C(C(CC=C)O)C(C)(CO)O)=O,,,5,1,5,0,5
8390_1,,,,2,2,1,3
8392_0,,,,2,2,1,3
C(C(C(CO)O)C(C)(CO)O)=O,,,5,1,5,0,5
8392_1,,,,2,2,1,3
8394_0,,,,2,2,1,3
C(C(C(C(C)O)O)C(C)(CO)O)=O,,,5,1,5,0,5
8394_1,,,,2,2,1,3
8396_0,,,,2,2,1,3
C(C(C(CO)(C)O)C(C(O)=O)O)=O,,,5,1,5,0,5
8396_1,,,,2,2,1,3
8398_0,,,,2,2,1,3
C(C(CC(CO)(C)O)(CC=O)O)=O,,,5,1,2,0,2
8399_0,,,,2,2,1,3
8400_0,,,,2,2,1,3
8400_1,,,,2,2,1,3
8401_0,,,,2,2,1,3
8401_1,,,,2,2,1,3
8402_0,,,,2,2,1,3
8402_1,,,,2,2,1,3
8403_0,,,,2,2,1,3
8403_1,,,,2,2,1,3
8405_0,,,,2,2,1,3
C(CC(CO)(CC(C=CC)O)O)=O,,,5,1,1,0,1
8407_0,,,,2,2,1,3
C(CO)(C(C(C)O)C(C=CC)O)=O,,,5,1,5,0,5
8407_1,,,,2,2,1,3
8409_0,,,,2,2,1,3
C(C(C(CO)=O)C(C=CC)O)(O)=O,,,5,1,5,0,5
8409_1,,,,2,2,1,3
8411_0,,,,2,2,1,3
C(CO)(C(CO)C(C=CC)O)=O,,,5,1,5,0,5
8411_1,,,,2,2,1,3
8413_0,,,,2,2,1,3
C(CC(C=CC)O)(C(C(C)O)O)=O,,,5,1,3,0,3
8413_1,,,,2,2,1,3
8415_0,,,,2,2,1,3
C(C(C(CC(C=CC)O)=O)O)(O)=O,,,5,1,3,0,3
8415_1,,,,2,2,1,3
8417_0,,,,2,2,1,3
C(CC(C=CC)O)(C(CO)O)=O,,,5,1,3,0,3
8417_1,,,,2,2,1,3
8419_0,,,,2,2,1,3
C(CC(CO)(CC(CC=C)O)O)=O,,,5,1,1,0,1
8421_0,,,,2,2,1,3
C(CO)(C(C(CC=C)O)C(C)O)=O,,,5,1,5,0,5
8421_1,,,,2,2,1,3
8423_0,,,,2,2,1,3
C(C(C(CO)=O)C(CC=C)O)(O)=O,,,5,1,5,0,5
8423_1,,,,2,2,1,3
8425_0,,,,2,2,1,3
C(CO)(C(CO)C(CC=C)O)=O,,,5,1,5,0,5
8425_1,,,,2,2,1,3
8427_0,,,,2,2,1,3
C(C(C(C)O)O)(CC(CC=C)O)=O,,,5,1,3,0,3
8427_1,,,,2,2,1,3
8429_0,,,,2,2,1,3
C(C(C(CC(CC=C)O)=O)O)(O)=O,,,5,1,3,0,3
8429_1,,,,2,2,1,3
8431_0,,,,2,2,1,3
C(C(CO)O)(CC(CC=C)O)=O,,,5,1,3,0,3
8431_1,,,,2,2,1,3
8433_0,,,,2,2,1,3
C(CO)(C(CO)C(C(CO)O)O)=O,,,5,1,5,0,5
8433_1,,,,2,2,1,3
8435_0,,,,2,2,1,3
C(C(CO)O)(CC(C(CO)O)O)=O,,,5,1,3,0,3
8435_1,,,,2,2,1,3
8437_0,,,,2,2,1,3
C(CC(CO)(CC(CO)O)O)=O,,,5,1,1,0,1
8439_0,,,,2,2,1,3
C(C(C(CO)(CC(CO)O)O)O)=O,,,5,1,2,0,2
8439_1,,,,2,2,1,3
8441_0,,,,2,2,1,3
C(CO)(C(C(CO)O)C(C=C)O)=O,,,5,1,2,0,2
8441_1,,,,2,2,1,3
8443_0,,,,2,2,1,3
C(CO)(C(C(CO)O)C(C)O)=O,,,5,1,5,0,5
8443_1,,,,2,2,1,3
8445_0,,,,2,2,1,3
C(C(C(CO)=O)C(CO)O)(O)=O,,,5,1,5,0,5
8445_1,,,,2,2,1,3
8447_0,,,,2,2,1,3
C(CO)(C(CO)C(CO)O)=O,,,5,1,5,0,5
8447_1,,,,2,2,1,3
8448_0,,,,2,2,1,3
8448_1,,,,2,2,1,3
8450_0,,,,2,2,1,3
C(CO)(C(C(CO)O)C(CO)O)=O,,,5,1,2,0,2
8450_1,,,,2,2,1,3
8452_0,,,,2,2,1,3
C(C(C(C=C)O)O)(CC(CO)O)=O,,,5,1,2,0,2
8452_1,,,,2,2,1,3
8454_0,,,,2,2,1,3
C(C(C(C)O)O)(CC(CO)O)=O,,,5,1,3,0,3
8454_1,,,,2,2,1,3
8456_0,,,,2,2,1,3
C(C(C(CC(CO)O)=O)O)(O)=O,,,5,1,3,0,3
8456_1,,,,2,2,1,3
8458_0,,,,2,2,1,3
C(C(CO)O)(CC(CO)O)=O,,,5,1,3,0,3
8458_1,,,,2,2,1,3
8459_0,,,,2,2,1,3
8459_1,,,,2,2,1,3
8461_0,,,,2,2,1,3
C(C(C(CO)O)O)(CC(CO)O)=O,,,5,1,4,0,4
8461_1,,,,2,2,1,3
8463_0,,,,2,2,1,3
C(CC(CO)(CC(C(C)O)O)O)=O,,,5,1,1,0,1
8465_0,,,,2,2,1,3
C(CO)(C(C(C)O)C(C(C)O)O)=O,,,5,1,5,0,5
8465_1,,,,2,2,1,3
8467_0,,,,2,2,1,3
C(C(C(CO)=O)C(C(C)O)O)(O)=O,,,5,1,5,0,5
8467_1,,,,2,2,1,3
8469_0,,,,2,2,1,3
C(CO)(C(CO)C(C(C)O)O)=O,,,5,1,5,0,5
8469_1,,,,2,2,1,3
8471_0,,,,2,2,1,3
C(C(C(C)O)O)(CC(C(C)O)O)=O,,,5,1,3,0,3
8471_1,,,,2,2,1,3
8473_0,,,,2,2,1,3
C(C(C(CC(C(C)O)O)=O)O)(O)=O,,,5,1,3,0,3
8473_1,,,,2,2,1,3
8475_0,,,,2,2,1,3
C(C(CO)O)(CC(C(C)O)O)=O,,,5,1,3,0,3
8475_1,,,,2,2,1,3
8477_0,,,,2,2,1,3
C(CC(CO)(CC(C(O)=O)O)O)=O,,,5,1,2,0,2
8479_0,,,,2,2,1,3
C(CO)(C(C(C)O)C(C(O)=O)O)=O,,,5,1,5,0,5
8479_1,,,,2,2,1,3
8481_0,,,,2,2,1,3
C(C(C(CO)=O)C(C(O)=O)O)(O)=O,,,5,1,6,0,6
8481_1,,,,2,2,1,3
8483_0,,,,2,2,1,3
C(CO)(C(CO)C(C(O)=O)O)=O,,,5,1,5,0,5
8483_1,,,,2,2,1,3
8485_0,,,,2,2,1,3
C(CC(C(O)=O)O)(C(C(C)O)O)=O,,,5,1,4,0,4
8485_1,,,,2,2,1,3
8487_0,,,,2,2,1,3
C(C(C(CC(C(O)=O)O)=O)O)(O)=O,,,5,1,4,0,4
8487_1,,,,2,2,1,3
8488_0,,,,2,2,1,3
8488_1,,,,2,2,1,3
8490_0,,,,2,2,1,3
C(C)(C(C)C(CO)(CC(C)O)O)=O,,,5,1,1,0,1
8492_0,,,,2,2,1,3
C(CC(CO)(CC(C)O)O)(CC)=O,,,5,1,1,0,1
8494_0,,,,2,2,1,3
C(C(C=O)C(CO)(CC(C)O)O)=O,,,5,1,2,0,2
8494_1,,,,2,2,1,3
8496_0,,,,2,2,1,3
C(CC(CO)(CC(C)O)O)=O,,,5,1,2,0,2
8498_0,,,,2,2,1,3
C(C(CC(CO)(CC(C)O)O)=O)=O,,,5,1,2,0,2
8500_0,,,,2,2,1,3
C(C(CO)C(CO)(CC(C)O)O)=O,,,5,1,3,0,3
8500_1,,,,2,2,1,3
8502_0,,,,2,2,1,3
C(CO)(CC(CO)(CC(C)O)O)=O,,,5,1,2,0,2
8504_0,,,,2,2,1,3
C(C)(C(C(CO)(CC(C)O)O)O)=O,,,5,1,3,0,3
8504_1,,,,2,2,1,3
8506_0,,,,2,2,1,3
C(C(C=C)C(CO)(CC(C)O)O)=O,,,5,1,2,0,2
8508_0,,,,2,2,1,3
C(C(C(CO)(CC(C)O)O)O)=O,,,5,1,3,0,3
8508_1,,,,2,2,1,3
8510_0,,,,2,2,1,3
C(CO)(C([C](C(O)=O)O)C(C)O)=O,,,5,1,2,0,2
8510_1,,,,2,2,1,3
8512_0,,,,2,2,1,3
C(CO)(C(C(C)O)C(C)(CC)O)=O,,,5,1,2,0,2
8512_1,,,,2,2,1,3
8514_0,,,,2,2,1,3
C(CC(C(C(CO)=O)C(C)O)O)=O,,,5,1,2,0,2
8514_1,,,,2,2,1,3
8516_0,,,,2,2,1,3
C(CO)(C(C(C)O)C(C=C)O)=O,,,5,1,2,0,2
8516_1,,,,2,2,1,3
8518_0,,,,2,2,1,3
C(CO)(C(C(C(O)O)O)C(C)O)=O,,,5,1,2,0,2
8518_1,,,,2,2,1,3
8520_0,,,,2,2,1,3
C(CO)(C(C(C)O)C(C)O)=O,,,5,1,3,0,3
8520_1,,,,2,2,1,3
8522_0,,,,2,2,1,3
C(C(C(CO)=O)C(C)O)(O)=O,,,5,1,7,0,7
8522_1,,,,2,2,1,3
8524_0,,,,2,2,1,3
C(C(C)(C(C(CO)=O)C(C)O)O)=O,,,5,1,5,0,5
8524_1,,,,2,2,1,3
8526_0,,,,2,2,1,3
C(CO)(C(C(C)O)C(C(C)=O)O)=O,,,5,1,5,0,5
8526_1,,,,2,2,1,3
8528_0,,,,2,2,1,3
C(CO)(C(CO)C(C)O)=O,,,5,1,5,0,5
8528_1,,,,2,2,1,3
8529_0,,,,2,2,1,3
8529_1,,,,2,2,1,3
8530_0,,,,2,2,1,3
8530_1,,,,2,2,1,3
8531_0,,,,2,2,1,3
8531_1,,,,2,2,1,3
8532_0,,,,2,2,1,3
8532_1,,,,2,2,1,3
8533_0,,,,2,2,1,3
8533_1,,,,2,2,1,3
8534_0,,,,2,2,1,3
8534_1,,,,2,2,1,3
8535_0,,,,2,2,1,3
8535_1,,,,2,2,1,3
8536_0,,,,2,2,1,3
8536_1,,,,2,2,1,3
8538_0,,,,2,2,1,3
C(CC(C)O)(C([C](C(O)=O)O)O)=O,,,5,1,3,0,3
8538_1,,,,2,2,1,3
8540_0,,,,2,2,1,3
C(C(C(C)(CC)O)O)(CC(C)O)=O,,,5,1,2,0,2
8540_1,,,,2,2,1,3
8542_0,,,,2,2,1,3
C(CC(C(C(CC(C)O)=O)O)O)=O,,,5,1,2,0,2
8542_1,,,,2,2,1,3
8544_0,,,,2,2,1,3
C(C(C(C=C)O)O)(CC(C)O)=O,,,5,1,2,0,2
8544_1,,,,2,2,1,3
8546_0,,,,2,2,1,3
C(C(C(C(O)O)O)O)(CC(C)O)=O,,,5,1,2,0,2
8546_1,,,,2,2,1,3
8548_0,,,,2,2,1,3
C(C(C(C)O)O)(CC(C)O)=O,,,5,1,3,0,3
8548_1,,,,2,2,1,3
8550_0,,,,2,2,1,3
C(C(C(CC(C)O)=O)O)(O)=O,,,5,1,4,0,4
8550_1,,,,2,2,1,3
8551_0,,,,2,2,1,3
8551_1,,,,2,2,1,3
8552_0,,,,2,2,1,3
8552_1,,,,2,2,1,3
8554_0,,,,2,2,1,3
C(C(CO)O)(CC(C)O)=O,,,5,1,3,0,3
8554_1,,,,2,2,1,3
8555_0,,,,2,2,1,3
8555_1,,,,2,2,1,3
8556_0,,,,2,2,1,3
8556_1,,,,2,2,1,3
8557_0,,,,2,2,1,3
8557_1,,,,2,2,1,3
8559_0,,,,2,2,1,3
C(C(C(C=CC)O)O)(CC(C)O)=O,,,5,1,3,0,3
8559_1,,,,2,2,1,3
8561_0,,,,2,2,1,3
C(C(C(CC=C)O)O)(CC(C)O)=O,,,5,1,3,0,3
8561_1,,,,2,2,1,3
8563_0,,,,2,2,1,3
C(C(C(CO)O)O)(CC(C)O)=O,,,5,1,5,0,5
8563_1,,,,2,2,1,3
8565_0,,,,2,2,1,3
C(C(C(C(C)O)O)O)(CC(C)O)=O,,,5,1,3,0,3
8565_1,,,,2,2,1,3
8566_0,,,,2,2,1,3
8566_1,,,,2,2,1,3
8568_0,,,,2,2,1,3
C(CC(CO)(C(C(C)=O)C)O)(O)=O,,,5,1,1,0,1
8570_0,,,,2,2,1,3
C(CC(CO)(CC(CC)=O)O)(O)=O,,,5,1,1,0,1
8572_0,,,,2,2,1,3
C(C(C=O)C(CO)(CC(O)=O)O)=O,,,5,1,2,0,2
8572_1,,,,2,2,1,3
8574_0,,,,2,2,1,3
C(CC(CO)(CC=O)O)(O)=O,,,5,1,2,0,2
8576_0,,,,2,2,1,3
C(CC(CO)(CC(C=O)=O)O)(O)=O,,,5,1,2,0,2
8578_0,,,,2,2,1,3
C(C(CO)C(CO)(CC(O)=O)O)=O,,,5,1,3,0,3
8578_1,,,,2,2,1,3
8580_0,,,,2,2,1,3
C(CC(CO)(CC(CO)=O)O)(O)=O,,,5,1,2,0,2
8582_0,,,,2,2,1,3
C(CC(CO)(C(C(C)=O)O)O)(O)=O,,,5,1,3,0,3
8582_1,,,,2,2,1,3
8584_0,,,,2,2,1,3
C(C(C=C)C(CO)(CC(O)=O)O)=O,,,5,1,2,0,2
8586_0,,,,2,2,1,3
C(CC(CO)(C(C=O)O)O)(O)=O,,,5,1,3,0,3
8586_1,,,,2,2,1,3
8588_0,,,,2,2,1,3
C(C(C(CO)=O)[C](C(O)=O)O)(O)=O,,,5,1,3,0,3
8588_1,,,,2,2,1,3
8590_0,,,,2,2,1,3
C(C(C(CO)=O)C(C)(CC)O)(O)=O,,,5,1,2,0,2
8590_1,,,,2,2,1,3
8592_0,,,,2,2,1,3
C(CC(C(C(O)=O)C(CO)=O)O)=O,,,5,1,3,0,3
8592_1,,,,2,2,1,3
8594_0,,,,2,2,1,3
C(C(C(CO)=O)C(C=C)O)(O)=O,,,5,1,2,0,2
8594_1,,,,2,2,1,3
8596_0,,,,2,2,1,3
C(C(C(CO)=O)C(C(O)O)O)(O)=O,,,5,1,2,0,2
8596_1,,,,2,2,1,3
8597_0,,,,2,2,1,3
8597_1,,,,2,2,1,3
8599_0,,,,2,2,1,3
C(C(C(O)=O)C(CO)=O)(O)=O,,,5,1,5,0,5
8599_1,,,,2,2,1,3
8601_0,,,,2,2,1,3
C(C(C)(C(C(O)=O)C(CO)=O)O)=O,,,5,1,5,0,5
8601_1,,,,2,2,1,3
8603_0,,,,2,2,1,3
C(C(C(CO)=O)C(C(C)=O)O)(O)=O,,,5,1,5,0,5
8603_1,,,,2,2,1,3
8605_0,,,,2,2,1,3
C(C(C(CO)=O)CO)(O)=O,,,5,1,7,0,7
8605_1,,,,2,2,1,3
8606_0,,,,2,2,1,3
8606_1,,,,2,2,1,3
8607_0,,,,2,2,1,3
8607_1,,,,2,2,1,3
8608_0,,,,2,2,1,3
8608_1,,,,2,2,1,3
8609_0,,,,2,2,1,3
8609_1,,,,2,2,1,3
8610_0,,,,2,2,1,3
8610_1,,,,2,2,1,3
8611_0,,,,2,2,1,3
8611_1,,,,2,2,1,3
8612_0,,,,2,2,1,3
8612_1,,,,2,2,1,3
8613_0,,,,2,2,1,3
8613_1,,,,2,2,1,3
8615_0,,,,2,2,1,3
C(CC(C([C](C(O)=O)O)O)=O)(O)=O,,,5,1,3,0,3
8615_1,,,,2,2,1,3
8617_0,,,,2,2,1,3
C(CC(C(C(C)(CC)O)O)=O)(O)=O,,,5,1,2,0,2
8617_1,,,,2,2,1,3
8619_0,,,,2,2,1,3
C(CC(C(C(CC(O)=O)=O)O)O)=O,,,5,1,2,0,2
8619_1,,,,2,2,1,3
8621_0,,,,2,2,1,3
C(CC(C(C(C=C)O)O)=O)(O)=O,,,5,1,2,0,2
8621_1,,,,2,2,1,3
8623_0,,,,2,2,1,3
C(CC(C(C(C(O)O)O)O)=O)(O)=O,,,5,1,2,0,2
8623_1,,,,2,2,1,3
8625_0,,,,2,2,1,3
C(CC(C(C(C)O)O)=O)(O)=O,,,5,1,3,0,3
8625_1,,,,2,2,1,3
8627_0,,,,2,2,1,3
C(CC(C(C(O)=O)O)=O)(O)=O,,,5,1,5,0,5
8627_1,,,,2,2,1,3
8628_0,,,,2,2,1,3
8628_1,,,,2,2,1,3
8629_0,,,,2,2,1,3
8629_1,,,,2,2,1,3
8631_0,,,,2,2,1,3
C(CC(C(CO)O)=O)(O)=O,,,5,1,7,0,7
8631_1,,,,2,2,1,3
8632_0,,,,2,2,1,3
8632_1,,,,2,2,1,3
8633_0,,,,2,2,1,3
8633_1,,,,2,2,1,3
8634_0,,,,2,2,1,3
8634_1,,,,2,2,1,3
8636_0,,,,2,2,1,3
C(CC(C(C(C=CC)O)O)=O)(O)=O,,,5,1,3,0,3
8636_1,,,,2,2,1,3
8638_0,,,,2,2,1,3
C(CC(C(C(CC=C)O)O)=O)(O)=O,,,5,1,3,0,3
8638_1,,,,2,2,1,3
8640_0,,,,2,2,1,3
C(CC(C(C(CO)O)O)=O)(O)=O,,,5,1,5,0,5
8640_1,,,,2,2,1,3
8642_0,,,,2,2,1,3
C(CC(C(C(C(C)O)O)O)=O)(O)=O,,,5,1,3,0,3
8642_1,,,,2,2,1,3
8643_0,,,,2,2,1,3
8643_1,,,,2,2,1,3
8645_0,,,,2,2,1,3
C(CO)(C(CO)C(CC(C)O)O)=O,,,5,1,5,0,5
8645_1,,,,2,2,1,3
8647_0,,,,2,2,1,3
C(C(CO)O)(CC(CC(C)O)O)=O,,,5,1,3,0,3
8647_1,,,,2,2,1,3
8649_0,,,,2,2,1,3
C(CC(C(C(CO)=O)CO)O)(O)=O,,,5,1,5,0,5
8649_1,,,,2,2,1,3
8651_0,,,,2,2,1,3
C(CC(CC(C(CO)O)=O)O)(O)=O,,,5,1,3,0,3
8651_1,,,,2,2,1,3
8652_0,,,,2,2,1,3
8652_1,,,,2,2,1,3
8654_0,,,,2,2,1,3
C(CO)(C(CO)C(C(CO)=O)O)=O,,,5,1,5,0,5
8654_1,,,,2,2,1,3
8656_0,,,,2,2,1,3
C(CC(C(CO)=O)O)(C(CO)O)=O,,,5,1,3,0,3
8656_1,,,,2,2,1,3
8658_0,,,,2,2,1,3
C(C(CO)(C(C(CO)=O)CO)O)=O,,,5,1,5,0,5
8658_1,,,,2,2,1,3
8660_0,,,,2,2,1,3
C(C(CO)(CC(C(CO)O)=O)O)=O,,,5,1,3,0,3
8660_1,,,,2,2,1,3
8661_0,,,,2,2,1,3
8663_0,,,,2,2,1,3
C(C(C)(CC(CO)(CC=O)O)O)=O,,,5,1,2,0,2
8664_0,,,,2,2,1,3
8664_1,,,,2,2,1,3
8665_0,,,,2,2,1,3
8665_1,,,,2,2,1,3
8667_0,,,,2,2,1,3
C(C(C)(C(C(CO)=O)CO)O)=O,,,5,1,5,0,5
8667_1,,,,2,2,1,3
8669_0,,,,2,2,1,3
C(C(C)(CC(C(C(C)O)O)=O)O)=O,,,5,1,3,0,3
8669_1,,,,2,2,1,3
8671_0,,,,2,2,1,3
C(C(C)(CC(C(C(O)=O)O)=O)O)=O,,,5,1,3,0,3
8671_1,,,,2,2,1,3
8673_0,,,,2,2,1,3
C(C(C)(CC(C(CO)O)=O)O)=O,,,5,1,3,0,3
8673_1,,,,2,2,1,3
8674_0,,,,2,2,1,3
8676_0,,,,2,2,1,3
C(CC(CO)(CC(C(C)=O)O)O)=O,,,5,1,2,0,2
8677_0,,,,2,2,1,3
8678_0,,,,2,2,1,3
8679_0,,,,2,2,1,3
8680_0,,,,2,2,1,3
8680_1,,,,2,2,1,3
8681_0,,,,2,2,1,3
8681_1,,,,2,2,1,3
8683_0,,,,2,2,1,3
C(CO)(C(CO)C(C(C)=O)O)=O,,,5,1,5,0,5
8683_1,,,,2,2,1,3
8685_0,,,,2,2,1,3
C(CC(C(C)=O)O)(C(C(C)O)O)=O,,,5,1,3,0,3
8685_1,,,,2,2,1,3
8687_0,,,,2,2,1,3
C(C(C(CC(C(C)=O)O)=O)O)(O)=O,,,5,1,3,0,3
8687_1,,,,2,2,1,3
8689_0,,,,2,2,1,3
C(CC(C(C)=O)O)(C(CO)O)=O,,,5,1,3,0,3
8689_1,,,,2,2,1,3
8691_0,,,,2,2,1,3
C(C(C)=O)(CC(CO)(CCO)O)=O,,,5,1,1,0,1
8693_0,,,,2,2,1,3
C(CC(CO)(CCO)O)(CCO)=O,,,5,1,1,0,1
8695_0,,,,2,2,1,3
C(C)(C(CO)C(CO)(CCO)O)=O,,,5,1,2,0,2
8695_1,,,,2,2,1,3
8697_0,,,,2,2,1,3
C(C)(C(C)C(CO)(CCO)O)=O,,,5,1,1,0,1
8699_0,,,,2,2,1,3
C(CC(CO)(CCO)O)(CC)=O,,,5,1,1,0,1
8701_0,,,,2,2,1,3
C(C(C)O)(CC(CO)(CCO)O)=O,,,5,1,1,0,1
8703_0,,,,2,2,1,3
C(C(C(CO)(CCO)O)O)(CC)=O,,,5,1,2,0,2
8703_1,,,,2,2,1,3
8705_0,,,,2,2,1,3
C(CO)(C(C)C(CO)(CCO)O)=O,,,5,1,1,0,1
8707_0,,,,2,2,1,3
C(C(C=O)C(CO)(CCO)O)=O,,,5,1,2,0,2
8707_1,,,,2,2,1,3
8709_0,,,,2,2,1,3
C(C(CCO)C(CO)(CCO)O)=O,,,5,1,1,0,1
8711_0,,,,2,2,1,3
C(CC(CO)(CCO)O)=O,,,5,1,2,0,2
8713_0,,,,2,2,1,3
C(C(C(C)O)C(CO)(CCO)O)=O,,,5,1,3,0,3
8713_1,,,,2,2,1,3
8715_0,,,,2,2,1,3
C(C(C=O)C(CO)(CCO)O)(O)=O,,,5,1,3,0,3
8715_1,,,,2,2,1,3
8717_0,,,,2,2,1,3
C(C(C(C(CO)(CCO)O)O)=O)=O,,,5,1,3,0,3
8717_1,,,,2,2,1,3
8719_0,,,,2,2,1,3
C(C(CC(CO)(CCO)O)=O)=O,,,5,1,2,0,2
8721_0,,,,2,2,1,3
C(C(CO)C(CO)(CCO)O)=O,,,5,1,3,0,3
8721_1,,,,2,2,1,3
8723_0,,,,2,2,1,3
C(CO)(C(C(CO)(CCO)O)O)=O,,,5,1,3,0,3
8723_1,,,,2,2,1,3
8725_0,,,,2,2,1,3
C(CO)(CC(CO)(CCO)O)=O,,,5,1,2,0,2
8727_0,,,,2,2,1,3
C(C)(C(C(CO)(CCO)O)O)=O,,,5,1,3,0,3
8727_1,,,,2,2,1,3
8729_0,,,,2,2,1,3
C(C(C=C)C(CO)(CCO)O)=O,,,5,1,2,0,2
8731_0,,,,2,2,1,3
C(C(C(CO)(CCO)O)O)=O,,,5,1,3,0,3
8731_1,,,,2,2,1,3
8733_0,,,,2,2,1,3
C(C(CC(CO)(CCO)O)=O)(O)=O,,,5,1,2,0,2
8735_0,,,,2,2,1,3
C(CO)(C(CO)C(C(C=O)=O)O)=O,,,5,1,2,0,2
8735_1,,,,2,2,1,3
8737_0,,,,2,2,1,3
C(C(C=O)(C(C(CO)=O)CO)O)=O,,,5,1,2,0,2
8737_1,,,,2,2,1,3
8739_0,,,,2,2,1,3
C(C)(C(C)(C(C(CO)=O)CO)O)=O,,,5,1,2,0,2
8739_1,,,,2,2,1,3
8741_0,,,,2,2,1,3
C(CO)(C([C](C(O)=O)O)CO)=O,,,5,1,2,0,2
8741_1,,,,2,2,1,3
8743_0,,,,2,2,1,3
C(CO)(C(CO)C(C)(CCO)O)=O,,,5,1,2,0,2
8743_1,,,,2,2,1,3
8745_0,,,,2,2,1,3
C(CO)(C(CO)C(C)(CC)O)=O,,,5,1,2,0,2
8745_1,,,,2,2,1,3
8747_0,,,,2,2,1,3
C(CO)(C(CO)C(C)(C(C)O)O)=O,,,5,1,2,0,2
8747_1,,,,2,2,1,3
8749_0,,,,2,2,1,3
C(CO)(C(CO)C(CO)(CC)O)=O,,,5,1,2,0,2
8749_1,,,,2,2,1,3
8751_0,,,,2,2,1,3
C(CC(C(C(CO)=O)CO)O)=O,,,5,1,2,0,2
8751_1,,,,2,2,1,3
8753_0,,,,2,2,1,3
C(CO)(C(CO)C([CH]C(O)=O)O)=O,,,5,1,2,0,2
8753_1,,,,2,2,1,3
8755_0,,,,2,2,1,3
C(C(C=C)(C(C(CO)=O)CO)O)=O,,,5,1,2,0,2
8755_1,,,,2,2,1,3
8757_0,,,,2,2,1,3
C(CO)(C(CO)C(C(C=C)=O)O)=O,,,5,1,2,0,2
8757_1,,,,2,2,1,3
8759_0,,,,2,2,1,3
C(CO)(C(CO)C(C=C)O)=O,,,5,1,2,0,2
8759_1,,,,2,2,1,3
8761_0,,,,2,2,1,3
C(CO)(C(CO)C(C(CC)O)O)=O,,,5,1,2,0,2
8761_1,,,,2,2,1,3
8763_0,,,,2,2,1,3
C(CO)(C(CO)C(CCCO)O)=O,,,5,1,2,0,2
8763_1,,,,2,2,1,3
8765_0,,,,2,2,1,3
C(CO)(C(CO)C(C(O)O)O)=O,,,5,1,2,0,2
8765_1,,,,2,2,1,3
8766_0,,,,2,2,1,3
8766_1,,,,2,2,1,3
8767_0,,,,2,2,1,3
8767_1,,,,2,2,1,3
8768_0,,,,2,2,1,3
8768_1,,,,2,2,1,3
8769_0,,,,2,2,1,3
8769_1,,,,2,2,1,3
8770_0,,,,2,2,1,3
8770_1,,,,2,2,1,3
8771_0,,,,2,2,1,3
8771_1,,,,2,2,1,3
8772_0,,,,2,2,1,3
8772_1,,,,2,2,1,3
8773_0,,,,2,2,1,3
8773_1,,,,2,2,1,3
8775_0,,,,2,2,1,3
C(CO)(C(CO)CO)=O,,,5,1,3,0,3
8775_1,,,,2,2,1,3
8776_0,,,,2,2,1,3
8776_1,,,,2,2,1,3
8777_0,,,,2,2,1,3
8777_1,,,,2,2,1,3
8778_0,,,,2,2,1,3
8778_1,,,,2,2,1,3
8779_0,,,,2,2,1,3
8779_1,,,,2,2,1,3
8780_0,,,,2,2,1,3
8780_1,,,,2,2,1,3
8781_0,,,,2,2,1,3
8781_1,,,,2,2,1,3
8782_0,,,,2,2,1,3
8782_1,,,,2,2,1,3
8783_0,,,,2,2,1,3
8783_1,,,,2,2,1,3
8784_0,,,,2,2,1,3
8784_1,,,,2,2,1,3
8785_0,,,,2,2,1,3
8785_1,,,,2,2,1,3
8786_0,,,,2,2,1,3
8786_1,,,,2,2,1,3
8788_0,,,,2,2,1,3
C(C(C)(C(C(CO)=O)CO)O)(O)=O,,,5,1,5,0,5
8788_1,,,,2,2,1,3
8789_0,,,,2,2,1,3
8789_1,,,,2,2,1,3
8790_0,,,,2,2,1,3
8790_1,,,,2,2,1,3
8792_0,,,,2,2,1,3
C(C)(C(C)(C(C(CCO)=O)O)O)=O,,,5,1,3,0,3
8792_1,,,,2,2,1,3
8794_0,,,,2,2,1,3
C(CCO)(C([C](C(O)=O)O)O)=O,,,5,1,3,0,3
8794_1,,,,2,2,1,3
8796_0,,,,2,2,1,3
C(C(C(C)(CCO)O)O)(CCO)=O,,,5,1,2,0,2
8796_1,,,,2,2,1,3
8798_0,,,,2,2,1,3
C(C(C(C)(CC)O)O)(CCO)=O,,,5,1,2,0,2
8798_1,,,,2,2,1,3
8800_0,,,,2,2,1,3
C(C(C(C)(C(C)O)O)O)(CCO)=O,,,5,1,2,0,2
8800_1,,,,2,2,1,3
8802_0,,,,2,2,1,3
C(C(C(CO)(CC)O)O)(CCO)=O,,,5,1,2,0,2
8802_1,,,,2,2,1,3
8804_0,,,,2,2,1,3
C(CC(C(C(CCO)=O)O)O)=O,,,5,1,2,0,2
8804_1,,,,2,2,1,3
8806_0,,,,2,2,1,3
C(C(C([CH]C(O)=O)O)O)(CCO)=O,,,5,1,2,0,2
8806_1,,,,2,2,1,3
8808_0,,,,2,2,1,3
C(C(C=C)(C(C(CCO)=O)O)O)=O,,,5,1,2,0,2
8808_1,,,,2,2,1,3
8810_0,,,,2,2,1,3
C(C(C(C(C=C)=O)O)O)(CCO)=O,,,5,1,2,0,2
8810_1,,,,2,2,1,3
8812_0,,,,2,2,1,3
C(C(C(C=C)O)O)(CCO)=O,,,5,1,2,0,2
8812_1,,,,2,2,1,3
8814_0,,,,2,2,1,3
C(C(C(C(CC)O)O)O)(CCO)=O,,,5,1,2,0,2
8814_1,,,,2,2,1,3
8816_0,,,,2,2,1,3
C(C(C(CCCO)O)O)(CCO)=O,,,5,1,2,0,2
8816_1,,,,2,2,1,3
8818_0,,,,2,2,1,3
C(C(C(C(O)O)O)O)(CCO)=O,,,5,1,2,0,2
8818_1,,,,2,2,1,3
8820_0,,,,2,2,1,3
C(C(C(C)O)O)(CCO)=O,,,5,1,3,0,3
8820_1,,,,2,2,1,3
8822_0,,,,2,2,1,3
C(C(C(CCO)=O)O)(O)=O,,,5,1,4,0,4
8822_1,,,,2,2,1,3
8824_0,,,,2,2,1,3
C(C(C(CC(C)O)O)O)(CCO)=O,,,5,1,3,0,3
8824_1,,,,2,2,1,3
8826_0,,,,2,2,1,3
C(CC(C(C(CCO)=O)O)O)(O)=O,,,5,1,3,0,3
8826_1,,,,2,2,1,3
8827_0,,,,2,2,1,3
8827_1,,,,2,2,1,3
8828_0,,,,2,2,1,3
8828_1,,,,2,2,1,3
8829_0,,,,2,2,1,3
8829_1,,,,2,2,1,3
8830_0,,,,2,2,1,3
8830_1,,,,2,2,1,3
8832_0,,,,2,2,1,3
C(C(CO)O)(CCO)=O,,,5,1,6,0,6
8832_1,,,,2,2,1,3
8833_0,,,,2,2,1,3
8833_1,,,,2,2,1,3
8834_0,,,,2,2,1,3
8834_1,,,,2,2,1,3
8835_0,,,,2,2,1,3
8835_1,,,,2,2,1,3
8836_0,,,,2,2,1,3
8836_1,,,,2,2,1,3
8837_0,,,,2,2,1,3
8837_1,,,,2,2,1,3
8839_0,,,,2,2,1,3
C(C(C(C=CC)O)O)(CCO)=O,,,5,1,3,0,3
8839_1,,,,2,2,1,3
8841_0,,,,2,2,1,3
C(C(C(CC=C)O)O)(CCO)=O,,,5,1,3,0,3
8841_1,,,,2,2,1,3
8843_0,,,,2,2,1,3
C(C(C(C(CO)O)O)O)(CCO)=O,,,5,1,5,0,5
8843_1,,,,2,2,1,3
8845_0,,,,2,2,1,3
C(C(C(CO)O)O)(CCO)=O,,,5,1,5,0,5
8845_1,,,,2,2,1,3
8847_0,,,,2,2,1,3
C(C(C(C(C)O)O)O)(CCO)=O,,,5,1,3,0,3
8847_1,,,,2,2,1,3
8848_0,,,,2,2,1,3
8848_1,,,,2,2,1,3
8849_0,,,,2,2,1,3
8849_1,,,,2,2,1,3
8850_0,,,,2,2,1,3
8850_1,,,,2,2,1,3
8852_0,,,,2,2,1,3
C(C(C)(CC(C(CO)O)=O)O)(O)=O,,,5,1,3,0,3
8852_1,,,,2,2,1,3
8854_0,,,,2,2,1,3
C(CC(C)(C(C(C=CC)O)O)O)=O,,,5,1,1,0,1
8855_0,,,,2,2,1,3
8856_0,,,,2,2,1,3
8857_0,,,,2,2,1,3
8859_0,,,,2,2,1,3
C(CC(C)(C(C(CC=C)O)O)O)=O,,,5,1,1,0,1
8860_0,,,,2,2,1,3
8861_0,,,,2,2,1,3
8862_0,,,,2,2,1,3
8863_0,,,,2,2,1,3
8865_0,,,,2,2,1,3
C(CC(C)(C(C(CO)O)O)O)=O,,,5,1,3,0,3
8867_0,,,,2,2,1,3
C(C(C(C)(C(C(CO)O)O)O)O)=O,,,5,1,3,0,3
8867_1,,,,2,2,1,3
8869_0,,,,2,2,1,3
C(CC(C=C)O)(C(C(CO)O)O)=O,,,5,1,1,0,1
8870_0,,,,2,2,1,3
8871_0,,,,2,2,1,3
8872_0,,,,2,2,1,3
8873_0,,,,2,2,1,3
8874_0,,,,2,2,1,3
8876_0,,,,2,2,1,3
C(CC(C)(C(C(C(C)O)O)O)O)=O,,,5,1,1,0,1
8877_0,,,,2,2,1,3
8878_0,,,,2,2,1,3
8879_0,,,,2,2,1,3
8881_0,,,,2,2,1,3
C(C)(C(C)C(C)(C(C(C)O)O)O)=O,,,5,1,1,0,1
8883_0,,,,2,2,1,3
C(CC(C)(C(C(C)O)O)O)(CC)=O,,,5,1,1,0,1
8885_0,,,,2,2,1,3
C(C(C=O)C(C)(C(C(C)O)O)O)=O,,,5,1,2,0,2
8885_1,,,,2,2,1,3
8887_0,,,,2,2,1,3
C(CC(C)(C(C(C)O)O)O)=O,,,5,1,1,0,1
8889_0,,,,2,2,1,3
C(C(CC(C)(C(C(C)O)O)O)=O)=O,,,5,1,1,0,1
8891_0,,,,2,2,1,3
C(C(CO)C(C)(C(C(C)O)O)O)=O,,,5,1,2,0,2
8891_1,,,,2,2,1,3
8893_0,,,,2,2,1,3
C(CO)(CC(C)(C(C(C)O)O)O)=O,,,5,1,1,0,1
8895_0,,,,2,2,1,3
C(C)(C(C(C)(C(C(C)O)O)O)O)=O,,,5,1,2,0,2
8895_1,,,,2,2,1,3
8897_0,,,,2,2,1,3
C(C(C=C)C(C)(C(C(C)O)O)O)=O,,,5,1,1,0,1
8899_0,,,,2,2,1,3
C(C(C(C)(C(C(C)O)O)O)O)=O,,,5,1,2,0,2
8899_1,,,,2,2,1,3
8901_0,,,,2,2,1,3
C(C(C(C)O)O)(C[C](C(O)=O)O)=O,,,5,1,1,0,1
8903_0,,,,2,2,1,3
C(C(C(C)O)O)(CC(C)(CC)O)=O,,,5,1,1,0,1
8905_0,,,,2,2,1,3
C(CC(CC(C(C(C)O)O)=O)O)=O,,,5,1,1,0,1
8907_0,,,,2,2,1,3
C(CC(C=C)O)(C(C(C)O)O)=O,,,5,1,1,0,1
8909_0,,,,2,2,1,3
C(C(C(C)O)O)(CC(C(O)O)O)=O,,,5,1,1,0,1
8910_0,,,,2,2,1,3
8911_0,,,,2,2,1,3
8912_0,,,,2,2,1,3
8913_0,,,,2,2,1,3
8914_0,,,,2,2,1,3
8915_0,,,,2,2,1,3
8916_0,,,,2,2,1,3
8917_0,,,,2,2,1,3
8918_0,,,,2,2,1,3
8919_0,,,,2,2,1,3
8920_0,,,,2,2,1,3
8921_0,,,,2,2,1,3
8922_0,,,,2,2,1,3
8924_0,,,,2,2,1,3
C(C(C(C)(C(C(C)=O)C)O)O)(O)=O,,,5,1,1,0,1
8926_0,,,,2,2,1,3
C(CC(C)(C(C(O)=O)O)O)(CC)=O,,,5,1,1,0,1
8928_0,,,,2,2,1,3
C(C(C=O)C(C)(C(C(O)=O)O)O)=O,,,5,1,2,0,2
8928_1,,,,2,2,1,3
8930_0,,,,2,2,1,3
C(CC(C)(C(C(O)=O)O)O)=O,,,5,1,2,0,2
8932_0,,,,2,2,1,3
C(C(C(C)(CC(C=O)=O)O)O)(O)=O,,,5,1,3,0,3
8934_0,,,,2,2,1,3
C(C(CO)C(C)(C(C(O)=O)O)O)=O,,,5,1,3,0,3
8934_1,,,,2,2,1,3
8936_0,,,,2,2,1,3
C(C(C(C)(CC(CO)=O)O)O)(O)=O,,,5,1,2,0,2
8938_0,,,,2,2,1,3
C(C(C(C)(C(C(C)=O)O)O)O)(O)=O,,,5,1,5,0,5
8938_1,,,,2,2,1,3
8940_0,,,,2,2,1,3
C(C(C=C)C(C)(C(C(O)=O)O)O)=O,,,5,1,2,0,2
8942_0,,,,2,2,1,3
C(C(C(C)(C(C=O)O)O)O)(O)=O,,,5,1,4,0,4
8942_1,,,,2,2,1,3
8944_0,,,,2,2,1,3
C(C(C(C[C](C(O)=O)O)=O)O)(O)=O,,,5,1,1,0,1
8946_0,,,,2,2,1,3
C(C(C(CC(C)(CC)O)=O)O)(O)=O,,,5,1,1,0,1
8948_0,,,,2,2,1,3
C(C(C(CC(CC=O)O)=O)O)(O)=O,,,5,1,1,0,1
8950_0,,,,2,2,1,3
C(C(C(CC(C=C)O)=O)O)(O)=O,,,5,1,1,0,1
8952_0,,,,2,2,1,3
C(C(C(CC(C(O)O)O)=O)O)(O)=O,,,5,1,1,0,1
8953_0,,,,2,2,1,3
8954_0,,,,2,2,1,3
8955_0,,,,2,2,1,3
8956_0,,,,2,2,1,3
8957_0,,,,2,2,1,3
8958_0,,,,2,2,1,3
8959_0,,,,2,2,1,3
8960_0,,,,2,2,1,3
8961_0,,,,2,2,1,3
8962_0,,,,2,2,1,3
8963_0,,,,2,2,1,3
8964_0,,,,2,2,1,3
8965_0,,,,2,2,1,3
8966_0,,,,2,2,1,3
8967_0,,,,2,2,1,3
8968_0,,,,2,2,1,3
8969_0,,,,2,2,1,3
8970_0,,,,2,2,1,3
8971_0,,,,2,2,1,3
8972_0,,,,2,2,1,3
8973_0,,,,2,2,1,3
8974_0,,,,2,2,1,3
8975_0,,,,2,2,1,3
8976_0,,,,2,2,1,3
8977_0,,,,2,2,1,3
8979_0,,,,2,2,1,3
C(C(C)=O)(CC(C)(C(CO)O)O)=O,,,5,1,1,0,1
8981_0,,,,2,2,1,3
C(CC(C)(C(CO)O)O)(CCO)=O,,,5,1,1,0,1
8983_0,,,,2,2,1,3
C(C)(C(CO)C(C)(C(CO)O)O)=O,,,5,1,2,0,2
8983_1,,,,2,2,1,3
8985_0,,,,2,2,1,3
C(C)(C(C)C(C)(C(CO)O)O)=O,,,5,1,1,0,1
8987_0,,,,2,2,1,3
C(CC(C)(C(CO)O)O)(CC)=O,,,5,1,1,0,1
8989_0,,,,2,2,1,3
C(C(C)O)(CC(C)(C(CO)O)O)=O,,,5,1,1,0,1
8991_0,,,,2,2,1,3
C(C(C(C)(C(CO)O)O)O)(CC)=O,,,5,1,2,0,2
8991_1,,,,2,2,1,3
8993_0,,,,2,2,1,3
C(CO)(C(C)C(C)(C(CO)O)O)=O,,,5,1,1,0,1
8995_0,,,,2,2,1,3
C(C(C=O)C(C)(C(CO)O)O)=O,,,5,1,2,0,2
8995_1,,,,2,2,1,3
8997_0,,,,2,2,1,3
C(C(CCO)C(C)(C(CO)O)O)=O,,,5,1,1,0,1
8999_0,,,,2,2,1,3
C(CC(C)(C(CO)O)O)=O,,,5,1,1,0,1
9001_0,,,,2,2,1,3
C(C(C(C)O)C(C)(C(CO)O)O)=O,,,5,1,2,0,2
9001_1,,,,2,2,1,3
9003_0,,,,2,2,1,3
C(C(C=O)C(C)(C(CO)O)O)(O)=O,,,5,1,2,0,2
9003_1,,,,2,2,1,3
9005_0,,,,2,2,1,3
C(C(C(C(C)(C(CO)O)O)O)=O)=O,,,5,1,2,0,2
9005_1,,,,2,2,1,3
9007_0,,,,2,2,1,3
C(C(CC(C)(C(CO)O)O)=O)=O,,,5,1,1,0,1
9009_0,,,,2,2,1,3
C(C(CO)C(C)(C(CO)O)O)=O,,,5,1,2,0,2
9009_1,,,,2,2,1,3
9011_0,,,,2,2,1,3
C(CO)(C(C(C)(C(CO)O)O)O)=O,,,5,1,2,0,2
9011_1,,,,2,2,1,3
9013_0,,,,2,2,1,3
C(CO)(CC(C)(C(CO)O)O)=O,,,5,1,1,0,1
9015_0,,,,2,2,1,3
C(C)(C(C(C)(C(CO)O)O)O)=O,,,5,1,2,0,2
9015_1,,,,2,2,1,3
9017_0,,,,2,2,1,3
C(C(C=C)C(C)(C(CO)O)O)=O,,,5,1,1,0,1
9019_0,,,,2,2,1,3
C(C(C(C)(C(CO)O)O)O)=O,,,5,1,2,0,2
9019_1,,,,2,2,1,3
9021_0,,,,2,2,1,3
C(C(CC(C)(C(CO)O)O)=O)(O)=O,,,5,1,1,0,1
9023_0,,,,2,2,1,3
C(CC(C(C=O)=O)O)(C(CO)O)=O,,,5,1,1,0,1
9025_0,,,,2,2,1,3
C(C(C=O)(CC(C(CO)O)=O)O)=O,,,5,1,1,0,1
9027_0,,,,2,2,1,3
C(C)(C(C)(CC(C(CO)O)=O)O)=O,,,5,1,1,0,1
9028_0,,,,2,2,1,3
9030_0,,,,2,2,1,3
C(C(CO)O)(CC(C)(CCO)O)=O,,,5,1,1,0,1
9032_0,,,,2,2,1,3
C(C(CO)O)(CC(C)(CC)O)=O,,,5,1,1,0,1
9034_0,,,,2,2,1,3
C(C(CO)O)(CC(C)(C(C)O)O)=O,,,5,1,1,0,1
9036_0,,,,2,2,1,3
C(C(CO)O)(CC(CO)(CC)O)=O,,,5,1,1,0,1
9038_0,,,,2,2,1,3
C(CC(CC(C(CO)O)=O)O)=O,,,5,1,4,0,4
9040_0,,,,2,2,1,3
C(CC([CH]C(O)=O)O)(C(CO)O)=O,,,5,1,1,0,1
9042_0,,,,2,2,1,3
C(C(C=C)(CC(C(CO)O)=O)O)=O,,,5,1,1,0,1
9044_0,,,,2,2,1,3
C(CC(C(C=C)=O)O)(C(CO)O)=O,,,5,1,1,0,1
9046_0,,,,2,2,1,3
C(CC(C=C)O)(C(CO)O)=O,,,5,1,1,0,1
9048_0,,,,2,2,1,3
C(C(CO)O)(CC(C(CC)O)O)=O,,,5,1,1,0,1
9050_0,,,,2,2,1,3
C(C(CO)O)(CC(CCCO)O)=O,,,5,1,1,0,1
9052_0,,,,2,2,1,3
C(C(CO)O)(CC(C(O)O)O)=O,,,5,1,1,0,1
9053_0,,,,2,2,1,3
9054_0,,,,2,2,1,3
9055_0,,,,2,2,1,3
9056_0,,,,2,2,1,3
9057_0,,,,2,2,1,3
9058_0,,,,2,2,1,3
9059_0,,,,2,2,1,3
9060_0,,,,2,2,1,3
9061_0,,,,2,2,1,3
9062_0,,,,2,2,1,3
9063_0,,,,2,2,1,3
9064_0,,,,2,2,1,3
9065_0,,,,2,2,1,3
9066_0,,,,2,2,1,3
9067_0,,,,2,2,1,3
9068_0,,,,2,2,1,3
9069_0,,,,2,2,1,3
9070_0,,,,2,2,1,3
9071_0,,,,2,2,1,3
9072_0,,,,2,2,1,3
9073_0,,,,2,2,1,3
9074_0,,,,2,2,1,3
9074_1,,,,2,2,1,3
9076_0,,,,2,2,1,3
C(C(C(C(CO)CO)=O)CO)(O)=O,,,5,1,2,0,2
9076_1,,,,2,2,1,3
9077_0,,,,2,2,1,3
9077_1,,,,2,2,1,3
9079_0,,,,2,2,1,3
C(C(C(C(CO)C(C)O)=O)C)(O)=O,,,5,1,4,0,4
9079_1,,,,2,2,1,3
9081_0,,,,2,2,1,3
C(C(C(C(C(O)=O)CO)=O)C)(O)=O,,,5,1,4,0,4
9081_1,,,,2,2,1,3
9083_0,,,,2,2,1,3
C(C(C)C(CCO)(CC=O)O)(O)=O,,,5,1,1,0,1
9084_0,,,,2,2,1,3
9084_1,,,,2,2,1,3
9085_0,,,,2,2,1,3
9085_1,,,,2,2,1,3
9087_0,,,,2,2,1,3
C(C(C(C(CO)CO)=O)C)(O)=O,,,5,1,2,0,2
9087_1,,,,2,2,1,3
9089_0,,,,2,2,1,3
C(CC(C(C=C)C(C=CC)O)O)=O,,,5,1,1,0,1
9091_0,,,,2,2,1,3
C(CC(C(C(C=CC)O)O)O)=O,,,5,1,1,0,1
9093_0,,,,2,2,1,3
C(C(C(C(C(C=CC)O)O)O)O)=O,,,5,1,2,0,2
9093_1,,,,2,2,1,3
9095_0,,,,2,2,1,3
C(C)(C(C)C(CC(C=CC)O)O)=O,,,5,1,1,0,1
9097_0,,,,2,2,1,3
C(CC(CC(C=CC)O)O)(CC)=O,,,5,1,1,0,1
9099_0,,,,2,2,1,3
C(C(C=O)C(CC(C=CC)O)O)=O,,,5,1,2,0,2
9099_1,,,,2,2,1,3
9101_0,,,,2,2,1,3
C(CC(CC(C=CC)O)O)=O,,,5,1,2,0,2
9103_0,,,,2,2,1,3
C(C(CC(CC(C=O)=O)O)O)=CC,,,5,1,1,0,1
9105_0,,,,2,2,1,3
C(C(CO)C(CC(C=CC)O)O)=O,,,5,1,2,0,2
9105_1,,,,2,2,1,3
9107_0,,,,2,2,1,3
C(CO)(CC(CC(C=CC)O)O)=O,,,5,1,1,0,1
9109_0,,,,2,2,1,3
C(C)(C(C(CC(C=CC)O)O)O)=O,,,5,1,2,0,2
9109_1,,,,2,2,1,3
9111_0,,,,2,2,1,3
C(C(C=C)C(CC(C=CC)O)O)=O,,,5,1,1,0,1
9113_0,,,,2,2,1,3
C(C(C(CC(C=CC)O)O)O)=O,,,5,1,3,0,3
9113_1,,,,2,2,1,3
9115_0,,,,2,2,1,3
C(C([C](C(O)=O)O)C(C=CC)O)=O,,,5,1,2,0,2
9115_1,,,,2,2,1,3
9117_0,,,,2,2,1,3
C(C(C(C)(CC)O)C(C=CC)O)=O,,,5,1,2,0,2
9117_1,,,,2,2,1,3
9119_0,,,,2,2,1,3
C(CC(C(C=O)C(C=CC)O)O)=O,,,5,1,2,0,2
9119_1,,,,2,2,1,3
9121_0,,,,2,2,1,3
C(C(C=C)(C(C=O)C(C=CC)O)O)=O,,,5,1,2,0,2
9121_1,,,,2,2,1,3
9123_0,,,,2,2,1,3
C(C(C(C=CC)O)C(C(C=C)=O)O)=O,,,5,1,2,0,2
9123_1,,,,2,2,1,3
9125_0,,,,2,2,1,3
C(C(C(C=CC)O)C(C=C)O)=O,,,5,1,2,0,2
9125_1,,,,2,2,1,3
9127_0,,,,2,2,1,3
C(C(C(C(O)O)O)C(C=CC)O)=O,,,5,1,2,0,2
9127_1,,,,2,2,1,3
9128_0,,,,2,2,1,3
9128_1,,,,2,2,1,3
9129_0,,,,2,2,1,3
9129_1,,,,2,2,1,3
9130_0,,,,2,2,1,3
9130_1,,,,2,2,1,3
9131_0,,,,2,2,1,3
9131_1,,,,2,2,1,3
9132_0,,,,2,2,1,3
9132_1,,,,2,2,1,3
9133_0,,,,2,2,1,3
9133_1,,,,2,2,1,3
9134_0,,,,2,2,1,3
9134_1,,,,2,2,1,3
9135_0,,,,2,2,1,3
9135_1,,,,2,2,1,3
9137_0,,,,2,2,1,3
C(C(C(C=CC)O)C(C=CC)O)=O,,,5,1,2,0,2
9137_1,,,,2,2,1,3
9139_0,,,,2,2,1,3
C(C(C(CC=C)O)C(C=CC)O)=O,,,5,1,4,0,4
9139_1,,,,2,2,1,3
9141_0,,,,2,2,1,3
C(C(C(CO)O)C(C=CC)O)=O,,,5,1,5,0,5
9141_1,,,,2,2,1,3
9143_0,,,,2,2,1,3
C(C(C(C(C)O)O)C(C=CC)O)=O,,,5,1,4,0,4
9143_1,,,,2,2,1,3
9145_0,,,,2,2,1,3
C(C(C(C=O)C(C=CC)O)O)(O)=O,,,5,1,4,0,4
9145_1,,,,2,2,1,3
9147_0,,,,2,2,1,3
C(C(CC(C=CC)O)(CC=O)O)=O,,,5,1,1,0,1
9148_0,,,,2,2,1,3
9150_0,,,,2,2,1,3
C=CC(C(C(C=O)=O)C(C=CC)O)O,,,5,1,2,0,2
9150_1,,,,2,2,1,3
9151_0,,,,2,2,1,3
9151_1,,,,2,2,1,3
9152_0,,,,2,2,1,3
9152_1,,,,2,2,1,3
9153_0,,,,2,2,1,3
9153_1,,,,2,2,1,3
9154_0,,,,2,2,1,3
9154_1,,,,2,2,1,3
9156_0,,,,2,2,1,3
C(CC(C(C=C)C(CC=C)O)O)=O,,,5,1,1,0,1
9158_0,,,,2,2,1,3
C(CC(C(C(CC=C)O)O)O)=O,,,5,1,1,0,1
9160_0,,,,2,2,1,3
C(C(C(C(C(CC=C)O)O)O)O)=O,,,5,1,2,0,2
9160_1,,,,2,2,1,3
9162_0,,,,2,2,1,3
C(C)(C(C)C(CC(CC=C)O)O)=O,,,5,1,1,0,1
9164_0,,,,2,2,1,3
C(CC(CC(CC=C)O)O)(CC)=O,,,5,1,1,0,1
9166_0,,,,2,2,1,3
C(C(C=O)C(CC(CC=C)O)O)=O,,,5,1,2,0,2
9166_1,,,,2,2,1,3
9168_0,,,,2,2,1,3
C(CC(CC(CC=C)O)O)=O,,,5,1,2,0,2
9170_0,,,,2,2,1,3
C=CCC(CC(CC(C=O)=O)O)O,,,5,1,1,0,1
9172_0,,,,2,2,1,3
C(C(CO)C(CC(CC=C)O)O)=O,,,5,1,2,0,2
9172_1,,,,2,2,1,3
9174_0,,,,2,2,1,3
C(CO)(CC(CC(CC=C)O)O)=O,,,5,1,1,0,1
9176_0,,,,2,2,1,3
C(C)(C(C(CC(CC=C)O)O)O)=O,,,5,1,2,0,2
9176_1,,,,2,2,1,3
9178_0,,,,2,2,1,3
C(C(C=C)C(CC(CC=C)O)O)=O,,,5,1,1,0,1
9180_0,,,,2,2,1,3
C(C(C(CC(CC=C)O)O)O)=O,,,5,1,3,0,3
9180_1,,,,2,2,1,3
9182_0,,,,2,2,1,3
C(C([C](C(O)=O)O)C(CC=C)O)=O,,,5,1,2,0,2
9182_1,,,,2,2,1,3
9184_0,,,,2,2,1,3
C(C(C(CC=C)O)C(C)(CC)O)=O,,,5,1,2,0,2
9184_1,,,,2,2,1,3
9186_0,,,,2,2,1,3
C(C(C(CC=C)O)C(CC=O)O)=O,,,5,1,2,0,2
9186_1,,,,2,2,1,3
9188_0,,,,2,2,1,3
C(C(C=C)(C(C=O)C(CC=C)O)O)=O,,,5,1,2,0,2
9188_1,,,,2,2,1,3
9190_0,,,,2,2,1,3
C(C(C(CC=C)O)C(C(C=C)=O)O)=O,,,5,1,2,0,2
9190_1,,,,2,2,1,3
9192_0,,,,2,2,1,3
C(C(C(CC=C)O)C(C=C)O)=O,,,5,1,2,0,2
9192_1,,,,2,2,1,3
9194_0,,,,2,2,1,3
C(C(C(CC=C)O)C(C(O)O)O)=O,,,5,1,2,0,2
9194_1,,,,2,2,1,3
9195_0,,,,2,2,1,3
9195_1,,,,2,2,1,3
9196_0,,,,2,2,1,3
9196_1,,,,2,2,1,3
9197_0,,,,2,2,1,3
9197_1,,,,2,2,1,3
9198_0,,,,2,2,1,3
9198_1,,,,2,2,1,3
9199_0,,,,2,2,1,3
9199_1,,,,2,2,1,3
9200_0,,,,2,2,1,3
9200_1,,,,2,2,1,3
9201_0,,,,2,2,1,3
9201_1,,,,2,2,1,3
9202_0,,,,2,2,1,3
9202_1,,,,2,2,1,3
9203_0,,,,2,2,1,3
9203_1,,,,2,2,1,3
9205_0,,,,2,2,1,3
C(C(C(CC=C)O)C(CC=C)O)=O,,,5,1,2,0,2
9205_1,,,,2,2,1,3
9207_0,,,,2,2,1,3
C(C(C(CC=C)O)C(CO)O)=O,,,5,1,5,0,5
9207_1,,,,2,2,1,3
9209_0,,,,2,2,1,3
C(C(C(CC=C)O)C(C(C)O)O)=O,,,5,1,4,0,4
9209_1,,,,2,2,1,3
9211_0,,,,2,2,1,3
C(C(C(CC=C)O)C(C(O)=O)O)=O,,,5,1,4,0,4
9211_1,,,,2,2,1,3
9213_0,,,,2,2,1,3
C(C(CC(CC=C)O)(CC=O)O)=O,,,5,1,1,0,1
9214_0,,,,2,2,1,3
9216_0,,,,2,2,1,3
C(CC(C(C(C=O)=O)C(C=C)O)O)=C,,,5,1,2,0,2
9216_1,,,,2,2,1,3
9217_0,,,,2,2,1,3
9217_1,,,,2,2,1,3
9218_0,,,,2,2,1,3
9218_1,,,,2,2,1,3
9219_0,,,,2,2,1,3
9219_1,,,,2,2,1,3
9220_0,,,,2,2,1,3
9220_1,,,,2,2,1,3
9222_0,,,,2,2,1,3
C(CC(C(C=C)C(CO)O)O)=O,,,5,1,1,0,1
9224_0,,,,2,2,1,3
C(C(C(C(C=C)C(CO)O)O)O)=O,,,5,1,2,0,2
9224_1,,,,2,2,1,3
9226_0,,,,2,2,1,3
C(CC(C(C=C)C(C(C)O)O)O)=O,,,5,1,1,0,1
9228_0,,,,2,2,1,3
C(CC(C(C=C)C(C(O)=O)O)O)=O,,,5,1,1,0,1
9230_0,,,,2,2,1,3
C(C)(C(C)C(C(C=C)C(C)O)O)=O,,,5,1,1,0,1
9232_0,,,,2,2,1,3
C(CC)(CC(C(C=C)C(C)O)O)=O,,,5,1,1,0,1
9234_0,,,,2,2,1,3
C(C(C=O)C(C(C=C)C(C)O)O)=O,,,5,1,2,0,2
9234_1,,,,2,2,1,3
9236_0,,,,2,2,1,3
C(CC(C(C=C)C(C)O)O)=O,,,5,1,2,0,2
9238_0,,,,2,2,1,3
C(C(C(CC(C=O)=O)O)C(C)O)=C,,,5,1,1,0,1
9240_0,,,,2,2,1,3
C(C(CO)C(C(C=C)C(C)O)O)=O,,,5,1,2,0,2
9240_1,,,,2,2,1,3
9242_0,,,,2,2,1,3
C(CO)(CC(C(C=C)C(C)O)O)=O,,,5,1,1,0,1
9244_0,,,,2,2,1,3
C(C)(C(C(C(C=C)C(C)O)O)O)=O,,,5,1,2,0,2
9244_1,,,,2,2,1,3
9246_0,,,,2,2,1,3
C(C(C=C)C(C(C=C)C(C)O)O)=O,,,5,1,1,0,1
9248_0,,,,2,2,1,3
C(C(C(C(C=C)C(C)O)O)O)=O,,,5,1,3,0,3
9248_1,,,,2,2,1,3
9250_0,,,,2,2,1,3
C(C(C=C)C(C(C(C)=O)C)O)(O)=O,,,5,1,1,0,1
9252_0,,,,2,2,1,3
C(C(C=C)C(CC(CC)=O)O)(O)=O,,,5,1,1,0,1
9254_0,,,,2,2,1,3
C(C(C=C)C(C(C=O)C=O)O)(O)=O,,,5,1,2,0,2
9254_1,,,,2,2,1,3
9256_0,,,,2,2,1,3
C(C(C=C)C(CC=O)O)(O)=O,,,5,1,2,0,2
9258_0,,,,2,2,1,3
C(C(C=C)C(CC(C=O)=O)O)(O)=O,,,5,1,1,0,1
9260_0,,,,2,2,1,3
C(C(C=C)C(C(C=O)CO)O)(O)=O,,,5,1,2,0,2
9260_1,,,,2,2,1,3
9262_0,,,,2,2,1,3
C(C(C=C)C(CC(CO)=O)O)(O)=O,,,5,1,1,0,1
9264_0,,,,2,2,1,3
C(C(C=C)C(C(C(C)=O)O)O)(O)=O,,,5,1,2,0,2
9264_1,,,,2,2,1,3
9266_0,,,,2,2,1,3
C(C(C=C)C(C(C(O)=O)C=C)O)=O,,,5,1,1,0,1
9268_0,,,,2,2,1,3
C(C(C=C)C(C(C=O)O)O)(O)=O,,,5,1,4,0,4
9268_1,,,,2,2,1,3
9269_0,,,,2,2,1,3
9269_1,,,,2,2,1,3
9270_0,,,,2,2,1,3
9272_0,,,,2,2,1,3
C(CC(C(C=C)C(C=O)(C)O)O)=O,,,5,1,1,0,1
9273_0,,,,2,2,1,3
9275_0,,,,2,2,1,3
C(CC(C(C=C)C(C(C)=O)O)O)=O,,,5,1,1,0,1
9277_0,,,,2,2,1,3
C(C(C=C)C(C(CC(C=C)O)=O)O)=O,,,5,1,1,0,1
9278_0,,,,2,2,1,3
9279_0,,,,2,2,1,3
9280_0,,,,2,2,1,3
9282_0,,,,2,2,1,3
C(C(CO)C(CC(C(C=C)=O)=O)O)=C,,,5,1,1,0,1
9284_0,,,,2,2,1,3
C(C(CO)C(CC(C(C)=O)=O)O)=C,,,5,1,2,0,2
9286_0,,,,2,2,1,3
C(CCO)(CC(C(C=C)CO)O)=O,,,5,1,1,0,1
9288_0,,,,2,2,1,3
C(C)(C(CO)C(C(C=C)CO)O)=O,,,5,1,2,0,2
9288_1,,,,2,2,1,3
9290_0,,,,2,2,1,3
C(C)(C(C)C(C(C=C)CO)O)=O,,,5,1,1,0,1
9292_0,,,,2,2,1,3
C(CC(C(C=C)CO)O)(CC)=O,,,5,1,1,0,1
9294_0,,,,2,2,1,3
C(C(C)O)(CC(C(C=C)CO)O)=O,,,5,1,1,0,1
9296_0,,,,2,2,1,3
C(C(C(C(C=C)CO)O)O)(CC)=O,,,5,1,2,0,2
9296_1,,,,2,2,1,3
9298_0,,,,2,2,1,3
C(CO)(C(C)C(C(C=C)CO)O)=O,,,5,1,1,0,1
9300_0,,,,2,2,1,3
C(C(C=O)C(C(C=C)CO)O)=O,,,5,1,2,0,2
9300_1,,,,2,2,1,3
9302_0,,,,2,2,1,3
C(C(C(C=O)=C)C(C(C=C)CO)O)=O,,,5,1,1,0,1
9304_0,,,,2,2,1,3
C(C(CO)C(CC(C=CC=O)=O)O)=C,,,5,1,1,0,1
9306_0,,,,2,2,1,3
C=CC(C(C=O)=O)C(C(C=C)CO)O,,,5,1,1,0,1
9308_0,,,,2,2,1,3
C(C(C(C(C=C)CO)O)CCO)=O,,,5,1,1,0,1
9310_0,,,,2,2,1,3
C(CC(C(C=C)CO)O)=O,,,5,1,2,0,2
9312_0,,,,2,2,1,3
C(C(C(C(C=C)CO)O)C(C)O)=O,,,5,1,2,0,2
9312_1,,,,2,2,1,3
9314_0,,,,2,2,1,3
C(C(C=O)C(C(C=C)CO)O)(O)=O,,,5,1,2,0,2
9314_1,,,,2,2,1,3
9316_0,,,,2,2,1,3
C(C(CO)C(C(C(C=O)=O)O)O)=C,,,5,1,2,0,2
9316_1,,,,2,2,1,3
9318_0,,,,2,2,1,3
C(C(CO)C(CC(C=O)=O)O)=C,,,5,1,2,0,2
9320_0,,,,2,2,1,3
C(C(CO)C(C(C=C)CO)O)=O,,,5,1,3,0,3
9320_1,,,,2,2,1,3
9322_0,,,,2,2,1,3
C(CO)(C(C(C(C=C)CO)O)O)=O,,,5,1,2,0,2
9322_1,,,,2,2,1,3
9324_0,,,,2,2,1,3
C(CO)(CC(C(C=C)CO)O)=O,,,5,1,2,0,2
9326_0,,,,2,2,1,3
C(C)(C(C(C(C=C)CO)O)O)=O,,,5,1,3,0,3
9326_1,,,,2,2,1,3
9328_0,,,,2,2,1,3
C(C(C=C)C(C(C=C)CO)O)=O,,,5,1,2,0,2
9330_0,,,,2,2,1,3
C(C(C(C(C=C)CO)O)O)=O,,,5,1,4,0,4
9330_1,,,,2,2,1,3
9332_0,,,,2,2,1,3
C(C(CO)C(CC(C(O)=O)=O)O)=C,,,5,1,1,0,1
9333_0,,,,2,2,1,3
9333_1,,,,2,2,1,3
9334_0,,,,2,2,1,3
9334_1,,,,2,2,1,3
9336_0,,,,2,2,1,3
C(CC(C(O)=O)(C(C=C)CO)O)=O,,,5,1,1,0,1
9337_0,,,,2,2,1,3
9337_1,,,,2,2,1,3
9339_0,,,,2,2,1,3
C(CC(C(C(C(O)=O)=C)CO)O)=O,,,5,1,1,0,1
9340_0,,,,2,2,1,3
9340_1,,,,2,2,1,3
9342_0,,,,2,2,1,3
C(CC(C(C(C(CO)O)O)O)O)=O,,,5,1,2,0,2
9344_0,,,,2,2,1,3
C(CC(CC(C(CO)O)O)O)=O,,,5,1,2,0,2
9346_0,,,,2,2,1,3
C(C(C(CC(C(CO)O)O)O)O)=O,,,5,1,3,0,3
9346_1,,,,2,2,1,3
9348_0,,,,2,2,1,3
C(C(C(C(CO)O)O)C(C=C)O)=O,,,5,1,2,0,2
9348_1,,,,2,2,1,3
9349_0,,,,2,2,1,3
9349_1,,,,2,2,1,3
9350_0,,,,2,2,1,3
9350_1,,,,2,2,1,3
9351_0,,,,2,2,1,3
9351_1,,,,2,2,1,3
9352_0,,,,2,2,1,3
9352_1,,,,2,2,1,3
9354_0,,,,2,2,1,3
C(C(C(CO)O)C(C(CO)O)O)=O,,,5,1,5,0,5
9354_1,,,,2,2,1,3
9355_0,,,,2,2,1,3
9355_1,,,,2,2,1,3
9357_0,,,,2,2,1,3
C(C)(C(C)C(C(C(CO)O)O)O)=O,,,5,1,1,0,1
9359_0,,,,2,2,1,3
C(CC(C(C(CO)O)O)O)(CC)=O,,,5,1,1,0,1
9361_0,,,,2,2,1,3
C(C(C=O)C(C(C(CO)O)O)O)=O,,,5,1,2,0,2
9361_1,,,,2,2,1,3
9363_0,,,,2,2,1,3
C(CC(C(C(CO)O)O)O)=O,,,5,1,2,0,2
9365_0,,,,2,2,1,3
C(C(CC(C(C(CO)O)O)O)=O)=O,,,5,1,2,0,2
9367_0,,,,2,2,1,3
C(C(CO)C(C(C(CO)O)O)O)=O,,,5,1,3,0,3
9367_1,,,,2,2,1,3
9369_0,,,,2,2,1,3
C(CO)(CC(C(C(CO)O)O)O)=O,,,5,1,2,0,2
9371_0,,,,2,2,1,3
C(C)(C(C(C(C(CO)O)O)O)O)=O,,,5,1,3,0,3
9371_1,,,,2,2,1,3
9373_0,,,,2,2,1,3
C(C(C=C)C(C(C(CO)O)O)O)=O,,,5,1,2,0,2
9375_0,,,,2,2,1,3
C(C(C(C(C(CO)O)O)O)O)=O,,,5,1,8,0,8
9375_1,,,,2,2,1,3
9377_0,,,,2,2,1,3
C(C(C)=O)(CC(CC(CO)O)O)=O,,,5,1,1,0,1
9379_0,,,,2,2,1,3
C(CC(CC(CO)O)O)(CCO)=O,,,5,1,1,0,1
9381_0,,,,2,2,1,3
C(C)(C(CO)C(CC(CO)O)O)=O,,,5,1,2,0,2
9381_1,,,,2,2,1,3
9383_0,,,,2,2,1,3
C(C)(C(C)C(CC(CO)O)O)=O,,,5,1,1,0,1
9385_0,,,,2,2,1,3
C(CC(CC(CO)O)O)(CC)=O,,,5,1,1,0,1
9387_0,,,,2,2,1,3
C(C(C)O)(CC(CC(CO)O)O)=O,,,5,1,1,0,1
9389_0,,,,2,2,1,3
C(C(C(CC(CO)O)O)O)(CC)=O,,,5,1,2,0,2
9389_1,,,,2,2,1,3
9391_0,,,,2,2,1,3
C(CO)(C(C)C(CC(CO)O)O)=O,,,5,1,1,0,1
9393_0,,,,2,2,1,3
C(C(C=O)C(CC(CO)O)O)=O,,,5,1,2,0,2
9393_1,,,,2,2,1,3
9395_0,,,,2,2,1,3
C(C(CCO)C(CC(CO)O)O)=O,,,5,1,1,0,1
9397_0,,,,2,2,1,3
C(CC(CC(CO)O)O)=O,,,5,1,1,0,1
9399_0,,,,2,2,1,3
C(C(C(C)O)C(CC(CO)O)O)=O,,,5,1,2,0,2
9399_1,,,,2,2,1,3
9401_0,,,,2,2,1,3
C(C(C=O)C(CC(CO)O)O)(O)=O,,,5,1,2,0,2
9401_1,,,,2,2,1,3
9403_0,,,,2,2,1,3
C(C(C(C(CC(CO)O)O)O)=O)=O,,,5,1,2,0,2
9403_1,,,,2,2,1,3
9405_0,,,,2,2,1,3
C(C(CC(CC(CO)O)O)=O)=O,,,5,1,1,0,1
9407_0,,,,2,2,1,3
C(C(CO)C(CC(CO)O)O)=O,,,5,1,2,0,2
9407_1,,,,2,2,1,3
9409_0,,,,2,2,1,3
C(CO)(C(C(CC(CO)O)O)O)=O,,,5,1,2,0,2
9409_1,,,,2,2,1,3
9411_0,,,,2,2,1,3
C(CO)(CC(CC(CO)O)O)=O,,,5,1,1,0,1
9413_0,,,,2,2,1,3
C(C)(C(C(CC(CO)O)O)O)=O,,,5,1,2,0,2
9413_1,,,,2,2,1,3
9415_0,,,,2,2,1,3
C(C(C=C)C(CC(CO)O)O)=O,,,5,1,1,0,1
9417_0,,,,2,2,1,3
C(C(C(CC(CO)O)O)O)=O,,,5,1,2,0,2
9417_1,,,,2,2,1,3
9419_0,,,,2,2,1,3
C(C(CC(CC(CO)O)O)=O)(O)=O,,,5,1,1,0,1
9421_0,,,,2,2,1,3
C(C(C(CO)O)C(C(C=O)=O)O)=O,,,5,1,2,0,2
9421_1,,,,2,2,1,3
9423_0,,,,2,2,1,3
C(C(C=O)(C(C=O)C(CO)O)O)=O,,,5,1,2,0,2
9423_1,,,,2,2,1,3
9425_0,,,,2,2,1,3
C(C(C(CO)O)C(C(C)=O)(C)O)=O,,,5,1,2,0,2
9425_1,,,,2,2,1,3
9427_0,,,,2,2,1,3
C(C([C](C(O)=O)O)C(CO)O)=O,,,5,1,2,0,2
9427_1,,,,2,2,1,3
9429_0,,,,2,2,1,3
C(C(C(CO)O)C(C)(CCO)O)=O,,,5,1,2,0,2
9429_1,,,,2,2,1,3
9431_0,,,,2,2,1,3
C(C(C(CO)O)C(C)(CC)O)=O,,,5,1,2,0,2
9431_1,,,,2,2,1,3
9433_0,,,,2,2,1,3
C(C(C(CO)O)C(C)(C(C)O)O)=O,,,5,1,2,0,2
9433_1,,,,2,2,1,3
9435_0,,,,2,2,1,3
C(C(C(CO)O)C(CO)(CC)O)=O,,,5,1,2,0,2
9435_1,,,,2,2,1,3
9437_0,,,,2,2,1,3
C(C(C(CC=O)O)C(CO)O)=O,,,5,1,2,0,2
9437_1,,,,2,2,1,3
9439_0,,,,2,2,1,3
C(C(C(CO)O)C([CH]C(O)=O)O)=O,,,5,1,2,0,2
9439_1,,,,2,2,1,3
9441_0,,,,2,2,1,3
C(C(C=C)(C(C=O)C(CO)O)O)=O,,,5,1,2,0,2
9441_1,,,,2,2,1,3
9443_0,,,,2,2,1,3
C(C(C(CO)O)C(C(C=C)=O)O)=O,,,5,1,2,0,2
9443_1,,,,2,2,1,3
9445_0,,,,2,2,1,3
C(C(C(CO)O)C(C=C)O)=O,,,5,1,2,0,2
9445_1,,,,2,2,1,3
9447_0,,,,2,2,1,3
C(C(C(CO)O)C(C(CC)O)O)=O,,,5,1,2,0,2
9447_1,,,,2,2,1,3
9449_0,,,,2,2,1,3
C(C(C(CO)O)C(CCCO)O)=O,,,5,1,2,0,2
9449_1,,,,2,2,1,3
9451_0,,,,2,2,1,3
C(C(C(CO)O)C(C(O)O)O)=O,,,5,1,2,0,2
9451_1,,,,2,2,1,3
9452_0,,,,2,2,1,3
9452_1,,,,2,2,1,3
9453_0,,,,2,2,1,3
9453_1,,,,2,2,1,3
9454_0,,,,2,2,1,3
9454_1,,,,2,2,1,3
9455_0,,,,2,2,1,3
9455_1,,,,2,2,1,3
9456_0,,,,2,2,1,3
9456_1,,,,2,2,1,3
9457_0,,,,2,2,1,3
9457_1,,,,2,2,1,3
9458_0,,,,2,2,1,3
9458_1,,,,2,2,1,3
9459_0,,,,2,2,1,3
9459_1,,,,2,2,1,3
9460_0,,,,2,2,1,3
9460_1,,,,2,2,1,3
9461_0,,,,2,2,1,3
9461_1,,,,2,2,1,3
9462_0,,,,2,2,1,3
9462_1,,,,2,2,1,3
9463_0,,,,2,2,1,3
9463_1,,,,2,2,1,3
9464_0,,,,2,2,1,3
9464_1,,,,2,2,1,3
9465_0,,,,2,2,1,3
9465_1,,,,2,2,1,3
9466_0,,,,2,2,1,3
9466_1,,,,2,2,1,3
9467_0,,,,2,2,1,3
9467_1,,,,2,2,1,3
9468_0,,,,2,2,1,3
9468_1,,,,2,2,1,3
9470_0,,,,2,2,1,3
C(C(C(CO)O)C(CO)O)=O,,,5,1,2,0,2
9470_1,,,,2,2,1,3
9472_0,,,,2,2,1,3
C(C(C(CO)O)C(C(C)O)O)=O,,,5,1,4,0,4
9472_1,,,,2,2,1,3
9474_0,,,,2,2,1,3
C(C(C(CO)O)C(C(O)=O)O)=O,,,5,1,4,0,4
9474_1,,,,2,2,1,3
9475_0,,,,2,2,1,3
9475_1,,,,2,2,1,3
9477_0,,,,2,2,1,3
C(CC(C(C(CO)O)C(C)O)O)=O,,,5,1,1,0,1
9478_0,,,,2,2,1,3
9479_0,,,,2,2,1,3
9481_0,,,,2,2,1,3
C(C(C(C(CO)O)O)(CC=O)O)=O,,,5,1,2,0,2
9483_0,,,,2,2,1,3
C(C(CC(CO)O)(CC=O)O)=O,,,5,1,1,0,1
9485_0,,,,2,2,1,3
C(C(CC(CO)O)(C(C=O)O)O)=O,,,5,1,2,0,2
9485_1,,,,2,2,1,3
9486_0,,,,2,2,1,3
9487_0,,,,2,2,1,3
9487_1,,,,2,2,1,3
9489_0,,,,2,2,1,3
C=CC(C(C(C=O)=O)C(CO)O)O,,,5,1,2,0,2
9489_1,,,,2,2,1,3
9490_0,,,,2,2,1,3
9490_1,,,,2,2,1,3
9491_0,,,,2,2,1,3
9491_1,,,,2,2,1,3
9492_0,,,,2,2,1,3
9492_1,,,,2,2,1,3
9493_0,,,,2,2,1,3
9493_1,,,,2,2,1,3
9495_0,,,,2,2,1,3
C(C(C(C(CO)O)C(CO)O)=O)=O,,,5,1,2,0,2
9495_1,,,,2,2,1,3
9497_0,,,,2,2,1,3
C(C(CC(CO)O)(CC=O)O)(O)=O,,,5,1,2,0,2
9498_0,,,,2,2,1,3
9498_1,,,,2,2,1,3
9499_0,,,,2,2,1,3
9499_1,,,,2,2,1,3
9500_0,,,,2,2,1,3
9500_1,,,,2,2,1,3
9502_0,,,,2,2,1,3
C(CC(C(C(C(C)O)O)O)O)=O,,,5,1,2,0,2
9504_0,,,,2,2,1,3
C(C(C(C(C(C(C)O)O)O)O)O)=O,,,5,1,3,0,3
9504_1,,,,2,2,1,3
9506_0,,,,2,2,1,3
C(CC(C(C(C(O)=O)O)O)O)=O,,,5,1,3,0,3
9508_0,,,,2,2,1,3
C(C(C(C(C(C=O)O)O)O)O)(O)=O,,,5,1,11,0,11
9508_1,,,,2,2,1,3
9510_0,,,,2,2,1,3
C(C(C)=O)(CC(C(C(C)O)O)O)=O,,,5,1,1,0,1
9512_0,,,,2,2,1,3
C(CC(C(C(C)O)O)O)(CCO)=O,,,5,1,1,0,1
9514_0,,,,2,2,1,3
C(C)(C(CO)C(C(C(C)O)O)O)=O,,,5,1,2,0,2
9514_1,,,,2,2,1,3
9516_0,,,,2,2,1,3
C(C)(C(C)C(C(C(C)O)O)O)=O,,,5,1,1,0,1
9518_0,,,,2,2,1,3
C(CC(C(C(C)O)O)O)(CC)=O,,,5,1,1,0,1
9520_0,,,,2,2,1,3
C(C(C)O)(CC(C(C(C)O)O)O)=O,,,5,1,1,0,1
9522_0,,,,2,2,1,3
C(C(C(C(C(C)O)O)O)O)(CC)=O,,,5,1,2,0,2
9522_1,,,,2,2,1,3
9524_0,,,,2,2,1,3
C(CO)(C(C)C(C(C(C)O)O)O)=O,,,5,1,1,0,1
9526_0,,,,2,2,1,3
C(C(C=O)C(C(C(C)O)O)O)=O,,,5,1,2,0,2
9526_1,,,,2,2,1,3
9528_0,,,,2,2,1,3
C(C(CCO)C(C(C(C)O)O)O)=O,,,5,1,1,0,1
9530_0,,,,2,2,1,3
C(CC(C(C(C)O)O)O)=O,,,5,1,1,0,1
9532_0,,,,2,2,1,3
C(C(C(C)O)C(C(C(C)O)O)O)=O,,,5,1,2,0,2
9532_1,,,,2,2,1,3
9534_0,,,,2,2,1,3
C(C(C=O)C(C(C(C)O)O)O)(O)=O,,,5,1,2,0,2
9534_1,,,,2,2,1,3
9536_0,,,,2,2,1,3
C(C(C(C(C(C(C)O)O)O)O)=O)=O,,,5,1,2,0,2
9536_1,,,,2,2,1,3
9538_0,,,,2,2,1,3
C(C(CC(C(C(C)O)O)O)=O)=O,,,5,1,2,0,2
9540_0,,,,2,2,1,3
C(C(CO)C(C(C(C)O)O)O)=O,,,5,1,2,0,2
9540_1,,,,2,2,1,3
9542_0,,,,2,2,1,3
C(CO)(C(C(C(C(C)O)O)O)O)=O,,,5,1,2,0,2
9542_1,,,,2,2,1,3
9544_0,,,,2,2,1,3
C(CO)(CC(C(C(C)O)O)O)=O,,,5,1,1,0,1
9546_0,,,,2,2,1,3
C(C)(C(C(C(C(C)O)O)O)O)=O,,,5,1,2,0,2
9546_1,,,,2,2,1,3
9548_0,,,,2,2,1,3
C(C(C=C)C(C(C(C)O)O)O)=O,,,5,1,1,0,1
9550_0,,,,2,2,1,3
C(C(C(C(C(C)O)O)O)O)=O,,,5,1,5,0,5
9550_1,,,,2,2,1,3
9552_0,,,,2,2,1,3
C(C(CC(C(C(C)O)O)O)=O)(O)=O,,,5,1,2,0,2
9554_0,,,,2,2,1,3
C(CC(C(C(CC(C)O)O)O)O)=O,,,5,1,1,0,1
9556_0,,,,2,2,1,3
C(CC(C(C(CC=O)O)O)O)(O)=O,,,5,1,1,0,1
9557_0,,,,2,2,1,3
9559_0,,,,2,2,1,3
C(C(CO)(C(C(CC=O)O)O)O)=O,,,5,1,3,0,3
9560_0,,,,2,2,1,3
9561_0,,,,2,2,1,3
9561_1,,,,2,2,1,3
9563_0,,,,2,2,1,3
C(C(C)(C(C(CC=O)O)O)O)=O,,,5,1,2,0,2
9565_0,,,,2,2,1,3
C(C(C)(C(C(C(C=O)O)O)O)O)=O,,,5,1,3,0,3
9565_1,,,,2,2,1,3
9567_0,,,,2,2,1,3
C(C(C)(C(C(CC=O)O)O)O)(O)=O,,,5,1,2,0,2
9568_0,,,,2,2,1,3
9568_1,,,,2,2,1,3
9570_0,,,,2,2,1,3
C1(C(C(CO)C(C)O1)(CC=O)O)=O,,,5,1,1,0,1
9571_0,,,,2,2,1,3
9571_1,,,,2,2,1,3
9573_0,,,,2,2,1,3
C1(C(CO)C(C(O1)=O)(CC=O)O)=O,,,5,1,2,0,2
9575_0,,,,2,2,1,3
C(CC(C(CO)C[CH]C(O)=O)O)=O,,,5,1,2,0,2
9577_0,,,,2,2,1,3
C(CCC(CO)C(CC=O)O)(O)=O,,,5,1,2,0,2
9579_0,,,,2,2,1,3
C(C)(C(C)C(CC(C(C)O)O)O)=O,,,5,1,1,0,1
9581_0,,,,2,2,1,3
C(CC(CC(C(C)O)O)O)(CC)=O,,,5,1,1,0,1
9583_0,,,,2,2,1,3
C(C(C=O)C(CC(C(C)O)O)O)=O,,,5,1,2,0,2
9583_1,,,,2,2,1,3
9585_0,,,,2,2,1,3
C(CC(CC(C(C)O)O)O)=O,,,5,1,1,0,1
9587_0,,,,2,2,1,3
C(C(CC(CC(C(C)O)O)O)=O)=O,,,5,1,1,0,1
9589_0,,,,2,2,1,3
C(C(CO)C(CC(C(C)O)O)O)=O,,,5,1,2,0,2
9589_1,,,,2,2,1,3
9591_0,,,,2,2,1,3
C(CO)(CC(CC(C(C)O)O)O)=O,,,5,1,1,0,1
9593_0,,,,2,2,1,3
C(C)(C(C(CC(C(C)O)O)O)O)=O,,,5,1,2,0,2
9593_1,,,,2,2,1,3
9595_0,,,,2,2,1,3
C(C(C=C)C(CC(C(C)O)O)O)=O,,,5,1,1,0,1
9597_0,,,,2,2,1,3
C(C(C(CC(C(C)O)O)O)O)=O,,,5,1,2,0,2
9597_1,,,,2,2,1,3
9599_0,,,,2,2,1,3
C(C([C](C(O)=O)O)C(C(C)O)O)=O,,,5,1,2,0,2
9599_1,,,,2,2,1,3
9601_0,,,,2,2,1,3
C(C(C(C(C)O)O)C(C)(CC)O)=O,,,5,1,2,0,2
9601_1,,,,2,2,1,3
9603_0,,,,2,2,1,3
C(C(C(CC=O)O)C(C(C)O)O)=O,,,5,1,2,0,2
9603_1,,,,2,2,1,3
9605_0,,,,2,2,1,3
C(C(C(C(C)O)O)C(C=C)O)=O,,,5,1,2,0,2
9605_1,,,,2,2,1,3
9607_0,,,,2,2,1,3
C(C(C(C(O)O)O)C(C(C)O)O)=O,,,5,1,2,0,2
9607_1,,,,2,2,1,3
9608_0,,,,2,2,1,3
9608_1,,,,2,2,1,3
9609_0,,,,2,2,1,3
9609_1,,,,2,2,1,3
9610_0,,,,2,2,1,3
9610_1,,,,2,2,1,3
9611_0,,,,2,2,1,3
9611_1,,,,2,2,1,3
9612_0,,,,2,2,1,3
9612_1,,,,2,2,1,3
9613_0,,,,2,2,1,3
9613_1,,,,2,2,1,3
9614_0,,,,2,2,1,3
9614_1,,,,2,2,1,3
9615_0,,,,2,2,1,3
9615_1,,,,2,2,1,3
9616_0,,,,2,2,1,3
9616_1,,,,2,2,1,3
9617_0,,,,2,2,1,3
9617_1,,,,2,2,1,3
9618_0,,,,2,2,1,3
9618_1,,,,2,2,1,3
9620_0,,,,2,2,1,3
C(C(C(C(C)O)O)C(C(C)O)O)=O,,,5,1,2,0,2
9620_1,,,,2,2,1,3
9622_0,,,,2,2,1,3
C(C(C(C(C)O)O)C(C(O)=O)O)=O,,,5,1,4,0,4
9622_1,,,,2,2,1,3
9624_0,,,,2,2,1,3
C(C(CC(C(C)O)O)(CC=O)O)=O,,,5,1,1,0,1
9625_0,,,,2,2,1,3
9626_0,,,,2,2,1,3
9626_1,,,,2,2,1,3
9627_0,,,,2,2,1,3
9627_1,,,,2,2,1,3
9628_0,,,,2,2,1,3
9628_1,,,,2,2,1,3
9629_0,,,,2,2,1,3
9629_1,,,,2,2,1,3
9631_0,,,,2,2,1,3
C(C(CC(C(C(C)=O)C)O)O)(O)=O,,,5,1,1,0,1
9633_0,,,,2,2,1,3
C(CC(CC(C(O)=O)O)O)(CC)=O,,,5,1,1,0,1
9635_0,,,,2,2,1,3
C(C(C=O)C(CC(C(O)=O)O)O)=O,,,5,1,2,0,2
9635_1,,,,2,2,1,3
9637_0,,,,2,2,1,3
C(CC(CC(C(O)=O)O)O)=O,,,5,1,2,0,2
9639_0,,,,2,2,1,3
C(C(CC(CC(C=O)=O)O)O)(O)=O,,,5,1,1,0,1
9641_0,,,,2,2,1,3
C(C(CO)C(CC(C(O)=O)O)O)=O,,,5,1,2,0,2
9641_1,,,,2,2,1,3
9643_0,,,,2,2,1,3
C(C(CC(CC(CO)=O)O)O)(O)=O,,,5,1,1,0,1
9645_0,,,,2,2,1,3
C(C(CC(C(C(C)=O)O)O)O)(O)=O,,,5,1,2,0,2
9645_1,,,,2,2,1,3
9647_0,,,,2,2,1,3
C(C(C=C)C(CC(C(O)=O)O)O)=O,,,5,1,1,0,1
9649_0,,,,2,2,1,3
C(C(CC(C(C=O)O)O)O)(O)=O,,,5,1,6,0,6
9649_1,,,,2,2,1,3
9651_0,,,,2,2,1,3
C(C([C](C(O)=O)O)C(C(O)=O)O)=O,,,5,1,2,0,2
9651_1,,,,2,2,1,3
9653_0,,,,2,2,1,3
C(C(C(C)(CC)O)C(C(O)=O)O)=O,,,5,1,2,0,2
9653_1,,,,2,2,1,3
9655_0,,,,2,2,1,3
C(CC(C(C=O)C(C(O)=O)O)O)=O,,,5,1,3,0,3
9655_1,,,,2,2,1,3
9657_0,,,,2,2,1,3
C(C(C(C=O)C(C=C)O)O)(O)=O,,,5,1,2,0,2
9657_1,,,,2,2,1,3
9659_0,,,,2,2,1,3
C(C(C(C(O)O)O)C(C(O)=O)O)=O,,,5,1,2,0,2
9659_1,,,,2,2,1,3
9660_0,,,,2,2,1,3
9660_1,,,,2,2,1,3
9661_0,,,,2,2,1,3
9661_1,,,,2,2,1,3
9662_0,,,,2,2,1,3
9662_1,,,,2,2,1,3
9663_0,,,,2,2,1,3
9663_1,,,,2,2,1,3
9664_0,,,,2,2,1,3
9664_1,,,,2,2,1,3
9665_0,,,,2,2,1,3
9665_1,,,,2,2,1,3
9666_0,,,,2,2,1,3
9666_1,,,,2,2,1,3
9667_0,,,,2,2,1,3
9667_1,,,,2,2,1,3
9668_0,,,,2,2,1,3
9668_1,,,,2,2,1,3
9669_0,,,,2,2,1,3
9669_1,,,,2,2,1,3
9670_0,,,,2,2,1,3
9670_1,,,,2,2,1,3
9671_0,,,,2,2,1,3
9671_1,,,,2,2,1,3
9673_0,,,,2,2,1,3
C(C(C(C=O)C(C(O)=O)O)O)(O)=O,,,5,1,2,0,2
9673_1,,,,2,2,1,3
9675_0,,,,2,2,1,3
C(C(CC(C=O)(CC=O)O)O)(O)=O,,,5,1,1,0,1
9676_0,,,,2,2,1,3
9677_0,,,,2,2,1,3
9677_1,,,,2,2,1,3
9678_0,,,,2,2,1,3
9678_1,,,,2,2,1,3
9679_0,,,,2,2,1,3
9679_1,,,,2,2,1,3
9680_0,,,,2,2,1,3
9680_1,,,,2,2,1,3
9682_0,,,,2,2,1,3
C(C(CC(C(O)=O)O)O)(CCO)=O,,,5,1,4,0,4
9684_0,,,,2,2,1,3
C(CC1(C(CC(C(C1)=O)=O)=O)O)=O,,,5,1,1,0,1
9686_0,,,,2,2,1,3
C=CC(C1C(C(CC(C1=O)=O)=O)=O)O,,,5,1,2,0,2
9686_1,,,,2,2,1,3
9688_0,,,,2,2,1,3
C1(C(CC(C(C1C(C)O)=O)=O)=O)=O,,,5,1,2,0,2
9688_1,,,,2,2,1,3
9690_0,,,,2,2,1,3
C(C1C(C(CC(C1=O)=O)=O)=O)(O)=O,,,5,1,2,0,2
9690_1,,,,2,2,1,3
9692_0,,,,2,2,1,3
C1(C(CC(C(C1CO)=O)=O)=O)=O,,,5,1,3,0,3
9692_1,,,,2,2,1,3
9694_0,,,,2,2,1,3
C(C(C1C(C(CC(C1=O)=O)=O)=O)O)=O,,,5,1,2,0,2
9694_1,,,,2,2,1,3
9696_0,,,,2,2,1,3
C(C(C(C=O)=O)(C(C(C)=O)C)O)=O,,,5,1,1,0,1
9698_0,,,,2,2,1,3
C(C(C(C=O)=O)(CC(CC)=O)O)=O,,,5,1,1,0,1
9700_0,,,,2,2,1,3
C(C(C=O)C(C=O)(C(C=O)=O)O)=O,,,5,1,2,0,2
9700_1,,,,2,2,1,3
9702_0,,,,2,2,1,3
C(C(C(C=O)=O)(CC=O)O)=O,,,5,1,2,0,2
9704_0,,,,2,2,1,3
C(C(C(C=O)=O)(CC(C=O)=O)O)=O,,,5,1,1,0,1
9706_0,,,,2,2,1,3
C(C(C(C=O)=O)(C(C=O)CO)O)=O,,,5,1,2,0,2
9706_1,,,,2,2,1,3
9708_0,,,,2,2,1,3
C(C(C(C=O)=O)(CC(CO)=O)O)=O,,,5,1,1,0,1
9710_0,,,,2,2,1,3
C(C(C(C=O)=O)(C(C(C)=O)O)O)=O,,,5,1,2,0,2
9710_1,,,,2,2,1,3
9712_0,,,,2,2,1,3
C(C(C=C)C(C=O)(C(C=O)=O)O)=O,,,5,1,1,0,1
9714_0,,,,2,2,1,3
C(C(C(C=O)=O)(C(C=O)O)O)=O,,,5,1,3,0,3
9714_1,,,,2,2,1,3
9716_0,,,,2,2,1,3
C(C)(C(C)C(C(C(C=O)=O)=O)O)=O,,,5,1,1,0,1
9718_0,,,,2,2,1,3
C(CC(C(C(C=O)=O)=O)O)(CC)=O,,,5,1,1,0,1
9720_0,,,,2,2,1,3
C(C(C=O)C(C(C(C=O)=O)=O)O)=O,,,5,1,2,0,2
9720_1,,,,2,2,1,3
9722_0,,,,2,2,1,3
C(CC(C(C(C=O)=O)=O)O)=O,,,5,1,2,0,2
9724_0,,,,2,2,1,3
C(C(CC(C(C(C=O)=O)=O)O)=O)=O,,,5,1,1,0,1
9726_0,,,,2,2,1,3
C(C(CO)C(C(C(C=O)=O)=O)O)=O,,,5,1,2,0,2
9726_1,,,,2,2,1,3
9728_0,,,,2,2,1,3
C(CO)(CC(C(C(C=O)=O)=O)O)=O,,,5,1,1,0,1
9730_0,,,,2,2,1,3
C(C)(C(C(C(C(C=O)=O)=O)O)O)=O,,,5,1,2,0,2
9730_1,,,,2,2,1,3
9732_0,,,,2,2,1,3
C(C(C=C)C(C(C(C=O)=O)=O)O)=O,,,5,1,1,0,1
9734_0,,,,2,2,1,3
C(C(C(C(C(C=O)=O)=O)O)O)=O,,,5,1,4,0,4
9734_1,,,,2,2,1,3
9736_0,,,,2,2,1,3
C(C(C(C(C(CCO)=O)=O)O)=O)=O,,,5,1,1,0,1
9738_0,,,,2,2,1,3
C(C(C(C(C(CO)=O)=O)CO)=O)=O,,,5,1,2,0,2
9738_1,,,,2,2,1,3
9740_0,,,,2,2,1,3
C(C(CC(C(C(CO)O)=O)=O)=O)=O,,,5,1,2,0,2
9740_1,,,,2,2,1,3
9741_0,,,,2,2,1,3
9743_0,,,,2,2,1,3
C(C(C)(CC=O)O)(CC(C=O)=O)=O,,,5,1,1,0,1
9745_0,,,,2,2,1,3
C(CC(C=O)(CC(C(C)=O)=O)O)=O,,,5,1,2,0,2
9747_0,,,,2,2,1,3
C(CC(C(CC(C(C)=O)=O)=O)O)=O,,,5,1,1,0,1
9749_0,,,,2,2,1,3
C=CC(C(C(C=O)=O)C(C(C)=O)=O)O,,,5,1,2,0,2
9749_1,,,,2,2,1,3
9751_0,,,,2,2,1,3
C(C(C(C(C(C)=O)=O)C(C)O)=O)=O,,,5,1,2,0,2
9751_1,,,,2,2,1,3
9753_0,,,,2,2,1,3
C(C(C(C=O)=O)C(C(C)=O)=O)(O)=O,,,5,1,2,0,2
9753_1,,,,2,2,1,3
9755_0,,,,2,2,1,3
C(C(C(C(C(C)=O)=O)CO)=O)=O,,,5,1,5,0,5
9755_1,,,,2,2,1,3
9757_0,,,,2,2,1,3
C=CC(CC(C(CC(C=O)=O)=O)=O)O,,,5,1,1,0,1
9759_0,,,,2,2,1,3
C(C(CC(C(CC(C)O)=O)=O)=O)=O,,,5,1,1,0,1
9761_0,,,,2,2,1,3
C(CC(C(CC(C=O)=O)=O)=O)(O)=O,,,5,1,1,0,1
9763_0,,,,2,2,1,3
C(C(CC(C(CCO)=O)=O)=O)=O,,,5,1,4,0,4
9765_0,,,,2,2,1,3
C(CC(CC(C(CO)=O)=O)O)=O,,,5,1,3,0,3
9767_0,,,,2,2,1,3
C(C(C(CC(C(CO)=O)=O)O)O)=O,,,5,1,3,0,3
9767_1,,,,2,2,1,3
9769_0,,,,2,2,1,3
C(C(CO)(CC=O)O)(CC=O)=O,,,5,1,2,0,2
9771_0,,,,2,2,1,3
C(C(CO)(C(C=O)O)O)(CC=O)=O,,,5,1,4,0,4
9771_1,,,,2,2,1,3
9773_0,,,,2,2,1,3
C(CC(C(CO)=O)(CC=O)O)=O,,,5,1,2,0,2
9774_0,,,,2,2,1,3
9774_1,,,,2,2,1,3
9776_0,,,,2,2,1,3
C(C(C(C(CO)=O)=O)C(C=C)O)=O,,,5,1,2,0,2
9776_1,,,,2,2,1,3
9777_0,,,,2,2,1,3
9777_1,,,,2,2,1,3
9778_0,,,,2,2,1,3
9778_1,,,,2,2,1,3
9780_0,,,,2,2,1,3
C(C(C(C(CO)=O)=O)CO)=O,,,5,1,5,0,5
9780_1,,,,2,2,1,3
9782_0,,,,2,2,1,3
C(C(C(C(CO)=O)=O)C(C=O)O)=O,,,5,1,2,0,2
9782_1,,,,2,2,1,3
9784_0,,,,2,2,1,3
C(C(C(C(CO)=O)=O)C(CO)O)=O,,,5,1,2,0,2
9784_1,,,,2,2,1,3
9786_0,,,,2,2,1,3
C(CC(C(C(C(C=C)O)O)=O)=O)=O,,,5,1,2,0,2
9786_1,,,,2,2,1,3
9788_0,,,,2,2,1,3
C(CC(C(C(C(C)O)O)=O)=O)=O,,,5,1,4,0,4
9788_1,,,,2,2,1,3
9790_0,,,,2,2,1,3
C(C(C(C(CC=O)=O)=O)O)(O)=O,,,5,1,4,0,4
9790_1,,,,2,2,1,3
9792_0,,,,2,2,1,3
C(CC(C(C(CO)O)=O)=O)=O,,,5,1,4,0,4
9792_1,,,,2,2,1,3
9794_0,,,,2,2,1,3
C(CC(C(C(C(C=O)O)O)=O)=O)=O,,,5,1,2,0,2
9794_1,,,,2,2,1,3
9796_0,,,,2,2,1,3
C(CC(C(C(C(CO)O)O)=O)=O)=O,,,5,1,2,0,2
9796_1,,,,2,2,1,3
9798_0,,,,2,2,1,3
C(C(C(C(O)=O)=O)(CC=O)O)=O,,,5,1,2,0,2
9800_0,,,,2,2,1,3
C(C(C(C(O)=O)=O)(C(C=O)O)O)=O,,,5,1,5,0,5
9800_1,,,,2,2,1,3
9802_0,,,,2,2,1,3
C(CC(C(C(C(O)=O)=O)=O)O)=O,,,5,1,2,0,2
9803_0,,,,2,2,1,3
9803_1,,,,2,2,1,3
9805_0,,,,2,2,1,3
C(C(C(C=O)=O)(CC=O)O)(O)=O,,,5,1,3,0,3
9806_0,,,,2,2,1,3
9806_1,,,,2,2,1,3
9808_0,,,,2,2,1,3
C(C(C(C(CO)=O)=O)=O)(CCO)=O,,,5,1,1,0,1
9810_0,,,,2,2,1,3
C(C(C(C(C)=O)=O)=O)(C(CO)O)=O,,,5,1,2,0,2
9810_1,,,,2,2,1,3
9812_0,,,,2,2,1,3
C(CC(C(C)=O)(C(C(C)=O)=O)O)=O,,,5,1,1,0,1
9814_0,,,,2,2,1,3
C(CC(C(C(C(C)=O)=O)=O)(C)O)=O,,,5,1,1,0,1
9816_0,,,,2,2,1,3
C=CC(CC(C(C(C(C)=O)=O)=O)=O)O,,,5,1,1,0,1
9818_0,,,,2,2,1,3
C(C(C(C(C)=O)=O)=O)(CC(C)O)=O,,,5,1,1,0,1
9820_0,,,,2,2,1,3
C(CC(C(C(C(C)=O)=O)=O)=O)(O)=O,,,5,1,1,0,1
9822_0,,,,2,2,1,3
C(C(C(C(C)=O)=O)=O)(CCO)=O,,,5,1,2,0,2
9824_0,,,,2,2,1,3
C(C(C(C(C(C(C)=O)=O)O)O)=O)=O,,,5,1,4,0,4
9824_1,,,,2,2,1,3
9826_0,,,,2,2,1,3
C(C(C(CC(C(CO)=O)=O)O)=O)=O,,,5,1,1,0,1
9828_0,,,,2,2,1,3
C(C(C(CC(C(C=O)=O)=O)O)=O)=O,,,5,1,1,0,1
9830_0,,,,2,2,1,3
C=CC(C(CC(C(C=O)=O)O)=O)=O,,,5,1,1,0,1
9832_0,,,,2,2,1,3
C(C(C(CC(C(C=O)=O)O)=O)O)=O,,,5,1,1,0,1
9834_0,,,,2,2,1,3
C(C(C(CC(C(C)=O)=O)O)=O)=O,,,5,1,3,0,3
9836_0,,,,2,2,1,3
C(CC(CC(C(C=O)=O)O)=O)(O)=O,,,5,1,1,0,1
9838_0,,,,2,2,1,3
C(C(C(C)=O)C(C(C=O)=O)O)(O)=O,,,5,1,2,0,2
9838_1,,,,2,2,1,3
9840_0,,,,2,2,1,3
C(CC(C(C=O)=O)O)(CCO)=O,,,5,1,1,0,1
9842_0,,,,2,2,1,3
C(C)(C(CO)C(C(C=O)=O)O)=O,,,5,1,2,0,2
9842_1,,,,2,2,1,3
9844_0,,,,2,2,1,3
C(C)(C(C)C(C(C=O)=O)O)=O,,,5,1,1,0,1
9846_0,,,,2,2,1,3
C(CC(C(C=O)=O)O)(CC)=O,,,5,1,1,0,1
9848_0,,,,2,2,1,3
C(C([CH]C(O)=O)C(C(C=O)=O)O)=O,,,5,1,1,0,1
9850_0,,,,2,2,1,3
C(CC(C=O)C(C(C=O)=O)O)(O)=O,,,5,1,1,0,1
9852_0,,,,2,2,1,3
C(C(C(C=O)=O)C(C(C=O)=O)O)=O,,,5,1,2,0,2
9852_1,,,,2,2,1,3
9854_0,,,,2,2,1,3
C(C(O)=O)(C(C)C(C(C=O)=O)O)=O,,,5,1,1,0,1
9856_0,,,,2,2,1,3
C(CC(C(C=O)=O)O)(C(C)O)=O,,,5,1,1,0,1
9858_0,,,,2,2,1,3
C(C(C(C(C=O)=O)O)O)(CC)=O,,,5,1,2,0,2
9858_1,,,,2,2,1,3
9860_0,,,,2,2,1,3
C(CO)(C(C)C(C(C=O)=O)O)=O,,,5,1,1,0,1
9861_0,,,,2,2,1,3
9861_1,,,,2,2,1,3
9863_0,,,,2,2,1,3
C(C(C(C=O)=C)C(C(C=O)=O)O)=O,,,5,1,1,0,1
9865_0,,,,2,2,1,3
C(C(C(CC(C=CC=O)=O)O)=O)=O,,,5,1,1,0,1
9867_0,,,,2,2,1,3
C=CC(C(C=O)=O)C(C(C=O)=O)O,,,5,1,1,0,1
9869_0,,,,2,2,1,3
C(C(CCO)C(C(C=O)=O)O)=O,,,5,1,2,0,2
9871_0,,,,2,2,1,3
C1(C(O)OCC1C(C(C=O)=O)O)=O,,,5,1,2,0,2
9871_1,,,,2,2,1,3
9873_0,,,,2,2,1,3
C1(C(OCC1C(C(C=O)=O)O)=O)=O,,,5,1,2,0,2
9873_1,,,,2,2,1,3
9875_0,,,,2,2,1,3
C(C(C(C1C(C(C(O1)=O)=O)=O)O)=O)=O,,,5,1,2,0,2
9875_1,,,,2,2,1,3
9877_0,,,,2,2,1,3
C(C(C(CO)C)C(C(C=O)=O)O)=O,,,5,1,1,0,1
9879_0,,,,2,2,1,3
C(CC(C(C=O)=O)O)=O,,,5,1,8,0,8
9881_0,,,,2,2,1,3
C(C(C(C)O)C(C(C=O)=O)O)=O,,,5,1,4,0,4
9881_1,,,,2,2,1,3
9882_0,,,,2,2,1,3
9882_1,,,,2,2,1,3
9884_0,,,,2,2,1,3
C(C(C(C(C(C=O)=O)O)O)=O)=O,,,5,1,4,0,4
9884_1,,,,2,2,1,3
9886_0,,,,2,2,1,3
C(C(CC(C(C=O)=O)O)=O)=O,,,5,1,4,0,4
9888_0,,,,2,2,1,3
C(C(C(C(C(C=O)=O)O)O)=O)(O)=O,,,5,1,6,0,6
9888_1,,,,2,2,1,3
9890_0,,,,2,2,1,3
C(C=O)(C(CO)C(C(C=O)=O)O)=O,,,5,1,3,0,3
9890_1,,,,2,2,1,3
9892_0,,,,2,2,1,3
C(C(CO)C(C(C=O)=O)O)=O,,,5,1,8,0,8
9892_1,,,,2,2,1,3
9893_0,,,,2,2,1,3
9893_1,,,,2,2,1,3
9895_0,,,,2,2,1,3
C(CO)(CC(C(C=O)=O)O)=O,,,5,1,7,0,7
9896_0,,,,2,2,1,3
9896_1,,,,2,2,1,3
9898_0,,,,2,2,1,3
C(C(C=C)C(C(C=O)=O)O)=O,,,5,1,3,0,3
9899_0,,,,2,2,1,3
9899_1,,,,2,2,1,3
9901_0,,,,2,2,1,3
C1(C(C(C(O1)=O)=O)C(C(C=O)=O)O)=O,,,5,1,2,0,2
9901_1,,,,2,2,1,3
9903_0,,,,2,2,1,3
C(C(CC(C(C=O)=O)O)=O)(O)=O,,,5,1,4,0,4
9905_0,,,,2,2,1,3
C(C(C=O)(C(C(C(C)=O)=O)O)O)=O,,,5,1,4,0,4
9905_1,,,,2,2,1,3
9907_0,,,,2,2,1,3
C(C(C=O)(CC(C(CO)=O)=O)O)=O,,,5,1,1,0,1
9909_0,,,,2,2,1,3
C(C(C=O)(CC(C(C=O)=O)=O)O)=O,,,5,1,1,0,1
9911_0,,,,2,2,1,3
C(C(C=O)(CC(C(C=C)=O)=O)O)=O,,,5,1,1,0,1
9913_0,,,,2,2,1,3
C(C(C=O)(CC(C(C=O)O)=O)O)=O,,,5,1,1,0,1
9915_0,,,,2,2,1,3
C(C(C=O)(CC(C(C)=O)=O)O)=O,,,5,1,1,0,1
9917_0,,,,2,2,1,3
C(C(C=O)(CC(CC(O)=O)=O)O)=O,,,5,1,1,0,1
9919_0,,,,2,2,1,3
C(C(C(C)=O)C(C=O)(C=O)O)(O)=O,,,5,1,2,0,2
9919_1,,,,2,2,1,3
9921_0,,,,2,2,1,3
C(C(C=O)(CC(CCO)=O)O)=O,,,5,1,1,0,1
9923_0,,,,2,2,1,3
C(C(C=O)(C(C(C)=O)CO)O)=O,,,5,1,2,0,2
9923_1,,,,2,2,1,3
9925_0,,,,2,2,1,3
C(C(C=O)(C(C(C)=O)C)O)=O,,,5,1,1,0,1
9927_0,,,,2,2,1,3
C(C(C=O)(CC(CC)=O)O)=O,,,5,1,1,0,1
9929_0,,,,2,2,1,3
C(C([CH]C(O)=O)C(C=O)(C=O)O)=O,,,5,1,1,0,1
9931_0,,,,2,2,1,3
C(C(C=O)(C(C=O)CC(O)=O)O)=O,,,5,1,1,0,1
9933_0,,,,2,2,1,3
C(C(C(C=O)=O)C(C=O)(C=O)O)=O,,,5,1,2,0,2
9933_1,,,,2,2,1,3
9935_0,,,,2,2,1,3
C(C(C=O)(C(C(C(O)=O)=O)C)O)=O,,,5,1,1,0,1
9937_0,,,,2,2,1,3
C(C(C=O)(CC(C(C)O)=O)O)=O,,,5,1,1,0,1
9939_0,,,,2,2,1,3
C(C(C=O)(C(C(CC)=O)O)O)=O,,,5,1,2,0,2
9939_1,,,,2,2,1,3
9941_0,,,,2,2,1,3
C(C(C=O)(C(C(CO)=O)C)O)=O,,,5,1,1,0,1
9943_0,,,,2,2,1,3
C(C(C=O)C(C=O)(C=O)O)=O,,,5,1,3,0,3
9943_1,,,,2,2,1,3
9945_0,,,,2,2,1,3
C(C(C(C=O)=C)C(C=O)(C=O)O)=O,,,5,1,1,0,1
9947_0,,,,2,2,1,3
C(C(C=O)(CC(C=CC=O)=O)O)=O,,,5,1,1,0,1
9949_0,,,,2,2,1,3
C(C(C=O)(C(C=C)C(C=O)=O)O)=O,,,5,1,1,0,1
9951_0,,,,2,2,1,3
C(C(C=O)(C(C=O)CCO)O)=O,,,5,1,1,0,1
9953_0,,,,2,2,1,3
C(C(C=O)(C1C(C(O)OC1)=O)O)=O,,,5,1,2,0,2
9953_1,,,,2,2,1,3
9955_0,,,,2,2,1,3
C(C(C=O)(C1C(C(OC1)=O)=O)O)=O,,,5,1,2,0,2
9955_1,,,,2,2,1,3
9957_0,,,,2,2,1,3
C(C(C=O)(C1C(C(C(O1)=O)=O)=O)O)=O,,,5,1,2,0,2
9957_1,,,,2,2,1,3
9959_0,,,,2,2,1,3
C(C(C=O)(C(C=O)C(CO)C)O)=O,,,5,1,1,0,1
9961_0,,,,2,2,1,3
C(C(C=O)(CC=O)O)=O,,,5,1,2,0,2
9963_0,,,,2,2,1,3
C(C(C=O)(C(C=O)C(C)O)O)=O,,,5,1,2,0,2
9963_1,,,,2,2,1,3
9965_0,,,,2,2,1,3
C(C(C=O)C(C=O)(C=O)O)(O)=O,,,5,1,3,0,3
9965_1,,,,2,2,1,3
9967_0,,,,2,2,1,3
C(C(C=O)(C(C(C=O)=O)O)O)=O,,,5,1,6,0,6
9967_1,,,,2,2,1,3
9969_0,,,,2,2,1,3
C(C(C=O)(CC(C=O)=O)O)=O,,,5,1,2,0,2
9971_0,,,,2,2,1,3
C(C(C=O)(C(C(C(O)=O)=O)O)O)=O,,,5,1,5,0,5
9971_1,,,,2,2,1,3
9973_0,,,,2,2,1,3
C(C(C=O)(C(C(C=O)=O)CO)O)=O,,,5,1,2,0,2
9973_1,,,,2,2,1,3
9975_0,,,,2,2,1,3
C(C(C=O)(C(C=O)CO)O)=O,,,5,1,3,0,3
9975_1,,,,2,2,1,3
9976_0,,,,2,2,1,3
9976_1,,,,2,2,1,3
9978_0,,,,2,2,1,3
C(C(C=O)(CC(CO)=O)O)=O,,,5,1,4,0,4
9979_0,,,,2,2,1,3
9979_1,,,,2,2,1,3
9981_0,,,,2,2,1,3
C(C(C=C)C(C=O)(C=O)O)=O,,,5,1,1,0,1
9982_0,,,,2,2,1,3
9982_1,,,,2,2,1,3
9984_0,,,,2,2,1,3
C1(C(C(C(O1)=O)=O)C(C=O)(C=O)O)=O,,,5,1,2,0,2
9984_1,,,,2,2,1,3
9986_0,,,,2,2,1,3
C(C(C=O)(CC(C(O)=O)=O)O)=O,,,5,1,2,0,2
9988_0,,,,2,2,1,3
C(C)(C(C)C(C(C)=O)(CCO)O)=O,,,5,1,1,0,1
9990_0,,,,2,2,1,3
C(C)(C(CCO)(CC(CC)=O)O)=O,,,5,1,1,0,1
9992_0,,,,2,2,1,3
C(C(C=O)C(C(C)=O)(CCO)O)=O,,,5,1,2,0,2
9992_1,,,,2,2,1,3
9994_0,,,,2,2,1,3
C(C)(C(CCO)(CC=O)O)=O,,,5,1,2,0,2
9996_0,,,,2,2,1,3
C(C)(C(CCO)(CC(C=O)=O)O)=O,,,5,1,2,0,2
9998_0,,,,2,2,1,3
C(C(CO)C(C(C)=O)(CCO)O)=O,,,5,1,3,0,3
9998_1,,,,2,2,1,3
10000_0,,,,2,2,1,3
C(C)(C(CCO)(CC(CO)=O)O)=O,,,5,1,2,0,2
10002_0,,,,2,2,1,3
C(C)(C(CCO)(C(C(C)=O)O)O)=O,,,5,1,4,0,4
10002_1,,,,2,2,1,3
10004_0,,,,2,2,1,3
C(C(C=C)C(C(C)=O)(CCO)O)=O,,,5,1,2,0,2
10006_0,,,,2,2,1,3
C(C)(C(CCO)(C(C=O)O)O)=O,,,5,1,4,0,4
10006_1,,,,2,2,1,3
10008_0,,,,2,2,1,3
C(C(C)(C(C(C)=O)C)O)(CCO)=O,,,5,1,1,0,1
10010_0,,,,2,2,1,3
C(C(C)(CC(CC)=O)O)(CCO)=O,,,5,1,1,0,1
10012_0,,,,2,2,1,3
C(C(C=O)C(C(CCO)=O)(C)O)=O,,,5,1,2,0,2
10012_1,,,,2,2,1,3
10014_0,,,,2,2,1,3
C(C(C)(CC=O)O)(CCO)=O,,,5,1,2,0,2
10016_0,,,,2,2,1,3
C(C(C)(CC(C=O)=O)O)(CCO)=O,,,5,1,2,0,2
10018_0,,,,2,2,1,3
C(C(CO)C(C(CCO)=O)(C)O)=O,,,5,1,3,0,3
10018_1,,,,2,2,1,3
10020_0,,,,2,2,1,3
C(C(C)(CC(CO)=O)O)(CCO)=O,,,5,1,2,0,2
10022_0,,,,2,2,1,3
C(C(C)(C(C(C)=O)O)O)(CCO)=O,,,5,1,3,0,3
10022_1,,,,2,2,1,3
10024_0,,,,2,2,1,3
C(C(C=C)C(C(CCO)=O)(C)O)=O,,,5,1,2,0,2
10026_0,,,,2,2,1,3
C(C(C)(C(C=O)O)O)(CCO)=O,,,5,1,3,0,3
10026_1,,,,2,2,1,3
10027_0,,,,2,2,1,3
10027_1,,,,2,2,1,3
10029_0,,,,2,2,1,3
C(C(C)=O)(C(CO)C(C)(CC)O)=O,,,5,1,2,0,2
10029_1,,,,2,2,1,3
10030_0,,,,2,2,1,3
10030_1,,,,2,2,1,3
10032_0,,,,2,2,1,3
C=CC(C(C(C(C)=O)=O)CO)O,,,5,1,2,0,2
10032_1,,,,2,2,1,3
10034_0,,,,2,2,1,3
C(C(C)=O)(C(CO)C(C(O)O)O)=O,,,5,1,2,0,2
10034_1,,,,2,2,1,3
10036_0,,,,2,2,1,3
C(C(C)=O)(C(CO)C(C)O)=O,,,5,1,5,0,5
10036_1,,,,2,2,1,3
10037_0,,,,2,2,1,3
10037_1,,,,2,2,1,3
10039_0,,,,2,2,1,3
C(C(C)(C(C(C(C)=O)=O)CO)O)=O,,,5,1,3,0,3
10039_1,,,,2,2,1,3
10041_0,,,,2,2,1,3
C(C(C(C(C(C)=O)=O)CO)O)(C)=O,,,5,1,3,0,3
10041_1,,,,2,2,1,3
10043_0,,,,2,2,1,3
C(C(C)=O)(C(CO)CO)=O,,,5,1,5,0,5
10043_1,,,,2,2,1,3
10045_0,,,,2,2,1,3
C(C(C)=O)(C(CO)C(CCO)O)=O,,,5,1,3,0,3
10045_1,,,,2,2,1,3
10047_0,,,,2,2,1,3
C(C(C(C(C(C)=O)=O)CO)O)=O,,,5,1,3,0,3
10047_1,,,,2,2,1,3
10049_0,,,,2,2,1,3
C(C(C)=O)(C(CO)C(C)(CO)O)=O,,,5,1,3,0,3
10049_1,,,,2,2,1,3
10051_0,,,,2,2,1,3
C(C)=CC(C(C(C(C)=O)=O)CO)O,,,5,1,3,0,3
10051_1,,,,2,2,1,3
10053_0,,,,2,2,1,3
C(CC(C(C(C(C)=O)=O)CO)O)=C,,,5,1,3,0,3
10053_1,,,,2,2,1,3
10055_0,,,,2,2,1,3
C(C(C)=O)(C(CO)C(CO)O)=O,,,5,1,3,0,3
10055_1,,,,2,2,1,3
10057_0,,,,2,2,1,3
C(C(C)=O)(C(CO)C(C(C)O)O)=O,,,5,1,3,0,3
10057_1,,,,2,2,1,3
10058_0,,,,2,2,1,3
10058_1,,,,2,2,1,3
10059_0,,,,2,2,1,3
10061_0,,,,2,2,1,3
C(C(CCO)=O)(CC(C)(CC)O)=O,,,5,1,1,0,1
10062_0,,,,2,2,1,3
10064_0,,,,2,2,1,3
C=CC(CC(C(CCO)=O)=O)O,,,5,1,1,0,1
10066_0,,,,2,2,1,3
C(C(CCO)=O)(CC(C(O)O)O)=O,,,5,1,1,0,1
10068_0,,,,2,2,1,3
C(C(CCO)=O)(CC(C)O)=O,,,5,1,3,0,3
10070_0,,,,2,2,1,3
C(CC(C(CCO)=O)=O)(O)=O,,,5,1,6,0,6
10072_0,,,,2,2,1,3
C(C(C)(CC(C(CCO)=O)=O)O)=O,,,5,1,2,0,2
10074_0,,,,2,2,1,3
C(C(CC(C(CCO)=O)=O)O)(C)=O,,,5,1,2,0,2
10076_0,,,,2,2,1,3
C(C(CCO)=O)(CCO)=O,,,5,1,2,0,2
10078_0,,,,2,2,1,3
C(C(CCO)=O)(CC(CCO)O)=O,,,5,1,2,0,2
10080_0,,,,2,2,1,3
C(C(CC(C(CCO)=O)=O)O)=O,,,5,1,2,0,2
10082_0,,,,2,2,1,3
C(C(CCO)=O)(CC(C)(CO)O)=O,,,5,1,2,0,2
10084_0,,,,2,2,1,3
C(C)=CC(CC(C(CCO)=O)=O)O,,,5,1,2,0,2
10086_0,,,,2,2,1,3
C=CCC(CC(C(CCO)=O)=O)O,,,5,1,2,0,2
10088_0,,,,2,2,1,3
C(C(CCO)=O)(CC(CO)O)=O,,,5,1,2,0,2
10090_0,,,,2,2,1,3
C(C(CCO)=O)(CC(C(C)O)O)=O,,,5,1,2,0,2
10091_0,,,,2,2,1,3
10093_0,,,,2,2,1,3
C(CC(C(C)=O)(CC=O)O)(O)=O,,,5,1,2,0,2
10095_0,,,,2,2,1,3
C(CC(C(C)=O)(C(C=O)O)O)(O)=O,,,5,1,4,0,4
10095_1,,,,2,2,1,3
10097_0,,,,2,2,1,3
C(C(C)(CC=O)O)(CC(O)=O)=O,,,5,1,3,0,3
10099_0,,,,2,2,1,3
C(C(C)(C(C=O)O)O)(CC(O)=O)=O,,,5,1,4,0,4
10099_1,,,,2,2,1,3
10101_0,,,,2,2,1,3
C(C(C(C(C)=O)=O)C(C=C)O)(O)=O,,,5,1,2,0,2
10101_1,,,,2,2,1,3
10103_0,,,,2,2,1,3
C(C(C(C(C)=O)=O)C(C)O)(O)=O,,,5,1,5,0,5
10103_1,,,,2,2,1,3
10105_0,,,,2,2,1,3
C(C(C(O)=O)C(C(C)=O)=O)(O)=O,,,5,1,5,0,5
10105_1,,,,2,2,1,3
10106_0,,,,2,2,1,3
10106_1,,,,2,2,1,3
10108_0,,,,2,2,1,3
C(C(C(C(C)=O)=O)C(C=O)O)(O)=O,,,5,1,3,0,3
10108_1,,,,2,2,1,3
10110_0,,,,2,2,1,3
C(C(C(C(C)=O)=O)C(CO)O)(O)=O,,,5,1,3,0,3
10110_1,,,,2,2,1,3
10112_0,,,,2,2,1,3
C(CC(C(CC(C=C)O)=O)=O)(O)=O,,,5,1,1,0,1
10114_0,,,,2,2,1,3
C(CC(C(CC(C)O)=O)=O)(O)=O,,,5,1,4,0,4
10116_0,,,,2,2,1,3
C(CC(C(CC(O)=O)=O)=O)(O)=O,,,5,1,4,0,4
10117_0,,,,2,2,1,3
10119_0,,,,2,2,1,3
C(CC(C(CC(C=O)O)=O)=O)(O)=O,,,5,1,2,0,2
10121_0,,,,2,2,1,3
C(CC(C(CC(CO)O)=O)=O)(O)=O,,,5,1,2,0,2
10123_0,,,,2,2,1,3
C(C(C(C(C(CO)O)=O)=O)(C)O)=O,,,5,1,2,0,2
10123_1,,,,2,2,1,3
10125_0,,,,2,2,1,3
C(C)(C(C(C(C(CO)O)=O)=O)O)=O,,,5,1,2,0,2
10125_1,,,,2,2,1,3
10127_0,,,,2,2,1,3
C(CCO)(C(C(C(CO)=O)=O)O)=O,,,5,1,1,0,1
10129_0,,,,2,2,1,3
C(C)(C(C)C(C(CO)=O)(CO)O)=O,,,5,1,1,0,1
10131_0,,,,2,2,1,3
C(CO)(C(CO)(CC(CC)=O)O)=O,,,5,1,1,0,1
10133_0,,,,2,2,1,3
C(C(C=O)C(C(CO)=O)(CO)O)=O,,,5,1,2,0,2
10133_1,,,,2,2,1,3
10134_0,,,,2,2,1,3
10135_0,,,,2,2,1,3
10137_0,,,,2,2,1,3
C(C(CO)C(C(CO)=O)(CO)O)=O,,,5,1,5,0,5
10137_1,,,,2,2,1,3
10139_0,,,,2,2,1,3
C(CO)(C(CO)(CC(CO)=O)O)=O,,,5,1,3,0,3
10141_0,,,,2,2,1,3
C(CO)(C(CO)(C(C(C)=O)O)O)=O,,,5,1,7,0,7
10141_1,,,,2,2,1,3
10143_0,,,,2,2,1,3
C(C(C=C)C(C(CO)=O)(CO)O)=O,,,5,1,2,0,2
10145_0,,,,2,2,1,3
C(CO)(C(CO)(C(C=O)O)O)=O,,,5,1,7,0,7
10145_1,,,,2,2,1,3
10147_0,,,,2,2,1,3
[C](C(O)=O)(C(C(C(CO)=O)=O)O)O,,,5,1,2,0,2
10147_1,,,,2,2,1,3
10149_0,,,,2,2,1,3
C(C(CO)=O)(C(C(C)(CC)O)O)=O,,,5,1,2,0,2
10149_1,,,,2,2,1,3
10151_0,,,,2,2,1,3
C(CC(C(C(C(CO)=O)=O)O)O)=O,,,5,1,2,0,2
10151_1,,,,2,2,1,3
10153_0,,,,2,2,1,3
C=CC(C(C(C(CO)=O)=O)O)O,,,5,1,2,0,2
10153_1,,,,2,2,1,3
10155_0,,,,2,2,1,3
C(C(CO)=O)(C(C(C(O)O)O)O)=O,,,5,1,2,0,2
10155_1,,,,2,2,1,3
10157_0,,,,2,2,1,3
C(C(CO)=O)(C(C(C)O)O)=O,,,5,1,3,0,3
10157_1,,,,2,2,1,3
10158_0,,,,2,2,1,3
10158_1,,,,2,2,1,3
10160_0,,,,2,2,1,3
C(C(C)(C(C(C(CO)=O)=O)O)O)=O,,,5,1,2,0,2
10160_1,,,,2,2,1,3
10162_0,,,,2,2,1,3
C(C)(C(C(C(C(CO)=O)=O)O)O)=O,,,5,1,2,0,2
10162_1,,,,2,2,1,3
10164_0,,,,2,2,1,3
C(C(CO)=O)(C(CO)O)=O,,,5,1,5,0,5
10164_1,,,,2,2,1,3
10166_0,,,,2,2,1,3
C(C(CO)=O)(C(C(CCO)O)O)=O,,,5,1,2,0,2
10166_1,,,,2,2,1,3
10168_0,,,,2,2,1,3
C(C(C(C(C(CO)=O)=O)O)O)=O,,,5,1,7,0,7
10168_1,,,,2,2,1,3
10170_0,,,,2,2,1,3
C(C(CO)=O)(C(C(CO)(C)O)O)=O,,,5,1,2,0,2
10170_1,,,,2,2,1,3
10172_0,,,,2,2,1,3
C(C)=CC(C(C(C(CO)=O)=O)O)O,,,5,1,2,0,2
10172_1,,,,2,2,1,3
10174_0,,,,2,2,1,3
C(CC(C(C(C(CO)=O)=O)O)O)=C,,,5,1,2,0,2
10174_1,,,,2,2,1,3
10176_0,,,,2,2,1,3
C(C(CO)=O)(C(C(CO)O)O)=O,,,5,1,4,0,4
10176_1,,,,2,2,1,3
10178_0,,,,2,2,1,3
C(C(CO)=O)(C(C(C(C)O)O)O)=O,,,5,1,2,0,2
10178_1,,,,2,2,1,3
10180_0,,,,2,2,1,3
C(C(C(C(C(CO)=O)=O)O)O)(O)=O,,,5,1,6,0,6
10180_1,,,,2,2,1,3
10182_0,,,,2,2,1,3
C(C(C(CC(C)O)O)(CC=O)O)=O,,,5,1,2,0,2
10184_0,,,,2,2,1,3
C(CC(C(C(CC(C)O)O)=O)O)=O,,,5,1,1,0,1
10186_0,,,,2,2,1,3
C(C(C(CC(C)O)O)=O)(CCO)=O,,,5,1,1,0,1
10188_0,,,,2,2,1,3
C(CC(C(C=O)(CC=O)O)O)(O)=O,,,5,1,2,0,2
10190_0,,,,2,2,1,3
C(CC(C(C(CC=O)O)=O)O)(O)=O,,,5,1,1,0,1
10192_0,,,,2,2,1,3
C(CC(C(C(CCO)=O)=O)O)(O)=O,,,5,1,1,0,1
10194_0,,,,2,2,1,3
C(CC(C=O)(C(C(CO)=O)O)O)=O,,,5,1,4,0,4
10196_0,,,,2,2,1,3
C(CC(C(C(C(CO)=O)O)=O)O)=O,,,5,1,2,0,2
10198_0,,,,2,2,1,3
C(CC(CO)(C(C(C=O)=O)O)O)=O,,,5,1,2,0,2
10200_0,,,,2,2,1,3
C(C(C(C)O)O)(C(C(C=O)=O)O)=O,,,5,1,3,0,3
10200_1,,,,2,2,1,3
10202_0,,,,2,2,1,3
C(C(C(C(C(C=O)=O)O)=O)O)(O)=O,,,5,1,3,0,3
10202_1,,,,2,2,1,3
10203_0,,,,2,2,1,3
10203_1,,,,2,2,1,3
10205_0,,,,2,2,1,3
C(CO)(C(C(C(CCO)=O)=O)O)=O,,,5,1,1,0,1
10207_0,,,,2,2,1,3
C(C(CO)O)(C(C(C(C)=O)=O)O)=O,,,5,1,2,0,2
10207_1,,,,2,2,1,3
10209_0,,,,2,2,1,3
C(CC(C=O)(C(C=O)(CO)O)O)=O,,,5,1,4,0,4
10211_0,,,,2,2,1,3
C(CC(C(C(C=O)(CO)O)=O)O)=O,,,5,1,1,0,1
10213_0,,,,2,2,1,3
C(CC(C(C(C=O)=O)(CO)O)O)=O,,,5,1,4,0,4
10215_0,,,,2,2,1,3
C(C(C(C(CCO)=O)=O)(CO)O)=O,,,5,1,1,0,1
10217_0,,,,2,2,1,3
C(CC(C=O)(C(C=O)(C)O)O)=O,,,5,1,4,0,4
10219_0,,,,2,2,1,3
C(C(C(C=O)(C(C=O)(C)O)O)O)=O,,,5,1,6,0,6
10219_1,,,,2,2,1,3
10221_0,,,,2,2,1,3
C(CC(C(C(C=O)(C)O)=O)O)=O,,,5,1,1,0,1
10223_0,,,,2,2,1,3
C(C(C(C(C(C=O)O)O)=O)(C)O)=O,,,5,1,2,0,2
10223_1,,,,2,2,1,3
10225_0,,,,2,2,1,3
C(CC(C(C(C=O)=O)(C)O)O)=O,,,5,1,4,0,4
10227_0,,,,2,2,1,3
C(C(C(C(C(C=O)=O)(C)O)O)O)=O,,,5,1,3,0,3
10227_1,,,,2,2,1,3
10228_0,,,,2,2,1,3
10230_0,,,,2,2,1,3
C(C(C)(CC=O)O)(C(C=O)(C)O)=O,,,5,1,1,0,1
10232_0,,,,2,2,1,3
C(CC(C(C(C(C)=O)=O)(C)O)O)=O,,,5,1,2,0,2
10234_0,,,,2,2,1,3
C(C(C(C(CC(C)O)=O)=O)(C)O)=O,,,5,1,1,0,1
10236_0,,,,2,2,1,3
C(C(C(C(CC(O)=O)=O)=O)(C)O)=O,,,5,1,1,0,1
10238_0,,,,2,2,1,3
C(C(C(C(CCO)=O)=O)(C)O)=O,,,5,1,2,0,2
10240_0,,,,2,2,1,3
C(CC(C=O)(C(C(C)=O)O)O)=O,,,5,1,5,0,5
10242_0,,,,2,2,1,3
C(C(C(C=O)(C(C(C)=O)O)O)O)=O,,,5,1,7,0,7
10242_1,,,,2,2,1,3
10244_0,,,,2,2,1,3
C(CC(C(C(C(C)=O)O)=O)O)=O,,,5,1,2,0,2
10246_0,,,,2,2,1,3
C(C(C(C(C(C(C)=O)O)=O)O)O)=O,,,5,1,5,0,5
10246_1,,,,2,2,1,3
10248_0,,,,2,2,1,3
C(CC(C)(C(C(C=O)=O)O)O)=O,,,5,1,3,0,3
10250_0,,,,2,2,1,3
C(C(C(C)(C(C(C=O)=O)O)O)O)=O,,,5,1,4,0,4
10250_1,,,,2,2,1,3
10252_0,,,,2,2,1,3
C(CC(C=C)O)(C(C(C=O)=O)O)=O,,,5,1,1,0,1
10254_0,,,,2,2,1,3
C(CC(C)O)(C(C(C=O)=O)O)=O,,,5,1,3,0,3
10256_0,,,,2,2,1,3
C(CC(C(C(C=O)=O)O)=O)(O)=O,,,5,1,4,0,4
10258_0,,,,2,2,1,3
C(CCO)(C(C(C=O)=O)O)=O,,,5,1,4,0,4
10260_0,,,,2,2,1,3
C(C(CC(C(C(C=O)=O)O)=O)O)=O,,,5,1,1,0,1
10262_0,,,,2,2,1,3
C(CC(CO)O)(C(C(C=O)=O)O)=O,,,5,1,1,0,1
10263_0,,,,2,2,1,3
10265_0,,,,2,2,1,3
C(C)(C(C(C(C)(CC=O)O)=O)O)=O,,,5,1,1,0,1
10267_0,,,,2,2,1,3
C(CC(C)(C(C(C(C)=O)=O)O)O)=O,,,5,1,1,0,1
10269_0,,,,2,2,1,3
C(C)(C(C(C(CC(C)O)=O)=O)O)=O,,,5,1,1,0,1
10271_0,,,,2,2,1,3
C(CC(C(C(C(C)=O)O)=O)=O)(O)=O,,,5,1,1,0,1
10273_0,,,,2,2,1,3
C(C)(C(C(C(CCO)=O)=O)O)=O,,,5,1,2,0,2
10275_0,,,,2,2,1,3
C(CC(C)O)(C(C(C(C)=O)=O)O)=O,,,5,1,1,0,1
10277_0,,,,2,2,1,3
C(CC(C(C(C(C)=O)=O)O)=O)(O)=O,,,5,1,1,0,1
10279_0,,,,2,2,1,3
C(CCO)(C(C(C(C)=O)=O)O)=O,,,5,1,2,0,2
10281_0,,,,2,2,1,3
C(C)(C(CO)(CC(C(C)=O)=O)O)=O,,,5,1,1,0,1
10283_0,,,,2,2,1,3
C(C)(C(CO)(CC(CCO)=O)O)=O,,,5,1,1,0,1
10285_0,,,,2,2,1,3
C(C)(C(CO)C(C(C)=O)(CO)O)=O,,,5,1,2,0,2
10285_1,,,,2,2,1,3
10287_0,,,,2,2,1,3
C(C)(C(C)C(C(C)=O)(CO)O)=O,,,5,1,1,0,1
10289_0,,,,2,2,1,3
C(C)(C(CO)(CC(CC)=O)O)=O,,,5,1,1,0,1
10291_0,,,,2,2,1,3
C(C)(C(CO)(CC(C(C)O)=O)O)=O,,,5,1,1,0,1
10293_0,,,,2,2,1,3
C(C)(C(CO)(C(C(CC)=O)O)O)=O,,,5,1,2,0,2
10293_1,,,,2,2,1,3
10295_0,,,,2,2,1,3
C(C)(C(CO)(C(C(CO)=O)C)O)=O,,,5,1,1,0,1
10297_0,,,,2,2,1,3
C(C(C=O)C(C(C)=O)(CO)O)=O,,,5,1,2,0,2
10297_1,,,,2,2,1,3
10299_0,,,,2,2,1,3
C(C(CCO)C(C(C)=O)(CO)O)=O,,,5,1,1,0,1
10300_0,,,,2,2,1,3
10301_0,,,,2,2,1,3
10301_1,,,,2,2,1,3
10302_0,,,,2,2,1,3
10302_1,,,,2,2,1,3
10303_0,,,,2,2,1,3
10303_1,,,,2,2,1,3
10304_0,,,,2,2,1,3
10306_0,,,,2,2,1,3
C(C(CO)C(C(C)=O)(CO)O)=O,,,5,1,5,0,5
10306_1,,,,2,2,1,3
10308_0,,,,2,2,1,3
C(C)(C(CO)(C(C(CO)=O)O)O)=O,,,5,1,7,0,7
10308_1,,,,2,2,1,3
10310_0,,,,2,2,1,3
C(C)(C(CO)(CC(CO)=O)O)=O,,,5,1,3,0,3
10312_0,,,,2,2,1,3
C(C)(C(CO)(C(C(C)=O)O)O)=O,,,5,1,6,0,6
10312_1,,,,2,2,1,3
10314_0,,,,2,2,1,3
C(C(C=C)C(C(C)=O)(CO)O)=O,,,5,1,3,0,3
10316_0,,,,2,2,1,3
C(C)(C(CO)(C(C=O)O)O)=O,,,5,1,6,0,6
10316_1,,,,2,2,1,3
10317_0,,,,2,2,1,3
10319_0,,,,2,2,1,3
C(CO)(C(C)(CC(C(C)=O)=O)O)=O,,,5,1,1,0,1
10321_0,,,,2,2,1,3
C(CO)(C(C)(CC(CCO)=O)O)=O,,,5,1,1,0,1
10323_0,,,,2,2,1,3
C(C)(C(CO)C(C(CO)=O)(C)O)=O,,,5,1,2,0,2
10323_1,,,,2,2,1,3
10325_0,,,,2,2,1,3
C(C)(C(C)C(C(CO)=O)(C)O)=O,,,5,1,1,0,1
10327_0,,,,2,2,1,3
C(CO)(C(C)(CC(CC)=O)O)=O,,,5,1,1,0,1
10329_0,,,,2,2,1,3
C(CO)(C(C)(CC(C(C)O)=O)O)=O,,,5,1,1,0,1
10331_0,,,,2,2,1,3
C(CO)(C(C)(C(C(CC)=O)O)O)=O,,,5,1,2,0,2
10331_1,,,,2,2,1,3
10333_0,,,,2,2,1,3
C(CO)(C(C)C(C(CO)=O)(C)O)=O,,,5,1,1,0,1
10335_0,,,,2,2,1,3
C(C(C=O)C(C(CO)=O)(C)O)=O,,,5,1,2,0,2
10335_1,,,,2,2,1,3
10337_0,,,,2,2,1,3
C(C(CCO)C(C(CO)=O)(C)O)=O,,,5,1,1,0,1
10339_0,,,,2,2,1,3
C(CO)(C(C)(CC=O)O)=O,,,5,1,1,0,1
10341_0,,,,2,2,1,3
C(C(C(C)O)C(C(CO)=O)(C)O)=O,,,5,1,2,0,2
10341_1,,,,2,2,1,3
10343_0,,,,2,2,1,3
C(C(C=O)C(C(CO)=O)(C)O)(O)=O,,,5,1,2,0,2
10343_1,,,,2,2,1,3
10345_0,,,,2,2,1,3
C(CO)(C(C)(C(C(C=O)=O)O)O)=O,,,5,1,2,0,2
10345_1,,,,2,2,1,3
10347_0,,,,2,2,1,3
C(CO)(C(C)(CC(C=O)=O)O)=O,,,5,1,1,0,1
10349_0,,,,2,2,1,3
C(C(CO)C(C(CO)=O)(C)O)=O,,,5,1,2,0,2
10349_1,,,,2,2,1,3
10351_0,,,,2,2,1,3
C(CO)(C(C)(C(C(CO)=O)O)O)=O,,,5,1,2,0,2
10351_1,,,,2,2,1,3
10353_0,,,,2,2,1,3
C(CO)(C(C)(CC(CO)=O)O)=O,,,5,1,1,0,1
10355_0,,,,2,2,1,3
C(CO)(C(C)(C(C(C)=O)O)O)=O,,,5,1,2,0,2
10355_1,,,,2,2,1,3
10357_0,,,,2,2,1,3
C(C(C=C)C(C(CO)=O)(C)O)=O,,,5,1,1,0,1
10359_0,,,,2,2,1,3
C(CO)(C(C)(C(C=O)O)O)=O,,,5,1,2,0,2
10359_1,,,,2,2,1,3
10361_0,,,,2,2,1,3
C(CO)(C(C)(CC(C(O)=O)=O)O)=O,,,5,1,1,0,1
10363_0,,,,2,2,1,3
C(C)(C(C)(C(C(C(C)=O)=O)O)O)=O,,,5,1,3,0,3
10363_1,,,,2,2,1,3
10365_0,,,,2,2,1,3
[C](C(O)=O)(C(C(C(C)=O)=O)O)O,,,5,1,5,0,5
10365_1,,,,2,2,1,3
10367_0,,,,2,2,1,3
C(C(C)=O)(C(C(C)(CCO)O)O)=O,,,5,1,2,0,2
10367_1,,,,2,2,1,3
10369_0,,,,2,2,1,3
C(C(C)=O)(C(C(C)(CC)O)O)=O,,,5,1,2,0,2
10369_1,,,,2,2,1,3
10371_0,,,,2,2,1,3
C(C(C)=O)(C(C(C)(C(C)O)O)O)=O,,,5,1,2,0,2
10371_1,,,,2,2,1,3
10373_0,,,,2,2,1,3
C(C(C)=O)(C(C(CO)(CC)O)O)=O,,,5,1,2,0,2
10373_1,,,,2,2,1,3
10375_0,,,,2,2,1,3
C(CC(C(C(C(C)=O)=O)O)O)=O,,,5,1,2,0,2
10375_1,,,,2,2,1,3
10377_0,,,,2,2,1,3
C([CH]C(C(C(C(C)=O)=O)O)O)(O)=O,,,5,1,2,0,2
10377_1,,,,2,2,1,3
10379_0,,,,2,2,1,3
C(C(C=C)(C(C(C(C)=O)=O)O)O)=O,,,5,1,2,0,2
10379_1,,,,2,2,1,3
10381_0,,,,2,2,1,3
C=CC(C(C(C(C(C)=O)=O)O)O)=O,,,5,1,2,0,2
10381_1,,,,2,2,1,3
10383_0,,,,2,2,1,3
C=CC(C(C(C(C)=O)=O)O)O,,,5,1,2,0,2
10383_1,,,,2,2,1,3
10385_0,,,,2,2,1,3
C(C(C)=O)(C(C(C(CC)O)O)O)=O,,,5,1,2,0,2
10385_1,,,,2,2,1,3
10387_0,,,,2,2,1,3
C(C(C)=O)(C(C(CCCO)O)O)=O,,,5,1,2,0,2
10387_1,,,,2,2,1,3
10389_0,,,,2,2,1,3
C(C(C)=O)(C(C(C(O)O)O)O)=O,,,5,1,2,0,2
10389_1,,,,2,2,1,3
10391_0,,,,2,2,1,3
C(C(C)=O)(C(C(C)O)O)=O,,,5,1,4,0,4
10391_1,,,,2,2,1,3
10392_0,,,,2,2,1,3
10392_1,,,,2,2,1,3
10394_0,,,,2,2,1,3
C(C(C)=O)(C(C(CC(C)O)O)O)=O,,,5,1,2,0,2
10394_1,,,,2,2,1,3
10396_0,,,,2,2,1,3
C(CC(C(C(C(C)=O)=O)O)O)(O)=O,,,5,1,2,0,2
10396_1,,,,2,2,1,3
10398_0,,,,2,2,1,3
C(CO)(C(C(C(C(C)=O)=O)O)O)=O,,,5,1,4,0,4
10398_1,,,,2,2,1,3
10400_0,,,,2,2,1,3
C(C(CO)(C(C(C(C)=O)=O)O)O)=O,,,5,1,4,0,4
10400_1,,,,2,2,1,3
10402_0,,,,2,2,1,3
C(C(C)(C(C(C(C)=O)=O)O)O)=O,,,5,1,5,0,5
10402_1,,,,2,2,1,3
10404_0,,,,2,2,1,3
C(C)(C(C(C(C(C)=O)=O)O)O)=O,,,5,1,6,0,6
10404_1,,,,2,2,1,3
10405_0,,,,2,2,1,3
10405_1,,,,2,2,1,3
10407_0,,,,2,2,1,3
C(C(C)=O)(C(C(CCO)O)O)=O,,,5,1,2,0,2
10407_1,,,,2,2,1,3
10409_0,,,,2,2,1,3
C(C(C(C(C(C)=O)=O)O)O)=O,,,5,1,10,0,10
10409_1,,,,2,2,1,3
10411_0,,,,2,2,1,3
C(C(C(C(C(C(C)=O)=O)O)O)O)=O,,,5,1,2,0,2
10411_1,,,,2,2,1,3
10413_0,,,,2,2,1,3
C(C(C)=O)(C(C(CO)(CO)O)O)=O,,,5,1,2,0,2
10413_1,,,,2,2,1,3
10415_0,,,,2,2,1,3
C(C(C)=O)(C(C(CO)(C)O)O)=O,,,5,1,2,0,2
10415_1,,,,2,2,1,3
10417_0,,,,2,2,1,3
C(C)=CC(C(C(C(C)=O)=O)O)O,,,5,1,2,0,2
10417_1,,,,2,2,1,3
10419_0,,,,2,2,1,3
C(CC(C(C(C(C)=O)=O)O)O)=C,,,5,1,2,0,2
10419_1,,,,2,2,1,3
10421_0,,,,2,2,1,3
C(C(C)=O)(C(C(C(CO)O)O)O)=O,,,5,1,2,0,2
10421_1,,,,2,2,1,3
10423_0,,,,2,2,1,3
C(C(C)=O)(C(C(CO)O)O)=O,,,5,1,4,0,4
10423_1,,,,2,2,1,3
10425_0,,,,2,2,1,3
C(C(C)=O)(C(C(C(C)O)O)O)=O,,,5,1,2,0,2
10425_1,,,,2,2,1,3
10426_0,,,,2,2,1,3
10426_1,,,,2,2,1,3
10428_0,,,,2,2,1,3
C(C(C)(C(C(C(C)=O)=O)O)O)(O)=O,,,5,1,3,0,3
10428_1,,,,2,2,1,3
10430_0,,,,2,2,1,3
C(C)(C(C)(CC(C(CO)=O)=O)O)=O,,,5,1,1,0,1
10432_0,,,,2,2,1,3
[C](C(O)=O)(CC(C(CO)=O)=O)O,,,5,1,4,0,4
10434_0,,,,2,2,1,3
C(C(CO)=O)(CC(C)(CCO)O)=O,,,5,1,1,0,1
10436_0,,,,2,2,1,3
C(C(CO)=O)(CC(C)(CC)O)=O,,,5,1,1,0,1
10438_0,,,,2,2,1,3
C(C(CO)=O)(CC(C)(C(C)O)O)=O,,,5,1,1,0,1
10440_0,,,,2,2,1,3
C(C(CO)=O)(CC(CO)(CC)O)=O,,,5,1,1,0,1
10441_0,,,,2,2,1,3
10443_0,,,,2,2,1,3
C([CH]C(CC(C(CO)=O)=O)O)(O)=O,,,5,1,1,0,1
10445_0,,,,2,2,1,3
C(C(C=C)(CC(C(CO)=O)=O)O)=O,,,5,1,1,0,1
10447_0,,,,2,2,1,3
C=CC(C(CC(C(CO)=O)=O)O)=O,,,5,1,1,0,1
10449_0,,,,2,2,1,3
C=CC(CC(C(CO)=O)=O)O,,,5,1,1,0,1
10451_0,,,,2,2,1,3
C(C(CO)=O)(CC(C(CC)O)O)=O,,,5,1,1,0,1
10453_0,,,,2,2,1,3
C(C(CO)=O)(CC(CCCO)O)=O,,,5,1,1,0,1
10455_0,,,,2,2,1,3
C(C(CO)=O)(CC(C(O)O)O)=O,,,5,1,1,0,1
10457_0,,,,2,2,1,3
C(C(CO)=O)(CC(C)O)=O,,,5,1,3,0,3
10458_0,,,,2,2,1,3
10460_0,,,,2,2,1,3
C(C(CO)=O)(CC(CC(C)O)O)=O,,,5,1,1,0,1
10462_0,,,,2,2,1,3
C(CC(CC(C(CO)=O)=O)O)(O)=O,,,5,1,1,0,1
10464_0,,,,2,2,1,3
C(CO)(C(CC(C(CO)=O)=O)O)=O,,,5,1,1,0,1
10466_0,,,,2,2,1,3
C(C(CO)(CC(C(CO)=O)=O)O)=O,,,5,1,1,0,1
10468_0,,,,2,2,1,3
C(C(C)(CC(C(CO)=O)=O)O)=O,,,5,1,1,0,1
10470_0,,,,2,2,1,3
C(C)(C(CC(C(CO)=O)=O)O)=O,,,5,1,1,0,1
10472_0,,,,2,2,1,3
C(C(CO)=O)(CCO)=O,,,5,1,7,0,7
10474_0,,,,2,2,1,3
C(C(CO)=O)(CC(CCO)O)=O,,,5,1,1,0,1
10476_0,,,,2,2,1,3
C(C(CC(C(CO)=O)=O)O)=O,,,5,1,4,0,4
10477_0,,,,2,2,1,3
10479_0,,,,2,2,1,3
C(C(CO)=O)(CC(CO)(CO)O)=O,,,5,1,1,0,1
10481_0,,,,2,2,1,3
C(C(CO)=O)(CC(CO)(C)O)=O,,,5,1,1,0,1
10483_0,,,,2,2,1,3
C(C)=CC(CC(C(CO)=O)=O)O,,,5,1,1,0,1
10485_0,,,,2,2,1,3
C(CC(CC(C(CO)=O)=O)O)=C,,,5,1,1,0,1
10487_0,,,,2,2,1,3
C(C(CO)=O)(CC(C(CO)O)O)=O,,,5,1,1,0,1
10489_0,,,,2,2,1,3
C(C(CO)=O)(CC(CO)O)=O,,,5,1,2,0,2
10491_0,,,,2,2,1,3
C(C(CO)=O)(CC(C(C)O)O)=O,,,5,1,1,0,1
10493_0,,,,2,2,1,3
C(C(CC(C(CO)=O)=O)O)(O)=O,,,5,1,6,0,6
10495_0,,,,2,2,1,3
C(C(C)(CC(C(CO)=O)=O)O)(O)=O,,,5,1,1,0,1
10497_0,,,,2,2,1,3
C(C(C(C(C(CO)O)=O)=O)O)(O)=O,,,5,1,4,0,4
10497_1,,,,2,2,1,3
10499_0,,,,2,2,1,3
C(C(CC(C(C)=O)=O)O)(C(C)O)=O,,,5,1,2,0,2
10501_0,,,,2,2,1,3
C(CC(C(C(C)O)=O)O)(CCO)=O,,,5,1,1,0,1
10503_0,,,,2,2,1,3
C(C)(C(CO)C(C(C(C)O)=O)O)=O,,,5,1,2,0,2
10503_1,,,,2,2,1,3
10505_0,,,,2,2,1,3
C(C)(C(C)C(C(C(C)O)=O)O)=O,,,5,1,1,0,1
10507_0,,,,2,2,1,3
C(CC(C(C(C)O)=O)O)(CC)=O,,,5,1,1,0,1
10509_0,,,,2,2,1,3
C(CC(C(C(C)O)=O)O)(C(C)O)=O,,,5,1,1,0,1
10511_0,,,,2,2,1,3
C(C(C(C(C(C)O)=O)O)O)(CC)=O,,,5,1,2,0,2
10511_1,,,,2,2,1,3
10513_0,,,,2,2,1,3
C(CO)(C(C)C(C(C(C)O)=O)O)=O,,,5,1,1,0,1
10515_0,,,,2,2,1,3
C(C(C=O)C(C(C(C)O)=O)O)=O,,,5,1,2,0,2
10515_1,,,,2,2,1,3
10517_0,,,,2,2,1,3
C(C(CCO)C(C(C(C)O)=O)O)=O,,,5,1,1,0,1
10519_0,,,,2,2,1,3
C(CC(C(C(C)O)=O)O)=O,,,5,1,3,0,3
10521_0,,,,2,2,1,3
C(C(C(C)O)C(C(C(C)O)=O)O)=O,,,5,1,2,0,2
10521_1,,,,2,2,1,3
10523_0,,,,2,2,1,3
C(C(C=O)C(C(C(C)O)=O)O)(O)=O,,,5,1,2,0,2
10523_1,,,,2,2,1,3
10525_0,,,,2,2,1,3
C(C(C(C(C=O)=O)O)O)(C(C)O)=O,,,5,1,2,0,2
10525_1,,,,2,2,1,3
10527_0,,,,2,2,1,3
C(C(CC(C=O)=O)O)(C(C)O)=O,,,5,1,1,0,1
10529_0,,,,2,2,1,3
C(C(CO)C(C(C(C)O)=O)O)=O,,,5,1,2,0,2
10529_1,,,,2,2,1,3
10531_0,,,,2,2,1,3
C(C(C(C(C(C)O)=O)O)O)(CO)=O,,,5,1,2,0,2
10531_1,,,,2,2,1,3
10533_0,,,,2,2,1,3
C(CC(C(C(C)O)=O)O)(CO)=O,,,5,1,1,0,1
10535_0,,,,2,2,1,3
C(C(C(C(C(C)O)=O)O)O)(C)=O,,,5,1,2,0,2
10535_1,,,,2,2,1,3
10537_0,,,,2,2,1,3
C(C(C=C)C(C(C(C)O)=O)O)=O,,,5,1,1,0,1
10539_0,,,,2,2,1,3
C(C(C(C=O)O)O)(C(C)O)=O,,,5,1,8,0,8
10539_1,,,,2,2,1,3
10541_0,,,,2,2,1,3
C(C(CC(C(O)=O)=O)O)(C(C)O)=O,,,5,1,1,0,1
10543_0,,,,2,2,1,3
C(C(C(C)O)(CC(C(C)=O)=O)O)=O,,,5,1,1,0,1
10545_0,,,,2,2,1,3
C(C(C(C)O)(CC(CCO)=O)O)=O,,,5,1,1,0,1
10547_0,,,,2,2,1,3
C(C(C(C)O)(C(C(C)=O)CO)O)=O,,,5,1,2,0,2
10547_1,,,,2,2,1,3
10549_0,,,,2,2,1,3
C(C(C(C)O)(C(C(C)=O)C)O)=O,,,5,1,1,0,1
10551_0,,,,2,2,1,3
C(C(C(C)O)(CC(CC)=O)O)=O,,,5,1,1,0,1
10553_0,,,,2,2,1,3
C(C(C(C)O)(CC(C(C)O)=O)O)=O,,,5,1,1,0,1
10555_0,,,,2,2,1,3
C(C(C(C)O)(C(C(CC)=O)O)O)=O,,,5,1,2,0,2
10555_1,,,,2,2,1,3
10557_0,,,,2,2,1,3
C(C(C(C)O)(C(C(CO)=O)C)O)=O,,,5,1,1,0,1
10559_0,,,,2,2,1,3
C(C(C=O)C(C=O)(C(C)O)O)=O,,,5,1,2,0,2
10559_1,,,,2,2,1,3
10561_0,,,,2,2,1,3
C(C(CCO)C(C=O)(C(C)O)O)=O,,,5,1,1,0,1
10563_0,,,,2,2,1,3
C(C(C(C)O)(CC=O)O)=O,,,5,1,2,0,2
10565_0,,,,2,2,1,3
C(C(C(C)O)C(C=O)(C(C)O)O)=O,,,5,1,3,0,3
10565_1,,,,2,2,1,3
10567_0,,,,2,2,1,3
C(C(C=O)C(C=O)(C(C)O)O)(O)=O,,,5,1,3,0,3
10567_1,,,,2,2,1,3
10569_0,,,,2,2,1,3
C(C(C(C)O)(C(C(C=O)=O)O)O)=O,,,5,1,6,0,6
10569_1,,,,2,2,1,3
10571_0,,,,2,2,1,3
C(C(C(C)O)(CC(C=O)=O)O)=O,,,5,1,2,0,2
10573_0,,,,2,2,1,3
C(C(CO)C(C=O)(C(C)O)O)=O,,,5,1,4,0,4
10573_1,,,,2,2,1,3
10575_0,,,,2,2,1,3
C(C(C(C)O)(C(C(CO)=O)O)O)=O,,,5,1,7,0,7
10575_1,,,,2,2,1,3
10577_0,,,,2,2,1,3
C(C(C(C)O)(CC(CO)=O)O)=O,,,5,1,3,0,3
10579_0,,,,2,2,1,3
C(C(C(C)O)(C(C(C)=O)O)O)=O,,,5,1,7,0,7
10579_1,,,,2,2,1,3
10581_0,,,,2,2,1,3
C(C(C=C)C(C=O)(C(C)O)O)=O,,,5,1,2,0,2
10583_0,,,,2,2,1,3
C(C(C(C)O)(C(C=O)O)O)=O,,,5,1,6,0,6
10583_1,,,,2,2,1,3
10585_0,,,,2,2,1,3
C(C(C(C)O)(CC(C(O)=O)=O)O)=O,,,5,1,2,0,2
10587_0,,,,2,2,1,3
C(C(C=O)(CC(C(C)=O)=O)O)(O)=O,,,5,1,1,0,1
10589_0,,,,2,2,1,3
C(C(C=O)(CC(CCO)=O)O)(O)=O,,,5,1,1,0,1
10591_0,,,,2,2,1,3
C(C(C=O)(C(C(C)=O)CO)O)(O)=O,,,5,1,2,0,2
10591_1,,,,2,2,1,3
10593_0,,,,2,2,1,3
C(C(C=O)(C(C(C)=O)C)O)(O)=O,,,5,1,1,0,1
10595_0,,,,2,2,1,3
C(C(C=O)(CC(CC)=O)O)(O)=O,,,5,1,1,0,1
10597_0,,,,2,2,1,3
C(C(C=O)(CC(C(C)O)=O)O)(O)=O,,,5,1,1,0,1
10599_0,,,,2,2,1,3
C(C(C=O)(C(C(CC)=O)O)O)(O)=O,,,5,1,2,0,2
10599_1,,,,2,2,1,3
10601_0,,,,2,2,1,3
C(C(C=O)(C(C(CO)=O)C)O)(O)=O,,,5,1,1,0,1
10603_0,,,,2,2,1,3
C(C(C=O)(C(C=O)C=O)O)(O)=O,,,5,1,3,0,3
10603_1,,,,2,2,1,3
10605_0,,,,2,2,1,3
C(C(C=O)(C(C=O)CCO)O)(O)=O,,,5,1,1,0,1
10607_0,,,,2,2,1,3
C(C(C=O)(CC=O)O)(O)=O,,,5,1,3,0,3
10609_0,,,,2,2,1,3
C(C(C=O)(C(C=O)C(C)O)O)(O)=O,,,5,1,3,0,3
10609_1,,,,2,2,1,3
10611_0,,,,2,2,1,3
C(C(C=O)C(C(O)=O)(C=O)O)(O)=O,,,5,1,3,0,3
10611_1,,,,2,2,1,3
10613_0,,,,2,2,1,3
C(C(C=O)(C(C(C=O)=O)O)O)(O)=O,,,5,1,7,0,7
10613_1,,,,2,2,1,3
10615_0,,,,2,2,1,3
C(C(C=O)(CC(C=O)=O)O)(O)=O,,,5,1,3,0,3
10617_0,,,,2,2,1,3
C(C(C=O)(C(C=O)CO)O)(O)=O,,,5,1,6,0,6
10617_1,,,,2,2,1,3
10618_0,,,,2,2,1,3
10618_1,,,,2,2,1,3
10620_0,,,,2,2,1,3
C(C(C=O)(CC(CO)=O)O)(O)=O,,,5,1,7,0,7
10621_0,,,,2,2,1,3
10621_1,,,,2,2,1,3
10623_0,,,,2,2,1,3
C(C(C=O)(C(C=O)C=C)O)(O)=O,,,5,1,2,0,2
10624_0,,,,2,2,1,3
10624_1,,,,2,2,1,3
10626_0,,,,2,2,1,3
C(C(C=O)(CC(C(O)=O)=O)O)(O)=O,,,5,1,2,0,2
10628_0,,,,2,2,1,3
C(C(C(CC(C(C)=O)=O)O)=O)(O)=O,,,5,1,2,0,2
10630_0,,,,2,2,1,3
C(CC(C(C(O)=O)=O)O)(CCO)=O,,,5,1,1,0,1
10632_0,,,,2,2,1,3
C(C)(C(CO)C(C(C(O)=O)=O)O)=O,,,5,1,2,0,2
10632_1,,,,2,2,1,3
10634_0,,,,2,2,1,3
C(C)(C(C)C(C(C(O)=O)=O)O)=O,,,5,1,1,0,1
10636_0,,,,2,2,1,3
C(CC(C(C(O)=O)=O)O)(CC)=O,,,5,1,1,0,1
10638_0,,,,2,2,1,3
C(CC(C(C(O)=O)=O)O)(C(C)O)=O,,,5,1,1,0,1
10640_0,,,,2,2,1,3
C(C(C(C(C(O)=O)=O)O)O)(CC)=O,,,5,1,2,0,2
10640_1,,,,2,2,1,3
10642_0,,,,2,2,1,3
C(CO)(C(C)C(C(C(O)=O)=O)O)=O,,,5,1,1,0,1
10643_0,,,,2,2,1,3
10643_1,,,,2,2,1,3
10645_0,,,,2,2,1,3
C(C(CCO)C(C(C(O)=O)=O)O)=O,,,5,1,2,0,2
10647_0,,,,2,2,1,3
C(CC(C(C(O)=O)=O)O)=O,,,5,1,5,0,5
10649_0,,,,2,2,1,3
C(C(C(C)O)C(C(C(O)=O)=O)O)=O,,,5,1,3,0,3
10649_1,,,,2,2,1,3
10651_0,,,,2,2,1,3
C(C(C=O)C(C(C(O)=O)=O)O)(O)=O,,,5,1,5,0,5
10651_1,,,,2,2,1,3
10652_0,,,,2,2,1,3
10652_1,,,,2,2,1,3
10654_0,,,,2,2,1,3
C(C(C(CC(C=O)=O)O)=O)(O)=O,,,5,1,3,0,3
10656_0,,,,2,2,1,3
C(C(CO)C(C(C(O)=O)=O)O)=O,,,5,1,7,0,7
10656_1,,,,2,2,1,3
10657_0,,,,2,2,1,3
10657_1,,,,2,2,1,3
10659_0,,,,2,2,1,3
C(CO)(CC(C(C(O)=O)=O)O)=O,,,5,1,4,0,4
10660_0,,,,2,2,1,3
10660_1,,,,2,2,1,3
10662_0,,,,2,2,1,3
C(C(C=C)C(C(C(O)=O)=O)O)=O,,,5,1,2,0,2
10663_0,,,,2,2,1,3
10663_1,,,,2,2,1,3
10665_0,,,,2,2,1,3
C(C(CC(C(C(O)=O)=O)O)=O)(O)=O,,,5,1,2,0,2
10666_0,,,,2,2,1,3
10668_0,,,,2,2,1,3
C(C(C)(CC=O)O)(C(C(O)=O)O)=O,,,5,1,1,0,1
10670_0,,,,2,2,1,3
C(C(C(C(CC(C)O)=O)=O)O)(O)=O,,,5,1,1,0,1
10672_0,,,,2,2,1,3
C(CC(C(C(C(O)=O)O)=O)=O)(O)=O,,,5,1,3,0,3
10674_0,,,,2,2,1,3
C(C(C(C(CCO)=O)=O)O)(O)=O,,,5,1,2,0,2
10676_0,,,,2,2,1,3
C(CC(C(C(C(O)=O)(C)O)=O)O)=O,,,5,1,1,0,1
10678_0,,,,2,2,1,3
C(C(C)(C(C=O)(CC=O)O)O)(O)=O,,,5,1,3,0,3
10680_0,,,,2,2,1,3
C=CC(C(CC(C(C(C)=O)=O)O)=O)=O,,,5,1,1,0,1
10682_0,,,,2,2,1,3
C(C(C(CC(C(C)=O)=O)O)=O)(C)=O,,,5,1,1,0,1
10684_0,,,,2,2,1,3
C(CC(C(C(C)=O)=O)O)(CCO)=O,,,5,1,1,0,1
10686_0,,,,2,2,1,3
C(C)(C(CO)C(C(C(C)=O)=O)O)=O,,,5,1,2,0,2
10686_1,,,,2,2,1,3
10688_0,,,,2,2,1,3
C(C)(C(C)C(C(C(C)=O)=O)O)=O,,,5,1,1,0,1
10690_0,,,,2,2,1,3
C(CC(C(C(C)=O)=O)O)(CC)=O,,,5,1,1,0,1
10692_0,,,,2,2,1,3
C(CC(C(C(C)=O)=O)O)(C(C)O)=O,,,5,1,1,0,1
10694_0,,,,2,2,1,3
C(C(C(C(C(C)=O)=O)O)O)(CC)=O,,,5,1,2,0,2
10694_1,,,,2,2,1,3
10696_0,,,,2,2,1,3
C(CO)(C(C)C(C(C(C)=O)=O)O)=O,,,5,1,1,0,1
10698_0,,,,2,2,1,3
C(C(C=O)C(C(C(C)=O)=O)O)=O,,,5,1,2,0,2
10698_1,,,,2,2,1,3
10700_0,,,,2,2,1,3
C(C(C(C=O)=C)C(C(C(C)=O)=O)O)=O,,,5,1,1,0,1
10702_0,,,,2,2,1,3
C(C=CC(CC(C(C(C)=O)=O)O)=O)=O,,,5,1,1,0,1
10704_0,,,,2,2,1,3
C=CC(C(C=O)=O)C(C(C(C)=O)=O)O,,,5,1,1,0,1
10706_0,,,,2,2,1,3
C(C(CCO)C(C(C(C)=O)=O)O)=O,,,5,1,1,0,1
10708_0,,,,2,2,1,3
C(CC(C(C(C)=O)=O)O)=O,,,5,1,3,0,3
10710_0,,,,2,2,1,3
C(C(C(C)O)C(C(C(C)=O)=O)O)=O,,,5,1,2,0,2
10710_1,,,,2,2,1,3
10712_0,,,,2,2,1,3
C(C(C=O)C(C(C(C)=O)=O)O)(O)=O,,,5,1,2,0,2
10712_1,,,,2,2,1,3
10713_0,,,,2,2,1,3
10713_1,,,,2,2,1,3
10715_0,,,,2,2,1,3
C(C(CC(C(C(C)=O)=O)O)=O)=O,,,5,1,3,0,3
10717_0,,,,2,2,1,3
C(C(CO)C(C(C(C)=O)=O)O)=O,,,5,1,4,0,4
10717_1,,,,2,2,1,3
10718_0,,,,2,2,1,3
10718_1,,,,2,2,1,3
10720_0,,,,2,2,1,3
C(CO)(CC(C(C(C)=O)=O)O)=O,,,5,1,3,0,3
10721_0,,,,2,2,1,3
10721_1,,,,2,2,1,3
10723_0,,,,2,2,1,3
C(C(C=C)C(C(C(C)=O)=O)O)=O,,,5,1,3,0,3
10724_0,,,,2,2,1,3
10724_1,,,,2,2,1,3
10726_0,,,,2,2,1,3
C(C(CC(C(C(C)=O)=O)O)=O)(O)=O,,,5,1,1,0,1
10728_0,,,,2,2,1,3
C=CC(C(CC(C(C=O)=O)(C)O)=O)=O,,,5,1,1,0,1
10730_0,,,,2,2,1,3
C(C(CC(C(C=O)=O)(C)O)=O)(C)=O,,,5,1,1,0,1
10732_0,,,,2,2,1,3
C(CC(C(C=O)=O)(C)O)(CCO)=O,,,5,1,1,0,1
10734_0,,,,2,2,1,3
C(C)(C(CO)C(C(C=O)=O)(C)O)=O,,,5,1,2,0,2
10734_1,,,,2,2,1,3
10736_0,,,,2,2,1,3
C(C)(C(C)C(C(C=O)=O)(C)O)=O,,,5,1,1,0,1
10738_0,,,,2,2,1,3
C(CC(C(C=O)=O)(C)O)(CC)=O,,,5,1,1,0,1
10740_0,,,,2,2,1,3
C(CC(C(C=O)=O)(C)O)(C(C)O)=O,,,5,1,1,0,1
10742_0,,,,2,2,1,3
C(C(C(C(C=O)=O)(C)O)O)(CC)=O,,,5,1,2,0,2
10742_1,,,,2,2,1,3
10744_0,,,,2,2,1,3
C(CO)(C(C)C(C(C=O)=O)(C)O)=O,,,5,1,1,0,1
10746_0,,,,2,2,1,3
C(C(C=O)C(C(C=O)=O)(C)O)=O,,,5,1,2,0,2
10746_1,,,,2,2,1,3
10748_0,,,,2,2,1,3
C(C(C(C=O)=C)C(C(C=O)=O)(C)O)=O,,,5,1,1,0,1
10750_0,,,,2,2,1,3
C(C=O)(C(C)(CC(C=CC=O)=O)O)=O,,,5,1,1,0,1
10752_0,,,,2,2,1,3
C=CC(C(C=O)=O)C(C(C=O)=O)(C)O,,,5,1,1,0,1
10754_0,,,,2,2,1,3
C(C(CCO)C(C(C=O)=O)(C)O)=O,,,5,1,1,0,1
10756_0,,,,2,2,1,3
C(CC(C(C=O)=O)(C)O)=O,,,5,1,1,0,1
10758_0,,,,2,2,1,3
C(C(C(C)O)C(C(C=O)=O)(C)O)=O,,,5,1,2,0,2
10758_1,,,,2,2,1,3
10760_0,,,,2,2,1,3
C(C(C=O)C(C(C=O)=O)(C)O)(O)=O,,,5,1,2,0,2
10760_1,,,,2,2,1,3
10762_0,,,,2,2,1,3
C(C=O)(C(C)(C(C(C=O)=O)O)O)=O,,,5,1,3,0,3
10762_1,,,,2,2,1,3
10764_0,,,,2,2,1,3
C(C=O)(C(C)(CC(C=O)=O)O)=O,,,5,1,1,0,1
10766_0,,,,2,2,1,3
C(C(CO)C(C(C=O)=O)(C)O)=O,,,5,1,2,0,2
10766_1,,,,2,2,1,3
10768_0,,,,2,2,1,3
C(C(C(C(C=O)=O)(C)O)O)(CO)=O,,,5,1,3,0,3
10768_1,,,,2,2,1,3
10770_0,,,,2,2,1,3
C(CC(C(C=O)=O)(C)O)(CO)=O,,,5,1,1,0,1
10772_0,,,,2,2,1,3
C(C(C(C(C=O)=O)(C)O)O)(C)=O,,,5,1,3,0,3
10772_1,,,,2,2,1,3
10774_0,,,,2,2,1,3
C(C(C=C)C(C(C=O)=O)(C)O)=O,,,5,1,1,0,1
10776_0,,,,2,2,1,3
C(C(C(C(C=O)=O)(C)O)O)=O,,,5,1,4,0,4
10776_1,,,,2,2,1,3
10778_0,,,,2,2,1,3
C(C=O)(C(C)(CC(C(O)=O)=O)O)=O,,,5,1,1,0,1
10780_0,,,,2,2,1,3
C(C(C(C)=O)(CC(C(C=C)=O)=O)O)=O,,,5,1,1,0,1
10782_0,,,,2,2,1,3
C(C(C(C)=O)(CC(C(C)=O)=O)O)=O,,,5,1,1,0,1
10784_0,,,,2,2,1,3
C(C)(C(C=O)(CC(CCO)=O)O)=O,,,5,1,1,0,1
10786_0,,,,2,2,1,3
C(C(C(C)=O)(C(C(C)=O)CO)O)=O,,,5,1,2,0,2
10786_1,,,,2,2,1,3
10788_0,,,,2,2,1,3
C(C(C(C)=O)(C(C(C)=O)C)O)=O,,,5,1,1,0,1
10790_0,,,,2,2,1,3
C(C)(C(C=O)(CC(CC)=O)O)=O,,,5,1,1,0,1
10792_0,,,,2,2,1,3
C(C)(C(C=O)(CC(C(C)O)=O)O)=O,,,5,1,1,0,1
10794_0,,,,2,2,1,3
C(C)(C(C=O)(C(C(CC)=O)O)O)=O,,,5,1,2,0,2
10794_1,,,,2,2,1,3
10796_0,,,,2,2,1,3
C(C)(C(C=O)(C(C(CO)=O)C)O)=O,,,5,1,1,0,1
10798_0,,,,2,2,1,3
C(C(C=O)C(C=O)(C(C)=O)O)=O,,,5,1,2,0,2
10798_1,,,,2,2,1,3
10800_0,,,,2,2,1,3
C(C(C(C=O)=C)C(C=O)(C(C)=O)O)=O,,,5,1,1,0,1
10802_0,,,,2,2,1,3
C(C(C(C)=O)(CC(C=CC=O)=O)O)=O,,,5,1,1,0,1
10804_0,,,,2,2,1,3
C(C(C(C)=O)(C(C=C)C(C=O)=O)O)=O,,,5,1,1,0,1
10806_0,,,,2,2,1,3
C(C(CCO)C(C=O)(C(C)=O)O)=O,,,5,1,1,0,1
10808_0,,,,2,2,1,3
C(C(C(C)=O)(CC=O)O)=O,,,5,1,2,0,2
10810_0,,,,2,2,1,3
C(C(C(C)O)C(C=O)(C(C)=O)O)=O,,,5,1,2,0,2
10810_1,,,,2,2,1,3
10812_0,,,,2,2,1,3
C(C(C=O)C(C=O)(C(C)=O)O)(O)=O,,,5,1,2,0,2
10812_1,,,,2,2,1,3
10814_0,,,,2,2,1,3
C(C(C(C)=O)(C(C(C=O)=O)O)O)=O,,,5,1,4,0,4
10814_1,,,,2,2,1,3
10816_0,,,,2,2,1,3
C(C(C(C)=O)(CC(C=O)=O)O)=O,,,5,1,2,0,2
10818_0,,,,2,2,1,3
C(C(CO)C(C=O)(C(C)=O)O)=O,,,5,1,3,0,3
10818_1,,,,2,2,1,3
10820_0,,,,2,2,1,3
C(C(C(C)=O)(C(C(CO)=O)O)O)=O,,,5,1,4,0,4
10820_1,,,,2,2,1,3
10822_0,,,,2,2,1,3
C(C(C(C)=O)(CC(CO)=O)O)=O,,,5,1,2,0,2
10824_0,,,,2,2,1,3
C(C(C(C)=O)(C(C(C)=O)O)O)=O,,,5,1,5,0,5
10824_1,,,,2,2,1,3
10826_0,,,,2,2,1,3
C(C(C=C)C(C=O)(C(C)=O)O)=O,,,5,1,2,0,2
10828_0,,,,2,2,1,3
C(C(C(C)=O)(C(C=O)O)O)=O,,,5,1,5,0,5
10828_1,,,,2,2,1,3
10830_0,,,,2,2,1,3
C(C(C(C)=O)(CC(C(O)=O)=O)O)=O,,,5,1,1,0,1
10832_0,,,,2,2,1,3
C(C)(C(C=C)(CC(C(C=O)=O)=O)O)=O,,,5,1,1,0,1
10834_0,,,,2,2,1,3
C=CC(C(C)(CC(C(C=O)=O)=O)O)=O,,,5,1,1,0,1
10836_0,,,,2,2,1,3
C(C)(C(C)(CC(C(C=O)=O)=O)O)=O,,,5,1,1,0,1
10838_0,,,,2,2,1,3
C(C(C(C[C](C(O)=O)O)=O)=O)=O,,,5,1,1,0,1
10840_0,,,,2,2,1,3
C(C(C(CC(C)(CCO)O)=O)=O)=O,,,5,1,1,0,1
10842_0,,,,2,2,1,3
C(C(C(CC(C)(CC)O)=O)=O)=O,,,5,1,1,0,1
10844_0,,,,2,2,1,3
C(C(C(CC(C)(C(C)O)O)=O)=O)=O,,,5,1,1,0,1
10846_0,,,,2,2,1,3
C(C(C(CC(CO)(CC)O)=O)=O)=O,,,5,1,1,0,1
10848_0,,,,2,2,1,3
C(CC(CC(C(C=O)=O)=O)O)=O,,,5,1,1,0,1
10850_0,,,,2,2,1,3
C([CH]C(CC(C(C=O)=O)=O)O)(O)=O,,,5,1,1,0,1
10852_0,,,,2,2,1,3
C(C(CC(C(C=O)=O)=O)O)=C(C=O)C,,,5,1,1,0,1
10854_0,,,,2,2,1,3
C(C)(C(CC(C(C=O)=O)=O)O)=CC=O,,,5,1,1,0,1
10856_0,,,,2,2,1,3
C=C(C=O)CC(CC(C(C=O)=O)=O)O,,,5,1,1,0,1
10858_0,,,,2,2,1,3
C(CC(C(CC(C(C=O)=O)=O)O)=C)=O,,,5,1,1,0,1
10860_0,,,,2,2,1,3
C(C(CC(C(C=O)=O)=O)O)=CC(C)=O,,,5,1,1,0,1
10862_0,,,,2,2,1,3
C(C(C)(CC(C(C=O)=O)=O)O)=CC=O,,,5,1,1,0,1
10864_0,,,,2,2,1,3
C(C(C=C)(CC(C(C=O)=O)=O)O)=O,,,5,1,1,0,1
10866_0,,,,2,2,1,3
C=CC(C(CC(C(C=O)=O)=O)O)=O,,,5,1,1,0,1
10868_0,,,,2,2,1,3
C(C(CC(C(C=O)=O)=O)(CC=C)O)=O,,,5,1,1,0,1
10870_0,,,,2,2,1,3
C(C(CC(C(C=O)=O)=O)O)(CC=C)=O,,,5,1,1,0,1
10872_0,,,,2,2,1,3
C(C(C=CC)(CC(C(C=O)=O)=O)O)=O,,,5,1,1,0,1
10874_0,,,,2,2,1,3
C(C)=CC(C(CC(C(C=O)=O)=O)O)=O,,,5,1,1,0,1
10876_0,,,,2,2,1,3
C=CC(CC(C(C=O)=O)=O)O,,,5,1,1,0,1
10878_0,,,,2,2,1,3
C(C(C(CC(C(CC)O)O)=O)=O)=O,,,5,1,1,0,1
10880_0,,,,2,2,1,3
C(C(C(CC(CCCO)O)=O)=O)=O,,,5,1,1,0,1
10882_0,,,,2,2,1,3
C(C(C(CC(C(O)O)O)=O)=O)=O,,,5,1,1,0,1
10884_0,,,,2,2,1,3
C(C(C(CC(C)O)=O)=O)=O,,,5,1,2,0,2
10886_0,,,,2,2,1,3
C(CC(C(C=O)=O)=O)(O)=O,,,5,1,4,0,4
10888_0,,,,2,2,1,3
C(C(C(CC(CC(C)O)O)=O)=O)=O,,,5,1,1,0,1
10890_0,,,,2,2,1,3
C(CC(CC(C(C=O)=O)=O)O)(O)=O,,,5,1,1,0,1
10892_0,,,,2,2,1,3
C(CO)(C(CC(C(C=O)=O)=O)O)=O,,,5,1,1,0,1
10894_0,,,,2,2,1,3
C(C(CO)(CC(C(C=O)=O)=O)O)=O,,,5,1,1,0,1
10896_0,,,,2,2,1,3
C(C(C)(CC(C(C=O)=O)=O)O)=O,,,5,1,1,0,1
10898_0,,,,2,2,1,3
C(C)(C(CC(C(C=O)=O)=O)O)=O,,,5,1,1,0,1
10900_0,,,,2,2,1,3
C(C(C(CCO)=O)=O)=O,,,5,1,4,0,4
10902_0,,,,2,2,1,3
C(C(C(CC(CCO)O)=O)=O)=O,,,5,1,1,0,1
10904_0,,,,2,2,1,3
C(C(CC(C(C=O)=O)=O)O)=O,,,5,1,3,0,3
10906_0,,,,2,2,1,3
C(C(C(CC(C(C=O)=O)=O)O)O)=O,,,5,1,1,0,1
10908_0,,,,2,2,1,3
C(C(C(CC(CO)(CO)O)=O)=O)=O,,,5,1,1,0,1
10910_0,,,,2,2,1,3
C(C(C(CC(C)(CO)O)=O)=O)=O,,,5,1,1,0,1
10912_0,,,,2,2,1,3
C(C(CC(C(C=O)=O)=O)O)=CC,,,5,1,1,0,1
10914_0,,,,2,2,1,3
C=CCC(CC(C(C=O)=O)=O)O,,,5,1,1,0,1
10916_0,,,,2,2,1,3
C(C(C(CC(C(CO)O)O)=O)=O)=O,,,5,1,1,0,1
10918_0,,,,2,2,1,3
C(C(C(CC(CO)O)=O)=O)=O,,,5,1,3,0,3
10920_0,,,,2,2,1,3
C(C(C(CC(C(C)O)O)=O)=O)=O,,,5,1,1,0,1
10922_0,,,,2,2,1,3
C(C(CC(C(C=O)=O)=O)O)(O)=O,,,5,1,2,0,2
10924_0,,,,2,2,1,3
C(C(C)(CC(C(C=O)=O)=O)O)(O)=O,,,5,1,1,0,1
10926_0,,,,2,2,1,3
C(C(C(C(C(C)=O)=O)=O)CO)(O)=O,,,5,1,2,0,2
10926_1,,,,2,2,1,3
10928_0,,,,2,2,1,3
C(CC(C(C(CCO)=O)=O)=O)(O)=O,,,5,1,1,0,1
10930_0,,,,2,2,1,3
C(C)(C(C)C(C(C=C)=O)(CO)O)=O,,,5,1,1,0,1
10932_0,,,,2,2,1,3
C(CC(C(C=C)=O)(CO)O)(CC)=O,,,5,1,1,0,1
10934_0,,,,2,2,1,3
C(C(C=O)C(C(C=C)=O)(CO)O)=O,,,5,1,2,0,2
10934_1,,,,2,2,1,3
10936_0,,,,2,2,1,3
C(CC(C(C=C)=O)(CO)O)=O,,,5,1,2,0,2
10938_0,,,,2,2,1,3
C=CC(C(CO)(CC(C=O)=O)O)=O,,,5,1,1,0,1
10940_0,,,,2,2,1,3
C(C(CO)C(C(C=C)=O)(CO)O)=O,,,5,1,2,0,2
10940_1,,,,2,2,1,3
10942_0,,,,2,2,1,3
C(CC(C(C=C)=O)(CO)O)(CO)=O,,,5,1,1,0,1
10944_0,,,,2,2,1,3
C(C(C(C(C=C)=O)(CO)O)O)(C)=O,,,5,1,2,0,2
10944_1,,,,2,2,1,3
10946_0,,,,2,2,1,3
C(C(C=C)C(C(C=C)=O)(CO)O)=O,,,5,1,1,0,1
10948_0,,,,2,2,1,3
C(C(C(C(C=C)=O)(CO)O)O)=O,,,5,1,3,0,3
10948_1,,,,2,2,1,3
10950_0,,,,2,2,1,3
C(C)(C(C)C(C(CO)=O)(C=C)O)=O,,,5,1,1,0,1
10952_0,,,,2,2,1,3
C(CO)(C(C=C)(CC(CC)=O)O)=O,,,5,1,1,0,1
10954_0,,,,2,2,1,3
C(C(C=O)C(C(CO)=O)(C=C)O)=O,,,5,1,2,0,2
10954_1,,,,2,2,1,3
10956_0,,,,2,2,1,3
C(CC(C(CO)=O)(C=C)O)=O,,,5,1,2,0,2
10958_0,,,,2,2,1,3
C(CO)(C(C=C)(CC(C=O)=O)O)=O,,,5,1,1,0,1
10960_0,,,,2,2,1,3
C(C(CO)C(C(CO)=O)(C=C)O)=O,,,5,1,2,0,2
10960_1,,,,2,2,1,3
10962_0,,,,2,2,1,3
C(CO)(C(C=C)(CC(CO)=O)O)=O,,,5,1,1,0,1
10964_0,,,,2,2,1,3
C(CO)(C(C=C)(C(C(C)=O)O)O)=O,,,5,1,2,0,2
10964_1,,,,2,2,1,3
10966_0,,,,2,2,1,3
C(C(C=C)C(C(CO)=O)(C=C)O)=O,,,5,1,1,0,1
10968_0,,,,2,2,1,3
C(C(C(C(CO)=O)(C=C)O)O)=O,,,5,1,3,0,3
10968_1,,,,2,2,1,3
10970_0,,,,2,2,1,3
C=CC(C(C([C](C(O)=O)O)O)=O)=O,,,5,1,2,0,2
10970_1,,,,2,2,1,3
10972_0,,,,2,2,1,3
C=CC(C(C(C(C)(CC)O)O)=O)=O,,,5,1,2,0,2
10972_1,,,,2,2,1,3
10974_0,,,,2,2,1,3
C(CC(C(C(C(C=C)=O)=O)O)O)=O,,,5,1,2,0,2
10974_1,,,,2,2,1,3
10976_0,,,,2,2,1,3
C(C(C=C)(C(C(C(C=C)=O)=O)O)O)=O,,,5,1,2,0,2
10976_1,,,,2,2,1,3
10978_0,,,,2,2,1,3
C=CC(C(C(C(C(C=C)=O)=O)O)O)=O,,,5,1,2,0,2
10978_1,,,,2,2,1,3
10980_0,,,,2,2,1,3
C=CC(C(C(C(C=C)=O)=O)O)O,,,5,1,2,0,2
10980_1,,,,2,2,1,3
10982_0,,,,2,2,1,3
C=CC(C(C(C(C(O)O)O)O)=O)=O,,,5,1,2,0,2
10982_1,,,,2,2,1,3
10984_0,,,,2,2,1,3
C=CC(C(C(C(C)O)O)=O)=O,,,5,1,3,0,3
10984_1,,,,2,2,1,3
10986_0,,,,2,2,1,3
C(C(C(C(C=C)=O)=O)O)(O)=O,,,5,1,3,0,3
10986_1,,,,2,2,1,3
10988_0,,,,2,2,1,3
C(C(C)(C(C(C(C=C)=O)=O)O)O)=O,,,5,1,2,0,2
10988_1,,,,2,2,1,3
10990_0,,,,2,2,1,3
C(C)(C(C(C(C(C=C)=O)=O)O)O)=O,,,5,1,2,0,2
10990_1,,,,2,2,1,3
10992_0,,,,2,2,1,3
C=CC(C(C(CO)O)=O)=O,,,5,1,3,0,3
10992_1,,,,2,2,1,3
10994_0,,,,2,2,1,3
C=CC(C(C(C(CCO)O)O)=O)=O,,,5,1,2,0,2
10994_1,,,,2,2,1,3
10996_0,,,,2,2,1,3
C(C(C(C(C(C=C)=O)=O)O)O)=O,,,5,1,3,0,3
10996_1,,,,2,2,1,3
10998_0,,,,2,2,1,3
C=CC(C(C(C(CO)(C)O)O)=O)=O,,,5,1,2,0,2
10998_1,,,,2,2,1,3
11000_0,,,,2,2,1,3
C=CC(C(C(C(C=CC)O)O)=O)=O,,,5,1,2,0,2
11000_1,,,,2,2,1,3
11002_0,,,,2,2,1,3
C(CC(C(C(C(C=C)=O)=O)O)O)=C,,,5,1,2,0,2
11002_1,,,,2,2,1,3
11004_0,,,,2,2,1,3
C=CC(C(C(C(CO)O)O)=O)=O,,,5,1,3,0,3
11004_1,,,,2,2,1,3
11006_0,,,,2,2,1,3
C=CC(C(C(C(C(C)O)O)O)=O)=O,,,5,1,2,0,2
11006_1,,,,2,2,1,3
11008_0,,,,2,2,1,3
C(C(C(C(C(C=C)=O)=O)O)O)(O)=O,,,5,1,3,0,3
11008_1,,,,2,2,1,3
11010_0,,,,2,2,1,3
C=C(C(O)=O)C(C(C(CO)O)=O)=O,,,5,1,2,0,2
11010_1,,,,2,2,1,3
11012_0,,,,2,2,1,3
C(C)(C(C=C)(CC(C(C=C)=O)=O)O)=O,,,5,1,1,0,1
11014_0,,,,2,2,1,3
C(C)(C(C=C)(CC(C(C)=O)=O)O)=O,,,5,1,1,0,1
11016_0,,,,2,2,1,3
C(C)(C(C=C)(CC(CCO)=O)O)=O,,,5,1,1,0,1
11018_0,,,,2,2,1,3
C(C)(C(CO)C(C(C)=O)(C=C)O)=O,,,5,1,2,0,2
11018_1,,,,2,2,1,3
11020_0,,,,2,2,1,3
C(C)(C(C)C(C(C)=O)(C=C)O)=O,,,5,1,1,0,1
11022_0,,,,2,2,1,3
C(C)(C(C=C)(CC(CC)=O)O)=O,,,5,1,1,0,1
11024_0,,,,2,2,1,3
C(C([CH]C(O)=O)C(C(C)=O)(C=C)O)=O,,,5,1,1,0,1
11026_0,,,,2,2,1,3
C(C(C(C=O)=O)C(C(C)=O)(C=C)O)=O,,,5,1,2,0,2
11026_1,,,,2,2,1,3
11028_0,,,,2,2,1,3
C(C)(C(C=C)(CC(C(C)O)=O)O)=O,,,5,1,1,0,1
11030_0,,,,2,2,1,3
C(C)(C(C=C)(C(C(CC)=O)O)O)=O,,,5,1,2,0,2
11030_1,,,,2,2,1,3
11032_0,,,,2,2,1,3
C(C)(C(C=C)(C(C(CO)=O)C)O)=O,,,5,1,1,0,1
11034_0,,,,2,2,1,3
C(C(C=O)C(C(C)=O)(C=C)O)=O,,,5,1,2,0,2
11034_1,,,,2,2,1,3
11036_0,,,,2,2,1,3
C(C(C(C=O)=C)C(C(C)=O)(C=C)O)=O,,,5,1,1,0,1
11038_0,,,,2,2,1,3
C(C)(C(C=C)(CC(C=CC=O)=O)O)=O,,,5,1,1,0,1
11040_0,,,,2,2,1,3
C(C)(C(C=C)(C(C=C)C(C=O)=O)O)=O,,,5,1,1,0,1
11042_0,,,,2,2,1,3
C(C(CCO)C(C(C)=O)(C=C)O)=O,,,5,1,1,0,1
11044_0,,,,2,2,1,3
C(C)(C(C=C)(C1C(C(OC1)=O)=O)O)=O,,,5,1,2,0,2
11044_1,,,,2,2,1,3
11046_0,,,,2,2,1,3
C(CC(C(C)=O)(C=C)O)=O,,,5,1,2,0,2
11048_0,,,,2,2,1,3
C(C(C(C)O)C(C(C)=O)(C=C)O)=O,,,5,1,2,0,2
11048_1,,,,2,2,1,3
11050_0,,,,2,2,1,3
C(C(C=O)C(C(C)=O)(C=C)O)(O)=O,,,5,1,2,0,2
11050_1,,,,2,2,1,3
11052_0,,,,2,2,1,3
C(C)(C(C=C)(C(C(C=O)=O)O)O)=O,,,5,1,2,0,2
11052_1,,,,2,2,1,3
11054_0,,,,2,2,1,3
C(C)(C(C=C)(CC(C=O)=O)O)=O,,,5,1,2,0,2
11056_0,,,,2,2,1,3
C(C(CO)C(C(C)=O)(C=C)O)=O,,,5,1,3,0,3
11056_1,,,,2,2,1,3
11058_0,,,,2,2,1,3
C(C)(C(C=C)(C(C(CO)=O)O)O)=O,,,5,1,2,0,2
11058_1,,,,2,2,1,3
11060_0,,,,2,2,1,3
C(C)(C(C=C)(CC(CO)=O)O)=O,,,5,1,2,0,2
11062_0,,,,2,2,1,3
C(C)(C(C=C)(C(C(C)=O)O)O)=O,,,5,1,3,0,3
11062_1,,,,2,2,1,3
11064_0,,,,2,2,1,3
C(C(C=C)C(C(C)=O)(C=C)O)=O,,,5,1,2,0,2
11066_0,,,,2,2,1,3
C(C(C(C(C)=O)(C=C)O)O)=O,,,5,1,3,0,3
11066_1,,,,2,2,1,3
11068_0,,,,2,2,1,3
C(C)(C(C=C)(CC(C(O)=O)=O)O)=O,,,5,1,1,0,1
11070_0,,,,2,2,1,3
C=CC(C(C)(CC(C(C=C)=O)=O)O)=O,,,5,1,1,0,1
11072_0,,,,2,2,1,3
C=CC(C(C)(CC(C(C)=O)=O)O)=O,,,5,1,1,0,1
11074_0,,,,2,2,1,3
C(CC(C(C=C)=O)(C)O)(CCO)=O,,,5,1,1,0,1
11076_0,,,,2,2,1,3
C(C)(C(CO)C(C(C=C)=O)(C)O)=O,,,5,1,2,0,2
11076_1,,,,2,2,1,3
11078_0,,,,2,2,1,3
C(C)(C(C)C(C(C=C)=O)(C)O)=O,,,5,1,1,0,1
11080_0,,,,2,2,1,3
C(CC(C(C=C)=O)(C)O)(CC)=O,,,5,1,1,0,1
11082_0,,,,2,2,1,3
C(C([CH]C(O)=O)C(C(C=C)=O)(C)O)=O,,,5,1,1,0,1
11084_0,,,,2,2,1,3
C(C(C(C=O)=O)C(C(C=C)=O)(C)O)=O,,,5,1,2,0,2
11084_1,,,,2,2,1,3
11086_0,,,,2,2,1,3
C(CC(C(C=C)=O)(C)O)(C(C)O)=O,,,5,1,1,0,1
11088_0,,,,2,2,1,3
C(C(C(C(C=C)=O)(C)O)O)(CC)=O,,,5,1,2,0,2
11088_1,,,,2,2,1,3
11090_0,,,,2,2,1,3
C(CO)(C(C)C(C(C=C)=O)(C)O)=O,,,5,1,1,0,1
11092_0,,,,2,2,1,3
C(C(C=O)C(C(C=C)=O)(C)O)=O,,,5,1,2,0,2
11092_1,,,,2,2,1,3
11094_0,,,,2,2,1,3
C(C(C(C=O)=C)C(C(C=C)=O)(C)O)=O,,,5,1,1,0,1
11096_0,,,,2,2,1,3
C=CC(C(C)(CC(C=CC=O)=O)O)=O,,,5,1,1,0,1
11098_0,,,,2,2,1,3
C=CC(C(C=O)=O)C(C(C=C)=O)(C)O,,,5,1,1,0,1
11100_0,,,,2,2,1,3
C(C(CCO)C(C(C=C)=O)(C)O)=O,,,5,1,1,0,1
11102_0,,,,2,2,1,3
C=CC(C(C)(C1C(C(OC1)=O)=O)O)=O,,,5,1,2,0,2
11102_1,,,,2,2,1,3
11104_0,,,,2,2,1,3
C(CC(C(C=C)=O)(C)O)=O,,,5,1,2,0,2
11106_0,,,,2,2,1,3
C(C(C(C)O)C(C(C=C)=O)(C)O)=O,,,5,1,2,0,2
11106_1,,,,2,2,1,3
11108_0,,,,2,2,1,3
C(C(C=O)C(C(C=C)=O)(C)O)(O)=O,,,5,1,2,0,2
11108_1,,,,2,2,1,3
11110_0,,,,2,2,1,3
C=CC(C(C)(C(C(C=O)=O)O)O)=O,,,5,1,2,0,2
11110_1,,,,2,2,1,3
11112_0,,,,2,2,1,3
C=CC(C(C)(CC(C=O)=O)O)=O,,,5,1,2,0,2
11114_0,,,,2,2,1,3
C(C(CO)C(C(C=C)=O)(C)O)=O,,,5,1,3,0,3
11114_1,,,,2,2,1,3
11116_0,,,,2,2,1,3
C(C(C(C(C=C)=O)(C)O)O)(CO)=O,,,5,1,2,0,2
11116_1,,,,2,2,1,3
11118_0,,,,2,2,1,3
C(CC(C(C=C)=O)(C)O)(CO)=O,,,5,1,2,0,2
11120_0,,,,2,2,1,3
C(C(C(C(C=C)=O)(C)O)O)(C)=O,,,5,1,3,0,3
11120_1,,,,2,2,1,3
11122_0,,,,2,2,1,3
C(C(C=C)C(C(C=C)=O)(C)O)=O,,,5,1,2,0,2
11124_0,,,,2,2,1,3
C(C(C(C(C=C)=O)(C)O)O)=O,,,5,1,3,0,3
11124_1,,,,2,2,1,3
11126_0,,,,2,2,1,3
C=CC(C(C)(CC(C(O)=O)=O)O)=O,,,5,1,1,0,1
11128_0,,,,2,2,1,3
C(C)(C(C)(CC(C(C=C)=O)=O)O)=O,,,5,1,1,0,1
11130_0,,,,2,2,1,3
C=CC(C(C[C](C(O)=O)O)=O)=O,,,5,1,3,0,3
11132_0,,,,2,2,1,3
C=CC(C(CC(C)(CCO)O)=O)=O,,,5,1,1,0,1
11134_0,,,,2,2,1,3
C=CC(C(CC(C)(CC)O)=O)=O,,,5,1,1,0,1
11136_0,,,,2,2,1,3
C=CC(C(CC(C[CH]C(O)=O)O)=O)=O,,,5,1,1,0,1
11138_0,,,,2,2,1,3
C=C(C(O)=O)C(CC(C(C=C)=O)=O)O,,,5,1,1,0,1
11140_0,,,,2,2,1,3
C=CC(C(CC(CC(C=O)=O)O)=O)=O,,,5,1,1,0,1
11142_0,,,,2,2,1,3
C(CC(C(CC(C(C=C)=O)=O)O)=O)=O,,,5,1,1,0,1
11144_0,,,,2,2,1,3
C(CC(C=O)(CC(C(C=C)=O)=O)O)=O,,,5,1,1,0,1
11146_0,,,,2,2,1,3
C=CC(C(CC(C)(C(C)O)O)=O)=O,,,5,1,1,0,1
11148_0,,,,2,2,1,3
C=CC(C(CC(CO)(CC)O)=O)=O,,,5,1,1,0,1
11150_0,,,,2,2,1,3
C(CC(CC(C(C=C)=O)=O)O)=O,,,5,1,1,0,1
11152_0,,,,2,2,1,3
C=CC(C(CC([CH]C(O)=O)O)=O)=O,,,5,1,1,0,1
11154_0,,,,2,2,1,3
C=C(C(CC(C(C=C)=O)=O)O)C(C)O,,,5,1,1,0,1
11156_0,,,,2,2,1,3
C=CC(C(CC(C(CO)=CC)O)=O)=O,,,5,1,1,0,1
11158_0,,,,2,2,1,3
C=CC(C(CC(C=C(C=O)C)O)=O)=O,,,5,1,1,0,1
11160_0,,,,2,2,1,3
C=CC(C(CC(C(C)=CC=O)O)=O)=O,,,5,1,1,0,1
11162_0,,,,2,2,1,3
C=C(C=O)CC(CC(C(C=C)=O)=O)O,,,5,1,1,0,1
11164_0,,,,2,2,1,3
C(CC(C(CC(C(C=C)=O)=O)O)=C)=O,,,5,1,1,0,1
11166_0,,,,2,2,1,3
C=CC(C(CC(C=CC(C)=O)O)=O)=O,,,5,1,1,0,1
11168_0,,,,2,2,1,3
C(C(C)(CC(C(C=C)=O)=O)O)=CC=O,,,5,1,1,0,1
11170_0,,,,2,2,1,3
C(C(C=C)(CC(C(C=C)=O)=O)O)=O,,,5,1,1,0,1
11172_0,,,,2,2,1,3
C=CC(C(CC(C(C=C)=O)=O)O)=O,,,5,1,1,0,1
11174_0,,,,2,2,1,3
C(C(CC=C)(CC(C(C=C)=O)=O)O)=O,,,5,1,1,0,1
11176_0,,,,2,2,1,3
C(C(CC(C(C=C)=O)=O)O)(CC=C)=O,,,5,1,1,0,1
11178_0,,,,2,2,1,3
C(C(C=CC)(CC(C(C=C)=O)=O)O)=O,,,5,1,1,0,1
11180_0,,,,2,2,1,3
C=CC(C(CC(C(C=CC)=O)O)=O)=O,,,5,1,1,0,1
11182_0,,,,2,2,1,3
C=CC(CC(C(C=C)=O)=O)O,,,5,1,1,0,1
11184_0,,,,2,2,1,3
C(C(C=C)(CC(C(C=C)=O)=O)O)(O)=O,,,5,1,1,0,1
11186_0,,,,2,2,1,3
C=CC(C(CC(C(CC)O)O)=O)=O,,,5,1,1,0,1
11188_0,,,,2,2,1,3
C=CC(C(CC(CCCO)O)=O)=O,,,5,1,1,0,1
11190_0,,,,2,2,1,3
C1(C(CCO1)(CC(C(C=C)=O)=O)O)=O,,,5,1,1,0,1
11192_0,,,,2,2,1,3
C=CC(C(CC(C(O)O)O)=O)=O,,,5,1,1,0,1
11194_0,,,,2,2,1,3
C=CC(C(CC(C)O)=O)=O,,,5,1,2,0,2
11196_0,,,,2,2,1,3
C(CC(C(C=C)=O)=O)(O)=O,,,5,1,2,0,2
11198_0,,,,2,2,1,3
C=CC(C(CC(CC(C)O)O)=O)=O,,,5,1,1,0,1
11200_0,,,,2,2,1,3
C(CC(CC(C(C=C)=O)=O)O)(O)=O,,,5,1,1,0,1
11202_0,,,,2,2,1,3
C(CO)(C(CC(C(C=C)=O)=O)O)=O,,,5,1,1,0,1
11204_0,,,,2,2,1,3
C(C(CO)(CC(C(C=C)=O)=O)O)=O,,,5,1,1,0,1
11206_0,,,,2,2,1,3
C(C(C)(CC(C(C=C)=O)=O)O)=O,,,5,1,2,0,2
11208_0,,,,2,2,1,3
C(C)(C(CC(C(C=C)=O)=O)O)=O,,,5,1,2,0,2
11210_0,,,,2,2,1,3
C=CC(C(CCO)=O)=O,,,5,1,2,0,2
11212_0,,,,2,2,1,3
C=CC(C(CC(CCO)O)=O)=O,,,5,1,2,0,2
11214_0,,,,2,2,1,3
C(C(CC(C(C=C)=O)=O)O)=O,,,5,1,2,0,2
11216_0,,,,2,2,1,3
C(C(C(CC(C(C=C)=O)=O)O)O)=O,,,5,1,1,0,1
11218_0,,,,2,2,1,3
C=CC(C(CC(CO)(CO)O)=O)=O,,,5,1,1,0,1
11220_0,,,,2,2,1,3
C=CC(C(CC(C)(CO)O)=O)=O,,,5,1,2,0,2
11222_0,,,,2,2,1,3
C=CC(C(CC(C=CC)O)=O)=O,,,5,1,2,0,2
11224_0,,,,2,2,1,3
C=CCC(CC(C(C=C)=O)=O)O,,,5,1,2,0,2
11226_0,,,,2,2,1,3
C=CC(C(CC(C(CO)O)O)=O)=O,,,5,1,1,0,1
11228_0,,,,2,2,1,3
C=CC(C(CC(CO)O)=O)=O,,,5,1,2,0,2
11230_0,,,,2,2,1,3
C=CC(C(CC(C(C)O)O)=O)=O,,,5,1,2,0,2
11232_0,,,,2,2,1,3
C(C(CC(C(C=C)=O)=O)O)(O)=O,,,5,1,4,0,4
11234_0,,,,2,2,1,3
C(C(C)(CC(C(C=C)=O)=O)O)(O)=O,,,5,1,1,0,1
11236_0,,,,2,2,1,3
C(CC(C(C(C(O)=O)=C)=O)(C)O)=O,,,5,1,1,0,1
11238_0,,,,2,2,1,3
C(CC(C(C)=O)(C(C(O)=O)=C)O)=O,,,5,1,1,0,1
11240_0,,,,2,2,1,3
C=CC(CC(C(C(C(O)=O)=C)=O)=O)O,,,5,1,1,0,1
11242_0,,,,2,2,1,3
C=C(C(O)=O)C(C(CC(C)O)=O)=O,,,5,1,1,0,1
11244_0,,,,2,2,1,3
C(CC(C(C(C(O)=O)=C)=O)=O)(O)=O,,,5,1,1,0,1
11246_0,,,,2,2,1,3
C=C(C(O)=O)C(C(CCO)=O)=O,,,5,1,2,0,2
11248_0,,,,2,2,1,3
[C](C(O)=O)=CC(C(C)(CC=O)O)=O,,,5,1,1,0,1
11250_0,,,,2,2,1,3
[C](C(O)=O)=CC(C(C)=O)(CC=O)O,,,5,1,1,0,1
11252_0,,,,2,2,1,3
[C](C(O)=O)=CC(C(CC(C=C)O)=O)=O,,,5,1,1,0,1
11254_0,,,,2,2,1,3
[C](C(O)=O)=CC(C(CC(C)O)=O)=O,,,5,1,1,0,1
11256_0,,,,2,2,1,3
[C](C(O)=O)=CC(C(CC(O)=O)=O)=O,,,5,1,1,0,1
11258_0,,,,2,2,1,3
[C](C(O)=O)=CC(C(CCO)=O)=O,,,5,1,2,0,2
11260_0,,,,2,2,1,3
[C](C(O)=O)=CC(C(CC(C=O)O)=O)=O,,,5,1,1,0,1
11262_0,,,,2,2,1,3
C(CC(C(C=CC(O)=O)=O)(C)O)=O,,,5,1,1,0,1
11264_0,,,,2,2,1,3
C(CC(C(C)=O)(C=CC(O)=O)O)=O,,,5,1,1,0,1
11266_0,,,,2,2,1,3
C=CC(CC(C(C=CC(O)=O)=O)=O)O,,,5,1,1,0,1
11268_0,,,,2,2,1,3
C(C(C=CC(O)=O)=O)(CC(C)O)=O,,,5,1,1,0,1
11270_0,,,,2,2,1,3
C(CC(C(C=CC(O)=O)=O)=O)(O)=O,,,5,1,1,0,1
11272_0,,,,2,2,1,3
C(C(C=CC(O)=O)=O)(CCO)=O,,,5,1,2,0,2
11274_0,,,,2,2,1,3
C(C(C=C(C(O)=O)C)(CC=O)O)=O,,,5,1,1,0,1
11276_0,,,,2,2,1,3
C(CC(C(C=C(C(O)=O)C)=O)O)=O,,,5,1,1,0,1
11278_0,,,,2,2,1,3
C(CC(C=O)(CC(C(O)=O)=C)O)=O,,,5,1,1,0,1
11280_0,,,,2,2,1,3
C(CC(C(CC(C(O)=O)=C)=O)O)=O,,,5,1,1,0,1
11282_0,,,,2,2,1,3
C=CC(C(C(C=O)=O)C(C(O)=O)=C)O,,,5,1,1,0,1
11284_0,,,,2,2,1,3
C=C(C(O)=O)C(C(C=O)=O)C(C)O,,,5,1,1,0,1
11286_0,,,,2,2,1,3
C(C(C(C=O)=O)C(C(O)=O)=C)(O)=O,,,5,1,1,0,1
11288_0,,,,2,2,1,3
C=C(C(O)=O)C(C(C=O)=O)CO,,,5,1,3,0,3
11289_0,,,,2,2,1,3
11291_0,,,,2,2,1,3
C(C)(C(C(CO)O)(C(C=O)O)O)=O,,,5,1,7,0,7
11291_1,,,,2,2,1,3
11293_0,,,,2,2,1,3
C(C(C)(CC=O)O)(C(CO)O)=O,,,5,1,2,0,2
11295_0,,,,2,2,1,3
C(C(C)(C(C=O)O)O)(C(CO)O)=O,,,5,1,5,0,5
11295_1,,,,2,2,1,3
11297_0,,,,2,2,1,3
C=CC(CC(C(C(CO)O)=O)=O)O,,,5,1,1,0,1
11299_0,,,,2,2,1,3
C(C(C(CO)O)=O)(CC(C)O)=O,,,5,1,3,0,3
11301_0,,,,2,2,1,3
C(CC(C(C(CO)O)=O)=O)(O)=O,,,5,1,7,0,7
11303_0,,,,2,2,1,3
C(C(C(CO)O)=O)(CCO)=O,,,5,1,2,0,2
11305_0,,,,2,2,1,3
C(C(CC(C(C(CO)O)=O)=O)O)=O,,,5,1,2,0,2
11307_0,,,,2,2,1,3
C(C(C(CO)O)=O)(CC(CO)O)=O,,,5,1,2,0,2
11309_0,,,,2,2,1,3
C1(C(C(C(C(CO)O1)=O)=O)(C)O)=O,,,5,1,2,0,2
11309_1,,,,2,2,1,3
11311_0,,,,2,2,1,3
C(CC(C(C[CH]C(O)=O)=O)O)=O,,,5,1,1,0,1
11313_0,,,,2,2,1,3
C(C(C=C)C(C(C[CH]C(O)=O)=O)O)=O,,,5,1,1,0,1
11315_0,,,,2,2,1,3
C(C(C(C(C[CH]C(O)=O)=O)O)O)=O,,,5,1,2,0,2
11315_1,,,,2,2,1,3
11317_0,,,,2,2,1,3
C(CC(C=O)(C[CH]C(O)=O)O)=O,,,5,1,2,0,2
11319_0,,,,2,2,1,3
C(C(C=C)C(C=O)(C[CH]C(O)=O)O)=O,,,5,1,2,0,2
11321_0,,,,2,2,1,3
C(C(C(C=O)(C[CH]C(O)=O)O)O)=O,,,5,1,4,0,4
11321_1,,,,2,2,1,3
11323_0,,,,2,2,1,3
C=CC(C([CH]C(O)=O)C(C=O)=O)O,,,5,1,1,0,1
11325_0,,,,2,2,1,3
[CH](C(O)=O)C(C(C=O)=O)C(C)O,,,5,1,1,0,1
11327_0,,,,2,2,1,3
C(C([CH]C(O)=O)C(C=O)=O)(O)=O,,,5,1,1,0,1
11329_0,,,,2,2,1,3
[CH](C(O)=O)C(C(C=O)=O)CO,,,5,1,1,0,1
11331_0,,,,2,2,1,3
C(C(C([CH]C(O)=O)C(C=O)=O)O)=O,,,5,1,1,0,1
11333_0,,,,2,2,1,3
C(C)=CC(C([CH]C(O)=O)C(C=O)=O)O,,,5,1,1,0,1
11335_0,,,,2,2,1,3
C=CCC(C([CH]C(O)=O)C(C=O)=O)O,,,5,1,1,0,1
11337_0,,,,2,2,1,3
[CH](C(O)=O)C(C(C=O)=O)C(CO)O,,,5,1,1,0,1
11339_0,,,,2,2,1,3
C(CCC(C(CC=O)O)=O)(O)=O,,,5,1,1,0,1
11341_0,,,,2,2,1,3
C(CCC(C(C(C=O)O)O)=O)(O)=O,,,5,1,2,0,2
11341_1,,,,2,2,1,3
11343_0,,,,2,2,1,3
C(CCC(C=O)(CC=O)O)(O)=O,,,5,1,2,0,2
11345_0,,,,2,2,1,3
C(CCC(C=O)(C(C=O)O)O)(O)=O,,,5,1,4,0,4
11345_1,,,,2,2,1,3
11347_0,,,,2,2,1,3
C(CC(C(C=O)=O)C(C=C)O)(O)=O,,,5,1,1,0,1
11349_0,,,,2,2,1,3
C(CC(C(C=O)=O)C(C)O)(O)=O,,,5,1,1,0,1
11351_0,,,,2,2,1,3
C(C(C(C=O)=O)CC(O)=O)(O)=O,,,5,1,2,0,2
11353_0,,,,2,2,1,3
C(CC(C(C=O)=O)CO)(O)=O,,,5,1,1,0,1
11355_0,,,,2,2,1,3
C(CC(C(C=O)=O)C(C=O)O)(O)=O,,,5,1,1,0,1
11357_0,,,,2,2,1,3
C(CC(C(C=O)=O)C(CO)O)(O)=O,,,5,1,1,0,1
11359_0,,,,2,2,1,3
[CH](C(O)=O)C(C(C(CO)=O)=O)CO,,,5,1,1,0,1
11361_0,,,,2,2,1,3
[CH](C(O)=O)CC(C(C(CO)O)=O)=O,,,5,1,2,0,2
11361_1,,,,2,2,1,3
11362_0,,,,2,2,1,3
11364_0,,,,2,2,1,3
C(C(C)(CC=O)O)(C[CH]C(O)=O)=O,,,5,1,1,0,1
11366_0,,,,2,2,1,3
C=CC(C([CH]C(O)=O)C(C(C)=O)=O)O,,,5,1,1,0,1
11368_0,,,,2,2,1,3
[CH](C(O)=O)C(C(C(C)=O)=O)C(C)O,,,5,1,2,0,2
11370_0,,,,2,2,1,3
C(C([CH]C(O)=O)C(C(C)=O)=O)(O)=O,,,5,1,1,0,1
11372_0,,,,2,2,1,3
[CH](C(O)=O)C(C(C(C)=O)=O)CO,,,5,1,3,0,3
11374_0,,,,2,2,1,3
C=CC(CC(C(C[CH]C(O)=O)=O)=O)O,,,5,1,1,0,1
11376_0,,,,2,2,1,3
[CH](C(O)=O)CC(C(CC(C)O)=O)=O,,,5,1,1,0,1
11378_0,,,,2,2,1,3
C(CC(C(C[CH]C(O)=O)=O)=O)(O)=O,,,5,1,1,0,1
11380_0,,,,2,2,1,3
[CH](C(O)=O)CC(C(CCO)=O)=O,,,5,1,1,0,1
11382_0,,,,2,2,1,3
C(CC(C(C(CO)=O)=O)CO)(O)=O,,,5,1,1,0,1
11384_0,,,,2,2,1,3
C(CCC(C(C(CO)O)=O)=O)(O)=O,,,5,1,2,0,2
11384_1,,,,2,2,1,3
11385_0,,,,2,2,1,3
11387_0,,,,2,2,1,3
C(CCC(O)=O)(C(C)(CC=O)O)=O,,,5,1,1,0,1
11389_0,,,,2,2,1,3
C(CC(C(C(C)=O)=O)C(C)O)(O)=O,,,5,1,2,0,2
11391_0,,,,2,2,1,3
C(C(C(C(C)=O)=O)CC(O)=O)(O)=O,,,5,1,1,0,1
11393_0,,,,2,2,1,3
C(CC(C(C(C)=O)=O)CO)(O)=O,,,5,1,3,0,3
11395_0,,,,2,2,1,3
C(CCC(C(CC(C)O)=O)=O)(O)=O,,,5,1,1,0,1
11397_0,,,,2,2,1,3
C(CC(C(CCC(O)=O)=O)=O)(O)=O,,,5,1,1,0,1
11399_0,,,,2,2,1,3
C(CCC(C(CCO)=O)=O)(O)=O,,,5,1,1,0,1
11401_0,,,,2,2,1,3
C(C)(C(C)C(C(CC(C)O)O)O)=O,,,5,1,1,0,1
11403_0,,,,2,2,1,3
C(CC(C(CC(C)O)O)O)(CC)=O,,,5,1,1,0,1
11405_0,,,,2,2,1,3
C(C(C=O)C(C(CC(C)O)O)O)=O,,,5,1,2,0,2
11405_1,,,,2,2,1,3
11407_0,,,,2,2,1,3
C(CC(C(CC(C)O)O)O)=O,,,5,1,1,0,1
11409_0,,,,2,2,1,3
C(C(CC(C(CC(C)O)O)O)=O)=O,,,5,1,1,0,1
11411_0,,,,2,2,1,3
C(C(CO)C(C(CC(C)O)O)O)=O,,,5,1,2,0,2
11411_1,,,,2,2,1,3
11413_0,,,,2,2,1,3
C(CO)(CC(C(CC(C)O)O)O)=O,,,5,1,1,0,1
11415_0,,,,2,2,1,3
C(C)(C(C(C(CC(C)O)O)O)O)=O,,,5,1,2,0,2
11415_1,,,,2,2,1,3
11417_0,,,,2,2,1,3
C(C(C=C)C(C(CC(C)O)O)O)=O,,,5,1,1,0,1
11418_0,,,,2,2,1,3
11418_1,,,,2,2,1,3
11420_0,,,,2,2,1,3
C(CC(C(C(C(C)=O)C)O)O)(O)=O,,,5,1,1,0,1
11422_0,,,,2,2,1,3
C(CC(C(CC(CC)=O)O)O)(O)=O,,,5,1,1,0,1
11424_0,,,,2,2,1,3
C(C(C=O)C(C(CC(O)=O)O)O)=O,,,5,1,2,0,2
11424_1,,,,2,2,1,3
11426_0,,,,2,2,1,3
C(CC(C(CC=O)O)O)(O)=O,,,5,1,1,0,1
11428_0,,,,2,2,1,3
C(CC(C(CC(C=O)=O)O)O)(O)=O,,,5,1,1,0,1
11430_0,,,,2,2,1,3
C(C(CO)C(C(CC(O)=O)O)O)=O,,,5,1,2,0,2
11430_1,,,,2,2,1,3
11432_0,,,,2,2,1,3
C(CC(C(CC(CO)=O)O)O)(O)=O,,,5,1,1,0,1
11434_0,,,,2,2,1,3
C(CC(C(C(C(C)=O)O)O)O)(O)=O,,,5,1,2,0,2
11434_1,,,,2,2,1,3
11436_0,,,,2,2,1,3
C(C(C=C)C(C(CC(O)=O)O)O)=O,,,5,1,1,0,1
11437_0,,,,2,2,1,3
11437_1,,,,2,2,1,3
11439_0,,,,2,2,1,3
C(C)(C(C)C(C(C(CO)=O)O)O)=O,,,5,1,1,0,1
11441_0,,,,2,2,1,3
C(CC)(CC(C(C(CO)=O)O)O)=O,,,5,1,1,0,1
11443_0,,,,2,2,1,3
C(C(C=O)C(C(C(CO)=O)O)O)=O,,,5,1,2,0,2
11443_1,,,,2,2,1,3
11445_0,,,,2,2,1,3
C(CC(C(C(CO)=O)O)O)=O,,,5,1,5,0,5
11447_0,,,,2,2,1,3
C(CO)(C(C(CC(C=O)=O)O)O)=O,,,5,1,4,0,4
11449_0,,,,2,2,1,3
C(C(CO)C(C(C(CO)=O)O)O)=O,,,5,1,3,0,3
11449_1,,,,2,2,1,3
11451_0,,,,2,2,1,3
C(CO)(CC(C(C(CO)=O)O)O)=O,,,5,1,2,0,2
11453_0,,,,2,2,1,3
C(C)(C(C(C(C(CO)=O)O)O)O)=O,,,5,1,5,0,5
11453_1,,,,2,2,1,3
11455_0,,,,2,2,1,3
C(C(C=C)C(C(C(CO)=O)O)O)=O,,,5,1,2,0,2
11456_0,,,,2,2,1,3
11456_1,,,,2,2,1,3
11458_0,,,,2,2,1,3
C(C(C(CO)(C(C(C)=O)C)O)O)=O,,,5,1,1,0,1
11460_0,,,,2,2,1,3
C(CC(CO)(C(C=O)O)O)(CC)=O,,,5,1,1,0,1
11462_0,,,,2,2,1,3
C(C(C=O)C(CO)(C(C=O)O)O)=O,,,5,1,2,0,2
11462_1,,,,2,2,1,3
11464_0,,,,2,2,1,3
C(CC(CO)(C(C=O)O)O)=O,,,5,1,2,0,2
11466_0,,,,2,2,1,3
C(C(C(CO)(CC(C=O)=O)O)O)=O,,,5,1,2,0,2
11468_0,,,,2,2,1,3
C(C(CO)C(CO)(C(C=O)O)O)=O,,,5,1,2,0,2
11468_1,,,,2,2,1,3
11470_0,,,,2,2,1,3
C(C(C(CO)(CC(CO)=O)O)O)=O,,,5,1,1,0,1
11472_0,,,,2,2,1,3
C(C(C(CO)(C(C(C)=O)O)O)O)=O,,,5,1,8,0,8
11472_1,,,,2,2,1,3
11474_0,,,,2,2,1,3
C(C(C=C)C(CO)(C(C=O)O)O)=O,,,5,1,1,0,1
11476_0,,,,2,2,1,3
C(C(C(CO)(C(C=O)O)O)O)=O,,,5,1,4,0,4
11476_1,,,,2,2,1,3
11478_0,,,,2,2,1,3
C(C(C(C([C](C(O)=O)O)O)=O)O)=O,,,5,1,2,0,2
11478_1,,,,2,2,1,3
11480_0,,,,2,2,1,3
C(C(C(C(C(C)(CC)O)O)=O)O)=O,,,5,1,2,0,2
11480_1,,,,2,2,1,3
11482_0,,,,2,2,1,3
C(CC(C(C(C(C=O)O)=O)O)O)=O,,,5,1,3,0,3
11482_1,,,,2,2,1,3
11484_0,,,,2,2,1,3
C(C(C(C(C(C=C)O)O)=O)O)=O,,,5,1,2,0,2
11484_1,,,,2,2,1,3
11486_0,,,,2,2,1,3
C(C(C(C(C(C(O)O)O)O)=O)O)=O,,,5,1,2,0,2
11486_1,,,,2,2,1,3
11488_0,,,,2,2,1,3
C(C(C(C(C(C)O)O)=O)O)=O,,,5,1,3,0,3
11488_1,,,,2,2,1,3
11490_0,,,,2,2,1,3
C(C(C(C(C=O)O)=O)O)(O)=O,,,5,1,11,0,11
11490_1,,,,2,2,1,3
11492_0,,,,2,2,1,3
C(C(C)(C(C(C(C=O)O)=O)O)O)=O,,,5,1,2,0,2
11492_1,,,,2,2,1,3
11494_0,,,,2,2,1,3
C(C(C(C(C(C(C)=O)O)O)=O)O)=O,,,5,1,2,0,2
11494_1,,,,2,2,1,3
11496_0,,,,2,2,1,3
C(C(C(C(CO)O)=O)O)=O,,,5,1,6,0,6
11496_1,,,,2,2,1,3
11498_0,,,,2,2,1,3
C(C(C(C(C(CCO)O)O)=O)O)=O,,,5,1,2,0,2
11498_1,,,,2,2,1,3
11500_0,,,,2,2,1,3
C(C(C(C(C(C=O)O)O)=O)O)=O,,,5,1,7,0,7
11500_1,,,,2,2,1,3
11502_0,,,,2,2,1,3
C(C(C(C(C(CO)(C)O)O)=O)O)=O,,,5,1,2,0,2
11502_1,,,,2,2,1,3
11504_0,,,,2,2,1,3
C(C(C(C(C(C=CC)O)O)=O)O)=O,,,5,1,2,0,2
11504_1,,,,2,2,1,3
11506_0,,,,2,2,1,3
C(C(C(C(C(CC=C)O)O)=O)O)=O,,,5,1,2,0,2
11506_1,,,,2,2,1,3
11508_0,,,,2,2,1,3
C(C(C(C(C(CO)O)O)=O)O)=O,,,5,1,5,0,5
11508_1,,,,2,2,1,3
11510_0,,,,2,2,1,3
C(C(C(C(C(C(C)O)O)O)=O)O)=O,,,5,1,3,0,3
11510_1,,,,2,2,1,3
11512_0,,,,2,2,1,3
C(C(C(C(C(C(O)=O)O)O)=O)O)=O,,,5,1,6,0,6
11512_1,,,,2,2,1,3
11514_0,,,,2,2,1,3
C(C(C(C(C(C)=O)C)O)(CO)O)=O,,,5,1,1,0,1
11516_0,,,,2,2,1,3
C(C(CO)(C(CC(CC)=O)O)O)=O,,,5,1,1,0,1
11518_0,,,,2,2,1,3
C(C(C=O)C(C(C=O)(CO)O)O)=O,,,5,1,2,0,2
11518_1,,,,2,2,1,3
11520_0,,,,2,2,1,3
C(C(CO)(C(CC=O)O)O)=O,,,5,1,6,0,6
11522_0,,,,2,2,1,3
C(C(CO)(C(CC(C=O)=O)O)O)=O,,,5,1,5,0,5
11524_0,,,,2,2,1,3
C(C(CO)C(C(C=O)(CO)O)O)=O,,,5,1,4,0,4
11524_1,,,,2,2,1,3
11526_0,,,,2,2,1,3
C(C(CO)(C(CC(CO)=O)O)O)=O,,,5,1,3,0,3
11528_0,,,,2,2,1,3
C(C(CO)(C(C(C(C)=O)O)O)O)=O,,,5,1,6,0,6
11528_1,,,,2,2,1,3
11530_0,,,,2,2,1,3
C(C(C=C)C(C(C=O)(CO)O)O)=O,,,5,1,3,0,3
11531_0,,,,2,2,1,3
11531_1,,,,2,2,1,3
11532_0,,,,2,2,1,3
11534_0,,,,2,2,1,3
C(C(C)(C(CC(CCO)=O)O)O)=O,,,5,1,1,0,1
11536_0,,,,2,2,1,3
C(C(C(C(C(C)=O)CO)O)(C)O)=O,,,5,1,2,0,2
11536_1,,,,2,2,1,3
11538_0,,,,2,2,1,3
C(C(C(C(C(C)=O)C)O)(C)O)=O,,,5,1,1,0,1
11540_0,,,,2,2,1,3
C(C(C)(C(CC(CC)=O)O)O)=O,,,5,1,1,0,1
11542_0,,,,2,2,1,3
C(C(C(CC(C(C)O)=O)O)(C)O)=O,,,5,1,3,0,3
11544_0,,,,2,2,1,3
C(C(C)(C(C(C(CC)=O)O)O)O)=O,,,5,1,2,0,2
11544_1,,,,2,2,1,3
11546_0,,,,2,2,1,3
C(C(C(C(C(CO)=O)C)O)(C)O)=O,,,5,1,1,0,1
11548_0,,,,2,2,1,3
C(C(C=O)C(C(C=O)(C)O)O)=O,,,5,1,2,0,2
11548_1,,,,2,2,1,3
11550_0,,,,2,2,1,3
C(C(C(C(C=O)(C)O)O)CCO)=O,,,5,1,1,0,1
11552_0,,,,2,2,1,3
C(C(C)(C(CC=O)O)O)=O,,,5,1,3,0,3
11554_0,,,,2,2,1,3
C(C(C(C(C=O)(C)O)O)C(C)O)=O,,,5,1,2,0,2
11554_1,,,,2,2,1,3
11556_0,,,,2,2,1,3
C(C(C=O)C(C(C=O)(C)O)O)(O)=O,,,5,1,2,0,2
11556_1,,,,2,2,1,3
11558_0,,,,2,2,1,3
C(C(C)(C(C(C(C=O)=O)O)O)O)=O,,,5,1,2,0,2
11558_1,,,,2,2,1,3
11560_0,,,,2,2,1,3
C(C(C)(C(CC(C=O)=O)O)O)=O,,,5,1,2,0,2
11562_0,,,,2,2,1,3
C(C(CO)C(C(C=O)(C)O)O)=O,,,5,1,2,0,2
11562_1,,,,2,2,1,3
11564_0,,,,2,2,1,3
C(C(C)(C(C(C(CO)=O)O)O)O)=O,,,5,1,4,0,4
11564_1,,,,2,2,1,3
11566_0,,,,2,2,1,3
C(C(C)(C(CC(CO)=O)O)O)=O,,,5,1,1,0,1
11568_0,,,,2,2,1,3
C(C(C)(C(C(C(C)=O)O)O)O)=O,,,5,1,3,0,3
11568_1,,,,2,2,1,3
11570_0,,,,2,2,1,3
C(C(C=C)C(C(C=O)(C)O)O)=O,,,5,1,1,0,1
11571_0,,,,2,2,1,3
11571_1,,,,2,2,1,3
11573_0,,,,2,2,1,3
C(C(C)(C(CC(C(O)=O)=O)O)O)=O,,,5,1,2,0,2
11575_0,,,,2,2,1,3
C(C(C(C)(CC(C(C)=O)=O)O)O)=O,,,5,1,1,0,1
11577_0,,,,2,2,1,3
C(CC(C)(C(C=O)O)O)(CCO)=O,,,5,1,1,0,1
11579_0,,,,2,2,1,3
C(C(C(C)(C(C(C)=O)CO)O)O)=O,,,5,1,2,0,2
11579_1,,,,2,2,1,3
11581_0,,,,2,2,1,3
C(C(C(C)(C(C(C)=O)C)O)O)=O,,,5,1,1,0,1
11583_0,,,,2,2,1,3
C(CC(C)(C(C=O)O)O)(CC)=O,,,5,1,1,0,1
11585_0,,,,2,2,1,3
C(C(C)O)(CC(C)(C(C=O)O)O)=O,,,5,1,1,0,1
11587_0,,,,2,2,1,3
C(C(C(C)(C(C=O)O)O)O)(CC)=O,,,5,1,2,0,2
11587_1,,,,2,2,1,3
11589_0,,,,2,2,1,3
C(C(C(C)(C(C(CO)=O)C)O)O)=O,,,5,1,1,0,1
11591_0,,,,2,2,1,3
C(C(C=O)C(C)(C(C=O)O)O)=O,,,5,1,2,0,2
11591_1,,,,2,2,1,3
11593_0,,,,2,2,1,3
C(C(CCO)C(C)(C(C=O)O)O)=O,,,5,1,1,0,1
11595_0,,,,2,2,1,3
C(CC(C)(C(C=O)O)O)=O,,,5,1,1,0,1
11597_0,,,,2,2,1,3
C(C(C(C)O)C(C)(C(C=O)O)O)=O,,,5,1,2,0,2
11597_1,,,,2,2,1,3
11599_0,,,,2,2,1,3
C(C(C=O)C(C)(C(C=O)O)O)(O)=O,,,5,1,2,0,2
11599_1,,,,2,2,1,3
11600_0,,,,2,2,1,3
11600_1,,,,2,2,1,3
11602_0,,,,2,2,1,3
C(C(C(C)(CC(C=O)=O)O)O)=O,,,5,1,3,0,3
11604_0,,,,2,2,1,3
C(C(CO)C(C)(C(C=O)O)O)=O,,,5,1,2,0,2
11604_1,,,,2,2,1,3
11606_0,,,,2,2,1,3
C(C(C(C)(C(C(CO)=O)O)O)O)=O,,,5,1,4,0,4
11606_1,,,,2,2,1,3
11608_0,,,,2,2,1,3
C(C(C(C)(CC(CO)=O)O)O)=O,,,5,1,1,0,1
11610_0,,,,2,2,1,3
C(C(C(C)(C(C(C)=O)O)O)O)=O,,,5,1,5,0,5
11610_1,,,,2,2,1,3
11612_0,,,,2,2,1,3
C(C(C=C)C(C)(C(C=O)O)O)=O,,,5,1,1,0,1
11614_0,,,,2,2,1,3
C(C(C(C)(C(C=O)O)O)O)=O,,,5,1,2,0,2
11614_1,,,,2,2,1,3
11616_0,,,,2,2,1,3
C(C(C(C)(CC(C(O)=O)=O)O)O)=O,,,5,1,3,0,3
11617_0,,,,2,2,1,3
11619_0,,,,2,2,1,3
C(CCO)(CC(C(C(C)=O)O)O)=O,,,5,1,1,0,1
11621_0,,,,2,2,1,3
C(C)(C(CO)C(C(C(C)=O)O)O)=O,,,5,1,2,0,2
11621_1,,,,2,2,1,3
11623_0,,,,2,2,1,3
C(C)(C(C)C(C(C(C)=O)O)O)=O,,,5,1,1,0,1
11625_0,,,,2,2,1,3
C(CC)(CC(C(C(C)=O)O)O)=O,,,5,1,1,0,1
11627_0,,,,2,2,1,3
C(C(C)O)(CC(C(C(C)=O)O)O)=O,,,5,1,4,0,4
11629_0,,,,2,2,1,3
C(C(C(C(C(C)=O)O)O)O)(CC)=O,,,5,1,2,0,2
11629_1,,,,2,2,1,3
11631_0,,,,2,2,1,3
C(C)(C(C(C(C(CO)=O)C)O)O)=O,,,5,1,1,0,1
11633_0,,,,2,2,1,3
C(C(C=O)C(C(C(C)=O)O)O)=O,,,5,1,2,0,2
11633_1,,,,2,2,1,3
11635_0,,,,2,2,1,3
C(C(C(C(C(C)=O)O)O)CCO)=O,,,5,1,1,0,1
11637_0,,,,2,2,1,3
C(CC(C(C(C)=O)O)O)=O,,,5,1,4,0,4
11639_0,,,,2,2,1,3
C(C(C(C(C(C)=O)O)O)C(C)O)=O,,,5,1,2,0,2
11639_1,,,,2,2,1,3
11641_0,,,,2,2,1,3
C(C(C=O)C(C(C(C)=O)O)O)(O)=O,,,5,1,2,0,2
11641_1,,,,2,2,1,3
11643_0,,,,2,2,1,3
C(C)(C(C(C(C(C=O)=O)O)O)O)=O,,,5,1,2,0,2
11643_1,,,,2,2,1,3
11645_0,,,,2,2,1,3
C(C)(C(C(CC(C=O)=O)O)O)=O,,,5,1,3,0,3
11647_0,,,,2,2,1,3
C(C(CO)C(C(C(C)=O)O)O)=O,,,5,1,2,0,2
11647_1,,,,2,2,1,3
11648_0,,,,2,2,1,3
11648_1,,,,2,2,1,3
11650_0,,,,2,2,1,3
C(C)(C(C(CC(CO)=O)O)O)=O,,,5,1,1,0,1
11652_0,,,,2,2,1,3
C(C)(C(C(C(C(C)=O)O)O)O)=O,,,5,1,2,0,2
11652_1,,,,2,2,1,3
11654_0,,,,2,2,1,3
C(C(C=C)C(C(C(C)=O)O)O)=O,,,5,1,1,0,1
11655_0,,,,2,2,1,3
11655_1,,,,2,2,1,3
11657_0,,,,2,2,1,3
C(C)(C(C(CC(C(O)=O)=O)O)O)=O,,,5,1,3,0,3
11659_0,,,,2,2,1,3
C(C)(C(C)(CC(C(C=O)O)=O)O)=O,,,5,1,1,0,1
11661_0,,,,2,2,1,3
C(C(C(C[C](C(O)=O)O)=O)O)=O,,,5,1,1,0,1
11663_0,,,,2,2,1,3
C(C(C(CC(C)(CCO)O)=O)O)=O,,,5,1,1,0,1
11665_0,,,,2,2,1,3
C(C(C(CC(C)(CC)O)=O)O)=O,,,5,1,1,0,1
11667_0,,,,2,2,1,3
C(C(C(CC(C)(C(C)O)O)=O)O)=O,,,5,1,1,0,1
11669_0,,,,2,2,1,3
C(C(C(CC(CO)(CC)O)=O)O)=O,,,5,1,1,0,1
11671_0,,,,2,2,1,3
C(C(C(CC(CC=O)O)=O)O)=O,,,5,1,1,0,1
11673_0,,,,2,2,1,3
C(C(C(CC([CH]C(O)=O)O)=O)O)=O,,,5,1,1,0,1
11675_0,,,,2,2,1,3
C(C(C=C)(CC(C(C=O)O)=O)O)=O,,,5,1,1,0,1
11677_0,,,,2,2,1,3
C(C(C(CC(C(C=C)=O)O)=O)O)=O,,,5,1,1,0,1
11679_0,,,,2,2,1,3
C(C(C(CC(C=C)O)=O)O)=O,,,5,1,1,0,1
11681_0,,,,2,2,1,3
C(C(C(CC(C(CC)O)O)=O)O)=O,,,5,1,1,0,1
11683_0,,,,2,2,1,3
C(C(C(CC(CCCO)O)=O)O)=O,,,5,1,1,0,1
11685_0,,,,2,2,1,3
C(C(C(CC(C(O)O)O)=O)O)=O,,,5,1,1,0,1
11687_0,,,,2,2,1,3
C(C(C(CC(C)O)=O)O)=O,,,5,1,2,0,2
11689_0,,,,2,2,1,3
C(CC(C(C=O)O)=O)(O)=O,,,5,1,4,0,4
11691_0,,,,2,2,1,3
C(C(C(CC(CC(C)O)O)=O)O)=O,,,5,1,1,0,1
11693_0,,,,2,2,1,3
C(C(C(CC(CC(O)=O)O)=O)O)=O,,,5,1,1,0,1
11695_0,,,,2,2,1,3
C(C(C(CC(C(CO)=O)O)=O)O)=O,,,5,1,1,0,1
11697_0,,,,2,2,1,3
C(C(CO)(CC(C(C=O)O)=O)O)=O,,,5,1,1,0,1
11699_0,,,,2,2,1,3
C(C(C)(CC(C(C=O)O)=O)O)=O,,,5,1,1,0,1
11701_0,,,,2,2,1,3
C(C(C(CC(C(C)=O)O)=O)O)=O,,,5,1,1,0,1
11703_0,,,,2,2,1,3
C(C(C(CCO)=O)O)=O,,,5,1,3,0,3
11705_0,,,,2,2,1,3
C(C(C(CC(CCO)O)=O)O)=O,,,5,1,1,0,1
11707_0,,,,2,2,1,3
C(C(C(CC(C=O)O)=O)O)=O,,,5,1,3,0,3
11709_0,,,,2,2,1,3
C(CC(C(C=O)O)O)(C(C=O)O)=O,,,5,1,1,0,1
11711_0,,,,2,2,1,3
C(C(C(CC(CO)(CO)O)=O)O)=O,,,5,1,1,0,1
11713_0,,,,2,2,1,3
C(C(C(CC(CO)(C)O)=O)O)=O,,,5,1,1,0,1
11715_0,,,,2,2,1,3
C(C(C(CC(C=CC)O)=O)O)=O,,,5,1,1,0,1
11717_0,,,,2,2,1,3
C(C(C(CC(CC=C)O)=O)O)=O,,,5,1,1,0,1
11719_0,,,,2,2,1,3
C(C(C(CC(C(CO)O)O)=O)O)=O,,,5,1,1,0,1
11721_0,,,,2,2,1,3
C(C(C(CC(CO)O)=O)O)=O,,,5,1,1,0,1
11723_0,,,,2,2,1,3
C(C(C(CC(C(C)O)O)=O)O)=O,,,5,1,1,0,1
11725_0,,,,2,2,1,3
C(C(C(CC(C(O)=O)O)=O)O)=O,,,5,1,2,0,2
11727_0,,,,2,2,1,3
C(C(C)(CC(C(C=O)O)=O)O)(O)=O,,,5,1,1,0,1
11729_0,,,,2,2,1,3
C(C(CO)(C(CC=O)O)O)(O)=O,,,5,1,6,0,6
11730_0,,,,2,2,1,3
11730_1,,,,2,2,1,3
11732_0,,,,2,2,1,3
C(C)(C(C)(CC(C(C)=O)=O)O)=O,,,5,1,1,0,1
11734_0,,,,2,2,1,3
C(C)(C(C)(CC(CC(O)=O)=O)O)=O,,,5,1,1,0,1
11736_0,,,,2,2,1,3
C(C(C(C)=O)C(C(C)=O)(C)O)(O)=O,,,5,1,2,0,2
11736_1,,,,2,2,1,3
11738_0,,,,2,2,1,3
C(C)(C(C)(CC(CCO)=O)O)=O,,,5,1,1,0,1
11740_0,,,,2,2,1,3
C(C)(C(CO)C(C(C)=O)(C)O)=O,,,5,1,2,0,2
11740_1,,,,2,2,1,3
11742_0,,,,2,2,1,3
C(C)(C(C)C(C(C)=O)(C)O)=O,,,5,1,1,0,1
11744_0,,,,2,2,1,3
C(C)(C(C)(CC(CC)=O)O)=O,,,5,1,1,0,1
11746_0,,,,2,2,1,3
C(C([CH]C(O)=O)C(C(C)=O)(C)O)=O,,,5,1,1,0,1
11748_0,,,,2,2,1,3
C(C)(C(C)(C(C=O)CC(O)=O)O)=O,,,5,1,1,0,1
11750_0,,,,2,2,1,3
C(C(C(C=O)=O)C(C(C)=O)(C)O)=O,,,5,1,2,0,2
11750_1,,,,2,2,1,3
11752_0,,,,2,2,1,3
C(C)(C(C)(C(C(C(O)=O)=O)C)O)=O,,,5,1,1,0,1
11754_0,,,,2,2,1,3
C(C)(C(C)(CC(C(C)O)=O)O)=O,,,5,1,1,0,1
11756_0,,,,2,2,1,3
C(C)(C(C)(C(C(CC)=O)O)O)=O,,,5,1,2,0,2
11756_1,,,,2,2,1,3
11758_0,,,,2,2,1,3
C(C)(C(C)(C(C(CO)=O)C)O)=O,,,5,1,1,0,1
11760_0,,,,2,2,1,3
C(C(C=O)C(C(C)=O)(C)O)=O,,,5,1,2,0,2
11760_1,,,,2,2,1,3
11762_0,,,,2,2,1,3
C(C(C(C=O)=C)C(C(C)=O)(C)O)=O,,,5,1,1,0,1
11764_0,,,,2,2,1,3
C(C)(C(C)(CC(C=CC=O)=O)O)=O,,,5,1,1,0,1
11766_0,,,,2,2,1,3
C(C)(C(C)(C(C=C)C(C=O)=O)O)=O,,,5,1,1,0,1
11768_0,,,,2,2,1,3
C(C(CCO)C(C(C)=O)(C)O)=O,,,5,1,1,0,1
11770_0,,,,2,2,1,3
C(C)(C(C)(C1C(C(O)OC1)=O)O)=O,,,5,1,2,0,2
11770_1,,,,2,2,1,3
11772_0,,,,2,2,1,3
C(C)(C(C)(C1C(C(OC1)=O)=O)O)=O,,,5,1,2,0,2
11772_1,,,,2,2,1,3
11774_0,,,,2,2,1,3
C(C(C(CO)C)C(C(C)=O)(C)O)=O,,,5,1,1,0,1
11776_0,,,,2,2,1,3
C(C)(C(C)(CC=O)O)=O,,,5,1,1,0,1
11778_0,,,,2,2,1,3
C(C(C(C)O)C(C(C)=O)(C)O)=O,,,5,1,2,0,2
11778_1,,,,2,2,1,3
11780_0,,,,2,2,1,3
C(C(C=O)C(C(C)=O)(C)O)(O)=O,,,5,1,2,0,2
11780_1,,,,2,2,1,3
11782_0,,,,2,2,1,3
C(C)(C(C)(C(C(C=O)=O)O)O)=O,,,5,1,3,0,3
11782_1,,,,2,2,1,3
11784_0,,,,2,2,1,3
C(C)(C(C)(CC(C=O)=O)O)=O,,,5,1,1,0,1
11786_0,,,,2,2,1,3
C(C)(C(C)(C(C(C(O)=O)=O)O)O)=O,,,5,1,3,0,3
11786_1,,,,2,2,1,3
11788_0,,,,2,2,1,3
C(C)(C(C)(C(C(C=O)=O)CO)O)=O,,,5,1,2,0,2
11788_1,,,,2,2,1,3
11790_0,,,,2,2,1,3
C(C(CO)C(C(C)=O)(C)O)=O,,,5,1,2,0,2
11790_1,,,,2,2,1,3
11792_0,,,,2,2,1,3
C(C)(C(C)(C(C(CO)=O)O)O)=O,,,5,1,3,0,3
11792_1,,,,2,2,1,3
11794_0,,,,2,2,1,3
C(C)(C(C)(CC(CO)=O)O)=O,,,5,1,1,0,1
11796_0,,,,2,2,1,3
C(C)(C(C)(C(C(C)=O)O)O)=O,,,5,1,3,0,3
11796_1,,,,2,2,1,3
11798_0,,,,2,2,1,3
C(C(C=C)C(C(C)=O)(C)O)=O,,,5,1,1,0,1
11800_0,,,,2,2,1,3
C(C)(C(C)(C(C=O)O)O)=O,,,5,1,3,0,3
11800_1,,,,2,2,1,3
11802_0,,,,2,2,1,3
C(C)(C(C)(CC(C(O)=O)=O)O)=O,,,5,1,1,0,1
11803_0,,,,2,2,1,3
11805_0,,,,2,2,1,3
C(CC(C)(CC(C(C)=O)=O)O)(O)=O,,,5,1,1,0,1
11807_0,,,,2,2,1,3
C(C(C)=O)(CC(C)(CCO)O)=O,,,5,1,1,0,1
11809_0,,,,2,2,1,3
C(C(C)=O)(CC(C)(CC)O)=O,,,5,1,1,0,1
11811_0,,,,2,2,1,3
[CH](C(O)=O)CC(CC(C(C)=O)=O)O,,,5,1,2,0,2
11813_0,,,,2,2,1,3
C(CCC(CC(C(C)=O)=O)O)(O)=O,,,5,1,2,0,2
11815_0,,,,2,2,1,3
C(C(C)=O)(CC(C(C)(CO)O)O)=O,,,5,1,2,0,2
11817_0,,,,2,2,1,3
C=C(C(O)=O)C(CC(C(C)=O)=O)O,,,5,1,1,0,1
11818_0,,,,2,2,1,3
11820_0,,,,2,2,1,3
C(CC(C(CC(C(C)=O)=O)O)=O)=O,,,5,1,1,0,1
11821_0,,,,2,2,1,3
11823_0,,,,2,2,1,3
C(C(C)C(CC(C(C)=O)=O)O)(O)=O,,,5,1,1,0,1
11825_0,,,,2,2,1,3
C(C(CC)(CC(C(C)=O)=O)O)(O)=O,,,5,1,1,0,1
11827_0,,,,2,2,1,3
C(C(C)=O)(CC(C)(C(C)O)O)=O,,,5,1,1,0,1
11829_0,,,,2,2,1,3
C(C(C)=O)(CC(CO)(CC)O)=O,,,5,1,1,0,1
11830_0,,,,2,2,1,3
11832_0,,,,2,2,1,3
C([CH]C(CC(C(C)=O)=O)O)(O)=O,,,5,1,1,0,1
11834_0,,,,2,2,1,3
C=C(C(CC(C(C)=O)=O)O)C(C)O,,,5,1,1,0,1
11836_0,,,,2,2,1,3
C(C)=C(CO)C(CC(C(C)=O)=O)O,,,5,1,1,0,1
11838_0,,,,2,2,1,3
C(C(CC(C(C)=O)=O)O)=C(C=O)C,,,5,1,1,0,1
11840_0,,,,2,2,1,3
C(C)(C(CC(C(C)=O)=O)O)=CC=O,,,5,1,1,0,1
11842_0,,,,2,2,1,3
C=C(C=O)CC(CC(C(C)=O)=O)O,,,5,1,1,0,1
11844_0,,,,2,2,1,3
C(CC(C(CC(C(C)=O)=O)O)=C)=O,,,5,1,1,0,1
11846_0,,,,2,2,1,3
C(C(CC(C(C)=O)=O)O)=CC(C)=O,,,5,1,1,0,1
11848_0,,,,2,2,1,3
C(C(C)(CC(C(C)=O)=O)O)=CC=O,,,5,1,1,0,1
11850_0,,,,2,2,1,3
C(C(C=C)(CC(C(C)=O)=O)O)=O,,,5,1,1,0,1
11852_0,,,,2,2,1,3
C=CC(C(CC(C(C)=O)=O)O)=O,,,5,1,1,0,1
11854_0,,,,2,2,1,3
C(C(CC=C)(CC(C(C)=O)=O)O)=O,,,5,1,1,0,1
11856_0,,,,2,2,1,3
C(C(CC(C(C)=O)=O)O)(CC=C)=O,,,5,1,1,0,1
11858_0,,,,2,2,1,3
C(C(C=CC)(CC(C(C)=O)=O)O)=O,,,5,1,1,0,1
11860_0,,,,2,2,1,3
C(C)=CC(C(CC(C(C)=O)=O)O)=O,,,5,1,1,0,1
11862_0,,,,2,2,1,3
C=CC(CC(C(C)=O)=O)O,,,5,1,1,0,1
11864_0,,,,2,2,1,3
C(C(C=C)(CC(C(C)=O)=O)O)(O)=O,,,5,1,1,0,1
11866_0,,,,2,2,1,3
C(C(C)=O)(CC(C(CC)O)O)=O,,,5,1,1,0,1
11868_0,,,,2,2,1,3
C(C(C)=O)(CC(CCCO)O)=O,,,5,1,1,0,1
11870_0,,,,2,2,1,3
C(C(C)=O)(CC1(C(O)OCC1)O)=O,,,5,1,1,0,1
11872_0,,,,2,2,1,3
C1(C(CCO1)(CC(C(C)=O)=O)O)=O,,,5,1,1,0,1
11874_0,,,,2,2,1,3
C(C(C)=O)(CC(CC(C)CO)O)=O,,,5,1,1,0,1
11876_0,,,,2,2,1,3
C(C(C)=O)(CC(C(CCO)O)O)=O,,,5,1,1,0,1
11878_0,,,,2,2,1,3
C(C(C)=O)(CC(C(O)O)O)=O,,,5,1,1,0,1
11880_0,,,,2,2,1,3
C(C(C)=O)(CC(C)O)=O,,,5,1,2,0,2
11881_0,,,,2,2,1,3
11883_0,,,,2,2,1,3
C(C(C)=O)(CC(CC(C)O)O)=O,,,5,1,1,0,1
11885_0,,,,2,2,1,3
C(CC(CC(C(C)=O)=O)O)(O)=O,,,5,1,3,0,3
11887_0,,,,2,2,1,3
C(CO)(C(CC(C(C)=O)=O)O)=O,,,5,1,2,0,2
11889_0,,,,2,2,1,3
C(C(CO)(CC(C(C)=O)=O)O)=O,,,5,1,1,0,1
11891_0,,,,2,2,1,3
C(C(C)(CC(C(C)=O)=O)O)=O,,,5,1,1,0,1
11893_0,,,,2,2,1,3
C(C)(C(CC(C(C)=O)=O)O)=O,,,5,1,1,0,1
11894_0,,,,2,2,1,3
11895_0,,,,2,2,1,3
11897_0,,,,2,2,1,3
C(C(CCO)(CC(C(C)=O)=O)O)=O,,,5,1,1,0,1
11899_0,,,,2,2,1,3
C(C(CC(C(C)=O)=O)O)(CCO)=O,,,5,1,1,0,1
11901_0,,,,2,2,1,3
C(C(C)=O)(CC(CCO)O)=O,,,5,1,3,0,3
11903_0,,,,2,2,1,3
C(C(CC(C(C)=O)=O)O)=O,,,5,1,4,0,4
11904_0,,,,2,2,1,3
11905_0,,,,2,2,1,3
11907_0,,,,2,2,1,3
C(C(C)=O)(CC(CO)(CO)O)=O,,,5,1,1,0,1
11909_0,,,,2,2,1,3
C(C(C)=O)(CC(C)(CO)O)=O,,,5,1,1,0,1
11911_0,,,,2,2,1,3
C(C)=CC(CC(C(C)=O)=O)O,,,5,1,1,0,1
11913_0,,,,2,2,1,3
C(CC(CC(C(C)=O)=O)O)=C,,,5,1,1,0,1
11915_0,,,,2,2,1,3
C(C(C)=O)(CC(C(CO)O)O)=O,,,5,1,4,0,4
11917_0,,,,2,2,1,3
C(C(C)=O)(CC(CO)O)=O,,,5,1,2,0,2
11919_0,,,,2,2,1,3
C(C(C)=O)(CC(C(C)O)O)=O,,,5,1,1,0,1
11920_0,,,,2,2,1,3
11922_0,,,,2,2,1,3
C(C(C)(CC(C(C)=O)=O)O)(O)=O,,,5,1,2,0,2
11924_0,,,,2,2,1,3
C(CC(C[C](C(O)=O)O)=O)(O)=O,,,5,1,3,0,3
11926_0,,,,2,2,1,3
C(C(C(C)=O)[C](C(O)=O)O)(O)=O,,,5,1,3,0,3
11926_1,,,,2,2,1,3
11928_0,,,,2,2,1,3
C(CCO)(C[C](C(O)=O)O)=O,,,5,1,1,0,1
11930_0,,,,2,2,1,3
C(C)(C([C](C(O)=O)O)CO)=O,,,5,1,2,0,2
11930_1,,,,2,2,1,3
11932_0,,,,2,2,1,3
C(C)(C([C](C(O)=O)O)C)=O,,,5,1,1,0,1
11934_0,,,,2,2,1,3
C(CC)(C[C](C(O)=O)O)=O,,,5,1,1,0,1
11936_0,,,,2,2,1,3
C(C)(C([CH]C(O)=O)[C](C(O)=O)O)=O,,,5,1,1,0,1
11938_0,,,,2,2,1,3
C(C[C](C(O)=O)O)(C[CH]C(O)=O)=O,,,5,1,1,0,1
11940_0,,,,2,2,1,3
C(C)(C([C](C(O)=O)O)CC(O)=O)=O,,,5,1,1,0,1
11942_0,,,,2,2,1,3
C(CCC(O)=O)(C[C](C(O)=O)O)=O,,,5,1,1,0,1
11944_0,,,,2,2,1,3
C(C([CH]C(O)=O)[C](C(O)=O)O)=O,,,5,1,1,0,1
11946_0,,,,2,2,1,3
C(C([C](C(O)=O)O)CC(O)=O)=O,,,5,1,1,0,1
11948_0,,,,2,2,1,3
C(C(C(C(C)O)=O)[C](C(O)=O)O)=O,,,5,1,2,0,2
11948_1,,,,2,2,1,3
11950_0,,,,2,2,1,3
C(C(C(C)=O)O)(C[C](C(O)=O)O)=O,,,5,1,1,0,1
11952_0,,,,2,2,1,3
C(C(CCO)O)(C[C](C(O)=O)O)=O,,,5,1,1,0,1
11954_0,,,,2,2,1,3
C(C(C=O)C(C=O)[C](C(O)=O)O)=O,,,5,1,1,0,1
11956_0,,,,2,2,1,3
C(C([C](C(O)=O)O)C(C=O)=O)=O,,,5,1,2,0,2
11956_1,,,,2,2,1,3
11958_0,,,,2,2,1,3
C(CC(C=O)=O)(C[C](C(O)=O)O)=O,,,5,1,1,0,1
11960_0,,,,2,2,1,3
C(C)(C([C](C(O)=O)O)C(C=O)=O)=O,,,5,1,2,0,2
11960_1,,,,2,2,1,3
11962_0,,,,2,2,1,3
[C](C(O)=O)(C(C(C(C=O)=O)=O)C)O,,,5,1,1,0,1
11964_0,,,,2,2,1,3
C(C([C](C(O)=O)O)C(C(O)=O)=O)=O,,,5,1,2,0,2
11964_1,,,,2,2,1,3
11966_0,,,,2,2,1,3
[C](C(O)=O)(C(C(C(O)=O)=O)C)O,,,5,1,1,0,1
11968_0,,,,2,2,1,3
C(C(C)O)(C[C](C(O)=O)O)=O,,,5,1,3,0,3
11970_0,,,,2,2,1,3
C(CC)(C([C](C(O)=O)O)O)=O,,,5,1,2,0,2
11970_1,,,,2,2,1,3
11972_0,,,,2,2,1,3
C(CO)(C([C](C(O)=O)O)C)=O,,,5,1,1,0,1
11974_0,,,,2,2,1,3
C(C(C=O)[C](C(O)=O)O)=O,,,5,1,2,0,2
11974_1,,,,2,2,1,3
11976_0,,,,2,2,1,3
C(C(C=CC(C)O)[C](C(O)=O)O)=O,,,5,1,1,0,1
11978_0,,,,2,2,1,3
C(C(C=CC(O)=O)[C](C(O)=O)O)=O,,,5,1,1,0,1
11980_0,,,,2,2,1,3
C([C](C(C(C=CC=O)=O)O)O)(O)=O,,,5,1,2,0,2
11980_1,,,,2,2,1,3
11982_0,,,,2,2,1,3
C=C(C=O)C([C](C(O)=O)O)C(C=O)=O,,,5,1,1,0,1
11984_0,,,,2,2,1,3
C(C([C](C(O)=O)O)C(C=O)=C)=O,,,5,1,1,0,1
11986_0,,,,2,2,1,3
C(C(C=CC(C[C](C(O)=O)O)=O)=O)=O,,,5,1,1,0,1
11988_0,,,,2,2,1,3
C(C=CC(C[C](C(O)=O)O)=O)=O,,,5,1,1,0,1
11990_0,,,,2,2,1,3
C=CC([C](C(O)=O)O)C(C=O)=O,,,5,1,1,0,1
11992_0,,,,2,2,1,3
C=C(C(O)=O)C(C[C](C(O)=O)O)=O,,,5,1,1,0,1
11994_0,,,,2,2,1,3
C(C([C](C(O)=O)O)CCO)=O,,,5,1,1,0,1
11996_0,,,,2,2,1,3
C1(C(O)OCC1[C](C(O)=O)O)=O,,,5,1,2,0,2
11996_1,,,,2,2,1,3
11998_0,,,,2,2,1,3
C1(C(O)OC(C)C1[C](C(O)=O)O)=O,,,5,1,2,0,2
11998_1,,,,2,2,1,3
12000_0,,,,2,2,1,3
C1(C(C(C(O)O1)=O)[C](C(O)=O)O)=O,,,5,1,2,0,2
12000_1,,,,2,2,1,3
12002_0,,,,2,2,1,3
[C](C(O)=O)(C1C(C(OC1)=O)=O)O,,,5,1,2,0,2
12002_1,,,,2,2,1,3
12004_0,,,,2,2,1,3
C1(C(C(C([C](C(O)=O)O)O1)=O)=O)=O,,,5,1,2,0,2
12004_1,,,,2,2,1,3
12006_0,,,,2,2,1,3
C(C([C](C(O)=O)O)C(C)CO)=O,,,5,1,1,0,1
12008_0,,,,2,2,1,3
C(C([C](C(O)=O)O)C(C)CCO)=O,,,5,1,1,0,1
12010_0,,,,2,2,1,3
C(C([C](C(O)=O)O)C(C)C(C)O)=O,,,5,1,1,0,1
12012_0,,,,2,2,1,3
C(C([C](C(O)=O)O)C(C)CC=O)=O,,,5,1,1,0,1
12014_0,,,,2,2,1,3
C([C](CC([C](C(O)=O)O)=O)O)(O)=O,,,5,1,1,0,1
12016_0,,,,2,2,1,3
C(C[C](C(O)=O)O)=O,,,5,1,3,0,3
12018_0,,,,2,2,1,3
C(C([C](C(O)=O)O)C(C)O)=O,,,5,1,2,0,2
12018_1,,,,2,2,1,3
12020_0,,,,2,2,1,3
C(C(C(O)=O)[C](C(O)=O)O)=O,,,5,1,2,0,2
12020_1,,,,2,2,1,3
12022_0,,,,2,2,1,3
C([C](C(C(C=O)=O)O)O)(O)=O,,,5,1,3,0,3
12022_1,,,,2,2,1,3
12024_0,,,,2,2,1,3
C(C(C[C](C(O)=O)O)=O)=O,,,5,1,1,0,1
12026_0,,,,2,2,1,3
C(C(C([C](C(O)=O)O)O)=O)(O)=O,,,5,1,3,0,3
12026_1,,,,2,2,1,3
12028_0,,,,2,2,1,3
C(C([C](C(O)=O)O)C(C=O)(C)O)=O,,,5,1,2,0,2
12028_1,,,,2,2,1,3
12030_0,,,,2,2,1,3
C(C([C](C(O)=O)O)C(C(C)=O)O)=O,,,5,1,2,0,2
12030_1,,,,2,2,1,3
12032_0,,,,2,2,1,3
C(CC(C(C[C](C(O)=O)O)=O)O)=O,,,5,1,1,0,1
12034_0,,,,2,2,1,3
[C](C(O)=O)(C(C(C=O)=O)CO)O,,,5,1,2,0,2
12034_1,,,,2,2,1,3
12036_0,,,,2,2,1,3
[C](C(O)=O)(C(C(C=O)=O)C(C)O)O,,,5,1,2,0,2
12036_1,,,,2,2,1,3
12038_0,,,,2,2,1,3
C(C([C](C(O)=O)O)C(C=O)=O)(O)=O,,,5,1,3,0,3
12038_1,,,,2,2,1,3
12040_0,,,,2,2,1,3
C(C([C](C(O)=O)O)CO)=O,,,5,1,3,0,3
12040_1,,,,2,2,1,3
12042_0,,,,2,2,1,3
[C](C(O)=O)(C(C(C(O)=O)=O)CO)O,,,5,1,2,0,2
12042_1,,,,2,2,1,3
12044_0,,,,2,2,1,3
C(C([C](C(O)=O)O)C(C(C)=O)=O)=O,,,5,1,2,0,2
12044_1,,,,2,2,1,3
12046_0,,,,2,2,1,3
C(CC(C(C[C](C(O)=O)O)=O)=O)=O,,,5,1,1,0,1
12048_0,,,,2,2,1,3
[C](C(O)=O)(CC(C(C(C)O)=O)=O)O,,,5,1,1,0,1
12050_0,,,,2,2,1,3
C([C](CC(C(C(O)=O)=O)=O)O)(O)=O,,,5,1,1,0,1
12052_0,,,,2,2,1,3
C(CO)(C([C](C(O)=O)O)O)=O,,,5,1,4,0,4
12052_1,,,,2,2,1,3
12054_0,,,,2,2,1,3
C(CO)(C[C](C(O)=O)O)=O,,,5,1,4,0,4
12056_0,,,,2,2,1,3
C(C)(C([C](C(O)=O)O)O)=O,,,5,1,4,0,4
12056_1,,,,2,2,1,3
12058_0,,,,2,2,1,3
C(C[C](C(O)=O)O)(C(C(O)=O)C)=O,,,5,1,1,0,1
12060_0,,,,2,2,1,3
C(C(C=C)[C](C(O)=O)O)=O,,,5,1,1,0,1
12062_0,,,,2,2,1,3
C=CC([C](C(O)=O)O)C(C(O)=O)=O,,,5,1,1,0,1
12064_0,,,,2,2,1,3
C(C([C](C(O)=O)O)C(C(O)=O)=C)=O,,,5,1,1,0,1
12066_0,,,,2,2,1,3
C(C([C](C(O)=O)O)O)=O,,,5,1,5,0,5
12066_1,,,,2,2,1,3
12068_0,,,,2,2,1,3
[C](C(O)=O)(C1C(C(OC1C)=O)=O)O,,,5,1,2,0,2
12068_1,,,,2,2,1,3
12070_0,,,,2,2,1,3
C1(C([C](C(O)=O)O)C(C(O1)=O)=O)=O,,,5,1,2,0,2
12070_1,,,,2,2,1,3
12072_0,,,,2,2,1,3
C(C([C](C(O)=O)O)C[CH]C(O)=O)=O,,,5,1,1,0,1
12074_0,,,,2,2,1,3
C(C([C](C(O)=O)O)CCC(O)=O)=O,,,5,1,1,0,1
12076_0,,,,2,2,1,3
C(C(C[C](C(O)=O)O)=O)(O)=O,,,5,1,1,0,1
12078_0,,,,2,2,1,3
C(CC(C)(CC(CCO)=O)O)(O)=O,,,5,1,1,0,1
12080_0,,,,2,2,1,3
C(CC(C)(C(C(C)=O)CO)O)(O)=O,,,5,1,2,0,2
12080_1,,,,2,2,1,3
12082_0,,,,2,2,1,3
C(CC(C)(C(C(C)=O)C)O)(O)=O,,,5,1,1,0,1
12084_0,,,,2,2,1,3
C(CC(C)(CC(CC)=O)O)(O)=O,,,5,1,1,0,1
12086_0,,,,2,2,1,3
C(CC(C)(CC(C(C)O)=O)O)(O)=O,,,5,1,1,0,1
12088_0,,,,2,2,1,3
C(CC(C)(C(C(CC)=O)O)O)(O)=O,,,5,1,2,0,2
12088_1,,,,2,2,1,3
12090_0,,,,2,2,1,3
C(CC(C)(C(C(CO)=O)C)O)(O)=O,,,5,1,1,0,1
12092_0,,,,2,2,1,3
C(C(C=O)C(C)(CC(O)=O)O)=O,,,5,1,2,0,2
12092_1,,,,2,2,1,3
12094_0,,,,2,2,1,3
C(C(CCO)C(C)(CC(O)=O)O)=O,,,5,1,1,0,1
12096_0,,,,2,2,1,3
C(CC(C)(CC=O)O)(O)=O,,,5,1,2,0,2
12098_0,,,,2,2,1,3
C(C(C(C)O)C(C)(CC(O)=O)O)=O,,,5,1,2,0,2
12098_1,,,,2,2,1,3
12100_0,,,,2,2,1,3
C(C(C=O)C(C)(CC(O)=O)O)(O)=O,,,5,1,2,0,2
12100_1,,,,2,2,1,3
12102_0,,,,2,2,1,3
C(CC(C)(C(C(C=O)=O)O)O)(O)=O,,,5,1,2,0,2
12102_1,,,,2,2,1,3
12104_0,,,,2,2,1,3
C(CC(C)(CC(C=O)=O)O)(O)=O,,,5,1,1,0,1
12106_0,,,,2,2,1,3
C(C(CO)C(C)(CC(O)=O)O)=O,,,5,1,2,0,2
12106_1,,,,2,2,1,3
12108_0,,,,2,2,1,3
C(CC(C)(C(C(CO)=O)O)O)(O)=O,,,5,1,2,0,2
12108_1,,,,2,2,1,3
12110_0,,,,2,2,1,3
C(CC(C)(CC(CO)=O)O)(O)=O,,,5,1,1,0,1
12112_0,,,,2,2,1,3
C(CC(C)(C(C(C)=O)O)O)(O)=O,,,5,1,2,0,2
12112_1,,,,2,2,1,3
12114_0,,,,2,2,1,3
C(C(C=C)C(C)(CC(O)=O)O)=O,,,5,1,1,0,1
12116_0,,,,2,2,1,3
C(CC(C)(C(C=O)O)O)(O)=O,,,5,1,3,0,3
12116_1,,,,2,2,1,3
12118_0,,,,2,2,1,3
C(CC(C)(CC(C(O)=O)=O)O)(O)=O,,,5,1,1,0,1
12120_0,,,,2,2,1,3
C(CC(CC(C)(CCO)O)=O)(O)=O,,,5,1,1,0,1
12122_0,,,,2,2,1,3
C(CC(CC(C)(CC)O)=O)(O)=O,,,5,1,1,0,1
12124_0,,,,2,2,1,3
C(CC(CC(C)(C(C)O)O)=O)(O)=O,,,5,1,1,0,1
12126_0,,,,2,2,1,3
C(CC(CC(CO)(CC)O)=O)(O)=O,,,5,1,1,0,1
12128_0,,,,2,2,1,3
C(CC(CC(CC=O)O)=O)(O)=O,,,5,1,1,0,1
12130_0,,,,2,2,1,3
C(CC(CC([CH]C(O)=O)O)=O)(O)=O,,,5,1,1,0,1
12132_0,,,,2,2,1,3
C(C(C=C)(CC(CC(O)=O)=O)O)=O,,,5,1,1,0,1
12134_0,,,,2,2,1,3
C(CC(CC(C(C=C)=O)O)=O)(O)=O,,,5,1,1,0,1
12136_0,,,,2,2,1,3
C(CC(CC(C=C)O)=O)(O)=O,,,5,1,1,0,1
12138_0,,,,2,2,1,3
C(CC(CC(C(CC)O)O)=O)(O)=O,,,5,1,1,0,1
12140_0,,,,2,2,1,3
C(CC(CC(CCCO)O)=O)(O)=O,,,5,1,1,0,1
12142_0,,,,2,2,1,3
C(CC(CC(C(O)O)O)=O)(O)=O,,,5,1,1,0,1
12143_0,,,,2,2,1,3
12144_0,,,,2,2,1,3
12146_0,,,,2,2,1,3
C(CC(CC(CC(C)O)O)=O)(O)=O,,,5,1,1,0,1
12148_0,,,,2,2,1,3
C(CC(CC(CC(O)=O)O)=O)(O)=O,,,5,1,1,0,1
12150_0,,,,2,2,1,3
C(CC(CC(C(CO)=O)O)=O)(O)=O,,,5,1,1,0,1
12152_0,,,,2,2,1,3
C(C(CO)(CC(CC(O)=O)=O)O)=O,,,5,1,1,0,1
12154_0,,,,2,2,1,3
C(C(C)(CC(CC(O)=O)=O)O)=O,,,5,1,2,0,2
12156_0,,,,2,2,1,3
C(CC(CC(C(C)=O)O)=O)(O)=O,,,5,1,2,0,2
12158_0,,,,2,2,1,3
C(CC(CCO)=O)(O)=O,,,5,1,8,0,8
12160_0,,,,2,2,1,3
C(CC(CC(CCO)O)=O)(O)=O,,,5,1,1,0,1
12162_0,,,,2,2,1,3
C(CC(CC(C=O)O)=O)(O)=O,,,5,1,5,0,5
12164_0,,,,2,2,1,3
C(CC(C(C=O)O)O)(CC(O)=O)=O,,,5,1,1,0,1
12166_0,,,,2,2,1,3
C(CC(CC(CO)(CO)O)=O)(O)=O,,,5,1,1,0,1
12168_0,,,,2,2,1,3
C(CC(CC(C)(CO)O)=O)(O)=O,,,5,1,1,0,1
12170_0,,,,2,2,1,3
C(CC(CC(C=CC)O)=O)(O)=O,,,5,1,1,0,1
12172_0,,,,2,2,1,3
C(CC(CC(CC=C)O)=O)(O)=O,,,5,1,1,0,1
12174_0,,,,2,2,1,3
C(CC(CC(C(CO)O)O)=O)(O)=O,,,5,1,1,0,1
12176_0,,,,2,2,1,3
C(CC(CC(CO)O)=O)(O)=O,,,5,1,3,0,3
12178_0,,,,2,2,1,3
C(CC(CC(C(C)O)O)=O)(O)=O,,,5,1,1,0,1
12180_0,,,,2,2,1,3
C(CC(CC(C(O)=O)O)=O)(O)=O,,,5,1,7,0,7
12182_0,,,,2,2,1,3
C(C(C)(CC(CC(O)=O)=O)O)(O)=O,,,5,1,1,0,1
12184_0,,,,2,2,1,3
C(C(C(C)=O)C(C)(CCO)O)(O)=O,,,5,1,2,0,2
12184_1,,,,2,2,1,3
12186_0,,,,2,2,1,3
C(C(C(C)=O)C(C)(CC)O)(O)=O,,,5,1,2,0,2
12186_1,,,,2,2,1,3
12188_0,,,,2,2,1,3
C(C(C(C)=O)C(C)(C(C)O)O)(O)=O,,,5,1,2,0,2
12188_1,,,,2,2,1,3
12190_0,,,,2,2,1,3
C(C(C(C)=O)C(CO)(CC)O)(O)=O,,,5,1,2,0,2
12190_1,,,,2,2,1,3
12192_0,,,,2,2,1,3
C(CC(C(C(O)=O)C(C)=O)O)=O,,,5,1,3,0,3
12192_1,,,,2,2,1,3
12194_0,,,,2,2,1,3
C(C(C(C)=O)C([CH]C(O)=O)O)(O)=O,,,5,1,2,0,2
12194_1,,,,2,2,1,3
12196_0,,,,2,2,1,3
C(C(C(C)=O)C(C=O)(C=C)O)(O)=O,,,5,1,2,0,2
12196_1,,,,2,2,1,3
12198_0,,,,2,2,1,3
C(C(C(C)=O)C(C(C=C)=O)O)(O)=O,,,5,1,2,0,2
12198_1,,,,2,2,1,3
12200_0,,,,2,2,1,3
C(C(C(C)=O)C(C=C)O)(O)=O,,,5,1,2,0,2
12200_1,,,,2,2,1,3
12202_0,,,,2,2,1,3
C(C(C(C)=O)C(C(CC)O)O)(O)=O,,,5,1,2,0,2
12202_1,,,,2,2,1,3
12204_0,,,,2,2,1,3
C(C(C(C)=O)C(CCCO)O)(O)=O,,,5,1,2,0,2
12204_1,,,,2,2,1,3
12206_0,,,,2,2,1,3
C(C(C(C)=O)C(C(O)O)O)(O)=O,,,5,1,2,0,2
12206_1,,,,2,2,1,3
12208_0,,,,2,2,1,3
C(C(C(C)=O)C(C)O)(O)=O,,,5,1,6,0,6
12208_1,,,,2,2,1,3
12210_0,,,,2,2,1,3
C(C(C(O)=O)C(C)=O)(O)=O,,,5,1,6,0,6
12210_1,,,,2,2,1,3
12212_0,,,,2,2,1,3
C(C(C(C)=O)C(CC(C)O)O)(O)=O,,,5,1,2,0,2
12212_1,,,,2,2,1,3
12214_0,,,,2,2,1,3
C(CC(C(C(O)=O)C(C)=O)O)(O)=O,,,5,1,2,0,2
12214_1,,,,2,2,1,3
12216_0,,,,2,2,1,3
C(C(C(C)=O)C(C(CO)=O)O)(O)=O,,,5,1,2,0,2
12216_1,,,,2,2,1,3
12218_0,,,,2,2,1,3
C(C(CO)(C(C(O)=O)C(C)=O)O)=O,,,5,1,2,0,2
12218_1,,,,2,2,1,3
12220_0,,,,2,2,1,3
C(C(C)(C(C(O)=O)C(C)=O)O)=O,,,5,1,3,0,3
12220_1,,,,2,2,1,3
12222_0,,,,2,2,1,3
C(C(C(C)=O)C(C(C)=O)O)(O)=O,,,5,1,3,0,3
12222_1,,,,2,2,1,3
12223_0,,,,2,2,1,3
12223_1,,,,2,2,1,3
12225_0,,,,2,2,1,3
C(C(C(C)=O)C(CCO)O)(O)=O,,,5,1,3,0,3
12225_1,,,,2,2,1,3
12227_0,,,,2,2,1,3
C(C(C(C)=O)C(C=O)O)(O)=O,,,5,1,5,0,5
12227_1,,,,2,2,1,3
12229_0,,,,2,2,1,3
C(C(C(C(C(O)=O)C(C)=O)O)O)=O,,,5,1,2,0,2
12229_1,,,,2,2,1,3
12231_0,,,,2,2,1,3
C(C(C(C)=O)C(CO)(CO)O)(O)=O,,,5,1,2,0,2
12231_1,,,,2,2,1,3
12233_0,,,,2,2,1,3
C(C(C(C)=O)C(C)(CO)O)(O)=O,,,5,1,3,0,3
12233_1,,,,2,2,1,3
12235_0,,,,2,2,1,3
C(C(C(C)=O)C(C=CC)O)(O)=O,,,5,1,3,0,3
12235_1,,,,2,2,1,3
12237_0,,,,2,2,1,3
C(C(C(C)=O)C(CC=C)O)(O)=O,,,5,1,3,0,3
12237_1,,,,2,2,1,3
12239_0,,,,2,2,1,3
C(C(C(C)=O)C(C(CO)O)O)(O)=O,,,5,1,2,0,2
12239_1,,,,2,2,1,3
12241_0,,,,2,2,1,3
C(C(C(C)=O)C(CO)O)(O)=O,,,5,1,5,0,5
12241_1,,,,2,2,1,3
12243_0,,,,2,2,1,3
C(C(C(C)=O)C(C(C)O)O)(O)=O,,,5,1,3,0,3
12243_1,,,,2,2,1,3
12245_0,,,,2,2,1,3
C(C(C(C)=O)C(C(O)=O)O)(O)=O,,,5,1,6,0,6
12245_1,,,,2,2,1,3
12247_0,,,,2,2,1,3
C(C(C)(C(C(O)=O)C(C)=O)O)(O)=O,,,5,1,2,0,2
12247_1,,,,2,2,1,3
12249_0,,,,2,2,1,3
C(CC(C)(CCO)O)(CCO)=O,,,5,1,1,0,1
12251_0,,,,2,2,1,3
C(C)(C(CO)C(C)(CCO)O)=O,,,5,1,2,0,2
12251_1,,,,2,2,1,3
12253_0,,,,2,2,1,3
C(C)(C(C)C(C)(CCO)O)=O,,,5,1,1,0,1
12255_0,,,,2,2,1,3
C(CC(C)(CCO)O)(CC)=O,,,5,1,1,0,1
12257_0,,,,2,2,1,3
C(C([CH]C(O)=O)C(C)(CCO)O)=O,,,5,1,1,0,1
12259_0,,,,2,2,1,3
C(C(C(C)(CCO)O)CC(O)=O)=O,,,5,1,1,0,1
12261_0,,,,2,2,1,3
C(C(C(C=O)=O)C(C)(CCO)O)=O,,,5,1,2,0,2
12261_1,,,,2,2,1,3
12263_0,,,,2,2,1,3
C(C(C(C)C(C)(CCO)O)=O)(O)=O,,,5,1,1,0,1
12265_0,,,,2,2,1,3
C(C(C)O)(CC(C)(CCO)O)=O,,,5,1,1,0,1
12267_0,,,,2,2,1,3
C(C(C(C)(CCO)O)O)(CC)=O,,,5,1,2,0,2
12267_1,,,,2,2,1,3
12269_0,,,,2,2,1,3
C(CO)(C(C)C(C)(CCO)O)=O,,,5,1,1,0,1
12271_0,,,,2,2,1,3
C(C(C=O)C(C)(CCO)O)=O,,,5,1,2,0,2
12271_1,,,,2,2,1,3
12273_0,,,,2,2,1,3
C(C(C(C=O)=C)C(C)(CCO)O)=O,,,5,1,1,0,1
12275_0,,,,2,2,1,3
C(C=CC(CC(C)(CCO)O)=O)=O,,,5,1,1,0,1
12277_0,,,,2,2,1,3
C=CC(C(C=O)=O)C(C)(CCO)O,,,5,1,1,0,1
12279_0,,,,2,2,1,3
C(C(CCO)C(C)(CCO)O)=O,,,5,1,1,0,1
12281_0,,,,2,2,1,3
C1(C(O)OCC1C(C)(CCO)O)=O,,,5,1,2,0,2
12281_1,,,,2,2,1,3
12283_0,,,,2,2,1,3
C1(C(C(CO1)C(C)(CCO)O)=O)=O,,,5,1,2,0,2
12283_1,,,,2,2,1,3
12285_0,,,,2,2,1,3
C(C(C(C)CO)C(C)(CCO)O)=O,,,5,1,1,0,1
12287_0,,,,2,2,1,3
C(CC(C)(CCO)O)=O,,,5,1,1,0,1
12289_0,,,,2,2,1,3
C(C(C(C)O)C(C)(CCO)O)=O,,,5,1,2,0,2
12289_1,,,,2,2,1,3
12291_0,,,,2,2,1,3
C(C(C=O)C(C)(CCO)O)(O)=O,,,5,1,2,0,2
12291_1,,,,2,2,1,3
12293_0,,,,2,2,1,3
C(C(C(C(C)(CCO)O)O)=O)=O,,,5,1,2,0,2
12293_1,,,,2,2,1,3
12295_0,,,,2,2,1,3
C(C(CC(C)(CCO)O)=O)=O,,,5,1,1,0,1
12297_0,,,,2,2,1,3
C(C(C(C(C)(CCO)O)O)=O)(O)=O,,,5,1,2,0,2
12297_1,,,,2,2,1,3
12299_0,,,,2,2,1,3
C(C(C(CO)C(C)(CCO)O)=O)=O,,,5,1,2,0,2
12299_1,,,,2,2,1,3
12301_0,,,,2,2,1,3
C(C(CO)C(C)(CCO)O)=O,,,5,1,2,0,2
12301_1,,,,2,2,1,3
12303_0,,,,2,2,1,3
C(CO)(C(C(C)(CCO)O)O)=O,,,5,1,2,0,2
12303_1,,,,2,2,1,3
12305_0,,,,2,2,1,3
C(CO)(CC(C)(CCO)O)=O,,,5,1,1,0,1
12307_0,,,,2,2,1,3
C(C)(C(C(C)(CCO)O)O)=O,,,5,1,2,0,2
12307_1,,,,2,2,1,3
12309_0,,,,2,2,1,3
C(C(C=C)C(C)(CCO)O)=O,,,5,1,1,0,1
12311_0,,,,2,2,1,3
C(C(C(C)(CCO)O)O)=O,,,5,1,2,0,2
12311_1,,,,2,2,1,3
12313_0,,,,2,2,1,3
C(C(CC(C)(CCO)O)=O)(O)=O,,,5,1,1,0,1
12315_0,,,,2,2,1,3
C(CC(C)(CC)O)(CCO)=O,,,5,1,1,0,1
12317_0,,,,2,2,1,3
C(CCO)(CC(C[CH]C(O)=O)O)=O,,,5,1,1,0,1
12319_0,,,,2,2,1,3
C(CCC(CC(CCO)=O)O)(O)=O,,,5,1,1,0,1
12321_0,,,,2,2,1,3
C(CC(C(C)(CO)O)O)(CCO)=O,,,5,1,1,0,1
12323_0,,,,2,2,1,3
C(CC(C(C(O)=O)=C)O)(CCO)=O,,,5,1,1,0,1
12325_0,,,,2,2,1,3
C(CCO)(CC(CC(C=O)=O)O)=O,,,5,1,1,0,1
12327_0,,,,2,2,1,3
C(CC(C(CC=O)=O)O)(CCO)=O,,,5,1,1,0,1
12329_0,,,,2,2,1,3
C(CC(C=O)(CC=O)O)(CCO)=O,,,5,1,1,0,1
12331_0,,,,2,2,1,3
C(C(C)C(CC(CCO)=O)O)(O)=O,,,5,1,1,0,1
12333_0,,,,2,2,1,3
C(C(CC)(CC(CCO)=O)O)(O)=O,,,5,1,1,0,1
12335_0,,,,2,2,1,3
C(CC(C)(C(C)O)O)(CCO)=O,,,5,1,1,0,1
12337_0,,,,2,2,1,3
C(CC(CO)(CC)O)(CCO)=O,,,5,1,1,0,1
12339_0,,,,2,2,1,3
C(CC(CC(CCO)=O)O)=O,,,5,1,1,0,1
12341_0,,,,2,2,1,3
C(CC([CH]C(O)=O)O)(CCO)=O,,,5,1,1,0,1
12343_0,,,,2,2,1,3
C(CC(C(C(C)O)=C)O)(CCO)=O,,,5,1,1,0,1
12345_0,,,,2,2,1,3
C(CC(C(CO)=CC)O)(CCO)=O,,,5,1,1,0,1
12347_0,,,,2,2,1,3
C(CC(C=C(C=O)C)O)(CCO)=O,,,5,1,1,0,1
12349_0,,,,2,2,1,3
C(CC(C(C)=CC=O)O)(CCO)=O,,,5,1,1,0,1
12351_0,,,,2,2,1,3
C(CC(CC(C=O)=C)O)(CCO)=O,,,5,1,1,0,1
12353_0,,,,2,2,1,3
C(CC(C(CC=O)=C)O)(CCO)=O,,,5,1,1,0,1
12355_0,,,,2,2,1,3
C(CC(C=CC(C)=O)O)(CCO)=O,,,5,1,1,0,1
12357_0,,,,2,2,1,3
C(CC(C=CC=O)(C)O)(CCO)=O,,,5,1,1,0,1
12359_0,,,,2,2,1,3
C(C(C=C)(CC(CCO)=O)O)=O,,,5,1,1,0,1
12361_0,,,,2,2,1,3
C(CC(C(C=C)=O)O)(CCO)=O,,,5,1,1,0,1
12363_0,,,,2,2,1,3
C(CC(C=O)(CC=C)O)(CCO)=O,,,5,1,1,0,1
12365_0,,,,2,2,1,3
C(CC(C(CC=C)=O)O)(CCO)=O,,,5,1,1,0,1
12367_0,,,,2,2,1,3
C(C(C=CC)(CC(CCO)=O)O)=O,,,5,1,1,0,1
12369_0,,,,2,2,1,3
C(CC(C(C=CC)=O)O)(CCO)=O,,,5,1,1,0,1
12371_0,,,,2,2,1,3
C(CC(C=C)O)(CCO)=O,,,5,1,1,0,1
12373_0,,,,2,2,1,3
C(C(C=C)(CC(CCO)=O)O)(O)=O,,,5,1,1,0,1
12375_0,,,,2,2,1,3
C(CC(C(CC)O)O)(CCO)=O,,,5,1,1,0,1
12377_0,,,,2,2,1,3
C(CC(CCCO)O)(CCO)=O,,,5,1,1,0,1
12379_0,,,,2,2,1,3
C(CC1(C(O)OCC1)O)(CCO)=O,,,5,1,1,0,1
12381_0,,,,2,2,1,3
C1(C(CCO1)(CC(CCO)=O)O)=O,,,5,1,1,0,1
12383_0,,,,2,2,1,3
C(CC(CC(C)CO)O)(CCO)=O,,,5,1,1,0,1
12385_0,,,,2,2,1,3
C(CC(C(CCO)O)O)(CCO)=O,,,5,1,1,0,1
12387_0,,,,2,2,1,3
C(CC(C(O)O)O)(CCO)=O,,,5,1,1,0,1
12389_0,,,,2,2,1,3
C(CC(C)O)(CCO)=O,,,5,1,4,0,4
12390_0,,,,2,2,1,3
12392_0,,,,2,2,1,3
C(CC(CC(C)O)O)(CCO)=O,,,5,1,1,0,1
12394_0,,,,2,2,1,3
C(CC(CC(CCO)=O)O)(O)=O,,,5,1,1,0,1
12396_0,,,,2,2,1,3
C(CC(C(CO)=O)O)(CCO)=O,,,5,1,1,0,1
12398_0,,,,2,2,1,3
C(C(CO)(CC(CCO)=O)O)=O,,,5,1,1,0,1
12400_0,,,,2,2,1,3
C(C(C)(CC(CCO)=O)O)=O,,,5,1,1,0,1
12402_0,,,,2,2,1,3
C(CC(C(C)=O)O)(CCO)=O,,,5,1,1,0,1
12404_0,,,,2,2,1,3
C(CCO)(CCO)=O,,,5,1,3,0,3
12406_0,,,,2,2,1,3
C(C(CO)(CC(CCO)=O)O)(O)=O,,,5,1,1,0,1
12408_0,,,,2,2,1,3
C(C(CCO)(CC(CCO)=O)O)=O,,,5,1,1,0,1
12410_0,,,,2,2,1,3
C(CC(C(CCO)=O)O)(CCO)=O,,,5,1,1,0,1
12412_0,,,,2,2,1,3
C(CC(CCO)O)(CCO)=O,,,5,1,1,0,1
12414_0,,,,2,2,1,3
C(CC(C=O)O)(CCO)=O,,,5,1,3,0,3
12416_0,,,,2,2,1,3
C(CCO)(CC(C(C=O)O)O)=O,,,5,1,1,0,1
12418_0,,,,2,2,1,3
C(CCO)(CC(C(C(O)=O)O)O)=O,,,5,1,1,0,1
12420_0,,,,2,2,1,3
C(CC(CO)(CO)O)(CCO)=O,,,5,1,1,0,1
12422_0,,,,2,2,1,3
C(CC(C)(CO)O)(CCO)=O,,,5,1,1,0,1
12424_0,,,,2,2,1,3
C(CC(C=CC)O)(CCO)=O,,,5,1,1,0,1
12426_0,,,,2,2,1,3
C(CCO)(CC(CC=C)O)=O,,,5,1,1,0,1
12428_0,,,,2,2,1,3
C(CC(C(CO)O)O)(CCO)=O,,,5,1,1,0,1
12430_0,,,,2,2,1,3
C(CC(CO)O)(CCO)=O,,,5,1,3,0,3
12432_0,,,,2,2,1,3
C(CC(C(C)O)O)(CCO)=O,,,5,1,1,0,1
12434_0,,,,2,2,1,3
C(CC(C(O)=O)O)(CCO)=O,,,5,1,3,0,3
12436_0,,,,2,2,1,3
C(C(C)(CC(CCO)=O)O)(O)=O,,,5,1,2,0,2
12438_0,,,,2,2,1,3
C(C)(C(CO)C(C)(CC)O)=O,,,5,1,2,0,2
12438_1,,,,2,2,1,3
12440_0,,,,2,2,1,3
C(C)(C(CO)C(C[CH]C(O)=O)O)=O,,,5,1,2,0,2
12440_1,,,,2,2,1,3
12442_0,,,,2,2,1,3
C(CCC(C(C(C)=O)CO)O)(O)=O,,,5,1,2,0,2
12442_1,,,,2,2,1,3
12444_0,,,,2,2,1,3
C(C)(C(CO)C(C(C)(CO)O)O)=O,,,5,1,2,0,2
12444_1,,,,2,2,1,3
12446_0,,,,2,2,1,3
C(C)(C(CO)C(C(C(O)=O)=C)O)=O,,,5,1,2,0,2
12446_1,,,,2,2,1,3
12448_0,,,,2,2,1,3
C(C)(C(CO)C(CC(C=O)=O)O)=O,,,5,1,2,0,2
12448_1,,,,2,2,1,3
12450_0,,,,2,2,1,3
C(C)(C(CO)C(C(CC=O)=O)O)=O,,,5,1,2,0,2
12450_1,,,,2,2,1,3
12452_0,,,,2,2,1,3
C(C)(C(CO)C(C=O)(CC=O)O)=O,,,5,1,2,0,2
12452_1,,,,2,2,1,3
12454_0,,,,2,2,1,3
C(C(C)C(C(C(C)=O)CO)O)(O)=O,,,5,1,2,0,2
12454_1,,,,2,2,1,3
12456_0,,,,2,2,1,3
C(C(CC)(C(C(C)=O)CO)O)(O)=O,,,5,1,2,0,2
12456_1,,,,2,2,1,3
12458_0,,,,2,2,1,3
C(C)(C(CO)C(C)(C(C)O)O)=O,,,5,1,2,0,2
12458_1,,,,2,2,1,3
12460_0,,,,2,2,1,3
C(C)(C(CO)C(CO)(CC)O)=O,,,5,1,2,0,2
12460_1,,,,2,2,1,3
12462_0,,,,2,2,1,3
C(CC(C(C(C)=O)CO)O)=O,,,5,1,2,0,2
12462_1,,,,2,2,1,3
12464_0,,,,2,2,1,3
C(C)(C(CO)C([CH]C(O)=O)O)=O,,,5,1,2,0,2
12464_1,,,,2,2,1,3
12466_0,,,,2,2,1,3
C(C)(C(CO)C(C(C(C)O)=C)O)=O,,,5,1,2,0,2
12466_1,,,,2,2,1,3
12468_0,,,,2,2,1,3
C(C)(C(CO)C(C(CO)=CC)O)=O,,,5,1,2,0,2
12468_1,,,,2,2,1,3
12470_0,,,,2,2,1,3
C(C)(C(CO)C(C=C(C=O)C)O)=O,,,5,1,2,0,2
12470_1,,,,2,2,1,3
12472_0,,,,2,2,1,3
C(C)(C(CO)C(C(C)=CC=O)O)=O,,,5,1,2,0,2
12472_1,,,,2,2,1,3
12474_0,,,,2,2,1,3
C(C)(C(CO)C(CC(C=O)=C)O)=O,,,5,1,2,0,2
12474_1,,,,2,2,1,3
12476_0,,,,2,2,1,3
C(C)(C(CO)C(C(CC=O)=C)O)=O,,,5,1,2,0,2
12476_1,,,,2,2,1,3
12478_0,,,,2,2,1,3
C(C)(C(CO)C(C=CC(C)=O)O)=O,,,5,1,2,0,2
12478_1,,,,2,2,1,3
12480_0,,,,2,2,1,3
C(C)(C(CO)C(C=CC=O)(C)O)=O,,,5,1,2,0,2
12480_1,,,,2,2,1,3
12482_0,,,,2,2,1,3
C(C(C=C)(C(C(C)=O)CO)O)=O,,,5,1,2,0,2
12482_1,,,,2,2,1,3
12484_0,,,,2,2,1,3
C(C)(C(CO)C(C(C=C)=O)O)=O,,,5,1,2,0,2
12484_1,,,,2,2,1,3
12486_0,,,,2,2,1,3
C(C)(C(CO)C(C=O)(CC=C)O)=O,,,5,1,2,0,2
12486_1,,,,2,2,1,3
12488_0,,,,2,2,1,3
C(C)(C(CO)C(C(CC=C)=O)O)=O,,,5,1,2,0,2
12488_1,,,,2,2,1,3
12490_0,,,,2,2,1,3
C(C(C=CC)(C(C(C)=O)CO)O)=O,,,5,1,2,0,2
12490_1,,,,2,2,1,3
12492_0,,,,2,2,1,3
C(C)(C(CO)C(C(C=CC)=O)O)=O,,,5,1,2,0,2
12492_1,,,,2,2,1,3
12494_0,,,,2,2,1,3
C(C)(C(CO)C(C=C)O)=O,,,5,1,2,0,2
12494_1,,,,2,2,1,3
12496_0,,,,2,2,1,3
C(C(C=C)(C(C(C)=O)CO)O)(O)=O,,,5,1,2,0,2
12496_1,,,,2,2,1,3
12498_0,,,,2,2,1,3
C(C)(C(CO)C(C(CC)O)O)=O,,,5,1,2,0,2
12498_1,,,,2,2,1,3
12500_0,,,,2,2,1,3
C(C)(C(CO)C(CCCO)O)=O,,,5,1,2,0,2
12500_1,,,,2,2,1,3
12502_0,,,,2,2,1,3
C(C)(C(CO)C1(C(O)OCC1)O)=O,,,5,1,2,0,2
12502_1,,,,2,2,1,3
12504_0,,,,2,2,1,3
C1(C(CCO1)(C(C(C)=O)CO)O)=O,,,5,1,2,0,2
12504_1,,,,2,2,1,3
12506_0,,,,2,2,1,3
C(C)(C(CO)C(CC(C)CO)O)=O,,,5,1,2,0,2
12506_1,,,,2,2,1,3
12508_0,,,,2,2,1,3
C(C)(C(CO)C(C(CCO)O)O)=O,,,5,1,2,0,2
12508_1,,,,2,2,1,3
12510_0,,,,2,2,1,3
C(C)(C(CO)C(C(O)O)O)=O,,,5,1,2,0,2
12510_1,,,,2,2,1,3
12512_0,,,,2,2,1,3
C(C)(C(CO)C(C)O)=O,,,5,1,4,0,4
12512_1,,,,2,2,1,3
12513_0,,,,2,2,1,3
12513_1,,,,2,2,1,3
12515_0,,,,2,2,1,3
C(C)(C(CO)C(CC(C)O)O)=O,,,5,1,3,0,3
12515_1,,,,2,2,1,3
12517_0,,,,2,2,1,3
C(CC(C(C(C)=O)CO)O)(O)=O,,,5,1,3,0,3
12517_1,,,,2,2,1,3
12519_0,,,,2,2,1,3
C(C)(C(CO)C(C(CO)=O)O)=O,,,5,1,3,0,3
12519_1,,,,2,2,1,3
12521_0,,,,2,2,1,3
C(C(CO)(C(C(C)=O)CO)O)=O,,,5,1,3,0,3
12521_1,,,,2,2,1,3
12523_0,,,,2,2,1,3
C(C(C)(C(C(C)=O)CO)O)=O,,,5,1,3,0,3
12523_1,,,,2,2,1,3
12525_0,,,,2,2,1,3
C(C)(C(CO)C(C(C)=O)O)=O,,,5,1,3,0,3
12525_1,,,,2,2,1,3
12527_0,,,,2,2,1,3
C(C)(C(CO)CO)=O,,,5,1,4,0,4
12527_1,,,,2,2,1,3
12529_0,,,,2,2,1,3
C(C(CO)(C(C(C)=O)CO)O)(O)=O,,,5,1,2,0,2
12529_1,,,,2,2,1,3
12531_0,,,,2,2,1,3
C(C(CCO)(C(C(C)=O)CO)O)=O,,,5,1,2,0,2
12531_1,,,,2,2,1,3
12533_0,,,,2,2,1,3
C(C)(C(CO)C(C(CCO)=O)O)=O,,,5,1,2,0,2
12533_1,,,,2,2,1,3
12535_0,,,,2,2,1,3
C(C)(C(CO)C(CCO)O)=O,,,5,1,2,0,2
12535_1,,,,2,2,1,3
12537_0,,,,2,2,1,3
C(C)(C(CO)C(C=O)O)=O,,,5,1,3,0,3
12537_1,,,,2,2,1,3
12539_0,,,,2,2,1,3
C(C(C(C(C(C)=O)CO)O)O)=O,,,5,1,2,0,2
12539_1,,,,2,2,1,3
12541_0,,,,2,2,1,3
C(C(C(C(C(C)=O)CO)O)O)(O)=O,,,5,1,2,0,2
12541_1,,,,2,2,1,3
12543_0,,,,2,2,1,3
C(C)(C(CO)C(CO)(CO)O)=O,,,5,1,2,0,2
12543_1,,,,2,2,1,3
12545_0,,,,2,2,1,3
C(C)(C(CO)C(C)(CO)O)=O,,,5,1,2,0,2
12545_1,,,,2,2,1,3
12547_0,,,,2,2,1,3
C(C)(C(CO)C(C=CC)O)=O,,,5,1,2,0,2
12547_1,,,,2,2,1,3
12549_0,,,,2,2,1,3
C(C)(C(CO)C(CC=C)O)=O,,,5,1,2,0,2
12549_1,,,,2,2,1,3
12551_0,,,,2,2,1,3
C(C)(C(CO)C(C(CO)O)O)=O,,,5,1,2,0,2
12551_1,,,,2,2,1,3
12553_0,,,,2,2,1,3
C(C)(C(CO)C(CO)O)=O,,,5,1,3,0,3
12553_1,,,,2,2,1,3
12555_0,,,,2,2,1,3
C(C)(C(CO)C(C(C)O)O)=O,,,5,1,2,0,2
12555_1,,,,2,2,1,3
12557_0,,,,2,2,1,3
C(C)(C(CO)C(C(O)=O)O)=O,,,5,1,5,0,5
12557_1,,,,2,2,1,3
12559_0,,,,2,2,1,3
C(C(C)(C(C(C)=O)CO)O)(O)=O,,,5,1,3,0,3
12559_1,,,,2,2,1,3
12561_0,,,,2,2,1,3
C(C)(C(C)C(C)(CC)O)=O,,,5,1,1,0,1
12563_0,,,,2,2,1,3
C(CC(C)(CC)O)(CC)=O,,,5,1,1,0,1
12565_0,,,,2,2,1,3
C(C)(C([CH]C(O)=O)C(C)(CC)O)=O,,,5,1,1,0,1
12567_0,,,,2,2,1,3
C(CC(C)(CC)O)(C[CH]C(O)=O)=O,,,5,1,1,0,1
12569_0,,,,2,2,1,3
C(C)(C(C(C)(CC)O)CC(O)=O)=O,,,5,1,1,0,1
12571_0,,,,2,2,1,3
C(CCC(O)=O)(CC(C)(CC)O)=O,,,5,1,1,0,1
12573_0,,,,2,2,1,3
C(C([CH]C(O)=O)C(C)(CC)O)=O,,,5,1,1,0,1
12575_0,,,,2,2,1,3
C(C(C(C)(CC)O)CC(O)=O)=O,,,5,1,1,0,1
12577_0,,,,2,2,1,3
C(C(C(C(C)O)=O)C(C)(CC)O)=O,,,5,1,2,0,2
12577_1,,,,2,2,1,3
12579_0,,,,2,2,1,3
C(CC(C)(CC)O)(C(C(C)=O)O)=O,,,5,1,1,0,1
12581_0,,,,2,2,1,3
C(C(CCO)O)(CC(C)(CC)O)=O,,,5,1,1,0,1
12583_0,,,,2,2,1,3
C(C(C=O)C(C=O)C(C)(CC)O)=O,,,5,1,1,0,1
12585_0,,,,2,2,1,3
C(C(C(C=O)=O)C(C)(CC)O)=O,,,5,1,2,0,2
12585_1,,,,2,2,1,3
12587_0,,,,2,2,1,3
C(CC(C)(CC)O)(CC(C=O)=O)=O,,,5,1,1,0,1
12589_0,,,,2,2,1,3
C(C)(C(C(C=O)=O)C(C)(CC)O)=O,,,5,1,2,0,2
12589_1,,,,2,2,1,3
12591_0,,,,2,2,1,3
C(C(C(C(C)C(C)(CC)O)=O)=O)=O,,,5,1,1,0,1
12593_0,,,,2,2,1,3
C(C(C(C(O)=O)=O)C(C)(CC)O)=O,,,5,1,2,0,2
12593_1,,,,2,2,1,3
12595_0,,,,2,2,1,3
C(C(C(C)C(C)(CC)O)=O)(O)=O,,,5,1,1,0,1
12597_0,,,,2,2,1,3
C(C(C)O)(CC(C)(CC)O)=O,,,5,1,1,0,1
12599_0,,,,2,2,1,3
C(C(C(C)(CC)O)O)(CC)=O,,,5,1,2,0,2
12599_1,,,,2,2,1,3
12601_0,,,,2,2,1,3
C(CO)(C(C)C(C)(CC)O)=O,,,5,1,1,0,1
12603_0,,,,2,2,1,3
C(C(C=O)C(C)(CC)O)=O,,,5,1,2,0,2
12603_1,,,,2,2,1,3
12605_0,,,,2,2,1,3
C(C(C=CC(C)O)C(C)(CC)O)=O,,,5,1,1,0,1
12607_0,,,,2,2,1,3
C(C(C=CC(O)=O)C(C)(CC)O)=O,,,5,1,1,0,1
12609_0,,,,2,2,1,3
C(C=CC(C(C(C)(CC)O)O)=O)=O,,,5,1,2,0,2
12609_1,,,,2,2,1,3
12611_0,,,,2,2,1,3
C=C(C=O)C(C(C=O)=O)C(C)(CC)O,,,5,1,1,0,1
12613_0,,,,2,2,1,3
C(C(C(C=O)=C)C(C)(CC)O)=O,,,5,1,1,0,1
12615_0,,,,2,2,1,3
C(C(C=CC(CC(C)(CC)O)=O)=O)=O,,,5,1,1,0,1
12617_0,,,,2,2,1,3
C(C=CC(CC(C)(CC)O)=O)=O,,,5,1,1,0,1
12619_0,,,,2,2,1,3
C=CC(C(C=O)=O)C(C)(CC)O,,,5,1,1,0,1
12621_0,,,,2,2,1,3
C=C(C(O)=O)C(CC(C)(CC)O)=O,,,5,1,1,0,1
12623_0,,,,2,2,1,3
C(C(CCO)C(C)(CC)O)=O,,,5,1,1,0,1
12625_0,,,,2,2,1,3
C1(C(O)OCC1C(C)(CC)O)=O,,,5,1,2,0,2
12625_1,,,,2,2,1,3
12627_0,,,,2,2,1,3
C1(C(O)OC(C)C1C(C)(CC)O)=O,,,5,1,2,0,2
12627_1,,,,2,2,1,3
12629_0,,,,2,2,1,3
C1(C(C(C(O)O1)=O)C(C)(CC)O)=O,,,5,1,2,0,2
12629_1,,,,2,2,1,3
12631_0,,,,2,2,1,3
C1(C(C(CO1)C(C)(CC)O)=O)=O,,,5,1,2,0,2
12631_1,,,,2,2,1,3
12633_0,,,,2,2,1,3
C1(C(C(C(C(C)(CC)O)O1)=O)=O)=O,,,5,1,2,0,2
12633_1,,,,2,2,1,3
12635_0,,,,2,2,1,3
C(C(C(C)CO)C(C)(CC)O)=O,,,5,1,1,0,1
12637_0,,,,2,2,1,3
C(C(C(C)CCO)C(C)(CC)O)=O,,,5,1,1,0,1
12639_0,,,,2,2,1,3
C(C(C(C)C(C)O)C(C)(CC)O)=O,,,5,1,1,0,1
12641_0,,,,2,2,1,3
C(C(C(C)CC=O)C(C)(CC)O)=O,,,5,1,1,0,1
12643_0,,,,2,2,1,3
C([C](C(CC(C)(CC)O)=O)O)(O)=O,,,5,1,1,0,1
12645_0,,,,2,2,1,3
C(CC(C)(CC)O)=O,,,5,1,1,0,1
12647_0,,,,2,2,1,3
C(C(C(C)O)C(C)(CC)O)=O,,,5,1,2,0,2
12647_1,,,,2,2,1,3
12649_0,,,,2,2,1,3
C(C(C=O)C(C)(CC)O)(O)=O,,,5,1,2,0,2
12649_1,,,,2,2,1,3
12651_0,,,,2,2,1,3
C(C(C(C(C)(CC)O)O)=O)=O,,,5,1,2,0,2
12651_1,,,,2,2,1,3
12653_0,,,,2,2,1,3
C(C(CC(C)(CC)O)=O)=O,,,5,1,1,0,1
12655_0,,,,2,2,1,3
C(C(C(C(C)(CC)O)O)=O)(O)=O,,,5,1,2,0,2
12655_1,,,,2,2,1,3
12657_0,,,,2,2,1,3
C(C(C(C)(CC)O)C(C=O)(C)O)=O,,,5,1,2,0,2
12657_1,,,,2,2,1,3
12659_0,,,,2,2,1,3
C(C(C(C)(CC)O)C(C(C)=O)O)=O,,,5,1,2,0,2
12659_1,,,,2,2,1,3
12661_0,,,,2,2,1,3
C(CC(C(CC(C)(CC)O)=O)O)=O,,,5,1,1,0,1
12663_0,,,,2,2,1,3
C(C(C(CO)C(C)(CC)O)=O)=O,,,5,1,2,0,2
12663_1,,,,2,2,1,3
12665_0,,,,2,2,1,3
C(C(C(C(C)O)C(C)(CC)O)=O)=O,,,5,1,2,0,2
12665_1,,,,2,2,1,3
12667_0,,,,2,2,1,3
C(C(C(C=O)=O)C(C)(CC)O)(O)=O,,,5,1,2,0,2
12667_1,,,,2,2,1,3
12669_0,,,,2,2,1,3
C(C(CO)C(C)(CC)O)=O,,,5,1,2,0,2
12669_1,,,,2,2,1,3
12671_0,,,,2,2,1,3
C(C(C(CO)C(C)(CC)O)=O)(O)=O,,,5,1,2,0,2
12671_1,,,,2,2,1,3
12673_0,,,,2,2,1,3
C(C(C(C(C)=O)=O)C(C)(CC)O)=O,,,5,1,2,0,2
12673_1,,,,2,2,1,3
12675_0,,,,2,2,1,3
C(CC(C(CC(C)(CC)O)=O)=O)=O,,,5,1,1,0,1
12677_0,,,,2,2,1,3
C(C(C(C)O)=O)(CC(C)(CC)O)=O,,,5,1,1,0,1
12679_0,,,,2,2,1,3
C(C(C(CC(C)(CC)O)=O)=O)(O)=O,,,5,1,1,0,1
12681_0,,,,2,2,1,3
C(CO)(C(C(C)(CC)O)O)=O,,,5,1,2,0,2
12681_1,,,,2,2,1,3
12683_0,,,,2,2,1,3
C(CO)(CC(C)(CC)O)=O,,,5,1,1,0,1
12685_0,,,,2,2,1,3
C(C)(C(C(C)(CC)O)O)=O,,,5,1,2,0,2
12685_1,,,,2,2,1,3
12687_0,,,,2,2,1,3
C(C(C(CC(C)(CC)O)=O)C)(O)=O,,,5,1,1,0,1
12689_0,,,,2,2,1,3
C(C(C=C)C(C)(CC)O)=O,,,5,1,1,0,1
12691_0,,,,2,2,1,3
C=CC(C(C(O)=O)=O)C(C)(CC)O,,,5,1,1,0,1
12693_0,,,,2,2,1,3
C(C(C(C(O)=O)=C)C(C)(CC)O)=O,,,5,1,1,0,1
12695_0,,,,2,2,1,3
C(C(C(C)(CC)O)O)=O,,,5,1,2,0,2
12695_1,,,,2,2,1,3
12697_0,,,,2,2,1,3
C1(C(C(C(C)O1)C(C)(CC)O)=O)=O,,,5,1,2,0,2
12697_1,,,,2,2,1,3
12699_0,,,,2,2,1,3
C1(C(C(C(O1)=O)=O)C(C)(CC)O)=O,,,5,1,2,0,2
12699_1,,,,2,2,1,3
12701_0,,,,2,2,1,3
C(C(C(C)(CC)O)C[CH]C(O)=O)=O,,,5,1,1,0,1
12703_0,,,,2,2,1,3
C(C(CCC(O)=O)C(C)(CC)O)=O,,,5,1,1,0,1
12705_0,,,,2,2,1,3
C(C(CC(C)(CC)O)=O)(O)=O,,,5,1,1,0,1
12707_0,,,,2,2,1,3
C(C)(C(C)C(C)(C[CH]C(O)=O)O)=O,,,5,1,1,0,1
12709_0,,,,2,2,1,3
C(CCC(C)(C(C(C)=O)C)O)(O)=O,,,5,1,1,0,1
12711_0,,,,2,2,1,3
C(C)(C(C)C(C[CH]C(O)=O)O)=O,,,5,1,1,0,1
12713_0,,,,2,2,1,3
C(CCC(C(C(C)=O)C)O)(O)=O,,,5,1,1,0,1
12715_0,,,,2,2,1,3
C(C(C)O)(CC(C(C(C)=O)C)O)=O,,,5,1,1,0,1
12717_0,,,,2,2,1,3
C(CC(C(C)O)(C(C(C)=O)C)O)=O,,,5,1,1,0,1
12719_0,,,,2,2,1,3
C(C)(C(C)C(C)(C(C(C)=O)O)O)=O,,,5,1,1,0,1
12721_0,,,,2,2,1,3
C(C)(C(C)C(C(C)(CCO)O)O)=O,,,5,1,1,0,1
12723_0,,,,2,2,1,3
C(C)(C(C)C(C)(C(CCO)O)O)=O,,,5,1,1,0,1
12725_0,,,,2,2,1,3
C(C)(C(C)C(C(CO)(CO)O)O)=O,,,5,1,1,0,1
12727_0,,,,2,2,1,3
C(C)(C(C)C(C(C)(C(C)O)O)O)=O,,,5,1,1,0,1
12729_0,,,,2,2,1,3
C(C)(C(C)C(C(C)(CO)O)O)=O,,,5,1,1,0,1
12731_0,,,,2,2,1,3
C(C)(C(C)C(C(C(O)=O)=C)O)=O,,,5,1,1,0,1
12733_0,,,,2,2,1,3
C(C(C=O)CC(C(C(C)=O)C)O)=O,,,5,1,1,0,1
12735_0,,,,2,2,1,3
C(C)(C(C)C(C(C=O)CC=O)O)=O,,,5,1,1,0,1
12737_0,,,,2,2,1,3
C(C)(C(C)C(CC(C=O)=O)O)=O,,,5,1,1,0,1
12739_0,,,,2,2,1,3
C(C)(C(C)C(C(CC=O)=O)O)=O,,,5,1,1,0,1
12741_0,,,,2,2,1,3
C(C)(C(C)C(C=O)(CC=O)O)=O,,,5,1,1,0,1
12743_0,,,,2,2,1,3
C(C)(C(C)C(C)(CC(C=O)=O)O)=O,,,5,1,1,0,1
12745_0,,,,2,2,1,3
C(C)(C(C)C(C(CC(C)=O)=O)O)=O,,,5,1,1,0,1
12747_0,,,,2,2,1,3
C(CC(C=O)(C(C(C)=O)C)O)(C)=O,,,5,1,1,0,1
12749_0,,,,2,2,1,3
C(C)(C(C)C(C(C=O)=O)(CC)O)=O,,,5,1,1,0,1
12751_0,,,,2,2,1,3
C(C)(C(C)C(C(C(CC)=O)=O)O)=O,,,5,1,1,0,1
12753_0,,,,2,2,1,3
C(CC)(C(C=O)(C(C(C)=O)C)O)=O,,,5,1,1,0,1
12755_0,,,,2,2,1,3
C(C)(C(C)C(C(O)=O)(CC=O)O)=O,,,5,1,1,0,1
12757_0,,,,2,2,1,3
C(C)(C(C)C(CC(C(O)=O)=O)O)=O,,,5,1,1,0,1
12759_0,,,,2,2,1,3
C(C(C)C(C(C(C)=O)C)O)(O)=O,,,5,1,1,0,1
12761_0,,,,2,2,1,3
C(C(CC)(C(C(C)=O)C)O)(O)=O,,,5,1,1,0,1
12763_0,,,,2,2,1,3
C(C)(C(C)C(C)(C(C)O)O)=O,,,5,1,1,0,1
12765_0,,,,2,2,1,3
C(C)(C(C)C(CO)(CC)O)=O,,,5,1,1,0,1
12767_0,,,,2,2,1,3
C(CC(C(C(C)=O)C)O)=O,,,5,1,1,0,1
12769_0,,,,2,2,1,3
C(C)(C(C)C([CH]C(O)=O)O)=O,,,5,1,1,0,1
12771_0,,,,2,2,1,3
C(C)(C(C)C(C=CCC(C)O)O)=O,,,5,1,1,0,1
12773_0,,,,2,2,1,3
C(C)(C(C(CC=CC(C)O)O)C)=O,,,5,1,1,0,1
12775_0,,,,2,2,1,3
C(C)(C(C)C(C(C(C)O)=C)O)=O,,,5,1,1,0,1
12777_0,,,,2,2,1,3
C(C)(C(C)C(C(CO)=CC)O)=O,,,5,1,1,0,1
12779_0,,,,2,2,1,3
C(C)(C(C)C(C(C(C)O)=CC)O)=O,,,5,1,1,0,1
12781_0,,,,2,2,1,3
C(C)(C(C)C(C(C(O)=O)=CC)O)=O,,,5,1,1,0,1
12783_0,,,,2,2,1,3
C(C)(C(C)C(C=CCC(O)=O)O)=O,,,5,1,1,0,1
12785_0,,,,2,2,1,3
C(C)(C(C)C(CC=CC(O)=O)O)=O,,,5,1,1,0,1
12787_0,,,,2,2,1,3
C(C)(C(C)C(C=CC(CO)=O)O)=O,,,5,1,1,0,1
12789_0,,,,2,2,1,3
C(C)(C(C)C(C=CC=O)(CO)O)=O,,,5,1,1,0,1
12791_0,,,,2,2,1,3
C(C)(C(C)C(C=C(C=O)CO)O)=O,,,5,1,1,0,1
12793_0,,,,2,2,1,3
C(C)(C(C)C(C(CO)=CC=O)O)=O,,,5,1,1,0,1
12795_0,,,,2,2,1,3
C(C)(C(C)C(C(C(C=C)O)=O)O)=O,,,5,1,1,0,1
12797_0,,,,2,2,1,3
C(C)(C(C)C(C=O)(C(C=C)O)O)=O,,,5,1,1,0,1
12799_0,,,,2,2,1,3
C(C(C=C(C=O)C)(C(C(C)=O)C)O)=O,,,5,1,1,0,1
12801_0,,,,2,2,1,3
C(C)(C(C)C(C(C=C(C=O)C)=O)O)=O,,,5,1,1,0,1
12803_0,,,,2,2,1,3
C(C)(C(C)C(C(C)=CC(C=O)=O)O)=O,,,5,1,1,0,1
12805_0,,,,2,2,1,3
C(C)(C(C)C(C=O)(CC(C=O)=C)O)=O,,,5,1,1,0,1
12807_0,,,,2,2,1,3
C(C)(C(C)C(C(CC(C=O)=C)=O)O)=O,,,5,1,1,0,1
12809_0,,,,2,2,1,3
C(C)(C(C)C(C(CC(C=O)=O)=C)O)=O,,,5,1,1,0,1
12811_0,,,,2,2,1,3
C(C)(C(C)C(C=C(C=O)C)O)=O,,,5,1,1,0,1
12813_0,,,,2,2,1,3
C(C)(C(C)C(C(C)=CC=O)O)=O,,,5,1,1,0,1
12815_0,,,,2,2,1,3
C(C)(C(C)C(CC(C=O)=C)O)=O,,,5,1,1,0,1
12817_0,,,,2,2,1,3
C(C)(C(C)C(C(CC=O)=C)O)=O,,,5,1,1,0,1
12819_0,,,,2,2,1,3
C(C(C=CC(C)=O)(C(C(C)=O)C)O)=O,,,5,1,1,0,1
12821_0,,,,2,2,1,3
C(C)(C(C)C(C(C=CC(C)=O)=O)O)=O,,,5,1,1,0,1
12823_0,,,,2,2,1,3
C(C)(C(C)C(C=CC(C=O)=O)(C)O)=O,,,5,1,1,0,1
12825_0,,,,2,2,1,3
C(C)(C(C)C(C=CC(C)=O)O)=O,,,5,1,1,0,1
12827_0,,,,2,2,1,3
C(C)(C(C)C(C=CC=O)(C)O)=O,,,5,1,1,0,1
12829_0,,,,2,2,1,3
C(C(C=C)(C(C(C)=O)C)O)=O,,,5,1,1,0,1
12831_0,,,,2,2,1,3
C(C)(C(C)C(C(C=C)=O)O)=O,,,5,1,1,0,1
12833_0,,,,2,2,1,3
C(C)(C(C)C(C=O)(CC=C)O)=O,,,5,1,1,0,1
12835_0,,,,2,2,1,3
C(C)(C(C)C(C(CC=C)=O)O)=O,,,5,1,1,0,1
12837_0,,,,2,2,1,3
C(C(C=CC)(C(C(C)=O)C)O)=O,,,5,1,1,0,1
12839_0,,,,2,2,1,3
C(C)(C(C)C(C(C=CC)=O)O)=O,,,5,1,1,0,1
12841_0,,,,2,2,1,3
C(C)(C(C)C(C=C)O)=O,,,5,1,1,0,1
12843_0,,,,2,2,1,3
C(C(C=C)(C(C(C)=O)C)O)(O)=O,,,5,1,1,0,1
12845_0,,,,2,2,1,3
C(C)(C(C)C(C(C(O)=O)=C)(C)O)=O,,,5,1,1,0,1
12847_0,,,,2,2,1,3
C(C)(C(C)C(C(CC)O)O)=O,,,5,1,1,0,1
12849_0,,,,2,2,1,3
C(C)(C(C)C(CCCO)O)=O,,,5,1,1,0,1
12851_0,,,,2,2,1,3
C(C)(C(C)C1(C(O)OCC1O)O)=O,,,5,1,1,0,1
12853_0,,,,2,2,1,3
C(C)(C(C)C1(C(O)OCC1)O)=O,,,5,1,1,0,1
12855_0,,,,2,2,1,3
C(C)(C(C)C1(C(O)OC(C)C1)O)=O,,,5,1,1,0,1
12857_0,,,,2,2,1,3
C1(CC(C(O)O1)(C(C(C)=O)C)O)=O,,,5,1,1,0,1
12859_0,,,,2,2,1,3
C1(C(C(CO1)O)(C(C(C)=O)C)O)=O,,,5,1,1,0,1
12861_0,,,,2,2,1,3
C1(C(CCO1)(C(C(C)=O)C)O)=O,,,5,1,1,0,1
12863_0,,,,2,2,1,3
C(C)(C(C)C1(C(C(OC1)=O)=O)O)=O,,,5,1,1,0,1
12865_0,,,,2,2,1,3
C(C)(C(C)C1(C(OCC1=O)=O)O)=O,,,5,1,1,0,1
12867_0,,,,2,2,1,3
C(C)(C(C)C(CC(C)CO)O)=O,,,5,1,1,0,1
12869_0,,,,2,2,1,3
C(C)(C(C)C(CC(C)CCO)O)=O,,,5,1,1,0,1
12871_0,,,,2,2,1,3
C(C)(C(C)C(CC(C)C(C)O)O)=O,,,5,1,1,0,1
12873_0,,,,2,2,1,3
C(CC(C)CC(C(C(C)=O)C)O)=O,,,5,1,1,0,1
12875_0,,,,2,2,1,3
C(C)(C(C)C([C](C(O)=O)O)(C)O)=O,,,5,1,1,0,1
12877_0,,,,2,2,1,3
C(C)(C(C)C(C(CCO)O)O)=O,,,5,1,1,0,1
12879_0,,,,2,2,1,3
C(C)(C(C)C(C(O)O)O)=O,,,5,1,1,0,1
12881_0,,,,2,2,1,3
C(C(C(C)O)(C(C(C)=O)C)O)(O)=O,,,5,1,1,0,1
12883_0,,,,2,2,1,3
C(C)(C(C)C(C)O)=O,,,5,1,2,0,2
12884_0,,,,2,2,1,3
12886_0,,,,2,2,1,3
C(C)(C(C)C(CC(C)O)O)=O,,,5,1,1,0,1
12888_0,,,,2,2,1,3
C(CC(C(C(C)=O)C)O)(O)=O,,,5,1,1,0,1
12890_0,,,,2,2,1,3
C(C)(C(C)C(C(CO)=O)O)=O,,,5,1,1,0,1
12892_0,,,,2,2,1,3
C(C(CO)(C(C(C)=O)C)O)=O,,,5,1,1,0,1
12894_0,,,,2,2,1,3
C(C(C)(C(C(C)=O)C)O)=O,,,5,1,2,0,2
12896_0,,,,2,2,1,3
C(C)(C(C)C(C(C)=O)O)=O,,,5,1,2,0,2
12898_0,,,,2,2,1,3
C(C)(C(C)CO)=O,,,5,1,2,0,2
12900_0,,,,2,2,1,3
C(C(CO)(C(C(C)=O)C)O)(O)=O,,,5,1,1,0,1
12902_0,,,,2,2,1,3
C(C)(C(C)C(C(CO)C(C)O)O)=O,,,5,1,1,0,1
12904_0,,,,2,2,1,3
C(C(CO)C(C(C(C)=O)C)O)(O)=O,,,5,1,1,0,1
12906_0,,,,2,2,1,3
C(C)(C(C)C(C(C(CO)O)=O)O)=O,,,5,1,1,0,1
12908_0,,,,2,2,1,3
C(C(C(CO)O)(C(C(C)=O)C)O)=O,,,5,1,1,0,1
12910_0,,,,2,2,1,3
C(C(C)(CC(C(C(C)=O)C)O)O)=O,,,5,1,1,0,1
12912_0,,,,2,2,1,3
C(CC(C)(C(C(C(C)=O)C)O)O)=O,,,5,1,1,0,1
12914_0,,,,2,2,1,3
C(C)(C(C)C(CC(C(C)=O)O)O)=O,,,5,1,1,0,1
12916_0,,,,2,2,1,3
C(CC(C(C)(C(C(C)=O)C)O)O)=O,,,5,1,1,0,1
12918_0,,,,2,2,1,3
C(C(CCO)(C(C(C)=O)C)O)=O,,,5,1,1,0,1
12920_0,,,,2,2,1,3
C(C)(C(C)C(C(CCO)=O)O)=O,,,5,1,1,0,1
12922_0,,,,2,2,1,3
C(C(CC(C)O)(C(C(C)=O)C)O)=O,,,5,1,1,0,1
12924_0,,,,2,2,1,3
C(C)(C(C)C(C(CC(C)O)=O)O)=O,,,5,1,1,0,1
12926_0,,,,2,2,1,3
C(C)(C(C)C(C=O)(CC(O)=O)O)=O,,,5,1,1,0,1
12928_0,,,,2,2,1,3
C(C)(C(C)C(C(CC(O)=O)=O)O)=O,,,5,1,1,0,1
12930_0,,,,2,2,1,3
C(C)(C(C)C(CCO)O)=O,,,5,1,2,0,2
12932_0,,,,2,2,1,3
C(C(CCO)(C(C(C)=O)C)O)(O)=O,,,5,1,1,0,1
12934_0,,,,2,2,1,3
C(C)(C(C)C(C(C)=O)(CC=O)O)=O,,,5,1,1,0,1
12936_0,,,,2,2,1,3
C(C(C)(C(C(C)=O)C)O)(CC=O)=O,,,5,1,1,0,1
12938_0,,,,2,2,1,3
C(C)(C(C)C(CC(C(C)=O)=O)O)=O,,,5,1,1,0,1
12940_0,,,,2,2,1,3
C(C)(C(C)C(C(C)=O)(C(C)O)O)=O,,,5,1,1,0,1
12942_0,,,,2,2,1,3
C(C(C)(C(C(C)=O)C)O)(C(C)O)=O,,,5,1,1,0,1
12944_0,,,,2,2,1,3
C(C(C(C)=O)(C(C(C)=O)C)O)(O)=O,,,5,1,1,0,1
12946_0,,,,2,2,1,3
C(C)(C(C)C(C(C(O)=O)=O)(C)O)=O,,,5,1,1,0,1
12948_0,,,,2,2,1,3
C(C)(C(C)C(C=O)O)=O,,,5,1,2,0,2
12950_0,,,,2,2,1,3
C(C(C(C(C(C)=O)C)O)O)=O,,,5,1,1,0,1
12952_0,,,,2,2,1,3
C(C(C(C(C(C)=O)C)O)O)(O)=O,,,5,1,1,0,1
12954_0,,,,2,2,1,3
C(C)(C(C)C(CO)(CO)O)=O,,,5,1,1,0,1
12956_0,,,,2,2,1,3
C(C)(C(C)C(C)(CO)O)=O,,,5,1,2,0,2
12958_0,,,,2,2,1,3
C(C(C(C(C(C)=O)C)O)(C)O)(O)=O,,,5,1,1,0,1
12960_0,,,,2,2,1,3
C(C(C)C(C)(C(C(C)=O)C)O)(O)=O,,,5,1,1,0,1
12962_0,,,,2,2,1,3
C(C)(C(C)C(C=CC)O)=O,,,5,1,2,0,2
12964_0,,,,2,2,1,3
C(C)(C(C)C(CC=C)O)=O,,,5,1,2,0,2
12966_0,,,,2,2,1,3
C(C(C=CC)(C(C(C)=O)C)O)(O)=O,,,5,1,1,0,1
12968_0,,,,2,2,1,3
C(C)(C(C)C(C(O)=O)(CC=C)O)=O,,,5,1,1,0,1
12970_0,,,,2,2,1,3
C(C)(C(C)C(CC(C(O)=O)=C)O)=O,,,5,1,1,0,1
12972_0,,,,2,2,1,3
C(C)(C(C)C(C=C(C(O)=O)C)O)=O,,,5,1,1,0,1
12974_0,,,,2,2,1,3
C(C)(C(C)C(C(CO)O)O)=O,,,5,1,1,0,1
12976_0,,,,2,2,1,3
C(C)(C(C)C(CO)O)=O,,,5,1,2,0,2
12978_0,,,,2,2,1,3
C1(C(CC(C)O1)(C(C(C)=O)C)O)=O,,,5,1,1,0,1
12980_0,,,,2,2,1,3
C(C)(C(C)C1(C(OC(C1)=O)=O)O)=O,,,5,1,1,0,1
12982_0,,,,2,2,1,3
C(C)(C(C)C(CC[CH]C(O)=O)O)=O,,,5,1,1,0,1
12984_0,,,,2,2,1,3
C(CCCC(C(C(C)=O)C)O)(O)=O,,,5,1,1,0,1
12986_0,,,,2,2,1,3
C(C)(C(C)C(C(C)O)O)=O,,,5,1,2,0,2
12988_0,,,,2,2,1,3
C(C)(C(C)C(C(O)=O)O)=O,,,5,1,2,0,2
12990_0,,,,2,2,1,3
C(C(C)(C(C(C)=O)C)O)(O)=O,,,5,1,1,0,1
12992_0,,,,2,2,1,3
C(CC(C)(C[CH]C(O)=O)O)(CC)=O,,,5,1,1,0,1
12994_0,,,,2,2,1,3
C(CCC(C)(CC(CC)=O)O)(O)=O,,,5,1,1,0,1
12996_0,,,,2,2,1,3
C(CC)(CC(C[CH]C(O)=O)O)=O,,,5,1,1,0,1
12998_0,,,,2,2,1,3
C(CCC(CC(CC)=O)O)(O)=O,,,5,1,1,0,1
13000_0,,,,2,2,1,3
C(CC(CC(C(C)O)=O)O)(CC)=O,,,5,1,1,0,1
13002_0,,,,2,2,1,3
C(CC(C(C)O)(CC(CC)=O)O)=O,,,5,1,1,0,1
13004_0,,,,2,2,1,3
C(CC(C)(C(C(C)=O)O)O)(CC)=O,,,5,1,1,0,1
13006_0,,,,2,2,1,3
C(CC(C(C)(CCO)O)O)(CC)=O,,,5,1,1,0,1
13008_0,,,,2,2,1,3
C(CC(C)(C(CCO)O)O)(CC)=O,,,5,1,1,0,1
13010_0,,,,2,2,1,3
C(CC(C(CO)(CO)O)O)(CC)=O,,,5,1,1,0,1
13012_0,,,,2,2,1,3
C(CC(C(C)(C(C)O)O)O)(CC)=O,,,5,1,1,0,1
13014_0,,,,2,2,1,3
C(CC(C(C)(CO)O)O)(CC)=O,,,5,1,1,0,1
13016_0,,,,2,2,1,3
C(CC(C(C(O)=O)=C)O)(CC)=O,,,5,1,1,0,1
13018_0,,,,2,2,1,3
C(C(C=O)CC(CC(CC)=O)O)=O,,,5,1,1,0,1
13020_0,,,,2,2,1,3
C(CC)(CC(C(C=O)CC=O)O)=O,,,5,1,1,0,1
13022_0,,,,2,2,1,3
C(CC)(CC(CC(C=O)=O)O)=O,,,5,1,1,0,1
13024_0,,,,2,2,1,3
C(CC(C(CC=O)=O)O)(CC)=O,,,5,1,1,0,1
13026_0,,,,2,2,1,3
C(CC(C=O)(CC=O)O)(CC)=O,,,5,1,1,0,1
13028_0,,,,2,2,1,3
C(CC(C)(CC(C=O)=O)O)(CC)=O,,,5,1,1,0,1
13030_0,,,,2,2,1,3
C(CC(C(CC(C)=O)=O)O)(CC)=O,,,5,1,1,0,1
13032_0,,,,2,2,1,3
C(CC(C=O)(CC(CC)=O)O)(C)=O,,,5,1,1,0,1
13034_0,,,,2,2,1,3
C(CC(C(C=O)=O)(CC)O)(CC)=O,,,5,1,1,0,1
13036_0,,,,2,2,1,3
C(CC(C(C(CC)=O)=O)O)(CC)=O,,,5,1,1,0,1
13038_0,,,,2,2,1,3
C(CC)(C(C=O)(CC(CC)=O)O)=O,,,5,1,1,0,1
13040_0,,,,2,2,1,3
C(CC(C(O)=O)(CC=O)O)(CC)=O,,,5,1,1,0,1
13042_0,,,,2,2,1,3
C(CC)(CC(CC(C(O)=O)=O)O)=O,,,5,1,1,0,1
13044_0,,,,2,2,1,3
C(C(C)C(CC(CC)=O)O)(O)=O,,,5,1,1,0,1
13046_0,,,,2,2,1,3
C(C(CC)(CC(CC)=O)O)(O)=O,,,5,1,1,0,1
13048_0,,,,2,2,1,3
C(CC(C)(C(C)O)O)(CC)=O,,,5,1,1,0,1
13050_0,,,,2,2,1,3
C(CC(CO)(CC)O)(CC)=O,,,5,1,1,0,1
13052_0,,,,2,2,1,3
C(CC(CC(CC)=O)O)=O,,,5,1,1,0,1
13054_0,,,,2,2,1,3
C(CC([CH]C(O)=O)O)(CC)=O,,,5,1,1,0,1
13056_0,,,,2,2,1,3
C(CC(C=CCC(C)O)O)(CC)=O,,,5,1,1,0,1
13058_0,,,,2,2,1,3
C(CC(CC=CC(C)O)O)(CC)=O,,,5,1,1,0,1
13060_0,,,,2,2,1,3
C(CC(C(C(C)O)=C)O)(CC)=O,,,5,1,1,0,1
13062_0,,,,2,2,1,3
C(CC(C(CO)=CC)O)(CC)=O,,,5,1,1,0,1
13064_0,,,,2,2,1,3
C(CC(C(C(C)O)=CC)O)(CC)=O,,,5,1,1,0,1
13066_0,,,,2,2,1,3
C(CC(C(C(O)=O)=CC)O)(CC)=O,,,5,1,1,0,1
13068_0,,,,2,2,1,3
C(CC(C=CCC(O)=O)O)(CC)=O,,,5,1,1,0,1
13070_0,,,,2,2,1,3
C(CC)(CC(CC=CC(O)=O)O)=O,,,5,1,1,0,1
13072_0,,,,2,2,1,3
C(CC(C=CC(CO)=O)O)(CC)=O,,,5,1,1,0,1
13074_0,,,,2,2,1,3
C(CC(C=CC=O)(CO)O)(CC)=O,,,5,1,1,0,1
13076_0,,,,2,2,1,3
C(CC(C=C(C=O)CO)O)(CC)=O,,,5,1,1,0,1
13078_0,,,,2,2,1,3
C(CC(C(CO)=CC=O)O)(CC)=O,,,5,1,1,0,1
13080_0,,,,2,2,1,3
C(CC(C(C(C=C)O)=O)O)(CC)=O,,,5,1,1,0,1
13082_0,,,,2,2,1,3
C(CC(C=O)(C(C=C)O)O)(CC)=O,,,5,1,1,0,1
13084_0,,,,2,2,1,3
C(C(C=C(C=O)C)(CC(CC)=O)O)=O,,,5,1,1,0,1
13086_0,,,,2,2,1,3
C(CC(C(C=C(C=O)C)=O)O)(CC)=O,,,5,1,1,0,1
13088_0,,,,2,2,1,3
C(CC(C(C)=CC(C=O)=O)O)(CC)=O,,,5,1,1,0,1
13090_0,,,,2,2,1,3
C(CC(C=O)(CC(C=O)=C)O)(CC)=O,,,5,1,1,0,1
13092_0,,,,2,2,1,3
C(CC(C(CC(C=O)=C)=O)O)(CC)=O,,,5,1,1,0,1
13094_0,,,,2,2,1,3
C(CC(C(CC(C=O)=O)=C)O)(CC)=O,,,5,1,1,0,1
13096_0,,,,2,2,1,3
C(CC(C=C(C=O)C)O)(CC)=O,,,5,1,1,0,1
13098_0,,,,2,2,1,3
C(CC(C(C)=CC=O)O)(CC)=O,,,5,1,1,0,1
13100_0,,,,2,2,1,3
C(CC)(CC(CC(C=O)=C)O)=O,,,5,1,1,0,1
13102_0,,,,2,2,1,3
C(CC(C(CC=O)=C)O)(CC)=O,,,5,1,1,0,1
13104_0,,,,2,2,1,3
C(C(C=CC(C)=O)(CC(CC)=O)O)=O,,,5,1,1,0,1
13106_0,,,,2,2,1,3
C(CC(C(C=CC(C)=O)=O)O)(CC)=O,,,5,1,1,0,1
13108_0,,,,2,2,1,3
C(CC(C=CC(C=O)=O)(C)O)(CC)=O,,,5,1,1,0,1
13110_0,,,,2,2,1,3
C(CC(C=CC(C)=O)O)(CC)=O,,,5,1,1,0,1
13112_0,,,,2,2,1,3
C(CC(C=CC=O)(C)O)(CC)=O,,,5,1,1,0,1
13114_0,,,,2,2,1,3
C(C(C=C)(CC(CC)=O)O)=O,,,5,1,1,0,1
13116_0,,,,2,2,1,3
C(CC(C(C=C)=O)O)(CC)=O,,,5,1,1,0,1
13118_0,,,,2,2,1,3
C(CC(C=O)(CC=C)O)(CC)=O,,,5,1,1,0,1
13120_0,,,,2,2,1,3
C(CC(C(CC=C)=O)O)(CC)=O,,,5,1,1,0,1
13122_0,,,,2,2,1,3
C(C(C=CC)(CC(CC)=O)O)=O,,,5,1,1,0,1
13124_0,,,,2,2,1,3
C(CC(C(C=CC)=O)O)(CC)=O,,,5,1,1,0,1
13126_0,,,,2,2,1,3
C(CC(C=C)O)(CC)=O,,,5,1,1,0,1
13128_0,,,,2,2,1,3
C(C(C=C)(CC(CC)=O)O)(O)=O,,,5,1,1,0,1
13130_0,,,,2,2,1,3
C(CC(C(C(O)=O)=C)(C)O)(CC)=O,,,5,1,1,0,1
13132_0,,,,2,2,1,3
C(CC(C(CC)O)O)(CC)=O,,,5,1,1,0,1
13134_0,,,,2,2,1,3
C(CC(CCCO)O)(CC)=O,,,5,1,1,0,1
13136_0,,,,2,2,1,3
C(CC1(C(O)OCC1O)O)(CC)=O,,,5,1,1,0,1
13138_0,,,,2,2,1,3
C(CC1(C(O)OCC1)O)(CC)=O,,,5,1,1,0,1
13140_0,,,,2,2,1,3
C(CC1(C(O)OC(C)C1)O)(CC)=O,,,5,1,1,0,1
13142_0,,,,2,2,1,3
C1(CC(C(O)O1)(CC(CC)=O)O)=O,,,5,1,1,0,1
13144_0,,,,2,2,1,3
C1(C(C(CO1)O)(CC(CC)=O)O)=O,,,5,1,1,0,1
13146_0,,,,2,2,1,3
C1(C(CCO1)(CC(CC)=O)O)=O,,,5,1,1,0,1
13148_0,,,,2,2,1,3
C(CC1(C(C(OC1)=O)=O)O)(CC)=O,,,5,1,1,0,1
13150_0,,,,2,2,1,3
C1(C(C(CO1)=O)(CC(CC)=O)O)=O,,,5,1,1,0,1
13152_0,,,,2,2,1,3
C(CC(CC(C)CO)O)(CC)=O,,,5,1,1,0,1
13154_0,,,,2,2,1,3
C(CC(CC(C)CCO)O)(CC)=O,,,5,1,1,0,1
13156_0,,,,2,2,1,3
C(CC(CC(C)C(C)O)O)(CC)=O,,,5,1,1,0,1
13158_0,,,,2,2,1,3
C(CC(C)CC(CC(CC)=O)O)=O,,,5,1,1,0,1
13160_0,,,,2,2,1,3
C(CC([C](C(O)=O)O)(C)O)(CC)=O,,,5,1,1,0,1
13162_0,,,,2,2,1,3
C(CC(C(CCO)O)O)(CC)=O,,,5,1,1,0,1
13164_0,,,,2,2,1,3
C(CC(C(O)O)O)(CC)=O,,,5,1,1,0,1
13166_0,,,,2,2,1,3
C(C(C(C)O)(CC(CC)=O)O)(O)=O,,,5,1,1,0,1
13168_0,,,,2,2,1,3
C(CC(C)O)(CC)=O,,,5,1,3,0,3
13170_0,,,,2,2,1,3
C(CC)(CC(O)=O)=O,,,5,1,3,0,3
13172_0,,,,2,2,1,3
C(CC(CC(C)O)O)(CC)=O,,,5,1,1,0,1
13174_0,,,,2,2,1,3
C(CC(CC(CC)=O)O)(O)=O,,,5,1,1,0,1
13176_0,,,,2,2,1,3
C(CC(C(CO)=O)O)(CC)=O,,,5,1,1,0,1
13178_0,,,,2,2,1,3
C(C(CO)(CC(CC)=O)O)=O,,,5,1,1,0,1
13180_0,,,,2,2,1,3
C(C(C)(CC(CC)=O)O)=O,,,5,1,3,0,3
13182_0,,,,2,2,1,3
C(CC(C(C)=O)O)(CC)=O,,,5,1,3,0,3
13184_0,,,,2,2,1,3
C(CC)(CCO)=O,,,5,1,3,0,3
13186_0,,,,2,2,1,3
C(C(CO)(CC(CC)=O)O)(O)=O,,,5,1,1,0,1
13188_0,,,,2,2,1,3
C(CC(C(CO)C(C)O)O)(CC)=O,,,5,1,1,0,1
13190_0,,,,2,2,1,3
C(C(CO)C(CC(CC)=O)O)(O)=O,,,5,1,1,0,1
13192_0,,,,2,2,1,3
C(CC(C(C(CO)O)=O)O)(CC)=O,,,5,1,1,0,1
13194_0,,,,2,2,1,3
C(C(C(CO)O)(CC(CC)=O)O)=O,,,5,1,1,0,1
13196_0,,,,2,2,1,3
C(C(C)(CC(CC(CC)=O)O)O)=O,,,5,1,1,0,1
13198_0,,,,2,2,1,3
C(CC(C)(C(CC(CC)=O)O)O)=O,,,5,1,1,0,1
13200_0,,,,2,2,1,3
C(CC(CC(C(C)=O)O)O)(CC)=O,,,5,1,1,0,1
13202_0,,,,2,2,1,3
C(CC(C(C)(CC(CC)=O)O)O)=O,,,5,1,1,0,1
13204_0,,,,2,2,1,3
C(C(CCO)(CC(CC)=O)O)=O,,,5,1,1,0,1
13206_0,,,,2,2,1,3
C(CC(C(CCO)=O)O)(CC)=O,,,5,1,1,0,1
13208_0,,,,2,2,1,3
C(C(CC(C)O)(CC(CC)=O)O)=O,,,5,1,1,0,1
13210_0,,,,2,2,1,3
C(CC(C(CC(C)O)=O)O)(CC)=O,,,5,1,1,0,1
13212_0,,,,2,2,1,3
C(CC(C=O)(CC(O)=O)O)(CC)=O,,,5,1,1,0,1
13214_0,,,,2,2,1,3
C(CC(C(CC(O)=O)=O)O)(CC)=O,,,5,1,1,0,1
13216_0,,,,2,2,1,3
C(CC(CCO)O)(CC)=O,,,5,1,3,0,3
13218_0,,,,2,2,1,3
C(C(CCO)(CC(CC)=O)O)(O)=O,,,5,1,1,0,1
13220_0,,,,2,2,1,3
C(CC(C(C)=O)(CC=O)O)(CC)=O,,,5,1,1,0,1
13222_0,,,,2,2,1,3
C(C(C)(CC(CC)=O)O)(CC=O)=O,,,5,1,1,0,1
13224_0,,,,2,2,1,3
C(CC)(CC(CC(C(C)=O)=O)O)=O,,,5,1,1,0,1
13226_0,,,,2,2,1,3
C(C)(C(C(C)O)(CC(CC)=O)O)=O,,,5,1,1,0,1
13228_0,,,,2,2,1,3
C(C(C)(CC(CC)=O)O)(C(C)O)=O,,,5,1,1,0,1
13230_0,,,,2,2,1,3
C(C)(C(C(O)=O)(CC(CC)=O)O)=O,,,5,1,1,0,1
13232_0,,,,2,2,1,3
C(CC(C(C(O)=O)=O)(C)O)(CC)=O,,,5,1,1,0,1
13234_0,,,,2,2,1,3
C(CC(C=O)O)(CC)=O,,,5,1,3,0,3
13236_0,,,,2,2,1,3
C(CC)(CC(C(C=O)O)O)=O,,,5,1,1,0,1
13238_0,,,,2,2,1,3
C(CC)(CC(C(C(O)=O)O)O)=O,,,5,1,1,0,1
13240_0,,,,2,2,1,3
C(CC(CO)(CO)O)(CC)=O,,,5,1,1,0,1
13242_0,,,,2,2,1,3
C(CC(C)(CO)O)(CC)=O,,,5,1,3,0,3
13244_0,,,,2,2,1,3
C(C(C)(C(CC(CC)=O)O)O)(O)=O,,,5,1,1,0,1
13246_0,,,,2,2,1,3
C(C(C)C(C)(CC(CC)=O)O)(O)=O,,,5,1,1,0,1
13248_0,,,,2,2,1,3
C(CC(C=CC)O)(CC)=O,,,5,1,3,0,3
13250_0,,,,2,2,1,3
C(CC)(CC(CC=C)O)=O,,,5,1,3,0,3
13252_0,,,,2,2,1,3
C(C(C=CC)(CC(CC)=O)O)(O)=O,,,5,1,1,0,1
13254_0,,,,2,2,1,3
C(CC(C(O)=O)(CC=C)O)(CC)=O,,,5,1,1,0,1
13256_0,,,,2,2,1,3
C(CC)(CC(CC(C(O)=O)=C)O)=O,,,5,1,1,0,1
13258_0,,,,2,2,1,3
C(CC(C=C(C(O)=O)C)O)(CC)=O,,,5,1,1,0,1
13260_0,,,,2,2,1,3
C(CC(C(CO)O)O)(CC)=O,,,5,1,1,0,1
13262_0,,,,2,2,1,3
C(CC(CO)O)(CC)=O,,,5,1,3,0,3
13264_0,,,,2,2,1,3
C1(C(CC(C)O1)(CC(CC)=O)O)=O,,,5,1,1,0,1
13266_0,,,,2,2,1,3
C(CC1(C(OC(C1)=O)=O)O)(CC)=O,,,5,1,1,0,1
13268_0,,,,2,2,1,3
C(CC(CC[CH]C(O)=O)O)(CC)=O,,,5,1,1,0,1
13270_0,,,,2,2,1,3
C(CCCC(CC(CC)=O)O)(O)=O,,,5,1,1,0,1
13272_0,,,,2,2,1,3
C(CC(C(C)O)O)(CC)=O,,,5,1,3,0,3
13274_0,,,,2,2,1,3
C(CC(C(O)=O)O)(CC)=O,,,5,1,3,0,3
13276_0,,,,2,2,1,3
C(C(C)(CC(CC)=O)O)(O)=O,,,5,1,1,0,1
13278_0,,,,2,2,1,3
C(C(C)(C(C)(CC=O)O)O)(O)=O,,,5,1,1,0,1
13280_0,,,,2,2,1,3
C(C(C)(C(C)(C(C=O)O)O)O)(O)=O,,,5,1,4,0,4
13280_1,,,,2,2,1,3
13282_0,,,,2,2,1,3
C(CC(C=C)O)(C(C(O)=O)(C)O)=O,,,5,1,1,0,1
13284_0,,,,2,2,1,3
C(C(C(CC(C)O)=O)(C)O)(O)=O,,,5,1,1,0,1
13285_0,,,,2,2,1,3
13287_0,,,,2,2,1,3
C(C(C(CCO)=O)(C)O)(O)=O,,,5,1,2,0,2
13289_0,,,,2,2,1,3
C(CC(C=O)O)(C(C(O)=O)(C)O)=O,,,5,1,1,0,1
13291_0,,,,2,2,1,3
C(C(C(CC(CO)O)=O)(C)O)(O)=O,,,5,1,1,0,1
13293_0,,,,2,2,1,3
C(CC(C(C)O)(CC=O)O)(O)=O,,,5,1,1,0,1
13295_0,,,,2,2,1,3
C(CC(C(C)O)(C(C=O)O)O)(O)=O,,,5,1,2,0,2
13295_1,,,,2,2,1,3
13297_0,,,,2,2,1,3
C(C(C)O)(C(C(O)=O)C(C=C)O)=O,,,5,1,2,0,2
13297_1,,,,2,2,1,3
13299_0,,,,2,2,1,3
C(C(C(C(C)O)=O)C(C)O)(O)=O,,,5,1,5,0,5
13299_1,,,,2,2,1,3
13301_0,,,,2,2,1,3
C(C(C(O)=O)C(C(C)O)=O)(O)=O,,,5,1,5,0,5
13301_1,,,,2,2,1,3
13303_0,,,,2,2,1,3
C(C(C(C(C)O)=O)CO)(O)=O,,,5,1,5,0,5
13303_1,,,,2,2,1,3
13305_0,,,,2,2,1,3
C(C(C)O)(C(C(O)=O)C(C=O)O)=O,,,5,1,2,0,2
13305_1,,,,2,2,1,3
13307_0,,,,2,2,1,3
C(C(C(C(C)O)=O)C(CO)O)(O)=O,,,5,1,2,0,2
13307_1,,,,2,2,1,3
13309_0,,,,2,2,1,3
C(C(C)C(CO)(CC=O)O)(O)=O,,,5,1,2,0,2
13311_0,,,,2,2,1,3
C(C(C)C(CO)(C(C=O)O)O)(O)=O,,,5,1,3,0,3
13311_1,,,,2,2,1,3
13313_0,,,,2,2,1,3
C(C(C(C(C(C=C)O)O)=O)C)(O)=O,,,5,1,2,0,2
13313_1,,,,2,2,1,3
13315_0,,,,2,2,1,3
C(C(C(C(C(C)O)O)=O)C)(O)=O,,,5,1,2,0,2
13315_1,,,,2,2,1,3
13316_0,,,,2,2,1,3
13316_1,,,,2,2,1,3
13318_0,,,,2,2,1,3
C(C(C(C(CO)O)=O)C)(O)=O,,,5,1,4,0,4
13318_1,,,,2,2,1,3
13320_0,,,,2,2,1,3
C(C(C(C(C(C=O)O)O)=O)C)(O)=O,,,5,1,2,0,2
13320_1,,,,2,2,1,3
13322_0,,,,2,2,1,3
C(C(C(C(C(CO)O)O)=O)C)(O)=O,,,5,1,2,0,2
13322_1,,,,2,2,1,3
13324_0,,,,2,2,1,3
C(CC(CC)(C(C(O)=O)O)O)=O,,,5,1,1,0,1
13326_0,,,,2,2,1,3
C(C(C(CC)(C(C=O)O)O)O)(O)=O,,,5,1,2,0,2
13326_1,,,,2,2,1,3
13328_0,,,,2,2,1,3
C(C(C)C(C=C)O)(C(C(O)=O)O)=O,,,5,1,1,0,1
13330_0,,,,2,2,1,3
C(C(C(C(C)C(C)O)=O)O)(O)=O,,,5,1,1,0,1
13331_0,,,,2,2,1,3
13333_0,,,,2,2,1,3
C(C(C(C(CO)C)=O)O)(O)=O,,,5,1,1,0,1
13335_0,,,,2,2,1,3
C(C(C)C(C=O)O)(C(C(O)=O)O)=O,,,5,1,1,0,1
13337_0,,,,2,2,1,3
C(C(C(C(C)C(CO)O)=O)O)(O)=O,,,5,1,1,0,1
13339_0,,,,2,2,1,3
C(C(CC=O)(CC(CO)=O)O)(O)=O,,,5,1,2,0,2
13341_0,,,,2,2,1,3
C(CC(CO)(CC(C(O)=O)=O)O)=O,,,5,1,1,0,1
13343_0,,,,2,2,1,3
C(CO)(C(C(C(O)=O)=O)C(C)O)=O,,,5,1,3,0,3
13343_1,,,,2,2,1,3
13345_0,,,,2,2,1,3
C(C(C(CO)=O)C(C(O)=O)=O)(O)=O,,,5,1,3,0,3
13345_1,,,,2,2,1,3
13347_0,,,,2,2,1,3
C(CO)(C(C(C(O)=O)=O)CO)=O,,,5,1,5,0,5
13347_1,,,,2,2,1,3
13349_0,,,,2,2,1,3
C(C(C(C)O)O)(CC(C(O)=O)=O)=O,,,5,1,2,0,2
13349_1,,,,2,2,1,3
13351_0,,,,2,2,1,3
C(C(C(CC(C(O)=O)=O)=O)O)(O)=O,,,5,1,2,0,2
13351_1,,,,2,2,1,3
13352_0,,,,2,2,1,3
13352_1,,,,2,2,1,3
13354_0,,,,2,2,1,3
C(C(C=O)C(C)(C[CH]C(O)=O)O)=O,,,5,1,2,0,2
13354_1,,,,2,2,1,3
13355_0,,,,2,2,1,3
13356_0,,,,2,2,1,3
13357_0,,,,2,2,1,3
13357_1,,,,2,2,1,3
13359_0,,,,2,2,1,3
C(CO)(CC(C)(C[CH]C(O)=O)O)=O,,,5,1,3,0,3
13361_0,,,,2,2,1,3
C(C)(C(C(C)(C[CH]C(O)=O)O)O)=O,,,5,1,3,0,3
13361_1,,,,2,2,1,3
13363_0,,,,2,2,1,3
C(C(C=C)C(C)(C[CH]C(O)=O)O)=O,,,5,1,2,0,2
13365_0,,,,2,2,1,3
C(C(C(C)(C[CH]C(O)=O)O)O)=O,,,5,1,3,0,3
13365_1,,,,2,2,1,3
13367_0,,,,2,2,1,3
C(CC(C(C(C)=O)[CH]C(O)=O)O)=O,,,5,1,1,0,1
13369_0,,,,2,2,1,3
C(C(C=C)(C(C(C)=O)[CH]C(O)=O)O)=O,,,5,1,1,0,1
13371_0,,,,2,2,1,3
C(C)(C([CH]C(O)=O)C(C(C=C)=O)O)=O,,,5,1,1,0,1
13373_0,,,,2,2,1,3
C(C)(C([CH]C(O)=O)C(C=C)O)=O,,,5,1,1,0,1
13375_0,,,,2,2,1,3
C(C)(C([CH]C(O)=O)C(C(O)O)O)=O,,,5,1,1,0,1
13377_0,,,,2,2,1,3
C(C)(C([CH]C(O)=O)C(C)O)=O,,,5,1,1,0,1
13379_0,,,,2,2,1,3
C(C(C(C)=O)[CH]C(O)=O)(O)=O,,,5,1,1,0,1
13381_0,,,,2,2,1,3
C(C(C)(C(C(C)=O)[CH]C(O)=O)O)=O,,,5,1,1,0,1
13383_0,,,,2,2,1,3
C(C)(C([CH]C(O)=O)C(C(C)=O)O)=O,,,5,1,1,0,1
13385_0,,,,2,2,1,3
C(C)(C([CH]C(O)=O)CO)=O,,,5,1,1,0,1
13387_0,,,,2,2,1,3
C(C)(C([CH]C(O)=O)C(CCO)O)=O,,,5,1,1,0,1
13389_0,,,,2,2,1,3
C(C(C(C(C)=O)[CH]C(O)=O)O)=O,,,5,1,1,0,1
13391_0,,,,2,2,1,3
C(C)(C([CH]C(O)=O)C(C)(CO)O)=O,,,5,1,1,0,1
13393_0,,,,2,2,1,3
C(C)(C([CH]C(O)=O)C(C=CC)O)=O,,,5,1,1,0,1
13395_0,,,,2,2,1,3
C(C)(C([CH]C(O)=O)C(CC=C)O)=O,,,5,1,1,0,1
13397_0,,,,2,2,1,3
C(C)(C([CH]C(O)=O)C(CO)O)=O,,,5,1,1,0,1
13399_0,,,,2,2,1,3
C(C)(C([CH]C(O)=O)C(C(C)O)O)=O,,,5,1,1,0,1
13401_0,,,,2,2,1,3
C(C(C(C(C)=O)[CH]C(O)=O)O)(O)=O,,,5,1,1,0,1
13403_0,,,,2,2,1,3
C(CC(CC(C[CH]C(O)=O)=O)O)=O,,,5,1,1,0,1
13405_0,,,,2,2,1,3
C(C(C=C)(CC(C[CH]C(O)=O)=O)O)=O,,,5,1,1,0,1
13407_0,,,,2,2,1,3
C(CC(C(C=C)=O)O)(C[CH]C(O)=O)=O,,,5,1,1,0,1
13409_0,,,,2,2,1,3
C(CC(C=C)O)(C[CH]C(O)=O)=O,,,5,1,1,0,1
13411_0,,,,2,2,1,3
C(CC(C(O)O)O)(C[CH]C(O)=O)=O,,,5,1,1,0,1
13413_0,,,,2,2,1,3
C(CC(C)O)(C[CH]C(O)=O)=O,,,5,1,2,0,2
13414_0,,,,2,2,1,3
13416_0,,,,2,2,1,3
C(C(C)(CC(C[CH]C(O)=O)=O)O)=O,,,5,1,1,0,1
13418_0,,,,2,2,1,3
C(CC(C(C)=O)O)(C[CH]C(O)=O)=O,,,5,1,1,0,1
13420_0,,,,2,2,1,3
C(CCO)(C[CH]C(O)=O)=O,,,5,1,1,0,1
13422_0,,,,2,2,1,3
C(CC(CCO)O)(C[CH]C(O)=O)=O,,,5,1,1,0,1
13424_0,,,,2,2,1,3
C(C(CC(C[CH]C(O)=O)=O)O)=O,,,5,1,1,0,1
13426_0,,,,2,2,1,3
C(CC(C)(CO)O)(C[CH]C(O)=O)=O,,,5,1,1,0,1
13428_0,,,,2,2,1,3
C(CC(C=CC)O)(C[CH]C(O)=O)=O,,,5,1,1,0,1
13430_0,,,,2,2,1,3
C(CC(CC=C)O)(C[CH]C(O)=O)=O,,,5,1,1,0,1
13432_0,,,,2,2,1,3
C(CC(CO)O)(C[CH]C(O)=O)=O,,,5,1,1,0,1
13434_0,,,,2,2,1,3
C(CC(C(C)O)O)(C[CH]C(O)=O)=O,,,5,1,1,0,1
13436_0,,,,2,2,1,3
C(C(CC(C[CH]C(O)=O)=O)O)(O)=O,,,5,1,1,0,1
13438_0,,,,2,2,1,3
C(C(C=O)C(C)(CCC(O)=O)O)=O,,,5,1,2,0,2
13438_1,,,,2,2,1,3
13439_0,,,,2,2,1,3
13440_0,,,,2,2,1,3
13441_0,,,,2,2,1,3
13441_1,,,,2,2,1,3
13443_0,,,,2,2,1,3
C(CCC(C)(CC(CO)=O)O)(O)=O,,,5,1,3,0,3
13445_0,,,,2,2,1,3
C(CCC(C)(C(C(C)=O)O)O)(O)=O,,,5,1,3,0,3
13445_1,,,,2,2,1,3
13447_0,,,,2,2,1,3
C(C(C=C)C(C)(CCC(O)=O)O)=O,,,5,1,2,0,2
13449_0,,,,2,2,1,3
C(CCC(C)(C(C=O)O)O)(O)=O,,,5,1,3,0,3
13449_1,,,,2,2,1,3
13451_0,,,,2,2,1,3
C(C)(C(C(CC=O)O)CC(O)=O)=O,,,5,1,1,0,1
13453_0,,,,2,2,1,3
C(CC(C(C)=O)C(C=C)O)(O)=O,,,5,1,1,0,1
13455_0,,,,2,2,1,3
C(C)(C(C(C(O)O)O)CC(O)=O)=O,,,5,1,1,0,1
13457_0,,,,2,2,1,3
C(C)(C(C(C)O)CC(O)=O)=O,,,5,1,1,0,1
13459_0,,,,2,2,1,3
C(C(C(C)=O)CC(O)=O)(O)=O,,,5,1,2,0,2
13461_0,,,,2,2,1,3
C(CC(C(C)=O)C(C=O)(C)O)(O)=O,,,5,1,1,0,1
13463_0,,,,2,2,1,3
C(CC(C(C)=O)C(C(C)=O)O)(O)=O,,,5,1,1,0,1
13465_0,,,,2,2,1,3
C(C)(C(CO)CC(O)=O)=O,,,5,1,1,0,1
13467_0,,,,2,2,1,3
C(C)(C(C(CCO)O)CC(O)=O)=O,,,5,1,1,0,1
13469_0,,,,2,2,1,3
C(CC(C(C)=O)C(C=O)O)(O)=O,,,5,1,1,0,1
13471_0,,,,2,2,1,3
C(C)(C(C(C)(CO)O)CC(O)=O)=O,,,5,1,1,0,1
13473_0,,,,2,2,1,3
C(CC(C(C)=O)C(C=CC)O)(O)=O,,,5,1,1,0,1
13475_0,,,,2,2,1,3
C(C)(C(C(CC=C)O)CC(O)=O)=O,,,5,1,1,0,1
13477_0,,,,2,2,1,3
C(C)(C(C(CO)O)CC(O)=O)=O,,,5,1,1,0,1
13479_0,,,,2,2,1,3
C(C)(C(C(C(C)O)O)CC(O)=O)=O,,,5,1,1,0,1
13481_0,,,,2,2,1,3
C(CC(C(C)=O)C(C(O)=O)O)(O)=O,,,5,1,1,0,1
13483_0,,,,2,2,1,3
C(CC(CC(CCC(O)=O)=O)O)=O,,,5,1,1,0,1
13485_0,,,,2,2,1,3
C(CCC(CC(C=C)O)=O)(O)=O,,,5,1,1,0,1
13487_0,,,,2,2,1,3
C(CCC(O)=O)(CC(C(O)O)O)=O,,,5,1,1,0,1
13489_0,,,,2,2,1,3
C(CCC(O)=O)(CC(C)O)=O,,,5,1,2,0,2
13490_0,,,,2,2,1,3
13492_0,,,,2,2,1,3
C(C(C)(CC(CCC(O)=O)=O)O)=O,,,5,1,1,0,1
13494_0,,,,2,2,1,3
C(CCC(CC(C(C)=O)O)=O)(O)=O,,,5,1,1,0,1
13496_0,,,,2,2,1,3
C(CCC(O)=O)(CCO)=O,,,5,1,1,0,1
13498_0,,,,2,2,1,3
C(CCC(O)=O)(CC(CCO)O)=O,,,5,1,1,0,1
13500_0,,,,2,2,1,3
C(CCC(CC(C=O)O)=O)(O)=O,,,5,1,1,0,1
13502_0,,,,2,2,1,3
C(CCC(O)=O)(CC(C)(CO)O)=O,,,5,1,1,0,1
13504_0,,,,2,2,1,3
C(CCC(CC(C=CC)O)=O)(O)=O,,,5,1,1,0,1
13506_0,,,,2,2,1,3
C(CCC(O)=O)(CC(CC=C)O)=O,,,5,1,1,0,1
13508_0,,,,2,2,1,3
C(CCC(O)=O)(CC(CO)O)=O,,,5,1,1,0,1
13510_0,,,,2,2,1,3
C(CCC(O)=O)(CC(C(C)O)O)=O,,,5,1,1,0,1
13512_0,,,,2,2,1,3
C(CCC(CC(C(O)=O)O)=O)(O)=O,,,5,1,1,0,1
13514_0,,,,2,2,1,3
C(C(C)O)(CC(C[CH]C(O)=O)O)=O,,,5,1,1,0,1
13516_0,,,,2,2,1,3
C(C(C(C[CH]C(O)=O)O)O)(CC)=O,,,5,1,2,0,2
13516_1,,,,2,2,1,3
13518_0,,,,2,2,1,3
C(CO)(C(C)C(C[CH]C(O)=O)O)=O,,,5,1,1,0,1
13520_0,,,,2,2,1,3
C(C(C=O)C(C[CH]C(O)=O)O)=O,,,5,1,2,0,2
13520_1,,,,2,2,1,3
13522_0,,,,2,2,1,3
C(C(C(C=O)=C)C(C[CH]C(O)=O)O)=O,,,5,1,1,0,1
13524_0,,,,2,2,1,3
[CH](C(O)=O)CC(CC(C=CC=O)=O)O,,,5,1,1,0,1
13526_0,,,,2,2,1,3
C=CC(C(C=O)=O)C(C[CH]C(O)=O)O,,,5,1,1,0,1
13528_0,,,,2,2,1,3
C(C(C(C[CH]C(O)=O)O)CCO)=O,,,5,1,1,0,1
13529_0,,,,2,2,1,3
13530_0,,,,2,2,1,3
13530_1,,,,2,2,1,3
13531_0,,,,2,2,1,3
13531_1,,,,2,2,1,3
13532_0,,,,2,2,1,3
13532_1,,,,2,2,1,3
13533_0,,,,2,2,1,3
13535_0,,,,2,2,1,3
C(C(CO)C(C[CH]C(O)=O)O)=O,,,5,1,5,0,5
13535_1,,,,2,2,1,3
13537_0,,,,2,2,1,3
C(CO)(C(C(C[CH]C(O)=O)O)O)=O,,,5,1,4,0,4
13537_1,,,,2,2,1,3
13539_0,,,,2,2,1,3
C(CO)(CC(C[CH]C(O)=O)O)=O,,,5,1,3,0,3
13541_0,,,,2,2,1,3
C(C)(C(C(C[CH]C(O)=O)O)O)=O,,,5,1,3,0,3
13541_1,,,,2,2,1,3
13543_0,,,,2,2,1,3
C(C(C=C)C(C[CH]C(O)=O)O)=O,,,5,1,3,0,3
13544_0,,,,2,2,1,3
13544_1,,,,2,2,1,3
13545_0,,,,2,2,1,3
13547_0,,,,2,2,1,3
C(C([CH]C(O)=O)C(C)(C(C)O)O)=O,,,5,1,1,0,1
13549_0,,,,2,2,1,3
C(C([CH]C(O)=O)C(CO)(CC)O)=O,,,5,1,1,0,1
13551_0,,,,2,2,1,3
C(C([CH]C(O)=O)C(CC=O)O)=O,,,5,1,1,0,1
13553_0,,,,2,2,1,3
C(C([CH]C(O)=O)C([CH]C(O)=O)O)=O,,,5,1,1,0,1
13555_0,,,,2,2,1,3
C(C([CH]C(O)=O)C(C=C(C=O)C)O)=O,,,5,1,1,0,1
13557_0,,,,2,2,1,3
C(C([CH]C(O)=O)C(C(C)=CC=O)O)=O,,,5,1,1,0,1
13559_0,,,,2,2,1,3
C(C([CH]C(O)=O)C(CC(C=O)=C)O)=O,,,5,1,1,0,1
13561_0,,,,2,2,1,3
C(C([CH]C(O)=O)C(C(CC=O)=C)O)=O,,,5,1,1,0,1
13563_0,,,,2,2,1,3
C(C([CH]C(O)=O)C(C=CC(C)=O)O)=O,,,5,1,1,0,1
13565_0,,,,2,2,1,3
C(C([CH]C(O)=O)C(C=CC=O)(C)O)=O,,,5,1,1,0,1
13567_0,,,,2,2,1,3
C(C([CH]C(O)=O)C(C=O)(C=C)O)=O,,,5,1,1,0,1
13569_0,,,,2,2,1,3
C(C([CH]C(O)=O)C(C(C=C)=O)O)=O,,,5,1,1,0,1
13571_0,,,,2,2,1,3
C(C([CH]C(O)=O)C(C=O)(CC=C)O)=O,,,5,1,1,0,1
13573_0,,,,2,2,1,3
C(C([CH]C(O)=O)C(C(CC=C)=O)O)=O,,,5,1,1,0,1
13575_0,,,,2,2,1,3
C(C([CH]C(O)=O)C(C=O)(C=CC)O)=O,,,5,1,1,0,1
13577_0,,,,2,2,1,3
C(C([CH]C(O)=O)C(C(C=CC)=O)O)=O,,,5,1,1,0,1
13579_0,,,,2,2,1,3
C(C([CH]C(O)=O)C(C=C)O)=O,,,5,1,1,0,1
13581_0,,,,2,2,1,3
C(C([CH]C(O)=O)C(C(CC)O)O)=O,,,5,1,1,0,1
13583_0,,,,2,2,1,3
C(C([CH]C(O)=O)C(CCCO)O)=O,,,5,1,1,0,1
13585_0,,,,2,2,1,3
C(C([CH]C(O)=O)C(C(O)O)O)=O,,,5,1,1,0,1
13587_0,,,,2,2,1,3
C(C([CH]C(O)=O)C(C)O)=O,,,5,1,1,0,1
13589_0,,,,2,2,1,3
C(C(C(O)=O)[CH]C(O)=O)=O,,,5,1,1,0,1
13591_0,,,,2,2,1,3
C(C([CH]C(O)=O)C(CC(C)O)O)=O,,,5,1,1,0,1
13593_0,,,,2,2,1,3
C(C([CH]C(O)=O)C(CC(O)=O)O)=O,,,5,1,1,0,1
13595_0,,,,2,2,1,3
C(C([CH]C(O)=O)C(C(CO)=O)O)=O,,,5,1,1,0,1
13597_0,,,,2,2,1,3
C(C([CH]C(O)=O)C(C=O)(CO)O)=O,,,5,1,1,0,1
13599_0,,,,2,2,1,3
C(C([CH]C(O)=O)C(C=O)(C)O)=O,,,5,1,1,0,1
13601_0,,,,2,2,1,3
C(C([CH]C(O)=O)C(C(C)=O)O)=O,,,5,1,1,0,1
13603_0,,,,2,2,1,3
C(C([CH]C(O)=O)CO)=O,,,5,1,1,0,1
13605_0,,,,2,2,1,3
C(C([CH]C(O)=O)C(CCO)O)=O,,,5,1,1,0,1
13607_0,,,,2,2,1,3
C(C([CH]C(O)=O)C(C=O)O)=O,,,5,1,1,0,1
13609_0,,,,2,2,1,3
C(C([CH]C(O)=O)C(C(C=O)O)O)=O,,,5,1,1,0,1
13611_0,,,,2,2,1,3
C(C([CH]C(O)=O)C(CO)(CO)O)=O,,,5,1,1,0,1
13613_0,,,,2,2,1,3
C(C([CH]C(O)=O)C(C)(CO)O)=O,,,5,1,1,0,1
13615_0,,,,2,2,1,3
C(C([CH]C(O)=O)C(C=CC)O)=O,,,5,1,1,0,1
13617_0,,,,2,2,1,3
C(C([CH]C(O)=O)C(CC=C)O)=O,,,5,1,1,0,1
13619_0,,,,2,2,1,3
C(C([CH]C(O)=O)C(C(CO)O)O)=O,,,5,1,1,0,1
13621_0,,,,2,2,1,3
C(C([CH]C(O)=O)C(CO)O)=O,,,5,1,1,0,1
13623_0,,,,2,2,1,3
C(C([CH]C(O)=O)C(C(C)O)O)=O,,,5,1,1,0,1
13625_0,,,,2,2,1,3
C(C([CH]C(O)=O)C(C(O)=O)O)=O,,,5,1,1,0,1
13627_0,,,,2,2,1,3
C(C([CH]C(O)=O)C(C(O)=O)(C)O)=O,,,5,1,1,0,1
13629_0,,,,2,2,1,3
C(CCC(CC(C(C)O)=O)O)(O)=O,,,5,1,1,0,1
13631_0,,,,2,2,1,3
C(CCC(C(C(CC)=O)O)O)(O)=O,,,5,1,2,0,2
13631_1,,,,2,2,1,3
13633_0,,,,2,2,1,3
C(CCC(C(C(CO)=O)C)O)(O)=O,,,5,1,1,0,1
13635_0,,,,2,2,1,3
C(C(C=O)C(CCC(O)=O)O)=O,,,5,1,2,0,2
13635_1,,,,2,2,1,3
13637_0,,,,2,2,1,3
C(C(CCO)C(CCC(O)=O)O)=O,,,5,1,1,0,1
13638_0,,,,2,2,1,3
13639_0,,,,2,2,1,3
13639_1,,,,2,2,1,3
13640_0,,,,2,2,1,3
13640_1,,,,2,2,1,3
13641_0,,,,2,2,1,3
13641_1,,,,2,2,1,3
13642_0,,,,2,2,1,3
13644_0,,,,2,2,1,3
C(C(CO)C(CCC(O)=O)O)=O,,,5,1,5,0,5
13644_1,,,,2,2,1,3
13646_0,,,,2,2,1,3
C(CCC(C(C(CO)=O)O)O)(O)=O,,,5,1,4,0,4
13646_1,,,,2,2,1,3
13648_0,,,,2,2,1,3
C(CCC(CC(CO)=O)O)(O)=O,,,5,1,3,0,3
13650_0,,,,2,2,1,3
C(CCC(C(C(C)=O)O)O)(O)=O,,,5,1,3,0,3
13650_1,,,,2,2,1,3
13652_0,,,,2,2,1,3
C(C(C=C)C(CCC(O)=O)O)=O,,,5,1,3,0,3
13653_0,,,,2,2,1,3
13653_1,,,,2,2,1,3
13654_0,,,,2,2,1,3
13656_0,,,,2,2,1,3
C(C(C(C)(C(C)O)O)CC(O)=O)=O,,,5,1,1,0,1
13658_0,,,,2,2,1,3
C(C(C(CO)(CC)O)CC(O)=O)=O,,,5,1,1,0,1
13660_0,,,,2,2,1,3
C(CC(C(C=O)CC(O)=O)O)=O,,,5,1,1,0,1
13662_0,,,,2,2,1,3
C(CC(C=O)C([CH]C(O)=O)O)(O)=O,,,5,1,1,0,1
13664_0,,,,2,2,1,3
C(C(C=C)(C(C=O)CC(O)=O)O)=O,,,5,1,1,0,1
13666_0,,,,2,2,1,3
C(CC(C=O)C(C(C=C)=O)O)(O)=O,,,5,1,1,0,1
13668_0,,,,2,2,1,3
C(CC(C=O)C(C=C)O)(O)=O,,,5,1,1,0,1
13670_0,,,,2,2,1,3
C(C(C(C(CC)O)O)CC(O)=O)=O,,,5,1,1,0,1
13672_0,,,,2,2,1,3
C(C(C(CCCO)O)CC(O)=O)=O,,,5,1,1,0,1
13674_0,,,,2,2,1,3
C(C(C(C(O)O)O)CC(O)=O)=O,,,5,1,1,0,1
13676_0,,,,2,2,1,3
C(C(C(C)O)CC(O)=O)=O,,,5,1,1,0,1
13678_0,,,,2,2,1,3
C(C(C(O)=O)CC(O)=O)=O,,,5,1,3,0,3
13680_0,,,,2,2,1,3
C(C(C(CC(C)O)O)CC(O)=O)=O,,,5,1,1,0,1
13682_0,,,,2,2,1,3
C(CC(C(C=O)CC(O)=O)O)(O)=O,,,5,1,1,0,1
13684_0,,,,2,2,1,3
C(CC(C=O)C(C(CO)=O)O)(O)=O,,,5,1,1,0,1
13686_0,,,,2,2,1,3
C(CC(C=O)C(C=O)(CO)O)(O)=O,,,5,1,1,0,1
13688_0,,,,2,2,1,3
C(CC(C=O)C(C=O)(C)O)(O)=O,,,5,1,1,0,1
13690_0,,,,2,2,1,3
C(CC(C=O)C(C(C)=O)O)(O)=O,,,5,1,1,0,1
13692_0,,,,2,2,1,3
C(C(CO)CC(O)=O)=O,,,5,1,1,0,1
13694_0,,,,2,2,1,3
C(C(C(CCO)O)CC(O)=O)=O,,,5,1,1,0,1
13696_0,,,,2,2,1,3
C(CC(C=O)C(C=O)O)(O)=O,,,5,1,1,0,1
13698_0,,,,2,2,1,3
C(C(C(C(C=O)CC(O)=O)O)O)=O,,,5,1,1,0,1
13700_0,,,,2,2,1,3
C(C(C(CO)(CO)O)CC(O)=O)=O,,,5,1,1,0,1
13702_0,,,,2,2,1,3
C(C(C(C)(CO)O)CC(O)=O)=O,,,5,1,1,0,1
13704_0,,,,2,2,1,3
C(CC(C=O)C(C=CC)O)(O)=O,,,5,1,1,0,1
13706_0,,,,2,2,1,3
C(C(C(CC=C)O)CC(O)=O)=O,,,5,1,1,0,1
13708_0,,,,2,2,1,3
C(C(C(C(CO)O)O)CC(O)=O)=O,,,5,1,1,0,1
13710_0,,,,2,2,1,3
C(C(C(CO)O)CC(O)=O)=O,,,5,1,1,0,1
13712_0,,,,2,2,1,3
C(C(C(C(C)O)O)CC(O)=O)=O,,,5,1,1,0,1
13714_0,,,,2,2,1,3
C(CC(C=O)C(C(O)=O)O)(O)=O,,,5,1,1,0,1
13716_0,,,,2,2,1,3
C(CC(C=O)C(C(O)=O)(C)O)(O)=O,,,5,1,1,0,1
13718_0,,,,2,2,1,3
C(C(CO)O)(C(C(C=O)=O)CO)=O,,,5,1,3,0,3
13718_1,,,,2,2,1,3
13719_0,,,,2,2,1,3
13720_0,,,,2,2,1,3
13720_1,,,,2,2,1,3
13722_0,,,,2,2,1,3
C(CC(C(CO)O)(CC=O)O)=O,,,5,1,2,0,2
13724_0,,,,2,2,1,3
C(CC(C(CO)O)(C(C=O)O)O)=O,,,5,1,4,0,4
13724_1,,,,2,2,1,3
13726_0,,,,2,2,1,3
C(C(CO)O)(C(C=O)C(C=C)O)=O,,,5,1,2,0,2
13726_1,,,,2,2,1,3
13727_0,,,,2,2,1,3
13727_1,,,,2,2,1,3
13728_0,,,,2,2,1,3
13728_1,,,,2,2,1,3
13730_0,,,,2,2,1,3
C(C(C(C(CO)O)=O)CO)=O,,,5,1,5,0,5
13730_1,,,,2,2,1,3
13732_0,,,,2,2,1,3
C(C(CO)O)(C(C=O)C(C=O)O)=O,,,5,1,4,0,4
13732_1,,,,2,2,1,3
13734_0,,,,2,2,1,3
C(C(C(C(CO)O)=O)C(CO)O)=O,,,5,1,4,0,4
13734_1,,,,2,2,1,3
13736_0,,,,2,2,1,3
C(C(C(C(C(CCO)=O)O)=O)O)=O,,,5,1,2,0,2
13738_0,,,,2,2,1,3
C(CC(C(C)O)(C(C=O)O)O)=O,,,5,1,4,0,4
13740_0,,,,2,2,1,3
C(C(C(C(C)O)(C(C=O)O)O)O)=O,,,5,1,5,0,5
13740_1,,,,2,2,1,3
13742_0,,,,2,2,1,3
C(CC(C(C(C(C)O)=O)O)O)=O,,,5,1,2,0,2
13744_0,,,,2,2,1,3
C(C(C(C(C(C(C)O)=O)O)O)O)=O,,,5,1,4,0,4
13744_1,,,,2,2,1,3
13746_0,,,,2,2,1,3
C(C(CC=O)(C(C=O)O)O)(O)=O,,,5,1,6,0,6
13748_0,,,,2,2,1,3
C(C(C(C=O)O)(C(C=O)O)O)(O)=O,,,5,1,7,0,7
13748_1,,,,2,2,1,3
13750_0,,,,2,2,1,3
C(CC(C(C(C(O)=O)=O)O)O)=O,,,5,1,6,0,6
13751_0,,,,2,2,1,3
13751_1,,,,2,2,1,3
13753_0,,,,2,2,1,3
C(CC(C=O)(CC=O)O)(C(C)O)=O,,,5,1,3,0,3
13755_0,,,,2,2,1,3
C(CC(C(CC(C(C)O)=O)=O)O)=O,,,5,1,2,0,2
13757_0,,,,2,2,1,3
C(CC(C(C)O)(CC(C=O)=O)O)=O,,,5,1,2,0,2
13759_0,,,,2,2,1,3
C(C(C)O)(C(C(C=O)=O)C(C)O)=O,,,5,1,3,0,3
13759_1,,,,2,2,1,3
13761_0,,,,2,2,1,3
C(C(C(C(C)O)=O)C(C=O)=O)(O)=O,,,5,1,3,0,3
13761_1,,,,2,2,1,3
13763_0,,,,2,2,1,3
C(C(C)O)(C(C(C=O)=O)CO)=O,,,5,1,5,0,5
13763_1,,,,2,2,1,3
13765_0,,,,2,2,1,3
C(C(C=O)C(CC(C(C)O)=O)O)=O,,,5,1,2,0,2
13765_1,,,,2,2,1,3
13767_0,,,,2,2,1,3
C(CC(CC(C(C)O)=O)O)=O,,,5,1,3,0,3
13769_0,,,,2,2,1,3
C(C(C)O)(CC(CC(C=O)=O)O)=O,,,5,1,3,0,3
13771_0,,,,2,2,1,3
C(C(C(CC(C(C)O)=O)O)CO)=O,,,5,1,3,0,3
13771_1,,,,2,2,1,3
13773_0,,,,2,2,1,3
C(C(C)O)(CC(CC(CO)=O)O)=O,,,5,1,2,0,2
13774_0,,,,2,2,1,3
13774_1,,,,2,2,1,3
13776_0,,,,2,2,1,3
C(C(C=C)C(CC(C(C)O)=O)O)=O,,,5,1,2,0,2
13778_0,,,,2,2,1,3
C(C(C)O)(CC(C(C=O)O)O)=O,,,5,1,4,0,4
13778_1,,,,2,2,1,3
13780_0,,,,2,2,1,3
C(C(C=O)C(C(C)O)(CC=O)O)=O,,,5,1,2,0,2
13780_1,,,,2,2,1,3
13782_0,,,,2,2,1,3
C(CC(C(C)O)(CC=O)O)=O,,,5,1,1,0,1
13783_0,,,,2,2,1,3
13785_0,,,,2,2,1,3
C(C(CO)C(C(C)O)(CC=O)O)=O,,,5,1,2,0,2
13785_1,,,,2,2,1,3
13787_0,,,,2,2,1,3
C(CC(C(C)O)(CC(CO)=O)O)=O,,,5,1,1,0,1
13789_0,,,,2,2,1,3
C(CC(C(C)O)(C(C(C)=O)O)O)=O,,,5,1,2,0,2
13789_1,,,,2,2,1,3
13791_0,,,,2,2,1,3
C(C(C=C)C(C(C)O)(CC=O)O)=O,,,5,1,1,0,1
13792_0,,,,2,2,1,3
13792_1,,,,2,2,1,3
13794_0,,,,2,2,1,3
C(CC(C(C=O)C(C(C)O)=O)O)=O,,,5,1,2,0,2
13794_1,,,,2,2,1,3
13796_0,,,,2,2,1,3
C(C(C)O)(C(C=O)C(C=C)O)=O,,,5,1,2,0,2
13796_1,,,,2,2,1,3
13798_0,,,,2,2,1,3
C(C(C(C(C)O)=O)C(C(O)O)O)=O,,,5,1,2,0,2
13798_1,,,,2,2,1,3
13799_0,,,,2,2,1,3
13799_1,,,,2,2,1,3
13800_0,,,,2,2,1,3
13800_1,,,,2,2,1,3
13802_0,,,,2,2,1,3
C(C(C)O)(C(C=O)C(C=O)(C)O)=O,,,5,1,3,0,3
13802_1,,,,2,2,1,3
13804_0,,,,2,2,1,3
C(C(C)O)(C(C=O)C(C(C)=O)O)=O,,,5,1,3,0,3
13804_1,,,,2,2,1,3
13806_0,,,,2,2,1,3
C(C(C(C(C)O)=O)CO)=O,,,5,1,4,0,4
13806_1,,,,2,2,1,3
13808_0,,,,2,2,1,3
C(C(C(C(C)O)=O)C(CCO)O)=O,,,5,1,3,0,3
13808_1,,,,2,2,1,3
13810_0,,,,2,2,1,3
C(C(C)O)(C(C=O)C(C=O)O)=O,,,5,1,5,0,5
13810_1,,,,2,2,1,3
13812_0,,,,2,2,1,3
C(C(C(C(C)O)=O)C(CO)(C)O)=O,,,5,1,3,0,3
13812_1,,,,2,2,1,3
13814_0,,,,2,2,1,3
C(C(C)O)(C(C=O)C(C=CC)O)=O,,,5,1,3,0,3
13814_1,,,,2,2,1,3
13816_0,,,,2,2,1,3
C(C(C(C(C)O)=O)C(CC=C)O)=O,,,5,1,3,0,3
13816_1,,,,2,2,1,3
13818_0,,,,2,2,1,3
C(C(C(C(C)O)=O)C(CO)O)=O,,,5,1,3,0,3
13818_1,,,,2,2,1,3
13820_0,,,,2,2,1,3
C(C(C(C(C)O)=O)C(C(C)O)O)=O,,,5,1,3,0,3
13820_1,,,,2,2,1,3
13822_0,,,,2,2,1,3
C(C(C)O)(C(C=O)C(C(O)=O)O)=O,,,5,1,3,0,3
13822_1,,,,2,2,1,3
13824_0,,,,2,2,1,3
C(C(C)O)(C(C(C(O)=O)=O)CO)=O,,,5,1,3,0,3
13824_1,,,,2,2,1,3
13826_0,,,,2,2,1,3
C(CC(C(C)O)(C(C(O)=O)O)O)=O,,,5,1,2,0,2
13828_0,,,,2,2,1,3
C(CC(C)(C(C(CO)=O)O)O)=O,,,5,1,2,0,2
13829_0,,,,2,2,1,3
13829_1,,,,2,2,1,3
13831_0,,,,2,2,1,3
C(CC(CO)(C(C(C)=O)O)O)=O,,,5,1,2,0,2
13832_0,,,,2,2,1,3
13832_1,,,,2,2,1,3
13834_0,,,,2,2,1,3
C(CC(C=C)O)(C(C(CO)=O)O)=O,,,5,1,1,0,1
13836_0,,,,2,2,1,3
C(CC(C)O)(C(C(CO)=O)O)=O,,,5,1,3,0,3
13838_0,,,,2,2,1,3
C(CC(C(C(CO)=O)O)=O)(O)=O,,,5,1,4,0,4
13840_0,,,,2,2,1,3
C(CCO)(C(C(CO)=O)O)=O,,,5,1,3,0,3
13842_0,,,,2,2,1,3
C(C(CC(C(C(CO)=O)O)=O)O)=O,,,5,1,1,0,1
13844_0,,,,2,2,1,3
C(CC(CO)O)(C(C(CO)=O)O)=O,,,5,1,1,0,1
13846_0,,,,2,2,1,3
C(C(C(C=C)O)O)(C(C(C)=O)O)=O,,,5,1,2,0,2
13846_1,,,,2,2,1,3
13848_0,,,,2,2,1,3
C(C(C(C)O)O)(C(C(C)=O)O)=O,,,5,1,3,0,3
13848_1,,,,2,2,1,3
13849_0,,,,2,2,1,3
13849_1,,,,2,2,1,3
13851_0,,,,2,2,1,3
C(C(CO)O)(C(C(C)=O)O)=O,,,5,1,6,0,6
13851_1,,,,2,2,1,3
13852_0,,,,2,2,1,3
13852_1,,,,2,2,1,3
13854_0,,,,2,2,1,3
C(C(C(CO)O)O)(C(C(C)=O)O)=O,,,5,1,4,0,4
13854_1,,,,2,2,1,3
13856_0,,,,2,2,1,3
C(C(C=O)C(C)(C(C(C)=O)O)O)=O,,,5,1,2,0,2
13856_1,,,,2,2,1,3
13858_0,,,,2,2,1,3
C(CC(C)(C(C(C)=O)O)O)=O,,,5,1,2,0,2
13860_0,,,,2,2,1,3
C(C)(C(C(C)(CC(C=O)=O)O)O)=O,,,5,1,4,0,4
13862_0,,,,2,2,1,3
C(C(CO)C(C)(C(C(C)=O)O)O)=O,,,5,1,3,0,3
13862_1,,,,2,2,1,3
13864_0,,,,2,2,1,3
C(C)(C(C(C)(CC(CO)=O)O)O)=O,,,5,1,2,0,2
13866_0,,,,2,2,1,3
C(C)(C(C(C)(C(C(C)=O)O)O)O)=O,,,5,1,3,0,3
13866_1,,,,2,2,1,3
13868_0,,,,2,2,1,3
C(C(C=C)C(C)(C(C(C)=O)O)O)=O,,,5,1,2,0,2
13869_0,,,,2,2,1,3
13869_1,,,,2,2,1,3
13871_0,,,,2,2,1,3
C(CC(CC(C(C(C)=O)O)=O)O)=O,,,5,1,1,0,1
13873_0,,,,2,2,1,3
C(CC(C=C)O)(C(C(C)=O)O)=O,,,5,1,1,0,1
13875_0,,,,2,2,1,3
C(CC(C(O)O)O)(C(C(C)=O)O)=O,,,5,1,1,0,1
13877_0,,,,2,2,1,3
C(CC(C)O)(C(C(C)=O)O)=O,,,5,1,3,0,3
13879_0,,,,2,2,1,3
C(CC(C(C(C)=O)O)=O)(O)=O,,,5,1,4,0,4
13881_0,,,,2,2,1,3
C(C(C)(CC(C(C(C)=O)O)=O)O)=O,,,5,1,2,0,2
13883_0,,,,2,2,1,3
C(C)(C(C(CC(C(C)=O)O)=O)O)=O,,,5,1,2,0,2
13885_0,,,,2,2,1,3
C(CCO)(C(C(C)=O)O)=O,,,5,1,3,0,3
13887_0,,,,2,2,1,3
C(CC(CCO)O)(C(C(C)=O)O)=O,,,5,1,2,0,2
13889_0,,,,2,2,1,3
C(C(CC(C(C(C)=O)O)=O)O)=O,,,5,1,2,0,2
13891_0,,,,2,2,1,3
C(CC(CO)(C)O)(C(C(C)=O)O)=O,,,5,1,2,0,2
13893_0,,,,2,2,1,3
C(C)(C(C(CC(C=CC)O)=O)O)=O,,,5,1,2,0,2
13895_0,,,,2,2,1,3
C(CC(CC=C)O)(C(C(C)=O)O)=O,,,5,1,2,0,2
13897_0,,,,2,2,1,3
C(CC(CO)O)(C(C(C)=O)O)=O,,,5,1,2,0,2
13899_0,,,,2,2,1,3
C(CC(C(C)O)O)(C(C(C)=O)O)=O,,,5,1,2,0,2
13901_0,,,,2,2,1,3
C(C(CC(C(C(C)=O)O)=O)O)(O)=O,,,5,1,2,0,2
13903_0,,,,2,2,1,3
C(C(C=O)O)(C([CH]C(O)=O)CO)=O,,,5,1,1,0,1
13905_0,,,,2,2,1,3
C(C(CO)CC(O)=O)(C(C=O)O)=O,,,5,1,1,0,1
13907_0,,,,2,2,1,3
C(C(C(CO)C(C)O)O)(CCO)=O,,,5,1,2,0,2
13908_0,,,,2,2,1,3
13910_0,,,,2,2,1,3
C(CC(CO)(C(CCO)O)O)=O,,,5,1,2,0,2
13912_0,,,,2,2,1,3
C(C(C(CO)(C(CCO)O)O)O)=O,,,5,1,5,0,5
13912_1,,,,2,2,1,3
13914_0,,,,2,2,1,3
C(C(C(C=C)O)O)(C(CCO)O)=O,,,5,1,2,0,2
13914_1,,,,2,2,1,3
13916_0,,,,2,2,1,3
C(C(CCO)O)(C(C(C)O)O)=O,,,5,1,3,0,3
13916_1,,,,2,2,1,3
13918_0,,,,2,2,1,3
C(C(C(C(CCO)O)=O)O)(O)=O,,,5,1,5,0,5
13918_1,,,,2,2,1,3
13920_0,,,,2,2,1,3
C(C(CCO)O)(C(CO)O)=O,,,5,1,4,0,4
13920_1,,,,2,2,1,3
13922_0,,,,2,2,1,3
C(C(C(C=O)O)O)(C(CCO)O)=O,,,5,1,3,0,3
13922_1,,,,2,2,1,3
13924_0,,,,2,2,1,3
C(C(CCO)O)(C(C(CO)O)O)=O,,,5,1,3,0,3
13924_1,,,,2,2,1,3
13926_0,,,,2,2,1,3
C(CC(C(CO)(CCO)O)O)=O,,,5,1,2,0,2
13928_0,,,,2,2,1,3
C(C(C(C(CO)(CCO)O)O)O)=O,,,5,1,3,0,3
13928_1,,,,2,2,1,3
13930_0,,,,2,2,1,3
C(C(C=O)C(C(C)(CCO)O)O)=O,,,5,1,2,0,2
13930_1,,,,2,2,1,3
13932_0,,,,2,2,1,3
C(CC(C(C)(CCO)O)O)=O,,,5,1,2,0,2
13934_0,,,,2,2,1,3
C(C(CC(C(C)(CCO)O)O)=O)=O,,,5,1,2,0,2
13936_0,,,,2,2,1,3
C(C(CO)C(C(C)(CCO)O)O)=O,,,5,1,3,0,3
13936_1,,,,2,2,1,3
13938_0,,,,2,2,1,3
C(CO)(CC(C(C)(CCO)O)O)=O,,,5,1,2,0,2
13940_0,,,,2,2,1,3
C(C)(C(C(C(C)(CCO)O)O)O)=O,,,5,1,3,0,3
13940_1,,,,2,2,1,3
13942_0,,,,2,2,1,3
C(C(C=C)C(C(C)(CCO)O)O)=O,,,5,1,2,0,2
13944_0,,,,2,2,1,3
C(C(C(C(C)(CCO)O)O)O)=O,,,5,1,3,0,3
13944_1,,,,2,2,1,3
13946_0,,,,2,2,1,3
C(C(C=O)C(C)(C(CCO)O)O)=O,,,5,1,2,0,2
13946_1,,,,2,2,1,3
13948_0,,,,2,2,1,3
C(CC(C)(C(CCO)O)O)=O,,,5,1,2,0,2
13950_0,,,,2,2,1,3
C(C(CC(C)(C(CCO)O)O)=O)=O,,,5,1,2,0,2
13952_0,,,,2,2,1,3
C(C(CO)C(C)(C(CCO)O)O)=O,,,5,1,3,0,3
13952_1,,,,2,2,1,3
13954_0,,,,2,2,1,3
C(CO)(CC(C)(C(CCO)O)O)=O,,,5,1,2,0,2
13956_0,,,,2,2,1,3
C(C)(C(C(C)(C(CCO)O)O)O)=O,,,5,1,3,0,3
13956_1,,,,2,2,1,3
13958_0,,,,2,2,1,3
C(C(C=C)C(C)(C(CCO)O)O)=O,,,5,1,2,0,2
13960_0,,,,2,2,1,3
C(C(C(C)(C(CCO)O)O)O)=O,,,5,1,3,0,3
13960_1,,,,2,2,1,3
13962_0,,,,2,2,1,3
C(CC(CC(C(CCO)O)=O)O)=O,,,5,1,1,0,1
13964_0,,,,2,2,1,3
C(CC(C=C)O)(C(CCO)O)=O,,,5,1,1,0,1
13966_0,,,,2,2,1,3
C(C(CCO)O)(CC(C(O)O)O)=O,,,5,1,1,0,1
13968_0,,,,2,2,1,3
C(C(CCO)O)(CC(C)O)=O,,,5,1,2,0,2
13970_0,,,,2,2,1,3
C(CC(C(CCO)O)=O)(O)=O,,,5,1,2,0,2
13972_0,,,,2,2,1,3
C(C(C)(CC(C(CCO)O)=O)O)=O,,,5,1,2,0,2
13974_0,,,,2,2,1,3
C(CC(C(C)=O)O)(C(CCO)O)=O,,,5,1,2,0,2
13976_0,,,,2,2,1,3
C(C(CCO)O)(CCO)=O,,,5,1,2,0,2
13978_0,,,,2,2,1,3
C(C(CCO)O)(CC(CCO)O)=O,,,5,1,2,0,2
13980_0,,,,2,2,1,3
C(CC(C=O)O)(C(CCO)O)=O,,,5,1,2,0,2
13982_0,,,,2,2,1,3
C(C(CCO)O)(CC(CO)(C)O)=O,,,5,1,2,0,2
13984_0,,,,2,2,1,3
C(CC(C=CC)O)(C(CCO)O)=O,,,5,1,2,0,2
13986_0,,,,2,2,1,3
C(C(CCO)O)(CC(CC=C)O)=O,,,5,1,2,0,2
13988_0,,,,2,2,1,3
C(C(CCO)O)(CC(CO)O)=O,,,5,1,2,0,2
13990_0,,,,2,2,1,3
C(C(CCO)O)(CC(C(C)O)O)=O,,,5,1,2,0,2
13992_0,,,,2,2,1,3
C(CC(C(O)=O)O)(C(CCO)O)=O,,,5,1,2,0,2
13994_0,,,,2,2,1,3
C(C(C[CH]C(O)=O)O)(C(CO)O)=O,,,5,1,3,0,3
13994_1,,,,2,2,1,3
13996_0,,,,2,2,1,3
C(CCC(C(C(CO)O)=O)O)(O)=O,,,5,1,3,0,3
13996_1,,,,2,2,1,3
13998_0,,,,2,2,1,3
C(CC(CC[CH]C(O)=O)(CO)O)=O,,,5,1,3,0,3
14000_0,,,,2,2,1,3
C(CO)(C(C(C)O)C[CH]C(O)=O)=O,,,5,1,3,0,3
14002_0,,,,2,2,1,3
C(C(C(CO)=O)C[CH]C(O)=O)(O)=O,,,5,1,3,0,3
14004_0,,,,2,2,1,3
C(CO)(C(CO)C[CH]C(O)=O)=O,,,5,1,3,0,3
14006_0,,,,2,2,1,3
C(CC[CH]C(O)=O)(C(C(C)O)O)=O,,,5,1,3,0,3
14006_1,,,,2,2,1,3
14008_0,,,,2,2,1,3
C(C(C(CC[CH]C(O)=O)=O)O)(O)=O,,,5,1,3,0,3
14008_1,,,,2,2,1,3
14010_0,,,,2,2,1,3
C(CC[CH]C(O)=O)(C(CO)O)=O,,,5,1,3,0,3
14010_1,,,,2,2,1,3
14012_0,,,,2,2,1,3
C(CCCC(CO)(CC=O)O)(O)=O,,,5,1,3,0,3
14014_0,,,,2,2,1,3
C(CCC(C(CO)=O)C(C)O)(O)=O,,,5,1,3,0,3
14016_0,,,,2,2,1,3
C(CCC(C(O)=O)C(CO)=O)(O)=O,,,5,1,3,0,3
14018_0,,,,2,2,1,3
C(CCC(C(CO)=O)CO)(O)=O,,,5,1,3,0,3
14020_0,,,,2,2,1,3
C(CCCC(C(C(C)O)O)=O)(O)=O,,,5,1,3,0,3
14020_1,,,,2,2,1,3
14022_0,,,,2,2,1,3
C(C(C(CCCC(O)=O)=O)O)(O)=O,,,5,1,3,0,3
14022_1,,,,2,2,1,3
14024_0,,,,2,2,1,3
C(CCCC(C(CO)O)=O)(O)=O,,,5,1,3,0,3
14024_1,,,,2,2,1,3
14026_0,,,,2,2,1,3
C(CC(C(CO)(CC=O)O)O)(O)=O,,,5,1,2,0,2
14028_0,,,,2,2,1,3
C(CC(C(C(C(C)O)O)=O)O)(O)=O,,,5,1,3,0,3
14028_1,,,,2,2,1,3
14029_0,,,,2,2,1,3
14029_1,,,,2,2,1,3
14031_0,,,,2,2,1,3
C(CC(C(C(CO)O)=O)O)(O)=O,,,5,1,6,0,6
14031_1,,,,2,2,1,3
14033_0,,,,2,2,1,3
C(CC(CO)(C(CC=O)O)O)(O)=O,,,5,1,2,0,2
14035_0,,,,2,2,1,3
C(CC(C)(C(CC=O)O)O)(O)=O,,,5,1,2,0,2
14037_0,,,,2,2,1,3
C(CC(C)(C(C(C=O)O)O)O)(O)=O,,,5,1,3,0,3
14037_1,,,,2,2,1,3
14039_0,,,,2,2,1,3
C(CC(C(C)(CC=O)O)O)(O)=O,,,5,1,2,0,2
14041_0,,,,2,2,1,3
C(CC(C(C)(C(C=O)O)O)O)(O)=O,,,5,1,3,0,3
14041_1,,,,2,2,1,3
14043_0,,,,2,2,1,3
C(CC(C(CC(C=C)O)=O)O)(O)=O,,,5,1,1,0,1
14045_0,,,,2,2,1,3
C(CC(C(CC(C)O)=O)O)(O)=O,,,5,1,2,0,2
14047_0,,,,2,2,1,3
C(CC(C(CC(O)=O)O)=O)(O)=O,,,5,1,3,0,3
14049_0,,,,2,2,1,3
C(CC(C(CCO)=O)O)(O)=O,,,5,1,3,0,3
14051_0,,,,2,2,1,3
C(CC(C(CC(C=O)O)=O)O)(O)=O,,,5,1,2,0,2
14053_0,,,,2,2,1,3
C(CC(C(CC(CO)O)=O)O)(O)=O,,,5,1,2,0,2
14055_0,,,,2,2,1,3
C(CC(C(CO)(CO)C(C)O)O)=O,,,5,1,1,0,1
14057_0,,,,2,2,1,3
C(C(CO)(CO)C(CC=O)O)(O)=O,,,5,1,3,0,3
14059_0,,,,2,2,1,3
C(CC(C(C(CO)(CO)O)=O)O)=O,,,5,1,3,0,3
14061_0,,,,2,2,1,3
C(C(C(CO)(CO)O)(CC=O)O)=O,,,5,1,2,0,2
14063_0,,,,2,2,1,3
C(CC(C(C=O)(C(C=O)O)O)O)=O,,,5,1,5,0,5
14065_0,,,,2,2,1,3
C(C(C=O)(C(C(CC=O)O)O)O)=O,,,5,1,3,0,3
14067_0,,,,2,2,1,3
C(C(CO)C(C(CC=O)O)O)(O)=O,,,5,1,2,0,2
14069_0,,,,2,2,1,3
C(C(C(CC=O)O)(C(CO)O)O)=O,,,5,1,5,0,5
14071_0,,,,2,2,1,3
C(C(C(CC=O)O)(C(C)O)O)=O,,,5,1,5,0,5
14073_0,,,,2,2,1,3
C(C(C(C(C=O)O)O)(C(C)O)O)=O,,,5,1,6,0,6
14073_1,,,,2,2,1,3
14075_0,,,,2,2,1,3
C(C(C=O)(C(CC=O)O)O)(O)=O,,,5,1,6,0,6
14076_0,,,,2,2,1,3
14076_1,,,,2,2,1,3
14077_0,,,,2,2,1,3
14079_0,,,,2,2,1,3
C(C(C(CC=O)O)(C(C)O)O)(O)=O,,,5,1,5,0,5
14081_0,,,,2,2,1,3
C(C(C(O)=O)(C(CC=O)O)O)(O)=O,,,5,1,5,0,5
14083_0,,,,2,2,1,3
C(C(C(CCO)=O)(CO)CO)(O)=O,,,5,1,2,0,2
14085_0,,,,2,2,1,3
C(C(C(CCO)=O)(C)C(C)O)(O)=O,,,5,1,2,0,2
14087_0,,,,2,2,1,3
C(C(C(O)=O)(C(CCO)=O)C)(O)=O,,,5,1,2,0,2
14089_0,,,,2,2,1,3
C(C(C)(CO)C(C)(CC=O)O)(O)=O,,,5,1,2,0,2
14091_0,,,,2,2,1,3
C(C(C(CC(C)O)=O)(C)CO)(O)=O,,,5,1,2,0,2
14093_0,,,,2,2,1,3
C(C(C(CC(O)=O)=O)(C)CO)(O)=O,,,5,1,2,0,2
14095_0,,,,2,2,1,3
C(C(C(CCO)=O)(C)CO)(O)=O,,,5,1,2,0,2
14097_0,,,,2,2,1,3
C(CC(C(CO)(C(CO)O)O)O)=O,,,5,1,3,0,3
14099_0,,,,2,2,1,3
C(CC(C(CO)(C(C)O)O)O)=O,,,5,1,1,0,1
14101_0,,,,2,2,1,3
C(C(C(C(CO)(C(C)O)O)O)O)=O,,,5,1,4,0,4
14101_1,,,,2,2,1,3
14103_0,,,,2,2,1,3
C(C(C=O)C(C(CO)(CO)O)O)=O,,,5,1,2,0,2
14103_1,,,,2,2,1,3
14105_0,,,,2,2,1,3
C(CC(C(CO)(CO)O)O)=O,,,5,1,1,0,1
14107_0,,,,2,2,1,3
C(C(CC(C(CO)(CO)O)O)=O)=O,,,5,1,1,0,1
14109_0,,,,2,2,1,3
C(C(CO)C(C(CO)(CO)O)O)=O,,,5,1,2,0,2
14109_1,,,,2,2,1,3
14111_0,,,,2,2,1,3
C(CO)(CC(C(CO)(CO)O)O)=O,,,5,1,1,0,1
14113_0,,,,2,2,1,3
C(C)(C(C(C(CO)(CO)O)O)O)=O,,,5,1,2,0,2
14113_1,,,,2,2,1,3
14115_0,,,,2,2,1,3
C(C(C=C)C(C(CO)(CO)O)O)=O,,,5,1,1,0,1
14117_0,,,,2,2,1,3
C(C(C(C(CO)(CO)O)O)O)=O,,,5,1,7,0,7
14117_1,,,,2,2,1,3
14118_0,,,,2,2,1,3
14118_1,,,,2,2,1,3
14120_0,,,,2,2,1,3
C(C(CO)(CC=O)O)(C(CO)O)=O,,,5,1,3,0,3
14120_1,,,,2,2,1,3
14122_0,,,,2,2,1,3
C(CC(CC(C(C)=O)(CO)O)O)=O,,,5,1,2,0,2
14124_0,,,,2,2,1,3
C(CC(C)(C(CO)(CC=O)O)O)=O,,,5,1,1,0,1
14125_0,,,,2,2,1,3
14125_1,,,,2,2,1,3
14126_0,,,,2,2,1,3
14126_1,,,,2,2,1,3
14127_0,,,,2,2,1,3
14127_1,,,,2,2,1,3
14129_0,,,,2,2,1,3
C(C(CO)(CC=O)O)(CC(C)O)=O,,,5,1,2,0,2
14131_0,,,,2,2,1,3
C(C(CO)(CC=O)O)(CC(O)=O)=O,,,5,1,3,0,3
14133_0,,,,2,2,1,3
C(C(CO)(CC=O)O)(CCO)=O,,,5,1,2,0,2
14135_0,,,,2,2,1,3
C(CC(C(C)(C(CCO)O)O)O)=O,,,5,1,1,0,1
14137_0,,,,2,2,1,3
C(C(C(CO)O)=O)(C(CO)(C)O)=O,,,5,1,3,0,3
14137_1,,,,2,2,1,3
14139_0,,,,2,2,1,3
C(C(CCO)=O)(C(C)(C(C)O)O)=O,,,5,1,2,0,2
14140_0,,,,2,2,1,3
14142_0,,,,2,2,1,3
C(C(C)(CC=O)O)(C(CO)(C)O)=O,,,5,1,2,0,2
14144_0,,,,2,2,1,3
C(C(CC(C)O)=O)(C(CO)(C)O)=O,,,5,1,2,0,2
14146_0,,,,2,2,1,3
C(CC(C(C(CO)(C)O)=O)=O)(O)=O,,,5,1,2,0,2
14148_0,,,,2,2,1,3
C(C(CCO)=O)(C(CO)(C)O)=O,,,5,1,2,0,2
14150_0,,,,2,2,1,3
C(CC(C(C)(C(C)(CO)O)O)O)=O,,,5,1,2,0,2
14152_0,,,,2,2,1,3
C(CC(C(C)(C(C=CC)O)O)O)=O,,,5,1,1,0,1
14154_0,,,,2,2,1,3
C(CC(C(C)(C(CC=C)O)O)O)=O,,,5,1,1,0,1
14156_0,,,,2,2,1,3
C(CC(C(C)(C(CO)O)O)O)=O,,,5,1,3,0,3
14158_0,,,,2,2,1,3
C(C(C(C(C)(C(CO)O)O)O)O)=O,,,5,1,3,0,3
14158_1,,,,2,2,1,3
14160_0,,,,2,2,1,3
C(CC(C(C)(C(C(C)O)O)O)O)=O,,,5,1,1,0,1
14162_0,,,,2,2,1,3
C(C(C=O)C(C(C)(C(C)O)O)O)=O,,,5,1,2,0,2
14162_1,,,,2,2,1,3
14164_0,,,,2,2,1,3
C(CC(C(C)(C(C)O)O)O)=O,,,5,1,1,0,1
14166_0,,,,2,2,1,3
C(C(CC(C(C)(C(C)O)O)O)=O)=O,,,5,1,1,0,1
14168_0,,,,2,2,1,3
C(C(CO)C(C(C)(C(C)O)O)O)=O,,,5,1,2,0,2
14168_1,,,,2,2,1,3
14170_0,,,,2,2,1,3
C(CO)(CC(C(C)(C(C)O)O)O)=O,,,5,1,1,0,1
14172_0,,,,2,2,1,3
C(C)(C(C(C(C)(C(C)O)O)O)O)=O,,,5,1,2,0,2
14172_1,,,,2,2,1,3
14174_0,,,,2,2,1,3
C(C(C=C)C(C(C)(C(C)O)O)O)=O,,,5,1,1,0,1
14176_0,,,,2,2,1,3
C(C(C(C(C)(C(C)O)O)O)O)=O,,,5,1,2,0,2
14176_1,,,,2,2,1,3
14177_0,,,,2,2,1,3
14179_0,,,,2,2,1,3
C(C(C)O)(CC(C(CO)(C)O)O)=O,,,5,1,1,0,1
14181_0,,,,2,2,1,3
C(C(C(C(CO)(C)O)O)O)(CC)=O,,,5,1,2,0,2
14181_1,,,,2,2,1,3
14183_0,,,,2,2,1,3
C(CO)(C(C)C(C(CO)(C)O)O)=O,,,5,1,1,0,1
14185_0,,,,2,2,1,3
C(C(C=O)C(C(C)(CO)O)O)=O,,,5,1,2,0,2
14185_1,,,,2,2,1,3
14187_0,,,,2,2,1,3
C(C(CCO)C(C(C)(CO)O)O)=O,,,5,1,1,0,1
14189_0,,,,2,2,1,3
C(CC(C(C)(CO)O)O)=O,,,5,1,1,0,1
14191_0,,,,2,2,1,3
C(C(C(C)O)C(C(C)(CO)O)O)=O,,,5,1,2,0,2
14191_1,,,,2,2,1,3
14193_0,,,,2,2,1,3
C(C(C=O)C(C(C)(CO)O)O)(O)=O,,,5,1,2,0,2
14193_1,,,,2,2,1,3
14195_0,,,,2,2,1,3
C(C(C(C(C(CO)(C)O)O)O)=O)=O,,,5,1,2,0,2
14195_1,,,,2,2,1,3
14197_0,,,,2,2,1,3
C(C(CC(C(C)(CO)O)O)=O)=O,,,5,1,1,0,1
14199_0,,,,2,2,1,3
C(C(CO)C(C(C)(CO)O)O)=O,,,5,1,2,0,2
14199_1,,,,2,2,1,3
14201_0,,,,2,2,1,3
C(CO)(C(C(C(CO)(C)O)O)O)=O,,,5,1,2,0,2
14201_1,,,,2,2,1,3
14203_0,,,,2,2,1,3
C(CO)(CC(C(CO)(C)O)O)=O,,,5,1,1,0,1
14205_0,,,,2,2,1,3
C(C)(C(C(C(CO)(C)O)O)O)=O,,,5,1,2,0,2
14205_1,,,,2,2,1,3
14207_0,,,,2,2,1,3
C(C(C=C)C(C(C)(CO)O)O)=O,,,5,1,1,0,1
14209_0,,,,2,2,1,3
C(C(C(C(CO)(C)O)O)O)=O,,,5,1,6,0,6
14209_1,,,,2,2,1,3
14211_0,,,,2,2,1,3
C(C(CC(C(C)(CO)O)O)=O)(O)=O,,,5,1,1,0,1
14213_0,,,,2,2,1,3
C(CC(C(C(O)=O)=C)O)(C(C)O)=O,,,5,1,1,0,1
14215_0,,,,2,2,1,3
C(C(C(C(C(O)=O)=C)O)O)(CC)=O,,,5,1,2,0,2
14215_1,,,,2,2,1,3
14217_0,,,,2,2,1,3
C(CO)(C(C)C(C(C(O)=O)=C)O)=O,,,5,1,1,0,1
14219_0,,,,2,2,1,3
C(C(C=O)C(C(C(O)=O)=C)O)=O,,,5,1,2,0,2
14219_1,,,,2,2,1,3
14221_0,,,,2,2,1,3
C(C(C(C=O)=C)C(C(C(O)=O)=C)O)=O,,,5,1,1,0,1
14223_0,,,,2,2,1,3
C=C(C(O)=O)C(CC(C=CC=O)=O)O,,,5,1,1,0,1
14225_0,,,,2,2,1,3
C=CC(C(C=O)=O)C(C(C(O)=O)=C)O,,,5,1,1,0,1
14227_0,,,,2,2,1,3
C(C(CCO)C(C(C(O)=O)=C)O)=O,,,5,1,1,0,1
14229_0,,,,2,2,1,3
C(CC(C(C(O)=O)=C)O)=O,,,5,1,3,0,3
14231_0,,,,2,2,1,3
C(C(C(C)O)C(C(C(O)=O)=C)O)=O,,,5,1,2,0,2
14231_1,,,,2,2,1,3
14233_0,,,,2,2,1,3
C(C(C=O)C(C(C(O)=O)=C)O)(O)=O,,,5,1,2,0,2
14233_1,,,,2,2,1,3
14235_0,,,,2,2,1,3
C=C(C(O)=O)C(C(C(C=O)=O)O)O,,,5,1,2,0,2
14235_1,,,,2,2,1,3
14237_0,,,,2,2,1,3
C=C(C(O)=O)C(CC(C=O)=O)O,,,5,1,3,0,3
14239_0,,,,2,2,1,3
C(C(CO)C(C(C(O)=O)=C)O)=O,,,5,1,4,0,4
14239_1,,,,2,2,1,3
14241_0,,,,2,2,1,3
C(CO)(C(C(C(C(O)=O)=C)O)O)=O,,,5,1,2,0,2
14241_1,,,,2,2,1,3
14243_0,,,,2,2,1,3
C(CO)(CC(C(C(O)=O)=C)O)=O,,,5,1,3,0,3
14245_0,,,,2,2,1,3
C(C)(C(C(C(C(O)=O)=C)O)O)=O,,,5,1,4,0,4
14245_1,,,,2,2,1,3
14247_0,,,,2,2,1,3
C(C(C=C)C(C(C(O)=O)=C)O)=O,,,5,1,3,0,3
14249_0,,,,2,2,1,3
C(C(C(C(C(O)=O)=C)O)O)=O,,,5,1,7,0,7
14249_1,,,,2,2,1,3
14251_0,,,,2,2,1,3
C=C(C(O)=O)C(CC(C(O)=O)=O)O,,,5,1,1,0,1
14253_0,,,,2,2,1,3
C(C(C)O)(OC(C(CCO)=O)=O)=O,,,5,1,1,0,1
14255_0,,,,2,2,1,3
C(C(C(C(CO)CC(C)O)=O)=O)=O,,,5,1,1,0,1
14257_0,,,,2,2,1,3
C(CC(C)O)(C(C(C=O)=O)CO)=O,,,5,1,2,0,2
14257_1,,,,2,2,1,3
14259_0,,,,2,2,1,3
C(C(CO)C(C)O)(CC(C=O)=O)=O,,,5,1,2,0,2
14259_1,,,,2,2,1,3
14261_0,,,,2,2,1,3
C(CC(C(C(C=O)=O)=O)CO)(O)=O,,,5,1,1,0,1
14263_0,,,,2,2,1,3
C(CC(O)=O)(C(C(C=O)=O)CO)=O,,,5,1,2,0,2
14263_1,,,,2,2,1,3
14265_0,,,,2,2,1,3
C(C(C(CC(C=O)=O)=O)CO)(O)=O,,,5,1,3,0,3
14265_1,,,,2,2,1,3
14267_0,,,,2,2,1,3
C(CO)(C(C(C(C=O)=O)=O)CO)=O,,,5,1,2,0,2
14267_1,,,,2,2,1,3
14269_0,,,,2,2,1,3
C(C(CO)O)(CC(C(C=O)=O)=O)=O,,,5,1,2,0,2
14269_1,,,,2,2,1,3
14271_0,,,,2,2,1,3
C(C(CC(C=O)C=O)(CC=O)O)=O,,,5,1,1,0,1
14273_0,,,,2,2,1,3
C(C(C=O)CC(C(CC=O)O)=O)=O,,,5,1,1,0,1
14275_0,,,,2,2,1,3
C(CC(C(C=O)CC(C=O)=O)O)=O,,,5,1,1,0,1
14277_0,,,,2,2,1,3
C(C(C=O)C(C(C=O)=O)C(C=C)O)=O,,,5,1,1,0,1
14279_0,,,,2,2,1,3
C(C(C=O)C(C(C=O)=O)C(C)O)=O,,,5,1,1,0,1
14281_0,,,,2,2,1,3
C(C(C=O)C(C(O)=O)C(C=O)=O)=O,,,5,1,1,0,1
14283_0,,,,2,2,1,3
C(C(C=O)C(C(C=O)=O)CO)=O,,,5,1,2,0,2
14285_0,,,,2,2,1,3
C(C(C=O)CC(C(C=O)C=O)O)=O,,,5,1,2,0,2
14285_1,,,,2,2,1,3
14287_0,,,,2,2,1,3
C(C(C=O)CC(CC=O)O)=O,,,5,1,2,0,2
14289_0,,,,2,2,1,3
C(C(C=O)CC(CC(C=O)=O)O)=O,,,5,1,1,0,1
14291_0,,,,2,2,1,3
C(C(C=O)CC(C(C=O)CO)O)=O,,,5,1,2,0,2
14291_1,,,,2,2,1,3
14293_0,,,,2,2,1,3
C(C(C=O)CC(CC(CO)=O)O)=O,,,5,1,1,0,1
14295_0,,,,2,2,1,3
C(C(C=O)CC(C(C(C)=O)O)O)=O,,,5,1,2,0,2
14295_1,,,,2,2,1,3
14297_0,,,,2,2,1,3
C(C(C=C)C(CC(C=O)C=O)O)=O,,,5,1,1,0,1
14299_0,,,,2,2,1,3
C(C(C=O)CC(C(C=O)O)O)=O,,,5,1,3,0,3
14299_1,,,,2,2,1,3
14301_0,,,,2,2,1,3
C(C(C(C(C=O)C=O)O)CC=O)=O,,,5,1,2,0,2
14301_1,,,,2,2,1,3
14303_0,,,,2,2,1,3
C(CC(C(C=O)CC=O)O)=O,,,5,1,2,0,2
14305_0,,,,2,2,1,3
C(C(C(CC(C=O)=O)O)CC=O)=O,,,5,1,1,0,1
14307_0,,,,2,2,1,3
C(C(CO)C(C(C=O)CC=O)O)=O,,,5,1,2,0,2
14307_1,,,,2,2,1,3
14309_0,,,,2,2,1,3
C(CO)(CC(C(C=O)CC=O)O)=O,,,5,1,1,0,1
14311_0,,,,2,2,1,3
C(C)(C(C(C(C=O)CC=O)O)O)=O,,,5,1,2,0,2
14311_1,,,,2,2,1,3
14313_0,,,,2,2,1,3
C(C(C(C(C=O)C=C)O)CC=O)=O,,,5,1,1,0,1
14315_0,,,,2,2,1,3
C(C(C(C(C=O)CC=O)O)O)=O,,,5,1,3,0,3
14315_1,,,,2,2,1,3
14317_0,,,,2,2,1,3
C(CC(C(C=O)C(C=O)C=O)O)=O,,,5,1,1,0,1
14319_0,,,,2,2,1,3
C(C(C=O)C(C=O)C(C=O)(C=C)O)=O,,,5,1,1,0,1
14321_0,,,,2,2,1,3
C(C(C=O)C(C=O)C(C(C=C)=O)O)=O,,,5,1,1,0,1
14323_0,,,,2,2,1,3
C(C(C=O)C(C=O)C(C=C)O)=O,,,5,1,1,0,1
14325_0,,,,2,2,1,3
C(C(C=O)C(C=O)C(C(O)O)O)=O,,,5,1,1,0,1
14326_0,,,,2,2,1,3
14327_0,,,,2,2,1,3
14329_0,,,,2,2,1,3
C(C(C)(C(C=O)C(C=O)C=O)O)=O,,,5,1,1,0,1
14331_0,,,,2,2,1,3
C(C(C=O)C(C=O)C(C(C)=O)O)=O,,,5,1,1,0,1
14333_0,,,,2,2,1,3
C(C(C=O)C(C=O)CO)=O,,,5,1,2,0,2
14335_0,,,,2,2,1,3
C(C(C=O)C(C=O)C(CCO)O)=O,,,5,1,1,0,1
14337_0,,,,2,2,1,3
C(C(C=O)C(C=O)C(C=O)O)=O,,,5,1,2,0,2
14339_0,,,,2,2,1,3
C(C(C=O)C(C=O)C(C)(CO)O)=O,,,5,1,1,0,1
14341_0,,,,2,2,1,3
C(C(C=O)C(C=O)C(C=CC)O)=O,,,5,1,1,0,1
14343_0,,,,2,2,1,3
C(C(C=O)C(C=O)C(CC=C)O)=O,,,5,1,1,0,1
14345_0,,,,2,2,1,3
C(C(C=O)C(C=O)C(CO)O)=O,,,5,1,2,0,2
14347_0,,,,2,2,1,3
C(C(C=O)C(C=O)C(C(C)O)O)=O,,,5,1,1,0,1
14349_0,,,,2,2,1,3
C(C(C=O)C(C=O)C(C(O)=O)O)=O,,,5,1,1,0,1
14351_0,,,,2,2,1,3
C(C(C=O)C(C(C(O)=O)=O)CO)=O,,,5,1,1,0,1
14353_0,,,,2,2,1,3
C(CC(C(C(C(C=O)=O)=O)C)O)=O,,,5,1,2,0,2
14355_0,,,,2,2,1,3
C(CC(C(C=O)=O)(C(C=O)C)O)=O,,,5,1,1,0,1
14357_0,,,,2,2,1,3
C(CC(C(C(C(C=O)C)=O)=O)O)=O,,,5,1,1,0,1
14359_0,,,,2,2,1,3
C(C(C(C(C=O)(CC=O)O)=O)C)=O,,,5,1,1,0,1
14361_0,,,,2,2,1,3
C(CC(C)(CC(C(C=O)=O)=O)O)=O,,,5,1,1,0,1
14363_0,,,,2,2,1,3
C(CC(C(C=O)=O)(CC(C)=O)O)=O,,,5,1,1,0,1
14365_0,,,,2,2,1,3
C(CC(C(C(CC(C)=O)=O)=O)O)=O,,,5,1,1,0,1
14367_0,,,,2,2,1,3
C(C(C(CC(C)=O)=O)(CC=O)O)=O,,,5,1,1,0,1
14369_0,,,,2,2,1,3
C(CC(C=C)O)(CC(C(C=O)=O)=O)=O,,,5,1,1,0,1
14371_0,,,,2,2,1,3
C(CC(C)O)(CC(C(C=O)=O)=O)=O,,,5,1,1,0,1
14373_0,,,,2,2,1,3
C(CC(CC(C(C=O)=O)=O)=O)(O)=O,,,5,1,1,0,1
14375_0,,,,2,2,1,3
C(CCO)(CC(C(C=O)=O)=O)=O,,,5,1,2,0,2
14377_0,,,,2,2,1,3
C(C)(C(C(C(C=O)=O)=O)C(C=C)O)=O,,,5,1,2,0,2
14377_1,,,,2,2,1,3
14379_0,,,,2,2,1,3
C(C)(C(C(C(C=O)=O)=O)C(C)O)=O,,,5,1,2,0,2
14379_1,,,,2,2,1,3
14381_0,,,,2,2,1,3
C(C(C(C)=O)C(C(C=O)=O)=O)(O)=O,,,5,1,2,0,2
14381_1,,,,2,2,1,3
14383_0,,,,2,2,1,3
C(C)(C(C(C(C=O)=O)=O)CO)=O,,,5,1,3,0,3
14383_1,,,,2,2,1,3
14384_0,,,,2,2,1,3
14386_0,,,,2,2,1,3
C(C(C(CC(C=O)=O)O)O)(CC)=O,,,5,1,2,0,2
14386_1,,,,2,2,1,3
14388_0,,,,2,2,1,3
C(CO)(C(C)C(CC(C=O)=O)O)=O,,,5,1,1,0,1
14390_0,,,,2,2,1,3
C(C(C=O)C(CC(C=O)=O)O)=O,,,5,1,2,0,2
14390_1,,,,2,2,1,3
14392_0,,,,2,2,1,3
C(C(C(C=O)=C)C(CC(C=O)=O)O)=O,,,5,1,1,0,1
14394_0,,,,2,2,1,3
C(C(CC(CC(C=CC=O)=O)O)=O)=O,,,5,1,1,0,1
14396_0,,,,2,2,1,3
C=CC(C(C=O)=O)C(CC(C=O)=O)O,,,5,1,1,0,1
14398_0,,,,2,2,1,3
C(C(C(CC(C=O)=O)O)CCO)=O,,,5,1,1,0,1
14400_0,,,,2,2,1,3
C(CC(CC(C=O)=O)O)=O,,,5,1,3,0,3
14402_0,,,,2,2,1,3
C(C(C(CC(C=O)=O)O)C(C)O)=O,,,5,1,2,0,2
14402_1,,,,2,2,1,3
14404_0,,,,2,2,1,3
C(C(C=O)C(CC(C=O)=O)O)(O)=O,,,5,1,2,0,2
14404_1,,,,2,2,1,3
14406_0,,,,2,2,1,3
C(C=O)(CC(C(C(C=O)=O)O)O)=O,,,5,1,2,0,2
14406_1,,,,2,2,1,3
14408_0,,,,2,2,1,3
C(C(CC(CC(C=O)=O)O)=O)=O,,,5,1,1,0,1
14410_0,,,,2,2,1,3
C(C(CO)C(CC(C=O)=O)O)=O,,,5,1,2,0,2
14410_1,,,,2,2,1,3
14411_0,,,,2,2,1,3
14411_1,,,,2,2,1,3
14413_0,,,,2,2,1,3
C(CO)(CC(CC(C=O)=O)O)=O,,,5,1,1,0,1
14414_0,,,,2,2,1,3
14414_1,,,,2,2,1,3
14416_0,,,,2,2,1,3
C(C(C=C)C(CC(C=O)=O)O)=O,,,5,1,1,0,1
14417_0,,,,2,2,1,3
14417_1,,,,2,2,1,3
14419_0,,,,2,2,1,3
C(C(CC(CC(C=O)=O)O)=O)(O)=O,,,5,1,2,0,2
14421_0,,,,2,2,1,3
C(CC(C(CC=O)=O)O)(C(C)O)=O,,,5,1,1,0,1
14423_0,,,,2,2,1,3
C(CC(C(C(C(CC)=O)O)O)=O)=O,,,5,1,2,0,2
14423_1,,,,2,2,1,3
14425_0,,,,2,2,1,3
C(CO)(C(C)C(C(CC=O)=O)O)=O,,,5,1,1,0,1
14427_0,,,,2,2,1,3
C(C(C=O)C(C(CC=O)=O)O)=O,,,5,1,2,0,2
14427_1,,,,2,2,1,3
14429_0,,,,2,2,1,3
C(C(C(C=O)=C)C(C(CC=O)=O)O)=O,,,5,1,1,0,1
14431_0,,,,2,2,1,3
C(CC(C(CC(C=CC=O)=O)O)=O)=O,,,5,1,1,0,1
14433_0,,,,2,2,1,3
C(CC(C(C(C=C)C(C=O)=O)O)=O)=O,,,5,1,1,0,1
14435_0,,,,2,2,1,3
C(C(CCO)C(C(CC=O)=O)O)=O,,,5,1,1,0,1
14437_0,,,,2,2,1,3
C(CC(C(CC=O)O)=O)=O,,,5,1,2,0,2
14439_0,,,,2,2,1,3
C(C(C(C)O)C(C(CC=O)=O)O)=O,,,5,1,2,0,2
14439_1,,,,2,2,1,3
14441_0,,,,2,2,1,3
C(C(C=O)C(C(CC=O)=O)O)(O)=O,,,5,1,2,0,2
14441_1,,,,2,2,1,3
14443_0,,,,2,2,1,3
C(CC(C(C(C(C=O)=O)O)O)=O)=O,,,5,1,2,0,2
14443_1,,,,2,2,1,3
14445_0,,,,2,2,1,3
C(CC(C(CC(C=O)=O)O)=O)=O,,,5,1,2,0,2
14447_0,,,,2,2,1,3
C(C(CO)C(C(CC=O)=O)O)=O,,,5,1,3,0,3
14447_1,,,,2,2,1,3
14449_0,,,,2,2,1,3
C(CC(C(C(C(CO)=O)O)O)=O)=O,,,5,1,2,0,2
14449_1,,,,2,2,1,3
14451_0,,,,2,2,1,3
C(CC(C(CC(CO)=O)O)=O)=O,,,5,1,2,0,2
14453_0,,,,2,2,1,3
C(CC(C(C(C(C)=O)O)O)=O)=O,,,5,1,3,0,3
14453_1,,,,2,2,1,3
14455_0,,,,2,2,1,3
C(C(C=C)C(C(CC=O)=O)O)=O,,,5,1,2,0,2
14457_0,,,,2,2,1,3
C(CC(C(C(C=O)O)O)=O)=O,,,5,1,3,0,3
14457_1,,,,2,2,1,3
14459_0,,,,2,2,1,3
C(CC(C(CC(C(O)=O)=O)O)=O)=O,,,5,1,1,0,1
14460_0,,,,2,2,1,3
14462_0,,,,2,2,1,3
C(C(C(C=O)(CC=O)O)O)(CC)=O,,,5,1,2,0,2
14462_1,,,,2,2,1,3
14464_0,,,,2,2,1,3
C(CO)(C(C)C(C=O)(CC=O)O)=O,,,5,1,1,0,1
14466_0,,,,2,2,1,3
C(C(C=O)C(C=O)(CC=O)O)=O,,,5,1,2,0,2
14466_1,,,,2,2,1,3
14468_0,,,,2,2,1,3
C(C(C(C=O)=C)C(C=O)(CC=O)O)=O,,,5,1,1,0,1
14470_0,,,,2,2,1,3
C(CC(C=O)(CC(C=CC=O)=O)O)=O,,,5,1,1,0,1
14472_0,,,,2,2,1,3
C(CC(C=O)(C(C=C)C(C=O)=O)O)=O,,,5,1,1,0,1
14474_0,,,,2,2,1,3
C(CC(C=O)(C(C=O)CCO)O)=O,,,5,1,1,0,1
14476_0,,,,2,2,1,3
C(CC(C=O)(CC=O)O)=O,,,5,1,2,0,2
14478_0,,,,2,2,1,3
C(CC(C=O)(C(C=O)C(C)O)O)=O,,,5,1,2,0,2
14478_1,,,,2,2,1,3
14480_0,,,,2,2,1,3
C(C(C=O)C(C=O)(CC=O)O)(O)=O,,,5,1,2,0,2
14480_1,,,,2,2,1,3
14482_0,,,,2,2,1,3
C(CC(C=O)(C(C(C=O)=O)O)O)=O,,,5,1,3,0,3
14482_1,,,,2,2,1,3
14484_0,,,,2,2,1,3
C(CC(C=O)(CC(C=O)=O)O)=O,,,5,1,2,0,2
14486_0,,,,2,2,1,3
C(CC(C=O)(C(C=O)CO)O)=O,,,5,1,3,0,3
14486_1,,,,2,2,1,3
14487_0,,,,2,2,1,3
14487_1,,,,2,2,1,3
14489_0,,,,2,2,1,3
C(CC(C=O)(CC(CO)=O)O)=O,,,5,1,2,0,2
14490_0,,,,2,2,1,3
14490_1,,,,2,2,1,3
14492_0,,,,2,2,1,3
C(C(C=C)C(C=O)(CC=O)O)=O,,,5,1,2,0,2
14494_0,,,,2,2,1,3
C(CC(C=O)(C(C=O)O)O)=O,,,5,1,4,0,4
14494_1,,,,2,2,1,3
14496_0,,,,2,2,1,3
C(CC(C=O)(CC(C(O)=O)=O)O)=O,,,5,1,1,0,1
14498_0,,,,2,2,1,3
C(C(C(C=O)=O)C(C)(C(C)O)O)=O,,,5,1,2,0,2
14498_1,,,,2,2,1,3
14500_0,,,,2,2,1,3
C(C(C(C=O)=O)C(CO)(CC)O)=O,,,5,1,2,0,2
14500_1,,,,2,2,1,3
14502_0,,,,2,2,1,3
C(C(C(C=O)=O)C(CC=O)O)=O,,,5,1,2,0,2
14502_1,,,,2,2,1,3
14504_0,,,,2,2,1,3
C(C(C(C=O)=O)C([CH]C(O)=O)O)=O,,,5,1,2,0,2
14504_1,,,,2,2,1,3
14506_0,,,,2,2,1,3
C(C(C(C=O)=O)C(C=C(C=O)C)O)=O,,,5,1,2,0,2
14506_1,,,,2,2,1,3
14508_0,,,,2,2,1,3
C(C(C(C=O)=O)C(C(C)=CC=O)O)=O,,,5,1,2,0,2
14508_1,,,,2,2,1,3
14510_0,,,,2,2,1,3
C(C(C(C=O)=O)C(CC(C=O)=C)O)=O,,,5,1,2,0,2
14510_1,,,,2,2,1,3
14512_0,,,,2,2,1,3
C(C(C(C=O)=O)C(C(CC=O)=C)O)=O,,,5,1,2,0,2
14512_1,,,,2,2,1,3
14514_0,,,,2,2,1,3
C(C(C(C=O)=O)C(C=CC(C)=O)O)=O,,,5,1,2,0,2
14514_1,,,,2,2,1,3
14516_0,,,,2,2,1,3
C(C(C(C=O)=O)C(C=CC=O)(C)O)=O,,,5,1,2,0,2
14516_1,,,,2,2,1,3
14518_0,,,,2,2,1,3
C(C(C(C=O)=O)C(C=O)(C=C)O)=O,,,5,1,2,0,2
14518_1,,,,2,2,1,3
14520_0,,,,2,2,1,3
C(C(C(C=O)=O)C(C(C=C)=O)O)=O,,,5,1,2,0,2
14520_1,,,,2,2,1,3
14522_0,,,,2,2,1,3
C(C(C(C=O)=O)C(C=O)(CC=C)O)=O,,,5,1,2,0,2
14522_1,,,,2,2,1,3
14524_0,,,,2,2,1,3
C(C(C(C=O)=O)C(C(CC=C)=O)O)=O,,,5,1,2,0,2
14524_1,,,,2,2,1,3
14526_0,,,,2,2,1,3
C(C(C(C=O)=O)C(C=O)(C=CC)O)=O,,,5,1,2,0,2
14526_1,,,,2,2,1,3
14528_0,,,,2,2,1,3
C(C(C(C=O)=O)C(C(C=CC)=O)O)=O,,,5,1,2,0,2
14528_1,,,,2,2,1,3
14530_0,,,,2,2,1,3
C(C(C(C=O)=O)C(C=C)O)=O,,,5,1,2,0,2
14530_1,,,,2,2,1,3
14532_0,,,,2,2,1,3
C(C(C(C=O)=O)C(C(CC)O)O)=O,,,5,1,2,0,2
14532_1,,,,2,2,1,3
14534_0,,,,2,2,1,3
C(C(C(C=O)=O)C(CCCO)O)=O,,,5,1,2,0,2
14534_1,,,,2,2,1,3
14536_0,,,,2,2,1,3
C(C(C(C=O)=O)C(C(O)O)O)=O,,,5,1,2,0,2
14536_1,,,,2,2,1,3
14538_0,,,,2,2,1,3
C(C(C(C=O)=O)C(C)O)=O,,,5,1,6,0,6
14538_1,,,,2,2,1,3
14540_0,,,,2,2,1,3
C(C(C(O)=O)C(C=O)=O)=O,,,5,1,7,0,7
14540_1,,,,2,2,1,3
14542_0,,,,2,2,1,3
C(C(C(C=O)=O)C(CC(C)O)O)=O,,,5,1,3,0,3
14542_1,,,,2,2,1,3
14544_0,,,,2,2,1,3
C(C(C(C=O)=O)C(CC(O)=O)O)=O,,,5,1,3,0,3
14544_1,,,,2,2,1,3
14546_0,,,,2,2,1,3
C(C(C(C=O)=O)C(C(CO)=O)O)=O,,,5,1,3,0,3
14546_1,,,,2,2,1,3
14548_0,,,,2,2,1,3
C(C(C(C=O)=O)C(C=O)(CO)O)=O,,,5,1,3,0,3
14548_1,,,,2,2,1,3
14550_0,,,,2,2,1,3
C(C(C(C=O)=O)C(C=O)(C)O)=O,,,5,1,5,0,5
14550_1,,,,2,2,1,3
14552_0,,,,2,2,1,3
C(C(C(C=O)=O)C(C(C)=O)O)=O,,,5,1,5,0,5
14552_1,,,,2,2,1,3
14554_0,,,,2,2,1,3
C(C(C(C=O)=O)CO)=O,,,5,1,10,0,10
14554_1,,,,2,2,1,3
14556_0,,,,2,2,1,3
C(C(C(C=O)=O)C(CCO)O)=O,,,5,1,3,0,3
14556_1,,,,2,2,1,3
14558_0,,,,2,2,1,3
C(C(C(C=O)=O)C(C=O)O)=O,,,5,1,3,0,3
14558_1,,,,2,2,1,3
14560_0,,,,2,2,1,3
C(C(C(C=O)=O)C(C(C=O)O)O)=O,,,5,1,2,0,2
14560_1,,,,2,2,1,3
14562_0,,,,2,2,1,3
C(C(C(C=O)=O)C(CO)(CO)O)=O,,,5,1,2,0,2
14562_1,,,,2,2,1,3
14564_0,,,,2,2,1,3
C(C(C(C=O)=O)C(C)(CO)O)=O,,,5,1,3,0,3
14564_1,,,,2,2,1,3
14566_0,,,,2,2,1,3
C(C(C(C=O)=O)C(C=CC)O)=O,,,5,1,3,0,3
14566_1,,,,2,2,1,3
14568_0,,,,2,2,1,3
C(C(C(C=O)=O)C(CC=C)O)=O,,,5,1,3,0,3
14568_1,,,,2,2,1,3
14570_0,,,,2,2,1,3
C(C(C(C=O)=O)C(C(CO)O)O)=O,,,5,1,2,0,2
14570_1,,,,2,2,1,3
14572_0,,,,2,2,1,3
C(C(C(C=O)=O)C(CO)O)=O,,,5,1,4,0,4
14572_1,,,,2,2,1,3
14574_0,,,,2,2,1,3
C(C(C(C=O)=O)C(C(C)O)O)=O,,,5,1,4,0,4
14574_1,,,,2,2,1,3
14576_0,,,,2,2,1,3
C(C(C(C=O)=O)C(C(O)=O)O)=O,,,5,1,4,0,4
14576_1,,,,2,2,1,3
14578_0,,,,2,2,1,3
C(C(C(C=O)=O)C(C(O)=O)(C)O)=O,,,5,1,3,0,3
14578_1,,,,2,2,1,3
14580_0,,,,2,2,1,3
C(C(C=O)C(C)(CC(C=O)=O)O)=O,,,5,1,2,0,2
14580_1,,,,2,2,1,3
14582_0,,,,2,2,1,3
C(CC(C)(CC(C=O)=O)O)=O,,,5,1,2,0,2
14584_0,,,,2,2,1,3
C(C(CC(C)(CC(C=O)=O)O)=O)=O,,,5,1,1,0,1
14586_0,,,,2,2,1,3
C(C(CO)C(C)(CC(C=O)=O)O)=O,,,5,1,2,0,2
14586_1,,,,2,2,1,3
14588_0,,,,2,2,1,3
C(CO)(CC(C)(CC(C=O)=O)O)=O,,,5,1,1,0,1
14589_0,,,,2,2,1,3
14589_1,,,,2,2,1,3
14591_0,,,,2,2,1,3
C(C(C=C)C(C)(CC(C=O)=O)O)=O,,,5,1,1,0,1
14592_0,,,,2,2,1,3
14592_1,,,,2,2,1,3
14594_0,,,,2,2,1,3
C(C(C=O)C(C(CC(C)=O)=O)O)=O,,,5,1,2,0,2
14594_1,,,,2,2,1,3
14596_0,,,,2,2,1,3
C(CC(C(CC(C)=O)=O)O)=O,,,5,1,3,0,3
14598_0,,,,2,2,1,3
C(C(CC(C=O)=O)O)(CC(C)=O)=O,,,5,1,1,0,1
14600_0,,,,2,2,1,3
C(C(CO)C(C(CC(C)=O)=O)O)=O,,,5,1,2,0,2
14600_1,,,,2,2,1,3
14602_0,,,,2,2,1,3
C(C)(CC(C(CC(CO)=O)O)=O)=O,,,5,1,1,0,1
14604_0,,,,2,2,1,3
C(C)(CC(C(C(C(C)=O)O)O)=O)=O,,,5,1,2,0,2
14604_1,,,,2,2,1,3
14606_0,,,,2,2,1,3
C(C(C=C)C(C(CC(C)=O)=O)O)=O,,,5,1,1,0,1
14608_0,,,,2,2,1,3
C(C(C(C(CC(C)=O)=O)O)O)=O,,,5,1,3,0,3
14608_1,,,,2,2,1,3
14610_0,,,,2,2,1,3
C(C(C=O)C(C=O)(CC(C)=O)O)=O,,,5,1,2,0,2
14610_1,,,,2,2,1,3
14612_0,,,,2,2,1,3
C(CC(C=O)(CC(C)=O)O)=O,,,5,1,2,0,2
14614_0,,,,2,2,1,3
C(C(CC(C=O)=O)(CC(C)=O)O)=O,,,5,1,1,0,1
14616_0,,,,2,2,1,3
C(CC(C=O)(C(C=O)CO)O)(C)=O,,,5,1,2,0,2
14616_1,,,,2,2,1,3
14618_0,,,,2,2,1,3
C(C(CC(C)=O)(CC(CO)=O)O)=O,,,5,1,1,0,1
14620_0,,,,2,2,1,3
C(C(CC(C)=O)(C(C(C)=O)O)O)=O,,,5,1,2,0,2
14620_1,,,,2,2,1,3
14622_0,,,,2,2,1,3
C(C(C=C)C(C=O)(CC(C)=O)O)=O,,,5,1,1,0,1
14624_0,,,,2,2,1,3
C(C(C(C=O)(CC(C)=O)O)O)=O,,,5,1,3,0,3
14624_1,,,,2,2,1,3
14626_0,,,,2,2,1,3
C(CC(CC(CC(C=O)=O)=O)O)=O,,,5,1,1,0,1
14628_0,,,,2,2,1,3
C(C(C=C)(CC(CC(C=O)=O)=O)O)=O,,,5,1,1,0,1
14630_0,,,,2,2,1,3
C(CC(C(C=C)=O)O)(CC(C=O)=O)=O,,,5,1,1,0,1
14632_0,,,,2,2,1,3
C(CC(C=C)O)(CC(C=O)=O)=O,,,5,1,1,0,1
14634_0,,,,2,2,1,3
C(CC(C(O)O)O)(CC(C=O)=O)=O,,,5,1,1,0,1
14635_0,,,,2,2,1,3
14636_0,,,,2,2,1,3
14638_0,,,,2,2,1,3
C(C(C)(CC(CC(C=O)=O)=O)O)=O,,,5,1,1,0,1
14640_0,,,,2,2,1,3
C(CC(C(C)=O)O)(CC(C=O)=O)=O,,,5,1,1,0,1
14642_0,,,,2,2,1,3
C(CCO)(CC(C=O)=O)=O,,,5,1,4,0,4
14644_0,,,,2,2,1,3
C(CC(CCO)O)(CC(C=O)=O)=O,,,5,1,1,0,1
14646_0,,,,2,2,1,3
C(C(CC(CC(C=O)=O)=O)O)=O,,,5,1,1,0,1
14648_0,,,,2,2,1,3
C(CC(C)(CO)O)(CC(C=O)=O)=O,,,5,1,1,0,1
14650_0,,,,2,2,1,3
C(CC(C=CC)O)(CC(C=O)=O)=O,,,5,1,1,0,1
14652_0,,,,2,2,1,3
C(CC(CC=C)O)(CC(C=O)=O)=O,,,5,1,1,0,1
14654_0,,,,2,2,1,3
C(CC(CO)O)(CC(C=O)=O)=O,,,5,1,1,0,1
14656_0,,,,2,2,1,3
C(CC(C(C)O)O)(CC(C=O)=O)=O,,,5,1,1,0,1
14658_0,,,,2,2,1,3
C(C(CC(CC(C=O)=O)=O)O)(O)=O,,,5,1,1,0,1
14660_0,,,,2,2,1,3
C(CC(C(C(C)=O)C(C=O)=O)O)=O,,,5,1,2,0,2
14660_1,,,,2,2,1,3
14662_0,,,,2,2,1,3
C(C(C=C)(C(C(C)=O)C(C=O)=O)O)=O,,,5,1,2,0,2
14662_1,,,,2,2,1,3
14664_0,,,,2,2,1,3
C(C)(C(C(C=O)=O)C(C(C=C)=O)O)=O,,,5,1,2,0,2
14664_1,,,,2,2,1,3
14666_0,,,,2,2,1,3
C(C)(C(C(C=O)=O)C(C=C)O)=O,,,5,1,2,0,2
14666_1,,,,2,2,1,3
14668_0,,,,2,2,1,3
C(C)(C(C(C=O)=O)C(C(O)O)O)=O,,,5,1,2,0,2
14668_1,,,,2,2,1,3
14670_0,,,,2,2,1,3
C(C)(C(C(C=O)=O)C(C)O)=O,,,5,1,5,0,5
14670_1,,,,2,2,1,3
14672_0,,,,2,2,1,3
C(C(C(C)=O)C(C=O)=O)(O)=O,,,5,1,5,0,5
14672_1,,,,2,2,1,3
14674_0,,,,2,2,1,3
C(C(C)(C(C(C)=O)C(C=O)=O)O)=O,,,5,1,2,0,2
14674_1,,,,2,2,1,3
14676_0,,,,2,2,1,3
C(C)(C(C(C=O)=O)C(C(C)=O)O)=O,,,5,1,2,0,2
14676_1,,,,2,2,1,3
14678_0,,,,2,2,1,3
C(C)(C(C(C=O)=O)CO)=O,,,5,1,4,0,4
14678_1,,,,2,2,1,3
14680_0,,,,2,2,1,3
C(C)(C(C(C=O)=O)C(CCO)O)=O,,,5,1,2,0,2
14680_1,,,,2,2,1,3
14682_0,,,,2,2,1,3
C(C(C(C(C)=O)C(C=O)=O)O)=O,,,5,1,3,0,3
14682_1,,,,2,2,1,3
14684_0,,,,2,2,1,3
C(C)(C(C(C=O)=O)C(C)(CO)O)=O,,,5,1,2,0,2
14684_1,,,,2,2,1,3
14686_0,,,,2,2,1,3
C(C)(C(C(C=O)=O)C(C=CC)O)=O,,,5,1,2,0,2
14686_1,,,,2,2,1,3
14688_0,,,,2,2,1,3
C(C)(C(C(C=O)=O)C(CC=C)O)=O,,,5,1,2,0,2
14688_1,,,,2,2,1,3
14690_0,,,,2,2,1,3
C(C)(C(C(C=O)=O)C(CO)O)=O,,,5,1,3,0,3
14690_1,,,,2,2,1,3
14692_0,,,,2,2,1,3
C(C)(C(C(C=O)=O)C(C(C)O)O)=O,,,5,1,2,0,2
14692_1,,,,2,2,1,3
14694_0,,,,2,2,1,3
C(C(C(C(C)=O)C(C=O)=O)O)(O)=O,,,5,1,2,0,2
14694_1,,,,2,2,1,3
14696_0,,,,2,2,1,3
C(C(C=O)C(C(C=O)=O)(CC)O)=O,,,5,1,2,0,2
14696_1,,,,2,2,1,3
14698_0,,,,2,2,1,3
C(CC(C(C=O)=O)(CC)O)=O,,,5,1,1,0,1
14700_0,,,,2,2,1,3
C(C=O)(C(CC)(CC(C=O)=O)O)=O,,,5,1,1,0,1
14702_0,,,,2,2,1,3
C(C(CO)C(C(C=O)=O)(CC)O)=O,,,5,1,2,0,2
14702_1,,,,2,2,1,3
14704_0,,,,2,2,1,3
C(CC(C(C=O)=O)(CC)O)(CO)=O,,,5,1,1,0,1
14706_0,,,,2,2,1,3
C(C(C(C(C=O)=O)(CC)O)O)(C)=O,,,5,1,2,0,2
14706_1,,,,2,2,1,3
14708_0,,,,2,2,1,3
C(C(C=C)C(C(C=O)=O)(CC)O)=O,,,5,1,1,0,1
14710_0,,,,2,2,1,3
C(C(C(C(C=O)=O)(CC)O)O)=O,,,5,1,2,0,2
14710_1,,,,2,2,1,3
14712_0,,,,2,2,1,3
C(C(C=O)C(C(C(CC)=O)=O)O)=O,,,5,1,2,0,2
14712_1,,,,2,2,1,3
14714_0,,,,2,2,1,3
C(CC(C(C(CC)=O)=O)O)=O,,,5,1,2,0,2
14716_0,,,,2,2,1,3
C(C=O)(CC(C(C(CC)=O)=O)O)=O,,,5,1,1,0,1
14718_0,,,,2,2,1,3
C(C(CO)C(C(C(CC)=O)=O)O)=O,,,5,1,2,0,2
14718_1,,,,2,2,1,3
14720_0,,,,2,2,1,3
C(CC(C(C(CC)=O)=O)O)(CO)=O,,,5,1,1,0,1
14722_0,,,,2,2,1,3
C(C(C(C(C(CC)=O)=O)O)O)(C)=O,,,5,1,2,0,2
14722_1,,,,2,2,1,3
14724_0,,,,2,2,1,3
C(C(C=C)C(C(C(CC)=O)=O)O)=O,,,5,1,1,0,1
14726_0,,,,2,2,1,3
C(C(C(C(C(CC)=O)=O)O)O)=O,,,5,1,3,0,3
14726_1,,,,2,2,1,3
14728_0,,,,2,2,1,3
C(C(C=O)C(C=O)(C(CC)=O)O)=O,,,5,1,2,0,2
14728_1,,,,2,2,1,3
14730_0,,,,2,2,1,3
C(CC)(C(C=O)(CC=O)O)=O,,,5,1,2,0,2
14732_0,,,,2,2,1,3
C(CC)(C(C=O)(CC(C=O)=O)O)=O,,,5,1,1,0,1
14734_0,,,,2,2,1,3
C(CC)(C(C=O)(C(C=O)CO)O)=O,,,5,1,2,0,2
14734_1,,,,2,2,1,3
14736_0,,,,2,2,1,3
C(CC)(C(C=O)(CC(CO)=O)O)=O,,,5,1,1,0,1
14738_0,,,,2,2,1,3
C(CC)(C(C=O)(C(C(C)=O)O)O)=O,,,5,1,2,0,2
14738_1,,,,2,2,1,3
14740_0,,,,2,2,1,3
C(C(C=C)C(C=O)(C(CC)=O)O)=O,,,5,1,1,0,1
14742_0,,,,2,2,1,3
C(CC)(C(C=O)(C(C=O)O)O)=O,,,5,1,3,0,3
14742_1,,,,2,2,1,3
14743_0,,,,2,2,1,3
14745_0,,,,2,2,1,3
C(C(C=C)(C(C(C(C=O)=O)=O)C)O)=O,,,5,1,1,0,1
14747_0,,,,2,2,1,3
C=CC(C(C(C(C(C=O)=O)=O)C)O)=O,,,5,1,1,0,1
14749_0,,,,2,2,1,3
C=CC(C(C(C(C=O)=O)=O)C)O,,,5,1,1,0,1
14751_0,,,,2,2,1,3
C(C(C(C(C)C(C(O)O)O)=O)=O)=O,,,5,1,1,0,1
14753_0,,,,2,2,1,3
C(C(C(C(C)C(C)O)=O)=O)=O,,,5,1,1,0,1
14754_0,,,,2,2,1,3
14756_0,,,,2,2,1,3
C(C(C)(C(C(C(C=O)=O)=O)C)O)=O,,,5,1,1,0,1
14758_0,,,,2,2,1,3
C(C(C(C(C(C=O)=O)=O)C)O)(C)=O,,,5,1,1,0,1
14760_0,,,,2,2,1,3
C(C(C(C(C)CO)=O)=O)=O,,,5,1,3,0,3
14762_0,,,,2,2,1,3
C(C(C(C(C)C(CCO)O)=O)=O)=O,,,5,1,1,0,1
14764_0,,,,2,2,1,3
C(C(C(C(C(C=O)=O)=O)C)O)=O,,,5,1,1,0,1
14766_0,,,,2,2,1,3
C(C(C(C(C)C(C)(CO)O)=O)=O)=O,,,5,1,1,0,1
14768_0,,,,2,2,1,3
C(C)=CC(C(C(C(C=O)=O)=O)C)O,,,5,1,1,0,1
14770_0,,,,2,2,1,3
C=CCC(C(C(C(C=O)=O)=O)C)O,,,5,1,1,0,1
14772_0,,,,2,2,1,3
C(C(C(C(C)C(CO)O)=O)=O)=O,,,5,1,1,0,1
14774_0,,,,2,2,1,3
C(C(C(C(C)C(C(C)O)O)=O)=O)=O,,,5,1,1,0,1
14776_0,,,,2,2,1,3
C(C(C(C(C(C=O)=O)=O)C)O)(O)=O,,,5,1,1,0,1
14778_0,,,,2,2,1,3
C(C)(C(C(C(C(O)=O)=O)=O)CO)=O,,,5,1,2,0,2
14778_1,,,,2,2,1,3
14780_0,,,,2,2,1,3
C(CCO)(CC(C(C(O)=O)=O)=O)=O,,,5,1,1,0,1
14782_0,,,,2,2,1,3
C(C(C=O)C(C(C=O)=O)CO)(O)=O,,,5,1,1,0,1
14784_0,,,,2,2,1,3
C(C(C=O)C(C(O)=O)(CC=O)O)=O,,,5,1,2,0,2
14784_1,,,,2,2,1,3
14786_0,,,,2,2,1,3
C(C(CC=O)(CC=O)O)(O)=O,,,5,1,2,0,2
14788_0,,,,2,2,1,3
C(C(CC=O)(CC(C=O)=O)O)(O)=O,,,5,1,1,0,1
14790_0,,,,2,2,1,3
C(CC(C(O)=O)(C(C=O)CO)O)=O,,,5,1,3,0,3
14790_1,,,,2,2,1,3
14791_0,,,,2,2,1,3
14793_0,,,,2,2,1,3
C(C(CC=O)(C(C(C)=O)O)O)(O)=O,,,5,1,4,0,4
14793_1,,,,2,2,1,3
14795_0,,,,2,2,1,3
C(C(C=C)C(C(O)=O)(CC=O)O)=O,,,5,1,1,0,1
14796_0,,,,2,2,1,3
14796_1,,,,2,2,1,3
14798_0,,,,2,2,1,3
C(C(C=O)C(CC(C(O)=O)=O)O)=O,,,5,1,2,0,2
14798_1,,,,2,2,1,3
14800_0,,,,2,2,1,3
C(CC(CC(C(O)=O)=O)O)=O,,,5,1,3,0,3
14801_0,,,,2,2,1,3
14803_0,,,,2,2,1,3
C(C(CO)C(CC(C(O)=O)=O)O)=O,,,5,1,2,0,2
14803_1,,,,2,2,1,3
14805_0,,,,2,2,1,3
C(CO)(CC(CC(C(O)=O)=O)O)=O,,,5,1,1,0,1
14806_0,,,,2,2,1,3
14806_1,,,,2,2,1,3
14808_0,,,,2,2,1,3
C(C(C=C)C(CC(C(O)=O)=O)O)=O,,,5,1,1,0,1
14809_0,,,,2,2,1,3
14809_1,,,,2,2,1,3
14811_0,,,,2,2,1,3
C(C(C(C(O)=O)=O)C(CC=O)O)=O,,,5,1,2,0,2
14811_1,,,,2,2,1,3
14813_0,,,,2,2,1,3
C(C(C(C(O)=O)=O)C(C=C)O)=O,,,5,1,2,0,2
14813_1,,,,2,2,1,3
14815_0,,,,2,2,1,3
C(C(C(C(O)=O)=O)C(C(O)O)O)=O,,,5,1,2,0,2
14815_1,,,,2,2,1,3
14817_0,,,,2,2,1,3
C(C(C(C(O)=O)=O)C(C)O)=O,,,5,1,4,0,4
14817_1,,,,2,2,1,3
14819_0,,,,2,2,1,3
C(C(C(O)=O)C(C(O)=O)=O)=O,,,5,1,5,0,5
14819_1,,,,2,2,1,3
14821_0,,,,2,2,1,3
C(C(C(C(O)=O)=O)C(C=O)(C)O)=O,,,5,1,3,0,3
14821_1,,,,2,2,1,3
14823_0,,,,2,2,1,3
C(C(C(C(O)=O)=O)C(C(C)=O)O)=O,,,5,1,3,0,3
14823_1,,,,2,2,1,3
14824_0,,,,2,2,1,3
14824_1,,,,2,2,1,3
14826_0,,,,2,2,1,3
C(C(C(C(O)=O)=O)C(CCO)O)=O,,,5,1,2,0,2
14826_1,,,,2,2,1,3
14828_0,,,,2,2,1,3
C(C(C(C(O)=O)=O)C(C=O)O)=O,,,5,1,4,0,4
14828_1,,,,2,2,1,3
14830_0,,,,2,2,1,3
C(C(C(C(O)=O)=O)C(C)(CO)O)=O,,,5,1,2,0,2
14830_1,,,,2,2,1,3
14832_0,,,,2,2,1,3
C(C(C(C(O)=O)=O)C(C=CC)O)=O,,,5,1,2,0,2
14832_1,,,,2,2,1,3
14834_0,,,,2,2,1,3
C(C(C(C(O)=O)=O)C(CC=C)O)=O,,,5,1,2,0,2
14834_1,,,,2,2,1,3
14836_0,,,,2,2,1,3
C(C(C(C(O)=O)=O)C(CO)O)=O,,,5,1,4,0,4
14836_1,,,,2,2,1,3
14838_0,,,,2,2,1,3
C(C(C(C(O)=O)=O)C(C(C)O)O)=O,,,5,1,2,0,2
14838_1,,,,2,2,1,3
14840_0,,,,2,2,1,3
C(C(C(C(O)=O)=O)C(C(O)=O)O)=O,,,5,1,2,0,2
14840_1,,,,2,2,1,3
14842_0,,,,2,2,1,3
C(C(C=O)CC(CC=O)O)(O)=O,,,5,1,3,0,3
14844_0,,,,2,2,1,3
C(C(C=O)CC(C(C=O)O)O)(O)=O,,,5,1,3,0,3
14844_1,,,,2,2,1,3
14846_0,,,,2,2,1,3
C(C(C(CC=O)O)CC=O)(O)=O,,,5,1,2,0,2
14848_0,,,,2,2,1,3
C(C(C(C(C=O)O)O)CC=O)(O)=O,,,5,1,2,0,2
14848_1,,,,2,2,1,3
14850_0,,,,2,2,1,3
C(C(C=O)C(C=O)C(C=C)O)(O)=O,,,5,1,1,0,1
14851_0,,,,2,2,1,3
14852_0,,,,2,2,1,3
14854_0,,,,2,2,1,3
C(C(C=O)C(C=O)CO)(O)=O,,,5,1,5,0,5
14856_0,,,,2,2,1,3
C(C(C=O)C(C=O)C(C=O)O)(O)=O,,,5,1,1,0,1
14858_0,,,,2,2,1,3
C(C(C=O)C(C=O)C(CO)O)(O)=O,,,5,1,1,0,1
14860_0,,,,2,2,1,3
C(CC(C)(CC(C(O)=O)=O)O)=O,,,5,1,2,0,2
14861_0,,,,2,2,1,3
14861_1,,,,2,2,1,3
14863_0,,,,2,2,1,3
C(C(CC=O)(CC(C)=O)O)(O)=O,,,5,1,2,0,2
14865_0,,,,2,2,1,3
C(C(CC(C)=O)(C(C=O)O)O)(O)=O,,,5,1,3,0,3
14865_1,,,,2,2,1,3
14867_0,,,,2,2,1,3
C(CC(C=C)O)(CC(C(O)=O)=O)=O,,,5,1,1,0,1
14868_0,,,,2,2,1,3
14869_0,,,,2,2,1,3
14871_0,,,,2,2,1,3
C(CCO)(CC(C(O)=O)=O)=O,,,5,1,5,0,5
14873_0,,,,2,2,1,3
C(C(CC(CC(C(O)=O)=O)=O)O)=O,,,5,1,1,0,1
14875_0,,,,2,2,1,3
C(CC(CO)O)(CC(C(O)=O)=O)=O,,,5,1,1,0,1
14877_0,,,,2,2,1,3
C(C)(C(C(C(O)=O)=O)C(C=C)O)=O,,,5,1,2,0,2
14877_1,,,,2,2,1,3
14879_0,,,,2,2,1,3
C(C)(C(C(C(O)=O)=O)C(C)O)=O,,,5,1,5,0,5
14879_1,,,,2,2,1,3
14881_0,,,,2,2,1,3
C(C(C(C)=O)C(C(O)=O)=O)(O)=O,,,5,1,5,0,5
14881_1,,,,2,2,1,3
14883_0,,,,2,2,1,3
C(C)(C(C(C(O)=O)=O)CO)=O,,,5,1,5,0,5
14883_1,,,,2,2,1,3
14885_0,,,,2,2,1,3
C(C(C(C(C)=O)C(C(O)=O)=O)O)=O,,,5,1,2,0,2
14885_1,,,,2,2,1,3
14887_0,,,,2,2,1,3
C(C)(C(C(C(O)=O)=O)C(CO)O)=O,,,5,1,2,0,2
14887_1,,,,2,2,1,3
14889_0,,,,2,2,1,3
C(CC(C(C(O)=O)=O)(CC)O)=O,,,5,1,1,0,1
14891_0,,,,2,2,1,3
C(C(C(C(C(O)=O)=O)(CC)O)O)=O,,,5,1,3,0,3
14891_1,,,,2,2,1,3
14893_0,,,,2,2,1,3
C(CC)(C(C(O)=O)(CC=O)O)=O,,,5,1,2,0,2
14895_0,,,,2,2,1,3
C(CC)(C(C(O)=O)(C(C=O)O)O)=O,,,5,1,4,0,4
14895_1,,,,2,2,1,3
14897_0,,,,2,2,1,3
C=CC(C(C(C(C(O)=O)=O)=O)C)O,,,5,1,1,0,1
14899_0,,,,2,2,1,3
C(C(C(C(C)C(C)O)=O)=O)(O)=O,,,5,1,1,0,1
14900_0,,,,2,2,1,3
14902_0,,,,2,2,1,3
C(C(C(C(C)CO)=O)=O)(O)=O,,,5,1,3,0,3
14904_0,,,,2,2,1,3
C(C(C(C(C(C(O)=O)=O)=O)C)O)=O,,,5,1,1,0,1
14906_0,,,,2,2,1,3
C(C(C(C(C)C(CO)O)=O)=O)(O)=O,,,5,1,1,0,1
14908_0,,,,2,2,1,3
C(C(C(C(CCO)=O)=O)CO)(O)=O,,,5,1,1,0,1
14910_0,,,,2,2,1,3
C(C(CCC(C)O)(CC=O)O)(O)=O,,,5,1,1,0,1
14912_0,,,,2,2,1,3
C(C(C(CC(C)O)C(C)O)=O)(O)=O,,,5,1,2,0,2
14914_0,,,,2,2,1,3
C(C(C(C(O)=O)=O)CC(C)O)(O)=O,,,5,1,2,0,2
14916_0,,,,2,2,1,3
C(C(C(CO)CC(C)O)=O)(O)=O,,,5,1,1,0,1
14918_0,,,,2,2,1,3
C(CC(CC(C)O)(CC=O)O)(O)=O,,,5,1,1,0,1
14920_0,,,,2,2,1,3
C(C(C(CC(C)O)=O)C(C)O)(O)=O,,,5,1,2,0,2
14920_1,,,,2,2,1,3
14922_0,,,,2,2,1,3
C(C(C(O)=O)C(CC(C)O)=O)(O)=O,,,5,1,2,0,2
14922_1,,,,2,2,1,3
14923_0,,,,2,2,1,3
14923_1,,,,2,2,1,3
14925_0,,,,2,2,1,3
C(CC(C(C(C)O)C(C)O)=O)(O)=O,,,5,1,2,0,2
14925_1,,,,2,2,1,3
14927_0,,,,2,2,1,3
C(C(C(CC(O)=O)=O)C(C)O)(O)=O,,,5,1,4,0,4
14927_1,,,,2,2,1,3
14929_0,,,,2,2,1,3
C(CC(C(CO)C(C)O)=O)(O)=O,,,5,1,4,0,4
14929_1,,,,2,2,1,3
14931_0,,,,2,2,1,3
C(CCC(C(O)=O)(CC=O)O)(O)=O,,,5,1,2,0,2
14933_0,,,,2,2,1,3
C(CC(C(C(O)=O)=O)C(C)O)(O)=O,,,5,1,2,0,2
14935_0,,,,2,2,1,3
C(C(C(C(O)=O)=O)CC(O)=O)(O)=O,,,5,1,1,0,1
14937_0,,,,2,2,1,3
C(CC(C(C(O)=O)=O)CO)(O)=O,,,5,1,2,0,2
14939_0,,,,2,2,1,3
C(CC(CC(O)=O)(CC=O)O)(O)=O,,,5,1,1,0,1
14940_0,,,,2,2,1,3
14940_1,,,,2,2,1,3
14942_0,,,,2,2,1,3
C(C(C(O)=O)C(CC(O)=O)=O)(O)=O,,,5,1,2,0,2
14942_1,,,,2,2,1,3
14943_0,,,,2,2,1,3
14943_1,,,,2,2,1,3
14945_0,,,,2,2,1,3
C(CC(C(CO)=O)(CC=O)O)(O)=O,,,5,1,1,0,1
14946_0,,,,2,2,1,3
14948_0,,,,2,2,1,3
C(C(C(C(CO)=O)=O)C(C)O)(O)=O,,,5,1,3,0,3
14948_1,,,,2,2,1,3
14950_0,,,,2,2,1,3
C(C(C(O)=O)C(C(CO)=O)=O)(O)=O,,,5,1,3,0,3
14950_1,,,,2,2,1,3
14951_0,,,,2,2,1,3
14951_1,,,,2,2,1,3
14953_0,,,,2,2,1,3
C(CC(C(C(C(C)O)O)=O)=O)(O)=O,,,5,1,2,0,2
14953_1,,,,2,2,1,3
14954_0,,,,2,2,1,3
14954_1,,,,2,2,1,3
14955_0,,,,2,2,1,3
14955_1,,,,2,2,1,3
14957_0,,,,2,2,1,3
C(C(C(C(C(CO)O)=O)=O)C)(O)=O,,,5,1,2,0,2
14957_1,,,,2,2,1,3
14958_0,,,,2,2,1,3
14960_0,,,,2,2,1,3
C(CC(C(C(C(O)=O)=O)CO)O)=O,,,5,1,3,0,3
14961_0,,,,2,2,1,3
14963_0,,,,2,2,1,3
C(CC(C(O)=O)(C(C=O)C)O)=O,,,5,1,1,0,1
14965_0,,,,2,2,1,3
C(C(C(C(O)=O)(C(C=O)C)O)O)=O,,,5,1,2,0,2
14965_1,,,,2,2,1,3
14967_0,,,,2,2,1,3
C(CC(C(C(C(O)=O)=O)C)O)=O,,,5,1,3,0,3
14969_0,,,,2,2,1,3
C(C(C(C(C(C(O)=O)=O)C)O)O)=O,,,5,1,3,0,3
14969_1,,,,2,2,1,3
14971_0,,,,2,2,1,3
C(C(C)(CC=O)O)(C(C(O)=O)C)=O,,,5,1,1,0,1
14973_0,,,,2,2,1,3
C(C(C)C(C(C)=O)(CC=O)O)(O)=O,,,5,1,1,0,1
14975_0,,,,2,2,1,3
C(C(C(C(CC(C)O)=O)=O)C)(O)=O,,,5,1,1,0,1
14977_0,,,,2,2,1,3
C(C(C(C(CC(O)=O)=O)=O)C)(O)=O,,,5,1,1,0,1
14979_0,,,,2,2,1,3
C(C(C(C(CCO)=O)=O)C)(O)=O,,,5,1,2,0,2
14981_0,,,,2,2,1,3
C(C(C(CC(C(C)O)=O)O)C)(O)=O,,,5,1,1,0,1
14983_0,,,,2,2,1,3
C(C(C)C(C(C(CC)=O)O)O)(O)=O,,,5,1,2,0,2
14983_1,,,,2,2,1,3
14985_0,,,,2,2,1,3
C(C(C)C(C(C(CO)=O)C)O)(O)=O,,,5,1,1,0,1
14987_0,,,,2,2,1,3
C(C(C=O)C(C(C(O)=O)C)O)=O,,,5,1,2,0,2
14987_1,,,,2,2,1,3
14989_0,,,,2,2,1,3
C(C(C)C(C(C=O)CCO)O)(O)=O,,,5,1,1,0,1
14991_0,,,,2,2,1,3
C(C(C)C(CC=O)O)(O)=O,,,5,1,1,0,1
14993_0,,,,2,2,1,3
C(C(C)C(C(C=O)C(C)O)O)(O)=O,,,5,1,2,0,2
14993_1,,,,2,2,1,3
14995_0,,,,2,2,1,3
C(C(C=O)C(C(C(O)=O)C)O)(O)=O,,,5,1,2,0,2
14995_1,,,,2,2,1,3
14997_0,,,,2,2,1,3
C(C(C)C(C(C(C=O)=O)O)O)(O)=O,,,5,1,2,0,2
14997_1,,,,2,2,1,3
14999_0,,,,2,2,1,3
C(C(C)C(CC(C=O)=O)O)(O)=O,,,5,1,1,0,1
15001_0,,,,2,2,1,3
C(C(C)C(C(C=O)CO)O)(O)=O,,,5,1,2,0,2
15001_1,,,,2,2,1,3
15003_0,,,,2,2,1,3
C(C(C)C(C(C(CO)=O)O)O)(O)=O,,,5,1,2,0,2
15003_1,,,,2,2,1,3
15005_0,,,,2,2,1,3
C(C(C)C(CC(CO)=O)O)(O)=O,,,5,1,1,0,1
15007_0,,,,2,2,1,3
C(C(C)C(C(C(C)=O)O)O)(O)=O,,,5,1,2,0,2
15007_1,,,,2,2,1,3
15009_0,,,,2,2,1,3
C(C(C=C)C(C(C(O)=O)C)O)=O,,,5,1,1,0,1
15011_0,,,,2,2,1,3
C(C(C)C(C(C=O)O)O)(O)=O,,,5,1,2,0,2
15011_1,,,,2,2,1,3
15013_0,,,,2,2,1,3
C(C(C)C(CC(C(O)=O)=O)O)(O)=O,,,5,1,1,0,1
15015_0,,,,2,2,1,3
C(C(CC)(CC(C(C)O)=O)O)(O)=O,,,5,1,1,0,1
15017_0,,,,2,2,1,3
C(C(CC)(C(C(CC)=O)O)O)(O)=O,,,5,1,2,0,2
15017_1,,,,2,2,1,3
15019_0,,,,2,2,1,3
C(C(CC)(C(C(CO)=O)C)O)(O)=O,,,5,1,1,0,1
15021_0,,,,2,2,1,3
C(C(C=O)C(C(O)=O)(CC)O)=O,,,5,1,2,0,2
15021_1,,,,2,2,1,3
15023_0,,,,2,2,1,3
C(C(CCO)C(C(O)=O)(CC)O)=O,,,5,1,1,0,1
15025_0,,,,2,2,1,3
C(C(CC)(CC=O)O)(O)=O,,,5,1,1,0,1
15027_0,,,,2,2,1,3
C(C(C(C)O)C(C(O)=O)(CC)O)=O,,,5,1,2,0,2
15027_1,,,,2,2,1,3
15029_0,,,,2,2,1,3
C(C(C=O)C(C(O)=O)(CC)O)(O)=O,,,5,1,2,0,2
15029_1,,,,2,2,1,3
15031_0,,,,2,2,1,3
C(C(CC)(C(C(C=O)=O)O)O)(O)=O,,,5,1,2,0,2
15031_1,,,,2,2,1,3
15033_0,,,,2,2,1,3
C(C(CC)(CC(C=O)=O)O)(O)=O,,,5,1,1,0,1
15035_0,,,,2,2,1,3
C(C(CO)C(C(O)=O)(CC)O)=O,,,5,1,2,0,2
15035_1,,,,2,2,1,3
15037_0,,,,2,2,1,3
C(C(CC)(C(C(CO)=O)O)O)(O)=O,,,5,1,2,0,2
15037_1,,,,2,2,1,3
15039_0,,,,2,2,1,3
C(C(CC)(CC(CO)=O)O)(O)=O,,,5,1,1,0,1
15041_0,,,,2,2,1,3
C(C(CC)(C(C(C)=O)O)O)(O)=O,,,5,1,2,0,2
15041_1,,,,2,2,1,3
15043_0,,,,2,2,1,3
C(C(C=C)C(C(O)=O)(CC)O)=O,,,5,1,1,0,1
15045_0,,,,2,2,1,3
C(C(CC)(C(C=O)O)O)(O)=O,,,5,1,2,0,2
15045_1,,,,2,2,1,3
15047_0,,,,2,2,1,3
C(C(CC)(CC(C(O)=O)=O)O)(O)=O,,,5,1,1,0,1
15049_0,,,,2,2,1,3
C(C(C(C)C(C)(C(C)O)O)=O)(O)=O,,,5,1,1,0,1
15051_0,,,,2,2,1,3
C(C(C(C)C(CO)(CC)O)=O)(O)=O,,,5,1,1,0,1
15052_0,,,,2,2,1,3
15054_0,,,,2,2,1,3
[CH](C(O)=O)C(C(C(C(O)=O)=O)C)O,,,5,1,1,0,1
15056_0,,,,2,2,1,3
C(C(C=C)(C(C(C(O)=O)=O)C)O)=O,,,5,1,1,0,1
15058_0,,,,2,2,1,3
C=CC(C(C(C(C(O)=O)=O)C)O)=O,,,5,1,1,0,1
15060_0,,,,2,2,1,3
C=CC(C(C(C(O)=O)=O)C)O,,,5,1,1,0,1
15062_0,,,,2,2,1,3
C(C(C(C)C(C(CC)O)O)=O)(O)=O,,,5,1,1,0,1
15064_0,,,,2,2,1,3
C(C(C(C)C(CCCO)O)=O)(O)=O,,,5,1,1,0,1
15066_0,,,,2,2,1,3
C(C(C(C)C(C(O)O)O)=O)(O)=O,,,5,1,1,0,1
15068_0,,,,2,2,1,3
C(C(C(C)C(C)O)=O)(O)=O,,,5,1,1,0,1
15069_0,,,,2,2,1,3
15071_0,,,,2,2,1,3
C(C(C(C)C(CC(C)O)O)=O)(O)=O,,,5,1,1,0,1
15073_0,,,,2,2,1,3
C(CC(C(C(C(O)=O)=O)C)O)(O)=O,,,5,1,1,0,1
15075_0,,,,2,2,1,3
C(C(C(C(C(O)=O)=O)C)O)(CO)=O,,,5,1,1,0,1
15077_0,,,,2,2,1,3
C(C(CO)(C(C(C(O)=O)=O)C)O)=O,,,5,1,1,0,1
15079_0,,,,2,2,1,3
C(C(C)(C(C(C(O)=O)=O)C)O)=O,,,5,1,1,0,1
15081_0,,,,2,2,1,3
C(C(C(C(C(O)=O)=O)C)O)(C)=O,,,5,1,1,0,1
15083_0,,,,2,2,1,3
C(C(C(C)CO)=O)(O)=O,,,5,1,3,0,3
15085_0,,,,2,2,1,3
C(C(C(C)C(CCO)O)=O)(O)=O,,,5,1,1,0,1
15087_0,,,,2,2,1,3
C(C(C(C(C(O)=O)=O)C)O)=O,,,5,1,1,0,1
15088_0,,,,2,2,1,3
15090_0,,,,2,2,1,3
C(C(C(C)C(CO)(CO)O)=O)(O)=O,,,5,1,1,0,1
15092_0,,,,2,2,1,3
C(C(C(C)C(C)(CO)O)=O)(O)=O,,,5,1,1,0,1
15094_0,,,,2,2,1,3
C(C)=CC(C(C(C(O)=O)=O)C)O,,,5,1,1,0,1
15096_0,,,,2,2,1,3
C=CCC(C(C(C(O)=O)=O)C)O,,,5,1,1,0,1
15098_0,,,,2,2,1,3
C(C(C(C)C(C(CO)O)O)=O)(O)=O,,,5,1,1,0,1
15100_0,,,,2,2,1,3
C(C(C(C)C(CO)O)=O)(O)=O,,,5,1,1,0,1
15102_0,,,,2,2,1,3
C(C(C(C)C(C(C)O)O)=O)(O)=O,,,5,1,1,0,1
15104_0,,,,2,2,1,3
C(C(C(C(C(O)=O)=O)C)O)(O)=O,,,5,1,1,0,1
15106_0,,,,2,2,1,3
C(C(C)(C(C(C(O)=O)=O)C)O)(O)=O,,,5,1,1,0,1
15108_0,,,,2,2,1,3
C(C(C)C(C(O)=O)(CC=O)O)(O)=O,,,5,1,1,0,1
15110_0,,,,2,2,1,3
C(C(C(C(C(O)=O)=C)=O)CO)(O)=O,,,5,1,2,0,2
15110_1,,,,2,2,1,3
15112_0,,,,2,2,1,3
C(C(C)O)(CC(C)(C(C)O)O)=O,,,5,1,1,0,1
15114_0,,,,2,2,1,3
C(C(C(C)(C(C)O)O)O)(CC)=O,,,5,1,2,0,2
15114_1,,,,2,2,1,3
15116_0,,,,2,2,1,3
C(CO)(C(C)C(C)(C(C)O)O)=O,,,5,1,1,0,1
15118_0,,,,2,2,1,3
C(C(C=O)C(C)(C(C)O)O)=O,,,5,1,2,0,2
15118_1,,,,2,2,1,3
15120_0,,,,2,2,1,3
C(C(C(C=O)=C)C(C)(C(C)O)O)=O,,,5,1,1,0,1
15122_0,,,,2,2,1,3
C(C=CC(CC(C)(C(C)O)O)=O)=O,,,5,1,1,0,1
15124_0,,,,2,2,1,3
C=CC(C(C=O)=O)C(C)(C(C)O)O,,,5,1,1,0,1
15126_0,,,,2,2,1,3
C(C(CCO)C(C)(C(C)O)O)=O,,,5,1,1,0,1
15128_0,,,,2,2,1,3
C1(C(O)OCC1C(C)(C(C)O)O)=O,,,5,1,2,0,2
15128_1,,,,2,2,1,3
15130_0,,,,2,2,1,3
C1(C(C(CO1)C(C)(C(C)O)O)=O)=O,,,5,1,2,0,2
15130_1,,,,2,2,1,3
15132_0,,,,2,2,1,3
C(C(C(C)CO)C(C)(C(C)O)O)=O,,,5,1,1,0,1
15134_0,,,,2,2,1,3
C(CC(C)(C(C)O)O)=O,,,5,1,1,0,1
15136_0,,,,2,2,1,3
C(C(C(C)O)C(C)(C(C)O)O)=O,,,5,1,2,0,2
15136_1,,,,2,2,1,3
15138_0,,,,2,2,1,3
C(C(C=O)C(C)(C(C)O)O)(O)=O,,,5,1,2,0,2
15138_1,,,,2,2,1,3
15140_0,,,,2,2,1,3
C(C(C(C(C)(C(C)O)O)O)=O)=O,,,5,1,2,0,2
15140_1,,,,2,2,1,3
15142_0,,,,2,2,1,3
C(C(CC(C)(C(C)O)O)=O)=O,,,5,1,1,0,1
15144_0,,,,2,2,1,3
C(C(C(C(C)(C(C)O)O)O)=O)(O)=O,,,5,1,2,0,2
15144_1,,,,2,2,1,3
15146_0,,,,2,2,1,3
C(C(C(CO)C(C)(C(C)O)O)=O)=O,,,5,1,2,0,2
15146_1,,,,2,2,1,3
15148_0,,,,2,2,1,3
C(C(CO)C(C)(C(C)O)O)=O,,,5,1,2,0,2
15148_1,,,,2,2,1,3
15150_0,,,,2,2,1,3
C(CO)(C(C(C)(C(C)O)O)O)=O,,,5,1,2,0,2
15150_1,,,,2,2,1,3
15152_0,,,,2,2,1,3
C(CO)(CC(C)(C(C)O)O)=O,,,5,1,1,0,1
15154_0,,,,2,2,1,3
C(C)(C(C(C)(C(C)O)O)O)=O,,,5,1,2,0,2
15154_1,,,,2,2,1,3
15156_0,,,,2,2,1,3
C(C(C=C)C(C)(C(C)O)O)=O,,,5,1,1,0,1
15158_0,,,,2,2,1,3
C(C(C(C)(C(C)O)O)O)=O,,,5,1,2,0,2
15158_1,,,,2,2,1,3
15160_0,,,,2,2,1,3
C(C(CC(C)(C(C)O)O)=O)(O)=O,,,5,1,1,0,1
15162_0,,,,2,2,1,3
C(C(C)O)(CC(CO)(CC)O)=O,,,5,1,1,0,1
15163_0,,,,2,2,1,3
15165_0,,,,2,2,1,3
C(CC([CH]C(O)=O)O)(C(C)O)=O,,,5,1,1,0,1
15167_0,,,,2,2,1,3
C(CC(C(C(C)O)=C)O)(C(C)O)=O,,,5,1,1,0,1
15169_0,,,,2,2,1,3
C(CC(C(CO)=CC)O)(C(C)O)=O,,,5,1,1,0,1
15171_0,,,,2,2,1,3
C(CC(C=C(C=O)C)O)(C(C)O)=O,,,5,1,1,0,1
15173_0,,,,2,2,1,3
C(CC(C(C)=CC=O)O)(C(C)O)=O,,,5,1,1,0,1
15175_0,,,,2,2,1,3
C(C(C)O)(CC(CC(C=O)=C)O)=O,,,5,1,1,0,1
15177_0,,,,2,2,1,3
C(CC(C(CC=O)=C)O)(C(C)O)=O,,,5,1,1,0,1
15179_0,,,,2,2,1,3
C(CC(C=CC(C)=O)O)(C(C)O)=O,,,5,1,1,0,1
15181_0,,,,2,2,1,3
C(CC(C=CC=O)(C)O)(C(C)O)=O,,,5,1,1,0,1
15183_0,,,,2,2,1,3
C(C(C=C)(CC(C(C)O)=O)O)=O,,,5,1,1,0,1
15185_0,,,,2,2,1,3
C(CC(C(C=C)=O)O)(C(C)O)=O,,,5,1,1,0,1
15187_0,,,,2,2,1,3
C(CC(C=O)(CC=C)O)(C(C)O)=O,,,5,1,1,0,1
15189_0,,,,2,2,1,3
C(CC(C(CC=C)=O)O)(C(C)O)=O,,,5,1,1,0,1
15191_0,,,,2,2,1,3
C(C(C=CC)(CC(C(C)O)=O)O)=O,,,5,1,1,0,1
15193_0,,,,2,2,1,3
C(CC(C(C=CC)=O)O)(C(C)O)=O,,,5,1,1,0,1
15195_0,,,,2,2,1,3
C(CC(C=C)O)(C(C)O)=O,,,5,1,1,0,1
15197_0,,,,2,2,1,3
C(C(C=C)(CC(C(C)O)=O)O)(O)=O,,,5,1,1,0,1
15199_0,,,,2,2,1,3
C(C(C)O)(CC(C(CC)O)O)=O,,,5,1,1,0,1
15201_0,,,,2,2,1,3
C(C(C)O)(CC(CCCO)O)=O,,,5,1,1,0,1
15203_0,,,,2,2,1,3
C(C(C)O)(CC1(C(O)OCC1)O)=O,,,5,1,1,0,1
15205_0,,,,2,2,1,3
C1(C(CCO1)(CC(C(C)O)=O)O)=O,,,5,1,1,0,1
15207_0,,,,2,2,1,3
C(C(C)O)(CC(CC(CO)C)O)=O,,,5,1,1,0,1
15209_0,,,,2,2,1,3
C(C(C)O)(CC(C(CCO)O)O)=O,,,5,1,1,0,1
15211_0,,,,2,2,1,3
C(C(C)O)(CC(C(O)O)O)=O,,,5,1,1,0,1
15213_0,,,,2,2,1,3
C(C(C)O)(CC(C)O)=O,,,5,1,1,0,1
15214_0,,,,2,2,1,3
15216_0,,,,2,2,1,3
C(C(C)O)(CC(CC(C)O)O)=O,,,5,1,1,0,1
15218_0,,,,2,2,1,3
C(CC(CC(C(C)O)=O)O)(O)=O,,,5,1,1,0,1
15220_0,,,,2,2,1,3
C(CC(C(CO)=O)O)(C(C)O)=O,,,5,1,1,0,1
15222_0,,,,2,2,1,3
C(C(CO)(CC(C(C)O)=O)O)=O,,,5,1,1,0,1
15224_0,,,,2,2,1,3
C(C(C)(CC(C(C)O)=O)O)=O,,,5,1,1,0,1
15226_0,,,,2,2,1,3
C(CC(C(C)=O)O)(C(C)O)=O,,,5,1,1,0,1
15228_0,,,,2,2,1,3
C(C(C)O)(CCO)=O,,,5,1,3,0,3
15230_0,,,,2,2,1,3
C(C(CO)(CC(C(C)O)=O)O)(O)=O,,,5,1,1,0,1
15232_0,,,,2,2,1,3
C(C(CCO)(CC(C(C)O)=O)O)=O,,,5,1,1,0,1
15234_0,,,,2,2,1,3
C(CC(C(CCO)=O)O)(C(C)O)=O,,,5,1,1,0,1
15236_0,,,,2,2,1,3
C(C(C)O)(CC(CCO)O)=O,,,5,1,1,0,1
15238_0,,,,2,2,1,3
C(CC(C=O)O)(C(C)O)=O,,,5,1,3,0,3
15239_0,,,,2,2,1,3
15241_0,,,,2,2,1,3
C(C(C)O)(CC(C(C(O)=O)O)O)=O,,,5,1,3,0,3
15243_0,,,,2,2,1,3
C(C(C)O)(CC(CO)(CO)O)=O,,,5,1,1,0,1
15245_0,,,,2,2,1,3
C(C(C)O)(CC(CO)(C)O)=O,,,5,1,1,0,1
15247_0,,,,2,2,1,3
C(CC(C=CC)O)(C(C)O)=O,,,5,1,1,0,1
15249_0,,,,2,2,1,3
C(C(C)O)(CC(CC=C)O)=O,,,5,1,1,0,1
15251_0,,,,2,2,1,3
C(C(C)O)(CC(C(CO)O)O)=O,,,5,1,1,0,1
15253_0,,,,2,2,1,3
C(C(C)O)(CC(CO)O)=O,,,5,1,1,0,1
15255_0,,,,2,2,1,3
C(C(C)O)(CC(C(C)O)O)=O,,,5,1,1,0,1
15257_0,,,,2,2,1,3
C(CC(C(O)=O)O)(C(C)O)=O,,,5,1,5,0,5
15259_0,,,,2,2,1,3
C(C(C)(CC(C(C)O)=O)O)(O)=O,,,5,1,1,0,1
15261_0,,,,2,2,1,3
C(C(C(CO)(CC)O)O)(CC)=O,,,5,1,2,0,2
15261_1,,,,2,2,1,3
15263_0,,,,2,2,1,3
C(CO)(C(C)C(CO)(CC)O)=O,,,5,1,1,0,1
15265_0,,,,2,2,1,3
C(C(C=O)C(CO)(CC)O)=O,,,5,1,2,0,2
15265_1,,,,2,2,1,3
15267_0,,,,2,2,1,3
C(C(C(C=O)=C)C(CO)(CC)O)=O,,,5,1,1,0,1
15269_0,,,,2,2,1,3
C(C=CC(CC(CO)(CC)O)=O)=O,,,5,1,1,0,1
15271_0,,,,2,2,1,3
C=CC(C(C=O)=O)C(CO)(CC)O,,,5,1,1,0,1
15273_0,,,,2,2,1,3
C(C(CCO)C(CO)(CC)O)=O,,,5,1,1,0,1
15275_0,,,,2,2,1,3
C1(C(O)OCC1C(CO)(CC)O)=O,,,5,1,2,0,2
15275_1,,,,2,2,1,3
15277_0,,,,2,2,1,3
C1(C(C(CO1)C(CO)(CC)O)=O)=O,,,5,1,2,0,2
15277_1,,,,2,2,1,3
15279_0,,,,2,2,1,3
C(C(C(C)CO)C(CO)(CC)O)=O,,,5,1,1,0,1
15281_0,,,,2,2,1,3
C(CC(CO)(CC)O)=O,,,5,1,1,0,1
15283_0,,,,2,2,1,3
C(C(C(C)O)C(CO)(CC)O)=O,,,5,1,2,0,2
15283_1,,,,2,2,1,3
15285_0,,,,2,2,1,3
C(C(C=O)C(CO)(CC)O)(O)=O,,,5,1,2,0,2
15285_1,,,,2,2,1,3
15287_0,,,,2,2,1,3
C(C(C(C(CO)(CC)O)O)=O)=O,,,5,1,2,0,2
15287_1,,,,2,2,1,3
15289_0,,,,2,2,1,3
C(C(CC(CO)(CC)O)=O)=O,,,5,1,1,0,1
15291_0,,,,2,2,1,3
C(C(C(C(CO)(CC)O)O)=O)(O)=O,,,5,1,2,0,2
15291_1,,,,2,2,1,3
15293_0,,,,2,2,1,3
C(C(C(CO)C(CO)(CC)O)=O)=O,,,5,1,2,0,2
15293_1,,,,2,2,1,3
15295_0,,,,2,2,1,3
C(C(CO)C(CO)(CC)O)=O,,,5,1,2,0,2
15295_1,,,,2,2,1,3
15297_0,,,,2,2,1,3
C(CO)(C(C(CO)(CC)O)O)=O,,,5,1,2,0,2
15297_1,,,,2,2,1,3
15299_0,,,,2,2,1,3
C(CO)(CC(CO)(CC)O)=O,,,5,1,1,0,1
15301_0,,,,2,2,1,3
C(C)(C(C(CO)(CC)O)O)=O,,,5,1,2,0,2
15301_1,,,,2,2,1,3
15303_0,,,,2,2,1,3
C(C(C=C)C(CO)(CC)O)=O,,,5,1,1,0,1
15305_0,,,,2,2,1,3
C(C(C(CO)(CC)O)O)=O,,,5,1,2,0,2
15305_1,,,,2,2,1,3
15307_0,,,,2,2,1,3
C(C(CC(CO)(CC)O)=O)(O)=O,,,5,1,1,0,1
15309_0,,,,2,2,1,3
C(CC(C(C(CC)=O)O)O)=O,,,5,1,2,0,2
15309_1,,,,2,2,1,3
15311_0,,,,2,2,1,3
C(C(C([CH]C(O)=O)O)O)(CC)=O,,,5,1,2,0,2
15311_1,,,,2,2,1,3
15313_0,,,,2,2,1,3
C(C(C(C(C(C)O)=C)O)O)(CC)=O,,,5,1,2,0,2
15313_1,,,,2,2,1,3
15315_0,,,,2,2,1,3
C(C(C(C(CO)=CC)O)O)(CC)=O,,,5,1,2,0,2
15315_1,,,,2,2,1,3
15317_0,,,,2,2,1,3
C(C(C(C=C(C=O)C)O)O)(CC)=O,,,5,1,2,0,2
15317_1,,,,2,2,1,3
15319_0,,,,2,2,1,3
C(C(C(C(C)=CC=O)O)O)(CC)=O,,,5,1,2,0,2
15319_1,,,,2,2,1,3
15321_0,,,,2,2,1,3
C(C(C(CC(C=O)=C)O)O)(CC)=O,,,5,1,2,0,2
15321_1,,,,2,2,1,3
15323_0,,,,2,2,1,3
C(CC(C(C(C(CC)=O)O)O)=C)=O,,,5,1,2,0,2
15323_1,,,,2,2,1,3
15325_0,,,,2,2,1,3
C(C(C(C=CC(C)=O)O)O)(CC)=O,,,5,1,2,0,2
15325_1,,,,2,2,1,3
15327_0,,,,2,2,1,3
C(C(C(C=CC=O)(C)O)O)(CC)=O,,,5,1,2,0,2
15327_1,,,,2,2,1,3
15329_0,,,,2,2,1,3
C(C(C=C)(C(C(CC)=O)O)O)=O,,,5,1,2,0,2
15329_1,,,,2,2,1,3
15331_0,,,,2,2,1,3
C(C(C(C(C=C)=O)O)O)(CC)=O,,,5,1,2,0,2
15331_1,,,,2,2,1,3
15333_0,,,,2,2,1,3
C(C(C(C=O)(CC=C)O)O)(CC)=O,,,5,1,2,0,2
15333_1,,,,2,2,1,3
15335_0,,,,2,2,1,3
C(C(C(C(CC=C)=O)O)O)(CC)=O,,,5,1,2,0,2
15335_1,,,,2,2,1,3
15337_0,,,,2,2,1,3
C(C(C=CC)(C(C(CC)=O)O)O)=O,,,5,1,2,0,2
15337_1,,,,2,2,1,3
15339_0,,,,2,2,1,3
C(C(C(C(C=CC)=O)O)O)(CC)=O,,,5,1,2,0,2
15339_1,,,,2,2,1,3
15341_0,,,,2,2,1,3
C(C(C(C=C)O)O)(CC)=O,,,5,1,2,0,2
15341_1,,,,2,2,1,3
15343_0,,,,2,2,1,3
C(C(C=C)(C(C(CC)=O)O)O)(O)=O,,,5,1,2,0,2
15343_1,,,,2,2,1,3
15345_0,,,,2,2,1,3
C(C(C(C(CC)O)O)O)(CC)=O,,,5,1,2,0,2
15345_1,,,,2,2,1,3
15347_0,,,,2,2,1,3
C(C(C(CCCO)O)O)(CC)=O,,,5,1,2,0,2
15347_1,,,,2,2,1,3
15349_0,,,,2,2,1,3
C(C(C1(C(O)OCC1)O)O)(CC)=O,,,5,1,2,0,2
15349_1,,,,2,2,1,3
15351_0,,,,2,2,1,3
C1(C(CCO1)(C(C(CC)=O)O)O)=O,,,5,1,2,0,2
15351_1,,,,2,2,1,3
15353_0,,,,2,2,1,3
C(C(C(CC(CO)C)O)O)(CC)=O,,,5,1,2,0,2
15353_1,,,,2,2,1,3
15355_0,,,,2,2,1,3
C(C(C(C(CCO)O)O)O)(CC)=O,,,5,1,2,0,2
15355_1,,,,2,2,1,3
15357_0,,,,2,2,1,3
C(C(C(C(O)O)O)O)(CC)=O,,,5,1,2,0,2
15357_1,,,,2,2,1,3
15359_0,,,,2,2,1,3
C(C(C(C)O)O)(CC)=O,,,5,1,2,0,2
15359_1,,,,2,2,1,3
15360_0,,,,2,2,1,3
15360_1,,,,2,2,1,3
15362_0,,,,2,2,1,3
C(C(C(CC(C)O)O)O)(CC)=O,,,5,1,2,0,2
15362_1,,,,2,2,1,3
15364_0,,,,2,2,1,3
C(CC(C(C(CC)=O)O)O)(O)=O,,,5,1,2,0,2
15364_1,,,,2,2,1,3
15366_0,,,,2,2,1,3
C(C(C(C(CC)=O)O)O)(CO)=O,,,5,1,2,0,2
15366_1,,,,2,2,1,3
15368_0,,,,2,2,1,3
C(C(CO)(C(C(CC)=O)O)O)=O,,,5,1,2,0,2
15368_1,,,,2,2,1,3
15370_0,,,,2,2,1,3
C(C(C)(C(C(CC)=O)O)O)=O,,,5,1,2,0,2
15370_1,,,,2,2,1,3
15372_0,,,,2,2,1,3
C(C(C(C(CC)=O)O)O)(C)=O,,,5,1,2,0,2
15372_1,,,,2,2,1,3
15374_0,,,,2,2,1,3
C(C(CO)O)(CC)=O,,,5,1,2,0,2
15374_1,,,,2,2,1,3
15376_0,,,,2,2,1,3
C(C(CO)(C(C(CC)=O)O)O)(O)=O,,,5,1,2,0,2
15376_1,,,,2,2,1,3
15378_0,,,,2,2,1,3
C(C(CCO)(C(C(CC)=O)O)O)=O,,,5,1,2,0,2
15378_1,,,,2,2,1,3
15380_0,,,,2,2,1,3
C(C(C(C(CC)=O)O)O)(CCO)=O,,,5,1,2,0,2
15380_1,,,,2,2,1,3
15382_0,,,,2,2,1,3
C(C(C(CCO)O)O)(CC)=O,,,5,1,2,0,2
15382_1,,,,2,2,1,3
15384_0,,,,2,2,1,3
C(C(C(C=O)O)O)(CC)=O,,,5,1,2,0,2
15384_1,,,,2,2,1,3
15386_0,,,,2,2,1,3
C(C(C(C(C=O)O)O)O)(CC)=O,,,5,1,2,0,2
15386_1,,,,2,2,1,3
15388_0,,,,2,2,1,3
C(C(C(C(C(O)=O)O)O)O)(CC)=O,,,5,1,2,0,2
15388_1,,,,2,2,1,3
15390_0,,,,2,2,1,3
C(C(C(CO)(CO)O)O)(CC)=O,,,5,1,2,0,2
15390_1,,,,2,2,1,3
15392_0,,,,2,2,1,3
C(C(C(CO)(C)O)O)(CC)=O,,,5,1,2,0,2
15392_1,,,,2,2,1,3
15394_0,,,,2,2,1,3
C(C(C(C=CC)O)O)(CC)=O,,,5,1,2,0,2
15394_1,,,,2,2,1,3
15396_0,,,,2,2,1,3
C(C(C(CC=C)O)O)(CC)=O,,,5,1,2,0,2
15396_1,,,,2,2,1,3
15398_0,,,,2,2,1,3
C(C(C(C(CO)O)O)O)(CC)=O,,,5,1,2,0,2
15398_1,,,,2,2,1,3
15400_0,,,,2,2,1,3
C(C(C(CO)O)O)(CC)=O,,,5,1,2,0,2
15400_1,,,,2,2,1,3
15402_0,,,,2,2,1,3
C(C(C(C(C)O)O)O)(CC)=O,,,5,1,2,0,2
15402_1,,,,2,2,1,3
15404_0,,,,2,2,1,3
C(C(C(C(O)=O)O)O)(CC)=O,,,5,1,2,0,2
15404_1,,,,2,2,1,3
15406_0,,,,2,2,1,3
C(C(C)(C(C(CC)=O)O)O)(O)=O,,,5,1,2,0,2
15406_1,,,,2,2,1,3
15408_0,,,,2,2,1,3
C(CC(C(C(CO)=O)C)O)=O,,,5,1,1,0,1
15410_0,,,,2,2,1,3
C(CO)(C(C)C([CH]C(O)=O)O)=O,,,5,1,1,0,1
15412_0,,,,2,2,1,3
C(CO)(C(C)C(C(C(C)O)=C)O)=O,,,5,1,1,0,1
15414_0,,,,2,2,1,3
C(CO)(C(C)C(C(CO)=CC)O)=O,,,5,1,1,0,1
15416_0,,,,2,2,1,3
C(CO)(C(C)C(C=C(C=O)C)O)=O,,,5,1,1,0,1
15418_0,,,,2,2,1,3
C(CO)(C(C)C(C(C)=CC=O)O)=O,,,5,1,1,0,1
15420_0,,,,2,2,1,3
C(CO)(C(C)C(CC(C=O)=C)O)=O,,,5,1,1,0,1
15422_0,,,,2,2,1,3
C(CO)(C(C)C(C(CC=O)=C)O)=O,,,5,1,1,0,1
15424_0,,,,2,2,1,3
C(CO)(C(C)C(C=CC(C)=O)O)=O,,,5,1,1,0,1
15426_0,,,,2,2,1,3
C(CO)(C(C)C(C=CC=O)(C)O)=O,,,5,1,1,0,1
15428_0,,,,2,2,1,3
C(C(C=C)(C(C(CO)=O)C)O)=O,,,5,1,1,0,1
15430_0,,,,2,2,1,3
C(CO)(C(C)C(C(C=C)=O)O)=O,,,5,1,1,0,1
15432_0,,,,2,2,1,3
C(CO)(C(C)C(C=O)(CC=C)O)=O,,,5,1,1,0,1
15434_0,,,,2,2,1,3
C(CO)(C(C)C(C(CC=C)=O)O)=O,,,5,1,1,0,1
15436_0,,,,2,2,1,3
C(C(C=CC)(C(C(CO)=O)C)O)=O,,,5,1,1,0,1
15438_0,,,,2,2,1,3
C(CO)(C(C)C(C(C=CC)=O)O)=O,,,5,1,1,0,1
15440_0,,,,2,2,1,3
C(CO)(C(C)C(C=C)O)=O,,,5,1,1,0,1
15442_0,,,,2,2,1,3
C(C(C=C)(C(C(CO)=O)C)O)(O)=O,,,5,1,1,0,1
15444_0,,,,2,2,1,3
C(CO)(C(C)C(C(CC)O)O)=O,,,5,1,1,0,1
15446_0,,,,2,2,1,3
C(CO)(C(C)C(CCCO)O)=O,,,5,1,1,0,1
15448_0,,,,2,2,1,3
C(CO)(C(C)C1(C(O)OCC1)O)=O,,,5,1,1,0,1
15450_0,,,,2,2,1,3
C1(C(CCO1)(C(C(CO)=O)C)O)=O,,,5,1,1,0,1
15452_0,,,,2,2,1,3
C(CO)(C(C)C(CC(CO)C)O)=O,,,5,1,1,0,1
15454_0,,,,2,2,1,3
C(CO)(C(C)C(C(CCO)O)O)=O,,,5,1,1,0,1
15456_0,,,,2,2,1,3
C(CO)(C(C)C(C(O)O)O)=O,,,5,1,1,0,1
15458_0,,,,2,2,1,3
C(CO)(C(C)C(C)O)=O,,,5,1,1,0,1
15459_0,,,,2,2,1,3
15461_0,,,,2,2,1,3
C(CO)(C(C)C(CC(C)O)O)=O,,,5,1,1,0,1
15463_0,,,,2,2,1,3
C(CC(C(C(CO)=O)C)O)(O)=O,,,5,1,1,0,1
15465_0,,,,2,2,1,3
C(CO)(C(C)C(C(CO)=O)O)=O,,,5,1,1,0,1
15467_0,,,,2,2,1,3
C(C(CO)(C(C(CO)=O)C)O)=O,,,5,1,1,0,1
15469_0,,,,2,2,1,3
C(C(C)(C(C(CO)=O)C)O)=O,,,5,1,1,0,1
15471_0,,,,2,2,1,3
C(CO)(C(C)C(C(C)=O)O)=O,,,5,1,1,0,1
15473_0,,,,2,2,1,3
C(CO)(C(CO)C)=O,,,5,1,1,0,1
15475_0,,,,2,2,1,3
C(C(CO)(C(C(CO)=O)C)O)(O)=O,,,5,1,1,0,1
15477_0,,,,2,2,1,3
C(C(CCO)(C(C(CO)=O)C)O)=O,,,5,1,1,0,1
15479_0,,,,2,2,1,3
C(CO)(C(C)C(C(CCO)=O)O)=O,,,5,1,1,0,1
15481_0,,,,2,2,1,3
C(CO)(C(C)C(CCO)O)=O,,,5,1,1,0,1
15483_0,,,,2,2,1,3
C(CO)(C(C)C(C=O)O)=O,,,5,1,1,0,1
15485_0,,,,2,2,1,3
C(C(C(C(C(CO)=O)C)O)O)=O,,,5,1,1,0,1
15487_0,,,,2,2,1,3
C(C(C(C(C(CO)=O)C)O)O)(O)=O,,,5,1,1,0,1
15489_0,,,,2,2,1,3
C(CO)(C(C)C(CO)(CO)O)=O,,,5,1,1,0,1
15491_0,,,,2,2,1,3
C(CO)(C(C)C(CO)(C)O)=O,,,5,1,1,0,1
15493_0,,,,2,2,1,3
C(CO)(C(C)C(C=CC)O)=O,,,5,1,1,0,1
15495_0,,,,2,2,1,3
C(CO)(C(C)C(CC=C)O)=O,,,5,1,1,0,1
15497_0,,,,2,2,1,3
C(CO)(C(C)C(C(CO)O)O)=O,,,5,1,1,0,1
15499_0,,,,2,2,1,3
C(CO)(C(C)C(CO)O)=O,,,5,1,1,0,1
15501_0,,,,2,2,1,3
C(CO)(C(C)C(C(C)O)O)=O,,,5,1,1,0,1
15503_0,,,,2,2,1,3
C(CO)(C(C)C(C(O)=O)O)=O,,,5,1,1,0,1
15505_0,,,,2,2,1,3
C(C(C)(C(C(CO)=O)C)O)(O)=O,,,5,1,1,0,1
15507_0,,,,2,2,1,3
C(CC(C)(CC(C(O)=O)O)O)=O,,,5,1,2,0,2
15509_0,,,,2,2,1,3
C(C(CC(C)(C(C=O)O)O)O)(O)=O,,,5,1,2,0,2
15509_1,,,,2,2,1,3
15511_0,,,,2,2,1,3
C(C(C(C(C)=O)C(C=C)O)O)(O)=O,,,5,1,2,0,2
15511_1,,,,2,2,1,3
15513_0,,,,2,2,1,3
C(C)(C(C(C)O)C(C(O)=O)O)=O,,,5,1,3,0,3
15513_1,,,,2,2,1,3
15514_0,,,,2,2,1,3
15514_1,,,,2,2,1,3
15515_0,,,,2,2,1,3
15515_1,,,,2,2,1,3
15517_0,,,,2,2,1,3
C(C(C(C(C)=O)C(C=O)O)O)(O)=O,,,5,1,2,0,2
15517_1,,,,2,2,1,3
15519_0,,,,2,2,1,3
C(C)(C(C(CO)O)C(C(O)=O)O)=O,,,5,1,2,0,2
15519_1,,,,2,2,1,3
15521_0,,,,2,2,1,3
C(C(CC(CC(C=C)O)=O)O)(O)=O,,,5,1,1,0,1
15523_0,,,,2,2,1,3
C(CC(C(O)=O)O)(CC(C)O)=O,,,5,1,6,0,6
15524_0,,,,2,2,1,3
15525_0,,,,2,2,1,3
15527_0,,,,2,2,1,3
C(C(CC(CC(C=O)O)=O)O)(O)=O,,,5,1,1,0,1
15529_0,,,,2,2,1,3
C(CC(C(O)=O)O)(CC(CO)O)=O,,,5,1,1,0,1
15531_0,,,,2,2,1,3
C(CC=O)(C(C(C(O)=O)=O)CO)=O,,,5,1,2,0,2
15531_1,,,,2,2,1,3
15533_0,,,,2,2,1,3
C(C(C(CC(C(O)=O)=O)=O)CO)=O,,,5,1,2,0,2
15533_1,,,,2,2,1,3
15535_0,,,,2,2,1,3
C(C(C=O)C(CC=O)O)=O,,,5,1,2,0,2
15535_1,,,,2,2,1,3
15537_0,,,,2,2,1,3
C(CC(C(C=O)C=CC(C)O)O)=O,,,5,1,1,0,1
15539_0,,,,2,2,1,3
C(C(C=CC(O)=O)C(CC=O)O)=O,,,5,1,1,0,1
15541_0,,,,2,2,1,3
C(CC(C(C(C=CC=O)=O)O)O)=O,,,5,1,2,0,2
15541_1,,,,2,2,1,3
15543_0,,,,2,2,1,3
C(CC(C(C(C=O)=O)C(C=O)=C)O)=O,,,5,1,1,0,1
15545_0,,,,2,2,1,3
C(C(C(C=O)=C)C(CC=O)O)=O,,,5,1,1,0,1
15547_0,,,,2,2,1,3
C(CC(CC(C=CC(C=O)=O)=O)O)=O,,,5,1,1,0,1
15549_0,,,,2,2,1,3
C(CC(CC(C=CC=O)=O)O)=O,,,5,1,1,0,1
15551_0,,,,2,2,1,3
C(CC(C(C=C)C(C=O)=O)O)=O,,,5,1,1,0,1
15553_0,,,,2,2,1,3
C(CC(CC(C(C(O)=O)=C)=O)O)=O,,,5,1,1,0,1
15555_0,,,,2,2,1,3
C(C(C(CC=O)O)CCO)=O,,,5,1,1,0,1
15557_0,,,,2,2,1,3
C(CC(C1C(C(O)OC1)=O)O)=O,,,5,1,2,0,2
15557_1,,,,2,2,1,3
15559_0,,,,2,2,1,3
C(CC(C1C(C(O)OC1C)=O)O)=O,,,5,1,2,0,2
15559_1,,,,2,2,1,3
15561_0,,,,2,2,1,3
C(CC(C1C(OC(C1=O)O)=O)O)=O,,,5,1,2,0,2
15561_1,,,,2,2,1,3
15563_0,,,,2,2,1,3
C(CC(C1C(C(OC1)=O)=O)O)=O,,,5,1,2,0,2
15563_1,,,,2,2,1,3
15565_0,,,,2,2,1,3
C(CC(C1C(C(C(O1)=O)=O)=O)O)=O,,,5,1,2,0,2
15565_1,,,,2,2,1,3
15567_0,,,,2,2,1,3
C(C(C(CC=O)O)C(C)CO)=O,,,5,1,1,0,1
15569_0,,,,2,2,1,3
C(C(C(CC=O)O)C(C)CCO)=O,,,5,1,1,0,1
15571_0,,,,2,2,1,3
C(C(C(CC=O)O)C(C)C(C)O)=O,,,5,1,1,0,1
15573_0,,,,2,2,1,3
C(C(C(CC=O)O)C(C)CC=O)=O,,,5,1,1,0,1
15575_0,,,,2,2,1,3
C(CC(CC([C](C(O)=O)O)=O)O)=O,,,5,1,1,0,1
15577_0,,,,2,2,1,3
C(CC(CC=O)O)=O,,,5,1,2,0,2
15579_0,,,,2,2,1,3
C(C(C(CC=O)O)C(C)O)=O,,,5,1,3,0,3
15579_1,,,,2,2,1,3
15581_0,,,,2,2,1,3
C(C(C=O)C(CC=O)O)(O)=O,,,5,1,3,0,3
15581_1,,,,2,2,1,3
15583_0,,,,2,2,1,3
C(CC(C(C(C=O)=O)O)O)=O,,,5,1,3,0,3
15583_1,,,,2,2,1,3
15584_0,,,,2,2,1,3
15585_0,,,,2,2,1,3
15585_1,,,,2,2,1,3
15587_0,,,,2,2,1,3
C(CC(C(C=O)C(C=O)(C)O)O)=O,,,5,1,2,0,2
15587_1,,,,2,2,1,3
15589_0,,,,2,2,1,3
C(CC(C(C=O)C(C(C)=O)O)O)=O,,,5,1,2,0,2
15589_1,,,,2,2,1,3
15591_0,,,,2,2,1,3
C(CC(C(CC(CC=O)O)=O)O)=O,,,5,1,1,0,1
15593_0,,,,2,2,1,3
C(CC(C(C(C=O)=O)CO)O)=O,,,5,1,4,0,4
15593_1,,,,2,2,1,3
15595_0,,,,2,2,1,3
C(CC(C(C(C=O)=O)C(C)O)O)=O,,,5,1,2,0,2
15595_1,,,,2,2,1,3
15597_0,,,,2,2,1,3
C(C(C(C=O)=O)C(CC=O)O)(O)=O,,,5,1,3,0,3
15597_1,,,,2,2,1,3
15599_0,,,,2,2,1,3
C(C(CO)C(CC=O)O)=O,,,5,1,3,0,3
15599_1,,,,2,2,1,3
15600_0,,,,2,2,1,3
15600_1,,,,2,2,1,3
15602_0,,,,2,2,1,3
C(CC(C(C=O)C(C(C)=O)=O)O)=O,,,5,1,2,0,2
15602_1,,,,2,2,1,3
15604_0,,,,2,2,1,3
C(CC(C(CC(CC=O)O)=O)=O)=O,,,5,1,1,0,1
15606_0,,,,2,2,1,3
C(CC(CC(C(C(C)O)=O)=O)O)=O,,,5,1,1,0,1
15608_0,,,,2,2,1,3
C(CC(CC(C(C(O)=O)=O)=O)O)=O,,,5,1,1,0,1
15609_0,,,,2,2,1,3
15609_1,,,,2,2,1,3
15611_0,,,,2,2,1,3
C(CC(CC(CO)=O)O)=O,,,5,1,2,0,2
15612_0,,,,2,2,1,3
15612_1,,,,2,2,1,3
15614_0,,,,2,2,1,3
C(C(C(CC(CC=O)O)=O)C)(O)=O,,,5,1,1,0,1
15616_0,,,,2,2,1,3
C(C(C=C)C(CC=O)O)=O,,,5,1,2,0,2
15618_0,,,,2,2,1,3
C(CC(C(C=C)C(C(O)=O)=O)O)=O,,,5,1,1,0,1
15620_0,,,,2,2,1,3
C(C(C(C(O)=O)=C)C(CC=O)O)=O,,,5,1,1,0,1
15621_0,,,,2,2,1,3
15621_1,,,,2,2,1,3
15623_0,,,,2,2,1,3
C(CC(C1C(C(OC1C)=O)=O)O)=O,,,5,1,2,0,2
15623_1,,,,2,2,1,3
15625_0,,,,2,2,1,3
C1(C(C(C(O1)=O)=O)C(CC=O)O)=O,,,5,1,2,0,2
15625_1,,,,2,2,1,3
15627_0,,,,2,2,1,3
C(CC(C(C=O)C[CH]C(O)=O)O)=O,,,5,1,1,0,1
15629_0,,,,2,2,1,3
C(C(CCC(O)=O)C(CC=O)O)=O,,,5,1,1,0,1
15630_0,,,,2,2,1,3
15632_0,,,,2,2,1,3
C(C(C=O)C([CH]C(O)=O)O)=O,,,5,1,2,0,2
15632_1,,,,2,2,1,3
15634_0,,,,2,2,1,3
C(C(C=O)C(C=CCC(C)O)O)=O,,,5,1,2,0,2
15634_1,,,,2,2,1,3
15636_0,,,,2,2,1,3
C(C(C=O)C(CC=CC(C)O)O)=O,,,5,1,2,0,2
15636_1,,,,2,2,1,3
15638_0,,,,2,2,1,3
C(C(C=O)C(C(C(C)O)=C)O)=O,,,5,1,2,0,2
15638_1,,,,2,2,1,3
15640_0,,,,2,2,1,3
C(C(C=O)C(C(CO)=CC)O)=O,,,5,1,2,0,2
15640_1,,,,2,2,1,3
15642_0,,,,2,2,1,3
C(C(C=O)C(C(C(C)O)=CC)O)=O,,,5,1,2,0,2
15642_1,,,,2,2,1,3
15644_0,,,,2,2,1,3
C(C(C=O)C(C(C(O)=O)=CC)O)=O,,,5,1,2,0,2
15644_1,,,,2,2,1,3
15646_0,,,,2,2,1,3
C(C(C=O)C(C=CCC(O)=O)O)=O,,,5,1,2,0,2
15646_1,,,,2,2,1,3
15648_0,,,,2,2,1,3
C(C(C=O)C(CC=CC(O)=O)O)=O,,,5,1,2,0,2
15648_1,,,,2,2,1,3
15650_0,,,,2,2,1,3
C(C(C=O)C(C=CC(CO)=O)O)=O,,,5,1,2,0,2
15650_1,,,,2,2,1,3
15652_0,,,,2,2,1,3
C(C(C=O)C(C=CC=O)(CO)O)=O,,,5,1,2,0,2
15652_1,,,,2,2,1,3
15654_0,,,,2,2,1,3
C(C(C=O)C(C=C(C=O)CO)O)=O,,,5,1,2,0,2
15654_1,,,,2,2,1,3
15656_0,,,,2,2,1,3
C(C(C=O)C(C(CO)=CC=O)O)=O,,,5,1,2,0,2
15656_1,,,,2,2,1,3
15658_0,,,,2,2,1,3
C(C(C=O)C(C(C(C=C)O)=O)O)=O,,,5,1,2,0,2
15658_1,,,,2,2,1,3
15660_0,,,,2,2,1,3
C(C(C=O)C(C=O)(C(C=C)O)O)=O,,,5,1,2,0,2
15660_1,,,,2,2,1,3
15662_0,,,,2,2,1,3
C(C(C=O)C(C=O)(C=C(C=O)C)O)=O,,,5,1,2,0,2
15662_1,,,,2,2,1,3
15664_0,,,,2,2,1,3
C(C(C=O)C(C(C=C(C=O)C)=O)O)=O,,,5,1,2,0,2
15664_1,,,,2,2,1,3
15666_0,,,,2,2,1,3
C(C(C=O)C(C(C)=CC(C=O)=O)O)=O,,,5,1,2,0,2
15666_1,,,,2,2,1,3
15668_0,,,,2,2,1,3
C(C(C=O)C(C=O)(CC(C=O)=C)O)=O,,,5,1,2,0,2
15668_1,,,,2,2,1,3
15670_0,,,,2,2,1,3
C(C(C=O)C(C(CC(C=O)=C)=O)O)=O,,,5,1,2,0,2
15670_1,,,,2,2,1,3
15672_0,,,,2,2,1,3
C(C(C=O)C(C(CC(C=O)=O)=C)O)=O,,,5,1,2,0,2
15672_1,,,,2,2,1,3
15674_0,,,,2,2,1,3
C(C(C=O)C(C=C(C=O)C)O)=O,,,5,1,2,0,2
15674_1,,,,2,2,1,3
15676_0,,,,2,2,1,3
C(C(C=O)C(C(C)=CC=O)O)=O,,,5,1,2,0,2
15676_1,,,,2,2,1,3
15678_0,,,,2,2,1,3
C(C(C=O)C(CC(C=O)=C)O)=O,,,5,1,2,0,2
15678_1,,,,2,2,1,3
15680_0,,,,2,2,1,3
C(C(C=O)C(C(CC=O)=C)O)=O,,,5,1,2,0,2
15680_1,,,,2,2,1,3
15682_0,,,,2,2,1,3
C(C(C=O)C(C=O)(C=CC(C)=O)O)=O,,,5,1,2,0,2
15682_1,,,,2,2,1,3
15684_0,,,,2,2,1,3
C(C(C=O)C(C(C=CC(C)=O)=O)O)=O,,,5,1,2,0,2
15684_1,,,,2,2,1,3
15686_0,,,,2,2,1,3
C(C(C=O)C(C=CC(C=O)=O)(C)O)=O,,,5,1,2,0,2
15686_1,,,,2,2,1,3
15688_0,,,,2,2,1,3
C(C(C=O)C(C=CC(C)=O)O)=O,,,5,1,2,0,2
15688_1,,,,2,2,1,3
15690_0,,,,2,2,1,3
C(C(C=O)C(C=CC=O)(C)O)=O,,,5,1,2,0,2
15690_1,,,,2,2,1,3
15692_0,,,,2,2,1,3
C(C(C=O)C(C=O)(C=C)O)=O,,,5,1,2,0,2
15692_1,,,,2,2,1,3
15694_0,,,,2,2,1,3
C(C(C=O)C(C(C=C)=O)O)=O,,,5,1,2,0,2
15694_1,,,,2,2,1,3
15696_0,,,,2,2,1,3
C(C(C=O)C(C=O)(CC=C)O)=O,,,5,1,2,0,2
15696_1,,,,2,2,1,3
15698_0,,,,2,2,1,3
C(C(C=O)C(C(CC=C)=O)O)=O,,,5,1,2,0,2
15698_1,,,,2,2,1,3
15700_0,,,,2,2,1,3
C(C(C=O)C(C=O)(C=CC)O)=O,,,5,1,2,0,2
15700_1,,,,2,2,1,3
15702_0,,,,2,2,1,3
C(C(C=O)C(C(C=CC)=O)O)=O,,,5,1,2,0,2
15702_1,,,,2,2,1,3
15704_0,,,,2,2,1,3
C(C(C=O)C(C=C)O)=O,,,5,1,2,0,2
15704_1,,,,2,2,1,3
15706_0,,,,2,2,1,3
C(C(C=C)(C(C=O)C=O)O)(O)=O,,,5,1,2,0,2
15706_1,,,,2,2,1,3
15708_0,,,,2,2,1,3
C(C(C=O)C(C(C(O)=O)=C)(C)O)=O,,,5,1,2,0,2
15708_1,,,,2,2,1,3
15710_0,,,,2,2,1,3
C(C(C=O)C(C(CC)O)O)=O,,,5,1,2,0,2
15710_1,,,,2,2,1,3
15712_0,,,,2,2,1,3
C(C(C=O)C(CCCO)O)=O,,,5,1,2,0,2
15712_1,,,,2,2,1,3
15714_0,,,,2,2,1,3
C(C(C=O)C1(C(O)OCC1O)O)=O,,,5,1,2,0,2
15714_1,,,,2,2,1,3
15716_0,,,,2,2,1,3
C(C(C=O)C1(C(O)OCC1)O)=O,,,5,1,2,0,2
15716_1,,,,2,2,1,3
15718_0,,,,2,2,1,3
C(C(C=O)C1(C(O)OC(C)C1)O)=O,,,5,1,2,0,2
15718_1,,,,2,2,1,3
15720_0,,,,2,2,1,3
C(C(C=O)C1(C(O)OC(C1)=O)O)=O,,,5,1,2,0,2
15720_1,,,,2,2,1,3
15722_0,,,,2,2,1,3
C(C(C=O)C1(C(OCC1O)=O)O)=O,,,5,1,2,0,2
15722_1,,,,2,2,1,3
15724_0,,,,2,2,1,3
C(C(C=O)C1(C(OCC1)=O)O)=O,,,5,1,2,0,2
15724_1,,,,2,2,1,3
15726_0,,,,2,2,1,3
C(C(C=O)C1(C(C(OC1)=O)=O)O)=O,,,5,1,2,0,2
15726_1,,,,2,2,1,3
15728_0,,,,2,2,1,3
C(C(C=O)C1(C(OCC1=O)=O)O)=O,,,5,1,2,0,2
15728_1,,,,2,2,1,3
15730_0,,,,2,2,1,3
C(C(C=O)C(CC(C)CO)O)=O,,,5,1,2,0,2
15730_1,,,,2,2,1,3
15732_0,,,,2,2,1,3
C(C(C=O)C(CC(C)CCO)O)=O,,,5,1,2,0,2
15732_1,,,,2,2,1,3
15734_0,,,,2,2,1,3
C(C(C=O)C(CC(C)C(C)O)O)=O,,,5,1,2,0,2
15734_1,,,,2,2,1,3
15736_0,,,,2,2,1,3
C(C(C=O)C(CC(C)CC=O)O)=O,,,5,1,2,0,2
15736_1,,,,2,2,1,3
15738_0,,,,2,2,1,3
C(C(C=O)C([C](C(O)=O)O)(C)O)=O,,,5,1,2,0,2
15738_1,,,,2,2,1,3
15740_0,,,,2,2,1,3
C(C(C=O)C(C(CCO)O)O)=O,,,5,1,2,0,2
15740_1,,,,2,2,1,3
15742_0,,,,2,2,1,3
C(C(C=O)C(C(O)O)O)=O,,,5,1,2,0,2
15742_1,,,,2,2,1,3
15744_0,,,,2,2,1,3
C(C(C=O)C(C(O)=O)(C(C)O)O)=O,,,5,1,3,0,3
15744_1,,,,2,2,1,3
15746_0,,,,2,2,1,3
C(C(C=O)C(C)O)=O,,,5,1,6,0,6
15746_1,,,,2,2,1,3
15748_0,,,,2,2,1,3
C(C(C=O)C(O)=O)=O,,,5,1,7,0,7
15748_1,,,,2,2,1,3
15750_0,,,,2,2,1,3
C(C(C=O)C(CC(C)O)O)=O,,,5,1,3,0,3
15750_1,,,,2,2,1,3
15752_0,,,,2,2,1,3
C(C(C=O)C(CC(O)=O)O)=O,,,5,1,3,0,3
15752_1,,,,2,2,1,3
15754_0,,,,2,2,1,3
C(C(C=O)C(C(CO)=O)O)=O,,,5,1,4,0,4
15754_1,,,,2,2,1,3
15756_0,,,,2,2,1,3
C(C(C=O)C(C=O)(CO)O)=O,,,5,1,3,0,3
15756_1,,,,2,2,1,3
15758_0,,,,2,2,1,3
C(C(C=O)C(C=O)(C)O)=O,,,5,1,3,0,3
15758_1,,,,2,2,1,3
15760_0,,,,2,2,1,3
C(C(C=O)C(C(C)=O)O)=O,,,5,1,3,0,3
15760_1,,,,2,2,1,3
15762_0,,,,2,2,1,3
C(C(C=O)CO)=O,,,5,1,10,0,10
15762_1,,,,2,2,1,3
15763_0,,,,2,2,1,3
15763_1,,,,2,2,1,3
15765_0,,,,2,2,1,3
C(C(C=O)C(C(CO)C(C)O)O)=O,,,5,1,2,0,2
15765_1,,,,2,2,1,3
15767_0,,,,2,2,1,3
C(C(C=O)C(C(C(O)=O)CO)O)=O,,,5,1,2,0,2
15767_1,,,,2,2,1,3
15769_0,,,,2,2,1,3
C(C(C=O)C(C(C(CO)O)=O)O)=O,,,5,1,2,0,2
15769_1,,,,2,2,1,3
15771_0,,,,2,2,1,3
C(C(C=O)C(C=O)(C(CO)O)O)=O,,,5,1,2,0,2
15771_1,,,,2,2,1,3
15773_0,,,,2,2,1,3
C(C(C=O)C(CC(C=O)(C)O)O)=O,,,5,1,2,0,2
15773_1,,,,2,2,1,3
15775_0,,,,2,2,1,3
C(C(C=O)C(C(C)(CC=O)O)O)=O,,,5,1,2,0,2
15775_1,,,,2,2,1,3
15777_0,,,,2,2,1,3
C(C(C=O)C(CC(C(C)=O)O)O)=O,,,5,1,2,0,2
15777_1,,,,2,2,1,3
15779_0,,,,2,2,1,3
C(C(C=O)C(C)(C(CC=O)O)O)=O,,,5,1,2,0,2
15779_1,,,,2,2,1,3
15781_0,,,,2,2,1,3
C(C(C=O)C(C=O)(CCO)O)=O,,,5,1,3,0,3
15781_1,,,,2,2,1,3
15783_0,,,,2,2,1,3
C(C(C=O)C(C(CCO)=O)O)=O,,,5,1,3,0,3
15783_1,,,,2,2,1,3
15785_0,,,,2,2,1,3
C(C(C=O)C(C=O)(CC(C)O)O)=O,,,5,1,2,0,2
15785_1,,,,2,2,1,3
15787_0,,,,2,2,1,3
C(C(C=O)C(C(CC(C)O)=O)O)=O,,,5,1,2,0,2
15787_1,,,,2,2,1,3
15789_0,,,,2,2,1,3
C(C(C=O)C(C=O)(CC(O)=O)O)=O,,,5,1,2,0,2
15789_1,,,,2,2,1,3
15791_0,,,,2,2,1,3
C(C(C=O)C(C(CC(O)=O)=O)O)=O,,,5,1,2,0,2
15791_1,,,,2,2,1,3
15793_0,,,,2,2,1,3
C(C(C=O)C(CCO)O)=O,,,5,1,3,0,3
15793_1,,,,2,2,1,3
15795_0,,,,2,2,1,3
C(C(C=O)C(C(O)=O)(CCO)O)=O,,,5,1,2,0,2
15795_1,,,,2,2,1,3
15797_0,,,,2,2,1,3
C(C(C=O)C(C(C)=O)(CC=O)O)=O,,,5,1,2,0,2
15797_1,,,,2,2,1,3
15799_0,,,,2,2,1,3
C(CC(C(C)(C(C=O)C=O)O)=O)=O,,,5,1,2,0,2
15799_1,,,,2,2,1,3
15801_0,,,,2,2,1,3
C(C(C=O)C(CC(C(C)=O)=O)O)=O,,,5,1,2,0,2
15801_1,,,,2,2,1,3
15803_0,,,,2,2,1,3
C(C(C=O)C(C(C)=O)(C(C)O)O)=O,,,5,1,2,0,2
15803_1,,,,2,2,1,3
15805_0,,,,2,2,1,3
C(C(C=O)C(C(C(C)O)=O)(C)O)=O,,,5,1,2,0,2
15805_1,,,,2,2,1,3
15807_0,,,,2,2,1,3
C(C(C=O)C(C(O)=O)(C(C)=O)O)=O,,,5,1,2,0,2
15807_1,,,,2,2,1,3
15809_0,,,,2,2,1,3
C(C(C=O)C(C(C(O)=O)=O)(C)O)=O,,,5,1,2,0,2
15809_1,,,,2,2,1,3
15811_0,,,,2,2,1,3
C(C(C=O)C(C=O)O)=O,,,5,1,4,0,4
15811_1,,,,2,2,1,3
15813_0,,,,2,2,1,3
C(C(C=O)C(C(C=O)O)O)=O,,,5,1,5,0,5
15813_1,,,,2,2,1,3
15815_0,,,,2,2,1,3
C(C(C=O)C(C(C(O)=O)O)O)=O,,,5,1,7,0,7
15815_1,,,,2,2,1,3
15817_0,,,,2,2,1,3
C(C(C=O)C(CO)(CO)O)=O,,,5,1,3,0,3
15817_1,,,,2,2,1,3
15819_0,,,,2,2,1,3
C(C(C=O)C(C)(CO)O)=O,,,5,1,3,0,3
15819_1,,,,2,2,1,3
15821_0,,,,2,2,1,3
C(C(C=O)C(C(C(O)=O)(C)O)O)=O,,,5,1,2,0,2
15821_1,,,,2,2,1,3
15823_0,,,,2,2,1,3
C(C(C=O)C(C)(C(C(O)=O)C)O)=O,,,5,1,2,0,2
15823_1,,,,2,2,1,3
15825_0,,,,2,2,1,3
C(C(C=O)C(C=CC)O)=O,,,5,1,3,0,3
15825_1,,,,2,2,1,3
15827_0,,,,2,2,1,3
C(C(C=O)C(CC=C)O)=O,,,5,1,3,0,3
15827_1,,,,2,2,1,3
15829_0,,,,2,2,1,3
C(C(C=O)C(C(O)=O)(C=CC)O)=O,,,5,1,2,0,2
15829_1,,,,2,2,1,3
15831_0,,,,2,2,1,3
C(C(C=O)C(C(O)=O)(CC=C)O)=O,,,5,1,2,0,2
15831_1,,,,2,2,1,3
15833_0,,,,2,2,1,3
C(C(C=O)C(CC(C(O)=O)=C)O)=O,,,5,1,2,0,2
15833_1,,,,2,2,1,3
15835_0,,,,2,2,1,3
C(C(C=O)C(C=C(C(O)=O)C)O)=O,,,5,1,2,0,2
15835_1,,,,2,2,1,3
15837_0,,,,2,2,1,3
C(C(C=O)C(C(CO)O)O)=O,,,5,1,3,0,3
15837_1,,,,2,2,1,3
15839_0,,,,2,2,1,3
C(C(C=O)C(CO)O)=O,,,5,1,4,0,4
15839_1,,,,2,2,1,3
15841_0,,,,2,2,1,3
C(C(C=O)C1(C(OC(C)C1)=O)O)=O,,,5,1,2,0,2
15841_1,,,,2,2,1,3
15843_0,,,,2,2,1,3
C(C(C=O)C1(C(OC(C1)=O)=O)O)=O,,,5,1,2,0,2
15843_1,,,,2,2,1,3
15845_0,,,,2,2,1,3
C(C(C=O)C(CC[CH]C(O)=O)O)=O,,,5,1,2,0,2
15845_1,,,,2,2,1,3
15847_0,,,,2,2,1,3
C(C(C=O)C(CCCC(O)=O)O)=O,,,5,1,2,0,2
15847_1,,,,2,2,1,3
15849_0,,,,2,2,1,3
C(C(C=O)C(C(C)O)O)=O,,,5,1,3,0,3
15849_1,,,,2,2,1,3
15850_0,,,,2,2,1,3
15850_1,,,,2,2,1,3
15851_0,,,,2,2,1,3
15851_1,,,,2,2,1,3
15853_0,,,,2,2,1,3
C1(C(C(C(C(O)=O)(C)O1)=O)CO)=O,,,5,1,2,0,2
15853_1,,,,2,2,1,3
15855_0,,,,2,2,1,3
C1(C(C(C(C(O1)=O)(C)O)=O)CO)=O,,,5,1,2,0,2
15855_1,,,,2,2,1,3
15857_0,,,,2,2,1,3
C(C(C(C[CH]C(O)=O)=O)CO)(O)=O,,,5,1,2,0,2
15857_1,,,,2,2,1,3
15859_0,,,,2,2,1,3
C(CC(O)=O)(C([CH]C(O)=O)CO)=O,,,5,1,1,0,1
15861_0,,,,2,2,1,3
C(C(C(CCC(O)=O)=O)CO)(O)=O,,,5,1,2,0,2
15861_1,,,,2,2,1,3
15863_0,,,,2,2,1,3
C(C(CO)CC(O)=O)(CC(O)=O)=O,,,5,1,1,0,1
15865_0,,,,2,2,1,3
C(C(C(C=O)=C)C([CH]C(O)=O)O)=O,,,5,1,1,0,1
15867_0,,,,2,2,1,3
C([CH]C(CC(C=CC=O)=O)O)(O)=O,,,5,1,1,0,1
15869_0,,,,2,2,1,3
C=CC(C(C=O)=O)C([CH]C(O)=O)O,,,5,1,1,0,1
15871_0,,,,2,2,1,3
C(C(CCO)C([CH]C(O)=O)O)=O,,,5,1,1,0,1
15873_0,,,,2,2,1,3
C1(C(O)OCC1C([CH]C(O)=O)O)=O,,,5,1,2,0,2
15873_1,,,,2,2,1,3
15875_0,,,,2,2,1,3
[CH](C(O)=O)C(C1C(C(OC1)=O)=O)O,,,5,1,2,0,2
15875_1,,,,2,2,1,3
15877_0,,,,2,2,1,3
C(C(C(CO)C)C([CH]C(O)=O)O)=O,,,5,1,1,0,1
15879_0,,,,2,2,1,3
C(CC([CH]C(O)=O)O)=O,,,5,1,1,0,1
15881_0,,,,2,2,1,3
C(C(C(C)O)C([CH]C(O)=O)O)=O,,,5,1,2,0,2
15881_1,,,,2,2,1,3
15883_0,,,,2,2,1,3
C(C(C=O)C([CH]C(O)=O)O)(O)=O,,,5,1,2,0,2
15883_1,,,,2,2,1,3
15885_0,,,,2,2,1,3
C([CH]C(C(C(C=O)=O)O)O)(O)=O,,,5,1,2,0,2
15885_1,,,,2,2,1,3
15887_0,,,,2,2,1,3
C([CH]C(CC(C=O)=O)O)(O)=O,,,5,1,2,0,2
15889_0,,,,2,2,1,3
C(C(C(C([CH]C(O)=O)O)O)=O)(O)=O,,,5,1,2,0,2
15889_1,,,,2,2,1,3
15891_0,,,,2,2,1,3
[CH](C(O)=O)C(C(C(C=O)=O)CO)O,,,5,1,2,0,2
15891_1,,,,2,2,1,3
15893_0,,,,2,2,1,3
C(C(CO)C([CH]C(O)=O)O)=O,,,5,1,2,0,2
15893_1,,,,2,2,1,3
15895_0,,,,2,2,1,3
C(CO)(C(C([CH]C(O)=O)O)O)=O,,,5,1,3,0,3
15895_1,,,,2,2,1,3
15897_0,,,,2,2,1,3
C(CO)(CC([CH]C(O)=O)O)=O,,,5,1,1,0,1
15899_0,,,,2,2,1,3
C(C)(C(C([CH]C(O)=O)O)O)=O,,,5,1,3,0,3
15899_1,,,,2,2,1,3
15901_0,,,,2,2,1,3
C(C(C=C)C([CH]C(O)=O)O)=O,,,5,1,1,0,1
15903_0,,,,2,2,1,3
C(C(C([CH]C(O)=O)O)O)=O,,,5,1,3,0,3
15903_1,,,,2,2,1,3
15905_0,,,,2,2,1,3
C(C(CC([CH]C(O)=O)O)=O)(O)=O,,,5,1,2,0,2
15907_0,,,,2,2,1,3
C(CC1(C(C=C(C(O)=O)C1)=O)O)=O,,,5,1,1,0,1
15909_0,,,,2,2,1,3
C1(CC(C(O)=O)=CC1(CC=O)O)=O,,,5,1,1,0,1
15911_0,,,,2,2,1,3
C=CC(C1C(C(C=C1C(O)=O)=O)=O)O,,,5,1,1,0,1
15913_0,,,,2,2,1,3
C1(C(C=C(C(O)=O)C1C(C)O)=O)=O,,,5,1,1,0,1
15915_0,,,,2,2,1,3
C(C1C(C(C=C1C(O)=O)=O)=O)(O)=O,,,5,1,1,0,1
15917_0,,,,2,2,1,3
C1(C(C=C(C(O)=O)C1CO)=O)=O,,,5,1,2,0,2
15919_0,,,,2,2,1,3
C(C(C1C(C(C=C1C(O)=O)=O)=O)O)=O,,,5,1,1,0,1
15921_0,,,,2,2,1,3
C(C(C=CCC(C)O)(CC=O)O)=O,,,5,1,1,0,1
15923_0,,,,2,2,1,3
C(CC(C(C=CCC(C)O)=O)O)=O,,,5,1,1,0,1
15925_0,,,,2,2,1,3
C(CC(C=O)(CC=CC(C)O)O)=O,,,5,1,1,0,1
15927_0,,,,2,2,1,3
C(CC(C(CC=CC(C)O)=O)O)=O,,,5,1,1,0,1
15929_0,,,,2,2,1,3
C(C(C)O)=CC(C(C=O)=O)C(C=C)O,,,5,1,1,0,1
15931_0,,,,2,2,1,3
C(C(C(C=O)=O)C(C)O)=CC(C)O,,,5,1,1,0,1
15933_0,,,,2,2,1,3
C(C(C=CC(C)O)C(C=O)=O)(O)=O,,,5,1,1,0,1
15935_0,,,,2,2,1,3
C(C(C(C=O)=O)CO)=CC(C)O,,,5,1,2,0,2
15937_0,,,,2,2,1,3
C(CC(C=CCC(C)O)O)=O,,,5,1,2,0,2
15939_0,,,,2,2,1,3
C(CC(C)O)=CC(CC(C=O)=O)O,,,5,1,1,0,1
15941_0,,,,2,2,1,3
C(C(CO)C(C=CCC(C)O)O)=O,,,5,1,2,0,2
15941_1,,,,2,2,1,3
15943_0,,,,2,2,1,3
C(CC(C=CCC(C)O)O)(CO)=O,,,5,1,1,0,1
15945_0,,,,2,2,1,3
C(C(C(C=CCC(C)O)O)O)(C)=O,,,5,1,2,0,2
15945_1,,,,2,2,1,3
15947_0,,,,2,2,1,3
C(C(C=C)C(C=CCC(C)O)O)=O,,,5,1,1,0,1
15949_0,,,,2,2,1,3
C(C(C(C=CCC(C)O)O)O)=O,,,5,1,3,0,3
15949_1,,,,2,2,1,3
15951_0,,,,2,2,1,3
C(CC(CC=CC(C)O)O)=O,,,5,1,2,0,2
15953_0,,,,2,2,1,3
C(CC(CC(C=O)=O)O)=CC(C)O,,,5,1,1,0,1
15955_0,,,,2,2,1,3
C(C(C(CC=CC(C)O)O)CO)=O,,,5,1,2,0,2
15955_1,,,,2,2,1,3
15957_0,,,,2,2,1,3
C(CO)(CC(CC=CC(C)O)O)=O,,,5,1,1,0,1
15959_0,,,,2,2,1,3
C(C)(C(C(CC=CC(C)O)O)O)=O,,,5,1,2,0,2
15959_1,,,,2,2,1,3
15961_0,,,,2,2,1,3
C(C(C=C)C(CC=CC(C)O)O)=O,,,5,1,1,0,1
15963_0,,,,2,2,1,3
C(C(C(CC=CC(C)O)O)O)=O,,,5,1,3,0,3
15963_1,,,,2,2,1,3
15965_0,,,,2,2,1,3
C(C(C=CC(C)O)C(C=O)(C=C)O)=O,,,5,1,1,0,1
15967_0,,,,2,2,1,3
C(C(C=CC(C)O)C(C(C=C)=O)O)=O,,,5,1,1,0,1
15969_0,,,,2,2,1,3
C(C(C=CC(C)O)C(C=C)O)=O,,,5,1,1,0,1
15971_0,,,,2,2,1,3
C(C(C=CC(C)O)C(C(O)O)O)=O,,,5,1,1,0,1
15972_0,,,,2,2,1,3
15973_0,,,,2,2,1,3
15975_0,,,,2,2,1,3
C(C(C=CC(C)O)C(C=O)(C)O)=O,,,5,1,1,0,1
15977_0,,,,2,2,1,3
C(C(C=CC(C)O)C(C(C)=O)O)=O,,,5,1,1,0,1
15979_0,,,,2,2,1,3
C(C(C=CC(C)O)CO)=O,,,5,1,2,0,2
15981_0,,,,2,2,1,3
C(C(C=CC(C)O)C(CCO)O)=O,,,5,1,1,0,1
15983_0,,,,2,2,1,3
C(C(C=CC(C)O)C(C=O)O)=O,,,5,1,2,0,2
15985_0,,,,2,2,1,3
C(C(C=CC(C)O)C(CO)(C)O)=O,,,5,1,1,0,1
15987_0,,,,2,2,1,3
C(C(C=CC(C)O)C(C=CC)O)=O,,,5,1,1,0,1
15989_0,,,,2,2,1,3
C(C(C=CC(C)O)C(CC=C)O)=O,,,5,1,1,0,1
15991_0,,,,2,2,1,3
C(C(C=CC(C)O)C(CO)O)=O,,,5,1,2,0,2
15993_0,,,,2,2,1,3
C(C(C=CC(C)O)C(C(C)O)O)=O,,,5,1,1,0,1
15995_0,,,,2,2,1,3
C(C(C=CC(C)O)C(C(O)=O)O)=O,,,5,1,1,0,1
15997_0,,,,2,2,1,3
C(C(C(C(O)=O)=O)CO)=CC(C)O,,,5,1,1,0,1
15999_0,,,,2,2,1,3
C(C(C(C)O)=CC(C(CO)O)=O)=O,,,5,1,2,0,2
15999_1,,,,2,2,1,3
16001_0,,,,2,2,1,3
C(C(CO)O)(C(C(C=O)=CC)O)=O,,,5,1,2,0,2
16001_1,,,,2,2,1,3
16003_0,,,,2,2,1,3
C(CC(C(C(C=O)C(C)O)=C)O)=O,,,5,1,1,0,1
16005_0,,,,2,2,1,3
C(CC(C(C(C=O)=C)C(C)O)O)=O,,,5,1,1,0,1
16007_0,,,,2,2,1,3
C(CC(C(C)=C(C=O)C(C)O)O)=O,,,5,1,1,0,1
16009_0,,,,2,2,1,3
C(CC(C(C(C)O)=C(C=O)C)O)=O,,,5,1,1,0,1
16011_0,,,,2,2,1,3
C(CC(C(C(C=O)=CC)(C)O)O)=O,,,5,1,1,0,1
16013_0,,,,2,2,1,3
C(CC(C(C(C=O)(C)O)=CC)O)=O,,,5,1,1,0,1
16015_0,,,,2,2,1,3
C(CC(C=C(C=O)C(C)O)(C)O)=O,,,5,1,1,0,1
16017_0,,,,2,2,1,3
C(CC(C(C(C)O)=CC(C)=O)O)=O,,,5,1,1,0,1
16019_0,,,,2,2,1,3
C=CC(CC(C=C(C=O)C(C)O)=O)O,,,5,1,1,0,1
16021_0,,,,2,2,1,3
C(C=C(C=O)C(C)O)(CC(C)O)=O,,,5,1,1,0,1
16023_0,,,,2,2,1,3
C(CC(C=C(C=O)C(C)O)=O)(O)=O,,,5,1,1,0,1
16025_0,,,,2,2,1,3
C(C=C(C=O)C(C)O)(CCO)=O,,,5,1,2,0,2
16027_0,,,,2,2,1,3
C(CC(C)(C(C(C=O)=CC)O)O)=O,,,5,1,1,0,1
16029_0,,,,2,2,1,3
C(CC(C(C(C(C)=O)O)=CC)O)=O,,,5,1,1,0,1
16031_0,,,,2,2,1,3
C(CC(C=C)O)(C(C(C=O)=CC)O)=O,,,5,1,1,0,1
16033_0,,,,2,2,1,3
C(CC(C)O)(C(C(C=O)=CC)O)=O,,,5,1,1,0,1
16035_0,,,,2,2,1,3
C(CC(C(C(C=O)=CC)O)=O)(O)=O,,,5,1,1,0,1
16037_0,,,,2,2,1,3
C(CCO)(C(C(C=O)=CC)O)=O,,,5,1,2,0,2
16039_0,,,,2,2,1,3
C(C(C(C=O)=C)C(C(C(C)O)=C)O)=O,,,5,1,1,0,1
16041_0,,,,2,2,1,3
C=C(C(CC(C=CC=O)=O)O)C(C)O,,,5,1,1,0,1
16043_0,,,,2,2,1,3
C=CC(C(C=O)=O)C(C(C(C)O)=C)O,,,5,1,1,0,1
16045_0,,,,2,2,1,3
C(C(CCO)C(C(C(C)O)=C)O)=O,,,5,1,1,0,1
16047_0,,,,2,2,1,3
C(CC(C(C(C)O)=C)O)=O,,,5,1,2,0,2
16049_0,,,,2,2,1,3
C(C(C(C)O)C(C(C(C)O)=C)O)=O,,,5,1,2,0,2
16049_1,,,,2,2,1,3
16051_0,,,,2,2,1,3
C(C(C=O)C(C(C(C)O)=C)O)(O)=O,,,5,1,2,0,2
16051_1,,,,2,2,1,3
16053_0,,,,2,2,1,3
C=C(C(C(C(C=O)=O)O)O)C(C)O,,,5,1,2,0,2
16053_1,,,,2,2,1,3
16055_0,,,,2,2,1,3
C=C(C(CC(C=O)=O)O)C(C)O,,,5,1,2,0,2
16057_0,,,,2,2,1,3
C(C(CO)C(C(C(C)O)=C)O)=O,,,5,1,3,0,3
16057_1,,,,2,2,1,3
16059_0,,,,2,2,1,3
C(C(C(C(C(C)O)=C)O)O)(CO)=O,,,5,1,2,0,2
16059_1,,,,2,2,1,3
16061_0,,,,2,2,1,3
C(CC(C(C(C)O)=C)O)(CO)=O,,,5,1,2,0,2
16063_0,,,,2,2,1,3
C(C(C(C(C(C)O)=C)O)O)(C)=O,,,5,1,3,0,3
16063_1,,,,2,2,1,3
16065_0,,,,2,2,1,3
C(C(C=C)C(C(C(C)O)=C)O)=O,,,5,1,2,0,2
16067_0,,,,2,2,1,3
C(C(C(C(C(C)O)=C)O)O)=O,,,5,1,3,0,3
16067_1,,,,2,2,1,3
16069_0,,,,2,2,1,3
C=C(C(CC(C(O)=O)=O)O)C(C)O,,,5,1,1,0,1
16071_0,,,,2,2,1,3
C(C(C(C=O)=C)C(C(CO)=CC)O)=O,,,5,1,1,0,1
16073_0,,,,2,2,1,3
C(C)=C(CO)C(CC(C=CC=O)=O)O,,,5,1,1,0,1
16075_0,,,,2,2,1,3
C=CC(C(C=O)=O)C(C(CO)=CC)O,,,5,1,1,0,1
16077_0,,,,2,2,1,3
C(C(CCO)C(C(CO)=CC)O)=O,,,5,1,1,0,1
16079_0,,,,2,2,1,3
C(CC(C(CO)=CC)O)=O,,,5,1,2,0,2
16081_0,,,,2,2,1,3
C(C(C(C)O)C(C(CO)=CC)O)=O,,,5,1,2,0,2
16081_1,,,,2,2,1,3
16083_0,,,,2,2,1,3
C(C(C=O)C(C(CO)=CC)O)(O)=O,,,5,1,2,0,2
16083_1,,,,2,2,1,3
16085_0,,,,2,2,1,3
C(C)=C(CO)C(C(C(C=O)=O)O)O,,,5,1,2,0,2
16085_1,,,,2,2,1,3
16087_0,,,,2,2,1,3
C(C)=C(CO)C(CC(C=O)=O)O,,,5,1,2,0,2
16089_0,,,,2,2,1,3
C(C(CO)C(C(CO)=CC)O)=O,,,5,1,3,0,3
16089_1,,,,2,2,1,3
16091_0,,,,2,2,1,3
C(CO)(C(C(C(CO)=CC)O)O)=O,,,5,1,2,0,2
16091_1,,,,2,2,1,3
16093_0,,,,2,2,1,3
C(CO)(CC(C(CO)=CC)O)=O,,,5,1,2,0,2
16095_0,,,,2,2,1,3
C(C)(C(C(C(CO)=CC)O)O)=O,,,5,1,3,0,3
16095_1,,,,2,2,1,3
16097_0,,,,2,2,1,3
C(C(C=C)C(C(CO)=CC)O)=O,,,5,1,2,0,2
16099_0,,,,2,2,1,3
C(C(C(C(CO)=CC)O)O)=O,,,5,1,3,0,3
16099_1,,,,2,2,1,3
16101_0,,,,2,2,1,3
C(C)=C(CO)C(CC(C(O)=O)=O)O,,,5,1,1,0,1
16103_0,,,,2,2,1,3
C(CC(C(C(C)O)=CC)O)=O,,,5,1,2,0,2
16105_0,,,,2,2,1,3
C(C)=C(C(CC(C=O)=O)O)C(C)O,,,5,1,1,0,1
16107_0,,,,2,2,1,3
C(C(CO)C(C(C(C)O)=CC)O)=O,,,5,1,2,0,2
16107_1,,,,2,2,1,3
16109_0,,,,2,2,1,3
C(CC(C(C(C)O)=CC)O)(CO)=O,,,5,1,1,0,1
16111_0,,,,2,2,1,3
C(C(C(C(C(C)O)=CC)O)O)(C)=O,,,5,1,2,0,2
16111_1,,,,2,2,1,3
16113_0,,,,2,2,1,3
C(C(C=C)C(C(C(C)O)=CC)O)=O,,,5,1,1,0,1
16115_0,,,,2,2,1,3
C(C(C(C(C(C)O)=CC)O)O)=O,,,5,1,3,0,3
16115_1,,,,2,2,1,3
16117_0,,,,2,2,1,3
C(CC(C(C(O)=O)=CC)O)=O,,,5,1,2,0,2
16119_0,,,,2,2,1,3
C(C)=C(C(O)=O)C(CC(C=O)=O)O,,,5,1,1,0,1
16121_0,,,,2,2,1,3
C(C(CO)C(C(C(O)=O)=CC)O)=O,,,5,1,2,0,2
16121_1,,,,2,2,1,3
16123_0,,,,2,2,1,3
C(CO)(CC(C(C(O)=O)=CC)O)=O,,,5,1,1,0,1
16125_0,,,,2,2,1,3
C(C)(C(C(C(C(O)=O)=CC)O)O)=O,,,5,1,2,0,2
16125_1,,,,2,2,1,3
16127_0,,,,2,2,1,3
C(C(C=C)C(C(C(O)=O)=CC)O)=O,,,5,1,1,0,1
16129_0,,,,2,2,1,3
C(C(C(C(C(O)=O)=CC)O)O)=O,,,5,1,3,0,3
16129_1,,,,2,2,1,3
16131_0,,,,2,2,1,3
C(C(C(C(O)=O)=CC(C)O)CO)=O,,,5,1,1,0,1
16133_0,,,,2,2,1,3
C(C(C(C(C)O)=C)(CC=O)O)(O)=O,,,5,1,1,0,1
16135_0,,,,2,2,1,3
C(C(C(CO)=CC)(CC=O)O)(O)=O,,,5,1,1,0,1
16137_0,,,,2,2,1,3
C(C(C=CCC(O)=O)(CC=O)O)=O,,,5,1,1,0,1
16139_0,,,,2,2,1,3
C(CC=CC(C(CC=O)O)=O)(O)=O,,,5,1,1,0,1
16141_0,,,,2,2,1,3
C(CC(C=O)(CC=CC(O)=O)O)=O,,,5,1,1,0,1
16143_0,,,,2,2,1,3
C(CC(C(CC=CC(O)=O)=O)O)=O,,,5,1,1,0,1
16145_0,,,,2,2,1,3
C=CC(C(C=CC(O)=O)C(C=O)=O)O,,,5,1,1,0,1
16147_0,,,,2,2,1,3
C(C(C(C=O)=O)C(C)O)=CC(O)=O,,,5,1,1,0,1
16149_0,,,,2,2,1,3
C(C(C=CC(O)=O)C(C=O)=O)(O)=O,,,5,1,1,0,1
16151_0,,,,2,2,1,3
C(C(C(C=O)=O)CO)=CC(O)=O,,,5,1,2,0,2
16153_0,,,,2,2,1,3
C(CC=CC(CC=O)O)(O)=O,,,5,1,2,0,2
16155_0,,,,2,2,1,3
C(CC=CC(CC(C=O)=O)O)(O)=O,,,5,1,1,0,1
16157_0,,,,2,2,1,3
C(C(CO)C(C=CCC(O)=O)O)=O,,,5,1,2,0,2
16157_1,,,,2,2,1,3
16159_0,,,,2,2,1,3
C(CC=CC(CC(CO)=O)O)(O)=O,,,5,1,1,0,1
16161_0,,,,2,2,1,3
C(CC=CC(C(C(C)=O)O)O)(O)=O,,,5,1,2,0,2
16161_1,,,,2,2,1,3
16163_0,,,,2,2,1,3
C(C(C=C)C(C=CCC(O)=O)O)=O,,,5,1,1,0,1
16165_0,,,,2,2,1,3
C(CC=CC(C(C=O)O)O)(O)=O,,,5,1,3,0,3
16165_1,,,,2,2,1,3
16167_0,,,,2,2,1,3
C(CC(CC=CC(O)=O)O)=O,,,5,1,2,0,2
16169_0,,,,2,2,1,3
C(CC(CC(C=O)=O)O)=CC(O)=O,,,5,1,1,0,1
16171_0,,,,2,2,1,3
C(C(CO)C(CC=CC(O)=O)O)=O,,,5,1,2,0,2
16171_1,,,,2,2,1,3
16173_0,,,,2,2,1,3
C(CO)(CC(CC=CC(O)=O)O)=O,,,5,1,1,0,1
16175_0,,,,2,2,1,3
C(C)(C(C(CC=CC(O)=O)O)O)=O,,,5,1,2,0,2
16175_1,,,,2,2,1,3
16177_0,,,,2,2,1,3
C(C(C=C)C(CC=CC(O)=O)O)=O,,,5,1,1,0,1
16179_0,,,,2,2,1,3
C(C(C(CC=CC(O)=O)O)O)=O,,,5,1,3,0,3
16179_1,,,,2,2,1,3
16181_0,,,,2,2,1,3
C(C(C=CC(O)=O)C(C=O)(C=C)O)=O,,,5,1,1,0,1
16183_0,,,,2,2,1,3
C(C(C=CC(O)=O)C(C(C=C)=O)O)=O,,,5,1,1,0,1
16185_0,,,,2,2,1,3
C(C(C=CC(O)=O)C(C=C)O)=O,,,5,1,1,0,1
16187_0,,,,2,2,1,3
C(C(C=CC(O)=O)C(C(O)O)O)=O,,,5,1,1,0,1
16188_0,,,,2,2,1,3
16189_0,,,,2,2,1,3
16191_0,,,,2,2,1,3
C(C(C=CC(O)=O)C(C=O)(C)O)=O,,,5,1,1,0,1
16193_0,,,,2,2,1,3
C(C(C=CC(O)=O)C(C(C)=O)O)=O,,,5,1,1,0,1
16195_0,,,,2,2,1,3
C(C(C=CC(O)=O)CO)=O,,,5,1,2,0,2
16197_0,,,,2,2,1,3
C(C(C=CC(O)=O)C(CCO)O)=O,,,5,1,1,0,1
16199_0,,,,2,2,1,3
C(C(C=CC(O)=O)C(C=O)O)=O,,,5,1,2,0,2
16201_0,,,,2,2,1,3
C(C(C=CC(O)=O)C(C)(CO)O)=O,,,5,1,1,0,1
16203_0,,,,2,2,1,3
C(C(C=CC(O)=O)C(C=CC)O)=O,,,5,1,1,0,1
16205_0,,,,2,2,1,3
C(C(C=CC(O)=O)C(CC=C)O)=O,,,5,1,1,0,1
16207_0,,,,2,2,1,3
C(C(C=CC(O)=O)C(CO)O)=O,,,5,1,2,0,2
16209_0,,,,2,2,1,3
C(C(C=CC(O)=O)C(C(C)O)O)=O,,,5,1,1,0,1
16211_0,,,,2,2,1,3
C(C(C=CC(O)=O)C(C(O)=O)O)=O,,,5,1,1,0,1
16213_0,,,,2,2,1,3
C(C(C(C(O)=O)=O)CO)=CC(O)=O,,,5,1,1,0,1
16215_0,,,,2,2,1,3
C(C(C=O)=CC(C(CO)O)=O)(O)=O,,,5,1,2,0,2
16215_1,,,,2,2,1,3
16217_0,,,,2,2,1,3
C(C(C=O)C(C(CC=O)O)=C)(O)=O,,,5,1,1,0,1
16219_0,,,,2,2,1,3
C(C(C(C=O)=C)C(CC=O)O)(O)=O,,,5,1,1,0,1
16221_0,,,,2,2,1,3
C(CC(C(C)=C(C(O)=O)C=O)O)=O,,,5,1,1,0,1
16223_0,,,,2,2,1,3
C(CC(C(C(O)=O)=C(C=O)C)O)=O,,,5,1,1,0,1
16225_0,,,,2,2,1,3
C(CC(C=C(C(O)=O)C=O)(C)O)=O,,,5,1,1,0,1
16227_0,,,,2,2,1,3
C(CC(C(C(O)=O)=CC(C)=O)O)=O,,,5,1,1,0,1
16229_0,,,,2,2,1,3
C=CC(CC(C=C(C(O)=O)C=O)=O)O,,,5,1,1,0,1
16231_0,,,,2,2,1,3
C(C(C=O)=CC(CC(C)O)=O)(O)=O,,,5,1,1,0,1
16233_0,,,,2,2,1,3
C(CC(C=C(C=O)C(O)=O)=O)(O)=O,,,5,1,1,0,1
16235_0,,,,2,2,1,3
C(C(C=O)=CC(CCO)=O)(O)=O,,,5,1,2,0,2
16237_0,,,,2,2,1,3
C(C(C=CC(C(O)=O)(C)O)CO)=O,,,5,1,1,0,1
16239_0,,,,2,2,1,3
C(CC(C(C(C(O)=O)(C)O)=C)O)=O,,,5,1,1,0,1
16241_0,,,,2,2,1,3
C(CC(C(CO)=C(C(O)=O)C)O)=O,,,5,1,1,0,1
16243_0,,,,2,2,1,3
C(C(C(C(O)=O)=CC(O)=O)CO)=O,,,5,1,1,0,1
16245_0,,,,2,2,1,3
C(C(C(C(O)=O)=C)(CC=O)O)(O)=O,,,5,1,1,0,1
16247_0,,,,2,2,1,3
C(C(C=CC(CO)=O)(CC=O)O)=O,,,5,1,1,0,1
16249_0,,,,2,2,1,3
C(CC(C(C=CC(CO)=O)=O)O)=O,,,5,1,1,0,1
16251_0,,,,2,2,1,3
C(CC(C=CC(C=O)=O)(CO)O)=O,,,5,1,1,0,1
16253_0,,,,2,2,1,3
C=CC(C(C(C=CC(C=O)=O)=O)O)O,,,5,1,2,0,2
16253_1,,,,2,2,1,3
16255_0,,,,2,2,1,3
C(C(C=CC(C(C(C)O)O)=O)=O)=O,,,5,1,2,0,2
16255_1,,,,2,2,1,3
16257_0,,,,2,2,1,3
C(C(C(C=CC(C=O)=O)=O)O)(O)=O,,,5,1,2,0,2
16257_1,,,,2,2,1,3
16259_0,,,,2,2,1,3
C(C(C=CC(C(CO)O)=O)=O)=O,,,5,1,3,0,3
16259_1,,,,2,2,1,3
16261_0,,,,2,2,1,3
C(CC(C=CC(CO)=O)O)=O,,,5,1,2,0,2
16263_0,,,,2,2,1,3
C(C(CC(C=O)=O)O)=CC(CO)=O,,,5,1,1,0,1
16265_0,,,,2,2,1,3
C(C(CO)C(C=CC(CO)=O)O)=O,,,5,1,2,0,2
16265_1,,,,2,2,1,3
16267_0,,,,2,2,1,3
C(CO)(CC(C=CC(CO)=O)O)=O,,,5,1,1,0,1
16269_0,,,,2,2,1,3
C(C)(C(C(C=CC(CO)=O)O)O)=O,,,5,1,2,0,2
16269_1,,,,2,2,1,3
16271_0,,,,2,2,1,3
C(C(C=C)C(C=CC(CO)=O)O)=O,,,5,1,1,0,1
16273_0,,,,2,2,1,3
C(C(C(C=CC(CO)=O)O)O)=O,,,5,1,3,0,3
16273_1,,,,2,2,1,3
16275_0,,,,2,2,1,3
C(CC(C=CC=O)(CO)O)=O,,,5,1,2,0,2
16277_0,,,,2,2,1,3
C(C(CO)(CC(C=O)=O)O)=CC=O,,,5,1,1,0,1
16279_0,,,,2,2,1,3
C(C(CO)C(C=CC=O)(CO)O)=O,,,5,1,2,0,2
16279_1,,,,2,2,1,3
16281_0,,,,2,2,1,3
C(CC(C=CC=O)(CO)O)(CO)=O,,,5,1,1,0,1
16283_0,,,,2,2,1,3
C(C(C(C=CC=O)(CO)O)O)(C)=O,,,5,1,2,0,2
16283_1,,,,2,2,1,3
16285_0,,,,2,2,1,3
C(C(C=C)C(C=CC=O)(CO)O)=O,,,5,1,1,0,1
16287_0,,,,2,2,1,3
C(C(C(C=CC=O)(CO)O)O)=O,,,5,1,3,0,3
16287_1,,,,2,2,1,3
16289_0,,,,2,2,1,3
C(C(C=C)(C(C(C=CC=O)=O)O)O)=O,,,5,1,2,0,2
16289_1,,,,2,2,1,3
16291_0,,,,2,2,1,3
C=CC(C(C(C(C=CC=O)=O)O)O)=O,,,5,1,2,0,2
16291_1,,,,2,2,1,3
16293_0,,,,2,2,1,3
C=CC(C(C(C=CC=O)=O)O)O,,,5,1,2,0,2
16293_1,,,,2,2,1,3
16295_0,,,,2,2,1,3
C(C=CC(C(C(C(O)O)O)O)=O)=O,,,5,1,2,0,2
16295_1,,,,2,2,1,3
16297_0,,,,2,2,1,3
C(C=CC(C(C(C)O)O)=O)=O,,,5,1,3,0,3
16297_1,,,,2,2,1,3
16299_0,,,,2,2,1,3
C(C(C(C=CC=O)=O)O)(O)=O,,,5,1,3,0,3
16299_1,,,,2,2,1,3
16301_0,,,,2,2,1,3
C(C(C)(C(C(C=CC=O)=O)O)O)=O,,,5,1,2,0,2
16301_1,,,,2,2,1,3
16303_0,,,,2,2,1,3
C(C)(C(C(C(C=CC=O)=O)O)O)=O,,,5,1,2,0,2
16303_1,,,,2,2,1,3
16305_0,,,,2,2,1,3
C(C=CC(C(CO)O)=O)=O,,,5,1,3,0,3
16305_1,,,,2,2,1,3
16307_0,,,,2,2,1,3
C(C=CC(C(C(CCO)O)O)=O)=O,,,5,1,2,0,2
16307_1,,,,2,2,1,3
16309_0,,,,2,2,1,3
C(C(C(C(C=CC=O)=O)O)O)=O,,,5,1,3,0,3
16309_1,,,,2,2,1,3
16311_0,,,,2,2,1,3
C(C=CC(C(C(CO)(C)O)O)=O)=O,,,5,1,2,0,2
16311_1,,,,2,2,1,3
16313_0,,,,2,2,1,3
C(C(C(C(C=CC=O)=O)O)O)=CC,,,5,1,2,0,2
16313_1,,,,2,2,1,3
16315_0,,,,2,2,1,3
C(CC(C(C(C=CC=O)=O)O)O)=C,,,5,1,2,0,2
16315_1,,,,2,2,1,3
16317_0,,,,2,2,1,3
C(C=CC(C(C(CO)O)O)=O)=O,,,5,1,3,0,3
16317_1,,,,2,2,1,3
16319_0,,,,2,2,1,3
C(C=CC(C(C(C(C)O)O)O)=O)=O,,,5,1,2,0,2
16319_1,,,,2,2,1,3
16321_0,,,,2,2,1,3
C(C(C(C(C=CC=O)=O)O)O)(O)=O,,,5,1,2,0,2
16321_1,,,,2,2,1,3
16323_0,,,,2,2,1,3
C(C(C=CC(C(CO)O)=O)=O)(O)=O,,,5,1,2,0,2
16323_1,,,,2,2,1,3
16325_0,,,,2,2,1,3
C(C(C=C(C=O)CO)(CC=O)O)=O,,,5,1,1,0,1
16327_0,,,,2,2,1,3
C(CC(C(C=C(C=O)CO)=O)O)=O,,,5,1,1,0,1
16329_0,,,,2,2,1,3
C(CC(C(CO)=CC(C=O)=O)O)=O,,,5,1,1,0,1
16331_0,,,,2,2,1,3
C(CC(C=C(C=O)CO)O)=O,,,5,1,2,0,2
16333_0,,,,2,2,1,3
C(C(CC(C=O)=O)O)=C(C=O)CO,,,5,1,1,0,1
16335_0,,,,2,2,1,3
C(C(CO)C(C=C(C=O)CO)O)=O,,,5,1,2,0,2
16335_1,,,,2,2,1,3
16337_0,,,,2,2,1,3
C(CO)(CC(C=C(C=O)CO)O)=O,,,5,1,1,0,1
16339_0,,,,2,2,1,3
C(C)(C(C(C=C(C=O)CO)O)O)=O,,,5,1,2,0,2
16339_1,,,,2,2,1,3
16341_0,,,,2,2,1,3
C(C(C=C)C(C=C(C=O)CO)O)=O,,,5,1,1,0,1
16343_0,,,,2,2,1,3
C(C(C(C=C(C=O)CO)O)O)=O,,,5,1,3,0,3
16343_1,,,,2,2,1,3
16345_0,,,,2,2,1,3
C(CC(C(CO)=CC=O)O)=O,,,5,1,2,0,2
16347_0,,,,2,2,1,3
C(CO)(C(CC(C=O)=O)O)=CC=O,,,5,1,1,0,1
16349_0,,,,2,2,1,3
C(C(CO)C(C(CO)=CC=O)O)=O,,,5,1,2,0,2
16349_1,,,,2,2,1,3
16351_0,,,,2,2,1,3
C(CO)(CC(C(CO)=CC=O)O)=O,,,5,1,1,0,1
16353_0,,,,2,2,1,3
C(C)(C(C(C(CO)=CC=O)O)O)=O,,,5,1,2,0,2
16353_1,,,,2,2,1,3
16355_0,,,,2,2,1,3
C(C(C=C)C(C(CO)=CC=O)O)=O,,,5,1,1,0,1
16357_0,,,,2,2,1,3
C(C(C(C(CO)=CC=O)O)O)=O,,,5,1,3,0,3
16357_1,,,,2,2,1,3
16359_0,,,,2,2,1,3
C(CC(C(C(C(C=O)=O)O)=C)O)=O,,,5,1,1,0,1
16361_0,,,,2,2,1,3
C(CC(C(C(C(C=O)=C)O)=O)O)=O,,,5,1,1,0,1
16363_0,,,,2,2,1,3
C(CC(C=O)(C(C(C=O)=C)O)O)=O,,,5,1,1,0,1
16365_0,,,,2,2,1,3
C(CC(C(C(C=C)O)=O)O)=O,,,5,1,2,0,2
16367_0,,,,2,2,1,3
C(C(CC(C=O)=O)O)(C(C=C)O)=O,,,5,1,1,0,1
16369_0,,,,2,2,1,3
C(C(CO)C(C(C(C=C)O)=O)O)=O,,,5,1,2,0,2
16369_1,,,,2,2,1,3
16371_0,,,,2,2,1,3
C(C(CC(CO)=O)O)(C(C=C)O)=O,,,5,1,1,0,1
16373_0,,,,2,2,1,3
C(C(C(C(C)=O)O)O)(C(C=C)O)=O,,,5,1,2,0,2
16373_1,,,,2,2,1,3
16375_0,,,,2,2,1,3
C(C(C=C)C(C(C(C=C)O)=O)O)=O,,,5,1,1,0,1
16377_0,,,,2,2,1,3
C(C(C(C(C(C=C)O)=O)O)O)=O,,,5,1,3,0,3
16377_1,,,,2,2,1,3
16379_0,,,,2,2,1,3
C(CC(C=O)(C(C=C)O)O)=O,,,5,1,3,0,3
16381_0,,,,2,2,1,3
C(C(CC(C=O)=O)(C(C=C)O)O)=O,,,5,1,2,0,2
16383_0,,,,2,2,1,3
C(C(CO)C(C=O)(C(C=C)O)O)=O,,,5,1,3,0,3
16383_1,,,,2,2,1,3
16385_0,,,,2,2,1,3
C(C(CC(CO)=O)(C(C=C)O)O)=O,,,5,1,2,0,2
16387_0,,,,2,2,1,3
C(C(C(C=C)O)(C(C(C)=O)O)O)=O,,,5,1,4,0,4
16387_1,,,,2,2,1,3
16389_0,,,,2,2,1,3
C(C(C=C)C(C=O)(C(C=C)O)O)=O,,,5,1,2,0,2
16391_0,,,,2,2,1,3
C(C(C(C=O)(C(C=C)O)O)O)=O,,,5,1,5,0,5
16391_1,,,,2,2,1,3
16393_0,,,,2,2,1,3
C(C(C=C(C=O)C)(CC=O)O)=O,,,5,1,2,0,2
16395_0,,,,2,2,1,3
C(C(C=C(C=O)C)(CC(C=O)=O)O)=O,,,5,1,1,0,1
16397_0,,,,2,2,1,3
C(C(C=C)C(C=O)(C=C(C=O)C)O)=O,,,5,1,1,0,1
16399_0,,,,2,2,1,3
C(C(C=C(C=O)C)(C(C=O)O)O)=O,,,5,1,2,0,2
16399_1,,,,2,2,1,3
16401_0,,,,2,2,1,3
C(CC(C(C=C(C=O)C)=O)O)=O,,,5,1,2,0,2
16403_0,,,,2,2,1,3
C(C(C)=CC(C(CC(C=O)=O)O)=O)=O,,,5,1,1,0,1
16405_0,,,,2,2,1,3
C(C(C=C)C(C(C=C(C=O)C)=O)O)=O,,,5,1,1,0,1
16407_0,,,,2,2,1,3
C(C(C(C(C=C(C=O)C)=O)O)O)=O,,,5,1,2,0,2
16407_1,,,,2,2,1,3
16409_0,,,,2,2,1,3
C(CC(C(C)=CC(C=O)=O)O)=O,,,5,1,2,0,2
16411_0,,,,2,2,1,3
C(C)(C(CC(C=O)=O)O)=CC(C=O)=O,,,5,1,1,0,1
16413_0,,,,2,2,1,3
C(C(C=C)C(C(C)=CC(C=O)=O)O)=O,,,5,1,1,0,1
16415_0,,,,2,2,1,3
C(C(C(C(C)=CC(C=O)=O)O)O)=O,,,5,1,2,0,2
16415_1,,,,2,2,1,3
16417_0,,,,2,2,1,3
C(CC(C=O)(CC(C=O)=C)O)=O,,,5,1,2,0,2
16419_0,,,,2,2,1,3
C(C(CC(C=O)=O)(CC(C=O)=C)O)=O,,,5,1,1,0,1
16421_0,,,,2,2,1,3
C(C(C=C)C(C=O)(CC(C=O)=C)O)=O,,,5,1,1,0,1
16423_0,,,,2,2,1,3
C(C(C(C=O)(CC(C=O)=C)O)O)=O,,,5,1,2,0,2
16423_1,,,,2,2,1,3
16425_0,,,,2,2,1,3
C(CC(C(CC(C=O)=C)=O)O)=O,,,5,1,2,0,2
16427_0,,,,2,2,1,3
C(C(CC(C=O)=O)O)(CC(C=O)=C)=O,,,5,1,1,0,1
16429_0,,,,2,2,1,3
C(C(C=C)C(C(CC(C=O)=C)=O)O)=O,,,5,1,1,0,1
16431_0,,,,2,2,1,3
C(C(C(C(CC(C=O)=C)=O)O)O)=O,,,5,1,2,0,2
16431_1,,,,2,2,1,3
16433_0,,,,2,2,1,3
C(CC(C(CC(C=O)=O)=C)O)=O,,,5,1,2,0,2
16435_0,,,,2,2,1,3
C=C(C(CC(C=O)=O)O)CC(C=O)=O,,,5,1,1,0,1
16437_0,,,,2,2,1,3
C(C(C=C)C(C(CC(C=O)=O)=C)O)=O,,,5,1,1,0,1
16439_0,,,,2,2,1,3
C(C(C(C(CC(C=O)=O)=C)O)O)=O,,,5,1,2,0,2
16439_1,,,,2,2,1,3
16441_0,,,,2,2,1,3
C=CC(C(C(C=O)=O)C(C=O)=C)O,,,5,1,1,0,1
16443_0,,,,2,2,1,3
C=C(C=O)C(C(C=O)=O)C(C)O,,,5,1,2,0,2
16445_0,,,,2,2,1,3
C(C(C(C=O)=O)C(C=O)=C)(O)=O,,,5,1,2,0,2
16447_0,,,,2,2,1,3
C(C(C)(C(C(C=O)=O)C(C=O)=C)O)=O,,,5,1,1,0,1
16449_0,,,,2,2,1,3
C(C)(C(C(C(C=O)=O)C(C=O)=C)O)=O,,,5,1,1,0,1
16451_0,,,,2,2,1,3
C=C(C=O)C(C(C=O)=O)CO,,,5,1,2,0,2
16453_0,,,,2,2,1,3
C(C(C(C(C=O)=O)C(C=O)=C)O)=O,,,5,1,1,0,1
16455_0,,,,2,2,1,3
C=C(C=O)C(C(C=O)=O)C(C=CC)O,,,5,1,1,0,1
16457_0,,,,2,2,1,3
C=CCC(C(C(C=O)=O)C(C=O)=C)O,,,5,1,1,0,1
16459_0,,,,2,2,1,3
C=C(C=O)C(C(C=O)=O)C(CO)O,,,5,1,1,0,1
16461_0,,,,2,2,1,3
C(C(C(C=O)=C)C(C=C(C=O)C)O)=O,,,5,1,1,0,1
16463_0,,,,2,2,1,3
C(C(CC(C=CC=O)=O)O)=C(C=O)C,,,5,1,1,0,1
16465_0,,,,2,2,1,3
C=CC(C(C=O)=O)C(C=C(C=O)C)O,,,5,1,1,0,1
16467_0,,,,2,2,1,3
C(C(CCO)C(C=C(C=O)C)O)=O,,,5,1,1,0,1
16469_0,,,,2,2,1,3
C(C(C1C(C(OC1)=O)=O)O)=C(C=O)C,,,5,1,2,0,2
16469_1,,,,2,2,1,3
16471_0,,,,2,2,1,3
C(CC(C=C(C=O)C)O)=O,,,5,1,2,0,2
16473_0,,,,2,2,1,3
C(C(C(C)O)C(C=C(C=O)C)O)=O,,,5,1,2,0,2
16473_1,,,,2,2,1,3
16475_0,,,,2,2,1,3
C(C(C=O)C(C=C(C=O)C)O)(O)=O,,,5,1,2,0,2
16475_1,,,,2,2,1,3
16477_0,,,,2,2,1,3
C(C(C(C(C=O)=O)O)O)=C(C=O)C,,,5,1,2,0,2
16477_1,,,,2,2,1,3
16479_0,,,,2,2,1,3
C(C(CC(C=O)=O)O)=C(C=O)C,,,5,1,2,0,2
16481_0,,,,2,2,1,3
C(C(CO)C(C=C(C=O)C)O)=O,,,5,1,3,0,3
16481_1,,,,2,2,1,3
16483_0,,,,2,2,1,3
C(CO)(C(C(C=C(C=O)C)O)O)=O,,,5,1,2,0,2
16483_1,,,,2,2,1,3
16485_0,,,,2,2,1,3
C(CO)(CC(C=C(C=O)C)O)=O,,,5,1,2,0,2
16487_0,,,,2,2,1,3
C(C)(C(C(C=C(C=O)C)O)O)=O,,,5,1,3,0,3
16487_1,,,,2,2,1,3
16489_0,,,,2,2,1,3
C(C(C=C)C(C=C(C=O)C)O)=O,,,5,1,2,0,2
16491_0,,,,2,2,1,3
C(C(C(C=C(C=O)C)O)O)=O,,,5,1,3,0,3
16491_1,,,,2,2,1,3
16493_0,,,,2,2,1,3
C(C(CC(C(O)=O)=O)O)=C(C=O)C,,,5,1,1,0,1
16495_0,,,,2,2,1,3
C(C(C(C=O)=C)C(C(C)=CC=O)O)=O,,,5,1,1,0,1
16497_0,,,,2,2,1,3
C(C)(C(CC(C=CC=O)=O)O)=CC=O,,,5,1,1,0,1
16499_0,,,,2,2,1,3
C=CC(C(C=O)=O)C(C(C)=CC=O)O,,,5,1,1,0,1
16501_0,,,,2,2,1,3
C(C(CCO)C(C(C)=CC=O)O)=O,,,5,1,1,0,1
16503_0,,,,2,2,1,3
C(C(C1C(C(OC1)=O)=O)O)(C)=CC=O,,,5,1,2,0,2
16503_1,,,,2,2,1,3
16505_0,,,,2,2,1,3
C(CC(C(C)=CC=O)O)=O,,,5,1,2,0,2
16507_0,,,,2,2,1,3
C(C(C(C)O)C(C(C)=CC=O)O)=O,,,5,1,2,0,2
16507_1,,,,2,2,1,3
16509_0,,,,2,2,1,3
C(C(C=O)C(C(C)=CC=O)O)(O)=O,,,5,1,2,0,2
16509_1,,,,2,2,1,3
16511_0,,,,2,2,1,3
C(C)(C(C(C(C=O)=O)O)O)=CC=O,,,5,1,2,0,2
16511_1,,,,2,2,1,3
16513_0,,,,2,2,1,3
C(C)(C(CC(C=O)=O)O)=CC=O,,,5,1,2,0,2
16515_0,,,,2,2,1,3
C(C(CO)C(C(C)=CC=O)O)=O,,,5,1,3,0,3
16515_1,,,,2,2,1,3
16517_0,,,,2,2,1,3
C(CO)(C(C(C(C)=CC=O)O)O)=O,,,5,1,2,0,2
16517_1,,,,2,2,1,3
16519_0,,,,2,2,1,3
C(CO)(CC(C(C)=CC=O)O)=O,,,5,1,2,0,2
16521_0,,,,2,2,1,3
C(C)(C(C(C(C)=CC=O)O)O)=O,,,5,1,3,0,3
16521_1,,,,2,2,1,3
16523_0,,,,2,2,1,3
C(C(C=C)C(C(C)=CC=O)O)=O,,,5,1,2,0,2
16525_0,,,,2,2,1,3
C(C(C(C(C)=CC=O)O)O)=O,,,5,1,3,0,3
16525_1,,,,2,2,1,3
16527_0,,,,2,2,1,3
C(C)(C(CC(C(O)=O)=O)O)=CC=O,,,5,1,1,0,1
16529_0,,,,2,2,1,3
C(C(C(C=O)=C)C(CC(C=O)=C)O)=O,,,5,1,1,0,1
16531_0,,,,2,2,1,3
C=C(C=O)CC(CC(C=CC=O)=O)O,,,5,1,1,0,1
16533_0,,,,2,2,1,3
C=CC(C(C=O)=O)C(CC(C=O)=C)O,,,5,1,1,0,1
16535_0,,,,2,2,1,3
C(C(C(CC(C=O)=C)O)CCO)=O,,,5,1,1,0,1
16537_0,,,,2,2,1,3
C=C(C=O)CC(C1C(C(OC1)=O)=O)O,,,5,1,2,0,2
16537_1,,,,2,2,1,3
16539_0,,,,2,2,1,3
C(CC(CC(C=O)=C)O)=O,,,5,1,2,0,2
16541_0,,,,2,2,1,3
C(C(C(CC(C=O)=C)O)C(C)O)=O,,,5,1,2,0,2
16541_1,,,,2,2,1,3
16543_0,,,,2,2,1,3
C(C(C=O)C(CC(C=O)=C)O)(O)=O,,,5,1,2,0,2
16543_1,,,,2,2,1,3
16545_0,,,,2,2,1,3
C=C(C=O)CC(C(C(C=O)=O)O)O,,,5,1,2,0,2
16545_1,,,,2,2,1,3
16547_0,,,,2,2,1,3
C=C(C=O)CC(CC(C=O)=O)O,,,5,1,2,0,2
16549_0,,,,2,2,1,3
C(C(CO)C(CC(C=O)=C)O)=O,,,5,1,3,0,3
16549_1,,,,2,2,1,3
16551_0,,,,2,2,1,3
C(CO)(C(C(CC(C=O)=C)O)O)=O,,,5,1,2,0,2
16551_1,,,,2,2,1,3
16553_0,,,,2,2,1,3
C(CO)(CC(CC(C=O)=C)O)=O,,,5,1,2,0,2
16555_0,,,,2,2,1,3
C(C)(C(C(CC(C=O)=C)O)O)=O,,,5,1,3,0,3
16555_1,,,,2,2,1,3
16557_0,,,,2,2,1,3
C(C(C=C)C(CC(C=O)=C)O)=O,,,5,1,2,0,2
16559_0,,,,2,2,1,3
C(C(C(CC(C=O)=C)O)O)=O,,,5,1,3,0,3
16559_1,,,,2,2,1,3
16561_0,,,,2,2,1,3
C=C(C=O)CC(CC(C(O)=O)=O)O,,,5,1,1,0,1
16563_0,,,,2,2,1,3
C(C(C(C=O)=C)C(C(CC=O)=C)O)=O,,,5,1,1,0,1
16565_0,,,,2,2,1,3
C(CC(C(CC(C=CC=O)=O)O)=C)=O,,,5,1,1,0,1
16567_0,,,,2,2,1,3
C(CC(C(C(C=C)C(C=O)=O)O)=C)=O,,,5,1,1,0,1
16569_0,,,,2,2,1,3
C(C(CCO)C(C(CC=O)=C)O)=O,,,5,1,1,0,1
16571_0,,,,2,2,1,3
C(CC(C(C1C(C(OC1)=O)=O)O)=C)=O,,,5,1,2,0,2
16571_1,,,,2,2,1,3
16573_0,,,,2,2,1,3
C(CC(C(CC=O)O)=C)=O,,,5,1,2,0,2
16575_0,,,,2,2,1,3
C(C(C(C)O)C(C(CC=O)=C)O)=O,,,5,1,2,0,2
16575_1,,,,2,2,1,3
16577_0,,,,2,2,1,3
C(C(C=O)C(C(CC=O)=C)O)(O)=O,,,5,1,2,0,2
16577_1,,,,2,2,1,3
16579_0,,,,2,2,1,3
C(CC(C(C(C(C=O)=O)O)O)=C)=O,,,5,1,2,0,2
16579_1,,,,2,2,1,3
16581_0,,,,2,2,1,3
C(CC(C(CC(C=O)=O)O)=C)=O,,,5,1,2,0,2
16583_0,,,,2,2,1,3
C(C(CO)C(C(CC=O)=C)O)=O,,,5,1,3,0,3
16583_1,,,,2,2,1,3
16585_0,,,,2,2,1,3
C(CC(C(C(C(CO)=O)O)O)=C)=O,,,5,1,2,0,2
16585_1,,,,2,2,1,3
16587_0,,,,2,2,1,3
C(CC(C(CC(CO)=O)O)=C)=O,,,5,1,2,0,2
16589_0,,,,2,2,1,3
C(CC(C(C(C(C)=O)O)O)=C)=O,,,5,1,3,0,3
16589_1,,,,2,2,1,3
16591_0,,,,2,2,1,3
C(C(C=C)C(C(CC=O)=C)O)=O,,,5,1,2,0,2
16593_0,,,,2,2,1,3
C(CC(C(C(C=O)O)O)=C)=O,,,5,1,3,0,3
16593_1,,,,2,2,1,3
16595_0,,,,2,2,1,3
C(CC(C(CC(C(O)=O)=O)O)=C)=O,,,5,1,1,0,1
16597_0,,,,2,2,1,3
C(C(C(C=O)=C)C(C=CC(C)=O)O)=O,,,5,1,1,0,1
16599_0,,,,2,2,1,3
C(C(C(C=O)=C)C(C=CC=O)(C)O)=O,,,5,1,1,0,1
16601_0,,,,2,2,1,3
C(C(C(C=O)=C)C(C=O)(C=C)O)=O,,,5,1,1,0,1
16603_0,,,,2,2,1,3
C(C(C(C=O)=C)C(C(C=C)=O)O)=O,,,5,1,1,0,1
16605_0,,,,2,2,1,3
C(C(C(C=O)=C)C(C=O)(CC=C)O)=O,,,5,1,1,0,1
16607_0,,,,2,2,1,3
C(C(C(C=O)=C)C(C(CC=C)=O)O)=O,,,5,1,1,0,1
16609_0,,,,2,2,1,3
C(C(C(C=O)=C)C(C=O)(C=CC)O)=O,,,5,1,1,0,1
16611_0,,,,2,2,1,3
C(C(C(C=O)=C)C(C(C=CC)=O)O)=O,,,5,1,1,0,1
16613_0,,,,2,2,1,3
C(C(C(C=O)=C)C(C=C)O)=O,,,5,1,1,0,1
16615_0,,,,2,2,1,3
C(C(C(C=O)=C)C(C(O)=O)(C=C)O)=O,,,5,1,1,0,1
16617_0,,,,2,2,1,3
C(C(C(C=O)=C)C(C(CC)O)O)=O,,,5,1,1,0,1
16619_0,,,,2,2,1,3
C(C(C(C=O)=C)C(CCCO)O)=O,,,5,1,1,0,1
16621_0,,,,2,2,1,3
C(C(C(C=O)=C)C1(C(OCC1)=O)O)=O,,,5,1,1,0,1
16623_0,,,,2,2,1,3
C(C(C(C=O)=C)C(C(O)O)O)=O,,,5,1,1,0,1
16624_0,,,,2,2,1,3
16625_0,,,,2,2,1,3
16627_0,,,,2,2,1,3
C(C(C(C=O)=C)C(CC(C)O)O)=O,,,5,1,1,0,1
16629_0,,,,2,2,1,3
C(C(C(C=O)=C)C(CC(O)=O)O)=O,,,5,1,1,0,1
16631_0,,,,2,2,1,3
C(C(C(C=O)=C)C(C(CO)=O)O)=O,,,5,1,1,0,1
16633_0,,,,2,2,1,3
C(C(C(C=O)=C)C(C=O)(CO)O)=O,,,5,1,1,0,1
16635_0,,,,2,2,1,3
C(C(C(C=O)=C)C(C=O)(C)O)=O,,,5,1,2,0,2
16637_0,,,,2,2,1,3
C(C(C(C=O)=C)C(C(C)=O)O)=O,,,5,1,2,0,2
16639_0,,,,2,2,1,3
C(C(C(C=O)=C)CO)=O,,,5,1,2,0,2
16641_0,,,,2,2,1,3
C(C(C(C=O)=C)C(CCO)O)=O,,,5,1,2,0,2
16643_0,,,,2,2,1,3
C(C(C(C=O)=C)C(C=O)O)=O,,,5,1,2,0,2
16645_0,,,,2,2,1,3
C(C(C(C=O)=C)C(C(C=O)O)O)=O,,,5,1,1,0,1
16647_0,,,,2,2,1,3
C(C(C(C=O)=C)C(CO)(CO)O)=O,,,5,1,1,0,1
16649_0,,,,2,2,1,3
C(C(C(C=O)=C)C(C)(CO)O)=O,,,5,1,2,0,2
16651_0,,,,2,2,1,3
C(C(C(C=O)=C)C(C=CC)O)=O,,,5,1,2,0,2
16653_0,,,,2,2,1,3
C(C(C(C=O)=C)C(CC=C)O)=O,,,5,1,2,0,2
16655_0,,,,2,2,1,3
C(C(C(C=O)=C)C(C(CO)O)O)=O,,,5,1,1,0,1
16657_0,,,,2,2,1,3
C(C(C(C=O)=C)C(CO)O)=O,,,5,1,2,0,2
16659_0,,,,2,2,1,3
C(C(C(C=O)=C)C(C(C)O)O)=O,,,5,1,2,0,2
16661_0,,,,2,2,1,3
C(C(C(C=O)=C)C(C(O)=O)O)=O,,,5,1,2,0,2
16663_0,,,,2,2,1,3
C(C(C(C=O)=C)C(C(O)=O)(C)O)=O,,,5,1,1,0,1
16665_0,,,,2,2,1,3
C(C(C=C(C=O)C)(CC=O)O)(O)=O,,,5,1,1,0,1
16667_0,,,,2,2,1,3
C(CC(C(C)=CC(C(O)=O)=O)O)=O,,,5,1,1,0,1
16669_0,,,,2,2,1,3
C(C(CC=O)(CC(C=O)=C)O)(O)=O,,,5,1,1,0,1
16671_0,,,,2,2,1,3
C(CC(C(CC(C(O)=O)=O)=C)O)=O,,,5,1,1,0,1
16673_0,,,,2,2,1,3
C=CC(C(C(C(O)=O)=O)C(C=O)=C)O,,,5,1,1,0,1
16675_0,,,,2,2,1,3
C=C(C=O)C(C(C(O)=O)=O)C(C)O,,,5,1,1,0,1
16677_0,,,,2,2,1,3
C(C(C(C(O)=O)=O)C(C=O)=C)(O)=O,,,5,1,1,0,1
16679_0,,,,2,2,1,3
C=C(C=O)C(C(C(O)=O)=O)CO,,,5,1,2,0,2
16681_0,,,,2,2,1,3
C(C(C=CC(C)=O)(CC=O)O)=O,,,5,1,2,0,2
16683_0,,,,2,2,1,3
C(C(C=CC(C)=O)(CC(C=O)=O)O)=O,,,5,1,1,0,1
16685_0,,,,2,2,1,3
C(C(C=C)C(C=O)(C=CC(C)=O)O)=O,,,5,1,1,0,1
16687_0,,,,2,2,1,3
C(C(C=CC(C)=O)(C(C=O)O)O)=O,,,5,1,2,0,2
16687_1,,,,2,2,1,3
16689_0,,,,2,2,1,3
C(CC(C(C=CC(C)=O)=O)O)=O,,,5,1,2,0,2
16691_0,,,,2,2,1,3
C(C(CC(C(C=CC(C)=O)=O)O)=O)=O,,,5,1,1,0,1
16693_0,,,,2,2,1,3
C(C(C=C)C(C(C=CC(C)=O)=O)O)=O,,,5,1,1,0,1
16695_0,,,,2,2,1,3
C(C(C(C(C=CC(C)=O)=O)O)O)=O,,,5,1,2,0,2
16695_1,,,,2,2,1,3
16697_0,,,,2,2,1,3
C(CC(C=CC(C=O)=O)(C)O)=O,,,5,1,2,0,2
16699_0,,,,2,2,1,3
C(C(C)(CC(C=O)=O)O)=CC(C=O)=O,,,5,1,1,0,1
16701_0,,,,2,2,1,3
C(C(C=C)C(C=CC(C=O)=O)(C)O)=O,,,5,1,1,0,1
16703_0,,,,2,2,1,3
C(C(C(C=CC(C=O)=O)(C)O)O)=O,,,5,1,2,0,2
16703_1,,,,2,2,1,3
16705_0,,,,2,2,1,3
C=CC(CC(C=CC(C=O)=O)=O)O,,,5,1,1,0,1
16707_0,,,,2,2,1,3
C(C(C=CC(CC(C)O)=O)=O)=O,,,5,1,2,0,2
16709_0,,,,2,2,1,3
C(CC(C=CC(C=O)=O)=O)(O)=O,,,5,1,2,0,2
16711_0,,,,2,2,1,3
C(C(C)(CC(C=CC(C=O)=O)=O)O)=O,,,5,1,1,0,1
16713_0,,,,2,2,1,3
C(C)(C(CC(C=CC(C=O)=O)=O)O)=O,,,5,1,1,0,1
16715_0,,,,2,2,1,3
C(C(C=CC(CCO)=O)=O)=O,,,5,1,2,0,2
16717_0,,,,2,2,1,3
C(C(CC(C=CC(C=O)=O)=O)O)=O,,,5,1,1,0,1
16719_0,,,,2,2,1,3
C(C(CC(C=CC(C=O)=O)=O)O)=CC,,,5,1,1,0,1
16721_0,,,,2,2,1,3
C=CCC(CC(C=CC(C=O)=O)=O)O,,,5,1,1,0,1
16723_0,,,,2,2,1,3
C(C(C=CC(CC(CO)O)=O)=O)=O,,,5,1,1,0,1
16725_0,,,,2,2,1,3
C(C(CC(C=CC=O)=O)O)=CC(C)=O,,,5,1,1,0,1
16727_0,,,,2,2,1,3
C=CC(C(C=O)=O)C(C=CC(C)=O)O,,,5,1,1,0,1
16729_0,,,,2,2,1,3
C(C(CCO)C(C=CC(C)=O)O)=O,,,5,1,1,0,1
16731_0,,,,2,2,1,3
C(C(C1C(C(OC1)=O)=O)O)=CC(C)=O,,,5,1,2,0,2
16731_1,,,,2,2,1,3
16733_0,,,,2,2,1,3
C(CC(C=CC(C)=O)O)=O,,,5,1,2,0,2
16735_0,,,,2,2,1,3
C(C(C(C)O)C(C=CC(C)=O)O)=O,,,5,1,2,0,2
16735_1,,,,2,2,1,3
16737_0,,,,2,2,1,3
C(C(C=O)C(C=CC(C)=O)O)(O)=O,,,5,1,2,0,2
16737_1,,,,2,2,1,3
16739_0,,,,2,2,1,3
C(C(C(C(C=O)=O)O)O)=CC(C)=O,,,5,1,2,0,2
16739_1,,,,2,2,1,3
16741_0,,,,2,2,1,3
C(C(CC(C=O)=O)O)=CC(C)=O,,,5,1,2,0,2
16743_0,,,,2,2,1,3
C(C(CO)C(C=CC(C)=O)O)=O,,,5,1,3,0,3
16743_1,,,,2,2,1,3
16745_0,,,,2,2,1,3
C(CO)(C(C(C=CC(C)=O)O)O)=O,,,5,1,2,0,2
16745_1,,,,2,2,1,3
16747_0,,,,2,2,1,3
C(CO)(CC(C=CC(C)=O)O)=O,,,5,1,2,0,2
16749_0,,,,2,2,1,3
C(C)(C(C(C=CC(C)=O)O)O)=O,,,5,1,3,0,3
16749_1,,,,2,2,1,3
16751_0,,,,2,2,1,3
C(C(C=C)C(C=CC(C)=O)O)=O,,,5,1,2,0,2
16753_0,,,,2,2,1,3
C(C(C(C=CC(C)=O)O)O)=O,,,5,1,3,0,3
16753_1,,,,2,2,1,3
16755_0,,,,2,2,1,3
C(C(CC(C(O)=O)=O)O)=CC(C)=O,,,5,1,1,0,1
16757_0,,,,2,2,1,3
C(C(C)(CC(C=CC=O)=O)O)=CC=O,,,5,1,1,0,1
16759_0,,,,2,2,1,3
C=CC(C(C=O)=O)C(C=CC=O)(C)O,,,5,1,1,0,1
16761_0,,,,2,2,1,3
C(C(CCO)C(C=CC=O)(C)O)=O,,,5,1,1,0,1
16763_0,,,,2,2,1,3
C(C(C)(C1C(C(OC1)=O)=O)O)=CC=O,,,5,1,2,0,2
16763_1,,,,2,2,1,3
16765_0,,,,2,2,1,3
C(CC(C=CC=O)(C)O)=O,,,5,1,3,0,3
16767_0,,,,2,2,1,3
C(C(C(C)O)C(C=CC=O)(C)O)=O,,,5,1,2,0,2
16767_1,,,,2,2,1,3
16769_0,,,,2,2,1,3
C(C(C=O)C(C=CC=O)(C)O)(O)=O,,,5,1,2,0,2
16769_1,,,,2,2,1,3
16771_0,,,,2,2,1,3
C(C(C)(C(C(C=O)=O)O)O)=CC=O,,,5,1,2,0,2
16771_1,,,,2,2,1,3
16773_0,,,,2,2,1,3
C(C(C)(CC(C=O)=O)O)=CC=O,,,5,1,3,0,3
16775_0,,,,2,2,1,3
C(C(CO)C(C=CC=O)(C)O)=O,,,5,1,4,0,4
16775_1,,,,2,2,1,3
16777_0,,,,2,2,1,3
C(C(C(C=CC=O)(C)O)O)(CO)=O,,,5,1,2,0,2
16777_1,,,,2,2,1,3
16779_0,,,,2,2,1,3
C(CC(C=CC=O)(C)O)(CO)=O,,,5,1,2,0,2
16781_0,,,,2,2,1,3
C(C(C(C=CC=O)(C)O)O)(C)=O,,,5,1,3,0,3
16781_1,,,,2,2,1,3
16783_0,,,,2,2,1,3
C(C(C=C)C(C=CC=O)(C)O)=O,,,5,1,2,0,2
16785_0,,,,2,2,1,3
C(C(C(C=CC=O)(C)O)O)=O,,,5,1,3,0,3
16785_1,,,,2,2,1,3
16787_0,,,,2,2,1,3
C(C(C)(CC(C(O)=O)=O)O)=CC=O,,,5,1,1,0,1
16789_0,,,,2,2,1,3
C(C(C=C)(CC(C=CC=O)=O)O)=O,,,5,1,1,0,1
16791_0,,,,2,2,1,3
C=CC(C(CC(C=CC=O)=O)O)=O,,,5,1,1,0,1
16793_0,,,,2,2,1,3
C(C(CC(C=CC=O)=O)(CC=C)O)=O,,,5,1,1,0,1
16795_0,,,,2,2,1,3
C(C(CC(C=CC=O)=O)O)(CC=C)=O,,,5,1,1,0,1
16797_0,,,,2,2,1,3
C(C(C=CC)(CC(C=CC=O)=O)O)=O,,,5,1,1,0,1
16799_0,,,,2,2,1,3
C(C)=CC(C(CC(C=CC=O)=O)O)=O,,,5,1,1,0,1
16801_0,,,,2,2,1,3
C=CC(CC(C=CC=O)=O)O,,,5,1,1,0,1
16803_0,,,,2,2,1,3
C(C(C=C)(CC(C=CC=O)=O)O)(O)=O,,,5,1,1,0,1
16805_0,,,,2,2,1,3
C(C=CC(CC(C(CC)O)O)=O)=O,,,5,1,1,0,1
16807_0,,,,2,2,1,3
C(C=CC(CC(CCCO)O)=O)=O,,,5,1,1,0,1
16809_0,,,,2,2,1,3
C1(C(CCO1)(CC(C=CC=O)=O)O)=O,,,5,1,1,0,1
16811_0,,,,2,2,1,3
C(C=CC(CC(C(O)O)O)=O)=O,,,5,1,1,0,1
16813_0,,,,2,2,1,3
C(C=CC(CC(C)O)=O)=O,,,5,1,2,0,2
16815_0,,,,2,2,1,3
C(CC(C=CC=O)=O)(O)=O,,,5,1,2,0,2
16817_0,,,,2,2,1,3
C(C=CC(CC(CC(C)O)O)=O)=O,,,5,1,1,0,1
16819_0,,,,2,2,1,3
C(CC(CC(C=CC=O)=O)O)(O)=O,,,5,1,1,0,1
16821_0,,,,2,2,1,3
C(CO)(C(CC(C=CC=O)=O)O)=O,,,5,1,1,0,1
16823_0,,,,2,2,1,3
C(C(CO)(CC(C=CC=O)=O)O)=O,,,5,1,1,0,1
16825_0,,,,2,2,1,3
C(C(C)(CC(C=CC=O)=O)O)=O,,,5,1,2,0,2
16827_0,,,,2,2,1,3
C(C)(C(CC(C=CC=O)=O)O)=O,,,5,1,2,0,2
16829_0,,,,2,2,1,3
C(C=CC(CCO)=O)=O,,,5,1,2,0,2
16831_0,,,,2,2,1,3
C(C=CC(CC(CCO)O)=O)=O,,,5,1,2,0,2
16833_0,,,,2,2,1,3
C(C(CC(C=CC=O)=O)O)=O,,,5,1,2,0,2
16835_0,,,,2,2,1,3
C(C(C(CC(C=CC=O)=O)O)O)=O,,,5,1,1,0,1
16837_0,,,,2,2,1,3
C(C=CC(CC(CO)(CO)O)=O)=O,,,5,1,1,0,1
16839_0,,,,2,2,1,3
C(C=CC(CC(C)(CO)O)=O)=O,,,5,1,2,0,2
16841_0,,,,2,2,1,3
C(C(CC(C=CC=O)=O)O)=CC,,,5,1,2,0,2
16843_0,,,,2,2,1,3
C=CCC(CC(C=CC=O)=O)O,,,5,1,2,0,2
16845_0,,,,2,2,1,3
C(C=CC(CC(C(CO)O)O)=O)=O,,,5,1,1,0,1
16847_0,,,,2,2,1,3
C(C=CC(CC(CO)O)=O)=O,,,5,1,2,0,2
16849_0,,,,2,2,1,3
C(C=CC(CC(C(C)O)O)=O)=O,,,5,1,2,0,2
16851_0,,,,2,2,1,3
C(C(CC(C=CC=O)=O)O)(O)=O,,,5,1,2,0,2
16853_0,,,,2,2,1,3
C(C(C)(CC(C=CC=O)=O)O)(O)=O,,,5,1,1,0,1
16855_0,,,,2,2,1,3
C(C(C=CC(C)=O)(CC=O)O)(O)=O,,,5,1,1,0,1
16857_0,,,,2,2,1,3
C(CC(C=CC(C(O)=O)=O)(C)O)=O,,,5,1,1,0,1
16859_0,,,,2,2,1,3
C=CC(CC(C=CC(C(O)=O)=O)=O)O,,,5,1,1,0,1
16861_0,,,,2,2,1,3
C(C(C=CC(CC(C)O)=O)=O)(O)=O,,,5,1,1,0,1
16863_0,,,,2,2,1,3
C(CC(C=CC(C(O)=O)=O)=O)(O)=O,,,5,1,1,0,1
16865_0,,,,2,2,1,3
C(C(C=CC(CCO)=O)=O)(O)=O,,,5,1,2,0,2
16867_0,,,,2,2,1,3
C(C(C=C)(C(C=C)C(C=O)=O)O)=O,,,5,1,1,0,1
16869_0,,,,2,2,1,3
C(C(C=C)(CC(C(C(O)=O)=C)=O)O)=O,,,5,1,1,0,1
16871_0,,,,2,2,1,3
C(C(C=C)(C(C=O)CCO)O)=O,,,5,1,1,0,1
16873_0,,,,2,2,1,3
C(C(C=C)(C1C(C(O)OC1)=O)O)=O,,,5,1,2,0,2
16873_1,,,,2,2,1,3
16875_0,,,,2,2,1,3
C(C(C=C)(C1C(C(OC1)=O)=O)O)=O,,,5,1,2,0,2
16875_1,,,,2,2,1,3
16877_0,,,,2,2,1,3
C(C(C=C)(C1C(C(C(O1)=O)=O)=O)O)=O,,,5,1,2,0,2
16877_1,,,,2,2,1,3
16879_0,,,,2,2,1,3
C(C(C=C)(C(C=O)C(CO)C)O)=O,,,5,1,1,0,1
16881_0,,,,2,2,1,3
C(CC(C)C(C=O)C(C=O)(C=C)O)=O,,,5,1,1,0,1
16883_0,,,,2,2,1,3
C(C(C=C)(CC=O)O)=O,,,5,1,2,0,2
16885_0,,,,2,2,1,3
C(C(C=C)(C(C=O)C(C)O)O)=O,,,5,1,3,0,3
16885_1,,,,2,2,1,3
16887_0,,,,2,2,1,3
C(C(C=O)C(C=O)(C=C)O)(O)=O,,,5,1,3,0,3
16887_1,,,,2,2,1,3
16889_0,,,,2,2,1,3
C(C(C=C)(C(C(C=O)=O)O)O)=O,,,5,1,3,0,3
16889_1,,,,2,2,1,3
16891_0,,,,2,2,1,3
C(C(C=C)(CC(C=O)=O)O)=O,,,5,1,2,0,2
16893_0,,,,2,2,1,3
C(C(C=C)(C(C(C(O)=O)=O)O)O)=O,,,5,1,2,0,2
16893_1,,,,2,2,1,3
16895_0,,,,2,2,1,3
C(C(C=C)(C(C(C=O)=O)CO)O)=O,,,5,1,2,0,2
16895_1,,,,2,2,1,3
16897_0,,,,2,2,1,3
C(C(C=C)(C(C=O)CO)O)=O,,,5,1,3,0,3
16897_1,,,,2,2,1,3
16899_0,,,,2,2,1,3
C(C(C(C(C)=O)=O)C(C=O)(C=C)O)=O,,,5,1,2,0,2
16899_1,,,,2,2,1,3
16901_0,,,,2,2,1,3
C(C(C=C)(CC(C(CC=O)=O)=O)O)=O,,,5,1,1,0,1
16903_0,,,,2,2,1,3
C(C(C=C)(C(C(CO)=O)O)O)=O,,,5,1,3,0,3
16903_1,,,,2,2,1,3
16905_0,,,,2,2,1,3
C(C(C=C)(CC(CO)=O)O)=O,,,5,1,2,0,2
16907_0,,,,2,2,1,3
C(C(C=C)(C(C(C)=O)O)O)=O,,,5,1,3,0,3
16907_1,,,,2,2,1,3
16909_0,,,,2,2,1,3
C(C(C=C)C(C=O)(C=C)O)=O,,,5,1,2,0,2
16911_0,,,,2,2,1,3
C(C(C=C)(C(C=C)C(C(O)=O)=O)O)=O,,,5,1,1,0,1
16913_0,,,,2,2,1,3
C(C(C(C(O)=O)=C)C(C=O)(C=C)O)=O,,,5,1,1,0,1
16915_0,,,,2,2,1,3
C(C(C=C)(C(C=O)O)O)=O,,,5,1,3,0,3
16915_1,,,,2,2,1,3
16917_0,,,,2,2,1,3
C(C(C=C)(C1C(C(OC1C)=O)=O)O)=O,,,5,1,2,0,2
16917_1,,,,2,2,1,3
16919_0,,,,2,2,1,3
C1(C(C(C(O1)=O)=O)C(C=O)(C=C)O)=O,,,5,1,2,0,2
16919_1,,,,2,2,1,3
16921_0,,,,2,2,1,3
C(C(C=C)(C(C=O)C[CH]C(O)=O)O)=O,,,5,1,1,0,1
16923_0,,,,2,2,1,3
C(C(C=C)(CC(C(O)=O)=O)O)=O,,,5,1,2,0,2
16925_0,,,,2,2,1,3
C=CC(C(C=O)=O)C(C(C=C)=O)O,,,5,1,1,0,1
16927_0,,,,2,2,1,3
C=C(C(O)=O)C(CC(C(C=C)=O)O)=O,,,5,1,1,0,1
16929_0,,,,2,2,1,3
C(C(CCO)C(C(C=C)=O)O)=O,,,5,1,1,0,1
16931_0,,,,2,2,1,3
C1(C(O)OCC1C(C(C=C)=O)O)=O,,,5,1,2,0,2
16931_1,,,,2,2,1,3
16933_0,,,,2,2,1,3
C=CC(C(C1C(C(OC1)=O)=O)O)=O,,,5,1,2,0,2
16933_1,,,,2,2,1,3
16935_0,,,,2,2,1,3
C=CC(C(C1C(C(C(O1)=O)=O)=O)O)=O,,,5,1,2,0,2
16935_1,,,,2,2,1,3
16937_0,,,,2,2,1,3
C(C(C(CO)C)C(C(C=C)=O)O)=O,,,5,1,1,0,1
16939_0,,,,2,2,1,3
C(CC(C)C(C=O)C(C(C=C)=O)O)=O,,,5,1,1,0,1
16941_0,,,,2,2,1,3
C(CC(C(C=C)=O)O)=O,,,5,1,4,0,4
16943_0,,,,2,2,1,3
C(C(C(C)O)C(C(C=C)=O)O)=O,,,5,1,3,0,3
16943_1,,,,2,2,1,3
16945_0,,,,2,2,1,3
C(C(C=O)C(C(C=C)=O)O)(O)=O,,,5,1,3,0,3
16945_1,,,,2,2,1,3
16947_0,,,,2,2,1,3
C=CC(C(C(C(C=O)=O)O)O)=O,,,5,1,3,0,3
16947_1,,,,2,2,1,3
16949_0,,,,2,2,1,3
C=CC(C(CC(C=O)=O)O)=O,,,5,1,2,0,2
16951_0,,,,2,2,1,3
C=CC(C(C(C(C(O)=O)=O)O)O)=O,,,5,1,3,0,3
16951_1,,,,2,2,1,3
16953_0,,,,2,2,1,3
C=CC(C(C(C(C=O)=O)CO)O)=O,,,5,1,2,0,2
16953_1,,,,2,2,1,3
16955_0,,,,2,2,1,3
C(C(CO)C(C(C=C)=O)O)=O,,,5,1,3,0,3
16955_1,,,,2,2,1,3
16957_0,,,,2,2,1,3
C(C(C(C(C)=O)=O)C(C(C=C)=O)O)=O,,,5,1,2,0,2
16957_1,,,,2,2,1,3
16959_0,,,,2,2,1,3
C(CC(C(CC(C(C=C)=O)O)=O)=O)=O,,,5,1,1,0,1
16961_0,,,,2,2,1,3
C(CO)(C(C(C(C=C)=O)O)O)=O,,,5,1,3,0,3
16961_1,,,,2,2,1,3
16963_0,,,,2,2,1,3
C(CO)(CC(C(C=C)=O)O)=O,,,5,1,2,0,2
16965_0,,,,2,2,1,3
C(C)(C(C(C(C=C)=O)O)O)=O,,,5,1,3,0,3
16965_1,,,,2,2,1,3
16967_0,,,,2,2,1,3
C(C(C=C)C(C(C=C)=O)O)=O,,,5,1,2,0,2
16969_0,,,,2,2,1,3
C=CC(C(C(O)=O)=O)C(C(C=C)=O)O,,,5,1,1,0,1
16971_0,,,,2,2,1,3
C(C(C(C(O)=O)=C)C(C(C=C)=O)O)=O,,,5,1,1,0,1
16973_0,,,,2,2,1,3
C(C(C(C(C=C)=O)O)O)=O,,,5,1,3,0,3
16973_1,,,,2,2,1,3
16975_0,,,,2,2,1,3
C=CC(C(C1C(C(OC1C)=O)=O)O)=O,,,5,1,2,0,2
16975_1,,,,2,2,1,3
16977_0,,,,2,2,1,3
C1(C(C(C(O1)=O)=O)C(C(C=C)=O)O)=O,,,5,1,2,0,2
16977_1,,,,2,2,1,3
16979_0,,,,2,2,1,3
C(C(C[CH]C(O)=O)C(C(C=C)=O)O)=O,,,5,1,1,0,1
16981_0,,,,2,2,1,3
C=CC(C(CC(C(O)=O)=O)O)=O,,,5,1,2,0,2
16983_0,,,,2,2,1,3
C(C(CC=C)(C(C=C)C(C=O)=O)O)=O,,,5,1,1,0,1
16985_0,,,,2,2,1,3
C(C(CCO)C(C=O)(CC=C)O)=O,,,5,1,1,0,1
16987_0,,,,2,2,1,3
C(C(CC=C)(C1C(C(OC1)=O)=O)O)=O,,,5,1,2,0,2
16987_1,,,,2,2,1,3
16989_0,,,,2,2,1,3
C(CC(C=O)(CC=C)O)=O,,,5,1,2,0,2
16991_0,,,,2,2,1,3
C(C(C(C)O)C(C=O)(CC=C)O)=O,,,5,1,2,0,2
16991_1,,,,2,2,1,3
16993_0,,,,2,2,1,3
C(C(C=O)C(C=O)(CC=C)O)(O)=O,,,5,1,2,0,2
16993_1,,,,2,2,1,3
16995_0,,,,2,2,1,3
C(C(CC=C)(C(C(C=O)=O)O)O)=O,,,5,1,2,0,2
16995_1,,,,2,2,1,3
16997_0,,,,2,2,1,3
C(C(CC(C=O)=O)(CC=C)O)=O,,,5,1,2,0,2
16999_0,,,,2,2,1,3
C(C(CO)C(C=O)(CC=C)O)=O,,,5,1,3,0,3
16999_1,,,,2,2,1,3
17001_0,,,,2,2,1,3
C(C(CC=C)(C(C(CO)=O)O)O)=O,,,5,1,2,0,2
17001_1,,,,2,2,1,3
17003_0,,,,2,2,1,3
C(C(CC=C)(CC(CO)=O)O)=O,,,5,1,2,0,2
17005_0,,,,2,2,1,3
C(C(CC=C)(C(C(C)=O)O)O)=O,,,5,1,3,0,3
17005_1,,,,2,2,1,3
17007_0,,,,2,2,1,3
C(C(C=C)C(C=O)(CC=C)O)=O,,,5,1,2,0,2
17009_0,,,,2,2,1,3
C(C(C(C=O)(CC=C)O)O)=O,,,5,1,3,0,3
17009_1,,,,2,2,1,3
17011_0,,,,2,2,1,3
C(C(CC(C(O)=O)=O)(CC=C)O)=O,,,5,1,1,0,1
17013_0,,,,2,2,1,3
C(C(C(C=C)C(C=O)=O)O)(CC=C)=O,,,5,1,1,0,1
17015_0,,,,2,2,1,3
C(C(CCO)C(C(CC=C)=O)O)=O,,,5,1,1,0,1
17017_0,,,,2,2,1,3
C(C(C1C(C(OC1)=O)=O)O)(CC=C)=O,,,5,1,2,0,2
17017_1,,,,2,2,1,3
17019_0,,,,2,2,1,3
C(CC(C(CC=C)=O)O)=O,,,5,1,2,0,2
17021_0,,,,2,2,1,3
C(C(C(C)O)C(C(CC=C)=O)O)=O,,,5,1,2,0,2
17021_1,,,,2,2,1,3
17023_0,,,,2,2,1,3
C(C(C=O)C(C(CC=C)=O)O)(O)=O,,,5,1,2,0,2
17023_1,,,,2,2,1,3
17025_0,,,,2,2,1,3
C(C(C(C(C=O)=O)O)O)(CC=C)=O,,,5,1,2,0,2
17025_1,,,,2,2,1,3
17027_0,,,,2,2,1,3
C(C(CC(C=O)=O)O)(CC=C)=O,,,5,1,2,0,2
17029_0,,,,2,2,1,3
C(C(CO)C(C(CC=C)=O)O)=O,,,5,1,3,0,3
17029_1,,,,2,2,1,3
17031_0,,,,2,2,1,3
C(C(C(C(CO)=O)O)O)(CC=C)=O,,,5,1,2,0,2
17031_1,,,,2,2,1,3
17033_0,,,,2,2,1,3
C(C(CC(CO)=O)O)(CC=C)=O,,,5,1,2,0,2
17035_0,,,,2,2,1,3
C(C(C(C(C)=O)O)O)(CC=C)=O,,,5,1,3,0,3
17035_1,,,,2,2,1,3
17037_0,,,,2,2,1,3
C(C(C=C)C(C(CC=C)=O)O)=O,,,5,1,2,0,2
17039_0,,,,2,2,1,3
C(C(C(C(CC=C)=O)O)O)=O,,,5,1,3,0,3
17039_1,,,,2,2,1,3
17041_0,,,,2,2,1,3
C(C(CC(C(O)=O)=O)O)(CC=C)=O,,,5,1,1,0,1
17043_0,,,,2,2,1,3
C(C(C=CC)(C(C=C)C(C=O)=O)O)=O,,,5,1,1,0,1
17045_0,,,,2,2,1,3
C=CC(C(C=O)=O)C(C(C=CC)=O)O,,,5,1,1,0,1
17047_0,,,,2,2,1,3
C=CC(C(C=O)=O)C(C=C)O,,,5,1,1,0,1
17049_0,,,,2,2,1,3
C(C(C=C)(C(C=C)C(C=O)=O)O)(O)=O,,,5,1,1,0,1
17051_0,,,,2,2,1,3
C=CC(C(C=O)=O)C(C(CC)O)O,,,5,1,1,0,1
17053_0,,,,2,2,1,3
C=CC(C(C=O)=O)C(CCCO)O,,,5,1,1,0,1
17055_0,,,,2,2,1,3
C1(C(CCO1)(C(C=C)C(C=O)=O)O)=O,,,5,1,1,0,1
17057_0,,,,2,2,1,3
C=CC(C(C=O)=O)C(C(O)O)O,,,5,1,1,0,1
17059_0,,,,2,2,1,3
C=CC(C(C=O)=O)C(C)O,,,5,1,2,0,2
17061_0,,,,2,2,1,3
C(C(C=C)C(C=O)=O)(O)=O,,,5,1,2,0,2
17063_0,,,,2,2,1,3
C=CC(C(C=O)=O)C(CC(C)O)O,,,5,1,1,0,1
17065_0,,,,2,2,1,3
C(CC(C(C=C)C(C=O)=O)O)(O)=O,,,5,1,1,0,1
17067_0,,,,2,2,1,3
C(CO)(C(C(C=C)C(C=O)=O)O)=O,,,5,1,1,0,1
17069_0,,,,2,2,1,3
C(C(CO)(C(C=C)C(C=O)=O)O)=O,,,5,1,1,0,1
17071_0,,,,2,2,1,3
C(C(C)(C(C=C)C(C=O)=O)O)=O,,,5,1,2,0,2
17073_0,,,,2,2,1,3
C(C)(C(C(C=C)C(C=O)=O)O)=O,,,5,1,2,0,2
17075_0,,,,2,2,1,3
C=CC(C(C=O)=O)CO,,,5,1,2,0,2
17077_0,,,,2,2,1,3
C=CC(C(C=O)=O)C(CCO)O,,,5,1,2,0,2
17079_0,,,,2,2,1,3
C(C(C(C=C)C(C=O)=O)O)=O,,,5,1,2,0,2
17081_0,,,,2,2,1,3
C(C(C(C(C=C)C(C=O)=O)O)O)=O,,,5,1,1,0,1
17083_0,,,,2,2,1,3
C=CC(C(C=O)=O)C(CO)(CO)O,,,5,1,1,0,1
17085_0,,,,2,2,1,3
C=CC(C(C=O)=O)C(C)(CO)O,,,5,1,2,0,2
17087_0,,,,2,2,1,3
C=CC(C(C=O)=O)C(C=CC)O,,,5,1,2,0,2
17089_0,,,,2,2,1,3
C=CC(C(C=O)=O)C(CC=C)O,,,5,1,2,0,2
17091_0,,,,2,2,1,3
C=CC(C(C=O)=O)C(C(CO)O)O,,,5,1,1,0,1
17093_0,,,,2,2,1,3
C=CC(C(C=O)=O)C(CO)O,,,5,1,2,0,2
17095_0,,,,2,2,1,3
C=CC(C(C=O)=O)C(C(C)O)O,,,5,1,2,0,2
17097_0,,,,2,2,1,3
C(C(C(C=C)C(C=O)=O)O)(O)=O,,,5,1,2,0,2
17099_0,,,,2,2,1,3
C(C(C)(C(C=C)C(C=O)=O)O)(O)=O,,,5,1,1,0,1
17101_0,,,,2,2,1,3
C(C(CCO)C(C=O)(C=CC)O)=O,,,5,1,1,0,1
17103_0,,,,2,2,1,3
C(C(C=CC)(C1C(C(OC1)=O)=O)O)=O,,,5,1,2,0,2
17103_1,,,,2,2,1,3
17105_0,,,,2,2,1,3
C(C(C=CC)(CC=O)O)=O,,,5,1,2,0,2
17107_0,,,,2,2,1,3
C(C(C(C)O)C(C=O)(C=CC)O)=O,,,5,1,2,0,2
17107_1,,,,2,2,1,3
17109_0,,,,2,2,1,3
C(C(C=O)C(C=O)(C=CC)O)(O)=O,,,5,1,2,0,2
17109_1,,,,2,2,1,3
17111_0,,,,2,2,1,3
C(C(C=CC)(C(C(C=O)=O)O)O)=O,,,5,1,2,0,2
17111_1,,,,2,2,1,3
17113_0,,,,2,2,1,3
C(C(C=CC)(CC(C=O)=O)O)=O,,,5,1,2,0,2
17115_0,,,,2,2,1,3
C(C(CO)C(C=O)(C=CC)O)=O,,,5,1,3,0,3
17115_1,,,,2,2,1,3
17117_0,,,,2,2,1,3
C(C(C=CC)(C(C(CO)=O)O)O)=O,,,5,1,2,0,2
17117_1,,,,2,2,1,3
17119_0,,,,2,2,1,3
C(C(C=CC)(CC(CO)=O)O)=O,,,5,1,2,0,2
17121_0,,,,2,2,1,3
C(C(C=CC)(C(C(C)=O)O)O)=O,,,5,1,3,0,3
17121_1,,,,2,2,1,3
17123_0,,,,2,2,1,3
C(C(C=C)C(C=O)(C=CC)O)=O,,,5,1,2,0,2
17125_0,,,,2,2,1,3
C(C(C=CC)(C(C=O)O)O)=O,,,5,1,3,0,3
17125_1,,,,2,2,1,3
17127_0,,,,2,2,1,3
C(C(C=CC)(CC(C(O)=O)=O)O)=O,,,5,1,1,0,1
17129_0,,,,2,2,1,3
C(C(CCO)C(C(C=CC)=O)O)=O,,,5,1,1,0,1
17131_0,,,,2,2,1,3
C(C)=CC(C(C1C(C(OC1)=O)=O)O)=O,,,5,1,2,0,2
17131_1,,,,2,2,1,3
17133_0,,,,2,2,1,3
C(CC(C(C=CC)=O)O)=O,,,5,1,3,0,3
17135_0,,,,2,2,1,3
C(C(C(C)O)C(C(C=CC)=O)O)=O,,,5,1,2,0,2
17135_1,,,,2,2,1,3
17137_0,,,,2,2,1,3
C(C(C=O)C(C(C=CC)=O)O)(O)=O,,,5,1,2,0,2
17137_1,,,,2,2,1,3
17139_0,,,,2,2,1,3
C(C)=CC(C(C(C(C=O)=O)O)O)=O,,,5,1,2,0,2
17139_1,,,,2,2,1,3
17141_0,,,,2,2,1,3
C(C)=CC(C(CC(C=O)=O)O)=O,,,5,1,2,0,2
17143_0,,,,2,2,1,3
C(C(CO)C(C(C=CC)=O)O)=O,,,5,1,3,0,3
17143_1,,,,2,2,1,3
17145_0,,,,2,2,1,3
C(CO)(C(C(C(C=CC)=O)O)O)=O,,,5,1,2,0,2
17145_1,,,,2,2,1,3
17147_0,,,,2,2,1,3
C(CO)(CC(C(C=CC)=O)O)=O,,,5,1,2,0,2
17149_0,,,,2,2,1,3
C(C)(C(C(C(C=CC)=O)O)O)=O,,,5,1,3,0,3
17149_1,,,,2,2,1,3
17151_0,,,,2,2,1,3
C(C(C=C)C(C(C=CC)=O)O)=O,,,5,1,2,0,2
17153_0,,,,2,2,1,3
C(C(C(C(C=CC)=O)O)O)=O,,,5,1,3,0,3
17153_1,,,,2,2,1,3
17155_0,,,,2,2,1,3
C(C)=CC(C(CC(C(O)=O)=O)O)=O,,,5,1,1,0,1
17157_0,,,,2,2,1,3
C=CC(CC(C(C(O)=O)=C)=O)O,,,5,1,1,0,1
17159_0,,,,2,2,1,3
C=CC(CC(C1OC(C(C=1)=O)=O)=O)O,,,5,1,1,0,1
17161_0,,,,2,2,1,3
C=CC(C1C(C(OC(C1=O)=O)=C)=O)O,,,5,1,2,0,2
17161_1,,,,2,2,1,3
17163_0,,,,2,2,1,3
C(C(C=CC[CH]C(O)=O)C(C=C)O)=O,,,5,1,1,0,1
17165_0,,,,2,2,1,3
C(C(C=CCCC(O)=O)C(C=C)O)=O,,,5,1,1,0,1
17167_0,,,,2,2,1,3
C(C(C(C)=C[CH]C(O)=O)C(C=C)O)=O,,,5,1,1,0,1
17169_0,,,,2,2,1,3
C(C(C(C[CH]C(O)=O)=C)C(C=C)O)=O,,,5,1,1,0,1
17171_0,,,,2,2,1,3
C(C(C(C)=CCC(O)=O)C(C=C)O)=O,,,5,1,1,0,1
17173_0,,,,2,2,1,3
C(C(C(CCC(O)=O)=C)C(C=C)O)=O,,,5,1,1,0,1
17175_0,,,,2,2,1,3
C(C(CCO)C(C=C)O)=O,,,5,1,1,0,1
17177_0,,,,2,2,1,3
C=CC(C(C(C(O)=O)=O)CCO)O,,,5,1,1,0,1
17179_0,,,,2,2,1,3
C(C(CO)C(C=O)C(C=C)O)(O)=O,,,5,1,1,0,1
17181_0,,,,2,2,1,3
C1(C(O)OCC1C(C=C)O)=O,,,5,1,2,0,2
17181_1,,,,2,2,1,3
17183_0,,,,2,2,1,3
C1(C(O)OC(C)C1C(C=C)O)=O,,,5,1,2,0,2
17183_1,,,,2,2,1,3
17185_0,,,,2,2,1,3
C1(C(C(C(O)O1)=O)C(C=C)O)=O,,,5,1,2,0,2
17185_1,,,,2,2,1,3
17187_0,,,,2,2,1,3
C1(C(C(C=C)O)OC(CC1O)O)=O,,,5,1,2,0,2
17187_1,,,,2,2,1,3
17189_0,,,,2,2,1,3
C1(C(O)OC([CH]CC1C(C=C)O)=O)=O,,,5,1,1,0,1
17191_0,,,,2,2,1,3
C(C1(C)C(C(C(O1)=O)=O)C(C=C)O)=O,,,5,1,2,0,2
17191_1,,,,2,2,1,3
17193_0,,,,2,2,1,3
C(C)(C1C(C(C(O1)=O)=O)C(C=C)O)=O,,,5,1,2,0,2
17193_1,,,,2,2,1,3
17195_0,,,,2,2,1,3
C(CC(C=C)O)(C1CC(C(O1)=O)=O)=O,,,5,1,1,0,1
17197_0,,,,2,2,1,3
C=CC(C1C(C(OC1)=O)=O)O,,,5,1,2,0,2
17197_1,,,,2,2,1,3
17199_0,,,,2,2,1,3
C=CC(C1C(C(C(O1)=O)=O)=O)O,,,5,1,2,0,2
17199_1,,,,2,2,1,3
17201_0,,,,2,2,1,3
C(C(C1(C)C[CH]C(O1)=O)C(C=C)O)=O,,,5,1,2,0,2
17201_1,,,,2,2,1,3
17203_0,,,,2,2,1,3
C1(CCC(C)(C(C=O)C(C=C)O)O1)=O,,,5,1,2,0,2
17203_1,,,,2,2,1,3
17205_0,,,,2,2,1,3
C(C(C1CC[CH]C(O1)=O)C(C=C)O)=O,,,5,1,2,0,2
17205_1,,,,2,2,1,3
17207_0,,,,2,2,1,3
C1(CCCC(C(C=O)C(C=C)O)O1)=O,,,5,1,2,0,2
17207_1,,,,2,2,1,3
17209_0,,,,2,2,1,3
C=CC(C1C(C(OC([CH]C1)=O)=O)=O)O,,,5,1,1,0,1
17211_0,,,,2,2,1,3
C1(CCC(C(C(O1)=O)=O)C(C=C)O)=O,,,5,1,1,0,1
17213_0,,,,2,2,1,3
C(C(C(CO)C)C(C=C)O)=O,,,5,1,1,0,1
17215_0,,,,2,2,1,3
C(C(C(C)CCO)C(C=C)O)=O,,,5,1,1,0,1
17217_0,,,,2,2,1,3
C(C(C(C)C(C)O)C(C=C)O)=O,,,5,1,1,0,1
17219_0,,,,2,2,1,3
C(CC(C)C(C=O)C(C=C)O)(O)=O,,,5,1,1,0,1
17221_0,,,,2,2,1,3
C(C(C(C)CC=CC=O)C(C=C)O)=O,,,5,1,1,0,1
17223_0,,,,2,2,1,3
C(C(C(C)C(C=O)C=C)C(C=C)O)=O,,,5,1,1,0,1
17225_0,,,,2,2,1,3
C(C(C(C)C(C=O)C(C=C)O)O)=O,,,5,1,1,0,1
17227_0,,,,2,2,1,3
C(CC(C)C(C=O)C(C=C)O)=O,,,5,1,1,0,1
17229_0,,,,2,2,1,3
C(CC(C)C(C(C=O)=O)C(C=C)O)=O,,,5,1,1,0,1
17231_0,,,,2,2,1,3
C(C(C(C)CC(C=O)=O)C(C=C)O)=O,,,5,1,1,0,1
17233_0,,,,2,2,1,3
C(C(C(C)C(CO)O)C(C=C)O)=O,,,5,1,1,0,1
17235_0,,,,2,2,1,3
C=CC(C(C([C](C(O)=O)O)=O)O)O,,,5,1,2,0,2
17235_1,,,,2,2,1,3
17237_0,,,,2,2,1,3
C=CC(CC([C](C(O)=O)O)=O)O,,,5,1,1,0,1
17239_0,,,,2,2,1,3
C(CC(C=C)O)=O,,,5,1,3,0,3
17241_0,,,,2,2,1,3
C(C(C(C)O)C(C=C)O)=O,,,5,1,4,0,4
17241_1,,,,2,2,1,3
17243_0,,,,2,2,1,3
C=CC(C(C(C(O)=O)=O)C(C)O)O,,,5,1,2,0,2
17243_1,,,,2,2,1,3
17245_0,,,,2,2,1,3
C(C(C=O)C(C=C)O)(O)=O,,,5,1,4,0,4
17245_1,,,,2,2,1,3
17247_0,,,,2,2,1,3
C(C(C)(C(C=O)C(C=C)O)O)(O)=O,,,5,1,2,0,2
17247_1,,,,2,2,1,3
17249_0,,,,2,2,1,3
C(C(C(C(O)=O)=O)C(C=C)O)(O)=O,,,5,1,2,0,2
17249_1,,,,2,2,1,3
17251_0,,,,2,2,1,3
C=CC(C(C(C=O)=O)O)O,,,5,1,4,0,4
17251_1,,,,2,2,1,3
17253_0,,,,2,2,1,3
C=CC(CC(C=O)=O)O,,,5,1,3,0,3
17255_0,,,,2,2,1,3
C=CC(C(C(C(O)=O)=O)O)O,,,5,1,4,0,4
17255_1,,,,2,2,1,3
17257_0,,,,2,2,1,3
C(C(C(CC(C)O)O)C(C=C)O)=O,,,5,1,2,0,2
17257_1,,,,2,2,1,3
17259_0,,,,2,2,1,3
C(CC(C(C=O)C(C=C)O)O)(O)=O,,,5,1,2,0,2
17259_1,,,,2,2,1,3
17261_0,,,,2,2,1,3
C(C(C(C=C)O)C(C(CO)=O)O)=O,,,5,1,2,0,2
17261_1,,,,2,2,1,3
17263_0,,,,2,2,1,3
C(CC(C(C(C(C=C)O)O)=O)O)=O,,,5,1,2,0,2
17263_1,,,,2,2,1,3
17265_0,,,,2,2,1,3
C(C(CO)(C(C=O)C(C=C)O)O)=O,,,5,1,2,0,2
17265_1,,,,2,2,1,3
17267_0,,,,2,2,1,3
C(C(C)(C(C=O)C(C=C)O)O)=O,,,5,1,4,0,4
17267_1,,,,2,2,1,3
17269_0,,,,2,2,1,3
C(C(C(C=C)O)C(C(C)=O)O)=O,,,5,1,4,0,4
17269_1,,,,2,2,1,3
17271_0,,,,2,2,1,3
C(CC(C(CC(C=C)O)=O)O)=O,,,5,1,3,0,3
17273_0,,,,2,2,1,3
C=CC(C(C(C=O)=O)CO)O,,,5,1,4,0,4
17273_1,,,,2,2,1,3
17275_0,,,,2,2,1,3
C=CC(C(C(C=O)=O)C(C)O)O,,,5,1,4,0,4
17275_1,,,,2,2,1,3
17277_0,,,,2,2,1,3
C(C(C(C=O)=O)C(C=C)O)(O)=O,,,5,1,4,0,4
17277_1,,,,2,2,1,3
17279_0,,,,2,2,1,3
C(C(CO)C(C=C)O)=O,,,5,1,4,0,4
17279_1,,,,2,2,1,3
17281_0,,,,2,2,1,3
C=CC(C(C(C(O)=O)=O)CO)O,,,5,1,4,0,4
17281_1,,,,2,2,1,3
17283_0,,,,2,2,1,3
C(C(C(C(C)=O)=O)C(C=C)O)=O,,,5,1,4,0,4
17283_1,,,,2,2,1,3
17285_0,,,,2,2,1,3
C(CC(C(CC(C=C)O)=O)=O)=O,,,5,1,3,0,3
17287_0,,,,2,2,1,3
C=CC(C(C(C(C(C)O)=O)=O)O)O,,,5,1,2,0,2
17287_1,,,,2,2,1,3
17289_0,,,,2,2,1,3
C=CC(C(C(C(C(O)=O)=O)=O)O)O,,,5,1,2,0,2
17289_1,,,,2,2,1,3
17291_0,,,,2,2,1,3
C=CC(CC(C(C(C)O)=O)=O)O,,,5,1,3,0,3
17293_0,,,,2,2,1,3
C=CC(CC(C(C(O)=O)=O)=O)O,,,5,1,3,0,3
17295_0,,,,2,2,1,3
C(CO)(C(C(C=C)O)O)=O,,,5,1,4,0,4
17295_1,,,,2,2,1,3
17297_0,,,,2,2,1,3
C(CO)(CC(C=C)O)=O,,,5,1,3,0,3
17299_0,,,,2,2,1,3
C(C)(C(C(C=C)O)O)=O,,,5,1,4,0,4
17299_1,,,,2,2,1,3
17301_0,,,,2,2,1,3
C(CC(C=C)O)(C(C(O)=O)CO)=O,,,5,1,1,0,1
17303_0,,,,2,2,1,3
C(CC(C=C)O)(C(C(O)=O)C)=O,,,5,1,3,0,3
17305_0,,,,2,2,1,3
C(C(C=C)C(C=C)O)=O,,,5,1,3,0,3
17307_0,,,,2,2,1,3
C=CC(C(C(O)=O)=O)C(C=C)O,,,5,1,3,0,3
17309_0,,,,2,2,1,3
C(C(C(C(O)=O)=C)C(C=C)O)=O,,,5,1,3,0,3
17311_0,,,,2,2,1,3
C=CC(C1C(C(OC(C1=C)=O)=O)=O)O,,,5,1,1,0,1
17313_0,,,,2,2,1,3
C(C(C(C=C)O)O)=O,,,5,1,6,0,6
17313_1,,,,2,2,1,3
17315_0,,,,2,2,1,3
C=CC(C1C(C(OC1C)=O)=O)O,,,5,1,4,0,4
17315_1,,,,2,2,1,3
17317_0,,,,2,2,1,3
C1(C(C(C(O1)=O)=O)C(C=C)O)=O,,,5,1,4,0,4
17317_1,,,,2,2,1,3
17319_0,,,,2,2,1,3
C=CC(C(C(C=O)=O)C[CH]C(O)=O)O,,,5,1,1,0,1
17321_0,,,,2,2,1,3
C(C(C[CH]C(O)=O)C(C=C)O)=O,,,5,1,3,0,3
17323_0,,,,2,2,1,3
C(CCC(C=O)C(C=C)O)(O)=O,,,5,1,3,0,3
17325_0,,,,2,2,1,3
C=CC(CC(C(O)=O)=O)O,,,5,1,3,0,3
17327_0,,,,2,2,1,3
C(C(C=C)(C(C=O)CCO)O)(O)=O,,,5,1,1,0,1
17329_0,,,,2,2,1,3
C(C(C=C)(CC=O)O)(O)=O,,,5,1,2,0,2
17331_0,,,,2,2,1,3
C(C(C=C)(C(C=O)C(C)O)O)(O)=O,,,5,1,2,0,2
17331_1,,,,2,2,1,3
17333_0,,,,2,2,1,3
C(C(C=O)C(C(O)=O)(C=C)O)(O)=O,,,5,1,2,0,2
17333_1,,,,2,2,1,3
17335_0,,,,2,2,1,3
C(C(C=C)(C(C(C=O)=O)O)O)(O)=O,,,5,1,3,0,3
17335_1,,,,2,2,1,3
17337_0,,,,2,2,1,3
C(C(C=C)(CC(C=O)=O)O)(O)=O,,,5,1,2,0,2
17339_0,,,,2,2,1,3
C(C(C=C)(C(C=O)CO)O)(O)=O,,,5,1,3,0,3
17339_1,,,,2,2,1,3
17341_0,,,,2,2,1,3
C(C(C=C)(C(C(CO)=O)O)O)(O)=O,,,5,1,3,0,3
17341_1,,,,2,2,1,3
17343_0,,,,2,2,1,3
C(C(C=C)(CC(CO)=O)O)(O)=O,,,5,1,2,0,2
17345_0,,,,2,2,1,3
C(C(C=C)(C(C(C)=O)O)O)(O)=O,,,5,1,5,0,5
17345_1,,,,2,2,1,3
17347_0,,,,2,2,1,3
C(C(C=C)C(C(O)=O)(C=C)O)=O,,,5,1,2,0,2
17349_0,,,,2,2,1,3
C(C(C=C)(C(C=O)O)O)(O)=O,,,5,1,5,0,5
17349_1,,,,2,2,1,3
17351_0,,,,2,2,1,3
C(C(C=C)(CC(C(O)=O)=O)O)(O)=O,,,5,1,2,0,2
17353_0,,,,2,2,1,3
C(CC(C=C(C(O)=O)CO)O)=O,,,5,1,2,0,2
17355_0,,,,2,2,1,3
C(C(C(C=C(C(O)=O)CO)O)O)=O,,,5,1,2,0,2
17355_1,,,,2,2,1,3
17357_0,,,,2,2,1,3
C(C(CC=O)(C(C=C)O)O)(O)=O,,,5,1,3,0,3
17359_0,,,,2,2,1,3
C(C(C(C=O)O)(C(C=C)O)O)(O)=O,,,5,1,6,0,6
17359_1,,,,2,2,1,3
17361_0,,,,2,2,1,3
C(C(CO)O)(C(C(C(O)=O)=C)O)=O,,,5,1,2,0,2
17361_1,,,,2,2,1,3
17363_0,,,,2,2,1,3
C(C(C(C(CC=O)O)=C)O)(O)=O,,,5,1,2,0,2
17365_0,,,,2,2,1,3
C(C(C(C(C(C=O)O)O)=C)O)(O)=O,,,5,1,2,0,2
17365_1,,,,2,2,1,3
17367_0,,,,2,2,1,3
C(CC(C(C(C(O)=O)=C)(C)O)O)=O,,,5,1,1,0,1
17369_0,,,,2,2,1,3
C(CC(C)(C(C(C(O)=O)=C)O)O)=O,,,5,1,1,0,1
17371_0,,,,2,2,1,3
C(CC(C)O)(C(C(C(O)=O)=C)O)=O,,,5,1,1,0,1
17373_0,,,,2,2,1,3
C(CC(C(C(C(O)=O)=C)O)=O)(O)=O,,,5,1,1,0,1
17375_0,,,,2,2,1,3
C(CCO)(C(C(C(O)=O)=C)O)=O,,,5,1,3,0,3
17377_0,,,,2,2,1,3
C(CC(C(C(O)=O)=C)(C)O)=O,,,5,1,2,0,2
17379_0,,,,2,2,1,3
C=C(C(O)=O)C(C)(CC(C=O)=O)O,,,5,1,1,0,1
17381_0,,,,2,2,1,3
C(C(CO)C(C(C(O)=O)=C)(C)O)=O,,,5,1,2,0,2
17381_1,,,,2,2,1,3
17383_0,,,,2,2,1,3
C(CC(C(C(O)=O)=C)(C)O)(CO)=O,,,5,1,1,0,1
17385_0,,,,2,2,1,3
C(C(C(C(C(O)=O)=C)(C)O)O)(C)=O,,,5,1,2,0,2
17385_1,,,,2,2,1,3
17387_0,,,,2,2,1,3
C(C(C=C)C(C(C(O)=O)=C)(C)O)=O,,,5,1,1,0,1
17389_0,,,,2,2,1,3
C(C(C(C(C(O)=O)=C)(C)O)O)=O,,,5,1,3,0,3
17389_1,,,,2,2,1,3
17391_0,,,,2,2,1,3
C=C(C(O)=O)C(CC(C(O)O)O)=O,,,5,1,1,0,1
17393_0,,,,2,2,1,3
C=C(C(O)=O)C(CC(C)O)=O,,,5,1,2,0,2
17394_0,,,,2,2,1,3
17396_0,,,,2,2,1,3
C(C(C)(CC(C(C(O)=O)=C)=O)O)=O,,,5,1,1,0,1
17398_0,,,,2,2,1,3
C(C)(C(CC(C(C(O)=O)=C)=O)O)=O,,,5,1,1,0,1
17400_0,,,,2,2,1,3
C=C(C(O)=O)C(CCO)=O,,,5,1,2,0,2
17402_0,,,,2,2,1,3
C=C(C(O)=O)C(CC(CCO)O)=O,,,5,1,1,0,1
17404_0,,,,2,2,1,3
C(C(CC(C(C(O)=O)=C)=O)O)=O,,,5,1,2,0,2
17406_0,,,,2,2,1,3
C=C(C(O)=O)C(CC(C)(CO)O)=O,,,5,1,1,0,1
17408_0,,,,2,2,1,3
C=C(C(O)=O)C(CC(C=CC)O)=O,,,5,1,1,0,1
17410_0,,,,2,2,1,3
C=CCC(CC(C(C(O)=O)=C)=O)O,,,5,1,1,0,1
17412_0,,,,2,2,1,3
C=C(C(O)=O)C(CC(CO)O)=O,,,5,1,2,0,2
17414_0,,,,2,2,1,3
C=C(C(O)=O)C(CC(C(C)O)O)=O,,,5,1,1,0,1
17416_0,,,,2,2,1,3
C(C(CC(C(C(O)=O)=C)=O)O)(O)=O,,,5,1,1,0,1
17418_0,,,,2,2,1,3
C1(C(C=C(C(C)=O)O1)(CC=O)O)=O,,,5,1,1,0,1
17420_0,,,,2,2,1,3
C(CC(C1OC(C(C=1)=O)=O)(C)O)=O,,,5,1,1,0,1
17422_0,,,,2,2,1,3
C1(C(C=C(C(CC(C)O)=O)O1)=O)=O,,,5,1,1,0,1
17424_0,,,,2,2,1,3
C(CC(C1OC(C(C=1)=O)=O)=O)(O)=O,,,5,1,1,0,1
17426_0,,,,2,2,1,3
C1(C(C=C(C(CCO)=O)O1)=O)=O,,,5,1,2,0,2
17428_0,,,,2,2,1,3
C(C(CC(C1OC(C(C=1)=O)=O)=O)O)=O,,,5,1,1,0,1
17430_0,,,,2,2,1,3
C1(C(CC=O)(CC(C(O1)=C)=O)O)=O,,,5,1,1,0,1
17432_0,,,,2,2,1,3
C(CC1(C(OC(C(C1)=O)=O)=C)O)=O,,,5,1,1,0,1
17434_0,,,,2,2,1,3
C=C1C(C(C(C(O1)=O)=O)C(C)O)=O,,,5,1,2,0,2
17434_1,,,,2,2,1,3
17436_0,,,,2,2,1,3
C(C1C(C(OC(C1=O)=C)=O)=O)(O)=O,,,5,1,2,0,2
17436_1,,,,2,2,1,3
17438_0,,,,2,2,1,3
C=C1C(C(C(C(O1)=O)=O)CO)=O,,,5,1,3,0,3
17438_1,,,,2,2,1,3
17440_0,,,,2,2,1,3
C(C(C1C(C(OC(C1=O)=C)=O)=O)O)=O,,,5,1,2,0,2
17440_1,,,,2,2,1,3
17442_0,,,,2,2,1,3
C(CC(C(C[CH]C(O)=O)=CC)O)=O,,,5,1,1,0,1
17444_0,,,,2,2,1,3
C(CC(C(C=C)C[CH]C(O)=O)O)=O,,,5,1,2,0,2
17446_0,,,,2,2,1,3
C(CCC(C(CC=O)O)=CC)(O)=O,,,5,1,1,0,1
17448_0,,,,2,2,1,3
C(CCC(C=C)C(CC=O)O)(O)=O,,,5,1,2,0,2
17450_0,,,,2,2,1,3
C(CC(C=CCC[CH]C(O)=O)O)=O,,,5,1,2,0,2
17452_0,,,,2,2,1,3
C(CC(CC=CC[CH]C(O)=O)O)=O,,,5,1,1,0,1
17454_0,,,,2,2,1,3
C(C(C=CC[CH]C(O)=O)C(C)O)=O,,,5,1,1,0,1
17456_0,,,,2,2,1,3
C(C(C(O)=O)C=CC[CH]C(O)=O)=O,,,5,1,1,0,1
17458_0,,,,2,2,1,3
C(C(C=CC[CH]C(O)=O)CO)=O,,,5,1,2,0,2
17460_0,,,,2,2,1,3
C(C(C=CC[CH]C(O)=O)C(C=O)O)=O,,,5,1,1,0,1
17462_0,,,,2,2,1,3
C(CCCC=CC(CC=O)O)(O)=O,,,5,1,2,0,2
17464_0,,,,2,2,1,3
C(CC(CC=CCCC(O)=O)O)=O,,,5,1,1,0,1
17466_0,,,,2,2,1,3
C(C(C=CCCC(O)=O)C(C)O)=O,,,5,1,1,0,1
17468_0,,,,2,2,1,3
C(C(C(O)=O)C=CCCC(O)=O)=O,,,5,1,1,0,1
17470_0,,,,2,2,1,3
C(C(C=CCCC(O)=O)CO)=O,,,5,1,2,0,2
17472_0,,,,2,2,1,3
C(CC(CC(C)=C[CH]C(O)=O)O)=O,,,5,1,1,0,1
17474_0,,,,2,2,1,3
C(C(C(C)=C[CH]C(O)=O)C(C)O)=O,,,5,1,1,0,1
17476_0,,,,2,2,1,3
C(C(C(O)=O)C(C)=C[CH]C(O)=O)=O,,,5,1,1,0,1
17478_0,,,,2,2,1,3
C(C(C(C)=C[CH]C(O)=O)CO)=O,,,5,1,2,0,2
17480_0,,,,2,2,1,3
C(C(C(C)=C[CH]C(O)=O)C(C=O)O)=O,,,5,1,1,0,1
17482_0,,,,2,2,1,3
C(CC(C=C(C)C[CH]C(O)=O)O)=O,,,5,1,1,0,1
17484_0,,,,2,2,1,3
C(CC(CC(C[CH]C(O)=O)=C)O)=O,,,5,1,1,0,1
17486_0,,,,2,2,1,3
C(C(C(C[CH]C(O)=O)=C)C(C)O)=O,,,5,1,1,0,1
17488_0,,,,2,2,1,3
C(C(C(O)=O)C(C[CH]C(O)=O)=C)=O,,,5,1,1,0,1
17490_0,,,,2,2,1,3
C(C(C(C[CH]C(O)=O)=C)CO)=O,,,5,1,2,0,2
17492_0,,,,2,2,1,3
C(C(C(C[CH]C(O)=O)=C)C(C=O)O)=O,,,5,1,1,0,1
17494_0,,,,2,2,1,3
C(CC(CC(C)=CCC(O)=O)O)=O,,,5,1,1,0,1
17496_0,,,,2,2,1,3
C(C(C(C)=CCC(O)=O)C(C)O)=O,,,5,1,1,0,1
17498_0,,,,2,2,1,3
C(C(C(O)=O)C(C)=CCC(O)=O)=O,,,5,1,1,0,1
17500_0,,,,2,2,1,3
C(C(C(C)=CCC(O)=O)CO)=O,,,5,1,2,0,2
17502_0,,,,2,2,1,3
C(CCC(C)=CC(CC=O)O)(O)=O,,,5,1,1,0,1
17504_0,,,,2,2,1,3
C(CC(CC(CCC(O)=O)=C)O)=O,,,5,1,1,0,1
17506_0,,,,2,2,1,3
C(C(C(CCC(O)=O)=C)C(C)O)=O,,,5,1,1,0,1
17508_0,,,,2,2,1,3
C(C(C(O)=O)C(CCC(O)=O)=C)=O,,,5,1,1,0,1
17510_0,,,,2,2,1,3
C(C(C(CCC(O)=O)=C)CO)=O,,,5,1,2,0,2
17512_0,,,,2,2,1,3
C(CC(C(C=C[CH]C(O)=O)=O)O)=O,,,5,1,1,0,1
17514_0,,,,2,2,1,3
C(C(C=C[CH]C(O)=O)(CC=O)O)=O,,,5,1,1,0,1
17516_0,,,,2,2,1,3
C(CC(C(CO)O)(C(C)O)O)=O,,,5,1,2,0,2
17518_0,,,,2,2,1,3
C(C(C(C(CO)O)(C(C)O)O)O)=O,,,5,1,5,0,5
17518_1,,,,2,2,1,3
17520_0,,,,2,2,1,3
C(C(CCO)C(C(CC)O)O)=O,,,5,1,1,0,1
17522_0,,,,2,2,1,3
C1(C(O)OCC1C(C(CC)O)O)=O,,,5,1,2,0,2
17522_1,,,,2,2,1,3
17524_0,,,,2,2,1,3
C1(C(C(CO1)C(C(CC)O)O)=O)=O,,,5,1,2,0,2
17524_1,,,,2,2,1,3
17526_0,,,,2,2,1,3
C(C(C(C(CC)O)O)C(C)CO)=O,,,5,1,1,0,1
17528_0,,,,2,2,1,3
C(CC(C(CC)O)O)=O,,,5,1,2,0,2
17530_0,,,,2,2,1,3
C(C(C(C)O)C(C(CC)O)O)=O,,,5,1,3,0,3
17530_1,,,,2,2,1,3
17532_0,,,,2,2,1,3
C(C(C=O)C(C(CC)O)O)(O)=O,,,5,1,3,0,3
17532_1,,,,2,2,1,3
17534_0,,,,2,2,1,3
C(C(C(C(C(CC)O)O)O)=O)=O,,,5,1,3,0,3
17534_1,,,,2,2,1,3
17536_0,,,,2,2,1,3
C(C(CC(C(CC)O)O)=O)=O,,,5,1,2,0,2
17538_0,,,,2,2,1,3
C(C(C(C(C(CC)O)O)O)=O)(O)=O,,,5,1,3,0,3
17538_1,,,,2,2,1,3
17540_0,,,,2,2,1,3
C(C(C(CO)C(C(CC)O)O)=O)=O,,,5,1,3,0,3
17540_1,,,,2,2,1,3
17542_0,,,,2,2,1,3
C(C(CO)C(C(CC)O)O)=O,,,5,1,3,0,3
17542_1,,,,2,2,1,3
17544_0,,,,2,2,1,3
C(CO)(C(C(C(CC)O)O)O)=O,,,5,1,3,0,3
17544_1,,,,2,2,1,3
17546_0,,,,2,2,1,3
C(CO)(CC(C(CC)O)O)=O,,,5,1,2,0,2
17548_0,,,,2,2,1,3
C(C)(C(C(C(CC)O)O)O)=O,,,5,1,3,0,3
17548_1,,,,2,2,1,3
17550_0,,,,2,2,1,3
C(C(C=C)C(C(CC)O)O)=O,,,5,1,2,0,2
17552_0,,,,2,2,1,3
C(C(C(C(CC)O)O)O)=O,,,5,1,3,0,3
17552_1,,,,2,2,1,3
17554_0,,,,2,2,1,3
C(C(CC(C(CC)O)O)=O)(O)=O,,,5,1,2,0,2
17556_0,,,,2,2,1,3
C(C(CCO)C(CCCO)O)=O,,,5,1,1,0,1
17558_0,,,,2,2,1,3
C1(C(O)OCC1C(CCCO)O)=O,,,5,1,2,0,2
17558_1,,,,2,2,1,3
17560_0,,,,2,2,1,3
C1(C(C(CO1)C(CCCO)O)=O)=O,,,5,1,2,0,2
17560_1,,,,2,2,1,3
17562_0,,,,2,2,1,3
C(C(C(CCCO)O)C(C)CO)=O,,,5,1,1,0,1
17564_0,,,,2,2,1,3
C(CC(CCCO)O)=O,,,5,1,2,0,2
17566_0,,,,2,2,1,3
C(C(C(C)O)C(CCCO)O)=O,,,5,1,3,0,3
17566_1,,,,2,2,1,3
17568_0,,,,2,2,1,3
C(C(C=O)C(CCCO)O)(O)=O,,,5,1,3,0,3
17568_1,,,,2,2,1,3
17570_0,,,,2,2,1,3
C(C(C(C(CCCO)O)O)=O)=O,,,5,1,3,0,3
17570_1,,,,2,2,1,3
17572_0,,,,2,2,1,3
C(C(CC(CCCO)O)=O)=O,,,5,1,2,0,2
17574_0,,,,2,2,1,3
C(C(C(C(CCCO)O)O)=O)(O)=O,,,5,1,3,0,3
17574_1,,,,2,2,1,3
17576_0,,,,2,2,1,3
C(C(C(CO)C(CCCO)O)=O)=O,,,5,1,3,0,3
17576_1,,,,2,2,1,3
17578_0,,,,2,2,1,3
C(C(CO)C(CCCO)O)=O,,,5,1,3,0,3
17578_1,,,,2,2,1,3
17580_0,,,,2,2,1,3
C(CO)(C(C(CCCO)O)O)=O,,,5,1,3,0,3
17580_1,,,,2,2,1,3
17582_0,,,,2,2,1,3
C(CO)(CC(CCCO)O)=O,,,5,1,2,0,2
17584_0,,,,2,2,1,3
C(C)(C(C(CCCO)O)O)=O,,,5,1,3,0,3
17584_1,,,,2,2,1,3
17586_0,,,,2,2,1,3
C(C(C=C)C(CCCO)O)=O,,,5,1,2,0,2
17588_0,,,,2,2,1,3
C(C(C(CCCO)O)O)=O,,,5,1,3,0,3
17588_1,,,,2,2,1,3
17590_0,,,,2,2,1,3
C(C(CC(CCCO)O)=O)(O)=O,,,5,1,2,0,2
17592_0,,,,2,2,1,3
C(C(CCO)C1(C(O)OCC1)O)=O,,,5,1,1,0,1
17594_0,,,,2,2,1,3
C(C(CCO)C1(C(OCC1)=O)O)=O,,,5,1,1,0,1
17596_0,,,,2,2,1,3
C(C(CCO)C(CC(C)CO)O)=O,,,5,1,1,0,1
17598_0,,,,2,2,1,3
C(C(CCO)C(C(CCO)O)O)=O,,,5,1,1,0,1
17600_0,,,,2,2,1,3
C(C(CCO)C(C(O)O)O)=O,,,5,1,1,0,1
17602_0,,,,2,2,1,3
C(C(CCO)C(C)O)=O,,,5,1,3,0,3
17604_0,,,,2,2,1,3
C(C(C=O)CCO)(O)=O,,,5,1,5,0,5
17606_0,,,,2,2,1,3
C(C(CCO)C(CC(C)O)O)=O,,,5,1,2,0,2
17608_0,,,,2,2,1,3
C(C(C(CC(O)=O)O)CCO)=O,,,5,1,2,0,2
17610_0,,,,2,2,1,3
C(C(CCO)C(C(CO)=O)O)=O,,,5,1,2,0,2
17612_0,,,,2,2,1,3
C(C(CCO)C(C=O)(CO)O)=O,,,5,1,2,0,2
17614_0,,,,2,2,1,3
C(C(CCO)C(C=O)(C)O)=O,,,5,1,2,0,2
17616_0,,,,2,2,1,3
C(C(CCO)C(C(C)=O)O)=O,,,5,1,2,0,2
17618_0,,,,2,2,1,3
C(C(CO)CCO)=O,,,5,1,2,0,2
17620_0,,,,2,2,1,3
C(C(CCO)C(C(O)=O)(CO)O)=O,,,5,1,3,0,3
17622_0,,,,2,2,1,3
C(C(CCO)C(C=O)(CCO)O)=O,,,5,1,2,0,2
17624_0,,,,2,2,1,3
C(C(CCO)C(C(CCO)=O)O)=O,,,5,1,2,0,2
17626_0,,,,2,2,1,3
C(C(CCO)C(CCO)O)=O,,,5,1,2,0,2
17628_0,,,,2,2,1,3
C(C(CCO)C(C=O)O)=O,,,5,1,2,0,2
17630_0,,,,2,2,1,3
C(C(C(C(C=O)O)O)CCO)=O,,,5,1,2,0,2
17632_0,,,,2,2,1,3
C(C(C(C(C(O)=O)O)O)CCO)=O,,,5,1,2,0,2
17634_0,,,,2,2,1,3
C(C(CCO)C(CO)(CO)O)=O,,,5,1,2,0,2
17636_0,,,,2,2,1,3
C(C(CCO)C(C)(CO)O)=O,,,5,1,2,0,2
17638_0,,,,2,2,1,3
C(C(CCO)C(C=CC)O)=O,,,5,1,2,0,2
17640_0,,,,2,2,1,3
C(C(C(CC=C)O)CCO)=O,,,5,1,2,0,2
17642_0,,,,2,2,1,3
C(C(CCO)C(C(CO)O)O)=O,,,5,1,2,0,2
17644_0,,,,2,2,1,3
C(C(CCO)C(CO)O)=O,,,5,1,2,0,2
17646_0,,,,2,2,1,3
C(C(CCO)C(C(C)O)O)=O,,,5,1,2,0,2
17648_0,,,,2,2,1,3
C(C(CCO)C(C(O)=O)O)=O,,,5,1,3,0,3
17650_0,,,,2,2,1,3
C(C(CCO)C(C(O)=O)(C)O)=O,,,5,1,3,0,3
17652_0,,,,2,2,1,3
C(C(C(CC)O)(CC=O)O)(O)=O,,,5,1,2,0,2
17654_0,,,,2,2,1,3
C(C(C(CC)O)(C(C=O)O)O)(O)=O,,,5,1,3,0,3
17654_1,,,,2,2,1,3
17656_0,,,,2,2,1,3
C(C(CCCO)(CC=O)O)(O)=O,,,5,1,2,0,2
17658_0,,,,2,2,1,3
C(C(CCCO)(C(C=O)O)O)(O)=O,,,5,1,3,0,3
17658_1,,,,2,2,1,3
17660_0,,,,2,2,1,3
C(C(C(CCO)C(C)O)=O)(O)=O,,,5,1,3,0,3
17662_0,,,,2,2,1,3
C(C(C(C(O)=O)=O)CCO)(O)=O,,,5,1,4,0,4
17664_0,,,,2,2,1,3
C(C(C(CO)CCO)=O)(O)=O,,,5,1,2,0,2
17666_0,,,,2,2,1,3
C(C(C(C(C(O)=O)=O)CCO)O)=O,,,5,1,2,0,2
17668_0,,,,2,2,1,3
C(C(C(CCO)C(CO)O)=O)(O)=O,,,5,1,2,0,2
17670_0,,,,2,2,1,3
C(C(CO)CC(CC=O)O)(O)=O,,,5,1,3,0,3
17672_0,,,,2,2,1,3
C(C(CO)CC(C(C=O)O)O)(O)=O,,,5,1,4,0,4
17672_1,,,,2,2,1,3
17674_0,,,,2,2,1,3
C(C(CO)C(C=O)C(C)O)(O)=O,,,5,1,4,0,4
17676_0,,,,2,2,1,3
C(C(C=O)C(C(O)=O)CO)(O)=O,,,5,1,4,0,4
17678_0,,,,2,2,1,3
C(C(CO)C(C=O)CO)(O)=O,,,5,1,4,0,4
17680_0,,,,2,2,1,3
C(C(CO)C(C=O)C(C=O)O)(O)=O,,,5,1,3,0,3
17682_0,,,,2,2,1,3
C(C(CO)C(C=O)C(CO)O)(O)=O,,,5,1,3,0,3
17684_0,,,,2,2,1,3
C(C(C)C(C(CC=O)O)O)(O)=O,,,5,1,2,0,2
17686_0,,,,2,2,1,3
C(C(C)C(C(C(C=O)O)O)O)(O)=O,,,5,1,4,0,4
17686_1,,,,2,2,1,3
17688_0,,,,2,2,1,3
C1(C(CO)C(C(C(O1)=O)=O)CO)=O,,,5,1,2,0,2
17690_0,,,,2,2,1,3
C1(C(O)OC(CC(C)O)C1CO)=O,,,5,1,3,0,3
17690_1,,,,2,2,1,3
17692_0,,,,2,2,1,3
C(CC1C(C(C(O)O1)=O)CO)(O)=O,,,5,1,3,0,3
17692_1,,,,2,2,1,3
17694_0,,,,2,2,1,3
C(C1C(C(C(O1)O)=O)CO)(CO)=O,,,5,1,3,0,3
17694_1,,,,2,2,1,3
17696_0,,,,2,2,1,3
C1(C(OC(C(C(CO)O)=O)C1)O)=O,,,5,1,3,0,3
17696_1,,,,2,2,1,3
17698_0,,,,2,2,1,3
C(C1(CO)C(C(C(O1)O)=O)CO)=O,,,5,1,3,0,3
17698_1,,,,2,2,1,3
17700_0,,,,2,2,1,3
C(CC(C1(COC(C1)O)O)O)=O,,,5,1,2,0,2
17702_0,,,,2,2,1,3
C(C(C(C1(COC(C1)O)O)O)O)=O,,,5,1,3,0,3
17702_1,,,,2,2,1,3
17704_0,,,,2,2,1,3
C(C1C(C(C(O1)O)=O)O)(CCO)=O,,,5,1,2,0,2
17706_0,,,,2,2,1,3
C(CC1(C(O)OCC1O)O)=O,,,5,1,2,0,2
17708_0,,,,2,2,1,3
C(C(CC1(C(O)OCC1O)O)=O)=O,,,5,1,2,0,2
17710_0,,,,2,2,1,3
C(C(CO)C1(C(O)OCC1O)O)=O,,,5,1,3,0,3
17710_1,,,,2,2,1,3
17712_0,,,,2,2,1,3
C(CO)(CC1(C(O)OCC1O)O)=O,,,5,1,2,0,2
17714_0,,,,2,2,1,3
C(C)(C(C1(C(O)OCC1O)O)O)=O,,,5,1,3,0,3
17714_1,,,,2,2,1,3
17716_0,,,,2,2,1,3
C(C(C=C)C1(C(O)OCC1O)O)=O,,,5,1,2,0,2
17718_0,,,,2,2,1,3
C(C(C1(C(O)OCC1O)O)O)=O,,,5,1,3,0,3
17718_1,,,,2,2,1,3
17720_0,,,,2,2,1,3
C(CC1(C(O)OC(C)C1O)O)=O,,,5,1,2,0,2
17722_0,,,,2,2,1,3
C(C(C1(C(O)OC(C)C1O)O)O)=O,,,5,1,3,0,3
17722_1,,,,2,2,1,3
17724_0,,,,2,2,1,3
C(CC1(C(O)OC(C1O)=O)O)=O,,,5,1,2,0,2
17726_0,,,,2,2,1,3
C1(C(C(C(O)O1)(C(C=O)O)O)O)=O,,,5,1,3,0,3
17726_1,,,,2,2,1,3
17728_0,,,,2,2,1,3
C(C1(C)CC(C(O1)O)(CC=O)O)=O,,,5,1,2,0,2
17730_0,,,,2,2,1,3
C(CC(C1(C)CC(C(O)O1)=O)O)=O,,,5,1,2,0,2
17732_0,,,,2,2,1,3
C(C1(C)C(C(C(O1)O)=O)C(C)O)=O,,,5,1,3,0,3
17732_1,,,,2,2,1,3
17734_0,,,,2,2,1,3
C(C1(C)C(C(O)=O)C(C(O1)O)=O)=O,,,5,1,3,0,3
17734_1,,,,2,2,1,3
17736_0,,,,2,2,1,3
C(C1(C)C(C(C(O1)O)=O)CO)=O,,,5,1,3,0,3
17736_1,,,,2,2,1,3
17738_0,,,,2,2,1,3
C(CC1(CC(C(C)=O)OC1O)O)=O,,,5,1,2,0,2
17740_0,,,,2,2,1,3
C(CC(C)(C1CC(C(O)O1)=O)O)=O,,,5,1,2,0,2
17742_0,,,,2,2,1,3
C(C1C(C(C(O1)O)=O)C(C)O)(C)=O,,,5,1,3,0,3
17742_1,,,,2,2,1,3
17744_0,,,,2,2,1,3
C(C1C(C(O)OC1C(C)=O)=O)(O)=O,,,5,1,3,0,3
17744_1,,,,2,2,1,3
17746_0,,,,2,2,1,3
C(C1C(C(C(O1)O)=O)CO)(C)=O,,,5,1,3,0,3
17746_1,,,,2,2,1,3
17748_0,,,,2,2,1,3
C1(C(OC(C(CC(C)O)=O)C1)O)=O,,,5,1,2,0,2
17750_0,,,,2,2,1,3
C(CC(C1CC(C(O)O1)=O)=O)(O)=O,,,5,1,2,0,2
17752_0,,,,2,2,1,3
C1(C(OC(C(CCO)=O)C1)O)=O,,,5,1,2,0,2
17754_0,,,,2,2,1,3
C(CC1(C(O)OCC1)O)=O,,,5,1,2,0,2
17756_0,,,,2,2,1,3
C(C(C(C)O)C1(C(O)OCC1)O)=O,,,5,1,3,0,3
17756_1,,,,2,2,1,3
17758_0,,,,2,2,1,3
C(C(C=O)C1(C(O)OCC1)O)(O)=O,,,5,1,3,0,3
17758_1,,,,2,2,1,3
17760_0,,,,2,2,1,3
C(C(C(C1(C(O)OCC1)O)O)=O)=O,,,5,1,3,0,3
17760_1,,,,2,2,1,3
17762_0,,,,2,2,1,3
C(C(CC1(C(O)OCC1)O)=O)=O,,,5,1,2,0,2
17764_0,,,,2,2,1,3
C(C(CO)C1(C(O)OCC1)O)=O,,,5,1,3,0,3
17764_1,,,,2,2,1,3
17766_0,,,,2,2,1,3
C(CO)(C(C1(C(O)OCC1)O)O)=O,,,5,1,3,0,3
17766_1,,,,2,2,1,3
17768_0,,,,2,2,1,3
C(CO)(CC1(C(O)OCC1)O)=O,,,5,1,2,0,2
17770_0,,,,2,2,1,3
C(C)(C(C1(C(O)OCC1)O)O)=O,,,5,1,3,0,3
17770_1,,,,2,2,1,3
17772_0,,,,2,2,1,3
C(C(C=C)C1(C(O)OCC1)O)=O,,,5,1,2,0,2
17774_0,,,,2,2,1,3
C(C(C1(C(O)OCC1)O)O)=O,,,5,1,3,0,3
17774_1,,,,2,2,1,3
17776_0,,,,2,2,1,3
C(C(CC1(C(O)OCC1)O)=O)(O)=O,,,5,1,2,0,2
17778_0,,,,2,2,1,3
C1(C(O)OCC1C(C(O)O)O)=O,,,5,1,2,0,2
17778_1,,,,2,2,1,3
17780_0,,,,2,2,1,3
C1(C(O)OCC1C(C)O)=O,,,5,1,3,0,3
17780_1,,,,2,2,1,3
17782_0,,,,2,2,1,3
C(C1C(C(O)OC1)=O)(O)=O,,,5,1,3,0,3
17782_1,,,,2,2,1,3
17784_0,,,,2,2,1,3
C1(C(O)OCC1C(CC(C)O)O)=O,,,5,1,3,0,3
17784_1,,,,2,2,1,3
17786_0,,,,2,2,1,3
C(CC(C1C(C(O)OC1)=O)O)(O)=O,,,5,1,3,0,3
17786_1,,,,2,2,1,3
17788_0,,,,2,2,1,3
C(C(C1C(C(O)OC1)=O)O)(CO)=O,,,5,1,3,0,3
17788_1,,,,2,2,1,3
17790_0,,,,2,2,1,3
C(C(CO)(C1C(C(O)OC1)=O)O)=O,,,5,1,3,0,3
17790_1,,,,2,2,1,3
17792_0,,,,2,2,1,3
C(C(C)(C1C(C(O)OC1)=O)O)=O,,,5,1,3,0,3
17792_1,,,,2,2,1,3
17794_0,,,,2,2,1,3
C(C(C1C(C(O)OC1)=O)O)(C)=O,,,5,1,3,0,3
17794_1,,,,2,2,1,3
17796_0,,,,2,2,1,3
C1(C(O)OCC1CO)=O,,,5,1,3,0,3
17796_1,,,,2,2,1,3
17798_0,,,,2,2,1,3
C1(C(O)OCC1C(CCO)O)=O,,,5,1,3,0,3
17798_1,,,,2,2,1,3
17800_0,,,,2,2,1,3
C1(C(O)OCC1C(C=O)O)=O,,,5,1,3,0,3
17800_1,,,,2,2,1,3
17802_0,,,,2,2,1,3
C(C(C(C1C(C(O)OC1)=O)O)O)=O,,,5,1,3,0,3
17802_1,,,,2,2,1,3
17804_0,,,,2,2,1,3
C1(C(O)OCC1C(CO)(CO)O)=O,,,5,1,3,0,3
17804_1,,,,2,2,1,3
17806_0,,,,2,2,1,3
C1(C(O)OCC1C(CO)(C)O)=O,,,5,1,3,0,3
17806_1,,,,2,2,1,3
17808_0,,,,2,2,1,3
C1(C(O)OCC1C(C=CC)O)=O,,,5,1,3,0,3
17808_1,,,,2,2,1,3
17810_0,,,,2,2,1,3
C1(C(O)OCC1C(CC=C)O)=O,,,5,1,3,0,3
17810_1,,,,2,2,1,3
17812_0,,,,2,2,1,3
C1(C(O)OCC1C(C(CO)O)O)=O,,,5,1,3,0,3
17812_1,,,,2,2,1,3
17814_0,,,,2,2,1,3
C1(C(O)OCC1C(CO)O)=O,,,5,1,3,0,3
17814_1,,,,2,2,1,3
17816_0,,,,2,2,1,3
C1(C(O)OCC1C(C(C)O)O)=O,,,5,1,3,0,3
17816_1,,,,2,2,1,3
17818_0,,,,2,2,1,3
C1(C(O)OCC1C(C(O)=O)O)=O,,,5,1,3,0,3
17818_1,,,,2,2,1,3
17820_0,,,,2,2,1,3
C(C(C)(C1C(C(O)OC1)=O)O)(O)=O,,,5,1,3,0,3
17820_1,,,,2,2,1,3
17822_0,,,,2,2,1,3
C(CC1(C(O)OC(C)C1)O)=O,,,5,1,2,0,2
17824_0,,,,2,2,1,3
C(C(CC1(C(O)OC(C)C1)O)=O)=O,,,5,1,2,0,2
17826_0,,,,2,2,1,3
C(C(CO)C1(C(O)OC(C)C1)O)=O,,,5,1,3,0,3
17826_1,,,,2,2,1,3
17828_0,,,,2,2,1,3
C(CO)(CC1(C(O)OC(C)C1)O)=O,,,5,1,2,0,2
17830_0,,,,2,2,1,3
C(C)(C(C1(C(O)OC(C)C1)O)O)=O,,,5,1,3,0,3
17830_1,,,,2,2,1,3
17832_0,,,,2,2,1,3
C(C(C=C)C1(C(O)OC(C)C1)O)=O,,,5,1,2,0,2
17834_0,,,,2,2,1,3
C(C(C1(C(O)OC(C)C1)O)O)=O,,,5,1,3,0,3
17834_1,,,,2,2,1,3
17836_0,,,,2,2,1,3
C1(C(O)OC(C)C1C(C(O)O)O)=O,,,5,1,2,0,2
17836_1,,,,2,2,1,3
17838_0,,,,2,2,1,3
C1(C(O)OC(C)C1C(C)O)=O,,,5,1,3,0,3
17838_1,,,,2,2,1,3
17840_0,,,,2,2,1,3
C(C1C(C(O)OC1C)=O)(O)=O,,,5,1,3,0,3
17840_1,,,,2,2,1,3
17842_0,,,,2,2,1,3
C(C(C)(C1C(C(O)OC1C)=O)O)=O,,,5,1,3,0,3
17842_1,,,,2,2,1,3
17844_0,,,,2,2,1,3
C(C(C1C(C(O)OC1C)=O)O)(C)=O,,,5,1,3,0,3
17844_1,,,,2,2,1,3
17846_0,,,,2,2,1,3
C1(C(O)OC(C)C1CO)=O,,,5,1,3,0,3
17846_1,,,,2,2,1,3
17848_0,,,,2,2,1,3
C1(C(O)OC(C)C1C(CCO)O)=O,,,5,1,3,0,3
17848_1,,,,2,2,1,3
17850_0,,,,2,2,1,3
C1(C(O)OC(C)C1C(C=O)O)=O,,,5,1,3,0,3
17850_1,,,,2,2,1,3
17852_0,,,,2,2,1,3
C1(C(O)OC(C)C1C(CO)(C)O)=O,,,5,1,3,0,3
17852_1,,,,2,2,1,3
17854_0,,,,2,2,1,3
C1(C(O)OC(C)C1C(C=CC)O)=O,,,5,1,3,0,3
17854_1,,,,2,2,1,3
17856_0,,,,2,2,1,3
C1(C(O)OC(C)C1C(CC=C)O)=O,,,5,1,3,0,3
17856_1,,,,2,2,1,3
17858_0,,,,2,2,1,3
C1(C(O)OC(C)C1C(CO)O)=O,,,5,1,3,0,3
17858_1,,,,2,2,1,3
17860_0,,,,2,2,1,3
C1(C(O)OC(C)C1C(C(C)O)O)=O,,,5,1,3,0,3
17860_1,,,,2,2,1,3
17862_0,,,,2,2,1,3
C1(C(O)OC(C)C1C(C(O)=O)O)=O,,,5,1,3,0,3
17862_1,,,,2,2,1,3
17864_0,,,,2,2,1,3
C1(CC(C(O)O1)(CC=O)O)=O,,,5,1,2,0,2
17866_0,,,,2,2,1,3
C1(CC(C(O)O1)(CC(C=O)=O)O)=O,,,5,1,2,0,2
17868_0,,,,2,2,1,3
C(C(CO)C1(C(O)OC(C1)=O)O)=O,,,5,1,3,0,3
17868_1,,,,2,2,1,3
17870_0,,,,2,2,1,3
C1(CC(C(O)O1)(CC(CO)=O)O)=O,,,5,1,2,0,2
17872_0,,,,2,2,1,3
C1(CC(C(O)O1)(C(C(C)=O)O)O)=O,,,5,1,3,0,3
17872_1,,,,2,2,1,3
17874_0,,,,2,2,1,3
C(C(C=C)C1(C(O)OC(C1)=O)O)=O,,,5,1,2,0,2
17876_0,,,,2,2,1,3
C1(CC(C(O)O1)(C(C=O)O)O)=O,,,5,1,3,0,3
17876_1,,,,2,2,1,3
17878_0,,,,2,2,1,3
C1(C(C(C(O)O1)=O)C(C(O)O)O)=O,,,5,1,2,0,2
17878_1,,,,2,2,1,3
17880_0,,,,2,2,1,3
C1(C(C(C(O)O1)=O)C(C)O)=O,,,5,1,3,0,3
17880_1,,,,2,2,1,3
17882_0,,,,2,2,1,3
C1(C(C(O)=O)C(C(O)O1)=O)=O,,,5,1,3,0,3
17882_1,,,,2,2,1,3
17884_0,,,,2,2,1,3
C(C(C)(C1C(OC(C1=O)O)=O)O)=O,,,5,1,3,0,3
17884_1,,,,2,2,1,3
17886_0,,,,2,2,1,3
C1(C(C(C(O)O1)=O)C(C(C)=O)O)=O,,,5,1,3,0,3
17886_1,,,,2,2,1,3
17888_0,,,,2,2,1,3
C1(C(C(C(O)O1)=O)CO)=O,,,5,1,3,0,3
17888_1,,,,2,2,1,3
17890_0,,,,2,2,1,3
C1(C(C(C(O)O1)=O)C(CCO)O)=O,,,5,1,3,0,3
17890_1,,,,2,2,1,3
17892_0,,,,2,2,1,3
C1(C(C(C(O)O1)=O)C(C=O)O)=O,,,5,1,3,0,3
17892_1,,,,2,2,1,3
17894_0,,,,2,2,1,3
C1(C(C(C(O)O1)=O)C(CO)(C)O)=O,,,5,1,3,0,3
17894_1,,,,2,2,1,3
17896_0,,,,2,2,1,3
C1(C(C(C(O)O1)=O)C(C=CC)O)=O,,,5,1,3,0,3
17896_1,,,,2,2,1,3
17898_0,,,,2,2,1,3
C1(C(C(C(O)O1)=O)C(CC=C)O)=O,,,5,1,3,0,3
17898_1,,,,2,2,1,3
17900_0,,,,2,2,1,3
C1(C(C(C(O)O1)=O)C(CO)O)=O,,,5,1,3,0,3
17900_1,,,,2,2,1,3
17902_0,,,,2,2,1,3
C1(C(C(C(O)O1)=O)C(C(C)O)O)=O,,,5,1,3,0,3
17902_1,,,,2,2,1,3
17904_0,,,,2,2,1,3
C1(C(C(C(O)O1)=O)C(C(O)=O)O)=O,,,5,1,3,0,3
17904_1,,,,2,2,1,3
17906_0,,,,2,2,1,3
C(C1(C)C(C(C(O1)O)=O)CO)(O)=O,,,5,1,3,0,3
17906_1,,,,2,2,1,3
17908_0,,,,2,2,1,3
C1(C(C)(O)O[C](C(O)=O)C1CO)=O,,,5,1,3,0,3
17908_1,,,,2,2,1,3
17910_0,,,,2,2,1,3
C(C1(C[C](C(O1)=O)O)O)(CCO)=O,,,5,1,2,0,2
17912_0,,,,2,2,1,3
C1(C(C)(OC(C(O)=O)C1CO)O)=O,,,5,1,3,0,3
17912_1,,,,2,2,1,3
17914_0,,,,2,2,1,3
C1(C(CC(C(CCO)=O)(O)O1)O)=O,,,5,1,2,0,2
17916_0,,,,2,2,1,3
C1(C(CC(C=O)(OC1CO)O)O)=O,,,5,1,3,0,3
17916_1,,,,2,2,1,3
17918_0,,,,2,2,1,3
C(CC1(COC(CC1O)O)O)=O,,,5,1,2,0,2
17920_0,,,,2,2,1,3
C(C(C1(COC(CC1O)O)O)O)=O,,,5,1,3,0,3
17920_1,,,,2,2,1,3
17922_0,,,,2,2,1,3
C1(C(C(C)O)OC(CC1O)O)=O,,,5,1,3,0,3
17922_1,,,,2,2,1,3
17924_0,,,,2,2,1,3
C(C1C(C(CC(O1)O)O)=O)(O)=O,,,5,1,3,0,3
17924_1,,,,2,2,1,3
17926_0,,,,2,2,1,3
C1(C(CO)OC(CC1O)O)=O,,,5,1,3,0,3
17926_1,,,,2,2,1,3
17928_0,,,,2,2,1,3
C(C(C1C(C(CC(O1)O)O)=O)O)=O,,,5,1,3,0,3
17928_1,,,,2,2,1,3
17930_0,,,,2,2,1,3
C1(C(C(CO)O)OC(CC1O)O)=O,,,5,1,3,0,3
17930_1,,,,2,2,1,3
17932_0,,,,2,2,1,3
C(C1(COC(C(C1CO)=O)O)O)=O,,,5,1,3,0,3
17932_1,,,,2,2,1,3
17934_0,,,,2,2,1,3
C1(C(C(CO)C(C)(C(O)O1)O)=O)=O,,,5,1,3,0,3
17934_1,,,,2,2,1,3
17936_0,,,,2,2,1,3
C1(C(C(CO)C(C(C)(O)O1)O)=O)=O,,,5,1,3,0,3
17936_1,,,,2,2,1,3
17938_0,,,,2,2,1,3
C1(C(C)(C(C(C(O)O1)=O)CO)O)=O,,,5,1,3,0,3
17938_1,,,,2,2,1,3
17940_0,,,,2,2,1,3
C1(C(C)(O)OC([C](C1CO)O)=O)=O,,,5,1,3,0,3
17940_1,,,,2,2,1,3
17942_0,,,,2,2,1,3
C1(C(C)(O)OC(C(C1CO)O)=O)=O,,,5,1,3,0,3
17942_1,,,,2,2,1,3
17944_0,,,,2,2,1,3
C(CC(C1(CC[CH]C(O1)=O)O)O)=O,,,5,1,2,0,2
17946_0,,,,2,2,1,3
C1(CCCC(C(CC=O)O)(O)O1)=O,,,5,1,2,0,2
17948_0,,,,2,2,1,3
C1(C(O)OC(C)CC(C1CO)O)=O,,,5,1,3,0,3
17948_1,,,,2,2,1,3
17950_0,,,,2,2,1,3
C1(CC(C(C(C(O)O1)=O)CO)O)=O,,,5,1,3,0,3
17950_1,,,,2,2,1,3
17952_0,,,,2,2,1,3
C1(C(OCC(C(C1CO)O)=O)O)=O,,,5,1,3,0,3
17952_1,,,,2,2,1,3
17954_0,,,,2,2,1,3
C1(C(OC(C(C(C1)O)=O)CO)O)=O,,,5,1,3,0,3
17954_1,,,,2,2,1,3
17956_0,,,,2,2,1,3
C(CC1(CC[CH]C(OC1O)=O)O)=O,,,5,1,2,0,2
17958_0,,,,2,2,1,3
C1(C(O)OC([CH]CC1C(C)O)=O)=O,,,5,1,2,0,2
17960_0,,,,2,2,1,3
C(C1C(C(O)OC([CH]C1)=O)=O)(O)=O,,,5,1,2,0,2
17962_0,,,,2,2,1,3
C1(C(O)OC([CH]CC1CO)=O)=O,,,5,1,2,0,2
17964_0,,,,2,2,1,3
C1(CCCC(C(O)O1)(CC=O)O)=O,,,5,1,2,0,2
17966_0,,,,2,2,1,3
C1(CCC(C(C(O)O1)=O)C(C)O)=O,,,5,1,2,0,2
17968_0,,,,2,2,1,3
C1(CCC(C(O)=O)C(C(O)O1)=O)=O,,,5,1,2,0,2
17970_0,,,,2,2,1,3
C1(CCC(C(C(O)O1)=O)CO)=O,,,5,1,2,0,2
17972_0,,,,2,2,1,3
C(CC(C(C[CH]C(O)=O)O)O)=O,,,5,1,2,0,2
17974_0,,,,2,2,1,3
C(C(C(C(C[CH]C(O)=O)O)O)O)=O,,,5,1,5,0,5
17974_1,,,,2,2,1,3
17976_0,,,,2,2,1,3
C(CCC(C(CC=O)O)O)(O)=O,,,5,1,2,0,2
17978_0,,,,2,2,1,3
C(CCC(C(C(C=O)O)O)O)(O)=O,,,5,1,5,0,5
17978_1,,,,2,2,1,3
17980_0,,,,2,2,1,3
C1(C(C(CO)C(CC(C)O)O1)=O)=O,,,5,1,2,0,2
17980_1,,,,2,2,1,3
17982_0,,,,2,2,1,3
C1(C(C(CO1)C(C)O)(CC=O)O)=O,,,5,1,1,0,1
17984_0,,,,2,2,1,3
C(CC1C(C(C(O1)=O)=O)CO)(O)=O,,,5,1,2,0,2
17984_1,,,,2,2,1,3
17986_0,,,,2,2,1,3
C(C(CO)C1CC(C(O1)=O)(C)O)=O,,,5,1,2,0,2
17986_1,,,,2,2,1,3
17988_0,,,,2,2,1,3
C1(C(C)(C(CO1)C(CC=O)O)O)=O,,,5,1,1,0,1
17990_0,,,,2,2,1,3
C(C1COC(C1(CC=O)O)=O)(O)=O,,,5,1,1,0,1
17992_0,,,,2,2,1,3
C(C1C(C(C(O1)=O)=O)CO)(CO)=O,,,5,1,2,0,2
17992_1,,,,2,2,1,3
17994_0,,,,2,2,1,3
C(C1CC(C(O1)=O)=O)(C(CO)O)=O,,,5,1,2,0,2
17994_1,,,,2,2,1,3
17996_0,,,,2,2,1,3
C(C1(CO)C(C(C(O1)=O)=O)CO)=O,,,5,1,2,0,2
17996_1,,,,2,2,1,3
17998_0,,,,2,2,1,3
C1(C(CC(C=O)(C)O1)(CC=O)O)=O,,,5,1,1,0,1
18000_0,,,,2,2,1,3
C(CC(C1(C)CC(C(O1)=O)=O)O)=O,,,5,1,1,0,1
18002_0,,,,2,2,1,3
C(C1(C)C(C(C(O1)=O)=O)C(C)O)=O,,,5,1,3,0,3
18002_1,,,,2,2,1,3
18004_0,,,,2,2,1,3
C(C1C(C(OC1(C=O)C)=O)=O)(O)=O,,,5,1,3,0,3
18004_1,,,,2,2,1,3
18006_0,,,,2,2,1,3
C(C1(C)C(C(C(O1)=O)=O)CO)=O,,,5,1,3,0,3
18006_1,,,,2,2,1,3
18008_0,,,,2,2,1,3
C(C1C(C(C(O1)=O)=O)O)(CCO)=O,,,5,1,1,0,1
18010_0,,,,2,2,1,3
C(C)(C1CC(C(O1)=O)(CC=O)O)=O,,,5,1,1,0,1
18012_0,,,,2,2,1,3
C(CC(C)(C1CC(C(O1)=O)=O)O)=O,,,5,1,1,0,1
18014_0,,,,2,2,1,3
C(C1C(C(C(O1)=O)=O)C(C)O)(C)=O,,,5,1,3,0,3
18014_1,,,,2,2,1,3
18016_0,,,,2,2,1,3
C(C1C(C(OC1C(C)=O)=O)=O)(O)=O,,,5,1,3,0,3
18016_1,,,,2,2,1,3
18018_0,,,,2,2,1,3
C(C1C(C(C(O1)=O)=O)CO)(C)=O,,,5,1,3,0,3
18018_1,,,,2,2,1,3
18020_0,,,,2,2,1,3
C(C1CC(C(O1)=O)=O)(CC(C)O)=O,,,5,1,1,0,1
18022_0,,,,2,2,1,3
C(CC(C1CC(C(O1)=O)=O)=O)(O)=O,,,5,1,1,0,1
18024_0,,,,2,2,1,3
C(C1CC(C(O1)=O)=O)(CCO)=O,,,5,1,2,0,2
18026_0,,,,2,2,1,3
C1(C(C(CO1)O)(CC=O)O)=O,,,5,1,2,0,2
18028_0,,,,2,2,1,3
C1(C(C(CO1)O)(CC(C=O)=O)O)=O,,,5,1,1,0,1
18030_0,,,,2,2,1,3
C(C(CO)C1(C(OCC1O)=O)O)=O,,,5,1,2,0,2
18030_1,,,,2,2,1,3
18032_0,,,,2,2,1,3
C1(C(C(CO1)O)(CC(CO)=O)O)=O,,,5,1,1,0,1
18034_0,,,,2,2,1,3
C1(C(C(CO1)O)(C(C(C)=O)O)O)=O,,,5,1,2,0,2
18034_1,,,,2,2,1,3
18036_0,,,,2,2,1,3
C(C(C=C)C1(C(OCC1O)=O)O)=O,,,5,1,1,0,1
18038_0,,,,2,2,1,3
C1(C(C(CO1)O)(C(C=O)O)O)=O,,,5,1,3,0,3
18038_1,,,,2,2,1,3
18040_0,,,,2,2,1,3
C1(C(CCO1)(CC=O)O)=O,,,5,1,2,0,2
18042_0,,,,2,2,1,3
C(C(C(C)O)C1(C(OCC1)=O)O)=O,,,5,1,2,0,2
18042_1,,,,2,2,1,3
18044_0,,,,2,2,1,3
C(C(C=O)C1(C(OCC1)=O)O)(O)=O,,,5,1,2,0,2
18044_1,,,,2,2,1,3
18046_0,,,,2,2,1,3
C1(C(CCO1)(C(C(C=O)=O)O)O)=O,,,5,1,2,0,2
18046_1,,,,2,2,1,3
18048_0,,,,2,2,1,3
C1(C(CCO1)(CC(C=O)=O)O)=O,,,5,1,2,0,2
18050_0,,,,2,2,1,3
C(C(CO)C1(C(OCC1)=O)O)=O,,,5,1,3,0,3
18050_1,,,,2,2,1,3
18052_0,,,,2,2,1,3
C1(C(CCO1)(C(C(CO)=O)O)O)=O,,,5,1,2,0,2
18052_1,,,,2,2,1,3
18054_0,,,,2,2,1,3
C1(C(CCO1)(CC(CO)=O)O)=O,,,5,1,2,0,2
18056_0,,,,2,2,1,3
C1(C(CCO1)(C(C(C)=O)O)O)=O,,,5,1,3,0,3
18056_1,,,,2,2,1,3
18058_0,,,,2,2,1,3
C(C(C=C)C1(C(OCC1)=O)O)=O,,,5,1,2,0,2
18060_0,,,,2,2,1,3
C1(C(CCO1)(C(C=O)O)O)=O,,,5,1,3,0,3
18060_1,,,,2,2,1,3
18062_0,,,,2,2,1,3
C1(C(CCO1)(CC(C(O)=O)=O)O)=O,,,5,1,1,0,1
18064_0,,,,2,2,1,3
C1(C(C(CO1)C(C(O)O)O)=O)=O,,,5,1,2,0,2
18064_1,,,,2,2,1,3
18065_0,,,,2,2,1,3
18065_1,,,,2,2,1,3
18066_0,,,,2,2,1,3
18066_1,,,,2,2,1,3
18068_0,,,,2,2,1,3
C1(C(C(CO1)C(CC(C)O)O)=O)=O,,,5,1,2,0,2
18068_1,,,,2,2,1,3
18070_0,,,,2,2,1,3
C(CC(C1C(C(OC1)=O)=O)O)(O)=O,,,5,1,2,0,2
18070_1,,,,2,2,1,3
18072_0,,,,2,2,1,3
C(C(C1C(C(OC1)=O)=O)O)(CO)=O,,,5,1,2,0,2
18072_1,,,,2,2,1,3
18074_0,,,,2,2,1,3
C(C(CO)(C1C(C(OC1)=O)=O)O)=O,,,5,1,2,0,2
18074_1,,,,2,2,1,3
18076_0,,,,2,2,1,3
C(C(C)(C1C(C(OC1)=O)=O)O)=O,,,5,1,3,0,3
18076_1,,,,2,2,1,3
18078_0,,,,2,2,1,3
C(C(C1C(C(OC1)=O)=O)O)(C)=O,,,5,1,3,0,3
18078_1,,,,2,2,1,3
18080_0,,,,2,2,1,3
C1(C(C(CO1)CO)=O)=O,,,5,1,3,0,3
18080_1,,,,2,2,1,3
18082_0,,,,2,2,1,3
C1(C(C(CO1)C(CCO)O)=O)=O,,,5,1,3,0,3
18082_1,,,,2,2,1,3
18084_0,,,,2,2,1,3
C(C(C1C(C(OC1)=O)=O)O)=O,,,5,1,3,0,3
18084_1,,,,2,2,1,3
18086_0,,,,2,2,1,3
C(C(C(C1C(C(OC1)=O)=O)O)O)=O,,,5,1,2,0,2
18086_1,,,,2,2,1,3
18088_0,,,,2,2,1,3
C1(C(C(CO1)C(CO)(CO)O)=O)=O,,,5,1,2,0,2
18088_1,,,,2,2,1,3
18090_0,,,,2,2,1,3
C1(C(C(CO1)C(C)(CO)O)=O)=O,,,5,1,3,0,3
18090_1,,,,2,2,1,3
18092_0,,,,2,2,1,3
C(C)=CC(C1C(C(OC1)=O)=O)O,,,5,1,3,0,3
18092_1,,,,2,2,1,3
18094_0,,,,2,2,1,3
C=CCC(C1C(C(OC1)=O)=O)O,,,5,1,3,0,3
18094_1,,,,2,2,1,3
18096_0,,,,2,2,1,3
C1(C(C(CO1)C(C(CO)O)O)=O)=O,,,5,1,2,0,2
18096_1,,,,2,2,1,3
18098_0,,,,2,2,1,3
C1(C(C(CO1)C(CO)O)=O)=O,,,5,1,3,0,3
18098_1,,,,2,2,1,3
18100_0,,,,2,2,1,3
C1(C(C(CO1)C(C(C)O)O)=O)=O,,,5,1,3,0,3
18100_1,,,,2,2,1,3
18102_0,,,,2,2,1,3
C(C(C1C(C(OC1)=O)=O)O)(O)=O,,,5,1,3,0,3
18102_1,,,,2,2,1,3
18103_0,,,,2,2,1,3
18103_1,,,,2,2,1,3
18105_0,,,,2,2,1,3
C1(C(C(C(C)O1)O)(CC=O)O)=O,,,5,1,2,0,2
18107_0,,,,2,2,1,3
C1(C(C(C(C)O1)O)(C(C=O)O)O)=O,,,5,1,4,0,4
18107_1,,,,2,2,1,3
18109_0,,,,2,2,1,3
C1(C(C(C(O1)=O)(CC=O)O)O)=O,,,5,1,2,0,2
18111_0,,,,2,2,1,3
C1(C(C(C(O1)=O)(C(C=O)O)O)O)=O,,,5,1,5,0,5
18111_1,,,,2,2,1,3
18113_0,,,,2,2,1,3
C(CC1(C(C(OC1)=O)=O)O)=O,,,5,1,2,0,2
18115_0,,,,2,2,1,3
C1(C(OCC1(CC(C=O)=O)O)=O)=O,,,5,1,1,0,1
18117_0,,,,2,2,1,3
C(C(CO)C1(C(C(OC1)=O)=O)O)=O,,,5,1,2,0,2
18117_1,,,,2,2,1,3
18119_0,,,,2,2,1,3
C(CC1(C(C(OC1)=O)=O)O)(CO)=O,,,5,1,1,0,1
18121_0,,,,2,2,1,3
C(C(C1(C(C(OC1)=O)=O)O)O)(C)=O,,,5,1,5,0,5
18121_1,,,,2,2,1,3
18123_0,,,,2,2,1,3
C(C(C=C)C1(C(C(OC1)=O)=O)O)=O,,,5,1,1,0,1
18125_0,,,,2,2,1,3
C(C(C1(C(C(OC1)=O)=O)O)O)=O,,,5,1,5,0,5
18125_1,,,,2,2,1,3
18127_0,,,,2,2,1,3
C1(C(C(CO1)=O)(CC=O)O)=O,,,5,1,2,0,2
18129_0,,,,2,2,1,3
C1(C(C(CO1)=O)(CC(C=O)=O)O)=O,,,5,1,1,0,1
18131_0,,,,2,2,1,3
C(C(CO)C1(C(OCC1=O)=O)O)=O,,,5,1,2,0,2
18131_1,,,,2,2,1,3
18133_0,,,,2,2,1,3
C1(C(C(CO1)=O)(CC(CO)=O)O)=O,,,5,1,1,0,1
18135_0,,,,2,2,1,3
C1(C(C(CO1)=O)(C(C(C)=O)O)O)=O,,,5,1,2,0,2
18135_1,,,,2,2,1,3
18137_0,,,,2,2,1,3
C(C(C=C)C1(C(OCC1=O)=O)O)=O,,,5,1,1,0,1
18139_0,,,,2,2,1,3
C1(C(C(CO1)=O)(C(C=O)O)O)=O,,,5,1,3,0,3
18139_1,,,,2,2,1,3
18141_0,,,,2,2,1,3
C1(C(C(C(C(C(O)O)O)O1)=O)=O)=O,,,5,1,2,0,2
18141_1,,,,2,2,1,3
18143_0,,,,2,2,1,3
C1(C(C(C(C(C)O)O1)=O)=O)=O,,,5,1,3,0,3
18143_1,,,,2,2,1,3
18145_0,,,,2,2,1,3
C(C1C(C(C(O1)=O)=O)=O)(O)=O,,,5,1,3,0,3
18145_1,,,,2,2,1,3
18147_0,,,,2,2,1,3
C(C(C)(C1C(C(C(O1)=O)=O)=O)O)=O,,,5,1,2,0,2
18147_1,,,,2,2,1,3
18149_0,,,,2,2,1,3
C(C)(C(C1C(C(C(O1)=O)=O)=O)O)=O,,,5,1,2,0,2
18149_1,,,,2,2,1,3
18151_0,,,,2,2,1,3
C1(C(C(C(CO)O1)=O)=O)=O,,,5,1,3,0,3
18151_1,,,,2,2,1,3
18153_0,,,,2,2,1,3
C1(C(C(C(C(CCO)O)O1)=O)=O)=O,,,5,1,2,0,2
18153_1,,,,2,2,1,3
18155_0,,,,2,2,1,3
C(C(C1C(C(C(O1)=O)=O)=O)O)=O,,,5,1,3,0,3
18155_1,,,,2,2,1,3
18157_0,,,,2,2,1,3
C1(C(C(C(C(C)(CO)O)O1)=O)=O)=O,,,5,1,2,0,2
18157_1,,,,2,2,1,3
18159_0,,,,2,2,1,3
C(C(C1C(C(C(O1)=O)=O)=O)O)=CC,,,5,1,2,0,2
18159_1,,,,2,2,1,3
18161_0,,,,2,2,1,3
C(CC(C1C(C(C(O1)=O)=O)=O)O)=C,,,5,1,2,0,2
18161_1,,,,2,2,1,3
18163_0,,,,2,2,1,3
C1(C(C(C(C(CO)O)O1)=O)=O)=O,,,5,1,3,0,3
18163_1,,,,2,2,1,3
18165_0,,,,2,2,1,3
C1(C(C(C(C(C(C)O)O)O1)=O)=O)=O,,,5,1,2,0,2
18165_1,,,,2,2,1,3
18167_0,,,,2,2,1,3
C(C(C1C(C(C(O1)=O)=O)=O)O)(O)=O,,,5,1,2,0,2
18167_1,,,,2,2,1,3
18169_0,,,,2,2,1,3
C(CC(C1(COC(C1O)=O)O)O)=O,,,5,1,1,0,1
18171_0,,,,2,2,1,3
C(CC(CC1(C)C[CH]C(O1)=O)O)=O,,,5,1,1,0,1
18173_0,,,,2,2,1,3
C(C(C1(C)C[CH]C(O1)=O)C(C)O)=O,,,5,1,2,0,2
18173_1,,,,2,2,1,3
18175_0,,,,2,2,1,3
C(C(C(O)=O)C1(C)C[CH]C(O1)=O)=O,,,5,1,2,0,2
18175_1,,,,2,2,1,3
18177_0,,,,2,2,1,3
C(C(CO)C1(C)C[CH]C(O1)=O)=O,,,5,1,3,0,3
18177_1,,,,2,2,1,3
18179_0,,,,2,2,1,3
C(C(C1(C)C[CH]C(O1)=O)C(C=O)O)=O,,,5,1,2,0,2
18179_1,,,,2,2,1,3
18181_0,,,,2,2,1,3
C1(CCC(C)(CC(CC=O)O)O1)=O,,,5,1,1,0,1
18183_0,,,,2,2,1,3
C(C(C(C)O)C1(C)CCC(O1)=O)=O,,,5,1,2,0,2
18183_1,,,,2,2,1,3
18185_0,,,,2,2,1,3
C(C(C(O)=O)C1(C)CCC(O1)=O)=O,,,5,1,2,0,2
18185_1,,,,2,2,1,3
18187_0,,,,2,2,1,3
C(C(CO)C1(C)CCC(O1)=O)=O,,,5,1,3,0,3
18187_1,,,,2,2,1,3
18189_0,,,,2,2,1,3
C(CC(C(C1C[CH]C(O1)=O)=O)O)=O,,,5,1,1,0,1
18191_0,,,,2,2,1,3
C(C(C1C[CH]C(O1)=O)(CC=O)O)=O,,,5,1,1,0,1
18193_0,,,,2,2,1,3
C1(CCC(C(C(CC=O)O)=O)O1)=O,,,5,1,1,0,1
18195_0,,,,2,2,1,3
C1(CCC(C(C=O)(CC=O)O)O1)=O,,,5,1,1,0,1
18197_0,,,,2,2,1,3
C1(C(C=O)C(C(C(CO)O1)=O)O)=O,,,5,1,2,0,2
18197_1,,,,2,2,1,3
18199_0,,,,2,2,1,3
C(C1(COC(C(C1CO)=O)=O)O)=O,,,5,1,2,0,2
18199_1,,,,2,2,1,3
18201_0,,,,2,2,1,3
C(CC1(COC(C(C1O)O)=O)O)=O,,,5,1,1,0,1
18203_0,,,,2,2,1,3
C1(C(C(C(OC1C(C)O)=O)O)O)=O,,,5,1,2,0,2
18203_1,,,,2,2,1,3
18205_0,,,,2,2,1,3
C(C1C(C(C(C(O1)=O)O)O)=O)(O)=O,,,5,1,2,0,2
18205_1,,,,2,2,1,3
18207_0,,,,2,2,1,3
C1(C(C(C(OC1CO)=O)O)O)=O,,,5,1,4,0,4
18207_1,,,,2,2,1,3
18209_0,,,,2,2,1,3
C1(C(C)(C(C(C(CO)O1)=O)O)O)=O,,,5,1,2,0,2
18209_1,,,,2,2,1,3
18211_0,,,,2,2,1,3
C1(C(CO)OC(C(C1CO)=O)=O)=O,,,5,1,2,0,2
18211_1,,,,2,2,1,3
18213_0,,,,2,2,1,3
C(C1COC(C(C1CO)=O)=O)(O)=O,,,5,1,1,0,1
18215_0,,,,2,2,1,3
C(CC(C1C(C)OC([CH]C1)=O)O)=O,,,5,1,1,0,1
18217_0,,,,2,2,1,3
C1(CCC(C(CC=O)O)C(C)O1)=O,,,5,1,1,0,1
18219_0,,,,2,2,1,3
C(CC(CC1CC[CH]C(O1)=O)O)=O,,,5,1,1,0,1
18221_0,,,,2,2,1,3
C(C(C1CC[CH]C(O1)=O)C(C)O)=O,,,5,1,2,0,2
18221_1,,,,2,2,1,3
18223_0,,,,2,2,1,3
C(C(C(O)=O)C1CC[CH]C(O1)=O)=O,,,5,1,2,0,2
18223_1,,,,2,2,1,3
18225_0,,,,2,2,1,3
C(C(CO)C1CC[CH]C(O1)=O)=O,,,5,1,3,0,3
18225_1,,,,2,2,1,3
18227_0,,,,2,2,1,3
C(C(C1CC[CH]C(O1)=O)C(C=O)O)=O,,,5,1,2,0,2
18227_1,,,,2,2,1,3
18229_0,,,,2,2,1,3
C1(CCCC(CC(CC=O)O)O1)=O,,,5,1,1,0,1
18231_0,,,,2,2,1,3
C(C(C1CCCC(O1)=O)C(C)O)=O,,,5,1,2,0,2
18231_1,,,,2,2,1,3
18233_0,,,,2,2,1,3
C(C(C(O)=O)C1CCCC(O1)=O)=O,,,5,1,2,0,2
18233_1,,,,2,2,1,3
18235_0,,,,2,2,1,3
C(C(CO)C1CCCC(O1)=O)=O,,,5,1,3,0,3
18235_1,,,,2,2,1,3
18237_0,,,,2,2,1,3
C1(C(C(CC=O)O)C[CH]C(O1)=O)=O,,,5,1,1,0,1
18239_0,,,,2,2,1,3
C1(C(CCC(O1)=O)C(CC=O)O)=O,,,5,1,1,0,1
18241_0,,,,2,2,1,3
C1(C(C(CO)C(CC(C)O1)O)=O)=O,,,5,1,2,0,2
18241_1,,,,2,2,1,3
18243_0,,,,2,2,1,3
C1(CC(C(C(C(O1)=O)=O)CO)O)=O,,,5,1,2,0,2
18243_1,,,,2,2,1,3
18245_0,,,,2,2,1,3
C1(C(C(C(C(OC1)=O)=O)CO)O)=O,,,5,1,2,0,2
18245_1,,,,2,2,1,3
18247_0,,,,2,2,1,3
C1(C(CC(C(OC1CO)=O)=O)O)=O,,,5,1,2,0,2
18247_1,,,,2,2,1,3
18249_0,,,,2,2,1,3
C1(C(COC(C(C1CO)=O)=O)O)=O,,,5,1,2,0,2
18249_1,,,,2,2,1,3
18251_0,,,,2,2,1,3
C1(C(CC[CH]C(O1)=O)(CC=O)O)=O,,,5,1,1,0,1
18253_0,,,,2,2,1,3
[CH]1C(OC(C(C(C(C)O)C1)=O)=O)=O,,,5,1,2,0,2
18255_0,,,,2,2,1,3
C(C1C(C(OC([CH]C1)=O)=O)=O)(O)=O,,,5,1,2,0,2
18257_0,,,,2,2,1,3
[CH]1C(OC(C(C(CO)C1)=O)=O)=O,,,5,1,2,0,2
18259_0,,,,2,2,1,3
C(C(C1C(C(OC([CH]C1)=O)=O)=O)O)=O,,,5,1,1,0,1
18261_0,,,,2,2,1,3
C1(CCCC(C(O1)=O)(CC=O)O)=O,,,5,1,1,0,1
18263_0,,,,2,2,1,3
C1(CCC(C(C(O1)=O)=O)C(C)O)=O,,,5,1,2,0,2
18265_0,,,,2,2,1,3
C1(CCC(C(O)=O)C(C(O1)=O)=O)=O,,,5,1,2,0,2
18267_0,,,,2,2,1,3
C1(CCC(C(C(O1)=O)=O)CO)=O,,,5,1,2,0,2
18269_0,,,,2,2,1,3
C(C(CO)C(C)CC(CC=O)O)=O,,,5,1,3,0,3
18271_0,,,,2,2,1,3
C(CC(C(CO)C(C)CC=O)O)=O,,,5,1,2,0,2
18273_0,,,,2,2,1,3
C(C(C(C)C(C=O)CO)C(C)O)=O,,,5,1,4,0,4
18275_0,,,,2,2,1,3
C(C(C=O)C(C)C(C=O)CO)(O)=O,,,5,1,4,0,4
18277_0,,,,2,2,1,3
C(C(CO)C(C)C(C=O)CO)=O,,,5,1,2,0,2
18279_0,,,,2,2,1,3
C(CC(C(C)CC(CC=O)O)O)=O,,,5,1,1,0,1
18281_0,,,,2,2,1,3
C(CC(C)C(CC(CC=O)O)O)=O,,,5,1,2,0,2
18283_0,,,,2,2,1,3
C(C(C(C)O)C(C)C(CC=O)O)=O,,,5,1,2,0,2
18285_0,,,,2,2,1,3
C(C(C=O)C(C)C(CC=O)O)(O)=O,,,5,1,2,0,2
18287_0,,,,2,2,1,3
C(C(CO)C(C)C(CC=O)O)=O,,,5,1,2,0,2
18288_0,,,,2,2,1,3
18288_1,,,,2,2,1,3
18289_0,,,,2,2,1,3
18289_1,,,,2,2,1,3
18291_0,,,,2,2,1,3
C(C(CO)C(C(C)CC=O)O)=O,,,5,1,3,0,3
18291_1,,,,2,2,1,3
18293_0,,,,2,2,1,3
C(CC(CC(C[CH]C(O)=O)O)O)=O,,,5,1,2,0,2
18294_0,,,,2,2,1,3
18294_1,,,,2,2,1,3
18295_0,,,,2,2,1,3
18295_1,,,,2,2,1,3
18296_0,,,,2,2,1,3
18296_1,,,,2,2,1,3
18298_0,,,,2,2,1,3
C(CCC(CC(CC=O)O)O)(O)=O,,,5,1,2,0,2
18299_0,,,,2,2,1,3
18299_1,,,,2,2,1,3
18300_0,,,,2,2,1,3
18300_1,,,,2,2,1,3
18301_0,,,,2,2,1,3
18301_1,,,,2,2,1,3
18303_0,,,,2,2,1,3
C(C(C=O)(C(C)C(C=O)CO)O)=O,,,5,1,2,0,2
18305_0,,,,2,2,1,3
C(C(CO)C(C)C(CO)C(C)O)=O,,,5,1,2,0,2
18307_0,,,,2,2,1,3
C(C(CO)C(C)C(CC(C)O)O)=O,,,5,1,2,0,2
18309_0,,,,2,2,1,3
C(C(CO)C(C)CC(CCO)O)=O,,,5,1,2,0,2
18311_0,,,,2,2,1,3
C(C(CO)C(C)C(C)(CCO)O)=O,,,5,1,2,0,2
18313_0,,,,2,2,1,3
C(C(CO)C(C)C(C=O)CO)(O)=O,,,5,1,2,0,2
18315_0,,,,2,2,1,3
C(C(CO)C(C)C(CC(O)=O)O)=O,,,5,1,2,0,2
18317_0,,,,2,2,1,3
C(C(CO)C(C)C(C(CO)=O)O)=O,,,5,1,2,0,2
18319_0,,,,2,2,1,3
C(CC(C)C(C(C(CO)O)=O)O)=O,,,5,1,3,0,3
18319_1,,,,2,2,1,3
18321_0,,,,2,2,1,3
C(CC(CC(C)CC(CO)=O)O)=O,,,5,1,1,0,1
18323_0,,,,2,2,1,3
C(CC(C)CC(CO)(CC=O)O)=O,,,5,1,3,0,3
18325_0,,,,2,2,1,3
C(C(C(C)O)C(C)CC(CO)=O)=O,,,5,1,2,0,2
18327_0,,,,2,2,1,3
C(C(C=O)C(C)CC(CO)=O)(O)=O,,,5,1,2,0,2
18329_0,,,,2,2,1,3
C(C(CO)C(C)CC(CO)=O)=O,,,5,1,2,0,2
18331_0,,,,2,2,1,3
C(CC(C)C(C(CO)=O)C(C)O)=O,,,5,1,3,0,3
18333_0,,,,2,2,1,3
C(CC(C)C(C(O)=O)C(CO)=O)=O,,,5,1,3,0,3
18335_0,,,,2,2,1,3
C(CC(C)C(C(CO)=O)CO)=O,,,5,1,3,0,3
18337_0,,,,2,2,1,3
C(CC(C)CC(C(C(C)O)O)=O)=O,,,5,1,3,0,3
18337_1,,,,2,2,1,3
18339_0,,,,2,2,1,3
C(C(C(CC(C)CC=O)=O)O)(O)=O,,,5,1,3,0,3
18339_1,,,,2,2,1,3
18341_0,,,,2,2,1,3
C(CC(C)CC(C(CO)O)=O)=O,,,5,1,3,0,3
18341_1,,,,2,2,1,3
18343_0,,,,2,2,1,3
C(CC(CC(C)C(C(C)=O)O)O)=O,,,5,1,1,0,1
18345_0,,,,2,2,1,3
C(CC(C)(C(C(C)CC=O)O)O)=O,,,5,1,2,0,2
18347_0,,,,2,2,1,3
C(C(C(C)O)C(C)C(C(C)=O)O)=O,,,5,1,2,0,2
18349_0,,,,2,2,1,3
C(C(C=O)C(C)C(C(C)=O)O)(O)=O,,,5,1,2,0,2
18351_0,,,,2,2,1,3
C(C(CO)C(C)C(C(C)=O)O)=O,,,5,1,2,0,2
18353_0,,,,2,2,1,3
C(CC(C)C(C(CC(C)O)=O)O)=O,,,5,1,2,0,2
18355_0,,,,2,2,1,3
C(CC(C)C(C(CC(O)=O)=O)O)=O,,,5,1,2,0,2
18357_0,,,,2,2,1,3
C(CC(C)C(C(CCO)=O)O)=O,,,5,1,2,0,2
18359_0,,,,2,2,1,3
C(CC(C)(C(C[CH]C(O)=O)O)O)=O,,,5,1,2,0,2
18361_0,,,,2,2,1,3
C(C(C[CH]C(O)=O)O)(CC(C)O)=O,,,5,1,2,0,2
18363_0,,,,2,2,1,3
C(CC(C(C[CH]C(O)=O)O)=O)(O)=O,,,5,1,2,0,2
18365_0,,,,2,2,1,3
C(C(C[CH]C(O)=O)O)(CCO)=O,,,5,1,2,0,2
18367_0,,,,2,2,1,3
C(CCC(C(C)(CC=O)O)O)(O)=O,,,5,1,2,0,2
18369_0,,,,2,2,1,3
C(CCC(C(CC(C)O)=O)O)(O)=O,,,5,1,2,0,2
18371_0,,,,2,2,1,3
C(CCC(C(CC(O)=O)=O)O)(O)=O,,,5,1,2,0,2
18373_0,,,,2,2,1,3
C(CCC(C(CCO)=O)O)(O)=O,,,5,1,2,0,2
18375_0,,,,2,2,1,3
C(CC(CC(C)CO)O)=O,,,5,1,1,0,1
18377_0,,,,2,2,1,3
C(C(C(C)O)C(CC(C)CO)O)=O,,,5,1,2,0,2
18377_1,,,,2,2,1,3
18379_0,,,,2,2,1,3
C(C(C=O)C(CC(C)CO)O)(O)=O,,,5,1,2,0,2
18379_1,,,,2,2,1,3
18381_0,,,,2,2,1,3
C(C(C(C(CC(CO)C)O)O)=O)=O,,,5,1,2,0,2
18381_1,,,,2,2,1,3
18383_0,,,,2,2,1,3
C(C(CC(CC(C)CO)O)=O)=O,,,5,1,1,0,1
18385_0,,,,2,2,1,3
C(C(CO)C(CC(C)CO)O)=O,,,5,1,2,0,2
18385_1,,,,2,2,1,3
18387_0,,,,2,2,1,3
C(CO)(C(C(CC(CO)C)O)O)=O,,,5,1,2,0,2
18387_1,,,,2,2,1,3
18389_0,,,,2,2,1,3
C(CO)(CC(CC(CO)C)O)=O,,,5,1,1,0,1
18391_0,,,,2,2,1,3
C(C)(C(C(CC(CO)C)O)O)=O,,,5,1,2,0,2
18391_1,,,,2,2,1,3
18393_0,,,,2,2,1,3
C(C(C=C)C(CC(C)CO)O)=O,,,5,1,1,0,1
18395_0,,,,2,2,1,3
C(C(C(CC(CO)C)O)O)=O,,,5,1,2,0,2
18395_1,,,,2,2,1,3
18397_0,,,,2,2,1,3
C(C(CC(CC(C)CO)O)=O)(O)=O,,,5,1,1,0,1
18399_0,,,,2,2,1,3
C(C(C(C(O)O)O)C(C)CO)=O,,,5,1,1,0,1
18401_0,,,,2,2,1,3
C(C(C(C)O)C(C)CO)=O,,,5,1,2,0,2
18403_0,,,,2,2,1,3
C(C(C=O)C(C)CO)(O)=O,,,5,1,2,0,2
18405_0,,,,2,2,1,3
C(C(C(CC(C)O)O)C(C)CO)=O,,,5,1,2,0,2
18407_0,,,,2,2,1,3
C(C(C(CC(O)=O)O)C(C)CO)=O,,,5,1,2,0,2
18409_0,,,,2,2,1,3
C(C(C(CO)C)C(C(CO)=O)O)=O,,,5,1,2,0,2
18411_0,,,,2,2,1,3
C(C(C(CO)C)C(C=O)(CO)O)=O,,,5,1,2,0,2
18413_0,,,,2,2,1,3
C(C(C(CO)C)C(C=O)(C)O)=O,,,5,1,2,0,2
18415_0,,,,2,2,1,3
C(C(C(CO)C)C(C(C)=O)O)=O,,,5,1,2,0,2
18417_0,,,,2,2,1,3
C(C(CO)C(C)CO)=O,,,5,1,2,0,2
18419_0,,,,2,2,1,3
C(C(C(CCO)O)C(C)CO)=O,,,5,1,1,0,1
18421_0,,,,2,2,1,3
C(C(C(CO)C)C(C=O)O)=O,,,5,1,1,0,1
18423_0,,,,2,2,1,3
C(C(C(C(C=O)O)O)C(CO)C)=O,,,5,1,1,0,1
18425_0,,,,2,2,1,3
C(C(C(C)CO)C(CO)(CO)O)=O,,,5,1,1,0,1
18427_0,,,,2,2,1,3
C(C(C(C)CO)C(C)(CO)O)=O,,,5,1,1,0,1
18429_0,,,,2,2,1,3
C(C(C(CO)C)C(C=CC)O)=O,,,5,1,1,0,1
18431_0,,,,2,2,1,3
C(C(C(CC=C)O)C(C)CO)=O,,,5,1,1,0,1
18433_0,,,,2,2,1,3
C(C(C(C(CO)O)O)C(C)CO)=O,,,5,1,1,0,1
18435_0,,,,2,2,1,3
C(C(C(CO)O)C(C)CO)=O,,,5,1,1,0,1
18437_0,,,,2,2,1,3
C(C(C(C(C)O)O)C(C)CO)=O,,,5,1,1,0,1
18439_0,,,,2,2,1,3
C(C(C(CO)C)C(C(O)=O)O)=O,,,5,1,1,0,1
18441_0,,,,2,2,1,3
C(C(C(CO)C)C(C(O)=O)(C)O)=O,,,5,1,2,0,2
18443_0,,,,2,2,1,3
C(C(CC(CO)C)(CC=O)O)(O)=O,,,5,1,1,0,1
18445_0,,,,2,2,1,3
C(C(C(C(C)O)C(C)CO)=O)(O)=O,,,5,1,2,0,2
18447_0,,,,2,2,1,3
C(C(C(C(O)=O)=O)C(C)CO)(O)=O,,,5,1,2,0,2
18449_0,,,,2,2,1,3
C(C(C(CO)C(C)CO)=O)(O)=O,,,5,1,2,0,2
18451_0,,,,2,2,1,3
C(C(CC(CC=O)O)CCO)(O)=O,,,5,1,4,0,4
18453_0,,,,2,2,1,3
C(C(CCO)C(C=O)C(C)O)(O)=O,,,5,1,2,0,2
18455_0,,,,2,2,1,3
C(C(C=O)C(C(O)=O)CCO)(O)=O,,,5,1,2,0,2
18457_0,,,,2,2,1,3
C(C(CCO)C(C=O)CO)(O)=O,,,5,1,2,0,2
18459_0,,,,2,2,1,3
C(C(C)(CO)CC(CC=O)O)(O)=O,,,5,1,1,0,1
18461_0,,,,2,2,1,3
C(C(C)(CO)C(C=O)C(C)O)(O)=O,,,5,1,2,0,2
18463_0,,,,2,2,1,3
C(C(C=O)C(C(O)=O)(C)CO)(O)=O,,,5,1,2,0,2
18465_0,,,,2,2,1,3
C(C(C)(CO)C(C=O)CO)(O)=O,,,5,1,2,0,2
18467_0,,,,2,2,1,3
C(C(C)C(CO)C(CC=O)O)(O)=O,,,5,1,4,0,4
18469_0,,,,2,2,1,3
C(CC(CC(C)CCO)O)=O,,,5,1,2,0,2
18471_0,,,,2,2,1,3
C(C(CC(CC(C)CCO)O)=O)=O,,,5,1,2,0,2
18473_0,,,,2,2,1,3
C(C(CO)C(CC(C)CCO)O)=O,,,5,1,3,0,3
18473_1,,,,2,2,1,3
18475_0,,,,2,2,1,3
C(CO)(CC(CC(C)CCO)O)=O,,,5,1,1,0,1
18477_0,,,,2,2,1,3
C(C)(C(C(CC(C)CCO)O)O)=O,,,5,1,2,0,2
18477_1,,,,2,2,1,3
18479_0,,,,2,2,1,3
C(C(C=C)C(CC(C)CCO)O)=O,,,5,1,1,0,1
18481_0,,,,2,2,1,3
C(C(C(CC(C)CCO)O)O)=O,,,5,1,2,0,2
18481_1,,,,2,2,1,3
18483_0,,,,2,2,1,3
C(C(C(C(O)O)O)C(C)CCO)=O,,,5,1,1,0,1
18485_0,,,,2,2,1,3
C(C(C(C)O)C(C)CCO)=O,,,5,1,3,0,3
18487_0,,,,2,2,1,3
C(C(C=O)C(C)CCO)(O)=O,,,5,1,3,0,3
18489_0,,,,2,2,1,3
C(C(C(C)CCO)C(C=O)(C)O)=O,,,5,1,3,0,3
18491_0,,,,2,2,1,3
C(C(C(C)CCO)C(C(C)=O)O)=O,,,5,1,3,0,3
18493_0,,,,2,2,1,3
C(C(CO)C(C)CCO)=O,,,5,1,3,0,3
18495_0,,,,2,2,1,3
C(C(C(CCO)O)C(C)CCO)=O,,,5,1,1,0,1
18497_0,,,,2,2,1,3
C(C(C(C)CCO)C(C=O)O)=O,,,5,1,1,0,1
18499_0,,,,2,2,1,3
C(C(C(C)CCO)C(C)(CO)O)=O,,,5,1,1,0,1
18501_0,,,,2,2,1,3
C(C(C(C)CCO)C(C=CC)O)=O,,,5,1,1,0,1
18503_0,,,,2,2,1,3
C(C(C(CC=C)O)C(C)CCO)=O,,,5,1,1,0,1
18505_0,,,,2,2,1,3
C(C(C(CO)O)C(C)CCO)=O,,,5,1,1,0,1
18507_0,,,,2,2,1,3
C(C(C(C(C)O)O)C(C)CCO)=O,,,5,1,1,0,1
18509_0,,,,2,2,1,3
C(C(C(C)CCO)C(C(O)=O)O)=O,,,5,1,1,0,1
18511_0,,,,2,2,1,3
C(C(C(CO)C(C)CCO)=O)(O)=O,,,5,1,3,0,3
18513_0,,,,2,2,1,3
C(C(CCCO)C(C=O)CO)(O)=O,,,5,1,2,0,2
18515_0,,,,2,2,1,3
C(C(C)(CCO)C(C=O)CO)(O)=O,,,5,1,3,0,3
18517_0,,,,2,2,1,3
C(CC(CC(C)C(C)O)O)=O,,,5,1,1,0,1
18519_0,,,,2,2,1,3
C(C(CC(CC(C)C(C)O)O)=O)=O,,,5,1,1,0,1
18521_0,,,,2,2,1,3
C(C(CO)C(CC(C)C(C)O)O)=O,,,5,1,2,0,2
18521_1,,,,2,2,1,3
18523_0,,,,2,2,1,3
C(CO)(CC(CC(C)C(C)O)O)=O,,,5,1,1,0,1
18525_0,,,,2,2,1,3
C(C)(C(C(CC(C)C(C)O)O)O)=O,,,5,1,2,0,2
18525_1,,,,2,2,1,3
18527_0,,,,2,2,1,3
C(C(C=C)C(CC(C)C(C)O)O)=O,,,5,1,1,0,1
18529_0,,,,2,2,1,3
C(C(C(CC(C)C(C)O)O)O)=O,,,5,1,2,0,2
18529_1,,,,2,2,1,3
18531_0,,,,2,2,1,3
C(C(C(C(O)O)O)C(C)C(C)O)=O,,,5,1,1,0,1
18533_0,,,,2,2,1,3
C(C(C(C)O)C(C)C(C)O)=O,,,5,1,2,0,2
18535_0,,,,2,2,1,3
C(C(C=O)C(C)C(C)O)(O)=O,,,5,1,2,0,2
18537_0,,,,2,2,1,3
C(C(C(C)C(C)O)C(C=O)(C)O)=O,,,5,1,2,0,2
18539_0,,,,2,2,1,3
C(C(C(C)C(C)O)C(C(C)=O)O)=O,,,5,1,2,0,2
18541_0,,,,2,2,1,3
C(C(CO)C(C)C(C)O)=O,,,5,1,2,0,2
18543_0,,,,2,2,1,3
C(C(C(CCO)O)C(C)C(C)O)=O,,,5,1,1,0,1
18545_0,,,,2,2,1,3
C(C(C(C)C(C)O)C(C=O)O)=O,,,5,1,1,0,1
18547_0,,,,2,2,1,3
C(C(C(C)C(C)O)C(C)(CO)O)=O,,,5,1,1,0,1
18549_0,,,,2,2,1,3
C(C(C(C)C(C)O)C(C=CC)O)=O,,,5,1,1,0,1
18551_0,,,,2,2,1,3
C(C(C(CC=C)O)C(C)C(C)O)=O,,,5,1,1,0,1
18553_0,,,,2,2,1,3
C(C(C(CO)O)C(C)C(C)O)=O,,,5,1,1,0,1
18555_0,,,,2,2,1,3
C(C(C(C(C)O)O)C(C)C(C)O)=O,,,5,1,1,0,1
18557_0,,,,2,2,1,3
C(C(C(C)C(C)O)C(C(O)=O)O)=O,,,5,1,1,0,1
18559_0,,,,2,2,1,3
C(C(C(CO)C(C)C(C)O)=O)(O)=O,,,5,1,2,0,2
18561_0,,,,2,2,1,3
C(C(CC(C)O)C(C=O)CO)(O)=O,,,5,1,3,0,3
18563_0,,,,2,2,1,3
C(C(C)(C(C)O)C(C=O)CO)(O)=O,,,5,1,2,0,2
18565_0,,,,2,2,1,3
C(CC(C)CC(CC=O)O)(O)=O,,,5,1,3,0,3
18567_0,,,,2,2,1,3
C(CC(C)CC(C(C=O)O)O)(O)=O,,,5,1,3,0,3
18567_1,,,,2,2,1,3
18569_0,,,,2,2,1,3
C(C(C(C)CC(O)=O)C(C)O)=O,,,5,1,4,0,4
18571_0,,,,2,2,1,3
C(C(C(O)=O)C(C)CC(O)=O)=O,,,5,1,4,0,4
18573_0,,,,2,2,1,3
C(C(CO)C(C)CC(O)=O)=O,,,5,1,4,0,4
18575_0,,,,2,2,1,3
C(CC(C)C(C=O)C(C=O)O)(O)=O,,,5,1,2,0,2
18577_0,,,,2,2,1,3
C(C(C(C)CC(O)=O)C(CO)O)=O,,,5,1,2,0,2
18579_0,,,,2,2,1,3
C(CC(CC(C)CC=CC=O)O)=O,,,5,1,1,0,1
18581_0,,,,2,2,1,3
C(CC(C=CCC(C)CC=O)O)=O,,,5,1,2,0,2
18583_0,,,,2,2,1,3
C(C(C(C)CC=CC=O)C(C)O)=O,,,5,1,2,0,2
18585_0,,,,2,2,1,3
C(C(C(O)=O)C(C)CC=CC=O)=O,,,5,1,2,0,2
18587_0,,,,2,2,1,3
C(C(CO)C(C)CC=CC=O)=O,,,5,1,2,0,2
18589_0,,,,2,2,1,3
C(C(C(C)CC=CC=O)C(C=O)O)=O,,,5,1,1,0,1
18591_0,,,,2,2,1,3
C(CC(C)C(C=C)C(CC=O)O)=O,,,5,1,2,0,2
18593_0,,,,2,2,1,3
C(C(C=C)C(C)CC(CC=O)O)=O,,,5,1,1,0,1
18595_0,,,,2,2,1,3
C(C(C=C)C(C)C(C=O)C(C)O)=O,,,5,1,2,0,2
18597_0,,,,2,2,1,3
C(C(C=C)C(C)C(C=O)C(O)=O)=O,,,5,1,2,0,2
18599_0,,,,2,2,1,3
C(C(C=C)C(C)C(C=O)CO)=O,,,5,1,2,0,2
18601_0,,,,2,2,1,3
C(C(C(C)C(C=O)C=C)C(C=O)O)=O,,,5,1,1,0,1
18603_0,,,,2,2,1,3
C(C(CO)C(C)C(C(C=O)O)O)=O,,,5,1,2,0,2
18605_0,,,,2,2,1,3
C(C(CO)C(C)C(C=O)(CO)O)=O,,,5,1,2,0,2
18607_0,,,,2,2,1,3
C(C(CO)C(C)C([CH]C(O)=O)O)=O,,,5,1,2,0,2
18609_0,,,,2,2,1,3
C(C(CO)C([C](C(O)=O)CO)C)=O,,,5,1,2,0,2
18611_0,,,,2,2,1,3
C(CC(C(C(C)CC=O)O)O)=O,,,5,1,2,0,2
18613_0,,,,2,2,1,3
C(CC(C)C(C(C(C=O)O)O)O)=O,,,5,1,5,0,5
18613_1,,,,2,2,1,3
18615_0,,,,2,2,1,3
C(CC(CC(C)C(C=O)O)O)=O,,,5,1,1,0,1
18617_0,,,,2,2,1,3
C(C(C(C)CC(C(C=O)O)O)O)=O,,,5,1,2,0,2
18617_1,,,,2,2,1,3
18619_0,,,,2,2,1,3
C(C(C(C)O)C(C)C(C=O)O)=O,,,5,1,2,0,2
18621_0,,,,2,2,1,3
C(C(C=O)C(C)C(C=O)O)(O)=O,,,5,1,2,0,2
18623_0,,,,2,2,1,3
C(C(CO)C(C)C(C=O)O)=O,,,5,1,2,0,2
18625_0,,,,2,2,1,3
C(C(C(C)C(C=O)C(C=O)O)O)=O,,,5,1,1,0,1
18627_0,,,,2,2,1,3
C(C(C(CO)O)C(C)C(C=O)O)=O,,,5,1,1,0,1
18629_0,,,,2,2,1,3
C(CC(C)CC(C(CC=O)O)O)=O,,,5,1,2,0,2
18631_0,,,,2,2,1,3
C(CC(CC(C)CC(C=O)O)O)=O,,,5,1,1,0,1
18633_0,,,,2,2,1,3
C(C(C(C)O)C(C)CC(C=O)O)=O,,,5,1,2,0,2
18635_0,,,,2,2,1,3
C(C(C=O)C(C)CC(C=O)O)(O)=O,,,5,1,2,0,2
18637_0,,,,2,2,1,3
C(C(CO)C(C)CC(C=O)O)=O,,,5,1,2,0,2
18639_0,,,,2,2,1,3
C(CC(C(C)(C(C)CC=O)O)O)=O,,,5,1,2,0,2
18641_0,,,,2,2,1,3
C(C(C)(C(C)CC(CC=O)O)O)=O,,,5,1,1,0,1
18643_0,,,,2,2,1,3
C(C(C(C)O)C(C)C(C=O)(C)O)=O,,,5,1,2,0,2
18645_0,,,,2,2,1,3
C(C(C=O)C(C)C(C=O)(C)O)(O)=O,,,5,1,2,0,2
18647_0,,,,2,2,1,3
C(C(CO)C(C)C(C=O)(C)O)=O,,,5,1,2,0,2
18648_0,,,,2,2,1,3
18649_0,,,,2,2,1,3
18650_0,,,,2,2,1,3
18650_1,,,,2,2,1,3
18652_0,,,,2,2,1,3
C(CC(C)CC(CC(CO)=O)O)=O,,,5,1,3,0,3
18654_0,,,,2,2,1,3
C(CC(C)CC(C(C(C)=O)O)O)=O,,,5,1,3,0,3
18654_1,,,,2,2,1,3
18656_0,,,,2,2,1,3
C(C(C=C)C(CC(C)CC=O)O)=O,,,5,1,2,0,2
18658_0,,,,2,2,1,3
C(CC(C)CC(C(C=O)O)O)=O,,,5,1,3,0,3
18658_1,,,,2,2,1,3
18660_0,,,,2,2,1,3
C(C(C(C)CC=O)C(C(O)O)O)=O,,,5,1,1,0,1
18661_0,,,,2,2,1,3
18662_0,,,,2,2,1,3
18663_0,,,,2,2,1,3
18664_0,,,,2,2,1,3
18665_0,,,,2,2,1,3
18667_0,,,,2,2,1,3
C(C(C(C)CC=O)C(CCO)O)=O,,,5,1,2,0,2
18669_0,,,,2,2,1,3
C(CC(C)C(C=O)C(C=O)O)=O,,,5,1,2,0,2
18671_0,,,,2,2,1,3
C(C(C(C)CC=O)C(C)(CO)O)=O,,,5,1,3,0,3
18673_0,,,,2,2,1,3
C(CC(C)C(C=O)C(C=CC)O)=O,,,5,1,2,0,2
18675_0,,,,2,2,1,3
C(C(C(CC=C)O)C(C)CC=O)=O,,,5,1,2,0,2
18677_0,,,,2,2,1,3
C(C(C(C)CC=O)C(CO)O)=O,,,5,1,2,0,2
18679_0,,,,2,2,1,3
C(C(C(C)CC=O)C(C(C)O)O)=O,,,5,1,2,0,2
18681_0,,,,2,2,1,3
C(CC(C)C(C=O)C(C(O)=O)O)=O,,,5,1,2,0,2
18683_0,,,,2,2,1,3
C(C(CO)C(C)C[C](C(O)=O)O)=O,,,5,1,3,0,3
18685_0,,,,2,2,1,3
C(C(CO)C(C)CC(C(O)=O)O)=O,,,5,1,3,0,3
18687_0,,,,2,2,1,3
C(C(CO)C(C)C(C(O)=O)(C)O)=O,,,5,1,2,0,2
18688_0,,,,2,2,1,3
18689_0,,,,2,2,1,3
18689_1,,,,2,2,1,3
18690_0,,,,2,2,1,3
18691_0,,,,2,2,1,3
18691_1,,,,2,2,1,3
18693_0,,,,2,2,1,3
C(C(CO)C(C)C(C)(CC=O)O)=O,,,5,1,2,0,2
18694_0,,,,2,2,1,3
18696_0,,,,2,2,1,3
C(C(CO)C(C)C(C(C=O)=O)O)=O,,,5,1,2,0,2
18697_0,,,,2,2,1,3
18698_0,,,,2,2,1,3
18700_0,,,,2,2,1,3
C(CC(CC(C)CC(C=O)=O)O)=O,,,5,1,2,0,2
18701_0,,,,2,2,1,3
18702_0,,,,2,2,1,3
18703_0,,,,2,2,1,3
18705_0,,,,2,2,1,3
C(C(C(C)CC(C=O)=O)C(C)O)=O,,,5,1,3,0,3
18707_0,,,,2,2,1,3
C(C(C(O)=O)C(C)CC(C=O)=O)=O,,,5,1,3,0,3
18709_0,,,,2,2,1,3
C(C(CO)C(C)CC(C=O)=O)=O,,,5,1,3,0,3
18711_0,,,,2,2,1,3
C(CC(CC(C)C(C(O)=O)O)O)=O,,,5,1,1,0,1
18713_0,,,,2,2,1,3
C(C(C(C)O)C(C)C(C(O)=O)O)=O,,,5,1,2,0,2
18715_0,,,,2,2,1,3
C(C(C=O)C(C)C(C(O)=O)O)(O)=O,,,5,1,2,0,2
18717_0,,,,2,2,1,3
C(C(CO)C(C)C(C(O)=O)O)=O,,,5,1,2,0,2
18719_0,,,,2,2,1,3
C(CC(CC(C)C(CO)O)O)=O,,,5,1,2,0,2
18721_0,,,,2,2,1,3
C(C(C(CC(C)C(CO)O)O)O)=O,,,5,1,2,0,2
18721_1,,,,2,2,1,3
18723_0,,,,2,2,1,3
C(C(C(C)O)C(C)C(CO)O)=O,,,5,1,3,0,3
18725_0,,,,2,2,1,3
C(C(C=O)C(C)C(CO)O)(O)=O,,,5,1,3,0,3
18727_0,,,,2,2,1,3
C(C(CO)C(C)C(CO)O)=O,,,5,1,3,0,3
18729_0,,,,2,2,1,3
C(C(C(C)C(CO)O)C(C=O)O)=O,,,5,1,1,0,1
18731_0,,,,2,2,1,3
C(C(C(CO)O)C(C)C(CO)O)=O,,,5,1,1,0,1
18732_0,,,,2,2,1,3
18733_0,,,,2,2,1,3
18734_0,,,,2,2,1,3
18736_0,,,,2,2,1,3
C(CCC(C(O)=O)C(C=O)CO)=O,,,5,1,2,0,2
18737_0,,,,2,2,1,3
18738_0,,,,2,2,1,3
18739_0,,,,2,2,1,3
18740_0,,,,2,2,1,3
18742_0,,,,2,2,1,3
C(CC(C(CC[CH]C(O)=O)O)O)=O,,,5,1,2,0,2
18744_0,,,,2,2,1,3
C(CCCC(C(CC=O)O)O)(O)=O,,,5,1,2,0,2
18746_0,,,,2,2,1,3
C(CC(C(C)(C[CH]C(O)=O)O)O)=O,,,5,1,2,0,2
18748_0,,,,2,2,1,3
C(CCC(C)(C(CC=O)O)O)(O)=O,,,5,1,2,0,2
18750_0,,,,2,2,1,3
C(C(C=CC(O)=O)(CC=O)O)(O)=O,,,5,1,1,0,1
18752_0,,,,2,2,1,3
C(C(C[C](C(O)=O)O)O)(CCO)=O,,,5,1,2,0,2
18754_0,,,,2,2,1,3
C(CC([C](C(O)=O)O)(CO)O)=O,,,5,1,2,0,2
18756_0,,,,2,2,1,3
C(C(C([C](C(O)=O)O)(CO)O)O)=O,,,5,1,4,0,4
18756_1,,,,2,2,1,3
18758_0,,,,2,2,1,3
C([C](C(C(C(C)O)O)=O)O)(O)=O,,,5,1,3,0,3
18758_1,,,,2,2,1,3
18760_0,,,,2,2,1,3
C(C(C([C](C(O)=O)O)=O)O)(O)=O,,,5,1,3,0,3
18760_1,,,,2,2,1,3
18762_0,,,,2,2,1,3
C([C](C(C(CO)O)=O)O)(O)=O,,,5,1,3,0,3
18762_1,,,,2,2,1,3
18764_0,,,,2,2,1,3
C(C(C(C([C](C(O)=O)O)=O)O)O)=O,,,5,1,3,0,3
18764_1,,,,2,2,1,3
18766_0,,,,2,2,1,3
C([C](C(C(C(CO)O)O)=O)O)(O)=O,,,5,1,3,0,3
18766_1,,,,2,2,1,3
18768_0,,,,2,2,1,3
C(CC([C](C(O)=O)O)(C)O)=O,,,5,1,2,0,2
18770_0,,,,2,2,1,3
[C](C(O)=O)(C(C)(CC(C=O)=O)O)O,,,5,1,3,0,3
18772_0,,,,2,2,1,3
C(C(CO)C([C](C(O)=O)O)(C)O)=O,,,5,1,3,0,3
18772_1,,,,2,2,1,3
18774_0,,,,2,2,1,3
C(CC([C](C(O)=O)O)(C)O)(CO)=O,,,5,1,2,0,2
18776_0,,,,2,2,1,3
C(C(C([C](C(O)=O)O)(C)O)O)(C)=O,,,5,1,4,0,4
18776_1,,,,2,2,1,3
18778_0,,,,2,2,1,3
C(C(C=C)C([C](C(O)=O)O)(C)O)=O,,,5,1,2,0,2
18780_0,,,,2,2,1,3
C(C(C([C](C(O)=O)O)(C)O)O)=O,,,5,1,4,0,4
18780_1,,,,2,2,1,3
18782_0,,,,2,2,1,3
C([C](C(CC(C(O)O)O)=O)O)(O)=O,,,5,1,1,0,1
18784_0,,,,2,2,1,3
C([C](C(CC(C)O)=O)O)(O)=O,,,5,1,2,0,2
18786_0,,,,2,2,1,3
C(CC([C](C(O)=O)O)=O)(O)=O,,,5,1,2,0,2
18788_0,,,,2,2,1,3
C(C(C)(CC([C](C(O)=O)O)=O)O)=O,,,5,1,2,0,2
18790_0,,,,2,2,1,3
C(C)(C(CC([C](C(O)=O)O)=O)O)=O,,,5,1,2,0,2
18792_0,,,,2,2,1,3
C([C](C(CCO)=O)O)(O)=O,,,5,1,2,0,2
18794_0,,,,2,2,1,3
C([C](C(CC(CCO)O)=O)O)(O)=O,,,5,1,2,0,2
18796_0,,,,2,2,1,3
C(C(CC([C](C(O)=O)O)=O)O)=O,,,5,1,2,0,2
18798_0,,,,2,2,1,3
C([C](C(CC(C)(CO)O)=O)O)(O)=O,,,5,1,2,0,2
18800_0,,,,2,2,1,3
C(C(CC([C](C(O)=O)O)=O)O)=CC,,,5,1,2,0,2
18802_0,,,,2,2,1,3
C=CCC(CC([C](C(O)=O)O)=O)O,,,5,1,2,0,2
18804_0,,,,2,2,1,3
C([C](C(CC(CO)O)=O)O)(O)=O,,,5,1,2,0,2
18806_0,,,,2,2,1,3
C([C](C(CC(C(C)O)O)=O)O)(O)=O,,,5,1,2,0,2
18808_0,,,,2,2,1,3
C(C(CC([C](C(O)=O)O)=O)O)(O)=O,,,5,1,2,0,2
18810_0,,,,2,2,1,3
C(C(CC(C(C(CO)O)=O)O)O)=O,,,5,1,4,0,4
18810_1,,,,2,2,1,3
18812_0,,,,2,2,1,3
C(C(C)(CC(C(CC=O)O)O)O)=O,,,5,1,1,0,1
18814_0,,,,2,2,1,3
C(CC(C(C)(CC(C=O)O)O)O)=O,,,5,1,3,0,3
18816_0,,,,2,2,1,3
C(CC(C(CC(C(C)=O)O)O)O)=O,,,5,1,1,0,1
18818_0,,,,2,2,1,3
C(CC(C)(C(CC(C=O)O)O)O)=O,,,5,1,3,0,3
18820_0,,,,2,2,1,3
C(C(CC(C=O)O)O)(CC(C)O)=O,,,5,1,3,0,3
18822_0,,,,2,2,1,3
C(CC(C(CC(C=O)O)O)=O)(O)=O,,,5,1,3,0,3
18824_0,,,,2,2,1,3
C(C(CC(C=O)O)O)(CCO)=O,,,5,1,3,0,3
18826_0,,,,2,2,1,3
C(CC(C(CCO)O)O)=O,,,5,1,1,0,1
18828_0,,,,2,2,1,3
C(C(C(C(CCO)O)O)C(C)O)=O,,,5,1,2,0,2
18828_1,,,,2,2,1,3
18830_0,,,,2,2,1,3
C(C(C=O)C(C(CCO)O)O)(O)=O,,,5,1,2,0,2
18830_1,,,,2,2,1,3
18832_0,,,,2,2,1,3
C(C(C(C(C(CCO)O)O)O)=O)=O,,,5,1,2,0,2
18832_1,,,,2,2,1,3
18834_0,,,,2,2,1,3
C(C(CC(C(CCO)O)O)=O)=O,,,5,1,1,0,1
18836_0,,,,2,2,1,3
C(C(CO)C(C(CCO)O)O)=O,,,5,1,2,0,2
18836_1,,,,2,2,1,3
18838_0,,,,2,2,1,3
C(CO)(C(C(C(CCO)O)O)O)=O,,,5,1,2,0,2
18838_1,,,,2,2,1,3
18840_0,,,,2,2,1,3
C(CO)(CC(C(CCO)O)O)=O,,,5,1,1,0,1
18842_0,,,,2,2,1,3
C(C)(C(C(C(CCO)O)O)O)=O,,,5,1,2,0,2
18842_1,,,,2,2,1,3
18844_0,,,,2,2,1,3
C(C(C=C)C(C(CCO)O)O)=O,,,5,1,1,0,1
18846_0,,,,2,2,1,3
C(C(C(C(CCO)O)O)O)=O,,,5,1,5,0,5
18846_1,,,,2,2,1,3
18848_0,,,,2,2,1,3
C(C(CC(C(CCO)O)O)=O)(O)=O,,,5,1,1,0,1
18850_0,,,,2,2,1,3
C(CC(C(O)O)O)=O,,,5,1,1,0,1
18852_0,,,,2,2,1,3
C(C(C(C(O)O)O)C(C)O)=O,,,5,1,2,0,2
18852_1,,,,2,2,1,3
18854_0,,,,2,2,1,3
C(C(C=O)C(C(O)O)O)(O)=O,,,5,1,2,0,2
18854_1,,,,2,2,1,3
18856_0,,,,2,2,1,3
C(C(C(C(C(O)O)O)O)=O)=O,,,5,1,2,0,2
18856_1,,,,2,2,1,3
18858_0,,,,2,2,1,3
C(C(CC(C(O)O)O)=O)=O,,,5,1,1,0,1
18860_0,,,,2,2,1,3
C(C(C(C(C(O)O)O)O)=O)(O)=O,,,5,1,2,0,2
18860_1,,,,2,2,1,3
18862_0,,,,2,2,1,3
C(C(C(C(O)O)O)C(C=O)(C)O)=O,,,5,1,2,0,2
18862_1,,,,2,2,1,3
18864_0,,,,2,2,1,3
C(C(C(C(O)O)O)C(C(C)=O)O)=O,,,5,1,2,0,2
18864_1,,,,2,2,1,3
18866_0,,,,2,2,1,3
C(CC(C(CC(C(O)O)O)=O)O)=O,,,5,1,1,0,1
18868_0,,,,2,2,1,3
C(C(C(CO)C(C(O)O)O)=O)=O,,,5,1,2,0,2
18868_1,,,,2,2,1,3
18870_0,,,,2,2,1,3
C(C(C(C(C(O)O)O)C(C)O)=O)=O,,,5,1,2,0,2
18870_1,,,,2,2,1,3
18872_0,,,,2,2,1,3
C(C(C(C=O)=O)C(C(O)O)O)(O)=O,,,5,1,2,0,2
18872_1,,,,2,2,1,3
18874_0,,,,2,2,1,3
C(C(CO)C(C(O)O)O)=O,,,5,1,2,0,2
18874_1,,,,2,2,1,3
18876_0,,,,2,2,1,3
C(C(C(CO)C(C(O)O)O)=O)(O)=O,,,5,1,2,0,2
18876_1,,,,2,2,1,3
18878_0,,,,2,2,1,3
C(C(C(C(C)=O)=O)C(C(O)O)O)=O,,,5,1,2,0,2
18878_1,,,,2,2,1,3
18880_0,,,,2,2,1,3
C(CC(C(CC(C(O)O)O)=O)=O)=O,,,5,1,1,0,1
18882_0,,,,2,2,1,3
C(C(C(C)O)=O)(CC(C(O)O)O)=O,,,5,1,1,0,1
18884_0,,,,2,2,1,3
C(C(C(CC(C(O)O)O)=O)=O)(O)=O,,,5,1,1,0,1
18886_0,,,,2,2,1,3
C(CO)(C(C(C(O)O)O)O)=O,,,5,1,2,0,2
18886_1,,,,2,2,1,3
18888_0,,,,2,2,1,3
C(CO)(CC(C(O)O)O)=O,,,5,1,1,0,1
18890_0,,,,2,2,1,3
C(C)(C(C(C(O)O)O)O)=O,,,5,1,2,0,2
18890_1,,,,2,2,1,3
18892_0,,,,2,2,1,3
C(C(C(CC(C(O)O)O)=O)C)(O)=O,,,5,1,1,0,1
18894_0,,,,2,2,1,3
C(C(C=C)C(C(O)O)O)=O,,,5,1,1,0,1
18896_0,,,,2,2,1,3
C=CC(C(C(O)=O)=O)C(C(O)O)O,,,5,1,1,0,1
18898_0,,,,2,2,1,3
C(C(C(C(O)=O)=C)C(C(O)O)O)=O,,,5,1,1,0,1
18900_0,,,,2,2,1,3
C(C(C(C(O)O)O)O)=O,,,5,1,2,0,2
18900_1,,,,2,2,1,3
18902_0,,,,2,2,1,3
C1(C(C(C(C)O1)C(C(O)O)O)=O)=O,,,5,1,2,0,2
18902_1,,,,2,2,1,3
18904_0,,,,2,2,1,3
C1(C(C(C(O1)=O)=O)C(C(O)O)O)=O,,,5,1,2,0,2
18904_1,,,,2,2,1,3
18906_0,,,,2,2,1,3
C(C(C(C(O)O)O)C[CH]C(O)=O)=O,,,5,1,1,0,1
18908_0,,,,2,2,1,3
C(C(CCC(O)=O)C(C(O)O)O)=O,,,5,1,1,0,1
18910_0,,,,2,2,1,3
C(C(CC(C(O)O)O)=O)(O)=O,,,5,1,1,0,1
18911_0,,,,2,2,1,3
18911_1,,,,2,2,1,3
18913_0,,,,2,2,1,3
C(CC(C(O)=O)(C(C=O)(C)O)O)=O,,,5,1,3,0,3
18915_0,,,,2,2,1,3
C(CC(C(C(C(O)=O)=O)(C)O)O)=O,,,5,1,3,0,3
18916_0,,,,2,2,1,3
18918_0,,,,2,2,1,3
C(CC(C)(C(C(C(O)=O)=O)O)O)=O,,,5,1,2,0,2
18920_0,,,,2,2,1,3
C(CC(C)O)(C(C(C(O)=O)=O)O)=O,,,5,1,2,0,2
18922_0,,,,2,2,1,3
C(CC(C(C(C(O)=O)=O)O)=O)(O)=O,,,5,1,2,0,2
18924_0,,,,2,2,1,3
C(CCO)(C(C(C(O)=O)=O)O)=O,,,5,1,3,0,3
18926_0,,,,2,2,1,3
C(C(C(C)O)(CC=O)O)(O)=O,,,5,1,3,0,3
18928_0,,,,2,2,1,3
C(C(C(C)O)(CC(C=O)=O)O)(O)=O,,,5,1,2,0,2
18930_0,,,,2,2,1,3
C(C(CO)C(C(O)=O)(C(C)O)O)=O,,,5,1,3,0,3
18930_1,,,,2,2,1,3
18932_0,,,,2,2,1,3
C(C(C(C)O)(CC(CO)=O)O)(O)=O,,,5,1,2,0,2
18933_0,,,,2,2,1,3
18933_1,,,,2,2,1,3
18935_0,,,,2,2,1,3
C(C(C=C)C(C(O)=O)(C(C)O)O)=O,,,5,1,2,0,2
18936_0,,,,2,2,1,3
18936_1,,,,2,2,1,3
18938_0,,,,2,2,1,3
C(C(CC=O)(C[CH]C(O)=O)O)(O)=O,,,5,1,2,0,2
18940_0,,,,2,2,1,3
[CH](C(O)=O)C(C(C(O)=O)=O)C(C)O,,,5,1,1,0,1
18942_0,,,,2,2,1,3
C(C([CH]C(O)=O)C(C(O)=O)=O)(O)=O,,,5,1,1,0,1
18944_0,,,,2,2,1,3
[CH](C(O)=O)C(C(C(O)=O)=O)CO,,,5,1,1,0,1
18946_0,,,,2,2,1,3
C(C(C)(C(CO)C(C(O)=O)O)O)=O,,,5,1,4,0,4
18946_1,,,,2,2,1,3
18948_0,,,,2,2,1,3
C(C(C(CO)C(C(C)=O)O)O)(O)=O,,,5,1,4,0,4
18948_1,,,,2,2,1,3
18949_0,,,,2,2,1,3
18949_1,,,,2,2,1,3
18951_0,,,,2,2,1,3
C(C(CC(C(O)=O)O)(CCO)O)=O,,,5,1,3,0,3
18951_1,,,,2,2,1,3
18953_0,,,,2,2,1,3
C(C(C(CO)C(CCO)O)O)(O)=O,,,5,1,3,0,3
18953_1,,,,2,2,1,3
18955_0,,,,2,2,1,3
C(C(C(CO)C(C=O)O)O)(O)=O,,,5,1,4,0,4
18955_1,,,,2,2,1,3
18957_0,,,,2,2,1,3
C(C(C(CO)C(CO)(C)O)O)(O)=O,,,5,1,3,0,3
18957_1,,,,2,2,1,3
18959_0,,,,2,2,1,3
C(C(C(CO)C(C=CC)O)O)(O)=O,,,5,1,3,0,3
18959_1,,,,2,2,1,3
18961_0,,,,2,2,1,3
C(C(C(C(CC=C)O)CO)O)(O)=O,,,5,1,3,0,3
18961_1,,,,2,2,1,3
18963_0,,,,2,2,1,3
C(C(C(CO)C(CO)O)O)(O)=O,,,5,1,3,0,3
18963_1,,,,2,2,1,3
18965_0,,,,2,2,1,3
C(C(C(CO)C(C(C)O)O)O)(O)=O,,,5,1,3,0,3
18965_1,,,,2,2,1,3
18967_0,,,,2,2,1,3
C(C(C(CO)C(C(O)=O)O)O)(O)=O,,,5,1,3,0,3
18967_1,,,,2,2,1,3
18968_0,,,,2,2,1,3
18968_1,,,,2,2,1,3
18969_0,,,,2,2,1,3
18969_1,,,,2,2,1,3
18971_0,,,,2,2,1,3
C(C(C(CO)CO)O)(O)=O,,,5,1,4,0,4
18971_1,,,,2,2,1,3
18973_0,,,,2,2,1,3
C(C(C(C(C)O)C(C=O)O)O)(O)=O,,,5,1,4,0,4
18973_1,,,,2,2,1,3
18975_0,,,,2,2,1,3
C(C(C(C(CO)O)C(C)O)O)(O)=O,,,5,1,3,0,3
18975_1,,,,2,2,1,3
18976_0,,,,2,2,1,3
18976_1,,,,2,2,1,3
18977_0,,,,2,2,1,3
18977_1,,,,2,2,1,3
18978_0,,,,2,2,1,3
18978_1,,,,2,2,1,3
18979_0,,,,2,2,1,3
18979_1,,,,2,2,1,3
18980_0,,,,2,2,1,3
18980_1,,,,2,2,1,3
18982_0,,,,2,2,1,3
C(C(C(C(CCO)O)O)O)(O)=O,,,5,1,5,0,5
18982_1,,,,2,2,1,3
18984_0,,,,2,2,1,3
C(C(CC(CCO)O)O)(O)=O,,,5,1,3,0,3
18984_1,,,,2,2,1,3
18985_0,,,,2,2,1,3
18986_0,,,,2,2,1,3
18987_0,,,,2,2,1,3
18988_0,,,,2,2,1,3
18989_0,,,,2,2,1,3
18990_0,,,,2,2,1,3
18991_0,,,,2,2,1,3
18992_0,,,,2,2,1,3
18993_0,,,,2,2,1,3
18994_0,,,,2,2,1,3
18995_0,,,,2,2,1,3
18996_0,,,,2,2,1,3
18997_0,,,,2,2,1,3
18998_0,,,,2,2,1,3
18999_0,,,,2,2,1,3
19000_0,,,,2,2,1,3
19001_0,,,,2,2,1,3
19002_0,,,,2,2,1,3
19004_0,,,,2,2,1,3
C(C(CC(C=O)O)(C(C)O)O)(O)=O,,,5,1,1,0,1
19006_0,,,,2,2,1,3
C(C(C(C)O)(CC(CO)O)O)(O)=O,,,5,1,1,0,1
19007_0,,,,2,2,1,3
19008_0,,,,2,2,1,3
19010_0,,,,2,2,1,3
C(C(C(C)O)(CCO)O)(O)=O,,,5,1,2,0,2
19012_0,,,,2,2,1,3
C(C(C(O)=O)(CC(C=O)O)O)(O)=O,,,5,1,1,0,1
19014_0,,,,2,2,1,3
C(C(C(O)=O)(CC(CO)O)O)(O)=O,,,5,1,1,0,1
19015_0,,,,2,2,1,3
19016_0,,,,2,2,1,3
19018_0,,,,2,2,1,3
C(C(C(O)=O)(CCO)O)(O)=O,,,5,1,2,0,2
19019_0,,,,2,2,1,3
19019_1,,,,2,2,1,3
19021_0,,,,2,2,1,3
C(C(CC(C=O)O)O)(O)=O,,,5,1,9,0,9
19021_1,,,,2,2,1,3
19022_0,,,,2,2,1,3
19022_1,,,,2,2,1,3
19023_0,,,,2,2,1,3
19023_1,,,,2,2,1,3
19025_0,,,,2,2,1,3
C(C(C(CC(C(O)=O)O)O)O)(O)=O,,,5,1,4,0,4
19025_1,,,,2,2,1,3
19027_0,,,,2,2,1,3
C(C(C(C(CO)(CO)O)O)O)(O)=O,,,5,1,7,0,7
19027_1,,,,2,2,1,3
19029_0,,,,2,2,1,3
C(C(CC(CO)(CO)O)O)(O)=O,,,5,1,4,0,4
19029_1,,,,2,2,1,3
19031_0,,,,2,2,1,3
C(C(C(C(CO)(C)O)O)O)(O)=O,,,5,1,6,0,6
19031_1,,,,2,2,1,3
19033_0,,,,2,2,1,3
C(C(CC(CO)(C)O)O)(O)=O,,,5,1,4,0,4
19033_1,,,,2,2,1,3
19035_0,,,,2,2,1,3
C(C(C(C(C=CC)O)O)O)(O)=O,,,5,1,5,0,5
19035_1,,,,2,2,1,3
19037_0,,,,2,2,1,3
C(C(CC(C=CC)O)O)(O)=O,,,5,1,4,0,4
19037_1,,,,2,2,1,3
19039_0,,,,2,2,1,3
C(C(C(C(CC=C)O)O)O)(O)=O,,,5,1,5,0,5
19039_1,,,,2,2,1,3
19041_0,,,,2,2,1,3
C(C(CC(CC=C)O)O)(O)=O,,,5,1,4,0,4
19041_1,,,,2,2,1,3
19043_0,,,,2,2,1,3
C(C(C(C(C(CO)O)O)O)O)(O)=O,,,5,1,9,0,9
19043_1,,,,2,2,1,3
19045_0,,,,2,2,1,3
C(C(CC(C(CO)O)O)O)(O)=O,,,5,1,4,0,4
19045_1,,,,2,2,1,3
19046_0,,,,2,2,1,3
19046_1,,,,2,2,1,3
19048_0,,,,2,2,1,3
C(C(CC(CO)O)O)(O)=O,,,5,1,5,0,5
19048_1,,,,2,2,1,3
19050_0,,,,2,2,1,3
C(C(C(CO)C[CH]C(O)=O)O)(O)=O,,,5,1,5,0,5
19050_1,,,,2,2,1,3
19052_0,,,,2,2,1,3
C(CCC(CO)C(C(O)=O)O)(O)=O,,,5,1,5,0,5
19052_1,,,,2,2,1,3
19054_0,,,,2,2,1,3
C(C(C(C(C(C)O)O)O)O)(O)=O,,,5,1,5,0,5
19054_1,,,,2,2,1,3
19056_0,,,,2,2,1,3
C(C(CC(C(C)O)O)O)(O)=O,,,5,1,4,0,4
19056_1,,,,2,2,1,3
19057_0,,,,2,2,1,3
19057_1,,,,2,2,1,3
19059_0,,,,2,2,1,3
C(C(CC(C(O)=O)O)O)(O)=O,,,5,1,6,0,6
19059_1,,,,2,2,1,3
19060_0,,,,2,2,1,3
19061_0,,,,2,2,1,3
19062_0,,,,2,2,1,3
19063_0,,,,2,2,1,3
19064_0,,,,2,2,1,3
19064_1,,,,2,2,1,3
19065_0,,,,2,2,1,3
19065_1,,,,2,2,1,3
19066_0,,,,2,2,1,3
19067_0,,,,2,2,1,3
19068_0,,,,2,2,1,3
19068_1,,,,2,2,1,3
19069_0,,,,2,2,1,3
19070_0,,,,2,2,1,3
19070_1,,,,2,2,1,3
19071_0,,,,2,2,1,3
19072_0,,,,2,2,1,3
19072_1,,,,2,2,1,3
19073_0,,,,2,2,1,3
19074_0,,,,2,2,1,3
19075_0,,,,2,2,1,3
19075_1,,,,2,2,1,3
19076_0,,,,2,2,1,3
19077_0,,,,2,2,1,3
19078_0,,,,2,2,1,3
19080_0,,,,2,2,1,3
C(C(C(CO)=O)(C(C)=O)O)(O)=O,,,5,1,4,0,4
19081_0,,,,2,2,1,3
19082_0,,,,2,2,1,3
19084_0,,,,2,2,1,3
C(C(C(C)=O)(C(C)=O)O)(O)=O,,,5,1,3,0,3
19085_0,,,,2,2,1,3
19085_1,,,,2,2,1,3
19086_0,,,,2,2,1,3
19087_0,,,,2,2,1,3
19088_0,,,,2,2,1,3
19089_0,,,,2,2,1,3
19090_0,,,,2,2,1,3
19091_0,,,,2,2,1,3
19092_0,,,,2,2,1,3
19093_0,,,,2,2,1,3
19094_0,,,,2,2,1,3
19095_0,,,,2,2,1,3
19095_1,,,,2,2,1,3
19096_0,,,,2,2,1,3
19097_0,,,,2,2,1,3
19097_1,,,,2,2,1,3
19098_0,,,,2,2,1,3
19099_0,,,,2,2,1,3
19099_1,,,,2,2,1,3
19100_0,,,,2,2,1,3
19101_0,,,,2,2,1,3
19101_1,,,,2,2,1,3
19102_0,,,,2,2,1,3
19103_0,,,,2,2,1,3
19103_1,,,,2,2,1,3
19104_0,,,,2,2,1,3
19105_0,,,,2,2,1,3
19105_1,,,,2,2,1,3
19106_0,,,,2,2,1,3
19107_0,,,,2,2,1,3
19108_0,,,,2,2,1,3
19109_0,,,,2,2,1,3
19109_1,,,,2,2,1,3
19110_0,,,,2,2,1,3
19110_1,,,,2,2,1,3
19111_0,,,,2,2,1,3
19111_1,,,,2,2,1,3
19112_0,,,,2,2,1,3
19113_0,,,,2,2,1,3
19113_1,,,,2,2,1,3
19114_0,,,,2,2,1,3
19114_1,,,,2,2,1,3
19115_0,,,,2,2,1,3
19117_0,,,,2,2,1,3
C(C(C(C)=O)(CC(O)=O)O)(O)=O,,,5,1,4,0,4
19118_0,,,,2,2,1,3
19120_0,,,,2,2,1,3
C(C(C=O)(C(C(O)=O)C)O)(O)=O,,,5,1,3,0,3
19121_0,,,,2,2,1,3
19121_1,,,,2,2,1,3
19122_0,,,,2,2,1,3
19123_0,,,,2,2,1,3
19124_0,,,,2,2,1,3
19125_0,,,,2,2,1,3
19126_0,,,,2,2,1,3
19126_1,,,,2,2,1,3
19127_0,,,,2,2,1,3
19128_0,,,,2,2,1,3
19129_0,,,,2,2,1,3
19129_1,,,,2,2,1,3
19130_0,,,,2,2,1,3
19130_1,,,,2,2,1,3
19131_0,,,,2,2,1,3
19132_0,,,,2,2,1,3
19133_0,,,,2,2,1,3
19133_1,,,,2,2,1,3
19134_0,,,,2,2,1,3
19134_1,,,,2,2,1,3
19135_0,,,,2,2,1,3
19136_0,,,,2,2,1,3
19137_0,,,,2,2,1,3
19138_0,,,,2,2,1,3
19140_0,,,,2,2,1,3
C(C(C)(C)O)(O)=O,,,5,1,1,0,1
19141_0,,,,2,2,1,3
19141_1,,,,2,2,1,3
19142_0,,,,2,2,1,3
19142_1,,,,2,2,1,3
19144_0,,,,2,2,1,3
C(C(C(C(O)=O)O)O)(C(C)O)=O,,,5,1,7,0,7
19144_1,,,,2,2,1,3
19145_0,,,,2,2,1,3
19145_1,,,,2,2,1,3
19146_0,,,,2,2,1,3
19146_1,,,,2,2,1,3
19148_0,,,,2,2,1,3
C(C(C(CO)(C(CO)O)O)O)(O)=O,,,5,1,7,0,7
19148_1,,,,2,2,1,3
19149_0,,,,2,2,1,3
19149_1,,,,2,2,1,3
19150_0,,,,2,2,1,3
19150_1,,,,2,2,1,3
19151_0,,,,2,2,1,3
19151_1,,,,2,2,1,3
19152_0,,,,2,2,1,3
19152_1,,,,2,2,1,3
19153_0,,,,2,2,1,3
19153_1,,,,2,2,1,3
19155_0,,,,2,2,1,3
C(C(CC(C(C)=O)(CO)O)O)(O)=O,,,5,1,4,0,4
19155_1,,,,2,2,1,3
19157_0,,,,2,2,1,3
C(C(CO)(C(C)(C(C)O)O)O)(O)=O,,,5,1,3,0,3
19158_0,,,,2,2,1,3
19159_0,,,,2,2,1,3
19161_0,,,,2,2,1,3
C(C(C)(C(C)(C(CO)O)O)O)(O)=O,,,5,1,2,0,2
19163_0,,,,2,2,1,3
C(C(C)(C(C)(C(C)O)O)O)(O)=O,,,5,1,2,0,2
19164_0,,,,2,2,1,3
19166_0,,,,2,2,1,3
C(C(C=O)(CCC(C)O)O)(O)=O,,,5,1,2,0,2
19168_0,,,,2,2,1,3
C(C(C(CCC(C)O)=O)O)(O)=O,,,5,1,3,0,3
19168_1,,,,2,2,1,3
19169_0,,,,2,2,1,3
19169_1,,,,2,2,1,3
19171_0,,,,2,2,1,3
C(C(C(O)=O)(CCC(C)O)O)(O)=O,,,5,1,1,0,1
19172_0,,,,2,2,1,3
19173_0,,,,2,2,1,3
19173_1,,,,2,2,1,3
19174_0,,,,2,2,1,3
19174_1,,,,2,2,1,3
19175_0,,,,2,2,1,3
19176_0,,,,2,2,1,3
19178_0,,,,2,2,1,3
C(C(C(O)=O)O)(CC(CO)=O)=O,,,5,1,3,0,3
19178_1,,,,2,2,1,3
19180_0,,,,2,2,1,3
C(C(C(O)=O)(CC(CO)=O)O)(O)=O,,,5,1,2,0,2
19181_0,,,,2,2,1,3
19183_0,,,,2,2,1,3
C(C(C(C(C(O)=O)O)=O)CO)=O,,,5,1,3,0,3
19183_1,,,,2,2,1,3
19184_0,,,,2,2,1,3
19184_1,,,,2,2,1,3
19186_0,,,,2,2,1,3
C(C(C=O)CC(C(O)=O)O)=O,,,5,1,4,0,4
19186_1,,,,2,2,1,3
19188_0,,,,2,2,1,3
C(C(C(O)=O)(C(C=O)CO)O)(O)=O,,,5,1,2,0,2
19190_0,,,,2,2,1,3
C(C(C=O)(C(C=O)C)O)(O)=O,,,5,1,3,0,3
19192_0,,,,2,2,1,3
C(C(C(C(C(O)=O)O)=O)C)=O,,,5,1,3,0,3
19192_1,,,,2,2,1,3
19194_0,,,,2,2,1,3
C(C(C=O)(CC(C)=O)O)(O)=O,,,5,1,3,0,3
19196_0,,,,2,2,1,3
C(C(C(O)=O)O)(CC(C)=O)=O,,,5,1,3,0,3
19196_1,,,,2,2,1,3
19197_0,,,,2,2,1,3
19197_1,,,,2,2,1,3
19198_0,,,,2,2,1,3
19198_1,,,,2,2,1,3
19200_0,,,,2,2,1,3
C(C(C=O)(C(C(O)=O)CO)O)(O)=O,,,5,1,4,0,4
19202_0,,,,2,2,1,3
C(C(C(C(C(O)=O)O)=O)CO)(O)=O,,,5,1,2,0,2
19202_1,,,,2,2,1,3
19203_0,,,,2,2,1,3
19203_1,,,,2,2,1,3
19205_0,,,,2,2,1,3
C(C(C=O)(CC)O)(O)=O,,,5,1,3,0,3
19206_0,,,,2,2,1,3
19206_1,,,,2,2,1,3
19208_0,,,,2,2,1,3
C(C(C(O)=O)(C(C=O)C)O)(O)=O,,,5,1,2,0,2
19210_0,,,,2,2,1,3
C(C(C(O)=O)(CC(C)=O)O)(O)=O,,,5,1,3,0,3
19212_0,,,,2,2,1,3
C(C(C=O)CC(C(O)=O)O)(O)=O,,,5,1,7,0,7
19212_1,,,,2,2,1,3
19214_0,,,,2,2,1,3
C(C(C(O)=O)(CC)O)(O)=O,,,5,1,1,0,1
19216_0,,,,2,2,1,3
C(C(C(O)=O)(C(C(O)=O)C)O)(O)=O,,,5,1,1,0,1
19217_0,,,,2,2,1,3
19218_0,,,,2,2,1,3
19219_0,,,,2,2,1,3
19221_0,,,,2,2,1,3
C(C(C)C(C(O)=O)(CO)O)(O)=O,,,5,1,1,0,1
19223_0,,,,2,2,1,3
C(C(C)C(C(O)=O)(C)O)(O)=O,,,5,1,1,0,1
19225_0,,,,2,2,1,3
C(C(C(C=CC(C)O)O)O)(O)=O,,,5,1,5,0,5
19225_1,,,,2,2,1,3
19227_0,,,,2,2,1,3
C(C(C=CCC(C)O)O)(O)=O,,,5,1,4,0,4
19227_1,,,,2,2,1,3
19229_0,,,,2,2,1,3
C(C(CC=CC(C)O)O)(O)=O,,,5,1,4,0,4
19229_1,,,,2,2,1,3
19231_0,,,,2,2,1,3
C(C(C(C=CC(O)=O)O)O)(O)=O,,,5,1,5,0,5
19231_1,,,,2,2,1,3
19232_0,,,,2,2,1,3
19232_1,,,,2,2,1,3
19234_0,,,,2,2,1,3
C(C(CC=CC(O)=O)O)(O)=O,,,5,1,4,0,4
19234_1,,,,2,2,1,3
19236_0,,,,2,2,1,3
C(C(C(C(C(O)=O)=O)=C)(C)O)(O)=O,,,5,1,2,0,2
19237_0,,,,2,2,1,3
19239_0,,,,2,2,1,3
C(C(C=CC(CO)=O)O)(O)=O,,,5,1,5,0,5
19239_1,,,,2,2,1,3
19241_0,,,,2,2,1,3
C(C(C=C(C=O)CO)O)(O)=O,,,5,1,5,0,5
19241_1,,,,2,2,1,3
19243_0,,,,2,2,1,3
C(C(C(C(C=O)=C)O)O)(O)=O,,,5,1,6,0,6
19243_1,,,,2,2,1,3
19244_0,,,,2,2,1,3
19244_1,,,,2,2,1,3
19246_0,,,,2,2,1,3
C(C(C=C(C=O)C)O)(O)=O,,,5,1,4,0,4
19246_1,,,,2,2,1,3
19248_0,,,,2,2,1,3
C(C(CC(C=O)=C)O)(O)=O,,,5,1,4,0,4
19248_1,,,,2,2,1,3
19250_0,,,,2,2,1,3
C(C(C=CC(C)=O)O)(O)=O,,,5,1,4,0,4
19250_1,,,,2,2,1,3
19251_0,,,,2,2,1,3
19251_1,,,,2,2,1,3
19253_0,,,,2,2,1,3
C(C(C=C(C(O)=O)CO)O)(O)=O,,,5,1,5,0,5
19253_1,,,,2,2,1,3
19254_0,,,,2,2,1,3
19254_1,,,,2,2,1,3
19255_0,,,,2,2,1,3
19255_1,,,,2,2,1,3
19256_0,,,,2,2,1,3
19256_1,,,,2,2,1,3
19258_0,,,,2,2,1,3
C1(CC(C(C(C(O)=O)O)O1)O)=O,,,5,1,4,0,4
19258_1,,,,2,2,1,3
19259_0,,,,2,2,1,3
19260_0,,,,2,2,1,3
19260_1,,,,2,2,1,3
19261_0,,,,2,2,1,3
19261_1,,,,2,2,1,3
19263_0,,,,2,2,1,3
C(CC(C)C(CC(C(O)=O)O)O)=O,,,5,1,4,0,4
19263_1,,,,2,2,1,3
19265_0,,,,2,2,1,3
C(C(CC(C[CH]C(O)=O)O)O)(O)=O,,,5,1,4,0,4
19265_1,,,,2,2,1,3
19267_0,,,,2,2,1,3
C(CCC(CC(C(O)=O)O)O)(O)=O,,,5,1,4,0,4
19267_1,,,,2,2,1,3
19269_0,,,,2,2,1,3
C(CC(C)C(CO)C(C(O)=O)O)=O,,,5,1,4,0,4
19269_1,,,,2,2,1,3
19270_0,,,,2,2,1,3
19270_1,,,,2,2,1,3
19271_0,,,,2,2,1,3
19271_1,,,,2,2,1,3
19272_0,,,,2,1,2,3
19273_0,,,,2,1,2,3
19274_0,,,,2,1,2,3
19275_0,,,,2,1,2,3
19276_0,,,,2,1,2,3
19277_0,,,,2,1,2,3
19278_0,,,,2,1,2,3
19279_0,,,,2,1,2,3
19280_0,,,,2,1,2,3
19281_0,,,,2,1,2,3
19282_0,,,,2,1,2,3
19284_0,,,,2,1,2,3
C(CC(C(CC(C=O)=O)=O)O)=O,,,5,1,3,0,3
19286_0,,,,2,1,2,3
C(C(C(C(C=O)=O)CO)=O)=O,,,5,1,3,0,3
19287_0,,,,2,1,2,3
19289_0,,,,2,1,2,3
C(C(C(C(C=O)=O)C(C)O)=O)=O,,,5,1,3,0,3
19291_0,,,,2,1,2,3
C(C(C(C=O)=O)C(C=O)=O)(O)=O,,,5,1,3,0,3
19293_0,,,,2,1,2,3
C(C(C(C(C(CO)O)=O)=O)O)=O,,,5,1,3,0,3
19294_0,,,,2,1,2,3
19295_0,,,,2,1,2,3
19297_0,,,,2,1,2,3
C(C(C(C(C(C)=O)=O)=O)CO)=O,,,5,1,1,0,1
19298_0,,,,2,1,2,3
19299_0,,,,2,1,2,3
19301_0,,,,2,1,2,3
C(C(C(C(C=CC)=O)=O)CO)=O,,,5,1,1,0,1
19303_0,,,,2,1,2,3
C(C(C(C(CC=C)=O)=O)CO)=O,,,5,1,1,0,1
19304_0,,,,2,1,2,3
19305_0,,,,2,1,2,3
19307_0,,,,2,1,2,3
C(CO)(CC(C(CCO)=O)=O)=O,,,5,1,2,0,2
19308_0,,,,2,1,2,3
19310_0,,,,2,1,2,3
C(C(C=C)C(C(CCO)=O)=O)=O,,,5,1,1,0,1
19312_0,,,,2,1,2,3
C(C(C(C(CCO)=O)=O)O)=O,,,5,1,1,0,1
19313_0,,,,2,1,2,3
19314_0,,,,2,1,2,3
19316_0,,,,2,1,2,3
C(C(C(C(C=O)=O)CO)=O)(O)=O,,,5,1,5,0,5
19317_0,,,,2,1,2,3
19318_0,,,,2,1,2,3
19319_0,,,,2,1,2,3
19320_0,,,,2,1,2,3
19322_0,,,,2,1,2,3
C(C(C(C=O)=O)C(C(C)=O)=O)=O,,,5,1,2,0,2
19324_0,,,,2,1,2,3
C(CC(C(CC(C=O)=O)=O)=O)=O,,,5,1,2,0,2
19326_0,,,,2,1,2,3
C(C(C(C(C(C)O)=O)=O)=O)=O,,,5,1,2,0,2
19328_0,,,,2,1,2,3
C(C(C(C(C(CO)=O)=O)=O)O)=O,,,5,1,3,0,3
19330_0,,,,2,1,2,3
C(CC(C(C(CO)=O)=O)=O)=O,,,5,1,1,0,1
19332_0,,,,2,1,2,3
C(C(C(C(C(O)=O)=O)=O)=O)=O,,,5,1,2,0,2
19334_0,,,,2,1,2,3
C(C(CC(C(C(C)O)=O)=O)=O)=O,,,5,1,3,0,3
19336_0,,,,2,1,2,3
C(CO)(CC(C(C(C)=O)=O)=O)=O,,,5,1,1,0,1
19338_0,,,,2,1,2,3
C(C)(C(C(C(C(C)=O)=O)=O)O)=O,,,5,1,1,0,1
19340_0,,,,2,1,2,3
C(C(C=C)C(C(C(C)=O)=O)=O)=O,,,5,1,1,0,1
19342_0,,,,2,1,2,3
C(C(C(C(C(C)=O)=O)=O)O)=O,,,5,1,4,0,4
19344_0,,,,2,1,2,3
C(CC(C(C(C)=O)=O)=O)=O,,,5,1,1,0,1
19346_0,,,,2,1,2,3
C(C(CC(C(C(C)=O)=O)=O)=O)=O,,,5,1,1,0,1
19348_0,,,,2,1,2,3
C(C(CC(C(C(O)=O)=O)=O)=O)=O,,,5,1,3,0,3
19349_0,,,,2,1,2,3
19350_0,,,,2,1,2,3
19351_0,,,,2,1,2,3
19352_0,,,,2,1,2,3
19353_0,,,,2,1,2,3
19354_0,,,,2,1,2,3
19355_0,,,,2,1,2,3
19356_0,,,,2,1,2,3
19357_0,,,,2,1,2,3
19358_0,,,,2,1,2,3
19359_0,,,,2,1,2,3
19360_0,,,,2,1,2,3
19361_0,,,,2,1,2,3
19362_0,,,,2,1,2,3
19363_0,,,,2,1,2,3
19365_0,,,,2,1,2,3
C(C(C(CO)=O)=O)=O,,,5,1,11,0,11
19366_0,,,,2,1,2,3
19368_0,,,,2,1,2,3
C(CO)(CC(C(C=CC)=O)=O)=O,,,5,1,1,0,1
19370_0,,,,2,1,2,3
C(CO)(CC(C(CC=C)=O)=O)=O,,,5,1,1,0,1
19372_0,,,,2,1,2,3
C(CO)(CC(C=O)=O)=O,,,5,1,9,0,9
19374_0,,,,2,1,2,3
C(CO)(CC(C(CO)=O)=O)=O,,,5,1,4,0,4
19376_0,,,,2,1,2,3
C(CO)(CC(C(C)=O)=O)=O,,,5,1,4,0,4
19377_0,,,,2,1,2,3
19379_0,,,,2,1,2,3
C(C)(C(C(C(C=CC)=O)=O)O)=O,,,5,1,1,0,1
19381_0,,,,2,1,2,3
C(C)(C(C(C(CC=C)=O)=O)O)=O,,,5,1,1,0,1
19382_0,,,,2,1,2,3
19383_0,,,,2,1,2,3
19384_0,,,,2,1,2,3
19385_0,,,,2,1,2,3
19386_0,,,,2,1,2,3
19387_0,,,,2,1,2,3
19388_0,,,,2,1,2,3
19389_0,,,,2,1,2,3
19390_0,,,,2,1,2,3
19391_0,,,,2,1,2,3
19392_0,,,,2,1,2,3
19393_0,,,,2,1,2,3
19395_0,,,,2,1,2,3
C(CC(C=O)=O)(C(C(O)=O)C)=O,,,5,1,3,0,3
19397_0,,,,2,1,2,3
C(C(C=C)C(C(C=CC)=O)=O)=O,,,5,1,1,0,1
19399_0,,,,2,1,2,3
C(C(C=C)C(C(CC=C)=O)=O)=O,,,5,1,1,0,1
19401_0,,,,2,1,2,3
C(C(C=C)C(C=O)=O)=O,,,5,1,2,0,2
19403_0,,,,2,1,2,3
C(C(C=C)C(C(CO)=O)=O)=O,,,5,1,2,0,2
19405_0,,,,2,1,2,3
C(C(C=C)C(C(C)=O)=O)=O,,,5,1,3,0,3
19407_0,,,,2,1,2,3
C(C(C(C(C=CC)=O)=O)O)=O,,,5,1,1,0,1
19409_0,,,,2,1,2,3
C(CC(C(C=CC)=O)=O)=O,,,5,1,3,0,3
19411_0,,,,2,1,2,3
C(C)=CC(C(CC(C=O)=O)=O)=O,,,5,1,1,0,1
19413_0,,,,2,1,2,3
C(C(C(C(CC=C)=O)=O)O)=O,,,5,1,1,0,1
19415_0,,,,2,1,2,3
C(CC(C(CC=C)=O)=O)=O,,,5,1,2,0,2
19417_0,,,,2,1,2,3
C=CCC(C(CC(C=O)=O)=O)=O,,,5,1,1,0,1
19419_0,,,,2,1,2,3
C=CC(C(C=O)=O)C(C(O)=O)=O,,,5,1,2,0,2
19421_0,,,,2,1,2,3
C(C(C(C=O)=O)C(C(O)=O)=C)=O,,,5,1,2,0,2
19422_0,,,,2,1,2,3
19424_0,,,,2,1,2,3
C(C(C(C=O)=O)O)=O,,,5,1,9,0,9
19426_0,,,,2,1,2,3
C(C(C(C(CC(C)O)=O)=O)O)=O,,,5,1,1,0,1
19427_0,,,,2,1,2,3
19429_0,,,,2,1,2,3
C(CC(C(C(C=O)O)=O)=O)(O)=O,,,5,1,1,0,1
19431_0,,,,2,1,2,3
C(C(C(C(CO)=O)=O)O)=O,,,5,1,6,0,6
19433_0,,,,2,1,2,3
C(C(C(C(C)=O)=O)O)=O,,,5,1,7,0,7
19435_0,,,,2,1,2,3
C(C(C1C(C(OC1C)=O)=O)=O)=O,,,5,1,2,0,2
19437_0,,,,2,1,2,3
C1(C(C(C=O)=O)C(C(O1)=O)=O)=O,,,5,1,2,0,2
19439_0,,,,2,1,2,3
C(C(C(C=O)=O)C[CH]C(O)=O)=O,,,5,1,4,0,4
19441_0,,,,2,1,2,3
C(C(C(C=O)=O)CCC(O)=O)=O,,,5,1,4,0,4
19442_0,,,,2,1,2,3
19443_0,,,,2,1,2,3
19444_0,,,,2,1,2,3
19446_0,,,,2,1,2,3
C(C(C(C(C=O)=O)O)=O)=O,,,5,1,3,0,3
19448_0,,,,2,1,2,3
C(C(CC(C=O)=O)=O)=O,,,5,1,4,0,4
19450_0,,,,2,1,2,3
C(C(C(C(C=O)=O)O)=O)(O)=O,,,5,1,3,0,3
19452_0,,,,2,1,2,3
C(C(CC(C(O)=O)=O)=O)=O,,,5,1,6,0,6
19453_0,,,,2,1,2,3
19454_0,,,,2,1,2,3
19455_0,,,,2,1,2,3
19456_0,,,,2,1,2,3
19457_0,,,,2,1,2,3
19458_0,,,,2,1,2,3
19459_0,,,,2,1,2,3
19460_0,,,,2,1,2,3
19461_0,,,,2,1,2,3
19462_0,,,,2,1,2,3
19463_0,,,,2,1,2,3
19464_0,,,,2,1,2,3
19465_0,,,,2,1,2,3
19466_0,,,,2,1,2,3
19468_0,,,,2,1,2,3
C(C(C(C(CO)=O)=O)=O)=O,,,5,1,2,0,2
19469_0,,,,2,1,2,3
19471_0,,,,2,1,2,3
C(C(C(C(C)=O)=O)=O)=O,,,5,1,3,0,3
19472_0,,,,2,1,2,3
19473_0,,,,2,1,2,3
19475_0,,,,2,1,2,3
C(C(C(C)=O)=O)(C)=O,,,5,1,11,0,11
19476_0,,,,2,1,2,3
19478_0,,,,2,1,2,3
C(C(C(C(CC(C)O)O)=O)=O)=O,,,5,1,2,0,2
19480_0,,,,2,1,2,3
C(CC(C(C(C=O)=O)=O)O)(O)=O,,,5,1,2,0,2
19482_0,,,,2,1,2,3
C(CO)(C(C(C(C=O)=O)=O)O)=O,,,5,1,3,0,3
19484_0,,,,2,1,2,3
C(C(C(C(C=O)=O)=O)(CO)O)=O,,,5,1,2,0,2
19485_0,,,,2,1,2,3
19486_0,,,,2,1,2,3
19488_0,,,,2,1,2,3
C(C(C(C(C=O)=O)=O)(C)O)=O,,,5,1,2,0,2
19490_0,,,,2,1,2,3
C(C)(C(C(C(C=O)=O)=O)O)=O,,,5,1,3,0,3
19492_0,,,,2,1,2,3
C(C(C(C(C)O)=O)=O)=O,,,5,1,7,0,7
19494_0,,,,2,1,2,3
C(C(C(C(C(C)=O)=O)=O)O)(O)=O,,,5,1,3,0,3
19496_0,,,,2,1,2,3
C(C(C(C(C=O)=O)=O)(C)O)(O)=O,,,5,1,2,0,2
19497_0,,,,2,1,2,3
19499_0,,,,2,1,2,3
C(C(C(CO)=O)=O)(C(CO)O)=O,,,5,1,3,0,3
19501_0,,,,2,1,2,3
C(C(C(CO)=O)=O)(C(C)O)=O,,,5,1,2,0,2
19503_0,,,,2,1,2,3
C(C(C(C(CO)O)=O)=O)=O,,,5,1,3,0,3
19505_0,,,,2,1,2,3
C(C(C(C)=O)=O)(C(CO)O)=O,,,5,1,3,0,3
19507_0,,,,2,1,2,3
C(C(C(C)=O)=O)(C(C)O)=O,,,5,1,3,0,3
19509_0,,,,2,1,2,3
C(C(C(C[CH]C(O)=O)=O)=O)=O,,,5,1,2,0,2
19510_0,,,,2,1,2,3
19512_0,,,,2,1,2,3
C(C(CO)=O)(C(CO)C(C)O)=O,,,5,1,3,0,3
19513_0,,,,2,1,2,3
19514_0,,,,2,1,2,3
19515_0,,,,2,1,2,3
19516_0,,,,2,1,2,3
19517_0,,,,2,1,2,3
19518_0,,,,2,1,2,3
19519_0,,,,2,1,2,3
19520_0,,,,2,1,2,3
19522_0,,,,2,1,2,3
C(C(CO)=O)(C(CO)(CO)O)=O,,,5,1,2,0,2
19523_0,,,,2,1,2,3
19524_0,,,,2,1,2,3
19526_0,,,,2,1,2,3
C(C(C)=O)(C(CO)(CO)O)=O,,,5,1,5,0,5
19528_0,,,,2,1,2,3
C(C(C(CO)(C)O)=O)=O,,,5,1,5,0,5
19529_0,,,,2,1,2,3
19530_0,,,,2,1,2,3
19531_0,,,,2,1,2,3
19532_0,,,,2,1,2,3
19533_0,,,,2,1,2,3
19534_0,,,,2,1,2,3
19535_0,,,,2,1,2,3
19537_0,,,,2,1,2,3
C(C(C(C=O)=O)(CO)C(C)O)=O,,,5,1,2,0,2
19539_0,,,,2,1,2,3
C(C(C=O)(C(C=O)=O)CO)(O)=O,,,5,1,2,0,2
19541_0,,,,2,1,2,3
C(C(C(C(C)=O)=O)(CO)CO)=O,,,5,1,2,0,2
19543_0,,,,2,1,2,3
C(C(C(C(C=O)=O)(CO)O)=O)=O,,,5,1,2,0,2
19544_0,,,,2,1,2,3
19546_0,,,,2,1,2,3
C(C(C(C(C(C=O)=O)=O)=O)O)=O,,,5,1,1,0,1
19548_0,,,,2,1,2,3
C(C(C(C(C(CO)O)=O)=O)=O)=O,,,5,1,1,0,1
19549_0,,,,2,1,2,3
19551_0,,,,2,1,2,3
C(C(C(C(CO)=O)=O)=O)(O)=O,,,5,1,1,0,1
19553_0,,,,2,1,2,3
C(C(C(C(CCO)O)=O)=O)=O,,,5,1,1,0,1
19555_0,,,,2,1,2,3
C(C(C(C)O)=O)(C(CCO)O)=O,,,5,1,1,0,1
19557_0,,,,2,1,2,3
C(C(C(C(CCO)O)=O)=O)(O)=O,,,5,1,1,0,1
19559_0,,,,2,1,2,3
C(C(CO)=O)(C(CCO)O)=O,,,5,1,1,0,1
19561_0,,,,2,1,2,3
C(C(C(C(C(C)O)=O)=O)=O)(O)=O,,,5,1,1,0,1
19563_0,,,,2,1,2,3
C(C(C(C(C(O)=O)=O)=O)=O)(O)=O,,,5,1,1,0,1
19565_0,,,,2,1,2,3
C(C(C(C(C=O)=O)=O)O)=O,,,5,1,1,0,1
19567_0,,,,2,1,2,3
C(C(C(C(C(C)O)=O)=O)O)=O,,,5,1,3,0,3
19569_0,,,,2,1,2,3
C(C(C(C(C(O)=O)=O)=O)O)=O,,,5,1,1,0,1
19570_0,,,,2,1,2,3
19571_0,,,,2,1,2,3
19573_0,,,,2,1,2,3
C(C(C=O)(C(C=O)=O)O)=O,,,5,1,2,0,2
19574_0,,,,2,1,2,3
19576_0,,,,2,1,2,3
C(C(C=O)(C(C(CO)=O)=O)O)=O,,,5,1,1,0,1
19578_0,,,,2,1,2,3
C(C(C=O)(C(C(C)=O)=O)O)=O,,,5,1,1,0,1
19579_0,,,,2,1,2,3
19581_0,,,,2,1,2,3
C(C(C(C(CO)(CO)O)=O)=O)=O,,,5,1,2,0,2
19583_0,,,,2,1,2,3
C(C(C(C(CO)(C)O)=O)=O)=O,,,5,1,2,0,2
19585_0,,,,2,1,2,3
C(C(C(C(C=O)=O)=O)O)=CC,,,5,1,1,0,1
19587_0,,,,2,1,2,3
C=CCC(C(C(C=O)=O)=O)O,,,5,1,1,0,1
19589_0,,,,2,1,2,3
C(C(C(C(C(CO)O)O)=O)=O)=O,,,5,1,3,0,3
19590_0,,,,2,1,2,3
19592_0,,,,2,1,2,3
C(C(C(C(C(C)O)O)=O)=O)=O,,,5,1,3,0,3
19594_0,,,,2,1,2,3
C(C(C=O)(C(C=O)=O)O)(O)=O,,,5,1,2,0,2
19596_0,,,,2,1,2,3
C(C(C(C(C=O)=O)=O)O)(O)=O,,,5,1,1,0,1
19597_0,,,,2,1,2,3
19598_0,,,,2,1,2,3
19599_0,,,,2,1,2,3
19600_0,,,,2,1,2,3
19601_0,,,,2,1,2,3
19602_0,,,,2,1,2,3
19603_0,,,,2,1,2,3
19604_0,,,,2,1,2,3
19606_0,,,,2,1,2,3
C(C(C=O)(C(C(C)=O)=O)O)(O)=O,,,5,1,1,0,1
19607_0,,,,2,1,2,3
19609_0,,,,2,1,2,3
C(C(CO)C(C(C=O)=O)O)(O)=O,,,5,1,7,0,7
19610_0,,,,2,1,2,3
19612_0,,,,2,1,2,3
C(C(C(C)O)=O)(C(CO)(C)O)=O,,,5,1,1,0,1
19614_0,,,,2,1,2,3
C(C(C(C(CO)(C)O)=O)=O)(O)=O,,,5,1,2,0,2
19615_0,,,,2,1,2,3
19616_0,,,,2,1,2,3
19618_0,,,,2,1,2,3
C(CO)(C(C(C=O)=O)(CO)O)=O,,,5,1,4,0,4
19620_0,,,,2,1,2,3
C(C(C(C(C(C)O)=O)=O)(C)O)=O,,,5,1,1,0,1
19622_0,,,,2,1,2,3
C(C(C(C(C(O)=O)=O)=O)(C)O)=O,,,5,1,1,0,1
19624_0,,,,2,1,2,3
C(C)(C(C(C(C(C)O)=O)=O)O)=O,,,5,1,2,0,2
19626_0,,,,2,1,2,3
C(C)(C(C(C(C(O)=O)=O)=O)O)=O,,,5,1,3,0,3
19628_0,,,,2,1,2,3
C(C)(C(C(C=O)=O)(C(C)O)O)=O,,,5,1,5,0,5
19629_0,,,,2,1,2,3
19631_0,,,,2,1,2,3
C(C(C(C)=O)(C(C=O)=O)O)(O)=O,,,5,1,5,0,5
19633_0,,,,2,1,2,3
C(C)(C(C(C=O)=O)(CO)O)=O,,,5,1,4,0,4
19635_0,,,,2,1,2,3
C(C)(C(C(C(C)=O)=O)(CO)O)=O,,,5,1,3,0,3
19637_0,,,,2,1,2,3
C(C(C(C(C(C)O)=O)=O)O)=CC,,,5,1,1,0,1
19639_0,,,,2,1,2,3
C(CC(C(C(C(C)O)=O)=O)O)=C,,,5,1,1,0,1
19640_0,,,,2,1,2,3
19641_0,,,,2,1,2,3
19642_0,,,,2,1,2,3
19643_0,,,,2,1,2,3
19645_0,,,,2,1,2,3
C(C(C(C)O)=O)(C(C)O)=O,,,5,1,1,0,1
19647_0,,,,2,1,2,3
C(C(C(C(C)O)=O)=O)(O)=O,,,5,1,2,0,2
19649_0,,,,2,1,2,3
C(C(C(C(C(O)=O)=O)=O)O)=CC,,,5,1,1,0,1
19651_0,,,,2,1,2,3
C=CCC(C(C(C(O)=O)=O)=O)O,,,5,1,1,0,1
19652_0,,,,2,1,2,3
19653_0,,,,2,1,2,3
19654_0,,,,2,1,2,3
19655_0,,,,2,1,2,3
19657_0,,,,2,1,2,3
C(C(C(C(O)=O)=O)=O)(O)=O,,,5,1,2,0,2
19659_0,,,,2,1,2,3
C(C)(C(C(O)=O)(C(C=O)=O)C)=O,,,5,1,2,0,2
19661_0,,,,2,1,2,3
C(C(C(C(CO)=O)=O)O)=CC,,,5,1,2,0,2
19663_0,,,,2,1,2,3
C=CCC(C(C(CO)=O)=O)O,,,5,1,2,0,2
19664_0,,,,2,1,2,3
19665_0,,,,2,1,2,3
19666_0,,,,2,1,2,3
19667_0,,,,2,1,2,3
19669_0,,,,2,1,2,3
C(C(C(C(CO)C(C)O)O)=O)=O,,,5,1,2,0,2
19671_0,,,,2,1,2,3
C(C(C(C=O)=O)(C(CO)O)O)=O,,,5,1,2,0,2
19673_0,,,,2,1,2,3
C(C(C)(CC(C(C=O)=O)O)O)=O,,,5,1,2,0,2
19675_0,,,,2,1,2,3
C(CC(C(C)=O)(C(C=O)=O)O)=O,,,5,1,2,0,2
19677_0,,,,2,1,2,3
C(C)(C(CC(C(C=O)=O)O)O)=O,,,5,1,2,0,2
19679_0,,,,2,1,2,3
C(C(C(C(C)=O)=O)(CCO)O)=O,,,5,1,1,0,1
19681_0,,,,2,1,2,3
C(C(C(C=O)=O)(CCO)O)=O,,,5,1,2,0,2
19683_0,,,,2,1,2,3
C(C(C(C=O)=O)(CC(C)O)O)=O,,,5,1,2,0,2
19685_0,,,,2,1,2,3
C(C(C(C=O)=O)(CC(O)=O)O)=O,,,5,1,2,0,2
19687_0,,,,2,1,2,3
C(C(C)=O)(C(CCO)O)=O,,,5,1,2,0,2
19689_0,,,,2,1,2,3
C(C(C(CCO)O)=O)=O,,,5,1,3,0,3
19690_0,,,,2,1,2,3
19692_0,,,,2,1,2,3
C(C(C(C=O)=O)(CCO)O)(O)=O,,,5,1,2,0,2
19693_0,,,,2,1,2,3
19695_0,,,,2,1,2,3
C(CC=O)(C(C(C=O)=O)(C)O)=O,,,5,1,2,0,2
19696_0,,,,2,1,2,3
19698_0,,,,2,1,2,3
C(C(C(C(C(C)=O)=O)(C)O)=O)=O,,,5,1,2,0,2
19700_0,,,,2,1,2,3
C(C(C)O)(C(C(C=O)=O)(C)O)=O,,,5,1,2,0,2
19702_0,,,,2,1,2,3
C(C(C(C(C(C)=O)=O)=O)(C)O)=O,,,5,1,1,0,1
19704_0,,,,2,1,2,3
C(C(C(C(C=O)=O)(C)O)=O)(O)=O,,,5,1,2,0,2
19706_0,,,,2,1,2,3
C(C(C)=O)(CC(C(CO)=O)=O)=O,,,5,1,1,0,1
19707_0,,,,2,1,2,3
19708_0,,,,2,1,2,3
19710_0,,,,2,1,2,3
C(C(C)C(C(C=O)=O)(C)O)(O)=O,,,5,1,2,0,2
19712_0,,,,2,1,2,3
C(C(C(C(C)=O)=O)O)=CC,,,5,1,3,0,3
19714_0,,,,2,1,2,3
C(C(C(C=O)=O)O)=CC,,,5,1,3,0,3
19716_0,,,,2,1,2,3
C=CCC(C(C(C)=O)=O)O,,,5,1,3,0,3
19718_0,,,,2,1,2,3
C=CCC(C(C=O)=O)O,,,5,1,3,0,3
19720_0,,,,2,1,2,3
C(C(C(C(C=CC)=O)=O)(C)O)=O,,,5,1,1,0,1
19722_0,,,,2,1,2,3
C(C(C=CC)(C(C=O)=O)O)(O)=O,,,5,1,2,0,2
19724_0,,,,2,1,2,3
C(C(C(C(C=CC)=O)=O)O)(O)=O,,,5,1,1,0,1
19726_0,,,,2,1,2,3
C(C(C(C(CC=C)=O)=O)(C)O)=O,,,5,1,1,0,1
19728_0,,,,2,1,2,3
C(C(C(C=O)=O)(CC=C)O)(O)=O,,,5,1,2,0,2
19730_0,,,,2,1,2,3
C(C(C(C(CC=C)=O)=O)O)(O)=O,,,5,1,1,0,1
19732_0,,,,2,1,2,3
C=C(C(O)=O)CC(C(C=O)=O)O,,,5,1,2,0,2
19734_0,,,,2,1,2,3
C(C(C(C=O)=O)O)=C(C(O)=O)C,,,5,1,2,0,2
19736_0,,,,2,1,2,3
C(C(C)=CC(C(CO)=O)=O)(O)=O,,,5,1,1,0,1
19738_0,,,,2,1,2,3
C=C(C(O)=O)CC(C(CO)=O)=O,,,5,1,1,0,1
19739_0,,,,2,1,2,3
19740_0,,,,2,1,2,3
19741_0,,,,2,1,2,3
19742_0,,,,2,1,2,3
19744_0,,,,2,1,2,3
C1(C(C(C=O)=O)(CC(C)O1)O)=O,,,5,1,2,0,2
19746_0,,,,2,1,2,3
C1(C(C(C=O)=O)(CC(O1)=O)O)=O,,,5,1,2,0,2
19748_0,,,,2,1,2,3
[CH](C(O)=O)CC(C(C(C)O)=O)=O,,,5,1,1,0,1
19750_0,,,,2,1,2,3
C([CH]CC(C(C(O)=O)=O)=O)(O)=O,,,5,1,1,0,1
19752_0,,,,2,1,2,3
C(CCC(C(C(C)O)=O)=O)(O)=O,,,5,1,1,0,1
19753_0,,,,2,1,2,3
19755_0,,,,2,1,2,3
[CH](C(O)=O)CCC(C(C=O)=O)O,,,5,1,3,0,3
19757_0,,,,2,1,2,3
C([CH]CCC(C(CO)=O)=O)(O)=O,,,5,1,3,0,3
19759_0,,,,2,1,2,3
C(CCCC(C(C=O)=O)O)(O)=O,,,5,1,3,0,3
19761_0,,,,2,1,2,3
C(CCCC(C(CO)=O)=O)(O)=O,,,5,1,3,0,3
19762_0,,,,2,1,2,3
19763_0,,,,2,1,2,3
19764_0,,,,2,1,2,3
19765_0,,,,2,1,2,3
19766_0,,,,2,1,2,3
19767_0,,,,2,1,2,3
19769_0,,,,2,1,2,3
C(C(COC(C(C)=O)=O)=O)=O,,,5,1,4,0,4
19770_0,,,,2,1,2,3
19772_0,,,,2,1,2,3
C=C(C(O)=O)C(C=O)=O,,,5,1,6,0,6
19774_0,,,,2,1,2,3
C(C(C=O)C(C(CO)=O)=O)=O,,,5,1,3,0,3
19776_0,,,,2,1,2,3
C(C(C=O)C(C=O)=O)=O,,,5,1,3,0,3
19778_0,,,,2,1,2,3
C(C(C=O)C(C(C)=O)=O)=O,,,5,1,3,0,3
19779_0,,,,2,1,2,3
19781_0,,,,2,1,2,3
C(C)=C(C=O)C(C(CO)=O)=O,,,5,1,2,0,2
19783_0,,,,2,1,2,3
C(C)=C(C=O)C(C(C)=O)=O,,,5,1,3,0,3
19785_0,,,,2,1,2,3
C(CC(C(C)=O)=O)=CC=O,,,5,1,2,0,2
19787_0,,,,2,1,2,3
C(CC=CC(C(C)=O)=O)=O,,,5,1,2,0,2
19789_0,,,,2,1,2,3
C=C(C=O)C(C(C)=O)=O,,,5,1,6,0,6
19791_0,,,,2,1,2,3
C(C(C)O)=CC(C(CO)=O)=O,,,5,1,2,0,2
19793_0,,,,2,1,2,3
C(C=CC(C(CO)=O)=O)(O)=O,,,5,1,2,0,2
19795_0,,,,2,1,2,3
C=C(C=O)C(C(CO)=O)=O,,,5,1,2,0,2
19797_0,,,,2,1,2,3
C(C(C)O)=CC(C=O)=O,,,5,1,3,0,3
19799_0,,,,2,1,2,3
C(C(C)O)=CC(C(C)=O)=O,,,5,1,2,0,2
19801_0,,,,2,1,2,3
C(C(C=CC(O)=O)=O)=O,,,5,1,3,0,3
19803_0,,,,2,1,2,3
C=C(C=O)C(C=O)=O,,,5,1,2,0,2
19804_0,,,,2,1,2,3
19806_0,,,,2,1,2,3
C=C1C(OCC(C1=O)=O)=O,,,5,1,3,0,3
19807_0,,,,2,1,2,3
19808_0,,,,2,1,2,3
19809_0,,,,2,1,2,3
19810_0,,,,2,1,2,3
19812_0,,,,2,1,2,3
C(C(C)=O)(C(CO)(C(C)O)O)=O,,,5,1,4,0,4
19813_0,,,,2,1,2,3
19814_0,,,,2,1,2,3
19815_0,,,,2,1,2,3
19816_0,,,,2,1,2,3
19817_0,,,,2,1,2,3
19818_0,,,,2,1,2,3
19820_0,,,,2,1,2,3
[CH](C(O)=O)C(C(C(C)=O)=O)O,,,5,1,2,0,2
19822_0,,,,2,1,2,3
C(C(C)C(C(C=O)=O)O)(O)=O,,,5,1,2,0,2
19824_0,,,,2,1,2,3
C(C(CO)CC(C=O)=O)(O)=O,,,5,1,4,0,4
19826_0,,,,2,1,2,3
C1(C(COC(C1C(C)O)O)=O)=O,,,5,1,2,0,2
19828_0,,,,2,1,2,3
C(C1C(C(COC1O)=O)=O)(O)=O,,,5,1,2,0,2
19829_0,,,,2,1,2,3
19830_0,,,,2,1,2,3
19832_0,,,,2,1,2,3
C(C1(C(C(C(CO1)=O)=O)O)O)=O,,,5,1,2,0,2
19834_0,,,,2,1,2,3
C(C1(CC(C(CO1)=O)=O)O)=O,,,5,1,3,0,3
19835_0,,,,2,1,2,3
19837_0,,,,2,1,2,3
C1(C(COC(C1)O)=O)=O,,,5,1,2,0,2
19838_0,,,,2,1,2,3
19840_0,,,,2,1,2,3
C(C1(CC(C(CO1)=O)=O)O)(O)=O,,,5,1,3,0,3
19841_0,,,,2,1,2,3
19842_0,,,,2,1,2,3
19844_0,,,,2,1,2,3
C1(C(C(COC1(C)O)=O)=O)=O,,,5,1,2,0,2
19846_0,,,,2,1,2,3
C1(C(COC(CO)(C1O)O)=O)=O,,,5,1,2,0,2
19848_0,,,,2,1,2,3
C1(C(COC(C1(CO)O)O)=O)=O,,,5,1,2,0,2
19850_0,,,,2,1,2,3
C1(C(COC(C1(C)O)O)=O)=O,,,5,1,2,0,2
19852_0,,,,2,1,2,3
C1(C(COC(C)(C1O)O)=O)=O,,,5,1,2,0,2
19853_0,,,,2,1,2,3
19854_0,,,,2,1,2,3
19855_0,,,,2,1,2,3
19856_0,,,,2,1,2,3
19858_0,,,,2,1,2,3
C1(C(CC(O)OC(C)C1)=O)=O,,,5,1,2,0,2
19859_0,,,,2,1,2,3
19860_0,,,,2,1,2,3
19862_0,,,,2,1,2,3
C1(CC(C(CC(O)O1)=O)=O)=O,,,5,1,2,0,2
19863_0,,,,2,1,2,3
19864_0,,,,2,1,2,3
19866_0,,,,2,1,2,3
C1(C(O)OCC(C(C1O)=O)=O)=O,,,5,1,2,0,2
19868_0,,,,2,1,2,3
C1(C(O)OCC(C(C1)=O)=O)=O,,,5,1,3,0,3
19869_0,,,,2,1,2,3
19870_0,,,,2,1,2,3
19871_0,,,,2,1,2,3
19872_0,,,,2,1,2,3
19873_0,,,,2,1,2,3
19875_0,,,,2,1,2,3
C1(C(CCOC(C(C1)=O)=O)=O)=O,,,5,1,1,0,1
19877_0,,,,2,1,2,3
C(C1C(OCC(C1=O)=O)=O)=O,,,5,1,2,0,2
19878_0,,,,2,1,2,3
19880_0,,,,2,1,2,3
C1(C(C(C(CO1)=O)=O)O)=O,,,5,1,2,0,2
19881_0,,,,2,1,2,3
19882_0,,,,2,1,2,3
19884_0,,,,2,1,2,3
C1(C(OCC(C(C1)=O)=O)=O)=O,,,5,1,3,0,3
19886_0,,,,2,1,2,3
C1(CC(C(C(CO1)=O)=O)O)=O,,,5,1,2,0,2
19888_0,,,,2,1,2,3
[CH]1C(OCC(C(C1)=O)=O)=O,,,5,1,2,0,2
19890_0,,,,2,1,2,3
C1(CCC(C(CO1)=O)=O)=O,,,5,1,2,0,2
19892_0,,,,2,1,2,3
C(CC(C(C(C=O)=O)=O)C)=O,,,5,1,1,0,1
19893_0,,,,2,1,2,3
19894_0,,,,2,1,2,3
19896_0,,,,2,1,2,3
C(C(C(C(C)=O)=O)CCO)(O)=O,,,5,1,3,0,3
19897_0,,,,2,1,2,3
19898_0,,,,2,1,2,3
19899_0,,,,2,1,2,3
19900_0,,,,2,1,2,3
19902_0,,,,2,1,2,3
C(C(C)C(C(C=O)=O)CO)(O)=O,,,5,1,2,0,2
19904_0,,,,2,1,2,3
C(C(CCO)CC(C=O)=O)(O)=O,,,5,1,2,0,2
19906_0,,,,2,1,2,3
C(CC(C)CC(C(CO)=O)=O)=O,,,5,1,2,0,2
19908_0,,,,2,1,2,3
C(CC(C)C(C(C(C)=O)=O)O)=O,,,5,1,2,0,2
19910_0,,,,2,1,2,3
C([CH]CC(C(C(C)=O)=O)O)(O)=O,,,5,1,2,0,2
19912_0,,,,2,1,2,3
C(CCC(C(C(C)=O)=O)O)(O)=O,,,5,1,2,0,2
19914_0,,,,2,1,2,3
C(CC(C)CC(C(C=O)=O)O)=O,,,5,1,2,0,2
19916_0,,,,2,1,2,3
C(CC(C)C(C(C=O)=O)(C)O)=O,,,5,1,2,0,2
19918_0,,,,2,1,2,3
[CH](C(O)=O)CC(C(C=O)=O)(C)O,,,5,1,2,0,2
19920_0,,,,2,1,2,3
C(CCC(C(C=O)=O)(C)O)(O)=O,,,5,1,2,0,2
19922_0,,,,2,1,2,3
C(CC(C(C(C(C)O)=O)=O)C)=O,,,5,1,1,0,1
19924_0,,,,2,1,2,3
C(CC(C(C(C(O)=O)=O)=O)C)=O,,,5,1,1,0,1
19926_0,,,,2,1,2,3
C(CC(C)CC(C(C=O)=O)=O)=O,,,5,1,3,0,3
19928_0,,,,2,1,2,3
C(C(C(CC[CH]C(O)=O)=O)=O)=O,,,5,1,3,0,3
19930_0,,,,2,1,2,3
C(CCCC(C(C=O)=O)=O)(O)=O,,,5,1,3,0,3
19932_0,,,,2,1,2,3
C(CC(C)CC(C(C=C)=O)=O)=O,,,5,1,3,0,3
19933_0,,,,2,1,2,3
19935_0,,,,2,1,2,3
C(CC(C(C(CO)=O)=O)C)=O,,,5,1,1,0,1
19936_0,,,,2,1,2,3
19938_0,,,,2,1,2,3
C(CC(C(C(C)=O)=O)C)=O,,,5,1,2,0,2
19940_0,,,,2,1,2,3
C(CC(C(C=O)=O)C)=O,,,5,1,2,0,2
19942_0,,,,2,1,2,3
C(C=O)(C(C)CC(C(O)=O)=O)=O,,,5,1,2,0,2
19944_0,,,,2,1,2,3
C(CC(C(O)=O)CC(C=O)=O)=O,,,5,1,2,0,2
19946_0,,,,2,1,2,3
C(CC(C(O)=O)(C(C=O)=O)C)=O,,,5,1,2,0,2
19948_0,,,,2,1,2,3
C(C(C(C=O)=O)C(C(O)=O)C)=O,,,5,1,2,0,2
19950_0,,,,2,1,2,3
C(C(C(C)O)CC(C=O)=O)(O)=O,,,5,1,3,0,3
19952_0,,,,2,1,2,3
C=CC(C(CC[CH]C(O)=O)=O)=O,,,5,1,3,0,3
19954_0,,,,2,1,2,3
C(CCCC(C(C=C)=O)=O)(O)=O,,,5,1,3,0,3
19956_0,,,,2,1,2,3
C(C(C(O)=O)CC(C=O)=O)(O)=O,,,5,1,4,0,4
19957_0,,,,2,1,2,3
19959_0,,,,2,1,2,3
C(C([C](C(O)=O)O)=O)=O,,,5,1,2,0,2
19960_0,,,,2,1,2,3
19961_0,,,,2,1,2,3
19962_0,,,,2,1,2,3
19964_0,,,,2,1,2,3
C(C(C(C(C)=O)=O)=O)(O)=O,,,5,1,2,0,2
19965_0,,,,2,1,2,3
19966_0,,,,2,1,2,3
19967_0,,,,2,1,2,3
19968_0,,,,2,1,1,2
19968_1,,,,2,1,1,2
19969_0,,,,2,1,1,2
19970_0,,,,2,1,1,2
19970_1,,,,2,1,1,2
19971_0,,,,2,1,1,2
19972_0,,,,2,1,1,2
19973_0,,,,2,1,2,3
19973_1,,,,2,1,2,3
19974_0,,,,2,1,1,2
19974_1,,,,2,1,1,2
19975_0,,,,2,1,1,2
19975_1,,,,2,1,1,2
19976_0,,,,2,1,1,2
19976_1,,,,2,1,1,2
19976_2,,,,2,1,1,2
19977_0,,,,2,1,1,2
19977_1,,,,2,1,1,2
19977_2,,,,2,1,1,2
19978_0,,,,2,1,1,2
19978_1,,,,2,1,1,2
19979_0,,,,2,1,1,2
19979_1,,,,2,1,1,2
19981_0,,,,2,1,1,2
C(C(CC(C(C=O)=O)O)O)=O,,,5,1,2,0,2
19981_1,,,,2,1,1,2
19982_0,,,,2,1,1,2
19982_1,,,,2,1,1,2
19983_0,,,,2,1,1,2
19984_0,,,,2,1,1,2
19984_1,,,,2,1,1,2
19985_0,,,,2,1,1,2
19985_1,,,,2,1,1,2
19986_0,,,,2,1,1,2
19986_1,,,,2,1,1,2
19987_0,,,,2,1,1,2
19987_1,,,,2,1,1,2
19988_0,,,,2,1,1,2
19988_1,,,,2,1,1,2
19989_0,,,,2,1,1,2
19989_1,,,,2,1,1,2
19990_0,,,,2,1,1,2
19991_0,,,,2,1,1,2
19991_1,,,,2,1,1,2
19992_0,,,,2,1,1,2
19992_1,,,,2,1,1,2
19993_0,,,,2,1,1,2
19994_0,,,,2,1,1,2
19995_0,,,,2,1,1,2
19996_0,,,,2,1,1,2
19996_1,,,,2,1,1,2
19997_0,,,,2,1,1,2
19998_0,,,,2,1,1,2
19999_0,,,,2,1,1,2
20000_0,,,,2,1,1,2
20001_0,,,,2,1,2,3
20001_1,,,,2,1,2,3
20002_0,,,,2,1,2,3
20002_1,,,,2,1,2,3
20003_0,,,,2,1,2,3
20003_1,,,,2,1,2,3
20004_0,,,,2,1,2,3
20005_0,,,,2,1,2,3
20005_1,,,,2,1,2,3
20006_0,,,,2,1,2,3
20006_1,,,,2,1,2,3
20007_0,,,,2,1,2,3
20007_1,,,,2,1,2,3
20008_0,,,,2,1,2,3
20008_1,,,,2,1,2,3
20009_0,,,,2,1,2,3
20009_1,,,,2,1,2,3
20010_0,,,,2,1,2,3
20010_1,,,,2,1,2,3
20011_0,,,,2,1,2,3
20012_0,,,,2,1,2,3
20012_1,,,,2,1,2,3
20013_0,,,,2,1,2,3
20013_1,,,,2,1,2,3
20014_0,,,,2,1,2,3
20014_1,,,,2,1,2,3
20015_0,,,,2,1,2,3
20015_1,,,,2,1,2,3
20016_0,,,,2,1,2,3
20017_0,,,,2,1,2,3
20017_1,,,,2,1,2,3
20018_0,,,,2,1,2,3
20019_0,,,,2,1,2,3
20019_1,,,,2,1,2,3
20020_0,,,,2,1,2,3
20021_0,,,,2,1,2,3
20022_0,,,,2,1,2,3
20022_1,,,,2,1,2,3
20023_0,,,,2,1,2,3
20024_0,,,,2,1,2,3
20024_1,,,,2,1,2,3
20025_0,,,,2,1,2,3
20026_0,,,,2,1,2,3
20026_1,,,,2,1,2,3
20027_0,,,,2,1,2,3
20027_1,,,,2,1,2,3
20028_0,,,,2,1,2,3
20028_1,,,,2,1,2,3
20029_0,,,,2,1,2,3
20030_0,,,,2,1,2,3
20030_1,,,,2,1,2,3
20031_0,,,,2,1,2,3
20031_1,,,,2,1,2,3
20032_0,,,,2,1,2,3
20032_1,,,,2,1,2,3
20033_0,,,,2,1,2,3
20033_1,,,,2,1,2,3
20034_0,,,,2,1,2,3
20034_1,,,,2,1,2,3
20035_0,,,,2,1,2,3
20035_1,,,,2,1,2,3
20036_0,,,,2,1,2,3
20037_0,,,,2,1,2,3
20037_1,,,,2,1,2,3
20038_0,,,,2,1,2,3
20038_1,,,,2,1,2,3
20039_0,,,,2,1,2,3
20039_1,,,,2,1,2,3
20040_0,,,,2,1,2,3
20040_1,,,,2,1,2,3
20041_0,,,,2,1,2,3
20042_0,,,,2,1,2,3
20042_1,,,,2,1,2,3
20043_0,,,,2,1,2,3
20044_0,,,,2,1,2,3
20044_1,,,,2,1,2,3
20045_0,,,,2,1,2,3
20046_0,,,,2,1,2,3
20047_0,,,,2,1,2,3
20047_1,,,,2,1,2,3
20048_0,,,,2,1,2,3
20049_0,,,,2,1,2,3
20049_1,,,,2,1,2,3
20050_0,,,,2,1,2,3
20050_1,,,,2,1,2,3
20051_0,,,,2,1,2,3
20052_0,,,,2,1,2,3
20052_1,,,,2,1,2,3
20053_0,,,,2,1,2,3
20053_1,,,,2,1,2,3
20054_0,,,,2,1,2,3
20055_0,,,,2,1,2,3
20055_1,,,,2,1,2,3
20056_0,,,,2,1,2,3
20057_0,,,,2,1,2,3
20058_0,,,,2,1,2,3
20059_0,,,,2,1,2,3
20059_1,,,,2,1,2,3
20060_0,,,,2,1,2,3
20060_1,,,,2,1,2,3
20061_0,,,,2,1,2,3
20061_1,,,,2,1,2,3
20062_0,,,,2,1,2,3
20062_1,,,,2,1,2,3
20063_0,,,,2,1,2,3
20063_1,,,,2,1,2,3
20064_0,,,,2,1,2,3
20064_1,,,,2,1,2,3
20065_0,,,,2,1,2,3
20065_1,,,,2,1,2,3
20066_0,,,,2,1,2,3
20067_0,,,,2,1,2,3
20067_1,,,,2,1,2,3
20068_0,,,,2,1,2,3
20069_0,,,,2,1,2,3
20069_1,,,,2,1,2,3
20070_0,,,,2,1,2,3
20071_0,,,,2,1,2,3
20071_1,,,,2,1,2,3
20072_0,,,,2,1,2,3
20073_0,,,,2,1,2,3
20073_1,,,,2,1,2,3
20074_0,,,,2,1,2,3
20075_0,,,,2,1,2,3
20075_1,,,,2,1,2,3
20076_0,,,,2,1,2,3
20076_1,,,,2,1,2,3
20077_0,,,,2,1,2,3
20077_1,,,,2,1,2,3
20078_0,,,,2,1,2,3
20078_1,,,,2,1,2,3
20079_0,,,,2,1,2,3
20079_1,,,,2,1,2,3
20080_0,,,,2,1,2,3
20080_1,,,,2,1,2,3
20081_0,,,,2,1,2,3
20082_0,,,,2,1,2,3
20082_1,,,,2,1,2,3
20083_0,,,,2,1,2,3
20083_1,,,,2,1,2,3
20084_0,,,,2,1,2,3
20085_0,,,,2,1,2,3
20085_1,,,,2,1,2,3
20086_0,,,,2,1,2,3
20086_1,,,,2,1,2,3
20087_0,,,,2,1,2,3
20087_1,,,,2,1,2,3
20088_0,,,,2,1,2,3
20088_1,,,,2,1,2,3
20089_0,,,,2,1,2,3
20089_1,,,,2,1,2,3
20090_0,,,,2,1,2,3
20090_1,,,,2,1,2,3
20091_0,,,,2,1,2,3
20091_1,,,,2,1,2,3
20092_0,,,,2,1,2,3
20092_1,,,,2,1,2,3
20093_0,,,,2,1,2,3
20093_1,,,,2,1,2,3
20094_0,,,,2,1,2,3
20095_0,,,,2,1,2,3
20095_1,,,,2,1,2,3
20096_0,,,,2,1,2,3
20097_0,,,,2,1,2,3
20097_1,,,,2,1,2,3
20098_0,,,,2,1,2,3
20098_1,,,,2,1,2,3
20099_0,,,,2,1,2,3
20099_1,,,,2,1,2,3
20100_0,,,,2,1,2,3
20100_1,,,,2,1,2,3
20101_0,,,,2,1,2,3
20102_0,,,,2,1,2,3
20102_1,,,,2,1,2,3
20103_0,,,,2,1,2,3
20103_1,,,,2,1,2,3
20104_0,,,,2,1,2,3
20104_1,,,,2,1,2,3
20105_0,,,,2,1,2,3
20105_1,,,,2,1,2,3
20106_0,,,,2,1,2,3
20107_0,,,,2,1,2,3
20107_1,,,,2,1,2,3
20108_0,,,,2,1,2,3
20108_1,,,,2,1,2,3
20109_0,,,,2,1,2,3
20109_1,,,,2,1,2,3
20110_0,,,,2,1,2,3
20110_1,,,,2,1,2,3
20111_0,,,,2,1,2,3
20111_1,,,,2,1,2,3
20112_0,,,,2,1,2,3
20112_1,,,,2,1,2,3
20113_0,,,,2,1,2,3
20113_1,,,,2,1,2,3
20114_0,,,,2,1,2,3
20115_0,,,,2,1,2,3
20115_1,,,,2,1,2,3
20116_0,,,,2,1,2,3
20116_1,,,,2,1,2,3
20117_0,,,,2,1,2,3
20117_1,,,,2,1,2,3
20117_2,,,,2,1,2,3
20118_0,,,,2,1,2,3
20118_1,,,,2,1,2,3
20118_2,,,,2,1,2,3
20119_0,,,,2,1,2,3
20120_0,,,,2,1,2,3
20120_1,,,,2,1,2,3
20121_0,,,,2,1,2,3
20121_1,,,,2,1,2,3
20122_0,,,,2,1,2,3
20122_1,,,,2,1,2,3
20122_2,,,,2,1,2,3
20123_0,,,,2,1,2,3
20123_1,,,,2,1,2,3
20123_2,,,,2,1,2,3
20124_0,,,,2,1,2,3
20125_0,,,,2,1,2,3
20125_1,,,,2,1,2,3
20126_0,,,,2,1,2,3
20127_0,,,,2,1,2,3
20127_1,,,,2,1,2,3
20128_0,,,,2,1,2,3
20128_1,,,,2,1,2,3
20129_0,,,,2,1,2,3
20129_1,,,,2,1,2,3
20130_0,,,,2,1,2,3
20130_1,,,,2,1,2,3
20131_0,,,,2,1,2,3
20131_1,,,,2,1,2,3
20132_0,,,,2,1,2,3
20132_1,,,,2,1,2,3
20132_2,,,,2,1,2,3
20133_0,,,,2,1,2,3
20133_1,,,,2,1,2,3
20133_2,,,,2,1,2,3
20134_0,,,,2,1,2,3
20135_0,,,,2,1,2,3
20135_1,,,,2,1,2,3
20136_0,,,,2,1,2,3
20136_1,,,,2,1,2,3
20137_0,,,,2,1,2,3
20137_1,,,,2,1,2,3
20138_0,,,,2,1,2,3
20138_1,,,,2,1,2,3
20139_0,,,,2,1,2,3
20139_1,,,,2,1,2,3
20140_0,,,,2,1,2,3
20140_1,,,,2,1,2,3
20140_2,,,,2,1,2,3
20141_0,,,,2,1,2,3
20141_1,,,,2,1,2,3
20141_2,,,,2,1,2,3
20142_0,,,,2,1,2,3
20143_0,,,,2,1,2,3
20143_1,,,,2,1,2,3
20144_0,,,,2,1,2,3
20145_0,,,,2,1,2,3
20146_0,,,,2,1,2,3
20147_0,,,,2,1,2,3
20148_0,,,,2,1,2,3
20149_0,,,,2,1,2,3
20149_1,,,,2,1,2,3
20150_0,,,,2,1,2,3
20150_1,,,,2,1,2,3
20151_0,,,,2,1,2,3
20151_1,,,,2,1,2,3
20152_0,,,,2,1,2,3
20152_1,,,,2,1,2,3
20153_0,,,,2,1,2,3
20153_1,,,,2,1,2,3
20154_0,,,,2,1,2,3
20154_1,,,,2,1,2,3
20155_0,,,,2,1,2,3
20155_1,,,,2,1,2,3
20156_0,,,,2,1,2,3
20156_1,,,,2,1,2,3
20157_0,,,,2,1,2,3
20158_0,,,,2,1,2,3
20158_1,,,,2,1,2,3
20159_0,,,,2,1,2,3
20160_0,,,,2,1,2,3
20160_1,,,,2,1,2,3
20161_0,,,,2,1,2,3
20162_0,,,,2,1,2,3
20163_0,,,,2,1,2,3
20163_1,,,,2,1,2,3
20164_0,,,,2,1,2,3
20164_1,,,,2,1,2,3
20165_0,,,,2,1,2,3
20166_0,,,,2,1,2,3
20167_0,,,,2,1,2,3
20168_0,,,,2,1,2,3
20168_1,,,,2,1,2,3
20169_0,,,,2,1,2,3
20170_0,,,,2,1,2,3
20171_0,,,,2,1,2,3
20172_0,,,,2,1,2,3
20172_1,,,,2,1,2,3
20173_0,,,,2,1,2,3
20174_0,,,,2,1,2,3
20175_0,,,,2,1,2,3
20176_0,,,,2,1,2,3
20177_0,,,,2,1,2,3
20178_0,,,,2,1,2,3
20178_1,,,,2,1,2,3
20179_0,,,,2,1,2,3
20179_1,,,,2,1,2,3
20180_0,,,,2,1,2,3
20180_1,,,,2,1,2,3
20181_0,,,,2,1,2,3
20181_1,,,,2,1,2,3
20182_0,,,,2,1,2,3
20182_1,,,,2,1,2,3
20183_0,,,,2,1,2,3
20183_1,,,,2,1,2,3
20184_0,,,,2,1,2,3
20184_1,,,,2,1,2,3
20185_0,,,,2,1,2,3
20185_1,,,,2,1,2,3
20186_0,,,,2,1,2,3
20186_1,,,,2,1,2,3
20187_0,,,,2,1,2,3
20187_1,,,,2,1,2,3
20188_0,,,,2,1,2,3
20188_1,,,,2,1,2,3
20189_0,,,,2,1,2,3
20189_1,,,,2,1,2,3
20190_0,,,,2,1,2,3
20190_1,,,,2,1,2,3
20191_0,,,,2,1,2,3
20191_1,,,,2,1,2,3
20192_0,,,,2,1,2,3
20192_1,,,,2,1,2,3
20193_0,,,,2,1,2,3
20193_1,,,,2,1,2,3
20194_0,,,,2,1,2,3
20194_1,,,,2,1,2,3
20195_0,,,,2,1,2,3
20195_1,,,,2,1,2,3
20196_0,,,,2,1,2,3
20196_1,,,,2,1,2,3
20197_0,,,,2,1,2,3
20197_1,,,,2,1,2,3
20198_0,,,,2,1,2,3
20198_1,,,,2,1,2,3
20199_0,,,,2,1,2,3
20199_1,,,,2,1,2,3
20200_0,,,,2,1,2,3
20200_1,,,,2,1,2,3
20201_0,,,,2,1,2,3
20202_0,,,,2,1,2,3
20203_0,,,,2,1,2,3
20204_0,,,,2,1,2,3
20204_1,,,,2,1,2,3
20205_0,,,,2,1,2,3
20205_1,,,,2,1,2,3
20206_0,,,,2,1,2,3
20206_1,,,,2,1,2,3
20207_0,,,,2,1,2,3
20207_1,,,,2,1,2,3
20208_0,,,,2,1,2,3
20208_1,,,,2,1,2,3
20209_0,,,,2,1,2,3
20209_1,,,,2,1,2,3
20210_0,,,,2,1,2,3
20211_0,,,,2,1,2,3
20212_0,,,,2,1,2,3
20213_0,,,,2,1,2,3
20213_1,,,,2,1,2,3
20214_0,,,,2,1,2,3
20215_0,,,,2,1,2,3
20216_0,,,,2,1,2,3
20216_1,,,,2,1,2,3
20217_0,,,,2,1,2,3
20217_1,,,,2,1,2,3
20218_0,,,,2,1,2,3
20219_0,,,,2,1,2,3
20219_1,,,,2,1,2,3
20220_0,,,,2,1,2,3
20221_0,,,,2,1,2,3
20221_1,,,,2,1,2,3
20222_0,,,,2,1,2,3
20223_0,,,,2,1,2,3
20224_0,,,,2,1,2,3
20224_1,,,,2,1,2,3
20225_0,,,,2,1,2,3
20225_1,,,,2,1,2,3
20226_0,,,,2,1,2,3
20227_0,,,,2,1,2,3
20228_0,,,,2,1,2,3
20229_0,,,,2,1,2,3
20229_1,,,,2,1,2,3
20230_0,,,,2,1,2,3
20231_0,,,,2,1,2,3
20232_0,,,,2,1,2,3
20233_0,,,,2,1,2,3
20233_1,,,,2,1,2,3
20234_0,,,,2,1,2,3
20235_0,,,,2,1,2,3
20235_1,,,,2,1,2,3
20236_0,,,,2,1,2,3
20236_1,,,,2,1,2,3
20237_0,,,,2,1,2,3
20237_1,,,,2,1,2,3
20238_0,,,,2,1,2,3
20238_1,,,,2,1,2,3
20239_0,,,,2,1,2,3
20239_1,,,,2,1,2,3
20240_0,,,,2,1,2,3
20240_1,,,,2,1,2,3
20241_0,,,,2,1,2,3
20241_1,,,,2,1,2,3
20242_0,,,,2,1,2,3
20242_1,,,,2,1,2,3
20243_0,,,,2,1,2,3
20243_1,,,,2,1,2,3
20244_0,,,,2,1,2,3
20244_1,,,,2,1,2,3
20245_0,,,,2,1,2,3
20245_1,,,,2,1,2,3
20246_0,,,,2,1,2,3
20246_1,,,,2,1,2,3
20247_0,,,,2,1,2,3
20247_1,,,,2,1,2,3
20248_0,,,,2,1,2,3
20248_1,,,,2,1,2,3
20249_0,,,,2,1,2,3
20249_1,,,,2,1,2,3
20250_0,,,,2,1,2,3
20250_1,,,,2,1,2,3
20251_0,,,,2,1,2,3
20251_1,,,,2,1,2,3
20252_0,,,,2,1,2,3
20252_1,,,,2,1,2,3
20253_0,,,,2,1,2,3
20253_1,,,,2,1,2,3
20254_0,,,,2,1,2,3
20255_0,,,,2,1,2,3
20256_0,,,,2,1,2,3
20257_0,,,,2,1,2,3
20258_0,,,,2,1,2,3
20259_0,,,,2,1,2,3
20260_0,,,,2,1,2,3
20261_0,,,,2,1,2,3
20262_0,,,,2,1,2,3
20263_0,,,,2,1,2,3
20264_0,,,,2,1,2,3
20265_0,,,,2,1,2,3
20266_0,,,,2,1,2,3
20267_0,,,,2,1,2,3
20268_0,,,,2,1,2,3
20269_0,,,,2,1,2,3
20270_0,,,,2,1,2,3
20271_0,,,,2,1,2,3
20272_0,,,,2,1,2,3
20273_0,,,,2,1,2,3
20273_1,,,,2,1,2,3
20274_0,,,,2,1,2,3
20275_0,,,,2,1,2,3
20276_0,,,,2,1,2,3
20276_1,,,,2,1,2,3
20277_0,,,,2,1,2,3
20277_1,,,,2,1,2,3
20278_0,,,,2,1,2,3
20279_0,,,,2,1,2,3
20280_0,,,,2,1,2,3
20280_1,,,,2,1,2,3
20281_0,,,,2,1,2,3
20281_1,,,,2,1,2,3
20282_0,,,,2,1,2,3
20282_1,,,,2,1,2,3
20283_0,,,,2,1,2,3
20283_1,,,,2,1,2,3
20284_0,,,,2,1,2,3
20285_0,,,,2,1,2,3
20285_1,,,,2,1,2,3
20286_0,,,,2,1,2,3
20286_1,,,,2,1,2,3
20287_0,,,,2,1,2,3
20288_0,,,,2,1,2,3
20288_1,,,,2,1,2,3
20289_0,,,,2,1,2,3
20289_1,,,,2,1,2,3
20290_0,,,,2,1,2,3
20291_0,,,,2,1,2,3
20291_1,,,,2,1,2,3
20292_0,,,,2,1,2,3
20292_1,,,,2,1,2,3
20293_0,,,,2,1,2,3
20293_1,,,,2,1,2,3
20294_0,,,,2,1,2,3
20294_1,,,,2,1,2,3
20296_0,,,,2,1,2,3
C(C(C=O)(CCO)O)=O,,,5,1,1,0,1
20297_0,,,,2,1,2,3
20297_1,,,,2,1,2,3
20298_0,,,,2,1,2,3
20298_1,,,,2,1,2,3
20299_0,,,,2,1,2,3
20300_0,,,,2,1,2,3
20301_0,,,,2,1,2,3
20301_1,,,,2,1,2,3
20302_0,,,,2,1,2,3
20302_1,,,,2,1,2,3
20303_0,,,,2,1,2,3
20304_0,,,,2,1,2,3
20304_1,,,,2,1,2,3
20305_0,,,,2,1,2,3
20306_0,,,,2,1,2,3
20306_1,,,,2,1,2,3
20307_0,,,,2,1,2,3
20308_0,,,,2,1,2,3
20309_0,,,,2,1,2,3
20309_1,,,,2,1,2,3
20310_0,,,,2,1,2,3
20311_0,,,,2,1,2,3
20311_1,,,,2,1,2,3
20312_0,,,,2,1,2,3
20313_0,,,,2,1,2,3
20314_0,,,,2,1,2,3
20314_1,,,,2,1,2,3
20315_0,,,,2,1,2,3
20316_0,,,,2,1,2,3
20316_1,,,,2,1,2,3
20317_0,,,,2,1,2,3
20317_1,,,,2,1,2,3
20318_0,,,,2,1,2,3
20318_1,,,,2,1,2,3
20319_0,,,,2,1,2,3
20319_1,,,,2,1,2,3
20320_0,,,,2,1,2,3
20320_1,,,,2,1,2,3
20321_0,,,,2,1,2,3
20321_1,,,,2,1,2,3
20322_0,,,,2,1,2,3
20322_1,,,,2,1,2,3
20323_0,,,,2,1,2,3
20323_1,,,,2,1,2,3
20324_0,,,,2,1,2,3
20324_1,,,,2,1,2,3
20325_0,,,,2,1,2,3
20325_1,,,,2,1,2,3
20326_0,,,,2,1,2,3
20326_1,,,,2,1,2,3
20327_0,,,,2,1,2,3
20327_1,,,,2,1,2,3
20328_0,,,,2,1,2,3
20328_1,,,,2,1,2,3
20329_0,,,,2,1,2,3
20329_1,,,,2,1,2,3
20330_0,,,,2,1,2,3
20330_1,,,,2,1,2,3
20331_0,,,,2,1,2,3
20331_1,,,,2,1,2,3
20332_0,,,,2,1,2,3
20332_1,,,,2,1,2,3
20333_0,,,,2,1,2,3
20333_1,,,,2,1,2,3
20334_0,,,,2,1,2,3
20334_1,,,,2,1,2,3
20335_0,,,,2,1,2,3
20335_1,,,,2,1,2,3
20336_0,,,,2,1,2,3
20336_1,,,,2,1,2,3
20337_0,,,,2,1,2,3
20337_1,,,,2,1,2,3
20338_0,,,,2,1,2,3
20338_1,,,,2,1,2,3
20339_0,,,,2,1,2,3
20339_1,,,,2,1,2,3
20340_0,,,,2,1,2,3
20340_1,,,,2,1,2,3
20341_0,,,,2,1,2,3
20341_1,,,,2,1,2,3
20342_0,,,,2,1,2,3
20342_1,,,,2,1,2,3
20343_0,,,,2,1,2,3
20343_1,,,,2,1,2,3
20344_0,,,,2,1,2,3
20344_1,,,,2,1,2,3
20345_0,,,,2,1,2,3
20345_1,,,,2,1,2,3
20346_0,,,,2,1,2,3
20346_1,,,,2,1,2,3
20347_0,,,,2,1,2,3
20347_1,,,,2,1,2,3
20348_0,,,,2,1,2,3
20348_1,,,,2,1,2,3
20349_0,,,,2,1,2,3
20350_0,,,,2,1,2,3
20350_1,,,,2,1,2,3
20351_0,,,,2,1,2,3
20351_1,,,,2,1,2,3
20352_0,,,,2,1,2,3
20353_0,,,,2,1,2,3
20353_1,,,,2,1,2,3
20354_0,,,,2,1,2,3
20354_1,,,,2,1,2,3
20355_0,,,,2,1,2,3
20356_0,,,,2,1,2,3
20357_0,,,,2,1,2,3
20357_1,,,,2,1,2,3
20358_0,,,,2,1,2,3
20358_1,,,,2,1,2,3
20359_0,,,,2,1,2,3
20360_0,,,,2,1,2,3
20361_0,,,,2,1,2,3
20362_0,,,,2,1,2,3
20362_1,,,,2,1,2,3
20363_0,,,,2,1,2,3
20364_0,,,,2,1,2,3
20364_1,,,,2,1,2,3
20365_0,,,,2,1,2,3
20366_0,,,,2,1,2,3
20367_0,,,,2,1,2,3
20367_1,,,,2,1,2,3
20368_0,,,,2,1,2,3
20369_0,,,,2,1,2,3
20369_1,,,,2,1,2,3
20370_0,,,,2,1,2,3
20370_1,,,,2,1,2,3
20371_0,,,,2,1,2,3
20371_1,,,,2,1,2,3
20372_0,,,,2,1,2,3
20372_1,,,,2,1,2,3
20373_0,,,,2,1,2,3
20373_1,,,,2,1,2,3
20374_0,,,,2,1,2,3
20374_1,,,,2,1,2,3
20375_0,,,,2,1,2,3
20375_1,,,,2,1,2,3
20376_0,,,,2,1,2,3
20376_1,,,,2,1,2,3
20377_0,,,,2,1,2,3
20377_1,,,,2,1,2,3
20378_0,,,,2,1,2,3
20378_1,,,,2,1,2,3
20379_0,,,,2,1,2,3
20379_1,,,,2,1,2,3
20380_0,,,,2,1,2,3
20380_1,,,,2,1,2,3
20381_0,,,,2,1,2,3
20381_1,,,,2,1,2,3
20382_0,,,,2,1,2,3
20382_1,,,,2,1,2,3
20383_0,,,,2,1,2,3
20383_1,,,,2,1,2,3
20384_0,,,,2,1,2,3
20384_1,,,,2,1,2,3
20385_0,,,,2,1,2,3
20385_1,,,,2,1,2,3
20386_0,,,,2,1,2,3
20386_1,,,,2,1,2,3
20387_0,,,,2,1,2,3
20387_1,,,,2,1,2,3
20388_0,,,,2,1,2,3
20388_1,,,,2,1,2,3
20389_0,,,,2,1,2,3
20389_1,,,,2,1,2,3
20390_0,,,,2,1,2,3
20390_1,,,,2,1,2,3
20391_0,,,,2,1,2,3
20392_0,,,,2,1,2,3
20392_1,,,,2,1,2,3
20393_0,,,,2,1,2,3
20393_1,,,,2,1,2,3
20394_0,,,,2,1,2,3
20395_0,,,,2,1,2,3
20395_1,,,,2,1,2,3
20396_0,,,,2,1,2,3
20396_1,,,,2,1,2,3
20397_0,,,,2,1,2,3
20398_0,,,,2,1,2,3
20399_0,,,,2,1,2,3
20399_1,,,,2,1,2,3
20400_0,,,,2,1,2,3
20400_1,,,,2,1,2,3
20401_0,,,,2,1,2,3
20401_1,,,,2,1,2,3
20402_0,,,,2,1,2,3
20403_0,,,,2,1,2,3
20403_1,,,,2,1,2,3
20404_0,,,,2,1,2,3
20404_1,,,,2,1,2,3
20405_0,,,,2,1,2,3
20405_1,,,,2,1,2,3
20406_0,,,,2,1,2,3
20406_1,,,,2,1,2,3
20407_0,,,,2,1,2,3
20408_0,,,,2,1,2,3
20408_1,,,,2,1,2,3
20409_0,,,,2,1,2,3
20409_1,,,,2,1,2,3
20410_0,,,,2,1,2,3
20410_1,,,,2,1,2,3
20411_0,,,,2,1,2,3
20411_1,,,,2,1,2,3
20412_0,,,,2,1,2,3
20412_1,,,,2,1,2,3
20413_0,,,,2,1,2,3
20413_1,,,,2,1,2,3
20414_0,,,,2,1,2,3
20414_1,,,,2,1,2,3
20415_0,,,,2,1,2,3
20415_1,,,,2,1,2,3
20416_0,,,,2,1,2,3
20416_1,,,,2,1,2,3
20417_0,,,,2,1,2,3
20417_1,,,,2,1,2,3
20418_0,,,,2,1,2,3
20418_1,,,,2,1,2,3
20419_0,,,,2,1,2,3
20419_1,,,,2,1,2,3
20420_0,,,,2,1,2,3
20420_1,,,,2,1,2,3
20421_0,,,,2,1,2,3
20421_1,,,,2,1,2,3
20422_0,,,,2,1,2,3
20422_1,,,,2,1,2,3
20423_0,,,,2,1,2,3
20423_1,,,,2,1,2,3
20424_0,,,,2,1,2,3
20424_1,,,,2,1,2,3
20425_0,,,,2,1,2,3
20425_1,,,,2,1,2,3
20426_0,,,,2,1,2,3
20426_1,,,,2,1,2,3
20427_0,,,,2,1,2,3
20427_1,,,,2,1,2,3
20428_0,,,,2,1,2,3
20428_1,,,,2,1,2,3
20429_0,,,,2,1,2,3
20429_1,,,,2,1,2,3
20430_0,,,,2,1,2,3
20431_0,,,,2,1,2,3
20431_1,,,,2,1,2,3
20432_0,,,,2,1,2,3
20432_1,,,,2,1,2,3
20433_0,,,,2,1,2,3
20433_1,,,,2,1,2,3
20434_0,,,,2,1,2,3
20434_1,,,,2,1,2,3
20435_0,,,,2,1,2,3
20435_1,,,,2,1,2,3
20436_0,,,,2,1,2,3
20437_0,,,,2,1,2,3
20438_0,,,,2,1,2,3
20439_0,,,,2,1,2,3
20440_0,,,,2,1,2,3
20440_1,,,,2,1,2,3
20441_0,,,,2,1,2,3
20441_1,,,,2,1,2,3
20442_0,,,,2,1,2,3
20443_0,,,,2,1,2,3
20443_1,,,,2,1,2,3
20444_0,,,,2,1,2,3
20444_1,,,,2,1,2,3
20445_0,,,,2,1,2,3
20446_0,,,,2,1,2,3
20447_0,,,,2,1,2,3
20448_0,,,,2,1,2,3
20449_0,,,,2,1,2,3
20449_1,,,,2,1,2,3
20450_0,,,,2,1,2,3
20450_1,,,,2,1,2,3
20451_0,,,,2,1,2,3
20451_1,,,,2,1,2,3
20452_0,,,,2,1,2,3
20453_0,,,,2,1,2,3
20454_0,,,,2,1,2,3
20455_0,,,,2,1,2,3
20455_1,,,,2,1,2,3
20456_0,,,,2,1,2,3
20456_1,,,,2,1,2,3
20457_0,,,,2,1,2,3
20457_1,,,,2,1,2,3
20458_0,,,,2,1,2,3
20458_1,,,,2,1,2,3
20459_0,,,,2,1,2,3
20460_0,,,,2,1,2,3
20460_1,,,,2,1,2,3
20461_0,,,,2,1,2,3
20462_0,,,,2,1,2,3
20462_1,,,,2,1,2,3
20463_0,,,,2,1,2,3
20464_0,,,,2,1,2,3
20464_1,,,,2,1,2,3
20465_0,,,,2,1,2,3
20465_1,,,,2,1,2,3
20466_0,,,,2,1,2,3
20467_0,,,,2,1,2,3
20467_1,,,,2,1,2,3
20468_0,,,,2,1,2,3
20468_1,,,,2,1,2,3
20469_0,,,,2,1,2,3
20469_1,,,,2,1,2,3
20470_0,,,,2,1,2,3
20470_1,,,,2,1,2,3
20471_0,,,,2,1,2,3
20472_0,,,,2,1,2,3
20472_1,,,,2,1,2,3
20473_0,,,,2,1,2,3
20473_1,,,,2,1,2,3
20474_0,,,,2,1,2,3
20474_1,,,,2,1,2,3
20475_0,,,,2,1,2,3
20475_1,,,,2,1,2,3
20476_0,,,,2,1,2,3
20476_1,,,,2,1,2,3
20477_0,,,,2,1,2,3
20477_1,,,,2,1,2,3
20478_0,,,,2,1,2,3
20478_1,,,,2,1,2,3
20479_0,,,,2,1,2,3
20480_0,,,,2,1,2,3
20480_1,,,,2,1,2,3
20481_0,,,,2,1,2,3
20481_1,,,,2,1,2,3
20482_0,,,,2,1,2,3
20482_1,,,,2,1,2,3
20483_0,,,,2,1,2,3
20483_1,,,,2,1,2,3
20484_0,,,,2,1,2,3
20484_1,,,,2,1,2,3
20485_0,,,,2,1,2,3
20485_1,,,,2,1,2,3
20486_0,,,,2,1,2,3
20486_1,,,,2,1,2,3
20487_0,,,,2,1,2,3
20487_1,,,,2,1,2,3
20488_0,,,,2,1,2,3
20488_1,,,,2,1,2,3
20489_0,,,,2,1,2,3
20489_1,,,,2,1,2,3
20490_0,,,,2,1,2,3
20490_1,,,,2,1,2,3
20491_0,,,,2,1,2,3
20491_1,,,,2,1,2,3
20492_0,,,,2,1,2,3
20492_1,,,,2,1,2,3
20493_0,,,,2,1,2,3
20493_1,,,,2,1,2,3
20494_0,,,,2,1,2,3
20494_1,,,,2,1,2,3
20495_0,,,,2,1,2,3
20495_1,,,,2,1,2,3
20496_0,,,,2,1,2,3
20496_1,,,,2,1,2,3
20497_0,,,,2,1,2,3
20497_1,,,,2,1,2,3
20498_0,,,,2,1,2,3
20498_1,,,,2,1,2,3
20499_0,,,,2,1,2,3
20499_1,,,,2,1,2,3
20500_0,,,,2,1,2,3
20500_1,,,,2,1,2,3
20501_0,,,,2,1,2,3
20501_1,,,,2,1,2,3
20502_0,,,,2,1,2,3
20502_1,,,,2,1,2,3
20503_0,,,,2,1,2,3
20503_1,,,,2,1,2,3
20504_0,,,,2,1,2,3
20504_1,,,,2,1,2,3
20505_0,,,,2,1,2,3
20505_1,,,,2,1,2,3
20506_0,,,,2,1,2,3
20506_1,,,,2,1,2,3
20507_0,,,,2,1,2,3
20507_1,,,,2,1,2,3
20508_0,,,,2,1,2,3
20508_1,,,,2,1,2,3
20509_0,,,,2,1,2,3
20509_1,,,,2,1,2,3
20510_0,,,,2,1,2,3
20510_1,,,,2,1,2,3
20511_0,,,,2,1,2,3
20511_1,,,,2,1,2,3
20512_0,,,,2,1,2,3
20512_1,,,,2,1,2,3
20513_0,,,,2,1,2,3
20513_1,,,,2,1,2,3
20514_0,,,,2,1,2,3
20514_1,,,,2,1,2,3
20515_0,,,,2,1,2,3
20515_1,,,,2,1,2,3
20516_0,,,,2,1,2,3
20516_1,,,,2,1,2,3
20517_0,,,,2,1,2,3
20517_1,,,,2,1,2,3
20518_0,,,,2,1,2,3
20518_1,,,,2,1,2,3
20519_0,,,,2,1,2,3
20519_1,,,,2,1,2,3
20520_0,,,,2,1,2,3
20520_1,,,,2,1,2,3
20521_0,,,,2,1,2,3
20521_1,,,,2,1,2,3
20522_0,,,,2,1,2,3
20522_1,,,,2,1,2,3
20523_0,,,,2,1,2,3
20523_1,,,,2,1,2,3
20524_0,,,,2,1,2,3
20524_1,,,,2,1,2,3
20525_0,,,,2,1,2,3
20525_1,,,,2,1,2,3
20526_0,,,,2,1,2,3
20526_1,,,,2,1,2,3
20527_0,,,,2,1,2,3
20527_1,,,,2,1,2,3
20528_0,,,,2,1,2,3
20528_1,,,,2,1,2,3
20529_0,,,,2,1,2,3
20529_1,,,,2,1,2,3
20530_0,,,,2,1,2,3
20531_0,,,,2,1,2,3
20531_1,,,,2,1,2,3
20532_0,,,,2,1,2,3
20533_0,,,,2,1,2,3
20533_1,,,,2,1,2,3
20534_0,,,,2,1,2,3
20535_0,,,,2,1,2,3
20536_0,,,,2,1,2,3
20536_1,,,,2,1,2,3
20537_0,,,,2,1,2,3
20537_1,,,,2,1,2,3
20538_0,,,,2,1,2,3
20538_1,,,,2,1,2,3
20539_0,,,,2,1,2,3
20539_1,,,,2,1,2,3
20540_0,,,,2,1,2,3
20540_1,,,,2,1,2,3
20541_0,,,,2,1,2,3
20541_1,,,,2,1,2,3
20542_0,,,,2,1,2,3
20542_1,,,,2,1,2,3
20543_0,,,,2,1,2,3
20543_1,,,,2,1,2,3
20544_0,,,,2,1,2,3
20544_1,,,,2,1,2,3
20545_0,,,,2,1,2,3
20545_1,,,,2,1,2,3
20546_0,,,,2,1,2,3
20546_1,,,,2,1,2,3
20547_0,,,,2,1,2,3
20547_1,,,,2,1,2,3
20548_0,,,,2,1,2,3
20548_1,,,,2,1,2,3
20549_0,,,,2,1,2,3
20549_1,,,,2,1,2,3
20550_0,,,,2,1,2,3
20550_1,,,,2,1,2,3
20551_0,,,,2,1,2,3
20552_0,,,,2,1,2,3
20553_0,,,,2,1,2,3
20554_0,,,,2,1,2,3
20555_0,,,,2,1,2,3
20556_0,,,,2,1,2,3
20556_1,,,,2,1,2,3
20557_0,,,,2,1,2,3
20557_1,,,,2,1,2,3
20558_0,,,,2,1,2,3
20559_0,,,,2,1,2,3
20560_0,,,,2,1,2,3
20561_0,,,,2,1,2,3
20561_1,,,,2,1,2,3
20562_0,,,,2,1,2,3
20562_1,,,,2,1,2,3
20563_0,,,,2,1,2,3
20564_0,,,,2,1,2,3
20565_0,,,,2,1,2,3
20566_0,,,,2,1,2,3
20567_0,,,,2,1,2,3
20568_0,,,,2,1,2,3
20568_1,,,,2,1,2,3
20569_0,,,,2,1,2,3
20569_1,,,,2,1,2,3
20570_0,,,,2,1,2,3
20571_0,,,,2,1,2,3
20571_1,,,,2,1,2,3
20572_0,,,,2,1,2,3
20572_1,,,,2,1,2,3
20573_0,,,,2,1,2,3
20574_0,,,,2,1,2,3
20575_0,,,,2,1,2,3
20577_0,,,,2,1,2,3
C(CC(CO)=O)=O,,,5,1,13,0,13
20578_0,,,,2,1,2,3
20578_1,,,,2,1,2,3
20579_0,,,,2,1,2,3
20580_0,,,,2,1,2,3
20582_0,,,,2,1,2,3
C(C(C=O)C=C)=O,,,5,1,6,0,6
20583_0,,,,2,1,2,3
20583_1,,,,2,1,2,3
20584_0,,,,2,1,2,3
20585_0,,,,2,1,2,3
20586_0,,,,2,1,2,3
20587_0,,,,2,1,2,3
20588_0,,,,2,1,2,3
20589_0,,,,2,1,2,3
20589_1,,,,2,1,2,3
20590_0,,,,2,1,2,3
20590_1,,,,2,1,2,3
20591_0,,,,2,1,2,3
20591_1,,,,2,1,2,3
20592_0,,,,2,1,2,3
20592_1,,,,2,1,2,3
20593_0,,,,2,1,2,3
20593_1,,,,2,1,2,3
20594_0,,,,2,1,2,3
20594_1,,,,2,1,2,3
20595_0,,,,2,1,2,3
20595_1,,,,2,1,2,3
20596_0,,,,2,1,2,3
20596_1,,,,2,1,2,3
20597_0,,,,2,1,2,3
20597_1,,,,2,1,2,3
20598_0,,,,2,1,2,3
20598_1,,,,2,1,2,3
20599_0,,,,2,1,2,3
20599_1,,,,2,1,2,3
20600_0,,,,2,1,2,3
20600_1,,,,2,1,2,3
20601_0,,,,2,1,2,3
20602_0,,,,2,1,2,3
20603_0,,,,2,1,2,3
20604_0,,,,2,1,2,3
20605_0,,,,2,1,2,3
20606_0,,,,2,1,2,3
20607_0,,,,2,1,2,3
20608_0,,,,2,1,2,3
20609_0,,,,2,1,2,3
20609_1,,,,2,1,2,3
20610_0,,,,2,1,2,3
20611_0,,,,2,1,2,3
20612_0,,,,2,1,2,3
20613_0,,,,2,1,2,3
20613_1,,,,2,1,2,3
20614_0,,,,2,1,2,3
20614_1,,,,2,1,2,3
20614_2,,,,2,1,2,3
20615_0,,,,2,1,2,3
20615_1,,,,2,1,2,3
20615_2,,,,2,1,2,3
20616_0,,,,2,1,2,3
20617_0,,,,2,1,2,3
20617_1,,,,2,1,2,3
20618_0,,,,2,1,2,3
20618_1,,,,2,1,2,3
20619_0,,,,2,1,2,3
20619_1,,,,2,1,2,3
20619_2,,,,2,1,2,3
20620_0,,,,2,1,2,3
20620_1,,,,2,1,2,3
20620_2,,,,2,1,2,3
20621_0,,,,2,1,2,3
20622_0,,,,2,1,2,3
20622_1,,,,2,1,2,3
20623_0,,,,2,1,2,3
20623_1,,,,2,1,2,3
20624_0,,,,2,1,2,3
20624_1,,,,2,1,2,3
20625_0,,,,2,1,2,3
20626_0,,,,2,1,2,3
20627_0,,,,2,1,2,3
20627_1,,,,2,1,2,3
20628_0,,,,2,1,2,3
20629_0,,,,2,1,2,3
20630_0,,,,2,1,2,3
20630_1,,,,2,1,2,3
20631_0,,,,2,1,2,3
20632_0,,,,2,1,2,3
20633_0,,,,2,1,2,3
20633_1,,,,2,1,2,3
20634_0,,,,2,1,2,3
20635_0,,,,2,1,2,3
20636_0,,,,2,1,2,3
20636_1,,,,2,1,2,3
20637_0,,,,2,1,2,3
20638_0,,,,2,1,2,3
20639_0,,,,2,1,2,3
20639_1,,,,2,1,2,3
20640_0,,,,2,1,2,3
20640_1,,,,2,1,2,3
20640_2,,,,2,1,2,3
20641_0,,,,2,1,2,3
20641_1,,,,2,1,2,3
20641_2,,,,2,1,2,3
20642_0,,,,2,1,2,3
20643_0,,,,2,1,2,3
20643_1,,,,2,1,2,3
20644_0,,,,2,1,2,3
20644_1,,,,2,1,2,3
20645_0,,,,2,1,2,3
20645_1,,,,2,1,2,3
20645_2,,,,2,1,2,3
20646_0,,,,2,1,2,3
20647_0,,,,2,1,2,3
20648_0,,,,2,1,2,3
20649_0,,,,2,1,2,3
20649_1,,,,2,1,2,3
20650_0,,,,2,1,2,3
20650_1,,,,2,1,2,3
20651_0,,,,2,1,2,3
20651_1,,,,2,1,2,3
20652_0,,,,2,1,2,3
20653_0,,,,2,1,2,3
20653_1,,,,2,1,2,3
20654_0,,,,2,1,2,3
20654_1,,,,2,1,2,3
20655_0,,,,2,1,2,3
20656_0,,,,2,1,2,3
20656_1,,,,2,1,2,3
20657_0,,,,2,1,2,3
20657_1,,,,2,1,2,3
20658_0,,,,2,1,2,3
20659_0,,,,2,1,2,3
20659_1,,,,2,1,2,3
20660_0,,,,2,1,2,3
20660_1,,,,2,1,2,3
20661_0,,,,2,1,2,3
20662_0,,,,2,1,2,3
20662_1,,,,2,1,2,3
20663_0,,,,2,1,2,3
20663_1,,,,2,1,2,3
20664_0,,,,2,1,2,3
20665_0,,,,2,1,2,3
20666_0,,,,2,1,2,3
20666_1,,,,2,1,2,3
20667_0,,,,2,1,2,3
20667_1,,,,2,1,2,3
20668_0,,,,2,1,2,3
20668_1,,,,2,1,2,3
20668_2,,,,2,1,2,3
20669_0,,,,2,1,2,3
20669_1,,,,2,1,2,3
20669_2,,,,2,1,2,3
20670_0,,,,2,1,2,3
20671_0,,,,2,1,2,3
20671_1,,,,2,1,2,3
20672_0,,,,2,1,2,3
20672_1,,,,2,1,2,3
20673_0,,,,2,1,2,3
20673_1,,,,2,1,2,3
20673_2,,,,2,1,2,3
20674_0,,,,2,1,2,3
20674_1,,,,2,1,2,3
20674_2,,,,2,1,2,3
20675_0,,,,2,1,2,3
20676_0,,,,2,1,2,3
20676_1,,,,2,1,2,3
20677_0,,,,2,1,2,3
20678_0,,,,2,1,2,3
20678_1,,,,2,1,2,3
20679_0,,,,2,1,2,3
20680_0,,,,2,1,2,3
20680_1,,,,2,1,2,3
20682_0,,,,2,1,2,3
C(C(C)O)(C(C)O)=O,,,5,1,12,0,12
20682_1,,,,2,1,2,3
20683_0,,,,2,1,2,3
20684_0,,,,2,1,2,3
20684_1,,,,2,1,2,3
20685_0,,,,2,1,2,3
20685_1,,,,2,1,2,3
20686_0,,,,2,1,2,3
20687_0,,,,2,1,2,3
20688_0,,,,2,1,2,3
20689_0,,,,2,1,2,3
20690_0,,,,2,1,2,3
20691_0,,,,2,1,2,3
20692_0,,,,2,1,2,3
20693_0,,,,2,1,2,3
20694_0,,,,2,1,2,3
20695_0,,,,2,1,2,3
20696_0,,,,2,1,2,3
20697_0,,,,2,1,2,3
20698_0,,,,2,1,2,3
20699_0,,,,2,1,2,3
20700_0,,,,2,1,2,3
20701_0,,,,2,1,2,3
20702_0,,,,2,1,2,3
20703_0,,,,2,1,2,3
20704_0,,,,2,1,2,3
20704_1,,,,2,1,2,3
20705_0,,,,2,1,2,3
20706_0,,,,2,1,2,3
20707_0,,,,2,1,2,3
20708_0,,,,2,1,2,3
20709_0,,,,2,1,2,3
20710_0,,,,2,1,2,3
20711_0,,,,2,1,2,3
20712_0,,,,2,1,2,3
20713_0,,,,2,1,2,3
20714_0,,,,2,1,2,3
20714_1,,,,2,1,2,3
20715_0,,,,2,1,2,3
20715_1,,,,2,1,2,3
20715_2,,,,2,1,2,3
20716_0,,,,2,1,2,3
20717_0,,,,2,1,2,3
20718_0,,,,2,1,2,3
20719_0,,,,2,1,2,3
20719_1,,,,2,1,2,3
20720_0,,,,2,1,2,3
20720_1,,,,2,1,2,3
20720_2,,,,2,1,2,3
20721_0,,,,2,1,2,3
20722_0,,,,2,1,2,3
20723_0,,,,2,1,2,3
20724_0,,,,2,1,2,3
20725_0,,,,2,1,2,3
20726_0,,,,2,1,2,3
20727_0,,,,2,1,2,3
20727_1,,,,2,1,2,3
20728_0,,,,2,1,2,3
20728_1,,,,2,1,2,3
20729_0,,,,2,1,2,3
20730_0,,,,2,1,2,3
20730_1,,,,2,1,2,3
20731_0,,,,2,1,2,3
20731_1,,,,2,1,2,3
20732_0,,,,2,1,2,3
20733_0,,,,2,1,2,3
20734_0,,,,2,1,2,3
20735_0,,,,2,1,2,3
20735_1,,,,2,1,2,3
20736_0,,,,2,1,2,3
20737_0,,,,2,1,2,3
20737_1,,,,2,1,2,3
20738_0,,,,2,1,2,3
20739_0,,,,2,1,2,3
20739_1,,,,2,1,2,3
20740_0,,,,2,1,2,3
20741_0,,,,2,1,2,3
20741_1,,,,2,1,2,3
20742_0,,,,2,1,2,3
20743_0,,,,2,1,2,3
20743_1,,,,2,1,2,3
20744_0,,,,2,1,2,3
20745_0,,,,2,1,2,3
20745_1,,,,2,1,2,3
20746_0,,,,2,1,2,3
20747_0,,,,2,1,2,3
20747_1,,,,2,1,2,3
20748_0,,,,2,1,2,3
20749_0,,,,2,1,2,3
20749_1,,,,2,1,2,3
20750_0,,,,2,1,2,3
20750_1,,,,2,1,2,3
20751_0,,,,2,1,2,3
20751_1,,,,2,1,2,3
20752_0,,,,2,1,2,3
20753_0,,,,2,1,2,3
20753_1,,,,2,1,2,3
20754_0,,,,2,1,2,3
20755_0,,,,2,1,2,3
20755_1,,,,2,1,2,3
20756_0,,,,2,1,2,3
20757_0,,,,2,1,2,3
20757_1,,,,2,1,2,3
20758_0,,,,2,1,2,3
20759_0,,,,2,1,2,3
20760_0,,,,2,1,2,3
20761_0,,,,2,1,2,3
20761_1,,,,2,1,2,3
20762_0,,,,2,1,2,3
20762_1,,,,2,1,2,3
20763_0,,,,2,1,2,3
20764_0,,,,2,1,2,3
20764_1,,,,2,1,2,3
20765_0,,,,2,1,2,3
20765_1,,,,2,1,2,3
20766_0,,,,2,1,2,3
20767_0,,,,2,1,2,3
20767_1,,,,2,1,2,3
20768_0,,,,2,1,2,3
20768_1,,,,2,1,2,3
20769_0,,,,2,1,2,3
20769_1,,,,2,1,2,3
20770_0,,,,2,1,2,3
20771_0,,,,2,1,2,3
20772_0,,,,2,1,2,3
20773_0,,,,2,1,2,3
20774_0,,,,2,1,2,3
20775_0,,,,2,1,2,3
20775_1,,,,2,1,2,3
20776_0,,,,2,1,2,3
20776_1,,,,2,1,2,3
20777_0,,,,2,1,2,3
20777_1,,,,2,1,2,3
20778_0,,,,2,1,2,3
20779_0,,,,2,1,2,3
20780_0,,,,2,1,2,3
20781_0,,,,2,1,2,3
20781_1,,,,2,1,2,3
20782_0,,,,2,1,2,3
20782_1,,,,2,1,2,3
20783_0,,,,2,1,2,3
20783_1,,,,2,1,2,3
20784_0,,,,2,1,2,3
20784_1,,,,2,1,2,3
20785_0,,,,2,1,2,3
20785_1,,,,2,1,2,3
20786_0,,,,2,1,2,3
20786_1,,,,2,1,2,3
20787_0,,,,2,1,2,3
20787_1,,,,2,1,2,3
20788_0,,,,2,1,2,3
20788_1,,,,2,1,2,3
20789_0,,,,2,1,2,3
20789_1,,,,2,1,2,3
20790_0,,,,2,1,2,3
20790_1,,,,2,1,2,3
20791_0,,,,2,1,2,3
20792_0,,,,2,1,2,3
20792_1,,,,2,1,2,3
20793_0,,,,2,1,2,3
20793_1,,,,2,1,2,3
20794_0,,,,2,1,2,3
20795_0,,,,2,1,2,3
20795_1,,,,2,1,2,3
20796_0,,,,2,1,2,3
20796_1,,,,2,1,2,3
20797_0,,,,2,1,2,3
20798_0,,,,2,1,2,3
20799_0,,,,2,1,2,3
20800_0,,,,2,1,2,3
20800_1,,,,2,1,2,3
20801_0,,,,2,1,2,3
20801_1,,,,2,1,2,3
20802_0,,,,2,1,2,3
20803_0,,,,2,1,2,3
20804_0,,,,2,1,2,3
20804_1,,,,2,1,2,3
20805_0,,,,2,1,2,3
20805_1,,,,2,1,2,3
20806_0,,,,2,1,2,3
20807_0,,,,2,1,2,3
20807_1,,,,2,1,2,3
20808_0,,,,2,1,2,3
20808_1,,,,2,1,2,3
20809_0,,,,2,1,2,3
20810_0,,,,2,1,2,3
20810_1,,,,2,1,2,3
20811_0,,,,2,1,2,3
20811_1,,,,2,1,2,3
20812_0,,,,2,1,2,3
20812_1,,,,2,1,2,3
20813_0,,,,2,1,2,3
20814_0,,,,2,1,2,3
20814_1,,,,2,1,2,3
20815_0,,,,2,1,2,3
20815_1,,,,2,1,2,3
20816_0,,,,2,1,2,3
20817_0,,,,2,1,2,3
20817_1,,,,2,1,2,3
20818_0,,,,2,1,2,3
20818_1,,,,2,1,2,3
20819_0,,,,2,1,2,3
20819_1,,,,2,1,2,3
20820_0,,,,2,1,2,3
20820_1,,,,2,1,2,3
20821_0,,,,2,1,2,3
20821_1,,,,2,1,2,3
20822_0,,,,2,1,2,3
20822_1,,,,2,1,2,3
20823_0,,,,2,1,2,3
20823_1,,,,2,1,2,3
20824_0,,,,2,1,2,3
20825_0,,,,2,1,2,3
20825_1,,,,2,1,2,3
20826_0,,,,2,1,2,3
20826_1,,,,2,1,2,3
20827_0,,,,2,1,2,3
20828_0,,,,2,1,2,3
20828_1,,,,2,1,2,3
20829_0,,,,2,1,2,3
20829_1,,,,2,1,2,3
20830_0,,,,2,1,2,3
20830_1,,,,2,1,2,3
20831_0,,,,2,1,2,3
20832_0,,,,2,1,2,3
20832_1,,,,2,1,2,3
20833_0,,,,2,1,2,3
20833_1,,,,2,1,2,3
20834_0,,,,2,1,2,3
20835_0,,,,2,1,2,3
20835_1,,,,2,1,2,3
20836_0,,,,2,1,2,3
20837_0,,,,2,1,2,3
20837_1,,,,2,1,2,3
20838_0,,,,2,1,2,3
20839_0,,,,2,1,2,3
20839_1,,,,2,1,2,3
20840_0,,,,2,1,2,3
20840_1,,,,2,1,2,3
20841_0,,,,2,1,2,3
20841_1,,,,2,1,2,3
20842_0,,,,2,1,2,3
20842_1,,,,2,1,2,3
20843_0,,,,2,1,2,3
20844_0,,,,2,1,2,3
20844_1,,,,2,1,2,3
20845_0,,,,2,1,2,3
20846_0,,,,2,1,2,3
20847_0,,,,2,1,2,3
20847_1,,,,2,1,2,3
20848_0,,,,2,1,2,3
20849_0,,,,2,1,2,3
20849_1,,,,2,1,2,3
20850_0,,,,2,1,2,3
20851_0,,,,2,1,2,3
20851_1,,,,2,1,2,3
20852_0,,,,2,1,2,3
20853_0,,,,2,1,2,3
20853_1,,,,2,1,2,3
20854_0,,,,2,1,2,3
20854_1,,,,2,1,2,3
20855_0,,,,2,1,2,3
20855_1,,,,2,1,2,3
20856_0,,,,2,1,2,3
20856_1,,,,2,1,2,3
20857_0,,,,2,1,2,3
20858_0,,,,2,1,2,3
20858_1,,,,2,1,2,3
20859_0,,,,2,1,2,3
20860_0,,,,2,1,2,3
20860_1,,,,2,1,2,3
20861_0,,,,2,1,2,3
20862_0,,,,2,1,2,3
20862_1,,,,2,1,2,3
20863_0,,,,2,1,2,3
20863_1,,,,2,1,2,3
20864_0,,,,2,1,2,3
20864_1,,,,2,1,2,3
20865_0,,,,2,1,2,3
20865_1,,,,2,1,2,3
20866_0,,,,2,1,2,3
20866_1,,,,2,1,2,3
20867_0,,,,2,1,2,3
20867_1,,,,2,1,2,3
20868_0,,,,2,1,2,3
20868_1,,,,2,1,2,3
20869_0,,,,2,1,2,3
20869_1,,,,2,1,2,3
20870_0,,,,2,1,2,3
20870_1,,,,2,1,2,3
20871_0,,,,2,1,2,3
20871_1,,,,2,1,2,3
20872_0,,,,2,1,2,3
20872_1,,,,2,1,2,3
20873_0,,,,2,1,2,3
20873_1,,,,2,1,2,3
20873_2,,,,2,1,2,3
20874_0,,,,2,1,2,3
20874_1,,,,2,1,2,3
20874_2,,,,2,1,2,3
20875_0,,,,2,1,2,3
20875_1,,,,2,1,2,3
20876_0,,,,2,1,2,3
20876_1,,,,2,1,2,3
20877_0,,,,2,1,2,3
20877_1,,,,2,1,2,3
20878_0,,,,2,1,2,3
20878_1,,,,2,1,2,3
20879_0,,,,2,1,2,3
20879_1,,,,2,1,2,3
20880_0,,,,2,1,2,3
20880_1,,,,2,1,2,3
20881_0,,,,2,1,2,3
20882_0,,,,2,1,2,3
20882_1,,,,2,1,2,3
20883_0,,,,2,1,2,3
20883_1,,,,2,1,2,3
20884_0,,,,2,1,2,3
20885_0,,,,2,1,2,3
20886_0,,,,2,1,2,3
20887_0,,,,2,1,2,3
20888_0,,,,2,1,2,3
20888_1,,,,2,1,2,3
20889_0,,,,2,1,2,3
20889_1,,,,2,1,2,3
20890_0,,,,2,1,2,3
20890_1,,,,2,1,2,3
20891_0,,,,2,1,2,3
20892_0,,,,2,1,2,3
20893_0,,,,2,1,2,3
20894_0,,,,2,1,2,3
20894_1,,,,2,1,2,3
20895_0,,,,2,1,2,3
20895_1,,,,2,1,2,3
20896_0,,,,2,1,2,3
20896_1,,,,2,1,2,3
20897_0,,,,2,1,2,3
20897_1,,,,2,1,2,3
20898_0,,,,2,1,2,3
20899_0,,,,2,1,2,3
20899_1,,,,2,1,2,3
20900_0,,,,2,1,2,3
20901_0,,,,2,1,2,3
20901_1,,,,2,1,2,3
20902_0,,,,2,1,2,3
20903_0,,,,2,1,2,3
20904_0,,,,2,1,2,3
20905_0,,,,2,1,2,3
20906_0,,,,2,1,2,3
20907_0,,,,2,1,2,3
20908_0,,,,2,1,2,3
20909_0,,,,2,1,2,3
20910_0,,,,2,1,2,3
20911_0,,,,2,1,2,3
20912_0,,,,2,1,2,3
20913_0,,,,2,1,2,3
20914_0,,,,2,1,2,3
20915_0,,,,2,1,2,3
20916_0,,,,2,1,2,3
20917_0,,,,2,1,2,3
20918_0,,,,2,1,2,3
20919_0,,,,2,1,2,3
20920_0,,,,2,1,2,3
20920_1,,,,2,1,2,3
20921_0,,,,2,1,2,3
20922_0,,,,2,1,2,3
20923_0,,,,2,1,2,3
20924_0,,,,2,1,2,3
20924_1,,,,2,1,2,3
20925_0,,,,2,1,2,3
20926_0,,,,2,1,2,3
20927_0,,,,2,1,2,3
20928_0,,,,2,1,2,3
20929_0,,,,2,1,2,3
20930_0,,,,2,1,2,3
20931_0,,,,2,1,2,3
20931_1,,,,2,1,2,3
20932_0,,,,2,1,2,3
20932_1,,,,2,1,2,3
20933_0,,,,2,1,2,3
20933_1,,,,2,1,2,3
20934_0,,,,2,1,2,3
20934_1,,,,2,1,2,3
20935_0,,,,2,1,2,3
20935_1,,,,2,1,2,3
20936_0,,,,2,1,2,3
20936_1,,,,2,1,2,3
20937_0,,,,2,1,2,3
20937_1,,,,2,1,2,3
20938_0,,,,2,1,2,3
20938_1,,,,2,1,2,3
20939_0,,,,2,1,2,3
20939_1,,,,2,1,2,3
20940_0,,,,2,1,2,3
20940_1,,,,2,1,2,3
20941_0,,,,2,1,2,3
20941_1,,,,2,1,2,3
20942_0,,,,2,1,2,3
20942_1,,,,2,1,2,3
20943_0,,,,2,1,2,3
20943_1,,,,2,1,2,3
20944_0,,,,2,1,2,3
20944_1,,,,2,1,2,3
20945_0,,,,2,1,2,3
20945_1,,,,2,1,2,3
20946_0,,,,2,1,2,3
20946_1,,,,2,1,2,3
20947_0,,,,2,1,2,3
20947_1,,,,2,1,2,3
20948_0,,,,2,1,2,3
20948_1,,,,2,1,2,3
20949_0,,,,2,1,2,3
20949_1,,,,2,1,2,3
20950_0,,,,2,1,2,3
20950_1,,,,2,1,2,3
20950_2,,,,2,1,2,3
20951_0,,,,2,1,2,3
20951_1,,,,2,1,2,3
20951_2,,,,2,1,2,3
20952_0,,,,2,1,2,3
20952_1,,,,2,1,2,3
20953_0,,,,2,1,2,3
20953_1,,,,2,1,2,3
20954_0,,,,2,1,2,3
20954_1,,,,2,1,2,3
20955_0,,,,2,1,2,3
20955_1,,,,2,1,2,3
20956_0,,,,2,1,2,3
20956_1,,,,2,1,2,3
20957_0,,,,2,1,2,3
20957_1,,,,2,1,2,3
20958_0,,,,2,1,2,3
20958_1,,,,2,1,2,3
20959_0,,,,2,1,2,3
20960_0,,,,2,1,2,3
20961_0,,,,2,1,2,3
20962_0,,,,2,1,2,3
20962_1,,,,2,1,2,3
20963_0,,,,2,1,2,3
20963_1,,,,2,1,2,3
20964_0,,,,2,1,2,3
20964_1,,,,2,1,2,3
20965_0,,,,2,1,2,3
20966_0,,,,2,1,2,3
20966_1,,,,2,1,2,3
20967_0,,,,2,1,2,3
20968_0,,,,2,1,2,3
20968_1,,,,2,1,2,3
20969_0,,,,2,1,2,3
20970_0,,,,2,1,2,3
20970_1,,,,2,1,2,3
20971_0,,,,2,1,2,3
20972_0,,,,2,1,2,3
20973_0,,,,2,1,2,3
20973_1,,,,2,1,2,3
20974_0,,,,2,1,2,3
20975_0,,,,2,1,2,3
20976_0,,,,2,1,2,3
20976_1,,,,2,1,2,3
20977_0,,,,2,1,2,3
20977_1,,,,2,1,2,3
20978_0,,,,2,1,2,3
20979_0,,,,2,1,2,3
20979_1,,,,2,1,2,3
20980_0,,,,2,1,2,3
20980_1,,,,2,1,2,3
20981_0,,,,2,1,2,3
20981_1,,,,2,1,2,3
20982_0,,,,2,1,2,3
20982_1,,,,2,1,2,3
20983_0,,,,2,1,2,3
20983_1,,,,2,1,2,3
20984_0,,,,2,1,2,3
20985_0,,,,2,1,2,3
20985_1,,,,2,1,2,3
20986_0,,,,2,1,2,3
20986_1,,,,2,1,2,3
20987_0,,,,2,1,2,3
20988_0,,,,2,1,2,3
20988_1,,,,2,1,2,3
20989_0,,,,2,1,2,3
20990_0,,,,2,1,2,3
20991_0,,,,2,1,2,3
20991_1,,,,2,1,2,3
20992_0,,,,2,1,2,3
20993_0,,,,2,1,2,3
20993_1,,,,2,1,2,3
20994_0,,,,2,1,2,3
20995_0,,,,2,1,2,3
20995_1,,,,2,1,2,3
20996_0,,,,2,1,2,3
20997_0,,,,2,1,2,3
20997_1,,,,2,1,2,3
20998_0,,,,2,1,2,3
20999_0,,,,2,1,2,3
20999_1,,,,2,1,2,3
21000_0,,,,2,1,2,3
21001_0,,,,2,1,2,3
21001_1,,,,2,1,2,3
21002_0,,,,2,1,2,3
21003_0,,,,2,1,2,3
21003_1,,,,2,1,2,3
21004_0,,,,2,1,2,3
21004_1,,,,2,1,2,3
21005_0,,,,2,1,2,3
21005_1,,,,2,1,2,3
21006_0,,,,2,1,2,3
21007_0,,,,2,1,2,3
21007_1,,,,2,1,2,3
21008_0,,,,2,1,2,3
21009_0,,,,2,1,2,3
21009_1,,,,2,1,2,3
21010_0,,,,2,1,2,3
21011_0,,,,2,1,2,3
21012_0,,,,2,1,2,3
21013_0,,,,2,1,2,3
21014_0,,,,2,1,2,3
21014_1,,,,2,1,2,3
21015_0,,,,2,1,2,3
21015_1,,,,2,1,2,3
21016_0,,,,2,1,2,3
21016_1,,,,2,1,2,3
21017_0,,,,2,1,2,3
21018_0,,,,2,1,2,3
21019_0,,,,2,1,2,3
21020_0,,,,2,1,2,3
21020_1,,,,2,1,2,3
21021_0,,,,2,1,2,3
21021_1,,,,2,1,2,3
21022_0,,,,2,1,2,3
21022_1,,,,2,1,2,3
21023_0,,,,2,1,2,3
21023_1,,,,2,1,2,3
21025_0,,,,2,1,2,3
C(C(C=CC)O)=O,,,5,1,3,0,3
21026_0,,,,2,1,2,3
21026_1,,,,2,1,2,3
21027_0,,,,2,1,2,3
21028_0,,,,2,1,2,3
21028_1,,,,2,1,2,3
21029_0,,,,2,1,2,3
21030_0,,,,2,1,2,3
21031_0,,,,2,1,2,3
21032_0,,,,2,1,2,3
21033_0,,,,2,1,2,3
21033_1,,,,2,1,2,3
21034_0,,,,2,1,2,3
21034_1,,,,2,1,2,3
21035_0,,,,2,1,2,3
21035_1,,,,2,1,2,3
21036_0,,,,2,1,2,3
21037_0,,,,2,1,2,3
21038_0,,,,2,1,2,3
21039_0,,,,2,1,2,3
21039_1,,,,2,1,2,3
21040_0,,,,2,1,2,3
21040_1,,,,2,1,2,3
21041_0,,,,2,1,2,3
21041_1,,,,2,1,2,3
21042_0,,,,2,1,2,3
21042_1,,,,2,1,2,3
21044_0,,,,2,1,2,3
C(C(CC=C)O)=O,,,5,1,3,0,3
21045_0,,,,2,1,2,3
21045_1,,,,2,1,2,3
21046_0,,,,2,1,2,3
21047_0,,,,2,1,2,3
21047_1,,,,2,1,2,3
21048_0,,,,2,1,2,3
21049_0,,,,2,1,2,3
21050_0,,,,2,1,2,3
21051_0,,,,2,1,2,3
21052_0,,,,2,1,2,3
21053_0,,,,2,1,2,3
21054_0,,,,2,1,2,3
21055_0,,,,2,1,2,3
21056_0,,,,2,1,2,3
21057_0,,,,2,1,2,3
21058_0,,,,2,1,2,3
21059_0,,,,2,1,2,3
21060_0,,,,2,1,2,3
21061_0,,,,2,1,2,3
21062_0,,,,2,1,2,3
21062_1,,,,2,1,2,3
21062_2,,,,2,1,2,3
21063_0,,,,2,1,2,3
21064_0,,,,2,1,2,3
21065_0,,,,2,1,2,3
21066_0,,,,2,1,2,3
21066_1,,,,2,1,2,3
21067_0,,,,2,1,2,3
21068_0,,,,2,1,2,3
21069_0,,,,2,1,2,3
21070_0,,,,2,1,2,3
21071_0,,,,2,1,2,3
21072_0,,,,2,1,2,3
21073_0,,,,2,1,2,3
21073_1,,,,2,1,2,3
21074_0,,,,2,1,2,3
21075_0,,,,2,1,2,3
21076_0,,,,2,1,2,3
21076_1,,,,2,1,2,3
21077_0,,,,2,1,2,3
21078_0,,,,2,1,2,3
21079_0,,,,2,1,2,3
21080_0,,,,2,1,2,3
21081_0,,,,2,1,2,3
21082_0,,,,2,1,2,3
21083_0,,,,2,1,2,3
21083_1,,,,2,1,2,3
21083_2,,,,2,1,2,3
21084_0,,,,2,1,2,3
21085_0,,,,2,1,2,3
21086_0,,,,2,1,2,3
21087_0,,,,2,1,2,3
21087_1,,,,2,1,2,3
21088_0,,,,2,1,2,3
21089_0,,,,2,1,2,3
21090_0,,,,2,1,2,3
21091_0,,,,2,1,2,3
21092_0,,,,2,1,2,3
21093_0,,,,2,1,2,3
21094_0,,,,2,1,2,3
21094_1,,,,2,1,2,3
21094_2,,,,2,1,2,3
21095_0,,,,2,1,2,3
21096_0,,,,2,1,2,3
21097_0,,,,2,1,2,3
21098_0,,,,2,1,2,3
21098_1,,,,2,1,2,3
21099_0,,,,2,1,2,3
21100_0,,,,2,1,2,3
21101_0,,,,2,1,2,3
21102_0,,,,2,1,2,3
21103_0,,,,2,1,2,3
21104_0,,,,2,1,2,3
21104_1,,,,2,1,2,3
21104_2,,,,2,1,2,3
21105_0,,,,2,1,2,3
21106_0,,,,2,1,2,3
21106_1,,,,2,1,2,3
21107_0,,,,2,1,2,3
21108_0,,,,2,1,2,3
21108_1,,,,2,1,2,3
21109_0,,,,2,1,2,3
21109_1,,,,2,1,2,3
21110_0,,,,2,1,2,3
21110_1,,,,2,1,2,3
21111_0,,,,2,1,2,3
21111_1,,,,2,1,2,3
21112_0,,,,2,1,2,3
21113_0,,,,2,1,2,3
21113_1,,,,2,1,2,3
21114_0,,,,2,1,2,3
21115_0,,,,2,1,2,3
21115_1,,,,2,1,2,3
21116_0,,,,2,1,2,3
21117_0,,,,2,1,2,3
21117_1,,,,2,1,2,3
21118_0,,,,2,1,1,2
21118_1,,,,2,1,1,2
21119_0,,,,2,1,1,2
21120_0,,,,2,1,2,3
21121_0,,,,2,1,2,3
21121_1,,,,2,1,2,3
21122_0,,,,2,1,2,3
21122_1,,,,2,1,2,3
21123_0,,,,2,1,2,3
21123_1,,,,2,1,2,3
21124_0,,,,2,1,2,3
21124_1,,,,2,1,2,3
21125_0,,,,2,1,2,3
21126_0,,,,2,1,2,3
21127_0,,,,2,1,2,3
21128_0,,,,2,1,2,3
21128_1,,,,2,1,2,3
21129_0,,,,2,1,2,3
21129_1,,,,2,1,2,3
21130_0,,,,2,1,2,3
21130_1,,,,2,1,2,3
21131_0,,,,2,1,2,3
21131_1,,,,2,1,2,3
21132_0,,,,2,1,2,3
21132_1,,,,2,1,2,3
21133_0,,,,2,1,2,3
21133_1,,,,2,1,2,3
21134_0,,,,2,1,2,3
21134_1,,,,2,1,2,3
21135_0,,,,2,1,2,3
21135_1,,,,2,1,2,3
21136_0,,,,2,1,2,3
21136_1,,,,2,1,2,3
21137_0,,,,2,1,2,3
21137_1,,,,2,1,2,3
21138_0,,,,2,1,2,3
21139_0,,,,2,1,2,3
21139_1,,,,2,1,2,3
21140_0,,,,2,1,2,3
21141_0,,,,2,1,2,3
21141_1,,,,2,1,2,3
21142_0,,,,2,1,2,3
21143_0,,,,2,1,2,3
21143_1,,,,2,1,2,3
21144_0,,,,2,1,2,3
21144_1,,,,2,1,2,3
21145_0,,,,2,1,2,3
21145_1,,,,2,1,2,3
21146_0,,,,2,1,2,3
21146_1,,,,2,1,2,3
21147_0,,,,2,1,2,3
21147_1,,,,2,1,2,3
21148_0,,,,2,1,2,3
21148_1,,,,2,1,2,3
21149_0,,,,2,1,2,3
21149_1,,,,2,1,2,3
21150_0,,,,2,1,2,3
21150_1,,,,2,1,2,3
21151_0,,,,2,1,2,3
21151_1,,,,2,1,2,3
21152_0,,,,2,1,2,3
21152_1,,,,2,1,2,3
21153_0,,,,2,1,2,3
21153_1,,,,2,1,2,3
21154_0,,,,2,1,2,3
21154_1,,,,2,1,2,3
21155_0,,,,2,1,2,3
21155_1,,,,2,1,2,3
21155_2,,,,2,1,2,3
21156_0,,,,2,1,2,3
21156_1,,,,2,1,2,3
21156_2,,,,2,1,2,3
21157_0,,,,2,1,2,3
21157_1,,,,2,1,2,3
21158_0,,,,2,1,2,3
21158_1,,,,2,1,2,3
21159_0,,,,2,1,2,3
21159_1,,,,2,1,2,3
21160_0,,,,2,1,2,3
21160_1,,,,2,1,2,3
21161_0,,,,2,1,2,3
21161_1,,,,2,1,2,3
21162_0,,,,2,1,2,3
21163_0,,,,2,1,2,3
21164_0,,,,2,1,2,3
21164_1,,,,2,1,2,3
21165_0,,,,2,1,2,3
21165_1,,,,2,1,2,3
21166_0,,,,2,1,2,3
21166_1,,,,2,1,2,3
21167_0,,,,2,1,2,3
21167_1,,,,2,1,2,3
21168_0,,,,2,1,2,3
21168_1,,,,2,1,2,3
21169_0,,,,2,1,2,3
21169_1,,,,2,1,2,3
21170_0,,,,2,1,2,3
21170_1,,,,2,1,2,3
21171_0,,,,2,1,2,3
21172_0,,,,2,1,2,3
21173_0,,,,2,1,2,3
21173_1,,,,2,1,2,3
21174_0,,,,2,1,2,3
21174_1,,,,2,1,2,3
21175_0,,,,2,1,2,3
21175_1,,,,2,1,2,3
21176_0,,,,2,1,2,3
21176_1,,,,2,1,2,3
21177_0,,,,2,1,2,3
21177_1,,,,2,1,2,3
21178_0,,,,2,1,2,3
21178_1,,,,2,1,2,3
21179_0,,,,2,1,2,3
21179_1,,,,2,1,2,3
21180_0,,,,2,1,2,3
21180_1,,,,2,1,2,3
21181_0,,,,2,1,2,3
21181_1,,,,2,1,2,3
21182_0,,,,2,1,2,3
21182_1,,,,2,1,2,3
21183_0,,,,2,1,2,3
21183_1,,,,2,1,2,3
21184_0,,,,2,1,2,3
21185_0,,,,2,1,2,3
21186_0,,,,2,1,2,3
21187_0,,,,2,1,2,3
21187_1,,,,2,1,2,3
21188_0,,,,2,1,2,3
21189_0,,,,2,1,2,3
21190_0,,,,2,1,2,3
21191_0,,,,2,1,2,3
21192_0,,,,2,1,2,3
21192_1,,,,2,1,2,3
21193_0,,,,2,1,2,3
21194_0,,,,2,1,2,3
21195_0,,,,2,1,2,3
21196_0,,,,2,1,2,3
21197_0,,,,2,1,2,3
21198_0,,,,2,1,2,3
21199_0,,,,2,1,2,3
21200_0,,,,2,1,2,3
21201_0,,,,2,1,2,3
21202_0,,,,2,1,2,3
21203_0,,,,2,1,2,3
21204_0,,,,2,1,2,3
21205_0,,,,2,1,2,3
21206_0,,,,2,1,2,3
21207_0,,,,2,1,2,3
21208_0,,,,2,1,2,3
21209_0,,,,2,1,2,3
21209_1,,,,2,1,2,3
21210_0,,,,2,1,2,3
21210_1,,,,2,1,2,3
21211_0,,,,2,1,2,3
21211_1,,,,2,1,2,3
21212_0,,,,2,1,2,3
21212_1,,,,2,1,2,3
21213_0,,,,2,1,2,3
21214_0,,,,2,1,2,3
21214_1,,,,2,1,2,3
21215_0,,,,2,1,2,3
21216_0,,,,2,1,2,3
21216_1,,,,2,1,2,3
21217_0,,,,2,1,2,3
21218_0,,,,2,1,2,3
21219_0,,,,2,1,2,3
21219_1,,,,2,1,2,3
21220_0,,,,2,1,2,3
21220_1,,,,2,1,2,3
21221_0,,,,2,1,2,3
21221_1,,,,2,1,2,3
21222_0,,,,2,1,2,3
21222_1,,,,2,1,2,3
21223_0,,,,2,1,2,3
21224_0,,,,2,1,2,3
21224_1,,,,2,1,2,3
21225_0,,,,2,1,2,3
21226_0,,,,2,1,2,3
21226_1,,,,2,1,2,3
21227_0,,,,2,1,2,3
21228_0,,,,2,1,2,3
21228_1,,,,2,1,2,3
21228_2,,,,2,1,2,3
21229_0,,,,2,1,2,3
21229_1,,,,2,1,2,3
21229_2,,,,2,1,2,3
21230_0,,,,2,1,2,3
21230_1,,,,2,1,2,3
21231_0,,,,2,1,2,3
21231_1,,,,2,1,2,3
21232_0,,,,2,1,2,3
21233_0,,,,2,1,2,3
21233_1,,,,2,1,2,3
21234_0,,,,2,1,2,3
21235_0,,,,2,1,2,3
21235_1,,,,2,1,2,3
21236_0,,,,2,1,2,3
21237_0,,,,2,1,2,3
21238_0,,,,2,1,2,3
21239_0,,,,2,1,2,3
21240_0,,,,2,1,2,3
21241_0,,,,2,1,2,3
21242_0,,,,2,1,2,3
21243_0,,,,2,1,2,3
21244_0,,,,2,1,2,3
21244_1,,,,2,1,2,3
21245_0,,,,2,1,2,3
21246_0,,,,2,1,2,3
21247_0,,,,2,1,2,3
21248_0,,,,2,1,2,3
21248_1,,,,2,1,2,3
21249_0,,,,2,1,2,3
21250_0,,,,2,1,2,3
21251_0,,,,2,1,2,3
21252_0,,,,2,1,2,3
21253_0,,,,2,1,2,3
21254_0,,,,2,1,2,3
21255_0,,,,2,1,2,3
21256_0,,,,2,1,2,3
21256_1,,,,2,1,2,3
21256_2,,,,2,1,2,3
21257_0,,,,2,1,2,3
21258_0,,,,2,1,2,3
21259_0,,,,2,1,2,3
21260_0,,,,2,1,2,3
21261_0,,,,2,1,2,3
21262_0,,,,2,1,2,3
21263_0,,,,2,1,2,3
21264_0,,,,2,1,2,3
21265_0,,,,2,1,2,3
21266_0,,,,2,1,2,3
21267_0,,,,2,1,2,3
21268_0,,,,2,1,2,3
21269_0,,,,2,1,2,3
21269_1,,,,2,1,2,3
21269_2,,,,2,1,2,3
21270_0,,,,2,1,2,3
21271_0,,,,2,1,2,3
21271_1,,,,2,1,2,3
21271_2,,,,2,1,2,3
21272_0,,,,2,1,2,3
21273_0,,,,2,1,2,3
21274_0,,,,2,1,2,3
21275_0,,,,2,1,2,3
21276_0,,,,2,1,2,3
21277_0,,,,2,1,2,3
21278_0,,,,2,1,2,3
21279_0,,,,2,1,2,3
21279_1,,,,2,1,2,3
21280_0,,,,2,1,2,3
21281_0,,,,2,1,2,3
21282_0,,,,2,1,2,3
21282_1,,,,2,1,2,3
21282_2,,,,2,1,2,3
21283_0,,,,2,1,2,3
21284_0,,,,2,1,2,3
21285_0,,,,2,1,2,3
21285_1,,,,2,1,2,3
21286_0,,,,2,1,2,3
21286_1,,,,2,1,2,3
21287_0,,,,2,1,2,3
21288_0,,,,2,1,2,3
21289_0,,,,2,1,2,3
21290_0,,,,2,1,2,3
21290_1,,,,2,1,2,3
21291_0,,,,2,1,2,3
21291_1,,,,2,1,2,3
21292_0,,,,2,1,2,3
21293_0,,,,2,1,2,3
21294_0,,,,2,1,2,3
21295_0,,,,2,1,2,3
21296_0,,,,2,1,2,3
21297_0,,,,2,1,2,3
21297_1,,,,2,1,2,3
21298_0,,,,2,1,2,3
21299_0,,,,2,1,1,2
21300_0,,,,2,1,2,3
21301_0,,,,2,1,2,3
21302_0,,,,2,1,2,3
21302_1,,,,2,1,2,3
21302_2,,,,2,1,2,3
21303_0,,,,2,1,2,3
21303_1,,,,2,1,2,3
21303_2,,,,2,1,2,3
21304_0,,,,2,1,2,3
21306_0,,,,2,1,2,3
C(C)(C)=O,,,5,1,5,0,5
21306_1,,,,2,1,2,3
21307_0,,,,2,1,2,3
21308_0,,,,2,1,2,3
21309_0,,,,2,1,2,3
21309_1,,,,2,1,2,3
21310_0,,,,2,1,2,3
21310_1,,,,2,1,2,3
21311_0,,,,2,1,2,3
21311_1,,,,2,1,2,3
21313_0,,,,2,1,2,3
C(CO)(C(CC(C)O)O)=O,,,5,1,4,0,4
21313_1,,,,2,1,2,3
21315_0,,,,2,1,2,3
C(C(C(CO)=O)C(C)O)=O,,,5,1,3,0,3
21315_1,,,,2,1,2,3
21316_0,,,,2,1,2,3
21316_1,,,,2,1,2,3
21317_0,,,,2,1,2,3
21317_1,,,,2,1,2,3
21318_0,,,,2,1,2,3
21318_1,,,,2,1,2,3
21320_0,,,,2,1,2,3
C(C(C=O)C(CO)=O)(O)=O,,,5,1,4,0,4
21320_1,,,,2,1,2,3
21321_0,,,,2,1,2,3
21321_1,,,,2,1,2,3
21322_0,,,,2,1,2,3
21322_1,,,,2,1,2,3
21323_0,,,,2,1,2,3
21324_0,,,,2,1,2,3
21324_1,,,,2,1,2,3
21325_0,,,,2,1,2,3
21325_1,,,,2,1,2,3
21327_0,,,,2,1,2,3
C(CO)(C(C(CO)=O)O)=O,,,5,1,4,0,4
21327_1,,,,2,1,2,3
21328_0,,,,2,1,2,3
21328_1,,,,2,1,2,3
21329_0,,,,2,1,2,3
21329_1,,,,2,1,2,3
21331_0,,,,2,1,2,3
C(C(C(C(C=O)O)=O)O)=O,,,5,1,4,0,4
21331_1,,,,2,1,2,3
21331_2,,,,2,1,2,3
21333_0,,,,2,1,2,3
C(C(C(CO)=O)(CO)O)=O,,,5,1,6,0,6
21333_1,,,,2,1,2,3
21334_0,,,,2,1,2,3
21334_1,,,,2,1,2,3
21334_2,,,,2,1,2,3
21335_0,,,,2,1,2,3
21336_0,,,,2,1,2,3
21336_1,,,,2,1,2,3
21336_2,,,,2,1,2,3
21337_0,,,,2,1,2,3
21338_0,,,,2,1,2,3
21340_0,,,,2,1,2,3
C(C(C(CO)=O)(C)O)=O,,,5,1,5,0,5
21340_1,,,,2,1,2,3
21341_0,,,,2,1,2,3
21341_1,,,,2,1,2,3
21343_0,,,,2,1,2,3
C(CO)(C(C)O)=O,,,5,1,19,0,19
21343_1,,,,2,1,2,3
21344_0,,,,2,1,2,3
21346_0,,,,2,1,2,3
C(C(C(CO)=O)(C)O)(O)=O,,,5,1,6,0,6
21346_1,,,,2,1,2,3
21347_0,,,,2,1,2,3
21347_1,,,,2,1,2,3
21348_0,,,,2,1,2,3
21348_1,,,,2,1,2,3
21348_2,,,,2,1,2,3
21349_0,,,,2,1,2,3
21351_0,,,,2,1,2,3
C(C(C(CO)=O)(CO)O)(O)=O,,,5,1,8,0,8
21351_1,,,,2,1,2,3
21352_0,,,,2,1,2,3
21352_1,,,,2,1,2,3
21352_2,,,,2,1,2,3
21353_0,,,,2,1,2,3
21354_0,,,,2,1,2,3
21354_1,,,,2,1,2,3
21355_0,,,,2,1,2,3
21355_1,,,,2,1,2,3
21356_0,,,,2,1,2,3
21357_0,,,,2,1,2,3
21357_1,,,,2,1,2,3
21358_0,,,,2,1,2,3
21360_0,,,,2,1,2,3
C(CO)(C[CH]C(O)=O)=O,,,5,1,5,0,5
21360_1,,,,2,1,2,3
21362_0,,,,2,1,2,3
C(CCC(CO)=O)(O)=O,,,5,1,6,0,6
21362_1,,,,2,1,2,3
21364_0,,,,2,1,2,3
C(C(C(CO)C(C)O)O)=O,,,5,1,4,0,4
21364_1,,,,2,1,2,3
21365_0,,,,2,1,2,3
21365_1,,,,2,1,2,3
21366_0,,,,2,1,2,3
21366_1,,,,2,1,2,3
21367_0,,,,2,1,2,3
21367_1,,,,2,1,2,3
21368_0,,,,2,1,2,3
21368_1,,,,2,1,2,3
21369_0,,,,2,1,2,3
21369_1,,,,2,1,2,3
21370_0,,,,2,1,2,3
21370_1,,,,2,1,2,3
21371_0,,,,2,1,2,3
21371_1,,,,2,1,2,3
21372_0,,,,2,1,2,3
21372_1,,,,2,1,2,3
21373_0,,,,2,1,2,3
21373_1,,,,2,1,2,3
21374_0,,,,2,1,2,3
21374_1,,,,2,1,2,3
21375_0,,,,2,1,2,3
21375_1,,,,2,1,2,3
21376_0,,,,2,1,2,3
21376_1,,,,2,1,2,3
21377_0,,,,2,1,2,3
21377_1,,,,2,1,2,3
21378_0,,,,2,1,2,3
21378_1,,,,2,1,2,3
21379_0,,,,2,1,2,3
21379_1,,,,2,1,2,3
21380_0,,,,2,1,2,3
21380_1,,,,2,1,2,3
21381_0,,,,2,1,2,3
21381_1,,,,2,1,2,3
21382_0,,,,2,1,2,3
21382_1,,,,2,1,2,3
21383_0,,,,2,1,2,3
21383_1,,,,2,1,2,3
21384_0,,,,2,1,2,3
21384_1,,,,2,1,2,3
21385_0,,,,2,1,2,3
21385_1,,,,2,1,2,3
21386_0,,,,2,1,2,3
21386_1,,,,2,1,2,3
21387_0,,,,2,1,2,3
21387_1,,,,2,1,2,3
21388_0,,,,2,1,2,3
21388_1,,,,2,1,2,3
21389_0,,,,2,1,2,3
21389_1,,,,2,1,2,3
21390_0,,,,2,1,2,3
21390_1,,,,2,1,2,3
21391_0,,,,2,1,2,3
21391_1,,,,2,1,2,3
21392_0,,,,2,1,2,3
21392_1,,,,2,1,2,3
21393_0,,,,2,1,2,3
21393_1,,,,2,1,2,3
21394_0,,,,2,1,2,3
21394_1,,,,2,1,2,3
21395_0,,,,2,1,2,3
21395_1,,,,2,1,2,3
21396_0,,,,2,1,2,3
21396_1,,,,2,1,2,3
21397_0,,,,2,1,2,3
21397_1,,,,2,1,2,3
21398_0,,,,2,1,2,3
21398_1,,,,2,1,2,3
21399_0,,,,2,1,2,3
21399_1,,,,2,1,2,3
21400_0,,,,2,1,2,3
21400_1,,,,2,1,2,3
21401_0,,,,2,1,2,3
21401_1,,,,2,1,2,3
21402_0,,,,2,1,2,3
21403_0,,,,2,1,2,3
21403_1,,,,2,1,2,3
21404_0,,,,2,1,2,3
21404_1,,,,2,1,2,3
21405_0,,,,2,1,2,3
21405_1,,,,2,1,2,3
21406_0,,,,2,1,2,3
21406_1,,,,2,1,2,3
21407_0,,,,2,1,2,3
21407_1,,,,2,1,2,3
21408_0,,,,2,1,2,3
21408_1,,,,2,1,2,3
21409_0,,,,2,1,2,3
21409_1,,,,2,1,2,3
21410_0,,,,2,1,2,3
21410_1,,,,2,1,2,3
21411_0,,,,2,1,2,3
21411_1,,,,2,1,2,3
21412_0,,,,2,1,2,3
21413_0,,,,2,1,2,3
21413_1,,,,2,1,2,3
21414_0,,,,2,1,2,3
21414_1,,,,2,1,2,3
21415_0,,,,2,1,2,3
21416_0,,,,2,1,2,3
21416_1,,,,2,1,2,3
21417_0,,,,2,1,2,3
21417_1,,,,2,1,2,3
21418_0,,,,2,1,2,3
21419_0,,,,2,1,2,3
21419_1,,,,2,1,2,3
21420_0,,,,2,1,2,3
21421_0,,,,2,1,2,3
21421_1,,,,2,1,2,3
21422_0,,,,2,1,2,3
21422_1,,,,2,1,2,3
21423_0,,,,2,1,2,3
21423_1,,,,2,1,2,3
21424_0,,,,2,1,2,3
21425_0,,,,2,1,2,3
21426_0,,,,2,1,2,3
21426_1,,,,2,1,2,3
21427_0,,,,2,1,2,3
21427_1,,,,2,1,2,3
21428_0,,,,2,1,2,3
21429_0,,,,2,1,2,3
21429_1,,,,2,1,2,3
21430_0,,,,2,1,2,3
21430_1,,,,2,1,2,3
21431_0,,,,2,1,2,3
21432_0,,,,2,1,2,3
21432_1,,,,2,1,2,3
21433_0,,,,2,1,2,3
21433_1,,,,2,1,2,3
21434_0,,,,2,1,2,3
21435_0,,,,2,1,2,3
21435_1,,,,2,1,2,3
21436_0,,,,2,1,2,3
21436_1,,,,2,1,2,3
21437_0,,,,2,1,2,3
21438_0,,,,2,1,2,3
21438_1,,,,2,1,2,3
21439_0,,,,2,1,2,3
21439_1,,,,2,1,2,3
21440_0,,,,2,1,2,3
21441_0,,,,2,1,2,3
21441_1,,,,2,1,2,3
21442_0,,,,2,1,2,3
21442_1,,,,2,1,2,3
21443_0,,,,2,1,2,3
21444_0,,,,2,1,2,3
21444_1,,,,2,1,2,3
21445_0,,,,2,1,2,3
21445_1,,,,2,1,2,3
21446_0,,,,2,1,2,3
21447_0,,,,2,1,2,3
21447_1,,,,2,1,2,3
21448_0,,,,2,1,2,3
21448_1,,,,2,1,2,3
21449_0,,,,2,1,2,3
21450_0,,,,2,1,2,3
21450_1,,,,2,1,2,3
21451_0,,,,2,1,2,3
21451_1,,,,2,1,2,3
21452_0,,,,2,1,2,3
21453_0,,,,2,1,2,3
21453_1,,,,2,1,2,3
21454_0,,,,2,1,2,3
21454_1,,,,2,1,2,3
21455_0,,,,2,1,2,3
21456_0,,,,2,1,2,3
21457_0,,,,2,1,2,3
21457_1,,,,2,1,2,3
21458_0,,,,2,1,2,3
21458_1,,,,2,1,2,3
21459_0,,,,2,1,2,3
21460_0,,,,2,1,2,3
21460_1,,,,2,1,2,3
21461_0,,,,2,1,2,3
21462_0,,,,2,1,2,3
21462_1,,,,2,1,2,3
21463_0,,,,2,1,2,3
21464_0,,,,2,1,2,3
21465_0,,,,2,1,2,3
21465_1,,,,2,1,2,3
21466_0,,,,2,1,2,3
21466_1,,,,2,1,2,3
21467_0,,,,2,1,2,3
21467_1,,,,2,1,2,3
21468_0,,,,2,1,2,3
21469_0,,,,2,1,2,3
21469_1,,,,2,1,2,3
21470_0,,,,2,1,2,3
21471_0,,,,2,1,2,3
21471_1,,,,2,1,2,3
21471_2,,,,2,1,2,3
21472_0,,,,2,1,2,3
21472_1,,,,2,1,2,3
21472_2,,,,2,1,2,3
21473_0,,,,2,1,2,3
21473_1,,,,2,1,2,3
21473_2,,,,2,1,2,3
21474_0,,,,2,1,2,3
21474_1,,,,2,1,2,3
21474_2,,,,2,1,2,3
21476_0,,,,2,1,2,3
C(C(C(C)=O)(CO)O)=O,,,5,1,4,0,4
21477_0,,,,2,1,2,3
21477_1,,,,2,1,2,3
21478_0,,,,2,1,2,3
21478_1,,,,2,1,2,3
21479_0,,,,2,1,2,3
21480_0,,,,2,1,2,3
21480_1,,,,2,1,2,3
21480_2,,,,2,1,2,3
21481_0,,,,2,1,2,3
21481_1,,,,2,1,2,3
21481_2,,,,2,1,2,3
21482_0,,,,2,1,2,3
21483_0,,,,2,1,2,3
21483_1,,,,2,1,2,3
21483_2,,,,2,1,2,3
21484_0,,,,2,1,2,3
21484_1,,,,2,1,2,3
21484_2,,,,2,1,2,3
21485_0,,,,2,1,2,3
21485_1,,,,2,1,2,3
21486_0,,,,2,1,2,3
21487_0,,,,2,1,2,3
21487_1,,,,2,1,2,3
21487_2,,,,2,1,2,3
21488_0,,,,2,1,2,3
21488_1,,,,2,1,2,3
21488_2,,,,2,1,2,3
21490_0,,,,2,1,2,3
C(CO)(C(CO)(C)O)=O,,,5,1,2,0,2
21491_0,,,,2,1,2,3
21491_1,,,,2,1,2,3
21491_2,,,,2,1,2,3
21492_0,,,,2,1,2,3
21492_1,,,,2,1,2,3
21492_2,,,,2,1,2,3
21494_0,,,,2,1,2,3
C(CO)(C(C=CC)O)=O,,,5,1,2,0,2
21495_0,,,,2,1,2,3
21495_1,,,,2,1,2,3
21495_2,,,,2,1,2,3
21496_0,,,,2,1,2,3
21496_1,,,,2,1,2,3
21496_2,,,,2,1,2,3
21498_0,,,,2,1,2,3
C(CO)(C(CC=C)O)=O,,,5,1,2,0,2
21499_0,,,,2,1,2,3
21499_1,,,,2,1,2,3
21499_2,,,,2,1,2,3
21500_0,,,,2,1,2,3
21500_1,,,,2,1,2,3
21500_2,,,,2,1,2,3
21501_0,,,,2,1,2,3
21502_0,,,,2,1,2,3
21502_1,,,,2,1,2,3
21502_2,,,,2,1,2,3
21503_0,,,,2,1,2,3
21503_1,,,,2,1,2,3
21503_2,,,,2,1,2,3
21504_0,,,,2,1,2,3
21505_0,,,,2,1,2,3
21505_1,,,,2,1,2,3
21505_2,,,,2,1,2,3
21506_0,,,,2,1,2,3
21506_1,,,,2,1,2,3
21506_2,,,,2,1,2,3
21507_0,,,,2,1,2,3
21508_0,,,,2,1,2,3
21508_1,,,,2,1,2,3
21508_2,,,,2,1,2,3
21509_0,,,,2,1,2,3
21509_1,,,,2,1,2,3
21509_2,,,,2,1,2,3
21510_0,,,,2,1,2,3
21511_0,,,,2,1,2,3
21511_1,,,,2,1,2,3
21511_2,,,,2,1,2,3
21512_0,,,,2,1,2,3
21512_1,,,,2,1,2,3
21512_2,,,,2,1,2,3
21513_0,,,,2,1,2,3
21514_0,,,,2,1,2,3
21514_1,,,,2,1,2,3
21514_2,,,,2,1,2,3
21515_0,,,,2,1,2,3
21515_1,,,,2,1,2,3
21516_0,,,,2,1,2,3
21517_0,,,,2,1,2,3
21517_1,,,,2,1,2,3
21517_2,,,,2,1,2,3
21518_0,,,,2,1,2,3
21518_1,,,,2,1,2,3
21518_2,,,,2,1,2,3
21519_0,,,,2,1,2,3
21520_0,,,,2,1,2,3
21520_1,,,,2,1,2,3
21520_2,,,,2,1,2,3
21521_0,,,,2,1,2,3
21521_1,,,,2,1,2,3
21521_2,,,,2,1,2,3
21522_0,,,,2,1,2,3
21523_0,,,,2,1,2,3
21523_1,,,,2,1,2,3
21523_2,,,,2,1,2,3
21524_0,,,,2,1,2,3
21525_0,,,,2,1,2,3
21526_0,,,,2,1,2,3
21526_1,,,,2,1,2,3
21526_2,,,,2,1,2,3
21527_0,,,,2,1,2,3
21527_1,,,,2,1,2,3
21528_0,,,,2,1,2,3
21529_0,,,,2,1,2,3
21529_1,,,,2,1,2,3
21529_2,,,,2,1,2,3
21530_0,,,,2,1,2,3
21531_0,,,,2,1,2,3
21532_0,,,,2,1,2,3
21532_1,,,,2,1,2,3
21532_2,,,,2,1,2,3
21533_0,,,,2,1,2,3
21535_0,,,,2,1,2,3
C(C(C(O)=O)=O)(O)=O,,,5,1,9,0,9
21536_0,,,,2,1,2,3
21537_0,,,,2,1,2,3
21537_1,,,,2,1,2,3
21537_2,,,,2,1,2,3
21538_0,,,,2,1,2,3
21538_1,,,,2,1,2,3
21539_0,,,,2,1,2,3
21539_1,,,,2,1,2,3
21539_2,,,,2,1,2,3
21540_0,,,,2,1,2,3
21540_1,,,,2,1,2,3
21540_2,,,,2,1,2,3
21541_0,,,,2,1,2,3
21541_1,,,,2,1,2,3
21542_0,,,,2,1,2,3
21542_1,,,,2,1,2,3
21542_2,,,,2,1,2,3
21543_0,,,,2,1,2,3
21544_0,,,,2,1,2,3
21544_1,,,,2,1,2,3
21545_0,,,,2,1,2,3
21546_0,,,,2,1,2,3
21546_1,,,,2,1,2,3
21546_2,,,,2,1,2,3
21547_0,,,,2,1,2,3
21547_1,,,,2,1,2,3
21547_2,,,,2,1,2,3
21548_0,,,,2,1,2,3
21549_0,,,,2,1,2,3
21549_1,,,,2,1,2,3
21550_0,,,,2,1,2,3
21550_1,,,,2,1,2,3
21550_2,,,,2,1,2,3
21551_0,,,,2,1,2,3
21551_1,,,,2,1,2,3
21551_2,,,,2,1,2,3
21552_0,,,,2,1,2,3
21552_1,,,,2,1,2,3
21552_2,,,,2,1,2,3
21553_0,,,,2,1,2,3
21553_1,,,,2,1,2,3
21553_2,,,,2,1,2,3
21554_0,,,,2,1,2,3
21555_0,,,,2,1,2,3
21555_1,,,,2,1,2,3
21555_2,,,,2,1,2,3
21556_0,,,,2,1,2,3
21556_1,,,,2,1,2,3
21556_2,,,,2,1,2,3
21557_0,,,,2,1,2,3
21557_1,,,,2,1,2,3
21557_2,,,,2,1,2,3
21558_0,,,,2,1,2,3
21559_0,,,,2,1,2,3
21559_1,,,,2,1,2,3
21559_2,,,,2,1,2,3
21560_0,,,,2,1,2,3
21561_0,,,,2,1,2,3
21561_1,,,,2,1,2,3
21562_0,,,,2,1,2,3
21562_1,,,,2,1,2,3
21562_2,,,,2,1,2,3
21563_0,,,,2,1,2,3
21563_1,,,,2,1,2,3
21563_2,,,,2,1,2,3
21564_0,,,,2,1,2,3
21564_1,,,,2,1,2,3
21564_2,,,,2,1,2,3
21565_0,,,,2,1,2,3
21566_0,,,,2,1,2,3
21566_1,,,,2,1,2,3
21566_2,,,,2,1,2,3
21567_0,,,,2,1,2,3
21568_0,,,,2,1,2,3
21568_1,,,,2,1,2,3
21568_2,,,,2,1,2,3
21569_0,,,,2,1,2,3
21569_1,,,,2,1,2,3
21570_0,,,,2,1,2,3
21571_0,,,,2,1,2,3
21571_1,,,,2,1,2,3
21571_2,,,,2,1,2,3
21572_0,,,,2,1,2,3
21572_1,,,,2,1,2,3
21573_0,,,,2,1,2,3
21573_1,,,,2,1,2,3
21574_0,,,,2,1,2,3
21574_1,,,,2,1,2,3
21575_0,,,,2,1,2,3
21575_1,,,,2,1,2,3
21576_0,,,,2,1,2,3
21577_0,,,,2,1,2,3
21577_1,,,,2,1,2,3
21578_0,,,,2,1,2,3
21579_0,,,,2,1,2,3
21579_1,,,,2,1,2,3
21581_0,,,,2,1,2,3
C(C(C=O)(C=O)O)=O,,,5,1,3,0,3
21581_1,,,,2,1,2,3
21582_0,,,,2,1,2,3
21582_1,,,,2,1,2,3
21582_2,,,,2,1,2,3
21583_0,,,,2,1,2,3
21583_1,,,,2,1,2,3
21583_2,,,,2,1,2,3
21584_0,,,,2,1,2,3
21584_1,,,,2,1,2,3
21584_2,,,,2,1,2,3
21585_0,,,,2,1,2,3
21585_1,,,,2,1,2,3
21585_2,,,,2,1,2,3
21586_0,,,,2,1,2,3
21586_1,,,,2,1,2,3
21586_2,,,,2,1,2,3
21587_0,,,,2,1,2,3
21587_1,,,,2,1,2,3
21587_2,,,,2,1,2,3
21588_0,,,,2,1,2,3
21588_1,,,,2,1,2,3
21588_2,,,,2,1,2,3
21589_0,,,,2,1,2,3
21589_1,,,,2,1,2,3
21589_2,,,,2,1,2,3
21590_0,,,,2,1,2,3
21590_1,,,,2,1,2,3
21590_2,,,,2,1,2,3
21591_0,,,,2,1,2,3
21591_1,,,,2,1,2,3
21591_2,,,,2,1,2,3
21592_0,,,,2,1,2,3
21592_1,,,,2,1,2,3
21592_2,,,,2,1,2,3
21593_0,,,,2,1,2,3
21594_0,,,,2,1,2,3
21594_1,,,,2,1,2,3
21594_2,,,,2,1,2,3
21595_0,,,,2,1,2,3
21595_1,,,,2,1,2,3
21595_2,,,,2,1,2,3
21596_0,,,,2,1,2,3
21596_1,,,,2,1,2,3
21597_0,,,,2,1,2,3
21597_1,,,,2,1,2,3
21597_2,,,,2,1,2,3
21598_0,,,,2,1,2,3
21598_1,,,,2,1,2,3
21598_2,,,,2,1,2,3
21599_0,,,,2,1,2,3
21599_1,,,,2,1,2,3
21599_2,,,,2,1,2,3
21600_0,,,,2,1,2,3
21600_1,,,,2,1,2,3
21600_2,,,,2,1,2,3
21601_0,,,,2,1,2,3
21601_1,,,,2,1,2,3
21602_0,,,,2,1,2,3
21602_1,,,,2,1,2,3
21602_2,,,,2,1,2,3
21603_0,,,,2,1,2,3
21603_1,,,,2,1,2,3
21604_0,,,,2,1,2,3
21604_1,,,,2,1,2,3
21604_2,,,,2,1,2,3
21605_0,,,,2,1,2,3
21605_1,,,,2,1,2,3
21605_2,,,,2,1,2,3
21606_0,,,,2,1,2,3
21606_1,,,,2,1,2,3
21606_2,,,,2,1,2,3
21607_0,,,,2,1,2,3
21608_0,,,,2,1,2,3
21608_1,,,,2,1,2,3
21608_2,,,,2,1,2,3
21609_0,,,,2,1,2,3
21609_1,,,,2,1,2,3
21610_0,,,,2,1,2,3
21610_1,,,,2,1,2,3
21610_2,,,,2,1,2,3
21611_0,,,,2,1,2,3
21611_1,,,,2,1,2,3
21611_2,,,,2,1,2,3
21612_0,,,,2,1,2,3
21612_1,,,,2,1,2,3
21613_0,,,,2,1,2,3
21613_1,,,,2,1,2,3
21613_2,,,,2,1,2,3
21614_0,,,,2,1,2,3
21615_0,,,,2,1,2,3
21615_1,,,,2,1,2,3
21615_2,,,,2,1,2,3
21616_0,,,,2,1,2,3
21617_0,,,,2,1,2,3
21617_1,,,,2,1,2,3
21617_2,,,,2,1,2,3
21618_0,,,,2,1,2,3
21619_0,,,,2,1,2,3
21619_1,,,,2,1,2,3
21619_2,,,,2,1,2,3
21620_0,,,,2,1,2,3
21621_0,,,,2,1,2,3
21621_1,,,,2,1,2,3
21621_2,,,,2,1,2,3
21622_0,,,,2,1,2,3
21623_0,,,,2,1,2,3
21623_1,,,,2,1,2,3
21623_2,,,,2,1,2,3
21624_0,,,,2,1,2,3
21625_0,,,,2,1,2,3
21625_1,,,,2,1,2,3
21625_2,,,,2,1,2,3
21626_0,,,,2,1,2,3
21627_0,,,,2,1,2,3
21627_1,,,,2,1,2,3
21627_2,,,,2,1,2,3
21628_0,,,,2,1,2,3
21629_0,,,,2,1,2,3
21629_1,,,,2,1,2,3
21629_2,,,,2,1,2,3
21630_0,,,,2,1,2,3
21631_0,,,,2,1,2,3
21632_0,,,,2,1,2,3
21632_1,,,,2,1,2,3
21632_2,,,,2,1,2,3
21633_0,,,,2,1,2,3
21634_0,,,,2,1,2,3
21634_1,,,,2,1,2,3
21634_2,,,,2,1,2,3
21635_0,,,,2,1,2,3
21636_0,,,,2,1,2,3
21636_1,,,,2,1,2,3
21637_0,,,,2,1,2,3
21637_1,,,,2,1,2,3
21637_2,,,,2,1,2,3
21638_0,,,,2,1,2,3
21639_0,,,,2,1,2,3
21639_1,,,,2,1,2,3
21639_2,,,,2,1,2,3
21640_0,,,,2,1,2,3
21640_1,,,,2,1,2,3
21640_2,,,,2,1,2,3
21641_0,,,,2,1,2,3
21641_1,,,,2,1,2,3
21641_2,,,,2,1,2,3
21642_0,,,,2,1,2,3
21643_0,,,,2,1,2,3
21643_1,,,,2,1,2,3
21644_0,,,,2,1,2,3
21644_1,,,,2,1,2,3
21644_2,,,,2,1,2,3
21645_0,,,,2,1,2,3
21646_0,,,,2,1,2,3
21646_1,,,,2,1,2,3
21647_0,,,,2,1,2,3
21647_1,,,,2,1,2,3
21647_2,,,,2,1,2,3
21648_0,,,,2,1,2,3
21649_0,,,,2,1,2,3
21649_1,,,,2,1,2,3
21649_2,,,,2,1,2,3
21650_0,,,,2,1,2,3
21651_0,,,,2,1,2,3
21651_1,,,,2,1,2,3
21651_2,,,,2,1,2,3
21652_0,,,,2,1,2,3
21652_1,,,,2,1,2,3
21652_2,,,,2,1,2,3
21653_0,,,,2,1,2,3
21654_0,,,,2,1,2,3
21654_1,,,,2,1,2,3
21655_0,,,,2,1,2,3
21655_1,,,,2,1,2,3
21655_2,,,,2,1,2,3
21656_0,,,,2,1,2,3
21656_1,,,,2,1,2,3
21656_2,,,,2,1,2,3
21657_0,,,,2,1,2,3
21657_1,,,,2,1,2,3
21657_2,,,,2,1,2,3
21658_0,,,,2,1,2,3
21658_1,,,,2,1,2,3
21658_2,,,,2,1,2,3
21659_0,,,,2,1,2,3
21659_1,,,,2,1,2,3
21660_0,,,,2,1,2,3
21660_1,,,,2,1,2,3
21661_0,,,,2,1,2,3
21661_1,,,,2,1,2,3
21662_0,,,,2,1,2,3
21662_1,,,,2,1,2,3
21663_0,,,,2,1,2,3
21663_1,,,,2,1,2,3
21663_2,,,,2,1,2,3
21664_0,,,,2,1,2,3
21664_1,,,,2,1,2,3
21664_2,,,,2,1,2,3
21665_0,,,,2,1,2,3
21666_0,,,,2,1,2,3
21666_1,,,,2,1,2,3
21666_2,,,,2,1,2,3
21667_0,,,,2,1,2,3
21667_1,,,,2,1,2,3
21667_2,,,,2,1,2,3
21668_0,,,,2,1,2,3
21668_1,,,,2,1,2,3
21668_2,,,,2,1,2,3
21669_0,,,,2,1,2,3
21669_1,,,,2,1,2,3
21669_2,,,,2,1,2,3
21670_0,,,,2,1,2,3
21670_1,,,,2,1,2,3
21670_2,,,,2,1,2,3
21671_0,,,,2,1,2,3
21671_1,,,,2,1,2,3
21672_0,,,,2,1,2,3
21672_1,,,,2,1,2,3
21673_0,,,,2,1,2,3
21674_0,,,,2,1,2,3
21674_1,,,,2,1,2,3
21675_0,,,,2,1,2,3
21675_1,,,,2,1,2,3
21676_0,,,,2,1,2,3
21677_0,,,,2,1,2,3
21678_0,,,,2,1,2,3
21678_1,,,,2,1,2,3
21679_0,,,,2,1,2,3
21679_1,,,,2,1,2,3
21680_0,,,,2,1,2,3
21681_0,,,,2,1,2,3
21681_1,,,,2,1,2,3
21682_0,,,,2,1,2,3
21683_0,,,,2,1,2,3
21683_1,,,,2,1,2,3
21684_0,,,,2,1,2,3
21685_0,,,,2,1,2,3
21685_1,,,,2,1,2,3
21686_0,,,,2,1,2,3
21687_0,,,,2,1,2,3
21687_1,,,,2,1,2,3
21688_0,,,,2,1,2,3
21689_0,,,,2,1,2,3
21689_1,,,,2,1,2,3
21690_0,,,,2,1,2,3
21691_0,,,,2,1,2,3
21691_1,,,,2,1,2,3
21692_0,,,,2,1,2,3
21693_0,,,,2,1,2,3
21694_0,,,,2,1,2,3
21694_1,,,,2,1,2,3
21695_0,,,,2,1,2,3
21696_0,,,,2,1,2,3
21696_1,,,,2,1,2,3
21697_0,,,,2,1,2,3
21698_0,,,,2,1,2,3
21698_1,,,,2,1,2,3
21699_0,,,,2,1,2,3
21700_0,,,,2,1,2,3
21700_1,,,,2,1,2,3
21700_2,,,,2,1,2,3
21701_0,,,,2,1,2,3
21701_1,,,,2,1,2,3
21701_2,,,,2,1,2,3
21702_0,,,,2,1,2,3
21702_1,,,,2,1,2,3
21702_2,,,,2,1,2,3
21703_0,,,,2,1,2,3
21703_1,,,,2,1,2,3
21703_2,,,,2,1,2,3
21704_0,,,,2,1,2,3
21704_1,,,,2,1,2,3
21704_2,,,,2,1,2,3
21705_0,,,,2,1,2,3
21705_1,,,,2,1,2,3
21705_2,,,,2,1,2,3
21706_0,,,,2,1,2,3
21706_1,,,,2,1,2,3
21706_2,,,,2,1,2,3
21707_0,,,,2,1,2,3
21707_1,,,,2,1,2,3
21707_2,,,,2,1,2,3
21708_0,,,,2,1,2,3
21708_1,,,,2,1,2,3
21708_2,,,,2,1,2,3
21709_0,,,,2,1,2,3
21709_1,,,,2,1,2,3
21709_2,,,,2,1,2,3
21710_0,,,,2,1,2,3
21710_1,,,,2,1,2,3
21710_2,,,,2,1,2,3
21711_0,,,,2,1,2,3
21711_1,,,,2,1,2,3
21711_2,,,,2,1,2,3
21712_0,,,,2,1,2,3
21712_1,,,,2,1,2,3
21712_2,,,,2,1,2,3
21713_0,,,,2,1,2,3
21713_1,,,,2,1,2,3
21713_2,,,,2,1,2,3
21714_0,,,,2,1,2,3
21714_1,,,,2,1,2,3
21714_2,,,,2,1,2,3
21715_0,,,,2,1,2,3
21715_1,,,,2,1,2,3
21715_2,,,,2,1,2,3
21716_0,,,,2,1,2,3
21716_1,,,,2,1,2,3
21716_2,,,,2,1,2,3
21717_0,,,,2,1,2,3
21717_1,,,,2,1,2,3
21717_2,,,,2,1,2,3
21718_0,,,,2,1,2,3
21718_1,,,,2,1,2,3
21719_0,,,,2,1,2,3
21719_1,,,,2,1,2,3
21719_2,,,,2,1,2,3
21720_0,,,,2,1,2,3
21720_1,,,,2,1,2,3
21720_2,,,,2,1,2,3
21721_0,,,,2,1,2,3
21721_1,,,,2,1,2,3
21721_2,,,,2,1,2,3
21722_0,,,,2,1,2,3
21722_1,,,,2,1,2,3
21723_0,,,,2,1,2,3
21723_1,,,,2,1,2,3
21724_0,,,,2,1,2,3
21724_1,,,,2,1,2,3
21725_0,,,,2,1,2,3
21725_1,,,,2,1,2,3
21726_0,,,,2,1,2,3
21726_1,,,,2,1,2,3
21727_0,,,,2,1,2,3
21728_0,,,,2,1,2,3
21728_1,,,,2,1,2,3
21729_0,,,,2,1,2,3
21730_0,,,,2,1,2,3
21730_1,,,,2,1,2,3
21731_0,,,,2,1,2,3
21731_1,,,,2,1,2,3
21732_0,,,,2,1,2,3
21732_1,,,,2,1,2,3
21733_0,,,,2,1,2,3
21733_1,,,,2,1,2,3
21734_0,,,,2,1,2,3
21734_1,,,,2,1,2,3
21735_0,,,,2,1,2,3
21735_1,,,,2,1,2,3
21736_0,,,,2,1,2,3
21736_1,,,,2,1,2,3
21737_0,,,,2,1,2,3
21737_1,,,,2,1,2,3
21738_0,,,,2,1,2,3
21739_0,,,,2,1,2,3
21739_1,,,,2,1,2,3
21740_0,,,,2,1,2,3
21740_1,,,,2,1,2,3
21741_0,,,,2,1,2,3
21742_0,,,,2,1,2,3
21742_1,,,,2,1,2,3
21743_0,,,,2,1,2,3
21744_0,,,,2,1,2,3
21744_1,,,,2,1,2,3
21745_0,,,,2,1,2,3
21746_0,,,,2,1,2,3
21746_1,,,,2,1,2,3
21747_0,,,,2,1,2,3
21747_1,,,,2,1,2,3
21748_0,,,,2,1,2,3
21748_1,,,,2,1,2,3
21749_0,,,,2,1,2,3
21749_1,,,,2,1,2,3
21750_0,,,,2,1,2,3
21750_1,,,,2,1,2,3
21751_0,,,,2,1,2,3
21751_1,,,,2,1,2,3
21751_2,,,,2,1,2,3
21752_0,,,,2,1,2,3
21752_1,,,,2,1,2,3
21752_2,,,,2,1,2,3
21753_0,,,,2,1,2,3
21753_1,,,,2,1,2,3
21753_2,,,,2,1,2,3
21754_0,,,,2,1,2,3
21754_1,,,,2,1,2,3
21754_2,,,,2,1,2,3
21755_0,,,,2,1,2,3
21755_1,,,,2,1,2,3
21756_0,,,,2,1,2,3
21756_1,,,,2,1,2,3
21757_0,,,,2,1,2,3
21758_0,,,,2,1,2,3
21759_0,,,,2,1,2,3
21759_1,,,,2,1,2,3
21760_0,,,,2,1,2,3
21761_0,,,,2,1,2,3
21761_1,,,,2,1,2,3
21762_0,,,,2,1,2,3
21763_0,,,,2,1,2,3
21763_1,,,,2,1,2,3
21764_0,,,,2,1,2,3
21765_0,,,,2,1,2,3
21765_1,,,,2,1,2,3
21766_0,,,,2,1,2,3
21767_0,,,,2,1,2,3
21767_1,,,,2,1,2,3
21768_0,,,,2,1,2,3
21769_0,,,,2,1,2,3
21769_1,,,,2,1,2,3
21770_0,,,,2,1,2,3
21771_0,,,,2,1,2,3
21771_1,,,,2,1,2,3
21772_0,,,,2,1,2,3
21773_0,,,,2,1,2,3
21773_1,,,,2,1,2,3
21774_0,,,,2,1,2,3
21774_1,,,,2,1,2,3
21775_0,,,,2,1,2,3
21776_0,,,,2,1,2,3
21776_1,,,,2,1,2,3
21777_0,,,,2,1,2,3
21778_0,,,,2,1,2,3
21778_1,,,,2,1,2,3
21779_0,,,,2,1,2,3
21779_1,,,,2,1,2,3
21780_0,,,,2,1,2,3
21780_1,,,,2,1,2,3
21781_0,,,,2,1,2,3
21782_0,,,,2,1,2,3
21783_0,,,,2,1,2,3
21783_1,,,,2,1,2,3
21784_0,,,,2,1,2,3
21784_1,,,,2,1,2,3
21785_0,,,,2,1,2,3
21785_1,,,,2,1,2,3
21786_0,,,,2,1,2,3
21786_1,,,,2,1,2,3
21787_0,,,,2,1,2,3
21787_1,,,,2,1,2,3
21788_0,,,,2,1,2,3
21788_1,,,,2,1,2,3
21789_0,,,,2,1,2,3
21790_0,,,,2,1,2,3
21790_1,,,,2,1,2,3
21791_0,,,,2,1,2,3
21791_1,,,,2,1,2,3
21792_0,,,,2,1,2,3
21792_1,,,,2,1,2,3
21793_0,,,,2,1,2,3
21793_1,,,,2,1,2,3
21794_0,,,,2,1,2,3
21794_1,,,,2,1,2,3
21795_0,,,,2,1,2,3
21796_0,,,,2,1,2,3
21796_1,,,,2,1,2,3
21797_0,,,,2,1,2,3
21797_1,,,,2,1,2,3
21798_0,,,,2,1,2,3
21798_1,,,,2,1,2,3
21799_0,,,,2,1,2,3
21799_1,,,,2,1,2,3
21800_0,,,,2,1,2,3
21800_1,,,,2,1,2,3
21801_0,,,,2,1,2,3
21801_1,,,,2,1,2,3
21802_0,,,,2,1,2,3
21802_1,,,,2,1,2,3
21803_0,,,,2,1,2,3
21803_1,,,,2,1,2,3
21804_0,,,,2,1,2,3
21805_0,,,,2,1,2,3
21805_1,,,,2,1,2,3
21806_0,,,,2,1,2,3
21806_1,,,,2,1,2,3
21807_0,,,,2,1,2,3
21807_1,,,,2,1,2,3
21808_0,,,,2,1,2,3
21808_1,,,,2,1,2,3
21809_0,,,,2,1,2,3
21809_1,,,,2,1,2,3
21810_0,,,,2,1,2,3
21810_1,,,,2,1,2,3
21811_0,,,,2,1,2,3
21812_0,,,,2,1,2,3
21814_0,,,,2,1,2,3
C(C(C(CO)=O)=O)(C)=O,,,5,1,2,0,2
21814_1,,,,2,1,2,3
21815_0,,,,2,1,2,3
21816_0,,,,2,1,2,3
21816_1,,,,2,1,2,3
21817_0,,,,2,1,2,3
21818_0,,,,2,1,2,3
21819_0,,,,2,1,2,3
21819_1,,,,2,1,2,3
21821_0,,,,2,1,2,3
C(C(C(C)(C(CO)O)O)=O)=O,,,5,1,2,0,2
21822_0,,,,2,1,2,3
21823_0,,,,2,1,2,3
21823_1,,,,2,1,2,3
21825_0,,,,2,1,2,3
C(C(C(C)(C(C)O)O)=O)=O,,,5,1,2,0,2
21826_0,,,,2,1,2,3
21827_0,,,,2,1,2,3
21827_1,,,,2,1,2,3
21828_0,,,,2,1,2,3
21829_0,,,,2,1,2,3
21829_1,,,,2,1,2,3
21830_0,,,,2,1,2,3
21830_1,,,,2,1,2,3
21831_0,,,,2,1,2,3
21832_0,,,,2,1,2,3
21832_1,,,,2,1,2,3
21834_0,,,,2,1,2,3
C(C)(C(CO)(C)O)=O,,,5,1,2,0,2
21835_0,,,,2,1,2,3
21835_1,,,,2,1,2,3
21837_0,,,,2,1,2,3
C(C)(C(C=CC)O)=O,,,5,1,1,0,1
21838_0,,,,2,1,2,3
21838_1,,,,2,1,2,3
21840_0,,,,2,1,2,3
C(C)(C(CC=C)O)=O,,,5,1,1,0,1
21841_0,,,,2,1,2,3
21841_1,,,,2,1,2,3
21842_0,,,,2,1,2,3
21843_0,,,,2,1,2,3
21843_1,,,,2,1,2,3
21844_0,,,,2,1,2,3
21845_0,,,,2,1,2,3
21845_1,,,,2,1,2,3
21846_0,,,,2,1,2,3
21847_0,,,,2,1,2,3
21847_1,,,,2,1,2,3
21848_0,,,,2,1,2,3
21849_0,,,,2,1,2,3
21849_1,,,,2,1,2,3
21850_0,,,,2,1,2,3
21850_1,,,,2,1,2,3
21852_0,,,,2,1,2,3
C(C(C(C)=O)(C)O)=O,,,5,1,2,0,2
21853_0,,,,2,1,2,3
21853_1,,,,2,1,2,3
21854_0,,,,2,1,2,3
21854_1,,,,2,1,2,3
21855_0,,,,2,1,2,3
21856_0,,,,2,1,2,3
21856_1,,,,2,1,2,3
21857_0,,,,2,1,2,3
21858_0,,,,2,1,2,3
21858_1,,,,2,1,2,3
21859_0,,,,2,1,2,3
21859_1,,,,2,1,2,3
21859_2,,,,2,1,2,3
21860_0,,,,2,1,2,3
21860_1,,,,2,1,2,3
21860_2,,,,2,1,2,3
21861_0,,,,2,1,2,3
21861_1,,,,2,1,2,3
21862_0,,,,2,1,2,3
21862_1,,,,2,1,2,3
21863_0,,,,2,1,2,3
21863_1,,,,2,1,2,3
21864_0,,,,2,1,2,3
21864_1,,,,2,1,2,3
21865_0,,,,2,1,2,3
21865_1,,,,2,1,2,3
21865_2,,,,2,1,2,3
21866_0,,,,2,1,2,3
21867_0,,,,2,1,2,3
21867_1,,,,2,1,2,3
21868_0,,,,2,1,2,3
21868_1,,,,2,1,2,3
21869_0,,,,2,1,2,3
21869_1,,,,2,1,2,3
21870_0,,,,2,1,2,3
21871_0,,,,2,1,2,3
21871_1,,,,2,1,2,3
21872_0,,,,2,1,2,3
21872_1,,,,2,1,2,3
21873_0,,,,2,1,2,3
21873_1,,,,2,1,2,3
21874_0,,,,2,1,2,3
21874_1,,,,2,1,2,3
21875_0,,,,2,1,2,3
21875_1,,,,2,1,2,3
21876_0,,,,2,1,2,3
21876_1,,,,2,1,2,3
21877_0,,,,2,1,2,3
21877_1,,,,2,1,2,3
21878_0,,,,2,1,2,3
21878_1,,,,2,1,2,3
21879_0,,,,2,1,2,3
21879_1,,,,2,1,2,3
21880_0,,,,2,1,2,3
21880_1,,,,2,1,2,3
21881_0,,,,2,1,2,3
21881_1,,,,2,1,2,3
21882_0,,,,2,1,2,3
21882_1,,,,2,1,2,3
21883_0,,,,2,1,2,3
21883_1,,,,2,1,2,3
21884_0,,,,2,1,2,3
21884_1,,,,2,1,2,3
21885_0,,,,2,1,2,3
21885_1,,,,2,1,2,3
21886_0,,,,2,1,2,3
21886_1,,,,2,1,2,3
21887_0,,,,2,1,2,3
21888_0,,,,2,1,2,3
21888_1,,,,2,1,2,3
21889_0,,,,2,1,2,3
21890_0,,,,2,1,2,3
21890_1,,,,2,1,2,3
21891_0,,,,2,1,2,3
21891_1,,,,2,1,2,3
21892_0,,,,2,1,2,3
21892_1,,,,2,1,2,3
21893_0,,,,2,1,2,3
21893_1,,,,2,1,2,3
21894_0,,,,2,1,2,3
21894_1,,,,2,1,2,3
21895_0,,,,2,1,2,3
21895_1,,,,2,1,2,3
21896_0,,,,2,1,2,3
21896_1,,,,2,1,2,3
21897_0,,,,2,1,2,3
21897_1,,,,2,1,2,3
21898_0,,,,2,1,2,3
21898_1,,,,2,1,2,3
21899_0,,,,2,1,2,3
21901_0,,,,2,1,2,3
C(C(C)OC(CO)=O)=O,,,5,1,2,0,2
21903_0,,,,2,1,2,3
C(C(C)O)(OCC=O)=O,,,5,1,4,0,4
21903_1,,,,2,1,2,3
21904_0,,,,2,1,2,3
21906_0,,,,2,1,2,3
C(C(CCC(C)O)=O)=O,,,5,1,4,0,4
21906_1,,,,2,1,2,3
21907_0,,,,2,1,2,3
21908_0,,,,2,1,2,3
21910_0,,,,2,1,2,3
C(C(C(C)O)CC=O)=O,,,5,1,3,0,3
21910_1,,,,2,1,2,3
21911_0,,,,2,1,2,3
21912_0,,,,2,1,2,3
21912_1,,,,2,1,2,3
21913_0,,,,2,1,2,3
21913_1,,,,2,1,2,3
21914_0,,,,2,1,2,3
21914_1,,,,2,1,2,3
21915_0,,,,2,1,2,3
21915_1,,,,2,1,2,3
21916_0,,,,2,1,2,3
21916_1,,,,2,1,2,3
21917_0,,,,2,1,2,3
21917_1,,,,2,1,2,3
21919_0,,,,2,1,2,3
C(CC(C(C=O)=O)=O)=O,,,5,1,3,0,3
21919_1,,,,2,1,2,3
21921_0,,,,2,1,2,3
C(C(C=O)C=O)=O,,,5,1,2,0,2
21922_0,,,,2,1,2,3
21922_1,,,,2,1,2,3
21923_0,,,,2,1,2,3
21923_1,,,,2,1,2,3
21925_0,,,,2,1,2,3
C(CC(C(C(O)=O)=O)=O)=O,,,5,1,4,0,4
21925_1,,,,2,1,2,3
21926_0,,,,2,1,2,3
21926_1,,,,2,1,2,3
21927_0,,,,2,1,2,3
21927_1,,,,2,1,2,3
21928_0,,,,2,1,2,3
21928_1,,,,2,1,2,3
21929_0,,,,2,1,2,3
21930_0,,,,2,1,2,3
21930_1,,,,2,1,2,3
21931_0,,,,2,1,2,3
21931_1,,,,2,1,2,3
21933_0,,,,2,1,2,3
C(C(C(C=O)=O)C)=O,,,5,1,3,0,3
21933_1,,,,2,1,2,3
21934_0,,,,2,1,2,3
21934_1,,,,2,1,2,3
21936_0,,,,2,1,2,3
C(CCC(C=O)=O)=O,,,5,1,4,0,4
21936_1,,,,2,1,2,3
21938_0,,,,2,1,2,3
C(CCC=O)=O,,,5,1,3,0,3
21938_1,,,,2,1,2,3
21940_0,,,,2,1,2,3
C(CCC(C(O)=O)=O)=O,,,5,1,4,0,4
21940_1,,,,2,1,2,3
21942_0,,,,2,1,2,3
C(C(CC)=O)=O,,,5,1,5,0,5
21942_1,,,,2,1,2,3
21943_0,,,,2,1,2,3
21943_1,,,,2,1,2,3
21945_0,,,,2,1,2,3
C(C(C(C=O)=O)C)(O)=O,,,5,1,5,0,5
21945_1,,,,2,1,2,3
21946_0,,,,2,1,2,3
21946_1,,,,2,1,2,3
21947_0,,,,2,1,2,3
21947_1,,,,2,1,2,3
21948_0,,,,2,1,2,3
21949_0,,,,2,1,2,3
21949_1,,,,2,1,2,3
21950_0,,,,2,1,2,3
21950_1,,,,2,1,2,3
21951_0,,,,2,1,2,3
21951_1,,,,2,1,2,3
21953_0,,,,2,1,2,3
C(C)(CC(C)O)=O,,,5,1,2,0,2
21953_1,,,,2,1,2,3
21954_0,,,,2,1,2,3
21955_0,,,,2,1,2,3
21955_1,,,,2,1,2,3
21956_0,,,,2,1,2,3
21956_1,,,,2,1,2,3
21957_0,,,,2,1,2,3
21959_0,,,,2,1,2,3
C(C(CO)=O)(CC)=O,,,5,1,4,0,4
21959_1,,,,2,1,2,3
21960_0,,,,2,1,2,3
21961_0,,,,2,1,2,3
21961_1,,,,2,1,2,3
21962_0,,,,2,1,2,3
21962_1,,,,2,1,2,3
21963_0,,,,2,1,2,3
21963_1,,,,2,1,2,3
21965_0,,,,2,1,2,3
C(C(C)=O)(CC)=O,,,5,1,3,0,3
21965_1,,,,2,1,2,3
21967_0,,,,2,1,2,3
C(CC)=O,,,5,1,6,0,6
21967_1,,,,2,1,2,3
21968_0,,,,2,1,2,3
21968_1,,,,2,1,2,3
21969_0,,,,2,1,2,3
21969_1,,,,2,1,2,3
21971_0,,,,2,1,2,3
C(CC(C=C)=O)(O)=O,,,5,1,3,0,3
21972_0,,,,2,1,2,3
21974_0,,,,2,1,2,3
C1(C(C)OC(C1)=O)=O,,,5,1,3,0,3
21976_0,,,,2,1,1,2
C(CC(OC(C(C)=O)=O)=O)=O,,,5,1,4,0,4
21976_1,,,,2,1,1,2
21978_0,,,,2,1,2,3
C1(COC(C1C)=O)=O,,,5,1,4,0,4
21978_1,,,,2,1,2,3
21979_0,,,,2,1,2,3
21979_1,,,,2,1,2,3
21980_0,,,,2,1,2,3
21980_1,,,,2,1,2,3
21982_0,,,,2,1,2,3
C([CH2])=O,,,5,1,1,0,1
21983_0,,,,2,1,2,3
21984_0,,,,2,1,2,3
21985_0,,,,2,1,2,3
21986_0,,,,2,1,2,3
21987_0,,,,2,1,2,3
21987_1,,,,2,1,2,3
21987_2,,,,2,1,2,3
21989_0,,,,2,1,2,3
C(C(C)O)=CC=O,,,5,1,4,0,4
21990_0,,,,2,1,2,3
21991_0,,,,2,1,2,3
21992_0,,,,2,1,2,3
21993_0,,,,2,1,2,3
21994_0,,,,2,1,2,3
21996_0,,,,2,1,2,3
C(C=C(C=O)C(C)O)=O,,,5,1,2,0,2
21997_0,,,,2,1,2,3
21999_0,,,,2,1,2,3
C(C(C(C=O)=CC)O)=O,,,5,1,3,0,3
21999_1,,,,2,1,2,3
22000_0,,,,2,1,2,3
22001_0,,,,2,1,2,3
22002_0,,,,2,1,2,3
22003_0,,,,2,1,2,3
22004_0,,,,2,1,2,3
22005_0,,,,2,1,2,3
22006_0,,,,2,1,2,3
22007_0,,,,2,1,2,3
22008_0,,,,2,1,2,3
22009_0,,,,2,1,2,3
22010_0,,,,2,1,2,3
22011_0,,,,2,1,2,3
22012_0,,,,2,1,2,3
22013_0,,,,2,1,2,3
22014_0,,,,2,1,2,3
22015_0,,,,2,1,2,3
22016_0,,,,2,1,2,3
22017_0,,,,2,1,2,3
22018_0,,,,2,1,2,3
22019_0,,,,2,1,2,3
22019_1,,,,2,1,2,3
22019_2,,,,2,1,2,3
22021_0,,,,2,1,2,3
C(C=CC(O)=O)=O,,,5,1,23,0,23
22022_0,,,,2,1,2,3
22024_0,,,,2,1,2,3
C(C(C(O)=O)=CC=O)=O,,,5,1,3,0,3
22025_0,,,,2,1,2,3
22026_0,,,,2,1,2,3
22026_1,,,,2,1,2,3
22026_2,,,,2,1,2,3
22027_0,,,,2,1,2,3
22028_0,,,,2,1,2,3
22029_0,,,,2,1,2,3
22030_0,,,,2,1,2,3
22031_0,,,,2,1,2,3
22032_0,,,,2,1,2,3
22033_0,,,,2,1,2,3
22035_0,,,,2,1,2,3
C(C(C=CC=O)=O)=O,,,5,1,3,0,3
22037_0,,,,2,1,2,3
C(C=CC=O)=O,,,5,1,3,0,3
22039_0,,,,2,1,2,3
C(C=CC(C(O)=O)=O)=O,,,5,1,2,0,2
22040_0,,,,2,1,2,3
22042_0,,,,2,1,2,3
C=C(C=O)C=O,,,5,1,2,0,2
22043_0,,,,2,1,2,3
22044_0,,,,2,1,2,3
22045_0,,,,2,1,2,3
22047_0,,,,2,1,1,2
C=CC(C(OC(C(C)=O)=O)=O)=O,,,5,1,2,0,2
22048_0,,,,2,1,2,3
22050_0,,,,2,1,2,3
C(C(C(C(O)=O)=C)O)=O,,,5,1,5,0,5
22050_1,,,,2,1,2,3
22051_0,,,,2,1,2,3
22053_0,,,,2,1,2,3
C=CC(C)=O,,,5,1,4,0,4
22054_0,,,,2,1,2,3
22054_1,,,,2,1,2,3
22055_0,,,,2,1,2,3
22055_1,,,,2,1,2,3
22057_0,,,,2,1,2,3
C(C(C(CO)(C(C)O)O)O)=O,,,5,1,6,0,6
22057_1,,,,2,1,2,3
22057_2,,,,2,1,2,3
22058_0,,,,2,1,2,3
22058_1,,,,2,1,2,3
22058_2,,,,2,1,2,3
22059_0,,,,2,1,2,3
22059_1,,,,2,1,2,3
22060_0,,,,2,1,2,3
22060_1,,,,2,1,2,3
22061_0,,,,2,1,2,3
22061_1,,,,2,1,2,3
22062_0,,,,2,1,2,3
22062_1,,,,2,1,2,3
22063_0,,,,2,1,2,3
22064_0,,,,2,1,2,3
22064_1,,,,2,1,2,3
22066_0,,,,2,1,2,3
C([C](C(O)=O)O)=O,,,5,1,11,0,11
22066_1,,,,2,1,2,3
22067_0,,,,2,1,2,3
22068_0,,,,2,1,2,3
22068_1,,,,2,1,2,3
22070_0,,,,2,1,1,2
C(C(C=O)O)(OC(C(C)=O)O)=O,,,5,1,2,0,2
22070_1,,,,2,1,1,2
22071_0,,,,2,1,1,2
22073_0,,,,2,1,1,2
C(CO)(C(C)(O)OC(C=O)=O)=O,,,5,1,2,0,2
22073_1,,,,2,1,1,2
22075_0,,,,2,1,1,2
C(C(C)(O)OC(C(CO)=O)=O)=O,,,5,1,2,0,2
22075_1,,,,2,1,1,2
22076_0,,,,2,1,2,3
22076_1,,,,2,1,2,3
22077_0,,,,2,1,2,3
22077_1,,,,2,1,2,3
22079_0,,,,2,1,1,2
C(CC(C)OC(C=O)(CO)O)=O,,,5,1,2,0,2
22079_1,,,,2,1,1,2
22081_0,,,,2,1,1,2
C(CC(C)OC(C(CO)=O)O)=O,,,5,1,4,0,4
22081_1,,,,2,1,1,2
22083_0,,,,2,1,1,2
C(CC(C)OC(C(C)=O)O)=O,,,5,1,3,0,3
22083_1,,,,2,1,1,2
22085_0,,,,2,1,1,2
C(CC(C)OC(C=O)(C)O)=O,,,5,1,2,0,2
22085_1,,,,2,1,1,2
22087_0,,,,2,1,1,2
C(CC=O)(OC(C=O)(CO)O)=O,,,5,1,2,0,2
22087_1,,,,2,1,1,2
22089_0,,,,2,1,1,2
C(CC=O)(OC(C(CO)=O)O)=O,,,5,1,4,0,4
22089_1,,,,2,1,1,2
22091_0,,,,2,1,1,2
C(CC=O)(OC(C(C)=O)O)=O,,,5,1,3,0,3
22091_1,,,,2,1,1,2
22093_0,,,,2,1,1,2
C(CC=O)(OC(C=O)(C)O)=O,,,5,1,2,0,2
22093_1,,,,2,1,1,2
22094_0,,,,2,1,2,3
22096_0,,,,2,1,1,2
C(COC(C(C=O)=O)O)(CO)=O,,,5,1,4,0,4
22096_1,,,,2,1,1,2
22098_0,,,,2,1,1,2
C(C(CO)OC(C(C=O)=O)O)=O,,,5,1,3,0,3
22098_1,,,,2,1,1,2
22098_2,,,,2,1,1,2
22100_0,,,,2,1,2,3
C(C1C(C(C(O)O1)=O)O)=O,,,5,1,4,0,4
22100_1,,,,2,1,2,3
22100_2,,,,2,1,2,3
22102_0,,,,2,1,1,2
C(C(C=O)(COC(C=O)O)O)=O,,,5,1,2,0,2
22102_1,,,,2,1,1,2
22104_0,,,,2,1,1,2
C(C(C=O)(O)OCC(C=O)O)=O,,,5,1,3,0,3
22104_1,,,,2,1,1,2
22104_2,,,,2,1,1,2
22106_0,,,,2,1,2,3
C(C1CC(C(O)O1)=O)=O,,,5,1,3,0,3
22106_1,,,,2,1,2,3
22108_0,,,,2,1,1,2
C(C(C=O)(O)OCC(C=O)O)(O)=O,,,5,1,3,0,3
22108_1,,,,2,1,1,2
22108_2,,,,2,1,1,2
22110_0,,,,2,1,1,2
C(C(C)OC(C(C=O)=O)O)=O,,,5,1,2,0,2
22110_1,,,,2,1,1,2
22112_0,,,,2,1,1,2
C(COC(C(C=O)=O)O)(C)=O,,,5,1,2,0,2
22112_1,,,,2,1,1,2
22114_0,,,,2,1,1,2
C(C(C=O)(COC(C=O)O)O)(O)=O,,,5,1,2,0,2
22114_1,,,,2,1,1,2
22116_0,,,,2,1,1,2
C(C(C=O)(CO)O)(OC(C=O)O)=O,,,5,1,2,0,2
22116_1,,,,2,1,1,2
22118_0,,,,2,1,1,2
C(C(C=O)(C)O)(OC(C=O)O)=O,,,5,1,2,0,2
22118_1,,,,2,1,1,2
22120_0,,,,2,1,2,3
C1(C(C)(O)OCC1O)=O,,,5,1,2,0,2
22122_0,,,,2,1,2,3
C1(C(C(C(C)(O)O1)=O)O)=O,,,5,1,4,0,4
22122_1,,,,2,1,2,3
22122_2,,,,2,1,2,3
22124_0,,,,2,1,2,3
C1(C(C(C(O)O1)=O)(C)O)=O,,,5,1,3,0,3
22124_1,,,,2,1,2,3
22126_0,,,,2,1,1,2
C(C)(C(CO)OC(C(O)=O)=O)=O,,,5,1,1,0,1
22128_0,,,,2,1,2,3
C(C1(CC(CO1)=O)O)(O)=O,,,5,1,3,0,3
22128_1,,,,2,1,2,3
22130_0,,,,2,1,1,2
C(C(CC(C)OC(C=O)O)O)=O,,,5,1,2,0,2
22130_1,,,,2,1,1,2
22132_0,,,,2,1,1,2
C(CC(C=O)O)(OC(C=O)O)=O,,,5,1,2,0,2
22132_1,,,,2,1,1,2
22134_0,,,,2,1,1,2
C(C(C(COC(C=O)O)=O)O)=O,,,5,1,2,0,2
22134_1,,,,2,1,1,2
22136_0,,,,2,1,1,2
C(C(C=O)(O)OCC(CO)=O)=O,,,5,1,2,0,2
22136_1,,,,2,1,1,2
22138_0,,,,2,1,1,2
C(C(CO)(O)OC(C(CO)=O)=O)=O,,,5,1,2,0,2
22138_1,,,,2,1,1,2
22140_0,,,,2,1,1,2
C(C(C=O)(O)OCC(CO)=O)(O)=O,,,5,1,2,0,2
22140_1,,,,2,1,1,2
22142_0,,,,2,1,1,2
C(C(CO)(O)OC(C(C)=O)=O)=O,,,5,1,1,0,1
22144_0,,,,2,1,1,2
C(C(O)OCC(C=O)=O)(CO)=O,,,5,1,4,0,4
22144_1,,,,2,1,1,2
22146_0,,,,2,1,1,2
C(C(COC(C(C=O)=O)O)O)=O,,,5,1,3,0,3
22146_1,,,,2,1,1,2
22146_2,,,,2,1,1,2
22148_0,,,,2,1,1,2
C(C)(C(O)OCC(C=O)=O)=O,,,5,1,2,0,2
22150_0,,,,2,1,1,2
C(CO)(C(O)OC(C(CO)=O)=O)=O,,,5,1,4,0,4
22150_1,,,,2,1,1,2
22152_0,,,,2,1,1,2
C(CO)(C(O)OC(C(C)=O)=O)=O,,,5,1,3,0,3
22154_0,,,,2,1,1,2
C(C(O)OCC(C(O)=O)=O)(CO)=O,,,5,1,2,0,2
22154_1,,,,2,1,1,2
22155_0,,,,2,1,1,2
22155_1,,,,2,1,1,2
22156_0,,,,2,1,1,2
22156_1,,,,2,1,1,2
22158_0,,,,2,1,1,2
C(C)(C(O)OC(C(CO)=O)=O)=O,,,5,1,3,0,3
22158_1,,,,2,1,1,2
22160_0,,,,2,1,1,2
C(C)(C(O)OC(C(C)=O)=O)=O,,,5,1,2,0,2
22162_0,,,,2,1,1,2
C(C(C)(O)OC(C(C)=O)=O)=O,,,5,1,1,0,1
22164_0,,,,2,1,1,2
C(C)(C(O)OCC(C(O)=O)=O)=O,,,5,1,1,0,1
22165_0,,,,2,1,1,2
22166_0,,,,2,1,1,2
22168_0,,,,2,1,1,2
[C](C(OC(C(C)=O)(C)O)=O)=O,,,5,1,1,0,1
22170_0,,,,2,1,1,2
C(C)(C(C)(O)OC(C=O)=O)=O,,,5,1,1,0,1
22172_0,,,,2,1,1,2
C(C)(C(COC(C(O)=O)=O)O)=O,,,5,1,1,0,1
22174_0,,,,2,1,1,2
C(C[CH]C(OC(C=O)O)=O)=O,,,5,1,2,0,2
22174_1,,,,2,1,1,2
22176_0,,,,2,1,1,2
C(CCC=O)(OC(C=O)O)=O,,,5,1,2,0,2
22176_1,,,,2,1,1,2
22177_0,,,,2,1,1,2
22177_1,,,,2,1,1,2
22178_0,,,,2,1,1,2
22179_0,,,,2,1,1,2
22179_1,,,,2,1,1,2
22180_0,,,,2,1,1,2
22182_0,,,,2,1,1,2
C(C(O)=O)(OCCC(C(C)=O)=O)=O,,,5,1,1,0,1
22183_0,,,,2,1,1,2
22183_1,,,,2,1,1,2
22184_0,,,,2,1,1,2
22184_1,,,,2,1,1,2
22185_0,,,,2,1,1,2
22187_0,,,,2,1,1,2
C(CC(C)OC(C(CO)=O)=O)=O,,,5,1,4,0,4
22187_1,,,,2,1,1,2
22189_0,,,,2,1,1,2
C(CC(C)OC(C(C)=O)=O)=O,,,5,1,3,0,3
22189_1,,,,2,1,1,2
22190_0,,,,2,1,2,3
22190_1,,,,2,1,2,3
22192_0,,,,2,1,1,2
C(CC(OCC(C=O)=O)=O)=O,,,5,1,6,0,6
22192_1,,,,2,1,1,2
22194_0,,,,2,1,1,2
C(CC=O)(OCC(C(O)=O)=O)=O,,,5,1,4,0,4
22194_1,,,,2,1,1,2
22195_0,,,,2,1,1,2
22195_1,,,,2,1,1,2
22197_0,,,,2,1,1,2
C(CC=O)(OC(C(CO)=O)=O)=O,,,5,1,4,0,4
22197_1,,,,2,1,1,2
22198_0,,,,2,1,1,2
22198_1,,,,2,1,1,2
22200_0,,,,2,1,1,2
C(CCOC(C(C)=O)=O)=O,,,5,1,2,0,2
22200_1,,,,2,1,1,2
22201_0,,,,2,1,2,3
22201_1,,,,2,1,2,3
22203_0,,,,2,1,1,2
C(COC(C(C=O)=O)=O)(CO)=O,,,5,1,4,0,4
22203_1,,,,2,1,1,2
22205_0,,,,2,1,1,2
C(C(CO)OC(C(C=O)=O)=O)=O,,,5,1,3,0,3
22205_1,,,,2,1,1,2
22205_2,,,,2,1,1,2
22207_0,,,,2,1,2,3
C(C1C(C(C(O1)=O)=O)O)=O,,,5,1,4,0,4
22207_1,,,,2,1,2,3
22207_2,,,,2,1,2,3
22209_0,,,,2,1,2,3
C(C1CC(C(O1)=O)=O)=O,,,5,1,3,0,3
22209_1,,,,2,1,2,3
22211_0,,,,2,1,1,2
C(C(C)OC(C(C=O)=O)=O)=O,,,5,1,2,0,2
22211_1,,,,2,1,1,2
22213_0,,,,2,1,1,2
C(COC(C(C=O)=O)=O)(C)=O,,,5,1,2,0,2
22213_1,,,,2,1,1,2
22214_0,,,,2,1,2,3
22214_1,,,,2,1,2,3
22216_0,,,,2,1,1,2
C(C(C)=O)(OCCC(C(O)=O)=O)=O,,,5,1,2,0,2
22216_1,,,,2,1,1,2
22218_0,,,,2,1,1,2
C(C(COC(C(CO)=O)=O)O)=O,,,5,1,3,0,3
22218_1,,,,2,1,1,2
22218_2,,,,2,1,1,2
22220_0,,,,2,1,1,2
C(C(COC(C=O)=O)O)=O,,,5,1,3,0,3
22220_1,,,,2,1,1,2
22220_2,,,,2,1,1,2
22222_0,,,,2,1,1,2
C(C(COC(C(C)=O)=O)O)=O,,,5,1,3,0,3
22222_1,,,,2,1,1,2
22222_2,,,,2,1,1,2
22224_0,,,,2,1,1,2
C(CC(OC(C)CC=O)=O)=O,,,5,1,4,0,4
22224_1,,,,2,1,1,2
22225_0,,,,2,1,1,2
22225_1,,,,2,1,1,2
22227_0,,,,2,1,1,2
C(CC(OC(CC=O)=O)=O)=O,,,5,1,2,0,2
22227_1,,,,2,1,1,2
22228_0,,,,2,1,1,2
22228_1,,,,2,1,1,2
22230_0,,,,2,1,1,2
C(C(CO)=O)(OCC(C=O)=O)=O,,,5,1,4,0,4
22230_1,,,,2,1,1,2
22232_0,,,,2,1,1,2
C(C(COC(C(C=O)=O)=O)O)=O,,,5,1,3,0,3
22232_1,,,,2,1,1,2
22232_2,,,,2,1,1,2
22233_0,,,,2,1,1,2
22235_0,,,,2,1,1,2
C(C(C)=O)(OCC(C(O)=O)=O)=O,,,5,1,2,0,2
22237_0,,,,2,1,1,2
C(C(C)=O)(OC(C(CO)=O)=O)=O,,,5,1,3,0,3
22238_0,,,,2,1,1,2
22238_1,,,,2,1,1,2
22240_0,,,,2,1,1,2
C(COC(C(CO)=O)=O)(CO)=O,,,5,1,2,0,2
22240_1,,,,2,1,1,2
22242_0,,,,2,1,1,2
C(COC(C=O)=O)(CO)=O,,,5,1,2,0,2
22242_1,,,,2,1,1,2
22244_0,,,,2,1,1,2
C(COC(C(C)=O)=O)(CO)=O,,,5,1,2,0,2
22244_1,,,,2,1,1,2
22246_0,,,,2,1,2,3
C1(COC(C(C1)=O)=O)=O,,,5,1,4,0,4
22246_1,,,,2,1,2,3
22247_0,,,,2,1,1,2
22247_1,,,,2,1,1,2
22248_0,,,,2,1,1,2
22249_0,,,,2,1,1,2
22249_1,,,,2,1,1,2
22250_0,,,,2,1,1,2
22251_0,,,,2,1,1,2
22251_1,,,,2,1,1,2
22252_0,,,,2,1,1,2
22252_1,,,,2,1,1,2
22253_0,,,,2,1,1,2
22255_0,,,,2,1,2,3
C(C(C)CC=O)=O,,,5,1,16,0,16
22255_1,,,,2,1,2,3
22256_0,,,,2,1,2,3
22256_1,,,,2,1,2,3
22257_0,,,,2,1,2,3
22257_1,,,,2,1,2,3
22258_0,,,,2,1,2,3
22258_1,,,,2,1,2,3
22259_0,,,,2,1,2,3
22259_1,,,,2,1,2,3
22260_0,,,,2,1,2,3
22260_1,,,,2,1,2,3
22261_0,,,,2,1,2,3
22261_1,,,,2,1,2,3
22262_0,,,,2,1,2,3
22262_1,,,,2,1,2,3
22263_0,,,,2,1,2,3
22263_1,,,,2,1,2,3
22264_0,,,,2,1,2,3
22264_1,,,,2,1,2,3
22265_0,,,,2,1,2,3
22265_1,,,,2,1,2,3
22267_0,,,,2,1,2,3
C(C)(C(C)CC=O)=O,,,5,1,7,0,7
22267_1,,,,2,1,2,3
22268_0,,,,2,1,2,3
22268_1,,,,2,1,2,3
22269_0,,,,2,1,2,3
22269_1,,,,2,1,2,3
22270_0,,,,2,1,2,3
22270_1,,,,2,1,2,3
22271_0,,,,2,1,2,3
22271_1,,,,2,1,2,3
22272_0,,,,2,1,2,3
22272_1,,,,2,1,2,3
22273_0,,,,2,1,2,3
22273_1,,,,2,1,2,3
22274_0,,,,2,1,2,3
22274_1,,,,2,1,2,3
22275_0,,,,2,1,2,3
22276_0,,,,2,1,2,3
22277_0,,,,2,1,2,3
22277_1,,,,2,1,2,3
22278_0,,,,2,1,2,3
22279_0,,,,2,1,2,3
22279_1,,,,2,1,2,3
22280_0,,,,2,1,2,3
22281_0,,,,2,1,2,3
22281_1,,,,2,1,2,3
22283_0,,,,2,1,2,3
C(CO)(C(C)CC=O)=O,,,5,1,2,0,2
22284_0,,,,2,1,2,3
22284_1,,,,2,1,2,3
22285_0,,,,2,1,2,3
22286_0,,,,2,1,2,3
22287_0,,,,2,1,2,3
22288_0,,,,2,1,2,3
22289_0,,,,2,1,2,3
22290_0,,,,2,1,2,3
22291_0,,,,2,1,2,3
22292_0,,,,2,1,2,3
22293_0,,,,2,1,2,3
22294_0,,,,2,1,2,3
22295_0,,,,2,1,2,3
22296_0,,,,2,1,2,3
22297_0,,,,2,1,2,3
22298_0,,,,2,1,2,3
22299_0,,,,2,1,2,3
22300_0,,,,2,1,2,3
22301_0,,,,2,1,2,3
22301_1,,,,2,1,2,3
22302_0,,,,2,1,2,3
22303_0,,,,2,1,2,3
22304_0,,,,2,1,2,3
22305_0,,,,2,1,2,3
22306_0,,,,2,1,2,3
22307_0,,,,2,1,2,3
22308_0,,,,2,1,2,3
22309_0,,,,2,1,2,3
22311_0,,,,2,1,2,3
C(C(C)CC(C(O)=O)=O)=O,,,5,1,2,0,2
22313_0,,,,2,1,2,3
C(CC(C(O)=O)CC=O)=O,,,5,1,1,0,1
22315_0,,,,2,1,2,3
C(C(C(O)=O)(C)CC=O)=O,,,5,1,1,0,1
22317_0,,,,2,1,2,3
C(CC(C(O)=O)C)=O,,,5,1,9,0,9
22319_0,,,,2,1,2,3
C(C(C=O)C(C(O)=O)C)=O,,,5,1,1,0,1
22321_0,,,,2,1,2,3
C(C(C(C)O)CC=O)(O)=O,,,5,1,2,0,2
22323_0,,,,2,1,2,3
C(C(C(O)=O)CC=O)(O)=O,,,5,1,3,0,3
22324_0,,,,2,1,2,3
22325_0,,,,2,1,2,3
22326_0,,,,2,1,2,3
22327_0,,,,2,1,2,3
22328_0,,,,2,1,2,3
22329_0,,,,2,1,2,3
22330_0,,,,2,1,2,3
22331_0,,,,2,1,2,3
22332_0,,,,2,1,2,3
22333_0,,,,2,1,2,3
22334_0,,,,2,1,2,3
22335_0,,,,2,1,2,3
22336_0,,,,2,1,2,3
22337_0,,,,2,1,2,3
22338_0,,,,2,1,2,3
22339_0,,,,2,1,2,3
22339_1,,,,2,1,2,3
22340_0,,,,2,1,2,3
22340_1,,,,2,1,2,3
22341_0,,,,2,1,2,3
22341_1,,,,2,1,2,3
22342_0,,,,2,1,2,3
22343_0,,,,2,1,2,3
22344_0,,,,2,1,2,3
22345_0,,,,2,1,2,3
22346_0,,,,2,1,2,3
22348_0,,,,2,1,2,3
C1(C(C)CC(C(O1)=O)=O)=O,,,5,1,3,0,3
22350_0,,,,2,1,2,3
C(C(C)CC(C(O)=O)=O)(O)=O,,,5,1,2,0,2
22351_0,,,,2,1,2,3
22352_0,,,,2,1,2,3
22353_0,,,,2,1,2,3
22354_0,,,,2,1,2,3
22355_0,,,,2,1,2,3
22357_0,,,,2,1,2,3
C(CC(C)CCC(C)=O)=O,,,5,1,3,0,3
22357_1,,,,2,1,2,3
22359_0,,,,2,1,2,3
C(C)(CCC[CH]C(O)=O)=O,,,5,1,3,0,3
22359_1,,,,2,1,2,3
22361_0,,,,2,1,2,3
C(C)(CCCCC(O)=O)=O,,,5,1,3,0,3
22361_1,,,,2,1,2,3
22363_0,,,,2,1,2,3
C(CC(C)C(C(C)=O)C)=O,,,5,1,2,0,2
22365_0,,,,2,1,2,3
C(C)(C(C)C[CH]C(O)=O)=O,,,5,1,2,0,2
22367_0,,,,2,1,2,3
C(C)(C(C)CCC(O)=O)=O,,,5,1,2,0,2
22369_0,,,,2,1,2,3
C(CC(C)CC(CC)=O)=O,,,5,1,3,0,3
22369_1,,,,2,1,2,3
22371_0,,,,2,1,2,3
C(CC[CH]C(O)=O)(CC)=O,,,5,1,3,0,3
22371_1,,,,2,1,2,3
22373_0,,,,2,1,2,3
C(CC)(CCCC(O)=O)=O,,,5,1,3,0,3
22373_1,,,,2,1,2,3
22374_0,,,,2,1,2,3
22374_1,,,,2,1,2,3
22375_0,,,,2,1,2,3
22375_1,,,,2,1,2,3
22376_0,,,,2,1,2,3
22377_0,,,,2,1,2,3
22378_0,,,,2,1,2,3
22379_0,,,,2,1,2,3
22379_1,,,,2,1,2,3
22380_0,,,,2,1,2,3
22381_0,,,,2,1,2,3
22382_0,,,,2,1,2,3
22383_0,,,,2,1,2,3
22384_0,,,,2,1,2,3
22385_0,,,,2,1,2,3
22385_1,,,,2,1,2,3
22386_0,,,,2,1,2,3
22386_1,,,,2,1,2,3
22387_0,,,,2,1,2,3
22387_1,,,,2,1,2,3
22388_0,,,,2,1,2,3
22388_1,,,,2,1,2,3
22388_2,,,,2,1,2,3
22390_0,,,,2,1,2,3
C(C(C([C](C(O)=O)O)O)O)=O,,,5,1,5,0,5
22390_1,,,,2,1,2,3
22390_2,,,,2,1,2,3
22392_0,,,,2,1,2,3
C(C(C[C](C(O)=O)O)O)=O,,,5,1,3,0,3
22392_1,,,,2,1,2,3
22393_0,,,,2,1,2,3
22393_1,,,,2,1,2,3
22395_0,,,,2,1,2,3
[CH](C(CO)=O)O,,,5,1,1,0,1
22397_0,,,,2,1,2,3
[CH](C(C)=O)O,,,5,1,1,0,1
22399_0,,,,2,1,2,3
C(C(CC(C=O)O)O)=O,,,5,1,4,0,4
22399_1,,,,2,1,2,3
22400_0,,,,2,1,2,3
22400_1,,,,2,1,2,3
22400_2,,,,2,1,2,3
22401_0,,,,2,1,2,3
22402_0,,,,2,1,1,2
22403_0,,,,2,1,1,2
22404_0,,,,2,1,1,2
22405_0,,,,2,1,1,2
22406_0,,,,2,1,1,2
22407_0,,,,2,1,1,2
22408_0,,,,2,1,1,2
22410_0,,,,2,1,1,2
C(C1(C(C(C(C1O)O)O)=O)O)=O,,,5,1,1,0,1
22411_0,,,,2,1,1,2
22413_0,,,,2,1,1,2
C(C1(C(C(C(C1)O)O)=O)O)=O,,,5,1,1,0,1
22414_0,,,,2,1,1,2
22416_0,,,,2,1,1,2
C1(C(CC(C(C1O)=O)O)O)=O,,,5,1,1,0,1
22417_0,,,,2,1,1,2
22419_0,,,,2,1,1,2
C1(C(C(C(C(C1)=O)O)O)O)=O,,,5,1,1,0,1
22420_0,,,,2,1,1,2
22421_0,,,,2,1,1,2
22422_0,,,,2,1,1,2
22423_0,,,,2,1,1,2
22424_0,,,,2,1,1,2
22425_0,,,,2,1,1,2
22426_0,,,,2,1,1,2
22427_0,,,,2,1,1,2
22429_0,,,,2,1,1,2
C1(C(CC(C(C1)=O)O)O)=O,,,5,1,1,0,1
22430_0,,,,2,1,1,2
22431_0,,,,2,1,1,2
22432_0,,,,2,1,1,2
22434_0,,,,2,1,1,2
C(CO)(C(CC(CC(C)O)O)O)=O,,,5,1,1,0,1
22436_0,,,,2,1,1,2
C(C(C(CO)=O)C(CC(C)O)O)=O,,,5,1,1,0,1
22438_0,,,,2,1,1,2
C(C(C(C(CCO)O)=O)C(C)O)=O,,,5,1,1,0,1
22440_0,,,,2,1,1,2
C(C(CC(C(CO)C(C)O)O)O)=O,,,5,1,2,0,2
22442_0,,,,2,1,1,2
C(C(C(CO)C(C)O)O)(C(C)O)=O,,,5,1,1,0,1
22443_0,,,,2,1,1,2
22445_0,,,,2,1,1,2
C(CO)(C(C(C(C)O)C(C)O)O)=O,,,5,1,1,0,1
22446_0,,,,2,1,1,2
22448_0,,,,2,1,1,2
C(CC(CC(C(CO)=O)O)O)(O)=O,,,5,1,2,0,2
22450_0,,,,2,1,1,2
C(CC(C(C=O)C(CO)=O)O)(O)=O,,,5,1,1,0,1
22452_0,,,,2,1,1,2
C(C(C=O)C(C(CCO)O)=O)(O)=O,,,5,1,1,0,1
22454_0,,,,2,1,1,2
C(C(CO)C(CC(C=O)O)O)(O)=O,,,5,1,4,0,4
22456_0,,,,2,1,1,2
C(C(CO)C(C(C(C)O)=O)O)(O)=O,,,5,1,2,0,2
22457_0,,,,2,1,1,2
22458_0,,,,2,1,1,2
22459_0,,,,2,1,1,2
22460_0,,,,2,1,1,2
22461_0,,,,2,1,1,2
22463_0,,,,2,1,1,2
C(C(C(CO)O)O)(CC(C=O)=O)=O,,,5,1,1,0,1
22465_0,,,,2,1,1,2
C(CO)(C(CC(C(CO)=O)O)O)=O,,,5,1,1,0,1
22466_0,,,,2,1,1,2
22467_0,,,,2,1,1,2
22468_0,,,,2,1,1,2
22469_0,,,,2,1,1,2
22471_0,,,,2,1,1,2
C(CC(C(C(CO)=O)(CO)O)O)=O,,,5,1,3,0,3
22473_0,,,,2,1,1,2
C(C(C(CO)=O)C(C(CO)=O)O)=O,,,5,1,1,0,1
22474_0,,,,2,1,1,2
22475_0,,,,2,1,1,2
22476_0,,,,2,1,1,2
22477_0,,,,2,1,1,2
22478_0,,,,2,1,1,2
22479_0,,,,2,1,1,2
22480_0,,,,2,1,1,2
22481_0,,,,2,1,1,2
22483_0,,,,2,1,1,2
C(CC(C(C(C(C=O)O)O)O)=O)=O,,,5,1,2,0,2
22484_0,,,,2,1,1,2
22486_0,,,,2,1,1,2
C(CC(C(C(C(CO)O)O)O)=O)=O,,,5,1,2,0,2
22487_0,,,,2,1,1,2
22489_0,,,,2,1,1,2
C(CC(C(C(C(C)O)O)O)=O)=O,,,5,1,2,0,2
22490_0,,,,2,1,1,2
22492_0,,,,2,1,1,2
C(CC(C(C(C(O)=O)O)O)=O)=O,,,5,1,5,0,5
22493_0,,,,2,1,1,2
22495_0,,,,2,1,1,2
C(CC(C(C(CO)O)O)=O)=O,,,5,1,2,0,2
22497_0,,,,2,1,1,2
C(C(CO)(CC(C(CO)=O)O)O)=O,,,5,1,2,0,2
22499_0,,,,2,1,1,2
C(CC(CO)(C(C(CO)=O)O)O)=O,,,5,1,1,0,1
22501_0,,,,2,1,1,2
C(C(CO)(C(C=O)C(CO)=O)O)=O,,,5,1,1,0,1
22503_0,,,,2,1,1,2
C(C(CCO)O)(C(C(C=O)=O)O)=O,,,5,1,1,0,1
22504_0,,,,2,1,1,2
22505_0,,,,2,1,1,2
22507_0,,,,2,1,1,2
C(C(C(C(C(CO)O)O)=O)CO)=O,,,5,1,1,0,1
22508_0,,,,2,1,1,2
22509_0,,,,2,1,1,2
22511_0,,,,2,1,1,2
C(C(C(CO)O)O)(CC(CO)=O)=O,,,5,1,1,0,1
22513_0,,,,2,1,1,2
C(C(CO)O)(C(C(C(C)O)=O)O)=O,,,5,1,2,0,2
22514_0,,,,2,1,1,2
22515_0,,,,2,1,1,2
22516_0,,,,2,1,1,2
22518_0,,,,2,1,1,2
C(C(C(C(C(CO)O)O)=O)C=C)=O,,,5,1,1,0,1
22520_0,,,,2,1,1,2
C(C(CO)O)(C(C(CO)=O)O)=O,,,5,1,5,0,5
22521_0,,,,2,1,1,2
22522_0,,,,2,1,1,2
22524_0,,,,2,1,1,2
C(C(CC(C=O)O)(C(CO)O)O)=O,,,5,1,2,0,2
22526_0,,,,2,1,1,2
C(C(C(C(C)O)=O)(C(CO)O)O)=O,,,5,1,3,0,3
22528_0,,,,2,1,1,2
C(C(C(CO)=O)(C(CO)O)O)=O,,,5,1,3,0,3
22530_0,,,,2,1,1,2
C(C(C(C)O)O)(C(C(CO)=O)O)=O,,,5,1,1,0,1
22531_0,,,,2,1,1,2
22532_0,,,,2,1,1,2
22534_0,,,,2,1,1,2
C(C(C(CO)=O)(C(C(C)O)O)O)=O,,,5,1,3,0,3
22535_0,,,,2,1,1,2
22536_0,,,,2,1,1,2
22537_0,,,,2,1,1,2
22539_0,,,,2,1,1,2
C(C(C(CO)=O)(C(C(O)=O)O)O)=O,,,5,1,3,0,3
22541_0,,,,2,1,1,2
C(C(C)(CC(C(CC=O)=O)O)O)=O,,,5,1,1,0,1
22543_0,,,,2,1,1,2
C(C(C)(CC(CC(C=O)O)O)O)=O,,,5,1,2,0,2
22545_0,,,,2,1,1,2
C(C(C)(CC(C(C(C)O)=O)O)O)=O,,,5,1,1,0,1
22547_0,,,,2,1,1,2
C(C(C)(CC(C(CO)=O)O)O)=O,,,5,1,1,0,1
22548_0,,,,2,1,1,2
22550_0,,,,2,1,1,2
C(CC(C)(C(C(C(C)O)=O)O)O)=O,,,5,1,1,0,1
22551_0,,,,2,1,1,2
22553_0,,,,2,1,1,2
C(C(C)(C(C=O)C(CO)=O)O)=O,,,5,1,2,0,2
22554_0,,,,2,1,1,2
22555_0,,,,2,1,1,2
22557_0,,,,2,1,1,2
C(C(CC(C(C)=O)O)O)(CC=O)=O,,,5,1,1,0,1
22558_0,,,,2,1,1,2
22559_0,,,,2,1,1,2
22560_0,,,,2,1,1,2
22561_0,,,,2,1,1,2
22563_0,,,,2,1,1,2
C(C(CC(C)O)O)(CC(C=O)=O)=O,,,5,1,1,0,1
22565_0,,,,2,1,1,2
C(CC(C(CC(C=O)=O)=O)O)(O)=O,,,5,1,1,0,1
22567_0,,,,2,1,1,2
C(C(CCO)O)(CC(C=O)=O)=O,,,5,1,1,0,1
22568_0,,,,2,1,1,2
22570_0,,,,2,1,1,2
C(C(CC(CC(C(C)=O)O)O)O)=O,,,5,1,2,0,2
22571_0,,,,2,1,1,2
22573_0,,,,2,1,1,2
C(C(C)O)(C(CC(C(C)=O)O)O)=O,,,5,1,1,0,1
22574_0,,,,2,1,1,2
22575_0,,,,2,1,1,2
22577_0,,,,2,1,1,2
C(C)(C(CC(C(CO)=O)O)O)=O,,,5,1,1,0,1
22578_0,,,,2,1,1,2
22579_0,,,,2,1,1,2
22580_0,,,,2,1,1,2
22581_0,,,,2,1,1,2
22583_0,,,,2,1,1,2
C(CC(C(C(C(C)O)=O)(C)O)O)=O,,,5,1,1,0,1
22585_0,,,,2,1,1,2
C(CC(C(C(CO)=O)(C)O)O)=O,,,5,1,1,0,1
22586_0,,,,2,1,1,2
22588_0,,,,2,1,1,2
C(C(C(CO)=O)C(C(C)=O)O)=O,,,5,1,2,0,2
22589_0,,,,2,1,1,2
22590_0,,,,2,1,1,2
22591_0,,,,2,1,1,2
22592_0,,,,2,1,1,2
22593_0,,,,2,1,1,2
22594_0,,,,2,1,1,2
22595_0,,,,2,1,1,2
22596_0,,,,2,1,1,2
22597_0,,,,2,1,1,2
22599_0,,,,2,1,1,2
C(CC(C(CC(CCO)O)O)=O)=O,,,5,1,1,0,1
22601_0,,,,2,1,1,2
C(CC(C(CC(CO)=O)=O)O)=O,,,5,1,2,0,2
22603_0,,,,2,1,1,2
C(CC(C(CC(C=O)O)O)=O)=O,,,5,1,1,0,1
22605_0,,,,2,1,1,2
C(CC(C(CC(CO)(C)O)O)=O)=O,,,5,1,1,0,1
22607_0,,,,2,1,1,2
C(C(CC(C=CC)O)O)(CC=O)=O,,,5,1,1,0,1
22609_0,,,,2,1,1,2
C(CC(C(CC(CC=C)O)O)=O)=O,,,5,1,1,0,1
22611_0,,,,2,1,1,2
C(CC(C(CC(CO)O)O)=O)=O,,,5,1,1,0,1
22613_0,,,,2,1,1,2
C(CC(C(CC(C(C)O)O)O)=O)=O,,,5,1,1,0,1
22615_0,,,,2,1,1,2
C(CC(C(CC(C(O)=O)O)O)=O)=O,,,5,1,1,0,1
22617_0,,,,2,1,1,2
C(CC(C(CC(C)O)O)=O)=O,,,5,1,2,0,2
22619_0,,,,2,1,1,2
C(CC(C(CC(O)=O)O)=O)=O,,,5,1,3,0,3
22621_0,,,,2,1,1,2
C(CC(C(CCO)O)=O)=O,,,5,1,1,0,1
22622_0,,,,2,1,1,2
22624_0,,,,2,1,1,2
C(C(CCO)O)(CC(C(O)=O)=O)=O,,,5,1,1,0,1
22626_0,,,,2,1,1,2
C(C(C(C(CO)O)=O)(CCO)O)=O,,,5,1,1,0,1
22628_0,,,,2,1,1,2
C(C(C(C(C=O)O)O)(CCO)O)=O,,,5,1,4,0,4
22630_0,,,,2,1,1,2
C(C(CC(C=O)O)(CCO)O)=O,,,5,1,2,0,2
22632_0,,,,2,1,1,2
C(C(C(C(C)O)=O)(CCO)O)=O,,,5,1,1,0,1
22634_0,,,,2,1,1,2
C(C(C(CO)=O)(CCO)O)=O,,,5,1,1,0,1
22636_0,,,,2,1,1,2
C(C(C(C(C=O)O)=O)(CCO)O)=O,,,5,1,1,0,1
22638_0,,,,2,1,1,2
C(C(C(C(CCO)O)=O)CO)=O,,,5,1,1,0,1
22640_0,,,,2,1,1,2
C(CCO)(C(C(C(CO)O)=O)O)=O,,,5,1,1,0,1
22641_0,,,,2,1,1,2
22643_0,,,,2,1,1,2
C(C(CCO)O)(C(C(CO)=O)O)=O,,,5,1,1,0,1
22644_0,,,,2,1,1,2
22646_0,,,,2,1,1,2
C(C(CCO)O)(CC(CO)=O)=O,,,5,1,1,0,1
22648_0,,,,2,1,1,2
C(CCO)(C(C(C(C)O)=O)O)=O,,,5,1,1,0,1
22650_0,,,,2,1,1,2
C(C(CCO)O)(C(C(C)=O)O)=O,,,5,1,1,0,1
22652_0,,,,2,1,1,2
C(C(C(C(CCO)O)=O)C=C)=O,,,5,1,1,0,1
22653_0,,,,2,1,1,2
22655_0,,,,2,1,1,2
C(C(C(C(CCO)O)=O)O)=O,,,5,1,2,0,2
22657_0,,,,2,1,1,2
C(CO)(C(C(C=O)=O)CO)=O,,,5,1,2,0,2
22658_0,,,,2,1,1,2
22660_0,,,,2,1,1,2
C(C(CC(C=O)O)(CC(C)O)O)=O,,,5,1,2,0,2
22662_0,,,,2,1,1,2
C(C(C(C(C)O)=O)(CC(C)O)O)=O,,,5,1,1,0,1
22664_0,,,,2,1,1,2
C(C(C(CO)=O)(CC(C)O)O)=O,,,5,1,1,0,1
22666_0,,,,2,1,1,2
C(C(C(C(CC(C)O)O)=O)CO)=O,,,5,1,1,0,1
22667_0,,,,2,1,1,2
22669_0,,,,2,1,1,2
C(C(CC(C)O)O)(CC(CO)=O)=O,,,5,1,1,0,1
22671_0,,,,2,1,1,2
C(CC(C)O)(C(C(C(C)O)=O)O)=O,,,5,1,1,0,1
22673_0,,,,2,1,1,2
C(C(CC(C)O)O)(C(C(C)=O)O)=O,,,5,1,1,0,1
22675_0,,,,2,1,1,2
C(C(C(C(CC(C)O)O)=O)C=C)=O,,,5,1,1,0,1
22676_0,,,,2,1,1,2
22677_0,,,,2,1,1,2
22679_0,,,,2,1,1,2
C(CO)(C(C(C=O)=O)C(C)O)=O,,,5,1,3,0,3
22681_0,,,,2,1,1,2
C(C(CC(C=O)(CC(O)=O)O)O)=O,,,5,1,2,0,2
22683_0,,,,2,1,1,2
C(C(C)O)(C(C=O)(CC(O)=O)O)=O,,,5,1,1,0,1
22685_0,,,,2,1,1,2
C(C(C(CO)=O)(CC(O)=O)O)=O,,,5,1,1,0,1
22687_0,,,,2,1,1,2
C(CC(C(C(C=O)CO)=O)O)(O)=O,,,5,1,1,0,1
22688_0,,,,2,1,1,2
22690_0,,,,2,1,1,2
C(CC(C(CC(CO)=O)=O)O)(O)=O,,,5,1,1,0,1
22692_0,,,,2,1,1,2
C(CC(C(C(C(C)O)=O)O)=O)(O)=O,,,5,1,1,0,1
22694_0,,,,2,1,1,2
C(CC(C(C(C(C)=O)O)=O)O)(O)=O,,,5,1,1,0,1
22696_0,,,,2,1,1,2
C(C(C(C(CC(O)=O)O)=O)C=C)=O,,,5,1,1,0,1
22697_0,,,,2,1,1,2
22698_0,,,,2,1,1,2
22700_0,,,,2,1,1,2
C(C(C(CO)=O)C(C=O)=O)(O)=O,,,5,1,3,0,3
22702_0,,,,2,1,1,2
C(C(C(CO)=O)(C(CO)O)O)(O)=O,,,5,1,8,0,8
22703_0,,,,2,1,1,2
22704_0,,,,2,1,1,2
22705_0,,,,2,1,1,2
22707_0,,,,2,1,1,2
C(C(CC(CCO)O)O)=O,,,5,1,2,0,2
22709_0,,,,2,1,1,2
C(C(CCO)O)(C(C)O)=O,,,5,1,1,0,1
22710_0,,,,2,1,1,2
22711_0,,,,2,1,1,2
22712_0,,,,2,1,1,2
22713_0,,,,2,1,1,2
22715_0,,,,2,1,1,2
C(C(C(CO)=O)CO)=O,,,5,1,2,0,2
22716_0,,,,2,1,1,2
22718_0,,,,2,1,1,2
C(C(CC(C=O)O)(CCO)O)(O)=O,,,5,1,2,0,2
22720_0,,,,2,1,1,2
C(C(C(C(C)O)=O)(CCO)O)(O)=O,,,5,1,1,0,1
22722_0,,,,2,1,1,2
C(C(C(CO)=O)(CCO)O)(O)=O,,,5,1,3,0,3
22723_0,,,,2,1,1,2
22725_0,,,,2,1,1,2
C(C)(C(CC(C=O)O)(CC=O)O)=O,,,5,1,2,0,2
22727_0,,,,2,1,1,2
C(C)(C(C(C(C)O)=O)(CC=O)O)=O,,,5,1,1,0,1
22729_0,,,,2,1,1,2
C(CC(C(CO)=O)(C(C)=O)O)=O,,,5,1,2,0,2
22731_0,,,,2,1,1,2
C(C(C)(CC(C=O)O)O)(CC=O)=O,,,5,1,2,0,2
22733_0,,,,2,1,1,2
C(CC=O)(C(C(C(C)O)=O)(C)O)=O,,,5,1,1,0,1
22735_0,,,,2,1,1,2
C(CC=O)(C(C(CO)=O)(C)O)=O,,,5,1,1,0,1
22736_0,,,,2,1,1,2
22737_0,,,,2,1,1,2
22738_0,,,,2,1,1,2
22740_0,,,,2,1,1,2
C(C(C(CO)=O)C(C(C)=O)=O)=O,,,5,1,1,0,1
22742_0,,,,2,1,1,2
C(C(C)O)(C(C=O)C(C(C)=O)=O)=O,,,5,1,1,0,1
22744_0,,,,2,1,1,2
C(CC(C(CC(CO)=O)=O)=O)=O,,,5,1,1,0,1
22746_0,,,,2,1,1,2
C(CC(C(CC(C(C)O)=O)=O)=O)=O,,,5,1,1,0,1
22748_0,,,,2,1,1,2
C(C(C)O)(C(C(CO)=O)(CO)O)=O,,,5,1,1,0,1
22749_0,,,,2,1,1,2
22750_0,,,,2,1,1,2
22752_0,,,,2,1,1,2
C(CO)(C(C(CO)=O)(C(C)O)O)=O,,,5,1,1,0,1
22753_0,,,,2,1,1,2
22754_0,,,,2,1,1,2
22756_0,,,,2,1,1,2
C(CO)(C(C(C(C(C)O)=O)=O)O)=O,,,5,1,1,0,1
22757_0,,,,2,1,1,2
22759_0,,,,2,1,1,2
C(C(C(C(C(C(C)O)=O)O)=O)O)=O,,,5,1,1,0,1
22760_0,,,,2,1,1,2
22761_0,,,,2,1,1,2
22762_0,,,,2,1,1,2
22764_0,,,,2,1,1,2
C(C(C)O)(C(C(C(C)O)=O)O)=O,,,5,1,1,0,1
22765_0,,,,2,1,1,2
22766_0,,,,2,1,1,2
22767_0,,,,2,1,1,2
22769_0,,,,2,1,1,2
C(C(C)O)(C(C(CO)=O)O)=O,,,5,1,3,0,3
22771_0,,,,2,1,1,2
C(CO)(C(C(C(O)=O)=O)(CO)O)=O,,,5,1,4,0,4
22773_0,,,,2,1,1,2
C(C(C(CO)=O)(C(CO)=O)O)(O)=O,,,5,1,1,0,1
22774_0,,,,2,1,1,2
22775_0,,,,2,1,1,2
22777_0,,,,2,1,1,2
C(CO)(C(C(C(C(O)=O)=O)=O)O)=O,,,5,1,1,0,1
22779_0,,,,2,1,1,2
C(C(C(C(C(C(O)=O)=O)O)=O)O)=O,,,5,1,1,0,1
22780_0,,,,2,1,1,2
22781_0,,,,2,1,1,2
22783_0,,,,2,1,1,2
C(C(C(C(C(O)=O)=O)O)=O)(O)=O,,,5,1,2,0,2
22784_0,,,,2,1,1,2
22786_0,,,,2,1,1,2
C(C(CC(C(C)=O)(C(C)O)O)O)=O,,,5,1,3,0,3
22788_0,,,,2,1,1,2
C(C(C)O)(C(C(C)=O)(C(C)O)O)=O,,,5,1,1,0,1
22790_0,,,,2,1,1,2
C(C)(C(C(CO)=O)(C(C)O)O)=O,,,5,1,3,0,3
22792_0,,,,2,1,1,2
C(C(C)O)(C(C)(CC(C=O)O)O)=O,,,5,1,2,0,2
22793_0,,,,2,1,1,2
22795_0,,,,2,1,1,2
C(C(C)O)(C(C(C(C)O)=O)(C)O)=O,,,5,1,1,0,1
22796_0,,,,2,1,1,2
22797_0,,,,2,1,1,2
22799_0,,,,2,1,1,2
C(C(C)O)(C(C(CO)=O)(C)O)=O,,,5,1,1,0,1
22800_0,,,,2,1,1,2
22801_0,,,,2,1,1,2
22802_0,,,,2,1,1,2
22804_0,,,,2,1,1,2
C(CO)(CC(C(C(C)O)=O)=O)=O,,,5,1,2,0,2
22805_0,,,,2,1,1,2
22806_0,,,,2,1,1,2
22807_0,,,,2,1,1,2
22808_0,,,,2,1,1,2
22809_0,,,,2,1,1,2
22810_0,,,,2,1,1,2
22811_0,,,,2,1,1,2
22812_0,,,,2,1,1,2
22813_0,,,,2,1,1,2
22814_0,,,,2,1,1,2
22816_0,,,,2,1,1,2
C(C(C)O)(CC(C(C(C)O)=O)=O)=O,,,5,1,1,0,1
22817_0,,,,2,1,1,2
22818_0,,,,2,1,1,2
22820_0,,,,2,1,1,2
C(C(CC(C(O)=O)(C(C)=O)O)O)=O,,,5,1,3,0,3
22822_0,,,,2,1,1,2
C(C(C)O)(C(C(O)=O)(C(C)=O)O)=O,,,5,1,1,0,1
22823_0,,,,2,1,1,2
22825_0,,,,2,1,1,2
C(C(CC(C(C(O)=O)=O)(C)O)O)=O,,,5,1,2,0,2
22827_0,,,,2,1,1,2
C(C(C)O)(C(C(C(O)=O)=O)(C)O)=O,,,5,1,2,0,2
22829_0,,,,2,1,1,2
C(CO)(C(C(C(O)=O)=O)(C)O)=O,,,5,1,1,0,1
22830_0,,,,2,1,1,2
22832_0,,,,2,1,1,2
C(C(C)O)(CC(C(C(O)=O)=O)=O)=O,,,5,1,1,0,1
22833_0,,,,2,1,1,2
22834_0,,,,2,1,1,2
22835_0,,,,2,1,1,2
22836_0,,,,2,1,1,2
22838_0,,,,2,1,1,2
C(CO)(CC(CO)=O)=O,,,5,1,2,0,2
22839_0,,,,2,1,1,2
22840_0,,,,2,1,1,2
22842_0,,,,2,1,1,2
C(C(C(CC(CO)=O)=O)CO)(O)=O,,,5,1,1,0,1
22844_0,,,,2,1,1,2
C(C(C(CC(CO)=O)=O)C)(O)=O,,,5,1,2,0,2
22846_0,,,,2,1,1,2
C(C(C(CO)=O)C=C)=O,,,5,1,1,0,1
22848_0,,,,2,1,1,2
C(CO)(C(C=C)C(C(O)=O)=O)=O,,,5,1,1,0,1
22850_0,,,,2,1,1,2
C(C(C(CO)=O)C(C(O)=O)=C)=O,,,5,1,1,0,1
22852_0,,,,2,1,1,2
C(CO)(C1C(C(OC(C1=C)=O)=O)=O)=O,,,5,1,1,0,1
22853_0,,,,2,1,1,2
22855_0,,,,2,1,1,2
C(CO)(C1C(C(OC1C)=O)=O)=O,,,5,1,1,0,1
22857_0,,,,2,1,1,2
C1(C(C(CO)=O)C(C(O1)=O)=O)=O,,,5,1,1,0,1
22859_0,,,,2,1,1,2
C(C(C(CO)=O)C[CH]C(O)=O)=O,,,5,1,1,0,1
22861_0,,,,2,1,1,2
C(CCC(C=O)C(CO)=O)(O)=O,,,5,1,1,0,1
22862_0,,,,2,1,1,2
22863_0,,,,2,1,1,2
22864_0,,,,2,1,1,2
22865_0,,,,2,1,1,2
22867_0,,,,2,1,1,2
C(C(C)(C(C=O)C(CO)=O)O)(O)=O,,,5,1,1,0,1
22868_0,,,,2,1,1,2
22869_0,,,,2,1,1,2
22870_0,,,,2,1,1,2
22871_0,,,,2,1,1,2
22872_0,,,,2,1,1,2
22873_0,,,,2,1,1,2
22874_0,,,,2,1,1,2
22875_0,,,,2,1,1,2
22876_0,,,,2,1,1,2
22877_0,,,,2,1,1,2
22878_0,,,,2,1,1,2
22879_0,,,,2,1,1,2
22880_0,,,,2,1,1,2
22881_0,,,,2,1,1,2
22882_0,,,,2,1,1,2
22883_0,,,,2,1,1,2
22884_0,,,,2,1,1,2
22885_0,,,,2,1,1,2
22886_0,,,,2,1,1,2
22887_0,,,,2,1,1,2
22888_0,,,,2,1,1,2
22889_0,,,,2,1,1,2
22890_0,,,,2,1,1,2
22891_0,,,,2,1,1,2
22892_0,,,,2,1,1,2
22893_0,,,,2,1,1,2
22894_0,,,,2,1,1,2
22896_0,,,,2,1,1,2
C(C(C(CC(C=O)O)O)O)(O)=O,,,5,1,3,0,3
22897_0,,,,2,1,1,2
22898_0,,,,2,1,1,2
22899_0,,,,2,1,1,2
22901_0,,,,2,1,1,2
C(C(CO)O)(C(CO)(CO)O)=O,,,5,1,1,0,1
22902_0,,,,2,1,1,2
22904_0,,,,2,1,1,2
C(C(CC(CO)(CO)O)O)=O,,,5,1,3,0,3
22906_0,,,,2,1,1,2
C(C(C)O)(C(CO)(CO)O)=O,,,5,1,3,0,3
22908_0,,,,2,1,1,2
C(CO)(C(CO)(CO)O)=O,,,5,1,4,0,4
22910_0,,,,2,1,1,2
C(C(C(C(CO)(CO)O)=O)O)=O,,,5,1,2,0,2
22912_0,,,,2,1,1,2
C(C(C(C(CO)(CO)O)=O)O)(O)=O,,,5,1,4,0,4
22914_0,,,,2,1,1,2
C(C(CO)O)(C(CO)(C)O)=O,,,5,1,3,0,3
22915_0,,,,2,1,1,2
22917_0,,,,2,1,1,2
C(C(CO)O)(C(C=CC)O)=O,,,5,1,1,0,1
22919_0,,,,2,1,1,2
C(C(C(C(C=CC)O)O)O)=O,,,5,1,4,0,4
22921_0,,,,2,1,1,2
C(C(CC=C)O)(C(CO)O)=O,,,5,1,1,0,1
22923_0,,,,2,1,1,2
C(C(C(C(CC=C)O)O)O)=O,,,5,1,4,0,4
22924_0,,,,2,1,1,2
22925_0,,,,2,1,1,2
22926_0,,,,2,1,1,2
22927_0,,,,2,1,1,2
22928_0,,,,2,1,1,2
22929_0,,,,2,1,1,2
22930_0,,,,2,1,1,2
22931_0,,,,2,1,1,2
22932_0,,,,2,1,1,2
22933_0,,,,2,1,1,2
22935_0,,,,2,1,1,2
C(C(CC(C)O)O)(C(CO)O)=O,,,5,1,3,0,3
22936_0,,,,2,1,1,2
22937_0,,,,2,1,1,2
22938_0,,,,2,1,1,2
22939_0,,,,2,1,1,2
22940_0,,,,2,1,1,2
22942_0,,,,2,1,1,2
C(C(C(C(CO)O)=O)(CO)O)=O,,,5,1,3,0,3
22943_0,,,,2,1,1,2
22945_0,,,,2,1,1,2
C(C(C(C(CO)O)=O)(C)O)=O,,,5,1,3,0,3
22946_0,,,,2,1,1,2
22947_0,,,,2,1,1,2
22948_0,,,,2,1,1,2
22949_0,,,,2,1,1,2
22950_0,,,,2,1,1,2
22951_0,,,,2,1,1,2
22953_0,,,,2,1,1,2
C(C(CC(CO)(C)O)O)=O,,,5,1,3,0,3
22955_0,,,,2,1,1,2
C(C(C)O)(C(CO)(C)O)=O,,,5,1,1,0,1
22956_0,,,,2,1,1,2
22958_0,,,,2,1,1,2
C(C(C(C(CO)(C)O)=O)O)=O,,,5,1,4,0,4
22960_0,,,,2,1,1,2
C(C(C(C(CO)(C)O)=O)O)(O)=O,,,5,1,3,0,3
22962_0,,,,2,1,1,2
C(C(C)(C(CC(C=O)O)O)O)(O)=O,,,5,1,4,0,4
22964_0,,,,2,1,1,2
C(C(C)C(C)(CC(C=O)O)O)(O)=O,,,5,1,2,0,2
22966_0,,,,2,1,1,2
C(C(CC(C=CC)O)O)=O,,,5,1,3,0,3
22968_0,,,,2,1,1,2
C(C(CC(CC=C)O)O)=O,,,5,1,3,0,3
22970_0,,,,2,1,1,2
C(C(CC(C(O)=O)(C=CC)O)O)=O,,,5,1,2,0,2
22972_0,,,,2,1,1,2
C(C(CC(C=O)O)(CC=C)O)(O)=O,,,5,1,2,0,2
22974_0,,,,2,1,1,2
C(C(CC(CC(C(O)=O)=C)O)O)=O,,,5,1,2,0,2
22976_0,,,,2,1,1,2
C(C(CC(C=C(C(O)=O)C)O)O)=O,,,5,1,2,0,2
22978_0,,,,2,1,1,2
C(C(CC(C(CO)O)O)O)=O,,,5,1,3,0,3
22980_0,,,,2,1,1,2
C(C(CC(CO)O)O)=O,,,5,1,2,0,2
22982_0,,,,2,1,1,2
C1(C(CC(C=O)O)(CC(C)O1)O)=O,,,5,1,2,0,2
22984_0,,,,2,1,1,2
C1(C(CC(C=O)O)(CC(O1)=O)O)=O,,,5,1,2,0,2
22986_0,,,,2,1,1,2
C(C(CC(CC[CH]C(O)=O)O)O)=O,,,5,1,3,0,3
22988_0,,,,2,1,1,2
C(CCCC(CC(C=O)O)O)(O)=O,,,5,1,3,0,3
22990_0,,,,2,1,1,2
C(C(CC(C(C)O)O)O)=O,,,5,1,2,0,2
22991_0,,,,2,1,1,2
22992_0,,,,2,1,1,2
22993_0,,,,2,1,1,2
22994_0,,,,2,1,1,2
22995_0,,,,2,1,1,2
22996_0,,,,2,1,1,2
22998_0,,,,2,1,1,2
C(C(CO)O)(CC(CO)=O)=O,,,5,1,3,0,3
22999_0,,,,2,1,1,2
23000_0,,,,2,1,1,2
23001_0,,,,2,1,1,2
23003_0,,,,2,1,1,2
C(C(C)O)(CC(CO)=O)=O,,,5,1,3,0,3
23004_0,,,,2,1,1,2
23005_0,,,,2,1,1,2
23006_0,,,,2,1,1,2
23007_0,,,,2,1,1,2
23009_0,,,,2,1,1,2
C(C(C)(C(C(C(C)O)=O)O)O)(O)=O,,,5,1,2,0,2
23011_0,,,,2,1,1,2
C(C(C)C(C(C(C)O)=O)(C)O)(O)=O,,,5,1,1,0,1
23013_0,,,,2,1,1,2
C(C(C)O)(C(C=CC)O)=O,,,5,1,1,0,1
23015_0,,,,2,1,1,2
C(C(CC=C)O)(C(C)O)=O,,,5,1,1,0,1
23017_0,,,,2,1,1,2
C(C(C)O)(C(C(O)=O)(C=CC)O)=O,,,5,1,1,0,1
23019_0,,,,2,1,1,2
C(C(C)O)(C(C(O)=O)(CC=C)O)=O,,,5,1,1,0,1
23021_0,,,,2,1,1,2
C(C(CC(C(O)=O)=C)O)(C(C)O)=O,,,5,1,1,0,1
23023_0,,,,2,1,1,2
C(C(C)O)(C(C=C(C(O)=O)C)O)=O,,,5,1,1,0,1
23025_0,,,,2,1,1,2
C(C(C(CO)O)O)(C(C)O)=O,,,5,1,2,0,2
23026_0,,,,2,1,1,2
23028_0,,,,2,1,1,2
C1(C(C(C(C)O)=O)(CC(C)O1)O)=O,,,5,1,1,0,1
23030_0,,,,2,1,1,2
C(C(C)O)(C1(C(OC(C1)=O)=O)O)=O,,,5,1,1,0,1
23032_0,,,,2,1,1,2
C(C(CC[CH]C(O)=O)O)(C(C)O)=O,,,5,1,1,0,1
23034_0,,,,2,1,1,2
C(CCCC(C(C(C)O)=O)O)(O)=O,,,5,1,1,0,1
23036_0,,,,2,1,1,2
C(C(C(C)O)O)(C(C)O)=O,,,5,1,1,0,1
23037_0,,,,2,1,1,2
23038_0,,,,2,1,1,2
23040_0,,,,2,1,1,2
C(C(CC(C)O)O)(C(C)O)=O,,,5,1,1,0,1
23042_0,,,,2,1,1,2
C(CC(C(C(C)O)=O)O)(O)=O,,,5,1,1,0,1
23044_0,,,,2,1,1,2
C(C(C(C(C)O)=O)(CO)O)=O,,,5,1,3,0,3
23046_0,,,,2,1,1,2
C(C(C(C(C)O)=O)(C)O)=O,,,5,1,1,0,1
23048_0,,,,2,1,1,2
C(C(C)O)(C(C(C)=O)O)=O,,,5,1,1,0,1
23049_0,,,,2,1,1,2
23050_0,,,,2,1,1,2
23051_0,,,,2,1,1,2
23052_0,,,,2,1,1,2
23053_0,,,,2,1,1,2
23054_0,,,,2,1,1,2
23056_0,,,,2,1,1,2
C(C(C(C(CCO)O)=O)(C)O)(O)=O,,,5,1,1,0,1
23057_0,,,,2,1,1,2
23059_0,,,,2,1,1,2
C(C(CO)C(C(CO)=O)(C)O)(O)=O,,,5,1,2,0,2
23061_0,,,,2,1,1,2
C(C(C)C(C(CO)=O)(C)O)(O)=O,,,5,1,1,0,1
23063_0,,,,2,1,1,2
C(C(C(CC(C(C)O)=O)=O)C)(O)=O,,,5,1,1,0,1
23064_0,,,,2,1,1,2
23066_0,,,,2,1,1,2
C(C(C=O)O)(C(C=CC)O)=O,,,5,1,2,0,2
23068_0,,,,2,1,1,2
C(C(C(O)=O)O)(C(C=CC)O)=O,,,5,1,2,0,2
23069_0,,,,2,1,1,2
23071_0,,,,2,1,1,2
C(C(C(C(CC=C)O)=O)O)=O,,,5,1,2,0,2
23073_0,,,,2,1,1,2
C(C(C(C(CC=C)O)=O)O)(O)=O,,,5,1,2,0,2
23074_0,,,,2,1,1,2
23076_0,,,,2,1,1,2
C(C(C(C(CO)O)=O)C=C)=O,,,5,1,2,0,2
23078_0,,,,2,1,1,2
C(C(C(C(C)O)=O)C=C)=O,,,5,1,2,0,2
23080_0,,,,2,1,1,2
C(C(C(CO)=O)(C=CC)O)(O)=O,,,5,1,1,0,1
23082_0,,,,2,1,1,2
C(C(C(CO)=O)(CC=C)O)(O)=O,,,5,1,1,0,1
23084_0,,,,2,1,1,2
C(C(C)O)(C(C=C)C(C(O)=O)=O)=O,,,5,1,1,0,1
23086_0,,,,2,1,1,2
C(CO)(C(CC(C(O)=O)=C)O)=O,,,5,1,1,0,1
23088_0,,,,2,1,1,2
C(C(C(C(C)O)=O)C(C(O)=O)=C)=O,,,5,1,1,0,1
23090_0,,,,2,1,1,2
C(CO)(C(C=C(C(O)=O)C)O)=O,,,5,1,1,0,1
23091_0,,,,2,1,1,2
23092_0,,,,2,1,1,2
23093_0,,,,2,1,1,2
23094_0,,,,2,1,1,2
23095_0,,,,2,1,1,2
23096_0,,,,2,1,1,2
23098_0,,,,2,1,1,2
C1(C(C(CO)=O)(CC(C)O1)O)=O,,,5,1,1,0,1
23100_0,,,,2,1,1,2
C1(C(C(CO)=O)(CC(O1)=O)O)=O,,,5,1,1,0,1
23102_0,,,,2,1,1,2
C(CO)(C(CC[CH]C(O)=O)O)=O,,,5,1,1,0,1
23104_0,,,,2,1,1,2
C(CCCC(C(CO)=O)O)(O)=O,,,5,1,1,0,1
23105_0,,,,2,1,1,2
23106_0,,,,2,1,1,2
23107_0,,,,2,1,1,2
23108_0,,,,2,1,1,2
23110_0,,,,2,1,1,2
C(C(C(CO)=O)(CC(C)O)O)(O)=O,,,5,1,1,0,1
23111_0,,,,2,1,1,2
23113_0,,,,2,1,1,2
C(C(C)(CC(C(CO)=O)O)O)(O)=O,,,5,1,1,0,1
23115_0,,,,2,1,1,2
C(C(C(CO)=O)(CC(O)=O)O)(O)=O,,,5,1,3,0,3
23116_0,,,,2,1,1,2
23117_0,,,,2,1,1,2
23118_0,,,,2,1,1,2
23119_0,,,,2,1,1,2
23121_0,,,,2,1,1,2
C(C(C)O)(C1C(C(OC1C)=O)=O)=O,,,5,1,1,0,1
23123_0,,,,2,1,1,2
C1(C(C(C(C)O)=O)C(C(O1)=O)=O)=O,,,5,1,1,0,1
23125_0,,,,2,1,1,2
C(CC(C(CC[CH]C(O)=O)O)=O)=O,,,5,1,2,0,2
23127_0,,,,2,1,1,2
C(CCCC(C(CC=O)=O)O)(O)=O,,,5,1,2,0,2
23129_0,,,,2,1,1,2
C(C(C)O)(C(C=O)C[CH]C(O)=O)=O,,,5,1,2,0,2
23131_0,,,,2,1,1,2
C(CCC(C=O)C(C(C)O)=O)(O)=O,,,5,1,2,0,2
23132_0,,,,2,1,1,2
23133_0,,,,2,1,1,2
23134_0,,,,2,1,1,2
23135_0,,,,2,1,1,2
23136_0,,,,2,1,1,2
23137_0,,,,2,1,1,2
23138_0,,,,2,1,1,2
23140_0,,,,2,1,1,2
C(C(C(C(C=O)O)=O)C(C)O)=O,,,5,1,1,0,1
23142_0,,,,2,1,1,2
C(C(C=O)C(C(C=O)O)=O)(O)=O,,,5,1,4,0,4
23144_0,,,,2,1,1,2
C(C(C(C(C(C=O)=O)O)=O)O)=O,,,5,1,1,0,1
23145_0,,,,2,1,1,2
23146_0,,,,2,1,1,2
23147_0,,,,2,1,1,2
23148_0,,,,2,1,1,2
23150_0,,,,2,1,1,2
C(C(C(CC(C=O)=O)=O)O)=O,,,5,1,2,0,2
23152_0,,,,2,1,1,2
C(CC(C(C=O)O)=O)=O,,,5,1,2,0,2
23154_0,,,,2,1,1,2
C(C(C(CC(C(O)=O)=O)=O)O)=O,,,5,1,2,0,2
23155_0,,,,2,1,1,2
23156_0,,,,2,1,1,2
23157_0,,,,2,1,1,2
23158_0,,,,2,1,1,2
23159_0,,,,2,1,1,2
23160_0,,,,2,1,1,2
23161_0,,,,2,1,1,2
23162_0,,,,2,1,1,2
23163_0,,,,2,1,1,2
23164_0,,,,2,1,1,2
23165_0,,,,2,1,1,2
23166_0,,,,2,1,1,2
23167_0,,,,2,1,1,2
23168_0,,,,2,1,1,2
23169_0,,,,2,1,1,2
23170_0,,,,2,1,1,2
23171_0,,,,2,1,1,2
23172_0,,,,2,1,1,2
23173_0,,,,2,1,1,2
23174_0,,,,2,1,1,2
23175_0,,,,2,1,1,2
23176_0,,,,2,1,1,2
23177_0,,,,2,1,1,2
23178_0,,,,2,1,1,2
23179_0,,,,2,1,1,2
23180_0,,,,2,1,1,2
23181_0,,,,2,1,1,2
23182_0,,,,2,1,1,2
23183_0,,,,2,1,1,2
23184_0,,,,2,1,1,2
23185_0,,,,2,1,1,2
23186_0,,,,2,1,1,2
23187_0,,,,2,1,1,2
23188_0,,,,2,1,1,2
23189_0,,,,2,1,1,2
23190_0,,,,2,1,1,2
23192_0,,,,2,1,1,2
C(C(C(C=C)=O)O)=O,,,5,1,3,0,3
23194_0,,,,2,1,1,2
C(C(C(C(C(O)=O)=C)=O)O)=O,,,5,1,3,0,3
23195_0,,,,2,1,1,2
23196_0,,,,2,1,1,2
23197_0,,,,2,1,1,2
23198_0,,,,2,1,1,2
23199_0,,,,2,1,1,2
23200_0,,,,2,1,1,2
23201_0,,,,2,1,1,2
23202_0,,,,2,1,1,2
23203_0,,,,2,1,1,2
23204_0,,,,2,1,1,2
23205_0,,,,2,1,1,2
23206_0,,,,2,1,1,2
23207_0,,,,2,1,1,2
23208_0,,,,2,1,1,2
23209_0,,,,2,1,1,2
23210_0,,,,2,1,1,2
23211_0,,,,2,1,1,2
23212_0,,,,2,1,1,2
23213_0,,,,2,1,1,2
23214_0,,,,2,1,1,2
23215_0,,,,2,1,1,2
23216_0,,,,2,1,1,2
23217_0,,,,2,1,1,2
23218_0,,,,2,1,1,2
23219_0,,,,2,1,1,2
23220_0,,,,2,1,1,2
23221_0,,,,2,1,1,2
23222_0,,,,2,1,1,2
23223_0,,,,2,1,1,2
23224_0,,,,2,1,1,2
23225_0,,,,2,1,1,2
23226_0,,,,2,1,1,2
23227_0,,,,2,1,1,2
23228_0,,,,2,1,1,2
23229_0,,,,2,1,1,2
23230_0,,,,2,1,1,2
23231_0,,,,2,1,1,2
23232_0,,,,2,1,1,2
23233_0,,,,2,1,1,2
23234_0,,,,2,1,1,2
23235_0,,,,2,1,1,2
23236_0,,,,2,1,1,2
23237_0,,,,2,1,1,2
23238_0,,,,2,1,1,2
23239_0,,,,2,1,1,2
23240_0,,,,2,1,1,2
23241_0,,,,2,1,1,2
23242_0,,,,2,1,1,2
23243_0,,,,2,1,1,2
23244_0,,,,2,1,1,2
23245_0,,,,2,1,1,2
23246_0,,,,2,1,1,2
23247_0,,,,2,1,1,2
23248_0,,,,2,1,1,2
23249_0,,,,2,1,1,2
23250_0,,,,2,1,1,2
23251_0,,,,2,1,1,2
23252_0,,,,2,1,1,2
23253_0,,,,2,1,1,2
23255_0,,,,2,1,1,2
C(C(C(C(CO)=O)=O)(CO)O)(O)=O,,,5,1,5,0,5
23256_0,,,,2,1,1,2
23257_0,,,,2,1,1,2
23258_0,,,,2,1,1,2
23259_0,,,,2,1,1,2
23260_0,,,,2,1,1,2
23261_0,,,,2,1,1,2
23262_0,,,,2,1,1,2
23263_0,,,,2,1,1,2
23264_0,,,,2,1,1,2
23265_0,,,,2,1,1,2
23266_0,,,,2,1,1,2
23267_0,,,,2,1,1,2
23268_0,,,,2,1,1,2
23269_0,,,,2,1,1,2
23270_0,,,,2,1,1,2
23271_0,,,,2,1,1,2
23272_0,,,,2,1,1,2
23273_0,,,,2,1,1,2
23274_0,,,,2,1,1,2
23275_0,,,,2,1,1,2
23276_0,,,,2,1,1,2
23277_0,,,,2,1,1,2
23278_0,,,,2,1,1,2
23279_0,,,,2,1,1,2
23280_0,,,,2,1,1,2
23281_0,,,,2,1,1,2
23282_0,,,,2,1,1,2
23283_0,,,,2,1,1,2
23284_0,,,,2,1,1,2
23285_0,,,,2,1,1,2
23286_0,,,,2,1,1,2
23287_0,,,,2,1,1,2
23288_0,,,,2,1,1,2
23289_0,,,,2,1,1,2
23290_0,,,,2,1,1,2
23291_0,,,,2,1,1,2
23292_0,,,,2,1,1,2
23293_0,,,,2,1,1,2
23295_0,,,,2,1,1,2
C(C(CO)O)(C(CO)C(C)O)=O,,,5,1,2,0,2
23297_0,,,,2,1,1,2
C(C(C)O)(C(CO)C(C)O)=O,,,5,1,2,0,2
23298_0,,,,2,1,1,2
23300_0,,,,2,1,1,2
C(C(C(C(CO)O)=O)CO)(O)=O,,,5,1,4,0,4
23301_0,,,,2,1,1,2
23302_0,,,,2,1,1,2
23303_0,,,,2,1,1,2
23304_0,,,,2,1,1,2
23306_0,,,,2,1,1,2
C(C(CO)O)(C[CH]C(O)=O)=O,,,5,1,3,0,3
23307_0,,,,2,1,1,2
23309_0,,,,2,1,1,2
C(CCC(O)=O)(C(CO)O)=O,,,5,1,3,0,3
23310_0,,,,2,1,1,2
23311_0,,,,2,1,1,2
23312_0,,,,2,1,1,2
23313_0,,,,2,1,1,2
23315_0,,,,2,1,1,2
C(C(C(C(CO)O)=O)C(C)O)(O)=O,,,5,1,2,0,2
23316_0,,,,2,1,1,2
23317_0,,,,2,1,1,2
23319_0,,,,2,1,1,2
C(C(C(O)=O)C(C(CO)O)=O)(O)=O,,,5,1,2,0,2
23320_0,,,,2,1,1,2
23321_0,,,,2,1,1,2
23322_0,,,,2,1,1,2
23323_0,,,,2,1,1,2
23325_0,,,,2,1,1,2
C(C(C(C(C)O)=O)(CO)C(C)O)=O,,,5,1,2,0,2
23327_0,,,,2,1,1,2
C(C(C(CO)=O)(CO)C(C)O)=O,,,5,1,1,0,1
23329_0,,,,2,1,1,2
C(C(C(CO)=O)(C(C)O)C(C)O)=O,,,5,1,1,0,1
23331_0,,,,2,1,1,2
C(C(C=O)(C(CO)=O)C(C)O)(O)=O,,,5,1,1,0,1
23332_0,,,,2,1,1,2
23334_0,,,,2,1,1,2
C(C(C=O)(C(C(C)O)=O)CO)(O)=O,,,5,1,2,0,2
23336_0,,,,2,1,1,2
C(C(C=O)(C(CO)=O)CO)(O)=O,,,5,1,1,0,1
23338_0,,,,2,1,1,2
C(C(C(O)=O)(C=O)C(CO)=O)(O)=O,,,5,1,1,0,1
23340_0,,,,2,1,1,2
C(C(C=O)O)(C(C(C)=O)(CO)O)=O,,,5,1,3,0,3
23342_0,,,,2,1,1,2
C(C(C)O)(C(C(C=O)=O)(CO)O)=O,,,5,1,4,0,4
23343_0,,,,2,1,1,2
23345_0,,,,2,1,1,2
C(CO)(C(C(C=O)=O)(C(C)O)O)=O,,,5,1,4,0,4
23347_0,,,,2,1,1,2
C(C(C(CO)=O)(C(C=O)=O)O)(O)=O,,,5,1,4,0,4
23349_0,,,,2,1,1,2
C(C(C=O)(C(C(CCO)O)=O)O)=O,,,5,1,1,0,1
23351_0,,,,2,1,1,2
C(C(C(C(CCO)O)=O)CO)(O)=O,,,5,1,1,0,1
23353_0,,,,2,1,1,2
C(C(C(C(CCO)O)=O)(CO)O)=O,,,5,1,1,0,1
23355_0,,,,2,1,1,2
C(C(C=O)(C(CO)=O)O)=O,,,5,1,1,0,1
23357_0,,,,2,1,1,2
C(C(C=O)(C(CO)=O)O)(O)=O,,,5,1,3,0,3
23358_0,,,,2,1,1,2
23359_0,,,,2,1,1,2
23360_0,,,,2,1,1,2
23362_0,,,,2,1,1,2
C(C(C(CO)=O)(C(C)O)O)(O)=O,,,5,1,6,0,6
23364_0,,,,2,1,1,2
C(C(C(O)=O)(C(CO)=O)O)(O)=O,,,5,1,4,0,4
23366_0,,,,2,1,1,2
C(C)(C(C(O)=O)(C(CO)=O)CO)=O,,,5,1,1,0,1
23368_0,,,,2,1,1,2
C(C)(C(C(O)=O)(C(CO)=O)C)=O,,,5,1,1,0,1
23369_0,,,,2,1,1,2
23370_0,,,,2,1,1,2
23371_0,,,,2,1,1,2
23372_0,,,,2,1,1,2
23374_0,,,,2,1,1,2
C(C(C=O)(C(C(CO)O)=O)O)=O,,,5,1,1,0,1
23376_0,,,,2,1,1,2
C(C(C=O)(C(C(C)O)=O)O)=O,,,5,1,1,0,1
23377_0,,,,2,1,1,2
23378_0,,,,2,1,1,2
23379_0,,,,2,1,1,2
23381_0,,,,2,1,1,2
C(C(C=O)(C(C(CO)O)=O)O)(O)=O,,,5,1,1,0,1
23383_0,,,,2,1,1,2
C(C(C=O)(C(C(C)O)=O)O)(O)=O,,,5,1,3,0,3
23384_0,,,,2,1,1,2
23386_0,,,,2,1,1,2
C(C(C(C(C)O)=O)(C(C)O)O)(O)=O,,,5,1,3,0,3
23388_0,,,,2,1,1,2
C(C(C(O)=O)(C(C(C)O)=O)O)(O)=O,,,5,1,3,0,3
23390_0,,,,2,1,1,2
C(C(C)O)(C(C(O)=O)(C(C)=O)C)=O,,,5,1,1,0,1
23391_0,,,,2,1,1,2
23393_0,,,,2,1,1,2
C(CC(C(CO)=O)(C(CO)=O)O)=O,,,5,1,1,0,1
23395_0,,,,2,1,1,2
C(CC(C(C=O)O)(C(C=O)O)O)=O,,,5,1,1,0,1
23396_0,,,,2,1,1,2
23397_0,,,,2,1,1,2
23398_0,,,,2,1,1,2
23400_0,,,,2,1,1,2
C(C(C(C(C(CO)O)O)=O)(C)O)=O,,,5,1,1,0,1
23401_0,,,,2,1,1,2
23402_0,,,,2,1,1,2
23404_0,,,,2,1,1,2
C(C(C(C(CCO)O)=O)(C)O)=O,,,5,1,1,0,1
23406_0,,,,2,1,1,2
C(C(C(C(CC(C)O)O)=O)(C)O)=O,,,5,1,1,0,1
23408_0,,,,2,1,1,2
C(CC(C(C(C=O)(C)O)=O)O)(O)=O,,,5,1,1,0,1
23410_0,,,,2,1,1,2
C(CO)(C(C(C(CO)=O)=O)(C)O)=O,,,5,1,1,0,1
23412_0,,,,2,1,1,2
C(C(C)(C(C=O)O)O)(C(C=O)O)=O,,,5,1,2,0,2
23414_0,,,,2,1,1,2
C(C(C(C(C)(C(CO)O)O)=O)O)=O,,,5,1,2,0,2
23416_0,,,,2,1,1,2
C(C(C(C(C)(C(C)O)O)=O)O)=O,,,5,1,2,0,2
23417_0,,,,2,1,1,2
23419_0,,,,2,1,1,2
C(CO)(C(C(C(C)=O)=O)(C)O)=O,,,5,1,1,0,1
23421_0,,,,2,1,1,2
C(C(C)O)(C(C(C(C)=O)=O)(C)O)=O,,,5,1,1,0,1
23423_0,,,,2,1,1,2
C(C(C)(C(C)(C(C(C)=O)O)O)O)=O,,,5,1,2,0,2
23424_0,,,,2,1,1,2
23425_0,,,,2,1,1,2
23427_0,,,,2,1,1,2
C(C(C)OC(C(CO)=O)=O)(O)=O,,,5,1,1,0,1
23428_0,,,,2,1,1,2
23429_0,,,,2,1,1,2
23430_0,,,,2,1,1,2
23431_0,,,,2,1,1,2
23433_0,,,,2,1,1,2
C(C(C=O)C(C(C=O)O)=O)=O,,,5,1,3,0,3
23435_0,,,,2,1,1,2
C(C(C=O)C(C(C(O)=O)O)=O)=O,,,5,1,3,0,3
23436_0,,,,2,1,1,2
23438_0,,,,2,1,1,2
C(C(C(C(C=O)O)=O)CO)(O)=O,,,5,1,2,0,2
23439_0,,,,2,1,1,2
23441_0,,,,2,1,1,2
C(C(C(C(C=O)O)=O)C)(O)=O,,,5,1,2,0,2
23442_0,,,,2,1,1,2
23443_0,,,,2,1,1,2
23444_0,,,,2,1,1,2
23446_0,,,,2,1,1,2
C(C(C(C=CC(C)O)=O)O)=O,,,5,1,2,0,2
23448_0,,,,2,1,1,2
C(C(C(C=CC(C)O)=O)O)(O)=O,,,5,1,2,0,2
23450_0,,,,2,1,1,2
C(C(C=C(C=O)C(C)O)O)=O,,,5,1,2,0,2
23452_0,,,,2,1,1,2
C(C(C(C(C=O)=CC)O)O)=O,,,5,1,2,0,2
23454_0,,,,2,1,1,2
C(C)=C(C(C(CO)O)=O)C=O,,,5,1,2,0,2
23456_0,,,,2,1,1,2
C(C)=C(C(C(C)O)=O)C=O,,,5,1,2,0,2
23458_0,,,,2,1,1,2
C(C(C(C=CC(O)=O)=O)O)=O,,,5,1,2,0,2
23460_0,,,,2,1,1,2
C(C(C(C=CC(O)=O)=O)O)(O)=O,,,5,1,2,0,2
23462_0,,,,2,1,1,2
C(C(C=C(C(O)=O)C=O)O)=O,,,5,1,2,0,2
23464_0,,,,2,1,1,2
C(C(C=CC(C=O)=O)O)=O,,,5,1,2,0,2
23466_0,,,,2,1,1,2
C(C(C=CC=O)O)=O,,,5,1,3,0,3
23468_0,,,,2,1,1,2
C(C(C=CC(C(O)=O)=O)O)=O,,,5,1,3,0,3
23470_0,,,,2,1,1,2
C(C(C(C(C=O)=C)=O)O)=O,,,5,1,2,0,2
23471_0,,,,2,1,1,2
23473_0,,,,2,1,1,2
C(C(C(C(C=O)=C)=O)O)(O)=O,,,5,1,2,0,2
23475_0,,,,2,1,1,2
C(C(C(C=C)=O)O)(O)=O,,,5,1,2,0,2
23477_0,,,,2,1,1,2
C(C(C(C(C(O)=O)=C)=O)O)(O)=O,,,5,1,2,0,2
23478_0,,,,2,1,1,2
23480_0,,,,2,1,1,2
C=C(C(O)=O)C(C(CO)O)=O,,,5,1,3,0,3
23482_0,,,,2,1,1,2
C=C(C(O)=O)C(C(C)O)=O,,,5,1,2,0,2
23483_0,,,,2,1,1,2
23484_0,,,,2,1,1,2
23486_0,,,,2,1,1,2
C(C(CO)O)(C(CO)(C(C)O)O)=O,,,5,1,2,0,2
23488_0,,,,2,1,1,2
C(C(C)O)(C(CO)(C(C)O)O)=O,,,5,1,4,0,4
23489_0,,,,2,1,1,2
23490_0,,,,2,1,1,2
23491_0,,,,2,1,1,2
23492_0,,,,2,1,1,2
23494_0,,,,2,1,1,2
C(C(C)O)(C([C](C(O)=O)O)O)=O,,,5,1,3,0,3
23495_0,,,,2,1,1,2
23497_0,,,,2,1,1,2
C1(C(C(C(C(C)(O)O1)O)=O)O)=O,,,5,1,3,0,3
23498_0,,,,2,1,1,2
23499_0,,,,2,1,1,2
23500_0,,,,2,1,1,2
23501_0,,,,2,1,1,2
23502_0,,,,2,1,1,2
23503_0,,,,2,1,1,2
23504_0,,,,2,1,1,2
23506_0,,,,2,1,1,2
C1(C(CC(C)O)OC(C1O)O)=O,,,5,1,2,0,2
23508_0,,,,2,1,1,2
C1(C(C(C(CC(C)O)O1)O)O)=O,,,5,1,3,0,3
23510_0,,,,2,1,1,2
C1(C(CC(CC(C)O)O1)O)=O,,,5,1,2,0,2
23512_0,,,,2,1,1,2
C(CC1C(C(C(O1)O)O)=O)(O)=O,,,5,1,2,0,2
23514_0,,,,2,1,1,2
C(CC1C(C(C(O1)=O)O)O)(O)=O,,,5,1,3,0,3
23516_0,,,,2,1,1,2
C(CC1CC(C(O1)=O)O)(O)=O,,,5,1,2,0,2
23518_0,,,,2,1,1,2
C1(C(C(OC1C(CO)=O)O)O)=O,,,5,1,2,0,2
23520_0,,,,2,1,1,2
C1(C(C(C(C(CO)=O)O1)O)O)=O,,,5,1,3,0,3
23522_0,,,,2,1,1,2
C(C(C1C(C(C(O)O1)=O)O)O)=O,,,5,1,2,0,2
23524_0,,,,2,1,1,2
C1(C(CC(C(CO)=O)O1)O)=O,,,5,1,2,0,2
23526_0,,,,2,1,1,2
C(C(C1CC(C(O)O1)=O)O)=O,,,5,1,2,0,2
23528_0,,,,2,1,1,2
C(C1(C(C(C(O1)O)O)=O)CO)=O,,,5,1,2,0,2
23530_0,,,,2,1,1,2
C(C1(CO)C(C(C(O1)=O)O)O)=O,,,5,1,3,0,3
23532_0,,,,2,1,1,2
C(C1(CO)CC(C(O1)=O)O)=O,,,5,1,2,0,2
23534_0,,,,2,1,1,2
C(C1(C(C(C(O1)O)O)=O)C)=O,,,5,1,2,0,2
23536_0,,,,2,1,1,2
C(C1(C)C(C(C(O1)=O)O)O)=O,,,5,1,3,0,3
23538_0,,,,2,1,1,2
C1(C(C(OC1C(C)=O)O)O)=O,,,5,1,2,0,2
23540_0,,,,2,1,1,2
C1(C(C(C(C(C)=O)O1)O)O)=O,,,5,1,3,0,3
23542_0,,,,2,1,1,2
C1(COC(C1O)O)=O,,,5,1,2,0,2
23544_0,,,,2,1,1,2
C1(C(C(CO1)O)O)=O,,,5,1,3,0,3
23546_0,,,,2,1,1,2
C(C1(C(C(C(O1)O)O)=O)CO)(O)=O,,,5,1,2,0,2
23548_0,,,,2,1,1,2
C(C1(CO)C(C(C(O1)=O)O)O)(O)=O,,,5,1,2,0,2
23550_0,,,,2,1,1,2
C1(C(C)OC(C1O)O)=O,,,5,1,2,0,2
23551_0,,,,2,1,1,2
23553_0,,,,2,1,1,2
C1(C(C(C(O)O1)O)=O)=O,,,5,1,2,0,2
23554_0,,,,2,1,1,2
23556_0,,,,2,1,1,2
C(C1(C(C(C(O1)O)O)=O)C)(O)=O,,,5,1,2,0,2
23557_0,,,,2,1,1,2
23559_0,,,,2,1,1,2
C(C1(C)CC(C(O1)=O)O)=O,,,5,1,2,0,2
23561_0,,,,2,1,1,2
C1(C(CC(C(C)=O)O1)O)=O,,,5,1,2,0,2
23563_0,,,,2,1,1,2
C1(C(CCO1)O)=O,,,5,1,2,0,2
23565_0,,,,2,1,1,2
C(C1(CO)CC(C(O1)=O)O)(O)=O,,,5,1,2,0,2
23566_0,,,,2,1,1,2
23567_0,,,,2,1,1,2
23568_0,,,,2,1,1,2
23570_0,,,,2,1,1,2
C(C1C(C(C(C)(O1)O)O)=O)(O)=O,,,5,1,2,0,2
23572_0,,,,2,1,1,2
C1(C(COC(C1C(C)O)O)O)=O,,,5,1,2,0,2
23574_0,,,,2,1,1,2
C(C1C(C(COC1O)O)=O)(O)=O,,,5,1,2,0,2
23576_0,,,,2,1,1,2
C1(C(C(C=O)(O)OCC1O)O)=O,,,5,1,2,0,2
23578_0,,,,2,1,1,2
C1(CC(C=O)(O)OCC1O)=O,,,5,1,2,0,2
23580_0,,,,2,1,1,2
C1(C(C(C(C(CO)(O)O1)O)=O)O)=O,,,5,1,2,0,2
23582_0,,,,2,1,1,2
C1(C(C(C(O)=O)(O)OCC1O)O)=O,,,5,1,2,0,2
23584_0,,,,2,1,1,2
C1(C(COC(C1)O)O)=O,,,5,1,2,0,2
23585_0,,,,2,1,1,2
23587_0,,,,2,1,1,2
C(C1(C(C(C(O)OC1)O)=O)O)=O,,,5,1,2,0,2
23589_0,,,,2,1,1,2
C(C1(COC(C(C1O)O)=O)O)=O,,,5,1,3,0,3
23591_0,,,,2,1,1,2
C(C1(COC(C(C1)O)=O)O)=O,,,5,1,2,0,2
23593_0,,,,2,1,1,2
C1(C(C(C(CO)(C(O)O1)O)=O)O)=O,,,5,1,2,0,2
23595_0,,,,2,1,1,2
C(C1(C(C(C(O)OC1)O)=O)O)(O)=O,,,5,1,2,0,2
23597_0,,,,2,1,1,2
C(C1(COC(C(C1O)O)=O)O)(O)=O,,,5,1,2,0,2
23599_0,,,,2,1,1,2
C1(C(C(C(C(O)O1)O)=O)(CO)O)=O,,,5,1,2,0,2
23601_0,,,,2,1,1,2
C1(C(CO)(C(C(C(O1)=O)O)O)O)=O,,,5,1,2,0,2
23603_0,,,,2,1,1,2
C1(C(C(C(C(O)O1)O)=O)(C)O)=O,,,5,1,2,0,2
23604_0,,,,2,1,1,2
23606_0,,,,2,1,1,2
C1(C(C(C(C)(C(O)O1)O)=O)O)=O,,,5,1,2,0,2
23608_0,,,,2,1,1,2
C(C1(COC(C(C1)O)=O)O)(O)=O,,,5,1,2,0,2
23610_0,,,,2,1,1,2
C1(C(CO)(CC(C(O1)=O)O)O)=O,,,5,1,2,0,2
23611_0,,,,2,1,1,2
23612_0,,,,2,1,1,2
23614_0,,,,2,1,1,2
C1(C(CC(C)OC(C1O)O)O)=O,,,5,1,2,0,2
23616_0,,,,2,1,1,2
C1(C(C(C(CC(C)O1)O)O)O)=O,,,5,1,3,0,3
23618_0,,,,2,1,1,2
C1(C(CC(CC(C)O1)O)O)=O,,,5,1,2,0,2
23620_0,,,,2,1,1,2
C1(CC(C(C(C(O)O1)O)=O)O)=O,,,5,1,2,0,2
23622_0,,,,2,1,1,2
C1(CC(C(C(C(O1)=O)O)O)O)=O,,,5,1,3,0,3
23624_0,,,,2,1,1,2
C1(CC(CC(C(O1)=O)O)O)=O,,,5,1,2,0,2
23626_0,,,,2,1,1,2
C1(C(C(OCC(C1O)=O)O)O)=O,,,5,1,2,0,2
23628_0,,,,2,1,1,2
C1(C(C(C(C(CO1)=O)O)O)O)=O,,,5,1,3,0,3
23630_0,,,,2,1,1,2
C1(C(COC(C(C1O)=O)O)O)=O,,,5,1,2,0,2
23632_0,,,,2,1,1,2
C1(C(CC(C(CO1)=O)O)O)=O,,,5,1,2,0,2
23634_0,,,,2,1,1,2
C1(C(COC(C(C1)=O)O)O)=O,,,5,1,2,0,2
23636_0,,,,2,1,1,2
C1(C(C(O)OC([CH]C1)=O)O)=O,,,5,1,2,0,2
23637_0,,,,2,1,1,2
23639_0,,,,2,1,1,2
C1(CCC(OC(C1O)O)=O)=O,,,5,1,2,0,2
23640_0,,,,2,1,1,2
23641_0,,,,2,1,1,2
23642_0,,,,2,1,1,2
23643_0,,,,2,1,1,2
23644_0,,,,2,1,1,2
23646_0,,,,2,1,1,2
C1(C(C(C(CC(C)O)O1)=O)O)=O,,,5,1,2,0,2
23648_0,,,,2,1,1,2
C1(C(C(C(CC(O)=O)O1)=O)O)=O,,,5,1,2,0,2
23650_0,,,,2,1,1,2
C1(C(C(C(C(CO)=O)O1)=O)O)=O,,,5,1,2,0,2
23652_0,,,,2,1,1,2
C(C(C1C(C(C(O1)=O)=O)O)O)=O,,,5,1,2,0,2
23654_0,,,,2,1,1,2
C(C(C1CC(C(O1)=O)=O)O)=O,,,5,1,2,0,2
23656_0,,,,2,1,1,2
C(C1(C(C(C(O1)=O)O)=O)CO)=O,,,5,1,2,0,2
23658_0,,,,2,1,1,2
C(C1(C(C(C(O1)=O)O)=O)C)=O,,,5,1,2,0,2
23660_0,,,,2,1,1,2
C1(C(C(C(C(C)=O)O1)=O)O)=O,,,5,1,3,0,3
23662_0,,,,2,1,1,2
C1(C(C(CO1)=O)O)=O,,,5,1,2,0,2
23664_0,,,,2,1,1,2
C1(C(C(C(C)O1)=O)O)=O,,,5,1,3,0,3
23665_0,,,,2,1,1,2
23667_0,,,,2,1,1,2
C(C1(C(C(C(O1)=O)O)=O)C)(O)=O,,,5,1,2,0,2
23669_0,,,,2,1,1,2
C1(C(C=O)C(C(CO1)O)=O)=O,,,5,1,2,0,2
23671_0,,,,2,1,1,2
C(C1(C(C(C(OC1)=O)O)=O)O)=O,,,5,1,2,0,2
23673_0,,,,2,1,1,2
C1(C(C(C(C(O1)=O)O)=O)(C)O)=O,,,5,1,2,0,2
23675_0,,,,2,1,1,2
C1(C(C(C(CO1)O)=O)(CO)O)=O,,,5,1,2,0,2
23677_0,,,,2,1,1,2
C1(C(C(C(CO1)O)=O)O)=O,,,5,1,2,0,2
23679_0,,,,2,1,1,2
C1(C(C(C(CO1)O)=O)(C)O)=O,,,5,1,2,0,2
23681_0,,,,2,1,1,2
C1(C(C(C(CC(C)O1)O)=O)O)=O,,,5,1,2,0,2
23683_0,,,,2,1,1,2
C1(C(C(C(CC(O1)=O)O)=O)O)=O,,,5,1,2,0,2
23685_0,,,,2,1,1,2
C1(C(C(C(C(CO1)=O)O)=O)O)=O,,,5,1,2,0,2
23687_0,,,,2,1,1,2
C1(C(COC(C(C1O)=O)=O)O)=O,,,5,1,2,0,2
23688_0,,,,2,1,1,2
23689_0,,,,2,1,1,2
23691_0,,,,2,1,1,2
C1(C(C(C[CH]C(O1)=O)=O)O)=O,,,5,1,2,0,2
23693_0,,,,2,1,1,2
C1(C(C(CCC(O1)=O)=O)O)=O,,,5,1,2,0,2
23695_0,,,,2,1,1,2
C(CC(C)C(C(C(C=O)O)=O)O)=O,,,5,1,2,0,2
23697_0,,,,2,1,1,2
C(C(C(C(C[CH]C(O)=O)O)=O)O)=O,,,5,1,2,0,2
23699_0,,,,2,1,1,2
C(CCC(C(C(C=O)O)=O)O)(O)=O,,,5,1,2,0,2
23701_0,,,,2,1,1,2
C(CC(C)C(C=O)C(C(C)O)=O)=O,,,5,1,2,0,2
23703_0,,,,2,1,1,2
C(CC(C)CC(C(CC=O)=O)O)=O,,,5,1,2,0,2
23705_0,,,,2,1,1,2
C(CC(C)CC(C(C(C)=O)O)=O)=O,,,5,1,3,0,3
23707_0,,,,2,1,1,2
C(CC[CH]C(O)=O)(C(C(C)=O)O)=O,,,5,1,3,0,3
23709_0,,,,2,1,1,2
C(CCCC(C(C(C)=O)O)=O)(O)=O,,,5,1,3,0,3
23710_0,,,,2,1,1,2
23711_0,,,,2,1,1,2
23712_0,,,,2,1,1,2
23714_0,,,,2,1,1,2
C(C(C)CC=O)(C(CO)O)=O,,,5,1,1,0,1
23715_0,,,,2,1,1,2
23716_0,,,,2,1,1,2
23717_0,,,,2,1,1,2
23718_0,,,,2,1,1,2
23719_0,,,,2,1,1,2
23720_0,,,,2,1,1,2
23721_0,,,,2,1,1,2
23722_0,,,,2,1,1,2
23724_0,,,,2,1,1,2
C(C(C)CC=O)(C(C)O)=O,,,5,1,1,0,1
23726_0,,,,2,1,1,2
C(C(C)CC(C(O)=O)=O)(C(C)O)=O,,,5,1,1,0,1
23728_0,,,,2,1,1,2
C(CC(C(O)=O)CC=O)(C(C)O)=O,,,5,1,1,0,1
23730_0,,,,2,1,1,2
C(C(C)O)(C(C(O)=O)(C)CC=O)=O,,,5,1,1,0,1
23732_0,,,,2,1,1,2
C(C(C)O)(C(C=O)C(C(O)=O)C)=O,,,5,1,1,0,1
23734_0,,,,2,1,1,2
C(C(C(C)O)CC(C(C)O)=O)(O)=O,,,5,1,1,0,1
23736_0,,,,2,1,1,2
C(C(C(O)=O)CC(C(C)O)=O)(O)=O,,,5,1,1,0,1
23738_0,,,,2,1,1,2
C(C(C)O)(C[CH]C(O)=O)=O,,,5,1,1,0,1
23740_0,,,,2,1,1,2
C(CCC(O)=O)(C(C)O)=O,,,5,1,1,0,1
23741_0,,,,2,1,1,2
23742_0,,,,2,1,1,2
23743_0,,,,2,1,1,2
23745_0,,,,2,1,1,2
C(C(C)CC=O)(C(C=O)O)=O,,,5,1,2,0,2
23747_0,,,,2,1,1,2
C(C(C)CC=O)(C(C(O)=O)O)=O,,,5,1,2,0,2
23749_0,,,,2,1,1,2
C(CO)(C(C)CC(C(O)=O)=O)=O,,,5,1,1,0,1
23750_0,,,,2,1,1,2
23752_0,,,,2,1,1,2
C(C(CC=O)CC(CO)=O)(O)=O,,,5,1,1,0,1
23753_0,,,,2,1,1,2
23755_0,,,,2,1,1,2
C(CO)(C(C(O)=O)(C)CC=O)=O,,,5,1,1,0,1
23756_0,,,,2,1,1,2
23758_0,,,,2,1,1,2
C(C(C)C(C=O)C(CO)=O)(O)=O,,,5,1,1,0,1
23759_0,,,,2,1,1,2
23761_0,,,,2,1,1,2
C(C(C(C)O)CC(CO)=O)(O)=O,,,5,1,2,0,2
23762_0,,,,2,1,1,2
23764_0,,,,2,1,1,2
C(C(C(O)=O)CC(CO)=O)(O)=O,,,5,1,2,0,2
23765_0,,,,2,1,1,2
23766_0,,,,2,1,1,2
23767_0,,,,2,1,1,2
23769_0,,,,2,1,1,2
C(C(C(C([C](C(O)=O)O)O)O)O)=O,,,5,1,3,0,3
23770_0,,,,2,1,1,2
23772_0,,,,2,1,1,2
C(C(C(C[C](C(O)=O)O)O)O)=O,,,5,1,2,0,2
23773_0,,,,2,1,1,2
23774_0,,,,2,1,1,2
23775_0,,,,2,1,1,2
23776_0,,,,2,1,1,2
23777_0,,,,2,1,1,2
23778_0,,,,2,1,1,2
23779_0,,,,2,1,1,2
23780_0,,,,2,1,1,2
23781_0,,,,2,1,1,2
23782_0,,,,2,1,1,2
23783_0,,,,2,1,1,2
23784_0,,,,2,1,1,2
23785_0,,,,2,1,1,2
23786_0,,,,2,1,1,2
23787_0,,,,2,1,1,2
23788_0,,,,2,1,1,2
23789_0,,,,2,1,1,2
23790_0,,,,2,1,1,2
23791_0,,,,2,1,1,2
23792_0,,,,2,1,1,2
23793_0,,,,2,1,1,2
23794_0,,,,2,1,1,2
23795_0,,,,2,1,1,2
23796_0,,,,2,1,1,2
23797_0,,,,2,3,2,5
23798_0,,,,2,3,2,5
23799_0,,,,2,3,2,5
23800_0,,,,2,3,2,5
23801_0,,,,2,3,2,5
23803_0,,,,2,3,2,5
CC(CC(CC(C(CO)O)O)O)O,,,5,1,2,0,2
23805_0,,,,2,3,2,5
CC(CC(CC(CCO)O)O)O,,,5,1,1,0,1
23806_0,,,,2,3,2,5
23808_0,,,,2,3,2,5
C(C(C(CO)C(CC(C)O)O)O)=O,,,5,1,2,0,2
23810_0,,,,2,3,2,5
CC(CC(C(CO)C(CO)O)O)O,,,5,1,1,0,1
23812_0,,,,2,3,2,5
CC(CC(C(CO)CO)O)O,,,5,1,1,0,1
23813_0,,,,2,3,2,5
23815_0,,,,2,3,2,5
CC(C(CO)C(C(CO)CO)O)O,,,5,1,1,0,1
23817_0,,,,2,3,2,5
C=CC(CO)C(C(CO)C(C)O)O,,,5,1,1,0,1
23819_0,,,,2,3,2,5
CC(C(CO)C(C(CO)O)O)O,,,5,1,4,0,4
23821_0,,,,2,3,2,5
CC(C(CO)C(CCO)O)O,,,5,1,2,0,2
23822_0,,,,2,3,2,5
23824_0,,,,2,3,2,5
CC(C(C(C(CO)O)O)C(C)O)O,,,5,1,2,0,2
23826_0,,,,2,3,2,5
CC(C(C(CCO)O)C(C)O)O,,,5,1,1,0,1
23827_0,,,,2,3,2,5
23828_0,,,,2,3,2,5
23829_0,,,,2,3,2,5
23831_0,,,,2,3,2,5
C(CC(CC(C(CO)O)O)O)(O)=O,,,5,1,2,0,2
23833_0,,,,2,3,2,5
C(CC(CC(CCO)O)O)(O)=O,,,5,1,1,0,1
23834_0,,,,2,3,2,5
23836_0,,,,2,3,2,5
C(CC(C(CO)C(C=O)O)O)(O)=O,,,5,1,2,0,2
23838_0,,,,2,3,2,5
C(CC(C(CO)C(CO)O)O)(O)=O,,,5,1,1,0,1
23840_0,,,,2,3,2,5
C(CC(C(CO)CO)O)(O)=O,,,5,1,1,0,1
23841_0,,,,2,3,2,5
23843_0,,,,2,3,2,5
C(C(CO)C(C(CO)CO)O)(O)=O,,,5,1,2,0,2
23845_0,,,,2,3,2,5
C(C(CO)C(C(C=C)CO)O)(O)=O,,,5,1,2,0,2
23846_0,,,,2,3,2,5
23847_0,,,,2,3,2,5
23848_0,,,,2,3,2,5
23849_0,,,,2,3,2,5
23850_0,,,,2,3,2,5
23851_0,,,,2,3,2,5
23852_0,,,,2,3,2,5
23854_0,,,,2,3,2,5
C(CO)(C(CC(C(CO)O)O)O)=O,,,5,1,2,0,2
23856_0,,,,2,3,2,5
C(CO)(C(CC(CCO)O)O)=O,,,5,1,1,0,1
23857_0,,,,2,3,2,5
23858_0,,,,2,3,2,5
23859_0,,,,2,3,2,5
23860_0,,,,2,3,2,5
23861_0,,,,2,3,2,5
23863_0,,,,2,3,2,5
C(C(C(CO)C(C(CO)=O)O)O)=O,,,5,1,2,0,2
23865_0,,,,2,3,2,5
C(CO)(C(C(CO)C(CO)O)O)=O,,,5,1,1,0,1
23867_0,,,,2,3,2,5
C(CO)(C(C(CO)CO)O)=O,,,5,1,1,0,1
23868_0,,,,2,3,2,5
23869_0,,,,2,3,2,5
23870_0,,,,2,3,2,5
23871_0,,,,2,3,2,5
23872_0,,,,2,3,2,5
23873_0,,,,2,3,2,5
23874_0,,,,2,3,2,5
23875_0,,,,2,3,2,5
23877_0,,,,2,3,2,5
C(C(CO)(CC(C(CO)O)O)O)=O,,,5,1,2,0,2
23878_0,,,,2,3,2,5
23880_0,,,,2,3,2,5
C(C(CO)(CC(CCO)O)O)=O,,,5,1,1,0,1
23881_0,,,,2,3,2,5
23882_0,,,,2,3,2,5
23883_0,,,,2,3,2,5
23884_0,,,,2,3,2,5
23886_0,,,,2,3,2,5
C(C(CO)(C(CO)C(C=O)O)O)=O,,,5,1,2,0,2
23887_0,,,,2,3,2,5
23889_0,,,,2,3,2,5
C(C(CO)(C(CO)C(CO)O)O)=O,,,5,1,1,0,1
23890_0,,,,2,3,2,5
23892_0,,,,2,3,2,5
C(C(CO)(C(CO)CO)O)=O,,,5,1,1,0,1
23893_0,,,,2,3,2,5
23894_0,,,,2,3,2,5
23896_0,,,,2,3,2,5
C(C(C(CO)CO)O)(C(CO)O)=O,,,5,1,1,0,1
23898_0,,,,2,3,2,5
C(C(C(C=C)CO)O)(C(CO)O)=O,,,5,1,1,0,1
23899_0,,,,2,3,2,5
23901_0,,,,2,3,2,5
C(C(C(CO)O)(C(CO)CO)O)=O,,,5,1,1,0,1
23902_0,,,,2,3,2,5
23903_0,,,,2,3,2,5
23904_0,,,,2,3,2,5
23906_0,,,,2,3,2,5
C(C(C(CO)O)(C(C=C)CO)O)=O,,,5,1,1,0,1
23907_0,,,,2,3,2,5
23909_0,,,,2,3,2,5
C(C(C(CO)O)(C(CO)O)O)=O,,,5,1,4,0,4
23910_0,,,,2,3,2,5
23912_0,,,,2,3,2,5
C(C(C(CO)O)(CCO)O)=O,,,5,1,4,0,4
23913_0,,,,2,3,2,5
23914_0,,,,2,3,2,5
23915_0,,,,2,3,2,5
23916_0,,,,2,3,2,5
23918_0,,,,2,3,2,5
C(C(C(CO)O)(C(C(C)O)O)O)=O,,,5,1,6,0,6
23919_0,,,,2,3,2,5
23921_0,,,,2,3,2,5
C(C(CCO)(C(C(C)O)O)O)=O,,,5,1,2,0,2
23922_0,,,,2,3,2,5
23923_0,,,,2,3,2,5
23924_0,,,,2,3,2,5
23925_0,,,,2,3,2,5
23926_0,,,,2,3,2,5
23927_0,,,,2,3,2,5
23929_0,,,,2,3,2,5
C(C(C)(CC(C=O)(CCO)O)O)=O,,,5,1,1,0,1
23930_0,,,,2,3,2,5
23931_0,,,,2,3,2,5
23932_0,,,,2,3,2,5
23933_0,,,,2,3,2,5
23934_0,,,,2,3,2,5
23935_0,,,,2,3,2,5
23936_0,,,,2,3,2,5
23937_0,,,,2,3,2,5
23938_0,,,,2,3,2,5
23939_0,,,,2,3,2,5
23940_0,,,,2,3,2,5
23941_0,,,,2,3,2,5
23943_0,,,,2,3,2,5
C(C(C)(CC(C(CO)CO)O)O)=O,,,5,1,1,0,1
23944_0,,,,2,3,2,5
23945_0,,,,2,3,2,5
23946_0,,,,2,3,2,5
23948_0,,,,2,3,2,5
C(C(C)(CC(C(C=C)CO)O)O)=O,,,5,1,1,0,1
23949_0,,,,2,3,2,5
23951_0,,,,2,3,2,5
C(C(C)(CC(C(CO)O)O)O)=O,,,5,1,2,0,2
23952_0,,,,2,3,2,5
23954_0,,,,2,3,2,5
C(C(C)(CC(CCO)O)O)=O,,,5,1,1,0,1
23955_0,,,,2,3,2,5
23956_0,,,,2,3,2,5
23957_0,,,,2,3,2,5
23959_0,,,,2,3,2,5
C(CC(C)(C(C(CO)CO)O)O)=O,,,5,1,1,0,1
23960_0,,,,2,3,2,5
23961_0,,,,2,3,2,5
23962_0,,,,2,3,2,5
23964_0,,,,2,3,2,5
C(CC(C)(C(C(C=C)CO)O)O)=O,,,5,1,1,0,1
23965_0,,,,2,3,2,5
23966_0,,,,2,3,2,5
23967_0,,,,2,3,2,5
23968_0,,,,2,3,2,5
23969_0,,,,2,3,2,5
23970_0,,,,2,3,2,5
23971_0,,,,2,3,2,5
23973_0,,,,2,3,2,5
C(C(C)(C(CO)C(CCO)O)O)=O,,,5,1,1,0,1
23974_0,,,,2,3,2,5
23975_0,,,,2,3,2,5
23977_0,,,,2,3,2,5
C(C(C)(C(CO)C(C=O)O)O)=O,,,5,1,2,0,2
23978_0,,,,2,3,2,5
23980_0,,,,2,3,2,5
C(C(C)(C(CO)C(CO)(C)O)O)=O,,,5,1,1,0,1
23981_0,,,,2,3,2,5
23983_0,,,,2,3,2,5
C(C(C)(C(CO)C(C=CC)O)O)=O,,,5,1,1,0,1
23984_0,,,,2,3,2,5
23986_0,,,,2,3,2,5
C(C(C)(C(CO)C(CC=C)O)O)=O,,,5,1,1,0,1
23987_0,,,,2,3,2,5
23989_0,,,,2,3,2,5
C(C(C)(C(CO)C(CO)O)O)=O,,,5,1,1,0,1
23990_0,,,,2,3,2,5
23992_0,,,,2,3,2,5
C(C(C)(C(CO)C(C(C)O)O)O)=O,,,5,1,1,0,1
23993_0,,,,2,3,2,5
23994_0,,,,2,3,2,5
23995_0,,,,2,3,2,5
23996_0,,,,2,3,2,5
23998_0,,,,2,3,2,5
C(C(C)(C(CO)C(C=O)(C)O)O)=O,,,5,1,1,0,1
24000_0,,,,2,3,2,5
C(C(C)(C(CO)C(C(C)=O)O)O)=O,,,5,1,1,0,1
24001_0,,,,2,3,2,5
24003_0,,,,2,3,2,5
C(C(C)(C(CO)CO)O)=O,,,5,1,1,0,1
24004_0,,,,2,3,2,5
24005_0,,,,2,3,2,5
24007_0,,,,2,3,2,5
C(C(CC(C(C)=O)O)(CCO)O)=O,,,5,1,1,0,1
24008_0,,,,2,3,2,5
24009_0,,,,2,3,2,5
24010_0,,,,2,3,2,5
24011_0,,,,2,3,2,5
24012_0,,,,2,3,2,5
24013_0,,,,2,3,2,5
24014_0,,,,2,3,2,5
24015_0,,,,2,3,2,5
24017_0,,,,2,3,2,5
C(C)(C(CC(C(CO)CO)O)O)=O,,,5,1,1,0,1
24019_0,,,,2,3,2,5
C(C)(C(CC(C(C=C)CO)O)O)=O,,,5,1,1,0,1
24021_0,,,,2,3,2,5
C(C)(C(CC(C(CO)O)O)O)=O,,,5,1,2,0,2
24023_0,,,,2,3,2,5
C(C)(C(CC(CCO)O)O)=O,,,5,1,1,0,1
24024_0,,,,2,3,2,5
24026_0,,,,2,3,2,5
C(CC(C(C)(C(CO)CO)O)O)=O,,,5,1,1,0,1
24027_0,,,,2,3,2,5
24028_0,,,,2,3,2,5
24029_0,,,,2,3,2,5
24031_0,,,,2,3,2,5
C(CC(C(C)(C(C=C)CO)O)O)=O,,,5,1,1,0,1
24032_0,,,,2,3,2,5
24033_0,,,,2,3,2,5
24034_0,,,,2,3,2,5
24036_0,,,,2,3,2,5
C(C)(C(C(CO)C(CCO)O)O)=O,,,5,1,1,0,1
24037_0,,,,2,3,2,5
24039_0,,,,2,3,2,5
C(C(C(CO)C(C(C)=O)O)O)=O,,,5,1,2,0,2
24041_0,,,,2,3,2,5
C(C)(C(C(CO)C(CO)(C)O)O)=O,,,5,1,1,0,1
24043_0,,,,2,3,2,5
C(C)(C(C(CO)C(C=CC)O)O)=O,,,5,1,1,0,1
24045_0,,,,2,3,2,5
C(C)(C(C(C(CC=C)O)CO)O)=O,,,5,1,1,0,1
24047_0,,,,2,3,2,5
C(C)(C(C(CO)C(CO)O)O)=O,,,5,1,1,0,1
24049_0,,,,2,3,2,5
C(C)(C(C(CO)C(C(C)O)O)O)=O,,,5,1,1,0,1
24050_0,,,,2,3,2,5
24052_0,,,,2,3,2,5
C(C)(C(C(CO)C(C(C)=O)O)O)=O,,,5,1,1,0,1
24054_0,,,,2,3,2,5
C(C)(C(C(CO)CO)O)=O,,,5,1,1,0,1
24055_0,,,,2,3,2,5
24056_0,,,,2,3,2,5
24057_0,,,,2,3,2,5
24058_0,,,,2,3,2,5
24059_0,,,,2,3,2,5
24060_0,,,,2,3,2,5
24061_0,,,,2,3,2,5
24062_0,,,,2,3,2,5
24063_0,,,,2,3,2,5
24064_0,,,,2,3,2,5
24065_0,,,,2,3,2,5
24066_0,,,,2,3,2,5
24068_0,,,,2,3,2,5
C(C(CCO)(C(CO)CO)O)=O,,,5,1,1,0,1
24069_0,,,,2,3,2,5
24070_0,,,,2,3,2,5
24071_0,,,,2,3,2,5
24072_0,,,,2,3,2,5
24074_0,,,,2,3,2,5
C(C(CCO)(C(C=C)CO)O)=O,,,5,1,1,0,1
24075_0,,,,2,3,2,5
24076_0,,,,2,3,2,5
24077_0,,,,2,3,2,5
24079_0,,,,2,3,2,5
C(C(CCO)(CCO)O)=O,,,5,1,1,0,1
24080_0,,,,2,3,2,5
24082_0,,,,2,3,2,5
C(C(CCO)(C(CO)C(C)O)O)=O,,,5,1,1,0,1
24083_0,,,,2,3,2,5
24084_0,,,,2,3,2,5
24085_0,,,,2,3,2,5
24086_0,,,,2,3,2,5
24087_0,,,,2,3,2,5
24088_0,,,,2,3,2,5
24089_0,,,,2,3,2,5
24090_0,,,,2,3,2,5
24092_0,,,,2,3,2,5
C(C(C(CO)CO)O)(CCO)=O,,,5,1,1,0,1
24094_0,,,,2,3,2,5
C(C(C(C=C)CO)O)(CCO)=O,,,5,1,1,0,1
24095_0,,,,2,3,2,5
24096_0,,,,2,3,2,5
24097_0,,,,2,3,2,5
24098_0,,,,2,3,2,5
24099_0,,,,2,3,2,5
24100_0,,,,2,3,2,5
24101_0,,,,2,3,2,5
24102_0,,,,2,3,2,5
24103_0,,,,2,3,2,5
24104_0,,,,2,3,2,5
24105_0,,,,2,3,2,5
24106_0,,,,2,3,2,5
24107_0,,,,2,3,2,5
24108_0,,,,2,3,2,5
24109_0,,,,2,3,2,5
24110_0,,,,2,3,2,5
24111_0,,,,2,3,2,5
24112_0,,,,2,3,2,5
24114_0,,,,2,3,2,5
C(C(CC(C)O)(C(CO)CO)O)=O,,,5,1,1,0,1
24115_0,,,,2,3,2,5
24116_0,,,,2,3,2,5
24117_0,,,,2,3,2,5
24119_0,,,,2,3,2,5
C(C(CC(C)O)(C(C=C)CO)O)=O,,,5,1,1,0,1
24120_0,,,,2,3,2,5
24122_0,,,,2,3,2,5
C(C(C(CO)O)(CC(C)O)O)=O,,,5,1,3,0,3
24123_0,,,,2,3,2,5
24125_0,,,,2,3,2,5
C(C(CCO)(CC(C)O)O)=O,,,5,1,1,0,1
24126_0,,,,2,3,2,5
24127_0,,,,2,3,2,5
24128_0,,,,2,3,2,5
24130_0,,,,2,3,2,5
C(C(C(CO)CO)O)(CC(C)O)=O,,,5,1,1,0,1
24132_0,,,,2,3,2,5
C(C(C(C=C)CO)O)(CC(C)O)=O,,,5,1,1,0,1
24133_0,,,,2,3,2,5
24134_0,,,,2,3,2,5
24135_0,,,,2,3,2,5
24136_0,,,,2,3,2,5
24137_0,,,,2,3,2,5
24138_0,,,,2,3,2,5
24139_0,,,,2,3,2,5
24140_0,,,,2,3,2,5
24141_0,,,,2,3,2,5
24142_0,,,,2,3,2,5
24143_0,,,,2,3,2,5
24144_0,,,,2,3,2,5
24146_0,,,,2,3,2,5
C(C(C(CO)CO)(CC(O)=O)O)=O,,,5,1,1,0,1
24147_0,,,,2,3,2,5
24148_0,,,,2,3,2,5
24149_0,,,,2,3,2,5
24151_0,,,,2,3,2,5
C(CC(C=O)(C(C=C)CO)O)(O)=O,,,5,1,1,0,1
24152_0,,,,2,3,2,5
24154_0,,,,2,3,2,5
C(C(C(CO)O)(CC(O)=O)O)=O,,,5,1,4,0,4
24155_0,,,,2,3,2,5
24157_0,,,,2,3,2,5
C(C(CCO)(CC(O)=O)O)=O,,,5,1,3,0,3
24158_0,,,,2,3,2,5
24159_0,,,,2,3,2,5
24160_0,,,,2,3,2,5
24162_0,,,,2,3,2,5
C(CC(C(C(CO)CO)O)=O)(O)=O,,,5,1,1,0,1
24164_0,,,,2,3,2,5
C(CC(C(C(C=C)CO)O)=O)(O)=O,,,5,1,1,0,1
24165_0,,,,2,3,2,5
24166_0,,,,2,3,2,5
24167_0,,,,2,3,2,5
24168_0,,,,2,3,2,5
24169_0,,,,2,3,2,5
24170_0,,,,2,3,2,5
24171_0,,,,2,3,2,5
24172_0,,,,2,3,2,5
24173_0,,,,2,3,2,5
24174_0,,,,2,3,2,5
24175_0,,,,2,3,2,5
24177_0,,,,2,3,2,5
C(C(C(CO)O)(C(CO)O)O)(O)=O,,,5,1,4,0,4
24179_0,,,,2,3,2,5
C(C(C(CO)O)(CCO)O)(O)=O,,,5,1,4,0,4
24181_0,,,,2,3,2,5
C(C(CO)C(CCO)O)O,,,5,1,1,0,1
24182_0,,,,2,3,2,5
24183_0,,,,2,3,2,5
24185_0,,,,2,3,2,5
C=CC(CO)C(CCO)O,,,5,1,1,0,1
24187_0,,,,2,3,2,5
C=C(C(O)=O)C(CO)C(CCO)O,,,5,1,1,0,1
24189_0,,,,2,3,2,5
C(C(C(CCO)O)O)O,,,5,1,4,0,4
24191_0,,,,2,3,2,5
[CH](C(O)=O)CC(CO)C(CCO)O,,,5,1,1,0,1
24193_0,,,,2,3,2,5
C(CCC(CO)C(CCO)O)(O)=O,,,5,1,1,0,1
24195_0,,,,2,3,2,5
C(CC(CCO)O)O,,,5,1,1,0,1
24196_0,,,,2,3,2,5
24197_0,,,,2,3,2,5
24198_0,,,,2,3,2,5
24199_0,,,,2,3,2,5
24201_0,,,,2,3,2,5
C(C(CCO)(C(CO)CO)O)(O)=O,,,5,1,1,0,1
24202_0,,,,2,3,2,5
24204_0,,,,2,3,2,5
C(C)(C(C(CO)CO)(CC=O)O)=O,,,5,1,1,0,1
24205_0,,,,2,3,2,5
24207_0,,,,2,3,2,5
C(CC(C(C)(C(CO)CO)O)=O)=O,,,5,1,1,0,1
24208_0,,,,2,3,2,5
24210_0,,,,2,3,2,5
C(C)(C(C(C)O)(C(CO)CO)O)=O,,,5,1,1,0,1
24212_0,,,,2,3,2,5
C(C(C)O)(C(C)(C(CO)CO)O)=O,,,5,1,1,0,1
24214_0,,,,2,3,2,5
C(C(C(C)=O)(C(CO)CO)O)(O)=O,,,5,1,1,0,1
24216_0,,,,2,3,2,5
C(C(C(C)(C(CO)CO)O)=O)(O)=O,,,5,1,1,0,1
24217_0,,,,2,3,2,5
24219_0,,,,2,3,2,5
C(C(C(CO)CO)O)=O,,,5,1,2,0,2
24220_0,,,,2,3,2,5
24221_0,,,,2,3,2,5
24223_0,,,,2,3,2,5
C(C(C(C(CO)CO)O)O)(O)=O,,,5,1,2,0,2
24225_0,,,,2,3,2,5
C(C(CO)(C(CO)CO)O)O,,,5,1,1,0,1
24227_0,,,,2,3,2,5
CC(CO)(C(CO)CO)O,,,5,1,1,0,1
24229_0,,,,2,3,2,5
C(C(C)(C(C(CO)CO)O)O)(O)=O,,,5,1,2,0,2
24231_0,,,,2,3,2,5
C(C(C)C(C)(C(CO)CO)O)(O)=O,,,5,1,1,0,1
24233_0,,,,2,3,2,5
C(C(C(CO)CO)O)=CC,,,5,1,1,0,1
24235_0,,,,2,3,2,5
C=CCC(C(CO)CO)O,,,5,1,1,0,1
24237_0,,,,2,3,2,5
C(C(C=CC)(C(CO)CO)O)(O)=O,,,5,1,1,0,1
24239_0,,,,2,3,2,5
C(C(C(CO)CO)(CC=C)O)(O)=O,,,5,1,1,0,1
24241_0,,,,2,3,2,5
C=C(C(O)=O)CC(C(CO)CO)O,,,5,1,1,0,1
24243_0,,,,2,3,2,5
C(C(C(CO)CO)O)=C(C(O)=O)C,,,5,1,1,0,1
24245_0,,,,2,3,2,5
C(C(CO)C(C(CO)O)O)O,,,5,1,1,0,1
24247_0,,,,2,3,2,5
C(C(CO)C(CO)O)O,,,5,1,1,0,1
24249_0,,,,2,3,2,5
C1(C(CC(C)O1)(C(CO)CO)O)=O,,,5,1,1,0,1
24251_0,,,,2,3,2,5
C1(C(C(CO)CO)(CC(O1)=O)O)=O,,,5,1,1,0,1
24253_0,,,,2,3,2,5
[CH](C(O)=O)CCC(C(CO)CO)O,,,5,1,2,0,2
24255_0,,,,2,3,2,5
C(CCCC(C(CO)CO)O)(O)=O,,,5,1,2,0,2
24257_0,,,,2,3,2,5
CC(C(C(CO)CO)O)O,,,5,1,1,0,1
24258_0,,,,2,3,2,5
24260_0,,,,2,3,2,5
C(C(CO)CO)O,,,5,1,1,0,1
24262_0,,,,2,3,2,5
C(C(CO)(C(CO)CO)O)(O)=O,,,5,1,1,0,1
24264_0,,,,2,3,2,5
C(C(CCO)(C(C=C)CO)O)(O)=O,,,5,1,1,0,1
24265_0,,,,2,3,2,5
24267_0,,,,2,3,2,5
C(C(CCO)(CCO)O)(O)=O,,,5,1,1,0,1
24268_0,,,,2,3,2,5
24269_0,,,,2,3,2,5
24271_0,,,,2,3,2,5
C(C(CO)(CC(CCO)O)O)(O)=O,,,5,1,1,0,1
24273_0,,,,2,3,2,5
C(C(CCO)(C(C(C)O)O)O)(O)=O,,,5,1,2,0,2
24274_0,,,,2,3,2,5
24275_0,,,,2,3,2,5
24276_0,,,,2,3,2,5
24278_0,,,,2,3,2,5
C(CC(C(C)=O)(C(C=C)CO)O)=O,,,5,1,1,0,1
24279_0,,,,2,3,2,5
24280_0,,,,2,3,2,5
24281_0,,,,2,3,2,5
24282_0,,,,2,3,2,5
24283_0,,,,2,3,2,5
24284_0,,,,2,3,2,5
24285_0,,,,2,3,2,5
24286_0,,,,2,3,2,5
24288_0,,,,2,3,2,5
C(CC(C(C)(C(C=C)CO)O)=O)=O,,,5,1,1,0,1
24289_0,,,,2,3,2,5
24291_0,,,,2,3,2,5
C(CC(C(C)(C(CO)O)O)=O)=O,,,5,1,3,0,3
24292_0,,,,2,3,2,5
24294_0,,,,2,3,2,5
C(CC(C(C)(CCO)O)=O)=O,,,5,1,1,0,1
24295_0,,,,2,3,2,5
24296_0,,,,2,3,2,5
24297_0,,,,2,3,2,5
24298_0,,,,2,3,2,5
24299_0,,,,2,3,2,5
24300_0,,,,2,3,2,5
24301_0,,,,2,3,2,5
24302_0,,,,2,3,2,5
24303_0,,,,2,3,2,5
24304_0,,,,2,3,2,5
24305_0,,,,2,3,2,5
24306_0,,,,2,3,2,5
24307_0,,,,2,3,2,5
24308_0,,,,2,3,2,5
24309_0,,,,2,3,2,5
24310_0,,,,2,3,2,5
24311_0,,,,2,3,2,5
24312_0,,,,2,3,2,5
24313_0,,,,2,3,2,5
24314_0,,,,2,3,2,5
24315_0,,,,2,3,2,5
24316_0,,,,2,3,2,5
24317_0,,,,2,3,2,5
24318_0,,,,2,3,2,5
24319_0,,,,2,3,2,5
24320_0,,,,2,3,2,5
24321_0,,,,2,3,2,5
24322_0,,,,2,3,2,5
24323_0,,,,2,3,2,5
24324_0,,,,2,3,2,5
24325_0,,,,2,3,2,5
24326_0,,,,2,3,2,5
24327_0,,,,2,3,2,5
24328_0,,,,2,3,2,5
24329_0,,,,2,3,2,5
24331_0,,,,2,3,2,5
C(C(C)O)(C(CO)(C(CO)O)O)=O,,,5,1,4,0,4
24333_0,,,,2,3,2,5
C(C(C)O)(C(CO)(CCO)O)=O,,,5,1,1,0,1
24335_0,,,,2,3,2,5
C(CO)(C(C(CO)O)(C(C)O)O)=O,,,5,1,7,0,7
24337_0,,,,2,3,2,5
C(CO)(C(C(C)O)(CCO)O)=O,,,5,1,2,0,2
24338_0,,,,2,3,2,5
24339_0,,,,2,3,2,5
24341_0,,,,2,3,2,5
C(C(C(CO)(CCO)O)=O)(O)=O,,,5,1,1,0,1
24342_0,,,,2,3,2,5
24343_0,,,,2,3,2,5
24344_0,,,,2,3,2,5
24346_0,,,,2,3,2,5
C(C)(C(C(C)O)(C(C=C)CO)O)=O,,,5,1,1,0,1
24348_0,,,,2,3,2,5
C(C)(C(C(CO)O)(C(C)O)O)=O,,,5,1,6,0,6
24350_0,,,,2,3,2,5
C(C)(C(C(C)O)(CCO)O)=O,,,5,1,2,0,2
24351_0,,,,2,3,2,5
24353_0,,,,2,3,2,5
C(C(C)(C(C=C)CO)O)(C(C)O)=O,,,5,1,1,0,1
24355_0,,,,2,3,2,5
C(C(C)O)(C(C)(C(CO)O)O)=O,,,5,1,2,0,2
24357_0,,,,2,3,2,5
C(C(C)O)(C(C)(CCO)O)=O,,,5,1,1,0,1
24358_0,,,,2,3,2,5
24359_0,,,,2,3,2,5
24360_0,,,,2,3,2,5
24362_0,,,,2,3,2,5
C(C(C(C)=O)(C(C=C)CO)O)(O)=O,,,5,1,1,0,1
24364_0,,,,2,3,2,5
C(C(C(C)=O)(C(CO)O)O)(O)=O,,,5,1,6,0,6
24366_0,,,,2,3,2,5
C(C(C(C)=O)(CCO)O)(O)=O,,,5,1,2,0,2
24367_0,,,,2,3,2,5
24369_0,,,,2,3,2,5
C(C(CO)C(C(C(O)=O)=O)(C)O)=C,,,5,1,1,0,1
24371_0,,,,2,3,2,5
C(C(C(C)(C(CO)O)O)=O)(O)=O,,,5,1,3,0,3
24373_0,,,,2,3,2,5
C(C(C(C)(CCO)O)=O)(O)=O,,,5,1,1,0,1
24374_0,,,,2,3,2,5
24375_0,,,,2,3,2,5
24376_0,,,,2,3,2,5
24377_0,,,,2,3,2,5
24378_0,,,,2,3,2,5
24379_0,,,,2,3,2,5
24380_0,,,,2,3,2,5
24381_0,,,,2,3,2,5
24383_0,,,,2,3,2,5
C(C(C(C=C)CO)O)=O,,,5,1,1,0,1
24384_0,,,,2,3,2,5
24385_0,,,,2,3,2,5
24387_0,,,,2,3,2,5
C(C(C(C(C(O)=O)=C)CO)O)=O,,,5,1,1,0,1
24388_0,,,,2,3,2,5
24389_0,,,,2,3,2,5
24390_0,,,,2,3,2,5
24391_0,,,,2,3,2,5
24393_0,,,,2,3,2,5
C(C(C(CO)C[CH]C(O)=O)O)=O,,,5,1,3,0,3
24394_0,,,,2,3,2,5
24396_0,,,,2,3,2,5
C(CCC(CO)C(C=O)O)(O)=O,,,5,1,3,0,3
24397_0,,,,2,3,2,5
24398_0,,,,2,3,2,5
24399_0,,,,2,3,2,5
24400_0,,,,2,3,2,5
24401_0,,,,2,3,2,5
24402_0,,,,2,3,2,5
24403_0,,,,2,3,2,5
24404_0,,,,2,3,2,5
24406_0,,,,2,3,2,5
C(C(C)(C(CO)C(C=O)O)O)(O)=O,,,5,1,2,0,2
24407_0,,,,2,3,2,5
24408_0,,,,2,3,2,5
24409_0,,,,2,3,2,5
24410_0,,,,2,3,2,5
24411_0,,,,2,3,2,5
24412_0,,,,2,3,2,5
24413_0,,,,2,3,2,5
24414_0,,,,2,3,2,5
24415_0,,,,2,3,2,5
24416_0,,,,2,3,2,5
24417_0,,,,2,3,2,5
24418_0,,,,2,3,2,5
24419_0,,,,2,3,2,5
24420_0,,,,2,3,2,5
24421_0,,,,2,3,2,5
24422_0,,,,2,3,2,5
24423_0,,,,2,3,2,5
24424_0,,,,2,3,2,5
24425_0,,,,2,3,2,5
24426_0,,,,2,3,2,5
24427_0,,,,2,3,2,5
24428_0,,,,2,3,2,5
24429_0,,,,2,3,2,5
24430_0,,,,2,3,2,5
24431_0,,,,2,3,2,5
24432_0,,,,2,3,2,5
24434_0,,,,2,3,2,5
C(C(C(C(C=C)CO)O)O)(O)=O,,,5,1,3,0,3
24435_0,,,,2,3,2,5
24436_0,,,,2,3,2,5
24437_0,,,,2,3,2,5
24438_0,,,,2,3,2,5
24439_0,,,,2,3,2,5
24440_0,,,,2,3,2,5
24442_0,,,,2,3,2,5
C=CC(CO)C(CO)(CO)O,,,5,1,1,0,1
24444_0,,,,2,3,2,5
C(C(CO)(C(CO)O)O)O,,,5,1,4,0,4
24446_0,,,,2,3,2,5
C(C(CO)(CCO)O)O,,,5,1,2,0,2
24448_0,,,,2,3,2,5
CC(C(CO)C(CO)(CO)O)O,,,5,1,2,0,2
24449_0,,,,2,3,2,5
24450_0,,,,2,3,2,5
24451_0,,,,2,3,2,5
24452_0,,,,2,3,2,5
24453_0,,,,2,3,2,5
24455_0,,,,2,3,2,5
C=CC(CO)C(C)(CO)O,,,5,1,1,0,1
24457_0,,,,2,3,2,5
C=C(C(O)=O)C(CO)C(C)(CO)O,,,5,1,1,0,1
24459_0,,,,2,3,2,5
CC(CO)(C(CO)O)O,,,5,1,3,0,3
24461_0,,,,2,3,2,5
[CH](C(O)=O)CC(CO)C(C)(CO)O,,,5,1,1,0,1
24463_0,,,,2,3,2,5
C(CCC(CO)C(C)(CO)O)(O)=O,,,5,1,1,0,1
24465_0,,,,2,3,2,5
CC(CO)(CCO)O,,,5,1,2,0,2
24467_0,,,,2,3,2,5
CC(CO)(C(CO)C(C)O)O,,,5,1,2,0,2
24468_0,,,,2,3,2,5
24469_0,,,,2,3,2,5
24470_0,,,,2,3,2,5
24471_0,,,,2,3,2,5
24472_0,,,,2,3,2,5
24473_0,,,,2,3,2,5
24474_0,,,,2,3,2,5
24476_0,,,,2,3,2,5
C(C(C(C)(C(CCO)O)O)O)(O)=O,,,5,1,2,0,2
24478_0,,,,2,3,2,5
C(C(C(C(C)(CCO)O)O)O)(O)=O,,,5,1,2,0,2
24480_0,,,,2,3,2,5
C(C(C(C(C=C)CO)O)(C)O)(O)=O,,,5,1,2,0,2
24481_0,,,,2,3,2,5
24482_0,,,,2,3,2,5
24483_0,,,,2,3,2,5
24485_0,,,,2,3,2,5
C(C(CO)C(C)(C(CO)O)O)(O)=O,,,5,1,3,0,3
24487_0,,,,2,3,2,5
C(C(CO)C(C)(CCO)O)(O)=O,,,5,1,2,0,2
24489_0,,,,2,3,2,5
C(C(C)C(C)(C(C=C)CO)O)(O)=O,,,5,1,1,0,1
24491_0,,,,2,3,2,5
C(C(C)C(C)(C(CO)O)O)(O)=O,,,5,1,2,0,2
24493_0,,,,2,3,2,5
C(C(C)C(C)(CCO)O)(O)=O,,,5,1,1,0,1
24494_0,,,,2,3,2,5
24495_0,,,,2,3,2,5
24497_0,,,,2,3,2,5
C(C)=CC(C(C=C)CO)O,,,5,1,1,0,1
24499_0,,,,2,3,2,5
C(C)=CC(C(C(C(O)=O)=C)CO)O,,,5,1,1,0,1
24501_0,,,,2,3,2,5
C(C(C(CO)O)O)=CC,,,5,1,3,0,3
24503_0,,,,2,3,2,5
C(C(C(CO)C[CH]C(O)=O)O)=CC,,,5,1,1,0,1
24505_0,,,,2,3,2,5
C(CCC(CO)C(C=CC)O)(O)=O,,,5,1,1,0,1
24507_0,,,,2,3,2,5
C(C(CCO)O)=CC,,,5,1,2,0,2
24509_0,,,,2,3,2,5
C(C(C(CO)C(C)O)O)=CC,,,5,1,2,0,2
24510_0,,,,2,3,2,5
24511_0,,,,2,3,2,5
24512_0,,,,2,3,2,5
24514_0,,,,2,3,2,5
C(C(CO)C(CC=C)O)=C,,,5,1,1,0,1
24516_0,,,,2,3,2,5
C=CCC(C(C(C(O)=O)=C)CO)O,,,5,1,1,0,1
24518_0,,,,2,3,2,5
C=CCC(C(CO)O)O,,,5,1,3,0,3
24520_0,,,,2,3,2,5
C=CCC(C(CO)C[CH]C(O)=O)O,,,5,1,1,0,1
24522_0,,,,2,3,2,5
C(CCC(CO)C(CC=C)O)(O)=O,,,5,1,1,0,1
24524_0,,,,2,3,2,5
C=CCC(CCO)O,,,5,1,2,0,2
24526_0,,,,2,3,2,5
C=CCC(C(CO)C(C)O)O,,,5,1,2,0,2
24527_0,,,,2,3,2,5
24528_0,,,,2,3,2,5
24529_0,,,,2,3,2,5
24531_0,,,,2,3,2,5
C(C(C=CC)(C(C=C)CO)O)(O)=O,,,5,1,1,0,1
24533_0,,,,2,3,2,5
C(C(CC=C)(C(C=C)CO)O)(O)=O,,,5,1,1,0,1
24535_0,,,,2,3,2,5
C(C(CO)C(CC(C(O)=O)=C)O)=C,,,5,1,1,0,1
24537_0,,,,2,3,2,5
C(C(CO)C(C=C(C(O)=O)C)O)=C,,,5,1,1,0,1
24539_0,,,,2,3,2,5
C=CC(CO)C(C(CO)O)O,,,5,1,1,0,1
24541_0,,,,2,3,2,5
C=CC(CO)C(CO)O,,,5,1,1,0,1
24543_0,,,,2,3,2,5
C1(C(CC(C)O1)(C(C=C)CO)O)=O,,,5,1,1,0,1
24545_0,,,,2,3,2,5
C1(CC(C(O1)=O)(C(C=C)CO)O)=O,,,5,1,1,0,1
24547_0,,,,2,3,2,5
C(C(CO)C(CC[CH]C(O)=O)O)=C,,,5,1,1,0,1
24549_0,,,,2,3,2,5
C(CCCC(C(C=C)CO)O)(O)=O,,,5,1,1,0,1
24551_0,,,,2,3,2,5
C=CC(CO)C(C(C)O)O,,,5,1,1,0,1
24553_0,,,,2,3,2,5
C(C(C(C=C)CO)O)(O)=O,,,5,1,3,0,3
24555_0,,,,2,3,2,5
C=CC(CO)C(C)O,,,5,1,2,0,2
24557_0,,,,2,3,2,5
C(C(C=C)CO)(O)=O,,,5,1,4,0,4
24559_0,,,,2,3,2,5
C=CC(CO)C(CC(C)O)O,,,5,1,2,0,2
24561_0,,,,2,3,2,5
C(CC(C(C=C)CO)O)(O)=O,,,5,1,2,0,2
24563_0,,,,2,3,2,5
C(C(C(C=C)CO)O)(CO)=O,,,5,1,2,0,2
24564_0,,,,2,3,2,5
24566_0,,,,2,3,2,5
C(C(CO)(C(C=C)CO)O)=O,,,5,1,2,0,2
24567_0,,,,2,3,2,5
24569_0,,,,2,3,2,5
C(C(C)(C(C=C)CO)O)=O,,,5,1,2,0,2
24571_0,,,,2,3,2,5
C(C(C(C=C)CO)O)(C)=O,,,5,1,2,0,2
24573_0,,,,2,3,2,5
C=CC(CO)CO,,,5,1,2,0,2
24575_0,,,,2,3,2,5
C(C(CO)(C(C=C)CO)O)(O)=O,,,5,1,2,0,2
24577_0,,,,2,3,2,5
C(C(C)(C(C=C)CO)O)(O)=O,,,5,1,2,0,2
24579_0,,,,2,3,2,5
C(C(C=CC)(C(CO)O)O)(O)=O,,,5,1,4,0,4
24581_0,,,,2,3,2,5
C(C(C=CC)(CCO)O)(O)=O,,,5,1,2,0,2
24582_0,,,,2,3,2,5
24584_0,,,,2,3,2,5
C(C(C(CO)O)(CC=C)O)(O)=O,,,5,1,4,0,4
24586_0,,,,2,3,2,5
C(C(CCO)(CC=C)O)(O)=O,,,5,1,2,0,2
24587_0,,,,2,3,2,5
24588_0,,,,2,3,2,5
24590_0,,,,2,3,2,5
C=C(C(O)=O)CC(C(CO)O)O,,,5,1,3,0,3
24592_0,,,,2,3,2,5
C=C(C(O)=O)CC(CCO)O,,,5,1,2,0,2
24593_0,,,,2,3,2,5
24595_0,,,,2,3,2,5
C=C(C(O)=O)C(CO)C(CO)O,,,5,1,1,0,1
24597_0,,,,2,3,2,5
C=C(C(O)=O)C(CO)C(C(C)O)O,,,5,1,1,0,1
24598_0,,,,2,3,2,5
24600_0,,,,2,3,2,5
C=C(C(O)=O)C(CO)C(C)O,,,5,1,2,0,2
24602_0,,,,2,3,2,5
C(C(C(C(O)=O)=C)CO)(O)=O,,,5,1,4,0,4
24603_0,,,,2,3,2,5
24605_0,,,,2,3,2,5
C(C(C)(C(C(C(O)=O)=C)CO)O)=O,,,5,1,1,0,1
24607_0,,,,2,3,2,5
C(C(C(C(C(O)=O)=C)CO)O)(C)=O,,,5,1,1,0,1
24609_0,,,,2,3,2,5
C=C(C(O)=O)C(CO)CO,,,5,1,2,0,2
24611_0,,,,2,3,2,5
C(C(C(CO)O)O)=C(C(O)=O)C,,,5,1,3,0,3
24613_0,,,,2,3,2,5
C(C(CCO)O)=C(C(O)=O)C,,,5,1,2,0,2
24614_0,,,,2,3,2,5
24616_0,,,,2,3,2,5
C1(C(C=C(C(O1)=O)C)(CCO)O)=O,,,5,1,1,0,1
24618_0,,,,2,3,2,5
C1(C(CCO)(CC(C(O1)=O)=C)O)=O,,,5,1,1,0,1
24620_0,,,,2,3,2,5
C(C(C(C(CO)O)O)O)O,,,5,1,4,0,4
24621_0,,,,2,3,2,5
24622_0,,,,2,3,2,5
24623_0,,,,2,3,2,5
24624_0,,,,2,3,2,5
24625_0,,,,2,3,2,5
24627_0,,,,2,3,2,5
C(C(C(CO)O)O)O,,,5,1,4,0,4
24629_0,,,,2,3,2,5
[CH](C(O)=O)CC(CO)C(CO)O,,,5,1,1,0,1
24631_0,,,,2,3,2,5
C(CCC(CO)C(CO)O)(O)=O,,,5,1,1,0,1
24633_0,,,,2,3,2,5
C(C(CCO)O)O,,,5,1,5,0,5
24635_0,,,,2,3,2,5
CC(C(CO)C(CO)O)O,,,5,1,1,0,1
24636_0,,,,2,3,2,5
24638_0,,,,2,3,2,5
C(C(C)(C(CO)C(CO)O)O)(O)=O,,,5,1,1,0,1
24639_0,,,,2,3,2,5
24640_0,,,,2,3,2,5
24642_0,,,,2,3,2,5
C1(C(C(CO)O)(CC(C)O1)O)=O,,,5,1,4,0,4
24644_0,,,,2,3,2,5
C1(C(C(CO)O)(CC(O1)=O)O)=O,,,5,1,4,0,4
24645_0,,,,2,3,2,5
24646_0,,,,2,3,2,5
24648_0,,,,2,3,2,5
CC(C(C(CO)O)O)O,,,5,1,4,0,4
24649_0,,,,2,3,2,5
24650_0,,,,2,3,2,5
24651_0,,,,2,3,2,5
24652_0,,,,2,3,2,5
24653_0,,,,2,3,2,5
24654_0,,,,2,3,2,5
24655_0,,,,2,3,2,5
24656_0,,,,2,3,2,5
24657_0,,,,2,3,2,5
24658_0,,,,2,3,2,5
24659_0,,,,2,3,2,5
24660_0,,,,2,3,2,5
24661_0,,,,2,3,2,5
24663_0,,,,2,3,2,5
C1(C(CCO)(CC(C)O1)O)=O,,,5,1,2,0,2
24664_0,,,,2,3,2,5
24665_0,,,,2,3,2,5
24667_0,,,,2,3,2,5
C1(C(CCO)(CC(O1)=O)O)=O,,,5,1,2,0,2
24668_0,,,,2,3,2,5
24669_0,,,,2,3,2,5
24671_0,,,,2,3,2,5
[CH](C(O)=O)CC(C)(C(CO)CO)O,,,5,1,2,0,2
24673_0,,,,2,3,2,5
C(CCC(C)(C(CO)CO)O)(O)=O,,,5,1,2,0,2
24675_0,,,,2,3,2,5
C(C(CC[CH]C(O)=O)(CCO)O)=O,,,5,1,2,0,2
24676_0,,,,2,3,2,5
24678_0,,,,2,3,2,5
C(CC[CH]C(O)=O)(C(CCO)O)=O,,,5,1,2,0,2
24679_0,,,,2,3,2,5
24680_0,,,,2,3,2,5
24681_0,,,,2,3,2,5
24683_0,,,,2,3,2,5
C(C(CCO)(CCCC(O)=O)O)=O,,,5,1,2,0,2
24684_0,,,,2,3,2,5
24686_0,,,,2,3,2,5
C(CCCC(C(CCO)O)=O)(O)=O,,,5,1,2,0,2
24687_0,,,,2,3,2,5
24688_0,,,,2,3,2,5
24689_0,,,,2,3,2,5
24690_0,,,,2,3,2,5
24692_0,,,,2,3,2,5
[CH](C(O)=O)CC(CO)C(C(C)O)O,,,5,1,1,0,1
24693_0,,,,2,3,2,5
24694_0,,,,2,3,2,5
24696_0,,,,2,3,2,5
C(C(C)(C(CO)C[CH]C(O)=O)O)=O,,,5,1,2,0,2
24698_0,,,,2,3,2,5
C(C)(C(C(CO)C[CH]C(O)=O)O)=O,,,5,1,2,0,2
24700_0,,,,2,3,2,5
[CH](C(O)=O)CC(CO)CO,,,5,1,2,0,2
24701_0,,,,2,3,2,5
24703_0,,,,2,3,2,5
C(CCC(CO)C(C(C)O)O)(O)=O,,,5,1,1,0,1
24704_0,,,,2,3,2,5
24705_0,,,,2,3,2,5
24707_0,,,,2,3,2,5
C(C(C)(C(CO)CCC(O)=O)O)=O,,,5,1,2,0,2
24709_0,,,,2,3,2,5
C(CCC(CO)C(C(C)=O)O)(O)=O,,,5,1,2,0,2
24711_0,,,,2,3,2,5
C(CCC(CO)CO)(O)=O,,,5,1,2,0,2
24713_0,,,,2,3,2,5
CC(C(CCO)O)O,,,5,1,1,0,1
24715_0,,,,2,3,2,5
CC(C(C(CO)C(C)O)O)O,,,5,1,1,0,1
24716_0,,,,2,3,2,5
24717_0,,,,2,3,2,5
24718_0,,,,2,3,2,5
24719_0,,,,2,3,2,5
24720_0,,,,2,3,2,5
24721_0,,,,2,3,2,5
24722_0,,,,2,3,2,5
24723_0,,,,2,3,2,5
24724_0,,,,2,3,2,5
24725_0,,,,2,3,2,5
24726_0,,,,2,3,2,5
24727_0,,,,2,3,2,5
24728_0,,,,2,3,2,5
24729_0,,,,2,3,2,5
24730_0,,,,2,3,2,5
24731_0,,,,2,3,2,5
24732_0,,,,2,3,2,5
24733_0,,,,2,3,2,5
24734_0,,,,2,3,2,5
24735_0,,,,2,3,2,5
24736_0,,,,2,3,2,5
24737_0,,,,2,3,2,5
24738_0,,,,2,3,2,5
24739_0,,,,2,3,2,5
24740_0,,,,2,3,2,5
24741_0,,,,2,3,2,5
24742_0,,,,2,3,2,5
24743_0,,,,2,3,2,5
24744_0,,,,2,3,2,5
24745_0,,,,2,3,2,5
24746_0,,,,2,3,2,5
24747_0,,,,2,3,2,5
24748_0,,,,2,3,2,5
24749_0,,,,2,3,2,5
24750_0,,,,2,3,2,5
24751_0,,,,2,3,2,5
24752_0,,,,2,3,2,5
24753_0,,,,2,3,2,5
24754_0,,,,2,3,2,5
24755_0,,,,2,3,2,5
24756_0,,,,2,3,2,5
24758_0,,,,2,3,2,5
C(C(C)=CC(CO)=O)(O)=O,,,5,1,3,0,3
24760_0,,,,2,3,2,5
C(CO)(CC(C(O)=O)=C)=O,,,5,1,2,0,2
24761_0,,,,2,3,2,5
24762_0,,,,2,3,2,5
24764_0,,,,2,3,2,5
CC(CC(CO)O)O,,,5,1,1,0,1
24766_0,,,,2,3,2,5
C(CC(CO)O)(O)=O,,,5,1,10,0,10
24767_0,,,,2,3,2,5
24768_0,,,,2,3,2,5
24769_0,,,,2,3,2,5
24770_0,,,,2,3,2,5
24771_0,,,,2,3,2,5
24772_0,,,,2,3,2,5
24773_0,,,,2,3,2,5
24774_0,,,,2,3,2,5
24775_0,,,,2,3,2,5
24776_0,,,,2,3,2,5
24777_0,,,,2,3,2,5
24778_0,,,,2,3,2,5
24779_0,,,,2,3,2,5
24780_0,,,,2,3,2,5
24781_0,,,,2,3,2,5
24782_0,,,,2,3,2,5
24783_0,,,,2,3,2,5
24784_0,,,,2,3,2,5
24785_0,,,,2,3,2,5
24786_0,,,,2,3,2,5
24787_0,,,,2,3,2,5
24788_0,,,,2,3,2,5
24789_0,,,,2,3,2,5
24790_0,,,,2,3,2,5
24791_0,,,,2,3,2,5
24792_0,,,,2,3,2,5
24793_0,,,,2,3,2,5
24794_0,,,,2,3,2,5
24795_0,,,,2,3,2,5
24796_0,,,,2,3,2,5
24797_0,,,,2,3,2,5
24798_0,,,,2,3,2,5
24799_0,,,,2,3,2,5
24800_0,,,,2,3,2,5
24801_0,,,,2,3,2,5
24802_0,,,,2,3,2,5
24803_0,,,,2,3,2,5
24804_0,,,,2,3,2,5
24805_0,,,,2,3,2,5
24806_0,,,,2,3,2,5
24807_0,,,,2,3,2,5
24808_0,,,,2,3,2,5
24809_0,,,,2,3,2,5
24810_0,,,,2,3,2,5
24812_0,,,,2,3,2,5
C(CC(CO)(CO)O)(O)=O,,,5,1,5,0,5
24814_0,,,,2,3,2,5
C(CC(C)(CO)O)(O)=O,,,5,1,5,0,5
24815_0,,,,2,3,2,5
24817_0,,,,2,3,2,5
C(C(C)(C(CO)(CO)C(C)O)O)=O,,,5,1,1,0,1
24819_0,,,,2,3,2,5
C(C)(C(C(CO)(CO)C(C)O)O)=O,,,5,1,1,0,1
24821_0,,,,2,3,2,5
CC(C(CO)(CO)C(CCO)O)O,,,5,1,1,0,1
24822_0,,,,2,3,2,5
24824_0,,,,2,3,2,5
C(C(C(CO)(CO)C(C)O)O)=O,,,5,1,1,0,1
24826_0,,,,2,3,2,5
CC(CO)(C(CO)(CO)C(C)O)O,,,5,1,1,0,1
24828_0,,,,2,3,2,5
C(C(C(CO)(CO)C(C)O)O)=CC,,,5,1,1,0,1
24830_0,,,,2,3,2,5
C=CCC(C(CO)(CO)C(C)O)O,,,5,1,1,0,1
24832_0,,,,2,3,2,5
CC(C(CO)(CO)C(CO)O)O,,,5,1,1,0,1
24834_0,,,,2,3,2,5
CC(C(C(CO)(CO)C(C)O)O)O,,,5,1,1,0,1
24836_0,,,,2,3,2,5
C(C(C(CO)(CO)C(C)O)O)(O)=O,,,5,1,2,0,2
24838_0,,,,2,3,2,5
CC(C(CO)(CO)C(C)O)O,,,5,1,1,0,1
24840_0,,,,2,3,2,5
C(C(CO)(CO)C(C)O)(O)=O,,,5,1,4,0,4
24842_0,,,,2,3,2,5
CC(C(CO)(CO)CO)O,,,5,1,1,0,1
24843_0,,,,2,3,2,5
24845_0,,,,2,3,2,5
C(C(C(CO)(C(C)O)C(C)O)O)=O,,,5,1,1,0,1
24847_0,,,,2,3,2,5
CC(C(CO)(C(C)O)C(CO)O)O,,,5,1,1,0,1
24849_0,,,,2,3,2,5
CC(C(CO)(C(C)O)C(C)O)O,,,5,1,1,0,1
24851_0,,,,2,3,2,5
C(C(CO)(C(C)O)C(C)O)(O)=O,,,5,1,4,0,4
24852_0,,,,2,3,2,5
24854_0,,,,2,3,2,5
C(C(CO)(C(C)O)C(C=O)O)(O)=O,,,5,1,5,0,5
24856_0,,,,2,3,2,5
C(C(CO)(C(CO)O)C(C)O)(O)=O,,,5,1,6,0,6
24858_0,,,,2,3,2,5
C(C(C(O)=O)(CO)C(C)O)(O)=O,,,5,1,5,0,5
24859_0,,,,2,3,2,5
24861_0,,,,2,3,2,5
C(C(C(CCO)O)C(C=O)O)(O)=O,,,5,1,4,0,4
24863_0,,,,2,3,2,5
C(C(C(CO)O)C(CCO)O)(O)=O,,,5,1,2,0,2
24864_0,,,,2,3,2,5
24866_0,,,,2,3,2,5
C(C(CO)(CO)C(C=O)(C)O)(O)=O,,,5,1,3,0,3
24868_0,,,,2,3,2,5
C(C(CO)(CO)C(C(C)=O)O)(O)=O,,,5,1,3,0,3
24870_0,,,,2,3,2,5
C(C(CO)(CO)C(CCO)O)(O)=O,,,5,1,3,0,3
24871_0,,,,2,3,2,5
24873_0,,,,2,3,2,5
C(C(CO)(CO)C(C=O)O)(O)=O,,,5,1,3,0,3
24875_0,,,,2,3,2,5
C(C(CO)(CO)C(C)(CO)O)(O)=O,,,5,1,3,0,3
24877_0,,,,2,3,2,5
C(C(CO)(CO)C(C=CC)O)(O)=O,,,5,1,3,0,3
24879_0,,,,2,3,2,5
C(C(CO)(CO)C(CC=C)O)(O)=O,,,5,1,3,0,3
24881_0,,,,2,3,2,5
C(C(CO)(CO)C(CO)O)(O)=O,,,5,1,4,0,4
24883_0,,,,2,3,2,5
C(C(CO)(CO)C(C(C)O)O)(O)=O,,,5,1,3,0,3
24885_0,,,,2,3,2,5
C(C(CO)(CO)C(C(O)=O)O)(O)=O,,,5,1,4,0,4
24887_0,,,,2,3,2,5
C(C(C(O)=O)(CO)CO)(O)=O,,,5,1,4,0,4
24889_0,,,,2,3,2,5
C(C(CO)(CO)CO)(O)=O,,,5,1,2,0,2
24890_0,,,,2,3,2,5
24892_0,,,,2,3,2,5
C(C(C(O)=O)(CO)C(C=O)O)(O)=O,,,5,1,5,0,5
24894_0,,,,2,3,2,5
C(C(C(O)=O)(CO)C(CO)O)(O)=O,,,5,1,6,0,6
24896_0,,,,2,3,2,5
C(C(C(O)=O)(C(O)=O)CO)(O)=O,,,5,1,4,0,4
24898_0,,,,2,3,2,5
C(C(C)(C(CO)(CO)CO)O)(O)=O,,,5,1,1,0,1
24899_0,,,,2,3,2,5
24901_0,,,,2,3,2,5
C(C(C)(C(C(CO)=O)(CO)O)O)=O,,,5,1,6,0,6
24902_0,,,,2,3,2,5
24903_0,,,,2,3,2,5
24905_0,,,,2,3,2,5
C(CO)(C(CO)(C(CCO)O)O)=O,,,5,1,5,0,5
24906_0,,,,2,3,2,5
24907_0,,,,2,3,2,5
24909_0,,,,2,3,2,5
C(CO)(C(CO)(C(CO)(C)O)O)=O,,,5,1,5,0,5
24911_0,,,,2,3,2,5
C(CO)(C(CO)(C(C=CC)O)O)=O,,,5,1,5,0,5
24913_0,,,,2,3,2,5
C(CO)(C(CO)(C(CC=C)O)O)=O,,,5,1,5,0,5
24915_0,,,,2,3,2,5
C(CO)(C(CO)(C(CO)O)O)=O,,,5,1,6,0,6
24917_0,,,,2,3,2,5
C(CO)(C(CO)(C(C(C)O)O)O)=O,,,5,1,5,0,5
24918_0,,,,2,3,2,5
24920_0,,,,2,3,2,5
C(CO)(C(CO)(C(C)O)O)=O,,,5,1,5,0,5
24921_0,,,,2,3,2,5
24922_0,,,,2,3,2,5
24923_0,,,,2,3,2,5
24924_0,,,,2,3,2,5
24926_0,,,,2,3,2,5
C(CO)(C(C(C)O)(C(C)O)O)=O,,,5,1,3,0,3
24927_0,,,,2,3,2,5
24928_0,,,,2,3,2,5
24929_0,,,,2,3,2,5
24930_0,,,,2,3,2,5
24931_0,,,,2,3,2,5
24932_0,,,,2,3,2,5
24934_0,,,,2,3,2,5
C(C(C=O)(C(CO)(CCO)O)O)=O,,,5,1,3,0,3
24936_0,,,,2,3,2,5
C(C(CO)C(CO)(CCO)O)(O)=O,,,5,1,2,0,2
24938_0,,,,2,3,2,5
C(C(CCO)(C(CO)(CO)O)O)=O,,,5,1,3,0,3
24940_0,,,,2,3,2,5
C(C(CO)(C(CO)(CCO)O)O)=O,,,5,1,3,0,3
24941_0,,,,2,3,2,5
24942_0,,,,2,3,2,5
24943_0,,,,2,3,2,5
24944_0,,,,2,3,2,5
24946_0,,,,2,3,2,5
C(C(CO)(C(CCO)O)O)O,,,5,1,2,0,2
24947_0,,,,2,3,2,5
24948_0,,,,2,3,2,5
24949_0,,,,2,3,2,5
24950_0,,,,2,3,2,5
24951_0,,,,2,3,2,5
24952_0,,,,2,3,2,5
24953_0,,,,2,3,2,5
24954_0,,,,2,3,2,5
24955_0,,,,2,3,2,5
24956_0,,,,2,3,2,5
24957_0,,,,2,3,2,5
24958_0,,,,2,3,2,5
24959_0,,,,2,3,2,5
24960_0,,,,2,3,2,5
24961_0,,,,2,3,2,5
24962_0,,,,2,3,2,5
24963_0,,,,2,3,2,5
24964_0,,,,2,3,2,5
24965_0,,,,2,3,2,5
24966_0,,,,2,3,2,5
24967_0,,,,2,3,2,5
24968_0,,,,2,3,2,5
24969_0,,,,2,3,2,5
24970_0,,,,2,3,2,5
24971_0,,,,2,3,2,5
24972_0,,,,2,3,2,5
24973_0,,,,2,3,2,5
24974_0,,,,2,3,2,5
24975_0,,,,2,3,2,5
24976_0,,,,2,3,2,5
24977_0,,,,2,3,2,5
24978_0,,,,2,3,2,5
24979_0,,,,2,3,2,5
24980_0,,,,2,3,2,5
24981_0,,,,2,3,2,5
24982_0,,,,2,3,2,5
24983_0,,,,2,3,2,5
24984_0,,,,2,3,2,5
24985_0,,,,2,3,2,5
24986_0,,,,2,3,2,5
24987_0,,,,2,3,2,5
24988_0,,,,2,3,2,5
24989_0,,,,2,3,2,5
24990_0,,,,2,3,2,5
24991_0,,,,2,3,2,5
24992_0,,,,2,3,2,5
24993_0,,,,2,3,2,5
24994_0,,,,2,3,2,5
24995_0,,,,2,3,2,5
24996_0,,,,2,3,2,5
24997_0,,,,2,3,2,5
24998_0,,,,2,3,2,5
24999_0,,,,2,3,2,5
25000_0,,,,2,3,2,5
25001_0,,,,2,3,2,5
25002_0,,,,2,3,2,5
25003_0,,,,2,3,2,5
25004_0,,,,2,3,2,5
25005_0,,,,2,3,2,5
25007_0,,,,2,3,2,5
C(C(CO)(C(CO)(CO)O)O)O,,,5,1,2,0,2
25009_0,,,,2,3,2,5
CC(CO)(C(CO)(CO)O)O,,,5,1,3,0,3
25010_0,,,,2,3,2,5
25011_0,,,,2,3,2,5
25012_0,,,,2,3,2,5
25014_0,,,,2,3,2,5
C(C(C(CO)(CO)O)O)=CC,,,5,1,2,0,2
25016_0,,,,2,3,2,5
C=CCC(C(CO)(CO)O)O,,,5,1,2,0,2
25018_0,,,,2,3,2,5
C(C(CO)(C(C(CO)O)O)O)O,,,5,1,4,0,4
25019_0,,,,2,3,2,5
25021_0,,,,2,3,2,5
CC(C(C(CO)(CO)O)O)O,,,5,1,2,0,2
25022_0,,,,2,3,2,5
25024_0,,,,2,3,2,5
CC(CC(C(CO)(CO)O)O)O,,,5,1,2,0,2
25026_0,,,,2,3,2,5
C(CC(C(CO)(CO)O)O)(O)=O,,,5,1,2,0,2
25027_0,,,,2,3,2,5
25028_0,,,,2,3,2,5
25029_0,,,,2,3,2,5
25031_0,,,,2,3,2,5
C(C(CO)(CO)O)O,,,5,1,2,0,2
25033_0,,,,2,3,2,5
[CH](C(O)=O)CC(CO)(CO)C(C)O,,,5,1,2,0,2
25035_0,,,,2,3,2,5
C(CCC(CO)(CO)C(C)O)(O)=O,,,5,1,2,0,2
25037_0,,,,2,3,2,5
C(C(CO)(CO)C[CH]C(O)=O)(O)=O,,,5,1,3,0,3
25039_0,,,,2,3,2,5
C(C(CCC(O)=O)(CO)CO)(O)=O,,,5,1,3,0,3
25041_0,,,,2,3,2,5
C(C)(C(CO)(C(CO)C(C)O)O)=O,,,5,1,2,0,2
25043_0,,,,2,3,2,5
CC(CO)(C(C(CO)C(C)O)O)O,,,5,1,1,0,1
25045_0,,,,2,3,2,5
C(C(CO)C(C(C)=O)(CO)O)(O)=O,,,5,1,3,0,3
25047_0,,,,2,3,2,5
C(C(CO)C(C(C)(CO)O)O)(O)=O,,,5,1,2,0,2
25048_0,,,,2,3,2,5
25049_0,,,,2,3,2,5
25051_0,,,,2,3,2,5
C(CO)(C(CCO)(C(C=O)O)O)=O,,,5,1,2,0,2
25053_0,,,,2,3,2,5
C(CO)(C(C(CO)O)(CCO)O)=O,,,5,1,2,0,2
25055_0,,,,2,3,2,5
C(CO)(C(CO)(CCO)O)=O,,,5,1,2,0,2
25056_0,,,,2,3,2,5
25058_0,,,,2,3,2,5
C(C(C(CO)O)(C(CO)(C)O)O)=O,,,5,1,5,0,5
25060_0,,,,2,3,2,5
C(C(C)(C(CO)(C(CO)O)O)O)=O,,,5,1,3,0,3
25061_0,,,,2,3,2,5
25063_0,,,,2,3,2,5
C(C(C)(CC(C(CO)(C)O)O)O)=O,,,5,1,1,0,1
25065_0,,,,2,3,2,5
C(C(C)(C(CC(CO)(C)O)O)O)=O,,,5,1,2,0,2
25067_0,,,,2,3,2,5
C(C(C(CC(CO)(C)O)O)O)(O)=O,,,5,1,2,0,2
25068_0,,,,2,3,2,5
25070_0,,,,2,3,2,5
C(C(C)(C(C(C)(CCO)O)O)O)=O,,,5,1,2,0,2
25071_0,,,,2,3,2,5
25073_0,,,,2,3,2,5
C(C)(C(CCO)(C(CCO)O)O)=O,,,5,1,2,0,2
25075_0,,,,2,3,2,5
C(C)(C(CCO)(C(CO)(C)O)O)=O,,,5,1,2,0,2
25077_0,,,,2,3,2,5
C(C)(C(CCO)(C(C=CC)O)O)=O,,,5,1,2,0,2
25079_0,,,,2,3,2,5
C(C)(C(C(CC=C)O)(CCO)O)=O,,,5,1,2,0,2
25081_0,,,,2,3,2,5
C(C)(C(C(CO)O)(CCO)O)=O,,,5,1,2,0,2
25083_0,,,,2,3,2,5
C(C)(C(CCO)(C(C(C)O)O)O)=O,,,5,1,2,0,2
25085_0,,,,2,3,2,5
C(C)(C(CCO)(C(C(O)=O)O)O)=O,,,5,1,3,0,3
25086_0,,,,2,3,2,5
25088_0,,,,2,3,2,5
C(C(C)(C(C(C)=O)(CCO)O)O)=O,,,5,1,3,0,3
25090_0,,,,2,3,2,5
C(C)(C(CO)(CCO)O)=O,,,5,1,2,0,2
25092_0,,,,2,3,2,5
C(C)(C(CC(C(CO)(C)O)O)O)=O,,,5,1,1,0,1
25093_0,,,,2,3,2,5
25095_0,,,,2,3,2,5
C(C(C)(C(C)(C(CCO)O)O)O)=O,,,5,1,2,0,2
25097_0,,,,2,3,2,5
C(C(CCO)(C(CO)(C)O)O)=O,,,5,1,2,0,2
25099_0,,,,2,3,2,5
C(C(C)(C(CO)(CCO)O)O)=O,,,5,1,2,0,2
25101_0,,,,2,3,2,5
C(C(C)(C(CO)(CCO)O)O)(O)=O,,,5,1,2,0,2
25103_0,,,,2,3,2,5
C(C(C(CO)(CCO)O)O)(O)=O,,,5,1,2,0,2
25104_0,,,,2,3,2,5
25106_0,,,,2,3,2,5
C(C(CC(C)O)(C(CO)(C)O)O)=O,,,5,1,2,0,2
25108_0,,,,2,3,2,5
C(C(C)(C(CO)(CC(C)O)O)O)=O,,,5,1,2,0,2
25110_0,,,,2,3,2,5
C(C(C(CO)(CC(C)O)O)O)(O)=O,,,5,1,2,0,2
25111_0,,,,2,3,2,5
25113_0,,,,2,3,2,5
C(C(C(CO)(C)O)(CC(O)=O)O)=O,,,5,1,2,0,2
25115_0,,,,2,3,2,5
C(C(C)(C(CO)(CC(O)=O)O)O)=O,,,5,1,2,0,2
25117_0,,,,2,3,2,5
C(CC(CO)(C(C(O)=O)O)O)(O)=O,,,5,1,2,0,2
25118_0,,,,2,3,2,5
25120_0,,,,2,3,2,5
CC(CO)(C(CCO)O)O,,,5,1,1,0,1
25122_0,,,,2,3,2,5
C(C(CCO)(C(CO)(C)O)O)(O)=O,,,5,1,2,0,2
25124_0,,,,2,3,2,5
C(CC(C(C)(C(CO)(C)O)O)=O)=O,,,5,1,2,0,2
25126_0,,,,2,3,2,5
C(C(C)(C(C=O)(C)O)O)(CCO)=O,,,5,1,2,0,2
25128_0,,,,2,3,2,5
C(C(C)(C(C(O)=O)O)O)(CCO)=O,,,5,1,2,0,2
25129_0,,,,2,3,2,5
25130_0,,,,2,3,2,5
25131_0,,,,2,3,2,5
25132_0,,,,2,3,2,5
25134_0,,,,2,3,2,5
C(C)(C(C(C)O)(C(CO)(C)O)O)=O,,,5,1,5,0,5
25136_0,,,,2,3,2,5
C(C(C)O)(C(C)(C(CO)(C)O)O)=O,,,5,1,1,0,1
25138_0,,,,2,3,2,5
C(C(C(C)=O)(C(CO)(C)O)O)(O)=O,,,5,1,5,0,5
25140_0,,,,2,3,2,5
C(C(C(C)(C(CO)(C)O)O)=O)(O)=O,,,5,1,2,0,2
25141_0,,,,2,3,2,5
25142_0,,,,2,3,2,5
25143_0,,,,2,3,2,5
25145_0,,,,2,3,2,5
CC(CO)(C(C)(CO)O)O,,,5,1,1,0,1
25147_0,,,,2,3,2,5
C(C(C)(C(C(CO)(C)O)O)O)(O)=O,,,5,1,2,0,2
25149_0,,,,2,3,2,5
C(C(C)C(C)(C(C)(CO)O)O)(O)=O,,,5,1,1,0,1
25151_0,,,,2,3,2,5
C(C(C(CO)(C)O)O)=CC,,,5,1,1,0,1
25153_0,,,,2,3,2,5
C=CCC(C(C)(CO)O)O,,,5,1,1,0,1
25155_0,,,,2,3,2,5
C(C(C=CC)(C(CO)(C)O)O)(O)=O,,,5,1,2,0,2
25157_0,,,,2,3,2,5
C(C(C(CO)(C)O)(CC=C)O)(O)=O,,,5,1,2,0,2
25159_0,,,,2,3,2,5
C=C(C(O)=O)CC(C(C)(CO)O)O,,,5,1,1,0,1
25161_0,,,,2,3,2,5
C(C(C(CO)(C)O)O)=C(C(O)=O)C,,,5,1,1,0,1
25163_0,,,,2,3,2,5
CC(CO)(C(C(CO)O)O)O,,,5,1,3,0,3
25164_0,,,,2,3,2,5
25166_0,,,,2,3,2,5
C1(C(CC(C)O1)(C(CO)(C)O)O)=O,,,5,1,2,0,2
25168_0,,,,2,3,2,5
C1(C(C(CO)(C)O)(CC(O1)=O)O)=O,,,5,1,2,0,2
25170_0,,,,2,3,2,5
C(CO)(C(CO)(C[CH]C(O)=O)O)=O,,,5,1,3,0,3
25172_0,,,,2,3,2,5
C(CCC(C(CO)=O)(CO)O)(O)=O,,,5,1,3,0,3
25174_0,,,,2,3,2,5
[CH](C(O)=O)CCC(C(C)(CO)O)O,,,5,1,1,0,1
25176_0,,,,2,3,2,5
C(CCCC(C(C)(CO)O)O)(O)=O,,,5,1,1,0,1
25178_0,,,,2,3,2,5
CC(CO)(C(C(C)O)O)O,,,5,1,1,0,1
25180_0,,,,2,3,2,5
CC(CO)(C(C)O)O,,,5,1,1,0,1
25182_0,,,,2,3,2,5
CC(CC(C(C)(CO)O)O)O,,,5,1,1,0,1
25184_0,,,,2,3,2,5
C(CC(C(C)(CO)O)O)(O)=O,,,5,1,1,0,1
25185_0,,,,2,3,2,5
25187_0,,,,2,3,2,5
CC(CO)(CO)O,,,5,1,1,0,1
25188_0,,,,2,3,2,5
25190_0,,,,2,3,2,5
C(C(CO)(C)OC(CO)=O)(O)=O,,,5,1,1,0,1
25192_0,,,,2,3,2,5
C(C(CO)O)(OC(C(O)=O)C)=O,,,5,1,1,0,1
25194_0,,,,2,3,2,5
C(C(CO)(C)O)(OC(CO)=O)=O,,,5,1,1,0,1
25196_0,,,,2,3,2,5
C(C(CO)O)(OC(C(C)O)=O)=O,,,5,1,2,0,2
25198_0,,,,2,3,2,5
C(C(CO)(C)O)(OCC(O)=O)=O,,,5,1,1,0,1
25200_0,,,,2,3,2,5
C(C(C)O)(OC(C(O)=O)CO)=O,,,5,1,1,0,1
25202_0,,,,2,3,2,5
C(C(CO)=O)(CCC(C)O)=O,,,5,1,3,0,3
25204_0,,,,2,3,2,5
C(CC(C)O)(CC(CO)=O)=O,,,5,1,2,0,2
25206_0,,,,2,3,2,5
C(C(C(C)O)C(C=O)CO)=O,,,5,1,4,0,4
25208_0,,,,2,3,2,5
C(C(C=O)C(CO)C(C)O)=O,,,5,1,2,0,2
25209_0,,,,2,3,2,5
25211_0,,,,2,3,2,5
C(C(C=O)C(CO)C(C)O)(O)=O,,,5,1,2,0,2
25212_0,,,,2,3,2,5
25214_0,,,,2,3,2,5
C(CC(CC(CO)=O)=O)(O)=O,,,5,1,3,0,3
25215_0,,,,2,3,2,5
25217_0,,,,2,3,2,5
C(C(C=O)C(C(O)=O)CO)=O,,,5,1,2,0,2
25218_0,,,,2,3,2,5
25219_0,,,,2,3,2,5
25220_0,,,,2,3,2,5
25222_0,,,,2,3,2,5
C(C(C(C(CO)CO)=O)=O)=O,,,5,1,2,0,2
25223_0,,,,2,3,2,5
25224_0,,,,2,3,2,5
25226_0,,,,2,3,2,5
C(C(C=O)CC(CO)=O)=O,,,5,1,2,0,2
25228_0,,,,2,3,2,5
C(C(CO)CC(C=O)=O)=O,,,5,1,4,0,4
25229_0,,,,2,3,2,5
25230_0,,,,2,3,2,5
25232_0,,,,2,3,2,5
C(C(C=O)CCO)=O,,,5,1,2,0,2
25234_0,,,,2,3,2,5
C(C(CO)CC=O)=O,,,5,1,4,0,4
25236_0,,,,2,3,2,5
C(C(CO)CC(C(O)=O)=O)=O,,,5,1,4,0,4
25237_0,,,,2,3,2,5
25239_0,,,,2,3,2,5
C(C(C(C(CO)=O)=O)C)=O,,,5,1,3,0,3
25241_0,,,,2,3,2,5
C(C)(CC(C(CO)=O)=O)=O,,,5,1,2,0,2
25242_0,,,,2,3,2,5
25243_0,,,,2,3,2,5
25244_0,,,,2,3,2,5
25245_0,,,,2,3,2,5
25246_0,,,,2,3,2,5
25248_0,,,,2,3,2,5
C(C)(CC(CO)=O)=O,,,5,1,4,0,4
25249_0,,,,2,3,2,5
25250_0,,,,2,3,2,5
25251_0,,,,2,3,2,5
25253_0,,,,2,3,2,5
C(C(C=O)CC(CO)=O)(O)=O,,,5,1,3,0,3
25254_0,,,,2,3,2,5
25255_0,,,,2,3,2,5
25256_0,,,,2,3,2,5
25257_0,,,,2,3,2,5
25258_0,,,,2,3,2,5
25259_0,,,,2,3,2,5
25260_0,,,,2,3,2,5
25261_0,,,,2,3,2,5
25262_0,,,,2,3,2,5
25264_0,,,,2,3,2,5
C(C(C)CO)(O)=O,,,5,1,1,0,1
25265_0,,,,2,3,2,5
25266_0,,,,2,3,2,5
25268_0,,,,2,3,2,5
C1(C(CO)C(C(O1)=O)(C)O)=O,,,5,1,5,0,5
25269_0,,,,2,3,2,5
25271_0,,,,2,3,2,5
C(C)=C(CO)C(CC(C)O)O,,,5,1,2,0,2
25273_0,,,,2,3,2,5
C(CC(C)O)=C(CO)C(C)O,,,5,1,2,0,2
25275_0,,,,2,3,2,5
C(C(CO)C(C)O)=CC(C)O,,,5,1,2,0,2
25277_0,,,,2,3,2,5
C(CC(C)O)=C(C(O)=O)CO,,,5,1,2,0,2
25279_0,,,,2,3,2,5
C(C(C=CC(C)O)CO)(O)=O,,,5,1,2,0,2
25281_0,,,,2,3,2,5
C(CO)(C(C=CC(C)O)O)=O,,,5,1,2,0,2
25283_0,,,,2,3,2,5
C(CC(C)O)=CC(CO)=O,,,5,1,2,0,2
25285_0,,,,2,3,2,5
C(CO)(CC=CC(C)O)=O,,,5,1,2,0,2
25287_0,,,,2,3,2,5
C(CC(C)O)=CCO,,,5,1,2,0,2
25289_0,,,,2,3,2,5
C(CCO)=CC(C)O,,,5,1,2,0,2
25291_0,,,,2,3,2,5
C(C(CO)C(C)O)=CC(O)=O,,,5,1,2,0,2
25293_0,,,,2,3,2,5
C(CC=C(CO)C(C)O)(O)=O,,,5,1,3,0,3
25295_0,,,,2,3,2,5
C(CC(C(CO)=CC)O)(O)=O,,,5,1,2,0,2
25297_0,,,,2,3,2,5
C(CO)(C(C)O)=CC(CO)=O,,,5,1,2,0,2
25299_0,,,,2,3,2,5
C(CO)(C(C(CO)=CC)O)=O,,,5,1,2,0,2
25301_0,,,,2,3,2,5
C(CO)(CO)=C(C=O)C(C)O,,,5,1,2,0,2
25303_0,,,,2,3,2,5
C(CO)(C(C)O)=C(C=O)CO,,,5,1,2,0,2
25305_0,,,,2,3,2,5
C(C)=C(C=O)C(CO)(CO)O,,,5,1,2,0,2
25307_0,,,,2,3,2,5
C(C(C(CO)=CC)(CO)O)=O,,,5,1,2,0,2
25309_0,,,,2,3,2,5
C(C(C(CO)=C)C(C)O)=O,,,5,1,2,0,2
25311_0,,,,2,3,2,5
C=C(C=O)C(CO)C(C)O,,,5,1,2,0,2
25313_0,,,,2,3,2,5
C(CO)(C)=C(C=O)C(C)O,,,5,1,2,0,2
25315_0,,,,2,3,2,5
C(CO)(C(C)O)=C(C=O)C,,,5,1,2,0,2
25317_0,,,,2,3,2,5
C(C)=C(C=O)C(CO)(C)O,,,5,1,2,0,2
25319_0,,,,2,3,2,5
C(C(C(CO)=CC)(C)O)=O,,,5,1,2,0,2
25321_0,,,,2,3,2,5
C(CO)(C(C)O)=CC(C)=O,,,5,1,2,0,2
25323_0,,,,2,3,2,5
C(C)(C(C(CO)=CC)O)=O,,,5,1,2,0,2
25325_0,,,,2,3,2,5
C=C(CO)C(C)O,,,5,1,2,0,2
25327_0,,,,2,3,2,5
C(C)=C(CO)CO,,,5,1,2,0,2
25329_0,,,,2,3,2,5
C(CO)(C(C)O)=C(C(O)=O)CO,,,5,1,2,0,2
25331_0,,,,2,3,2,5
C(C(C(CO)=CC)(CO)O)(O)=O,,,5,1,2,0,2
25333_0,,,,2,3,2,5
C(C)=C(CO)C(C)O,,,5,1,2,0,2
25335_0,,,,2,3,2,5
C(C)=C(C(O)=O)CO,,,5,1,4,0,4
25337_0,,,,2,3,2,5
C(CO)(C(C)O)=C(C(O)=O)C,,,5,1,2,0,2
25339_0,,,,2,3,2,5
C(C(C(CO)=CC)(C)O)(O)=O,,,5,1,2,0,2
25341_0,,,,2,3,2,5
C(CO)=C(C(O)=O)CC(C)O,,,5,1,2,0,2
25343_0,,,,2,3,2,5
C(C(C)O)=C(C(O)=O)CCO,,,5,1,2,0,2
25344_0,,,,2,3,2,5
25346_0,,,,2,3,2,5
C(C(C=CC(O)=O)CO)(O)=O,,,5,1,4,0,4
25348_0,,,,2,3,2,5
C(CO)(C(C=CC(O)=O)O)=O,,,5,1,3,0,3
25350_0,,,,2,3,2,5
C(CC=CC(CO)=O)(O)=O,,,5,1,3,0,3
25352_0,,,,2,3,2,5
C(CO)(CC=CC(O)=O)=O,,,5,1,2,0,2
25353_0,,,,2,3,2,5
25355_0,,,,2,3,2,5
C(CCO)=CC(O)=O,,,5,1,2,0,2
25357_0,,,,2,3,2,5
C(C(CO)=CC(CO)=O)(O)=O,,,5,1,4,0,4
25359_0,,,,2,3,2,5
C(CO)(CO)=C(C(O)=O)C=O,,,5,1,2,0,2
25361_0,,,,2,3,2,5
C(C(CO)=C(C=O)CO)(O)=O,,,5,1,3,0,3
25363_0,,,,2,3,2,5
C(C(C=O)C(CO)=C)(O)=O,,,5,1,2,0,2
25365_0,,,,2,3,2,5
C(C(C(C=O)=C)CO)(O)=O,,,5,1,2,0,2
25367_0,,,,2,3,2,5
C(C)(CO)=C(C(O)=O)C=O,,,5,1,2,0,2
25369_0,,,,2,3,2,5
C(C(CO)=C(C=O)C)(O)=O,,,5,1,2,0,2
25371_0,,,,2,3,2,5
C(C(CO)=CC(C)=O)(O)=O,,,5,1,2,0,2
25373_0,,,,2,3,2,5
C(C(CO)=C(C(O)=O)CO)(O)=O,,,5,1,2,0,2
25375_0,,,,2,3,2,5
C(C(C)=C(C(O)=O)CO)(O)=O,,,5,1,3,0,3
25377_0,,,,2,3,2,5
C(C(C)(CC=CCO)O)(O)=O,,,5,1,2,0,2
25379_0,,,,2,3,2,5
C(C(C=CCCO)(C)O)(O)=O,,,5,1,2,0,2
25381_0,,,,2,3,2,5
C(C(C(CO)=C)(C)O)(O)=O,,,5,1,3,0,3
25383_0,,,,2,3,2,5
C(CO)(CO)=C(C(O)=O)C,,,5,1,2,0,2
25385_0,,,,2,3,2,5
C(CC(C(O)=O)=CCO)(O)=O,,,5,1,2,0,2
25387_0,,,,2,3,2,5
C(C=C(C(O)=O)CCO)(O)=O,,,5,1,2,0,2
25389_0,,,,2,3,2,5
C(C=CC(CO)=O)(CO)=O,,,5,1,2,0,2
25391_0,,,,2,3,2,5
C(CO)=CC(CO)=O,,,5,1,3,0,3
25393_0,,,,2,3,2,5
C(C(CO)=CC(CO)=O)=O,,,5,1,3,0,3
25395_0,,,,2,3,2,5
C(CO)(CO)=CC(C=O)=O,,,5,1,2,0,2
25397_0,,,,2,3,2,5
C(CO)=C(C=O)CO,,,5,1,3,0,3
25399_0,,,,2,3,2,5
C(CO)(CO)=CC=O,,,5,1,2,0,2
25401_0,,,,2,3,2,5
C(CO)(CO)=CC(C(O)=O)=O,,,5,1,2,0,2
25403_0,,,,2,3,2,5
C=C(CO)C(C(C=O)=O)O,,,5,1,2,0,2
25405_0,,,,2,3,2,5
C(CO)(C(C(C=O)=C)O)=O,,,5,1,3,0,3
25407_0,,,,2,3,2,5
C(CO)(C(C=C)O)=O,,,5,1,3,0,3
25409_0,,,,2,3,2,5
C(C(C)=CC(CO)=O)=O,,,5,1,2,0,2
25411_0,,,,2,3,2,5
C(C)(CO)=CC(C=O)=O,,,5,1,2,0,2
25413_0,,,,2,3,2,5
C(CO)(CC(C=O)=C)=O,,,5,1,2,0,2
25415_0,,,,2,3,2,5
C=C(CO)CC(C=O)=O,,,5,1,2,0,2
25417_0,,,,2,3,2,5
C=C(CO)C(C(C(O)=O)=O)O,,,5,1,2,0,2
25419_0,,,,2,3,2,5
C(CO)=C(C=O)C,,,5,1,2,0,2
25421_0,,,,2,3,2,5
C(C)(CO)=CC=O,,,5,1,2,0,2
25423_0,,,,2,3,2,5
C=C(C=O)CCO,,,5,1,2,0,2
25425_0,,,,2,3,2,5
C(CC(CO)=C)=O,,,5,1,2,0,2
25427_0,,,,2,3,2,5
C(C)(CO)=CC(C(O)=O)=O,,,5,1,2,0,2
25429_0,,,,2,3,2,5
C=C(CO)CC(C(O)=O)=O,,,5,1,2,0,2
25431_0,,,,2,3,2,5
C(C=CC(CO)=O)(C)=O,,,5,1,2,0,2
25433_0,,,,2,3,2,5
C(CO)=CC(C)=O,,,5,1,2,0,2
25435_0,,,,2,3,2,5
C=CC(CO)=O,,,5,1,7,0,7
25436_0,,,,2,3,2,5
25438_0,,,,2,3,2,5
C(CO)(CC=C)=O,,,5,1,2,0,2
25440_0,,,,2,3,2,5
C(C)=CC(CO)=O,,,5,1,4,0,4
25442_0,,,,2,3,2,5
C=CCO,,,5,1,4,0,4
25444_0,,,,2,3,2,5
C(CO)=C(C(O)=O)CO,,,5,1,3,0,3
25446_0,,,,2,3,2,5
C(C(C(CO)=C)(CO)O)(O)=O,,,5,1,2,0,2
25448_0,,,,2,3,2,5
C=C(C(O)=O)C(CO)(CO)O,,,5,1,4,0,4
25450_0,,,,2,3,2,5
C(C(C(CO)=C)O)(O)=O,,,5,1,2,0,2
25452_0,,,,2,3,2,5
C=C(C(O)=O)C(CO)(C)O,,,5,1,3,0,3
25454_0,,,,2,3,2,5
C(C)=C(CO)C[CH]C(O)=O,,,5,1,2,0,2
25456_0,,,,2,3,2,5
C(C(CO)C[CH]C(O)=O)=C,,,5,1,3,0,3
25458_0,,,,2,3,2,5
C(CCC(CO)=CC)(O)=O,,,5,1,2,0,2
25460_0,,,,2,3,2,5
C(CCC(C=C)CO)(O)=O,,,5,1,3,0,3
25462_0,,,,2,3,2,5
C(CC[CH]C(O)=O)=CCO,,,5,1,3,0,3
25464_0,,,,2,3,2,5
C(C[CH]C(O)=O)=CCCO,,,5,1,2,0,2
25466_0,,,,2,3,2,5
C(CCCC=CCO)(O)=O,,,5,1,3,0,3
25468_0,,,,2,3,2,5
C(CCC=CCCO)(O)=O,,,5,1,2,0,2
25470_0,,,,2,3,2,5
C(C)(CCO)=C[CH]C(O)=O,,,5,1,2,0,2
25472_0,,,,2,3,2,5
C(CO)=C(C)C[CH]C(O)=O,,,5,1,2,0,2
25474_0,,,,2,3,2,5
C=C(CCO)C[CH]C(O)=O,,,5,1,2,0,2
25476_0,,,,2,3,2,5
C(CC=C(C)CCO)(O)=O,,,5,1,2,0,2
25478_0,,,,2,3,2,5
C(CCC(C)=CCO)(O)=O,,,5,1,2,0,2
25480_0,,,,2,3,2,5
C(CCC(CCO)=C)(O)=O,,,5,1,2,0,2
25482_0,,,,2,3,2,5
C([CH]C=CC(CO)=O)(O)=O,,,5,1,2,0,2
25484_0,,,,2,3,2,5
CC(CC(C(C(CO)O)O)O)O,,,5,1,3,0,3
25486_0,,,,2,3,2,5
CC(C(CO)(C(CO)(CO)O)O)O,,,5,1,2,0,2
25488_0,,,,2,3,2,5
CC(CO)(C(CO)(C(C)O)O)O,,,5,1,2,0,2
25490_0,,,,2,3,2,5
C(CC(C(C(CO)O)O)O)(O)=O,,,5,1,3,0,3
25492_0,,,,2,3,2,5
[CH](C(O)=O)CC(C(CO)O)O,,,5,1,5,0,5
25494_0,,,,2,3,2,5
C(CCC(C(CO)O)O)(O)=O,,,5,1,5,0,5
25496_0,,,,2,3,2,5
CCC(CO)O,,,5,1,3,0,3
25498_0,,,,2,3,2,5
C(CCCO)O,,,5,1,2,0,2
25500_0,,,,2,3,2,5
C(C(CO)CCO)(O)=O,,,5,1,3,0,3
25501_0,,,,2,3,2,5
25503_0,,,,2,3,2,5
CC1C(CO)C(C(CO)(O)O1)O,,,5,1,2,0,2
25505_0,,,,2,3,2,5
C1C(CO)(C(C(O)O1)C(C)O)O,,,5,1,2,0,2
25507_0,,,,2,3,2,5
CC1C(CO)C(C(O)O1)(CO)O,,,5,1,2,0,2
25509_0,,,,2,3,2,5
CC1(C(O)OC(C)C1CO)O,,,5,1,2,0,2
25511_0,,,,2,3,2,5
CC1(C(C(CO)C(C)O1)O)O,,,5,1,2,0,2
25513_0,,,,2,3,2,5
C1(C(CO)C(C(CO)(O)O1)O)=O,,,5,1,2,0,2
25515_0,,,,2,3,2,5
C(C1C(O)OCC1(CO)O)(O)=O,,,5,1,2,0,2
25517_0,,,,2,3,2,5
C1(C(CO)C(CO)(C(O)O1)O)=O,,,5,1,2,0,2
25519_0,,,,2,3,2,5
C1(C(CO)C(C)(C(O)O1)O)=O,,,5,1,2,0,2
25521_0,,,,2,3,2,5
C1(C(CO)C(C(C)(O)O1)O)=O,,,5,1,2,0,2
25523_0,,,,2,3,2,5
C1(C(O)OC(CO)(CO)C1O)=O,,,5,1,2,0,2
25525_0,,,,2,3,2,5
C(C1(COC(CO)(C1O)O)O)=O,,,5,1,2,0,2
25527_0,,,,2,3,2,5
C(C1(C(C(CO)(CO1)O)O)O)=O,,,5,1,2,0,2
25529_0,,,,2,3,2,5
C1(C(O)OC(CO)(CO)C1)=O,,,5,1,2,0,2
25531_0,,,,2,3,2,5
C(C1(COC(CO)(C1)O)O)=O,,,5,1,2,0,2
25533_0,,,,2,3,2,5
C(C1(CC(CO)(CO1)O)O)=O,,,5,1,2,0,2
25535_0,,,,2,3,2,5
C(C1(C(C(CO)(CO1)O)O)O)(O)=O,,,5,1,2,0,2
25537_0,,,,2,3,2,5
C1C(CO)(CC(O)O1)O,,,5,1,2,0,2
25539_0,,,,2,3,2,5
C(C1(CC(CO)(CO1)O)O)(O)=O,,,5,1,2,0,2
25541_0,,,,2,3,2,5
C1(C(O)OC(CO)(C)C1O)=O,,,5,1,2,0,2
25542_0,,,,2,3,2,5
25543_0,,,,2,3,2,5
25544_0,,,,2,3,2,5
25546_0,,,,2,3,2,5
C1(C(O)OC(CO)(C)C1)=O,,,5,1,2,0,2
25548_0,,,,2,3,2,5
C(C1(COC(CO)(C1)O)O)(O)=O,,,5,1,2,0,2
25550_0,,,,2,3,2,5
C1(C(CO)(CC(CO)(O)O1)O)=O,,,5,1,2,0,2
25552_0,,,,2,3,2,5
C1(C(C)(CC(CO)(O)O1)O)=O,,,5,1,2,0,2
25554_0,,,,2,3,2,5
CC1CC(C(C(CO)(O)O1)O)O,,,5,1,2,0,2
25556_0,,,,2,3,2,5
CC1CC(CC(CO)(O)O1)O,,,5,1,2,0,2
25558_0,,,,2,3,2,5
C1(CC(C(C(CO)(O)O1)O)O)=O,,,5,1,2,0,2
25560_0,,,,2,3,2,5
C1(CC(CC(CO)(O)O1)O)=O,,,5,1,2,0,2
25562_0,,,,2,3,2,5
C1(COC(CO)(C(C1O)O)O)=O,,,5,1,2,0,2
25564_0,,,,2,3,2,5
C1(COC(CO)(CC1O)O)=O,,,5,1,2,0,2
25566_0,,,,2,3,2,5
C1(C(O)OCC(CO)(C1O)O)=O,,,5,1,2,0,2
25568_0,,,,2,3,2,5
C1(C(O)OCC(CO)(C1)O)=O,,,5,1,2,0,2
25570_0,,,,2,3,2,5
[CH]1C(OC(CO)(C(C1)O)O)=O,,,5,1,2,0,2
25572_0,,,,2,3,2,5
C1(CCC(C(CO)(O)O1)O)=O,,,5,1,2,0,2
25574_0,,,,2,3,2,5
[CH]1C(OC(CC1)(CO)O)=O,,,5,1,2,0,2
25576_0,,,,2,3,2,5
C1(CCCC(CO)(O)O1)=O,,,5,1,2,0,2
25577_0,,,,2,3,2,5
25578_0,,,,2,3,2,5
25580_0,,,,2,3,2,5
C1(C(CO)(C(CO)C(C)O1)O)=O,,,5,1,2,0,2
25582_0,,,,2,3,2,5
C1(C(C)(C(CO)C(C)O1)O)=O,,,5,1,2,0,2
25584_0,,,,2,3,2,5
C1(CC(C(C(CO)=O)O1)O)=O,,,5,1,2,0,2
25586_0,,,,2,3,2,5
C1(C(C=O)C(CO1)(CO)O)=O,,,5,1,2,0,2
25588_0,,,,2,3,2,5
C1(C(CO)C(C=O)(CO1)O)=O,,,5,1,2,0,2
25590_0,,,,2,3,2,5
C1(C(CO)C(C(O1)=O)(CO)O)=O,,,5,1,4,0,4
25592_0,,,,2,3,2,5
C1(C(CO)C(C(O)=O)(CO1)O)=O,,,5,1,4,0,4
25594_0,,,,2,3,2,5
C1(C(C)(CC(CCO)O1)O)=O,,,5,1,2,0,2
25596_0,,,,2,3,2,5
C1(C(C)(C(CO)CO1)O)=O,,,5,1,2,0,2
25598_0,,,,2,3,2,5
C1(C(C(C(CO)(CO)O1)O)=O)=O,,,5,1,2,0,2
25600_0,,,,2,3,2,5
C1(C(CC(CO)(CO)O1)=O)=O,,,5,1,2,0,2
25602_0,,,,2,3,2,5
C1(C(C(C(CO)(C)O1)O)=O)=O,,,5,1,2,0,2
25604_0,,,,2,3,2,5
C1(C(CC(C)(CO)O1)=O)=O,,,5,1,2,0,2
25606_0,,,,2,3,2,5
C1(C(CO)(C(CO)(CO1)O)O)=O,,,5,1,2,0,2
25608_0,,,,2,3,2,5
C1(C(C(CO)(CO1)O)O)=O,,,5,1,2,0,2
25610_0,,,,2,3,2,5
C1(C(C)(C(CO)(CO1)O)O)=O,,,5,1,3,0,3
25612_0,,,,2,3,2,5
[CH]1C(OC(C)(CCO)C1)=O,,,5,1,2,0,2
25614_0,,,,2,3,2,5
C1(CCC(C)(CCO)O1)=O,,,5,1,2,0,2
25616_0,,,,2,3,2,5
C(CO)(C1C[CH]C(O1)=O)=O,,,5,1,2,0,2
25618_0,,,,2,3,2,5
C1(CCC(C(CO)=O)O1)=O,,,5,1,2,0,2
25620_0,,,,2,3,2,5
C1(C(CO)C(CC(C)O1)O)=O,,,5,1,2,0,2
25622_0,,,,2,3,2,5
C1(CC(C(CO)C(C)O1)O)=O,,,5,1,2,0,2
25624_0,,,,2,3,2,5
C1(C(CO)C(CC(O1)=O)O)=O,,,5,1,2,0,2
25626_0,,,,2,3,2,5
C1(C(CO)C(C(CO1)=O)O)=O,,,5,1,2,0,2
25628_0,,,,2,3,2,5
C1(C(C(C(CO)(CO1)O)O)=O)=O,,,5,1,2,0,2
25630_0,,,,2,3,2,5
C1(C(CC(CO1)(CO)O)=O)=O,,,5,1,2,0,2
25632_0,,,,2,3,2,5
[CH]1C(OC(C)C(CO)C1)=O,,,5,1,2,0,2
25634_0,,,,2,3,2,5
C1(CCC(CO)C(C)O1)=O,,,5,1,2,0,2
25636_0,,,,2,3,2,5
[CH]1C(OC(CC1)CCO)=O,,,5,1,2,0,2
25638_0,,,,2,3,2,5
C1(CCCC(CCO)O1)=O,,,5,1,2,0,2
25640_0,,,,2,3,2,5
C1(C(CO)C[CH]C(O1)=O)=O,,,5,1,2,0,2
25642_0,,,,2,3,2,5
C1(C(CCC(O1)=O)CO)=O,,,5,1,2,0,2
25644_0,,,,2,3,2,5
C(C(C(C)O)C(C(C)CCO)O)=O,,,5,1,1,0,1
25646_0,,,,2,3,2,5
C(CC(C)C(C(CO)C(C)O)O)=O,,,5,1,2,0,2
25648_0,,,,2,3,2,5
[CH](C(O)=O)CC(C(CO)C(C)O)O,,,5,1,2,0,2
25650_0,,,,2,3,2,5
C(CCC(C(CO)C(C)O)O)(O)=O,,,5,1,2,0,2
25652_0,,,,2,3,2,5
C(C(CO)(C(C)O)C(C)CCO)=O,,,5,1,1,0,1
25654_0,,,,2,3,2,5
C(CC(C)C(CO)(CO)C(C)O)=O,,,5,1,2,0,2
25655_0,,,,2,3,2,5
25657_0,,,,2,3,2,5
C(CC(C)CC(C(CO)CO)O)=O,,,5,1,2,0,2
25659_0,,,,2,3,2,5
C(C(CO)C(C)(C(C)CCO)O)=O,,,5,1,1,0,1
25661_0,,,,2,3,2,5
C(CC(C)C(C)(C(CO)CO)O)=O,,,5,1,2,0,2
25663_0,,,,2,3,2,5
C(C(C=O)C(C(C)CCO)O)(O)=O,,,5,1,1,0,1
25665_0,,,,2,3,2,5
C(C(CO)C(C(C)CC=O)O)(O)=O,,,5,1,3,0,3
25667_0,,,,2,3,2,5
C(C(CO)C(C[CH]C(O)=O)O)(O)=O,,,5,1,4,0,4
25669_0,,,,2,3,2,5
C(C(CO)C(CCC(O)=O)O)(O)=O,,,5,1,4,0,4
25671_0,,,,2,3,2,5
C(C(C=O)(CO)C(C)CCO)(O)=O,,,5,1,1,0,1
25673_0,,,,2,3,2,5
C(C(CO)(CO)C(C)CC=O)(O)=O,,,5,1,3,0,3
25675_0,,,,2,3,2,5
C(C(C(C(C(C)CCO)O)O)=O)=O,,,5,1,1,0,1
25677_0,,,,2,3,2,5
C(CC(C)C(C(C(CO)=O)O)O)=O,,,5,1,2,0,2
25678_0,,,,2,3,2,5
25679_0,,,,2,3,2,5
25681_0,,,,2,3,2,5
C(C(C(CO)(C(C)CCO)O)=O)=O,,,5,1,1,0,1
25683_0,,,,2,3,2,5
C(CC(C)C(C(CO)=O)(CO)O)=O,,,5,1,3,0,3
25684_0,,,,2,3,2,5
25686_0,,,,2,3,2,5
C(C(C)(C(CO)C(C)CC=O)O)=O,,,5,1,2,0,2
25687_0,,,,2,3,2,5
25689_0,,,,2,3,2,5
C(C(CC(C)CCO)(CC=O)O)=O,,,5,1,1,0,1
25691_0,,,,2,3,2,5
C(C(CCO)(CC(C)CC=O)O)=O,,,5,1,2,0,2
25692_0,,,,2,3,2,5
25693_0,,,,2,3,2,5
25695_0,,,,2,3,2,5
C(CC(C)C(CO)C(C(C)=O)O)=O,,,5,1,2,0,2
25697_0,,,,2,3,2,5
C(CC(C(CC(C)CCO)=O)O)=O,,,5,1,1,0,1
25699_0,,,,2,3,2,5
C(CC(C)CC(C(CCO)O)=O)=O,,,5,1,2,0,2
25701_0,,,,2,3,2,5
C(C)(C(C(C)CCO)(CC=O)O)=O,,,5,1,1,0,1
25703_0,,,,2,3,2,5
C(CC(C)C(C(C)=O)(CCO)O)=O,,,5,1,2,0,2
25705_0,,,,2,3,2,5
C(C)(C(CCO)(C[CH]C(O)=O)O)=O,,,5,1,2,0,2
25707_0,,,,2,3,2,5
C(CCC(C(C)=O)(CCO)O)(O)=O,,,5,1,2,0,2
25709_0,,,,2,3,2,5
C(C(CC(C(C)CCO)O)=O)=O,,,5,1,1,0,1
25711_0,,,,2,3,2,5
C(CC(C)C(CC(CO)=O)O)=O,,,5,1,2,0,2
25712_0,,,,2,3,2,5
25713_0,,,,2,3,2,5
25715_0,,,,2,3,2,5
C(C(C(CO)C(C)CCO)=O)=O,,,5,1,1,0,1
25716_0,,,,2,3,2,5
25717_0,,,,2,3,2,5
25718_0,,,,2,3,2,5
25720_0,,,,2,3,2,5
C(C(CC(C)(C(C)CCO)O)=O)=O,,,5,1,1,0,1
25722_0,,,,2,3,2,5
C(CC(C)C(C)(CC(CO)=O)O)=O,,,5,1,2,0,2
25723_0,,,,2,3,2,5
25724_0,,,,2,3,2,5
25726_0,,,,2,3,2,5
C(C(C(C(C)O)C(C)CCO)=O)=O,,,5,1,1,0,1
25727_0,,,,2,3,2,5
25729_0,,,,2,3,2,5
C(C(C(C=O)=O)C(C)CCO)(O)=O,,,5,1,1,0,1
25730_0,,,,2,3,2,5
25731_0,,,,2,3,2,5
25733_0,,,,2,3,2,5
C(CC(C)C(CO)CO)=O,,,5,1,2,0,2
25735_0,,,,2,3,2,5
C(C(CC(C)C(CO)CO)=O)(O)=O,,,5,1,2,0,2
25737_0,,,,2,3,2,5
C(C(CC(C=O)CO)CCO)(O)=O,,,5,1,2,0,2
25739_0,,,,2,3,2,5
C(C(CC(CO)CO)CC=O)(O)=O,,,5,1,2,0,2
25740_0,,,,2,3,2,5
25742_0,,,,2,3,2,5
C(C(C)(C(CO)CO)CC=O)(O)=O,,,5,1,2,0,2
25744_0,,,,2,3,2,5
C(C(C)C(CO)C(C=O)CO)(O)=O,,,5,1,2,0,2
25746_0,,,,2,3,2,5
C(C(C)C(C=O)C(CO)CO)(O)=O,,,5,1,2,0,2
25748_0,,,,2,3,2,5
C(C(CC(CO)CO)C(C)O)(O)=O,,,5,1,2,0,2
25750_0,,,,2,3,2,5
C(C(C(O)=O)CC(CO)CO)(O)=O,,,5,1,2,0,2
25752_0,,,,2,3,2,5
C(CC(C(C)CCO)O)=O,,,5,1,1,0,1
25754_0,,,,2,3,2,5
C(CC(C)C(CCO)O)=O,,,5,1,2,0,2
25756_0,,,,2,3,2,5
C(C(CC(C)C(CCO)O)=O)(O)=O,,,5,1,2,0,2
25757_0,,,,2,3,2,5
25759_0,,,,2,3,2,5
C(C(CC(CCO)O)CC=O)(O)=O,,,5,1,2,0,2
25761_0,,,,2,3,2,5
C(C(C)(C(CC=O)O)CCO)(O)=O,,,5,1,1,0,1
25763_0,,,,2,3,2,5
C(C(C)(C(CCO)O)CC=O)(O)=O,,,5,1,2,0,2
25764_0,,,,2,3,2,5
25766_0,,,,2,3,2,5
C(C(C)C(C=O)C(CCO)O)(O)=O,,,5,1,2,0,2
25768_0,,,,2,3,2,5
C(C(CC(CCO)O)C(C)O)(O)=O,,,5,1,2,0,2
25770_0,,,,2,3,2,5
C(C(C(O)=O)CC(CCO)O)(O)=O,,,5,1,2,0,2
25772_0,,,,2,3,2,5
[CH](C(O)=O)CC(CCO)O,,,5,1,2,0,2
25774_0,,,,2,3,2,5
C(CCC(CCO)O)(O)=O,,,5,1,2,0,2
25775_0,,,,2,3,2,5
25777_0,,,,2,3,2,5
C(C(CC(C(C)CCO)O)=O)(O)=O,,,5,1,1,0,1
25779_0,,,,2,3,2,5
C(CC(C(CC(C)CCO)=O)=O)=O,,,5,1,1,0,1
25781_0,,,,2,3,2,5
C(CC(C)CC(C(CCO)=O)=O)=O,,,5,1,2,0,2
25783_0,,,,2,3,2,5
[CH](C(O)=O)CCC(C(CCO)=O)=O,,,5,1,2,0,2
25785_0,,,,2,3,2,5
C(CCCC(C(CCO)=O)=O)(O)=O,,,5,1,2,0,2
25787_0,,,,2,3,2,5
C(C(C(C(C)=O)=O)C(C)CCO)=O,,,5,1,1,0,1
25789_0,,,,2,3,2,5
C(CC(C)C(C(C(C)=O)=O)CO)=O,,,5,1,2,0,2
25791_0,,,,2,3,2,5
[CH](C(O)=O)CC(C(C(C)=O)=O)CO,,,5,1,2,0,2
25793_0,,,,2,3,2,5
C(CCC(C(C(C)=O)=O)CO)(O)=O,,,5,1,2,0,2
25795_0,,,,2,3,2,5
C(C(C(C)O)=O)(CC(C)CCO)=O,,,5,1,1,0,1
25797_0,,,,2,3,2,5
C(C(C)=O)(C(CC(C)CCO)O)=O,,,5,1,1,0,1
25799_0,,,,2,3,2,5
C(C(C)=O)(C(C)(C(C)CCO)O)=O,,,5,1,1,0,1
25801_0,,,,2,3,2,5
C(C(C(CC(C)CCO)=O)=O)(O)=O,,,5,1,1,0,1
25803_0,,,,2,3,2,5
C(C(C=O)(C(C)CCO)O)=O,,,5,1,1,0,1
25804_0,,,,2,3,2,5
25805_0,,,,2,3,2,5
25806_0,,,,2,3,2,5
25808_0,,,,2,3,2,5
C(C(C=O)(C(C)CCO)O)(O)=O,,,5,1,1,0,1
25809_0,,,,2,3,2,5
25810_0,,,,2,3,2,5
25811_0,,,,2,3,2,5
25813_0,,,,2,3,2,5
CC(CCO)C(CO)C(C)O,,,5,1,1,0,1
25815_0,,,,2,3,2,5
CC(CC(C(C)CCO)O)O,,,5,1,1,0,1
25817_0,,,,2,3,2,5
CC(CC(CCO)O)CCO,,,5,1,1,0,1
25819_0,,,,2,3,2,5
CC(CCO)(C(C)CCO)O,,,5,1,1,0,1
25821_0,,,,2,3,2,5
C(C(CO)C(C)CCO)(O)=O,,,5,1,1,0,1
25823_0,,,,2,3,2,5
C(CC(C(C)CCO)O)(O)=O,,,5,1,1,0,1
25825_0,,,,2,3,2,5
C(CO)(C(C(C)CCO)O)=O,,,5,1,1,0,1
25827_0,,,,2,3,2,5
C(CO)(CC(C)CCO)=O,,,5,1,1,0,1
25829_0,,,,2,3,2,5
C(C(CCC(CO)=O)CCO)(O)=O,,,5,1,2,0,2
25831_0,,,,2,3,2,5
C(C(C)(CCO)CC(CO)=O)(O)=O,,,5,1,1,0,1
25833_0,,,,2,3,2,5
C(C(C)C(CO)CC(CO)=O)(O)=O,,,5,1,2,0,2
25835_0,,,,2,3,2,5
C(C)(C(C(C)CCO)O)=O,,,5,1,1,0,1
25837_0,,,,2,3,2,5
C(C(CC(C(C)=O)O)CCO)(O)=O,,,5,1,2,0,2
25839_0,,,,2,3,2,5
C(C(C)(CCO)C(C(C)=O)O)(O)=O,,,5,1,1,0,1
25841_0,,,,2,3,2,5
C(C(C)C(CO)C(C(C)=O)O)(O)=O,,,5,1,2,0,2
25843_0,,,,2,3,2,5
CC(CO)CCO,,,5,1,1,0,1
25845_0,,,,2,3,2,5
C(C(CCO)CCO)(O)=O,,,5,1,2,0,2
25847_0,,,,2,3,2,5
C(C(C)(CO)CCO)(O)=O,,,5,1,1,0,1
25849_0,,,,2,3,2,5
C(C(C)C(CO)CO)(O)=O,,,5,1,2,0,2
25851_0,,,,2,3,2,5
CC(CCO)CCO,,,5,1,1,0,1
25853_0,,,,2,3,2,5
C(C(CCO)CCCO)(O)=O,,,5,1,2,0,2
25855_0,,,,2,3,2,5
C(C(C)(CCO)CCO)(O)=O,,,5,1,1,0,1
25857_0,,,,2,3,2,5
C(C(C)C(CO)CCO)(O)=O,,,5,1,2,0,2
25859_0,,,,2,3,2,5
CC(C(C)CCO)O,,,5,1,1,0,1
25861_0,,,,2,3,2,5
C(C(CCO)CC(C)O)(O)=O,,,5,1,2,0,2
25863_0,,,,2,3,2,5
C(C(C)(CCO)C(C)O)(O)=O,,,5,1,1,0,1
25865_0,,,,2,3,2,5
C(C(C)C(CO)C(C)O)(O)=O,,,5,1,2,0,2
25867_0,,,,2,3,2,5
C(C(C(C)O)C(C)CCO)(O)=O,,,5,1,1,0,1
25869_0,,,,2,3,2,5
C(CC(CC(C)CCO)O)(O)=O,,,5,1,1,0,1
25871_0,,,,2,3,2,5
C(CC(C)(C(C)CCO)O)(O)=O,,,5,1,1,0,1
25873_0,,,,2,3,2,5
C(C(C(O)=O)C(C)CCO)(O)=O,,,5,1,1,0,1
25875_0,,,,2,3,2,5
C(CC(C)CCO)(O)=O,,,5,1,3,0,3
25877_0,,,,2,3,2,5
C(C(CCC(O)=O)CCO)(O)=O,,,5,1,4,0,4
25879_0,,,,2,3,2,5
C(C(C)(CCO)CC(O)=O)(O)=O,,,5,1,3,0,3
25881_0,,,,2,3,2,5
C(C(C)C(CO)CC(O)=O)(O)=O,,,5,1,3,0,3
25883_0,,,,2,3,2,5
C(C(CO)(CC(C)CCO)O)(O)=O,,,5,1,1,0,1
25885_0,,,,2,3,2,5
C(C(C)(C(C(C)CCO)O)O)(O)=O,,,5,1,1,0,1
25887_0,,,,2,3,2,5
C(C(C(CC(C)CCO)O)O)(O)=O,,,5,1,2,0,2
25889_0,,,,2,3,2,5
C(C(C(C)(C(C)CCO)O)O)(O)=O,,,5,1,1,0,1
25891_0,,,,2,3,2,5
C(C(C(C)O)(C(C)CCO)O)(O)=O,,,5,1,1,0,1
25893_0,,,,2,3,2,5
C(C(C(O)=O)(C(C)CCO)O)(O)=O,,,5,1,1,0,1
25895_0,,,,2,3,2,5
C(C(C=O)(CC(C)CCO)O)(O)=O,,,5,1,1,0,1
25896_0,,,,2,3,2,5
25897_0,,,,2,3,2,5
25898_0,,,,2,3,2,5
25900_0,,,,2,3,2,5
C(C(C(C)=O)CC(C)CCO)(O)=O,,,5,1,1,0,1
25902_0,,,,2,3,2,5
C(C(C(C)=O)(C)C(C)CCO)(O)=O,,,5,1,1,0,1
25904_0,,,,2,3,2,5
C(C(C(CC(C)CCO)=O)C)(O)=O,,,5,1,1,0,1
25906_0,,,,2,3,2,5
C(CC(C)CCO)=CC=O,,,5,1,1,0,1
25908_0,,,,2,3,2,5
C(CC(C)CC=CCO)=O,,,5,1,3,0,3
25910_0,,,,2,3,2,5
C(CC(C)CC(C(O)=O)=O)=CCO,,,5,1,2,0,2
25912_0,,,,2,3,2,5
C(C(CCC=CC=O)CCO)(O)=O,,,5,1,2,0,2
25914_0,,,,2,3,2,5
C(C(CCC=CCO)CC=O)(O)=O,,,5,1,2,0,2
25916_0,,,,2,3,2,5
C(C(C)(CCO)CC=CC=O)(O)=O,,,5,1,1,0,1
25918_0,,,,2,3,2,5
C(C(C)(CC=O)CC=CCO)(O)=O,,,5,1,2,0,2
25920_0,,,,2,3,2,5
C(C(C)C(CO)CC=CC=O)(O)=O,,,5,1,2,0,2
25922_0,,,,2,3,2,5
C(C(C)C(C=O)CC=CCO)(O)=O,,,5,1,2,0,2
25924_0,,,,2,3,2,5
C(C(CCC=CCO)C(C)O)(O)=O,,,5,1,2,0,2
25926_0,,,,2,3,2,5
C(C(C(O)=O)CCC=CCO)(O)=O,,,5,1,2,0,2
25928_0,,,,2,3,2,5
C(CC(C)C(C=C)CO)=O,,,5,1,3,0,3
25930_0,,,,2,3,2,5
C(C(C=C)C(C)CCO)=O,,,5,1,1,0,1
25932_0,,,,2,3,2,5
C(CC(C)CCO)=CC(C(O)=O)=O,,,5,1,1,0,1
25934_0,,,,2,3,2,5
C=CC(C(C(O)=O)=O)C(C)CCO,,,5,1,1,0,1
25936_0,,,,2,3,2,5
C(CC(C)C(C(C(O)=O)=C)CO)=O,,,5,1,2,0,2
25938_0,,,,2,3,2,5
C(C(C(C(O)=O)=C)C(C)CCO)=O,,,5,1,1,0,1
25940_0,,,,2,3,2,5
C(CC(C)CC(C(O)=O)=CCO)=O,,,5,1,2,0,2
25942_0,,,,2,3,2,5
C(C(CC(C)CCO)=CC=O)(O)=O,,,5,1,1,0,1
25944_0,,,,2,3,2,5
C=C(C(O)=O)C(CC(C)CCO)O,,,5,1,1,0,1
25946_0,,,,2,3,2,5
C=C(C(O)=O)C(C)(C(C)CCO)O,,,5,1,1,0,1
25948_0,,,,2,3,2,5
C(C(C=C)(CC(C)CCO)O)(O)=O,,,5,1,1,0,1
25950_0,,,,2,3,2,5
CC(C(CO)(C(C)CCO)O)O,,,5,1,1,0,1
25952_0,,,,2,3,2,5
CC(C(C(C(C)CCO)O)O)O,,,5,1,1,0,1
25954_0,,,,2,3,2,5
CC(CC(C(CO)O)O)CCO,,,5,1,1,0,1
25956_0,,,,2,3,2,5
CC(C(CO)O)(C(C)CCO)O,,,5,1,1,0,1
25958_0,,,,2,3,2,5
C(CC(C)C(C(CO)O)O)=O,,,5,1,5,0,5
25960_0,,,,2,3,2,5
C(C(C(C(C)CCO)O)O)=O,,,5,1,1,0,1
25962_0,,,,2,3,2,5
C(CC(C)C(CO)(CO)O)=O,,,5,1,3,0,3
25964_0,,,,2,3,2,5
C(C(CO)(C(C)CCO)O)=O,,,5,1,1,0,1
25966_0,,,,2,3,2,5
[CH](C(O)=O)C(C(C)CCO)O,,,5,1,1,0,1
25968_0,,,,2,3,2,5
[C](C(O)=O)(CO)C(C)CCO,,,5,1,1,0,1
25969_0,,,,2,3,2,5
25971_0,,,,2,3,2,5
C(C(C(C)CCO)O)=O,,,5,1,1,0,1
25973_0,,,,2,3,2,5
C1(C(C(C(C)O1)C(C)CCO)=O)=O,,,5,1,1,0,1
25975_0,,,,2,3,2,5
C1(C(CC(CC(C)CCO)O1)=O)=O,,,5,1,1,0,1
25977_0,,,,2,3,2,5
C1(C(CC(C)(C(C)CCO)O1)=O)=O,,,5,1,1,0,1
25979_0,,,,2,3,2,5
C1(C(C(C(O1)=O)=O)C(C)CCO)=O,,,5,1,1,0,1
25981_0,,,,2,3,2,5
C(CC(C)C(CO)C[CH]C(O)=O)=O,,,5,1,3,0,3
25983_0,,,,2,3,2,5
C(C(C(C)CCO)C[CH]C(O)=O)=O,,,5,1,3,0,3
25985_0,,,,2,3,2,5
C(CC(C)C([CH]C(O)=O)CCO)=O,,,5,1,2,0,2
25987_0,,,,2,3,2,5
C(CC([CH]C(O)=O)C(C)CCO)=O,,,5,1,1,0,1
25989_0,,,,2,3,2,5
C(CC([C](C(O)=O)CCCO)C)=O,,,5,1,2,0,2
25991_0,,,,2,3,2,5
C(CC[C](C(O)=O)C(C)CCO)=O,,,5,1,1,0,1
25993_0,,,,2,3,2,5
C(CCC(CO)C(C)CC=O)(O)=O,,,5,1,3,0,3
25995_0,,,,2,3,2,5
C(C(CCC(O)=O)C(C)CCO)=O,,,5,1,3,0,3
25997_0,,,,2,3,2,5
C(CC(CCO)C(C)CC=O)(O)=O,,,5,1,2,0,2
25999_0,,,,2,3,2,5
C(CC(C(C)CCO)CC=O)(O)=O,,,5,1,1,0,1
26001_0,,,,2,3,2,5
C(C(CCCO)C(C)CC=O)(O)=O,,,5,1,2,0,2
26003_0,,,,2,3,2,5
C(C(CCC=O)C(C)CCO)(O)=O,,,5,1,1,0,1
26005_0,,,,2,3,2,5
[C](C(O)=O)(C(C(C)CCO)O)O,,,5,1,1,0,1
26007_0,,,,2,3,2,5
C(CC(C)CC(CO)O)=O,,,5,1,2,0,2
26009_0,,,,2,3,2,5
C(C(CC(C)CCO)O)=O,,,5,1,1,0,1
26011_0,,,,2,3,2,5
C(CC(C)C(C)(CO)O)=O,,,5,1,2,0,2
26013_0,,,,2,3,2,5
C(C(C)(C(C)CCO)O)=O,,,5,1,1,0,1
26015_0,,,,2,3,2,5
C(C(C(C(C)CCO)O)O)(O)=O,,,5,1,2,0,2
26017_0,,,,2,3,2,5
C(C(CO)(C(C)CCO)O)(O)=O,,,5,1,1,0,1
26018_0,,,,2,3,2,5
26020_0,,,,2,3,2,5
[C](C(O)=O)(CC(C)CCO)O,,,5,1,2,0,2
26022_0,,,,2,3,2,5
C(C(CC(C)CCO)O)(O)=O,,,5,1,2,0,2
26024_0,,,,2,3,2,5
C(C(C)(C(C)CCO)O)(O)=O,,,5,1,1,0,1
26025_0,,,,2,3,2,5
26026_0,,,,2,3,2,5
26027_0,,,,2,3,2,5
26028_0,,,,2,3,2,5
26029_0,,,,2,3,2,5
26031_0,,,,2,3,2,5
C(CC(C)(C(C)CCO)O)=O,,,5,1,1,0,1
26032_0,,,,2,3,2,5
26033_0,,,,2,3,2,5
26034_0,,,,2,3,2,5
26036_0,,,,2,3,2,5
C(C(C(C(C)CCO)O)=O)=O,,,5,1,1,0,1
26037_0,,,,2,3,2,5
26039_0,,,,2,3,2,5
C(C(CC(C)CCO)=O)=O,,,5,1,2,0,2
26041_0,,,,2,3,2,5
C(C(C(C)CCO)O)(O)=O,,,5,1,1,0,1
26043_0,,,,2,3,2,5
CC(CCO)C(CO)O,,,5,1,2,0,2
26045_0,,,,2,3,2,5
C(C(C(C(C)CCO)O)=O)(O)=O,,,5,1,1,0,1
26046_0,,,,2,3,2,5
26048_0,,,,2,3,2,5
C(C(CO)C(C)CC(C(O)=O)=O)=C,,,5,1,2,0,2
26050_0,,,,2,3,2,5
C(C(C=C)CC(C(O)=O)CCO)=O,,,5,1,2,0,2
26052_0,,,,2,3,2,5
C(C(CC(C=C)CO)CC=O)(O)=O,,,5,1,2,0,2
26054_0,,,,2,3,2,5
C(C(C=C)C(C(O)=O)(C)CCO)=O,,,5,1,1,0,1
26056_0,,,,2,3,2,5
C(C(C)(CC=O)C(C=C)CO)(O)=O,,,5,1,2,0,2
26058_0,,,,2,3,2,5
C(C(C=C)C(CO)C(C(O)=O)C)=O,,,5,1,2,0,2
26060_0,,,,2,3,2,5
C(C(C)C(C=O)C(C=C)CO)(O)=O,,,5,1,2,0,2
26062_0,,,,2,3,2,5
C(C(CC(C=C)CO)C(C)O)(O)=O,,,5,1,2,0,2
26064_0,,,,2,3,2,5
C(C(C(O)=O)CC(C=C)CO)(O)=O,,,5,1,2,0,2
26065_0,,,,2,3,2,5
26067_0,,,,2,3,2,5
C(C(CC(C)CC(CO)O)=O)(O)=O,,,5,1,2,0,2
26069_0,,,,2,3,2,5
C(C(CC(C)C(C)(CO)O)=O)(O)=O,,,5,1,2,0,2
26070_0,,,,2,3,2,5
26072_0,,,,2,3,2,5
C=C(C(O)=O)C(CO)C[CH]C(O)=O,,,5,1,2,0,2
26074_0,,,,2,3,2,5
C(CCC(C(C(O)=O)=C)CO)(O)=O,,,5,1,2,0,2
26075_0,,,,2,3,2,5
26077_0,,,,2,3,2,5
C(C(CC(C=O)O)CCO)(O)=O,,,5,1,2,0,2
26079_0,,,,2,3,2,5
C(C(CCC(CO)O)CC=O)(O)=O,,,5,1,2,0,2
26081_0,,,,2,3,2,5
C(C(CCO)CCC(C=O)O)(O)=O,,,5,1,2,0,2
26083_0,,,,2,3,2,5
C(C(CC(C)(CO)O)CC=O)(O)=O,,,5,1,2,0,2
26085_0,,,,2,3,2,5
C(C(CC(C=O)(C)O)CCO)(O)=O,,,5,1,2,0,2
26086_0,,,,2,3,2,5
26088_0,,,,2,3,2,5
C(C(CCC=O)CCO)(O)=O,,,5,1,3,0,3
26089_0,,,,2,3,2,5
26091_0,,,,2,3,2,5
C(C(CCC(C=O)=O)CCO)(O)=O,,,5,1,3,0,3
26092_0,,,,2,3,2,5
26094_0,,,,2,3,2,5
C(C(CCO)CC(CO)O)(O)=O,,,5,1,2,0,2
26096_0,,,,2,3,2,5
C(CO)=C(C(O)=O)CC[CH]C(O)=O,,,5,1,2,0,2
26098_0,,,,2,3,2,5
C(CCCC(C(O)=O)=CCO)(O)=O,,,5,1,2,0,2
26099_0,,,,2,3,2,5
26101_0,,,,2,3,2,5
C(C(C)(CCO)C(C=O)O)(O)=O,,,5,1,1,0,1
26103_0,,,,2,3,2,5
C(C(C)(CC(CO)O)CC=O)(O)=O,,,5,1,2,0,2
26105_0,,,,2,3,2,5
C(C(C)(CC(C=O)O)CCO)(O)=O,,,5,1,1,0,1
26107_0,,,,2,3,2,5
C(C(C)(C(C)(CO)O)CC=O)(O)=O,,,5,1,2,0,2
26109_0,,,,2,3,2,5
C(C(C)(CCO)C(C=O)(C)O)(O)=O,,,5,1,1,0,1
26110_0,,,,2,3,2,5
26111_0,,,,2,3,2,5
26113_0,,,,2,3,2,5
C(C(C)(CCO)CC(C=O)=O)(O)=O,,,5,1,2,0,2
26115_0,,,,2,3,2,5
C(C(C)(CCO)C(C(O)=O)O)(O)=O,,,5,1,1,0,1
26117_0,,,,2,3,2,5
C(C(C)(CCO)C(CO)O)(O)=O,,,5,1,2,0,2
26118_0,,,,2,3,2,5
26120_0,,,,2,3,2,5
C(C(C)C(CO)C(C=O)O)(O)=O,,,5,1,2,0,2
26122_0,,,,2,3,2,5
C(C(C)C(C=O)CC(CO)O)(O)=O,,,5,1,2,0,2
26124_0,,,,2,3,2,5
C(C(C)C(CO)CC(C=O)O)(O)=O,,,5,1,2,0,2
26126_0,,,,2,3,2,5
C(C(C)C(C=O)C(C)(CO)O)(O)=O,,,5,1,2,0,2
26128_0,,,,2,3,2,5
C(C(C)C(CO)C(C=O)(C)O)(O)=O,,,5,1,2,0,2
26129_0,,,,2,3,2,5
26131_0,,,,2,3,2,5
C(C(C)C(CO)CC=O)(O)=O,,,5,1,2,0,2
26132_0,,,,2,3,2,5
26134_0,,,,2,3,2,5
C(C(C)C(CO)CC(C=O)=O)(O)=O,,,5,1,2,0,2
26135_0,,,,2,3,2,5
26137_0,,,,2,3,2,5
C(C(C)C(CO)C(CO)O)(O)=O,,,5,1,2,0,2
26138_0,,,,2,3,2,5
26140_0,,,,2,3,2,5
C(C(CCC(CO)O)C(C)O)(O)=O,,,5,1,2,0,2
26142_0,,,,2,3,2,5
C(C(CC(C)(CO)O)C(C)O)(O)=O,,,5,1,2,0,2
26143_0,,,,2,3,2,5
26144_0,,,,2,3,2,5
26145_0,,,,2,3,2,5
26147_0,,,,2,3,2,5
C(C(C(O)=O)CCC(CO)O)(O)=O,,,5,1,2,0,2
26149_0,,,,2,3,2,5
C(C(C(O)=O)CC(C)(CO)O)(O)=O,,,5,1,2,0,2
26150_0,,,,2,3,2,5
26151_0,,,,2,3,2,5
26152_0,,,,2,3,2,5
26153_0,,,,2,3,2,5
26154_0,,,,2,3,2,5
26156_0,,,,2,3,2,5
[CH](C(O)=O)CC(CO)(CO)O,,,5,1,3,0,3
26158_0,,,,2,3,2,5
C(CCC(CO)(CO)O)(O)=O,,,5,1,3,0,3
26160_0,,,,2,3,2,5
[CH](C(O)=O)CC(CO)C[CH]C(O)=O,,,5,1,2,0,2
26162_0,,,,2,3,2,5
C(CCC(CO)C[CH]C(O)=O)(O)=O,,,5,1,3,0,3
26164_0,,,,2,3,2,5
[CH](C(O)=O)C(CCO)C[CH]C(O)=O,,,5,1,3,0,3
26166_0,,,,2,3,2,5
C(CCC([CH]C(O)=O)CCO)(O)=O,,,5,1,3,0,3
26168_0,,,,2,3,2,5
[CH](C(O)=O)C[C](C(O)=O)CCCO,,,5,1,2,0,2
26170_0,,,,2,3,2,5
C(CC[C](C(O)=O)CCCO)(O)=O,,,5,1,2,0,2
26172_0,,,,2,3,2,5
C(CCC(CCC(O)=O)CO)(O)=O,,,5,1,2,0,2
26174_0,,,,2,3,2,5
C(CC(CCO)C[CH]C(O)=O)(O)=O,,,5,1,3,0,3
26176_0,,,,2,3,2,5
C(CCC(CCO)CC(O)=O)(O)=O,,,5,1,3,0,3
26178_0,,,,2,3,2,5
C(C(CCCO)C[CH]C(O)=O)(O)=O,,,5,1,3,0,3
26180_0,,,,2,3,2,5
C(C(CCC(O)=O)CCCO)(O)=O,,,5,1,3,0,3
26182_0,,,,2,3,2,5
[CH](C(O)=O)CCC(CO)O,,,5,1,2,0,2
26184_0,,,,2,3,2,5
C(CCCC(CO)O)(O)=O,,,5,1,2,0,2
26186_0,,,,2,3,2,5
[CH](C(O)=O)CC(C)(CO)O,,,5,1,2,0,2
26188_0,,,,2,3,2,5
C(CCC(C)(CO)O)(O)=O,,,5,1,2,0,2
26190_0,,,,2,3,2,5
[C](C(O)=O)(C(C(CO)(CO)O)O)O,,,5,1,3,0,3
26192_0,,,,2,3,2,5
[C](C(O)=O)(CC(CO)(CO)O)O,,,5,1,2,0,2
26194_0,,,,2,3,2,5
[C](C(O)=O)(C(C(CO)(C)O)O)O,,,5,1,3,0,3
26196_0,,,,2,3,2,5
[C](C(O)=O)(CC(C)(CO)O)O,,,5,1,2,0,2
26198_0,,,,2,3,2,5
CC(CC(CC(CO)O)O)O,,,5,1,1,0,1
26200_0,,,,2,3,2,5
C(CC(CC(CO)O)O)(O)=O,,,5,1,1,0,1
26202_0,,,,2,3,2,5
C(CO)(C(CC(CO)O)O)=O,,,5,1,1,0,1
26204_0,,,,2,3,2,5
C(C(CO)(CC(CO)O)O)=O,,,5,1,1,0,1
26205_0,,,,2,3,2,5
26207_0,,,,2,3,2,5
C(C(C)(CC(CO)O)O)=O,,,5,1,1,0,1
26208_0,,,,2,3,2,5
26210_0,,,,2,3,2,5
C(C)(C(CC(CO)O)O)=O,,,5,1,1,0,1
26211_0,,,,2,3,2,5
26213_0,,,,2,3,2,5
C(C(CO)(CC(CO)O)O)(O)=O,,,5,1,1,0,1
26215_0,,,,2,3,2,5
C(C(C)(CC(CO)O)O)(O)=O,,,5,1,1,0,1
26217_0,,,,2,3,2,5
C(C(O)O)O,,,5,1,1,0,1
26218_0,,,,2,3,2,5
26220_0,,,,2,3,2,5
C(C(C(CO)(C)O)=O)(O)=O,,,5,1,4,0,4
26221_0,,,,2,3,2,5
26222_0,,,,2,3,2,5
26223_0,,,,2,3,2,5
26224_0,,,,2,3,2,5
26226_0,,,,2,3,2,5
C(CC(CC(CC(C)O)O)O)(O)=O,,,5,1,1,0,1
26227_0,,,,2,3,2,5
26228_0,,,,2,3,2,5
26229_0,,,,2,3,2,5
26231_0,,,,2,3,2,5
C(CC(C(C(C)O)C(C)O)O)(O)=O,,,5,1,1,0,1
26232_0,,,,2,3,2,5
26234_0,,,,2,3,2,5
C(CC(CC(CC(O)=O)O)O)(O)=O,,,5,1,1,0,1
26235_0,,,,2,3,2,5
26236_0,,,,2,3,2,5
26237_0,,,,2,3,2,5
26238_0,,,,2,3,2,5
26239_0,,,,2,3,2,5
26240_0,,,,2,3,2,5
26241_0,,,,2,3,2,5
26242_0,,,,2,3,2,5
26243_0,,,,2,3,2,5
26244_0,,,,2,3,2,5
26245_0,,,,2,3,2,5
26247_0,,,,2,3,2,5
C(C(CO)(CC(CC(O)=O)O)O)=O,,,5,1,2,0,2
26248_0,,,,2,3,2,5
26249_0,,,,2,3,2,5
26250_0,,,,2,3,2,5
26251_0,,,,2,3,2,5
26252_0,,,,2,3,2,5
26253_0,,,,2,3,2,5
26254_0,,,,2,3,2,5
26255_0,,,,2,3,2,5
26257_0,,,,2,3,2,5
C(C(C(C(C)O)O)(CC(O)=O)O)=O,,,5,1,2,0,2
26258_0,,,,2,3,2,5
26259_0,,,,2,3,2,5
26260_0,,,,2,3,2,5
26261_0,,,,2,3,2,5
26262_0,,,,2,3,2,5
26263_0,,,,2,3,2,5
26264_0,,,,2,3,2,5
26266_0,,,,2,3,2,5
C(C(C)(CC(CC(O)=O)O)O)=O,,,5,1,1,0,1
26267_0,,,,2,3,2,5
26268_0,,,,2,3,2,5
26269_0,,,,2,3,2,5
26270_0,,,,2,3,2,5
26271_0,,,,2,3,2,5
26272_0,,,,2,3,2,5
26274_0,,,,2,3,2,5
C(C(C(C(O)=O)C(C=O)(C)O)O)=O,,,5,1,4,0,4
26275_0,,,,2,3,2,5
26277_0,,,,2,3,2,5
C(C(C(CO)O)C(C=O)(C)O)(O)=O,,,5,1,2,0,2
26278_0,,,,2,3,2,5
26279_0,,,,2,3,2,5
26280_0,,,,2,3,2,5
26281_0,,,,2,3,2,5
26282_0,,,,2,3,2,5
26283_0,,,,2,3,2,5
26285_0,,,,2,3,2,5
C(CC(CC(C(C)=O)O)O)(O)=O,,,5,1,1,0,1
26286_0,,,,2,3,2,5
26287_0,,,,2,3,2,5
26288_0,,,,2,3,2,5
26290_0,,,,2,3,2,5
C(C(C(C=O)O)C(C(C)=O)O)(O)=O,,,5,1,4,0,4
26292_0,,,,2,3,2,5
C(C(C(CO)O)C(C(C)=O)O)(O)=O,,,5,1,2,0,2
26293_0,,,,2,3,2,5
26294_0,,,,2,3,2,5
26295_0,,,,2,3,2,5
26296_0,,,,2,3,2,5
26297_0,,,,2,3,2,5
26298_0,,,,2,3,2,5
26299_0,,,,2,3,2,5
26300_0,,,,2,3,2,5
26301_0,,,,2,3,2,5
26302_0,,,,2,3,2,5
26303_0,,,,2,3,2,5
26305_0,,,,2,3,2,5
C(C(C=C)C(C=O)(CCO)O)(O)=O,,,5,1,1,0,1
26306_0,,,,2,3,2,5
26307_0,,,,2,3,2,5
26308_0,,,,2,3,2,5
26309_0,,,,2,3,2,5
26310_0,,,,2,3,2,5
26311_0,,,,2,3,2,5
26312_0,,,,2,3,2,5
26313_0,,,,2,3,2,5
26315_0,,,,2,3,2,5
C(C(C=C)C(C(CCO)=O)O)(O)=O,,,5,1,1,0,1
26316_0,,,,2,3,2,5
26317_0,,,,2,3,2,5
26318_0,,,,2,3,2,5
26319_0,,,,2,3,2,5
26320_0,,,,2,3,2,5
26321_0,,,,2,3,2,5
26322_0,,,,2,3,2,5
26323_0,,,,2,3,2,5
26324_0,,,,2,3,2,5
26325_0,,,,2,3,2,5
26326_0,,,,2,3,2,5
26327_0,,,,2,3,2,5
26328_0,,,,2,3,2,5
26329_0,,,,2,3,2,5
26330_0,,,,2,3,2,5
26332_0,,,,2,3,2,5
C(C(CC(C)O)(CC(O)=O)O)=O,,,5,1,1,0,1
26333_0,,,,2,3,2,5
26334_0,,,,2,3,2,5
26335_0,,,,2,3,2,5
26336_0,,,,2,3,2,5
26337_0,,,,2,3,2,5
26338_0,,,,2,3,2,5
26339_0,,,,2,3,2,5
26340_0,,,,2,3,2,5
26341_0,,,,2,3,2,5
26343_0,,,,2,3,2,5
C(CC(C=O)(CC(O)=O)O)(O)=O,,,5,1,1,0,1
26344_0,,,,2,3,2,5
26345_0,,,,2,3,2,5
26346_0,,,,2,3,2,5
26347_0,,,,2,3,2,5
26348_0,,,,2,3,2,5
26349_0,,,,2,3,2,5
26350_0,,,,2,3,2,5
26351_0,,,,2,3,2,5
26353_0,,,,2,3,2,5
C(C(C=C)C(CCO)O)(O)=O,,,5,1,2,0,2
26354_0,,,,2,3,2,5
26355_0,,,,2,3,2,5
26356_0,,,,2,3,2,5
26357_0,,,,2,3,2,5
26358_0,,,,2,3,2,5
26359_0,,,,2,3,2,5
26360_0,,,,2,3,2,5
26361_0,,,,2,3,2,5
26362_0,,,,2,3,2,5
26363_0,,,,2,3,2,5
26364_0,,,,2,3,2,5
26365_0,,,,2,3,2,5
26366_0,,,,2,3,2,5
26367_0,,,,2,3,2,5
26368_0,,,,2,3,2,5
26369_0,,,,2,3,2,5
26370_0,,,,2,3,2,5
26371_0,,,,2,3,2,5
26372_0,,,,2,3,2,5
26373_0,,,,2,3,2,5
26374_0,,,,2,3,2,5
26375_0,,,,2,3,2,5
26376_0,,,,2,3,2,5
26377_0,,,,2,3,2,5
26378_0,,,,2,3,2,5
26379_0,,,,2,3,2,5
26380_0,,,,2,3,2,5
26381_0,,,,2,3,2,5
26382_0,,,,2,3,2,5
26384_0,,,,2,3,2,5
C(C(C)(CC(O)=O)O)(CC=O)=O,,,5,1,1,0,1
26385_0,,,,2,3,2,5
26386_0,,,,2,3,2,5
26387_0,,,,2,3,2,5
26388_0,,,,2,3,2,5
26389_0,,,,2,3,2,5
26390_0,,,,2,3,2,5
26391_0,,,,2,3,2,5
26392_0,,,,2,3,2,5
26393_0,,,,2,3,2,5
26394_0,,,,2,3,2,5
26395_0,,,,2,3,2,5
26396_0,,,,2,3,2,5
26397_0,,,,2,3,2,5
26398_0,,,,2,3,2,5
26399_0,,,,2,3,2,5
26401_0,,,,2,3,2,5
C(C(CO)(CC(O)=O)O)(C(C)O)=O,,,5,1,1,0,1
26403_0,,,,2,3,2,5
C(CO)(C(C(C)O)(CC(O)=O)O)=O,,,5,1,2,0,2
26405_0,,,,2,3,2,5
C(CC(C(C(O)=O)=O)(CO)O)(O)=O,,,5,1,2,0,2
26406_0,,,,2,3,2,5
26407_0,,,,2,3,2,5
26409_0,,,,2,3,2,5
C(C)(C(C(C)O)(CC(O)=O)O)=O,,,5,1,2,0,2
26410_0,,,,2,3,2,5
26412_0,,,,2,3,2,5
C(C(C)(CC(O)=O)O)(C(C)O)=O,,,5,1,1,0,1
26413_0,,,,2,3,2,5
26414_0,,,,2,3,2,5
26415_0,,,,2,3,2,5
26416_0,,,,2,3,2,5
26418_0,,,,2,3,2,5
C(CC(C(C(O)=O)=O)(C)O)(O)=O,,,5,1,1,0,1
26419_0,,,,2,3,2,5
26420_0,,,,2,3,2,5
26421_0,,,,2,3,2,5
26422_0,,,,2,3,2,5
26423_0,,,,2,3,2,5
26425_0,,,,2,3,2,5
C(C(C=C)C(C=O)O)(O)=O,,,5,1,2,0,2
26426_0,,,,2,3,2,5
26427_0,,,,2,3,2,5
26429_0,,,,2,3,2,5
C(C(C(C(O)=O)=C)C(C=O)O)(O)=O,,,5,1,1,0,1
26430_0,,,,2,3,2,5
26431_0,,,,2,3,2,5
26432_0,,,,2,3,2,5
26433_0,,,,2,3,2,5
26435_0,,,,2,3,2,5
C(C(C[CH]C(O)=O)C(C=O)O)(O)=O,,,5,1,3,0,3
26436_0,,,,2,3,2,5
26438_0,,,,2,3,2,5
C(CCC(C(O)=O)C(C=O)O)(O)=O,,,5,1,3,0,3
26439_0,,,,2,3,2,5
26440_0,,,,2,3,2,5
26441_0,,,,2,3,2,5
26442_0,,,,2,3,2,5
26443_0,,,,2,3,2,5
26444_0,,,,2,3,2,5
26445_0,,,,2,3,2,5
26446_0,,,,2,3,2,5
26447_0,,,,2,3,2,5
26448_0,,,,2,3,2,5
26449_0,,,,2,3,2,5
26450_0,,,,2,3,2,5
26451_0,,,,2,3,2,5
26452_0,,,,2,3,2,5
26453_0,,,,2,3,2,5
26454_0,,,,2,3,2,5
26455_0,,,,2,3,2,5
26456_0,,,,2,3,2,5
26457_0,,,,2,3,2,5
26458_0,,,,2,3,2,5
26459_0,,,,2,3,2,5
26460_0,,,,2,3,2,5
26461_0,,,,2,3,2,5
26462_0,,,,2,3,2,5
26463_0,,,,2,3,2,5
26464_0,,,,2,3,2,5
26465_0,,,,2,3,2,5
26466_0,,,,2,3,2,5
26467_0,,,,2,3,2,5
26468_0,,,,2,3,2,5
26470_0,,,,2,3,2,5
C(C(C=C)C(C(C(O)=O)O)O)(O)=O,,,5,1,2,0,2
26471_0,,,,2,3,2,5
26472_0,,,,2,3,2,5
26473_0,,,,2,3,2,5
26475_0,,,,2,3,2,5
C(C(C=C)C(CO)(CO)O)(O)=O,,,5,1,2,0,2
26476_0,,,,2,3,2,5
26477_0,,,,2,3,2,5
26478_0,,,,2,3,2,5
26479_0,,,,2,3,2,5
26480_0,,,,2,3,2,5
26481_0,,,,2,3,2,5
26482_0,,,,2,3,2,5
26483_0,,,,2,3,2,5
26485_0,,,,2,3,2,5
C(C(C=C)C(C)(CO)O)(O)=O,,,5,1,2,0,2
26486_0,,,,2,3,2,5
26487_0,,,,2,3,2,5
26488_0,,,,2,3,2,5
26489_0,,,,2,3,2,5
26490_0,,,,2,3,2,5
26491_0,,,,2,3,2,5
26492_0,,,,2,3,2,5
26493_0,,,,2,3,2,5
26494_0,,,,2,3,2,5
26495_0,,,,2,3,2,5
26496_0,,,,2,3,2,5
26497_0,,,,2,3,2,5
26499_0,,,,2,3,2,5
C(C(CO)C(C)(CC(O)=O)O)(O)=O,,,5,1,2,0,2
26500_0,,,,2,3,2,5
26502_0,,,,2,3,2,5
C(C(C)C(C)(CC(O)=O)O)(O)=O,,,5,1,1,0,1
26504_0,,,,2,3,2,5
C(C(C=C)C(C=CC)O)(O)=O,,,5,1,2,0,2
26505_0,,,,2,3,2,5
26507_0,,,,2,3,2,5
C(CC(C=CC)O)(O)=O,,,5,1,5,0,5
26508_0,,,,2,3,2,5
26509_0,,,,2,3,2,5
26510_0,,,,2,3,2,5
26511_0,,,,2,3,2,5
26513_0,,,,2,3,2,5
C(C(C=C)C(CC=C)O)(O)=O,,,5,1,2,0,2
26514_0,,,,2,3,2,5
26516_0,,,,2,3,2,5
C(CC(CC=C)O)(O)=O,,,5,1,5,0,5
26517_0,,,,2,3,2,5
26518_0,,,,2,3,2,5
26519_0,,,,2,3,2,5
26520_0,,,,2,3,2,5
26522_0,,,,2,3,2,5
C(C(C=C)C(C(CO)O)O)(O)=O,,,5,1,2,0,2
26524_0,,,,2,3,2,5
C(C(C=C)C(CO)O)(O)=O,,,5,1,2,0,2
26526_0,,,,2,3,2,5
C(C(C=C)C(C(C)O)O)(O)=O,,,5,1,2,0,2
26528_0,,,,2,3,2,5
C(C(C=C)C(C(O)=O)O)(O)=O,,,5,1,3,0,3
26530_0,,,,2,3,2,5
C(C(C=C)C(C)O)(O)=O,,,5,1,3,0,3
26532_0,,,,2,3,2,5
C(C(C(O)=O)C=C)(O)=O,,,5,1,3,0,3
26534_0,,,,2,3,2,5
C(C(C=C)C(CC(C)O)O)(O)=O,,,5,1,2,0,2
26536_0,,,,2,3,2,5
C(C(C=C)C(CC(O)=O)O)(O)=O,,,5,1,2,0,2
26538_0,,,,2,3,2,5
C(C(C=C)C(C(CO)=O)O)(O)=O,,,5,1,2,0,2
26539_0,,,,2,3,2,5
26541_0,,,,2,3,2,5
C(C(C=C)C(C=O)(CO)O)(O)=O,,,5,1,2,0,2
26542_0,,,,2,3,2,5
26544_0,,,,2,3,2,5
C(C(C=C)C(C=O)(C)O)(O)=O,,,5,1,2,0,2
26546_0,,,,2,3,2,5
C(C(C=C)C(C(C)=O)O)(O)=O,,,5,1,2,0,2
26547_0,,,,2,3,2,5
26549_0,,,,2,3,2,5
C(C(C=C)C(C(O)=O)(CO)O)(O)=O,,,5,1,1,0,1
26551_0,,,,2,3,2,5
C(C(C=C)C(C(O)=O)(C)O)(O)=O,,,5,1,3,0,3
26552_0,,,,2,3,2,5
26554_0,,,,2,3,2,5
C(C(C=CC)(CC(O)=O)O)(O)=O,,,5,1,2,0,2
26555_0,,,,2,3,2,5
26557_0,,,,2,3,2,5
C(CC(C(O)=O)(CC=C)O)(O)=O,,,5,1,2,0,2
26558_0,,,,2,3,2,5
26560_0,,,,2,3,2,5
C(CC(CC(C(O)=O)=C)O)(O)=O,,,5,1,2,0,2
26562_0,,,,2,3,2,5
C(C(C(C(O)=O)=C)C(CO)O)(O)=O,,,5,1,1,0,1
26564_0,,,,2,3,2,5
C(C(C(C(O)=O)=C)C(C)O)(O)=O,,,5,1,2,0,2
26566_0,,,,2,3,2,5
C(C(C(O)=O)C(C(O)=O)=C)(O)=O,,,5,1,2,0,2
26567_0,,,,2,3,2,5
26568_0,,,,2,3,2,5
26570_0,,,,2,3,2,5
C(CC(C=C(C(O)=O)C)O)(O)=O,,,5,1,2,0,2
26571_0,,,,2,3,2,5
26572_0,,,,2,3,2,5
26573_0,,,,2,3,2,5
26574_0,,,,2,3,2,5
26575_0,,,,2,3,2,5
26576_0,,,,2,3,2,5
26577_0,,,,2,3,2,5
26579_0,,,,2,3,2,5
C(C(C(CO)O)C[CH]C(O)=O)(O)=O,,,5,1,2,0,2
26581_0,,,,2,3,2,5
C(C(CCC(O)=O)C(CO)O)(O)=O,,,5,1,3,0,3
26582_0,,,,2,3,2,5
26583_0,,,,2,3,2,5
26584_0,,,,2,3,2,5
26585_0,,,,2,3,2,5
26586_0,,,,2,3,2,5
26587_0,,,,2,3,2,5
26588_0,,,,2,3,2,5
26589_0,,,,2,3,2,5
26590_0,,,,2,3,2,5
26591_0,,,,2,3,2,5
26592_0,,,,2,3,2,5
26593_0,,,,2,3,2,5
26594_0,,,,2,3,2,5
26595_0,,,,2,3,2,5
26596_0,,,,2,3,2,5
26597_0,,,,2,3,2,5
26598_0,,,,2,3,2,5
26599_0,,,,2,3,2,5
26600_0,,,,2,3,2,5
26601_0,,,,2,3,2,5
26603_0,,,,2,3,2,5
C1(C(CC(C)O1)(CC(O)=O)O)=O,,,5,1,2,0,2
26605_0,,,,2,3,2,5
C1(CC(C(O1)=O)(CC(O)=O)O)=O,,,5,1,2,0,2
26606_0,,,,2,3,2,5
26607_0,,,,2,3,2,5
26608_0,,,,2,3,2,5
26609_0,,,,2,3,2,5
26611_0,,,,2,3,2,5
C(CC(C(C)O)O)(O)=O,,,5,1,6,0,6
26612_0,,,,2,3,2,5
26613_0,,,,2,3,2,5
26614_0,,,,2,3,2,5
26615_0,,,,2,3,2,5
26616_0,,,,2,3,2,5
26617_0,,,,2,3,2,5
26618_0,,,,2,3,2,5
26619_0,,,,2,3,2,5
26620_0,,,,2,3,2,5
26621_0,,,,2,3,2,5
26622_0,,,,2,3,2,5
26623_0,,,,2,3,2,5
26624_0,,,,2,3,2,5
26625_0,,,,2,3,2,5
26627_0,,,,2,3,2,5
C(C(C(C(C(CO)=O)=O)O)=O)(O)=O,,,5,1,1,0,1
26628_0,,,,2,3,2,5
26629_0,,,,2,3,2,5
26630_0,,,,2,3,2,5
26631_0,,,,2,3,2,5
26632_0,,,,2,3,2,5
26633_0,,,,2,3,2,5
26634_0,,,,2,3,2,5
26635_0,,,,2,3,2,5
26636_0,,,,2,3,2,5
26637_0,,,,2,3,2,5
26638_0,,,,2,3,2,5
26639_0,,,,2,3,2,5
26640_0,,,,2,3,2,5
26641_0,,,,2,3,2,5
26642_0,,,,2,3,2,5
26643_0,,,,2,3,2,5
26644_0,,,,2,3,2,5
26645_0,,,,2,3,2,5
26646_0,,,,2,3,2,5
26647_0,,,,2,3,2,5
26648_0,,,,2,3,2,5
26649_0,,,,2,3,2,5
26650_0,,,,2,3,2,5
26651_0,,,,2,3,2,5
26652_0,,,,2,3,2,5
26653_0,,,,2,3,2,5
26654_0,,,,2,3,2,5
26655_0,,,,2,3,2,5
26656_0,,,,2,3,2,5
26657_0,,,,2,3,2,5
26658_0,,,,2,3,2,5
26659_0,,,,2,3,2,5
26660_0,,,,2,3,2,5
26661_0,,,,2,3,2,5
26662_0,,,,2,3,2,5
26663_0,,,,2,3,2,5
26664_0,,,,2,3,2,5
26666_0,,,,2,3,2,5
C(C[CH]C(O)=O)(O)=O,,,5,1,1,0,1
26668_0,,,,2,3,2,5
C(CCC(O)=O)(O)=O,,,5,1,1,0,1
26669_0,,,,2,3,2,5
26670_0,,,,2,3,2,5
26671_0,,,,2,3,2,5
26672_0,,,,2,3,2,5
26673_0,,,,2,3,2,5
26674_0,,,,2,3,2,5
26675_0,,,,2,3,2,5
26676_0,,,,2,3,2,5
26677_0,,,,2,3,2,5
26678_0,,,,2,3,2,5
26679_0,,,,2,3,2,5
26680_0,,,,2,3,2,5
26681_0,,,,2,3,2,5
26682_0,,,,2,3,2,5
26683_0,,,,2,3,2,5
26684_0,,,,2,3,2,5
26685_0,,,,2,3,2,5
26686_0,,,,2,3,2,5
26687_0,,,,2,3,2,5
26688_0,,,,2,3,2,5
26689_0,,,,2,3,2,5
26690_0,,,,2,3,2,5
26691_0,,,,2,3,2,5
26692_0,,,,2,3,2,5
26693_0,,,,2,3,2,5
26694_0,,,,2,3,2,5
26695_0,,,,2,3,2,5
26696_0,,,,2,3,2,5
26697_0,,,,2,3,2,5
26698_0,,,,2,3,2,5
26699_0,,,,2,3,2,5
26700_0,,,,2,3,2,5
26701_0,,,,2,3,2,5
26702_0,,,,2,3,2,5
26703_0,,,,2,3,2,5
26704_0,,,,2,3,2,5
26705_0,,,,2,3,2,5
26706_0,,,,2,3,2,5
26707_0,,,,2,3,2,5
26708_0,,,,2,3,2,5
26710_0,,,,2,3,2,5
C(C(C(C)O)(C(C)O)C(C)O)(O)=O,,,5,1,2,0,2
26712_0,,,,2,3,2,5
C(C(C(O)=O)(C(C)O)C(C)O)(O)=O,,,5,1,3,0,3
26714_0,,,,2,3,2,5
C(C(C(O)=O)(C(O)=O)C(C)O)(O)=O,,,5,1,3,0,3
26715_0,,,,2,3,2,5
26716_0,,,,2,3,2,5
26717_0,,,,2,3,2,5
26718_0,,,,2,3,2,5
26719_0,,,,2,3,2,5
26721_0,,,,2,3,2,5
C(C(C(O)=O)(C(O)=O)C(O)=O)(O)=O,,,5,1,2,0,2
26722_0,,,,2,3,2,5
26723_0,,,,2,3,2,5
26724_0,,,,2,3,2,5
26725_0,,,,2,3,2,5
26726_0,,,,2,3,2,5
26727_0,,,,2,3,2,5
26728_0,,,,2,3,2,5
26729_0,,,,2,3,2,5
26730_0,,,,2,3,2,5
26731_0,,,,2,3,2,5
26732_0,,,,2,3,2,5
26733_0,,,,2,3,2,5
26734_0,,,,2,3,2,5
26735_0,,,,2,3,2,5
26736_0,,,,2,3,2,5
26737_0,,,,2,3,2,5
26738_0,,,,2,3,2,5
26739_0,,,,2,3,2,5
26740_0,,,,2,3,2,5
26741_0,,,,2,3,2,5
26742_0,,,,2,3,2,5
26743_0,,,,2,3,2,5
26744_0,,,,2,3,2,5
26745_0,,,,2,3,2,5
26746_0,,,,2,3,2,5
26747_0,,,,2,3,2,5
26748_0,,,,2,3,2,5
26749_0,,,,2,3,2,5
26750_0,,,,2,3,2,5
26751_0,,,,2,3,2,5
26752_0,,,,2,3,2,5
26753_0,,,,2,3,2,5
26754_0,,,,2,3,2,5
26755_0,,,,2,3,2,5
26756_0,,,,2,3,2,5
26757_0,,,,2,3,2,5
26758_0,,,,2,3,2,5
26759_0,,,,2,3,2,5
26760_0,,,,2,3,2,5
26761_0,,,,2,3,2,5
26762_0,,,,2,3,2,5
26763_0,,,,2,3,2,5
26764_0,,,,2,3,2,5
26765_0,,,,2,3,2,5
26766_0,,,,2,3,2,5
26767_0,,,,2,3,2,5
26768_0,,,,2,3,2,5
26769_0,,,,2,3,2,5
26770_0,,,,2,3,2,5
26771_0,,,,2,3,2,5
26772_0,,,,2,3,2,5
26773_0,,,,2,3,2,5
26774_0,,,,2,3,2,5
26775_0,,,,2,3,2,5
26776_0,,,,2,3,2,5
26777_0,,,,2,3,2,5
26778_0,,,,2,3,2,5
26779_0,,,,2,3,2,5
26780_0,,,,2,3,2,5
26781_0,,,,2,3,2,5
26782_0,,,,2,3,2,5
26783_0,,,,2,3,2,5
26784_0,,,,2,3,2,5
26785_0,,,,2,3,2,5
26786_0,,,,2,3,2,5
26787_0,,,,2,3,2,5
26788_0,,,,2,3,2,5
26789_0,,,,2,3,2,5
26790_0,,,,2,3,2,5
26792_0,,,,2,3,2,5
C(CO)(C(CO)(CC(O)=O)O)=O,,,5,1,2,0,2
26793_0,,,,2,3,2,5
26795_0,,,,2,3,2,5
C(C)(C(C(CO)O)(CC(O)=O)O)=O,,,5,1,2,0,2
26797_0,,,,2,3,2,5
C(C)(C(CO)(CC(O)=O)O)=O,,,5,1,2,0,2
26798_0,,,,2,3,2,5
26799_0,,,,2,3,2,5
26800_0,,,,2,3,2,5
26801_0,,,,2,3,2,5
26802_0,,,,2,3,2,5
26803_0,,,,2,3,2,5
26804_0,,,,2,3,2,5
26805_0,,,,2,3,2,5
26806_0,,,,2,3,2,5
26807_0,,,,2,3,2,5
26808_0,,,,2,3,2,5
26809_0,,,,2,3,2,5
26810_0,,,,2,3,2,5
26811_0,,,,2,3,2,5
26812_0,,,,2,3,2,5
26813_0,,,,2,3,2,5
26814_0,,,,2,3,2,5
26815_0,,,,2,3,2,5
26816_0,,,,2,3,2,5
26817_0,,,,2,3,2,5
26818_0,,,,2,3,2,5
26820_0,,,,2,3,2,5
C(C(C(O)=O)(C)OC(CO)=O)(O)=O,,,5,1,1,0,1
26822_0,,,,2,3,2,5
C(C(C(OC(C(O)=O)C)=O)O)(O)=O,,,5,1,2,0,2
26824_0,,,,2,3,2,5
C(C(C(O)=O)(C)O)(OC(CO)=O)=O,,,5,1,1,0,1
26826_0,,,,2,3,2,5
C(C(C(O)=O)O)(OC(C(C)O)=O)=O,,,5,1,2,0,2
26828_0,,,,2,3,2,5
C(C(C(OCC(O)=O)=O)(C)O)(O)=O,,,5,1,1,0,1
26830_0,,,,2,3,2,5
C(C(C(O)=O)OC(C(C)O)=O)(O)=O,,,5,1,1,0,1
26831_0,,,,2,3,2,5
26832_0,,,,2,3,2,5
26833_0,,,,2,3,2,5
26835_0,,,,2,3,2,5
C(C(C=O)C(C(O)=O)C(C)O)=O,,,5,1,2,0,2
26837_0,,,,2,3,2,5
C(C(C(O)=O)C(C=O)C(C)O)(O)=O,,,5,1,1,0,1
26839_0,,,,2,3,2,5
C(C(C=O)C(C(O)=O)C(C)O)(O)=O,,,5,1,1,0,1
26840_0,,,,2,3,2,5
26841_0,,,,2,3,2,5
26842_0,,,,2,3,2,5
26844_0,,,,2,3,2,5
C(C(C=O)C(C(O)=O)C(O)=O)=O,,,5,1,2,0,2
26846_0,,,,2,3,2,5
C(C(C(O)=O)C(C(O)=O)C(O)=O)=O,,,5,1,1,0,1
26847_0,,,,2,3,2,5
26848_0,,,,2,3,2,5
26849_0,,,,2,3,2,5
26850_0,,,,2,3,2,5
26851_0,,,,2,3,2,5
26852_0,,,,2,3,2,5
26853_0,,,,2,3,2,5
26854_0,,,,2,3,2,5
26855_0,,,,2,3,2,5
26857_0,,,,2,3,2,5
C(C(C=O)CC(O)=O)=O,,,5,1,2,0,2
26858_0,,,,2,3,2,5
26859_0,,,,2,3,2,5
26860_0,,,,2,3,2,5
26861_0,,,,2,3,2,5
26862_0,,,,2,3,2,5
26863_0,,,,2,3,2,5
26864_0,,,,2,3,2,5
26866_0,,,,2,3,2,5
C(C(C(O)=O)C(C(C=O)=O)O)(O)=O,,,5,1,4,0,4
26867_0,,,,2,3,2,5
26868_0,,,,2,3,2,5
26869_0,,,,2,3,2,5
26870_0,,,,2,3,2,5
26871_0,,,,2,3,2,5
26872_0,,,,2,3,2,5
26873_0,,,,2,3,2,5
26874_0,,,,2,3,2,5
26875_0,,,,2,3,2,5
26876_0,,,,2,3,2,5
26878_0,,,,2,3,2,5
C(C(C(O)=O)CC(C(O)=O)=O)(O)=O,,,5,1,2,0,2
26879_0,,,,2,3,2,5
26880_0,,,,2,3,2,5
26881_0,,,,2,3,2,5
26882_0,,,,2,3,2,5
26883_0,,,,2,3,2,5
26885_0,,,,2,3,2,5
C(C(C(O)=O)C)(O)=O,,,5,1,1,0,1
26886_0,,,,2,3,2,5
26887_0,,,,2,3,2,5
26889_0,,,,2,3,2,5
C1(C(C(O)=O)C(C(O1)=O)(C)O)=O,,,5,1,3,0,3
26891_0,,,,2,3,2,5
C([CH]C(O)=O)(O)=O,,,5,1,1,0,1
26893_0,,,,2,3,2,5
C(C)=C(C(O)=O)C(CC(C)O)O,,,5,1,2,0,2
26895_0,,,,2,3,2,5
C(CC(C)O)=C(C(O)=O)C(C)O,,,5,1,2,0,2
26897_0,,,,2,3,2,5
C(C(C=CC(C)O)C(C)O)(O)=O,,,5,1,2,0,2
26899_0,,,,2,3,2,5
C(CC(C)O)=C(C(O)=O)C(O)=O,,,5,1,2,0,2
26901_0,,,,2,3,2,5
C(C(C(O)=O)C=CC(C)O)(O)=O,,,5,1,2,0,2
26902_0,,,,2,3,2,5
26903_0,,,,2,3,2,5
26904_0,,,,2,3,2,5
26906_0,,,,2,3,2,5
C(CC(C)O)=CC(O)=O,,,5,1,2,0,2
26908_0,,,,2,3,2,5
C(CC=CC(C)O)(O)=O,,,5,1,2,0,2
26910_0,,,,2,3,2,5
C(C(C=CC(O)=O)C(C)O)(O)=O,,,5,1,3,0,3
26912_0,,,,2,3,2,5
C(CC=C(C(O)=O)C(C)O)(O)=O,,,5,1,3,0,3
26914_0,,,,2,3,2,5
C(CC(C(C(O)=O)=CC)O)(O)=O,,,5,1,2,0,2
26916_0,,,,2,3,2,5
C(C(C(C)O)=CC(CO)=O)(O)=O,,,5,1,2,0,2
26918_0,,,,2,3,2,5
C(CO)(C(C(C(O)=O)=CC)O)=O,,,5,1,2,0,2
26919_0,,,,2,3,2,5
26921_0,,,,2,3,2,5
C(C(C(C)O)=C(C=O)CO)(O)=O,,,5,1,2,0,2
26922_0,,,,2,3,2,5
26924_0,,,,2,3,2,5
C(C(C(C(O)=O)=CC)(CO)O)=O,,,5,1,2,0,2
26925_0,,,,2,3,2,5
26927_0,,,,2,3,2,5
C(C(C(C=O)=C)C(C)O)(O)=O,,,5,1,2,0,2
26928_0,,,,2,3,2,5
26930_0,,,,2,3,2,5
C(C(C(C)O)=C(C=O)C)(O)=O,,,5,1,2,0,2
26931_0,,,,2,3,2,5
26933_0,,,,2,3,2,5
C(C(C(C(O)=O)=CC)(C)O)=O,,,5,1,2,0,2
26935_0,,,,2,3,2,5
C(C(C(C)O)=CC(C)=O)(O)=O,,,5,1,2,0,2
26937_0,,,,2,3,2,5
C(C)(C(C(C(O)=O)=CC)O)=O,,,5,1,2,0,2
26938_0,,,,2,3,2,5
26939_0,,,,2,3,2,5
26941_0,,,,2,3,2,5
C(C(C(C)O)=C(C(O)=O)CO)(O)=O,,,5,1,1,0,1
26943_0,,,,2,3,2,5
C(C(C(C(O)=O)=CC)(CO)O)(O)=O,,,5,1,1,0,1
26945_0,,,,2,3,2,5
C(C)=C(C(O)=O)C(C)O,,,5,1,3,0,3
26947_0,,,,2,3,2,5
C(C)=C(C(O)=O)C(O)=O,,,5,1,3,0,3
26949_0,,,,2,3,2,5
C(C(C(C)O)=C(C(O)=O)C)(O)=O,,,5,1,2,0,2
26951_0,,,,2,3,2,5
C(C(C(C(O)=O)=CC)(C)O)(O)=O,,,5,1,2,0,2
26953_0,,,,2,3,2,5
C(C=C(C(O)=O)CC(C)O)(O)=O,,,5,1,2,0,2
26955_0,,,,2,3,2,5
C(CC(C(O)=O)=CC(C)O)(O)=O,,,5,1,2,0,2
26957_0,,,,2,3,2,5
C(CC=C(C(O)=O)C(O)=O)(O)=O,,,5,1,3,0,3
26959_0,,,,2,3,2,5
C(C(C(O)=O)C=CC(O)=O)(O)=O,,,5,1,3,0,3
26960_0,,,,2,3,2,5
26961_0,,,,2,3,2,5
26962_0,,,,2,3,2,5
26963_0,,,,2,3,2,5
26964_0,,,,2,3,2,5
26966_0,,,,2,3,2,5
C(C(C(O)=O)=CC(CO)=O)(O)=O,,,5,1,2,0,2
26967_0,,,,2,3,2,5
26969_0,,,,2,3,2,5
C(C(C(O)=O)=C(C=O)CO)(O)=O,,,5,1,2,0,2
26970_0,,,,2,3,2,5
26972_0,,,,2,3,2,5
C(C(C(O)=O)C(C=O)=C)(O)=O,,,5,1,2,0,2
26973_0,,,,2,3,2,5
26975_0,,,,2,3,2,5
C(C(C)=C(C(O)=O)C(O)=O)=O,,,5,1,2,0,2
26977_0,,,,2,3,2,5
C(C(C(O)=O)=CC(C)=O)(O)=O,,,5,1,2,0,2
26979_0,,,,2,3,2,5
C(C(C(O)=O)=C(C(O)=O)CO)(O)=O,,,5,1,1,0,1
26981_0,,,,2,3,2,5
C(C(C(O)=O)=C(C(O)=O)C)(O)=O,,,5,1,2,0,2
26983_0,,,,2,3,2,5
C(C(C)(CC=CC(O)=O)O)(O)=O,,,5,1,2,0,2
26985_0,,,,2,3,2,5
C(C(C=CCC(O)=O)(C)O)(O)=O,,,5,1,3,0,3
26986_0,,,,2,3,2,5
26987_0,,,,2,3,2,5
26989_0,,,,2,3,2,5
C(CC(C(O)=O)=CC(O)=O)(O)=O,,,5,1,3,0,3
26990_0,,,,2,3,2,5
26991_0,,,,2,3,2,5
26993_0,,,,2,3,2,5
C(C=CC(CO)=O)(O)=O,,,5,1,3,0,3
26994_0,,,,2,3,2,5
26995_0,,,,2,3,2,5
26997_0,,,,2,3,2,5
C(C(CO)=CC(O)=O)=O,,,5,1,4,0,4
26998_0,,,,2,3,2,5
26999_0,,,,2,3,2,5
27000_0,,,,2,3,2,5
27001_0,,,,2,3,2,5
27002_0,,,,2,3,2,5
27003_0,,,,2,3,2,5
27004_0,,,,2,3,2,5
27005_0,,,,2,3,2,5
27006_0,,,,2,3,2,5
27007_0,,,,2,3,2,5
27009_0,,,,2,3,2,5
C(C(C)=CC(O)=O)=O,,,5,1,2,0,2
27010_0,,,,2,3,2,5
27012_0,,,,2,3,2,5
C(CC(C=O)=C)(O)=O,,,5,1,2,0,2
27013_0,,,,2,3,2,5
27014_0,,,,2,3,2,5
27015_0,,,,2,3,2,5
27016_0,,,,2,3,2,5
27018_0,,,,2,3,2,5
C(C=CC(C)=O)(O)=O,,,5,1,3,0,3
27019_0,,,,2,3,2,5
27020_0,,,,2,3,2,5
27021_0,,,,2,3,2,5
27022_0,,,,2,3,2,5
27023_0,,,,2,3,2,5
27025_0,,,,2,3,2,5
C(C(CO)=CC(O)=O)(O)=O,,,5,1,3,0,3
27026_0,,,,2,3,2,5
27027_0,,,,2,3,2,5
27028_0,,,,2,3,2,5
27029_0,,,,2,3,2,5
27031_0,,,,2,3,2,5
C(C)=C(C(O)=O)C[CH]C(O)=O,,,5,1,2,0,2
27033_0,,,,2,3,2,5
C(C(C=C)C[CH]C(O)=O)(O)=O,,,5,1,4,0,4
27035_0,,,,2,3,2,5
C(CCC(C(O)=O)=CC)(O)=O,,,5,1,2,0,2
27037_0,,,,2,3,2,5
C(C(C=C)CCC(O)=O)(O)=O,,,5,1,4,0,4
27039_0,,,,2,3,2,5
C(CC[CH]C(O)=O)=CC(O)=O,,,5,1,3,0,3
27041_0,,,,2,3,2,5
C(CC=CC[CH]C(O)=O)(O)=O,,,5,1,2,0,2
27043_0,,,,2,3,2,5
C(CCCC=CC(O)=O)(O)=O,,,5,1,3,0,3
27045_0,,,,2,3,2,5
C(CC=CCCC(O)=O)(O)=O,,,5,1,2,0,2
27047_0,,,,2,3,2,5
C(CC(C)=C[CH]C(O)=O)(O)=O,,,5,1,2,0,2
27049_0,,,,2,3,2,5
C(C)(C[CH]C(O)=O)=CC(O)=O,,,5,1,2,0,2
27051_0,,,,2,3,2,5
C(CC(C[CH]C(O)=O)=C)(O)=O,,,5,1,2,0,2
27053_0,,,,2,3,2,5
C(CC=C(C)CC(O)=O)(O)=O,,,5,1,2,0,2
27055_0,,,,2,3,2,5
C(CCC(C)=CC(O)=O)(O)=O,,,5,1,2,0,2
27057_0,,,,2,3,2,5
C(CC(CCC(O)=O)=C)(O)=O,,,5,1,2,0,2
27058_0,,,,2,3,2,5
27059_0,,,,2,3,2,5
27060_0,,,,2,3,2,5
27061_0,,,,2,3,2,5
27062_0,,,,2,3,2,5
27063_0,,,,2,3,2,5
27065_0,,,,2,3,2,5
C(C(CC)O)(O)=O,,,5,1,5,0,5
27066_0,,,,2,3,2,5
27068_0,,,,2,3,2,5
C(C(CO)CC(O)=O)(O)=O,,,5,1,3,0,3
27070_0,,,,2,3,2,5
C(C(C)C(C(O)=O)O)(O)=O,,,5,1,4,0,4
27072_0,,,,2,3,2,5
C(C1C(C)OC(CO)(C1O)O)(O)=O,,,5,1,2,0,2
27073_0,,,,2,3,2,5
27075_0,,,,2,3,2,5
C(C1C(C)OC(C1(CO)O)O)(O)=O,,,5,1,2,0,2
27077_0,,,,2,3,2,5
C(C1C(C)OC(C1(C)O)O)(O)=O,,,5,1,2,0,2
27079_0,,,,2,3,2,5
C(C1C(C)OC(C)(C1O)O)(O)=O,,,5,1,2,0,2
27081_0,,,,2,3,2,5
C1(C(C(O)=O)C(C(CO)(O)O1)O)=O,,,5,1,2,0,2
27082_0,,,,2,3,2,5
27084_0,,,,2,3,2,5
C1(C(C(O)=O)C(C(O)O1)(CO)O)=O,,,5,1,2,0,2
27086_0,,,,2,3,2,5
C1(C(C(O)=O)C(C)(C(O)O1)O)=O,,,5,1,2,0,2
27088_0,,,,2,3,2,5
C1(C(C(O)=O)C(C(C)(O)O1)O)=O,,,5,1,2,0,2
27089_0,,,,2,3,2,5
27090_0,,,,2,3,2,5
27091_0,,,,2,3,2,5
27092_0,,,,2,3,2,5
27093_0,,,,2,3,2,5
27094_0,,,,2,3,2,5
27095_0,,,,2,3,2,5
27096_0,,,,2,3,2,5
27097_0,,,,2,3,2,5
27098_0,,,,2,3,2,5
27099_0,,,,2,3,2,5
27100_0,,,,2,3,2,5
27101_0,,,,2,3,2,5
27102_0,,,,2,3,2,5
27103_0,,,,2,3,2,5
27104_0,,,,2,3,2,5
27105_0,,,,2,3,2,5
27106_0,,,,2,3,2,5
27107_0,,,,2,3,2,5
27108_0,,,,2,3,2,5
27109_0,,,,2,3,2,5
27110_0,,,,2,3,2,5
27111_0,,,,2,3,2,5
27112_0,,,,2,3,2,5
27113_0,,,,2,3,2,5
27114_0,,,,2,3,2,5
27115_0,,,,2,3,2,5
27116_0,,,,2,3,2,5
27118_0,,,,2,3,2,5
C(C1C(C)OC(C1(CO)O)=O)(O)=O,,,5,1,1,0,1
27120_0,,,,2,3,2,5
C(C1C(C)OC(C1(C)O)=O)(O)=O,,,5,1,2,0,2
27121_0,,,,2,3,2,5
27122_0,,,,2,3,2,5
27124_0,,,,2,3,2,5
C1(C(C(O)=O)C(C=O)(CO1)O)=O,,,5,1,2,0,2
27126_0,,,,2,3,2,5
C1(C(C(O)=O)C(C(O1)=O)(CO)O)=O,,,5,1,1,0,1
27128_0,,,,2,3,2,5
C1(C(C(O)=O)C(C(O)=O)(CO1)O)=O,,,5,1,1,0,1
27130_0,,,,2,3,2,5
C1(C(C)(CC(CC(O)=O)O1)O)=O,,,5,1,2,0,2
27132_0,,,,2,3,2,5
C(C1COC(C1(C)O)=O)(O)=O,,,5,1,2,0,2
27134_0,,,,2,3,2,5
C(C1(CO)C(C(C(O1)=O)=O)O)(O)=O,,,5,1,1,0,1
27135_0,,,,2,3,2,5
27136_0,,,,2,3,2,5
27137_0,,,,2,3,2,5
27139_0,,,,2,3,2,5
C1(C(CO)(C(C(O)=O)(CO1)O)O)=O,,,5,1,4,0,4
27140_0,,,,2,3,2,5
27141_0,,,,2,3,2,5
27143_0,,,,2,3,2,5
C(CC1(C)C[CH]C(O1)=O)(O)=O,,,5,1,2,0,2
27145_0,,,,2,3,2,5
C1(CCC(C)(CC(O)=O)O1)=O,,,5,1,2,0,2
27146_0,,,,2,3,2,5
27147_0,,,,2,3,2,5
27149_0,,,,2,3,2,5
C1(C(C(O)=O)C(CC(C)O1)O)=O,,,5,1,2,0,2
27151_0,,,,2,3,2,5
C(C1C(CC(OC1C)=O)O)(O)=O,,,5,1,2,0,2
27153_0,,,,2,3,2,5
C1(C(C(O)=O)C(CC(O1)=O)O)=O,,,5,1,2,0,2
27155_0,,,,2,3,2,5
C1(C(C(O)=O)C(C(CO1)=O)O)=O,,,5,1,2,0,2
27157_0,,,,2,3,2,5
C(C1(COC(C(C1O)=O)=O)O)(O)=O,,,5,1,1,0,1
27158_0,,,,2,3,2,5
27160_0,,,,2,3,2,5
C(C1C(C)OC([CH]C1)=O)(O)=O,,,5,1,2,0,2
27162_0,,,,2,3,2,5
C1(CCC(C(O)=O)C(C)O1)=O,,,5,1,2,0,2
27164_0,,,,2,3,2,5
C(CC1CC[CH]C(O1)=O)(O)=O,,,5,1,2,0,2
27166_0,,,,2,3,2,5
C1(CCCC(CC(O)=O)O1)=O,,,5,1,2,0,2
27168_0,,,,2,3,2,5
C1(C(C(O)=O)C[CH]C(O1)=O)=O,,,5,1,2,0,2
27170_0,,,,2,3,2,5
C1(C(C(O)=O)CCC(O1)=O)=O,,,5,1,2,0,2
27172_0,,,,2,3,2,5
C(CC(C)C(CC(C=O)=O)O)(O)=O,,,5,1,2,0,2
27173_0,,,,2,3,2,5
27174_0,,,,2,3,2,5
27175_0,,,,2,3,2,5
27177_0,,,,2,3,2,5
C(CC(C)C(C(C=O)=O)CO)(O)=O,,,5,1,2,0,2
27178_0,,,,2,3,2,5
27179_0,,,,2,3,2,5
27180_0,,,,2,3,2,5
27182_0,,,,2,3,2,5
C(CC(C)C(CC=O)O)(O)=O,,,5,1,2,0,2
27183_0,,,,2,3,2,5
27184_0,,,,2,3,2,5
27185_0,,,,2,3,2,5
27187_0,,,,2,3,2,5
C(C(C=O)(C(C)CC(O)=O)O)=O,,,5,1,2,0,2
27188_0,,,,2,3,2,5
27189_0,,,,2,3,2,5
27190_0,,,,2,3,2,5
27192_0,,,,2,3,2,5
C(C(C=O)(C(C)CC(O)=O)O)(O)=O,,,5,1,2,0,2
27193_0,,,,2,3,2,5
27194_0,,,,2,3,2,5
27195_0,,,,2,3,2,5
27197_0,,,,2,3,2,5
C(CC(C)C(CO)C(C)O)(O)=O,,,5,1,2,0,2
27199_0,,,,2,3,2,5
C(CC(C)C(CC(C)O)O)(O)=O,,,5,1,2,0,2
27201_0,,,,2,3,2,5
C(CC(C)CC(CCO)O)(O)=O,,,5,1,2,0,2
27203_0,,,,2,3,2,5
C(CC(C)C(C)(CCO)O)(O)=O,,,5,1,2,0,2
27205_0,,,,2,3,2,5
C(C(CO)C(C)CC(O)=O)(O)=O,,,5,1,2,0,2
27207_0,,,,2,3,2,5
C(CC(C(C)CC(O)=O)O)(O)=O,,,5,1,2,0,2
27209_0,,,,2,3,2,5
C(CC(C)C(C(CO)=O)O)(O)=O,,,5,1,2,0,2
27211_0,,,,2,3,2,5
C(CC(C)CC(CO)=O)(O)=O,,,5,1,2,0,2
27213_0,,,,2,3,2,5
C(CC(C)C(C(C)=O)O)(O)=O,,,5,1,2,0,2
27215_0,,,,2,3,2,5
C(CC(C)CO)(O)=O,,,5,1,2,0,2
27217_0,,,,2,3,2,5
C(C(CCO)CC(O)=O)(O)=O,,,5,1,3,0,3
27219_0,,,,2,3,2,5
C(C(C)(CO)CC(O)=O)(O)=O,,,5,1,2,0,2
27221_0,,,,2,3,2,5
C(C(C)C(C(O)=O)CO)(O)=O,,,5,1,2,0,2
27222_0,,,,2,3,2,5
27224_0,,,,2,3,2,5
C(C(CCCO)CC(O)=O)(O)=O,,,5,1,2,0,2
27225_0,,,,2,3,2,5
27227_0,,,,2,3,2,5
C(C(CCO)C(C(O)=O)C)(O)=O,,,5,1,2,0,2
27229_0,,,,2,3,2,5
C(CC(C)C(C)O)(O)=O,,,5,1,2,0,2
27231_0,,,,2,3,2,5
C(C(CC(C)O)CC(O)=O)(O)=O,,,5,1,2,0,2
27233_0,,,,2,3,2,5
C(C(C)(C(C)O)CC(O)=O)(O)=O,,,5,1,2,0,2
27235_0,,,,2,3,2,5
C(C(C(C)O)C(C(O)=O)C)(O)=O,,,5,1,2,0,2
27237_0,,,,2,3,2,5
C(C(C(C)CC(O)=O)C(C)O)(O)=O,,,5,1,2,0,2
27239_0,,,,2,3,2,5
C(CC(C)CC(CC(O)=O)O)(O)=O,,,5,1,2,0,2
27241_0,,,,2,3,2,5
C(CC(C)(C(C)CC(O)=O)O)(O)=O,,,5,1,2,0,2
27243_0,,,,2,3,2,5
C(C(C(O)=O)C(C)CC(O)=O)(O)=O,,,5,1,2,0,2
27245_0,,,,2,3,2,5
C(CC(C)CC(O)=O)(O)=O,,,5,1,2,0,2
27247_0,,,,2,3,2,5
C(CCC(C(O)=O)CC(O)=O)(O)=O,,,5,1,2,0,2
27249_0,,,,2,3,2,5
C(C(C)(CC(O)=O)CC(O)=O)(O)=O,,,5,1,2,0,2
27251_0,,,,2,3,2,5
C(CC(C(O)=O)C(C(O)=O)C)(O)=O,,,5,1,2,0,2
27253_0,,,,2,3,2,5
C(CC(C)CC=CC=O)(O)=O,,,5,1,2,0,2
27255_0,,,,2,3,2,5
C(CC(C)CC=CC(O)=O)=O,,,5,1,3,0,3
27257_0,,,,2,3,2,5
C(CC(C)C(C(O)=O)C=C)=O,,,5,1,3,0,3
27259_0,,,,2,3,2,5
C(C(C=C)C(C)CC(O)=O)=O,,,5,1,2,0,2
27261_0,,,,2,3,2,5
C(CC(C)C(CO)(C(C)O)O)(O)=O,,,5,1,2,0,2
27263_0,,,,2,3,2,5
C(CC(C)C(C(C(C)O)O)O)(O)=O,,,5,1,2,0,2
27265_0,,,,2,3,2,5
C(CC(C)CC(C(CO)O)O)(O)=O,,,5,1,2,0,2
27267_0,,,,2,3,2,5
C(CC(C)C(C)(C(CO)O)O)(O)=O,,,5,1,2,0,2
27268_0,,,,2,3,2,5
27270_0,,,,2,3,2,5
C(CC(C)C(C(C=O)O)O)(O)=O,,,5,1,2,0,2
27271_0,,,,2,3,2,5
27273_0,,,,2,3,2,5
C(C(CO)(C(C)CC(O)=O)O)=O,,,5,1,2,0,2
27275_0,,,,2,3,2,5
C(CC(C)C([CH]C(O)=O)O)(O)=O,,,5,1,2,0,2
27277_0,,,,2,3,2,5
C(CC([C](C(O)=O)CO)C)(O)=O,,,5,1,2,0,2
27278_0,,,,2,3,2,5
27280_0,,,,2,3,2,5
C(CC(C)C(C=O)O)(O)=O,,,5,1,2,0,2
27282_0,,,,2,3,2,5
C(CC(C)C([C](C(O)=O)O)O)(O)=O,,,5,1,2,0,2
27283_0,,,,2,3,2,5
27285_0,,,,2,3,2,5
C(CC(C)CC(C=O)O)(O)=O,,,5,1,2,0,2
27286_0,,,,2,3,2,5
27288_0,,,,2,3,2,5
C(C(C)(C(C)CC(O)=O)O)=O,,,5,1,2,0,2
27290_0,,,,2,3,2,5
C(CC(C)C(C(C(O)=O)O)O)(O)=O,,,5,1,3,0,3
27292_0,,,,2,3,2,5
C(C(CO)(C(C)CC(O)=O)O)(O)=O,,,5,1,2,0,2
27293_0,,,,2,3,2,5
27295_0,,,,2,3,2,5
C(CC(C)C[C](C(O)=O)O)(O)=O,,,5,1,3,0,3
27297_0,,,,2,3,2,5
C(CC(C)CC(C(O)=O)O)(O)=O,,,5,1,3,0,3
27299_0,,,,2,3,2,5
C(C(C)(C(C)CC(O)=O)O)(O)=O,,,5,1,2,0,2
27300_0,,,,2,3,2,5
27301_0,,,,2,3,2,5
27302_0,,,,2,3,2,5
27303_0,,,,2,3,2,5
27304_0,,,,2,3,2,5
27306_0,,,,2,3,2,5
C(CC(C)C(C)(CC=O)O)(O)=O,,,5,1,2,0,2
27307_0,,,,2,3,2,5
27308_0,,,,2,3,2,5
27309_0,,,,2,3,2,5
27311_0,,,,2,3,2,5
C(CC(C)C(C(C=O)=O)O)(O)=O,,,5,1,2,0,2
27312_0,,,,2,3,2,5
27314_0,,,,2,3,2,5
C(CC(C)CC(C=O)=O)(O)=O,,,5,1,3,0,3
27316_0,,,,2,3,2,5
C(CC(C)C(C(O)=O)O)(O)=O,,,5,1,2,0,2
27318_0,,,,2,3,2,5
C(CC(C)C(CO)O)(O)=O,,,5,1,3,0,3
27320_0,,,,2,3,2,5
C(CC(C)C(C(C(O)=O)=O)O)(O)=O,,,5,1,2,0,2
27321_0,,,,2,3,2,5
27322_0,,,,2,3,2,5
27323_0,,,,2,3,2,5
27325_0,,,,2,3,2,5
C(C(CC(C=O)O)CC(O)=O)(O)=O,,,5,1,3,0,3
27326_0,,,,2,3,2,5
27328_0,,,,2,3,2,5
C(CCC(C(O)=O)CC(O)=O)=O,,,5,1,2,0,2
27330_0,,,,2,3,2,5
C(C(CC(CO)O)CC(O)=O)(O)=O,,,5,1,3,0,3
27331_0,,,,2,3,2,5
27333_0,,,,2,3,2,5
C(CC(C(O)=O)(C)C(C=O)O)(O)=O,,,5,1,2,0,2
27334_0,,,,2,3,2,5
27336_0,,,,2,3,2,5
C(C(C)(C(CO)O)CC(O)=O)(O)=O,,,5,1,3,0,3
27337_0,,,,2,3,2,5
27339_0,,,,2,3,2,5
C(C(C)C(C(O)=O)C(C=O)O)(O)=O,,,5,1,2,0,2
27340_0,,,,2,3,2,5
27342_0,,,,2,3,2,5
C(CC(C(O)=O)C(C(O)=O)C)=O,,,5,1,2,0,2
27344_0,,,,2,3,2,5
C(C(C(CO)O)C(C(O)=O)C)(O)=O,,,5,1,2,0,2
27345_0,,,,2,3,2,5
27346_0,,,,2,3,2,5
27347_0,,,,2,3,2,5
27348_0,,,,2,3,2,5
27349_0,,,,2,3,2,5
27350_0,,,,2,3,2,5
27351_0,,,,2,3,2,5
27352_0,,,,2,3,2,5
27353_0,,,,2,3,2,5
27354_0,,,,2,3,2,5
27355_0,,,,2,3,2,5
27356_0,,,,2,3,2,5
27357_0,,,,2,3,2,5
27358_0,,,,2,3,2,5
27359_0,,,,2,3,2,5
27360_0,,,,2,3,2,5
27361_0,,,,2,3,2,5
27362_0,,,,2,3,2,5
27363_0,,,,2,3,2,5
27364_0,,,,2,3,2,5
27365_0,,,,2,3,2,5
27366_0,,,,2,3,2,5
27367_0,,,,2,3,2,5
27368_0,,,,2,3,2,5
27370_0,,,,2,3,2,5
C(C(O)O)(O)=O,,,5,1,3,0,3
27371_0,,,,2,3,2,5
27372_0,,,,2,3,2,5
27373_0,,,,2,1,1,2
27375_0,,,,2,1,1,2
C(C1C(C(C(CC1O)O)O)O)(O)=O,,,5,1,1,0,1
27377_0,,,,2,1,1,2
C(C1C(CC(CC1O)O)O)(O)=O,,,5,1,1,0,1
27378_0,,,,2,1,1,2
27379_0,,,,2,1,1,2
27381_0,,,,2,1,1,2
C1(C(CO)(C(C=O)(CC1O)O)O)=O,,,5,1,4,0,4
27381_1,,,,2,1,1,2
27382_0,,,,2,1,1,2
27382_1,,,,2,1,1,2
27384_0,,,,2,1,1,2
C(C1(C(CC(C1(CO)O)O)O)O)=O,,,5,1,4,0,4
27384_1,,,,2,1,1,2
27385_0,,,,2,1,1,2
27385_1,,,,2,1,1,2
27387_0,,,,2,1,1,2
C(C1(C(CC(C(C1O)=O)O)O)O)=O,,,5,1,2,0,2
27387_1,,,,2,1,1,2
27389_0,,,,2,1,1,2
C1(C(C(CC1O)O)(C(C=O)O)O)=O,,,5,1,4,0,4
27389_1,,,,2,1,1,2
27391_0,,,,2,1,1,2
C1(C(CC(C1(C(CO)O)O)O)O)=O,,,5,1,4,0,4
27391_1,,,,2,1,1,2
27393_0,,,,2,1,1,2
C1(C(CC(C1(C(C)O)O)O)O)=O,,,5,1,4,0,4
27393_1,,,,2,1,1,2
27395_0,,,,2,1,1,2
C(C1(C(C(CC1O)O)=O)O)(O)=O,,,5,1,4,0,4
27395_1,,,,2,1,1,2
27397_0,,,,2,1,1,2
C1(C(CC(C1(CO)O)O)O)=O,,,5,1,4,0,4
27397_1,,,,2,1,1,2
27399_0,,,,2,1,1,2
C(C1(C(C(CO)(CC1O)O)O)O)=O,,,5,1,4,0,4
27399_1,,,,2,1,1,2
27400_0,,,,2,1,1,2
27400_1,,,,2,1,1,2
27402_0,,,,2,1,1,2
C1(C(C(CO)C(C1(CO)O)O)O)=O,,,5,1,2,0,2
27402_1,,,,2,1,1,2
27404_0,,,,2,1,1,2
C1(C(CC(CO)(C1(CO)O)O)O)=O,,,5,1,2,0,2
27404_1,,,,2,1,1,2
27406_0,,,,2,1,1,2
C1(C(C(C(C)(C1(CO)O)O)O)O)=O,,,5,1,2,0,2
27406_1,,,,2,1,1,2
27408_0,,,,2,1,1,2
C1(C(C(C=C)C(C1(CO)O)O)O)=O,,,5,1,2,0,2
27408_1,,,,2,1,1,2
27410_0,,,,2,1,1,2
C1(C(C(C(C1(CO)O)O)O)O)=O,,,5,1,2,0,2
27410_1,,,,2,1,1,2
27411_0,,,,2,1,1,2
27411_1,,,,2,1,1,2
27412_0,,,,2,1,1,2
27412_1,,,,2,1,1,2
27414_0,,,,2,1,1,2
C(C1(CO)C(C(C)(CC1O)O)O)=O,,,5,1,2,0,2
27416_0,,,,2,1,1,2
C(C)(C1(C(C(C)(CC1O)O)O)O)=O,,,5,1,4,0,4
27416_1,,,,2,1,1,2
27418_0,,,,2,1,1,2
C(C1(C=C)C(C(C)(CC1O)O)O)=O,,,5,1,2,0,2
27420_0,,,,2,1,1,2
C(C1(C(C(C)(CC1O)O)O)O)=O,,,5,1,4,0,4
27420_1,,,,2,1,1,2
27421_0,,,,2,1,1,2
27422_0,,,,2,1,1,2
27422_1,,,,2,1,1,2
27423_0,,,,2,1,1,2
27424_0,,,,2,1,1,2
27424_1,,,,2,1,1,2
27426_0,,,,2,1,1,2
C(C1(CO)C(CC(C1(C)O)O)O)=O,,,5,1,2,0,2
27428_0,,,,2,1,1,2
C(C)(C1(C(CC(C1(C)O)O)O)O)=O,,,5,1,4,0,4
27428_1,,,,2,1,1,2
27430_0,,,,2,1,1,2
C(C1(C=C)C(CC(C1(C)O)O)O)=O,,,5,1,2,0,2
27432_0,,,,2,1,1,2
C(C1(C(CC(C1(C)O)O)O)O)=O,,,5,1,4,0,4
27432_1,,,,2,1,1,2
27433_0,,,,2,1,1,2
27434_0,,,,2,1,1,2
27434_1,,,,2,1,1,2
27435_0,,,,2,1,1,2
27436_0,,,,2,1,1,2
27436_1,,,,2,1,1,2
27437_0,,,,2,1,1,2
27437_1,,,,2,1,1,2
27438_0,,,,2,1,1,2
27440_0,,,,2,1,1,2
C(C1(C(CC(C1(C)O)=O)O)CO)=O,,,5,1,2,0,2
27441_0,,,,2,1,1,2
27443_0,,,,2,1,1,2
C1(C(C)(C(C(C)=O)(C(C1)O)O)O)=O,,,5,1,4,0,4
27443_1,,,,2,1,1,2
27445_0,,,,2,1,1,2
C(C1(C=C)C(CC(C1(C)O)=O)O)=O,,,5,1,2,0,2
27447_0,,,,2,1,1,2
C1(C(C)(C(C=O)(C(C1)O)O)O)=O,,,5,1,4,0,4
27447_1,,,,2,1,1,2
27448_0,,,,2,1,1,2
27448_1,,,,2,1,1,2
27449_0,,,,2,1,1,2
27450_0,,,,2,1,1,2
27450_1,,,,2,1,1,2
27451_0,,,,2,1,1,2
27452_0,,,,2,1,1,2
27453_0,,,,2,1,1,2
27453_1,,,,2,1,1,2
27454_0,,,,2,1,1,2
27454_1,,,,2,1,1,2
27455_0,,,,2,1,1,2
27455_1,,,,2,1,1,2
27456_0,,,,2,1,1,2
27456_1,,,,2,1,1,2
27458_0,,,,2,1,1,2
C(C1(C(CC(C1(C)O)O)O)O)(O)=O,,,5,1,4,0,4
27458_1,,,,2,1,1,2
27460_0,,,,2,1,1,2
C(C1(C(C(C)(CC1O)O)O)O)(O)=O,,,5,1,4,0,4
27460_1,,,,2,1,1,2
27461_0,,,,2,1,1,2
27462_0,,,,2,1,1,2
27463_0,,,,2,1,1,2
27464_0,,,,2,1,1,2
27465_0,,,,2,1,1,2
27466_0,,,,2,1,1,2
27466_1,,,,2,1,1,2
27468_0,,,,2,1,1,2
C1(C(CO)(C(C(C1)=O)O)O)=O,,,5,1,2,0,2
27468_1,,,,2,1,1,2
27470_0,,,,2,1,1,2
C1(C(C(C)(C(C1(CO)O)O)O)O)=O,,,5,1,2,0,2
27470_1,,,,2,1,1,2
27471_0,,,,2,1,1,2
27471_1,,,,2,1,1,2
27472_0,,,,2,1,1,2
27472_1,,,,2,1,1,2
27474_0,,,,2,1,1,2
C1(C(C)(C(C(O)=O)(C(C1)O)O)O)=O,,,5,1,4,0,4
27474_1,,,,2,1,1,2
27475_0,,,,2,1,1,2
27475_1,,,,2,1,1,2
27476_0,,,,2,1,1,2
27476_1,,,,2,1,1,2
27477_0,,,,2,1,1,2
27477_1,,,,2,1,1,2
27479_0,,,,2,1,1,2
C(C1C(C(C(C1O)O)O)O)(O)=O,,,5,1,2,0,2
27481_0,,,,2,1,1,2
C1(C2C(C(C(C2O)O)(O)O1)O)=O,,,5,1,3,0,3
27483_0,,,,2,1,1,2
C1(C2C(C(CC2O)(O)O1)O)=O,,,5,1,3,0,3
27484_0,,,,2,1,1,2
27486_0,,,,2,1,1,2
C(C1(C(C)O)C(C(C)CC1O)O)=O,,,5,1,1,0,1
27488_0,,,,2,1,1,2
C(C1(CO)C(CC(C)CC1O)O)=O,,,5,1,1,0,1
27490_0,,,,2,1,1,2
C(C1(CO)C(CC(C)C1(C)O)O)=O,,,5,1,1,0,1
27492_0,,,,2,1,1,2
C(C1(C=O)C(C(C)CC1O)O)(O)=O,,,5,1,1,0,1
27494_0,,,,2,1,1,2
C(C(C1(C(C(C)CC1O)O)O)=O)=O,,,5,1,2,0,2
27494_1,,,,2,1,1,2
27496_0,,,,2,1,1,2
C(C1(CC(C(O)=O)CC1O)CO)=O,,,5,1,2,0,2
27498_0,,,,2,1,1,2
C(C1(CC(CC1O)O)C(C)O)(O)=O,,,5,1,1,0,1
27500_0,,,,2,1,1,2
C(C1(C(O)=O)CC(CC1O)O)(O)=O,,,5,1,1,0,1
27502_0,,,,2,1,1,2
C(C1C(C(C)CC1O)O)(O)=O,,,5,1,1,0,1
27504_0,,,,2,1,1,2
C(C1C(CC(C)CC1O)O)(O)=O,,,5,1,1,0,1
27506_0,,,,2,1,1,2
C(C1C(CC(C)C1(C)O)O)(O)=O,,,5,1,1,0,1
27508_0,,,,2,1,1,2
C(C1(C(CC(C)CC1O)O)O)(O)=O,,,5,1,2,0,2
27508_1,,,,2,1,1,2
27510_0,,,,2,1,1,2
C(C1(C(CC(C)C1(C)O)O)O)(O)=O,,,5,1,2,0,2
27510_1,,,,2,1,1,2
27512_0,,,,2,1,1,2
C(C1(C(C)=O)CC(C)CC1O)(O)=O,,,5,1,1,0,1
27514_0,,,,2,1,1,2
C(C1(C(CC(C)CC1O)=O)C)(O)=O,,,5,1,1,0,1
27516_0,,,,2,1,1,2
C(C1(CCC=CC1O)C(C)O)(O)=O,,,5,1,1,0,1
27518_0,,,,2,1,1,2
C(C1(C(O)=O)CCC=CC1O)(O)=O,,,5,1,1,0,1
27520_0,,,,2,1,1,2
C(C1(C(C(C)CC1O)O)O)=O,,,5,1,2,0,2
27520_1,,,,2,1,1,2
27522_0,,,,2,1,1,2
C(C1(C(C(C)CC1O)O)O)(O)=O,,,5,1,2,0,2
27522_1,,,,2,1,1,2
27524_0,,,,2,1,1,2
C(C1(CCC(C1O)O)C(C)O)(O)=O,,,5,1,1,0,1
27526_0,,,,2,1,1,2
C(C1(CCC(C1O)=O)C(C)O)(O)=O,,,5,1,1,0,1
27528_0,,,,2,1,1,2
C(C1(C(O)=O)CCC(C1O)O)(O)=O,,,5,1,1,0,1
27530_0,,,,2,1,1,2
C(C1(C(O)=O)CCC(C1O)=O)(O)=O,,,5,1,1,0,1
27532_0,,,,2,1,1,2
C(C1C(C(CC1O)O)O)(O)=O,,,5,1,1,0,1
27533_0,,,,2,2,1,3
27534_0,,,,2,2,1,3
27534_1,,,,2,2,1,3
27535_0,,,,2,2,1,3
27535_1,,,,2,2,1,3
27536_0,,,,2,2,1,3
27536_1,,,,2,2,1,3
27538_0,,,,2,2,1,3
C1(C(C(CC1O)O)(C(C=C)O)O)=O,,,5,1,2,0,2
27538_1,,,,2,2,1,3
27539_0,,,,2,2,1,3
27539_1,,,,2,2,1,3
27540_0,,,,2,2,1,3
27540_1,,,,2,2,1,3
27541_0,,,,2,2,1,3
27541_1,,,,2,2,1,3
27542_0,,,,2,2,1,3
27542_1,,,,2,2,1,3
27543_0,,,,2,2,1,3
27543_1,,,,2,2,1,3
27544_0,,,,2,2,1,3
27544_1,,,,2,2,1,3
27546_0,,,,2,2,1,3
C(C(CO)(CO)C(CC(C)O)O)=O,,,5,1,2,0,2
27548_0,,,,2,2,1,3
C(C(CO)(CO)C(CC(O)=O)O)=O,,,5,1,2,0,2
27549_0,,,,2,2,1,3
27550_0,,,,2,2,1,3
27552_0,,,,2,2,1,3
C(C(CO)(CO)C(C(CO)=O)O)=O,,,5,1,2,0,2
27553_0,,,,2,2,1,3
27553_1,,,,2,2,1,3
27555_0,,,,2,2,1,3
C(C(CO)(CO)C(C=O)(CO)O)=O,,,5,1,2,0,2
27556_0,,,,2,2,1,3
27557_0,,,,2,2,1,3
27559_0,,,,2,2,1,3
C(C(CO)(CO)C(C=O)(C)O)=O,,,5,1,2,0,2
27560_0,,,,2,2,1,3
27561_0,,,,2,2,1,3
27563_0,,,,2,2,1,3
C(C(CO)(CO)C(C(C)=O)O)=O,,,5,1,2,0,2
27564_0,,,,2,2,1,3
27564_1,,,,2,2,1,3
27565_0,,,,2,2,1,3
27565_1,,,,2,2,1,3
27567_0,,,,2,2,1,3
C(C(CO)(C(C=O)O)O)(CCO)=O,,,5,1,2,0,2
27567_1,,,,2,2,1,3
27569_0,,,,2,2,1,3
C(C(C(C(C=O)=O)(CO)CO)O)=O,,,5,1,2,0,2
27571_0,,,,2,2,1,3
C(C(C(CO)(CO)C(CO)O)=O)=O,,,5,1,2,0,2
27573_0,,,,2,2,1,3
C(C(C(CO)(C(C)O)C(C)O)=O)=O,,,5,1,2,0,2
27575_0,,,,2,2,1,3
C(C(C(C=O)=O)(CO)C(C)O)(O)=O,,,5,1,3,0,3
27577_0,,,,2,2,1,3
C(C(C(CO)(CO)C(C)O)=O)=O,,,5,1,2,0,2
27578_0,,,,2,2,1,3
27580_0,,,,2,2,1,3
C(C(C(O)=O)(C(C=O)=O)CO)(O)=O,,,5,1,2,0,2
27582_0,,,,2,2,1,3
C(C(C(C=O)=O)(CO)CO)(O)=O,,,5,1,2,0,2
27584_0,,,,2,2,1,3
C=CC(C(C(C=O)=O)(CO)CO)O,,,5,1,1,0,1
27585_0,,,,2,2,1,3
27586_0,,,,2,2,1,3
27588_0,,,,2,2,1,3
C(C(C(CO)(CO)CO)=O)=O,,,5,1,1,0,1
27589_0,,,,2,2,1,3
27590_0,,,,2,2,1,3
27591_0,,,,2,2,1,3
27592_0,,,,2,2,1,3
27593_0,,,,2,2,1,3
27594_0,,,,2,2,1,3
27595_0,,,,2,2,1,3
27596_0,,,,2,2,1,3
27598_0,,,,2,2,1,3
C(C(CO)(CO)C(CCO)O)=O,,,5,1,2,0,2
27599_0,,,,2,2,1,3
27599_1,,,,2,2,1,3
27601_0,,,,2,2,1,3
C(C)(C(C(C)O)(C(CCO)O)O)=O,,,5,1,4,0,4
27601_1,,,,2,2,1,3
27603_0,,,,2,2,1,3
C(C(C(C)=O)(C(CCO)O)O)(O)=O,,,5,1,4,0,4
27603_1,,,,2,2,1,3
27605_0,,,,2,2,1,3
C(C)(C(CO)(C(CCO)O)O)=O,,,5,1,4,0,4
27605_1,,,,2,2,1,3
27607_0,,,,2,2,1,3
C(C(C=C)(C(C)O)C(CCO)O)=O,,,5,1,2,0,2
27609_0,,,,2,2,1,3
C(C(C=O)(C=C)C(CCO)O)(O)=O,,,5,1,2,0,2
27611_0,,,,2,2,1,3
C(C(C=C)(CO)C(CCO)O)=O,,,5,1,3,0,3
27613_0,,,,2,2,1,3
C(C(C(CCO)O)(C(C=C)O)O)=O,,,5,1,2,0,2
27613_1,,,,2,2,1,3
27615_0,,,,2,2,1,3
C(C(C(C)O)(C(CCO)O)O)=O,,,5,1,4,0,4
27615_1,,,,2,2,1,3
27616_0,,,,2,2,1,3
27616_1,,,,2,2,1,3
27617_0,,,,2,2,1,3
27617_1,,,,2,2,1,3
27619_0,,,,2,2,1,3
C(C(C(CCO)O)(C(C=O)O)O)=O,,,5,1,4,0,4
27619_1,,,,2,2,1,3
27621_0,,,,2,2,1,3
C(C(C(CO)O)(C(CCO)O)O)=O,,,5,1,4,0,4
27621_1,,,,2,2,1,3
27622_0,,,,2,2,1,3
27623_0,,,,2,2,1,3
27624_0,,,,2,2,1,3
27624_1,,,,2,2,1,3
27626_0,,,,2,2,1,3
C(C(CO)(C(C=O)O)C(C=C)O)=O,,,5,1,1,0,1
27627_0,,,,2,2,1,3
27628_0,,,,2,2,1,3
27630_0,,,,2,2,1,3
C(C(CO)(CO)C(C=O)O)=O,,,5,1,2,0,2
27632_0,,,,2,2,1,3
C(C(CO)(C(C=O)O)C(C=O)O)=O,,,5,1,1,0,1
27634_0,,,,2,2,1,3
C(C(CO)(C(CO)O)C(C=O)O)=O,,,5,1,2,0,2
27635_0,,,,2,2,1,3
27635_1,,,,2,2,1,3
27637_0,,,,2,2,1,3
C(C(CO)(CO)C(C(C=O)O)O)=O,,,5,1,2,0,2
27639_0,,,,2,2,1,3
C(C(CO)(CO)C(CO)(CO)O)=O,,,5,1,2,0,2
27640_0,,,,2,2,1,3
27641_0,,,,2,2,1,3
27643_0,,,,2,2,1,3
C(C(CO)(CO)C(C)(CO)O)=O,,,5,1,2,0,2
27644_0,,,,2,2,1,3
27645_0,,,,2,2,1,3
27647_0,,,,2,2,1,3
C(C(CO)(CO)C(C=CC)O)=O,,,5,1,2,0,2
27648_0,,,,2,2,1,3
27649_0,,,,2,2,1,3
27651_0,,,,2,2,1,3
C(C(CO)(CO)C(CC=C)O)=O,,,5,1,2,0,2
27653_0,,,,2,2,1,3
C(C(CO)(CO)C(C(CO)O)O)=O,,,5,1,2,0,2
27655_0,,,,2,2,1,3
C(C(CO)(C(CO)O)C(C=C)O)=O,,,5,1,1,0,1
27656_0,,,,2,2,1,3
27657_0,,,,2,2,1,3
27659_0,,,,2,2,1,3
C(C(CO)(CO)C(CO)O)=O,,,5,1,2,0,2
27660_0,,,,2,2,1,3
27662_0,,,,2,2,1,3
C(C(CO)(C(CO)O)C(CO)O)=O,,,5,1,1,0,1
27663_0,,,,2,2,1,3
27664_0,,,,2,2,1,3
27666_0,,,,2,2,1,3
C(C(CO)(CO)C(C(C)O)O)=O,,,5,1,2,0,2
27667_0,,,,2,2,1,3
27668_0,,,,2,2,1,3
27670_0,,,,2,2,1,3
C(C(CO)(CO)C(C(O)=O)O)=O,,,5,1,2,0,2
27672_0,,,,2,2,1,3
C(C(CO)(CO)C(C(C=O)=O)O)=O,,,5,1,1,0,1
27674_0,,,,2,2,1,3
C(C(C=O)(C(C=O)(CO)CO)O)=O,,,5,1,1,0,1
27676_0,,,,2,2,1,3
C(C(CO)(CO)C(C(C)=O)(C)O)=O,,,5,1,1,0,1
27678_0,,,,2,2,1,3
C(C([C](C(O)=O)O)(CO)CO)=O,,,5,1,1,0,1
27680_0,,,,2,2,1,3
C(C(CO)(CO)C(C)(CCO)O)=O,,,5,1,1,0,1
27682_0,,,,2,2,1,3
C(C(CO)(CO)C(C)(CC)O)=O,,,5,1,1,0,1
27684_0,,,,2,2,1,3
C(C(CO)(CO)C(C)(C(C)O)O)=O,,,5,1,1,0,1
27686_0,,,,2,2,1,3
C(C(CO)(CO)C(CO)(CC)O)=O,,,5,1,1,0,1
27688_0,,,,2,2,1,3
C(C(CO)(CO)C(CC=O)O)=O,,,5,1,1,0,1
27690_0,,,,2,2,1,3
C(C(CO)(CO)C([CH]C(O)=O)O)=O,,,5,1,1,0,1
27692_0,,,,2,2,1,3
C(C(C=C)(C(C=O)(CO)CO)O)=O,,,5,1,1,0,1
27694_0,,,,2,2,1,3
C(C(CO)(CO)C(C(C=C)=O)O)=O,,,5,1,1,0,1
27696_0,,,,2,2,1,3
C(C(CO)(CO)C(C=C)O)=O,,,5,1,1,0,1
27698_0,,,,2,2,1,3
C(C(CO)(CO)C(C(CC)O)O)=O,,,5,1,1,0,1
27700_0,,,,2,2,1,3
C(C(CO)(CO)C(CCCO)O)=O,,,5,1,1,0,1
27702_0,,,,2,2,1,3
C(C(CO)(CO)C(C(O)O)O)=O,,,5,1,1,0,1
27703_0,,,,2,2,1,3
27704_0,,,,2,2,1,3
27705_0,,,,2,2,1,3
27706_0,,,,2,2,1,3
27707_0,,,,2,2,1,3
27708_0,,,,2,2,1,3
27709_0,,,,2,2,1,3
27710_0,,,,2,2,1,3
27712_0,,,,2,2,1,3
C(C(CO)(CO)CO)=O,,,5,1,1,0,1
27713_0,,,,2,2,1,3
27714_0,,,,2,2,1,3
27715_0,,,,2,2,1,3
27716_0,,,,2,2,1,3
27717_0,,,,2,2,1,3
27718_0,,,,2,2,1,3
27719_0,,,,2,2,1,3
27720_0,,,,2,2,1,3
27721_0,,,,2,2,1,3
27722_0,,,,2,2,1,3
27723_0,,,,2,2,1,3
27724_0,,,,2,2,1,3
27726_0,,,,2,2,1,3
C(C(C=O)(C(C(CO)CO)O)O)=O,,,5,1,2,0,2
27726_1,,,,2,2,1,3
27727_0,,,,2,2,1,3
27729_0,,,,2,2,1,3
C(C(CO)(C(C(CO)CO)O)O)=O,,,5,1,2,0,2
27729_1,,,,2,2,1,3
27730_0,,,,2,2,1,3
27731_0,,,,2,2,1,3
27733_0,,,,2,2,1,3
C(C(C(CO)(CO)CO)=O)(O)=O,,,5,1,1,0,1
27735_0,,,,2,2,1,3
C(C(C(C(C)=O)=O)(CO)C(C)O)=O,,,5,1,2,0,2
27737_0,,,,2,2,1,3
C(C(C=O)(C(C(C)=O)=O)CO)(O)=O,,,5,1,2,0,2
27738_0,,,,2,2,1,3
27739_0,,,,2,2,1,3
27740_0,,,,2,2,1,3
27742_0,,,,2,2,1,3
C(C(C(C)O)=O)(C(CO)(CO)O)=O,,,5,1,2,0,2
27742_1,,,,2,2,1,3
27744_0,,,,2,2,1,3
C(C(C(C(CO)(CO)O)=O)=O)(O)=O,,,5,1,3,0,3
27744_1,,,,2,2,1,3
27745_0,,,,2,2,1,3
27745_1,,,,2,2,1,3
27746_0,,,,2,2,1,3
27746_1,,,,2,2,1,3
27747_0,,,,2,2,1,3
27747_1,,,,2,2,1,3
27748_0,,,,2,2,1,3
27748_1,,,,2,2,1,3
27749_0,,,,2,2,1,3
27749_1,,,,2,2,1,3
27750_0,,,,2,2,1,3
27750_1,,,,2,2,1,3
27752_0,,,,2,2,1,3
C(C(C(C(C)=O)(C(C=C)O)O)O)=O,,,5,1,2,0,2
27752_1,,,,2,2,1,3
27753_0,,,,2,2,1,3
27753_1,,,,2,2,1,3
27754_0,,,,2,2,1,3
27754_1,,,,2,2,1,3
27755_0,,,,2,2,1,3
27755_1,,,,2,2,1,3
27757_0,,,,2,2,1,3
C(C(C(C(C)=O)(C(C=O)O)O)O)=O,,,5,1,2,0,2
27757_1,,,,2,2,1,3
27758_0,,,,2,2,1,3
27758_1,,,,2,2,1,3
27759_0,,,,2,2,1,3
27759_1,,,,2,2,1,3
27760_0,,,,2,2,1,3
27760_1,,,,2,2,1,3
27761_0,,,,2,2,1,3
27761_1,,,,2,2,1,3
27762_0,,,,2,2,1,3
27762_1,,,,2,2,1,3
27763_0,,,,2,2,1,3
27763_1,,,,2,2,1,3
27764_0,,,,2,2,1,3
27764_1,,,,2,2,1,3
27766_0,,,,2,2,1,3
C(C(C=C)(C(C=C)O)C(C=O)O)=O,,,5,1,1,0,1
27768_0,,,,2,2,1,3
C(C(C=C)(C(C)O)C(C=O)O)=O,,,5,1,3,0,3
27770_0,,,,2,2,1,3
C(C(C=O)(C=C)C(C=O)O)(O)=O,,,5,1,3,0,3
27772_0,,,,2,2,1,3
C(C(C=C)(CO)C(C=O)O)=O,,,5,1,3,0,3
27774_0,,,,2,2,1,3
C(C(C=C)(C(C=O)O)C(C=O)O)=O,,,5,1,1,0,1
27776_0,,,,2,2,1,3
C(C(C=C)(C(C=CC)O)C(C=O)O)=O,,,5,1,2,0,2
27778_0,,,,2,2,1,3
C(C(C=C)(C(CC=C)O)C(C=O)O)=O,,,5,1,2,0,2
27780_0,,,,2,2,1,3
C(C(C=C)(C(CO)O)C(C=O)O)=O,,,5,1,2,0,2
27782_0,,,,2,2,1,3
C(C([C](C(O)=O)O)(C(C=O)O)O)=O,,,5,1,2,0,2
27782_1,,,,2,2,1,3
27784_0,,,,2,2,1,3
C(C(C(C)(CC)O)(C(C=O)O)O)=O,,,5,1,2,0,2
27784_1,,,,2,2,1,3
27785_0,,,,2,2,1,3
27785_1,,,,2,2,1,3
27786_0,,,,2,2,1,3
27786_1,,,,2,2,1,3
27788_0,,,,2,2,1,3
C(C(C(C(O)O)O)(C(C=O)O)O)=O,,,5,1,2,0,2
27788_1,,,,2,2,1,3
27789_0,,,,2,2,1,3
27789_1,,,,2,2,1,3
27790_0,,,,2,2,1,3
27790_1,,,,2,2,1,3
27791_0,,,,2,2,1,3
27791_1,,,,2,2,1,3
27792_0,,,,2,2,1,3
27792_1,,,,2,2,1,3
27793_0,,,,2,2,1,3
27793_1,,,,2,2,1,3
27794_0,,,,2,2,1,3
27794_1,,,,2,2,1,3
27796_0,,,,2,2,1,3
C(C(C(C=O)(C(C=O)O)O)O)=O,,,5,1,2,0,2
27796_1,,,,2,2,1,3
27798_0,,,,2,2,1,3
C(C(C(CO)(C)O)(C(C=O)O)O)=O,,,5,1,4,0,4
27798_1,,,,2,2,1,3
27800_0,,,,2,2,1,3
C(C(C(C=O)(C(C=CC)O)O)O)=O,,,5,1,4,0,4
27800_1,,,,2,2,1,3
27802_0,,,,2,2,1,3
C(C(C(CC=C)O)(C(C=O)O)O)=O,,,5,1,4,0,4
27802_1,,,,2,2,1,3
27803_0,,,,2,2,1,3
27803_1,,,,2,2,1,3
27804_0,,,,2,2,1,3
27804_1,,,,2,2,1,3
27805_0,,,,2,2,1,3
27805_1,,,,2,2,1,3
27807_0,,,,2,2,1,3
C(C(C=O)(C(CC(C=O)O)O)O)=O,,,5,1,2,0,2
27807_1,,,,2,2,1,3
27808_0,,,,2,2,1,3
27810_0,,,,2,2,1,3
C(C(CO)(C(CC(C=O)O)O)O)=O,,,5,1,2,0,2
27810_1,,,,2,2,1,3
27811_0,,,,2,2,1,3
27811_1,,,,2,2,1,3
27812_0,,,,2,2,1,3
27813_0,,,,2,2,1,3
27813_1,,,,2,2,1,3
27814_0,,,,2,2,1,3
27815_0,,,,2,2,1,3
27816_0,,,,2,2,1,3
27817_0,,,,2,2,1,3
27818_0,,,,2,2,1,3
27819_0,,,,2,2,1,3
27820_0,,,,2,2,1,3
27820_1,,,,2,2,1,3
27821_0,,,,2,2,1,3
27821_1,,,,2,2,1,3
27822_0,,,,2,2,1,3
27822_1,,,,2,2,1,3
27823_0,,,,2,2,1,3
27823_1,,,,2,2,1,3
27824_0,,,,2,2,1,3
27824_1,,,,2,2,1,3
27825_0,,,,2,2,1,3
27825_1,,,,2,2,1,3
27826_0,,,,2,2,1,3
27826_1,,,,2,2,1,3
27827_0,,,,2,2,1,3
27827_1,,,,2,2,1,3
27828_0,,,,2,2,1,3
27828_1,,,,2,2,1,3
27830_0,,,,2,2,1,3
C(C(C(C(C(C)=O)(CO)O)O)O)=O,,,5,1,6,0,6
27830_1,,,,2,2,1,3
27831_0,,,,2,2,1,3
27831_1,,,,2,2,1,3
27833_0,,,,2,2,1,3
C(C(C=C)(CO)C(C(C=O)O)O)=O,,,5,1,2,0,2
27834_0,,,,2,2,1,3
27834_1,,,,2,2,1,3
27835_0,,,,2,2,1,3
27835_1,,,,2,2,1,3
27836_0,,,,2,2,1,3
27836_1,,,,2,2,1,3
27837_0,,,,2,2,1,3
27837_1,,,,2,2,1,3
27839_0,,,,2,2,1,3
C(CC(C(C=O)(C(C=C)O)O)O)=O,,,5,1,2,0,2
27839_1,,,,2,2,1,3
27840_0,,,,2,2,1,3
27840_1,,,,2,2,1,3
27841_0,,,,2,2,1,3
27841_1,,,,2,2,1,3
27842_0,,,,2,2,1,3
27842_1,,,,2,2,1,3
27843_0,,,,2,2,1,3
27843_1,,,,2,2,1,3
27844_0,,,,2,2,1,3
27844_1,,,,2,2,1,3
27845_0,,,,2,2,1,3
27845_1,,,,2,2,1,3
27846_0,,,,2,2,1,3
27846_1,,,,2,2,1,3
27847_0,,,,2,2,1,3
27847_1,,,,2,2,1,3
27848_0,,,,2,2,1,3
27848_1,,,,2,2,1,3
27849_0,,,,2,2,1,3
27849_1,,,,2,2,1,3
27850_0,,,,2,2,1,3
27850_1,,,,2,2,1,3
27852_0,,,,2,2,1,3
C(C)(C(CO)(C(CO)(CO)O)O)=O,,,5,1,4,0,4
27852_1,,,,2,2,1,3
27854_0,,,,2,2,1,3
C(C(C=C)(CO)C(CO)(CO)O)=O,,,5,1,2,0,2
27856_0,,,,2,2,1,3
C(C(C(C)O)(C(CO)(CO)O)O)=O,,,5,1,4,0,4
27856_1,,,,2,2,1,3
27857_0,,,,2,2,1,3
27857_1,,,,2,2,1,3
27858_0,,,,2,2,1,3
27858_1,,,,2,2,1,3
27859_0,,,,2,2,1,3
27859_1,,,,2,2,1,3
27860_0,,,,2,2,1,3
27860_1,,,,2,2,1,3
27861_0,,,,2,2,1,3
27861_1,,,,2,2,1,3
27862_0,,,,2,2,1,3
27862_1,,,,2,2,1,3
27863_0,,,,2,2,1,3
27863_1,,,,2,2,1,3
27864_0,,,,2,2,1,3
27864_1,,,,2,2,1,3
27865_0,,,,2,2,1,3
27865_1,,,,2,2,1,3
27867_0,,,,2,2,1,3
C(CO)(C(C(C)O)(C(C=C)O)O)=O,,,5,1,2,0,2
27867_1,,,,2,2,1,3
27868_0,,,,2,2,1,3
27868_1,,,,2,2,1,3
27869_0,,,,2,2,1,3
27869_1,,,,2,2,1,3
27870_0,,,,2,2,1,3
27870_1,,,,2,2,1,3
27871_0,,,,2,2,1,3
27871_1,,,,2,2,1,3
27872_0,,,,2,2,1,3
27872_1,,,,2,2,1,3
27874_0,,,,2,2,1,3
C(C(C(CO)=O)(C(C=C)O)O)(O)=O,,,5,1,2,0,2
27874_1,,,,2,2,1,3
27875_0,,,,2,2,1,3
27875_1,,,,2,2,1,3
27876_0,,,,2,2,1,3
27876_1,,,,2,2,1,3
27877_0,,,,2,2,1,3
27877_1,,,,2,2,1,3
27878_0,,,,2,2,1,3
27878_1,,,,2,2,1,3
27879_0,,,,2,2,1,3
27879_1,,,,2,2,1,3
27880_0,,,,2,2,1,3
27880_1,,,,2,2,1,3
27881_0,,,,2,2,1,3
27881_1,,,,2,2,1,3
27882_0,,,,2,2,1,3
27882_1,,,,2,2,1,3
27884_0,,,,2,2,1,3
C(CO)(C([C](C(O)=O)O)(CO)O)=O,,,5,1,3,0,3
27884_1,,,,2,2,1,3
27886_0,,,,2,2,1,3
C(CO)(C(CO)(C(C)(CC)O)O)=O,,,5,1,2,0,2
27886_1,,,,2,2,1,3
27887_0,,,,2,2,1,3
27887_1,,,,2,2,1,3
27889_0,,,,2,2,1,3
C(CO)(C(CO)(C(C=C)O)O)=O,,,5,1,2,0,2
27889_1,,,,2,2,1,3
27891_0,,,,2,2,1,3
C(CO)(C(CO)(C(C(O)O)O)O)=O,,,5,1,2,0,2
27891_1,,,,2,2,1,3
27892_0,,,,2,2,1,3
27892_1,,,,2,2,1,3
27893_0,,,,2,2,1,3
27893_1,,,,2,2,1,3
27894_0,,,,2,2,1,3
27894_1,,,,2,2,1,3
27895_0,,,,2,2,1,3
27895_1,,,,2,2,1,3
27896_0,,,,2,2,1,3
27896_1,,,,2,2,1,3
27897_0,,,,2,2,1,3
27897_1,,,,2,2,1,3
27898_0,,,,2,2,1,3
27898_1,,,,2,2,1,3
27899_0,,,,2,2,1,3
27899_1,,,,2,2,1,3
27900_0,,,,2,2,1,3
27900_1,,,,2,2,1,3
27901_0,,,,2,2,1,3
27901_1,,,,2,2,1,3
27902_0,,,,2,2,1,3
27902_1,,,,2,2,1,3
27903_0,,,,2,2,1,3
27903_1,,,,2,2,1,3
27904_0,,,,2,2,1,3
27904_1,,,,2,2,1,3
27905_0,,,,2,2,1,3
27905_1,,,,2,2,1,3
27906_0,,,,2,2,1,3
27906_1,,,,2,2,1,3
27908_0,,,,2,2,1,3
C(C)(C(CO)(C(CO)(C)O)O)=O,,,5,1,4,0,4
27908_1,,,,2,2,1,3
27910_0,,,,2,2,1,3
C(C(C=C)(C(C)O)C(C)(CO)O)=O,,,5,1,2,0,2
27912_0,,,,2,2,1,3
C(C(C=O)(C=C)C(C)(CO)O)(O)=O,,,5,1,2,0,2
27914_0,,,,2,2,1,3
C(C(C=C)(CO)C(C)(CO)O)=O,,,5,1,3,0,3
27916_0,,,,2,2,1,3
C(C(C(CO)(C)O)(C(C=C)O)O)=O,,,5,1,2,0,2
27916_1,,,,2,2,1,3
27918_0,,,,2,2,1,3
C(C(C(C)O)(C(CO)(C)O)O)=O,,,5,1,4,0,4
27918_1,,,,2,2,1,3
27919_0,,,,2,2,1,3
27919_1,,,,2,2,1,3
27920_0,,,,2,2,1,3
27920_1,,,,2,2,1,3
27921_0,,,,2,2,1,3
27921_1,,,,2,2,1,3
27922_0,,,,2,2,1,3
27922_1,,,,2,2,1,3
27923_0,,,,2,2,1,3
27924_0,,,,2,2,1,3
27925_0,,,,2,2,1,3
27925_1,,,,2,2,1,3
27926_0,,,,2,2,1,3
27927_0,,,,2,2,1,3
27927_1,,,,2,2,1,3
27928_0,,,,2,2,1,3
27929_0,,,,2,2,1,3
27929_1,,,,2,2,1,3
27931_0,,,,2,2,1,3
C(C)(C(C(C)O)(C(C=CC)O)O)=O,,,5,1,4,0,4
27931_1,,,,2,2,1,3
27933_0,,,,2,2,1,3
C(C(C(C)=O)(C(C=CC)O)O)(O)=O,,,5,1,4,0,4
27933_1,,,,2,2,1,3
27935_0,,,,2,2,1,3
C(C)(C(CO)(C(C=CC)O)O)=O,,,5,1,4,0,4
27935_1,,,,2,2,1,3
27937_0,,,,2,2,1,3
C(C)(C(C(CC=C)O)(C(C)O)O)=O,,,5,1,4,0,4
27937_1,,,,2,2,1,3
27939_0,,,,2,2,1,3
C(C(C(C)=O)(C(CC=C)O)O)(O)=O,,,5,1,4,0,4
27939_1,,,,2,2,1,3
27941_0,,,,2,2,1,3
C(C)(C(CO)(C(CC=C)O)O)=O,,,5,1,4,0,4
27941_1,,,,2,2,1,3
27943_0,,,,2,2,1,3
C(C)(C(CO)(C(C(CO)O)O)O)=O,,,5,1,4,0,4
27943_1,,,,2,2,1,3
27945_0,,,,2,2,1,3
C(C)(C(C(CO)O)(C(C=C)O)O)=O,,,5,1,2,0,2
27945_1,,,,2,2,1,3
27946_0,,,,2,2,1,3
27946_1,,,,2,2,1,3
27947_0,,,,2,2,1,3
27947_1,,,,2,2,1,3
27949_0,,,,2,2,1,3
C(C)(C(CO)(C(CO)O)O)=O,,,5,1,5,0,5
27949_1,,,,2,2,1,3
27950_0,,,,2,2,1,3
27950_1,,,,2,2,1,3
27952_0,,,,2,2,1,3
C(C)(C(C(CO)O)(C(CO)O)O)=O,,,5,1,3,0,3
27952_1,,,,2,2,1,3
27954_0,,,,2,2,1,3
C(C)(C(C(C)O)(C(C(C)O)O)O)=O,,,5,1,4,0,4
27954_1,,,,2,2,1,3
27956_0,,,,2,2,1,3
C(C(C(C)=O)(C(C(C)O)O)O)(O)=O,,,5,1,4,0,4
27956_1,,,,2,2,1,3
27958_0,,,,2,2,1,3
C(C)(C(CO)(C(C(C)O)O)O)=O,,,5,1,4,0,4
27958_1,,,,2,2,1,3
27960_0,,,,2,2,1,3
C(C)(C([C](C(O)=O)O)(C(C)O)O)=O,,,5,1,3,0,3
27960_1,,,,2,2,1,3
27962_0,,,,2,2,1,3
C(C)(C(C(C)O)(C(C)(CC)O)O)=O,,,5,1,2,0,2
27962_1,,,,2,2,1,3
27964_0,,,,2,2,1,3
C(CC(C(C(C)=O)(C(C)O)O)O)=O,,,5,1,2,0,2
27964_1,,,,2,2,1,3
27966_0,,,,2,2,1,3
C(C)(C(C(C)O)(C(C=C)O)O)=O,,,5,1,2,0,2
27966_1,,,,2,2,1,3
27968_0,,,,2,2,1,3
C(C)(C(C(C(O)O)O)(C(C)O)O)=O,,,5,1,2,0,2
27968_1,,,,2,2,1,3
27970_0,,,,2,2,1,3
C(C)(C(C(C)O)(C(C)O)O)=O,,,5,1,2,0,2
27970_1,,,,2,2,1,3
27972_0,,,,2,2,1,3
C(C(C(C)=O)(C(C)O)O)(O)=O,,,5,1,5,0,5
27972_1,,,,2,2,1,3
27973_0,,,,2,2,1,3
27973_1,,,,2,2,1,3
27974_0,,,,2,2,1,3
27974_1,,,,2,2,1,3
27976_0,,,,2,2,1,3
C(C)(C(CO)(C(C)O)O)=O,,,5,1,4,0,4
27976_1,,,,2,2,1,3
27977_0,,,,2,2,1,3
27977_1,,,,2,2,1,3
27978_0,,,,2,2,1,3
27978_1,,,,2,2,1,3
27979_0,,,,2,2,1,3
27979_1,,,,2,2,1,3
27980_0,,,,2,2,1,3
27980_1,,,,2,2,1,3
27981_0,,,,2,2,1,3
27981_1,,,,2,2,1,3
27982_0,,,,2,2,1,3
27982_1,,,,2,2,1,3
27983_0,,,,2,2,1,3
27983_1,,,,2,2,1,3
27984_0,,,,2,2,1,3
27984_1,,,,2,2,1,3
27986_0,,,,2,2,1,3
C(C(C(C)=O)([C](C(O)=O)O)O)(O)=O,,,5,1,3,0,3
27986_1,,,,2,2,1,3
27988_0,,,,2,2,1,3
C(C(C(C)=O)(C(C)(CC)O)O)(O)=O,,,5,1,2,0,2
27988_1,,,,2,2,1,3
27990_0,,,,2,2,1,3
C(CC(C(C(O)=O)(C(C)=O)O)O)=O,,,5,1,2,0,2
27990_1,,,,2,2,1,3
27992_0,,,,2,2,1,3
C(C(C(C)=O)(C(C=C)O)O)(O)=O,,,5,1,2,0,2
27992_1,,,,2,2,1,3
27994_0,,,,2,2,1,3
C(C(C(C)=O)(C(C(O)O)O)O)(O)=O,,,5,1,2,0,2
27994_1,,,,2,2,1,3
27995_0,,,,2,2,1,3
27995_1,,,,2,2,1,3
27997_0,,,,2,2,1,3
C(C(C(O)=O)(C(C)=O)O)(O)=O,,,5,1,3,0,3
27997_1,,,,2,2,1,3
27998_0,,,,2,2,1,3
27998_1,,,,2,2,1,3
27999_0,,,,2,2,1,3
27999_1,,,,2,2,1,3
28001_0,,,,2,2,1,3
C(C(C(C)=O)(CO)O)(O)=O,,,5,1,5,0,5
28001_1,,,,2,2,1,3
28002_0,,,,2,2,1,3
28002_1,,,,2,2,1,3
28003_0,,,,2,2,1,3
28003_1,,,,2,2,1,3
28004_0,,,,2,2,1,3
28004_1,,,,2,2,1,3
28005_0,,,,2,2,1,3
28005_1,,,,2,2,1,3
28006_0,,,,2,2,1,3
28006_1,,,,2,2,1,3
28007_0,,,,2,2,1,3
28007_1,,,,2,2,1,3
28008_0,,,,2,2,1,3
28008_1,,,,2,2,1,3
28009_0,,,,2,2,1,3
28009_1,,,,2,2,1,3
28011_0,,,,2,2,1,3
C(C)(C(CO)(C(CC(C)O)O)O)=O,,,5,1,4,0,4
28011_1,,,,2,2,1,3
28012_0,,,,2,2,1,3
28014_0,,,,2,2,1,3
C(CC(C(C(C)=O)(CO)O)O)(O)=O,,,5,1,4,0,4
28014_1,,,,2,2,1,3
28016_0,,,,2,2,1,3
C(C(CO)(C(C(C)=O)(CO)O)O)=O,,,5,1,6,0,6
28016_1,,,,2,2,1,3
28017_0,,,,2,2,1,3
28017_1,,,,2,2,1,3
28018_0,,,,2,2,1,3
28018_1,,,,2,2,1,3
28020_0,,,,2,2,1,3
C(C(C)(C(C(C)=O)(CO)O)O)=O,,,5,1,5,0,5
28020_1,,,,2,2,1,3
28021_0,,,,2,2,1,3
28021_1,,,,2,2,1,3
28022_0,,,,2,2,1,3
28022_1,,,,2,2,1,3
28023_0,,,,2,2,1,3
28023_1,,,,2,2,1,3
28024_0,,,,2,2,1,3
28024_1,,,,2,2,1,3
28026_0,,,,2,2,1,3
C(C(C=O)(C(C(C)=O)(CO)O)O)=O,,,5,1,6,0,6
28026_1,,,,2,2,1,3
28028_0,,,,2,2,1,3
C(C)(C(CO)(C(C(C)=O)(C)O)O)=O,,,5,1,3,0,3
28028_1,,,,2,2,1,3
28030_0,,,,2,2,1,3
C(C)(C([C](C(O)=O)O)(CO)O)=O,,,5,1,3,0,3
28030_1,,,,2,2,1,3
28032_0,,,,2,2,1,3
C(C)(C(CO)(C(C)(CCO)O)O)=O,,,5,1,2,0,2
28032_1,,,,2,2,1,3
28034_0,,,,2,2,1,3
C(C)(C(CO)(C(C)(CC)O)O)=O,,,5,1,2,0,2
28034_1,,,,2,2,1,3
28036_0,,,,2,2,1,3
C(C)(C(CO)(C(C)(C(C)O)O)O)=O,,,5,1,2,0,2
28036_1,,,,2,2,1,3
28038_0,,,,2,2,1,3
C(C)(C(CO)(C(CO)(CC)O)O)=O,,,5,1,2,0,2
28038_1,,,,2,2,1,3
28040_0,,,,2,2,1,3
C(CC(C(C(C)=O)(CO)O)O)=O,,,5,1,2,0,2
28040_1,,,,2,2,1,3
28042_0,,,,2,2,1,3
C(C)(C(CO)(C([CH]C(O)=O)O)O)=O,,,5,1,2,0,2
28042_1,,,,2,2,1,3
28044_0,,,,2,2,1,3
C(C(C=C)(C(C(C)=O)(CO)O)O)=O,,,5,1,2,0,2
28044_1,,,,2,2,1,3
28046_0,,,,2,2,1,3
C(C)(C(CO)(C(C(C=C)=O)O)O)=O,,,5,1,2,0,2
28046_1,,,,2,2,1,3
28048_0,,,,2,2,1,3
C(C)(C(CO)(C(C=C)O)O)=O,,,5,1,2,0,2
28048_1,,,,2,2,1,3
28050_0,,,,2,2,1,3
C(C)(C(CO)(C(C(CC)O)O)O)=O,,,5,1,2,0,2
28050_1,,,,2,2,1,3
28052_0,,,,2,2,1,3
C(C)(C(CO)(C(CCCO)O)O)=O,,,5,1,2,0,2
28052_1,,,,2,2,1,3
28054_0,,,,2,2,1,3
C(C)(C(CO)(C(C(O)O)O)O)=O,,,5,1,2,0,2
28054_1,,,,2,2,1,3
28055_0,,,,2,2,1,3
28055_1,,,,2,2,1,3
28056_0,,,,2,2,1,3
28056_1,,,,2,2,1,3
28057_0,,,,2,2,1,3
28057_1,,,,2,2,1,3
28058_0,,,,2,2,1,3
28058_1,,,,2,2,1,3
28059_0,,,,2,2,1,3
28059_1,,,,2,2,1,3
28060_0,,,,2,2,1,3
28060_1,,,,2,2,1,3
28061_0,,,,2,2,1,3
28061_1,,,,2,2,1,3
28062_0,,,,2,2,1,3
28062_1,,,,2,2,1,3
28064_0,,,,2,2,1,3
C(C)(C(CO)(CO)O)=O,,,5,1,2,0,2
28064_1,,,,2,2,1,3
28065_0,,,,2,2,1,3
28065_1,,,,2,2,1,3
28066_0,,,,2,2,1,3
28066_1,,,,2,2,1,3
28067_0,,,,2,2,1,3
28067_1,,,,2,2,1,3
28068_0,,,,2,2,1,3
28068_1,,,,2,2,1,3
28069_0,,,,2,2,1,3
28069_1,,,,2,2,1,3
28070_0,,,,2,2,1,3
28070_1,,,,2,2,1,3
28071_0,,,,2,2,1,3
28071_1,,,,2,2,1,3
28072_0,,,,2,2,1,3
28072_1,,,,2,2,1,3
28073_0,,,,2,2,1,3
28073_1,,,,2,2,1,3
28074_0,,,,2,2,1,3
28074_1,,,,2,2,1,3
28075_0,,,,2,2,1,3
28075_1,,,,2,2,1,3
28076_0,,,,2,2,1,3
28076_1,,,,2,2,1,3
28078_0,,,,2,2,1,3
C(C(C=O)(C(C)(C(CO)O)O)O)=O,,,5,1,2,0,2
28078_1,,,,2,2,1,3
28079_0,,,,2,2,1,3
28081_0,,,,2,2,1,3
C(C(CO)(C(C)(C(CO)O)O)O)=O,,,5,1,2,0,2
28081_1,,,,2,2,1,3
28082_0,,,,2,2,1,3
28083_0,,,,2,2,1,3
28084_0,,,,2,2,1,3
28085_0,,,,2,2,1,3
28086_0,,,,2,2,1,3
28087_0,,,,2,2,1,3
28088_0,,,,2,2,1,3
28090_0,,,,2,2,1,3
C(C(C=C)(C(C=CC)O)C(C=C)O)=O,,,5,1,1,0,1
28092_0,,,,2,2,1,3
C(C(C=C)(C(C)O)C(C=CC)O)=O,,,5,1,2,0,2
28094_0,,,,2,2,1,3
C(C(C(O)=O)(C=C)C(C=CC)O)=O,,,5,1,2,0,2
28096_0,,,,2,2,1,3
C(C(C=C)(CO)C(C=CC)O)=O,,,5,1,3,0,3
28097_0,,,,2,2,1,3
28099_0,,,,2,2,1,3
C(C(C(C=CC)O)(C(C=C)O)O)=O,,,5,1,2,0,2
28099_1,,,,2,2,1,3
28101_0,,,,2,2,1,3
C(C(C(C)O)(C(C=CC)O)O)=O,,,5,1,4,0,4
28101_1,,,,2,2,1,3
28102_0,,,,2,2,1,3
28102_1,,,,2,2,1,3
28103_0,,,,2,2,1,3
28103_1,,,,2,2,1,3
28104_0,,,,2,2,1,3
28104_1,,,,2,2,1,3
28106_0,,,,2,2,1,3
C(C(C(CO)O)(C(C=CC)O)O)=O,,,5,1,4,0,4
28106_1,,,,2,2,1,3
28107_0,,,,2,2,1,3
28108_0,,,,2,2,1,3
28109_0,,,,2,2,1,3
28109_1,,,,2,2,1,3
28111_0,,,,2,2,1,3
C(C(C=C)(C(CC=C)O)C(C=C)O)=O,,,5,1,1,0,1
28113_0,,,,2,2,1,3
C(C(C=C)(C(CC=C)O)C(C)O)=O,,,5,1,2,0,2
28115_0,,,,2,2,1,3
C(C(C(O)=O)(C=C)C(CC=C)O)=O,,,5,1,2,0,2
28117_0,,,,2,2,1,3
C(C(C=C)(CO)C(CC=C)O)=O,,,5,1,3,0,3
28118_0,,,,2,2,1,3
28120_0,,,,2,2,1,3
C(C(C(CC=C)O)(C(C=C)O)O)=O,,,5,1,2,0,2
28120_1,,,,2,2,1,3
28122_0,,,,2,2,1,3
C(C(C(CC=C)O)(C(C)O)O)=O,,,5,1,4,0,4
28122_1,,,,2,2,1,3
28123_0,,,,2,2,1,3
28123_1,,,,2,2,1,3
28124_0,,,,2,2,1,3
28124_1,,,,2,2,1,3
28125_0,,,,2,2,1,3
28125_1,,,,2,2,1,3
28127_0,,,,2,2,1,3
C(C(C(CC=C)O)(C(CO)O)O)=O,,,5,1,4,0,4
28127_1,,,,2,2,1,3
28128_0,,,,2,2,1,3
28129_0,,,,2,2,1,3
28130_0,,,,2,2,1,3
28130_1,,,,2,2,1,3
28132_0,,,,2,2,1,3
C(C(C=C)(CO)C(C(CO)O)O)=O,,,5,1,2,0,2
28134_0,,,,2,2,1,3
C(C(C=C)(C(CO)O)C(C=C)O)=O,,,5,1,1,0,1
28136_0,,,,2,2,1,3
C(C(C=C)(C(CO)O)C(C)O)=O,,,5,1,3,0,3
28138_0,,,,2,2,1,3
C(C(C=O)(C=C)C(CO)O)(O)=O,,,5,1,3,0,3
28140_0,,,,2,2,1,3
C(C(C=C)(CO)C(CO)O)=O,,,5,1,3,0,3
28141_0,,,,2,2,1,3
28143_0,,,,2,2,1,3
C(C(C=C)(C(CO)O)C(CO)O)=O,,,5,1,1,0,1
28145_0,,,,2,2,1,3
C(C(C=C)(C(C)O)C(C(C)O)O)=O,,,5,1,2,0,2
28147_0,,,,2,2,1,3
C(C(C=O)(C=C)C(C(C)O)O)(O)=O,,,5,1,2,0,2
28149_0,,,,2,2,1,3
C(C(C=C)(CO)C(C(C)O)O)=O,,,5,1,3,0,3
28151_0,,,,2,2,1,3
C(C(C=C)(C(C)O)C(C(O)=O)O)=O,,,5,1,2,0,2
28153_0,,,,2,2,1,3
C(C(C=O)(C=C)C(C(O)=O)O)(O)=O,,,5,1,2,0,2
28155_0,,,,2,2,1,3
C(C(C=C)(CO)C(C(O)=O)O)=O,,,5,1,3,0,3
28157_0,,,,2,2,1,3
C(C(C=C)([C](C(O)=O)O)C(C)O)=O,,,5,1,1,0,1
28159_0,,,,2,2,1,3
C(C(C=C)(C(C)O)C(C)(CC)O)=O,,,5,1,1,0,1
28161_0,,,,2,2,1,3
C(C(C=C)(C(CC=O)O)C(C)O)=O,,,5,1,1,0,1
28163_0,,,,2,2,1,3
C(C(C=C)(C(C)O)C(C=O)(C=C)O)=O,,,5,1,1,0,1
28165_0,,,,2,2,1,3
C(C(C=C)(C(C)O)C(C(C=C)=O)O)=O,,,5,1,1,0,1
28167_0,,,,2,2,1,3
C(C(C=C)(C(C)O)C(C=C)O)=O,,,5,1,1,0,1
28169_0,,,,2,2,1,3
C(C(C=C)(C(C(O)O)O)C(C)O)=O,,,5,1,1,0,1
28171_0,,,,2,2,1,3
C(C(C=C)(C(C)O)C(C)O)=O,,,5,1,2,0,2
28173_0,,,,2,2,1,3
C(C(C=O)(C=C)C(C)O)(O)=O,,,5,1,3,0,3
28175_0,,,,2,2,1,3
C(C(C=C)(C(C)O)C(C=O)(C)O)=O,,,5,1,2,0,2
28177_0,,,,2,2,1,3
C(C(C=C)(C(C)O)C(C(C)=O)O)=O,,,5,1,2,0,2
28179_0,,,,2,2,1,3
C(C(C=C)(CO)C(C)O)=O,,,5,1,3,0,3
28180_0,,,,2,2,1,3
28181_0,,,,2,2,1,3
28182_0,,,,2,2,1,3
28183_0,,,,2,2,1,3
28184_0,,,,2,2,1,3
28185_0,,,,2,2,1,3
28186_0,,,,2,2,1,3
28187_0,,,,2,2,1,3
28189_0,,,,2,2,1,3
C(C(C(O)=O)(C=C)[C](C(O)=O)O)=O,,,5,1,1,0,1
28191_0,,,,2,2,1,3
C(C(C=O)(C=C)C(C)(CC)O)(O)=O,,,5,1,1,0,1
28193_0,,,,2,2,1,3
C(C(C=O)(C=C)C(CC=O)O)(O)=O,,,5,1,1,0,1
28195_0,,,,2,2,1,3
C(C(C(O)=O)(C=C)C(C=O)(C=C)O)=O,,,5,1,1,0,1
28197_0,,,,2,2,1,3
C(C(C(O)=O)(C=C)C(C(C=C)=O)O)=O,,,5,1,1,0,1
28199_0,,,,2,2,1,3
C(C(C(O)=O)(C=C)C(C=C)O)=O,,,5,1,1,0,1
28201_0,,,,2,2,1,3
C(C(C=O)(C=C)C(C(O)O)O)(O)=O,,,5,1,1,0,1
28202_0,,,,2,2,1,3
28204_0,,,,2,2,1,3
C(C(C(O)=O)(C(O)=O)C=C)=O,,,5,1,2,0,2
28206_0,,,,2,2,1,3
C(C(C=O)(C=C)C(C=O)(C)O)(O)=O,,,5,1,2,0,2
28208_0,,,,2,2,1,3
C(C(C=O)(C=C)C(C(C)=O)O)(O)=O,,,5,1,2,0,2
28210_0,,,,2,2,1,3
C(C(C=O)(C=C)CO)(O)=O,,,5,1,3,0,3
28211_0,,,,2,2,1,3
28212_0,,,,2,2,1,3
28213_0,,,,2,2,1,3
28214_0,,,,2,2,1,3
28215_0,,,,2,2,1,3
28216_0,,,,2,2,1,3
28217_0,,,,2,2,1,3
28218_0,,,,2,2,1,3
28220_0,,,,2,2,1,3
C(C(C=C)(CO)C(CC(C)O)O)=O,,,5,1,2,0,2
28221_0,,,,2,2,1,3
28223_0,,,,2,2,1,3
C(C(C=C)(CO)C(CC(O)=O)O)=O,,,5,1,2,0,2
28225_0,,,,2,2,1,3
C(C(C=C)(CO)C(C(CO)=O)O)=O,,,5,1,2,0,2
28227_0,,,,2,2,1,3
C(C(C=C)(CO)C(C=O)(CO)O)=O,,,5,1,2,0,2
28229_0,,,,2,2,1,3
C(C(C)(C(C=O)(C=C)C(C=C)O)O)=O,,,5,1,1,0,1
28230_0,,,,2,2,1,3
28231_0,,,,2,2,1,3
28233_0,,,,2,2,1,3
C(C(C=C)(CO)C(C=O)(C)O)=O,,,5,1,3,0,3
28235_0,,,,2,2,1,3
C(C(C=C)(C(C=C)O)C(C(C)=O)O)=O,,,5,1,1,0,1
28236_0,,,,2,2,1,3
28237_0,,,,2,2,1,3
28239_0,,,,2,2,1,3
C(C(C=C)(CO)C(C(C)=O)O)=O,,,5,1,3,0,3
28241_0,,,,2,2,1,3
C(C(C=C)(CO)C(C(C=O)=O)O)=O,,,5,1,1,0,1
28243_0,,,,2,2,1,3
C(C(C=C)(CO)C(C=O)(C=O)O)=O,,,5,1,1,0,1
28245_0,,,,2,2,1,3
C(C(C=C)(CO)C(C(C)=O)(C=C)O)=O,,,5,1,1,0,1
28247_0,,,,2,2,1,3
C(C(C=C)(CO)C(C(C=C)=O)(C)O)=O,,,5,1,1,0,1
28249_0,,,,2,2,1,3
C(C(C=C)(CO)C(C(C)=O)(C)O)=O,,,5,1,1,0,1
28251_0,,,,2,2,1,3
C(C(C=C)([C](C(O)=O)O)CO)=O,,,5,1,1,0,1
28253_0,,,,2,2,1,3
C(C(C=C)(CO)C(C)(CCO)O)=O,,,5,1,1,0,1
28255_0,,,,2,2,1,3
C(C(C=C)(CO)C(C)(CC)O)=O,,,5,1,1,0,1
28257_0,,,,2,2,1,3
C(C(C=C)(CO)C(C)(C(C)O)O)=O,,,5,1,1,0,1
28259_0,,,,2,2,1,3
C(C(C=C)(CO)C(CO)(CC)O)=O,,,5,1,1,0,1
28261_0,,,,2,2,1,3
C(C(C=C)(CO)C(CC=O)O)=O,,,5,1,1,0,1
28263_0,,,,2,2,1,3
C(C(C=C)(CO)C([CH]C(O)=O)O)=O,,,5,1,1,0,1
28265_0,,,,2,2,1,3
C(C(C=C)(CO)C(C=C(C=O)C)O)=O,,,5,1,1,0,1
28267_0,,,,2,2,1,3
C(C(C=C)(CO)C(C(C)=CC=O)O)=O,,,5,1,1,0,1
28269_0,,,,2,2,1,3
C(C(C=C)(CO)C(CC(C=O)=C)O)=O,,,5,1,1,0,1
28271_0,,,,2,2,1,3
C(C(C=C)(CO)C(C(CC=O)=C)O)=O,,,5,1,1,0,1
28273_0,,,,2,2,1,3
C(C(C=C)(CO)C(C=CC(C)=O)O)=O,,,5,1,1,0,1
28275_0,,,,2,2,1,3
C(C(C=C)(CO)C(C=CC=O)(C)O)=O,,,5,1,1,0,1
28277_0,,,,2,2,1,3
C(C(C=C)(CO)C(C=O)(C=C)O)=O,,,5,1,1,0,1
28279_0,,,,2,2,1,3
C(C(C=C)(CO)C(C(C=C)=O)O)=O,,,5,1,1,0,1
28281_0,,,,2,2,1,3
C(C(C=C)(CO)C(C=O)(CC=C)O)=O,,,5,1,1,0,1
28283_0,,,,2,2,1,3
C(C(C=C)(CO)C(C(CC=C)=O)O)=O,,,5,1,1,0,1
28285_0,,,,2,2,1,3
C(C(C=C)(CO)C(C=O)(C=CC)O)=O,,,5,1,1,0,1
28287_0,,,,2,2,1,3
C(C(C=C)(CO)C(C(C=CC)=O)O)=O,,,5,1,1,0,1
28289_0,,,,2,2,1,3
C(C(C=C)(CO)C(C=C)O)=O,,,5,1,1,0,1
28291_0,,,,2,2,1,3
C(C(C=C)(CO)C(C(CC)O)O)=O,,,5,1,1,0,1
28293_0,,,,2,2,1,3
C(C(C=C)(CO)C(CCCO)O)=O,,,5,1,1,0,1
28295_0,,,,2,2,1,3
C(C(C=C)(CO)C(C(O)O)O)=O,,,5,1,1,0,1
28296_0,,,,2,2,1,3
28297_0,,,,2,2,1,3
28298_0,,,,2,2,1,3
28299_0,,,,2,2,1,3
28300_0,,,,2,2,1,3
28301_0,,,,2,2,1,3
28302_0,,,,2,2,1,3
28303_0,,,,2,2,1,3
28305_0,,,,2,2,1,3
C(C(C=C)(CO)CO)=O,,,5,1,2,0,2
28306_0,,,,2,2,1,3
28307_0,,,,2,2,1,3
28308_0,,,,2,2,1,3
28309_0,,,,2,2,1,3
28310_0,,,,2,2,1,3
28311_0,,,,2,2,1,3
28312_0,,,,2,2,1,3
28313_0,,,,2,2,1,3
28314_0,,,,2,2,1,3
28315_0,,,,2,2,1,3
28316_0,,,,2,2,1,3
28318_0,,,,2,2,1,3
C(C(C=C)(CO)C(C(O)=O)(C)O)=O,,,5,1,2,0,2
28320_0,,,,2,2,1,3
C(C(C=O)(C(C(C=C)CO)O)O)=O,,,5,1,2,0,2
28320_1,,,,2,2,1,3
28321_0,,,,2,2,1,3
28323_0,,,,2,2,1,3
C(C(C(C(C=C)CO)O)(CO)O)=O,,,5,1,2,0,2
28323_1,,,,2,2,1,3
28324_0,,,,2,2,1,3
28326_0,,,,2,2,1,3
C=CC(C(C(O)=O)=O)(CO)C(C)O,,,5,1,2,0,2
28328_0,,,,2,2,1,3
C(C(C=C)(C(C(O)=O)=O)CO)(O)=O,,,5,1,2,0,2
28329_0,,,,2,2,1,3
28330_0,,,,2,2,1,3
28332_0,,,,2,2,1,3
C=CC(C(C(O)=O)=O)(CO)CO,,,5,1,2,0,2
28334_0,,,,2,2,1,3
C(C(C(C(O)=O)=C)(CO)C(C)O)=O,,,5,1,2,0,2
28336_0,,,,2,2,1,3
C(C(C=O)(C(C(O)=O)=C)CO)(O)=O,,,5,1,2,0,2
28337_0,,,,2,2,1,3
28338_0,,,,2,2,1,3
28340_0,,,,2,2,1,3
C(C(C(C(O)=O)=C)(CO)CO)=O,,,5,1,2,0,2
28342_0,,,,2,2,1,3
C(C(C(C)O)(C(C(CO)O)O)O)=O,,,5,1,5,0,5
28342_1,,,,2,2,1,3
28343_0,,,,2,2,1,3
28343_1,,,,2,2,1,3
28344_0,,,,2,2,1,3
28344_1,,,,2,2,1,3
28346_0,,,,2,2,1,3
C(C([C](C(O)=O)O)(C(CO)O)O)=O,,,5,1,3,0,3
28346_1,,,,2,2,1,3
28348_0,,,,2,2,1,3
C(C(C(CO)O)(C(C)(CC)O)O)=O,,,5,1,2,0,2
28348_1,,,,2,2,1,3
28349_0,,,,2,2,1,3
28349_1,,,,2,2,1,3
28351_0,,,,2,2,1,3
C(C(C(CO)O)(C(C=C)O)O)=O,,,5,1,2,0,2
28351_1,,,,2,2,1,3
28353_0,,,,2,2,1,3
C(C(C(C(O)O)O)(C(CO)O)O)=O,,,5,1,2,0,2
28353_1,,,,2,2,1,3
28355_0,,,,2,2,1,3
C(C(C(CO)O)(C(C)O)O)=O,,,5,1,4,0,4
28355_1,,,,2,2,1,3
28356_0,,,,2,2,1,3
28356_1,,,,2,2,1,3
28357_0,,,,2,2,1,3
28357_1,,,,2,2,1,3
28358_0,,,,2,2,1,3
28358_1,,,,2,2,1,3
28359_0,,,,2,2,1,3
28359_1,,,,2,2,1,3
28360_0,,,,2,2,1,3
28360_1,,,,2,2,1,3
28361_0,,,,2,2,1,3
28361_1,,,,2,2,1,3
28362_0,,,,2,2,1,3
28362_1,,,,2,2,1,3
28363_0,,,,2,2,1,3
28363_1,,,,2,2,1,3
28364_0,,,,2,2,1,3
28364_1,,,,2,2,1,3
28365_0,,,,2,2,1,3
28365_1,,,,2,2,1,3
28366_0,,,,2,2,1,3
28366_1,,,,2,2,1,3
28367_0,,,,2,2,1,3
28367_1,,,,2,2,1,3
28369_0,,,,2,2,1,3
C(C(C=O)(C(CC(CO)O)O)O)=O,,,5,1,2,0,2
28369_1,,,,2,2,1,3
28371_0,,,,2,2,1,3
C(C(CO)C(CC(CO)O)O)(O)=O,,,5,1,1,0,1
28373_0,,,,2,2,1,3
C(C(CO)(C(CC(CO)O)O)O)=O,,,5,1,2,0,2
28373_1,,,,2,2,1,3
28374_0,,,,2,2,1,3
28375_0,,,,2,2,1,3
28376_0,,,,2,2,1,3
28377_0,,,,2,2,1,3
28378_0,,,,2,2,1,3
28379_0,,,,2,2,1,3
28380_0,,,,2,2,1,3
28380_1,,,,2,2,1,3
28381_0,,,,2,2,1,3
28381_1,,,,2,2,1,3
28382_0,,,,2,2,1,3
28382_1,,,,2,2,1,3
28383_0,,,,2,2,1,3
28383_1,,,,2,2,1,3
28385_0,,,,2,2,1,3
C(C(C(C(C)O)O)(C(C=C)O)O)=O,,,5,1,2,0,2
28385_1,,,,2,2,1,3
28387_0,,,,2,2,1,3
C(C(C(C)O)(C(C(C)O)O)O)=O,,,5,1,5,0,5
28387_1,,,,2,2,1,3
28388_0,,,,2,2,1,3
28388_1,,,,2,2,1,3
28389_0,,,,2,2,1,3
28389_1,,,,2,2,1,3
28390_0,,,,2,2,1,3
28390_1,,,,2,2,1,3
28391_0,,,,2,2,1,3
28391_1,,,,2,2,1,3
28392_0,,,,2,2,1,3
28392_1,,,,2,2,1,3
28393_0,,,,2,2,1,3
28393_1,,,,2,2,1,3
28394_0,,,,2,2,1,3
28394_1,,,,2,2,1,3
28395_0,,,,2,2,1,3
28395_1,,,,2,2,1,3
28396_0,,,,2,2,1,3
28396_1,,,,2,2,1,3
28397_0,,,,2,2,1,3
28397_1,,,,2,2,1,3
28399_0,,,,2,2,1,3
C(C(C(C=O)(C(C=C)O)O)O)(O)=O,,,5,1,3,0,3
28399_1,,,,2,2,1,3
28401_0,,,,2,2,1,3
C(C(C(C)O)(C(C(O)=O)O)O)=O,,,5,1,5,0,5
28401_1,,,,2,2,1,3
28402_0,,,,2,2,1,3
28402_1,,,,2,2,1,3
28403_0,,,,2,2,1,3
28403_1,,,,2,2,1,3
28404_0,,,,2,2,1,3
28404_1,,,,2,2,1,3
28405_0,,,,2,2,1,3
28405_1,,,,2,2,1,3
28406_0,,,,2,2,1,3
28406_1,,,,2,2,1,3
28408_0,,,,2,2,1,3
C(C(C=O)(C(C=O)(C(C)O)O)O)=O,,,5,1,6,0,6
28408_1,,,,2,2,1,3
28410_0,,,,2,2,1,3
C(C(C(C)O)(C(C(C)=O)(C)O)O)=O,,,5,1,3,0,3
28410_1,,,,2,2,1,3
28412_0,,,,2,2,1,3
C(C([C](C(O)=O)O)(C(C)O)O)=O,,,5,1,3,0,3
28412_1,,,,2,2,1,3
28414_0,,,,2,2,1,3
C(C(C(C)O)(C(C)(CCO)O)O)=O,,,5,1,2,0,2
28414_1,,,,2,2,1,3
28416_0,,,,2,2,1,3
C(C(C(C)O)(C(C)(CC)O)O)=O,,,5,1,2,0,2
28416_1,,,,2,2,1,3
28418_0,,,,2,2,1,3
C(C(C(C)O)(C(C)(C(C)O)O)O)=O,,,5,1,2,0,2
28418_1,,,,2,2,1,3
28420_0,,,,2,2,1,3
C(C(C(C)O)(C(CO)(CC)O)O)=O,,,5,1,2,0,2
28420_1,,,,2,2,1,3
28421_0,,,,2,2,1,3
28421_1,,,,2,2,1,3
28423_0,,,,2,2,1,3
C(C(C(C)O)(C([CH]C(O)=O)O)O)=O,,,5,1,2,0,2
28423_1,,,,2,2,1,3
28425_0,,,,2,2,1,3
C(C(C=C)(C(C=O)(C(C)O)O)O)=O,,,5,1,2,0,2
28425_1,,,,2,2,1,3
28427_0,,,,2,2,1,3
C(C(C(C)O)(C(C(C=C)=O)O)O)=O,,,5,1,2,0,2
28427_1,,,,2,2,1,3
28429_0,,,,2,2,1,3
C(C(C(C)O)(C(C=C)O)O)=O,,,5,1,2,0,2
28429_1,,,,2,2,1,3
28431_0,,,,2,2,1,3
C(C(C(C)O)(C(C(CC)O)O)O)=O,,,5,1,2,0,2
28431_1,,,,2,2,1,3
28433_0,,,,2,2,1,3
C(C(C(C)O)(C(CCCO)O)O)=O,,,5,1,2,0,2
28433_1,,,,2,2,1,3
28435_0,,,,2,2,1,3
C(C(C(C(O)O)O)(C(C)O)O)=O,,,5,1,2,0,2
28435_1,,,,2,2,1,3
28437_0,,,,2,2,1,3
C(C(C(C)O)(C(C)O)O)=O,,,5,1,3,0,3
28437_1,,,,2,2,1,3
28438_0,,,,2,2,1,3
28438_1,,,,2,2,1,3
28440_0,,,,2,2,1,3
C(C(C(C)O)(C(CC(C)O)O)O)=O,,,5,1,4,0,4
28440_1,,,,2,2,1,3
28442_0,,,,2,2,1,3
C(C(C(CC(O)=O)O)(C(C)O)O)=O,,,5,1,4,0,4
28442_1,,,,2,2,1,3
28443_0,,,,2,2,1,3
28443_1,,,,2,2,1,3
28445_0,,,,2,2,1,3
C(C(C(C)O)(C(C=O)(CO)O)O)=O,,,5,1,6,0,6
28445_1,,,,2,2,1,3
28447_0,,,,2,2,1,3
C(C(C(C)O)(C(C=O)(C)O)O)=O,,,5,1,5,0,5
28447_1,,,,2,2,1,3
28448_0,,,,2,2,1,3
28448_1,,,,2,2,1,3
28449_0,,,,2,2,1,3
28449_1,,,,2,2,1,3
28450_0,,,,2,2,1,3
28450_1,,,,2,2,1,3
28451_0,,,,2,2,1,3
28451_1,,,,2,2,1,3
28452_0,,,,2,2,1,3
28452_1,,,,2,2,1,3
28453_0,,,,2,2,1,3
28453_1,,,,2,2,1,3
28454_0,,,,2,2,1,3
28454_1,,,,2,2,1,3
28455_0,,,,2,2,1,3
28455_1,,,,2,2,1,3
28456_0,,,,2,2,1,3
28456_1,,,,2,2,1,3
28457_0,,,,2,2,1,3
28457_1,,,,2,2,1,3
28458_0,,,,2,2,1,3
28458_1,,,,2,2,1,3
28459_0,,,,2,2,1,3
28459_1,,,,2,2,1,3
28460_0,,,,2,2,1,3
28460_1,,,,2,2,1,3
28462_0,,,,2,2,1,3
C(C(C)(C(C=O)(C(C)O)O)O)(O)=O,,,5,1,5,0,5
28462_1,,,,2,2,1,3
28464_0,,,,2,2,1,3
C(C(C=O)(C(C(C(C)O)O)O)O)=O,,,5,1,2,0,2
28464_1,,,,2,2,1,3
28466_0,,,,2,2,1,3
C(C(CO)C(C(C(C)O)O)O)(O)=O,,,5,1,2,0,2
28468_0,,,,2,2,1,3
C(C(CO)(C(C(C(C)O)O)O)O)=O,,,5,1,2,0,2
28468_1,,,,2,2,1,3
28469_0,,,,2,2,1,3
28469_1,,,,2,2,1,3
28470_0,,,,2,2,1,3
28470_1,,,,2,2,1,3
28471_0,,,,2,2,1,3
28471_1,,,,2,2,1,3
28472_0,,,,2,2,1,3
28473_0,,,,2,2,1,3
28474_0,,,,2,2,1,3
28475_0,,,,2,2,1,3
28475_1,,,,2,2,1,3
28476_0,,,,2,2,1,3
28476_1,,,,2,2,1,3
28477_0,,,,2,2,1,3
28477_1,,,,2,2,1,3
28478_0,,,,2,2,1,3
28478_1,,,,2,2,1,3
28479_0,,,,2,2,1,3
28479_1,,,,2,2,1,3
28480_0,,,,2,2,1,3
28480_1,,,,2,2,1,3
28482_0,,,,2,2,1,3
C(C(C)(C(C=O)(C(C=C)O)O)O)=O,,,5,1,3,0,3
28482_1,,,,2,2,1,3
28483_0,,,,2,2,1,3
28483_1,,,,2,2,1,3
28484_0,,,,2,2,1,3
28484_1,,,,2,2,1,3
28485_0,,,,2,2,1,3
28485_1,,,,2,2,1,3
28486_0,,,,2,2,1,3
28486_1,,,,2,2,1,3
28487_0,,,,2,2,1,3
28487_1,,,,2,2,1,3
28488_0,,,,2,2,1,3
28488_1,,,,2,2,1,3
28489_0,,,,2,2,1,3
28489_1,,,,2,2,1,3
28490_0,,,,2,2,1,3
28490_1,,,,2,2,1,3
28491_0,,,,2,2,1,3
28491_1,,,,2,2,1,3
28493_0,,,,2,2,1,3
C1(C(C(CO)(C(C)O1)C(C)O)=O)=O,,,5,1,2,0,2
28495_0,,,,2,2,1,3
C(C1(C(C(OC1C)=O)=O)CO)(O)=O,,,5,1,2,0,2
28496_0,,,,2,2,1,3
28497_0,,,,2,2,1,3
28499_0,,,,2,2,1,3
C1(C(C(CO)(CO)C(C)O1)=O)=O,,,5,1,2,0,2
28500_0,,,,2,2,1,3
28502_0,,,,2,2,1,3
C1(C(C(C(O1)=O)=O)(CO)C(C)O)=O,,,5,1,2,0,2
28504_0,,,,2,2,1,3
C1(C(C(O)=O)(C(C(O1)=O)=O)CO)=O,,,5,1,2,0,2
28505_0,,,,2,2,1,3
28506_0,,,,2,2,1,3
28508_0,,,,2,2,1,3
C1(C(C(C(O1)=O)=O)(CO)CO)=O,,,5,1,2,0,2
28509_0,,,,2,2,1,3
28510_0,,,,2,2,1,3
28512_0,,,,2,2,1,3
C(C(CO)(CO)C[CH]C(O)=O)=O,,,5,1,2,0,2
28513_0,,,,2,2,1,3
28514_0,,,,2,2,1,3
28516_0,,,,2,2,1,3
C(C(CCC(O)=O)(CO)CO)=O,,,5,1,2,0,2
28517_0,,,,2,2,1,3
28518_0,,,,2,2,1,3
28519_0,,,,2,2,1,3
28519_1,,,,2,2,1,3
28520_0,,,,2,2,1,3
28521_0,,,,2,2,1,3
28522_0,,,,2,2,1,3
28522_1,,,,2,2,1,3
28523_0,,,,2,2,1,3
28523_1,,,,2,2,1,3
28525_0,,,,2,2,1,3
C(C(C(CO)O)(C(C=C)O)O)(O)=O,,,5,1,4,0,4
28525_1,,,,2,2,1,3
28526_0,,,,2,2,1,3
28526_1,,,,2,2,1,3
28527_0,,,,2,2,1,3
28527_1,,,,2,2,1,3
28528_0,,,,2,2,1,3
28528_1,,,,2,2,1,3
28529_0,,,,2,2,1,3
28529_1,,,,2,2,1,3
28530_0,,,,2,2,1,3
28530_1,,,,2,2,1,3
28532_0,,,,2,2,1,3
C(C(C(C(C(C)=O)=O)(CO)O)=O)=O,,,5,1,2,0,2
28532_1,,,,2,2,1,3
28533_0,,,,2,2,1,3
28533_1,,,,2,2,1,3
28535_0,,,,2,2,1,3
C(C(C=O)(C)C(C(C=O)=O)O)(O)=O,,,5,1,1,0,1
28536_0,,,,2,2,1,3
28536_1,,,,2,2,1,3
28537_0,,,,2,2,1,3
28537_1,,,,2,2,1,3
28538_0,,,,2,2,1,3
28538_1,,,,2,2,1,3
28539_0,,,,2,2,1,3
28541_0,,,,2,2,1,3
C(C(C(C)O)C(C(C=O)=O)O)(O)=O,,,5,1,3,0,3
28542_0,,,,2,2,1,3
28543_0,,,,2,2,1,3
28543_1,,,,2,2,1,3
28545_0,,,,2,2,1,3
C(C(C=O)(C(C=O)(C(C)=O)O)O)=O,,,5,1,4,0,4
28545_1,,,,2,2,1,3
28547_0,,,,2,2,1,3
C(C(C=O)(C)C(C=O)(C=O)O)(O)=O,,,5,1,1,0,1
28548_0,,,,2,2,1,3
28548_1,,,,2,2,1,3
28550_0,,,,2,2,1,3
C(C(C=O)(C(C=O)(C=O)O)O)=O,,,5,1,2,0,2
28550_1,,,,2,2,1,3
28552_0,,,,2,2,1,3
C(C(C=O)(C(C=O)(C=O)O)O)(O)=O,,,5,1,6,0,6
28552_1,,,,2,2,1,3
28554_0,,,,2,2,1,3
C(C(C=O)(C(C(O)=O)CO)O)=O,,,5,1,1,0,1
28556_0,,,,2,2,1,3
C(C(C=O)(C(C(O)=O)C(C)O)O)=O,,,5,1,1,0,1
28558_0,,,,2,2,1,3
C(C(C(O)=O)C(C=O)(C=O)O)(O)=O,,,5,1,1,0,1
28559_0,,,,2,2,1,3
28559_1,,,,2,2,1,3
28561_0,,,,2,2,1,3
C(C)(C(C(C(CO)=O)=O)(CO)O)=O,,,5,1,2,0,2
28561_1,,,,2,2,1,3
28562_0,,,,2,2,1,3
28563_0,,,,2,2,1,3
28564_0,,,,2,2,1,3
28566_0,,,,2,2,1,3
C(C(CO)C(C(C(C)=O)=O)O)(O)=O,,,5,1,2,0,2
28567_0,,,,2,2,1,3
28567_1,,,,2,2,1,3
28568_0,,,,2,2,1,3
28568_1,,,,2,2,1,3
28569_0,,,,2,2,1,3
28569_1,,,,2,2,1,3
28571_0,,,,2,2,1,3
C(CO)(C(C(C(C)=O)=O)(CO)O)=O,,,5,1,2,0,2
28571_1,,,,2,2,1,3
28573_0,,,,2,2,1,3
C(C)(C(C(C=O)=O)(C(C=C)O)O)=O,,,5,1,2,0,2
28573_1,,,,2,2,1,3
28574_0,,,,2,2,1,3
28574_1,,,,2,2,1,3
28575_0,,,,2,2,1,3
28575_1,,,,2,2,1,3
28576_0,,,,2,2,1,3
28576_1,,,,2,2,1,3
28578_0,,,,2,2,1,3
C(C(C(C(C)=O)(C(C=O)=O)O)O)=O,,,5,1,2,0,2
28578_1,,,,2,2,1,3
28580_0,,,,2,2,1,3
C(C)(C(C(C=O)=O)(C(CO)O)O)=O,,,5,1,2,0,2
28580_1,,,,2,2,1,3
28582_0,,,,2,2,1,3
C(C)(C(C(C(C)=O)=O)(C(C)O)O)=O,,,5,1,2,0,2
28582_1,,,,2,2,1,3
28584_0,,,,2,2,1,3
C(C(C(C)=O)(C(C(C)=O)=O)O)(O)=O,,,5,1,2,0,2
28584_1,,,,2,2,1,3
28585_0,,,,2,2,1,3
28585_1,,,,2,2,1,3
28586_0,,,,2,2,1,3
28586_1,,,,2,2,1,3
28587_0,,,,2,2,1,3
28588_0,,,,2,2,1,3
28588_1,,,,2,2,1,3
28590_0,,,,2,2,1,3
C(C(C=O)(C(C(CO)=O)(C)O)O)=O,,,5,1,2,0,2
28590_1,,,,2,2,1,3
28591_0,,,,2,2,1,3
28593_0,,,,2,2,1,3
C(C(CO)(C(C(CO)=O)(C)O)O)=O,,,5,1,2,0,2
28593_1,,,,2,2,1,3
28594_0,,,,2,2,1,3
28594_1,,,,2,2,1,3
28596_0,,,,2,2,1,3
C(C(C=O)(C(C(C(C)O)=O)O)O)=O,,,5,1,2,0,2
28596_1,,,,2,2,1,3
28597_0,,,,2,2,1,3
28599_0,,,,2,2,1,3
C(C(CO)(C(C(C(C)O)=O)O)O)=O,,,5,1,2,0,2
28599_1,,,,2,2,1,3
28600_0,,,,2,2,1,3
28600_1,,,,2,2,1,3
28602_0,,,,2,2,1,3
C(C(CO)C(C=O)(C(C)O)O)(O)=O,,,5,1,3,0,3
28603_0,,,,2,2,1,3
28603_1,,,,2,2,1,3
28604_0,,,,2,2,1,3
28604_1,,,,2,2,1,3
28605_0,,,,2,2,1,3
28606_0,,,,2,2,1,3
28606_1,,,,2,2,1,3
28607_0,,,,2,2,1,3
28607_1,,,,2,2,1,3
28609_0,,,,2,2,1,3
C(C(CO)C(C(C(O)=O)=O)O)(O)=O,,,5,1,5,0,5
28610_0,,,,2,2,1,3
28610_1,,,,2,2,1,3
28612_0,,,,2,2,1,3
C(C(C(C(C)=O)=O)(C(C)O)O)(O)=O,,,5,1,2,0,2
28612_1,,,,2,2,1,3
28614_0,,,,2,2,1,3
C(C(C(O)=O)(C(C(C)=O)=O)O)(O)=O,,,5,1,2,0,2
28614_1,,,,2,2,1,3
28615_0,,,,2,2,1,3
28615_1,,,,2,2,1,3
28616_0,,,,2,2,1,3
28616_1,,,,2,2,1,3
28617_0,,,,2,2,1,3
28618_0,,,,2,2,1,3
28618_1,,,,2,2,1,3
28620_0,,,,2,2,1,3
C(C(C=O)(C(C(C=O)=O)(C)O)O)=O,,,5,1,3,0,3
28620_1,,,,2,2,1,3
28622_0,,,,2,2,1,3
C(C(CO)C(C(C=O)=O)(C)O)(O)=O,,,5,1,2,0,2
28624_0,,,,2,2,1,3
C(C(CO)(C(C(C=O)=O)(C)O)O)=O,,,5,1,3,0,3
28624_1,,,,2,2,1,3
28625_0,,,,2,2,1,3
28625_1,,,,2,2,1,3
28627_0,,,,2,2,1,3
C(C(CO)C(C=O)(C(C)=O)O)(O)=O,,,5,1,1,0,1
28629_0,,,,2,2,1,3
C(C(CO)(C(C=O)(C(C)=O)O)O)=O,,,5,1,4,0,4
28629_1,,,,2,2,1,3
28631_0,,,,2,2,1,3
C(C(C(C(C=O)=O)=O)(C)CO)(O)=O,,,5,1,1,0,1
28633_0,,,,2,2,1,3
C(C(C=O)(C(C(C)=O)(C=C)O)O)=O,,,5,1,2,0,2
28633_1,,,,2,2,1,3
28635_0,,,,2,2,1,3
C(C(CO)C(C(C)=O)(C=C)O)(O)=O,,,5,1,1,0,1
28637_0,,,,2,2,1,3
C(C(CO)(C(C(C)=O)(C=C)O)O)=O,,,5,1,2,0,2
28637_1,,,,2,2,1,3
28639_0,,,,2,2,1,3
C(C(C=O)(C(C(C=C)=O)(C)O)O)=O,,,5,1,2,0,2
28639_1,,,,2,2,1,3
28641_0,,,,2,2,1,3
C(C(CO)C(C(C=C)=O)(C)O)(O)=O,,,5,1,1,0,1
28643_0,,,,2,2,1,3
C(C(CO)(C(C(C=C)=O)(C)O)O)=O,,,5,1,2,0,2
28643_1,,,,2,2,1,3
28645_0,,,,2,2,1,3
C=CC(C(C(C(C)=O)=O)(CO)O)O,,,5,1,2,0,2
28645_1,,,,2,2,1,3
28646_0,,,,2,2,1,3
28646_1,,,,2,2,1,3
28647_0,,,,2,2,1,3
28647_1,,,,2,2,1,3
28648_0,,,,2,2,1,3
28648_1,,,,2,2,1,3
28650_0,,,,2,2,1,3
C(C(C(C(C(C)=O)=O)(CO)O)O)=O,,,5,1,3,0,3
28650_1,,,,2,2,1,3
28652_0,,,,2,2,1,3
C(C(C)=O)(C(CO)(C(CO)O)O)=O,,,5,1,3,0,3
28652_1,,,,2,2,1,3
28653_0,,,,2,2,1,3
28655_0,,,,2,2,1,3
C(C(C(C)(CC)O)C(C=O)O)(O)=O,,,5,1,1,0,1
28656_0,,,,2,2,1,3
28658_0,,,,2,2,1,3
C(C(C(C=O)O)C(C=C)O)(O)=O,,,5,1,1,0,1
28660_0,,,,2,2,1,3
C(C(C(C(O)O)O)C(C=O)O)(O)=O,,,5,1,1,0,1
28661_0,,,,2,2,1,3
28662_0,,,,2,2,1,3
28663_0,,,,2,2,1,3
28664_0,,,,2,2,1,3
28665_0,,,,2,2,1,3
28666_0,,,,2,2,1,3
28668_0,,,,2,2,1,3
C(C(C(C=O)O)C(C=O)O)(O)=O,,,5,1,2,0,2
28670_0,,,,2,2,1,3
C(C(C(CO)(C)O)C(C=O)O)(O)=O,,,5,1,2,0,2
28672_0,,,,2,2,1,3
C(C(C(C=O)O)C(C=CC)O)(O)=O,,,5,1,2,0,2
28674_0,,,,2,2,1,3
C(C(C(CC=C)O)C(C=O)O)(O)=O,,,5,1,2,0,2
28676_0,,,,2,2,1,3
C(C(C(CO)O)C(C=O)O)(O)=O,,,5,1,2,0,2
28678_0,,,,2,2,1,3
C(C(C(C(C)O)O)C(C=O)O)(O)=O,,,5,1,2,0,2
28679_0,,,,2,2,1,3
28681_0,,,,2,2,1,3
C(C(C(CO)=O)([C](C(O)=O)O)O)=O,,,5,1,2,0,2
28681_1,,,,2,2,1,3
28683_0,,,,2,2,1,3
C(C(C(CO)=O)(C(C)(CC)O)O)=O,,,5,1,2,0,2
28683_1,,,,2,2,1,3
28685_0,,,,2,2,1,3
C(CC(C(C=O)(C(CO)=O)O)O)=O,,,5,1,2,0,2
28685_1,,,,2,2,1,3
28687_0,,,,2,2,1,3
C(C(C(CO)=O)(C(C=C)O)O)=O,,,5,1,2,0,2
28687_1,,,,2,2,1,3
28689_0,,,,2,2,1,3
C(C(C(CO)=O)(C(C(O)O)O)O)=O,,,5,1,2,0,2
28689_1,,,,2,2,1,3
28691_0,,,,2,2,1,3
C(C(C(CO)=O)(C(C)O)O)=O,,,5,1,2,0,2
28691_1,,,,2,2,1,3
28692_0,,,,2,2,1,3
28692_1,,,,2,2,1,3
28694_0,,,,2,2,1,3
C(C(C)(C(C=O)(C(CO)=O)O)O)=O,,,5,1,2,0,2
28694_1,,,,2,2,1,3
28696_0,,,,2,2,1,3
C(C(C(CO)=O)(C(C(C)=O)O)O)=O,,,5,1,2,0,2
28696_1,,,,2,2,1,3
28697_0,,,,2,2,1,3
28697_1,,,,2,2,1,3
28699_0,,,,2,2,1,3
C(C(C(CO)=O)(C(CCO)O)O)=O,,,5,1,2,0,2
28699_1,,,,2,2,1,3
28701_0,,,,2,2,1,3
C(C(C(CO)=O)(C(C=O)O)O)=O,,,5,1,2,0,2
28701_1,,,,2,2,1,3
28703_0,,,,2,2,1,3
C(C(C(CO)=O)(C(CO)(C)O)O)=O,,,5,1,2,0,2
28703_1,,,,2,2,1,3
28705_0,,,,2,2,1,3
C(C(C(CO)=O)(C(C=CC)O)O)=O,,,5,1,2,0,2
28705_1,,,,2,2,1,3
28707_0,,,,2,2,1,3
C(C(C(CO)=O)(C(CC=C)O)O)=O,,,5,1,2,0,2
28707_1,,,,2,2,1,3
28708_0,,,,2,2,1,3
28708_1,,,,2,2,1,3
28709_0,,,,2,2,1,3
28709_1,,,,2,2,1,3
28710_0,,,,2,2,1,3
28710_1,,,,2,2,1,3
28712_0,,,,2,2,1,3
C(C(C=O)(C(C(C=O)(C)O)O)O)=O,,,5,1,2,0,2
28712_1,,,,2,2,1,3
28713_0,,,,2,2,1,3
28715_0,,,,2,2,1,3
C(C(CO)(C(C(C=O)(C)O)O)O)=O,,,5,1,5,0,5
28715_1,,,,2,2,1,3
28717_0,,,,2,2,1,3
C(C(C(C)=O)(C(C(C)=O)(C)O)O)=O,,,5,1,3,0,3
28717_1,,,,2,2,1,3
28719_0,,,,2,2,1,3
C(C(C(C)=O)([C](C(O)=O)O)O)=O,,,5,1,3,0,3
28719_1,,,,2,2,1,3
28721_0,,,,2,2,1,3
C(C(C(C)=O)(C(C)(CCO)O)O)=O,,,5,1,2,0,2
28721_1,,,,2,2,1,3
28723_0,,,,2,2,1,3
C(C(C(C)=O)(C(C)(CC)O)O)=O,,,5,1,2,0,2
28723_1,,,,2,2,1,3
28725_0,,,,2,2,1,3
C(C(C(C)=O)(C(C)(C(C)O)O)O)=O,,,5,1,2,0,2
28725_1,,,,2,2,1,3
28727_0,,,,2,2,1,3
C(C(C(C)=O)(C(CO)(CC)O)O)=O,,,5,1,2,0,2
28727_1,,,,2,2,1,3
28729_0,,,,2,2,1,3
C(CC(C(C=O)(C(C)=O)O)O)=O,,,5,1,2,0,2
28729_1,,,,2,2,1,3
28731_0,,,,2,2,1,3
C(C(C(C)=O)(C([CH]C(O)=O)O)O)=O,,,5,1,2,0,2
28731_1,,,,2,2,1,3
28733_0,,,,2,2,1,3
C(C(C=C)(C(C=O)(C(C)=O)O)O)=O,,,5,1,2,0,2
28733_1,,,,2,2,1,3
28735_0,,,,2,2,1,3
C(C(C(C)=O)(C(C(C=C)=O)O)O)=O,,,5,1,2,0,2
28735_1,,,,2,2,1,3
28737_0,,,,2,2,1,3
C(C(C(C)=O)(C(C=C)O)O)=O,,,5,1,2,0,2
28737_1,,,,2,2,1,3
28739_0,,,,2,2,1,3
C(C(C(C)=O)(C(C(CC)O)O)O)=O,,,5,1,2,0,2
28739_1,,,,2,2,1,3
28741_0,,,,2,2,1,3
C(C(C(C)=O)(C(CCCO)O)O)=O,,,5,1,2,0,2
28741_1,,,,2,2,1,3
28743_0,,,,2,2,1,3
C(C(C(C)=O)(C(C(O)O)O)O)=O,,,5,1,2,0,2
28743_1,,,,2,2,1,3
28745_0,,,,2,2,1,3
C(C(C(C)=O)(C(C)O)O)=O,,,5,1,2,0,2
28745_1,,,,2,2,1,3
28747_0,,,,2,2,1,3
C(C(C=O)(C(C)=O)O)(O)=O,,,5,1,3,0,3
28747_1,,,,2,2,1,3
28749_0,,,,2,2,1,3
C(C(C(C)=O)(C(CC(C)O)O)O)=O,,,5,1,2,0,2
28749_1,,,,2,2,1,3
28751_0,,,,2,2,1,3
C(CC(C(C=O)(C(C)=O)O)O)(O)=O,,,5,1,2,0,2
28751_1,,,,2,2,1,3
28752_0,,,,2,2,1,3
28752_1,,,,2,2,1,3
28753_0,,,,2,2,1,3
28753_1,,,,2,2,1,3
28755_0,,,,2,2,1,3
C(C(C)(C(C=O)(C(C)=O)O)O)=O,,,5,1,4,0,4
28755_1,,,,2,2,1,3
28756_0,,,,2,2,1,3
28756_1,,,,2,2,1,3
28757_0,,,,2,2,1,3
28757_1,,,,2,2,1,3
28759_0,,,,2,2,1,3
C(C(C(C)=O)(C(CCO)O)O)=O,,,5,1,2,0,2
28759_1,,,,2,2,1,3
28760_0,,,,2,2,1,3
28760_1,,,,2,2,1,3
28762_0,,,,2,2,1,3
C(C(C(C(C=O)(C(C)=O)O)O)O)=O,,,5,1,2,0,2
28762_1,,,,2,2,1,3
28764_0,,,,2,2,1,3
C(C(C(C)=O)(C(CO)(CO)O)O)=O,,,5,1,2,0,2
28764_1,,,,2,2,1,3
28766_0,,,,2,2,1,3
C(C(C(C)=O)(C(CO)(C)O)O)=O,,,5,1,2,0,2
28766_1,,,,2,2,1,3
28768_0,,,,2,2,1,3
C(C(C(C)=O)(C(C=CC)O)O)=O,,,5,1,2,0,2
28768_1,,,,2,2,1,3
28770_0,,,,2,2,1,3
C(C(C(C)=O)(C(CC=C)O)O)=O,,,5,1,2,0,2
28770_1,,,,2,2,1,3
28772_0,,,,2,2,1,3
C(C(C(C)=O)(C(C(CO)O)O)O)=O,,,5,1,2,0,2
28772_1,,,,2,2,1,3
28774_0,,,,2,2,1,3
C(C(C(C)=O)(C(CO)O)O)=O,,,5,1,2,0,2
28774_1,,,,2,2,1,3
28776_0,,,,2,2,1,3
C(C(C(C)=O)(C(C(C)O)O)O)=O,,,5,1,2,0,2
28776_1,,,,2,2,1,3
28778_0,,,,2,2,1,3
C(C(C(C)=O)(C(C(O)=O)O)O)=O,,,5,1,4,0,4
28778_1,,,,2,2,1,3
28780_0,,,,2,2,1,3
C(C(C)(C(C=O)(C(C)=O)O)O)(O)=O,,,5,1,3,0,3
28780_1,,,,2,2,1,3
28782_0,,,,2,2,1,3
C(C(C=O)(C(C)(C(C=O)O)O)O)=O,,,5,1,2,0,2
28782_1,,,,2,2,1,3
28783_0,,,,2,2,1,3
28785_0,,,,2,2,1,3
C(C(CO)(C(C)(C(C=O)O)O)O)=O,,,5,1,2,0,2
28785_1,,,,2,2,1,3
28787_0,,,,2,2,1,3
C(C(C=O)(C(C(C(C)=O)O)O)O)=O,,,5,1,2,0,2
28787_1,,,,2,2,1,3
28788_0,,,,2,2,1,3
28789_0,,,,2,2,1,3
28789_1,,,,2,2,1,3
28791_0,,,,2,2,1,3
C(C(C=O)(C)C(C(C)=O)(C)O)(O)=O,,,5,1,1,0,1
28793_0,,,,2,2,1,3
C(C(CO)(C(C(C)=O)(C)O)O)(O)=O,,,5,1,3,0,3
28793_1,,,,2,2,1,3
28795_0,,,,2,2,1,3
C(C(C=O)(C(C(C)=O)(C)O)O)=O,,,5,1,3,0,3
28795_1,,,,2,2,1,3
28797_0,,,,2,2,1,3
C(C(C=O)(C(C(C)=O)(C)O)O)(O)=O,,,5,1,3,0,3
28797_1,,,,2,2,1,3
28799_0,,,,2,2,1,3
C(C(CO)C(C(C)=O)(C)O)(O)=O,,,5,1,1,0,1
28801_0,,,,2,2,1,3
C(C(C(C)O)C(C(C)=O)(C)O)(O)=O,,,5,1,1,0,1
28803_0,,,,2,2,1,3
C(C(C(O)=O)C(C(C)=O)(C)O)(O)=O,,,5,1,1,0,1
28805_0,,,,2,2,1,3
C(C(CO)(C(C(C)=O)(C)O)O)=O,,,5,1,3,0,3
28805_1,,,,2,2,1,3
28807_0,,,,2,2,1,3
C(C)(C(C(C)=O)([C](C(O)=O)O)O)=O,,,5,1,2,0,2
28807_1,,,,2,2,1,3
28809_0,,,,2,2,1,3
C(C([C](C(O)=O)O)(CO)CO)(O)=O,,,5,1,3,0,3
28811_0,,,,2,2,1,3
C(C(C=O)([C](C(O)=O)O)CC=O)=O,,,5,1,1,0,1
28813_0,,,,2,2,1,3
C(C(C(O)=O)([C](C(O)=O)O)C)=O,,,5,1,1,0,1
28815_0,,,,2,2,1,3
C1(C(O)OCC1([C](C(O)=O)O)O)=O,,,5,1,2,0,2
28815_1,,,,2,2,1,3
28817_0,,,,2,2,1,3
[C](C(O)=O)(C1(C(C(OC1)=O)=O)O)O,,,5,1,3,0,3
28817_1,,,,2,2,1,3
28819_0,,,,2,2,1,3
C1(C([C](C(O1)=O)O)[C](C(O)=O)O)=O,,,5,1,1,0,1
28821_0,,,,2,2,1,3
C1(C([C](C(O)=O)O)C(C(O1)=O)O)=O,,,5,1,1,0,1
28823_0,,,,2,2,1,3
C(C([C](C(O)=O)O)(CO)O)(O)=O,,,5,1,6,0,6
28823_1,,,,2,2,1,3
28825_0,,,,2,2,1,3
C(C([C](C(O)=O)O)(CO)C(C)O)=O,,,5,1,1,0,1
28827_0,,,,2,2,1,3
C(C(C=O)([C](C(O)=O)O)CO)(O)=O,,,5,1,1,0,1
28829_0,,,,2,2,1,3
[C](C(O)=O)(C(C(C=O)=O)(CO)O)O,,,5,1,2,0,2
28829_1,,,,2,2,1,3
28831_0,,,,2,2,1,3
C(C(C=O)([C](C(O)=O)O)O)=O,,,5,1,3,0,3
28831_1,,,,2,2,1,3
28833_0,,,,2,2,1,3
C(C(C=O)([C](C(O)=O)O)O)(O)=O,,,5,1,3,0,3
28833_1,,,,2,2,1,3
28834_0,,,,2,2,1,3
28835_0,,,,2,2,1,3
28836_0,,,,2,2,1,3
28838_0,,,,2,2,1,3
C(C([C](C(O)=O)O)(C(C)O)O)(O)=O,,,5,1,6,0,6
28838_1,,,,2,2,1,3
28840_0,,,,2,2,1,3
C(C(C(O)=O)([C](C(O)=O)O)O)(O)=O,,,5,1,5,0,5
28840_1,,,,2,2,1,3
28842_0,,,,2,2,1,3
C(C)(C(C(O)=O)([C](C(O)=O)O)C)=O,,,5,1,1,0,1
28844_0,,,,2,2,1,3
C(C([C](C(O)=O)O)(CO)O)=O,,,5,1,4,0,4
28844_1,,,,2,2,1,3
28846_0,,,,2,2,1,3
C(C(C=O)(C(C)(CC(O)=O)O)O)=O,,,5,1,2,0,2
28846_1,,,,2,2,1,3
28847_0,,,,2,2,1,3
28849_0,,,,2,2,1,3
C(C(CO)(C(C)(CC(O)=O)O)O)=O,,,5,1,2,0,2
28849_1,,,,2,2,1,3
28851_0,,,,2,2,1,3
C(C(C=O)(C)C(C)(CCO)O)(O)=O,,,5,1,1,0,1
28853_0,,,,2,2,1,3
C(C(CO)(C(C)(CCO)O)O)(O)=O,,,5,1,2,0,2
28853_1,,,,2,2,1,3
28855_0,,,,2,2,1,3
C(C(C=O)(C(C)(CCO)O)O)=O,,,5,1,2,0,2
28855_1,,,,2,2,1,3
28857_0,,,,2,2,1,3
C(C(C=O)(C(C)(CCO)O)O)(O)=O,,,5,1,2,0,2
28857_1,,,,2,2,1,3
28858_0,,,,2,2,1,3
28860_0,,,,2,2,1,3
C(C(C(C)O)C(C)(CCO)O)(O)=O,,,5,1,1,0,1
28862_0,,,,2,2,1,3
C(C(C(O)=O)C(C)(CCO)O)(O)=O,,,5,1,1,0,1
28864_0,,,,2,2,1,3
C(C(CO)(C(C)(CCO)O)O)=O,,,5,1,2,0,2
28864_1,,,,2,2,1,3
28866_0,,,,2,2,1,3
C(C)(C(C(C)=O)(C(C)(CC)O)O)=O,,,5,1,2,0,2
28866_1,,,,2,2,1,3
28868_0,,,,2,2,1,3
C(C(CO)(CO)C(C)(CC)O)(O)=O,,,5,1,1,0,1
28870_0,,,,2,2,1,3
C(C(C=O)(C(C)(CC)O)CC=O)=O,,,5,1,1,0,1
28872_0,,,,2,2,1,3
C(C(C=O)(C)C(C)(CC)O)(O)=O,,,5,1,1,0,1
28874_0,,,,2,2,1,3
C1(C(O)OCC1(C(C)(CC)O)O)=O,,,5,1,2,0,2
28874_1,,,,2,2,1,3
28876_0,,,,2,2,1,3
C1(C(C(CO1)(C(C)(CC)O)O)=O)=O,,,5,1,2,0,2
28876_1,,,,2,2,1,3
28878_0,,,,2,2,1,3
C1(C([C](C(O1)=O)O)C(C)(CC)O)=O,,,5,1,1,0,1
28880_0,,,,2,2,1,3
C1(C(C(C)(CC)O)C(C(O1)=O)O)=O,,,5,1,1,0,1
28882_0,,,,2,2,1,3
C(C(CO)(C(C)(CC)O)O)(O)=O,,,5,1,2,0,2
28882_1,,,,2,2,1,3
28884_0,,,,2,2,1,3
C(C(CO)(C(C)O)C(C)(CC)O)=O,,,5,1,1,0,1
28886_0,,,,2,2,1,3
C(C(C=O)(CO)C(C)(CC)O)(O)=O,,,5,1,1,0,1
28888_0,,,,2,2,1,3
C(C(C(CO)(C(C)(CC)O)O)=O)=O,,,5,1,2,0,2
28888_1,,,,2,2,1,3
28890_0,,,,2,2,1,3
C(C(C=O)(C(C)(CC)O)O)=O,,,5,1,2,0,2
28890_1,,,,2,2,1,3
28892_0,,,,2,2,1,3
C(C(C=O)(C(C)(CC)O)O)(O)=O,,,5,1,2,0,2
28892_1,,,,2,2,1,3
28894_0,,,,2,2,1,3
C(C(CO)C(C)(CC)O)(O)=O,,,5,1,1,0,1
28896_0,,,,2,2,1,3
C(C(C(C)O)C(C)(CC)O)(O)=O,,,5,1,1,0,1
28898_0,,,,2,2,1,3
C(C(C(O)=O)C(C)(CC)O)(O)=O,,,5,1,1,0,1
28900_0,,,,2,2,1,3
C(C(C(C)O)(C(C)(CC)O)O)(O)=O,,,5,1,2,0,2
28900_1,,,,2,2,1,3
28902_0,,,,2,2,1,3
C(C(C(O)=O)(C(C)(CC)O)O)(O)=O,,,5,1,2,0,2
28902_1,,,,2,2,1,3
28904_0,,,,2,2,1,3
C(C(C(C)=O)(C)C(C)(CC)O)(O)=O,,,5,1,1,0,1
28906_0,,,,2,2,1,3
C(C(CO)(C(C)(CC)O)O)=O,,,5,1,2,0,2
28906_1,,,,2,2,1,3
28908_0,,,,2,2,1,3
C(CO)(C(C(O)=O)(C)C(C=C)O)=O,,,5,1,1,0,1
28910_0,,,,2,2,1,3
C(C(C(CO)=O)(C)C(C)O)(O)=O,,,5,1,1,0,1
28912_0,,,,2,2,1,3
C(C(C(O)=O)(C(CO)=O)C)(O)=O,,,5,1,1,0,1
28914_0,,,,2,2,1,3
C(C(C(CO)=O)(CO)C)(O)=O,,,5,1,1,0,1
28916_0,,,,2,2,1,3
C(CO)(C(C(O)=O)(C)C(C=O)O)=O,,,5,1,1,0,1
28918_0,,,,2,2,1,3
C(C(C(CO)=O)(C)C(CO)O)(O)=O,,,5,1,1,0,1
28920_0,,,,2,2,1,3
C(CC)(C(C(O)=O)(C(C=C)O)O)=O,,,5,1,2,0,2
28920_1,,,,2,2,1,3
28922_0,,,,2,2,1,3
C(C(C(CC)=O)(C(C)O)O)(O)=O,,,5,1,3,0,3
28922_1,,,,2,2,1,3
28924_0,,,,2,2,1,3
C(C(C(O)=O)(C(CC)=O)O)(O)=O,,,5,1,3,0,3
28924_1,,,,2,2,1,3
28926_0,,,,2,2,1,3
C(C(C(CC)=O)(CO)O)(O)=O,,,5,1,3,0,3
28926_1,,,,2,2,1,3
28927_0,,,,2,2,1,3
28927_1,,,,2,2,1,3
28929_0,,,,2,2,1,3
C(C(C(CC)=O)(C(CO)O)O)(O)=O,,,5,1,2,0,2
28929_1,,,,2,2,1,3
28931_0,,,,2,2,1,3
C(C(C=O)(C(C[CH]C(O)=O)O)O)=O,,,5,1,3,0,3
28931_1,,,,2,2,1,3
28932_0,,,,2,2,1,3
28934_0,,,,2,2,1,3
C(C(CO)(C(C[CH]C(O)=O)O)O)=O,,,5,1,5,0,5
28934_1,,,,2,2,1,3
28936_0,,,,2,2,1,3
C(C(C=O)(C(CCC(O)=O)O)O)=O,,,5,1,3,0,3
28936_1,,,,2,2,1,3
28937_0,,,,2,2,1,3
28939_0,,,,2,2,1,3
C(C(CO)(C(CCC(O)=O)O)O)=O,,,5,1,5,0,5
28939_1,,,,2,2,1,3
28940_0,,,,2,2,1,3
28941_0,,,,2,2,1,3
28943_0,,,,2,2,1,3
C(C(CO)(CO)O)(CC(C=O)=O)=O,,,5,1,2,0,2
28943_1,,,,2,2,1,3
28945_0,,,,2,2,1,3
C(C(CO)(C(C=C)O)O)(CC=O)=O,,,5,1,2,0,2
28945_1,,,,2,2,1,3
28947_0,,,,2,2,1,3
C(CC(C(CO)(C(C)O)O)=O)=O,,,5,1,2,0,2
28947_1,,,,2,2,1,3
28949_0,,,,2,2,1,3
C(C(C(CC=O)=O)(CO)O)(O)=O,,,5,1,4,0,4
28949_1,,,,2,2,1,3
28951_0,,,,2,2,1,3
C(CC(C(CO)(CO)O)=O)=O,,,5,1,2,0,2
28951_1,,,,2,2,1,3
28952_0,,,,2,2,1,3
28952_1,,,,2,2,1,3
28954_0,,,,2,2,1,3
C(CC(C(CO)(C(CO)O)O)=O)=O,,,5,1,2,0,2
28954_1,,,,2,2,1,3
28956_0,,,,2,2,1,3
C(C(C(C(C=O)(C)O)=O)(CO)O)=O,,,5,1,2,0,2
28956_1,,,,2,2,1,3
28957_0,,,,2,2,1,3
28957_1,,,,2,2,1,3
28958_0,,,,2,2,1,3
28958_1,,,,2,2,1,3
28960_0,,,,2,2,1,3
C(C(C(C(C(C)=O)O)=O)(CO)O)=O,,,5,1,2,0,2
28960_1,,,,2,2,1,3
28962_0,,,,2,2,1,3
C(C(C)O)(C(C=O)(C(C=C)O)O)=O,,,5,1,2,0,2
28962_1,,,,2,2,1,3
28964_0,,,,2,2,1,3
C(C(C(C(C)O)=O)(C(C)O)O)=O,,,5,1,2,0,2
28964_1,,,,2,2,1,3
28965_0,,,,2,2,1,3
28965_1,,,,2,2,1,3
28966_0,,,,2,2,1,3
28966_1,,,,2,2,1,3
28968_0,,,,2,2,1,3
C(C(C)O)(C(C=O)(C(C=O)O)O)=O,,,5,1,2,0,2
28968_1,,,,2,2,1,3
28969_0,,,,2,2,1,3
28969_1,,,,2,2,1,3
28971_0,,,,2,2,1,3
C(C(C(C(O)=O)=O)(C(C=C)O)O)=O,,,5,1,2,0,2
28971_1,,,,2,2,1,3
28973_0,,,,2,2,1,3
C(C(C(C(O)=O)=O)(C(C)O)O)=O,,,5,1,2,0,2
28973_1,,,,2,2,1,3
28975_0,,,,2,2,1,3
C(C(C=O)(C(C(O)=O)=O)O)(O)=O,,,5,1,3,0,3
28975_1,,,,2,2,1,3
28976_0,,,,2,2,1,3
28976_1,,,,2,2,1,3
28977_0,,,,2,2,1,3
28977_1,,,,2,2,1,3
28979_0,,,,2,2,1,3
C(C(C(C(O)=O)=O)(C(CO)O)O)=O,,,5,1,3,0,3
28979_1,,,,2,2,1,3
28980_0,,,,2,2,1,3
28980_1,,,,2,2,1,3
28981_0,,,,2,2,1,3
28981_1,,,,2,2,1,3
28982_0,,,,2,2,1,3
28982_1,,,,2,2,1,3
28984_0,,,,2,2,1,3
C(CO)(C(C(C)=O)(C(C=C)O)O)=O,,,5,1,2,0,2
28984_1,,,,2,2,1,3
28985_0,,,,2,2,1,3
28985_1,,,,2,2,1,3
28986_0,,,,2,2,1,3
28986_1,,,,2,2,1,3
28988_0,,,,2,2,1,3
C(C)(C(C(CO)=O)(CO)O)=O,,,5,1,2,0,2
28988_1,,,,2,2,1,3
28990_0,,,,2,2,1,3
C(C(C(C(CO)=O)(C(C)=O)O)O)=O,,,5,1,2,0,2
28990_1,,,,2,2,1,3
28992_0,,,,2,2,1,3
C(C)(C(C(CO)=O)(C(CO)O)O)=O,,,5,1,2,0,2
28992_1,,,,2,2,1,3
28994_0,,,,2,2,1,3
C(CC(C(C(C)=O)(C(C)=O)O)O)=O,,,5,1,2,0,2
28994_1,,,,2,2,1,3
28996_0,,,,2,2,1,3
C(C)(C(C(C)=O)(C(C=C)O)O)=O,,,5,1,2,0,2
28996_1,,,,2,2,1,3
28998_0,,,,2,2,1,3
C(C)(C(C(C)=O)(C(C(O)O)O)O)=O,,,5,1,2,0,2
28998_1,,,,2,2,1,3
29000_0,,,,2,2,1,3
C(C)(C(C(C)=O)(C(C)O)O)=O,,,5,1,2,0,2
29000_1,,,,2,2,1,3
29001_0,,,,2,2,1,3
29001_1,,,,2,2,1,3
29003_0,,,,2,2,1,3
C(C(C)(C(C(C)=O)(C(C)=O)O)O)=O,,,5,1,2,0,2
29003_1,,,,2,2,1,3
29005_0,,,,2,2,1,3
C(C)(C(C(C)=O)(C(C(C)=O)O)O)=O,,,5,1,2,0,2
29005_1,,,,2,2,1,3
29007_0,,,,2,2,1,3
C(C)(C(C(C)=O)(CO)O)=O,,,5,1,2,0,2
29007_1,,,,2,2,1,3
29009_0,,,,2,2,1,3
C(C)(C(C(C)=O)(C(CCO)O)O)=O,,,5,1,2,0,2
29009_1,,,,2,2,1,3
29011_0,,,,2,2,1,3
C(C(C(C(C)=O)(C(C)=O)O)O)=O,,,5,1,2,0,2
29011_1,,,,2,2,1,3
29013_0,,,,2,2,1,3
C(C)(C(C(C)=O)(C(CO)(C)O)O)=O,,,5,1,2,0,2
29013_1,,,,2,2,1,3
29015_0,,,,2,2,1,3
C(C)(C(C(C)=O)(C(C=CC)O)O)=O,,,5,1,2,0,2
29015_1,,,,2,2,1,3
29017_0,,,,2,2,1,3
C(C)(C(C(C)=O)(C(CC=C)O)O)=O,,,5,1,2,0,2
29017_1,,,,2,2,1,3
29019_0,,,,2,2,1,3
C(C)(C(C(C)=O)(C(CO)O)O)=O,,,5,1,2,0,2
29019_1,,,,2,2,1,3
29021_0,,,,2,2,1,3
C(C)(C(C(C)=O)(C(C(C)O)O)O)=O,,,5,1,2,0,2
29021_1,,,,2,2,1,3
29023_0,,,,2,2,1,3
C(C(C(C(C)=O)(C(C)=O)O)O)(O)=O,,,5,1,2,0,2
29023_1,,,,2,2,1,3
29024_0,,,,2,2,1,3
29024_1,,,,2,2,1,3
29025_0,,,,2,2,1,3
29025_1,,,,2,2,1,3
29027_0,,,,2,2,1,3
C(C(C(C[CH]C(O)=O)=O)(CO)O)=O,,,5,1,2,0,2
29027_1,,,,2,2,1,3
29029_0,,,,2,2,1,3
C(C(C(CCC(O)=O)=O)(CO)O)=O,,,5,1,2,0,2
29029_1,,,,2,2,1,3
29031_0,,,,2,2,1,3
C(C(CO)(C(C)O)C(C=C)O)(O)=O,,,5,1,1,0,1
29032_0,,,,2,2,1,3
29033_0,,,,2,2,1,3
29034_0,,,,2,2,1,3
29035_0,,,,2,2,1,3
29036_0,,,,2,2,1,3
29038_0,,,,2,2,1,3
C(C(C(CCO)O)C(C=C)O)(O)=O,,,5,1,1,0,1
29039_0,,,,2,2,1,3
29040_0,,,,2,2,1,3
29041_0,,,,2,2,1,3
29042_0,,,,2,2,1,3
29043_0,,,,2,2,1,3
29044_0,,,,2,2,1,3
29045_0,,,,2,2,1,3
29046_0,,,,2,2,1,3
29048_0,,,,2,2,1,3
C(C(CO)(CO)C(C=C)O)(O)=O,,,5,1,1,0,1
29050_0,,,,2,2,1,3
C(C(CO)(CO)C(C(O)O)O)(O)=O,,,5,1,1,0,1
29051_0,,,,2,2,1,3
29052_0,,,,2,2,1,3
29053_0,,,,2,2,1,3
29054_0,,,,2,2,1,3
29055_0,,,,2,2,1,3
29056_0,,,,2,2,1,3
29057_0,,,,2,2,1,3
29058_0,,,,2,2,1,3
29059_0,,,,2,2,1,3
29060_0,,,,2,2,1,3
29061_0,,,,2,2,1,3
29062_0,,,,2,2,1,3
29063_0,,,,2,2,1,3
29065_0,,,,2,2,1,3
C(C(C(O)=O)(CO)C(C=C)O)(O)=O,,,5,1,1,0,1
29066_0,,,,2,2,1,3
29067_0,,,,2,2,1,3
29068_0,,,,2,2,1,3
29069_0,,,,2,2,1,3
29070_0,,,,2,2,1,3
29071_0,,,,2,2,1,3
29071_1,,,,2,2,1,3
29072_0,,,,2,2,1,3
29072_1,,,,2,2,1,3
29073_0,,,,2,2,1,3
29073_1,,,,2,2,1,3
29074_0,,,,2,2,1,3
29074_1,,,,2,2,1,3
29075_0,,,,2,2,1,3
29076_0,,,,2,2,1,3
29077_0,,,,2,2,1,3
29078_0,,,,2,2,1,3
29079_0,,,,2,2,1,3
29080_0,,,,2,2,1,3
29081_0,,,,2,2,1,3
29082_0,,,,2,2,1,3
29083_0,,,,2,2,1,3
29084_0,,,,2,2,1,3
29085_0,,,,2,2,1,3
29086_0,,,,2,2,1,3
29087_0,,,,2,2,1,3
29088_0,,,,2,2,1,3
29089_0,,,,2,2,1,3
29090_0,,,,2,2,1,3
29091_0,,,,2,2,1,3
29092_0,,,,2,2,1,3
29093_0,,,,2,2,1,3
29094_0,,,,2,2,1,3
29095_0,,,,2,2,1,3
29096_0,,,,2,2,1,3
29097_0,,,,2,2,1,3
29099_0,,,,2,2,1,3
C(C(C)(C(C(O)=O)C(C=C)O)O)=O,,,5,1,1,0,1
29100_0,,,,2,2,1,3
29101_0,,,,2,2,1,3
29102_0,,,,2,2,1,3
29103_0,,,,2,2,1,3
29104_0,,,,2,2,1,3
29106_0,,,,2,2,1,3
C(C(C(C=C)O)C(C(C)=O)O)(O)=O,,,5,1,1,0,1
29107_0,,,,2,2,1,3
29108_0,,,,2,2,1,3
29109_0,,,,2,2,1,3
29110_0,,,,2,2,1,3
29111_0,,,,2,2,1,3
29112_0,,,,2,2,1,3
29113_0,,,,2,2,1,3
29114_0,,,,2,2,1,3
29114_1,,,,2,2,1,3
29115_0,,,,2,2,1,3
29115_1,,,,2,2,1,3
29116_0,,,,2,2,1,3
29116_1,,,,2,2,1,3
29117_0,,,,2,2,1,3
29117_1,,,,2,2,1,3
29118_0,,,,2,2,1,3
29119_0,,,,2,2,1,3
29120_0,,,,2,2,1,3
29121_0,,,,2,2,1,3
29122_0,,,,2,2,1,3
29123_0,,,,2,2,1,3
29123_1,,,,2,2,1,3
29124_0,,,,2,2,1,3
29124_1,,,,2,2,1,3
29125_0,,,,2,2,1,3
29126_0,,,,2,2,1,3
29127_0,,,,2,2,1,3
29128_0,,,,2,2,1,3
29129_0,,,,2,2,1,3
29130_0,,,,2,2,1,3
29131_0,,,,2,2,1,3
29132_0,,,,2,2,1,3
29133_0,,,,2,2,1,3
29134_0,,,,2,2,1,3
29135_0,,,,2,2,1,3
29136_0,,,,2,2,1,3
29136_1,,,,2,2,1,3
29137_0,,,,2,2,1,3
29137_1,,,,2,2,1,3
29138_0,,,,2,2,1,3
29138_1,,,,2,2,1,3
29139_0,,,,2,2,1,3
29139_1,,,,2,2,1,3
29140_0,,,,2,2,1,3
29140_1,,,,2,2,1,3
29141_0,,,,2,2,1,3
29141_1,,,,2,2,1,3
29142_0,,,,2,2,1,3
29142_1,,,,2,2,1,3
29143_0,,,,2,2,1,3
29143_1,,,,2,2,1,3
29144_0,,,,2,2,1,3
29144_1,,,,2,2,1,3
29145_0,,,,2,2,1,3
29145_1,,,,2,2,1,3
29146_0,,,,2,2,1,3
29146_1,,,,2,2,1,3
29147_0,,,,2,2,1,3
29149_0,,,,2,2,1,3
C(C(C=O)(C(C(CO)(C)O)O)O)=O,,,5,1,2,0,2
29149_1,,,,2,2,1,3
29150_0,,,,2,2,1,3
29152_0,,,,2,2,1,3
C(C(CO)(C(C(CO)(C)O)O)O)=O,,,5,1,2,0,2
29152_1,,,,2,2,1,3
29154_0,,,,2,2,1,3
C1(C(C(C)O)(C(C(O1)=O)(C)O)O)=O,,,5,1,2,0,2
29154_1,,,,2,2,1,3
29156_0,,,,2,2,1,3
C1(C(C(O)=O)(C(C(O1)=O)(C)O)O)=O,,,5,1,2,0,2
29156_1,,,,2,2,1,3
29157_0,,,,2,2,1,3
29157_1,,,,2,2,1,3
29159_0,,,,2,2,1,3
C(C(C=O)(C(C(C(O)=O)=C)O)O)=O,,,5,1,2,0,2
29159_1,,,,2,2,1,3
29161_0,,,,2,2,1,3
C(C(CO)C(C(C(O)=O)=C)O)(O)=O,,,5,1,2,0,2
29163_0,,,,2,2,1,3
C(C(CO)(C(C(C(O)=O)=C)O)O)=O,,,5,1,2,0,2
29163_1,,,,2,2,1,3
29165_0,,,,2,2,1,3
C(C(C=O)(CO)C(C=O)C(C)O)=O,,,5,1,1,0,1
29167_0,,,,2,2,1,3
C(C(C=O)C(C=O)(CO)C(C)O)=O,,,5,1,1,0,1
29169_0,,,,2,2,1,3
C(C(C=O)(CO)C(C(O)=O)C=O)=O,,,5,1,1,0,1
29171_0,,,,2,2,1,3
C(C(C=O)(CO)C(C=O)C=O)(O)=O,,,5,1,1,0,1
29173_0,,,,2,2,1,3
C(C(C(C(C=O)=O)=O)(CO)CO)=O,,,5,1,1,0,1
29175_0,,,,2,2,1,3
C(C(C=O)(CO)C(C(C=O)=O)O)=O,,,5,1,1,0,1
29177_0,,,,2,2,1,3
C(C(C=O)(CC(C=O)=O)C(C=C)O)=O,,,5,1,1,0,1
29179_0,,,,2,2,1,3
C(C(C=O)(C(C)O)CC(C=O)=O)=O,,,5,1,1,0,1
29181_0,,,,2,2,1,3
C(C(C=O)(C(O)=O)CC(C=O)=O)=O,,,5,1,1,0,1
29183_0,,,,2,2,1,3
C(C(C=O)(CO)CC(C=O)=O)=O,,,5,1,1,0,1
29185_0,,,,2,2,1,3
C(CC(C(C=O)(C=O)CC=O)O)=O,,,5,1,1,0,1
29187_0,,,,2,2,1,3
C(C(C=O)(CC=O)C(C=O)(C=C)O)=O,,,5,1,1,0,1
29189_0,,,,2,2,1,3
C(C(C=O)(CC=O)C(C(C=C)=O)O)=O,,,5,1,1,0,1
29191_0,,,,2,2,1,3
C(C(C=O)(CC=O)C(C=C)O)=O,,,5,1,1,0,1
29193_0,,,,2,2,1,3
C(C(C=O)(C(C(O)O)O)CC=O)=O,,,5,1,1,0,1
29195_0,,,,2,2,1,3
C(C(C=O)(C(C)O)CC=O)=O,,,5,1,1,0,1
29197_0,,,,2,2,1,3
C(C(C=O)(C(O)=O)CC=O)=O,,,5,1,1,0,1
29199_0,,,,2,2,1,3
C(C(C)(C(C=O)(C=O)CC=O)O)=O,,,5,1,1,0,1
29201_0,,,,2,2,1,3
C(C(C=O)(CC=O)C(C(C)=O)O)=O,,,5,1,1,0,1
29203_0,,,,2,2,1,3
C(C(C=O)(CO)CC=O)=O,,,5,1,1,0,1
29205_0,,,,2,2,1,3
C(C(C=O)(C(CCO)O)CC=O)=O,,,5,1,1,0,1
29207_0,,,,2,2,1,3
C(C(C=O)(CC=O)C(C=O)O)=O,,,5,1,1,0,1
29209_0,,,,2,2,1,3
C(C(C=O)(C(C)(CO)O)CC=O)=O,,,5,1,1,0,1
29211_0,,,,2,2,1,3
C(C(C=O)(CC=O)C(C=CC)O)=O,,,5,1,1,0,1
29213_0,,,,2,2,1,3
C(C(C=O)(C(CC=C)O)CC=O)=O,,,5,1,1,0,1
29215_0,,,,2,2,1,3
C(C(C=O)(C(CO)O)CC=O)=O,,,5,1,1,0,1
29217_0,,,,2,2,1,3
C(C(C=O)(C(C(C)O)O)CC=O)=O,,,5,1,1,0,1
29219_0,,,,2,2,1,3
C(C(C=O)(CC=O)C(C(O)=O)O)=O,,,5,1,1,0,1
29221_0,,,,2,2,1,3
C(C(C=O)(CO)CC(C(O)=O)=O)=O,,,5,1,1,0,1
29223_0,,,,2,2,1,3
C(C(C(C(C=O)=O)=O)(C)C(C=C)O)=O,,,5,1,1,0,1
29225_0,,,,2,2,1,3
C(C(C(C(C=O)=O)=O)(C)C(C)O)=O,,,5,1,1,0,1
29227_0,,,,2,2,1,3
C(C(C(O)=O)(C(C(C=O)=O)=O)C)=O,,,5,1,1,0,1
29229_0,,,,2,2,1,3
C(C(C(C(C=O)=O)=O)(C)CO)=O,,,5,1,1,0,1
29231_0,,,,2,2,1,3
C(C(C=O)(C(CC(C=O)=O)O)O)=O,,,5,1,2,0,2
29231_1,,,,2,2,1,3
29232_0,,,,2,2,1,3
29233_0,,,,2,2,1,3
29233_1,,,,2,2,1,3
29235_0,,,,2,2,1,3
C(C(C=O)(C(C(CC=O)=O)O)O)=O,,,5,1,2,0,2
29235_1,,,,2,2,1,3
29237_0,,,,2,2,1,3
C(C(CO)C(C(CC=O)=O)O)(O)=O,,,5,1,1,0,1
29239_0,,,,2,2,1,3
C(C(CO)(C(C(CC=O)=O)O)O)=O,,,5,1,2,0,2
29239_1,,,,2,2,1,3
29241_0,,,,2,2,1,3
C(C(C=O)(C(C=O)(CC=O)O)O)=O,,,5,1,3,0,3
29241_1,,,,2,2,1,3
29242_0,,,,2,2,1,3
29243_0,,,,2,2,1,3
29243_1,,,,2,2,1,3
29245_0,,,,2,2,1,3
C(C(C(C(C(O)=O)=O)=O)(C)CO)=O,,,5,1,1,0,1
29247_0,,,,2,2,1,3
C(C(C=O)(CO)CC(C=O)=O)(O)=O,,,5,1,1,0,1
29249_0,,,,2,2,1,3
C(C(C=O)(CC=O)C(C=C)O)(O)=O,,,5,1,1,0,1
29251_0,,,,2,2,1,3
C(C(C=O)(C(C)O)CC=O)(O)=O,,,5,1,2,0,2
29253_0,,,,2,2,1,3
C(C(C(O)=O)(C(O)=O)CC=O)=O,,,5,1,2,0,2
29255_0,,,,2,2,1,3
C(C(C=O)(CO)CC=O)(O)=O,,,5,1,2,0,2
29257_0,,,,2,2,1,3
C(C(C=O)(CC=O)C(C=O)O)(O)=O,,,5,1,1,0,1
29259_0,,,,2,2,1,3
C(C(C=O)(C(CO)O)CC=O)(O)=O,,,5,1,1,0,1
29261_0,,,,2,2,1,3
C(C(C(C(C)=O)=O)(CO)CO)(O)=O,,,5,1,1,0,1
29263_0,,,,2,2,1,3
C(C(C(C(CO)=O)=O)(CO)C)(O)=O,,,5,1,1,0,1
29265_0,,,,2,2,1,3
C(C(C(C(O)=O)=O)(CO)C(C)O)=O,,,5,1,2,0,2
29267_0,,,,2,2,1,3
C(C(C=O)(C(C(O)=O)=O)CO)(O)=O,,,5,1,2,0,2
29269_0,,,,2,2,1,3
C(C(C(C(O)=O)=O)(CO)CO)=O,,,5,1,1,0,1
29271_0,,,,2,2,1,3
C(C(C=O)(C(C)O)C(C(O)=O)O)=O,,,5,1,1,0,1
29273_0,,,,2,2,1,3
C(C(C=O)(C=O)C(C(O)=O)O)(O)=O,,,5,1,1,0,1
29275_0,,,,2,2,1,3
C(C(C=O)(CO)C(C(O)=O)O)=O,,,5,1,1,0,1
29277_0,,,,2,2,1,3
C(C(C=O)(CO)C(C(O)=O)(C)O)=O,,,5,1,1,0,1
29279_0,,,,2,2,1,3
C(C(C(C(O)=O)=O)(C)C(C=C)O)=O,,,5,1,1,0,1
29281_0,,,,2,2,1,3
C(C(C(C(O)=O)=O)(C)C(C)O)=O,,,5,1,1,0,1
29283_0,,,,2,2,1,3
C(C(C(O)=O)(C(C(O)=O)=O)C)=O,,,5,1,1,0,1
29285_0,,,,2,2,1,3
C(C(C(C(O)=O)=O)(C)CO)=O,,,5,1,1,0,1
29287_0,,,,2,2,1,3
C(C(C(C(O)=O)=O)(C)C(C=O)O)=O,,,5,1,1,0,1
29289_0,,,,2,2,1,3
C(C(C(C(O)=O)=O)(C)C(CO)O)=O,,,5,1,1,0,1
29291_0,,,,2,2,1,3
C(C(C(C(C)=O)=O)(C)C(C)O)(O)=O,,,5,1,1,0,1
29293_0,,,,2,2,1,3
C(C(C(O)=O)(C(C(C)=O)=O)C)(O)=O,,,5,1,1,0,1
29295_0,,,,2,2,1,3
C(C(C(C(C)=O)=O)(C)CO)(O)=O,,,5,1,1,0,1
29297_0,,,,2,2,1,3
C(C(C=O)(C)C(C)(C(C)O)O)(O)=O,,,5,1,1,0,1
29299_0,,,,2,2,1,3
C(C(C=O)(C)C(CO)(CC)O)(O)=O,,,5,1,1,0,1
29301_0,,,,2,2,1,3
C(C(C=O)(C)C(CC=O)O)(O)=O,,,5,1,1,0,1
29303_0,,,,2,2,1,3
C(C(C=O)(C)C([CH]C(O)=O)O)(O)=O,,,5,1,1,0,1
29305_0,,,,2,2,1,3
C(C(C=O)(C)C(C=O)(C=C)O)(O)=O,,,5,1,1,0,1
29307_0,,,,2,2,1,3
C(C(C=O)(C)C(C(C=C)=O)O)(O)=O,,,5,1,1,0,1
29309_0,,,,2,2,1,3
C(C(C=O)(C)C(C=C)O)(O)=O,,,5,1,1,0,1
29311_0,,,,2,2,1,3
C(C(C=O)(C)C(C(CC)O)O)(O)=O,,,5,1,1,0,1
29313_0,,,,2,2,1,3
C(C(C=O)(C)C(CCCO)O)(O)=O,,,5,1,1,0,1
29315_0,,,,2,2,1,3
C(C(C=O)(C)C(C(O)O)O)(O)=O,,,5,1,1,0,1
29317_0,,,,2,2,1,3
C(C(C=O)(C)C(C)O)(O)=O,,,5,1,1,0,1
29319_0,,,,2,2,1,3
C(C(C(O)=O)(C(O)=O)C)=O,,,5,1,1,0,1
29321_0,,,,2,2,1,3
C(C(C=O)(C)C(CC(C)O)O)(O)=O,,,5,1,1,0,1
29323_0,,,,2,2,1,3
C(C(C=O)(C)C(CC(O)=O)O)(O)=O,,,5,1,1,0,1
29325_0,,,,2,2,1,3
C(C(C=O)(C)C(C(CO)=O)O)(O)=O,,,5,1,1,0,1
29327_0,,,,2,2,1,3
C(C(C=O)(C)C(C=O)(CO)O)(O)=O,,,5,1,1,0,1
29329_0,,,,2,2,1,3
C(C(C=O)(C)C(C=O)(C)O)(O)=O,,,5,1,1,0,1
29331_0,,,,2,2,1,3
C(C(C=O)(C)C(C(C)=O)O)(O)=O,,,5,1,1,0,1
29333_0,,,,2,2,1,3
C(C(C=O)(C)CO)(O)=O,,,5,1,1,0,1
29335_0,,,,2,2,1,3
C(C(C=O)(C)C(CCO)O)(O)=O,,,5,1,1,0,1
29337_0,,,,2,2,1,3
C(C(C=O)(C)C(C=O)O)(O)=O,,,5,1,1,0,1
29339_0,,,,2,2,1,3
C(C(C=O)(C)C(C(C=O)O)O)(O)=O,,,5,1,1,0,1
29341_0,,,,2,2,1,3
C(C(C=O)(C)C(CO)(CO)O)(O)=O,,,5,1,1,0,1
29343_0,,,,2,2,1,3
C(C(C=O)(C)C(C)(CO)O)(O)=O,,,5,1,1,0,1
29345_0,,,,2,2,1,3
C(C(C=O)(C)C(C=CC)O)(O)=O,,,5,1,1,0,1
29347_0,,,,2,2,1,3
C(C(C=O)(C)C(CC=C)O)(O)=O,,,5,1,1,0,1
29349_0,,,,2,2,1,3
C(C(C=O)(C)C(C(CO)O)O)(O)=O,,,5,1,1,0,1
29351_0,,,,2,2,1,3
C(C(C=O)(C)C(CO)O)(O)=O,,,5,1,1,0,1
29353_0,,,,2,2,1,3
C(C(C=O)(C)C(C(C)O)O)(O)=O,,,5,1,1,0,1
29355_0,,,,2,2,1,3
C(C(C=O)(C)C(C(O)=O)O)(O)=O,,,5,1,1,0,1
29357_0,,,,2,2,1,3
C(C(C=O)(C)C(C(O)=O)(C)O)(O)=O,,,5,1,1,0,1
29359_0,,,,2,2,1,3
C(C(C=O)(C(C(C(O)=O)C)O)O)=O,,,5,1,2,0,2
29359_1,,,,2,2,1,3
29361_0,,,,2,2,1,3
C(C(CO)C(C(C(O)=O)C)O)(O)=O,,,5,1,1,0,1
29363_0,,,,2,2,1,3
C(C(C)C(C(C=O)(CO)O)O)(O)=O,,,5,1,2,0,2
29363_1,,,,2,2,1,3
29365_0,,,,2,2,1,3
C(C(C=O)(C(C(O)=O)(CC)O)O)=O,,,5,1,2,0,2
29365_1,,,,2,2,1,3
29367_0,,,,2,2,1,3
C(C(CO)C(C(O)=O)(CC)O)(O)=O,,,5,1,1,0,1
29369_0,,,,2,2,1,3
C(C(CC)(C(C=O)(CO)O)O)(O)=O,,,5,1,2,0,2
29369_1,,,,2,2,1,3
29371_0,,,,2,2,1,3
C(C(C(C(O)=O)=O)(C)C(C)O)(O)=O,,,5,1,1,0,1
29373_0,,,,2,2,1,3
C(C(C(O)=O)(C(C(O)=O)=O)C)(O)=O,,,5,1,1,0,1
29375_0,,,,2,2,1,3
C(C(C(C(O)=O)=O)(C)CO)(O)=O,,,5,1,1,0,1
29376_0,,,,2,2,1,3
29376_1,,,,2,2,1,3
29378_0,,,,2,2,1,3
C(C(C=O)(C(C)(C(C)O)O)O)=O,,,5,1,2,0,2
29378_1,,,,2,2,1,3
29380_0,,,,2,2,1,3
C(C(C=O)(C(C)(C(C)O)O)O)(O)=O,,,5,1,2,0,2
29380_1,,,,2,2,1,3
29382_0,,,,2,2,1,3
C(C(CO)C(C)(C(C)O)O)(O)=O,,,5,1,1,0,1
29384_0,,,,2,2,1,3
C(C(C(C)O)C(C)(C(C)O)O)(O)=O,,,5,1,1,0,1
29386_0,,,,2,2,1,3
C(C(C(O)=O)C(C)(C(C)O)O)(O)=O,,,5,1,1,0,1
29388_0,,,,2,2,1,3
C(C(CO)(C(C)(C(C)O)O)O)=O,,,5,1,2,0,2
29388_1,,,,2,2,1,3
29390_0,,,,2,2,1,3
C(C(CO)(C(CO)(CC)O)O)(O)=O,,,5,1,2,0,2
29390_1,,,,2,2,1,3
29392_0,,,,2,2,1,3
C(C(C=O)(C(CO)(CC)O)O)=O,,,5,1,2,0,2
29392_1,,,,2,2,1,3
29394_0,,,,2,2,1,3
C(C(C=O)(C(CO)(CC)O)O)(O)=O,,,5,1,2,0,2
29394_1,,,,2,2,1,3
29396_0,,,,2,2,1,3
C(C(CO)C(CO)(CC)O)(O)=O,,,5,1,1,0,1
29398_0,,,,2,2,1,3
C(C(C(C)O)C(CO)(CC)O)(O)=O,,,5,1,1,0,1
29400_0,,,,2,2,1,3
C(C(C(O)=O)C(CO)(CC)O)(O)=O,,,5,1,1,0,1
29402_0,,,,2,2,1,3
C(C(CO)(C(CO)(CC)O)O)=O,,,5,1,2,0,2
29402_1,,,,2,2,1,3
29404_0,,,,2,2,1,3
C(CC(C1(C(C(O)OC1)=O)O)O)=O,,,5,1,2,0,2
29404_1,,,,2,2,1,3
29406_0,,,,2,2,1,3
C(CC(C1(C(C(OC1)=O)=O)O)O)=O,,,5,1,2,0,2
29406_1,,,,2,2,1,3
29408_0,,,,2,2,1,3
C1(C([C](C(O1)=O)O)C(CC=O)O)=O,,,5,1,1,0,1
29410_0,,,,2,2,1,3
C1(C(C(CC=O)O)C(C(O1)=O)O)=O,,,5,1,1,0,1
29411_0,,,,2,2,1,3
29411_1,,,,2,2,1,3
29413_0,,,,2,2,1,3
C(C(CO)(C(CC=O)O)C(C)O)=O,,,5,1,1,0,1
29415_0,,,,2,2,1,3
C(C(C=O)(CO)C(CC=O)O)(O)=O,,,5,1,1,0,1
29416_0,,,,2,2,1,3
29416_1,,,,2,2,1,3
29418_0,,,,2,2,1,3
C(C(C=O)(C(CC=O)O)O)=O,,,5,1,3,0,3
29418_1,,,,2,2,1,3
29419_0,,,,2,2,1,3
29419_1,,,,2,2,1,3
29420_0,,,,2,2,1,3
29421_0,,,,2,2,1,3
29422_0,,,,2,2,1,3
29423_0,,,,2,2,1,3
29423_1,,,,2,2,1,3
29424_0,,,,2,2,1,3
29424_1,,,,2,2,1,3
29426_0,,,,2,2,1,3
C(CC(C(C(O)=O)(C(C)=O)C)O)=O,,,5,1,1,0,1
29427_0,,,,2,2,1,3
29427_1,,,,2,2,1,3
29429_0,,,,2,2,1,3
C1(C(C(C(C(O1)=O)(CO)O)=O)C)=O,,,5,1,2,0,2
29429_1,,,,2,2,1,3
29431_0,,,,2,2,1,3
C1(C(C(C(C(O1)=O)O)=O)(CO)C)=O,,,5,1,1,0,1
29433_0,,,,2,2,1,3
C1(C(C=O)(CO)C(C(O1)=O)(C)O)=O,,,5,1,1,0,1
29435_0,,,,2,2,1,3
C1(C(C(C(C(O)=O)(CO)O1)=O)C)=O,,,5,1,2,0,2
29435_1,,,,2,2,1,3
29437_0,,,,2,2,1,3
C1(C(C(C(C(O)=O)O1)=O)(C)CO)=O,,,5,1,1,0,1
29439_0,,,,2,2,1,3
C(C(CO)(C([CH]C(O)=O)O)O)(O)=O,,,5,1,2,0,2
29439_1,,,,2,2,1,3
29441_0,,,,2,2,1,3
C(C(C=O)(C([CH]C(O)=O)O)O)=O,,,5,1,2,0,2
29441_1,,,,2,2,1,3
29443_0,,,,2,2,1,3
C(C(C=O)(C([CH]C(O)=O)O)O)(O)=O,,,5,1,2,0,2
29443_1,,,,2,2,1,3
29445_0,,,,2,2,1,3
C(C(CO)C([CH]C(O)=O)O)(O)=O,,,5,1,2,0,2
29447_0,,,,2,2,1,3
C(C(C(C)O)C([CH]C(O)=O)O)(O)=O,,,5,1,1,0,1
29449_0,,,,2,2,1,3
C(C(C(O)=O)C([CH]C(O)=O)O)(O)=O,,,5,1,1,0,1
29451_0,,,,2,2,1,3
C(C(CO)(C([CH]C(O)=O)O)O)=O,,,5,1,2,0,2
29451_1,,,,2,2,1,3
29453_0,,,,2,2,1,3
C(C(C=CC(C)O)(CO)C(C)O)=O,,,5,1,1,0,1
29455_0,,,,2,2,1,3
C(C(C=O)(C=CC(C)O)CO)(O)=O,,,5,1,1,0,1
29457_0,,,,2,2,1,3
C(C(C=CC(O)=O)(CO)C(C)O)=O,,,5,1,1,0,1
29459_0,,,,2,2,1,3
C(C(CO)C(C(C=O)=CC)O)(O)=O,,,5,1,1,0,1
29461_0,,,,2,2,1,3
C(C(C(C=O)=C)(C(C)O)C(C=C)O)=O,,,5,1,1,0,1
29463_0,,,,2,2,1,3
C(C(C(C=O)=C)(C(C)O)C(C)O)=O,,,5,1,1,0,1
29465_0,,,,2,2,1,3
C(C(C=O)(C(C=O)=C)C(C)O)(O)=O,,,5,1,2,0,2
29467_0,,,,2,2,1,3
C(C(C(C=O)=C)(CO)C(C)O)=O,,,5,1,2,0,2
29469_0,,,,2,2,1,3
C(C(C=O)(C(C(C(C)O)=C)O)O)=O,,,5,1,2,0,2
29469_1,,,,2,2,1,3
29471_0,,,,2,2,1,3
C(C(CO)C(C(C(C)O)=C)O)(O)=O,,,5,1,1,0,1
29473_0,,,,2,2,1,3
C(C(CO)(C(C(C(C)O)=C)O)O)=O,,,5,1,2,0,2
29473_1,,,,2,2,1,3
29475_0,,,,2,2,1,3
C(C(C=O)(C(C(CO)=CC)O)O)=O,,,5,1,2,0,2
29475_1,,,,2,2,1,3
29477_0,,,,2,2,1,3
C(C(CO)C(C(CO)=CC)O)(O)=O,,,5,1,1,0,1
29479_0,,,,2,2,1,3
C(C(CO)(C(C(CO)=CC)O)O)=O,,,5,1,2,0,2
29479_1,,,,2,2,1,3
29481_0,,,,2,2,1,3
C(C(C=O)(C=CC(O)=O)CO)(O)=O,,,5,1,1,0,1
29483_0,,,,2,2,1,3
C(C(C(O)=O)(C(C=O)=C)C(C=C)O)=O,,,5,1,1,0,1
29484_0,,,,2,2,1,3
29486_0,,,,2,2,1,3
C(C(C(O)=O)(C(O)=O)C(C=O)=C)=O,,,5,1,1,0,1
29488_0,,,,2,2,1,3
C(C(C=O)(C(C=O)=C)CO)(O)=O,,,5,1,2,0,2
29490_0,,,,2,2,1,3
C(C(C=O)(C(C=C(C=O)C)O)O)=O,,,5,1,2,0,2
29490_1,,,,2,2,1,3
29492_0,,,,2,2,1,3
C(C(CO)C(C=C(C=O)C)O)(O)=O,,,5,1,1,0,1
29494_0,,,,2,2,1,3
C(C(CO)(C(C=C(C=O)C)O)O)=O,,,5,1,2,0,2
29494_1,,,,2,2,1,3
29496_0,,,,2,2,1,3
C(C(C=O)(C(C(C)=CC=O)O)O)=O,,,5,1,2,0,2
29496_1,,,,2,2,1,3
29498_0,,,,2,2,1,3
C(C(CO)C(C(C)=CC=O)O)(O)=O,,,5,1,1,0,1
29500_0,,,,2,2,1,3
C(C(CO)(C(C(C)=CC=O)O)O)=O,,,5,1,2,0,2
29500_1,,,,2,2,1,3
29502_0,,,,2,2,1,3
C(C(C=O)(C(CC(C=O)=C)O)O)=O,,,5,1,2,0,2
29502_1,,,,2,2,1,3
29504_0,,,,2,2,1,3
C(C(CO)C(CC(C=O)=C)O)(O)=O,,,5,1,1,0,1
29506_0,,,,2,2,1,3
C(C(CO)(C(CC(C=O)=C)O)O)=O,,,5,1,2,0,2
29506_1,,,,2,2,1,3
29508_0,,,,2,2,1,3
C(C(C=O)(C(C(CC=O)=C)O)O)=O,,,5,1,2,0,2
29508_1,,,,2,2,1,3
29510_0,,,,2,2,1,3
C(C(CO)C(C(CC=O)=C)O)(O)=O,,,5,1,1,0,1
29512_0,,,,2,2,1,3
C(C(CO)(C(C(CC=O)=C)O)O)=O,,,5,1,2,0,2
29512_1,,,,2,2,1,3
29514_0,,,,2,2,1,3
C(C(C=O)(C(C=CC(C)=O)O)O)=O,,,5,1,2,0,2
29514_1,,,,2,2,1,3
29516_0,,,,2,2,1,3
C(C(CO)C(C=CC(C)=O)O)(O)=O,,,5,1,1,0,1
29518_0,,,,2,2,1,3
C(C(CO)(C(C=CC(C)=O)O)O)=O,,,5,1,2,0,2
29518_1,,,,2,2,1,3
29520_0,,,,2,2,1,3
C(C(C=O)(C(C=CC=O)(C)O)O)=O,,,5,1,2,0,2
29520_1,,,,2,2,1,3
29522_0,,,,2,2,1,3
C(C(CO)C(C=CC=O)(C)O)(O)=O,,,5,1,1,0,1
29524_0,,,,2,2,1,3
C(C(CO)(C(C=CC=O)(C)O)O)=O,,,5,1,2,0,2
29524_1,,,,2,2,1,3
29526_0,,,,2,2,1,3
C1(C([C](C(O1)=O)O)C(C=O)(C=C)O)=O,,,5,1,1,0,1
29528_0,,,,2,2,1,3
C(C(C=C)(C(C(O)=O)(CO)O)O)=O,,,5,1,2,0,2
29528_1,,,,2,2,1,3
29530_0,,,,2,2,1,3
C(C(C=O)(C(C=O)(C=C)O)O)=O,,,5,1,3,0,3
29530_1,,,,2,2,1,3
29532_0,,,,2,2,1,3
C(C(C=O)(C(C=O)(C=C)O)O)(O)=O,,,5,1,2,0,2
29532_1,,,,2,2,1,3
29534_0,,,,2,2,1,3
C(C(C=C)(C(C(O)=O)CO)O)=O,,,5,1,2,0,2
29536_0,,,,2,2,1,3
C(C(C=C)(C(C(O)=O)C(C)O)O)=O,,,5,1,1,0,1
29538_0,,,,2,2,1,3
C(C(C(O)=O)C(C=O)(C=C)O)(O)=O,,,5,1,1,0,1
29540_0,,,,2,2,1,3
C(C(C=C)(C(C=O)(CO)O)O)=O,,,5,1,3,0,3
29540_1,,,,2,2,1,3
29542_0,,,,2,2,1,3
C1(C([C](C(O1)=O)O)C(C(C=C)=O)O)=O,,,5,1,1,0,1
29544_0,,,,2,2,1,3
C(C(CO)(C(C(C=C)=O)O)O)(O)=O,,,5,1,2,0,2
29544_1,,,,2,2,1,3
29546_0,,,,2,2,1,3
C(C(C=O)(C(C(C=C)=O)O)O)=O,,,5,1,3,0,3
29546_1,,,,2,2,1,3
29548_0,,,,2,2,1,3
C(C(C=O)(C(C(C=C)=O)O)O)(O)=O,,,5,1,2,0,2
29548_1,,,,2,2,1,3
29550_0,,,,2,2,1,3
C(C(CO)C(C(C=C)=O)O)(O)=O,,,5,1,2,0,2
29552_0,,,,2,2,1,3
C(C(C(C)O)C(C(C=C)=O)O)(O)=O,,,5,1,1,0,1
29554_0,,,,2,2,1,3
C(C(C(O)=O)C(C(C=C)=O)O)(O)=O,,,5,1,1,0,1
29556_0,,,,2,2,1,3
C(C(CO)(C(C(C=C)=O)O)O)=O,,,5,1,3,0,3
29556_1,,,,2,2,1,3
29558_0,,,,2,2,1,3
C(C(C=O)(C(C=O)(CC=C)O)O)=O,,,5,1,2,0,2
29558_1,,,,2,2,1,3
29560_0,,,,2,2,1,3
C(C(CO)C(C=O)(CC=C)O)(O)=O,,,5,1,1,0,1
29562_0,,,,2,2,1,3
C(C(CO)(C(C=O)(CC=C)O)O)=O,,,5,1,2,0,2
29562_1,,,,2,2,1,3
29564_0,,,,2,2,1,3
C(C(C=O)(C(C(CC=C)=O)O)O)=O,,,5,1,2,0,2
29564_1,,,,2,2,1,3
29566_0,,,,2,2,1,3
C(C(CO)C(C(CC=C)=O)O)(O)=O,,,5,1,1,0,1
29568_0,,,,2,2,1,3
C(C(CO)(C(C(CC=C)=O)O)O)=O,,,5,1,2,0,2
29568_1,,,,2,2,1,3
29570_0,,,,2,2,1,3
C(C(C=CC)(C(C=O)(C=O)O)O)=O,,,5,1,2,0,2
29570_1,,,,2,2,1,3
29572_0,,,,2,2,1,3
C(C(CO)C(C=O)(C=CC)O)(O)=O,,,5,1,1,0,1
29574_0,,,,2,2,1,3
C(C(CO)(C(C=O)(C=CC)O)O)=O,,,5,1,2,0,2
29574_1,,,,2,2,1,3
29576_0,,,,2,2,1,3
C(C(C=O)(C(C(C=CC)=O)O)O)=O,,,5,1,2,0,2
29576_1,,,,2,2,1,3
29578_0,,,,2,2,1,3
C(C(CO)C(C(C=CC)=O)O)(O)=O,,,5,1,1,0,1
29580_0,,,,2,2,1,3
C(C(CO)(C(C(C=CC)=O)O)O)=O,,,5,1,2,0,2
29580_1,,,,2,2,1,3
29582_0,,,,2,2,1,3
C(C(C(C=C)O)(C(C=C)O)O)(O)=O,,,5,1,2,0,2
29582_1,,,,2,2,1,3
29584_0,,,,2,2,1,3
C(C(CO)(C(C=C)O)O)(C(C)O)=O,,,5,1,2,0,2
29584_1,,,,2,2,1,3
29586_0,,,,2,2,1,3
C(C(C)(C(CO)O)C(C=C)O)(O)=O,,,5,1,1,0,1
29588_0,,,,2,2,1,3
C1(C(C(C(C)O1)O)(C(C=C)O)O)=O,,,5,1,2,0,2
29588_1,,,,2,2,1,3
29590_0,,,,2,2,1,3
C1(C(C(C(O1)=O)(C(C=C)O)O)O)=O,,,5,1,2,0,2
29590_1,,,,2,2,1,3
29592_0,,,,2,2,1,3
C(C(CO)(C(C=C)O)CC=O)(O)=O,,,5,1,1,0,1
29594_0,,,,2,2,1,3
C(C(C)(C(C=O)O)C(C=C)O)(O)=O,,,5,1,1,0,1
29596_0,,,,2,2,1,3
C1(C(O)OCC1(C(C=C)O)O)=O,,,5,1,2,0,2
29596_1,,,,2,2,1,3
29598_0,,,,2,2,1,3
C1(C(O)OC(C)C1(C(C=C)O)O)=O,,,5,1,2,0,2
29598_1,,,,2,2,1,3
29600_0,,,,2,2,1,3
C1(C(C(C(O)O1)=O)(C(C=C)O)O)=O,,,5,1,2,0,2
29600_1,,,,2,2,1,3
29602_0,,,,2,2,1,3
C1(C(C(CC(O)O1)O)C(C=C)O)=O,,,5,1,1,0,1
29604_0,,,,2,2,1,3
C=CC(C1(C(C(OC1)=O)=O)O)O,,,5,1,2,0,2
29604_1,,,,2,2,1,3
29606_0,,,,2,2,1,3
C=CC(C1(C(C(OC1C)=O)=O)O)O,,,5,1,2,0,2
29606_1,,,,2,2,1,3
29608_0,,,,2,2,1,3
C1(C(C(C(O1)=O)=O)(C(C=C)O)O)=O,,,5,1,2,0,2
29608_1,,,,2,2,1,3
29610_0,,,,2,2,1,3
C1(C(C)(C(C(O1)=O)C(C=C)O)O)=O,,,5,1,1,0,1
29612_0,,,,2,2,1,3
C1(C([C](C(O1)=O)O)C(C=C)O)=O,,,5,1,1,0,1
29614_0,,,,2,2,1,3
C1(C(C(C(O1)=O)C(C=C)O)O)=O,,,5,1,1,0,1
29616_0,,,,2,2,1,3
C(C1(C(C)OC([CH]C1)=O)C(C=C)O)=O,,,5,1,1,0,1
29618_0,,,,2,2,1,3
C1(CCC(C=O)(C(C)O1)C(C=C)O)=O,,,5,1,1,0,1
29620_0,,,,2,2,1,3
C1(C(C=O)(C[CH]C(O1)=O)C(C=C)O)=O,,,5,1,1,0,1
29622_0,,,,2,2,1,3
C1(CCC(C(O1)=O)(C=O)C(C=C)O)=O,,,5,1,1,0,1
29624_0,,,,2,2,1,3
C(C(CO)(C(C=C)O)O)(O)=O,,,5,1,6,0,6
29624_1,,,,2,2,1,3
29626_0,,,,2,2,1,3
C(C(CO)(C(C)O)C(C=C)O)=O,,,5,1,3,0,3
29628_0,,,,2,2,1,3
C(C(C(C)O)(C(C)O)C(C=C)O)=O,,,5,1,1,0,1
29630_0,,,,2,2,1,3
C(C(C=O)(C(C)O)C(C=C)O)(O)=O,,,5,1,1,0,1
29632_0,,,,2,2,1,3
C(C(C(CC=O)O)C(C=C)O)(O)=O,,,5,1,1,0,1
29634_0,,,,2,2,1,3
C(C(C=O)(CO)C(C=C)O)(O)=O,,,5,1,3,0,3
29636_0,,,,2,2,1,3
C(C(C(O)=O)(C=O)C(C=C)O)(O)=O,,,5,1,1,0,1
29638_0,,,,2,2,1,3
C=CC(C(C(C=O)=O)(CO)O)O,,,5,1,4,0,4
29638_1,,,,2,2,1,3
29640_0,,,,2,2,1,3
C=CC(C(C(C=O)=O)(C(C)O)O)O,,,5,1,2,0,2
29640_1,,,,2,2,1,3
29642_0,,,,2,2,1,3
C(C(C(C=O)=O)(C(C=C)O)O)(O)=O,,,5,1,2,0,2
29642_1,,,,2,2,1,3
29644_0,,,,2,2,1,3
C=CC(C(C(C(O)=O)=O)(CO)O)O,,,5,1,2,0,2
29644_1,,,,2,2,1,3
29646_0,,,,2,2,1,3
C(C(C=O)(C(C=C)O)O)=O,,,5,1,4,0,4
29646_1,,,,2,2,1,3
29648_0,,,,2,2,1,3
C(C(C=O)(C(C=C)O)O)(O)=O,,,5,1,4,0,4
29648_1,,,,2,2,1,3
29650_0,,,,2,2,1,3
C(C(CO)C(C=C)O)(O)=O,,,5,1,3,0,3
29652_0,,,,2,2,1,3
C(C(C(C)O)C(C=C)O)(O)=O,,,5,1,3,0,3
29654_0,,,,2,2,1,3
C(C(C(O)=O)C(C=C)O)(O)=O,,,5,1,3,0,3
29656_0,,,,2,2,1,3
C(C(C(C)O)(C(C=C)O)O)(O)=O,,,5,1,6,0,6
29656_1,,,,2,2,1,3
29658_0,,,,2,2,1,3
C(C(C(O)=O)(C(C=C)O)O)(O)=O,,,5,1,6,0,6
29658_1,,,,2,2,1,3
29660_0,,,,2,2,1,3
C(C)(C(C(O)=O)(CO)C(C=C)O)=O,,,5,1,1,0,1
29662_0,,,,2,2,1,3
C(C)(C(C(O)=O)(C)C(C=C)O)=O,,,5,1,3,0,3
29664_0,,,,2,2,1,3
C(C(CO)(C(C=C)O)O)=O,,,5,1,4,0,4
29664_1,,,,2,2,1,3
29666_0,,,,2,2,1,3
C(C([C](C(O)=O)O)C(C=C)O)(O)=O,,,5,1,1,0,1
29668_0,,,,2,2,1,3
C(C(C(C(O)=O)C(C=C)O)O)(O)=O,,,5,1,1,0,1
29670_0,,,,2,2,1,3
C(C(C=C)(C(C=O)(C=O)O)O)(O)=O,,,5,1,3,0,3
29670_1,,,,2,2,1,3
29672_0,,,,2,2,1,3
C(C(C=C)(C(C(O)=O)CO)O)(O)=O,,,5,1,1,0,1
29674_0,,,,2,2,1,3
C(C(C=C)(C(C=O)(CO)O)O)(O)=O,,,5,1,3,0,3
29674_1,,,,2,2,1,3
29675_0,,,,2,2,1,3
29676_0,,,,2,2,1,3
29676_1,,,,2,2,1,3
29677_0,,,,2,2,1,3
29677_1,,,,2,2,1,3
29678_0,,,,2,2,1,3
29678_1,,,,2,2,1,3
29679_0,,,,2,2,1,3
29679_1,,,,2,2,1,3
29680_0,,,,2,2,1,3
29680_1,,,,2,2,1,3
29682_0,,,,2,2,1,3
C1(C(CO)(C(C(C(O1)=O)=C)O)O)=O,,,5,1,2,0,2
29682_1,,,,2,2,1,3
29684_0,,,,2,2,1,3
C(C1(CO)C(C(C(O1)=O)=C)O)(O)=O,,,5,1,2,0,2
29684_1,,,,2,2,1,3
29685_0,,,,2,2,1,3
29686_0,,,,2,2,1,3
29687_0,,,,2,2,1,3
29688_0,,,,2,2,1,3
29688_1,,,,2,2,1,3
29689_0,,,,2,2,1,3
29689_1,,,,2,2,1,3
29690_0,,,,2,2,1,3
29690_1,,,,2,2,1,3
29691_0,,,,2,2,1,3
29691_1,,,,2,2,1,3
29692_0,,,,2,2,1,3
29692_1,,,,2,2,1,3
29694_0,,,,2,2,1,3
C(C(C)(C(CO)O)C(C)O)(O)=O,,,5,1,3,0,3
29696_0,,,,2,2,1,3
C(C(C(O)=O)(C)C(CO)O)(O)=O,,,5,1,2,0,2
29698_0,,,,2,2,1,3
C(C(C)(CO)C(CO)O)(O)=O,,,5,1,3,0,3
29700_0,,,,2,2,1,3
C(C(C)(C(CO)O)C(C=O)O)(O)=O,,,5,1,4,0,4
29702_0,,,,2,2,1,3
C(C(C)(C(CO)O)C(CO)O)(O)=O,,,5,1,3,0,3
29704_0,,,,2,2,1,3
C1(C(C(C)O)(C(C(C)O1)O)O)=O,,,5,1,3,0,3
29704_1,,,,2,2,1,3
29706_0,,,,2,2,1,3
C1(C(C(O)=O)(C(C(C)O1)O)O)=O,,,5,1,3,0,3
29706_1,,,,2,2,1,3
29708_0,,,,2,2,1,3
C1(C(CO)(C(C(C)O1)O)O)=O,,,5,1,3,0,3
29708_1,,,,2,2,1,3
29709_0,,,,2,2,1,3
29709_1,,,,2,2,1,3
29711_0,,,,2,2,1,3
C1(C(C(CO)O)(C(C(C)O1)O)O)=O,,,5,1,2,0,2
29711_1,,,,2,2,1,3
29713_0,,,,2,2,1,3
C1(C(C(C)O)(C(C(O1)=O)O)O)=O,,,5,1,4,0,4
29713_1,,,,2,2,1,3
29715_0,,,,2,2,1,3
C1(C(C(O)=O)(C(C(O1)=O)O)O)=O,,,5,1,4,0,4
29715_1,,,,2,2,1,3
29716_0,,,,2,2,1,3
29716_1,,,,2,2,1,3
29717_0,,,,2,2,1,3
29717_1,,,,2,2,1,3
29719_0,,,,2,2,1,3
C1(C(C(CO)O)(C(C(O1)=O)O)O)=O,,,5,1,3,0,3
29719_1,,,,2,2,1,3
29720_0,,,,2,2,1,3
29720_1,,,,2,2,1,3
29721_0,,,,2,2,1,3
29721_1,,,,2,2,1,3
29723_0,,,,2,2,1,3
C(C(CO)(C(C(CC)O)O)O)(O)=O,,,5,1,3,0,3
29723_1,,,,2,2,1,3
29725_0,,,,2,2,1,3
C(C(C=O)(C(C(CC)O)O)O)=O,,,5,1,3,0,3
29725_1,,,,2,2,1,3
29727_0,,,,2,2,1,3
C(C(C=O)(C(C(CC)O)O)O)(O)=O,,,5,1,3,0,3
29727_1,,,,2,2,1,3
29729_0,,,,2,2,1,3
C(C(CO)C(C(CC)O)O)(O)=O,,,5,1,2,0,2
29731_0,,,,2,2,1,3
C(C(C(C)O)C(C(CC)O)O)(O)=O,,,5,1,2,0,2
29733_0,,,,2,2,1,3
C(C(C(O)=O)C(C(CC)O)O)(O)=O,,,5,1,2,0,2
29735_0,,,,2,2,1,3
C(C(CO)(C(C(CC)O)O)O)=O,,,5,1,3,0,3
29735_1,,,,2,2,1,3
29737_0,,,,2,2,1,3
C(C(CO)(C(CCCO)O)O)(O)=O,,,5,1,3,0,3
29737_1,,,,2,2,1,3
29739_0,,,,2,2,1,3
C(C(C=O)(C(CCCO)O)O)=O,,,5,1,3,0,3
29739_1,,,,2,2,1,3
29741_0,,,,2,2,1,3
C(C(C=O)(C(CCCO)O)O)(O)=O,,,5,1,3,0,3
29741_1,,,,2,2,1,3
29743_0,,,,2,2,1,3
C(C(CO)C(CCCO)O)(O)=O,,,5,1,2,0,2
29745_0,,,,2,2,1,3
C(C(C(C)O)C(CCCO)O)(O)=O,,,5,1,2,0,2
29747_0,,,,2,2,1,3
C(C(C(O)=O)C(CCCO)O)(O)=O,,,5,1,2,0,2
29749_0,,,,2,2,1,3
C(C(CO)(C(CCCO)O)O)=O,,,5,1,3,0,3
29749_1,,,,2,2,1,3
29751_0,,,,2,2,1,3
C(C(CO)(C(C)O)CC=O)(O)=O,,,5,1,2,0,2
29753_0,,,,2,2,1,3
C(C(C(O)=O)(CO)CC=O)(O)=O,,,5,1,1,0,1
29755_0,,,,2,2,1,3
C(C(CO)(CO)CC=O)(O)=O,,,5,1,2,0,2
29757_0,,,,2,2,1,3
C(C(CO)(C(C=O)O)CC=O)(O)=O,,,5,1,2,0,2
29759_0,,,,2,2,1,3
C(C(CO)(C(CO)O)CC=O)(O)=O,,,5,1,2,0,2
29761_0,,,,2,2,1,3
C(C(C)(C(C)O)C(C=O)O)(O)=O,,,5,1,1,0,1
29763_0,,,,2,2,1,3
C(C(C(O)=O)(C)C(C=O)O)(O)=O,,,5,1,1,0,1
29765_0,,,,2,2,1,3
C(C(CO)(C)C(C=O)O)(O)=O,,,5,1,1,0,1
29767_0,,,,2,2,1,3
C(C(C)(C(C=O)O)C(C=O)O)(O)=O,,,5,1,1,0,1
29768_0,,,,2,2,1,3
29770_0,,,,2,2,1,3
C1(C(CO)(C)C(C(C(O1)=O)=O)O)=O,,,5,1,1,0,1
29772_0,,,,2,2,1,3
C1(C(CO)(CO)CC(C(O1)=O)=O)=O,,,5,1,1,0,1
29774_0,,,,2,2,1,3
C(C1(CO)C(C)OC(C1(C)O)O)=O,,,5,1,2,0,2
29776_0,,,,2,2,1,3
C(C1(CO)C(C)OC(C)(C1O)O)=O,,,5,1,2,0,2
29778_0,,,,2,2,1,3
C(C(CO)C1CC(C(O)O1)=O)(O)=O,,,5,1,2,0,2
29780_0,,,,2,2,1,3
C1(C(C=O)(CO)C(C)(C(O)O1)O)=O,,,5,1,2,0,2
29782_0,,,,2,2,1,3
C1(C(C=O)(CO)C(C(C)(O)O1)O)=O,,,5,1,2,0,2
29784_0,,,,2,2,1,3
C(C1(C)C(C(C(O1)O)=O)(CO)O)=O,,,5,1,3,0,3
29784_1,,,,2,2,1,3
29786_0,,,,2,2,1,3
C(C)(C1(CO)C(C(C(O1)O)=O)O)=O,,,5,1,3,0,3
29786_1,,,,2,2,1,3
29788_0,,,,2,2,1,3
C(C1C(C(C(O1)O)=O)(CO)O)(C)=O,,,5,1,3,0,3
29788_1,,,,2,2,1,3
29790_0,,,,2,2,1,3
C1(C(O)OCC1(C(C(O)O)O)O)=O,,,5,1,2,0,2
29790_1,,,,2,2,1,3
29792_0,,,,2,2,1,3
C1(C(O)OCC1(C(C)O)O)=O,,,5,1,3,0,3
29792_1,,,,2,2,1,3
29794_0,,,,2,2,1,3
C(C1(C(C(O)OC1)=O)O)(O)=O,,,5,1,3,0,3
29794_1,,,,2,2,1,3
29796_0,,,,2,2,1,3
C(C(C)(C1(C(C(O)OC1)=O)O)O)=O,,,5,1,3,0,3
29796_1,,,,2,2,1,3
29798_0,,,,2,2,1,3
C(C(C1(C(C(O)OC1)=O)O)O)(C)=O,,,5,1,3,0,3
29798_1,,,,2,2,1,3
29800_0,,,,2,2,1,3
C1(C(O)OCC1(CO)O)=O,,,5,1,3,0,3
29800_1,,,,2,2,1,3
29802_0,,,,2,2,1,3
C1(C(O)OCC1(C(CCO)O)O)=O,,,5,1,3,0,3
29802_1,,,,2,2,1,3
29804_0,,,,2,2,1,3
C1(C(O)OCC1(C(C=O)O)O)=O,,,5,1,3,0,3
29804_1,,,,2,2,1,3
29806_0,,,,2,2,1,3
C1(C(O)OCC1(C(CO)(C)O)O)=O,,,5,1,3,0,3
29806_1,,,,2,2,1,3
29808_0,,,,2,2,1,3
C1(C(O)OCC1(C(C=CC)O)O)=O,,,5,1,3,0,3
29808_1,,,,2,2,1,3
29810_0,,,,2,2,1,3
C1(C(O)OCC1(C(CC=C)O)O)=O,,,5,1,3,0,3
29810_1,,,,2,2,1,3
29812_0,,,,2,2,1,3
C1(C(O)OCC1(C(CO)O)O)=O,,,5,1,3,0,3
29812_1,,,,2,2,1,3
29814_0,,,,2,2,1,3
C1(C(O)OCC1(C(C(C)O)O)O)=O,,,5,1,3,0,3
29814_1,,,,2,2,1,3
29816_0,,,,2,2,1,3
C1(C(O)OCC1(C(C(O)=O)O)O)=O,,,5,1,3,0,3
29816_1,,,,2,2,1,3
29818_0,,,,2,2,1,3
C1(C(O)OC(C)C1(C(C)O)O)=O,,,5,1,3,0,3
29818_1,,,,2,2,1,3
29820_0,,,,2,2,1,3
C(C1(C(C(O)OC1C)=O)O)(O)=O,,,5,1,3,0,3
29820_1,,,,2,2,1,3
29822_0,,,,2,2,1,3
C1(C(O)OC(C)C1(CO)O)=O,,,5,1,3,0,3
29822_1,,,,2,2,1,3
29824_0,,,,2,2,1,3
C1(C(O)OC(C)C1(C(C=O)O)O)=O,,,5,1,3,0,3
29824_1,,,,2,2,1,3
29826_0,,,,2,2,1,3
C1(C(O)OC(C)C1(C(CO)O)O)=O,,,5,1,3,0,3
29826_1,,,,2,2,1,3
29828_0,,,,2,2,1,3
C1(C(C(C(O)O1)=O)(C(C)O)O)=O,,,5,1,3,0,3
29828_1,,,,2,2,1,3
29830_0,,,,2,2,1,3
C1(C(C(O)=O)(C(C(O)O1)=O)O)=O,,,5,1,3,0,3
29830_1,,,,2,2,1,3
29832_0,,,,2,2,1,3
C1(C(C(C(O)O1)=O)(CO)O)=O,,,5,1,3,0,3
29832_1,,,,2,2,1,3
29834_0,,,,2,2,1,3
C1(C(C(C(O)O1)=O)(C(C=O)O)O)=O,,,5,1,3,0,3
29834_1,,,,2,2,1,3
29836_0,,,,2,2,1,3
C1(C(C(C(O)O1)=O)(C(CO)O)O)=O,,,5,1,3,0,3
29836_1,,,,2,2,1,3
29838_0,,,,2,2,1,3
C(C(C=O)(C1(C(O)OCC1)O)O)=O,,,5,1,3,0,3
29838_1,,,,2,2,1,3
29840_0,,,,2,2,1,3
C(C(CO)C1(C(O)OCC1)O)(O)=O,,,5,1,2,0,2
29842_0,,,,2,2,1,3
C(C(CO)(C1(C(O)OCC1)O)O)=O,,,5,1,3,0,3
29842_1,,,,2,2,1,3
29843_0,,,,2,2,1,3
29843_1,,,,2,2,1,3
29844_0,,,,2,2,1,3
29844_1,,,,2,2,1,3
29846_0,,,,2,2,1,3
C1(C(C(C)O)(C(C)(C(O)O1)O)O)=O,,,5,1,3,0,3
29846_1,,,,2,2,1,3
29848_0,,,,2,2,1,3
C1(C(C(O)=O)(C(C(O)O1)(C)O)O)=O,,,5,1,3,0,3
29848_1,,,,2,2,1,3
29849_0,,,,2,2,1,3
29849_1,,,,2,2,1,3
29851_0,,,,2,2,1,3
C1(C(C(C)O)(C(C(C)(O)O1)O)O)=O,,,5,1,3,0,3
29851_1,,,,2,2,1,3
29853_0,,,,2,2,1,3
C1(C(C(O)=O)(C(C(C)(O)O1)O)O)=O,,,5,1,3,0,3
29853_1,,,,2,2,1,3
29854_0,,,,2,2,1,3
29854_1,,,,2,2,1,3
29856_0,,,,2,2,1,3
C1(C(CO)C(CC(C=O)(O)O1)O)=O,,,5,1,2,0,2
29858_0,,,,2,2,1,3
C1(C(C(C)O)C(CC(O)O1)O)=O,,,5,1,2,0,2
29860_0,,,,2,2,1,3
C1(C(C(O)=O)C(CC(O)O1)O)=O,,,5,1,2,0,2
29862_0,,,,2,2,1,3
C1(C(CO)C(CC(O)O1)O)=O,,,5,1,2,0,2
29864_0,,,,2,2,1,3
C1(C(C(CC(O)O1)O)C(C=O)O)=O,,,5,1,2,0,2
29866_0,,,,2,2,1,3
C1(C(C(CO)O)C(CC(O)O1)O)=O,,,5,1,2,0,2
29868_0,,,,2,2,1,3
C(C1(C(O)OC([CH]C1)=O)CO)(O)=O,,,5,1,2,0,2
29870_0,,,,2,2,1,3
C(C1(CCC(OC1O)=O)CO)(O)=O,,,5,1,2,0,2
29872_0,,,,2,2,1,3
C1(C(CO)C(CC(C(O)O1)=O)O)=O,,,5,1,2,0,2
29874_0,,,,2,2,1,3
C(C1(CO)C(C)OC(C1(C)O)=O)=O,,,5,1,1,0,1
29876_0,,,,2,2,1,3
C1(C(C(CO1)(C(C)O)C(C)O)=O)=O,,,5,1,1,0,1
29878_0,,,,2,2,1,3
C(C1(C(C(OC1)=O)=O)C(C)O)(O)=O,,,5,1,2,0,2
29880_0,,,,2,2,1,3
C1(C(C(CO1)(CO)C(C)O)=O)=O,,,5,1,2,0,2
29882_0,,,,2,2,1,3
C1(CC(C(C(C=O)=O)(CO)O1)O)=O,,,5,1,2,0,2
29882_1,,,,2,2,1,3
29884_0,,,,2,2,1,3
C1(C(CO)C(C(C(C=O)=O)O1)O)=O,,,5,1,1,0,1
29886_0,,,,2,2,1,3
C(C(C1CC(C(O1)=O)=O)CO)(O)=O,,,5,1,1,0,1
29888_0,,,,2,2,1,3
C1(C(C=O)(CO)C(C=O)(CO1)O)=O,,,5,1,1,0,1
29890_0,,,,2,2,1,3
C(C1(COC(C1(C)O)=O)C(C)O)=O,,,5,1,1,0,1
29892_0,,,,2,2,1,3
C(C1(C=O)COC(C1(C)O)=O)(O)=O,,,5,1,1,0,1
29894_0,,,,2,2,1,3
C(C1(CO)COC(C1(C)O)=O)=O,,,5,1,2,0,2
29895_0,,,,2,2,1,3
29897_0,,,,2,2,1,3
C(C1(C(O)=O)C(C(OC1)=O)=O)(O)=O,,,5,1,1,0,1
29899_0,,,,2,2,1,3
C(C1(C(C(OC1)=O)=O)CO)(O)=O,,,5,1,2,0,2
29901_0,,,,2,2,1,3
C(C1(C)C(C(C(O1)=O)=O)(CO)O)=O,,,5,1,2,0,2
29901_1,,,,2,2,1,3
29903_0,,,,2,2,1,3
C(C1C(C(C(O1)=O)=O)(CO)O)(C)=O,,,5,1,2,0,2
29903_1,,,,2,2,1,3
29905_0,,,,2,2,1,3
C(C)(C1(CO)C(C(C(O1)=O)=O)O)=O,,,5,1,2,0,2
29905_1,,,,2,2,1,3
29907_0,,,,2,2,1,3
C1(C(C(CO1)(C(C(O)O)O)O)=O)=O,,,5,1,2,0,2
29907_1,,,,2,2,1,3
29909_0,,,,2,2,1,3
C1(C(C(CO1)(C(C)O)O)=O)=O,,,5,1,3,0,3
29909_1,,,,2,2,1,3
29911_0,,,,2,2,1,3
C(C1(C(C(OC1)=O)=O)O)(O)=O,,,5,1,3,0,3
29911_1,,,,2,2,1,3
29913_0,,,,2,2,1,3
C(C(C)(C1(C(C(OC1)=O)=O)O)O)=O,,,5,1,3,0,3
29913_1,,,,2,2,1,3
29914_0,,,,2,2,1,3
29914_1,,,,2,2,1,3
29916_0,,,,2,2,1,3
C1(C(C(CO)(CO1)O)=O)=O,,,5,1,3,0,3
29916_1,,,,2,2,1,3
29918_0,,,,2,2,1,3
C1(C(C(CO1)(C(CCO)O)O)=O)=O,,,5,1,2,0,2
29918_1,,,,2,2,1,3
29919_0,,,,2,2,1,3
29919_1,,,,2,2,1,3
29921_0,,,,2,2,1,3
C1(C(C(CO1)(C(CO)(C)O)O)=O)=O,,,5,1,2,0,2
29921_1,,,,2,2,1,3
29923_0,,,,2,2,1,3
C(C)=CC(C1(C(C(OC1)=O)=O)O)O,,,5,1,2,0,2
29923_1,,,,2,2,1,3
29925_0,,,,2,2,1,3
C=CCC(C1(C(C(OC1)=O)=O)O)O,,,5,1,2,0,2
29925_1,,,,2,2,1,3
29927_0,,,,2,2,1,3
C1(C(C(CO1)(C(CO)O)O)=O)=O,,,5,1,3,0,3
29927_1,,,,2,2,1,3
29929_0,,,,2,2,1,3
C1(C(C(CO1)(C(C(C)O)O)O)=O)=O,,,5,1,2,0,2
29929_1,,,,2,2,1,3
29931_0,,,,2,2,1,3
C(C(C1(C(C(OC1)=O)=O)O)O)(O)=O,,,5,1,3,0,3
29931_1,,,,2,2,1,3
29933_0,,,,2,2,1,3
C(C(C=O)(C1(C(OCC1)=O)O)O)=O,,,5,1,2,0,2
29933_1,,,,2,2,1,3
29935_0,,,,2,2,1,3
C(C(CO)C1(C(OCC1)=O)O)(O)=O,,,5,1,1,0,1
29937_0,,,,2,2,1,3
C1(C(CCO1)(C(C=O)(CO)O)O)=O,,,5,1,2,0,2
29937_1,,,,2,2,1,3
29939_0,,,,2,2,1,3
C1(C(C(C(C)O)(C(C)O1)O)=O)=O,,,5,1,3,0,3
29939_1,,,,2,2,1,3
29941_0,,,,2,2,1,3
C(C1(C(C(OC1C)=O)=O)O)(O)=O,,,5,1,3,0,3
29941_1,,,,2,2,1,3
29943_0,,,,2,2,1,3
C1(C(C(CO)(C(C)O1)O)=O)=O,,,5,1,3,0,3
29943_1,,,,2,2,1,3
29945_0,,,,2,2,1,3
C(C(C1(C(C(OC1C)=O)=O)O)O)=O,,,5,1,2,0,2
29945_1,,,,2,2,1,3
29947_0,,,,2,2,1,3
C1(C(C(C(CO)O)(C(C)O1)O)=O)=O,,,5,1,2,0,2
29947_1,,,,2,2,1,3
29949_0,,,,2,2,1,3
C1(C(C(C(O1)=O)=O)(C(C)O)O)=O,,,5,1,3,0,3
29949_1,,,,2,2,1,3
29951_0,,,,2,2,1,3
C1(C(C(O)=O)(C(C(O1)=O)=O)O)=O,,,5,1,3,0,3
29951_1,,,,2,2,1,3
29953_0,,,,2,2,1,3
C1(C(C(C(O1)=O)=O)(CO)O)=O,,,5,1,3,0,3
29953_1,,,,2,2,1,3
29955_0,,,,2,2,1,3
C1(C(C(C(O1)=O)=O)(C(C=O)O)O)=O,,,5,1,2,0,2
29955_1,,,,2,2,1,3
29957_0,,,,2,2,1,3
C1(C(C(C(O1)=O)=O)(C(CO)O)O)=O,,,5,1,2,0,2
29957_1,,,,2,2,1,3
29959_0,,,,2,2,1,3
C1(C(C(C)O)C(C(O1)=O)(C)O)=O,,,5,1,2,0,2
29960_0,,,,2,2,1,3
29961_0,,,,2,2,1,3
29963_0,,,,2,2,1,3
C1(C(C)(C(C(O1)=O)C(C=O)O)O)=O,,,5,1,1,0,1
29965_0,,,,2,2,1,3
C1(C(C(CO)O)C(C(O1)=O)(C)O)=O,,,5,1,1,0,1
29967_0,,,,2,2,1,3
C(C1(C(CC(O1)=O)O)C(C)O)(O)=O,,,5,1,2,0,2
29967_1,,,,2,2,1,3
29969_0,,,,2,2,1,3
C(C1(C(O)=O)C(CC(O1)=O)O)(O)=O,,,5,1,2,0,2
29969_1,,,,2,2,1,3
29970_0,,,,2,2,1,3
29970_1,,,,2,2,1,3
29972_0,,,,2,2,1,3
C1(C(C(C(C(O)=O)O1)O)C(C)O)=O,,,5,1,1,0,1
29974_0,,,,2,2,1,3
C(C1C(OC(C(O)=O)C1O)=O)(O)=O,,,5,1,1,0,1
29976_0,,,,2,2,1,3
C1(C(CO)C(C(C(O)=O)O1)O)=O,,,5,1,3,0,3
29978_0,,,,2,2,1,3
C1(C(CO)C(C(C(O)=O)(C)O1)O)=O,,,5,1,1,0,1
29980_0,,,,2,2,1,3
C1(C(C(C)O)(C(C=O)(CO1)O)O)=O,,,5,1,2,0,2
29980_1,,,,2,2,1,3
29982_0,,,,2,2,1,3
C1(C(C(O)=O)(C(C=O)(CO1)O)O)=O,,,5,1,2,0,2
29982_1,,,,2,2,1,3
29983_0,,,,2,2,1,3
29983_1,,,,2,2,1,3
29985_0,,,,2,2,1,3
C1(C(CO)(C(C(O1)=O)(CO)O)O)=O,,,5,1,3,0,3
29985_1,,,,2,2,1,3
29986_0,,,,2,2,1,3
29986_1,,,,2,2,1,3
29988_0,,,,2,2,1,3
C1(C2(CO)C(C(C(O2)=O)(C)O1)O)=O,,,5,1,2,0,2
29988_1,,,,2,2,1,3
29990_0,,,,2,2,1,3
C(C(CO)(C1C[CH]C(O1)=O)O)(O)=O,,,5,1,2,0,2
29990_1,,,,2,2,1,3
29992_0,,,,2,2,1,3
C(C(CO)(C1CCC(O1)=O)O)(O)=O,,,5,1,2,0,2
29992_1,,,,2,2,1,3
29994_0,,,,2,2,1,3
C1(C([C](C(O1)=O)O)C(C(O)O)O)=O,,,5,1,1,0,1
29996_0,,,,2,2,1,3
C1(C([C](C(O1)=O)O)C(C)O)=O,,,5,1,2,0,2
29998_0,,,,2,2,1,3
C1(C(C(O)=O)[C](C(O1)=O)O)=O,,,5,1,2,0,2
30000_0,,,,2,2,1,3
C1(C([C](C(O1)=O)O)C(C=O)(C)O)=O,,,5,1,1,0,1
30002_0,,,,2,2,1,3
C1(C([C](C(O1)=O)O)C(C(C)=O)O)=O,,,5,1,1,0,1
30004_0,,,,2,2,1,3
C1(C([C](C(O1)=O)O)CO)=O,,,5,1,2,0,2
30006_0,,,,2,2,1,3
C1(C([C](C(O1)=O)O)C(CCO)O)=O,,,5,1,1,0,1
30008_0,,,,2,2,1,3
C1(C([C](C(O1)=O)O)C(C=O)O)=O,,,5,1,2,0,2
30010_0,,,,2,2,1,3
C1(C([C](C(O1)=O)O)C(C)(CO)O)=O,,,5,1,1,0,1
30012_0,,,,2,2,1,3
C1(C([C](C(O1)=O)O)C(C=CC)O)=O,,,5,1,1,0,1
30014_0,,,,2,2,1,3
C1(C([C](C(O1)=O)O)C(CC=C)O)=O,,,5,1,1,0,1
30016_0,,,,2,2,1,3
C1(C([C](C(O1)=O)O)C(CO)O)=O,,,5,1,2,0,2
30018_0,,,,2,2,1,3
C1(C([C](C(O1)=O)O)C(C(C)O)O)=O,,,5,1,1,0,1
30020_0,,,,2,2,1,3
C1(C([C](C(O1)=O)O)C(C(O)=O)O)=O,,,5,1,1,0,1
30022_0,,,,2,2,1,3
C1(C(C(C(O)O)O)C(C(O1)=O)O)=O,,,5,1,1,0,1
30024_0,,,,2,2,1,3
C1(C(C(C)O)C(C(O1)=O)O)=O,,,5,1,2,0,2
30026_0,,,,2,2,1,3
C1(C(C(O)=O)C(C(O1)=O)O)=O,,,5,1,2,0,2
30028_0,,,,2,2,1,3
C1(C(C(C(O1)=O)C(C=O)(C)O)O)=O,,,5,1,1,0,1
30030_0,,,,2,2,1,3
C1(C(C(C(O1)=O)C(C(C)=O)O)O)=O,,,5,1,1,0,1
30032_0,,,,2,2,1,3
C1(C(CO)C(C(O1)=O)O)=O,,,5,1,3,0,3
30034_0,,,,2,2,1,3
C1(C(C(CCO)O)C(C(O1)=O)O)=O,,,5,1,1,0,1
30036_0,,,,2,2,1,3
C1(C(C(C(O1)=O)C(C=O)O)O)=O,,,5,1,2,0,2
30038_0,,,,2,2,1,3
C1(C(C(CO)(C)O)C(C(O1)=O)O)=O,,,5,1,1,0,1
30040_0,,,,2,2,1,3
C1(C(C(C(O1)=O)C(C=CC)O)O)=O,,,5,1,1,0,1
30042_0,,,,2,2,1,3
C1(C(C(CC=C)O)C(C(O1)=O)O)=O,,,5,1,1,0,1
30044_0,,,,2,2,1,3
C1(C(C(CO)O)C(C(O1)=O)O)=O,,,5,1,2,0,2
30046_0,,,,2,2,1,3
C1(C(C(C(C)O)O)C(C(O1)=O)O)=O,,,5,1,1,0,1
30048_0,,,,2,2,1,3
C1(C(C(C(O1)=O)C(C(O)=O)O)O)=O,,,5,1,1,0,1
30050_0,,,,2,2,1,3
C1(C(C=O)(CO)C(CC(C)O1)O)=O,,,5,1,1,0,1
30052_0,,,,2,2,1,3
C1(C(CO)C(C(C=O)C(C)O1)O)=O,,,5,1,1,0,1
30054_0,,,,2,2,1,3
C(C1(CO)C(CC(OC1C)=O)O)=O,,,5,1,1,0,1
30056_0,,,,2,2,1,3
C1(C(C=O)(CO)C(CC(O1)=O)O)=O,,,5,1,1,0,1
30058_0,,,,2,2,1,3
C1(C(C=O)C(C(C(O1)=O)CO)O)=O,,,5,1,1,0,1
30060_0,,,,2,2,1,3
C1(C(C=O)(CO)C(C(CO1)=O)O)=O,,,5,1,1,0,1
30062_0,,,,2,2,1,3
C1(C(C(C)O)(C(CC(C)O1)O)O)=O,,,5,1,2,0,2
30062_1,,,,2,2,1,3
30064_0,,,,2,2,1,3
C1(C(C(O)=O)(C(CC(C)O1)O)O)=O,,,5,1,2,0,2
30064_1,,,,2,2,1,3
30065_0,,,,2,2,1,3
30065_1,,,,2,2,1,3
30067_0,,,,2,2,1,3
C1(C(C(CC(O1)=O)O)(C(C)O)O)=O,,,5,1,2,0,2
30067_1,,,,2,2,1,3
30069_0,,,,2,2,1,3
C1(C(C(O)=O)(C(CC(O1)=O)O)O)=O,,,5,1,2,0,2
30069_1,,,,2,2,1,3
30070_0,,,,2,2,1,3
30070_1,,,,2,2,1,3
30072_0,,,,2,2,1,3
C1(C(C(C(C(O1)=O)O)O)C(C)O)=O,,,5,1,1,0,1
30074_0,,,,2,2,1,3
C1(C(C(O)=O)C(C(C(O1)=O)O)O)=O,,,5,1,1,0,1
30076_0,,,,2,2,1,3
C1(C(CO)C(C(C(O1)=O)O)O)=O,,,5,1,4,0,4
30078_0,,,,2,2,1,3
C1(C(CO)C(C(C(O1)=O)(C)O)O)=O,,,5,1,1,0,1
30080_0,,,,2,2,1,3
C1(C(C(C)O)(C(C(CO1)=O)O)O)=O,,,5,1,2,0,2
30080_1,,,,2,2,1,3
30082_0,,,,2,2,1,3
C1(C(C(O)=O)(C(C(CO1)=O)O)O)=O,,,5,1,2,0,2
30082_1,,,,2,2,1,3
30083_0,,,,2,2,1,3
30083_1,,,,2,2,1,3
30085_0,,,,2,2,1,3
C1(COC(C(C1(C(C)O)O)O)=O)=O,,,5,1,2,0,2
30085_1,,,,2,2,1,3
30087_0,,,,2,2,1,3
C(C1(C(COC(C1O)=O)=O)O)(O)=O,,,5,1,2,0,2
30087_1,,,,2,2,1,3
30089_0,,,,2,2,1,3
C1(COC(C(C1(CO)O)O)=O)=O,,,5,1,3,0,3
30089_1,,,,2,2,1,3
30091_0,,,,2,2,1,3
C1(C(C)(C(C(CO1)=O)(CO)O)O)=O,,,5,1,2,0,2
30091_1,,,,2,2,1,3
30093_0,,,,2,2,1,3
C1(C(CO)(CO)OC(C(C1)=O)=O)=O,,,5,1,2,0,2
30093_1,,,,2,2,1,3
30095_0,,,,2,2,1,3
C(C1(COC(C(C1)=O)=O)CO)(O)=O,,,5,1,1,0,1
30097_0,,,,2,2,1,3
C(C1(C(C)OC([CH]C1)=O)C(C)O)=O,,,5,1,1,0,1
30099_0,,,,2,2,1,3
C(C1(C(O)=O)C(C)OC([CH]C1)=O)=O,,,5,1,1,0,1
30101_0,,,,2,2,1,3
C(C1(CO)C(C)OC([CH]C1)=O)=O,,,5,1,2,0,2
30103_0,,,,2,2,1,3
C(C1(C(C)OC([CH]C1)=O)C(C=O)O)=O,,,5,1,1,0,1
30105_0,,,,2,2,1,3
C(C1(CCC(OC1C)=O)C(C)O)=O,,,5,1,1,0,1
30107_0,,,,2,2,1,3
C(C1(C(O)=O)CCC(OC1C)=O)=O,,,5,1,1,0,1
30109_0,,,,2,2,1,3
C(C1(CCC(OC1C)=O)CO)=O,,,5,1,2,0,2
30111_0,,,,2,2,1,3
C1(C(C=O)(C(C)O)C[CH]C(O1)=O)=O,,,5,1,1,0,1
30113_0,,,,2,2,1,3
C1(C(C=O)(C(O)=O)C[CH]C(O1)=O)=O,,,5,1,1,0,1
30115_0,,,,2,2,1,3
C1(C(C=O)(CO)C[CH]C(O1)=O)=O,,,5,1,2,0,2
30117_0,,,,2,2,1,3
C1(C(C=O)(C[CH]C(O1)=O)C(C=O)O)=O,,,5,1,1,0,1
30119_0,,,,2,2,1,3
C1(C(C=O)(CCC(O1)=O)C(C)O)=O,,,5,1,1,0,1
30121_0,,,,2,2,1,3
C1(C(C=O)(C(O)=O)CCC(O1)=O)=O,,,5,1,1,0,1
30123_0,,,,2,2,1,3
C1(C(C=O)(CCC(O1)=O)CO)=O,,,5,1,2,0,2
30125_0,,,,2,2,1,3
C(C1(CO)C(C[CH]C(O1)=O)O)(O)=O,,,5,1,2,0,2
30125_1,,,,2,2,1,3
30127_0,,,,2,2,1,3
C(C1(CO)C(CCC(O1)=O)O)(O)=O,,,5,1,2,0,2
30127_1,,,,2,2,1,3
30129_0,,,,2,2,1,3
C1(C(CO)C(CC(C(O1)=O)=O)O)=O,,,5,1,1,0,1
30131_0,,,,2,2,1,3
C1(C(CO)(COC(C(C1)=O)=O)O)=O,,,5,1,2,0,2
30131_1,,,,2,2,1,3
30133_0,,,,2,2,1,3
C1(C(CO)(C(C[CH]C(O1)=O)O)O)=O,,,5,1,2,0,2
30133_1,,,,2,2,1,3
30135_0,,,,2,2,1,3
C1(C(CO)(C(CCC(O1)=O)O)O)=O,,,5,1,2,0,2
30135_1,,,,2,2,1,3
30136_0,,,,2,2,1,3
30137_0,,,,2,2,1,3
30139_0,,,,2,2,1,3
C(C(CO)(CO)C(C)CC=O)=O,,,5,1,2,0,2
30140_0,,,,2,2,1,3
30141_0,,,,2,2,1,3
30142_0,,,,2,2,1,3
30143_0,,,,2,2,1,3
30145_0,,,,2,2,1,3
C(C(C=O)(C(CC(CO)C)O)O)=O,,,5,1,2,0,2
30145_1,,,,2,2,1,3
30147_0,,,,2,2,1,3
C(C(CO)C(CC(C)CO)O)(O)=O,,,5,1,1,0,1
30149_0,,,,2,2,1,3
C(C(CO)(C(CC(CO)C)O)O)=O,,,5,1,2,0,2
30149_1,,,,2,2,1,3
30151_0,,,,2,2,1,3
C(C(CO)(C(C)O)C(C(O)=O)C)=O,,,5,1,4,0,4
30153_0,,,,2,2,1,3
C(C(C=O)(CO)C(C(O)=O)C)(O)=O,,,5,1,2,0,2
30155_0,,,,2,2,1,3
C(C(CO)(CO)C(C(O)=O)C)=O,,,5,1,2,0,2
30157_0,,,,2,2,1,3
C(C(CCO)(C(C)O)C(C)O)(O)=O,,,5,1,1,0,1
30159_0,,,,2,2,1,3
C(C(C(O)=O)(CCO)C(C)O)(O)=O,,,5,1,2,0,2
30161_0,,,,2,2,1,3
C(C(CO)(CCO)C(C)O)(O)=O,,,5,1,1,0,1
30162_0,,,,2,2,1,3
30164_0,,,,2,2,1,3
C(C(C(O)=O)(C(O)=O)CCO)(O)=O,,,5,1,1,0,1
30166_0,,,,2,2,1,3
C(C(C(O)=O)(CO)CCO)(O)=O,,,5,1,1,0,1
30168_0,,,,2,2,1,3
C(C(CO)(CCCO)C(C)O)(O)=O,,,5,1,1,0,1
30170_0,,,,2,2,1,3
C(C(C(O)=O)(CO)CCCO)(O)=O,,,5,1,1,0,1
30171_0,,,,2,2,1,3
30173_0,,,,2,2,1,3
C(C(CO)(CC(C)O)C(C)O)(O)=O,,,5,1,1,0,1
30175_0,,,,2,2,1,3
C(C(C(O)=O)(CO)CC(C)O)(O)=O,,,5,1,1,0,1
30177_0,,,,2,2,1,3
C(C(CO)(C(C(C)CC=O)O)O)=O,,,5,1,3,0,3
30177_1,,,,2,2,1,3
30178_0,,,,2,2,1,3
30179_0,,,,2,2,1,3
30181_0,,,,2,2,1,3
C(C(CCC=O)(CO)C(C)O)(O)=O,,,5,1,2,0,2
30183_0,,,,2,2,1,3
C(C(C(O)=O)(CCC=O)CO)(O)=O,,,5,1,2,0,2
30184_0,,,,2,2,1,3
30184_1,,,,2,2,1,3
30185_0,,,,2,2,1,3
30185_1,,,,2,2,1,3
30186_0,,,,2,2,1,3
30186_1,,,,2,2,1,3
30187_0,,,,2,2,1,3
30189_0,,,,2,2,1,3
C(C(C=O)(C(C(CCO)O)O)O)=O,,,5,1,2,0,2
30189_1,,,,2,2,1,3
30191_0,,,,2,2,1,3
C(C(CO)C(C(CCO)O)O)(O)=O,,,5,1,1,0,1
30193_0,,,,2,2,1,3
C(C(CO)(C(C(CCO)O)O)O)=O,,,5,1,2,0,2
30193_1,,,,2,2,1,3
30195_0,,,,2,2,1,3
C(C(CO)(C(C(O)O)O)O)(O)=O,,,5,1,2,0,2
30195_1,,,,2,2,1,3
30197_0,,,,2,2,1,3
C(C(CO)(C(C(O)O)O)C(C)O)=O,,,5,1,1,0,1
30199_0,,,,2,2,1,3
C(C(C=O)(CO)C(C(O)O)O)(O)=O,,,5,1,1,0,1
30201_0,,,,2,2,1,3
C(C(C(CO)(C(C(O)O)O)O)=O)=O,,,5,1,2,0,2
30201_1,,,,2,2,1,3
30203_0,,,,2,2,1,3
C(C(C=O)(C(C(O)O)O)O)=O,,,5,1,2,0,2
30203_1,,,,2,2,1,3
30205_0,,,,2,2,1,3
C(C(C=O)(C(C(O)O)O)O)(O)=O,,,5,1,2,0,2
30205_1,,,,2,2,1,3
30207_0,,,,2,2,1,3
C(C(CO)C(C(O)O)O)(O)=O,,,5,1,1,0,1
30209_0,,,,2,2,1,3
C(C(C(C(O)O)O)C(C)O)(O)=O,,,5,1,1,0,1
30211_0,,,,2,2,1,3
C(C(C(O)=O)C(C(O)O)O)(O)=O,,,5,1,1,0,1
30213_0,,,,2,2,1,3
C(C(C(C(O)O)O)(C(C)O)O)(O)=O,,,5,1,2,0,2
30213_1,,,,2,2,1,3
30215_0,,,,2,2,1,3
C(C(C(O)=O)(C(C(O)O)O)O)(O)=O,,,5,1,2,0,2
30215_1,,,,2,2,1,3
30217_0,,,,2,2,1,3
C(C(C(C)=O)(C)C(C(O)O)O)(O)=O,,,5,1,1,0,1
30219_0,,,,2,2,1,3
C(C(CO)(C(C(O)O)O)O)=O,,,5,1,2,0,2
30219_1,,,,2,2,1,3
30220_0,,,,2,2,1,3
30221_0,,,,2,2,1,3
30221_1,,,,2,2,1,3
30223_0,,,,2,2,1,3
C(C)(C(C(C(O)=O)=O)(C(C)O)O)=O,,,5,1,3,0,3
30223_1,,,,2,2,1,3
30225_0,,,,2,2,1,3
C(C(C(C)=O)(C(C(O)=O)=O)O)(O)=O,,,5,1,3,0,3
30225_1,,,,2,2,1,3
30227_0,,,,2,2,1,3
C(C)(C(C(C(O)=O)=O)(CO)O)=O,,,5,1,4,0,4
30227_1,,,,2,2,1,3
30229_0,,,,2,1,1,2
C(CO)(C1(C(C(C(C1)O)O)O)O)=O,,,5,1,1,0,1
30231_0,,,,2,1,1,2
C(CO)(C1(C(CC(C1)O)O)O)=O,,,5,1,1,0,1
30232_0,,,,2,1,1,2
30233_0,,,,2,1,1,2
30235_0,,,,2,1,1,2
C(C1(CC(C(C)=O)(C(C1)O)O)O)=O,,,5,1,1,0,1
30236_0,,,,2,1,1,2
30238_0,,,,2,1,1,2
C(C)(C1(C(CC(C(C1)=O)O)O)O)=O,,,5,1,1,0,1
30240_0,,,,2,1,1,2
C(C)(C1(C(C(CO)C(C1)O)O)O)=O,,,5,1,1,0,1
30242_0,,,,2,1,1,2
C(C)(C1(CC(CC1(CO)O)O)O)=O,,,5,1,1,0,1
30244_0,,,,2,1,1,2
C(C)(C1(CC(C(C1(C)O)O)O)O)=O,,,5,1,1,0,1
30246_0,,,,2,1,1,2
C(C)(C1(C(C(C=C)C(C1)O)O)O)=O,,,5,1,1,0,1
30248_0,,,,2,1,1,2
C(C)(C1(C(C(C(C1)O)O)O)O)=O,,,5,1,1,0,1
30250_0,,,,2,1,1,2
C(C)(C1(C(CC(C1)O)O)O)=O,,,5,1,1,0,1
30252_0,,,,2,1,1,2
C(C1(CC(CC1(C(C)=O)O)O)O)=O,,,5,1,1,0,1
30253_0,,,,2,1,1,2
30255_0,,,,2,1,1,2
C(C1(C(CC(C(C1)=O)O)O)O)=O,,,5,1,1,0,1
30256_0,,,,2,1,1,2
30258_0,,,,2,1,1,2
C(C1(C(CC(C(C1)=O)O)O)O)(O)=O,,,5,1,1,0,1
30260_0,,,,2,1,1,2
C1(C(C)(C(C(CO)C1(C)O)O)O)=O,,,5,1,1,0,1
30262_0,,,,2,1,1,2
C(C1(C(CC(C(C1)=O)=O)O)O)=O,,,5,1,1,0,1
30264_0,,,,2,1,1,2
C(C1(C(CC(C(C1)=O)=O)O)O)(O)=O,,,5,1,1,0,1
30266_0,,,,2,1,1,2
C(C)(C1(C(CC(C(C1)=O)=O)O)O)=O,,,5,1,1,0,1
30268_0,,,,2,1,1,2
C1(C(CO)(C(C(C1(C)O)O)O)O)=O,,,5,1,1,0,1
30270_0,,,,2,1,1,2
C1(C(CO)(CC(C1(C)O)O)O)=O,,,5,1,1,0,1
30271_0,,,,2,1,1,2
30273_0,,,,2,1,1,2
C1(C(C)(CC(CO)(C1(C)O)O)O)=O,,,5,1,1,0,1
30275_0,,,,2,1,1,2
C1(C(C)(C(C(C)(C1(C)O)O)O)O)=O,,,5,1,2,0,2
30277_0,,,,2,1,1,2
C1(C(C)(C(C=C)C(C1(C)O)O)O)=O,,,5,1,1,0,1
30279_0,,,,2,1,1,2
C1(C(C)(C(C(C1(C)O)O)O)O)=O,,,5,1,1,0,1
30281_0,,,,2,1,1,2
C1(C(C)(CC(C1(C)O)O)O)=O,,,5,1,1,0,1
30283_0,,,,2,1,1,2
C1(C(C)(C(C=O)(CC1(C)O)O)O)=O,,,5,1,1,0,1
30284_0,,,,2,1,1,2
30285_0,,,,2,1,1,2
30286_0,,,,2,1,1,2
30287_0,,,,2,1,1,2
30288_0,,,,2,1,1,2
30290_0,,,,2,1,1,2
C1(C(C)(C(C(C1)=O)O)O)=O,,,5,1,1,0,1
30292_0,,,,2,1,1,2
C(C1C(CC(C1(C=O)O)O)O)(O)=O,,,5,1,1,0,1
30294_0,,,,2,1,1,2
C(C)(C1(C(C(C)(C(C1)O)O)O)O)=O,,,5,1,1,0,1
30295_0,,,,2,1,1,2
30296_0,,,,2,1,1,2
30297_0,,,,2,1,1,2
30298_0,,,,2,1,1,2
30299_0,,,,2,1,1,2
30300_0,,,,2,1,1,2
30301_0,,,,2,1,1,2
30302_0,,,,2,1,1,2
30303_0,,,,2,1,1,2
30304_0,,,,2,1,1,2
30306_0,,,,2,1,1,2
C1(C2(C(C(CO2)(C1O)O)O)O)=O,,,5,1,1,0,1
30308_0,,,,2,1,1,2
C1(C2(C(C(CO2)(C1)O)O)O)=O,,,5,1,1,0,1
30309_0,,,,2,1,1,2
30311_0,,,,2,1,1,2
C1(C(C(CC(C)C1)O)(CC=O)O)=O,,,5,1,1,0,1
30313_0,,,,2,1,1,2
C1(C(CC(C)CC(C1(C)O)O)=O)=O,,,5,1,1,0,1
30315_0,,,,2,1,1,2
C(C(C)=O)(C1(CC(C)CC1O)O)=O,,,5,1,1,0,1
30317_0,,,,2,1,1,2
C(C1CC(C(C)=O)(C(C1)O)O)(O)=O,,,5,1,2,0,2
30319_0,,,,2,1,1,2
C(C1(CC(C)CC1O)O)=O,,,5,1,1,0,1
30321_0,,,,2,1,1,2
C(C1(CC(C)CC1O)O)(O)=O,,,5,1,1,0,1
30323_0,,,,2,1,1,2
C(C1(CC(C)CC1(C=O)O)O)(O)=O,,,5,1,1,0,1
30325_0,,,,2,1,1,2
C(C1CC(C=O)(C(C1)O)O)(O)=O,,,5,1,2,0,2
30327_0,,,,2,1,1,2
C(C1CCC(C=O)(C(C1)O)O)(O)=O,,,5,1,2,0,2
30329_0,,,,2,1,1,2
C(C1CC(C(O)=O)(C(C1)O)O)(O)=O,,,5,1,3,0,3
30331_0,,,,2,1,1,2
C(C1(C)CC(C=O)(C(C1)O)O)(O)=O,,,5,1,1,0,1
30332_0,,,,2,2,1,3
30333_0,,,,2,2,1,3
30334_0,,,,2,2,1,3
30335_0,,,,2,2,1,3
30337_0,,,,2,2,1,3
C1(C(CC(C1O)O)(C(C=C)O)O)=O,,,5,1,1,0,1
30338_0,,,,2,2,1,3
30339_0,,,,2,2,1,3
30340_0,,,,2,2,1,3
30341_0,,,,2,2,1,3
30342_0,,,,2,2,1,3
30343_0,,,,2,2,1,3
30344_0,,,,2,2,1,3
30345_0,,,,2,2,1,3
30346_0,,,,2,2,1,3
30347_0,,,,2,2,1,3
30348_0,,,,2,2,1,3
30350_0,,,,2,2,1,3
C1(CC(CC1([C](C(O)=O)O)O)O)=O,,,5,1,2,0,2
30352_0,,,,2,2,1,3
C1(CC(CC1(C(C)(CC)O)O)O)=O,,,5,1,1,0,1
30354_0,,,,2,2,1,3
C1(CC(CC1(C(CC=O)O)O)O)=O,,,5,1,1,0,1
30356_0,,,,2,2,1,3
C1(C(CC(C1)O)(C(C=C)O)O)=O,,,5,1,1,0,1
30358_0,,,,2,2,1,3
C1(CC(CC1(C(C(O)O)O)O)O)=O,,,5,1,1,0,1
30359_0,,,,2,2,1,3
30360_0,,,,2,2,1,3
30361_0,,,,2,2,1,3
30362_0,,,,2,2,1,3
30363_0,,,,2,2,1,3
30364_0,,,,2,2,1,3
30365_0,,,,2,2,1,3
30366_0,,,,2,2,1,3
30367_0,,,,2,2,1,3
30368_0,,,,2,2,1,3
30369_0,,,,2,2,1,3
30370_0,,,,2,2,1,3
30371_0,,,,2,2,1,3
30373_0,,,,2,2,1,3
[C](C(O)=O)(C1(C(CC(C1)O)O)O)O,,,5,1,1,0,1
30375_0,,,,2,2,1,3
C(C(C1(C(CC(C1)O)O)O)(O)O)=O,,,5,1,1,0,1
30377_0,,,,2,2,1,3
C(C(C1(C(CC(C1)O)O)O)O)(O)=O,,,5,1,1,0,1
30379_0,,,,2,2,1,3
C(C(C)(C1(C(CC(C1)O)O)O)O)=O,,,5,1,1,0,1
30380_0,,,,2,2,1,3
30381_0,,,,2,2,1,3
30383_0,,,,2,2,1,3
C1(C(CC(C1)O)(C(C=O)(O)O)O)=O,,,5,1,1,0,1
30384_0,,,,2,2,1,3
30385_0,,,,2,2,1,3
30386_0,,,,2,2,1,3
30387_0,,,,2,2,1,3
30388_0,,,,2,2,1,3
30389_0,,,,2,2,1,3
30390_0,,,,2,2,1,3
30391_0,,,,2,2,1,3
30392_0,,,,2,2,1,3
30393_0,,,,2,2,1,3
30394_0,,,,2,2,1,3
30395_0,,,,2,2,1,3
30396_0,,,,2,2,1,3
30397_0,,,,2,2,1,3
30399_0,,,,2,2,1,3
[C](C(O)=O)(C(CC(CCO)O)O)O,,,5,1,1,0,1
30401_0,,,,2,2,1,3
C(C(C(CC(CCO)O)O)(O)O)=O,,,5,1,1,0,1
30403_0,,,,2,2,1,3
C(C(C(CC(CCO)O)O)O)(O)=O,,,5,1,1,0,1
30405_0,,,,2,2,1,3
C(C(C)(C(CC(CCO)O)O)O)=O,,,5,1,1,0,1
30406_0,,,,2,2,1,3
30407_0,,,,2,2,1,3
30408_0,,,,2,2,1,3
30409_0,,,,2,2,1,3
30411_0,,,,2,2,1,3
C(C(C(C=O)(C(C=O)CO)O)O)=O,,,5,1,1,0,1
30412_0,,,,2,2,1,3
30413_0,,,,2,2,1,3
30414_0,,,,2,2,1,3
30415_0,,,,2,2,1,3
30417_0,,,,2,2,1,3
[C](C(O)=O)(C(C(CO)CO)O)O,,,5,1,1,0,1
30419_0,,,,2,2,1,3
C(C)(C(C)(C(C(CO)CO)O)O)=O,,,5,1,1,0,1
30421_0,,,,2,2,1,3
C(C(CC)(C(C(CO)CO)O)O)=O,,,5,1,1,0,1
30423_0,,,,2,2,1,3
C(C(C(C(CO)CO)O)(O)O)=O,,,5,1,1,0,1
30424_0,,,,2,2,1,3
30425_0,,,,2,2,1,3
30427_0,,,,2,2,1,3
C(C(C)(C(C(CO)CO)O)O)=O,,,5,1,1,0,1
30428_0,,,,2,2,1,3
30429_0,,,,2,2,1,3
30430_0,,,,2,2,1,3
30431_0,,,,2,2,1,3
30432_0,,,,2,2,1,3
30433_0,,,,2,2,1,3
30434_0,,,,2,2,1,3
30435_0,,,,2,2,1,3
30436_0,,,,2,2,1,3
30437_0,,,,2,2,1,3
30438_0,,,,2,2,1,3
30440_0,,,,2,2,1,3
C(C(C(C=O)(CC(CO)=O)O)O)=O,,,5,1,1,0,1
30441_0,,,,2,2,1,3
30442_0,,,,2,2,1,3
30443_0,,,,2,2,1,3
30444_0,,,,2,2,1,3
30445_0,,,,2,2,1,3
30447_0,,,,2,2,1,3
C(C(C=C)C(C=O)(C(C=O)O)O)=O,,,5,1,1,0,1
30449_0,,,,2,2,1,3
C(C(C=C)C(C=O)(C(C=CC)O)O)=O,,,5,1,1,0,1
30451_0,,,,2,2,1,3
C(C(C=C)C(C=O)(C(CC=C)O)O)=O,,,5,1,1,0,1
30452_0,,,,2,2,1,3
30453_0,,,,2,2,1,3
30455_0,,,,2,2,1,3
C(C(C(C(C(C=O)(O)O)O)O)O)=O,,,5,1,1,0,1
30456_0,,,,2,2,1,3
30457_0,,,,2,2,1,3
30458_0,,,,2,2,1,3
30459_0,,,,2,2,1,3
30461_0,,,,2,2,1,3
C(C)(C(C)(C(C=O)(CC=O)O)O)=O,,,5,1,2,0,2
30463_0,,,,2,2,1,3
C(C([C](C(O)=O)O)(CC=O)O)=O,,,5,1,2,0,2
30465_0,,,,2,2,1,3
C(C(C(C)(CCO)O)(CC=O)O)=O,,,5,1,1,0,1
30467_0,,,,2,2,1,3
C(C(C(C)(CC)O)(CC=O)O)=O,,,5,1,1,0,1
30469_0,,,,2,2,1,3
C(C(C(C)(C(C)O)O)(CC=O)O)=O,,,5,1,1,0,1
30471_0,,,,2,2,1,3
C(C(C(CO)(CC)O)(CC=O)O)=O,,,5,1,1,0,1
30473_0,,,,2,2,1,3
C(CC(C(C=O)(CC=O)O)O)=O,,,5,1,1,0,1
30475_0,,,,2,2,1,3
C(CC(C=O)(C([CH]C(O)=O)O)O)=O,,,5,1,1,0,1
30477_0,,,,2,2,1,3
C(C(C=C)(C(C=O)(CC=O)O)O)=O,,,5,1,1,0,1
30479_0,,,,2,2,1,3
C(CC(C=O)(C(C(C=C)=O)O)O)=O,,,5,1,1,0,1
30480_0,,,,2,2,1,3
30482_0,,,,2,2,1,3
C(C(C(C(CC)O)O)(CC=O)O)=O,,,5,1,1,0,1
30484_0,,,,2,2,1,3
C(C(C(CCCO)O)(CC=O)O)=O,,,5,1,1,0,1
30486_0,,,,2,2,1,3
C(C(C(C(O)O)O)(CC=O)O)=O,,,5,1,1,0,1
30487_0,,,,2,2,1,3
30488_0,,,,2,2,1,3
30489_0,,,,2,2,1,3
30490_0,,,,2,2,1,3
30491_0,,,,2,2,1,3
30492_0,,,,2,2,1,3
30493_0,,,,2,2,1,3
30494_0,,,,2,2,1,3
30495_0,,,,2,2,1,3
30497_0,,,,2,2,1,3
C(C(C(CCO)O)(CC=O)O)=O,,,5,1,1,0,1
30498_0,,,,2,2,1,3
30499_0,,,,2,2,1,3
30500_0,,,,2,2,1,3
30502_0,,,,2,2,1,3
C(C(C(CO)(C)O)(CC=O)O)=O,,,5,1,1,0,1
30504_0,,,,2,2,1,3
C(CC(C=O)(C(C=CC)O)O)=O,,,5,1,1,0,1
30506_0,,,,2,2,1,3
C(C(C(CC=C)O)(CC=O)O)=O,,,5,1,1,0,1
30507_0,,,,2,2,1,3
30508_0,,,,2,2,1,3
30509_0,,,,2,2,1,3
30510_0,,,,2,2,1,3
30511_0,,,,2,2,1,3
30513_0,,,,2,2,1,3
C(C(CC([C](C(O)=O)O)O)O)=O,,,5,1,1,0,1
30515_0,,,,2,2,1,3
C(C(CC(C(C(C)=O)(C)O)O)O)=O,,,5,1,1,0,1
30517_0,,,,2,2,1,3
C(C(C(CC(C=O)O)O)(CC)O)=O,,,5,1,1,0,1
30519_0,,,,2,2,1,3
C(C(CC(C(C=O)(O)O)O)O)=O,,,5,1,1,0,1
30520_0,,,,2,2,1,3
30521_0,,,,2,2,1,3
30523_0,,,,2,2,1,3
C(C(C)(C(CC(C=O)O)O)O)=O,,,5,1,1,0,1
30525_0,,,,2,2,1,3
C(CC(C([C](C(O)=O)O)O)O)=O,,,5,1,1,0,1
30527_0,,,,2,2,1,3
C(CC(C(C(C(C)=O)(C)O)O)O)=O,,,5,1,1,0,1
30529_0,,,,2,2,1,3
C(C(C(C(CC=O)O)O)(CC)O)=O,,,5,1,1,0,1
30531_0,,,,2,2,1,3
C(CC(C(C(C=O)(O)O)O)O)=O,,,5,1,1,0,1
30532_0,,,,2,2,1,3
30533_0,,,,2,2,1,3
30534_0,,,,2,2,1,3
30535_0,,,,2,2,1,3
30536_0,,,,2,2,1,3
30537_0,,,,2,2,1,3
30538_0,,,,2,2,1,3
30539_0,,,,2,2,1,3
30540_0,,,,2,2,1,3
30541_0,,,,2,2,1,3
30542_0,,,,2,2,1,3
30543_0,,,,2,2,1,3
30544_0,,,,2,2,1,3
30546_0,,,,2,2,1,3
C(C(C(C=O)(CC(C=O)=O)O)O)=O,,,5,1,1,0,1
30547_0,,,,2,2,1,3
30548_0,,,,2,2,1,3
30549_0,,,,2,2,1,3
30550_0,,,,2,2,1,3
30552_0,,,,2,2,1,3
[C](C(O)=O)(C(CO)(C(CO)O)O)O,,,5,1,2,0,2
30554_0,,,,2,2,1,3
C(C(C(CO)(C(CO)O)O)(O)O)=O,,,5,1,1,0,1
30555_0,,,,2,2,1,3
30556_0,,,,2,2,1,3
30558_0,,,,2,2,1,3
[C](C(O)=O)(C(CC(CO)(C)O)O)O,,,5,1,1,0,1
30560_0,,,,2,2,1,3
C(C(C(CC(CO)(C)O)O)(O)O)=O,,,5,1,1,0,1
30561_0,,,,2,2,1,3
30562_0,,,,2,2,1,3
30563_0,,,,2,2,1,3
30564_0,,,,2,2,1,3
30565_0,,,,2,2,1,3
30567_0,,,,2,2,1,3
[C](C(O)=O)(C(CO)(CC(C)O)O)O,,,5,1,1,0,1
30569_0,,,,2,2,1,3
C(C(C(CO)(CC(C)O)O)(O)O)=O,,,5,1,1,0,1
30570_0,,,,2,2,1,3
30571_0,,,,2,2,1,3
30573_0,,,,2,2,1,3
C(CC([C](C(O)=O)O)(CO)O)(O)=O,,,5,1,1,0,1
30575_0,,,,2,2,1,3
C(CC(CO)(C(C=O)(O)O)O)(O)=O,,,5,1,1,0,1
30576_0,,,,2,2,1,3
30577_0,,,,2,2,1,3
30578_0,,,,2,2,1,3
30579_0,,,,2,2,1,3
30580_0,,,,2,2,1,3
30581_0,,,,2,2,1,3
30583_0,,,,2,2,1,3
[C](C(O)=O)(C(CO)(CCO)O)O,,,5,1,1,0,1
30585_0,,,,2,2,1,3
C(C)(C(C)(C(CO)(CCO)O)O)=O,,,5,1,1,0,1
30587_0,,,,2,2,1,3
C(C(CC)(C(CO)(CCO)O)O)=O,,,5,1,1,0,1
30589_0,,,,2,2,1,3
C(C(C(CO)(CCO)O)(O)O)=O,,,5,1,1,0,1
30590_0,,,,2,2,1,3
30591_0,,,,2,2,1,3
30592_0,,,,2,2,1,3
30594_0,,,,2,2,1,3
[C](C(O)=O)(C(C)(C(C(C)O)O)O)O,,,5,1,1,0,1
30596_0,,,,2,2,1,3
C(C(C(C)(C(C(C)O)O)O)(O)O)=O,,,5,1,1,0,1
30598_0,,,,2,2,1,3
C(C(C(C)(C(C(C)O)O)O)O)(O)=O,,,5,1,1,0,1
30600_0,,,,2,2,1,3
C(C(C)(C(C)(C(C(C)O)O)O)O)=O,,,5,1,1,0,1
30602_0,,,,2,2,1,3
C(C(C([C](C(O)=O)O)(C)O)O)(O)=O,,,5,1,3,0,3
30604_0,,,,2,2,1,3
C(C(C(C)(C(C=O)(O)O)O)O)(O)=O,,,5,1,1,0,1
30606_0,,,,2,2,1,3
C(C(C(C)(C(C(O)=O)O)O)O)(O)=O,,,5,1,2,0,2
30608_0,,,,2,2,1,3
C(C(C)(C(C)(C(C(O)=O)O)O)O)=O,,,5,1,2,0,2
30610_0,,,,2,2,1,3
[C](C(O)=O)(C(C)(C(CO)O)O)O,,,5,1,1,0,1
30612_0,,,,2,2,1,3
C(C)(C(C)(C(C)(C(CO)O)O)O)=O,,,5,1,1,0,1
30614_0,,,,2,2,1,3
C(C(CC)(C(C)(C(CO)O)O)O)=O,,,5,1,1,0,1
30616_0,,,,2,2,1,3
C(C(C(C)(C(CO)O)O)(O)O)=O,,,5,1,1,0,1
30617_0,,,,2,2,1,3
30619_0,,,,2,2,1,3
C(C(C(C)(C(CO)O)O)O)(O)=O,,,5,1,1,0,1
30621_0,,,,2,2,1,3
C(C(C)(C(C)(C(CO)O)O)O)=O,,,5,1,1,0,1
30623_0,,,,2,2,1,3
C(C(CC([C](C(O)=O)O)O)O)=CC,,,5,1,1,0,1
30625_0,,,,2,2,1,3
C(C(C(CC(C=CC)O)O)(O)O)=O,,,5,1,1,0,1
30627_0,,,,2,2,1,3
C(C(C(CC(C=CC)O)O)O)(O)=O,,,5,1,1,0,1
30629_0,,,,2,2,1,3
C(C(C)(C(CC(C=CC)O)O)O)=O,,,5,1,1,0,1
30631_0,,,,2,2,1,3
C(CC(CC([C](C(O)=O)O)O)O)=C,,,5,1,1,0,1
30633_0,,,,2,2,1,3
C(C(C(CC(CC=C)O)O)(O)O)=O,,,5,1,1,0,1
30635_0,,,,2,2,1,3
C(C(C(CC(CC=C)O)O)O)(O)=O,,,5,1,1,0,1
30637_0,,,,2,2,1,3
C(C(C)(C(CC(CC=C)O)O)O)=O,,,5,1,1,0,1
30638_0,,,,2,2,1,3
30640_0,,,,2,2,1,3
C(C(C(O)=O)(C(C=O)C=C)O)(O)=O,,,5,1,1,0,1
30641_0,,,,2,2,1,3
30643_0,,,,2,2,1,3
C(C(C(C)O)C([C](C(O)=O)O)O)=C,,,5,1,1,0,1
30645_0,,,,2,2,1,3
C(C(C(C(C=C)C(C)O)O)(O)O)=O,,,5,1,1,0,1
30647_0,,,,2,2,1,3
C(C(C(C(C=C)C(C)O)O)O)(O)=O,,,5,1,1,0,1
30649_0,,,,2,2,1,3
C(C(C(C(C=C)C(C)O)O)(C)O)=O,,,5,1,1,0,1
30651_0,,,,2,2,1,3
C(C(C=C)C([C](C(O)=O)O)O)(O)=O,,,5,1,1,0,1
30653_0,,,,2,2,1,3
C(C(C=C)C(C(C=O)(O)O)O)(O)=O,,,5,1,1,0,1
30654_0,,,,2,2,1,3
30656_0,,,,2,2,1,3
C(C(C=C)C(C(C=O)(C)O)O)(O)=O,,,5,1,1,0,1
30657_0,,,,2,2,1,3
30659_0,,,,2,2,1,3
C(C(C=C)C(C(C)=O)(C(C=C)O)O)=O,,,5,1,1,0,1
30660_0,,,,2,2,1,3
30661_0,,,,2,2,1,3
30662_0,,,,2,2,1,3
30664_0,,,,2,2,1,3
C(C(CO)C([C](C(O)=O)O)O)=C,,,5,1,1,0,1
30666_0,,,,2,2,1,3
C(C)(C(C(C(C=C)CO)O)(C)O)=O,,,5,1,1,0,1
30668_0,,,,2,2,1,3
C(C(C(C(C=C)CO)O)(CC)O)=O,,,5,1,1,0,1
30670_0,,,,2,2,1,3
C(C(C(C(C=C)CO)O)(O)O)=O,,,5,1,1,0,1
30671_0,,,,2,2,1,3
30672_0,,,,2,2,1,3
30674_0,,,,2,2,1,3
C(C(C(C(C=C)CO)O)(C)O)=O,,,5,1,2,0,2
30676_0,,,,2,2,1,3
[C](C(O)=O)(C(C(C(CO)O)O)O)O,,,5,1,4,0,4
30678_0,,,,2,2,1,3
C(C(C(C(C(CO)O)O)O)(O)O)=O,,,5,1,1,0,1
30679_0,,,,2,2,1,3
30681_0,,,,2,2,1,3
C(C(C)(C(C(C(CO)O)O)O)O)=O,,,5,1,2,0,2
30683_0,,,,2,2,1,3
[C](C(O)=O)(C(CC(CO)O)O)O,,,5,1,1,0,1
30685_0,,,,2,2,1,3
C(C)(C(C)(C(CC(CO)O)O)O)=O,,,5,1,1,0,1
30687_0,,,,2,2,1,3
C(C(CC)(C(CC(CO)O)O)O)=O,,,5,1,1,0,1
30689_0,,,,2,2,1,3
C(C(C(CC(CO)O)O)(O)O)=O,,,5,1,1,0,1
30691_0,,,,2,2,1,3
C(C(C)(C(CC(CO)O)O)O)(O)=O,,,5,1,2,0,2
30693_0,,,,2,2,1,3
C(C(C(CC(CO)O)O)O)(O)=O,,,5,1,1,0,1
30695_0,,,,2,2,1,3
C(C(C)(C(CC(CO)O)O)O)=O,,,5,1,1,0,1
30697_0,,,,2,2,1,3
[C](C(O)=O)(C(C(C(C)O)O)O)O,,,5,1,2,0,2
30699_0,,,,2,2,1,3
C(C)(C(C)(C(C(C(C)O)O)O)O)=O,,,5,1,1,0,1
30701_0,,,,2,2,1,3
C(C(CC)(C(C(C(C)O)O)O)O)=O,,,5,1,1,0,1
30703_0,,,,2,2,1,3
C(C(C(C(C(C)O)O)O)(O)O)=O,,,5,1,1,0,1
30705_0,,,,2,2,1,3
C(C(C)(C(C(C(C)O)O)O)O)(O)=O,,,5,1,1,0,1
30706_0,,,,2,2,1,3
30708_0,,,,2,2,1,3
C(C(C)(C(C(C(C)O)O)O)O)=O,,,5,1,1,0,1
30710_0,,,,2,2,1,3
[C](C(O)=O)(C(CC(C(C)O)O)O)O,,,5,1,1,0,1
30712_0,,,,2,2,1,3
C(C(C(CC(C(C)O)O)O)(O)O)=O,,,5,1,1,0,1
30714_0,,,,2,2,1,3
C(C(C(CC(C(C)O)O)O)O)(O)=O,,,5,1,1,0,1
30716_0,,,,2,2,1,3
C(C(C)(C(CC(C(C)O)O)O)O)=O,,,5,1,1,0,1
30718_0,,,,2,2,1,3
C(C([C](C(O)=O)O)(CC=O)O)(O)=O,,,5,1,2,0,2
30720_0,,,,2,2,1,3
C(C(C(C)(CC)O)(CC=O)O)(O)=O,,,5,1,1,0,1
30722_0,,,,2,2,1,3
C(C(C(CC=O)O)(CC=O)O)(O)=O,,,5,1,1,0,1
30723_0,,,,2,2,1,3
30725_0,,,,2,2,1,3
C(C(C(C(O)O)O)(CC=O)O)(O)=O,,,5,1,1,0,1
30726_0,,,,2,2,1,3
30728_0,,,,2,2,1,3
C(C(C(O)=O)(CC=O)O)(O)=O,,,5,1,2,0,2
30729_0,,,,2,2,1,3
30730_0,,,,2,2,1,3
30731_0,,,,2,2,1,3
30733_0,,,,2,2,1,3
C(C(C(CCO)O)(CC=O)O)(O)=O,,,5,1,1,0,1
30734_0,,,,2,2,1,3
30736_0,,,,2,2,1,3
C(C(C(CO)(C)O)(CC=O)O)(O)=O,,,5,1,1,0,1
30738_0,,,,2,2,1,3
C(C(CC=O)(C(C=CC)O)O)(O)=O,,,5,1,1,0,1
30740_0,,,,2,2,1,3
C(C(C(CC=C)O)(CC=O)O)(O)=O,,,5,1,1,0,1
30741_0,,,,2,2,1,3
30742_0,,,,2,2,1,3
30743_0,,,,2,2,1,3
30745_0,,,,2,2,1,3
C(C(CC([C](C(O)=O)O)O)O)(O)=O,,,5,1,1,0,1
30747_0,,,,2,2,1,3
C(C(CC(C(C=O)(O)O)O)O)(O)=O,,,5,1,1,0,1
30748_0,,,,2,2,1,3
30750_0,,,,2,2,1,3
C(C(C)(C(CC(C(O)=O)O)O)O)=O,,,5,1,1,0,1
30751_0,,,,2,2,1,3
30752_0,,,,2,2,1,3
30753_0,,,,2,2,1,3
30755_0,,,,2,2,1,3
C(C(C(O)=O)(CC(C=O)=O)O)(O)=O,,,5,1,1,0,1
30756_0,,,,2,2,1,3
30757_0,,,,2,2,1,3
30759_0,,,,2,2,1,3
C(C(CO)(CC(C=O)(C)O)O)(O)=O,,,5,1,1,0,1
30761_0,,,,2,2,1,3
C(C(CO)(CC(C(C)=O)O)O)(O)=O,,,5,1,1,0,1
30762_0,,,,2,2,1,3
30764_0,,,,2,2,1,3
C(C([C](C(O)=O)O)(CCO)O)(O)=O,,,5,1,2,0,2
30766_0,,,,2,2,1,3
C(C(CCO)(C(C)(CC)O)O)(O)=O,,,5,1,1,0,1
30768_0,,,,2,2,1,3
C(C(C(CC=O)O)(CCO)O)(O)=O,,,5,1,1,0,1
30770_0,,,,2,2,1,3
C(C(CCO)(C(C=C)O)O)(O)=O,,,5,1,1,0,1
30772_0,,,,2,2,1,3
C(C(C(C(O)O)O)(CCO)O)(O)=O,,,5,1,1,0,1
30773_0,,,,2,2,1,3
30774_0,,,,2,2,1,3
30775_0,,,,2,2,1,3
30776_0,,,,2,2,1,3
30777_0,,,,2,2,1,3
30779_0,,,,2,2,1,3
C(C(CCO)(C(CCO)O)O)(O)=O,,,5,1,1,0,1
30780_0,,,,2,2,1,3
30781_0,,,,2,2,1,3
30783_0,,,,2,2,1,3
C(C(CCO)(C(C=CC)O)O)(O)=O,,,5,1,1,0,1
30785_0,,,,2,2,1,3
C(C(C(CC=C)O)(CCO)O)(O)=O,,,5,1,1,0,1
30786_0,,,,2,2,1,3
30787_0,,,,2,2,1,3
30788_0,,,,2,2,1,3
30790_0,,,,2,2,1,3
C(C([C](C(O)=O)O)(C(C=O)=O)O)=O,,,5,1,1,0,1
30792_0,,,,2,2,1,3
C(C(C(C=O)=O)(C(C=O)(O)O)O)=O,,,5,1,1,0,1
30794_0,,,,2,2,1,3
C(C(C(C=O)=O)(C(C(O)=O)O)O)=O,,,5,1,2,0,2
30796_0,,,,2,2,1,3
C(C(C(C=O)=O)(C(C=O)(C)O)O)=O,,,5,1,1,0,1
30798_0,,,,2,2,1,3
C([C](C(C(C(C=O)=O)=O)O)O)(O)=O,,,5,1,1,0,1
30800_0,,,,2,2,1,3
C(C(C(C(C(C=O)=O)=O)O)(O)O)=O,,,5,1,1,0,1
30802_0,,,,2,2,1,3
C(C(C(C(C(C=O)=O)=O)O)O)(O)=O,,,5,1,1,0,1
30804_0,,,,2,2,1,3
C(C(C)(C(C(C(C=O)=O)=O)O)O)=O,,,5,1,1,0,1
30805_0,,,,2,2,1,3
30806_0,,,,2,2,1,3
30807_0,,,,2,2,1,3
30808_0,,,,2,2,1,3
30810_0,,,,2,2,1,3
C(C(CC)(C(C(C=O)=O)O)O)=O,,,5,1,1,0,1
30812_0,,,,2,2,1,3
C1(C(C(C(C=O)=O)O)(O)OCC1)=O,,,5,1,1,0,1
30813_0,,,,2,2,1,3
30815_0,,,,2,2,1,3
C(C(C(C(C=O)=O)O)(O)O)=O,,,5,1,1,0,1
30816_0,,,,2,2,1,3
30817_0,,,,2,2,1,3
30818_0,,,,2,2,1,3
30819_0,,,,2,2,1,3
30820_0,,,,2,2,1,3
30821_0,,,,2,2,1,3
30822_0,,,,2,2,1,3
30824_0,,,,2,2,1,3
C(C(C=O)(C(C=O)(CC)O)O)=O,,,5,1,1,0,1
30826_0,,,,2,2,1,3
C(C(C=O)(C1(C(CCO1)=O)O)O)=O,,,5,1,1,0,1
30827_0,,,,2,2,1,3
30829_0,,,,2,2,1,3
C(C(C=O)(C(C=O)(O)O)O)=O,,,5,1,1,0,1
30830_0,,,,2,2,1,3
30831_0,,,,2,2,1,3
30832_0,,,,2,2,1,3
30834_0,,,,2,2,1,3
C(C)(C([C](C(O)=O)O)(CCO)O)=O,,,5,1,2,0,2
30836_0,,,,2,2,1,3
C(C)(C(CCO)(C(C=O)(O)O)O)=O,,,5,1,1,0,1
30837_0,,,,2,2,1,3
30838_0,,,,2,2,1,3
30840_0,,,,2,2,1,3
C(CCO)(C([C](C(O)=O)O)(C)O)=O,,,5,1,1,0,1
30842_0,,,,2,2,1,3
C(C(C)(C(C=O)(O)O)O)(CCO)=O,,,5,1,1,0,1
30843_0,,,,2,2,1,3
30844_0,,,,2,2,1,3
30845_0,,,,2,2,1,3
30847_0,,,,2,2,1,3
C(CO)(C(CO)(C(C=O)(O)O)O)=O,,,5,1,1,0,1
30848_0,,,,2,2,1,3
30849_0,,,,2,2,1,3
30851_0,,,,2,2,1,3
C(C(C(C(C)O)(CC(C)O)O)=O)=O,,,5,1,1,0,1
30853_0,,,,2,2,1,3
C(C(C(C=O)=O)(CC(C)O)O)(O)=O,,,5,1,2,0,2
30855_0,,,,2,2,1,3
C(C(C(CO)(CC(C)O)O)=O)=O,,,5,1,1,0,1
30857_0,,,,2,2,1,3
C(C(C)=O)(C(CO)(CC(C)O)O)=O,,,5,1,1,0,1
30859_0,,,,2,2,1,3
C(CC(C(C=O)=O)(C(C)O)O)(O)=O,,,5,1,1,0,1
30861_0,,,,2,2,1,3
C(C(C(C=O)=O)(CC(O)=O)O)(O)=O,,,5,1,2,0,2
30863_0,,,,2,2,1,3
C(CC(C(C=O)=O)(CO)O)(O)=O,,,5,1,1,0,1
30865_0,,,,2,2,1,3
C(CC(C(C(C)=O)=O)(CO)O)(O)=O,,,5,1,1,0,1
30866_0,,,,2,2,1,3
30867_0,,,,2,2,1,3
30869_0,,,,2,2,1,3
C(C(CC)(C(C(C)=O)(CO)O)O)=O,,,5,1,1,0,1
30871_0,,,,2,2,1,3
C(C)(C(CO)(C(C=O)(O)O)O)=O,,,5,1,1,0,1
30872_0,,,,2,2,1,3
30873_0,,,,2,2,1,3
30874_0,,,,2,2,1,3
30876_0,,,,2,2,1,3
C(CO)(C([C](C(O)=O)O)(C)O)=O,,,5,1,1,0,1
30878_0,,,,2,2,1,3
C(C)(C(C)(C(C(CO)=O)(C)O)O)=O,,,5,1,1,0,1
30880_0,,,,2,2,1,3
C(C(CC)(C(C(CO)=O)(C)O)O)=O,,,5,1,1,0,1
30882_0,,,,2,2,1,3
C(CO)(C(C)(C(C=O)(O)O)O)=O,,,5,1,1,0,1
30884_0,,,,2,2,1,3
C(C(C)(C(C(CO)=O)(C)O)O)(O)=O,,,5,1,1,0,1
30886_0,,,,2,2,1,3
C(CO)(C(C)(C(C(O)=O)O)O)=O,,,5,1,1,0,1
30888_0,,,,2,2,1,3
C(C(C)(C(C(CO)=O)(C)O)O)=O,,,5,1,1,0,1
30890_0,,,,2,2,1,3
C(C)(C(C)(C(C(C=O)=O)(C)O)O)=O,,,5,1,2,0,2
30892_0,,,,2,2,1,3
[C](C(O)=O)(C(C(C=O)=O)(C)O)O,,,5,1,2,0,2
30894_0,,,,2,2,1,3
C(C(C(C)(C(C)(CCO)O)O)=O)=O,,,5,1,1,0,1
30896_0,,,,2,2,1,3
C(C(C(C)(C(C)(CC)O)O)=O)=O,,,5,1,1,0,1
30898_0,,,,2,2,1,3
C(C(C(C)(C(C)(C(C)O)O)O)=O)=O,,,5,1,1,0,1
30900_0,,,,2,2,1,3
C(C(C(C)(C(CO)(CC)O)O)=O)=O,,,5,1,1,0,1
30901_0,,,,2,2,1,3
30903_0,,,,2,2,1,3
[CH](C(O)=O)C(C(C(C=O)=O)(C)O)O,,,5,1,1,0,1
30905_0,,,,2,2,1,3
C(C(C=C)(C(C(C=O)=O)(C)O)O)=O,,,5,1,1,0,1
30907_0,,,,2,2,1,3
C=CC(C(C(C(C=O)=O)(C)O)O)=O,,,5,1,1,0,1
30909_0,,,,2,2,1,3
C=CC(C(C(C=O)=O)(C)O)O,,,5,1,1,0,1
30911_0,,,,2,2,1,3
C(C(C(C)(C(C(CC)O)O)O)=O)=O,,,5,1,1,0,1
30913_0,,,,2,2,1,3
C(C(C(C)(C(CCCO)O)O)=O)=O,,,5,1,1,0,1
30915_0,,,,2,2,1,3
C(C(C(C)(C(C(O)O)O)O)=O)=O,,,5,1,1,0,1
30916_0,,,,2,2,1,3
30917_0,,,,2,2,1,3
30919_0,,,,2,2,1,3
C(C(C(C)(C(CC(C)O)O)O)=O)=O,,,5,1,1,0,1
30921_0,,,,2,2,1,3
C(CC(C(C(C=O)=O)(C)O)O)(O)=O,,,5,1,1,0,1
30922_0,,,,2,2,1,3
30923_0,,,,2,2,1,3
30925_0,,,,2,2,1,3
C(C(C)(C(C(C=O)=O)(C)O)O)=O,,,5,1,2,0,2
30926_0,,,,2,2,1,3
30927_0,,,,2,2,1,3
30929_0,,,,2,2,1,3
C(C(C(C)(C(CCO)O)O)=O)=O,,,5,1,1,0,1
30930_0,,,,2,2,1,3
30931_0,,,,2,2,1,3
30933_0,,,,2,2,1,3
C(C(C(C)(C(CO)(CO)O)O)=O)=O,,,5,1,1,0,1
30935_0,,,,2,2,1,3
C(C(C(C)(C(CO)(C)O)O)=O)=O,,,5,1,1,0,1
30937_0,,,,2,2,1,3
C(C)=CC(C(C(C=O)=O)(C)O)O,,,5,1,1,0,1
30939_0,,,,2,2,1,3
C=CCC(C(C(C=O)=O)(C)O)O,,,5,1,1,0,1
30941_0,,,,2,2,1,3
C(C(C(C)(C(C(CO)O)O)O)=O)=O,,,5,1,1,0,1
30942_0,,,,2,2,1,3
30944_0,,,,2,2,1,3
C(C(C(C)(C(C(C)O)O)O)=O)=O,,,5,1,1,0,1
30946_0,,,,2,2,1,3
C(C(C(C(C=O)=O)(C)O)O)(O)=O,,,5,1,2,0,2
30948_0,,,,2,2,1,3
C(C(C)(C(C(C=O)=O)(C)O)O)(O)=O,,,5,1,2,0,2
30949_0,,,,2,2,1,3
30951_0,,,,2,2,1,3
C(C)(C(C)(C(C(C(C)O)=O)O)O)=O,,,5,1,1,0,1
30953_0,,,,2,2,1,3
C(C(CC)(C(C(C(C)O)=O)O)O)=O,,,5,1,1,0,1
30955_0,,,,2,2,1,3
C(C(C(C=O)(O)O)O)(C(C)O)=O,,,5,1,1,0,1
30956_0,,,,2,2,1,3
30957_0,,,,2,2,1,3
30959_0,,,,2,2,1,3
C(C(C)(C(C(C(C)O)=O)O)O)=O,,,5,1,1,0,1
30960_0,,,,2,2,1,3
30961_0,,,,2,2,1,3
30963_0,,,,2,2,1,3
C(C(CC)(C(C=O)(C(C)O)O)O)=O,,,5,1,1,0,1
30965_0,,,,2,2,1,3
C(C(C(C)O)(C(C=O)(O)O)O)=O,,,5,1,1,0,1
30966_0,,,,2,2,1,3
30967_0,,,,2,2,1,3
30968_0,,,,2,2,1,3
30969_0,,,,2,2,1,3
30970_0,,,,2,2,1,3
30972_0,,,,2,2,1,3
C(C(C=O)(C(C=O)(CC)O)O)(O)=O,,,5,1,1,0,1
30974_0,,,,2,2,1,3
C(C(C=O)(C(C=O)(O)O)O)(O)=O,,,5,1,1,0,1
30975_0,,,,2,2,1,3
30976_0,,,,2,2,1,3
30977_0,,,,2,2,1,3
30978_0,,,,2,2,1,3
30979_0,,,,2,2,1,3
30981_0,,,,2,2,1,3
C(C(CC)(C(C(C(O)=O)=O)O)O)=O,,,5,1,1,0,1
30983_0,,,,2,2,1,3
C(C(C(C(C(O)=O)=O)O)(O)O)=O,,,5,1,1,0,1
30984_0,,,,2,2,1,3
30985_0,,,,2,2,1,3
30986_0,,,,2,2,1,3
30987_0,,,,2,2,1,3
30988_0,,,,2,2,1,3
30990_0,,,,2,2,1,3
C(C(CC)(C(C(C(C)=O)=O)O)O)=O,,,5,1,1,0,1
30992_0,,,,2,2,1,3
C(C(C(C(C(C)=O)=O)O)(O)O)=O,,,5,1,1,0,1
30993_0,,,,2,2,1,3
30994_0,,,,2,2,1,3
30995_0,,,,2,2,1,3
30996_0,,,,2,2,1,3
30997_0,,,,2,2,1,3
30999_0,,,,2,2,1,3
C(C(CC)(C(C(C=O)=O)(C)O)O)=O,,,5,1,1,0,1
31001_0,,,,2,2,1,3
C(C(C(C(C=O)=O)(C)O)(O)O)=O,,,5,1,1,0,1
31002_0,,,,2,2,1,3
31003_0,,,,2,2,1,3
31004_0,,,,2,2,1,3
31005_0,,,,2,2,1,3
31006_0,,,,2,2,1,3
31008_0,,,,2,2,1,3
C(C(CC)(C(C=O)(C(C)=O)O)O)=O,,,5,1,1,0,1
31010_0,,,,2,2,1,3
C(C(C(C)=O)(C(C=O)(O)O)O)=O,,,5,1,1,0,1
31011_0,,,,2,2,1,3
31012_0,,,,2,2,1,3
31013_0,,,,2,2,1,3
31015_0,,,,2,2,1,3
C=CC(C([C](C(O)=O)O)(CO)O)=O,,,5,1,1,0,1
31017_0,,,,2,2,1,3
C(C(C(C(C=C)=O)(CO)O)(O)O)=O,,,5,1,1,0,1
31019_0,,,,2,2,1,3
C(C(C(C(C=C)=O)(CO)O)O)(O)=O,,,5,1,1,0,1
31021_0,,,,2,2,1,3
C(C(C)(C(C(C=C)=O)(CO)O)O)=O,,,5,1,1,0,1
31023_0,,,,2,2,1,3
C(CO)(C(C=C)([C](C(O)=O)O)O)=O,,,5,1,1,0,1
31025_0,,,,2,2,1,3
C(C(C(C(CO)=O)(C=C)O)(O)O)=O,,,5,1,1,0,1
31027_0,,,,2,2,1,3
C(C(C(C(CO)=O)(C=C)O)O)(O)=O,,,5,1,1,0,1
31029_0,,,,2,2,1,3
C(C(C)(C(C(CO)=O)(C=C)O)O)=O,,,5,1,1,0,1
31031_0,,,,2,2,1,3
C(C)(C(C=C)([C](C(O)=O)O)O)=O,,,5,1,1,0,1
31033_0,,,,2,2,1,3
C(C)(C(C)(C(C(C)=O)(C=C)O)O)=O,,,5,1,1,0,1
31035_0,,,,2,2,1,3
C(C(CC)(C(C(C)=O)(C=C)O)O)=O,,,5,1,1,0,1
31037_0,,,,2,2,1,3
C(C(C(C(C)=O)(C=C)O)(O)O)=O,,,5,1,1,0,1
31039_0,,,,2,2,1,3
C(C(C)(C(C(C)=O)(C=C)O)O)(O)=O,,,5,1,1,0,1
31041_0,,,,2,2,1,3
C(C(C(C(C)=O)(C=C)O)O)(O)=O,,,5,1,2,0,2
31043_0,,,,2,2,1,3
C(C(C)(C(C(C)=O)(C=C)O)O)=O,,,5,1,2,0,2
31045_0,,,,2,2,1,3
C=CC(C([C](C(O)=O)O)(C)O)=O,,,5,1,1,0,1
31047_0,,,,2,2,1,3
C(C)(C(C)(C(C(C=C)=O)(C)O)O)=O,,,5,1,1,0,1
31049_0,,,,2,2,1,3
C(C(CC)(C(C(C=C)=O)(C)O)O)=O,,,5,1,1,0,1
31051_0,,,,2,2,1,3
C(C(C(C(C=C)=O)(C)O)(O)O)=O,,,5,1,1,0,1
31053_0,,,,2,2,1,3
C(C(C)(C(C(C=C)=O)(C)O)O)(O)=O,,,5,1,1,0,1
31055_0,,,,2,2,1,3
C(C(C(C(C=C)=O)(C)O)O)(O)=O,,,5,1,2,0,2
31057_0,,,,2,2,1,3
C(C(C)(C(C(C=C)=O)(C)O)O)=O,,,5,1,2,0,2
31059_0,,,,2,2,1,3
C=C(C(O)=O)C(C(C=O)=O)(CO)O,,,5,1,1,0,1
31061_0,,,,2,2,1,3
C(C([C](C(O)=O)O)(CC(C)O)O)=O,,,5,1,2,0,2
31063_0,,,,2,2,1,3
C(C(CC(C)O)(C(C)(CC)O)O)=O,,,5,1,1,0,1
31065_0,,,,2,2,1,3
C(C(C(CC=O)O)(CC(C)O)O)=O,,,5,1,1,0,1
31067_0,,,,2,2,1,3
C(C(CC(C)O)(C(C=C)O)O)=O,,,5,1,1,0,1
31069_0,,,,2,2,1,3
C(C(C(C(O)O)O)(CC(C)O)O)=O,,,5,1,1,0,1
31071_0,,,,2,2,1,3
C(C(C(C)O)(CC(C)O)O)=O,,,5,1,1,0,1
31073_0,,,,2,2,1,3
C(C(C=O)(CC(C)O)O)(O)=O,,,5,1,1,0,1
31074_0,,,,2,2,1,3
31075_0,,,,2,2,1,3
31077_0,,,,2,2,1,3
C(C(CO)(CC(C)O)O)=O,,,5,1,1,0,1
31079_0,,,,2,2,1,3
C(C(C(CCO)O)(CC(C)O)O)=O,,,5,1,1,0,1
31080_0,,,,2,2,1,3
31081_0,,,,2,2,1,3
31083_0,,,,2,2,1,3
C(C(CC(C)O)(C(C=CC)O)O)=O,,,5,1,1,0,1
31085_0,,,,2,2,1,3
C(C(C(CC=C)O)(CC(C)O)O)=O,,,5,1,1,0,1
31086_0,,,,2,2,1,3
31088_0,,,,2,2,1,3
C(C(C(C(C)O)O)(CC(C)O)O)=O,,,5,1,1,0,1
31089_0,,,,2,2,1,3
31090_0,,,,2,2,1,3
31092_0,,,,2,2,1,3
C(C(C(C(CC(C)O)O)O)(O)O)=O,,,5,1,1,0,1
31093_0,,,,2,2,1,3
31095_0,,,,2,2,1,3
C(C(C)(C(C(CC(C)O)O)O)O)=O,,,5,1,1,0,1
31097_0,,,,2,2,1,3
C(C([C](C(O)=O)O)(CC(O)=O)O)=O,,,5,1,2,0,2
31099_0,,,,2,2,1,3
C(C(C(C)(CC)O)(CC(O)=O)O)=O,,,5,1,1,0,1
31101_0,,,,2,2,1,3
C(CC(C(C=O)(CC(O)=O)O)O)=O,,,5,1,1,0,1
31103_0,,,,2,2,1,3
C(CC(C=O)(C(C=C)O)O)(O)=O,,,5,1,1,0,1
31105_0,,,,2,2,1,3
C(C(C(C(O)O)O)(CC(O)=O)O)=O,,,5,1,1,0,1
31107_0,,,,2,2,1,3
C(C(C(C)O)(CC(O)=O)O)=O,,,5,1,1,0,1
31109_0,,,,2,2,1,3
C(C(C=O)(CC(O)=O)O)(O)=O,,,5,1,1,0,1
31110_0,,,,2,2,1,3
31111_0,,,,2,2,1,3
31112_0,,,,2,2,1,3
31114_0,,,,2,2,1,3
C(C(C(CCO)O)(CC(O)=O)O)=O,,,5,1,1,0,1
31115_0,,,,2,2,1,3
31116_0,,,,2,2,1,3
31118_0,,,,2,2,1,3
C(CC(C=O)(C(C=CC)O)O)(O)=O,,,5,1,1,0,1
31120_0,,,,2,2,1,3
C(C(C(CC=C)O)(CC(O)=O)O)=O,,,5,1,1,0,1
31121_0,,,,2,2,1,3
31122_0,,,,2,2,1,3
31123_0,,,,2,2,1,3
31124_0,,,,2,2,1,3
31126_0,,,,2,2,1,3
C(CC(C(C(C=O)(O)O)O)O)(O)=O,,,5,1,1,0,1
31127_0,,,,2,2,1,3
31129_0,,,,2,2,1,3
C(C(C)(C(C(CC(O)=O)O)O)O)=O,,,5,1,1,0,1
31130_0,,,,2,2,1,3
31132_0,,,,2,2,1,3
C(C(C(C(C(CO)=O)O)O)(O)O)=O,,,5,1,1,0,1
31133_0,,,,2,2,1,3
31134_0,,,,2,2,1,3
31135_0,,,,2,2,1,3
31137_0,,,,2,2,1,3
C(C(C(CO)(C(C=O)(O)O)O)O)=O,,,5,1,1,0,1
31138_0,,,,2,2,1,3
31140_0,,,,2,2,1,3
C(C(C)(C(CO)(C(C=O)O)O)O)=O,,,5,1,4,0,4
31141_0,,,,2,2,1,3
31143_0,,,,2,2,1,3
C(C(CO)(C(C(C=O)(O)O)O)O)=O,,,5,1,1,0,1
31144_0,,,,2,2,1,3
31145_0,,,,2,2,1,3
31146_0,,,,2,2,1,3
31148_0,,,,2,2,1,3
C(C(C)(C(C(C(C)=O)(C)O)O)O)=O,,,5,1,1,0,1
31150_0,,,,2,2,1,3
C(C(C)(C(C(C=O)(CC)O)O)O)=O,,,5,1,1,0,1
31152_0,,,,2,2,1,3
C(C(C)(C(C(C=O)(O)O)O)O)=O,,,5,1,1,0,1
31153_0,,,,2,2,1,3
31154_0,,,,2,2,1,3
31156_0,,,,2,2,1,3
C(C(C)(C(C(C=O)(C)O)O)O)=O,,,5,1,1,0,1
31157_0,,,,2,2,1,3
31159_0,,,,2,2,1,3
C(C(C(C)(C(C(C)=O)(C)O)O)O)=O,,,5,1,1,0,1
31161_0,,,,2,2,1,3
C(C(CC)(C(C)(C(C=O)O)O)O)=O,,,5,1,1,0,1
31163_0,,,,2,2,1,3
C(C(C(C)(C(C=O)(O)O)O)O)=O,,,5,1,1,0,1
31164_0,,,,2,2,1,3
31165_0,,,,2,2,1,3
31167_0,,,,2,2,1,3
C(C(C)(C(C)(C(C=O)O)O)O)=O,,,5,1,1,0,1
31168_0,,,,2,2,1,3
31170_0,,,,2,2,1,3
C(C)(C(C)(C(C(C(C)=O)O)O)O)=O,,,5,1,1,0,1
31172_0,,,,2,2,1,3
C(C(C(C(C(C)=O)O)O)(CC)O)=O,,,5,1,1,0,1
31174_0,,,,2,2,1,3
C(C(C(C(C(C)=O)O)O)(O)O)=O,,,5,1,1,0,1
31175_0,,,,2,2,1,3
31176_0,,,,2,2,1,3
31177_0,,,,2,2,1,3
31179_0,,,,2,2,1,3
C(C(C=C)(C(C(C)=O)(C)O)O)(O)=O,,,5,1,2,0,2
31181_0,,,,2,2,1,3
C(C)(C([C](C(O)=O)O)(C)O)=O,,,5,1,2,0,2
31183_0,,,,2,2,1,3
C(C)(C(C)(C(C(C)=O)(C)O)O)=O,,,5,1,1,0,1
31185_0,,,,2,2,1,3
C(C(CC)(C(C(C)=O)(C)O)O)=O,,,5,1,1,0,1
31187_0,,,,2,2,1,3
C(C)(C(C)(C1(C(CCO1)=O)O)O)=O,,,5,1,1,0,1
31189_0,,,,2,2,1,3
C(C(CCO)(C(C(C)=O)(C)O)O)=O,,,5,1,2,0,2
31191_0,,,,2,2,1,3
C(C)(C(C)(C(C=O)(O)O)O)=O,,,5,1,1,0,1
31193_0,,,,2,2,1,3
C(C(C)(C(C(C)=O)(C)O)O)(O)=O,,,5,1,2,0,2
31195_0,,,,2,2,1,3
C(C)(C(C)(C(C(O)=O)O)O)=O,,,5,1,2,0,2
31197_0,,,,2,2,1,3
C(C(C)(C(C(C)=O)(C)O)O)=O,,,5,1,2,0,2
31199_0,,,,2,2,1,3
C(CC=O)(C([C](C(O)=O)O)(C)O)=O,,,5,1,2,0,2
31200_0,,,,2,2,1,3
31202_0,,,,2,2,1,3
C(C(C=C)([C](C(O)=O)O)O)(O)=O,,,5,1,2,0,2
31204_0,,,,2,2,1,3
C([C]([C](C(O)=O)O)O)(O)=O,,,5,1,1,0,1
31205_0,,,,2,2,1,3
31207_0,,,,2,2,1,3
C=CC([C](C(O)=O)O)(C(C=O)=O)O,,,5,1,1,0,1
31209_0,,,,2,2,1,3
C(C(C=CC)([C](C(O)=O)O)O)(O)=O,,,5,1,2,0,2
31211_0,,,,2,2,1,3
C(C([C](C(O)=O)O)(CC=C)O)(O)=O,,,5,1,2,0,2
31213_0,,,,2,2,1,3
C(C([C](C(O)=O)O)(CC)O)=O,,,5,1,1,0,1
31215_0,,,,2,2,1,3
C1(C(COC1([C](C(O)=O)O)O)O)=O,,,5,1,1,0,1
31217_0,,,,2,2,1,3
C1(CCOC1([C](C(O)=O)O)O)=O,,,5,1,1,0,1
31219_0,,,,2,2,1,3
C1(CC(C)OC1([C](C(O)=O)O)O)=O,,,5,1,1,0,1
31221_0,,,,2,2,1,3
C1(CC(C([C](C(O)=O)O)(O)O1)=O)=O,,,5,1,1,0,1
31223_0,,,,2,2,1,3
C1(C([C](C(O)=O)O)(CC(C)O1)O)=O,,,5,1,2,0,2
31225_0,,,,2,2,1,3
C1(C([C](C(O)=O)O)(CC(O1)=O)O)=O,,,5,1,2,0,2
31227_0,,,,2,2,1,3
C(C([C](C(O)=O)O)(CCO)O)=O,,,5,1,2,0,2
31229_0,,,,2,2,1,3
C(C([C](C(O)=O)O)(O)O)=O,,,5,1,1,0,1
31231_0,,,,2,2,1,3
[C](C(O)=O)(C(C(C(O)=O)=O)(C)O)O,,,5,1,2,0,2
31233_0,,,,2,2,1,3
C(C([C](C(O)=O)O)(C)O)(O)=O,,,5,1,3,0,3
31234_0,,,,2,2,1,3
31236_0,,,,2,2,1,3
C(CC(C(C)=O)([C](C(O)=O)O)O)=O,,,5,1,2,0,2
31238_0,,,,2,2,1,3
[C](C(O)=O)(C(C(C(C)=O)=O)(C)O)O,,,5,1,1,0,1
31240_0,,,,2,2,1,3
C(C([C](C(O)=O)O)(C)O)=O,,,5,1,3,0,3
31242_0,,,,2,2,1,3
C(CC([C](C(O)=O)O)(C)O)(O)=O,,,5,1,1,0,1
31244_0,,,,2,2,1,3
C(CC(C)(C(C(C)=O)(C)O)O)(O)=O,,,5,1,1,0,1
31246_0,,,,2,2,1,3
C(C(CC)(C(C)(CC(O)=O)O)O)=O,,,5,1,1,0,1
31248_0,,,,2,2,1,3
C(CC(C)(C(C=O)(O)O)O)(O)=O,,,5,1,1,0,1
31250_0,,,,2,2,1,3
C(C(C)(C(C)(CC(O)=O)O)O)(O)=O,,,5,1,1,0,1
31252_0,,,,2,2,1,3
C(CC(C)(C(C(O)=O)O)O)(O)=O,,,5,1,1,0,1
31254_0,,,,2,2,1,3
C(C(C)(C(C)(CC(O)=O)O)O)=O,,,5,1,1,0,1
31256_0,,,,2,2,1,3
C(C(C=C)(C(C)(CCO)O)O)(O)=O,,,5,1,1,0,1
31258_0,,,,2,2,1,3
[C](C(O)=O)(C(C)(CCO)O)O,,,5,1,1,0,1
31260_0,,,,2,2,1,3
C(C)(C(C)(C(C)(CCO)O)O)=O,,,5,1,1,0,1
31262_0,,,,2,2,1,3
C(C(CC)(C(C)(CCO)O)O)=O,,,5,1,1,0,1
31264_0,,,,2,2,1,3
C1(C(C(C)(CCO)O)(O)OCC1)=O,,,5,1,1,0,1
31266_0,,,,2,2,1,3
C(C(CCO)(C(C)(CCO)O)O)=O,,,5,1,1,0,1
31268_0,,,,2,2,1,3
C(C(C(C)(CCO)O)(O)O)=O,,,5,1,1,0,1
31270_0,,,,2,2,1,3
C(C(C)(C(C)(CCO)O)O)(O)=O,,,5,1,1,0,1
31272_0,,,,2,2,1,3
C(C(C(C)(CCO)O)O)(O)=O,,,5,1,1,0,1
31274_0,,,,2,2,1,3
C(C(C)(C(C)(CCO)O)O)=O,,,5,1,1,0,1
31276_0,,,,2,2,1,3
C(CC(C(C)(C(C)(CC)O)O)=O)=O,,,5,1,1,0,1
31278_0,,,,2,2,1,3
C(C)(C(CCO)(C(C)(CC)O)O)=O,,,5,1,1,0,1
31280_0,,,,2,2,1,3
C(C(C=C)(C(C)(CC)O)O)(O)=O,,,5,1,1,0,1
31282_0,,,,2,2,1,3
[C](C(O)=O)(C(C)(CC)O)O,,,5,1,1,0,1
31284_0,,,,2,2,1,3
C(C)(C(C)(C(C)(CC)O)O)=O,,,5,1,1,0,1
31286_0,,,,2,2,1,3
C=CC(C(C=O)=O)(C(C)(CC)O)O,,,5,1,1,0,1
31288_0,,,,2,2,1,3
C(C(C=CC)(C(C)(CC)O)O)(O)=O,,,5,1,1,0,1
31290_0,,,,2,2,1,3
C(C(C(C)(CC)O)(CC=C)O)(O)=O,,,5,1,1,0,1
31292_0,,,,2,2,1,3
C(C(CC)(C(C)(CC)O)O)=O,,,5,1,1,0,1
31294_0,,,,2,2,1,3
C1(C(C(C)(CC)O)(O)OCC1O)=O,,,5,1,1,0,1
31296_0,,,,2,2,1,3
C1(C(C(C)(CC)O)(O)OCC1)=O,,,5,1,1,0,1
31298_0,,,,2,2,1,3
C1(C(C(C)(CC)O)(O)OC(C)C1)=O,,,5,1,1,0,1
31300_0,,,,2,2,1,3
C1(CC(C(C(C)(CC)O)(O)O1)=O)=O,,,5,1,1,0,1
31302_0,,,,2,2,1,3
C1(C(CC(C)O1)(C(C)(CC)O)O)=O,,,5,1,1,0,1
31304_0,,,,2,2,1,3
C1(C(C(C)(CC)O)(CC(O1)=O)O)=O,,,5,1,1,0,1
31306_0,,,,2,2,1,3
C(C(CCO)(C(C)(CC)O)O)=O,,,5,1,1,0,1
31308_0,,,,2,2,1,3
C(C(C(C)(CC)O)(O)O)=O,,,5,1,1,0,1
31310_0,,,,2,2,1,3
C(C(C(C)(C(C)(CC)O)O)=O)(O)=O,,,5,1,1,0,1
31312_0,,,,2,2,1,3
C(C(C)(C(C)(CC)O)O)(O)=O,,,5,1,1,0,1
31314_0,,,,2,2,1,3
C(C(C(C)(CC)O)O)(O)=O,,,5,1,1,0,1
31316_0,,,,2,2,1,3
C(C)(C(C(C)(CC)O)(CC=O)O)=O,,,5,1,1,0,1
31318_0,,,,2,2,1,3
C(C(C)=O)(C(C)(C(C)(CC)O)O)=O,,,5,1,1,0,1
31320_0,,,,2,2,1,3
C(C(C)(C(C)(CC)O)O)=O,,,5,1,1,0,1
31322_0,,,,2,2,1,3
C(C(C)(C(C=C)O)O)(CC(O)=O)=O,,,5,1,1,0,1
31324_0,,,,2,2,1,3
C(CC(C(C)(C(C)O)O)=O)(O)=O,,,5,1,1,0,1
31325_0,,,,2,2,1,3
31327_0,,,,2,2,1,3
C(CC(C(CO)(C)O)=O)(O)=O,,,5,1,1,0,1
31328_0,,,,2,2,1,3
31330_0,,,,2,2,1,3
C(CC(C(C)(C(CO)O)O)=O)(O)=O,,,5,1,1,0,1
31332_0,,,,2,2,1,3
[C](C(O)=O)(C(C)(C[CH]C(O)=O)O)O,,,5,1,1,0,1
31334_0,,,,2,2,1,3
C(C(C(C)(C[CH]C(O)=O)O)(O)O)=O,,,5,1,1,0,1
31335_0,,,,2,2,1,3
31337_0,,,,2,2,1,3
C(C(C)(C(C)(C[CH]C(O)=O)O)O)=O,,,5,1,2,0,2
31339_0,,,,2,2,1,3
C(CCC([C](C(O)=O)O)(C)O)(O)=O,,,5,1,1,0,1
31341_0,,,,2,2,1,3
C(CCC(C)(C(C=O)(O)O)O)(O)=O,,,5,1,1,0,1
31342_0,,,,2,2,1,3
31344_0,,,,2,2,1,3
C(C(C)(C(C)(CCC(O)=O)O)O)=O,,,5,1,2,0,2
31345_0,,,,2,2,1,3
31347_0,,,,2,2,1,3
C(C)(C(C)(C(C[CH]C(O)=O)O)O)=O,,,5,1,1,0,1
31349_0,,,,2,2,1,3
C(C(C(C[CH]C(O)=O)O)(CC)O)=O,,,5,1,1,0,1
31351_0,,,,2,2,1,3
C(C(C(C[CH]C(O)=O)O)(O)O)=O,,,5,1,1,0,1
31352_0,,,,2,2,1,3
31353_0,,,,2,2,1,3
31355_0,,,,2,2,1,3
C(C(C)(C(C[CH]C(O)=O)O)O)=O,,,5,1,2,0,2
31356_0,,,,2,2,1,3
31358_0,,,,2,2,1,3
C(CCC(C(C(C)=O)(C)O)O)(O)=O,,,5,1,1,0,1
31360_0,,,,2,2,1,3
C(C(C(CCC(O)=O)O)(CC)O)=O,,,5,1,1,0,1
31362_0,,,,2,2,1,3
C(CCC(C(C=O)(O)O)O)(O)=O,,,5,1,1,0,1
31363_0,,,,2,2,1,3
31364_0,,,,2,2,1,3
31366_0,,,,2,2,1,3
C(C(C)(C(CCC(O)=O)O)O)=O,,,5,1,2,0,2
31368_0,,,,2,2,1,3
C(C(C(C(CO)(C)O)=O)C(C)O)=O,,,5,1,1,0,1
31370_0,,,,2,2,1,3
C(C(C=O)C(C(CO)(C)O)=O)(O)=O,,,5,1,1,0,1
31372_0,,,,2,2,1,3
C(C(CO)(C)O)(C(C(C=O)=O)O)=O,,,5,1,1,0,1
31374_0,,,,2,2,1,3
C(C(C)(C(C=C)O)O)(C(C=O)O)=O,,,5,1,1,0,1
31375_0,,,,2,2,1,3
31376_0,,,,2,2,1,3
31377_0,,,,2,2,1,3
31378_0,,,,2,2,1,3
31379_0,,,,2,2,1,3
31381_0,,,,2,2,1,3
C(C(C)(C(C)O)O)(CC(C=O)=O)=O,,,5,1,1,0,1
31383_0,,,,2,2,1,3
C(C(C(CC(C=O)=O)=O)(C)O)(O)=O,,,5,1,1,0,1
31385_0,,,,2,2,1,3
C(C(CO)(C)O)(CC(C=O)=O)=O,,,5,1,1,0,1
31387_0,,,,2,2,1,3
C(C(C)(C(CC=O)O)O)(CC=O)=O,,,5,1,1,0,1
31389_0,,,,2,2,1,3
C(C(C)(C(C=C)O)O)(CC=O)=O,,,5,1,1,0,1
31391_0,,,,2,2,1,3
C(CC(C(C)(C(C(O)O)O)O)=O)=O,,,5,1,1,0,1
31393_0,,,,2,2,1,3
C(CC(C(C)(C(C)O)O)=O)=O,,,5,1,1,0,1
31395_0,,,,2,2,1,3
C(C(C(CC=O)=O)(C)O)(O)=O,,,5,1,3,0,3
31396_0,,,,2,2,1,3
31397_0,,,,2,2,1,3
31399_0,,,,2,2,1,3
C(CC(C(CO)(C)O)=O)=O,,,5,1,1,0,1
31401_0,,,,2,2,1,3
C(CC(C(C)(C(CCO)O)O)=O)=O,,,5,1,1,0,1
31402_0,,,,2,2,1,3
31403_0,,,,2,2,1,3
31405_0,,,,2,2,1,3
C(C(C)(C(C=CC)O)O)(CC=O)=O,,,5,1,1,0,1
31407_0,,,,2,2,1,3
C(C(C)(C(CC=C)O)O)(CC=O)=O,,,5,1,1,0,1
31408_0,,,,2,2,1,3
31410_0,,,,2,2,1,3
C(CC(C(C)(C(C(C)O)O)O)=O)=O,,,5,1,1,0,1
31411_0,,,,2,2,1,3
31413_0,,,,2,2,1,3
C(CC([C](C(O)=O)O)O)(C(C)O)=O,,,5,1,1,0,1
31415_0,,,,2,2,1,3
C(C(C)O)(CC(C(C=O)(O)O)O)=O,,,5,1,1,0,1
31416_0,,,,2,2,1,3
31417_0,,,,2,2,1,3
31419_0,,,,2,2,1,3
C(CC([C](C(O)=O)O)(C(C)O)O)=O,,,5,1,1,0,1
31421_0,,,,2,2,1,3
C(CC(C(C)O)(C(C=O)(O)O)O)=O,,,5,1,1,0,1
31422_0,,,,2,2,1,3
31424_0,,,,2,2,1,3
C(C(C)(C(C(C)O)(CC=O)O)O)=O,,,5,1,1,0,1
31426_0,,,,2,2,1,3
C(C(CO)(C)O)(CC(C(O)=O)=O)=O,,,5,1,1,0,1
31428_0,,,,2,2,1,3
C(C(C(C(C)(C(C)O)O)=O)O)(O)=O,,,5,1,1,0,1
31429_0,,,,2,2,1,3
31430_0,,,,2,2,1,3
31431_0,,,,2,2,1,3
31433_0,,,,2,2,1,3
C(C(C(C)(C(C(C)=O)O)O)(O)O)=O,,,5,1,1,0,1
31434_0,,,,2,2,1,3
31435_0,,,,2,2,1,3
31437_0,,,,2,2,1,3
C(C(C(C(CO)(C)O)=O)(C)O)(O)=O,,,5,1,1,0,1
31438_0,,,,2,2,1,3
31439_0,,,,2,2,1,3
31441_0,,,,2,2,1,3
C(CO)(C(CCO)(C(C=C)O)O)=O,,,5,1,1,0,1
31442_0,,,,2,2,1,3
31443_0,,,,2,2,1,3
31444_0,,,,2,2,1,3
31445_0,,,,2,2,1,3
31446_0,,,,2,2,1,3
31448_0,,,,2,2,1,3
[C](C(O)=O)(C(C(C)(CCO)O)O)O,,,5,1,1,0,1
31450_0,,,,2,2,1,3
C(C(C(C(C)(CCO)O)O)(O)O)=O,,,5,1,1,0,1
31451_0,,,,2,2,1,3
31452_0,,,,2,2,1,3
31454_0,,,,2,2,1,3
C(CC(C(C(C)=O)(CCO)O)O)=O,,,5,1,1,0,1
31456_0,,,,2,2,1,3
C(C)(C(CCO)(C(C=C)O)O)=O,,,5,1,1,0,1
31458_0,,,,2,2,1,3
C(C)(C(C(C(O)O)O)(CCO)O)=O,,,5,1,1,0,1
31459_0,,,,2,2,1,3
31460_0,,,,2,2,1,3
31461_0,,,,2,2,1,3
31462_0,,,,2,2,1,3
31463_0,,,,2,2,1,3
31464_0,,,,2,2,1,3
31465_0,,,,2,2,1,3
31466_0,,,,2,2,1,3
31467_0,,,,2,2,1,3
31468_0,,,,2,2,1,3
31469_0,,,,2,2,1,3
31470_0,,,,2,2,1,3
31471_0,,,,2,2,1,3
31473_0,,,,2,2,1,3
[C](C(O)=O)(C(C)(C(CCO)O)O)O,,,5,1,1,0,1
31475_0,,,,2,2,1,3
C(C(C(C)(C(CCO)O)O)(O)O)=O,,,5,1,1,0,1
31476_0,,,,2,2,1,3
31477_0,,,,2,2,1,3
31478_0,,,,2,2,1,3
31479_0,,,,2,2,1,3
31480_0,,,,2,2,1,3
31481_0,,,,2,2,1,3
31482_0,,,,2,2,1,3
31484_0,,,,2,2,1,3
C(CC(C(C)=O)(C(C=C)O)O)(O)=O,,,5,1,1,0,1
31485_0,,,,2,2,1,3
31486_0,,,,2,2,1,3
31487_0,,,,2,2,1,3
31488_0,,,,2,2,1,3
31489_0,,,,2,2,1,3
31490_0,,,,2,2,1,3
31491_0,,,,2,2,1,3
31492_0,,,,2,2,1,3
31493_0,,,,2,2,1,3
31494_0,,,,2,2,1,3
31495_0,,,,2,2,1,3
31496_0,,,,2,2,1,3
31498_0,,,,2,2,1,3
C(C(C(C(CO)(CO)O)O)(O)O)=O,,,5,1,1,0,1
31499_0,,,,2,2,1,3
31501_0,,,,2,2,1,3
C(C(C)(C(C(CO)(CO)O)O)O)=O,,,5,1,1,0,1
31503_0,,,,2,2,1,3
[C](C(O)=O)(C(C(C)(C(C)O)O)O)O,,,5,1,1,0,1
31505_0,,,,2,2,1,3
C(C(C(C(C)(C(C)O)O)O)(O)O)=O,,,5,1,1,0,1
31507_0,,,,2,2,1,3
C(C(C(C(C)(C(C)O)O)O)O)(O)=O,,,5,1,1,0,1
31509_0,,,,2,2,1,3
C(C(C)(C(C(C)(C(C)O)O)O)O)=O,,,5,1,1,0,1
31510_0,,,,2,2,1,3
31512_0,,,,2,2,1,3
C(C)(C(C)(C(C(CO)(C)O)O)O)=O,,,5,1,1,0,1
31514_0,,,,2,2,1,3
C(C(CC)(C(C(CO)(C)O)O)O)=O,,,5,1,1,0,1
31516_0,,,,2,2,1,3
C(C(C(C(CO)(C)O)O)(O)O)=O,,,5,1,1,0,1
31517_0,,,,2,2,1,3
31518_0,,,,2,2,1,3
31520_0,,,,2,2,1,3
C(C(C)(C(C(CO)(C)O)O)O)=O,,,5,1,1,0,1
31522_0,,,,2,2,1,3
C(C(C=C)(C(C)(C(C)O)O)O)(O)=O,,,5,1,1,0,1
31524_0,,,,2,2,1,3
C(C(C=C)(C(CO)(CC)O)O)(O)=O,,,5,1,1,0,1
31526_0,,,,2,2,1,3
C(C(C=C)(C(CC=O)O)O)(O)=O,,,5,1,1,0,1
31528_0,,,,2,2,1,3
C(C(C=C)(C([CH]C(O)=O)O)O)(O)=O,,,5,1,1,0,1
31530_0,,,,2,2,1,3
C(C(C=C)(C(C(O)=O)(C=C)O)O)=O,,,5,1,1,0,1
31532_0,,,,2,2,1,3
C(C(C=C)(C(C(C=C)=O)O)O)(O)=O,,,5,1,1,0,1
31534_0,,,,2,2,1,3
C(C(C=C)(C(C=C)O)O)(O)=O,,,5,1,1,0,1
31536_0,,,,2,2,1,3
C(C(C=C)(C(C(CC)O)O)O)(O)=O,,,5,1,1,0,1
31538_0,,,,2,2,1,3
C(C(C=C)(C(CCCO)O)O)(O)=O,,,5,1,1,0,1
31540_0,,,,2,2,1,3
C(C(C=C)(C(C(O)O)O)O)(O)=O,,,5,1,1,0,1
31542_0,,,,2,2,1,3
C(C(C=C)(C(C)O)O)(O)=O,,,5,1,2,0,2
31544_0,,,,2,2,1,3
C(C(C(O)=O)(C=C)O)(O)=O,,,5,1,2,0,2
31546_0,,,,2,2,1,3
C(C(C=C)(C(CC(C)O)O)O)(O)=O,,,5,1,1,0,1
31548_0,,,,2,2,1,3
C(C(C=C)(C(CC(O)=O)O)O)(O)=O,,,5,1,1,0,1
31549_0,,,,2,2,1,3
31550_0,,,,2,2,1,3
31552_0,,,,2,2,1,3
C(C(C=C)(C(C=O)(C)O)O)(O)=O,,,5,1,4,0,4
31553_0,,,,2,2,1,3
31554_0,,,,2,2,1,3
31556_0,,,,2,2,1,3
C(C(C=C)(C(CCO)O)O)(O)=O,,,5,1,2,0,2
31557_0,,,,2,2,1,3
31559_0,,,,2,2,1,3
C(C(C=C)(C(C(C=O)O)O)O)(O)=O,,,5,1,1,0,1
31561_0,,,,2,2,1,3
C(C(C=C)(C(CO)(CO)O)O)(O)=O,,,5,1,1,0,1
31563_0,,,,2,2,1,3
C(C(C=C)(C(CO)(C)O)O)(O)=O,,,5,1,2,0,2
31565_0,,,,2,2,1,3
C(C(C=C)(C(C=CC)O)O)(O)=O,,,5,1,2,0,2
31567_0,,,,2,2,1,3
C(C(C=C)(C(CC=C)O)O)(O)=O,,,5,1,2,0,2
31569_0,,,,2,2,1,3
C(C(C=C)(C(C(CO)O)O)O)(O)=O,,,5,1,1,0,1
31571_0,,,,2,2,1,3
C(C(C=C)(C(CO)O)O)(O)=O,,,5,1,2,0,2
31573_0,,,,2,2,1,3
C(C(C=C)(C(C(C)O)O)O)(O)=O,,,5,1,2,0,2
31575_0,,,,2,2,1,3
C(C(C=C)(C(C(O)=O)O)O)(O)=O,,,5,1,5,0,5
31577_0,,,,2,2,1,3
C(C(C=C)(C(C(O)=O)(C)O)O)(O)=O,,,5,1,2,0,2
31579_0,,,,2,2,1,3
C(C(C(C(O)=O)=C)(C(C)O)O)(O)=O,,,5,1,1,0,1
31581_0,,,,2,2,1,3
C(C(C(O)=O)(C(C(O)=O)=C)O)(O)=O,,,5,1,1,0,1
31582_0,,,,2,2,1,3
31584_0,,,,2,2,1,3
C=C(C(O)=O)C([C](C(O)=O)O)O,,,5,1,3,0,3
31586_0,,,,2,2,1,3
C(C)(C(C)(C(C(C(O)=O)=C)O)O)=O,,,5,1,1,0,1
31588_0,,,,2,2,1,3
C(C(CC)(C(C(C(O)=O)=C)O)O)=O,,,5,1,1,0,1
31590_0,,,,2,2,1,3
C(C(C(C(C(O)=O)=C)O)(O)O)=O,,,5,1,1,0,1
31592_0,,,,2,2,1,3
C(C(C)(C(C(C(O)=O)=C)O)O)(O)=O,,,5,1,1,0,1
31593_0,,,,2,2,1,3
31595_0,,,,2,2,1,3
C(C(C)(C(C(C(O)=O)=C)O)O)=O,,,5,1,3,0,3
31597_0,,,,2,2,1,3
C(C(CO)(C)O)(OC(C(C)=O)=O)=O,,,5,1,1,0,1
31599_0,,,,2,2,1,3
C(C(C=O)CC([C](C(O)=O)O)O)=O,,,5,1,1,0,1
31601_0,,,,2,2,1,3
C(CC(C=O)C([C](C(O)=O)O)O)=O,,,5,1,1,0,1
31603_0,,,,2,2,1,3
C([C](C(CC(C=O)=O)O)O)(O)=O,,,5,1,1,0,1
31605_0,,,,2,2,1,3
C(CC(C([C](C(O)=O)O)O)=O)=O,,,5,1,1,0,1
31606_0,,,,2,2,1,3
31607_0,,,,2,2,1,3
31609_0,,,,2,2,1,3
C(C([C](C(O)=O)O)O)(CC(C)=O)=O,,,5,1,1,0,1
31611_0,,,,2,2,1,3
C(C([C](C(O)=O)O)(CC(C)=O)O)=O,,,5,1,1,0,1
31613_0,,,,2,2,1,3
[C](C(O)=O)(C(C(C=O)=O)(CC)O)O,,,5,1,1,0,1
31615_0,,,,2,2,1,3
[C](C(O)=O)(C(C(C(CC)=O)=O)O)O,,,5,1,1,0,1
31617_0,,,,2,2,1,3
C(C(C(CC)=O)([C](C(O)=O)O)O)=O,,,5,1,1,0,1
31618_0,,,,2,2,1,3
31620_0,,,,2,2,1,3
C(C(CC([C](C(O)=O)O)O)=O)(O)=O,,,5,1,1,0,1
31621_0,,,,2,2,1,3
31623_0,,,,2,2,1,3
C(C([C](C(O)=O)O)(CC)O)(O)=O,,,5,1,1,0,1
31625_0,,,,2,2,1,3
[C](C(O)=O)(C(C)(C(C)O)O)O,,,5,1,1,0,1
31627_0,,,,2,2,1,3
[C](C(O)=O)(C(CO)(CC)O)O,,,5,1,1,0,1
31629_0,,,,2,2,1,3
C(CC([C](C(O)=O)O)O)=O,,,5,1,1,0,1
31631_0,,,,2,2,1,3
C([CH]C([C](C(O)=O)O)O)(O)=O,,,5,1,1,0,1
31633_0,,,,2,2,1,3
C(C([C](C(O)=O)O)O)=CCC(C)O,,,5,1,1,0,1
31635_0,,,,2,2,1,3
C(CC([C](C(O)=O)O)O)=CC(C)O,,,5,1,1,0,1
31637_0,,,,2,2,1,3
C=C(C(C)O)C([C](C(O)=O)O)O,,,5,1,1,0,1
31639_0,,,,2,2,1,3
C(C)=C(CO)C([C](C(O)=O)O)O,,,5,1,1,0,1
31641_0,,,,2,2,1,3
C(C(C)O)(C([C](C(O)=O)O)O)=CC,,,5,1,1,0,1
31643_0,,,,2,2,1,3
C(C)=C(C(O)=O)C([C](C(O)=O)O)O,,,5,1,1,0,1
31645_0,,,,2,2,1,3
C(CC=CC([C](C(O)=O)O)O)(O)=O,,,5,1,1,0,1
31647_0,,,,2,2,1,3
C(CC([C](C(O)=O)O)O)=CC(O)=O,,,5,1,1,0,1
31649_0,,,,2,2,1,3
C(C([C](C(O)=O)O)O)=CC(CO)=O,,,5,1,1,0,1
31651_0,,,,2,2,1,3
C(C([C](C(O)=O)O)(CO)O)=CC=O,,,5,1,1,0,1
31653_0,,,,2,2,1,3
C(C([C](C(O)=O)O)O)=C(C=O)CO,,,5,1,1,0,1
31655_0,,,,2,2,1,3
C(CO)(C([C](C(O)=O)O)O)=CC=O,,,5,1,1,0,1
31657_0,,,,2,2,1,3
C(C([C](C(O)=O)O)O)(C(C=C)O)=O,,,5,1,1,0,1
31659_0,,,,2,2,1,3
C(C([C](C(O)=O)O)(C(C=C)O)O)=O,,,5,1,1,0,1
31661_0,,,,2,2,1,3
C(C([C](C(O)=O)O)O)=C(C=O)C,,,5,1,1,0,1
31663_0,,,,2,2,1,3
C(C)(C([C](C(O)=O)O)O)=CC=O,,,5,1,1,0,1
31665_0,,,,2,2,1,3
C=C(C=O)CC([C](C(O)=O)O)O,,,5,1,1,0,1
31667_0,,,,2,2,1,3
C(CC(C([C](C(O)=O)O)O)=C)=O,,,5,1,1,0,1
31669_0,,,,2,2,1,3
C(C([C](C(O)=O)O)O)=CC(C)=O,,,5,1,1,0,1
31671_0,,,,2,2,1,3
C(C([C](C(O)=O)O)(C)O)=CC=O,,,5,1,1,0,1
31673_0,,,,2,2,1,3
C(C(C=C)([C](C(O)=O)O)O)=O,,,5,1,1,0,1
31675_0,,,,2,2,1,3
C=CC(C([C](C(O)=O)O)O)=O,,,5,1,1,0,1
31677_0,,,,2,2,1,3
C(C([C](C(O)=O)O)(CC=C)O)=O,,,5,1,1,0,1
31679_0,,,,2,2,1,3
C(CC=C)(C([C](C(O)=O)O)O)=O,,,5,1,1,0,1
31681_0,,,,2,2,1,3
C(C(C=CC)([C](C(O)=O)O)O)=O,,,5,1,1,0,1
31683_0,,,,2,2,1,3
C(C)=CC(C([C](C(O)=O)O)O)=O,,,5,1,1,0,1
31685_0,,,,2,2,1,3
C=CC([C](C(O)=O)O)O,,,5,1,3,0,3
31686_0,,,,2,2,1,3
31688_0,,,,2,2,1,3
C=C(C(O)=O)C([C](C(O)=O)O)(C)O,,,5,1,1,0,1
31690_0,,,,2,2,1,3
[C](C(O)=O)(C(C(CC)O)O)O,,,5,1,1,0,1
31692_0,,,,2,2,1,3
[C](C(O)=O)(C(CCCO)O)O,,,5,1,1,0,1
31694_0,,,,2,2,1,3
[C](C(O)=O)(C1(C(O)OCC1O)O)O,,,5,1,1,0,1
31696_0,,,,2,2,1,3
[C](C(O)=O)(C1(C(O)OCC1)O)O,,,5,1,1,0,1
31698_0,,,,2,2,1,3
[C](C(O)=O)(C1(C(O)OC(C)C1)O)O,,,5,1,1,0,1
31700_0,,,,2,2,1,3
C1(CC([C](C(O)=O)O)(C(O)O1)O)=O,,,5,1,1,0,1
31702_0,,,,2,2,1,3
C1(C([C](C(O)=O)O)(C(CO1)O)O)=O,,,5,1,1,0,1
31704_0,,,,2,2,1,3
C1(C([C](C(O)=O)O)(CCO1)O)=O,,,5,1,1,0,1
31705_0,,,,2,2,1,3
31707_0,,,,2,2,1,3
C1(C(C(CO1)=O)([C](C(O)=O)O)O)=O,,,5,1,1,0,1
31709_0,,,,2,2,1,3
[C](C(O)=O)(C(CC(CO)C)O)O,,,5,1,1,0,1
31711_0,,,,2,2,1,3
[C](C(O)=O)(C(CC(C)CCO)O)O,,,5,1,1,0,1
31713_0,,,,2,2,1,3
[C](C(O)=O)(C(CC(C)C(C)O)O)O,,,5,1,1,0,1
31715_0,,,,2,2,1,3
C(CC(C)CC([C](C(O)=O)O)O)=O,,,5,1,1,0,1
31717_0,,,,2,2,1,3
[C](C(O)=O)(C([C](C(O)=O)O)(C)O)O,,,5,1,1,0,1
31719_0,,,,2,2,1,3
[C](C(O)=O)(C(C(CCO)O)O)O,,,5,1,2,0,2
31721_0,,,,2,2,1,3
[C](C(O)=O)(C(C(O)O)O)O,,,5,1,1,0,1
31722_0,,,,2,2,1,3
31724_0,,,,2,2,1,3
[C](C(O)=O)(C(C)O)O,,,5,1,2,0,2
31726_0,,,,2,2,1,3
C([C](C(O)=O)O)(O)=O,,,5,1,1,0,1
31728_0,,,,2,2,1,3
[C](C(O)=O)(C(CC(C)O)O)O,,,5,1,2,0,2
31730_0,,,,2,2,1,3
C(CC([C](C(O)=O)O)O)(O)=O,,,5,1,2,0,2
31731_0,,,,2,2,1,3
31732_0,,,,2,2,1,3
31733_0,,,,2,2,1,3
31734_0,,,,2,2,1,3
31735_0,,,,2,2,1,3
31736_0,,,,2,2,1,3
31738_0,,,,2,2,1,3
[C](C(O)=O)(C(C(CO)C(C)O)O)O,,,5,1,1,0,1
31740_0,,,,2,2,1,3
C(C(CO)C([C](C(O)=O)O)O)(O)=O,,,5,1,1,0,1
31741_0,,,,2,2,1,3
31742_0,,,,2,2,1,3
31744_0,,,,2,2,1,3
C(C(C)(CC([C](C(O)=O)O)O)O)=O,,,5,1,1,0,1
31746_0,,,,2,2,1,3
C(CC(C)(C([C](C(O)=O)O)O)O)=O,,,5,1,1,0,1
31748_0,,,,2,2,1,3
C(C)(C(CC([C](C(O)=O)O)O)O)=O,,,5,1,1,0,1
31750_0,,,,2,2,1,3
C(CC(C([C](C(O)=O)O)(C)O)O)=O,,,5,1,1,0,1
31751_0,,,,2,2,1,3
31752_0,,,,2,2,1,3
31753_0,,,,2,2,1,3
31754_0,,,,2,2,1,3
31755_0,,,,2,2,1,3
31756_0,,,,2,2,1,3
31758_0,,,,2,2,1,3
[C](C(O)=O)(C(CCO)O)O,,,5,1,1,0,1
31759_0,,,,2,2,1,3
31760_0,,,,2,2,1,3
31761_0,,,,2,2,1,3
31763_0,,,,2,2,1,3
C([C](C(CC(C(C)=O)=O)O)O)(O)=O,,,5,1,1,0,1
31764_0,,,,2,2,1,3
31766_0,,,,2,2,1,3
C(C(C)O)(C([C](C(O)=O)O)(C)O)=O,,,5,1,1,0,1
31767_0,,,,2,2,1,3
31768_0,,,,2,2,1,3
31769_0,,,,2,2,1,3
31770_0,,,,2,2,1,3
31772_0,,,,2,2,1,3
C(C(C([C](C(O)=O)O)O)O)(O)=O,,,5,1,2,0,2
31774_0,,,,2,2,1,3
[C](C(O)=O)(C(CO)(CO)O)O,,,5,1,2,0,2
31776_0,,,,2,2,1,3
[C](C(O)=O)(C(CO)(C)O)O,,,5,1,1,0,1
31777_0,,,,2,2,1,3
31779_0,,,,2,2,1,3
C(C(C)C([C](C(O)=O)O)(C)O)(O)=O,,,5,1,1,0,1
31781_0,,,,2,2,1,3
C(C([C](C(O)=O)O)O)=CC,,,5,1,1,0,1
31783_0,,,,2,2,1,3
C=CCC([C](C(O)=O)O)O,,,5,1,1,0,1
31784_0,,,,2,2,1,3
31785_0,,,,2,2,1,3
31787_0,,,,2,2,1,3
C=C(C(O)=O)CC([C](C(O)=O)O)O,,,5,1,1,0,1
31789_0,,,,2,2,1,3
C(C([C](C(O)=O)O)O)=C(C(O)=O)C,,,5,1,1,0,1
31791_0,,,,2,2,1,3
[C](C(O)=O)(C(C(CO)O)O)O,,,5,1,2,0,2
31792_0,,,,2,2,1,3
31793_0,,,,2,2,1,3
31794_0,,,,2,2,1,3
31796_0,,,,2,2,1,3
[CH](C(O)=O)CCC([C](C(O)=O)O)O,,,5,1,1,0,1
31798_0,,,,2,2,1,3
C(CCCC([C](C(O)=O)O)O)(O)=O,,,5,1,1,0,1
31799_0,,,,2,2,1,3
31800_0,,,,2,2,1,3
31801_0,,,,2,2,1,3
31803_0,,,,2,2,1,3
C(C(C=O)C(C(C=O)=O)(CO)O)=O,,,5,1,1,0,1
31805_0,,,,2,2,1,3
C(C(C=O)CC(C(C=O)(O)O)O)=O,,,5,1,1,0,1
31807_0,,,,2,2,1,3
C(C(C=O)CC(C(C(O)=O)O)O)=O,,,5,1,1,0,1
31809_0,,,,2,2,1,3
C(C(C=O)CC(C(C=O)(C)O)O)=O,,,5,1,1,0,1
31811_0,,,,2,2,1,3
C(C(C(C(C=O)(O)O)O)CC=O)=O,,,5,1,1,0,1
31813_0,,,,2,2,1,3
C(C(C(C(C=O)CC=O)O)O)(O)=O,,,5,1,1,0,1
31815_0,,,,2,2,1,3
C(C(C)(C(C(C=O)CC=O)O)O)=O,,,5,1,1,0,1
31817_0,,,,2,2,1,3
C(C)(C(C)(C(CC(C=O)=O)O)O)=O,,,5,1,1,0,1
31819_0,,,,2,2,1,3
C(C(C(CC(C=O)=O)O)(CC)O)=O,,,5,1,1,0,1
31821_0,,,,2,2,1,3
C(C(C(CC(C=O)=O)O)(O)O)=O,,,5,1,1,0,1
31822_0,,,,2,2,1,3
31823_0,,,,2,2,1,3
31824_0,,,,2,2,1,3
31826_0,,,,2,2,1,3
C(C)(C(C)(C(C(CC=O)=O)O)O)=O,,,5,1,1,0,1
31828_0,,,,2,2,1,3
C(C(CC)(C(C(CC=O)=O)O)O)=O,,,5,1,1,0,1
31830_0,,,,2,2,1,3
C(CC(C(C(C=O)(O)O)O)=O)=O,,,5,1,1,0,1
31832_0,,,,2,2,1,3
C(C(C)(C(C(CC=O)=O)O)O)(O)=O,,,5,1,1,0,1
31833_0,,,,2,2,1,3
31835_0,,,,2,2,1,3
C(C(C)(C(C(CC=O)=O)O)O)=O,,,5,1,2,0,2
31836_0,,,,2,2,1,3
31838_0,,,,2,2,1,3
C(CC(C=O)(C(C=O)(CC)O)O)=O,,,5,1,1,0,1
31840_0,,,,2,2,1,3
C(CC(C=O)(C(C=O)(O)O)O)=O,,,5,1,1,0,1
31841_0,,,,2,2,1,3
31842_0,,,,2,2,1,3
31843_0,,,,2,2,1,3
31845_0,,,,2,2,1,3
C(C(C(C)(CC(C=O)=O)O)(O)O)=O,,,5,1,1,0,1
31846_0,,,,2,2,1,3
31848_0,,,,2,2,1,3
C(C(C)(C(C)(CC(C=O)=O)O)O)=O,,,5,1,1,0,1
31850_0,,,,2,2,1,3
C(C(C(C(CC(C)=O)=O)O)(O)O)=O,,,5,1,1,0,1
31852_0,,,,2,2,1,3
C(C(C(C(CC(C)=O)=O)O)O)(O)=O,,,5,1,1,0,1
31854_0,,,,2,2,1,3
C(C(C)(C(C(CC(C)=O)=O)O)O)=O,,,5,1,1,0,1
31856_0,,,,2,2,1,3
C(C(C(C=O)(CC(C)=O)O)(O)O)=O,,,5,1,1,0,1
31858_0,,,,2,2,1,3
C(C(C(C=O)(CC(C)=O)O)O)(O)=O,,,5,1,1,0,1
31860_0,,,,2,2,1,3
C(CC(C=O)(C(C=O)(C)O)O)(C)=O,,,5,1,1,0,1
31862_0,,,,2,2,1,3
C(C(C(C(C=O)=O)(CC)O)(O)O)=O,,,5,1,1,0,1
31864_0,,,,2,2,1,3
C(C(C(C(C=O)=O)(CC)O)O)(O)=O,,,5,1,1,0,1
31866_0,,,,2,2,1,3
C(C(C)(C(C(C=O)=O)(CC)O)O)=O,,,5,1,1,0,1
31868_0,,,,2,2,1,3
C(C(C(C(C(CC)=O)=O)O)(O)O)=O,,,5,1,1,0,1
31870_0,,,,2,2,1,3
C(C(C(C(C(CC)=O)=O)O)O)(O)=O,,,5,1,1,0,1
31872_0,,,,2,2,1,3
C(C(C)(C(C(C(CC)=O)=O)O)O)=O,,,5,1,1,0,1
31874_0,,,,2,2,1,3
C(CC)(C(C=O)(C(C=O)(O)O)O)=O,,,5,1,1,0,1
31876_0,,,,2,2,1,3
C(CC)(C(C=O)(C(C(O)=O)O)O)=O,,,5,1,1,0,1
31878_0,,,,2,2,1,3
C(CC)(C(C=O)(C(C=O)(C)O)O)=O,,,5,1,1,0,1
31880_0,,,,2,2,1,3
C(C(CC=O)(C(C=O)(O)O)O)(O)=O,,,5,1,1,0,1
31881_0,,,,2,2,1,3
31882_0,,,,2,2,1,3
31884_0,,,,2,2,1,3
C(C(C(CC(C(O)=O)=O)O)(O)O)=O,,,5,1,1,0,1
31885_0,,,,2,2,1,3
31886_0,,,,2,2,1,3
31887_0,,,,2,2,1,3
31889_0,,,,2,2,1,3
C(C(C(O)=O)(C(C=O)C=O)O)(O)=O,,,5,1,1,0,1
31890_0,,,,2,2,1,3
31892_0,,,,2,2,1,3
C(C(C)C(C(C(C)=O)(C)O)O)(O)=O,,,5,1,1,0,1
31894_0,,,,2,2,1,3
C(C(C)C(C(C=O)(CC)O)O)(O)=O,,,5,1,1,0,1
31896_0,,,,2,2,1,3
C(C(C)C(C(C=O)(O)O)O)(O)=O,,,5,1,1,0,1
31898_0,,,,2,2,1,3
C(C(C)C(C(C(O)=O)(C)O)O)(O)=O,,,5,1,1,0,1
31899_0,,,,2,2,1,3
31901_0,,,,2,2,1,3
C(C(C)C(C(C=O)(C)O)O)(O)=O,,,5,1,1,0,1
31903_0,,,,2,2,1,3
C(C(CC)(C(C(C)=O)(C)O)O)(O)=O,,,5,1,1,0,1
31905_0,,,,2,2,1,3
C(C(CC)(C(C=O)(CC)O)O)(O)=O,,,5,1,1,0,1
31907_0,,,,2,2,1,3
C(C(CC)(C(C=O)(O)O)O)(O)=O,,,5,1,1,0,1
31909_0,,,,2,2,1,3
C(C(CC)(C(C(O)=O)(C)O)O)(O)=O,,,5,1,1,0,1
31911_0,,,,2,2,1,3
C(C(CC)(C(C(O)=O)O)O)(O)=O,,,5,1,1,0,1
31913_0,,,,2,2,1,3
C(C(CC)(C(C=O)(C)O)O)(O)=O,,,5,1,1,0,1
31915_0,,,,2,2,1,3
C(C)(C(C)(C(C)(C(C)O)O)O)=O,,,5,1,1,0,1
31917_0,,,,2,2,1,3
C(C)(C(C)(C(CO)(CC)O)O)=O,,,5,1,1,0,1
31919_0,,,,2,2,1,3
C(CC(C(C(C)=O)(C)O)O)=O,,,5,1,1,0,1
31921_0,,,,2,2,1,3
C(C)(C(C)(C([CH]C(O)=O)O)O)=O,,,5,1,1,0,1
31923_0,,,,2,2,1,3
C(C)(C(C)(C(C(C(C)O)=C)O)O)=O,,,5,1,1,0,1
31925_0,,,,2,2,1,3
C(C)(C(C)(C(C(CO)=CC)O)O)=O,,,5,1,1,0,1
31927_0,,,,2,2,1,3
C(C)(C(C)(C(C=C(C=O)C)O)O)=O,,,5,1,1,0,1
31929_0,,,,2,2,1,3
C(C)(C(C)(C(C(C)=CC=O)O)O)=O,,,5,1,1,0,1
31931_0,,,,2,2,1,3
C(C)(C(C)(C(CC(C=O)=C)O)O)=O,,,5,1,1,0,1
31933_0,,,,2,2,1,3
C(C)(C(C)(C(C(CC=O)=C)O)O)=O,,,5,1,1,0,1
31935_0,,,,2,2,1,3
C(C)(C(C)(C(C=CC(C)=O)O)O)=O,,,5,1,1,0,1
31937_0,,,,2,2,1,3
C(C)(C(C)(C(C=CC=O)(C)O)O)=O,,,5,1,1,0,1
31939_0,,,,2,2,1,3
C(C(C=C)(C(C(C)=O)(C)O)O)=O,,,5,1,1,0,1
31941_0,,,,2,2,1,3
C(C)(C(C)(C(C(C=C)=O)O)O)=O,,,5,1,1,0,1
31943_0,,,,2,2,1,3
C(C)(C(C)(C(C=O)(CC=C)O)O)=O,,,5,1,1,0,1
31945_0,,,,2,2,1,3
C(C)(C(C)(C(C(CC=C)=O)O)O)=O,,,5,1,1,0,1
31947_0,,,,2,2,1,3
C(C(C=CC)(C(C(C)=O)(C)O)O)=O,,,5,1,1,0,1
31949_0,,,,2,2,1,3
C(C)(C(C)(C(C(C=CC)=O)O)O)=O,,,5,1,1,0,1
31951_0,,,,2,2,1,3
C(C)(C(C)(C(C=C)O)O)=O,,,5,1,1,0,1
31952_0,,,,2,2,1,3
31954_0,,,,2,2,1,3
C(C)(C(C)(C(C(CC)O)O)O)=O,,,5,1,1,0,1
31956_0,,,,2,2,1,3
C(C)(C(C)(C(CCCO)O)O)=O,,,5,1,1,0,1
31958_0,,,,2,2,1,3
C(C)(C(C)(C1(C(O)OCC1)O)O)=O,,,5,1,1,0,1
31960_0,,,,2,2,1,3
C1(C(CCO1)(C(C(C)=O)(C)O)O)=O,,,5,1,1,0,1
31962_0,,,,2,2,1,3
C(C)(C(C)(C(CC(CO)C)O)O)=O,,,5,1,1,0,1
31964_0,,,,2,2,1,3
C(C)(C(C)(C(C(CCO)O)O)O)=O,,,5,1,1,0,1
31966_0,,,,2,2,1,3
C(C)(C(C)(C(C(O)O)O)O)=O,,,5,1,1,0,1
31968_0,,,,2,2,1,3
C(C)(C(C)(C(C)O)O)=O,,,5,1,1,0,1
31969_0,,,,2,2,1,3
31971_0,,,,2,2,1,3
C(C)(C(C)(C(CC(C)O)O)O)=O,,,5,1,1,0,1
31973_0,,,,2,2,1,3
C(CC(C(C(C)=O)(C)O)O)(O)=O,,,5,1,1,0,1
31974_0,,,,2,2,1,3
31975_0,,,,2,2,1,3
31976_0,,,,2,2,1,3
31977_0,,,,2,2,1,3
31978_0,,,,2,2,1,3
31979_0,,,,2,2,1,3
31980_0,,,,2,2,1,3
31981_0,,,,2,2,1,3
31983_0,,,,2,2,1,3
C(C)(C(C)(C(CCO)O)O)=O,,,5,1,1,0,1
31984_0,,,,2,2,1,3
31986_0,,,,2,2,1,3
C(C(C(C(C(C)=O)(C)O)O)O)=O,,,5,1,1,0,1
31988_0,,,,2,2,1,3
C(C(C(C(C(C)=O)(C)O)O)O)(O)=O,,,5,1,1,0,1
31990_0,,,,2,2,1,3
C(C)(C(C)(C(CO)(CO)O)O)=O,,,5,1,1,0,1
31992_0,,,,2,2,1,3
C(C)(C(C)(C(CO)(C)O)O)=O,,,5,1,1,0,1
31994_0,,,,2,2,1,3
C(C)(C(C)(C(C=CC)O)O)=O,,,5,1,1,0,1
31996_0,,,,2,2,1,3
C(C)(C(C)(C(CC=C)O)O)=O,,,5,1,1,0,1
31998_0,,,,2,2,1,3
C(C)(C(C)(C(C(CO)O)O)O)=O,,,5,1,1,0,1
32000_0,,,,2,2,1,3
C(C)(C(C)(C(CO)O)O)=O,,,5,1,1,0,1
32002_0,,,,2,2,1,3
C(C)(C(C)(C(C(C)O)O)O)=O,,,5,1,1,0,1
32003_0,,,,2,2,1,3
32004_0,,,,2,2,1,3
32006_0,,,,2,2,1,3
C(C(CC)(C(C)(C(C)O)O)O)=O,,,5,1,1,0,1
32008_0,,,,2,2,1,3
C1(C(C(C)(C(C)O)O)(O)OCC1)=O,,,5,1,1,0,1
32010_0,,,,2,2,1,3
C(C(CCO)(C(C)(C(C)O)O)O)=O,,,5,1,1,0,1
32012_0,,,,2,2,1,3
C(C(C(C)(C(C)O)O)(O)O)=O,,,5,1,1,0,1
32013_0,,,,2,2,1,3
32015_0,,,,2,2,1,3
C(C(C(C)(C(C)O)O)O)(O)=O,,,5,1,1,0,1
32017_0,,,,2,2,1,3
C(C(C)(C(C)(C(C)O)O)O)=O,,,5,1,1,0,1
32019_0,,,,2,2,1,3
C(C(CC)(C(CO)(CC)O)O)=O,,,5,1,1,0,1
32021_0,,,,2,2,1,3
C1(C(C(CO)(CC)O)(O)OCC1)=O,,,5,1,1,0,1
32023_0,,,,2,2,1,3
C(C(CCO)(C(CO)(CC)O)O)=O,,,5,1,1,0,1
32025_0,,,,2,2,1,3
C(C(C(CO)(CC)O)(O)O)=O,,,5,1,1,0,1
32027_0,,,,2,2,1,3
C(C(C)(C(CO)(CC)O)O)(O)=O,,,5,1,1,0,1
32029_0,,,,2,2,1,3
C(C(C(CO)(CC)O)O)(O)=O,,,5,1,1,0,1
32031_0,,,,2,2,1,3
C(C(C)(C(CO)(CC)O)O)=O,,,5,1,1,0,1
32033_0,,,,2,2,1,3
C(C(CC(C)=O)(C(C=C)O)O)(O)=O,,,5,1,1,0,1
32035_0,,,,2,2,1,3
C(C(C(C)O)(CC(C)=O)O)(O)=O,,,5,1,2,0,2
32036_0,,,,2,2,1,3
32038_0,,,,2,2,1,3
C(C(CO)(CC(C)=O)O)(O)=O,,,5,1,2,0,2
32039_0,,,,2,2,1,3
32041_0,,,,2,2,1,3
C(C(C(CO)O)(CC(C)=O)O)(O)=O,,,5,1,1,0,1
32043_0,,,,2,2,1,3
C(CC(C(C=C)(C(C=O)=O)O)O)=O,,,5,1,1,0,1
32045_0,,,,2,2,1,3
C(CC(C(C(O)=O)(C=CC)O)O)=O,,,5,1,1,0,1
32047_0,,,,2,2,1,3
C(C(C(CC=O)O)(CC=C)O)(O)=O,,,5,1,1,0,1
32049_0,,,,2,2,1,3
C(C(C(CC=O)O)(CC)O)=O,,,5,1,1,0,1
32051_0,,,,2,2,1,3
C(CC(C1(C(C(CO1)O)=O)O)O)=O,,,5,1,1,0,1
32053_0,,,,2,2,1,3
C(CC(C1(C(CCO1)=O)O)O)=O,,,5,1,1,0,1
32055_0,,,,2,2,1,3
C(CC(C1(C(CC(C)O1)=O)O)O)=O,,,5,1,1,0,1
32057_0,,,,2,2,1,3
C(CC(C1(C(CC(O1)=O)=O)O)O)=O,,,5,1,1,0,1
32059_0,,,,2,2,1,3
C1(C(C(CC=O)O)(CC(C)O1)O)=O,,,5,1,1,0,1
32061_0,,,,2,2,1,3
C1(C(C(CC=O)O)(CC(O1)=O)O)=O,,,5,1,1,0,1
32063_0,,,,2,2,1,3
C(C(C(CC=O)O)(CCO)O)=O,,,5,1,1,0,1
32065_0,,,,2,2,1,3
C(CC(C(C=O)(O)O)O)=O,,,5,1,1,0,1
32066_0,,,,2,2,1,3
32067_0,,,,2,2,1,3
32068_0,,,,2,2,1,3
32070_0,,,,2,2,1,3
C(C)(C(C(CC=O)O)(CC=O)O)=O,,,5,1,1,0,1
32071_0,,,,2,2,1,3
32072_0,,,,2,2,1,3
32074_0,,,,2,2,1,3
C(C(CC)(C([CH]C(O)=O)O)O)=O,,,5,1,1,0,1
32076_0,,,,2,2,1,3
C1(C(C([CH]C(O)=O)O)(O)OCC1)=O,,,5,1,1,0,1
32078_0,,,,2,2,1,3
C(C(CCO)(C([CH]C(O)=O)O)O)=O,,,5,1,1,0,1
32080_0,,,,2,2,1,3
C(C(C([CH]C(O)=O)O)(O)O)=O,,,5,1,1,0,1
32081_0,,,,2,2,1,3
32083_0,,,,2,2,1,3
C(C(C([CH]C(O)=O)O)O)(O)=O,,,5,1,2,0,2
32085_0,,,,2,2,1,3
C(C(C)(C([CH]C(O)=O)O)O)=O,,,5,1,1,0,1
32087_0,,,,2,2,1,3
C(C(C(C=O)=O)(CO)O)=CC(C)O,,,5,1,1,0,1
32089_0,,,,2,2,1,3
C(C(C(C=CCC(C)O)O)(O)O)=O,,,5,1,1,0,1
32091_0,,,,2,2,1,3
C(C(C(C=CCC(C)O)O)O)(O)=O,,,5,1,1,0,1
32093_0,,,,2,2,1,3
C(C(C)(C(C=CCC(C)O)O)O)=O,,,5,1,1,0,1
32095_0,,,,2,2,1,3
C(C(C(CC=CC(C)O)O)(O)O)=O,,,5,1,1,0,1
32097_0,,,,2,2,1,3
C(C(C(CC=CC(C)O)O)O)(O)=O,,,5,1,1,0,1
32099_0,,,,2,2,1,3
C(C(C(CC=CC(C)O)O)(C)O)=O,,,5,1,1,0,1
32101_0,,,,2,2,1,3
C(CO)(C(C(C=O)=CC)(CO)O)=O,,,5,1,1,0,1
32103_0,,,,2,2,1,3
C(C)(C(C(C=O)=CC)(C(C=C)O)O)=O,,,5,1,1,0,1
32105_0,,,,2,2,1,3
C(C)(C(C(C=O)=CC)(C(C)O)O)=O,,,5,1,1,0,1
32107_0,,,,2,2,1,3
C(C(C(C)=O)(C(C=O)=CC)O)(O)=O,,,5,1,1,0,1
32109_0,,,,2,2,1,3
C(C)(C(C(C=O)=CC)(CO)O)=O,,,5,1,2,0,2
32111_0,,,,2,2,1,3
C(C(CC)(C(C(C(C)O)=C)O)O)=O,,,5,1,1,0,1
32113_0,,,,2,2,1,3
C(C(C(C(C(C)O)=C)O)(O)O)=O,,,5,1,1,0,1
32115_0,,,,2,2,1,3
C(C(C)(C(C(C(C)O)=C)O)O)(O)=O,,,5,1,1,0,1
32117_0,,,,2,2,1,3
C(C(C(C(C(C)O)=C)O)O)(O)=O,,,5,1,2,0,2
32119_0,,,,2,2,1,3
C(C(C)(C(C(C(C)O)=C)O)O)=O,,,5,1,2,0,2
32121_0,,,,2,2,1,3
C(C(CC)(C(C(CO)=CC)O)O)=O,,,5,1,1,0,1
32123_0,,,,2,2,1,3
C(C(C(C(CO)=CC)O)(O)O)=O,,,5,1,1,0,1
32125_0,,,,2,2,1,3
C(C(C)(C(C(CO)=CC)O)O)(O)=O,,,5,1,1,0,1
32127_0,,,,2,2,1,3
C(C(C(C(CO)=CC)O)O)(O)=O,,,5,1,2,0,2
32129_0,,,,2,2,1,3
C(C(C)(C(C(CO)=CC)O)O)=O,,,5,1,2,0,2
32131_0,,,,2,2,1,3
C(C(C(C(C(C)O)=CC)O)(O)O)=O,,,5,1,1,0,1
32133_0,,,,2,2,1,3
C(C(C(C(C(C)O)=CC)O)O)(O)=O,,,5,1,1,0,1
32135_0,,,,2,2,1,3
C(C(C)(C(C(C(C)O)=CC)O)O)=O,,,5,1,1,0,1
32137_0,,,,2,2,1,3
C(C(C(C(C(O)=O)=CC)O)(O)O)=O,,,5,1,1,0,1
32139_0,,,,2,2,1,3
C(C(C(C(C(O)=O)=CC)O)O)(O)=O,,,5,1,1,0,1
32141_0,,,,2,2,1,3
C(C(C)(C(C(C(O)=O)=CC)O)O)=O,,,5,1,1,0,1
32143_0,,,,2,2,1,3
C(C(C(C=O)=O)(CO)O)=CC(O)=O,,,5,1,1,0,1
32145_0,,,,2,2,1,3
C(CC=CC(C(C=O)(O)O)O)(O)=O,,,5,1,1,0,1
32147_0,,,,2,2,1,3
C(CC=CC(C(C(O)=O)O)O)(O)=O,,,5,1,1,0,1
32149_0,,,,2,2,1,3
C(C(C)(C(C=CCC(O)=O)O)O)=O,,,5,1,1,0,1
32151_0,,,,2,2,1,3
C(C(C(CC=CC(O)=O)O)(O)O)=O,,,5,1,1,0,1
32153_0,,,,2,2,1,3
C(C(C(CC=CC(O)=O)O)O)(O)=O,,,5,1,1,0,1
32155_0,,,,2,2,1,3
C(C(C)(C(CC=CC(O)=O)O)O)=O,,,5,1,1,0,1
32157_0,,,,2,2,1,3
C(C(C(C=CC(CO)=O)O)(O)O)=O,,,5,1,1,0,1
32159_0,,,,2,2,1,3
C(C(C(C=CC(CO)=O)O)O)(O)=O,,,5,1,1,0,1
32161_0,,,,2,2,1,3
C(C(C)(C(C=CC(CO)=O)O)O)=O,,,5,1,1,0,1
32163_0,,,,2,2,1,3
C(C(C(C=CC=O)(CO)O)(O)O)=O,,,5,1,1,0,1
32165_0,,,,2,2,1,3
C(C(C(C=CC=O)(CO)O)O)(O)=O,,,5,1,1,0,1
32167_0,,,,2,2,1,3
C(C(C)(C(C=CC=O)(CO)O)O)=O,,,5,1,1,0,1
32169_0,,,,2,2,1,3
C(C(C(C=C(C=O)CO)O)(O)O)=O,,,5,1,1,0,1
32171_0,,,,2,2,1,3
C(C(C(C=C(C=O)CO)O)O)(O)=O,,,5,1,1,0,1
32173_0,,,,2,2,1,3
C(C(C)(C(C=C(C=O)CO)O)O)=O,,,5,1,1,0,1
32175_0,,,,2,2,1,3
C(C(C(C(CO)=CC=O)O)(O)O)=O,,,5,1,1,0,1
32177_0,,,,2,2,1,3
C(C(C(C(CO)=CC=O)O)O)(O)=O,,,5,1,1,0,1
32179_0,,,,2,2,1,3
C(C(C)(C(C(CO)=CC=O)O)O)=O,,,5,1,1,0,1
32181_0,,,,2,2,1,3
C=CC(C(C(C=O)=O)(C(C=O)=C)O)O,,,5,1,1,0,1
32183_0,,,,2,2,1,3
C=C(C=O)C(C(C=O)=O)(C(C)O)O,,,5,1,1,0,1
32185_0,,,,2,2,1,3
C(C(C(C=O)=O)(C(C=O)=C)O)(O)=O,,,5,1,1,0,1
32187_0,,,,2,2,1,3
C=C(C=O)C(C(C=O)=O)(CO)O,,,5,1,2,0,2
32189_0,,,,2,2,1,3
C(C(C=C)(C(C=C)(C(C=O)=O)O)O)=O,,,5,1,1,0,1
32191_0,,,,2,2,1,3
C=CC(C(C=O)=O)(C(C(C=C)=O)O)O,,,5,1,1,0,1
32193_0,,,,2,2,1,3
C=CC(C(C=O)=O)(C(C=C)O)O,,,5,1,1,0,1
32195_0,,,,2,2,1,3
C=CC(C(C=O)=O)(C(C(O)O)O)O,,,5,1,1,0,1
32197_0,,,,2,2,1,3
C=CC(C(C=O)=O)(C(C)O)O,,,5,1,2,0,2
32199_0,,,,2,2,1,3
C(C(C=C)(C(C=O)=O)O)(O)=O,,,5,1,2,0,2
32201_0,,,,2,2,1,3
C(C(C)(C(C=C)(C(C=O)=O)O)O)=O,,,5,1,1,0,1
32203_0,,,,2,2,1,3
C(C)(C(C(C=C)(C(C=O)=O)O)O)=O,,,5,1,1,0,1
32205_0,,,,2,2,1,3
C=CC(C(C=O)=O)(CO)O,,,5,1,2,0,2
32207_0,,,,2,2,1,3
C=CC(C(C=O)=O)(C(CCO)O)O,,,5,1,1,0,1
32209_0,,,,2,2,1,3
C(C(C(C=C)(C(C=O)=O)O)O)=O,,,5,1,2,0,2
32211_0,,,,2,2,1,3
C=CC(C(C=O)=O)(C(CO)(C)O)O,,,5,1,1,0,1
32213_0,,,,2,2,1,3
C=CC(C(C=O)=O)(C(C=CC)O)O,,,5,1,1,0,1
32215_0,,,,2,2,1,3
C=CC(C(C=O)=O)(C(CC=C)O)O,,,5,1,1,0,1
32217_0,,,,2,2,1,3
C=CC(C(C=O)=O)(C(CO)O)O,,,5,1,2,0,2
32219_0,,,,2,2,1,3
C=CC(C(C=O)=O)(C(C(C)O)O)O,,,5,1,1,0,1
32221_0,,,,2,2,1,3
C(C(C(C=C)(C(C=O)=O)O)O)(O)=O,,,5,1,1,0,1
32223_0,,,,2,2,1,3
C(C(C(C(C(C=C)O)=O)O)(O)O)=O,,,5,1,1,0,1
32225_0,,,,2,2,1,3
C(C(C(C(C(C=C)O)=O)O)O)(O)=O,,,5,1,1,0,1
32227_0,,,,2,2,1,3
C(C(C)(C(C(C(C=C)O)=O)O)O)=O,,,5,1,1,0,1
32229_0,,,,2,2,1,3
C(C(C(C=O)(C(C=C)O)O)(O)O)=O,,,5,1,1,0,1
32230_0,,,,2,2,1,3
32231_0,,,,2,2,1,3
32233_0,,,,2,2,1,3
C=C(C=O)C(C(C(O)=O)=O)(CO)O,,,5,1,1,0,1
32235_0,,,,2,2,1,3
C(C(CC)(C(C=C(C=O)C)O)O)=O,,,5,1,1,0,1
32237_0,,,,2,2,1,3
C(C(C(C=C(C=O)C)O)(O)O)=O,,,5,1,1,0,1
32239_0,,,,2,2,1,3
C(C(C)(C(C=C(C=O)C)O)O)(O)=O,,,5,1,1,0,1
32241_0,,,,2,2,1,3
C(C(C(C=C(C=O)C)O)O)(O)=O,,,5,1,2,0,2
32243_0,,,,2,2,1,3
C(C(C)(C(C=C(C=O)C)O)O)=O,,,5,1,2,0,2
32245_0,,,,2,2,1,3
C(C(CC)(C(C(C)=CC=O)O)O)=O,,,5,1,1,0,1
32247_0,,,,2,2,1,3
C(C(C(C(C)=CC=O)O)(O)O)=O,,,5,1,1,0,1
32249_0,,,,2,2,1,3
C(C(C)(C(C(C)=CC=O)O)O)(O)=O,,,5,1,1,0,1
32251_0,,,,2,2,1,3
C(C(C(C(C)=CC=O)O)O)(O)=O,,,5,1,2,0,2
32253_0,,,,2,2,1,3
C(C(C)(C(C(C)=CC=O)O)O)=O,,,5,1,2,0,2
32255_0,,,,2,2,1,3
C(C(C(CC(C=O)=C)O)(CC)O)=O,,,5,1,1,0,1
32257_0,,,,2,2,1,3
C(C(C(CC(C=O)=C)O)(O)O)=O,,,5,1,1,0,1
32259_0,,,,2,2,1,3
C(C(C)(C(CC(C=O)=C)O)O)(O)=O,,,5,1,1,0,1
32261_0,,,,2,2,1,3
C(C(C(CC(C=O)=C)O)O)(O)=O,,,5,1,2,0,2
32263_0,,,,2,2,1,3
C(C(C)(C(CC(C=O)=C)O)O)=O,,,5,1,2,0,2
32265_0,,,,2,2,1,3
C(C(CC)(C(C(CC=O)=C)O)O)=O,,,5,1,1,0,1
32267_0,,,,2,2,1,3
C(CC(C(C(C=O)(O)O)O)=C)=O,,,5,1,1,0,1
32269_0,,,,2,2,1,3
C(C(C)(C(C(CC=O)=C)O)O)(O)=O,,,5,1,1,0,1
32271_0,,,,2,2,1,3
C(CC(C(C(C(O)=O)O)O)=C)=O,,,5,1,2,0,2
32273_0,,,,2,2,1,3
C(C(C)(C(C(CC=O)=C)O)O)=O,,,5,1,2,0,2
32275_0,,,,2,2,1,3
C(C(CC)(C(C=CC(C)=O)O)O)=O,,,5,1,1,0,1
32277_0,,,,2,2,1,3
C(C(C(C=CC(C)=O)O)(O)O)=O,,,5,1,1,0,1
32279_0,,,,2,2,1,3
C(C(C)(C(C=CC(C)=O)O)O)(O)=O,,,5,1,1,0,1
32281_0,,,,2,2,1,3
C(C(C(C=CC(C)=O)O)O)(O)=O,,,5,1,2,0,2
32283_0,,,,2,2,1,3
C(C(C)(C(C=CC(C)=O)O)O)=O,,,5,1,2,0,2
32285_0,,,,2,2,1,3
C(C(CC)(C(C=CC=O)(C)O)O)=O,,,5,1,1,0,1
32287_0,,,,2,2,1,3
C(C(C(C=CC=O)(C)O)(O)O)=O,,,5,1,1,0,1
32289_0,,,,2,2,1,3
C(C(C)(C(C=CC=O)(C)O)O)(O)=O,,,5,1,1,0,1
32291_0,,,,2,2,1,3
C(C(C(C=CC=O)(C)O)O)(O)=O,,,5,1,3,0,3
32293_0,,,,2,2,1,3
C(C(C)(C(C=CC=O)(C)O)O)=O,,,5,1,2,0,2
32295_0,,,,2,2,1,3
C(C(C=C)(C(C=O)(CC)O)O)=O,,,5,1,1,0,1
32297_0,,,,2,2,1,3
C(C(C=C)(C1(C(CCO1)=O)O)O)=O,,,5,1,1,0,1
32299_0,,,,2,2,1,3
C(C(C=C)(C(C=O)(CCO)O)O)=O,,,5,1,1,0,1
32301_0,,,,2,2,1,3
C(C(C=C)(C(C=O)(O)O)O)=O,,,5,1,1,0,1
32303_0,,,,2,2,1,3
C(C(C=C)(C(C(O)=O)(C)O)O)=O,,,5,1,2,0,2
32305_0,,,,2,2,1,3
C(C(C=C)(C(C(O)=O)O)O)=O,,,5,1,2,0,2
32307_0,,,,2,2,1,3
C(C(C=C)(C(C=O)(C)O)O)=O,,,5,1,2,0,2
32309_0,,,,2,2,1,3
C(C(CC)(C(C(C=C)=O)O)O)=O,,,5,1,1,0,1
32311_0,,,,2,2,1,3
C1(C(C(C(C=C)=O)O)(O)OCC1)=O,,,5,1,1,0,1
32313_0,,,,2,2,1,3
C(C(CCO)(C(C(C=C)=O)O)O)=O,,,5,1,1,0,1
32315_0,,,,2,2,1,3
C(C(C(C(C=C)=O)O)(O)O)=O,,,5,1,1,0,1
32317_0,,,,2,2,1,3
C(C(C)(C(C(C=C)=O)O)O)(O)=O,,,5,1,2,0,2
32319_0,,,,2,2,1,3
C(C(C(C(C=C)=O)O)O)(O)=O,,,5,1,2,0,2
32321_0,,,,2,2,1,3
C(C(C)(C(C(C=C)=O)O)O)=O,,,5,1,2,0,2
32323_0,,,,2,2,1,3
C(C(CC)(C(C=O)(CC=C)O)O)=O,,,5,1,1,0,1
32325_0,,,,2,2,1,3
C(C(C(C=O)(CC=C)O)(O)O)=O,,,5,1,1,0,1
32327_0,,,,2,2,1,3
C(C(C)(C(C=O)(CC=C)O)O)(O)=O,,,5,1,1,0,1
32329_0,,,,2,2,1,3
C(C(C(C=O)(CC=C)O)O)(O)=O,,,5,1,2,0,2
32331_0,,,,2,2,1,3
C(C(C)(C(C=O)(CC=C)O)O)=O,,,5,1,2,0,2
32333_0,,,,2,2,1,3
C(C(CC)(C(C(CC=C)=O)O)O)=O,,,5,1,1,0,1
32335_0,,,,2,2,1,3
C(C(C(C(CC=C)=O)O)(O)O)=O,,,5,1,1,0,1
32337_0,,,,2,2,1,3
C(C(C)(C(C(CC=C)=O)O)O)(O)=O,,,5,1,1,0,1
32339_0,,,,2,2,1,3
C(C(C(C(CC=C)=O)O)O)(O)=O,,,5,1,2,0,2
32341_0,,,,2,2,1,3
C(C(C)(C(C(CC=C)=O)O)O)=O,,,5,1,2,0,2
32343_0,,,,2,2,1,3
C(C(CC)(C(C=O)(C=CC)O)O)=O,,,5,1,1,0,1
32345_0,,,,2,2,1,3
C(C(C=CC)(C(C=O)(O)O)O)=O,,,5,1,1,0,1
32347_0,,,,2,2,1,3
C(C(C)(C(C=O)(C=CC)O)O)(O)=O,,,5,1,1,0,1
32349_0,,,,2,2,1,3
C(C(C=CC)(C(C(O)=O)O)O)=O,,,5,1,2,0,2
32351_0,,,,2,2,1,3
C(C(C)(C(C=O)(C=CC)O)O)=O,,,5,1,2,0,2
32353_0,,,,2,2,1,3
C(C(CC)(C(C(C=CC)=O)O)O)=O,,,5,1,1,0,1
32355_0,,,,2,2,1,3
C(C(C(C(C=CC)=O)O)(O)O)=O,,,5,1,1,0,1
32357_0,,,,2,2,1,3
C(C(C)(C(C(C=CC)=O)O)O)(O)=O,,,5,1,1,0,1
32359_0,,,,2,2,1,3
C(C(C(C(C=CC)=O)O)O)(O)=O,,,5,1,2,0,2
32361_0,,,,2,2,1,3
C(C(C)(C(C(C=CC)=O)O)O)=O,,,5,1,2,0,2
32363_0,,,,2,2,1,3
C=CC(C(C(O)=O)=O)(C(C=C)O)O,,,5,1,1,0,1
32365_0,,,,2,2,1,3
C(C(C(C=O)=C)(C(C=C)O)O)(O)=O,,,5,1,1,0,1
32367_0,,,,2,2,1,3
C(C1(C=C(C(O1)=O)C)C(C=C)O)(O)=O,,,5,1,1,0,1
32369_0,,,,2,2,1,3
C(C1(CC(C(O1)=O)=C)C(C=C)O)(O)=O,,,5,1,1,0,1
32371_0,,,,2,2,1,3
C1(C(C=C(C(O1)=O)C)(C(C=C)O)O)=O,,,5,1,1,0,1
32373_0,,,,2,2,1,3
C1(C(CC(C(O1)=O)=C)(C(C=C)O)O)=O,,,5,1,1,0,1
32375_0,,,,2,2,1,3
C(C(C=CC)(C(C=C)O)O)(O)=O,,,5,1,1,0,1
32377_0,,,,2,2,1,3
C(C(CC=C)(C(C=C)O)O)(O)=O,,,5,1,1,0,1
32379_0,,,,2,2,1,3
C(C(C)(C(C=C)O)O)(C(CO)O)=O,,,5,1,1,0,1
32381_0,,,,2,2,1,3
C(C(CC)(C(C=C)O)O)=O,,,5,1,1,0,1
32383_0,,,,2,2,1,3
C=CC(C(C(C(O)=O)=O)(CC)O)O,,,5,1,1,0,1
32385_0,,,,2,2,1,3
C(C(C)C(C=O)(C(C=C)O)O)(O)=O,,,5,1,1,0,1
32387_0,,,,2,2,1,3
C1(C(C(C=C)O)(O)OCC1O)=O,,,5,1,1,0,1
32389_0,,,,2,2,1,3
C1(C(C(C=C)O)(O)OC(C)C1O)=O,,,5,1,1,0,1
32391_0,,,,2,2,1,3
C1(C(C(C(C(C=C)O)(O)O1)=O)O)=O,,,5,1,1,0,1
32393_0,,,,2,2,1,3
C1(C(C(C=C)O)(O)OCC1)=O,,,5,1,1,0,1
32395_0,,,,2,2,1,3
C1(C(C(C=C)O)(O)OC(C)C1)=O,,,5,1,1,0,1
32397_0,,,,2,2,1,3
C1(CC(C(C(C=C)O)(O)O1)=O)=O,,,5,1,1,0,1
32399_0,,,,2,2,1,3
C1(COC(CC1(C(C=C)O)O)O)=O,,,5,1,1,0,1
32401_0,,,,2,2,1,3
C1(CC[CH]C(OC1(C(C=C)O)O)=O)=O,,,5,1,1,0,1
32403_0,,,,2,2,1,3
C(C(C[CH]C(O)=O)(C(C=C)O)O)=O,,,5,1,1,0,1
32405_0,,,,2,2,1,3
C(CCC(C=O)(C(C=C)O)O)(O)=O,,,5,1,1,0,1
32407_0,,,,2,2,1,3
C(C)(C1(CC(C(O1)=O)=O)C(C=C)O)=O,,,5,1,1,0,1
32409_0,,,,2,2,1,3
C1(C2(C)CC(C(O2)=O)(C(C=C)O)O1)=O,,,5,1,1,0,1
32411_0,,,,2,2,1,3
C=CC(C1(C(C=O)=O)C[CH]C(O1)=O)O,,,5,1,1,0,1
32413_0,,,,2,2,1,3
C1(CCC(C(C=O)=O)(C(C=C)O)O1)=O,,,5,1,1,0,1
32415_0,,,,2,2,1,3
C(C1(C[CH]C(O1)=O)C(C=C)O)(O)=O,,,5,1,1,0,1
32417_0,,,,2,2,1,3
C(C1(CCC(O1)=O)C(C=C)O)(O)=O,,,5,1,1,0,1
32419_0,,,,2,2,1,3
C1(C(CC(C)O1)(C(C=C)O)O)=O,,,5,1,1,0,1
32421_0,,,,2,2,1,3
C1(CC(C(O1)=O)(C(C=C)O)O)=O,,,5,1,1,0,1
32423_0,,,,2,2,1,3
C1(C(C[CH]C(O1)=O)(C(C=C)O)O)=O,,,5,1,1,0,1
32425_0,,,,2,2,1,3
C1(CCC(C(O1)=O)(C(C=C)O)O)=O,,,5,1,1,0,1
32427_0,,,,2,2,1,3
C(C1(CC[CH]C(O1)=O)C(C=C)O)(O)=O,,,5,1,1,0,1
32429_0,,,,2,2,1,3
C1(C(CC[CH]C(O1)=O)(C(C=C)O)O)=O,,,5,1,1,0,1
32431_0,,,,2,2,1,3
C(CC(C)C(C=O)(C(C=C)O)O)=O,,,5,1,1,0,1
32433_0,,,,2,2,1,3
C(C(CCO)(C(C=C)O)O)=O,,,5,1,1,0,1
32435_0,,,,2,2,1,3
C(C(C(C=C)O)(O)O)=O,,,5,1,1,0,1
32437_0,,,,2,2,1,3
C=CC(C(C(C(O)=O)=O)(C)O)O,,,5,1,1,0,1
32439_0,,,,2,2,1,3
C(C(C)(C(C=C)O)O)(O)=O,,,5,1,3,0,3
32440_0,,,,2,2,1,3
32442_0,,,,2,2,1,3
C(CC(C(CO)=O)(C(C=C)O)O)=O,,,5,1,1,0,1
32444_0,,,,2,2,1,3
C(CC(C(C)=O)(C(C=C)O)O)=O,,,5,1,3,0,3
32446_0,,,,2,2,1,3
C=CC(C(C(C(CO)=O)=O)(C)O)O,,,5,1,1,0,1
32448_0,,,,2,2,1,3
C=CC(C(C(C(C)=O)=O)(C)O)O,,,5,1,3,0,3
32450_0,,,,2,2,1,3
C(C(C)(C(C=C)O)O)=O,,,5,1,3,0,3
32452_0,,,,2,2,1,3
C(C(CC(C)O)(C(C=C)O)O)(O)=O,,,5,1,1,0,1
32454_0,,,,2,2,1,3
C(CC(C(O)=O)(C(C=C)O)O)(O)=O,,,5,1,1,0,1
32456_0,,,,2,2,1,3
C(C(C=C)(C(C=O)(CC)O)O)(O)=O,,,5,1,1,0,1
32458_0,,,,2,2,1,3
C(C(C=C)(C(C=O)(O)O)O)(O)=O,,,5,1,1,0,1
32459_0,,,,2,2,1,3
32460_0,,,,2,2,1,3
32461_0,,,,2,2,1,3
32463_0,,,,2,2,1,3
C=CC(C(C(O)=O)=O)(C(C)O)O,,,5,1,2,0,2
32465_0,,,,2,2,1,3
C(C(C=C)(C(C(O)=O)=O)O)(O)=O,,,5,1,2,0,2
32467_0,,,,2,2,1,3
C=CC(C(C(O)=O)=O)(CO)O,,,5,1,2,0,2
32469_0,,,,2,2,1,3
C(C(C(C=C)(C(C(O)=O)=O)O)O)=O,,,5,1,1,0,1
32471_0,,,,2,2,1,3
C=CC(C(C(O)=O)=O)(C(CO)O)O,,,5,1,1,0,1
32473_0,,,,2,2,1,3
C(C(C=CC(C)O)(C(C)O)O)(O)=O,,,5,1,1,0,1
32475_0,,,,2,2,1,3
C(C(C(O)=O)(C=CC(C)O)O)(O)=O,,,5,1,1,0,1
32476_0,,,,2,2,1,3
32478_0,,,,2,2,1,3
C(C(C=CC(O)=O)(C(C)O)O)(O)=O,,,5,1,1,0,1
32480_0,,,,2,2,1,3
C(C(C(O)=O)(C=CC(O)=O)O)(O)=O,,,5,1,1,0,1
32481_0,,,,2,2,1,3
32483_0,,,,2,2,1,3
C(CO)(C(C(C(O)=O)=C)(CO)O)=O,,,5,1,1,0,1
32485_0,,,,2,2,1,3
C(C(C(C=O)=C)(C(C)O)O)(O)=O,,,5,1,2,0,2
32487_0,,,,2,2,1,3
C(C(C(O)=O)(C(C=O)=C)O)(O)=O,,,5,1,2,0,2
32488_0,,,,2,2,1,3
32490_0,,,,2,2,1,3
C(C(C(C=O)=C)(C(C=O)O)O)(O)=O,,,5,1,1,0,1
32492_0,,,,2,2,1,3
C(C(C(C=O)=C)(C(CO)O)O)(O)=O,,,5,1,1,0,1
32494_0,,,,2,2,1,3
C(C)(C(C(C(O)=O)=C)(C(C)O)O)=O,,,5,1,1,0,1
32496_0,,,,2,2,1,3
C(C(C(C)=O)(C(C(O)=O)=C)O)(O)=O,,,5,1,1,0,1
32498_0,,,,2,2,1,3
C(C)(C(C(C(O)=O)=C)(CO)O)=O,,,5,1,2,0,2
32500_0,,,,2,2,1,3
C(C(C(C(C(O)=O)=C)(C)O)(O)O)=O,,,5,1,1,0,1
32502_0,,,,2,2,1,3
C(C(C(C(C(O)=O)=C)(C)O)O)(O)=O,,,5,1,1,0,1
32504_0,,,,2,2,1,3
C(C(C)(C(C(C(O)=O)=C)(C)O)O)=O,,,5,1,1,0,1
32506_0,,,,2,2,1,3
C(C1(C=C(C(O1)=O)C)C(C)O)(O)=O,,,5,1,1,0,1
32508_0,,,,2,2,1,3
C(C1(C(O)=O)C=C(C(O1)=O)C)(O)=O,,,5,1,1,0,1
32510_0,,,,2,2,1,3
C(C1(C=C(C(O1)=O)C)CO)(O)=O,,,5,1,2,0,2
32512_0,,,,2,2,1,3
C(C1(C(C)O)CC(C(O1)=O)=C)(O)=O,,,5,1,1,0,1
32514_0,,,,2,2,1,3
C(C1(C(O)=O)CC(C(O1)=O)=C)(O)=O,,,5,1,1,0,1
32516_0,,,,2,2,1,3
C(C1(CO)CC(C(O1)=O)=C)(O)=O,,,5,1,3,0,3
32518_0,,,,2,2,1,3
C1(C(C=C(C(O1)=O)C)(C(C)O)O)=O,,,5,1,1,0,1
32520_0,,,,2,2,1,3
C1(C(C(O)=O)(C=C(C(O1)=O)C)O)=O,,,5,1,1,0,1
32522_0,,,,2,2,1,3
C1(C(C=C(C(O1)=O)C)(CO)O)=O,,,5,1,2,0,2
32524_0,,,,2,2,1,3
C1(C(C(C)O)(CC(C(O1)=O)=C)O)=O,,,5,1,1,0,1
32526_0,,,,2,2,1,3
C1(C(C(O)=O)(CC(C(O1)=O)=C)O)=O,,,5,1,1,0,1
32528_0,,,,2,2,1,3
C1(C(CO)(CC(C(O1)=O)=C)O)=O,,,5,1,3,0,3
32530_0,,,,2,2,1,3
C(C(C=C[CH]C(O)=O)(CO)O)(O)=O,,,5,1,1,0,1
32532_0,,,,2,2,1,3
C(C(C=CCC(O)=O)(CO)O)(O)=O,,,5,1,1,0,1
32534_0,,,,2,2,1,3
C(C(C=CC)(C(C(O)O)O)O)(O)=O,,,5,1,1,0,1
32536_0,,,,2,2,1,3
C(C(C=CC)(C(C)O)O)(O)=O,,,5,1,2,0,2
32538_0,,,,2,2,1,3
C(C(C(O)=O)(C=CC)O)(O)=O,,,5,1,2,0,2
32539_0,,,,2,2,1,3
32540_0,,,,2,2,1,3
32542_0,,,,2,2,1,3
C(C(C=CC)(CO)O)(O)=O,,,5,1,2,0,2
32544_0,,,,2,2,1,3
C(C(C=CC)(C(CCO)O)O)(O)=O,,,5,1,1,0,1
32545_0,,,,2,2,1,3
32546_0,,,,2,2,1,3
32548_0,,,,2,2,1,3
C(C(C=CC)(C(C=CC)O)O)(O)=O,,,5,1,1,0,1
32550_0,,,,2,2,1,3
C(C(C=CC)(C(CC=C)O)O)(O)=O,,,5,1,1,0,1
32551_0,,,,2,2,1,3
32553_0,,,,2,2,1,3
C(C(C=CC)(C(C(C)O)O)O)(O)=O,,,5,1,1,0,1
32554_0,,,,2,2,1,3
32556_0,,,,2,2,1,3
C(C(C(C(O)O)O)(CC=C)O)(O)=O,,,5,1,1,0,1
32558_0,,,,2,2,1,3
C(C(C(C)O)(CC=C)O)(O)=O,,,5,1,2,0,2
32560_0,,,,2,2,1,3
C(C(C(O)=O)(CC=C)O)(O)=O,,,5,1,2,0,2
32561_0,,,,2,2,1,3
32562_0,,,,2,2,1,3
32564_0,,,,2,2,1,3
C(C(CO)(CC=C)O)(O)=O,,,5,1,2,0,2
32566_0,,,,2,2,1,3
C(C(C(CCO)O)(CC=C)O)(O)=O,,,5,1,1,0,1
32567_0,,,,2,2,1,3
32568_0,,,,2,2,1,3
32570_0,,,,2,2,1,3
C(C(CC=C)(C(C=CC)O)O)(O)=O,,,5,1,1,0,1
32572_0,,,,2,2,1,3
C(C(C(CC=C)O)(CC=C)O)(O)=O,,,5,1,1,0,1
32573_0,,,,2,2,1,3
32575_0,,,,2,2,1,3
C(C(C(C(C)O)O)(CC=C)O)(O)=O,,,5,1,1,0,1
32576_0,,,,2,2,1,3
32578_0,,,,2,2,1,3
C(C(CO)O)(C(C)(C(C)O)O)=O,,,5,1,2,0,2
32579_0,,,,2,2,1,3
32580_0,,,,2,2,1,3
32581_0,,,,2,2,1,3
32583_0,,,,2,2,1,3
C(C(CO)O)(C(C)(C(CO)O)O)=O,,,5,1,2,0,2
32585_0,,,,2,2,1,3
C(C(CC)(C(C(CC)O)O)O)=O,,,5,1,1,0,1
32587_0,,,,2,2,1,3
C(C(CC)(C(CCCO)O)O)=O,,,5,1,1,0,1
32589_0,,,,2,2,1,3
C(C(CC)(C1(C(O)OCC1)O)O)=O,,,5,1,1,0,1
32591_0,,,,2,2,1,3
C1(C(CCO1)(C(C=O)(CC)O)O)=O,,,5,1,1,0,1
32593_0,,,,2,2,1,3
C(C(CC)(C(CC(CO)C)O)O)=O,,,5,1,1,0,1
32595_0,,,,2,2,1,3
C(C(CC)(C(C(CCO)O)O)O)=O,,,5,1,1,0,1
32597_0,,,,2,2,1,3
C(C(C(C(O)O)O)(CC)O)=O,,,5,1,1,0,1
32599_0,,,,2,2,1,3
C(C(C(C)O)(CC)O)=O,,,5,1,2,0,2
32600_0,,,,2,2,1,3
32602_0,,,,2,2,1,3
C(C(CC)(C(CC(C)O)O)O)=O,,,5,1,2,0,2
32604_0,,,,2,2,1,3
C(C(C(CC(O)=O)O)(CC)O)=O,,,5,1,2,0,2
32606_0,,,,2,2,1,3
C(C(CC)(C(C(CO)=O)O)O)=O,,,5,1,2,0,2
32608_0,,,,2,2,1,3
C(C(CC)(C(C=O)(CO)O)O)=O,,,5,1,2,0,2
32610_0,,,,2,2,1,3
C(C(CC)(C(C=O)(C)O)O)=O,,,5,1,2,0,2
32612_0,,,,2,2,1,3
C(C(CC)(C(C(C)=O)O)O)=O,,,5,1,2,0,2
32614_0,,,,2,2,1,3
C(C(CO)(CC)O)=O,,,5,1,2,0,2
32616_0,,,,2,2,1,3
C(C(CO)(C(C=O)(CC)O)O)(O)=O,,,5,1,2,0,2
32618_0,,,,2,2,1,3
C(C(CCO)(C(C=O)(CC)O)O)=O,,,5,1,1,0,1
32620_0,,,,2,2,1,3
C(C(CC)(C(C(CCO)=O)O)O)=O,,,5,1,1,0,1
32622_0,,,,2,2,1,3
C(C(CC)(C(CCO)O)O)=O,,,5,1,1,0,1
32624_0,,,,2,2,1,3
C(C(CC)(C(C=O)O)O)=O,,,5,1,1,0,1
32626_0,,,,2,2,1,3
C(C(C(C(C=O)O)O)(CC)O)=O,,,5,1,1,0,1
32628_0,,,,2,2,1,3
C(C(C(C(C(O)=O)O)O)(CC)O)=O,,,5,1,1,0,1
32630_0,,,,2,2,1,3
C(C(CC)(C(CO)(CO)O)O)=O,,,5,1,1,0,1
32632_0,,,,2,2,1,3
C(C(CC)(C(CO)(C)O)O)=O,,,5,1,1,0,1
32634_0,,,,2,2,1,3
C(C(CC)(C(C=CC)O)O)=O,,,5,1,1,0,1
32636_0,,,,2,2,1,3
C(C(C(CC=C)O)(CC)O)=O,,,5,1,1,0,1
32638_0,,,,2,2,1,3
C(C(CC)(C(C(CO)O)O)O)=O,,,5,1,1,0,1
32640_0,,,,2,2,1,3
C(C(C(CO)O)(CC)O)=O,,,5,1,1,0,1
32642_0,,,,2,2,1,3
C(C(CC)(C(C(C)O)O)O)=O,,,5,1,1,0,1
32644_0,,,,2,2,1,3
C(C(CC)(C(C(O)=O)O)O)=O,,,5,1,1,0,1
32646_0,,,,2,2,1,3
C(C(C)(C(C=O)(CC)O)O)(O)=O,,,5,1,2,0,2
32648_0,,,,2,2,1,3
C1(C(C(C(CC)O)O)(O)OCC1)=O,,,5,1,1,0,1
32650_0,,,,2,2,1,3
C(C(CCO)(C(C(CC)O)O)O)=O,,,5,1,1,0,1
32652_0,,,,2,2,1,3
C(C(C(C(CC)O)O)(O)O)=O,,,5,1,1,0,1
32654_0,,,,2,2,1,3
C(C(C)(C(C(CC)O)O)O)(O)=O,,,5,1,2,0,2
32656_0,,,,2,2,1,3
C(C(C(C(CC)O)O)O)(O)=O,,,5,1,2,0,2
32658_0,,,,2,2,1,3
C(C(C)(C(C(CC)O)O)O)=O,,,5,1,2,0,2
32660_0,,,,2,2,1,3
C1(C(C(CCCO)O)(O)OCC1)=O,,,5,1,1,0,1
32662_0,,,,2,2,1,3
C(C(CCO)(C(CCCO)O)O)=O,,,5,1,1,0,1
32664_0,,,,2,2,1,3
C(C(C(CCCO)O)(O)O)=O,,,5,1,1,0,1
32666_0,,,,2,2,1,3
C(C(C)(C(CCCO)O)O)(O)=O,,,5,1,2,0,2
32668_0,,,,2,2,1,3
C(C(C(CCCO)O)O)(O)=O,,,5,1,2,0,2
32670_0,,,,2,2,1,3
C(C(C)(C(CCCO)O)O)=O,,,5,1,2,0,2
32672_0,,,,2,2,1,3
C(C(C(C(C)O)(CC)O)=O)(O)=O,,,5,1,2,0,2
32674_0,,,,2,2,1,3
C(C(C(C(O)=O)=O)(CC)O)(O)=O,,,5,1,2,0,2
32676_0,,,,2,2,1,3
C(C(C(CO)(CC)O)=O)(O)=O,,,5,1,2,0,2
32677_0,,,,2,2,1,3
32679_0,,,,2,2,1,3
C(C(C(C(CO)O)(CC)O)=O)(O)=O,,,5,1,1,0,1
32681_0,,,,2,2,1,3
C(C(C)C(C=O)(C(C)O)O)(O)=O,,,5,1,2,0,2
32682_0,,,,2,2,1,3
32684_0,,,,2,2,1,3
C(C(C)C(C=O)(CO)O)(O)=O,,,5,1,2,0,2
32686_0,,,,2,2,1,3
C(C(C)C(C=O)(C(C=O)O)O)(O)=O,,,5,1,1,0,1
32688_0,,,,2,2,1,3
C(C(C)C(C=O)(C(CO)O)O)(O)=O,,,5,1,1,0,1
32690_0,,,,2,2,1,3
C1(C(C)C(C(C(O1)=O)=O)(CO)O)=O,,,5,1,2,0,2
32692_0,,,,2,2,1,3
C1(C(CO)(O)OC(CC(C)O)C1)=O,,,5,1,1,0,1
32694_0,,,,2,2,1,3
C(CC1CC(C(CO)(O)O1)=O)(O)=O,,,5,1,1,0,1
32696_0,,,,2,2,1,3
C1(CC(C(CO)=O)OC1(CO)O)=O,,,5,1,1,0,1
32698_0,,,,2,2,1,3
C(CO)(C1(CO)CC(C(O1)O)=O)=O,,,5,1,2,0,2
32700_0,,,,2,2,1,3
C(C1(CO)CC(C(CO)(O1)O)=O)=O,,,5,1,1,0,1
32702_0,,,,2,2,1,3
C(C1(C)C(C(C(CO)(O1)O)=O)O)=O,,,5,1,1,0,1
32704_0,,,,2,2,1,3
C(C1C(C(C(CO)(O1)O)=O)O)(C)=O,,,5,1,1,0,1
32706_0,,,,2,2,1,3
C1(C(C(C(O)O)O)(O)OCC1O)=O,,,5,1,1,0,1
32708_0,,,,2,2,1,3
C1(C(C(C)O)(O)OCC1O)=O,,,5,1,2,0,2
32710_0,,,,2,2,1,3
C(C1(C(C(CO1)O)=O)O)(O)=O,,,5,1,2,0,2
32712_0,,,,2,2,1,3
C(C(C)(C1(C(C(CO1)O)=O)O)O)=O,,,5,1,1,0,1
32714_0,,,,2,2,1,3
C(C(C1(C(C(CO1)O)=O)O)O)(C)=O,,,5,1,1,0,1
32716_0,,,,2,2,1,3
C1(C(CO)(O)OCC1O)=O,,,5,1,1,0,1
32718_0,,,,2,2,1,3
C1(C(C(CCO)O)(O)OCC1O)=O,,,5,1,1,0,1
32720_0,,,,2,2,1,3
C(C(C1(C(C(CO1)O)=O)O)O)=O,,,5,1,1,0,1
32722_0,,,,2,2,1,3
C1(C(C(CO)(C)O)(O)OCC1O)=O,,,5,1,1,0,1
32724_0,,,,2,2,1,3
C1(C(C(C=CC)O)(O)OCC1O)=O,,,5,1,1,0,1
32726_0,,,,2,2,1,3
C1(C(C(CC=C)O)(O)OCC1O)=O,,,5,1,1,0,1
32728_0,,,,2,2,1,3
C1(C(C(CO)O)(O)OCC1O)=O,,,5,1,1,0,1
32730_0,,,,2,2,1,3
C1(C(C(C(C)O)O)(O)OCC1O)=O,,,5,1,1,0,1
32732_0,,,,2,2,1,3
C(C(C1(C(C(CO1)O)=O)O)O)(O)=O,,,5,1,1,0,1
32734_0,,,,2,2,1,3
C(C(C1(C(O)OCC1O)O)(O)O)=O,,,5,1,1,0,1
32736_0,,,,2,2,1,3
C(C(C1(C(O)OCC1O)O)O)(O)=O,,,5,1,2,0,2
32738_0,,,,2,2,1,3
C(C(C)(C1(C(O)OCC1O)O)O)=O,,,5,1,2,0,2
32740_0,,,,2,2,1,3
C1(C(C(C)O)(O)OC(C)C1O)=O,,,5,1,2,0,2
32742_0,,,,2,2,1,3
C(C1(C(C(C(C)O1)O)=O)O)(O)=O,,,5,1,2,0,2
32744_0,,,,2,2,1,3
C1(C(CO)(O)OC(C)C1O)=O,,,5,1,1,0,1
32746_0,,,,2,2,1,3
C(C(C1(C(C(C(C)O1)O)=O)O)O)=O,,,5,1,1,0,1
32748_0,,,,2,2,1,3
C1(C(C(CO)O)(O)OC(C)C1O)=O,,,5,1,1,0,1
32750_0,,,,2,2,1,3
C1(C(C(C(C(C)O)(O)O1)=O)O)=O,,,5,1,2,0,2
32752_0,,,,2,2,1,3
C1(C(C(C(C(O)=O)(O)O1)=O)O)=O,,,5,1,2,0,2
32754_0,,,,2,2,1,3
C1(C(C(C(CO)(O)O1)=O)O)=O,,,5,1,2,0,2
32756_0,,,,2,2,1,3
C1(C(C(C(C(C=O)O)(O)O1)=O)O)=O,,,5,1,1,0,1
32758_0,,,,2,2,1,3
C1(C(C(C(C(CO)O)(O)O1)=O)O)=O,,,5,1,1,0,1
32760_0,,,,2,2,1,3
C(C1(C)CC(C(C(C)O)(O1)O)=O)=O,,,5,1,2,0,2
32762_0,,,,2,2,1,3
C(C1(C)CC(C(C(O)=O)(O1)O)=O)=O,,,5,1,2,0,2
32764_0,,,,2,2,1,3
C(C1(C)CC(C(CO)(O1)O)=O)=O,,,5,1,1,0,1
32766_0,,,,2,2,1,3
C1(CC(C(C)=O)OC1(C(C)O)O)=O,,,5,1,2,0,2
32768_0,,,,2,2,1,3
C(C1(C(CC(C(C)=O)O1)=O)O)(O)=O,,,5,1,2,0,2
32770_0,,,,2,2,1,3
C1(CC(C(C)=O)OC1(CO)O)=O,,,5,1,1,0,1
32772_0,,,,2,2,1,3
C(C)(C1(C(C)O)CC(C(O1)O)=O)=O,,,5,1,2,0,2
32774_0,,,,2,2,1,3
C(C1(C(C)=O)CC(C(O1)O)=O)(O)=O,,,5,1,2,0,2
32776_0,,,,2,2,1,3
C(C)(C1(CO)CC(C(O1)O)=O)=O,,,5,1,2,0,2
32778_0,,,,2,2,1,3
C1(C(C(C(O)O)O)(O)OCC1)=O,,,5,1,1,0,1
32780_0,,,,2,2,1,3
C1(C(C(C)O)(O)OCC1)=O,,,5,1,2,0,2
32782_0,,,,2,2,1,3
C(C1(C(CCO1)=O)O)(O)=O,,,5,1,2,0,2
32784_0,,,,2,2,1,3
C1(C(C(CC(C)O)O)(O)OCC1)=O,,,5,1,1,0,1
32786_0,,,,2,2,1,3
C(CC(C1(C(CCO1)=O)O)O)(O)=O,,,5,1,1,0,1
32788_0,,,,2,2,1,3
C(C(C1(C(CCO1)=O)O)O)(CO)=O,,,5,1,1,0,1
32790_0,,,,2,2,1,3
C(C(CO)(C1(C(CCO1)=O)O)O)=O,,,5,1,1,0,1
32792_0,,,,2,2,1,3
C(C(C)(C1(C(CCO1)=O)O)O)=O,,,5,1,1,0,1
32794_0,,,,2,2,1,3
C(C(C1(C(CCO1)=O)O)O)(C)=O,,,5,1,1,0,1
32796_0,,,,2,2,1,3
C1(C(CO)(O)OCC1)=O,,,5,1,1,0,1
32798_0,,,,2,2,1,3
C1(C(C(CCO)O)(O)OCC1)=O,,,5,1,1,0,1
32800_0,,,,2,2,1,3
C(C(C1(C(CCO1)=O)O)O)=O,,,5,1,1,0,1
32802_0,,,,2,2,1,3
C(C(C(C1(C(CCO1)=O)O)O)O)=O,,,5,1,1,0,1
32804_0,,,,2,2,1,3
C1(C(C(CO)(CO)O)(O)OCC1)=O,,,5,1,1,0,1
32806_0,,,,2,2,1,3
C1(C(C(CO)(C)O)(O)OCC1)=O,,,5,1,1,0,1
32808_0,,,,2,2,1,3
C1(C(C(C=CC)O)(O)OCC1)=O,,,5,1,1,0,1
32810_0,,,,2,2,1,3
C1(C(C(CC=C)O)(O)OCC1)=O,,,5,1,1,0,1
32812_0,,,,2,2,1,3
C1(C(C(C(CO)O)O)(O)OCC1)=O,,,5,1,1,0,1
32814_0,,,,2,2,1,3
C1(C(C(CO)O)(O)OCC1)=O,,,5,1,1,0,1
32816_0,,,,2,2,1,3
C1(C(C(C(C)O)O)(O)OCC1)=O,,,5,1,1,0,1
32818_0,,,,2,2,1,3
C(C(C1(C(CCO1)=O)O)O)(O)=O,,,5,1,1,0,1
32820_0,,,,2,2,1,3
C(C(C)(C1(C(CCO1)=O)O)O)(O)=O,,,5,1,2,0,2
32822_0,,,,2,2,1,3
C(C(C1(C(O)OCC1)O)(O)O)=O,,,5,1,1,0,1
32824_0,,,,2,2,1,3
C(C(C)(C1(C(O)OCC1)O)O)(O)=O,,,5,1,2,0,2
32826_0,,,,2,2,1,3
C(C(C1(C(O)OCC1)O)O)(O)=O,,,5,1,2,0,2
32828_0,,,,2,2,1,3
C(C(C)(C1(C(O)OCC1)O)O)=O,,,5,1,2,0,2
32830_0,,,,2,2,1,3
C1(C(C(C(O)O)O)(O)OC(C)C1)=O,,,5,1,1,0,1
32832_0,,,,2,2,1,3
C1(C(C(C)O)(O)OC(C)C1)=O,,,5,1,2,0,2
32834_0,,,,2,2,1,3
C(C1(C(CC(C)O1)=O)O)(O)=O,,,5,1,2,0,2
32836_0,,,,2,2,1,3
C(C(C)(C1(C(CC(C)O1)=O)O)O)=O,,,5,1,1,0,1
32838_0,,,,2,2,1,3
C(C(C1(C(CC(C)O1)=O)O)O)(C)=O,,,5,1,1,0,1
32840_0,,,,2,2,1,3
C1(C(CO)(O)OC(C)C1)=O,,,5,1,1,0,1
32842_0,,,,2,2,1,3
C1(C(C(CCO)O)(O)OC(C)C1)=O,,,5,1,1,0,1
32844_0,,,,2,2,1,3
C(C(C1(C(CC(C)O1)=O)O)O)=O,,,5,1,1,0,1
32846_0,,,,2,2,1,3
C1(C(C(CO)(C)O)(O)OC(C)C1)=O,,,5,1,1,0,1
32848_0,,,,2,2,1,3
C1(C(C(C=CC)O)(O)OC(C)C1)=O,,,5,1,1,0,1
32850_0,,,,2,2,1,3
C1(C(C(CC=C)O)(O)OC(C)C1)=O,,,5,1,1,0,1
32852_0,,,,2,2,1,3
C1(C(C(CO)O)(O)OC(C)C1)=O,,,5,1,1,0,1
32854_0,,,,2,2,1,3
C1(C(C(C(C)O)O)(O)OC(C)C1)=O,,,5,1,1,0,1
32856_0,,,,2,2,1,3
C(C(C1(C(CC(C)O1)=O)O)O)(O)=O,,,5,1,1,0,1
32858_0,,,,2,2,1,3
C(C(C1(C(O)OC(C)C1)O)(O)O)=O,,,5,1,1,0,1
32860_0,,,,2,2,1,3
C(C(C1(C(O)OC(C)C1)O)O)(O)=O,,,5,1,2,0,2
32862_0,,,,2,2,1,3
C(C(C)(C1(C(O)OC(C)C1)O)O)=O,,,5,1,2,0,2
32864_0,,,,2,2,1,3
C1(CC(C(C(C(O)O)O)(O)O1)=O)=O,,,5,1,1,0,1
32866_0,,,,2,2,1,3
C1(CC(C(C(C)O)(O)O1)=O)=O,,,5,1,2,0,2
32868_0,,,,2,2,1,3
C1(CC(C(C(O)=O)(O)O1)=O)=O,,,5,1,2,0,2
32870_0,,,,2,2,1,3
C(C(C)(C1(C(CC(O1)=O)=O)O)O)=O,,,5,1,1,0,1
32872_0,,,,2,2,1,3
C1(CC(C(C(C(C)=O)O)(O)O1)=O)=O,,,5,1,1,0,1
32874_0,,,,2,2,1,3
C1(CC(C(CO)(O)O1)=O)=O,,,5,1,3,0,3
32876_0,,,,2,2,1,3
C1(CC(C(C(CCO)O)(O)O1)=O)=O,,,5,1,1,0,1
32878_0,,,,2,2,1,3
C1(CC(C(C(C=O)O)(O)O1)=O)=O,,,5,1,1,0,1
32880_0,,,,2,2,1,3
C1(CC(C(C(CO)(C)O)(O)O1)=O)=O,,,5,1,1,0,1
32882_0,,,,2,2,1,3
C1(CC(C(C(C=CC)O)(O)O1)=O)=O,,,5,1,1,0,1
32884_0,,,,2,2,1,3
C1(CC(C(C(CC=C)O)(O)O1)=O)=O,,,5,1,1,0,1
32886_0,,,,2,2,1,3
C1(CC(C(C(CO)O)(O)O1)=O)=O,,,5,1,1,0,1
32888_0,,,,2,2,1,3
C1(CC(C(C(C(C)O)O)(O)O1)=O)=O,,,5,1,1,0,1
32890_0,,,,2,2,1,3
C1(CC(C(C(C(O)=O)O)(O)O1)=O)=O,,,5,1,1,0,1
32892_0,,,,2,2,1,3
C1(CC(C(O)O1)(C(C=O)(O)O)O)=O,,,5,1,1,0,1
32894_0,,,,2,2,1,3
C1(CC(C(O)O1)(C(C(O)=O)O)O)=O,,,5,1,2,0,2
32896_0,,,,2,2,1,3
C(C(C)(C1(C(O)OC(C1)=O)O)O)=O,,,5,1,2,0,2
32898_0,,,,2,2,1,3
C(C1(C)CC(C(CO)(O1)O)=O)(O)=O,,,5,1,1,0,1
32900_0,,,,2,2,1,3
C(C1(CO)CC(C(C)(O1)O)=O)(O)=O,,,5,1,2,0,2
32902_0,,,,2,2,1,3
C1(C(CO)(CC(C(C)=O)(O)O1)O)=O,,,5,1,2,0,2
32904_0,,,,2,2,1,3
C(C1(CC(C(CO1)=O)(CO)O)O)=O,,,5,1,2,0,2
32906_0,,,,2,2,1,3
C1(COC(CC1(C(C)O)O)O)=O,,,5,1,2,0,2
32908_0,,,,2,2,1,3
C(C1(C(COC(C1)O)=O)O)(O)=O,,,5,1,2,0,2
32910_0,,,,2,2,1,3
C1(COC(CC1(CO)O)O)=O,,,5,1,2,0,2
32912_0,,,,2,2,1,3
C1(COC(CC1(C(C=O)O)O)O)=O,,,5,1,2,0,2
32914_0,,,,2,2,1,3
C1(COC(CC1(C(CO)O)O)O)=O,,,5,1,2,0,2
32916_0,,,,2,2,1,3
C(C1(COC(C(C1)=O)(CO)O)O)=O,,,5,1,1,0,1
32918_0,,,,2,2,1,3
C1(C(C)(CC(C(CO)(O)O1)=O)O)=O,,,5,1,1,0,1
32920_0,,,,2,2,1,3
C1(C(CO)(CC(C(C)(O)O1)=O)O)=O,,,5,1,2,0,2
32922_0,,,,2,2,1,3
C1(C(CO)(O)OC(C)CC(C1)O)=O,,,5,1,1,0,1
32924_0,,,,2,2,1,3
C1(CC(CC(C(CO)(O)O1)=O)O)=O,,,5,1,1,0,1
32926_0,,,,2,2,1,3
C1(CC(C(COC1(CO)O)=O)O)=O,,,5,1,1,0,1
32928_0,,,,2,2,1,3
C1(COC(C(CC1(CO)O)=O)O)=O,,,5,1,2,0,2
32930_0,,,,2,2,1,3
C1(C(O)OC([CH]CC1(CO)O)=O)=O,,,5,1,2,0,2
32932_0,,,,2,2,1,3
C1(C(C[CH]C(OC1(CO)O)=O)O)=O,,,5,1,1,0,1
32934_0,,,,2,2,1,3
C1(CCC(C(C(O)O1)=O)(CO)O)=O,,,5,1,2,0,2
32936_0,,,,2,2,1,3
C1(CCC(C(C(CO)(O)O1)=O)O)=O,,,5,1,1,0,1
32938_0,,,,2,2,1,3
C1(CC[CH]C(OC1(C(C)O)O)=O)=O,,,5,1,2,0,2
32940_0,,,,2,2,1,3
C(C1(C(CC[CH]C(O1)=O)=O)O)(O)=O,,,5,1,2,0,2
32942_0,,,,2,2,1,3
C1(CC[CH]C(OC1(CO)O)=O)=O,,,5,1,1,0,1
32944_0,,,,2,2,1,3
C1(CCCC(C(C(C)O)(O)O1)=O)=O,,,5,1,2,0,2
32946_0,,,,2,2,1,3
C(C1(C(CCCC(O1)=O)=O)O)(O)=O,,,5,1,2,0,2
32948_0,,,,2,2,1,3
C1(CCCC(C(CO)(O)O1)=O)=O,,,5,1,1,0,1
32950_0,,,,2,2,1,3
C(C(C(C)O)(C[CH]C(O)=O)O)=O,,,5,1,2,0,2
32951_0,,,,2,2,1,3
32952_0,,,,2,2,1,3
32953_0,,,,2,2,1,3
32955_0,,,,2,2,1,3
C(C(C(CO)O)(C[CH]C(O)=O)O)=O,,,5,1,2,0,2
32957_0,,,,2,2,1,3
C(C(CCC(O)=O)(C(C)O)O)=O,,,5,1,3,0,3
32958_0,,,,2,2,1,3
32959_0,,,,2,2,1,3
32960_0,,,,2,2,1,3
32962_0,,,,2,2,1,3
C(C(CCC(O)=O)(C(CO)O)O)=O,,,5,1,2,0,2
32964_0,,,,2,2,1,3
C(CO)(C1(CO)CC(C(O1)=O)=O)=O,,,5,1,1,0,1
32966_0,,,,2,2,1,3
C(C)(C1(C(C)O)CC(C(O1)=O)=O)=O,,,5,1,1,0,1
32968_0,,,,2,2,1,3
C(C1(C(C)=O)CC(C(O1)=O)=O)(O)=O,,,5,1,1,0,1
32970_0,,,,2,2,1,3
C(C)(C1(CO)CC(C(O1)=O)=O)=O,,,5,1,2,0,2
32972_0,,,,2,2,1,3
C1(C(C(CO1)O)(C(C=O)(O)O)O)=O,,,5,1,1,0,1
32974_0,,,,2,2,1,3
C1(C(C(CO1)O)(C(C(O)=O)O)O)=O,,,5,1,1,0,1
32976_0,,,,2,2,1,3
C1(C(C(CO1)O)(C(C=O)(C)O)O)=O,,,5,1,1,0,1
32978_0,,,,2,2,1,3
C1(C(CCO1)(C(C=O)(O)O)O)=O,,,5,1,1,0,1
32980_0,,,,2,2,1,3
C1(C(CCO1)(C(C(O)=O)(C)O)O)=O,,,5,1,1,0,1
32982_0,,,,2,2,1,3
C1(C(CCO1)(C(C(O)=O)O)O)=O,,,5,1,2,0,2
32984_0,,,,2,2,1,3
C1(C(CCO1)(C(C=O)(C)O)O)=O,,,5,1,2,0,2
32986_0,,,,2,2,1,3
C(C(C1(C(C(OC1)=O)=O)O)(O)O)=O,,,5,1,1,0,1
32987_0,,,,2,2,1,3
32988_0,,,,2,2,1,3
32990_0,,,,2,2,1,3
C1(C(C(CO1)=O)(C(C=O)(O)O)O)=O,,,5,1,1,0,1
32992_0,,,,2,2,1,3
C1(C(C(CO1)=O)(C(C(O)=O)O)O)=O,,,5,1,1,0,1
32994_0,,,,2,2,1,3
C(C(C)(C1(C(OCC1=O)=O)O)O)=O,,,5,1,1,0,1
32996_0,,,,2,2,1,3
C1(C2(C)CC(C(O2)=O)(C(C)O)O1)=O,,,5,1,1,0,1
32998_0,,,,2,2,1,3
C(C12C(OC(C(O1)=O)(C)C2)=O)(O)=O,,,5,1,1,0,1
33000_0,,,,2,2,1,3
C1(C2(C)CC(C(O2)=O)(CO)O1)=O,,,5,1,3,0,3
33002_0,,,,2,2,1,3
[CH]1C(OC(C(C=O)=O)(C(C)O)C1)=O,,,5,1,1,0,1
33004_0,,,,2,2,1,3
C(C1(C(C=O)=O)C[CH]C(O1)=O)(O)=O,,,5,1,1,0,1
33006_0,,,,2,2,1,3
[CH]1C(OC(C(C=O)=O)(CO)C1)=O,,,5,1,2,0,2
33008_0,,,,2,2,1,3
C(C(C1(C(C=O)=O)C[CH]C(O1)=O)O)=O,,,5,1,1,0,1
33010_0,,,,2,2,1,3
C1(CCC(C(C=O)=O)(C(C)O)O1)=O,,,5,1,1,0,1
33012_0,,,,2,2,1,3
C(C1(C(C=O)=O)CCC(O1)=O)(O)=O,,,5,1,1,0,1
33014_0,,,,2,2,1,3
C1(CCC(C(C=O)=O)(CO)O1)=O,,,5,1,2,0,2
33016_0,,,,2,2,1,3
C(C1(C(C)O)C[CH]C(O1)=O)(O)=O,,,5,1,2,0,2
33018_0,,,,2,2,1,3
C(C1(C(O)=O)C[CH]C(O1)=O)(O)=O,,,5,1,2,0,2
33019_0,,,,2,2,1,3
33021_0,,,,2,2,1,3
C(C1(C[CH]C(O1)=O)C(C=O)O)(O)=O,,,5,1,1,0,1
33023_0,,,,2,2,1,3
C(C1(C[CH]C(O1)=O)C(C=CC)O)(O)=O,,,5,1,1,0,1
33025_0,,,,2,2,1,3
C(C1(C(CC=C)O)C[CH]C(O1)=O)(O)=O,,,5,1,1,0,1
33027_0,,,,2,2,1,3
C(C1(C(CO)O)C[CH]C(O1)=O)(O)=O,,,5,1,1,0,1
33029_0,,,,2,2,1,3
C(C1(CCC(O1)=O)C(C)O)(O)=O,,,5,1,2,0,2
33031_0,,,,2,2,1,3
C(C1(C(O)=O)CCC(O1)=O)(O)=O,,,5,1,2,0,2
33032_0,,,,2,2,1,3
33034_0,,,,2,2,1,3
C(C1(CCC(O1)=O)C(C=O)O)(O)=O,,,5,1,1,0,1
33036_0,,,,2,2,1,3
C(C1(CCC(O1)=O)C(CO)O)(O)=O,,,5,1,1,0,1
33038_0,,,,2,2,1,3
[CH]1C(OC(C(C(O)=O)=O)(CO)C1)=O,,,5,1,1,0,1
33040_0,,,,2,2,1,3
C1(CCC(C(C(O)=O)=O)(CO)O1)=O,,,5,1,1,0,1
33042_0,,,,2,2,1,3
C1(C(C(C(O)O)O)(CC(C)O1)O)=O,,,5,1,1,0,1
33044_0,,,,2,2,1,3
C1(C(C(C)O)(CC(C)O1)O)=O,,,5,1,2,0,2
33046_0,,,,2,2,1,3
C1(C(C(O)=O)(CC(C)O1)O)=O,,,5,1,2,0,2
33047_0,,,,2,2,1,3
33048_0,,,,2,2,1,3
33050_0,,,,2,2,1,3
C1(C(CO)(CC(C)O1)O)=O,,,5,1,2,0,2
33052_0,,,,2,2,1,3
C1(C(CC(C)O1)(C(CCO)O)O)=O,,,5,1,1,0,1
33053_0,,,,2,2,1,3
33054_0,,,,2,2,1,3
33056_0,,,,2,2,1,3
C1(C(CC(C)O1)(C(C=CC)O)O)=O,,,5,1,1,0,1
33058_0,,,,2,2,1,3
C1(C(C(CC=C)O)(CC(C)O1)O)=O,,,5,1,1,0,1
33059_0,,,,2,2,1,3
33061_0,,,,2,2,1,3
C1(C(CC(C)O1)(C(C(C)O)O)O)=O,,,5,1,1,0,1
33062_0,,,,2,2,1,3
33064_0,,,,2,2,1,3
C1(C(C(C(O)O)O)(CC(O1)=O)O)=O,,,5,1,1,0,1
33066_0,,,,2,2,1,3
C1(C(C(C)O)(CC(O1)=O)O)=O,,,5,1,2,0,2
33068_0,,,,2,2,1,3
C1(C(C(O)=O)(CC(O1)=O)O)=O,,,5,1,2,0,2
33069_0,,,,2,2,1,3
33070_0,,,,2,2,1,3
33072_0,,,,2,2,1,3
C1(C(CO)(CC(O1)=O)O)=O,,,5,1,2,0,2
33074_0,,,,2,2,1,3
C1(C(C(CCO)O)(CC(O1)=O)O)=O,,,5,1,1,0,1
33075_0,,,,2,2,1,3
33076_0,,,,2,2,1,3
33078_0,,,,2,2,1,3
C1(CC(C(O1)=O)(C(C=CC)O)O)=O,,,5,1,1,0,1
33080_0,,,,2,2,1,3
C1(C(C(CC=C)O)(CC(O1)=O)O)=O,,,5,1,1,0,1
33081_0,,,,2,2,1,3
33083_0,,,,2,2,1,3
C1(C(C(C(C)O)O)(CC(O1)=O)O)=O,,,5,1,1,0,1
33084_0,,,,2,2,1,3
33086_0,,,,2,2,1,3
C1(C(C=O)C(C(CO1)=O)(CO)O)=O,,,5,1,1,0,1
33088_0,,,,2,2,1,3
C1(C(C(C)O)(C[CH]C(O1)=O)O)=O,,,5,1,2,0,2
33090_0,,,,2,2,1,3
C1(C(C(O)=O)(C[CH]C(O1)=O)O)=O,,,5,1,2,0,2
33091_0,,,,2,2,1,3
33093_0,,,,2,2,1,3
C1(C(C[CH]C(O1)=O)(C(C=O)O)O)=O,,,5,1,1,0,1
33095_0,,,,2,2,1,3
C1(C(C[CH]C(O1)=O)(C(C=CC)O)O)=O,,,5,1,1,0,1
33097_0,,,,2,2,1,3
C1(C(C(CC=C)O)(C[CH]C(O1)=O)O)=O,,,5,1,1,0,1
33099_0,,,,2,2,1,3
C1(C(C(CO)O)(C[CH]C(O1)=O)O)=O,,,5,1,1,0,1
33101_0,,,,2,2,1,3
C1(C(CCC(O1)=O)(C(C)O)O)=O,,,5,1,2,0,2
33103_0,,,,2,2,1,3
C1(C(C(O)=O)(CCC(O1)=O)O)=O,,,5,1,2,0,2
33104_0,,,,2,2,1,3
33106_0,,,,2,2,1,3
C1(CCC(C(O1)=O)(C(C=O)O)O)=O,,,5,1,1,0,1
33108_0,,,,2,2,1,3
C1(C(CCC(O1)=O)(C(CO)O)O)=O,,,5,1,1,0,1
33110_0,,,,2,2,1,3
C(C1(CC[CH]C(O1)=O)C(C)O)(O)=O,,,5,1,1,0,1
33112_0,,,,2,2,1,3
C(C1(C(O)=O)CC[CH]C(O1)=O)(O)=O,,,5,1,1,0,1
33114_0,,,,2,2,1,3
C(C1(CC[CH]C(O1)=O)CO)(O)=O,,,5,1,2,0,2
33116_0,,,,2,2,1,3
C(C1(CCCC(O1)=O)C(C)O)(O)=O,,,5,1,1,0,1
33118_0,,,,2,2,1,3
C(C1(C(O)=O)CCCC(O1)=O)(O)=O,,,5,1,1,0,1
33120_0,,,,2,2,1,3
C(C1(CO)CCCC(O1)=O)(O)=O,,,5,1,2,0,2
33122_0,,,,2,2,1,3
C1(COC(C(CC1(CO)O)=O)=O)=O,,,5,1,1,0,1
33124_0,,,,2,2,1,3
[CH]1C(OC(C(C(CO)(C1)O)=O)=O)=O,,,5,1,1,0,1
33126_0,,,,2,2,1,3
C1(C(CC[CH]C(O1)=O)(C(C)O)O)=O,,,5,1,1,0,1
33128_0,,,,2,2,1,3
C1(C(C(O)=O)(CC[CH]C(O1)=O)O)=O,,,5,1,1,0,1
33130_0,,,,2,2,1,3
C1(C(CO)(CC[CH]C(O1)=O)O)=O,,,5,1,2,0,2
33132_0,,,,2,2,1,3
C1(CCC(C(C(O1)=O)=O)(CO)O)=O,,,5,1,1,0,1
33134_0,,,,2,2,1,3
C1(C(C(C)O)(CCCC(O1)=O)O)=O,,,5,1,1,0,1
33136_0,,,,2,2,1,3
C1(C(C(O)=O)(CCCC(O1)=O)O)=O,,,5,1,1,0,1
33138_0,,,,2,2,1,3
C1(C(CO)(CCCC(O1)=O)O)=O,,,5,1,2,0,2
33139_0,,,,2,2,1,3
33141_0,,,,2,2,1,3
C(CC(C)C(C(C)=O)(C(C)O)O)=O,,,5,1,2,0,2
33143_0,,,,2,2,1,3
C(CC(C)C(C(O)=O)(C(C)=O)O)=O,,,5,1,2,0,2
33145_0,,,,2,2,1,3
C(CC(C)C(C(C)=O)(CO)O)=O,,,5,1,2,0,2
33147_0,,,,2,2,1,3
C(C)(C(C(C)O)(C[CH]C(O)=O)O)=O,,,5,1,2,0,2
33149_0,,,,2,2,1,3
C(C(C(C)=O)(C[CH]C(O)=O)O)(O)=O,,,5,1,2,0,2
33151_0,,,,2,2,1,3
C(C)(C(CO)(C[CH]C(O)=O)O)=O,,,5,1,2,0,2
33153_0,,,,2,2,1,3
C(CCC(C(C)=O)(C(C)O)O)(O)=O,,,5,1,2,0,2
33155_0,,,,2,2,1,3
C(CCC(C(O)=O)(C(C)=O)O)(O)=O,,,5,1,2,0,2
33157_0,,,,2,2,1,3
C(CCC(C(C)=O)(CO)O)(O)=O,,,5,1,2,0,2
33159_0,,,,2,2,1,3
C(C(C(CC(CO)C)O)(O)O)=O,,,5,1,1,0,1
33161_0,,,,2,2,1,3
C(C(C)(C(CC(CO)C)O)O)(O)=O,,,5,1,1,0,1
33163_0,,,,2,2,1,3
C(C(C(CC(CO)C)O)O)(O)=O,,,5,1,1,0,1
33165_0,,,,2,2,1,3
C(C(C)(C(CC(CO)C)O)O)=O,,,5,1,1,0,1
33167_0,,,,2,2,1,3
C(C(C(CC(C)CCO)O)(O)O)=O,,,5,1,1,0,1
33168_0,,,,2,2,1,3
33170_0,,,,2,2,1,3
C(C(C)(C(CC(C)CCO)O)O)=O,,,5,1,1,0,1
33172_0,,,,2,2,1,3
C(C(C(CC(C)C(C)O)O)(O)O)=O,,,5,1,1,0,1
33174_0,,,,2,2,1,3
C(C(C(CC(C)C(C)O)O)O)(O)=O,,,5,1,1,0,1
33176_0,,,,2,2,1,3
C(C(C)(C(CC(C)C(C)O)O)O)=O,,,5,1,1,0,1
33178_0,,,,2,2,1,3
C(C(C(C)O)(C(C)CC=O)O)=O,,,5,1,2,0,2
33179_0,,,,2,2,1,3
33180_0,,,,2,2,1,3
33182_0,,,,2,2,1,3
C(CC(C)C(C=O)(C(C=O)O)O)=O,,,5,1,2,0,2
33184_0,,,,2,2,1,3
C(C(C(CO)O)(C(C)CC=O)O)=O,,,5,1,2,0,2
33186_0,,,,2,2,1,3
C(C(C(C)O)(CC(C)CC=O)O)=O,,,5,1,2,0,2
33187_0,,,,2,2,1,3
33189_0,,,,2,2,1,3
C(C(CO)(CC(C)CC=O)O)=O,,,5,1,2,0,2
33191_0,,,,2,2,1,3
C(CC(C)CC(C(C=O)(O)O)O)=O,,,5,1,1,0,1
33192_0,,,,2,2,1,3
33194_0,,,,2,2,1,3
C(C(C)(C(CC(C)CC=O)O)O)=O,,,5,1,2,0,2
33195_0,,,,2,2,1,3
33196_0,,,,2,2,1,3
33197_0,,,,2,2,1,3
33198_0,,,,2,2,1,3
33199_0,,,,2,2,1,3
33201_0,,,,2,2,1,3
C(C(CC[CH]C(O)=O)(C(C)O)O)=O,,,5,1,2,0,2
33202_0,,,,2,2,1,3
33204_0,,,,2,2,1,3
C(C(CO)(CC[CH]C(O)=O)O)=O,,,5,1,2,0,2
33206_0,,,,2,2,1,3
C(C(C(C)O)(CCCC(O)=O)O)=O,,,5,1,2,0,2
33207_0,,,,2,2,1,3
33209_0,,,,2,2,1,3
C(C(CO)(CCCC(O)=O)O)=O,,,5,1,2,0,2
33211_0,,,,2,2,1,3
C(C)(C(CO)(C[C](C(O)=O)O)O)=O,,,5,1,2,0,2
33213_0,,,,2,2,1,3
C(C(C([C](C(O)=O)O)(C)O)(O)O)=O,,,5,1,1,0,1
33214_0,,,,2,2,1,3
33216_0,,,,2,2,1,3
C(C(C)(C([C](C(O)=O)O)(C)O)O)=O,,,5,1,2,0,2
33218_0,,,,2,2,1,3
C(C(CO)(CC(CC(C)O)O)O)=O,,,5,1,1,0,1
33219_0,,,,2,2,1,3
33220_0,,,,2,2,1,3
33222_0,,,,2,2,1,3
C(C(CC(C(CO)=O)(CO)O)O)=O,,,5,1,2,0,2
33224_0,,,,2,2,1,3
C(C(CO)(CC(C=O)(CO)O)O)=O,,,5,1,1,0,1
33226_0,,,,2,2,1,3
C(C(C)(CC(C=O)(C(C)O)O)O)=O,,,5,1,1,0,1
33228_0,,,,2,2,1,3
C(C(C=O)(CC(C=O)(C)O)O)(O)=O,,,5,1,1,0,1
33230_0,,,,2,2,1,3
C(C(CO)(CC(C=O)(C)O)O)=O,,,5,1,1,0,1
33232_0,,,,2,2,1,3
C(C(CC(C(C)=O)O)(C(C)O)O)=O,,,5,1,1,0,1
33234_0,,,,2,2,1,3
C(C(C=O)(CC(C(C)=O)O)O)(O)=O,,,5,1,1,0,1
33236_0,,,,2,2,1,3
C(C(CO)(CC(C(C)=O)O)O)=O,,,5,1,1,0,1
33237_0,,,,2,2,1,3
33238_0,,,,2,2,1,3
33240_0,,,,2,2,1,3
C(C(CC(C(C)=O)(CO)O)O)=O,,,5,1,2,0,2
33242_0,,,,2,2,1,3
C(C(C(C(O)O)O)(CCO)O)=O,,,5,1,1,0,1
33244_0,,,,2,2,1,3
C(C(C(C)O)(CCO)O)=O,,,5,1,1,0,1
33246_0,,,,2,2,1,3
C(C(C=O)(CCO)O)(O)=O,,,5,1,1,0,1
33248_0,,,,2,2,1,3
C(C(CCO)(C(CC(C)O)O)O)=O,,,5,1,1,0,1
33250_0,,,,2,2,1,3
C(C(C(CC(O)=O)O)(CCO)O)=O,,,5,1,1,0,1
33251_0,,,,2,2,1,3
33252_0,,,,2,2,1,3
33253_0,,,,2,2,1,3
33254_0,,,,2,2,1,3
33255_0,,,,2,2,1,3
33257_0,,,,2,2,1,3
C(C(CCO)(C(CCO)O)O)=O,,,5,1,1,0,1
33258_0,,,,2,2,1,3
33259_0,,,,2,2,1,3
33260_0,,,,2,2,1,3
33261_0,,,,2,2,1,3
33263_0,,,,2,2,1,3
C(C(CCO)(C(C=CC)O)O)=O,,,5,1,1,0,1
33265_0,,,,2,2,1,3
C(C(C(CC=C)O)(CCO)O)=O,,,5,1,1,0,1
33267_0,,,,2,2,1,3
C(C(CCO)(C(C(CO)O)O)O)=O,,,5,1,3,0,3
33268_0,,,,2,2,1,3
33269_0,,,,2,2,1,3
33270_0,,,,2,2,1,3
33271_0,,,,2,2,1,3
33273_0,,,,2,2,1,3
C(C(C(C(CCO)O)O)(O)O)=O,,,5,1,1,0,1
33275_0,,,,2,2,1,3
C(C(C)(C(C(CCO)O)O)O)(O)=O,,,5,1,1,0,1
33276_0,,,,2,2,1,3
33278_0,,,,2,2,1,3
C(C(C)(C(C(CCO)O)O)O)=O,,,5,1,1,0,1
33280_0,,,,2,2,1,3
C(C(C)(CC(C=O)(CO)O)O)(O)=O,,,5,1,1,0,1
33282_0,,,,2,2,1,3
C(C(C(C(O)O)O)(O)O)=O,,,5,1,1,0,1
33284_0,,,,2,2,1,3
C(C(C(C)O)(C(C=O)(O)O)O)(O)=O,,,5,1,1,0,1
33286_0,,,,2,2,1,3
C(C(C(C)O)(O)O)=O,,,5,1,1,0,1
33288_0,,,,2,2,1,3
C(C(C=O)(O)O)(O)=O,,,5,1,1,0,1
33290_0,,,,2,2,1,3
C(C(C(CC(C)O)O)(O)O)=O,,,5,1,1,0,1
33292_0,,,,2,2,1,3
C(CC(C(C=O)(O)O)O)(O)=O,,,5,1,1,0,1
33294_0,,,,2,2,1,3
C(C(C(C(CO)=O)O)(O)O)=O,,,5,1,1,0,1
33296_0,,,,2,2,1,3
C(C(CO)(C(C=O)(O)O)O)=O,,,5,1,1,0,1
33298_0,,,,2,2,1,3
C(C(C)(C(C=O)(O)O)O)=O,,,5,1,1,0,1
33300_0,,,,2,2,1,3
C(C(C(C(C)=O)O)(O)O)=O,,,5,1,1,0,1
33302_0,,,,2,2,1,3
C(C(CO)(O)O)=O,,,5,1,1,0,1
33304_0,,,,2,2,1,3
C(C(CO)(C(C=O)(O)O)O)(O)=O,,,5,1,1,0,1
33306_0,,,,2,2,1,3
C(C(C(C(CO)C(C)O)O)(O)O)=O,,,5,1,1,0,1
33308_0,,,,2,2,1,3
C(C(CO)C(C(C=O)(O)O)O)(O)=O,,,5,1,1,0,1
33310_0,,,,2,2,1,3
C(C(C(C=O)(O)O)O)(C(CO)O)=O,,,5,1,1,0,1
33312_0,,,,2,2,1,3
C(C(C(CO)O)(C(C=O)(O)O)O)=O,,,5,1,1,0,1
33314_0,,,,2,2,1,3
C(C(C)(CC(C(C=O)(O)O)O)O)=O,,,5,1,1,0,1
33316_0,,,,2,2,1,3
C(CC(C)(C(C(C=O)(O)O)O)O)=O,,,5,1,1,0,1
33318_0,,,,2,2,1,3
C(C(C(CC(C(C)=O)O)O)(O)O)=O,,,5,1,1,0,1
33320_0,,,,2,2,1,3
C(CC(C(C)(C(C=O)(O)O)O)O)=O,,,5,1,1,0,1
33322_0,,,,2,2,1,3
C(C(CCO)(C(C=O)(O)O)O)=O,,,5,1,1,0,1
33324_0,,,,2,2,1,3
C(C(C(C=O)(O)O)O)(CCO)=O,,,5,1,1,0,1
33326_0,,,,2,2,1,3
C(C(CC(C)O)(C(C=O)(O)O)O)=O,,,5,1,1,0,1
33328_0,,,,2,2,1,3
C(C(C(C=O)(O)O)O)(CC(C)O)=O,,,5,1,1,0,1
33330_0,,,,2,2,1,3
C(CC(C=O)(C(C=O)(O)O)O)(O)=O,,,5,1,1,0,1
33332_0,,,,2,2,1,3
C(CC(C(C(C=O)(O)O)O)=O)(O)=O,,,5,1,1,0,1
33334_0,,,,2,2,1,3
C(C(C(CCO)O)(O)O)=O,,,5,1,1,0,1
33336_0,,,,2,2,1,3
C(C(CCO)(C(C=O)(O)O)O)(O)=O,,,5,1,1,0,1
33338_0,,,,2,2,1,3
C(CC(C(C)=O)(C(C=O)(O)O)O)=O,,,5,1,1,0,1
33340_0,,,,2,2,1,3
C(C(C)(C(C=O)(O)O)O)(CC=O)=O,,,5,1,1,0,1
33342_0,,,,2,2,1,3
C(C(C(CC(C(C)=O)=O)O)(O)O)=O,,,5,1,1,0,1
33344_0,,,,2,2,1,3
C(C)(C(C(C)O)(C(C=O)(O)O)O)=O,,,5,1,1,0,1
33346_0,,,,2,2,1,3
C(C(C)(C(C=O)(O)O)O)(C(C)O)=O,,,5,1,1,0,1
33348_0,,,,2,2,1,3
C(C(C(C)=O)(C(C=O)(O)O)O)(O)=O,,,5,1,1,0,1
33350_0,,,,2,2,1,3
C(C(C(C(C(O)=O)=O)(C)O)(O)O)=O,,,5,1,1,0,1
33352_0,,,,2,2,1,3
C(C(C(C=O)(O)O)O)=O,,,5,1,1,0,1
33354_0,,,,2,2,1,3
C(C(C(C(C=O)(O)O)O)O)=O,,,5,1,1,0,1
33356_0,,,,2,2,1,3
C(C(C(C(C=O)(O)O)O)O)(O)=O,,,5,1,1,0,1
33358_0,,,,2,2,1,3
C(C(C(CO)(CO)O)(O)O)=O,,,5,1,1,0,1
33360_0,,,,2,2,1,3
C(C(C(CO)(C)O)(O)O)=O,,,5,1,1,0,1
33362_0,,,,2,2,1,3
C(C(C)(C(C(C=O)(O)O)O)O)(O)=O,,,5,1,1,0,1
33364_0,,,,2,2,1,3
C(C(C)C(C)(C(C=O)(O)O)O)(O)=O,,,5,1,1,0,1
33366_0,,,,2,2,1,3
C(C(C(C=CC)O)(O)O)=O,,,5,1,1,0,1
33368_0,,,,2,2,1,3
C(C(C(CC=C)O)(O)O)=O,,,5,1,1,0,1
33370_0,,,,2,2,1,3
C(C(C=CC)(C(C=O)(O)O)O)(O)=O,,,5,1,1,0,1
33372_0,,,,2,2,1,3
C(C(CC=C)(C(C=O)(O)O)O)(O)=O,,,5,1,1,0,1
33374_0,,,,2,2,1,3
C(C(C(CC(C(O)=O)=C)O)(O)O)=O,,,5,1,1,0,1
33376_0,,,,2,2,1,3
C(C(C(C=C(C(O)=O)C)O)(O)O)=O,,,5,1,1,0,1
33378_0,,,,2,2,1,3
C(C(C(C(CO)O)O)(O)O)=O,,,5,1,1,0,1
33380_0,,,,2,2,1,3
C(C(C(CO)O)(O)O)=O,,,5,1,1,0,1
33382_0,,,,2,2,1,3
C1(C(CC(C)O1)(C(C=O)(O)O)O)=O,,,5,1,1,0,1
33384_0,,,,2,2,1,3
C1(CC(C(O1)=O)(C(C=O)(O)O)O)=O,,,5,1,1,0,1
33386_0,,,,2,2,1,3
C(C(C(CC[CH]C(O)=O)O)(O)O)=O,,,5,1,1,0,1
33388_0,,,,2,2,1,3
C(CCCC(C(C=O)(O)O)O)(O)=O,,,5,1,1,0,1
33390_0,,,,2,2,1,3
C(C(C(C(C)O)O)(O)O)=O,,,5,1,1,0,1
33392_0,,,,2,2,1,3
C(C(C(C=O)(O)O)O)(O)=O,,,5,1,1,0,1
33394_0,,,,2,2,1,3
C(C(C)(C(C=O)(O)O)O)(O)=O,,,5,1,1,0,1
33396_0,,,,2,2,1,3
C(C(C(C)(C(C(O)O)O)O)=O)(O)=O,,,5,1,1,0,1
33398_0,,,,2,2,1,3
C(C(C)(C(C(O)O)O)O)(O)=O,,,5,1,1,0,1
33400_0,,,,2,2,1,3
C(C(C(C(O)O)O)O)(O)=O,,,5,1,1,0,1
33402_0,,,,2,2,1,3
C(C)(C(C(C(O)O)O)(CC=O)O)=O,,,5,1,1,0,1
33404_0,,,,2,2,1,3
C(C(C)=O)(C(C)(C(C(O)O)O)O)=O,,,5,1,1,0,1
33406_0,,,,2,2,1,3
C(C(C)(C(C(O)O)O)O)=O,,,5,1,1,0,1
33408_0,,,,2,2,1,3
C(C(C(CO)(CC(C)O)O)=O)(O)=O,,,5,1,1,0,1
33409_0,,,,2,2,1,3
33411_0,,,,2,2,1,3
C(C(C(C)(C(C)O)O)=O)(O)=O,,,5,1,2,0,2
33412_0,,,,2,2,1,3
33413_0,,,,2,2,1,3
33414_0,,,,2,2,1,3
33415_0,,,,2,2,1,3
33417_0,,,,2,2,1,3
C(C(C(C)(C(CCO)O)O)=O)(O)=O,,,5,1,1,0,1
33418_0,,,,2,2,1,3
33419_0,,,,2,2,1,3
33421_0,,,,2,2,1,3
C(C)=CC(C(C(C(O)=O)=O)(C)O)O,,,5,1,1,0,1
33423_0,,,,2,2,1,3
C=CCC(C(C(C(O)=O)=O)(C)O)O,,,5,1,1,0,1
33424_0,,,,2,2,1,3
33426_0,,,,2,2,1,3
C(C(C(C)(C(C(C)O)O)O)=O)(O)=O,,,5,1,1,0,1
33427_0,,,,2,2,1,3
33428_0,,,,2,2,1,3
33429_0,,,,2,2,1,3
33430_0,,,,2,2,1,3
33431_0,,,,2,1,1,2
33432_0,,,,2,1,1,2
33433_0,,,,2,1,1,2
33434_0,,,,2,1,1,2
33435_0,,,,2,1,1,2
33435_1,,,,2,1,1,2
33436_0,,,,2,1,1,2
33436_1,,,,2,1,1,2
33437_0,,,,2,1,2,3
33438_0,,,,2,1,2,3
33439_0,,,,2,1,2,3
33440_0,,,,2,1,2,3
33441_0,,,,2,1,2,3
33442_0,,,,2,1,2,3
33443_0,,,,2,1,2,3
33444_0,,,,2,1,2,3
33445_0,,,,2,1,2,3
33446_0,,,,2,1,2,3
33447_0,,,,2,1,2,3
33448_0,,,,2,1,2,3
33449_0,,,,2,1,2,3
33450_0,,,,2,1,2,3
33451_0,,,,2,1,2,3
33452_0,,,,2,1,2,3
33453_0,,,,2,1,2,3
33454_0,,,,2,1,2,3
33455_0,,,,2,1,2,3
33456_0,,,,2,1,2,3
33457_0,,,,2,1,2,3
33457_1,,,,2,1,2,3
33458_0,,,,2,1,2,3
33458_1,,,,2,1,2,3
33459_0,,,,2,1,2,3
33460_0,,,,2,1,2,3
33462_0,,,,2,1,2,3
C(CC(C)=O)=O,,,5,1,5,0,5
33463_0,,,,2,1,2,3
33464_0,,,,2,1,2,3
33464_1,,,,2,1,2,3
33465_0,,,,2,1,2,3
33465_1,,,,2,1,2,3
33466_0,,,,2,1,2,3
33466_1,,,,2,1,2,3
33467_0,,,,2,1,2,3
33467_1,,,,2,1,2,3
33468_0,,,,2,1,2,3
33469_0,,,,2,1,2,3
33470_0,,,,2,1,2,3
33471_0,,,,2,1,2,3
33472_0,,,,2,1,2,3
33473_0,,,,2,1,2,3
33474_0,,,,2,1,2,3
33475_0,,,,2,1,2,3
33476_0,,,,2,1,2,3
33477_0,,,,2,1,2,3
33478_0,,,,2,1,2,3
33479_0,,,,2,1,2,3
33480_0,,,,2,1,2,3
33481_0,,,,2,1,2,3
33482_0,,,,2,1,2,3
33483_0,,,,2,1,2,3
33484_0,,,,2,1,2,3
33485_0,,,,2,1,2,3
33486_0,,,,2,1,2,3
33487_0,,,,2,1,2,3
33488_0,,,,2,1,2,3
33488_1,,,,2,1,2,3
33489_0,,,,2,1,2,3
33489_1,,,,2,1,2,3
33490_0,,,,2,1,2,3
33490_1,,,,2,1,2,3
33491_0,,,,2,1,2,3
33491_1,,,,2,1,2,3
33492_0,,,,2,1,2,3
33493_0,,,,2,1,2,3
33494_0,,,,2,1,2,3
33495_0,,,,2,1,2,3
33496_0,,,,2,1,2,3
33497_0,,,,2,1,2,3
33498_0,,,,2,1,2,3
33499_0,,,,2,1,2,3
33500_0,,,,2,1,2,3
33501_0,,,,2,1,2,3
33502_0,,,,2,1,2,3
33503_0,,,,2,1,2,3
33504_0,,,,2,1,2,3
33505_0,,,,2,1,2,3
33506_0,,,,2,1,2,3
33507_0,,,,2,1,2,3
33508_0,,,,2,1,2,3
33509_0,,,,2,1,2,3
33510_0,,,,2,1,2,3
33511_0,,,,2,1,2,3
33512_0,,,,2,1,2,3
33513_0,,,,2,1,2,3
33514_0,,,,2,1,2,3
33515_0,,,,2,1,2,3
33516_0,,,,2,1,2,3
33517_0,,,,2,1,2,3
33518_0,,,,2,1,2,3
33519_0,,,,2,1,2,3
33520_0,,,,2,1,2,3
33521_0,,,,2,1,2,3
33522_0,,,,2,1,2,3
33523_0,,,,2,1,2,3
33524_0,,,,2,1,2,3
33525_0,,,,2,1,2,3
33526_0,,,,2,1,2,3
33527_0,,,,2,1,2,3
33528_0,,,,2,1,2,3
33528_1,,,,2,1,2,3
33529_0,,,,2,1,2,3
33529_1,,,,2,1,2,3
33530_0,,,,2,1,2,3
33530_1,,,,2,1,2,3
33531_0,,,,2,1,2,3
33531_1,,,,2,1,2,3
33532_0,,,,2,1,2,3
33532_1,,,,2,1,2,3
33533_0,,,,2,1,2,3
33534_0,,,,2,1,2,3
33535_0,,,,2,1,2,3
33536_0,,,,2,1,2,3
33537_0,,,,2,1,2,3
33538_0,,,,2,1,2,3
33538_1,,,,2,1,2,3
33539_0,,,,2,1,2,3
33539_1,,,,2,1,2,3
33540_0,,,,2,1,2,3
33540_1,,,,2,1,2,3
33541_0,,,,2,1,2,3
33542_0,,,,2,1,2,3
33543_0,,,,2,1,2,3
33544_0,,,,2,1,2,3
33545_0,,,,2,1,2,3
33545_1,,,,2,1,2,3
33546_0,,,,2,1,2,3
33546_1,,,,2,1,2,3
33547_0,,,,2,1,2,3
33548_0,,,,2,1,2,3
33549_0,,,,2,1,2,3
33550_0,,,,2,1,2,3
33551_0,,,,2,1,2,3
33552_0,,,,2,1,2,3
33553_0,,,,2,1,2,3
33554_0,,,,2,1,2,3
33555_0,,,,2,1,2,3
33556_0,,,,2,1,2,3
33557_0,,,,2,1,2,3
33558_0,,,,2,1,2,3
33559_0,,,,2,1,2,3
33560_0,,,,2,1,2,3
33561_0,,,,2,1,2,3
33562_0,,,,2,1,2,3
33563_0,,,,2,1,2,3
33564_0,,,,2,1,2,3
33565_0,,,,2,1,2,3
33566_0,,,,2,1,2,3
33567_0,,,,2,1,2,3
33568_0,,,,2,1,2,3
33569_0,,,,2,1,2,3
33570_0,,,,2,1,2,3
33571_0,,,,2,1,2,3
33571_1,,,,2,1,2,3
33572_0,,,,2,1,2,3
33572_1,,,,2,1,2,3
33573_0,,,,2,1,2,3
33573_1,,,,2,1,2,3
33574_0,,,,2,1,2,3
33575_0,,,,2,1,2,3
33576_0,,,,2,1,2,3
33577_0,,,,2,1,2,3
33578_0,,,,2,1,2,3
33579_0,,,,2,1,2,3
33580_0,,,,2,1,2,3
33581_0,,,,2,1,2,3
33582_0,,,,2,1,2,3
33583_0,,,,2,1,2,3
33584_0,,,,2,1,2,3
33585_0,,,,2,1,2,3
33586_0,,,,2,1,2,3
33587_0,,,,2,1,2,3
33588_0,,,,2,1,2,3
33589_0,,,,2,1,2,3
33590_0,,,,2,1,2,3
33591_0,,,,2,1,2,3
33592_0,,,,2,1,2,3
33592_1,,,,2,1,2,3
33593_0,,,,2,1,2,3
33593_1,,,,2,1,2,3
33594_0,,,,2,1,2,3
33594_1,,,,2,1,2,3
33595_0,,,,2,1,2,3
33595_1,,,,2,1,2,3
33596_0,,,,2,1,2,3
33596_1,,,,2,1,2,3
33597_0,,,,2,1,2,3
33597_1,,,,2,1,2,3
33598_0,,,,2,1,2,3
33598_1,,,,2,1,2,3
33599_0,,,,2,1,2,3
33599_1,,,,2,1,2,3
33600_0,,,,2,1,2,3
33600_1,,,,2,1,2,3
33601_0,,,,2,1,2,3
33601_1,,,,2,1,2,3
33602_0,,,,2,1,2,3
33602_1,,,,2,1,2,3
33603_0,,,,2,1,2,3
33603_1,,,,2,1,2,3
33604_0,,,,2,1,2,3
33604_1,,,,2,1,2,3
33605_0,,,,2,1,2,3
33605_1,,,,2,1,2,3
33606_0,,,,2,1,2,3
33606_1,,,,2,1,2,3
33607_0,,,,2,1,2,3
33607_1,,,,2,1,2,3
33608_0,,,,2,1,2,3
33608_1,,,,2,1,2,3
33609_0,,,,2,1,2,3
33609_1,,,,2,1,2,3
33610_0,,,,2,1,2,3
33610_1,,,,2,1,2,3
33611_0,,,,2,1,2,3
33611_1,,,,2,1,2,3
33612_0,,,,2,1,2,3
33612_1,,,,2,1,2,3
33613_0,,,,2,1,2,3
33613_1,,,,2,1,2,3
33614_0,,,,2,1,2,3
33614_1,,,,2,1,2,3
33615_0,,,,2,1,2,3
33615_1,,,,2,1,2,3
33616_0,,,,2,1,2,3
33616_1,,,,2,1,2,3
33617_0,,,,2,1,2,3
33617_1,,,,2,1,2,3
33618_0,,,,2,1,2,3
33618_1,,,,2,1,2,3
33619_0,,,,2,1,2,3
33619_1,,,,2,1,2,3
33620_0,,,,2,1,2,3
33620_1,,,,2,1,2,3
33621_0,,,,2,1,2,3
33621_1,,,,2,1,2,3
33622_0,,,,2,1,2,3
33622_1,,,,2,1,2,3
33623_0,,,,2,1,2,3
33624_0,,,,2,1,2,3
33625_0,,,,2,1,2,3
33626_0,,,,2,1,2,3
33627_0,,,,2,1,2,3
33627_1,,,,2,1,2,3
33628_0,,,,2,1,2,3
33628_1,,,,2,1,2,3
33629_0,,,,2,1,2,3
33630_0,,,,2,1,2,3
33631_0,,,,2,1,2,3
33632_0,,,,2,1,2,3
33633_0,,,,2,1,2,3
33634_0,,,,2,1,2,3
33635_0,,,,2,1,2,3
33637_0,,,,2,1,1,2
C(CC(OCC(C=O)=O)O)(O)=O,,,5,1,2,0,2
33639_0,,,,2,1,1,2
C(OCC(C=O)(CC(O)=O)O)=O,,,5,1,1,0,1
33641_0,,,,2,1,1,2
C(CC(OCC(C(O)=O)=O)O)(O)=O,,,5,1,1,0,1
33643_0,,,,2,1,1,2
C(C(COC=O)(CC(O)=O)O)(O)=O,,,5,1,1,0,1
33645_0,,,,2,1,1,2
C(CC(O)OC(C(CO)=O)=O)(O)=O,,,5,1,1,0,1
33647_0,,,,2,1,1,2
C(C(CO)(CC(O)=O)O)(OC=O)=O,,,5,1,1,0,1
33649_0,,,,2,1,1,2
C(CC(O)OC(C(C)=O)=O)(O)=O,,,5,1,1,0,1
33651_0,,,,2,1,1,2
C(C(C)(CC(O)=O)O)(OC=O)=O,,,5,1,1,0,1
33653_0,,,,2,1,1,2
C(C(C=O)(O)OCC(C(O)=O)O)=O,,,5,1,2,0,2
33653_1,,,,2,1,1,2
33655_0,,,,2,1,2,3
C1(C(C(C(C=O)(O)O1)O)O)=O,,,5,1,3,0,3
33655_1,,,,2,1,2,3
33657_0,,,,2,1,1,2
C(C(C=O)(O)OC(C(CO)O)=O)=O,,,5,1,2,0,2
33657_1,,,,2,1,1,2
33659_0,,,,2,1,2,3
C(C1C(C(C(O)O1)=O)O)(O)=O,,,5,1,3,0,3
33659_1,,,,2,1,2,3
33661_0,,,,2,1,1,2
C(C(CO)OC(C(C=O)=O)O)(O)=O,,,5,1,2,0,2
33661_1,,,,2,1,1,2
33663_0,,,,2,1,1,2
C(C(COC(C=O)(CO)O)O)(O)=O,,,5,1,2,0,2
33663_1,,,,2,1,1,2
33664_0,,,,2,1,2,3
33664_1,,,,2,1,2,3
33666_0,,,,2,1,1,2
C(C(CO)O)(OC(C=O)(CO)O)=O,,,5,1,2,0,2
33666_1,,,,2,1,1,2
33668_0,,,,2,1,1,2
C(C(COC(C(CO)=O)O)O)(O)=O,,,5,1,2,0,2
33668_1,,,,2,1,1,2
33669_0,,,,2,1,2,3
33669_1,,,,2,1,2,3
33671_0,,,,2,1,1,2
C(C(CO)O)(OC(C(CO)=O)O)=O,,,5,1,2,0,2
33671_1,,,,2,1,1,2
33673_0,,,,2,1,1,2
C(C(COC(C(C)=O)O)O)(O)=O,,,5,1,2,0,2
33673_1,,,,2,1,1,2
33674_0,,,,2,1,2,3
33674_1,,,,2,1,2,3
33676_0,,,,2,1,1,2
C(C(CO)O)(OC(C(C)=O)O)=O,,,5,1,2,0,2
33676_1,,,,2,1,1,2
33678_0,,,,2,1,1,2
C(C(COC(C=O)(C)O)O)(O)=O,,,5,1,2,0,2
33678_1,,,,2,1,1,2
33679_0,,,,2,1,2,3
33679_1,,,,2,1,2,3
33681_0,,,,2,1,1,2
C(C(CO)O)(OC(C=O)(C)O)=O,,,5,1,2,0,2
33681_1,,,,2,1,1,2
33683_0,,,,2,1,1,2
C(OC(C)CC(CC(O)=O)O)=O,,,5,1,1,0,1
33685_0,,,,2,1,1,2
C(CC(O)OC(C)CC=O)(O)=O,,,5,1,1,0,1
33687_0,,,,2,1,1,2
C(OC(CC(CC(O)=O)O)=O)=O,,,5,1,1,0,1
33689_0,,,,2,1,1,2
C(CC=O)(OC(CC(O)=O)O)=O,,,5,1,1,0,1
33690_0,,,,2,1,1,2
33692_0,,,,2,1,1,2
C(OCC(C(CC(O)=O)O)=O)=O,,,5,1,1,0,1
33694_0,,,,2,1,1,2
C(C(COC(C(C=O)=O)O)O)(O)=O,,,5,1,2,0,2
33694_1,,,,2,1,1,2
33696_0,,,,2,1,2,3
C1(C(C(C(C(O)O1)=O)O)O)=O,,,5,1,3,0,3
33696_1,,,,2,1,2,3
33698_0,,,,2,1,1,2
C(C(CO)O)(OC(C(C=O)=O)O)=O,,,5,1,2,0,2
33698_1,,,,2,1,1,2
33699_0,,,,2,1,2,3
33699_1,,,,2,1,2,3
33701_0,,,,2,1,1,2
C(CC=O)(OC(C(O)=O)CO)=O,,,5,1,2,0,2
33701_1,,,,2,1,1,2
33702_0,,,,2,1,2,3
33702_1,,,,2,1,2,3
33704_0,,,,2,1,1,2
C(C(CO)O)(OCC(C=O)=O)=O,,,5,1,4,0,4
33704_1,,,,2,1,1,2
33705_0,,,,2,1,2,3
33705_1,,,,2,1,2,3
33707_0,,,,2,1,1,2
C(C(CO)O)(OC(C=O)=O)=O,,,5,1,2,0,2
33707_1,,,,2,1,1,2
33709_0,,,,2,1,1,2
C(C(COC(C=O)=O)O)(O)=O,,,5,1,2,0,2
33709_1,,,,2,1,1,2
33710_0,,,,2,1,2,3
33710_1,,,,2,1,2,3
33712_0,,,,2,1,1,2
C(CC(C)OC(C(CO)O)=O)=O,,,5,1,2,0,2
33712_1,,,,2,1,1,2
33713_0,,,,2,1,2,3
33713_1,,,,2,1,2,3
33715_0,,,,2,1,1,2
C(CC=O)(OC(C(CO)O)=O)=O,,,5,1,2,0,2
33715_1,,,,2,1,1,2
33717_0,,,,2,1,1,2
C(CC=O)(OCC(C(O)=O)O)=O,,,5,1,2,0,2
33717_1,,,,2,1,1,2
33718_0,,,,2,1,2,3
33718_1,,,,2,1,2,3
33719_0,,,,2,1,1,2
33719_1,,,,2,1,1,2
33721_0,,,,2,1,1,2
C(C(CC(C(C=O)=O)O)O)(O)=O,,,5,1,3,0,3
33722_0,,,,2,1,1,2
33723_0,,,,2,1,2,3
33724_0,,,,2,1,2,3
33725_0,,,,2,1,2,3
33726_0,,,,2,1,2,3
33727_0,,,,2,1,2,3
33728_0,,,,2,1,2,3
33729_0,,,,2,1,2,3
33730_0,,,,2,1,2,3
33731_0,,,,2,1,2,3
33732_0,,,,2,1,2,3
33733_0,,,,2,1,2,3
33734_0,,,,2,1,2,3
33735_0,,,,2,1,2,3
33736_0,,,,2,1,2,3
33737_0,,,,2,1,2,3
33738_0,,,,2,1,2,3
33739_0,,,,2,1,2,3
33740_0,,,,2,1,2,3
33741_0,,,,2,1,2,3
33742_0,,,,2,1,2,3
33743_0,,,,2,1,2,3
33744_0,,,,2,1,2,3
33745_0,,,,2,1,2,3
33746_0,,,,2,1,2,3
33747_0,,,,2,1,2,3
33748_0,,,,2,1,2,3
33749_0,,,,2,1,2,3
33750_0,,,,2,1,2,3
33751_0,,,,2,1,2,3
33752_0,,,,2,1,2,3
33753_0,,,,2,1,2,3
33754_0,,,,2,1,2,3
33755_0,,,,2,1,2,3
33756_0,,,,2,1,2,3
33757_0,,,,2,1,2,3
33758_0,,,,2,1,2,3
33759_0,,,,2,1,2,3
33760_0,,,,2,1,2,3
33761_0,,,,2,1,2,3
33762_0,,,,2,1,2,3
33763_0,,,,2,1,2,3
33764_0,,,,2,1,2,3
33765_0,,,,2,1,2,3
33766_0,,,,2,1,2,3
33767_0,,,,2,1,2,3
33768_0,,,,2,1,2,3
33769_0,,,,2,1,2,3
33770_0,,,,2,1,2,3
33771_0,,,,2,1,2,3
33772_0,,,,2,1,2,3
33773_0,,,,2,1,2,3
33774_0,,,,2,1,2,3
33775_0,,,,2,1,2,3
33776_0,,,,2,1,2,3
33777_0,,,,2,1,2,3
33778_0,,,,2,1,2,3
33779_0,,,,2,1,2,3
33780_0,,,,2,1,2,3
33781_0,,,,2,1,2,3
33782_0,,,,2,1,2,3
33783_0,,,,2,1,2,3
33784_0,,,,2,1,2,3
33785_0,,,,2,1,2,3
33786_0,,,,2,1,2,3
33787_0,,,,2,1,2,3
33788_0,,,,2,1,2,3
33789_0,,,,2,1,2,3
33790_0,,,,2,1,2,3
33791_0,,,,2,1,2,3
33792_0,,,,2,1,2,3
33793_0,,,,2,1,2,3
33794_0,,,,2,1,2,3
33795_0,,,,2,1,2,3
33796_0,,,,2,1,2,3
33797_0,,,,2,1,2,3
33798_0,,,,2,1,2,3
33799_0,,,,2,1,2,3
33800_0,,,,2,1,2,3
33801_0,,,,2,1,2,3
33802_0,,,,2,1,2,3
33803_0,,,,2,1,2,3
33804_0,,,,2,1,2,3
33805_0,,,,2,1,2,3
33806_0,,,,2,1,2,3
33807_0,,,,2,1,2,3
33808_0,,,,2,1,2,3
33809_0,,,,2,1,2,3
33810_0,,,,2,1,2,3
33811_0,,,,2,1,2,3
33812_0,,,,2,1,2,3
33813_0,,,,2,1,2,3
33814_0,,,,2,1,2,3
33815_0,,,,2,1,2,3
33816_0,,,,2,1,2,3
33817_0,,,,2,1,2,3
33818_0,,,,2,1,2,3
33819_0,,,,2,1,2,3
33820_0,,,,2,1,2,3
33821_0,,,,2,1,2,3
33822_0,,,,2,1,2,3
33823_0,,,,2,1,2,3
33824_0,,,,2,1,2,3
33825_0,,,,2,1,2,3
33826_0,,,,2,1,2,3
33827_0,,,,2,1,2,3
33828_0,,,,2,1,2,3
33829_0,,,,2,1,2,3
33830_0,,,,2,1,2,3
33831_0,,,,2,1,2,3
33832_0,,,,2,1,2,3
33833_0,,,,2,1,2,3
33834_0,,,,2,1,2,3
33835_0,,,,2,1,2,3
33836_0,,,,2,1,2,3
33837_0,,,,2,1,2,3
33838_0,,,,2,1,2,3
33839_0,,,,2,1,2,3
33840_0,,,,2,1,2,3
33841_0,,,,2,1,2,3
33842_0,,,,2,1,2,3
33843_0,,,,2,1,2,3
33844_0,,,,2,1,2,3
33845_0,,,,2,1,2,3
33846_0,,,,2,1,2,3
33847_0,,,,2,1,2,3
33848_0,,,,2,1,2,3
33849_0,,,,2,1,2,3
33850_0,,,,2,1,2,3
33851_0,,,,2,1,2,3
33852_0,,,,2,1,2,3
33853_0,,,,2,1,2,3
33854_0,,,,2,1,2,3
33855_0,,,,2,1,2,3
33856_0,,,,2,1,2,3
33857_0,,,,2,1,2,3
33858_0,,,,2,1,2,3
33859_0,,,,2,1,2,3
33860_0,,,,2,1,2,3
33861_0,,,,2,1,2,3
33862_0,,,,2,1,2,3
33864_0,,,,2,1,2,3
C(CO)(OC(C(C)=O)=O)=O,,,5,1,2,0,2
33866_0,,,,2,1,1,2
C(C(C)O)(OC(C=O)=O)=O,,,5,1,1,0,1
33867_0,,,,2,1,1,2
33868_0,,,,2,1,2,3
33870_0,,,,2,1,2,3
C(C(C(C=O)=CC)O)(O)=O,,,5,1,2,0,2
33871_0,,,,2,1,2,3
33872_0,,,,2,1,2,3
33873_0,,,,2,1,2,3
33874_0,,,,2,1,2,3
33876_0,,,,2,1,1,2
C(CO)(OC(C(C=O)=C)=O)=O,,,5,1,2,0,2
33878_0,,,,2,1,2,3
C1(C(C(C(O1)=O)=C)O)=O,,,5,1,3,0,3
33880_0,,,,2,1,1,2
C(COC(C(C=O)=C)=O)(O)=O,,,5,1,2,0,2
33881_0,,,,2,1,2,3
33882_0,,,,2,1,2,3
33883_0,,,,2,1,2,3
33884_0,,,,2,1,2,3
33886_0,,,,2,1,1,2
C(C(C(C)=O)(O)OC(CO)=O)=O,,,5,1,1,0,1
33888_0,,,,2,1,1,2
C(CO)(OC(C(C=O)=O)(C)O)=O,,,5,1,1,0,1
33889_0,,,,2,1,1,2
33891_0,,,,2,1,1,2
C(CO)(OC(C=O)=O)=O,,,5,1,1,0,1
33893_0,,,,2,1,1,2
C(C(C=O)C)(OC(C(O)=O)O)=O,,,5,1,1,0,1
33894_0,,,,2,1,2,3
33895_0,,,,2,1,2,3
33896_0,,,,2,1,2,3
33898_0,,,,2,1,2,3
C1(C(C(C(O)O1)C(C)O)O)=O,,,5,1,2,0,2
33900_0,,,,2,1,2,3
C(C1C(O)OC(C1O)=O)(O)=O,,,5,1,2,0,2
33902_0,,,,2,1,1,2
C(C(C=O)(COC(C(O)=O)O)O)=O,,,5,1,1,0,1
33904_0,,,,2,1,1,2
C(C(C=O)(O)OC(C(C)O)=O)=O,,,5,1,1,0,1
33906_0,,,,2,1,1,2
C(C(C)OC(C(C=O)=O)O)(O)=O,,,5,1,1,0,1
33908_0,,,,2,1,2,3
C1(C(CC(C=O)(O)O1)O)=O,,,5,1,2,0,2
33910_0,,,,2,1,2,3
C(C1CC(C(O)O1)=O)(O)=O,,,5,1,2,0,2
33912_0,,,,2,1,2,3
C1(C(CC(O)O1)O)=O,,,5,1,2,0,2
33914_0,,,,2,1,2,3
C1(C(CC(C(O)=O)(O)O1)O)=O,,,5,1,2,0,2
33916_0,,,,2,1,1,2
C(C(C=O)(O)OC(C(C)O)=O)(O)=O,,,5,1,1,0,1
33918_0,,,,2,1,1,2
C(C(C=O)(C)O)(OC(C(O)=O)O)=O,,,5,1,1,0,1
33920_0,,,,2,1,1,2
C(COC(C(C=O)=O)(C)O)(O)=O,,,5,1,1,0,1
33922_0,,,,2,1,1,2
C(C(CO)(O)OC(CO)=O)=O,,,5,1,1,0,1
33924_0,,,,2,1,1,2
C(C(C)O)(OC(C=O)(CO)O)=O,,,5,1,1,0,1
33926_0,,,,2,1,1,2
C(CO)(OC(C(CO)=O)O)=O,,,5,1,1,0,1
33928_0,,,,2,1,1,2
C(C(C)O)(OC(C(CO)=O)O)=O,,,5,1,1,0,1
33930_0,,,,2,1,1,2
C(CO)(OC(C(C)=O)O)=O,,,5,1,1,0,1
33932_0,,,,2,1,1,2
C(C(C)O)(OC(C(C)=O)O)=O,,,5,1,1,0,1
33934_0,,,,2,1,1,2
C(C(C)(O)OC(CO)=O)=O,,,5,1,1,0,1
33936_0,,,,2,1,1,2
C(C(C)O)(OC(C=O)(C)O)=O,,,5,1,1,0,1
33938_0,,,,2,1,1,2
C(C(CC(C)OC(C(O)=O)O)O)=O,,,5,1,1,0,1
33940_0,,,,2,1,1,2
C(CC(C=O)O)(OC(C(O)=O)O)=O,,,5,1,1,0,1
33942_0,,,,2,1,1,2
C(C(C(COC(C(O)=O)O)=O)O)=O,,,5,1,1,0,1
33944_0,,,,2,1,1,2
C(C(C)O)(OC(C(C=O)=O)O)=O,,,5,1,1,0,1
33946_0,,,,2,1,2,3
C1(C(CC(C(O)O1)=O)O)=O,,,5,1,2,0,2
33948_0,,,,2,1,1,2
C(C[CH]C(OC(C(O)=O)O)=O)=O,,,5,1,1,0,1
33950_0,,,,2,1,1,2
C(CCC=O)(OC(C(O)=O)O)=O,,,5,1,1,0,1
33952_0,,,,2,1,2,3
C(C1C(C)OC(C1O)=O)=O,,,5,1,2,0,2
33954_0,,,,2,1,2,3
C1(C(C=O)C(C(O1)=O)O)=O,,,5,1,3,0,3
33956_0,,,,2,1,2,3
C(C1CC(C(O1)=O)=O)(O)=O,,,5,1,2,0,2
33958_0,,,,2,1,1,2
C(C(C)OC(C(C=O)=O)=O)(O)=O,,,5,1,1,0,1
33960_0,,,,2,1,1,2
C(CC=O)(OCC(O)=O)=O,,,5,1,1,0,1
33962_0,,,,2,1,1,2
C(CC(OC(C(O)=O)C)=O)=O,,,5,1,1,0,1
33964_0,,,,2,1,1,2
C(CO)(OCC(C=O)=O)=O,,,5,1,2,0,2
33966_0,,,,2,1,1,2
C(C(C)O)(OCC(C=O)=O)=O,,,5,1,2,0,2
33968_0,,,,2,1,1,2
C(CO)(OC(C(CO)=O)=O)=O,,,5,1,1,0,1
33970_0,,,,2,1,1,2
C(CO)(OCC(C(O)=O)=O)=O,,,5,1,1,0,1
33971_0,,,,2,1,1,2
33973_0,,,,2,1,1,2
C(C1(C(OCC(O1)=O)=O)C)=O,,,5,1,1,0,1
33975_0,,,,2,1,1,2
C(C1C(OC(C(O1)=O)C)=O)=O,,,5,1,1,0,1
33976_0,,,,2,1,2,3
33977_0,,,,2,1,2,3
33979_0,,,,2,1,2,3
C1(C(CC(C(O1)=O)=O)O)=O,,,5,1,2,0,2
33981_0,,,,2,1,1,2
C(C(C)O)(OC(C(C=O)=O)=O)=O,,,5,1,1,0,1
33983_0,,,,2,1,1,2
C(CC(C)OC(CO)=O)=O,,,5,1,1,0,1
33985_0,,,,2,1,1,2
C(CC(C)OC(C(C)O)=O)=O,,,5,1,1,0,1
33987_0,,,,2,1,1,2
C(CC=O)(OC(CO)=O)=O,,,5,1,1,0,1
33989_0,,,,2,1,1,2
C(CC=O)(OC(C(C)O)=O)=O,,,5,1,1,0,1
33990_0,,,,2,1,1,2
33991_0,,,,2,1,1,2
33993_0,,,,2,1,1,2
C(C[CH]C(OCC(O)=O)=O)=O,,,5,1,1,0,1
33994_0,,,,2,1,2,3
33996_0,,,,2,1,1,2
C(CCC=O)(OCC(O)=O)=O,,,5,1,1,0,1
33997_0,,,,2,1,2,3
33999_0,,,,2,1,1,2
C(C[CH]C(OC(CO)=O)=O)=O,,,5,1,1,0,1
34001_0,,,,2,1,1,2
C(CCC=O)(OC(CO)=O)=O,,,5,1,1,0,1
34002_0,,,,2,1,2,3
34003_0,,,,2,1,2,3
34004_0,,,,2,1,2,3
34005_0,,,,2,1,2,3
34006_0,,,,2,1,2,3
34007_0,,,,2,1,2,3
34008_0,,,,2,1,2,3
34009_0,,,,2,1,2,3
34010_0,,,,2,1,2,3
34011_0,,,,2,1,2,3
34012_0,,,,2,1,2,3
34013_0,,,,2,1,2,3
34014_0,,,,2,1,2,3
34015_0,,,,2,1,2,3
34016_0,,,,2,1,2,3
34017_0,,,,2,1,2,3
34018_0,,,,2,1,2,3
34019_0,,,,2,1,2,3
34020_0,,,,2,1,2,3
34021_0,,,,2,1,2,3
34023_0,,,,2,1,2,3
C(C(C[C](C(O)=O)O)O)(O)=O,,,5,1,2,0,2
34024_0,,,,2,1,2,3
34025_0,,,,2,1,2,3
34026_0,,,,2,1,2,3
34027_0,,,,2,1,2,3
34028_0,,,,2,1,2,3
34029_0,,,,2,1,2,3
34031_0,,,,2,1,2,3
C1(C(C(C(C(C)O)C1)O)=O)=O,,,5,1,1,0,1
34032_0,,,,2,1,2,3
34034_0,,,,2,1,2,3
C(C1CC(C(C1O)=O)=O)(O)=O,,,5,1,2,0,2
34035_0,,,,2,1,2,3
34036_0,,,,2,1,2,3
34038_0,,,,2,1,2,3
C(C1C(C(C(C1O)=O)O)=O)=O,,,5,1,1,0,1
34039_0,,,,2,1,2,3
34041_0,,,,2,1,2,3
C(C1C(C(C(C1O)O)=O)=O)=O,,,5,1,1,0,1
34042_0,,,,2,1,2,3
34044_0,,,,2,1,2,3
C(C1C(C(C(C1)O)=O)=O)=O,,,5,1,1,0,1
34045_0,,,,2,1,2,3
34046_0,,,,2,1,2,3
34048_0,,,,2,1,2,3
C(C1C(C(C(C1O)=O)O)=O)(O)=O,,,5,1,1,0,1
34049_0,,,,2,1,2,3
34050_0,,,,2,1,2,3
34051_0,,,,2,1,2,3
34052_0,,,,2,1,2,3
34054_0,,,,2,1,2,3
C1(C(C(CC1)O)=O)=O,,,5,1,2,0,2
34056_0,,,,2,1,2,3
C(C1C(C(C(C1)O)=O)=O)(O)=O,,,5,1,2,0,2
34057_0,,,,2,1,2,3
34058_0,,,,2,1,2,3
34060_0,,,,2,1,2,3
C(C1C(C(C(C1)=O)O)=O)=O,,,5,1,1,0,1
34062_0,,,,2,1,2,3
C(C1C(C(C(C1)=O)O)=O)(O)=O,,,5,1,1,0,1
34063_0,,,,2,1,2,3
34064_0,,,,2,1,2,3
34066_0,,,,2,1,2,3
C(C(CCC(CC(C)O)O)=O)=O,,,5,1,2,0,2
34068_0,,,,2,1,2,3
C(CC(CC(CC(C)O)O)=O)=O,,,5,1,1,0,1
34070_0,,,,2,1,2,3
C(C(C(CC(C)O)O)CC=O)=O,,,5,1,1,0,1
34072_0,,,,2,1,2,3
C(C(C(C)=O)C(CC(C)O)O)=O,,,5,1,1,0,1
34074_0,,,,2,1,2,3
C(C(C)=O)(CC(CO)C(C)O)=O,,,5,1,1,0,1
34076_0,,,,2,1,2,3
C(C(CO)C(C)O)(CC(C)=O)=O,,,5,1,1,0,1
34078_0,,,,2,1,2,3
C(C(CC(CO)C(C)O)=O)=O,,,5,1,1,0,1
34080_0,,,,2,1,2,3
C(CC(C(CO)C(C)O)=O)=O,,,5,1,1,0,1
34082_0,,,,2,1,2,3
C(C(CC(C(C)O)C(C)O)=O)=O,,,5,1,1,0,1
34084_0,,,,2,1,2,3
C(CC(C(C(C)O)C(C)O)=O)=O,,,5,1,1,0,1
34085_0,,,,2,1,2,3
34087_0,,,,2,1,2,3
C(C(C(CC=O)=O)C(C)O)(O)=O,,,5,1,1,0,1
34089_0,,,,2,1,2,3
C(CC(CCC(C=O)=O)O)(O)=O,,,5,1,2,0,2
34091_0,,,,2,1,2,3
C(CC(CC(CC(O)=O)O)=O)=O,,,5,1,1,0,1
34093_0,,,,2,1,2,3
C(CC(C(C=O)CC=O)O)(O)=O,,,5,1,1,0,1
34095_0,,,,2,1,2,3
C(CC(C(C=O)C(C)=O)O)(O)=O,,,5,1,1,0,1
34097_0,,,,2,1,2,3
C(C(CO)CC(C(C)=O)=O)(O)=O,,,5,1,2,0,2
34099_0,,,,2,1,2,3
C(C(C(CC(C)=O)=O)CO)(O)=O,,,5,1,2,0,2
34100_0,,,,2,1,2,3
34102_0,,,,2,1,2,3
C(C(C(CC=O)=O)CO)(O)=O,,,5,1,1,0,1
34103_0,,,,2,1,2,3
34105_0,,,,2,1,2,3
C(C(C(O)=O)C(CC=O)=O)(O)=O,,,5,1,1,0,1
34106_0,,,,2,1,2,3
34107_0,,,,2,1,2,3
34109_0,,,,2,1,2,3
C(CO)(C(CCC(C=O)=O)O)=O,,,5,1,2,0,2
34111_0,,,,2,1,2,3
C(CC(CC(C(CO)=O)O)=O)=O,,,5,1,1,0,1
34112_0,,,,2,1,2,3
34113_0,,,,2,1,2,3
34115_0,,,,2,1,2,3
C(C(CO)C(C=O)O)(CC=O)=O,,,5,1,1,0,1
34116_0,,,,2,1,2,3
34118_0,,,,2,1,2,3
C(C(CO)CC=O)(CC=O)=O,,,5,1,1,0,1
34120_0,,,,2,1,2,3
C(CC(C=O)C(C(CO)=O)O)=O,,,5,1,1,0,1
34122_0,,,,2,1,2,3
C(C(C(C)=O)C(C(CO)=O)O)=O,,,5,1,1,0,1
34123_0,,,,2,1,2,3
34125_0,,,,2,1,2,3
C(CC(C(C(CC=O)O)=O)=O)=O,,,5,1,1,0,1
34127_0,,,,2,1,2,3
C(CC(C(C(CC=O)O)=O)O)=O,,,5,1,1,0,1
34128_0,,,,2,1,2,3
34129_0,,,,2,1,2,3
34131_0,,,,2,1,2,3
C(CC(C(C(CCO)=O)=O)O)=O,,,5,1,1,0,1
34132_0,,,,2,1,2,3
34133_0,,,,2,1,2,3
34134_0,,,,2,1,2,3
34135_0,,,,2,1,2,3
34136_0,,,,2,1,2,3
34138_0,,,,2,1,2,3
C(C(CO)(CCC(C=O)=O)O)=O,,,5,1,2,0,2
34140_0,,,,2,1,2,3
C(C(CO)(CC(CC=O)=O)O)=O,,,5,1,1,0,1
34141_0,,,,2,1,2,3
34142_0,,,,2,1,2,3
34144_0,,,,2,1,2,3
C(CC(CO)(CC(C=O)=O)O)=O,,,5,1,1,0,1
34145_0,,,,2,1,2,3
34146_0,,,,2,1,2,3
34148_0,,,,2,1,2,3
C(C(CO)CC=O)(C(C=O)O)=O,,,5,1,1,0,1
34149_0,,,,2,1,2,3
34151_0,,,,2,1,2,3
C(CC(C=O)C(C=O)(CO)O)=O,,,5,1,1,0,1
34153_0,,,,2,1,2,3
C(C(CO)(C(C=O)C(C)=O)O)=O,,,5,1,1,0,1
34154_0,,,,2,1,2,3
34155_0,,,,2,1,2,3
34156_0,,,,2,1,2,3
34157_0,,,,2,1,2,3
34158_0,,,,2,1,2,3
34159_0,,,,2,1,2,3
34160_0,,,,2,1,2,3
34161_0,,,,2,1,2,3
34163_0,,,,2,1,2,3
C(C(CO)O)(CC(C(C)=O)=O)=O,,,5,1,1,0,1
34164_0,,,,2,1,2,3
34165_0,,,,2,1,2,3
34167_0,,,,2,1,2,3
C(C)(CC(C(C(CO)O)=O)=O)=O,,,5,1,1,0,1
34168_0,,,,2,1,2,3
34169_0,,,,2,1,2,3
34170_0,,,,2,1,2,3
34171_0,,,,2,1,2,3
34172_0,,,,2,1,2,3
34173_0,,,,2,1,2,3
34174_0,,,,2,1,2,3
34175_0,,,,2,1,2,3
34177_0,,,,2,1,2,3
C(C(CO)C(C=O)C(CO)=O)=O,,,5,1,1,0,1
34178_0,,,,2,1,2,3
34179_0,,,,2,1,2,3
34181_0,,,,2,1,2,3
C(C(C(CO)=O)CC(CO)=O)=O,,,5,1,1,0,1
34182_0,,,,2,1,2,3
34183_0,,,,2,1,2,3
34184_0,,,,2,1,2,3
34185_0,,,,2,1,2,3
34186_0,,,,2,1,2,3
34187_0,,,,2,1,2,3
34189_0,,,,2,1,2,3
C(C(C=C)C(C=O)C(CO)=O)=O,,,5,1,1,0,1
34190_0,,,,2,1,2,3
34191_0,,,,2,1,2,3
34192_0,,,,2,1,2,3
34194_0,,,,2,1,2,3
C(C(C(CO)=O)C(C=O)O)=O,,,5,1,1,0,1
34195_0,,,,2,1,2,3
34196_0,,,,2,1,2,3
34198_0,,,,2,1,2,3
C(C(C(CO)=O)CC=O)=O,,,5,1,2,0,2
34199_0,,,,2,1,2,3
34200_0,,,,2,1,2,3
34202_0,,,,2,1,2,3
C(C(C(CO)=O)CC(C=O)=O)=O,,,5,1,2,0,2
34204_0,,,,2,1,2,3
C(C(C(C)O)O)(CC(C=O)=O)=O,,,5,1,1,0,1
34205_0,,,,2,1,2,3
34206_0,,,,2,1,2,3
34207_0,,,,2,1,2,3
34208_0,,,,2,1,2,3
34209_0,,,,2,1,2,3
34210_0,,,,2,1,2,3
34211_0,,,,2,1,2,3
34212_0,,,,2,1,2,3
34213_0,,,,2,1,2,3
34215_0,,,,2,1,2,3
C(C(C)O)(C(C=O)CC=O)=O,,,5,1,2,0,2
34217_0,,,,2,1,2,3
C(C(C(CC(C=O)=O)=O)O)(O)=O,,,5,1,2,0,2
34218_0,,,,2,1,2,3
34219_0,,,,2,1,2,3
34220_0,,,,2,1,2,3
34222_0,,,,2,1,2,3
C(C(C(C(O)=O)=O)CC=O)=O,,,5,1,2,0,2
34224_0,,,,2,1,2,3
C(C(C)CC(C=O)=O)(CC=O)=O,,,5,1,1,0,1
34226_0,,,,2,1,2,3
C(C(C)(CCC(C(C)=O)=O)O)=O,,,5,1,2,0,2
34228_0,,,,2,1,2,3
C(C(C)(CC(CC(C)=O)=O)O)=O,,,5,1,1,0,1
34230_0,,,,2,1,2,3
C(C(C)(CCC(C=O)=O)O)=O,,,5,1,2,0,2
34232_0,,,,2,1,2,3
C(C(C)(CC(CC=O)=O)O)=O,,,5,1,1,0,1
34234_0,,,,2,1,2,3
C(C(C)CC=O)(C(C=O)CO)=O,,,5,1,1,0,1
34236_0,,,,2,1,2,3
C(CO)(CC(C(C)CC=O)=O)=O,,,5,1,1,0,1
34238_0,,,,2,1,2,3
C(CC(C)(CC(C(C)=O)=O)O)=O,,,5,1,1,0,1
34240_0,,,,2,1,2,3
C(C)(CC(C(C)(CC=O)O)=O)=O,,,5,1,1,0,1
34242_0,,,,2,1,2,3
C(C)(C(C(C(C)CC=O)=O)O)=O,,,5,1,1,0,1
34244_0,,,,2,1,2,3
C(C(C)CC=O)(C(C=O)C=C)=O,,,5,1,1,0,1
34245_0,,,,2,1,2,3
34246_0,,,,2,1,2,3
34247_0,,,,2,1,2,3
34249_0,,,,2,1,2,3
C(C(C)CC=O)(CC=O)=O,,,5,1,2,0,2
34251_0,,,,2,1,2,3
C(C(C)CC=O)(CC(C=O)=O)=O,,,5,1,2,0,2
34253_0,,,,2,1,2,3
C(C(C)C(C=O)C(C=O)(C)O)=O,,,5,1,2,0,2
34255_0,,,,2,1,2,3
C(CC(C=O)C(C=O)(C)O)=O,,,5,1,1,0,1
34257_0,,,,2,1,2,3
C(C(C)(C(C=O)C(C)=O)O)=O,,,5,1,1,0,1
34259_0,,,,2,1,2,3
C(CC(C=O)C(C=O)(C)O)(C)=O,,,5,1,2,0,2
34261_0,,,,2,1,2,3
C(CC)(C(C=O)C(C=O)(C)O)=O,,,5,1,1,0,1
34263_0,,,,2,1,2,3
C(C)(C(CCC(C(C)=O)=O)O)=O,,,5,1,2,0,2
34265_0,,,,2,1,2,3
C(C)(CC(CC(C(C)=O)O)=O)=O,,,5,1,1,0,1
34267_0,,,,2,1,2,3
C(C)(C(CCC(C=O)=O)O)=O,,,5,1,2,0,2
34269_0,,,,2,1,2,3
C(CC(CC(C(C)=O)O)=O)=O,,,5,1,1,0,1
34271_0,,,,2,1,2,3
C(CC(C(C)C(C=O)CO)=O)=O,,,5,1,1,0,1
34273_0,,,,2,1,2,3
C(C(C)CC(CO)=O)(CC=O)=O,,,5,1,1,0,1
34275_0,,,,2,1,2,3
C(CC(C(C(C(C)=O)=O)C)O)=O,,,5,1,1,0,1
34277_0,,,,2,1,2,3
C(C(C)C(C(C)=O)O)(CC=O)=O,,,5,1,1,0,1
34279_0,,,,2,1,2,3
C(CC(C(C)C(C=O)C=C)=O)=O,,,5,1,1,0,1
34281_0,,,,2,1,2,3
C(CC(C(C(C=O)=O)C)O)=O,,,5,1,1,0,1
34283_0,,,,2,1,2,3
C(C(C)C(C=O)O)(CC=O)=O,,,5,1,1,0,1
34285_0,,,,2,1,2,3
C(C(C(C=O)C(C=O)C)O)(C)=O,,,5,1,2,0,2
34287_0,,,,2,1,2,3
C(CC(C=O)C(C(C)=O)O)=O,,,5,1,1,0,1
34289_0,,,,2,1,2,3
C(C(C(C)=O)C(C(C)=O)O)=O,,,5,1,1,0,1
34291_0,,,,2,1,2,3
C(C(CC(C)=O)C(C(C)=O)O)=O,,,5,1,2,0,2
34293_0,,,,2,1,2,3
C(CC)(C(C=O)C(C(C)=O)O)=O,,,5,1,1,0,1
34295_0,,,,2,1,2,3
C(CC(C(CC(C=O)C)=O)O)=O,,,5,1,1,0,1
34297_0,,,,2,1,2,3
C(CCC(C(CC=O)O)=O)=O,,,5,1,1,0,1
34298_0,,,,2,1,2,3
34300_0,,,,2,1,2,3
C(CC(C(CCC(C)=O)=O)O)=O,,,5,1,1,0,1
34302_0,,,,2,1,2,3
C(CC(C(CC(CC)=O)=O)O)=O,,,5,1,1,0,1
34304_0,,,,2,1,2,3
C(C(C(C(CO)=O)=O)CCO)=O,,,5,1,1,0,1
34306_0,,,,2,1,2,3
C(C(C(C(C)=O)=O)CCO)=O,,,5,1,1,0,1
34308_0,,,,2,1,2,3
C(C(C(C=O)=O)CCO)=O,,,5,1,1,0,1
34310_0,,,,2,1,2,3
C(C(C(C(C=O)=O)=O)CCO)=O,,,5,1,1,0,1
34312_0,,,,2,1,2,3
C(CCO)(CC(C(CO)=O)=O)=O,,,5,1,1,0,1
34313_0,,,,2,1,2,3
34315_0,,,,2,1,2,3
C(CCO)(CC(C(C)=O)=O)=O,,,5,1,1,0,1
34317_0,,,,2,1,2,3
C(C)(CC(C(CCO)=O)=O)=O,,,5,1,1,0,1
34318_0,,,,2,1,2,3
34319_0,,,,2,1,2,3
34321_0,,,,2,1,2,3
C(CC=O)(C(C(C=O)=O)CO)=O,,,5,1,1,0,1
34323_0,,,,2,1,2,3
C(C=O)(C(CO)CC(C=O)=O)=O,,,5,1,1,0,1
34325_0,,,,2,1,2,3
C(C(CO)C(C(C=O)=O)CO)=O,,,5,1,2,0,2
34327_0,,,,2,1,2,3
C(C(C)C(C(C=O)=O)CO)=O,,,5,1,2,0,2
34328_0,,,,2,1,2,3
34329_0,,,,2,1,2,3
34331_0,,,,2,1,2,3
C(CC(C(C=O)=O)CO)(CO)=O,,,5,1,2,0,2
34333_0,,,,2,1,2,3
C(CCO)(C(C(C=O)=O)CO)=O,,,5,1,2,0,2
34335_0,,,,2,1,2,3
C(CC(C(C=O)=O)CO)=O,,,5,1,1,0,1
34336_0,,,,2,1,2,3
34338_0,,,,2,1,2,3
C(CC(C(C=O)=O)CO)(C)=O,,,5,1,2,0,2
34340_0,,,,2,1,2,3
C(CC)(C(C(C=O)=O)CO)=O,,,5,1,1,0,1
34342_0,,,,2,1,2,3
C(C(C(C(C)=O)=O)CC(C)O)=O,,,5,1,1,0,1
34344_0,,,,2,1,2,3
C(C(C(C=O)=O)CC(C)O)=O,,,5,1,1,0,1
34346_0,,,,2,1,2,3
C(CC(C)O)(CC(C(C)=O)=O)=O,,,5,1,1,0,1
34348_0,,,,2,1,2,3
C(C)(CC(C(CC(C)O)=O)=O)=O,,,5,1,1,0,1
34349_0,,,,2,1,2,3
34350_0,,,,2,1,2,3
34352_0,,,,2,1,2,3
C(C(C)C(C(C=O)=O)C(C)O)=O,,,5,1,2,0,2
34354_0,,,,2,1,2,3
C(CC(C(C=O)=O)C(C)O)=O,,,5,1,1,0,1
34355_0,,,,2,1,2,3
34357_0,,,,2,1,2,3
C(CC(C(C=O)=O)C(C)O)(C)=O,,,5,1,2,0,2
34359_0,,,,2,1,2,3
C(CC)(C(C(C=O)=O)C(C)O)=O,,,5,1,1,0,1
34361_0,,,,2,1,2,3
C(C(C(C(C)=O)=O)CC(O)=O)=O,,,5,1,1,0,1
34363_0,,,,2,1,2,3
C(C(C(C=O)=O)CC(O)=O)=O,,,5,1,1,0,1
34365_0,,,,2,1,2,3
C(CC(O)=O)(CC(C(C)=O)=O)=O,,,5,1,2,0,2
34367_0,,,,2,1,2,3
C(CC(C(CC(C)=O)=O)=O)(O)=O,,,5,1,1,0,1
34368_0,,,,2,1,2,3
34369_0,,,,2,1,2,3
34371_0,,,,2,1,2,3
C(C(C)C(C(O)=O)C(C=O)=O)=O,,,5,1,1,0,1
34373_0,,,,2,1,2,3
C(C(C(C=O)=O)CC=O)(O)=O,,,5,1,1,0,1
34374_0,,,,2,1,2,3
34376_0,,,,2,1,2,3
C(C(C(C=O)=O)CC(C)=O)(O)=O,,,5,1,1,0,1
34378_0,,,,2,1,2,3
C(CC)(C(C(O)=O)C(C=O)=O)=O,,,5,1,1,0,1
34379_0,,,,2,1,2,3
34380_0,,,,2,1,2,3
34381_0,,,,2,1,2,3
34382_0,,,,2,1,2,3
34384_0,,,,2,1,2,3
C(C(C(CO)=O)CC=O)(O)=O,,,5,1,1,0,1
34385_0,,,,2,1,2,3
34386_0,,,,2,1,2,3
34388_0,,,,2,1,2,3
C(C(CO)=O)(CCCO)=O,,,5,1,2,0,2
34390_0,,,,2,1,2,3
C(CCO)(CC(CO)=O)=O,,,5,1,2,0,2
34392_0,,,,2,1,2,3
C(C(C)=O)(CCCO)=O,,,5,1,2,0,2
34394_0,,,,2,1,2,3
C(CCO)(CC(C)=O)=O,,,5,1,1,0,1
34396_0,,,,2,1,2,3
C(C(CCCO)=O)=O,,,5,1,3,0,3
34398_0,,,,2,1,2,3
C(CC(CCO)=O)=O,,,5,1,2,0,2
34400_0,,,,2,1,2,3
C(C(C(CCCO)=O)=O)=O,,,5,1,1,0,1
34401_0,,,,2,1,2,3
34403_0,,,,2,1,2,3
C(C(C(CCCO)=O)=O)(O)=O,,,5,1,1,0,1
34404_0,,,,2,1,2,3
34406_0,,,,2,1,2,3
C(C(CO)C(C(C)=O)C(C)=O)=O,,,5,1,1,0,1
34408_0,,,,2,1,2,3
C(C(C(CC=O)=O)CO)=O,,,5,1,1,0,1
34409_0,,,,2,1,2,3
34411_0,,,,2,1,2,3
C(C(C(CC(O)=O)=O)CO)=O,,,5,1,2,0,2
34412_0,,,,2,1,2,3
34414_0,,,,2,1,2,3
C(C(CO)C(C=O)CO)=O,,,5,1,2,0,2
34416_0,,,,2,1,2,3
C(C(C)C(C=O)CO)=O,,,5,1,2,0,2
34418_0,,,,2,1,2,3
C(C(C(C(C=O)CO)=O)C)(O)=O,,,5,1,1,0,1
34419_0,,,,2,1,2,3
34420_0,,,,2,1,2,3
34422_0,,,,2,1,2,3
C(C(CO)CC(CO)=O)=O,,,5,1,3,0,3
34424_0,,,,2,1,2,3
C(C(C(CCO)=O)CO)=O,,,5,1,2,0,2
34425_0,,,,2,1,2,3
34427_0,,,,2,1,2,3
C(C(C(C)=O)CO)=O,,,5,1,2,0,2
34429_0,,,,2,1,2,3
C(C(CO)CC(C)=O)=O,,,5,1,2,0,2
34431_0,,,,2,1,2,3
C(C(C(CC)=O)CO)=O,,,5,1,1,0,1
34432_0,,,,2,1,2,3
34433_0,,,,2,1,2,3
34435_0,,,,2,1,2,3
C(C(C(C=O)=O)CCO)(O)=O,,,5,1,1,0,1
34437_0,,,,2,1,2,3
C(C(C)C(C(C(O)=O)=O)CO)=O,,,5,1,2,0,2
34439_0,,,,2,1,2,3
C(CC(C(C(O)=O)=O)CO)=O,,,5,1,1,0,1
34440_0,,,,2,1,2,3
34442_0,,,,2,1,2,3
C(CC(C(C(O)=O)=O)CO)(C)=O,,,5,1,2,0,2
34444_0,,,,2,1,2,3
C(CC)(C(C(C(O)=O)=O)CO)=O,,,5,1,1,0,1
34445_0,,,,2,1,2,3
34446_0,,,,2,1,2,3
34447_0,,,,2,1,2,3
34449_0,,,,2,1,2,3
C(C(C)O)(C(C(O)=O)CC=O)=O,,,5,1,1,0,1
34451_0,,,,2,1,2,3
C(C(C(C(O)=O)=O)CC=O)(O)=O,,,5,1,2,0,2
34453_0,,,,2,1,2,3
C(CC(C(C)=O)C(C(C)=O)=O)=O,,,5,1,1,0,1
34455_0,,,,2,1,2,3
C(CC(C(C)=O)C(C=O)=O)=O,,,5,1,1,0,1
34457_0,,,,2,1,2,3
C(CC=O)(C(C(C(C)=O)=O)C)=O,,,5,1,1,0,1
34459_0,,,,2,1,2,3
C(CC=O)(C(C(C=O)=O)C)=O,,,5,1,1,0,1
34461_0,,,,2,1,2,3
C(C(CCC(C(C)=O)=O)=O)(C)=O,,,5,1,1,0,1
34463_0,,,,2,1,2,3
C(CC(C)=O)(CC(C(C)=O)=O)=O,,,5,1,1,0,1
34465_0,,,,2,1,2,3
C(C(CCC(C(C)=O)=O)=O)=O,,,5,1,1,0,1
34467_0,,,,2,1,2,3
C(CC=O)(CC(C(C)=O)=O)=O,,,5,1,1,0,1
34469_0,,,,2,1,2,3
C(C(C)C(C=O)C(C(C)=O)=O)=O,,,5,1,1,0,1
34471_0,,,,2,1,2,3
C(C(C(C(C)=O)=O)CC=O)=O,,,5,1,1,0,1
34473_0,,,,2,1,2,3
C(C(C(C)=O)C(C(C)=O)=O)=O,,,5,1,1,0,1
34475_0,,,,2,1,2,3
C(C(C(C(C)=O)=O)CC(C)=O)=O,,,5,1,1,0,1
34477_0,,,,2,1,2,3
C(CC)(C(C=O)C(C(C)=O)=O)=O,,,5,1,1,0,1
34479_0,,,,2,1,2,3
C(C(C)CC(C(CC=O)=O)=O)=O,,,5,1,1,0,1
34481_0,,,,2,1,2,3
C(CC(C(CCC=O)=O)=O)=O,,,5,1,1,0,1
34483_0,,,,2,1,2,3
C(CC(C(CC(C)=O)=O)=O)=O,,,5,1,1,0,1
34485_0,,,,2,1,2,3
C(CC(C(CCC(C)=O)=O)=O)=O,,,5,1,1,0,1
34487_0,,,,2,1,2,3
C(CC(C(CC(CC)=O)=O)=O)=O,,,5,1,1,0,1
34488_0,,,,2,1,2,3
34489_0,,,,2,1,2,3
34490_0,,,,2,1,2,3
34491_0,,,,2,1,2,3
34493_0,,,,2,1,2,3
C(C(C(C(CO)=O)C(C)=O)O)=O,,,5,1,1,0,1
34495_0,,,,2,1,2,3
C(CC(C(C)=O)C(CO)=O)=O,,,5,1,2,0,2
34496_0,,,,2,1,2,3
34498_0,,,,2,1,2,3
C(CC(C(C(C(C)O)=O)=O)=O)=O,,,5,1,1,0,1
34500_0,,,,2,1,2,3
C(CC(C(C(C(C)O)=O)=O)O)=O,,,5,1,1,0,1
34501_0,,,,2,1,2,3
34502_0,,,,2,1,2,3
34504_0,,,,2,1,2,3
C(C(C(C(C)O)=O)=O)(CCO)=O,,,5,1,1,0,1
34506_0,,,,2,1,2,3
C(C)(CC(C(C(C)O)=O)=O)=O,,,5,1,2,0,2
34508_0,,,,2,1,2,3
C(C(C(C(C)O)=O)=O)(CC)=O,,,5,1,1,0,1
34510_0,,,,2,1,2,3
C(CC(C(C(C)O)=O)=O)=O,,,5,1,1,0,1
34511_0,,,,2,1,2,3
34512_0,,,,2,1,2,3
34513_0,,,,2,1,2,3
34514_0,,,,2,1,2,3
34515_0,,,,2,1,2,3
34516_0,,,,2,1,2,3
34518_0,,,,2,1,2,3
C(CC(C(C(C(O)=O)=O)=O)=O)=O,,,5,1,1,0,1
34519_0,,,,2,1,2,3
34520_0,,,,2,1,2,3
34521_0,,,,2,1,2,3
34523_0,,,,2,1,2,3
C(C(C(C(CCO)=O)=O)=O)(O)=O,,,5,1,1,0,1
34524_0,,,,2,1,2,3
34526_0,,,,2,1,2,3
C(C(C(C(O)=O)=O)=O)(CC)=O,,,5,1,1,0,1
34527_0,,,,2,1,2,3
34528_0,,,,2,1,2,3
34530_0,,,,2,1,2,3
C(C)(C(C(C)=O)CC(CO)=O)=O,,,5,1,1,0,1
34532_0,,,,2,1,2,3
C(C)(C(C(C(C)=O)=O)C(C)O)=O,,,5,1,1,0,1
34534_0,,,,2,1,2,3
C(C)(C(C(C)=O)C(C(C)=O)O)=O,,,5,1,1,0,1
34536_0,,,,2,1,2,3
C(C(C=C)C(C(C)=O)C(C)=O)=O,,,5,1,1,0,1
34537_0,,,,2,1,2,3
34539_0,,,,2,1,2,3
C(C(C(C(C)=O)C(C)=O)O)=O,,,5,1,1,0,1
34541_0,,,,2,1,2,3
C(CC(C(C)=O)C(C)=O)=O,,,5,1,1,0,1
34543_0,,,,2,1,2,3
C(C)(C(C(C)=O)CC(C=O)=O)=O,,,5,1,1,0,1
34545_0,,,,2,1,2,3
C(C(C)O)(C(C(C(C)=O)=O)C)=O,,,5,1,2,0,2
34547_0,,,,2,1,2,3
C(C(C)O)(C(C(C=O)=O)C)=O,,,5,1,1,0,1
34549_0,,,,2,1,2,3
C(C(C)CC(C(C(C)O)=O)=O)=O,,,5,1,1,0,1
34551_0,,,,2,1,2,3
C(CCC(C(C(C)O)=O)=O)=O,,,5,1,1,0,1
34552_0,,,,2,1,2,3
34554_0,,,,2,1,2,3
C(CCC(C(C(C)O)=O)=O)(C)=O,,,5,1,1,0,1
34556_0,,,,2,1,2,3
C(CC)(CC(C(C(C)O)=O)=O)=O,,,5,1,1,0,1
34558_0,,,,2,1,2,3
C(C(C(C)=O)C(C(C)=O)=O)(O)=O,,,5,1,1,0,1
34559_0,,,,2,1,2,3
34561_0,,,,2,1,2,3
C(C(C)=O)(C(C(C(O)=O)=O)C)=O,,,5,1,2,0,2
34563_0,,,,2,1,2,3
C(C(C(C(C(O)=O)=O)C)=O)=O,,,5,1,1,0,1
34565_0,,,,2,1,2,3
C(C(C)CC(C(C(O)=O)=O)=O)=O,,,5,1,1,0,1
34567_0,,,,2,1,2,3
C(CCC(C(C(O)=O)=O)=O)=O,,,5,1,1,0,1
34568_0,,,,2,1,2,3
34570_0,,,,2,1,2,3
C(C)(CCC(C(C(O)=O)=O)=O)=O,,,5,1,1,0,1
34572_0,,,,2,1,2,3
C(CC)(CC(C(C(O)=O)=O)=O)=O,,,5,1,1,0,1
34573_0,,,,2,1,2,3
34574_0,,,,2,1,2,3
34575_0,,,,2,1,2,3
34576_0,,,,2,1,2,3
34577_0,,,,2,1,2,3
34578_0,,,,2,1,2,3
34579_0,,,,2,1,2,3
34580_0,,,,2,1,2,3
34581_0,,,,2,1,2,3
34582_0,,,,2,1,2,3
34584_0,,,,2,1,2,3
C(C(C=O)O)(CC(CO)=O)=O,,,5,1,1,0,1
34586_0,,,,2,1,2,3
C(CC(C(C(CO)=O)O)=O)=O,,,5,1,1,0,1
34587_0,,,,2,1,2,3
34589_0,,,,2,1,2,3
C(CC(CC(CO)=O)=O)=O,,,5,1,1,0,1
34591_0,,,,2,1,2,3
C(CO)(CCC(C=O)=O)=O,,,5,1,2,0,2
34592_0,,,,2,1,2,3
34594_0,,,,2,1,2,3
C(C(C=O)O)(CC(C)=O)=O,,,5,1,1,0,1
34596_0,,,,2,1,2,3
C(CC(C(C(C)=O)O)=O)=O,,,5,1,1,0,1
34597_0,,,,2,1,2,3
34599_0,,,,2,1,2,3
C(C(C(CC=O)=O)C=C)=O,,,5,1,1,0,1
34601_0,,,,2,1,2,3
C(C(C=C)CC(C=O)=O)=O,,,5,1,1,0,1
34602_0,,,,2,1,2,3
34603_0,,,,2,1,2,3
34605_0,,,,2,1,2,3
C(CC(CC=O)=O)=O,,,5,1,3,0,3
34606_0,,,,2,1,2,3
34608_0,,,,2,1,2,3
C(C(C(CC=O)=O)C(C)O)=O,,,5,1,2,0,2
34610_0,,,,2,1,2,3
C(C(C(C)O)CC(C=O)=O)=O,,,5,1,1,0,1
34612_0,,,,2,1,2,3
C(C(C(O)=O)C(CC=O)=O)=O,,,5,1,2,0,2
34613_0,,,,2,1,2,3
34614_0,,,,2,1,2,3
34615_0,,,,2,1,2,3
34617_0,,,,2,1,2,3
C(CC(C(C(C=O)=O)O)=O)=O,,,5,1,2,0,2
34618_0,,,,2,1,2,3
34620_0,,,,2,1,2,3
C(CC(CC(C=O)=O)=O)=O,,,5,1,2,0,2
34622_0,,,,2,1,2,3
C(C(CCC(C=O)=O)=O)=O,,,5,1,1,0,1
34623_0,,,,2,1,2,3
34624_0,,,,2,1,2,3
34626_0,,,,2,1,2,3
C(CC(C(C(C(O)=O)=O)O)=O)=O,,,5,1,2,0,2
34627_0,,,,2,1,2,3
34628_0,,,,2,1,2,3
34630_0,,,,2,1,2,3
C(C(CCC(C(O)=O)=O)=O)=O,,,5,1,2,0,2
34631_0,,,,2,1,2,3
34632_0,,,,2,1,2,3
34633_0,,,,2,1,2,3
34634_0,,,,2,1,2,3
34635_0,,,,2,1,2,3
34637_0,,,,2,1,2,3
C(CO)(CCC(C(O)=O)=O)=O,,,5,1,2,0,2
34638_0,,,,2,1,2,3
34639_0,,,,2,1,2,3
34640_0,,,,2,1,2,3
34641_0,,,,2,1,2,3
34643_0,,,,2,1,2,3
C(C(C(CC(O)=O)=O)C=C)=O,,,5,1,1,0,1
34645_0,,,,2,1,2,3
C(C(C=C)CC(C(O)=O)=O)=O,,,5,1,1,0,1
34646_0,,,,2,1,2,3
34648_0,,,,2,1,2,3
C(C(C(CC=O)=O)O)(O)=O,,,5,1,2,0,2
34649_0,,,,2,1,2,3
34650_0,,,,2,1,2,3
34652_0,,,,2,1,2,3
C(CC(CC(O)=O)=O)=O,,,5,1,3,0,3
34653_0,,,,2,1,2,3
34655_0,,,,2,1,2,3
C(C(C(CC(O)=O)=O)C(C)O)=O,,,5,1,1,0,1
34657_0,,,,2,1,2,3
C(C(C(C)O)CC(C(O)=O)=O)=O,,,5,1,1,0,1
34659_0,,,,2,1,2,3
C(C(C(O)=O)C(CC(O)=O)=O)=O,,,5,1,2,0,2
34660_0,,,,2,1,2,3
34661_0,,,,2,1,2,3
34662_0,,,,2,1,2,3
34663_0,,,,2,1,2,3
34664_0,,,,2,1,2,3
34665_0,,,,2,1,2,3
34666_0,,,,2,1,2,3
34667_0,,,,2,1,2,3
34669_0,,,,2,1,2,3
C(C(CCC(C(O)=O)=O)=O)(O)=O,,,5,1,1,0,1
34671_0,,,,2,1,2,3
C(C(CO)=O)(C(CO)CO)=O,,,5,1,1,0,1
34672_0,,,,2,1,2,3
34673_0,,,,2,1,2,3
34674_0,,,,2,1,2,3
34675_0,,,,2,1,2,3
34677_0,,,,2,1,2,3
C(C(C=C)C(C=O)CO)=O,,,5,1,1,0,1
34678_0,,,,2,1,2,3
34679_0,,,,2,1,2,3
34680_0,,,,2,1,2,3
34681_0,,,,2,1,2,3
34682_0,,,,2,1,2,3
34683_0,,,,2,1,2,3
34684_0,,,,2,1,2,3
34685_0,,,,2,1,2,3
34686_0,,,,2,1,2,3
34687_0,,,,2,1,2,3
34688_0,,,,2,1,2,3
34690_0,,,,2,1,2,3
C(C(C)C(C(CO)=O)O)=O,,,5,1,1,0,1
34692_0,,,,2,1,2,3
C(C(CO)=O)(C(CO)C)=O,,,5,1,1,0,1
34694_0,,,,2,1,2,3
C(CO)(CC(C=CC)=O)=O,,,5,1,1,0,1
34696_0,,,,2,1,2,3
C(CC(C(CO)=O)=O)=CC,,,5,1,1,0,1
34698_0,,,,2,1,2,3
C(CC(CO)=O)(CC=C)=O,,,5,1,1,0,1
34700_0,,,,2,1,2,3
C=CCCC(C(CO)=O)=O,,,5,1,1,0,1
34701_0,,,,2,1,2,3
34702_0,,,,2,1,2,3
34703_0,,,,2,1,2,3
34704_0,,,,2,1,2,3
34705_0,,,,2,1,2,3
34706_0,,,,2,1,2,3
34707_0,,,,2,1,2,3
34708_0,,,,2,1,2,3
34709_0,,,,2,1,2,3
34710_0,,,,2,1,2,3
34712_0,,,,2,1,2,3
C(CO)(C(CC(C)=O)O)=O,,,5,1,1,0,1
34714_0,,,,2,1,2,3
C(CC)(C(C(CO)=O)O)=O,,,5,1,1,0,1
34715_0,,,,2,1,2,3
34716_0,,,,2,1,2,3
34717_0,,,,2,1,2,3
34718_0,,,,2,1,2,3
34719_0,,,,2,1,2,3
34720_0,,,,2,1,2,3
34721_0,,,,2,1,2,3
34722_0,,,,2,1,2,3
34723_0,,,,2,1,2,3
34724_0,,,,2,1,2,3
34725_0,,,,2,1,2,3
34726_0,,,,2,1,2,3
34727_0,,,,2,1,2,3
34728_0,,,,2,1,2,3
34729_0,,,,2,1,2,3
34730_0,,,,2,1,2,3
34732_0,,,,2,1,2,3
C(C(C)CC(CO)=O)=O,,,5,1,1,0,1
34734_0,,,,2,1,2,3
C(C(C)=O)(C(C)CO)=O,,,5,1,1,0,1
34736_0,,,,2,1,2,3
C(C(C)C(C(C)=O)O)=O,,,5,1,1,0,1
34738_0,,,,2,1,2,3
C(C(C)CC(C(C(O)=O)C)=O)=O,,,5,1,1,0,1
34740_0,,,,2,1,2,3
C(C(C=C)C(C=O)C)=O,,,5,1,1,0,1
34742_0,,,,2,1,2,3
C(C(C)C(C=C)C(C(O)=O)=O)=O,,,5,1,1,0,1
34744_0,,,,2,1,2,3
C(C(C(C(O)=O)=C)C(C=O)C)=O,,,5,1,1,0,1
34746_0,,,,2,1,2,3
C(C(C(C)CO)=O)=O,,,5,1,1,0,1
34748_0,,,,2,1,2,3
C(C(C)C(C=O)O)=O,,,5,1,2,0,2
34750_0,,,,2,1,2,3
C(C(C)C1C(C(OC1C)=O)=O)=O,,,5,1,1,0,1
34752_0,,,,2,1,2,3
C(C(C)C1C(OC(C1=O)=O)=O)=O,,,5,1,1,0,1
34754_0,,,,2,1,2,3
C(C(C)C(C=O)C[CH]C(O)=O)=O,,,5,1,1,0,1
34756_0,,,,2,1,2,3
C(C(CCC(O)=O)C(C=O)C)=O,,,5,1,1,0,1
34757_0,,,,2,1,2,3
34759_0,,,,2,1,2,3
C(C(C(C)O)C(C=O)C)=O,,,5,1,2,0,2
34761_0,,,,2,1,2,3
C(C(C(O)=O)C(C=O)C)=O,,,5,1,1,0,1
34762_0,,,,2,1,2,3
34764_0,,,,2,1,2,3
C(C(C)C(C(C=O)=O)O)=O,,,5,1,2,0,2
34766_0,,,,2,1,2,3
C(C(C)CC(C=O)=O)=O,,,5,1,1,0,1
34767_0,,,,2,1,2,3
34769_0,,,,2,1,2,3
C(C(C)C(C(C(O)=O)=O)O)=O,,,5,1,2,0,2
34770_0,,,,2,1,2,3
34771_0,,,,2,1,2,3
34772_0,,,,2,1,2,3
34773_0,,,,2,1,2,3
34775_0,,,,2,1,2,3
C(CO)(CCC(CO)=O)=O,,,5,1,1,0,1
34776_0,,,,2,1,2,3
34778_0,,,,2,1,2,3
C(CCC(CO)=O)=O,,,5,1,2,0,2
34779_0,,,,2,1,2,3
34781_0,,,,2,1,2,3
C(C)(CCC(CO)=O)=O,,,5,1,1,0,1
34783_0,,,,2,1,2,3
C(CC)(CC(CO)=O)=O,,,5,1,1,0,1
34784_0,,,,2,1,2,3
34785_0,,,,2,1,2,3
34787_0,,,,2,1,2,3
C(C(C(C(C(C)=O)O)=O)C)(O)=O,,,5,1,1,0,1
34789_0,,,,2,1,2,3
C(C(C(CC(C)=O)=O)(C)O)(O)=O,,,5,1,1,0,1
34790_0,,,,2,1,2,3
34792_0,,,,2,1,2,3
C(C(C)C(C(C(C)=O)=O)C)(O)=O,,,5,1,1,0,1
34794_0,,,,2,1,2,3
C(C)(CC(C=CC)=O)=O,,,5,1,1,0,1
34796_0,,,,2,1,2,3
C(CC(C(C)=O)=O)=CC,,,5,1,1,0,1
34798_0,,,,2,1,2,3
C(CC(C)=O)(CC=C)=O,,,5,1,1,0,1
34800_0,,,,2,1,2,3
C=CCCC(C(C)=O)=O,,,5,1,1,0,1
34802_0,,,,2,1,2,3
C(C(C=CC)C(C(C)=O)=O)(O)=O,,,5,1,1,0,1
34804_0,,,,2,1,2,3
C(C(C(C(C)=O)=O)CC=C)(O)=O,,,5,1,1,0,1
34806_0,,,,2,1,2,3
C(CC(C)=O)(CC(C(O)=O)=C)=O,,,5,1,1,0,1
34808_0,,,,2,1,2,3
C=C(C(O)=O)CCC(C(C)=O)=O,,,5,1,1,0,1
34810_0,,,,2,1,2,3
C(C)(CC(C=C(C(O)=O)C)=O)=O,,,5,1,1,0,1
34812_0,,,,2,1,2,3
C(CC(C(C)=O)=O)=C(C(O)=O)C,,,5,1,1,0,1
34813_0,,,,2,1,2,3
34814_0,,,,2,1,2,3
34815_0,,,,2,1,2,3
34816_0,,,,2,1,2,3
34818_0,,,,2,1,2,3
C(C(CO)O)(CC(C)=O)=O,,,5,1,1,0,1
34819_0,,,,2,1,2,3
34820_0,,,,2,1,2,3
34821_0,,,,2,1,2,3
34822_0,,,,2,1,2,3
34823_0,,,,2,1,2,3
34825_0,,,,2,1,2,3
C1(C(C(C(C)=O)=O)CC(C)O1)=O,,,5,1,1,0,1
34827_0,,,,2,1,2,3
C1(C(C(C(C)=O)=O)CC(O1)=O)=O,,,5,1,1,0,1
34829_0,,,,2,1,2,3
C(CC[CH]C(O)=O)(CC(C)=O)=O,,,5,1,1,0,1
34831_0,,,,2,1,2,3
[CH](C(O)=O)CCCC(C(C)=O)=O,,,5,1,1,0,1
34833_0,,,,2,1,2,3
C(CCCC(O)=O)(CC(C)=O)=O,,,5,1,1,0,1
34835_0,,,,2,1,2,3
C(CCCCC(C(C)=O)=O)(O)=O,,,5,1,1,0,1
34837_0,,,,2,1,2,3
C(C)(C(CC(C)=O)O)=O,,,5,1,1,0,1
34839_0,,,,2,1,2,3
C(CC)(C(C(C)=O)O)=O,,,5,1,1,0,1
34841_0,,,,2,1,2,3
C(C(C)O)(CC(C)=O)=O,,,5,1,1,0,1
34842_0,,,,2,1,2,3
34844_0,,,,2,1,2,3
C(C)(CC(C)=O)=O,,,5,1,1,0,1
34845_0,,,,2,1,2,3
34847_0,,,,2,1,2,3
C(CC(C)O)(CC(C)=O)=O,,,5,1,1,0,1
34849_0,,,,2,1,2,3
C(C(C)=O)(CCC(C)O)=O,,,5,1,2,0,2
34851_0,,,,2,1,2,3
C(CC(O)=O)(CC(C)=O)=O,,,5,1,1,0,1
34852_0,,,,2,1,2,3
34853_0,,,,2,1,2,3
34854_0,,,,2,1,2,3
34856_0,,,,2,1,2,3
C(C(C(C(C)=O)=O)C)=O,,,5,1,2,0,2
34858_0,,,,2,1,2,3
C(C)(CC(C(C)=O)=O)=O,,,5,1,1,0,1
34859_0,,,,2,1,2,3
34860_0,,,,2,1,2,3
34861_0,,,,2,1,2,3
34862_0,,,,2,1,2,3
34863_0,,,,2,1,2,3
34864_0,,,,2,1,2,3
34865_0,,,,2,1,2,3
34867_0,,,,2,1,2,3
C(C(C)C(C(O)=O)O)(CC=O)=O,,,5,1,1,0,1
34868_0,,,,2,1,2,3
34869_0,,,,2,1,2,3
34870_0,,,,2,1,2,3
34871_0,,,,2,1,2,3
34872_0,,,,2,1,2,3
34873_0,,,,2,1,2,3
34874_0,,,,2,1,2,3
34875_0,,,,2,1,2,3
34876_0,,,,2,1,2,3
34877_0,,,,2,1,2,3
34879_0,,,,2,1,2,3
C(C(C(C(C(O)=O)C)=O)C=C)=O,,,5,1,1,0,1
34880_0,,,,2,1,2,3
34881_0,,,,2,1,2,3
34882_0,,,,2,1,2,3
34884_0,,,,2,1,2,3
C(CC=O)(C(C(O)=O)C)=O,,,5,1,1,0,1
34885_0,,,,2,1,2,3
34887_0,,,,2,1,2,3
C(C(CO)C(C(C=O)=O)C)(O)=O,,,5,1,1,0,1
34889_0,,,,2,1,2,3
C(C(C(CCC=O)=O)CO)(O)=O,,,5,1,1,0,1
34890_0,,,,2,1,2,3
34892_0,,,,2,1,2,3
C(C(C)C(C(C=O)=O)C)(O)=O,,,5,1,1,0,1
34894_0,,,,2,1,2,3
C(CCC(C(C(O)=O)C)=O)=O,,,5,1,1,0,1
34896_0,,,,2,1,2,3
C(CC(C)=O)(C(C(O)=O)C)=O,,,5,1,1,0,1
34898_0,,,,2,1,2,3
C(CCC(C(C(O)=O)C)=O)(C)=O,,,5,1,1,0,1
34900_0,,,,2,1,2,3
C(CC(CC)=O)(C(C(O)=O)C)=O,,,5,1,1,0,1
34902_0,,,,2,1,2,3
C(CC(C=O)=O)=CC,,,5,1,1,0,1
34904_0,,,,2,1,2,3
C(CC(C=CC)=O)=O,,,5,1,1,0,1
34906_0,,,,2,1,2,3
C(CC(C(C=O)=O)=O)=CC,,,5,1,2,0,2
34908_0,,,,2,1,2,3
C(C)=CC(CC(C=O)=O)=O,,,5,1,2,0,2
34910_0,,,,2,1,2,3
C(CC(C(C(O)=O)=O)=O)=CC,,,5,1,2,0,2
34912_0,,,,2,1,2,3
C(C)=CC(CC(C(O)=O)=O)=O,,,5,1,2,0,2
34914_0,,,,2,1,2,3
C=CCCC(C=O)=O,,,5,1,1,0,1
34916_0,,,,2,1,2,3
C(CC(CC=C)=O)=O,,,5,1,1,0,1
34918_0,,,,2,1,2,3
C=CCCC(C(C=O)=O)=O,,,5,1,2,0,2
34920_0,,,,2,1,2,3
C(CC(C=O)=O)(CC=C)=O,,,5,1,2,0,2
34922_0,,,,2,1,2,3
C=CCCC(C(C(O)=O)=O)=O,,,5,1,2,0,2
34924_0,,,,2,1,2,3
C(CC(C(O)=O)=O)(CC=C)=O,,,5,1,2,0,2
34925_0,,,,2,1,2,3
34926_0,,,,2,1,2,3
34928_0,,,,2,1,2,3
C(C(C=C)CC(CO)=O)=O,,,5,1,1,0,1
34930_0,,,,2,1,2,3
C(C(C(CCO)=O)C=C)=O,,,5,1,1,0,1
34932_0,,,,2,1,2,3
C(C(C=C)CC=O)=O,,,5,1,1,0,1
34934_0,,,,2,1,2,3
C(C(C(C)=O)C=C)=O,,,5,1,1,0,1
34936_0,,,,2,1,2,3
C(C(C=C)CC(C)=O)=O,,,5,1,1,0,1
34938_0,,,,2,1,2,3
C(C(C(CC)=O)C=C)=O,,,5,1,1,0,1
34940_0,,,,2,1,2,3
C(C(C=O)C(C=O)C=C)=O,,,5,1,2,0,2
34942_0,,,,2,1,2,3
C(C(C(O)=O)C(C=O)C=C)=O,,,5,1,2,0,2
34944_0,,,,2,1,2,3
C(C(C=CC)C(C=O)=O)(O)=O,,,5,1,1,0,1
34946_0,,,,2,1,2,3
C(C(C(C=O)=O)CC=C)(O)=O,,,5,1,1,0,1
34948_0,,,,2,1,2,3
C(CC(C=C)C(C(O)=O)=O)=O,,,5,1,1,0,1
34950_0,,,,2,1,2,3
C(C)(C(C=C)C(C(O)=O)=O)=O,,,5,1,1,0,1
34952_0,,,,2,1,2,3
C(C)(CC(C=C)C(C(O)=O)=O)=O,,,5,1,1,0,1
34954_0,,,,2,1,2,3
C(CC)(C(C=C)C(C(O)=O)=O)=O,,,5,1,1,0,1
34956_0,,,,2,1,2,3
C=C(C(O)=O)CCC(C=O)=O,,,5,1,1,0,1
34958_0,,,,2,1,2,3
C(CC(CC(C(O)=O)=C)=O)=O,,,5,1,1,0,1
34960_0,,,,2,1,2,3
C(C(C(C(O)=O)=C)CC=O)=O,,,5,1,1,0,1
34962_0,,,,2,1,2,3
C(C(C(C)=O)C(C(O)=O)=C)=O,,,5,1,1,0,1
34964_0,,,,2,1,2,3
C(C(C(C(O)=O)=C)CC(C)=O)=O,,,5,1,1,0,1
34966_0,,,,2,1,2,3
C(C(C(CC)=O)C(C(O)=O)=C)=O,,,5,1,1,0,1
34968_0,,,,2,1,2,3
C(CC(C=O)=O)=C(C(O)=O)C,,,5,1,1,0,1
34970_0,,,,2,1,2,3
C(CC(C=C(C(O)=O)C)=O)=O,,,5,1,1,0,1
34971_0,,,,2,1,2,3
34972_0,,,,2,1,2,3
34973_0,,,,2,1,2,3
34974_0,,,,2,1,2,3
34975_0,,,,2,1,2,3
34976_0,,,,2,1,2,3
34977_0,,,,2,1,2,3
34978_0,,,,2,1,2,3
34979_0,,,,2,1,2,3
34980_0,,,,2,1,2,3
34981_0,,,,2,1,2,3
34982_0,,,,2,1,2,3
34984_0,,,,2,1,2,3
C(C(C(C)O)CC(CO)=O)=O,,,5,1,2,0,2
34986_0,,,,2,1,2,3
C(C(C(CCO)=O)C(C)O)=O,,,5,1,1,0,1
34987_0,,,,2,1,2,3
34988_0,,,,2,1,2,3
34989_0,,,,2,1,2,3
34991_0,,,,2,1,2,3
C(C(C=O)C(CCO)=O)(O)=O,,,5,1,2,0,2
34992_0,,,,2,1,2,3
34993_0,,,,2,1,2,3
34994_0,,,,2,1,2,3
34995_0,,,,2,1,2,3
34996_0,,,,2,1,2,3
34997_0,,,,2,1,2,3
34998_0,,,,2,1,2,3
34999_0,,,,2,1,2,3
35000_0,,,,2,1,2,3
35001_0,,,,2,1,2,3
35002_0,,,,2,1,2,3
35003_0,,,,2,1,2,3
35004_0,,,,2,1,2,3
35005_0,,,,2,1,2,3
35006_0,,,,2,1,2,3
35007_0,,,,2,1,2,3
35008_0,,,,2,1,2,3
35009_0,,,,2,1,2,3
35010_0,,,,2,1,2,3
35011_0,,,,2,1,2,3
35012_0,,,,2,1,2,3
35013_0,,,,2,1,2,3
35014_0,,,,2,1,2,3
35015_0,,,,2,1,2,3
35017_0,,,,2,1,2,3
C(CC1C(C(OC1C)=O)=O)=O,,,5,1,1,0,1
35019_0,,,,2,1,2,3
C(C)(C1C(C(OC1C)=O)=O)=O,,,5,1,1,0,1
35021_0,,,,2,1,2,3
C1(C(C(C(O1)=O)=O)CC=O)=O,,,5,1,1,0,1
35023_0,,,,2,1,2,3
C1(C(C(C)=O)C(C(O1)=O)=O)=O,,,5,1,1,0,1
35025_0,,,,2,1,2,3
C(CC(C=O)C[CH]C(O)=O)=O,,,5,1,2,0,2
35027_0,,,,2,1,2,3
C(C(C(C)=O)C[CH]C(O)=O)=O,,,5,1,1,0,1
35029_0,,,,2,1,2,3
C(C(CCC(O)=O)CC=O)=O,,,5,1,2,0,2
35031_0,,,,2,1,2,3
C(C(C(C)=O)CCC(O)=O)=O,,,5,1,1,0,1
35032_0,,,,2,1,2,3
35033_0,,,,2,1,2,3
35034_0,,,,2,1,2,3
35036_0,,,,2,1,2,3
C(C(C(C)=O)C(C)O)=O,,,5,1,1,0,1
35038_0,,,,2,1,2,3
C(CC(C(C(O)=O)=O)C(C)O)=O,,,5,1,1,0,1
35039_0,,,,2,1,2,3
35040_0,,,,2,1,2,3
35042_0,,,,2,1,2,3
C(C(C(O)=O)C(C)=O)=O,,,5,1,2,0,2
35044_0,,,,2,1,2,3
C(C(C)(C(C=O)CC=O)O)(O)=O,,,5,1,1,0,1
35046_0,,,,2,1,2,3
C(C(C)(C(C=O)C(C)=O)O)(O)=O,,,5,1,2,0,2
35047_0,,,,2,1,2,3
35048_0,,,,2,1,2,3
35049_0,,,,2,1,2,3
35050_0,,,,2,1,2,3
35051_0,,,,2,1,2,3
35052_0,,,,2,1,2,3
35053_0,,,,2,1,2,3
35054_0,,,,2,1,2,3
35055_0,,,,2,1,2,3
35056_0,,,,2,1,2,3
35057_0,,,,2,1,2,3
35058_0,,,,2,1,2,3
35059_0,,,,2,1,2,3
35060_0,,,,2,1,2,3
35062_0,,,,2,1,2,3
C1(C(C(C=O)=O)CC(C)O1)=O,,,5,1,1,0,1
35064_0,,,,2,1,2,3
C1(C(C(C=O)=O)CC(O1)=O)=O,,,5,1,1,0,1
35066_0,,,,2,1,2,3
C(CC(CC[CH]C(O)=O)=O)=O,,,5,1,1,0,1
35068_0,,,,2,1,2,3
[CH](C(O)=O)CCCC(C=O)=O,,,5,1,1,0,1
35070_0,,,,2,1,2,3
C(CC(CCCC(O)=O)=O)=O,,,5,1,1,0,1
35072_0,,,,2,1,2,3
C(CCCCC(C=O)=O)(O)=O,,,5,1,1,0,1
35074_0,,,,2,1,2,3
C(C(CC(C)=O)O)=O,,,5,1,3,0,3
35076_0,,,,2,1,2,3
C(C(C(CC)=O)O)=O,,,5,1,1,0,1
35077_0,,,,2,1,2,3
35078_0,,,,2,1,2,3
35079_0,,,,2,1,2,3
35080_0,,,,2,1,2,3
35081_0,,,,2,1,2,3
35082_0,,,,2,1,2,3
35084_0,,,,2,1,2,3
C(CC(CC(C)O)=O)=O,,,5,1,2,0,2
35085_0,,,,2,1,2,3
35087_0,,,,2,1,2,3
C(C(C(C=O)=O)CC(C)O)(O)=O,,,5,1,1,0,1
35088_0,,,,2,1,2,3
35089_0,,,,2,1,2,3
35091_0,,,,2,1,2,3
C(C(C)(CC(CC=O)=O)O)(O)=O,,,5,1,1,0,1
35093_0,,,,2,1,2,3
C(C(C)(CCC(C=O)=O)O)(O)=O,,,5,1,2,0,2
35094_0,,,,2,1,2,3
35095_0,,,,2,1,2,3
35096_0,,,,2,1,2,3
35097_0,,,,2,1,2,3
35098_0,,,,2,1,2,3
35099_0,,,,2,1,2,3
35100_0,,,,2,1,2,3
35102_0,,,,2,1,2,3
C(CC1C(C(OC1C)=O)=O)(C)=O,,,5,1,1,0,1
35104_0,,,,2,1,2,3
C(CC)(C1C(C(OC1C)=O)=O)=O,,,5,1,1,0,1
35106_0,,,,2,1,2,3
C1(C(C(C(O1)=O)=O)CC(C)=O)=O,,,5,1,1,0,1
35108_0,,,,2,1,2,3
C(CC)(C1C(OC(C1=O)=O)=O)=O,,,5,1,1,0,1
35110_0,,,,2,1,2,3
C(C(C[CH]C(O)=O)CC(C)=O)=O,,,5,1,1,0,1
35112_0,,,,2,1,2,3
C(CC)(C(C=O)C[CH]C(O)=O)=O,,,5,1,1,0,1
35114_0,,,,2,1,2,3
C(C(CCC(O)=O)CC(C)=O)=O,,,5,1,1,0,1
35116_0,,,,2,1,2,3
C(C(C(CC)=O)CCC(O)=O)=O,,,5,1,1,0,1
35118_0,,,,2,1,2,3
C(CCC(C)=O)=O,,,5,1,1,0,1
35120_0,,,,2,1,2,3
C(CC(CC)=O)=O,,,5,1,1,0,1
35122_0,,,,2,1,2,3
C(C(C(C)O)CC(C)=O)=O,,,5,1,2,0,2
35124_0,,,,2,1,2,3
C(C(C(CC)=O)C(C)O)=O,,,5,1,1,0,1
35126_0,,,,2,1,2,3
C(C(C(O)=O)CC(C)=O)=O,,,5,1,1,0,1
35128_0,,,,2,1,2,3
C(C(C(CC)=O)C(O)=O)=O,,,5,1,1,0,1
35129_0,,,,2,1,2,3
35131_0,,,,2,1,2,3
C(C)(CC(C(C=O)=O)O)=O,,,5,1,2,0,2
35132_0,,,,2,1,2,3
35134_0,,,,2,1,2,3
C(CC)(C(C(C=O)=O)O)=O,,,5,1,1,0,1
35136_0,,,,2,1,2,3
C(C)(CCC(C=O)=O)=O,,,5,1,1,0,1
35138_0,,,,2,1,2,3
C(CC)(CC(C=O)=O)=O,,,5,1,1,0,1
35139_0,,,,2,1,2,3
35141_0,,,,2,1,2,3
C(C)(CC(C(C(O)=O)=O)O)=O,,,5,1,2,0,2
35142_0,,,,2,1,2,3
35144_0,,,,2,1,2,3
C(CC)(C(C(C(O)=O)=O)O)=O,,,5,1,1,0,1
35146_0,,,,2,1,2,3
C(C)(CCC(C(O)=O)=O)=O,,,5,1,1,0,1
35148_0,,,,2,1,2,3
C(CC)(CC(C(O)=O)=O)=O,,,5,1,1,0,1
35149_0,,,,2,1,2,3
35150_0,,,,2,1,2,3
35151_0,,,,2,1,2,3
35153_0,,,,2,1,2,3
C(C(CC(C(O)=O)=O)=O)(O)=O,,,5,1,2,0,2
35155_0,,,,2,1,2,3
C(CC(C(CC(C)O)O)=O)(O)=O,,,5,1,1,0,1
35156_0,,,,2,1,2,3
35157_0,,,,2,1,2,3
35158_0,,,,2,1,2,3
35159_0,,,,2,1,2,3
35160_0,,,,2,1,2,3
35161_0,,,,2,1,2,3
35162_0,,,,2,1,2,3
35164_0,,,,2,1,2,3
C(C(C(CC(O)=O)=O)(CO)O)=O,,,5,1,1,0,1
35165_0,,,,2,1,2,3
35166_0,,,,2,1,2,3
35167_0,,,,2,1,2,3
35168_0,,,,2,1,2,3
35169_0,,,,2,1,2,3
35171_0,,,,2,1,2,3
C(C(C(CC(O)=O)=O)(C)O)=O,,,5,1,1,0,1
35172_0,,,,2,1,2,3
35173_0,,,,2,1,2,3
35174_0,,,,2,1,2,3
35175_0,,,,2,1,2,3
35176_0,,,,2,1,2,3
35177_0,,,,2,1,2,3
35178_0,,,,2,1,2,3
35179_0,,,,2,1,2,3
35180_0,,,,2,1,2,3
35181_0,,,,2,1,2,3
35182_0,,,,2,1,2,3
35183_0,,,,2,1,2,3
35184_0,,,,2,1,2,3
35185_0,,,,2,1,2,3
35186_0,,,,2,1,2,3
35187_0,,,,2,1,2,3
35188_0,,,,2,1,2,3
35189_0,,,,2,1,2,3
35190_0,,,,2,1,2,3
35191_0,,,,2,1,2,3
35192_0,,,,2,1,2,3
35193_0,,,,2,1,2,3
35194_0,,,,2,1,2,3
35195_0,,,,2,1,2,3
35196_0,,,,2,1,2,3
35197_0,,,,2,1,2,3
35198_0,,,,2,1,2,3
35199_0,,,,2,1,2,3
35200_0,,,,2,1,2,3
35201_0,,,,2,1,2,3
35202_0,,,,2,1,2,3
35203_0,,,,2,1,2,3
35204_0,,,,2,1,2,3
35205_0,,,,2,1,2,3
35206_0,,,,2,1,2,3
35207_0,,,,2,1,2,3
35208_0,,,,2,1,2,3
35209_0,,,,2,1,2,3
35210_0,,,,2,1,2,3
35211_0,,,,2,1,2,3
35212_0,,,,2,1,2,3
35213_0,,,,2,1,2,3
35214_0,,,,2,1,2,3
35215_0,,,,2,1,2,3
35216_0,,,,2,1,2,3
35217_0,,,,2,1,2,3
35218_0,,,,2,1,2,3
35219_0,,,,2,1,2,3
35220_0,,,,2,1,2,3
35221_0,,,,2,1,2,3
35223_0,,,,2,1,2,3
C(C(C)C(C(O)=O)(CO)O)=O,,,5,1,1,0,1
35224_0,,,,2,1,2,3
35225_0,,,,2,1,2,3
35226_0,,,,2,1,2,3
35227_0,,,,2,1,2,3
35229_0,,,,2,1,2,3
C(C(C)C(C(O)=O)O)=O,,,5,1,2,0,2
35231_0,,,,2,1,2,3
C(C(C)C(C(O)=O)(C)O)=O,,,5,1,1,0,1
35232_0,,,,2,1,2,3
35233_0,,,,2,1,2,3
35234_0,,,,2,1,2,3
35235_0,,,,2,1,2,3
35236_0,,,,2,1,2,3
35237_0,,,,2,1,2,3
35238_0,,,,2,1,2,3
35239_0,,,,2,1,2,3
35241_0,,,,2,1,2,3
C(C(CO)(C(C)O)C(C=O)C)=O,,,5,1,2,0,2
35243_0,,,,2,1,2,3
C(C(CO)(C(C)O)CC=O)=O,,,5,1,2,0,2
35245_0,,,,2,1,2,3
C(C(C(C)=O)(CO)C(C)O)=O,,,5,1,1,0,1
35247_0,,,,2,1,2,3
C(C(CO)(C(C)O)CC(C)=O)=O,,,5,1,2,0,2
35249_0,,,,2,1,2,3
C(C(C(CC)=O)(CO)C(C)O)=O,,,5,1,1,0,1
35251_0,,,,2,1,2,3
C(C(C(C)O)(C(C)O)CC=O)=O,,,5,1,1,0,1
35253_0,,,,2,1,2,3
C(C(C(C)=O)(C(C)O)C(C)O)=O,,,5,1,1,0,1
35254_0,,,,2,1,2,3
35256_0,,,,2,1,2,3
C(C(C=O)(C(C)=O)C(C)O)(O)=O,,,5,1,1,0,1
35257_0,,,,2,1,2,3
35258_0,,,,2,1,2,3
35260_0,,,,2,1,2,3
C(C(C=O)(CO)C(C=O)C)(O)=O,,,5,1,2,0,2
35261_0,,,,2,1,2,3
35263_0,,,,2,1,2,3
C(C(C=O)(C(C)=O)CO)(O)=O,,,5,1,1,0,1
35265_0,,,,2,1,2,3
C(C(C=O)(CO)CC(C)=O)(O)=O,,,5,1,2,0,2
35267_0,,,,2,1,2,3
C(C(C=O)(C(CC)=O)CO)(O)=O,,,5,1,1,0,1
35268_0,,,,2,1,2,3
35270_0,,,,2,1,2,3
C(C(C(O)=O)(C(O)=O)C(C)=O)=O,,,5,1,1,0,1
35271_0,,,,2,1,2,3
35273_0,,,,2,1,2,3
C(C(C(C)=O)C(C(C=O)=O)O)=O,,,5,1,1,0,1
35274_0,,,,2,1,2,3
35275_0,,,,2,1,2,3
35276_0,,,,2,1,2,3
35277_0,,,,2,1,2,3
35278_0,,,,2,1,2,3
35279_0,,,,2,1,2,3
35280_0,,,,2,1,2,3
35282_0,,,,2,1,2,3
C(C(C)C(C(C=O)=O)(CO)O)=O,,,5,1,1,0,1
35283_0,,,,2,1,2,3
35285_0,,,,2,1,2,3
C(C)=CC(C(C(C=O)=O)CO)=O,,,5,1,1,0,1
35286_0,,,,2,1,2,3
35288_0,,,,2,1,2,3
C(CC=C)(C(C(C=O)=O)CO)=O,,,5,1,1,0,1
35289_0,,,,2,1,2,3
35291_0,,,,2,1,2,3
C(CC(C(C=O)=O)(CO)O)=O,,,5,1,1,0,1
35292_0,,,,2,1,2,3
35293_0,,,,2,1,2,3
35294_0,,,,2,1,2,3
35296_0,,,,2,1,2,3
C(CC(C(C=O)=O)(CO)O)(C)=O,,,5,1,1,0,1
35298_0,,,,2,1,2,3
C(CC)(C(C(C=O)=O)(CO)O)=O,,,5,1,1,0,1
35299_0,,,,2,1,2,3
35300_0,,,,2,1,2,3
35301_0,,,,2,1,2,3
35302_0,,,,2,1,2,3
35303_0,,,,2,1,2,3
35304_0,,,,2,1,2,3
35305_0,,,,2,1,2,3
35306_0,,,,2,1,2,3
35307_0,,,,2,1,2,3
35309_0,,,,2,1,2,3
C(CC(C(C=O)=O)(C(C)O)O)=O,,,5,1,1,0,1
35310_0,,,,2,1,2,3
35311_0,,,,2,1,2,3
35312_0,,,,2,1,2,3
35313_0,,,,2,1,2,3
35314_0,,,,2,1,2,3
35315_0,,,,2,1,2,3
35316_0,,,,2,1,2,3
35317_0,,,,2,1,2,3
35318_0,,,,2,1,2,3
35319_0,,,,2,1,2,3
35321_0,,,,2,1,2,3
C(C(C=O)C(C(CCO)=O)=O)=O,,,5,1,1,0,1
35322_0,,,,2,1,2,3
35323_0,,,,2,1,2,3
35324_0,,,,2,1,2,3
35325_0,,,,2,1,2,3
35326_0,,,,2,1,2,3
35327_0,,,,2,1,2,3
35328_0,,,,2,1,2,3
35329_0,,,,2,1,2,3
35330_0,,,,2,1,2,3
35331_0,,,,2,1,2,3
35333_0,,,,2,1,2,3
C(C(C=O)C(CCO)=O)=O,,,5,1,1,0,1
35334_0,,,,2,1,2,3
35335_0,,,,2,1,2,3
35337_0,,,,2,1,2,3
C(C(C(CCO)=O)C(C)O)(O)=O,,,5,1,2,0,2
35339_0,,,,2,1,2,3
C(C(C(O)=O)C(CCO)=O)(O)=O,,,5,1,2,0,2
35340_0,,,,2,1,2,3
35341_0,,,,2,1,2,3
35342_0,,,,2,1,2,3
35343_0,,,,2,1,2,3
35344_0,,,,2,1,2,3
35345_0,,,,2,1,2,3
35346_0,,,,2,1,2,3
35347_0,,,,2,1,2,3
35348_0,,,,2,1,2,3
35349_0,,,,2,1,2,3
35350_0,,,,2,1,2,3
35352_0,,,,2,1,2,3
C(C(C=O)(C(CC=O)=O)O)=O,,,5,1,1,0,1
35353_0,,,,2,1,2,3
35354_0,,,,2,1,2,3
35356_0,,,,2,1,2,3
C(C(C=O)(C(CC(O)=O)=O)O)=O,,,5,1,1,0,1
35357_0,,,,2,1,2,3
35358_0,,,,2,1,2,3
35359_0,,,,2,1,2,3
35361_0,,,,2,1,2,3
C(C(C=O)(C(C=O)C)O)=O,,,5,1,1,0,1
35363_0,,,,2,1,2,3
C(C(C=O)C(C=CC)=O)=O,,,5,1,1,0,1
35365_0,,,,2,1,2,3
C(C(C=O)C(CC=C)=O)=O,,,5,1,1,0,1
35366_0,,,,2,1,2,3
35367_0,,,,2,1,2,3
35368_0,,,,2,1,2,3
35370_0,,,,2,1,2,3
C(C(C=O)(C(CCO)=O)O)=O,,,5,1,1,0,1
35372_0,,,,2,1,2,3
C(C(C=O)C(C(CO)O)=O)=O,,,5,1,1,0,1
35373_0,,,,2,1,2,3
35375_0,,,,2,1,2,3
C(C(C=O)(C(C)=O)O)=O,,,5,1,1,0,1
35377_0,,,,2,1,2,3
C(C(C=O)C(CO)=O)=O,,,5,1,1,0,1
35379_0,,,,2,1,2,3
C(C(C=O)(CC(C)=O)O)=O,,,5,1,1,0,1
35381_0,,,,2,1,2,3
C(C(C=O)(C(CC)=O)O)=O,,,5,1,1,0,1
35383_0,,,,2,1,2,3
C(C(C=O)C(C(C)O)=O)=O,,,5,1,1,0,1
35385_0,,,,2,1,2,3
C(C(C=O)C(C(O)=O)=O)=O,,,5,1,3,0,3
35387_0,,,,2,1,2,3
C(C(C=O)C(C)=O)=O,,,5,1,1,0,1
35389_0,,,,2,1,2,3
C(C(C=O)C(CC(C)O)=O)=O,,,5,1,1,0,1
35391_0,,,,2,1,2,3
C(C(C=O)C(CC(O)=O)=O)=O,,,5,1,1,0,1
35392_0,,,,2,1,2,3
35393_0,,,,2,1,2,3
35394_0,,,,2,1,2,3
35395_0,,,,2,1,2,3
35396_0,,,,2,1,2,3
35398_0,,,,2,1,2,3
C(C(C=O)(C(CC=O)=O)O)(O)=O,,,5,1,1,0,1
35399_0,,,,2,1,2,3
35400_0,,,,2,1,2,3
35402_0,,,,2,1,2,3
C(C(C(C(C=O)O)=O)CO)=O,,,5,1,1,0,1
35404_0,,,,2,1,2,3
C(C(C(CC=O)=O)(CO)O)=O,,,5,1,1,0,1
35405_0,,,,2,1,2,3
35406_0,,,,2,1,2,3
35407_0,,,,2,1,2,3
35409_0,,,,2,1,2,3
C(C(C(O)=O)C(C=CC)=O)=O,,,5,1,1,0,1
35411_0,,,,2,1,2,3
C(C(C(O)=O)C(CC=C)=O)=O,,,5,1,1,0,1
35412_0,,,,2,1,2,3
35413_0,,,,2,1,2,3
35414_0,,,,2,1,2,3
35416_0,,,,2,1,2,3
C(C(C=O)(C(CCO)=O)O)(O)=O,,,5,1,1,0,1
35417_0,,,,2,1,2,3
35418_0,,,,2,1,2,3
35419_0,,,,2,1,2,3
35420_0,,,,2,1,2,3
35421_0,,,,2,1,2,3
35423_0,,,,2,1,2,3
C(C(C=O)(C(CC)=O)O)(O)=O,,,5,1,1,0,1
35424_0,,,,2,1,2,3
35425_0,,,,2,1,2,3
35426_0,,,,2,1,2,3
35428_0,,,,2,1,2,3
C(C(C=O)C(CC(C)O)=O)(O)=O,,,5,1,1,0,1
35429_0,,,,2,1,2,3
35430_0,,,,2,1,2,3
35431_0,,,,2,1,2,3
35432_0,,,,2,1,2,3
35433_0,,,,2,1,2,3
35434_0,,,,2,1,2,3
35435_0,,,,2,1,2,3
35437_0,,,,2,1,2,3
C(C(CO)C(C=O)C)(O)=O,,,5,1,1,0,1
35438_0,,,,2,1,2,3
35439_0,,,,2,1,2,3
35441_0,,,,2,1,2,3
C(C(CO)CC(CO)=O)(O)=O,,,5,1,1,0,1
35442_0,,,,2,1,2,3
35443_0,,,,2,1,2,3
35444_0,,,,2,1,2,3
35446_0,,,,2,1,2,3
C(C(CO)CC(C)=O)(O)=O,,,5,1,1,0,1
35448_0,,,,2,1,2,3
C(C(C(CC)=O)CO)(O)=O,,,5,1,1,0,1
35450_0,,,,2,1,2,3
C(C(C(C)O)C(C=O)CO)(O)=O,,,5,1,1,0,1
35452_0,,,,2,1,2,3
C(C(C(O)=O)C(C=O)CO)(O)=O,,,5,1,1,0,1
35453_0,,,,2,1,2,3
35454_0,,,,2,1,2,3
35456_0,,,,2,1,2,3
C(C(C(C)O)C(C=O)C)(O)=O,,,5,1,1,0,1
35458_0,,,,2,1,2,3
C(C(C)C(C(O)=O)C(O)=O)=O,,,5,1,1,0,1
35459_0,,,,2,1,2,3
35461_0,,,,2,1,2,3
C(C(C)C(C(O)=O)(C(C)O)O)=O,,,5,1,1,0,1
35462_0,,,,2,1,2,3
35464_0,,,,2,1,2,3
C(C(C)C(C(C)=O)(C(O)=O)C)=O,,,5,1,1,0,1
35465_0,,,,2,1,2,3
35467_0,,,,2,1,2,3
C(C(C)C(C=O)(CO)O)=O,,,5,1,1,0,1
35468_0,,,,2,1,2,3
35469_0,,,,2,1,2,3
35470_0,,,,2,1,2,3
35471_0,,,,2,1,2,3
35472_0,,,,2,1,2,3
35473_0,,,,2,1,2,3
35475_0,,,,2,1,2,3
C(C(C(C)O)CC(C)=O)(O)=O,,,5,1,2,0,2
35477_0,,,,2,1,2,3
C(C(C(CC)=O)C(C)O)(O)=O,,,5,1,1,0,1
35478_0,,,,2,1,2,3
35479_0,,,,2,1,2,3
35480_0,,,,2,1,2,3
35481_0,,,,2,1,2,3
35482_0,,,,2,1,2,3
35483_0,,,,2,1,2,3
35485_0,,,,2,1,2,3
C(C(C(O)=O)CC(C)=O)(O)=O,,,5,1,2,0,2
35487_0,,,,2,1,2,3
C(CC)(C(C(O)=O)C(O)=O)=O,,,5,1,1,0,1
35489_0,,,,2,1,2,3
C(C(C(CO)=O)C(C(O)=O)O)=O,,,5,1,2,0,2
35490_0,,,,2,1,2,3
35491_0,,,,2,1,2,3
35492_0,,,,2,1,2,3
35493_0,,,,2,1,2,3
35494_0,,,,2,1,2,3
35496_0,,,,2,1,2,3
C(C(C(C(C)=O)C(C)=O)O)(O)=O,,,5,1,1,0,1
35497_0,,,,2,1,2,3
35498_0,,,,2,1,2,3
35500_0,,,,2,1,2,3
C(C(C(C)=O)C(C(O)=O)O)=O,,,5,1,1,0,1
35501_0,,,,2,1,2,3
35502_0,,,,2,1,2,3
35504_0,,,,2,1,2,3
C(C(C(C=CC)=O)C(C)O)(O)=O,,,5,1,1,0,1
35505_0,,,,2,1,2,3
35507_0,,,,2,1,2,3
C(C(C(CC=C)=O)C(C)O)(O)=O,,,5,1,1,0,1
35508_0,,,,2,1,2,3
35509_0,,,,2,1,2,3
35510_0,,,,2,1,2,3
35511_0,,,,2,1,2,3
35512_0,,,,2,1,2,3
35513_0,,,,2,1,2,3
35514_0,,,,2,1,2,3
35515_0,,,,2,1,2,3
35516_0,,,,2,1,2,3
35517_0,,,,2,1,2,3
35518_0,,,,2,1,2,3
35519_0,,,,2,1,2,3
35520_0,,,,2,1,2,3
35522_0,,,,2,1,2,3
C(C(C(O)=O)C(C=CC)=O)(O)=O,,,5,1,1,0,1
35524_0,,,,2,1,2,3
C(C(C(O)=O)C(CC=C)=O)(O)=O,,,5,1,1,0,1
35525_0,,,,2,1,2,3
35526_0,,,,2,1,2,3
35527_0,,,,2,1,2,3
35528_0,,,,2,1,2,3
35529_0,,,,2,1,2,3
35530_0,,,,2,1,2,3
35531_0,,,,2,1,2,3
35533_0,,,,2,1,2,3
C(C)(C(C(O)=O)(CO)CC=O)=O,,,5,1,1,0,1
35535_0,,,,2,1,2,3
C(C(C(C)=O)(C(C)=O)CO)(O)=O,,,5,1,1,0,1
35537_0,,,,2,1,2,3
C(C)(C(C(O)=O)(C)CC=O)=O,,,5,1,2,0,2
35539_0,,,,2,1,2,3
C(C)(C(C(C)=O)(C(O)=O)C)=O,,,5,1,1,0,1
35541_0,,,,2,1,2,3
C(C)(C(C(O)=O)(C)CC(C)=O)=O,,,5,1,1,0,1
35543_0,,,,2,1,2,3
C(CC)(C(C(C)=O)(C(O)=O)C)=O,,,5,1,1,0,1
35544_0,,,,2,1,2,3
35546_0,,,,2,1,2,3
C(C(C(C=CC)=O)CO)=O,,,5,1,1,0,1
35547_0,,,,2,1,2,3
35549_0,,,,2,1,2,3
C(C(C(C=CC)=O)CO)(O)=O,,,5,1,2,0,2
35550_0,,,,2,1,2,3
35552_0,,,,2,1,2,3
C(C(C(CC=C)=O)CO)=O,,,5,1,1,0,1
35553_0,,,,2,1,2,3
35555_0,,,,2,1,2,3
C(C(C(CC=C)=O)CO)(O)=O,,,5,1,2,0,2
35556_0,,,,2,1,2,3
35557_0,,,,2,1,2,3
35558_0,,,,2,1,2,3
35559_0,,,,2,1,2,3
35560_0,,,,2,1,2,3
35561_0,,,,2,1,2,3
35562_0,,,,2,1,2,3
35564_0,,,,2,1,2,3
C(C(C(CCO)=O)(CO)O)=O,,,5,1,1,0,1
35565_0,,,,2,1,2,3
35566_0,,,,2,1,2,3
35567_0,,,,2,1,2,3
35568_0,,,,2,1,2,3
35569_0,,,,2,1,2,3
35570_0,,,,2,1,2,3
35572_0,,,,2,1,2,3
C(C(CO)(CC(C)=O)O)=O,,,5,1,1,0,1
35574_0,,,,2,1,2,3
C(C(C(CC)=O)(CO)O)=O,,,5,1,1,0,1
35575_0,,,,2,1,2,3
35576_0,,,,2,1,2,3
35577_0,,,,2,1,2,3
35578_0,,,,2,1,2,3
35580_0,,,,2,1,2,3
C(C(C(CC(C)O)=O)CO)=O,,,5,1,1,0,1
35581_0,,,,2,1,2,3
35582_0,,,,2,1,2,3
35583_0,,,,2,1,2,3
35584_0,,,,2,1,2,3
35585_0,,,,2,1,2,3
35586_0,,,,2,1,2,3
35587_0,,,,2,1,2,3
35588_0,,,,2,1,2,3
35589_0,,,,2,1,2,3
35590_0,,,,2,1,2,3
35591_0,,,,2,1,2,3
35593_0,,,,2,1,2,3
C(C(C(CCO)=O)(CO)O)(O)=O,,,5,1,1,0,1
35595_0,,,,2,1,2,3
C(C([C](C(O)=O)O)CC=O)(O)=O,,,5,1,1,0,1
35596_0,,,,2,1,2,3
35598_0,,,,2,1,2,3
C(C(C(C(O)=O)CC=O)O)(O)=O,,,5,1,2,0,2
35599_0,,,,2,1,2,3
35600_0,,,,2,1,2,3
35601_0,,,,2,1,2,3
35602_0,,,,2,1,2,3
35603_0,,,,2,1,2,3
35605_0,,,,2,1,2,3
C(C(C(C)O)C(C=O)C(C)=O)=O,,,5,1,1,0,1
35607_0,,,,2,1,2,3
C(C(C(C(CO)C(C)O)=O)C)=O,,,5,1,1,0,1
35609_0,,,,2,1,2,3
C(C(CC(CO)C(C)O)=O)(O)=O,,,5,1,1,0,1
35610_0,,,,2,1,2,3
35612_0,,,,2,1,2,3
C(C(C(O)=O)C(C=O)C(C)=O)=O,,,5,1,1,0,1
35614_0,,,,2,1,2,3
C(C(C(C(C=O)C)=O)CO)(O)=O,,,5,1,1,0,1
35615_0,,,,2,1,2,3
35617_0,,,,2,1,2,3
C(CC(C(CO)=O)C(C=O)=O)=O,,,5,1,1,0,1
35618_0,,,,2,1,2,3
35619_0,,,,2,1,2,3
35621_0,,,,2,1,2,3
C(CC(C(CO)=O)C(CO)=O)=O,,,5,1,1,0,1
35622_0,,,,2,1,2,3
35623_0,,,,2,1,2,3
35624_0,,,,2,1,2,3
35626_0,,,,2,1,2,3
C(C(C(C(C(CO)O)=O)=O)C)=O,,,5,1,1,0,1
35627_0,,,,2,1,2,3
35628_0,,,,2,1,2,3
35629_0,,,,2,1,2,3
35630_0,,,,2,1,2,3
35631_0,,,,2,1,2,3
35632_0,,,,2,1,2,3
35633_0,,,,2,1,2,3
35635_0,,,,2,1,2,3
C(C(C)(CC(C(C=O)C)=O)O)=O,,,5,1,1,0,1
35637_0,,,,2,1,2,3
C(C(C)(CCC(C(O)=O)=O)O)=O,,,5,1,2,0,2
35638_0,,,,2,1,2,3
35640_0,,,,2,1,2,3
C(C(C)(CC=O)O)(C(C=O)C)=O,,,5,1,1,0,1
35642_0,,,,2,1,2,3
C(C(C)CC=O)(C(C=O)(C)O)=O,,,5,1,1,0,1
35644_0,,,,2,1,2,3
C(C(C(C)=O)CC(C=O)=O)=O,,,5,1,1,0,1
35646_0,,,,2,1,2,3
C(C)(C(C(CCO)=O)CC=O)=O,,,5,1,1,0,1
35648_0,,,,2,1,2,3
C(CC(C(C)=O)(C(C=O)C)O)=O,,,5,1,1,0,1
35650_0,,,,2,1,2,3
C(CC(C(C)=O)C(C=CC)=O)=O,,,5,1,1,0,1
35652_0,,,,2,1,2,3
C(CC=C)(C(C(C)=O)CC=O)=O,,,5,1,1,0,1
35653_0,,,,2,1,2,3
35655_0,,,,2,1,2,3
C(CC(C(C)=O)(C(C)=O)O)=O,,,5,1,1,0,1
35656_0,,,,2,1,2,3
35658_0,,,,2,1,2,3
C(CC(C(C)=O)(CC(C)=O)O)=O,,,5,1,1,0,1
35660_0,,,,2,1,2,3
C(C)(C(C(CC)=O)(CC=O)O)=O,,,5,1,1,0,1
35662_0,,,,2,1,2,3
C(C)(C(C(C(C)O)=O)CC=O)=O,,,5,1,1,0,1
35664_0,,,,2,1,2,3
C(CC(C(C)=O)C(C(O)=O)=O)=O,,,5,1,1,0,1
35666_0,,,,2,1,2,3
C(C(C(C)=O)CC=O)=O,,,5,1,1,0,1
35668_0,,,,2,1,2,3
C(CC(C(C)=O)O)(C(C=O)C)=O,,,5,1,1,0,1
35670_0,,,,2,1,2,3
C(C)(C(CCC(C(O)=O)=O)O)=O,,,5,1,2,0,2
35671_0,,,,2,1,2,3
35673_0,,,,2,1,2,3
C(C(C)C(C=O)(C)O)(CC=O)=O,,,5,1,1,0,1
35675_0,,,,2,1,2,3
C(C(C(C)=O)CC(C(O)=O)=O)=O,,,5,1,1,0,1
35677_0,,,,2,1,2,3
C(C(C(C(O)=O)=O)CCO)=O,,,5,1,1,0,1
35679_0,,,,2,1,2,3
C(C(C(C(CCO)=O)=O)C)=O,,,5,1,1,0,1
35681_0,,,,2,1,2,3
C(C(C(C(O)=O)=O)CC(C)O)=O,,,5,1,1,0,1
35683_0,,,,2,1,2,3
C(C(C(C(CC(C)O)=O)=O)C)=O,,,5,1,1,0,1
35685_0,,,,2,1,2,3
C(C(C(C(O)=O)=O)CC(O)=O)=O,,,5,1,1,0,1
35687_0,,,,2,1,2,3
C(C(C(C(CC(O)=O)=O)=O)C)=O,,,5,1,1,0,1
35689_0,,,,2,1,2,3
C(CCO)(C(C(C(C)=O)=O)C)=O,,,5,1,1,0,1
35691_0,,,,2,1,2,3
C(C(C(CCO)=O)C)=O,,,5,1,1,0,1
35692_0,,,,2,1,2,3
35693_0,,,,2,1,2,3
35694_0,,,,2,1,2,3
35695_0,,,,2,1,2,3
35697_0,,,,2,1,2,3
C(CC=O)(C(C(C(O)=O)=O)C)=O,,,5,1,1,0,1
35699_0,,,,2,1,2,3
C(C(C(CC(C(C)=O)=O)=O)C)=O,,,5,1,1,0,1
35701_0,,,,2,1,2,3
C(C(CCC(C(C)=O)=O)=O)(O)=O,,,5,1,1,0,1
35702_0,,,,2,1,2,3
35704_0,,,,2,1,2,3
C(C(C(C(C(CO)=O)=O)C)=O)=O,,,5,1,1,0,1
35706_0,,,,2,1,2,3
C(CC(C(C(CO)=O)=O)(C)O)=O,,,5,1,1,0,1
35708_0,,,,2,1,2,3
C(C)(C(C(C(CO)=O)=O)(C)O)=O,,,5,1,1,0,1
35710_0,,,,2,1,2,3
C(CO)(C(C(C(CO)=O)=O)C)=O,,,5,1,1,0,1
35712_0,,,,2,1,2,3
C(C)(C(C(C(CO)=O)=O)C)=O,,,5,1,1,0,1
35713_0,,,,2,1,2,3
35715_0,,,,2,1,2,3
C(C(C(C(C(C)=O)=O)C)=O)=O,,,5,1,1,0,1
35717_0,,,,2,1,2,3
C(C(C)C(C(C(C)=O)=O)(C)O)=O,,,5,1,1,0,1
35719_0,,,,2,1,2,3
C(C)=CC(C(C(C(C)=O)=O)C)=O,,,5,1,1,0,1
35721_0,,,,2,1,2,3
C(CC=C)(C(C(C(C)=O)=O)C)=O,,,5,1,1,0,1
35723_0,,,,2,1,2,3
C(CC(C(C(C)=O)=O)(C)O)=O,,,5,1,1,0,1
35725_0,,,,2,1,2,3
C(C)(C(C(C(C)=O)=O)(C)O)=O,,,5,1,1,0,1
35727_0,,,,2,1,2,3
C(CO)(C(C(C(C)=O)=O)C)=O,,,5,1,1,0,1
35729_0,,,,2,1,2,3
C(CC(C(C(C)=O)=O)(C)O)(C)=O,,,5,1,1,0,1
35731_0,,,,2,1,2,3
C(CC)(C(C(C(C)=O)=O)(C)O)=O,,,5,1,1,0,1
35732_0,,,,2,1,2,3
35733_0,,,,2,1,2,3
35735_0,,,,2,1,2,3
C(C)(C(C(C(C)=O)=O)C)=O,,,5,1,1,0,1
35737_0,,,,2,1,2,3
C(C(C)=O)(C(C(C(C)=O)=O)C)=O,,,5,1,1,0,1
35738_0,,,,2,1,2,3
35740_0,,,,2,1,2,3
C(C(C)(C(C(C)=O)C(C)=O)O)=O,,,5,1,1,0,1
35742_0,,,,2,1,2,3
C(C(C)O)(C(C(C(O)=O)=O)C)=O,,,5,1,1,0,1
35744_0,,,,2,1,2,3
C(C(O)=O)(C(C(C(O)=O)=O)C)=O,,,5,1,1,0,1
35746_0,,,,2,1,2,3
C(C(C(O)=O)CC(C(C)=O)=O)=O,,,5,1,1,0,1
35748_0,,,,2,1,2,3
C(C(C(C(C=O)O)=O)C)=O,,,5,1,1,0,1
35750_0,,,,2,1,2,3
C(C(C(CC=O)=O)(C)O)=O,,,5,1,1,0,1
35751_0,,,,2,1,2,3
35752_0,,,,2,1,2,3
35753_0,,,,2,1,2,3
35754_0,,,,2,1,2,3
35756_0,,,,2,1,2,3
C(C(C)C(C=O)(C)O)=O,,,5,1,1,0,1
35758_0,,,,2,1,2,3
C(C(C(C(C(O)=O)(C)O)=O)C)=O,,,5,1,1,0,1
35760_0,,,,2,1,2,3
C(C(C(C(C=O)(C)O)=O)C)(O)=O,,,5,1,1,0,1
35762_0,,,,2,1,2,3
C(C(C)C(C(C(O)=O)=O)C)(O)=O,,,5,1,1,0,1
35764_0,,,,2,1,2,3
C(C(C(C=CC)=O)C)=O,,,5,1,1,0,1
35766_0,,,,2,1,2,3
C(C(C(C=CC)=O)C)(O)=O,,,5,1,3,0,3
35768_0,,,,2,1,2,3
C(CC(C(O)=O)=O)=CC,,,5,1,2,0,2
35770_0,,,,2,1,2,3
C(CC(C=CC)=O)(O)=O,,,5,1,2,0,2
35772_0,,,,2,1,2,3
C(C(C(CC=C)=O)C)=O,,,5,1,1,0,1
35774_0,,,,2,1,2,3
C(CC=C)(C(C(O)=O)C)=O,,,5,1,2,0,2
35776_0,,,,2,1,2,3
C=CCCC(C(O)=O)=O,,,5,1,2,0,2
35778_0,,,,2,1,2,3
C(CC(CC=C)=O)(O)=O,,,5,1,2,0,2
35780_0,,,,2,1,2,3
C(C(C=CC)C(C(O)=O)=O)(O)=O,,,5,1,1,0,1
35782_0,,,,2,1,2,3
C(C(C(C(O)=O)=O)CC=C)(O)=O,,,5,1,1,0,1
35784_0,,,,2,1,2,3
C(C(C(CC(C(O)=O)=C)=O)C)=O,,,5,1,1,0,1
35786_0,,,,2,1,2,3
C=C(C(O)=O)CCC(C(O)=O)=O,,,5,1,1,0,1
35788_0,,,,2,1,2,3
C(CC(CC(C(O)=O)=C)=O)(O)=O,,,5,1,1,0,1
35790_0,,,,2,1,2,3
C(C(C(C=C(C(O)=O)C)=O)C)=O,,,5,1,1,0,1
35792_0,,,,2,1,2,3
C(CC(C(O)=O)=O)=C(C(O)=O)C,,,5,1,1,0,1
35794_0,,,,2,1,2,3
C(CC(C=C(C(O)=O)C)=O)(O)=O,,,5,1,1,0,1
35796_0,,,,2,1,2,3
C(C(C(O)=O)C=C(C(O)=O)C)=O,,,5,1,1,0,1
35798_0,,,,2,1,2,3
C(C(C(O)=O)CC(C(O)=O)=C)=O,,,5,1,1,0,1
35799_0,,,,2,1,2,3
35800_0,,,,2,1,2,3
35801_0,,,,2,1,2,3
35803_0,,,,2,1,2,3
C(C(C(C(CO)O)=O)C)=O,,,5,1,1,0,1
35805_0,,,,2,1,2,3
C(C(C(CCO)=O)(C)O)=O,,,5,1,1,0,1
35806_0,,,,2,1,2,3
35807_0,,,,2,1,2,3
35808_0,,,,2,1,2,3
35809_0,,,,2,1,2,3
35810_0,,,,2,1,2,3
35811_0,,,,2,1,2,3
35812_0,,,,2,1,2,3
35813_0,,,,2,1,2,3
35814_0,,,,2,1,2,3
35815_0,,,,2,1,2,3
35816_0,,,,2,1,2,3
35817_0,,,,2,1,2,3
35819_0,,,,2,1,2,3
C(C(C(CO)=O)C)=O,,,5,1,1,0,1
35820_0,,,,2,1,2,3
35821_0,,,,2,1,2,3
35823_0,,,,2,1,2,3
C(C(C(CO)=O)CC(C)O)(O)=O,,,5,1,1,0,1
35825_0,,,,2,1,2,3
C(C(C(C)=O)(CC(C)O)O)(O)=O,,,5,1,1,0,1
35826_0,,,,2,1,2,3
35828_0,,,,2,1,2,3
C(C(C(CO)=O)CC(O)=O)(O)=O,,,5,1,1,0,1
35829_0,,,,2,1,2,3
35831_0,,,,2,1,2,3
C1(C(C(C(O)=O)=O)CC(C)O1)=O,,,5,1,1,0,1
35833_0,,,,2,1,2,3
C1(C(C(C(O)=O)=O)CC(O1)=O)=O,,,5,1,1,0,1
35835_0,,,,2,1,2,3
C(C1C(OC(C(O)=O)(C)C1)=O)=O,,,5,1,1,0,1
35837_0,,,,2,1,2,3
C1(C(C=O)CC(C(O1)=O)(C)O)=O,,,5,1,1,0,1
35838_0,,,,2,1,2,3
35839_0,,,,2,1,2,3
35841_0,,,,2,1,2,3
C(C(C(C)=O)C[CH]C(O)=O)(O)=O,,,5,1,3,0,3
35843_0,,,,2,1,2,3
C(C)(C(C(O)=O)CCC(O)=O)=O,,,5,1,3,0,3
35845_0,,,,2,1,2,3
C(C(C(CC[CH]C(O)=O)=O)C)=O,,,5,1,1,0,1
35847_0,,,,2,1,2,3
[CH](C(O)=O)CCCC(C(O)=O)=O,,,5,1,2,0,2
35849_0,,,,2,1,2,3
C(CC(CC[CH]C(O)=O)=O)(O)=O,,,5,1,2,0,2
35851_0,,,,2,1,2,3
C(C(C(O)=O)CC[CH]C(O)=O)=O,,,5,1,2,0,2
35853_0,,,,2,1,2,3
C(C(C(CCCC(O)=O)=O)C)=O,,,5,1,1,0,1
35855_0,,,,2,1,2,3
C(CCCCC(C(O)=O)=O)(O)=O,,,5,1,2,0,2
35857_0,,,,2,1,2,3
C(CCCC(O)=O)(CC(O)=O)=O,,,5,1,2,0,2
35859_0,,,,2,1,2,3
C(C(C(O)=O)CCCC(O)=O)=O,,,5,1,2,0,2
35861_0,,,,2,1,2,3
C(C(C)(CC(C)=O)O)=O,,,5,1,1,0,1
35863_0,,,,2,1,2,3
C(C(C(CC)=O)(C)O)=O,,,5,1,1,0,1
35865_0,,,,2,1,2,3
C(C(C(C(C)O)=O)C)=O,,,5,1,1,0,1
35867_0,,,,2,1,2,3
C(C(C(C)=O)C)=O,,,5,1,1,0,1
35869_0,,,,2,1,2,3
C(C(C(CC(C)O)=O)C)=O,,,5,1,1,0,1
35871_0,,,,2,1,2,3
C(C(C(CC(O)=O)=O)C)=O,,,5,1,1,0,1
35873_0,,,,2,1,2,3
C(C(C=O)C)=O,,,5,1,2,0,2
35875_0,,,,2,1,2,3
C(C(C)(CC(C)=O)O)(O)=O,,,5,1,1,0,1
35877_0,,,,2,1,2,3
C(C(C(C(C)O)=O)C)(O)=O,,,5,1,1,0,1
35879_0,,,,2,1,2,3
C(C(C(CC)=O)(C)O)(O)=O,,,5,1,1,0,1
35881_0,,,,2,1,2,3
C(C(C(C)=O)CC(C)O)(O)=O,,,5,1,2,0,2
35883_0,,,,2,1,2,3
C(C(C=O)CC(C)O)(O)=O,,,5,1,2,0,2
35884_0,,,,2,1,2,3
35885_0,,,,2,1,2,3
35886_0,,,,2,1,2,3
35888_0,,,,2,1,2,3
C1(C(C(C(O1)=O)=O)C)=O,,,5,1,2,0,2
35889_0,,,,2,1,2,3
35891_0,,,,2,1,2,3
C(C(C=O)C(C=O)=CC)=O,,,5,1,2,0,2
35893_0,,,,2,1,2,3
C(C(C(O)=O)C(C=O)=CC)=O,,,5,1,2,0,2
35894_0,,,,2,1,2,3
35895_0,,,,2,1,2,3
35896_0,,,,2,1,2,3
35898_0,,,,2,1,2,3
C(C(C=O)C(C(O)=O)=C)=O,,,5,1,2,0,2
35899_0,,,,2,1,2,3
35900_0,,,,2,1,2,3
35901_0,,,,2,1,2,3
35902_0,,,,2,1,2,3
35903_0,,,,2,1,2,3
35904_0,,,,2,1,2,3
35906_0,,,,2,1,2,3
C1(CC(C(C(O1)=O)=C)=O)=O,,,5,1,3,0,3
35907_0,,,,2,1,2,3
35909_0,,,,2,1,2,3
C(C1C(OC(C1=C)=O)=O)=O,,,5,1,3,0,3
35910_0,,,,2,1,2,3
35911_0,,,,2,1,2,3
35913_0,,,,2,1,2,3
C(CC(C)O)(C(CO)C(C)O)=O,,,5,1,1,0,1
35914_0,,,,2,1,2,3
35916_0,,,,2,1,2,3
C(C(C(CCC(C)O)=O)O)=O,,,5,1,1,0,1
35917_0,,,,2,1,2,3
35919_0,,,,2,1,2,3
C(CC(C=O)O)(CC(C)O)=O,,,5,1,2,0,2
35921_0,,,,2,1,2,3
C(C)(C(CC(C)O)O)=O,,,5,1,1,0,1
35923_0,,,,2,1,2,3
C(CO)(CCC(C)O)=O,,,5,1,1,0,1
35924_0,,,,2,1,2,3
35925_0,,,,2,1,2,3
35926_0,,,,2,1,2,3
35927_0,,,,2,1,2,3
35928_0,,,,2,1,2,3
35929_0,,,,2,1,2,3
35930_0,,,,2,1,2,3
35931_0,,,,2,1,2,3
35933_0,,,,2,1,2,3
C(C(C=O)C(CO)(C(C)O)O)=O,,,5,1,2,0,2
35934_0,,,,2,1,2,3
35935_0,,,,2,1,2,3
35936_0,,,,2,1,2,3
35937_0,,,,2,1,2,3
35938_0,,,,2,1,2,3
35939_0,,,,2,1,2,3
35940_0,,,,2,1,2,3
35941_0,,,,2,1,2,3
35942_0,,,,2,1,2,3
35943_0,,,,2,1,2,3
35944_0,,,,2,1,2,3
35945_0,,,,2,1,2,3
35946_0,,,,2,1,2,3
35947_0,,,,2,1,2,3
35948_0,,,,2,1,2,3
35949_0,,,,2,1,2,3
35950_0,,,,2,1,2,3
35951_0,,,,2,1,2,3
35952_0,,,,2,1,2,3
35953_0,,,,2,1,2,3
35954_0,,,,2,1,2,3
35955_0,,,,2,1,2,3
35956_0,,,,2,1,2,3
35957_0,,,,2,1,2,3
35958_0,,,,2,1,2,3
35959_0,,,,2,1,2,3
35961_0,,,,2,1,2,3
C(C(C)(CC(C(C)=O)O)O)(O)=O,,,5,1,1,0,1
35963_0,,,,2,1,2,3
C(C(C)(CCC(CO)=O)O)(O)=O,,,5,1,1,0,1
35964_0,,,,2,1,2,3
35965_0,,,,2,1,2,3
35966_0,,,,2,1,2,3
35967_0,,,,2,1,2,3
35969_0,,,,2,1,2,3
C(CC(C[C](C(O)=O)O)=O)=O,,,5,1,2,0,2
35970_0,,,,2,1,2,3
35972_0,,,,2,1,2,3
C(C)(C(C([CH]C(O)=O)=O)O)=O,,,5,1,1,0,1
35974_0,,,,2,1,2,3
C(C)(CC([C](C(O)=O)O)=O)=O,,,5,1,2,0,2
35975_0,,,,2,1,2,3
35977_0,,,,2,1,2,3
C(CC(CC(C(O)=O)O)=O)=O,,,5,1,2,0,2
35978_0,,,,2,1,2,3
35979_0,,,,2,1,2,3
35980_0,,,,2,1,2,3
35982_0,,,,2,1,2,3
C1(CC(C(C(C)=O)(O)O1)=O)=O,,,5,1,2,0,2
35983_0,,,,2,1,2,3
35984_0,,,,2,1,2,3
35986_0,,,,2,1,2,3
C(CC1(CC(C(O1)=O)=O)O)=O,,,5,1,2,0,2
35987_0,,,,2,1,2,3
35988_0,,,,2,1,2,3
35990_0,,,,2,1,2,3
C1(CC(C(C(C)(O)O1)=O)=O)=O,,,5,1,2,0,2
35991_0,,,,2,1,2,3
35993_0,,,,2,1,2,3
C1(C(C(CC(C)(O)O1)=O)=O)=O,,,5,1,2,0,2
35994_0,,,,2,1,2,3
35996_0,,,,2,1,2,3
C1(C(C)OC(C(C1O)=O)=O)=O,,,5,1,2,0,2
35997_0,,,,2,1,2,3
35998_0,,,,2,1,2,3
35999_0,,,,2,1,2,3
36000_0,,,,2,1,2,3
36002_0,,,,2,1,2,3
C(C)(C(CO)C[CH]C(O)=O)=O,,,5,1,2,0,2
36003_0,,,,2,1,2,3
36005_0,,,,2,1,2,3
C(CCC(C(C)=O)CO)(O)=O,,,5,1,2,0,2
36007_0,,,,2,1,2,3
C(C)(C(CC[CH]C(O)=O)O)=O,,,5,1,2,0,2
36009_0,,,,2,1,2,3
C(CO)(CCC[CH]C(O)=O)=O,,,5,1,2,0,2
36010_0,,,,2,1,2,3
36012_0,,,,2,1,2,3
C(CC[CH]C(O)=O)(CCO)=O,,,5,1,2,0,2
36014_0,,,,2,1,2,3
C(CCCC(C(C)=O)O)(O)=O,,,5,1,2,0,2
36016_0,,,,2,1,2,3
C(CCCCC(CO)=O)(O)=O,,,5,1,2,0,2
36017_0,,,,2,1,2,3
36019_0,,,,2,1,2,3
C(CCCC(CCO)=O)(O)=O,,,5,1,2,0,2
36021_0,,,,2,1,2,3
C(C)(C(C)(C[CH]C(O)=O)O)=O,,,5,1,2,0,2
36023_0,,,,2,1,2,3
C(CO)(C(C)C[CH]C(O)=O)=O,,,5,1,2,0,2
36024_0,,,,2,1,2,3
36026_0,,,,2,1,2,3
C(CCC(C(C)=O)(C)O)(O)=O,,,5,1,2,0,2
36028_0,,,,2,1,2,3
C(CCC(C(CO)=O)C)(O)=O,,,5,1,2,0,2
36029_0,,,,2,1,2,3
36031_0,,,,2,1,2,3
C(CC(C[CH]C(O)=O)=O)=O,,,5,1,1,0,1
36032_0,,,,2,1,2,3
36034_0,,,,2,1,2,3
C(CC(CCC(O)=O)=O)=O,,,5,1,1,0,1
36035_0,,,,2,1,2,3
36036_0,,,,2,1,2,3
36038_0,,,,2,1,2,3
C(C(C([CH]C(O)=O)=O)C)(O)=O,,,5,1,2,0,2
36039_0,,,,2,1,2,3
36040_0,,,,2,1,2,3
36041_0,,,,2,1,2,3
36043_0,,,,2,1,2,3
C(C1C(C(C=O)OC1C)O)=O,,,5,1,1,0,1
36045_0,,,,2,1,2,3
C(C1C(C(CO)OC1C)=O)=O,,,5,1,1,0,1
36047_0,,,,2,1,2,3
C(C1C(C)OC(C1C=O)O)=O,,,5,1,2,0,2
36049_0,,,,2,1,2,3
C1(C(CO)C(C=O)C(C)O1)=O,,,5,1,1,0,1
36051_0,,,,2,1,2,3
C(C1C(C)OC(C1C)=O)=O,,,5,1,2,0,2
36053_0,,,,2,1,2,3
C(C1C(C(C)OC1C)=O)=O,,,5,1,1,0,1
36055_0,,,,2,1,2,3
C1(C(C=O)C(C(O)O1)C(C)O)=O,,,5,1,2,0,2
36057_0,,,,2,1,2,3
C1(C(C=O)C(C(C=O)O1)O)=O,,,5,1,2,0,2
36059_0,,,,2,1,2,3
C1(C(C=O)C(C(CO)O1)=O)=O,,,5,1,2,0,2
36061_0,,,,2,1,2,3
C1(C(C=O)C(C=O)C(O)O1)=O,,,5,1,2,0,2
36063_0,,,,2,1,2,3
C1(C(C=O)C(C(O1)=O)CO)=O,,,5,1,1,0,1
36065_0,,,,2,1,2,3
C(C1C(OC(C1C)=O)=O)=O,,,5,1,1,0,1
36067_0,,,,2,1,2,3
C(C1C(C(C)OC1=O)=O)=O,,,5,1,2,0,2
36069_0,,,,2,1,2,3
C1(C(C=O)C(C(O)=O)C(O)O1)=O,,,5,1,2,0,2
36071_0,,,,2,1,2,3
C(C1(C(C(C=O)OC1)=O)O)=O,,,5,1,1,0,1
36073_0,,,,2,1,2,3
C(C1C(C(C=O)(O)OC1)=O)=O,,,5,1,2,0,2
36075_0,,,,2,1,2,3
C(C1(C(C(C(O)=O)OC1)=O)O)=O,,,5,1,1,0,1
36077_0,,,,2,1,2,3
C(C1C(C(C(O)=O)(O)OC1)=O)=O,,,5,1,2,0,2
36079_0,,,,2,1,2,3
C(C1C(C(C=O)(O)OC1)=O)(O)=O,,,5,1,2,0,2
36081_0,,,,2,1,2,3
C(C1(C(C(C=O)OC1)=O)O)(O)=O,,,5,1,1,0,1
36083_0,,,,2,1,2,3
C1(C(C=O)C(C(C=O)(O)O1)O)=O,,,5,1,2,0,2
36085_0,,,,2,1,2,3
C1(C(C(C(C=O)(O)O1)=O)CO)=O,,,5,1,2,0,2
36087_0,,,,2,1,2,3
C1(C(C(C(C=O)O1)=O)(CO)O)=O,,,5,1,2,0,2
36089_0,,,,2,1,2,3
C1(C(C(C(C=O)(O)O1)=O)C)=O,,,5,1,2,0,2
36091_0,,,,2,1,2,3
C1(C(C(C(C=O)O1)=O)(C)O)=O,,,5,1,3,0,3
36093_0,,,,2,1,2,3
C1(C(C=O)CC(C=O)(O)O1)=O,,,5,1,2,0,2
36095_0,,,,2,1,2,3
C1(C(C=O)CC(O)O1)=O,,,5,1,2,0,2
36097_0,,,,2,1,2,3
C1(C(C=O)CC(C(O)=O)(O)O1)=O,,,5,1,2,0,2
36099_0,,,,2,1,2,3
C1(C(C(C(C(O)=O)(O)O1)=O)C)=O,,,5,1,2,0,2
36101_0,,,,2,1,2,3
C1(C(C(C(C(O)=O)O1)=O)(C)O)=O,,,5,1,2,0,2
36103_0,,,,2,1,2,3
C1(C(C=O)C(C(C)(O)O1)=O)=O,,,5,1,2,0,2
36104_0,,,,2,1,2,3
36106_0,,,,2,1,2,3
C(C1(COC(C=O)C1O)O)(O)=O,,,5,1,1,0,1
36108_0,,,,2,1,2,3
C(C1C(C(CO)(O)OC1)=O)(O)=O,,,5,1,2,0,2
36110_0,,,,2,1,2,3
C(C1(C(C(CO)OC1)=O)O)(O)=O,,,5,1,1,0,1
36111_0,,,,2,1,2,3
36113_0,,,,2,1,2,3
C1(C(CO)(C(C(C=O)O1)O)O)=O,,,5,1,2,0,2
36115_0,,,,2,1,2,3
C1(C(C(C(CO)(O)O1)=O)CO)=O,,,5,1,2,0,2
36117_0,,,,2,1,2,3
C1(C(C(C(CO)O1)=O)(CO)O)=O,,,5,1,2,0,2
36119_0,,,,2,1,2,3
C(C1C(O)OCC1(C(O)=O)O)=O,,,5,1,2,0,2
36120_0,,,,2,1,2,3
36121_0,,,,2,1,2,3
36123_0,,,,2,1,2,3
C(C1C(O)OC(C1(CO)O)=O)=O,,,5,1,2,0,2
36124_0,,,,2,1,2,3
36126_0,,,,2,1,2,3
C1(C(C)C(C(O)=O)(CO1)O)=O,,,5,1,1,0,1
36127_0,,,,2,1,2,3
36129_0,,,,2,1,2,3
C1(C(C)C(C(O1)=O)(CO)O)=O,,,5,1,1,0,1
36131_0,,,,2,1,2,3
C(C1C(C(C)(O)OC1)=O)(O)=O,,,5,1,2,0,2
36133_0,,,,2,1,2,3
C(C1(C(C(C)OC1)=O)O)(O)=O,,,5,1,1,0,1
36134_0,,,,2,1,2,3
36136_0,,,,2,1,2,3
C1(C(C(C(C)(O)O1)=O)CO)=O,,,5,1,2,0,2
36138_0,,,,2,1,2,3
C1(C(C(C(C)O1)=O)(CO)O)=O,,,5,1,2,0,2
36140_0,,,,2,1,2,3
C1(C(CC(CO)(O)O1)=O)=O,,,5,1,2,0,2
36142_0,,,,2,1,2,3
C1(C(C(C(C=O)O1)O)O)=O,,,5,1,2,0,2
36143_0,,,,2,1,2,3
36145_0,,,,2,1,2,3
C1(C(C(C(CO)O1)=O)O)=O,,,5,1,2,0,2
36147_0,,,,2,1,2,3
C1(C(C)(C(C(C=O)O1)O)O)=O,,,5,1,2,0,2
36149_0,,,,2,1,2,3
C1(C(C(C(CO)(O)O1)=O)C)=O,,,5,1,2,0,2
36151_0,,,,2,1,2,3
C1(C(C(C(CO)O1)=O)(C)O)=O,,,5,1,2,0,2
36153_0,,,,2,1,2,3
C1(C(C(CO)C(O)O1)=O)=O,,,5,1,2,0,2
36155_0,,,,2,1,2,3
C(C1C(O)OC(C1O)=O)=O,,,5,1,2,0,2
36156_0,,,,2,1,2,3
36158_0,,,,2,1,2,3
C(C1C(O)OC(C1(C)O)=O)=O,,,5,1,2,0,2
36159_0,,,,2,1,2,3
36161_0,,,,2,1,2,3
C1(C(C(C)C(O)O1)=O)=O,,,5,1,2,0,2
36163_0,,,,2,1,2,3
C1(C(C)C(C(O1)=O)O)=O,,,5,1,1,0,1
36165_0,,,,2,1,2,3
C1(C(C)C(C(O1)=O)(C)O)=O,,,5,1,1,0,1
36167_0,,,,2,1,2,3
C1(C(CC(C)(O)O1)=O)=O,,,5,1,2,0,2
36169_0,,,,2,1,2,3
C1(CC(C(C)(O)O1)=O)=O,,,5,1,2,0,2
36170_0,,,,2,1,2,3
36172_0,,,,2,1,2,3
C1(C(C(C(C)(O)O1)=O)C)=O,,,5,1,2,0,2
36174_0,,,,2,1,2,3
C1(C(C(C(C)O1)=O)(C)O)=O,,,5,1,2,0,2
36176_0,,,,2,1,2,3
C(C1C(C(CC(C)O1)O)=O)=O,,,5,1,1,0,1
36178_0,,,,2,1,2,3
C(C1(C(CCC(C)O1)=O)O)=O,,,5,1,2,0,2
36180_0,,,,2,1,2,3
C1(CC(C=O)(O)OC(C)C1)=O,,,5,1,2,0,2
36182_0,,,,2,1,2,3
C(C1C(C(CC(C)O1)O)=O)(O)=O,,,5,1,1,0,1
36184_0,,,,2,1,2,3
C(C1(C(CCC(C)O1)=O)O)(O)=O,,,5,1,2,0,2
36186_0,,,,2,1,2,3
C1(CC(C(O)=O)(O)OC(C)C1)=O,,,5,1,2,0,2
36188_0,,,,2,1,2,3
C(C1C(C(CC(O1)=O)O)=O)=O,,,5,1,2,0,2
36190_0,,,,2,1,2,3
C(C1(C(CCC(O1)=O)=O)O)=O,,,5,1,2,0,2
36192_0,,,,2,1,2,3
C1(CC(CC(C=O)(O)O1)=O)=O,,,5,1,2,0,2
36194_0,,,,2,1,2,3
C(C1C(C(CC(O1)=O)O)=O)(O)=O,,,5,1,2,0,2
36196_0,,,,2,1,2,3
C(C1(C(CCC(O1)=O)=O)O)(O)=O,,,5,1,2,0,2
36198_0,,,,2,1,2,3
C1(CC(CC(C(O)=O)(O)O1)=O)=O,,,5,1,2,0,2
36200_0,,,,2,1,2,3
C1(C(C=O)OCC(C1O)=O)=O,,,5,1,1,0,1
36202_0,,,,2,1,2,3
C1(C(C=O)(O)OCC(C1)=O)=O,,,5,1,2,0,2
36203_0,,,,2,1,2,3
36205_0,,,,2,1,2,3
C1(C(C(CC(CO)(O)O1)=O)=O)=O,,,5,1,2,0,2
36207_0,,,,2,1,2,3
C(C1C(C(C(C(O1)=O)=O)O)O)=O,,,5,1,2,0,2
36209_0,,,,2,1,2,3
C1(C(CO)(O)OC(C(C1)=O)=O)=O,,,5,1,2,0,2
36211_0,,,,2,1,2,3
C1(C(CO)OC(C(C1O)=O)=O)=O,,,5,1,2,0,2
36213_0,,,,2,1,2,3
C1(C(C(O)=O)OCC(C1O)=O)=O,,,5,1,1,0,1
36215_0,,,,2,1,2,3
C1(C(C(O)=O)(O)OCC(C1)=O)=O,,,5,1,2,0,2
36216_0,,,,2,1,2,3
36218_0,,,,2,1,2,3
C(C1C(CC(C(O1)=O)=O)O)=O,,,5,1,2,0,2
36219_0,,,,2,1,2,3
36221_0,,,,2,1,2,3
C(C1C(C(C(O)OC1)=O)=O)=O,,,5,1,2,0,2
36223_0,,,,2,1,2,3
C1(C(C(C(CO)C(O)O1)=O)=O)=O,,,5,1,2,0,2
36225_0,,,,2,1,2,3
C(C1C(O)OC(C(C1O)=O)=O)=O,,,5,1,2,0,2
36227_0,,,,2,1,2,3
C1(C(CO)C(C(C(O1)=O)=O)O)=O,,,5,1,1,0,1
36229_0,,,,2,1,2,3
C(C1C(O)OC(C(C1)=O)=O)=O,,,5,1,2,0,2
36230_0,,,,2,1,2,3
36232_0,,,,2,1,2,3
C(C1C(C(C(O)OC1)=O)=O)(O)=O,,,5,1,2,0,2
36234_0,,,,2,1,2,3
C1(C(C=O)C(C(C(O)O1)=O)O)=O,,,5,1,2,0,2
36236_0,,,,2,1,2,3
C1(C(C(C(C(O)O1)=O)=O)CO)=O,,,5,1,2,0,2
36238_0,,,,2,1,2,3
C1(C(C(C(C(O)O1)=O)=O)C)=O,,,5,1,2,0,2
36240_0,,,,2,1,2,3
C1(C(C(C(C)C(O)O1)=O)=O)=O,,,5,1,2,0,2
36241_0,,,,2,1,2,3
36242_0,,,,2,1,2,3
36244_0,,,,2,1,2,3
C1(C(C)OC(C(C1)=O)=O)=O,,,5,1,2,0,2
36246_0,,,,2,1,2,3
C1(C(C=O)CC(C(O)O1)=O)=O,,,5,1,2,0,2
36248_0,,,,2,1,2,3
C(C1C(C[CH]C(O1)=O)=O)=O,,,5,1,2,0,2
36250_0,,,,2,1,2,3
C(C1C(CCC(O1)=O)=O)=O,,,5,1,2,0,2
36252_0,,,,2,1,2,3
C(C1C(C[CH]C(O1)=O)=O)(O)=O,,,5,1,2,0,2
36254_0,,,,2,1,2,3
C(C1C(CCC(O1)=O)=O)(O)=O,,,5,1,2,0,2
36256_0,,,,2,1,2,3
C1(C(C(O)OC(C)CC1)=O)=O,,,5,1,2,0,2
36258_0,,,,2,1,2,3
C1(CC(C)OC(C(C1)=O)O)=O,,,5,1,2,0,2
36260_0,,,,2,1,2,3
C1(CCC(C(C(O)O1)=O)=O)=O,,,5,1,2,0,2
36262_0,,,,2,1,2,3
C1(CC(CC(C(O)O1)=O)=O)=O,,,5,1,2,0,2
36264_0,,,,2,1,2,3
C1(COC(C(C(C1)=O)=O)O)=O,,,5,1,2,0,2
36265_0,,,,2,1,2,3
36267_0,,,,2,1,2,3
C(C1C(OC(C)C1C=O)=O)=O,,,5,1,2,0,2
36269_0,,,,2,1,2,3
C(C1C(OC(C1C=O)=O)=O)=O,,,5,1,2,0,2
36270_0,,,,2,1,2,3
36272_0,,,,2,1,2,3
C(C1C(C(OC1)=O)=O)=O,,,5,1,2,0,2
36273_0,,,,2,1,2,3
36274_0,,,,2,1,2,3
36275_0,,,,2,1,2,3
36276_0,,,,2,1,2,3
36278_0,,,,2,1,2,3
C(C1C(C(C(OC1)=O)=O)=O)=O,,,5,1,2,0,2
36280_0,,,,2,1,2,3
C(C1C(OC(C(C1)=O)=O)=O)=O,,,5,1,2,0,2
36282_0,,,,2,1,2,3
C1(C(C(C(C(O1)=O)=O)=O)C)=O,,,5,1,2,0,2
36283_0,,,,2,1,2,3
36285_0,,,,2,1,2,3
C1(C(C(CC(C)O1)=O)CO)=O,,,5,1,2,0,2
36286_0,,,,2,1,2,3
36288_0,,,,2,1,2,3
C1(C(C(CC(O1)=O)=O)CO)=O,,,5,1,2,0,2
36290_0,,,,2,1,2,3
C1(CC(C(C(O)=O)CO1)=O)=O,,,5,1,2,0,2
36291_0,,,,2,1,2,3
36293_0,,,,2,1,2,3
C1(C(C(C(CO1)=O)=O)CO)=O,,,5,1,2,0,2
36295_0,,,,2,1,2,3
C1(C(OC(C)CC1)=O)=O,,,5,1,2,0,2
36297_0,,,,2,1,2,3
C1(CC(C)OC(C1)=O)=O,,,5,1,2,0,2
36299_0,,,,2,1,2,3
C1(CC(C)OC(C1C)=O)=O,,,5,1,2,0,2
36301_0,,,,2,1,2,3
C1(CCC(C(O1)=O)=O)=O,,,5,1,3,0,3
36303_0,,,,2,1,2,3
C1(CC(CC(O1)=O)=O)=O,,,5,1,2,0,2
36305_0,,,,2,1,2,3
C1(CC(OC(C1C)=O)=O)=O,,,5,1,2,0,2
36306_0,,,,2,1,2,3
36308_0,,,,2,1,2,3
C1(CC(C(CO1)=O)=O)=O,,,5,1,2,0,2
36310_0,,,,2,1,2,3
C1(C(C(C(CO1)=O)=O)C)=O,,,5,1,2,0,2
36311_0,,,,2,1,2,3
36312_0,,,,2,1,2,3
36314_0,,,,2,1,2,3
C1(C(C(OC(C)CC1)=O)=O)=O,,,5,1,2,0,2
36316_0,,,,2,1,2,3
C1(CC(C)OC(C(C1)=O)=O)=O,,,5,1,2,0,2
36318_0,,,,2,1,2,3
C1(CCC(C(C(O1)=O)=O)=O)=O,,,5,1,2,0,2
36320_0,,,,2,1,2,3
C1(CC(CC(C(O1)=O)=O)=O)=O,,,5,1,2,0,2
36322_0,,,,2,1,2,3
C1(COC(C(C(C1)=O)=O)=O)=O,,,5,1,2,0,2
36323_0,,,,2,1,2,3
36325_0,,,,2,1,2,3
C1(CC(C[CH]C(O1)=O)=O)=O,,,5,1,2,0,2
36326_0,,,,2,1,2,3
36328_0,,,,2,1,2,3
C1(CC(CCC(O1)=O)=O)=O,,,5,1,2,0,2
36329_0,,,,2,1,2,3
36330_0,,,,2,1,2,3
36331_0,,,,2,1,2,3
36333_0,,,,2,1,2,3
C(CC(C=O)=O)(C[CH]C(O)=O)=O,,,5,1,1,0,1
36334_0,,,,2,1,2,3
36336_0,,,,2,1,2,3
C(CCC(O)=O)(CC(C=O)=O)=O,,,5,1,1,0,1
36337_0,,,,2,1,2,3
36339_0,,,,2,1,2,3
C(C(C(C=O)=O)C(C)CC=O)=O,,,5,1,2,0,2
36341_0,,,,2,1,2,3
C(C(C(O)=O)CC(C)CC=O)=O,,,5,1,2,0,2
36343_0,,,,2,1,2,3
C(C(C)CC=O)(C(C(O)=O)C)=O,,,5,1,1,0,1
36345_0,,,,2,1,2,3
C(C[CH]C(O)=O)(C(C(O)=O)C)=O,,,5,1,1,0,1
36347_0,,,,2,1,2,3
C(CCC(O)=O)(C(C(O)=O)C)=O,,,5,1,1,0,1
36349_0,,,,2,1,2,3
C(CC(C)CC(CC(O)=O)=O)=O,,,5,1,2,0,2
36351_0,,,,2,1,2,3
C(CC(C)CCC(C(O)=O)=O)=O,,,5,1,2,0,2
36353_0,,,,2,1,2,3
C(CC(C)C(C(C(O)=O)=O)C)=O,,,5,1,2,0,2
36355_0,,,,2,1,2,3
[CH](C(O)=O)CC(C(C(O)=O)=O)C,,,5,1,2,0,2
36357_0,,,,2,1,2,3
C(CCC(C(C(O)=O)=O)C)(O)=O,,,5,1,2,0,2
36359_0,,,,2,1,2,3
C(CC(C)C(C(C)=O)C(O)=O)=O,,,5,1,2,0,2
36360_0,,,,2,1,2,3
36362_0,,,,2,1,2,3
C(CC(C)C(C(C)=O)CO)=O,,,5,1,2,0,2
36364_0,,,,2,1,2,3
C(CC(C)CC(C(C)O)=O)=O,,,5,1,2,0,2
36366_0,,,,2,1,2,3
C(CC(C)C(C(CC)=O)O)=O,,,5,1,2,0,2
36368_0,,,,2,1,2,3
C(C(C)CC=O)(CC(C)O)=O,,,5,1,1,0,1
36370_0,,,,2,1,2,3
C(CC(C)C(CC(C)=O)O)=O,,,5,1,2,0,2
36372_0,,,,2,1,2,3
C(CC(C)CC(C(C)=O)O)=O,,,5,1,2,0,2
36374_0,,,,2,1,2,3
C(CC(C)CCC(CO)=O)=O,,,5,1,2,0,2
36375_0,,,,2,1,2,3
36377_0,,,,2,1,2,3
C(CC(C)CC(CCO)=O)=O,,,5,1,2,0,2
36379_0,,,,2,1,2,3
C(CC(C)C(C(C)=O)(C)O)=O,,,5,1,2,0,2
36381_0,,,,2,1,2,3
C(CC(C)C(C(CO)=O)C)=O,,,5,1,2,0,2
36382_0,,,,2,1,2,3
36383_0,,,,2,1,2,3
36384_0,,,,2,1,2,3
36386_0,,,,2,1,2,3
C(C(C=O)C(C)CC=O)=O,,,5,1,2,0,2
36388_0,,,,2,1,2,3
C(CC(C([CH]C(O)=O)=O)C)=O,,,5,1,1,0,1
36390_0,,,,2,1,2,3
C(C(C)CC=O)(CC(O)=O)=O,,,5,1,1,0,1
36391_0,,,,2,1,2,3
36392_0,,,,2,1,2,3
36393_0,,,,2,1,2,3
36394_0,,,,2,1,2,3
36396_0,,,,2,1,2,3
C(C)(C(C)CC(C(O)=O)=O)=O,,,5,1,1,0,1
36397_0,,,,2,1,2,3
36399_0,,,,2,1,2,3
C(CC(C(O)=O)CC(C)=O)=O,,,5,1,1,0,1
36400_0,,,,2,1,2,3
36401_0,,,,2,1,2,3
36402_0,,,,2,1,2,3
36404_0,,,,2,1,2,3
C(C(C(C)=O)C(C(O)=O)C)=O,,,5,1,1,0,1
36405_0,,,,2,1,2,3
36406_0,,,,2,1,2,3
36407_0,,,,2,1,2,3
36408_0,,,,2,1,2,3
36409_0,,,,2,1,2,3
36411_0,,,,2,1,2,3
C(CC[CH]C(O)=O)(C(C)O)=O,,,5,1,2,0,2
36413_0,,,,2,1,2,3
C(C(C[CH]C(O)=O)O)(CC)=O,,,5,1,2,0,2
36414_0,,,,2,1,2,3
36416_0,,,,2,1,2,3
C(C)(CC(C[CH]C(O)=O)O)=O,,,5,1,2,0,2
36418_0,,,,2,1,2,3
C(CCCC(C(C)O)=O)(O)=O,,,5,1,2,0,2
36420_0,,,,2,1,2,3
C(CCC(C(CC)=O)O)(O)=O,,,5,1,2,0,2
36421_0,,,,2,1,2,3
36423_0,,,,2,1,2,3
C(CCC(CC(C)=O)O)(O)=O,,,5,1,2,0,2
36425_0,,,,2,1,2,3
C(C(C=O)C[CH]C(O)=O)=O,,,5,1,2,0,2
36427_0,,,,2,1,2,3
C(C(C=O)CCC(O)=O)=O,,,5,1,2,0,2
36429_0,,,,2,1,2,3
C([CH]CC([CH]C(O)=O)=O)(O)=O,,,5,1,1,0,1
36431_0,,,,2,1,2,3
C(CCC([CH]C(O)=O)=O)(O)=O,,,5,1,1,0,1
36433_0,,,,2,1,2,3
C([CH]C(C(CC(C)O)O)=O)(O)=O,,,5,1,1,0,1
36435_0,,,,2,1,2,3
C([C](C(CCC(C)O)=O)O)(O)=O,,,5,1,2,0,2
36437_0,,,,2,1,2,3
C(CC(C)O)(C[C](C(O)=O)O)=O,,,5,1,2,0,2
36439_0,,,,2,1,2,3
C(CC(C([CH]C(O)=O)=O)O)(O)=O,,,5,1,1,0,1
36441_0,,,,2,1,2,3
C(CCC([C](C(O)=O)O)=O)(O)=O,,,5,1,2,0,2
36442_0,,,,2,1,2,3
36444_0,,,,2,1,2,3
C(CO)(C(C([CH]C(O)=O)=O)O)=O,,,5,1,1,0,1
36446_0,,,,2,1,2,3
C(CO)(CC([C](C(O)=O)O)=O)=O,,,5,1,2,0,2
36447_0,,,,2,1,2,3
36449_0,,,,2,1,2,3
C(C(C([CH]C(O)=O)=O)(CO)O)=O,,,5,1,1,0,1
36451_0,,,,2,1,2,3
C(C(C([C](C(O)=O)O)=O)CO)=O,,,5,1,2,0,2
36453_0,,,,2,1,2,3
C(C(C=O)C([C](C(O)=O)O)O)=O,,,5,1,2,0,2
36455_0,,,,2,1,2,3
C(C(C=O)C[C](C(O)=O)O)=O,,,5,1,2,0,2
36457_0,,,,2,1,2,3
C(C(C([CH]C(O)=O)=O)(C)O)=O,,,5,1,1,0,1
36459_0,,,,2,1,2,3
C(C(C([C](C(O)=O)O)=O)C)=O,,,5,1,2,0,2
36461_0,,,,2,1,2,3
C([CH]C(CO)=O)(O)=O,,,5,1,1,0,1
36462_0,,,,2,1,2,3
36463_0,,,,2,1,2,3
36465_0,,,,2,1,2,3
C(C(C(O)=O)C[C](C(O)=O)O)=O,,,5,1,3,0,3
36467_0,,,,2,1,2,3
C(C)(C[C](C(O)=O)O)=O,,,5,1,2,0,2
36469_0,,,,2,1,2,3
C([C](C(O)=O)O)(CC)=O,,,5,1,2,0,2
36471_0,,,,2,1,2,3
C([CH]C(C(C)O)=O)(O)=O,,,5,1,1,0,1
36473_0,,,,2,1,2,3
C(C([CH]C(O)=O)=O)(O)=O,,,5,1,1,0,1
36475_0,,,,2,1,2,3
C(C(C([C](C(O)=O)O)=O)C)(O)=O,,,5,1,2,0,2
36477_0,,,,2,1,2,3
C(C(C([CH]C(O)=O)=O)(C)O)(O)=O,,,5,1,1,0,1
36479_0,,,,2,1,2,3
C(C(C=O)CC(C=O)O)=O,,,5,1,2,0,2
36481_0,,,,2,1,2,3
C(C(C=O)CC(C=O)O)(O)=O,,,5,1,3,0,3
36482_0,,,,2,1,2,3
36483_0,,,,2,1,2,3
36485_0,,,,2,1,2,3
C1(C(C=C(C(C)O)C1O)O)=O,,,5,1,1,0,1
36486_0,,,,2,1,2,3
36487_0,,,,2,1,2,3
36489_0,,,,2,1,2,3
C1C(C(C)O)C(C(C=1)=O)O,,,5,1,1,0,1
36490_0,,,,2,1,2,3
36492_0,,,,2,1,2,3
C1(C(C(C(C)O)=CC1)O)=O,,,5,1,1,0,1
36493_0,,,,2,1,2,3
36494_0,,,,2,1,2,3
36495_0,,,,2,1,2,3
36497_0,,,,2,1,2,3
C1(C(C(C(O)=O)=CC1O)O)=O,,,5,1,2,0,2
36499_0,,,,2,1,2,3
C(C1C=CC(C1O)=O)(O)=O,,,5,1,1,0,1
36500_0,,,,2,1,2,3
36502_0,,,,2,1,2,3
C1(CC=C(C(O)=O)C1O)=O,,,5,1,1,0,1
36503_0,,,,2,1,2,3
36505_0,,,,2,1,2,3
C1(C(C(CO)=C(C(O)=O)C1)=O)=O,,,5,1,1,0,1
36506_0,,,,2,1,2,3
36508_0,,,,2,1,2,3
C1(C(C(C=O)=CC1O)O)=O,,,5,1,1,0,1
36509_0,,,,2,1,2,3
36510_0,,,,2,1,2,3
36512_0,,,,2,1,2,3
C1(C(C=CC1O)O)=O,,,5,1,1,0,1
36513_0,,,,2,1,2,3
36514_0,,,,2,1,2,3
36515_0,,,,2,1,2,3
36517_0,,,,2,1,2,3
C(C1C(C(C(C=1)=O)O)O)=O,,,5,1,1,0,1
36519_0,,,,2,1,2,3
C1(CC(C=O)=CC1O)=O,,,5,1,1,0,1
36520_0,,,,2,1,2,3
36522_0,,,,2,1,2,3
C(C1CC(C(C=1)=O)O)=O,,,5,1,1,0,1
36523_0,,,,2,1,2,3
36524_0,,,,2,1,2,3
36526_0,,,,2,1,2,3
C1(CC=CC1O)=O,,,5,1,1,0,1
36527_0,,,,2,1,2,3
36529_0,,,,2,1,2,3
C1CC(C(C=1)=O)O,,,5,1,1,0,1
36531_0,,,,2,1,2,3
C1(CC(C(O)=O)=CC1O)=O,,,5,1,1,0,1
36532_0,,,,2,1,2,3
36534_0,,,,2,1,2,3
C(C1CC(C(C=1)=O)O)(O)=O,,,5,1,1,0,1
36536_0,,,,2,1,2,3
C1CC(C(C=1)=O)=O,,,5,1,1,0,1
36538_0,,,,2,1,2,3
C=C(C(C=O)=O)C(CC(C)O)O,,,5,1,1,0,1
36540_0,,,,2,1,2,3
C(CC(C)O)=C(C(C=O)=O)CO,,,5,1,1,0,1
36541_0,,,,2,1,2,3
36542_0,,,,2,1,2,3
36543_0,,,,2,1,2,3
36545_0,,,,2,1,2,3
C(C(C=CC(CC(C)O)O)O)=O,,,5,1,1,0,1
36546_0,,,,2,1,2,3
36547_0,,,,2,1,2,3
36548_0,,,,2,1,2,3
36549_0,,,,2,1,2,3
36551_0,,,,2,1,2,3
C(CC(CC(C)O)O)=CC=O,,,5,1,1,0,1
36553_0,,,,2,1,2,3
C(CC=CC(CC(C)O)O)=O,,,5,1,1,0,1
36554_0,,,,2,1,2,3
36555_0,,,,2,1,2,3
36556_0,,,,2,1,2,3
36557_0,,,,2,1,2,3
36559_0,,,,2,1,2,3
C(C=C(C=O)C(CC(C)O)O)=O,,,5,1,1,0,1
36561_0,,,,2,1,2,3
C(C(C(C=O)=CCC(C)O)O)=O,,,5,1,1,0,1
36562_0,,,,2,1,2,3
36563_0,,,,2,1,2,3
36564_0,,,,2,1,2,3
36566_0,,,,2,1,2,3
C(CO)=C(C=O)C(CC(C)O)O,,,5,1,1,0,1
36568_0,,,,2,1,2,3
C(CC(C)O)=C(C=O)C(CO)O,,,5,1,1,0,1
36569_0,,,,2,1,2,3
36570_0,,,,2,1,2,3
36571_0,,,,2,1,2,3
36573_0,,,,2,1,2,3
C=C(C=O)C(CC(C)O)O,,,5,1,2,0,2
36575_0,,,,2,1,2,3
C(CC(C)O)=C(C=O)CO,,,5,1,1,0,1
36576_0,,,,2,1,2,3
36577_0,,,,2,1,2,3
36578_0,,,,2,1,2,3
36579_0,,,,2,1,2,3
36580_0,,,,2,1,2,3
36581_0,,,,2,1,2,3
36582_0,,,,2,1,2,3
36584_0,,,,2,1,2,3
C=C(C=O)C(C(CO)C(C)O)O,,,5,1,2,0,2
36586_0,,,,2,1,2,3
C(C(CO)C(C)O)=C(C=O)CO,,,5,1,1,0,1
36587_0,,,,2,1,2,3
36589_0,,,,2,1,2,3
C(C(C=C(CO)C(C)O)CO)=O,,,5,1,1,0,1
36590_0,,,,2,1,2,3
36591_0,,,,2,1,2,3
36593_0,,,,2,1,2,3
C(C(CO)C(C)O)=CC(CO)=O,,,5,1,1,0,1
36594_0,,,,2,1,2,3
36596_0,,,,2,1,2,3
C(CO)(CC=C(CO)C(C)O)=O,,,5,1,1,0,1
36597_0,,,,2,1,2,3
36598_0,,,,2,1,2,3
36599_0,,,,2,1,2,3
36601_0,,,,2,1,2,3
C(C)(C(C=C(CO)C(C)O)O)=O,,,5,1,1,0,1
36602_0,,,,2,1,2,3
36603_0,,,,2,1,2,3
36605_0,,,,2,1,2,3
C(C(CO)C(C)O)=C(C=O)C=C,,,5,1,1,0,1
36606_0,,,,2,1,2,3
36608_0,,,,2,1,2,3
C(C(C=C)C=C(CO)C(C)O)=O,,,5,1,1,0,1
36609_0,,,,2,1,2,3
36610_0,,,,2,1,2,3
36611_0,,,,2,1,2,3
36613_0,,,,2,1,2,3
C(C(C=C(CO)C(C)O)O)=O,,,5,1,1,0,1
36614_0,,,,2,1,2,3
36615_0,,,,2,1,2,3
36617_0,,,,2,1,2,3
C(C(CO)C(C)O)=CC=O,,,5,1,2,0,2
36618_0,,,,2,1,2,3
36620_0,,,,2,1,2,3
C(CC=C(CO)C(C)O)=O,,,5,1,1,0,1
36621_0,,,,2,1,2,3
36622_0,,,,2,1,2,3
36624_0,,,,2,1,2,3
C(C(CO)C(C)O)=CC(C=O)=O,,,5,1,1,0,1
36625_0,,,,2,1,2,3
36627_0,,,,2,1,2,3
C(CC(C=O)=O)=C(CO)C(C)O,,,5,1,1,0,1
36628_0,,,,2,1,2,3
36629_0,,,,2,1,2,3
36630_0,,,,2,1,2,3
36631_0,,,,2,1,2,3
36633_0,,,,2,1,2,3
C(C(C=C(C(C)O)C(C)O)O)=O,,,5,1,1,0,1
36635_0,,,,2,1,2,3
C(C(C(C)O)C(C)O)=CC=O,,,5,1,1,0,1
36636_0,,,,2,1,2,3
36637_0,,,,2,1,2,3
36639_0,,,,2,1,2,3
C(CC=C(C(C)O)C(C)O)=O,,,5,1,1,0,1
36641_0,,,,2,1,2,3
C(C(C=C(C(O)=O)C(C)O)O)=O,,,5,1,1,0,1
36642_0,,,,2,1,2,3
36643_0,,,,2,1,2,3
36645_0,,,,2,1,2,3
C(C(C=CC=O)C(C)O)(O)=O,,,5,1,3,0,3
36647_0,,,,2,1,2,3
C(CC=C(C(O)=O)C(C)O)=O,,,5,1,2,0,2
36648_0,,,,2,1,2,3
36649_0,,,,2,1,2,3
36651_0,,,,2,1,2,3
C(CC(C(C(C=O)=O)=C)O)(O)=O,,,5,1,1,0,1
36653_0,,,,2,1,2,3
C(CC=C(C(C=O)=O)CO)(O)=O,,,5,1,2,0,2
36654_0,,,,2,1,2,3
36656_0,,,,2,1,2,3
C(C(C=CC(CC(O)=O)O)O)=O,,,5,1,1,0,1
36657_0,,,,2,1,2,3
36658_0,,,,2,1,2,3
36660_0,,,,2,1,2,3
C(CC(CC=CC=O)O)(O)=O,,,5,1,2,0,2
36662_0,,,,2,1,2,3
C(CC=CC(CC(O)=O)O)=O,,,5,1,1,0,1
36663_0,,,,2,1,2,3
36664_0,,,,2,1,2,3
36666_0,,,,2,1,2,3
C(CC(C(C=O)=CC=O)O)(O)=O,,,5,1,1,0,1
36668_0,,,,2,1,2,3
C(CC=C(C=O)C(C=O)O)(O)=O,,,5,1,1,0,1
36669_0,,,,2,1,2,3
36671_0,,,,2,1,2,3
C(CC(C(C=O)=CCO)O)(O)=O,,,5,1,1,0,1
36673_0,,,,2,1,2,3
C(CC=C(C=O)C(CO)O)(O)=O,,,5,1,1,0,1
36674_0,,,,2,1,2,3
36676_0,,,,2,1,2,3
C(CC(C(C=O)=C)O)(O)=O,,,5,1,2,0,2
36678_0,,,,2,1,2,3
C(CC=C(C=O)CO)(O)=O,,,5,1,2,0,2
36679_0,,,,2,1,2,3
36680_0,,,,2,1,2,3
36681_0,,,,2,1,2,3
36683_0,,,,2,1,2,3
C(C(CO)C(C(C=O)=C)O)(O)=O,,,5,1,2,0,2
36685_0,,,,2,1,2,3
C(C(C=C(C=O)CO)CO)(O)=O,,,5,1,1,0,1
36686_0,,,,2,1,2,3
36688_0,,,,2,1,2,3
C(C(C=C(C(O)=O)CO)CO)=O,,,5,1,1,0,1
36690_0,,,,2,1,2,3
C(C(C=CC(CO)=O)CO)(O)=O,,,5,1,1,0,1
36691_0,,,,2,1,2,3
36693_0,,,,2,1,2,3
C(CO)(CC=C(C(O)=O)CO)=O,,,5,1,1,0,1
36694_0,,,,2,1,2,3
36696_0,,,,2,1,2,3
C(C)(C(C=C(C(O)=O)CO)O)=O,,,5,1,1,0,1
36698_0,,,,2,1,2,3
C(C(C=C(C=O)C=C)CO)(O)=O,,,5,1,1,0,1
36699_0,,,,2,1,2,3
36701_0,,,,2,1,2,3
C(C(C=C)C=C(C(O)=O)CO)=O,,,5,1,1,0,1
36702_0,,,,2,1,2,3
36704_0,,,,2,1,2,3
C(C(C=C(C(O)=O)CO)O)=O,,,5,1,3,0,3
36706_0,,,,2,1,2,3
C(C(C=CC=O)CO)(O)=O,,,5,1,2,0,2
36707_0,,,,2,1,2,3
36709_0,,,,2,1,2,3
C(CC=C(C(O)=O)CO)=O,,,5,1,2,0,2
36711_0,,,,2,1,2,3
C(C(C=CC(C=O)=O)CO)(O)=O,,,5,1,1,0,1
36712_0,,,,2,1,2,3
36714_0,,,,2,1,2,3
C(CC(C=O)=O)=C(C(O)=O)CO,,,5,1,1,0,1
36716_0,,,,2,1,2,3
C(C(C=C(C(O)=O)C(O)=O)O)=O,,,5,1,1,0,1
36718_0,,,,2,1,2,3
C(C(C(O)=O)C=CC=O)(O)=O,,,5,1,3,0,3
36720_0,,,,2,1,2,3
C(CC=C(C(O)=O)C(O)=O)=O,,,5,1,2,0,2
36722_0,,,,2,1,2,3
C(CO)(C(C(C(C=O)=O)=C)O)=O,,,5,1,1,0,1
36724_0,,,,2,1,2,3
C(C(C(CO)=CC(CO)=O)=O)=O,,,5,1,1,0,1
36725_0,,,,2,1,2,3
36727_0,,,,2,1,2,3
C(C(C=CC(C(CO)=O)O)O)=O,,,5,1,1,0,1
36728_0,,,,2,1,2,3
36730_0,,,,2,1,2,3
C(CO)(C(CC=CC=O)O)=O,,,5,1,1,0,1
36732_0,,,,2,1,2,3
C(CC=CC(C(CO)=O)O)=O,,,5,1,1,0,1
36733_0,,,,2,1,2,3
36734_0,,,,2,1,2,3
36735_0,,,,2,1,2,3
36736_0,,,,2,1,2,3
36738_0,,,,2,1,2,3
C(CO)(C(C(C=O)=CC=O)O)=O,,,5,1,1,0,1
36740_0,,,,2,1,2,3
C(C(C(C=O)=CC(CO)=O)O)=O,,,5,1,1,0,1
36742_0,,,,2,1,2,3
C(CO)(C(C(C=O)=CCO)O)=O,,,5,1,2,0,2
36744_0,,,,2,1,2,3
C(C(C(CO)O)=CC(CO)=O)=O,,,5,1,2,0,2
36745_0,,,,2,1,2,3
36746_0,,,,2,1,2,3
36747_0,,,,2,1,2,3
36748_0,,,,2,1,2,3
36749_0,,,,2,1,2,3
36750_0,,,,2,1,2,3
36751_0,,,,2,1,2,3
36752_0,,,,2,1,2,3
36754_0,,,,2,1,2,3
C(C(C(C(C=O)=O)=C)(CO)O)=O,,,5,1,1,0,1
36756_0,,,,2,1,2,3
C(C(C(CO)=C(C=O)CO)=O)=O,,,5,1,1,0,1
36758_0,,,,2,1,2,3
C(C(C=CC(C=O)O)(CO)O)=O,,,5,1,1,0,1
36759_0,,,,2,1,2,3
36761_0,,,,2,1,2,3
C(C(CO)(CC=CC=O)O)=O,,,5,1,1,0,1
36763_0,,,,2,1,2,3
C(C(C=CCC=O)(CO)O)=O,,,5,1,1,0,1
36764_0,,,,2,1,2,3
36765_0,,,,2,1,2,3
36767_0,,,,2,1,2,3
C(C(C(C=O)=CC=O)(CO)O)=O,,,5,1,1,0,1
36769_0,,,,2,1,2,3
C(C(C(C=O)=C(C=O)CO)O)=O,,,5,1,1,0,1
36771_0,,,,2,1,2,3
C(C(C(C=O)=CCO)(CO)O)=O,,,5,1,2,0,2
36773_0,,,,2,1,2,3
C(C(C(CO)O)=C(C=O)CO)=O,,,5,1,2,0,2
36775_0,,,,2,1,2,3
C(C(C(C=O)=C)(CO)O)=O,,,5,1,2,0,2
36777_0,,,,2,1,2,3
C(C(CO)=C(C=O)CO)=O,,,5,1,1,0,1
36778_0,,,,2,1,2,3
36780_0,,,,2,1,2,3
C(C(CO)O)(C(C(C=O)=C)O)=O,,,5,1,2,0,2
36782_0,,,,2,1,2,3
C(C=C(C=O)CO)(C(CO)O)=O,,,5,1,1,0,1
36784_0,,,,2,1,2,3
C(C=CC(CO)=O)(C(CO)O)=O,,,5,1,1,0,1
36786_0,,,,2,1,2,3
C=CC(C=O)=CC(C(CO)O)=O,,,5,1,1,0,1
36788_0,,,,2,1,2,3
C(C(C(C=O)=C)(C(CO)O)O)=O,,,5,1,2,0,2
36789_0,,,,2,1,2,3
36790_0,,,,2,1,2,3
36792_0,,,,2,1,2,3
C=CC(C=O)=C(C=O)C(CO)O,,,5,1,1,0,1
36794_0,,,,2,1,2,3
C(C=C(C=O)C(CO)O)=O,,,5,1,1,0,1
36796_0,,,,2,1,2,3
C(C(C=C(C=O)C(CO)O)=O)=O,,,5,1,1,0,1
36797_0,,,,2,1,2,3
36798_0,,,,2,1,2,3
36800_0,,,,2,1,2,3
C(C=C(C=O)C(C(C)O)O)=O,,,5,1,1,0,1
36801_0,,,,2,1,2,3
36803_0,,,,2,1,2,3
C(C(C(C=O)=CC=O)O)(O)=O,,,5,1,1,0,1
36805_0,,,,2,1,2,3
C(C(C)(CC(C=O)=CC=O)O)=O,,,5,1,1,0,1
36807_0,,,,2,1,2,3
C(C(C=C(C=O)CC=O)(C)O)=O,,,5,1,1,0,1
36808_0,,,,2,1,2,3
36809_0,,,,2,1,2,3
36810_0,,,,2,1,2,3
36811_0,,,,2,1,2,3
36812_0,,,,2,1,2,3
36813_0,,,,2,1,2,3
36814_0,,,,2,1,2,3
36815_0,,,,2,1,2,3
36816_0,,,,2,1,2,3
36818_0,,,,2,1,2,3
C(C(C(C(C=O)=O)=CC)(C)O)=O,,,5,1,1,0,1
36820_0,,,,2,1,2,3
C(C(C(C(C)O)=C(C=O)C)=O)=O,,,5,1,1,0,1
36821_0,,,,2,1,2,3
36823_0,,,,2,1,2,3
C(C(C(C(O)=O)=C(C=O)C)=O)=O,,,5,1,1,0,1
36824_0,,,,2,1,2,3
36826_0,,,,2,1,2,3
C(C(C(C(C=O)=O)=C)(C)O)=O,,,5,1,1,0,1
36828_0,,,,2,1,2,3
C(C(C(CO)=C(C=O)C)=O)=O,,,5,1,1,0,1
36829_0,,,,2,1,2,3
36831_0,,,,2,1,2,3
C(C(C)(CC(C(C=O)=C)O)O)=O,,,5,1,2,0,2
36833_0,,,,2,1,2,3
C(C(C)(CC=C(C=O)CO)O)=O,,,5,1,1,0,1
36835_0,,,,2,1,2,3
C(C(C=CC(C=O)(C)O)CO)=O,,,5,1,1,0,1
36836_0,,,,2,1,2,3
36837_0,,,,2,1,2,3
36839_0,,,,2,1,2,3
C(C(C)(CC=CC(CO)=O)O)=O,,,5,1,1,0,1
36841_0,,,,2,1,2,3
C(C(C=CCC(CO)=O)(C)O)=O,,,5,1,1,0,1
36842_0,,,,2,1,2,3
36843_0,,,,2,1,2,3
36845_0,,,,2,1,2,3
C(C(C=CC(C(C)=O)O)(C)O)=O,,,5,1,2,0,2
36846_0,,,,2,1,2,3
36847_0,,,,2,1,2,3
36849_0,,,,2,1,2,3
C(C(C)(CC=C(C=O)C=C)O)=O,,,5,1,1,0,1
36851_0,,,,2,1,2,3
C(C(C=C)C=CC(C=O)(C)O)=O,,,5,1,1,0,1
36852_0,,,,2,1,2,3
36853_0,,,,2,1,2,3
36855_0,,,,2,1,2,3
C(C(C=CC(C=O)O)(C)O)=O,,,5,1,1,0,1
36856_0,,,,2,1,2,3
36857_0,,,,2,1,2,3
36859_0,,,,2,1,2,3
C(C(C)(CC=CC=O)O)=O,,,5,1,1,0,1
36861_0,,,,2,1,2,3
C(C(C=CCC=O)(C)O)=O,,,5,1,1,0,1
36862_0,,,,2,1,2,3
36863_0,,,,2,1,2,3
36865_0,,,,2,1,2,3
C(C(C)(CC=CC(C=O)=O)O)=O,,,5,1,1,0,1
36867_0,,,,2,1,2,3
C(C(C=CCC(C=O)=O)(C)O)=O,,,5,1,1,0,1
36868_0,,,,2,1,2,3
36869_0,,,,2,1,2,3
36871_0,,,,2,1,2,3
C(CC(C)(C(C(C=O)=C)O)O)=O,,,5,1,2,0,2
36873_0,,,,2,1,2,3
C(CC(C=C(C=O)CO)(C)O)=O,,,5,1,1,0,1
36874_0,,,,2,1,2,3
36875_0,,,,2,1,2,3
36877_0,,,,2,1,2,3
C(CC(C=CC(CO)=O)(C)O)=O,,,5,1,1,0,1
36878_0,,,,2,1,2,3
36879_0,,,,2,1,2,3
36880_0,,,,2,1,2,3
36881_0,,,,2,1,2,3
36883_0,,,,2,1,2,3
C(CC(C=C(C=O)C=C)(C)O)=O,,,5,1,1,0,1
36884_0,,,,2,1,2,3
36885_0,,,,2,1,2,3
36886_0,,,,2,1,2,3
36887_0,,,,2,1,2,3
36888_0,,,,2,1,2,3
36889_0,,,,2,1,2,3
36890_0,,,,2,1,2,3
36891_0,,,,2,1,2,3
36892_0,,,,2,1,2,3
36893_0,,,,2,1,2,3
36895_0,,,,2,1,2,3
C(C(C)(C(C=O)C=CCO)O)=O,,,5,1,1,0,1
36896_0,,,,2,1,2,3
36898_0,,,,2,1,2,3
C(C(C(C=O)=CCCO)(C)O)=O,,,5,1,1,0,1
36900_0,,,,2,1,2,3
C(C(C(CCO)O)=C(C=O)C)=O,,,5,1,1,0,1
36901_0,,,,2,1,2,3
36903_0,,,,2,1,2,3
C(C(C(C=O)=CC=O)(C)O)=O,,,5,1,1,0,1
36905_0,,,,2,1,2,3
C(C(C(C=O)=C(C=O)C)O)=O,,,5,1,1,0,1
36906_0,,,,2,1,2,3
36908_0,,,,2,1,2,3
C(C(C)(C(C=O)C(CO)=C)O)=O,,,5,1,1,0,1
36910_0,,,,2,1,2,3
C(C(C(C=O)=C(CO)C)(C)O)=O,,,5,1,1,0,1
36912_0,,,,2,1,2,3
C(C(C(CO)(C)O)=C(C=O)C)=O,,,5,1,1,0,1
36913_0,,,,2,1,2,3
36915_0,,,,2,1,2,3
C(C(C(C=O)=CC=CC)(C)O)=O,,,5,1,1,0,1
36917_0,,,,2,1,2,3
C(C(C(C=O)=C(C=O)C)O)=CC,,,5,1,1,0,1
36918_0,,,,2,1,2,3
36920_0,,,,2,1,2,3
C(C(C=CC=C)C(C=O)(C)O)=O,,,5,1,1,0,1
36922_0,,,,2,1,2,3
C(C(C(C=O)=CCC=C)(C)O)=O,,,5,1,1,0,1
36924_0,,,,2,1,2,3
C=CCC(C(C=O)=C(C=O)C)O,,,5,1,1,0,1
36925_0,,,,2,1,2,3
36927_0,,,,2,1,2,3
C(C(C(C=O)=CCO)(C)O)=O,,,5,1,2,0,2
36929_0,,,,2,1,2,3
C(C(C(CO)O)=C(C=O)C)=O,,,5,1,1,0,1
36930_0,,,,2,1,2,3
36931_0,,,,2,1,2,3
36933_0,,,,2,1,2,3
C(C(C(C=O)=CC(C)O)(C)O)=O,,,5,1,2,0,2
36935_0,,,,2,1,2,3
C(C(C(C(C)O)O)=C(C=O)C)=O,,,5,1,1,0,1
36936_0,,,,2,1,2,3
36938_0,,,,2,1,2,3
C(C(C(C=O)=CC(O)=O)(C)O)=O,,,5,1,3,0,3
36940_0,,,,2,1,2,3
C(C(C(C=O)=C(C=O)C)O)(O)=O,,,5,1,1,0,1
36941_0,,,,2,1,2,3
36942_0,,,,2,1,2,3
36944_0,,,,2,1,2,3
C(C(C(C=O)=C(C=O)C)(C)O)=O,,,5,1,1,0,1
36946_0,,,,2,1,2,3
C(C(C(C=O)=CC(C)=O)(C)O)=O,,,5,1,1,0,1
36948_0,,,,2,1,2,3
C(C)(C(C(C=O)=C(C=O)C)O)=O,,,5,1,1,0,1
36949_0,,,,2,1,2,3
36951_0,,,,2,1,2,3
C(C(C(C=O)=C)(C)O)=O,,,5,1,4,0,4
36953_0,,,,2,1,2,3
C(C(C)=C(C=O)CO)=O,,,5,1,1,0,1
36954_0,,,,2,1,2,3
36956_0,,,,2,1,2,3
C(C(C(C(C(O)=O)=O)=C)(C)O)=O,,,5,1,2,0,2
36958_0,,,,2,1,2,3
C(C(C(CO)=C(C=O)C)=O)(O)=O,,,5,1,1,0,1
36959_0,,,,2,1,2,3
36961_0,,,,2,1,2,3
C(C)(C(CC(C=O)=CC=O)O)=O,,,5,1,1,0,1
36963_0,,,,2,1,2,3
C(CC(C=O)=CC(C(C)=O)O)=O,,,5,1,1,0,1
36964_0,,,,2,1,2,3
36965_0,,,,2,1,2,3
36966_0,,,,2,1,2,3
36967_0,,,,2,1,2,3
36969_0,,,,2,1,2,3
C(C)(C(C(C(C=O)=O)=CC)O)=O,,,5,1,1,0,1
36971_0,,,,2,1,2,3
C(C(C(C(C)O)=CC(C)=O)=O)=O,,,5,1,1,0,1
36973_0,,,,2,1,2,3
C(C(C(C(O)=O)=CC(C)=O)=O)=O,,,5,1,1,0,1
36975_0,,,,2,1,2,3
C(C)(C(C(C(C=O)=O)=C)O)=O,,,5,1,1,0,1
36977_0,,,,2,1,2,3
C(C(C(CO)=CC(C)=O)=O)=O,,,5,1,1,0,1
36978_0,,,,2,1,2,3
36979_0,,,,2,1,2,3
36980_0,,,,2,1,2,3
36981_0,,,,2,1,2,3
36982_0,,,,2,1,2,3
36983_0,,,,2,1,2,3
36985_0,,,,2,1,2,3
C(C)(C(CC(C(C=O)=C)O)O)=O,,,5,1,2,0,2
36987_0,,,,2,1,2,3
C(C)(C(CC=C(C=O)CO)O)=O,,,5,1,1,0,1
36989_0,,,,2,1,2,3
C(C(C=CC(C(C)=O)O)CO)=O,,,5,1,1,0,1
36990_0,,,,2,1,2,3
36992_0,,,,2,1,2,3
C(C)(C(CC=CC(CO)=O)O)=O,,,5,1,1,0,1
36994_0,,,,2,1,2,3
C(CO)(CC=CC(C(C)=O)O)=O,,,5,1,1,0,1
36995_0,,,,2,1,2,3
36997_0,,,,2,1,2,3
C(C)(C(C=CC(C(C)=O)O)O)=O,,,5,1,1,0,1
36998_0,,,,2,1,2,3
37000_0,,,,2,1,2,3
C(C)(C(CC=C(C=O)C=C)O)=O,,,5,1,1,0,1
37002_0,,,,2,1,2,3
C(C(C=C)C=CC(C(C)=O)O)=O,,,5,1,1,0,1
37003_0,,,,2,1,2,3
37005_0,,,,2,1,2,3
C(C(C=CC(C(C)=O)O)O)=O,,,5,1,1,0,1
37006_0,,,,2,1,2,3
37008_0,,,,2,1,2,3
C(C)(C(CC=CC=O)O)=O,,,5,1,1,0,1
37010_0,,,,2,1,2,3
C(CC=CC(C(C)=O)O)=O,,,5,1,1,0,1
37011_0,,,,2,1,2,3
37013_0,,,,2,1,2,3
C(C)(C(CC=CC(C=O)=O)O)=O,,,5,1,1,0,1
37015_0,,,,2,1,2,3
C(C)(C(C=CCC(C=O)=O)O)=O,,,5,1,1,0,1
37016_0,,,,2,1,2,3
37018_0,,,,2,1,2,3
C(CC(C(C(C=O)=C)(C)O)O)=O,,,5,1,2,0,2
37020_0,,,,2,1,2,3
C(CC(C(C)=C(C=O)CO)O)=O,,,5,1,1,0,1
37021_0,,,,2,1,2,3
37023_0,,,,2,1,2,3
C(CC(C(C(C=O)CO)=C)O)=O,,,5,1,1,0,1
37025_0,,,,2,1,2,3
C(CC(C(C)=CC(CO)=O)O)=O,,,5,1,1,0,1
37026_0,,,,2,1,2,3
37028_0,,,,2,1,2,3
C(CC(C(CC(CO)=O)=C)O)=O,,,5,1,1,0,1
37029_0,,,,2,1,2,3
37031_0,,,,2,1,2,3
C(CC(C(C(C(C)=O)O)=C)O)=O,,,5,1,1,0,1
37033_0,,,,2,1,2,3
C(CC(C(C)=C(C=O)C=C)O)=O,,,5,1,1,0,1
37034_0,,,,2,1,2,3
37036_0,,,,2,1,2,3
C(C(C=C)C(C(CC=O)O)=C)=O,,,5,1,1,0,1
37037_0,,,,2,1,2,3
37039_0,,,,2,1,2,3
C(C(C(C(CC=O)O)=C)O)=O,,,5,1,1,0,1
37041_0,,,,2,1,2,3
C(C(C=CCO)C(C(C)=O)O)=O,,,5,1,1,0,1
37042_0,,,,2,1,2,3
37044_0,,,,2,1,2,3
C(C)(C(C(C=O)=CCCO)O)=O,,,5,1,1,0,1
37046_0,,,,2,1,2,3
C(C(C(CCO)O)=CC(C)=O)=O,,,5,1,1,0,1
37048_0,,,,2,1,2,3
C(C)(C(C(C=O)=CC=O)O)=O,,,5,1,1,0,1
37050_0,,,,2,1,2,3
C(C(C(C=O)=CC(C)=O)O)=O,,,5,1,1,0,1
37052_0,,,,2,1,2,3
C(C(C(CO)=C)C(C(C)=O)O)=O,,,5,1,1,0,1
37054_0,,,,2,1,2,3
C(C)(C(C(C=O)=C(CO)C)O)=O,,,5,1,1,0,1
37056_0,,,,2,1,2,3
C(C(C(CO)(C)O)=CC(C)=O)=O,,,5,1,1,0,1
37058_0,,,,2,1,2,3
C(C)(C(C(C=O)=CC=CC)O)=O,,,5,1,1,0,1
37060_0,,,,2,1,2,3
C(C(C(C=O)=CC(C)=O)O)=CC,,,5,1,1,0,1
37062_0,,,,2,1,2,3
C(C(C=CC=C)C(C(C)=O)O)=O,,,5,1,1,0,1
37064_0,,,,2,1,2,3
C(C)(C(C(C=O)=CCC=C)O)=O,,,5,1,1,0,1
37066_0,,,,2,1,2,3
C=CCC(C(C=O)=CC(C)=O)O,,,5,1,1,0,1
37068_0,,,,2,1,2,3
C(C)(C(C(C=O)=CCO)O)=O,,,5,1,2,0,2
37070_0,,,,2,1,2,3
C(C(C(CO)O)=CC(C)=O)=O,,,5,1,1,0,1
37071_0,,,,2,1,2,3
37073_0,,,,2,1,2,3
C(C)(C(C(C=O)=CC(C)O)O)=O,,,5,1,2,0,2
37075_0,,,,2,1,2,3
C(C(C(C(C)O)O)=CC(C)=O)=O,,,5,1,1,0,1
37077_0,,,,2,1,2,3
C(C)(C(C(C=O)=CC(O)=O)O)=O,,,5,1,3,0,3
37079_0,,,,2,1,2,3
C(C(C(C=O)=CC(C)=O)O)(O)=O,,,5,1,1,0,1
37081_0,,,,2,1,2,3
C(C)(C(C(C=O)=CC(C)=O)O)=O,,,5,1,1,0,1
37083_0,,,,2,1,2,3
C(C)(C(C(C=O)=C)O)=O,,,5,1,4,0,4
37085_0,,,,2,1,2,3
C(C(CO)=CC(C)=O)=O,,,5,1,1,0,1
37087_0,,,,2,1,2,3
C(CC(C(CC=CCO)=O)O)=O,,,5,1,1,0,1
37088_0,,,,2,1,2,3
37089_0,,,,2,1,2,3
37091_0,,,,2,1,2,3
C(CC(C(C=CCCO)=O)O)=O,,,5,1,1,0,1
37092_0,,,,2,1,2,3
37094_0,,,,2,1,2,3
C(CC(C(C=CC=O)=O)O)=O,,,5,1,1,0,1
37096_0,,,,2,1,2,3
C(CC(C(CC(CO)=C)=O)O)=O,,,5,1,1,0,1
37097_0,,,,2,1,2,3
37099_0,,,,2,1,2,3
C(CC(C(C=C(C)CO)=O)O)=O,,,5,1,1,0,1
37100_0,,,,2,1,2,3
37102_0,,,,2,1,2,3
C(CC(C(C=CC=CC)=O)O)=O,,,5,1,1,0,1
37104_0,,,,2,1,2,3
C(CC(C(CC=CC=C)=O)O)=O,,,5,1,1,0,1
37105_0,,,,2,1,2,3
37107_0,,,,2,1,2,3
C(CC(C(C=CCC=C)=O)O)=O,,,5,1,1,0,1
37108_0,,,,2,1,2,3
37110_0,,,,2,1,2,3
C(CC(C(C=CCO)=O)O)=O,,,5,1,1,0,1
37111_0,,,,2,1,2,3
37112_0,,,,2,1,2,3
37114_0,,,,2,1,2,3
C(CC(C(C=CC(C)O)=O)O)=O,,,5,1,1,0,1
37115_0,,,,2,1,2,3
37117_0,,,,2,1,2,3
C(CC(C(C=CC(O)=O)=O)O)=O,,,5,1,1,0,1
37118_0,,,,2,1,2,3
37119_0,,,,2,1,2,3
37120_0,,,,2,1,2,3
37121_0,,,,2,1,2,3
37122_0,,,,2,1,2,3
37123_0,,,,2,1,2,3
37125_0,,,,2,1,2,3
C(C)(C(C(C(C(O)=O)=O)=C)O)=O,,,5,1,2,0,2
37127_0,,,,2,1,2,3
C(C(C(CO)=CC(C)=O)=O)(O)=O,,,5,1,1,0,1
37128_0,,,,2,1,2,3
37129_0,,,,2,1,2,3
37131_0,,,,2,1,2,3
C(C(C(C=O)=C)(CCO)O)=O,,,5,1,2,0,2
37133_0,,,,2,1,2,3
C(C(CCO)=C(C=O)CO)=O,,,5,1,1,0,1
37134_0,,,,2,1,2,3
37136_0,,,,2,1,2,3
C(C(C(C=O)=CCO)CO)=O,,,5,1,1,0,1
37137_0,,,,2,1,2,3
37138_0,,,,2,1,2,3
37140_0,,,,2,1,2,3
C(C(CCO)=CC(CO)=O)=O,,,5,1,1,0,1
37141_0,,,,2,1,2,3
37143_0,,,,2,1,2,3
C(CO)(CC(C=O)=CCO)=O,,,5,1,1,0,1
37144_0,,,,2,1,2,3
37145_0,,,,2,1,2,3
37147_0,,,,2,1,2,3
C=CC(C=O)=C(C=O)CCO,,,5,1,1,0,1
37148_0,,,,2,1,2,3
37150_0,,,,2,1,2,3
C(C(C=C)C(C=O)=CCO)=O,,,5,1,1,0,1
37151_0,,,,2,1,2,3
37153_0,,,,2,1,2,3
C(C(C(C=O)=CCO)O)=O,,,5,1,1,0,1
37155_0,,,,2,1,2,3
C(C=C(C=O)CCO)=O,,,5,1,1,0,1
37156_0,,,,2,1,2,3
37158_0,,,,2,1,2,3
C(CC(C=O)=CCO)=O,,,5,1,1,0,1
37160_0,,,,2,1,2,3
C(C(C(C=O)=CC)(CCO)O)=O,,,5,1,1,0,1
37162_0,,,,2,1,2,3
C(C(CCO)=C(C=O)C(C)O)=O,,,5,1,1,0,1
37163_0,,,,2,1,2,3
37164_0,,,,2,1,2,3
37166_0,,,,2,1,2,3
C(C(C(C=O)=CCO)C(C)O)=O,,,5,1,1,0,1
37168_0,,,,2,1,2,3
C(C(C=O)=C(C=O)CCO)(O)=O,,,5,1,1,0,1
37169_0,,,,2,1,2,3
37171_0,,,,2,1,2,3
C(C(C=O)C(C=O)=CCO)(O)=O,,,5,1,1,0,1
37172_0,,,,2,1,2,3
37174_0,,,,2,1,2,3
C(CO)=C(C=O)C(C(C=O)=O)O,,,5,1,1,0,1
37176_0,,,,2,1,2,3
C(C(C=C(C=O)CCO)=O)=O,,,5,1,1,0,1
37177_0,,,,2,1,2,3
37179_0,,,,2,1,2,3
C(CO)=C(C=O)CC(C=O)=O,,,5,1,1,0,1
37181_0,,,,2,1,2,3
C(C(C=C(C=O)CCO)=O)(O)=O,,,5,1,1,0,1
37182_0,,,,2,1,2,3
37184_0,,,,2,1,2,3
C(CO)=C(C=O)CC(C(O)=O)=O,,,5,1,1,0,1
37186_0,,,,2,1,2,3
C(CCO)(C(C(C=O)=C)O)=O,,,5,1,2,0,2
37188_0,,,,2,1,2,3
C(C=C(C=O)CO)(CCO)=O,,,5,1,1,0,1
37189_0,,,,2,1,2,3
37190_0,,,,2,1,2,3
37192_0,,,,2,1,2,3
C(C=CC(CO)=O)(CCO)=O,,,5,1,1,0,1
37193_0,,,,2,1,2,3
37194_0,,,,2,1,2,3
37196_0,,,,2,1,2,3
C=CC(C=O)=CC(CCO)=O,,,5,1,1,0,1
37197_0,,,,2,1,2,3
37198_0,,,,2,1,2,3
37200_0,,,,2,1,2,3
C(C(C(C=O)=O)CO)=CCO,,,5,1,1,0,1
37201_0,,,,2,1,2,3
37203_0,,,,2,1,2,3
C(CCO)=C(C(C=O)=O)CO,,,5,1,1,0,1
37205_0,,,,2,1,2,3
C=C(C(C=O)=O)C(CCO)O,,,5,1,1,0,1
37207_0,,,,2,1,2,3
C(C(C(CO)=CC=O)=O)=O,,,5,1,1,0,1
37209_0,,,,2,1,2,3
C(C(C(C(C=O)=O)=C)O)=O,,,5,1,1,0,1
37211_0,,,,2,1,2,3
C(C(C=C(C(C=O)=O)CO)O)=O,,,5,1,1,0,1
37213_0,,,,2,1,2,3
C(C(C(C(C(C=O)=O)=C)O)O)=O,,,5,1,1,0,1
37215_0,,,,2,1,2,3
C(CO)(CO)=C(C(C=O)=O)CO,,,5,1,1,0,1
37217_0,,,,2,1,2,3
C=C(C(C=O)=O)C(CO)(CO)O,,,5,1,1,0,1
37219_0,,,,2,1,2,3
C=C(CO)C(C(C=O)=O)CO,,,5,1,1,0,1
37221_0,,,,2,1,2,3
C(C)(CO)=C(C(C=O)=O)CO,,,5,1,1,0,1
37223_0,,,,2,1,2,3
C=C(C(C=O)=O)C(CO)(C)O,,,5,1,1,0,1
37225_0,,,,2,1,2,3
C(C)=CC=C(C(C=O)=O)CO,,,5,1,1,0,1
37227_0,,,,2,1,2,3
C(C(C(C(C=O)=O)=C)O)=CC,,,5,1,1,0,1
37229_0,,,,2,1,2,3
C=CC=CC(C(C=O)=O)CO,,,5,1,1,0,1
37231_0,,,,2,1,2,3
C=CCC=C(C(C=O)=O)CO,,,5,1,1,0,1
37233_0,,,,2,1,2,3
C=CCC(C(C(C=O)=O)=C)O,,,5,1,1,0,1
37235_0,,,,2,1,2,3
C(C(CO)O)=C(C(C=O)=O)CO,,,5,1,1,0,1
37237_0,,,,2,1,2,3
C=C(C(C=O)=O)C(C(CO)O)O,,,5,1,1,0,1
37239_0,,,,2,1,2,3
C(CO)=C(C(C=O)=O)CO,,,5,1,1,0,1
37241_0,,,,2,1,2,3
C=C(C(C=O)=O)C(CO)O,,,5,1,1,0,1
37242_0,,,,2,1,2,3
37244_0,,,,2,1,2,3
C(C(C)O)=C(C(C=O)=O)CO,,,5,1,1,0,1
37246_0,,,,2,1,2,3
C=C(C(C=O)=O)C(C(C)O)O,,,5,1,1,0,1
37248_0,,,,2,1,2,3
C(C(C(CO)=CC(O)=O)=O)=O,,,5,1,1,0,1
37250_0,,,,2,1,2,3
C(C(C(C(C=O)=O)=C)O)(O)=O,,,5,1,1,0,1
37251_0,,,,2,1,2,3
37253_0,,,,2,1,2,3
C(C)=C(C(C=O)=O)CO,,,5,1,2,0,2
37255_0,,,,2,1,2,3
C=C(C(C=O)=O)C(C)O,,,5,1,3,0,3
37256_0,,,,2,1,2,3
37258_0,,,,2,1,2,3
C=C(C(C=O)=O)CO,,,5,1,3,0,3
37259_0,,,,2,1,2,3
37261_0,,,,2,1,2,3
C(C(C(CO)=C(C(O)=O)C)=O)=O,,,5,1,1,0,1
37263_0,,,,2,1,2,3
C(C(C(C(C=O)=O)=C)(C)O)(O)=O,,,5,1,1,0,1
37265_0,,,,2,1,2,3
C(C(C(C=O)=C)(CC(C)O)O)=O,,,5,1,2,0,2
37267_0,,,,2,1,2,3
C(C(CC(C)O)=C(C=O)CO)=O,,,5,1,1,0,1
37268_0,,,,2,1,2,3
37269_0,,,,2,1,2,3
37271_0,,,,2,1,2,3
C(C(C(C=O)=CC(C)O)CO)=O,,,5,1,1,0,1
37273_0,,,,2,1,2,3
C(C(CC(C)O)=CC(CO)=O)=O,,,5,1,1,0,1
37274_0,,,,2,1,2,3
37275_0,,,,2,1,2,3
37277_0,,,,2,1,2,3
C(CO)(CC(C=O)=CC(C)O)=O,,,5,1,1,0,1
37278_0,,,,2,1,2,3
37279_0,,,,2,1,2,3
37280_0,,,,2,1,2,3
37282_0,,,,2,1,2,3
C=CC(C=O)=C(C=O)CC(C)O,,,5,1,1,0,1
37283_0,,,,2,1,2,3
37284_0,,,,2,1,2,3
37286_0,,,,2,1,2,3
C(C(C=C)C(C=O)=CC(C)O)=O,,,5,1,1,0,1
37287_0,,,,2,1,2,3
37288_0,,,,2,1,2,3
37290_0,,,,2,1,2,3
C(C(C(C=O)=CC(C)O)O)=O,,,5,1,1,0,1
37292_0,,,,2,1,2,3
C(C=C(C=O)CC(C)O)=O,,,5,1,1,0,1
37293_0,,,,2,1,2,3
37294_0,,,,2,1,2,3
37296_0,,,,2,1,2,3
C(CC(C=O)=CC(C)O)=O,,,5,1,1,0,1
37298_0,,,,2,1,2,3
C(C(C=C(C=O)CC(C)O)=O)=O,,,5,1,1,0,1
37299_0,,,,2,1,2,3
37300_0,,,,2,1,2,3
37302_0,,,,2,1,2,3
C(C(C)O)=C(C=O)CC(C=O)=O,,,5,1,1,0,1
37304_0,,,,2,1,2,3
C(CC(C)O)(C(C(C=O)=C)O)=O,,,5,1,2,0,2
37306_0,,,,2,1,2,3
C(C=C(C=O)CO)(CC(C)O)=O,,,5,1,1,0,1
37307_0,,,,2,1,2,3
37308_0,,,,2,1,2,3
37310_0,,,,2,1,2,3
C(C=CC(CO)=O)(CC(C)O)=O,,,5,1,1,0,1
37311_0,,,,2,1,2,3
37312_0,,,,2,1,2,3
37313_0,,,,2,1,2,3
37314_0,,,,2,1,2,3
37316_0,,,,2,1,2,3
C=CC(C=O)=CC(CC(C)O)=O,,,5,1,1,0,1
37317_0,,,,2,1,2,3
37318_0,,,,2,1,2,3
37319_0,,,,2,1,2,3
37320_0,,,,2,1,2,3
37322_0,,,,2,1,2,3
C(C(C(C=O)=O)C(C)O)=CCO,,,5,1,1,0,1
37323_0,,,,2,1,2,3
37324_0,,,,2,1,2,3
37326_0,,,,2,1,2,3
C(CCO)=C(C(C=O)=O)C(C)O,,,5,1,1,0,1
37328_0,,,,2,1,2,3
C(C)=C(C(C=O)=O)C(CCO)O,,,5,1,1,0,1
37329_0,,,,2,1,2,3
37331_0,,,,2,1,2,3
C(C(C(C(C)O)=CC=O)=O)=O,,,5,1,1,0,1
37333_0,,,,2,1,2,3
C(C(C(C(C=O)=O)=CC)O)=O,,,5,1,1,0,1
37335_0,,,,2,1,2,3
C=C(CO)C(C(C=O)=O)C(C)O,,,5,1,1,0,1
37336_0,,,,2,1,2,3
37338_0,,,,2,1,2,3
C(CO)(C)=C(C(C=O)=O)C(C)O,,,5,1,1,0,1
37340_0,,,,2,1,2,3
C(C)=C(C(C=O)=O)C(CO)(C)O,,,5,1,1,0,1
37341_0,,,,2,1,2,3
37343_0,,,,2,1,2,3
C(C)=CC=C(C(C=O)=O)C(C)O,,,5,1,1,0,1
37345_0,,,,2,1,2,3
C(C(C(C(C=O)=O)=CC)O)=CC,,,5,1,1,0,1
37347_0,,,,2,1,2,3
C=CC=CC(C(C=O)=O)C(C)O,,,5,1,1,0,1
37348_0,,,,2,1,2,3
37350_0,,,,2,1,2,3
C=CCC=C(C(C=O)=O)C(C)O,,,5,1,1,0,1
37352_0,,,,2,1,2,3
C=CCC(C(C(C=O)=O)=CC)O,,,5,1,1,0,1
37353_0,,,,2,1,2,3
37355_0,,,,2,1,2,3
C(CO)=C(C(C=O)=O)C(C)O,,,5,1,1,0,1
37357_0,,,,2,1,2,3
C(C)=C(C(C=O)=O)C(CO)O,,,5,1,1,0,1
37358_0,,,,2,1,2,3
37359_0,,,,2,1,2,3
37361_0,,,,2,1,2,3
C(C(C)O)=C(C(C=O)=O)C(C)O,,,5,1,1,0,1
37363_0,,,,2,1,2,3
C(C)=C(C(C=O)=O)C(C(C)O)O,,,5,1,1,0,1
37364_0,,,,2,1,2,3
37366_0,,,,2,1,2,3
C(C(C(C(C)O)=CC(O)=O)=O)=O,,,5,1,1,0,1
37368_0,,,,2,1,2,3
C(C(C(C(C=O)=O)=CC)O)(O)=O,,,5,1,1,0,1
37369_0,,,,2,1,2,3
37371_0,,,,2,1,2,3
C(C)=C(C(C=O)=O)C(C)O,,,5,1,2,0,2
37372_0,,,,2,1,2,3
37374_0,,,,2,1,2,3
C(C)=C(C(O)=O)C(C=O)=O,,,5,1,2,0,2
37376_0,,,,2,1,2,3
C(C(C(C=O)=C)(CC(O)=O)O)=O,,,5,1,2,0,2
37378_0,,,,2,1,2,3
C(CC(C=O)=C(C=O)CO)(O)=O,,,5,1,1,0,1
37380_0,,,,2,1,2,3
C(C(C(C=O)=CC(O)=O)CO)=O,,,5,1,2,0,2
37382_0,,,,2,1,2,3
C(CC(C=O)=CC(CO)=O)(O)=O,,,5,1,1,0,1
37384_0,,,,2,1,2,3
C(CO)(CC(C=O)=CC(O)=O)=O,,,5,1,2,0,2
37385_0,,,,2,1,2,3
37387_0,,,,2,1,2,3
C(CC(C=O)=C(C=O)C=C)(O)=O,,,5,1,1,0,1
37389_0,,,,2,1,2,3
C(C(C=C)C(C=O)=CC(O)=O)=O,,,5,1,2,0,2
37391_0,,,,2,1,2,3
C(C(C(C=O)=CC(O)=O)O)=O,,,5,1,2,0,2
37393_0,,,,2,1,2,3
C(CC(C=O)=CC=O)(O)=O,,,5,1,1,0,1
37395_0,,,,2,1,2,3
C(CC(C=O)=CC(O)=O)=O,,,5,1,2,0,2
37397_0,,,,2,1,2,3
C(CC(C=O)=CC(C=O)=O)(O)=O,,,5,1,1,0,1
37399_0,,,,2,1,2,3
C(C(CC(C=O)=O)=CC(O)=O)=O,,,5,1,2,0,2
37401_0,,,,2,1,2,3
C(CC(C(C(C=O)=C)O)=O)(O)=O,,,5,1,2,0,2
37403_0,,,,2,1,2,3
C(CC(C=C(C=O)CO)=O)(O)=O,,,5,1,1,0,1
37405_0,,,,2,1,2,3
C(CC(C=CC(CO)=O)=O)(O)=O,,,5,1,1,0,1
37407_0,,,,2,1,2,3
C(CC(C=C(C=O)C=C)=O)(O)=O,,,5,1,1,0,1
37409_0,,,,2,1,2,3
C(C(C=CCO)C(C=O)=O)(O)=O,,,5,1,1,0,1
37410_0,,,,2,1,2,3
37412_0,,,,2,1,2,3
C(CCO)=C(C(O)=O)C(C=O)=O,,,5,1,1,0,1
37414_0,,,,2,1,2,3
C(C(C(C(O)=O)=CC=O)=O)=O,,,5,1,1,0,1
37416_0,,,,2,1,2,3
C(C(C(CO)=C)C(C=O)=O)(O)=O,,,5,1,1,0,1
37418_0,,,,2,1,2,3
C(C)(CO)=C(C(O)=O)C(C=O)=O,,,5,1,1,0,1
37420_0,,,,2,1,2,3
C(C)=CC=C(C(O)=O)C(C=O)=O,,,5,1,1,0,1
37422_0,,,,2,1,2,3
C(C(C=CC=C)C(C=O)=O)(O)=O,,,5,1,1,0,1
37424_0,,,,2,1,2,3
C=CCC=C(C(O)=O)C(C=O)=O,,,5,1,1,0,1
37426_0,,,,2,1,2,3
C(CO)=C(C(O)=O)C(C=O)=O,,,5,1,1,0,1
37427_0,,,,2,1,2,3
37429_0,,,,2,1,2,3
C(C(C)O)=C(C(O)=O)C(C=O)=O,,,5,1,1,0,1
37431_0,,,,2,1,2,3
C(C(C(C(O)=O)=CC(O)=O)=O)=O,,,5,1,1,0,1
37433_0,,,,2,1,2,3
C(C(C(CO)O)=CC=O)(O)=O,,,5,1,2,0,2
37435_0,,,,2,1,2,3
C=C(C=O)C(CCO)O,,,5,1,4,0,4
37437_0,,,,2,1,2,3
C(CCO)=C(C=O)CO,,,5,1,1,0,1
37439_0,,,,2,1,2,3
C(C(C=CCO)CO)=O,,,5,1,1,0,1
37440_0,,,,2,1,2,3
37442_0,,,,2,1,2,3
C=C(C(C(O)=O)=O)C(CCO)O,,,5,1,1,0,1
37444_0,,,,2,1,2,3
C(CCO)=C(C(C(O)=O)=O)CO,,,5,1,1,0,1
37446_0,,,,2,1,2,3
C(C(C(C(O)=O)=O)CO)=CCO,,,5,1,1,0,1
37447_0,,,,2,1,2,3
37449_0,,,,2,1,2,3
C(CCO)=C(C=O)C(C(C)=O)=O,,,5,1,1,0,1
37451_0,,,,2,1,2,3
C(C(C=CCO)C(C(C)=O)=O)=O,,,5,1,1,0,1
37452_0,,,,2,1,2,3
37454_0,,,,2,1,2,3
C(CC(C(C=CCCO)=O)=O)=O,,,5,1,1,0,1
37456_0,,,,2,1,2,3
C(CC(C(CC=CCO)=O)=O)=O,,,5,1,1,0,1
37457_0,,,,2,1,2,3
37459_0,,,,2,1,2,3
C(CCO)=CC(C(C(C)O)=O)=O,,,5,1,1,0,1
37460_0,,,,2,1,2,3
37462_0,,,,2,1,2,3
C(CC(C(C(C)O)=O)=O)=CCO,,,5,1,1,0,1
37463_0,,,,2,1,2,3
37465_0,,,,2,1,2,3
C(CCO)=CC(C(C(O)=O)=O)=O,,,5,1,1,0,1
37467_0,,,,2,1,2,3
C(CC(C(C(O)=O)=O)=O)=CCO,,,5,1,1,0,1
37468_0,,,,2,1,2,3
37470_0,,,,2,1,2,3
C(CO)(C(C=CCO)O)=O,,,5,1,1,0,1
37471_0,,,,2,1,2,3
37473_0,,,,2,1,2,3
C(CCO)=CC(CO)=O,,,5,1,1,0,1
37475_0,,,,2,1,2,3
C(CO)(CC=CCO)=O,,,5,1,1,0,1
37476_0,,,,2,1,2,3
37478_0,,,,2,1,2,3
C(C)(C(C=CCO)O)=O,,,5,1,1,0,1
37479_0,,,,2,1,2,3
37481_0,,,,2,1,2,3
C(C(C(C=CCCO)=O)C)(O)=O,,,5,1,1,0,1
37483_0,,,,2,1,2,3
C(C(C(CC=CCO)=O)C)(O)=O,,,5,1,1,0,1
37484_0,,,,2,1,2,3
37486_0,,,,2,1,2,3
C(CCO)=C(C=O)C=C,,,5,1,1,0,1
37488_0,,,,2,1,2,3
C(C(C=C)C=CCO)=O,,,5,1,1,0,1
37489_0,,,,2,1,2,3
37491_0,,,,2,1,2,3
C(CCO)=C(C=C)C(C(O)=O)=O,,,5,1,1,0,1
37493_0,,,,2,1,2,3
C=CC(C=CCO)C(C(O)=O)=O,,,5,1,1,0,1
37494_0,,,,2,1,2,3
37496_0,,,,2,1,2,3
C=C(C(O)=O)C(C=O)=CCCO,,,5,1,1,0,1
37498_0,,,,2,1,2,3
C(C(C=CCO)C(C(O)=O)=C)=O,,,5,1,1,0,1
37499_0,,,,2,1,2,3
37501_0,,,,2,1,2,3
C(C(C=CCO)O)=O,,,5,1,1,0,1
37502_0,,,,2,1,2,3
37504_0,,,,2,1,2,3
C(CCO)=C1C(C(OC1C)=O)=O,,,5,1,1,0,1
37506_0,,,,2,1,2,3
C(C1C(C(OC1C)=O)=O)=CCO,,,5,1,1,0,1
37507_0,,,,2,1,2,3
37509_0,,,,2,1,2,3
C(CCO)=C1C(OC(C1=O)=O)=O,,,5,1,1,0,1
37511_0,,,,2,1,2,3
C1(C(C=CCO)C(C(O1)=O)=O)=O,,,5,1,1,0,1
37512_0,,,,2,1,2,3
37514_0,,,,2,1,2,3
C(CCO)=C(C=O)C[CH]C(O)=O,,,5,1,1,0,1
37516_0,,,,2,1,2,3
C(C(C=CCO)C[CH]C(O)=O)=O,,,5,1,1,0,1
37517_0,,,,2,1,2,3
37519_0,,,,2,1,2,3
C(CCC(C=O)=CCCO)(O)=O,,,5,1,1,0,1
37521_0,,,,2,1,2,3
C(CCC(C=O)C=CCO)(O)=O,,,5,1,1,0,1
37522_0,,,,2,1,2,3
37524_0,,,,2,1,2,3
C(CCO)=CC=O,,,5,1,2,0,2
37526_0,,,,2,1,2,3
C(CC=CCO)=O,,,5,1,1,0,1
37527_0,,,,2,1,2,3
37529_0,,,,2,1,2,3
C(C)=C(C=O)C(CCO)O,,,5,1,1,0,1
37531_0,,,,2,1,2,3
C(CCO)=C(C=O)C(C)O,,,5,1,1,0,1
37532_0,,,,2,1,2,3
37534_0,,,,2,1,2,3
C(C(C=CCO)C(C)O)=O,,,5,1,1,0,1
37535_0,,,,2,1,2,3
37537_0,,,,2,1,2,3
C(CCO)=C(C(O)=O)C=O,,,5,1,1,0,1
37539_0,,,,2,1,2,3
C(C(C=O)C=CCO)(O)=O,,,5,1,1,0,1
37540_0,,,,2,1,2,3
37542_0,,,,2,1,2,3
C(C(C(C=O)=O)O)=CCO,,,5,1,1,0,1
37543_0,,,,2,1,2,3
37545_0,,,,2,1,2,3
C(CCO)=CC(C=O)=O,,,5,1,1,0,1
37547_0,,,,2,1,2,3
C(CC(C=O)=O)=CCO,,,5,1,1,0,1
37548_0,,,,2,1,2,3
37550_0,,,,2,1,2,3
C(C(C(C(O)=O)=O)O)=CCO,,,5,1,1,0,1
37551_0,,,,2,1,2,3
37553_0,,,,2,1,2,3
C(CCO)=CC(C(O)=O)=O,,,5,1,2,0,2
37555_0,,,,2,1,2,3
C(CC(C(O)=O)=O)=CCO,,,5,1,1,0,1
37556_0,,,,2,1,2,3
37558_0,,,,2,1,2,3
C(C(C(C(O)=O)=CCO)CO)=O,,,5,1,1,0,1
37559_0,,,,2,1,2,3
37561_0,,,,2,1,2,3
C(C(CCO)=C(C=O)CO)(O)=O,,,5,1,1,0,1
37563_0,,,,2,1,2,3
C(C(C(C=O)=C)(CCO)O)(O)=O,,,5,1,2,0,2
37565_0,,,,2,1,2,3
C(C(C(C(C)=O)=CC=O)CO)=O,,,5,1,1,0,1
37567_0,,,,2,1,2,3
C(CC(C(C)=O)=C(C=O)CO)=O,,,5,1,1,0,1
37569_0,,,,2,1,2,3
C(CC(C(C)=O)(C(C=O)=C)O)=O,,,5,1,2,0,2
37571_0,,,,2,1,2,3
C(C(C(C(CC=O)=O)=C)CO)=O,,,5,1,1,0,1
37573_0,,,,2,1,2,3
C(CC(C(C)=C(C=O)CO)=O)=O,,,5,1,1,0,1
37575_0,,,,2,1,2,3
C(CC=O)(C(C(C=O)=C)(C)O)=O,,,5,1,2,0,2
37577_0,,,,2,1,2,3
C(C(C=CC(C(C)=O)=O)CO)=O,,,5,1,1,0,1
37579_0,,,,2,1,2,3
C(CC(C(C)=O)=O)=C(C=O)CO,,,5,1,1,0,1
37581_0,,,,2,1,2,3
C=C(C=O)C(CC(C(C)=O)=O)O,,,5,1,2,0,2
37582_0,,,,2,1,2,3
37584_0,,,,2,1,2,3
C(C(C(C)O)=C(C=O)CO)(C)=O,,,5,1,1,0,1
37586_0,,,,2,1,2,3
C(C)(C(C(C=O)=C)(C(C)O)O)=O,,,5,1,2,0,2
37588_0,,,,2,1,2,3
C(C(C(C(C(C)O)=O)=C)CO)=O,,,5,1,1,0,1
37589_0,,,,2,1,2,3
37591_0,,,,2,1,2,3
C(C(C)=C(C=O)CO)(C(C)O)=O,,,5,1,1,0,1
37593_0,,,,2,1,2,3
C(C(C)O)(C(C(C=O)=C)(C)O)=O,,,5,1,2,0,2
37595_0,,,,2,1,2,3
C(C(C(C)=O)=C(C=O)CO)(O)=O,,,5,1,1,0,1
37597_0,,,,2,1,2,3
C(C(C(C)=O)(C(C=O)=C)O)(O)=O,,,5,1,2,0,2
37599_0,,,,2,1,2,3
C(C(C(C(C(O)=O)=O)=C)CO)=O,,,5,1,1,0,1
37601_0,,,,2,1,2,3
C(C(C(C)=C(C=O)CO)=O)(O)=O,,,5,1,1,0,1
37603_0,,,,2,1,2,3
C=C(C=O)C(C(C(O)=O)=O)(C)O,,,5,1,2,0,2
37604_0,,,,2,1,2,3
37606_0,,,,2,1,2,3
C(C(C(C=O)=C)O)=O,,,5,1,5,0,5
37608_0,,,,2,1,2,3
C(C(C=C(C=O)CO)O)=O,,,5,1,3,0,3
37610_0,,,,2,1,2,3
C(C(C(C(C=O)=C)O)O)=O,,,5,1,4,0,4
37611_0,,,,2,1,2,3
37612_0,,,,2,1,2,3
37614_0,,,,2,1,2,3
C(CO)(CO)=C(C=O)CO,,,5,1,1,0,1
37616_0,,,,2,1,2,3
C=C(C=O)C(CO)(CO)O,,,5,1,2,0,2
37618_0,,,,2,1,2,3
C(C(C(CO)=C)CO)=O,,,5,1,1,0,1
37620_0,,,,2,1,2,3
C(C)(CO)=C(C=O)CO,,,5,1,1,0,1
37622_0,,,,2,1,2,3
C=C(C=O)C(CO)(C)O,,,5,1,4,0,4
37623_0,,,,2,1,2,3
37625_0,,,,2,1,2,3
C(C(C=C(C=O)CO)(C)O)(O)=O,,,5,1,1,0,1
37627_0,,,,2,1,2,3
C(C(C)(C(C(C=O)=C)O)O)(O)=O,,,5,1,2,0,2
37629_0,,,,2,1,2,3
C(C(C(C(C=O)CO)=C)C)(O)=O,,,5,1,1,0,1
37631_0,,,,2,1,2,3
C(C(C(C)=C(C(O)=O)C)CO)=O,,,5,1,1,0,1
37633_0,,,,2,1,2,3
C(C(C(C)=C(C=O)CO)C)(O)=O,,,5,1,1,0,1
37635_0,,,,2,1,2,3
C(C(C)C(C(C=O)=C)(C)O)(O)=O,,,5,1,2,0,2
37637_0,,,,2,1,2,3
C(C)=CC=C(C=O)CO,,,5,1,1,0,1
37639_0,,,,2,1,2,3
C(C(C(C=O)=C)O)=CC,,,5,1,4,0,4
37641_0,,,,2,1,2,3
C(C(C=CC=C)CO)=O,,,5,1,1,0,1
37643_0,,,,2,1,2,3
C=CCC=C(C=O)CO,,,5,1,1,0,1
37645_0,,,,2,1,2,3
C=CCC(C(C=O)=C)O,,,5,1,4,0,4
37647_0,,,,2,1,2,3
C(C)=CC(C(O)=O)=C(C=O)CO,,,5,1,1,0,1
37649_0,,,,2,1,2,3
C(C(C=CC)(C(C=O)=C)O)(O)=O,,,5,1,2,0,2
37651_0,,,,2,1,2,3
C(C(C(C(O)=O)=CC=C)CO)=O,,,5,1,1,0,1
37653_0,,,,2,1,2,3
C=CCC(C(O)=O)=C(C=O)CO,,,5,1,1,0,1
37655_0,,,,2,1,2,3
C(C(C(C=O)=C)(CC=C)O)(O)=O,,,5,1,2,0,2
37657_0,,,,2,1,2,3
C(C(C=CC(C(O)=O)=C)CO)=O,,,5,1,1,0,1
37659_0,,,,2,1,2,3
C(CC(C(O)=O)=C)=C(C=O)CO,,,5,1,1,0,1
37661_0,,,,2,1,2,3
C=C(C(O)=O)CC(C(C=O)=C)O,,,5,1,2,0,2
37663_0,,,,2,1,2,3
C(C(CO)=CC=C(C(O)=O)C)=O,,,5,1,1,0,1
37665_0,,,,2,1,2,3
C(C(C(C=O)=C)O)=C(C(O)=O)C,,,5,1,2,0,2
37667_0,,,,2,1,2,3
C(C(CO)O)=C(C=O)CO,,,5,1,1,0,1
37669_0,,,,2,1,2,3
C=C(C=O)C(C(CO)O)O,,,5,1,2,0,2
37670_0,,,,2,1,2,3
37672_0,,,,2,1,2,3
C=C(C=O)C(CO)O,,,5,1,6,0,6
37674_0,,,,2,1,2,3
C(C(C1C(OC(C=1)C)=O)CO)=O,,,5,1,1,0,1
37676_0,,,,2,1,2,3
C1(C(CC(C)O1)=C(C=O)CO)=O,,,5,1,1,0,1
37678_0,,,,2,1,2,3
C1(C(C(C=O)=C)(CC(C)O1)O)=O,,,5,1,2,0,2
37680_0,,,,2,1,2,3
C(C(C1C(OC(C=1)=O)=O)CO)=O,,,5,1,1,0,1
37682_0,,,,2,1,2,3
C1(CC(C(O1)=O)=C(C=O)CO)=O,,,5,1,1,0,1
37684_0,,,,2,1,2,3
C1(C(C(C=O)=C)(CC(O1)=O)O)=O,,,5,1,2,0,2
37685_0,,,,2,1,2,3
37687_0,,,,2,1,2,3
C(CC[CH]C(O)=O)=C(C=O)CO,,,5,1,2,0,2
37689_0,,,,2,1,2,3
C=C(C=O)C(CC[CH]C(O)=O)O,,,5,1,3,0,3
37690_0,,,,2,1,2,3
37692_0,,,,2,1,2,3
C(CCCC=C(C=O)CO)(O)=O,,,5,1,2,0,2
37694_0,,,,2,1,2,3
C(CCCC(C(C=O)=C)O)(O)=O,,,5,1,3,0,3
37695_0,,,,2,1,2,3
37697_0,,,,2,1,2,3
C(C(C)O)=C(C=O)CO,,,5,1,1,0,1
37699_0,,,,2,1,2,3
C=C(C=O)C(C(C)O)O,,,5,1,4,0,4
37700_0,,,,2,1,2,3
37701_0,,,,2,1,2,3
37703_0,,,,2,1,2,3
C=C(C=O)CO,,,5,1,8,0,8
37704_0,,,,2,1,2,3
37705_0,,,,2,1,2,3
37707_0,,,,2,1,2,3
C(C(CCO)=CC(CO)=O)(O)=O,,,5,1,1,0,1
37709_0,,,,2,1,2,3
C(CO)(CC(C(O)=O)=CCO)=O,,,5,1,1,0,1
37710_0,,,,2,1,2,3
37712_0,,,,2,1,2,3
C(C)(C(C(C(O)=O)=CCO)O)=O,,,5,1,1,0,1
37713_0,,,,2,1,2,3
37715_0,,,,2,1,2,3
C=CC(C=O)=C(C(O)=O)CCO,,,5,1,1,0,1
37717_0,,,,2,1,2,3
C(C(C=C)C(C(O)=O)=CCO)=O,,,5,1,1,0,1
37718_0,,,,2,1,2,3
37720_0,,,,2,1,2,3
C(C(C(C(O)=O)=CCO)O)=O,,,5,1,1,0,1
37721_0,,,,2,1,2,3
37723_0,,,,2,1,2,3
C(C(CCO)=CC=O)(O)=O,,,5,1,2,0,2
37725_0,,,,2,1,2,3
C(CC(C(O)=O)=CCO)=O,,,5,1,1,0,1
37726_0,,,,2,1,2,3
37728_0,,,,2,1,2,3
C(C(C=C(C(O)=O)CCO)=O)=O,,,5,1,1,0,1
37730_0,,,,2,1,2,3
C(CO)=C(C(O)=O)CC(C=O)=O,,,5,1,1,0,1
37731_0,,,,2,1,2,3
37733_0,,,,2,1,2,3
C(C(C(CO)=CC=O)=O)(O)=O,,,5,1,2,0,2
37735_0,,,,2,1,2,3
C(C(C(C(C(O)=O)=O)=C)O)=O,,,5,1,2,0,2
37737_0,,,,2,1,2,3
C=C(CO)C(C(C(O)=O)=O)CO,,,5,1,1,0,1
37739_0,,,,2,1,2,3
C(C)(CO)=C(C(C(O)=O)=O)CO,,,5,1,1,0,1
37741_0,,,,2,1,2,3
C=C(C(C(O)=O)=O)C(CO)(C)O,,,5,1,1,0,1
37743_0,,,,2,1,2,3
C(C)=CC=C(C(C(O)=O)=O)CO,,,5,1,1,0,1
37745_0,,,,2,1,2,3
C(C(C(C(C(O)=O)=O)=C)O)=CC,,,5,1,1,0,1
37747_0,,,,2,1,2,3
C=CC=CC(C(C(O)=O)=O)CO,,,5,1,1,0,1
37749_0,,,,2,1,2,3
C=CCC=C(C(C(O)=O)=O)CO,,,5,1,1,0,1
37751_0,,,,2,1,2,3
C=CCC(C(C(C(O)=O)=O)=C)O,,,5,1,1,0,1
37753_0,,,,2,1,2,3
C(CO)=C(C(C(O)=O)=O)CO,,,5,1,1,0,1
37755_0,,,,2,1,2,3
C=C(C(C(O)=O)=O)C(CO)O,,,5,1,1,0,1
37756_0,,,,2,1,2,3
37758_0,,,,2,1,2,3
C(C(C)O)=C(C(C(O)=O)=O)CO,,,5,1,1,0,1
37760_0,,,,2,1,2,3
C=C(C(C(O)=O)=O)C(C(C)O)O,,,5,1,1,0,1
37762_0,,,,2,1,2,3
C(C(C(CO)=CC(O)=O)=O)(O)=O,,,5,1,2,0,2
37764_0,,,,2,1,2,3
C(C(C(C(C(O)=O)=O)=C)O)(O)=O,,,5,1,2,0,2
37766_0,,,,2,1,2,3
C=C(C(C(O)=O)=O)CO,,,5,1,3,0,3
37768_0,,,,2,1,2,3
C(C(CO)(CC=CC=O)O)(O)=O,,,5,1,2,0,2
37770_0,,,,2,1,2,3
C(C(C=CCC=O)(CO)O)(O)=O,,,5,1,1,0,1
37771_0,,,,2,1,2,3
37773_0,,,,2,1,2,3
C(C(C(C(C)O)O)=CC=O)(O)=O,,,5,1,1,0,1
37774_0,,,,2,1,2,3
37776_0,,,,2,1,2,3
C(C(C(C(O)=O)=CC=O)O)(O)=O,,,5,1,3,0,3
37778_0,,,,2,1,2,3
C(CC(C(C)=O)=CC(CO)=O)=O,,,5,1,1,0,1
37780_0,,,,2,1,2,3
C(CO)(CC(C(C)=O)=CC=O)=O,,,5,1,1,0,1
37782_0,,,,2,1,2,3
C(C)(C(C(C(C)=O)=CC=O)O)=O,,,5,1,1,0,1
37784_0,,,,2,1,2,3
C(CC(C(C)=O)=C(C=O)C=C)=O,,,5,1,1,0,1
37786_0,,,,2,1,2,3
C(C(C=C)C(C(C)=O)=CC=O)=O,,,5,1,1,0,1
37788_0,,,,2,1,2,3
C(C(C(C(C)=O)=CC=O)O)=O,,,5,1,1,0,1
37790_0,,,,2,1,2,3
C(CC(C(C)=O)=CC=O)=O,,,5,1,1,0,1
37792_0,,,,2,1,2,3
C(CC(C(C)=O)=CC(C=O)=O)=O,,,5,1,1,0,1
37794_0,,,,2,1,2,3
C(C(CC(C(C)=O)=CC=O)=O)=O,,,5,1,1,0,1
37796_0,,,,2,1,2,3
C(CC(C(C)=CC(CO)=O)=O)=O,,,5,1,1,0,1
37798_0,,,,2,1,2,3
C(CC(C(CC(CO)=O)=C)=O)=O,,,5,1,1,0,1
37800_0,,,,2,1,2,3
C(CC(C(C(C(C)=O)O)=C)=O)=O,,,5,1,1,0,1
37802_0,,,,2,1,2,3
C(CC(C(C)=C(C=O)C=C)=O)=O,,,5,1,1,0,1
37804_0,,,,2,1,2,3
C(C(C=C)C(C(CC=O)=O)=C)=O,,,5,1,1,0,1
37806_0,,,,2,1,2,3
C(CC(C(C(C=O)O)=C)=O)=O,,,5,1,1,0,1
37808_0,,,,2,1,2,3
C(CC(C(C)=CC=O)=O)=O,,,5,1,1,0,1
37810_0,,,,2,1,2,3
C(CC(C(CC=O)=O)=C)=O,,,5,1,1,0,1
37812_0,,,,2,1,2,3
C(CC(C(C)=CC(C=O)=O)=O)=O,,,5,1,1,0,1
37814_0,,,,2,1,2,3
C(CC(C(CC(C=O)=O)=C)=O)=O,,,5,1,1,0,1
37816_0,,,,2,1,2,3
C(CC(C(C)=O)=O)=CC(CO)=O,,,5,1,1,0,1
37818_0,,,,2,1,2,3
C(CO)(CC=CC(C(C)=O)=O)=O,,,5,1,1,0,1
37820_0,,,,2,1,2,3
C(C)(C(C=CC(C(C)=O)=O)O)=O,,,5,1,1,0,1
37822_0,,,,2,1,2,3
C(CC(C(C)=O)=O)=C(C=O)C=C,,,5,1,1,0,1
37824_0,,,,2,1,2,3
C(C(C=C)C=CC(C(C)=O)=O)=O,,,5,1,1,0,1
37826_0,,,,2,1,2,3
C(C(C=CC(C(C)=O)=O)O)=O,,,5,1,1,0,1
37827_0,,,,2,1,2,3
37828_0,,,,2,1,2,3
37830_0,,,,2,1,2,3
C(CC(C(C)=O)=O)=CC(C=O)=O,,,5,1,1,0,1
37832_0,,,,2,1,2,3
C(CC(C=O)=O)=CC(C(C)=O)=O,,,5,1,1,0,1
37834_0,,,,2,1,2,3
C(C(C(C(C)=O)=O)=CC=O)=O,,,5,1,1,0,1
37836_0,,,,2,1,2,3
C(C(C(CO)=C)C(C(C)=O)=O)=O,,,5,1,1,0,1
37838_0,,,,2,1,2,3
C(C)(CO)=C(C=O)C(C(C)=O)=O,,,5,1,1,0,1
37840_0,,,,2,1,2,3
C(C)=CC=C(C=O)C(C(C)=O)=O,,,5,1,1,0,1
37842_0,,,,2,1,2,3
C(C(C=CC=C)C(C(C)=O)=O)=O,,,5,1,1,0,1
37844_0,,,,2,1,2,3
C=CCC=C(C=O)C(C(C)=O)=O,,,5,1,1,0,1
37846_0,,,,2,1,2,3
C(CO)=C(C=O)C(C(C)=O)=O,,,5,1,1,0,1
37847_0,,,,2,1,2,3
37849_0,,,,2,1,2,3
C(C(C)O)=C(C=O)C(C(C)=O)=O,,,5,1,1,0,1
37851_0,,,,2,1,2,3
C(C(C(C(C)=O)=O)=CC(O)=O)=O,,,5,1,1,0,1
37852_0,,,,2,1,2,3
37853_0,,,,2,1,2,3
37855_0,,,,2,1,2,3
C(C(C(C(C)=O)=O)C(C=O)=C)=O,,,5,1,1,0,1
37857_0,,,,2,1,2,3
C(C(C(C(C)=O)=O)=C(C=O)C)=O,,,5,1,1,0,1
37859_0,,,,2,1,2,3
C(C(C(C(C)=O)=O)=CC(C)=O)=O,,,5,1,1,0,1
37860_0,,,,2,1,2,3
37862_0,,,,2,1,2,3
C(CC(C(C=CC=O)=O)=O)=O,,,5,1,1,0,1
37864_0,,,,2,1,2,3
C(CC(C(CC(CO)=C)=O)=O)=O,,,5,1,1,0,1
37866_0,,,,2,1,2,3
C(CC(C(C=C(C)CO)=O)=O)=O,,,5,1,1,0,1
37868_0,,,,2,1,2,3
C(CC(C(C=CC=CC)=O)=O)=O,,,5,1,1,0,1
37870_0,,,,2,1,2,3
C(CC(C(CC=CC=C)=O)=O)=O,,,5,1,1,0,1
37872_0,,,,2,1,2,3
C(CC(C(C=CCC=C)=O)=O)=O,,,5,1,1,0,1
37874_0,,,,2,1,2,3
C(CC(C(C=CCO)=O)=O)=O,,,5,1,1,0,1
37875_0,,,,2,1,2,3
37877_0,,,,2,1,2,3
C(CC(C(C=CC(C)O)=O)=O)=O,,,5,1,1,0,1
37879_0,,,,2,1,2,3
C(CC(C(C=CC(O)=O)=O)=O)=O,,,5,1,1,0,1
37880_0,,,,2,1,2,3
37881_0,,,,2,1,2,3
37883_0,,,,2,1,2,3
C(CC(C(CC(C=O)=C)=O)=O)=O,,,5,1,1,0,1
37885_0,,,,2,1,2,3
C(CC(C(C=C(C=O)C)=O)=O)=O,,,5,1,1,0,1
37887_0,,,,2,1,2,3
C(CC(C(C=CC(C)=O)=O)=O)=O,,,5,1,1,0,1
37889_0,,,,2,1,2,3
C(CC(C(C=C)=O)=O)=O,,,5,1,4,0,4
37890_0,,,,2,1,2,3
37892_0,,,,2,1,2,3
C(C(CO)=CC=O)(C(C)O)=O,,,5,1,1,0,1
37893_0,,,,2,1,2,3
37894_0,,,,2,1,2,3
37896_0,,,,2,1,2,3
C(C=C(C(CO)=O)C(C)O)=O,,,5,1,1,0,1
37897_0,,,,2,1,2,3
37898_0,,,,2,1,2,3
37899_0,,,,2,1,2,3
37901_0,,,,2,1,2,3
C=CC(C(C(C(C)O)=O)=O)O,,,5,1,1,0,1
37902_0,,,,2,1,2,3
37903_0,,,,2,1,2,3
37904_0,,,,2,1,2,3
37905_0,,,,2,1,2,3
37907_0,,,,2,1,2,3
C(C(C(CO)=O)=CC=O)(O)=O,,,5,1,1,0,1
37909_0,,,,2,1,2,3
C=CC(C(C(C(O)=O)=O)=O)O,,,5,1,1,0,1
37911_0,,,,2,1,2,3
C(C(C(C)O)=CC(CO)=O)(C)=O,,,5,1,1,0,1
37912_0,,,,2,1,2,3
37913_0,,,,2,1,2,3
37915_0,,,,2,1,2,3
C=CC(C=O)=C(C(C)=O)C(C)O,,,5,1,1,0,1
37916_0,,,,2,1,2,3
37917_0,,,,2,1,2,3
37919_0,,,,2,1,2,3
C(C=C(C(C)=O)C(C)O)=O,,,5,1,1,0,1
37920_0,,,,2,1,2,3
37922_0,,,,2,1,2,3
C(C(C=C(C(C)=O)C(C)O)=O)=O,,,5,1,1,0,1
37923_0,,,,2,1,2,3
37925_0,,,,2,1,2,3
C(C(C)=CC(CO)=O)(C(C)O)=O,,,5,1,1,0,1
37927_0,,,,2,1,2,3
C(CO)(CC(C(C(C)O)=O)=C)=O,,,5,1,1,0,1
37928_0,,,,2,1,2,3
37930_0,,,,2,1,2,3
C(C)(C(C(C(C(C)O)=O)=C)O)=O,,,5,1,1,0,1
37931_0,,,,2,1,2,3
37933_0,,,,2,1,2,3
C=CC(C=O)=C(C(C(C)O)=O)C,,,5,1,1,0,1
37935_0,,,,2,1,2,3
C(C(C=C)C(C(C(C)O)=O)=C)=O,,,5,1,1,0,1
37936_0,,,,2,1,2,3
37938_0,,,,2,1,2,3
C(C(C(C(C(C)O)=O)=C)O)=O,,,5,1,1,0,1
37939_0,,,,2,1,2,3
37941_0,,,,2,1,2,3
C(C(C)=CC=O)(C(C)O)=O,,,5,1,1,0,1
37943_0,,,,2,1,2,3
C(CC(C(C(C)O)=O)=C)=O,,,5,1,1,0,1
37944_0,,,,2,1,2,3
37946_0,,,,2,1,2,3
C(C(C=C(C(C(C)O)=O)C)=O)=O,,,5,1,1,0,1
37948_0,,,,2,1,2,3
C=C(C(C(C)O)=O)CC(C=O)=O,,,5,1,1,0,1
37949_0,,,,2,1,2,3
37951_0,,,,2,1,2,3
C(C(C=CC=O)=O)(C(C)O)=O,,,5,1,1,0,1
37952_0,,,,2,1,2,3
37954_0,,,,2,1,2,3
C=C(CO)CC(C(C(C)O)=O)=O,,,5,1,1,0,1
37956_0,,,,2,1,2,3
C(CO)(C)=CC(C(C(C)O)=O)=O,,,5,1,1,0,1
37957_0,,,,2,1,2,3
37959_0,,,,2,1,2,3
C(C)=CC=CC(C(C(C)O)=O)=O,,,5,1,1,0,1
37960_0,,,,2,1,2,3
37962_0,,,,2,1,2,3
C=CC=CCC(C(C(C)O)=O)=O,,,5,1,1,0,1
37964_0,,,,2,1,2,3
C=CCC=CC(C(C(C)O)=O)=O,,,5,1,1,0,1
37965_0,,,,2,1,2,3
37967_0,,,,2,1,2,3
C(CO)=CC(C(C(C)O)=O)=O,,,5,1,1,0,1
37968_0,,,,2,1,2,3
37969_0,,,,2,1,2,3
37971_0,,,,2,1,2,3
C(C(C)O)=CC(C(C(C)O)=O)=O,,,5,1,1,0,1
37972_0,,,,2,1,2,3
37974_0,,,,2,1,2,3
C(C(C=CC(O)=O)=O)(C(C)O)=O,,,5,1,1,0,1
37975_0,,,,2,1,2,3
37977_0,,,,2,1,2,3
C=CCC(C(C(C)O)=O)=O,,,5,1,1,0,1
37979_0,,,,2,1,2,3
C(C)=CC(C(C(C)O)=O)=O,,,5,1,2,0,2
37980_0,,,,2,1,2,3
37981_0,,,,2,1,2,3
37983_0,,,,2,1,2,3
C=C(C=O)CC(C(C(C)O)=O)=O,,,5,1,1,0,1
37985_0,,,,2,1,2,3
C(C(C=C(C=O)C)=O)(C(C)O)=O,,,5,1,1,0,1
37986_0,,,,2,1,2,3
37988_0,,,,2,1,2,3
C(C(C=CC(C)=O)=O)(C(C)O)=O,,,5,1,1,0,1
37989_0,,,,2,1,2,3
37991_0,,,,2,1,2,3
C=CC(C(C(C)O)=O)=O,,,5,1,3,0,3
37992_0,,,,2,1,2,3
37994_0,,,,2,1,2,3
C(C(C(C)=O)=CC(CO)=O)(O)=O,,,5,1,1,0,1
37996_0,,,,2,1,2,3
C=CC(C=O)=C(C(O)=O)C(C)=O,,,5,1,1,0,1
37998_0,,,,2,1,2,3
C(C=C(C(O)=O)C(C)=O)=O,,,5,1,1,0,1
38000_0,,,,2,1,2,3
C(C(C=C(C(O)=O)C(C)=O)=O)=O,,,5,1,1,0,1
38002_0,,,,2,1,2,3
C(C(C(C)=CC(CO)=O)=O)(O)=O,,,5,1,1,0,1
38004_0,,,,2,1,2,3
C(CO)(CC(C(C(O)=O)=O)=C)=O,,,5,1,1,0,1
38005_0,,,,2,1,2,3
38007_0,,,,2,1,2,3
C=CC(C=O)=C(C(C(O)=O)=O)C,,,5,1,1,0,1
38009_0,,,,2,1,2,3
C(C(C=C)C(C(C(O)=O)=O)=C)=O,,,5,1,1,0,1
38010_0,,,,2,1,2,3
38012_0,,,,2,1,2,3
C(C=C(C(C(O)=O)=O)C)=O,,,5,1,1,0,1
38014_0,,,,2,1,2,3
C(CC(C(C(O)=O)=O)=C)=O,,,5,1,1,0,1
38016_0,,,,2,1,2,3
C(C(C=C(C(C(O)=O)=O)C)=O)=O,,,5,1,1,0,1
38018_0,,,,2,1,2,3
C=C(C(C(O)=O)=O)CC(C=O)=O,,,5,1,1,0,1
38020_0,,,,2,1,2,3
C(C=CC(C(C(O)=O)=O)=O)=O,,,5,1,1,0,1
38022_0,,,,2,1,2,3
C=C(CO)CC(C(C(O)=O)=O)=O,,,5,1,1,0,1
38024_0,,,,2,1,2,3
C(C)(CO)=CC(C(C(O)=O)=O)=O,,,5,1,1,0,1
38026_0,,,,2,1,2,3
C(C)=CC=CC(C(C(O)=O)=O)=O,,,5,1,1,0,1
38028_0,,,,2,1,2,3
C=CC=CCC(C(C(O)=O)=O)=O,,,5,1,1,0,1
38030_0,,,,2,1,2,3
C=CCC=CC(C(C(O)=O)=O)=O,,,5,1,1,0,1
38032_0,,,,2,1,2,3
C(CO)=CC(C(C(O)=O)=O)=O,,,5,1,1,0,1
38033_0,,,,2,1,2,3
38035_0,,,,2,1,2,3
C(C(C)O)=CC(C(C(O)=O)=O)=O,,,5,1,1,0,1
38037_0,,,,2,1,2,3
C(C(C(C=CC(O)=O)=O)=O)(O)=O,,,5,1,1,0,1
38039_0,,,,2,1,2,3
C=CCC(C(C(O)=O)=O)=O,,,5,1,1,0,1
38041_0,,,,2,1,2,3
C(C)=CC(C(C(O)=O)=O)=O,,,5,1,2,0,2
38043_0,,,,2,1,2,3
C=C(C=O)CC(C(C(O)=O)=O)=O,,,5,1,1,0,1
38045_0,,,,2,1,2,3
C(C(C)=CC(C(C(O)=O)=O)=O)=O,,,5,1,1,0,1
38047_0,,,,2,1,2,3
C(C(C(C=CC(C)=O)=O)=O)(O)=O,,,5,1,1,0,1
38049_0,,,,2,1,2,3
C=CC(C(C(O)=O)=O)=O,,,5,1,4,0,4
38051_0,,,,2,1,2,3
C(C(C(C(C=C)=O)=O)(C)O)(O)=O,,,5,1,1,0,1
38052_0,,,,2,1,2,3
38053_0,,,,2,1,2,3
38055_0,,,,2,1,2,3
C(C(C(C=CC=O)=O)CO)(O)=O,,,5,1,1,0,1
38056_0,,,,2,1,2,3
38058_0,,,,2,1,2,3
C(C(C(C=CC=O)=O)C)(O)=O,,,5,1,1,0,1
38060_0,,,,2,1,2,3
C=CC(C=O)=CC=O,,,5,1,2,0,2
38062_0,,,,2,1,2,3
C=CC(C(C(O)=O)=O)=CC=O,,,5,1,1,0,1
38064_0,,,,2,1,2,3
C=C(C(O)=O)C(C=O)=CC=O,,,5,1,1,0,1
38066_0,,,,2,1,2,3
C=C1C(OC(C(C1=CC=O)=O)=O)=O,,,5,1,1,0,1
38068_0,,,,2,1,2,3
C(C=C1C(C(OC1C)=O)=O)=O,,,5,1,1,0,1
38070_0,,,,2,1,2,3
C1(C(C(C(O1)=O)=O)=CC=O)=O,,,5,1,1,0,1
38072_0,,,,2,1,2,3
C(C(C[CH]C(O)=O)=CC=O)=O,,,5,1,1,0,1
38074_0,,,,2,1,2,3
C(CCC(C=O)=CC=O)(O)=O,,,5,1,1,0,1
38075_0,,,,2,1,2,3
38076_0,,,,2,1,2,3
38077_0,,,,2,1,2,3
38078_0,,,,2,1,2,3
38080_0,,,,2,1,2,3
C(C(C(C(C(O)=O)=O)=CC)O)=O,,,5,1,1,0,1
38082_0,,,,2,1,2,3
C(C(C(C(C)O)=CC=O)=O)(O)=O,,,5,1,1,0,1
38083_0,,,,2,1,2,3
38084_0,,,,2,1,2,3
38085_0,,,,2,1,2,3
38087_0,,,,2,1,2,3
C(C(C(C=O)=C(C(O)=O)C)O)=O,,,5,1,1,0,1
38089_0,,,,2,1,2,3
C(C(C(C=O)=CC=O)(C)O)(O)=O,,,5,1,1,0,1
38091_0,,,,2,1,2,3
C(C=C(C(O)=O)C(C(O)=O)=O)=O,,,5,1,1,0,1
38092_0,,,,2,1,2,3
38093_0,,,,2,1,2,3
38094_0,,,,2,1,2,3
38095_0,,,,2,1,2,3
38097_0,,,,2,1,2,3
C=C([C](C(O)=O)O)C(C(C)=O)=O,,,5,1,2,0,2
38099_0,,,,2,1,2,3
[C](C(O)=O)=C(C(C(C)=O)=O)CO,,,5,1,1,0,1
38100_0,,,,2,1,2,3
38101_0,,,,2,1,2,3
38103_0,,,,2,1,2,3
C(C(C(C(C(C)=O)=O)=C)O)(O)=O,,,5,1,3,0,3
38105_0,,,,2,1,2,3
C(C=C(C(C(C)=O)=O)CO)(O)=O,,,5,1,1,0,1
38106_0,,,,2,1,2,3
38108_0,,,,2,1,2,3
C(C(C=CC(CO)=O)O)=O,,,5,1,3,0,3
38110_0,,,,2,1,2,3
C(C(C=C(C=O)C=C)O)=O,,,5,1,1,0,1
38111_0,,,,2,1,2,3
38112_0,,,,2,1,2,3
38113_0,,,,2,1,2,3
38114_0,,,,2,1,2,3
38115_0,,,,2,1,2,3
38116_0,,,,2,1,2,3
38117_0,,,,2,1,2,3
38118_0,,,,2,1,2,3
38120_0,,,,2,1,2,3
C(C(C=C(C=O)C=C)O)(O)=O,,,5,1,1,0,1
38122_0,,,,2,1,2,3
C(C(C=CC=O)O)(O)=O,,,5,1,2,0,2
38124_0,,,,2,1,2,3
C(C(C(C(C=O)=CC)O)O)(O)=O,,,5,1,1,0,1
38126_0,,,,2,1,2,3
C(C(C=C(C=O)C(C)O)O)(O)=O,,,5,1,1,0,1
38127_0,,,,2,1,2,3
38129_0,,,,2,1,2,3
C(C(C=C(C(O)=O)C=O)O)(O)=O,,,5,1,1,0,1
38131_0,,,,2,1,2,3
C(C(C=CC(C=O)=O)O)(O)=O,,,5,1,1,0,1
38133_0,,,,2,1,2,3
C(C(C=CC(C(O)=O)=O)O)(O)=O,,,5,1,2,0,2
38135_0,,,,2,1,2,3
C(CO)(CO)=CC(CO)=O,,,5,1,1,0,1
38137_0,,,,2,1,2,3
C=CC(C=O)=C(CO)CO,,,5,1,1,0,1
38138_0,,,,2,1,2,3
38139_0,,,,2,1,2,3
38140_0,,,,2,1,2,3
38141_0,,,,2,1,2,3
38142_0,,,,2,1,2,3
38143_0,,,,2,1,2,3
38144_0,,,,2,1,2,3
38146_0,,,,2,1,2,3
C(CO)(C(C(CO)=C)O)=O,,,5,1,1,0,1
38148_0,,,,2,1,2,3
C(CO)(C(C=CC=C)O)=O,,,5,1,1,0,1
38149_0,,,,2,1,2,3
38150_0,,,,2,1,2,3
38151_0,,,,2,1,2,3
38152_0,,,,2,1,2,3
38153_0,,,,2,1,2,3
38154_0,,,,2,1,2,3
38155_0,,,,2,1,2,3
38157_0,,,,2,1,2,3
C(C)(CO)=CC(CO)=O,,,5,1,1,0,1
38159_0,,,,2,1,2,3
C(CO)(CC(CO)=C)=O,,,5,1,1,0,1
38161_0,,,,2,1,2,3
C(C)(C(C(CO)=C)O)=O,,,5,1,1,0,1
38163_0,,,,2,1,2,3
C(C(C(C=C(CO)C)=O)C)(O)=O,,,5,1,1,0,1
38165_0,,,,2,1,2,3
C(C(C(CC(CO)=C)=O)C)(O)=O,,,5,1,1,0,1
38167_0,,,,2,1,2,3
C=CC(C=O)=C(C)CO,,,5,1,1,0,1
38169_0,,,,2,1,2,3
C(C(C=C)C(CO)=C)=O,,,5,1,1,0,1
38171_0,,,,2,1,2,3
C=CC(C(C(O)=O)=O)=C(C)CO,,,5,1,1,0,1
38173_0,,,,2,1,2,3
C=CC(C(CO)=C)C(C(O)=O)=O,,,5,1,1,0,1
38175_0,,,,2,1,2,3
C=C(C(O)=O)C(C=O)=C(C)CO,,,5,1,1,0,1
38177_0,,,,2,1,2,3
C(C(C(CO)=C)C(C(O)=O)=C)=O,,,5,1,1,0,1
38179_0,,,,2,1,2,3
C(C(C(CO)=C)O)=O,,,5,1,1,0,1
38181_0,,,,2,1,2,3
C(CO)(C)=C1C(C(OC1C)=O)=O,,,5,1,1,0,1
38183_0,,,,2,1,2,3
C=C(CO)C1C(C(OC1C)=O)=O,,,5,1,1,0,1
38185_0,,,,2,1,2,3
C(C)(CO)=C1C(OC(C1=O)=O)=O,,,5,1,1,0,1
38187_0,,,,2,1,2,3
C1(C(C(CO)=C)C(C(O1)=O)=O)=O,,,5,1,1,0,1
38189_0,,,,2,1,2,3
C(C)(CO)=C(C=O)C[CH]C(O)=O,,,5,1,1,0,1
38191_0,,,,2,1,2,3
C(C(C(CO)=C)C[CH]C(O)=O)=O,,,5,1,1,0,1
38193_0,,,,2,1,2,3
C(CCC(C=O)=C(C)CO)(O)=O,,,5,1,1,0,1
38195_0,,,,2,1,2,3
C(CCC(C=O)C(CO)=C)(O)=O,,,5,1,1,0,1
38196_0,,,,2,1,2,3
38197_0,,,,2,1,2,3
38198_0,,,,2,1,2,3
38199_0,,,,2,1,2,3
38200_0,,,,2,1,2,3
38201_0,,,,2,1,2,3
38202_0,,,,2,1,2,3
38203_0,,,,2,1,2,3
38204_0,,,,2,1,2,3
38205_0,,,,2,1,2,3
38206_0,,,,2,1,2,3
38207_0,,,,2,1,2,3
38208_0,,,,2,1,2,3
38209_0,,,,2,1,2,3
38210_0,,,,2,1,2,3
38212_0,,,,2,1,2,3
C(C(C=CC(CO)=O)(C)O)(O)=O,,,5,1,1,0,1
38214_0,,,,2,1,2,3
C(C(C(CC(CO)=O)=C)C)(O)=O,,,5,1,1,0,1
38216_0,,,,2,1,2,3
C(CO)(CC(C)=C(C(O)=O)C)=O,,,5,1,1,0,1
38218_0,,,,2,1,2,3
C(C(C(C)=CC(CO)=O)C)(O)=O,,,5,1,1,0,1
38220_0,,,,2,1,2,3
C(C)=CC=CC(CO)=O,,,5,1,1,0,1
38222_0,,,,2,1,2,3
C(CO)(CC=CC=C)=O,,,5,1,1,0,1
38224_0,,,,2,1,2,3
C=CCC=CC(CO)=O,,,5,1,1,0,1
38226_0,,,,2,1,2,3
C(C)=CC(C(O)=O)=CC(CO)=O,,,5,1,1,0,1
38228_0,,,,2,1,2,3
C(CO)(CC(C(O)=O)=CC=C)=O,,,5,1,1,0,1
38230_0,,,,2,1,2,3
C=CCC(C(O)=O)=CC(CO)=O,,,5,1,1,0,1
38232_0,,,,2,1,2,3
C(CO)(CC=CC(C(O)=O)=C)=O,,,5,1,1,0,1
38234_0,,,,2,1,2,3
C=C(C(O)=O)CC=CC(CO)=O,,,5,1,1,0,1
38236_0,,,,2,1,2,3
C(C(C)=CC=CC(CO)=O)(O)=O,,,5,1,1,0,1
38238_0,,,,2,1,2,3
C(C(CO)O)=CC(CO)=O,,,5,1,1,0,1
38239_0,,,,2,1,2,3
38241_0,,,,2,1,2,3
C(CO)(CC1C(OC(C=1)C)=O)=O,,,5,1,1,0,1
38243_0,,,,2,1,2,3
C1(C(CC(C)O1)=CC(CO)=O)=O,,,5,1,1,0,1
38245_0,,,,2,1,2,3
C(CO)(CC1C(OC(C=1)=O)=O)=O,,,5,1,1,0,1
38247_0,,,,2,1,2,3
C1(CC(C(O1)=O)=CC(CO)=O)=O,,,5,1,1,0,1
38249_0,,,,2,1,2,3
C(CO)(CC=CC[CH]C(O)=O)=O,,,5,1,1,0,1
38251_0,,,,2,1,2,3
C(CC[CH]C(O)=O)=CC(CO)=O,,,5,1,1,0,1
38253_0,,,,2,1,2,3
C(CCC=CCC(CO)=O)(O)=O,,,5,1,1,0,1
38255_0,,,,2,1,2,3
C(CCCC=CC(CO)=O)(O)=O,,,5,1,1,0,1
38256_0,,,,2,1,2,3
38258_0,,,,2,1,2,3
C(C(C)O)=CC(CO)=O,,,5,1,1,0,1
38259_0,,,,2,1,2,3
38260_0,,,,2,1,2,3
38261_0,,,,2,1,2,3
38262_0,,,,2,1,2,3
38263_0,,,,2,1,2,3
38264_0,,,,2,1,2,3
38265_0,,,,2,1,2,3
38266_0,,,,2,1,2,3
38267_0,,,,2,1,2,3
38268_0,,,,2,1,2,3
38269_0,,,,2,1,2,3
38270_0,,,,2,1,2,3
38271_0,,,,2,1,2,3
38272_0,,,,2,1,2,3
38273_0,,,,2,1,2,3
38274_0,,,,2,1,2,3
38275_0,,,,2,1,2,3
38276_0,,,,2,1,2,3
38277_0,,,,2,1,2,3
38279_0,,,,2,1,2,3
C(C(C(C(C(C)=O)O)=C)C)(O)=O,,,5,1,1,0,1
38281_0,,,,2,1,2,3
C(C)(C(C(C)=C(C(O)=O)C)O)=O,,,5,1,1,0,1
38283_0,,,,2,1,2,3
C(C)(C(C=CC=C)O)=O,,,5,1,1,0,1
38285_0,,,,2,1,2,3
C(C)(C(C(C(O)=O)=CC=C)O)=O,,,5,1,1,0,1
38287_0,,,,2,1,2,3
C(C)(C(C=CC(C(O)=O)=C)O)=O,,,5,1,1,0,1
38289_0,,,,2,1,2,3
C(C)(C(C1C(OC(C=1)C)=O)O)=O,,,5,1,1,0,1
38291_0,,,,2,1,2,3
C(C)(C(C1C(OC(C=1)=O)=O)O)=O,,,5,1,1,0,1
38293_0,,,,2,1,2,3
C(C)(C(C=CC[CH]C(O)=O)O)=O,,,5,1,1,0,1
38295_0,,,,2,1,2,3
C(CCC=CC(C(C)=O)O)(O)=O,,,5,1,1,0,1
38296_0,,,,2,1,2,3
38298_0,,,,2,1,2,3
C(C)(C(C=C)O)=O,,,5,1,2,0,2
38300_0,,,,2,1,2,3
C(C)(C(C=CC(C)O)O)=O,,,5,1,1,0,1
38301_0,,,,2,1,2,3
38302_0,,,,2,1,2,3
38304_0,,,,2,1,2,3
C(C)(C(C=CC(O)=O)O)=O,,,5,1,2,0,2
38305_0,,,,2,1,2,3
38306_0,,,,2,1,2,3
38307_0,,,,2,1,2,3
38308_0,,,,2,1,2,3
38309_0,,,,2,1,2,3
38310_0,,,,2,1,2,3
38311_0,,,,2,1,2,3
38312_0,,,,2,1,2,3
38313_0,,,,2,1,2,3
38314_0,,,,2,1,2,3
38316_0,,,,2,1,2,3
C(C(C=C(C=O)C=C)(C)O)(O)=O,,,5,1,1,0,1
38317_0,,,,2,1,2,3
38318_0,,,,2,1,2,3
38320_0,,,,2,1,2,3
C(C(C=CC=O)(C)O)(O)=O,,,5,1,3,0,3
38321_0,,,,2,1,2,3
38323_0,,,,2,1,2,3
C(C(C=CC(C=O)=O)(C)O)(O)=O,,,5,1,1,0,1
38324_0,,,,2,1,2,3
38326_0,,,,2,1,2,3
C(C(C(C(C=O)O)=C)CO)(O)=O,,,5,1,1,0,1
38328_0,,,,2,1,2,3
C(C(C(C)=C(C(O)=O)CO)O)=O,,,5,1,1,0,1
38329_0,,,,2,1,2,3
38331_0,,,,2,1,2,3
C(C(C(C)=CC=O)CO)(O)=O,,,5,1,1,0,1
38333_0,,,,2,1,2,3
C(C(C(CC=O)=C)CO)(O)=O,,,5,1,1,0,1
38335_0,,,,2,1,2,3
C(CC(C)=C(C(O)=O)CO)=O,,,5,1,2,0,2
38336_0,,,,2,1,2,3
38338_0,,,,2,1,2,3
C(C(C(C=CCO)=O)CO)(O)=O,,,5,1,1,0,1
38339_0,,,,2,1,2,3
38340_0,,,,2,1,2,3
38341_0,,,,2,1,2,3
38342_0,,,,2,1,2,3
38343_0,,,,2,1,2,3
38345_0,,,,2,1,2,3
C(C(C(C=C)=O)CO)(O)=O,,,5,1,1,0,1
38346_0,,,,2,1,2,3
38348_0,,,,2,1,2,3
C(C(C(C)=C(C=O)C=C)C)(O)=O,,,5,1,1,0,1
38350_0,,,,2,1,2,3
C(C(C=C)C(C(C(O)=O)C)=C)=O,,,5,1,1,0,1
38352_0,,,,2,1,2,3
C(C(C=C)C(C)=C(C(O)=O)C)=O,,,5,1,1,0,1
38354_0,,,,2,1,2,3
C(C(C(C(C=O)O)=C)C)(O)=O,,,5,1,1,0,1
38356_0,,,,2,1,2,3
C(C(C(C)=C(C(O)=O)C)O)=O,,,5,1,1,0,1
38358_0,,,,2,1,2,3
C(C(C(C)=CC=O)C)(O)=O,,,5,1,1,0,1
38360_0,,,,2,1,2,3
C(CC(C(C(O)=O)C)=C)=O,,,5,1,1,0,1
38362_0,,,,2,1,2,3
C(CC(C)=C(C(O)=O)C)=O,,,5,1,2,0,2
38364_0,,,,2,1,2,3
C(C(C(C)=CC(C=O)=O)C)(O)=O,,,5,1,1,0,1
38366_0,,,,2,1,2,3
C(C(C(CC(C=O)=O)=C)C)(O)=O,,,5,1,1,0,1
38368_0,,,,2,1,2,3
C(C)(CC(C=O)=O)=C(C(O)=O)C,,,5,1,1,0,1
38370_0,,,,2,1,2,3
C(C(C(C=CC=CC)=O)C)(O)=O,,,5,1,1,0,1
38372_0,,,,2,1,2,3
C(CC=CC=C)(C(C(O)=O)C)=O,,,5,1,1,0,1
38374_0,,,,2,1,2,3
C(C(C(C=CCC=C)=O)C)(O)=O,,,5,1,1,0,1
38376_0,,,,2,1,2,3
C(C(C(C=CCO)=O)C)(O)=O,,,5,1,1,0,1
38377_0,,,,2,1,2,3
38379_0,,,,2,1,2,3
C(C(C(C=CC(C)O)=O)C)(O)=O,,,5,1,1,0,1
38381_0,,,,2,1,2,3
C(C(C(C=CC(O)=O)=O)C)(O)=O,,,5,1,1,0,1
38382_0,,,,2,1,2,3
38383_0,,,,2,1,2,3
38385_0,,,,2,1,2,3
C(CC(C=O)=C)(C(C(O)=O)C)=O,,,5,1,1,0,1
38387_0,,,,2,1,2,3
C(C(C(C=C(C=O)C)=O)C)(O)=O,,,5,1,1,0,1
38389_0,,,,2,1,2,3
C(C(C(C=CC(C)=O)=O)C)(O)=O,,,5,1,1,0,1
38391_0,,,,2,1,2,3
C(C(C(C=C)=O)C)(O)=O,,,5,1,3,0,3
38393_0,,,,2,1,2,3
C=CC(C=O)=CC=CC,,,5,1,1,0,1
38395_0,,,,2,1,2,3
C=CC(C(C(O)=O)=O)=CC=CC,,,5,1,1,0,1
38397_0,,,,2,1,2,3
C=C(C(O)=O)C(C=O)=CC=CC,,,5,1,1,0,1
38399_0,,,,2,1,2,3
C(C)=CC=C1C(C(OC1C)=O)=O,,,5,1,1,0,1
38401_0,,,,2,1,2,3
C(C)=CC=C1C(OC(C1=O)=O)=O,,,5,1,1,0,1
38403_0,,,,2,1,2,3
C(C)=CC=C(C=O)C[CH]C(O)=O,,,5,1,1,0,1
38405_0,,,,2,1,2,3
C(CCC(C=O)=CC=CC)(O)=O,,,5,1,1,0,1
38407_0,,,,2,1,2,3
C(C)=CC=CC=O,,,5,1,2,0,2
38409_0,,,,2,1,2,3
C(C(C(C=O)=CC)O)=CC,,,5,1,2,0,2
38411_0,,,,2,1,2,3
C(C)=CC=C(C=O)C(C)O,,,5,1,2,0,2
38412_0,,,,2,1,2,3
38414_0,,,,2,1,2,3
C(C)=CC=C(C=O)C(O)=O,,,5,1,2,0,2
38416_0,,,,2,1,2,3
C(C)=CC=CC(C=O)=O,,,5,1,2,0,2
38418_0,,,,2,1,2,3
C(C)=CC=CC(C(O)=O)=O,,,5,1,2,0,2
38420_0,,,,2,1,2,3
C=CCC=C(C=O)C=C,,,5,1,1,0,1
38422_0,,,,2,1,2,3
C(C(C=C)C=CC=C)=O,,,5,1,1,0,1
38424_0,,,,2,1,2,3
C=CCC=C(C=C)C(C(O)=O)=O,,,5,1,1,0,1
38426_0,,,,2,1,2,3
C=CC(C=CC=C)C(C(O)=O)=O,,,5,1,1,0,1
38428_0,,,,2,1,2,3
C=CCC=C(C=O)C(C(O)=O)=C,,,5,1,1,0,1
38430_0,,,,2,1,2,3
C(C(C=CC=C)C(C(O)=O)=C)=O,,,5,1,1,0,1
38432_0,,,,2,1,2,3
C(C(C=CC=C)O)=O,,,5,1,1,0,1
38434_0,,,,2,1,2,3
C=CCC=C1C(C(OC1C)=O)=O,,,5,1,1,0,1
38436_0,,,,2,1,2,3
C=CC=CC1C(C(OC1C)=O)=O,,,5,1,1,0,1
38438_0,,,,2,1,2,3
C=CCC=C1C(OC(C1=O)=O)=O,,,5,1,1,0,1
38440_0,,,,2,1,2,3
C1(C(C=CC=C)C(C(O1)=O)=O)=O,,,5,1,1,0,1
38442_0,,,,2,1,2,3
C=CCC=C(C=O)C[CH]C(O)=O,,,5,1,1,0,1
38444_0,,,,2,1,2,3
C(C(C=CC=C)C[CH]C(O)=O)=O,,,5,1,1,0,1
38446_0,,,,2,1,2,3
C(CCC(C=O)=CCC=C)(O)=O,,,5,1,1,0,1
38448_0,,,,2,1,2,3
C(C(C=CC=C)CCC(O)=O)=O,,,5,1,1,0,1
38450_0,,,,2,1,2,3
C=CCC=CC=O,,,5,1,2,0,2
38452_0,,,,2,1,2,3
C(CC=CC=C)=O,,,5,1,2,0,2
38454_0,,,,2,1,2,3
C=CCC(C(C=O)=CC)O,,,5,1,2,0,2
38456_0,,,,2,1,2,3
C=CCC=C(C=O)C(C)O,,,5,1,2,0,2
38457_0,,,,2,1,2,3
38459_0,,,,2,1,2,3
C(C(C=CC=C)C(C)O)=O,,,5,1,2,0,2
38461_0,,,,2,1,2,3
C=CCC=C(C=O)C(O)=O,,,5,1,2,0,2
38463_0,,,,2,1,2,3
C(C(C(O)=O)C=CC=C)=O,,,5,1,2,0,2
38465_0,,,,2,1,2,3
C=CC=CC(C(C=O)=O)O,,,5,1,2,0,2
38467_0,,,,2,1,2,3
C=CCC=CC(C=O)=O,,,5,1,2,0,2
38469_0,,,,2,1,2,3
C=CC=CCC(C=O)=O,,,5,1,2,0,2
38471_0,,,,2,1,2,3
C=CC=CC(C(C(O)=O)=O)O,,,5,1,2,0,2
38473_0,,,,2,1,2,3
C=CCC=CC(C(O)=O)=O,,,5,1,2,0,2
38475_0,,,,2,1,2,3
C=CC=CCC(C(O)=O)=O,,,5,1,2,0,2
38477_0,,,,2,1,2,3
C=CC(C=O)=C(C(O)=O)C=CC,,,5,1,1,0,1
38479_0,,,,2,1,2,3
C(C(C=C)C(C(O)=O)=CC=C)=O,,,5,1,1,0,1
38481_0,,,,2,1,2,3
C=CCC(C(O)=O)=C(C=O)C=C,,,5,1,1,0,1
38483_0,,,,2,1,2,3
C(C(C=C)C=CC(C(O)=O)=C)=O,,,5,1,1,0,1
38485_0,,,,2,1,2,3
C=C(C(O)=O)CC=C(C=O)C=C,,,5,1,1,0,1
38487_0,,,,2,1,2,3
C=CC(C=O)=CC=C(C(O)=O)C,,,5,1,1,0,1
38489_0,,,,2,1,2,3
C(C(CO)O)=C(C=O)C=C,,,5,1,1,0,1
38491_0,,,,2,1,2,3
C=CC(C=O)=CCO,,,5,1,1,0,1
38493_0,,,,2,1,2,3
C(C(C=C)C1C(OC(C=1)C)=O)=O,,,5,1,1,0,1
38495_0,,,,2,1,2,3
C=CC(C=O)=C1C(OC(C)C1)=O,,,5,1,1,0,1
38497_0,,,,2,1,2,3
C(C(C=C)C1C(OC(C=1)=O)=O)=O,,,5,1,1,0,1
38499_0,,,,2,1,2,3
C1(CC(C(O1)=O)=C(C=O)C=C)=O,,,5,1,1,0,1
38501_0,,,,2,1,2,3
C(C(C=C)C=CC[CH]C(O)=O)=O,,,5,1,1,0,1
38503_0,,,,2,1,2,3
C=CC(C=O)=CCC[CH]C(O)=O,,,5,1,1,0,1
38505_0,,,,2,1,2,3
C(C(C=C)C=CCCC(O)=O)=O,,,5,1,1,0,1
38507_0,,,,2,1,2,3
C(CCCC=C(C=O)C=C)(O)=O,,,5,1,1,0,1
38508_0,,,,2,1,2,3
38510_0,,,,2,1,2,3
C(C(C)O)=C(C=O)C=C,,,5,1,1,0,1
38512_0,,,,2,1,2,3
C=CC(C=O)=CC(O)=O,,,5,1,1,0,1
38514_0,,,,2,1,2,3
C(C(C=C)C=C)=O,,,5,1,1,0,1
38516_0,,,,2,1,2,3
C=CC(C=O)=CC,,,5,1,4,0,4
38518_0,,,,2,1,2,3
C(C(C=C)C=CC(C)O)=O,,,5,1,2,0,2
38519_0,,,,2,1,2,3
38520_0,,,,2,1,2,3
38522_0,,,,2,1,2,3
C(CC(C)O)=C(C=O)C=C,,,5,1,2,0,2
38524_0,,,,2,1,2,3
C(C(C=C)C=CC(O)=O)=O,,,5,1,2,0,2
38526_0,,,,2,1,2,3
C(CC=C(C=O)C=C)(O)=O,,,5,1,2,0,2
38528_0,,,,2,1,2,3
C=CC(C=O)=CC(CO)=O,,,5,1,2,0,2
38530_0,,,,2,1,2,3
C=CC(C=O)=C(C=O)CO,,,5,1,2,0,2
38532_0,,,,2,1,2,3
C(C(C=C)C(C=O)=C)=O,,,5,1,2,0,2
38534_0,,,,2,1,2,3
C=CC(C=O)=C(C=O)C,,,5,1,2,0,2
38536_0,,,,2,1,2,3
C=CC(C=O)=CC(C)=O,,,5,1,2,0,2
38538_0,,,,2,1,2,3
C=C(C=O)C=C,,,5,1,7,0,7
38540_0,,,,2,1,2,3
C=CC(C=O)=C(C(O)=O)CO,,,5,1,2,0,2
38542_0,,,,2,1,2,3
C(C(C=C)C(C(O)=O)=C)=O,,,5,1,2,0,2
38544_0,,,,2,1,2,3
C=CC(C=O)=C(C(O)=O)C,,,5,1,3,0,3
38546_0,,,,2,1,2,3
C(C)=CC(C(O)=O)=CC=O,,,5,1,2,0,2
38548_0,,,,2,1,2,3
C(C)=CC(C(O)=O)=CC(C=O)=O,,,5,1,1,0,1
38550_0,,,,2,1,2,3
C(C(C(C(O)=O)=CC=C)O)=O,,,5,1,1,0,1
38552_0,,,,2,1,2,3
C=CCC(C(O)=O)=CC=O,,,5,1,2,0,2
38554_0,,,,2,1,2,3
C(CC(C(O)=O)=CC=C)=O,,,5,1,2,0,2
38556_0,,,,2,1,2,3
C=CCC(C(O)=O)=CC(C=O)=O,,,5,1,1,0,1
38558_0,,,,2,1,2,3
C=CC=C(C(O)=O)CC(C=O)=O,,,5,1,1,0,1
38560_0,,,,2,1,2,3
C=CC(C(C(O)=O)=O)=CCO,,,5,1,1,0,1
38561_0,,,,2,1,2,3
38563_0,,,,2,1,2,3
C(C(C)O)=C(C=C)C(C(O)=O)=O,,,5,1,1,0,1
38565_0,,,,2,1,2,3
C=CC(C(C(O)=O)=O)=CC(O)=O,,,5,1,1,0,1
38567_0,,,,2,1,2,3
C=CC(C=C)C(C(O)=O)=O,,,5,1,1,0,1
38569_0,,,,2,1,2,3
C=CC(C(C(O)=O)=O)=CC,,,5,1,3,0,3
38571_0,,,,2,1,2,3
C=CC(C(C(O)=O)=O)C(C=O)=C,,,5,1,1,0,1
38573_0,,,,2,1,2,3
C=CC(C(C(O)=O)=O)=C(C=O)C,,,5,1,1,0,1
38575_0,,,,2,1,2,3
C=CC(C(C(O)=O)=O)=CC(C)=O,,,5,1,1,0,1
38577_0,,,,2,1,2,3
C=C(C=C)C(C(O)=O)=O,,,5,1,4,0,4
38579_0,,,,2,1,2,3
C(C(C=CC(C(O)=O)=C)O)=O,,,5,1,1,0,1
38581_0,,,,2,1,2,3
C=C(C(O)=O)CC=CC=O,,,5,1,2,0,2
38583_0,,,,2,1,2,3
C(CC=CC(C(O)=O)=C)=O,,,5,1,2,0,2
38585_0,,,,2,1,2,3
C=C(C(O)=O)CC=CC(C=O)=O,,,5,1,1,0,1
38587_0,,,,2,1,2,3
C=C(C(O)=O)C=CCC(C=O)=O,,,5,1,1,0,1
38589_0,,,,2,1,2,3
C=C(C(O)=O)C(C=O)=CCO,,,5,1,1,0,1
38590_0,,,,2,1,2,3
38592_0,,,,2,1,2,3
C=C(C(O)=O)C(C=O)=CC(C)O,,,5,1,1,0,1
38594_0,,,,2,1,2,3
C=C(C(O)=O)C(C=O)=CC(O)=O,,,5,1,1,0,1
38595_0,,,,2,1,2,3
38597_0,,,,2,1,2,3
C=C(C(O)=O)C(C=O)=CC,,,5,1,3,0,3
38599_0,,,,2,1,2,3
C(C(C(C(O)=O)=C)C(C=O)=C)=O,,,5,1,1,0,1
38601_0,,,,2,1,2,3
C=C(C(O)=O)C(C=O)=C(C=O)C,,,5,1,1,0,1
38603_0,,,,2,1,2,3
C=C(C(O)=O)C(C=O)=CC(C)=O,,,5,1,1,0,1
38605_0,,,,2,1,2,3
C=C(C=O)C(C(O)=O)=C,,,5,1,6,0,6
38607_0,,,,2,1,2,3
C(C=CC=C(C(O)=O)C)=O,,,5,1,2,0,2
38609_0,,,,2,1,2,3
C(C(C=CC=C(C(O)=O)C)=O)=O,,,5,1,1,0,1
38611_0,,,,2,1,2,3
C(C=C1C(OC(C(C)=C1)=O)=O)=O,,,5,1,1,0,1
38613_0,,,,2,1,2,3
C=C1C(OC(C(C1)=CC=O)=O)=O,,,5,1,1,0,1
38615_0,,,,2,1,2,3
C(CC1C(OC(C(C=1)=C)=O)=O)=O,,,5,1,1,0,1
38617_0,,,,2,1,2,3
C=CC1C(C(OC(C1=C)=O)=O)=O,,,5,1,1,0,1
38619_0,,,,2,1,2,3
C=C1C(OC(C(C1=CC)=O)=O)=O,,,5,1,1,0,1
38621_0,,,,2,1,2,3
C=C1C(OC(C(C1=C)=O)=O)=O,,,5,1,3,0,3
38623_0,,,,2,1,2,3
C(C(CO)O)=CC=O,,,5,1,3,0,3
38625_0,,,,2,1,2,3
C(C)=C(C=O)C(C(CO)O)O,,,5,1,2,0,2
38627_0,,,,2,1,2,3
C(C(CO)O)=C(C=O)C(C)O,,,5,1,2,0,2
38628_0,,,,2,1,2,3
38630_0,,,,2,1,2,3
C(C(CO)O)=C(C(O)=O)C=O,,,5,1,2,0,2
38632_0,,,,2,1,2,3
C(C(CO)O)=CC(C=O)=O,,,5,1,2,0,2
38634_0,,,,2,1,2,3
C(C(CO)O)=CC(C(O)=O)=O,,,5,1,3,0,3
38636_0,,,,2,1,2,3
C(C)(C1(C(C(C(O1)=O)=O)=C)O)=O,,,5,1,2,0,2
38638_0,,,,2,1,2,3
C1(C(C(CO)=C(C(C)=O)O1)=O)=O,,,5,1,1,0,1
38639_0,,,,2,1,2,3
38641_0,,,,2,1,2,3
C=CC(C1(CC(C(O1)=O)=O)O)=O,,,5,1,2,0,2
38643_0,,,,2,1,2,3
C=C1C(C(C)(O)OC(C1=O)=O)=O,,,5,1,2,0,2
38644_0,,,,2,1,2,3
38646_0,,,,2,1,2,3
C(CO)=C1C(C(OC1C)=O)=O,,,5,1,1,0,1
38648_0,,,,2,1,2,3
C(CO)=C1C(OC(C1=O)=O)=O,,,5,1,1,0,1
38650_0,,,,2,1,2,3
C(CO)=C(C=O)C[CH]C(O)=O,,,5,1,1,0,1
38652_0,,,,2,1,2,3
C(CCC(C=O)=CCO)(O)=O,,,5,1,1,0,1
38654_0,,,,2,1,2,3
C(CO)=CC=O,,,5,1,3,0,3
38656_0,,,,2,1,2,3
C(C)=C(C=O)C(CO)O,,,5,1,2,0,2
38658_0,,,,2,1,2,3
C(CO)=C(C=O)C(C)O,,,5,1,1,0,1
38659_0,,,,2,1,2,3
38661_0,,,,2,1,2,3
C(C)=C(C(C(O)=O)=O)C(CO)O,,,5,1,1,0,1
38663_0,,,,2,1,2,3
C(CO)=C(C(C(O)=O)=O)C(C)O,,,5,1,1,0,1
38664_0,,,,2,1,2,3
38666_0,,,,2,1,2,3
C(CO)=C(C(O)=O)C=O,,,5,1,1,0,1
38667_0,,,,2,1,2,3
38669_0,,,,2,1,2,3
C(C(C)=C(C=O)C(CO)O)(O)=O,,,5,1,1,0,1
38671_0,,,,2,1,2,3
C(C(C(C=O)=CCO)(C)O)(O)=O,,,5,1,2,0,2
38673_0,,,,2,1,2,3
C(CO)=C(C(O)=O)C(C(O)=O)=O,,,5,1,1,0,1
38675_0,,,,2,1,2,3
C(CO)=CC(C=O)=O,,,5,1,1,0,1
38677_0,,,,2,1,2,3
C(CO)=CC(C(O)=O)=O,,,5,1,2,0,2
38679_0,,,,2,1,2,3
C(C(C1C(OC(C=1)C)=O)O)=O,,,5,1,1,0,1
38681_0,,,,2,1,2,3
C(C(C1C(OC(C=1)=O)=O)O)=O,,,5,1,1,0,1
38683_0,,,,2,1,2,3
C(C(C=CC[CH]C(O)=O)O)=O,,,5,1,1,0,1
38685_0,,,,2,1,2,3
C(C(C=CCCC(O)=O)O)=O,,,5,1,1,0,1
38686_0,,,,2,1,2,3
38688_0,,,,2,1,2,3
C(C(C=C)O)=O,,,5,1,4,0,4
38690_0,,,,2,1,2,3
C(C(C=CC(C)O)O)=O,,,5,1,2,0,2
38691_0,,,,2,1,2,3
38692_0,,,,2,1,2,3
38694_0,,,,2,1,2,3
C(C(C(C(O)=O)=CC(C)O)O)=O,,,5,1,1,0,1
38695_0,,,,2,1,2,3
38696_0,,,,2,1,2,3
38698_0,,,,2,1,2,3
C(C(C=CC(O)=O)O)=O,,,5,1,2,0,2
38699_0,,,,2,1,2,3
38700_0,,,,2,1,2,3
38702_0,,,,2,1,2,3
C(C(C=CC(C=O)O)(C)O)(O)=O,,,5,1,1,0,1
38704_0,,,,2,1,2,3
C(C(C(C(O)=O)=CC(O)=O)O)=O,,,5,1,2,0,2
38705_0,,,,2,1,2,3
38706_0,,,,2,1,2,3
38708_0,,,,2,1,2,3
C(C=C1C(OC(C)C1)=O)=O,,,5,1,2,0,2
38710_0,,,,2,1,2,3
C(CC1C(OC(C=1)C)=O)=O,,,5,1,1,0,1
38712_0,,,,2,1,2,3
C(C(C=C1C(OC(C)C1)=O)=O)=O,,,5,1,1,0,1
38714_0,,,,2,1,2,3
C1C(C)OC(C=1CC(C=O)=O)=O,,,5,1,1,0,1
38715_0,,,,2,1,2,3
38717_0,,,,2,1,2,3
C(C(C)O)=C1C(C(OC1C)=O)=O,,,5,1,1,0,1
38719_0,,,,2,1,2,3
C(C=C1C(C(OC1C)=O)=O)(O)=O,,,5,1,1,0,1
38721_0,,,,2,1,2,3
C=CC1C(C(OC1C)=O)=O,,,5,1,2,0,2
38723_0,,,,2,1,2,3
C(C)=C1C(C(OC1C)=O)=O,,,5,1,3,0,3
38725_0,,,,2,1,2,3
C=C(C=O)C1C(C(OC1C)=O)=O,,,5,1,1,0,1
38727_0,,,,2,1,2,3
C(C(C)=C1C(C(OC1C)=O)=O)=O,,,5,1,1,0,1
38729_0,,,,2,1,2,3
C(C=C1C(C(OC1C)=O)=O)(C)=O,,,5,1,1,0,1
38731_0,,,,2,1,2,3
C=C1C(C(OC1C)=O)=O,,,5,1,5,0,5
38733_0,,,,2,1,2,3
C1(CC(C(O1)=O)=CC=O)=O,,,5,1,2,0,2
38735_0,,,,2,1,2,3
C(CC1C(OC(C=1)=O)=O)=O,,,5,1,1,0,1
38737_0,,,,2,1,2,3
C1(CC(C(O1)=O)=CC(C=O)=O)=O,,,5,1,1,0,1
38739_0,,,,2,1,2,3
C(C(CC1C(OC(C=1)=O)=O)=O)=O,,,5,1,1,0,1
38740_0,,,,2,1,2,3
38742_0,,,,2,1,2,3
C(C(C)O)=C1C(OC(C1=O)=O)=O,,,5,1,1,0,1
38744_0,,,,2,1,2,3
C1(C(C(C(O1)=O)=O)=CC(O)=O)=O,,,5,1,1,0,1
38746_0,,,,2,1,2,3
C1(C(C=C)C(C(O1)=O)=O)=O,,,5,1,2,0,2
38748_0,,,,2,1,2,3
C(C)=C1C(OC(C1=O)=O)=O,,,5,1,3,0,3
38750_0,,,,2,1,2,3
C1(C(C(C(O1)=O)=O)C(C=O)=C)=O,,,5,1,1,0,1
38752_0,,,,2,1,2,3
C(C(C)=C1C(OC(C1=O)=O)=O)=O,,,5,1,1,0,1
38754_0,,,,2,1,2,3
C1(C(C(C(O1)=O)=O)=CC(C)=O)=O,,,5,1,1,0,1
38756_0,,,,2,1,2,3
C=C1C(OC(C1=O)=O)=O,,,5,1,4,0,4
38757_0,,,,2,1,2,3
38759_0,,,,2,1,2,3
C=C(C=O)C(C)(C[CH]C(O)=O)O,,,5,1,2,0,2
38761_0,,,,2,1,2,3
C(C)(C[CH]C(O)=O)=C(C=O)CO,,,5,1,1,0,1
38762_0,,,,2,1,2,3
38763_0,,,,2,1,2,3
38765_0,,,,2,1,2,3
C(CCC(C(C=O)=C)(C)O)(O)=O,,,5,1,2,0,2
38767_0,,,,2,1,2,3
C(CCC(C)=C(C=O)CO)(O)=O,,,5,1,1,0,1
38768_0,,,,2,1,2,3
38770_0,,,,2,1,2,3
C(C(CC[CH]C(O)=O)=CC=O)=O,,,5,1,2,0,2
38772_0,,,,2,1,2,3
C(CC(C=O)=CC[CH]C(O)=O)=O,,,5,1,1,0,1
38774_0,,,,2,1,2,3
C(C=CC(CC[CH]C(O)=O)=O)=O,,,5,1,2,0,2
38776_0,,,,2,1,2,3
C=CC(C(C=O)=O)C[CH]C(O)=O,,,5,1,2,0,2
38778_0,,,,2,1,2,3
C(C)=C(C(C=O)=O)C[CH]C(O)=O,,,5,1,1,0,1
38780_0,,,,2,1,2,3
C=C(C(C=O)=O)C[CH]C(O)=O,,,5,1,1,0,1
38782_0,,,,2,1,2,3
C(CCCC(C=O)=CC=O)(O)=O,,,5,1,2,0,2
38784_0,,,,2,1,2,3
C(CC(C=O)=CCCC(O)=O)=O,,,5,1,1,0,1
38786_0,,,,2,1,2,3
C(CCCC(C=CC=O)=O)(O)=O,,,5,1,2,0,2
38788_0,,,,2,1,2,3
C(CCC(C=C)C(C=O)=O)(O)=O,,,5,1,2,0,2
38790_0,,,,2,1,2,3
C(CCC(C(C=O)=O)=CC)(O)=O,,,5,1,1,0,1
38792_0,,,,2,1,2,3
C(CCC(C(C=O)=O)=C)(O)=O,,,5,1,1,0,1
38794_0,,,,2,1,2,3
C(CC[CH]C(O)=O)=CC(C=O)=O,,,5,1,2,0,2
38796_0,,,,2,1,2,3
C(CC(C=O)=O)=CC[CH]C(O)=O,,,5,1,1,0,1
38797_0,,,,2,1,2,3
38799_0,,,,2,1,2,3
C(C(C)O)=C(C=O)C[CH]C(O)=O,,,5,1,1,0,1
38801_0,,,,2,1,2,3
C(C(C[CH]C(O)=O)=CC(O)=O)=O,,,5,1,1,0,1
38803_0,,,,2,1,2,3
C(C(C(C=O)=C)C[CH]C(O)=O)=O,,,5,1,2,0,2
38805_0,,,,2,1,2,3
[CH](C(O)=O)CC(C=O)=C(C=O)C,,,5,1,1,0,1
38807_0,,,,2,1,2,3
[CH](C(O)=O)CC(C=O)=CC(C)=O,,,5,1,1,0,1
38809_0,,,,2,1,2,3
C=C(C=O)C[CH]C(O)=O,,,5,1,4,0,4
38811_0,,,,2,1,2,3
C=C(C(C(O)=O)=O)C[CH]C(O)=O,,,5,1,1,0,1
38813_0,,,,2,1,2,3
C(CCCC=CC(C=O)=O)(O)=O,,,5,1,2,0,2
38815_0,,,,2,1,2,3
C(CCC=CCC(C=O)=O)(O)=O,,,5,1,1,0,1
38816_0,,,,2,1,2,3
38818_0,,,,2,1,2,3
C(CCC(C=O)=CC(C)O)(O)=O,,,5,1,1,0,1
38820_0,,,,2,1,2,3
C(CCC(C=O)=CC(O)=O)(O)=O,,,5,1,1,0,1
38822_0,,,,2,1,2,3
C(C(C(C=O)=C)CCC(O)=O)=O,,,5,1,2,0,2
38824_0,,,,2,1,2,3
C(CCC(C=O)=C(C=O)C)(O)=O,,,5,1,1,0,1
38826_0,,,,2,1,2,3
C(CCC(C=O)=CC(C)=O)(O)=O,,,5,1,1,0,1
38828_0,,,,2,1,2,3
C(CCC(C=O)=C)(O)=O,,,5,1,4,0,4
38830_0,,,,2,1,2,3
C(CCC(C(C(O)=O)=O)=C)(O)=O,,,5,1,1,0,1
38831_0,,,,2,1,2,3
38832_0,,,,2,1,2,3
38834_0,,,,2,1,2,3
C(C)=C(C=O)C(C(C)O)O,,,5,1,1,0,1
38836_0,,,,2,1,2,3
C(C(C)O)=C(C=O)C(C)O,,,5,1,1,0,1
38837_0,,,,2,1,2,3
38838_0,,,,2,1,2,3
38840_0,,,,2,1,2,3
C(C(C)O)=C(C(O)=O)C=O,,,5,1,1,0,1
38841_0,,,,2,1,2,3
38842_0,,,,2,1,2,3
38843_0,,,,2,1,2,3
38844_0,,,,2,1,2,3
38845_0,,,,2,1,2,3
38847_0,,,,2,1,2,3
C(C(C)O)=CC(C(O)=O)=O,,,5,1,4,0,4
38848_0,,,,2,1,2,3
38849_0,,,,2,1,2,3
38850_0,,,,2,1,2,3
38852_0,,,,2,1,2,3
C(C=C(C=O)C(C)O)(O)=O,,,5,1,2,0,2
38853_0,,,,2,1,2,3
38855_0,,,,2,1,2,3
C(C(C(O)=O)=CC(O)=O)=O,,,5,1,1,0,1
38856_0,,,,2,1,2,3
38857_0,,,,2,1,2,3
38858_0,,,,2,1,2,3
38859_0,,,,2,1,2,3
38860_0,,,,2,1,2,3
38862_0,,,,2,1,2,3
C(C(CC(C)O)O)=CC(O)=O,,,5,1,1,0,1
38863_0,,,,2,1,2,3
38864_0,,,,2,1,2,3
38865_0,,,,2,1,2,3
38866_0,,,,2,1,2,3
38867_0,,,,2,1,2,3
38869_0,,,,2,1,2,3
C(CC(C=CC(O)=O)O)(O)=O,,,5,1,1,0,1
38870_0,,,,2,1,2,3
38871_0,,,,2,1,2,3
38872_0,,,,2,1,2,3
38873_0,,,,2,1,2,3
38875_0,,,,2,1,2,3
C(C(C=CC(O)=O)(CO)O)=O,,,5,1,2,0,2
38876_0,,,,2,1,2,3
38877_0,,,,2,1,2,3
38879_0,,,,2,1,2,3
C(C(C=CC(O)=O)(C)O)=O,,,5,1,2,0,2
38880_0,,,,2,1,2,3
38881_0,,,,2,1,2,3
38882_0,,,,2,1,2,3
38883_0,,,,2,1,2,3
38884_0,,,,2,1,2,3
38886_0,,,,2,1,2,3
C(CO)=CC(O)=O,,,5,1,3,0,3
38887_0,,,,2,1,2,3
38888_0,,,,2,1,2,3
38889_0,,,,2,1,2,3
38890_0,,,,2,1,2,3
38891_0,,,,2,1,2,3
38892_0,,,,2,1,2,3
38893_0,,,,2,1,2,3
38894_0,,,,2,1,2,3
38895_0,,,,2,1,2,3
38896_0,,,,2,1,2,3
38897_0,,,,2,1,2,3
38898_0,,,,2,1,2,3
38899_0,,,,2,1,2,3
38900_0,,,,2,1,2,3
38901_0,,,,2,1,2,3
38902_0,,,,2,1,2,3
38903_0,,,,2,1,2,3
38904_0,,,,2,1,2,3
38905_0,,,,2,1,2,3
38906_0,,,,2,1,2,3
38907_0,,,,2,1,2,3
38908_0,,,,2,1,2,3
38909_0,,,,2,1,2,3
38910_0,,,,2,1,2,3
38911_0,,,,2,1,2,3
38912_0,,,,2,1,2,3
38913_0,,,,2,1,2,3
38914_0,,,,2,1,2,3
38915_0,,,,2,1,2,3
38916_0,,,,2,1,2,3
38917_0,,,,2,1,2,3
38918_0,,,,2,1,2,3
38919_0,,,,2,1,2,3
38920_0,,,,2,1,2,3
38921_0,,,,2,1,2,3
38922_0,,,,2,1,2,3
38923_0,,,,2,1,2,3
38924_0,,,,2,1,2,3
38925_0,,,,2,1,2,3
38927_0,,,,2,1,2,3
C(C(C(C=C)=O)C(C)O)=O,,,5,1,1,0,1
38928_0,,,,2,1,2,3
38929_0,,,,2,1,2,3
38930_0,,,,2,1,2,3
38931_0,,,,2,1,2,3
38933_0,,,,2,1,2,3
C(C(C(O)=O)C(C=C)=O)=O,,,5,1,1,0,1
38934_0,,,,2,1,2,3
38936_0,,,,2,1,2,3
C=CC(C(C(C=O)=O)O)=O,,,5,1,1,0,1
38937_0,,,,2,1,2,3
38938_0,,,,2,1,2,3
38939_0,,,,2,1,2,3
38941_0,,,,2,1,2,3
C=CC(CC(C=O)=O)=O,,,5,1,1,0,1
38943_0,,,,2,1,2,3
C=CC(C(C(C(O)=O)=O)O)=O,,,5,1,1,0,1
38945_0,,,,2,1,2,3
C(CC(C=C)=O)=O,,,5,1,1,0,1
38947_0,,,,2,1,2,3
C=CC(CC(C(O)=O)=O)=O,,,5,1,1,0,1
38948_0,,,,2,1,2,3
38949_0,,,,2,1,2,3
38951_0,,,,2,1,2,3
C(C(C(C=C)=O)(CO)O)(O)=O,,,5,1,1,0,1
38952_0,,,,2,1,2,3
38953_0,,,,2,1,2,3
38955_0,,,,2,1,2,3
C(C(C(C=C)=O)(C)O)(O)=O,,,5,1,1,0,1
38957_0,,,,2,1,2,3
C=C(C(CC(C)O)O)C(C)O,,,5,1,1,0,1
38958_0,,,,2,1,2,3
38959_0,,,,2,1,2,3
38960_0,,,,2,1,2,3
38961_0,,,,2,1,2,3
38962_0,,,,2,1,2,3
38963_0,,,,2,1,2,3
38964_0,,,,2,1,2,3
38965_0,,,,2,1,2,3
38966_0,,,,2,1,2,3
38967_0,,,,2,1,2,3
38968_0,,,,2,1,2,3
38970_0,,,,2,1,2,3
C=CC(CC(C)O)O,,,5,1,1,0,1
38971_0,,,,2,1,2,3
38972_0,,,,2,1,2,3
38973_0,,,,2,1,2,3
38974_0,,,,2,1,2,3
38975_0,,,,2,1,2,3
38976_0,,,,2,1,2,3
38978_0,,,,2,1,2,3
C(CC(C(C(C)O)=C)O)(O)=O,,,5,1,1,0,1
38979_0,,,,2,1,2,3
38980_0,,,,2,1,2,3
38981_0,,,,2,1,2,3
38983_0,,,,2,1,2,3
C(CO)(C(C(C(C)O)=C)O)=O,,,5,1,1,0,1
38984_0,,,,2,1,2,3
38985_0,,,,2,1,2,3
38986_0,,,,2,1,2,3
38988_0,,,,2,1,2,3
C(C(C(C(C)O)=C)(CO)O)=O,,,5,1,1,0,1
38989_0,,,,2,1,2,3
38990_0,,,,2,1,2,3
38991_0,,,,2,1,2,3
38992_0,,,,2,1,2,3
38994_0,,,,2,1,2,3
C(C(C(C(C)O)=C)(C)O)=O,,,5,1,1,0,1
38995_0,,,,2,1,2,3
38996_0,,,,2,1,2,3
38997_0,,,,2,1,2,3
38999_0,,,,2,1,2,3
C(C)(C(C(C(C)O)=C)O)=O,,,5,1,1,0,1
39000_0,,,,2,1,2,3
39001_0,,,,2,1,2,3
39002_0,,,,2,1,2,3
39003_0,,,,2,1,2,3
39004_0,,,,2,1,2,3
39005_0,,,,2,1,2,3
39007_0,,,,2,1,2,3
C(C(C(C(C)O)=C)(CO)O)(O)=O,,,5,1,1,0,1
39008_0,,,,2,1,2,3
39009_0,,,,2,1,2,3
39010_0,,,,2,1,2,3
39011_0,,,,2,1,2,3
39013_0,,,,2,1,2,3
C=C(C(C)O)C(C)O,,,5,1,1,0,1
39014_0,,,,2,1,2,3
39015_0,,,,2,1,2,3
39016_0,,,,2,1,2,3
39017_0,,,,2,1,2,3
39018_0,,,,2,1,2,3
39020_0,,,,2,1,2,3
C(C(C(C(C)O)=C)(C)O)(O)=O,,,5,1,1,0,1
39021_0,,,,2,1,2,3
39022_0,,,,2,1,2,3
39024_0,,,,2,1,2,3
C(C(C=C)(CC(C)O)O)(O)=O,,,5,1,2,0,2
39025_0,,,,2,1,2,3
39026_0,,,,2,1,2,3
39027_0,,,,2,1,2,3
39028_0,,,,2,1,2,3
39029_0,,,,2,1,2,3
39030_0,,,,2,1,2,3
39031_0,,,,2,1,2,3
39033_0,,,,2,1,2,3
C(CC(C=C)O)(O)=O,,,5,1,1,0,1
39034_0,,,,2,1,2,3
39035_0,,,,2,1,2,3
39036_0,,,,2,1,2,3
39037_0,,,,2,1,2,3
39038_0,,,,2,1,2,3
39039_0,,,,2,1,2,3
39040_0,,,,2,1,2,3
39041_0,,,,2,1,2,3
39042_0,,,,2,1,2,3
39043_0,,,,2,1,2,3
39044_0,,,,2,1,2,3
39045_0,,,,2,1,2,3
39046_0,,,,2,1,2,3
39047_0,,,,2,1,2,3
39048_0,,,,2,1,2,3
39049_0,,,,2,1,2,3
39050_0,,,,2,1,2,3
39051_0,,,,2,1,2,3
39053_0,,,,2,1,2,3
C(C(C)(CC(C=C)O)O)(O)=O,,,5,1,1,0,1
39054_0,,,,2,1,2,3
39055_0,,,,2,1,2,3
39056_0,,,,2,1,2,3
39057_0,,,,2,1,2,3
39058_0,,,,2,1,2,3
39059_0,,,,2,1,2,3
39060_0,,,,2,1,2,3
39062_0,,,,2,1,2,3
C(C(C=C)(CC(O)=O)O)(O)=O,,,5,1,2,0,2
39063_0,,,,2,1,2,3
39064_0,,,,2,1,2,3
39065_0,,,,2,1,2,3
39066_0,,,,2,1,2,3
39068_0,,,,2,1,2,3
C(C(C=C)(CO)O)=O,,,5,1,2,0,2
39069_0,,,,2,1,2,3
39071_0,,,,2,1,2,3
C(C(C=C)(C)O)=O,,,5,1,2,0,2
39072_0,,,,2,1,2,3
39073_0,,,,2,1,2,3
39074_0,,,,2,1,2,3
39075_0,,,,2,1,2,3
39076_0,,,,2,1,2,3
39077_0,,,,2,1,2,3
39078_0,,,,2,1,2,3
39079_0,,,,2,1,2,3
39080_0,,,,2,1,2,3
39081_0,,,,2,1,2,3
39082_0,,,,2,1,2,3
39083_0,,,,2,1,2,3
39085_0,,,,2,1,2,3
C=CC=C,,,5,1,2,0,2
39086_0,,,,2,1,2,3
39088_0,,,,2,1,2,3
C=C(C(C)O)C[CH]C(O)=O,,,5,1,1,0,1
39089_0,,,,2,1,2,3
39090_0,,,,2,1,2,3
39092_0,,,,2,1,2,3
C(CCC(C(C)O)=C)(O)=O,,,5,1,1,0,1
39093_0,,,,2,1,2,3
39094_0,,,,2,1,2,3
39096_0,,,,2,1,2,3
C=CC(CC[CH]C(O)=O)O,,,5,1,3,0,3
39097_0,,,,2,1,2,3
39098_0,,,,2,1,2,3
39100_0,,,,2,1,2,3
C(CCCC(C=C)O)(O)=O,,,5,1,3,0,3
39101_0,,,,2,1,2,3
39102_0,,,,2,1,2,3
39103_0,,,,2,1,2,3
39105_0,,,,2,1,2,3
C(C(C)(C[CH]C(O)=O)O)=C,,,5,1,2,0,2
39106_0,,,,2,1,2,3
39107_0,,,,2,1,2,3
39108_0,,,,2,1,2,3
39110_0,,,,2,1,2,3
C(CCC(C=C)(C)O)(O)=O,,,5,1,2,0,2
39111_0,,,,2,1,2,3
39112_0,,,,2,1,2,3
39113_0,,,,2,1,2,3
39114_0,,,,2,1,2,3
39115_0,,,,2,1,2,3
39116_0,,,,2,1,2,3
39118_0,,,,2,1,2,3
C=CC[CH]C(O)=O,,,5,1,3,0,3
39120_0,,,,2,1,2,3
C(CCC=C)(O)=O,,,5,1,3,0,3
39121_0,,,,2,1,2,3
39122_0,,,,2,1,2,3
39123_0,,,,2,1,2,3
39124_0,,,,2,1,2,3
39125_0,,,,2,1,2,3
39126_0,,,,2,1,2,3
39127_0,,,,2,1,2,3
39128_0,,,,2,1,2,3
39129_0,,,,2,1,2,3
39130_0,,,,2,1,2,3
39131_0,,,,2,1,2,3
39132_0,,,,2,1,2,3
39133_0,,,,2,1,2,3
39134_0,,,,2,1,2,3
39135_0,,,,2,1,2,3
39136_0,,,,2,1,2,3
39137_0,,,,2,1,2,3
39138_0,,,,2,1,2,3
39139_0,,,,2,1,2,3
39140_0,,,,2,1,2,3
39141_0,,,,2,1,2,3
39142_0,,,,2,1,2,3
39143_0,,,,2,1,2,3
39144_0,,,,2,1,2,3
39145_0,,,,2,1,2,3
39146_0,,,,2,1,2,3
39147_0,,,,2,1,2,3
39148_0,,,,2,1,2,3
39149_0,,,,2,1,2,3
39150_0,,,,2,1,2,3
39151_0,,,,2,1,2,3
39152_0,,,,2,1,2,3
39153_0,,,,2,1,2,3
39154_0,,,,2,1,2,3
39155_0,,,,2,1,2,3
39156_0,,,,2,1,2,3
39157_0,,,,2,1,2,3
39158_0,,,,2,1,2,3
39159_0,,,,2,1,2,3
39160_0,,,,2,1,2,3
39161_0,,,,2,1,2,3
39162_0,,,,2,1,2,3
39163_0,,,,2,1,2,3
39164_0,,,,2,1,2,3
39165_0,,,,2,1,2,3
39166_0,,,,2,1,2,3
39167_0,,,,2,1,2,3
39168_0,,,,2,1,2,3
39169_0,,,,2,1,2,3
39170_0,,,,2,1,2,3
39171_0,,,,2,1,2,3
39172_0,,,,2,1,2,3
39173_0,,,,2,1,2,3
39174_0,,,,2,1,2,3
39175_0,,,,2,1,2,3
39176_0,,,,2,1,2,3
39177_0,,,,2,1,2,3
39178_0,,,,2,1,2,3
39179_0,,,,2,1,2,3
39180_0,,,,2,1,2,3
39181_0,,,,2,1,2,3
39182_0,,,,2,1,2,3
39183_0,,,,2,1,2,3
39184_0,,,,2,1,2,3
39185_0,,,,2,1,2,3
39186_0,,,,2,1,2,3
39187_0,,,,2,1,2,3
39188_0,,,,2,1,2,3
39189_0,,,,2,1,2,3
39190_0,,,,2,1,2,3
39191_0,,,,2,1,2,3
39192_0,,,,2,1,2,3
39193_0,,,,2,1,2,3
39194_0,,,,2,1,2,3
39195_0,,,,2,1,2,3
39196_0,,,,2,1,2,3
39197_0,,,,2,1,2,3
39198_0,,,,2,1,2,3
39199_0,,,,2,1,2,3
39200_0,,,,2,1,2,3
39201_0,,,,2,1,2,3
39202_0,,,,2,1,2,3
39204_0,,,,2,1,2,3
C(C(C=CCO)(CO)C(C)O)=O,,,5,1,1,0,1
39205_0,,,,2,1,2,3
39206_0,,,,2,1,2,3
39207_0,,,,2,1,2,3
39209_0,,,,2,1,2,3
C(C(C(CO)=C)(CO)C(C)O)=O,,,5,1,1,0,1
39210_0,,,,2,1,2,3
39211_0,,,,2,1,2,3
39213_0,,,,2,1,2,3
C(C(C=CC=C)(CO)C(C)O)=O,,,5,1,1,0,1
39214_0,,,,2,1,2,3
39215_0,,,,2,1,2,3
39216_0,,,,2,1,2,3
39217_0,,,,2,1,2,3
39218_0,,,,2,1,2,3
39219_0,,,,2,1,2,3
39220_0,,,,2,1,2,3
39221_0,,,,2,1,2,3
39222_0,,,,2,1,2,3
39223_0,,,,2,1,2,3
39224_0,,,,2,1,2,3
39225_0,,,,2,1,2,3
39226_0,,,,2,1,2,3
39227_0,,,,2,1,2,3
39228_0,,,,2,1,2,3
39229_0,,,,2,1,2,3
39231_0,,,,2,1,2,3
C(C(C=CC=O)C(C=O)O)(O)=O,,,5,1,1,0,1
39233_0,,,,2,1,2,3
C(CC(C(C(O)=O)=CC=O)O)=O,,,5,1,2,0,2
39235_0,,,,2,1,2,3
C(CC=C(C(O)=O)C(C=O)O)=O,,,5,1,1,0,1
39237_0,,,,2,1,2,3
C(C(C=CC=O)C(CO)O)(O)=O,,,5,1,1,0,1
39239_0,,,,2,1,2,3
C(CC(C(C(O)=O)=CCO)O)=O,,,5,1,1,0,1
39241_0,,,,2,1,2,3
C(CC=C(C(O)=O)C(CO)O)=O,,,5,1,1,0,1
39242_0,,,,2,1,2,3
39244_0,,,,2,1,2,3
C(C(C=O)(C=CCO)CO)(O)=O,,,5,1,1,0,1
39245_0,,,,2,1,2,3
39247_0,,,,2,1,2,3
C(C(C=O)(C(CO)=C)CO)(O)=O,,,5,1,1,0,1
39249_0,,,,2,1,2,3
C(C(C=O)(C=CC=C)CO)(O)=O,,,5,1,1,0,1
39250_0,,,,2,1,2,3
39251_0,,,,2,1,2,3
39252_0,,,,2,1,2,3
39254_0,,,,2,1,2,3
C(C(C(C=O)=O)(CO)O)=CCO,,,5,1,1,0,1
39255_0,,,,2,1,2,3
39257_0,,,,2,1,2,3
C=C(CO)C(C(C=O)=O)(CO)O,,,5,1,1,0,1
39259_0,,,,2,1,2,3
C=CC=CC(C(C=O)=O)(CO)O,,,5,1,1,0,1
39260_0,,,,2,1,2,3
39261_0,,,,2,1,2,3
39262_0,,,,2,1,2,3
39263_0,,,,2,1,2,3
39264_0,,,,2,1,2,3
39265_0,,,,2,1,2,3
39266_0,,,,2,1,2,3
39268_0,,,,2,1,2,3
C(C(C=O)(C(C=O)=CCO)O)=O,,,5,1,1,0,1
39270_0,,,,2,1,2,3
C(C(C(C(O)=O)=C)(CCO)O)=O,,,5,1,2,0,2
39272_0,,,,2,1,2,3
C(C(CO)=C(C=O)CCO)(O)=O,,,5,1,1,0,1
39273_0,,,,2,1,2,3
39275_0,,,,2,1,2,3
C(C(C(C=O)=CCO)CO)(O)=O,,,5,1,1,0,1
39276_0,,,,2,1,2,3
39277_0,,,,2,1,2,3
39278_0,,,,2,1,2,3
39279_0,,,,2,1,2,3
39281_0,,,,2,1,2,3
C(C=C(C(O)=O)CO)(CCO)=O,,,5,1,1,0,1
39282_0,,,,2,1,2,3
39283_0,,,,2,1,2,3
39284_0,,,,2,1,2,3
39286_0,,,,2,1,2,3
C(C(C=O)(C=CCO)O)=O,,,5,1,1,0,1
39287_0,,,,2,1,2,3
39289_0,,,,2,1,2,3
C(C(C=O)(C=CCO)O)(O)=O,,,5,1,1,0,1
39290_0,,,,2,1,2,3
39292_0,,,,2,1,2,3
C=C(C(O)=O)C(CCO)O,,,5,1,2,0,2
39294_0,,,,2,1,2,3
C(CCO)=C(C(O)=O)CO,,,5,1,1,0,1
39296_0,,,,2,1,2,3
C(C(C=CCO)CO)(O)=O,,,5,1,1,0,1
39297_0,,,,2,1,2,3
39299_0,,,,2,1,2,3
C(C)=C(C(O)=O)C(CCO)O,,,5,1,1,0,1
39301_0,,,,2,1,2,3
C(CCO)=C(C(O)=O)C(C)O,,,5,1,1,0,1
39302_0,,,,2,1,2,3
39304_0,,,,2,1,2,3
C(C(C=CCO)C(C)O)(O)=O,,,5,1,2,0,2
39305_0,,,,2,1,2,3
39307_0,,,,2,1,2,3
C(CCO)=C(C(O)=O)C(O)=O,,,5,1,1,0,1
39309_0,,,,2,1,2,3
C(C(C(O)=O)C=CCO)(O)=O,,,5,1,2,0,2
39310_0,,,,2,1,2,3
39311_0,,,,2,1,2,3
39313_0,,,,2,1,2,3
C(C(C=CCO)(C(C)O)O)(O)=O,,,5,1,1,0,1
39314_0,,,,2,1,2,3
39316_0,,,,2,1,2,3
C(C(C(O)=O)(C=CCO)O)(O)=O,,,5,1,1,0,1
39317_0,,,,2,1,2,3
39319_0,,,,2,1,2,3
C(C)(C(C(O)=O)(C=CCO)C)=O,,,5,1,1,0,1
39320_0,,,,2,1,2,3
39322_0,,,,2,1,2,3
C(C(C=CCO)(CO)O)=O,,,5,1,1,0,1
39323_0,,,,2,1,2,3
39325_0,,,,2,1,2,3
C(C(C=CCO)(CO)O)(O)=O,,,5,1,1,0,1
39326_0,,,,2,1,2,3
39327_0,,,,2,1,2,3
39328_0,,,,2,1,2,3
39329_0,,,,2,1,2,3
39330_0,,,,2,1,2,3
39332_0,,,,2,1,2,3
C(C(C(C(O)=O)=CC)O)=O,,,5,1,1,0,1
39334_0,,,,2,1,2,3
C(C(C(C)O)=CC=O)(O)=O,,,5,1,2,0,2
39335_0,,,,2,1,2,3
39337_0,,,,2,1,2,3
C(C=C(C(O)=O)C(O)=O)=O,,,5,1,1,0,1
39338_0,,,,2,1,2,3
39340_0,,,,2,1,2,3
[C](C(O)=O)=C(C(O)=O)C(C=O)O,,,5,1,1,0,1
39342_0,,,,2,1,2,3
C(C=C(C(O)=O)[C](C(O)=O)O)=O,,,5,1,1,0,1
39343_0,,,,2,1,2,3
39344_0,,,,2,1,2,3
39346_0,,,,2,1,2,3
C(C(C=O)(C(CO)=C)O)=O,,,5,1,1,0,1
39348_0,,,,2,1,2,3
C(C(C=O)(C=CC=C)O)=O,,,5,1,1,0,1
39349_0,,,,2,1,2,3
39351_0,,,,2,1,2,3
C(C(C=O)(C=C)O)=O,,,5,1,1,0,1
39353_0,,,,2,1,2,3
C(C(C=O)(C=CC(C)O)O)=O,,,5,1,1,0,1
39354_0,,,,2,1,2,3
39355_0,,,,2,1,2,3
39357_0,,,,2,1,2,3
C(C(C=O)(C=CC(O)=O)O)=O,,,5,1,1,0,1
39359_0,,,,2,1,2,3
C(C(C=O)(C(C=O)=C)O)=O,,,5,1,1,0,1
39361_0,,,,2,1,2,3
C(C(C=O)(C(C(O)=O)=C)O)=O,,,5,1,1,0,1
39363_0,,,,2,1,2,3
C(C(C=O)(C(CO)=C)O)(O)=O,,,5,1,1,0,1
39365_0,,,,2,1,2,3
C(C(C=O)(C=CC=C)O)(O)=O,,,5,1,1,0,1
39366_0,,,,2,1,2,3
39368_0,,,,2,1,2,3
C(C(C=O)(C=C)O)(O)=O,,,5,1,1,0,1
39370_0,,,,2,1,2,3
C(C(C=O)(C=CC(C)O)O)(O)=O,,,5,1,1,0,1
39371_0,,,,2,1,2,3
39372_0,,,,2,1,2,3
39374_0,,,,2,1,2,3
C(C(C=O)(C=CC(O)=O)O)(O)=O,,,5,1,1,0,1
39376_0,,,,2,1,2,3
C(C(C=O)(C(C=O)=C)O)(O)=O,,,5,1,1,0,1
39378_0,,,,2,1,2,3
C(C(C=O)(C(C(O)=O)=C)O)(O)=O,,,5,1,1,0,1
39379_0,,,,2,1,2,3
39380_0,,,,2,1,2,3
39382_0,,,,2,1,2,3
C(CO)(CO)=C(C(O)=O)CO,,,5,1,1,0,1
39383_0,,,,2,1,2,3
39385_0,,,,2,1,2,3
C(C(C(CO)=C)CO)(O)=O,,,5,1,1,0,1
39387_0,,,,2,1,2,3
C(C)(CO)=C(C(O)=O)CO,,,5,1,1,0,1
39388_0,,,,2,1,2,3
39390_0,,,,2,1,2,3
C(C)=CC=C(C(O)=O)CO,,,5,1,1,0,1
39392_0,,,,2,1,2,3
C(C(C(C(O)=O)=C)O)=CC,,,5,1,3,0,3
39394_0,,,,2,1,2,3
C(C(C=CC=C)CO)(O)=O,,,5,1,1,0,1
39396_0,,,,2,1,2,3
C=CCC=C(C(O)=O)CO,,,5,1,1,0,1
39398_0,,,,2,1,2,3
C=CCC(C(C(O)=O)=C)O,,,5,1,3,0,3
39400_0,,,,2,1,2,3
C(C(CO)O)=C(C(O)=O)CO,,,5,1,1,0,1
39402_0,,,,2,1,2,3
C=C(C(O)=O)C(C(CO)O)O,,,5,1,3,0,3
39403_0,,,,2,1,2,3
39404_0,,,,2,1,2,3
39405_0,,,,2,1,2,3
39407_0,,,,2,1,2,3
C(C(C)O)=C(C(O)=O)CO,,,5,1,2,0,2
39409_0,,,,2,1,2,3
C=C(C(O)=O)C(C(C)O)O,,,5,1,2,0,2
39410_0,,,,2,1,2,3
39411_0,,,,2,1,2,3
39413_0,,,,2,1,2,3
C(C)=C(C(O)=O)C(CO)(CO)O,,,5,1,1,0,1
39415_0,,,,2,1,2,3
C(CO)(CO)=C(C(O)=O)C(C)O,,,5,1,1,0,1
39416_0,,,,2,1,2,3
39418_0,,,,2,1,2,3
C(CO)(CO)=C(C(O)=O)C(O)=O,,,5,1,1,0,1
39420_0,,,,2,1,2,3
C(C)=C(C(O)=O)C(CO)(C)O,,,5,1,1,0,1
39422_0,,,,2,1,2,3
C(CO)(C)=C(C(O)=O)C(C)O,,,5,1,1,0,1
39423_0,,,,2,1,2,3
39425_0,,,,2,1,2,3
C(C(C(CO)=C)C(C)O)(O)=O,,,5,1,1,0,1
39427_0,,,,2,1,2,3
C(C)(CO)=C(C(O)=O)C(O)=O,,,5,1,1,0,1
39429_0,,,,2,1,2,3
C(C(C(O)=O)C(CO)=C)(O)=O,,,5,1,1,0,1
39430_0,,,,2,1,2,3
39432_0,,,,2,1,2,3
C(C(C(CO)=C)(C(C)O)O)(O)=O,,,5,1,1,0,1
39434_0,,,,2,1,2,3
C(C(C(O)=O)(C(CO)=C)O)(O)=O,,,5,1,1,0,1
39436_0,,,,2,1,2,3
C(C)(C(C(O)=O)(C(CO)=C)C)=O,,,5,1,1,0,1
39438_0,,,,2,1,2,3
C(C(C(CO)=C)(CO)O)=O,,,5,1,1,0,1
39440_0,,,,2,1,2,3
C(C)=CC=C(C(O)=O)C(C)O,,,5,1,1,0,1
39442_0,,,,2,1,2,3
C(C(C(C(O)=O)=CC)O)=CC,,,5,1,1,0,1
39443_0,,,,2,1,2,3
39445_0,,,,2,1,2,3
C(C(C=CC=C)C(C)O)(O)=O,,,5,1,1,0,1
39447_0,,,,2,1,2,3
C=CCC=C(C(O)=O)C(C)O,,,5,1,1,0,1
39449_0,,,,2,1,2,3
C=CCC(C(C(O)=O)=CC)O,,,5,1,1,0,1
39450_0,,,,2,1,2,3
39452_0,,,,2,1,2,3
C(C(CO)O)=C(C(O)=O)C(C)O,,,5,1,1,0,1
39454_0,,,,2,1,2,3
C(C)=C(C(O)=O)C(C(CO)O)O,,,5,1,1,0,1
39455_0,,,,2,1,2,3
39457_0,,,,2,1,2,3
C(CO)=C(C(O)=O)C(C)O,,,5,1,1,0,1
39459_0,,,,2,1,2,3
C(C)=C(C(O)=O)C(CO)O,,,5,1,1,0,1
39460_0,,,,2,1,2,3
39461_0,,,,2,1,2,3
39463_0,,,,2,1,2,3
C(C(C)O)=C(C(O)=O)C(C)O,,,5,1,2,0,2
39465_0,,,,2,1,2,3
C(C)=C(C(O)=O)C(C(C)O)O,,,5,1,1,0,1
39466_0,,,,2,1,2,3
39468_0,,,,2,1,2,3
C(C=C(C(O)=O)C(C)O)(O)=O,,,5,1,2,0,2
39470_0,,,,2,1,2,3
C(C(C(C(O)=O)=CC)O)(O)=O,,,5,1,2,0,2
39471_0,,,,2,1,2,3
39473_0,,,,2,1,2,3
C(C)=CC=C(C(O)=O)C(O)=O,,,5,1,1,0,1
39475_0,,,,2,1,2,3
C(C(C(O)=O)C=CC=C)(O)=O,,,5,1,1,0,1
39477_0,,,,2,1,2,3
C=CCC=C(C(O)=O)C(O)=O,,,5,1,1,0,1
39479_0,,,,2,1,2,3
C(C(CO)O)=C(C(O)=O)C(O)=O,,,5,1,1,0,1
39481_0,,,,2,1,2,3
C(CO)=C(C(O)=O)C(O)=O,,,5,1,1,0,1
39482_0,,,,2,1,2,3
39484_0,,,,2,1,2,3
C(C(C)O)=C(C(O)=O)C(O)=O,,,5,1,2,0,2
39486_0,,,,2,1,2,3
C(C(C(O)=O)=CC(O)=O)(O)=O,,,5,1,2,0,2
39487_0,,,,2,1,2,3
39488_0,,,,2,1,2,3
39489_0,,,,2,1,2,3
39490_0,,,,2,1,2,3
39491_0,,,,2,1,2,3
39492_0,,,,2,1,2,3
39493_0,,,,2,1,2,3
39495_0,,,,2,1,2,3
C(C(C=CC=C)(C(C)O)O)(O)=O,,,5,1,1,0,1
39496_0,,,,2,1,2,3
39497_0,,,,2,1,2,3
39498_0,,,,2,1,2,3
39499_0,,,,2,1,2,3
39500_0,,,,2,1,2,3
39501_0,,,,2,1,2,3
39502_0,,,,2,1,2,3
39504_0,,,,2,1,2,3
C(C(C(O)=O)(C=CC=C)O)(O)=O,,,5,1,1,0,1
39505_0,,,,2,1,2,3
39507_0,,,,2,1,2,3
C(C(C(C)=O)(C=C)CO)(O)=O,,,5,1,1,0,1
39509_0,,,,2,1,2,3
C(C)(C(C(O)=O)(C=CC=C)C)=O,,,5,1,1,0,1
39510_0,,,,2,1,2,3
39512_0,,,,2,1,2,3
C(C)(C(C(O)=O)(C=C)C)=O,,,5,1,1,0,1
39514_0,,,,2,1,2,3
C(C)(C(C(O)=O)(C(C=O)=C)C)=O,,,5,1,1,0,1
39516_0,,,,2,1,2,3
C(C(C=CC=C)(CO)O)=O,,,5,1,1,0,1
39518_0,,,,2,1,2,3
C(C(C=CC=C)(CO)O)(O)=O,,,5,1,2,0,2
39519_0,,,,2,1,2,3
39520_0,,,,2,1,2,3
39521_0,,,,2,1,2,3
39523_0,,,,2,1,2,3
C(C(C=CC(C)O)(CO)O)=O,,,5,1,1,0,1
39524_0,,,,2,1,2,3
39525_0,,,,2,1,2,3
39526_0,,,,2,1,2,3
39527_0,,,,2,1,2,3
39529_0,,,,2,1,2,3
[C](C(O)=O)=C(C(O)=O)C(CO)O,,,5,1,1,0,1
39531_0,,,,2,1,2,3
C(CO)=C(C(O)=O)[C](C(O)=O)O,,,5,1,1,0,1
39533_0,,,,2,1,2,3
C(C=C(C(O)=O)C(CO)O)(O)=O,,,5,1,3,0,3
39535_0,,,,2,1,2,3
C(C(C(C(O)=O)=CCO)O)(O)=O,,,5,1,2,0,2
39537_0,,,,2,1,2,3
C(C(C=C)(CO)C[CH]C(O)=O)=O,,,5,1,2,0,2
39539_0,,,,2,1,2,3
C(C(C=C)(CCC(O)=O)CO)=O,,,5,1,2,0,2
39541_0,,,,2,1,2,3
C(C(C=C)[C](C(O)=O)O)(O)=O,,,5,1,2,0,2
39543_0,,,,2,1,2,3
C(C)=C(C(O)=O)[C](C(O)=O)O,,,5,1,2,0,2
39545_0,,,,2,1,2,3
[C](C(O)=O)=C(C(O)=O)C(C)O,,,5,1,1,0,1
39547_0,,,,2,1,2,3
[C](C(O)=O)=C(C(O)=O)C(O)=O,,,5,1,1,0,1
39549_0,,,,2,1,2,3
C=C(C(O)=O)[C](C(O)=O)O,,,5,1,2,0,2
39551_0,,,,2,1,2,3
[C](C(O)=O)=C(C(O)=O)CO,,,5,1,1,0,1
39553_0,,,,2,1,2,3
C(C(CO)=C(C=O)C(C)O)(C)=O,,,5,1,1,0,1
39554_0,,,,2,1,2,3
39555_0,,,,2,1,2,3
39556_0,,,,2,1,2,3
39557_0,,,,2,1,2,3
39559_0,,,,2,1,2,3
C(C(C=C(CO)C(C)O)(C)O)=O,,,5,1,1,0,1
39560_0,,,,2,1,2,3
39561_0,,,,2,1,2,3
39562_0,,,,2,1,2,3
39564_0,,,,2,1,2,3
C(C(C=C(CO)C(C)O)O)(O)=O,,,5,1,1,0,1
39565_0,,,,2,1,2,3
39566_0,,,,2,1,2,3
39568_0,,,,2,1,2,3
C(C(C=O)=C(C(C)=O)CO)(O)=O,,,5,1,1,0,1
39569_0,,,,2,1,2,3
39570_0,,,,2,1,2,3
39572_0,,,,2,1,2,3
C(C(C=C(C(O)=O)CO)(C)O)=O,,,5,1,1,0,1
39574_0,,,,2,1,2,3
C(C(C=C(C(CO)=O)CO)=O)=O,,,5,1,1,0,1
39576_0,,,,2,1,2,3
C(C(C(C(CO)=O)=CC=O)O)=O,,,5,1,1,0,1
39578_0,,,,2,1,2,3
C(C=C(C(CO)=O)C(CO)O)=O,,,5,1,1,0,1
39580_0,,,,2,1,2,3
C(C=C(C(CO)=O)CO)=O,,,5,1,1,0,1
39581_0,,,,2,1,2,3
39582_0,,,,2,1,2,3
39583_0,,,,2,1,2,3
39585_0,,,,2,1,2,3
C(C(C=CC(C=O)(C)O)(C)O)=O,,,5,1,1,0,1
39586_0,,,,2,1,2,3
39587_0,,,,2,1,2,3
39589_0,,,,2,1,2,3
C(C(C=CC(C(O)=O)O)(C)O)=O,,,5,1,1,0,1
39590_0,,,,2,1,2,3
39591_0,,,,2,1,2,3
39592_0,,,,2,1,2,3
39593_0,,,,2,1,2,3
39594_0,,,,2,1,2,3
39596_0,,,,2,1,2,3
C(C(C=C(C(C)=O)CO)=O)=O,,,5,1,1,0,1
39598_0,,,,2,1,2,3
C(CC(C(C)=O)(C=CCO)O)=O,,,5,1,1,0,1
39599_0,,,,2,1,2,3
39601_0,,,,2,1,2,3
C(C=C(C(C)=O)C(CCO)O)=O,,,5,1,1,0,1
39603_0,,,,2,1,2,3
C(CC(C(C)=O)(C(CO)=C)O)=O,,,5,1,1,0,1
39605_0,,,,2,1,2,3
C(C=C(C(C)=O)C(CO)(C)O)=O,,,5,1,1,0,1
39607_0,,,,2,1,2,3
C(C(C(C(C)=O)=CC=O)O)=CC,,,5,1,1,0,1
39609_0,,,,2,1,2,3
C(CC(C(C)=O)(C=CC=C)O)=O,,,5,1,1,0,1
39611_0,,,,2,1,2,3
C=CCC(C(C(C)=O)=CC=O)O,,,5,1,1,0,1
39613_0,,,,2,1,2,3
C(C=C(C(C)=O)C(CO)O)=O,,,5,1,1,0,1
39614_0,,,,2,1,2,3
39616_0,,,,2,1,2,3
C(C=C(C(C)=O)C(C(C)O)O)=O,,,5,1,1,0,1
39618_0,,,,2,1,2,3
C(C(C(C(C)=O)=CC=O)O)(O)=O,,,5,1,1,0,1
39619_0,,,,2,1,2,3
39621_0,,,,2,1,2,3
C(C(C(C(C)=O)=CC=O)(C)O)=O,,,5,1,1,0,1
39623_0,,,,2,1,2,3
C(C=C(C(C)=O)CO)=O,,,5,1,1,0,1
39624_0,,,,2,1,2,3
39625_0,,,,2,1,2,3
39626_0,,,,2,1,2,3
39628_0,,,,2,1,2,3
C(C(C=CC(C(C)=O)O)O)(O)=O,,,5,1,1,0,1
39629_0,,,,2,1,2,3
39630_0,,,,2,1,2,3
39631_0,,,,2,1,2,3
39633_0,,,,2,1,2,3
C(CC(C(C(C=O)(C)O)=C)O)=O,,,5,1,1,0,1
39635_0,,,,2,1,2,3
C(C(C=C(C(C)=O)CO)=O)(O)=O,,,5,1,1,0,1
39636_0,,,,2,1,2,3
39637_0,,,,2,1,2,3
39638_0,,,,2,1,2,3
39639_0,,,,2,1,2,3
39640_0,,,,2,1,2,3
39641_0,,,,2,1,2,3
39642_0,,,,2,1,2,3
39644_0,,,,2,1,2,3
C(C(C(C=O)=CCO)O)(O)=O,,,5,1,1,0,1
39645_0,,,,2,1,2,3
39646_0,,,,2,1,2,3
39647_0,,,,2,1,2,3
39648_0,,,,2,1,2,3
39649_0,,,,2,1,2,3
39650_0,,,,2,1,2,3
39651_0,,,,2,1,2,3
39652_0,,,,2,1,2,3
39654_0,,,,2,1,2,3
C(C(C(C=O)=CC(C)O)O)(O)=O,,,5,1,1,0,1
39655_0,,,,2,1,2,3
39656_0,,,,2,1,2,3
39657_0,,,,2,1,2,3
39658_0,,,,2,1,2,3
39659_0,,,,2,1,2,3
39661_0,,,,2,1,2,3
C(C(C(C=O)=CC(O)=O)O)(O)=O,,,5,1,2,0,2
39662_0,,,,2,1,2,3
39664_0,,,,2,1,2,3
C=C(C(C(C)=O)=O)C(CCO)O,,,5,1,1,0,1
39666_0,,,,2,1,2,3
C(C(C(C(C)=O)=O)(C)O)=CCO,,,5,1,1,0,1
39667_0,,,,2,1,2,3
39668_0,,,,2,1,2,3
39670_0,,,,2,1,2,3
C(C(C=CCO)(C)O)=O,,,5,1,1,0,1
39671_0,,,,2,1,2,3
39672_0,,,,2,1,2,3
39674_0,,,,2,1,2,3
C(C(C=CCO)(C)O)(O)=O,,,5,1,1,0,1
39675_0,,,,2,1,2,3
39677_0,,,,2,1,2,3
C(C(C=CCO)O)(O)=O,,,5,1,1,0,1
39678_0,,,,2,1,2,3
39679_0,,,,2,1,2,3
39681_0,,,,2,1,2,3
C(C(C(C(O)=O)=CCO)(C)O)=O,,,5,1,1,0,1
39682_0,,,,2,1,2,3
39683_0,,,,2,1,2,3
39684_0,,,,2,1,2,3
39685_0,,,,2,1,2,3
39687_0,,,,2,1,2,3
C(C(C(C(CC=O)=O)=C)(C)O)=O,,,5,1,1,0,1
39689_0,,,,2,1,2,3
C(C(C(C(CC=O)=O)=C)O)(O)=O,,,5,1,1,0,1
39690_0,,,,2,1,2,3
39692_0,,,,2,1,2,3
C(C(C=CC(C(C)=O)=O)(C)O)=O,,,5,1,1,0,1
39694_0,,,,2,1,2,3
C(C(C=CC(C(C)=O)=O)O)(O)=O,,,5,1,1,0,1
39696_0,,,,2,1,2,3
C(C(C(C(C(CO)=O)=O)=C)O)=O,,,5,1,1,0,1
39698_0,,,,2,1,2,3
C=C(C(C(CO)=O)=O)C(CO)O,,,5,1,1,0,1
39700_0,,,,2,1,2,3
C=CC(C(C(CO)=O)=O)(C)O,,,5,1,1,0,1
39702_0,,,,2,1,2,3
C=C(C(C(CO)=O)=O)C(C)O,,,5,1,1,0,1
39704_0,,,,2,1,2,3
C=C(C(C(CO)=O)=O)CO,,,5,1,1,0,1
39706_0,,,,2,1,2,3
C(C(C(C(C(C)=O)=O)=C)O)=O,,,5,1,1,0,1
39708_0,,,,2,1,2,3
C=C(CO)C(C(C(C)=O)=O)(C)O,,,5,1,1,0,1
39710_0,,,,2,1,2,3
C=C(C(C(C)=O)=O)C(CO)(C)O,,,5,1,1,0,1
39712_0,,,,2,1,2,3
C(C(C(C(C(C)=O)=O)=C)O)=CC,,,5,1,1,0,1
39714_0,,,,2,1,2,3
C=CC=CC(C(C(C)=O)=O)(C)O,,,5,1,1,0,1
39716_0,,,,2,1,2,3
C=CCC(C(C(C(C)=O)=O)=C)O,,,5,1,1,0,1
39718_0,,,,2,1,2,3
C=C(C(C(C)=O)=O)C(CO)O,,,5,1,1,0,1
39719_0,,,,2,1,2,3
39721_0,,,,2,1,2,3
C=C(C(C(C)=O)=O)C(C(C)O)O,,,5,1,1,0,1
39722_0,,,,2,1,2,3
39724_0,,,,2,1,2,3
C=CC(C(C(C)=O)=O)(C)O,,,5,1,1,0,1
39726_0,,,,2,1,2,3
C=C(C(C(C)=O)=O)C(C)O,,,5,1,1,0,1
39728_0,,,,2,1,2,3
C=C(C=O)C(C(C(C)=O)=O)(C)O,,,5,1,1,0,1
39730_0,,,,2,1,2,3
C(C(C(C(C(C)=O)=O)=C)(C)O)=O,,,5,1,1,0,1
39732_0,,,,2,1,2,3
C(C)(C(C(C(C(C)=O)=O)=C)O)=O,,,5,1,1,0,1
39734_0,,,,2,1,2,3
C=C(C(C(C)=O)=O)CO,,,5,1,1,0,1
39735_0,,,,2,1,2,3
39736_0,,,,2,1,2,3
39737_0,,,,2,1,2,3
39739_0,,,,2,1,2,3
C(C(C(C(C(C)O)=O)=C)(C)O)=O,,,5,1,1,0,1
39740_0,,,,2,1,2,3
39742_0,,,,2,1,2,3
C(C(C(C(C(C)O)=O)=C)O)(O)=O,,,5,1,1,0,1
39743_0,,,,2,1,2,3
39744_0,,,,2,1,2,3
39745_0,,,,2,1,2,3
39746_0,,,,2,1,2,3
39747_0,,,,2,1,2,3
39749_0,,,,2,1,2,3
C(C(CO)=CC(C(C)=O)=O)(O)=O,,,5,1,1,0,1
39750_0,,,,2,1,2,3
39751_0,,,,2,1,2,3
39752_0,,,,2,1,2,3
39754_0,,,,2,1,2,3
C(C(C(CO)=C)(C)O)=O,,,5,1,1,0,1
39755_0,,,,2,1,2,3
39756_0,,,,2,1,2,3
39757_0,,,,2,1,2,3
39759_0,,,,2,1,2,3
C(C(C(C(C=O)(C)O)=C)C)(O)=O,,,5,1,1,0,1
39761_0,,,,2,1,2,3
C(C(C(C)=C(C(O)=O)C)(C)O)=O,,,5,1,1,0,1
39763_0,,,,2,1,2,3
C(C(C(C(C(O)=O)O)=C)C)(O)=O,,,5,1,2,0,2
39765_0,,,,2,1,2,3
C(C(C(C)=C(C(O)=O)C)O)(O)=O,,,5,1,1,0,1
39766_0,,,,2,1,2,3
39767_0,,,,2,1,2,3
39768_0,,,,2,1,2,3
39770_0,,,,2,1,2,3
C(C(C=CC=C)(C)O)=O,,,5,1,1,0,1
39771_0,,,,2,1,2,3
39773_0,,,,2,1,2,3
C(C(C=CC=C)(C)O)(O)=O,,,5,1,2,0,2
39775_0,,,,2,1,2,3
C(C(C=CC=C)O)(O)=O,,,5,1,2,0,2
39776_0,,,,2,1,2,3
39777_0,,,,2,1,2,3
39779_0,,,,2,1,2,3
C(C(C(C(O)=O)=CC=C)(C)O)=O,,,5,1,1,0,1
39781_0,,,,2,1,2,3
C(C(C(C(O)=O)=CC=C)O)(O)=O,,,5,1,1,0,1
39782_0,,,,2,1,2,3
39784_0,,,,2,1,2,3
C(C(C=CC(C(O)=O)=C)(C)O)=O,,,5,1,1,0,1
39786_0,,,,2,1,2,3
C(C(C=CC(C(O)=O)=C)O)(O)=O,,,5,1,1,0,1
39787_0,,,,2,1,2,3
39789_0,,,,2,1,2,3
C=C(C(O)=O)C=C(C(O)=O)CO,,,5,1,1,0,1
39790_0,,,,2,1,2,3
39791_0,,,,2,1,2,3
39792_0,,,,2,1,2,3
39794_0,,,,2,1,2,3
C(C(C)O)=C(C(O)=O)C(CO)O,,,5,1,2,0,2
39795_0,,,,2,1,2,3
39796_0,,,,2,1,2,3
39797_0,,,,2,1,2,3
39798_0,,,,2,1,2,3
39800_0,,,,2,1,2,3
C(C(C1C(OC(C=1)C)=O)(C)O)=O,,,5,1,1,0,1
39802_0,,,,2,1,2,3
C(C(C1C(OC(C=1)C)=O)O)(O)=O,,,5,1,1,0,1
39803_0,,,,2,1,2,3
39805_0,,,,2,1,2,3
C(C(C1C(OC(C=1)=O)=O)(C)O)=O,,,5,1,1,0,1
39807_0,,,,2,1,2,3
C(C(C1C(OC(C=1)=O)=O)O)(O)=O,,,5,1,1,0,1
39809_0,,,,2,1,2,3
C(C1(C=C(C(O1)=O)CO)C)(O)=O,,,5,1,1,0,1
39810_0,,,,2,1,2,3
39811_0,,,,2,1,2,3
39813_0,,,,2,1,2,3
C1(C(C=C(C(O1)=O)CO)(C)O)=O,,,5,1,1,0,1
39814_0,,,,2,1,2,3
39815_0,,,,2,1,2,3
39817_0,,,,2,1,2,3
C(C(C(CO)=C[CH]C(O)=O)=O)=O,,,5,1,1,0,1
39818_0,,,,2,1,2,3
39820_0,,,,2,1,2,3
C(C(C=C)(C[CH]C(O)=O)O)(O)=O,,,5,1,2,0,2
39822_0,,,,2,1,2,3
C([CH]C=C(C(O)=O)C(C)O)(O)=O,,,5,1,1,0,1
39824_0,,,,2,1,2,3
C(C(C(O)=O)=C[CH]C(O)=O)(O)=O,,,5,1,1,0,1
39826_0,,,,2,1,2,3
C(C(C=C)(CCC(O)=O)O)(O)=O,,,5,1,2,0,2
39827_0,,,,2,1,2,3
39828_0,,,,2,1,2,3
39829_0,,,,2,1,2,3
39831_0,,,,2,1,2,3
C(C(C=CC[CH]C(O)=O)(C)O)=O,,,5,1,1,0,1
39833_0,,,,2,1,2,3
C(C(C=CC[CH]C(O)=O)O)(O)=O,,,5,1,1,0,1
39835_0,,,,2,1,2,3
C(C[CH]C(O)=O)=C(C(O)=O)CO,,,5,1,1,0,1
39836_0,,,,2,1,2,3
39838_0,,,,2,1,2,3
C(C(C=CCCC(O)=O)(C)O)=O,,,5,1,1,0,1
39840_0,,,,2,1,2,3
C(C(C=CCCC(O)=O)O)(O)=O,,,5,1,1,0,1
39842_0,,,,2,1,2,3
C(CCC=C(C(O)=O)CO)(O)=O,,,5,1,1,0,1
39843_0,,,,2,1,2,3
39844_0,,,,2,1,2,3
39845_0,,,,2,1,2,3
39846_0,,,,2,1,2,3
39848_0,,,,2,1,2,3
C(C(C=CC(C)O)(C)O)=O,,,5,1,1,0,1
39849_0,,,,2,1,2,3
39850_0,,,,2,1,2,3
39851_0,,,,2,1,2,3
39852_0,,,,2,1,2,3
39853_0,,,,2,1,2,3
39854_0,,,,2,1,2,3
39855_0,,,,2,1,2,3
39856_0,,,,2,1,2,3
39857_0,,,,2,1,2,3
39858_0,,,,2,1,2,3
39859_0,,,,2,1,2,3
39860_0,,,,2,1,2,3
39861_0,,,,2,1,2,3
39862_0,,,,2,1,2,3
39863_0,,,,2,1,2,3
39864_0,,,,2,1,2,3
39865_0,,,,2,1,2,3
39866_0,,,,2,1,2,3
39867_0,,,,2,1,2,3
39868_0,,,,2,1,2,3
39869_0,,,,2,1,2,3
39870_0,,,,2,1,2,3
39871_0,,,,2,1,2,3
39872_0,,,,2,1,2,3
39874_0,,,,2,1,2,3
C(C(C=O)O)(OC(C=C)=O)=O,,,5,1,1,0,1
39876_0,,,,2,1,2,3
C=CC(OCC(C(O)=O)=O)=O,,,5,1,2,0,2
39878_0,,,,2,1,2,3
C=CC(OC(C(CO)=O)=O)=O,,,5,1,2,0,2
39880_0,,,,2,1,2,3
C=CC(OC(C(C)=O)=O)=O,,,5,1,2,0,2
39881_0,,,,2,1,2,3
39883_0,,,,2,1,2,3
C(C(C(O)=O)OC(C=C)=O)=O,,,5,1,1,0,1
39884_0,,,,2,1,2,3
39885_0,,,,2,1,2,3
39886_0,,,,2,1,2,3
39887_0,,,,2,1,2,3
39888_0,,,,2,1,2,3
39889_0,,,,2,1,2,3
39890_0,,,,2,1,2,3
39891_0,,,,2,1,2,3
39892_0,,,,2,1,2,3
39893_0,,,,2,1,2,3
39894_0,,,,2,1,2,3
39895_0,,,,2,1,2,3
39897_0,,,,2,1,2,3
C=C(C=O)C(C(C=O)=O)=O,,,5,1,1,0,1
39899_0,,,,2,1,2,3
C(C(C=O)=CC(C=O)=O)=O,,,5,1,1,0,1
39901_0,,,,2,1,2,3
C=C(C=O)C(C(C(O)=O)=O)=O,,,5,1,1,0,1
39903_0,,,,2,1,2,3
C(C(C=O)=CC(C(O)=O)=O)=O,,,5,1,1,0,1
39905_0,,,,2,1,2,3
C(C(C(O)=O)=CC(C=O)=O)=O,,,5,1,1,0,1
39907_0,,,,2,1,2,3
C=C(C(O)=O)C(C(C=O)=O)=O,,,5,1,1,0,1
39908_0,,,,2,1,2,3
39910_0,,,,2,1,2,3
C(C(C=O)=C(C(O)=O)CO)=O,,,5,1,1,0,1
39911_0,,,,2,1,2,3
39912_0,,,,2,1,2,3
39913_0,,,,2,1,2,3
39914_0,,,,2,1,2,3
39915_0,,,,2,1,2,3
39917_0,,,,2,1,2,3
C=C(C=O)C(C(O)=O)=O,,,5,1,3,0,3
39919_0,,,,2,1,2,3
C(C(C=O)=CC(O)=O)=O,,,5,1,1,0,1
39920_0,,,,2,1,2,3
39922_0,,,,2,1,2,3
C(C(C=O)=C(C(O)=O)C)=O,,,5,1,1,0,1
39923_0,,,,2,1,2,3
39924_0,,,,2,1,2,3
39925_0,,,,2,1,2,3
39926_0,,,,2,1,2,3
39928_0,,,,2,1,2,3
C(C1C(OC(C=1C)=O)=O)=O,,,5,1,1,0,1
39930_0,,,,2,1,2,3
C(C)=C(C=O)C=CC(C)O,,,5,1,2,0,2
39931_0,,,,2,1,2,3
39932_0,,,,2,1,2,3
39933_0,,,,2,1,2,3
39934_0,,,,2,1,2,3
39935_0,,,,2,1,2,3
39936_0,,,,2,1,2,3
39937_0,,,,2,1,2,3
39938_0,,,,2,1,2,3
39939_0,,,,2,1,2,3
39940_0,,,,2,1,2,3
39941_0,,,,2,1,2,3
39942_0,,,,2,1,2,3
39943_0,,,,2,1,2,3
39944_0,,,,2,1,2,3
39945_0,,,,2,1,2,3
39946_0,,,,2,1,2,3
39947_0,,,,2,1,2,3
39948_0,,,,2,1,2,3
39949_0,,,,2,1,2,3
39950_0,,,,2,1,2,3
39951_0,,,,2,1,2,3
39952_0,,,,2,1,2,3
39954_0,,,,2,1,2,3
C(C)=C(C=O)C=CC(O)=O,,,5,1,2,0,2
39955_0,,,,2,1,2,3
39956_0,,,,2,1,2,3
39957_0,,,,2,1,2,3
39958_0,,,,2,1,2,3
39959_0,,,,2,1,2,3
39961_0,,,,2,1,2,3
C=C(C=O)C(C=O)=CC,,,5,1,2,0,2
39962_0,,,,2,1,2,3
39963_0,,,,2,1,2,3
39964_0,,,,2,1,2,3
39965_0,,,,2,1,2,3
39966_0,,,,2,1,2,3
39967_0,,,,2,1,2,3
39968_0,,,,2,1,2,3
39969_0,,,,2,1,2,3
39970_0,,,,2,1,2,3
39971_0,,,,2,1,2,3
39972_0,,,,2,1,2,3
39973_0,,,,2,1,2,3
39974_0,,,,2,1,2,3
39975_0,,,,2,1,2,3
39976_0,,,,2,1,2,3
39977_0,,,,2,1,2,3
39978_0,,,,2,1,2,3
39979_0,,,,2,1,2,3
39980_0,,,,2,1,2,3
39981_0,,,,2,1,2,3
39982_0,,,,2,1,2,3
39983_0,,,,2,1,2,3
39985_0,,,,2,1,2,3
C=C(C(O)=O)C=CC(C)O,,,5,1,2,0,2
39986_0,,,,2,1,2,3
39987_0,,,,2,1,2,3
39988_0,,,,2,1,2,3
39989_0,,,,2,1,2,3
39990_0,,,,2,1,2,3
39991_0,,,,2,1,2,3
39993_0,,,,2,1,2,3
C1OC(C(C=1)=C)=O,,,5,1,2,0,2
39994_0,,,,2,1,2,3
39996_0,,,,2,1,2,3
C=C1C(OC(C1=C)=O)=O,,,5,1,2,0,2
39998_0,,,,2,1,2,3
[C]1C(OC(C(C=1)=C)=O)=O,,,5,1,2,0,2
39999_0,,,,2,1,2,3
40001_0,,,,2,1,2,3
C=C1C(OC(C=C1)=O)=O,,,5,1,2,0,2
40002_0,,,,2,1,2,3
40004_0,,,,2,1,2,3
[C](C(O)=O)=CC=C,,,5,1,2,0,2
40005_0,,,,2,1,2,3
40007_0,,,,2,1,2,3
C=CC=CC(O)=O,,,5,1,2,0,2
40008_0,,,,2,1,2,3
40010_0,,,,2,1,2,3
C=CC(CO)(C(CC(C)O)O)O,,,5,1,2,0,2
40012_0,,,,2,1,2,3
C(C(CO)(C(C)O)O)=CC(C)O,,,5,1,2,0,2
40014_0,,,,2,1,2,3
C(C(C(CO)(C(C)O)O)O)=CC,,,5,1,2,0,2
40016_0,,,,2,1,2,3
C=CCC(C(CO)(C(C)O)O)O,,,5,1,2,0,2
40018_0,,,,2,1,2,3
C(C(C(C=CC(C)O)O)O)=O,,,5,1,3,0,3
40019_0,,,,2,1,2,3
40020_0,,,,2,1,2,3
40022_0,,,,2,1,2,3
C(C(CO)O)=CC(C)O,,,5,1,3,0,3
40023_0,,,,2,1,2,3
40024_0,,,,2,1,2,3
40026_0,,,,2,1,2,3
C(C(CO)(C(C)O)O)=CC(O)=O,,,5,1,2,0,2
40028_0,,,,2,1,2,3
C(CC(C(C=C)(CO)O)O)(O)=O,,,5,1,2,0,2
40030_0,,,,2,1,2,3
C(C(C(C=C)(CO)O)O)(CO)=O,,,5,1,2,0,2
40032_0,,,,2,1,2,3
C(C(CO)(C(C=C)(CO)O)O)=O,,,5,1,2,0,2
40034_0,,,,2,1,2,3
C=C(C=O)C(CO)(C(C)O)O,,,5,1,2,0,2
40036_0,,,,2,1,2,3
C(C(C)(C(C=C)(CO)O)O)=O,,,5,1,2,0,2
40038_0,,,,2,1,2,3
C(C(C(C=C)(CO)O)O)(C)=O,,,5,1,2,0,2
40040_0,,,,2,1,2,3
C=CC(CO)(CO)O,,,5,1,2,0,2
40042_0,,,,2,1,2,3
C=CC(CO)(C(C)O)O,,,5,1,2,0,2
40044_0,,,,2,1,2,3
C=C(C(O)=O)C(CO)(C(C)O)O,,,5,1,2,0,2
40046_0,,,,2,1,2,3
C(C(C)(C(C=C)(CO)O)O)(O)=O,,,5,1,2,0,2
40048_0,,,,2,1,2,3
C(C(C(C=C)(CO)O)O)(O)=O,,,5,1,3,0,3
40050_0,,,,2,1,2,3
C(C(C(C=C)(C(C)O)O)O)(O)=O,,,5,1,2,0,2
40052_0,,,,2,1,2,3
C(C(C(C=CC(O)=O)O)O)=O,,,5,1,3,0,3
40054_0,,,,2,1,2,3
C(C(CO)O)=CC(O)=O,,,5,1,3,0,3
40055_0,,,,2,1,2,3
40056_0,,,,2,1,2,3
40058_0,,,,2,1,2,3
C(C(C=CC(CO)O)(C)O)(O)=O,,,5,1,2,0,2
40060_0,,,,2,1,2,3
C=CC(C(CO)O)=O,,,5,1,2,0,2
40062_0,,,,2,1,2,3
[C](C(O)=O)=CC(C(CO)O)=O,,,5,1,2,0,2
40064_0,,,,2,1,2,3
C(C=CC(C(CO)O)=O)(O)=O,,,5,1,2,0,2
40065_0,,,,2,1,2,3
40067_0,,,,2,1,2,3
C1(C(CO)O)OC(C(C=1)=O)=O,,,5,1,2,0,2
40069_0,,,,2,1,2,3
C1(C(C(C(C(O1)=C)=O)O)O)=O,,,5,1,2,0,2
40071_0,,,,2,1,2,3
C=C1C(C(C(C(O1)=O)=O)O)O,,,5,1,2,0,2
40073_0,,,,2,1,2,3
C(CO)(C(C)O)=C[CH]C(O)=O,,,5,1,1,0,1
40075_0,,,,2,1,2,3
C(C(CO)(C[CH]C(O)=O)O)=C,,,5,1,3,0,3
40076_0,,,,2,1,2,3
40078_0,,,,2,1,2,3
C(CCC(C=C)(CO)O)(O)=O,,,5,1,3,0,3
40080_0,,,,2,1,2,3
C(C[CH]C(O)=O)=CC(CO)O,,,5,1,2,0,2
40082_0,,,,2,1,2,3
C(CCC=CC(CO)O)(O)=O,,,5,1,2,0,2
40084_0,,,,2,1,2,3
C(C)(C(CO)O)=C[CH]C(O)=O,,,5,1,2,0,2
40086_0,,,,2,1,2,3
C=C(C(CO)O)C[CH]C(O)=O,,,5,1,2,0,2
40088_0,,,,2,1,2,3
C(CC=C(C)C(CO)O)(O)=O,,,5,1,2,0,2
40090_0,,,,2,1,2,3
C(CCC(C(CO)O)=C)(O)=O,,,5,1,2,0,2
40092_0,,,,2,1,2,3
C(C(C=C[CH]C(O)=O)O)=O,,,5,1,2,0,2
40094_0,,,,2,1,2,3
C(CC=CC(C=O)O)(O)=O,,,5,1,3,0,3
40095_0,,,,2,1,2,3
40096_0,,,,2,1,2,3
40097_0,,,,2,1,2,3
40098_0,,,,2,1,2,3
40099_0,,,,2,1,2,3
40100_0,,,,2,1,2,3
40101_0,,,,2,1,2,3
40102_0,,,,2,1,2,3
40104_0,,,,2,1,2,3
C1(C(C=C(C(O)=O)O1)CO)=O,,,5,1,2,0,2
40105_0,,,,2,1,2,3
40106_0,,,,2,1,2,3
40107_0,,,,2,1,2,3
40109_0,,,,2,1,2,3
C=C(C(O)=O)C([CH]C(O)=O)O,,,5,1,2,0,2
40110_0,,,,2,1,2,3
40111_0,,,,2,1,2,3
40113_0,,,,2,1,2,3
[C](C(O)=O)=CC(C(O)=O)CO,,,5,1,2,0,2
40114_0,,,,2,1,2,3
40115_0,,,,2,1,2,3
40116_0,,,,2,1,2,3
40118_0,,,,2,1,2,3
C1(C(O)OC(C=CC)C1O)=O,,,5,1,2,0,2
40120_0,,,,2,1,2,3
C1(C(O)OC(C1O)CC=C)=O,,,5,1,2,0,2
40122_0,,,,2,1,2,3
C1(C(O)OC(C=CC)C1)=O,,,5,1,2,0,2
40124_0,,,,2,1,2,3
C1(C(O)OC(CC=C)C1)=O,,,5,1,2,0,2
40126_0,,,,2,1,2,3
C1C(CO)(OC(C=1C=O)C)O,,,5,1,1,0,1
40128_0,,,,2,1,2,3
C1(C(OCC=1C=O)O)C(C)O,,,5,1,1,0,1
40130_0,,,,2,1,2,3
C(C1(C(C(C)O)=COC1)O)=O,,,5,1,1,0,1
40132_0,,,,2,1,2,3
C(C1(C(C(O)OC1)=CC)O)=O,,,5,1,2,0,2
40134_0,,,,2,1,2,3
C(C1(COC(C1C=C)O)O)=O,,,5,1,2,0,2
40136_0,,,,2,1,2,3
C1(C(OC(C=1C=O)C)O)CO,,,5,1,1,0,1
40138_0,,,,2,1,2,3
C(C1C(C(O)OC1C)=C)=O,,,5,1,2,0,2
40140_0,,,,2,1,2,3
C1(C(OC(C=1C=O)C)O)C,,,5,1,1,0,1
40142_0,,,,2,1,2,3
C(C1C(C)OC(C1O)=C)=O,,,5,1,1,0,1
40144_0,,,,2,1,2,3
C1C(C)(OC(C=1C=O)C)O,,,5,1,1,0,1
40146_0,,,,2,1,2,3
C1(C(OCC=1C(O)=O)O)C(C)O,,,5,1,1,0,1
40148_0,,,,2,1,2,3
C(C1(C(C(C)O)=COC1)O)(O)=O,,,5,1,1,0,1
40150_0,,,,2,1,2,3
C(C1(C(C(O)OC1)=CC)O)(O)=O,,,5,1,2,0,2
40152_0,,,,2,1,2,3
C(C1(COC(C1C=C)O)O)(O)=O,,,5,1,2,0,2
40154_0,,,,2,1,2,3
C1(C(O)OC(C=1CO)=O)C(C)O,,,5,1,1,0,1
40156_0,,,,2,1,2,3
C1(C(C(C(C)O)=CO1)(CO)O)=O,,,5,1,1,0,1
40158_0,,,,2,1,2,3
C1(C(C(C(O)O1)=CC)(CO)O)=O,,,5,1,2,0,2
40160_0,,,,2,1,2,3
C1(C(CO)(C(C=C)C(O)O1)O)=O,,,5,1,2,0,2
40162_0,,,,2,1,2,3
C=C1C(OC(C1C(C)O)O)=O,,,5,1,2,0,2
40164_0,,,,2,1,2,3
C1(C(O)OC(C=1C)=O)C(C)O,,,5,1,1,0,1
40166_0,,,,2,1,2,3
C1(C(C(C(C)O)=CO1)(C)O)=O,,,5,1,1,0,1
40168_0,,,,2,1,2,3
C1(C(C(C(O)O1)=CC)(C)O)=O,,,5,1,2,0,2
40170_0,,,,2,1,2,3
C1(C(C)(C(C=C)C(O)O1)O)=O,,,5,1,2,0,2
40172_0,,,,2,1,2,3
C1(C(C=CO1)(CC(C)O)O)=O,,,5,1,1,0,1
40174_0,,,,2,1,2,3
C1C(O)OC(C=1CC(C)O)=O,,,5,1,1,0,1
40176_0,,,,2,1,2,3
C(C(C)O)=C1C(OC(C1)O)=O,,,5,1,2,0,2
40178_0,,,,2,1,2,3
C1(C(C=CC)(CC(O)O1)O)=O,,,5,1,2,0,2
40180_0,,,,2,1,2,3
C1(C(CC(O)O1)(CC=C)O)=O,,,5,1,2,0,2
40182_0,,,,2,1,2,3
C1C(CO)(O)OC(C=1C=O)=O,,,5,1,1,0,1
40184_0,,,,2,1,2,3
C(C1C(O)OCC=1C=O)(O)=O,,,5,1,1,0,1
40186_0,,,,2,1,2,3
C(C1(C(C(O)=O)=COC1)O)=O,,,5,1,1,0,1
40188_0,,,,2,1,2,3
C1(CO)C(O)OC(C=1C=O)=O,,,5,1,1,0,1
40190_0,,,,2,1,2,3
C1(C(C=O)C(C(O)O1)=C)=O,,,5,1,2,0,2
40192_0,,,,2,1,2,3
C1(C)C(O)OC(C=1C=O)=O,,,5,1,1,0,1
40194_0,,,,2,1,2,3
C1(C(C=O)C(C(O1)=C)O)=O,,,5,1,1,0,1
40196_0,,,,2,1,2,3
C1C(C)(O)OC(C=1C=O)=O,,,5,1,1,0,1
40198_0,,,,2,1,2,3
C(C1COC(C=1C(O)=O)O)(O)=O,,,5,1,1,0,1
40200_0,,,,2,1,2,3
C(C1(C(C(O)=O)=COC1)O)(O)=O,,,5,1,1,0,1
40202_0,,,,2,1,2,3
C1(C(CO)=C(C(O)=O)C(O)O1)=O,,,5,1,1,0,1
40204_0,,,,2,1,2,3
C1(C(C(C(O)=O)=CO1)(CO)O)=O,,,5,1,1,0,1
40206_0,,,,2,1,2,3
C(C1C(C(OC1O)=O)=C)(O)=O,,,5,1,2,0,2
40208_0,,,,2,1,2,3
C1(C(C)=C(C(O)=O)C(O)O1)=O,,,5,1,1,0,1
40210_0,,,,2,1,2,3
C1(C(C(C(O)=O)=CO1)(C)O)=O,,,5,1,1,0,1
40212_0,,,,2,1,2,3
C=C1C(OC(C1CO)O)=O,,,5,1,2,0,2
40214_0,,,,2,1,2,3
C1(C(C(C(O)O1)=C)(C)O)=O,,,5,1,3,0,3
40216_0,,,,2,1,2,3
C1(CO)C(O)OC(C=1C)=O,,,5,1,1,0,1
40218_0,,,,2,1,2,3
C1(C(C(CO)=CO1)(C)O)=O,,,5,1,1,0,1
40220_0,,,,2,1,2,3
C1(C(C=CO1)(CC(O)=O)O)=O,,,5,1,1,0,1
40222_0,,,,2,1,2,3
C(CC1C(OC(C=1)O)=O)(O)=O,,,5,1,1,0,1
40224_0,,,,2,1,2,3
C1(C(CC(O)O1)=CC(O)=O)=O,,,5,1,2,0,2
40226_0,,,,2,1,2,3
C=C1C(C(C(C(O)=O)=O)CO1)=O,,,5,1,1,0,1
40228_0,,,,2,1,2,3
C1(C(OCC1)=CC(C(O)=O)=O)=O,,,5,1,1,0,1
40230_0,,,,2,1,2,3
C(C1(C=C(C=O)OC1)O)=O,,,5,1,1,0,1
40232_0,,,,2,1,2,3
C(C1(C=C(C=O)CO1)O)=O,,,5,1,1,0,1
40234_0,,,,2,1,2,3
C(C1(C=COC1)O)=O,,,5,1,1,0,1
40236_0,,,,2,1,2,3
C1C(O)OCC=1C=O,,,5,1,1,0,1
40238_0,,,,2,1,2,3
C(C1(C=C(C(O)=O)OC1)O)=O,,,5,1,1,0,1
40240_0,,,,2,1,2,3
C(C1(C=C(C=O)CO1)O)(O)=O,,,5,1,1,0,1
40242_0,,,,2,1,2,3
C(C1(C(C(C(O1)=O)=C)O)O)=O,,,5,1,2,0,2
40244_0,,,,2,1,2,3
C(C1(C=C(C(O)=O)CO1)O)=O,,,5,1,1,0,1
40246_0,,,,2,1,2,3
C(C1(C=C(C=O)OC1)O)(O)=O,,,5,1,1,0,1
40248_0,,,,2,1,2,3
C(C1(C=C(C(O1)=O)CO)O)=O,,,5,1,1,0,1
40250_0,,,,2,1,2,3
C1(C(C=C(C=O)O1)(CO)O)=O,,,5,1,1,0,1
40252_0,,,,2,1,2,3
C(C1(CC(C(O1)=O)=C)O)=O,,,5,1,2,0,2
40254_0,,,,2,1,2,3
C(C1(C=C(C(O1)=O)C)O)=O,,,5,1,1,0,1
40256_0,,,,2,1,2,3
C1(C(C=C(C=O)O1)(C)O)=O,,,5,1,1,0,1
40258_0,,,,2,1,2,3
C=C1C(OC(C(O)=O)=C1CO)=O,,,5,1,1,0,1
40260_0,,,,2,1,2,3
C(C1(C(C(C(O1)=O)=C)=C)O)(O)=O,,,5,1,2,0,2
40262_0,,,,2,1,2,3
C1(C2(C(C(C(O2)=O)(O)O1)=C)C)=O,,,5,1,2,0,2
40264_0,,,,2,1,2,3
C(C1(C=COC1)O)(O)=O,,,5,1,1,0,1
40266_0,,,,2,1,2,3
C1C(O)OCC=1C(O)=O,,,5,1,1,0,1
40268_0,,,,2,1,2,3
C1(C(C=CO1)(CO)O)=O,,,5,1,1,0,1
40270_0,,,,2,1,2,3
C1C(O)OC(C=1CO)=O,,,5,1,1,0,1
40272_0,,,,2,1,2,3
C(C1(C=C(C(O)=O)OC1)O)(O)=O,,,5,1,1,0,1
40274_0,,,,2,1,2,3
C(C1(C=C(C(O)=O)CO1)O)(O)=O,,,5,1,1,0,1
40276_0,,,,2,1,2,3
C1(C(C=C(C(O)=O)O1)(CO)O)=O,,,5,1,1,0,1
40278_0,,,,2,1,2,3
C(C1(C=C(C(O1)=O)CO)O)(O)=O,,,5,1,1,0,1
40280_0,,,,2,1,2,3
C(C1(C(C(C(O1)=O)=C)O)O)(O)=O,,,5,1,2,0,2
40282_0,,,,2,1,2,3
C(C1(C(C(OC1)=C)=O)O)(O)=O,,,5,1,1,0,1
40284_0,,,,2,1,2,3
C1(C(C(C(O1)=C)=O)(CO)O)=O,,,5,1,1,0,1
40286_0,,,,2,1,2,3
C=C1C(OC(C1=O)(CO)O)=O,,,5,1,2,0,2
40288_0,,,,2,1,2,3
C1(C(C(C(O1)=C)=O)(C)O)=O,,,5,1,1,0,1
40290_0,,,,2,1,2,3
C=C1C(OC(C1=O)(C)O)=O,,,5,1,2,0,2
40292_0,,,,2,1,2,3
C(C1C(C(C(O1)=C)=O)O)(O)=O,,,5,1,1,0,1
40294_0,,,,2,1,2,3
C=C1C(C[C](C(O)=O)O1)=O,,,5,1,1,0,1
40296_0,,,,2,1,2,3
[C]1C(OC(C(C)=O)(C=1)O)=O,,,5,1,1,0,1
40298_0,,,,2,1,2,3
C1([C](C=C(C(C)=O)O1)O)=O,,,5,1,1,0,1
40300_0,,,,2,1,2,3
C(C1CC(C(O1)=C)=O)(O)=O,,,5,1,1,0,1
40302_0,,,,2,1,2,3
C(C)(C1(C=CC(O1)=O)O)=O,,,5,1,1,0,1
40304_0,,,,2,1,2,3
C1(C(C=C(C(C)=O)O1)O)=O,,,5,1,1,0,1
40306_0,,,,2,1,2,3
C(C1(C(C(O)OC1)=C)O)(O)=O,,,5,1,2,0,2
40308_0,,,,2,1,2,3
C1(C(C(C(O)O1)=C)(CO)O)=O,,,5,1,2,0,2
40310_0,,,,2,1,2,3
C(C1(COC(C1O)=C)O)(O)=O,,,5,1,1,0,1
40312_0,,,,2,1,2,3
C1(C(CO)(C(C(O1)=C)O)O)=O,,,5,1,1,0,1
40314_0,,,,2,1,2,3
C=C1C(OC(CO)(C1O)O)=O,,,5,1,2,0,2
40316_0,,,,2,1,2,3
C=C1C(OC(C1(CO)O)O)=O,,,5,1,2,0,2
40318_0,,,,2,1,2,3
C1(C(C(C(O)O1)=C)O)=O,,,5,1,2,0,2
40320_0,,,,2,1,2,3
C=C1C(OC(C1(C)O)O)=O,,,5,1,2,0,2
40321_0,,,,2,1,2,3
40323_0,,,,2,1,2,3
C1(C(C(C(O1)=C)O)O)=O,,,5,1,1,0,1
40325_0,,,,2,1,2,3
C=C1C(OC(C)(C1O)O)=O,,,5,1,2,0,2
40327_0,,,,2,1,2,3
C1(C(C)(C(C(O1)=C)O)O)=O,,,5,1,1,0,1
40329_0,,,,2,1,2,3
C(C1OC(C(C=1)=O)CO)(O)=O,,,5,1,1,0,1
40331_0,,,,2,1,2,3
C(C1C=C(C(O)=O)OC1)(O)=O,,,5,1,1,0,1
40333_0,,,,2,1,2,3
C1OC(C)CC(C=1C(C)O)O,,,5,1,1,0,1
40335_0,,,,2,1,2,3
C(C)=C1C(O)OC(C)CC1O,,,5,1,2,0,2
40337_0,,,,2,1,2,3
C1CC(C)OC(C=1C(C)O)O,,,5,1,1,0,1
40339_0,,,,2,1,2,3
C=CC1C(O)OC(C)CC1O,,,5,1,2,0,2
40341_0,,,,2,1,2,3
C1C(C(OC(C=1)C)O)C(C)O,,,5,1,1,0,1
40343_0,,,,2,1,2,3
C1OC(C)CC(C=1C(O)=O)O,,,5,1,1,0,1
40345_0,,,,2,1,2,3
C1CC(C)OC(C=1C(O)=O)O,,,5,1,1,0,1
40347_0,,,,2,1,2,3
C(C1C=CC(C)OC1O)(O)=O,,,5,1,1,0,1
40349_0,,,,2,1,2,3
C(C1(C(C=CC(C)O1)O)O)=O,,,5,1,1,0,1
40351_0,,,,2,1,2,3
C1C(CC(C)OC=1C=O)O,,,5,1,1,0,1
40353_0,,,,2,1,2,3
C(C1(C=CCC(C)O1)O)=O,,,5,1,1,0,1
40355_0,,,,2,1,2,3
C(C1(CC=CC(C)O1)O)=O,,,5,1,1,0,1
40357_0,,,,2,1,2,3
C(C1(C(C=CC(C)O1)O)O)(O)=O,,,5,1,1,0,1
40359_0,,,,2,1,2,3
C1OC(C)CC(C=1)O,,,5,1,1,0,1
40361_0,,,,2,1,2,3
C1CC(C)OC(C=1)O,,,5,1,1,0,1
40363_0,,,,2,1,2,3
C1CC(OC(C=1)C)O,,,5,1,1,0,1
40365_0,,,,2,1,2,3
C1C(CC(C)OC=1C(O)=O)O,,,5,1,1,0,1
40367_0,,,,2,1,2,3
C(C1(C=CCC(C)O1)O)(O)=O,,,5,1,1,0,1
40369_0,,,,2,1,2,3
C(C1(CC=CC(C)O1)O)(O)=O,,,5,1,1,0,1
40371_0,,,,2,1,2,3
C1C(C(O)OC(C=1)=O)C(C)O,,,5,1,1,0,1
40373_0,,,,2,1,2,3
C1(CC=C(C(O)O1)C(C)O)=O,,,5,1,1,0,1
40375_0,,,,2,1,2,3
C1(CC(C(C(C)O)=CO1)O)=O,,,5,1,1,0,1
40377_0,,,,2,1,2,3
C1(CC(C(C(O)O1)=CC)O)=O,,,5,1,2,0,2
40379_0,,,,2,1,2,3
C1(CC(C(C=C)C(O)O1)O)=O,,,5,1,2,0,2
40381_0,,,,2,1,2,3
C1(C(OCC(C=1)=O)O)C(C)O,,,5,1,1,0,1
40383_0,,,,2,1,2,3
C1(COC=C(C(C)O)C1O)=O,,,5,1,1,0,1
40385_0,,,,2,1,2,3
C1(COC(C(C1O)=CC)O)=O,,,5,1,2,0,2
40387_0,,,,2,1,2,3
C1(C(C(C=C)C(OC1)O)O)=O,,,5,1,2,0,2
40389_0,,,,2,1,2,3
C(C1(C=COC(C)C1)O)(O)=O,,,5,1,1,0,1
40391_0,,,,2,1,2,3
C1C(O)OC(C)CC=1C(O)=O,,,5,1,1,0,1
40393_0,,,,2,1,2,3
C1C(C)OC(CC=1C(O)=O)O,,,5,1,1,0,1
40395_0,,,,2,1,2,3
C1(CC(C(C(O)=O)=CO1)O)=O,,,5,1,1,0,1
40397_0,,,,2,1,2,3
C1(CC=C(C(O)=O)C(O)O1)=O,,,5,1,1,0,1
40399_0,,,,2,1,2,3
C(C1C=CC(OC1O)=O)(O)=O,,,5,1,1,0,1
40401_0,,,,2,1,2,3
C(C1(C(C=CC(O1)=O)O)O)=O,,,5,1,1,0,1
40403_0,,,,2,1,2,3
C1(CC(C=C(C=O)O1)O)=O,,,5,1,1,0,1
40405_0,,,,2,1,2,3
C1(CC=CC(C=O)(O)O1)=O,,,5,1,2,0,2
40407_0,,,,2,1,2,3
C(C1(CC=CC(O1)=O)O)=O,,,5,1,1,0,1
40409_0,,,,2,1,2,3
C(C1(C(C=CC(O1)=O)O)O)(O)=O,,,5,1,1,0,1
40411_0,,,,2,1,2,3
C1(CC(C=CO1)O)=O,,,5,1,1,0,1
40413_0,,,,2,1,2,3
C1(CC=CC(O)O1)=O,,,5,1,1,0,1
40415_0,,,,2,1,2,3
C1CC(O)OC(C=1)=O,,,5,1,1,0,1
40417_0,,,,2,1,2,3
C1(CC(C=C(C(O)=O)O1)O)=O,,,5,1,1,0,1
40419_0,,,,2,1,2,3
C1(CC=CC(C(O)=O)(O)O1)=O,,,5,1,2,0,2
40421_0,,,,2,1,2,3
C(C1(CC=CC(O1)=O)O)(O)=O,,,5,1,1,0,1
40423_0,,,,2,1,2,3
C(C1C(O)OCC(C=1)=O)(O)=O,,,5,1,1,0,1
40425_0,,,,2,1,2,3
C1(COC=C(C(O)=O)C1O)=O,,,5,1,1,0,1
40427_0,,,,2,1,2,3
C(C1(C)CC(C=CO1)O)(O)=O,,,5,1,1,0,1
40429_0,,,,2,1,2,3
C(C1(C)CC=CC(O1)O)(O)=O,,,5,1,1,0,1
40431_0,,,,2,1,2,3
C(C1(C=CCC(O1)O)C)(O)=O,,,5,1,1,0,1
40433_0,,,,2,1,2,3
C(C1(C=COC(C1)=O)O)(O)=O,,,5,1,1,0,1
40435_0,,,,2,1,2,3
C1(CC(C(O)=O)=CC(O)O1)=O,,,5,1,1,0,1
40437_0,,,,2,1,2,3
C1(C=C(C(O)=O)CC(O)O1)=O,,,5,1,1,0,1
40439_0,,,,2,1,2,3
C1(CC(C(OC1(C=C)O)=O)=O)=O,,,5,1,2,0,2
40441_0,,,,2,1,2,3
C(CO)=C1C(CC(C(O1)=O)=O)=O,,,5,1,1,0,1
40443_0,,,,2,1,2,3
C1(COC(C=O)=CC1O)=O,,,5,1,1,0,1
40445_0,,,,2,1,2,3
C(C1(C=CC(CO1)=O)O)=O,,,5,1,1,0,1
40447_0,,,,2,1,2,3
C1(COC=CC1O)=O,,,5,1,1,0,1
40449_0,,,,2,1,2,3
C1C(O)OCC(C=1)=O,,,5,1,1,0,1
40451_0,,,,2,1,2,3
C1C(CO)(O)OC(C(C=1)=O)=O,,,5,1,1,0,1
40453_0,,,,2,1,2,3
C1(COC(C(O)=O)=CC1O)=O,,,5,1,1,0,1
40455_0,,,,2,1,2,3
C(C1(C=CC(CO1)=O)O)(O)=O,,,5,1,1,0,1
40457_0,,,,2,1,2,3
C(C1COC(C(C=1)=O)O)=O,,,5,1,1,0,1
40459_0,,,,2,1,2,3
C1(CO)C(O)OC(C(C=1)=O)=O,,,5,1,1,0,1
40461_0,,,,2,1,2,3
C1(C(O)OC(C(C1O)=C)=O)=O,,,5,1,2,0,2
40463_0,,,,2,1,2,3
C=C1C(O)OC(C(C1O)=O)=O,,,5,1,2,0,2
40465_0,,,,2,1,2,3
C1(C)C(O)OC(C(C=1)=O)=O,,,5,1,1,0,1
40467_0,,,,2,1,2,3
C=C1C(O)OC(C(C1)=O)=O,,,5,1,2,0,2
40469_0,,,,2,1,2,3
C1C(C)(O)OC(C(C=1)=O)=O,,,5,1,1,0,1
40471_0,,,,2,1,2,3
C=C1C(CC(C(O1)=O)=O)O,,,5,1,1,0,1
40473_0,,,,2,1,2,3
C(C1COC(C(C=1)=O)O)(O)=O,,,5,1,1,0,1
40475_0,,,,2,1,2,3
C1(C(CO)=CC(C(O)O1)=O)=O,,,5,1,1,0,1
40477_0,,,,2,1,2,3
C1(C(O)OC(C(C1)=C)=O)=O,,,5,1,2,0,2
40479_0,,,,2,1,2,3
C1(C(C)=CC(C(O)O1)=O)=O,,,5,1,1,0,1
40481_0,,,,2,1,2,3
[C]1C(OC(C(C=1)=O)(C)O)=O,,,5,1,1,0,1
40483_0,,,,2,1,2,3
C=C1C(C[C](C(O1)=O)O)=O,,,5,1,1,0,1
40485_0,,,,2,1,2,3
C1(C=CC(C(C)(O)O1)=O)=O,,,5,1,1,0,1
40487_0,,,,2,1,2,3
C1(C(CC(C(O1)=C)=O)O)=O,,,5,1,1,0,1
40489_0,,,,2,1,2,3
C(C1OCC(C(C=1)=O)O)(O)=O,,,5,1,1,0,1
40491_0,,,,2,1,2,3
C1OC([CH]CC=1C(C)O)=O,,,5,1,1,0,1
40493_0,,,,2,1,2,3
C(C)=C1C(O)OC([CH]C1)=O,,,5,1,2,0,2
40495_0,,,,2,1,2,3
C(C1C(O)OC([CH]C1)=O)=C,,,5,1,2,0,2
40497_0,,,,2,1,2,3
C1(CCC(C(C)O)=CO1)=O,,,5,1,1,0,1
40499_0,,,,2,1,2,3
C1(CCC(C(O)O1)=CC)=O,,,5,1,2,0,2
40501_0,,,,2,1,2,3
C1(CCC(C=C)C(O)O1)=O,,,5,1,2,0,2
40503_0,,,,2,1,2,3
C1OC([CH]CC=1C(O)=O)=O,,,5,1,1,0,1
40505_0,,,,2,1,2,3
C1(CCC(C(O)=O)=CO1)=O,,,5,1,1,0,1
40507_0,,,,2,1,2,3
C(C1(C=C[CH]C(O1)=O)O)=O,,,5,1,1,0,1
40508_0,,,,2,1,2,3
40510_0,,,,2,1,2,3
C1C[CH]C(OC=1C=O)=O,,,5,1,1,0,1
40512_0,,,,2,1,2,3
C1(CCC=C(C=O)O1)=O,,,5,1,1,0,1
40514_0,,,,2,1,2,3
C(C1(C=C[CH]C(O1)=O)O)(O)=O,,,5,1,1,0,1
40516_0,,,,2,1,2,3
C1OC([CH]CC=1)=O,,,5,1,1,0,1
40518_0,,,,2,1,2,3
C1C[CH]C(OC=1C(O)=O)=O,,,5,1,1,0,1
40519_0,,,,2,1,2,3
40521_0,,,,2,1,2,3
C1(CCC=CO1)=O,,,5,1,1,0,1
40523_0,,,,2,1,2,3
C1(CCC=C(C(O)=O)O1)=O,,,5,1,1,0,1
40525_0,,,,2,1,2,3
C1(C(OC(C=CC1O)C)O)=O,,,5,1,1,0,1
40527_0,,,,2,1,2,3
C1CC(C)OC(C(C=1)=O)O,,,5,1,1,0,1
40529_0,,,,2,1,2,3
C1(C(OC(C=CC1)C)O)=O,,,5,1,1,0,1
40531_0,,,,2,1,2,3
C1(C(O)OC(C=CC1O)=O)=O,,,5,1,1,0,1
40533_0,,,,2,1,2,3
C1(CC=CC(C(O)O1)=O)=O,,,5,1,2,0,2
40535_0,,,,2,1,2,3
C1(C(O)OC(C=CC1)=O)=O,,,5,1,1,0,1
40537_0,,,,2,1,2,3
C1(C(C)(CC(C=CO1)O)O)=O,,,5,1,1,0,1
40539_0,,,,2,1,2,3
C1(C(C)(CC=CC(O)O1)O)=O,,,5,1,1,0,1
40541_0,,,,2,1,2,3
C=C1C(OC(CC(C1)O)O)=O,,,5,1,2,0,2
40543_0,,,,2,1,2,3
C1C(CC(O)OC(C=1C)=O)O,,,5,1,1,0,1
40545_0,,,,2,1,2,3
C1(C(C=CCC(O)O1)(C)O)=O,,,5,1,1,0,1
40547_0,,,,2,1,2,3
C1(C(C=C(C(O)=O)OCC1)=O)=O,,,5,1,1,0,1
40549_0,,,,2,1,2,3
C1(C=CC(C(O)OC1)=O)=O,,,5,1,1,0,1
40551_0,,,,2,1,2,3
C1(C)CC(O)OC([CH]C=1)=O,,,5,1,1,0,1
40553_0,,,,2,1,2,3
C1C(C)(C[CH]C(OC=1)=O)O,,,5,1,1,0,1
40555_0,,,,2,1,2,3
C1C(O)OC([CH]CC=1C)=O,,,5,1,1,0,1
40557_0,,,,2,1,2,3
C=C1CC(O)OC([CH]C1)=O,,,5,1,2,0,2
40559_0,,,,2,1,2,3
C1(CC=C(C)CC(O)O1)=O,,,5,1,1,0,1
40561_0,,,,2,1,2,3
C1(CCC(C=CO1)(C)O)=O,,,5,1,1,0,1
40563_0,,,,2,1,2,3
C1(CCC(C)=CC(O)O1)=O,,,5,1,1,0,1
40565_0,,,,2,1,2,3
C1(CCC(CC(O)O1)=C)=O,,,5,1,2,0,2
40567_0,,,,2,1,2,3
C1([CH]C=CC(C(O)O1)=O)=O,,,5,1,1,0,1
40568_0,,,,2,1,2,3
40570_0,,,,2,1,2,3
C(C=C[CH]C(O)=O)=O,,,5,1,5,0,5
40571_0,,,,2,1,2,3
40573_0,,,,2,1,2,3
C(C1C(C(C(O1)=O)=O)O)=CC,,,5,1,2,0,2
40575_0,,,,2,1,2,3
C(CC1C(C(C(O1)=O)=O)O)=C,,,5,1,2,0,2
40577_0,,,,2,1,2,3
C(C1CC(C(O1)=O)=O)=CC,,,5,1,2,0,2
40579_0,,,,2,1,2,3
C=CCC1CC(C(O1)=O)=O,,,5,1,2,0,2
40581_0,,,,2,1,2,3
C1(C(CO)=C(C=O)C(C)O1)=O,,,5,1,1,0,1
40583_0,,,,2,1,2,3
C(C1C(C(OC1C)=O)=C)=O,,,5,1,2,0,2
40585_0,,,,2,1,2,3
C(C1C(C)OC(C=1C)=O)=O,,,5,1,1,0,1
40587_0,,,,2,1,2,3
C(C)=C1C(C(OC1)=O)=O,,,5,1,2,0,2
40589_0,,,,2,1,2,3
C=CC1C(C(OC1)=O)=O,,,5,1,2,0,2
40591_0,,,,2,1,2,3
C1C(C(C=O)=O)OC(C=1)=O,,,5,1,1,0,1
40593_0,,,,2,1,2,3
C1C(C(C(O)=O)=O)OC(C=1)=O,,,5,1,1,0,1
40595_0,,,,2,1,2,3
C(C1C(OCC=1C=O)=O)=O,,,5,1,1,0,1
40597_0,,,,2,1,2,3
C1(C(C=O)=C(C(O1)=O)CO)=O,,,5,1,1,0,1
40599_0,,,,2,1,2,3
C1(C(C=O)=C(C(O)=O)CO1)=O,,,5,1,1,0,1
40601_0,,,,2,1,2,3
C(CC1CC(C(O1)=O)=C)=O,,,5,1,2,0,2
40603_0,,,,2,1,2,3
C(CC1C=C(C(O1)=O)C)=O,,,5,1,1,0,1
40605_0,,,,2,1,2,3
C(C1C(C(OC1)=O)=C)=O,,,5,1,3,0,3
40607_0,,,,2,1,2,3
C(C1COC(C=1C)=O)=O,,,5,1,1,0,1
40609_0,,,,2,1,2,3
C1(C(C(CO1)=C(C(O)=O)C)=O)=O,,,5,1,2,0,2
40610_0,,,,2,1,2,3
40612_0,,,,2,1,2,3
C1(C(C)=C(C(C(O)=O)=O)CO1)=O,,,5,1,1,0,1
40613_0,,,,2,1,2,3
40615_0,,,,2,1,2,3
C=C1C(OCC1)=O,,,5,1,2,0,2
40617_0,,,,2,1,2,3
C1COC(C=1C)=O,,,5,1,1,0,1
40619_0,,,,2,1,2,3
C1(CC(C(O1)=O)=C)=O,,,5,1,2,0,2
40621_0,,,,2,1,2,3
C1(C(C)=CC(O1)=O)=O,,,5,1,1,0,1
40623_0,,,,2,1,2,3
C(C1(C=CC(O1)=O)CO)(O)=O,,,5,1,1,0,1
40625_0,,,,2,1,2,3
C(C1C=CC(O1)=O)(O)=O,,,5,1,1,0,1
40626_0,,,,2,1,2,3
40628_0,,,,2,1,2,3
C(C1(C(C(OC1)=O)=C)O)=O,,,5,1,2,0,2
40630_0,,,,2,1,2,3
C=C1C(OCC1O)=O,,,5,1,3,0,3
40632_0,,,,2,1,2,3
[C]1C(OC(C=1)C)=O,,,5,1,1,0,1
40634_0,,,,2,1,2,3
[C]1C(OC(C=1)=O)=O,,,5,1,1,0,1
40636_0,,,,2,1,2,3
C1C(C)OC(C=1)=O,,,5,1,2,0,2
40638_0,,,,2,1,2,3
C1(C=CC(O1)=O)=O,,,5,1,1,0,1
40640_0,,,,2,1,2,3
C1CC(C)OC(C=1C=O)=O,,,5,1,1,0,1
40642_0,,,,2,1,2,3
C(C1C(OC(C=C1)C)=O)=O,,,5,1,1,0,1
40644_0,,,,2,1,2,3
C(C1C=CC(OC1C)=O)=O,,,5,1,1,0,1
40646_0,,,,2,1,2,3
C1(CC=C(C=O)C(C)O1)=O,,,5,1,1,0,1
40648_0,,,,2,1,2,3
C1(CC=C(C=O)C(O1)=O)=O,,,5,1,1,0,1
40650_0,,,,2,1,2,3
C(C1C(OC(C=C1)=O)=O)=O,,,5,1,1,0,1
40652_0,,,,2,1,2,3
C(C1C(OCC(C=1)=O)=O)=O,,,5,1,1,0,1
40654_0,,,,2,1,2,3
C(C1COC(C(C=1)=O)=O)=O,,,5,1,1,0,1
40656_0,,,,2,1,2,3
C1(C(C=C(C(O)=O)CO1)=O)=O,,,5,1,1,0,1
40658_0,,,,2,1,2,3
C1(C(CO)=CC(C(O1)=O)=O)=O,,,5,1,2,0,2
40660_0,,,,2,1,2,3
C=C1C(OC(C(C1O)=O)=O)=O,,,5,1,2,0,2
40662_0,,,,2,1,2,3
C1(C(C=CC(C)O1)(CO)O)=O,,,5,1,1,0,1
40664_0,,,,2,1,2,3
C1(C(C=CC(O1)=O)(CO)O)=O,,,5,1,1,0,1
40666_0,,,,2,1,2,3
C(C1(C=CC(OC1)=O)O)(O)=O,,,5,1,1,0,1
40668_0,,,,2,1,2,3
C1(C(C=CC(C)O1)O)=O,,,5,1,1,0,1
40670_0,,,,2,1,2,3
C=C1C(OC(C)CC1O)=O,,,5,1,2,0,2
40672_0,,,,2,1,2,3
C1(C(C=CC(C)O1)(C)O)=O,,,5,1,1,0,1
40674_0,,,,2,1,2,3
C1(C(C=CC(O1)=O)O)=O,,,5,1,1,0,1
40676_0,,,,2,1,2,3
C1(CC(C(C(O1)=O)=C)O)=O,,,5,1,2,0,2
40677_0,,,,2,1,2,3
40679_0,,,,2,1,2,3
C1(COC(C(C1O)=C)=O)=O,,,5,1,2,0,2
40681_0,,,,2,1,2,3
C1([CH]C=CC(O1)=O)=O,,,5,1,1,0,1
40683_0,,,,2,1,2,3
C1(CC=CC(O1)=O)=O,,,5,1,1,0,1
40685_0,,,,2,1,2,3
C1COC([CH]C=1)=O,,,5,1,1,0,1
40687_0,,,,2,1,2,3
C(C1C=C[CH]C(O1)=O)(O)=O,,,5,1,1,0,1
40689_0,,,,2,1,2,3
C1(C(CO)=C[CH]C(O1)=O)=O,,,5,1,1,0,1
40691_0,,,,2,1,2,3
C1([CH]C=C(C(O)=O)CO1)=O,,,5,1,1,0,1
40693_0,,,,2,1,2,3
C=C1C(OC([CH]C1)=O)=O,,,5,1,2,0,2
40695_0,,,,2,1,2,3
C1(C(C)=C[CH]C(O1)=O)=O,,,5,1,1,0,1
40697_0,,,,2,1,2,3
C1(CC=CCO1)=O,,,5,1,1,0,1
40699_0,,,,2,1,2,3
C1(CC=CC(C(O)=O)O1)=O,,,5,1,1,0,1
40701_0,,,,2,1,2,3
C1(CC=C(C(O1)=O)CO)=O,,,5,1,1,0,1
40703_0,,,,2,1,2,3
C1(CC=C(C(O)=O)CO1)=O,,,5,1,1,0,1
40705_0,,,,2,1,2,3
C1(CCC(C(O1)=O)=C)=O,,,5,1,2,0,2
40707_0,,,,2,1,2,3
C1(CC=C(C(O1)=O)C)=O,,,5,1,1,0,1
40709_0,,,,2,1,2,3
C1C(C(C(OC(C=1)C)=O)=O)O,,,5,1,1,0,1
40711_0,,,,2,1,2,3
C1CC(C)OC(C(C=1)=O)=O,,,5,1,1,0,1
40713_0,,,,2,1,2,3
C1CC(C(OC(C=1)C)=O)=O,,,5,1,1,0,1
40715_0,,,,2,1,2,3
C1C(C(C(OC(C=1)=O)=O)=O)O,,,5,1,1,0,1
40717_0,,,,2,1,2,3
C1(CC=CC(C(O1)=O)=O)=O,,,5,1,2,0,2
40719_0,,,,2,1,2,3
C1CC(C(OC(C=1)=O)=O)=O,,,5,1,1,0,1
40721_0,,,,2,1,2,3
C1(C(C=CC(CO1)=O)=O)=O,,,5,1,1,0,1
40723_0,,,,2,1,2,3
C1([CH]C=CC(C(O1)=O)=O)=O,,,5,1,1,0,1
40725_0,,,,2,1,2,3
C1(C(C=C[CH]C(O1)=O)O)=O,,,5,1,1,0,1
40727_0,,,,2,1,2,3
[C]1C(OC([CH]CC=1)=O)=O,,,5,1,1,0,1
40729_0,,,,2,1,2,3
C1C[CH]C(OC(C=1)=O)=O,,,5,1,1,0,1
40730_0,,,,2,1,2,3
40732_0,,,,2,1,2,3
C1(CC=CC(C(O1)=O)O)=O,,,5,1,1,0,1
40734_0,,,,2,1,2,3
[C]1C(OC(CCC=1)=O)=O,,,5,1,1,0,1
40736_0,,,,2,1,2,3
C1(CCC=CC(O1)=O)=O,,,5,1,1,0,1
40738_0,,,,2,1,2,3
C(C(C=C(C)CC=O)C(C)O)=O,,,5,1,1,0,1
40740_0,,,,2,1,2,3
C(CC(C=C(C=O)C(C)O)C)=O,,,5,1,1,0,1
40742_0,,,,2,1,2,3
C(CC(C)C(C(C=O)=CC)O)=O,,,5,1,2,0,2
40744_0,,,,2,1,2,3
C(C(C=C)C(C(C)CC=O)O)=O,,,5,1,2,0,2
40746_0,,,,2,1,2,3
C(C(C=C[CH]C(O)=O)C(C)O)=O,,,5,1,1,0,1
40748_0,,,,2,1,2,3
C(C[CH]C(O)=O)=C(C=O)C(C)O,,,5,1,1,0,1
40750_0,,,,2,1,2,3
C(C)=C(C=O)C(C[CH]C(O)=O)O,,,5,1,2,0,2
40751_0,,,,2,1,2,3
40753_0,,,,2,1,2,3
C(C(C=CCC(O)=O)C(C)O)=O,,,5,1,1,0,1
40755_0,,,,2,1,2,3
C(CCC=C(C=O)C(C)O)(O)=O,,,5,1,1,0,1
40757_0,,,,2,1,2,3
C(CCC(C(C=O)=CC)O)(O)=O,,,5,1,2,0,2
40758_0,,,,2,1,2,3
40760_0,,,,2,1,2,3
C(C(C=C)(CO)C(C)CC=O)=O,,,5,1,2,0,2
40762_0,,,,2,1,2,3
C(CC(C)CC(C(C=O)=C)O)=O,,,5,1,2,0,2
40764_0,,,,2,1,2,3
C(CC(C)CC=C(C=O)CO)=O,,,5,1,2,0,2
40766_0,,,,2,1,2,3
C(C(C=CC(C)CC=O)CO)=O,,,5,1,1,0,1
40768_0,,,,2,1,2,3
C(C(C(C)=C(C)CC=O)CO)=O,,,5,1,1,0,1
40770_0,,,,2,1,2,3
C(CC(C)C(C(C=O)=C)(C)O)=O,,,5,1,2,0,2
40772_0,,,,2,1,2,3
C(CC(C(C)=C(C=O)CO)C)=O,,,5,1,1,0,1
40774_0,,,,2,1,2,3
C(C(C(C(C)CC=O)=C)CO)=O,,,5,1,1,0,1
40776_0,,,,2,1,2,3
C(C(C(O)=O)C=C(C)CC=O)=O,,,5,1,1,0,1
40778_0,,,,2,1,2,3
C(CC(C=C(C=O)C(O)=O)C)=O,,,5,1,2,0,2
40780_0,,,,2,1,2,3
C(C(C(O)=O)C=C[CH]C(O)=O)=O,,,5,1,1,0,1
40782_0,,,,2,1,2,3
C(C[CH]C(O)=O)=C(C=O)C(O)=O,,,5,1,2,0,2
40784_0,,,,2,1,2,3
C(C(C(O)=O)C=CCC(O)=O)=O,,,5,1,1,0,1
40786_0,,,,2,1,2,3
C(CCC=C(C=O)C(O)=O)(O)=O,,,5,1,2,0,2
40788_0,,,,2,1,2,3
C(CC(C)=CC(C(C=O)=O)O)=O,,,5,1,1,0,1
40790_0,,,,2,1,2,3
C(C(C(C=O)=O)O)=C[CH]C(O)=O,,,5,1,1,0,1
40792_0,,,,2,1,2,3
C(CC=CC(C(C=O)=O)O)(O)=O,,,5,1,1,0,1
40794_0,,,,2,1,2,3
C(CC(C)=C(C(C=O)=O)CO)=O,,,5,1,1,0,1
40796_0,,,,2,1,2,3
C(CC(C(C=O)=C(C=O)C)C)=O,,,5,1,1,0,1
40798_0,,,,2,1,2,3
C(C(C(C=O)=C)C(C)CC=O)=O,,,5,1,2,0,2
40800_0,,,,2,1,2,3
C(CC(C)CC(C=O)=CC=O)=O,,,5,1,2,0,2
40802_0,,,,2,1,2,3
C(CC(C=O)=CC(C)CC=O)=O,,,5,1,1,0,1
40804_0,,,,2,1,2,3
C(CC(C(C=O)=CC(C)=O)C)=O,,,5,1,1,0,1
40806_0,,,,2,1,2,3
C(CC(C)CC(C=CC=O)=O)=O,,,5,1,2,0,2
40808_0,,,,2,1,2,3
C(CC(C)=C(C(C)=O)CC=O)=O,,,5,1,1,0,1
40810_0,,,,2,1,2,3
C(CC(C(C(C)=O)=CC=O)C)=O,,,5,1,1,0,1
40812_0,,,,2,1,2,3
C(CC(C(C)=O)=C[CH]C(O)=O)=O,,,5,1,1,0,1
40814_0,,,,2,1,2,3
[CH](C(O)=O)CC(C(C)=O)=CC=O,,,5,1,1,0,1
40816_0,,,,2,1,2,3
C(CC(C(C)=O)=CCC(O)=O)=O,,,5,1,1,0,1
40818_0,,,,2,1,2,3
C(CCC(C(C)=O)=CC=O)(O)=O,,,5,1,1,0,1
40820_0,,,,2,1,2,3
C(CC(C)=CCC(C=O)=O)=O,,,5,1,1,0,1
40822_0,,,,2,1,2,3
C(CC(C=CC(C=O)=O)C)=O,,,5,1,1,0,1
40824_0,,,,2,1,2,3
C(CC(C=O)=O)=C[CH]C(O)=O,,,5,1,1,0,1
40826_0,,,,2,1,2,3
C(C[CH]C(O)=O)=CC(C=O)=O,,,5,1,1,0,1
40828_0,,,,2,1,2,3
C(CC=CCC(C=O)=O)(O)=O,,,5,1,1,0,1
40830_0,,,,2,1,2,3
C(CCC=CC(C=O)=O)(O)=O,,,5,1,1,0,1
40832_0,,,,2,1,2,3
C(CC(C(C(C=O)=O)=C)C)=O,,,5,1,1,0,1
40834_0,,,,2,1,2,3
C(CC(C=CCC(C=O)=O)C)=O,,,5,1,1,0,1
40836_0,,,,2,1,2,3
C(CC(C)CC=CC(C=O)=O)=O,,,5,1,2,0,2
40838_0,,,,2,1,2,3
C(CC(C)=C(C)CC(C=O)=O)=O,,,5,1,1,0,1
40840_0,,,,2,1,2,3
C(CC(C(CC(C=O)=O)=C)C)=O,,,5,1,1,0,1
40842_0,,,,2,1,2,3
C(CC(C(C)=CC(C=O)=O)C)=O,,,5,1,1,0,1
40844_0,,,,2,1,2,3
C(C)(CC(C=O)=O)=C[CH]C(O)=O,,,5,1,1,0,1
40846_0,,,,2,1,2,3
C=C(CC(C=O)=O)C[CH]C(O)=O,,,5,1,1,0,1
40848_0,,,,2,1,2,3
C(C)(C[CH]C(O)=O)=CC(C=O)=O,,,5,1,1,0,1
40850_0,,,,2,1,2,3
C(CC=C(C)CC(C=O)=O)(O)=O,,,5,1,1,0,1
40852_0,,,,2,1,2,3
C(CCC(CC(C=O)=O)=C)(O)=O,,,5,1,1,0,1
40854_0,,,,2,1,2,3
C(CCC(C)=CC(C=O)=O)(O)=O,,,5,1,1,0,1
40856_0,,,,2,1,2,3
C(CC(C)C(C=C)C(C=O)=O)=O,,,5,1,2,0,2
40858_0,,,,2,1,2,3
C(CC(C(C(C=O)=O)=CC)C)=O,,,5,1,1,0,1
40860_0,,,,2,1,2,3
C(CC(C(C=O)=C)C)=O,,,5,1,4,0,4
40862_0,,,,2,1,2,3
C=C(C=O)C(C)CC(C(O)=O)=O,,,5,1,2,0,2
40864_0,,,,2,1,2,3
C(CC(C(O)=O)CC(C=O)=C)=O,,,5,1,2,0,2
40866_0,,,,2,1,2,3
C(CC(C(O)=O)(C(C=O)=C)C)=O,,,5,1,2,0,2
40868_0,,,,2,1,2,3
C(C(C(C=O)=C)C(C(O)=O)C)=O,,,5,1,2,0,2
40870_0,,,,2,1,2,3
C(C(C=C)CC(C=O)CO)(O)=O,,,5,1,2,0,2
40872_0,,,,2,1,2,3
C(C(CO)CC(C(O)=O)=CC)=O,,,5,1,1,0,1
40874_0,,,,2,1,2,3
C(C(C(C)O)CC(C=O)=C)(O)=O,,,5,1,2,0,2
40876_0,,,,2,1,2,3
C(C(C(O)=O)CC(C=O)=C)(O)=O,,,5,1,2,0,2
40878_0,,,,2,1,2,3
C(CC=C(C)CC=O)=O,,,5,1,1,0,1
40880_0,,,,2,1,2,3
C(CC(C=CC=O)C)=O,,,5,1,4,0,4
40882_0,,,,2,1,2,3
C(CC=C(C)CC(C(O)=O)=O)=O,,,5,1,1,0,1
40884_0,,,,2,1,2,3
C(C(C)CC(C(O)=O)=O)=CC=O,,,5,1,2,0,2
40886_0,,,,2,1,2,3
C(CC=CC(C(O)=O)CC=O)=O,,,5,1,1,0,1
40888_0,,,,2,1,2,3
C(CC(C(O)=O)CC=CC=O)=O,,,5,1,2,0,2
40890_0,,,,2,1,2,3
C(CC(C(O)=O)(C=CC=O)C)=O,,,5,1,2,0,2
40892_0,,,,2,1,2,3
C(CC=C(C=O)C(C(O)=O)C)=O,,,5,1,1,0,1
40894_0,,,,2,1,2,3
C(C(C=CC=O)C(C(O)=O)C)=O,,,5,1,2,0,2
40896_0,,,,2,1,2,3
C(C(C=CCC=O)C(C)O)(O)=O,,,5,1,1,0,1
40898_0,,,,2,1,2,3
C(C(C=C)CC(CC=O)O)(O)=O,,,5,1,2,0,2
40900_0,,,,2,1,2,3
C(C(C(C)O)CC=CC=O)(O)=O,,,5,1,2,0,2
40902_0,,,,2,1,2,3
C(CC(CC(C(O)=O)=CC)O)=O,,,5,1,1,0,1
40904_0,,,,2,1,2,3
C(C(C(O)=O)C=CCC=O)(O)=O,,,5,1,1,0,1
40906_0,,,,2,1,2,3
C(C(C(O)=O)CC=CC=O)(O)=O,,,5,1,2,0,2
40908_0,,,,2,1,2,3
C(CC=C[CH]C(O)=O)=O,,,5,1,1,0,1
40910_0,,,,2,1,2,3
C(C[CH]C(O)=O)=CC=O,,,5,1,4,0,4
40912_0,,,,2,1,2,3
C(CC=CCC(O)=O)=O,,,5,1,1,0,1
40914_0,,,,2,1,2,3
C(CCC=CC=O)(O)=O,,,5,1,4,0,4
40916_0,,,,2,1,2,3
C(CC(C(C(C(O)=O)=O)=C)C)=O,,,5,1,1,0,1
40918_0,,,,2,1,2,3
C(CC(C)=CCC(C(O)=O)=O)=O,,,5,1,1,0,1
40920_0,,,,2,1,2,3
C(CC(C=CC(C(O)=O)=O)C)=O,,,5,1,1,0,1
40922_0,,,,2,1,2,3
C(CC(C(O)=O)=O)=C[CH]C(O)=O,,,5,1,1,0,1
40924_0,,,,2,1,2,3
C(C[CH]C(O)=O)=CC(C(O)=O)=O,,,5,1,1,0,1
40926_0,,,,2,1,2,3
C(CC=CCC(C(O)=O)=O)(O)=O,,,5,1,1,0,1
40928_0,,,,2,1,2,3
C(CCC=CC(C(O)=O)=O)(O)=O,,,5,1,1,0,1
40929_0,,,,2,1,2,3
40930_0,,,,2,1,2,3
40931_0,,,,2,1,2,3
40933_0,,,,2,1,2,3
C(CC(C=CC(C(C)=O)=O)C)=O,,,5,1,1,0,1
40935_0,,,,2,1,2,3
C(C[CH]C(O)=O)=CC(C(C)=O)=O,,,5,1,1,0,1
40937_0,,,,2,1,2,3
C(CCC=CC(C(C)=O)=O)(O)=O,,,5,1,1,0,1
40939_0,,,,2,1,2,3
C(CC(C)=C(C(C(C)=O)=O)C)=O,,,5,1,1,0,1
40941_0,,,,2,1,2,3
C(CC(C(C(C(C)=O)=O)=C)C)=O,,,5,1,1,0,1
40943_0,,,,2,1,2,3
C([CH]C=C(C(C(C)=O)=O)C)(O)=O,,,5,1,1,0,1
40945_0,,,,2,1,2,3
C=C(C(C(C)=O)=O)C[CH]C(O)=O,,,5,1,1,0,1
40947_0,,,,2,1,2,3
C(CC=C(C(C(C)=O)=O)C)(O)=O,,,5,1,1,0,1
40949_0,,,,2,1,2,3
C(CCC(C(C(C)=O)=O)=C)(O)=O,,,5,1,1,0,1
40951_0,,,,2,1,2,3
C(CC(C)=C(C=O)C=O)=O,,,5,1,1,0,1
40953_0,,,,2,1,2,3
C(C(C=O)=C[CH]C(O)=O)=O,,,5,1,1,0,1
40955_0,,,,2,1,2,3
C(CC=C(C=O)C=O)(O)=O,,,5,1,1,0,1
40957_0,,,,2,1,2,3
C(CC(C)=C(C=O)C(O)=O)=O,,,5,1,1,0,1
40959_0,,,,2,1,2,3
C(C(C(O)=O)=C[CH]C(O)=O)=O,,,5,1,1,0,1
40960_0,,,,2,1,2,3
40962_0,,,,2,1,2,3
C(CC(C(C(C)O)=C)C)=O,,,5,1,1,0,1
40964_0,,,,2,1,2,3
C(CC(C(CO)=CC)C)=O,,,5,1,1,0,1
40965_0,,,,2,1,2,3
40967_0,,,,2,1,2,3
C(CC(C)=CCC(C)O)=O,,,5,1,1,0,1
40969_0,,,,2,1,2,3
C(CC(C=CC(C)O)C)=O,,,5,1,1,0,1
40971_0,,,,2,1,2,3
C(CC(C)C(C=CC)O)=O,,,5,1,2,0,2
40973_0,,,,2,1,2,3
C(CC(C)C(CC=C)O)=O,,,5,1,2,0,2
40975_0,,,,2,1,2,3
C(CC(C)O)=C[CH]C(O)=O,,,5,1,1,0,1
40977_0,,,,2,1,2,3
C(C[CH]C(O)=O)=CC(C)O,,,5,1,1,0,1
40979_0,,,,2,1,2,3
C(C(C[CH]C(O)=O)O)=CC,,,5,1,2,0,2
40981_0,,,,2,1,2,3
C=CCC(C[CH]C(O)=O)O,,,5,1,2,0,2
40983_0,,,,2,1,2,3
C(CC=CCC(C)O)(O)=O,,,5,1,1,0,1
40985_0,,,,2,1,2,3
C(CCC=CC(C)O)(O)=O,,,5,1,1,0,1
40987_0,,,,2,1,2,3
C(CCC(C=CC)O)(O)=O,,,5,1,2,0,2
40989_0,,,,2,1,2,3
C(CCC(CC=C)O)(O)=O,,,5,1,2,0,2
40991_0,,,,2,1,2,3
C(CC(C)CC(C=C)O)=O,,,5,1,3,0,3
40992_0,,,,2,1,2,3
40994_0,,,,2,1,2,3
C(CC(C=CCCO)C)=O,,,5,1,1,0,1
40996_0,,,,2,1,2,3
C(CC(C)=C(C)CCO)=O,,,5,1,1,0,1
40998_0,,,,2,1,2,3
C(CC(C)C(C=C)(C)O)=O,,,5,1,2,0,2
41000_0,,,,2,1,2,3
C(CC(C(C)=CCO)C)=O,,,5,1,1,0,1
41002_0,,,,2,1,2,3
C(CC(C(CCO)=C)C)=O,,,5,1,1,0,1
41004_0,,,,2,1,2,3
C(CC(C(C(O)=O)=C)C)=O,,,5,1,3,0,3
41005_0,,,,2,1,2,3
41007_0,,,,2,1,2,3
C(CC(C=CC(O)=O)C)=O,,,5,1,3,0,3
41009_0,,,,2,1,2,3
C(CC=C[CH]C(O)=O)(O)=O,,,5,1,2,0,2
41010_0,,,,2,1,2,3
41012_0,,,,2,1,2,3
C(CC=CCC(O)=O)(O)=O,,,5,1,1,0,1
41013_0,,,,2,1,2,3
41015_0,,,,2,1,2,3
C(CC(C)=CC(CO)=O)=O,,,5,1,1,0,1
41017_0,,,,2,1,2,3
C(C(C=C)CCC(CO)=O)(O)=O,,,5,1,2,0,2
41019_0,,,,2,1,2,3
C(CO)(CCC(C(O)=O)=CC)=O,,,5,1,1,0,1
41021_0,,,,2,1,2,3
C(CC(C)=CC(C)=O)=O,,,5,1,1,0,1
41023_0,,,,2,1,2,3
C(C)(CC(C(O)=O)=O)=CC(C)=O,,,5,1,1,0,1
41025_0,,,,2,1,2,3
C(C(C=CC(C)=O)CC=O)(O)=O,,,5,1,1,0,1
41027_0,,,,2,1,2,3
C(C(C(C=O)=CC(C)=O)C)(O)=O,,,5,1,1,0,1
41029_0,,,,2,1,2,3
C(C(C=CC(C)=O)C(C)O)(O)=O,,,5,1,1,0,1
41031_0,,,,2,1,2,3
C(C(C=C)CC(C(C)=O)O)(O)=O,,,5,1,2,0,2
41033_0,,,,2,1,2,3
C(C)(C(CC(C(O)=O)=CC)O)=O,,,5,1,1,0,1
41035_0,,,,2,1,2,3
C(C(C(O)=O)C=CC(C)=O)(O)=O,,,5,1,1,0,1
41037_0,,,,2,1,2,3
C([CH]C=CC(C)=O)(O)=O,,,5,1,1,0,1
41039_0,,,,2,1,2,3
C(CC=CC(C)=O)(O)=O,,,5,1,1,0,1
41041_0,,,,2,1,2,3
C(CC(C)=C)=O,,,5,1,1,0,1
41043_0,,,,2,1,2,3
C=C(C)CC(C(O)=O)=O,,,5,1,1,0,1
41045_0,,,,2,1,2,3
C(C(C=C)CC=O)(O)=O,,,5,1,1,0,1
41047_0,,,,2,1,2,3
C(C(C(C=O)=C)C)(O)=O,,,5,1,3,0,3
41048_0,,,,2,1,2,3
41050_0,,,,2,1,2,3
C(C(C=C)CCO)(O)=O,,,5,1,2,0,2
41052_0,,,,2,1,2,3
C(C)=C(C(O)=O)CCO,,,5,1,1,0,1
41053_0,,,,2,1,2,3
41054_0,,,,2,1,2,3
41056_0,,,,2,1,2,3
C(C(C(C(O)=O)=C)CCO)(O)=O,,,5,1,2,0,2
41058_0,,,,2,1,2,3
C(C(CCO)=C(C(O)=O)C)(O)=O,,,5,1,1,0,1
41060_0,,,,2,1,2,3
C1(C(C(CO)=C(C(O)=O)O1)C)=O,,,5,1,1,0,1
41062_0,,,,2,1,2,3
C1(C(C(C(C(O)=O)(O)O1)=C)C)=O,,,5,1,1,0,1
41064_0,,,,2,1,2,3
C1(C(C=C(C(O)=O)O1)CCO)=O,,,5,1,2,0,2
41066_0,,,,2,1,2,3
C1(C(C=C)CC(C(O)=O)(O)O1)=O,,,5,1,1,0,1
41068_0,,,,2,1,2,3
C1(C(C(C(C(O1)=O)=O)=C)C)=O,,,5,1,2,0,2
41070_0,,,,2,1,2,3
C1(C(C=C)CC(C(O1)=O)=O)=O,,,5,1,1,0,1
41072_0,,,,2,1,2,3
C([CH]C(CO)=C(C(O)=O)C)(O)=O,,,5,1,1,0,1
41074_0,,,,2,1,2,3
C(C(C([CH]C(O)=O)=C)(C)O)(O)=O,,,5,1,1,0,1
41076_0,,,,2,1,2,3
C=C(C(O)=O)C([CH]C(O)=O)CO,,,5,1,2,0,2
41078_0,,,,2,1,2,3
[C](C(O)=O)=C(CO)C(C(O)=O)C,,,5,1,1,0,1
41080_0,,,,2,1,2,3
C(C(C([C](C(O)=O)O)=C)C)(O)=O,,,5,1,1,0,1
41082_0,,,,2,1,2,3
[C](C(O)=O)=CC(C(O)=O)CCO,,,5,1,2,0,2
41084_0,,,,2,1,2,3
C(C(C=C)C[C](C(O)=O)O)(O)=O,,,5,1,2,0,2
41086_0,,,,2,1,2,3
C(CC(CO)=C(C(O)=O)C)(O)=O,,,5,1,1,0,1
41088_0,,,,2,1,2,3
C(C(C(CC(O)=O)=C)(C)O)(O)=O,,,5,1,1,0,1
41090_0,,,,2,1,2,3
C(CC(C(C(O)=O)=C)CO)(O)=O,,,5,1,2,0,2
41092_0,,,,2,1,2,3
C(C(C(CO)=CC(O)=O)C)(O)=O,,,5,1,1,0,1
41093_0,,,,2,1,2,3
41095_0,,,,2,1,2,3
C(C(C=CC(O)=O)CCO)(O)=O,,,5,1,2,0,2
41097_0,,,,2,1,2,3
C(C(C=C)CC(C(O)=O)O)(O)=O,,,5,1,3,0,3
41099_0,,,,2,1,2,3
C(C(C(C(C(O)=O)=O)=C)C)(O)=O,,,5,1,1,0,1
41101_0,,,,2,1,2,3
C(C(C=C)CC(C(O)=O)=O)(O)=O,,,5,1,1,0,1
41103_0,,,,2,1,2,3
C=C[CH]C(O)=O,,,5,1,2,0,2
41104_0,,,,2,1,2,3
41106_0,,,,2,1,2,3
C(CC(C=C)C)=O,,,5,1,2,0,2
41108_0,,,,2,1,2,3
C(C(C)CC(C(O)=O)=O)=C,,,5,1,2,0,2
41110_0,,,,2,1,2,3
C(CC(C(O)=O)CC=C)=O,,,5,1,2,0,2
41112_0,,,,2,1,2,3
C(CC(C(O)=O)(C=C)C)=O,,,5,1,2,0,2
41114_0,,,,2,1,2,3
C(C(C=C)C(C(O)=O)C)=O,,,5,1,2,0,2
41116_0,,,,2,1,2,3
C(C(C=C)CCCO)(O)=O,,,5,1,2,0,2
41118_0,,,,2,1,2,3
C(C)=C(C(O)=O)CCCO,,,5,1,1,0,1
41120_0,,,,2,1,2,3
C(C(C(C)O)CC=C)(O)=O,,,5,1,2,0,2
41122_0,,,,2,1,2,3
C(C(C(O)=O)CC=C)(O)=O,,,5,1,2,0,2
41124_0,,,,2,1,2,3
C1(C(C)C(C=C)C(C(O1)=O)=O)=O,,,5,1,2,0,2
41126_0,,,,2,1,2,3
C1(C(C=C)(C)CC(C(O1)=O)=O)=O,,,5,1,2,0,2
41128_0,,,,2,1,2,3
C1(C(CC(C(O1)=O)=O)CC=C)=O,,,5,1,2,0,2
41130_0,,,,2,1,2,3
C(CC(C)=CC)=O,,,5,1,1,0,1
41131_0,,,,2,1,2,3
41133_0,,,,2,1,2,3
C(C)=C(C)CC(C(O)=O)=O,,,5,1,1,0,1
41134_0,,,,2,1,2,3
41136_0,,,,2,1,2,3
C(C(C=CC)CC=O)(O)=O,,,5,1,1,0,1
41137_0,,,,2,1,2,3
41138_0,,,,2,1,2,3
41140_0,,,,2,1,2,3
C(C(C(C=O)=CC)C)(O)=O,,,5,1,1,0,1
41141_0,,,,2,1,2,3
41143_0,,,,2,1,2,3
C(C(C=CC)C(C)O)(O)=O,,,5,1,1,0,1
41145_0,,,,2,1,2,3
C(C(C=C)CC(C)O)(O)=O,,,5,1,2,0,2
41146_0,,,,2,1,2,3
41148_0,,,,2,1,2,3
C(C)=C(C(O)=O)CC(C)O,,,5,1,1,0,1
41150_0,,,,2,1,2,3
C(C(C(O)=O)C=CC)(O)=O,,,5,1,1,0,1
41151_0,,,,2,1,2,3
41153_0,,,,2,1,2,3
C1(C(C(C(C(O1)=O)=O)=CC)C)=O,,,5,1,1,0,1
41154_0,,,,2,1,2,3
41155_0,,,,2,1,2,3
41157_0,,,,2,1,2,3
C1(C(C=CC)CC(C(O1)=O)=O)=O,,,5,1,1,0,1
41158_0,,,,2,1,2,3
41160_0,,,,2,1,2,3
C(C)=C[CH]C(O)=O,,,5,1,1,0,1
41161_0,,,,2,1,2,3
41163_0,,,,2,1,2,3
C(CC=CC)(O)=O,,,5,1,1,0,1
41164_0,,,,2,1,2,3
41166_0,,,,2,1,2,3
C(CC(C(C(O)=O)=CC)C)=O,,,5,1,1,0,1
41167_0,,,,2,1,2,3
41168_0,,,,2,1,2,3
41170_0,,,,2,1,2,3
C(CC(C=CCC(O)=O)C)=O,,,5,1,1,0,1
41172_0,,,,2,1,2,3
C(CC(C)=C(C)CC(O)=O)=O,,,5,1,1,0,1
41174_0,,,,2,1,2,3
C(CC(C(C)=CC(O)=O)C)=O,,,5,1,1,0,1
41176_0,,,,2,1,2,3
C(CC(C(CC(O)=O)=C)C)=O,,,5,1,1,0,1
41178_0,,,,2,1,2,3
C(CC(C=C(C(O)=O)CO)C)=O,,,5,1,1,0,1
41180_0,,,,2,1,2,3
C(C(C=C(C)CC=O)(C)O)(O)=O,,,5,1,1,0,1
41182_0,,,,2,1,2,3
C(CC(C)C(C(C(O)=O)=C)O)=O,,,5,1,2,0,2
41184_0,,,,2,1,2,3
C(C(C=C[CH]C(O)=O)(C)O)(O)=O,,,5,1,1,0,1
41186_0,,,,2,1,2,3
C=C(C(O)=O)C(C[CH]C(O)=O)O,,,5,1,2,0,2
41187_0,,,,2,1,2,3
41189_0,,,,2,1,2,3
C(CCC(C(C(O)=O)=C)O)(O)=O,,,5,1,2,0,2
41191_0,,,,2,1,2,3
C(C(C=CC(C)CC=O)O)(O)=O,,,5,1,1,0,1
41193_0,,,,2,1,2,3
C(CC(C)=C(C)C(C(O)=O)O)=O,,,5,1,1,0,1
41195_0,,,,2,1,2,3
C(C(C(C(C)CC=O)=C)O)(O)=O,,,5,1,1,0,1
41197_0,,,,2,1,2,3
C(C(C(C)=C[CH]C(O)=O)O)(O)=O,,,5,1,1,0,1
41199_0,,,,2,1,2,3
C(C(C(C[CH]C(O)=O)=C)O)(O)=O,,,5,1,1,0,1
41201_0,,,,2,1,2,3
C(CC=C(C)C(C(O)=O)O)(O)=O,,,5,1,1,0,1
41203_0,,,,2,1,2,3
C(C(C(CCC(O)=O)=C)O)(O)=O,,,5,1,1,0,1
41205_0,,,,2,1,2,3
C(CC(C)=C(C(O)=O)C(C)O)=O,,,5,1,1,0,1
41207_0,,,,2,1,2,3
C(C(C=C)(C(C)CC=O)O)(O)=O,,,5,1,2,0,2
41209_0,,,,2,1,2,3
C(CC(C)=C(C(O)=O)C(O)=O)=O,,,5,1,1,0,1
41210_0,,,,2,1,2,3
41211_0,,,,2,1,2,3
41212_0,,,,2,1,2,3
41214_0,,,,2,1,2,3
C(C(C=C)CCC=CC=O)(O)=O,,,5,1,2,0,2
41216_0,,,,2,1,2,3
C(C)=C(C(O)=O)CCC=CC=O,,,5,1,1,0,1
41218_0,,,,2,1,2,3
C(CC(C=CC(C(O)=O)=C)C)=O,,,5,1,1,0,1
41220_0,,,,2,1,2,3
C(CC(C(C(C(O)=O)=C)=C)C)=O,,,5,1,1,0,1
41222_0,,,,2,1,2,3
C(CC(C)=C(C(C(O)=O)=C)C)=O,,,5,1,1,0,1
41224_0,,,,2,1,2,3
C(CC(C=C(C(O)=O)C=C)C)=O,,,5,1,1,0,1
41226_0,,,,2,1,2,3
C(CC(C)C(C=C)(CO)O)=O,,,5,1,3,0,3
41228_0,,,,2,1,2,3
C(CC(C)=C(CO)C(C)O)=O,,,5,1,1,0,1
41230_0,,,,2,1,2,3
C(CC(C)C(C(C=C)O)O)=O,,,5,1,2,0,2
41232_0,,,,2,1,2,3
C(CC(C)=CC(C(C)O)O)=O,,,5,1,1,0,1
41234_0,,,,2,1,2,3
C(CC(C=CC(CO)O)C)=O,,,5,1,1,0,1
41236_0,,,,2,1,2,3
C(CC(C(C(CO)O)=C)C)=O,,,5,1,1,0,1
41238_0,,,,2,1,2,3
C(CC(C)=C(C)C(CO)O)=O,,,5,1,1,0,1
41240_0,,,,2,1,2,3
C(CC(C)=CC(C=O)O)=O,,,5,1,1,0,1
41242_0,,,,2,1,2,3
C(CC(C)=C(C=O)CO)=O,,,5,1,1,0,1
41244_0,,,,2,1,2,3
[C](C(O)=O)=CC(C)CC=O,,,5,1,3,0,3
41245_0,,,,2,1,2,3
41247_0,,,,2,1,2,3
C(CC(C)=CC=O)=O,,,5,1,1,0,1
41249_0,,,,2,1,2,3
C(CC(C)=C[C](C(O)=O)O)=O,,,5,1,1,0,1
41250_0,,,,2,1,2,3
41251_0,,,,2,1,2,3
41253_0,,,,2,1,2,3
C(CC(C)=C(C=O)C)=O,,,5,1,1,0,1
41255_0,,,,2,1,2,3
C(CC(C)=CC(C(O)=O)O)=O,,,5,1,1,0,1
41256_0,,,,2,1,2,3
41257_0,,,,2,1,2,3
41258_0,,,,2,1,2,3
41259_0,,,,2,1,2,3
41260_0,,,,2,1,2,3
41262_0,,,,2,1,2,3
C(CC(C(C=O)=CC)C)=O,,,5,1,1,0,1
41263_0,,,,2,1,2,3
41264_0,,,,2,1,2,3
41266_0,,,,2,1,2,3
C(CC=CC(C)CC=O)=O,,,5,1,1,0,1
41268_0,,,,2,1,2,3
C(CC(C(C)=CC=O)C)=O,,,5,1,1,0,1
41270_0,,,,2,1,2,3
C(CC(C(C)CC=O)=C)=O,,,5,1,1,0,1
41272_0,,,,2,1,2,3
C(CC(C)=C(C)CC=O)=O,,,5,1,1,0,1
41274_0,,,,2,1,2,3
C(CC(C)=CC(C=O)=O)=O,,,5,1,1,0,1
41276_0,,,,2,1,2,3
C(CC(C)=CC(O)=O)=O,,,5,1,1,0,1
41278_0,,,,2,1,2,3
C(CC(C)=CCO)=O,,,5,1,1,0,1
41280_0,,,,2,1,2,3
C(CC(C)=CC(C(O)=O)=O)=O,,,5,1,1,0,1
41282_0,,,,2,1,2,3
C(C(C=C)CC(C(O)=O)C=C)=O,,,5,1,2,0,2
41284_0,,,,2,1,2,3
C(C(C=C)CC(C(O)=O)=CC)=O,,,5,1,1,0,1
41286_0,,,,2,1,2,3
C(C)(CC(C(O)=O)=O)=CC=O,,,5,1,1,0,1
41287_0,,,,2,1,2,3
41288_0,,,,2,1,2,3
41290_0,,,,2,1,2,3
C(C)(CC(C(O)=O)=O)=C(C=O)C,,,5,1,1,0,1
41292_0,,,,2,1,2,3
C(C)(CC(C(O)=O)=O)=CC(O)=O,,,5,1,1,0,1
41294_0,,,,2,1,2,3
C(CO)=C(C)CC(C(O)=O)=O,,,5,1,1,0,1
41296_0,,,,2,1,2,3
C(C(C=CC=O)CC=O)(O)=O,,,5,1,1,0,1
41297_0,,,,2,1,2,3
41298_0,,,,2,1,2,3
41300_0,,,,2,1,2,3
C(C(C=C(C=O)C)CC=O)(O)=O,,,5,1,1,0,1
41302_0,,,,2,1,2,3
C(C(C=CC(O)=O)CC=O)(O)=O,,,5,1,1,0,1
41304_0,,,,2,1,2,3
C(C(C=CCO)CC=O)(O)=O,,,5,1,1,0,1
41305_0,,,,2,1,2,3
41306_0,,,,2,1,2,3
41308_0,,,,2,1,2,3
C(C(C(C=O)=CC=O)C)(O)=O,,,5,1,2,0,2
41309_0,,,,2,1,2,3
41310_0,,,,2,1,2,3
41312_0,,,,2,1,2,3
C(C(C(C=O)=C(C=O)C)C)(O)=O,,,5,1,1,0,1
41314_0,,,,2,1,2,3
C(C(C(C=O)=CC(O)=O)C)(O)=O,,,5,1,1,0,1
41316_0,,,,2,1,2,3
C(C(C(C=O)=CCO)C)(O)=O,,,5,1,1,0,1
41318_0,,,,2,1,2,3
C=C(C(O)=O)C=CC[CH]C(O)=O,,,5,1,1,0,1
41320_0,,,,2,1,2,3
C(CCC=CC(C(O)=O)=C)(O)=O,,,5,1,1,0,1
41322_0,,,,2,1,2,3
C=C(C(O)=O)C(C)=C[CH]C(O)=O,,,5,1,1,0,1
41324_0,,,,2,1,2,3
C=C(C(O)=O)C(C[CH]C(O)=O)=C,,,5,1,1,0,1
41326_0,,,,2,1,2,3
C(CC=C(C(C(O)=O)=C)C)(O)=O,,,5,1,1,0,1
41328_0,,,,2,1,2,3
C(CCC(C(C(O)=O)=C)=C)(O)=O,,,5,1,1,0,1
41330_0,,,,2,1,2,3
C(C(CC(C(O)=O)=CC)O)=O,,,5,1,1,0,1
41331_0,,,,2,1,2,3
41333_0,,,,2,1,2,3
C(C(C=C)CC(C=O)O)(O)=O,,,5,1,2,0,2
41335_0,,,,2,1,2,3
C(C(CCC(C(O)=O)=CC)O)=O,,,5,1,1,0,1
41336_0,,,,2,1,2,3
41338_0,,,,2,1,2,3
C(C(C=C)CCC(C=O)O)(O)=O,,,5,1,2,0,2
41340_0,,,,2,1,2,3
C(C(C)(CC(C(O)=O)=CC)O)=O,,,5,1,1,0,1
41341_0,,,,2,1,2,3
41343_0,,,,2,1,2,3
C(C(C=C(C=O)C)C(C)O)(O)=O,,,5,1,1,0,1
41345_0,,,,2,1,2,3
C(C(C=C)CC(C=O)(C)O)(O)=O,,,5,1,2,0,2
41347_0,,,,2,1,2,3
C(CCC(C(O)=O)=CC)=O,,,5,1,2,0,2
41349_0,,,,2,1,2,3
C(CCC(C(O)=O)C=C)=O,,,5,1,3,0,3
41351_0,,,,2,1,2,3
C(C)=C(C(O)=O)CCC(C=O)=O,,,5,1,1,0,1
41353_0,,,,2,1,2,3
C(C(C=C)CCC(C=O)=O)(O)=O,,,5,1,3,0,3
41355_0,,,,2,1,2,3
C(C(CC(C(O)=O)=CC)O)(O)=O,,,5,1,1,0,1
41356_0,,,,2,1,2,3
41357_0,,,,2,1,2,3
41359_0,,,,2,1,2,3
C(C)=C(C(O)=O)CC(CO)O,,,5,1,1,0,1
41360_0,,,,2,1,2,3
41362_0,,,,2,1,2,3
C(C(C=C)CC(CO)O)(O)=O,,,5,1,2,0,2
41364_0,,,,2,1,2,3
C=CC(C(O)=O)=CC[CH]C(O)=O,,,5,1,1,0,1
41366_0,,,,2,1,2,3
C(CCC=C(C(O)=O)C=C)(O)=O,,,5,1,1,0,1
41367_0,,,,2,1,2,3
41368_0,,,,2,1,2,3
41369_0,,,,2,1,2,3
41371_0,,,,2,1,2,3
C(C(C(O)=O)C=C(C=O)C)(O)=O,,,5,1,1,0,1
41372_0,,,,2,1,2,3
41373_0,,,,2,1,2,3
41375_0,,,,2,1,2,3
C(C(C(C)O)O)=C[CH]C(O)=O,,,5,1,1,0,1
41377_0,,,,2,1,2,3
C=CC(C(C[CH]C(O)=O)O)O,,,5,1,2,0,2
41379_0,,,,2,1,2,3
C(CC=CC(C(C)O)O)(O)=O,,,5,1,1,0,1
41381_0,,,,2,1,2,3
C(CCC(C(C=C)O)O)(O)=O,,,5,1,2,0,2
41383_0,,,,2,1,2,3
C(C(CO)=C[CH]C(O)=O)=O,,,5,1,1,0,1
41384_0,,,,2,1,2,3
41386_0,,,,2,1,2,3
C([CH]C=C[CH]C(O)=O)(O)=O,,,5,1,1,0,1
41387_0,,,,2,1,2,3
41388_0,,,,2,1,2,3
41389_0,,,,2,1,2,3
41391_0,,,,2,1,2,3
C([C](C=C[CH]C(O)=O)O)(O)=O,,,5,1,2,0,2
41393_0,,,,2,1,2,3
C(CC=C[C](C(O)=O)O)(O)=O,,,5,1,3,0,3
41394_0,,,,2,1,2,3
41395_0,,,,2,1,2,3
41397_0,,,,2,1,2,3
C(C(C)=C[CH]C(O)=O)=O,,,5,1,1,0,1
41398_0,,,,2,1,2,3
41400_0,,,,2,1,2,3
C(CC=C(C=O)C)(O)=O,,,5,1,1,0,1
41401_0,,,,2,1,2,3
41403_0,,,,2,1,2,3
C(C([C](C(O)=O)O)O)=CC(C)O,,,5,1,2,0,2
41405_0,,,,2,1,2,3
C(C(C([C](C(O)=O)O)O)O)=CC,,,5,1,2,0,2
41407_0,,,,2,1,2,3
C(CC(C([C](C(O)=O)O)O)O)=C,,,5,1,2,0,2
41409_0,,,,2,1,2,3
[C](C(O)=O)=CC(CC(C)O)O,,,5,1,1,0,1
41411_0,,,,2,1,2,3
C(CC(C)O)=C[C](C(O)=O)O,,,5,1,2,0,2
41413_0,,,,2,1,2,3
C(C[C](C(O)=O)O)=CC(C)O,,,5,1,2,0,2
41415_0,,,,2,1,2,3
C(C(C[C](C(O)=O)O)O)=CC,,,5,1,2,0,2
41417_0,,,,2,1,2,3
C=CCC(C[C](C(O)=O)O)O,,,5,1,2,0,2
41419_0,,,,2,1,2,3
C=C([C](C(O)=O)O)C(C)O,,,5,1,2,0,2
41421_0,,,,2,1,2,3
[C](C(O)=O)=C(CO)C(C)O,,,5,1,1,0,1
41423_0,,,,2,1,2,3
C(C)=C([C](C(O)=O)O)CO,,,5,1,2,0,2
41425_0,,,,2,1,2,3
C=CC([C](C(O)=O)O)CO,,,5,1,2,0,2
41427_0,,,,2,1,2,3
C=CC([C](C(O)=O)O)C(C)O,,,5,1,2,0,2
41429_0,,,,2,1,2,3
C(C)=C([C](C(O)=O)O)C(C)O,,,5,1,2,0,2
41431_0,,,,2,1,2,3
[C](C(O)=O)=C(C(C)O)C(C)O,,,5,1,1,0,1
41433_0,,,,2,1,2,3
C(C([C](C(O)=O)O)O)=CC(O)=O,,,5,1,2,0,2
41435_0,,,,2,1,2,3
[C](C(O)=O)=CC(CC(O)=O)O,,,5,1,1,0,1
41436_0,,,,2,1,2,3
41438_0,,,,2,1,2,3
C(C[C](C(O)=O)O)=CC(O)=O,,,5,1,2,0,2
41440_0,,,,2,1,2,3
[C](C(O)=O)=CC(C(CO)=O)O,,,5,1,1,0,1
41442_0,,,,2,1,2,3
C([C](C=CC(CO)=O)O)(O)=O,,,5,1,2,0,2
41444_0,,,,2,1,2,3
[C](C(O)=O)=CC(C=O)(CO)O,,,5,1,1,0,1
41446_0,,,,2,1,2,3
C(C(CO)=C[C](C(O)=O)O)=O,,,5,1,2,0,2
41448_0,,,,2,1,2,3
C=C(C=O)C([C](C(O)=O)O)O,,,5,1,2,0,2
41450_0,,,,2,1,2,3
[C](C(O)=O)=CC(C=O)(C)O,,,5,1,1,0,1
41452_0,,,,2,1,2,3
C(C(C)=C[C](C(O)=O)O)=O,,,5,1,2,0,2
41454_0,,,,2,1,2,3
C=C(C=O)C[C](C(O)=O)O,,,5,1,2,0,2
41456_0,,,,2,1,2,3
[C](C(O)=O)=CC(C(C)=O)O,,,5,1,1,0,1
41458_0,,,,2,1,2,3
C([C](C=CC(C)=O)O)(O)=O,,,5,1,2,0,2
41460_0,,,,2,1,2,3
[C](C(O)=O)=C(C(C(O)=O)=C)CO,,,5,1,1,0,1
41462_0,,,,2,1,2,3
C=C(C(O)=O)C([C](C(O)=O)O)=C,,,5,1,2,0,2
41464_0,,,,2,1,2,3
[C](C(O)=O)=CCO,,,5,1,2,0,2
41466_0,,,,2,1,2,3
C=C[C](C(O)=O)O,,,5,1,2,0,2
41468_0,,,,2,1,2,3
[C](C(O)=O)=CC(C(O)=O)(CO)O,,,5,1,1,0,1
41470_0,,,,2,1,2,3
C(C(CO)=C[C](C(O)=O)O)(O)=O,,,5,1,2,0,2
41471_0,,,,2,1,2,3
41472_0,,,,2,1,2,3
41474_0,,,,2,1,2,3
C(C(CC(C)O)O)=CC=O,,,5,1,2,0,2
41476_0,,,,2,1,2,3
C(C(C=CCC(C)O)O)=O,,,5,1,2,0,2
41478_0,,,,2,1,2,3
C(C(CC=CC(C)O)O)=O,,,5,1,2,0,2
41479_0,,,,2,1,2,3
41480_0,,,,2,1,2,3
41482_0,,,,2,1,2,3
C(CC(C=CC=O)O)(O)=O,,,5,1,2,0,2
41483_0,,,,2,1,2,3
41485_0,,,,2,1,2,3
C(C(CC=CC(O)=O)O)=O,,,5,1,2,0,2
41487_0,,,,2,1,2,3
C(CO)(C(C=CC=O)O)=O,,,5,1,2,0,2
41488_0,,,,2,1,2,3
41490_0,,,,2,1,2,3
C(C(C=CC=O)(CO)O)=O,,,5,1,2,0,2
41491_0,,,,2,1,2,3
41493_0,,,,2,1,2,3
C(C(C=CC=O)(C)O)=O,,,5,1,2,0,2
41495_0,,,,2,1,2,3
C(C(C=C(C=O)C)O)=O,,,5,1,2,0,2
41497_0,,,,2,1,2,3
C(C(CC(C=O)=C)O)=O,,,5,1,2,0,2
41499_0,,,,2,1,2,3
C(C)(C(C=CC=O)O)=O,,,5,1,2,0,2
41501_0,,,,2,1,2,3
C(C(C=CC(C)=O)O)=O,,,5,1,2,0,2
41502_0,,,,2,1,2,3
41503_0,,,,2,1,2,3
41504_0,,,,2,1,2,3
41506_0,,,,2,1,2,3
C(C(C=CC=O)(CO)O)(O)=O,,,5,1,2,0,2
41508_0,,,,2,1,2,3
C(C(CC(C(O)=O)=C)O)=O,,,5,1,2,0,2
41510_0,,,,2,1,2,3
C(C(C=C(C(O)=O)C)O)=O,,,5,1,2,0,2
41511_0,,,,2,1,2,3
41512_0,,,,2,1,2,3
41514_0,,,,2,1,2,3
C(C(C(C(O)=O)=O)O)=CC,,,5,1,2,0,2
41516_0,,,,2,1,2,3
C=CCC(C(C(O)=O)=O)O,,,5,1,2,0,2
41517_0,,,,2,1,2,3
41518_0,,,,2,1,2,3
41519_0,,,,2,1,2,3
41520_0,,,,2,1,2,3
41522_0,,,,2,1,2,3
C(C(C(C(C)O)=C)O)(O)=O,,,5,1,2,0,2
41524_0,,,,2,1,2,3
C(CO)(C(C)O)=CC(O)=O,,,5,1,1,0,1
41526_0,,,,2,1,2,3
C(C(C(CO)=CC)O)(O)=O,,,5,1,2,0,2
41527_0,,,,2,1,2,3
41529_0,,,,2,1,2,3
C(C(C(C=C)C(C)O)O)(O)=O,,,5,1,2,0,2
41531_0,,,,2,1,2,3
C(C(C(C(C)O)=CC)O)(O)=O,,,5,1,2,0,2
41533_0,,,,2,1,2,3
C(C(C)O)(C(C)O)=CC(O)=O,,,5,1,1,0,1
41535_0,,,,2,1,2,3
C=C(C(O)=O)C(CO)=CC(O)=O,,,5,1,1,0,1
41537_0,,,,2,1,2,3
C(C(C(C(C(O)=O)=C)=C)O)(O)=O,,,5,1,2,0,2
41539_0,,,,2,2,1,3
CC(C1C(C(C(C1O)O)O)O)O,,,5,1,1,0,1
41540_0,,,,2,2,1,3
41541_0,,,,2,2,1,3
41543_0,,,,2,2,1,3
C(C1(C(C(C(C1O)O)O)O)O)=O,,,5,1,1,0,1
41545_0,,,,2,2,1,3
C(C1(C(C(C(C1)O)O)O)O)=O,,,5,1,1,0,1
41546_0,,,,2,2,1,3
41548_0,,,,2,2,1,3
C(C1(C(C(C(C1O)O)O)O)O)(O)=O,,,5,1,1,0,1
41550_0,,,,2,2,1,3
C1C(C(C(C1O)O)O)O,,,5,1,1,0,1
41552_0,,,,2,2,1,3
C(C1(C(C(C(C1)O)O)O)O)(O)=O,,,5,1,1,0,1
41553_0,,,,2,2,1,3
41555_0,,,,2,2,1,3
C1(C2(CC(C(C2O)O)(O)O1)O)=O,,,5,1,3,0,3
41556_0,,,,2,2,1,3
41557_0,,,,2,2,1,3
41558_0,,,,2,2,1,3
41559_0,,,,2,2,1,3
41560_0,,,,2,2,1,3
41561_0,,,,2,2,1,3
41562_0,,,,2,2,1,3
41563_0,,,,2,2,1,3
41564_0,,,,2,2,1,3
41565_0,,,,2,2,1,3
41566_0,,,,2,2,1,3
41567_0,,,,2,2,1,3
41568_0,,,,2,2,1,3
41569_0,,,,2,2,1,3
41570_0,,,,2,2,1,3
41571_0,,,,2,2,1,3
41572_0,,,,2,2,1,3
41573_0,,,,2,2,1,3
41574_0,,,,2,2,1,3
41575_0,,,,2,2,1,3
41576_0,,,,2,2,1,3
41577_0,,,,2,2,1,3
41578_0,,,,2,2,1,3
41579_0,,,,2,2,1,3
41580_0,,,,2,2,1,3
41581_0,,,,2,2,1,3
41582_0,,,,2,2,1,3
41583_0,,,,2,2,1,3
41584_0,,,,2,2,1,3
41585_0,,,,2,2,1,3
41586_0,,,,2,2,1,3
41587_0,,,,2,2,1,3
41588_0,,,,2,2,1,3
41589_0,,,,2,2,1,3
41590_0,,,,2,2,1,3
41591_0,,,,2,2,1,3
41592_0,,,,2,2,1,3
41593_0,,,,2,2,1,3
41594_0,,,,2,2,1,3
41595_0,,,,2,2,1,3
41596_0,,,,2,2,1,3
41597_0,,,,2,2,1,3
41598_0,,,,2,2,1,3
41599_0,,,,2,2,1,3
41600_0,,,,2,2,1,3
41601_0,,,,2,2,1,3
41602_0,,,,2,2,1,3
41603_0,,,,2,2,1,3
41604_0,,,,2,2,1,3
41605_0,,,,2,2,1,3
41606_0,,,,2,2,1,3
41607_0,,,,2,2,1,3
41608_0,,,,2,2,1,3
41609_0,,,,2,2,1,3
41610_0,,,,2,2,1,3
41611_0,,,,2,2,1,3
41613_0,,,,2,2,1,3
C(C(CCO)(C(C=C)(CO)O)O)=O,,,5,1,1,0,1
41614_0,,,,2,2,1,3
41615_0,,,,2,2,1,3
41616_0,,,,2,2,1,3
41617_0,,,,2,2,1,3
41618_0,,,,2,2,1,3
41619_0,,,,2,2,1,3
41620_0,,,,2,2,1,3
41621_0,,,,2,2,1,3
41623_0,,,,2,2,1,3
C(C(C(C=C)(CO)O)O)(CCO)=O,,,5,1,1,0,1
41624_0,,,,2,2,1,3
41625_0,,,,2,2,1,3
41626_0,,,,2,2,1,3
41627_0,,,,2,2,1,3
41629_0,,,,2,2,1,3
C(C(C(CO)(C(CO)(C)O)O)O)=O,,,5,1,2,0,2
41631_0,,,,2,2,1,3
C(C(C(CO)(C(C=CC)O)O)O)=O,,,5,1,2,0,2
41633_0,,,,2,2,1,3
C(C(C(C(CC=C)O)(CO)O)O)=O,,,5,1,2,0,2
41634_0,,,,2,2,1,3
41635_0,,,,2,2,1,3
41636_0,,,,2,2,1,3
41637_0,,,,2,2,1,3
41638_0,,,,2,2,1,3
41639_0,,,,2,2,1,3
41640_0,,,,2,2,1,3
41641_0,,,,2,2,1,3
41642_0,,,,2,2,1,3
41643_0,,,,2,2,1,3
41645_0,,,,2,2,1,3
C(C(C(C(C)O)(C(C)O)O)O)=O,,,5,1,2,0,2
41646_0,,,,2,2,1,3
41647_0,,,,2,2,1,3
41648_0,,,,2,2,1,3
41649_0,,,,2,2,1,3
41650_0,,,,2,2,1,3
41651_0,,,,2,2,1,3
41652_0,,,,2,2,1,3
41653_0,,,,2,2,1,3
41655_0,,,,2,2,1,3
C(C(C(C(CCO)O)O)O)O,,,5,1,2,0,2
41656_0,,,,2,2,1,3
41658_0,,,,2,2,1,3
C=CC(CO)(C(CCO)O)O,,,5,1,1,0,1
41659_0,,,,2,2,1,3
41661_0,,,,2,2,1,3
CC(C(CO)(C(CCO)O)O)O,,,5,1,1,0,1
41662_0,,,,2,2,1,3
41663_0,,,,2,2,1,3
41664_0,,,,2,2,1,3
41665_0,,,,2,2,1,3
41666_0,,,,2,2,1,3
41667_0,,,,2,2,1,3
41668_0,,,,2,2,1,3
41669_0,,,,2,2,1,3
41670_0,,,,2,2,1,3
41671_0,,,,2,2,1,3
41672_0,,,,2,2,1,3
41673_0,,,,2,2,1,3
41674_0,,,,2,2,1,3
41675_0,,,,2,2,1,3
41676_0,,,,2,2,1,3
41677_0,,,,2,2,1,3
41678_0,,,,2,2,1,3
41679_0,,,,2,2,1,3
41680_0,,,,2,2,1,3
41681_0,,,,2,2,1,3
41682_0,,,,2,2,1,3
41683_0,,,,2,2,1,3
41684_0,,,,2,2,1,3
41685_0,,,,2,2,1,3
41686_0,,,,2,2,1,3
41687_0,,,,2,2,1,3
41688_0,,,,2,2,1,3
41689_0,,,,2,2,1,3
41690_0,,,,2,2,1,3
41691_0,,,,2,2,1,3
41692_0,,,,2,2,1,3
41693_0,,,,2,2,1,3
41694_0,,,,2,2,1,3
41695_0,,,,2,2,1,3
41696_0,,,,2,2,1,3
41697_0,,,,2,2,1,3
41698_0,,,,2,2,1,3
41699_0,,,,2,2,1,3
41700_0,,,,2,2,1,3
41701_0,,,,2,2,1,3
41702_0,,,,2,2,1,3
41703_0,,,,2,2,1,3
41704_0,,,,2,2,1,3
41705_0,,,,2,2,1,3
41706_0,,,,2,2,1,3
41707_0,,,,2,2,1,3
41708_0,,,,2,2,1,3
41709_0,,,,2,2,1,3
41710_0,,,,2,2,1,3
41711_0,,,,2,2,1,3
41712_0,,,,2,2,1,3
41713_0,,,,2,2,1,3
41714_0,,,,2,2,1,3
41715_0,,,,2,2,1,3
41716_0,,,,2,2,1,3
41717_0,,,,2,2,1,3
41718_0,,,,2,2,1,3
41719_0,,,,2,2,1,3
41720_0,,,,2,2,1,3
41721_0,,,,2,2,1,3
41722_0,,,,2,2,1,3
41723_0,,,,2,2,1,3
41724_0,,,,2,2,1,3
41725_0,,,,2,2,1,3
41726_0,,,,2,2,1,3
41727_0,,,,2,2,1,3
41728_0,,,,2,2,1,3
41729_0,,,,2,2,1,3
41730_0,,,,2,2,1,3
41731_0,,,,2,2,1,3
41732_0,,,,2,2,1,3
41733_0,,,,2,2,1,3
41734_0,,,,2,2,1,3
41736_0,,,,2,2,1,3
C(C(C(C(CO)O)O)O)(C(C)O)=O,,,5,1,1,0,1
41738_0,,,,2,2,1,3
C(C(C(C(C)O)O)O)(C(C)O)=O,,,5,1,1,0,1
41739_0,,,,2,2,1,3
41740_0,,,,2,2,1,3
41741_0,,,,2,2,1,3
41742_0,,,,2,2,1,3
41743_0,,,,2,2,1,3
41744_0,,,,2,2,1,3
41745_0,,,,2,2,1,3
41746_0,,,,2,2,1,3
41747_0,,,,2,2,1,3
41748_0,,,,2,2,1,3
41749_0,,,,2,2,1,3
41750_0,,,,2,2,1,3
41751_0,,,,2,2,1,3
41752_0,,,,2,2,1,3
41753_0,,,,2,2,1,3
41755_0,,,,2,2,1,3
C(C(C(C=C)(CO)O)O)=O,,,5,1,1,0,1
41757_0,,,,2,2,1,3
C(C(C(C=C)(C(C=O)O)O)O)(O)=O,,,5,1,1,0,1
41759_0,,,,2,2,1,3
C(C(C(C(C(O)=O)=C)(CO)O)O)=O,,,5,1,1,0,1
41761_0,,,,2,2,1,3
C1(C(C(C(C)O1)(C(C=O)O)O)O)=O,,,5,1,1,0,1
41762_0,,,,2,2,1,3
41764_0,,,,2,2,1,3
C(C(C(CO)(C[CH]C(O)=O)O)O)=O,,,5,1,4,0,4
41766_0,,,,2,2,1,3
C(CCC(CO)(C(C=O)O)O)(O)=O,,,5,1,4,0,4
41767_0,,,,2,2,1,3
41768_0,,,,2,2,1,3
41769_0,,,,2,2,1,3
41770_0,,,,2,2,1,3
41771_0,,,,2,2,1,3
41772_0,,,,2,2,1,3
41773_0,,,,2,2,1,3
41775_0,,,,2,2,1,3
C(C(C(C(C=C)(CO)O)O)O)=O,,,5,1,1,0,1
41776_0,,,,2,2,1,3
41777_0,,,,2,2,1,3
41778_0,,,,2,2,1,3
41779_0,,,,2,2,1,3
41780_0,,,,2,2,1,3
41781_0,,,,2,2,1,3
41782_0,,,,2,2,1,3
41784_0,,,,2,2,1,3
C(C(C(C(C=C)(CO)O)O)O)(O)=O,,,5,1,1,0,1
41785_0,,,,2,2,1,3
41786_0,,,,2,2,1,3
41787_0,,,,2,2,1,3
41788_0,,,,2,2,1,3
41790_0,,,,2,2,1,3
C=CC(CO)(C(CO)(CO)O)O,,,5,1,1,0,1
41791_0,,,,2,2,1,3
41792_0,,,,2,2,1,3
41793_0,,,,2,2,1,3
41794_0,,,,2,2,1,3
41795_0,,,,2,2,1,3
41796_0,,,,2,2,1,3
41797_0,,,,2,2,1,3
41798_0,,,,2,2,1,3
41800_0,,,,2,2,1,3
C=CC(CO)(C(CO)(C)O)O,,,5,1,1,0,1
41801_0,,,,2,2,1,3
41802_0,,,,2,2,1,3
41803_0,,,,2,2,1,3
41804_0,,,,2,2,1,3
41805_0,,,,2,2,1,3
41807_0,,,,2,2,1,3
C(C(C(C(CO)O)O)O)=CC,,,5,1,2,0,2
41809_0,,,,2,2,1,3
C=CCC(C(C(CO)O)O)O,,,5,1,2,0,2
41811_0,,,,2,2,1,3
C(C(C(C(C(CO)O)O)O)O)O,,,5,1,2,0,2
41812_0,,,,2,2,1,3
41814_0,,,,2,2,1,3
CC(C(C(C(CO)O)O)O)O,,,5,1,2,0,2
41815_0,,,,2,2,1,3
41816_0,,,,2,2,1,3
41817_0,,,,2,2,1,3
41818_0,,,,2,2,1,3
41819_0,,,,2,2,1,3
41820_0,,,,2,2,1,3
41821_0,,,,2,2,1,3
41822_0,,,,2,2,1,3
41823_0,,,,2,2,1,3
41824_0,,,,2,2,1,3
41825_0,,,,2,2,1,3
41826_0,,,,2,2,1,3
41827_0,,,,2,2,1,3
41828_0,,,,2,2,1,3
41829_0,,,,2,2,1,3
41830_0,,,,2,2,1,3
41831_0,,,,2,2,1,3
41832_0,,,,2,2,1,3
41833_0,,,,2,2,1,3
41834_0,,,,2,2,1,3
41835_0,,,,2,2,1,3
41836_0,,,,2,2,1,3
41837_0,,,,2,2,1,3
41838_0,,,,2,2,1,3
41839_0,,,,2,2,1,3
41840_0,,,,2,2,1,3
41841_0,,,,2,2,1,3
41842_0,,,,2,2,1,3
41843_0,,,,2,2,1,3
41844_0,,,,2,2,1,3
41845_0,,,,2,2,1,3
41846_0,,,,2,2,1,3
41847_0,,,,2,2,1,3
41848_0,,,,2,2,1,3
41849_0,,,,2,2,1,3
41850_0,,,,2,2,1,3
41851_0,,,,2,2,1,3
41853_0,,,,2,2,1,3
C(C(C)C(C(C(CO)O)O)O)(O)=O,,,5,1,1,0,1
41854_0,,,,2,2,1,3
41856_0,,,,2,2,1,3
C(C(C)C(C(C(C)O)O)O)(O)=O,,,5,1,1,0,1
41857_0,,,,2,2,1,3
41858_0,,,,2,2,1,3
41859_0,,,,2,2,1,3
41861_0,,,,2,2,1,3
C(C(C)C(C(CO)O)O)(O)=O,,,5,1,1,0,1
41863_0,,,,2,2,1,3
C(C)=CC(C(C=C)(CO)O)O,,,5,1,1,0,1
41864_0,,,,2,2,1,3
41865_0,,,,2,2,1,3
41866_0,,,,2,2,1,3
41867_0,,,,2,2,1,3
41868_0,,,,2,2,1,3
41870_0,,,,2,2,1,3
C(C(CO)(C(CC=C)O)O)=C,,,5,1,1,0,1
41871_0,,,,2,2,1,3
41872_0,,,,2,2,1,3
41873_0,,,,2,2,1,3
41874_0,,,,2,2,1,3
41875_0,,,,2,2,1,3
41877_0,,,,2,2,1,3
C=CC(CO)(C(C(CO)O)O)O,,,5,1,1,0,1
41879_0,,,,2,2,1,3
C=CC(CO)(C(CO)O)O,,,5,1,1,0,1
41881_0,,,,2,2,1,3
C=CC(CO)(C(C(C)O)O)O,,,5,1,1,0,1
41882_0,,,,2,2,1,3
41883_0,,,,2,2,1,3
41884_0,,,,2,2,1,3
41885_0,,,,2,2,1,3
41886_0,,,,2,2,1,3
41887_0,,,,2,2,1,3
41888_0,,,,2,2,1,3
41889_0,,,,2,2,1,3
41890_0,,,,2,2,1,3
41891_0,,,,2,2,1,3
41892_0,,,,2,2,1,3
41894_0,,,,2,2,1,3
C(C(CO)(C(C=C)(CO)O)O)(O)=O,,,5,1,1,0,1
41895_0,,,,2,2,1,3
41896_0,,,,2,2,1,3
41897_0,,,,2,2,1,3
41899_0,,,,2,2,1,3
C(C(C(C=C)(C(CO)O)O)O)(O)=O,,,5,1,1,0,1
41900_0,,,,2,2,1,3
41901_0,,,,2,2,1,3
41902_0,,,,2,2,1,3
41903_0,,,,2,2,1,3
41905_0,,,,2,2,1,3
C=C(C(O)=O)C(CO)(C(CO)O)O,,,5,1,1,0,1
41906_0,,,,2,2,1,3
41907_0,,,,2,2,1,3
41908_0,,,,2,2,1,3
41909_0,,,,2,2,1,3
41911_0,,,,2,2,1,3
C1(C(C(C(C(O1)=O)=C)(CO)O)O)=O,,,5,1,1,0,1
41912_0,,,,2,2,1,3
41914_0,,,,2,2,1,3
CC(C(CO)(C(C(CO)O)O)O)O,,,5,1,2,0,2
41915_0,,,,2,2,1,3
41916_0,,,,2,2,1,3
41917_0,,,,2,2,1,3
41919_0,,,,2,2,1,3
C1(C(C(C(CO)O)(C(C)O1)O)O)=O,,,5,1,1,0,1
41920_0,,,,2,2,1,3
41922_0,,,,2,2,1,3
[CH](C(O)=O)CC(CO)(C(CO)O)O,,,5,1,1,0,1
41924_0,,,,2,2,1,3
C(CCC(CO)(C(CO)O)O)(O)=O,,,5,1,1,0,1
41925_0,,,,2,2,1,3
41927_0,,,,2,2,1,3
CC(C(CO)(C(CO)O)O)O,,,5,1,1,0,1
41928_0,,,,2,2,1,3
41929_0,,,,2,2,1,3
41930_0,,,,2,2,1,3
41931_0,,,,2,2,1,3
41933_0,,,,2,2,1,3
C1(C(C(C(C)O)(C(C)O1)O)O)=O,,,5,1,2,0,2
41935_0,,,,2,2,1,3
C(C1(C(C)OC(C1O)=O)O)(O)=O,,,5,1,2,0,2
41937_0,,,,2,2,1,3
C1(C(C(CO)(C(C)O1)O)O)=O,,,5,1,2,0,2
41938_0,,,,2,2,1,3
41939_0,,,,2,2,1,3
41940_0,,,,2,2,1,3
41941_0,,,,2,2,1,3
41942_0,,,,2,2,1,3
41943_0,,,,2,2,1,3
41944_0,,,,2,2,1,3
41945_0,,,,2,2,1,3
41946_0,,,,2,2,1,3
41948_0,,,,2,2,1,3
CC(C(C(CO)(C(C)O)O)O)O,,,5,1,1,0,1
41949_0,,,,2,2,1,3
41950_0,,,,2,2,1,3
41951_0,,,,2,2,1,3
41952_0,,,,2,2,1,3
41953_0,,,,2,2,1,3
41954_0,,,,2,2,1,3
41955_0,,,,2,2,1,3
41956_0,,,,2,2,1,3
41957_0,,,,2,2,1,3
41958_0,,,,2,2,1,3
41959_0,,,,2,2,1,3
41961_0,,,,2,2,1,3
C(C(CO)=O)(C(CO)(C(C)O)O)=O,,,5,1,1,0,1
41962_0,,,,2,2,1,3
41963_0,,,,2,2,1,3
41964_0,,,,2,2,1,3
41965_0,,,,2,2,1,3
41966_0,,,,2,2,1,3
41967_0,,,,2,2,1,3
41968_0,,,,2,2,1,3
41969_0,,,,2,2,1,3
41970_0,,,,2,2,1,3
41971_0,,,,2,2,1,3
41972_0,,,,2,2,1,3
41973_0,,,,2,2,1,3
41974_0,,,,2,2,1,3
41975_0,,,,2,2,1,3
41976_0,,,,2,2,1,3
41977_0,,,,2,2,1,3
41978_0,,,,2,2,1,3
41979_0,,,,2,2,1,3
41980_0,,,,2,2,1,3
41981_0,,,,2,2,1,3
41982_0,,,,2,2,1,3
41983_0,,,,2,2,1,3
41984_0,,,,2,2,1,3
41985_0,,,,2,2,1,3
41986_0,,,,2,2,1,3
41987_0,,,,2,2,1,3
41988_0,,,,2,2,1,3
41989_0,,,,2,2,1,3
41990_0,,,,2,2,1,3
41991_0,,,,2,2,1,3
41992_0,,,,2,2,1,3
41993_0,,,,2,2,1,3
41994_0,,,,2,2,1,3
41995_0,,,,2,2,1,3
41996_0,,,,2,2,1,3
41997_0,,,,2,2,1,3
41998_0,,,,2,2,1,3
41999_0,,,,2,2,1,3
42000_0,,,,2,2,1,3
42001_0,,,,2,2,1,3
42002_0,,,,2,2,1,3
42003_0,,,,2,2,1,3
42004_0,,,,2,2,1,3
42005_0,,,,2,2,1,3
42006_0,,,,2,2,1,3
42007_0,,,,2,2,1,3
42008_0,,,,2,2,1,3
42009_0,,,,2,2,1,3
42010_0,,,,2,2,1,3
42011_0,,,,2,2,1,3
42012_0,,,,2,2,1,3
42013_0,,,,2,2,1,3
42014_0,,,,2,2,1,3
42015_0,,,,2,2,1,3
42017_0,,,,2,2,1,3
CC(C(C)O)O,,,5,1,2,0,2
42018_0,,,,2,2,1,3
42019_0,,,,2,2,1,3
42020_0,,,,2,2,1,3
42021_0,,,,2,2,1,3
42022_0,,,,2,2,1,3
42023_0,,,,2,2,1,3
42024_0,,,,2,2,1,3
42026_0,,,,2,2,1,3
[CH](C(O)=O)C(C(C)O)O,,,5,1,2,0,2
42027_0,,,,2,2,1,3
42028_0,,,,2,2,1,3
42029_0,,,,2,2,1,3
42031_0,,,,2,2,1,3
[CH](C(O)=O)C(CO)O,,,5,1,1,0,1
42032_0,,,,2,2,1,3
42033_0,,,,2,2,1,3
42034_0,,,,2,2,1,3
42035_0,,,,2,2,1,3
42036_0,,,,2,2,1,3
42037_0,,,,2,2,1,3
42038_0,,,,2,2,1,3
42039_0,,,,2,2,1,3
42040_0,,,,2,2,1,3
42041_0,,,,2,2,1,3
42042_0,,,,2,2,1,3
42043_0,,,,2,2,1,3
42044_0,,,,2,2,1,3
42045_0,,,,2,2,1,3
42046_0,,,,2,2,1,3
42047_0,,,,2,2,1,3
42048_0,,,,2,2,1,3
42049_0,,,,2,2,1,3
42050_0,,,,2,2,1,3
42051_0,,,,2,2,1,3
42052_0,,,,2,2,1,3
42053_0,,,,2,2,1,3
42054_0,,,,2,2,1,3
42056_0,,,,2,2,1,3
C(C(C(C([CH]C(O)=O)O)O)O)=O,,,5,1,1,0,1
42057_0,,,,2,2,1,3
42059_0,,,,2,2,1,3
C(C(C(C([CH]C(O)=O)O)O)O)(O)=O,,,5,1,1,0,1
42060_0,,,,2,2,1,3
42061_0,,,,2,2,1,3
42062_0,,,,2,2,1,3
42063_0,,,,2,2,1,3
42064_0,,,,2,2,1,3
42065_0,,,,2,2,1,3
42066_0,,,,2,2,1,3
42067_0,,,,2,2,1,3
42068_0,,,,2,2,1,3
42069_0,,,,2,2,1,3
42070_0,,,,2,2,1,3
42071_0,,,,2,2,1,3
42072_0,,,,2,2,1,3
42073_0,,,,2,2,1,3
42074_0,,,,2,2,1,3
42075_0,,,,2,2,1,3
42076_0,,,,2,2,1,3
42077_0,,,,2,2,1,3
42078_0,,,,2,2,1,3
42079_0,,,,2,2,1,3
42080_0,,,,2,2,1,3
42081_0,,,,2,2,1,3
42082_0,,,,2,2,1,3
42083_0,,,,2,2,1,3
42085_0,,,,2,2,1,3
C(CC(C(CO)O)(C(CO)O)O)=O,,,5,1,1,0,1
42086_0,,,,2,2,1,3
42087_0,,,,2,2,1,3
42088_0,,,,2,2,1,3
42089_0,,,,2,2,1,3
42090_0,,,,2,2,1,3
42091_0,,,,2,2,1,3
42092_0,,,,2,2,1,3
42094_0,,,,2,2,1,3
C(C(CO)O)(OCC(C(O)=O)O)=O,,,5,1,1,0,1
42096_0,,,,2,2,1,3
C(C(CO)O)(OC(C(CO)O)=O)=O,,,5,1,1,0,1
42097_0,,,,2,2,1,3
42098_0,,,,2,2,1,3
42099_0,,,,2,2,1,3
42100_0,,,,2,2,1,3
42101_0,,,,2,2,1,3
42102_0,,,,2,2,1,3
42103_0,,,,2,2,1,3
42104_0,,,,2,2,1,3
42105_0,,,,2,2,1,3
42106_0,,,,2,2,1,3
42107_0,,,,2,2,1,3
42108_0,,,,2,2,1,3
42110_0,,,,2,2,1,3
C(C(C=O)C(CO)(C(C)O)O)(O)=O,,,5,1,1,0,1
42111_0,,,,2,2,1,3
42112_0,,,,2,2,1,3
42113_0,,,,2,2,1,3
42114_0,,,,2,2,1,3
42115_0,,,,2,2,1,3
42116_0,,,,2,2,1,3
42117_0,,,,2,2,1,3
42118_0,,,,2,2,1,3
42119_0,,,,2,2,1,3
42120_0,,,,2,2,1,3
42121_0,,,,2,2,1,3
42122_0,,,,2,2,1,3
42123_0,,,,2,2,1,3
42124_0,,,,2,2,1,3
42125_0,,,,2,2,1,3
42126_0,,,,2,2,1,3
42127_0,,,,2,2,1,3
42128_0,,,,2,2,1,3
42129_0,,,,2,2,1,3
42130_0,,,,2,2,1,3
42131_0,,,,2,2,1,3
42132_0,,,,2,2,1,3
42133_0,,,,2,2,1,3
42134_0,,,,2,2,1,3
42135_0,,,,2,2,1,3
42136_0,,,,2,2,1,3
42137_0,,,,2,2,1,3
42138_0,,,,2,2,1,3
42139_0,,,,2,2,1,3
42140_0,,,,2,2,1,3
42141_0,,,,2,2,1,3
42142_0,,,,2,2,1,3
42143_0,,,,2,2,1,3
42144_0,,,,2,2,1,3
42145_0,,,,2,2,1,3
42146_0,,,,2,2,1,3
42147_0,,,,2,2,1,3
42148_0,,,,2,2,1,3
42149_0,,,,2,2,1,3
42150_0,,,,2,2,1,3
42151_0,,,,2,2,1,3
42152_0,,,,2,2,1,3
42153_0,,,,2,2,1,3
42154_0,,,,2,2,1,3
42155_0,,,,2,2,1,3
42156_0,,,,2,2,1,3
42157_0,,,,2,2,1,3
42158_0,,,,2,2,1,3
42159_0,,,,2,2,1,3
42160_0,,,,2,2,1,3
42161_0,,,,2,2,1,3
42162_0,,,,2,2,1,3
42163_0,,,,2,2,1,3
42164_0,,,,2,2,1,3
42165_0,,,,2,2,1,3
42166_0,,,,2,2,1,3
42167_0,,,,2,2,1,3
42168_0,,,,2,2,1,3
42169_0,,,,2,2,1,3
42170_0,,,,2,2,1,3
42171_0,,,,2,2,1,3
42172_0,,,,2,2,1,3
42173_0,,,,2,2,1,3
42174_0,,,,2,2,1,3
42176_0,,,,2,2,1,3
C(CC(C(C(C)O)O)O)(O)=O,,,5,1,1,0,1
42177_0,,,,2,2,1,3
42178_0,,,,2,2,1,3
42179_0,,,,2,2,1,3
42180_0,,,,2,2,1,3
42181_0,,,,2,2,1,3
42182_0,,,,2,2,1,3
42183_0,,,,2,2,1,3
42184_0,,,,2,2,1,3
42185_0,,,,2,2,1,3
42186_0,,,,2,2,1,3
42187_0,,,,2,2,1,3
42188_0,,,,2,2,1,3
42189_0,,,,2,2,1,3
42190_0,,,,2,2,1,3
42191_0,,,,2,2,1,3
42192_0,,,,2,2,1,3
42193_0,,,,2,2,1,3
42194_0,,,,2,2,1,3
42195_0,,,,2,2,1,3
42196_0,,,,2,2,1,3
42197_0,,,,2,2,1,3
42198_0,,,,2,2,1,3
42199_0,,,,2,2,1,3
42200_0,,,,2,2,1,3
42201_0,,,,2,2,1,3
42202_0,,,,2,2,1,3
42203_0,,,,2,2,1,3
42204_0,,,,2,2,1,3
42205_0,,,,2,2,1,3
42206_0,,,,2,2,1,3
42207_0,,,,2,2,1,3
42209_0,,,,2,2,1,3
C(CC(C([CH]C(O)=O)O)O)(O)=O,,,5,1,1,0,1
42210_0,,,,2,2,1,3
42212_0,,,,2,2,1,3
C(CC(C(CC(O)=O)O)O)(O)=O,,,5,1,1,0,1
42213_0,,,,2,2,1,3
42214_0,,,,2,2,1,3
42215_0,,,,2,2,1,3
42216_0,,,,2,2,1,3
42217_0,,,,2,2,1,3
42218_0,,,,2,2,1,3
42219_0,,,,2,2,1,3
42220_0,,,,2,2,1,3
42221_0,,,,2,2,1,3
42222_0,,,,2,2,1,3
42223_0,,,,2,2,1,3
42224_0,,,,2,2,1,3
42225_0,,,,2,2,1,3
42226_0,,,,2,2,1,3
42227_0,,,,2,2,1,3
42228_0,,,,2,2,1,3
42229_0,,,,2,2,1,3
42230_0,,,,2,2,1,3
42231_0,,,,2,2,1,3
42232_0,,,,2,2,1,3
42234_0,,,,2,2,1,3
C=C(C(C(CO)O)=O)C(C(O)=O)=O,,,5,1,1,0,1
42235_0,,,,2,2,1,3
42236_0,,,,2,2,1,3
42237_0,,,,2,2,1,3
42238_0,,,,2,2,1,3
42239_0,,,,2,2,1,3
42240_0,,,,2,2,1,3
42241_0,,,,2,2,1,3
42242_0,,,,2,2,1,3
42243_0,,,,2,2,1,3
42244_0,,,,2,2,1,3
42245_0,,,,2,2,1,3
42246_0,,,,2,2,1,3
42247_0,,,,2,2,1,3
42248_0,,,,2,2,1,3
42249_0,,,,2,2,1,3
42250_0,,,,2,2,1,3
42251_0,,,,2,2,1,3
42252_0,,,,2,2,1,3
42253_0,,,,2,2,1,3
42254_0,,,,2,2,1,3
42255_0,,,,2,2,1,3
42256_0,,,,2,2,1,3
42257_0,,,,2,2,1,3
42258_0,,,,2,2,1,3
42259_0,,,,2,2,1,3
42260_0,,,,2,2,1,3
42262_0,,,,2,2,1,3
C1(C(C(C(C(CO)O)(O)O1)O)O)=O,,,5,1,3,0,3
42263_0,,,,2,2,1,3
42264_0,,,,2,2,1,3
42265_0,,,,2,2,1,3
42266_0,,,,2,2,1,3
42267_0,,,,2,2,1,3
42269_0,,,,2,2,1,3
CC(CC1C(C(C(O)O1)O)O)O,,,5,1,2,0,2
42271_0,,,,2,2,1,3
CC1C(CO)(C(C(CO)(O)O1)O)O,,,5,1,2,0,2
42273_0,,,,2,2,1,3
CC1C(CO)(C(C(O)O1)(CO)O)O,,,5,1,2,0,2
42275_0,,,,2,2,1,3
CC1(C(O)OC(C)C1(CO)O)O,,,5,1,2,0,2
42277_0,,,,2,2,1,3
CC1(C(C(CO)(C(C)O1)O)O)O,,,5,1,2,0,2
42279_0,,,,2,2,1,3
C(CC1C(C(C(O)O1)O)O)(O)=O,,,5,1,2,0,2
42280_0,,,,2,2,1,3
42281_0,,,,2,2,1,3
42282_0,,,,2,2,1,3
42283_0,,,,2,2,1,3
42285_0,,,,2,2,1,3
C(CO)(C1C(C(C(O1)O)O)O)=O,,,5,1,2,0,2
42287_0,,,,2,2,1,3
C(C1(CO)C(C(C(O1)O)O)O)=O,,,5,1,2,0,2
42289_0,,,,2,2,1,3
C1(C(O)OC(C(CO)O)C1O)=O,,,5,1,2,0,2
42291_0,,,,2,2,1,3
C(C1(C)C(C(C(O1)O)O)O)=O,,,5,1,2,0,2
42293_0,,,,2,2,1,3
C(C)(C1C(C(C(O1)O)O)O)=O,,,5,1,2,0,2
42295_0,,,,2,2,1,3
C1(C(O)OC(C(CO)O)C1)=O,,,5,1,2,0,2
42297_0,,,,2,2,1,3
C1C(C(C(O)O1)O)O,,,5,1,2,0,2
42299_0,,,,2,2,1,3
C(C1(CO)C(C(C(O1)O)O)O)(O)=O,,,5,1,2,0,2
42301_0,,,,2,2,1,3
CC1C(C(C(O)O1)O)O,,,5,1,2,0,2
42303_0,,,,2,2,1,3
C1(C(C(C(O)O1)O)O)=O,,,5,1,2,0,2
42305_0,,,,2,2,1,3
C(C1(C)C(C(C(O1)O)O)O)(O)=O,,,5,1,2,0,2
42307_0,,,,2,2,1,3
[C]1(C(O)=O)C(C(C(C)(O)O1)O)O,,,5,1,2,0,2
42309_0,,,,2,2,1,3
[C]1(C(OC(C(CO)O)(C1)O)=O)O,,,5,1,2,0,2
42311_0,,,,2,2,1,3
C(C1C(C(C(C)(O1)O)O)O)(O)=O,,,5,1,2,0,2
42313_0,,,,2,2,1,3
C1(C(CC(C(CO)O)(O)O1)O)=O,,,5,1,2,0,2
42315_0,,,,2,2,1,3
C(C1(C(C(C(CO)O1)O)O)O)(O)=O,,,5,1,2,0,2
42317_0,,,,2,2,1,3
C1(C(C(C(C(CO)(O)O1)O)O)O)=O,,,5,1,2,0,2
42319_0,,,,2,2,1,3
C(C1(COC(C(C1O)O)O)O)=O,,,5,1,2,0,2
42321_0,,,,2,2,1,3
C1(C(C(C(CO)(C(O)O1)O)O)O)=O,,,5,1,2,0,2
42323_0,,,,2,2,1,3
C1(C(C(C(C)(C(O)O1)O)O)O)=O,,,5,1,2,0,2
42325_0,,,,2,2,1,3
C1(C(C(C(C(C)(O)O1)O)O)O)=O,,,5,1,3,0,3
42327_0,,,,2,2,1,3
C(C1(COC(C(C1O)O)O)O)(O)=O,,,5,1,2,0,2
42329_0,,,,2,2,1,3
C1(C(CO)(C(C(C(O)O1)O)O)O)=O,,,5,1,2,0,2
42331_0,,,,2,2,1,3
C1(C(C)(C(C(C(O)O1)O)O)O)=O,,,5,1,2,0,2
42333_0,,,,2,2,1,3
[C]1(C(OC(C)(C(C1O)O)O)=O)O,,,5,1,2,0,2
42334_0,,,,2,2,1,3
42336_0,,,,2,2,1,3
C(C1(C(C(C(CO1)O)O)O)O)(O)=O,,,5,1,2,0,2
42338_0,,,,2,2,1,3
CC1CC(C(C(C(O)O1)O)O)O,,,5,1,2,0,2
42340_0,,,,2,2,1,3
C1(CC(C(C(C(O)O1)O)O)O)=O,,,5,1,2,0,2
42342_0,,,,2,2,1,3
C1(COC(C(C(C1O)O)O)O)=O,,,5,1,2,0,2
42344_0,,,,2,2,1,3
[CH]1C(OC(C(C(C1)O)O)O)=O,,,5,1,2,0,2
42346_0,,,,2,2,1,3
C1(CCC(C(C(O)O1)O)O)=O,,,5,1,2,0,2
42347_0,,,,2,2,1,3
42349_0,,,,2,2,1,3
C1(C(CO)(C(CO)(C(C)O1)O)O)=O,,,5,1,1,0,1
42351_0,,,,2,2,1,3
C1(C(C)(C(CO)(C(C)O1)O)O)=O,,,5,1,2,0,2
42353_0,,,,2,2,1,3
C1(C(C(CO1)(C(C)O)O)O)=O,,,5,1,2,0,2
42354_0,,,,2,2,1,3
42355_0,,,,2,2,1,3
42356_0,,,,2,2,1,3
42357_0,,,,2,2,1,3
42359_0,,,,2,2,1,3
C1(C(C)(CC(C(CO)O)O1)O)=O,,,5,1,2,0,2
42360_0,,,,2,2,1,3
42361_0,,,,2,2,1,3
42363_0,,,,2,2,1,3
C1(C(C(C(C(C)=O)=O)(CO1)O)O)=O,,,5,1,1,0,1
42365_0,,,,2,2,1,3
C(C(CO)O)(C1C(C(OC1)=O)=O)=O,,,5,1,1,0,1
42366_0,,,,2,2,1,3
42367_0,,,,2,2,1,3
42368_0,,,,2,2,1,3
42369_0,,,,2,2,1,3
42371_0,,,,2,2,1,3
C1(C(C(C(C(CO)O)O1)O)=O)=O,,,5,1,2,0,2
42372_0,,,,2,2,1,3
42374_0,,,,2,2,1,3
C1(C(CC(C(CO)O)O1)=O)=O,,,5,1,2,0,2
42376_0,,,,2,2,1,3
C1(C(C(C(C(O)=O)=C)(CO1)O)O)=O,,,5,1,1,0,1
42378_0,,,,2,2,1,3
C(C(C1(C(C(OC1)=O)=C)O)O)(O)=O,,,5,1,1,0,1
42380_0,,,,2,2,1,3
C1(C2(C)C(CO1)(C(C(O2)=O)O)O)=O,,,5,1,1,0,1
42381_0,,,,2,2,1,3
42382_0,,,,2,2,1,3
42384_0,,,,2,2,1,3
[CH]1C(OC(C)(C(CO)O)C1)=O,,,5,1,2,0,2
42386_0,,,,2,2,1,3
C1(CCC(C)(C(CO)O)O1)=O,,,5,1,2,0,2
42387_0,,,,2,2,1,3
42389_0,,,,2,2,1,3
C1(CC(C(CO)(C(C)O1)O)O)=O,,,5,1,2,0,2
42390_0,,,,2,2,1,3
42391_0,,,,2,2,1,3
42392_0,,,,2,2,1,3
42393_0,,,,2,2,1,3
42394_0,,,,2,2,1,3
42395_0,,,,2,2,1,3
42397_0,,,,2,2,1,3
C1(C(C(C(C(CO)O1)O)O)=O)=O,,,5,1,2,0,2
42399_0,,,,2,2,1,3
C(C1COC(C(C1O)O)=O)(O)=O,,,5,1,2,0,2
42401_0,,,,2,2,1,3
[CH]1C(OC(C)C(CO)(C1)O)=O,,,5,1,2,0,2
42403_0,,,,2,2,1,3
C1(CCC(CO)(C(C)O1)O)=O,,,5,1,2,0,2
42405_0,,,,2,2,1,3
[CH]1C(OC(CC1)C(CO)O)=O,,,5,1,2,0,2
42407_0,,,,2,2,1,3
C1(CCCC(C(CO)O)O1)=O,,,5,1,2,0,2
42408_0,,,,2,2,1,3
42409_0,,,,2,2,1,3
42410_0,,,,2,2,1,3
42411_0,,,,2,2,1,3
42412_0,,,,2,2,1,3
42414_0,,,,2,2,1,3
C1(C(C(C(OCC1O)=O)O)O)=O,,,5,1,2,0,2
42416_0,,,,2,2,1,3
C1(C(C(C(C(CO1)O)O)O)=O)=O,,,5,1,2,0,2
42417_0,,,,2,2,1,3
42418_0,,,,2,2,1,3
42420_0,,,,2,2,1,3
C(C(CC(C(C)C(CO)O)O)=O)=O,,,5,1,1,0,1
42421_0,,,,2,2,1,3
42422_0,,,,2,2,1,3
42423_0,,,,2,2,1,3
42425_0,,,,2,2,1,3
C(C(C(CO)C(C)C(CO)O)=O)=O,,,5,1,1,0,1
42427_0,,,,2,2,1,3
C(CC(C)C(CO)(C(C=O)O)O)=O,,,5,1,3,0,3
42428_0,,,,2,2,1,3
42429_0,,,,2,2,1,3
42431_0,,,,2,2,1,3
C(CC(C(C)C(CO)O)O)=O,,,5,1,1,0,1
42432_0,,,,2,2,1,3
42433_0,,,,2,2,1,3
42434_0,,,,2,2,1,3
42436_0,,,,2,2,1,3
C(C(C=O)(C(C)C(CO)O)O)=O,,,5,1,1,0,1
42438_0,,,,2,2,1,3
C(C(C=O)(C(C)C(CO)O)O)(O)=O,,,5,1,1,0,1
42440_0,,,,2,2,1,3
CC(C(CO)O)C(CO)C(C)O,,,5,1,1,0,1
42442_0,,,,2,2,1,3
CC(CC(C(C)C(CO)O)O)O,,,5,1,1,0,1
42444_0,,,,2,2,1,3
CC(CC(CCO)O)C(CO)O,,,5,1,1,0,1
42446_0,,,,2,2,1,3
CC(CCO)(C(C)C(CO)O)O,,,5,1,1,0,1
42448_0,,,,2,2,1,3
C(C(CO)C(C)C(CO)O)(O)=O,,,5,1,1,0,1
42450_0,,,,2,2,1,3
C(CC(C(C)C(CO)O)O)(O)=O,,,5,1,1,0,1
42452_0,,,,2,2,1,3
C(CO)(C(C(C)C(CO)O)O)=O,,,5,1,1,0,1
42454_0,,,,2,2,1,3
C(CO)(CC(C)C(CO)O)=O,,,5,1,1,0,1
42455_0,,,,2,2,1,3
42457_0,,,,2,2,1,3
C(C)(C(C(C)C(CO)O)O)=O,,,5,1,1,0,1
42458_0,,,,2,2,1,3
42459_0,,,,2,2,1,3
42460_0,,,,2,2,1,3
42462_0,,,,2,2,1,3
CC(CO)C(CO)O,,,5,1,1,0,1
42464_0,,,,2,2,1,3
C(C(C(C(CO)C)O)O)(O)=O,,,5,1,1,0,1
42466_0,,,,2,2,1,3
C(C(CCO)C(CO)O)(O)=O,,,5,1,2,0,2
42467_0,,,,2,2,1,3
42469_0,,,,2,2,1,3
C(C(C)C(CO)(CO)O)(O)=O,,,5,1,1,0,1
42471_0,,,,2,2,1,3
C1(C(C)C(CO)(C(C(O1)=O)O)O)=O,,,5,1,1,0,1
42473_0,,,,2,2,1,3
C1(C(CO)(C)C(C(C(O1)=O)O)O)=O,,,5,1,1,0,1
42475_0,,,,2,2,1,3
C1(C(C(C(C(O1)=O)O)O)CCO)=O,,,5,1,2,0,2
42476_0,,,,2,2,1,3
42477_0,,,,2,2,1,3
42479_0,,,,2,2,1,3
C(C(CCCO)C(CO)O)(O)=O,,,5,1,2,0,2
42480_0,,,,2,2,1,3
42482_0,,,,2,2,1,3
C(C(C)C(CO)(CCO)O)(O)=O,,,5,1,1,0,1
42484_0,,,,2,2,1,3
CC(C(C)O)C(CO)O,,,5,1,1,0,1
42486_0,,,,2,2,1,3
C(C(C(C(C)C(C)O)O)O)(O)=O,,,5,1,1,0,1
42488_0,,,,2,2,1,3
C(C(CC(C)O)C(CO)O)(O)=O,,,5,1,2,0,2
42489_0,,,,2,2,1,3
42491_0,,,,2,2,1,3
C(C(C)C(CO)(C(C)O)O)(O)=O,,,5,1,1,0,1
42493_0,,,,2,2,1,3
C(C(C(C)O)C(C)C(CO)O)(O)=O,,,5,1,1,0,1
42495_0,,,,2,2,1,3
C(CC(CC(C)C(CO)O)O)(O)=O,,,5,1,1,0,1
42497_0,,,,2,2,1,3
C(CC(C)(C(C)C(CO)O)O)(O)=O,,,5,1,1,0,1
42499_0,,,,2,2,1,3
C(C(C(O)=O)C(C)C(CO)O)(O)=O,,,5,1,1,0,1
42500_0,,,,2,2,1,3
42501_0,,,,2,2,1,3
42502_0,,,,2,2,1,3
42503_0,,,,2,2,1,3
42505_0,,,,2,2,1,3
C(C(C)C(CO)(CC(O)=O)O)(O)=O,,,5,1,1,0,1
42507_0,,,,2,2,1,3
C(CC(C)C(CO)O)=CC=O,,,5,1,1,0,1
42508_0,,,,2,2,1,3
42510_0,,,,2,2,1,3
C(C(C=C)C(C)C(CO)O)=O,,,5,1,1,0,1
42512_0,,,,2,2,1,3
CC(C(CO)O)C(CO)(C(C)O)O,,,5,1,1,0,1
42514_0,,,,2,2,1,3
CC(C(C(C(C)C(CO)O)O)O)O,,,5,1,1,0,1
42516_0,,,,2,2,1,3
CC(CC(C(CO)O)O)C(CO)O,,,5,1,1,0,1
42518_0,,,,2,2,1,3
CC(C(CO)O)(C(C)C(CO)O)O,,,5,1,1,0,1
42520_0,,,,2,2,1,3
C(C(C(C(C)C(CO)O)O)O)=O,,,5,1,1,0,1
42522_0,,,,2,2,1,3
C(C(CO)(C(C)C(CO)O)O)=O,,,5,1,1,0,1
42524_0,,,,2,2,1,3
[CH](C(O)=O)C(C(C)C(CO)O)O,,,5,1,1,0,1
42526_0,,,,2,2,1,3
[C](C(O)=O)(CO)C(C)C(CO)O,,,5,1,1,0,1
42528_0,,,,2,2,1,3
C(C(C(C)C(CO)O)O)=O,,,5,1,1,0,1
42530_0,,,,2,2,1,3
[C](C(O)=O)(C(C(C)C(CO)O)O)O,,,5,1,1,0,1
42532_0,,,,2,2,1,3
C(C(CC(C)C(CO)O)O)=O,,,5,1,1,0,1
42534_0,,,,2,2,1,3
C(C(C)(C(C)C(CO)O)O)=O,,,5,1,1,0,1
42536_0,,,,2,2,1,3
C(C(C(C(C)C(CO)O)O)O)(O)=O,,,5,1,2,0,2
42538_0,,,,2,2,1,3
C(C(CO)(C(C)C(CO)O)O)(O)=O,,,5,1,1,0,1
42539_0,,,,2,2,1,3
42541_0,,,,2,2,1,3
[C](C(O)=O)(CC(C)C(CO)O)O,,,5,1,2,0,2
42543_0,,,,2,2,1,3
C(C(CC(C)C(CO)O)O)(O)=O,,,5,1,2,0,2
42545_0,,,,2,2,1,3
C(C(C)(C(C)C(CO)O)O)(O)=O,,,5,1,1,0,1
42546_0,,,,2,2,1,3
42547_0,,,,2,2,1,3
42548_0,,,,2,2,1,3
42549_0,,,,2,2,1,3
42550_0,,,,2,2,1,3
42552_0,,,,2,2,1,3
C(CC(C)(C(C)C(CO)O)O)=O,,,5,1,1,0,1
42553_0,,,,2,2,1,3
42554_0,,,,2,2,1,3
42556_0,,,,2,2,1,3
C(C(C(C(C)C(CO)O)O)=O)=O,,,5,1,1,0,1
42557_0,,,,2,2,1,3
42559_0,,,,2,2,1,3
C(C(CC(C)C(CO)O)=O)=O,,,5,1,2,0,2
42561_0,,,,2,2,1,3
C(C(C(C)C(CO)O)O)(O)=O,,,5,1,1,0,1
42563_0,,,,2,2,1,3
CC(C(CO)O)C(CO)O,,,5,1,1,0,1
42565_0,,,,2,2,1,3
C(C(C(C(C)C(CO)O)O)=O)(O)=O,,,5,1,1,0,1
42566_0,,,,2,2,1,3
42567_0,,,,2,2,1,3
42569_0,,,,2,2,1,3
C(C(C(C(C)C(C=O)O)O)O)(O)=O,,,5,1,1,0,1
42570_0,,,,2,2,1,3
42572_0,,,,2,2,1,3
C(C(CC(C=O)O)C(CO)O)(O)=O,,,5,1,2,0,2
42573_0,,,,2,2,1,3
42575_0,,,,2,2,1,3
C(C(CCC=O)C(CO)O)(O)=O,,,5,1,2,0,2
42577_0,,,,2,2,1,3
C(C(CC(CO)O)C(CO)O)(O)=O,,,5,1,2,0,2
42578_0,,,,2,2,1,3
42579_0,,,,2,2,1,3
42580_0,,,,2,2,1,3
42581_0,,,,2,2,1,3
42582_0,,,,2,2,1,3
42583_0,,,,2,2,1,3
42585_0,,,,2,2,1,3
C(C(C)C(CO)(C(CO)O)O)(O)=O,,,5,1,1,0,1
42586_0,,,,2,2,1,3
42587_0,,,,2,2,1,3
42589_0,,,,2,2,1,3
[C](C(O)=O)(CC(C(CO)O)O)O,,,5,1,2,0,2
42590_0,,,,2,2,1,3
42591_0,,,,2,2,1,3
42592_0,,,,2,2,1,3
42593_0,,,,2,2,1,3
42594_0,,,,2,2,1,3
42595_0,,,,2,2,1,3
42596_0,,,,2,2,1,3
42597_0,,,,2,2,1,3
42598_0,,,,2,2,1,3
42599_0,,,,2,2,1,3
42600_0,,,,2,2,1,3
42601_0,,,,2,2,1,3
42602_0,,,,2,2,1,3
42603_0,,,,2,2,1,3
42604_0,,,,2,2,1,3
42605_0,,,,2,2,1,3
42606_0,,,,2,2,1,3
42607_0,,,,2,2,1,3
42608_0,,,,2,2,1,3
42609_0,,,,2,2,1,3
42610_0,,,,2,2,1,3
42611_0,,,,2,2,1,3
42612_0,,,,2,2,1,3
42613_0,,,,2,2,1,3
42614_0,,,,2,2,1,3
42615_0,,,,2,2,1,3
42616_0,,,,2,2,1,3
42617_0,,,,2,2,1,3
42618_0,,,,2,2,1,3
42619_0,,,,2,2,1,3
42620_0,,,,2,2,1,3
42621_0,,,,2,2,1,3
42622_0,,,,2,2,1,3
42623_0,,,,2,2,1,3
42624_0,,,,2,2,1,3
42625_0,,,,2,2,1,3
42626_0,,,,2,2,1,3
42627_0,,,,2,2,1,3
42628_0,,,,2,2,1,3
42629_0,,,,2,2,1,3
42630_0,,,,2,2,1,3
42631_0,,,,2,2,1,3
42632_0,,,,2,2,1,3
42633_0,,,,2,2,1,3
42634_0,,,,2,2,1,3
42635_0,,,,2,2,1,3
42636_0,,,,2,2,1,3
42637_0,,,,2,2,1,3
42638_0,,,,2,2,1,3
42639_0,,,,2,2,1,3
42640_0,,,,2,2,1,3
42641_0,,,,2,2,1,3
42642_0,,,,2,2,1,3
42643_0,,,,2,2,1,3
42644_0,,,,2,2,1,3
42645_0,,,,2,2,1,3
42646_0,,,,2,2,1,3
42647_0,,,,2,2,1,3
42648_0,,,,2,2,1,3
42649_0,,,,2,2,1,3
42650_0,,,,2,2,1,3
42651_0,,,,2,2,1,3
42652_0,,,,2,2,1,3
42653_0,,,,2,2,1,3
42654_0,,,,2,2,1,3
42655_0,,,,2,2,1,3
42656_0,,,,2,2,1,3
42657_0,,,,2,2,1,3
42658_0,,,,2,2,1,3
42659_0,,,,2,2,1,3
42660_0,,,,2,2,1,3
42661_0,,,,2,2,1,3
42662_0,,,,2,2,1,3
42663_0,,,,2,2,1,3
42664_0,,,,2,2,1,3
42665_0,,,,2,2,1,3
42666_0,,,,2,2,1,3
42667_0,,,,2,2,1,3
42668_0,,,,2,2,1,3
42669_0,,,,2,2,1,3
42670_0,,,,2,2,1,3
42671_0,,,,2,2,1,3
42672_0,,,,2,2,1,3
42673_0,,,,2,2,1,3
42674_0,,,,2,2,1,3
42675_0,,,,2,2,1,3
42676_0,,,,2,2,1,3
42677_0,,,,2,2,1,3
42678_0,,,,2,2,1,3
42679_0,,,,2,2,1,3
42680_0,,,,2,2,1,3
42681_0,,,,2,2,1,3
42682_0,,,,2,2,1,3
42683_0,,,,2,2,1,3
42684_0,,,,2,2,1,3
42685_0,,,,2,2,1,3
42686_0,,,,2,2,1,3
42687_0,,,,2,2,1,3
42688_0,,,,2,2,1,3
42689_0,,,,2,2,1,3
42690_0,,,,2,2,1,3
42691_0,,,,2,2,1,3
42692_0,,,,2,2,1,3
42693_0,,,,2,2,1,3
42694_0,,,,2,2,1,3
42695_0,,,,2,2,1,3
42696_0,,,,2,2,1,3
42697_0,,,,2,2,1,3
42698_0,,,,2,2,1,3
42699_0,,,,2,2,1,3
42700_0,,,,2,2,1,3
42701_0,,,,2,2,1,3
42702_0,,,,2,2,1,3
42703_0,,,,2,2,1,3
42704_0,,,,2,2,1,3
42705_0,,,,2,2,1,3
42706_0,,,,2,2,1,3
42707_0,,,,2,2,1,3
42708_0,,,,2,2,1,3
42709_0,,,,2,2,1,3
42710_0,,,,2,2,1,3
42711_0,,,,2,2,1,3
42712_0,,,,2,2,1,3
42713_0,,,,2,2,1,3
42714_0,,,,2,2,1,3
42715_0,,,,2,2,1,3
42716_0,,,,2,2,1,3
42717_0,,,,2,2,1,3
42718_0,,,,2,2,1,3
42719_0,,,,2,2,1,3
42720_0,,,,2,2,1,3
42721_0,,,,2,2,1,3
42722_0,,,,2,2,1,3
42723_0,,,,2,2,1,3
42724_0,,,,2,2,1,3
42725_0,,,,2,2,1,3
42726_0,,,,2,2,1,3
42727_0,,,,2,2,1,3
42728_0,,,,2,2,1,3
42729_0,,,,2,2,1,3
42730_0,,,,2,2,1,3
42731_0,,,,2,2,1,3
42732_0,,,,2,2,1,3
42733_0,,,,2,2,1,3
42734_0,,,,2,2,1,3
42735_0,,,,2,2,1,3
42736_0,,,,2,2,1,3
42737_0,,,,2,2,1,3
42738_0,,,,2,2,1,3
42739_0,,,,2,2,1,3
42740_0,,,,2,2,1,3
42741_0,,,,2,2,1,3
42742_0,,,,2,2,1,3
42743_0,,,,2,2,1,3
42744_0,,,,2,2,1,3
42745_0,,,,2,2,1,3
42746_0,,,,2,2,1,3
42747_0,,,,2,2,1,3
42748_0,,,,2,2,1,3
42749_0,,,,2,2,1,3
42750_0,,,,2,2,1,3
42751_0,,,,2,2,1,3
42752_0,,,,2,2,1,3
42753_0,,,,2,2,1,3
42754_0,,,,2,2,1,3
42755_0,,,,2,2,1,3
42756_0,,,,2,2,1,3
42757_0,,,,2,2,1,3
42758_0,,,,2,2,1,3
42759_0,,,,2,2,1,3
42760_0,,,,2,2,1,3
42761_0,,,,2,2,1,3
42762_0,,,,2,2,1,3
42763_0,,,,2,2,1,3
42764_0,,,,2,2,1,3
42765_0,,,,2,2,1,3
42766_0,,,,2,2,1,3
42767_0,,,,2,2,1,3
42768_0,,,,2,2,1,3
42769_0,,,,2,2,1,3
42770_0,,,,2,2,1,3
42771_0,,,,2,2,1,3
42772_0,,,,2,2,1,3
42773_0,,,,2,2,1,3
42774_0,,,,2,2,1,3
42775_0,,,,2,2,1,3
42776_0,,,,2,2,1,3
42777_0,,,,2,2,1,3
42778_0,,,,2,2,1,3
42779_0,,,,2,2,1,3
42780_0,,,,2,2,1,3
42781_0,,,,2,2,1,3
42782_0,,,,2,2,1,3
42783_0,,,,2,2,1,3
42784_0,,,,2,2,1,3
42785_0,,,,2,2,1,3
42786_0,,,,2,2,1,3
42787_0,,,,2,2,1,3
42788_0,,,,2,2,1,3
42789_0,,,,2,2,1,3
42790_0,,,,2,2,1,3
42791_0,,,,2,2,1,3
42792_0,,,,2,2,1,3
42793_0,,,,2,2,1,3
42794_0,,,,2,2,1,3
42795_0,,,,2,2,1,3
42796_0,,,,2,2,1,3
42797_0,,,,2,2,1,3
42798_0,,,,2,2,1,3
42799_0,,,,2,2,1,3
42800_0,,,,2,2,1,3
42801_0,,,,2,2,1,3
42802_0,,,,2,2,1,3
42803_0,,,,2,2,1,3
42804_0,,,,2,2,1,3
42805_0,,,,2,2,1,3
42806_0,,,,2,2,1,3
42807_0,,,,2,2,1,3
42808_0,,,,2,2,1,3
42809_0,,,,2,2,1,3
42810_0,,,,2,2,1,3
42811_0,,,,2,2,1,3
42812_0,,,,2,2,1,3
42813_0,,,,2,2,1,3
42814_0,,,,2,2,1,3
42815_0,,,,2,2,1,3
42816_0,,,,2,2,1,3
42817_0,,,,2,2,1,3
42818_0,,,,2,2,1,3
42819_0,,,,2,2,1,3
42820_0,,,,2,2,1,3
42821_0,,,,2,2,1,3
42822_0,,,,2,2,1,3
42823_0,,,,2,2,1,3
42824_0,,,,2,2,1,3
42826_0,,,,2,2,1,3
C(C(C(C)O)(CCC(C)O)O)=O,,,5,1,1,0,1
42827_0,,,,2,2,1,3
42829_0,,,,2,2,1,3
C(C(CC(C(C)O)O)C(C)O)=O,,,5,1,2,0,2
42830_0,,,,2,2,1,3
42831_0,,,,2,2,1,3
42832_0,,,,2,2,1,3
42834_0,,,,2,2,1,3
C(C(C=O)CC(C(C)O)O)(O)=O,,,5,1,2,0,2
42835_0,,,,2,2,1,3
42837_0,,,,2,2,1,3
C(C(C(CC(C(C)O)O)O)=O)=O,,,5,1,1,0,1
42838_0,,,,2,2,1,3
42840_0,,,,2,2,1,3
C(C(C(CCC(C)O)O)=O)=O,,,5,1,1,0,1
42841_0,,,,2,2,1,3
42843_0,,,,2,2,1,3
C(C(CCC(C(C)O)O)=O)=O,,,5,1,2,0,2
42844_0,,,,2,2,1,3
42846_0,,,,2,2,1,3
C(C(C(CC(C(C)O)O)O)=O)(O)=O,,,5,1,1,0,1
42847_0,,,,2,2,1,3
42849_0,,,,2,2,1,3
C(C(CCC(C)O)O)=O,,,5,1,1,0,1
42850_0,,,,2,2,1,3
42852_0,,,,2,2,1,3
C(CCC(C(C)O)O)=O,,,5,1,2,0,2
42853_0,,,,2,2,1,3
42855_0,,,,2,2,1,3
C(C(C(CCC(C)O)O)=O)(O)=O,,,5,1,1,0,1
42856_0,,,,2,2,1,3
42858_0,,,,2,2,1,3
C(C(CCC(C(C)O)O)=O)(O)=O,,,5,1,2,0,2
42859_0,,,,2,2,1,3
42861_0,,,,2,2,1,3
C(C(CC(C(O)=O)O)C(C)O)=O,,,5,1,3,0,3
42862_0,,,,2,2,1,3
42863_0,,,,2,2,1,3
42864_0,,,,2,2,1,3
42865_0,,,,2,2,1,3
42866_0,,,,2,2,1,3
42867_0,,,,2,2,1,3
42868_0,,,,2,2,1,3
42869_0,,,,2,2,1,3
42870_0,,,,2,2,1,3
42871_0,,,,2,2,1,3
42872_0,,,,2,2,1,3
42873_0,,,,2,2,1,3
42874_0,,,,2,2,1,3
42875_0,,,,2,2,1,3
42877_0,,,,2,2,1,3
C(C(C)C(C=O)(C(C)O)O)=O,,,5,1,1,0,1
42878_0,,,,2,2,1,3
42879_0,,,,2,2,1,3
42880_0,,,,2,2,1,3
42882_0,,,,2,2,1,3
C(C(C(C)O)(CC(C)=O)O)=O,,,5,1,1,0,1
42883_0,,,,2,2,1,3
42884_0,,,,2,2,1,3
42885_0,,,,2,2,1,3
42886_0,,,,2,2,1,3
42887_0,,,,2,2,1,3
42888_0,,,,2,2,1,3
42889_0,,,,2,2,1,3
42890_0,,,,2,2,1,3
42891_0,,,,2,2,1,3
42892_0,,,,2,2,1,3
42893_0,,,,2,2,1,3
42894_0,,,,2,2,1,3
42895_0,,,,2,2,1,3
42896_0,,,,2,2,1,3
42897_0,,,,2,2,1,3
42898_0,,,,2,2,1,3
42899_0,,,,2,2,1,3
42900_0,,,,2,2,1,3
42901_0,,,,2,2,1,3
42902_0,,,,2,2,1,3
42904_0,,,,2,2,1,3
C(C(CC(C)O)C(C=O)O)(O)=O,,,5,1,1,0,1
42905_0,,,,2,2,1,3
42907_0,,,,2,2,1,3
C(C(C(C(C)O)O)CC=O)(O)=O,,,5,1,1,0,1
42908_0,,,,2,2,1,3
42909_0,,,,2,2,1,3
42910_0,,,,2,2,1,3
42911_0,,,,2,2,1,3
42912_0,,,,2,2,1,3
42913_0,,,,2,2,1,3
42914_0,,,,2,2,1,3
42915_0,,,,2,2,1,3
42916_0,,,,2,2,1,3
42917_0,,,,2,2,1,3
42918_0,,,,2,2,1,3
42919_0,,,,2,2,1,3
42920_0,,,,2,2,1,3
42921_0,,,,2,2,1,3
42922_0,,,,2,2,1,3
42923_0,,,,2,2,1,3
42924_0,,,,2,2,1,3
42926_0,,,,2,2,1,3
C(C(CCC(C=O)=O)O)(O)=O,,,5,1,3,0,3
42927_0,,,,2,2,1,3
42929_0,,,,2,2,1,3
C(C(CC(C(C(O)=O)=O)O)O)(O)=O,,,5,1,2,0,2
42930_0,,,,2,2,1,3
42931_0,,,,2,2,1,3
42932_0,,,,2,2,1,3
42934_0,,,,2,2,1,3
C(CCC(C(O)=O)O)=O,,,5,1,3,0,3
42935_0,,,,2,2,1,3
42936_0,,,,2,2,1,3
42937_0,,,,2,2,1,3
42939_0,,,,2,2,1,3
C(C(CCC(C(O)=O)=O)O)(O)=O,,,5,1,3,0,3
42940_0,,,,2,2,1,3
42941_0,,,,2,2,1,3
42942_0,,,,2,2,1,3
42943_0,,,,2,2,1,3
42944_0,,,,2,2,1,3
42945_0,,,,2,2,1,3
42946_0,,,,2,2,1,3
42947_0,,,,2,2,1,3
42948_0,,,,2,2,1,3
42949_0,,,,2,2,1,3
42950_0,,,,2,2,1,3
42951_0,,,,2,2,1,3
42952_0,,,,2,2,1,3
42953_0,,,,2,2,1,3
42954_0,,,,2,2,1,3
42956_0,,,,2,2,1,3
C(C(C)(CCC(C=O)O)O)(O)=O,,,5,1,1,0,1
42957_0,,,,2,2,1,3
42959_0,,,,2,2,1,3
C(C(C)(C(CCC=O)O)O)(O)=O,,,5,1,2,0,2
42960_0,,,,2,2,1,3
42961_0,,,,2,2,1,3
42962_0,,,,2,2,1,3
42963_0,,,,2,2,1,3
42964_0,,,,2,2,1,3
42966_0,,,,2,2,1,3
C(CC(C(O)=O)C(C=O)O)(O)=O,,,5,1,2,0,2
42967_0,,,,2,2,1,3
42968_0,,,,2,2,1,3
42969_0,,,,2,2,1,3
42970_0,,,,2,2,1,3
42972_0,,,,2,2,1,3
C(C(C(C(C(C)=O)=O)(C)O)=O)(O)=O,,,5,1,2,0,2
42973_0,,,,2,2,1,3
42975_0,,,,2,2,1,3
C(C(CC(C(C(C)O)=O)=O)=O)(O)=O,,,5,1,2,0,2
42976_0,,,,2,2,1,3
42977_0,,,,2,2,1,3
42978_0,,,,2,2,1,3
42979_0,,,,2,2,1,3
42980_0,,,,2,2,1,3
42981_0,,,,2,2,1,3
42982_0,,,,2,2,1,3
42983_0,,,,2,2,1,3
42984_0,,,,2,2,1,3
42985_0,,,,2,2,1,3
42986_0,,,,2,2,1,3
42987_0,,,,2,2,1,3
42988_0,,,,2,2,1,3
42989_0,,,,2,2,1,3
42990_0,,,,2,2,1,3
42991_0,,,,2,2,1,3
42992_0,,,,2,2,1,3
42993_0,,,,2,2,1,3
42994_0,,,,2,2,1,3
42995_0,,,,2,2,1,3
42996_0,,,,2,2,1,3
42997_0,,,,2,2,1,3
42998_0,,,,2,2,1,3
42999_0,,,,2,2,1,3
43000_0,,,,2,2,1,3
43001_0,,,,2,2,1,3
43002_0,,,,2,2,1,3
43003_0,,,,2,2,1,3
43004_0,,,,2,2,1,3
43005_0,,,,2,2,1,3
43006_0,,,,2,2,1,3
43007_0,,,,2,2,1,3
43008_0,,,,2,2,1,3
43009_0,,,,2,2,1,3
43010_0,,,,2,2,1,3
43011_0,,,,2,2,1,3
43012_0,,,,2,2,1,3
43013_0,,,,2,2,1,3
43014_0,,,,2,2,1,3
43015_0,,,,2,2,1,3
43016_0,,,,2,2,1,3
43017_0,,,,2,2,1,3
43018_0,,,,2,2,1,3
43020_0,,,,2,2,1,3
C(C(C(CC)O)=O)=O,,,5,1,1,0,1
43021_0,,,,2,2,1,3
43022_0,,,,2,2,1,3
43023_0,,,,2,2,1,3
43025_0,,,,2,2,1,3
C(C(C(C(C(O)=O)=O)=C)CO)(O)=O,,,5,1,1,0,1
43027_0,,,,2,2,1,3
C=C(C(O)=O)C(C(C(O)=O)=O)(C)O,,,5,1,1,0,1
43028_0,,,,2,2,1,3
43030_0,,,,2,2,1,3
C(C1(C)C(C(C(O1)=O)=O)(C)O)(O)=O,,,5,1,1,0,1
43031_0,,,,2,2,1,3
43032_0,,,,2,2,1,3
43033_0,,,,2,2,1,3
43035_0,,,,2,2,1,3
C1(C(C)(C(C(C(O1)=O)=O)(C)O)O)=O,,,5,1,1,0,1
43036_0,,,,2,2,1,3
43037_0,,,,2,2,1,3
43038_0,,,,2,2,1,3
43039_0,,,,2,2,1,3
43040_0,,,,2,2,1,3
43041_0,,,,2,2,1,3
43042_0,,,,2,2,1,3
43043_0,,,,2,2,1,3
43044_0,,,,2,2,1,3
43046_0,,,,2,2,1,3
C(C(C(CCO)O)=O)(O)=O,,,5,1,2,0,2
43047_0,,,,2,2,1,3
43048_0,,,,2,2,1,3
43049_0,,,,2,2,1,3
43050_0,,,,2,2,1,3
43051_0,,,,2,2,1,3
43053_0,,,,2,2,1,3
C(C(CO)(CC(C(C)O)O)O)(O)=O,,,5,1,1,0,1
43054_0,,,,2,2,1,3
43055_0,,,,2,2,1,3
43056_0,,,,2,2,1,3
43057_0,,,,2,2,1,3
43058_0,,,,2,2,1,3
43059_0,,,,2,2,1,3
43060_0,,,,2,2,1,3
43061_0,,,,2,2,1,3
43062_0,,,,2,2,1,3
43064_0,,,,2,2,1,3
C(C(C)(CC(C(C)O)O)O)(O)=O,,,5,1,1,0,1
43065_0,,,,2,2,1,3
43066_0,,,,2,2,1,3
43067_0,,,,2,2,1,3
43068_0,,,,2,2,1,3
43069_0,,,,2,2,1,3
43070_0,,,,2,2,1,3
43071_0,,,,2,2,1,3
43072_0,,,,2,2,1,3
43073_0,,,,2,2,1,3
43074_0,,,,2,2,1,3
43075_0,,,,2,2,1,3
43076_0,,,,2,2,1,3
43077_0,,,,2,2,1,3
43078_0,,,,2,2,1,3
43079_0,,,,2,2,1,3
43080_0,,,,2,2,1,3
43081_0,,,,2,2,1,3
43082_0,,,,2,2,1,3
43083_0,,,,2,2,1,3
43084_0,,,,2,2,1,3
43085_0,,,,2,2,1,3
43086_0,,,,2,2,1,3
43087_0,,,,2,2,1,3
43088_0,,,,2,2,1,3
43089_0,,,,2,2,1,3
43090_0,,,,2,2,1,3
43091_0,,,,2,2,1,3
43092_0,,,,2,2,1,3
43093_0,,,,2,2,1,3
43094_0,,,,2,2,1,3
43095_0,,,,2,2,1,3
43096_0,,,,2,2,1,3
43097_0,,,,2,2,1,3
43098_0,,,,2,2,1,3
43099_0,,,,2,2,1,3
43100_0,,,,2,2,1,3
43101_0,,,,2,2,1,3
43102_0,,,,2,2,1,3
43103_0,,,,2,2,1,3
43104_0,,,,2,2,1,3
43105_0,,,,2,2,1,3
43106_0,,,,2,2,1,3
43107_0,,,,2,2,1,3
43108_0,,,,2,2,1,3
43110_0,,,,2,2,1,3
C1(C(CO)CC(O)O1)=O,,,5,1,2,0,2
43112_0,,,,2,2,1,3
C1(C(C)C(C(O)O1)O)=O,,,5,1,2,0,2
43113_0,,,,2,2,1,3
43114_0,,,,2,2,1,3
43115_0,,,,2,2,1,3
43116_0,,,,2,2,1,3
43117_0,,,,2,2,1,3
43118_0,,,,2,2,1,3
43119_0,,,,2,2,1,3
43120_0,,,,2,2,1,3
43121_0,,,,2,2,1,3
43122_0,,,,2,2,1,3
43123_0,,,,2,2,1,3
43124_0,,,,2,2,1,3
43125_0,,,,2,2,1,3
43127_0,,,,2,2,1,3
C(C1(C)C([CH]C(O1)=O)O)(O)=O,,,5,1,2,0,2
43128_0,,,,2,2,1,3
43130_0,,,,2,2,1,3
C1(C(C)C([C](C(O)=O)O1)O)=O,,,5,1,2,0,2
43131_0,,,,2,2,1,3
43133_0,,,,2,2,1,3
C1(C(CO)C[C](C(O)=O)O1)=O,,,5,1,2,0,2
43134_0,,,,2,2,1,3
43135_0,,,,2,2,1,3
43136_0,,,,2,2,1,3
43138_0,,,,2,2,1,3
C1(C(C)C(C(C(O)=O)O1)O)=O,,,5,1,2,0,2
43139_0,,,,2,2,1,3
43141_0,,,,2,2,1,3
C1(C(CC(C(O)=O)O1)CO)=O,,,5,1,2,0,2
43142_0,,,,2,2,1,3
43144_0,,,,2,2,1,3
C1(C(C)(C([CH]C(O1)=O)O)O)=O,,,5,1,2,0,2
43145_0,,,,2,2,1,3
43147_0,,,,2,2,1,3
C1(C(C)C([C](C(O1)=O)O)O)=O,,,5,1,2,0,2
43148_0,,,,2,2,1,3
43150_0,,,,2,2,1,3
C1(C(CO)C[C](C(O1)=O)O)=O,,,5,1,2,0,2
43151_0,,,,2,2,1,3
43152_0,,,,2,2,1,3
43153_0,,,,2,2,1,3
43155_0,,,,2,2,1,3
C1(C(C)C(C(C(O1)=O)O)O)=O,,,5,1,2,0,2
43156_0,,,,2,2,1,3
43158_0,,,,2,2,1,3
C1(C(CO)CC(C(O1)=O)O)=O,,,5,1,2,0,2
43159_0,,,,2,2,1,3
43161_0,,,,2,2,1,3
C(C(CC)(C[CH]C(O)=O)O)=O,,,5,1,2,0,2
43162_0,,,,2,2,1,3
43164_0,,,,2,2,1,3
C(C(CCO)C[CH]C(O)=O)=O,,,5,1,2,0,2
43165_0,,,,2,2,1,3
43167_0,,,,2,2,1,3
C(C(CCC(O)=O)(CC)O)=O,,,5,1,2,0,2
43168_0,,,,2,2,1,3
43170_0,,,,2,2,1,3
C(C(CCC(O)=O)CCO)=O,,,5,1,2,0,2
43171_0,,,,2,2,1,3
43173_0,,,,2,2,1,3
C(C(CCC[CH]C(O)=O)O)=O,,,5,1,2,0,2
43174_0,,,,2,2,1,3
43176_0,,,,2,2,1,3
C(CCC(C[CH]C(O)=O)O)=O,,,5,1,3,0,3
43177_0,,,,2,2,1,3
43179_0,,,,2,2,1,3
C(CCCCC(C=O)O)(O)=O,,,5,1,2,0,2
43180_0,,,,2,2,1,3
43182_0,,,,2,2,1,3
C(CCC(CCC=O)O)(O)=O,,,5,1,3,0,3
43183_0,,,,2,2,1,3
43184_0,,,,2,2,1,3
43185_0,,,,2,2,1,3
43187_0,,,,2,2,1,3
C(C(C(C)C[CH]C(O)=O)O)=O,,,5,1,2,0,2
43188_0,,,,2,2,1,3
43190_0,,,,2,2,1,3
C(CC(CO)C[CH]C(O)=O)=O,,,5,1,2,0,2
43191_0,,,,2,2,1,3
43192_0,,,,2,2,1,3
43193_0,,,,2,2,1,3
43195_0,,,,2,2,1,3
C(CCC(C)C(C=O)O)(O)=O,,,5,1,2,0,2
43196_0,,,,2,2,1,3
43198_0,,,,2,2,1,3
C(CCC(CO)CC=O)(O)=O,,,5,1,2,0,2
43199_0,,,,2,2,1,3
43200_0,,,,2,2,1,3
43201_0,,,,2,2,1,3
43203_0,,,,2,2,1,3
C(CC([CH]C(O)=O)O)(O)=O,,,5,1,1,0,1
43204_0,,,,2,2,1,3
43205_0,,,,2,2,1,3
43207_0,,,,2,2,1,3
[CH](C(O)=O)C(CCO)O,,,5,1,1,0,1
43208_0,,,,2,2,1,3
43209_0,,,,2,2,1,3
43210_0,,,,2,2,1,3
43212_0,,,,2,2,1,3
C(C(CC([CH]C(O)=O)O)O)(O)=O,,,5,1,1,0,1
43213_0,,,,2,2,1,3
43214_0,,,,2,2,1,3
43215_0,,,,2,2,1,3
43216_0,,,,2,2,1,3
43217_0,,,,2,2,1,3
43218_0,,,,2,2,1,3
43219_0,,,,2,2,1,3
43220_0,,,,2,2,1,3
43221_0,,,,2,2,1,3
43223_0,,,,2,2,1,3
C(C(C)C([CH]C(O)=O)O)(O)=O,,,5,1,1,0,1
43224_0,,,,2,2,1,3
43225_0,,,,2,2,1,3
43226_0,,,,2,2,1,3
43227_0,,,,2,2,1,3
43228_0,,,,2,2,1,3
43229_0,,,,2,2,1,3
43230_0,,,,2,2,1,3
43231_0,,,,2,2,1,3
43232_0,,,,2,2,1,3
43233_0,,,,2,2,1,3
43234_0,,,,2,2,1,3
43235_0,,,,2,2,1,3
43236_0,,,,2,2,1,3
43238_0,,,,2,2,1,3
C(C(C)C(CC(O)=O)O)(O)=O,,,5,1,1,0,1
43239_0,,,,2,2,1,3
43240_0,,,,2,2,1,3
43241_0,,,,2,2,1,3
43242_0,,,,2,2,1,3
43244_0,,,,2,2,1,3
[C](C(O)=O)(C(CC)O)O,,,5,1,2,0,2
43245_0,,,,2,2,1,3
43247_0,,,,2,2,1,3
[C](C(O)=O)(CCCO)O,,,5,1,2,0,2
43248_0,,,,2,2,1,3
43250_0,,,,2,2,1,3
C(C([CH]C(O)=O)O)(O)=O,,,5,1,1,0,1
43251_0,,,,2,2,1,3
43252_0,,,,2,2,1,3
43253_0,,,,2,2,1,3
43255_0,,,,2,2,1,3
C(C(C(CC)O)O)(O)=O,,,5,1,2,0,2
43256_0,,,,2,2,1,3
43258_0,,,,2,2,1,3
C(C(CCCO)O)(O)=O,,,5,1,3,0,3
43259_0,,,,2,2,1,3
43260_0,,,,2,2,1,3
43262_0,,,,2,2,1,3
C(C(CO)C1C(C(OC1)=O)=O)(O)=O,,,5,1,1,0,1
43263_0,,,,2,2,1,3
43265_0,,,,2,2,1,3
C1(C(CO)C(C(C(O)=O)=O)CO1)=O,,,5,1,1,0,1
43266_0,,,,2,2,1,3
43268_0,,,,2,2,1,3
C(CC(C)CCC(C=O)O)=O,,,5,1,2,0,2
43269_0,,,,2,2,1,3
43271_0,,,,2,2,1,3
C(C(CCO)C(C)CC=O)=O,,,5,1,2,0,2
43272_0,,,,2,2,1,3
43273_0,,,,2,2,1,3
43274_0,,,,2,1,2,3
43276_0,,,,2,1,2,3
C=CC,,,5,1,2,0,2
43278_0,,,,2,1,2,3
C=C(C(O)=O)C,,,5,1,2,0,2
43279_0,,,,2,1,2,3
43280_0,,,,2,1,2,3
43281_0,,,,2,1,2,3
43282_0,,,,2,1,2,3
43283_0,,,,2,1,2,3
43284_0,,,,2,1,2,3
43285_0,,,,2,1,2,3
43286_0,,,,2,1,2,3
43287_0,,,,2,1,2,3
43288_0,,,,2,1,2,3
43289_0,,,,2,1,2,3
43290_0,,,,2,1,2,3
43291_0,,,,2,1,2,3
43292_0,,,,2,1,2,3
43293_0,,,,2,1,2,3
43294_0,,,,2,1,2,3
43295_0,,,,2,1,2,3
43296_0,,,,2,1,2,3
43297_0,,,,2,1,2,3
43298_0,,,,2,1,2,3
43299_0,,,,2,1,2,3
43300_0,,,,2,1,2,3
43301_0,,,,2,1,2,3
43302_0,,,,2,1,2,3
43303_0,,,,2,1,2,3
43304_0,,,,2,1,2,3
43305_0,,,,2,1,2,3
43306_0,,,,2,1,2,3
43307_0,,,,2,1,2,3
43308_0,,,,2,1,2,3
43309_0,,,,2,1,2,3
43310_0,,,,2,1,2,3
43311_0,,,,2,1,2,3
43312_0,,,,2,1,2,3
43313_0,,,,2,1,2,3
43314_0,,,,2,1,2,3
43315_0,,,,2,1,2,3
43316_0,,,,2,1,2,3
43317_0,,,,2,1,2,3
43318_0,,,,2,1,2,3
43319_0,,,,2,1,2,3
43320_0,,,,2,1,2,3
43321_0,,,,2,1,2,3
43323_0,,,,2,1,2,3
C(C(C)O)=CCO,,,5,1,1,0,1
43325_0,,,,2,1,2,3
C(C(C)O)=CC(C)O,,,5,1,1,0,1
43326_0,,,,2,1,2,3
43327_0,,,,2,1,2,3
43328_0,,,,2,1,2,3
43329_0,,,,2,1,2,3
43330_0,,,,2,1,2,3
43331_0,,,,2,1,2,3
43332_0,,,,2,1,2,3
43333_0,,,,2,1,2,3
43334_0,,,,2,1,2,3
43335_0,,,,2,1,2,3
43336_0,,,,2,1,2,3
43337_0,,,,2,1,2,3
43338_0,,,,2,1,2,3
43340_0,,,,2,1,1,2
CC1C2C(C(C(C2O)O)(O)O1)O,,,5,1,2,0,2
43340_1,,,,2,1,1,2
43342_0,,,,2,1,1,2
CC1C2C(C(CC2O)(O)O1)O,,,5,1,2,0,2
43342_1,,,,2,1,1,2
43343_0,,,,2,1,1,2
43343_1,,,,2,1,1,2
43344_0,,,,2,1,1,2
43344_1,,,,2,1,1,2
43345_0,,,,2,1,1,2
43345_1,,,,2,1,1,2
43346_0,,,,2,1,1,2
43346_1,,,,2,1,1,2
43347_0,,,,2,1,1,2
43347_1,,,,2,1,1,2
43348_0,,,,2,1,1,2
43348_1,,,,2,1,1,2
43349_0,,,,2,1,1,2
43349_1,,,,2,1,1,2
43351_0,,,,2,1,1,2
C1(C2(C(C(C(C2O)O)(O)O1)O)O)=O,,,5,1,2,0,2
43351_1,,,,2,1,1,2
43353_0,,,,2,1,1,2
C1(C2(C(C(C(C2)O)(O)O1)O)O)=O,,,5,1,2,0,2
43353_1,,,,2,1,1,2
43354_0,,,,2,1,1,2
43354_1,,,,2,1,1,2
43355_0,,,,2,1,1,2
43355_1,,,,2,1,1,2
43356_0,,,,2,1,1,2
43356_1,,,,2,1,1,2
43358_0,,,,2,1,1,2
C1(C2(CC(C(C2)O)(O)O1)O)=O,,,5,1,2,0,2
43358_1,,,,2,1,1,2
43359_0,,,,2,1,1,2
43360_0,,,,2,1,1,2
43362_0,,,,2,1,1,2
C(C1C(CC(C)O)OC(C1O)O)=O,,,5,1,1,0,1
43364_0,,,,2,1,1,2
CC(CC(C1C(O)OCC1O)O)O,,,5,1,1,0,1
43366_0,,,,2,1,1,2
C(C1C(C)OC(C1O)(CCO)O)=O,,,5,1,1,0,1
43368_0,,,,2,1,1,2
C1(C(O)OC(C(CO)C(C)O)C1)=O,,,5,1,1,0,1
43369_0,,,,2,1,1,2
43370_0,,,,2,1,1,2
43372_0,,,,2,1,1,2
C(C1C(CC(O)=O)OC(C1O)O)=O,,,5,1,1,0,1
43374_0,,,,2,1,1,2
C(CC(C1C(O)OCC1O)O)(O)=O,,,5,1,1,0,1
43376_0,,,,2,1,1,2
C1(C(C=O)C(C(CCO)(O)O1)O)=O,,,5,1,1,0,1
43377_0,,,,2,1,1,2
43378_0,,,,2,1,1,2
43379_0,,,,2,1,1,2
43381_0,,,,2,1,1,2
C(C(C1COC(CO)(C1O)O)=O)=O,,,5,1,1,0,1
43382_0,,,,2,1,1,2
43384_0,,,,2,1,1,2
C(C(C1CC(C(CO)(O)O1)O)O)=O,,,5,1,1,0,1
43386_0,,,,2,1,1,2
C(CC1CC(C(CO)(O)O1)O)=O,,,5,1,1,0,1
43388_0,,,,2,1,1,2
C(C(C1(CO)C(CC(O)O1)O)O)=O,,,5,1,1,0,1
43390_0,,,,2,1,1,2
C(CC1C(CO)(C(C(O)O1)O)O)=O,,,5,1,1,0,1
43392_0,,,,2,1,1,2
C(CC(C1(COC(C1O)O)O)O)=O,,,5,1,1,0,1
43394_0,,,,2,1,1,2
C(CC1(CO)C(CC(O)O1)O)=O,,,5,1,1,0,1
43396_0,,,,2,1,1,2
C(CC1C(CO)(CC(O)O1)O)=O,,,5,1,1,0,1
43397_0,,,,2,1,1,2
43399_0,,,,2,1,1,2
C(C1C(C(OC1C(CO)=O)O)O)=O,,,5,1,1,0,1
43401_0,,,,2,1,1,2
C(C1C(C(CO)(OC1C=O)O)O)=O,,,5,1,1,0,1
43403_0,,,,2,1,1,2
C(CO)(C(C1C(O)OCC1O)O)=O,,,5,1,1,0,1
43405_0,,,,2,1,1,2
C(C1C(CO)OC(CO)(C1O)O)=O,,,5,1,1,0,1
43407_0,,,,2,1,1,2
C(C1COC(CO)(C1O)O)=O,,,5,1,1,0,1
43409_0,,,,2,1,1,2
C(CC(C1(C(C(CO1)O)O)O)O)=O,,,5,1,1,0,1
43410_0,,,,2,1,1,2
43411_0,,,,2,1,1,2
43413_0,,,,2,1,1,2
C(C(C1COC(C1(CO)O)O)=O)=O,,,5,1,1,0,1
43415_0,,,,2,1,1,2
C(C1(COC(C=O)(C1CO)O)O)=O,,,5,1,1,0,1
43417_0,,,,2,1,1,2
C(C(C1CC(C(O)O1)(CO)O)O)=O,,,5,1,1,0,1
43419_0,,,,2,1,1,2
C(CC1CC(C(O)O1)(CO)O)=O,,,5,1,1,0,1
43421_0,,,,2,1,1,2
C(C(C1C(CO)(CC(O)O1)O)O)=O,,,5,1,1,0,1
43423_0,,,,2,1,1,2
C(CC1(CO)C(C(C(O)O1)O)O)=O,,,5,1,1,0,1
43424_0,,,,2,1,1,2
43426_0,,,,2,1,1,2
C(C1C(C(OC1(C=O)CO)O)O)=O,,,5,1,1,0,1
43428_0,,,,2,1,1,2
C(C1C(CO)(C(OC1C=O)O)O)=O,,,5,1,1,0,1
43430_0,,,,2,1,1,2
C(C1(COC(C1C(C=O)O)O)O)=O,,,5,1,1,0,1
43432_0,,,,2,1,1,2
C(C(CO)(C1C(O)OCC1O)O)=O,,,5,1,1,0,1
43434_0,,,,2,1,1,2
C(C1C(CO)OC(C1(CO)O)O)=O,,,5,1,1,0,1
43436_0,,,,2,1,1,2
C(C1(COC(C1C(CO)O)O)O)=O,,,5,1,1,0,1
43438_0,,,,2,1,1,2
C(C1COC(C1(CO)O)O)=O,,,5,1,1,0,1
43440_0,,,,2,1,1,2
C(C1(COC(C1CO)O)O)=O,,,5,1,1,0,1
43441_0,,,,2,1,1,2
43443_0,,,,2,1,1,2
C(C1COC(C1O)(C(CO)O)O)=O,,,5,1,1,0,1
43445_0,,,,2,1,1,2
C(C1COC(C1(C(CO)O)O)O)=O,,,5,1,1,0,1
43447_0,,,,2,1,1,2
C(C1(C(CO)OC(C1CO)O)O)=O,,,5,1,1,0,1
43448_0,,,,2,1,1,2
43450_0,,,,2,1,1,2
C(C1(C(CO)OC(CO)(C1)O)O)=O,,,5,1,1,0,1
43451_0,,,,2,1,1,2
43453_0,,,,2,1,1,2
C(C1(C(CO)OC(C)(C1O)O)O)=O,,,5,1,1,0,1
43454_0,,,,2,1,1,2
43456_0,,,,2,1,1,2
C(C1(C(CO)OC(C1C=C)O)O)=O,,,5,1,1,0,1
43457_0,,,,2,1,1,2
43459_0,,,,2,1,1,2
C(C1(C(CO)OC(C1O)O)O)=O,,,5,1,1,0,1
43460_0,,,,2,1,1,2
43462_0,,,,2,1,1,2
C(C1(C(CO)OC(C1)O)O)=O,,,5,1,1,0,1
43463_0,,,,2,1,1,2
43465_0,,,,2,1,1,2
C(C1(C(CO)O)CC(C(O1)O)=O)=O,,,5,1,1,0,1
43467_0,,,,2,1,1,2
C(C1(CC(C=O)(O)OC1CO)O)=O,,,5,1,1,0,1
43468_0,,,,2,1,1,2
43470_0,,,,2,1,1,2
C(C1(C(C(O)OC1C(C)O)O)O)=O,,,5,1,1,0,1
43471_0,,,,2,1,1,2
43473_0,,,,2,1,1,2
C(C1(CC(O)OC1C(C)O)O)=O,,,5,1,1,0,1
43474_0,,,,2,1,1,2
43476_0,,,,2,1,1,2
C(C1(C(C(OC1C(O)=O)O)O)O)=O,,,5,1,1,0,1
43477_0,,,,2,1,1,2
43479_0,,,,2,1,1,2
C(C1(CC(OC1C(O)=O)O)O)=O,,,5,1,1,0,1
43480_0,,,,2,1,1,2
43482_0,,,,2,1,1,2
C(C1(CC(C)(C(O1)O)O)CC=O)=O,,,5,1,1,0,1
43483_0,,,,2,1,1,2
43485_0,,,,2,1,1,2
C(CC1C(C)(CC(C=O)(O)O1)O)=O,,,5,1,1,0,1
43486_0,,,,2,1,1,2
43488_0,,,,2,1,1,2
C(C(CC1(C)C(CC(O)O1)O)=O)=O,,,5,1,1,0,1
43489_0,,,,2,1,1,2
43490_0,,,,2,1,1,2
43492_0,,,,2,1,1,2
C(C(C1C(C)OC(C1(C)O)O)=O)=O,,,5,1,1,0,1
43493_0,,,,2,1,1,2
43494_0,,,,2,1,1,2
43496_0,,,,2,1,1,2
C1(C(C(C=O)=O)C(C)(C(O)O1)O)=O,,,5,1,1,0,1
43497_0,,,,2,1,1,2
43498_0,,,,2,1,1,2
43500_0,,,,2,1,1,2
C(C(C1COC(C1(C)O)O)=O)=O,,,5,1,1,0,1
43502_0,,,,2,1,1,2
C(C(CO)C1CC(C)(C(O)O1)O)=O,,,5,1,1,0,1
43504_0,,,,2,1,1,2
C(CO)(CC1CC(C(O)O1)(C)O)=O,,,5,1,1,0,1
43506_0,,,,2,1,1,2
C(C)(C(C1CC(C(O)O1)(C)O)O)=O,,,5,1,1,0,1
43508_0,,,,2,1,1,2
C(C(C=C)C1CC(C)(C(O)O1)O)=O,,,5,1,1,0,1
43510_0,,,,2,1,1,2
C(C(C1CC(C(O)O1)(C)O)O)=O,,,5,1,1,0,1
43512_0,,,,2,1,1,2
C(CC1CC(C)(C(O)O1)O)=O,,,5,1,1,0,1
43514_0,,,,2,1,1,2
C(C(C)(CC1CC(C(O)O1)=O)O)=O,,,5,1,1,0,1
43516_0,,,,2,1,1,2
C(C(CC1CC(C)(C(O)O1)O)=O)=O,,,5,1,1,0,1
43518_0,,,,2,1,1,2
C(C(CO)C1C(C)(CC(O)O1)O)=O,,,5,1,1,0,1
43520_0,,,,2,1,1,2
C(CC1(C)C(C(C(O)O1)CO)O)=O,,,5,1,1,0,1
43522_0,,,,2,1,1,2
C(CO)(CC1C(C)(CC(O)O1)O)=O,,,5,1,1,0,1
43524_0,,,,2,1,1,2
C(CC1(C)C(CC(CO)(O)O1)O)=O,,,5,1,1,0,1
43526_0,,,,2,1,1,2
C(C)(C(C1C(C)(CC(O)O1)O)O)=O,,,5,1,1,0,1
43528_0,,,,2,1,1,2
C(CC1(C)C(C(C(C)(O)O1)O)O)=O,,,5,1,1,0,1
43530_0,,,,2,1,1,2
C(C(C=C)C1C(C)(CC(O)O1)O)=O,,,5,1,1,0,1
43532_0,,,,2,1,1,2
C(CC1(C)C(C(C=C)C(O)O1)O)=O,,,5,1,1,0,1
43534_0,,,,2,1,1,2
C(C(C1C(C)(CC(O)O1)O)O)=O,,,5,1,1,0,1
43536_0,,,,2,1,1,2
C(CC1(C)C(C(C(O)O1)O)O)=O,,,5,1,1,0,1
43538_0,,,,2,1,1,2
C(CC1C(C)(CC(O)O1)O)=O,,,5,1,1,0,1
43540_0,,,,2,1,1,2
C(CC1(C)C(CC(O)O1)O)=O,,,5,1,1,0,1
43541_0,,,,2,1,1,2
43543_0,,,,2,1,1,2
C(C(CC1C(C)(CC(O)O1)O)=O)=O,,,5,1,1,0,1
43545_0,,,,2,1,1,2
C(CC1(C)C(CC(C=O)(O)O1)O)=O,,,5,1,1,0,1
43547_0,,,,2,1,1,2
C(C1C(CCO)OC(C1(C)O)O)=O,,,5,1,1,0,1
43549_0,,,,2,1,1,2
C(C1C(C(OC1(C=O)C)O)O)=O,,,5,1,1,0,1
43551_0,,,,2,1,1,2
C(C1C(C)(C(OC1C=O)O)O)=O,,,5,1,1,0,1
43553_0,,,,2,1,1,2
C(C(C)(C1C(O)OCC1(C)O)O)=O,,,5,1,1,0,1
43555_0,,,,2,1,1,2
C(C1C(C)(CO)OC(C1(C)O)O)=O,,,5,1,1,0,1
43557_0,,,,2,1,1,2
C(C1C(C)(C(OC1C=CC)O)O)=O,,,5,1,1,0,1
43559_0,,,,2,1,1,2
C(C1C(CC=C)OC(C1(C)O)O)=O,,,5,1,1,0,1
43561_0,,,,2,1,1,2
C(C(C)(C1C(O)OCC1O)O)=O,,,5,1,1,0,1
43563_0,,,,2,1,1,2
C(C1C(CO)OC(C1(C)O)O)=O,,,5,1,1,0,1
43565_0,,,,2,1,1,2
C(C(C)(C1C(O)OC(C)C1O)O)=O,,,5,1,1,0,1
43567_0,,,,2,1,1,2
C(C1C(C(C)O)OC(C1(C)O)O)=O,,,5,1,1,0,1
43569_0,,,,2,1,1,2
C(C(C)(C1C(O)OC(C1O)=O)O)=O,,,5,1,1,0,1
43571_0,,,,2,1,1,2
C(C1C(C)(C(OC1C(O)=O)O)O)=O,,,5,1,1,0,1
43573_0,,,,2,1,1,2
C(C1C(C)(C(OC1(C=O)C)O)O)=O,,,5,1,1,0,1
43575_0,,,,2,1,1,2
C(C1C(C(C)(OC1(C=O)C)O)O)=O,,,5,1,1,0,1
43577_0,,,,2,1,1,2
C(C1C(C)(C(OC1C(C)=O)O)O)=O,,,5,1,1,0,1
43579_0,,,,2,1,1,2
C(C1COC(C1(C)O)O)=O,,,5,1,1,0,1
43581_0,,,,2,1,1,2
C(C(C1COC(C1(C)O)O)=O)(O)=O,,,5,1,1,0,1
43583_0,,,,2,1,1,2
C(C1(CC(C(C)(O1)O)O)CC=O)=O,,,5,1,1,0,1
43584_0,,,,2,1,1,2
43585_0,,,,2,1,1,2
43586_0,,,,2,1,1,2
43588_0,,,,2,1,1,2
C(C(C1C(C)OC(C)(C1O)O)=O)=O,,,5,1,1,0,1
43589_0,,,,2,1,1,2
43590_0,,,,2,1,1,2
43592_0,,,,2,1,1,2
C1(C(C(C=O)=O)C(C(C)(O)O1)O)=O,,,5,1,1,0,1
43593_0,,,,2,1,1,2
43594_0,,,,2,1,1,2
43596_0,,,,2,1,1,2
C(C(C1COC(C)(C1O)O)=O)=O,,,5,1,1,0,1
43597_0,,,,2,1,1,2
43598_0,,,,2,1,1,2
43599_0,,,,2,1,1,2
43601_0,,,,2,1,1,2
C(C(CO)C1CC(C(C)(O)O1)O)=O,,,5,1,1,0,1
43603_0,,,,2,1,1,2
C(CO)(CC1CC(C(C)(O)O1)O)=O,,,5,1,1,0,1
43605_0,,,,2,1,1,2
C(C)(C(C1CC(C(C)(O)O1)O)O)=O,,,5,1,1,0,1
43607_0,,,,2,1,1,2
C(C(C=C)C1CC(C(C)(O)O1)O)=O,,,5,1,1,0,1
43609_0,,,,2,1,1,2
C(C(C1CC(C(C)(O)O1)O)O)=O,,,5,1,1,0,1
43611_0,,,,2,1,1,2
C(CC1CC(C(C)(O)O1)O)=O,,,5,1,1,0,1
43613_0,,,,2,1,1,2
C(C)(C(CC1CC(C(O)O1)=O)O)=O,,,5,1,1,0,1
43615_0,,,,2,1,1,2
C(C(CC1CC(C(C)(O)O1)O)=O)=O,,,5,1,1,0,1
43617_0,,,,2,1,1,2
C(C(CO)C1(C)C(CC(O)O1)O)=O,,,5,1,1,0,1
43619_0,,,,2,1,1,2
C(CC1C(C)(C(C(O)O1)CO)O)=O,,,5,1,1,0,1
43621_0,,,,2,1,1,2
C(CO)(CC1(C)C(CC(O)O1)O)=O,,,5,1,1,0,1
43623_0,,,,2,1,1,2
C(CC1C(C)(CC(CO)(O)O1)O)=O,,,5,1,1,0,1
43625_0,,,,2,1,1,2
C(C)(C(C1(C)C(CC(O)O1)O)O)=O,,,5,1,1,0,1
43627_0,,,,2,1,1,2
C(CC1C(C)(C(C(C)(O)O1)O)O)=O,,,5,1,1,0,1
43629_0,,,,2,1,1,2
C(C(C=C)C1(C)C(CC(O)O1)O)=O,,,5,1,1,0,1
43631_0,,,,2,1,1,2
C(CC1C(C)(C(C=C)C(O)O1)O)=O,,,5,1,1,0,1
43633_0,,,,2,1,1,2
C(C(C1(C)C(CC(O)O1)O)O)=O,,,5,1,1,0,1
43635_0,,,,2,1,1,2
C(CC1C(C)(C(C(O)O1)O)O)=O,,,5,1,1,0,1
43637_0,,,,2,1,1,2
C(C1C(CCO)OC(C)(C1O)O)=O,,,5,1,1,0,1
43639_0,,,,2,1,1,2
C(C1C(C(OC1C(C)=O)O)O)=O,,,5,1,1,0,1
43641_0,,,,2,1,1,2
C(C1C(C(C)(OC1C=O)O)O)=O,,,5,1,1,0,1
43643_0,,,,2,1,1,2
C(C)(C(C1C(O)OCC1(C)O)O)=O,,,5,1,1,0,1
43645_0,,,,2,1,1,2
C(C1C(C(C)(O)OC1(C)CO)O)=O,,,5,1,1,0,1
43647_0,,,,2,1,1,2
C(C1C(C(C)(OC1C=CC)O)O)=O,,,5,1,1,0,1
43649_0,,,,2,1,1,2
C(C1C(CC=C)OC(C)(C1O)O)=O,,,5,1,1,0,1
43651_0,,,,2,1,1,2
C(C)(C(C1C(O)OCC1O)O)=O,,,5,1,1,0,1
43653_0,,,,2,1,1,2
C(C1C(CO)OC(C)(C1O)O)=O,,,5,1,1,0,1
43655_0,,,,2,1,1,2
C(C)(C(C1C(O)OC(C)C1O)O)=O,,,5,1,1,0,1
43657_0,,,,2,1,1,2
C(C1C(C(C)O)OC(C)(C1O)O)=O,,,5,1,1,0,1
43659_0,,,,2,1,1,2
C1(C(C(C(O)O1)C(C(C)=O)O)O)=O,,,5,1,1,0,1
43661_0,,,,2,1,1,2
C(C1C(C(C)(OC1C(O)=O)O)O)=O,,,5,1,1,0,1
43663_0,,,,2,1,1,2
C(C1C(C(C)(OC1C(C)=O)O)O)=O,,,5,1,1,0,1
43665_0,,,,2,1,1,2
C(C1COC(C)(C1O)O)=O,,,5,1,1,0,1
43667_0,,,,2,1,1,2
C(CC(C1(CC(CO1)(C)O)O)O)=O,,,5,1,1,0,1
43669_0,,,,2,1,1,2
C(CC(C1(CC(CO1)O)O)O)=O,,,5,1,1,0,1
43671_0,,,,2,1,1,2
C(CC(C1(CC(C(C)O1)O)O)O)=O,,,5,1,1,0,1
43673_0,,,,2,1,1,2
C(CC(C1(CC(C(O1)=O)O)O)O)=O,,,5,1,1,0,1
43675_0,,,,2,1,1,2
C(C(C1COC(C)(C1O)O)=O)(O)=O,,,5,1,1,0,1
43677_0,,,,2,1,1,2
C(C1COC(C1(CCO)O)O)=O,,,5,1,1,0,1
43678_0,,,,2,1,1,2
43679_0,,,,2,1,1,2
43680_0,,,,2,1,1,2
43681_0,,,,2,1,1,2
43682_0,,,,2,1,1,2
43683_0,,,,2,1,1,2
43684_0,,,,2,1,1,2
43686_0,,,,2,1,1,2
C(C1C(C)OC(C1(CCO)O)O)=O,,,5,1,1,0,1
43687_0,,,,2,1,1,2
43689_0,,,,2,1,1,2
C1(C(C=O)C(C(O)O1)(CCO)O)=O,,,5,1,1,0,1
43690_0,,,,2,1,1,2
43692_0,,,,2,1,1,2
C(C1(CCO)C(C(C(O1)O)=O)O)=O,,,5,1,1,0,1
43693_0,,,,2,1,1,2
43695_0,,,,2,1,1,2
C(C1(CCO)CC(C(O1)O)=O)=O,,,5,1,1,0,1
43696_0,,,,2,1,1,2
43697_0,,,,2,1,1,2
43699_0,,,,2,1,1,2
C(C1COC(C1O)(CCO)O)=O,,,5,1,1,0,1
43700_0,,,,2,1,1,2
43702_0,,,,2,1,1,2
C1(C(O)OC(CCO)C1CO)=O,,,5,1,1,0,1
43704_0,,,,2,1,1,2
C(C(C1COC(C1O)O)=O)=O,,,5,1,1,0,1
43705_0,,,,2,1,1,2
43707_0,,,,2,1,1,2
C1(C(OC(C=O)C1CO)O)=O,,,5,1,1,0,1
43709_0,,,,2,1,1,2
C(C1C(C(CO)C(C=O)(O1)O)O)=O,,,5,1,1,0,1
43710_0,,,,2,1,1,2
43712_0,,,,2,1,1,2
C(C(C1C(C(C(O)O1)=O)CO)O)=O,,,5,1,1,0,1
43714_0,,,,2,1,1,2
C(C1(C(CO)C(CO)(CO1)O)O)=O,,,5,1,1,0,1
43715_0,,,,2,1,1,2
43717_0,,,,2,1,1,2
C1(C(O)OC(CO)(CO)C1CO)=O,,,5,1,1,0,1
43719_0,,,,2,1,1,2
C(C1(C(CO)C(CO1)(C)O)O)=O,,,5,1,1,0,1
43720_0,,,,2,1,1,2
43722_0,,,,2,1,1,2
C1(C(O)OC(CO)(C)C1CO)=O,,,5,1,1,0,1
43723_0,,,,2,1,1,2
43725_0,,,,2,1,1,2
C1(C(OC(C=CC)C1CO)O)=O,,,5,1,1,0,1
43726_0,,,,2,1,1,2
43728_0,,,,2,1,1,2
C1(C(O)OC(CC=C)C1CO)=O,,,5,1,1,0,1
43730_0,,,,2,1,1,2
C(C1(C(CO)C(C(CO)O1)O)O)=O,,,5,1,1,0,1
43731_0,,,,2,1,1,2
43733_0,,,,2,1,1,2
C1(C(O)OC(C(CO)O)C1CO)=O,,,5,1,1,0,1
43735_0,,,,2,1,1,2
C(C1(C(CO)C(CO1)O)O)=O,,,5,1,1,0,1
43736_0,,,,2,1,1,2
43738_0,,,,2,1,1,2
C1(C(O)OC(CO)C1CO)=O,,,5,1,1,0,1
43740_0,,,,2,1,1,2
C(C1(C(CO)C(C(C)O1)O)O)=O,,,5,1,1,0,1
43741_0,,,,2,1,1,2
43743_0,,,,2,1,1,2
C1(C(O)OC(C(C)O)C1CO)=O,,,5,1,1,0,1
43745_0,,,,2,1,1,2
C1(C(C(CO)C(C=O)(O)O1)O)=O,,,5,1,1,0,1
43746_0,,,,2,1,1,2
43748_0,,,,2,1,1,2
C1(C(OC(C(O)=O)C1CO)O)=O,,,5,1,1,0,1
43749_0,,,,2,1,1,2
43750_0,,,,2,1,1,2
43751_0,,,,2,1,1,2
43752_0,,,,2,1,1,2
43753_0,,,,2,1,1,2
43755_0,,,,2,1,1,2
C1(C(C)(C(CO)C(C=O)(O)O1)O)=O,,,5,1,1,0,1
43756_0,,,,2,1,1,2
43757_0,,,,2,1,1,2
43759_0,,,,2,1,1,2
C(C1COC(C1(CC(C)O)O)O)=O,,,5,1,1,0,1
43760_0,,,,2,1,1,2
43761_0,,,,2,1,1,2
43762_0,,,,2,1,1,2
43763_0,,,,2,1,1,2
43764_0,,,,2,1,1,2
43765_0,,,,2,1,1,2
43767_0,,,,2,1,1,2
C(C1(CC(C)O)CC(C(O1)O)=O)=O,,,5,1,1,0,1
43768_0,,,,2,1,1,2
43770_0,,,,2,1,1,2
C(C1COC(C1O)(CC(C)O)O)=O,,,5,1,1,0,1
43771_0,,,,2,1,1,2
43773_0,,,,2,1,1,2
C1(C(O)OC(CCO)C1C(C)O)=O,,,5,1,1,0,1
43775_0,,,,2,1,1,2
C(C(C1C(C)OC(C1O)O)=O)=O,,,5,1,1,0,1
43776_0,,,,2,1,1,2
43778_0,,,,2,1,1,2
C1(C(OC(C=O)C1C(C)O)O)=O,,,5,1,1,0,1
43780_0,,,,2,1,1,2
C(C1(C(C(C)O)C(CO1)(C)O)O)=O,,,5,1,1,0,1
43781_0,,,,2,1,1,2
43783_0,,,,2,1,1,2
C1(C(O)OC(CO)(C)C1C(C)O)=O,,,5,1,1,0,1
43784_0,,,,2,1,1,2
43786_0,,,,2,1,1,2
C1(C(OC(C=CC)C1C(C)O)O)=O,,,5,1,1,0,1
43787_0,,,,2,1,1,2
43789_0,,,,2,1,1,2
C1(C(O)OC(CC=C)C1C(C)O)=O,,,5,1,1,0,1
43791_0,,,,2,1,1,2
C(C1(C(C(C)O)C(CO1)O)O)=O,,,5,1,1,0,1
43792_0,,,,2,1,1,2
43794_0,,,,2,1,1,2
C1(C(O)OC(CO)C1C(C)O)=O,,,5,1,1,0,1
43796_0,,,,2,1,1,2
C(C1(C(C(C(C)O1)O)C(C)O)O)=O,,,5,1,1,0,1
43797_0,,,,2,1,1,2
43799_0,,,,2,1,1,2
C1(C(O)OC(C(C)O)C1C(C)O)=O,,,5,1,1,0,1
43801_0,,,,2,1,1,2
C1(C(C(C(C)O)C(C=O)(O)O1)O)=O,,,5,1,1,0,1
43802_0,,,,2,1,1,2
43804_0,,,,2,1,1,2
C1(C(OC(C(O)=O)C1C(C)O)O)=O,,,5,1,1,0,1
43805_0,,,,2,1,1,2
43806_0,,,,2,1,1,2
43807_0,,,,2,1,1,2
43809_0,,,,2,1,1,2
C(C1COC(C1(CC(O)=O)O)O)=O,,,5,1,1,0,1
43810_0,,,,2,1,1,2
43811_0,,,,2,1,1,2
43812_0,,,,2,1,1,2
43813_0,,,,2,1,1,2
43814_0,,,,2,1,1,2
43815_0,,,,2,1,1,2
43817_0,,,,2,1,1,2
C(CC1(C=O)CC(C(O)O1)=O)(O)=O,,,5,1,1,0,1
43818_0,,,,2,1,1,2
43820_0,,,,2,1,1,2
C(C1COC(C1O)(CC(O)=O)O)=O,,,5,1,1,0,1
43821_0,,,,2,1,1,2
43823_0,,,,2,1,1,2
C(C1C(C(O)OC1CCO)=O)(O)=O,,,5,1,1,0,1
43825_0,,,,2,1,1,2
C1(C(C(C=O)=O)C(C(O)O1)O)=O,,,5,1,1,0,1
43826_0,,,,2,1,1,2
43828_0,,,,2,1,1,2
C(C1C(C(O)OC1C=O)=O)(O)=O,,,5,1,1,0,1
43830_0,,,,2,1,1,2
C(C1C(COC1(C=O)O)(C)O)(O)=O,,,5,1,1,0,1
43831_0,,,,2,1,1,2
43833_0,,,,2,1,1,2
C(C1C(C(O)OC1(CO)C)=O)(O)=O,,,5,1,1,0,1
43834_0,,,,2,1,1,2
43836_0,,,,2,1,1,2
C(C1C(C(O)OC1C=CC)=O)(O)=O,,,5,1,1,0,1
43837_0,,,,2,1,1,2
43839_0,,,,2,1,1,2
C(C1C(C(O)OC1CC=C)=O)(O)=O,,,5,1,1,0,1
43841_0,,,,2,1,1,2
C(C1C(COC1(C=O)O)O)(O)=O,,,5,1,1,0,1
43842_0,,,,2,1,1,2
43844_0,,,,2,1,1,2
C(C1C(C(O)OC1CO)=O)(O)=O,,,5,1,1,0,1
43846_0,,,,2,1,1,2
C(C1C(C(C)OC1(C=O)O)O)(O)=O,,,5,1,1,0,1
43847_0,,,,2,1,1,2
43849_0,,,,2,1,1,2
C(C1C(C(O)OC1C(C)O)=O)(O)=O,,,5,1,1,0,1
43851_0,,,,2,1,1,2
C1(C(C(C(O)=O)C(C=O)(O)O1)O)=O,,,5,1,1,0,1
43852_0,,,,2,1,1,2
43854_0,,,,2,1,1,2
C(C1C(C(O)OC1C(O)=O)=O)(O)=O,,,5,1,1,0,1
43855_0,,,,2,1,1,2
43857_0,,,,2,1,1,2
C(C1(C(CO)OC(C1O)O)O)(O)=O,,,5,1,1,0,1
43859_0,,,,2,1,1,2
C1(C(C(CO)O)(C(C(O)O1)O)O)=O,,,5,1,1,0,1
43861_0,,,,2,1,1,2
C(C1(C(CO)OC(C1)O)O)(O)=O,,,5,1,1,0,1
43863_0,,,,2,1,1,2
C1(C(C(CO)O)(CC(O)O1)O)=O,,,5,1,1,0,1
43865_0,,,,2,1,1,2
C(C1C(C(C)(O)OC1CCO)=O)=O,,,5,1,1,0,1
43867_0,,,,2,1,1,2
C(CC1(C(CC(CCO)O1)=O)O)=O,,,5,1,1,0,1
43869_0,,,,2,1,1,2
C1(C(C(C)O)(O)OC(CCO)C1)=O,,,5,1,1,0,1
43871_0,,,,2,1,1,2
C(C1(C(CC(CCO)O1)=O)O)(O)=O,,,5,1,1,0,1
43873_0,,,,2,1,1,2
C=C1C(OC(C1C(CCO)O)O)=O,,,5,1,1,0,1
43875_0,,,,2,1,1,2
C1(C(O)OC(CCO)C1O)=O,,,5,1,1,0,1
43877_0,,,,2,1,1,2
C1(C(O)OC(CCO)C1)=O,,,5,1,1,0,1
43879_0,,,,2,1,1,2
C1(C(CCO)(C(CO)C(O)O1)O)=O,,,5,1,1,0,1
43881_0,,,,2,1,1,2
C(C1COC(C)(C1(CC=O)O)O)=O,,,5,1,1,0,1
43883_0,,,,2,1,1,2
C(C1COC(C1(C)O)(CC=O)O)=O,,,5,1,1,0,1
43885_0,,,,2,1,1,2
C(C(CO)C1(C(CC(O1)O)=O)C)=O,,,5,1,1,0,1
43887_0,,,,2,1,1,2
C(C(C1CC(C(C)(O)O1)=O)CO)=O,,,5,1,1,0,1
43889_0,,,,2,1,1,2
C(C)(C1(C(C)OC(C1CO)O)O)=O,,,5,1,1,0,1
43891_0,,,,2,1,1,2
C(C1COC(C)(C1(C(C)O)O)O)=O,,,5,1,1,0,1
43893_0,,,,2,1,1,2
C(C1COC(C(C)O)(C1(C)O)O)=O,,,5,1,1,0,1
43895_0,,,,2,1,1,2
C1(C(C(C)=O)(C(CO)C(O)O1)O)=O,,,5,1,1,0,1
43897_0,,,,2,1,1,2
C(C1COC(C)(C1(C(O)=O)O)O)=O,,,5,1,1,0,1
43899_0,,,,2,1,1,2
C(C1COC(C(O)=O)(C1(C)O)O)=O,,,5,1,1,0,1
43901_0,,,,2,1,1,2
C(C1COC(C1O)O)=O,,,5,1,1,0,1
43903_0,,,,2,1,1,2
C(C1C(C(CO)C(O1)O)O)=O,,,5,1,1,0,1
43905_0,,,,2,1,1,2
C(C1C(C(CO)C(O1)O)O)(O)=O,,,5,1,1,0,1
43907_0,,,,2,1,1,2
C1C(CO)(C(C(O)O1)CO)O,,,5,1,1,0,1
43909_0,,,,2,1,1,2
C1C(C)(C(C(O)O1)CO)O,,,5,1,1,0,1
43911_0,,,,2,1,1,2
C(C1(C)C(C(CO)C(O1)O)O)(O)=O,,,5,1,1,0,1
43913_0,,,,2,1,1,2
C1(C(C=CC)(C(CO)C(O)O1)O)=O,,,5,1,1,0,1
43915_0,,,,2,1,1,2
C1(C(C(CO)C(O)O1)(CC=C)O)=O,,,5,1,1,0,1
43917_0,,,,2,1,1,2
C1(C(CO)C(C(CO)O1)O)O,,,5,1,1,0,1
43919_0,,,,2,1,1,2
C1C(C(C(O)O1)CO)O,,,5,1,1,0,1
43921_0,,,,2,1,1,2
CC1C(C(C(O)O1)CO)O,,,5,1,1,0,1
43923_0,,,,2,1,1,2
C1(C(C(CO)C(O)O1)O)=O,,,5,1,1,0,1
43925_0,,,,2,1,1,2
C(C1(COC(C1CO)O)O)(O)=O,,,5,1,1,0,1
43927_0,,,,2,1,1,2
C1(C(CO)(C(CO)C(O)O1)O)=O,,,5,1,1,0,1
43929_0,,,,2,1,1,2
C1(C(CCO)(CC(CO)(O)O1)O)=O,,,5,1,1,0,1
43931_0,,,,2,1,1,2
C1(C(CCO)(C(C(C)(O)O1)O)O)=O,,,5,1,1,0,1
43933_0,,,,2,1,1,2
C1(C(CCO)(C(C=C)C(O)O1)O)=O,,,5,1,1,0,1
43935_0,,,,2,1,1,2
C1(C(C(C(O)O1)O)(CCO)O)=O,,,5,1,1,0,1
43937_0,,,,2,1,1,2
C1(C(CCO)(CC(O)O1)O)=O,,,5,1,1,0,1
43939_0,,,,2,1,1,2
C(C1(CCO)CC(C(O1)O)=O)(O)=O,,,5,1,1,0,1
43941_0,,,,2,1,1,2
C1(C(CC(C=O)(O)O1)(CCO)O)=O,,,5,1,1,0,1
43943_0,,,,2,1,1,2
C(C(C1COC(C1O)O)=O)(O)=O,,,5,1,1,0,1
43945_0,,,,2,1,1,2
C(C1(C(CO)C(CO1)(C)O)O)(O)=O,,,5,1,1,0,1
43947_0,,,,2,1,1,2
C(C1(C(CO)C(CO1)O)O)(O)=O,,,5,1,1,0,1
43949_0,,,,2,1,1,2
C(C1(C(CO)C(C(C)O1)O)O)(O)=O,,,5,1,1,0,1
43951_0,,,,2,1,1,2
C1(C(C(CO)C(C(O)=O)(O)O1)O)=O,,,5,1,1,0,1
43953_0,,,,2,1,1,2
C(C1(CC(O)OC1C(C)O)O)(O)=O,,,5,1,1,0,1
43955_0,,,,2,1,1,2
C1(C(CC(O)O1)(C(C(C)O)O)O)=O,,,5,1,1,0,1
43957_0,,,,2,1,1,2
C(C1(CC(OC1C(O)=O)O)O)(O)=O,,,5,1,1,0,1
43959_0,,,,2,1,1,2
C1(C(CC(O)O1)(C(C(O)=O)O)O)=O,,,5,1,1,0,1
43961_0,,,,2,1,1,2
C(C)(C1(CC(OC1C(C)=O)O)O)=O,,,5,1,1,0,1
43963_0,,,,2,1,1,2
C(C)(C1(CC(OC1C=O)O)O)=O,,,5,1,1,0,1
43965_0,,,,2,1,1,2
C(CC1(C(C)=O)CC(C(O)O1)=O)=O,,,5,1,1,0,1
43967_0,,,,2,1,1,2
C1(C(C)(CC(CO)=O)OC(C1)O)=O,,,5,1,1,0,1
43969_0,,,,2,1,1,2
C1(C(C)(C(C(C)=O)O)OC(C1)O)=O,,,5,1,1,0,1
43971_0,,,,2,1,1,2
C(C(C=C)C1(C(CC(O1)O)=O)C)=O,,,5,1,1,0,1
43973_0,,,,2,1,1,2
C1(C(C)(C(C=O)O)OC(C1)O)=O,,,5,1,1,0,1
43975_0,,,,2,1,1,2
C1(C(C)(CC=O)OC(C1)O)=O,,,5,1,1,0,1
43977_0,,,,2,1,1,2
C(C1(C)CC(C(O1)O)=O)(CC=O)=O,,,5,1,1,0,1
43979_0,,,,2,1,1,2
C1(C(C)(CC(C=O)=O)OC(C1)O)=O,,,5,1,1,0,1
43981_0,,,,2,1,1,2
C1(C(C)(O)OC(C1)CC(CO)=O)=O,,,5,1,1,0,1
43983_0,,,,2,1,1,2
C1(C(C)(O)OC(C(C(C)=O)O)C1)=O,,,5,1,1,0,1
43985_0,,,,2,1,1,2
C(C)(C1C(CC(C(C)=O)(O1)O)O)=O,,,5,1,1,0,1
43987_0,,,,2,1,1,2
C(C(C=C)C1CC(C(C)(O)O1)=O)=O,,,5,1,1,0,1
43989_0,,,,2,1,1,2
C(C1C(CC(C(C)=O)(O1)O)O)=O,,,5,1,1,0,1
43991_0,,,,2,1,1,2
C(C(C1CC(C(C)(O)O1)=O)O)=O,,,5,1,1,0,1
43993_0,,,,2,1,1,2
C(CC1CC(C(C)(O)O1)=O)=O,,,5,1,1,0,1
43995_0,,,,2,1,1,2
C1(C(O)OC(CC(C(C)=O)=O)C1)=O,,,5,1,1,0,1
43997_0,,,,2,1,1,2
C1(C(C)(O)OC(CC(C=O)=O)C1)=O,,,5,1,1,0,1
43999_0,,,,2,1,1,2
C1(C(C)(OC(C=O)C1C=O)O)=O,,,5,1,1,0,1
44001_0,,,,2,1,1,2
C(C1C(COC1(C(C)=O)O)(C)O)=O,,,5,1,1,0,1
44003_0,,,,2,1,1,2
C(C(C)=O)(C1C(O)OCC1(C)O)=O,,,5,1,1,0,1
44005_0,,,,2,1,1,2
C(C1C(C(C)(O)OC1(CO)C)=O)=O,,,5,1,1,0,1
44007_0,,,,2,1,1,2
C1(C(C)(OC(C=CC)C1C=O)O)=O,,,5,1,1,0,1
44009_0,,,,2,1,1,2
C(C1C(C(C)(O)OC1CC=C)=O)=O,,,5,1,1,0,1
44011_0,,,,2,1,1,2
C(C1C(COC1(C(C)=O)O)O)=O,,,5,1,1,0,1
44013_0,,,,2,1,1,2
C(C(C)=O)(C1C(O)OCC1O)=O,,,5,1,1,0,1
44015_0,,,,2,1,1,2
C(C1C(C(C)(O)OC1CO)=O)=O,,,5,1,1,0,1
44017_0,,,,2,1,1,2
C(C1C(C(C)OC1(C(C)=O)O)O)=O,,,5,1,1,0,1
44019_0,,,,2,1,1,2
C(C(C)=O)(C1C(O)OC(C)C1O)=O,,,5,1,1,0,1
44021_0,,,,2,1,1,2
C(C1C(C(C)(O)OC1C(C)O)=O)=O,,,5,1,1,0,1
44023_0,,,,2,1,1,2
C1(C(C(C=O)C(C(C)=O)(O)O1)O)=O,,,5,1,1,0,1
44025_0,,,,2,1,1,2
C1(C(C(C(C(C)=O)=O)C(O)O1)O)=O,,,5,1,1,0,1
44027_0,,,,2,1,1,2
C1(C(C)(OC(C(O)=O)C1C=O)O)=O,,,5,1,1,0,1
44029_0,,,,2,1,1,2
C(C1C(C(C)(O)OC1C)=O)=O,,,5,1,1,0,1
44030_0,,,,2,1,1,2
44032_0,,,,2,1,1,2
C(C1C(C(C)(OC1(C=O)C)O)=O)=O,,,5,1,1,0,1
44034_0,,,,2,1,1,2
C1(C(C)(OC(C(C)=O)C1C=O)O)=O,,,5,1,1,0,1
44036_0,,,,2,1,1,2
C(C1C(C(C)(O)OC1)=O)=O,,,5,1,2,0,2
44038_0,,,,2,1,1,2
C(C1CC(C(CC=O)(O)O1)=O)=O,,,5,1,1,0,1
44040_0,,,,2,1,1,2
C(CC(C1(CC(CO1)(C)O)O)=O)=O,,,5,1,1,0,1
44042_0,,,,2,1,1,2
C(CC1(C(CC(CO)(C)O1)=O)O)=O,,,5,1,1,0,1
44044_0,,,,2,1,1,2
C(CC1(C(CC(C=CC)O1)=O)O)=O,,,5,1,1,0,1
44046_0,,,,2,1,1,2
C(CC1(C(CC(CC=C)O1)=O)O)=O,,,5,1,1,0,1
44048_0,,,,2,1,1,2
C(CC(C1(CC(CO1)O)O)=O)=O,,,5,1,1,0,1
44050_0,,,,2,1,1,2
C(CC1(C(CC(CO)O1)=O)O)=O,,,5,1,1,0,1
44052_0,,,,2,1,1,2
C(CC(C1(CC(C(C)O1)O)O)=O)=O,,,5,1,1,0,1
44054_0,,,,2,1,1,2
C(CC1(C(CC(C(C)O)O1)=O)O)=O,,,5,1,1,0,1
44056_0,,,,2,1,1,2
C1(C(CC(C(CC=O)=O)(O)O1)O)=O,,,5,1,1,0,1
44058_0,,,,2,1,1,2
C(C1CC(C(CC=O)(O)O1)=O)(O)=O,,,5,1,1,0,1
44060_0,,,,2,1,1,2
C(CC1(C(CC(C)O1)=O)O)=O,,,5,1,1,0,1
44062_0,,,,2,1,1,2
C1(CC(C(CC=O)(O)O1)=O)=O,,,5,1,1,0,1
44064_0,,,,2,1,1,2
C(CC1(C(CC(C=O)(C)O1)=O)O)=O,,,5,1,1,0,1
44066_0,,,,2,1,1,2
C(CC1(C(CC(C(C)=O)O1)=O)O)=O,,,5,1,1,0,1
44068_0,,,,2,1,1,2
C(CC1(C(CCO1)=O)O)=O,,,5,1,2,0,2
44070_0,,,,2,1,1,2
C(C(C)O)(C1(COC(C1O)O)O)=O,,,5,1,1,0,1
44072_0,,,,2,1,1,2
C(C(C)O)(C1(COC(C1)O)O)=O,,,5,1,1,0,1
44074_0,,,,2,1,1,2
C(CO)(C1(C(C)OC(C1O)O)O)=O,,,5,1,1,0,1
44076_0,,,,2,1,1,2
C(CO)(C1(C(C)OC(C1)O)O)=O,,,5,1,1,0,1
44078_0,,,,2,1,1,2
C(C1C(C(C(C(C)O)(O1)O)=O)O)=O,,,5,1,1,0,1
44080_0,,,,2,1,1,2
C(C1(C(C(CO1)O)O)O)(C(C)O)=O,,,5,1,1,0,1
44082_0,,,,2,1,1,2
C1(C(C(C)O)(O)OC(CO)C1O)=O,,,5,1,1,0,1
44083_0,,,,2,1,1,2
44084_0,,,,2,1,1,2
44085_0,,,,2,1,1,2
44087_0,,,,2,1,1,2
C(C(C1(COC(C1O)O)O)=O)(O)=O,,,5,1,1,0,1
44089_0,,,,2,1,1,2
C(C(C1(COC(C1)O)O)=O)(O)=O,,,5,1,1,0,1
44091_0,,,,2,1,1,2
C1(C(C(CO)=O)(C(C(O)O1)O)O)=O,,,5,1,1,0,1
44093_0,,,,2,1,1,2
C1(C(C(CO)=O)(CC(O)O1)O)=O,,,5,1,1,0,1
44095_0,,,,2,1,1,2
C(C1(C(C(C(C=O)O1)O)=O)O)(O)=O,,,5,1,1,0,1
44097_0,,,,2,1,1,2
C(C(C1(C(C(CO1)O)O)O)=O)(O)=O,,,5,1,1,0,1
44099_0,,,,2,1,1,2
C(C1(C(C(C(CO)O1)O)=O)O)(O)=O,,,5,1,1,0,1
44100_0,,,,2,1,1,2
44101_0,,,,2,1,1,2
44102_0,,,,2,1,1,2
44104_0,,,,2,1,1,2
C(C)(C1(C(C)OC(CO)(C1)O)O)=O,,,5,1,1,0,1
44106_0,,,,2,1,1,2
C(C)(C1(C(C)OC(C)(C1O)O)O)=O,,,5,1,1,0,1
44108_0,,,,2,1,1,2
C(C)(C1(C(C)OC(C1C=C)O)O)=O,,,5,1,1,0,1
44110_0,,,,2,1,1,2
C(C)(C1(C(C)OC(C1O)O)O)=O,,,5,1,1,0,1
44112_0,,,,2,1,1,2
C(C)(C1(C(C)OC(C1)O)O)=O,,,5,1,1,0,1
44113_0,,,,2,1,1,2
44115_0,,,,2,1,1,2
C(C1(CC(C(C)=O)(C(C)O1)O)O)=O,,,5,1,1,0,1
44117_0,,,,2,1,1,2
C(C1(C)CC(C(O1)O)=O)(C(C)O)=O,,,5,1,1,0,1
44119_0,,,,2,1,1,2
C1(CC(C=O)OC1(C(C)O)O)=O,,,5,1,1,0,1
44121_0,,,,2,1,1,2
C(C1(CC(CO1)(C)O)O)(C(C)O)=O,,,5,1,1,0,1
44123_0,,,,2,1,1,2
C1(C(C(C)O)(O)OC(CO)(C)C1)=O,,,5,1,1,0,1
44125_0,,,,2,1,1,2
C1(CC(C=CC)OC1(C(C)O)O)=O,,,5,1,1,0,1
44127_0,,,,2,1,1,2
C1(C(C(C)O)(O)OC(CC=C)C1)=O,,,5,1,1,0,1
44129_0,,,,2,1,1,2
C(C1(CC(CO1)O)O)(C(C)O)=O,,,5,1,1,0,1
44131_0,,,,2,1,1,2
C1(C(C(C)O)(O)OC(CO)C1)=O,,,5,1,1,0,1
44133_0,,,,2,1,1,2
C(C1(CC(C(C)O1)O)O)(C(C)O)=O,,,5,1,1,0,1
44135_0,,,,2,1,1,2
C1(C(C(C)O)(O)OC(C(C)O)C1)=O,,,5,1,1,0,1
44137_0,,,,2,1,1,2
C1(C(CC(C(C(C)O)=O)(O)O1)O)=O,,,5,1,1,0,1
44139_0,,,,2,1,1,2
C1(CC(C(O)=O)OC1(C(C)O)O)=O,,,5,1,1,0,1
44140_0,,,,2,1,1,2
44141_0,,,,2,1,1,2
44142_0,,,,2,1,1,2
44143_0,,,,2,1,1,2
44144_0,,,,2,1,1,2
44146_0,,,,2,1,1,2
C1(C(C(C)=O)(CC(CO)(O)O1)O)=O,,,5,1,1,0,1
44148_0,,,,2,1,1,2
C1(C(C(C)=O)(C(C(C)(O)O1)O)O)=O,,,5,1,1,0,1
44150_0,,,,2,1,1,2
C1(C(C(C)=O)(C(C=C)C(O)O1)O)=O,,,5,1,1,0,1
44152_0,,,,2,1,1,2
C1(C(C(C)=O)(C(C(O)O1)O)O)=O,,,5,1,1,0,1
44154_0,,,,2,1,1,2
C1(C(C(C)=O)(CC(O)O1)O)=O,,,5,1,1,0,1
44155_0,,,,2,1,1,2
44157_0,,,,2,1,1,2
C(C1(CC(C(O1)=O)(C(C)=O)O)O)=O,,,5,1,1,0,1
44159_0,,,,2,1,1,2
C1(C(OC(C(C(O)=O)=O)(C)C1)O)=O,,,5,1,1,0,1
44161_0,,,,2,1,1,2
C(C1(C(CC(C=O)O1)=O)O)(O)=O,,,5,1,1,0,1
44163_0,,,,2,1,1,2
C(C(C1(CC(CO1)(C)O)O)=O)(O)=O,,,5,1,1,0,1
44165_0,,,,2,1,1,2
C(C1(C(CC(CO)(C)O1)=O)O)(O)=O,,,5,1,1,0,1
44167_0,,,,2,1,1,2
C(C1(C(CC(C=CC)O1)=O)O)(O)=O,,,5,1,1,0,1
44169_0,,,,2,1,1,2
C(C1(C(CC(CC=C)O1)=O)O)(O)=O,,,5,1,1,0,1
44171_0,,,,2,1,1,2
C(C(C1(CC(CO1)O)O)=O)(O)=O,,,5,1,1,0,1
44173_0,,,,2,1,1,2
C(C1(C(CC(CO)O1)=O)O)(O)=O,,,5,1,1,0,1
44175_0,,,,2,1,1,2
C(C(C1(CC(C(C)O1)O)O)=O)(O)=O,,,5,1,1,0,1
44177_0,,,,2,1,1,2
C(C1(C(CC(C(C)O)O1)=O)O)(O)=O,,,5,1,1,0,1
44179_0,,,,2,1,1,2
C1(C(CC(C(C(O)=O)=O)(O)O1)O)=O,,,5,1,1,0,1
44181_0,,,,2,1,1,2
C(C1(C(CC(C(O)=O)O1)=O)O)(O)=O,,,5,1,1,0,1
44182_0,,,,2,1,1,2
44183_0,,,,2,1,1,2
44184_0,,,,2,1,1,2
44185_0,,,,2,1,1,2
44186_0,,,,2,1,1,2
44187_0,,,,2,1,1,2
44189_0,,,,2,1,1,2
C1(C(C(C(CCO)(O)O1)=O)(C)O)=O,,,5,1,1,0,1
44191_0,,,,2,1,1,2
C(C(C1C(C(OC1O)=O)=C)O)=O,,,5,1,1,0,1
44193_0,,,,2,1,1,2
C(C1C(C)OC(C1O)O)=O,,,5,1,1,0,1
44195_0,,,,2,1,1,2
C(C(C1C(C)OC(C1O)O)=O)(O)=O,,,5,1,1,0,1
44197_0,,,,2,1,1,2
C1(C(C=O)C(C(O)O1)O)=O,,,5,1,1,0,1
44199_0,,,,2,1,1,2
C1(C(C)(C(C(O)O1)C(C=O)O)O)=O,,,5,1,1,0,1
44201_0,,,,2,1,1,2
C(C1C(C(OC1(C(O)=O)C)O)O)=O,,,5,1,1,0,1
44203_0,,,,2,1,1,2
C1(C(C(C(O)=O)=O)C(C(O)O1)O)=O,,,5,1,1,0,1
44204_0,,,,2,1,1,2
44205_0,,,,2,1,1,2
44207_0,,,,2,1,1,2
C1(C(CCO)(O)O[C](C(O)=O)C1)=O,,,5,1,1,0,1
44208_0,,,,2,1,1,2
44210_0,,,,2,1,1,2
C1(C(C[C](C(O)=O)O)(O)OCC1)=O,,,5,1,2,0,2
44211_0,,,,2,1,1,2
44213_0,,,,2,1,1,2
C1(C(C)(O)OCC1[C](C(O)=O)O)=O,,,5,1,2,0,2
44215_0,,,,2,1,1,2
C(C1(C([C](C(O1)=O)O)CO)O)(C)=O,,,5,1,1,0,1
44217_0,,,,2,1,1,2
C1(CC(C(O)=O)OC1(CCO)O)=O,,,5,1,1,0,1
44218_0,,,,2,1,1,2
44220_0,,,,2,1,1,2
C(C(CC1(C(CCO1)=O)O)O)(O)=O,,,5,1,2,0,2
44221_0,,,,2,1,1,2
44223_0,,,,2,1,1,2
C1(C(C)(O)OCC1C(C(O)=O)O)=O,,,5,1,2,0,2
44225_0,,,,2,1,1,2
C1(C(C(CO)C(C(C)=O)(O)O1)O)=O,,,5,1,1,0,1
44226_0,,,,2,1,1,2
44228_0,,,,2,1,1,2
C(C1C(C(C(CO)(O1)O)O)O)=O,,,5,1,1,0,1
44230_0,,,,2,1,1,2
C(C1C(CC(CO)(O1)O)O)=O,,,5,1,1,0,1
44231_0,,,,2,1,1,2
44233_0,,,,2,1,1,2
C(C1C(C(C(C)(O1)O)O)O)=O,,,5,1,1,0,1
44235_0,,,,2,1,1,2
C(C1C(C(C=C)C(O1)O)O)=O,,,5,1,1,0,1
44237_0,,,,2,1,1,2
C(C1C(C(C(O1)O)O)O)=O,,,5,1,1,0,1
44239_0,,,,2,1,1,2
C(C1C(CC(O1)O)O)=O,,,5,1,1,0,1
44241_0,,,,2,1,1,2
C(C1C(C(C(O1)O)C(C)O)O)=O,,,5,1,1,0,1
44243_0,,,,2,1,1,2
C(C1C(C(C=O)OC1O)O)(O)=O,,,5,1,1,0,1
44245_0,,,,2,1,1,2
C(C(C1C(C(C(O1)O)O)O)=O)=O,,,5,1,1,0,1
44246_0,,,,2,1,1,2
44248_0,,,,2,1,1,2
C(C1C(C(C(C=O)(O1)O)O)O)=O,,,5,1,1,0,1
44249_0,,,,2,1,1,2
44251_0,,,,2,1,1,2
C(C1C(CC(C=O)(O1)O)O)=O,,,5,1,1,0,1
44253_0,,,,2,1,1,2
C(C(C1C(C(C(O1)O)O)O)=O)(O)=O,,,5,1,1,0,1
44255_0,,,,2,1,1,2
C(C1C(C(C(C(O)=O)(O1)O)O)O)=O,,,5,1,1,0,1
44257_0,,,,2,1,1,2
C(C1C(CC(C(O)=O)(O1)O)O)=O,,,5,1,1,0,1
44259_0,,,,2,1,1,2
C(C1C(C(C(CO)(O1)O)O)O)(O)=O,,,5,1,1,0,1
44261_0,,,,2,1,1,2
C(C1C(CC(CO)(O1)O)O)(O)=O,,,5,1,1,0,1
44262_0,,,,2,1,1,2
44264_0,,,,2,1,1,2
C(C1C(C(C=C)C(O1)O)O)(O)=O,,,5,1,1,0,1
44266_0,,,,2,1,1,2
C(C1C(C(C(O1)O)O)O)(O)=O,,,5,1,1,0,1
44268_0,,,,2,1,1,2
C(C1C(CC(O1)O)O)(O)=O,,,5,1,1,0,1
44270_0,,,,2,1,1,2
C(C1C(C(C(O1)O)C(C)O)O)(O)=O,,,5,1,1,0,1
44272_0,,,,2,1,1,2
C(C1C(C(C(O)=O)OC1O)O)(O)=O,,,5,1,1,0,1
44274_0,,,,2,1,1,2
C(C(C1C(C(C(O)O1)=O)O)O)(O)=O,,,5,1,1,0,1
44276_0,,,,2,1,1,2
C(C1C(C(C(C=O)(O1)O)O)O)(O)=O,,,5,1,1,0,1
44278_0,,,,2,1,1,2
C(C(C1CC(C(O)O1)=O)O)(O)=O,,,5,1,1,0,1
44280_0,,,,2,1,1,2
C(C1C(CC(C=O)(O1)O)O)(O)=O,,,5,1,1,0,1
44282_0,,,,2,1,1,2
C(C1C(CC(C(O)=O)(O1)O)O)(O)=O,,,5,1,1,0,1
44284_0,,,,2,1,1,2
C1C(CO)(C(C(CO)(O)O1)O)O,,,5,1,1,0,1
44286_0,,,,2,1,1,2
C1C(CO)(CC(CO)(O)O1)O,,,5,1,1,0,1
44288_0,,,,2,1,1,2
C1C(CO)(C(C(C)(O)O1)O)O,,,5,1,1,0,1
44290_0,,,,2,1,1,2
C=CC1C(O)OCC1(CO)O,,,5,1,1,0,1
44292_0,,,,2,1,1,2
C1C(CO)(C(C(O)O1)O)O,,,5,1,1,0,1
44293_0,,,,2,1,1,2
44294_0,,,,2,1,1,2
44295_0,,,,2,1,1,2
44296_0,,,,2,1,1,2
44297_0,,,,2,1,1,2
44298_0,,,,2,1,1,2
44299_0,,,,2,1,1,2
44300_0,,,,2,1,1,2
44301_0,,,,2,1,1,2
44303_0,,,,2,1,1,2
C1C(C)(C(C(CO)(O)O1)O)O,,,5,1,1,0,1
44305_0,,,,2,1,1,2
C(C1(C(C(C(CO)O1)O)O)O)O,,,5,1,1,0,1
44307_0,,,,2,1,1,2
C1C(C(C(CO)(O)O1)O)O,,,5,1,1,0,1
44309_0,,,,2,1,1,2
CC1C(C(C(CO)(O)O1)O)O,,,5,1,1,0,1
44310_0,,,,2,1,1,2
44312_0,,,,2,1,1,2
C1C(C)(CC(CO)(O)O1)O,,,5,1,1,0,1
44314_0,,,,2,1,1,2
C1C(C)(C(C(C)(O)O1)O)O,,,5,1,1,0,1
44316_0,,,,2,1,1,2
C(C(C)C1(CC(CO1)(C)O)O)(O)=O,,,5,1,1,0,1
44318_0,,,,2,1,1,2
C=CC1C(O)OCC1(C)O,,,5,1,1,0,1
44320_0,,,,2,1,1,2
C(C1(C(C=C)C(CO1)(C)O)O)(O)=O,,,5,1,1,0,1
44322_0,,,,2,1,1,2
C=C1C(OC(C1C(C)(CO)O)O)=O,,,5,1,1,0,1
44324_0,,,,2,1,1,2
C=C(C(O)=O)C1C(O)OCC1(C)O,,,5,1,1,0,1
44326_0,,,,2,1,1,2
C1C(C)(C(C(O)O1)O)O,,,5,1,1,0,1
44328_0,,,,2,1,1,2
C1(C2(C(C(C)O1)C(CO2)(C)O)O)=O,,,5,1,1,0,1
44330_0,,,,2,1,1,2
C1(C2C(COC2(C(O1)=O)O)(C)O)=O,,,5,1,1,0,1
44332_0,,,,2,1,1,2
[CH](C(O)=O)CC1C(O)OCC1(C)O,,,5,1,1,0,1
44334_0,,,,2,1,1,2
C(CCC1C(O)OCC1(C)O)(O)=O,,,5,1,1,0,1
44336_0,,,,2,1,1,2
C1C(C)(CC(O)O1)O,,,5,1,1,0,1
44338_0,,,,2,1,1,2
C1C(C)(C(C(O)O1)C(C)O)O,,,5,1,1,0,1
44340_0,,,,2,1,1,2
C(C1C(O)OCC1(C)O)(O)=O,,,5,1,1,0,1
44341_0,,,,2,1,1,2
44343_0,,,,2,1,1,2
C(C1(C(C(CO1)(C)O)O)O)=O,,,5,1,1,0,1
44344_0,,,,2,1,1,2
44346_0,,,,2,1,1,2
C(C1(CC(CO1)(C)O)O)=O,,,5,1,1,0,1
44348_0,,,,2,1,1,2
C(C1(C(C(CO1)(C)O)O)O)(O)=O,,,5,1,1,0,1
44350_0,,,,2,1,1,2
C(C1(CC(CO1)(C)O)O)(O)=O,,,5,1,1,0,1
44352_0,,,,2,1,1,2
C(C1(C)C(CC(CO)(O1)O)O)(O)=O,,,5,1,1,0,1
44354_0,,,,2,1,1,2
C1(C(C=CC)(CC(CO)(O)O1)O)=O,,,5,1,1,0,1
44356_0,,,,2,1,1,2
C1(C(CC(CO)(O)O1)(CC=C)O)=O,,,5,1,1,0,1
44358_0,,,,2,1,1,2
C(C1(CC(C(CO)O1)O)O)O,,,5,1,1,0,1
44360_0,,,,2,1,1,2
C1C(CC(CO)(O)O1)O,,,5,1,1,0,1
44362_0,,,,2,1,1,2
CC1C(CC(CO)(O)O1)O,,,5,1,1,0,1
44364_0,,,,2,1,1,2
C1(C(CC(CO)(O)O1)O)=O,,,5,1,1,0,1
44365_0,,,,2,1,1,2
44366_0,,,,2,1,1,2
44367_0,,,,2,1,1,2
44368_0,,,,2,1,1,2
44370_0,,,,2,1,1,2
C(C1(C)C(C(C(C)(O1)O)O)O)(O)=O,,,5,1,1,0,1
44372_0,,,,2,1,1,2
C1(C(C=CC)(C(C(C)(O)O1)O)O)=O,,,5,1,1,0,1
44374_0,,,,2,1,1,2
C1(C(C(C(C)(O)O1)O)(CC=C)O)=O,,,5,1,1,0,1
44376_0,,,,2,1,1,2
CC1(C(C(C(CO)O1)O)O)O,,,5,1,1,0,1
44378_0,,,,2,1,1,2
CC1(C(C(CO1)O)O)O,,,5,1,1,0,1
44380_0,,,,2,1,1,2
CC1(C(C(C(C)O1)O)O)O,,,5,1,1,0,1
44382_0,,,,2,1,1,2
C(C1(COC(C)(C1O)O)O)=O,,,5,1,1,0,1
44383_0,,,,2,1,1,2
44385_0,,,,2,1,1,2
C(C(C1(C)C(CC(O)O1)O)O)(O)=O,,,5,1,1,0,1
44387_0,,,,2,1,1,2
C(C(C1C(C)(CC(O)O1)O)O)(O)=O,,,5,1,1,0,1
44389_0,,,,2,1,1,2
C1(C(C(C(CC(C)O)(O)O1)O)O)=O,,,5,1,1,0,1
44391_0,,,,2,1,1,2
C(CC1(C(C(C(O1)=O)O)O)O)(O)=O,,,5,1,1,0,1
44393_0,,,,2,1,1,2
C1(C(C(C(CCO)(O)O1)O)O)=O,,,5,1,1,0,1
44395_0,,,,2,1,1,2
C1(C(C)(C(C(CCO)(O)O1)O)O)=O,,,5,1,1,0,1
44397_0,,,,2,1,1,2
C(C1(C(C(C=C)C(O1)O)O)C)(O)=O,,,5,1,1,0,1
44398_0,,,,2,1,1,2
44400_0,,,,2,1,1,2
C(C1(C)C(CC(O1)O)O)(O)=O,,,5,1,1,0,1
44402_0,,,,2,1,1,2
C(C(C)(C1CC(C(O)O1)=O)O)(O)=O,,,5,1,1,0,1
44404_0,,,,2,1,1,2
C(C1(C)C(CC(C=O)(O1)O)O)(O)=O,,,5,1,1,0,1
44406_0,,,,2,1,1,2
C(C(CO)C1(CC(CO1)O)O)(O)=O,,,5,1,1,0,1
44408_0,,,,2,1,1,2
C(C(C)C1(C)CC(C(O)O1)=O)(O)=O,,,5,1,1,0,1
44410_0,,,,2,1,1,2
C(C(C)C1(CC(CO1)O)O)(O)=O,,,5,1,1,0,1
44412_0,,,,2,1,1,2
C(C(C)C1(CC(C(C)O1)O)O)(O)=O,,,5,1,1,0,1
44414_0,,,,2,1,1,2
C(C(C)C1(CC(C(O1)=O)O)O)(O)=O,,,5,1,1,0,1
44416_0,,,,2,1,1,2
C(C)=CC(C1C(C(OC1O)=O)=C)O,,,5,1,1,0,1
44417_0,,,,2,1,1,2
44418_0,,,,2,1,1,2
44420_0,,,,2,1,1,2
C=CCC(C1C(C(OC1O)=O)=C)O,,,5,1,1,0,1
44421_0,,,,2,1,1,2
44422_0,,,,2,1,1,2
44424_0,,,,2,1,1,2
C1(C(C=CC)(C(C=C)C(O)O1)O)=O,,,5,1,1,0,1
44426_0,,,,2,1,1,2
C1(C(CC=C)(C(C=C)C(O)O1)O)=O,,,5,1,1,0,1
44428_0,,,,2,1,1,2
C=CC1C(O)OC(CO)C1O,,,5,1,1,0,1
44430_0,,,,2,1,1,2
C=CC1C(O)OCC1O,,,5,1,1,0,1
44432_0,,,,2,1,1,2
C=CC1C(O)OC(C)C1O,,,5,1,1,0,1
44434_0,,,,2,1,1,2
C1(C(C(C=C)C(O)O1)O)=O,,,5,1,1,0,1
44435_0,,,,2,1,1,2
44436_0,,,,2,1,1,2
44437_0,,,,2,1,1,2
44438_0,,,,2,1,1,2
44440_0,,,,2,1,1,2
C1(C(C=CC)(C(C(O)O1)O)O)=O,,,5,1,1,0,1
44441_0,,,,2,1,1,2
44443_0,,,,2,1,1,2
C(C1(C=CC)CC(C(O1)O)=O)(O)=O,,,5,1,1,0,1
44445_0,,,,2,1,1,2
C(C1(CC(C(O1)=O)(C=CC)O)O)=O,,,5,1,1,0,1
44447_0,,,,2,1,1,2
C1(C(C(C(O)O1)O)(CC=C)O)=O,,,5,1,1,0,1
44448_0,,,,2,1,1,2
44450_0,,,,2,1,1,2
C(C1(CC=C)CC(C(O)O1)=O)(O)=O,,,5,1,1,0,1
44452_0,,,,2,1,1,2
C1(C(CC(C=O)(O)O1)(CC=C)O)=O,,,5,1,1,0,1
44454_0,,,,2,1,1,2
C(C1(C(C=C)C(CO1)O)O)(O)=O,,,5,1,1,0,1
44456_0,,,,2,1,1,2
C(C1(C(C=C)C(C(C)O1)O)O)(O)=O,,,5,1,1,0,1
44458_0,,,,2,1,1,2
C1(C(C(C=C)C(C(O)=O)(O)O1)O)=O,,,5,1,1,0,1
44460_0,,,,2,1,1,2
C1(C(O)OC(C1)CC(C(O)=O)=C)=O,,,5,1,1,0,1
44462_0,,,,2,1,1,2
C=C(C(O)=O)C1C(O)OCC1O,,,5,1,1,0,1
44464_0,,,,2,1,1,2
C=C1C(OC(C1C(CO)O)O)=O,,,5,1,1,0,1
44466_0,,,,2,1,1,2
C=C(C(O)=O)C1C(O)OC(C)C1O,,,5,1,1,0,1
44468_0,,,,2,1,1,2
C=C1C(OC(C1C(C(C)O)O)O)=O,,,5,1,1,0,1
44470_0,,,,2,1,1,2
C1(C(C(C(C(O)=O)=C)C(O)O1)O)=O,,,5,1,1,0,1
44472_0,,,,2,1,1,2
C(C(C1C(C(OC1O)=O)=C)O)(O)=O,,,5,1,1,0,1
44473_0,,,,2,1,1,2
44474_0,,,,2,1,1,2
44476_0,,,,2,1,1,2
C(C(C)(C1C(C(OC1O)=O)=C)O)=O,,,5,1,1,0,1
44478_0,,,,2,1,1,2
C(C(C1C(C(OC1O)=O)=C)O)(C)=O,,,5,1,1,0,1
44479_0,,,,2,1,1,2
44481_0,,,,2,1,1,2
C1(C(O)OC(C=C(C(O)=O)C)C1)=O,,,5,1,1,0,1
44483_0,,,,2,1,1,2
C(C1C(C(C(O)O1)O)O)O,,,5,1,1,0,1
44485_0,,,,2,1,1,2
C(C1C(CC(O)O1)O)O,,,5,1,1,0,1
44487_0,,,,2,1,1,2
CC(C1C(O)OC(CO)C1O)O,,,5,1,1,0,1
44489_0,,,,2,1,1,2
C(C1C(O)OC(CO)C1O)(O)=O,,,5,1,1,0,1
44490_0,,,,2,1,1,2
44492_0,,,,2,1,1,2
C(C1(C(C(C(CO)O1)O)O)O)=O,,,5,1,1,0,1
44493_0,,,,2,1,1,2
44495_0,,,,2,1,1,2
C(C1(CC(C(CO)O1)O)O)=O,,,5,1,1,0,1
44496_0,,,,2,1,1,2
44498_0,,,,2,1,1,2
C(C1(CC(C(CO)O1)O)O)(O)=O,,,5,1,1,0,1
44500_0,,,,2,1,1,2
C1(C(C2COC(C)(C2(O)O1)O)=O)=O,,,5,1,2,0,2
44501_0,,,,2,1,1,2
44503_0,,,,2,1,1,2
C1(C2(C(C(CO2)O)C(C)O1)O)=O,,,5,1,1,0,1
44505_0,,,,2,1,1,2
C1(C2C(COC2(C(O1)=O)O)O)=O,,,5,1,1,0,1
44507_0,,,,2,1,1,2
[CH](C(O)=O)CC1C(O)OCC1O,,,5,1,1,0,1
44509_0,,,,2,1,1,2
C(CCC1C(O)OCC1O)(O)=O,,,5,1,1,0,1
44511_0,,,,2,1,1,2
C1C(CC(O)O1)O,,,5,1,1,0,1
44513_0,,,,2,1,1,2
C1C(C(C(O)O1)C(C)O)O,,,5,1,1,0,1
44515_0,,,,2,1,1,2
C(C1(C(C(C)O)C(CO1)O)O)(O)=O,,,5,1,1,0,1
44517_0,,,,2,1,1,2
C(C1C(O)OCC1O)(O)=O,,,5,1,1,0,1
44519_0,,,,2,1,1,2
C1(C(C)(C(C(O)O1)C(CO)O)O)=O,,,5,1,1,0,1
44521_0,,,,2,1,1,2
C(C(C)(C1C(O)OCC1O)O)(O)=O,,,5,1,1,0,1
44523_0,,,,2,1,1,2
C(C1C(COC1(C(O)=O)O)O)(O)=O,,,5,1,1,0,1
44525_0,,,,2,1,1,2
C1(C(O)OC(CO)C1O)=O,,,5,1,1,0,1
44527_0,,,,2,1,1,2
C(C1(C(C(CO1)O)O)O)=O,,,5,1,1,0,1
44529_0,,,,2,1,1,2
C1(C(O)OC(CO)C1)=O,,,5,1,1,0,1
44531_0,,,,2,1,1,2
C(C1(CC(CO1)O)O)=O,,,5,1,1,0,1
44533_0,,,,2,1,1,2
C(C1(C(C(CO1)O)O)O)(O)=O,,,5,1,1,0,1
44535_0,,,,2,1,1,2
C(C1(CC(CO1)O)O)(O)=O,,,5,1,1,0,1
44536_0,,,,2,1,1,2
44537_0,,,,2,1,1,2
44539_0,,,,2,1,1,2
C1(C(C(C(O)O1)O)(CC(C)O)O)=O,,,5,1,1,0,1
44541_0,,,,2,1,1,2
C1(C(C(C(O)O1)O)(CC(O)=O)O)=O,,,5,1,1,0,1
44543_0,,,,2,1,1,2
C(C1(COC(C1O)O)O)=O,,,5,1,1,0,1
44545_0,,,,2,1,1,2
C(C1(COC(C1O)O)O)(O)=O,,,5,1,1,0,1
44547_0,,,,2,1,1,2
C1(C(CO)(C(C(O)O1)O)O)=O,,,5,1,1,0,1
44549_0,,,,2,1,1,2
C1(C(C)(C(C(O)O1)O)O)=O,,,5,1,1,0,1
44551_0,,,,2,1,1,2
C1(C2(CC(C)O1)CC(C(O2)O)=O)=O,,,5,1,1,0,1
44553_0,,,,2,1,1,2
C1(C2(C(C(C(C)O2)O)C(C)O1)O)=O,,,5,1,1,0,1
44555_0,,,,2,1,1,2
C1(C(C2C(C)OC(C2(O)O1)=O)O)=O,,,5,1,1,0,1
44557_0,,,,2,1,1,2
C1(CC2(C(O1)=O)CC(C(O)O2)=O)=O,,,5,1,1,0,1
44559_0,,,,2,1,1,2
C1(C2C(C(C)OC2(C(O1)=O)O)O)=O,,,5,1,1,0,1
44561_0,,,,2,1,1,2
C1(C2(C(C(O1)=O)C(C(O2)=O)O)O)=O,,,5,1,1,0,1
44563_0,,,,2,1,1,2
C1(C(O)OC(C)C1C[CH]C(O)=O)=O,,,5,1,2,0,2
44565_0,,,,2,1,1,2
C1(C(C(C(O)O1)=O)C[CH]C(O)=O)=O,,,5,1,2,0,2
44567_0,,,,2,1,1,2
C1(C(O)OCC1C[CH]C(O)=O)=O,,,5,1,2,0,2
44569_0,,,,2,1,1,2
C(CCC1C(C(O)OC1C)=O)(O)=O,,,5,1,2,0,2
44571_0,,,,2,1,1,2
C(CCC1C(OC(C1=O)O)=O)(O)=O,,,5,1,2,0,2
44573_0,,,,2,1,1,2
C(CCC1C(C(O)OC1)=O)(O)=O,,,5,1,2,0,2
44575_0,,,,2,1,1,2
C1(C(O)OC(CC[CH]C(O)=O)C1)=O,,,5,1,2,0,2
44577_0,,,,2,1,1,2
[CH](C(O)=O)CC1C(O)OC(C)C1O,,,5,1,1,0,1
44579_0,,,,2,1,1,2
C1(C(C(C(O)O1)C[CH]C(O)=O)O)=O,,,5,1,1,0,1
44581_0,,,,2,1,1,2
C(CCCC1CC(C(O)O1)=O)(O)=O,,,5,1,2,0,2
44583_0,,,,2,1,1,2
C(CCC1C(O)OC(C)C1O)(O)=O,,,5,1,1,0,1
44585_0,,,,2,1,1,2
C(CCC1C(O)OC(C1O)=O)(O)=O,,,5,1,1,0,1
44587_0,,,,2,1,1,2
CC1C(CC(O)O1)O,,,5,1,1,0,1
44589_0,,,,2,1,1,2
CC(C1C(O)OC(C)C1O)O,,,5,1,1,0,1
44591_0,,,,2,1,1,2
C(C1C(O)OC(C)C1O)(O)=O,,,5,1,1,0,1
44593_0,,,,2,1,1,2
C1(C(O)OC(C(C)O)C1O)=O,,,5,1,1,0,1
44595_0,,,,2,1,1,2
C(C1(C(C(C(C)O1)O)O)O)=O,,,5,1,1,0,1
44597_0,,,,2,1,1,2
C1(C(O)OC(C(C)O)C1)=O,,,5,1,1,0,1
44599_0,,,,2,1,1,2
C(C1(CC(C(C)O1)O)O)=O,,,5,1,1,0,1
44601_0,,,,2,1,1,2
C(C1(C(C(C(C)O1)O)O)O)(O)=O,,,5,1,1,0,1
44603_0,,,,2,1,1,2
C(C1(CC(C(C)O1)O)O)(O)=O,,,5,1,1,0,1
44604_0,,,,2,1,1,2
44605_0,,,,2,1,1,2
44606_0,,,,2,1,1,2
44607_0,,,,2,1,1,2
44608_0,,,,2,1,1,2
44609_0,,,,2,1,1,2
44610_0,,,,2,1,1,2
44612_0,,,,2,1,1,2
C1(C(C(C(C(O)=O)(O)O1)O)O)=O,,,5,1,1,0,1
44613_0,,,,2,1,1,2
44615_0,,,,2,1,1,2
C(C1CC(C(CO)(O1)O)O)(O)=O,,,5,1,1,0,1
44617_0,,,,2,1,1,2
C(C1C(C(CO)(C(O1)O)O)O)(O)=O,,,5,1,1,0,1
44619_0,,,,2,1,1,2
C(C1CC(CO)(C(O1)O)O)(O)=O,,,5,1,1,0,1
44621_0,,,,2,1,1,2
C(C1C(C(C)(C(O1)O)O)O)(O)=O,,,5,1,1,0,1
44623_0,,,,2,1,1,2
C(C1CC(C)(C(O1)O)O)(O)=O,,,5,1,1,0,1
44625_0,,,,2,1,1,2
C(C1CC(C(C)(O1)O)O)(O)=O,,,5,1,1,0,1
44627_0,,,,2,1,1,2
C(C1C(C(CO)(O)OC1C)=O)=O,,,5,1,1,0,1
44629_0,,,,2,1,1,2
C1(C(C=O)C(C(CO)(O)O1)=O)=O,,,5,1,1,0,1
44631_0,,,,2,1,1,2
C(CO)(C1(CC(C(O1)=O)=O)O)=O,,,5,1,1,0,1
44633_0,,,,2,1,1,2
C1(C(C(C(O)O1)=O)=O)=O,,,5,1,1,0,1
44635_0,,,,2,1,1,2
C(C)(C1(C(C(C(O1)=O)=O)O)O)=O,,,5,1,1,0,1
44637_0,,,,2,1,1,2
C(C)(C1(C(C(CO1)=O)=O)O)=O,,,5,1,1,0,1
44639_0,,,,2,1,1,2
C1(C(C)(O)OCC1)=O,,,5,1,1,0,1
44640_0,,,,2,1,1,2
44642_0,,,,2,1,1,2
C(CO)(C1(C(CC(C)O1)O)O)=O,,,5,1,1,0,1
44644_0,,,,2,1,1,2
C1(CC(C(C(CO)=O)(O)O1)O)=O,,,5,1,1,0,1
44646_0,,,,2,1,1,2
C1(COC(C(CO)=O)(C1O)O)=O,,,5,1,1,0,1
44648_0,,,,2,1,1,2
C(C1(C(C(CO)(O)OC1)=O)O)=O,,,5,1,1,0,1
44650_0,,,,2,1,1,2
C(C1(C(CC(C)O1)O)O)=O,,,5,1,1,0,1
44652_0,,,,2,1,1,2
C(C)(C1(C(CC(C)O1)O)O)=O,,,5,1,1,0,1
44654_0,,,,2,1,1,2
C1(CC(C(C=O)(O)O1)O)=O,,,5,1,1,0,1
44656_0,,,,2,1,1,2
C1(CC(C(C(C)=O)(O)O1)O)=O,,,5,1,1,0,1
44658_0,,,,2,1,1,2
C(C1(C(C(CO1)=O)O)O)=O,,,5,1,1,0,1
44660_0,,,,2,1,1,2
C1(COC(C(C)=O)(C1O)O)=O,,,5,1,1,0,1
44662_0,,,,2,1,1,2
C(C1(C(C(O)OC1)=O)O)=O,,,5,1,1,0,1
44664_0,,,,2,1,1,2
C(C1(C(C(C)(O)OC1)=O)O)=O,,,5,1,1,0,1
44665_0,,,,2,1,1,2
44666_0,,,,2,1,1,2
44667_0,,,,2,1,1,2
44668_0,,,,2,1,1,2
44669_0,,,,2,1,1,2
44670_0,,,,2,1,1,2
44671_0,,,,2,1,1,2
44672_0,,,,2,1,1,2
44673_0,,,,2,1,1,2
44674_0,,,,2,1,1,2
44675_0,,,,2,1,1,2
44676_0,,,,2,1,1,2
44678_0,,,,2,1,1,2
C(C1(C[CH]C(O1)=O)O)=O,,,5,1,1,0,1
44680_0,,,,2,1,1,2
C1(CCC(C=O)(O)O1)=O,,,5,1,1,0,1
44682_0,,,,2,1,1,2
C(CO)(C1(C[CH]C(O1)=O)O)=O,,,5,1,1,0,1
44684_0,,,,2,1,1,2
C(C)(C1(C[CH]C(O1)=O)O)=O,,,5,1,1,0,1
44686_0,,,,2,1,1,2
C1(CCC(C(CO)=O)(O)O1)=O,,,5,1,1,0,1
44688_0,,,,2,1,1,2
C1(CCC(C(C)=O)(O)O1)=O,,,5,1,1,0,1
44690_0,,,,2,1,1,2
CC1CC(C(O)O1)O,,,5,1,1,0,1
44692_0,,,,2,1,1,2
C1(CC(C(O)O1)O)=O,,,5,1,1,0,1
44693_0,,,,2,1,1,2
44694_0,,,,2,1,1,2
44695_0,,,,2,1,1,2
44697_0,,,,2,1,1,2
[CH]1C(OC(C)(C1)O)=O,,,5,1,1,0,1
44699_0,,,,2,1,1,2
C1(CCC(C)(O)O1)=O,,,5,1,1,0,1
44701_0,,,,2,1,1,2
[CH]1C(OC(C1)O)=O,,,5,1,1,0,1
44703_0,,,,2,1,1,2
C1(CCC(O)O1)=O,,,5,1,1,0,1
44704_0,,,,2,1,1,2
44706_0,,,,2,1,1,2
C(C(C1(C(CC(C)O1)O)O)O)=O,,,5,1,1,0,1
44708_0,,,,2,1,1,2
C(C(C1(C(CC(C)O1)O)O)O)(O)=O,,,5,1,1,0,1
44710_0,,,,2,1,1,2
C1(C(CO)OC(C1C(C)O)O)=O,,,5,1,1,0,1
44712_0,,,,2,1,1,2
C1(C(C)OC(C1C(C)O)O)=O,,,5,1,1,0,1
44713_0,,,,2,1,1,2
44715_0,,,,2,1,1,2
C1(CC(C(C(C=O)O)(O)O1)O)=O,,,5,1,1,0,1
44717_0,,,,2,1,1,2
C1(CC(C(C(C(O)=O)O)(O)O1)O)=O,,,5,1,1,0,1
44719_0,,,,2,1,1,2
C(C1C(C(CO)OC1O)=O)(O)=O,,,5,1,1,0,1
44721_0,,,,2,1,1,2
C(C1C(C(C)OC1O)=O)(O)=O,,,5,1,1,0,1
44723_0,,,,2,1,1,2
C(C1C(C(C(CO)(O1)O)O)=O)=O,,,5,1,1,0,1
44724_0,,,,2,1,1,2
44726_0,,,,2,1,1,2
C(C(C1(C(C(CO1)=O)O)O)O)=O,,,5,1,1,0,1
44728_0,,,,2,1,1,2
C1(C(C(C=O)(OC1CO)O)O)=O,,,5,1,1,0,1
44730_0,,,,2,1,1,2
C1(CC(C=O)(OC1CO)O)=O,,,5,1,1,0,1
44732_0,,,,2,1,1,2
C(C1C(C(C(CO)(O1)O)O)=O)(O)=O,,,5,1,1,0,1
44734_0,,,,2,1,1,2
C(C(C1(C(C(CO1)=O)O)O)O)(O)=O,,,5,1,1,0,1
44736_0,,,,2,1,1,2
C1(C(C(C(O)=O)(OC1CO)O)O)=O,,,5,1,1,0,1
44738_0,,,,2,1,1,2
C1(C(C(C(C(CO)O)(O)O1)O)=O)=O,,,5,1,1,0,1
44740_0,,,,2,1,1,2
C1(C(CO)OC(C1)O)=O,,,5,1,1,0,1
44742_0,,,,2,1,1,2
C(C1C(C(C(O1)O)(CO)O)=O)=O,,,5,1,1,0,1
44743_0,,,,2,1,1,2
44745_0,,,,2,1,1,2
C(C1C(C(C(O1)O)(CO)O)=O)(O)=O,,,5,1,1,0,1
44747_0,,,,2,1,1,2
C(C1C(C(C(O1)O)(C)O)=O)=O,,,5,1,1,0,1
44748_0,,,,2,1,1,2
44750_0,,,,2,1,1,2
C1(C(C(C=O)(OC1C)O)O)=O,,,5,1,1,0,1
44752_0,,,,2,1,1,2
C(C1C(C(C(C)(O1)O)O)=O)=O,,,5,1,1,0,1
44753_0,,,,2,1,1,2
44754_0,,,,2,1,1,2
44755_0,,,,2,1,1,2
44756_0,,,,2,1,1,2
44757_0,,,,2,1,1,2
44759_0,,,,2,1,1,2
C(C1C(C(C(O1)O)(C)O)=O)(O)=O,,,5,1,1,0,1
44761_0,,,,2,1,1,2
C1(CC(C=O)(OC1C)O)=O,,,5,1,1,0,1
44762_0,,,,2,1,1,2
44764_0,,,,2,1,1,2
C1(C(C(C(O)=O)(OC1C)O)O)=O,,,5,1,1,0,1
44766_0,,,,2,1,1,2
C1(C(C(C(C(C)O)(O)O1)O)=O)=O,,,5,1,1,0,1
44768_0,,,,2,1,1,2
C1(C(C)OC(C1)O)=O,,,5,1,1,0,1
44770_0,,,,2,1,1,2
C1(CC(C(O)=O)(OC1C)O)=O,,,5,1,1,0,1
44772_0,,,,2,1,1,2
C1(C(CC(C(C)O)(O)O1)=O)=O,,,5,1,1,0,1
44774_0,,,,2,1,1,2
C1(COC(C)(C1O)O)=O,,,5,1,1,0,1
44775_0,,,,2,1,1,2
44777_0,,,,2,1,1,2
C(C(C1(C[CH]C(O1)=O)O)O)=O,,,5,1,1,0,1
44779_0,,,,2,1,1,2
C1(CCC(C(C=O)O)(O)O1)=O,,,5,1,1,0,1
44781_0,,,,2,1,1,2
C(C(C1(C[CH]C(O1)=O)O)O)(O)=O,,,5,1,1,0,1
44783_0,,,,2,1,1,2
C1(CCC(C(C(O)=O)O)(O)O1)=O,,,5,1,1,0,1
44785_0,,,,2,1,1,2
C1C(C(C)O)C(C(CO)(O)O1)O,,,5,1,1,0,1
44786_0,,,,2,1,1,2
44788_0,,,,2,1,1,2
C1C(C(C)O)C(C(O)O1)(CO)O,,,5,1,1,0,1
44789_0,,,,2,1,1,2
44791_0,,,,2,1,1,2
CC1(C(O)OCC1C(C)O)O,,,5,1,1,0,1
44792_0,,,,2,1,1,2
44794_0,,,,2,1,1,2
C1C(C(C)O)C(C(C)(O)O1)O,,,5,1,1,0,1
44795_0,,,,2,1,1,2
44797_0,,,,2,1,1,2
C(C1COC(CO)(C1O)O)(O)=O,,,5,1,1,0,1
44798_0,,,,2,1,1,2
44800_0,,,,2,1,1,2
C(C1COC(C1(CO)O)O)(O)=O,,,5,1,1,0,1
44801_0,,,,2,1,1,2
44803_0,,,,2,1,1,2
C(C1COC(C1(C)O)O)(O)=O,,,5,1,1,0,1
44804_0,,,,2,1,1,2
44806_0,,,,2,1,1,2
C(C1COC(C)(C1O)O)(O)=O,,,5,1,1,0,1
44807_0,,,,2,1,1,2
44809_0,,,,2,1,1,2
C1CC(C(CO)(O)O1)O,,,5,1,1,0,1
44811_0,,,,2,1,1,2
C1CC(C(O)O1)(CO)O,,,5,1,1,0,1
44813_0,,,,2,1,1,2
CC1(C(O)OCC1)O,,,5,1,1,0,1
44815_0,,,,2,1,1,2
CC1(C(CCO1)O)O,,,5,1,1,0,1
44817_0,,,,2,1,1,2
C1(C(C(C)O)C(C(CO)(O)O1)O)=O,,,5,1,1,0,1
44818_0,,,,2,1,1,2
44820_0,,,,2,1,1,2
C1(C(C(C)O)C(CO)(C(O)O1)O)=O,,,5,1,1,0,1
44821_0,,,,2,1,1,2
44823_0,,,,2,1,1,2
C1(C(C(C)O)C(C)(C(O)O1)O)=O,,,5,1,1,0,1
44824_0,,,,2,1,1,2
44826_0,,,,2,1,1,2
C1(C(C(C)O)C(C(C)(O)O1)O)=O,,,5,1,1,0,1
44827_0,,,,2,1,1,2
44828_0,,,,2,1,1,2
44829_0,,,,2,1,1,2
44830_0,,,,2,1,1,2
44831_0,,,,2,1,1,2
44833_0,,,,2,1,1,2
C1(CC(C(CO)(O)O1)O)=O,,,5,1,1,0,1
44835_0,,,,2,1,1,2
C1(CC(CO)(C(O)O1)O)=O,,,5,1,1,0,1
44837_0,,,,2,1,1,2
C1(CC(C)(C(O)O1)O)=O,,,5,1,1,0,1
44839_0,,,,2,1,1,2
C1(CC(C(C)(O)O1)O)=O,,,5,1,1,0,1
44840_0,,,,2,1,1,2
44842_0,,,,2,1,1,2
C(C1(COC(C1(C)O)O)C(C)O)=O,,,5,1,1,0,1
44843_0,,,,2,1,1,2
44845_0,,,,2,1,1,2
C(C1(COC(C)(C1O)O)C(C)O)=O,,,5,1,1,0,1
44847_0,,,,2,1,1,2
C(C1(CO)C(C)OC(C1O)O)=O,,,5,1,1,0,1
44849_0,,,,2,1,1,2
C(C1(COC(C1O)O)C(C)O)=O,,,5,1,1,0,1
44851_0,,,,2,1,1,2
C1C(C)(C(C(O)O1)(CO)C(C)O)O,,,5,1,1,0,1
44853_0,,,,2,1,1,2
C1C(C(C(O)O1)(CO)C(C)O)O,,,5,1,1,0,1
44855_0,,,,2,1,1,2
CC(C1(C(O)OC(C)C1O)CO)O,,,5,1,1,0,1
44857_0,,,,2,1,1,2
C1(C(C(CO)(C(O)O1)C(C)O)O)=O,,,5,1,1,0,1
44859_0,,,,2,1,1,2
C(C1(C(C)OC(C1O)O)C(C)O)=O,,,5,1,1,0,1
44861_0,,,,2,1,1,2
C1C(C(C(O)O1)(C(C)O)C(C)O)O,,,5,1,1,0,1
44863_0,,,,2,1,1,2
C(C1(C=O)C(C)OC(C1O)O)(O)=O,,,5,1,1,0,1
44865_0,,,,2,1,1,2
C1(C(C=O)(C(C(O)O1)O)C(C)O)=O,,,5,1,1,0,1
44867_0,,,,2,1,1,2
C(C1(C(O)OCC1O)C(C)O)(O)=O,,,5,1,1,0,1
44869_0,,,,2,1,1,2
C(C1C(CC=O)OC(C1O)O)(O)=O,,,5,1,1,0,1
44871_0,,,,2,1,1,2
C1(C(C(CC=O)O)C(C(O)O1)O)=O,,,5,1,1,0,1
44872_0,,,,2,1,1,2
44874_0,,,,2,1,1,2
C(C1(C=O)COC(C1(C)O)O)(O)=O,,,5,1,1,0,1
44875_0,,,,2,1,1,2
44877_0,,,,2,1,1,2
C(C1(C=O)COC(C)(C1O)O)(O)=O,,,5,1,1,0,1
44879_0,,,,2,1,1,2
C1(C(C=O)(CO)C(C(O)O1)O)=O,,,5,1,1,0,1
44881_0,,,,2,1,1,2
C(C1(C=O)COC(C1O)O)(O)=O,,,5,1,1,0,1
44883_0,,,,2,1,1,2
C(C1(C(O)OCC1(C)O)CO)(O)=O,,,5,1,1,0,1
44885_0,,,,2,1,1,2
C(C1(C(O)OCC1O)CO)(O)=O,,,5,1,1,0,1
44887_0,,,,2,1,1,2
C(C1(C(O)OC(C)C1O)CO)(O)=O,,,5,1,1,0,1
44889_0,,,,2,1,1,2
C(C1(C(O)OC(C1O)=O)CO)(O)=O,,,5,1,1,0,1
44891_0,,,,2,1,1,2
C1(C(C(O)=O)(C=O)C(C(O)O1)O)=O,,,5,1,1,0,1
44893_0,,,,2,1,1,2
C(C1(C(O)=O)C(O)OCC1O)(O)=O,,,5,1,1,0,1
44895_0,,,,2,1,1,2
C1(C(C)(C(CO)(CO)C(O)O1)O)=O,,,5,1,1,0,1
44896_0,,,,2,1,1,2
44898_0,,,,2,1,1,2
C(C(C1(COC(C1(C)O)O)O)=O)=O,,,5,1,1,0,1
44899_0,,,,2,1,1,2
44901_0,,,,2,1,1,2
C(C1(C(C(C(C)=O)(CO1)O)O)O)=O,,,5,1,1,0,1
44902_0,,,,2,1,1,2
44903_0,,,,2,1,1,2
44905_0,,,,2,1,1,2
C(C(C1(COC(C)(C1O)O)O)=O)=O,,,5,1,1,0,1
44906_0,,,,2,1,1,2
44907_0,,,,2,1,1,2
44909_0,,,,2,1,1,2
C1(C(O)OC(CCO)C1(CO)O)=O,,,5,1,1,0,1
44911_0,,,,2,1,1,2
C(C(C1(COC(C1O)O)O)=O)=O,,,5,1,1,0,1
44912_0,,,,2,1,1,2
44914_0,,,,2,1,1,2
C1(C(OC(C=O)C1(CO)O)O)=O,,,5,1,1,0,1
44916_0,,,,2,1,1,2
C(C1(C(CO)(C(CO1)(C)O)O)O)=O,,,5,1,1,0,1
44917_0,,,,2,1,1,2
44919_0,,,,2,1,1,2
C1(C(O)OC(CO)(C)C1(CO)O)=O,,,5,1,1,0,1
44920_0,,,,2,1,1,2
44922_0,,,,2,1,1,2
C1(C(OC(C=CC)C1(CO)O)O)=O,,,5,1,1,0,1
44923_0,,,,2,1,1,2
44925_0,,,,2,1,1,2
C1(C(O)OC(CC=C)C1(CO)O)=O,,,5,1,1,0,1
44927_0,,,,2,1,1,2
C(C1(C(CO)(C(CO1)O)O)O)=O,,,5,1,1,0,1
44928_0,,,,2,1,1,2
44930_0,,,,2,1,1,2
C1(C(O)OC(CO)C1(CO)O)=O,,,5,1,1,0,1
44932_0,,,,2,1,1,2
C(C1(C(CO)(C(C(C)O1)O)O)O)=O,,,5,1,1,0,1
44933_0,,,,2,1,1,2
44935_0,,,,2,1,1,2
C1(C(O)OC(C(C)O)C1(CO)O)=O,,,5,1,1,0,1
44937_0,,,,2,1,1,2
C1(C(C(CO)(C(C=O)(O)O1)O)O)=O,,,5,1,1,0,1
44938_0,,,,2,1,1,2
44940_0,,,,2,1,1,2
C1(C(OC(C(O)=O)C1(CO)O)O)=O,,,5,1,1,0,1
44941_0,,,,2,1,1,2
44942_0,,,,2,1,1,2
44943_0,,,,2,1,1,2
44945_0,,,,2,1,1,2
C(C(C1(C(C)OC(C1O)O)O)=O)=O,,,5,1,1,0,1
44946_0,,,,2,1,1,2
44948_0,,,,2,1,1,2
C1(C(OC(C=O)C1(C(C)O)O)O)=O,,,5,1,1,0,1
44950_0,,,,2,1,1,2
C(C1(C(C(C)O)(C(CO1)O)O)O)=O,,,5,1,1,0,1
44951_0,,,,2,1,1,2
44953_0,,,,2,1,1,2
C1(C(O)OC(CO)C1(C(C)O)O)=O,,,5,1,1,0,1
44954_0,,,,2,1,1,2
44955_0,,,,2,1,1,2
44956_0,,,,2,1,1,2
44958_0,,,,2,1,1,2
C1(C(C(C=O)=O)(C(C(O)O1)O)O)=O,,,5,1,1,0,1
44959_0,,,,2,1,1,2
44961_0,,,,2,1,1,2
C(C1(C(C(O)OC1C=O)=O)O)(O)=O,,,5,1,1,0,1
44963_0,,,,2,1,1,2
C(C1(C(COC1(C=O)O)O)O)(O)=O,,,5,1,1,0,1
44964_0,,,,2,1,1,2
44966_0,,,,2,1,1,2
C(C1(C(C(O)OC1CO)=O)O)(O)=O,,,5,1,1,0,1
44967_0,,,,2,1,1,2
44968_0,,,,2,1,1,2
44970_0,,,,2,1,1,2
C(C1COC(C1(CCO)O)O)(O)=O,,,5,1,1,0,1
44972_0,,,,2,1,1,2
C1(C(CO)C(C(O)O1)(CCO)O)=O,,,5,1,1,0,1
44973_0,,,,2,1,1,2
44975_0,,,,2,1,1,2
C(C1(COC(C1(CCO)O)O)O)=O,,,5,1,1,0,1
44976_0,,,,2,1,1,2
44978_0,,,,2,1,1,2
C(C1COC(C1O)(CCO)O)(O)=O,,,5,1,1,0,1
44980_0,,,,2,1,1,2
C1(C(CO)C(C(CCO)(O)O1)O)=O,,,5,1,1,0,1
44982_0,,,,2,1,1,2
C(C1(COC(C1O)(CCO)O)O)=O,,,5,1,1,0,1
44984_0,,,,2,1,1,2
C(C1(C(CO)(C(CO1)O)O)O)(O)=O,,,5,1,1,0,1
44986_0,,,,2,1,1,2
C1(C(C=O)(C(C(O)O1)O)O)=O,,,5,1,1,0,1
44988_0,,,,2,1,1,2
C(C1COC(C1O)O)(O)=O,,,5,1,1,0,1
44990_0,,,,2,1,1,2
C1(C(CO)C(C(O)O1)O)=O,,,5,1,1,0,1
44992_0,,,,2,1,1,2
C1(C(C(C(O)O1)O)C(C)O)=O,,,5,1,1,0,1
44994_0,,,,2,1,1,2
C(C1C(C)OC(C1O)O)(O)=O,,,5,1,1,0,1
44996_0,,,,2,1,1,2
C1(C(C(O)=O)C(C(O)O1)O)=O,,,5,1,1,0,1
44998_0,,,,2,1,1,2
C(C1(C(C)OC(C1O)O)O)(O)=O,,,5,1,1,0,1
45000_0,,,,2,1,1,2
C1(C(C(C)O)(C(C(O)O1)O)O)=O,,,5,1,1,0,1
45002_0,,,,2,1,1,2
C1(C(C(O)=O)(C(C(O)O1)O)O)=O,,,5,1,1,0,1
45004_0,,,,2,1,1,2
C(C1(C(C)=O)COC(C1O)O)(O)=O,,,5,1,1,0,1
45006_0,,,,2,1,1,2
C1(C(C(C)=O)(CO)C(C(O)O1)O)=O,,,5,1,1,0,1
45008_0,,,,2,1,1,2
C1(C(C(C)=O)(C)C(C(O)O1)O)=O,,,5,1,1,0,1
45010_0,,,,2,1,1,2
C(C1[C](C(O)=O)OC(C1O)O)(O)=O,,,5,1,1,0,1
45012_0,,,,2,1,1,2
C1(C([C](C(O)=O)O)C(C(O)O1)O)=O,,,5,1,1,0,1
45014_0,,,,2,1,1,2
C(C1C(C(OC1C(O)=O)O)O)(O)=O,,,5,1,1,0,1
45016_0,,,,2,1,1,2
C1(C(C(C(O)O1)O)C(C(O)=O)O)=O,,,5,1,1,0,1
45018_0,,,,2,1,1,2
C(C1(C(OC(C=O)C1O)O)O)=O,,,5,1,1,0,1
45020_0,,,,2,1,1,2
C(C1(C=O)C(C(C(O1)O)O)O)=O,,,5,1,1,0,1
45022_0,,,,2,1,1,2
C(C1(C(OC(C(O)=O)C1O)O)O)=O,,,5,1,1,0,1
45024_0,,,,2,1,1,2
C(C1(C(O)OCC1(CO)O)O)=O,,,5,1,1,0,1
45026_0,,,,2,1,1,2
C(C1(C(O)OCC1(C)O)O)=O,,,5,1,1,0,1
45028_0,,,,2,1,1,2
C(C1(C(O)OC(CO)C1O)O)=O,,,5,1,1,0,1
45030_0,,,,2,1,1,2
C(C1(C(O)OCC1O)O)=O,,,5,1,1,0,1
45032_0,,,,2,1,1,2
C(C1(C(O)OC(C)C1O)O)=O,,,5,1,1,0,1
45034_0,,,,2,1,1,2
C(C1(C(O)OC(C1O)=O)O)=O,,,5,1,1,0,1
45036_0,,,,2,1,1,2
C(C1(C(O)OCC1(C=O)O)O)=O,,,5,1,1,0,1
45038_0,,,,2,1,1,2
C(C1(COC(C1(C=O)O)O)O)(O)=O,,,5,1,1,0,1
45040_0,,,,2,1,1,2
C1(C(CO)(C(C=O)(C(O)O1)O)O)=O,,,5,1,1,0,1
45042_0,,,,2,1,1,2
C1(C(C)(C(C=O)(C(O)O1)O)O)=O,,,5,1,1,0,1
45044_0,,,,2,1,1,2
C(C1(C=O)C(C(C(O1)O)O)O)(O)=O,,,5,1,1,0,1
45046_0,,,,2,1,1,2
C(C1(C(OC(C=O)C1O)O)O)(O)=O,,,5,1,1,0,1
45047_0,,,,2,1,1,2
45049_0,,,,2,1,1,2
C(C1C(C(CO)(C(O1)O)O)O)=O,,,5,1,1,0,1
45051_0,,,,2,1,1,2
C(C1(C(O)OCC1(CO)O)O)(O)=O,,,5,1,1,0,1
45053_0,,,,2,1,1,2
C(C1(C(O)OCC1(C)O)O)(O)=O,,,5,1,1,0,1
45055_0,,,,2,1,1,2
C(C1(C(O)OC(CO)C1O)O)(O)=O,,,5,1,1,0,1
45057_0,,,,2,1,1,2
C(C1(C(O)OCC1O)O)(O)=O,,,5,1,1,0,1
45059_0,,,,2,1,1,2
C(C1(C(O)OC(C)C1O)O)(O)=O,,,5,1,1,0,1
45061_0,,,,2,1,1,2
C(C1(C(O)OC(C1O)=O)O)(O)=O,,,5,1,1,0,1
45063_0,,,,2,1,1,2
C1(C(C=O)(C(C(CO)(O)O1)O)O)=O,,,5,1,1,0,1
45065_0,,,,2,1,1,2
C(C1(C(O)OCC1(C=O)O)O)(O)=O,,,5,1,1,0,1
45067_0,,,,2,1,1,2
C1(C(C=O)(C(CO)(C(O)O1)O)O)=O,,,5,1,1,0,1
45069_0,,,,2,1,1,2
C1(C(C=O)(C(C)(C(O)O1)O)O)=O,,,5,1,1,0,1
45071_0,,,,2,1,1,2
C1(C(C=O)(C(C(C)(O)O1)O)O)=O,,,5,1,1,0,1
45073_0,,,,2,1,1,2
C1(C(C)(C(C(O)=O)(C(O)O1)O)O)=O,,,5,1,1,0,1
45075_0,,,,2,1,1,2
C1C(CO)(C(C(O)O1)(CO)O)O,,,5,1,1,0,1
45077_0,,,,2,1,1,2
C(C1(C)C(C)(O)OCC1(C)O)(O)=O,,,5,1,1,0,1
45079_0,,,,2,1,1,2
C1C(C)(C(C(O)O1)(CO)O)O,,,5,1,1,0,1
45081_0,,,,2,1,1,2
C1(C(C(CO)(C(CO)(O)O1)O)O)=O,,,5,1,1,0,1
45083_0,,,,2,1,1,2
C(C1(C(C)OC(C1(C)O)O)O)(O)=O,,,5,1,1,0,1
45084_0,,,,2,1,1,2
45085_0,,,,2,1,1,2
45087_0,,,,2,1,1,2
C(C1(C(C)OC(C)(C1O)O)O)(O)=O,,,5,1,1,0,1
45088_0,,,,2,1,1,2
45089_0,,,,2,1,1,2
45091_0,,,,2,1,1,2
C1(C(C(C(C)O)(C(C)(O)O1)O)O)=O,,,5,1,1,0,1
45093_0,,,,2,1,1,2
C(C1(C(C)(O)OC(C1O)=O)O)(O)=O,,,5,1,1,0,1
45095_0,,,,2,1,1,2
C1(C(C(CO)(C(C)(O)O1)O)O)=O,,,5,1,1,0,1
45097_0,,,,2,1,1,2
C1(C(C)(C(CO)(C(C)(O)O1)O)O)=O,,,5,1,1,0,1
45099_0,,,,2,1,1,2
C(C1(CO)C(C)(O)OCC1O)(O)=O,,,5,1,1,0,1
45101_0,,,,2,1,1,2
C(C1(C)C(C)(O)OCC1O)(O)=O,,,5,1,1,0,1
45103_0,,,,2,1,1,2
C(C1(C)C(C)(O)OC(C)C1O)(O)=O,,,5,1,1,0,1
45105_0,,,,2,1,1,2
C(C1(C)C(C)(O)OC(C1O)=O)(O)=O,,,5,1,1,0,1
45107_0,,,,2,1,1,2
C1(C(C(C)=O)(C)C(C)(C(O)O1)O)=O,,,5,1,1,0,1
45109_0,,,,2,1,1,2
C1(C(C(C)=O)(C)C(C(C)(O)O1)O)=O,,,5,1,1,0,1
45111_0,,,,2,1,1,2
C1(C(CO)(C(C(CO)O1)O)O)O,,,5,1,1,0,1
45113_0,,,,2,1,1,2
C1C(C(C(O)O1)(CO)O)O,,,5,1,1,0,1
45115_0,,,,2,1,1,2
CC1C(C(C(O)O1)(CO)O)O,,,5,1,1,0,1
45117_0,,,,2,1,1,2
C(C1(COC(C1(CO)O)O)O)=O,,,5,1,1,0,1
45119_0,,,,2,1,1,2
C(C1(COC(C1(C)O)O)O)=O,,,5,1,1,0,1
45121_0,,,,2,1,1,2
C(C)(C1(COC(C1C(C)O)O)O)=O,,,5,1,1,0,1
45123_0,,,,2,1,1,2
C(C1C(C)OC(C)(C1(CO)O)O)=O,,,5,1,1,0,1
45125_0,,,,2,1,1,2
C(C1C(O)OCC1(C(C)=O)O)(O)=O,,,5,1,1,0,1
45127_0,,,,2,1,1,2
C1(C(C=O)C(CO)(C(C)(O)O1)O)=O,,,5,1,1,0,1
45128_0,,,,2,1,1,2
45130_0,,,,2,1,1,2
C(C1(CC(C(CO)=O)(CO1)O)O)=O,,,5,1,1,0,1
45132_0,,,,2,1,1,2
C(CO)(C1(CC(OC1C=O)O)O)=O,,,5,1,1,0,1
45134_0,,,,2,1,1,2
C(CC1(C(CO)(O)OCC1O)O)=O,,,5,1,1,0,1
45136_0,,,,2,1,1,2
C(CO)(C1(C(CO)OC(C1)O)O)=O,,,5,1,1,0,1
45138_0,,,,2,1,1,2
C(CO)(C1(COC(C1)O)O)=O,,,5,1,1,0,1
45140_0,,,,2,1,1,2
C(C1(C(CO)OC(C1(C)O)O)O)=O,,,5,1,1,0,1
45141_0,,,,2,1,1,2
45143_0,,,,2,1,1,2
C1(C(C(C(O)O1)(C(CO)O)O)O)=O,,,5,1,1,0,1
45144_0,,,,2,1,1,2
45146_0,,,,2,1,1,2
C(C(C)(C1CC(C(O)O1)(C)O)O)=O,,,5,1,1,0,1
45148_0,,,,2,1,1,2
C(C(C1CC(C(O)O1)(C)O)O)(O)=O,,,5,1,1,0,1
45150_0,,,,2,1,1,2
C(C(C)(C1C(C)(CC(O)O1)O)O)=O,,,5,1,1,0,1
45152_0,,,,2,1,1,2
C(CC1(C)C(C(C)(C(O)O1)O)O)=O,,,5,1,1,0,1
45153_0,,,,2,1,1,2
45155_0,,,,2,1,1,2
C(C1(CC(C(C)=O)(CO1)O)O)=O,,,5,1,1,0,1
45157_0,,,,2,1,1,2
C(C)(C1(CC(O)OC1CCO)O)=O,,,5,1,1,0,1
45159_0,,,,2,1,1,2
C(CC1(C(C)(O)OCC1(C)O)O)=O,,,5,1,1,0,1
45161_0,,,,2,1,1,2
C(C)(C1(CC(O)OC1(CO)C)O)=O,,,5,1,1,0,1
45163_0,,,,2,1,1,2
C(C)(C1(CC(OC1C=CC)O)O)=O,,,5,1,1,0,1
45165_0,,,,2,1,1,2
C(C)(C1(C(CC=C)OC(C1)O)O)=O,,,5,1,1,0,1
45167_0,,,,2,1,1,2
C(CC1(C(C)(O)OCC1O)O)=O,,,5,1,1,0,1
45169_0,,,,2,1,1,2
C(C)(C1(C(CO)OC(C1)O)O)=O,,,5,1,1,0,1
45171_0,,,,2,1,1,2
C(CC1(C(C(C)OC1(C)O)O)O)=O,,,5,1,1,0,1
45173_0,,,,2,1,1,2
C(C)(C1(CC(O)OC1C(C)O)O)=O,,,5,1,1,0,1
45175_0,,,,2,1,1,2
C(CC1(C(C)(O)OC(C1O)=O)O)=O,,,5,1,1,0,1
45177_0,,,,2,1,1,2
C(C)(C1(CC(OC1C(O)=O)O)O)=O,,,5,1,1,0,1
45179_0,,,,2,1,1,2
C(C1(C)C(C(C)=O)(CC(O1)O)O)=O,,,5,1,1,0,1
45181_0,,,,2,1,1,2
C(C)(C1(COC(C1)O)O)=O,,,5,1,1,0,1
45183_0,,,,2,1,1,2
C(C(C)(C1CC(C(C)(O)O1)O)O)=O,,,5,1,1,0,1
45185_0,,,,2,1,1,2
C(C(C1CC(C(C)(O)O1)O)O)(O)=O,,,5,1,1,0,1
45187_0,,,,2,1,1,2
C(C(C)(C1(C)C(CC(O)O1)O)O)=O,,,5,1,1,0,1
45189_0,,,,2,1,1,2
C(CC1C(C)(C(C)(C(O)O1)O)O)=O,,,5,1,1,0,1
45191_0,,,,2,1,1,2
C(C1(CC(C(C)=O)(CO1)O)O)(O)=O,,,5,1,1,0,1
45192_0,,,,2,1,1,2
45194_0,,,,2,1,1,2
C1(C(C)(C(C(O)O1)(CCO)O)O)=O,,,5,1,1,0,1
45195_0,,,,2,1,1,2
45197_0,,,,2,1,1,2
C1(C(C(C(O)O1)(CCO)O)O)=O,,,5,1,1,0,1
45198_0,,,,2,1,1,2
45199_0,,,,2,1,1,2
45201_0,,,,2,1,1,2
C1(C(C(C(O)O1)(CC(C)O)O)O)=O,,,5,1,1,0,1
45202_0,,,,2,1,1,2
45203_0,,,,2,1,1,2
45205_0,,,,2,1,1,2
C(CC1(C(O)OC(C1O)=O)O)(O)=O,,,5,1,1,0,1
45206_0,,,,2,1,1,2
45208_0,,,,2,1,1,2
C1(C(C)(O)OC(CCO)C1(C)O)=O,,,5,1,1,0,1
45210_0,,,,2,1,1,2
C1(C(CCO)(C(C)(C(O)O1)O)O)=O,,,5,1,1,0,1
45212_0,,,,2,1,1,2
C(C(C)(C1(C(CC(O1)O)=O)C)O)=O,,,5,1,1,0,1
45214_0,,,,2,1,1,2
C1(C(C)(C(C(O)=O)O)OC(C1)O)=O,,,5,1,1,0,1
45216_0,,,,2,1,1,2
C(CC1(C(C)(C(C(O1)=O)O)O)O)=O,,,5,1,1,0,1
45218_0,,,,2,1,1,2
C(C1(C)C(CC(C(C)=O)(O1)O)O)=O,,,5,1,1,0,1
45220_0,,,,2,1,1,2
C(C(C1CC(C(C)(O)O1)=O)(C)O)=O,,,5,1,1,0,1
45222_0,,,,2,1,1,2
C(C1C(CC(C(C)=O)(O1)O)O)(O)=O,,,5,1,1,0,1
45224_0,,,,2,1,1,2
C(C(C1CC(C(C)(O)O1)=O)O)(O)=O,,,5,1,1,0,1
45226_0,,,,2,1,1,2
C1(C(C)(C(C=O)OC1(CO)O)O)=O,,,5,1,1,0,1
45228_0,,,,2,1,1,2
C(CO)(C1(C(C)(C(CO1)O)O)O)=O,,,5,1,1,0,1
45230_0,,,,2,1,1,2
C1(C(CO)(O)OC(CO)C1(C)O)=O,,,5,1,1,0,1
45232_0,,,,2,1,1,2
C1(C(CO)(O)OC(C)C1(C)O)=O,,,5,1,1,0,1
45234_0,,,,2,1,1,2
C1(C(CO)(O)OCC1(C)O)=O,,,5,1,1,0,1
45236_0,,,,2,1,1,2
C1(C(C)(C(C=O)OC1(C)O)O)=O,,,5,1,1,0,1
45238_0,,,,2,1,1,2
C(C)(C1(C(C)(C(CO1)(C)O)O)O)=O,,,5,1,1,0,1
45240_0,,,,2,1,1,2
C1(C(C)(O)OC(C)(CO)C1(C)O)=O,,,5,1,1,0,1
45242_0,,,,2,1,1,2
C1(C(C)(C(C=CC)OC1(C)O)O)=O,,,5,1,1,0,1
45244_0,,,,2,1,1,2
C1(C(C)(O)OC(CC=C)C1(C)O)=O,,,5,1,1,0,1
45246_0,,,,2,1,1,2
C(C)(C1(C(C)(C(CO1)O)O)O)=O,,,5,1,1,0,1
45248_0,,,,2,1,1,2
C1(C(C)(O)OC(CO)C1(C)O)=O,,,5,1,1,0,1
45250_0,,,,2,1,1,2
C(C)(C1(C(C)(C(C(C)O1)O)O)O)=O,,,5,1,1,0,1
45252_0,,,,2,1,1,2
C1(C(C)(O)OC(C(C)O)C1(C)O)=O,,,5,1,1,0,1
45254_0,,,,2,1,1,2
C1(C(C(C)(C(C(C)=O)(O)O1)O)O)=O,,,5,1,1,0,1
45256_0,,,,2,1,1,2
C1(C(C)(C(C(O)=O)OC1(C)O)O)=O,,,5,1,1,0,1
45258_0,,,,2,1,1,2
C1(C(C)(O)OC(C)C1(C)O)=O,,,5,1,1,0,1
45260_0,,,,2,1,1,2
C(C1(C)C(C(C(C)(O1)O)=O)(C)O)=O,,,5,1,1,0,1
45262_0,,,,2,1,1,2
C1(C(C)(C(C(C)=O)OC1(C)O)O)=O,,,5,1,1,0,1
45264_0,,,,2,1,1,2
C1(C(C)(O)OCC1(C)O)=O,,,5,1,1,0,1
45266_0,,,,2,1,1,2
C(C)(C1(C(C)OC(C1(C)O)O)O)=O,,,5,1,1,0,1
45268_0,,,,2,1,1,2
C1(C(C(C)(C(C(C)O)(O)O1)O)O)=O,,,5,1,1,0,1
45270_0,,,,2,1,1,2
C1(C(C(C)=O)(C(C)(C(O)O1)O)O)=O,,,5,1,1,0,1
45272_0,,,,2,1,1,2
C1(C(C(C)(C(C(O)=O)(O)O1)O)O)=O,,,5,1,1,0,1
45273_0,,,,2,1,1,2
45275_0,,,,2,1,1,2
C(C1(COC(C(C)=O)(C1)O)O)(O)=O,,,5,1,1,0,1
45276_0,,,,2,1,1,2
45277_0,,,,2,1,1,2
45279_0,,,,2,1,1,2
C(C1C(C(C)(C(O1)O)O)O)=O,,,5,1,1,0,1
45281_0,,,,2,1,1,2
C1C(CO)(C(C)(C(O)O1)O)O,,,5,1,1,0,1
45283_0,,,,2,1,1,2
C1C(C)(C(C)(C(O)O1)O)O,,,5,1,1,0,1
45285_0,,,,2,1,1,2
C(C1(C)C(C(C)(C(O1)O)O)O)(O)=O,,,5,1,1,0,1
45287_0,,,,2,1,1,2
C1(C(C=CC)(C(C)(C(O)O1)O)O)=O,,,5,1,1,0,1
45289_0,,,,2,1,1,2
C1(C(C(C)(C(O)O1)O)(CC=C)O)=O,,,5,1,1,0,1
45291_0,,,,2,1,1,2
CC1(C(O)OC(CO)C1O)O,,,5,1,1,0,1
45293_0,,,,2,1,1,2
CC1(C(O)OCC1O)O,,,5,1,1,0,1
45295_0,,,,2,1,1,2
C1(C(O)OCC1(C[CH]C(O)=O)O)=O,,,5,1,2,0,2
45297_0,,,,2,1,1,2
C(CCC1(C(C(O)OC1)=O)O)(O)=O,,,5,1,2,0,2
45299_0,,,,2,1,1,2
CC1(C(O)OC(C)C1O)O,,,5,1,1,0,1
45301_0,,,,2,1,1,2
C(C(C1(CCC(C)O1)O)=O)=O,,,5,1,1,0,1
45303_0,,,,2,1,1,2
C(C(C1(CCC(C)O1)O)=O)(O)=O,,,5,1,1,0,1
45305_0,,,,2,1,1,2
C1(C(CC(CC(C)O)(O)O1)=O)=O,,,5,1,1,0,1
45306_0,,,,2,1,1,2
45307_0,,,,2,1,1,2
45309_0,,,,2,1,1,2
C(C1C(O)OC(C)C1C=O)(O)=O,,,5,1,1,0,1
45311_0,,,,2,1,1,2
C1(CCC(C(C=O)=O)(O)O1)=O,,,5,1,1,0,1
45313_0,,,,2,1,1,2
C1(CCC(C(C(O)=O)=O)(O)O1)=O,,,5,1,1,0,1
45315_0,,,,2,1,1,2
C(CC1(CC(C(O1)=O)=O)O)(O)=O,,,5,1,1,0,1
45316_0,,,,2,1,1,2
45317_0,,,,2,1,1,2
45319_0,,,,2,1,1,2
C1(COC(C(C=O)=O)(C1)O)=O,,,5,1,1,0,1
45321_0,,,,2,1,1,2
C1(COC(C(C(O)=O)=O)(C1)O)=O,,,5,1,1,0,1
45322_0,,,,2,1,1,2
45323_0,,,,2,1,1,2
45324_0,,,,2,1,1,2
45325_0,,,,2,1,1,2
45326_0,,,,2,1,1,2
45327_0,,,,2,1,1,2
45329_0,,,,2,1,1,2
C1(C(CC(O)O1)=O)=O,,,5,1,1,0,1
45330_0,,,,2,1,1,2
45331_0,,,,2,1,1,2
45332_0,,,,2,1,1,2
45333_0,,,,2,1,1,2
45334_0,,,,2,1,1,2
45335_0,,,,2,1,1,2
45336_0,,,,2,1,1,2
45337_0,,,,2,1,1,2
45338_0,,,,2,1,1,2
45339_0,,,,2,1,1,2
45341_0,,,,2,1,1,2
C(C1(CCC(C)O1)O)(O)=O,,,5,1,1,0,1
45343_0,,,,2,1,1,2
C1(CCC(C(O)=O)(O)O1)=O,,,5,1,1,0,1
45344_0,,,,2,1,1,2
45345_0,,,,2,1,1,2
45346_0,,,,2,1,1,2
45347_0,,,,2,1,1,2
45348_0,,,,2,1,1,2
45349_0,,,,2,1,1,2
45350_0,,,,2,1,1,2
45352_0,,,,2,1,1,2
C1(C(CC(C)(O)O1)O)=O,,,5,1,1,0,1
45353_0,,,,2,1,1,2
45355_0,,,,2,1,1,2
C(CC1(C[CH]C(O1)=O)O)(O)=O,,,5,1,1,0,1
45357_0,,,,2,1,1,2
C1(CCC(CC(O)=O)(O)O1)=O,,,5,1,1,0,1
45358_0,,,,2,1,1,2
45359_0,,,,2,1,1,2
45360_0,,,,2,1,1,2
45361_0,,,,2,1,1,2
45362_0,,,,2,1,1,2
45363_0,,,,2,1,1,2
45364_0,,,,2,1,1,2
45365_0,,,,2,1,1,2
45366_0,,,,2,1,1,2
45367_0,,,,2,1,1,2
45368_0,,,,2,1,1,2
45369_0,,,,2,1,1,2
45370_0,,,,2,1,1,2
45371_0,,,,2,1,1,2
45372_0,,,,2,1,1,2
45373_0,,,,2,1,1,2
45374_0,,,,2,1,1,2
45375_0,,,,2,1,1,2
45376_0,,,,2,1,1,2
45377_0,,,,2,1,1,2
45378_0,,,,2,1,1,2
45379_0,,,,2,1,1,2
45381_0,,,,2,1,1,2
C1C(C(C)O)(C(C(CO)(O)O1)O)O,,,5,1,1,0,1
45382_0,,,,2,1,1,2
45384_0,,,,2,1,1,2
C1C(C(C)O)(C(C(O)O1)(CO)O)O,,,5,1,1,0,1
45385_0,,,,2,1,1,2
45387_0,,,,2,1,1,2
C1C(C(C)O)(C(C)(C(O)O1)O)O,,,5,1,1,0,1
45388_0,,,,2,1,1,2
45390_0,,,,2,1,1,2
C1C(C(C)O)(C(C(C)(O)O1)O)O,,,5,1,1,0,1
45391_0,,,,2,1,1,2
45392_0,,,,2,1,1,2
45393_0,,,,2,1,1,2
45394_0,,,,2,1,1,2
45395_0,,,,2,1,1,2
45397_0,,,,2,1,1,2
C1(C2C(C(C(C)(O2)O)(O)O1)O)=O,,,5,1,2,0,2
45399_0,,,,2,1,1,2
C1(C2(CC(C(CO)O2)(O)O1)O)=O,,,5,1,2,0,2
45401_0,,,,2,1,1,2
C1CCC(O)O1,,,5,1,1,0,1
45403_0,,,,2,1,1,2
C(C1(CCCO1)O)(O)=O,,,5,1,1,0,1
45405_0,,,,2,1,1,2
C(C1COC(C1)O)(O)=O,,,5,1,1,0,1
45406_0,,,,2,1,1,2
45407_0,,,,2,1,1,2
45409_0,,,,2,1,1,2
C1(C2COC(C(O1)=O)(C2)O)=O,,,5,1,2,0,2
45411_0,,,,2,1,1,2
CC1C2C(O)OC(CO)(C2O)O1,,,5,1,1,0,1
45413_0,,,,2,1,1,2
C1C2(C(O)OC(C2C(C)O)O1)O,,,5,1,1,0,1
45415_0,,,,2,1,1,2
C1C2(C(O)OC(C)C2C(O)O1)O,,,5,1,2,0,2
45416_0,,,,2,1,1,2
45418_0,,,,2,1,1,2
C12C(CO)(C(C(O)O1)C(C)O2)O,,,5,1,1,0,1
45420_0,,,,2,1,1,2
C12C(C)(C(C(O)O1)C(C)O2)O,,,5,1,1,0,1
45422_0,,,,2,1,1,2
CC12C(C(C(O)O1)C(C)O2)O,,,5,1,1,0,1
45424_0,,,,2,1,1,2
C1(C2C(O)OC(CO)(C2O)O1)=O,,,5,1,1,0,1
45426_0,,,,2,1,1,2
C(C1C2OCC1(C(O)O2)O)(O)=O,,,5,1,1,0,1
45428_0,,,,2,1,1,2
C1(C2C(O)OCC2(C(O)O1)O)=O,,,5,1,2,0,2
45429_0,,,,2,1,1,2
45431_0,,,,2,1,1,2
C1(C2C(O)OC(C2(CO)O)O1)=O,,,5,1,1,0,1
45433_0,,,,2,1,1,2
C1(C2C(O)OC(C2(C)O)O1)=O,,,5,1,1,0,1
45435_0,,,,2,1,1,2
C1(C2C(O)OC(C)(C2O)O1)=O,,,5,1,1,0,1
45437_0,,,,2,1,1,2
C1(C2(C)OC(C(O)=O)(C1CO2)O)=O,,,5,1,1,0,1
45438_0,,,,2,1,1,2
45440_0,,,,2,1,1,2
C(C12COC(C1O)(C(O2)O)O)=O,,,5,1,2,0,2
45441_0,,,,2,1,1,2
45443_0,,,,2,1,1,2
C(C12C(C(C(O1)O)(CO2)O)O)=O,,,5,1,1,0,1
45445_0,,,,2,1,1,2
C(C12COC(C1)(C(O2)O)O)=O,,,5,1,2,0,2
45446_0,,,,2,1,1,2
45448_0,,,,2,1,1,2
C(C12CC(C(O1)O)(CO2)O)=O,,,5,1,1,0,1
45450_0,,,,2,1,1,2
C(C12C(C(C(O1)O)(CO2)O)O)(O)=O,,,5,1,1,0,1
45452_0,,,,2,1,1,2
C1C2(C(O)OC(C2)O1)O,,,5,1,1,0,1
45454_0,,,,2,1,1,2
C(C12CC(C(O1)O)(CO2)O)(O)=O,,,5,1,1,0,1
45456_0,,,,2,1,1,2
C(C12COC(C1O)(C(O2)O)O)(O)=O,,,5,1,2,0,2
45458_0,,,,2,1,1,2
C1(C2(CO)C(C(C(O2)O)(O)O1)O)=O,,,5,1,2,0,2
45459_0,,,,2,1,1,2
45460_0,,,,2,1,1,2
45462_0,,,,2,1,1,2
C1(C2(C)C(C(C(O2)O)(O)O1)O)=O,,,5,1,2,0,2
45463_0,,,,2,1,1,2
45465_0,,,,2,1,1,2
C(C12COC(C1)(C(O2)O)O)(O)=O,,,5,1,2,0,2
45467_0,,,,2,1,1,2
C1(C2(CO)CC(C(O2)O)(O)O1)=O,,,5,1,2,0,2
45468_0,,,,2,1,1,2
45469_0,,,,2,1,1,2
45471_0,,,,2,1,1,2
C1(C2(C)CC(C(O2)O)(O)O1)=O,,,5,1,2,0,2
45472_0,,,,2,1,1,2
45473_0,,,,2,1,1,2
45475_0,,,,2,1,1,2
[C]12C(OC(C(C)(O)O1)(C2)O)=O,,,5,1,2,0,2
45476_0,,,,2,1,1,2
45478_0,,,,2,1,1,2
C1(C2CC(C(C)(O2)O)(O)O1)=O,,,5,1,2,0,2
45479_0,,,,2,1,1,2
45480_0,,,,2,1,1,2
45482_0,,,,2,1,1,2
CC1CC2C(C(C(O)O2)(O)O1)O,,,5,1,2,0,2
45484_0,,,,2,1,1,2
CC1CC2CC(C(O)O2)(O)O1,,,5,1,2,0,2
45486_0,,,,2,1,1,2
C1C2(C(C(C(O)O1)C(C)O2)O)O,,,5,1,2,0,2
45488_0,,,,2,1,1,2
C1(CC2C(C(C(O)O2)(O)O1)O)=O,,,5,1,2,0,2
45490_0,,,,2,1,1,2
C1(CC2CC(C(O)O2)(O)O1)=O,,,5,1,2,0,2
45492_0,,,,2,1,1,2
C1(C2C(O)OCC(C2O)(O)O1)=O,,,5,1,2,0,2
45494_0,,,,2,1,1,2
C1(C(CC2(C(CCO2)(O)O1)O)=O)=O,,,5,1,2,0,2
45496_0,,,,2,1,1,2
C1(COC2(C(C1OC2O)O)O)=O,,,5,1,2,0,2
45498_0,,,,2,1,1,2
C1(COC2(CC1OC2O)O)=O,,,5,1,2,0,2
45500_0,,,,2,1,1,2
C1(C2(C(C(CO2)(C(O)O1)O)O)O)=O,,,5,1,2,0,2
45502_0,,,,2,1,1,2
C1(C2(CC(CO2)(C(O)O1)O)O)=O,,,5,1,2,0,2
45504_0,,,,2,1,1,2
C1(C2(COC(C(C2O)(O)O1)O)O)=O,,,5,1,2,0,2
45506_0,,,,2,1,1,2
C1(C2(COC(C(O)O1)(C2O)O)O)=O,,,5,1,2,0,2
45508_0,,,,2,1,1,2
C1(C2(COC(C(C2)(O)O1)O)O)=O,,,5,1,2,0,2
45510_0,,,,2,1,1,2
C1(C2(COC(C(O)O1)(C2)O)O)=O,,,5,1,2,0,2
45512_0,,,,2,1,1,2
C1(C2(CC(C(CO2)O)(O)O1)O)=O,,,5,1,2,0,2
45514_0,,,,2,1,1,2
C1(C2(CC(C(O2)=O)(O)OCC1)O)=O,,,5,1,2,0,2
45516_0,,,,2,1,1,2
C1(CC2(C(O)=O)OC1(CCO2)O)=O,,,5,1,1,0,1
45518_0,,,,2,1,1,2
C1(C2(COC(C2C(C)O1)O)O)=O,,,5,1,2,0,2
45520_0,,,,2,1,1,2
C1(CC2C(C(C(O)O2)=O)O1)=O,,,5,1,2,0,2
45522_0,,,,2,1,1,2
C1(C2C(O)OCC2(C(O1)=O)O)=O,,,5,1,2,0,2
45524_0,,,,2,1,1,2
C1(C2C(O)OC(C2(CO1)O)=O)=O,,,5,1,2,0,2
45526_0,,,,2,1,1,2
C(C12COC(C(O1)=O)(C2O)O)=O,,,5,1,2,0,2
45528_0,,,,2,1,1,2
C(C12COC(C(O1)=O)(C2)O)=O,,,5,1,2,0,2
45530_0,,,,2,1,1,2
C1(C2(C(C(C(O2)=O)=C)CO1)O)=O,,,5,1,2,0,2
45532_0,,,,2,1,1,2
C1(C(C)(C2COC(C2(O)O1)=O)O)=O,,,5,1,2,0,2
45534_0,,,,2,1,1,2
C(C12COC(C(O1)=O)(C2)O)(O)=O,,,5,1,2,0,2
45536_0,,,,2,1,1,2
C1(C2(CO)CC(C(O2)=O)(O)O1)=O,,,5,1,2,0,2
45538_0,,,,2,1,1,2
C1(C2(C)C(C(C(O2)=O)(O)O1)O)=O,,,5,1,2,0,2
45540_0,,,,2,1,1,2
C1(C2(COC(C2(CO1)O)O)O)=O,,,5,1,2,0,2
45542_0,,,,2,1,1,2
C1(C2(COC(C(C2)(O)O1)=O)O)=O,,,5,1,2,0,2
45544_0,,,,2,1,1,2
C1(C2(COC(C(O1)=O)(C2)O)O)=O,,,5,1,2,0,2
45546_0,,,,2,1,1,2
C1(C2(COC(CO1)(C2O)O)O)=O,,,5,1,2,0,2
45548_0,,,,2,1,1,2
C1(C2COC(C(C2)(O)O1)=O)=O,,,5,1,2,0,2
45550_0,,,,2,1,1,2
C1(CC2(C(OCC1O2)=O)O)=O,,,5,1,2,0,2
45552_0,,,,2,1,1,2
C(C(C1C(C)CC(O)O1)C(C)O)=O,,,5,1,1,0,1
45554_0,,,,2,1,1,2
C(C(CO)C1(C)C(C)CC(O)O1)=O,,,5,1,1,0,1
45556_0,,,,2,1,1,2
C(C(C=O)C1C(C)CC(O)O1)(O)=O,,,5,1,1,0,1
45558_0,,,,2,1,1,2
C(C(C(C1C(C)CC(O)O1)O)=O)=O,,,5,1,1,0,1
45560_0,,,,2,1,1,2
C(CC(C)C1C(C(C(O)O1)=O)O)=O,,,5,1,2,0,2
45562_0,,,,2,1,1,2
C1(C(O)OC(C1O)C[CH]C(O)=O)=O,,,5,1,2,0,2
45564_0,,,,2,1,1,2
C(CCC1C(C(C(O)O1)=O)O)(O)=O,,,5,1,2,0,2
45566_0,,,,2,1,1,2
C(C(C1(CO)C(C)CC(O1)O)=O)=O,,,5,1,1,0,1
45568_0,,,,2,1,1,2
C(CC(C)C1(C(C(O)OC1)=O)O)=O,,,5,1,2,0,2
45570_0,,,,2,1,1,2
C(C)(C1(C(C)CC(O1)O)CC=O)=O,,,5,1,1,0,1
45572_0,,,,2,1,1,2
C(C(CC1C(C)CC(O)O1)=O)=O,,,5,1,1,0,1
45574_0,,,,2,1,1,2
C(CC(C)C1CC(C(O)O1)=O)=O,,,5,1,2,0,2
45576_0,,,,2,1,1,2
C1(C(O)OC(C[CH]C(O)=O)C1)=O,,,5,1,2,0,2
45578_0,,,,2,1,1,2
C(CCC1CC(C(O)O1)=O)(O)=O,,,5,1,2,0,2
45580_0,,,,2,1,1,2
C(CC(C)C1C(C(O)OC1)=O)=O,,,5,1,2,0,2
45582_0,,,,2,1,1,2
C(CC(C)CC1CC(C(O)O1)=O)=O,,,5,1,2,0,2
45584_0,,,,2,1,1,2
C(C(CC1(C)C(C)CC(O)O1)=O)=O,,,5,1,1,0,1
45586_0,,,,2,1,1,2
C(CC(C)C1(C)CC(C(O)O1)=O)=O,,,5,1,2,0,2
45588_0,,,,2,1,1,2
C1(C(O)OC(C)(C[CH]C(O)=O)C1)=O,,,5,1,2,0,2
45590_0,,,,2,1,1,2
C(CCC1(C)CC(C(O)O1)=O)(O)=O,,,5,1,2,0,2
45592_0,,,,2,1,1,2
C(CC(C)C1C(C(O)OC1C)=O)=O,,,5,1,2,0,2
45594_0,,,,2,1,1,2
C(CC(C)C1C(OC(C1=O)O)=O)=O,,,5,1,2,0,2
45596_0,,,,2,1,1,2
C1(C(CC(C=O)CO)CC(O)O1)=O,,,5,1,2,0,2
45598_0,,,,2,1,1,2
C1(C(C)(CC(O)O1)C(C=O)CO)=O,,,5,1,1,0,1
45600_0,,,,2,1,1,2
C1(C(C)(C(CO)C(O)O1)CC=O)=O,,,5,1,1,0,1
45602_0,,,,2,1,1,2
C1(C(C)C(C(O)O1)C(C=O)CO)=O,,,5,1,2,0,2
45604_0,,,,2,1,1,2
C(C(C)C1C(O)OCC1C=O)(O)=O,,,5,1,1,0,1
45606_0,,,,2,1,1,2
C(CC1C(C)CC(O)O1)=O,,,5,1,1,0,1
45608_0,,,,2,1,1,2
C(CC1C(C)CC(C(O)=O)(O)O1)=O,,,5,1,1,0,1
45610_0,,,,2,1,1,2
C1(C(CC(CC=O)O)CC(O)O1)=O,,,5,1,2,0,2
45612_0,,,,2,1,1,2
C1(C(C)(C(CC=O)O)CC(O)O1)=O,,,5,1,1,0,1
45614_0,,,,2,1,1,2
C(C1(C)C(CC=O)OC(C1)O)(O)=O,,,5,1,1,0,1
45616_0,,,,2,1,1,2
C1(C(C)C(C(O)O1)C(CC=O)O)=O,,,5,1,2,0,2
45618_0,,,,2,1,1,2
C(C(CC1C(C)CC(O)O1)=O)(O)=O,,,5,1,1,0,1
45620_0,,,,2,1,1,2
C(C(C)=O)(C1(C)C(C)CC(O1)O)=O,,,5,1,1,0,1
45622_0,,,,2,1,1,2
C(C1(C=O)C(C)CC(O1)O)=O,,,5,1,1,0,1
45624_0,,,,2,1,1,2
C(C1(C=O)C(C)CC(O1)O)(O)=O,,,5,1,1,0,1
45626_0,,,,2,1,1,2
CC(CC1C(C)CC(O)O1)O,,,5,1,1,0,1
45628_0,,,,2,1,1,2
CC1CC(O)OC1(C)CCO,,,5,1,1,0,1
45630_0,,,,2,1,1,2
C(CC1C(C)CC(O)O1)(O)=O,,,5,1,1,0,1
45632_0,,,,2,1,1,2
C(CO)(C1C(C)CC(O1)O)=O,,,5,1,1,0,1
45634_0,,,,2,1,1,2
C1(C(CCC(CO)=O)CC(O)O1)=O,,,5,1,2,0,2
45636_0,,,,2,1,1,2
C1(C(C)(CC(O)O1)CC(CO)=O)=O,,,5,1,1,0,1
45638_0,,,,2,1,1,2
C1(C(C)(CC(CO)(O)O1)CC=O)=O,,,5,1,1,0,1
45640_0,,,,2,1,1,2
C1(C(C)C(C(O)O1)CC(CO)=O)=O,,,5,1,2,0,2
45642_0,,,,2,1,1,2
C(C)(C1C(C)CC(O1)O)=O,,,5,1,1,0,1
45644_0,,,,2,1,1,2
C(C1(CC(C)C(C(C)=O)O1)O)(O)=O,,,5,1,1,0,1
45646_0,,,,2,1,1,2
C1(C(CC(C(C)=O)O)CC(O)O1)=O,,,5,1,2,0,2
45648_0,,,,2,1,1,2
C1(C(C)(CC(O)O1)C(C(C)=O)O)=O,,,5,1,1,0,1
45650_0,,,,2,1,1,2
C1(C(C)(C(C(C)(O)O1)O)CC=O)=O,,,5,1,1,0,1
45652_0,,,,2,1,1,2
C(C1(C)CC(OC1C(C)=O)O)(O)=O,,,5,1,1,0,1
45654_0,,,,2,1,1,2
C1(C(C)C(C(O)O1)C(C(C)=O)O)=O,,,5,1,2,0,2
45656_0,,,,2,1,1,2
C1C(C)CC(O)O1,,,5,1,1,0,1
45658_0,,,,2,1,1,2
C(C1(CC(CO1)C)O)(O)=O,,,5,1,1,0,1
45660_0,,,,2,1,1,2
C1(C(CC(O)O1)CCO)=O,,,5,1,2,0,2
45662_0,,,,2,1,1,2
C1(C(C)(CO)CC(O)O1)=O,,,5,1,1,0,1
45664_0,,,,2,1,1,2
C(C1(COC(C1)O)C)(O)=O,,,5,1,1,0,1
45666_0,,,,2,1,1,2
C1(C(C)C(CO)C(O)O1)=O,,,5,1,2,0,2
45668_0,,,,2,1,1,2
C1(C2(COC(C(O1)=O)(C2)O)C)=O,,,5,1,1,0,1
45669_0,,,,2,1,1,2
45671_0,,,,2,1,1,2
C1(C(CO)(C)CC(C(O)=O)(O)O1)=O,,,5,1,1,0,1
45673_0,,,,2,1,1,2
C(C1(COC(C(O)=O)(C1)O)C)(O)=O,,,5,1,1,0,1
45674_0,,,,2,1,1,2
45676_0,,,,2,1,1,2
C1(C(CC(O)O1)CCCO)=O,,,5,1,2,0,2
45678_0,,,,2,1,1,2
C1(C(C)(CC(O)O1)CCO)=O,,,5,1,1,0,1
45680_0,,,,2,1,1,2
C1(C(C)C(C(O)O1)CCO)=O,,,5,1,2,0,2
45682_0,,,,2,1,1,2
C(C(C)C1C(O)OCC1)(O)=O,,,5,1,1,0,1
45684_0,,,,2,1,1,2
C1(C(C)C2CCOC2(C(O1)=O)O)=O,,,5,1,1,0,1
45686_0,,,,2,1,1,2
CC1CC(O)OC1C,,,5,1,1,0,1
45688_0,,,,2,1,1,2
C(C1(CC(C)C(C)O1)O)(O)=O,,,5,1,1,0,1
45690_0,,,,2,1,1,2
C1(C(CC(O)O1)CC(C)O)=O,,,5,1,2,0,2
45692_0,,,,2,1,1,2
C1(C(C)(CC(O)O1)C(C)O)=O,,,5,1,1,0,1
45694_0,,,,2,1,1,2
C(C1(C)C(C)OC(C1)O)(O)=O,,,5,1,1,0,1
45696_0,,,,2,1,1,2
C1(C(C)C(C(O)O1)C(C)O)=O,,,5,1,2,0,2
45698_0,,,,2,1,1,2
C1(C2(C)CC(C(O1)=O)(O)OC2C)=O,,,5,1,1,0,1
45700_0,,,,2,1,1,2
C(CC1(C)C(C)CC(O)O1)(O)=O,,,5,1,1,0,1
45702_0,,,,2,1,1,2
C1(C(CCC(O)=O)CC(O)O1)=O,,,5,1,2,0,2
45704_0,,,,2,1,1,2
C1(C(C)(CC(O)O1)CC(O)=O)=O,,,5,1,1,0,1
45706_0,,,,2,1,1,2
C1(C(C)C(C(O)O1)CC(O)=O)=O,,,5,1,2,0,2
45708_0,,,,2,1,1,2
C(C(C)C1C(O)OC(C1)=O)(O)=O,,,5,1,1,0,1
45710_0,,,,2,1,1,2
C(C(C)(C1C(C)CC(O)O1)O)(O)=O,,,5,1,1,0,1
45712_0,,,,2,1,1,2
C(C(C1(C)C(C)CC(O)O1)O)(O)=O,,,5,1,1,0,1
45714_0,,,,2,1,1,2
C(C1(C(C)O)C(C)CC(O1)O)(O)=O,,,5,1,1,0,1
45716_0,,,,2,1,1,2
C(C1(C(O)=O)C(C)CC(O1)O)(O)=O,,,5,1,1,0,1
45718_0,,,,2,1,1,2
C1(C(CCC=CC=O)CC(O)O1)=O,,,5,1,2,0,2
45720_0,,,,2,1,1,2
C1(C(C)(CC(O)O1)CC=CC=O)=O,,,5,1,1,0,1
45722_0,,,,2,1,1,2
C1(C(C)C(C(O)O1)CC=CC=O)=O,,,5,1,2,0,2
45724_0,,,,2,1,1,2
C(CC(C)C1C(C(OC1O)=O)=C)=O,,,5,1,2,0,2
45726_0,,,,2,1,1,2
C=C(C(O)=O)C1(C)C(C)CC(O1)O,,,5,1,1,0,1
45728_0,,,,2,1,1,2
CC1CC(O)OC1(CO)C(C)O,,,5,1,1,0,1
45730_0,,,,2,1,1,2
CC(C(C1C(C)CC(O)O1)O)O,,,5,1,1,0,1
45732_0,,,,2,1,1,2
CC1CC(O)OC1(C)C(CO)O,,,5,1,1,0,1
45734_0,,,,2,1,1,2
C(C(C1C(C)CC(O)O1)O)=O,,,5,1,1,0,1
45736_0,,,,2,1,1,2
C(C1(CO)C(C)CC(O1)O)=O,,,5,1,1,0,1
45738_0,,,,2,1,1,2
[CH](C(O)=O)C1C(C)CC(O1)O,,,5,1,1,0,1
45740_0,,,,2,1,1,2
C(C1C(C)CC(O1)O)=O,,,5,1,1,0,1
45742_0,,,,2,1,1,2
[C](C(O)=O)(C1C(C)CC(O1)O)O,,,5,1,1,0,1
45744_0,,,,2,1,1,2
C(C1(C)C(C)CC(O1)O)=O,,,5,1,1,0,1
45746_0,,,,2,1,1,2
C(C(C1C(C)CC(O)O1)O)(O)=O,,,5,1,1,0,1
45748_0,,,,2,1,1,2
C(C1(CO)C(C)CC(O1)O)(O)=O,,,5,1,1,0,1
45750_0,,,,2,1,1,2
C(C1(C)C(C)CC(O1)O)(O)=O,,,5,1,1,0,1
45752_0,,,,2,1,1,2
C(CC1(C)C(C)CC(O)O1)=O,,,5,1,1,0,1
45754_0,,,,2,1,1,2
C(C(C1C(C)CC(O1)O)=O)=O,,,5,1,1,0,1
45756_0,,,,2,1,1,2
C(C1C(C)CC(O1)O)(O)=O,,,5,1,1,0,1
45758_0,,,,2,1,1,2
CC1CC(O)OC1CO,,,5,1,1,0,1
45760_0,,,,2,1,1,2
C(C(C1C(C)CC(O1)O)=O)(O)=O,,,5,1,1,0,1
45762_0,,,,2,1,1,2
C(C(C=C)CC1C(OC(C1)O)=O)=O,,,5,1,2,0,2
45764_0,,,,2,1,1,2
C(C(C=C)C1(C(OC(C1)O)=O)C)=O,,,5,1,1,0,1
45766_0,,,,2,1,1,2
C1(C(C)(CC=O)C(C=C)C(O)O1)=O,,,5,1,1,0,1
45768_0,,,,2,1,1,2
C(C(C=C)C1C(O)OC(C1C)=O)=O,,,5,1,2,0,2
45770_0,,,,2,1,1,2
C(C1C(C)CC(C(O)=O)(O1)O)=O,,,5,1,1,0,1
45772_0,,,,2,1,1,2
C(C1(C)C(C)CC(C(O)=O)(O1)O)=O,,,5,1,1,0,1
45774_0,,,,2,1,1,2
C(C1C(C)CC(C(O)=O)(O1)O)(O)=O,,,5,1,1,0,1
45776_0,,,,2,1,1,2
C(C1(CC(C)C(CO)O1)O)(O)=O,,,5,1,1,0,1
45778_0,,,,2,1,1,2
C=C1C(OC(C1C[CH]C(O)=O)O)=O,,,5,1,2,0,2
45780_0,,,,2,1,1,2
C(CCC1C(C(OC1O)=O)=C)(O)=O,,,5,1,2,0,2
45782_0,,,,2,1,1,2
C1(C(CC(C=O)O)CC(O)O1)=O,,,5,1,2,0,2
45784_0,,,,2,1,1,2
C1(C(CC(O)O1)CCC(C=O)O)=O,,,5,1,2,0,2
45786_0,,,,2,1,1,2
C1(C(CC(C=O)(C)O)CC(O)O1)=O,,,5,1,2,0,2
45788_0,,,,2,1,1,2
C1(C(CCC=O)CC(O)O1)=O,,,5,1,2,0,2
45790_0,,,,2,1,1,2
C1(C(CCC(C=O)=O)CC(O)O1)=O,,,5,1,2,0,2
45792_0,,,,2,1,1,2
C1(C(CC(C(O)=O)O)CC(O)O1)=O,,,5,1,2,0,2
45794_0,,,,2,1,1,2
C1(C(CC(O)O1)CC(CO)O)=O,,,5,1,2,0,2
45796_0,,,,2,1,1,2
C(C1(C)CC(OC1C=O)O)(O)=O,,,5,1,1,0,1
45798_0,,,,2,1,1,2
C1(C(C)(C(C(O)O1)O)CC=O)=O,,,5,1,1,0,1
45800_0,,,,2,1,1,2
C1(C(C)(CC(O)O1)C(C=O)O)=O,,,5,1,1,0,1
45802_0,,,,2,1,1,2
C1(C(C)(CC(C=O)O)CC(O)O1)=O,,,5,1,1,0,1
45804_0,,,,2,1,1,2
C(C1(C)CC(OC1(C=O)C)O)(O)=O,,,5,1,1,0,1
45806_0,,,,2,1,1,2
C1(C(C)(C(C)(C(O)O1)O)CC=O)=O,,,5,1,1,0,1
45808_0,,,,2,1,1,2
C1(C(C)(CC(O)O1)C(C=O)(C)O)=O,,,5,1,1,0,1
45810_0,,,,2,1,1,2
C1(C(C)(CC(O)O1)CC=O)=O,,,5,1,1,0,1
45812_0,,,,2,1,1,2
C1(C(C)(CC(C=O)(O)O1)CC=O)=O,,,5,1,1,0,1
45814_0,,,,2,1,1,2
C1(C(C)(CC(O)O1)CC(C=O)=O)=O,,,5,1,1,0,1
45816_0,,,,2,1,1,2
C(C1(C)CC(OC1C(O)=O)O)(O)=O,,,5,1,1,0,1
45818_0,,,,2,1,1,2
C1(C(C)(CC(O)O1)C(C(O)=O)O)=O,,,5,1,1,0,1
45820_0,,,,2,1,1,2
C(C1(C)C(CO)OC(C1)O)(O)=O,,,5,1,1,0,1
45822_0,,,,2,1,1,2
C1(C(C)(CC(O)O1)C(CO)O)=O,,,5,1,1,0,1
45824_0,,,,2,1,1,2
C1(C(C)C(C(O)O1)C(C=O)O)=O,,,5,1,2,0,2
45826_0,,,,2,1,1,2
C(C(C)C1CC(C=O)OC1O)(O)=O,,,5,1,1,0,1
45828_0,,,,2,1,1,2
C1(C(C)C(C(O)O1)CC(C=O)O)=O,,,5,1,2,0,2
45830_0,,,,2,1,1,2
C1(C(C)C(C(O)O1)C(C=O)(C)O)=O,,,5,1,2,0,2
45832_0,,,,2,1,1,2
C1(C(C)C(C(O)O1)CC=O)=O,,,5,1,2,0,2
45834_0,,,,2,1,1,2
C1(C(C)C(C(O)O1)CC(C=O)=O)=O,,,5,1,2,0,2
45836_0,,,,2,1,1,2
C(C(C)C1C(O)OC(C1O)=O)(O)=O,,,5,1,1,0,1
45838_0,,,,2,1,1,2
C1(C(C)C(C(O)O1)C(C(O)=O)O)=O,,,5,1,2,0,2
45840_0,,,,2,1,1,2
C(C(C)C1C(O)OCC1O)(O)=O,,,5,1,1,0,1
45842_0,,,,2,1,1,2
C1(C(C)C(C(O)O1)C(CO)O)=O,,,5,1,2,0,2
45844_0,,,,2,1,1,2
[C]1(C(O)=O)C(C(C(CO)(O)O1)O)O,,,5,1,1,0,1
45846_0,,,,2,1,1,2
[C]1(C(O)=O)CC(C(CO)(O)O1)O,,,5,1,1,0,1
45848_0,,,,2,1,1,2
[C]1(C(O)=O)C(C(C(O)O1)(CO)O)O,,,5,1,1,0,1
45850_0,,,,2,1,1,2
[C]1(C(O)=O)CC(C(O)O1)(CO)O,,,5,1,1,0,1
45852_0,,,,2,1,1,2
[C]1(C(O)=O)C(C(C(O)O1)(C)O)O,,,5,1,1,0,1
45854_0,,,,2,1,1,2
[C]1(C(O)=O)CC(C)(C(O)O1)O,,,5,1,1,0,1
45856_0,,,,2,1,1,2
[C]1(C(O)=O)CC(C(C)(O)O1)O,,,5,1,1,0,1
45858_0,,,,2,1,1,2
CC(CC1CC(C(O)O1)O)O,,,5,1,1,0,1
45860_0,,,,2,1,1,2
C(CC1CC(C(O)O1)O)(O)=O,,,5,1,1,0,1
45862_0,,,,2,1,1,2
C(C1CC(C(CO)(O1)O)O)=O,,,5,1,1,0,1
45864_0,,,,2,1,1,2
C(CO)(C1CC(C(O1)O)O)=O,,,5,1,1,0,1
45866_0,,,,2,1,1,2
C(C1CC(CO)(C(O1)O)O)=O,,,5,1,1,0,1
45868_0,,,,2,1,1,2
C(C1(CO)CC(C(O1)O)O)=O,,,5,1,1,0,1
45870_0,,,,2,1,1,2
C(C1CC(C)(C(O1)O)O)=O,,,5,1,1,0,1
45872_0,,,,2,1,1,2
C(C1(C)CC(C(O1)O)O)=O,,,5,1,1,0,1
45874_0,,,,2,1,1,2
C(C1CC(C(C)(O1)O)O)=O,,,5,1,1,0,1
45876_0,,,,2,1,1,2
C(C)(C1CC(C(O1)O)O)=O,,,5,1,1,0,1
45878_0,,,,2,1,1,2
C1CC(C(O)O1)O,,,5,1,1,0,1
45880_0,,,,2,1,1,2
C(C1(CO)CC(C(O1)O)O)(O)=O,,,5,1,1,0,1
45882_0,,,,2,1,1,2
C(C1(C)CC(C(O1)O)O)(O)=O,,,5,1,1,0,1
45884_0,,,,2,1,1,2
C(C1(C(CC(C)O1)O)O)(O)=O,,,5,1,1,0,1
45886_0,,,,2,1,1,2
C1(CC(C(C(O)=O)(O)O1)O)=O,,,5,1,1,0,1
45888_0,,,,2,1,1,2
C1(C(C(C(CO)(O)O1)O)=O)=O,,,5,1,1,0,1
45890_0,,,,2,1,1,2
C(C1(C(C(CO1)=O)O)O)(O)=O,,,5,1,1,0,1
45892_0,,,,2,1,1,2
C1(C(C(CO)(C(O)O1)O)=O)=O,,,5,1,1,0,1
45894_0,,,,2,1,1,2
C1(C(C(C)(C(O)O1)O)=O)=O,,,5,1,1,0,1
45896_0,,,,2,1,1,2
C1(C(C(C(C)(O)O1)O)=O)=O,,,5,1,1,0,1
45898_0,,,,2,1,1,2
C(C1(C[CH]C(O1)=O)O)(O)=O,,,5,1,1,0,1
45900_0,,,,2,1,1,2
C(C1(C(CO)C(CC(C)O1)O)O)=O,,,5,1,1,0,1
45902_0,,,,2,1,1,2
CC(CC1CC(C(C(O)O1)O)O)O,,,5,1,1,0,1
45904_0,,,,2,1,1,2
CC(CC1CC(CC(O)O1)O)O,,,5,1,1,0,1
45906_0,,,,2,1,1,2
C(C(C1C(O)OC(C)CC1O)O)=O,,,5,1,1,0,1
45908_0,,,,2,1,1,2
CC1CC(C(C(O)O1)C(CO)O)O,,,5,1,1,0,1
45910_0,,,,2,1,1,2
CC1CC(C(C(O)O1)CO)O,,,5,1,1,0,1
45912_0,,,,2,1,1,2
CC1C(CO)C(C(C(O)O1)CO)O,,,5,1,1,0,1
45914_0,,,,2,1,1,2
C1C(C(C)O)C(C(C(O)O1)CO)O,,,5,1,1,0,1
45916_0,,,,2,1,1,2
CC1C(CO)C(CC(CO)(O)O1)O,,,5,1,1,0,1
45918_0,,,,2,1,1,2
CC(C1COC(CO)(CC1O)O)O,,,5,1,1,0,1
45920_0,,,,2,1,1,2
CC1(C(C(C(CO)C(C)O1)O)O)O,,,5,1,1,0,1
45922_0,,,,2,1,1,2
CC(C1COC(C)(C(C1O)O)O)O,,,5,1,1,0,1
45924_0,,,,2,1,1,2
C=CC1C(O)OC(C)C(CO)C1O,,,5,1,1,0,1
45926_0,,,,2,1,1,2
C=CC1C(O)OCC(C1O)C(C)O,,,5,1,1,0,1
45928_0,,,,2,1,1,2
CC1C(CO)C(C(C(O)O1)O)O,,,5,1,1,0,1
45930_0,,,,2,1,1,2
C1C(C(C)O)C(C(C(O)O1)O)O,,,5,1,1,0,1
45932_0,,,,2,1,1,2
CC1C(CO)C(CC(O)O1)O,,,5,1,1,0,1
45934_0,,,,2,1,1,2
CC(C1COC(CC1O)O)O,,,5,1,1,0,1
45936_0,,,,2,1,1,2
C(C1(CC(C(CO)C(C)O1)O)O)=O,,,5,1,1,0,1
45938_0,,,,2,1,1,2
C(C1(CC(C(CO1)C(C)O)O)O)=O,,,5,1,1,0,1
45940_0,,,,2,1,1,2
CC(C1C(C)OC(C(C1O)O)O)O,,,5,1,1,0,1
45942_0,,,,2,1,1,2
CC(C1C(C)OC(CC1O)O)O,,,5,1,1,0,1
45944_0,,,,2,1,1,2
C(C1C(C)OC(C(C1O)O)O)(O)=O,,,5,1,1,0,1
45946_0,,,,2,1,1,2
C1(C(C(C)O)C(C(C(O)O1)O)O)=O,,,5,1,1,0,1
45948_0,,,,2,1,1,2
C(C1C(C)OC(CC1O)O)(O)=O,,,5,1,1,0,1
45949_0,,,,2,1,1,2
45951_0,,,,2,1,1,2
C1(CC(C(CO)C(C=O)(O)O1)O)=O,,,5,1,1,0,1
45953_0,,,,2,1,1,2
C(CC1CC(C(C(O)O1)O)O)(O)=O,,,5,1,1,0,1
45955_0,,,,2,1,1,2
C(CC1CC(CC(O)O1)O)(O)=O,,,5,1,1,0,1
45957_0,,,,2,1,1,2
C1(CC(C(C(O)O1)C(C=O)O)O)=O,,,5,1,1,0,1
45959_0,,,,2,1,1,2
C1(CC(C(C(O)O1)C(CO)O)O)=O,,,5,1,1,0,1
45961_0,,,,2,1,1,2
C1(CC(C(CO)C(O)O1)O)=O,,,5,1,1,0,1
45963_0,,,,2,1,1,2
C1(C(CO)C(C(CO)C(O)O1)O)=O,,,5,1,1,0,1
45965_0,,,,2,1,1,2
C(C1COC(C(CO)C1O)O)(O)=O,,,5,1,1,0,1
45967_0,,,,2,1,1,2
C1(C(CO)C(CC(CO)(O)O1)O)=O,,,5,1,1,0,1
45969_0,,,,2,1,1,2
C(C1COC(CO)(CC1O)O)(O)=O,,,5,1,1,0,1
45971_0,,,,2,1,1,2
C1(C(CO)C(C(C(C)(O)O1)O)O)=O,,,5,1,1,0,1
45973_0,,,,2,1,1,2
C(C1COC(C)(C(C1O)O)O)(O)=O,,,5,1,1,0,1
45975_0,,,,2,1,1,2
C1(C(CO)C(C(C=C)C(O)O1)O)=O,,,5,1,1,0,1
45977_0,,,,2,1,1,2
C(C1COC(C(C=C)C1O)O)(O)=O,,,5,1,1,0,1
45979_0,,,,2,1,1,2
C1(C(CO)C(C(C(O)O1)O)O)=O,,,5,1,1,0,1
45981_0,,,,2,1,1,2
C(C1COC(C(C1O)O)O)(O)=O,,,5,1,1,0,1
45982_0,,,,2,1,1,2
45984_0,,,,2,1,1,2
C(C1COC(CC1O)O)(O)=O,,,5,1,1,0,1
45985_0,,,,2,1,1,2
45987_0,,,,2,1,1,2
C(C1COC(C=O)(CC1O)O)(O)=O,,,5,1,1,0,1
45989_0,,,,2,1,1,2
C1(C(C(O)=O)C(C(C(O)O1)O)O)=O,,,5,1,1,0,1
45990_0,,,,2,1,1,2
45992_0,,,,2,1,1,2
C(C1(C(CO)C(C(CO1)=O)O)O)=O,,,5,1,1,0,1
45993_0,,,,2,1,1,2
45995_0,,,,2,1,1,2
C(C1C(CC(C(CO)(O1)O)O)O)=O,,,5,1,1,0,1
45997_0,,,,2,1,1,2
C(CO)(C1CC(C(C(O1)O)O)O)=O,,,5,1,1,0,1
45999_0,,,,2,1,1,2
C(CO)(C1CC(CC(O1)O)O)=O,,,5,1,1,0,1
46001_0,,,,2,1,1,2
C(C1C(CO)(C(CC(O1)O)O)O)=O,,,5,1,1,0,1
46002_0,,,,2,1,1,2
46003_0,,,,2,1,1,2
46005_0,,,,2,1,1,2
C(C(C1C(OCC(C1O)=O)O)O)=O,,,5,1,1,0,1
46007_0,,,,2,1,1,2
C(C1C(COC(CO)(C1O)O)O)=O,,,5,1,1,0,1
46009_0,,,,2,1,1,2
C1(COC(C(C(CO)O)C1O)O)=O,,,5,1,1,0,1
46011_0,,,,2,1,1,2
C1(COC(C(CO)C1O)O)=O,,,5,1,1,0,1
46013_0,,,,2,1,1,2
C(CC1C(C(C(C(O1)O)O)O)=O)=O,,,5,1,1,0,1
46014_0,,,,2,1,1,2
46015_0,,,,2,1,1,2
46016_0,,,,2,1,1,2
46017_0,,,,2,1,1,2
46018_0,,,,2,1,1,2
46019_0,,,,2,1,1,2
46021_0,,,,2,1,1,2
C(C1C(CC(CO)(C(O1)O)O)O)=O,,,5,1,1,0,1
46023_0,,,,2,1,1,2
C(C1(CO)CC(C(C(O1)O)O)O)=O,,,5,1,1,0,1
46025_0,,,,2,1,1,2
C(C1(CO)CC(CC(O1)O)O)=O,,,5,1,1,0,1
46027_0,,,,2,1,1,2
C(C1C(C(CO)(CC(O1)O)O)O)=O,,,5,1,1,0,1
46029_0,,,,2,1,1,2
C(CC1(COC(C(C1O)O)O)O)=O,,,5,1,1,0,1
46031_0,,,,2,1,1,2
C(C1C(C(O)OCC1(C=O)O)O)=O,,,5,1,1,0,1
46033_0,,,,2,1,1,2
C(C1C(COC(C1(CO)O)O)O)=O,,,5,1,1,0,1
46035_0,,,,2,1,1,2
C1(C(CO)OC(C(CO)C1O)O)=O,,,5,1,1,0,1
46037_0,,,,2,1,1,2
C1(COC(C(C1)O)(C(CO)O)O)=O,,,5,1,1,0,1
46039_0,,,,2,1,1,2
C1(C(CO)OC(CC1O)(CO)O)=O,,,5,1,1,0,1
46041_0,,,,2,1,1,2
C1(C(CO)OC(C(C1O)O)(C)O)=O,,,5,1,1,0,1
46043_0,,,,2,1,1,2
C1(C(C(C=C)C(OC1CO)O)O)=O,,,5,1,1,0,1
46045_0,,,,2,1,1,2
C1(C(CO)OC(C(C1O)O)O)=O,,,5,1,1,0,1
46047_0,,,,2,1,1,2
C(C1(C(COC(C1CO)O)O)O)=O,,,5,1,1,0,1
46049_0,,,,2,1,1,2
C1(COC(C(C(CO)O)(C1)O)O)=O,,,5,1,1,0,1
46051_0,,,,2,1,1,2
C(C1(C(COC(CO)(C1)O)O)O)=O,,,5,1,1,0,1
46053_0,,,,2,1,1,2
C(C1(C(COC(C)(C1O)O)O)O)=O,,,5,1,1,0,1
46055_0,,,,2,1,1,2
C(C1(C(COC(C1C=C)O)O)O)=O,,,5,1,1,0,1
46057_0,,,,2,1,1,2
C(C1(C(C(O)OCC1O)O)O)=O,,,5,1,1,0,1
46059_0,,,,2,1,1,2
C(C1(C(COC(C1)O)O)O)=O,,,5,1,1,0,1
46061_0,,,,2,1,1,2
C(C1(C(CO)OC(C(C1)=O)O)O)=O,,,5,1,1,0,1
46063_0,,,,2,1,1,2
C(C1(CC(C=O)(O)OCC1O)O)=O,,,5,1,1,0,1
46065_0,,,,2,1,1,2
C1(C(C(C)O)OC(C(C1O)O)O)=O,,,5,1,1,0,1
46067_0,,,,2,1,1,2
C(C1(C(C(O)OC(C)C1O)O)O)=O,,,5,1,1,0,1
46069_0,,,,2,1,1,2
C(C1(CC(O)OC(C)C1O)O)=O,,,5,1,1,0,1
46071_0,,,,2,1,1,2
C(C1C(C(C(C(O1)O)O)O)=O)(O)=O,,,5,1,1,0,1
46073_0,,,,2,1,1,2
C(C1(C(C(O)OC(C1O)=O)O)O)=O,,,5,1,1,0,1
46075_0,,,,2,1,1,2
C(C1(CC(O)OC(C1O)=O)O)=O,,,5,1,1,0,1
46077_0,,,,2,1,1,2
C(C1(CC(C=O)(C)OC(C1)O)O)=O,,,5,1,1,0,1
46079_0,,,,2,1,1,2
C(CC1C(CC(C)(C(O1)O)O)=O)=O,,,5,1,1,0,1
46081_0,,,,2,1,1,2
C(CC1C(C)(CC(C(O)O1)=O)O)=O,,,5,1,1,0,1
46083_0,,,,2,1,1,2
C(C1(C)CC(C(CO)C(O1)O)O)=O,,,5,1,1,0,1
46085_0,,,,2,1,1,2
C(C1(C)CC(CC(CO)(O1)O)O)=O,,,5,1,1,0,1
46087_0,,,,2,1,1,2
C(C)(C1C(CC(C)(C(O1)O)O)O)=O,,,5,1,1,0,1
46089_0,,,,2,1,1,2
C(C1(C)CC(C(C(C)(O1)O)O)O)=O,,,5,1,1,0,1
46091_0,,,,2,1,1,2
C(C1(C)CC(C(C=C)C(O1)O)O)=O,,,5,1,1,0,1
46093_0,,,,2,1,1,2
C(C1C(CC(C)(C(O1)O)O)O)=O,,,5,1,1,0,1
46095_0,,,,2,1,1,2
C(C1(C)CC(C(C(O1)O)O)O)=O,,,5,1,1,0,1
46097_0,,,,2,1,1,2
C(C1(C)CC(CC(O1)O)O)=O,,,5,1,1,0,1
46099_0,,,,2,1,1,2
C(C1(C)CC(CC(C=O)(O1)O)O)=O,,,5,1,1,0,1
46101_0,,,,2,1,1,2
C(C)(C1C(C(C)(CC(O1)O)O)O)=O,,,5,1,1,0,1
46103_0,,,,2,1,1,2
C(C1C(C(C)(CC(O1)O)O)O)=O,,,5,1,1,0,1
46105_0,,,,2,1,1,2
C(CC1(C)C(CC(C(O)O1)=O)O)=O,,,5,1,1,0,1
46107_0,,,,2,1,1,2
C(C(C)(C1C(O)OCCC1O)O)=O,,,5,1,1,0,1
46109_0,,,,2,1,1,2
C(C1C(COC(C1(C)O)O)(C)O)=O,,,5,1,1,0,1
46111_0,,,,2,1,1,2
C(C1C(COC(C1(C)O)O)O)=O,,,5,1,1,0,1
46113_0,,,,2,1,1,2
C(C1C(C(C)OC(C1(C)O)O)O)=O,,,5,1,1,0,1
46115_0,,,,2,1,1,2
C(C1C(C)(C(O)OC(C1O)=O)O)=O,,,5,1,1,0,1
46116_0,,,,2,1,1,2
46118_0,,,,2,1,1,2
C(C1(CC(C(C)=O)OC(C1)O)O)=O,,,5,1,1,0,1
46120_0,,,,2,1,1,2
C(CC1C(CC(C(C)(O1)O)O)=O)=O,,,5,1,1,0,1
46122_0,,,,2,1,1,2
C(C)(C1CC(C(CO)C(O1)O)O)=O,,,5,1,1,0,1
46124_0,,,,2,1,1,2
C(C)(C1CC(CC(CO)(O1)O)O)=O,,,5,1,1,0,1
46126_0,,,,2,1,1,2
C(C)(C1C(CC(C(C)(O1)O)O)O)=O,,,5,1,1,0,1
46128_0,,,,2,1,1,2
C(C)(C1CC(C(C(C)(O1)O)O)O)=O,,,5,1,1,0,1
46130_0,,,,2,1,1,2
C(C)(C1CC(C(C=C)C(O1)O)O)=O,,,5,1,1,0,1
46132_0,,,,2,1,1,2
C(C1C(CC(C(C)(O1)O)O)O)=O,,,5,1,1,0,1
46134_0,,,,2,1,1,2
C(C)(C1CC(C(C(O1)O)O)O)=O,,,5,1,1,0,1
46136_0,,,,2,1,1,2
C(C)(C1CC(CC(O1)O)O)=O,,,5,1,1,0,1
46138_0,,,,2,1,1,2
C(C1(CC(CC(C(C)=O)O1)O)O)=O,,,5,1,1,0,1
46140_0,,,,2,1,1,2
C(C)(C1C(C)(C(CC(O1)O)O)O)=O,,,5,1,1,0,1
46142_0,,,,2,1,1,2
C(C1C(C)(C(CC(O1)O)O)O)=O,,,5,1,1,0,1
46144_0,,,,2,1,1,2
C(C)(C(C1C(O)OCCC1O)O)=O,,,5,1,1,0,1
46146_0,,,,2,1,1,2
C(C1C(C(C)(O)OCC1(C)O)O)=O,,,5,1,1,0,1
46148_0,,,,2,1,1,2
C(C1C(COC(C)(C1O)O)O)=O,,,5,1,1,0,1
46150_0,,,,2,1,1,2
C(C1C(C(C)(O)OC(C)C1O)O)=O,,,5,1,1,0,1
46152_0,,,,2,1,1,2
C(C1C(C(C)(O)OC(C1O)=O)O)=O,,,5,1,1,0,1
46154_0,,,,2,1,1,2
C(CC(C1(CC(CCO1)O)O)O)=O,,,5,1,1,0,1
46156_0,,,,2,1,1,2
C(CC1C(CC(C(O1)O)O)=O)=O,,,5,1,1,0,1
46157_0,,,,2,1,1,2
46159_0,,,,2,1,1,2
C1(C(CC(C(CCO)(O)O1)O)=O)=O,,,5,1,1,0,1
46161_0,,,,2,1,1,2
C(C1(CCOC(C1CO)O)O)=O,,,5,1,1,0,1
46163_0,,,,2,1,1,2
C1(COC(C(CCO)(C1O)O)O)=O,,,5,1,1,0,1
46165_0,,,,2,1,1,2
C(C1(CCOC(CO)(C1O)O)O)=O,,,5,1,1,0,1
46167_0,,,,2,1,1,2
C1(COC(C(CCO)(C1)O)O)=O,,,5,1,1,0,1
46169_0,,,,2,1,1,2
C(C1(CCOC(CO)(C1)O)O)=O,,,5,1,1,0,1
46171_0,,,,2,1,1,2
C(C1(CCOC(C)(C1O)O)O)=O,,,5,1,1,0,1
46173_0,,,,2,1,1,2
C(C1(CCOC(C1C=C)O)O)=O,,,5,1,1,0,1
46175_0,,,,2,1,1,2
C(C1(C(C(O)OCC1)O)O)=O,,,5,1,1,0,1
46177_0,,,,2,1,1,2
C(C1(CC(O)OCC1)O)=O,,,5,1,1,0,1
46179_0,,,,2,1,1,2
C(C1(CCOC(C1C(C)O)O)O)=O,,,5,1,1,0,1
46181_0,,,,2,1,1,2
C(C1C(O)OCCC1(C=O)O)(O)=O,,,5,1,1,0,1
46183_0,,,,2,1,1,2
C(C1(C(C(C=O)(O)OCC1)O)O)=O,,,5,1,1,0,1
46185_0,,,,2,1,1,2
C(C1(CC(C=O)(O)OCC1)O)=O,,,5,1,1,0,1
46187_0,,,,2,1,1,2
C1(C(CC(C(O)O1)(CCO)O)=O)=O,,,5,1,1,0,1
46189_0,,,,2,1,1,2
C(C1(CC(C(O)=O)(O)OCC1)O)=O,,,5,1,1,0,1
46191_0,,,,2,1,1,2
C1(COC(C(C1O)O)(CCO)O)=O,,,5,1,1,0,1
46193_0,,,,2,1,1,2
C1(COC(C(C1)O)(CCO)O)=O,,,5,1,1,0,1
46195_0,,,,2,1,1,2
C(C1(C(CO)C(CCO1)O)O)=O,,,5,1,1,0,1
46197_0,,,,2,1,1,2
C(C1C(C(C(C(O1)O)=O)CO)O)=O,,,5,1,1,0,1
46199_0,,,,2,1,1,2
C(C(C1COC(C(C1O)O)O)=O)=O,,,5,1,1,0,1
46201_0,,,,2,1,1,2
C1(C(O)OCC(CO)(C1CO)O)=O,,,5,1,1,0,1
46203_0,,,,2,1,1,2
C1(C(O)OCC(C)(C1CO)O)=O,,,5,1,1,0,1
46205_0,,,,2,1,1,2
C1(C(O)OC(CO)C(C1CO)O)=O,,,5,1,1,0,1
46207_0,,,,2,1,1,2
C(C1(C(CO)C(C(CO1)O)O)O)=O,,,5,1,1,0,1
46209_0,,,,2,1,1,2
C1(C(O)OCC(C1CO)O)=O,,,5,1,1,0,1
46211_0,,,,2,1,1,2
C1(C(O)OC(C)C(C1CO)O)=O,,,5,1,1,0,1
46213_0,,,,2,1,1,2
C1(C(O)OC(C(C1CO)O)=O)=O,,,5,1,1,0,1
46214_0,,,,2,1,1,2
46216_0,,,,2,1,1,2
C(C1(CC(C)OC(C1CO)O)O)=O,,,5,1,1,0,1
46218_0,,,,2,1,1,2
C1(COC(C(CC(C)O)(C1)O)O)=O,,,5,1,1,0,1
46220_0,,,,2,1,1,2
C(C1(CC(CO)(O)OC(C)C1)O)=O,,,5,1,1,0,1
46222_0,,,,2,1,1,2
C(C1(C(C(C)(O)OC(C)C1)O)O)=O,,,5,1,1,0,1
46224_0,,,,2,1,1,2
C(C1(CC(C)OC(C1C=C)O)O)=O,,,5,1,1,0,1
46226_0,,,,2,1,1,2
C(C1(C(C(O)OC(C)C1)O)O)=O,,,5,1,1,0,1
46228_0,,,,2,1,1,2
C(C1(CC(O)OC(C)C1)O)=O,,,5,1,1,0,1
46230_0,,,,2,1,1,2
C(C1(CC(C=O)(O)OC(C)C1)O)=O,,,5,1,1,0,1
46232_0,,,,2,1,1,2
C1(COC(C(C1)O)(CC(C)O)O)=O,,,5,1,1,0,1
46234_0,,,,2,1,1,2
C(C1(C(C(CCO1)O)C(C)O)O)=O,,,5,1,1,0,1
46236_0,,,,2,1,1,2
C1(C(O)OCC(C)(C1C(C)O)O)=O,,,5,1,1,0,1
46238_0,,,,2,1,1,2
C1(C(O)OCC(C1C(C)O)O)=O,,,5,1,1,0,1
46240_0,,,,2,1,1,2
C1(C(O)OC(C)C(C1C(C)O)O)=O,,,5,1,1,0,1
46242_0,,,,2,1,1,2
C1(C(O)OC(C(C1C(C)O)O)=O)=O,,,5,1,1,0,1
46244_0,,,,2,1,1,2
C(C1(C(CO)C(O)OC(C1)=O)O)=O,,,5,1,1,0,1
46246_0,,,,2,1,1,2
C(CC1(C(OCC(C1)=O)O)O)(O)=O,,,5,1,1,0,1
46248_0,,,,2,1,1,2
C(C1(CC(CO)(O)OC(C1)=O)O)=O,,,5,1,1,0,1
46250_0,,,,2,1,1,2
C(C1(C(C(C)(O)OC(C1)=O)O)O)=O,,,5,1,1,0,1
46252_0,,,,2,1,1,2
C1(CC(C=O)(C(C=C)C(O)O1)O)=O,,,5,1,1,0,1
46254_0,,,,2,1,1,2
C(C1(C(C(O)OC(C1)=O)O)O)=O,,,5,1,1,0,1
46256_0,,,,2,1,1,2
C(C1(CC(O)OC(C1)=O)O)=O,,,5,1,1,0,1
46258_0,,,,2,1,1,2
C(C1(CC(C=O)(O)OC(C1)=O)O)=O,,,5,1,1,0,1
46260_0,,,,2,1,1,2
C(CC1(C(CC(CO1)=O)O)O)(O)=O,,,5,1,1,0,1
46262_0,,,,2,1,1,2
C(C1C(CCOC1(C=O)O)O)(O)=O,,,5,1,1,0,1
46264_0,,,,2,1,1,2
C(C1C(C(O)OCC1(C)O)=O)(O)=O,,,5,1,1,0,1
46266_0,,,,2,1,1,2
C(C1C(C(O)OCC1O)=O)(O)=O,,,5,1,1,0,1
46268_0,,,,2,1,1,2
C(C1C(C(O)OC(C)C1O)=O)(O)=O,,,5,1,1,0,1
46270_0,,,,2,1,1,2
C(C1C(C(O)OC(C1O)=O)=O)(O)=O,,,5,1,1,0,1
46272_0,,,,2,1,1,2
C(C1(C(C(O)OCC1O)O)O)(O)=O,,,5,1,1,0,1
46274_0,,,,2,1,1,2
C(C1(C(COC(C1)O)O)O)(O)=O,,,5,1,1,0,1
46276_0,,,,2,1,1,2
C1CC(C(C(O)O1)CO)O,,,5,1,1,0,1
46278_0,,,,2,1,1,2
C(C1(C(CO)C(CCO1)O)O)(O)=O,,,5,1,1,0,1
46280_0,,,,2,1,1,2
C(C1C(CCOC1(C(C)=O)O)O)=O,,,5,1,1,0,1
46282_0,,,,2,1,1,2
C(C(C)=O)(C1C(O)OCCC1O)=O,,,5,1,1,0,1
46284_0,,,,2,1,1,2
C(CC(C1(CC(CCO1)O)O)=O)=O,,,5,1,1,0,1
46286_0,,,,2,1,1,2
C(C1(CC(CCO1)O)O)(C(C)O)=O,,,5,1,1,0,1
46288_0,,,,2,1,1,2
C(C(C1(CC(CCO1)O)O)=O)(O)=O,,,5,1,1,0,1
46290_0,,,,2,1,1,2
C1CC(C(C(CO)(O)O1)O)O,,,5,1,1,0,1
46292_0,,,,2,1,1,2
C1CC(CC(CO)(O)O1)O,,,5,1,1,0,1
46294_0,,,,2,1,1,2
CC1(C(C(CCO1)O)O)O,,,5,1,1,0,1
46296_0,,,,2,1,1,2
C(C(C)C1(CC(CCO1)O)O)(O)=O,,,5,1,1,0,1
46298_0,,,,2,1,1,2
C=CC1C(O)OCCC1O,,,5,1,1,0,1
46300_0,,,,2,1,1,2
C(C1(C(C=C)C(CCO1)O)O)(O)=O,,,5,1,1,0,1
46302_0,,,,2,1,1,2
C=C(C(O)=O)C1C(O)OCCC1O,,,5,1,1,0,1
46304_0,,,,2,1,1,2
C1CC(C(C(O)O1)O)O,,,5,1,1,0,1
46306_0,,,,2,1,1,2
C1(C2(C(C(CCO2)O)C(C)O1)O)=O,,,5,1,1,0,1
46308_0,,,,2,1,1,2
C1(C2C(CCOC2(C(O1)=O)O)O)=O,,,5,1,1,0,1
46310_0,,,,2,1,1,2
[CH]1C(OC(C(C(CCO)O)C1)O)=O,,,5,1,1,0,1
46312_0,,,,2,1,1,2
[CH](C(O)=O)CC1C(O)OCCC1O,,,5,1,1,0,1
46314_0,,,,2,1,1,2
C1(CCC(C(O)O1)C(CCO)O)=O,,,5,1,1,0,1
46316_0,,,,2,1,1,2
C(CCC1C(O)OCCC1O)(O)=O,,,5,1,1,0,1
46318_0,,,,2,1,1,2
C1CC(CC(O)O1)O,,,5,1,1,0,1
46320_0,,,,2,1,1,2
CC(C1C(O)OCCC1O)O,,,5,1,1,0,1
46322_0,,,,2,1,1,2
C(C1C(O)OCCC1O)(O)=O,,,5,1,1,0,1
46324_0,,,,2,1,1,2
C(C1(C(C(CCO1)O)O)O)=O,,,5,1,1,0,1
46326_0,,,,2,1,1,2
C(C1(CC(CCO1)O)O)=O,,,5,1,1,0,1
46328_0,,,,2,1,1,2
C(C1(C(C(CCO1)O)O)O)(O)=O,,,5,1,1,0,1
46330_0,,,,2,1,1,2
C(C1(CC(CCO1)O)O)(O)=O,,,5,1,1,0,1
46332_0,,,,2,1,1,2
C(C1(CCOC(C1CO)O)O)(O)=O,,,5,1,1,0,1
46334_0,,,,2,1,1,2
C(C1COC(CC1(C(C)=O)O)O)=O,,,5,1,1,0,1
46336_0,,,,2,1,1,2
C(C1COC(C(C)=O)(CC1O)O)=O,,,5,1,1,0,1
46338_0,,,,2,1,1,2
C1(C(C)OC(C(CO)C1(C)O)O)=O,,,5,1,1,0,1
46340_0,,,,2,1,1,2
C1(C(C(C)(C(CO)C(O)O1)O)=O)=O,,,5,1,1,0,1
46342_0,,,,2,1,1,2
C(C1COC(C(C1O)O)O)=O,,,5,1,1,0,1
46344_0,,,,2,1,1,2
C1(C(C(C(CO)C(O)O1)O)O)=O,,,5,1,1,0,1
46346_0,,,,2,1,1,2
C1(C(C)(C(C(CO)C(O)O1)O)O)=O,,,5,1,1,0,1
46348_0,,,,2,1,1,2
C1(C(C)C(C)(C(CO)C(O)O1)O)=O,,,5,1,1,0,1
46350_0,,,,2,1,1,2
C1C(C(C(C(O)O1)CO)O)O,,,5,1,1,0,1
46352_0,,,,2,1,1,2
C(C1(CCOC(CO)(C1)O)O)(O)=O,,,5,1,1,0,1
46354_0,,,,2,1,1,2
C(C1(CCOC(C)(C1O)O)O)(O)=O,,,5,1,1,0,1
46356_0,,,,2,1,1,2
C(C1(CCOC(C1C=C)O)O)(O)=O,,,5,1,1,0,1
46358_0,,,,2,1,1,2
C(C1(C(C(O)OCC1)O)O)(O)=O,,,5,1,1,0,1
46360_0,,,,2,1,1,2
C(C1(CC(O)OCC1)O)(O)=O,,,5,1,1,0,1
46362_0,,,,2,1,1,2
C(C1(CC(C=O)(O)OCC1)O)(O)=O,,,5,1,1,0,1
46364_0,,,,2,1,1,2
C1(C(CCO)(CC(C(O)O1)=O)O)=O,,,5,1,1,0,1
46366_0,,,,2,1,1,2
C1(C(C(CO)C(C(O)O1)O)=O)=O,,,5,1,1,0,1
46368_0,,,,2,1,1,2
C(C1(CO)CC(CC(O1)O)O)(O)=O,,,5,1,1,0,1
46370_0,,,,2,1,1,2
C(C1(CC(O)OC(C)C1O)O)(O)=O,,,5,1,1,0,1
46372_0,,,,2,1,1,2
C(C1(CC(O)OC(C1O)=O)O)(O)=O,,,5,1,1,0,1
46374_0,,,,2,1,1,2
C(CC1(C(C)(OCC(C1)=O)O)O)=O,,,5,1,1,0,1
46376_0,,,,2,1,1,2
C(CC1(C(C)(CC(CO1)=O)O)O)=O,,,5,1,1,0,1
46378_0,,,,2,1,1,2
C1(C(C)(C(C(C)=O)OC(C1)O)O)=O,,,5,1,1,0,1
46380_0,,,,2,1,1,2
C1(C(C)(C(C=O)OC(C1)O)O)=O,,,5,1,1,0,1
46382_0,,,,2,1,1,2
C1(C(C)(OC(C(C)=O)C(C1)O)O)=O,,,5,1,1,0,1
46384_0,,,,2,1,1,2
C(C1C(CC(C(C)(O1)O)=O)O)=O,,,5,1,1,0,1
46386_0,,,,2,1,1,2
C(C1C(C(C)(O)OCC1(C)O)=O)=O,,,5,1,1,0,1
46388_0,,,,2,1,1,2
C(C1C(C(C)(O)OCC1O)=O)=O,,,5,1,1,0,1
46390_0,,,,2,1,1,2
C(C1C(C(C)(O)OC(C)C1O)=O)=O,,,5,1,1,0,1
46392_0,,,,2,1,1,2
C1(C(C)(O)OC(C(C1C=O)O)=O)=O,,,5,1,1,0,1
46394_0,,,,2,1,1,2
C(CC1(C(CC(CO1)(C)O)=O)O)=O,,,5,1,1,0,1
46396_0,,,,2,1,1,2
C(CC1(C(CC(CO1)O)=O)O)=O,,,5,1,1,0,1
46398_0,,,,2,1,1,2
C(CC1(C(CC(C(C)O1)O)=O)O)=O,,,5,1,1,0,1
46400_0,,,,2,1,1,2
C1(C(CC(C(CC=O)(O)O1)=O)O)=O,,,5,1,1,0,1
46402_0,,,,2,1,1,2
C1(C(C)OC(C(C1(CO)O)O)O)=O,,,5,1,1,0,1
46404_0,,,,2,1,1,2
C1(C(C)OC(CC1(CO)O)O)=O,,,5,1,1,0,1
46406_0,,,,2,1,1,2
C1(COC(C(C1(C(C)O)O)O)O)=O,,,5,1,1,0,1
46407_0,,,,2,1,1,2
46409_0,,,,2,1,1,2
C1(C(C(C)O)(O)OCC(C1O)O)=O,,,5,1,1,0,1
46411_0,,,,2,1,1,2
C1(C(C(CO)(C(C(O)O1)O)O)=O)=O,,,5,1,1,0,1
46413_0,,,,2,1,1,2
C1(C(C(CO)(CC(O)O1)O)=O)=O,,,5,1,1,0,1
46415_0,,,,2,1,1,2
C(C1(C(COC(C1O)O)=O)O)(O)=O,,,5,1,1,0,1
46416_0,,,,2,1,1,2
46418_0,,,,2,1,1,2
C(C1(C(C(C(CO1)O)O)=O)O)(O)=O,,,5,1,1,0,1
46420_0,,,,2,1,1,2
C1(COC(C)(C(C(C)O)(C1)O)O)=O,,,5,1,1,0,1
46422_0,,,,2,1,1,2
C(C)(C1(C(C)OC(C(C1)=O)O)O)=O,,,5,1,1,0,1
46424_0,,,,2,1,1,2
C1(COC(C(C)O)(C(C)(C1)O)O)=O,,,5,1,1,0,1
46426_0,,,,2,1,1,2
C1(C(C)OC(CO)(CC1(C)O)O)=O,,,5,1,1,0,1
46428_0,,,,2,1,1,2
C1(C(C)OC(C)(C(C1(C)O)O)O)=O,,,5,1,1,0,1
46430_0,,,,2,1,1,2
C1(C(C)(C(C=C)C(OC1C)O)O)=O,,,5,1,1,0,1
46432_0,,,,2,1,1,2
C1(C(C)OC(C(C1(C)O)O)O)=O,,,5,1,1,0,1
46434_0,,,,2,1,1,2
C1(C(C)OC(CC1(C)O)O)=O,,,5,1,1,0,1
46436_0,,,,2,1,1,2
C1(C(C)OC(C=O)(CC1(C)O)O)=O,,,5,1,1,0,1
46438_0,,,,2,1,1,2
C1(C(C(C)O)(O)OCC(C)(C1)O)=O,,,5,1,1,0,1
46440_0,,,,2,1,1,2
C1(C(C(C)O)(O)OCC(C1)O)=O,,,5,1,1,0,1
46442_0,,,,2,1,1,2
C1(C(C(C)O)(O)OC(C(C1)O)C)=O,,,5,1,1,0,1
46444_0,,,,2,1,1,2
C1(CC(C(OC1(C(C)O)O)=O)O)=O,,,5,1,1,0,1
46446_0,,,,2,1,1,2
C(C1(C(C)(OCC(C1)=O)O)O)(O)=O,,,5,1,1,0,1
46448_0,,,,2,1,1,2
C1(C(C(C)=O)(CC(C(O)O1)=O)O)=O,,,5,1,1,0,1
46450_0,,,,2,1,1,2
C(C1(C(C)(CC(CO1)=O)O)O)(O)=O,,,5,1,1,0,1
46452_0,,,,2,1,1,2
C1(C(C(C)(CC(CO)(O)O1)O)=O)=O,,,5,1,1,0,1
46454_0,,,,2,1,1,2
C1(C(C(C)(C(C(C)(O)O1)O)O)=O)=O,,,5,1,1,0,1
46456_0,,,,2,1,1,2
C(C1C(O)OC(C(C1(C)O)=O)=O)=C,,,5,1,1,0,1
46458_0,,,,2,1,1,2
C1(C(C(C)(C(C(O)O1)O)O)=O)=O,,,5,1,1,0,1
46460_0,,,,2,1,1,2
C1(C(C(C)(CC(O)O1)O)=O)=O,,,5,1,1,0,1
46462_0,,,,2,1,1,2
C(C1(CC(C(C(O1)=O)=O)(C)O)O)=O,,,5,1,1,0,1
46464_0,,,,2,1,1,2
C(C1(C(CC(CO1)(C)O)=O)O)(O)=O,,,5,1,1,0,1
46466_0,,,,2,1,1,2
C(C1(C(CC(CO1)O)=O)O)(O)=O,,,5,1,1,0,1
46468_0,,,,2,1,1,2
C(C1(C(CC(C(C)O1)O)=O)O)(O)=O,,,5,1,1,0,1
46470_0,,,,2,1,1,2
C(C1(C(CC(C(O1)=O)O)=O)O)(O)=O,,,5,1,1,0,1
46472_0,,,,2,1,1,2
C1(COC(C(C1O)O)O)=O,,,5,1,1,0,1
46474_0,,,,2,1,1,2
C1(COC(C(C1)O)O)=O,,,5,1,1,0,1
46476_0,,,,2,1,1,2
C=CC1C(C(OC(C1O)O)=O)=O,,,5,1,1,0,1
46478_0,,,,2,1,1,2
C(C1C(C(OC(C1O)O)=O)=C)=O,,,5,1,1,0,1
46480_0,,,,2,1,1,2
C(C(C1C(O)OC([CH]C1)=O)O)=O,,,5,1,1,0,1
46482_0,,,,2,1,1,2
C1(CCC(C(O)O1)C(C=O)O)=O,,,5,1,1,0,1
46484_0,,,,2,1,1,2
C1(C(C(C(C(O)O1)O)C(C)O)=O)=O,,,5,1,1,0,1
46486_0,,,,2,1,1,2
C(C1C(C(O)OC(C1(C)O)=O)O)=O,,,5,1,1,0,1
46488_0,,,,2,1,1,2
C(C1C(C(OC(C1O)O)=O)=O)(O)=O,,,5,1,1,0,1
46490_0,,,,2,1,1,2
C1(C(C(C(C(O)O1)O)O)=O)=O,,,5,1,1,0,1
46492_0,,,,2,1,1,2
C1(C(CC(C(O)O1)O)=O)=O,,,5,1,1,0,1
46494_0,,,,2,1,1,2
C1(C(CCO)(O)OC([C](C1)O)=O)=O,,,5,1,1,0,1
46495_0,,,,2,1,1,2
46497_0,,,,2,1,1,2
C1(CC(C(OC1(CCO)O)=O)O)=O,,,5,1,1,0,1
46498_0,,,,2,1,1,2
46500_0,,,,2,1,1,2
C(C1C(C)OC(C(C1O)O)O)=O,,,5,1,1,0,1
46502_0,,,,2,1,1,2
C1(C(C=O)C(C(C(O)O1)O)O)=O,,,5,1,1,0,1
46504_0,,,,2,1,1,2
C(C1C(C(C(C(O1)O)=O)O)O)=O,,,5,1,1,0,1
46506_0,,,,2,1,1,2
C(C1C(CC(C(O1)O)=O)O)=O,,,5,1,1,0,1
46507_0,,,,2,1,1,2
46509_0,,,,2,1,1,2
C1(C(C(CC(CO)(O)O1)O)O)=O,,,5,1,1,0,1
46510_0,,,,2,1,1,2
46512_0,,,,2,1,1,2
C1(C(C(C(C=C)C(O)O1)O)O)=O,,,5,1,1,0,1
46514_0,,,,2,1,1,2
C1(C(C(C(C(O)O1)O)O)O)=O,,,5,1,1,0,1
46516_0,,,,2,1,1,2
C1(C(C(CC(O)O1)O)O)=O,,,5,1,1,0,1
46518_0,,,,2,1,1,2
C1(C(C(C(C(O)O1)C(C)O)O)O)=O,,,5,1,1,0,1
46520_0,,,,2,1,1,2
C(C1C(O)OC(C(C1O)O)=O)(O)=O,,,5,1,1,0,1
46522_0,,,,2,1,1,2
C(C1C(C(C(C(O1)O)=O)O)O)(O)=O,,,5,1,1,0,1
46524_0,,,,2,1,1,2
C1(C(C(C(C(C=O)(O)O1)O)O)O)=O,,,5,1,1,0,1
46526_0,,,,2,1,1,2
C(C1C(CC(C(O1)O)=O)O)(O)=O,,,5,1,1,0,1
46528_0,,,,2,1,1,2
C1(C(C(CC(C=O)(O)O1)O)O)=O,,,5,1,1,0,1
46530_0,,,,2,1,1,2
C1(C(C(CC(C(O)=O)(O)O1)O)O)=O,,,5,1,1,0,1
46531_0,,,,2,1,1,2
46532_0,,,,2,1,1,2
46534_0,,,,2,1,1,2
C1C(C(C(C(CO)(O)O1)O)O)O,,,5,1,1,0,1
46535_0,,,,2,1,1,2
46536_0,,,,2,1,1,2
46537_0,,,,2,1,1,2
46539_0,,,,2,1,1,2
C1(COC(C(CO)(C1O)O)O)=O,,,5,1,1,0,1
46541_0,,,,2,1,1,2
C1(COC(C(C)(C1O)O)O)=O,,,5,1,1,0,1
46543_0,,,,2,1,1,2
C1(COC(C)(C(C1O)O)O)=O,,,5,1,1,0,1
46545_0,,,,2,1,1,2
[CH]1C(OC(C(C(C)(CO)O)C1)O)=O,,,5,1,1,0,1
46547_0,,,,2,1,1,2
C1(CCC(C(O)O1)C(C)(CO)O)=O,,,5,1,1,0,1
46549_0,,,,2,1,1,2
C1(C(O)OCC(C)(C1O)O)=O,,,5,1,1,0,1
46551_0,,,,2,1,1,2
C1(C(O)OCC(C)(C1)O)=O,,,5,1,1,0,1
46553_0,,,,2,1,1,2
C1(C(C)(C(CC(CO)(O)O1)O)O)=O,,,5,1,1,0,1
46555_0,,,,2,1,1,2
C1(C(C)C(C)(CC(CO)(O)O1)O)=O,,,5,1,1,0,1
46557_0,,,,2,1,1,2
C1C(C(CC(CO)(O)O1)O)O,,,5,1,1,0,1
46558_0,,,,2,1,1,2
46559_0,,,,2,1,1,2
46560_0,,,,2,1,1,2
46562_0,,,,2,1,1,2
C1(COC(CO)(C(C1)O)O)=O,,,5,1,1,0,1
46564_0,,,,2,1,1,2
C1(COC(C(CO)(C1)O)O)=O,,,5,1,1,0,1
46566_0,,,,2,1,1,2
C1(COC(C(C)(C1)O)O)=O,,,5,1,1,0,1
46568_0,,,,2,1,1,2
C1(COC(C)(C(C1)O)O)=O,,,5,1,1,0,1
46570_0,,,,2,1,1,2
C1(C(C)(C(C(C(C)(O)O1)O)O)O)=O,,,5,1,1,0,1
46572_0,,,,2,1,1,2
C1(C(C)C(C)(C(C(C)(O)O1)O)O)=O,,,5,1,1,0,1
46574_0,,,,2,1,1,2
CC1(C(C(C(CO1)O)O)O)O,,,5,1,1,0,1
46576_0,,,,2,1,1,2
CC1(C(C(CC(C)O1)O)O)O,,,5,1,1,0,1
46578_0,,,,2,1,1,2
C1(CC(C(C(C)(O)O1)O)O)=O,,,5,1,1,0,1
46580_0,,,,2,1,1,2
C(C1C(C)(C(CC(O1)O)O)O)(O)=O,,,5,1,1,0,1
46582_0,,,,2,1,1,2
C(C1C(C(C)(CC(O1)O)O)O)(O)=O,,,5,1,1,0,1
46584_0,,,,2,1,1,2
C1(C(C(C(C=C)C(O)O1)O)(C)O)=O,,,5,1,1,0,1
46585_0,,,,2,1,1,2
46587_0,,,,2,1,1,2
C1(C(C)(C(CC(O)O1)O)O)=O,,,5,1,1,0,1
46589_0,,,,2,1,1,2
C(C1(C)C(CC(C(O1)O)=O)O)(O)=O,,,5,1,1,0,1
46591_0,,,,2,1,1,2
C1(C(C)(C(CC(C=O)(O)O1)O)O)=O,,,5,1,1,0,1
46593_0,,,,2,1,1,2
C(C1COC(C(C1(C)O)O)O)(O)=O,,,5,1,1,0,1
46595_0,,,,2,1,1,2
C1(C(CO)C(C)(C(C(O)O1)O)O)=O,,,5,1,1,0,1
46597_0,,,,2,1,1,2
C(C1COC(CC1(C)O)O)(O)=O,,,5,1,1,0,1
46599_0,,,,2,1,1,2
C1(C(CO)C(C)(CC(O)O1)O)=O,,,5,1,1,0,1
46601_0,,,,2,1,1,2
C1(C(C)C(C)(C(C=C)C(O)O1)O)=O,,,5,1,1,0,1
46603_0,,,,2,1,1,2
C1(C(C)C(C)(C(C(O)O1)O)O)=O,,,5,1,1,0,1
46605_0,,,,2,1,1,2
C1(C(C)C(C)(CC(O)O1)O)=O,,,5,1,1,0,1
46607_0,,,,2,1,1,2
C1(C(C)C(C)(CC(C=O)(O)O1)O)=O,,,5,1,1,0,1
46609_0,,,,2,1,1,2
C(C(C1C(O)OC([CH]C1)=O)O)=CC,,,5,1,1,0,1
46611_0,,,,2,1,1,2
C1(CCC(C(O)O1)C(C=CC)O)=O,,,5,1,1,0,1
46613_0,,,,2,1,1,2
C=CCC(C1C(O)OC([CH]C1)=O)O,,,5,1,1,0,1
46615_0,,,,2,1,1,2
C1(CCC(C(O)O1)C(CC=C)O)=O,,,5,1,1,0,1
46617_0,,,,2,1,1,2
C=CC1C(O)OCC(C1O)O,,,5,1,1,0,1
46618_0,,,,2,1,1,2
46619_0,,,,2,1,1,2
46620_0,,,,2,1,1,2
46622_0,,,,2,1,1,2
C1(C(C=CC)(CC(C(O)O1)=O)O)=O,,,5,1,1,0,1
46624_0,,,,2,1,1,2
C1(C(CC=C)(CC(C(O)O1)=O)O)=O,,,5,1,1,0,1
46626_0,,,,2,1,1,2
C=CC1C(C(OC(C1(C)O)O)=O)=O,,,5,1,1,0,1
46628_0,,,,2,1,1,2
C=CC1C(C(OC(C)(C1O)O)=O)=O,,,5,1,1,0,1
46630_0,,,,2,1,1,2
C(C1C(C(OC(C1(C)O)O)=O)=C)=O,,,5,1,1,0,1
46632_0,,,,2,1,1,2
C(C1C(C(OC(C)(C1O)O)=O)=C)=O,,,5,1,1,0,1
46634_0,,,,2,1,1,2
C1C(C(C(C(O)O1)O)O)O,,,5,1,1,0,1
46636_0,,,,2,1,1,2
C1C(C(CC(O)O1)O)O,,,5,1,1,0,1
46638_0,,,,2,1,1,2
C1C(C(C(C(O)O1)C(C)O)O)O,,,5,1,1,0,1
46640_0,,,,2,1,1,2
C(C1C(O)OCC(C1O)O)(O)=O,,,5,1,1,0,1
46642_0,,,,2,1,1,2
C1(C(O)OC(CO)C(C1O)O)=O,,,5,1,1,0,1
46644_0,,,,2,1,1,2
C(C1(C(C(C(CO1)O)O)O)O)=O,,,5,1,1,0,1
46646_0,,,,2,1,1,2
C1(C(O)OC(CO)C(C1)O)=O,,,5,1,1,0,1
46648_0,,,,2,1,1,2
C(C1(CC(C(CO1)O)O)O)=O,,,5,1,1,0,1
46649_0,,,,2,1,1,2
46651_0,,,,2,1,1,2
C(C1(CC(C(CO1)O)O)O)(O)=O,,,5,1,1,0,1
46653_0,,,,2,1,1,2
[CH]1C(OC(C(C(CO)O)C1)O)=O,,,5,1,1,0,1
46655_0,,,,2,1,1,2
C1(CCC(C(O)O1)C(CO)O)=O,,,5,1,1,0,1
46657_0,,,,2,1,1,2
C1(C(O)OCC(C1O)O)=O,,,5,1,1,0,1
46659_0,,,,2,1,1,2
C1(C(O)OCC(C1)O)=O,,,5,1,1,0,1
46661_0,,,,2,1,1,2
CC1CC(C(C(O)O1)O)O,,,5,1,1,0,1
46663_0,,,,2,1,1,2
C(C1(C(C(O)OC(C)C1)O)O)(O)=O,,,5,1,1,0,1
46665_0,,,,2,1,1,2
C1(CC(C(C(O)O1)O)O)=O,,,5,1,1,0,1
46667_0,,,,2,1,1,2
C(C1(C)CC(C(C(O1)O)O)O)(O)=O,,,5,1,1,0,1
46669_0,,,,2,1,1,2
C(C1(C(C(O)OC(C1)=O)O)O)(O)=O,,,5,1,1,0,1
46670_0,,,,2,1,1,2
46672_0,,,,2,1,1,2
C(C1(C(C(C)O)C[CH]C(O1)=O)O)=O,,,5,1,1,0,1
46674_0,,,,2,1,1,2
C(C1C[CH]C(OC1(C=O)O)=O)(O)=O,,,5,1,1,0,1
46676_0,,,,2,1,1,2
C(C1(C(CO)C[CH]C(O1)=O)O)=O,,,5,1,1,0,1
46677_0,,,,2,1,1,2
46679_0,,,,2,1,1,2
C1(CCC(C(C)O)C(C=O)(O)O1)=O,,,5,1,1,0,1
46681_0,,,,2,1,1,2
C(C1CCC(OC1(C=O)O)=O)(O)=O,,,5,1,1,0,1
46683_0,,,,2,1,1,2
C1(CCC(CO)C(C=O)(O)O1)=O,,,5,1,1,0,1
46685_0,,,,2,1,1,2
[CH]1C(OC(C(C(C(C)O)O)C1)O)=O,,,5,1,1,0,1
46687_0,,,,2,1,1,2
C(C(C1C(O)OC([CH]C1)=O)O)(O)=O,,,5,1,1,0,1
46689_0,,,,2,1,1,2
C(C(C)(C1C(O)OC([CH]C1)=O)O)=O,,,5,1,1,0,1
46691_0,,,,2,1,1,2
C(C)(C(C1C(O)OC([CH]C1)=O)O)=O,,,5,1,1,0,1
46693_0,,,,2,1,1,2
[CH]1C(OC(C(CO)C1)O)=O,,,5,1,1,0,1
46695_0,,,,2,1,1,2
C(C1(C(CO)C[CH]C(O1)=O)O)(O)=O,,,5,1,1,0,1
46697_0,,,,2,1,1,2
C1(CCC(C(O)O1)C(C(C)O)O)=O,,,5,1,1,0,1
46699_0,,,,2,1,1,2
C1(CCC(C(O)O1)C(C(O)=O)O)=O,,,5,1,1,0,1
46701_0,,,,2,1,1,2
C(C(C)(C1C(O)OC(CC1)=O)O)=O,,,5,1,1,0,1
46703_0,,,,2,1,1,2
C1(CCC(C(O)O1)C(C(C)=O)O)=O,,,5,1,1,0,1
46705_0,,,,2,1,1,2
C1(CCC(CO)C(O)O1)=O,,,5,1,1,0,1
46707_0,,,,2,1,1,2
C1(CCC(CO)C(C(O)=O)(O)O1)=O,,,5,1,1,0,1
46709_0,,,,2,1,1,2
C1(C(O)OC(C)C(C1O)O)=O,,,5,1,1,0,1
46711_0,,,,2,1,1,2
C1(C(O)OC(C)C(C1)O)=O,,,5,1,1,0,1
46712_0,,,,2,1,1,2
46713_0,,,,2,1,1,2
46715_0,,,,2,1,1,2
C1(C(CC(C(CO)(O)O1)O)O)=O,,,5,1,1,0,1
46716_0,,,,2,1,1,2
46718_0,,,,2,1,1,2
C1(C(CC(CO)(C(O)O1)O)O)=O,,,5,1,1,0,1
46719_0,,,,2,1,1,2
46721_0,,,,2,1,1,2
C1(C(CC(C)(C(O)O1)O)O)=O,,,5,1,1,0,1
46723_0,,,,2,1,1,2
C1(C(CC(C(C)(O)O1)O)O)=O,,,5,1,1,0,1
46724_0,,,,2,1,1,2
46725_0,,,,2,1,1,2
46726_0,,,,2,1,1,2
46727_0,,,,2,1,1,2
46728_0,,,,2,1,1,2
46729_0,,,,2,1,1,2
46730_0,,,,2,1,1,2
46732_0,,,,2,1,1,2
C1(C(C)(O)OC(C(C1O)=O)=O)=O,,,5,1,1,0,1
46733_0,,,,2,1,1,2
46735_0,,,,2,1,1,2
C1(C(CO)(O)OC(CC1O)C)=O,,,5,1,1,0,1
46737_0,,,,2,1,1,2
C1(CC(C(C(CO)(O)O1)=O)O)=O,,,5,1,1,0,1
46738_0,,,,2,1,1,2
46740_0,,,,2,1,1,2
C1(C(CO)(OCC(C1O)=O)O)=O,,,5,1,1,0,1
46741_0,,,,2,1,1,2
46742_0,,,,2,1,1,2
46743_0,,,,2,1,1,2
46745_0,,,,2,1,1,2
C1(C(O)OC(C)CC1O)=O,,,5,1,1,0,1
46747_0,,,,2,1,1,2
C1(C(C)(O)OC(CC1O)C)=O,,,5,1,1,0,1
46749_0,,,,2,1,1,2
C1(CC(C(C(O)O1)=O)O)=O,,,5,1,1,0,1
46751_0,,,,2,1,1,2
C1(CC(C(C(C)(O)O1)=O)O)=O,,,5,1,1,0,1
46753_0,,,,2,1,1,2
C1(C(O)OCC(C1O)=O)=O,,,5,1,1,0,1
46755_0,,,,2,1,1,2
C1(C(C)(OCC(C1O)=O)O)=O,,,5,1,1,0,1
46756_0,,,,2,1,1,2
46757_0,,,,2,1,1,2
46758_0,,,,2,1,1,2
46759_0,,,,2,1,1,2
46761_0,,,,2,1,1,2
C1(C(O)OC([CH]C1)=O)=O,,,5,1,1,0,1
46763_0,,,,2,1,1,2
C1(CCC(C(O)O1)=O)=O,,,5,1,1,0,1
46765_0,,,,2,1,1,2
C1(C(CO)(O)OC([CH]C1)=O)=O,,,5,1,1,0,1
46767_0,,,,2,1,1,2
C1(C(C)(O)OC([CH]C1)=O)=O,,,5,1,1,0,1
46769_0,,,,2,1,1,2
C1(CCC(OC1(CO)O)=O)=O,,,5,1,1,0,1
46771_0,,,,2,1,1,2
C1(CCC(OC1(C)O)=O)=O,,,5,1,1,0,1
46772_0,,,,2,1,1,2
46773_0,,,,2,1,1,2
46775_0,,,,2,1,1,2
C1(C(CO)OC(C(C1O)=O)O)=O,,,5,1,1,0,1
46776_0,,,,2,1,1,2
46778_0,,,,2,1,1,2
C1(C(CO)OC(C(C1)=O)O)=O,,,5,1,1,0,1
46779_0,,,,2,1,1,2
46780_0,,,,2,1,1,2
46781_0,,,,2,1,1,2
46782_0,,,,2,1,1,2
46783_0,,,,2,1,1,2
46784_0,,,,2,1,1,2
46786_0,,,,2,1,1,2
C1(C(C)OC(C(C1O)=O)O)=O,,,5,1,1,0,1
46787_0,,,,2,1,1,2
46788_0,,,,2,1,1,2
46789_0,,,,2,1,1,2
46790_0,,,,2,1,1,2
46792_0,,,,2,1,1,2
C1(C(C)OC(C(C1)=O)O)=O,,,5,1,1,0,1
46793_0,,,,2,1,1,2
46794_0,,,,2,1,1,2
46795_0,,,,2,1,1,2
46796_0,,,,2,1,1,2
46797_0,,,,2,1,1,2
46798_0,,,,2,1,1,2
46799_0,,,,2,1,1,2
46801_0,,,,2,1,1,2
CC(C1(C(O)OCCC1O)CO)O,,,5,1,1,0,1
46802_0,,,,2,1,1,2
46804_0,,,,2,1,1,2
C(C1C(CC(OC1C=O)O)O)(O)=O,,,5,1,1,0,1
46805_0,,,,2,1,1,2
46807_0,,,,2,1,1,2
C(C1C(CO)OC(CC1O)O)(O)=O,,,5,1,1,0,1
46809_0,,,,2,1,1,2
C(C1(C(O)OCCC1O)CO)(O)=O,,,5,1,1,0,1
46811_0,,,,2,1,1,2
C(C)(C1(COC(C(C1O)=O)O)O)=O,,,5,1,1,0,1
46813_0,,,,2,1,1,2
C(C1(C(CO)(C(CCO1)O)O)O)=O,,,5,1,1,0,1
46815_0,,,,2,1,1,2
C1(C(O)OCC(C)(C1(CO)O)O)=O,,,5,1,1,0,1
46817_0,,,,2,1,1,2
C1(C(O)OCC(C1(CO)O)O)=O,,,5,1,1,0,1
46819_0,,,,2,1,1,2
C1(C(O)OC(C)C(C1(CO)O)O)=O,,,5,1,1,0,1
46821_0,,,,2,1,1,2
C1(C(O)OC(C(C1(CO)O)O)=O)=O,,,5,1,1,0,1
46823_0,,,,2,1,1,2
C1(C(O)OCC(C1(C(C)O)O)O)=O,,,5,1,1,0,1
46825_0,,,,2,1,1,2
C(C1(C(C(O)OCC1O)=O)O)(O)=O,,,5,1,1,0,1
46827_0,,,,2,1,1,2
C(C1(CCOC(C1(C=O)O)O)O)=O,,,5,1,1,0,1
46829_0,,,,2,1,1,2
C(C1(CCOC(C1(CO)O)O)O)=O,,,5,1,1,0,1
46831_0,,,,2,1,1,2
C(C1(C(O)OCCC1O)O)=O,,,5,1,1,0,1
46833_0,,,,2,1,1,2
C(C1(C(O)OCCC1O)O)(O)=O,,,5,1,1,0,1
46835_0,,,,2,1,1,2
C(C1(C)C(C)(O)OCCC1O)(O)=O,,,5,1,1,0,1
46837_0,,,,2,1,1,2
C1CC(C(C(O)O1)(CO)O)O,,,5,1,1,0,1
46839_0,,,,2,1,1,2
C(C1[C](C(OC(C1O)O)=O)O)(O)=O,,,5,1,1,0,1
46841_0,,,,2,1,1,2
C(C1C(C(O)OC(C1O)=O)O)(O)=O,,,5,1,1,0,1
46843_0,,,,2,1,1,2
C(C1(C(O)OC(C(C1O)O)=O)O)=O,,,5,1,1,0,1
46845_0,,,,2,1,1,2
C(C1(C(O)OCC(C1O)O)O)=O,,,5,1,1,0,1
46847_0,,,,2,1,1,2
C(C1(C(O)OC(C)CC1O)O)=O,,,5,1,1,0,1
46849_0,,,,2,1,1,2
C(C1(C(O)OC(CC1O)=O)O)=O,,,5,1,1,0,1
46851_0,,,,2,1,1,2
C(C1(C(OCC(C1O)=O)O)O)=O,,,5,1,1,0,1
46853_0,,,,2,1,1,2
C1(C(C=O)(C(C(C(O)O1)O)O)O)=O,,,5,1,1,0,1
46854_0,,,,2,1,1,2
46856_0,,,,2,1,1,2
C(C1(C(O)OCC(C1O)O)O)(O)=O,,,5,1,1,0,1
46858_0,,,,2,1,1,2
C(C1(C(O)OC(C)CC1O)O)(O)=O,,,5,1,1,0,1
46860_0,,,,2,1,1,2
C(C1(C(O)OC(CC1O)=O)O)(O)=O,,,5,1,1,0,1
46862_0,,,,2,1,1,2
C(C1(C(OCC(C1O)=O)O)O)(O)=O,,,5,1,1,0,1
46864_0,,,,2,1,1,2
C1C(C(C(C(O)O1)(CO)O)O)O,,,5,1,1,0,1
46866_0,,,,2,1,1,2
CC1CC(C(C(O)O1)(CO)O)O,,,5,1,1,0,1
46868_0,,,,2,1,1,2
C1(CC(C(CO)(C(O)O1)O)O)=O,,,5,1,1,0,1
46870_0,,,,2,1,1,2
[CH]1C(OC(C(CO)(C(C)O)C1)O)=O,,,5,1,1,0,1
46872_0,,,,2,1,1,2
C1(CCC(CO)(C(O)O1)C(C)O)=O,,,5,1,1,0,1
46873_0,,,,2,1,1,2
46874_0,,,,2,1,1,2
46876_0,,,,2,1,1,2
CC1(C(O)OC(C)C(CO)C1O)O,,,5,1,1,0,1
46878_0,,,,2,1,1,2
CC1(C(O)OCC(C(C)O)C1O)O,,,5,1,1,0,1
46880_0,,,,2,1,1,2
C1(C(CO)C(C(C)(C(O)O1)O)O)=O,,,5,1,1,0,1
46882_0,,,,2,1,1,2
C(C1COC(C(C)(C1O)O)O)(O)=O,,,5,1,1,0,1
46883_0,,,,2,1,1,2
46885_0,,,,2,1,1,2
C(CO)(C1(COC(C(C1)=O)O)O)=O,,,5,1,1,0,1
46887_0,,,,2,1,1,2
C1(COC(C(C1(CC=O)O)O)O)=O,,,5,1,1,0,1
46888_0,,,,2,1,1,2
46890_0,,,,2,1,1,2
C(CO)(C1(C(COC(C1)O)O)O)=O,,,5,1,1,0,1
46891_0,,,,2,1,1,2
46892_0,,,,2,1,1,2
46894_0,,,,2,1,1,2
C1(C(CO)OC(C(C)(C1O)O)O)=O,,,5,1,1,0,1
46896_0,,,,2,1,1,2
C(C1(C(COC(C1(C)O)O)O)O)=O,,,5,1,1,0,1
46898_0,,,,2,1,1,2
C(C1(C)C(CC(C)(C(O1)O)O)O)=O,,,5,1,1,0,1
46900_0,,,,2,1,1,2
C(C1(C)CC(C(C)(C(O1)O)O)O)=O,,,5,1,1,0,1
46902_0,,,,2,1,1,2
C(C1C(CC(C)(C(O1)O)O)O)(O)=O,,,5,1,1,0,1
46904_0,,,,2,1,1,2
C(C1(C)C(C(C)(CC(O1)O)O)O)=O,,,5,1,1,0,1
46906_0,,,,2,1,1,2
C(C)(C1(COC(C(C1)=O)O)O)=O,,,5,1,1,0,1
46908_0,,,,2,1,1,2
C(CC1(C(CCOC1(C)O)O)O)=O,,,5,1,1,0,1
46910_0,,,,2,1,1,2
C(C)(C1(CC(O)OCC1(C)O)O)=O,,,5,1,1,0,1
46912_0,,,,2,1,1,2
C(C)(C1(C(COC(C1)O)O)O)=O,,,5,1,1,0,1
46914_0,,,,2,1,1,2
C(C)(C1(CC(O)OC(C)C1O)O)=O,,,5,1,1,0,1
46916_0,,,,2,1,1,2
C(C)(C1(CC(O)OC(C1O)=O)O)=O,,,5,1,1,0,1
46918_0,,,,2,1,1,2
C(C1(C)C(CC(C(C)(O1)O)O)O)=O,,,5,1,1,0,1
46920_0,,,,2,1,1,2
C(C)(C1CC(C(C)(C(O1)O)O)O)=O,,,5,1,1,0,1
46922_0,,,,2,1,1,2
C(C1C(CC(C(C)(O1)O)O)O)(O)=O,,,5,1,1,0,1
46924_0,,,,2,1,1,2
C(C1(C)C(C)(C(CC(O1)O)O)O)=O,,,5,1,1,0,1
46926_0,,,,2,1,1,2
C1(C(CC(CO)(C(C)(O)O1)O)=O)=O,,,5,1,1,0,1
46928_0,,,,2,1,1,2
C(C1(CCOC(C1(C)O)O)O)=O,,,5,1,1,0,1
46930_0,,,,2,1,1,2
C(C1(CC(C)OC(C1(C)O)O)O)=O,,,5,1,1,0,1
46932_0,,,,2,1,1,2
C(C1(C(C)(C(O)OC(C1)=O)O)O)=O,,,5,1,1,0,1
46934_0,,,,2,1,1,2
C(C)(C1(C(C)(C(CCO1)O)O)O)=O,,,5,1,1,0,1
46936_0,,,,2,1,1,2
CC1(C(O)OCCC1O)O,,,5,1,1,0,1
46938_0,,,,2,1,1,2
C(C1(CCOC(C1(C)O)O)O)(O)=O,,,5,1,1,0,1
46940_0,,,,2,1,1,2
C1(C(C)(C(C=O)(C)OC(C1)O)O)=O,,,5,1,1,0,1
46942_0,,,,2,1,1,2
C1(C(C)(C(C(O)=O)OC(C1)O)O)=O,,,5,1,1,0,1
46944_0,,,,2,1,1,2
C(C1(C(CC(C(C)(O1)O)=O)O)C)=O,,,5,1,1,0,1
46946_0,,,,2,1,1,2
C(C1C(CC(C(C)(O1)O)=O)O)(O)=O,,,5,1,1,0,1
46948_0,,,,2,1,1,2
C1(C(C(CC(C(C)=O)(O)O1)O)O)=O,,,5,1,1,0,1
46950_0,,,,2,1,1,2
C1(C(CO)(O)OCC(C1(C)O)O)=O,,,5,1,1,0,1
46952_0,,,,2,1,1,2
C1(C(C)(O)OCC(C)(C1(C)O)O)=O,,,5,1,1,0,1
46954_0,,,,2,1,1,2
C1(C(C)(O)OCC(C1(C)O)O)=O,,,5,1,1,0,1
46956_0,,,,2,1,1,2
C1(C(C)(O)OC(C)C(C1(C)O)O)=O,,,5,1,1,0,1
46958_0,,,,2,1,1,2
C1(C(C)(O)OC(C(C1(C)O)O)=O)=O,,,5,1,1,0,1
46960_0,,,,2,1,1,2
C1(C(C)OC(C(C)(C1(C)O)O)O)=O,,,5,1,1,0,1
46962_0,,,,2,1,1,2
C1(C(C(C)(C(C)(C(O)O1)O)O)=O)=O,,,5,1,1,0,1
46964_0,,,,2,1,1,2
C(C1(COC(C(C1)=O)(C)O)O)(O)=O,,,5,1,1,0,1
46965_0,,,,2,1,1,2
46967_0,,,,2,1,1,2
C1(C(C)(C(C(C)(C(O)O1)O)O)O)=O,,,5,1,1,0,1
46969_0,,,,2,1,1,2
C1(C(C)C(C)(C(C)(C(O)O1)O)O)=O,,,5,1,1,0,1
46971_0,,,,2,1,1,2
CC1(C(O)OCC(C1O)O)O,,,5,1,1,0,1
46973_0,,,,2,1,1,2
C(C1(C(CO)(C[CH]C(O1)=O)O)O)=O,,,5,1,1,0,1
46975_0,,,,2,1,1,2
C1(CCC(CO)(C(C=O)(O)O1)O)=O,,,5,1,1,0,1
46977_0,,,,2,1,1,2
CC1(C(O)OC(C)CC1O)O,,,5,1,1,0,1
46979_0,,,,2,1,1,2
C1(CC(C(C)(C(O)O1)O)O)=O,,,5,1,1,0,1
46980_0,,,,2,1,1,2
46981_0,,,,2,1,1,2
46982_0,,,,2,1,1,2
46983_0,,,,2,1,1,2
46984_0,,,,2,1,1,2
46985_0,,,,2,1,1,2
46986_0,,,,2,1,1,2
46987_0,,,,2,1,1,2
46988_0,,,,2,1,1,2
46989_0,,,,2,1,1,2
46990_0,,,,2,1,1,2
46991_0,,,,2,1,1,2
46992_0,,,,2,1,1,2
46993_0,,,,2,1,1,2
46994_0,,,,2,1,1,2
46995_0,,,,2,1,1,2
46996_0,,,,2,1,1,2
46997_0,,,,2,1,1,2
46998_0,,,,2,1,1,2
46999_0,,,,2,1,1,2
47000_0,,,,2,1,1,2
47002_0,,,,2,1,1,2
C(C1C(O)OC(C(C1)=O)=O)(O)=O,,,5,1,1,0,1
47003_0,,,,2,1,1,2
47004_0,,,,2,1,1,2
47005_0,,,,2,1,1,2
47006_0,,,,2,1,1,2
47007_0,,,,2,1,1,2
47008_0,,,,2,1,1,2
47009_0,,,,2,1,1,2
47010_0,,,,2,1,1,2
47011_0,,,,2,1,1,2
47012_0,,,,2,1,1,2
47013_0,,,,2,1,1,2
47014_0,,,,2,1,1,2
47015_0,,,,2,1,1,2
47016_0,,,,2,1,1,2
47017_0,,,,2,1,1,2
47018_0,,,,2,1,1,2
47019_0,,,,2,1,1,2
47020_0,,,,2,1,1,2
47021_0,,,,2,1,1,2
47022_0,,,,2,1,1,2
47023_0,,,,2,1,1,2
47024_0,,,,2,1,1,2
47025_0,,,,2,1,1,2
47026_0,,,,2,1,1,2
47027_0,,,,2,1,1,2
47028_0,,,,2,1,1,2
47029_0,,,,2,1,1,2
47030_0,,,,2,1,1,2
47032_0,,,,2,1,1,2
C1(C2(C(C(C(CO2)(O)O1)O)O)O)=O,,,5,1,2,0,2
47033_0,,,,2,1,1,2
47035_0,,,,2,1,1,2
C1(C2(CC(C(CO2)(O)O1)O)O)=O,,,5,1,2,0,2
47036_0,,,,2,1,1,2
47038_0,,,,2,1,1,2
C1(C2OC(C(CO2)(C1O)O)O)=O,,,5,1,1,0,1
47040_0,,,,2,1,1,2
C1(C2OC(C(CO2)(C1)O)O)=O,,,5,1,1,0,1
47042_0,,,,2,1,1,2
C1(CC2(C(OC1(CCO2)O)=O)O)=O,,,5,1,2,0,2
47044_0,,,,2,1,1,2
[CH]1C(OC(C(C1)O)O)=O,,,5,1,1,0,1
47046_0,,,,2,1,1,2
C1(CCC(C(O)O1)O)=O,,,5,1,1,0,1
47048_0,,,,2,1,1,2
C1(C2(C(C(CC(C)O2)O1)O)O)=O,,,5,1,2,0,2
47050_0,,,,2,1,1,2
C1(C2(CC(CC(C)O2)O1)O)=O,,,5,1,2,0,2
47052_0,,,,2,1,1,2
C1(CC2C(C(C(O2)=O)(O)O1)O)=O,,,5,1,2,0,2
47054_0,,,,2,1,1,2
C1(CC2CC(C(O2)=O)(O)O1)=O,,,5,1,2,0,2
47056_0,,,,2,1,1,2
C1(C2(C)CC(CC(O2)O)O1)=O,,,5,1,2,0,2
47058_0,,,,2,1,1,2
C1(C2(C(C(C(CO2)=O)O1)O)O)=O,,,5,1,2,0,2
47060_0,,,,2,1,1,2
C1(C2(CC(C(CO2)=O)O1)O)=O,,,5,1,2,0,2
47062_0,,,,2,1,1,2
C1(CC2(C(OC1CO2)=O)O)=O,,,5,1,2,0,2
47064_0,,,,2,1,1,2
C(C1(CO)C(C)OC(CC1C)O)=O,,,5,1,1,0,1
47066_0,,,,2,1,1,2
C(C1(COC(CC1C)O)C(C)O)=O,,,5,1,1,0,1
47068_0,,,,2,1,1,2
C(C(CO)C1CC(C)CC(O)O1)=O,,,5,1,1,0,1
47070_0,,,,2,1,1,2
C1(C(C=O)(CO)C(C)CC(O)O1)=O,,,5,1,1,0,1
47072_0,,,,2,1,1,2
C(C1(C=O)COC(CC1C)O)(O)=O,,,5,1,1,0,1
47074_0,,,,2,1,1,2
C(C(C1C(C(C)CC(O1)O)O)=O)=O,,,5,1,1,0,1
47076_0,,,,2,1,1,2
C(C(C1(COC(CC1C)O)O)=O)=O,,,5,1,1,0,1
47078_0,,,,2,1,1,2
C(C1C(C)CC(OC1(C=O)C)O)=O,,,5,1,1,0,1
47080_0,,,,2,1,1,2
C(C1(CC(C)CC(O1)O)CC=O)=O,,,5,1,1,0,1
47082_0,,,,2,1,1,2
C(C1C(C)CC(OC1C(C)=O)O)=O,,,5,1,1,0,1
47084_0,,,,2,1,1,2
C(CC1(C(C)(O)OC([CH]C1)=O)O)=O,,,5,1,1,0,1
47086_0,,,,2,1,1,2
C1(CCC(C(C)(O)O1)(CC=O)O)=O,,,5,1,1,0,1
47088_0,,,,2,1,1,2
C(C(C1COC(CC1C)O)=O)=O,,,5,1,1,0,1
47090_0,,,,2,1,1,2
C(C(CC1CC(C)CC(O)O1)=O)=O,,,5,1,1,0,1
47092_0,,,,2,1,1,2
C(C(C1C(C)OC(CC1C)O)=O)=O,,,5,1,1,0,1
47094_0,,,,2,1,1,2
C1(C(C(C=O)=O)C(C)CC(O)O1)=O,,,5,1,1,0,1
47096_0,,,,2,1,1,2
C(C1COC(CC1C)O)=O,,,5,1,1,0,1
47098_0,,,,2,1,1,2
C(C1COC(C(O)=O)(CC1C)O)=O,,,5,1,1,0,1
47100_0,,,,2,1,1,2
C1(C(CC(CO)C(O)O1)CC=O)=O,,,5,1,1,0,1
47102_0,,,,2,1,1,2
C(C1(C)CC(O)OCC1C=O)(O)=O,,,5,1,1,0,1
47104_0,,,,2,1,1,2
C1(C(C)C(C=O)C(CO)C(O)O1)=O,,,5,1,1,0,1
47106_0,,,,2,1,1,2
C(C1C(C)OC(C(C1)CO)O)(O)=O,,,5,1,1,0,1
47108_0,,,,2,1,1,2
C1(C(CC(CO)C(O)O1)C(C)O)=O,,,5,1,1,0,1
47110_0,,,,2,1,1,2
C1(C(C(O)=O)CC(C(O)O1)CO)=O,,,5,1,1,0,1
47112_0,,,,2,1,1,2
C(C1CC(CC=O)OC(C1)O)(O)=O,,,5,1,1,0,1
47114_0,,,,2,1,1,2
C1(C(C)(C(CC(O)O1)O)CC=O)=O,,,5,1,1,0,1
47116_0,,,,2,1,1,2
C(C(C1COC(CC1C)O)=O)(O)=O,,,5,1,1,0,1
47118_0,,,,2,1,1,2
C(CC(C1(CC[CH]C(O1)=O)O)=O)=O,,,5,1,1,0,1
47120_0,,,,2,1,1,2
C1(CCCC(C(CC=O)=O)(O)O1)=O,,,5,1,1,0,1
47122_0,,,,2,1,1,2
C(C1C[CH]C(OC1(C(C)=O)O)=O)=O,,,5,1,1,0,1
47124_0,,,,2,1,1,2
[CH]1C(OC(C(C(C(C)=O)=O)C1)O)=O,,,5,1,1,0,1
47126_0,,,,2,1,1,2
C1(CCC(C=O)C(C(C)=O)(O)O1)=O,,,5,1,1,0,1
47128_0,,,,2,1,1,2
C1(CCC(C(C(C)=O)=O)C(O)O1)=O,,,5,1,1,0,1
47130_0,,,,2,1,1,2
C(C1(CC[CH]C(O1)=O)O)(C(C)O)=O,,,5,1,1,0,1
47132_0,,,,2,1,1,2
C1(CCCC(C(C(C)O)=O)(O)O1)=O,,,5,1,1,0,1
47134_0,,,,2,1,1,2
C(C(C)=O)(C1CC(C)CC(O1)O)=O,,,5,1,1,0,1
47136_0,,,,2,1,1,2
C(C)(C1(C(C)(C[CH]C(O1)=O)O)O)=O,,,5,1,1,0,1
47138_0,,,,2,1,1,2
C1(CCC(C)(C(C(C)=O)(O)O1)O)=O,,,5,1,1,0,1
47140_0,,,,2,1,1,2
[CH]1C(OC(C(C(O)=O)=O)(CC1)O)=O,,,5,1,1,0,1
47142_0,,,,2,1,1,2
C1(CCCC(C(C(O)=O)=O)(O)O1)=O,,,5,1,1,0,1
47144_0,,,,2,1,1,2
C(C1(C(O)OC([CH]C1)=O)O)=O,,,5,1,1,0,1
47146_0,,,,2,1,1,2
C(C1(C(O)OC(CC1)=O)O)=O,,,5,1,1,0,1
47148_0,,,,2,1,1,2
C1(C(C=O)(C(C)CC(O)O1)O)=O,,,5,1,1,0,1
47150_0,,,,2,1,1,2
C(C1(C(O)OC([CH]C1)=O)O)(O)=O,,,5,1,1,0,1
47152_0,,,,2,1,1,2
C(C1(C(O)OC(CC1)=O)O)(O)=O,,,5,1,1,0,1
47154_0,,,,2,1,1,2
CC1CC(O)OCC1C(C)O,,,5,1,1,0,1
47156_0,,,,2,1,1,2
CC1CC(O)OC(C)C1CO,,,5,1,1,0,1
47158_0,,,,2,1,1,2
CC1CC(CCO)OC(C1)O,,,5,1,1,0,1
47160_0,,,,2,1,1,2
C(C1COC(CC1C)O)(O)=O,,,5,1,1,0,1
47162_0,,,,2,1,1,2
C1(C(CO)C(C)CC(O)O1)=O,,,5,1,1,0,1
47164_0,,,,2,1,1,2
C1(C(CCC(CO)(O)O1)CC=O)=O,,,5,1,1,0,1
47166_0,,,,2,1,1,2
C1(C(C)C(C=O)CC(CO)(O)O1)=O,,,5,1,1,0,1
47168_0,,,,2,1,1,2
C(C(C)C1C(OCC(C1)=O)O)(O)=O,,,5,1,1,0,1
47170_0,,,,2,1,1,2
C(C1C(C)OC(CO)(CC1)O)(O)=O,,,5,1,1,0,1
47172_0,,,,2,1,1,2
C1(C(CCC(CO)(O)O1)C(C)O)=O,,,5,1,1,0,1
47174_0,,,,2,1,1,2
C1(C(C(O)=O)CCC(CO)(O)O1)=O,,,5,1,1,0,1
47176_0,,,,2,1,1,2
C1(C(CC(C(C)(O)O1)O)CC=O)=O,,,5,1,1,0,1
47178_0,,,,2,1,1,2
C(C1CC(C(C)=O)OC(C1)O)(O)=O,,,5,1,1,0,1
47180_0,,,,2,1,1,2
C1(C(C)C(C=O)C(C(C)(O)O1)O)=O,,,5,1,1,0,1
47182_0,,,,2,1,1,2
C(C1C(C)OC(C)(C(C1)O)O)(O)=O,,,5,1,1,0,1
47184_0,,,,2,1,1,2
C1(C(CC(C(C)(O)O1)O)C(C)O)=O,,,5,1,1,0,1
47186_0,,,,2,1,1,2
C1(C(C(O)=O)CC(C(C)(O)O1)O)=O,,,5,1,1,0,1
47188_0,,,,2,1,1,2
[CH]1C(OC(C)(C(C1)O)O)=O,,,5,1,1,0,1
47190_0,,,,2,1,1,2
C1(CCC(C(C)(O)O1)O)=O,,,5,1,1,0,1
47192_0,,,,2,1,1,2
C(C1CCOC(C1)O)(O)=O,,,5,1,1,0,1
47194_0,,,,2,1,1,2
C1(C2CC(C(O1)=O)(O)OCC2)=O,,,5,1,1,0,1
47196_0,,,,2,1,1,2
C(C1CC(C(O)=O)(O)OCC1)(O)=O,,,5,1,1,0,1
47198_0,,,,2,1,1,2
CC1CCOC(C1)O,,,5,1,1,0,1
47200_0,,,,2,1,1,2
C(C1(CC(C)CCO1)O)(O)=O,,,5,1,1,0,1
47202_0,,,,2,1,1,2
C(C1(C)CCOC(C1)O)(O)=O,,,5,1,1,0,1
47204_0,,,,2,1,1,2
C1(C2(C)CC(C(O1)=O)(O)OCC2)=O,,,5,1,1,0,1
47206_0,,,,2,1,1,2
C(C1CC(O)OC(C)C1)(O)=O,,,5,1,1,0,1
47208_0,,,,2,1,1,2
C1(C2CC(C(O1)=O)(O)OC(C)C2)=O,,,5,1,1,0,1
47210_0,,,,2,1,1,2
C1(C(C(C)O)C(C)CC(O)O1)=O,,,5,1,1,0,1
47212_0,,,,2,1,1,2
C(C1C(C)OC(CC1C)O)(O)=O,,,5,1,1,0,1
47214_0,,,,2,1,1,2
C(CC1CC(C)CC(O)O1)(O)=O,,,5,1,1,0,1
47216_0,,,,2,1,1,2
C1(C(C(O)=O)C(C)CC(O)O1)=O,,,5,1,1,0,1
47218_0,,,,2,1,1,2
C1(CC(C)CC(O)O1)=O,,,5,1,1,0,1
47220_0,,,,2,1,1,2
C1(CC(C)CC(C(O)=O)(O)O1)=O,,,5,1,1,0,1
47222_0,,,,2,1,1,2
C(C1(C)CC(O)OC(C1)=O)(O)=O,,,5,1,1,0,1
47224_0,,,,2,1,1,2
C(C1(CO)CC(C)CC(O1)O)(O)=O,,,5,1,1,0,1
47226_0,,,,2,1,1,2
C(C1(C)C(C(C)CC(O1)O)O)(O)=O,,,5,1,1,0,1
47228_0,,,,2,1,1,2
C(C(C1CC(C)CC(O)O1)O)(O)=O,,,5,1,1,0,1
47230_0,,,,2,1,1,2
C(C1C(C)(C(C)CC(O1)O)O)(O)=O,,,5,1,1,0,1
47232_0,,,,2,1,1,2
C(C1(C(C)OC(CC1C)O)O)(O)=O,,,5,1,1,0,1
47234_0,,,,2,1,1,2
C1(C(C(C)O)(C(C)CC(O)O1)O)=O,,,5,1,1,0,1
47236_0,,,,2,1,1,2
C1(C(C(O)=O)(C(C)CC(O)O1)O)=O,,,5,1,1,0,1
47238_0,,,,2,1,1,2
C(C1(C=O)CC(C)CC(O1)O)(O)=O,,,5,1,1,0,1
47240_0,,,,2,1,1,2
C1(C(C(C)=O)(C)C(C)CC(O)O1)=O,,,5,1,1,0,1
47242_0,,,,2,1,1,2
C(C1(C)C(C)(O)OC([CH]C1)=O)(O)=O,,,5,1,1,0,1
47244_0,,,,2,1,1,2
C(C1(C)CCC(OC1(C)O)=O)(O)=O,,,5,1,1,0,1
47246_0,,,,2,1,1,2
C(C(C)C1(CC[CH]C(O1)=O)O)(O)=O,,,5,1,1,0,1
47248_0,,,,2,1,1,2
C(C(C)C1(CCCC(O1)=O)O)(O)=O,,,5,1,1,0,1
47250_0,,,,2,1,1,2
C=C(C(O)=O)C1CC(C)CC(O1)O,,,5,1,1,0,1
47252_0,,,,2,1,1,2
C(C1(C=C)CC(C)CC(O1)O)(O)=O,,,5,1,1,0,1
47254_0,,,,2,1,1,2
C1C(C(C)O)(C(C)CC(O)O1)O,,,5,1,1,0,1
47256_0,,,,2,1,1,2
CC1CC(O)OC(C)C1(CO)O,,,5,1,1,0,1
47258_0,,,,2,1,1,2
CC(C1C(C(C)CC(O)O1)O)O,,,5,1,1,0,1
47260_0,,,,2,1,1,2
CC1CC(C(CO)O)OC(C1)O,,,5,1,1,0,1
47262_0,,,,2,1,1,2
CC1(C(CO)OC(CC1C)O)O,,,5,1,1,0,1
47264_0,,,,2,1,1,2
C(C1C(C(C)CC(O1)O)O)=O,,,5,1,1,0,1
47266_0,,,,2,1,1,2
C(C1(COC(CC1C)O)O)=O,,,5,1,1,0,1
47268_0,,,,2,1,1,2
[C]1(C(O)=O)COC(CC1C)O,,,5,1,1,0,1
47270_0,,,,2,1,1,2
[C]1(C(OC(CC1C)O)=O)CO,,,5,1,1,0,1
47272_0,,,,2,1,1,2
C(CC(C)C1C(O)OC([CH]C1)=O)=O,,,5,1,2,0,2
47274_0,,,,2,1,1,2
C(CC(C)C1[CH]C(OC(C1)O)=O)=O,,,5,1,2,0,2
47276_0,,,,2,1,1,2
C(CC([C]1C(OC(CC1)O)=O)C)=O,,,5,1,2,0,2
47278_0,,,,2,1,1,2
C(CC[C]1C(OC(CC1C)O)=O)=O,,,5,1,1,0,1
47280_0,,,,2,1,1,2
C1(CCC(C(O)O1)C(C)CC=O)=O,,,5,1,2,0,2
47282_0,,,,2,1,1,2
C1(CC(CC(O)O1)C(C)CC=O)=O,,,5,1,2,0,2
47284_0,,,,2,1,1,2
C1(C(CCC(O)O1)C(C)CC=O)=O,,,5,1,2,0,2
47286_0,,,,2,1,1,2
C1(C(CCC=O)C(C)CC(O)O1)=O,,,5,1,1,0,1
47288_0,,,,2,1,1,2
[C]1(C(O)=O)C(C(C)CC(O)O1)O,,,5,1,1,0,1
47290_0,,,,2,1,1,2
C(C1CC(C)CC(O1)O)=O,,,5,1,1,0,1
47292_0,,,,2,1,1,2
C(C1C(C(C)CC(O1)O)O)(O)=O,,,5,1,1,0,1
47294_0,,,,2,1,1,2
C(C1(COC(CC1C)O)O)(O)=O,,,5,1,1,0,1
47296_0,,,,2,1,1,2
C1(C(CO)(C(C)CC(O)O1)O)=O,,,5,1,1,0,1
47298_0,,,,2,1,1,2
[C]1(C(O)=O)CC(C)CC(O)O1,,,5,1,1,0,1
47300_0,,,,2,1,1,2
C(C1CC(C)CC(O1)O)(O)=O,,,5,1,1,0,1
47302_0,,,,2,1,1,2
C1(C(C)(C(C)CC(O)O1)O)=O,,,5,1,1,0,1
47304_0,,,,2,1,1,2
C(C1C(C)OC(CC1C)O)=O,,,5,1,1,0,1
47306_0,,,,2,1,1,2
C(CC1CC(C)CC(O)O1)=O,,,5,1,1,0,1
47308_0,,,,2,1,1,2
C1(C(C=O)C(C)CC(O)O1)=O,,,5,1,1,0,1
47310_0,,,,2,1,1,2
C1(C(C(C)CC(O)O1)O)=O,,,5,1,1,0,1
47312_0,,,,2,1,1,2
C1C(C(C)CC(O)O1)O,,,5,1,1,0,1
47314_0,,,,2,1,1,2
C1(C(CC(C=C)C(O)O1)CC=O)=O,,,5,1,1,0,1
47316_0,,,,2,1,1,2
C1(C(C)C(C=O)C(C=C)C(O)O1)=O,,,5,1,1,0,1
47318_0,,,,2,1,1,2
C(C1CC(C=C)C(O)OC1C)(O)=O,,,5,1,1,0,1
47320_0,,,,2,1,1,2
C1(C(CC(C=C)C(O)O1)C(C)O)=O,,,5,1,1,0,1
47322_0,,,,2,1,1,2
C1(C(C(O)=O)CC(C=C)C(O)O1)=O,,,5,1,1,0,1
47324_0,,,,2,1,1,2
C(C1CC(C)CC(C(O)=O)(O1)O)=O,,,5,1,1,0,1
47326_0,,,,2,1,1,2
C1(C(C(C)CC(C(O)=O)(O)O1)O)=O,,,5,1,1,0,1
47328_0,,,,2,1,1,2
C(C1(CC(C)C(CO1)O)O)(O)=O,,,5,1,1,0,1
47330_0,,,,2,1,1,2
C(C1(C(C=C)C[CH]C(O1)=O)O)(O)=O,,,5,1,1,0,1
47332_0,,,,2,1,1,2
C1(CCC(C=C)C(C(O)=O)(O)O1)=O,,,5,1,1,0,1
47334_0,,,,2,1,1,2
C=C(C(O)=O)C1C(O)OC([CH]C1)=O,,,5,1,1,0,1
47336_0,,,,2,1,1,2
C1(CCC(C(C(O)=O)=C)C(O)O1)=O,,,5,1,1,0,1
47338_0,,,,2,1,1,2
C(C1CC(C=O)OC(C1)O)(O)=O,,,5,1,1,0,1
47340_0,,,,2,1,1,2
C1(C(CC(C(O)O1)O)CC=O)=O,,,5,1,1,0,1
47342_0,,,,2,1,1,2
C(C1CC(C=O)(C)OC(C1)O)(O)=O,,,5,1,1,0,1
47344_0,,,,2,1,1,2
C1(C(CC(C)(C(O)O1)O)CC=O)=O,,,5,1,1,0,1
47346_0,,,,2,1,1,2
C1(C(CCC(O)O1)CC=O)=O,,,5,1,1,0,1
47348_0,,,,2,1,1,2
C1(C(CCC(C=O)(O)O1)CC=O)=O,,,5,1,1,0,1
47350_0,,,,2,1,1,2
C(C1CC(C(O)=O)OC(C1)O)(O)=O,,,5,1,1,0,1
47352_0,,,,2,1,1,2
C(C1CC(O)OC(C1)CO)(O)=O,,,5,1,1,0,1
47354_0,,,,2,1,1,2
C(C1(C)CC(C=O)OC(C1)O)(O)=O,,,5,1,1,0,1
47356_0,,,,2,1,1,2
C1(C(C)(CC(C(O)O1)O)CC=O)=O,,,5,1,1,0,1
47358_0,,,,2,1,1,2
C1(C(C)(CC=O)CC(C(O)O1)=O)=O,,,5,1,1,0,1
47360_0,,,,2,1,1,2
C(C1(C)CC(O)OC(C1O)=O)(O)=O,,,5,1,1,0,1
47362_0,,,,2,1,1,2
C(C1(C)CC(O)OCC1O)(O)=O,,,5,1,1,0,1
47364_0,,,,2,1,1,2
C1(C(C)C(C=O)C(C(O)O1)O)=O,,,5,1,1,0,1
47366_0,,,,2,1,1,2
C1(C(C)C(C=O)C(C)(C(O)O1)O)=O,,,5,1,1,0,1
47368_0,,,,2,1,1,2
C1(C(C)C(C=O)CC(O)O1)=O,,,5,1,1,0,1
47370_0,,,,2,1,1,2
C1(C(C)C(C=O)CC(C=O)(O)O1)=O,,,5,1,1,0,1
47372_0,,,,2,1,1,2
C(C1C(C)OC(C(C1)O)O)(O)=O,,,5,1,1,0,1
47374_0,,,,2,1,1,2
C1(C(CC(C(O)O1)O)C(C)O)=O,,,5,1,1,0,1
47376_0,,,,2,1,1,2
C(C1C(C)OC(C(C)(C1)O)O)(O)=O,,,5,1,1,0,1
47378_0,,,,2,1,1,2
C1(C(CC(C)(C(O)O1)O)C(C)O)=O,,,5,1,1,0,1
47380_0,,,,2,1,1,2
C(C1C(C)OC(CC1)O)(O)=O,,,5,1,1,0,1
47382_0,,,,2,1,1,2
C1(C(CCC(O)O1)C(C)O)=O,,,5,1,1,0,1
47384_0,,,,2,1,1,2
C(C1C(C)OC(C=O)(CC1)O)(O)=O,,,5,1,1,0,1
47386_0,,,,2,1,1,2
C1(C(C(C)O)CCC(C=O)(O)O1)=O,,,5,1,1,0,1
47388_0,,,,2,1,1,2
C1(C(C(O)=O)CC(C(O)O1)O)=O,,,5,1,1,0,1
47390_0,,,,2,1,1,2
C1(C(C(O)=O)CC(C)(C(O)O1)O)=O,,,5,1,1,0,1
47392_0,,,,2,1,1,2
C1(C(C(O)=O)CCC(O)O1)=O,,,5,1,1,0,1
47394_0,,,,2,1,1,2
C(C1C(OC(C=O)(CC1)O)=O)(O)=O,,,5,1,1,0,1
47396_0,,,,2,1,1,2
[CH]1C(OC(C(CO)(C1)O)O)=O,,,5,1,1,0,1
47398_0,,,,2,1,1,2
C1(CCC(CO)(C(O)O1)O)=O,,,5,1,1,0,1
47400_0,,,,2,1,1,2
C1(C2(C(C(C)O1)C[CH]C(O2)=O)O)=O,,,5,1,1,0,1
47402_0,,,,2,1,1,2
C1(CCC2C(C)OC(C2(O)O1)=O)=O,,,5,1,1,0,1
47404_0,,,,2,1,1,2
C1(C2(C(C(O1)=O)C[CH]C(O2)=O)O)=O,,,5,1,1,0,1
47406_0,,,,2,1,1,2
C1(C2CCC(OC2(C(O1)=O)O)=O)=O,,,5,1,1,0,1
47408_0,,,,2,1,1,2
[CH](C(O)=O)CC1C(O)OC([CH]C1)=O,,,5,1,2,0,2
47410_0,,,,2,1,1,2
C1(CCC(C(O)O1)C[CH]C(O)=O)=O,,,5,1,2,0,2
47412_0,,,,2,1,1,2
C(CCC1C(O)OC([CH]C1)=O)(O)=O,,,5,1,2,0,2
47414_0,,,,2,1,1,2
[CH]1C(OC(CC1C[CH]C(O)=O)O)=O,,,5,1,2,0,2
47416_0,,,,2,1,1,2
C(CCC1[CH]C(OC(C1)O)=O)(O)=O,,,5,1,2,0,2
47418_0,,,,2,1,1,2
[CH](C(O)=O)C[C]1C(OC(CC1)O)=O,,,5,1,2,0,2
47420_0,,,,2,1,1,2
C(CC[C]1C(OC(CC1)O)=O)(O)=O,,,5,1,2,0,2
47422_0,,,,2,1,1,2
C1(CCC(CCC(O)=O)C(O)O1)=O,,,5,1,2,0,2
47424_0,,,,2,1,1,2
C1(CC(CC(O)O1)C[CH]C(O)=O)=O,,,5,1,2,0,2
47426_0,,,,2,1,1,2
C1(CC(CCC(O)=O)CC(O)O1)=O,,,5,1,2,0,2
47428_0,,,,2,1,1,2
C1(C(CCC(O)O1)C[CH]C(O)=O)=O,,,5,1,2,0,2
47430_0,,,,2,1,1,2
C1(C(CCC(O)=O)CCC(O)O1)=O,,,5,1,2,0,2
47432_0,,,,2,1,1,2
[CH]1C(OC(C(C)(C1)O)O)=O,,,5,1,1,0,1
47434_0,,,,2,1,1,2
C1(CCC(C)(C(O)O1)O)=O,,,5,1,1,0,1
47436_0,,,,2,1,1,2
[C]1(C(OC(CO)(C(C1O)O)O)=O)O,,,5,1,1,0,1
47438_0,,,,2,1,1,2
[C]1(C(OC(CO)(C(C1)O)O)=O)O,,,5,1,1,0,1
47440_0,,,,2,1,1,2
[C]1(C(OC(C(CO)(C1O)O)O)=O)O,,,5,1,1,0,1
47442_0,,,,2,1,1,2
[C]1(C(OC(C(CO)(C1)O)O)=O)O,,,5,1,1,0,1
47444_0,,,,2,1,1,2
[C]1(C(OC(C(C)(C1O)O)O)=O)O,,,5,1,1,0,1
47446_0,,,,2,1,1,2
[C]1(C(OC(C(C)(C1)O)O)=O)O,,,5,1,1,0,1
47448_0,,,,2,1,1,2
[C]1(C(OC(C)(C(C1)O)O)=O)O,,,5,1,1,0,1
47450_0,,,,2,1,1,2
C(C1(COC(C(C1)O)O)O)=O,,,5,1,1,0,1
47452_0,,,,2,1,1,2
C(C1(COC(C(C1)O)O)O)(O)=O,,,5,1,1,0,1
47454_0,,,,2,1,1,2
C1(C(CO)(CC(C(O)O1)O)O)=O,,,5,1,1,0,1
47456_0,,,,2,1,1,2
C1(C(C)(CC(C(O)O1)O)O)=O,,,5,1,1,0,1
47457_0,,,,2,1,1,2
47459_0,,,,2,1,1,2
C(C1C(C(O)OC(C)CC1O)O)=O,,,5,1,1,0,1
47461_0,,,,2,1,1,2
C1(C(C(C(O)OCC1)C(C)O)O)=O,,,5,1,1,0,1
47463_0,,,,2,1,1,2
C1(C(O)OC(C)C(CO)C(C1)O)=O,,,5,1,1,0,1
47465_0,,,,2,1,1,2
C1(C(O)OCC(C(C1)O)C(C)O)=O,,,5,1,1,0,1
47466_0,,,,2,1,1,2
47468_0,,,,2,1,1,2
C(C1C(CC(OC(C1O)O)=O)O)=O,,,5,1,1,0,1
47470_0,,,,2,1,1,2
C(C1C(O)OCCC(C1O)=O)(O)=O,,,5,1,1,0,1
47471_0,,,,2,1,1,2
47473_0,,,,2,1,1,2
C(C1COC(C(CC1O)=O)O)(O)=O,,,5,1,1,0,1
47474_0,,,,2,1,1,2
47475_0,,,,2,1,1,2
47477_0,,,,2,1,1,2
C1(C(COC(C=O)(CC1O)O)O)=O,,,5,1,1,0,1
47479_0,,,,2,1,1,2
C(C1C(C(OCC(C1O)=O)O)O)=O,,,5,1,1,0,1
47481_0,,,,2,1,1,2
C1(C(C(C=O)OC(CC1O)O)O)=O,,,5,1,1,0,1
47483_0,,,,2,1,1,2
C1(C(CC(O)OC(CO)C1O)O)=O,,,5,1,1,0,1
47485_0,,,,2,1,1,2
C1(C(CC(O)OC(C)C1O)O)=O,,,5,1,1,0,1
47487_0,,,,2,1,1,2
C1(C(C(C(CC(O)O1)O)=O)O)=O,,,5,1,1,0,1
47489_0,,,,2,1,1,2
C1(C(CC(O)OCC1O)O)=O,,,5,1,1,0,1
47491_0,,,,2,1,1,2
C(C1(COC(C(C(C1)O)O)O)O)=O,,,5,1,1,0,1
47493_0,,,,2,1,1,2
C(C1(COC(CC(C1)O)O)O)=O,,,5,1,1,0,1
47495_0,,,,2,1,1,2
C1(C(C(C(C=O)(O)OCC1)O)O)=O,,,5,1,1,0,1
47497_0,,,,2,1,1,2
C1(C(C(C(O)OCC1O)CO)O)=O,,,5,1,1,0,1
47499_0,,,,2,1,1,2
C1(C(CC(CO)(O)OCC1O)O)=O,,,5,1,1,0,1
47501_0,,,,2,1,1,2
C1(C(C(C(C)(O)OCC1O)O)O)=O,,,5,1,1,0,1
47503_0,,,,2,1,1,2
C1(C(C(C=C)C(O)OCC1O)O)=O,,,5,1,1,0,1
47505_0,,,,2,1,1,2
C1(C(C(C(O)OCC1O)O)O)=O,,,5,1,1,0,1
47507_0,,,,2,1,1,2
C(C1(C(COC(C(C1)=O)O)O)O)=O,,,5,1,1,0,1
47509_0,,,,2,1,1,2
C1(C(C(C(O)OC(C)C1O)O)O)=O,,,5,1,1,0,1
47511_0,,,,2,1,1,2
C1(C(C(C(C(C(O)O1)O)O)=O)O)=O,,,5,1,1,0,1
47513_0,,,,2,1,1,2
C(C1(C)CC(C(CC(O1)O)O)=O)=O,,,5,1,1,0,1
47515_0,,,,2,1,1,2
C(C1COC(C(C)(CC1O)O)O)=O,,,5,1,1,0,1
47517_0,,,,2,1,1,2
C(C1(C)CC(CC(C(O1)O)=O)O)=O,,,5,1,1,0,1
47519_0,,,,2,1,1,2
C(C1COC(CC(C)(C1O)O)O)=O,,,5,1,1,0,1
47521_0,,,,2,1,1,2
C(C1C(CCOC(C1(C)O)O)O)=O,,,5,1,1,0,1
47523_0,,,,2,1,1,2
C1(CC(C(C)=O)OC(CC1O)O)=O,,,5,1,1,0,1
47525_0,,,,2,1,1,2
C1(C(CC(C=O)(O)OC(C)C1)O)=O,,,5,1,1,0,1
47527_0,,,,2,1,1,2
C1(C(CC(C=O)(O)OC(C1)=O)O)=O,,,5,1,1,0,1
47529_0,,,,2,1,1,2
C1(C(CC(C=O)(O)OCC1)O)=O,,,5,1,1,0,1
47531_0,,,,2,1,1,2
C(C1COC(C)(C(CC1O)O)O)=O,,,5,1,1,0,1
47533_0,,,,2,1,1,2
C(C)(C1CC(CC(C(O1)O)=O)O)=O,,,5,1,1,0,1
47535_0,,,,2,1,1,2
C(C1COC(CC(C1(C)O)O)O)=O,,,5,1,1,0,1
47537_0,,,,2,1,1,2
C(C1C(C(C)(O)OCCC1O)O)=O,,,5,1,1,0,1
47539_0,,,,2,1,1,2
C1(C(CC(O)OC(CCO)C1)O)=O,,,5,1,1,0,1
47541_0,,,,2,1,1,2
C1(CC(C=O)OC(CC1O)O)=O,,,5,1,1,0,1
47543_0,,,,2,1,1,2
C1(C(CC(O)OC(CO)(C)C1)O)=O,,,5,1,1,0,1
47545_0,,,,2,1,1,2
C1(CC(C=CC)OC(CC1O)O)=O,,,5,1,1,0,1
47547_0,,,,2,1,1,2
C1(C(CC(O)OC(CC=C)C1)O)=O,,,5,1,1,0,1
47549_0,,,,2,1,1,2
C1(C(CC(O)OC(CO)C1)O)=O,,,5,1,1,0,1
47551_0,,,,2,1,1,2
C1(C(CC(O)OC(C(C)O)C1)O)=O,,,5,1,1,0,1
47553_0,,,,2,1,1,2
C1(CC(C(O)=O)OC(CC1O)O)=O,,,5,1,1,0,1
47555_0,,,,2,1,1,2
C1(C(CC(O)OC(C)C1)O)=O,,,5,1,1,0,1
47557_0,,,,2,1,1,2
C1(CC(C(CC(O)O1)O)=O)=O,,,5,1,1,0,1
47559_0,,,,2,1,1,2
C1(C(CC(O)OCC1)O)=O,,,5,1,1,0,1
47561_0,,,,2,1,1,2
C1(C(CC(C(O)=O)(O)OCC1)O)=O,,,5,1,1,0,1
47563_0,,,,2,1,1,2
C(C1(CCOC(C(C1O)=O)O)O)=O,,,5,1,1,0,1
47565_0,,,,2,1,1,2
C(C1(CCOC(C(C1)=O)O)O)=O,,,5,1,1,0,1
47567_0,,,,2,1,1,2
C1(C(C(C(O)OCC1)CO)O)=O,,,5,1,1,0,1
47569_0,,,,2,1,1,2
C1(C(C(C(CO)(O)OCC1)O)O)=O,,,5,1,1,0,1
47571_0,,,,2,1,1,2
C1(C(CC(CO)(O)OCC1)O)=O,,,5,1,1,0,1
47573_0,,,,2,1,1,2
C1(C(C(C(C)(O)OCC1)O)O)=O,,,5,1,1,0,1
47575_0,,,,2,1,1,2
C1(C(C(C=C)C(O)OCC1)O)=O,,,5,1,1,0,1
47577_0,,,,2,1,1,2
C1(C(C(C(O)OCC1)O)O)=O,,,5,1,1,0,1
47579_0,,,,2,1,1,2
C1(C(O)OCCC(C1CO)O)=O,,,5,1,1,0,1
47581_0,,,,2,1,1,2
C1(C(O)OCC(C(C1CO)O)O)=O,,,5,1,1,0,1
47583_0,,,,2,1,1,2
C(C1(CC(C)OC(C(C1)=O)O)O)=O,,,5,1,1,0,1
47585_0,,,,2,1,1,2
C1(C(C(C(O)OC(C)C1)CO)O)=O,,,5,1,1,0,1
47587_0,,,,2,1,1,2
C1(C(CC(CO)(O)OC(C)C1)O)=O,,,5,1,1,0,1
47589_0,,,,2,1,1,2
C1(C(C(C(C)(O)OC(C)C1)O)O)=O,,,5,1,1,0,1
47591_0,,,,2,1,1,2
C1(C(C(C=C)C(O)OC(C)C1)O)=O,,,5,1,1,0,1
47593_0,,,,2,1,1,2
C1(C(C(C(O)OC(C)C1)O)O)=O,,,5,1,1,0,1
47595_0,,,,2,1,1,2
C1(C(O)OCCC(C1C(C)O)O)=O,,,5,1,1,0,1
47597_0,,,,2,1,1,2
C1(CC(C=O)(CC(C(O)O1)=O)O)=O,,,5,1,1,0,1
47599_0,,,,2,1,1,2
C1(CC(C(C(CO)C(O)O1)O)=O)=O,,,5,1,1,0,1
47601_0,,,,2,1,1,2
C1(CC(C(CC(CO)(O)O1)O)=O)=O,,,5,1,1,0,1
47603_0,,,,2,1,1,2
C1(CC(C(C(C(C)(O)O1)O)O)=O)=O,,,5,1,1,0,1
47605_0,,,,2,1,1,2
C1(CC(C(C(C=C)C(O)O1)O)=O)=O,,,5,1,1,0,1
47607_0,,,,2,1,1,2
C1(CC(C(C(C(O)O1)O)O)=O)=O,,,5,1,1,0,1
47609_0,,,,2,1,1,2
C(C1C(C(O)OCCC1O)=O)(O)=O,,,5,1,1,0,1
47611_0,,,,2,1,1,2
C(C1C(C(C)(O)OCCC1O)=O)=O,,,5,1,1,0,1
47613_0,,,,2,1,1,2
C1(C(CC(O)OC(CCO)C1)=O)=O,,,5,1,1,0,1
47615_0,,,,2,1,1,2
C(CC1(C(CC(CCO1)O)=O)O)=O,,,5,1,1,0,1
47617_0,,,,2,1,1,2
C1(C(C(C)O)(O)OCCC(C1)O)=O,,,5,1,1,0,1
47619_0,,,,2,1,1,2
C(C1(C(CC(CCO1)O)=O)O)(O)=O,,,5,1,1,0,1
47621_0,,,,2,1,1,2
C1(C(O)OCCC(C1O)O)=O,,,5,1,1,0,1
47623_0,,,,2,1,1,2
C1(C(O)OCCC(C1)O)=O,,,5,1,1,0,1
47625_0,,,,2,1,1,2
C(C1COC(CC(C1(C)O)=O)O)=O,,,5,1,1,0,1
47627_0,,,,2,1,1,2
C(C1C(CC(C(C)(O)OC1)=O)O)=O,,,5,1,1,0,1
47629_0,,,,2,1,1,2
C=C1C(OC(C(CO)C(C1)O)O)=O,,,5,1,1,0,1
47631_0,,,,2,1,1,2
C(C1(CCOC(C(C1)=O)O)O)(O)=O,,,5,1,1,0,1
47633_0,,,,2,1,1,2
C(C1(COC(CC(C1)O)O)O)(O)=O,,,5,1,1,0,1
47635_0,,,,2,1,1,2
C1(C(CO)(CC(CC(O)O1)O)O)=O,,,5,1,1,0,1
47637_0,,,,2,1,1,2
C(C)(C1(CC(OCC(C1)=O)O)O)=O,,,5,1,1,0,1
47639_0,,,,2,1,1,2
C(C)(C1(CC(CC(CO1)=O)O)O)=O,,,5,1,1,0,1
47641_0,,,,2,1,1,2
C(C1CC(C(CC(O1)O)=O)=O)=O,,,5,1,1,0,1
47643_0,,,,2,1,1,2
C1(C(CC(O)OC(C)(CO)C1)=O)=O,,,5,1,1,0,1
47645_0,,,,2,1,1,2
C(C)=CC1CC(C(CC(O1)O)=O)=O,,,5,1,1,0,1
47647_0,,,,2,1,1,2
C=CCC1CC(C(CC(O)O1)=O)=O,,,5,1,1,0,1
47649_0,,,,2,1,1,2
C1(C(CC(O)OC(CO)C1)=O)=O,,,5,1,1,0,1
47651_0,,,,2,1,1,2
C1(C(CC(O)OC(C(C)O)C1)=O)=O,,,5,1,1,0,1
47653_0,,,,2,1,1,2
C(C1CC(C(CC(O1)O)=O)=O)(O)=O,,,5,1,1,0,1
47654_0,,,,2,1,1,2
47655_0,,,,2,1,1,2
47657_0,,,,2,1,1,2
C(C1(C)CC(C(CC(O1)O)=O)=O)=O,,,5,1,1,0,1
47659_0,,,,2,1,1,2
C(C1CC(C(CC(O1)O)=O)=O)(C)=O,,,5,1,1,0,1
47661_0,,,,2,1,1,2
C1(C(CC(O)OCC1)=O)=O,,,5,1,1,0,1
47663_0,,,,2,1,1,2
C1(C(C(C)OC(C(C1O)O)O)=O)=O,,,5,1,1,0,1
47665_0,,,,2,1,1,2
C1(C(C(C(C(C(O)O1)O)O)=O)=O)=O,,,5,1,1,0,1
47667_0,,,,2,1,1,2
C1(C(C)(CC(C(OC1C)O)=O)O)=O,,,5,1,1,0,1
47669_0,,,,2,1,1,2
C1(C(C(C)OC(C(C1)O)O)=O)=O,,,5,1,1,0,1
47671_0,,,,2,1,1,2
C1(C(C(C)OC(C(C)(C1)O)O)=O)=O,,,5,1,1,0,1
47673_0,,,,2,1,1,2
C1(C(C(C)OC(C(C1)O)(C)O)=O)=O,,,5,1,1,0,1
47675_0,,,,2,1,1,2
C1(C(O)OC(C(C(C)(C1)O)=O)=O)=O,,,5,1,1,0,1
47677_0,,,,2,1,1,2
C1(C(C(CC(C(O)O1)O)=O)=O)=O,,,5,1,1,0,1
47679_0,,,,2,1,1,2
C1(C(C(CC(C)(C(O)O1)O)=O)=O)=O,,,5,1,1,0,1
47681_0,,,,2,1,1,2
C1(C(C(CC(C(C)(O)O1)O)=O)=O)=O,,,5,1,1,0,1
47683_0,,,,2,1,1,2
C(C1C(CC(C(O)OC1)O)=O)(O)=O,,,5,1,1,0,1
47685_0,,,,2,1,1,2
C1(C(C(CC(C(O)O1)O)=O)CO)=O,,,5,1,1,0,1
47687_0,,,,2,1,1,2
C1(C(C(CC(C(O)O1)O)=O)C)=O,,,5,1,1,0,1
47689_0,,,,2,1,1,2
C(C1C(C(O)OC([CH]C1)=O)O)=O,,,5,1,1,0,1
47691_0,,,,2,1,1,2
C(C1CCC(OC(C1O)O)=O)=O,,,5,1,1,0,1
47692_0,,,,2,1,1,2
47694_0,,,,2,1,1,2
C1(COC(C(C(C1)O)O)O)=O,,,5,1,1,0,1
47696_0,,,,2,1,1,2
C1(C(C(C(C(C(O)O1)O)O)O)=O)=O,,,5,1,1,0,1
47698_0,,,,2,1,1,2
C1(C(CC(C(C(O)O1)O)O)=O)=O,,,5,1,1,0,1
47700_0,,,,2,1,1,2
C1(C(C(C(C(C(O)O1)=O)O)O)O)=O,,,5,1,1,0,1
47702_0,,,,2,1,1,2
C1(C(C(CC(C(O)O1)=O)O)O)=O,,,5,1,1,0,1
47704_0,,,,2,1,1,2
C=C1C(OC(CO)(CC(C1)O)O)=O,,,5,1,1,0,1
47706_0,,,,2,1,1,2
C=C1C(OC(C)(C(C(C1)O)O)O)=O,,,5,1,1,0,1
47708_0,,,,2,1,1,2
C1(C(C(C)(C(CC(O)O1)O)O)O)=O,,,5,1,1,0,1
47710_0,,,,2,1,1,2
C1(C(C(C(C)(CC(O)O1)O)O)O)=O,,,5,1,1,0,1
47712_0,,,,2,1,1,2
C1(C(C)(C(CC(C(O)O1)=O)O)O)=O,,,5,1,1,0,1
47714_0,,,,2,1,1,2
C1(C(C)C(C)(CC(C(O)O1)=O)O)=O,,,5,1,1,0,1
47716_0,,,,2,1,1,2
C1(C(C(CC(C)(C(O)O1)O)=O)C)=O,,,5,1,1,0,1
47718_0,,,,2,1,1,2
C1(C(C(CC(C(C)(O)O1)O)=O)C)=O,,,5,1,1,0,1
47720_0,,,,2,1,1,2
C(C1C(O)OC(C(CC1O)=C)=O)=C,,,5,1,1,0,1
47722_0,,,,2,1,1,2
C=C1C(OC(C(C(C1)O)O)O)=O,,,5,1,1,0,1
47723_0,,,,2,1,1,2
47725_0,,,,2,1,1,2
C(C1(CC(CC(C(O1)=O)=C)O)O)=O,,,5,1,1,0,1
47727_0,,,,2,1,1,2
C1(C(O)OCC(C(C1O)O)O)=O,,,5,1,1,0,1
47729_0,,,,2,1,1,2
C1(C(O)OCC(C(C1)O)O)=O,,,5,1,1,0,1
47730_0,,,,2,1,1,2
47732_0,,,,2,1,1,2
C1(C(C)(CC(C(C(O)O1)O)O)O)=O,,,5,1,1,0,1
47734_0,,,,2,1,1,2
[CH]1C(OC(C(CO)C(C)(C1)O)O)=O,,,5,1,1,0,1
47736_0,,,,2,1,1,2
C1(CCC(C)(C(CO)C(O)O1)O)=O,,,5,1,1,0,1
47737_0,,,,2,1,1,2
47738_0,,,,2,1,1,2
47739_0,,,,2,1,1,2
47740_0,,,,2,1,1,2
47741_0,,,,2,1,1,2
47742_0,,,,2,1,1,2
47743_0,,,,2,1,1,2
47744_0,,,,2,1,1,2
47746_0,,,,2,1,1,2
C(C1C(C)(C(O)OC([CH]C1)=O)O)=O,,,5,1,1,0,1
47748_0,,,,2,1,1,2
C(C1C(C(C)(O)OC([CH]C1)=O)O)=O,,,5,1,1,0,1
47750_0,,,,2,1,1,2
C(C1CCC(OC(C1(C)O)O)=O)=O,,,5,1,1,0,1
47752_0,,,,2,1,1,2
C(C1CCC(OC(C)(C1O)O)=O)=O,,,5,1,1,0,1
47753_0,,,,2,1,1,2
47754_0,,,,2,1,1,2
47755_0,,,,2,1,1,2
47756_0,,,,2,1,1,2
47757_0,,,,2,1,1,2
47758_0,,,,2,1,1,2
47759_0,,,,2,1,1,2
47760_0,,,,2,1,1,2
47761_0,,,,2,1,1,2
47763_0,,,,2,1,1,2
C(C1C(COC(CC1O)O)O)(O)=O,,,5,1,1,0,1
47765_0,,,,2,1,1,2
C1(C(O)OCCC(C1(CO)O)O)=O,,,5,1,1,0,1
47767_0,,,,2,1,1,2
C(C1(C(O)OCCC(C1O)=O)O)=O,,,5,1,1,0,1
47769_0,,,,2,1,1,2
C1(C(C(C(O)OCC1)(CO)O)O)=O,,,5,1,1,0,1
47770_0,,,,2,1,1,2
47772_0,,,,2,1,1,2
C1(C(C(C(O)OCC1O)(C)O)O)=O,,,5,1,1,0,1
47774_0,,,,2,1,1,2
C1(C(C(CC(C)(C(O)O1)O)O)O)=O,,,5,1,1,0,1
47776_0,,,,2,1,1,2
C(C)(C1(CC(O)OCCC1O)O)=O,,,5,1,1,0,1
47778_0,,,,2,1,1,2
C1(C(C(CC(C(C)(O)O1)O)O)O)=O,,,5,1,1,0,1
47780_0,,,,2,1,1,2
C1(C(C(C(O)OCC1)(C)O)O)=O,,,5,1,1,0,1
47782_0,,,,2,1,1,2
C1(C(C(C(O)OC(C)C1)(C)O)O)=O,,,5,1,1,0,1
47784_0,,,,2,1,1,2
C1(CC(C(C(C)(C(O)O1)O)O)=O)=O,,,5,1,1,0,1
47786_0,,,,2,1,1,2
C1(C(C)(O)OCCC(C1(C)O)O)=O,,,5,1,1,0,1
47788_0,,,,2,1,1,2
C1(C(C)(C(C(OC(C1)O)=O)O)O)=O,,,5,1,1,0,1
47790_0,,,,2,1,1,2
C1(C(C(CC(C(C)(O)O1)=O)O)O)=O,,,5,1,1,0,1
47792_0,,,,2,1,1,2
C1(C(COC(C(C1(C)O)O)O)=O)=O,,,5,1,1,0,1
47794_0,,,,2,1,1,2
C=C1C(OC(C(C)(C(C1)O)O)O)=O,,,5,1,1,0,1
47795_0,,,,2,1,1,2
47796_0,,,,2,1,1,2
47797_0,,,,2,1,1,2
47798_0,,,,2,1,1,2
47799_0,,,,2,1,1,2
47800_0,,,,2,1,1,2
47801_0,,,,2,1,1,2
47803_0,,,,2,1,1,2
C1(CC(O)OC(C(C1)=O)=O)=O,,,5,1,1,0,1
47804_0,,,,2,1,1,2
47805_0,,,,2,1,1,2
47806_0,,,,2,1,1,2
47807_0,,,,2,1,1,2
47808_0,,,,2,1,1,2
47809_0,,,,2,1,1,2
47810_0,,,,2,1,1,2
47812_0,,,,2,1,1,2
C(C1C(C)OC(CC(C)C1O)O)=O,,,5,1,1,0,1
47814_0,,,,2,1,1,2
[CH]1C(OC(C(C(C1)O)C(C)O)O)=O,,,5,1,1,0,1
47816_0,,,,2,1,1,2
C1(CCC(C(C(O)O1)C(C)O)O)=O,,,5,1,1,0,1
47818_0,,,,2,1,1,2
C(C1COC(CC(C)C1(C)O)O)=O,,,5,1,1,0,1
47820_0,,,,2,1,1,2
C1(C(C=O)C(C(C)CC(O)O1)O)=O,,,5,1,1,0,1
47822_0,,,,2,1,1,2
C(C1C(O)OC([CH]CC1O)=O)(O)=O,,,5,1,1,0,1
47824_0,,,,2,1,1,2
C(C1C(O)OC(CCC1O)=O)(O)=O,,,5,1,1,0,1
47826_0,,,,2,1,1,2
C(C1(C(C(C[CH]C(O1)=O)O)O)O)=O,,,5,1,1,0,1
47828_0,,,,2,1,1,2
C1(CCC(C(C(C=O)(O)O1)O)O)=O,,,5,1,1,0,1
47830_0,,,,2,1,1,2
C(CC1C(CC(C)CC(O1)O)=O)=O,,,5,1,1,0,1
47832_0,,,,2,1,1,2
C(C)(C1(CC(O)OC([CH]C1)=O)O)=O,,,5,1,1,0,1
47834_0,,,,2,1,1,2
C1(CCC(C(C)=O)(CC(O)O1)O)=O,,,5,1,1,0,1
47836_0,,,,2,1,1,2
C(C1(CC(C[CH]C(O1)=O)O)O)=O,,,5,1,1,0,1
47838_0,,,,2,1,1,2
C1(CCC(CC(C=O)(O)O1)O)=O,,,5,1,1,0,1
47840_0,,,,2,1,1,2
C(C1(CC(C)(C[CH]C(O1)=O)O)O)=O,,,5,1,1,0,1
47842_0,,,,2,1,1,2
C1(CCC(C)(CC(C=O)(O)O1)O)=O,,,5,1,1,0,1
47844_0,,,,2,1,1,2
C1(C(CC(C)C(CO)C(O)O1)=O)=O,,,5,1,1,0,1
47846_0,,,,2,1,1,2
C(C1CC(C=O)COC(C1)O)(O)=O,,,5,1,1,0,1
47848_0,,,,2,1,1,2
C1(C(CC(CC(O)O1)O)CC=O)=O,,,5,1,1,0,1
47850_0,,,,2,1,1,2
C1(C(C)C(C=O)C(CC(O)O1)O)=O,,,5,1,1,0,1
47852_0,,,,2,1,1,2
C(C1C(C)OC(CC(C1)O)O)(O)=O,,,5,1,1,0,1
47854_0,,,,2,1,1,2
C1(C(CC(CC(O)O1)O)C(C)O)=O,,,5,1,1,0,1
47856_0,,,,2,1,1,2
C1(C(C(O)=O)CC(CC(O)O1)O)=O,,,5,1,1,0,1
47858_0,,,,2,1,1,2
[CH]1C(OC(CC(C1)O)O)=O,,,5,1,1,0,1
47860_0,,,,2,1,1,2
C1(CCC(CC(O)O1)O)=O,,,5,1,1,0,1
47862_0,,,,2,1,1,2
C1(C(C(CO)C(C)CC(O)O1)=O)=O,,,5,1,1,0,1
47864_0,,,,2,1,1,2
C(C1(CC(C[CH]C(O1)=O)O)O)(O)=O,,,5,1,1,0,1
47866_0,,,,2,1,1,2
C1(CCC(CC(C(O)=O)(O)O1)O)=O,,,5,1,1,0,1
47868_0,,,,2,1,1,2
C(CC1(C(CC[CH]C(O1)=O)=O)O)=O,,,5,1,1,0,1
47870_0,,,,2,1,1,2
C1(CCCC(C(CC=O)(O)O1)=O)=O,,,5,1,1,0,1
47872_0,,,,2,1,1,2
C1(C(C)(O)OC([CH]CC1C=O)=O)=O,,,5,1,1,0,1
47874_0,,,,2,1,1,2
C1(CCC(C=O)C(C(C)(O)O1)=O)=O,,,5,1,1,0,1
47875_0,,,,2,1,1,2
47876_0,,,,2,1,1,2
47878_0,,,,2,1,1,2
C(C)(C1(C(CC[CH]C(O1)=O)O)O)=O,,,5,1,1,0,1
47880_0,,,,2,1,1,2
C1(CCCC(C(C(C)=O)(O)O1)O)=O,,,5,1,1,0,1
47882_0,,,,2,1,1,2
C1(C(C)(O)OC([CH]CC1(C)O)=O)=O,,,5,1,1,0,1
47884_0,,,,2,1,1,2
C1(CCC(C(C(C)(O)O1)=O)(C)O)=O,,,5,1,1,0,1
47885_0,,,,2,1,1,2
47886_0,,,,2,1,1,2
47888_0,,,,2,1,1,2
CC1CC(C(C)CC(O)O1)O,,,5,1,1,0,1
47890_0,,,,2,1,1,2
CC1(CCOC(CC1C)O)O,,,5,1,1,0,1
47892_0,,,,2,1,1,2
C1(CC(C(C)CC(O)O1)O)=O,,,5,1,1,0,1
47894_0,,,,2,1,1,2
C1(COC(CC(C)C1O)O)=O,,,5,1,1,0,1
47896_0,,,,2,1,1,2
C1(COC(CC(C)C1)O)=O,,,5,1,1,0,1
47898_0,,,,2,1,1,2
C1(C(CC(C)CC(CO)(O)O1)=O)=O,,,5,1,1,0,1
47900_0,,,,2,1,1,2
C(C1(CC(C)CC(CO1)=O)O)(O)=O,,,5,1,1,0,1
47902_0,,,,2,1,1,2
C(C1(C)CC(OCC(C1)=O)O)(O)=O,,,5,1,1,0,1
47904_0,,,,2,1,1,2
C1(C(CC(C)C(C(C)(O)O1)O)=O)=O,,,5,1,1,0,1
47906_0,,,,2,1,1,2
C(C1CC(O)OCCC1)(O)=O,,,5,1,1,0,1
47908_0,,,,2,1,1,2
C1(C2CC(C(O1)=O)(O)OCCC2)=O,,,5,1,1,0,1
47910_0,,,,2,1,1,2
C1(CC(C)(C(C)CC(O)O1)O)=O,,,5,1,1,0,1
47912_0,,,,2,1,1,2
C(C1CCC(OC(C1)O)=O)(O)=O,,,5,1,1,0,1
47914_0,,,,2,1,1,2
C(C1(COC(CC(C)C1)O)O)(O)=O,,,5,1,1,0,1
47916_0,,,,2,1,1,2
C1(C(CO)(CC(C)CC(O)O1)O)=O,,,5,1,1,0,1
47918_0,,,,2,1,1,2
C1(C(C)(C(C(C)CC(O)O1)O)O)=O,,,5,1,1,0,1
47920_0,,,,2,1,1,2
C(C1C(CC(C)CC(O1)O)O)(O)=O,,,5,1,1,0,1
47922_0,,,,2,1,1,2
C1(C(C(C)(C(C)CC(O)O1)O)O)=O,,,5,1,1,0,1
47924_0,,,,2,1,1,2
C1(C(C=O)(CC(C)CC(O)O1)O)=O,,,5,1,1,0,1
47926_0,,,,2,1,1,2
C(C1(C(O)OC([CH]CC1)=O)O)(O)=O,,,5,1,1,0,1
47928_0,,,,2,1,1,2
C(C1(C(O)OC(CCC1)=O)O)(O)=O,,,5,1,1,0,1
47930_0,,,,2,1,1,2
C1(C(C(C)=O)CC(C)CC(O)O1)=O,,,5,1,1,0,1
47932_0,,,,2,1,1,2
C(C1CC[CH]C(OC1(C)O)=O)(O)=O,,,5,1,1,0,1
47934_0,,,,2,1,1,2
C(C1CCCC(OC1(C)O)=O)(O)=O,,,5,1,1,0,1
47936_0,,,,2,1,1,2
C=CC1C(C(OC(CC1C)O)=O)=O,,,5,1,1,0,1
47938_0,,,,2,1,1,2
C(C1C(C(OC(CC1C)O)=O)=C)=O,,,5,1,1,0,1
47940_0,,,,2,1,1,2
C1(C(CC(C)CC(O)O1)=CC=O)=O,,,5,1,1,0,1
47942_0,,,,2,1,1,2
C=C1C(OC(CC(C)C1(C)O)O)=O,,,5,1,1,0,1
47944_0,,,,2,1,1,2
C1(C(C=C)(CC(C)CC(O)O1)O)=O,,,5,1,1,0,1
47946_0,,,,2,1,1,2
CC1C(C(C(C)CC(O)O1)O)O,,,5,1,1,0,1
47948_0,,,,2,1,1,2
CC1CC(C(CO)OC(C1)O)O,,,5,1,1,0,1
47950_0,,,,2,1,1,2
C1C(C(C)(C(C)CC(O)O1)O)O,,,5,1,1,0,1
47952_0,,,,2,1,1,2
[CH]1C(OC(CC(C)C1O)O)=O,,,5,1,1,0,1
47954_0,,,,2,1,1,2
C(CC1[CH]C(OC(CC1C)O)=O)=O,,,5,1,1,0,1
47956_0,,,,2,1,1,2
C1(CC(C(C)CC(O)O1)CC=O)=O,,,5,1,1,0,1
47958_0,,,,2,1,1,2
[C]1(C(OC(CC(C)C1O)O)=O)O,,,5,1,1,0,1
47960_0,,,,2,1,1,2
C1(C(C(C(C)CC(O)O1)O)O)=O,,,5,1,1,0,1
47962_0,,,,2,1,1,2
[C]1(C(OC(CC(C)C1)O)=O)O,,,5,1,1,0,1
47964_0,,,,2,1,1,2
C1(C(CC(C)CC(O)O1)O)=O,,,5,1,1,0,1
47966_0,,,,2,1,1,2
C1(C(C(C(C)CC(O)O1)O)=O)=O,,,5,1,1,0,1
47968_0,,,,2,1,1,2
C1(C(CC(C)CC(O)O1)=O)=O,,,5,1,1,0,1
47970_0,,,,2,1,1,2
C(C1C(O)OC(C(CC1C)=O)=O)=C,,,5,1,1,0,1
47972_0,,,,2,1,1,2
C1(C(CC(C)C(C(O)O1)O)=O)=O,,,5,1,1,0,1
47974_0,,,,2,1,1,2
C1(C(CC(C)C(C)(C(O)O1)O)=O)=O,,,5,1,1,0,1
47976_0,,,,2,1,1,2
C(C1(CC(C)CC(C(O1)=O)=O)O)=O,,,5,1,1,0,1
47978_0,,,,2,1,1,2
C(C1CCC(C=O)OC(C1)O)(O)=O,,,5,1,1,0,1
47980_0,,,,2,1,1,2
C1(C(CCC(C(O)O1)O)CC=O)=O,,,5,1,1,0,1
47982_0,,,,2,1,1,2
C1(C(CCC(C(O)O1)=O)CC=O)=O,,,5,1,1,0,1
47984_0,,,,2,1,1,2
C(C1CC(C(OC(C1)O)=O)O)(O)=O,,,5,1,1,0,1
47986_0,,,,2,1,1,2
C(C1CC(O)OCC(C1)O)(O)=O,,,5,1,1,0,1
47988_0,,,,2,1,1,2
C1(C(C)C(C=O)CC(C(O)O1)O)=O,,,5,1,1,0,1
47990_0,,,,2,1,1,2
C1(C(O)OC(C(C)C(C=O)C1)=O)=O,,,5,1,1,0,1
47992_0,,,,2,1,1,2
C(C1C(C)OC(C(CC1)O)O)(O)=O,,,5,1,1,0,1
47994_0,,,,2,1,1,2
C1(C(CCC(C(O)O1)O)C(C)O)=O,,,5,1,1,0,1
47996_0,,,,2,1,1,2
C(C1CCC(C(O)OC1C)=O)(O)=O,,,5,1,1,0,1
47998_0,,,,2,1,1,2
C1(C(CCC(C(O)O1)=O)C(C)O)=O,,,5,1,1,0,1
48000_0,,,,2,1,1,2
C1(C(C(O)=O)CCC(C(O)O1)O)=O,,,5,1,1,0,1
48002_0,,,,2,1,1,2
C(C1C(OC(C(CC1)=O)O)=O)(O)=O,,,5,1,1,0,1
48004_0,,,,2,1,1,2
C1(C2(CC(C)(C[CH]C(O2)=O)O1)O)=O,,,5,1,1,0,1
48006_0,,,,2,1,1,2
C1(CCC2(C)CC(C(O2)=O)(O)O1)=O,,,5,1,1,0,1
48008_0,,,,2,1,1,2
[CH](C(O)=O)C1CC(O)OC([CH]C1)=O,,,5,1,1,0,1
48010_0,,,,2,1,1,2
C1(CCC([CH]C(O)=O)CC(O)O1)=O,,,5,1,1,0,1
48012_0,,,,2,1,1,2
C(CC1CC(O)OC([CH]C1)=O)(O)=O,,,5,1,1,0,1
48014_0,,,,2,1,1,2
C1(CCC(CC(O)O1)CC(O)=O)=O,,,5,1,1,0,1
48016_0,,,,2,1,1,2
[CH]1C(OC(C(CC1)O)O)=O,,,5,1,1,0,1
48018_0,,,,2,1,1,2
C1(CCCC(C(O)O1)O)=O,,,5,1,1,0,1
48020_0,,,,2,1,1,2
CC1CC(CC(C(O)O1)O)O,,,5,1,1,0,1
48022_0,,,,2,1,1,2
C1(CC(CC(C(O)O1)O)O)=O,,,5,1,1,0,1
48024_0,,,,2,1,1,2
C1(COC(C(CC1O)O)O)=O,,,5,1,1,0,1
48025_0,,,,2,1,1,2
48025_1,,,,2,1,1,2
48026_0,,,,2,1,1,2
48027_0,,,,2,1,1,2
48028_0,,,,2,1,1,2
48029_0,,,,2,1,1,2
48030_0,,,,2,1,1,2
48031_0,,,,2,1,1,2
48032_0,,,,2,1,1,2
48033_0,,,,2,1,1,2
48034_0,,,,2,1,1,2
48035_0,,,,2,1,1,2
48036_0,,,,2,1,1,2
48037_0,,,,2,1,1,2
48038_0,,,,2,1,1,2
48039_0,,,,2,1,1,2
48040_0,,,,2,1,1,2
48041_0,,,,2,1,1,2
48042_0,,,,2,1,1,2
48043_0,,,,2,1,1,2
48044_0,,,,2,1,1,2
48045_0,,,,2,1,1,2
48046_0,,,,2,1,1,2
48047_0,,,,2,1,1,2
48048_0,,,,2,1,1,2
48049_0,,,,2,1,1,2
48050_0,,,,2,1,1,2
48051_0,,,,2,1,1,2
48052_0,,,,2,1,1,2
48053_0,,,,2,1,1,2
48054_0,,,,2,1,1,2
48055_0,,,,2,1,1,2
48056_0,,,,2,1,1,2
48057_0,,,,2,1,1,2
48058_0,,,,2,1,1,2
48059_0,,,,2,1,1,2
48060_0,,,,2,1,1,2
48061_0,,,,2,1,1,2
48062_0,,,,2,1,1,2
48063_0,,,,2,1,1,2
48064_0,,,,2,1,1,2
48065_0,,,,2,1,1,2
48066_0,,,,2,1,1,2
48067_0,,,,2,1,1,2
48068_0,,,,2,1,1,2
48069_0,,,,2,1,1,2
48070_0,,,,2,1,1,2
48071_0,,,,2,1,1,2
48072_0,,,,2,1,1,2
48073_0,,,,2,1,1,2
48074_0,,,,2,1,1,2
48075_0,,,,2,1,1,2
48076_0,,,,2,1,1,2
48077_0,,,,2,1,1,2
48078_0,,,,2,1,1,2
48079_0,,,,2,1,1,2
48080_0,,,,2,1,1,2
48081_0,,,,2,1,1,2
48082_0,,,,2,1,1,2
48083_0,,,,2,1,1,2
48084_0,,,,2,1,1,2
48085_0,,,,2,1,1,2
48086_0,,,,2,1,1,2
48087_0,,,,2,1,1,2
48088_0,,,,2,1,1,2
48089_0,,,,2,1,1,2
48090_0,,,,2,1,1,2
48091_0,,,,2,1,1,2
48092_0,,,,2,1,1,2
48093_0,,,,2,1,1,2
48094_0,,,,2,1,1,2
48095_0,,,,2,1,1,2
48096_0,,,,2,1,1,2
48097_0,,,,2,1,1,2
48098_0,,,,2,1,1,2
48099_0,,,,2,1,1,2
48100_0,,,,2,1,1,2
48101_0,,,,2,1,1,2
48102_0,,,,2,1,1,2
48103_0,,,,2,1,1,2
48104_0,,,,2,1,1,2
48105_0,,,,2,1,1,2
48106_0,,,,2,1,1,2
48107_0,,,,2,1,1,2
48108_0,,,,2,1,1,2
48109_0,,,,2,1,1,2
48110_0,,,,2,1,1,2
48111_0,,,,2,1,1,2
48112_0,,,,2,1,1,2
48113_0,,,,2,1,1,2
48114_0,,,,2,1,1,2
48115_0,,,,2,1,1,2
48116_0,,,,2,1,1,2
48117_0,,,,2,1,1,2
48118_0,,,,2,1,1,2
48119_0,,,,2,1,1,2
48120_0,,,,2,1,1,2
48121_0,,,,2,1,1,2
48122_0,,,,2,1,1,2
48123_0,,,,2,1,1,2
48124_0,,,,2,1,1,2
48125_0,,,,2,1,1,2
48126_0,,,,2,1,1,2
48127_0,,,,2,1,1,2
48128_0,,,,2,1,1,2
48129_0,,,,2,1,1,2
48130_0,,,,2,1,1,2
48131_0,,,,2,1,1,2
48132_0,,,,2,1,1,2
48133_0,,,,2,1,1,2
48134_0,,,,2,1,1,2
48135_0,,,,2,1,1,2
48136_0,,,,2,1,1,2
48137_0,,,,2,1,1,2
48138_0,,,,2,1,1,2
48139_0,,,,2,1,1,2
48140_0,,,,2,1,1,2
48141_0,,,,2,1,1,2
48142_0,,,,2,1,1,2
48143_0,,,,2,1,1,2
48144_0,,,,2,1,1,2
48145_0,,,,2,1,1,2
48146_0,,,,2,1,1,2
48147_0,,,,2,1,1,2
48148_0,,,,2,1,1,2
48149_0,,,,2,1,1,2
48150_0,,,,2,1,1,2
48151_0,,,,2,1,1,2
48152_0,,,,2,1,1,2
48153_0,,,,2,1,1,2
48154_0,,,,2,1,1,2
48155_0,,,,2,1,1,2
48156_0,,,,2,1,1,2
48157_0,,,,2,1,1,2
48158_0,,,,2,1,1,2
48159_0,,,,2,1,1,2
48160_0,,,,2,1,1,2
48161_0,,,,2,1,1,2
48162_0,,,,2,1,1,2
48163_0,,,,2,1,1,2
48164_0,,,,2,1,1,2
48165_0,,,,2,1,1,2
48166_0,,,,2,1,1,2
48167_0,,,,2,1,1,2
48168_0,,,,2,1,1,2
48169_0,,,,2,1,1,2
48170_0,,,,2,1,1,2
48171_0,,,,2,1,1,2
48172_0,,,,2,1,1,2
48173_0,,,,2,1,1,2
48174_0,,,,2,1,1,2
48175_0,,,,2,1,1,2
48176_0,,,,2,1,1,2
48177_0,,,,2,1,1,2
48178_0,,,,2,1,1,2
48179_0,,,,2,1,1,2
48180_0,,,,2,1,1,2
48181_0,,,,2,1,1,2
48182_0,,,,2,1,1,2
48183_0,,,,2,1,1,2
48184_0,,,,2,1,1,2
48185_0,,,,2,1,1,2
48186_0,,,,2,1,1,2
48187_0,,,,2,1,1,2
48188_0,,,,2,1,1,2
48189_0,,,,2,1,1,2
48190_0,,,,2,1,1,2
48191_0,,,,2,1,1,2
48192_0,,,,2,1,1,2
48193_0,,,,2,1,1,2
48194_0,,,,2,1,1,2
48195_0,,,,2,1,1,2
48196_0,,,,2,1,1,2
48197_0,,,,2,1,2,3
48198_0,,,,2,1,2,3
48199_0,,,,2,1,2,3
48200_0,,,,2,1,2,3
48201_0,,,,2,1,2,3
48202_0,,,,2,1,2,3
48203_0,,,,2,1,2,3
48204_0,,,,2,1,2,3
48205_0,,,,2,1,2,3
48206_0,,,,2,1,2,3
48207_0,,,,2,1,2,3
48208_0,,,,2,1,2,3
48209_0,,,,2,1,2,3
48210_0,,,,2,1,2,3
48211_0,,,,2,1,2,3
48212_0,,,,2,1,2,3
48213_0,,,,2,1,2,3
48214_0,,,,2,1,2,3
48215_0,,,,2,1,2,3
48216_0,,,,2,1,2,3
48217_0,,,,2,1,2,3
48218_0,,,,2,1,2,3
48219_0,,,,2,1,2,3
48220_0,,,,2,1,2,3
48221_0,,,,2,1,2,3
48222_0,,,,2,1,2,3
48223_0,,,,2,1,2,3
48224_0,,,,2,1,2,3
48225_0,,,,2,1,2,3
48226_0,,,,2,1,2,3
48227_0,,,,2,1,2,3
48228_0,,,,2,1,2,3
48229_0,,,,2,1,2,3
48230_0,,,,2,1,2,3
48231_0,,,,2,1,2,3
48232_0,,,,2,1,2,3
48233_0,,,,2,1,2,3
48234_0,,,,2,1,2,3
48235_0,,,,2,1,2,3
48236_0,,,,2,1,2,3
48237_0,,,,2,1,2,3
48238_0,,,,2,1,2,3
48239_0,,,,2,1,2,3
48240_0,,,,2,1,2,3
48241_0,,,,2,1,2,3
48242_0,,,,2,1,2,3
48243_0,,,,2,1,2,3
48244_0,,,,2,1,2,3
48245_0,,,,2,1,2,3
48246_0,,,,2,1,2,3
48247_0,,,,2,1,2,3
48248_0,,,,2,1,2,3
48249_0,,,,2,1,2,3
48250_0,,,,2,1,2,3
48251_0,,,,2,1,2,3
48252_0,,,,2,1,2,3
48253_0,,,,2,1,2,3
48254_0,,,,2,1,2,3
48255_0,,,,2,1,2,3
48256_0,,,,2,1,2,3
48257_0,,,,2,1,2,3
48258_0,,,,2,1,2,3
48259_0,,,,2,1,2,3
48260_0,,,,2,1,2,3
48261_0,,,,2,1,2,3
48262_0,,,,2,1,2,3
48263_0,,,,2,1,2,3
48264_0,,,,2,1,2,3
48265_0,,,,2,1,2,3
48266_0,,,,2,1,2,3
48267_0,,,,2,1,2,3
48268_0,,,,2,1,2,3
48269_0,,,,2,1,2,3
48270_0,,,,2,1,2,3
48271_0,,,,2,1,2,3
48272_0,,,,2,1,2,3
48273_0,,,,2,1,2,3
48274_0,,,,2,1,2,3
48275_0,,,,2,1,2,3
48276_0,,,,2,1,2,3
48277_0,,,,2,1,2,3
48278_0,,,,2,1,2,3
48279_0,,,,2,1,2,3
48280_0,,,,2,1,2,3
48281_0,,,,2,1,2,3
48282_0,,,,2,1,2,3
48283_0,,,,2,1,2,3
48284_0,,,,2,1,2,3
48285_0,,,,2,1,2,3
48286_0,,,,2,1,2,3
48287_0,,,,2,1,2,3
48288_0,,,,2,1,2,3
48290_0,,,,2,1,2,3
C(CCC(C)O)=O,,,5,1,2,0,2
48291_0,,,,2,1,2,3
48292_0,,,,2,1,2,3
48293_0,,,,2,1,2,3
48294_0,,,,2,1,2,3
48295_0,,,,2,1,2,3
48296_0,,,,2,1,2,3
48297_0,,,,2,1,2,3
48298_0,,,,2,1,2,3
48299_0,,,,2,1,2,3
48300_0,,,,2,1,2,3
48301_0,,,,2,1,2,3
48302_0,,,,2,1,2,3
48303_0,,,,2,1,2,3
48304_0,,,,2,1,2,3
48305_0,,,,2,1,2,3
48306_0,,,,2,1,2,3
48307_0,,,,2,1,2,3
48308_0,,,,2,1,2,3
48309_0,,,,2,1,2,3
48310_0,,,,2,1,2,3
48311_0,,,,2,1,2,3
48312_0,,,,2,1,2,3
48313_0,,,,2,1,2,3
48314_0,,,,2,1,2,3
48315_0,,,,2,1,2,3
48316_0,,,,2,1,2,3
48317_0,,,,2,1,2,3
48318_0,,,,2,1,2,3
48319_0,,,,2,1,2,3
48320_0,,,,2,1,2,3
48321_0,,,,2,1,2,3
48322_0,,,,2,1,2,3
48323_0,,,,2,1,2,3
48324_0,,,,2,1,2,3
48325_0,,,,2,1,2,3
48327_0,,,,2,1,2,3
C1(CC(C(C=O)O1)O)=O,,,5,1,2,0,2
48328_0,,,,2,1,2,3
48329_0,,,,2,1,2,3
48331_0,,,,2,1,2,3
C(C1C[CH]C(O1)=O)=O,,,5,1,2,0,2
48333_0,,,,2,1,2,3
C(C1CCC(O1)=O)=O,,,5,1,2,0,2
48334_0,,,,2,1,2,3
48335_0,,,,2,1,2,3
48336_0,,,,2,1,2,3
48337_0,,,,2,1,2,3
48338_0,,,,2,1,2,3
48339_0,,,,2,1,2,3
48340_0,,,,2,1,2,3
48341_0,,,,2,1,2,3
48342_0,,,,2,1,2,3
48343_0,,,,2,1,2,3
48344_0,,,,2,1,2,3
48345_0,,,,2,1,2,3
48346_0,,,,2,1,2,3
48347_0,,,,2,1,2,3
48348_0,,,,2,1,2,3
48349_0,,,,2,1,2,3
48350_0,,,,2,1,2,3
48351_0,,,,2,1,2,3
48352_0,,,,2,1,2,3
48353_0,,,,2,1,2,3
48354_0,,,,2,1,2,3
48355_0,,,,2,1,2,3
48356_0,,,,2,1,2,3
48357_0,,,,2,1,2,3
48358_0,,,,2,1,2,3
48359_0,,,,2,1,2,3
48360_0,,,,2,1,2,3
48361_0,,,,2,1,2,3
48362_0,,,,2,1,2,3
48363_0,,,,2,1,2,3
48364_0,,,,2,1,2,3
48365_0,,,,2,1,2,3
48366_0,,,,2,1,2,3
48367_0,,,,2,1,2,3
48368_0,,,,2,1,2,3
48369_0,,,,2,1,2,3
48370_0,,,,2,1,2,3
48371_0,,,,2,1,2,3
48372_0,,,,2,1,2,3
48373_0,,,,2,1,2,3
48374_0,,,,2,1,2,3
48375_0,,,,2,1,2,3
48376_0,,,,2,1,2,3
48377_0,,,,2,1,2,3
48378_0,,,,2,1,2,3
48379_0,,,,2,1,2,3
48380_0,,,,2,1,2,3
48381_0,,,,2,1,2,3
48382_0,,,,2,1,2,3
48383_0,,,,2,1,2,3
48384_0,,,,2,1,2,3
48385_0,,,,2,1,2,3
48386_0,,,,2,1,2,3
48387_0,,,,2,1,2,3
48388_0,,,,2,1,2,3
48389_0,,,,2,1,2,3
48390_0,,,,2,1,2,3
48391_0,,,,2,1,2,3
48392_0,,,,2,1,2,3
48393_0,,,,2,1,2,3
48394_0,,,,2,1,2,3
48395_0,,,,2,1,2,3
48396_0,,,,2,1,2,3
48397_0,,,,2,1,2,3
48398_0,,,,2,1,2,3
48399_0,,,,2,1,2,3
48400_0,,,,2,1,2,3
48401_0,,,,2,1,2,3
48402_0,,,,2,1,2,3
48403_0,,,,2,1,2,3
48404_0,,,,2,1,2,3
48405_0,,,,2,1,2,3
48406_0,,,,2,1,2,3
48407_0,,,,2,1,2,3
48408_0,,,,2,1,2,3
48409_0,,,,2,1,2,3
48410_0,,,,2,1,2,3
48411_0,,,,2,1,2,3
48412_0,,,,2,1,2,3
48413_0,,,,2,1,2,3
48414_0,,,,2,1,2,3
48415_0,,,,2,1,2,3
48416_0,,,,2,1,2,3
48417_0,,,,2,1,2,3
48417_1,,,,2,1,2,3
48418_0,,,,2,1,2,3
48419_0,,,,2,1,2,3
48419_1,,,,2,1,2,3
48420_0,,,,2,1,2,3
48420_1,,,,2,1,2,3
48421_0,,,,2,1,2,3
48421_1,,,,2,1,2,3
48422_0,,,,2,1,2,3
48422_1,,,,2,1,2,3
48424_0,,,,2,1,2,3
C1(C(C(C(C=O)O1)O)C(C)O)=O,,,5,1,1,0,1
48426_0,,,,2,1,2,3
C1(C(CO)C(C(C(C)=O)O1)O)=O,,,5,1,1,0,1
48428_0,,,,2,1,2,3
C1(C(CO)C(C(C=O)O1)O)=O,,,5,1,1,0,1
48430_0,,,,2,1,2,3
C(C1C(OC(C=O)C1O)=O)(O)=O,,,5,1,1,0,1
48432_0,,,,2,1,2,3
C1(C(C(C(CC=O)O1)=O)O)=O,,,5,1,1,0,1
48434_0,,,,2,1,2,3
C1(C(C(C(C(C=O)O)O1)=O)O)=O,,,5,1,1,0,1
48436_0,,,,2,1,2,3
C1(C(C(C=O)(C(C=O)O1)O)O)=O,,,5,1,1,0,1
48438_0,,,,2,1,2,3
C1(C(C(C=O)C(C=O)(C)O1)O)=O,,,5,1,1,0,1
48439_0,,,,2,1,2,3
48440_0,,,,2,1,2,3
48442_0,,,,2,1,2,3
C1(CC(C(CC(C=O)=O)O1)=O)=O,,,5,1,1,0,1
48444_0,,,,2,1,2,3
C1(C(C(C=O)C(C(C)=O)O1)O)=O,,,5,1,1,0,1
48446_0,,,,2,1,2,3
C1(CC(C(CC=O)O1)=O)=O,,,5,1,1,0,1
48447_0,,,,2,1,2,3
48448_0,,,,2,1,2,3
48449_0,,,,2,1,2,3
48451_0,,,,2,1,2,3
C(C1(CCO)CC(C(O1)=O)=O)=O,,,5,1,1,0,1
48453_0,,,,2,1,2,3
C1(C(C(C(C=O)=O)CO1)O)=O,,,5,1,1,0,1
48455_0,,,,2,1,2,3
C1(C(C)(C(C(C=O)=O)CO1)O)=O,,,5,1,1,0,1
48457_0,,,,2,1,2,3
C1(C(C(C(C=O)=O)C(C)O1)O)=O,,,5,1,1,0,1
48459_0,,,,2,1,2,3
C1(CC(C=O)(C(C(C)=O)O1)O)=O,,,5,1,1,0,1
48461_0,,,,2,1,2,3
C1(CC(C=O)(C(C=O)O1)O)=O,,,5,1,1,0,1
48463_0,,,,2,1,2,3
C(C(CO)C1C(CC(O1)=O)=O)=O,,,5,1,1,0,1
48465_0,,,,2,1,2,3
C1(CC(C(CC(CO)=O)O1)=O)=O,,,5,1,1,0,1
48467_0,,,,2,1,2,3
C1(CC(C(C(C(C)=O)O)O1)=O)=O,,,5,1,1,0,1
48469_0,,,,2,1,2,3
C(C(C=C)C1C(CC(O1)=O)=O)=O,,,5,1,1,0,1
48471_0,,,,2,1,2,3
C1(CC(C(C(C=O)O)O1)=O)=O,,,5,1,1,0,1
48473_0,,,,2,1,2,3
C1(C(C(C=O)=O)C(C)(CO1)O)=O,,,5,1,1,0,1
48475_0,,,,2,1,2,3
C1(C(C(C=O)=O)C(CO1)O)=O,,,5,1,1,0,1
48477_0,,,,2,1,2,3
C1(C(C(C=O)=O)C(C(C)O1)O)=O,,,5,1,1,0,1
48479_0,,,,2,1,2,3
C1(C(C(C=O)=O)C(C(O1)=O)O)=O,,,5,1,1,0,1
48480_0,,,,2,1,2,3
48481_0,,,,2,1,2,3
48482_0,,,,2,1,2,3
48484_0,,,,2,1,2,3
C1(C(C(CO)C(CCO)O1)=O)=O,,,5,1,1,0,1
48486_0,,,,2,1,2,3
C=CC1C(C(OC1CCO)=O)=O,,,5,1,1,0,1
48488_0,,,,2,1,2,3
C(C1C(C(OC1CCO)=O)=C)=O,,,5,1,1,0,1
48490_0,,,,2,1,1,2
C1(C(C(C(CCO)O1)C(C)O)=O)=O,,,5,1,1,0,1
48492_0,,,,2,1,1,2
C(C1C(C(OC1CCO)=O)=O)(O)=O,,,5,1,1,0,1
48494_0,,,,2,1,2,3
C1(C(C(C(CCO)O1)O)=O)=O,,,5,1,1,0,1
48496_0,,,,2,1,2,3
C1(C(CC(CCO)O1)=O)=O,,,5,1,1,0,1
48497_0,,,,2,1,2,3
48499_0,,,,2,1,2,3
C(C1COC(C1(CCO)O)=O)=O,,,5,1,1,0,1
48501_0,,,,2,1,2,3
C(C1COC(C1(C(C)=O)O)=O)=O,,,5,1,1,0,1
48503_0,,,,2,1,2,3
C(C1COC(C1(C=CC)O)=O)=O,,,5,1,1,0,1
48505_0,,,,2,1,2,3
C(C1COC(C1(CC=C)O)=O)=O,,,5,1,1,0,1
48507_0,,,,2,1,2,3
C(C(C1CC(C(O1)=O)=C)CO)=O,,,5,1,1,0,1
48509_0,,,,2,1,1,2
C(C1COC(C1(CC(C)O)O)=O)=O,,,5,1,1,0,1
48511_0,,,,2,1,1,2
C(CC1(C(OCC1C=O)=O)O)(O)=O,,,5,1,1,0,1
48513_0,,,,2,1,2,3
C(C1COC(C1O)=O)=O,,,5,1,1,0,1
48515_0,,,,2,1,2,3
C(C1COC(C1(CO)O)=O)=O,,,5,1,1,0,1
48516_0,,,,2,1,2,3
48517_0,,,,2,1,2,3
48518_0,,,,2,1,2,3
48519_0,,,,2,1,2,3
48520_0,,,,2,1,2,3
48521_0,,,,2,1,2,3
48523_0,,,,2,1,2,3
C(C1C(C(C(O1)=O)=O)CO)=O,,,5,1,1,0,1
48524_0,,,,2,1,2,3
48526_0,,,,2,1,2,3
C1(C(C(CO)C(C)(CO)O1)=O)=O,,,5,1,1,0,1
48527_0,,,,2,1,2,3
48529_0,,,,2,1,2,3
C(C)=CC1C(C(C(O1)=O)=O)CO,,,5,1,1,0,1
48530_0,,,,2,1,2,3
48532_0,,,,2,1,2,3
C=CCC1C(C(C(O1)=O)=O)CO,,,5,1,1,0,1
48533_0,,,,2,1,2,3
48535_0,,,,2,1,2,3
C1(C(C(CO)C(CO)O1)=O)=O,,,5,1,1,0,1
48536_0,,,,2,1,2,3
48538_0,,,,2,1,2,3
C1(C(C(CO)C(C(C)O)O1)=O)=O,,,5,1,1,0,1
48539_0,,,,2,1,2,3
48541_0,,,,2,1,2,3
C1(C(C(C(C(O)=O)=O)CO1)O)=O,,,5,1,1,0,1
48543_0,,,,2,1,2,3
C(C1C(C(C(O1)=O)=O)CO)(O)=O,,,5,1,1,0,1
48544_0,,,,2,1,2,3
48545_0,,,,2,1,2,3
48547_0,,,,2,1,2,3
C1(C(CO)(CC(CC=O)O1)O)=O,,,5,1,1,0,1
48548_0,,,,2,1,2,3
48549_0,,,,2,1,2,3
48551_0,,,,2,1,2,3
C(C1C(C(C(O1)=O)=O)(CO)O)=O,,,5,1,1,0,1
48552_0,,,,2,1,2,3
48553_0,,,,2,1,2,3
48554_0,,,,2,1,2,3
48555_0,,,,2,1,2,3
48556_0,,,,2,1,2,3
48557_0,,,,2,1,2,3
48558_0,,,,2,1,2,3
48559_0,,,,2,1,2,3
48560_0,,,,2,1,2,3
48562_0,,,,2,1,2,3
C(C1C(C(C(O1)=O)=O)(C)O)(C)=O,,,5,1,1,0,1
48564_0,,,,2,1,2,3
C(C1C(C(C(O1)=O)=O)(C)O)=O,,,5,1,1,0,1
48566_0,,,,2,1,2,3
C(C1C(C=C)C(C(O1)=O)=O)=O,,,5,1,1,0,1
48568_0,,,,2,1,2,3
C(C1C(C(OC1C=O)=O)=C)=O,,,5,1,1,0,1
48570_0,,,,2,1,1,2
C(C1C(C(C(O1)=O)=O)C(C(O)=O)=C)=O,,,5,1,1,0,1
48572_0,,,,2,1,1,2
C(C1C(C(C(O)=O)=O)C(C(O1)=O)=C)=O,,,5,1,1,0,1
48574_0,,,,2,1,1,2
C(C1C(C(C(O1)=O)=O)C(C)O)=O,,,5,1,2,0,2
48576_0,,,,2,1,1,2
C(C1C(C(OC1C=O)=O)=O)(O)=O,,,5,1,2,0,2
48577_0,,,,2,1,2,3
48578_0,,,,2,1,2,3
48580_0,,,,2,1,2,3
C1(C(C)(C(C=O)C(C=O)O1)O)=O,,,5,1,1,0,1
48581_0,,,,2,1,2,3
48582_0,,,,2,1,2,3
48583_0,,,,2,1,2,3
48584_0,,,,2,1,2,3
48586_0,,,,2,1,2,3
[C]1(C(OCC1C(C(C)=O)=O)=O)O,,,5,1,1,0,1
48588_0,,,,2,1,2,3
C1(C(C(C(C(C)=O)=O)CO1)O)=O,,,5,1,1,0,1
48589_0,,,,2,1,2,3
48590_0,,,,2,1,2,3
48591_0,,,,2,1,2,3
48592_0,,,,2,1,2,3
48593_0,,,,2,1,2,3
48594_0,,,,2,1,2,3
48595_0,,,,2,1,2,3
48597_0,,,,2,1,2,3
C1(C(C=O)C(C(C(O)=O)O1)O)=O,,,5,1,1,0,1
48599_0,,,,2,1,2,3
C1(C(C(C(C(C=O)=O)O1)O)O)=O,,,5,1,1,0,1
48601_0,,,,2,1,2,3
C(C(C1CC(C(O1)=O)=O)O)(O)=O,,,5,1,1,0,1
48602_0,,,,2,1,2,3
48603_0,,,,2,1,2,3
48604_0,,,,2,1,2,3
48605_0,,,,2,1,2,3
48606_0,,,,2,1,2,3
48608_0,,,,2,1,2,3
C=CC1C(C(OC1(C)CO)=O)=O,,,5,1,1,0,1
48610_0,,,,2,1,2,3
C(C1C(C(OC1(C)CO)=O)=C)=O,,,5,1,1,0,1
48612_0,,,,2,1,1,2
C1(C(C(C(C)O)C(C)(CO)O1)=O)=O,,,5,1,1,0,1
48614_0,,,,2,1,1,2
C(C1C(C(OC1(C)CO)=O)=O)(O)=O,,,5,1,1,0,1
48616_0,,,,2,1,1,2
C1(C(C(C(O)=O)=O)C(CO1)(C)O)=O,,,5,1,1,0,1
48618_0,,,,2,1,2,3
C1(C(C=O)C(C)(CO1)O)=O,,,5,1,1,0,1
48619_0,,,,2,1,2,3
48620_0,,,,2,1,2,3
48622_0,,,,2,1,2,3
C(CO)(CC1CC(C(O1)=O)=C)=O,,,5,1,1,0,1
48624_0,,,,2,1,2,3
C1(CC(CO1)=O)=O,,,5,1,1,0,1
48626_0,,,,2,1,2,3
C1(C(C)(C(C(C(C)=O)O1)O)O)=O,,,5,1,1,0,1
48628_0,,,,2,1,2,3
C1(C(C)C(C)(C(C(C)=O)O1)O)=O,,,5,1,1,0,1
48630_0,,,,2,1,2,3
C(C)(C(C1CC(C(O1)=O)=C)O)=O,,,5,1,1,0,1
48632_0,,,,2,1,1,2
C1(CC(C(O)=O)(C(C(C)=O)O1)O)=O,,,5,1,1,0,1
48634_0,,,,2,1,2,3
C1(CC(C(C(C)=O)O1)O)=O,,,5,1,1,0,1
48636_0,,,,2,1,2,3
C(CC1C(C)(C(C(O1)=O)O)O)=O,,,5,1,1,0,1
48638_0,,,,2,1,2,3
C(CC1(C)C(C(C(O1)=O)O)O)=O,,,5,1,1,0,1
48640_0,,,,2,1,2,3
C1(CC(C(C(C(O)=O)O)O1)=O)=O,,,5,1,1,0,1
48641_0,,,,2,1,2,3
48643_0,,,,2,1,2,3
C1(C(CO)C(C)(C(C=O)O1)O)=O,,,5,1,1,0,1
48645_0,,,,2,1,2,3
C1(C(C)C(C)(C(C=O)O1)O)=O,,,5,1,1,0,1
48647_0,,,,2,1,2,3
C=CC1C(C(OC1C=CC)=O)=O,,,5,1,1,0,1
48649_0,,,,2,1,2,3
C(C1C(C(OC1C=CC)=O)=C)=O,,,5,1,1,0,1
48651_0,,,,2,1,1,2
C(C)=CC1C(C(C(O1)=O)=O)C(C)O,,,5,1,1,0,1
48653_0,,,,2,1,1,2
C(C1C(C(OC1C=CC)=O)=O)(O)=O,,,5,1,1,0,1
48654_0,,,,2,1,2,3
48655_0,,,,2,1,2,3
48657_0,,,,2,1,2,3
C=CC1C(C(OC1CC=C)=O)=O,,,5,1,1,0,1
48659_0,,,,2,1,2,3
C(C1C(C(OC1CC=C)=O)=C)=O,,,5,1,1,0,1
48661_0,,,,2,1,1,2
C=CCC1C(C(C(O1)=O)=O)C(C)O,,,5,1,1,0,1
48663_0,,,,2,1,1,2
C(C1C(C(OC1CC=C)=O)=O)(O)=O,,,5,1,1,0,1
48664_0,,,,2,1,2,3
48665_0,,,,2,1,2,3
48667_0,,,,2,1,2,3
C(C(C=C)C1CC(C(O1)=O)=C)=O,,,5,1,1,0,1
48669_0,,,,2,1,2,3
C=CC1C(C(OC1CO)=O)=O,,,5,1,1,0,1
48671_0,,,,2,1,2,3
C=CC1C(C(OC1C(C)O)=O)=O,,,5,1,1,0,1
48673_0,,,,2,1,2,3
C(C1C(C=C)C(C(O1)=O)=O)(O)=O,,,5,1,1,0,1
48674_0,,,,2,1,2,3
48675_0,,,,2,1,2,3
48677_0,,,,2,1,2,3
C(C1(C)C(C=C)C(C(O1)=O)=O)=O,,,5,1,1,0,1
48679_0,,,,2,1,2,3
C(C)(C1C(C=C)C(C(O1)=O)=O)=O,,,5,1,1,0,1
48680_0,,,,2,1,2,3
48682_0,,,,2,1,2,3
C(C(C1CC(C(O1)=O)=C)O)=O,,,5,1,1,0,1
48683_0,,,,2,1,2,3
48685_0,,,,2,1,2,3
C=C1C(OC(CC(C=O)=O)C1)=O,,,5,1,1,0,1
48687_0,,,,2,1,2,3
C(C1C(C(OC1CO)=O)=C)=O,,,5,1,1,0,1
48689_0,,,,2,1,2,3
C(C1C(C(OC1C(C)O)=O)=C)=O,,,5,1,1,0,1
48691_0,,,,2,1,2,3
C(C1C(C(OC1C(O)=O)=O)=C)=O,,,5,1,1,0,1
48692_0,,,,2,1,2,3
48693_0,,,,2,1,2,3
48695_0,,,,2,1,2,3
C(C1C(C(OC1(C=O)C)=O)=C)=O,,,5,1,1,0,1
48697_0,,,,2,1,2,3
C(C1C(C(OC1C(C)=O)=O)=C)=O,,,5,1,1,0,1
48698_0,,,,2,1,2,3
48700_0,,,,2,1,1,2
C(CC1(C(O)=O)CC(C(O1)=O)=C)=O,,,5,1,1,0,1
48702_0,,,,2,1,1,2
C=C(C(O)=O)C1C(C(OC1C)=O)=O,,,5,1,1,0,1
48704_0,,,,2,1,1,2
C=C1C(OC(C)C1C(C(O)=O)=O)=O,,,5,1,1,0,1
48706_0,,,,2,1,1,2
C1(C(C(C(O1)=O)=O)C(C(O)=O)=C)=O,,,5,1,1,0,1
48708_0,,,,2,1,1,2
C1(C(C(C(O)=O)=O)C(C(O1)=O)=C)=O,,,5,1,1,0,1
48709_0,,,,2,1,1,2
48710_0,,,,2,1,1,2
48712_0,,,,2,1,2,3
C1(C(C=O)C(C(CO)O1)O)=O,,,5,1,1,0,1
48713_0,,,,2,1,2,3
48714_0,,,,2,1,2,3
48716_0,,,,2,1,1,2
C1(C(C(C(CO)O1)C(C)O)=O)=O,,,5,1,2,0,2
48718_0,,,,2,1,1,2
C(C1C(C(OC1CO)=O)=O)(O)=O,,,5,1,2,0,2
48720_0,,,,2,1,1,2
C1(C(C(C(O)=O)=O)C(CO1)O)=O,,,5,1,2,0,2
48721_0,,,,2,1,2,3
48722_0,,,,2,1,2,3
48724_0,,,,2,1,2,3
C1(C(C=O)C(CO1)O)=O,,,5,1,1,0,1
48726_0,,,,2,1,2,3
C(C1C(CO)OC(C1(C)O)=O)=O,,,5,1,1,0,1
48727_0,,,,2,1,2,3
48728_0,,,,2,1,2,3
48729_0,,,,2,1,2,3
48731_0,,,,2,1,2,3
C1(C(C(C(CO)O1)O)=O)=O,,,5,1,1,0,1
48733_0,,,,2,1,2,3
C1(C(CC(CO)O1)=O)=O,,,5,1,1,0,1
48735_0,,,,2,1,1,2
C1(CC(C(O)=O)(C(C=O)O1)O)=O,,,5,1,2,0,2
48736_0,,,,2,1,2,3
48737_0,,,,2,1,2,3
48739_0,,,,2,1,2,3
C1(C(C)(CC(C(C=O)O)O1)O)=O,,,5,1,1,0,1
48740_0,,,,2,1,2,3
48741_0,,,,2,1,2,3
48743_0,,,,2,1,1,2
C1(C(C(C(C(C)O)O1)C(C)O)=O)=O,,,5,1,1,0,1
48745_0,,,,2,1,1,2
C(C1C(C(C(O1)=O)=O)C(C)O)(O)=O,,,5,1,1,0,1
48746_0,,,,2,1,1,2
48747_0,,,,2,1,1,2
48748_0,,,,2,1,1,2
48749_0,,,,2,1,1,2
48750_0,,,,2,1,1,2
48752_0,,,,2,1,1,2
C(C1C(C(OC1C(C)O)=O)=O)(O)=O,,,5,1,1,0,1
48754_0,,,,2,1,1,2
C1(C(C(C(O)=O)=O)C(C(C)O1)O)=O,,,5,1,1,0,1
48756_0,,,,2,1,1,2
C(C1C(C(OC1C(O)=O)=O)=O)(O)=O,,,5,1,1,0,1
48758_0,,,,2,1,1,2
C1(C(C(C(O)=O)=O)C(C(O1)=O)O)=O,,,5,1,1,0,1
48759_0,,,,2,1,1,2
48760_0,,,,2,1,1,2
48761_0,,,,2,1,1,2
48762_0,,,,2,1,1,2
48763_0,,,,2,1,1,2
48764_0,,,,2,1,2,3
48765_0,,,,2,1,2,3
48767_0,,,,2,1,2,3
[CH](C(O)=O)CC1C(C(OC1)=O)=O,,,5,1,2,0,2
48769_0,,,,2,1,2,3
C(CCC1C(C(OC1)=O)=O)(O)=O,,,5,1,2,0,2
48771_0,,,,2,1,2,3
C1(C(C=O)C(C(C)O1)O)=O,,,5,1,1,0,1
48773_0,,,,2,1,2,3
C1(C(C(C(C(C)O)O1)O)=O)=O,,,5,1,1,0,1
48775_0,,,,2,1,2,3
C1(C(CC(C(C)O)O1)=O)=O,,,5,1,1,0,1
48776_0,,,,2,1,2,3
48777_0,,,,2,1,2,3
48779_0,,,,2,1,2,3
C(C1C(C(C(O1)=O)=O)O)(O)=O,,,5,1,1,0,1
48780_0,,,,2,1,2,3
48781_0,,,,2,1,2,3
48782_0,,,,2,1,2,3
48783_0,,,,2,1,2,3
48784_0,,,,2,1,2,3
48785_0,,,,2,1,2,3
48786_0,,,,2,1,2,3
48787_0,,,,2,1,2,3
48788_0,,,,2,1,2,3
48789_0,,,,2,1,2,3
48790_0,,,,2,1,2,3
48791_0,,,,2,1,2,3
48792_0,,,,2,1,2,3
48793_0,,,,2,1,2,3
48795_0,,,,2,1,2,3
C1(C(CO)(CC(C(O)=O)O1)O)=O,,,5,1,1,0,1
48796_0,,,,2,1,2,3
48797_0,,,,2,1,2,3
48798_0,,,,2,1,2,3
48799_0,,,,2,1,2,3
48800_0,,,,2,1,2,3
48801_0,,,,2,1,2,3
48802_0,,,,2,1,2,3
48803_0,,,,2,1,2,3
48804_0,,,,2,1,2,3
48805_0,,,,2,1,2,3
48806_0,,,,2,1,2,3
48807_0,,,,2,1,2,3
48808_0,,,,2,1,2,3
48809_0,,,,2,1,2,3
48810_0,,,,2,1,2,3
48811_0,,,,2,1,2,3
48812_0,,,,2,1,2,3
48813_0,,,,2,1,2,3
48814_0,,,,2,1,2,3
48815_0,,,,2,1,2,3
48816_0,,,,2,1,2,3
48817_0,,,,2,1,2,3
48819_0,,,,2,1,2,3
C1(C(CO)(C(CO1)C(C)O)O)=O,,,5,1,1,0,1
48820_0,,,,2,1,2,3
48822_0,,,,2,1,2,3
C1(C(C)(C(CO1)C(C)O)O)=O,,,5,1,1,0,1
48823_0,,,,2,1,2,3
48825_0,,,,2,1,2,3
C1(C(CCO1)(CC(C)O)O)=O,,,5,1,1,0,1
48826_0,,,,2,1,2,3
48827_0,,,,2,1,2,3
48828_0,,,,2,1,2,3
48830_0,,,,2,1,2,3
C(C1COC(C1(CO)O)=O)(O)=O,,,5,1,1,0,1
48831_0,,,,2,1,2,3
48832_0,,,,2,1,2,3
48833_0,,,,2,1,2,3
48834_0,,,,2,1,2,3
48835_0,,,,2,1,2,3
48837_0,,,,2,1,2,3
C1(C(CCO1)(CC(O)=O)O)=O,,,5,1,1,0,1
48838_0,,,,2,1,2,3
48840_0,,,,2,1,2,3
C1(C(CO)(CCO1)O)=O,,,5,1,1,0,1
48841_0,,,,2,1,2,3
48843_0,,,,2,1,2,3
C1(C(CO)(C(C)(CO1)O)O)=O,,,5,1,1,0,1
48844_0,,,,2,1,2,3
48845_0,,,,2,1,2,3
48847_0,,,,2,1,2,3
C1(C(C(C)(CO1)O)O)=O,,,5,1,1,0,1
48849_0,,,,2,1,2,3
C1(C(C)(C(C)(CO1)O)O)=O,,,5,1,1,0,1
48850_0,,,,2,1,2,3
48851_0,,,,2,1,2,3
48852_0,,,,2,1,2,3
48853_0,,,,2,1,2,3
48854_0,,,,2,1,2,3
48856_0,,,,2,1,2,3
C1(C(C(C)O)C(C=O)(CO1)O)=O,,,5,1,1,0,1
48857_0,,,,2,1,2,3
48858_0,,,,2,1,2,3
48860_0,,,,2,1,2,3
C1(C(CC(C)O)(CC(O1)=O)O)=O,,,5,1,1,0,1
48861_0,,,,2,1,2,3
48862_0,,,,2,1,2,3
48863_0,,,,2,1,2,3
48864_0,,,,2,1,2,3
48865_0,,,,2,1,2,3
48867_0,,,,2,1,2,3
C(C1(COC(C1)=O)O)=O,,,5,1,1,0,1
48869_0,,,,2,1,2,3
C(C1(COC(C1)=O)O)(O)=O,,,5,1,1,0,1
48870_0,,,,2,1,2,3
48871_0,,,,2,1,2,3
48872_0,,,,2,1,2,3
48873_0,,,,2,1,2,3
48875_0,,,,2,1,2,3
C(C1(COC(C1O)=O)C(C)O)=O,,,5,1,1,0,1
48877_0,,,,2,1,2,3
C(C1(CO)C(C)OC(C1O)=O)=O,,,5,1,1,0,1
48879_0,,,,2,1,2,3
C1(C(C=O)(C(C)O)C(CO1)O)=O,,,5,1,1,0,1
48880_0,,,,2,1,2,3
48881_0,,,,2,1,2,3
48883_0,,,,2,1,2,3
C1(C(C(CC=O)O)C(CO1)O)=O,,,5,1,1,0,1
48885_0,,,,2,1,2,3
C1(C(C=O)(CO)C(C)(CO1)O)=O,,,5,1,1,0,1
48887_0,,,,2,1,2,3
C1(C(C=O)(CO)C(CO1)O)=O,,,5,1,1,0,1
48889_0,,,,2,1,2,3
C1(C(C=O)(CO)C(C(C)O1)O)=O,,,5,1,1,0,1
48891_0,,,,2,1,2,3
C(C1(C=O)COC(C1O)=O)(O)=O,,,5,1,1,0,1
48893_0,,,,2,1,2,3
C1(C(C=O)(CO)C(C(O1)=O)O)=O,,,5,1,1,0,1
48895_0,,,,2,1,2,3
C1(C(C(O)=O)(C=O)C(CO1)O)=O,,,5,1,1,0,1
48896_0,,,,2,1,2,3
48897_0,,,,2,1,2,3
48898_0,,,,2,1,2,3
48900_0,,,,2,1,2,3
C1(C(C(C(C=O)=O)(CO1)O)O)=O,,,5,1,1,0,1
48902_0,,,,2,1,2,3
C1(C(C(C=O)=O)(C(CO1)O)O)=O,,,5,1,1,0,1
48904_0,,,,2,1,2,3
C1(C(C(CO)(C(CO)O1)O)=O)=O,,,5,1,1,0,1
48905_0,,,,2,1,2,3
48906_0,,,,2,1,2,3
48907_0,,,,2,1,2,3
48908_0,,,,2,1,2,3
48909_0,,,,2,1,2,3
48910_0,,,,2,1,2,3
48911_0,,,,2,1,2,3
48912_0,,,,2,1,2,3
48913_0,,,,2,1,2,3
48914_0,,,,2,1,2,3
48915_0,,,,2,1,2,3
48917_0,,,,2,1,2,3
C(C1[C](C(OC1C=O)=O)O)(O)=O,,,5,1,1,0,1
48918_0,,,,2,1,2,3
48920_0,,,,2,1,2,3
C1(C(C(C(O)=O)C(C=O)O1)O)=O,,,5,1,1,0,1
48922_0,,,,2,1,2,3
C(C1(C=O)C(C(C(O1)=O)O)O)=O,,,5,1,1,0,1
48924_0,,,,2,1,2,3
C(C1(C=O)C(CC(O1)=O)O)=O,,,5,1,1,0,1
48926_0,,,,2,1,2,3
C1(C(C=O)(C(C(C=O)O1)O)O)=O,,,5,1,1,0,1
48928_0,,,,2,1,2,3
C1(C(C=O)(C(CO)(CO1)O)O)=O,,,5,1,1,0,1
48930_0,,,,2,1,2,3
C1(C(C=O)(C(C)(CO1)O)O)=O,,,5,1,1,0,1
48932_0,,,,2,1,2,3
C1(C(C=O)(C(C(CO)O1)O)O)=O,,,5,1,1,0,1
48934_0,,,,2,1,2,3
C1(C(C=O)(C(CO1)O)O)=O,,,5,1,1,0,1
48936_0,,,,2,1,2,3
C1(C(C=O)(C(C(C)O1)O)O)=O,,,5,1,1,0,1
48938_0,,,,2,1,2,3
C1(C(C=O)(C(C(O1)=O)O)O)=O,,,5,1,1,0,1
48940_0,,,,2,1,2,3
C(C1(C=O)C(CC(O1)=O)O)(O)=O,,,5,1,1,0,1
48942_0,,,,2,1,2,3
C1(C(C=O)(C(C=O)(CO1)O)O)=O,,,5,1,1,0,1
48944_0,,,,2,1,2,3
C1(C(C=O)(C(C(O1)=O)(C)O)O)=O,,,5,1,1,0,1
48945_0,,,,2,1,2,3
48947_0,,,,2,1,2,3
C1(C(CO)C(CO1)(CO)O)=O,,,5,1,1,0,1
48949_0,,,,2,1,2,3
C1(C(CO)C(C)(CO1)O)=O,,,5,1,1,0,1
48951_0,,,,2,1,2,3
C1(C(CO)C(C(CO)O1)O)=O,,,5,1,1,0,1
48953_0,,,,2,1,2,3
C1(C(CO)C(CO1)O)=O,,,5,1,1,0,1
48955_0,,,,2,1,2,3
C1(C(CO)C(C(C)O1)O)=O,,,5,1,1,0,1
48956_0,,,,2,1,2,3
48958_0,,,,2,1,2,3
C(C1COC(C1O)=O)(O)=O,,,5,1,1,0,1
48960_0,,,,2,1,2,3
C1(C(C(C)O)C(CO1)(CO)O)=O,,,5,1,1,0,1
48962_0,,,,2,1,2,3
C1(C(C(O)=O)C(CO1)(CO)O)=O,,,5,1,1,0,1
48964_0,,,,2,1,2,3
C1(C(C(C)O)C(C)(CO1)O)=O,,,5,1,1,0,1
48966_0,,,,2,1,2,3
C1(C(C(O)=O)C(CO1)(C)O)=O,,,5,1,1,0,1
48968_0,,,,2,1,2,3
C1(C(C(C)O)(C(C)(CO1)O)O)=O,,,5,1,1,0,1
48970_0,,,,2,1,2,3
C1(C(C(O)=O)(C(CO1)(C)O)O)=O,,,5,1,1,0,1
48972_0,,,,2,1,2,3
C1(C(C(C)=O)(C)C(C)(CO1)O)=O,,,5,1,1,0,1
48974_0,,,,2,1,2,3
C1(C(C(C)O)C(C(CO)O1)O)=O,,,5,1,1,0,1
48976_0,,,,2,1,2,3
C1(C(C(C)O)C(CO1)O)=O,,,5,1,1,0,1
48978_0,,,,2,1,2,3
C1(C(C(C)O)C(C(C)O1)O)=O,,,5,1,1,0,1
48979_0,,,,2,1,2,3
48981_0,,,,2,1,2,3
C(C1C(C)OC(C1O)=O)(O)=O,,,5,1,1,0,1
48983_0,,,,2,1,2,3
C1(C(C(O)=O)C(C(CO)O1)O)=O,,,5,1,1,0,1
48985_0,,,,2,1,2,3
C1(C(C(O)=O)C(CO1)O)=O,,,5,1,1,0,1
48987_0,,,,2,1,2,3
C1(C(C(O)=O)C(C(C)O1)O)=O,,,5,1,1,0,1
48988_0,,,,2,1,2,3
48990_0,,,,2,1,2,3
C(CO)(C1(COC(C1O)=O)O)=O,,,5,1,1,0,1
48992_0,,,,2,1,2,3
C(C)(C1(C(C)OC(C1O)=O)O)=O,,,5,1,1,0,1
48994_0,,,,2,1,2,3
C1(C(C(C)=O)(C(C(O1)=O)O)O)=O,,,5,1,1,0,1
48996_0,,,,2,1,2,3
C(C)(C1(COC(C1O)=O)O)=O,,,5,1,1,0,1
48998_0,,,,2,1,2,3
C1(C(C)(C(C(C)=O)(CO1)O)O)=O,,,5,1,1,0,1
49000_0,,,,2,1,2,3
C1(C(C(C)O)(C(CO1)O)O)=O,,,5,1,1,0,1
49001_0,,,,2,1,2,3
49002_0,,,,2,1,2,3
49003_0,,,,2,1,2,3
49005_0,,,,2,1,2,3
C1(C(C(O)=O)(C(CO1)O)O)=O,,,5,1,1,0,1
49006_0,,,,2,1,2,3
49007_0,,,,2,1,2,3
49009_0,,,,2,1,2,3
C1(C(C(C)=O)(CO)C(CO1)O)=O,,,5,1,1,0,1
49011_0,,,,2,1,2,3
C1(C(C(C)=O)(C)C(CO1)O)=O,,,5,1,1,0,1
49013_0,,,,2,1,2,3
C1(C(C(C)=O)(C)C(C(C)O1)O)=O,,,5,1,1,0,1
49015_0,,,,2,1,2,3
C(C)(C1(C(OC(C1O)=O)=O)C)=O,,,5,1,1,0,1
49016_0,,,,2,1,2,3
49018_0,,,,2,1,2,3
C(C1(CO)C(CC(O1)=O)O)=O,,,5,1,1,0,1
49020_0,,,,2,1,2,3
C1(C(CO)(C(C(CO)O1)O)O)=O,,,5,1,1,0,1
49021_0,,,,2,1,2,3
49023_0,,,,2,1,2,3
C(C1[C](C(OC1CO)=O)O)(O)=O,,,5,1,1,0,1
49025_0,,,,2,1,2,3
C1(C([C](C(O)=O)O)C(CO1)O)=O,,,5,1,1,0,1
49026_0,,,,2,1,2,3
49028_0,,,,2,1,2,3
C(C1C(CO)OC(C1O)=O)(O)=O,,,5,1,1,0,1
49030_0,,,,2,1,2,3
C1(C(C(CO1)O)C(C(O)=O)O)=O,,,5,1,1,0,1
49032_0,,,,2,1,2,3
C1(C(CO)(C(CO1)O)O)=O,,,5,1,1,0,1
49034_0,,,,2,1,2,3
C(C1[C](C(OC1C)=O)O)(O)=O,,,5,1,1,0,1
49035_0,,,,2,1,2,3
49036_0,,,,2,1,2,3
49038_0,,,,2,1,2,3
C(C1[C](C(OC1)=O)O)(O)=O,,,5,1,1,0,1
49039_0,,,,2,1,2,3
49041_0,,,,2,1,2,3
C1(C(C=O)C(C(C)=O)(CO1)O)=O,,,5,1,1,0,1
49043_0,,,,2,1,2,3
C1(C(CO)C(C(C=O)(C)O1)O)=O,,,5,1,1,0,1
49045_0,,,,2,1,2,3
C(C1(C(CO)OC(C1O)=O)O)=O,,,5,1,1,0,1
49046_0,,,,2,1,2,3
49048_0,,,,2,1,2,3
C1(CC(C=O)(C(C=O)(C)O1)O)=O,,,5,1,1,0,1
49050_0,,,,2,1,2,3
C1(CC(C=O)(C(C(O)=O)O1)O)=O,,,5,1,1,0,1
49052_0,,,,2,1,2,3
C(C(C)(C1C(CC(O1)=O)=O)O)=O,,,5,1,1,0,1
49053_0,,,,2,1,2,3
49055_0,,,,2,1,2,3
C1(C(CCO)(C(C(O1)=O)O)O)=O,,,5,1,1,0,1
49056_0,,,,2,1,2,3
49058_0,,,,2,1,2,3
C(C1(C)C(C(C(O1)=O)=O)(C)O)=O,,,5,1,1,0,1
49060_0,,,,2,1,2,3
C(C1C(C(C(O1)=O)=O)(C)O)(O)=O,,,5,1,1,0,1
49062_0,,,,2,1,2,3
C1(C(C(C(C(O)=O)O1)O)O)=O,,,5,1,1,0,1
49064_0,,,,2,1,2,3
C1(C(C)(C(C(C=O)(C)O1)O)O)=O,,,5,1,1,0,1
49066_0,,,,2,1,2,3
C1(C(C)C(C)(C(C=O)(C)O1)O)=O,,,5,1,1,0,1
49068_0,,,,2,1,2,3
C1(C(C)C(C)(C(C(O)=O)O1)O)=O,,,5,1,1,0,1
49070_0,,,,2,1,2,3
C1(C(C=CC)(C(C(O1)=O)O)O)=O,,,5,1,1,0,1
49072_0,,,,2,1,2,3
C1(C(C(C(O1)=O)(CC=C)O)O)=O,,,5,1,1,0,1
49074_0,,,,2,1,2,3
C(C(C)(C1CC(C(O1)=O)=C)O)=O,,,5,1,1,0,1
49076_0,,,,2,1,2,3
C(C(C1CC(C(O1)=O)=C)O)(O)=O,,,5,1,1,0,1
49077_0,,,,2,1,2,3
49079_0,,,,2,1,2,3
C1(C(C)(C(C(CO)O1)O)O)=O,,,5,1,1,0,1
49081_0,,,,2,1,2,3
C1(C(C(C(CO)O1)O)O)=O,,,5,1,1,0,1
49082_0,,,,2,1,2,3
49084_0,,,,2,1,2,3
C1(C(C(CO1)O)(CC(C)O)O)=O,,,5,1,1,0,1
49085_0,,,,2,1,2,3
49087_0,,,,2,1,2,3
C1(C(C(CO1)O)(CC(O)=O)O)=O,,,5,1,1,0,1
49089_0,,,,2,1,2,3
C(C1(C(CO)OC(C1)=O)O)(O)=O,,,5,1,1,0,1
49091_0,,,,2,1,1,2
C1(C(CC(C)O)(C(C(O1)=O)O)O)=O,,,5,1,1,0,1
49093_0,,,,2,1,1,2
C1(CC(C(O)=O)(C(C=O)(C)O1)O)=O,,,5,1,1,0,1
49095_0,,,,2,1,1,2
C1(C(C(C(O1)=O)(CC(O)=O)O)O)=O,,,5,1,1,0,1
49097_0,,,,2,1,1,2
C1(CC(C(O)=O)(C(C(O)=O)O1)O)=O,,,5,1,1,0,1
49098_0,,,,2,1,2,3
49099_0,,,,2,1,2,3
49100_0,,,,2,1,1,2
49101_0,,,,2,1,1,2
49102_0,,,,2,1,2,3
49103_0,,,,2,1,2,3
49104_0,,,,2,1,2,3
49105_0,,,,2,1,2,3
49106_0,,,,2,1,2,3
49107_0,,,,2,1,2,3
49109_0,,,,2,1,2,3
C(C1(C)C(CC(O1)=O)O)=O,,,5,1,1,0,1
49111_0,,,,2,1,2,3
C1(C(C)(C(C(C)O1)O)O)=O,,,5,1,1,0,1
49112_0,,,,2,1,2,3
49113_0,,,,2,1,2,3
49114_0,,,,2,1,2,3
49115_0,,,,2,1,2,3
49117_0,,,,2,1,2,3
C(C1(C(C)OC(C1)=O)O)(O)=O,,,5,1,1,0,1
49118_0,,,,2,1,2,3
49119_0,,,,2,1,2,3
49120_0,,,,2,1,2,3
49121_0,,,,2,1,2,3
49122_0,,,,2,1,2,3
49123_0,,,,2,1,2,3
49124_0,,,,2,1,1,2
49125_0,,,,2,1,1,2
49126_0,,,,2,1,2,3
49127_0,,,,2,1,2,3
49128_0,,,,2,1,2,3
49129_0,,,,2,1,2,3
49130_0,,,,2,1,2,3
49131_0,,,,2,1,2,3
49132_0,,,,2,1,2,3
49133_0,,,,2,1,1,2
49134_0,,,,2,1,1,2
49135_0,,,,2,1,2,3
49136_0,,,,2,1,2,3
49137_0,,,,2,1,2,3
49138_0,,,,2,1,1,2
49139_0,,,,2,1,1,2
49140_0,,,,2,1,1,2
49141_0,,,,2,1,1,2
49142_0,,,,2,1,1,2
49144_0,,,,2,1,2,3
C1(CC(C(CO)(C(C)O)O1)O)=O,,,5,1,1,0,1
49146_0,,,,2,1,2,3
C1(C(C)(C(CO1)(C(C)O)O)O)=O,,,5,1,1,0,1
49147_0,,,,2,1,2,3
49148_0,,,,2,1,2,3
49149_0,,,,2,1,2,3
49150_0,,,,2,1,2,3
49152_0,,,,2,1,2,3
C1(CC(C(C(C=O)O)O1)O)=O,,,5,1,2,0,2
49154_0,,,,2,1,2,3
C1(CC(C(CO)O1)O)=O,,,5,1,1,0,1
49155_0,,,,2,1,2,3
49157_0,,,,2,1,2,3
C(C)(C1C([C](C(O1)=O)O)O)=O,,,5,1,1,0,1
49159_0,,,,2,1,2,3
C1(C(C)C(CO1)O)=O,,,5,1,1,0,1
49161_0,,,,2,1,2,3
[CH]1C(OC(CO)(C(C)O)C1)=O,,,5,1,1,0,1
49163_0,,,,2,1,2,3
C1(CCC(CO)(C(C)O)O1)=O,,,5,1,1,0,1
49164_0,,,,2,1,2,3
49165_0,,,,2,1,2,3
49167_0,,,,2,1,2,3
C(C(C1C[CH]C(O1)=O)O)=O,,,5,1,2,0,2
49169_0,,,,2,1,2,3
C1(CCC(C(C=O)O)O1)=O,,,5,1,2,0,2
49170_0,,,,2,1,2,3
49171_0,,,,2,1,2,3
49172_0,,,,2,1,2,3
49173_0,,,,2,1,2,3
49174_0,,,,2,1,2,3
49176_0,,,,2,1,2,3
C1(C2(COC(C2C(C)O)O1)O)=O,,,5,1,1,0,1
49177_0,,,,2,1,2,3
49178_0,,,,2,1,2,3
49179_0,,,,2,1,2,3
49181_0,,,,2,1,2,3
C(C1C2OCC1(C(O2)=O)O)(O)=O,,,5,1,1,0,1
49182_0,,,,2,1,2,3
49184_0,,,,2,1,2,3
C1(C2(CC(C(O2)=O)=O)OCC1)=O,,,5,1,1,0,1
49185_0,,,,2,1,2,3
49186_0,,,,2,1,2,3
49188_0,,,,2,1,2,3
C1(C2(COC(C=O)(C2O)O1)O)=O,,,5,1,1,0,1
49190_0,,,,2,1,2,3
C1(C2(COC(C=O)(C2)O1)O)=O,,,5,1,1,0,1
49191_0,,,,2,1,2,3
49192_0,,,,2,1,1,2
49194_0,,,,2,1,2,3
C1(C2(COC(C2)O1)O)=O,,,5,1,1,0,1
49195_0,,,,2,1,2,3
49197_0,,,,2,1,2,3
C1(C2(COC(C(O)=O)(C2)O1)O)=O,,,5,1,1,0,1
49198_0,,,,2,1,2,3
49199_0,,,,2,1,2,3
49201_0,,,,2,1,2,3
C1(C2(C(C(C)(OC2)O1)=O)O)=O,,,5,1,1,0,1
49203_0,,,,2,1,2,3
C1(C2(COC(CO)(C2O)O1)O)=O,,,5,1,1,0,1
49204_0,,,,2,1,2,3
49206_0,,,,2,1,2,3
C1(C2(COC(C2(CO)O)O1)O)=O,,,5,1,1,0,1
49208_0,,,,2,1,2,3
C1(C2(COC(C2(C)O)O1)O)=O,,,5,1,1,0,1
49210_0,,,,2,1,2,3
C1(C2(COC(C)(C2O)O1)O)=O,,,5,1,1,0,1
49212_0,,,,2,1,2,3
C1(C2CC(C(O)=O)(OC2)O1)=O,,,5,1,1,0,1
49213_0,,,,2,1,2,3
49214_0,,,,2,1,2,3
49216_0,,,,2,1,2,3
C1(C2(CC(OC(C)C2)O1)O)=O,,,5,1,1,0,1
49217_0,,,,2,1,2,3
49218_0,,,,2,1,2,3
49219_0,,,,2,1,2,3
49221_0,,,,2,1,2,3
C1(C2(CC(O1)OC(C2)=O)O)=O,,,5,1,2,0,2
49222_0,,,,2,1,2,3
49223_0,,,,2,1,2,3
49224_0,,,,2,1,2,3
49225_0,,,,2,1,2,3
49226_0,,,,2,1,1,2
49228_0,,,,2,1,2,3
C1(CC2C(C(C(O2)=O)=O)O1)=O,,,5,1,2,0,2
49229_0,,,,2,1,2,3
49230_0,,,,2,1,1,2
49231_0,,,,2,1,1,2
49232_0,,,,2,1,1,2
49233_0,,,,2,1,1,2
49234_0,,,,2,1,2,3
49235_0,,,,2,1,1,2
49236_0,,,,2,1,1,2
49237_0,,,,2,1,1,2
49238_0,,,,2,1,1,2
49239_0,,,,2,1,1,2
49240_0,,,,2,1,1,2
49241_0,,,,2,1,1,2
49242_0,,,,2,1,1,2
49243_0,,,,2,1,1,2
49244_0,,,,2,1,1,2
49245_0,,,,2,1,1,2
49246_0,,,,2,1,1,2
49247_0,,,,2,1,1,2
49248_0,,,,2,1,1,2
49249_0,,,,2,1,1,2
49250_0,,,,2,1,1,2
49251_0,,,,2,1,1,2
49252_0,,,,2,1,1,2
49253_0,,,,2,1,1,2
49254_0,,,,2,1,1,2
49255_0,,,,2,1,1,2
49256_0,,,,2,1,1,2
49257_0,,,,2,1,1,2
49258_0,,,,2,1,1,2
49259_0,,,,2,1,1,2
49260_0,,,,2,1,1,2
49261_0,,,,2,1,1,2
49262_0,,,,2,1,1,2
49263_0,,,,2,1,1,2
49264_0,,,,2,1,1,2
49265_0,,,,2,1,1,2
49266_0,,,,2,1,1,2
49267_0,,,,2,1,1,2
49268_0,,,,2,1,1,2
49270_0,,,,2,1,2,3
C(C(C1C[CH]C(O1)=O)C(C)O)=O,,,5,1,1,0,1
49272_0,,,,2,1,2,3
C(C(C1CCC(O1)=O)C(C)O)=O,,,5,1,1,0,1
49274_0,,,,2,1,2,3
C(C(C(O)=O)C1C[CH]C(O1)=O)=O,,,5,1,1,0,1
49276_0,,,,2,1,2,3
C(C(C(O)=O)C1CCC(O1)=O)=O,,,5,1,1,0,1
49278_0,,,,2,1,2,3
[CH]1C(OC(C(C(C=O)=O)O)C1)=O,,,5,1,1,0,1
49280_0,,,,2,1,2,3
C1(CCC(C(C(C=O)=O)O)O1)=O,,,5,1,1,0,1
49282_0,,,,2,1,2,3
C(CC1(C(C)=O)C[CH]C(O1)=O)=O,,,5,1,1,0,1
49284_0,,,,2,1,2,3
C(C)(C1(CCC(O1)=O)CC=O)=O,,,5,1,1,0,1
49286_0,,,,2,1,2,3
[CH]1C(OC(CC(C=O)=O)C1)=O,,,5,1,1,0,1
49288_0,,,,2,1,2,3
C1(CCC(CC(C=O)=O)O1)=O,,,5,1,1,0,1
49290_0,,,,2,1,2,3
[CH]1C(OC(C)(CC(C=O)=O)C1)=O,,,5,1,1,0,1
49292_0,,,,2,1,2,3
C1(CCC(C)(CC(C=O)=O)O1)=O,,,5,1,1,0,1
49294_0,,,,2,1,2,3
C(C1COC(C1(C)CC=O)=O)=O,,,5,1,1,0,1
49296_0,,,,2,1,2,3
C(CC1CC(C(O1)=O)CC=O)=O,,,5,1,1,0,1
49298_0,,,,2,1,2,3
C(CC1C(C=O)C(C(O1)=O)C)=O,,,5,1,1,0,1
49300_0,,,,2,1,2,3
C1(C(CC(CC=O)O1)C(C)O)=O,,,5,1,1,0,1
49302_0,,,,2,1,2,3
C1(C(C(O)=O)CC(CC=O)O1)=O,,,5,1,1,0,1
49304_0,,,,2,1,2,3
C(CC1C[CH]C(O1)=O)=O,,,5,1,1,0,1
49306_0,,,,2,1,2,3
C(CC1CCC(O1)=O)=O,,,5,1,1,0,1
49308_0,,,,2,1,2,3
C(CC(C)C1C(C(OC1)=O)=O)=O,,,5,1,2,0,2
49310_0,,,,2,1,2,3
C(CC(C)C1CC(C(O1)=O)=O)=O,,,5,1,2,0,2
49312_0,,,,2,1,2,3
[CH]1C(OC(CC(C(O)=O)=O)C1)=O,,,5,1,1,0,1
49314_0,,,,2,1,2,3
[CH](C(O)=O)CC1CC(C(O1)=O)=O,,,5,1,2,0,2
49316_0,,,,2,1,2,3
C1(CCC(CC(C(O)=O)=O)O1)=O,,,5,1,1,0,1
49318_0,,,,2,1,2,3
C(CCC1CC(C(O1)=O)=O)(O)=O,,,5,1,2,0,2
49320_0,,,,2,1,2,3
[CH]1C(OC(C(C(C)=O)=O)(C)C1)=O,,,5,1,1,0,1
49322_0,,,,2,1,2,3
C1(CCC(C(C(C)=O)=O)(C)O1)=O,,,5,1,1,0,1
49324_0,,,,2,1,2,3
C(C1(C=O)C[CH]C(O1)=O)=O,,,5,1,1,0,1
49326_0,,,,2,1,2,3
C(C1(C=O)CCC(O1)=O)=O,,,5,1,1,0,1
49328_0,,,,2,1,2,3
C(C1(C=O)C[CH]C(O1)=O)(O)=O,,,5,1,1,0,1
49330_0,,,,2,1,2,3
C(C1(C=O)CCC(O1)=O)(O)=O,,,5,1,1,0,1
49332_0,,,,2,1,2,3
[CH]1C(OC(CC(C)O)C1)=O,,,5,1,1,0,1
49334_0,,,,2,1,2,3
C1(CCC(CC(C)O)O1)=O,,,5,1,1,0,1
49336_0,,,,2,1,2,3
C(CC1C[CH]C(O1)=O)(O)=O,,,5,1,1,0,1
49338_0,,,,2,1,2,3
C1(CCC(CC(O)=O)O1)=O,,,5,1,1,0,1
49340_0,,,,2,1,2,3
C(C)(C1CC(C(O1)=O)CC=O)=O,,,5,1,1,0,1
49342_0,,,,2,1,2,3
C(C1C(C=O)C(C(O1)=O)C)(C)=O,,,5,1,1,0,1
49344_0,,,,2,1,2,3
C1(C(CC(C(C)=O)O1)C(C)O)=O,,,5,1,1,0,1
49346_0,,,,2,1,2,3
C(C1C(OC(C(C)=O)C1)=O)(O)=O,,,5,1,1,0,1
49348_0,,,,2,1,2,3
C(C)(C1C[CH]C(O1)=O)=O,,,5,1,1,0,1
49350_0,,,,2,1,2,3
C(C)(C1CCC(O1)=O)=O,,,5,1,1,0,1
49352_0,,,,2,1,2,3
C(CC1C(OCC1)=O)=O,,,5,1,1,0,1
49354_0,,,,2,1,2,3
C(C1COC(C1C)=O)=O,,,5,1,1,0,1
49356_0,,,,2,1,2,3
C1(C(CCO1)C(C)O)=O,,,5,1,1,0,1
49358_0,,,,2,1,2,3
C1(C(C(O)=O)CCO1)=O,,,5,1,1,0,1
49360_0,,,,2,1,2,3
C1(C(CCO1)C(C(O)=O)(C)O)=O,,,5,1,1,0,1
49362_0,,,,2,1,2,3
C1(C(CCO)C(C(O1)=O)(C)O)=O,,,5,1,2,0,2
49364_0,,,,2,1,2,3
C1(C(C)C2COC(C2(O)O1)=O)=O,,,5,1,1,0,1
49366_0,,,,2,1,1,2
C(C(C)C1C(C(OC1)=O)=O)(O)=O,,,5,1,2,0,2
49368_0,,,,2,1,1,2
C1(C(C)C(C(C(O)=O)=O)CO1)=O,,,5,1,2,0,2
49370_0,,,,2,1,1,2
C1(C(CCO1)CC(C(O)=O)=O)=O,,,5,1,2,0,2
49372_0,,,,2,1,2,3
C(C1(C)C([CH]C(O1)=O)CO)(O)=O,,,5,1,2,0,2
49374_0,,,,2,1,2,3
C(C(C)(C1[CH]C(OC1)=O)O)(O)=O,,,5,1,1,0,1
49376_0,,,,2,1,2,3
C1(C(C)(C([CH]C(O)=O)CO1)O)=O,,,5,1,1,0,1
49378_0,,,,2,1,2,3
C(C(C)C1[C](C(OC1)=O)O)(O)=O,,,5,1,1,0,1
49380_0,,,,2,1,2,3
C1(C(C)C([C](C(O)=O)O1)CO)=O,,,5,1,2,0,2
49382_0,,,,2,1,2,3
C1(C(C)C([C](C(O)=O)O)CO1)=O,,,5,1,1,0,1
49384_0,,,,2,1,2,3
C1(C(CCO)C[C](C(O)=O)O1)=O,,,5,1,2,0,2
49386_0,,,,2,1,2,3
C1(C(CCO1)C[C](C(O)=O)O)=O,,,5,1,1,0,1
49388_0,,,,2,1,2,3
C(C1(C)C(CO)CC(O1)=O)(O)=O,,,5,1,2,0,2
49390_0,,,,2,1,2,3
C(C(C)(C1COC(C1)=O)O)(O)=O,,,5,1,1,0,1
49392_0,,,,2,1,2,3
C1(C(C)(C(CO1)CC(O)=O)O)=O,,,5,1,1,0,1
49394_0,,,,2,1,2,3
C(C(C)C1COC(C1O)=O)(O)=O,,,5,1,1,0,1
49396_0,,,,2,1,2,3
C1(C(C)C(CO)C(C(O)=O)O1)=O,,,5,1,2,0,2
49398_0,,,,2,1,2,3
C1(C(C)C(CO1)C(C(O)=O)O)=O,,,5,1,1,0,1
49400_0,,,,2,1,2,3
C1(C(CC(C(O)=O)O1)CCO)=O,,,5,1,2,0,2
49402_0,,,,2,1,2,3
C1(C(CC(C(O)=O)O)CCO1)=O,,,5,1,1,0,1
49403_0,,,,2,1,2,3
49404_0,,,,2,1,2,3
49405_0,,,,2,1,2,3
49407_0,,,,2,1,2,3
[CH]1C(OCC1)=O,,,5,1,1,0,1
49409_0,,,,2,1,2,3
C1(CCCO1)=O,,,5,1,1,0,1
49411_0,,,,2,1,2,3
C(CC1(C(OCC1)=O)C)=O,,,5,1,1,0,1
49413_0,,,,2,1,1,2
C1(C(C)(CCO1)CC(C(O)=O)=O)=O,,,5,1,1,0,1
49415_0,,,,2,1,2,3
C(CC1C(OC(C)C1)=O)=O,,,5,1,1,0,1
49416_0,,,,2,1,2,3
49418_0,,,,2,1,2,3
C1(C(CC(C)O1)C(C)O)=O,,,5,1,1,0,1
49420_0,,,,2,1,2,3
C1(C(C(O)=O)CC(C)O1)=O,,,5,1,1,0,1
49422_0,,,,2,1,1,2
C(C(C)C1C(C(OC1C)=O)=O)(O)=O,,,5,1,1,0,1
49424_0,,,,2,1,1,2
C1(C(C)C(C(C(O)=O)=O)C(C)O1)=O,,,5,1,1,0,1
49426_0,,,,2,1,1,2
C1(C(CC(C)O1)CC(C(O)=O)=O)=O,,,5,1,1,0,1
49428_0,,,,2,1,2,3
[CH]1C(OC(C)C1)=O,,,5,1,1,0,1
49430_0,,,,2,1,2,3
C1(CCC(C)O1)=O,,,5,1,1,0,1
49432_0,,,,2,1,2,3
C(CC1(C(OC(C1)=O)=O)C)=O,,,5,1,1,0,1
49434_0,,,,2,1,2,3
C(C(C)(C1C[CH]C(O1)=O)O)(O)=O,,,5,1,1,0,1
49436_0,,,,2,1,2,3
C(C(C)(C1CCC(O1)=O)O)(O)=O,,,5,1,1,0,1
49438_0,,,,2,1,2,3
C(C(C1(C)C[CH]C(O1)=O)O)(O)=O,,,5,1,1,0,1
49440_0,,,,2,1,2,3
C1(CCC(C)(C(C(O)=O)O)O1)=O,,,5,1,1,0,1
49442_0,,,,2,1,2,3
C(C1CC(C(O1)=O)CC=O)=O,,,5,1,1,0,1
49444_0,,,,2,1,2,3
C(C1(C)CC(C(O1)=O)CC=O)=O,,,5,1,1,0,1
49446_0,,,,2,1,2,3
C(C1CC(C(O1)=O)CC=O)(O)=O,,,5,1,1,0,1
49448_0,,,,2,1,2,3
C1(C(CC(CO)O1)CC=O)=O,,,5,1,1,0,1
49450_0,,,,2,1,2,3
C(C1CC(C(O1)=O)(C)CC=O)=O,,,5,1,1,0,1
49452_0,,,,2,1,2,3
C1(C(C)(C(C(O1)=O)O)CC=O)=O,,,5,1,1,0,1
49454_0,,,,2,1,2,3
C1(C(C)(C(CO1)O)CC=O)=O,,,5,1,1,0,1
49456_0,,,,2,1,2,3
C(C1C(C=O)C(C(O1)=O)C)=O,,,5,1,1,0,1
49458_0,,,,2,1,2,3
C(C1(C)C(C=O)C(C(O1)=O)C)=O,,,5,1,1,0,1
49460_0,,,,2,1,2,3
C(C1C(C=O)C(C(O1)=O)C)(O)=O,,,5,1,1,0,1
49462_0,,,,2,1,2,3
C1(C(C)C(C=O)C(CO)O1)=O,,,5,1,1,0,1
49464_0,,,,2,1,2,3
C=C(C(O)=O)C1(C)C[CH]C(O1)=O,,,5,1,1,0,1
49466_0,,,,2,1,2,3
C1(CCC(C(C(O)=O)=C)(C)O1)=O,,,5,1,1,0,1
49468_0,,,,2,1,2,3
C1(C(CC(C=O)O1)C(C)O)=O,,,5,1,1,0,1
49470_0,,,,2,1,2,3
C1(C(CC(C=O)(C)O1)C(C)O)=O,,,5,1,1,0,1
49472_0,,,,2,1,2,3
C1(C(CC(C(O)=O)O1)C(C)O)=O,,,5,1,1,0,1
49474_0,,,,2,1,2,3
C1(C(CC(CO)O1)C(C)O)=O,,,5,1,1,0,1
49476_0,,,,2,1,2,3
C(C1C(OC(C=O)C1)=O)(O)=O,,,5,1,1,0,1
49478_0,,,,2,1,2,3
C(C1C(OC(C=O)(C)C1)=O)(O)=O,,,5,1,1,0,1
49480_0,,,,2,1,2,3
C(C1C(OC(C(O)=O)C1)=O)(O)=O,,,5,1,1,0,1
49482_0,,,,2,1,2,3
C1(C(C(O)=O)CC(CO)O1)=O,,,5,1,1,0,1
49484_0,,,,2,1,2,3
[CH]1C(OC(C(C(C)O)O)C1)=O,,,5,1,1,0,1
49486_0,,,,2,1,2,3
C1(CCC(C(C(C)O)O)O1)=O,,,5,1,1,0,1
49488_0,,,,2,1,2,3
C(C1(CO)C[CH]C(O1)=O)=O,,,5,1,1,0,1
49490_0,,,,2,1,2,3
C(C1(CCC(O1)=O)CO)=O,,,5,1,1,0,1
49492_0,,,,2,1,2,3
C1([CH]CC([CH]C(O)=O)O1)=O,,,5,1,1,0,1
49494_0,,,,2,1,2,3
C1(CCC([CH]C(O)=O)O1)=O,,,5,1,1,0,1
49496_0,,,,2,1,2,3
C1([CH]CC([C](C(O)=O)O)O1)=O,,,5,1,2,0,2
49498_0,,,,2,1,2,3
C1(CCC([C](C(O)=O)O)O1)=O,,,5,1,2,0,2
49500_0,,,,2,1,2,3
C(C1(C)C[CH]C(O1)=O)=O,,,5,1,1,0,1
49502_0,,,,2,1,2,3
C(C1(C)CCC(O1)=O)=O,,,5,1,1,0,1
49504_0,,,,2,1,2,3
[C]1(C(OC(CC(C)O)C1O)=O)O,,,5,1,1,0,1
49506_0,,,,2,1,2,3
[C]1(C(OC(CC(C)O)C1)=O)O,,,5,1,1,0,1
49508_0,,,,2,1,2,3
[C]1(C(OCC1C(C)O)=O)O,,,5,1,1,0,1
49510_0,,,,2,1,2,3
[C]1(C(OC(C)C1CO)=O)O,,,5,1,1,0,1
49512_0,,,,2,1,2,3
[C]1(C(OC(C)C1C(C)O)=O)O,,,5,1,1,0,1
49514_0,,,,2,1,2,3
C(CC1C([C](C(O1)=O)O)O)(O)=O,,,5,1,1,0,1
49516_0,,,,2,1,2,3
C1(CC(C([C](C(O)=O)O)O1)O)=O,,,5,1,2,0,2
49518_0,,,,2,1,2,3
C(CC1C[C](C(O1)=O)O)(O)=O,,,5,1,1,0,1
49520_0,,,,2,1,2,3
C(CO)(C1C([C](C(O1)=O)O)O)=O,,,5,1,1,0,1
49522_0,,,,2,1,2,3
C(CO)(C1C[C](C(O1)=O)O)=O,,,5,1,1,0,1
49524_0,,,,2,1,2,3
C(C1(CO)C([C](C(O1)=O)O)O)=O,,,5,1,1,0,1
49526_0,,,,2,1,2,3
C(C1(CO)C[C](C(O1)=O)O)=O,,,5,1,1,0,1
49528_0,,,,2,1,2,3
C(C1(C)C([C](C(O1)=O)O)O)=O,,,5,1,1,0,1
49530_0,,,,2,1,2,3
C(C1(C)C[C](C(O1)=O)O)=O,,,5,1,1,0,1
49532_0,,,,2,1,2,3
C(C)(C1C[C](C(O1)=O)O)=O,,,5,1,1,0,1
49534_0,,,,2,1,2,3
C=C(C(O)=O)C1[C](C(OC1)=O)O,,,5,1,1,0,1
49536_0,,,,2,1,2,3
C=C1C(O[C](C(O)=O)C1CO)=O,,,5,1,1,0,1
49538_0,,,,2,1,2,3
C=C1C(OCC1[C](C(O)=O)O)=O,,,5,1,2,0,2
49540_0,,,,2,1,2,3
[C]1(C(OCC1O)=O)O,,,5,1,1,0,1
49542_0,,,,2,1,2,3
[C]1(C(OCC1)=O)O,,,5,1,1,0,1
49544_0,,,,2,1,2,3
C(C1(CO)C[C](C(O1)=O)O)(O)=O,,,5,1,1,0,1
49546_0,,,,2,1,2,3
C1(C(CO)(C[C](C(O)=O)O1)O)=O,,,5,1,1,0,1
49548_0,,,,2,1,2,3
[C]1(C(OC(C)C1O)=O)O,,,5,1,1,0,1
49550_0,,,,2,1,2,3
C1(C([C](C(O1)=O)O)O)=O,,,5,1,1,0,1
49552_0,,,,2,1,2,3
C1(C(C)(C([C](C(O)=O)O1)O)O)=O,,,5,1,1,0,1
49554_0,,,,2,1,2,3
C(C1(C)C([C](C(O1)=O)O)O)(O)=O,,,5,1,1,0,1
49556_0,,,,2,1,2,3
C1([C](C(CO1)=O)O)=O,,,5,1,1,0,1
49558_0,,,,2,1,2,3
C1(C(CO)(CC(C=O)O1)O)=O,,,5,1,1,0,1
49560_0,,,,2,1,2,3
C1(C(C)(CC(C=O)O1)O)=O,,,5,1,1,0,1
49562_0,,,,2,1,2,3
C(C1(C(C(OC1)=O)=O)O)=O,,,5,1,1,0,1
49564_0,,,,2,1,2,3
C1(C(C(C(O1)=O)=O)(C)O)=O,,,5,1,1,0,1
49566_0,,,,2,1,2,3
C1(C(C(CO1)C(C)O)O)=O,,,5,1,1,0,1
49568_0,,,,2,1,2,3
C1(C(C(CO)C(C)O1)O)=O,,,5,1,1,0,1
49570_0,,,,2,1,2,3
C1(C(C(C(C)O)C(C)O1)O)=O,,,5,1,1,0,1
49572_0,,,,2,1,2,3
C1(C(C(C(C(O)=O)=C)CO1)O)=O,,,5,1,1,0,1
49574_0,,,,2,1,2,3
C(C1C(C(C(O1)=O)=C)CO)(O)=O,,,5,1,1,0,1
49576_0,,,,2,1,2,3
C(C(C1C(C(OC1)=O)=C)O)(O)=O,,,5,1,2,0,2
49578_0,,,,2,1,2,3
C1(CC(C(C(C=O)=O)CO1)O)=O,,,5,1,1,0,1
49580_0,,,,2,1,2,3
C1(CC(CC(C(C=O)O)O1)O)=O,,,5,1,1,0,1
49582_0,,,,2,1,2,3
C1(CC(CC(CC=O)O1)O)=O,,,5,1,1,0,1
49584_0,,,,2,1,2,3
C1(CC(C(C=O)C(C=O)O1)O)=O,,,5,1,1,0,1
49586_0,,,,2,1,2,3
C(C1C(CC(OC1CO)=O)O)=O,,,5,1,1,0,1
49588_0,,,,2,1,2,3
C(C1COC(CC1O)=O)=O,,,5,1,1,0,1
49590_0,,,,2,1,2,3
C1(C(CO)C(C(C=O)CO1)O)=O,,,5,1,1,0,1
49592_0,,,,2,1,2,3
C1(C(C(C(C(C=O)O1)O)=O)O)=O,,,5,1,1,0,1
49594_0,,,,2,1,2,3
C1(C(CC(C(CC=O)O1)=O)O)=O,,,5,1,1,0,1
49596_0,,,,2,1,2,3
C1(C(C=O)C(C=O)(CCO1)O)=O,,,5,1,1,0,1
49598_0,,,,2,1,2,3
C1(CC(C=O)(C(C=O)CO1)O)=O,,,5,1,1,0,1
49600_0,,,,2,1,2,3
C1(CC(C(C(C(C)=O)O1)O)=O)=O,,,5,1,1,0,1
49602_0,,,,2,1,2,3
C1(CC(C(C(C=O)O1)O)=O)=O,,,5,1,1,0,1
49604_0,,,,2,1,2,3
C1(C(C(C=O)=O)C(CCO1)O)=O,,,5,1,1,0,1
49606_0,,,,2,1,2,3
C1(C(C(CC(CCO)O1)=O)=O)=O,,,5,1,1,0,1
49608_0,,,,2,1,2,3
C1(C(C(CC(CCO)O1)=O)C)=O,,,5,1,1,0,1
49610_0,,,,2,1,1,2
C1(C(C(C(O)=O)=O)C(CCO1)O)=O,,,5,1,1,0,1
49612_0,,,,2,1,2,3
C(C1C(CCO)OC([CH]C1)=O)=O,,,5,1,1,0,1
49614_0,,,,2,1,2,3
C(C1CCC(OC1CCO)=O)=O,,,5,1,1,0,1
49616_0,,,,2,1,2,3
C1(C(C=O)C(CCO1)O)=O,,,5,1,1,0,1
49618_0,,,,2,1,2,3
C(C1COC(C(C1(C)O)=O)=O)=O,,,5,1,1,0,1
49620_0,,,,2,1,2,3
C(C1COC(C(C1O)O)=O)=O,,,5,1,1,0,1
49622_0,,,,2,1,2,3
C(C1COC(C(C1O)(C)O)=O)=O,,,5,1,1,0,1
49624_0,,,,2,1,2,3
C1(C(C)C(C)(C(C=O)CO1)O)=O,,,5,1,1,0,1
49626_0,,,,2,1,1,2
C1(CC(C(O)=O)(C(C=O)CO1)O)=O,,,5,1,1,0,1
49627_0,,,,2,1,2,3
49628_0,,,,2,1,2,3
49630_0,,,,2,1,2,3
C1(C(CCO)(CC(CO1)=O)O)=O,,,5,1,1,0,1
49632_0,,,,2,1,2,3
C1(C(C(CO)C(C)(CO1)O)=O)=O,,,5,1,1,0,1
49634_0,,,,2,1,2,3
C1(C(C(CO)C(CO1)O)=O)=O,,,5,1,1,0,1
49636_0,,,,2,1,2,3
C1(C(C(CO)C(C(C)O1)O)=O)=O,,,5,1,1,0,1
49638_0,,,,2,1,2,3
C1(C(C(C(C(O1)=O)=O)CO)O)=O,,,5,1,1,0,1
49640_0,,,,2,1,2,3
C1(C(C(C(C(C)O1)=O)=O)O)=O,,,5,1,1,0,1
49642_0,,,,2,1,2,3
C(C1C(C(C(C(O1)=O)=O)=O)O)=O,,,5,1,1,0,1
49644_0,,,,2,1,2,3
C1(C(C(C(C(CO)O1)O)=O)=O)=O,,,5,1,1,0,1
49646_0,,,,2,1,2,3
C1(C(C(C(C(C)O1)O)=O)=O)=O,,,5,1,1,0,1
49648_0,,,,2,1,2,3
C1(C(C(C(C(O1)=O)=O)=O)O)=O,,,5,1,1,0,1
49650_0,,,,2,1,2,3
C1(C(C(C(CO1)O)=O)=O)=O,,,5,1,1,0,1
49652_0,,,,2,1,2,3
C1(CC(C(C(C)O1)=O)=O)=O,,,5,1,1,0,1
49654_0,,,,2,1,2,3
C1(C(C(C)=O)(CC(CO1)=O)O)=O,,,5,1,1,0,1
49656_0,,,,2,1,2,3
C(C1CC(C(C(O1)=O)=O)=O)=O,,,5,1,1,0,1
49658_0,,,,2,1,2,3
C1(C(C(CC(C)(CO)O1)=O)=O)=O,,,5,1,1,0,1
49660_0,,,,2,1,2,3
C(C1CC(C(C(O1)=O)=O)=O)=CC,,,5,1,1,0,1
49662_0,,,,2,1,2,3
C=CCC1CC(C(C(O1)=O)=O)=O,,,5,1,1,0,1
49664_0,,,,2,1,2,3
C1(C(C(CC(CO)O1)=O)=O)=O,,,5,1,1,0,1
49666_0,,,,2,1,2,3
C1(C(C(CC(C(C)O)O1)=O)=O)=O,,,5,1,1,0,1
49668_0,,,,2,1,2,3
C(C1CC(C(C(O1)=O)=O)=O)(O)=O,,,5,1,1,0,1
49670_0,,,,2,1,2,3
C1(C(C(OC(C)C1)=O)=O)=O,,,5,1,1,0,1
49672_0,,,,2,1,2,3
C1(CC(C(C(O1)=O)=O)=O)=O,,,5,1,1,0,1
49674_0,,,,2,1,2,3
C(C1(C)CC(C(C(O1)=O)=O)=O)=O,,,5,1,1,0,1
49676_0,,,,2,1,2,3
C(C)(C1CC(C(C(O1)=O)=O)=O)=O,,,5,1,1,0,1
49678_0,,,,2,1,2,3
C1(C(C(OCC1)=O)=O)=O,,,5,1,1,0,1
49680_0,,,,2,1,2,3
C1(CC(C=O)OC(C1CO)=O)=O,,,5,1,1,0,1
49682_0,,,,2,1,2,3
C1(CC(C=O)OC(C1C)=O)=O,,,5,1,1,0,1
49684_0,,,,2,1,2,3
C(C1C(C=O)C[CH]C(O1)=O)=O,,,5,1,1,0,1
49686_0,,,,2,1,2,3
C(C1CCC(OC1C=O)=O)=O,,,5,1,1,0,1
49687_0,,,,2,1,2,3
49688_0,,,,2,1,2,3
49690_0,,,,2,1,2,3
C(C1C(C(C(OC1C)=O)O)O)=O,,,5,1,1,0,1
49692_0,,,,2,1,2,3
C1(C(C=O)C(C(C(O1)=O)O)O)=O,,,5,1,1,0,1
49694_0,,,,2,1,2,3
C(C1C(CC(C(O1)=O)=O)O)(O)=O,,,5,1,1,0,1
49695_0,,,,2,1,2,3
49696_0,,,,2,1,2,3
49698_0,,,,2,1,2,3
C1(C(C(CC(C)(CO)O1)=O)C)=O,,,5,1,1,0,1
49700_0,,,,2,1,2,3
C=CC1C(C(OCC1(C)O)=O)=O,,,5,1,1,0,1
49702_0,,,,2,1,2,3
C(C1C(C(OCC1(C)O)=O)=C)=O,,,5,1,1,0,1
49704_0,,,,2,1,1,2
C1(C(C(C(C)O)C(C)(CO1)O)=O)=O,,,5,1,1,0,1
49706_0,,,,2,1,1,2
C(C1C(C(OCC1(C)O)=O)=O)(O)=O,,,5,1,1,0,1
49708_0,,,,2,1,2,3
C(C1C(C)(CO)OC([CH]C1)=O)=O,,,5,1,1,0,1
49710_0,,,,2,1,2,3
C(C1CCC(OC1(C)CO)=O)=O,,,5,1,1,0,1
49712_0,,,,2,1,2,3
C1(C(C(C(C)(CO1)O)O)=O)=O,,,5,1,1,0,1
49714_0,,,,2,1,2,3
C1(C(CC(C)(CO1)O)=O)=O,,,5,1,1,0,1
49716_0,,,,2,1,2,3
C1(C(C=CC)(CC(CO1)=O)O)=O,,,5,1,1,0,1
49718_0,,,,2,1,2,3
C1(C(CC=C)(CC(CO1)=O)O)=O,,,5,1,1,0,1
49720_0,,,,2,1,1,2
C1(C(CC(C)O)(CC(CO1)=O)O)=O,,,5,1,1,0,1
49722_0,,,,2,1,1,2
C1(C(CC(O)=O)(CC(CO1)=O)O)=O,,,5,1,1,0,1
49724_0,,,,2,1,2,3
C(CO)(CC1CC[CH]C(O1)=O)=O,,,5,1,1,0,1
49726_0,,,,2,1,2,3
C1(CCCC(CC(CO)=O)O1)=O,,,5,1,1,0,1
49728_0,,,,2,1,2,3
C1(C(CC(CO1)=O)O)=O,,,5,1,1,0,1
49730_0,,,,2,1,2,3
C1(C(CO)(CC(CO1)=O)O)=O,,,5,1,1,0,1
49732_0,,,,2,1,2,3
C1(C(C)(CC(CO1)=O)O)=O,,,5,1,1,0,1
49734_0,,,,2,1,2,3
C(C)(C1C(CC(C(O1)=O)=C)O)=O,,,5,1,1,0,1
49736_0,,,,2,1,2,3
C(C)(C(C1CC[CH]C(O1)=O)O)=O,,,5,1,1,0,1
49738_0,,,,2,1,2,3
C1(CCCC(C(C(C)=O)O)O1)=O,,,5,1,1,0,1
49739_0,,,,2,1,2,3
49741_0,,,,2,1,2,3
C1(CC(C(C(C(O)=O)O1)O)=O)=O,,,5,1,1,0,1
49743_0,,,,2,1,2,3
C1(C(C(CC(CO)O1)=O)CO)=O,,,5,1,1,0,1
49744_0,,,,2,1,2,3
49745_0,,,,2,1,2,3
49746_0,,,,2,1,2,3
49748_0,,,,2,1,2,3
C1(C(C(CCO1)=O)CO)=O,,,5,1,1,0,1
49750_0,,,,2,1,2,3
C1(CC(C=CC)OC(C1C)=O)=O,,,5,1,1,0,1
49752_0,,,,2,1,2,3
C1(CC(CC=C)OC(C1C)=O)=O,,,5,1,1,0,1
49754_0,,,,2,1,2,3
C1(C(C(CC(CO)O1)=O)C)=O,,,5,1,1,0,1
49756_0,,,,2,1,2,3
C1(C(C(CC(C(C)O)O1)=O)C)=O,,,5,1,1,0,1
49758_0,,,,2,1,2,3
C1(CC(C(O)=O)OC(C1C)=O)=O,,,5,1,1,0,1
49759_0,,,,2,1,2,3
49760_0,,,,2,1,2,3
49762_0,,,,2,1,2,3
C(C1(C)CC(C(C(O1)=O)C)=O)=O,,,5,1,1,0,1
49764_0,,,,2,1,2,3
C1(CC(C(C)=O)OC(C1C)=O)=O,,,5,1,1,0,1
49766_0,,,,2,1,2,3
C1(CCOC(C1C)=O)=O,,,5,1,1,0,1
49768_0,,,,2,1,2,3
C(C1C(C=CC)OC([CH]C1)=O)=O,,,5,1,1,0,1
49770_0,,,,2,1,2,3
C(C1CCC(OC1C=CC)=O)=O,,,5,1,1,0,1
49772_0,,,,2,1,2,3
C(C1C(CC=C)OC([CH]C1)=O)=O,,,5,1,1,0,1
49774_0,,,,2,1,2,3
C(C1CCC(OC1CC=C)=O)=O,,,5,1,1,0,1
49776_0,,,,2,1,2,3
C(C(C=C)C1CC[CH]C(O1)=O)=O,,,5,1,1,0,1
49778_0,,,,2,1,2,3
C(C(C=C)C1CCCC(O1)=O)=O,,,5,1,1,0,1
49780_0,,,,2,1,2,3
C=CC1C(C(OCC1O)=O)=O,,,5,1,1,0,1
49782_0,,,,2,1,2,3
C=CC1C(C(OC(C)C1O)=O)=O,,,5,1,1,0,1
49784_0,,,,2,1,2,3
C1(C(C(C=C)C(C(O1)=O)=O)O)=O,,,5,1,1,0,1
49786_0,,,,2,1,2,3
C(C1C(CC(C(O1)=O)=C)O)=O,,,5,1,1,0,1
49788_0,,,,2,1,2,3
C(C1C(C(OCC1O)=O)=C)=O,,,5,1,1,0,1
49790_0,,,,2,1,2,3
C(C1C(C(OC(C)C1O)=O)=C)=O,,,5,1,1,0,1
49792_0,,,,2,1,2,3
C(C1C(C(OC(C1O)=O)=O)=C)=O,,,5,1,1,0,1
49794_0,,,,2,1,2,3
C1(C(C=O)C(C(CO1)O)O)=O,,,5,1,1,0,1
49795_0,,,,2,1,2,3
49797_0,,,,2,1,2,3
C1(C(CC(C(CO)O1)O)=O)=O,,,5,1,1,0,1
49799_0,,,,2,1,1,2
C1(C(C(C(C)O)C(CO1)O)=O)=O,,,5,1,2,0,2
49801_0,,,,2,1,1,2
C(C1C(C(OCC1O)=O)=O)(O)=O,,,5,1,2,0,2
49803_0,,,,2,1,2,3
C(C1C(CO)OC([CH]C1)=O)=O,,,5,1,1,0,1
49805_0,,,,2,1,2,3
C(C1CCC(OC1CO)=O)=O,,,5,1,1,0,1
49806_0,,,,2,1,2,3
49808_0,,,,2,1,2,3
C(C1C(COC(C1(C)O)=O)O)=O,,,5,1,1,0,1
49809_0,,,,2,1,2,3
49811_0,,,,2,1,2,3
C1(C(C(C(CO1)O)O)=O)=O,,,5,1,1,0,1
49813_0,,,,2,1,2,3
C1(C(CC(CO1)O)=O)=O,,,5,1,1,0,1
49815_0,,,,2,1,2,3
C(C(C1CC[CH]C(O1)=O)O)=O,,,5,1,1,0,1
49817_0,,,,2,1,2,3
C1(CCCC(C(C=O)O)O1)=O,,,5,1,1,0,1
49819_0,,,,2,1,2,3
C1(C(C)(CC(C(C=O)O1)O)O)=O,,,5,1,1,0,1
49821_0,,,,2,1,1,2
C1(C(C(C(C)O)C(C(C)O1)O)=O)=O,,,5,1,1,0,1
49823_0,,,,2,1,1,2
C1(C(C(C(C(O1)=O)=O)C(C)O)O)=O,,,5,1,1,0,1
49825_0,,,,2,1,1,2
C(C1C(C(OC(C)C1O)=O)=O)(O)=O,,,5,1,1,0,1
49827_0,,,,2,1,1,2
C(C1C(C(OC(C1O)=O)=O)=O)(O)=O,,,5,1,1,0,1
49829_0,,,,2,1,2,3
C(C1(CC[CH]C(O1)=O)CC=O)=O,,,5,1,1,0,1
49831_0,,,,2,1,2,3
[CH]1C(OC(C)C(C(C=O)=O)C1)=O,,,5,1,1,0,1
49833_0,,,,2,1,2,3
C1(C(C(C=O)=O)C[CH]C(O1)=O)=O,,,5,1,1,0,1
49835_0,,,,2,1,2,3
[CH]1C(OCC(C(C=O)=O)C1)=O,,,5,1,1,0,1
49837_0,,,,2,1,2,3
C(C1(CCCC(O1)=O)CC=O)=O,,,5,1,1,0,1
49839_0,,,,2,1,2,3
C1(CCC(C(C=O)=O)C(C)O1)=O,,,5,1,1,0,1
49841_0,,,,2,1,2,3
C1(C(C(C=O)=O)CCC(O1)=O)=O,,,5,1,1,0,1
49843_0,,,,2,1,2,3
C1(CCC(C(C=O)=O)CO1)=O,,,5,1,1,0,1
49845_0,,,,2,1,2,3
[CH]1C(OC(CC1)CC(C=O)=O)=O,,,5,1,1,0,1
49847_0,,,,2,1,2,3
C(C1C(C(C)O)OC([CH]C1)=O)=O,,,5,1,1,0,1
49849_0,,,,2,1,2,3
C(C1C(C(O)=O)OC([CH]C1)=O)=O,,,5,1,1,0,1
49851_0,,,,2,1,2,3
C(C1(C)C(C=O)C[CH]C(O1)=O)=O,,,5,1,1,0,1
49853_0,,,,2,1,2,3
C(C1C(C(C)=O)OC([CH]C1)=O)=O,,,5,1,1,0,1
49855_0,,,,2,1,2,3
C(C1COC([CH]C1)=O)=O,,,5,1,1,0,1
49857_0,,,,2,1,2,3
[CH]1C(OCC(C(C(O)=O)=O)C1)=O,,,5,1,1,0,1
49859_0,,,,2,1,2,3
C1(CCCC(CC(C=O)=O)O1)=O,,,5,1,1,0,1
49861_0,,,,2,1,2,3
C(C1CCC(OC1C(C)O)=O)=O,,,5,1,1,0,1
49863_0,,,,2,1,2,3
C(C1CCC(OC1C(O)=O)=O)=O,,,5,1,1,0,1
49865_0,,,,2,1,2,3
C(C1CCC(OC1(C=O)C)=O)=O,,,5,1,1,0,1
49867_0,,,,2,1,2,3
C(C1CCC(OC1C(C)=O)=O)=O,,,5,1,1,0,1
49869_0,,,,2,1,2,3
C(C1CCC(OC1)=O)=O,,,5,1,1,0,1
49871_0,,,,2,1,2,3
C1(CCC(C(C(O)=O)=O)CO1)=O,,,5,1,1,0,1
49873_0,,,,2,1,2,3
C1(C(C(C(C(C)O1)O)O)=O)=O,,,5,1,1,0,1
49875_0,,,,2,1,2,3
C1(C(CC(C(C)O1)O)=O)=O,,,5,1,1,0,1
49877_0,,,,2,1,2,3
C1(C(C(C(C(O1)=O)=O)O)O)=O,,,5,1,1,0,1
49878_0,,,,2,1,2,3
49880_0,,,,2,1,2,3
C1(CC(C(C(C(O)=O)O1)O)O)=O,,,5,1,1,0,1
49882_0,,,,2,1,2,3
C1(CC(CC(C(O)=O)O1)O)=O,,,5,1,1,0,1
49883_0,,,,2,1,2,3
49884_0,,,,2,1,2,3
49885_0,,,,2,1,2,3
49886_0,,,,2,1,2,3
49887_0,,,,2,1,2,3
49888_0,,,,2,1,2,3
49889_0,,,,2,1,2,3
49890_0,,,,2,1,2,3
49891_0,,,,2,1,2,3
49892_0,,,,2,1,2,3
49893_0,,,,2,1,2,3
49894_0,,,,2,1,2,3
49895_0,,,,2,1,2,3
49896_0,,,,2,1,2,3
49897_0,,,,2,1,2,3
49898_0,,,,2,1,2,3
49899_0,,,,2,1,2,3
49900_0,,,,2,1,2,3
49901_0,,,,2,1,2,3
49902_0,,,,2,1,2,3
49903_0,,,,2,1,2,3
49904_0,,,,2,1,2,3
49905_0,,,,2,1,2,3
49906_0,,,,2,1,2,3
49908_0,,,,2,1,2,3
C1(CC(C(CO1)C(C)O)O)=O,,,5,1,1,0,1
49909_0,,,,2,1,2,3
49910_0,,,,2,1,2,3
49912_0,,,,2,1,2,3
C(C1COC(CC1O)=O)(O)=O,,,5,1,1,0,1
49914_0,,,,2,1,2,3
C1(CC(CCO1)O)=O,,,5,1,1,0,1
49915_0,,,,2,1,2,3
49917_0,,,,2,1,2,3
C(C1(CCOC(C1)=O)O)(O)=O,,,5,1,1,0,1
49919_0,,,,2,1,2,3
[CH]1C(OCC(C(C)O)C1)=O,,,5,1,1,0,1
49920_0,,,,2,1,2,3
49922_0,,,,2,1,2,3
C1(CCC(CO1)C(C)O)=O,,,5,1,1,0,1
49923_0,,,,2,1,2,3
49924_0,,,,2,1,2,3
49925_0,,,,2,1,2,3
49926_0,,,,2,1,2,3
49928_0,,,,2,1,2,3
C(C1COC([CH]C1)=O)(O)=O,,,5,1,1,0,1
49929_0,,,,2,1,2,3
49931_0,,,,2,1,2,3
C1(CCC(C(O)=O)CO1)=O,,,5,1,1,0,1
49933_0,,,,2,1,2,3
[CH]1C(OCCC1)=O,,,5,1,1,0,1
49935_0,,,,2,1,2,3
C1(CCCCO1)=O,,,5,1,1,0,1
49937_0,,,,2,1,2,3
C1(C(C(C)O)C(CC(C)O1)O)=O,,,5,1,1,0,1
49938_0,,,,2,1,2,3
49940_0,,,,2,1,2,3
C1(CC(CC(C)O1)O)=O,,,5,1,1,0,1
49942_0,,,,2,1,2,3
C1(C(C(CC(O1)=O)O)C(C)O)=O,,,5,1,1,0,1
49943_0,,,,2,1,2,3
49945_0,,,,2,1,2,3
C1(C(C(C)O)C(C(CO1)=O)O)=O,,,5,1,1,0,1
49947_0,,,,2,1,2,3
C(C1(CC(C)OC(C1)=O)O)(O)=O,,,5,1,1,0,1
49948_0,,,,2,1,2,3
49950_0,,,,2,1,2,3
C1(CC(CC(O1)=O)O)=O,,,5,1,1,0,1
49951_0,,,,2,1,2,3
49953_0,,,,2,1,2,3
C(C1(C)CC(CC(O1)=O)O)(O)=O,,,5,1,1,0,1
49955_0,,,,2,1,2,3
C1(CC(C(O)=O)(CC(O1)=O)O)=O,,,5,1,1,0,1
49957_0,,,,2,1,2,3
C1(CC(C(CO1)=O)O)=O,,,5,1,1,0,1
49959_0,,,,2,1,2,3
C1(C(C(C)O)C[CH]C(O1)=O)=O,,,5,1,1,0,1
49960_0,,,,2,1,2,3
49962_0,,,,2,1,2,3
C1(C(CCC(O1)=O)C(C)O)=O,,,5,1,1,0,1
49963_0,,,,2,1,2,3
49964_0,,,,2,1,2,3
49965_0,,,,2,1,2,3
49966_0,,,,2,1,2,3
49967_0,,,,2,1,2,3
49969_0,,,,2,1,2,3
C1(CC[CH]C(O1)=O)=O,,,5,1,1,0,1
49971_0,,,,2,1,2,3
C1(CCCC(O1)=O)=O,,,5,1,1,0,1
49973_0,,,,2,1,2,3
C1(C(C=O)(CO)C(CCO1)O)=O,,,5,1,1,0,1
49975_0,,,,2,1,2,3
C1(C(CO)C(C=O)(CCO1)O)=O,,,5,1,1,0,1
49977_0,,,,2,1,2,3
C1(C(C(CO)(C(CO1)O)O)=O)=O,,,5,1,1,0,1
49979_0,,,,2,1,2,3
C1(C(C=O)(C(CCO1)O)O)=O,,,5,1,1,0,1
49981_0,,,,2,1,2,3
C1(C(CO)C(CCO1)O)=O,,,5,1,1,0,1
49983_0,,,,2,1,2,3
C1(C(C(C)O)C(CCO1)O)=O,,,5,1,1,0,1
49985_0,,,,2,1,2,3
C1(C(C(O)=O)C(CCO1)O)=O,,,5,1,1,0,1
49987_0,,,,2,1,2,3
C1(C(C(C)O)(C(CCO1)O)O)=O,,,5,1,1,0,1
49989_0,,,,2,1,2,3
C1(C(C(O)=O)(C(CCO1)O)O)=O,,,5,1,1,0,1
49991_0,,,,2,1,2,3
C1(C(C(C)=O)(C)C(CCO1)O)=O,,,5,1,1,0,1
49993_0,,,,2,1,2,3
C1(C(CO)(C(CCO1)O)O)=O,,,5,1,1,0,1
49995_0,,,,2,1,2,3
C1(C(C=O)(C(C(CO1)O)O)O)=O,,,5,1,1,0,1
49997_0,,,,2,1,2,3
C1(C(C=O)(C(CC(C)O1)O)O)=O,,,5,1,1,0,1
49999_0,,,,2,1,2,3
C1(C(C=O)(C(CC(O1)=O)O)O)=O,,,5,1,1,0,1
50001_0,,,,2,1,2,3
C1(C(C=O)(C(C(CO1)=O)O)O)=O,,,5,1,1,0,1
50002_0,,,,2,1,2,3
50003_0,,,,2,1,2,3
50005_0,,,,2,1,2,3
C1(C(CO)C(C(CO1)O)O)=O,,,5,1,1,0,1
50007_0,,,,2,1,2,3
C1(C(C(C)O)C(C(CO1)O)O)=O,,,5,1,1,0,1
50009_0,,,,2,1,2,3
C1(C(C(O)=O)C(C(CO1)O)O)=O,,,5,1,1,0,1
50010_0,,,,2,1,2,3
50012_0,,,,2,1,2,3
C(C1(COC(CC1O)=O)O)=O,,,5,1,1,0,1
50014_0,,,,2,1,2,3
C1(C(CO)(C(C(CO1)O)O)O)=O,,,5,1,1,0,1
50016_0,,,,2,1,2,3
C(C1[C](C(OCC1O)=O)O)(O)=O,,,5,1,1,0,1
50018_0,,,,2,1,2,3
C(C1C(COC(C1O)=O)O)(O)=O,,,5,1,1,0,1
50020_0,,,,2,1,2,3
C(C1(COC([CH]C1)=O)C(C)O)=O,,,5,1,1,0,1
50021_0,,,,2,1,2,3
50023_0,,,,2,1,2,3
C(C1(COC(CC1)=O)C(C)O)=O,,,5,1,1,0,1
50024_0,,,,2,1,2,3
50026_0,,,,2,1,2,3
C(C1(C(O)=O)COC([CH]C1)=O)=O,,,5,1,1,0,1
50027_0,,,,2,1,2,3
50029_0,,,,2,1,2,3
C(C1(C(O)=O)COC(CC1)=O)=O,,,5,1,1,0,1
50030_0,,,,2,1,2,3
50032_0,,,,2,1,2,3
C1(C(C(C(CO1)C(C)O)O)O)=O,,,5,1,1,0,1
50034_0,,,,2,1,2,3
C1(C(C(C(CO)C(C)O1)O)O)=O,,,5,1,1,0,1
50036_0,,,,2,1,2,3
C(C1(C(COC(C1O)=O)O)O)=O,,,5,1,1,0,1
50038_0,,,,2,1,2,3
C(C1(C)CC(C(C(O1)=O)O)O)=O,,,5,1,1,0,1
50040_0,,,,2,1,2,3
C1(C(C(CC(C(C)=O)O1)O)O)=O,,,5,1,1,0,1
50042_0,,,,2,1,2,3
C(C)(C1(COC(C(C1)=O)=O)O)=O,,,5,1,1,0,1
50044_0,,,,2,1,2,3
C1(C(C)(C(C=O)(CCO1)O)O)=O,,,5,1,1,0,1
50046_0,,,,2,1,2,3
C(C1(CCOC(C1O)=O)O)=O,,,5,1,1,0,1
50048_0,,,,2,1,2,3
C(C1(CC(C)OC(C1O)=O)O)=O,,,5,1,1,0,1
50050_0,,,,2,1,2,3
C1(CC(C=O)(C(C(O1)=O)O)O)=O,,,5,1,1,0,1
50052_0,,,,2,1,2,3
C(C1(C)C(C(CC(O1)=O)=O)O)=O,,,5,1,1,0,1
50054_0,,,,2,1,2,3
C1(C(C)(C(CCO1)O)O)=O,,,5,1,1,0,1
50056_0,,,,2,1,2,3
C1(C(C(CCO1)O)O)=O,,,5,1,1,0,1
50058_0,,,,2,1,2,3
C(C1(CCOC(C1O)=O)O)(O)=O,,,5,1,1,0,1
50060_0,,,,2,1,2,3
C1(C(C)(C(C(OC1C)=O)O)O)=O,,,5,1,1,0,1
50062_0,,,,2,1,2,3
C1(C(C(C(C(O1)=O)=O)(C)O)O)=O,,,5,1,1,0,1
50064_0,,,,2,1,2,3
C1(C(C(C(C(O1)=O)O)O)O)=O,,,5,1,1,0,1
50066_0,,,,2,1,2,3
C1(C(C)C(C)(C(C(O1)=O)O)O)=O,,,5,1,1,0,1
50068_0,,,,2,1,2,3
C(C1(C)C(CC(C(O1)=O)=C)O)=O,,,5,1,1,0,1
50070_0,,,,2,1,2,3
C(C1C(CC(C(O1)=O)=C)O)(O)=O,,,5,1,1,0,1
50071_0,,,,2,1,2,3
50073_0,,,,2,1,2,3
C(C1(COC(C(C1)=C)=O)O)(O)=O,,,5,1,1,0,1
50075_0,,,,2,1,2,3
C1(C(C)(C(C(CO1)O)O)O)=O,,,5,1,1,0,1
50077_0,,,,2,1,2,3
C1(C(C(C(CO1)O)O)O)=O,,,5,1,1,0,1
50079_0,,,,2,1,2,3
C(C1(C(COC(C1)=O)O)O)(O)=O,,,5,1,1,0,1
50081_0,,,,2,1,1,2
C1(CC(C(O)=O)(C(C(O1)=O)O)O)=O,,,5,1,1,0,1
50083_0,,,,2,1,2,3
C1(C2(COC(C(C2)(C)O1)=O)O)=O,,,5,1,1,0,1
50085_0,,,,2,1,1,2
C1(C(C)(CC(C(O)=O)(CO1)O)O)=O,,,5,1,1,0,1
50087_0,,,,2,1,2,3
[CH]1C(OCC(C(C=O)=O)(C1)O)=O,,,5,1,1,0,1
50089_0,,,,2,1,2,3
C1(CCC(C(C=O)=O)(CO1)O)=O,,,5,1,1,0,1
50091_0,,,,2,1,2,3
C(C1(C(C)OC([CH]C1)=O)O)(O)=O,,,5,1,1,0,1
50092_0,,,,2,1,2,3
50093_0,,,,2,1,2,3
50095_0,,,,2,1,2,3
C(C1(CCC(OC1C)=O)O)(O)=O,,,5,1,1,0,1
50096_0,,,,2,1,2,3
50097_0,,,,2,1,2,3
50099_0,,,,2,1,2,3
C(C(C)(C1CC[CH]C(O1)=O)O)=O,,,5,1,1,0,1
50101_0,,,,2,1,2,3
C(C(C1CC[CH]C(O1)=O)O)(O)=O,,,5,1,1,0,1
50102_0,,,,2,1,2,3
50104_0,,,,2,1,2,3
C(C(C)(C1CCCC(O1)=O)O)=O,,,5,1,1,0,1
50106_0,,,,2,1,2,3
C1(CCCC(C(C(O)=O)O)O1)=O,,,5,1,1,0,1
50107_0,,,,2,1,2,3
50108_0,,,,2,1,2,3
50109_0,,,,2,1,2,3
50110_0,,,,2,1,2,3
50111_0,,,,2,1,2,3
50112_0,,,,2,1,2,3
50113_0,,,,2,1,2,3
50114_0,,,,2,1,2,3
50115_0,,,,2,1,2,3
50116_0,,,,2,1,2,3
50117_0,,,,2,1,2,3
50118_0,,,,2,1,2,3
50119_0,,,,2,1,2,3
50120_0,,,,2,1,2,3
50121_0,,,,2,1,2,3
50122_0,,,,2,1,2,3
50123_0,,,,2,1,2,3
50124_0,,,,2,1,2,3
50125_0,,,,2,1,2,3
50127_0,,,,2,1,2,3
C1(CC(C(CO1)(C(C)O)O)O)=O,,,5,1,1,0,1
50128_0,,,,2,1,2,3
50130_0,,,,2,1,2,3
C1(CC(C(C(C=O)O1)O)O)=O,,,5,1,1,0,1
50132_0,,,,2,1,2,3
C1(CC(C(CO1)O)O)=O,,,5,1,1,0,1
50134_0,,,,2,1,2,3
C1(C(C)(CC(C(CO)O1)O)O)=O,,,5,1,1,0,1
50136_0,,,,2,1,2,3
C1(C(CO)OC([C](C1)O)=O)=O,,,5,1,1,0,1
50138_0,,,,2,1,2,3
C1(CC(C(OC1CO)=O)O)=O,,,5,1,1,0,1
50140_0,,,,2,1,2,3
[CH]1C(OCC(C(C)O)(C1)O)=O,,,5,1,1,0,1
50141_0,,,,2,1,2,3
50143_0,,,,2,1,2,3
C1(CCC(CO1)(C(C)O)O)=O,,,5,1,1,0,1
50144_0,,,,2,1,2,3
50145_0,,,,2,1,2,3
50146_0,,,,2,1,2,3
50148_0,,,,2,1,2,3
[CH]1C(OC(CO)C(C)(C1)O)=O,,,5,1,1,0,1
50150_0,,,,2,1,2,3
C1(CCC(C)(C(CO)O1)O)=O,,,5,1,1,0,1
50152_0,,,,2,1,2,3
C(C1C(C[CH]C(O1)=O)O)=O,,,5,1,1,0,1
50154_0,,,,2,1,2,3
C1(CCC(C(C=O)O1)O)=O,,,5,1,1,0,1
50156_0,,,,2,1,2,3
C1(C(OCCC1)=O)=O,,,5,1,1,0,1
50157_0,,,,2,1,2,3
50158_0,,,,2,1,1,2
50159_0,,,,2,1,2,3
50160_0,,,,2,1,2,3
50162_0,,,,2,1,2,3
C(C1COC([C](C1)O)=O)(O)=O,,,5,1,1,0,1
50163_0,,,,2,1,2,3
50164_0,,,,2,1,2,3
50166_0,,,,2,1,2,3
C(C1COC(C(C1)O)=O)(O)=O,,,5,1,1,0,1
50167_0,,,,2,1,2,3
50168_0,,,,2,1,2,3
50170_0,,,,2,1,2,3
C1(C2(C)OCC1C(C(O2)=O)=O)=O,,,5,1,1,0,1
50172_0,,,,2,1,2,3
C1(C2(CO)C(C(C(O2)O1)=O)O)=O,,,5,1,1,0,1
50174_0,,,,2,1,2,3
C1(C2(C)C(C(C(O2)O1)=O)O)=O,,,5,1,1,0,1
50176_0,,,,2,1,2,3
C1(C2(CO)CC(C(O2)O1)=O)=O,,,5,1,1,0,1
50178_0,,,,2,1,2,3
C1(C2(C)CC(C(O2)O1)=O)=O,,,5,1,1,0,1
50179_0,,,,2,1,2,3
50180_0,,,,2,1,2,3
50182_0,,,,2,1,2,3
C1(C2C(C(C(C)(O2)O1)=O)O)=O,,,5,1,1,0,1
50184_0,,,,2,1,2,3
C1(C2(C)O[C](C(O2)=O)C1)=O,,,5,1,1,0,1
50186_0,,,,2,1,2,3
C1(CC2C(OC1(C)O2)=O)=O,,,5,1,1,0,1
50187_0,,,,2,1,2,3
50188_0,,,,2,1,2,3
50190_0,,,,2,1,2,3
C1(C2(COC(C(C2O)=O)O1)O)=O,,,5,1,1,0,1
50192_0,,,,2,1,2,3
C1(C2(COC(C(C2)=O)O1)O)=O,,,5,1,1,0,1
50193_0,,,,2,1,2,3
50194_0,,,,2,1,1,2
50195_0,,,,2,1,1,2
50196_0,,,,2,1,1,2
50197_0,,,,2,1,1,2
50198_0,,,,2,1,1,2
50199_0,,,,2,1,1,2
50200_0,,,,2,1,1,2
50201_0,,,,2,1,1,2
50202_0,,,,2,1,1,2
50203_0,,,,2,1,1,2
50204_0,,,,2,1,1,2
50205_0,,,,2,1,1,2
50206_0,,,,2,1,1,2
50207_0,,,,2,1,1,2
50208_0,,,,2,1,1,2
50209_0,,,,2,1,1,2
50210_0,,,,2,1,1,2
50211_0,,,,2,1,1,2
50212_0,,,,2,1,1,2
50213_0,,,,2,1,1,2
50215_0,,,,2,1,2,3
[CH]1C(OC(C(C=O)=O)C(C1)O)=O,,,5,1,1,0,1
50217_0,,,,2,1,2,3
C1(CCC(C(C(C=O)=O)O1)O)=O,,,5,1,1,0,1
50219_0,,,,2,1,2,3
C(C1CC(C(OC1)=O)CC=O)=O,,,5,1,1,0,1
50221_0,,,,2,1,2,3
C(C1COC(C(C)C1C=O)=O)=O,,,5,1,1,0,1
50223_0,,,,2,1,2,3
C1(C(CC(C=O)CO1)C(C)O)=O,,,5,1,1,0,1
50225_0,,,,2,1,2,3
C1(C(C(O)=O)CC(C=O)CO1)=O,,,5,1,1,0,1
50227_0,,,,2,1,2,3
C(CC1C(C)CC(C(O1)=O)=O)=O,,,5,1,1,0,1
50229_0,,,,2,1,2,3
[CH]1C(OC(C(C(C)=O)=O)CC1)=O,,,5,1,1,0,1
50231_0,,,,2,1,2,3
C1(CCCC(C(C(C)=O)=O)O1)=O,,,5,1,1,0,1
50233_0,,,,2,1,2,3
C1(C(C=O)(C[CH]C(O1)=O)O)=O,,,5,1,1,0,1
50235_0,,,,2,1,2,3
C1(C(C=O)(CCC(O1)=O)O)=O,,,5,1,1,0,1
50237_0,,,,2,1,2,3
C1(CC(C(OC1)=O)(C)CC=O)=O,,,5,1,1,0,1
50239_0,,,,2,1,2,3
C(C)(C1C(C)CC(C(O1)=O)=O)=O,,,5,1,1,0,1
50241_0,,,,2,1,2,3
C1(C(OCC(C)C1)=O)=O,,,5,1,1,0,1
50243_0,,,,2,1,2,3
C(C1CCOC(C1(C)O)=O)(O)=O,,,5,1,1,0,1
50245_0,,,,2,1,1,2
C(C1(COC(C(C1)=O)=O)C)(O)=O,,,5,1,2,0,2
50247_0,,,,2,1,2,3
C1(C(C)(C([CH]C(O1)=O)CO)O)=O,,,5,1,2,0,2
50249_0,,,,2,1,2,3
C1(C(C)C([C](C(O1)=O)O)CO)=O,,,5,1,2,0,2
50251_0,,,,2,1,2,3
C1(C(CCO)C[C](C(O1)=O)O)=O,,,5,1,2,0,2
50253_0,,,,2,1,2,3
C1(C(C)(C(CO)CC(O1)=O)O)=O,,,5,1,2,0,2
50255_0,,,,2,1,2,3
C1(C(C)C(CO)C(C(O1)=O)O)=O,,,5,1,2,0,2
50257_0,,,,2,1,2,3
C1(C(CC(C(O1)=O)O)CCO)=O,,,5,1,2,0,2
50258_0,,,,2,1,2,3
50259_0,,,,2,1,2,3
50260_0,,,,2,1,2,3
50261_0,,,,2,1,2,3
50263_0,,,,2,1,2,3
C(CC1C(OCCC1)=O)=O,,,5,1,1,0,1
50265_0,,,,2,1,2,3
C(C1CCOC(C1C)=O)=O,,,5,1,1,0,1
50267_0,,,,2,1,2,3
C1(C(CCCO1)C(C)O)=O,,,5,1,1,0,1
50269_0,,,,2,1,2,3
C1(C(C(O)=O)CCCO1)=O,,,5,1,1,0,1
50271_0,,,,2,1,1,2
C(C(C)C1C(C(OCC1)=O)=O)(O)=O,,,5,1,1,0,1
50273_0,,,,2,1,1,2
C1(C(C)C(C(C(O)=O)=O)CCO1)=O,,,5,1,1,0,1
50275_0,,,,2,1,1,2
C1(C(CCCO1)CC(C(O)=O)=O)=O,,,5,1,1,0,1
50277_0,,,,2,1,2,3
C1(C(OC(C)C(C)C1)=O)=O,,,5,1,1,0,1
50279_0,,,,2,1,1,2
C(C1(C)C(C)OC(C(C1)=O)=O)(O)=O,,,5,1,1,0,1
50281_0,,,,2,1,2,3
C(CC1C(OC(CC1)=O)=O)=O,,,5,1,1,0,1
50283_0,,,,2,1,2,3
C(C1CC(OC(C1C)=O)=O)=O,,,5,1,1,0,1
50285_0,,,,2,1,2,3
C(C1(C)C(C[CH]C(O1)=O)O)(O)=O,,,5,1,1,0,1
50287_0,,,,2,1,2,3
C(C1(C)C(CCC(O1)=O)O)(O)=O,,,5,1,1,0,1
50289_0,,,,2,1,2,3
C(C1C(C)(C[CH]C(O1)=O)O)(O)=O,,,5,1,1,0,1
50291_0,,,,2,1,2,3
C1(CCC(C)(C(C(O)=O)O1)O)=O,,,5,1,1,0,1
50293_0,,,,2,1,2,3
C(C1(C=O)CC[CH]C(O1)=O)(O)=O,,,5,1,1,0,1
50295_0,,,,2,1,2,3
C(C1(C=O)CCCC(O1)=O)(O)=O,,,5,1,1,0,1
50297_0,,,,2,1,2,3
C(C)(C1(C(OC([CH]C1)=O)=O)C)=O,,,5,1,1,0,1
50299_0,,,,2,1,2,3
C(C)(C1(C(OC(CC1)=O)=O)C)=O,,,5,1,1,0,1
50301_0,,,,2,1,2,3
C(C1C(C)CC(C(O1)=O)=O)=O,,,5,1,1,0,1
50303_0,,,,2,1,2,3
C(C1(C)C(C)CC(C(O1)=O)=O)=O,,,5,1,1,0,1
50305_0,,,,2,1,2,3
C(C1C(C)CC(C(O1)=O)=O)(O)=O,,,5,1,1,0,1
50307_0,,,,2,1,2,3
C1(C(CC(C)C(CO)O1)=O)=O,,,5,1,1,0,1
50309_0,,,,2,1,2,3
C(C1CCC(C(O1)=O)CC=O)=O,,,5,1,1,0,1
50311_0,,,,2,1,2,3
C1(C(CC(C(O1)=O)CC=O)O)=O,,,5,1,1,0,1
50313_0,,,,2,1,2,3
C1(C(CC(CO1)O)CC=O)=O,,,5,1,1,0,1
50315_0,,,,2,1,2,3
C(C1CC(C=O)C(C(O1)=O)C)=O,,,5,1,1,0,1
50317_0,,,,2,1,2,3
C1(C(C(C=O)C(C(O1)=O)C)O)=O,,,5,1,1,0,1
50319_0,,,,2,1,2,3
C1(C(C)C(C=O)C(CO1)O)=O,,,5,1,1,0,1
50321_0,,,,2,1,2,3
C=C(C(O)=O)C1CC[CH]C(O1)=O,,,5,1,1,0,1
50323_0,,,,2,1,2,3
C1(CCCC(C(C(O)=O)=C)O1)=O,,,5,1,1,0,1
50325_0,,,,2,1,2,3
C1(C(CCC(C=O)O1)C(C)O)=O,,,5,1,1,0,1
50327_0,,,,2,1,2,3
C1(C(CC(C(O1)=O)O)C(C)O)=O,,,5,1,1,0,1
50329_0,,,,2,1,2,3
C(C1CC(C(OC1C)=O)O)(O)=O,,,5,1,1,0,1
50331_0,,,,2,1,2,3
C1(C(CC(CO1)O)C(C)O)=O,,,5,1,1,0,1
50333_0,,,,2,1,2,3
C(C1(C=C)CC[CH]C(O1)=O)(O)=O,,,5,1,1,0,1
50335_0,,,,2,1,2,3
C(C1(C=C)CCCC(O1)=O)(O)=O,,,5,1,1,0,1
50337_0,,,,2,1,2,3
C(C1C(OC(C=O)CC1)=O)(O)=O,,,5,1,1,0,1
50339_0,,,,2,1,2,3
C1(C(C(O)=O)CC(C(O1)=O)O)=O,,,5,1,1,0,1
50341_0,,,,2,1,2,3
C1(C(C(O)=O)CC(CO1)O)=O,,,5,1,1,0,1
50343_0,,,,2,1,2,3
[CH]1C(OC(C(C1)O)C(C)O)=O,,,5,1,1,0,1
50345_0,,,,2,1,2,3
C1(CCC(C(C(C)O)O1)O)=O,,,5,1,1,0,1
50347_0,,,,2,1,2,3
C(C1(COC([CH]C1)=O)O)=O,,,5,1,1,0,1
50349_0,,,,2,1,2,3
C(C1(COC(CC1)=O)O)=O,,,5,1,1,0,1
50351_0,,,,2,1,2,3
[CH]1C(OC[C](C(O)=O)C1)=O,,,5,1,1,0,1
50353_0,,,,2,1,2,3
[CH]1C(OC([C](CO)C1)=O)=O,,,5,1,1,0,1
50355_0,,,,2,1,2,3
C1(CC[C](C(O)=O)CO1)=O,,,5,1,1,0,1
50357_0,,,,2,1,2,3
C1(CC[C](C(O1)=O)CO)=O,,,5,1,1,0,1
50359_0,,,,2,1,1,2
C1(C(C(C(O)=O)=O)C[CH]C(O1)=O)=O,,,5,1,1,0,1
50361_0,,,,2,1,1,2
C1(C(C(C(O)=O)=O)CCC(O1)=O)=O,,,5,1,1,0,1
50363_0,,,,2,1,2,3
C(CC[C]1C(OC([CH]C1)=O)=O)=O,,,5,1,1,0,1
50365_0,,,,2,1,2,3
C(CC[C]1C(OC(CC1)=O)=O)=O,,,5,1,1,0,1
50367_0,,,,2,1,2,3
C(CCC1C(OC([CH]C1)=O)=O)=O,,,5,1,1,0,1
50369_0,,,,2,1,2,3
C(CCC1C(OC(CC1)=O)=O)=O,,,5,1,1,0,1
50371_0,,,,2,1,2,3
C1([CH]CC([C](C(O)=O)O1)O)=O,,,5,1,1,0,1
50373_0,,,,2,1,2,3
C1(CCC([C](C(O)=O)O1)O)=O,,,5,1,1,0,1
50375_0,,,,2,1,2,3
C(C1CC[CH]C(O1)=O)=O,,,5,1,1,0,1
50377_0,,,,2,1,2,3
C(C1CCCC(O1)=O)=O,,,5,1,1,0,1
50379_0,,,,2,1,2,3
C1(CC(C([C](C(O)=O)O1)O)O)=O,,,5,1,1,0,1
50381_0,,,,2,1,2,3
C1(CC(C[C](C(O)=O)O1)O)=O,,,5,1,1,0,1
50383_0,,,,2,1,2,3
C(C1(COC([C](C1O)O)=O)O)=O,,,5,1,1,0,1
50385_0,,,,2,1,2,3
C(C1(COC([C](C1)O)=O)O)=O,,,5,1,1,0,1
50387_0,,,,2,1,2,3
C=C1C(OC([C](C1CO)O)=O)=O,,,5,1,1,0,1
50389_0,,,,2,1,2,3
C(C1(COC([C](C1)O)=O)O)(O)=O,,,5,1,1,0,1
50391_0,,,,2,1,2,3
C1(C(CO)(C[C](C(O1)=O)O)O)=O,,,5,1,1,0,1
50393_0,,,,2,1,2,3
C1(C(C)(C([C](C(O1)=O)O)O)O)=O,,,5,1,1,0,1
50395_0,,,,2,1,2,3
C1(CC(CC(C=O)O1)O)=O,,,5,1,1,0,1
50397_0,,,,2,1,2,3
C1(C(C(CC(C)O1)O)=O)=O,,,5,1,1,0,1
50399_0,,,,2,1,2,3
C1(CC(C(C(O1)=O)=O)O)=O,,,5,1,1,0,1
50401_0,,,,2,1,2,3
C1(COC(C(C1O)=O)=O)=O,,,5,1,1,0,1
50403_0,,,,2,1,2,3
C1(C(C[CH]C(O1)=O)=O)=O,,,5,1,1,0,1
50405_0,,,,2,1,2,3
C1(C(C(C(C(O1)=O)=C)CO)O)=O,,,5,1,1,0,1
50407_0,,,,2,1,2,3
C1(CC(CC(C(C=O)O1)O)O)=O,,,5,1,1,0,1
50409_0,,,,2,1,2,3
C(C1C(CC(OCC1O)=O)O)=O,,,5,1,1,0,1
50411_0,,,,2,1,2,3
C1(C(C=O)C(C(CCO1)=O)O)=O,,,5,1,1,0,1
50413_0,,,,2,1,2,3
C1(C(CO)C(CC(CO1)=O)O)=O,,,5,1,1,0,1
50415_0,,,,2,1,2,3
C(C1(CCOC(C(C1)=O)=O)O)=O,,,5,1,1,0,1
50417_0,,,,2,1,2,3
C1(CC(C=O)(CC(CO1)=O)O)=O,,,5,1,1,0,1
50419_0,,,,2,1,2,3
C(C1COC(CC(C1O)=O)=O)=O,,,5,1,1,0,1
50421_0,,,,2,1,2,3
C1(C(C(CO)C(CCO1)O)=O)=O,,,5,1,1,0,1
50423_0,,,,2,1,2,3
C=CC1C(C(OCCC1O)=O)=O,,,5,1,1,0,1
50425_0,,,,2,1,2,3
C(C1C(C(OCCC1O)=O)=C)=O,,,5,1,1,0,1
50427_0,,,,2,1,1,2
C1(C(C(C(C)O)C(CCO1)O)=O)=O,,,5,1,1,0,1
50429_0,,,,2,1,1,2
C(C1C(C(OCCC1O)=O)=O)(O)=O,,,5,1,1,0,1
50431_0,,,,2,1,2,3
C1(C(C(C(CCO1)O)O)=O)=O,,,5,1,1,0,1
50433_0,,,,2,1,2,3
C1(C(CC(CCO1)O)=O)=O,,,5,1,1,0,1
50435_0,,,,2,1,2,3
C(C1COC(C(CC1O)=C)=O)=O,,,5,1,1,0,1
50437_0,,,,2,1,2,3
C1(C(C(C(C(CO1)O)O)=O)=O)=O,,,5,1,1,0,1
50439_0,,,,2,1,2,3
C1(C(CC(C(C(C)O1)=O)=O)O)=O,,,5,1,1,0,1
50441_0,,,,2,1,2,3
C1(CC(C(C(OC1)=O)=O)(C)O)=O,,,5,1,1,0,1
50443_0,,,,2,1,2,3
C1(C(C(CC(C)(CO1)O)=O)=O)=O,,,5,1,1,0,1
50445_0,,,,2,1,2,3
C1(C(C(CC(CO1)O)=O)=O)=O,,,5,1,1,0,1
50447_0,,,,2,1,2,3
C1(C(C(CC(C(C)O1)O)=O)=O)=O,,,5,1,1,0,1
50449_0,,,,2,1,2,3
C1(C(CC(C(C(O1)=O)=O)=O)O)=O,,,5,1,1,0,1
50451_0,,,,2,1,2,3
C1(C(C(C(CCO1)=O)=O)(C)O)=O,,,5,1,1,0,1
50452_0,,,,2,1,2,3
50454_0,,,,2,1,2,3
C1(C(C(CC(CO1)=O)O)O)=O,,,5,1,1,0,1
50456_0,,,,2,1,2,3
C1(C(C(CC(C(O1)=O)=O)O)O)=O,,,5,1,1,0,1
50458_0,,,,2,1,2,3
C1(CC(C(C(CO1)=O)O)O)=O,,,5,1,1,0,1
50460_0,,,,2,1,2,3
C1(C(C(CC(C)(CO1)O)=O)C)=O,,,5,1,1,0,1
50462_0,,,,2,1,2,3
C(C1C(C)(COC([CH]C1)=O)O)=O,,,5,1,1,0,1
50464_0,,,,2,1,2,3
C(C1CCC(OCC1(C)O)=O)=O,,,5,1,1,0,1
50466_0,,,,2,1,2,3
C1(C(C)(C(CC(CO1)=O)O)O)=O,,,5,1,1,0,1
50468_0,,,,2,1,2,3
C1(C(C)C(C)(CC(CO1)=O)O)=O,,,5,1,1,0,1
50470_0,,,,2,1,1,2
C1(CC(C(O)=O)(CC(CO1)=O)O)=O,,,5,1,1,0,1
50472_0,,,,2,1,2,3
C1(CC(CC(CO1)=O)O)=O,,,5,1,1,0,1
50474_0,,,,2,1,2,3
C(C)(C1C(CC[CH]C(O1)=O)O)=O,,,5,1,1,0,1
50476_0,,,,2,1,2,3
C1(CCCC(C(C(C)=O)O1)O)=O,,,5,1,1,0,1
50477_0,,,,2,1,2,3
50479_0,,,,2,1,2,3
C1(C(C(C(OC(C)C1)=O)O)O)=O,,,5,1,1,0,1
50481_0,,,,2,1,2,3
C1(CC(C(C(C(O1)=O)O)O)=O)=O,,,5,1,1,0,1
50483_0,,,,2,1,2,3
C1(C(C(C(OCC1)=O)O)O)=O,,,5,1,1,0,1
50485_0,,,,2,1,2,3
C1(C(C)(C(C(CCO1)=O)O)O)=O,,,5,1,1,0,1
50487_0,,,,2,1,2,3
C1(C(C(CC(CO1)O)=O)CO)=O,,,5,1,1,0,1
50489_0,,,,2,1,2,3
C1(C(C(CC(CO1)O)=O)C)=O,,,5,1,1,0,1
50491_0,,,,2,1,2,3
C1(C(C(CC(C(C)O1)O)=O)C)=O,,,5,1,1,0,1
50493_0,,,,2,1,2,3
C1(CC(C(OC(C1C)=O)=O)O)=O,,,5,1,1,0,1
50494_0,,,,2,1,2,3
50496_0,,,,2,1,2,3
C1(C(CC(C(CO1)O)O)=O)=O,,,5,1,1,0,1
50498_0,,,,2,1,2,3
C(C1C(COC([CH]C1)=O)O)=O,,,5,1,1,0,1
50500_0,,,,2,1,2,3
C(C1CCC(OCC1O)=O)=O,,,5,1,1,0,1
50502_0,,,,2,1,2,3
C(C1C(CC[CH]C(O1)=O)O)=O,,,5,1,1,0,1
50504_0,,,,2,1,2,3
C1(CCCC(C(C=O)O1)O)=O,,,5,1,1,0,1
50506_0,,,,2,1,2,3
C(C1COC([CH]CC1(C)O)=O)=O,,,5,1,1,0,1
50508_0,,,,2,1,2,3
C(C1COC(CCC1(C)O)=O)=O,,,5,1,1,0,1
50510_0,,,,2,1,2,3
C(CC1C(CC[CH]C(O1)=O)=O)=O,,,5,1,1,0,1
50512_0,,,,2,1,2,3
C(CC1C(CCCC(O1)=O)=O)=O,,,5,1,1,0,1
50514_0,,,,2,1,2,3
C(C1C(C(C)OC([CH]C1)=O)O)=O,,,5,1,1,0,1
50516_0,,,,2,1,2,3
C1(C(C(C=O)C[CH]C(O1)=O)O)=O,,,5,1,1,0,1
50517_0,,,,2,1,2,3
50519_0,,,,2,1,2,3
C(C1CCC(OC(C)C1O)=O)=O,,,5,1,1,0,1
50521_0,,,,2,1,2,3
C1(CCC(C=O)C(C(O1)=O)O)=O,,,5,1,1,0,1
50522_0,,,,2,1,2,3
50523_0,,,,2,1,2,3
50524_0,,,,2,1,2,3
50525_0,,,,2,1,2,3
50526_0,,,,2,1,2,3
50527_0,,,,2,1,2,3
50528_0,,,,2,1,2,3
50529_0,,,,2,1,2,3
50530_0,,,,2,1,2,3
50531_0,,,,2,1,2,3
50532_0,,,,2,1,2,3
50533_0,,,,2,1,2,3
50534_0,,,,2,1,2,3
50535_0,,,,2,1,2,3
50536_0,,,,2,1,2,3
50537_0,,,,2,1,2,3
50539_0,,,,2,1,2,3
C1(C(C)(CC(CCO1)O)O)=O,,,5,1,1,0,1
50541_0,,,,2,1,2,3
[CH]1C(OCCC(C)(C1)O)=O,,,5,1,1,0,1
50543_0,,,,2,1,2,3
C1(CCC(C)(CCO1)O)=O,,,5,1,1,0,1
50545_0,,,,2,1,2,3
C1(COC([CH]CC1O)=O)=O,,,5,1,1,0,1
50547_0,,,,2,1,2,3
C1(CCC(C(CO1)=O)O)=O,,,5,1,1,0,1
50549_0,,,,2,1,2,3
C1(COC([CH]CC1)=O)=O,,,5,1,1,0,1
50551_0,,,,2,1,2,3
C1(COC(CCC1)=O)=O,,,5,1,1,0,1
50553_0,,,,2,1,2,3
C1(C(C)(CC(CC(O1)=O)O)O)=O,,,5,1,1,0,1
50555_0,,,,2,1,2,3
C1(CC(C)(C[CH]C(O1)=O)O)=O,,,5,1,1,0,1
50557_0,,,,2,1,2,3
C1(CCC(C)(CC(O1)=O)O)=O,,,5,1,1,0,1
50559_0,,,,2,1,2,3
C1(C(CO)C(C(CCO1)=O)O)=O,,,5,1,1,0,1
50561_0,,,,2,1,2,3
C1(C(C(CC(C(O1)=O)=C)O)O)=O,,,5,1,1,0,1
50563_0,,,,2,1,2,3
C(C1(C)C(CC[CH]C(O1)=O)O)=O,,,5,1,1,0,1
50565_0,,,,2,1,2,3
C(C1C(CC[CH]C(O1)=O)O)(O)=O,,,5,1,1,0,1
50566_0,,,,2,1,2,3
50568_0,,,,2,1,2,3
C(C1(COC([CH]CC1)=O)O)(O)=O,,,5,1,1,0,1
50570_0,,,,2,1,2,3
C(C1(C)C(CCCC(O1)=O)O)=O,,,5,1,1,0,1
50572_0,,,,2,1,2,3
C1(CCCC(C(C(O)=O)O1)O)=O,,,5,1,1,0,1
50573_0,,,,2,1,2,3
50575_0,,,,2,1,2,3
C(C1(COC(CCC1)=O)O)(O)=O,,,5,1,1,0,1
50576_0,,,,2,1,2,3
50577_0,,,,2,1,2,3
50578_0,,,,2,1,2,3
50579_0,,,,2,1,2,3
50580_0,,,,2,1,2,3
50581_0,,,,2,1,2,3
50582_0,,,,2,1,2,3
50584_0,,,,2,1,2,3
C1(C(C)(CC(C(CO1)O)O)O)=O,,,5,1,1,0,1
50586_0,,,,2,1,2,3
C1(C(COC([C](C1)O)=O)O)=O,,,5,1,1,0,1
50588_0,,,,2,1,2,3
C1(CC(C(OCC1O)=O)O)=O,,,5,1,1,0,1
50590_0,,,,2,1,2,3
[CH]1C(OC(CO)C(CC1)O)=O,,,5,1,1,0,1
50592_0,,,,2,1,2,3
C1(CCCC(C(CO)O1)O)=O,,,5,1,1,0,1
50594_0,,,,2,1,2,3
[CH]1C(OCC(C(C)(C1)O)O)=O,,,5,1,1,0,1
50596_0,,,,2,1,2,3
C1(CCC(C)(C(CO1)O)O)=O,,,5,1,1,0,1
50598_0,,,,2,1,2,3
C1(CC2C(C(C(O2)O1)=O)O)=O,,,5,1,1,0,1
50600_0,,,,2,1,2,3
C1(CC2CC(C(O2)O1)=O)=O,,,5,1,1,0,1
50601_0,,,,2,1,2,3
50603_0,,,,2,1,2,3
C1(C2(C)CC(CC(O2)O1)O)=O,,,5,1,1,0,1
50605_0,,,,2,1,2,3
C(C1C(C[CH]C(OC1C)=O)O)=O,,,5,1,1,0,1
50607_0,,,,2,1,2,3
C(C1C(C)OC(CCC1O)=O)=O,,,5,1,1,0,1
50609_0,,,,2,1,2,3
C1(C(C=O)C(C[CH]C(O1)=O)O)=O,,,5,1,1,0,1
50611_0,,,,2,1,2,3
C1(C(C=O)C(CCC(O1)=O)O)=O,,,5,1,1,0,1
50613_0,,,,2,1,2,3
C(C1COC(C(CC1C)=O)=O)=O,,,5,1,1,0,1
50615_0,,,,2,1,2,3
[CH]1C(OC(C)CC(C1)O)=O,,,5,1,1,0,1
50617_0,,,,2,1,2,3
C1(CCC(CC(C)O1)O)=O,,,5,1,1,0,1
50619_0,,,,2,1,2,3
C1(CC(C[CH]C(O1)=O)O)=O,,,5,1,1,0,1
50621_0,,,,2,1,2,3
C1(CCC(CC(O1)=O)O)=O,,,5,1,1,0,1
50623_0,,,,2,1,2,3
C1(COC(C(CC1)CC=O)=O)=O,,,5,1,1,0,1
50625_0,,,,2,1,2,3
C1(CC(C=O)C(C(OC1)=O)C)=O,,,5,1,1,0,1
50627_0,,,,2,1,2,3
C1(C(CCC(CO1)=O)C(C)O)=O,,,5,1,1,0,1
50629_0,,,,2,1,2,3
C(C1C(OCC(CC1)=O)=O)(O)=O,,,5,1,1,0,1
50631_0,,,,2,1,2,3
C1(C2CC(C(OCC2)=O)(O)O1)=O,,,5,1,1,0,1
50633_0,,,,2,1,1,2
C(C1CCOC(C(C1)=O)=O)(O)=O,,,5,1,2,0,2
50635_0,,,,2,1,2,3
C(C1CCOC([C](C1)O)=O)(O)=O,,,5,1,1,0,1
50637_0,,,,2,1,2,3
C(C1CC(C(OCC1)=O)O)(O)=O,,,5,1,1,0,1
50638_0,,,,2,1,2,3
50640_0,,,,2,1,2,3
C1(C(OCCC(C)C1)=O)=O,,,5,1,1,0,1
50642_0,,,,2,1,1,2
C(C1(C)CCOC(C(C1)=O)=O)(O)=O,,,5,1,1,0,1
50644_0,,,,2,1,1,2
C(C1CC(C)OC(C(C1)=O)=O)(O)=O,,,5,1,1,0,1
50646_0,,,,2,1,2,3
C1(CC(C)CC(C(O1)=O)=O)=O,,,5,1,1,0,1
50648_0,,,,2,1,2,3
C1(C(C)(C(C[CH]C(O1)=O)O)O)=O,,,5,1,1,0,1
50650_0,,,,2,1,2,3
C1(C(C)(C(CCC(O1)=O)O)O)=O,,,5,1,1,0,1
50652_0,,,,2,1,2,3
C1(C(C(C)(C[CH]C(O1)=O)O)O)=O,,,5,1,1,0,1
50654_0,,,,2,1,2,3
C1(CCC(C)(C(C(O1)=O)O)O)=O,,,5,1,1,0,1
50656_0,,,,2,1,2,3
C1(C(C=O)(CC[CH]C(O1)=O)O)=O,,,5,1,1,0,1
50658_0,,,,2,1,2,3
C1(C(C=O)(CCCC(O1)=O)O)=O,,,5,1,1,0,1
50660_0,,,,2,1,2,3
C(C)(C1C(OC([CH]CC1)=O)=O)=O,,,5,1,1,0,1
50662_0,,,,2,1,2,3
C(C)(C1C(OC(CCC1)=O)=O)=O,,,5,1,1,0,1
50664_0,,,,2,1,2,3
C(C1CC(C)CC(C(O1)=O)=O)=O,,,5,1,1,0,1
50666_0,,,,2,1,2,3
C1(C(C(C)CC(C(O1)=O)=O)O)=O,,,5,1,1,0,1
50668_0,,,,2,1,2,3
C1(C(CC(C)C(CO1)O)=O)=O,,,5,1,1,0,1
50670_0,,,,2,1,2,3
C=CC1C(C(OC([CH]C1)=O)=O)=O,,,5,1,1,0,1
50672_0,,,,2,1,2,3
C1(CCC(C=C)C(C(O1)=O)=O)=O,,,5,1,1,0,1
50674_0,,,,2,1,2,3
C(C1C(C(OC([CH]C1)=O)=O)=C)=O,,,5,1,1,0,1
50676_0,,,,2,1,2,3
C(C1C(C(OC(CC1)=O)=O)=C)=O,,,5,1,1,0,1
50678_0,,,,2,1,2,3
C(C=C1C(OC([CH]CC1)=O)=O)=O,,,5,1,1,0,1
50680_0,,,,2,1,2,3
C1(CCCC(C(O1)=O)=CC=O)=O,,,5,1,1,0,1
50682_0,,,,2,1,2,3
C=C1C(OC([CH]CC1(C)O)=O)=O,,,5,1,1,0,1
50684_0,,,,2,1,2,3
C1(CCC(C(C(O1)=O)=C)(C)O)=O,,,5,1,1,0,1
50686_0,,,,2,1,2,3
C1(C(C=C)(CC[CH]C(O1)=O)O)=O,,,5,1,1,0,1
50688_0,,,,2,1,2,3
C1(C(C=C)(CCCC(O1)=O)O)=O,,,5,1,1,0,1
50690_0,,,,2,1,2,3
[CH]1C(OC(C)C(C(C1)O)O)=O,,,5,1,1,0,1
50692_0,,,,2,1,2,3
C1(CCC(C(C(C)O1)O)O)=O,,,5,1,1,0,1
50694_0,,,,2,1,2,3
C1([CH]CC([CH]C(O1)=O)O)=O,,,5,1,1,0,1
50696_0,,,,2,1,2,3
C1(CCC([CH]C(O1)=O)O)=O,,,5,1,1,0,1
50697_0,,,,2,1,1,2
50698_0,,,,2,1,1,2
50699_0,,,,2,1,1,2
50700_0,,,,2,1,1,2
50702_0,,,,2,1,2,3
C(CC1[CH]C(OC([CH]C1)=O)=O)=O,,,5,1,1,0,1
50704_0,,,,2,1,2,3
C(CC1[CH]C(OC(CC1)=O)=O)=O,,,5,1,1,0,1
50706_0,,,,2,1,2,3
C(CC1CC(OC([CH]C1)=O)=O)=O,,,5,1,1,0,1
50708_0,,,,2,1,2,3
C(CC1CCC(OC(C1)=O)=O)=O,,,5,1,1,0,1
50710_0,,,,2,1,2,3
C1([CH]CC([C](C(O1)=O)O)O)=O,,,5,1,1,0,1
50712_0,,,,2,1,2,3
C1(CCC([C](C(O1)=O)O)O)=O,,,5,1,1,0,1
50714_0,,,,2,1,2,3
[C]1(C(OC(C)CC(C1O)O)=O)O,,,5,1,1,0,1
50716_0,,,,2,1,2,3
[C]1(C(OC(C)CC(C1)O)=O)O,,,5,1,1,0,1
50718_0,,,,2,1,2,3
C1(CC(C([C](C(O1)=O)O)O)O)=O,,,5,1,1,0,1
50720_0,,,,2,1,2,3
C1(CC(C[C](C(O1)=O)O)O)=O,,,5,1,1,0,1
50722_0,,,,2,1,2,3
C1(COC([C](C(C1O)O)O)=O)=O,,,5,1,1,0,1
50724_0,,,,2,1,2,3
C1(COC([C](CC1O)O)=O)=O,,,5,1,1,0,1
50725_0,,,,2,1,1,2
50726_0,,,,2,1,1,2
50727_0,,,,2,1,1,2
50728_0,,,,2,1,1,2
50729_0,,,,2,1,1,2
50730_0,,,,2,1,1,2
50731_0,,,,2,1,1,2
50732_0,,,,2,1,1,2
50733_0,,,,2,1,1,2
50734_0,,,,2,1,1,2
50735_0,,,,2,1,1,2
50736_0,,,,2,1,1,2
50737_0,,,,2,1,1,2
50738_0,,,,2,1,1,2
50740_0,,,,2,1,1,2
C(C1(C=C)CC(C(O)=O)CC1O)=O,,,5,1,1,0,1
50741_0,,,,2,1,1,2
50742_0,,,,2,1,1,2
50743_0,,,,2,1,1,2
50744_0,,,,2,1,1,2
50745_0,,,,2,1,1,2
50746_0,,,,2,1,1,2
50747_0,,,,2,1,1,2
50748_0,,,,2,1,1,2
50749_0,,,,2,1,1,2
50750_0,,,,2,1,1,2
50751_0,,,,2,1,1,2
50752_0,,,,2,1,1,2
50753_0,,,,2,1,1,2
50755_0,,,,2,1,1,2
C1(C(CCC1)=O)=O,,,5,1,1,0,1
50757_0,,,,2,1,1,2
C(C1C(C(CC1)=O)=O)(O)=O,,,5,1,1,0,1
50759_0,,,,2,1,1,2
C([C]1CC(C(C1)=O)=O)(O)=O,,,5,1,1,0,1
50761_0,,,,2,1,1,2
C(C1CC(C(C1)=O)=O)(O)=O,,,5,1,1,0,1
50762_0,,,,2,1,1,2
50763_0,,,,2,1,1,2
50764_0,,,,2,1,1,2
50765_0,,,,2,1,1,2
50766_0,,,,2,1,1,2
50767_0,,,,2,1,1,2
50769_0,,,,2,1,1,2
C(C1CCC(C1C=O)O)=O,,,5,1,1,0,1
50770_0,,,,2,1,1,2
50772_0,,,,2,1,1,2
C(C1CC(CC1C=O)O)(O)=O,,,5,1,1,0,1
50774_0,,,,2,1,1,2
C1(C(CCC1C(C(O)=O)=O)=O)=O,,,5,1,2,0,2
50775_0,,,,2,1,1,2
50777_0,,,,2,1,1,2
C(C1CCC(CC1O)O)(O)=O,,,5,1,1,0,1
50779_0,,,,2,1,1,2
C(C1CC(C)(CC1O)O)(O)=O,,,5,1,1,0,1
50781_0,,,,2,1,1,2
C(C1CC(C(C1O)=O)O)(O)=O,,,5,1,1,0,1
50783_0,,,,2,1,1,2
C(C1CCC(C1O)=O)(O)=O,,,5,1,1,0,1
50785_0,,,,2,1,1,2
C(CC1CCC(C(O)=O)C1C=O)=O,,,5,1,2,0,2
50787_0,,,,2,1,1,2
C(CC1CC(C=O)C(C(O)=O)C1)=O,,,5,1,2,0,2
50789_0,,,,2,1,1,2
C(C1CCC(CC1O)CC=O)(O)=O,,,5,1,2,0,2
50791_0,,,,2,1,1,2
C(C1CCC(C1(C)O)CC=O)(O)=O,,,5,1,2,0,2
50793_0,,,,2,1,1,2
C(C1CC(C(O)=O)C(C=O)C1C)=O,,,5,1,1,0,1
50794_0,,,,2,1,1,2
50796_0,,,,2,1,1,2
C(C1C(C)CC(C(O)=O)C1C=O)=O,,,5,1,1,0,1
50797_0,,,,2,1,1,2
50799_0,,,,2,1,1,2
C(C1CC(C=O)C(C)CC1O)(O)=O,,,5,1,1,0,1
50800_0,,,,2,1,1,2
50802_0,,,,2,1,1,2
C(C1CC(C)(CC1O)CC=O)(O)=O,,,5,1,1,0,1
50804_0,,,,2,1,1,2
C(C1CC(C=O)C(C)C1(C)O)(O)=O,,,5,1,1,0,1
50805_0,,,,2,1,1,2
50807_0,,,,2,1,1,2
C(C1C[C](C(O)=O)CC1C(O)=O)=O,,,5,1,1,0,1
50809_0,,,,2,1,1,2
C(C1CC(C(O)=O)CC1C(O)=O)=O,,,5,1,1,0,1
50811_0,,,,2,1,1,2
C(C1[C](C(O)=O)CCC1C(O)=O)=O,,,5,1,1,0,1
50813_0,,,,2,1,1,2
C(C1C(C(O)=O)CCC1C(O)=O)=O,,,5,1,1,0,1
50815_0,,,,2,1,1,2
C(C1CC([CH]C(O)=O)CC1O)(O)=O,,,5,1,1,0,1
50817_0,,,,2,1,1,2
C(C1C(CC[C](C(O)=O)C1)O)(O)=O,,,5,1,1,0,1
50819_0,,,,2,1,1,2
C(C1CC(CC1O)CC(O)=O)(O)=O,,,5,1,1,0,1
50821_0,,,,2,1,1,2
C(C1CC(C(O)=O)C(CC1)O)(O)=O,,,5,1,1,0,1
50823_0,,,,2,1,1,2
C(C1C(C)(C[C](C(O)=O)C1)O)(O)=O,,,5,1,1,0,1
50825_0,,,,2,1,1,2
C(C1CC(C(O)=O)C(C)(C1)O)(O)=O,,,5,1,1,0,1
50827_0,,,,2,2,1,3
C(CCC1C(C(C(C1O)=O)O)O)=O,,,5,1,1,0,1
50829_0,,,,2,2,1,3
C(CCC1(CC(C(C1O)=O)O)O)=O,,,5,1,1,0,1
50831_0,,,,2,2,1,3
C(CCC1(C(C(CC1O)O)=O)O)=O,,,5,1,1,0,1
50833_0,,,,2,2,1,3
C(CCC1(C(C(C(C1)O)O)=O)O)=O,,,5,1,1,0,1
50835_0,,,,2,2,1,3
C(CCC1C(CC(C1O)=O)O)=O,,,5,1,1,0,1
50836_0,,,,2,2,1,3
50837_0,,,,2,2,1,3
50838_0,,,,2,2,1,3
50840_0,,,,2,2,1,3
C(CCC1(CC(C(C1)=O)O)O)=O,,,5,1,1,0,1
50842_0,,,,2,2,1,3
C1(C(CC(C[CH]C(O)=O)(C1)O)O)=O,,,5,1,1,0,1
50844_0,,,,2,2,1,3
C(CCC1(CC(C(C1)=O)O)O)(O)=O,,,5,1,1,0,1
50846_0,,,,2,2,1,3
C(CC(C)C1(CC(C(C1)=O)O)O)=O,,,5,1,1,0,1
50848_0,,,,2,2,1,3
C(CCC1C(C(CC1O)O)=O)=O,,,5,1,1,0,1
50849_0,,,,2,2,1,3
50850_0,,,,2,2,1,3
50851_0,,,,2,2,1,3
50853_0,,,,2,2,1,3
C1(CC(CC1(CCC=O)O)O)=O,,,5,1,1,0,1
50854_0,,,,2,2,1,3
50855_0,,,,2,2,1,3
50856_0,,,,2,2,1,3
50858_0,,,,2,2,1,3
C1(C(CC(C1CCC(C=O)=O)O)=O)=O,,,5,1,1,0,1
50860_0,,,,2,2,1,3
C(CCC1C(C(CC1O)=O)=O)=O,,,5,1,1,0,1
50861_0,,,,2,2,1,3
50862_0,,,,2,2,1,3
50863_0,,,,2,2,1,3
50865_0,,,,2,2,1,3
C(C(CCC1(CC(C(C1)=O)=O)O)=O)=O,,,5,1,1,0,1
50867_0,,,,2,2,1,3
C(CCC1(CC(C(C1)=O)=O)O)=O,,,5,1,1,0,1
50869_0,,,,2,2,1,3
[CH](C(O)=O)CC1(CC(C(C1)=O)=O)O,,,5,1,1,0,1
50871_0,,,,2,2,1,3
C(CCC1(CC(C(C1)=O)=O)O)(O)=O,,,5,1,1,0,1
50873_0,,,,2,2,1,3
C(CC(C)C1(CC(C(C1)=O)=O)O)=O,,,5,1,1,0,1
50875_0,,,,2,2,1,3
C(CCC(C(C(C=O)=O)CO)O)=O,,,5,1,1,0,1
50877_0,,,,2,2,1,3
C(CCC(C(C=O)=O)(CO)CO)=O,,,5,1,1,0,1
50879_0,,,,2,2,1,3
C(C(CCC=O)(C(CCO)O)O)=O,,,5,1,1,0,1
50881_0,,,,2,2,1,3
C(CCC(CO)C(C(C=O)O)O)=O,,,5,1,1,0,1
50883_0,,,,2,2,1,3
C(CCC(CCO)(C(C=O)O)O)=O,,,5,1,1,0,1
50885_0,,,,2,2,1,3
C(CCC(CC(C(C=O)O)O)O)=O,,,5,1,1,0,1
50887_0,,,,2,2,1,3
C(C(CCC=O)C(CCO)O)=O,,,5,1,1,0,1
50888_0,,,,2,2,1,3
50889_0,,,,2,2,1,3
50890_0,,,,2,2,1,3
50892_0,,,,2,2,1,3
C(CC(C(CCC=O)CO)O)=O,,,5,1,1,0,1
50893_0,,,,2,2,1,3
50894_0,,,,2,2,1,3
50895_0,,,,2,2,1,3
50897_0,,,,2,2,1,3
C(CCC(CCO)(CC=O)O)=O,,,5,1,1,0,1
50899_0,,,,2,2,1,3
C(CC(CCO)(C[CH]C(O)=O)O)=O,,,5,1,1,0,1
50901_0,,,,2,2,1,3
C(CCC(CCO)(CC=O)O)(O)=O,,,5,1,1,0,1
50903_0,,,,2,2,1,3
C(CC(C)C(CCO)(CC=O)O)=O,,,5,1,1,0,1
50905_0,,,,2,2,1,3
C(CCC(CC(CC=O)O)O)=O,,,5,1,1,0,1
50906_0,,,,2,2,1,3
50907_0,,,,2,2,1,3
50908_0,,,,2,2,1,3
50910_0,,,,2,2,1,3
C(CCC(C=O)(C(C=O)CO)O)=O,,,5,1,1,0,1
50912_0,,,,2,2,1,3
C(C(CO)(CCC=O)C(C=O)O)=O,,,5,1,1,0,1
50914_0,,,,2,2,1,3
C(CCC(C(C=O)C(C=O)O)O)=O,,,5,1,1,0,1
50916_0,,,,2,2,1,3
C(C(CO)C(C(CCC=O)O)O)=O,,,5,1,1,0,1
50918_0,,,,2,2,1,3
C(C(CO)C(CCC=O)(CO)O)=O,,,5,1,1,0,1
50920_0,,,,2,2,1,3
C(C(CCC=O)(CO)C(CO)O)=O,,,5,1,1,0,1
50922_0,,,,2,2,1,3
C(C(C(CO)O)C(CCC=O)O)=O,,,5,1,1,0,1
50924_0,,,,2,2,1,3
C(C(CO)C(C(C)CC(O)=O)O)=O,,,5,1,1,0,1
50926_0,,,,2,2,1,3
C(C(CO)C(CCC(C=O)=O)O)=O,,,5,1,1,0,1
50928_0,,,,2,2,1,3
C(C(CO)C(CCC=O)O)=O,,,5,1,1,0,1
50929_0,,,,2,2,1,3
50930_0,,,,2,2,1,3
50931_0,,,,2,2,1,3
50933_0,,,,2,2,1,3
C(C(CO)(CO)C(C)CC(O)=O)=O,,,5,1,1,0,1
50935_0,,,,2,2,1,3
C(C(CCC(C=O)=O)(CO)CO)=O,,,5,1,1,0,1
50937_0,,,,2,2,1,3
C(C(CCC=O)(CO)CO)=O,,,5,1,1,0,1
50938_0,,,,2,2,1,3
50939_0,,,,2,2,1,3
50940_0,,,,2,2,1,3
50942_0,,,,2,2,1,3
C(CO)(C(CCC=O)C(C=O)O)=O,,,5,1,1,0,1
50944_0,,,,2,2,1,3
C(CC(C=O)O)(C(CCC=O)O)=O,,,5,1,1,0,1
50946_0,,,,2,2,1,3
C(CCC(C=O)(CC(CO)=O)O)=O,,,5,1,1,0,1
50948_0,,,,2,2,1,3
C(CCCC(C(C(C=O)O)O)=O)=O,,,5,1,1,0,1
50950_0,,,,2,2,1,3
C(C)(C(CCC=O)(C(C=O)O)O)=O,,,5,1,1,0,1
50952_0,,,,2,2,1,3
C(CCC(C=O)(C(C(C)=O)O)O)=O,,,5,1,1,0,1
50954_0,,,,2,2,1,3
C(CCC(C=O)(C=C)C(C=O)O)=O,,,5,1,1,0,1
50956_0,,,,2,2,1,3
C(C(C=C)(C[CH]C(O)=O)C(C=O)O)=O,,,5,1,1,0,1
50958_0,,,,2,2,1,3
C(CC(C)C(C=O)(C=C)C(C=O)O)=O,,,5,1,1,0,1
50960_0,,,,2,2,1,3
C(CCC(C=O)(C(C=O)C=C)O)=O,,,5,1,1,0,1
50961_0,,,,2,2,1,3
50963_0,,,,2,2,1,3
C(CC(C)C(C=O)(C(C=O)C=C)O)=O,,,5,1,1,0,1
50965_0,,,,2,2,1,3
C(CCC(C=O)(C(C=O)O)O)=O,,,5,1,1,0,1
50966_0,,,,2,2,1,3
50967_0,,,,2,2,1,3
50968_0,,,,2,2,1,3
50969_0,,,,2,2,1,3
50971_0,,,,2,2,1,3
C(C(CCC(C=O)=O)C(C=O)O)=O,,,5,1,1,0,1
50973_0,,,,2,2,1,3
C(CCC(C=O)C(C=O)O)=O,,,5,1,1,0,1
50974_0,,,,2,2,1,3
50975_0,,,,2,2,1,3
50976_0,,,,2,2,1,3
50978_0,,,,2,2,1,3
C(CC(C)C(C=O)(CC=O)O)(O)=O,,,5,1,1,0,1
50980_0,,,,2,2,1,3
C(C(CCC(C=O)=O)(CC=O)O)=O,,,5,1,1,0,1
50982_0,,,,2,2,1,3
C(CCC(C=O)(CC=O)O)=O,,,5,1,1,0,1
50983_0,,,,2,2,1,3
50984_0,,,,2,2,1,3
50986_0,,,,2,2,1,3
C(CC(C)C(C=O)(CC=O)O)=O,,,5,1,1,0,1
50988_0,,,,2,2,1,3
C(CCC(C(C=O)=O)C(C=O)O)=O,,,5,1,1,0,1
50990_0,,,,2,2,1,3
C(CCC(C=O)(CC(C=O)=O)O)=O,,,5,1,1,0,1
50992_0,,,,2,2,1,3
C(CCC(C=O)C(C(C=O)O)O)=O,,,5,1,1,0,1
50994_0,,,,2,2,1,3
C(CCC(C(C=O)O)(CC=O)O)=O,,,5,1,1,0,1
50996_0,,,,2,2,1,3
C(C(C(CC=O)O)(CCC=O)O)=O,,,5,1,1,0,1
50998_0,,,,2,2,1,3
C(C(CCC=O)C(CO)(CO)O)=O,,,5,1,1,0,1
51000_0,,,,2,2,1,3
C(CCC(C(CO)(CC=O)O)O)=O,,,5,1,1,0,1
51002_0,,,,2,2,1,3
C(CCCC(C(C(CO)=O)O)O)=O,,,5,1,1,0,1
51004_0,,,,2,2,1,3
C(CCC(C)(C(C(CO)=O)O)O)=O,,,5,1,1,0,1
51006_0,,,,2,2,1,3
C(CCC(C(CO)=O)(C(C)O)O)=O,,,5,1,1,0,1
51008_0,,,,2,2,1,3
C(CCC(C(C(C(C)O)O)=O)O)=O,,,5,1,1,0,1
51010_0,,,,2,2,1,3
C(CCC(C(O)=O)(C(CO)=O)O)=O,,,5,1,1,0,1
51012_0,,,,2,2,1,3
C(CCC(C(C(C(O)=O)O)=O)O)=O,,,5,1,1,0,1
51014_0,,,,2,2,1,3
C(CCC(C(C(CO)=O)O)O)=O,,,5,1,1,0,1
51015_0,,,,2,2,1,3
51016_0,,,,2,2,1,3
51017_0,,,,2,2,1,3
51019_0,,,,2,2,1,3
C(CCC(C(CO)=O)(CO)O)=O,,,5,1,1,0,1
51020_0,,,,2,2,1,3
51021_0,,,,2,2,1,3
51022_0,,,,2,2,1,3
51024_0,,,,2,2,1,3
C(CCC(C(C(CO)O)=O)O)=O,,,5,1,1,0,1
51025_0,,,,2,2,1,3
51026_0,,,,2,2,1,3
51027_0,,,,2,2,1,3
51029_0,,,,2,2,1,3
C(C(CCC=O)(C(CO)(C)O)O)=O,,,5,1,1,0,1
51031_0,,,,2,2,1,3
C(CCCC(CO)(C(C=O)O)O)=O,,,5,1,1,0,1
51033_0,,,,2,2,1,3
C(CCC(C(C)(C(C=O)O)O)O)=O,,,5,1,1,0,1
51035_0,,,,2,2,1,3
C(C(CCC=O)C(C)(CO)O)=O,,,5,1,1,0,1
51036_0,,,,2,2,1,3
51037_0,,,,2,2,1,3
51038_0,,,,2,2,1,3
51040_0,,,,2,2,1,3
C(CCCC(CO)(CC=O)O)=O,,,5,1,1,0,1
51041_0,,,,2,2,1,3
51042_0,,,,2,2,1,3
51043_0,,,,2,2,1,3
51045_0,,,,2,2,1,3
C(CC(C)(C(CCC=O)O)O)=O,,,5,1,1,0,1
51046_0,,,,2,2,1,3
51047_0,,,,2,2,1,3
51048_0,,,,2,2,1,3
51050_0,,,,2,2,1,3
C(CCC(C(CC(CO)=O)O)O)=O,,,5,1,1,0,1
51052_0,,,,2,2,1,3
C(CCC(CO)(CC(CO)=O)O)=O,,,5,1,1,0,1
51054_0,,,,2,2,1,3
C(CCC(C(CO)=O)C(CO)O)=O,,,5,1,1,0,1
51056_0,,,,2,2,1,3
C(CCC(C(CC(CO)O)=O)O)=O,,,5,1,1,0,1
51058_0,,,,2,2,1,3
C(CCCC(CC(CO)=O)O)=O,,,5,1,1,0,1
51059_0,,,,2,2,1,3
51060_0,,,,2,2,1,3
51061_0,,,,2,2,1,3
51063_0,,,,2,2,1,3
C(CCC(C)(CC(CO)=O)O)=O,,,5,1,1,0,1
51064_0,,,,2,2,1,3
51065_0,,,,2,2,1,3
51066_0,,,,2,2,1,3
51068_0,,,,2,2,1,3
C(CCC(C(CO)=O)C(C)O)=O,,,5,1,1,0,1
51069_0,,,,2,2,1,3
51070_0,,,,2,2,1,3
51071_0,,,,2,2,1,3
51073_0,,,,2,2,1,3
C(CCC(C(CC(C)O)=O)O)=O,,,5,1,1,0,1
51074_0,,,,2,2,1,3
51075_0,,,,2,2,1,3
51076_0,,,,2,2,1,3
51078_0,,,,2,2,1,3
C(CCC(C(O)=O)C(CO)=O)=O,,,5,1,1,0,1
51079_0,,,,2,2,1,3
51080_0,,,,2,2,1,3
51081_0,,,,2,2,1,3
51083_0,,,,2,2,1,3
C(CCC(C(CC(O)=O)=O)O)=O,,,5,1,1,0,1
51084_0,,,,2,2,1,3
51085_0,,,,2,2,1,3
51086_0,,,,2,2,1,3
51088_0,,,,2,2,1,3
C(CC(C)C(CC(CO)=O)O)(O)=O,,,5,1,1,0,1
51090_0,,,,2,2,1,3
C(CO)(CC(CCC(C=O)=O)O)=O,,,5,1,1,0,1
51092_0,,,,2,2,1,3
C(CCC(CC(CO)=O)O)=O,,,5,1,1,0,1
51093_0,,,,2,2,1,3
51094_0,,,,2,2,1,3
51095_0,,,,2,2,1,3
51097_0,,,,2,2,1,3
C(CC(C)C(C(CO)=O)CO)(O)=O,,,5,1,1,0,1
51099_0,,,,2,2,1,3
C(CO)(C(CO)CCC(C=O)=O)=O,,,5,1,1,0,1
51101_0,,,,2,2,1,3
C(CCC(C(CO)=O)CO)=O,,,5,1,1,0,1
51102_0,,,,2,2,1,3
51103_0,,,,2,2,1,3
51104_0,,,,2,2,1,3
51106_0,,,,2,2,1,3
C(CC(C)C(C(CCO)=O)O)(O)=O,,,5,1,1,0,1
51108_0,,,,2,2,1,3
C(C(CCC(C=O)=O)O)(CCO)=O,,,5,1,1,0,1
51110_0,,,,2,2,1,3
C(CCC(C(CCO)=O)O)=O,,,5,1,1,0,1
51111_0,,,,2,2,1,3
51112_0,,,,2,2,1,3
51113_0,,,,2,2,1,3
51115_0,,,,2,2,1,3
C(CCC(C(C(C(C)=O)O)O)O)=O,,,5,1,1,0,1
51117_0,,,,2,2,1,3
C(CCC(CO)(C(C(C)=O)O)O)=O,,,5,1,1,0,1
51119_0,,,,2,2,1,3
C(CCCC(C(C(CO)O)O)=O)=O,,,5,1,1,0,1
51121_0,,,,2,2,1,3
C(CCC(C(C)=O)(C(CO)O)O)=O,,,5,1,1,0,1
51123_0,,,,2,2,1,3
C(CCCC(C(C(C)=O)O)O)=O,,,5,1,1,0,1
51124_0,,,,2,2,1,3
51125_0,,,,2,2,1,3
51126_0,,,,2,2,1,3
51128_0,,,,2,2,1,3
C(CCC(C)(C(C(C)=O)O)O)=O,,,5,1,1,0,1
51129_0,,,,2,2,1,3
51130_0,,,,2,2,1,3
51132_0,,,,2,2,1,3
C(CC(C)C(C)(C(C(C)=O)O)O)=O,,,5,1,1,0,1
51134_0,,,,2,2,1,3
C(CCCC(C(C(C)O)O)=O)=O,,,5,1,1,0,1
51135_0,,,,2,2,1,3
51136_0,,,,2,2,1,3
51137_0,,,,2,2,1,3
51139_0,,,,2,2,1,3
C(CCC(C(C)=O)(C(C)O)O)=O,,,5,1,1,0,1
51140_0,,,,2,2,1,3
51141_0,,,,2,2,1,3
51142_0,,,,2,2,1,3
51144_0,,,,2,2,1,3
C(C(C(CCCC=O)=O)O)(O)=O,,,5,1,1,0,1
51145_0,,,,2,2,1,3
51146_0,,,,2,2,1,3
51147_0,,,,2,2,1,3
51149_0,,,,2,2,1,3
C(CCC(C(O)=O)(C(C)=O)O)=O,,,5,1,1,0,1
51150_0,,,,2,2,1,3
51151_0,,,,2,2,1,3
51152_0,,,,2,2,1,3
51154_0,,,,2,2,1,3
C(CC(C)C(C(C(C)=O)O)O)(O)=O,,,5,1,1,0,1
51156_0,,,,2,2,1,3
C(C)(C(C(CCC(C=O)=O)O)O)=O,,,5,1,1,0,1
51158_0,,,,2,2,1,3
C(CCC(C(C(C)=O)O)O)=O,,,5,1,1,0,1
51159_0,,,,2,2,1,3
51160_0,,,,2,2,1,3
51162_0,,,,2,2,1,3
C(CC(C)C(C(C(C)=O)O)O)=O,,,5,1,1,0,1
51164_0,,,,2,2,1,3
C(CC(C)CC(C(CO)O)=O)(O)=O,,,5,1,1,0,1
51166_0,,,,2,2,1,3
C(C(CO)O)(CCCC(C=O)=O)=O,,,5,1,1,0,1
51168_0,,,,2,2,1,3
C(CCCC(C(CO)O)=O)=O,,,5,1,1,0,1
51169_0,,,,2,2,1,3
51170_0,,,,2,2,1,3
51171_0,,,,2,2,1,3
51173_0,,,,2,2,1,3
C(CC(C)C(C(C)=O)(CO)O)(O)=O,,,5,1,1,0,1
51175_0,,,,2,2,1,3
C(C)(C(CO)(CCC(C=O)=O)O)=O,,,5,1,1,0,1
51177_0,,,,2,2,1,3
C(CCC(C(C)=O)(CO)O)=O,,,5,1,1,0,1
51178_0,,,,2,2,1,3
51179_0,,,,2,2,1,3
51180_0,,,,2,2,1,3
51182_0,,,,2,2,1,3
C(CCC(C=O)(C=C)C(C=CC)O)=O,,,5,1,1,0,1
51184_0,,,,2,2,1,3
C(CCC(C=CC)(C(C=O)C=C)O)=O,,,5,1,1,0,1
51186_0,,,,2,2,1,3
C(CCCC=CC(C(C=O)C=C)O)=O,,,5,1,1,0,1
51188_0,,,,2,2,1,3
C(CCC(C=O)(C(C=CC)O)O)=O,,,5,1,1,0,1
51190_0,,,,2,2,1,3
C(CCC(C=CC)(C(C=O)O)O)=O,,,5,1,1,0,1
51192_0,,,,2,2,1,3
C(CCCC=CC(C(C=O)O)O)=O,,,5,1,1,0,1
51194_0,,,,2,2,1,3
C(C(CCC(C=O)=O)C(C=CC)O)=O,,,5,1,1,0,1
51196_0,,,,2,2,1,3
C(CCC(C=O)C(C=CC)O)=O,,,5,1,1,0,1
51197_0,,,,2,2,1,3
51198_0,,,,2,2,1,3
51199_0,,,,2,2,1,3
51201_0,,,,2,2,1,3
C(CC(C=CC)(CCC(C=O)=O)O)=O,,,5,1,1,0,1
51203_0,,,,2,2,1,3
C(CCC(C=CC)(CC=O)O)=O,,,5,1,1,0,1
51205_0,,,,2,2,1,3
C(CC(C=CC)(C[CH]C(O)=O)O)=O,,,5,1,1,0,1
51207_0,,,,2,2,1,3
C(CCC(C=CC)(CC=O)O)(O)=O,,,5,1,1,0,1
51209_0,,,,2,2,1,3
C(CC(C)C(C=CC)(CC=O)O)=O,,,5,1,1,0,1
51211_0,,,,2,2,1,3
C(CC(C=CCCCC(C=O)=O)O)=O,,,5,1,1,0,1
51213_0,,,,2,2,1,3
C(CC(C=CCCCC=O)O)=O,,,5,1,1,0,1
51214_0,,,,2,2,1,3
51215_0,,,,2,2,1,3
51216_0,,,,2,2,1,3
51218_0,,,,2,2,1,3
C(CCC(C(C=O)=O)C(C=CC)O)=O,,,5,1,1,0,1
51220_0,,,,2,2,1,3
C(CCC(C=CC)(CC(C=O)=O)O)=O,,,5,1,1,0,1
51222_0,,,,2,2,1,3
C(CCCC=CC(CC(C=O)=O)O)=O,,,5,1,1,0,1
51224_0,,,,2,2,1,3
C(CCC(C=O)(C=C)C(CC=C)O)=O,,,5,1,1,0,1
51226_0,,,,2,2,1,3
C(C(C=C)C(C(C=C)CCC=O)O)=O,,,5,1,1,0,1
51228_0,,,,2,2,1,3
C(CCC(CC=C)(C(C=O)C=C)O)=O,,,5,1,1,0,1
51230_0,,,,2,2,1,3
C(C(C(CC=C)O)(CCC=O)O)=O,,,5,1,1,0,1
51232_0,,,,2,2,1,3
C(CCC(C=C)C(C(C=O)O)O)=O,,,5,1,1,0,1
51234_0,,,,2,2,1,3
C(CCC(C(C=O)O)(CC=C)O)=O,,,5,1,1,0,1
51236_0,,,,2,2,1,3
C(C(CCC(C=O)=O)C(CC=C)O)=O,,,5,1,1,0,1
51238_0,,,,2,2,1,3
C(C(CCC=O)C(CC=C)O)=O,,,5,1,1,0,1
51239_0,,,,2,2,1,3
51240_0,,,,2,2,1,3
51241_0,,,,2,2,1,3
51243_0,,,,2,2,1,3
C(CC(C(C=C)CCC(C=O)=O)O)=O,,,5,1,1,0,1
51245_0,,,,2,2,1,3
C(CCC(C=C)C(CC=O)O)=O,,,5,1,1,0,1
51246_0,,,,2,2,1,3
51247_0,,,,2,2,1,3
51248_0,,,,2,2,1,3
51250_0,,,,2,2,1,3
C(CC(CCC(C=O)=O)(CC=C)O)=O,,,5,1,1,0,1
51252_0,,,,2,2,1,3
C(CCC(CC=O)(CC=C)O)=O,,,5,1,1,0,1
51254_0,,,,2,2,1,3
C(CC(CC=C)(C[CH]C(O)=O)O)=O,,,5,1,1,0,1
51256_0,,,,2,2,1,3
C(CCC(CC=O)(CC=C)O)(O)=O,,,5,1,1,0,1
51258_0,,,,2,2,1,3
C(CC(C(C)CC=O)(CC=C)O)=O,,,5,1,1,0,1
51260_0,,,,2,2,1,3
C(CCC(C(C=O)=O)C(CC=C)O)=O,,,5,1,1,0,1
51262_0,,,,2,2,1,3
C(CCC(C=C)C(CC(C=O)=O)O)=O,,,5,1,1,0,1
51264_0,,,,2,2,1,3
C(CCC(CC=C)(CC(C=O)=O)O)=O,,,5,1,1,0,1
51266_0,,,,2,2,1,3
C(C(C=C)C(C(CCC=O)O)O)=O,,,5,1,1,0,1
51268_0,,,,2,2,1,3
C(C(C=C)C(CCC=O)(CO)O)=O,,,5,1,1,0,1
51270_0,,,,2,2,1,3
C(C(C=C)(CCC=O)C(CO)O)=O,,,5,1,1,0,1
51272_0,,,,2,2,1,3
C(C(C=C)C(CCCC(C=O)=O)O)=O,,,5,1,1,0,1
51274_0,,,,2,2,1,3
C(C(C=C)C(CCCC=O)O)=O,,,5,1,1,0,1
51275_0,,,,2,2,1,3
51276_0,,,,2,2,1,3
51277_0,,,,2,2,1,3
51279_0,,,,2,2,1,3
C(C(C=C)C(C)(CCC(C=O)=O)O)=O,,,5,1,1,0,1
51281_0,,,,2,2,1,3
C(C(C=C)C(C)(CCC=O)O)=O,,,5,1,1,0,1
51282_0,,,,2,2,1,3
51283_0,,,,2,2,1,3
51285_0,,,,2,2,1,3
C(C(C=C)C(C)(C(C)CC=O)O)=O,,,5,1,1,0,1
51287_0,,,,2,2,1,3
C(C(C=C)(CCC(C=O)=O)C(C)O)=O,,,5,1,1,0,1
51289_0,,,,2,2,1,3
C(C(C=C)(CCC=O)C(C)O)=O,,,5,1,1,0,1
51291_0,,,,2,2,1,3
C(C(C=C)(C(C)O)C[CH]C(O)=O)=O,,,5,1,1,0,1
51293_0,,,,2,2,1,3
C(C(C=C)(CCC(O)=O)C(C)O)=O,,,5,1,1,0,1
51295_0,,,,2,2,1,3
C(C(C=C)(C(C)CC=O)C(C)O)=O,,,5,1,1,0,1
51297_0,,,,2,2,1,3
C(C(C(O)=O)(C=C)CCC(C=O)=O)=O,,,5,1,1,0,1
51299_0,,,,2,2,1,3
C(C(C(O)=O)(C=C)CCC=O)=O,,,5,1,1,0,1
51301_0,,,,2,2,1,3
C(C(C(O)=O)(C=C)C[CH]C(O)=O)=O,,,5,1,1,0,1
51303_0,,,,2,2,1,3
C(C(C(O)=O)(C=C)CCC(O)=O)=O,,,5,1,1,0,1
51305_0,,,,2,2,1,3
C(C(C(O)=O)(C=C)C(C)CC=O)=O,,,5,1,1,0,1
51307_0,,,,2,2,1,3
C(CCCC(C=O)(C(C=O)C=C)O)=O,,,5,1,1,0,1
51309_0,,,,2,2,1,3
C(CCC(C=O)(C=C)C(C=O)(C)O)=O,,,5,1,1,0,1
51311_0,,,,2,2,1,3
C(CCCC(C(C(C=O)C=C)O)=O)=O,,,5,1,1,0,1
51313_0,,,,2,2,1,3
C(CCC(C(C)=O)(C(C=O)C=C)O)=O,,,5,1,1,0,1
51315_0,,,,2,2,1,3
C(CCC(C=O)(C=C)C(C(C)=O)O)=O,,,5,1,1,0,1
51317_0,,,,2,2,1,3
C(C(C=C)C(CCC(C(C)=O)=O)O)=O,,,5,1,1,0,1
51319_0,,,,2,2,1,3
C(C(C=C)C(C(C)CC(O)=O)O)=O,,,5,1,1,0,1
51321_0,,,,2,2,1,3
C(C(C=C)C(C(C=O)C(C=O)C)O)=O,,,5,1,1,0,1
51323_0,,,,2,2,1,3
C(C(C)(C(C(C=O)C=C)O)CC=O)=O,,,5,1,1,0,1
51325_0,,,,2,2,1,3
C(C(CC(C(C=O)C=C)O)CC=O)=O,,,5,1,1,0,1
51327_0,,,,2,2,1,3
C(C(C(C(C=O)C=C)O)CC(C)=O)=O,,,5,1,1,0,1
51329_0,,,,2,2,1,3
C(C)(C(C(C(C=O)C=C)O)CC=O)=O,,,5,1,1,0,1
51331_0,,,,2,2,1,3
C(C(C=C)C(CCC(C=O)=O)O)=O,,,5,1,1,0,1
51333_0,,,,2,2,1,3
C(C(C=C)C(C(C)CC(C=O)=O)O)=O,,,5,1,1,0,1
51335_0,,,,2,2,1,3
C(C(C=C)C(CCC=O)O)=O,,,5,1,1,0,1
51337_0,,,,2,2,1,3
C(C(C=C)C(CC(C(O)=O)C=C)O)=O,,,5,1,1,0,1
51338_0,,,,2,2,1,3
51339_0,,,,2,2,1,3
51340_0,,,,2,2,1,3
51342_0,,,,2,2,1,3
C(C(C=C)(CCC(C(C)=O)=O)CO)=O,,,5,1,1,0,1
51344_0,,,,2,2,1,3
C(C(C=C)(CO)C(C)CC(O)=O)=O,,,5,1,1,0,1
51346_0,,,,2,2,1,3
C(C(C)C(C=O)C(C=O)(C=C)CO)=O,,,5,1,1,0,1
51348_0,,,,2,2,1,3
C(C(C)(CC=O)C(C=O)(C=C)CO)=O,,,5,1,1,0,1
51350_0,,,,2,2,1,3
C(C(CC(C=O)(C=C)CO)CC=O)=O,,,5,1,1,0,1
51352_0,,,,2,2,1,3
C(CC(C=O)C(C=O)(C=C)CO)(C)=O,,,5,1,1,0,1
51354_0,,,,2,2,1,3
C(CC(C(C)=O)C(C=O)(C=C)CO)=O,,,5,1,1,0,1
51356_0,,,,2,2,1,3
C(C(C=C)(CCC(C=O)=O)CO)=O,,,5,1,1,0,1
51358_0,,,,2,2,1,3
C(C(C=C)(CO)C(C)CC(C=O)=O)=O,,,5,1,1,0,1
51360_0,,,,2,2,1,3
C(C(C=C)(CCC=O)CO)=O,,,5,1,1,0,1
51362_0,,,,2,2,1,3
C(C(C=C)(CC(C(O)=O)C=C)CO)=O,,,5,1,1,0,1
51363_0,,,,2,2,1,3
51364_0,,,,2,2,1,3
51365_0,,,,2,2,1,3
51366_0,,,,2,2,1,3
51367_0,,,,2,2,1,3
51368_0,,,,2,2,1,3
51369_0,,,,2,2,1,3
51370_0,,,,2,2,1,3
51371_0,,,,2,2,1,3
51372_0,,,,2,2,1,3
51373_0,,,,2,2,1,3
51375_0,,,,2,2,1,3
C(C(CCC=O)C(C(CO)O)O)=O,,,5,1,1,0,1
51377_0,,,,2,2,1,3
C(CCC(C(C(CC=O)O)O)O)=O,,,5,1,1,0,1
51379_0,,,,2,2,1,3
C(CC(C(CCC=O)(CO)O)O)=O,,,5,1,1,0,1
51381_0,,,,2,2,1,3
C(CCC(C(CO)O)(CC=O)O)=O,,,5,1,1,0,1
51383_0,,,,2,2,1,3
C(C(CCC=O)(C(CO)O)O)=O,,,5,1,1,0,1
51384_0,,,,2,2,1,3
51385_0,,,,2,2,1,3
51386_0,,,,2,2,1,3
51388_0,,,,2,2,1,3
C(CCC(C(C(C=O)O)O)O)=O,,,5,1,1,0,1
51389_0,,,,2,2,1,3
51390_0,,,,2,2,1,3
51391_0,,,,2,2,1,3
51393_0,,,,2,2,1,3
C(CCC(CO)(C(C=O)O)O)=O,,,5,1,1,0,1
51394_0,,,,2,2,1,3
51395_0,,,,2,2,1,3
51396_0,,,,2,2,1,3
51397_0,,,,2,2,1,3
51399_0,,,,2,2,1,3
C(C(CCC(C=O)=O)C(CO)O)=O,,,5,1,1,0,1
51401_0,,,,2,2,1,3
C(C(CCC=O)C(CO)O)=O,,,5,1,1,0,1
51402_0,,,,2,2,1,3
51403_0,,,,2,2,1,3
51404_0,,,,2,2,1,3
51406_0,,,,2,2,1,3
C(CC(C)C(C(CC=O)O)O)(O)=O,,,5,1,1,0,1
51408_0,,,,2,2,1,3
C(CC(C(CCC(C=O)=O)O)O)=O,,,5,1,1,0,1
51410_0,,,,2,2,1,3
C(CCC(C(CC=O)O)O)=O,,,5,1,1,0,1
51411_0,,,,2,2,1,3
51412_0,,,,2,2,1,3
51413_0,,,,2,2,1,3
51415_0,,,,2,2,1,3
C(CC(C)C(CO)(CC=O)O)(O)=O,,,5,1,1,0,1
51417_0,,,,2,2,1,3
C(CC(CCC(C=O)=O)(CO)O)=O,,,5,1,1,0,1
51419_0,,,,2,2,1,3
C(CCC(CO)(CC=O)O)=O,,,5,1,1,0,1
51421_0,,,,2,2,1,3
C(CC(CO)(C[CH]C(O)=O)O)=O,,,5,1,1,0,1
51423_0,,,,2,2,1,3
C(CCC(CO)(CC=O)O)(O)=O,,,5,1,1,0,1
51425_0,,,,2,2,1,3
C(CC(CO)(C(C)CC=O)O)=O,,,5,1,1,0,1
51427_0,,,,2,2,1,3
C(CCC(C(C=O)=O)C(CO)O)=O,,,5,1,1,0,1
51429_0,,,,2,2,1,3
C(CCC(C(CC(C=O)=O)O)O)=O,,,5,1,1,0,1
51431_0,,,,2,2,1,3
C(CCC(CO)(CC(C=O)=O)O)=O,,,5,1,1,0,1
51433_0,,,,2,2,1,3
C(CCCC(C(C(C=O)O)O)O)=O,,,5,1,1,0,1
51435_0,,,,2,2,1,3
C(CCC(C)(C(C(C=O)O)O)O)=O,,,5,1,1,0,1
51437_0,,,,2,2,1,3
C(CCC(C(C)O)(C(C=O)O)O)=O,,,5,1,1,0,1
51439_0,,,,2,2,1,3
C(C(CCC=O)(C(C(C)O)O)O)=O,,,5,1,1,0,1
51441_0,,,,2,2,1,3
C(C(CCC=O)(C(C=O)O)O)(O)=O,,,5,1,1,0,1
51443_0,,,,2,2,1,3
C(CCC(C=O)(C(C(O)=O)O)O)=O,,,5,1,1,0,1
51444_0,,,,2,2,1,3
51446_0,,,,2,2,1,3
C(C(C(CCCC(C=O)=O)O)O)=O,,,5,1,1,0,1
51448_0,,,,2,2,1,3
C(CCCC(C(C=O)O)O)=O,,,5,1,1,0,1
51449_0,,,,2,2,1,3
51450_0,,,,2,2,1,3
51451_0,,,,2,2,1,3
51453_0,,,,2,2,1,3
C(CC(C)C(C)(C(C=O)O)O)(O)=O,,,5,1,1,0,1
51455_0,,,,2,2,1,3
C(C(C(CCC(C=O)=O)(C)O)O)=O,,,5,1,1,0,1
51457_0,,,,2,2,1,3
C(CCC(C)(C(C=O)O)O)=O,,,5,1,1,0,1
51458_0,,,,2,2,1,3
51459_0,,,,2,2,1,3
51461_0,,,,2,2,1,3
C(CC(C)C(C)(C(C=O)O)O)=O,,,5,1,1,0,1
51463_0,,,,2,2,1,3
C(C(C(C)O)(C(C)CC(O)=O)O)=O,,,5,1,1,0,1
51465_0,,,,2,2,1,3
C(C(CCC(C=O)=O)(C(C)O)O)=O,,,5,1,1,0,1
51467_0,,,,2,2,1,3
C(C(CCC=O)(C(C)O)O)=O,,,5,1,1,0,1
51468_0,,,,2,2,1,3
51469_0,,,,2,2,1,3
51470_0,,,,2,2,1,3
51472_0,,,,2,2,1,3
C(CCCC(C=O)(C(C=O)O)O)=O,,,5,1,1,0,1
51474_0,,,,2,2,1,3
C(CCC(C=O)(C(C=O)(C)O)O)=O,,,5,1,1,0,1
51476_0,,,,2,2,1,3
C(C(CCC=O)C(C(C)O)O)=O,,,5,1,1,0,1
51477_0,,,,2,2,1,3
51478_0,,,,2,2,1,3
51479_0,,,,2,2,1,3
51481_0,,,,2,2,1,3
C(CCCC(C(CC=O)O)O)=O,,,5,1,1,0,1
51482_0,,,,2,2,1,3
51483_0,,,,2,2,1,3
51484_0,,,,2,2,1,3
51486_0,,,,2,2,1,3
C(CCC(C)(C(CC=O)O)O)=O,,,5,1,1,0,1
51487_0,,,,2,2,1,3
51488_0,,,,2,2,1,3
51489_0,,,,2,2,1,3
51491_0,,,,2,2,1,3
C(CC(CCC=O)(C(C)O)O)=O,,,5,1,1,0,1
51493_0,,,,2,2,1,3
C(CC(C(C)O)(C[CH]C(O)=O)O)=O,,,5,1,1,0,1
51495_0,,,,2,2,1,3
C(CCC(C(C)O)(CC=O)O)(O)=O,,,5,1,1,0,1
51497_0,,,,2,2,1,3
C(CC(C(C)CC=O)(C(C)O)O)=O,,,5,1,1,0,1
51499_0,,,,2,2,1,3
C(CCC(C=O)C(C(O)=O)O)=O,,,5,1,2,0,2
51500_0,,,,2,2,1,3
51501_0,,,,2,2,1,3
51502_0,,,,2,2,1,3
51504_0,,,,2,2,1,3
C(C(CCC=O)(CC=O)O)(O)=O,,,5,1,1,0,1
51505_0,,,,2,2,1,3
51506_0,,,,2,2,1,3
51508_0,,,,2,2,1,3
C(C(C(C)CC=O)(CC=O)O)(O)=O,,,5,1,1,0,1
51510_0,,,,2,2,1,3
C(CCC(C(C(C(O)=O)O)O)O)=O,,,5,1,1,0,1
51512_0,,,,2,2,1,3
C(CCC(CO)(C(C(O)=O)O)O)=O,,,5,1,1,0,1
51514_0,,,,2,2,1,3
C(C(CCC=O)(C(CO)O)O)(O)=O,,,5,1,1,0,1
51516_0,,,,2,2,1,3
C(CCC(CC(C(O)=O)O)O)=O,,,5,1,1,0,1
51517_0,,,,2,2,1,3
51518_0,,,,2,2,1,3
51519_0,,,,2,2,1,3
51521_0,,,,2,2,1,3
C(CCC(CO)C(C(O)=O)O)=O,,,5,1,1,0,1
51522_0,,,,2,2,1,3
51523_0,,,,2,2,1,3
51524_0,,,,2,2,1,3
51526_0,,,,2,2,1,3
C(C(CCC=O)(CCO)O)(O)=O,,,5,1,1,0,1
51528_0,,,,2,2,1,3
C(C(CCO)(C[CH]C(O)=O)O)(O)=O,,,5,1,1,0,1
51530_0,,,,2,2,1,3
C(C(CCC(O)=O)(CCO)O)(O)=O,,,5,1,1,0,1
51532_0,,,,2,2,1,3
C(C(CCO)(C(C)CC=O)O)(O)=O,,,5,1,1,0,1
51534_0,,,,2,2,1,3
C(CCC1C(C(CC(C1=O)=O)=O)=O)=O,,,5,1,1,0,1
51536_0,,,,2,2,1,3
C(CCCC(C(CC(C=O)=O)=O)=O)=O,,,5,1,1,0,1
51538_0,,,,2,2,1,3
C(CCC(C(C=O)=O)C(C(C)=O)=O)=O,,,5,1,1,0,1
51540_0,,,,2,2,1,3
C(CCC(C=O)C(C(CO)=O)=O)=O,,,5,1,1,0,1
51542_0,,,,2,2,1,3
C(CCC(C(C(CC=O)=O)=O)O)=O,,,5,1,1,0,1
51544_0,,,,2,2,1,3
C(CCCC(C(C(C(C)=O)=O)=O)=O)=O,,,5,1,1,0,1
51546_0,,,,2,2,1,3
C(CCCC(C(CCO)=O)=O)=O,,,5,1,1,0,1
51547_0,,,,2,2,1,3
51548_0,,,,2,2,1,3
51549_0,,,,2,2,1,3
51551_0,,,,2,2,1,3
C(CCC(C(C(C)=O)=O)CO)=O,,,5,1,1,0,1
51552_0,,,,2,2,1,3
51553_0,,,,2,2,1,3
51554_0,,,,2,2,1,3
51556_0,,,,2,2,1,3
C(CCC(CC(C(C)=O)=O)O)=O,,,5,1,1,0,1
51557_0,,,,2,2,1,3
51558_0,,,,2,2,1,3
51560_0,,,,2,2,1,3
C(CC(C)C(CC(C(C)=O)=O)O)=O,,,5,1,1,0,1
51562_0,,,,2,2,1,3
C(CCCC(C(CC(O)=O)=O)=O)=O,,,5,1,1,0,1
51564_0,,,,2,2,1,3
C(CCC(C(O)=O)C(C(C)=O)=O)=O,,,5,1,2,0,2
51566_0,,,,2,2,1,3
C(CCC(C(C(CO)=O)=O)O)=O,,,5,1,1,0,1
51568_0,,,,2,2,1,3
C([CH]CC(C(C(CO)=O)=O)O)(O)=O,,,5,1,1,0,1
51570_0,,,,2,2,1,3
C(CCC(C(C(CO)=O)=O)O)(O)=O,,,5,1,1,0,1
51572_0,,,,2,2,1,3
C(CC(C)C(C(C(CO)=O)=O)O)=O,,,5,1,1,0,1
51574_0,,,,2,2,1,3
C(C(C(C=O)=O)(CCCC=O)O)=O,,,5,1,1,0,1
51576_0,,,,2,2,1,3
C(CCCC(C(C(C=O)=O)O)=O)=O,,,5,1,1,0,1
51578_0,,,,2,2,1,3
C(CCC(C(C)=O)(C(C=O)=O)O)=O,,,5,1,1,0,1
51580_0,,,,2,2,1,3
C(CC(C)CC(C(CO)=O)=O)(O)=O,,,5,1,1,0,1
51582_0,,,,2,2,1,3
C(C=O)(CCCC(C(CO)=O)=O)=O,,,5,1,2,0,2
51584_0,,,,2,2,1,3
C(CCCC(C(CO)=O)=O)=O,,,5,1,2,0,2
51585_0,,,,2,2,1,3
51586_0,,,,2,2,1,3
51587_0,,,,2,2,1,3
51589_0,,,,2,2,1,3
C(CC(C)C(C(C(C)=O)=O)O)(O)=O,,,5,1,1,0,1
51591_0,,,,2,2,1,3
C(C=O)(CCC(C(C(C)=O)=O)O)=O,,,5,1,1,0,1
51593_0,,,,2,2,1,3
C(CCC(C(C(C)=O)=O)O)=O,,,5,1,1,0,1
51594_0,,,,2,2,1,3
51595_0,,,,2,2,1,3
51596_0,,,,2,2,1,3
51598_0,,,,2,2,1,3
C(CC(C)CC(C(C=O)=O)O)(O)=O,,,5,1,1,0,1
51600_0,,,,2,2,1,3
C(C=O)(CCCC(C(C=O)=O)O)=O,,,5,1,1,0,1
51602_0,,,,2,2,1,3
C(CCCC(C(C=O)=O)O)=O,,,5,1,1,0,1
51603_0,,,,2,2,1,3
51604_0,,,,2,2,1,3
51605_0,,,,2,2,1,3
51607_0,,,,2,2,1,3
C(CC(C)C(C(C=O)=O)(C)O)(O)=O,,,5,1,1,0,1
51609_0,,,,2,2,1,3
C(C=O)(C(C)(CCC(C=O)=O)O)=O,,,5,1,1,0,1
51611_0,,,,2,2,1,3
C(CCC(C(C=O)=O)(C)O)=O,,,5,1,1,0,1
51612_0,,,,2,2,1,3
51613_0,,,,2,2,1,3
51614_0,,,,2,2,1,3
51616_0,,,,2,2,1,3
C(C(C)=O)(CCCC(C(C=O)=O)=O)=O,,,5,1,1,0,1
51618_0,,,,2,2,1,3
C(CC(C)CC(C(C=O)=O)=O)(O)=O,,,5,1,1,0,1
51620_0,,,,2,2,1,3
C(C(C)C(C=O)CC(C(C=O)=O)=O)=O,,,5,1,1,0,1
51622_0,,,,2,2,1,3
C(C(C)(CC=O)CC(C(C=O)=O)=O)=O,,,5,1,1,0,1
51624_0,,,,2,2,1,3
C(C(CCC(C(C=O)=O)=O)CC=O)=O,,,5,1,1,0,1
51626_0,,,,2,2,1,3
C(C(CC(C(C=O)=O)=O)CC(C)=O)=O,,,5,1,1,0,1
51628_0,,,,2,2,1,3
C(CC(C(C)=O)CC(C(C=O)=O)=O)=O,,,5,1,1,0,1
51630_0,,,,2,2,1,3
C(C(CCCC(C(C=O)=O)=O)=O)=O,,,5,1,1,0,1
51632_0,,,,2,2,1,3
C(C(CC(C)CC(C(C=O)=O)=O)=O)=O,,,5,1,1,0,1
51634_0,,,,2,2,1,3
C(CCCC(C(C=O)=O)=O)=O,,,5,1,1,0,1
51636_0,,,,2,2,1,3
C(C(C=C)CCC(C(C=O)=O)=O)(O)=O,,,5,1,1,0,1
51637_0,,,,2,2,1,3
51638_0,,,,2,2,1,3
51639_0,,,,2,2,1,3
51641_0,,,,2,2,1,3
C=CC(C(C(CCC(C=O)=O)O)=O)=O,,,5,1,1,0,1
51643_0,,,,2,2,1,3
C(CCC(C(C(C=C)=O)=O)O)=O,,,5,1,1,0,1
51645_0,,,,2,2,1,3
C=CC(C(C(C[CH]C(O)=O)O)=O)=O,,,5,1,1,0,1
51647_0,,,,2,2,1,3
C(CCC(C(C(C=C)=O)=O)O)(O)=O,,,5,1,1,0,1
51649_0,,,,2,2,1,3
C(CC(C)C(C(C(C=C)=O)=O)O)=O,,,5,1,1,0,1
51651_0,,,,2,2,1,3
C(C)(CCCCC(C(CO)=O)=O)=O,,,5,1,1,0,1
51653_0,,,,2,2,1,3
C(C)(C(C)CCC(C(CO)=O)=O)=O,,,5,1,1,0,1
51655_0,,,,2,2,1,3
C(CC)(CCCC(C(CO)=O)=O)=O,,,5,1,1,0,1
51657_0,,,,2,2,1,3
C(C(CO)=O)(CCC(CO)CO)=O,,,5,1,1,0,1
51659_0,,,,2,2,1,3
C(C(CO)=O)(CCC(CCO)O)=O,,,5,1,1,0,1
51661_0,,,,2,2,1,3
C(C)=CC(CCC(C(CO)=O)=O)O,,,5,1,1,0,1
51663_0,,,,2,2,1,3
C(CCCC(C(CO)=O)=O)=CCO,,,5,1,1,0,1
51665_0,,,,2,2,1,3
C(C(CO)CCC(C(CO)=O)=O)=C,,,5,1,1,0,1
51667_0,,,,2,2,1,3
C(CC(CCC(C(CO)=O)=O)O)=C,,,5,1,1,0,1
51669_0,,,,2,2,1,3
C(C(CO)=O)(CCCC(CO)O)=O,,,5,1,1,0,1
51671_0,,,,2,2,1,3
C(C(CO)=O)(CCC(CO)(C)O)=O,,,5,1,1,0,1
51673_0,,,,2,2,1,3
C(C(CO)=O)(CCC(C(C)O)O)=O,,,5,1,1,0,1
51675_0,,,,2,2,1,3
C([C](CCC(C(CO)=O)=O)O)(O)=O,,,5,1,1,0,1
51677_0,,,,2,2,1,3
C(C(C=O)CCC(C(CO)=O)=O)=O,,,5,1,1,0,1
51679_0,,,,2,2,1,3
C(C(CCCC(C(CO)=O)=O)O)=C,,,5,1,1,0,1
51681_0,,,,2,2,1,3
C(C(C)(CCC(C(CO)=O)=O)O)=C,,,5,1,1,0,1
51682_0,,,,2,2,1,3
51684_0,,,,2,2,1,3
C(C(CCC(C(CO)=O)=O)(O)O)=O,,,5,1,1,0,1
51685_0,,,,2,2,1,3
51686_0,,,,2,2,1,3
51688_0,,,,2,2,1,3
C(C(CCC(C(CO)=O)=O)O)(O)=O,,,5,1,1,0,1
51690_0,,,,2,2,1,3
C(C(CO)=O)(CCC(CO)O)=O,,,5,1,1,0,1
51692_0,,,,2,2,1,3
C(C(CO)CCC(C(CO)=O)=O)=O,,,5,1,1,0,1
51694_0,,,,2,2,1,3
C(CC(CCC(C(CO)=O)=O)O)=O,,,5,1,1,0,1
51696_0,,,,2,2,1,3
C(CO)(CCCC(C(CO)=O)=O)=O,,,5,1,1,0,1
51698_0,,,,2,2,1,3
C(C)(C(CCC(C(CO)=O)=O)O)=O,,,5,1,1,0,1
51699_0,,,,2,2,1,3
51701_0,,,,2,2,1,3
C(C(CO)=O)(CCCCO)=O,,,5,1,1,0,1
51702_0,,,,2,2,1,3
51703_0,,,,2,2,1,3
51705_0,,,,2,2,1,3
C(CCCC(C(CO)=O)=O)=CC=O,,,5,1,1,0,1
51707_0,,,,2,2,1,3
C(C(C=C)CCC(C(CO)=O)=O)=O,,,5,1,1,0,1
51709_0,,,,2,2,1,3
C(C(CCC(C(CO)=O)=O)O)=O,,,5,1,1,0,1
51711_0,,,,2,2,1,3
C(C(CCCC(C(CO)=O)=O)O)=O,,,5,1,1,0,1
51713_0,,,,2,2,1,3
C(C(C)(CCC(C(CO)=O)=O)O)=O,,,5,1,1,0,1
51715_0,,,,2,2,1,3
C(C(C(C(CO)=O)=O)CCO)(O)=O,,,5,1,1,0,1
51717_0,,,,2,2,1,3
C=CC(C(CCCC(C(C)=O)=O)=O)=O,,,5,1,1,0,1
51719_0,,,,2,2,1,3
C(CC(C)CC(C(C=C)=O)=O)(O)=O,,,5,1,1,0,1
51721_0,,,,2,2,1,3
C(C(C(O)=O)CCC(C(C=C)=O)=O)=O,,,5,1,1,0,1
51723_0,,,,2,2,1,3
C(C(CCC(C(C=C)=O)=O)C(C)O)=O,,,5,1,1,0,1
51725_0,,,,2,2,1,3
C(C(CO)C(C)CC(C(C=C)=O)=O)=O,,,5,1,1,0,1
51727_0,,,,2,2,1,3
C(C(C)C(C=O)CC(C(C=C)=O)=O)=O,,,5,1,1,0,1
51729_0,,,,2,2,1,3
C(C(C)(CC=O)CC(C(C=C)=O)=O)=O,,,5,1,1,0,1
51731_0,,,,2,2,1,3
C(C(CCC(C(C=C)=O)=O)CC=O)=O,,,5,1,1,0,1
51733_0,,,,2,2,1,3
C(C(CC(C)=O)CC(C(C=C)=O)=O)=O,,,5,1,1,0,1
51735_0,,,,2,2,1,3
C(CC(C(C)=O)CC(C(C=C)=O)=O)=O,,,5,1,1,0,1
51737_0,,,,2,2,1,3
C=CC(C(CCCC(C=O)=O)=O)=O,,,5,1,1,0,1
51739_0,,,,2,2,1,3
C=CC(C(CC(C)CC(C=O)=O)=O)=O,,,5,1,1,0,1
51741_0,,,,2,2,1,3
C(CCCC(C(C=C)=O)=O)=O,,,5,1,1,0,1
51743_0,,,,2,2,1,3
C=CC(C(CCCC(C(O)=O)=O)=O)=O,,,5,1,1,0,1
51745_0,,,,2,2,1,3
C(C(C=C)CCC(C(C=C)=O)=O)(O)=O,,,5,1,1,0,1
51746_0,,,,2,2,1,3
51747_0,,,,2,2,1,3
51748_0,,,,2,2,1,3
51750_0,,,,2,2,1,3
C(C(C)=O)(CCCC(C(C)=O)=O)=O,,,5,1,1,0,1
51752_0,,,,2,2,1,3
C(CCCC(C(C)=O)=O)(CCO)=O,,,5,1,1,0,1
51754_0,,,,2,2,1,3
C(C)(CC(CCC(C(C)=O)=O)O)=O,,,5,1,1,0,1
51756_0,,,,2,2,1,3
C(C)(C(CCC(C(C)=O)=O)CO)=O,,,5,1,1,0,1
51758_0,,,,2,2,1,3
C(C)(CCCCC(C(C)=O)=O)=O,,,5,1,1,0,1
51760_0,,,,2,2,1,3
C(C)(C(C)CCC(C(C)=O)=O)=O,,,5,1,1,0,1
51762_0,,,,2,2,1,3
C(CC)(CCCC(C(C)=O)=O)=O,,,5,1,1,0,1
51764_0,,,,2,2,1,3
C(C([CH]C(O)=O)CCC(C(C)=O)=O)=O,,,5,1,1,0,1
51766_0,,,,2,2,1,3
C(C[C](C(O)=O)CCC(C(C)=O)=O)=O,,,5,1,1,0,1
51768_0,,,,2,2,1,3
C(C(C)=O)(CCC(CO)CO)=O,,,5,1,1,0,1
51770_0,,,,2,2,1,3
C(C(C)=O)(CCC(CCO)O)=O,,,5,1,1,0,1
51772_0,,,,2,2,1,3
C(C(CCC(C(C)=O)=O)O)=CC,,,5,1,1,0,1
51774_0,,,,2,2,1,3
C(CCCC(C(C)=O)=O)=CCO,,,5,1,1,0,1
51776_0,,,,2,2,1,3
C(C(CCC(C(C)=O)=O)CO)=C,,,5,1,1,0,1
51778_0,,,,2,2,1,3
C(CC(CCC(C(C)=O)=O)O)=C,,,5,1,1,0,1
51780_0,,,,2,2,1,3
C(C(C)=O)(CCC(C(CO)O)O)=O,,,5,1,1,0,1
51782_0,,,,2,2,1,3
C(C(C)=O)(CCC(CO)(CO)O)=O,,,5,1,1,0,1
51784_0,,,,2,2,1,3
C(C(C)=O)(CCCC(CO)O)=O,,,5,1,1,0,1
51786_0,,,,2,2,1,3
C(C(C)=O)(CCC(C)(CO)O)=O,,,5,1,1,0,1
51788_0,,,,2,2,1,3
C(C(C)=O)(CCC(C(C)O)O)=O,,,5,1,1,0,1
51790_0,,,,2,2,1,3
C(CCCC(C(C)=O)=O)=CC(O)=O,,,5,1,1,0,1
51792_0,,,,2,2,1,3
C(C(C=C)CCC(C(C)=O)=O)(O)=O,,,5,1,2,0,2
51794_0,,,,2,2,1,3
C([C](CCC(C(C)=O)=O)O)(O)=O,,,5,1,1,0,1
51796_0,,,,2,2,1,3
C(C(C(C=O)=O)CCC(C(C)=O)=O)=O,,,5,1,1,0,1
51798_0,,,,2,2,1,3
C(C(C)O)(CCCC(C(C)=O)=O)=O,,,5,1,1,0,1
51800_0,,,,2,2,1,3
C(C)(C(CCCC(C(C)=O)=O)O)=O,,,5,1,1,0,1
51802_0,,,,2,2,1,3
C(C)(C(C)(CCC(C(C)=O)=O)O)=O,,,5,1,1,0,1
51804_0,,,,2,2,1,3
C(C(CCC(C(C)=O)=O)O)(CC)=O,,,5,1,1,0,1
51806_0,,,,2,2,1,3
C(CO)(CCCCC(C(C)=O)=O)=O,,,5,1,1,0,1
51808_0,,,,2,2,1,3
C(CO)(C(C)CCC(C(C)=O)=O)=O,,,5,1,1,0,1
51810_0,,,,2,2,1,3
C(C(C=O)CCC(C(C)=O)=O)=O,,,5,1,1,0,1
51812_0,,,,2,2,1,3
C=C(C=O)C(CCCC(C(C)=O)=O)O,,,5,1,1,0,1
51814_0,,,,2,2,1,3
C=C(C=O)C(C)(CCC(C(C)=O)=O)O,,,5,1,1,0,1
51816_0,,,,2,2,1,3
C(C)=C(C=O)C(CCC(C(C)=O)=O)O,,,5,1,1,0,1
51818_0,,,,2,2,1,3
C(CCCC(C(C)=O)=O)=C(C=O)CO,,,5,1,1,0,1
51820_0,,,,2,2,1,3
C(C(C)=O)(CCCC(C=O)=CC=O)=O,,,5,1,1,0,1
51822_0,,,,2,2,1,3
C(C(C(C=O)=C)CCC(C(C)=O)=O)=O,,,5,1,1,0,1
51824_0,,,,2,2,1,3
C(C(C)=O)(CCCC(C=CC=O)=O)=O,,,5,1,1,0,1
51826_0,,,,2,2,1,3
C=CC(C(C=O)=O)CCC(C(C)=O)=O,,,5,1,1,0,1
51828_0,,,,2,2,1,3
C(CCCC(C(C)=O)=O)=CC(C=O)=O,,,5,1,1,0,1
51830_0,,,,2,2,1,3
C(C(CCCC(C(C)=O)=O)O)=C,,,5,1,1,0,1
51832_0,,,,2,2,1,3
C(C(C)(CCC(C(C)=O)=O)O)=C,,,5,1,1,0,1
51834_0,,,,2,2,1,3
C(C(CO)(CCC(C(C)=O)=O)O)=C,,,5,1,1,0,1
51836_0,,,,2,2,1,3
C(C(C(CCC(C(C)=O)=O)O)O)=C,,,5,1,1,0,1
51838_0,,,,2,2,1,3
C(C(CCC(C(C)=O)=O)(CC)O)=O,,,5,1,1,0,1
51840_0,,,,2,2,1,3
C(C(CCCCC(C(C)=O)=O)O)=O,,,5,1,1,0,1
51842_0,,,,2,2,1,3
C(C(C(CCC(C(C)=O)=O)C)O)=O,,,5,1,1,0,1
51844_0,,,,2,2,1,3
C(C(CCC(C(C)=O)=O)CCO)=O,,,5,1,1,0,1
51846_0,,,,2,2,1,3
C(CCC(CCC(C(C)=O)=O)O)=O,,,5,1,1,0,1
51848_0,,,,2,2,1,3
C(CC(CCC(C(C)=O)=O)CO)=O,,,5,1,1,0,1
51850_0,,,,2,2,1,3
C1(C(OCC1CCC(C(C)=O)=O)=O)=O,,,5,1,1,0,1
51852_0,,,,2,2,1,3
C(C(C)=O)(CCC1CC(C(O1)=O)=O)=O,,,5,1,1,0,1
51854_0,,,,2,2,1,3
C([CH]CCC(C(C)=O)=O)(O)=O,,,5,1,2,0,2
51856_0,,,,2,2,1,3
C(C(CCC(C(C)=O)=O)(O)O)=O,,,5,1,1,0,1
51858_0,,,,2,2,1,3
C(CCCC(C(C)=O)=O)=O,,,5,1,2,0,2
51860_0,,,,2,2,1,3
[C](C(O)=O)(CCCC(C(C)=O)=O)O,,,5,1,1,0,1
51862_0,,,,2,2,1,3
C(C(CCCC(C(C)=O)=O)O)(O)=O,,,5,1,1,0,1
51864_0,,,,2,2,1,3
C(C(C)(CCC(C(C)=O)=O)O)(O)=O,,,5,1,1,0,1
51866_0,,,,2,2,1,3
C(C(CCC(C(C)=O)=O)C(C)O)=O,,,5,1,2,0,2
51868_0,,,,2,2,1,3
C(CC(CCCC(C(C)=O)=O)O)=O,,,5,1,1,0,1
51870_0,,,,2,2,1,3
C(CC(C)(CCC(C(C)=O)=O)O)=O,,,5,1,1,0,1
51872_0,,,,2,2,1,3
C(C(C(O)=O)CCC(C(C)=O)=O)=O,,,5,1,2,0,2
51874_0,,,,2,2,1,3
C(C(C)=O)(CCC(C(C=O)=O)O)=O,,,5,1,1,0,1
51876_0,,,,2,2,1,3
C(C=O)(CCCC(C(C)=O)=O)=O,,,5,1,2,0,2
51878_0,,,,2,2,1,3
C(C(CCC(C(C)=O)=O)O)(O)=O,,,5,1,2,0,2
51880_0,,,,2,2,1,3
C(C(C)=O)(CCC(CO)O)=O,,,5,1,1,0,1
51882_0,,,,2,2,1,3
C(C(CCC(C(C)=O)=O)CO)=O,,,5,1,1,0,1
51884_0,,,,2,2,1,3
C(CC(CCC(C(C)=O)=O)O)=O,,,5,1,1,0,1
51886_0,,,,2,2,1,3
C(C(C=O)(CCC(C(C)=O)=O)O)=O,,,5,1,1,0,1
51888_0,,,,2,2,1,3
C(C(C)=O)(CCC(CO)C(C)O)=O,,,5,1,1,0,1
51890_0,,,,2,2,1,3
C(C(C)=O)(CCC(CC(C)O)O)=O,,,5,1,1,0,1
51892_0,,,,2,2,1,3
C(C(C)=O)(CCCC(CCO)O)=O,,,5,1,1,0,1
51894_0,,,,2,2,1,3
C(C(C)=O)(CCC(C)(CCO)O)=O,,,5,1,1,0,1
51896_0,,,,2,2,1,3
C(C(CCC(C(C)=O)=O)CO)(O)=O,,,5,1,2,0,2
51898_0,,,,2,2,1,3
C(CC(CCC(C(C)=O)=O)O)(O)=O,,,5,1,1,0,1
51900_0,,,,2,2,1,3
C(CO)(C(CCC(C(C)=O)=O)O)=O,,,5,1,1,0,1
51902_0,,,,2,2,1,3
C(CO)(CCCC(C(C)=O)=O)=O,,,5,1,1,0,1
51903_0,,,,2,2,1,3
51904_0,,,,2,2,1,3
51906_0,,,,2,2,1,3
C(C(C)=O)(CCCCO)=O,,,5,1,1,0,1
51907_0,,,,2,2,1,3
51909_0,,,,2,2,1,3
C(CCCC(C(C)=O)=O)(O)=O,,,5,1,2,0,2
51911_0,,,,2,2,1,3
C(CCCC(C(C)=O)=O)=CC=O,,,5,1,1,0,1
51913_0,,,,2,2,1,3
C(C(C=C)CCC(C(C)=O)=O)=O,,,5,1,1,0,1
51915_0,,,,2,2,1,3
C(C(C(CCC(C(C)=O)=O)O)O)=O,,,5,1,1,0,1
51917_0,,,,2,2,1,3
C(C(CO)(CCC(C(C)=O)=O)O)=O,,,5,1,1,0,1
51919_0,,,,2,2,1,3
[CH](C(O)=O)C(CCC(C(C)=O)=O)O,,,5,1,1,0,1
51921_0,,,,2,2,1,3
C([C](CO)CCC(C(C)=O)=O)(O)=O,,,5,1,1,0,1
51923_0,,,,2,2,1,3
C(C(CCC(C(C)=O)=O)O)=O,,,5,1,1,0,1
51925_0,,,,2,2,1,3
C(C(CCCC(C(C)=O)=O)O)=O,,,5,1,1,0,1
51926_0,,,,2,2,1,3
51928_0,,,,2,2,1,3
C(C(C)=O)(CCCC(C(O)=O)=O)=O,,,5,1,2,0,2
51930_0,,,,2,2,1,3
C(CCCC(C(C(C(O)=O)=C)=O)=O)=O,,,5,1,1,0,1
51931_0,,,,2,2,1,3
51932_0,,,,2,2,1,3
51934_0,,,,2,2,1,3
C(C(C(C(C)=O)=O)CCCO)(O)=O,,,5,1,1,0,1
51936_0,,,,2,2,1,3
C(C(C(C(C)=O)=O)CC(C)O)(O)=O,,,5,1,1,0,1
51938_0,,,,2,2,1,3
C(C(CCO)C(C(C=O)=O)O)(O)=O,,,5,1,1,0,1
51940_0,,,,2,2,1,3
[C](C(O)=O)=CC(C(CCCC=O)=O)=O,,,5,1,1,0,1
51942_0,,,,2,2,1,3
C(CC([CH]C(O)=O)C(C(C)=O)=O)=O,,,5,1,1,0,1
51943_0,,,,2,2,1,3
51945_0,,,,2,2,1,3
[CH](C(O)=O)C(C(C(C)=O)=O)CCO,,,5,1,1,0,1
51946_0,,,,2,2,1,3
51948_0,,,,2,2,1,3
C(C[C](C(O)=O)CC(C(C)=O)=O)=O,,,5,1,1,0,1
51950_0,,,,2,2,1,3
C([C](CO)CC(C(C)=O)=O)(O)=O,,,5,1,1,0,1
51952_0,,,,2,2,1,3
[C](C(O)=O)(CCO)CC(C(C)=O)=O,,,5,1,1,0,1
51954_0,,,,2,2,1,3
[C](C(O)=O)(C(C)O)CC(C(C)=O)=O,,,5,1,1,0,1
51956_0,,,,2,2,1,3
C(CCCC(C(C=CC(O)=O)=O)=O)=O,,,5,1,1,0,1
51958_0,,,,2,2,1,3
C(CC(C(C(C)=O)=O)CC(O)=O)=O,,,5,1,1,0,1
51959_0,,,,2,2,1,3
51961_0,,,,2,2,1,3
C(CC(C(C(C)=O)=O)CCO)(O)=O,,,5,1,1,0,1
51962_0,,,,2,2,1,3
51964_0,,,,2,2,1,3
C(CC(C(O)=O)CC(C(C)=O)=O)=O,,,5,1,1,0,1
51965_0,,,,2,2,1,3
51967_0,,,,2,2,1,3
C(C(CCO)CC(C(C)=O)=O)(O)=O,,,5,1,1,0,1
51969_0,,,,2,2,1,3
C(C(C(C)O)CC(C(C)=O)=O)(O)=O,,,5,1,1,0,1
51971_0,,,,2,2,1,3
C(CCCC(C(O)=O)=CC(C=O)=O)=O,,,5,1,1,0,1
51973_0,,,,2,2,1,3
C(CC(C(C=O)=O)C(C(O)=O)C)=O,,,5,1,1,0,1
51974_0,,,,2,2,1,3
51976_0,,,,2,2,1,3
C(C(C)C(C(C=O)=O)CCO)(O)=O,,,5,1,1,0,1
51978_0,,,,2,2,1,3
C(C(C)C(C(C=O)=O)C(C)O)(O)=O,,,5,1,1,0,1
51979_0,,,,2,2,1,3
51981_0,,,,2,2,1,3
C(C(C)(CO)CC(C=O)=O)(O)=O,,,5,1,1,0,1
51982_0,,,,2,2,1,3
51984_0,,,,2,2,1,3
C(C(C)(C(C)O)CC(C=O)=O)(O)=O,,,5,1,1,0,1
51986_0,,,,2,2,1,3
C(CCC(C(C=O)=O)C(C(O)=O)=C)=O,,,5,1,1,0,1
51988_0,,,,2,2,1,3
C(CCC(C(O)=O)CC(C=O)=O)=O,,,5,1,2,0,2
51989_0,,,,2,2,1,3
51991_0,,,,2,2,1,3
C(C(CCCO)CC(C=O)=O)(O)=O,,,5,1,1,0,1
51993_0,,,,2,2,1,3
C(C(CC(C)O)CC(C=O)=O)(O)=O,,,5,1,1,0,1
51995_0,,,,2,2,1,3
C(CCCC(C(C(CO)O)=O)=O)=O,,,5,1,1,0,1
51997_0,,,,2,2,1,3
C(CCC(C(C(C)=O)=O)(CO)O)=O,,,5,1,1,0,1
51999_0,,,,2,2,1,3
C(CCC(C(C(C(C)=O)=O)O)O)=O,,,5,1,1,0,1
52001_0,,,,2,2,1,3
C(CCC([CH]C(O)=O)C(C=O)=O)=O,,,5,1,1,0,1
52003_0,,,,2,2,1,3
C(CC(C)C([CH]C(O)=O)C(C=O)=O)=O,,,5,1,1,0,1
52005_0,,,,2,2,1,3
C(CC[C](C(O)=O)CC(C=O)=O)=O,,,5,1,1,0,1
52007_0,,,,2,2,1,3
C(CC([C](C(O)=O)CC(C=O)=O)C)=O,,,5,1,1,0,1
52009_0,,,,2,2,1,3
C(CCC(C(C=O)=O)CC(O)=O)=O,,,5,1,1,0,1
52010_0,,,,2,2,1,3
52012_0,,,,2,2,1,3
C(CCCC(C(C[CH]C(O)=O)=O)=O)=O,,,5,1,1,0,1
52014_0,,,,2,2,1,3
C(CCC([CH]C(O)=O)C(C(C)=O)=O)=O,,,5,1,1,0,1
52016_0,,,,2,2,1,3
C(CC[C](C(O)=O)CC(C(C)=O)=O)=O,,,5,1,1,0,1
52018_0,,,,2,2,1,3
C(CCC(C(C)O)C(C=O)O)=O,,,5,1,1,0,1
52020_0,,,,2,2,1,3
C(C(C(C(C)O)C[CH]C(O)=O)O)=O,,,5,1,2,0,2
52022_0,,,,2,2,1,3
C(CCC(C(C)O)C(C=O)O)(O)=O,,,5,1,2,0,2
52024_0,,,,2,2,1,3
C(CC(C)C(C(C)O)C(C=O)O)=O,,,5,1,2,0,2
52026_0,,,,2,2,1,3
C(C(CCC=O)(CC(C)O)O)=O,,,5,1,1,0,1
52028_0,,,,2,2,1,3
C(C(CC(C)O)(C[CH]C(O)=O)O)=O,,,5,1,1,0,1
52030_0,,,,2,2,1,3
C(C(CCC(O)=O)(CC(C)O)O)=O,,,5,1,1,0,1
52032_0,,,,2,2,1,3
C(C(CC(C)O)(C(C)CC=O)O)=O,,,5,1,1,0,1
52034_0,,,,2,2,1,3
C(CCCC(CC(C=O)O)O)=O,,,5,1,1,0,1
52035_0,,,,2,2,1,3
52036_0,,,,2,2,1,3
52038_0,,,,2,2,1,3
C(CC(C)CC(CC(C=O)O)O)=O,,,5,1,2,0,2
52040_0,,,,2,2,1,3
C(CCC(C)(CC(C=O)O)O)=O,,,5,1,1,0,1
52042_0,,,,2,2,1,3
C(C(CC(C)(C[CH]C(O)=O)O)O)=O,,,5,1,2,0,2
52044_0,,,,2,2,1,3
C(CCC(C)(CC(C=O)O)O)(O)=O,,,5,1,2,0,2
52046_0,,,,2,2,1,3
C(CC(C)C(C)(CC(C=O)O)O)=O,,,5,1,2,0,2
52048_0,,,,2,2,1,3
C(C(CCC=O)C(C=O)O)(O)=O,,,5,1,1,0,1
52049_0,,,,2,2,1,3
52050_0,,,,2,2,1,3
52052_0,,,,2,2,1,3
C(C(C(C)CC=O)C(C=O)O)(O)=O,,,5,1,2,0,2
52054_0,,,,2,2,1,3
C(CCC(C=O)(CC(O)=O)O)=O,,,5,1,1,0,1
52056_0,,,,2,2,1,3
C(CC(C=O)(C[CH]C(O)=O)O)(O)=O,,,5,1,1,0,1
52058_0,,,,2,2,1,3
C(CCC(C=O)(CC(O)=O)O)(O)=O,,,5,1,1,0,1
52060_0,,,,2,2,1,3
C(CC(C)C(C=O)(CC(O)=O)O)=O,,,5,1,1,0,1
52062_0,,,,2,2,1,3
C(CCC(C(C(C=O)O)=O)O)=O,,,5,1,1,0,1
52063_0,,,,2,2,1,3
52064_0,,,,2,2,1,3
52065_0,,,,2,2,1,3
52067_0,,,,2,2,1,3
C(CCC(C=O)(C(CO)=O)O)=O,,,5,1,1,0,1
52069_0,,,,2,2,1,3
C(C(C(CO)=O)(C[CH]C(O)=O)O)=O,,,5,1,1,0,1
52071_0,,,,2,2,1,3
C(CCC(C=O)(C(CO)=O)O)(O)=O,,,5,1,1,0,1
52073_0,,,,2,2,1,3
C(CC(C)C(C=O)(C(CO)=O)O)=O,,,5,1,1,0,1
52075_0,,,,2,2,1,3
C(C(C=O)(C(CCC=O)O)O)=O,,,5,1,1,0,1
52076_0,,,,2,2,1,3
52077_0,,,,2,2,1,3
52079_0,,,,2,2,1,3
C(C(C=O)(C(C(C)CC=O)O)O)=O,,,5,1,1,0,1
52081_0,,,,2,2,1,3
C(C(C=O)(CC(C)CC(O)=O)O)=O,,,5,1,1,0,1
52083_0,,,,2,2,1,3
C(C(C=O)(CCCC(C=O)=O)O)=O,,,5,1,1,0,1
52085_0,,,,2,2,1,3
C(C(C=O)(CCCC=O)O)=O,,,5,1,1,0,1
52087_0,,,,2,2,1,3
C(C(C=O)(CC[CH]C(O)=O)O)=O,,,5,1,1,0,1
52089_0,,,,2,2,1,3
C(C(C=O)(CCCC(O)=O)O)=O,,,5,1,1,0,1
52091_0,,,,2,2,1,3
C(C(C=O)(CC(C)CC=O)O)=O,,,5,1,1,0,1
52093_0,,,,2,2,1,3
C(C(C(CC(C)CC(O)=O)=O)O)=O,,,5,1,1,0,1
52095_0,,,,2,2,1,3
C(C(C(CCCC(C=O)=O)=O)O)=O,,,5,1,1,0,1
52097_0,,,,2,2,1,3
C(C(C(CCCC=O)=O)O)=O,,,5,1,1,0,1
52099_0,,,,2,2,1,3
C(C(C(CC[CH]C(O)=O)=O)O)=O,,,5,1,1,0,1
52101_0,,,,2,2,1,3
C(C(C(CCCC(O)=O)=O)O)=O,,,5,1,1,0,1
52103_0,,,,2,2,1,3
C(C(C(CC(C)CC=O)=O)O)=O,,,5,1,1,0,1
52105_0,,,,2,2,1,3
C(CC(C)C(C=O)(C(C)=O)O)(O)=O,,,5,1,1,0,1
52107_0,,,,2,2,1,3
C(C(C(C)=O)(CCC(C=O)=O)O)=O,,,5,1,1,0,1
52109_0,,,,2,2,1,3
C(CCC(C=O)(C(C)=O)O)=O,,,5,1,1,0,1
52111_0,,,,2,2,1,3
C(C(C(C)=O)(C[CH]C(O)=O)O)=O,,,5,1,1,0,1
52113_0,,,,2,2,1,3
C(CCC(C=O)(C(C)=O)O)(O)=O,,,5,1,1,0,1
52115_0,,,,2,2,1,3
C(CC(C)C(C=O)(C(C)=O)O)=O,,,5,1,1,0,1
52117_0,,,,2,2,1,3
C(C(C=O)(C(CCC=O)O)O)(O)=O,,,5,1,1,0,1
52119_0,,,,2,2,1,3
C(CC(C)CC(C(C)=O)=O)(O)=O,,,5,1,1,0,1
52120_0,,,,2,2,1,3
52121_0,,,,2,2,1,3
52123_0,,,,2,2,1,3
C(C(CO)C(C)CC(C(C)=O)=O)=O,,,5,1,1,0,1
52125_0,,,,2,2,1,3
C(C(C)C(C=O)CC(C(C)=O)=O)=O,,,5,1,1,0,1
52127_0,,,,2,2,1,3
C(C(C)(CC=O)CC(C(C)=O)=O)=O,,,5,1,1,0,1
52129_0,,,,2,2,1,3
C(C(CCC(C(C)=O)=O)CC=O)=O,,,5,1,1,0,1
52131_0,,,,2,2,1,3
C(C(CC(C)=O)CC(C(C)=O)=O)=O,,,5,1,1,0,1
52133_0,,,,2,2,1,3
C(CC(C(C)=O)CC(C(C)=O)=O)=O,,,5,1,1,0,1
52134_0,,,,2,2,1,3
52136_0,,,,2,2,1,3
C(C=O)(CC(C)CC(C(C)=O)=O)=O,,,5,1,1,0,1
52137_0,,,,2,2,1,3
52138_0,,,,2,2,1,3
52139_0,,,,2,2,1,3
52140_0,,,,2,2,1,3
52141_0,,,,2,2,1,3
52142_0,,,,2,2,1,3
52144_0,,,,2,2,1,3
C(CC(C)CC(C(C)=O)=O)=O,,,5,1,1,0,1
52146_0,,,,2,2,1,3
C(CC(C)CC(O)=O)(CC(O)=O)=O,,,5,1,1,0,1
52148_0,,,,2,2,1,3
C(CCCC(C=O)=O)(CC(O)=O)=O,,,5,1,1,0,1
52150_0,,,,2,2,1,3
C(CCCC(CC(O)=O)=O)=O,,,5,1,1,0,1
52151_0,,,,2,2,1,3
52152_0,,,,2,2,1,3
52153_0,,,,2,2,1,3
52155_0,,,,2,2,1,3
C(C)(C(C(O)=O)C(C)CC(O)=O)=O,,,5,1,1,0,1
52157_0,,,,2,2,1,3
C(C)(C(C(O)=O)CCC(C=O)=O)=O,,,5,1,2,0,2
52159_0,,,,2,2,1,3
C(CCC(C(C)=O)C(O)=O)=O,,,5,1,2,0,2
52160_0,,,,2,2,1,3
52161_0,,,,2,2,1,3
52162_0,,,,2,2,1,3
52164_0,,,,2,2,1,3
C(CC(C)CC(CCO)=O)(O)=O,,,5,1,1,0,1
52166_0,,,,2,2,1,3
C(C(C=O)CCC(CCO)=O)(O)=O,,,5,1,1,0,1
52168_0,,,,2,2,1,3
C(C(CCC(CCO)=O)C(C)O)=O,,,5,1,1,0,1
52170_0,,,,2,2,1,3
C(C(CO)C(C)CC(CCO)=O)=O,,,5,1,1,0,1
52172_0,,,,2,2,1,3
C(CC(C=O)C(C=O)C)(CCO)=O,,,5,1,1,0,1
52174_0,,,,2,2,1,3
C(C(C)(CC(CCO)=O)CC=O)=O,,,5,1,1,0,1
52176_0,,,,2,2,1,3
C(CCC(C=O)CC=O)(CCO)=O,,,5,1,1,0,1
52178_0,,,,2,2,1,3
C(CC(C=O)CC(CCO)=O)(C)=O,,,5,1,1,0,1
52180_0,,,,2,2,1,3
C(CC(C(C)=O)CC=O)(CCO)=O,,,5,1,1,0,1
52182_0,,,,2,2,1,3
C(CCCC(C=O)=O)(CCO)=O,,,5,1,1,0,1
52184_0,,,,2,2,1,3
C(CC(C)CC(C=O)=O)(CCO)=O,,,5,1,1,0,1
52186_0,,,,2,2,1,3
C(CCCC(CCO)=O)=O,,,5,1,1,0,1
52188_0,,,,2,2,1,3
C(CCCC(C(O)=O)=O)(CCO)=O,,,5,1,1,0,1
52190_0,,,,2,2,1,3
C(C(CCC(CCO)=O)CO)(O)=O,,,5,1,1,0,1
52192_0,,,,2,2,1,3
C(C(C=C)CCC(CCO)=O)(O)=O,,,5,1,1,0,1
52193_0,,,,2,2,1,3
52194_0,,,,2,2,1,3
52195_0,,,,2,2,1,3
52197_0,,,,2,2,1,3
C(CC(C)C(CC(C)=O)O)(O)=O,,,5,1,1,0,1
52199_0,,,,2,2,1,3
C(C(C=O)CC(CC(C)=O)O)(O)=O,,,5,1,1,0,1
52201_0,,,,2,2,1,3
C(C(CC(CC(C)=O)O)C(C)O)=O,,,5,1,1,0,1
52203_0,,,,2,2,1,3
C(C(CO)C(C)C(CC(C)=O)O)=O,,,5,1,1,0,1
52205_0,,,,2,2,1,3
C(C(C)C(C=O)C(CC(C)=O)O)=O,,,5,1,1,0,1
52207_0,,,,2,2,1,3
C(C)(CC(C(C=O)(C)CC=O)O)=O,,,5,1,1,0,1
52209_0,,,,2,2,1,3
C(C)(CC(CC(C=O)CC=O)O)=O,,,5,1,1,0,1
52211_0,,,,2,2,1,3
C(C)(CC(C(C=O)CC(C)=O)O)=O,,,5,1,1,0,1
52213_0,,,,2,2,1,3
C(C)(CC(C(C(C)=O)CC=O)O)=O,,,5,1,1,0,1
52215_0,,,,2,2,1,3
C(C)(CC(CCC(C=O)=O)O)=O,,,5,1,1,0,1
52217_0,,,,2,2,1,3
C(C)(CC(C(C)CC(C=O)=O)O)=O,,,5,1,1,0,1
52219_0,,,,2,2,1,3
C(CCC(CC(C)=O)O)=O,,,5,1,1,0,1
52221_0,,,,2,2,1,3
C(C)(CC(CCC(C(O)=O)=O)O)=O,,,5,1,1,0,1
52223_0,,,,2,2,1,3
C(C(CO)CC(CC(C)=O)O)(O)=O,,,5,1,1,0,1
52225_0,,,,2,2,1,3
C(C(C=C)CC(CC(C)=O)O)(O)=O,,,5,1,1,0,1
52226_0,,,,2,2,1,3
52227_0,,,,2,2,1,3
52228_0,,,,2,2,1,3
52230_0,,,,2,2,1,3
C(CC(C)C(C(C)=O)CO)(O)=O,,,5,1,1,0,1
52232_0,,,,2,2,1,3
C(C(C=O)CC(C(C)=O)CO)(O)=O,,,5,1,1,0,1
52234_0,,,,2,2,1,3
C(C(CC(C(C)=O)CO)C(C)O)=O,,,5,1,1,0,1
52236_0,,,,2,2,1,3
C(C(CO)C(C)C(C(C)=O)CO)=O,,,5,1,1,0,1
52238_0,,,,2,2,1,3
C(C)(C(CO)C(C=O)C(C=O)C)=O,,,5,1,1,0,1
52240_0,,,,2,2,1,3
C(C)(C(CO)C(C=O)(C)CC=O)=O,,,5,1,1,0,1
52242_0,,,,2,2,1,3
C(C)(C(CC(C=O)CC=O)CO)=O,,,5,1,1,0,1
52244_0,,,,2,2,1,3
C(CC(C=O)C(C(C)=O)CO)(C)=O,,,5,1,1,0,1
52246_0,,,,2,2,1,3
C(C)(C(CO)C(C(C)=O)CC=O)=O,,,5,1,1,0,1
52248_0,,,,2,2,1,3
C(C)(C(CCC(C=O)=O)CO)=O,,,5,1,1,0,1
52250_0,,,,2,2,1,3
C(C)(C(CO)C(C)CC(C=O)=O)=O,,,5,1,1,0,1
52252_0,,,,2,2,1,3
C(CCC(C(C)=O)CO)=O,,,5,1,1,0,1
52254_0,,,,2,2,1,3
C(C)(C(CCC(C(O)=O)=O)CO)=O,,,5,1,1,0,1
52256_0,,,,2,2,1,3
C(C(CC(C(C)=O)CO)CO)(O)=O,,,5,1,1,0,1
52258_0,,,,2,2,1,3
C(C(C=C)CC(C(C)=O)CO)(O)=O,,,5,1,1,0,1
52259_0,,,,2,2,1,3
52260_0,,,,2,2,1,3
52261_0,,,,2,2,1,3
52263_0,,,,2,2,1,3
C(C(CCCC(C)=O)CCO)(O)=O,,,5,1,1,0,1
52265_0,,,,2,2,1,3
C(C(C)C(CCC(C)=O)CO)(O)=O,,,5,1,1,0,1
52267_0,,,,2,2,1,3
C(C)(CCC(C)CC(O)=O)=O,,,5,1,1,0,1
52269_0,,,,2,2,1,3
C(C(C(O)=O)CCCC(C)=O)=O,,,5,1,1,0,1
52271_0,,,,2,2,1,3
C(CC(CCC(C)=O)CC(C)O)=O,,,5,1,1,0,1
52273_0,,,,2,2,1,3
C(C(CCCC(C)=O)C(C)O)=O,,,5,1,1,0,1
52275_0,,,,2,2,1,3
C(C(CO)C(C)CCC(C)=O)=O,,,5,1,1,0,1
52277_0,,,,2,2,1,3
C(C(C(C)O)C(C)CCC(C)=O)=O,,,5,1,1,0,1
52279_0,,,,2,2,1,3
C(C(C(O)=O)C(C)CCC(C)=O)=O,,,5,1,1,0,1
52281_0,,,,2,2,1,3
C(CC(CCC(C)=O)CC(O)=O)=O,,,5,1,2,0,2
52282_0,,,,2,2,1,3
52284_0,,,,2,2,1,3
C(C)(CCC(C=O)CC(CO)=O)=O,,,5,1,1,0,1
52286_0,,,,2,2,1,3
C(C)(CCC(C(CO)=O)CC=O)=O,,,5,1,1,0,1
52288_0,,,,2,2,1,3
C(C(CCC(C)=O)C(C=O)CO)=O,,,5,1,1,0,1
52290_0,,,,2,2,1,3
C(C)(CCC(C=O)(CO)CC=O)=O,,,5,1,1,0,1
52292_0,,,,2,2,1,3
C(C(C)C(C(C=O)=O)CCC(C)=O)=O,,,5,1,1,0,1
52294_0,,,,2,2,1,3
C(C)(CCC(C=O)(C)CC(C=O)=O)=O,,,5,1,1,0,1
52296_0,,,,2,2,1,3
C(C)(CCCC(C=O)CC(C=O)=O)=O,,,5,1,1,0,1
52298_0,,,,2,2,1,3
C(C(CCC(C)=O)C(C=O)C)=O,,,5,1,1,0,1
52300_0,,,,2,2,1,3
C(C)(CCC(C=O)(C)CC=O)=O,,,5,1,1,0,1
52302_0,,,,2,2,1,3
C(C)(CCCC(C=O)CC=O)=O,,,5,1,1,0,1
52304_0,,,,2,2,1,3
C(C)(CCC(C(C=O)=O)CC(C)=O)=O,,,5,1,1,0,1
52306_0,,,,2,2,1,3
C(C)(CCC(C(C)=O)CC(C=O)=O)=O,,,5,1,1,0,1
52308_0,,,,2,2,1,3
C(C)(CCC(C=O)CC(C)=O)=O,,,5,1,1,0,1
52310_0,,,,2,2,1,3
C(C)(CCC(C(C)=O)CC=O)=O,,,5,1,1,0,1
52312_0,,,,2,2,1,3
C(C)(CCCCC(C=O)=O)=O,,,5,1,1,0,1
52314_0,,,,2,2,1,3
C(C)(CCC(C)CC(C=O)=O)=O,,,5,1,1,0,1
52316_0,,,,2,2,1,3
C(CCCCC(C)=O)=O,,,5,1,1,0,1
52318_0,,,,2,2,1,3
C(C)(CCCCC(C(O)=O)=O)=O,,,5,1,1,0,1
52320_0,,,,2,2,1,3
C(C(CO)CCCC(C)=O)(O)=O,,,5,1,1,0,1
52322_0,,,,2,2,1,3
C(C)(CCCC(C(C)=O)C(O)=O)=O,,,5,1,1,0,1
52324_0,,,,2,2,1,3
C(C)(CCCC(C(O)=O)C=C)=O,,,5,1,1,0,1
52326_0,,,,2,2,1,3
C1(C(CCCC(C)=O)CC(O)O1)=O,,,5,1,1,0,1
52328_0,,,,2,2,1,3
C1(C(C)C(CCC(C)=O)C(O)O1)=O,,,5,1,1,0,1
52330_0,,,,2,2,1,3
C(C)(CCC([CH]C(O)=O)C(C)O)=O,,,5,1,1,0,1
52332_0,,,,2,2,1,3
C(C)(CCC(C(O)=O)[CH]C(O)=O)=O,,,5,1,1,0,1
52334_0,,,,2,2,1,3
C(C[C](C(O)=O)CCC(C)=O)(O)=O,,,5,1,1,0,1
52336_0,,,,2,2,1,3
C(CC(CCC(C)=O)C(C)O)(O)=O,,,5,1,1,0,1
52338_0,,,,2,2,1,3
C(C)(CCC(C(O)=O)CC(O)=O)=O,,,5,1,1,0,1
52339_0,,,,2,2,1,3
52340_0,,,,2,2,1,3
52341_0,,,,2,2,1,3
52343_0,,,,2,2,1,3
C(C)(CCC(C)CC(C(O)=O)=O)=O,,,5,1,1,0,1
52345_0,,,,2,2,1,3
C(C)(CCCC(C(O)=O)CC=O)=O,,,5,1,1,0,1
52347_0,,,,2,2,1,3
C(C)(CCC(C(O)=O)(C)CC=O)=O,,,5,1,1,0,1
52349_0,,,,2,2,1,3
C(C(CCC(C)=O)C(C(O)=O)C)=O,,,5,1,1,0,1
52351_0,,,,2,2,1,3
C(C(CCCC(C)=O)C(C)O)(O)=O,,,5,1,1,0,1
52353_0,,,,2,2,1,3
C(C)(CCCC(C(O)=O)C(O)=O)=O,,,5,1,1,0,1
52355_0,,,,2,2,1,3
C(C(CC(C(C)=O)C)CCO)(O)=O,,,5,1,1,0,1
52357_0,,,,2,2,1,3
C(C(C)C(CO)C(C(C)=O)C)(O)=O,,,5,1,1,0,1
52359_0,,,,2,2,1,3
C(C)(C(C)C(C)CC(O)=O)=O,,,5,1,1,0,1
52361_0,,,,2,2,1,3
C(C(C(O)=O)CC(C(C)=O)C)=O,,,5,1,1,0,1
52363_0,,,,2,2,1,3
C(CC(CC(C)O)C(C(C)=O)C)=O,,,5,1,1,0,1
52365_0,,,,2,2,1,3
C(C(CC(C(C)=O)C)C(C)O)=O,,,5,1,1,0,1
52367_0,,,,2,2,1,3
C(C(CO)C(C)C(C(C)=O)C)=O,,,5,1,1,0,1
52369_0,,,,2,2,1,3
C(C(C(C)C(C(C)=O)C)C(C)O)=O,,,5,1,1,0,1
52371_0,,,,2,2,1,3
C(C(C(O)=O)C(C)C(C(C)=O)C)=O,,,5,1,1,0,1
52373_0,,,,2,2,1,3
C(CC(CC(O)=O)C(C(C)=O)C)=O,,,5,1,2,0,2
52374_0,,,,2,2,1,3
52376_0,,,,2,2,1,3
C(CC(C=O)C(C(C)=O)C)(CO)=O,,,5,1,1,0,1
52378_0,,,,2,2,1,3
C(C)(C(C)C(C(CO)=O)CC=O)=O,,,5,1,1,0,1
52380_0,,,,2,2,1,3
C(C)(C(C)C(C=O)C(C=O)CO)=O,,,5,1,1,0,1
52382_0,,,,2,2,1,3
C(C)(C(C)C(C=O)(CO)CC=O)=O,,,5,1,1,0,1
52384_0,,,,2,2,1,3
C(C)(C(C)C(C(C=O)=O)C(C=O)C)=O,,,5,1,1,0,1
52386_0,,,,2,2,1,3
C(C)(C(C)C(C=O)(C)CC(C=O)=O)=O,,,5,1,1,0,1
52388_0,,,,2,2,1,3
C(C)(C(C)CC(C=O)CC(C=O)=O)=O,,,5,1,1,0,1
52390_0,,,,2,2,1,3
C(C)(C(C)C(C=O)C(C=O)C)=O,,,5,1,1,0,1
52392_0,,,,2,2,1,3
C(C)(C(C)C(C=O)(C)CC=O)=O,,,5,1,1,0,1
52394_0,,,,2,2,1,3
C(C)(C(C)CC(C=O)CC=O)=O,,,5,1,1,0,1
52396_0,,,,2,2,1,3
C(CC(C(C=O)=O)C(C(C)=O)C)(C)=O,,,5,1,1,0,1
52398_0,,,,2,2,1,3
C(C)(C(C)C(C(C)=O)CC(C=O)=O)=O,,,5,1,1,0,1
52400_0,,,,2,2,1,3
C(CC(C=O)C(C(C)=O)C)(C)=O,,,5,1,1,0,1
52402_0,,,,2,2,1,3
C(C)(C(C)C(C(C)=O)CC=O)=O,,,5,1,1,0,1
52404_0,,,,2,2,1,3
C(C)(C(C)CCC(C=O)=O)=O,,,5,1,1,0,1
52406_0,,,,2,2,1,3
C(C)(C(C)C(C)CC(C=O)=O)=O,,,5,1,1,0,1
52408_0,,,,2,2,1,3
C(CCC(C(C)=O)C)=O,,,5,1,1,0,1
52410_0,,,,2,2,1,3
C(C)(C(C)CCC(C(O)=O)=O)=O,,,5,1,1,0,1
52412_0,,,,2,2,1,3
C(C(CC(C(C)=O)C)CO)(O)=O,,,5,1,1,0,1
52414_0,,,,2,2,1,3
C(C)(C(C)CC(C(C)=O)C(O)=O)=O,,,5,1,1,0,1
52416_0,,,,2,2,1,3
C(C)(C(C)CC(C(O)=O)C=C)=O,,,5,1,1,0,1
52418_0,,,,2,2,1,3
C1(C(CC(C(C)=O)C)CC(O)O1)=O,,,5,1,1,0,1
52420_0,,,,2,2,1,3
C1(C(C)C(C(O)O1)C(C(C)=O)C)=O,,,5,1,1,0,1
52422_0,,,,2,2,1,3
C(C)(C(C)C([CH]C(O)=O)C(C)O)=O,,,5,1,1,0,1
52424_0,,,,2,2,1,3
C(C)(C(C)C(C(O)=O)[CH]C(O)=O)=O,,,5,1,1,0,1
52426_0,,,,2,2,1,3
C(C)(C([C](C(O)=O)CC(O)=O)C)=O,,,5,1,1,0,1
52428_0,,,,2,2,1,3
C(CC(C(C)O)C(C(C)=O)C)(O)=O,,,5,1,1,0,1
52430_0,,,,2,2,1,3
C(C)(C(C)C(C(O)=O)CC(O)=O)=O,,,5,1,1,0,1
52431_0,,,,2,2,1,3
52432_0,,,,2,2,1,3
52433_0,,,,2,2,1,3
52435_0,,,,2,2,1,3
C(C)(C(C)C(C)CC(C(O)=O)=O)=O,,,5,1,1,0,1
52437_0,,,,2,2,1,3
C(C)(C(C)CC(C(O)=O)CC=O)=O,,,5,1,1,0,1
52439_0,,,,2,2,1,3
C(C)(C(C)C(C(O)=O)(C)CC=O)=O,,,5,1,1,0,1
52441_0,,,,2,2,1,3
C(C)(C(C)C(C=O)C(C(O)=O)C)=O,,,5,1,1,0,1
52443_0,,,,2,2,1,3
C(C(CC(C(C)=O)C)C(C)O)(O)=O,,,5,1,1,0,1
52445_0,,,,2,2,1,3
C(C)(C(C)CC(C(O)=O)C(O)=O)=O,,,5,1,1,0,1
52447_0,,,,2,2,1,3
C(C(CCC(CC)=O)CCO)(O)=O,,,5,1,1,0,1
52449_0,,,,2,2,1,3
C(C(C)C(CO)CC(CC)=O)(O)=O,,,5,1,1,0,1
52451_0,,,,2,2,1,3
C(CC(C)CC(O)=O)(CC)=O,,,5,1,1,0,1
52453_0,,,,2,2,1,3
C(C(C(O)=O)CCC(CC)=O)=O,,,5,1,1,0,1
52455_0,,,,2,2,1,3
C(CC(CC(C)O)CC(CC)=O)=O,,,5,1,1,0,1
52457_0,,,,2,2,1,3
C(C(CCC(CC)=O)C(C)O)=O,,,5,1,1,0,1
52459_0,,,,2,2,1,3
C(C(CO)C(C)CC(CC)=O)=O,,,5,1,1,0,1
52461_0,,,,2,2,1,3
C(C(C(C)CC(CC)=O)C(C)O)=O,,,5,1,1,0,1
52463_0,,,,2,2,1,3
C(C(C(O)=O)C(C)CC(CC)=O)=O,,,5,1,1,0,1
52465_0,,,,2,2,1,3
C(CC(CC(CC)=O)CC(O)=O)=O,,,5,1,2,0,2
52466_0,,,,2,2,1,3
52468_0,,,,2,2,1,3
C(CC(C=O)CC(CC)=O)(CO)=O,,,5,1,1,0,1
52470_0,,,,2,2,1,3
C(CC(C(CO)=O)CC=O)(CC)=O,,,5,1,1,0,1
52472_0,,,,2,2,1,3
C(CC(C=O)C(C=O)CO)(CC)=O,,,5,1,1,0,1
52474_0,,,,2,2,1,3
C(C(CO)(CC(CC)=O)CC=O)=O,,,5,1,1,0,1
52476_0,,,,2,2,1,3
C(CC(C(C=O)=O)C(C=O)C)(CC)=O,,,5,1,1,0,1
52478_0,,,,2,2,1,3
C(C(C)(CC(CC)=O)CC(C=O)=O)=O,,,5,1,1,0,1
52480_0,,,,2,2,1,3
C(CC)(CCC(C=O)CC(C=O)=O)=O,,,5,1,1,0,1
52482_0,,,,2,2,1,3
C(CC(C=O)C(C=O)C)(CC)=O,,,5,1,1,0,1
52484_0,,,,2,2,1,3
C(C(C)(CC(CC)=O)CC=O)=O,,,5,1,1,0,1
52486_0,,,,2,2,1,3
C(CC)(CCC(C=O)CC=O)=O,,,5,1,1,0,1
52488_0,,,,2,2,1,3
C(CC(C(C=O)=O)CC(CC)=O)(C)=O,,,5,1,1,0,1
52490_0,,,,2,2,1,3
C(CC(C(C)=O)CC(C=O)=O)(CC)=O,,,5,1,1,0,1
52492_0,,,,2,2,1,3
C(CC(C=O)CC(CC)=O)(C)=O,,,5,1,1,0,1
52494_0,,,,2,2,1,3
C(CC(C(C)=O)CC=O)(CC)=O,,,5,1,1,0,1
52496_0,,,,2,2,1,3
C(CC)(CCCC(C=O)=O)=O,,,5,1,1,0,1
52498_0,,,,2,2,1,3
C(CC(C)CC(C=O)=O)(CC)=O,,,5,1,1,0,1
52500_0,,,,2,2,1,3
C(CCCC(CC)=O)=O,,,5,1,1,0,1
52502_0,,,,2,2,1,3
C(CC)(CCCC(C(O)=O)=O)=O,,,5,1,1,0,1
52504_0,,,,2,2,1,3
C(C(CCC(CC)=O)CO)(O)=O,,,5,1,1,0,1
52506_0,,,,2,2,1,3
C(CC)(CCC(C(C)=O)C(O)=O)=O,,,5,1,1,0,1
52508_0,,,,2,2,1,3
C(CC)(CCC(C(O)=O)C=C)=O,,,5,1,1,0,1
52510_0,,,,2,2,1,3
C1(C(CCC(CC)=O)CC(O)O1)=O,,,5,1,1,0,1
52512_0,,,,2,2,1,3
C1(C(C)C(C(O)O1)CC(CC)=O)=O,,,5,1,1,0,1
52514_0,,,,2,2,1,3
C(CC([CH]C(O)=O)C(C)O)(CC)=O,,,5,1,1,0,1
52516_0,,,,2,2,1,3
C(CC(C(O)=O)[CH]C(O)=O)(CC)=O,,,5,1,1,0,1
52518_0,,,,2,2,1,3
C(CC)(C[C](C(O)=O)CC(O)=O)=O,,,5,1,1,0,1
52520_0,,,,2,2,1,3
C(CC(C(C)O)CC(CC)=O)(O)=O,,,5,1,1,0,1
52522_0,,,,2,2,1,3
C(CC(C(O)=O)CC(O)=O)(CC)=O,,,5,1,1,0,1
52523_0,,,,2,2,1,3
52524_0,,,,2,2,1,3
52525_0,,,,2,2,1,3
52527_0,,,,2,2,1,3
C(CC(C)CC(C(O)=O)=O)(CC)=O,,,5,1,1,0,1
52529_0,,,,2,2,1,3
C(CC)(CCC(C(O)=O)CC=O)=O,,,5,1,1,0,1
52531_0,,,,2,2,1,3
C(CC(C(O)=O)(C)CC=O)(CC)=O,,,5,1,1,0,1
52533_0,,,,2,2,1,3
C(CC(C=O)C(C(O)=O)C)(CC)=O,,,5,1,1,0,1
52535_0,,,,2,2,1,3
C(C(CCC(CC)=O)C(C)O)(O)=O,,,5,1,1,0,1
52537_0,,,,2,2,1,3
C(CC)(CCC(C(O)=O)C(O)=O)=O,,,5,1,1,0,1
52539_0,,,,2,2,1,3
C(C(C(CCCC=O)=O)(C)O)(O)=O,,,5,1,1,0,1
52541_0,,,,2,2,1,3
C(CCCC(C(O)=O)(C(C)=O)O)=O,,,5,1,1,0,1
52543_0,,,,2,2,1,3
C(CCC(C(O)=O)C(C(C)O)=O)=O,,,5,1,1,0,1
52545_0,,,,2,2,1,3
C(CCCC(C(CC(O)=O)=O)O)=O,,,5,1,1,0,1
52547_0,,,,2,2,1,3
C(C(C)(CCC=O)O)(CC(O)=O)=O,,,5,1,1,0,1
52549_0,,,,2,2,1,3
C(CCC(C(C(C(O)=O)C)=O)O)=O,,,5,1,1,0,1
52551_0,,,,2,2,1,3
C(CCCC(C(O)=O)C(CO)=O)=O,,,5,1,1,0,1
52553_0,,,,2,2,1,3
C(CCC(C(O)=O)(C(CO)=O)C)=O,,,5,1,1,0,1
52555_0,,,,2,2,1,3
C(C(C(CC)=O)(CCC=O)O)(O)=O,,,5,1,1,0,1
52557_0,,,,2,2,1,3
C(C(C(CCCCC=O)=O)O)(O)=O,,,5,1,1,0,1
52559_0,,,,2,2,1,3
C(C(C)CCC=O)(C(C(O)=O)O)=O,,,5,1,1,0,1
52561_0,,,,2,2,1,3
C(C)(C([CH]C(O)=O)CCC(C=O)=O)=O,,,5,1,1,0,1
52563_0,,,,2,2,1,3
C(CCC(C(C)=O)[CH]C(O)=O)=O,,,5,1,1,0,1
52565_0,,,,2,2,1,3
C(C)(C([CH]C(O)=O)C[CH]C(O)=O)=O,,,5,1,1,0,1
52567_0,,,,2,2,1,3
C(C)(C([CH]C(O)=O)CCC(O)=O)=O,,,5,1,1,0,1
52569_0,,,,2,2,1,3
C(CC(C)C(C(C)=O)[CH]C(O)=O)=O,,,5,1,1,0,1
52571_0,,,,2,2,1,3
C(C)(C[C](C(O)=O)CCC(C=O)=O)=O,,,5,1,1,0,1
52573_0,,,,2,2,1,3
C(CC[C](C(O)=O)CC(C)=O)=O,,,5,1,1,0,1
52575_0,,,,2,2,1,3
C(C)(C[C](C(O)=O)C[CH]C(O)=O)=O,,,5,1,1,0,1
52577_0,,,,2,2,1,3
C(C)(C[C](C(O)=O)CCC(O)=O)=O,,,5,1,1,0,1
52579_0,,,,2,2,1,3
C(C)(C[C](C(O)=O)C(C)CC=O)=O,,,5,1,1,0,1
52581_0,,,,2,2,1,3
C(CCCC(C=O)=O)(C[CH]C(O)=O)=O,,,5,1,1,0,1
52583_0,,,,2,2,1,3
C(CCCC(C[CH]C(O)=O)=O)=O,,,5,1,1,0,1
52585_0,,,,2,2,1,3
C(CC[CH]C(O)=O)(C[CH]C(O)=O)=O,,,5,1,1,0,1
52587_0,,,,2,2,1,3
C(CCCC(O)=O)(C[CH]C(O)=O)=O,,,5,1,1,0,1
52589_0,,,,2,2,1,3
C(CC(C)CC(C[CH]C(O)=O)=O)=O,,,5,1,1,0,1
52591_0,,,,2,2,1,3
C(C)(C(CCC=O)CC(O)=O)=O,,,5,1,1,0,1
52593_0,,,,2,2,1,3
C(CC(C(C)=O)C[CH]C(O)=O)(O)=O,,,5,1,1,0,1
52595_0,,,,2,2,1,3
C(C)(C(CCC(O)=O)CC(O)=O)=O,,,5,1,1,0,1
52597_0,,,,2,2,1,3
C(C)(C(C(C)CC=O)CC(O)=O)=O,,,5,1,1,0,1
52599_0,,,,2,2,1,3
C(CCC(C(O)=O)CC(C)=O)=O,,,5,1,1,0,1
52601_0,,,,2,2,1,3
C(C(C[CH]C(O)=O)CC(C)=O)(O)=O,,,5,1,1,0,1
52603_0,,,,2,2,1,3
C(CC(C(O)=O)CCC(O)=O)(C)=O,,,5,1,1,0,1
52605_0,,,,2,2,1,3
C(CC(C)C(C(O)=O)CC(C)=O)=O,,,5,1,1,0,1
52607_0,,,,2,2,1,3
C(CCCC(CCC(O)=O)=O)=O,,,5,1,1,0,1
52609_0,,,,2,2,1,3
C(CCC(CC[CH]C(O)=O)=O)(O)=O,,,5,1,1,0,1
52611_0,,,,2,2,1,3
C(CCC(O)=O)(CCCC(O)=O)=O,,,5,1,1,0,1
52613_0,,,,2,2,1,3
C(CC(C)CC(CCC(O)=O)=O)=O,,,5,1,1,0,1
52615_0,,,,2,2,1,3
C(C([CH]C(O)=O)C(C)CC(O)=O)=O,,,5,1,1,0,1
52617_0,,,,2,2,1,3
C(C(C)C(C=O)C(C=O)[CH]C(O)=O)=O,,,5,1,1,0,1
52619_0,,,,2,2,1,3
C(C(C)(CC=O)C(C=O)[CH]C(O)=O)=O,,,5,1,1,0,1
52621_0,,,,2,2,1,3
C(C(CC(C=O)[CH]C(O)=O)CC=O)=O,,,5,1,1,0,1
52623_0,,,,2,2,1,3
C(C([CH]C(O)=O)C(C=O)CC(C)=O)=O,,,5,1,1,0,1
52625_0,,,,2,2,1,3
C(C([CH]C(O)=O)C(C(C)=O)CC=O)=O,,,5,1,1,0,1
52627_0,,,,2,2,1,3
C(C([CH]C(O)=O)CCC(C=O)=O)=O,,,5,1,1,0,1
52629_0,,,,2,2,1,3
C(C([CH]C(O)=O)C(C)CC(C=O)=O)=O,,,5,1,1,0,1
52631_0,,,,2,2,1,3
C(C([CH]C(O)=O)CCC=O)=O,,,5,1,1,0,1
52633_0,,,,2,2,1,3
C(C([CH]C(O)=O)CC(C(O)=O)C=C)=O,,,5,1,1,0,1
52635_0,,,,2,2,1,3
C(C([CH]C(O)=O)C[CH]C(O)=O)=O,,,5,1,1,0,1
52637_0,,,,2,2,1,3
C(C([CH]C(O)=O)CCC(O)=O)=O,,,5,1,1,0,1
52639_0,,,,2,2,1,3
C(C([CH]C(O)=O)C(C)CC=O)=O,,,5,1,1,0,1
52641_0,,,,2,2,1,3
C(C[C](C(O)=O)C(C)CC(O)=O)=O,,,5,1,1,0,1
52643_0,,,,2,2,1,3
C(C[C](C(O)=O)C(C=O)C(C=O)C)=O,,,5,1,1,0,1
52645_0,,,,2,2,1,3
C(C([C](C(O)=O)CC=O)(C)CC=O)=O,,,5,1,1,0,1
52647_0,,,,2,2,1,3
C(C[C](C(O)=O)CC(C=O)CC=O)=O,,,5,1,1,0,1
52649_0,,,,2,2,1,3
C(C([C](C(O)=O)CC=O)CC(C)=O)=O,,,5,1,1,0,1
52651_0,,,,2,2,1,3
C(C[C](C(O)=O)C(C(C)=O)CC=O)=O,,,5,1,1,0,1
52653_0,,,,2,2,1,3
C(C[C](C(O)=O)CCC(C=O)=O)=O,,,5,1,1,0,1
52655_0,,,,2,2,1,3
C(C[C](C(O)=O)C(C)CC(C=O)=O)=O,,,5,1,1,0,1
52657_0,,,,2,2,1,3
C(C[C](C(O)=O)CCC=O)=O,,,5,1,1,0,1
52659_0,,,,2,2,1,3
C(C[C](C(O)=O)CC(C(O)=O)C=C)=O,,,5,1,1,0,1
52661_0,,,,2,2,1,3
C(C[C](C(O)=O)C[CH]C(O)=O)=O,,,5,1,1,0,1
52663_0,,,,2,2,1,3
C(C[C](C(O)=O)CCC(O)=O)=O,,,5,1,1,0,1
52665_0,,,,2,2,1,3
C(C[C](C(O)=O)C(C)CC=O)=O,,,5,1,1,0,1
52667_0,,,,2,2,1,3
C(C(C(C)CC(O)=O)CC(O)=O)=O,,,5,1,1,0,1
52669_0,,,,2,2,1,3
C(C(CCC(C=O)=O)CC(O)=O)=O,,,5,1,1,0,1
52671_0,,,,2,2,1,3
C(CCC(C=O)CC(O)=O)=O,,,5,1,1,0,1
52673_0,,,,2,2,1,3
C(C(CC(O)=O)C[CH]C(O)=O)=O,,,5,1,1,0,1
52675_0,,,,2,2,1,3
C(C(CCC(O)=O)CC(O)=O)=O,,,5,1,1,0,1
52677_0,,,,2,2,1,3
C(CC(C)C(C=O)CC(O)=O)=O,,,5,1,1,0,1
52679_0,,,,2,2,1,3
C(CC(C(O)=O)C(C)CC(O)=O)=O,,,5,1,1,0,1
52680_0,,,,2,2,1,3
52681_0,,,,2,2,1,3
52683_0,,,,2,2,1,3
C(CC(C(O)=O)C[CH]C(O)=O)=O,,,5,1,2,0,2
52684_0,,,,2,2,1,3
52686_0,,,,2,2,1,3
C(CC(C)C(C(O)=O)CC=O)=O,,,5,1,1,0,1
52688_0,,,,2,2,1,3
C(CCC(C=O)C(C(CO)O)=O)=O,,,5,1,1,0,1
52690_0,,,,2,2,1,3
C(CCC(C(C(CC=O)=O)O)O)=O,,,5,1,1,0,1
52692_0,,,,2,2,1,3
C(C(CO)(CCC=O)O)(CC=O)=O,,,5,1,1,0,1
52694_0,,,,2,2,1,3
C(CCCC(C(C(C=O)O)=O)O)=O,,,5,1,1,0,1
52696_0,,,,2,2,1,3
C(C(C)(CCC=O)O)(C(C=O)O)=O,,,5,1,1,0,1
52698_0,,,,2,2,1,3
C(CCC(C=O)(C(C(C)O)=O)O)=O,,,5,1,1,0,1
52700_0,,,,2,2,1,3
C(C(C(C(O)=O)=O)(CCC=O)O)=O,,,5,1,1,0,1
52702_0,,,,2,2,1,3
C(CCC(C=O)C(C(C)O)=O)=O,,,5,1,1,0,1
52703_0,,,,2,2,1,3
52704_0,,,,2,2,1,3
52705_0,,,,2,2,1,3
52707_0,,,,2,2,1,3
C(CCCC(C(CC=O)=O)O)=O,,,5,1,1,0,1
52708_0,,,,2,2,1,3
52709_0,,,,2,2,1,3
52710_0,,,,2,2,1,3
52712_0,,,,2,2,1,3
C(C(C)(CCC=O)O)(CC=O)=O,,,5,1,1,0,1
52714_0,,,,2,2,1,3
C(C(C)(C[CH]C(O)=O)O)(CC=O)=O,,,5,1,1,0,1
52716_0,,,,2,2,1,3
C(C(C)(CCC(O)=O)O)(CC=O)=O,,,5,1,1,0,1
52718_0,,,,2,2,1,3
C(C(C)(C(C)CC=O)O)(CC=O)=O,,,5,1,1,0,1
52720_0,,,,2,2,1,3
C(CCCC(C(C(CO)=O)O)=O)=O,,,5,1,1,0,1
52722_0,,,,2,2,1,3
C(CCC(C(C(C(C)=O)O)=O)O)=O,,,5,1,1,0,1
52724_0,,,,2,2,1,3
C(CCC(C(C)=O)(C(CO)=O)O)=O,,,5,1,1,0,1
52726_0,,,,2,2,1,3
C(CCCC(C(C(C)=O)O)=O)=O,,,5,1,1,0,1
52727_0,,,,2,2,1,3
52728_0,,,,2,2,1,3
52729_0,,,,2,2,1,3
52731_0,,,,2,2,1,3
C(CCC(C(C)=O)(C(C)=O)O)=O,,,5,1,1,0,1
52733_0,,,,2,2,1,3
C(C)(C(C(C)=O)(C[CH]C(O)=O)O)=O,,,5,1,1,0,1
52735_0,,,,2,2,1,3
C(CCC(C(C)=O)(C(C)=O)O)(O)=O,,,5,1,1,0,1
52737_0,,,,2,2,1,3
C(CC(C)C(C(C)=O)(C(C)=O)O)=O,,,5,1,1,0,1
52739_0,,,,2,2,1,3
C(CCC(CO)C(CC(C)O)O)=O,,,5,1,1,0,1
52741_0,,,,2,2,1,3
C(CCC(CC(CC(C)O)O)O)=O,,,5,1,1,0,1
52743_0,,,,2,2,1,3
C(CCC(C(C)O)C(CCO)O)=O,,,5,1,1,0,1
52745_0,,,,2,2,1,3
C(CCC(CC(C)O)(CCO)O)=O,,,5,1,1,0,1
52747_0,,,,2,2,1,3
C(CCCC(CC(CCO)O)O)=O,,,5,1,1,0,1
52749_0,,,,2,2,1,3
C(CCC(C)(CC(CCO)O)O)=O,,,5,1,1,0,1
52751_0,,,,2,2,1,3
C(CCC(C(CO)C(C)O)O)=O,,,5,1,1,0,1
52752_0,,,,2,2,1,3
52753_0,,,,2,2,1,3
52754_0,,,,2,2,1,3
52756_0,,,,2,2,1,3
C(CCC(CO)(CO)C(C)O)=O,,,5,1,1,0,1
52757_0,,,,2,2,1,3
52758_0,,,,2,2,1,3
52759_0,,,,2,2,1,3
52761_0,,,,2,2,1,3
C(CCCC(C(CO)CO)O)=O,,,5,1,1,0,1
52762_0,,,,2,2,1,3
52763_0,,,,2,2,1,3
52764_0,,,,2,2,1,3
52766_0,,,,2,2,1,3
C(CCC(C)(C(CO)CO)O)=O,,,5,1,1,0,1
52767_0,,,,2,2,1,3
52768_0,,,,2,2,1,3
52769_0,,,,2,2,1,3
52771_0,,,,2,2,1,3
C(CCCC(C(CO)C(C)O)O)=O,,,5,1,1,0,1
52773_0,,,,2,2,1,3
C(CCC(C)(C(CO)C(C)O)O)=O,,,5,1,1,0,1
52775_0,,,,2,2,1,3
C(CCC(CO)(C(C)O)C(C)O)=O,,,5,1,1,0,1
52777_0,,,,2,2,1,3
C(CCC(C(C(C)O)C(C)O)O)=O,,,5,1,1,0,1
52778_0,,,,2,2,1,3
52780_0,,,,2,2,1,3
C(C(C(C)O)C(CCC=O)O)(O)=O,,,5,1,1,0,1
52782_0,,,,2,2,1,3
C(C(CO)C(CCCC=O)O)(O)=O,,,5,1,1,0,1
52784_0,,,,2,2,1,3
C(C(CO)C(C)(CCC=O)O)(O)=O,,,5,1,1,0,1
52786_0,,,,2,2,1,3
C(CC(C(CCC=O)CO)O)(O)=O,,,5,1,1,0,1
52788_0,,,,2,2,1,3
C(CC(CC(CCC=O)O)O)(O)=O,,,5,1,1,0,1
52790_0,,,,2,2,1,3
C(C(CCC=O)C(CCO)O)(O)=O,,,5,1,1,0,1
52792_0,,,,2,2,1,3
C(CC(CCC=O)(CCO)O)(O)=O,,,5,1,1,0,1
52794_0,,,,2,2,1,3
C(C(CO)C(CCC=O)O)(O)=O,,,5,1,1,0,1
52795_0,,,,2,2,1,3
52796_0,,,,2,2,1,3
52797_0,,,,2,2,1,3
52799_0,,,,2,2,1,3
C(C(CCC=O)(CO)CO)(O)=O,,,5,1,1,0,1
52800_0,,,,2,2,1,3
52801_0,,,,2,2,1,3
52802_0,,,,2,2,1,3
52803_0,,,,2,2,1,3
52805_0,,,,2,2,1,3
C(C(C(O)=O)C(CCC=O)O)(O)=O,,,5,1,1,0,1
52807_0,,,,2,2,1,3
C(CCC(CO)C(C(CO)=O)O)=O,,,5,1,1,0,1
52809_0,,,,2,2,1,3
C(CCC(CC(C(CO)=O)O)O)=O,,,5,1,1,0,1
52811_0,,,,2,2,1,3
C(CCC(C(C(CCO)O)=O)O)=O,,,5,1,1,0,1
52813_0,,,,2,2,1,3
C(CCC(C(CO)=O)(CCO)O)=O,,,5,1,1,0,1
52815_0,,,,2,2,1,3
C(C(CO)(C(CO)CCC=O)O)=O,,,5,1,1,0,1
52817_0,,,,2,2,1,3
C(C(CO)(CC(CCC=O)O)O)=O,,,5,1,1,0,1
52819_0,,,,2,2,1,3
C(C(C(CCC=O)O)(CCO)O)=O,,,5,1,1,0,1
52821_0,,,,2,2,1,3
C(C(C)(C(CO)CCC=O)O)=O,,,5,1,1,0,1
52822_0,,,,2,2,1,3
52823_0,,,,2,2,1,3
52824_0,,,,2,2,1,3
52826_0,,,,2,2,1,3
C(C(C)(CC(CCC=O)O)O)=O,,,5,1,1,0,1
52828_0,,,,2,2,1,3
C(C(C)(CC(C[CH]C(O)=O)O)O)=O,,,5,1,1,0,1
52830_0,,,,2,2,1,3
C(C(C)(CC(CCC(O)=O)O)O)=O,,,5,1,1,0,1
52832_0,,,,2,2,1,3
C(C(C)(CC(C(C)CC=O)O)O)=O,,,5,1,1,0,1
52834_0,,,,2,2,1,3
C(C(CCO)(CCCC=O)O)=O,,,5,1,1,0,1
52835_0,,,,2,2,1,3
52836_0,,,,2,2,1,3
52837_0,,,,2,2,1,3
52839_0,,,,2,2,1,3
C(CCC(CO)C(C(C)=O)O)=O,,,5,1,1,0,1
52840_0,,,,2,2,1,3
52841_0,,,,2,2,1,3
52842_0,,,,2,2,1,3
52844_0,,,,2,2,1,3
C(CCC(CC(C(C)=O)O)O)=O,,,5,1,1,0,1
52846_0,,,,2,2,1,3
C(C)(C(CC(C[CH]C(O)=O)O)O)=O,,,5,1,1,0,1
52848_0,,,,2,2,1,3
C(CCC(CC(C(C)=O)O)O)(O)=O,,,5,1,1,0,1
52850_0,,,,2,2,1,3
C(CC(C)C(CC(C(C)=O)O)O)=O,,,5,1,1,0,1
52852_0,,,,2,2,1,3
C(CCCC(C(CCO)O)=O)=O,,,5,1,1,0,1
52853_0,,,,2,2,1,3
52854_0,,,,2,2,1,3
52855_0,,,,2,2,1,3
52857_0,,,,2,2,1,3
C(CCC(C(C)=O)(CCO)O)=O,,,5,1,1,0,1
52858_0,,,,2,2,1,3
52859_0,,,,2,2,1,3
52860_0,,,,2,2,1,3
52862_0,,,,2,2,1,3
C(C(CCO)CC(CO)CO)(O)=O,,,5,1,1,0,1
52864_0,,,,2,2,1,3
C(C(C)C(CO)C(CO)CO)(O)=O,,,5,1,1,0,1
52866_0,,,,2,2,1,3
C(CC(C)C(CO)CO)(O)=O,,,5,1,1,0,1
52868_0,,,,2,2,1,3
C(C(C=O)CC(CO)CO)(O)=O,,,5,1,1,0,1
52870_0,,,,2,2,1,3
C(CC(CC(C)O)C(CO)CO)=O,,,5,1,1,0,1
52872_0,,,,2,2,1,3
C(C(CC(CO)CO)C(C)O)=O,,,5,1,1,0,1
52874_0,,,,2,2,1,3
C(C(CO)C(C)C(CO)CO)=O,,,5,1,1,0,1
52876_0,,,,2,2,1,3
C(C(C(C)O)C(C)C(CO)CO)=O,,,5,1,1,0,1
52878_0,,,,2,2,1,3
C(C(C=O)C(C)C(CO)CO)(O)=O,,,5,1,1,0,1
52880_0,,,,2,2,1,3
C(CC(C(CO)CO)CC=O)(O)=O,,,5,1,2,0,2
52881_0,,,,2,2,1,3
52883_0,,,,2,2,1,3
C(C(C(CO)CO)CC(CO)=O)=O,,,5,1,1,0,1
52885_0,,,,2,2,1,3
C(CO)(C(C(CO)CO)CC=O)=O,,,5,1,1,0,1
52887_0,,,,2,2,1,3
C(C(C(CO)CO)C(C=O)CO)=O,,,5,1,1,0,1
52889_0,,,,2,2,1,3
C(C(CO)(C(CO)CO)CC=O)=O,,,5,1,1,0,1
52891_0,,,,2,2,1,3
C(C(C(CO)CO)C(C=O)C)=O,,,5,1,1,0,1
52893_0,,,,2,2,1,3
C(C(C)(C(CO)CO)CC=O)=O,,,5,1,1,0,1
52895_0,,,,2,2,1,3
C(C(CC(CO)CO)CC=O)=O,,,5,1,1,0,1
52897_0,,,,2,2,1,3
C(C(C(CO)CO)CC(C)=O)=O,,,5,1,1,0,1
52899_0,,,,2,2,1,3
C(C)(C(C(CO)CO)CC=O)=O,,,5,1,1,0,1
52901_0,,,,2,2,1,3
C(C(CCC(CO)CO)=O)=O,,,5,1,1,0,1
52903_0,,,,2,2,1,3
C(C(CC(C)C(CO)CO)=O)=O,,,5,1,1,0,1
52905_0,,,,2,2,1,3
C(CCC(CO)CO)=O,,,5,1,1,0,1
52907_0,,,,2,2,1,3
C(C(CCC(CO)CO)=O)(O)=O,,,5,1,1,0,1
52909_0,,,,2,2,1,3
C(C(CO)CC(CO)CO)(O)=O,,,5,1,1,0,1
52911_0,,,,2,2,1,3
C(C(C(C)=O)CC(CO)CO)(O)=O,,,5,1,1,0,1
52913_0,,,,2,2,1,3
C(C(C=C)CC(CO)CO)(O)=O,,,5,1,1,0,1
52915_0,,,,2,2,1,3
C1(C(CC(O)O1)CC(CO)CO)=O,,,5,1,1,0,1
52917_0,,,,2,2,1,3
C1(C(C)C(C(O)O1)C(CO)CO)=O,,,5,1,1,0,1
52919_0,,,,2,2,1,3
[CH](C(O)=O)C(C(C)O)C(CO)CO,,,5,1,1,0,1
52921_0,,,,2,2,1,3
C(C([CH]C(O)=O)C(CO)CO)(O)=O,,,5,1,1,0,1
52923_0,,,,2,2,1,3
C(C[C](C(O)=O)C(CO)CO)(O)=O,,,5,1,1,0,1
52925_0,,,,2,2,1,3
C(CC(C(C)O)C(CO)CO)(O)=O,,,5,1,1,0,1
52927_0,,,,2,2,1,3
C(C(C(CO)CO)CC(O)=O)(O)=O,,,5,1,1,0,1
52928_0,,,,2,2,1,3
52929_0,,,,2,2,1,3
52930_0,,,,2,2,1,3
52931_0,,,,2,2,1,3
52932_0,,,,2,2,1,3
52933_0,,,,2,2,1,3
52934_0,,,,2,2,1,3
52935_0,,,,2,2,1,3
52936_0,,,,2,2,1,3
52938_0,,,,2,2,1,3
C(C(CC(CCO)O)CCO)(O)=O,,,5,1,1,0,1
52940_0,,,,2,2,1,3
C(C(C)C(CO)C(CCO)O)(O)=O,,,5,1,1,0,1
52942_0,,,,2,2,1,3
C(CC(C)C(CCO)O)(O)=O,,,5,1,1,0,1
52944_0,,,,2,2,1,3
C(C(C=O)CC(CCO)O)(O)=O,,,5,1,1,0,1
52946_0,,,,2,2,1,3
C(CC(CC(C)O)C(CCO)O)=O,,,5,1,1,0,1
52948_0,,,,2,2,1,3
C(C(CC(CCO)O)C(C)O)=O,,,5,1,1,0,1
52950_0,,,,2,2,1,3
C(C(CO)C(C)C(CCO)O)=O,,,5,1,1,0,1
52952_0,,,,2,2,1,3
C(C(C(C)O)C(C)C(CCO)O)=O,,,5,1,1,0,1
52954_0,,,,2,2,1,3
C(C(C=O)C(C)C(CCO)O)(O)=O,,,5,1,1,0,1
52956_0,,,,2,2,1,3
C(CC(C(CCO)O)CC=O)(O)=O,,,5,1,2,0,2
52957_0,,,,2,2,1,3
52959_0,,,,2,2,1,3
C(C(C(CCO)O)CC(CO)=O)=O,,,5,1,1,0,1
52961_0,,,,2,2,1,3
C(CO)(C(C(CCO)O)CC=O)=O,,,5,1,1,0,1
52963_0,,,,2,2,1,3
C(C(C(CCO)O)C(C=O)CO)=O,,,5,1,1,0,1
52965_0,,,,2,2,1,3
C(C(CO)(C(CCO)O)CC=O)=O,,,5,1,1,0,1
52967_0,,,,2,2,1,3
C(C(C(CCO)O)C(C=O)C)=O,,,5,1,1,0,1
52969_0,,,,2,2,1,3
C(C(C)(C(CCO)O)CC=O)=O,,,5,1,1,0,1
52971_0,,,,2,2,1,3
C(C(CC(CCO)O)CC=O)=O,,,5,1,1,0,1
52973_0,,,,2,2,1,3
C(C(C(CCO)O)CC(C)=O)=O,,,5,1,1,0,1
52975_0,,,,2,2,1,3
C(C)(C(C(CCO)O)CC=O)=O,,,5,1,1,0,1
52977_0,,,,2,2,1,3
C(C(CCC(CCO)O)=O)=O,,,5,1,1,0,1
52979_0,,,,2,2,1,3
C(C(CC(C)C(CCO)O)=O)=O,,,5,1,1,0,1
52981_0,,,,2,2,1,3
C(CCC(CCO)O)=O,,,5,1,1,0,1
52983_0,,,,2,2,1,3
C(C(CCC(CCO)O)=O)(O)=O,,,5,1,1,0,1
52985_0,,,,2,2,1,3
C(C(CO)CC(CCO)O)(O)=O,,,5,1,1,0,1
52987_0,,,,2,2,1,3
C(C(C(C)=O)CC(CCO)O)(O)=O,,,5,1,1,0,1
52989_0,,,,2,2,1,3
C(C(C=C)CC(CCO)O)(O)=O,,,5,1,1,0,1
52991_0,,,,2,2,1,3
C1(C(CC(O)O1)CC(CCO)O)=O,,,5,1,1,0,1
52993_0,,,,2,2,1,3
C1(C(C)C(C(O)O1)C(CCO)O)=O,,,5,1,1,0,1
52995_0,,,,2,2,1,3
[CH](C(O)=O)C(C(C)O)C(CCO)O,,,5,1,1,0,1
52997_0,,,,2,2,1,3
C(C([CH]C(O)=O)C(CCO)O)(O)=O,,,5,1,1,0,1
52999_0,,,,2,2,1,3
C(C[C](C(O)=O)C(CCO)O)(O)=O,,,5,1,1,0,1
53001_0,,,,2,2,1,3
C(CC(C(CCO)O)C(C)O)(O)=O,,,5,1,1,0,1
53003_0,,,,2,2,1,3
C(C(C(CCO)O)CC(O)=O)(O)=O,,,5,1,1,0,1
53004_0,,,,2,2,1,3
53005_0,,,,2,2,1,3
53006_0,,,,2,2,1,3
53007_0,,,,2,2,1,3
53008_0,,,,2,2,1,3
53009_0,,,,2,2,1,3
53010_0,,,,2,2,1,3
53011_0,,,,2,2,1,3
53012_0,,,,2,2,1,3
53014_0,,,,2,2,1,3
C(C(CC(C=CC)O)CCO)(O)=O,,,5,1,1,0,1
53016_0,,,,2,2,1,3
C(C(C)C(CO)C(C=CC)O)(O)=O,,,5,1,1,0,1
53018_0,,,,2,2,1,3
C(CC(C)C(C=CC)O)(O)=O,,,5,1,1,0,1
53020_0,,,,2,2,1,3
C(C(C=O)CC(C=CC)O)(O)=O,,,5,1,1,0,1
53022_0,,,,2,2,1,3
C(CC(CC(C)O)C(C=CC)O)=O,,,5,1,1,0,1
53024_0,,,,2,2,1,3
C(C(CC(C=CC)O)C(C)O)=O,,,5,1,1,0,1
53026_0,,,,2,2,1,3
C(C(CO)C(C)C(C=CC)O)=O,,,5,1,1,0,1
53028_0,,,,2,2,1,3
C(C(C(C)O)C(C)C(C=CC)O)=O,,,5,1,1,0,1
53030_0,,,,2,2,1,3
C(C(C=O)C(C)C(C=CC)O)(O)=O,,,5,1,1,0,1
53032_0,,,,2,2,1,3
C(CC(C(C=CC)O)CC=O)(O)=O,,,5,1,2,0,2
53033_0,,,,2,2,1,3
53035_0,,,,2,2,1,3
C(C(CC(CO)=O)C(C=CC)O)=O,,,5,1,1,0,1
53037_0,,,,2,2,1,3
C(CC(C(CO)=O)C(C=CC)O)=O,,,5,1,1,0,1
53039_0,,,,2,2,1,3
C(C(CO)C(C=O)C(C=CC)O)=O,,,5,1,1,0,1
53041_0,,,,2,2,1,3
C(CC(C=O)(CO)C(C=CC)O)=O,,,5,1,1,0,1
53043_0,,,,2,2,1,3
C(C(C)C(C(C=O)=O)C(C=CC)O)=O,,,5,1,1,0,1
53045_0,,,,2,2,1,3
C(C(C)(C(C=CC)O)CC(C=O)=O)=O,,,5,1,1,0,1
53047_0,,,,2,2,1,3
C(C(CC(C=CC)O)CC(C=O)=O)=O,,,5,1,1,0,1
53049_0,,,,2,2,1,3
C(C(C)C(C=O)C(C=CC)O)=O,,,5,1,1,0,1
53051_0,,,,2,2,1,3
C(CC(C=O)(C)C(C=CC)O)=O,,,5,1,1,0,1
53053_0,,,,2,2,1,3
C(C(CC(C=CC)O)CC=O)=O,,,5,1,1,0,1
53055_0,,,,2,2,1,3
C(C)(CC(C(C=O)=O)C(C=CC)O)=O,,,5,1,1,0,1
53057_0,,,,2,2,1,3
C(C)(C(CC(C=O)=O)C(C=CC)O)=O,,,5,1,1,0,1
53059_0,,,,2,2,1,3
C(C(CC(C)=O)C(C=CC)O)=O,,,5,1,1,0,1
53061_0,,,,2,2,1,3
C(CC(C(C)=O)C(C=CC)O)=O,,,5,1,1,0,1
53063_0,,,,2,2,1,3
C(C(CCC(C=O)=O)O)=CC,,,5,1,1,0,1
53065_0,,,,2,2,1,3
C(C(C(C)CC(C=O)=O)O)=CC,,,5,1,1,0,1
53067_0,,,,2,2,1,3
C(CCC(C=CC)O)=O,,,5,1,1,0,1
53069_0,,,,2,2,1,3
C(C(CCC(C(O)=O)=O)O)=CC,,,5,1,1,0,1
53071_0,,,,2,2,1,3
C(C(CO)CC(C=CC)O)(O)=O,,,5,1,1,0,1
53073_0,,,,2,2,1,3
C(C(C(C)=O)CC(C=CC)O)(O)=O,,,5,1,1,0,1
53075_0,,,,2,2,1,3
C(C(C=C)CC(C=CC)O)(O)=O,,,5,1,1,0,1
53077_0,,,,2,2,1,3
C1(C(CC(C=CC)O)CC(O)O1)=O,,,5,1,1,0,1
53079_0,,,,2,2,1,3
C1(C(C)C(C(O)O1)C(C=CC)O)=O,,,5,1,1,0,1
53081_0,,,,2,2,1,3
C(C)=CC(C([CH]C(O)=O)C(C)O)O,,,5,1,1,0,1
53083_0,,,,2,2,1,3
C(C([CH]C(O)=O)C(C=CC)O)(O)=O,,,5,1,1,0,1
53085_0,,,,2,2,1,3
C(C[C](C(O)=O)C(C=CC)O)(O)=O,,,5,1,1,0,1
53087_0,,,,2,2,1,3
C(CC(C(C)O)C(C=CC)O)(O)=O,,,5,1,1,0,1
53089_0,,,,2,2,1,3
C(CC(C(O)=O)C(C=CC)O)(O)=O,,,5,1,1,0,1
53090_0,,,,2,2,1,3
53091_0,,,,2,2,1,3
53092_0,,,,2,2,1,3
53094_0,,,,2,2,1,3
C(C(C(C)CC(C(O)=O)=O)O)=CC,,,5,1,1,0,1
53096_0,,,,2,2,1,3
C(C(CC(C=CC)O)CC=O)(O)=O,,,5,1,1,0,1
53098_0,,,,2,2,1,3
C(C(C)(C(C=CC)O)CC=O)(O)=O,,,5,1,1,0,1
53100_0,,,,2,2,1,3
C(C(C)C(C=O)C(C=CC)O)(O)=O,,,5,1,1,0,1
53102_0,,,,2,2,1,3
C(C(CC(C=CC)O)C(C)O)(O)=O,,,5,1,1,0,1
53104_0,,,,2,2,1,3
C(C(C(O)=O)CC(C=CC)O)(O)=O,,,5,1,1,0,1
53106_0,,,,2,2,1,3
C(C(CCC=CCO)CCO)(O)=O,,,5,1,1,0,1
53108_0,,,,2,2,1,3
C(C(C)C(CO)CC=CCO)(O)=O,,,5,1,1,0,1
53110_0,,,,2,2,1,3
C(CC(C)CC=CCO)(O)=O,,,5,1,1,0,1
53112_0,,,,2,2,1,3
C(C(C=O)CCC=CCO)(O)=O,,,5,1,1,0,1
53114_0,,,,2,2,1,3
C(CC(CC(C)O)CC=CCO)=O,,,5,1,1,0,1
53116_0,,,,2,2,1,3
C(C(CCC=CCO)C(C)O)=O,,,5,1,1,0,1
53118_0,,,,2,2,1,3
C(C(CO)C(C)CC=CCO)=O,,,5,1,1,0,1
53120_0,,,,2,2,1,3
C(C(C(C)O)C(C)CC=CCO)=O,,,5,1,1,0,1
53122_0,,,,2,2,1,3
C(C(C=O)C(C)CC=CCO)(O)=O,,,5,1,1,0,1
53124_0,,,,2,2,1,3
C(CC(CC=O)CC=CCO)(O)=O,,,5,1,2,0,2
53125_0,,,,2,2,1,3
53127_0,,,,2,2,1,3
C(C(CC(CO)=O)CC=CCO)=O,,,5,1,1,0,1
53129_0,,,,2,2,1,3
C(CC(C(CO)=O)CC=CCO)=O,,,5,1,1,0,1
53131_0,,,,2,2,1,3
C(C(CO)C(C=O)CC=CCO)=O,,,5,1,1,0,1
53133_0,,,,2,2,1,3
C(C(CO)(CC=O)CC=CCO)=O,,,5,1,1,0,1
53135_0,,,,2,2,1,3
C(C(C)C(C(C=O)=O)CC=CCO)=O,,,5,1,1,0,1
53137_0,,,,2,2,1,3
C(C(C)(CC=CCO)CC(C=O)=O)=O,,,5,1,1,0,1
53139_0,,,,2,2,1,3
C(C(CCC=CCO)CC(C=O)=O)=O,,,5,1,1,0,1
53141_0,,,,2,2,1,3
C(C(C)C(C=O)CC=CCO)=O,,,5,1,1,0,1
53143_0,,,,2,2,1,3
C(C(C)(CC=O)CC=CCO)=O,,,5,1,1,0,1
53145_0,,,,2,2,1,3
C(C(CCC=CCO)CC=O)=O,,,5,1,1,0,1
53147_0,,,,2,2,1,3
C(C)(CC(C(C=O)=O)CC=CCO)=O,,,5,1,1,0,1
53149_0,,,,2,2,1,3
C(C)(C(CC=CCO)CC(C=O)=O)=O,,,5,1,1,0,1
53151_0,,,,2,2,1,3
C(C(CC(C)=O)CC=CCO)=O,,,5,1,1,0,1
53153_0,,,,2,2,1,3
C(CC(C(C)=O)CC=CCO)=O,,,5,1,1,0,1
53155_0,,,,2,2,1,3
C(CCCC(C=O)=O)=CCO,,,5,1,1,0,1
53157_0,,,,2,2,1,3
C(CC(C)CC(C=O)=O)=CCO,,,5,1,1,0,1
53159_0,,,,2,2,1,3
C(CCCC=CCO)=O,,,5,1,1,0,1
53161_0,,,,2,2,1,3
C(CCCC(C(O)=O)=O)=CCO,,,5,1,1,0,1
53163_0,,,,2,2,1,3
C(C(CO)CCC=CCO)(O)=O,,,5,1,1,0,1
53165_0,,,,2,2,1,3
C(C)(C(C(O)=O)CCC=CCO)=O,,,5,1,1,0,1
53167_0,,,,2,2,1,3
C(C(C=C)CCC=CCO)(O)=O,,,5,1,1,0,1
53169_0,,,,2,2,1,3
C1(C(CCC=CCO)CC(O)O1)=O,,,5,1,1,0,1
53171_0,,,,2,2,1,3
C1(C(C)C(C(O)O1)CC=CCO)=O,,,5,1,1,0,1
53173_0,,,,2,2,1,3
C(CO)=CCC([CH]C(O)=O)C(C)O,,,5,1,1,0,1
53175_0,,,,2,2,1,3
C(C([CH]C(O)=O)CC=CCO)(O)=O,,,5,1,1,0,1
53177_0,,,,2,2,1,3
C(C[C](C(O)=O)CC=CCO)(O)=O,,,5,1,1,0,1
53179_0,,,,2,2,1,3
C(CC(C(C)O)CC=CCO)(O)=O,,,5,1,1,0,1
53181_0,,,,2,2,1,3
C(CC(C(O)=O)CC=CCO)(O)=O,,,5,1,1,0,1
53182_0,,,,2,2,1,3
53183_0,,,,2,2,1,3
53184_0,,,,2,2,1,3
53185_0,,,,2,2,1,3
53186_0,,,,2,2,1,3
53187_0,,,,2,2,1,3
53188_0,,,,2,2,1,3
53189_0,,,,2,2,1,3
53190_0,,,,2,2,1,3
53192_0,,,,2,2,1,3
C(C(CC(C=C)CO)CCO)(O)=O,,,5,1,1,0,1
53194_0,,,,2,2,1,3
C(C(C)C(CO)C(C=C)CO)(O)=O,,,5,1,1,0,1
53196_0,,,,2,2,1,3
C(CC(C)C(C=C)CO)(O)=O,,,5,1,1,0,1
53198_0,,,,2,2,1,3
C(C(C=O)CC(C=C)CO)(O)=O,,,5,1,1,0,1
53200_0,,,,2,2,1,3
C(CC(CC(C)O)C(C=C)CO)=O,,,5,1,1,0,1
53202_0,,,,2,2,1,3
C(C(CC(C=C)CO)C(C)O)=O,,,5,1,1,0,1
53204_0,,,,2,2,1,3
C(C(CO)C(C)C(C=C)CO)=O,,,5,1,1,0,1
53206_0,,,,2,2,1,3
C(C(C(C)C(C=C)CO)C(C)O)=O,,,5,1,1,0,1
53208_0,,,,2,2,1,3
C(C(C=O)C(C)C(C=C)CO)(O)=O,,,5,1,1,0,1
53210_0,,,,2,2,1,3
C(CC(CC=O)C(C=C)CO)(O)=O,,,5,1,2,0,2
53211_0,,,,2,2,1,3
53213_0,,,,2,2,1,3
C(CC(C=O)C(C=C)CO)(CO)=O,,,5,1,1,0,1
53215_0,,,,2,2,1,3
C(CC(C(CO)=O)C(C=C)CO)=O,,,5,1,1,0,1
53217_0,,,,2,2,1,3
C(C(CO)C(C=O)C(C=C)CO)=O,,,5,1,1,0,1
53219_0,,,,2,2,1,3
C(C(CO)(CC=O)C(C=C)CO)=O,,,5,1,1,0,1
53221_0,,,,2,2,1,3
C(C(C)C(C(C=O)=O)C(C=C)CO)=O,,,5,1,1,0,1
53223_0,,,,2,2,1,3
C(C(C)(CC(C=O)=O)C(C=C)CO)=O,,,5,1,1,0,1
53225_0,,,,2,2,1,3
C(C(CC(C=C)CO)CC(C=O)=O)=O,,,5,1,1,0,1
53227_0,,,,2,2,1,3
C(C(C)C(C=O)C(C=C)CO)=O,,,5,1,1,0,1
53229_0,,,,2,2,1,3
C(C(C)(CC=O)C(C=C)CO)=O,,,5,1,1,0,1
53231_0,,,,2,2,1,3
C(C(CC(C=C)CO)CC=O)=O,,,5,1,1,0,1
53233_0,,,,2,2,1,3
C(CC(C(C=O)=O)C(C=C)CO)(C)=O,,,5,1,1,0,1
53235_0,,,,2,2,1,3
C(C(CC(C=O)=O)C(C=C)CO)(C)=O,,,5,1,1,0,1
53237_0,,,,2,2,1,3
C(CC(C=O)C(C=C)CO)(C)=O,,,5,1,1,0,1
53239_0,,,,2,2,1,3
C(CC(C(C)=O)C(C=C)CO)=O,,,5,1,1,0,1
53241_0,,,,2,2,1,3
C(C(CCC(C=O)=O)CO)=C,,,5,1,1,0,1
53243_0,,,,2,2,1,3
C(C(CO)C(C)CC(C=O)=O)=C,,,5,1,1,0,1
53245_0,,,,2,2,1,3
C(CCC(C=C)CO)=O,,,5,1,1,0,1
53247_0,,,,2,2,1,3
C(C(CCC(C(O)=O)=O)CO)=C,,,5,1,1,0,1
53249_0,,,,2,2,1,3
C(C(CC(C=C)CO)CO)(O)=O,,,5,1,1,0,1
53251_0,,,,2,2,1,3
C(C(C(C)=O)CC(C=C)CO)(O)=O,,,5,1,1,0,1
53253_0,,,,2,2,1,3
C(C(C=C)CC(C=C)CO)(O)=O,,,5,1,1,0,1
53255_0,,,,2,2,1,3
C1(C(CC(C=C)CO)CC(O)O1)=O,,,5,1,1,0,1
53257_0,,,,2,2,1,3
C1(C(C)C(C(O)O1)C(C=C)CO)=O,,,5,1,1,0,1
53259_0,,,,2,2,1,3
C=CC(CO)C([CH]C(O)=O)C(C)O,,,5,1,1,0,1
53261_0,,,,2,2,1,3
C(C([CH]C(O)=O)C(C=C)CO)(O)=O,,,5,1,1,0,1
53263_0,,,,2,2,1,3
C(C[C](C(O)=O)C(C=C)CO)(O)=O,,,5,1,1,0,1
53265_0,,,,2,2,1,3
C(CC(C(C)O)C(C=C)CO)(O)=O,,,5,1,1,0,1
53267_0,,,,2,2,1,3
C(CC(C(O)=O)C(C=C)CO)(O)=O,,,5,1,1,0,1
53268_0,,,,2,2,1,3
53269_0,,,,2,2,1,3
53270_0,,,,2,2,1,3
53271_0,,,,2,2,1,3
53272_0,,,,2,2,1,3
53273_0,,,,2,2,1,3
53274_0,,,,2,2,1,3
53275_0,,,,2,2,1,3
53276_0,,,,2,2,1,3
53278_0,,,,2,2,1,3
C(C(CC(CC=C)O)CCO)(O)=O,,,5,1,1,0,1
53280_0,,,,2,2,1,3
C(C(C)C(CO)C(CC=C)O)(O)=O,,,5,1,1,0,1
53282_0,,,,2,2,1,3
C(CC(C)C(CC=C)O)(O)=O,,,5,1,1,0,1
53284_0,,,,2,2,1,3
C(C(C=O)CC(CC=C)O)(O)=O,,,5,1,1,0,1
53286_0,,,,2,2,1,3
C(CC(C(CC=C)O)CC(C)O)=O,,,5,1,1,0,1
53288_0,,,,2,2,1,3
C(C(CC(CC=C)O)C(C)O)=O,,,5,1,1,0,1
53290_0,,,,2,2,1,3
C(C(CO)C(C)C(CC=C)O)=O,,,5,1,1,0,1
53292_0,,,,2,2,1,3
C(C(C(C)O)C(C)C(CC=C)O)=O,,,5,1,1,0,1
53294_0,,,,2,2,1,3
C(C(C=O)C(C)C(CC=C)O)(O)=O,,,5,1,1,0,1
53296_0,,,,2,2,1,3
C(CC(C(CC=C)O)CC=O)(O)=O,,,5,1,2,0,2
53297_0,,,,2,2,1,3
53299_0,,,,2,2,1,3
C(C(C(CC=C)O)CC(CO)=O)=O,,,5,1,1,0,1
53301_0,,,,2,2,1,3
C(CO)(C(C(CC=C)O)CC=O)=O,,,5,1,1,0,1
53303_0,,,,2,2,1,3
C(C(C(CC=C)O)C(C=O)CO)=O,,,5,1,1,0,1
53305_0,,,,2,2,1,3
C(C(CO)(C(CC=C)O)CC=O)=O,,,5,1,1,0,1
53307_0,,,,2,2,1,3
C(C(C)C(C(C=O)=O)C(CC=C)O)=O,,,5,1,1,0,1
53309_0,,,,2,2,1,3
C(C(C)(C(CC=C)O)CC(C=O)=O)=O,,,5,1,1,0,1
53311_0,,,,2,2,1,3
C(C(CC(CC=C)O)CC(C=O)=O)=O,,,5,1,1,0,1
53313_0,,,,2,2,1,3
C(C(C)C(C=O)C(CC=C)O)=O,,,5,1,1,0,1
53315_0,,,,2,2,1,3
C(C(C)(C(CC=C)O)CC=O)=O,,,5,1,1,0,1
53317_0,,,,2,2,1,3
C(C(CC(CC=C)O)CC=O)=O,,,5,1,1,0,1
53319_0,,,,2,2,1,3
C(CC(C(C=O)=O)C(CC=C)O)(C)=O,,,5,1,1,0,1
53321_0,,,,2,2,1,3
C(C)(C(C(CC=C)O)CC(C=O)=O)=O,,,5,1,1,0,1
53323_0,,,,2,2,1,3
C(C(C(CC=C)O)CC(C)=O)=O,,,5,1,1,0,1
53325_0,,,,2,2,1,3
C(C)(C(C(CC=C)O)CC=O)=O,,,5,1,1,0,1
53327_0,,,,2,2,1,3
C=CCC(CCC(C=O)=O)O,,,5,1,1,0,1
53329_0,,,,2,2,1,3
C=CCC(C(C)CC(C=O)=O)O,,,5,1,1,0,1
53331_0,,,,2,2,1,3
C(CCC(CC=C)O)=O,,,5,1,1,0,1
53333_0,,,,2,2,1,3
C=CCC(CCC(C(O)=O)=O)O,,,5,1,1,0,1
53335_0,,,,2,2,1,3
C(C(CO)CC(CC=C)O)(O)=O,,,5,1,1,0,1
53337_0,,,,2,2,1,3
C(C(C(C)=O)CC(CC=C)O)(O)=O,,,5,1,1,0,1
53339_0,,,,2,2,1,3
C(C(C=C)CC(CC=C)O)(O)=O,,,5,1,1,0,1
53341_0,,,,2,2,1,3
C1(C(CC(CC=C)O)CC(O)O1)=O,,,5,1,1,0,1
53343_0,,,,2,2,1,3
C1(C(C)C(C(O)O1)C(CC=C)O)=O,,,5,1,1,0,1
53345_0,,,,2,2,1,3
C=CCC(C([CH]C(O)=O)C(C)O)O,,,5,1,1,0,1
53347_0,,,,2,2,1,3
C(C([CH]C(O)=O)C(CC=C)O)(O)=O,,,5,1,1,0,1
53349_0,,,,2,2,1,3
C(C[C](C(O)=O)C(CC=C)O)(O)=O,,,5,1,1,0,1
53351_0,,,,2,2,1,3
C(CC(C(CC=C)O)C(C)O)(O)=O,,,5,1,1,0,1
53353_0,,,,2,2,1,3
C(C(C(CC=C)O)CC(O)=O)(O)=O,,,5,1,1,0,1
53354_0,,,,2,2,1,3
53355_0,,,,2,2,1,3
53356_0,,,,2,2,1,3
53358_0,,,,2,2,1,3
C=CCC(C(C)CC(C(O)=O)=O)O,,,5,1,1,0,1
53360_0,,,,2,2,1,3
C(C(CC(CC=C)O)CC=O)(O)=O,,,5,1,1,0,1
53362_0,,,,2,2,1,3
C(C(C)(C(CC=C)O)CC=O)(O)=O,,,5,1,1,0,1
53364_0,,,,2,2,1,3
C(C(C)C(C=O)C(CC=C)O)(O)=O,,,5,1,1,0,1
53366_0,,,,2,2,1,3
C(C(CC(CC=C)O)C(C)O)(O)=O,,,5,1,1,0,1
53368_0,,,,2,2,1,3
C(C(C(O)=O)CC(CC=C)O)(O)=O,,,5,1,1,0,1
53370_0,,,,2,2,1,3
C(CCC(C(C(O)=O)=C)CO)=O,,,5,1,1,0,1
53371_0,,,,2,2,1,3
53372_0,,,,2,2,1,3
53373_0,,,,2,2,1,3
53375_0,,,,2,2,1,3
C(CCC(CC(C(O)=O)=C)O)=O,,,5,1,1,0,1
53377_0,,,,2,2,1,3
C=C(C(O)=O)CC(C[CH]C(O)=O)O,,,5,1,1,0,1
53379_0,,,,2,2,1,3
C(CCC(CC(C(O)=O)=C)O)(O)=O,,,5,1,1,0,1
53381_0,,,,2,2,1,3
C(CC(C)C(CC(C(O)=O)=C)O)=O,,,5,1,1,0,1
53383_0,,,,2,2,1,3
C(C(CCO)CCC(CO)O)(O)=O,,,5,1,1,0,1
53385_0,,,,2,2,1,3
C(C(CCO)CC(C)(CO)O)(O)=O,,,5,1,1,0,1
53387_0,,,,2,2,1,3
C(C(CCO)CC(C(C)O)O)(O)=O,,,5,1,1,0,1
53388_0,,,,2,2,1,3
53390_0,,,,2,2,1,3
C(C(C=O)CC(C(O)=O)CCO)=O,,,5,1,1,0,1
53392_0,,,,2,2,1,3
C(C(CCO)CCC(C=C)O)(O)=O,,,5,1,1,0,1
53394_0,,,,2,2,1,3
C(C(CC(C=C)(C)O)CCO)(O)=O,,,5,1,1,0,1
53396_0,,,,2,2,1,3
C(C(CCO)C[CH]C(O)=O)(O)=O,,,5,1,3,0,3
53398_0,,,,2,2,1,3
C(C(CC(C=O)(O)O)CCO)(O)=O,,,5,1,1,0,1
53399_0,,,,2,2,1,3
53400_0,,,,2,2,1,3
53401_0,,,,2,2,1,3
53402_0,,,,2,2,1,3
53403_0,,,,2,2,1,3
53404_0,,,,2,2,1,3
53405_0,,,,2,2,1,3
53406_0,,,,2,2,1,3
53407_0,,,,2,2,1,3
53408_0,,,,2,2,1,3
53409_0,,,,2,2,1,3
53410_0,,,,2,2,1,3
53411_0,,,,2,2,1,3
53412_0,,,,2,2,1,3
53413_0,,,,2,2,1,3
53414_0,,,,2,2,1,3
53415_0,,,,2,2,1,3
53417_0,,,,2,2,1,3
C(CCCC(C(O)=O)=CCO)=O,,,5,1,1,0,1
53418_0,,,,2,2,1,3
53419_0,,,,2,2,1,3
53420_0,,,,2,2,1,3
53422_0,,,,2,2,1,3
C(CCC(C=C(C(O)=O)C)O)=O,,,5,1,1,0,1
53424_0,,,,2,2,1,3
C(C(C[CH]C(O)=O)O)=C(C(O)=O)C,,,5,1,1,0,1
53426_0,,,,2,2,1,3
C(CCC(C=C(C(O)=O)C)O)(O)=O,,,5,1,1,0,1
53428_0,,,,2,2,1,3
C(CC(C)C(C=C(C(O)=O)C)O)=O,,,5,1,1,0,1
53430_0,,,,2,2,1,3
C(C(C)C(CO)CC(CO)O)(O)=O,,,5,1,1,0,1
53432_0,,,,2,2,1,3
C(C(C)C(CO)C(C)(CO)O)(O)=O,,,5,1,1,0,1
53434_0,,,,2,2,1,3
C(C(C)C(CO)C(C(C)O)O)(O)=O,,,5,1,1,0,1
53435_0,,,,2,2,1,3
53437_0,,,,2,2,1,3
C(C(C=O)C(CO)C(C(O)=O)C)=O,,,5,1,1,0,1
53439_0,,,,2,2,1,3
C(C(C)C(CO)CC(C=C)O)(O)=O,,,5,1,1,0,1
53441_0,,,,2,2,1,3
C(C(C)C(CO)C(C=C)(C)O)(O)=O,,,5,1,1,0,1
53443_0,,,,2,2,1,3
C(C(C)C([CH]C(O)=O)CO)(O)=O,,,5,1,2,0,2
53445_0,,,,2,2,1,3
C(C(C)C(CO)C(C=O)(O)O)(O)=O,,,5,1,1,0,1
53446_0,,,,2,2,1,3
53447_0,,,,2,2,1,3
53448_0,,,,2,2,1,3
53449_0,,,,2,2,1,3
53450_0,,,,2,2,1,3
53451_0,,,,2,2,1,3
53452_0,,,,2,2,1,3
53453_0,,,,2,2,1,3
53454_0,,,,2,2,1,3
53455_0,,,,2,2,1,3
53456_0,,,,2,2,1,3
53457_0,,,,2,2,1,3
53458_0,,,,2,2,1,3
53459_0,,,,2,2,1,3
53460_0,,,,2,2,1,3
53461_0,,,,2,2,1,3
53462_0,,,,2,2,1,3
53464_0,,,,2,2,1,3
C(CC(C)C(C(CO)O)O)(O)=O,,,5,1,1,0,1
53466_0,,,,2,2,1,3
C(C(C=O)CC(C(CO)O)O)(O)=O,,,5,1,1,0,1
53468_0,,,,2,2,1,3
C(C(CC(C(CO)O)O)C(C)O)=O,,,5,1,1,0,1
53470_0,,,,2,2,1,3
C(C(CO)C(C)C(C(CO)O)O)=O,,,5,1,1,0,1
53472_0,,,,2,2,1,3
C(C(C(C(CO)O)O)C(C=O)C)=O,,,5,1,1,0,1
53474_0,,,,2,2,1,3
C(C(C)(C(C(CO)O)O)CC=O)=O,,,5,1,1,0,1
53476_0,,,,2,2,1,3
C(C(CC(C(CO)O)O)CC=O)=O,,,5,1,1,0,1
53478_0,,,,2,2,1,3
C(C(C(C(CO)O)O)CC(C)=O)=O,,,5,1,1,0,1
53480_0,,,,2,2,1,3
C(C)(C(C(C(CO)O)O)CC=O)=O,,,5,1,1,0,1
53482_0,,,,2,2,1,3
C(C(CCC(C(CO)O)O)=O)=O,,,5,1,1,0,1
53484_0,,,,2,2,1,3
C(C(CC(C)C(C(CO)O)O)=O)=O,,,5,1,1,0,1
53486_0,,,,2,2,1,3
C(CCC(C(CO)O)O)=O,,,5,1,1,0,1
53488_0,,,,2,2,1,3
C(C(CCC(C(CO)O)O)=O)(O)=O,,,5,1,1,0,1
53490_0,,,,2,2,1,3
C(C(CO)CC(C(CO)O)O)(O)=O,,,5,1,1,0,1
53492_0,,,,2,2,1,3
C(C(C=C)CC(C(CO)O)O)(O)=O,,,5,1,1,0,1
53493_0,,,,2,2,1,3
53494_0,,,,2,2,1,3
53495_0,,,,2,2,1,3
53497_0,,,,2,2,1,3
C(CC(C)C(CO)(CO)O)(O)=O,,,5,1,1,0,1
53499_0,,,,2,2,1,3
C(C(C=O)CC(CO)(CO)O)(O)=O,,,5,1,1,0,1
53501_0,,,,2,2,1,3
C(C(CC(CO)(CO)O)C(C)O)=O,,,5,1,1,0,1
53503_0,,,,2,2,1,3
C(C(CO)C(C)C(CO)(CO)O)=O,,,5,1,1,0,1
53505_0,,,,2,2,1,3
C(C(C(CO)(CO)O)C(C=O)C)=O,,,5,1,1,0,1
53507_0,,,,2,2,1,3
C(C(C)(C(CO)(CO)O)CC=O)=O,,,5,1,1,0,1
53509_0,,,,2,2,1,3
C(C(CC(CO)(CO)O)CC=O)=O,,,5,1,1,0,1
53511_0,,,,2,2,1,3
C(C(C(CO)(CO)O)CC(C)=O)=O,,,5,1,1,0,1
53513_0,,,,2,2,1,3
C(C)(C(C(CO)(CO)O)CC=O)=O,,,5,1,1,0,1
53515_0,,,,2,2,1,3
C(C(CCC(CO)(CO)O)=O)=O,,,5,1,1,0,1
53517_0,,,,2,2,1,3
C(C(CC(C)C(CO)(CO)O)=O)=O,,,5,1,1,0,1
53519_0,,,,2,2,1,3
C(CCC(CO)(CO)O)=O,,,5,1,1,0,1
53521_0,,,,2,2,1,3
C(C(CCC(CO)(CO)O)=O)(O)=O,,,5,1,1,0,1
53523_0,,,,2,2,1,3
C(C(CO)CC(CO)(CO)O)(O)=O,,,5,1,1,0,1
53525_0,,,,2,2,1,3
C(C(C=C)CC(CO)(CO)O)(O)=O,,,5,1,1,0,1
53526_0,,,,2,2,1,3
53527_0,,,,2,2,1,3
53528_0,,,,2,2,1,3
53530_0,,,,2,2,1,3
C(CCC(CO)C[CH]C(O)=O)=O,,,5,1,1,0,1
53531_0,,,,2,2,1,3
53532_0,,,,2,2,1,3
53533_0,,,,2,2,1,3
53535_0,,,,2,2,1,3
C(CCC(CC[CH]C(O)=O)O)=O,,,5,1,1,0,1
53537_0,,,,2,2,1,3
[CH](C(O)=O)CCC(C[CH]C(O)=O)O,,,5,1,2,0,2
53539_0,,,,2,2,1,3
C(CCC(CC[CH]C(O)=O)O)(O)=O,,,5,1,2,0,2
53541_0,,,,2,2,1,3
C(CC(C)C(CC[CH]C(O)=O)O)=O,,,5,1,2,0,2
53543_0,,,,2,2,1,3
C(CCC([CH]C(O)=O)CCO)=O,,,5,1,1,0,1
53544_0,,,,2,2,1,3
53545_0,,,,2,2,1,3
53546_0,,,,2,2,1,3
53548_0,,,,2,2,1,3
C(CC[C](C(O)=O)CCCO)=O,,,5,1,1,0,1
53549_0,,,,2,2,1,3
53550_0,,,,2,2,1,3
53551_0,,,,2,2,1,3
53553_0,,,,2,2,1,3
C(CCC(CCC=O)CO)(O)=O,,,5,1,1,0,1
53554_0,,,,2,2,1,3
53555_0,,,,2,2,1,3
53556_0,,,,2,2,1,3
53558_0,,,,2,2,1,3
C(CCCC(CCC=O)O)(O)=O,,,5,1,1,0,1
53560_0,,,,2,2,1,3
C(CCCC(C[CH]C(O)=O)O)(O)=O,,,5,1,2,0,2
53562_0,,,,2,2,1,3
C(CCC(CCCC(O)=O)O)(O)=O,,,5,1,2,0,2
53564_0,,,,2,2,1,3
C(CCCC(C(C)CC=O)O)(O)=O,,,5,1,2,0,2
53566_0,,,,2,2,1,3
C(CC(CCC=O)CCO)(O)=O,,,5,1,1,0,1
53567_0,,,,2,2,1,3
53568_0,,,,2,2,1,3
53569_0,,,,2,2,1,3
53571_0,,,,2,2,1,3
C(C(CCC=O)CCCO)(O)=O,,,5,1,1,0,1
53572_0,,,,2,2,1,3
53573_0,,,,2,2,1,3
53574_0,,,,2,2,1,3
53576_0,,,,2,2,1,3
C(CC(C)CC(CO)O)(O)=O,,,5,1,1,0,1
53578_0,,,,2,2,1,3
C(C(C=O)CCC(CO)O)(O)=O,,,5,1,1,0,1
53580_0,,,,2,2,1,3
C(CC(CC(C)O)CC(CO)O)=O,,,5,1,1,0,1
53582_0,,,,2,2,1,3
C(C(CCC(CO)O)C(C)O)=O,,,5,1,1,0,1
53584_0,,,,2,2,1,3
C(C(CO)C(C)CC(CO)O)=O,,,5,1,1,0,1
53586_0,,,,2,2,1,3
C(C(C(C)O)C(C)CC(CO)O)=O,,,5,1,1,0,1
53588_0,,,,2,2,1,3
C(C(C=O)C(C)CC(CO)O)(O)=O,,,5,1,1,0,1
53590_0,,,,2,2,1,3
C(CC(CC(CO)O)CC=O)(O)=O,,,5,1,2,0,2
53591_0,,,,2,2,1,3
53593_0,,,,2,2,1,3
C(C(CC(CO)O)CC(CO)=O)=O,,,5,1,1,0,1
53595_0,,,,2,2,1,3
C(CO)(C(CC(CO)O)CC=O)=O,,,5,1,1,0,1
53597_0,,,,2,2,1,3
C(C(CC(CO)O)C(C=O)CO)=O,,,5,1,1,0,1
53599_0,,,,2,2,1,3
C(C(CO)(CC(CO)O)CC=O)=O,,,5,1,1,0,1
53601_0,,,,2,2,1,3
C(C(CC(CO)O)C(C=O)C)=O,,,5,1,1,0,1
53603_0,,,,2,2,1,3
C(C(C)(CC(CO)O)CC=O)=O,,,5,1,1,0,1
53605_0,,,,2,2,1,3
C(C(CCC(CO)O)CC=O)=O,,,5,1,1,0,1
53607_0,,,,2,2,1,3
C(C(CC(CO)O)CC(C)=O)=O,,,5,1,1,0,1
53609_0,,,,2,2,1,3
C(C)(C(CC(CO)O)CC=O)=O,,,5,1,1,0,1
53611_0,,,,2,2,1,3
C(C(CCCC(CO)O)=O)=O,,,5,1,1,0,1
53613_0,,,,2,2,1,3
C(C(CC(C)CC(CO)O)=O)=O,,,5,1,1,0,1
53615_0,,,,2,2,1,3
C(CCCC(CO)O)=O,,,5,1,1,0,1
53617_0,,,,2,2,1,3
C(C(CCCC(CO)O)=O)(O)=O,,,5,1,1,0,1
53619_0,,,,2,2,1,3
C(C(CO)CCC(CO)O)(O)=O,,,5,1,1,0,1
53621_0,,,,2,2,1,3
C(C(C(C)=O)CCC(CO)O)(O)=O,,,5,1,1,0,1
53623_0,,,,2,2,1,3
C(C(C=C)CCC(CO)O)(O)=O,,,5,1,1,0,1
53625_0,,,,2,2,1,3
C1(C(CC(O)O1)CCC(CO)O)=O,,,5,1,1,0,1
53627_0,,,,2,2,1,3
C1(C(C)C(C(O)O1)CC(CO)O)=O,,,5,1,1,0,1
53629_0,,,,2,2,1,3
[CH](C(O)=O)C(CC(CO)O)C(C)O,,,5,1,1,0,1
53631_0,,,,2,2,1,3
C(C([CH]C(O)=O)CC(CO)O)(O)=O,,,5,1,1,0,1
53633_0,,,,2,2,1,3
C(C[C](C(O)=O)CC(CO)O)(O)=O,,,5,1,1,0,1
53635_0,,,,2,2,1,3
C(CC(CC(CO)O)C(C)O)(O)=O,,,5,1,1,0,1
53636_0,,,,2,2,1,3
53637_0,,,,2,2,1,3
53638_0,,,,2,2,1,3
53639_0,,,,2,2,1,3
53640_0,,,,2,2,1,3
53641_0,,,,2,2,1,3
53642_0,,,,2,2,1,3
53643_0,,,,2,2,1,3
53644_0,,,,2,2,1,3
53645_0,,,,2,2,1,3
53647_0,,,,2,2,1,3
C(CC(C)C(C)(CO)O)(O)=O,,,5,1,1,0,1
53649_0,,,,2,2,1,3
C(C(C=O)CC(C)(CO)O)(O)=O,,,5,1,1,0,1
53651_0,,,,2,2,1,3
C(CC(CC(C)O)C(C)(CO)O)=O,,,5,1,1,0,1
53653_0,,,,2,2,1,3
C(C(CC(C)(CO)O)C(C)O)=O,,,5,1,1,0,1
53655_0,,,,2,2,1,3
C(C(CO)C(C)C(C)(CO)O)=O,,,5,1,1,0,1
53657_0,,,,2,2,1,3
C(C(C(C)O)C(C)C(C)(CO)O)=O,,,5,1,1,0,1
53659_0,,,,2,2,1,3
C(C(C=O)C(C)C(C)(CO)O)(O)=O,,,5,1,1,0,1
53661_0,,,,2,2,1,3
C(CC(C(C)(CO)O)CC=O)(O)=O,,,5,1,2,0,2
53662_0,,,,2,2,1,3
53664_0,,,,2,2,1,3
C(C(C(CO)(C)O)CC(CO)=O)=O,,,5,1,1,0,1
53666_0,,,,2,2,1,3
C(CO)(C(C(CO)(C)O)CC=O)=O,,,5,1,1,0,1
53668_0,,,,2,2,1,3
C(C(C(C)(CO)O)C(C=O)CO)=O,,,5,1,1,0,1
53670_0,,,,2,2,1,3
C(C(CO)(C(C)(CO)O)CC=O)=O,,,5,1,1,0,1
53672_0,,,,2,2,1,3
C(C(C(C)(CO)O)C(C=O)C)=O,,,5,1,1,0,1
53674_0,,,,2,2,1,3
C(C(C)(C(C)(CO)O)CC=O)=O,,,5,1,1,0,1
53676_0,,,,2,2,1,3
C(C(CC(C)(CO)O)CC=O)=O,,,5,1,1,0,1
53678_0,,,,2,2,1,3
C(C(C(C)(CO)O)CC(C)=O)=O,,,5,1,1,0,1
53680_0,,,,2,2,1,3
C(C)(C(C(C)(CO)O)CC=O)=O,,,5,1,1,0,1
53682_0,,,,2,2,1,3
C(C(CCC(C)(CO)O)=O)=O,,,5,1,1,0,1
53684_0,,,,2,2,1,3
C(C(CC(C)C(C)(CO)O)=O)=O,,,5,1,1,0,1
53686_0,,,,2,2,1,3
C(CCC(C)(CO)O)=O,,,5,1,1,0,1
53688_0,,,,2,2,1,3
C(C(CCC(C)(CO)O)=O)(O)=O,,,5,1,1,0,1
53690_0,,,,2,2,1,3
C(C(CO)CC(C)(CO)O)(O)=O,,,5,1,1,0,1
53692_0,,,,2,2,1,3
C(C(C(C)=O)CC(C)(CO)O)(O)=O,,,5,1,1,0,1
53694_0,,,,2,2,1,3
C(C(C=C)CC(C)(CO)O)(O)=O,,,5,1,1,0,1
53696_0,,,,2,2,1,3
C1(C(CC(O)O1)CC(C)(CO)O)=O,,,5,1,1,0,1
53698_0,,,,2,2,1,3
C1(C(C)C(C(O)O1)C(C)(CO)O)=O,,,5,1,1,0,1
53700_0,,,,2,2,1,3
[CH](C(O)=O)C(C(C)O)C(C)(CO)O,,,5,1,1,0,1
53702_0,,,,2,2,1,3
C(C([CH]C(O)=O)C(C)(CO)O)(O)=O,,,5,1,1,0,1
53704_0,,,,2,2,1,3
C(C[C](C(O)=O)C(CO)(C)O)(O)=O,,,5,1,1,0,1
53706_0,,,,2,2,1,3
C(CC(C(C)O)C(C)(CO)O)(O)=O,,,5,1,1,0,1
53708_0,,,,2,2,1,3
C(C(C(C)(CO)O)CC(O)=O)(O)=O,,,5,1,1,0,1
53709_0,,,,2,2,1,3
53710_0,,,,2,2,1,3
53711_0,,,,2,2,1,3
53712_0,,,,2,2,1,3
53713_0,,,,2,2,1,3
53714_0,,,,2,2,1,3
53715_0,,,,2,2,1,3
53716_0,,,,2,2,1,3
53717_0,,,,2,2,1,3
53719_0,,,,2,2,1,3
C(CC(C)C(C(C)O)O)(O)=O,,,5,1,1,0,1
53720_0,,,,2,2,1,3
53722_0,,,,2,2,1,3
C(CC(CC(C)O)C(C(C)O)O)=O,,,5,1,1,0,1
53723_0,,,,2,2,1,3
53725_0,,,,2,2,1,3
C(C(CO)C(C)C(C(C)O)O)=O,,,5,1,1,0,1
53727_0,,,,2,2,1,3
C(C(C(C)O)C(C)C(C(C)O)O)=O,,,5,1,1,0,1
53729_0,,,,2,2,1,3
C(C(C=O)C(C)C(C(C)O)O)(O)=O,,,5,1,1,0,1
53731_0,,,,2,2,1,3
C(CC(C(C(C)O)O)CC=O)(O)=O,,,5,1,2,0,2
53732_0,,,,2,2,1,3
53734_0,,,,2,2,1,3
C(C(C(C(C)O)O)CC(CO)=O)=O,,,5,1,1,0,1
53736_0,,,,2,2,1,3
C(CO)(C(C(C(C)O)O)CC=O)=O,,,5,1,1,0,1
53738_0,,,,2,2,1,3
C(C(C(C(C)O)O)C(C=O)CO)=O,,,5,1,1,0,1
53740_0,,,,2,2,1,3
C(C(CO)(C(C(C)O)O)CC=O)=O,,,5,1,1,0,1
53742_0,,,,2,2,1,3
C(C(C(C(C)O)O)C(C=O)C)=O,,,5,1,1,0,1
53744_0,,,,2,2,1,3
C(C(C)(C(C(C)O)O)CC=O)=O,,,5,1,1,0,1
53746_0,,,,2,2,1,3
C(C(CC(C(C)O)O)CC=O)=O,,,5,1,1,0,1
53748_0,,,,2,2,1,3
C(C(C(C(C)O)O)CC(C)=O)=O,,,5,1,1,0,1
53750_0,,,,2,2,1,3
C(C)(C(C(C(C)O)O)CC=O)=O,,,5,1,1,0,1
53751_0,,,,2,2,1,3
53753_0,,,,2,2,1,3
C(C(CC(C)C(C(C)O)O)=O)=O,,,5,1,1,0,1
53754_0,,,,2,2,1,3
53755_0,,,,2,2,1,3
53757_0,,,,2,2,1,3
C(C(CO)CC(C(C)O)O)(O)=O,,,5,1,1,0,1
53759_0,,,,2,2,1,3
C(C(C(C)=O)CC(C(C)O)O)(O)=O,,,5,1,1,0,1
53761_0,,,,2,2,1,3
C(C(C=C)CC(C(C)O)O)(O)=O,,,5,1,1,0,1
53763_0,,,,2,2,1,3
C1(C(CC(O)O1)CC(C(C)O)O)=O,,,5,1,1,0,1
53765_0,,,,2,2,1,3
C1(C(C)C(C(O)O1)C(C(C)O)O)=O,,,5,1,1,0,1
53767_0,,,,2,2,1,3
[CH](C(O)=O)C(C(C)O)C(C(C)O)O,,,5,1,1,0,1
53769_0,,,,2,2,1,3
C(C([CH]C(O)=O)C(C(C)O)O)(O)=O,,,5,1,1,0,1
53771_0,,,,2,2,1,3
C(C[C](C(O)=O)C(C(C)O)O)(O)=O,,,5,1,1,0,1
53773_0,,,,2,2,1,3
C(CC(C(C(C)O)O)C(C)O)(O)=O,,,5,1,1,0,1
53775_0,,,,2,2,1,3
C(C(C(C(C)O)O)CC(O)=O)(O)=O,,,5,1,1,0,1
53777_0,,,,2,2,1,3
[CH](C(O)=O)CC(C(C)O)O,,,5,1,1,0,1
53779_0,,,,2,2,1,3
C(CCC(C(C)O)O)(O)=O,,,5,1,1,0,1
53781_0,,,,2,2,1,3
C(CC(C)C(C(C)O)O)=O,,,5,1,1,0,1
53783_0,,,,2,2,1,3
C(C(CC(C)C(C(C)O)O)=O)(O)=O,,,5,1,1,0,1
53785_0,,,,2,2,1,3
C(C(CC(C(C)O)O)CC=O)(O)=O,,,5,1,1,0,1
53787_0,,,,2,2,1,3
C(C(C)(C(C(C)O)O)CC=O)(O)=O,,,5,1,1,0,1
53789_0,,,,2,2,1,3
C(C(C)C(C=O)C(C(C)O)O)(O)=O,,,5,1,1,0,1
53791_0,,,,2,2,1,3
C(C(CC(C(C)O)O)C(C)O)(O)=O,,,5,1,1,0,1
53793_0,,,,2,2,1,3
C(C(C(O)=O)CC(C(C)O)O)(O)=O,,,5,1,1,0,1
53795_0,,,,2,2,1,3
C(C(CCC=O)C(C=O)(C)O)(O)=O,,,5,1,2,0,2
53797_0,,,,2,2,1,3
C(CCCC(C=O)(CC(O)=O)O)=O,,,5,1,1,0,1
53799_0,,,,2,2,1,3
C(C(CCC=O)C(C(C)=O)O)(O)=O,,,5,1,2,0,2
53801_0,,,,2,2,1,3
C(CC(C(CCCC=O)=O)O)(O)=O,,,5,1,1,0,1
53803_0,,,,2,2,1,3
C(C)(C(CCC=O)(CC(O)=O)O)=O,,,5,1,1,0,1
53805_0,,,,2,2,1,3
C(CC(C)CC=CC(O)=O)(O)=O,,,5,1,1,0,1
53807_0,,,,2,2,1,3
C(C(C(O)=O)CCC=CC(O)=O)=O,,,5,1,1,0,1
53809_0,,,,2,2,1,3
C(C(CCC=CC(O)=O)C(C)O)=O,,,5,1,1,0,1
53811_0,,,,2,2,1,3
C(C(CO)C(C)CC=CC(O)=O)=O,,,5,1,1,0,1
53813_0,,,,2,2,1,3
C(C(C)C(C=O)CC=CC(O)=O)=O,,,5,1,1,0,1
53815_0,,,,2,2,1,3
C(C(C)(CC=O)CC=CC(O)=O)=O,,,5,1,1,0,1
53817_0,,,,2,2,1,3
C(C(CCC=CC(O)=O)CC=O)=O,,,5,1,1,0,1
53819_0,,,,2,2,1,3
C(C(CC(C)=O)CC=CC(O)=O)=O,,,5,1,1,0,1
53821_0,,,,2,2,1,3
C(CC(C(C)=O)CC=CC(O)=O)=O,,,5,1,1,0,1
53823_0,,,,2,2,1,3
C(CCCC(C=O)=O)=CC(O)=O,,,5,1,1,0,1
53825_0,,,,2,2,1,3
C(CC(C)CC(C=O)=O)=CC(O)=O,,,5,1,1,0,1
53827_0,,,,2,2,1,3
C(CCCC=CC(O)=O)=O,,,5,1,1,0,1
53829_0,,,,2,2,1,3
C(CCCC(C(O)=O)=O)=CC(O)=O,,,5,1,1,0,1
53831_0,,,,2,2,1,3
C(C(CCC=CC(O)=O)CO)(O)=O,,,5,1,1,0,1
53833_0,,,,2,2,1,3
C(C(C=C)CCC=CC(O)=O)(O)=O,,,5,1,1,0,1
53834_0,,,,2,2,1,3
53835_0,,,,2,2,1,3
53836_0,,,,2,2,1,3
53838_0,,,,2,2,1,3
C(C(C=C)C(C)CC(O)=O)(O)=O,,,5,1,1,0,1
53840_0,,,,2,2,1,3
C(C(C)(C(C(C)CC(O)=O)O)O)=O,,,5,1,1,0,1
53842_0,,,,2,2,1,3
C(C(CO)(CC(C)CC(O)=O)O)=O,,,5,1,1,0,1
53844_0,,,,2,2,1,3
C(C(C=C)(C(C)CC(O)=O)O)(O)=O,,,5,1,1,0,1
53846_0,,,,2,2,1,3
C(CC([C](C(O)=O)O)C)(O)=O,,,5,1,1,0,1
53848_0,,,,2,2,1,3
C(C(C(C=O)=O)C(C)CC(O)=O)=O,,,5,1,1,0,1
53850_0,,,,2,2,1,3
C(C(C(O)=O)CC(C)CC(O)=O)=O,,,5,1,1,0,1
53852_0,,,,2,2,1,3
C(C(C(O)=O)(C)C(C)CC(O)=O)=O,,,5,1,1,0,1
53854_0,,,,2,2,1,3
C(CC(C)CCC(C(O)=O)=O)(O)=O,,,5,1,1,0,1
53856_0,,,,2,2,1,3
C(CC(C)C(C(C(O)=O)=O)C)(O)=O,,,5,1,1,0,1
53858_0,,,,2,2,1,3
C(CC(C)CC(C(C)O)=O)(O)=O,,,5,1,1,0,1
53860_0,,,,2,2,1,3
C(CC(C)CC(C(C)=O)O)(O)=O,,,5,1,1,0,1
53862_0,,,,2,2,1,3
C(CC(C)C(C(C)=O)(C)O)(O)=O,,,5,1,1,0,1
53864_0,,,,2,2,1,3
C(CC(C)C(C(CC)=O)O)(O)=O,,,5,1,1,0,1
53866_0,,,,2,2,1,3
C(CC(C)CCC(CO)=O)(O)=O,,,5,1,1,0,1
53868_0,,,,2,2,1,3
C(CC(C)C(C(CO)=O)C)(O)=O,,,5,1,1,0,1
53870_0,,,,2,2,1,3
C(C(C=O)C(C)CC(O)=O)=O,,,5,1,1,0,1
53872_0,,,,2,2,1,3
C(CC(C)CC(C(C=O)=C)O)(O)=O,,,5,1,1,0,1
53874_0,,,,2,2,1,3
C(CC(C)C(C(C=O)=C)(C)O)(O)=O,,,5,1,1,0,1
53876_0,,,,2,2,1,3
C(CC(C)C(C(C=O)=CC)O)(O)=O,,,5,1,1,0,1
53878_0,,,,2,2,1,3
C(CC(C)CC=C(C=O)CO)(O)=O,,,5,1,1,0,1
53880_0,,,,2,2,1,3
C(CC(C)CC(C=O)=CC=O)(O)=O,,,5,1,1,0,1
53882_0,,,,2,2,1,3
C(C(C(C=O)=C)C(C)CC(O)=O)=O,,,5,1,1,0,1
53884_0,,,,2,2,1,3
C(CC(C)CC(C=CC=O)=O)(O)=O,,,5,1,1,0,1
53886_0,,,,2,2,1,3
C(CC(C)C(C=C)C(C=O)=O)(O)=O,,,5,1,1,0,1
53888_0,,,,2,2,1,3
C(CC(C)CC=CC(C=O)=O)(O)=O,,,5,1,1,0,1
53890_0,,,,2,2,1,3
C(CC(C)CC(C=C)O)(O)=O,,,5,1,1,0,1
53892_0,,,,2,2,1,3
C(CC(C)C(C=C)(C)O)(O)=O,,,5,1,1,0,1
53894_0,,,,2,2,1,3
C(CC(C)C(C(C(O)=O)=C)O)(O)=O,,,5,1,1,0,1
53896_0,,,,2,2,1,3
C(CC(C)C(C=C)(CO)O)(O)=O,,,5,1,1,0,1
53898_0,,,,2,2,1,3
C(CC(C)C(C(C=C)O)O)(O)=O,,,5,1,1,0,1
53900_0,,,,2,2,1,3
C(C(CC)(C(C)CC(O)=O)O)=O,,,5,1,1,0,1
53902_0,,,,2,2,1,3
C(CC(C)CCC(C=O)O)(O)=O,,,5,1,1,0,1
53904_0,,,,2,2,1,3
C(CC(C)C(C)C(C=O)O)(O)=O,,,5,1,1,0,1
53906_0,,,,2,2,1,3
C(C(CCO)C(C)CC(O)=O)=O,,,5,1,1,0,1
53908_0,,,,2,2,1,3
C(CC(C)C(CCC=O)O)(O)=O,,,5,1,1,0,1
53910_0,,,,2,2,1,3
C(CC(C)C(CO)CC=O)(O)=O,,,5,1,1,0,1
53912_0,,,,2,2,1,3
C(CC(C)C1CC(C(O)O1)=O)(O)=O,,,5,1,1,0,1
53914_0,,,,2,2,1,3
C(CC(C)C1C(C(O)OC1)=O)(O)=O,,,5,1,1,0,1
53916_0,,,,2,2,1,3
C(CC(C)C1(C(CCO1)=O)O)(O)=O,,,5,1,1,0,1
53918_0,,,,2,2,1,3
C(CC(C)C1C(C(OC1)=O)=O)(O)=O,,,5,1,1,0,1
53920_0,,,,2,2,1,3
C(CC(C)C1CC(C(O1)=O)=O)(O)=O,,,5,1,1,0,1
53922_0,,,,2,2,1,3
C(C(C(C)CC(O)=O)C(C)CO)=O,,,5,1,1,0,1
53924_0,,,,2,2,1,3
C(CC(C)CC(CO)CC=O)(O)=O,,,5,1,1,0,1
53926_0,,,,2,2,1,3
C(CC(C)C(C)(CO)CC=O)(O)=O,,,5,1,1,0,1
53928_0,,,,2,2,1,3
C(CC(C)C(C(C)CC=O)O)(O)=O,,,5,1,1,0,1
53930_0,,,,2,2,1,3
C(CC(C)C([CH]C(O)=O)CO)(O)=O,,,5,1,1,0,1
53932_0,,,,2,2,1,3
C(CC([C](C(O)=O)CCO)C)(O)=O,,,5,1,1,0,1
53934_0,,,,2,2,1,3
C(CC(C)C(C[CH]C(O)=O)O)(O)=O,,,5,1,1,0,1
53936_0,,,,2,2,1,3
C(CC(C)C(CO)CC(O)=O)(O)=O,,,5,1,1,0,1
53938_0,,,,2,2,1,3
C(C(CCO)C(C)CC(O)=O)(O)=O,,,5,1,1,0,1
53940_0,,,,2,2,1,3
C(CCC(C(C)CC(O)=O)O)(O)=O,,,5,1,1,0,1
53942_0,,,,2,2,1,3
C(CC([CH]C(O)=O)C)(O)=O,,,5,1,1,0,1
53944_0,,,,2,2,1,3
C(CC(C)C(CC(C=O)O)O)(O)=O,,,5,1,1,0,1
53946_0,,,,2,2,1,3
C(CC(C)C(CO)C(C=O)O)(O)=O,,,5,1,1,0,1
53948_0,,,,2,2,1,3
C(C(CCO)(C(C)CC(O)=O)O)=O,,,5,1,1,0,1
53950_0,,,,2,2,1,3
C(CC(C)C(C=O)(O)O)(O)=O,,,5,1,1,0,1
53951_0,,,,2,2,1,3
53952_0,,,,2,2,1,3
53953_0,,,,2,2,1,3
53954_0,,,,2,2,1,3
53955_0,,,,2,2,1,3
53956_0,,,,2,2,1,3
53957_0,,,,2,2,1,3
53958_0,,,,2,2,1,3
53959_0,,,,2,2,1,3
53960_0,,,,2,2,1,3
53961_0,,,,2,2,1,3
53962_0,,,,2,2,1,3
53963_0,,,,2,2,1,3
53964_0,,,,2,2,1,3
53965_0,,,,2,2,1,3
53966_0,,,,2,2,1,3
53967_0,,,,2,2,1,3
53968_0,,,,2,2,1,3
53969_0,,,,2,2,1,3
53970_0,,,,2,2,1,3
53971_0,,,,2,2,1,3
53972_0,,,,2,2,1,3
53973_0,,,,2,2,1,3
53974_0,,,,2,2,1,3
53975_0,,,,2,2,1,3
53976_0,,,,2,2,1,3
53977_0,,,,2,2,1,3
53978_0,,,,2,2,1,3
53979_0,,,,2,2,1,3
53980_0,,,,2,2,1,3
53981_0,,,,2,2,1,3
53982_0,,,,2,2,1,3
53983_0,,,,2,2,1,3
53984_0,,,,2,2,1,3
53985_0,,,,2,2,1,3
53986_0,,,,2,2,1,3
53987_0,,,,2,2,1,3
53988_0,,,,2,2,1,3
53989_0,,,,2,2,1,3
53990_0,,,,2,2,1,3
53991_0,,,,2,2,1,3
53992_0,,,,2,2,1,3
53993_0,,,,2,2,1,3
53994_0,,,,2,2,1,3
53995_0,,,,2,2,1,3
53996_0,,,,2,2,1,3
53997_0,,,,2,2,1,3
53998_0,,,,2,2,1,3
53999_0,,,,2,2,1,3
54000_0,,,,2,2,1,3
54001_0,,,,2,2,1,3
54002_0,,,,2,2,1,3
54003_0,,,,2,2,1,3
54005_0,,,,2,2,1,3
C(C(C(O)=O)CC(C(O)=O)C=C)=O,,,5,1,2,0,2
54007_0,,,,2,2,1,3
C(C(C=C)CC(C=O)C(C)O)(O)=O,,,5,1,2,0,2
54009_0,,,,2,2,1,3
C(C(C=C)C(C)C(C=O)CO)(O)=O,,,5,1,1,0,1
54011_0,,,,2,2,1,3
C(C(C)C(C=O)C(C(O)=O)C=C)=O,,,5,1,1,0,1
54013_0,,,,2,2,1,3
C(C(C)(CC=O)C(C(O)=O)C=C)=O,,,5,1,1,0,1
54015_0,,,,2,2,1,3
C(C(CC(C(O)=O)C=C)CC=O)=O,,,5,1,1,0,1
54017_0,,,,2,2,1,3
C(C(C=C)C(C=O)CC(C)=O)(O)=O,,,5,1,1,0,1
54019_0,,,,2,2,1,3
C(C(C=C)C(C(C)=O)CC=O)(O)=O,,,5,1,1,0,1
54020_0,,,,2,2,1,3
54022_0,,,,2,2,1,3
C(C(C=C)C(C)CC(C=O)=O)(O)=O,,,5,1,1,0,1
54023_0,,,,2,2,1,3
54025_0,,,,2,2,1,3
C(C(C=C)CCC(C(O)=O)=O)(O)=O,,,5,1,2,0,2
54027_0,,,,2,2,1,3
C(C(C=C)CC(C(O)=O)CO)(O)=O,,,5,1,2,0,2
54029_0,,,,2,2,1,3
C(C(C=C)CC(C(O)=O)C=C)(O)=O,,,5,1,1,0,1
54030_0,,,,2,2,1,3
54031_0,,,,2,2,1,3
54032_0,,,,2,2,1,3
54034_0,,,,2,2,1,3
C(CCC(C(O)=O)C(C(O)=O)=C)=O,,,5,1,2,0,2
54036_0,,,,2,2,1,3
C(CC(C(O)=O)C[CH]C(O)=O)(O)=O,,,5,1,1,0,1
54037_0,,,,2,2,1,3
54038_0,,,,2,2,1,3
54039_0,,,,2,2,1,3
54040_0,,,,2,2,1,3
54041_0,,,,2,2,1,3
54042_0,,,,2,2,1,3
54043_0,,,,2,2,1,3
54045_0,,,,2,2,1,3
C(CCCC(C(O)=O)=CC(O)=O)=O,,,5,1,1,0,1
54047_0,,,,2,2,1,3
C(C([CH]C(O)=O)(C)CC(O)=O)(O)=O,,,5,1,1,0,1
54048_0,,,,2,2,1,3
54049_0,,,,2,2,1,3
54050_0,,,,2,2,1,3
54051_0,,,,2,2,1,3
54052_0,,,,2,2,1,3
54053_0,,,,2,2,1,3
54054_0,,,,2,2,1,3
54056_0,,,,2,2,1,3
C(C([CH]C(O)=O)C(C(O)=O)C)(O)=O,,,5,1,1,0,1
54057_0,,,,2,2,1,3
54058_0,,,,2,2,1,3
54059_0,,,,2,2,1,3
54060_0,,,,2,2,1,3
54061_0,,,,2,2,1,3
54062_0,,,,2,2,1,3
54063_0,,,,2,2,1,3
54064_0,,,,2,2,1,3
54066_0,,,,2,2,1,3
C(CCC([CH]C(O)=O)CC(O)=O)=O,,,5,1,1,0,1
54067_0,,,,2,2,1,3
54068_0,,,,2,2,1,3
54070_0,,,,2,2,1,3
C(CCC(CC(O)=O)CC(O)=O)=O,,,5,1,1,0,1
54072_0,,,,2,2,1,3
C(C(C=O)(C(CCCC=O)O)O)=O,,,5,1,1,0,1
54074_0,,,,2,2,1,3
C(C(C=O)(C(C)(CCC=O)O)O)=O,,,5,1,1,0,1
54076_0,,,,2,2,1,3
C(C(CO)(C(CCCC=O)O)O)=O,,,5,1,1,0,1
54078_0,,,,2,2,1,3
C(C(CO)(C(C)(CCC=O)O)O)=O,,,5,1,1,0,1
54080_0,,,,2,2,1,3
C(C(C(C)O)(C(CCC=O)O)O)=O,,,5,1,1,0,1
54082_0,,,,2,2,1,3
C(C(CO)(C(CCC=O)O)O)=O,,,5,1,1,0,1
54083_0,,,,2,2,1,3
54084_0,,,,2,2,1,3
54085_0,,,,2,2,1,3
54087_0,,,,2,2,1,3
C(C(C(CO)O)(CCCC=O)O)=O,,,5,1,1,0,1
54089_0,,,,2,2,1,3
C(C(C)(C(C(CCC=O)O)O)O)=O,,,5,1,1,0,1
54091_0,,,,2,2,1,3
C(C(C)(C(CO)(CCC=O)O)O)=O,,,5,1,1,0,1
54093_0,,,,2,2,1,3
C(C(C)(C(CCCC=O)O)O)=O,,,5,1,1,0,1
54094_0,,,,2,2,1,3
54095_0,,,,2,2,1,3
54096_0,,,,2,2,1,3
54098_0,,,,2,2,1,3
C(C(C)(C(C)(CCC=O)O)O)=O,,,5,1,1,0,1
54099_0,,,,2,2,1,3
54100_0,,,,2,2,1,3
54102_0,,,,2,2,1,3
C(C(C)(C(C)(C(C)CC=O)O)O)=O,,,5,1,1,0,1
54104_0,,,,2,2,1,3
C(C(C(C)O)(CCCC=O)O)=O,,,5,1,1,0,1
54105_0,,,,2,2,1,3
54106_0,,,,2,2,1,3
54107_0,,,,2,2,1,3
54109_0,,,,2,2,1,3
C(C(C)(C(CCC(C=O)=O)O)O)=O,,,5,1,1,0,1
54111_0,,,,2,2,1,3
C(C(C)(C(CCC=O)O)O)=O,,,5,1,1,0,1
54112_0,,,,2,2,1,3
54113_0,,,,2,2,1,3
54115_0,,,,2,2,1,3
C(C(C)(C(C(C)CC=O)O)O)=O,,,5,1,1,0,1
54117_0,,,,2,2,1,3
C(C(CO)(CCCC(C=O)=O)O)=O,,,5,1,1,0,1
54119_0,,,,2,2,1,3
C(C(CO)(CCCC=O)O)=O,,,5,1,1,0,1
54120_0,,,,2,2,1,3
54121_0,,,,2,2,1,3
54122_0,,,,2,2,1,3
54124_0,,,,2,2,1,3
C(C(C=C)(CCC(C=O)=O)O)(O)=O,,,5,1,1,0,1
54126_0,,,,2,2,1,3
C(C(C=C)(CCC=O)O)(O)=O,,,5,1,1,0,1
54127_0,,,,2,2,1,3
54128_0,,,,2,2,1,3
54129_0,,,,2,2,1,3
54131_0,,,,2,2,1,3
C(C(CCC=O)C(C(O)=O)O)(O)=O,,,5,1,2,0,2
54133_0,,,,2,2,1,3
C(C(CCO)C(C(O)=O)O)(O)=O,,,5,1,1,0,1
54135_0,,,,2,2,1,3
C(C(CCCO)C(C(O)=O)O)(O)=O,,,5,1,1,0,1
54137_0,,,,2,2,1,3
C(C(CC(C)O)C(C(O)=O)O)(O)=O,,,5,1,1,0,1
54138_0,,,,2,2,1,3
54140_0,,,,2,2,1,3
C(C(C=O)CCC(C(C)O)=O)(O)=O,,,5,1,1,0,1
54142_0,,,,2,2,1,3
C(C(C=O)CCC(C(C)=O)O)(O)=O,,,5,1,1,0,1
54144_0,,,,2,2,1,3
C(C(C=O)CC(C(C)=O)(C)O)(O)=O,,,5,1,1,0,1
54146_0,,,,2,2,1,3
C(C(C=O)CC(C(CC)=O)O)(O)=O,,,5,1,1,0,1
54148_0,,,,2,2,1,3
C(C(C=O)CCCC(CO)=O)(O)=O,,,5,1,1,0,1
54150_0,,,,2,2,1,3
C(C(C=O)CC(C(CO)=O)C)(O)=O,,,5,1,1,0,1
54152_0,,,,2,2,1,3
C(C(C=O)CC(C=O)C(O)=O)=O,,,5,1,1,0,1
54154_0,,,,2,2,1,3
C(C(C(O)=O)CCC(C=O)=CC=O)=O,,,5,1,1,0,1
54156_0,,,,2,2,1,3
C(C(C(C=O)=C)CC(C=O)C(O)=O)=O,,,5,1,1,0,1
54158_0,,,,2,2,1,3
C(C(C(O)=O)CCC(C=CC=O)=O)=O,,,5,1,1,0,1
54160_0,,,,2,2,1,3
C(C(C(O)=O)CC(C=C)C(C=O)=O)=O,,,5,1,1,0,1
54162_0,,,,2,2,1,3
C(C(C(O)=O)CCC=CC(C=O)=O)=O,,,5,1,1,0,1
54164_0,,,,2,2,1,3
C(C(C=O)CCC(C=C)O)(O)=O,,,5,1,1,0,1
54166_0,,,,2,2,1,3
C(C(C=O)CC(C=C)(C)O)(O)=O,,,5,1,1,0,1
54168_0,,,,2,2,1,3
C(C(C=O)CC(C=C)(CO)O)(O)=O,,,5,1,1,0,1
54170_0,,,,2,2,1,3
C(C(C=O)CC(C(C=C)O)O)(O)=O,,,5,1,1,0,1
54172_0,,,,2,2,1,3
C(C(C=O)CC(C=O)(CC)O)(O)=O,,,5,1,1,0,1
54174_0,,,,2,2,1,3
C(C(C=O)CCCC(C=O)O)(O)=O,,,5,1,1,0,1
54176_0,,,,2,2,1,3
C(C(C=O)CC(C)C(C=O)O)(O)=O,,,5,1,1,0,1
54178_0,,,,2,2,1,3
C(C(C=O)CC(C=O)CCO)(O)=O,,,5,1,1,0,1
54180_0,,,,2,2,1,3
C(C(C=O)CC(CCC=O)O)(O)=O,,,5,1,1,0,1
54182_0,,,,2,2,1,3
C(C(C=O)CC(CO)CC=O)(O)=O,,,5,1,1,0,1
54183_0,,,,2,2,1,3
54185_0,,,,2,2,1,3
C(C(C=O)CC(C=O)(O)O)(O)=O,,,5,1,1,0,1
54187_0,,,,2,2,1,3
C(C(C(O)=O)CCC=O)=O,,,5,1,2,0,2
54189_0,,,,2,2,1,3
C(C(C(O)=O)CC[C](C(O)=O)O)=O,,,5,1,1,0,1
54191_0,,,,2,2,1,3
C(C(C=O)CCC(C(O)=O)O)(O)=O,,,5,1,1,0,1
54193_0,,,,2,2,1,3
C(C(C=O)CC(C(O)=O)(C)O)(O)=O,,,5,1,1,0,1
54195_0,,,,2,2,1,3
C(C(C=O)CC(C=O)C(C)O)(O)=O,,,5,1,2,0,2
54197_0,,,,2,2,1,3
C(C(C=O)CCC(CC=O)O)(O)=O,,,5,1,1,0,1
54199_0,,,,2,2,1,3
C(C(C=O)CC(C)(CC=O)O)(O)=O,,,5,1,1,0,1
54201_0,,,,2,2,1,3
C(C(C(O)=O)CC(C=O)C(O)=O)=O,,,5,1,1,0,1
54203_0,,,,2,2,1,3
C(C(C=O)CC(C(C=O)=O)O)(O)=O,,,5,1,1,0,1
54205_0,,,,2,2,1,3
C(C(C(O)=O)CCC(C=O)=O)=O,,,5,1,2,0,2
54206_0,,,,2,2,1,3
54208_0,,,,2,2,1,3
C(C(C=O)CC(CO)O)(O)=O,,,5,1,1,0,1
54210_0,,,,2,2,1,3
C(C(C=O)CC(C=O)CO)(O)=O,,,5,1,1,0,1
54211_0,,,,2,2,1,3
54213_0,,,,2,2,1,3
C(C(C=O)CC(C=O)(C=O)O)(O)=O,,,5,1,1,0,1
54215_0,,,,2,2,1,3
C(C(C=O)CC(CO)C(C)O)(O)=O,,,5,1,1,0,1
54217_0,,,,2,2,1,3
C(C(C=O)CC(CC(C)O)O)(O)=O,,,5,1,1,0,1
54219_0,,,,2,2,1,3
C(C(C=O)CCC(CCO)O)(O)=O,,,5,1,1,0,1
54221_0,,,,2,2,1,3
C(C(C=O)CC(C)(CCO)O)(O)=O,,,5,1,1,0,1
54223_0,,,,2,2,1,3
C(C(C=O)CC(C(O)=O)CO)(O)=O,,,5,1,2,0,2
54225_0,,,,2,2,1,3
C(C(C=O)CC(CC(O)=O)O)(O)=O,,,5,1,1,0,1
54227_0,,,,2,2,1,3
C(C(C=O)CC(C(CO)=O)O)(O)=O,,,5,1,1,0,1
54229_0,,,,2,2,1,3
C(C(C=O)CCC(CO)=O)(O)=O,,,5,1,1,0,1
54231_0,,,,2,2,1,3
C(C(C=O)CC(C(C)=O)O)(O)=O,,,5,1,1,0,1
54232_0,,,,2,2,1,3
54234_0,,,,2,2,1,3
C(C(C=O)CCCO)(O)=O,,,5,1,1,0,1
54235_0,,,,2,2,1,3
54236_0,,,,2,2,1,3
54238_0,,,,2,2,1,3
C(C(C(O)=O)CCC=CC=O)=O,,,5,1,1,0,1
54240_0,,,,2,2,1,3
C(C(C=C)CC(C=O)C(O)=O)=O,,,5,1,1,0,1
54241_0,,,,2,2,1,3
54243_0,,,,2,2,1,3
C(C(C=O)CC(C=O)(CO)O)(O)=O,,,5,1,1,0,1
54245_0,,,,2,2,1,3
C(C(C=O)CC([CH]C(O)=O)O)(O)=O,,,5,1,1,0,1
54247_0,,,,2,2,1,3
C(C(C=O)C[C](C(O)=O)CO)(O)=O,,,5,1,1,0,1
54248_0,,,,2,2,1,3
54250_0,,,,2,2,1,3
C(C(C=O)CCC(C=O)O)(O)=O,,,5,1,1,0,1
54252_0,,,,2,2,1,3
C(C(C=O)CC(C=O)(C)O)(O)=O,,,5,1,1,0,1
54254_0,,,,2,2,1,3
C(C(C(O)=O)CCC(C(O)=O)=O)=O,,,5,1,2,0,2
54256_0,,,,2,2,1,3
C(CC([C](C(O)=O)O)CC(C)O)=O,,,5,1,1,0,1
54258_0,,,,2,2,1,3
C(C(C(C)O)C[C](C(O)=O)O)=O,,,5,1,1,0,1
54260_0,,,,2,2,1,3
C(C(CO)C([C](C(O)=O)O)C)=O,,,5,1,1,0,1
54262_0,,,,2,2,1,3
C(C(C(C)O)C([C](C(O)=O)O)C)=O,,,5,1,1,0,1
54264_0,,,,2,2,1,3
C(C(C(O)=O)C([C](C(O)=O)O)C)=O,,,5,1,1,0,1
54266_0,,,,2,2,1,3
C(CC([C](C(O)=O)O)CC(O)=O)=O,,,5,1,2,0,2
54267_0,,,,2,2,1,3
54269_0,,,,2,2,1,3
C(C([C](C(O)=O)O)CC(CO)=O)=O,,,5,1,1,0,1
54271_0,,,,2,2,1,3
C(CC(C(CO)=O)[C](C(O)=O)O)=O,,,5,1,1,0,1
54273_0,,,,2,2,1,3
C(C([C](C(O)=O)O)C(C=O)CO)=O,,,5,1,1,0,1
54275_0,,,,2,2,1,3
C(C([C](C(O)=O)O)(CO)CC=O)=O,,,5,1,1,0,1
54277_0,,,,2,2,1,3
C(C([C](C(O)=O)O)C(C=O)C)=O,,,5,1,1,0,1
54279_0,,,,2,2,1,3
C(C([C](C(O)=O)O)(C)CC=O)=O,,,5,1,1,0,1
54281_0,,,,2,2,1,3
C(CC(C=O)C[C](C(O)=O)O)=O,,,5,1,1,0,1
54283_0,,,,2,2,1,3
C(C([C](C(O)=O)O)CC(C)=O)=O,,,5,1,1,0,1
54285_0,,,,2,2,1,3
C(CC(C(C)=O)[C](C(O)=O)O)=O,,,5,1,1,0,1
54287_0,,,,2,2,1,3
C(C(CC[C](C(O)=O)O)=O)=O,,,5,1,1,0,1
54289_0,,,,2,2,1,3
[C](C(O)=O)(C(C)CC(C=O)=O)O,,,5,1,1,0,1
54291_0,,,,2,2,1,3
C(CC[C](C(O)=O)O)=O,,,5,1,1,0,1
54293_0,,,,2,2,1,3
C(C(CC[C](C(O)=O)O)=O)(O)=O,,,5,1,1,0,1
54294_0,,,,2,2,1,3
54296_0,,,,2,2,1,3
C(C(C(C)=O)C[C](C(O)=O)O)(O)=O,,,5,1,1,0,1
54297_0,,,,2,2,1,3
54299_0,,,,2,2,1,3
C1(C(CC(O)O1)C[C](C(O)=O)O)=O,,,5,1,1,0,1
54301_0,,,,2,2,1,3
C1(C(C)C([C](C(O)=O)O)C(O)O1)=O,,,5,1,1,0,1
54303_0,,,,2,2,1,3
[C](C(O)=O)(C([CH]C(O)=O)C(C)O)O,,,5,1,1,0,1
54305_0,,,,2,2,1,3
C(C([CH]C(O)=O)[C](C(O)=O)O)(O)=O,,,5,1,1,0,1
54307_0,,,,2,2,1,3
C(C[C](C(O)=O)[C](C(O)=O)O)(O)=O,,,5,1,1,0,1
54309_0,,,,2,2,1,3
C(CC([C](C(O)=O)O)C(C)O)(O)=O,,,5,1,1,0,1
54311_0,,,,2,2,1,3
C(C([C](C(O)=O)O)CC(O)=O)(O)=O,,,5,1,1,0,1
54313_0,,,,2,2,1,3
C([C](C[CH]C(O)=O)O)(O)=O,,,5,1,2,0,2
54315_0,,,,2,2,1,3
C(CC[C](C(O)=O)O)(O)=O,,,5,1,2,0,2
54317_0,,,,2,2,1,3
C(CC([C](C(O)=O)O)C)=O,,,5,1,1,0,1
54319_0,,,,2,2,1,3
[C](C(O)=O)(C(C)CC(C(O)=O)=O)O,,,5,1,1,0,1
54321_0,,,,2,2,1,3
C(CC(C(O)=O)C[C](C(O)=O)O)=O,,,5,1,1,0,1
54323_0,,,,2,2,1,3
C(CC(C(O)=O)([C](C(O)=O)O)C)=O,,,5,1,1,0,1
54325_0,,,,2,2,1,3
C(C([C](C(O)=O)O)C(C(O)=O)C)=O,,,5,1,1,0,1
54327_0,,,,2,2,1,3
C(C(C(C)O)C[C](C(O)=O)O)(O)=O,,,5,1,1,0,1
54329_0,,,,2,2,1,3
C(C(C(O)=O)C[C](C(O)=O)O)(O)=O,,,5,1,1,0,1
54331_0,,,,2,2,1,3
C(CCC(C(C=O)=O)C(C=O)C=O)=O,,,5,1,1,0,1
54333_0,,,,2,2,1,3
C(CCC(C=O)(C=O)CC(C=O)=O)=O,,,5,1,1,0,1
54335_0,,,,2,2,1,3
C(C(C=O)C(C=O)CCC(C=O)=O)=O,,,5,1,1,0,1
54337_0,,,,2,2,1,3
C(CCC(C=O)C(C=O)C=O)=O,,,5,1,1,0,1
54339_0,,,,2,2,1,3
C(C(C=O)C(C=O)C[CH]C(O)=O)=O,,,5,1,1,0,1
54341_0,,,,2,2,1,3
C(C(C=O)C(C=O)CCC(O)=O)=O,,,5,1,1,0,1
54343_0,,,,2,2,1,3
C(CC(C)C(C=O)C(C=O)C=O)=O,,,5,1,1,0,1
54345_0,,,,2,2,1,3
C(C(C=O)(CCC(C=O)=O)CC=O)=O,,,5,1,1,0,1
54347_0,,,,2,2,1,3
C(CCC(C=O)(C=O)CC=O)=O,,,5,1,1,0,1
54349_0,,,,2,2,1,3
C(C(C=O)(C[CH]C(O)=O)CC=O)=O,,,5,1,1,0,1
54351_0,,,,2,2,1,3
C(C(C=O)(CCC(O)=O)CC=O)=O,,,5,1,1,0,1
54353_0,,,,2,2,1,3
C(CC(C)C(C=O)(C=O)CC=O)=O,,,5,1,1,0,1
54355_0,,,,2,2,1,3
C(C(C(C(C=O)=O)=O)CCCC=O)=O,,,5,1,1,0,1
54357_0,,,,2,2,1,3
C(C(C(C(C=O)=O)=O)(C)CCC=O)=O,,,5,1,1,0,1
54359_0,,,,2,2,1,3
C(CCCC(CC(C(C=O)=O)=O)=O)=O,,,5,1,1,0,1
54361_0,,,,2,2,1,3
C(CCC(C(C)=O)C(C(C=O)=O)=O)=O,,,5,1,1,0,1
54363_0,,,,2,2,1,3
C(C(C)C(C=O)C(C=O)C(C=O)=O)=O,,,5,1,1,0,1
54365_0,,,,2,2,1,3
C(C(C)(CC=O)C(C=O)C(C=O)=O)=O,,,5,1,1,0,1
54367_0,,,,2,2,1,3
C(C(CC(C=O)C(C=O)=O)CC=O)=O,,,5,1,1,0,1
54369_0,,,,2,2,1,3
C(C(C(C=O)=O)C(C=O)CC(C)=O)=O,,,5,1,1,0,1
54371_0,,,,2,2,1,3
C(C(C(C=O)=O)C(C(C)=O)CC=O)=O,,,5,1,1,0,1
54373_0,,,,2,2,1,3
C(C(C(C=O)=O)CCC(C=O)=O)=O,,,5,1,1,0,1
54375_0,,,,2,2,1,3
C(C(C(C=O)=O)C(C)CC(C=O)=O)=O,,,5,1,1,0,1
54377_0,,,,2,2,1,3
C(C(C(C=O)=O)CCC=O)=O,,,5,1,1,0,1
54379_0,,,,2,2,1,3
C(C(C(C=O)=O)CC(C(O)=O)C=C)=O,,,5,1,1,0,1
54380_0,,,,2,2,1,3
54381_0,,,,2,2,1,3
54382_0,,,,2,2,1,3
54384_0,,,,2,2,1,3
C(CCCC(C=O)=O)(CC(C=O)=O)=O,,,5,1,1,0,1
54386_0,,,,2,2,1,3
C(CCCC(CC(C=O)=O)=O)=O,,,5,1,1,0,1
54388_0,,,,2,2,1,3
C(CC[CH]C(O)=O)(CC(C=O)=O)=O,,,5,1,1,0,1
54390_0,,,,2,2,1,3
C(CCCC(O)=O)(CC(C=O)=O)=O,,,5,1,1,0,1
54392_0,,,,2,2,1,3
C(CC(C)CC(CC(C=O)=O)=O)=O,,,5,1,1,0,1
54394_0,,,,2,2,1,3
C(C)(C(C(C=O)=O)CCC(C=O)=O)=O,,,5,1,1,0,1
54396_0,,,,2,2,1,3
C(CCC(C(C)=O)C(C=O)=O)=O,,,5,1,1,0,1
54398_0,,,,2,2,1,3
C(C)(C(C(C=O)=O)C[CH]C(O)=O)=O,,,5,1,1,0,1
54400_0,,,,2,2,1,3
C(C)(C(C(C=O)=O)CCC(O)=O)=O,,,5,1,1,0,1
54402_0,,,,2,2,1,3
C(CC(C)C(C(C)=O)C(C=O)=O)=O,,,5,1,1,0,1
54404_0,,,,2,2,1,3
C(C(CCCCC(C(C=O)=O)=O)=O)=O,,,5,1,1,0,1
54406_0,,,,2,2,1,3
C(CCCCC(C(C=O)=O)=O)=O,,,5,1,1,0,1
54408_0,,,,2,2,1,3
[CH](C(O)=O)CCCC(C(C=O)=O)=O,,,5,1,1,0,1
54410_0,,,,2,2,1,3
C(CCCCC(C(C=O)=O)=O)(O)=O,,,5,1,1,0,1
54412_0,,,,2,2,1,3
C(CC(C)CCC(C(C=O)=O)=O)=O,,,5,1,1,0,1
54414_0,,,,2,2,1,3
C(C(CCC(C(C(C=O)=O)=O)C)=O)=O,,,5,1,1,0,1
54416_0,,,,2,2,1,3
C(CCC(C(C(C=O)=O)=O)C)=O,,,5,1,1,0,1
54418_0,,,,2,2,1,3
[CH](C(O)=O)CC(C(C(C=O)=O)=O)C,,,5,1,1,0,1
54420_0,,,,2,2,1,3
C(CCC(C(C(C=O)=O)=O)C)(O)=O,,,5,1,1,0,1
54422_0,,,,2,2,1,3
C(CC(C)C(C(C(C=O)=O)=O)C)=O,,,5,1,1,0,1
54424_0,,,,2,2,1,3
C(C(C(C(O)=O)=O)CCC=O)=O,,,5,1,1,0,1
54426_0,,,,2,2,1,3
C(C(C(C(O)=O)=O)C[CH]C(O)=O)=O,,,5,1,2,0,2
54428_0,,,,2,2,1,3
C(C(C(C(O)=O)=O)CCC(O)=O)=O,,,5,1,2,0,2
54430_0,,,,2,2,1,3
C(C(C(C(O)=O)=O)C(C)CC=O)=O,,,5,1,1,0,1
54432_0,,,,2,2,1,3
C(CCC(C=O)C(C=O)C(O)=O)=O,,,5,1,2,0,2
54434_0,,,,2,2,1,3
C(CCC(C=O)(C(O)=O)CC=O)=O,,,5,1,1,0,1
54436_0,,,,2,2,1,3
C(CCCC(CC(C(O)=O)=O)=O)=O,,,5,1,1,0,1
54438_0,,,,2,2,1,3
C(CCC(C(C)=O)C(C(O)=O)=O)=O,,,5,1,1,0,1
54440_0,,,,2,2,1,3
C(CCCCC(C(C(O)=O)=O)=O)=O,,,5,1,1,0,1
54442_0,,,,2,2,1,3
C(CCC(C(C(C(O)=O)=O)=O)C)=O,,,5,1,1,0,1
54444_0,,,,2,2,1,3
C(C(C(C(O)=O)=O)CCCC=O)=O,,,5,1,1,0,1
54446_0,,,,2,2,1,3
C(C(C(C(O)=O)=O)(C)CCC=O)=O,,,5,1,1,0,1
54448_0,,,,2,2,1,3
C(C(C(O)=O)CCCC(C=O)=O)=O,,,5,1,1,0,1
54450_0,,,,2,2,1,3
C(C(C(O)=O)CCCC=O)=O,,,5,1,1,0,1
54451_0,,,,2,2,1,3
54452_0,,,,2,2,1,3
54453_0,,,,2,2,1,3
54455_0,,,,2,2,1,3
C(C(C(O)=O)(C)CCC(C=O)=O)=O,,,5,1,1,0,1
54457_0,,,,2,2,1,3
C(C(C(O)=O)(C)CCC=O)=O,,,5,1,1,0,1
54459_0,,,,2,2,1,3
C(C(C(O)=O)(C)C[CH]C(O)=O)=O,,,5,1,1,0,1
54461_0,,,,2,2,1,3
C(C(C(O)=O)(C)CCC(O)=O)=O,,,5,1,1,0,1
54463_0,,,,2,2,1,3
C(C(C(O)=O)(C)C(C)CC=O)=O,,,5,1,1,0,1
54465_0,,,,2,2,1,3
C(C(CCCCC(C(O)=O)=O)=O)=O,,,5,1,1,0,1
54467_0,,,,2,2,1,3
C(CCCCC(C(O)=O)=O)=O,,,5,1,1,0,1
54468_0,,,,2,2,1,3
54469_0,,,,2,2,1,3
54470_0,,,,2,2,1,3
54472_0,,,,2,2,1,3
C(C(O)=O)(C(C)CCC(C=O)=O)=O,,,5,1,1,0,1
54474_0,,,,2,2,1,3
C(CCC(C(C(O)=O)=O)C)=O,,,5,1,1,0,1
54475_0,,,,2,2,1,3
54476_0,,,,2,2,1,3
54477_0,,,,2,2,1,3
54479_0,,,,2,2,1,3
C(C(C(CC(O)=O)=O)CCO)(O)=O,,,5,1,1,0,1
54481_0,,,,2,2,1,3
C(C(CCC(C(C)O)=O)C(C)O)=O,,,5,1,1,0,1
54483_0,,,,2,2,1,3
C(C(CO)C(C)CC(C(C)O)=O)=O,,,5,1,1,0,1
54485_0,,,,2,2,1,3
C(CC(C=O)C(C=O)C)(C(C)O)=O,,,5,1,1,0,1
54487_0,,,,2,2,1,3
C(C(C)(CC(C(C)O)=O)CC=O)=O,,,5,1,1,0,1
54489_0,,,,2,2,1,3
C(C(C)O)(CCC(C=O)CC=O)=O,,,5,1,1,0,1
54491_0,,,,2,2,1,3
C(CC(C=O)CC(C(C)O)=O)(C)=O,,,5,1,1,0,1
54493_0,,,,2,2,1,3
C(CC(C(C)=O)CC=O)(C(C)O)=O,,,5,1,1,0,1
54495_0,,,,2,2,1,3
C(C(C)O)(CCCC(C=O)=O)=O,,,5,1,1,0,1
54497_0,,,,2,2,1,3
C(C(C)O)(CC(C)CC(C=O)=O)=O,,,5,1,1,0,1
54499_0,,,,2,2,1,3
C(CCCC(C(C)O)=O)=O,,,5,1,1,0,1
54501_0,,,,2,2,1,3
C(C(C)O)(CCCC(C(O)=O)=O)=O,,,5,1,1,0,1
54503_0,,,,2,2,1,3
C(C(CCC(C(C)O)=O)CO)(O)=O,,,5,1,1,0,1
54505_0,,,,2,2,1,3
C(C(C=C)CCC(C(C)O)=O)(O)=O,,,5,1,1,0,1
54506_0,,,,2,2,1,3
54507_0,,,,2,2,1,3
54508_0,,,,2,2,1,3
54510_0,,,,2,2,1,3
C(C(C(C)O)CCC(C(C)=O)O)=O,,,5,1,1,0,1
54512_0,,,,2,2,1,3
C(C(CO)C(C)CC(C(C)=O)O)=O,,,5,1,1,0,1
54514_0,,,,2,2,1,3
C(C(CC(C(C)=O)O)C(C=O)C)=O,,,5,1,1,0,1
54516_0,,,,2,2,1,3
C(C)(C(CC(C=O)(C)CC=O)O)=O,,,5,1,1,0,1
54518_0,,,,2,2,1,3
C(C)(C(CCC(C=O)CC=O)O)=O,,,5,1,1,0,1
54520_0,,,,2,2,1,3
C(C)(C(CC(C=O)CC(C)=O)O)=O,,,5,1,1,0,1
54522_0,,,,2,2,1,3
C(C)(C(CC(C(C)=O)CC=O)O)=O,,,5,1,1,0,1
54524_0,,,,2,2,1,3
C(C)(C(CCCC(C=O)=O)O)=O,,,5,1,1,0,1
54526_0,,,,2,2,1,3
C(C)(C(CC(C)CC(C=O)=O)O)=O,,,5,1,1,0,1
54528_0,,,,2,2,1,3
C(CCCC(C(C)=O)O)=O,,,5,1,1,0,1
54530_0,,,,2,2,1,3
C(C)(C(CCCC(C(O)=O)=O)O)=O,,,5,1,1,0,1
54532_0,,,,2,2,1,3
C(C(CO)CCC(C(C)=O)O)(O)=O,,,5,1,1,0,1
54534_0,,,,2,2,1,3
C(C(C=C)CCC(C(C)=O)O)(O)=O,,,5,1,1,0,1
54535_0,,,,2,2,1,3
54536_0,,,,2,2,1,3
54537_0,,,,2,2,1,3
54539_0,,,,2,2,1,3
C(C(CC(C(C)=O)(C)O)C(C)O)=O,,,5,1,1,0,1
54541_0,,,,2,2,1,3
C(C(CO)C(C)C(C(C)=O)(C)O)=O,,,5,1,1,0,1
54543_0,,,,2,2,1,3
C(C)(C(C)(C(C=O)C(C=O)C)O)=O,,,5,1,1,0,1
54545_0,,,,2,2,1,3
C(C)(C(C)(C(C=O)(C)CC=O)O)=O,,,5,1,1,0,1
54547_0,,,,2,2,1,3
C(C)(C(C)(CC(C=O)CC=O)O)=O,,,5,1,1,0,1
54549_0,,,,2,2,1,3
C(CC(C=O)C(C(C)=O)(C)O)(C)=O,,,5,1,1,0,1
54551_0,,,,2,2,1,3
C(C)(C(C)(C(C(C)=O)CC=O)O)=O,,,5,1,1,0,1
54553_0,,,,2,2,1,3
C(C)(C(C)(CCC(C=O)=O)O)=O,,,5,1,1,0,1
54555_0,,,,2,2,1,3
C(C)(C(C)(C(C)CC(C=O)=O)O)=O,,,5,1,1,0,1
54557_0,,,,2,2,1,3
C(CCC(C(C)=O)(C)O)=O,,,5,1,1,0,1
54559_0,,,,2,2,1,3
C(C)(C(C)(CCC(C(O)=O)=O)O)=O,,,5,1,1,0,1
54561_0,,,,2,2,1,3
C(C(CO)CC(C(C)=O)(C)O)(O)=O,,,5,1,1,0,1
54563_0,,,,2,2,1,3
C(C(C=C)CC(C(C)=O)(C)O)(O)=O,,,5,1,1,0,1
54564_0,,,,2,2,1,3
54565_0,,,,2,2,1,3
54566_0,,,,2,2,1,3
54568_0,,,,2,2,1,3
C(C(CC(C(CC)=O)O)C(C)O)=O,,,5,1,1,0,1
54570_0,,,,2,2,1,3
C(C(CO)C(C)C(C(CC)=O)O)=O,,,5,1,1,0,1
54572_0,,,,2,2,1,3
C(C(C(C=O)C(C=O)C)O)(CC)=O,,,5,1,1,0,1
54574_0,,,,2,2,1,3
C(CC(C=O)(C)C(C(CC)=O)O)=O,,,5,1,1,0,1
54576_0,,,,2,2,1,3
C(C(CC(C=O)CC=O)O)(CC)=O,,,5,1,1,0,1
54578_0,,,,2,2,1,3
C(CC(C=O)C(C(CC)=O)O)(C)=O,,,5,1,1,0,1
54580_0,,,,2,2,1,3
C(C(C(C(C)=O)CC=O)O)(CC)=O,,,5,1,1,0,1
54582_0,,,,2,2,1,3
C(C(CCC(C=O)=O)O)(CC)=O,,,5,1,1,0,1
54584_0,,,,2,2,1,3
C(C(C(C)CC(C=O)=O)O)(CC)=O,,,5,1,1,0,1
54586_0,,,,2,2,1,3
C(CCC(C(CC)=O)O)=O,,,5,1,1,0,1
54588_0,,,,2,2,1,3
C(C(CCC(C(O)=O)=O)O)(CC)=O,,,5,1,1,0,1
54590_0,,,,2,2,1,3
C(C(CO)CC(C(CC)=O)O)(O)=O,,,5,1,1,0,1
54592_0,,,,2,2,1,3
C(C(C=C)CC(C(CC)=O)O)(O)=O,,,5,1,1,0,1
54593_0,,,,2,2,1,3
54594_0,,,,2,2,1,3
54595_0,,,,2,2,1,3
54597_0,,,,2,2,1,3
C(C(C(C)O)CCCC(CO)=O)=O,,,5,1,1,0,1
54599_0,,,,2,2,1,3
C(C(CO)C(C)CCC(CO)=O)=O,,,5,1,1,0,1
54601_0,,,,2,2,1,3
C(C(CCC(CO)=O)C(C=O)C)=O,,,5,1,1,0,1
54603_0,,,,2,2,1,3
C(CO)(CCC(C=O)(C)CC=O)=O,,,5,1,1,0,1
54605_0,,,,2,2,1,3
C(CO)(CCCC(C=O)CC=O)=O,,,5,1,1,0,1
54607_0,,,,2,2,1,3
C(CO)(CCC(C=O)CC(C)=O)=O,,,5,1,1,0,1
54609_0,,,,2,2,1,3
C(CO)(CCC(C(C)=O)CC=O)=O,,,5,1,1,0,1
54611_0,,,,2,2,1,3
C(CO)(CCCCC(C=O)=O)=O,,,5,1,1,0,1
54613_0,,,,2,2,1,3
C(CO)(CCC(C)CC(C=O)=O)=O,,,5,1,1,0,1
54615_0,,,,2,2,1,3
C(CCCCC(CO)=O)=O,,,5,1,1,0,1
54617_0,,,,2,2,1,3
C(CO)(CCCCC(C(O)=O)=O)=O,,,5,1,1,0,1
54619_0,,,,2,2,1,3
C(C(CO)CCCC(CO)=O)(O)=O,,,5,1,1,0,1
54621_0,,,,2,2,1,3
C(C(C=C)CCCC(CO)=O)(O)=O,,,5,1,1,0,1
54622_0,,,,2,2,1,3
54623_0,,,,2,2,1,3
54624_0,,,,2,2,1,3
54626_0,,,,2,2,1,3
C(C(CC(C(CO)=O)C)C(C)O)=O,,,5,1,1,0,1
54628_0,,,,2,2,1,3
C(C(CO)C(C)C(C(CO)=O)C)=O,,,5,1,1,0,1
54630_0,,,,2,2,1,3
C(CO)(C(C)C(C=O)C(C=O)C)=O,,,5,1,1,0,1
54632_0,,,,2,2,1,3
C(CO)(C(C)C(C=O)(C)CC=O)=O,,,5,1,1,0,1
54634_0,,,,2,2,1,3
C(CO)(C(C)CC(C=O)CC=O)=O,,,5,1,1,0,1
54636_0,,,,2,2,1,3
C(CC(C=O)C(C(CO)=O)C)(C)=O,,,5,1,1,0,1
54638_0,,,,2,2,1,3
C(CO)(C(C)C(C(C)=O)CC=O)=O,,,5,1,1,0,1
54640_0,,,,2,2,1,3
C(CO)(C(C)CCC(C=O)=O)=O,,,5,1,1,0,1
54642_0,,,,2,2,1,3
C(CO)(C(C)C(C)CC(C=O)=O)=O,,,5,1,1,0,1
54644_0,,,,2,2,1,3
C(CCC(C(CO)=O)C)=O,,,5,1,1,0,1
54646_0,,,,2,2,1,3
C(CO)(C(C)CCC(C(O)=O)=O)=O,,,5,1,1,0,1
54648_0,,,,2,2,1,3
C(C(CO)CC(C(CO)=O)C)(O)=O,,,5,1,1,0,1
54650_0,,,,2,2,1,3
C(C(C=C)CC(C(CO)=O)C)(O)=O,,,5,1,1,0,1
54651_0,,,,2,2,1,3
54652_0,,,,2,2,1,3
54653_0,,,,2,2,1,3
54655_0,,,,2,2,1,3
C(C)(C(CCC=O)C(C(O)=O)O)=O,,,5,1,1,0,1
54657_0,,,,2,2,1,3
C(C(CCC=O)(CC(C)=O)O)(O)=O,,,5,1,1,0,1
54659_0,,,,2,2,1,3
C(CC(C(O)=O)O)(CCCC=O)=O,,,5,1,1,0,1
54661_0,,,,2,2,1,3
C(C(C=O)C(CC(C)O)CC=O)=O,,,5,1,1,0,1
54663_0,,,,2,2,1,3
C(C(C=O)CC(C=O)C(C)O)=O,,,5,1,1,0,1
54665_0,,,,2,2,1,3
C(C(C=O)C(C)C(C=O)CO)=O,,,5,1,1,0,1
54667_0,,,,2,2,1,3
C(C(C=O)C(C)C(C=O)C(C)O)=O,,,5,1,1,0,1
54669_0,,,,2,2,1,3
C(C(C=O)C(C)C(C=O)C(O)=O)=O,,,5,1,1,0,1
54671_0,,,,2,2,1,3
C(C(C=O)C(CC=O)CC(O)=O)=O,,,5,1,2,0,2
54672_0,,,,2,2,1,3
54674_0,,,,2,2,1,3
C(C(C=O)C(C=O)CC(CO)=O)=O,,,5,1,1,0,1
54676_0,,,,2,2,1,3
C(C(C=O)C(C(CO)=O)CC=O)=O,,,5,1,1,0,1
54678_0,,,,2,2,1,3
C(C(CO)C(C=O)C(C=O)C=O)=O,,,5,1,1,0,1
54680_0,,,,2,2,1,3
C(C(CO)(CC=O)C(C=O)C=O)=O,,,5,1,1,0,1
54682_0,,,,2,2,1,3
C(C(C)C(C(C=O)=O)C(C=O)C=O)=O,,,5,1,1,0,1
54684_0,,,,2,2,1,3
C(C(C)(CC(C=O)=O)C(C=O)C=O)=O,,,5,1,1,0,1
54686_0,,,,2,2,1,3
C(C(CC(C=O)C=O)CC(C=O)=O)=O,,,5,1,1,0,1
54688_0,,,,2,2,1,3
C(C(C)C(C=O)C(C=O)C=O)=O,,,5,1,1,0,1
54690_0,,,,2,2,1,3
C(C(C)(CC=O)C(C=O)C=O)=O,,,5,1,1,0,1
54692_0,,,,2,2,1,3
C(C(CC(C=O)C=O)CC=O)=O,,,5,1,1,0,1
54694_0,,,,2,2,1,3
C(C(C=O)C(C(C=O)=O)CC(C)=O)=O,,,5,1,1,0,1
54696_0,,,,2,2,1,3
C(C(C=O)C(C(C)=O)CC(C=O)=O)=O,,,5,1,1,0,1
54698_0,,,,2,2,1,3
C(C(C=O)C(C=O)CC(C)=O)=O,,,5,1,1,0,1
54700_0,,,,2,2,1,3
C(C(C=O)C(C(C)=O)CC=O)=O,,,5,1,1,0,1
54702_0,,,,2,2,1,3
C(C(C=O)CCC(C=O)=O)=O,,,5,1,1,0,1
54704_0,,,,2,2,1,3
C(C(C=O)C(C)CC(C=O)=O)=O,,,5,1,1,0,1
54706_0,,,,2,2,1,3
C(C(C=O)CCC=O)=O,,,5,1,1,0,1
54708_0,,,,2,2,1,3
C(C(C=O)CCC(C(O)=O)=O)=O,,,5,1,1,0,1
54710_0,,,,2,2,1,3
C(C(C=O)CC(C(O)=O)CO)=O,,,5,1,1,0,1
54712_0,,,,2,2,1,3
C(C(C=O)CC(C(C)=O)C(O)=O)=O,,,5,1,1,0,1
54714_0,,,,2,2,1,3
C(C(C=O)CC(C(O)=O)C=C)=O,,,5,1,1,0,1
54716_0,,,,2,2,1,3
C(C(C=O)CC1C(OC(C1)O)=O)=O,,,5,1,1,0,1
54718_0,,,,2,2,1,3
C(C(C=O)C1C(O)OC(C1C)=O)=O,,,5,1,1,0,1
54720_0,,,,2,2,1,3
C(C(C=O)C([CH]C(O)=O)C(C)O)=O,,,5,1,1,0,1
54722_0,,,,2,2,1,3
C(C(C=O)C(C(O)=O)[CH]C(O)=O)=O,,,5,1,1,0,1
54724_0,,,,2,2,1,3
C(C(C=O)[C](C(O)=O)CC(O)=O)=O,,,5,1,1,0,1
54726_0,,,,2,2,1,3
C(C(C=O)C(C(C)O)CC(O)=O)=O,,,5,1,1,0,1
54728_0,,,,2,2,1,3
C(C(C=O)C(C(O)=O)CC(O)=O)=O,,,5,1,1,0,1
54729_0,,,,2,2,1,3
54730_0,,,,2,2,1,3
54731_0,,,,2,2,1,3
54733_0,,,,2,2,1,3
C(C(C=O)C(C)CC(C(O)=O)=O)=O,,,5,1,1,0,1
54735_0,,,,2,2,1,3
C(C(C=O)CC(C(O)=O)CC=O)=O,,,5,1,1,0,1
54737_0,,,,2,2,1,3
C(C(C=O)C(C(O)=O)(C)CC=O)=O,,,5,1,1,0,1
54739_0,,,,2,2,1,3
C(C(C=O)C(C=O)C(C(O)=O)C)=O,,,5,1,1,0,1
54741_0,,,,2,2,1,3
C(C(C=O)CC(C(O)=O)C(C)O)=O,,,5,1,1,0,1
54743_0,,,,2,2,1,3
C(C(C=O)CC(C(O)=O)C(O)=O)=O,,,5,1,1,0,1
54745_0,,,,2,2,1,3
C(CCC1C(C(C=C1C(O)=O)=O)=O)=O,,,5,1,1,0,1
54747_0,,,,2,2,1,3
C(C1CC(C(C1[CH]C(O)=O)=O)=O)(O)=O,,,5,1,1,0,1
54749_0,,,,2,2,1,3
C(CC1C(C(CC1C(O)=O)=O)=O)=O,,,5,1,1,0,1
54751_0,,,,2,2,1,3
C(C1CC(C(C1CO)=O)=O)(O)=O,,,5,1,1,0,1
54753_0,,,,2,2,1,3
C(C1CC(C(C1CCO)=O)=O)(O)=O,,,5,1,1,0,1
54755_0,,,,2,2,1,3
C(C1CC(C(C1C(C)O)=O)=O)(O)=O,,,5,1,1,0,1
54757_0,,,,2,2,1,3
C(C1([CH]C(O)=O)CC(C(C1)=O)=O)(O)=O,,,5,1,1,0,1
54759_0,,,,2,2,1,3
C(CC1(C(O)=O)CC(C(C1)=O)=O)=O,,,5,1,1,0,1
54761_0,,,,2,2,1,3
C(C1(CO)CC(C(C1)=O)=O)(O)=O,,,5,1,1,0,1
54763_0,,,,2,2,1,3
C(C1(CCO)CC(C(C1)=O)=O)(O)=O,,,5,1,1,0,1
54765_0,,,,2,2,1,3
C(C1(C(C)O)CC(C(C1)=O)=O)(O)=O,,,5,1,1,0,1
54766_0,,,,2,2,1,3
54768_0,,,,2,2,1,3
C(C(C(C)O)C(CO)CC(C)O)=O,,,5,1,1,0,1
54770_0,,,,2,2,1,3
C(C(C=O)C(CO)CC(C)O)(O)=O,,,5,1,1,0,1
54772_0,,,,2,2,1,3
C(CCC(C=CC(C=O)=O)C(C)O)=O,,,5,1,1,0,1
54774_0,,,,2,2,1,3
C(CCCC(CC=CC(C=O)=O)O)=O,,,5,1,1,0,1
54776_0,,,,2,2,1,3
C(CCC(C)(CC=CC(C=O)=O)O)=O,,,5,1,1,0,1
54778_0,,,,2,2,1,3
C(CC(CC(C)O)CC(C=O)=O)=O,,,5,1,2,0,2
54780_0,,,,2,2,1,3
C(C(CC(CO)CC(C)O)=O)=O,,,5,1,1,0,1
54782_0,,,,2,2,1,3
C(C(CC(CC(C)O)CCO)=O)=O,,,5,1,1,0,1
54784_0,,,,2,2,1,3
C(C(CC(CC(C)O)C(C)O)=O)=O,,,5,1,1,0,1
54786_0,,,,2,2,1,3
C(CCC(C=CC(C)O)C(C=O)=O)=O,,,5,1,1,0,1
54788_0,,,,2,2,1,3
C(CCCC(C=CCC(C=O)=O)O)=O,,,5,1,1,0,1
54790_0,,,,2,2,1,3
C(CCC(C=CCC(C=O)=O)(C)O)=O,,,5,1,1,0,1
54792_0,,,,2,2,1,3
C(C(CCC(C=O)=O)C(C)O)=CC=O,,,5,1,1,0,1
54794_0,,,,2,2,1,3
C(CCC(C=CC=O)C(C)O)=O,,,5,1,1,0,1
54796_0,,,,2,2,1,3
C(C(C(C)O)C[CH]C(O)=O)=CC=O,,,5,1,1,0,1
54798_0,,,,2,2,1,3
C(CCC(C=CC=O)C(C)O)(O)=O,,,5,1,1,0,1
54800_0,,,,2,2,1,3
C(CC(C)C(C=CC=O)C(C)O)=O,,,5,1,1,0,1
54802_0,,,,2,2,1,3
C(CC(CCCC(C=O)=O)O)=CC=O,,,5,1,1,0,1
54804_0,,,,2,2,1,3
C(CCCC(CC=CC=O)O)=O,,,5,1,1,0,1
54806_0,,,,2,2,1,3
C(CC(CC[CH]C(O)=O)O)=CC=O,,,5,1,1,0,1
54808_0,,,,2,2,1,3
C(CCCC(CC=CC=O)O)(O)=O,,,5,1,1,0,1
54810_0,,,,2,2,1,3
C(CC(C)CC(CC=CC=O)O)=O,,,5,1,1,0,1
54812_0,,,,2,2,1,3
C(CC(C)(CCC(C=O)=O)O)=CC=O,,,5,1,1,0,1
54814_0,,,,2,2,1,3
C(CCC(C)(CC=CC=O)O)=O,,,5,1,1,0,1
54816_0,,,,2,2,1,3
C(CC(C)(C[CH]C(O)=O)O)=CC=O,,,5,1,1,0,1
54818_0,,,,2,2,1,3
C(CCC(C)(CC=CC=O)O)(O)=O,,,5,1,1,0,1
54820_0,,,,2,2,1,3
C(CC(C)C(C)(CC=CC=O)O)=O,,,5,1,1,0,1
54822_0,,,,2,2,1,3
C(CC(CC(C=C)O)CC(C)O)=O,,,5,1,1,0,1
54824_0,,,,2,2,1,3
C(CC(CC(C)O)C(C=C)(C)O)=O,,,5,1,1,0,1
54826_0,,,,2,2,1,3
C(CC([CH]C(O)=O)CC(C)O)=O,,,5,1,1,0,1
54828_0,,,,2,2,1,3
C(CC(CC(C)O)C(C=O)(O)O)=O,,,5,1,1,0,1
54830_0,,,,2,2,1,3
C(CC(CC(C)O)CC=O)=O,,,5,1,1,0,1
54831_0,,,,2,2,1,3
54833_0,,,,2,2,1,3
C(CC(CC(C)O)C(C(O)=O)O)=O,,,5,1,1,0,1
54835_0,,,,2,2,1,3
C(CC(CC(C)O)C(CO)O)=O,,,5,1,1,0,1
54837_0,,,,2,2,1,3
C(C(CO)C(CC(C)O)CC=O)=O,,,5,1,1,0,1
54839_0,,,,2,2,1,3
C(CC(C(CC=O)O)CC(C)O)=O,,,5,1,1,0,1
54841_0,,,,2,2,1,3
C(CC(CC(C)O)CC(CO)=O)=O,,,5,1,1,0,1
54843_0,,,,2,2,1,3
C(CC(CC(C)O)C(C(C)=O)O)=O,,,5,1,1,0,1
54845_0,,,,2,2,1,3
C(CC(CO)CC(C)O)=O,,,5,1,1,0,1
54847_0,,,,2,2,1,3
C(CC(CC(C)O)CCO)=O,,,5,1,1,0,1
54849_0,,,,2,2,1,3
C(CC(CC(C)O)C(C)O)=O,,,5,1,1,0,1
54851_0,,,,2,2,1,3
C(CC(CC(C)O)CC=O)(O)=O,,,5,1,1,0,1
54853_0,,,,2,2,1,3
C(CC(CC(C)O)CC=CC=O)=O,,,5,1,1,0,1
54855_0,,,,2,2,1,3
C(C(C=C)C(CC(C)O)CC=O)=O,,,5,1,1,0,1
54857_0,,,,2,2,1,3
C(CC(CC(C)O)C(C=O)O)=O,,,5,1,1,0,1
54859_0,,,,2,2,1,3
C(CC(CC(C=O)O)CC(C)O)=O,,,5,1,1,0,1
54861_0,,,,2,2,1,3
C(C(C)(C(CC(C)O)CC=O)O)=O,,,5,1,1,0,1
54863_0,,,,2,2,1,3
C(C(C=CC(C)O)CCC(C=O)=O)=O,,,5,1,1,0,1
54865_0,,,,2,2,1,3
C(CCC(C=O)C=CC(C)O)=O,,,5,1,1,0,1
54867_0,,,,2,2,1,3
C(C(C=CC(C)O)C[CH]C(O)=O)=O,,,5,1,1,0,1
54869_0,,,,2,2,1,3
C(CCC(C=O)C=CC(C)O)(O)=O,,,5,1,1,0,1
54871_0,,,,2,2,1,3
C(CC(C)C(C=O)C=CC(C)O)=O,,,5,1,1,0,1
54873_0,,,,2,2,1,3
C(CC=CC(CCCC(C=O)=O)O)=O,,,5,1,1,0,1
54875_0,,,,2,2,1,3
C(CCCC(C=CCC=O)O)=O,,,5,1,1,0,1
54877_0,,,,2,2,1,3
C(CC=CC(CC[CH]C(O)=O)O)=O,,,5,1,1,0,1
54879_0,,,,2,2,1,3
C(CCCC(C=CCC=O)O)(O)=O,,,5,1,1,0,1
54881_0,,,,2,2,1,3
C(CC(C)CC(C=CCC=O)O)=O,,,5,1,1,0,1
54883_0,,,,2,2,1,3
C(CC=CC(C)(CCC(C=O)=O)O)=O,,,5,1,1,0,1
54885_0,,,,2,2,1,3
C(CC=CC(C)(CCC=O)O)=O,,,5,1,1,0,1
54887_0,,,,2,2,1,3
C(CC=CC(C)(C[CH]C(O)=O)O)=O,,,5,1,1,0,1
54889_0,,,,2,2,1,3
C(CC=CC(C)(CCC(O)=O)O)=O,,,5,1,1,0,1
54891_0,,,,2,2,1,3
C(CC=CC(C)(C(C)CC=O)O)=O,,,5,1,1,0,1
54893_0,,,,2,2,1,3
C(C(CC(CO)CC(C)O)=O)(O)=O,,,5,1,1,0,1
54895_0,,,,2,2,1,3
C(C(C(CO)CC(O)=O)C(C)O)=O,,,5,1,2,0,2
54896_0,,,,2,2,1,3
54897_0,,,,2,2,1,3
54899_0,,,,2,2,1,3
C(C(C(C)O)C(C(CO)=O)CO)=O,,,5,1,1,0,1
54901_0,,,,2,2,1,3
C(C(CO)(C(C)O)CC(CO)=O)=O,,,5,1,1,0,1
54902_0,,,,2,2,1,3
54904_0,,,,2,2,1,3
C(C(CO)(CO)C(C=O)C(C)O)=O,,,5,1,1,0,1
54906_0,,,,2,2,1,3
C(C(CO)(C(C)O)C(C=O)CO)=O,,,5,1,1,0,1
54907_0,,,,2,2,1,3
54909_0,,,,2,2,1,3
C(C(C(C=O)=C)(CCC=O)C(C)O)=O,,,5,1,1,0,1
54911_0,,,,2,2,1,3
C(C(C(C=O)=C)C(CCCC=O)O)=O,,,5,1,1,0,1
54913_0,,,,2,2,1,3
C(C(C(C=O)=C)C(C)(CCC=O)O)=O,,,5,1,1,0,1
54915_0,,,,2,2,1,3
C(CCC(C=O)C(C=O)C(C)O)=O,,,5,1,1,0,1
54917_0,,,,2,2,1,3
C(C(C(C)O)C(C=O)CCO)=O,,,5,1,1,0,1
54919_0,,,,2,2,1,3
C(C(C(C)O)C(C=O)CCCO)=O,,,5,1,1,0,1
54921_0,,,,2,2,1,3
C(C(CC(C)O)C(C=O)C(C)O)=O,,,5,1,1,0,1
54923_0,,,,2,2,1,3
C(CCCC(C=O)=C(C=O)C(C)O)=O,,,5,1,1,0,1
54925_0,,,,2,2,1,3
C(CCCC(C(C=O)=C(C=O)C)O)=O,,,5,1,1,0,1
54927_0,,,,2,2,1,3
C(CCC(C(C=O)=C(C=O)C)(C)O)=O,,,5,1,1,0,1
54929_0,,,,2,2,1,3
C(C(C(C)O)C(C=O)(C)CC=O)=O,,,5,1,2,0,2
54931_0,,,,2,2,1,3
C(C(C)(CO)C(C=O)C(C)O)=O,,,5,1,1,0,1
54933_0,,,,2,2,1,3
C(C(C)(CCO)C(C=O)C(C)O)=O,,,5,1,1,0,1
54935_0,,,,2,2,1,3
C(C(C)(C(C)O)C(C=O)C(C)O)=O,,,5,1,1,0,1
54937_0,,,,2,2,1,3
C(C(C)C(C=O)(C(C)O)CC=O)=O,,,5,1,1,0,1
54938_0,,,,2,2,1,3
54940_0,,,,2,2,1,3
C(C(CCO)(C(C)O)C(C=O)C)=O,,,5,1,1,0,1
54942_0,,,,2,2,1,3
C(C(C(C)O)(C(C)O)C(C=O)C)=O,,,5,1,1,0,1
54944_0,,,,2,2,1,3
C(CCCC(C=O)(C(C=O)=CC)O)=O,,,5,1,1,0,1
54946_0,,,,2,2,1,3
C(C(C(C=O)=CCCCC=O)(C)O)=O,,,5,1,1,0,1
54947_0,,,,2,2,1,3
54948_0,,,,2,2,1,3
54949_0,,,,2,2,1,3
54950_0,,,,2,2,1,3
54952_0,,,,2,2,1,3
C(CCCC(C=C(C=O)C(C)O)=O)=O,,,5,1,1,0,1
54954_0,,,,2,2,1,3
C(CCCC(C(C=O)=CC(C)=O)O)=O,,,5,1,1,0,1
54956_0,,,,2,2,1,3
C(CCC(C(C=O)=CC(C)=O)(C)O)=O,,,5,1,1,0,1
54958_0,,,,2,2,1,3
C(CC(C(C)=O)C(C=O)C(C)O)=O,,,5,1,2,0,2
54960_0,,,,2,2,1,3
C(C(C(C)O)C(C(C)=O)CO)=O,,,5,1,1,0,1
54962_0,,,,2,2,1,3
C(C(C(C)O)C(C(C)=O)CCO)=O,,,5,1,1,0,1
54964_0,,,,2,2,1,3
C(C(C(C)O)C(C(C)=O)C(C)O)=O,,,5,1,1,0,1
54966_0,,,,2,2,1,3
C(C(C(C)O)(CC(C)=O)CC=O)=O,,,5,1,1,0,1
54967_0,,,,2,2,1,3
54969_0,,,,2,2,1,3
C(C(CCO)(C(C)O)CC(C)=O)=O,,,5,1,1,0,1
54971_0,,,,2,2,1,3
C(C(C(C)O)(C(C)O)CC(C)=O)=O,,,5,1,1,0,1
54973_0,,,,2,2,1,3
C(CCCC(C(C(C=O)=CC)O)=O)=O,,,5,1,1,0,1
54975_0,,,,2,2,1,3
C(CCC(C(C)=O)(C(C=O)=CC)O)=O,,,5,1,1,0,1
54977_0,,,,2,2,1,3
C(CCCC=C(C=O)C(C(C)=O)O)=O,,,5,1,1,0,1
54978_0,,,,2,2,1,3
54979_0,,,,2,2,1,3
54980_0,,,,2,2,1,3
54981_0,,,,2,2,1,3
54983_0,,,,2,2,1,3
C(C(CC(C(C=O)=C)O)C(C=O)C)=O,,,5,1,1,0,1
54985_0,,,,2,2,1,3
C(C(C)(CC(C(C=O)=C)O)CC=O)=O,,,5,1,1,0,1
54987_0,,,,2,2,1,3
C(C(CCC(C(C=O)=C)O)CC=O)=O,,,5,1,1,0,1
54989_0,,,,2,2,1,3
C(C(CC(C(C=O)=C)O)CC(C)=O)=O,,,5,1,1,0,1
54991_0,,,,2,2,1,3
C(C)(C(CC(C(C=O)=C)O)CC=O)=O,,,5,1,1,0,1
54993_0,,,,2,2,1,3
C=C(C=O)C(CCCC(C=O)=O)O,,,5,1,1,0,1
54995_0,,,,2,2,1,3
C=C(C=O)C(CC(C)CC(C=O)=O)O,,,5,1,1,0,1
54997_0,,,,2,2,1,3
C(CCCC(C(C=O)=C)O)=O,,,5,1,1,0,1
54999_0,,,,2,2,1,3
C(C(C=C)CCC(C(C=O)=C)O)(O)=O,,,5,1,1,0,1
55000_0,,,,2,2,1,3
55001_0,,,,2,2,1,3
55002_0,,,,2,2,1,3
55004_0,,,,2,2,1,3
C(C(C)C(C=O)C(C(C=O)=C)(C)O)=O,,,5,1,1,0,1
55006_0,,,,2,2,1,3
C(C(C)(CC=O)C(C(C=O)=C)(C)O)=O,,,5,1,1,0,1
55008_0,,,,2,2,1,3
C(C(CC(C(C=O)=C)(C)O)CC=O)=O,,,5,1,1,0,1
55010_0,,,,2,2,1,3
C(CC(C=O)C(C(C=O)=C)(C)O)(C)=O,,,5,1,1,0,1
55012_0,,,,2,2,1,3
C(CC(C(C)=O)C(C(C=O)=C)(C)O)=O,,,5,1,1,0,1
55014_0,,,,2,2,1,3
C=C(C=O)C(C)(CCC(C=O)=O)O,,,5,1,1,0,1
55016_0,,,,2,2,1,3
C=C(C=O)C(C)(C(C)CC(C=O)=O)O,,,5,1,1,0,1
55018_0,,,,2,2,1,3
C(CCC(C(C=O)=C)(C)O)=O,,,5,1,1,0,1
55020_0,,,,2,2,1,3
C(C(C=C)CC(C(C=O)=C)(C)O)(O)=O,,,5,1,1,0,1
55021_0,,,,2,2,1,3
55022_0,,,,2,2,1,3
55023_0,,,,2,2,1,3
55025_0,,,,2,2,1,3
C(C(CCC(C=O)=CC=O)C(C)O)=O,,,5,1,1,0,1
55027_0,,,,2,2,1,3
C(C(C(C=O)=C)CC(C=O)C(C)O)=O,,,5,1,1,0,1
55029_0,,,,2,2,1,3
C(C(CCC(C=CC=O)=O)C(C)O)=O,,,5,1,1,0,1
55031_0,,,,2,2,1,3
C(C(CC(C=C)C(C=O)=O)C(C)O)=O,,,5,1,1,0,1
55033_0,,,,2,2,1,3
C(C(CCC=CC(C=O)=O)C(C)O)=O,,,5,1,1,0,1
55035_0,,,,2,2,1,3
C(C(C(C)O)CCC(C=C)O)=O,,,5,1,1,0,1
55037_0,,,,2,2,1,3
C(C(CC(C=C)(C)O)C(C)O)=O,,,5,1,1,0,1
55039_0,,,,2,2,1,3
C(C(CC(C=C)(CO)O)C(C)O)=O,,,5,1,1,0,1
55041_0,,,,2,2,1,3
C(C(C(C)O)CC(C(C=C)O)O)=O,,,5,1,1,0,1
55043_0,,,,2,2,1,3
C(C(CC(C=O)(CC)O)C(C)O)=O,,,5,1,1,0,1
55045_0,,,,2,2,1,3
C(C(C(C)O)CCCC(C=O)O)=O,,,5,1,1,0,1
55047_0,,,,2,2,1,3
C(C(C(C)O)CC(C)C(C=O)O)=O,,,5,1,1,0,1
55049_0,,,,2,2,1,3
C(C(CC(C=O)CCO)C(C)O)=O,,,5,1,1,0,1
55051_0,,,,2,2,1,3
C(C(CC(CCC=O)O)C(C)O)=O,,,5,1,1,0,1
55053_0,,,,2,2,1,3
C(C(CC(CO)CC=O)C(C)O)=O,,,5,1,1,0,1
55054_0,,,,2,2,1,3
55056_0,,,,2,2,1,3
C(C(CC(C=O)(O)O)C(C)O)=O,,,5,1,1,0,1
55058_0,,,,2,2,1,3
C(C(CCC=O)C(C)O)=O,,,5,1,2,0,2
55060_0,,,,2,2,1,3
C(C(CC[C](C(O)=O)O)C(C)O)=O,,,5,1,1,0,1
55062_0,,,,2,2,1,3
C(C(C(C)O)CCC(C(O)=O)O)=O,,,5,1,1,0,1
55064_0,,,,2,2,1,3
C(C(CC(C(O)=O)(C)O)C(C)O)=O,,,5,1,1,0,1
55066_0,,,,2,2,1,3
C(C(CC(C=O)C(C)O)C(C)O)=O,,,5,1,1,0,1
55068_0,,,,2,2,1,3
C(C(CCC(CC=O)O)C(C)O)=O,,,5,1,1,0,1
55070_0,,,,2,2,1,3
C(C(CC(C)(CC=O)O)C(C)O)=O,,,5,1,1,0,1
55071_0,,,,2,2,1,3
55073_0,,,,2,2,1,3
C(C(CC(C(C=O)=O)O)C(C)O)=O,,,5,1,1,0,1
55075_0,,,,2,2,1,3
C(C(CCC(C=O)=O)C(C)O)=O,,,5,1,2,0,2
55076_0,,,,2,2,1,3
55078_0,,,,2,2,1,3
C(C(CC(CO)O)C(C)O)=O,,,5,1,1,0,1
55080_0,,,,2,2,1,3
C(C(CC(C=O)CO)C(C)O)=O,,,5,1,1,0,1
55082_0,,,,2,2,1,3
C(C(CC(CC=O)O)C(C)O)=O,,,5,1,1,0,1
55084_0,,,,2,2,1,3
C(C(C=O)(CC(C=O)C(C)O)O)=O,,,5,1,1,0,1
55086_0,,,,2,2,1,3
C(C(CC(CO)C(C)O)C(C)O)=O,,,5,1,1,0,1
55088_0,,,,2,2,1,3
C(C(CC(CC(C)O)O)C(C)O)=O,,,5,1,1,0,1
55090_0,,,,2,2,1,3
C(C(CCC(CCO)O)C(C)O)=O,,,5,1,1,0,1
55092_0,,,,2,2,1,3
C(C(CC(C)(CCO)O)C(C)O)=O,,,5,1,1,0,1
55094_0,,,,2,2,1,3
C(C(CC(C=O)C(C)O)CO)(O)=O,,,5,1,2,0,2
55096_0,,,,2,2,1,3
C(C(CC(CC(O)=O)O)C(C)O)=O,,,5,1,1,0,1
55098_0,,,,2,2,1,3
C(C(CC(C(CO)=O)O)C(C)O)=O,,,5,1,1,0,1
55100_0,,,,2,2,1,3
C(C(CCC(CO)=O)C(C)O)=O,,,5,1,1,0,1
55102_0,,,,2,2,1,3
C(C(CC(C(C)=O)O)C(C)O)=O,,,5,1,1,0,1
55103_0,,,,2,2,1,3
55105_0,,,,2,2,1,3
C(C(CCCO)C(C)O)=O,,,5,1,1,0,1
55107_0,,,,2,2,1,3
C(C(CC(C)O)C(C)O)=O,,,5,1,1,0,1
55108_0,,,,2,2,1,3
55110_0,,,,2,2,1,3
C(C(CCC=CC=O)C(C)O)=O,,,5,1,1,0,1
55112_0,,,,2,2,1,3
C(C(C=C)CC(C=O)C(C)O)=O,,,5,1,1,0,1
55114_0,,,,2,2,1,3
C(C(C(C)O)CC(C(C=O)O)O)=O,,,5,1,1,0,1
55116_0,,,,2,2,1,3
C(C(CC(C=O)(CO)O)C(C)O)=O,,,5,1,1,0,1
55118_0,,,,2,2,1,3
C(C(CC([CH]C(O)=O)O)C(C)O)=O,,,5,1,1,0,1
55120_0,,,,2,2,1,3
C(C(C(C)O)C[C](C(O)=O)CO)=O,,,5,1,1,0,1
55122_0,,,,2,2,1,3
C(C(CC(C=O)O)C(C)O)=O,,,5,1,1,0,1
55124_0,,,,2,2,1,3
C(C(C(C)O)CCC(C=O)O)=O,,,5,1,1,0,1
55126_0,,,,2,2,1,3
C(C(CC(C=O)(C)O)C(C)O)=O,,,5,1,1,0,1
55128_0,,,,2,2,1,3
C(C(CCC(C(O)=O)=O)C(C)O)=O,,,5,1,2,0,2
55130_0,,,,2,2,1,3
C(C(C)C(C=O)C(C(C=O)=CC)O)=O,,,5,1,1,0,1
55132_0,,,,2,2,1,3
C(CC(C=O)(C)C(C(C=O)=CC)O)=O,,,5,1,1,0,1
55134_0,,,,2,2,1,3
C(C(CC(C(C=O)=CC)O)CC=O)=O,,,5,1,1,0,1
55136_0,,,,2,2,1,3
C(C(CC(C)=O)C(C(C=O)=CC)O)=O,,,5,1,1,0,1
55138_0,,,,2,2,1,3
C(CC(C(C)=O)C(C(C=O)=CC)O)=O,,,5,1,1,0,1
55140_0,,,,2,2,1,3
C(C)=C(C=O)C(CCC(C=O)=O)O,,,5,1,1,0,1
55142_0,,,,2,2,1,3
C(C)=C(C=O)C(C(C)CC(C=O)=O)O,,,5,1,1,0,1
55144_0,,,,2,2,1,3
C(CCC(C(C=O)=CC)O)=O,,,5,1,1,0,1
55146_0,,,,2,2,1,3
C(C(C=C)CC(C(C=O)=CC)O)(O)=O,,,5,1,1,0,1
55147_0,,,,2,2,1,3
55148_0,,,,2,2,1,3
55149_0,,,,2,2,1,3
55151_0,,,,2,2,1,3
C(C(C)C(C=O)CC=C(C=O)CO)=O,,,5,1,1,0,1
55153_0,,,,2,2,1,3
C(C(C)(CC=O)CC=C(C=O)CO)=O,,,5,1,1,0,1
55155_0,,,,2,2,1,3
C(C(CCC=C(C=O)CO)CC=O)=O,,,5,1,1,0,1
55157_0,,,,2,2,1,3
C(C(CC(C)=O)CC=C(C=O)CO)=O,,,5,1,1,0,1
55159_0,,,,2,2,1,3
C(CC(C(C)=O)CC=C(C=O)CO)=O,,,5,1,1,0,1
55161_0,,,,2,2,1,3
C(CCCC(C=O)=O)=C(C=O)CO,,,5,1,1,0,1
55163_0,,,,2,2,1,3
C(CC(C)CC(C=O)=O)=C(C=O)CO,,,5,1,1,0,1
55165_0,,,,2,2,1,3
C(CCCC=C(C=O)CO)=O,,,5,1,1,0,1
55167_0,,,,2,2,1,3
C(C(C=C)CCC=C(C=O)CO)(O)=O,,,5,1,1,0,1
55168_0,,,,2,2,1,3
55169_0,,,,2,2,1,3
55170_0,,,,2,2,1,3
55172_0,,,,2,2,1,3
C(C(CO)C(C)CC(C=O)=CC=O)=O,,,5,1,1,0,1
55174_0,,,,2,2,1,3
C(C(C(C=O)=C)C(C)C(C=O)CO)=O,,,5,1,1,0,1
55176_0,,,,2,2,1,3
C(C(CO)C(C)CC(C=CC=O)=O)=O,,,5,1,1,0,1
55178_0,,,,2,2,1,3
C(C(CO)C(C)C(C=C)C(C=O)=O)=O,,,5,1,1,0,1
55180_0,,,,2,2,1,3
C(C(CO)C(C)CC=CC(C=O)=O)=O,,,5,1,1,0,1
55182_0,,,,2,2,1,3
C(C(CO)C(C)CC(C=C)O)=O,,,5,1,1,0,1
55184_0,,,,2,2,1,3
C(C(CO)C(C)C(C=C)(C)O)=O,,,5,1,1,0,1
55186_0,,,,2,2,1,3
C(C(CO)C(C)C(C=C)(CO)O)=O,,,5,1,1,0,1
55188_0,,,,2,2,1,3
C(C(CO)C(C)C(C(C=C)O)O)=O,,,5,1,1,0,1
55190_0,,,,2,2,1,3
C(C(CO)C(C)C(C=O)(CC)O)=O,,,5,1,1,0,1
55192_0,,,,2,2,1,3
C(C(CO)C(C)CCC(C=O)O)=O,,,5,1,1,0,1
55194_0,,,,2,2,1,3
C(C(CO)C(C)C(C)C(C=O)O)=O,,,5,1,1,0,1
55196_0,,,,2,2,1,3
C(C(CCO)C(C)C(C=O)CO)=O,,,5,1,1,0,1
55198_0,,,,2,2,1,3
C(C(CO)C(C)C(CCC=O)O)=O,,,5,1,1,0,1
55200_0,,,,2,2,1,3
C(C(CO)C(C)C(CO)CC=O)=O,,,5,1,1,0,1
55202_0,,,,2,2,1,3
C(C(CO)C([CH]C(O)=O)C)=O,,,5,1,1,0,1
55204_0,,,,2,2,1,3
C(C(CO)C(C)C(C=O)(O)O)=O,,,5,1,1,0,1
55205_0,,,,2,2,1,3
55206_0,,,,2,2,1,3
55207_0,,,,2,2,1,3
55208_0,,,,2,2,1,3
55209_0,,,,2,2,1,3
55210_0,,,,2,2,1,3
55211_0,,,,2,2,1,3
55212_0,,,,2,2,1,3
55213_0,,,,2,2,1,3
55214_0,,,,2,2,1,3
55215_0,,,,2,2,1,3
55216_0,,,,2,2,1,3
55217_0,,,,2,2,1,3
55218_0,,,,2,2,1,3
55219_0,,,,2,2,1,3
55220_0,,,,2,2,1,3
55221_0,,,,2,2,1,3
55222_0,,,,2,2,1,3
55223_0,,,,2,2,1,3
55224_0,,,,2,2,1,3
55225_0,,,,2,2,1,3
55226_0,,,,2,2,1,3
55227_0,,,,2,2,1,3
55228_0,,,,2,2,1,3
55229_0,,,,2,2,1,3
55230_0,,,,2,2,1,3
55231_0,,,,2,2,1,3
55232_0,,,,2,2,1,3
55233_0,,,,2,2,1,3
55234_0,,,,2,2,1,3
55235_0,,,,2,2,1,3
55236_0,,,,2,2,1,3
55237_0,,,,2,2,1,3
55238_0,,,,2,2,1,3
55239_0,,,,2,2,1,3
55240_0,,,,2,2,1,3
55241_0,,,,2,2,1,3
55242_0,,,,2,2,1,3
55244_0,,,,2,2,1,3
C(CCCC(C=O)=O)=C(C=O)C(C)O,,,5,1,1,0,1
55246_0,,,,2,2,1,3
C(CCCC=C(C=O)C(C)O)=O,,,5,1,1,0,1
55248_0,,,,2,2,1,3
C(CC[CH]C(O)=O)=C(C=O)C(C)O,,,5,1,1,0,1
55250_0,,,,2,2,1,3
C(CCCC=C(C=O)C(C)O)(O)=O,,,5,1,1,0,1
55252_0,,,,2,2,1,3
C(CC(C)CC=C(C=O)C(C)O)=O,,,5,1,1,0,1
55254_0,,,,2,2,1,3
C(C)=C(C=O)C(CCCC(C=O)=O)O,,,5,1,1,0,1
55256_0,,,,2,2,1,3
C(CCCC(C(C=O)=CC)O)=O,,,5,1,1,0,1
55258_0,,,,2,2,1,3
C(C)=C(C=O)C(CC[CH]C(O)=O)O,,,5,1,1,0,1
55260_0,,,,2,2,1,3
C(CCCC(C(C=O)=CC)O)(O)=O,,,5,1,1,0,1
55262_0,,,,2,2,1,3
C(CC(C)CC(C(C=O)=CC)O)=O,,,5,1,1,0,1
55264_0,,,,2,2,1,3
C(C)=C(C=O)C(C)(CCC(C=O)=O)O,,,5,1,1,0,1
55266_0,,,,2,2,1,3
C(CCC(C(C=O)=CC)(C)O)=O,,,5,1,1,0,1
55268_0,,,,2,2,1,3
C(C)=C(C=O)C(C)(C[CH]C(O)=O)O,,,5,1,1,0,1
55270_0,,,,2,2,1,3
C(CCC(C(C=O)=CC)(C)O)(O)=O,,,5,1,1,0,1
55272_0,,,,2,2,1,3
C(CC(C)C(C(C=O)=CC)(C)O)=O,,,5,1,1,0,1
55274_0,,,,2,2,1,3
C(C(C(C)O)C(C)CC(C=C)O)=O,,,5,1,1,0,1
55276_0,,,,2,2,1,3
C(C(C(C)O)C(C)C(C=C)(C)O)=O,,,5,1,1,0,1
55278_0,,,,2,2,1,3
C(C(C(C)O)C([CH]C(O)=O)C)=O,,,5,1,1,0,1
55280_0,,,,2,2,1,3
C(C(C(C)O)C(C)C(C=O)(O)O)=O,,,5,1,1,0,1
55281_0,,,,2,2,1,3
55282_0,,,,2,2,1,3
55283_0,,,,2,2,1,3
55284_0,,,,2,2,1,3
55285_0,,,,2,2,1,3
55286_0,,,,2,2,1,3
55287_0,,,,2,2,1,3
55288_0,,,,2,2,1,3
55289_0,,,,2,2,1,3
55290_0,,,,2,2,1,3
55291_0,,,,2,2,1,3
55292_0,,,,2,2,1,3
55293_0,,,,2,2,1,3
55294_0,,,,2,2,1,3
55295_0,,,,2,2,1,3
55296_0,,,,2,2,1,3
55297_0,,,,2,2,1,3
55299_0,,,,2,2,1,3
C(CCCC(C=O)=O)=C(C=O)C(O)=O,,,5,1,1,0,1
55301_0,,,,2,2,1,3
C(CCCC=C(C=O)C(O)=O)=O,,,5,1,1,0,1
55303_0,,,,2,2,1,3
C(CC[CH]C(O)=O)=C(C=O)C(O)=O,,,5,1,1,0,1
55305_0,,,,2,2,1,3
C(CCCC=C(C=O)C(O)=O)(O)=O,,,5,1,1,0,1
55307_0,,,,2,2,1,3
C(CC(C)CC=C(C=O)C(O)=O)=O,,,5,1,1,0,1
55309_0,,,,2,2,1,3
C(C(C=O)C(C)CC(C=C)O)(O)=O,,,5,1,1,0,1
55311_0,,,,2,2,1,3
C(C(C=O)C(C)C(C=C)(C)O)(O)=O,,,5,1,1,0,1
55313_0,,,,2,2,1,3
C(C(C(O)=O)C([CH]C(O)=O)C)=O,,,5,1,1,0,1
55315_0,,,,2,2,1,3
C(C(C=O)C(C)C(C=O)(O)O)(O)=O,,,5,1,1,0,1
55316_0,,,,2,2,1,3
55317_0,,,,2,2,1,3
55318_0,,,,2,2,1,3
55319_0,,,,2,2,1,3
55320_0,,,,2,2,1,3
55321_0,,,,2,2,1,3
55322_0,,,,2,2,1,3
55323_0,,,,2,2,1,3
55324_0,,,,2,2,1,3
55325_0,,,,2,2,1,3
55326_0,,,,2,2,1,3
55327_0,,,,2,2,1,3
55328_0,,,,2,2,1,3
55329_0,,,,2,2,1,3
55330_0,,,,2,2,1,3
55331_0,,,,2,2,1,3
55332_0,,,,2,2,1,3
55333_0,,,,2,2,1,3
55334_0,,,,2,2,1,3
55335_0,,,,2,2,1,3
55336_0,,,,2,2,1,3
55338_0,,,,2,2,1,3
C(C(CO)(CC(C)O)CC=O)(O)=O,,,5,1,1,0,1
55340_0,,,,2,2,1,3
C(C(C(CO)C(C)O)CC=O)(O)=O,,,5,1,1,0,1
55342_0,,,,2,2,1,3
C(CCC(C(C(O)=O)=O)C(C)O)=O,,,5,1,2,0,2
55343_0,,,,2,2,1,3
55345_0,,,,2,2,1,3
C(C(C(CCCO)C(C)O)=O)(O)=O,,,5,1,1,0,1
55346_0,,,,2,2,1,3
55347_0,,,,2,2,1,3
55348_0,,,,2,2,1,3
55349_0,,,,2,2,1,3
55350_0,,,,2,2,1,3
55351_0,,,,2,2,1,3
55352_0,,,,2,2,1,3
55354_0,,,,2,2,1,3
C(C(C=O)C(CO)CC(O)=O)(O)=O,,,5,1,2,0,2
55355_0,,,,2,2,1,3
55357_0,,,,2,2,1,3
C(CC(CO)C(C(C=O)=O)O)(O)=O,,,5,1,1,0,1
55359_0,,,,2,2,1,3
C(CCC(C(O)=O)C=CC(C=O)=O)=O,,,5,1,1,0,1
55361_0,,,,2,2,1,3
C(CC(CC(O)=O)CC(C=O)=O)=O,,,5,1,4,0,4
55363_0,,,,2,2,1,3
C(CC(CO)CC(C=O)=O)(O)=O,,,5,1,2,0,2
55365_0,,,,2,2,1,3
C(CC(CCO)CC(C=O)=O)(O)=O,,,5,1,2,0,2
55367_0,,,,2,2,1,3
C(CC(C(C)O)CC(C=O)=O)(O)=O,,,5,1,3,0,3
55369_0,,,,2,2,1,3
C(CCC(C=CC(O)=O)C(C=O)=O)=O,,,5,1,1,0,1
55370_0,,,,2,2,1,3
55371_0,,,,2,2,1,3
55372_0,,,,2,2,1,3
55373_0,,,,2,2,1,3
55375_0,,,,2,2,1,3
C(C(C=CC=O)CCC(C=O)=O)(O)=O,,,5,1,1,0,1
55377_0,,,,2,2,1,3
C(CCC(C(O)=O)C=CC=O)=O,,,5,1,2,0,2
55379_0,,,,2,2,1,3
C(C(C=CC=O)C[CH]C(O)=O)(O)=O,,,5,1,1,0,1
55381_0,,,,2,2,1,3
C(C(C=CC=O)CCC(O)=O)(O)=O,,,5,1,1,0,1
55383_0,,,,2,2,1,3
C(CC(C)C(C(O)=O)C=CC=O)=O,,,5,1,1,0,1
55385_0,,,,2,2,1,3
C(CC(CC(C=C)O)CC=O)(O)=O,,,5,1,2,0,2
55387_0,,,,2,2,1,3
C(CC(CC=O)C(C=C)(C)O)(O)=O,,,5,1,2,0,2
55389_0,,,,2,2,1,3
C(CC([CH]C(O)=O)CC(O)=O)=O,,,5,1,3,0,3
55391_0,,,,2,2,1,3
C(CC(C(C=O)(O)O)CC=O)(O)=O,,,5,1,2,0,2
55393_0,,,,2,2,1,3
C(CC(CC=O)CC(O)=O)=O,,,5,1,2,0,2
55394_0,,,,2,2,1,3
55396_0,,,,2,2,1,3
C(CC(C(C(O)=O)O)CC=O)(O)=O,,,5,1,3,0,3
55398_0,,,,2,2,1,3
C(CC(C(CO)O)CC=O)(O)=O,,,5,1,2,0,2
55400_0,,,,2,2,1,3
C(C(C(CC(O)=O)CC=O)CO)=O,,,5,1,2,0,2
55402_0,,,,2,2,1,3
C(CC(C(CC=O)O)CC=O)(O)=O,,,5,1,2,0,2
55404_0,,,,2,2,1,3
C(CC(CC=O)CC(CO)=O)(O)=O,,,5,1,2,0,2
55406_0,,,,2,2,1,3
C(CC(C(C(C)=O)O)CC=O)(O)=O,,,5,1,2,0,2
55408_0,,,,2,2,1,3
C(CC(CO)CC=O)(O)=O,,,5,1,2,0,2
55410_0,,,,2,2,1,3
C(CC(CCO)CC=O)(O)=O,,,5,1,2,0,2
55412_0,,,,2,2,1,3
C(CC(C(C)O)CC=O)(O)=O,,,5,1,3,0,3
55414_0,,,,2,2,1,3
C(CC(CC(O)=O)CC(O)=O)=O,,,5,1,3,0,3
55416_0,,,,2,2,1,3
C(CC(CC(O)=O)CC=CC=O)=O,,,5,1,2,0,2
55418_0,,,,2,2,1,3
C(C(C=C)C(CC=O)CC(O)=O)=O,,,5,1,2,0,2
55420_0,,,,2,2,1,3
C(CC(C(C=O)O)CC=O)(O)=O,,,5,1,2,0,2
55422_0,,,,2,2,1,3
C(CC(CC(C=O)O)CC=O)(O)=O,,,5,1,2,0,2
55424_0,,,,2,2,1,3
C(C(C)(C(CC(O)=O)CC=O)O)=O,,,5,1,2,0,2
55426_0,,,,2,2,1,3
C(C(C=CC(O)=O)CCC(C=O)=O)=O,,,5,1,1,0,1
55428_0,,,,2,2,1,3
C(C(C=CC(O)=O)CCC=O)=O,,,5,1,1,0,1
55430_0,,,,2,2,1,3
C(C(C=CC(O)=O)C[CH]C(O)=O)=O,,,5,1,1,0,1
55432_0,,,,2,2,1,3
C(C(C=CC(O)=O)CCC(O)=O)=O,,,5,1,1,0,1
55434_0,,,,2,2,1,3
C(C(C=CC(O)=O)C(C)CC=O)=O,,,5,1,1,0,1
55435_0,,,,2,2,1,3
55436_0,,,,2,2,1,3
55437_0,,,,2,2,1,3
55438_0,,,,2,2,1,3
55439_0,,,,2,2,1,3
55440_0,,,,2,2,1,3
55441_0,,,,2,2,1,3
55442_0,,,,2,2,1,3
55443_0,,,,2,2,1,3
55444_0,,,,2,2,1,3
55445_0,,,,2,2,1,3
55446_0,,,,2,2,1,3
55447_0,,,,2,2,1,3
55448_0,,,,2,2,1,3
55449_0,,,,2,2,1,3
55450_0,,,,2,2,1,3
55451_0,,,,2,2,1,3
55452_0,,,,2,2,1,3
55453_0,,,,2,2,1,3
55454_0,,,,2,2,1,3
55455_0,,,,2,2,1,3
55457_0,,,,2,2,1,3
C(CC(CO)CC(C(O)=O)=O)(O)=O,,,5,1,2,0,2
55458_0,,,,2,2,1,3
55460_0,,,,2,2,1,3
C(C(C=O)C(C(CO)=O)CO)(O)=O,,,5,1,1,0,1
55462_0,,,,2,2,1,3
C(C(C=O)(CO)CC(CO)=O)(O)=O,,,5,1,1,0,1
55464_0,,,,2,2,1,3
C(C(C=O)C(C=O)(CO)CO)(O)=O,,,5,1,1,0,1
55466_0,,,,2,2,1,3
C(C(C=O)(CO)C(C=O)CO)(O)=O,,,5,1,1,0,1
55468_0,,,,2,2,1,3
C(C(C(O)=O)(C(C=O)=C)CCC=O)=O,,,5,1,1,0,1
55469_0,,,,2,2,1,3
55471_0,,,,2,2,1,3
C(C(C=O)C(C=O)CCO)(O)=O,,,5,1,1,0,1
55473_0,,,,2,2,1,3
C(C(C=O)C(C=O)CCCO)(O)=O,,,5,1,1,0,1
55475_0,,,,2,2,1,3
C(C(C=O)C(C=O)CC(C)O)(O)=O,,,5,1,1,0,1
55477_0,,,,2,2,1,3
C(CCCC(C=O)=C(C=O)C(O)=O)=O,,,5,1,1,0,1
55479_0,,,,2,2,1,3
C(C(C)(CC=O)C(C=O)C(O)=O)=O,,,5,1,2,0,2
55481_0,,,,2,2,1,3
C(C(C=O)C(C=O)(C)CO)(O)=O,,,5,1,1,0,1
55483_0,,,,2,2,1,3
C(C(C=O)C(C=O)(C)CCO)(O)=O,,,5,1,1,0,1
55485_0,,,,2,2,1,3
C(C(C=O)C(C=O)(C)C(C)O)(O)=O,,,5,1,1,0,1
55487_0,,,,2,2,1,3
C(C(C)C(C=O)(C(O)=O)CC=O)=O,,,5,1,1,0,1
55488_0,,,,2,2,1,3
55490_0,,,,2,2,1,3
C(C(C=O)(CCO)C(C=O)C)(O)=O,,,5,1,1,0,1
55492_0,,,,2,2,1,3
C(C(C=O)(C(C)O)C(C=O)C)(O)=O,,,5,1,1,0,1
55494_0,,,,2,2,1,3
C(CCCC(C=C(C=O)C(O)=O)=O)=O,,,5,1,1,0,1
55496_0,,,,2,2,1,3
C(C(C(O)=O)C(C(C)=O)CC=O)=O,,,5,1,2,0,2
55498_0,,,,2,2,1,3
C(C(C=O)C(C(C)=O)CO)(O)=O,,,5,1,1,0,1
55500_0,,,,2,2,1,3
C(C(C=O)C(C(C)=O)CCO)(O)=O,,,5,1,1,0,1
55502_0,,,,2,2,1,3
C(C(C=O)C(C(C)=O)C(C)O)(O)=O,,,5,1,1,0,1
55504_0,,,,2,2,1,3
C(C(C(O)=O)(CC(C)=O)CC=O)=O,,,5,1,1,0,1
55505_0,,,,2,2,1,3
55507_0,,,,2,2,1,3
C(C(C=O)(CCO)CC(C)=O)(O)=O,,,5,1,1,0,1
55509_0,,,,2,2,1,3
C(C(C=O)(C(C)O)CC(C)=O)(O)=O,,,5,1,1,0,1
55510_0,,,,2,2,1,3
55511_0,,,,2,2,1,3
55513_0,,,,2,2,1,3
C(C(C)(CC(CO)CC=O)O)(O)=O,,,5,1,1,0,1
55515_0,,,,2,2,1,3
C(CCC(C=O)C(C(O)=O)(C)O)=O,,,5,1,2,0,2
55516_0,,,,2,2,1,3
55518_0,,,,2,2,1,3
C(C(CCCO)C(C(O)=O)(C)O)=O,,,5,1,1,0,1
55520_0,,,,2,2,1,3
C(C(CC(C)O)C(C(O)=O)(C)O)=O,,,5,1,1,0,1
55521_0,,,,2,2,1,3
55522_0,,,,2,2,1,3
55523_0,,,,2,2,1,3
55524_0,,,,2,2,1,3
55526_0,,,,2,2,1,3
C(C(C)C(C=O)(CO)CC=O)(O)=O,,,5,1,1,0,1
55527_0,,,,2,2,1,3
55529_0,,,,2,2,1,3
C(C(CO)(CCO)C(C(O)=O)C)=O,,,5,1,1,0,1
55530_0,,,,2,2,1,3
55532_0,,,,2,2,1,3
C(CC(C(O)=O)C(C=O)CO)(O)=O,,,5,1,2,0,2
55534_0,,,,2,2,1,3
C(C(CO)(CC(O)=O)CC=O)(O)=O,,,5,1,3,0,3
55536_0,,,,2,2,1,3
C(C(CO)C(C(O)=O)CC=O)(O)=O,,,5,1,1,0,1
55537_0,,,,2,2,1,3
55539_0,,,,2,2,1,3
C(CCC(C(O)=O)C(C(O)=O)=O)=O,,,5,1,2,0,2
55540_0,,,,2,2,1,3
55542_0,,,,2,2,1,3
C(C(C(C(O)=O)=O)CCCO)(O)=O,,,5,1,1,0,1
55543_0,,,,2,2,1,3
55545_0,,,,2,2,1,3
C(CCC(C(C=CC(C=O)=O)=O)O)=O,,,5,1,1,0,1
55547_0,,,,2,2,1,3
C(CC(C(C=O)=O)CC(CO)=O)=O,,,5,1,1,0,1
55548_0,,,,2,2,1,3
55550_0,,,,2,2,1,3
C(CC(C(C=O)=O)CCO)(CO)=O,,,5,1,1,0,1
55552_0,,,,2,2,1,3
C(CC(C(C=O)=O)C(C)O)(CO)=O,,,5,1,1,0,1
55554_0,,,,2,2,1,3
C(CC(C(CO)=O)CC(C=O)=O)=O,,,5,1,2,0,2
55556_0,,,,2,2,1,3
C(CO)(C(CO)CC(C=O)=O)=O,,,5,1,1,0,1
55558_0,,,,2,2,1,3
C(CO)(C(CCO)CC(C=O)=O)=O,,,5,1,1,0,1
55560_0,,,,2,2,1,3
C(CO)(C(C(C)O)CC(C=O)=O)=O,,,5,1,1,0,1
55562_0,,,,2,2,1,3
C(C=O)(CCC(C(C=CC=O)=O)O)=O,,,5,1,1,0,1
55564_0,,,,2,2,1,3
C(CCC(C(C=CC=O)=O)O)=O,,,5,1,1,0,1
55566_0,,,,2,2,1,3
C([CH]CC(C(C=CC=O)=O)O)(O)=O,,,5,1,1,0,1
55568_0,,,,2,2,1,3
C(CCC(C(C=CC=O)=O)O)(O)=O,,,5,1,1,0,1
55570_0,,,,2,2,1,3
C(CC(C)C(C(C=CC=O)=O)O)=O,,,5,1,1,0,1
55572_0,,,,2,2,1,3
C(C(CC(C=C)O)CC(CO)=O)=O,,,5,1,1,0,1
55574_0,,,,2,2,1,3
C(CC(C=O)C(C=C)(C)O)(CO)=O,,,5,1,1,0,1
55576_0,,,,2,2,1,3
C(C([CH]C(O)=O)CC(CO)=O)=O,,,5,1,1,0,1
55578_0,,,,2,2,1,3
C(C(C(C=O)CC(CO)=O)(O)O)=O,,,5,1,1,0,1
55580_0,,,,2,2,1,3
C(CC(C=O)CC(CO)=O)=O,,,5,1,1,0,1
55582_0,,,,2,2,1,3
C(C(CC(C=O)=O)CC(CO)=O)=O,,,5,1,1,0,1
55584_0,,,,2,2,1,3
C(C(C(C=O)CC(CO)=O)O)(O)=O,,,5,1,1,0,1
55586_0,,,,2,2,1,3
C(C(C(CO)O)CC(CO)=O)=O,,,5,1,1,0,1
55588_0,,,,2,2,1,3
C(CC(C=O)C(C=O)CO)(CO)=O,,,5,1,2,0,2
55590_0,,,,2,2,1,3
C(CC(C(C=O)CC(CO)=O)O)=O,,,5,1,1,0,1
55592_0,,,,2,2,1,3
C(C(CC(CO)=O)CC(CO)=O)=O,,,5,1,1,0,1
55594_0,,,,2,2,1,3
C(C(CC(CO)=O)C(C(C)=O)O)=O,,,5,1,1,0,1
55595_0,,,,2,2,1,3
55597_0,,,,2,2,1,3
C(C(CCO)CC(CO)=O)=O,,,5,1,1,0,1
55598_0,,,,2,2,1,3
55600_0,,,,2,2,1,3
C(CC(C=O)CC(CO)=O)(O)=O,,,5,1,1,0,1
55602_0,,,,2,2,1,3
C(C(CC(CO)=O)CC=CC=O)=O,,,5,1,1,0,1
55604_0,,,,2,2,1,3
C(C(C=C)C(C=O)CC(CO)=O)=O,,,5,1,1,0,1
55606_0,,,,2,2,1,3
C(C(C(C=O)CC(CO)=O)O)=O,,,5,1,1,0,1
55608_0,,,,2,2,1,3
C(C(CC(C=O)CC(CO)=O)O)=O,,,5,1,1,0,1
55610_0,,,,2,2,1,3
C(CC(C=O)C(C=O)(C)O)(CO)=O,,,5,1,1,0,1
55612_0,,,,2,2,1,3
C(CO)(C(CC(C=C)O)CC=O)=O,,,5,1,1,0,1
55614_0,,,,2,2,1,3
C(CC(C(CO)=O)C(C=C)(C)O)=O,,,5,1,1,0,1
55616_0,,,,2,2,1,3
C(CC(C(CO)=O)[CH]C(O)=O)=O,,,5,1,1,0,1
55618_0,,,,2,2,1,3
C(CC(C(CO)=O)C(C=O)(O)O)=O,,,5,1,1,0,1
55620_0,,,,2,2,1,3
C(CC(C(CO)=O)CC=O)=O,,,5,1,1,0,1
55621_0,,,,2,2,1,3
55623_0,,,,2,2,1,3
C(C(C(C(CO)=O)CC=O)O)(O)=O,,,5,1,1,0,1
55625_0,,,,2,2,1,3
C(CO)(C(C(CO)O)CC=O)=O,,,5,1,1,0,1
55627_0,,,,2,2,1,3
C(CC(C(CO)=O)C(C=O)CO)=O,,,5,1,1,0,1
55629_0,,,,2,2,1,3
C(CO)(C(C(CC=O)O)CC=O)=O,,,5,1,1,0,1
55631_0,,,,2,2,1,3
C(CC(C(CO)=O)CC(CO)=O)=O,,,5,1,1,0,1
55633_0,,,,2,2,1,3
C(CC(C(CO)=O)C(C(C)=O)O)=O,,,5,1,1,0,1
55635_0,,,,2,2,1,3
C(CO)(C(CO)CC=O)=O,,,5,1,1,0,1
55637_0,,,,2,2,1,3
C(CO)(C(CCO)CC=O)=O,,,5,1,1,0,1
55639_0,,,,2,2,1,3
C(CO)(C(C(C)O)CC=O)=O,,,5,1,1,0,1
55641_0,,,,2,2,1,3
C(CC(C(CO)=O)CC=O)(O)=O,,,5,1,1,0,1
55643_0,,,,2,2,1,3
C(CC(C(CO)=O)CC=CC=O)=O,,,5,1,1,0,1
55645_0,,,,2,2,1,3
C(C(C=C)C(C(CO)=O)CC=O)=O,,,5,1,1,0,1
55647_0,,,,2,2,1,3
C(CC(C(CO)=O)C(C=O)O)=O,,,5,1,1,0,1
55649_0,,,,2,2,1,3
C(CO)(C(CC(C=O)O)CC=O)=O,,,5,1,1,0,1
55651_0,,,,2,2,1,3
C(CC(C(CO)=O)C(C=O)(C)O)=O,,,5,1,1,0,1
55653_0,,,,2,2,1,3
C(CC(C(C(O)=O)=O)CO)(CO)=O,,,5,1,1,0,1
55655_0,,,,2,2,1,3
C(CO)(C(CO)CC(C(O)=O)=O)=O,,,5,1,1,0,1
55657_0,,,,2,2,1,3
C(CCC(C(C=O)=CC(C=O)=O)O)=O,,,5,1,1,0,1
55659_0,,,,2,2,1,3
C(CC(C(C=O)=O)C(C=O)CO)=O,,,5,1,1,0,1
55660_0,,,,2,2,1,3
55662_0,,,,2,2,1,3
C(C(CO)C(C(C=O)=O)CCO)=O,,,5,1,1,0,1
55664_0,,,,2,2,1,3
C(C(CO)C(C(C=O)=O)C(C)O)=O,,,5,1,1,0,1
55666_0,,,,2,2,1,3
C(C(CO)(CC=O)CC(C=O)=O)=O,,,5,1,2,0,2
55668_0,,,,2,2,1,3
C(C(CO)(CO)CC(C=O)=O)=O,,,5,1,1,0,1
55670_0,,,,2,2,1,3
C(C(CO)(CCO)CC(C=O)=O)=O,,,5,1,1,0,1
55672_0,,,,2,2,1,3
C(C(CO)(C(C)O)CC(C=O)=O)=O,,,5,1,1,0,1
55674_0,,,,2,2,1,3
C(C=O)(CCC(C(C=O)=CC=O)O)=O,,,5,1,1,0,1
55676_0,,,,2,2,1,3
C(CCC(C(C=O)=CC=O)O)=O,,,5,1,1,0,1
55678_0,,,,2,2,1,3
C([CH]CC(C(C=O)=CC=O)O)(O)=O,,,5,1,1,0,1
55680_0,,,,2,2,1,3
C(CCC(C(C=O)=CC=O)O)(O)=O,,,5,1,1,0,1
55682_0,,,,2,2,1,3
C(CC(C)C(C(C=O)=CC=O)O)=O,,,5,1,1,0,1
55684_0,,,,2,2,1,3
C(C(CC(C=C)O)C(C=O)CO)=O,,,5,1,1,0,1
55686_0,,,,2,2,1,3
C(C(CO)C(C=O)C(C=C)(C)O)=O,,,5,1,1,0,1
55688_0,,,,2,2,1,3
C(C([CH]C(O)=O)C(C=O)CO)=O,,,5,1,1,0,1
55690_0,,,,2,2,1,3
C(C(C(C=O)(O)O)C(C=O)CO)=O,,,5,1,1,0,1
55692_0,,,,2,2,1,3
C(CC(C=O)C(C=O)CO)=O,,,5,1,1,0,1
55694_0,,,,2,2,1,3
C(C(CO)C(C=O)CC(C=O)=O)=O,,,5,1,1,0,1
55696_0,,,,2,2,1,3
C(C(C(C=O)C(C=O)CO)O)(O)=O,,,5,1,1,0,1
55698_0,,,,2,2,1,3
C(C(C(CO)O)C(C=O)CO)=O,,,5,1,1,0,1
55700_0,,,,2,2,1,3
C(C(CO)C(C=O)C(C=O)CO)=O,,,5,1,1,0,1
55702_0,,,,2,2,1,3
C(CC(C(C=O)C(C=O)CO)O)=O,,,5,1,1,0,1
55703_0,,,,2,2,1,3
55705_0,,,,2,2,1,3
C(C(C(C=O)C(C=O)CO)O)(C)=O,,,5,1,1,0,1
55706_0,,,,2,2,1,3
55708_0,,,,2,2,1,3
C(C(CCO)C(C=O)CO)=O,,,5,1,1,0,1
55709_0,,,,2,2,1,3
55711_0,,,,2,2,1,3
C(CC(C=O)C(C=O)CO)(O)=O,,,5,1,1,0,1
55713_0,,,,2,2,1,3
C(C(CO)C(C=O)CC=CC=O)=O,,,5,1,1,0,1
55715_0,,,,2,2,1,3
C(C(CO)C(C=O)C(C=O)C=C)=O,,,5,1,1,0,1
55717_0,,,,2,2,1,3
C(C(C(C=O)C(C=O)CO)O)=O,,,5,1,1,0,1
55719_0,,,,2,2,1,3
C(C(CC(C=O)C(C=O)CO)O)=O,,,5,1,1,0,1
55721_0,,,,2,2,1,3
C(C(CO)C(C=O)C(C=O)(C)O)=O,,,5,1,1,0,1
55723_0,,,,2,2,1,3
C(C(CO)(CC(C=C)O)CC=O)=O,,,5,1,1,0,1
55725_0,,,,2,2,1,3
C(C(CO)(CC=O)C(C=C)(C)O)=O,,,5,1,1,0,1
55727_0,,,,2,2,1,3
C(C([CH]C(O)=O)(CO)CC=O)=O,,,5,1,1,0,1
55729_0,,,,2,2,1,3
C(CC(C=O)(CO)C(C=O)(O)O)=O,,,5,1,1,0,1
55731_0,,,,2,2,1,3
C(C(CO)(CC=O)CC=O)=O,,,5,1,1,0,1
55732_0,,,,2,2,1,3
55734_0,,,,2,2,1,3
C(CC(C=O)(CO)C(C(O)=O)O)=O,,,5,1,1,0,1
55736_0,,,,2,2,1,3
C(C(CO)(C(CO)O)CC=O)=O,,,5,1,1,0,1
55738_0,,,,2,2,1,3
C(C(CO)C(C=O)(CO)CC=O)=O,,,5,1,1,0,1
55740_0,,,,2,2,1,3
C(C(CO)(C(CC=O)O)CC=O)=O,,,5,1,1,0,1
55742_0,,,,2,2,1,3
C(C(CO)(CC(CO)=O)CC=O)=O,,,5,1,1,0,1
55744_0,,,,2,2,1,3
C(CC(C=O)(CO)C(C(C)=O)O)=O,,,5,1,1,0,1
55746_0,,,,2,2,1,3
C(C(CO)(CO)CC=O)=O,,,5,1,1,0,1
55748_0,,,,2,2,1,3
C(C(CO)(CCO)CC=O)=O,,,5,1,1,0,1
55749_0,,,,2,2,1,3
55751_0,,,,2,2,1,3
C(C(CO)(CC(O)=O)CC=O)=O,,,5,1,1,0,1
55753_0,,,,2,2,1,3
C(C(CO)(CC=O)CC=CC=O)=O,,,5,1,1,0,1
55755_0,,,,2,2,1,3
C(C(CO)(CC=O)C(C=O)C=C)=O,,,5,1,1,0,1
55757_0,,,,2,2,1,3
C(CC(C=O)(CO)C(C=O)O)=O,,,5,1,1,0,1
55759_0,,,,2,2,1,3
C(C(CO)(CC(C=O)O)CC=O)=O,,,5,1,1,0,1
55761_0,,,,2,2,1,3
C(C(C)(C(C=O)(CO)CC=O)O)=O,,,5,1,1,0,1
55763_0,,,,2,2,1,3
C(C(CO)C(C(C(O)=O)=O)CO)=O,,,5,1,1,0,1
55765_0,,,,2,2,1,3
C(C(CO)(CO)CC(C(O)=O)=O)=O,,,5,1,1,0,1
55767_0,,,,2,2,1,3
C(CCC(C(C=O)=O)(C(C=O)=C)O)=O,,,5,1,1,0,1
55769_0,,,,2,2,1,3
C(CCC(C=O)C(C(C=O)=O)O)=O,,,5,1,1,0,1
55770_0,,,,2,2,1,3
55772_0,,,,2,2,1,3
C(C(CCCO)C(C(C=O)=O)O)=O,,,5,1,1,0,1
55774_0,,,,2,2,1,3
C(C(CC(C)O)C(C(C=O)=O)O)=O,,,5,1,1,0,1
55776_0,,,,2,2,1,3
C=CC(C(C=O)=O)(CCC(C=O)=O)O,,,5,1,1,0,1
55778_0,,,,2,2,1,3
C(CCC(C=C)(C(C=O)=O)O)=O,,,5,1,1,0,1
55780_0,,,,2,2,1,3
C=CC(C(C=O)=O)(C[CH]C(O)=O)O,,,5,1,1,0,1
55782_0,,,,2,2,1,3
C(CCC(C=C)(C(C=O)=O)O)(O)=O,,,5,1,1,0,1
55784_0,,,,2,2,1,3
C(CC(C)C(C=C)(C(C=O)=O)O)=O,,,5,1,1,0,1
55786_0,,,,2,2,1,3
C(CCCC(C=O)=CC(C=O)=O)=O,,,5,1,1,0,1
55788_0,,,,2,2,1,3
C(C(CC[CH]C(O)=O)=CC(C=O)=O)=O,,,5,1,1,0,1
55790_0,,,,2,2,1,3
C(CCCC(C=O)=CC(C=O)=O)(O)=O,,,5,1,1,0,1
55792_0,,,,2,2,1,3
C(CC(C)CC(C=O)=CC(C=O)=O)=O,,,5,1,1,0,1
55794_0,,,,2,2,1,3
C(C(C)C(C(C=O)=O)CC(C=C)O)=O,,,5,1,1,0,1
55796_0,,,,2,2,1,3
C(C(C)C(C(C=O)=O)C(C=C)(C)O)=O,,,5,1,1,0,1
55798_0,,,,2,2,1,3
C(C(C)C([CH]C(O)=O)C(C=O)=O)=O,,,5,1,1,0,1
55800_0,,,,2,2,1,3
C(CC(C(C=O)=O)C(C=O)C)=O,,,5,1,1,0,1
55802_0,,,,2,2,1,3
C(C(C)C(C(C=O)=O)CC(C=O)=O)=O,,,5,1,1,0,1
55804_0,,,,2,2,1,3
C(C(C)C(C(C=O)=O)C(CO)O)=O,,,5,1,1,0,1
55805_0,,,,2,2,1,3
55807_0,,,,2,2,1,3
C(C(C)C(C(C=O)=O)CCO)=O,,,5,1,1,0,1
55808_0,,,,2,2,1,3
55810_0,,,,2,2,1,3
C(C(C)C(C(C=O)=O)CC(O)=O)=O,,,5,1,1,0,1
55812_0,,,,2,2,1,3
C(C(C)C(C(C=O)=O)CC=CC=O)=O,,,5,1,1,0,1
55814_0,,,,2,2,1,3
C(C(C)C(C(C=O)=O)C(C=O)C=C)=O,,,5,1,1,0,1
55816_0,,,,2,2,1,3
C(C(C(C(C=O)=O)C(C=O)C)O)=O,,,5,1,1,0,1
55818_0,,,,2,2,1,3
C(C(C)(CC(C=C)O)CC(C=O)=O)=O,,,5,1,1,0,1
55820_0,,,,2,2,1,3
C(C(C)(CC(C=O)=O)C(C=C)(C)O)=O,,,5,1,1,0,1
55822_0,,,,2,2,1,3
C(C([CH]C(O)=O)(C)CC(C=O)=O)=O,,,5,1,1,0,1
55824_0,,,,2,2,1,3
C(C(C)(CC=O)CC(C=O)=O)=O,,,5,1,2,0,2
55826_0,,,,2,2,1,3
C(C(C)(CC(C=O)=O)CC(C=O)=O)=O,,,5,1,1,0,1
55828_0,,,,2,2,1,3
C(C(C)(C(CO)O)CC(C=O)=O)=O,,,5,1,1,0,1
55830_0,,,,2,2,1,3
C(C(C)(CO)CC(C=O)=O)=O,,,5,1,1,0,1
55832_0,,,,2,2,1,3
C(C(C)(CCO)CC(C=O)=O)=O,,,5,1,1,0,1
55834_0,,,,2,2,1,3
C(C(C)(C(C)O)CC(C=O)=O)=O,,,5,1,1,0,1
55836_0,,,,2,2,1,3
C(C(C)(CC(O)=O)CC(C=O)=O)=O,,,5,1,1,0,1
55838_0,,,,2,2,1,3
C(C(C)(CC(C=O)=O)CC=CC=O)=O,,,5,1,1,0,1
55840_0,,,,2,2,1,3
C(C(C)(CC(C=O)=O)C(C=O)C=C)=O,,,5,1,1,0,1
55842_0,,,,2,2,1,3
C(C(C)(C(C=O)O)CC(C=O)=O)=O,,,5,1,1,0,1
55844_0,,,,2,2,1,3
C(CCC(C(C=O)=O)C(C=O)=C)=O,,,5,1,1,0,1
55846_0,,,,2,2,1,3
C=C(C=O)C(C(C=O)=O)C[CH]C(O)=O,,,5,1,1,0,1
55848_0,,,,2,2,1,3
C(CCC(C(C=O)=O)C(C=O)=C)(O)=O,,,5,1,1,0,1
55850_0,,,,2,2,1,3
C(CC(C)C(C(C=O)=O)C(C=O)=C)=O,,,5,1,1,0,1
55852_0,,,,2,2,1,3
C(C(CCC(C=C)O)CC(C=O)=O)=O,,,5,1,1,0,1
55854_0,,,,2,2,1,3
C(C(CC(C=C)(C)O)CC(C=O)=O)=O,,,5,1,1,0,1
55856_0,,,,2,2,1,3
C(C(CC(C=O)=O)C[CH]C(O)=O)=O,,,5,1,1,0,1
55858_0,,,,2,2,1,3
C(CCC(C=O)CC(C=O)=O)=O,,,5,1,1,0,1
55860_0,,,,2,2,1,3
C(C(CCC(C=O)=O)CC(C=O)=O)=O,,,5,1,1,0,1
55862_0,,,,2,2,1,3
C(C(CC(CO)O)CC(C=O)=O)=O,,,5,1,1,0,1
55864_0,,,,2,2,1,3
C(C(CCO)CC(C=O)=O)=O,,,5,1,1,0,1
55866_0,,,,2,2,1,3
C(C(CCCO)CC(C=O)=O)=O,,,5,1,1,0,1
55868_0,,,,2,2,1,3
C(C(CC(C)O)CC(C=O)=O)=O,,,5,1,1,0,1
55870_0,,,,2,2,1,3
C(C(CCC(O)=O)CC(C=O)=O)=O,,,5,1,1,0,1
55872_0,,,,2,2,1,3
C(C(CCC=CC=O)CC(C=O)=O)=O,,,5,1,1,0,1
55874_0,,,,2,2,1,3
C(C(CC(C=O)C=C)CC(C=O)=O)=O,,,5,1,1,0,1
55876_0,,,,2,2,1,3
C(C(CC(C=O)CC(C=O)=O)O)=O,,,5,1,1,0,1
55877_0,,,,2,2,1,3
55879_0,,,,2,2,1,3
C(C(C)C(C=O)CC(C=O)=CC=O)=O,,,5,1,1,0,1
55881_0,,,,2,2,1,3
C(C(C)(CC=O)CC(C=O)=CC=O)=O,,,5,1,1,0,1
55883_0,,,,2,2,1,3
C(C(CCC(C=O)=CC=O)CC=O)=O,,,5,1,1,0,1
55885_0,,,,2,2,1,3
C(C(CC(C=O)=CC=O)CC(C)=O)=O,,,5,1,1,0,1
55887_0,,,,2,2,1,3
C(CC(C(C)=O)CC(C=O)=CC=O)=O,,,5,1,1,0,1
55889_0,,,,2,2,1,3
C(C(CCCC(C=O)=CC=O)=O)=O,,,5,1,1,0,1
55891_0,,,,2,2,1,3
C(C(CC(C)CC(C=O)=CC=O)=O)=O,,,5,1,1,0,1
55893_0,,,,2,2,1,3
C(CCCC(C=O)=CC=O)=O,,,5,1,1,0,1
55895_0,,,,2,2,1,3
C(C(O)=O)(CCCC(C=O)=CC=O)=O,,,5,1,1,0,1
55897_0,,,,2,2,1,3
C(C(C=C)CCC(C=O)=CC=O)(O)=O,,,5,1,1,0,1
55898_0,,,,2,2,1,3
55899_0,,,,2,2,1,3
55900_0,,,,2,2,1,3
55902_0,,,,2,2,1,3
C(C(C)C(C=O)C(C=O)C(C=O)=C)=O,,,5,1,1,0,1
55904_0,,,,2,2,1,3
C(C(C)C(C=O)CC(C=CC=O)=O)=O,,,5,1,1,0,1
55906_0,,,,2,2,1,3
C(C(C)C(C=O)C(C=C)C(C=O)=O)=O,,,5,1,1,0,1
55908_0,,,,2,2,1,3
C(C(C)C(C=O)CC=CC(C=O)=O)=O,,,5,1,1,0,1
55910_0,,,,2,2,1,3
C(C(CC(C=C)O)C(C=O)C)=O,,,5,1,1,0,1
55912_0,,,,2,2,1,3
C(C(C)C(C=O)C(C=C)(C)O)=O,,,5,1,1,0,1
55914_0,,,,2,2,1,3
C(C(C)C(C=O)C(C=C)(CO)O)=O,,,5,1,1,0,1
55916_0,,,,2,2,1,3
C(C(C(C(C=C)O)O)C(C=O)C)=O,,,5,1,1,0,1
55918_0,,,,2,2,1,3
C(C(C)C(C=O)C(C=O)(CC)O)=O,,,5,1,1,0,1
55920_0,,,,2,2,1,3
C(C(CCC(C=O)C(C=O)C)O)=O,,,5,1,1,0,1
55922_0,,,,2,2,1,3
C(C(C(C)C(C=O)C(C=O)C)O)=O,,,5,1,1,0,1
55924_0,,,,2,2,1,3
C(C(C)C(C=O)C(C=O)CCO)=O,,,5,1,1,0,1
55926_0,,,,2,2,1,3
C(CCC(C(C=O)C(C=O)C)O)=O,,,5,1,1,0,1
55928_0,,,,2,2,1,3
C(CC(CO)C(C=O)C(C=O)C)=O,,,5,1,1,0,1
55930_0,,,,2,2,1,3
C(C(C)C(C=O)C1C(C(OC1)=O)=O)=O,,,5,1,1,0,1
55932_0,,,,2,2,1,3
C(C(C)C(C=O)C1CC(C(O1)=O)=O)=O,,,5,1,1,0,1
55934_0,,,,2,2,1,3
C(C([CH]C(O)=O)C(C=O)C)=O,,,5,1,1,0,1
55936_0,,,,2,2,1,3
C(C(C(C=O)(O)O)C(C=O)C)=O,,,5,1,1,0,1
55938_0,,,,2,2,1,3
C(CC(C=O)C(C=O)C)=O,,,5,1,1,0,1
55940_0,,,,2,2,1,3
C(C(C)C(C=O)C[C](C(O)=O)O)=O,,,5,1,1,0,1
55942_0,,,,2,2,1,3
C(C(CC(C=O)C(C=O)C)O)(O)=O,,,5,1,1,0,1
55944_0,,,,2,2,1,3
C(C(C)(C(C=O)C(C=O)C)O)(O)=O,,,5,1,1,0,1
55946_0,,,,2,2,1,3
C(C(C)C(C=O)C(C=O)C(C)O)=O,,,5,1,1,0,1
55948_0,,,,2,2,1,3
C(CC(CC(C=O)C(C=O)C)O)=O,,,5,1,1,0,1
55950_0,,,,2,2,1,3
C(CC(C)(C(C=O)C(C=O)C)O)=O,,,5,1,1,0,1
55952_0,,,,2,2,1,3
C(C(C)C(C=O)C(C=O)C(O)=O)=O,,,5,1,1,0,1
55954_0,,,,2,2,1,3
C(C(C)C(C=O)C(C(C=O)=O)O)=O,,,5,1,1,0,1
55956_0,,,,2,2,1,3
C(C(C)C(C=O)CC(C=O)=O)=O,,,5,1,1,0,1
55958_0,,,,2,2,1,3
C(C(C(C=O)C(C=O)C)O)(O)=O,,,5,1,1,0,1
55960_0,,,,2,2,1,3
C(C(C(CO)O)C(C=O)C)=O,,,5,1,1,0,1
55962_0,,,,2,2,1,3
C(C(C)C(C=O)C(C=O)CO)=O,,,5,1,1,0,1
55964_0,,,,2,2,1,3
C(CC(C(C=O)C(C=O)C)O)=O,,,5,1,1,0,1
55966_0,,,,2,2,1,3
C(C(C)C(C=O)C(C=O)(C=O)O)=O,,,5,1,1,0,1
55968_0,,,,2,2,1,3
C(C(C(CO)C(C)O)C(C=O)C)=O,,,5,1,1,0,1
55970_0,,,,2,2,1,3
C(C(C(CC(C)O)O)C(C=O)C)=O,,,5,1,1,0,1
55972_0,,,,2,2,1,3
C(C(CC(CCO)O)C(C=O)C)=O,,,5,1,1,0,1
55974_0,,,,2,2,1,3
C(C(C(C)(CCO)O)C(C=O)C)=O,,,5,1,1,0,1
55976_0,,,,2,2,1,3
C(C(CO)C(C=O)C(C=O)C)(O)=O,,,5,1,1,0,1
55978_0,,,,2,2,1,3
C(CC(C(C=O)C(C=O)C)O)(O)=O,,,5,1,1,0,1
55980_0,,,,2,2,1,3
C(C(C(C=O)C(C=O)C)O)(CO)=O,,,5,1,1,0,1
55982_0,,,,2,2,1,3
C(CC(C=O)C(C=O)C)(CO)=O,,,5,1,1,0,1
55983_0,,,,2,2,1,3
55984_0,,,,2,2,1,3
55986_0,,,,2,2,1,3
C(C(CCO)C(C=O)C)=O,,,5,1,1,0,1
55987_0,,,,2,2,1,3
55989_0,,,,2,2,1,3
C(C(C)C(C=O)CC(O)=O)=O,,,5,1,1,0,1
55991_0,,,,2,2,1,3
C(C(C)C(C=O)CC=CC=O)=O,,,5,1,1,0,1
55993_0,,,,2,2,1,3
C(C(C)C(C=O)C(C=O)C=C)=O,,,5,1,1,0,1
55995_0,,,,2,2,1,3
C(C(C(C(C=O)C(C=O)C)O)O)=O,,,5,1,1,0,1
55997_0,,,,2,2,1,3
C(C(C)C(C=O)C(C=O)(CO)O)=O,,,5,1,1,0,1
55999_0,,,,2,2,1,3
C(C(C)C(C=O)C([CH]C(O)=O)O)=O,,,5,1,1,0,1
56001_0,,,,2,2,1,3
C(C(C)C(C=O)[C](C(O)=O)CO)=O,,,5,1,1,0,1
56003_0,,,,2,2,1,3
C(C(C(C=O)C(C=O)C)O)=O,,,5,1,1,0,1
56005_0,,,,2,2,1,3
C(C(CC(C=O)C(C=O)C)O)=O,,,5,1,1,0,1
56006_0,,,,2,2,1,3
56008_0,,,,2,2,1,3
C(C(C)C(C=O)CC(C(O)=O)=O)=O,,,5,1,1,0,1
56010_0,,,,2,2,1,3
C(C(C)(CC=O)C(C=O)C(C=O)=C)=O,,,5,1,1,0,1
56012_0,,,,2,2,1,3
C(C(C)(CC=O)CC(C=CC=O)=O)=O,,,5,1,1,0,1
56014_0,,,,2,2,1,3
C(C(C)(CC=O)C(C=C)C(C=O)=O)=O,,,5,1,1,0,1
56016_0,,,,2,2,1,3
C(C(C)(CC=O)CC=CC(C=O)=O)=O,,,5,1,1,0,1
56018_0,,,,2,2,1,3
C(C(C)(CC(C=C)O)CC=O)=O,,,5,1,1,0,1
56020_0,,,,2,2,1,3
C(C(C)(CC=O)C(C=C)(C)O)=O,,,5,1,1,0,1
56022_0,,,,2,2,1,3
C(C(C)(CC=O)C(C=C)(CO)O)=O,,,5,1,1,0,1
56024_0,,,,2,2,1,3
C(C(C)(C(C(C=C)O)O)CC=O)=O,,,5,1,1,0,1
56026_0,,,,2,2,1,3
C(C(CC)(C(C=O)(C)CC=O)O)=O,,,5,1,1,0,1
56028_0,,,,2,2,1,3
C(C(C)(CCC(C=O)O)CC=O)=O,,,5,1,1,0,1
56030_0,,,,2,2,1,3
C(C(C)(C(C)C(C=O)O)CC=O)=O,,,5,1,1,0,1
56032_0,,,,2,2,1,3
C(C(CCO)C(C=O)(C)CC=O)=O,,,5,1,1,0,1
56034_0,,,,2,2,1,3
C(C(C)(C(CCC=O)O)CC=O)=O,,,5,1,1,0,1
56036_0,,,,2,2,1,3
C(C(C)(C(CO)CC=O)CC=O)=O,,,5,1,1,0,1
56038_0,,,,2,2,1,3
C(C(C)(CC=O)C1C(C(OC1)=O)=O)=O,,,5,1,1,0,1
56040_0,,,,2,2,1,3
C(C(C)(C1CC(C(O1)=O)=O)CC=O)=O,,,5,1,1,0,1
56042_0,,,,2,2,1,3
C(C([CH]C(O)=O)(C)CC=O)=O,,,5,1,1,0,1
56044_0,,,,2,2,1,3
C(CC(C=O)(C)C(C=O)(O)O)=O,,,5,1,1,0,1
56046_0,,,,2,2,1,3
C(C(C)(CC=O)CC=O)=O,,,5,1,1,0,1
56048_0,,,,2,2,1,3
C(C(C)(CC=O)C[C](C(O)=O)O)=O,,,5,1,1,0,1
56050_0,,,,2,2,1,3
C(C(CC(C=O)(C)CC=O)O)(O)=O,,,5,1,1,0,1
56052_0,,,,2,2,1,3
C(C(C)(C(C=O)(C)CC=O)O)(O)=O,,,5,1,1,0,1
56053_0,,,,2,2,1,3
56055_0,,,,2,2,1,3
C(C(C)(CC(CC=O)O)CC=O)=O,,,5,1,1,0,1
56057_0,,,,2,2,1,3
C(C(C)(C(C)(CC=O)O)CC=O)=O,,,5,1,1,0,1
56058_0,,,,2,2,1,3
56060_0,,,,2,2,1,3
C(CC(C=O)(C)C(C(C=O)=O)O)=O,,,5,1,1,0,1
56061_0,,,,2,2,1,3
56063_0,,,,2,2,1,3
C(CC(C=O)(C)C(C(O)=O)O)=O,,,5,1,1,0,1
56065_0,,,,2,2,1,3
C(C(C)(C(CO)O)CC=O)=O,,,5,1,1,0,1
56067_0,,,,2,2,1,3
C(C(CO)C(C=O)(C)CC=O)=O,,,5,1,1,0,1
56069_0,,,,2,2,1,3
C(C(C)(C(CC=O)O)CC=O)=O,,,5,1,1,0,1
56071_0,,,,2,2,1,3
C(C(C)(CC=O)C(C=O)(C=O)O)=O,,,5,1,1,0,1
56073_0,,,,2,2,1,3
C(C(C)(C(CO)C(C)O)CC=O)=O,,,5,1,1,0,1
56075_0,,,,2,2,1,3
C(C(C)(C(CC(C)O)O)CC=O)=O,,,5,1,1,0,1
56077_0,,,,2,2,1,3
C(C(C)(CC(CCO)O)CC=O)=O,,,5,1,1,0,1
56079_0,,,,2,2,1,3
C(C(C)(C(C)(CCO)O)CC=O)=O,,,5,1,1,0,1
56081_0,,,,2,2,1,3
C(C(CO)C(C=O)(C)CC=O)(O)=O,,,5,1,1,0,1
56083_0,,,,2,2,1,3
C(CC(C(C=O)(C)CC=O)O)(O)=O,,,5,1,1,0,1
56085_0,,,,2,2,1,3
C(CC(C=O)(C)C(C(CO)=O)O)=O,,,5,1,1,0,1
56087_0,,,,2,2,1,3
C(C(C)(CC(CO)=O)CC=O)=O,,,5,1,1,0,1
56089_0,,,,2,2,1,3
C(CC(C=O)(C)C(C(C)=O)O)=O,,,5,1,1,0,1
56091_0,,,,2,2,1,3
C(C(C)(CO)CC=O)=O,,,5,1,1,0,1
56093_0,,,,2,2,1,3
C(C(C)(CCO)CC=O)=O,,,5,1,1,0,1
56095_0,,,,2,2,1,3
C(C(C)(C(C)O)CC=O)=O,,,5,1,1,0,1
56097_0,,,,2,2,1,3
C(C(C)(CC=O)CC(O)=O)=O,,,5,1,1,0,1
56099_0,,,,2,2,1,3
C(C(C)(CC=O)CC=CC=O)=O,,,5,1,1,0,1
56101_0,,,,2,2,1,3
C(C(C)(CC=O)C(C=O)C=C)=O,,,5,1,1,0,1
56103_0,,,,2,2,1,3
C(C(C)(C(C(C=O)O)O)CC=O)=O,,,5,1,1,0,1
56105_0,,,,2,2,1,3
C(C(CO)(C(C=O)(C)CC=O)O)=O,,,5,1,1,0,1
56107_0,,,,2,2,1,3
C(CC(C=O)(C)C([CH]C(O)=O)O)=O,,,5,1,1,0,1
56109_0,,,,2,2,1,3
C(C([C](C(O)=O)CO)(C)CC=O)=O,,,5,1,1,0,1
56111_0,,,,2,2,1,3
C(CC(C=O)(C)C(C=O)O)=O,,,5,1,1,0,1
56113_0,,,,2,2,1,3
C(C(C)(CC(C=O)O)CC=O)=O,,,5,1,1,0,1
56115_0,,,,2,2,1,3
C(C(C)(C(C=O)(C)CC=O)O)=O,,,5,1,1,0,1
56117_0,,,,2,2,1,3
C(C(C)(CC=O)CC(C(O)=O)=O)=O,,,5,1,2,0,2
56119_0,,,,2,2,1,3
C(C(CC(C=O)C(C=O)=C)CC=O)=O,,,5,1,1,0,1
56121_0,,,,2,2,1,3
C(C(C(C=O)=C)C(C=O)CC(C)=O)=O,,,5,1,1,0,1
56123_0,,,,2,2,1,3
C(C(C(C=O)=C)C(C(C)=O)CC=O)=O,,,5,1,1,0,1
56125_0,,,,2,2,1,3
C(C(C(C=O)=C)CCC(C=O)=O)=O,,,5,1,1,0,1
56127_0,,,,2,2,1,3
C(C(C(C=O)=C)C(C)CC(C=O)=O)=O,,,5,1,1,0,1
56129_0,,,,2,2,1,3
C(C(C(C=O)=C)CCC=O)=O,,,5,1,1,0,1
56131_0,,,,2,2,1,3
C(C(C(C=O)=C)CCC(C(O)=O)=O)=O,,,5,1,1,0,1
56133_0,,,,2,2,1,3
C(C(C(C=O)=C)CC(C(O)=O)C=C)=O,,,5,1,1,0,1
56134_0,,,,2,2,1,3
56135_0,,,,2,2,1,3
56136_0,,,,2,2,1,3
56138_0,,,,2,2,1,3
C(C(CCC(C=CC=O)=O)CC=O)=O,,,5,1,1,0,1
56140_0,,,,2,2,1,3
C(C(CC(C=C)C(C=O)=O)CC=O)=O,,,5,1,1,0,1
56142_0,,,,2,2,1,3
C(C(CCC=CC(C=O)=O)CC=O)=O,,,5,1,1,0,1
56144_0,,,,2,2,1,3
C(C(CCC(C=C)O)CC=O)=O,,,5,1,1,0,1
56146_0,,,,2,2,1,3
C(C(CC(C=C)(C)O)CC=O)=O,,,5,1,1,0,1
56148_0,,,,2,2,1,3
C(C(CC(C=C)(CO)O)CC=O)=O,,,5,1,1,0,1
56150_0,,,,2,2,1,3
C(C(CC(C(C=C)O)O)CC=O)=O,,,5,1,1,0,1
56152_0,,,,2,2,1,3
C(C(CC(C=O)CC=O)(CC)O)=O,,,5,1,1,0,1
56154_0,,,,2,2,1,3
C(C(CCCC(C=O)CC=O)O)=O,,,5,1,1,0,1
56156_0,,,,2,2,1,3
C(C(C(C)CC(C=O)CC=O)O)=O,,,5,1,1,0,1
56158_0,,,,2,2,1,3
C(C(CC(C=O)CC=O)CCO)=O,,,5,1,1,0,1
56160_0,,,,2,2,1,3
C(CCC(CC(C=O)CC=O)O)=O,,,5,1,1,0,1
56162_0,,,,2,2,1,3
C(CC(CC(C=O)CC=O)CO)=O,,,5,1,1,0,1
56164_0,,,,2,2,1,3
C(C(CC1C(C(OC1)=O)=O)CC=O)=O,,,5,1,1,0,1
56166_0,,,,2,2,1,3
C(C(CC1CC(C(O1)=O)=O)CC=O)=O,,,5,1,1,0,1
56167_0,,,,2,2,1,3
56169_0,,,,2,2,1,3
C(C(CC(C=O)(O)O)CC=O)=O,,,5,1,1,0,1
56171_0,,,,2,2,1,3
C(CCC(C=O)CC=O)=O,,,5,1,1,0,1
56173_0,,,,2,2,1,3
C(C(CC[C](C(O)=O)O)CC=O)=O,,,5,1,1,0,1
56175_0,,,,2,2,1,3
C(C(CCC(C=O)CC=O)O)(O)=O,,,5,1,1,0,1
56177_0,,,,2,2,1,3
C(C(C)(CC(C=O)CC=O)O)(O)=O,,,5,1,1,0,1
56179_0,,,,2,2,1,3
C(C(CC(C=O)CC=O)C(C)O)=O,,,5,1,1,0,1
56181_0,,,,2,2,1,3
C(CC(CCC(C=O)CC=O)O)=O,,,5,1,1,0,1
56183_0,,,,2,2,1,3
C(CC(C)(CC(C=O)CC=O)O)=O,,,5,1,1,0,1
56185_0,,,,2,2,1,3
C(C(CC(C=O)C(O)=O)CC=O)=O,,,5,1,1,0,1
56187_0,,,,2,2,1,3
C(C(CC(C(C=O)=O)O)CC=O)=O,,,5,1,1,0,1
56189_0,,,,2,2,1,3
C(C(CCC(C=O)=O)CC=O)=O,,,5,1,1,0,1
56191_0,,,,2,2,1,3
C(C(CC(C=O)CC=O)O)(O)=O,,,5,1,1,0,1
56193_0,,,,2,2,1,3
C(C(CC(CO)O)CC=O)=O,,,5,1,1,0,1
56195_0,,,,2,2,1,3
C(C(CC(C=O)CC=O)CO)=O,,,5,1,1,0,1
56197_0,,,,2,2,1,3
C(CC(CC(C=O)CC=O)O)=O,,,5,1,1,0,1
56199_0,,,,2,2,1,3
C(C(CC(C=O)(C=O)O)CC=O)=O,,,5,1,1,0,1
56201_0,,,,2,2,1,3
C(C(CC(CO)C(C)O)CC=O)=O,,,5,1,1,0,1
56203_0,,,,2,2,1,3
C(C(CC(CC(C)O)O)CC=O)=O,,,5,1,1,0,1
56205_0,,,,2,2,1,3
C(C(CCC(CCO)O)CC=O)=O,,,5,1,1,0,1
56207_0,,,,2,2,1,3
C(C(CC(C)(CCO)O)CC=O)=O,,,5,1,1,0,1
56209_0,,,,2,2,1,3
C(C(CC(C=O)CC=O)CO)(O)=O,,,5,1,1,0,1
56211_0,,,,2,2,1,3
C(CC(CC(C=O)CC=O)O)(O)=O,,,5,1,1,0,1
56213_0,,,,2,2,1,3
C(CO)(C(CC(C=O)CC=O)O)=O,,,5,1,1,0,1
56215_0,,,,2,2,1,3
C(CO)(CCC(C=O)CC=O)=O,,,5,1,1,0,1
56217_0,,,,2,2,1,3
C(C)(C(CC(C=O)CC=O)O)=O,,,5,1,1,0,1
56219_0,,,,2,2,1,3
C(C(CCO)CC=O)=O,,,5,1,1,0,1
56221_0,,,,2,2,1,3
C(C(CCCO)CC=O)=O,,,5,1,1,0,1
56223_0,,,,2,2,1,3
C(C(CC(C)O)CC=O)=O,,,5,1,1,0,1
56224_0,,,,2,2,1,3
56226_0,,,,2,2,1,3
C(C(CCC=CC=O)CC=O)=O,,,5,1,1,0,1
56228_0,,,,2,2,1,3
C(C(CC(C=O)C=C)CC=O)=O,,,5,1,1,0,1
56230_0,,,,2,2,1,3
C(C(C(CC(C=O)CC=O)O)O)=O,,,5,1,1,0,1
56232_0,,,,2,2,1,3
C(C(CO)(CC(C=O)CC=O)O)=O,,,5,1,1,0,1
56234_0,,,,2,2,1,3
C(C(CC([CH]C(O)=O)O)CC=O)=O,,,5,1,1,0,1
56236_0,,,,2,2,1,3
C(CC(C=O)C[C](C(O)=O)CO)=O,,,5,1,1,0,1
56238_0,,,,2,2,1,3
C(C(CC(C=O)CC=O)O)=O,,,5,1,1,0,1
56240_0,,,,2,2,1,3
C(C(CCC(C=O)CC=O)O)=O,,,5,1,1,0,1
56242_0,,,,2,2,1,3
C(C(C)(CC(C=O)CC=O)O)=O,,,5,1,1,0,1
56244_0,,,,2,2,1,3
C(C(CCC(C(O)=O)=O)CC=O)=O,,,5,1,1,0,1
56246_0,,,,2,2,1,3
C(CCCC(C=O)=CC(C(O)=O)=O)=O,,,5,1,1,0,1
56248_0,,,,2,2,1,3
C(CC(C(C(O)=O)=O)C(C=O)C)=O,,,5,1,1,0,1
56249_0,,,,2,2,1,3
56251_0,,,,2,2,1,3
C(C(C)C(C(C(O)=O)=O)CCO)=O,,,5,1,1,0,1
56253_0,,,,2,2,1,3
C(C(C)C(C(C(O)=O)=O)C(C)O)=O,,,5,1,1,0,1
56254_0,,,,2,2,1,3
56256_0,,,,2,2,1,3
C(C(C)(CO)CC(C(O)=O)=O)=O,,,5,1,1,0,1
56258_0,,,,2,2,1,3
C(C(C)(CCO)CC(C(O)=O)=O)=O,,,5,1,1,0,1
56260_0,,,,2,2,1,3
C(C(C)(C(C)O)CC(C(O)=O)=O)=O,,,5,1,1,0,1
56262_0,,,,2,2,1,3
C(CCC(C(C(O)=O)=O)C(C=O)=C)=O,,,5,1,1,0,1
56264_0,,,,2,2,1,3
C(CCC(C=O)CC(C(O)=O)=O)=O,,,5,1,1,0,1
56266_0,,,,2,2,1,3
C(C(CCO)CC(C(O)=O)=O)=O,,,5,1,1,0,1
56268_0,,,,2,2,1,3
C(C(CCCO)CC(C(O)=O)=O)=O,,,5,1,1,0,1
56270_0,,,,2,2,1,3
C(C(CC(C)O)CC(C(O)=O)=O)=O,,,5,1,1,0,1
56272_0,,,,2,2,1,3
C(CCCC(C=CC(C=O)=O)=O)=O,,,5,1,1,0,1
56274_0,,,,2,2,1,3
C(C(C=CC(CC[CH]C(O)=O)=O)=O)=O,,,5,1,1,0,1
56276_0,,,,2,2,1,3
C(CCCC(C=CC(C=O)=O)=O)(O)=O,,,5,1,1,0,1
56278_0,,,,2,2,1,3
C(CC(C)CC(C=CC(C=O)=O)=O)=O,,,5,1,1,0,1
56280_0,,,,2,2,1,3
C(CC(C(C=O)=O)CC(C=C)O)(C)=O,,,5,1,1,0,1
56282_0,,,,2,2,1,3
C(CC(C(C=O)=O)C(C=C)(C)O)(C)=O,,,5,1,1,0,1
56284_0,,,,2,2,1,3
C(C)(CC([CH]C(O)=O)C(C=O)=O)=O,,,5,1,1,0,1
56286_0,,,,2,2,1,3
C(CC(C(C=O)=O)CC(C)=O)=O,,,5,1,1,0,1
56288_0,,,,2,2,1,3
C(C)(CC(C(C=O)=O)CC(C=O)=O)=O,,,5,1,1,0,1
56290_0,,,,2,2,1,3
C(CC(C(C=O)=O)C(CO)O)(C)=O,,,5,1,1,0,1
56291_0,,,,2,2,1,3
56293_0,,,,2,2,1,3
C(CC(C(C=O)=O)CCO)(C)=O,,,5,1,1,0,1
56294_0,,,,2,2,1,3
56296_0,,,,2,2,1,3
C(CC(C(C=O)=O)CC(C)=O)(O)=O,,,5,1,1,0,1
56298_0,,,,2,2,1,3
C(C)(CC(C(C=O)=O)CC=CC=O)=O,,,5,1,1,0,1
56300_0,,,,2,2,1,3
C(C(C=C)C(C(C=O)=O)CC(C)=O)=O,,,5,1,1,0,1
56302_0,,,,2,2,1,3
C(C(C(C(C=O)=O)CC(C)=O)O)=O,,,5,1,1,0,1
56304_0,,,,2,2,1,3
C(C)(C(CC(C=C)O)CC(C=O)=O)=O,,,5,1,1,0,1
56306_0,,,,2,2,1,3
C(C(CC(C=O)=O)C(C=C)(C)O)(C)=O,,,5,1,1,0,1
56308_0,,,,2,2,1,3
C(C)(C([CH]C(O)=O)CC(C=O)=O)=O,,,5,1,1,0,1
56310_0,,,,2,2,1,3
C(CC(C(C)=O)CC(C=O)=O)=O,,,5,1,2,0,2
56312_0,,,,2,2,1,3
C(C)(C(CC(C=O)=O)CC(C=O)=O)=O,,,5,1,1,0,1
56314_0,,,,2,2,1,3
C(C)(C(C(CO)O)CC(C=O)=O)=O,,,5,1,1,0,1
56316_0,,,,2,2,1,3
C(C)(C(CO)CC(C=O)=O)=O,,,5,1,1,0,1
56318_0,,,,2,2,1,3
C(C)(C(CCO)CC(C=O)=O)=O,,,5,1,1,0,1
56320_0,,,,2,2,1,3
C(C)(C(C(C)O)CC(C=O)=O)=O,,,5,1,1,0,1
56322_0,,,,2,2,1,3
C(CC(C(C)=O)CC(C=O)=O)(O)=O,,,5,1,1,0,1
56324_0,,,,2,2,1,3
C(C)(C(CC(C=O)=O)CC=CC=O)=O,,,5,1,1,0,1
56326_0,,,,2,2,1,3
C(C(C=C)C(C(C)=O)CC(C=O)=O)=O,,,5,1,1,0,1
56328_0,,,,2,2,1,3
C(C(C(C(C)=O)CC(C=O)=O)O)=O,,,5,1,1,0,1
56330_0,,,,2,2,1,3
C(C(CC(C=CC=O)=O)CC(C)=O)=O,,,5,1,1,0,1
56332_0,,,,2,2,1,3
C(CC(C(C)=O)CC(C=CC=O)=O)=O,,,5,1,1,0,1
56334_0,,,,2,2,1,3
C(C(CCCC(C=CC=O)=O)=O)=O,,,5,1,1,0,1
56336_0,,,,2,2,1,3
C(C(CC(C)CC(C=CC=O)=O)=O)=O,,,5,1,1,0,1
56338_0,,,,2,2,1,3
C(CCCC(C=CC=O)=O)=O,,,5,1,1,0,1
56340_0,,,,2,2,1,3
C(C(O)=O)(CCCC(C=CC=O)=O)=O,,,5,1,1,0,1
56342_0,,,,2,2,1,3
C(C(C=C)CCC(C=CC=O)=O)(O)=O,,,5,1,1,0,1
56343_0,,,,2,2,1,3
56344_0,,,,2,2,1,3
56345_0,,,,2,2,1,3
56347_0,,,,2,2,1,3
C(C(CC(C)=O)C(C=C)C(C=O)=O)=O,,,5,1,1,0,1
56349_0,,,,2,2,1,3
C(C(CC(C)=O)CC=CC(C=O)=O)=O,,,5,1,1,0,1
56351_0,,,,2,2,1,3
C(C(CC(C=C)O)CC(C)=O)=O,,,5,1,1,0,1
56353_0,,,,2,2,1,3
C(CC(C=O)C(C=C)(C)O)(C)=O,,,5,1,1,0,1
56355_0,,,,2,2,1,3
C(CC(C=O)C(C=C)(CO)O)(C)=O,,,5,1,1,0,1
56357_0,,,,2,2,1,3
C(C(C(C(C=C)O)O)CC(C)=O)=O,,,5,1,1,0,1
56359_0,,,,2,2,1,3
C(CC(C=O)C(C=O)(CC)O)(C)=O,,,5,1,1,0,1
56361_0,,,,2,2,1,3
C(C(CCC(C=O)CC(C)=O)O)=O,,,5,1,1,0,1
56363_0,,,,2,2,1,3
C(C(C(C)C(C=O)CC(C)=O)O)=O,,,5,1,1,0,1
56365_0,,,,2,2,1,3
C(CC(C=O)C(C=O)CCO)(C)=O,,,5,1,1,0,1
56367_0,,,,2,2,1,3
C(CCC(C(C=O)CC(C)=O)O)=O,,,5,1,1,0,1
56369_0,,,,2,2,1,3
C(CC(CO)C(C=O)CC(C)=O)=O,,,5,1,1,0,1
56371_0,,,,2,2,1,3
C(CC(C=O)C1C(C(OC1)=O)=O)(C)=O,,,5,1,1,0,1
56373_0,,,,2,2,1,3
C(C(C1CC(C(O1)=O)=O)CC(C)=O)=O,,,5,1,1,0,1
56375_0,,,,2,2,1,3
C(C([CH]C(O)=O)CC(C)=O)=O,,,5,1,1,0,1
56377_0,,,,2,2,1,3
C(C(C(C=O)CC(C)=O)(O)O)=O,,,5,1,1,0,1
56379_0,,,,2,2,1,3
C(CC(C=O)CC(C)=O)=O,,,5,1,1,0,1
56381_0,,,,2,2,1,3
C(C(C[C](C(O)=O)O)CC(C)=O)=O,,,5,1,1,0,1
56383_0,,,,2,2,1,3
C(C(CC(C=O)CC(C)=O)O)(O)=O,,,5,1,1,0,1
56385_0,,,,2,2,1,3
C(CC(C=O)C(C(O)=O)(C)O)(C)=O,,,5,1,1,0,1
56387_0,,,,2,2,1,3
C(CC(C=O)C(C=O)C(C)O)(C)=O,,,5,1,1,0,1
56389_0,,,,2,2,1,3
C(CC(CC(C=O)CC(C)=O)O)=O,,,5,1,1,0,1
56391_0,,,,2,2,1,3
C(CC(C)(C(C=O)CC(C)=O)O)=O,,,5,1,1,0,1
56393_0,,,,2,2,1,3
C(C(C(O)=O)C(C=O)CC(C)=O)=O,,,5,1,1,0,1
56395_0,,,,2,2,1,3
C(C(CC(C)=O)C(C(C=O)=O)O)=O,,,5,1,1,0,1
56397_0,,,,2,2,1,3
C(C(CC(C=O)=O)CC(C)=O)=O,,,5,1,1,0,1
56399_0,,,,2,2,1,3
C(C(C(C=O)CC(C)=O)O)(O)=O,,,5,1,1,0,1
56401_0,,,,2,2,1,3
C(C(C(CO)O)CC(C)=O)=O,,,5,1,1,0,1
56403_0,,,,2,2,1,3
C(CC(C=O)C(C=O)CO)(C)=O,,,5,1,1,0,1
56405_0,,,,2,2,1,3
C(CC(C(C=O)CC(C)=O)O)=O,,,5,1,1,0,1
56407_0,,,,2,2,1,3
C(C(C=O)(C(C=O)CC(C)=O)O)=O,,,5,1,1,0,1
56409_0,,,,2,2,1,3
C(C(C(CO)C(C)O)CC(C)=O)=O,,,5,1,1,0,1
56411_0,,,,2,2,1,3
C(C(C(CC(C)O)O)CC(C)=O)=O,,,5,1,1,0,1
56413_0,,,,2,2,1,3
C(C(CC(CCO)O)CC(C)=O)=O,,,5,1,1,0,1
56415_0,,,,2,2,1,3
C(C(C(C)(CCO)O)CC(C)=O)=O,,,5,1,1,0,1
56417_0,,,,2,2,1,3
C(CC(C=O)C(C(O)=O)CO)(C)=O,,,5,1,1,0,1
56419_0,,,,2,2,1,3
C(CC(C(C=O)CC(C)=O)O)(O)=O,,,5,1,1,0,1
56421_0,,,,2,2,1,3
C(C(CC(C)=O)C(C(CO)=O)O)=O,,,5,1,1,0,1
56423_0,,,,2,2,1,3
C(C(CC(C)=O)CC(CO)=O)=O,,,5,1,1,0,1
56424_0,,,,2,2,1,3
56425_0,,,,2,2,1,3
56427_0,,,,2,2,1,3
C(C(CCO)CC(C)=O)=O,,,5,1,1,0,1
56428_0,,,,2,2,1,3
56430_0,,,,2,2,1,3
C(C(CC(O)=O)CC(C)=O)=O,,,5,1,1,0,1
56432_0,,,,2,2,1,3
C(C(CC(C)=O)CC=CC=O)=O,,,5,1,1,0,1
56434_0,,,,2,2,1,3
C(C(C=C)C(C=O)CC(C)=O)=O,,,5,1,1,0,1
56436_0,,,,2,2,1,3
C(C(C(C(C=O)CC(C)=O)O)O)=O,,,5,1,1,0,1
56438_0,,,,2,2,1,3
C(CC(C=O)C(C=O)(CO)O)(C)=O,,,5,1,1,0,1
56440_0,,,,2,2,1,3
C(C(CC(C)=O)C([CH]C(O)=O)O)=O,,,5,1,1,0,1
56442_0,,,,2,2,1,3
C(C([C](C(O)=O)CO)CC(C)=O)=O,,,5,1,1,0,1
56444_0,,,,2,2,1,3
C(C(C(C=O)CC(C)=O)O)=O,,,5,1,1,0,1
56446_0,,,,2,2,1,3
C(C(CC(C=O)CC(C)=O)O)=O,,,5,1,1,0,1
56447_0,,,,2,2,1,3
56449_0,,,,2,2,1,3
C(C(CC(C(O)=O)=O)CC(C)=O)=O,,,5,1,1,0,1
56451_0,,,,2,2,1,3
C(CC(C(C)=O)C(C=C)C(C=O)=O)=O,,,5,1,1,0,1
56453_0,,,,2,2,1,3
C(CC(C(C)=O)CC=CC(C=O)=O)=O,,,5,1,1,0,1
56455_0,,,,2,2,1,3
C(C)(C(CC(C=C)O)CC=O)=O,,,5,1,1,0,1
56457_0,,,,2,2,1,3
C(CC(C(C)=O)C(C=C)(C)O)=O,,,5,1,1,0,1
56459_0,,,,2,2,1,3
C(CC(C(C)=O)C(C=C)(CO)O)=O,,,5,1,1,0,1
56461_0,,,,2,2,1,3
C(C)(C(C(C(C=C)O)O)CC=O)=O,,,5,1,1,0,1
56463_0,,,,2,2,1,3
C(CC(C(C)=O)C(C=O)(CC)O)=O,,,5,1,1,0,1
56465_0,,,,2,2,1,3
C(C)(C(CCC(C=O)O)CC=O)=O,,,5,1,1,0,1
56467_0,,,,2,2,1,3
C(C)(C(C(C)C(C=O)O)CC=O)=O,,,5,1,1,0,1
56469_0,,,,2,2,1,3
C(CC(C(C)=O)C(C=O)CCO)=O,,,5,1,1,0,1
56471_0,,,,2,2,1,3
C(C)(C(C(CCC=O)O)CC=O)=O,,,5,1,1,0,1
56473_0,,,,2,2,1,3
C(C)(C(C(CO)CC=O)CC=O)=O,,,5,1,1,0,1
56475_0,,,,2,2,1,3
C(CC(C(C)=O)C1C(C(OC1)=O)=O)=O,,,5,1,1,0,1
56477_0,,,,2,2,1,3
C(C)(C(C1CC(C(O1)=O)=O)CC=O)=O,,,5,1,1,0,1
56479_0,,,,2,2,1,3
C(CC(C(C)=O)[CH]C(O)=O)=O,,,5,1,1,0,1
56481_0,,,,2,2,1,3
C(CC(C(C)=O)C(C=O)(O)O)=O,,,5,1,1,0,1
56483_0,,,,2,2,1,3
C(CC(C(C)=O)CC=O)=O,,,5,1,1,0,1
56485_0,,,,2,2,1,3
C(CC(C(C)=O)C[C](C(O)=O)O)=O,,,5,1,1,0,1
56487_0,,,,2,2,1,3
C(C)(C(CC(C(O)=O)O)CC=O)=O,,,5,1,1,0,1
56489_0,,,,2,2,1,3
C(C(C)(C(C(C)=O)CC=O)O)(O)=O,,,5,1,1,0,1
56490_0,,,,2,2,1,3
56492_0,,,,2,2,1,3
C(C)(C(CC(CC=O)O)CC=O)=O,,,5,1,1,0,1
56494_0,,,,2,2,1,3
C(C)(C(C(C)(CC=O)O)CC=O)=O,,,5,1,1,0,1
56495_0,,,,2,2,1,3
56497_0,,,,2,2,1,3
C(CC(C(C)=O)C(C(C=O)=O)O)=O,,,5,1,1,0,1
56498_0,,,,2,2,1,3
56500_0,,,,2,2,1,3
C(C(C(C(C)=O)CC=O)O)(O)=O,,,5,1,1,0,1
56502_0,,,,2,2,1,3
C(C)(C(C(CO)O)CC=O)=O,,,5,1,1,0,1
56504_0,,,,2,2,1,3
C(CC(C(C)=O)C(C=O)CO)=O,,,5,1,1,0,1
56506_0,,,,2,2,1,3
C(C)(C(C(CC=O)O)CC=O)=O,,,5,1,1,0,1
56508_0,,,,2,2,1,3
C(C(C=O)(C(C(C)=O)CC=O)O)=O,,,5,1,1,0,1
56510_0,,,,2,2,1,3
C(C)(C(C(CO)C(C)O)CC=O)=O,,,5,1,1,0,1
56512_0,,,,2,2,1,3
C(C)(C(C(CC(C)O)O)CC=O)=O,,,5,1,1,0,1
56514_0,,,,2,2,1,3
C(C)(C(CC(CCO)O)CC=O)=O,,,5,1,1,0,1
56516_0,,,,2,2,1,3
C(C)(C(C(C)(CCO)O)CC=O)=O,,,5,1,1,0,1
56518_0,,,,2,2,1,3
C(C(CO)C(C(C)=O)CC=O)(O)=O,,,5,1,1,0,1
56520_0,,,,2,2,1,3
C(C)(C(C(CC(O)=O)O)CC=O)=O,,,5,1,1,0,1
56522_0,,,,2,2,1,3
C(CC(C(C)=O)C(C(CO)=O)O)=O,,,5,1,1,0,1
56524_0,,,,2,2,1,3
C(CC(C(C)=O)CC(CO)=O)=O,,,5,1,1,0,1
56526_0,,,,2,2,1,3
C(CC(C(C)=O)C(C(C)=O)O)=O,,,5,1,1,0,1
56528_0,,,,2,2,1,3
C(C)(C(CO)CC=O)=O,,,5,1,1,0,1
56530_0,,,,2,2,1,3
C(C)(C(CCO)CC=O)=O,,,5,1,1,0,1
56532_0,,,,2,2,1,3
C(C)(C(C(C)O)CC=O)=O,,,5,1,1,0,1
56534_0,,,,2,2,1,3
C(CC(C(C)=O)CC(O)=O)=O,,,5,1,1,0,1
56536_0,,,,2,2,1,3
C(CC(C(C)=O)CC=CC=O)=O,,,5,1,1,0,1
56538_0,,,,2,2,1,3
C(C(C=C)C(C(C)=O)CC=O)=O,,,5,1,1,0,1
56540_0,,,,2,2,1,3
C(C)(C(C(C(C=O)O)O)CC=O)=O,,,5,1,1,0,1
56542_0,,,,2,2,1,3
C(CC(C(C)=O)C(C=O)(CO)O)=O,,,5,1,1,0,1
56544_0,,,,2,2,1,3
C(CC(C(C)=O)C([CH]C(O)=O)O)=O,,,5,1,1,0,1
56546_0,,,,2,2,1,3
C(CC(C(C)=O)[C](C(O)=O)CO)=O,,,5,1,1,0,1
56548_0,,,,2,2,1,3
C(CC(C(C)=O)C(C=O)O)=O,,,5,1,1,0,1
56550_0,,,,2,2,1,3
C(C)(C(CC(C=O)O)CC=O)=O,,,5,1,1,0,1
56552_0,,,,2,2,1,3
C(CC(C(C)=O)C(C=O)(C)O)=O,,,5,1,1,0,1
56554_0,,,,2,2,1,3
C(CC(C(C)=O)CC(C(O)=O)=O)=O,,,5,1,2,0,2
56556_0,,,,2,2,1,3
C(CCCC(C=CC(C(O)=O)=O)=O)=O,,,5,1,1,0,1
56558_0,,,,2,2,1,3
C(CC(C(C(O)=O)=O)CC(C)=O)=O,,,5,1,1,0,1
56559_0,,,,2,2,1,3
56561_0,,,,2,2,1,3
C(CC(C(C(O)=O)=O)CCO)(C)=O,,,5,1,1,0,1
56563_0,,,,2,2,1,3
C(CC(C(C(O)=O)=O)C(C)O)(C)=O,,,5,1,1,0,1
56564_0,,,,2,2,1,3
56566_0,,,,2,2,1,3
C(C)(C(CO)CC(C(O)=O)=O)=O,,,5,1,1,0,1
56568_0,,,,2,2,1,3
C(C)(C(CCO)CC(C(O)=O)=O)=O,,,5,1,1,0,1
56570_0,,,,2,2,1,3
C(C)(C(C(C)O)CC(C(O)=O)=O)=O,,,5,1,1,0,1
56572_0,,,,2,2,1,3
C=CC(C(C=O)=O)CCC(C=O)=O,,,5,1,1,0,1
56574_0,,,,2,2,1,3
C(CCCC(C=O)=O)=CC(C=O)=O,,,5,1,1,0,1
56576_0,,,,2,2,1,3
C=CC(CCCC(C=O)=O)O,,,5,1,1,0,1
56578_0,,,,2,2,1,3
C(C(C)(CCC(C=O)=O)O)=C,,,5,1,1,0,1
56580_0,,,,2,2,1,3
C=C(C(O)=O)C(CCC(C=O)=O)O,,,5,1,1,0,1
56582_0,,,,2,2,1,3
C=C(C(CCCC(C=O)=O)=O)C(O)=O,,,5,1,1,0,1
56584_0,,,,2,2,1,3
C(C(CO)(CCC(C=O)=O)O)=C,,,5,1,1,0,1
56586_0,,,,2,2,1,3
C=CC(C(CCC(C=O)=O)O)O,,,5,1,1,0,1
56588_0,,,,2,2,1,3
C=C1C(OC(C1CCC(C=O)=O)O)=O,,,5,1,1,0,1
56590_0,,,,2,2,1,3
C=C1C(OC(CCC(C=O)=O)(C1)O)=O,,,5,1,1,0,1
56592_0,,,,2,2,1,3
C1C(O)OC(C=1CCCC(C=O)=O)=O,,,5,1,1,0,1
56594_0,,,,2,2,1,3
C1C(CCC(C=O)=O)(O)OC(C=1C)=O,,,5,1,1,0,1
56596_0,,,,2,2,1,3
C1(C(C=CO1)(CCCC(C=O)=O)O)=O,,,5,1,1,0,1
56598_0,,,,2,2,1,3
C(C(CCC(C=O)=O)O)=C[CH]C(O)=O,,,5,1,1,0,1
56600_0,,,,2,2,1,3
C(CO)=C[C](C(O)=O)CCC(C=O)=O,,,5,1,1,0,1
56602_0,,,,2,2,1,3
[C](C(O)=O)=CC(CCCC(C=O)=O)O,,,5,1,1,0,1
56604_0,,,,2,2,1,3
[C](C(O)=O)=CC(C)(CCC(C=O)=O)O,,,5,1,1,0,1
56606_0,,,,2,2,1,3
C(CCCC(C=O)=O)=C[C](C(O)=O)O,,,5,1,1,0,1
56608_0,,,,2,2,1,3
C=CC([C](C(O)=O)O)CCC(C=O)=O,,,5,1,1,0,1
56610_0,,,,2,2,1,3
C(C(CCC(C=O)=O)(CC)O)=O,,,5,1,1,0,1
56612_0,,,,2,2,1,3
C(C(CCCCC(C=O)=O)O)=O,,,5,1,1,0,1
56614_0,,,,2,2,1,3
C(C(C(CCC(C=O)=O)C)O)=O,,,5,1,1,0,1
56616_0,,,,2,2,1,3
C(C(CCC(C=O)=O)CCO)=O,,,5,1,1,0,1
56618_0,,,,2,2,1,3
C(CCC(CCC(C=O)=O)O)=O,,,5,1,1,0,1
56620_0,,,,2,2,1,3
C(CC(CCC(C=O)=O)CO)=O,,,5,1,1,0,1
56622_0,,,,2,2,1,3
C1(C(O)OC(CCC(C=O)=O)C1)=O,,,5,1,1,0,1
56624_0,,,,2,2,1,3
C1(C(O)OCC1CCC(C=O)=O)=O,,,5,1,1,0,1
56626_0,,,,2,2,1,3
C1(C(CCC(C=O)=O)(O)OCC1)=O,,,5,1,1,0,1
56628_0,,,,2,2,1,3
[CH]1C(OC(C(CCC(C=O)=O)C1)O)=O,,,5,1,1,0,1
56630_0,,,,2,2,1,3
[CH]1C(OC(CCC(C=O)=O)(CC1)O)=O,,,5,1,1,0,1
56632_0,,,,2,2,1,3
[CH]1C(OC(CC1CCC(C=O)=O)O)=O,,,5,1,1,0,1
56634_0,,,,2,2,1,3
[C]1(C(OC(CC1)O)=O)CCC(C=O)=O,,,5,1,1,0,1
56636_0,,,,2,2,1,3
C1(C(OCC1CCC(C=O)=O)=O)=O,,,5,1,1,0,1
56638_0,,,,2,2,1,3
C(C(CCC1CC(C(O1)=O)=O)=O)=O,,,5,1,1,0,1
56640_0,,,,2,2,1,3
C(C=O)(CCC1C(C(C(O1)=O)=O)=O)=O,,,5,1,1,0,1
56642_0,,,,2,2,1,3
[CH]1C(OC(CCC(C=O)=O)(CO)C1)=O,,,5,1,1,0,1
56644_0,,,,2,2,1,3
[CH]1C(OC(C(CCC(C=O)=O)O)C1)=O,,,5,1,1,0,1
56646_0,,,,2,2,1,3
[CH]1C(OC(CO)C1CCC(C=O)=O)=O,,,5,1,1,0,1
56648_0,,,,2,2,1,3
[C]1(C(OC(CO)C1)=O)CCC(C=O)=O,,,5,1,1,0,1
56650_0,,,,2,2,1,3
[C]1(C(OC(C)C1CCC(C=O)=O)=O)O,,,5,1,1,0,1
56652_0,,,,2,2,1,3
[C]1(C(OC(CCCC(C=O)=O)C1)=O)O,,,5,1,1,0,1
56654_0,,,,2,2,1,3
[C]1(C(OC(C)(CCC(C=O)=O)C1)=O)O,,,5,1,1,0,1
56656_0,,,,2,2,1,3
C1(C([C](C(O1)=O)O)CCC(C=O)=O)=O,,,5,1,1,0,1
56658_0,,,,2,2,1,3
[CH]1C(OCC(CCC(C=O)=O)(C1)O)=O,,,5,1,1,0,1
56660_0,,,,2,2,1,3
[CH]1C(OC(CCC(C=O)=O)C(C1)O)=O,,,5,1,1,0,1
56662_0,,,,2,2,1,3
[CH]1C(OCC(C1CCC(C=O)=O)O)=O,,,5,1,1,0,1
56664_0,,,,2,2,1,3
[C]1(C(OCC(C1)O)=O)CCC(C=O)=O,,,5,1,1,0,1
56666_0,,,,2,2,1,3
C(C(CCC(C=O)=O)C(C)CO)=O,,,5,1,1,0,1
56668_0,,,,2,2,1,3
C(CC(CO)CCCC(C=O)=O)=O,,,5,1,1,0,1
56670_0,,,,2,2,1,3
C(CC(C)(CCC(C=O)=O)CO)=O,,,5,1,1,0,1
56672_0,,,,2,2,1,3
C(CC(C)C(CCC(C=O)=O)O)=O,,,5,1,1,0,1
56674_0,,,,2,2,1,3
[CH](C(O)=O)C(CCC(C=O)=O)CO,,,5,1,1,0,1
56676_0,,,,2,2,1,3
[C](C(O)=O)(CCC(C=O)=O)CCO,,,5,1,1,0,1
56678_0,,,,2,2,1,3
[CH](C(O)=O)CC(CCC(C=O)=O)O,,,5,1,1,0,1
56680_0,,,,2,2,1,3
C(CC(CCC(C=O)=O)CO)(O)=O,,,5,1,1,0,1
56681_0,,,,2,2,1,3
56683_0,,,,2,2,1,3
C(CCC(CCC(C=O)=O)O)(O)=O,,,5,1,1,0,1
56685_0,,,,2,2,1,3
C(C(CCC(C=O)=O)C(C)CC=O)=O,,,5,1,1,0,1
56687_0,,,,2,2,1,3
C(CC(CCCC(C=O)=O)CC=O)=O,,,5,1,1,0,1
56689_0,,,,2,2,1,3
C(CC(CCC(C=O)=O)(C)CC=O)=O,,,5,1,1,0,1
56690_0,,,,2,2,1,3
56692_0,,,,2,2,1,3
C(C(CC(CCC(C=O)=O)O)O)=O,,,5,1,1,0,1
56694_0,,,,2,2,1,3
C(C(C(CCC(C=O)=O)CO)O)=O,,,5,1,1,0,1
56696_0,,,,2,2,1,3
C(C(CCC(C=O)=O)(CCO)O)=O,,,5,1,1,0,1
56698_0,,,,2,2,1,3
C(C(CCC(C=O)=O)(O)O)=O,,,5,1,1,0,1
56700_0,,,,2,2,1,3
C(C(C(CCC(C=O)=O)O)O)(O)=O,,,5,1,1,0,1
56702_0,,,,2,2,1,3
C(C(CO)(CCC(C=O)=O)O)(O)=O,,,5,1,1,0,1
56704_0,,,,2,2,1,3
C(CCCC(C=O)=O)=O,,,5,1,2,0,2
56706_0,,,,2,2,1,3
[C](C(O)=O)(CCCC(C=O)=O)O,,,5,1,1,0,1
56708_0,,,,2,2,1,3
C(C(CCCC(C=O)=O)O)(O)=O,,,5,1,1,0,1
56709_0,,,,2,2,1,3
56710_0,,,,2,2,1,3
56712_0,,,,2,2,1,3
C(CC(CCCC(C=O)=O)O)=O,,,5,1,1,0,1
56714_0,,,,2,2,1,3
C(CC(C)(CCC(C=O)=O)O)=O,,,5,1,1,0,1
56715_0,,,,2,2,1,3
56717_0,,,,2,2,1,3
C(C=O)(CCC(C(C=O)=O)O)=O,,,5,1,1,0,1
56719_0,,,,2,2,1,3
C(C(CCCC(C=O)=O)=O)=O,,,5,1,1,0,1
56720_0,,,,2,2,1,3
56722_0,,,,2,2,1,3
C(C(CCC(CO)O)=O)=O,,,5,1,1,0,1
56724_0,,,,2,2,1,3
C(C=O)(CCC(C(C(O)=O)=O)O)=O,,,5,1,1,0,1
56726_0,,,,2,2,1,3
C(C(CCC(CC(C=O)=O)O)=O)=O,,,5,1,1,0,1
56728_0,,,,2,2,1,3
C(C=O)(C(CCC(C=O)=O)CO)=O,,,5,1,1,0,1
56730_0,,,,2,2,1,3
C(C(CCC(C=O)=O)CO)=O,,,5,1,1,0,1
56732_0,,,,2,2,1,3
C(CC(CCC(C=O)=O)O)=O,,,5,1,1,0,1
56734_0,,,,2,2,1,3
C(CC(C(CCCC(C=O)=O)=O)=O)=O,,,5,1,1,0,1
56736_0,,,,2,2,1,3
C(C(C(C(C)=O)=O)CCC(C=O)=O)=O,,,5,1,1,0,1
56738_0,,,,2,2,1,3
C(C(C=O)(CCC(C=O)=O)O)=O,,,5,1,1,0,1
56740_0,,,,2,2,1,3
C(C(C=O)(CCC(C=O)=O)O)(O)=O,,,5,1,1,0,1
56742_0,,,,2,2,1,3
C(C(CCC(CO)C(C)O)=O)=O,,,5,1,1,0,1
56743_0,,,,2,2,1,3
56745_0,,,,2,2,1,3
C(C(CCCC(CCO)O)=O)=O,,,5,1,1,0,1
56747_0,,,,2,2,1,3
C(C(CCC(C)(CCO)O)=O)=O,,,5,1,1,0,1
56749_0,,,,2,2,1,3
C(C(CCC(C=O)=O)CO)(O)=O,,,5,1,2,0,2
56750_0,,,,2,2,1,3
56751_0,,,,2,2,1,3
56753_0,,,,2,2,1,3
C(CO)(CCCC(C=O)=O)=O,,,5,1,1,0,1
56754_0,,,,2,2,1,3
56755_0,,,,2,2,1,3
56757_0,,,,2,2,1,3
C(C(CCCCO)=O)=O,,,5,1,1,0,1
56758_0,,,,2,2,1,3
56759_0,,,,2,2,1,3
56761_0,,,,2,2,1,3
C(CC(CCCC(C=O)=O)O)(O)=O,,,5,1,1,0,1
56763_0,,,,2,2,1,3
C(CC(C)(CCC(C=O)=O)O)(O)=O,,,5,1,1,0,1
56764_0,,,,2,2,1,3
56765_0,,,,2,2,1,3
56767_0,,,,2,2,1,3
C(CCCC(C=O)=O)=CC=O,,,5,1,1,0,1
56769_0,,,,2,2,1,3
C(C(C=C)CCC(C=O)=O)=O,,,5,1,1,0,1
56771_0,,,,2,2,1,3
C(CCCC(C=O)=O)=CC(C(O)=O)=O,,,5,1,1,0,1
56773_0,,,,2,2,1,3
C=CC(C(C(O)=O)=O)CCC(C=O)=O,,,5,1,1,0,1
56775_0,,,,2,2,1,3
C(C(C(C(O)=O)=C)CCC(C=O)=O)=O,,,5,1,1,0,1
56777_0,,,,2,2,1,3
C(C(CCCC(C(O)=O)=CC=O)=O)=O,,,5,1,1,0,1
56779_0,,,,2,2,1,3
C(C(CCC(CO)(C(C)O)O)=O)=O,,,5,1,1,0,1
56781_0,,,,2,2,1,3
C(C(CCC(C(C(C)O)O)O)=O)=O,,,5,1,1,0,1
56783_0,,,,2,2,1,3
C(C(CCCC(C(CO)O)O)=O)=O,,,5,1,1,0,1
56785_0,,,,2,2,1,3
C(C(CCC(C)(C(CO)O)O)=O)=O,,,5,1,1,0,1
56787_0,,,,2,2,1,3
C(C(C(CCC(C=O)=O)O)O)=O,,,5,1,1,0,1
56788_0,,,,2,2,1,3
56790_0,,,,2,2,1,3
[CH](C(O)=O)C(CCC(C=O)=O)O,,,5,1,1,0,1
56792_0,,,,2,2,1,3
C([C](CO)CCC(C=O)=O)(O)=O,,,5,1,1,0,1
56794_0,,,,2,2,1,3
C(C(CCC(C=O)=O)O)=O,,,5,1,1,0,1
56796_0,,,,2,2,1,3
C1(C(OC(C)C1CCC(C=O)=O)=O)=O,,,5,1,1,0,1
56798_0,,,,2,2,1,3
C(C(CCCC1CC(C(O1)=O)=O)=O)=O,,,5,1,1,0,1
56800_0,,,,2,2,1,3
C(C(CCC1(C)CC(C(O1)=O)=O)=O)=O,,,5,1,1,0,1
56802_0,,,,2,2,1,3
C1(C(C(C(O1)=O)=O)CCC(C=O)=O)=O,,,5,1,1,0,1
56804_0,,,,2,2,1,3
C(C(CCC(C=O)=O)C[CH]C(O)=O)=O,,,5,1,1,0,1
56806_0,,,,2,2,1,3
C(CC([CH]C(O)=O)CCC(C=O)=O)=O,,,5,1,1,0,1
56808_0,,,,2,2,1,3
C(CC[C](C(O)=O)CCC(C=O)=O)=O,,,5,1,2,0,2
56810_0,,,,2,2,1,3
[C](C(O)=O)(C(CCC(C=O)=O)O)O,,,5,1,1,0,1
56812_0,,,,2,2,1,3
C(C(CCCC(C=O)=O)O)=O,,,5,1,1,0,1
56813_0,,,,2,2,1,3
56815_0,,,,2,2,1,3
C(C(CCCC(C(O)=O)=O)=O)=O,,,5,1,2,0,2
56817_0,,,,2,2,1,3
C(C(CO)(CO)CC(C=O)=O)(O)=O,,,5,1,1,0,1
56819_0,,,,2,2,1,3
C(C(CO)C(C(C=O)=O)CO)(O)=O,,,5,1,1,0,1
56821_0,,,,2,2,1,3
C=CC(C(C=O)=O)C(C)CC(C=O)=O,,,5,1,1,0,1
56823_0,,,,2,2,1,3
C(CCC(C=C)C(C=O)=O)=O,,,5,1,1,0,1
56825_0,,,,2,2,1,3
C=CC(C(C=O)=O)CCC(C(O)=O)=O,,,5,1,1,0,1
56827_0,,,,2,2,1,3
C(C(C=C)CC(C=C)C(C=O)=O)(O)=O,,,5,1,1,0,1
56828_0,,,,2,2,1,3
56829_0,,,,2,2,1,3
56830_0,,,,2,2,1,3
56832_0,,,,2,2,1,3
C(CC(C)CC(C=O)=O)=CC(C=O)=O,,,5,1,1,0,1
56834_0,,,,2,2,1,3
C(CCCC=CC(C=O)=O)=O,,,5,1,1,0,1
56836_0,,,,2,2,1,3
C(CCCC(C(O)=O)=O)=CC(C=O)=O,,,5,1,1,0,1
56838_0,,,,2,2,1,3
C(C(C=C)CCC=CC(C=O)=O)(O)=O,,,5,1,1,0,1
56839_0,,,,2,2,1,3
56840_0,,,,2,2,1,3
56841_0,,,,2,2,1,3
56843_0,,,,2,2,1,3
C=CC(CC(C)CC(C=O)=O)O,,,5,1,1,0,1
56845_0,,,,2,2,1,3
C(C(C)(C(C)CC(C=O)=O)O)=C,,,5,1,1,0,1
56847_0,,,,2,2,1,3
C(C(CO)(C(C)CC(C=O)=O)O)=C,,,5,1,1,0,1
56849_0,,,,2,2,1,3
C=CC(C(C(C)CC(C=O)=O)O)O,,,5,1,1,0,1
56851_0,,,,2,2,1,3
C(C(CC)(C(C)CC(C=O)=O)O)=O,,,5,1,1,0,1
56853_0,,,,2,2,1,3
C(C(CCC(C)CC(C=O)=O)O)=O,,,5,1,1,0,1
56855_0,,,,2,2,1,3
C(C(C(C)C(C)CC(C=O)=O)O)=O,,,5,1,1,0,1
56857_0,,,,2,2,1,3
C(C(CCO)C(C)CC(C=O)=O)=O,,,5,1,1,0,1
56859_0,,,,2,2,1,3
C(CCC(C(C)CC(C=O)=O)O)=O,,,5,1,1,0,1
56861_0,,,,2,2,1,3
C(CC(CO)C(C)CC(C=O)=O)=O,,,5,1,1,0,1
56863_0,,,,2,2,1,3
C1(C(OCC1C(C)CC(C=O)=O)=O)=O,,,5,1,1,0,1
56865_0,,,,2,2,1,3
C(C(CC(C)C1CC(C(O1)=O)=O)=O)=O,,,5,1,1,0,1
56867_0,,,,2,2,1,3
[CH](C(O)=O)C(C)CC(C=O)=O,,,5,1,1,0,1
56869_0,,,,2,2,1,3
C(C(C(C)CC(C=O)=O)(O)O)=O,,,5,1,1,0,1
56870_0,,,,2,2,1,3
56872_0,,,,2,2,1,3
[C](C(O)=O)(CC(C)CC(C=O)=O)O,,,5,1,2,0,2
56874_0,,,,2,2,1,3
C(C(CC(C)CC(C=O)=O)O)(O)=O,,,5,1,2,0,2
56876_0,,,,2,2,1,3
C(C(C)(C(C)CC(C=O)=O)O)(O)=O,,,5,1,1,0,1
56877_0,,,,2,2,1,3
56878_0,,,,2,2,1,3
56880_0,,,,2,2,1,3
C(CC(C)(C(C)CC(C=O)=O)O)=O,,,5,1,1,0,1
56881_0,,,,2,2,1,3
56883_0,,,,2,2,1,3
C(C=O)(CC(C)C(C(C=O)=O)O)=O,,,5,1,1,0,1
56885_0,,,,2,2,1,3
C(C(CC(C)CC(C=O)=O)=O)=O,,,5,1,1,0,1
56887_0,,,,2,2,1,3
C(C(C(C)CC(C=O)=O)O)(O)=O,,,5,1,1,0,1
56888_0,,,,2,2,1,3
56889_0,,,,2,2,1,3
56891_0,,,,2,2,1,3
C(CC(C(C)CC(C=O)=O)O)=O,,,5,1,1,0,1
56893_0,,,,2,2,1,3
C(C(C=O)(C(C)CC(C=O)=O)O)=O,,,5,1,1,0,1
56895_0,,,,2,2,1,3
C(C(CC(C)C(CO)C(C)O)=O)=O,,,5,1,1,0,1
56897_0,,,,2,2,1,3
C(C(CC(C)C(CC(C)O)O)=O)=O,,,5,1,1,0,1
56899_0,,,,2,2,1,3
C(C(CC(C)CC(CCO)O)=O)=O,,,5,1,1,0,1
56901_0,,,,2,2,1,3
C(C(CC(C)C(C)(CCO)O)=O)=O,,,5,1,1,0,1
56903_0,,,,2,2,1,3
C(C(CO)C(C)CC(C=O)=O)(O)=O,,,5,1,1,0,1
56905_0,,,,2,2,1,3
C(CC(C(C)CC(C=O)=O)O)(O)=O,,,5,1,1,0,1
56907_0,,,,2,2,1,3
C(CO)(C(C(C)CC(C=O)=O)O)=O,,,5,1,1,0,1
56909_0,,,,2,2,1,3
C(CO)(CC(C)CC(C=O)=O)=O,,,5,1,1,0,1
56911_0,,,,2,2,1,3
C(C)(C(C(C)CC(C=O)=O)O)=O,,,5,1,1,0,1
56913_0,,,,2,2,1,3
C(C(CC(C)CO)=O)=O,,,5,1,1,0,1
56914_0,,,,2,2,1,3
56916_0,,,,2,2,1,3
C(C(CC(C)C(C)O)=O)=O,,,5,1,1,0,1
56917_0,,,,2,2,1,3
56919_0,,,,2,2,1,3
C(CC(C)CC(C=O)=O)=CC=O,,,5,1,1,0,1
56921_0,,,,2,2,1,3
C(C(C=C)C(C)CC(C=O)=O)=O,,,5,1,1,0,1
56923_0,,,,2,2,1,3
C(C(C(C(C)CC(C=O)=O)O)O)=O,,,5,1,1,0,1
56925_0,,,,2,2,1,3
C(C(CO)(C(C)CC(C=O)=O)O)=O,,,5,1,1,0,1
56927_0,,,,2,2,1,3
[CH](C(O)=O)C(C(C)CC(C=O)=O)O,,,5,1,1,0,1
56929_0,,,,2,2,1,3
[C](C(O)=O)(CO)C(C)CC(C=O)=O,,,5,1,1,0,1
56931_0,,,,2,2,1,3
C(C(C(C)CC(C=O)=O)O)=O,,,5,1,1,0,1
56933_0,,,,2,2,1,3
C(C(CC(C)CC(C=O)=O)O)=O,,,5,1,1,0,1
56935_0,,,,2,2,1,3
C(C(C)(C(C)CC(C=O)=O)O)=O,,,5,1,1,0,1
56936_0,,,,2,2,1,3
56938_0,,,,2,2,1,3
C(CCC(C(C(O)=O)=CC=O)O)=O,,,5,1,1,0,1
56940_0,,,,2,2,1,3
C(CCC(C=C)(C(C(O)=O)=O)O)=O,,,5,1,1,0,1
56942_0,,,,2,2,1,3
C(CCCC(C=C)O)=O,,,5,1,1,0,1
56944_0,,,,2,2,1,3
C(CCC(C=C)(C)O)=O,,,5,1,1,0,1
56946_0,,,,2,2,1,3
C(C(C(C=O)=C)(CCC=O)O)(O)=O,,,5,1,1,0,1
56948_0,,,,2,2,1,3
C(CCC(C(C(O)=O)=C)O)=O,,,5,1,1,0,1
56950_0,,,,2,2,1,3
C(CCCC(C(C(O)=O)=C)=O)=O,,,5,1,1,0,1
56952_0,,,,2,2,1,3
C(CCC(C=C)(CO)O)=O,,,5,1,1,0,1
56954_0,,,,2,2,1,3
C(CCC(C(C=C)O)O)=O,,,5,1,1,0,1
56956_0,,,,2,2,1,3
C(CCC(C=C)(C(C(O)=O)O)O)=O,,,5,1,1,0,1
56958_0,,,,2,2,1,3
C(C(CCC=O)(C(C=C)O)O)(O)=O,,,5,1,1,0,1
56960_0,,,,2,2,1,3
C(CCC(C(C(O)=O)=C)(CO)O)=O,,,5,1,1,0,1
56962_0,,,,2,2,1,3
C(CCC(C(C(C(O)=O)=C)O)O)=O,,,5,1,1,0,1
56964_0,,,,2,2,1,3
C(CCC1C(C(OC1O)=O)=C)=O,,,5,1,1,0,1
56966_0,,,,2,2,1,3
C(CCC1(CC(C(O1)=O)=C)O)=O,,,5,1,1,0,1
56968_0,,,,2,2,1,3
C(CCCC1C(OC(C=1)O)=O)=O,,,5,1,1,0,1
56970_0,,,,2,2,1,3
C(CCC1(C=C(C(O1)=O)C)O)=O,,,5,1,1,0,1
56972_0,,,,2,2,1,3
C1(C(C=CO1)(CCCC=O)O)=O,,,5,1,1,0,1
56974_0,,,,2,2,1,3
C(CCCC(C1OC(C(C=1)=O)=O)=O)=O,,,5,1,1,0,1
56976_0,,,,2,2,1,3
C(CCC1C(C(OC(C1=O)=C)=O)=O)=O,,,5,1,1,0,1
56978_0,,,,2,2,1,3
C1(C(C(C(O1)=O)=C)(CCCC=O)O)=O,,,5,1,1,0,1
56980_0,,,,2,2,1,3
[C]1C(OC(C(O)=O)(C=1)CCCC=O)=O,,,5,1,1,0,1
56982_0,,,,2,2,1,3
C(CCCC1C(O[C](C(O)=O)C=1)=O)=O,,,5,1,1,0,1
56984_0,,,,2,2,1,3
C(CCC1[C](C(O)=O)OC(C1=C)=O)=O,,,5,1,1,0,1
56986_0,,,,2,2,1,3
C(C1(C=CC(O1)=O)CCCC=O)(O)=O,,,5,1,1,0,1
56988_0,,,,2,2,1,3
C(CCC1(C(O)=O)C=C(C(O1)=O)C)=O,,,5,1,1,0,1
56990_0,,,,2,2,1,3
C(C1C=C(C(O1)=O)CCCC=O)(O)=O,,,5,1,1,0,1
56992_0,,,,2,2,1,3
C(CCC1C(C(OC1C(O)=O)=O)=C)=O,,,5,1,1,0,1
56994_0,,,,2,2,1,3
C(C1(CCC=O)CC(C(O1)=O)=C)(O)=O,,,5,1,1,0,1
56996_0,,,,2,2,1,3
[C]1C(OC(C(C=1)(CCCC=O)O)=O)=O,,,5,1,1,0,1
56998_0,,,,2,2,1,3
C(CCCC1C(OC([C](C=1)O)=O)=O)=O,,,5,1,1,0,1
57000_0,,,,2,2,1,3
C(CCC1[C](C(OC(C1=C)=O)=O)O)=O,,,5,1,1,0,1
57002_0,,,,2,2,1,3
C1(C(C=CC(O1)=O)(CCCC=O)O)=O,,,5,1,1,0,1
57004_0,,,,2,2,1,3
C(CCC1(C(OC(C(C)=C1)=O)=O)O)=O,,,5,1,1,0,1
57006_0,,,,2,2,1,3
C1(C(C=C(C(O1)=O)CCCC=O)O)=O,,,5,1,1,0,1
57008_0,,,,2,2,1,3
C(CCC1C(C(OC(C1O)=O)=O)=C)=O,,,5,1,1,0,1
57010_0,,,,2,2,1,3
C1(C(CCC=O)(CC(C(O1)=O)=C)O)=O,,,5,1,1,0,1
57012_0,,,,2,2,1,3
C(CCC([CH]C(O)=O)C(C=O)=CC)=O,,,5,1,1,0,1
57014_0,,,,2,2,1,3
C(CC[C](C(O)=O)CC(C=O)=CC)=O,,,5,1,1,0,1
57016_0,,,,2,2,1,3
C(CCCC=C(C=O)C[CH]C(O)=O)=O,,,5,1,1,0,1
57018_0,,,,2,2,1,3
C(CCC([CH]C(O)=O)C(C=O)C=C)=O,,,5,1,1,0,1
57020_0,,,,2,2,1,3
C(C(C=C)C[C](C(O)=O)CCC=O)=O,,,5,1,1,0,1
57022_0,,,,2,2,1,3
C(CCC(C=O)(C=C)C[CH]C(O)=O)=O,,,5,1,1,0,1
57024_0,,,,2,2,1,3
C(CCC(C(C=O)=CC)CC(O)=O)=O,,,5,1,1,0,1
57026_0,,,,2,2,1,3
C(CCC(C(O)=O)CC(C=O)=CC)=O,,,5,1,1,0,1
57028_0,,,,2,2,1,3
C(CCCC=C(C=O)CCC(O)=O)=O,,,5,1,1,0,1
57030_0,,,,2,2,1,3
C(C(C=C)C(CCC=O)CC(O)=O)=O,,,5,1,1,0,1
57032_0,,,,2,2,1,3
C(C(C=C)CC(C(O)=O)CCC=O)=O,,,5,1,1,0,1
57034_0,,,,2,2,1,3
C(C(C=C)(CCC=O)CCC(O)=O)=O,,,5,1,1,0,1
57036_0,,,,2,2,1,3
C(CCC([CH]C(O)=O)CC=CC=O)=O,,,5,1,1,0,1
57038_0,,,,2,2,1,3
C(CC[C](C(O)=O)CCC=CC=O)=O,,,5,1,1,0,1
57040_0,,,,2,2,1,3
C(CCC(C=CC=O)C[CH]C(O)=O)=O,,,5,1,1,0,1
57042_0,,,,2,2,1,3
C(CC=CC([CH]C(O)=O)CCC=O)=O,,,5,1,1,0,1
57044_0,,,,2,2,1,3
C(CC=CC[C](C(O)=O)CCC=O)=O,,,5,1,1,0,1
57046_0,,,,2,2,1,3
C(C(C=CC[CH]C(O)=O)CCC=O)=O,,,5,1,1,0,1
57048_0,,,,2,2,1,3
C(CCC(CC(O)=O)CC=CC=O)=O,,,5,1,1,0,1
57050_0,,,,2,2,1,3
C(CCC(C(O)=O)CCC=CC=O)=O,,,5,1,1,0,1
57052_0,,,,2,2,1,3
C(CCC(C=CC=O)CCC(O)=O)=O,,,5,1,1,0,1
57054_0,,,,2,2,1,3
C(CCC(C=CCC=O)CC(O)=O)=O,,,5,1,1,0,1
57056_0,,,,2,2,1,3
C(CCC(C(O)=O)CC=CCC=O)=O,,,5,1,1,0,1
57058_0,,,,2,2,1,3
C(CCC(C=O)C=CCCC(O)=O)=O,,,5,1,1,0,1
57060_0,,,,2,2,1,3
C(CC(C)=C[C](C(O)=O)CCC=O)=O,,,5,1,1,0,1
57062_0,,,,2,2,1,3
C(CCC(C=O)C(C)=C[CH]C(O)=O)=O,,,5,1,1,0,1
57064_0,,,,2,2,1,3
C(CC(CCCC=O)=C[CH]C(O)=O)=O,,,5,1,1,0,1
57066_0,,,,2,2,1,3
C(CCC(C(C)=CC=O)[CH]C(O)=O)=O,,,5,1,1,0,1
57068_0,,,,2,2,1,3
C(CC[C](C(O)=O)CC(C)=CC=O)=O,,,5,1,1,0,1
57070_0,,,,2,2,1,3
C(CCCC(C[CH]C(O)=O)=CC=O)=O,,,5,1,1,0,1
57072_0,,,,2,2,1,3
C(CC(C([CH]C(O)=O)CCC=O)=C)=O,,,5,1,1,0,1
57074_0,,,,2,2,1,3
C(CC(C[C](C(O)=O)CCC=O)=C)=O,,,5,1,1,0,1
57076_0,,,,2,2,1,3
C(C(C(C[CH]C(O)=O)=C)CCC=O)=O,,,5,1,1,0,1
57078_0,,,,2,2,1,3
C(CCC(C(O)=O)C=C(C)CC=O)=O,,,5,1,1,0,1
57080_0,,,,2,2,1,3
C(C(C(C)=CCC(O)=O)CCC=O)=O,,,5,1,1,0,1
57082_0,,,,2,2,1,3
C(CC(CCCC=O)=CCC(O)=O)=O,,,5,1,1,0,1
57084_0,,,,2,2,1,3
C(CCC(C(C)=CC=O)CC(O)=O)=O,,,5,1,1,0,1
57086_0,,,,2,2,1,3
C(CCC(C(O)=O)CC(C)=CC=O)=O,,,5,1,1,0,1
57088_0,,,,2,2,1,3
C(CCCC(CCC(O)=O)=CC=O)=O,,,5,1,1,0,1
57090_0,,,,2,2,1,3
C(CCC(C(CC=O)=C)CC(O)=O)=O,,,5,1,1,0,1
57092_0,,,,2,2,1,3
C(CCC(C(O)=O)CC(CC=O)=C)=O,,,5,1,1,0,1
57094_0,,,,2,2,1,3
C(CCC(C=O)C(CCC(O)=O)=C)=O,,,5,1,1,0,1
57096_0,,,,2,2,1,3
C(CC[C](C(O)=O)C=CC(C=O)=O)=O,,,5,1,1,0,1
57098_0,,,,2,2,1,3
C(CC[C](C(O)=O)C=CC(O)=O)=O,,,5,1,1,0,1
57100_0,,,,2,2,1,3
C(CCC(C(O)=O)C=CC(O)=O)=O,,,5,1,2,0,2
57102_0,,,,2,2,1,3
C(CCC(C=C[CH]C(O)=O)O)=O,,,5,1,1,0,1
57104_0,,,,2,2,1,3
C(CC[C](C(O)=O)C=CCO)=O,,,5,1,1,0,1
57106_0,,,,2,2,1,3
[C](C(O)=O)=CC([CH]C(O)=O)CCC=O,,,5,1,1,0,1
57108_0,,,,2,2,1,3
[C](C(O)=O)=CC[C](C(O)=O)CCC=O,,,5,1,1,0,1
57110_0,,,,2,2,1,3
C(CCC(C=CC(O)=O)[CH]C(O)=O)=O,,,5,1,1,0,1
57112_0,,,,2,2,1,3
C(CC[C](C(O)=O)CC=CC(O)=O)=O,,,5,1,1,0,1
57114_0,,,,2,2,1,3
C(CCC([CH]C(O)=O)C(C(O)=O)=C)=O,,,5,1,1,0,1
57116_0,,,,2,2,1,3
C(CC[C](C(O)=O)CC(C(O)=O)=C)=O,,,5,1,1,0,1
57118_0,,,,2,2,1,3
C(CCCC(C(O)=O)=C[CH]C(O)=O)=O,,,5,1,1,0,1
57120_0,,,,2,2,1,3
C(CC[C](C(O)=O)C=C(C(O)=O)C)=O,,,5,1,1,0,1
57122_0,,,,2,2,1,3
C(CCC(C=CCC(O)=O)O)=O,,,5,1,1,0,1
57124_0,,,,2,2,1,3
C(CCC(C(O)=O)C=CCO)=O,,,5,1,1,0,1
57126_0,,,,2,2,1,3
[C](C(O)=O)=CC(CCC=O)CC(O)=O,,,5,1,1,0,1
57128_0,,,,2,2,1,3
[C](C(O)=O)=CCC(C(O)=O)CCC=O,,,5,1,1,0,1
57130_0,,,,2,2,1,3
[C](C(O)=O)=CC(CCCC=O)O,,,5,1,1,0,1
57132_0,,,,2,2,1,3
[C](C(O)=O)=CC(C)(CCC=O)O,,,5,1,1,0,1
57134_0,,,,2,2,1,3
C(CCCC=C[C](C(O)=O)O)=O,,,5,1,1,0,1
57136_0,,,,2,2,1,3
C(CCC(C=C)[C](C(O)=O)O)=O,,,5,1,1,0,1
57138_0,,,,2,2,1,3
C(CCCC(C=CC(O)=O)O)=O,,,5,1,1,0,1
57140_0,,,,2,2,1,3
C(CCC(C=CC(O)=O)(C)O)=O,,,5,1,1,0,1
57142_0,,,,2,2,1,3
C(CCC(C(O)=O)(C=CC)O)=O,,,5,1,1,0,1
57144_0,,,,2,2,1,3
C(C(C=CCCCC=O)O)(O)=O,,,5,1,1,0,1
57146_0,,,,2,2,1,3
C(CCC(C=C)C(C(O)=O)O)=O,,,5,1,1,0,1
57148_0,,,,2,2,1,3
C(C(CCC=O)(CC=C)O)(O)=O,,,5,1,1,0,1
57150_0,,,,2,2,1,3
C(CCC(C(CO)(C(C)O)O)O)=O,,,5,1,1,0,1
57152_0,,,,2,2,1,3
C(CCCC(C(CO)(CO)O)O)=O,,,5,1,1,0,1
57154_0,,,,2,2,1,3
C(CCC(C)(C(CO)(CO)O)O)=O,,,5,1,1,0,1
57156_0,,,,2,2,1,3
C(CCC(C(C(C(C)O)=O)O)O)=O,,,5,1,1,0,1
57158_0,,,,2,2,1,3
C(CCC(C(C(C)O)=O)(CO)O)=O,,,5,1,1,0,1
57160_0,,,,2,2,1,3
C(CCCC(C(C(CO)O)=O)O)=O,,,5,1,1,0,1
57162_0,,,,2,2,1,3
C(CCC(C(C(CO)O)=O)(C)O)=O,,,5,1,1,0,1
57164_0,,,,2,2,1,3
C(C(CCCC=O)C(CO)O)(O)=O,,,5,1,1,0,1
57166_0,,,,2,2,1,3
C(C(C)(CCC=O)C(CO)O)(O)=O,,,5,1,1,0,1
57168_0,,,,2,2,1,3
C(C(C)C(C(CCC=O)O)O)(O)=O,,,5,1,1,0,1
57170_0,,,,2,2,1,3
C(C(C)C(CCC=O)(CO)O)(O)=O,,,5,1,1,0,1
57172_0,,,,2,2,1,3
C(CCC1(C(C)OC(C1O)=O)O)=O,,,5,1,1,0,1
57174_0,,,,2,2,1,3
C1(C(CCC=O)(C(C(C)O1)O)O)=O,,,5,1,1,0,1
57176_0,,,,2,2,1,3
C(CCCC1C(C(C(O1)=O)O)O)=O,,,5,1,1,0,1
57178_0,,,,2,2,1,3
C(CCC1(C)C(C(C(O1)=O)O)O)=O,,,5,1,1,0,1
57180_0,,,,2,2,1,3
C1(C(CCC=O)(C(C(O1)=O)O)O)=O,,,5,1,1,0,1
57182_0,,,,2,2,1,3
C(C(CCC=O)(CC)O)=O,,,5,1,1,0,1
57184_0,,,,2,2,1,3
C(CCCCC(C=O)O)=O,,,5,1,1,0,1
57186_0,,,,2,2,1,3
C(CCC(C)C(C=O)O)=O,,,5,1,1,0,1
57188_0,,,,2,2,1,3
C(C(CCC=O)CCO)=O,,,5,1,1,0,1
57190_0,,,,2,2,1,3
C(CCC(CCC=O)O)=O,,,5,1,1,0,1
57192_0,,,,2,2,1,3
C(CCC(CO)CC=O)=O,,,5,1,1,0,1
57194_0,,,,2,2,1,3
C(CCC(C(C(O)=O)=O)(CC)O)=O,,,5,1,1,0,1
57196_0,,,,2,2,1,3
C(CCCCC(C(C(O)=O)=O)O)=O,,,5,1,1,0,1
57198_0,,,,2,2,1,3
C(CCC(C)C(C(C(O)=O)=O)O)=O,,,5,1,1,0,1
57200_0,,,,2,2,1,3
C(CCC(C(C(O)=O)=O)CCO)=O,,,5,1,1,0,1
57202_0,,,,2,2,1,3
C(CCC(CCC(C(O)=O)=O)O)=O,,,5,1,2,0,2
57204_0,,,,2,2,1,3
C(CCC(CO)CC(C(O)=O)=O)=O,,,5,1,1,0,1
57206_0,,,,2,2,1,3
C(C(C(CCC=O)O)CC=O)(O)=O,,,5,1,1,0,1
57208_0,,,,2,2,1,3
C(C(CCC=O)(CO)CC=O)(O)=O,,,5,1,1,0,1
57210_0,,,,2,2,1,3
C(CCC(C=O)C(C(O)=O)CO)=O,,,5,1,1,0,1
57212_0,,,,2,2,1,3
C(C(CCCC=O)C(C=O)O)(O)=O,,,5,1,1,0,1
57214_0,,,,2,2,1,3
C(C(C)(CCC=O)C(C=O)O)(O)=O,,,5,1,1,0,1
57216_0,,,,2,2,1,3
C(C(C)C(C=O)(CCC=O)O)(O)=O,,,5,1,1,0,1
57218_0,,,,2,2,1,3
C(C1(COC(C1CCC=O)O)O)=O,,,5,1,1,0,1
57220_0,,,,2,2,1,3
C(C1(COC(C1)(CCC=O)O)O)=O,,,5,1,1,0,1
57222_0,,,,2,2,1,3
C(C1(C(CCC=O)OC(C1)O)O)=O,,,5,1,1,0,1
57224_0,,,,2,2,1,3
C(CCC1C(C(C(O)O1)=O)O)=O,,,5,1,1,0,1
57226_0,,,,2,2,1,3
C(CCC1(C(C(O)OC1)=O)O)=O,,,5,1,1,0,1
57228_0,,,,2,2,1,3
C(CCC1(C(C(CO1)O)=O)O)=O,,,5,1,1,0,1
57230_0,,,,2,2,1,3
C(CCCC1C(C(C(O)O1)=O)O)=O,,,5,1,1,0,1
57232_0,,,,2,2,1,3
C(CCC1(C)C(C(C(O)O1)=O)O)=O,,,5,1,1,0,1
57234_0,,,,2,2,1,3
C(CCC1(C(C(O)OC1C)=O)O)=O,,,5,1,1,0,1
57236_0,,,,2,2,1,3
C(CCC1(C(C(C(C)O1)O)=O)O)=O,,,5,1,1,0,1
57238_0,,,,2,2,1,3
C(CCC1(C(OC(C1=O)O)=O)O)=O,,,5,1,1,0,1
57240_0,,,,2,2,1,3
C(CCC1(C(C(C(O1)=O)O)=O)O)=O,,,5,1,1,0,1
57242_0,,,,2,2,1,3
C(CCC1CC(C(O)O1)=O)=O,,,5,1,1,0,1
57244_0,,,,2,2,1,3
C(CCC1C(C(O)OC1)=O)=O,,,5,1,1,0,1
57246_0,,,,2,2,1,3
C(CCC1(C(CCO1)=O)O)=O,,,5,1,1,0,1
57248_0,,,,2,2,1,3
C(CCCC1CC(C(O)O1)=O)=O,,,5,1,1,0,1
57250_0,,,,2,2,1,3
C(CCC1(C)CC(C(O)O1)=O)=O,,,5,1,1,0,1
57252_0,,,,2,2,1,3
C(CCC1C(C(O)OC1C)=O)=O,,,5,1,1,0,1
57254_0,,,,2,2,1,3
C(CCC1(C(CC(C)O1)=O)O)=O,,,5,1,1,0,1
57256_0,,,,2,2,1,3
C(CCC1C(OC(C1=O)O)=O)=O,,,5,1,1,0,1
57258_0,,,,2,2,1,3
C(CCC1(C(CC(O1)=O)=O)O)=O,,,5,1,1,0,1
57260_0,,,,2,2,1,3
C(CCC1C(O)OC(C)CC1O)=O,,,5,1,1,0,1
57262_0,,,,2,2,1,3
C(CCC1(CC(CC(C)O1)O)O)=O,,,5,1,1,0,1
57264_0,,,,2,2,1,3
C(CCC1C(C)OC(CC1O)O)=O,,,5,1,1,0,1
57266_0,,,,2,2,1,3
C(CCC1(CC(O)OC(C)C1)O)=O,,,5,1,1,0,1
57268_0,,,,2,2,1,3
C(CCCC1CC(CC(O)O1)O)=O,,,5,1,1,0,1
57270_0,,,,2,2,1,3
C(CCC1(C)CC(CC(O)O1)O)=O,,,5,1,1,0,1
57272_0,,,,2,2,1,3
C1(CC(C(CCC=O)C(O)O1)O)=O,,,5,1,1,0,1
57274_0,,,,2,2,1,3
C1(CC(CC(CCC=O)(O)O1)O)=O,,,5,1,1,0,1
57276_0,,,,2,2,1,3
C1(C(CCC=O)C(CC(O)O1)O)=O,,,5,1,1,0,1
57278_0,,,,2,2,1,3
C1(CC(CCC=O)(CC(O)O1)O)=O,,,5,1,1,0,1
57280_0,,,,2,2,1,3
C(CCC1C(OCC(C1O)=O)O)=O,,,5,1,1,0,1
57282_0,,,,2,2,1,3
C(CCC1(CC(C(CO1)=O)O)O)=O,,,5,1,1,0,1
57284_0,,,,2,2,1,3
C(CCC1C(C(CC(O1)O)O)=O)=O,,,5,1,1,0,1
57286_0,,,,2,2,1,3
C(CCC1(C(COC(C1)O)=O)O)=O,,,5,1,1,0,1
57288_0,,,,2,2,1,3
C(CCC1[CH]C(OC(C=O)(C1)O)=O)=O,,,5,1,1,0,1
57290_0,,,,2,2,1,3
C(C1(CC[C](C(O1)=O)CCC=O)O)=O,,,5,1,1,0,1
57292_0,,,,2,2,1,3
C(CCC1C(C=O)(O)OC([CH]C1)=O)=O,,,5,1,1,0,1
57294_0,,,,2,2,1,3
C(CCC1C(O)OC([CH]C1)=O)=O,,,5,1,1,0,1
57296_0,,,,2,2,1,3
C(CCC1(CC[CH]C(O1)=O)O)=O,,,5,1,1,0,1
57298_0,,,,2,2,1,3
C(CCC1[CH]C(OC(C1)O)=O)=O,,,5,1,1,0,1
57300_0,,,,2,2,1,3
C(CC[C]1C(OC(CC1)O)=O)=O,,,5,1,1,0,1
57302_0,,,,2,2,1,3
C1(CCC(CCC=O)C(O)O1)=O,,,5,1,1,0,1
57304_0,,,,2,2,1,3
C1(CCCC(CCC=O)(O)O1)=O,,,5,1,1,0,1
57306_0,,,,2,2,1,3
C1(CC(CCC=O)CC(O)O1)=O,,,5,1,1,0,1
57308_0,,,,2,2,1,3
C1(C(CCC=O)CCC(O)O1)=O,,,5,1,1,0,1
57310_0,,,,2,2,1,3
C(CCC1[CH]C(OC(C(C1)=O)O)=O)=O,,,5,1,1,0,1
57312_0,,,,2,2,1,3
C(CC[C]1C(OC(C(CC1)=O)O)=O)=O,,,5,1,1,0,1
57314_0,,,,2,2,1,3
C(CCC1C(C(O)OC([CH]C1)=O)=O)=O,,,5,1,1,0,1
57316_0,,,,2,2,1,3
C(CCC1(C(CC[CH]C(O1)=O)=O)O)=O,,,5,1,1,0,1
57318_0,,,,2,2,1,3
C(CCC(C=O)(C[CH]C(O)=O)O)=O,,,5,1,1,0,1
57320_0,,,,2,2,1,3
C(CCC([CH]C(O)=O)C(C=O)O)=O,,,5,1,1,0,1
57322_0,,,,2,2,1,3
C(CC[C](C(O)=O)CC(C=O)O)=O,,,5,1,1,0,1
57324_0,,,,2,2,1,3
C(C(CCC(O)=O)(CCC=O)O)=O,,,5,1,1,0,1
57326_0,,,,2,2,1,3
C(CC(CCC=O)C(C=O)O)(O)=O,,,5,1,1,0,1
57328_0,,,,2,2,1,3
C(C(CCC=O)CC(C=O)O)(O)=O,,,5,1,1,0,1
57330_0,,,,2,2,1,3
C(CCC1C(C(OC1(C=O)C)=O)=O)=O,,,5,1,1,0,1
57332_0,,,,2,2,1,3
C(CCCC1(C=O)CC(C(O1)=O)=O)=O,,,5,1,1,0,1
57334_0,,,,2,2,1,3
C(CCC1C(C(OC1C(C)=O)=O)=O)=O,,,5,1,1,0,1
57336_0,,,,2,2,1,3
C(CCCC(C1CC(C(O1)=O)=O)=O)=O,,,5,1,1,0,1
57338_0,,,,2,2,1,3
C(C)(C1(CCC=O)CC(C(O1)=O)=O)=O,,,5,1,1,0,1
57340_0,,,,2,2,1,3
C(CCC1(C(C(OC1)=O)=O)O)=O,,,5,1,1,0,1
57342_0,,,,2,2,1,3
C(CCC1C(C(C(O1)=O)=O)O)=O,,,5,1,1,0,1
57344_0,,,,2,2,1,3
C(CCC1C(C(OC1)=O)=O)=O,,,5,1,1,0,1
57346_0,,,,2,2,1,3
C(CCC1CC(C(O1)=O)=O)=O,,,5,1,1,0,1
57348_0,,,,2,2,1,3
C(CCCC1C(C(C(O1)=O)=O)O)=O,,,5,1,1,0,1
57350_0,,,,2,2,1,3
C(CCC1(C)C(C(C(O1)=O)=O)O)=O,,,5,1,1,0,1
57352_0,,,,2,2,1,3
C(CCC1(C(C(OC1C)=O)=O)O)=O,,,5,1,1,0,1
57354_0,,,,2,2,1,3
C1(C(C(C(O1)=O)=O)(CCC=O)O)=O,,,5,1,1,0,1
57356_0,,,,2,2,1,3
C(CCC1C(C(C(O1)=O)=O)=O)=O,,,5,1,1,0,1
57358_0,,,,2,2,1,3
C1(C(CCO1)(CCCC=O)O)=O,,,5,1,1,0,1
57360_0,,,,2,2,1,3
C1(C(C)(C(CO1)CCC=O)O)=O,,,5,1,1,0,1
57362_0,,,,2,2,1,3
C1(C(C)(CC(CCC=O)O1)O)=O,,,5,1,1,0,1
57364_0,,,,2,2,1,3
C1(C(CCCC=O)(CC(O1)=O)O)=O,,,5,1,1,0,1
57366_0,,,,2,2,1,3
C1(C(CCC=O)C(C(O1)=O)(C)O)=O,,,5,1,2,0,2
57368_0,,,,2,2,1,3
C1(C(C(CO1)O)(CCCC=O)O)=O,,,5,1,1,0,1
57370_0,,,,2,2,1,3
C1(C(C)(C(CO1)(CCC=O)O)O)=O,,,5,1,1,0,1
57372_0,,,,2,2,1,3
C1(C(C)(C(C(CCC=O)O1)O)O)=O,,,5,1,1,0,1
57374_0,,,,2,2,1,3
C(CCC1[C]2C(OC1(C(O2)=O)C)=O)=O,,,5,1,1,0,1
57376_0,,,,2,2,1,3
C1(C2(CCCC=O)C[C](C(O2)=O)O1)=O,,,5,1,1,0,1
57378_0,,,,2,2,1,3
C(CCC1C2C(OC1(C(O2)=O)C)=O)=O,,,5,1,1,0,1
57380_0,,,,2,2,1,3
C(CCC12C(OC(C(O1)=O)(C)C2)=O)=O,,,5,1,1,0,1
57382_0,,,,2,2,1,3
C(CCCC12C(OC(C(O1)=O)C2)=O)=O,,,5,1,1,0,1
57384_0,,,,2,2,1,3
C(CC1(C)C([CH]C(O1)=O)CCC=O)=O,,,5,1,1,0,1
57386_0,,,,2,2,1,3
C(CC1(C)C[C](C(O1)=O)CCC=O)=O,,,5,1,1,0,1
57388_0,,,,2,2,1,3
C(C(CCC=O)C1(C)C[CH]C(O1)=O)=O,,,5,1,1,0,1
57390_0,,,,2,2,1,3
C(CCCC1(CC=O)C[CH]C(O1)=O)=O,,,5,1,1,0,1
57392_0,,,,2,2,1,3
C(CCC1C(C)(CC=O)OC(C1)=O)=O,,,5,1,1,0,1
57394_0,,,,2,2,1,3
C(CC1(C)CC(C(O1)=O)CCC=O)=O,,,5,1,1,0,1
57396_0,,,,2,2,1,3
C(C(CCC=O)C1(C)CCC(O1)=O)=O,,,5,1,1,0,1
57398_0,,,,2,2,1,3
C(CCCC1(CCC(O1)=O)CC=O)=O,,,5,1,1,0,1
57400_0,,,,2,2,1,3
C(CCC1[CH]C(OC1C(C=O)=O)=O)=O,,,5,1,1,0,1
57402_0,,,,2,2,1,3
C(CC[C]1C(OC(C(C=O)=O)C1)=O)=O,,,5,1,1,0,1
57404_0,,,,2,2,1,3
C(CCC1(C(C=O)=O)C[CH]C(O1)=O)=O,,,5,1,1,0,1
57406_0,,,,2,2,1,3
C(CCC1C(C(C=O)=O)OC(C1)=O)=O,,,5,1,1,0,1
57408_0,,,,2,2,1,3
C(CCC1C(OC(C(C=O)=O)C1)=O)=O,,,5,1,1,0,1
57410_0,,,,2,2,1,3
C(CCC1(C(C=O)=O)CCC(O1)=O)=O,,,5,1,1,0,1
57412_0,,,,2,2,1,3
C(CCC1[CH]C(OC1C(O)=O)=O)=O,,,5,1,1,0,1
57414_0,,,,2,2,1,3
C(CC[C]1C(OC(C(O)=O)C1)=O)=O,,,5,1,1,0,1
57416_0,,,,2,2,1,3
C(C1(CCC=O)C[CH]C(O1)=O)(O)=O,,,5,1,1,0,1
57418_0,,,,2,2,1,3
C(CCC1C(C(O)=O)OC(C1)=O)=O,,,5,1,1,0,1
57420_0,,,,2,2,1,3
C(CCC1C(OC(C(O)=O)C1)=O)=O,,,5,1,2,0,2
57422_0,,,,2,2,1,3
C(C1(CCC=O)CCC(O1)=O)(O)=O,,,5,1,1,0,1
57424_0,,,,2,2,1,3
C(CCC1(CO)C[CH]C(O1)=O)=O,,,5,1,1,0,1
57426_0,,,,2,2,1,3
C(CCC(C1C[CH]C(O1)=O)O)=O,,,5,1,1,0,1
57428_0,,,,2,2,1,3
C(CCC1[CH]C(OC1CO)=O)=O,,,5,1,1,0,1
57430_0,,,,2,2,1,3
C(CC[C]1C(OC(CO)C1)=O)=O,,,5,1,1,0,1
57432_0,,,,2,2,1,3
C(C1(CCCC=O)C[CH]C(O1)=O)(O)=O,,,5,1,1,0,1
57434_0,,,,2,2,1,3
C(CCC1[CH]C(OC1(C(O)=O)C)=O)=O,,,5,1,1,0,1
57436_0,,,,2,2,1,3
C(C1(C)C[C](C(O1)=O)CCC=O)(O)=O,,,5,1,1,0,1
57438_0,,,,2,2,1,3
C1(CCC(CCC=O)(CO)O1)=O,,,5,1,1,0,1
57440_0,,,,2,2,1,3
C1(CCC(C(CCC=O)O)O1)=O,,,5,1,1,0,1
57442_0,,,,2,2,1,3
C1(CC(CCC=O)C(CO)O1)=O,,,5,1,1,0,1
57444_0,,,,2,2,1,3
C1(C(CCC=O)CC(CO)O1)=O,,,5,1,1,0,1
57446_0,,,,2,2,1,3
C(CCC1[C](C(OC1C)=O)O)=O,,,5,1,1,0,1
57448_0,,,,2,2,1,3
C(CCCC1C[C](C(O1)=O)O)=O,,,5,1,1,0,1
57450_0,,,,2,2,1,3
C(CCC1(C)C[C](C(O1)=O)O)=O,,,5,1,1,0,1
57452_0,,,,2,2,1,3
C1(C([C](C(O1)=O)O)CCC=O)=O,,,5,1,1,0,1
57454_0,,,,2,2,1,3
C(CCC1C(C)OC(C1O)=O)=O,,,5,1,1,0,1
57456_0,,,,2,2,1,3
C1(C(CCC=O)(CC(C)O1)O)=O,,,5,1,1,0,1
57458_0,,,,2,2,1,3
C(CCCC1CC(C(O1)=O)O)=O,,,5,1,1,0,1
57460_0,,,,2,2,1,3
C(CCC1(C)CC(C(O1)=O)O)=O,,,5,1,1,0,1
57462_0,,,,2,2,1,3
C1(C(CCC=O)C(C(O1)=O)O)=O,,,5,1,1,0,1
57464_0,,,,2,2,1,3
C1(C(CCC=O)(CC(O1)=O)O)=O,,,5,1,1,0,1
57466_0,,,,2,2,1,3
C(CCC1[CH]C(OC(C)C1C=O)=O)=O,,,5,1,1,0,1
57468_0,,,,2,2,1,3
C(C1C(C)OC([C](C1)CCC=O)=O)=O,,,5,1,1,0,1
57470_0,,,,2,2,1,3
C(C1(CCC=O)C(C)OC([CH]C1)=O)=O,,,5,1,1,0,1
57472_0,,,,2,2,1,3
C(CCCC1C(C=O)C[CH]C(O1)=O)=O,,,5,1,1,0,1
57474_0,,,,2,2,1,3
C(CCC1(C)C(C=O)C[CH]C(O1)=O)=O,,,5,1,1,0,1
57476_0,,,,2,2,1,3
C(C1C(CCC=O)CC(OC1C)=O)=O,,,5,1,1,0,1
57478_0,,,,2,2,1,3
C(C1CC(C(OC1C)=O)CCC=O)=O,,,5,1,1,0,1
57480_0,,,,2,2,1,3
C(C1(CCC=O)CCC(OC1C)=O)=O,,,5,1,1,0,1
57482_0,,,,2,2,1,3
C(C1CCC(OC1CCCC=O)=O)=O,,,5,1,1,0,1
57484_0,,,,2,2,1,3
C(C1CCC(OC1(C)CCC=O)=O)=O,,,5,1,1,0,1
57486_0,,,,2,2,1,3
C(CC1CC([CH]C(O1)=O)CCC=O)=O,,,5,1,1,0,1
57488_0,,,,2,2,1,3
C(CC1CC[C](C(O1)=O)CCC=O)=O,,,5,1,1,0,1
57490_0,,,,2,2,1,3
C(C(CCC=O)C1CC[CH]C(O1)=O)=O,,,5,1,1,0,1
57492_0,,,,2,2,1,3
C(CCC1C(CC=O)OC([CH]C1)=O)=O,,,5,1,1,0,1
57494_0,,,,2,2,1,3
C(CCC1(CC[CH]C(O1)=O)CC=O)=O,,,5,1,1,0,1
57496_0,,,,2,2,1,3
C(CCC1CC(CC=O)OC(C1)=O)=O,,,5,1,1,0,1
57498_0,,,,2,2,1,3
C(CC1CCC(C(O1)=O)CCC=O)=O,,,5,1,1,0,1
57500_0,,,,2,2,1,3
C(C(CCC=O)C1CCCC(O1)=O)=O,,,5,1,1,0,1
57502_0,,,,2,2,1,3
C(CCC1CCC(OC1CC=O)=O)=O,,,5,1,1,0,1
57504_0,,,,2,2,1,3
C(CCC1(CCCC(O1)=O)CC=O)=O,,,5,1,1,0,1
57506_0,,,,2,2,1,3
C(CCC1[CH]C(OC(C1C=O)=O)=O)=O,,,5,1,1,0,1
57508_0,,,,2,2,1,3
C(C1C(OC([C](C1)CCC=O)=O)=O)=O,,,5,1,1,0,1
57510_0,,,,2,2,1,3
C(CCC1(C=O)C(OC([CH]C1)=O)=O)=O,,,5,1,1,0,1
57512_0,,,,2,2,1,3
C(C1C(OC(CC1CCC=O)=O)=O)=O,,,5,1,1,0,1
57514_0,,,,2,2,1,3
C(C1C(OC(C(C1)CCC=O)=O)=O)=O,,,5,1,1,0,1
57516_0,,,,2,2,1,3
C(C1(C(OC(CC1)=O)=O)CCC=O)=O,,,5,1,1,0,1
57518_0,,,,2,2,1,3
C(CCC1[CH]C(OC(C1O)=O)=O)=O,,,5,1,1,0,1
57520_0,,,,2,2,1,3
C1(C(C[C](C(O1)=O)CCC=O)O)=O,,,5,1,1,0,1
57522_0,,,,2,2,1,3
C1(C(CCC=O)(C[CH]C(O1)=O)O)=O,,,5,1,1,0,1
57524_0,,,,2,2,1,3
C1(CC(CCC=O)C(C(O1)=O)O)=O,,,5,1,1,0,1
57526_0,,,,2,2,1,3
C1(C(CCC=O)CC(C(O1)=O)O)=O,,,5,1,2,0,2
57528_0,,,,2,2,1,3
C1(C(CCC(O1)=O)(CCC=O)O)=O,,,5,1,1,0,1
57530_0,,,,2,2,1,3
C(CCC1(COC([CH]C1)=O)O)=O,,,5,1,1,0,1
57532_0,,,,2,2,1,3
C(CCC1C(C[CH]C(O1)=O)O)=O,,,5,1,1,0,1
57534_0,,,,2,2,1,3
C(CCC1[CH]C(OCC1O)=O)=O,,,5,1,1,0,1
57536_0,,,,2,2,1,3
C(CC[C]1C(OCC(C1)O)=O)=O,,,5,1,1,0,1
57538_0,,,,2,2,1,3
C(CCC1[C](C(O)=O)OC([CH]C1)=O)=O,,,5,1,1,0,1
57540_0,,,,2,2,1,3
C(CCC1[CH]C(O[C](C(O)=O)C1)=O)=O,,,5,1,1,0,1
57542_0,,,,2,2,1,3
C(CC[C]1C(O[C](C(O)=O)CC1)=O)=O,,,5,1,1,0,1
57544_0,,,,2,2,1,3
C(CCC1C(C(O)=O)OC([CH]C1)=O)=O,,,5,1,1,0,1
57546_0,,,,2,2,1,3
C(C1(CC[CH]C(O1)=O)CCC=O)(O)=O,,,5,1,1,0,1
57548_0,,,,2,2,1,3
C(CCC1[CH]C(OC(C(O)=O)C1)=O)=O,,,5,1,1,0,1
57550_0,,,,2,2,1,3
C(C1CC[C](C(O1)=O)CCC=O)(O)=O,,,5,1,1,0,1
57552_0,,,,2,2,1,3
C1(C(CCCC=O)(C[CH]C(O1)=O)O)=O,,,5,1,1,0,1
57554_0,,,,2,2,1,3
C(CCC1[CH]C(OC(C1(C)O)=O)=O)=O,,,5,1,1,0,1
57556_0,,,,2,2,1,3
C1(C(C)(C[C](C(O1)=O)CCC=O)O)=O,,,5,1,1,0,1
57558_0,,,,2,2,1,3
C1(CCC(CO1)(CCC=O)O)=O,,,5,1,1,0,1
57560_0,,,,2,2,1,3
C1(CCC(C(CCC=O)O1)O)=O,,,5,1,1,0,1
57562_0,,,,2,2,1,3
C1(CC(CCC=O)C(CO1)O)=O,,,5,1,1,0,1
57564_0,,,,2,2,1,3
C1(C(CCC=O)CC(CO1)O)=O,,,5,1,1,0,1
57566_0,,,,2,2,1,3
C1(CCC([C](C(O)=O)O1)CCC=O)=O,,,5,1,1,0,1
57568_0,,,,2,2,1,3
C1(CC(CCC=O)C[C](C(O)=O)O1)=O,,,5,1,1,0,1
57570_0,,,,2,2,1,3
C1(C(CC[C](C(O)=O)O1)CCC=O)=O,,,5,1,1,0,1
57572_0,,,,2,2,1,3
C(CCC1[C](C(OC([CH]C1)=O)=O)O)=O,,,5,1,1,0,1
57574_0,,,,2,2,1,3
C(CCC1[CH]C(OC([C](C1)O)=O)=O)=O,,,5,1,1,0,1
57576_0,,,,2,2,1,3
C(CC[C]1C(OC([C](CC1)O)=O)=O)=O,,,5,1,1,0,1
57578_0,,,,2,2,1,3
C(CCC1C(C(OC([CH]C1)=O)=O)O)=O,,,5,1,1,0,1
57580_0,,,,2,2,1,3
C1(C(CC[CH]C(O1)=O)(CCC=O)O)=O,,,5,1,1,0,1
57582_0,,,,2,2,1,3
C(CCC1[CH]C(OC(C(C1)O)=O)=O)=O,,,5,1,1,0,1
57584_0,,,,2,2,1,3
C1(C(CC[C](C(O1)=O)CCC=O)O)=O,,,5,1,1,0,1
57586_0,,,,2,2,1,3
C(CCC1C(C(OC([CH]C1)=O)=O)=O)=O,,,5,1,1,0,1
57588_0,,,,2,2,1,3
C(CCC1[CH]C(OC(C(C1)=O)=O)=O)=O,,,5,1,1,0,1
57590_0,,,,2,2,1,3
C(CC[C]1C(OC(C(CC1)=O)=O)=O)=O,,,5,1,1,0,1
57592_0,,,,2,2,1,3
C1(CCC([C](C(O1)=O)O)CCC=O)=O,,,5,1,1,0,1
57594_0,,,,2,2,1,3
C1(CC(CCC=O)C[C](C(O1)=O)O)=O,,,5,1,1,0,1
57596_0,,,,2,2,1,3
C1(C(CC[C](C(O1)=O)O)CCC=O)=O,,,5,1,1,0,1
57598_0,,,,2,2,1,3
C(CCC1C(C(OC(CC1)=O)=O)=O)=O,,,5,1,1,0,1
57600_0,,,,2,2,1,3
C(CCC1CC(OC(C(C1)=O)=O)=O)=O,,,5,1,1,0,1
57602_0,,,,2,2,1,3
C(CCC1C(OC(C(CC1)=O)=O)=O)=O,,,5,1,1,0,1
57604_0,,,,2,2,1,3
C(C(CCC=O)C(C)CO)=O,,,5,1,1,0,1
57606_0,,,,2,2,1,3
C(CCCC(CO)CC=O)=O,,,5,1,1,0,1
57608_0,,,,2,2,1,3
C(CCC(C)(CO)CC=O)=O,,,5,1,1,0,1
57610_0,,,,2,2,1,3
C(CCC(C(C)CC=O)O)=O,,,5,1,2,0,2
57612_0,,,,2,2,1,3
C(CCC([CH]C(O)=O)CO)=O,,,5,1,1,0,1
57614_0,,,,2,2,1,3
C(CC[C](C(O)=O)CCO)=O,,,5,1,1,0,1
57615_0,,,,2,2,1,3
57617_0,,,,2,2,1,3
C(CC(CCC=O)CO)(O)=O,,,5,1,1,0,1
57618_0,,,,2,2,1,3
57619_0,,,,2,2,1,3
57621_0,,,,2,2,1,3
C(C(CCC=O)C(C)CCO)=O,,,5,1,1,0,1
57623_0,,,,2,2,1,3
C(CC(CCO)CCCC=O)=O,,,5,1,1,0,1
57625_0,,,,2,2,1,3
C(CCC(C)(CCO)CC=O)=O,,,5,1,1,0,1
57627_0,,,,2,2,1,3
C(CCC(CO)C(C)CC=O)=O,,,5,1,1,0,1
57629_0,,,,2,2,1,3
C(CC(C)CC(CCC=O)O)=O,,,5,1,1,0,1
57631_0,,,,2,2,1,3
C(C(CCC=O)C(C)C(C)O)=O,,,5,1,1,0,1
57633_0,,,,2,2,1,3
C(CC(CCCC=O)C(C)O)=O,,,5,1,1,0,1
57635_0,,,,2,2,1,3
C(CCC(C)(C(C)O)CC=O)=O,,,5,1,1,0,1
57637_0,,,,2,2,1,3
C(CC(C)C(CCCC=O)O)=O,,,5,1,1,0,1
57639_0,,,,2,2,1,3
C(CCC(C)(C(C)CC=O)O)=O,,,5,1,1,0,1
57641_0,,,,2,2,1,3
C(CCC([CH]C(O)=O)C(C)O)=O,,,5,1,1,0,1
57643_0,,,,2,2,1,3
C(CC[C](C(O)=O)CC(C)O)=O,,,5,1,1,0,1
57645_0,,,,2,2,1,3
C(CCCC(C[CH]C(O)=O)O)=O,,,5,1,1,0,1
57647_0,,,,2,2,1,3
C(CCC(C)(C[CH]C(O)=O)O)=O,,,5,1,1,0,1
57649_0,,,,2,2,1,3
C(CC(CCC=O)C(C)O)(O)=O,,,5,1,1,0,1
57651_0,,,,2,2,1,3
C(C(CCC=O)CC(C)O)(O)=O,,,5,1,1,0,1
57653_0,,,,2,2,1,3
C(CCC(CCCC=O)O)(O)=O,,,5,1,1,0,1
57655_0,,,,2,2,1,3
C(CCC(C)(CCC=O)O)(O)=O,,,5,1,1,0,1
57657_0,,,,2,2,1,3
C(C(CCC=O)C(C)CC(O)=O)=O,,,5,1,1,0,1
57659_0,,,,2,2,1,3
C(CCCC(CC=O)CC(O)=O)=O,,,5,1,1,0,1
57661_0,,,,2,2,1,3
C(CC(C)(CCC=O)CC(O)=O)=O,,,5,1,1,0,1
57662_0,,,,2,2,1,3
57664_0,,,,2,2,1,3
C(C(CCC=O)C(C)CC=CC=O)=O,,,5,1,1,0,1
57666_0,,,,2,2,1,3
C(CC(CCCC=O)CC=CC=O)=O,,,5,1,1,0,1
57668_0,,,,2,2,1,3
C(CCC(C)(CC=O)CC=CC=O)=O,,,5,1,1,0,1
57670_0,,,,2,2,1,3
C(CC(C)C(C=CC=O)CCC=O)=O,,,5,1,1,0,1
57672_0,,,,2,2,1,3
C(C(C=C)(CCC=O)C(C)CC=O)=O,,,5,1,1,0,1
57674_0,,,,2,2,1,3
C(C(CCC=O)C(C)C(C=O)C=C)=O,,,5,1,1,0,1
57676_0,,,,2,2,1,3
C(C(C=C)C(CCCC=O)CC=O)=O,,,5,1,1,0,1
57678_0,,,,2,2,1,3
C(C(C=C)C(C)(CCC=O)CC=O)=O,,,5,1,1,0,1
57680_0,,,,2,2,1,3
C(C(CCC=O)(C(C)CC=O)O)=O,,,5,1,1,0,1
57682_0,,,,2,2,1,3
C(CCC(C=O)C(C)C(C=O)O)=O,,,5,1,1,0,1
57684_0,,,,2,2,1,3
C(CCCC(C(C=O)O)CC=O)=O,,,5,1,1,0,1
57686_0,,,,2,2,1,3
C(CC(CCC=O)(C)C(C=O)O)=O,,,5,1,1,0,1
57688_0,,,,2,2,1,3
C(C(CCC=O)C(C)CC=O)=O,,,5,1,1,0,1
57690_0,,,,2,2,1,3
C(CC(CCCC=O)CC=O)=O,,,5,1,1,0,1
57692_0,,,,2,2,1,3
C(CC(C)(CCC=O)CC=O)=O,,,5,1,1,0,1
57694_0,,,,2,2,1,3
C(CC(C)C(C(C=O)=O)CCC=O)=O,,,5,1,1,0,1
57696_0,,,,2,2,1,3
C(C(CCC=O)C(C)CC(C=O)=O)=O,,,5,1,1,0,1
57698_0,,,,2,2,1,3
C(CC(CCCC=O)CC(C=O)=O)=O,,,5,1,1,0,1
57700_0,,,,2,2,1,3
C(CCC(C)(CC=O)CC(C=O)=O)=O,,,5,1,1,0,1
57702_0,,,,2,2,1,3
C(CCC(CO)(C(C)CC=O)O)=O,,,5,1,1,0,1
57704_0,,,,2,2,1,3
C(CCC(C(C(C)CC=O)O)O)=O,,,5,1,1,0,1
57706_0,,,,2,2,1,3
C(C(CCC=O)C(C)C(CO)O)=O,,,5,1,1,0,1
57708_0,,,,2,2,1,3
C(CC(CCCC=O)C(CO)O)=O,,,5,1,1,0,1
57710_0,,,,2,2,1,3
C(CCC(C)(C(CO)O)CC=O)=O,,,5,1,1,0,1
57711_0,,,,2,2,1,3
57713_0,,,,2,2,1,3
C(CCC([C](C(O)=O)O)(CO)O)=O,,,5,1,1,0,1
57715_0,,,,2,2,1,3
C(CCC(C([C](C(O)=O)O)O)O)=O,,,5,1,1,0,1
57717_0,,,,2,2,1,3
C(CCC([C](C(O)=O)O)CO)=O,,,5,1,1,0,1
57719_0,,,,2,2,1,3
C(CCC(C[C](C(O)=O)O)O)=O,,,5,1,1,0,1
57721_0,,,,2,2,1,3
C(CCC(C([C](C(O)=O)O)=O)O)=O,,,5,1,1,0,1
57723_0,,,,2,2,1,3
C(CCCC([C](C(O)=O)O)=O)=O,,,5,1,1,0,1
57725_0,,,,2,2,1,3
C(CCC(CC(C=O)O)O)=O,,,5,1,1,0,1
57727_0,,,,2,2,1,3
C(CCC(CO)C(C=O)O)=O,,,5,1,1,0,1
57729_0,,,,2,2,1,3
C(C(CCC=O)(CCO)O)=O,,,5,1,1,0,1
57731_0,,,,2,2,1,3
C(CCC(C=O)(O)O)=O,,,5,1,1,0,1
57733_0,,,,2,2,1,3
C(CCCC(C(C(O)=O)=O)O)=O,,,5,1,1,0,1
57735_0,,,,2,2,1,3
C(CCC(C(C(O)=O)=O)(C)O)=O,,,5,1,1,0,1
57737_0,,,,2,2,1,3
C(CCC(C(C(O)=O)O)O)=O,,,5,1,1,0,1
57739_0,,,,2,2,1,3
C(C(CO)(CCC=O)O)(O)=O,,,5,1,1,0,1
57741_0,,,,2,2,1,3
C(CCCC=O)=O,,,5,1,1,0,1
57743_0,,,,2,2,1,3
C(CCC[C](C(O)=O)O)=O,,,5,1,1,0,1
57745_0,,,,2,2,1,3
C(CCCC(C(O)=O)O)=O,,,5,1,1,0,1
57747_0,,,,2,2,1,3
C(C(C)(CCC=O)O)(O)=O,,,5,1,1,0,1
57748_0,,,,2,2,1,3
57750_0,,,,2,2,1,3
C(CCCC(CC=O)O)=O,,,5,1,1,0,1
57752_0,,,,2,2,1,3
C(CCC(C)(CC=O)O)=O,,,5,1,1,0,1
57753_0,,,,2,2,1,3
57755_0,,,,2,2,1,3
C(CCCC(CC(C(O)=O)=O)O)=O,,,5,1,1,0,1
57757_0,,,,2,2,1,3
C(CCC(C)(CC(C(O)=O)=O)O)=O,,,5,1,1,0,1
57758_0,,,,2,2,1,3
57760_0,,,,2,2,1,3
C(C(CCCC=O)(CC=O)O)(O)=O,,,5,1,1,0,1
57761_0,,,,2,2,1,3
57762_0,,,,2,2,1,3
57764_0,,,,2,2,1,3
C(CCC(C(C=O)=O)O)=O,,,5,1,1,0,1
57765_0,,,,2,2,1,3
57767_0,,,,2,2,1,3
C(C(C(C)O)(CCCC=O)O)(O)=O,,,5,1,1,0,1
57769_0,,,,2,2,1,3
C(C(C)(C(CCCC=O)O)O)(O)=O,,,5,1,1,0,1
57771_0,,,,2,2,1,3
C(C(C)(C(C)(CCC=O)O)O)(O)=O,,,5,1,1,0,1
57773_0,,,,2,2,1,3
C(C(C(O)=O)(CCCC=O)O)(O)=O,,,5,1,1,0,1
57774_0,,,,2,2,1,3
57776_0,,,,2,2,1,3
C(CCC(CO)O)=O,,,5,1,1,0,1
57778_0,,,,2,2,1,3
C(CCC(C(C(O)=O)=O)O)=O,,,5,1,1,0,1
57780_0,,,,2,2,1,3
C(C(CCC=O)C(CC(C)O)O)=O,,,5,1,1,0,1
57782_0,,,,2,2,1,3
C(CCC(C(CC=O)O)C(C)O)=O,,,5,1,1,0,1
57784_0,,,,2,2,1,3
C(CC(CCC=O)(CC(C)O)O)=O,,,5,1,1,0,1
57786_0,,,,2,2,1,3
C(CC(CC(CCCC=O)O)O)=O,,,5,1,1,0,1
57788_0,,,,2,2,1,3
C(CCC(C)(CC(CC=O)O)O)=O,,,5,1,1,0,1
57790_0,,,,2,2,1,3
C(C(C(C)O)C(CCC=O)O)=O,,,5,1,1,0,1
57792_0,,,,2,2,1,3
C(C(CCC=O)(CO)C(C)O)=O,,,5,1,1,0,1
57794_0,,,,2,2,1,3
C(C(CO)C(CCCC=O)O)=O,,,5,1,1,0,1
57796_0,,,,2,2,1,3
C(C(CO)C(C)(CCC=O)O)=O,,,5,1,1,0,1
57798_0,,,,2,2,1,3
C(C(C(C)O)C(CCCC=O)O)=O,,,5,1,1,0,1
57800_0,,,,2,2,1,3
C(C(C(C)O)C(C)(CCC=O)O)=O,,,5,1,1,0,1
57802_0,,,,2,2,1,3
C(C(CCC=O)(C(C)O)C(C)O)=O,,,5,1,1,0,1
57804_0,,,,2,2,1,3
C(C(C=O)(CCC=O)C(C)O)(O)=O,,,5,1,1,0,1
57806_0,,,,2,2,1,3
C(C(C=O)C(CCCC=O)O)(O)=O,,,5,1,1,0,1
57808_0,,,,2,2,1,3
C(C(C=O)C(C)(CCC=O)O)(O)=O,,,5,1,1,0,1
57810_0,,,,2,2,1,3
C(C(CCC=O)C(CC(O)=O)O)=O,,,5,1,1,0,1
57812_0,,,,2,2,1,3
C(C(CCC=O)C(CC=O)O)(O)=O,,,5,1,1,0,1
57814_0,,,,2,2,1,3
C(CC(CCC=O)(CC=O)O)(O)=O,,,5,1,1,0,1
57816_0,,,,2,2,1,3
C(C(C=O)C(CCC=O)O)(O)=O,,,5,1,1,0,1
57818_0,,,,2,2,1,3
C(C(C=O)(CCC=O)CO)(O)=O,,,5,1,1,0,1
57820_0,,,,2,2,1,3
C(CCC(C=O)C(C(CO)=O)O)=O,,,5,1,1,0,1
57822_0,,,,2,2,1,3
C(CCC(C(C(CC=O)O)=O)O)=O,,,5,1,1,0,1
57824_0,,,,2,2,1,3
C(CO)(C(CCC=O)(CC=O)O)=O,,,5,1,1,0,1
57826_0,,,,2,2,1,3
C(CCC(C=O)C(C=O)(CO)O)=O,,,5,1,1,0,1
57828_0,,,,2,2,1,3
C(CCC(C(C=O)(CC=O)O)O)=O,,,5,1,1,0,1
57830_0,,,,2,2,1,3
C(CCC(C(C(C=O)=O)O)O)=O,,,5,1,1,0,1
57832_0,,,,2,2,1,3
C(CCC(C(C=O)=O)(CO)O)=O,,,5,1,1,0,1
57834_0,,,,2,2,1,3
C(CCCC(C(C(C=O)=O)O)O)=O,,,5,1,1,0,1
57836_0,,,,2,2,1,3
C(CCC(C)(C(C(C=O)=O)O)O)=O,,,5,1,1,0,1
57838_0,,,,2,2,1,3
C(CCC(C(C=O)=O)(C(C)O)O)=O,,,5,1,1,0,1
57840_0,,,,2,2,1,3
C(C(C(C=O)=O)(CCC=O)O)(O)=O,,,5,1,1,0,1
57842_0,,,,2,2,1,3
C(CCC(C=O)C(C=O)(C)O)=O,,,5,1,1,0,1
57844_0,,,,2,2,1,3
C(CCCC(C=O)(CC=O)O)=O,,,5,1,1,0,1
57846_0,,,,2,2,1,3
C(CCC(C=O)C(C(C)=O)O)=O,,,5,1,1,0,1
57848_0,,,,2,2,1,3
C(CC(C(CCCC=O)=O)O)=O,,,5,1,1,0,1
57850_0,,,,2,2,1,3
C(C)(C(CCC=O)(CC=O)O)=O,,,5,1,1,0,1
57852_0,,,,2,2,1,3
C(CCC(CC(C=O)=O)O)=O,,,5,1,1,0,1
57854_0,,,,2,2,1,3
C(CCC(C(C=O)=O)CO)=O,,,5,1,1,0,1
57856_0,,,,2,2,1,3
C(CCCC(CC(C=O)=O)O)=O,,,5,1,1,0,1
57858_0,,,,2,2,1,3
C(CCC(C)(CC(C=O)=O)O)=O,,,5,1,1,0,1
57860_0,,,,2,2,1,3
C(CCC(C(C=O)=O)C(C)O)=O,,,5,1,1,0,1
57862_0,,,,2,2,1,3
C(CCC(C(O)=O)C(C=O)=O)=O,,,5,1,1,0,1
57864_0,,,,2,2,1,3
C(CCC(C(C(O)=O)=O)(CO)O)=O,,,5,1,1,0,1
57866_0,,,,2,2,1,3
C(CCC(C(C(C(O)=O)=O)O)O)=O,,,5,1,1,0,1
57868_0,,,,2,2,1,3
C(C(CCC=O)CO)=O,,,5,1,1,0,1
57870_0,,,,2,2,1,3
C(CCC(CC=O)O)=O,,,5,1,1,0,1
57872_0,,,,2,2,1,3
C(CCC(C(C(O)=O)=O)CO)=O,,,5,1,1,0,1
57874_0,,,,2,2,1,3
C(CCC(CC(C(O)=O)=O)O)=O,,,5,1,1,0,1
57876_0,,,,2,2,1,3
C(CC(C(CCCC=O)=O)=O)=O,,,5,1,1,0,1
57878_0,,,,2,2,1,3
C(CCC(C=O)C(C(C)=O)=O)=O,,,5,1,1,0,1
57880_0,,,,2,2,1,3
C(CCCC(C(C(CO)=O)=O)O)=O,,,5,1,1,0,1
57882_0,,,,2,2,1,3
C(CCC(C(C(CO)=O)=O)(C)O)=O,,,5,1,1,0,1
57884_0,,,,2,2,1,3
C(CCC(C(C(C(C)O)=O)=O)O)=O,,,5,1,1,0,1
57886_0,,,,2,2,1,3
C(CCC(C(C(C(O)=O)=O)=O)O)=O,,,5,1,1,0,1
57888_0,,,,2,2,1,3
C(CCCC(C(C(C)O)=O)=O)=O,,,5,1,1,0,1
57890_0,,,,2,2,1,3
C(CCCC(C(C(C)=O)=O)O)=O,,,5,1,1,0,1
57892_0,,,,2,2,1,3
C(CCC(C(C(C)=O)=O)(C)O)=O,,,5,1,1,0,1
57894_0,,,,2,2,1,3
C(CCCC(C(C(O)=O)=O)=O)=O,,,5,1,1,0,1
57896_0,,,,2,2,1,3
C(C(C=O)(CCC=O)O)=O,,,5,1,1,0,1
57898_0,,,,2,2,1,3
C(C(C=O)(CCC=O)O)(O)=O,,,5,1,1,0,1
57900_0,,,,2,2,1,3
C(CCC(CO)C(C)O)=O,,,5,1,1,0,1
57902_0,,,,2,2,1,3
C(CCC(CC(C)O)O)=O,,,5,1,1,0,1
57904_0,,,,2,2,1,3
C(CCCC(CCO)O)=O,,,5,1,1,0,1
57906_0,,,,2,2,1,3
C(CCC(C)(CCO)O)=O,,,5,1,1,0,1
57908_0,,,,2,2,1,3
C(C(CCC=O)CO)(O)=O,,,5,1,2,0,2
57910_0,,,,2,2,1,3
C(CC(CCC=O)O)(O)=O,,,5,1,1,0,1
57912_0,,,,2,2,1,3
C(C(CCO)(CCCC=O)O)(O)=O,,,5,1,1,0,1
57914_0,,,,2,2,1,3
C(C(C)(C(CO)CCC=O)O)(O)=O,,,5,1,1,0,1
57916_0,,,,2,2,1,3
C(C(C)(CC(CCC=O)O)O)(O)=O,,,5,1,1,0,1
57918_0,,,,2,2,1,3
C(CCC(C(CO)=O)O)=O,,,5,1,1,0,1
57920_0,,,,2,2,1,3
C(CCCC(CO)=O)=O,,,5,1,1,0,1
57922_0,,,,2,2,1,3
C(CCC(C(C)=O)O)=O,,,5,1,1,0,1
57923_0,,,,2,2,1,3
57925_0,,,,2,2,1,3
C(CCCCO)=O,,,5,1,1,0,1
57926_0,,,,2,2,1,3
57927_0,,,,2,2,1,3
57929_0,,,,2,2,1,3
C(CC(CCCC=O)O)(O)=O,,,5,1,1,0,1
57931_0,,,,2,2,1,3
C(CC(C)(CCC=O)O)(O)=O,,,5,1,1,0,1
57932_0,,,,2,2,1,3
57933_0,,,,2,2,1,3
57935_0,,,,2,2,1,3
C(C(CO)(C(CCC=O)O)O)(O)=O,,,5,1,1,0,1
57937_0,,,,2,2,1,3
C(C(CO)(CCCC=O)O)(O)=O,,,5,1,1,0,1
57938_0,,,,2,2,1,3
57940_0,,,,2,2,1,3
C(CCCC(C(C(O)=O)O)O)=O,,,5,1,1,0,1
57942_0,,,,2,2,1,3
C(CCC(C)(C(C(O)=O)O)O)=O,,,5,1,1,0,1
57944_0,,,,2,2,1,3
C(C(CCC=O)(C(C)O)O)(O)=O,,,5,1,1,0,1
57946_0,,,,2,2,1,3
C(C(C(O)=O)(CCC=O)O)(O)=O,,,5,1,1,0,1
57948_0,,,,2,2,1,3
C(C(C=O)(CCCC=O)O)(O)=O,,,5,1,1,0,1
57950_0,,,,2,2,1,3
C(C(C(CCCC=O)=O)CO)(O)=O,,,5,1,1,0,1
57952_0,,,,2,2,1,3
C(CCC(C(C(O)=O)C(C)=O)O)=O,,,5,1,1,0,1
57954_0,,,,2,2,1,3
C(CCC(C(O)=O)(C(C)=O)CO)=O,,,5,1,1,0,1
57956_0,,,,2,2,1,3
C(CCCC(C(C)=O)C(O)=O)=O,,,5,1,1,0,1
57958_0,,,,2,2,1,3
C(CCC(C(C)=O)(C(O)=O)C)=O,,,5,1,1,0,1
57960_0,,,,2,2,1,3
C(CCCC(C(C(O)=O)C)=O)=O,,,5,1,1,0,1
57962_0,,,,2,2,1,3
C(CCCC=CC=O)=O,,,5,1,1,0,1
57964_0,,,,2,2,1,3
C(C(C=C)CCC=O)=O,,,5,1,1,0,1
57966_0,,,,2,2,1,3
C(CCCC=CC(C(O)=O)=O)=O,,,5,1,1,0,1
57968_0,,,,2,2,1,3
C(CCC(C=C)C(C(O)=O)=O)=O,,,5,1,1,0,1
57970_0,,,,2,2,1,3
C(C(C(C(O)=O)=C)CCC=O)=O,,,5,1,1,0,1
57972_0,,,,2,2,1,3
C(CCCC(C(O)=O)=CC=O)=O,,,5,1,1,0,1
57974_0,,,,2,2,1,3
C(C(C=C)(C(CCC=O)O)O)(O)=O,,,5,1,1,0,1
57976_0,,,,2,2,1,3
C(CCCC(C(C(O)=O)=C)O)=O,,,5,1,1,0,1
57978_0,,,,2,2,1,3
C(CCC(C(C(O)=O)=C)(C)O)=O,,,5,1,1,0,1
57980_0,,,,2,2,1,3
C(C(C=C)(CCCC=O)O)(O)=O,,,5,1,1,0,1
57982_0,,,,2,2,1,3
C(CCCC1C(OC(C(C=1)=O)=O)=O)=O,,,5,1,1,0,1
57984_0,,,,2,2,1,3
C(CCC1C(C(OC(C1=C)=O)=O)=O)=O,,,5,1,1,0,1
57986_0,,,,2,2,1,3
C(CCC(CO)(C(C)O)O)=O,,,5,1,1,0,1
57988_0,,,,2,2,1,3
C(CCC(C(C(C)O)O)O)=O,,,5,1,1,0,1
57990_0,,,,2,2,1,3
C(CCCC(C(CO)O)O)=O,,,5,1,1,0,1
57992_0,,,,2,2,1,3
C(CCC(C)(C(CO)O)O)=O,,,5,1,1,0,1
57994_0,,,,2,2,1,3
C(CCC(C(C=O)O)O)=O,,,5,1,1,0,1
57996_0,,,,2,2,1,3
C(C(CO)(CCC=O)O)=O,,,5,1,1,0,1
57998_0,,,,2,2,1,3
C(CCC([CH]C(O)=O)O)=O,,,5,1,1,0,1
58000_0,,,,2,2,1,3
C(CC[C](C(O)=O)CO)=O,,,5,1,1,0,1
58002_0,,,,2,2,1,3
C1(C(CC(O)O1)(CCCC=O)O)=O,,,5,1,1,0,1
58004_0,,,,2,2,1,3
C1(C(C)(C(C(O)O1)CCC=O)O)=O,,,5,1,1,0,1
58006_0,,,,2,2,1,3
C1(C(C)(CC(CCC=O)(O)O1)O)=O,,,5,1,1,0,1
58008_0,,,,2,2,1,3
C(CCC(C=O)O)=O,,,5,1,1,0,1
58010_0,,,,2,2,1,3
C(CCC1C(C(OC1C)=O)=O)=O,,,5,1,1,0,1
58012_0,,,,2,2,1,3
C(CCCC1CC(C(O1)=O)=O)=O,,,5,1,1,0,1
58014_0,,,,2,2,1,3
C(CCC1(C)CC(C(O1)=O)=O)=O,,,5,1,1,0,1
58016_0,,,,2,2,1,3
C(CCC1C(OC(C1=O)=O)=O)=O,,,5,1,1,0,1
58018_0,,,,2,2,1,3
C(CCC([CH]C(O)=O)CC(C=O)=O)=O,,,5,1,1,0,1
58019_0,,,,2,2,1,3
58021_0,,,,2,2,1,3
C(CCC(C(C=O)=O)C[CH]C(O)=O)=O,,,5,1,1,0,1
58023_0,,,,2,2,1,3
C(CCC(CO)(C[CH]C(O)=O)O)=O,,,5,1,1,0,1
58025_0,,,,2,2,1,3
C(CCC(C(C[CH]C(O)=O)O)O)=O,,,5,1,1,0,1
58027_0,,,,2,2,1,3
C(CCC([CH]C(O)=O)C(CO)O)=O,,,5,1,1,0,1
58029_0,,,,2,2,1,3
C(CC[C](C(O)=O)CC(CO)O)=O,,,5,1,1,0,1
58031_0,,,,2,2,1,3
C(CCC(C=O)C[CH]C(O)=O)=O,,,5,1,1,0,1
58033_0,,,,2,2,1,3
C(CCC([CH]C(O)=O)CC=O)=O,,,5,1,1,0,1
58035_0,,,,2,2,1,3
C(CC[C](C(O)=O)CCC=O)=O,,,5,1,1,0,1
58037_0,,,,2,2,1,3
C(CCC(CCC=O)(CO)O)(O)=O,,,5,1,1,0,1
58039_0,,,,2,2,1,3
C(CCC(C(CCC=O)O)O)(O)=O,,,5,1,1,0,1
58041_0,,,,2,2,1,3
C(CC(CCC=O)C(CO)O)(O)=O,,,5,1,1,0,1
58043_0,,,,2,2,1,3
C(C(CCC=O)CC(CO)O)(O)=O,,,5,1,1,0,1
58045_0,,,,2,2,1,3
C(C(CCC=O)CCC(O)=O)=O,,,5,1,1,0,1
58047_0,,,,2,2,1,3
C(CCC(CC=O)CC(O)=O)=O,,,5,1,1,0,1
58049_0,,,,2,2,1,3
C(CCC(C(O)=O)CCC=O)=O,,,5,1,1,0,1
58051_0,,,,2,2,1,3
C(CCC([C](C(O)=O)O)C(C)O)=O,,,5,1,1,0,1
58053_0,,,,2,2,1,3
C(CCCC(C[C](C(O)=O)O)O)=O,,,5,1,1,0,1
58055_0,,,,2,2,1,3
C(CCC(C)(C[C](C(O)=O)O)O)=O,,,5,1,1,0,1
58057_0,,,,2,2,1,3
C(CCC(C(O)=O)[C](C(O)=O)O)=O,,,5,1,1,0,1
58059_0,,,,2,2,1,3
C(CCC([C](C(O)=O)O)O)=O,,,5,1,1,0,1
58061_0,,,,2,2,1,3
C(CCCC(C=O)O)=O,,,5,1,1,0,1
58063_0,,,,2,2,1,3
C(C(C)(CCC=O)O)=O,,,5,1,1,0,1
58065_0,,,,2,2,1,3
C(CCC(C(C)O)C(C(O)=O)O)=O,,,5,1,1,0,1
58067_0,,,,2,2,1,3
C(C(CCC=O)(CC(C)O)O)(O)=O,,,5,1,1,0,1
58069_0,,,,2,2,1,3
C(CCCC(CC(C(O)=O)O)O)=O,,,5,1,1,0,1
58071_0,,,,2,2,1,3
C(CCC(C)(CC(C(O)=O)O)O)=O,,,5,1,1,0,1
58072_0,,,,2,2,1,3
58074_0,,,,2,2,1,3
C(C(CCC=O)(CC(O)=O)O)(O)=O,,,5,1,1,0,1
58076_0,,,,2,2,1,3
C(CCCC(C(O)=O)=O)=O,,,5,1,2,0,2
58078_0,,,,2,2,1,3
C=CC(CCCC(C(O)=O)=O)O,,,5,1,1,0,1
58080_0,,,,2,2,1,3
C(C(C)(CCC(C(O)=O)=O)O)=C,,,5,1,1,0,1
58082_0,,,,2,2,1,3
C(C(CO)(CCC(C(O)=O)=O)O)=C,,,5,1,1,0,1
58084_0,,,,2,2,1,3
C=CC(C(CCC(C(O)=O)=O)O)O,,,5,1,1,0,1
58086_0,,,,2,2,1,3
C(C(CCC(C(O)=O)=O)(CC)O)=O,,,5,1,1,0,1
58088_0,,,,2,2,1,3
C(C(CCCCC(C(O)=O)=O)O)=O,,,5,1,1,0,1
58090_0,,,,2,2,1,3
C(C(C(CCC(C(O)=O)=O)C)O)=O,,,5,1,1,0,1
58092_0,,,,2,2,1,3
C(C(CCC(C(O)=O)=O)CCO)=O,,,5,1,1,0,1
58093_0,,,,2,2,1,3
58095_0,,,,2,2,1,3
C(CC(CCC(C(O)=O)=O)CO)=O,,,5,1,1,0,1
58096_0,,,,2,2,1,3
58098_0,,,,2,2,1,3
C(C(CCC(C(O)=O)=O)(O)O)=O,,,5,1,1,0,1
58099_0,,,,2,2,1,3
58101_0,,,,2,2,1,3
[C](C(O)=O)(CCCC(C(O)=O)=O)O,,,5,1,1,0,1
58103_0,,,,2,2,1,3
C(C(CCCC(C(O)=O)=O)O)(O)=O,,,5,1,1,0,1
58105_0,,,,2,2,1,3
C(C(C)(CCC(C(O)=O)=O)O)(O)=O,,,5,1,1,0,1
58106_0,,,,2,2,1,3
58108_0,,,,2,2,1,3
C(CC(CCCC(C(O)=O)=O)O)=O,,,5,1,1,0,1
58110_0,,,,2,2,1,3
C(CC(C)(CCC(C(O)=O)=O)O)=O,,,5,1,1,0,1
58111_0,,,,2,2,1,3
58113_0,,,,2,2,1,3
C(C(O)=O)(CCC(C(C=O)=O)O)=O,,,5,1,1,0,1
58114_0,,,,2,2,1,3
58115_0,,,,2,2,1,3
58117_0,,,,2,2,1,3
C(C(CCC(CO)O)=O)(O)=O,,,5,1,1,0,1
58119_0,,,,2,2,1,3
C(C(CCC(C(O)=O)=O)CO)=O,,,5,1,1,0,1
58121_0,,,,2,2,1,3
C(CC(CCC(C(O)=O)=O)O)=O,,,5,1,1,0,1
58123_0,,,,2,2,1,3
C(C(C=O)(CCC(C(O)=O)=O)O)=O,,,5,1,1,0,1
58125_0,,,,2,2,1,3
C(C(CCC(CO)C(C)O)=O)(O)=O,,,5,1,1,0,1
58127_0,,,,2,2,1,3
C(C(CCC(CC(C)O)O)=O)(O)=O,,,5,1,1,0,1
58129_0,,,,2,2,1,3
C(C(CCCC(CCO)O)=O)(O)=O,,,5,1,1,0,1
58131_0,,,,2,2,1,3
C(C(CCC(C)(CCO)O)=O)(O)=O,,,5,1,1,0,1
58133_0,,,,2,2,1,3
C(C(CCC(C(O)=O)=O)CO)(O)=O,,,5,1,2,0,2
58135_0,,,,2,2,1,3
C(CC(CCC(C(O)=O)=O)O)(O)=O,,,5,1,1,0,1
58137_0,,,,2,2,1,3
C(CO)(C(CCC(C(O)=O)=O)O)=O,,,5,1,1,0,1
58139_0,,,,2,2,1,3
C(CO)(CCCC(C(O)=O)=O)=O,,,5,1,1,0,1
58140_0,,,,2,2,1,3
58141_0,,,,2,2,1,3
58143_0,,,,2,2,1,3
C(C(CCCCO)=O)(O)=O,,,5,1,1,0,1
58144_0,,,,2,2,1,3
58145_0,,,,2,2,1,3
58147_0,,,,2,2,1,3
C(CCCC(C(O)=O)=O)=CC=O,,,5,1,1,0,1
58149_0,,,,2,2,1,3
C(C(C=C)CCC(C(O)=O)=O)=O,,,5,1,1,0,1
58151_0,,,,2,2,1,3
C(C(C(CCC(C(O)=O)=O)O)O)=O,,,5,1,1,0,1
58153_0,,,,2,2,1,3
C(C(CO)(CCC(C(O)=O)=O)O)=O,,,5,1,1,0,1
58155_0,,,,2,2,1,3
[CH](C(O)=O)C(CCC(C(O)=O)=O)O,,,5,1,1,0,1
58157_0,,,,2,2,1,3
C([C](CO)CCC(C(O)=O)=O)(O)=O,,,5,1,1,0,1
58159_0,,,,2,2,1,3
C(C(CCC(C(O)=O)=O)O)=O,,,5,1,1,0,1
58161_0,,,,2,2,1,3
C(C(CCCC(C(O)=O)=O)O)=O,,,5,1,1,0,1
58162_0,,,,2,2,1,3
58164_0,,,,2,2,1,3
C(C(O)=O)(CCCC(C(O)=O)=O)=O,,,5,1,1,0,1
58166_0,,,,2,2,1,3
C(C([CH]C(O)=O)C(C(O)=O)CO)=O,,,5,1,1,0,1
58168_0,,,,2,2,1,3
C(C(CO)C(C=O)CC=O)(O)=O,,,5,1,1,0,1
58169_0,,,,2,2,1,3
58170_0,,,,2,2,1,3
58172_0,,,,2,2,1,3
C(C(CO)C(C=O)CCO)(O)=O,,,5,1,1,0,1
58173_0,,,,2,2,1,3
58175_0,,,,2,2,1,3
C(CC(C=O)C(C(O)=O)CO)(O)=O,,,5,1,1,0,1
58176_0,,,,2,2,1,3
58178_0,,,,2,2,1,3
C(C([CH]C(O)=O)(CO)CC=O)(O)=O,,,5,1,1,0,1
58180_0,,,,2,2,1,3
C(C(CO)(CC=O)CC=O)(O)=O,,,5,1,1,0,1
58181_0,,,,2,2,1,3
58182_0,,,,2,2,1,3
58184_0,,,,2,2,1,3
C(C(CO)(CCO)CC=O)(O)=O,,,5,1,1,0,1
58185_0,,,,2,2,1,3
58186_0,,,,2,2,1,3
58187_0,,,,2,2,1,3
58189_0,,,,2,2,1,3
C(C(CO)CCC(C=C)O)(O)=O,,,5,1,1,0,1
58191_0,,,,2,2,1,3
C(C(C(C)=O)CCC(C=C)O)(O)=O,,,5,1,1,0,1
58193_0,,,,2,2,1,3
C(C(C=C)CCC(C=C)O)(O)=O,,,5,1,1,0,1
58195_0,,,,2,2,1,3
C1(C(CC(O)O1)CCC(C=C)O)=O,,,5,1,1,0,1
58197_0,,,,2,2,1,3
C1(C(C)C(C(O)O1)CC(C=C)O)=O,,,5,1,1,0,1
58199_0,,,,2,2,1,3
C=CC(CC([CH]C(O)=O)C(C)O)O,,,5,1,1,0,1
58201_0,,,,2,2,1,3
C(C([CH]C(O)=O)CC(C=C)O)(O)=O,,,5,1,1,0,1
58203_0,,,,2,2,1,3
C(C[C](C(O)=O)CC(C=C)O)(O)=O,,,5,1,1,0,1
58205_0,,,,2,2,1,3
C(CC(CC(C=C)O)C(C)O)(O)=O,,,5,1,1,0,1
58207_0,,,,2,2,1,3
C(C(CC(C=C)O)CC(O)=O)(O)=O,,,5,1,1,0,1
58208_0,,,,2,2,1,3
58209_0,,,,2,2,1,3
58210_0,,,,2,2,1,3
58212_0,,,,2,2,1,3
C=CC(CC(C)CC(C(O)=O)=O)O,,,5,1,1,0,1
58214_0,,,,2,2,1,3
C(C(CCC(C=C)O)CC=O)(O)=O,,,5,1,1,0,1
58216_0,,,,2,2,1,3
C(C(C)(CC(C=C)O)CC=O)(O)=O,,,5,1,1,0,1
58218_0,,,,2,2,1,3
C(C(C)C(C=O)CC(C=C)O)(O)=O,,,5,1,1,0,1
58220_0,,,,2,2,1,3
C(C(C(C)O)CCC(C=C)O)(O)=O,,,5,1,1,0,1
58222_0,,,,2,2,1,3
C(C(C(O)=O)CCC(C=C)O)(O)=O,,,5,1,1,0,1
58224_0,,,,2,2,1,3
C(C(CO)CC(C=C)(C)O)(O)=O,,,5,1,1,0,1
58226_0,,,,2,2,1,3
C(C(C(C)=O)CC(C=C)(C)O)(O)=O,,,5,1,1,0,1
58228_0,,,,2,2,1,3
C(C(C=C)CC(C=C)(C)O)(O)=O,,,5,1,1,0,1
58230_0,,,,2,2,1,3
C1(C(CC(C=C)(C)O)CC(O)O1)=O,,,5,1,1,0,1
58232_0,,,,2,2,1,3
C1(C(C)C(C(O)O1)C(C=C)(C)O)=O,,,5,1,1,0,1
58234_0,,,,2,2,1,3
C=CC(C)(C([CH]C(O)=O)C(C)O)O,,,5,1,1,0,1
58236_0,,,,2,2,1,3
C(C([CH]C(O)=O)C(C=C)(C)O)(O)=O,,,5,1,1,0,1
58238_0,,,,2,2,1,3
C(C[C](C(O)=O)C(C=C)(C)O)(O)=O,,,5,1,1,0,1
58240_0,,,,2,2,1,3
C(CC(C(C)O)C(C=C)(C)O)(O)=O,,,5,1,1,0,1
58242_0,,,,2,2,1,3
C(CC(C(O)=O)C(C=C)(C)O)(O)=O,,,5,1,1,0,1
58243_0,,,,2,2,1,3
58244_0,,,,2,2,1,3
58245_0,,,,2,2,1,3
58247_0,,,,2,2,1,3
C(C(C)(C(C)CC(C(O)=O)=O)O)=C,,,5,1,1,0,1
58249_0,,,,2,2,1,3
C(C(CC(C=C)(C)O)CC=O)(O)=O,,,5,1,1,0,1
58251_0,,,,2,2,1,3
C(C(C)(CC=O)C(C=C)(C)O)(O)=O,,,5,1,1,0,1
58253_0,,,,2,2,1,3
C(C(C)C(C=O)C(C=C)(C)O)(O)=O,,,5,1,1,0,1
58255_0,,,,2,2,1,3
C(C(CC(C=C)(C)O)C(C)O)(O)=O,,,5,1,1,0,1
58257_0,,,,2,2,1,3
C(C(C(O)=O)CC(C=C)(C)O)(O)=O,,,5,1,1,0,1
58258_0,,,,2,2,1,3
58260_0,,,,2,2,1,3
C(C(CCO)C(CC(C)O)O)(O)=O,,,5,1,1,0,1
58261_0,,,,2,2,1,3
58263_0,,,,2,2,1,3
C(CC(CO)C(C(O)=O)O)(O)=O,,,5,1,1,0,1
58265_0,,,,2,2,1,3
C(CC(CCO)C(C(O)=O)O)(O)=O,,,5,1,1,0,1
58267_0,,,,2,2,1,3
C(CC(C(C)O)C(C(O)=O)O)(O)=O,,,5,1,2,0,2
58269_0,,,,2,2,1,3
C(C(C(CC(O)=O)O)CCO)(O)=O,,,5,1,1,0,1
58271_0,,,,2,2,1,3
C(C(CCO)C(C(CO)=O)O)(O)=O,,,5,1,1,0,1
58273_0,,,,2,2,1,3
C(C(CCO)C(C=O)(CO)O)(O)=O,,,5,1,1,0,1
58274_0,,,,2,2,1,3
58275_0,,,,2,2,1,3
58277_0,,,,2,2,1,3
C(C(CC(CO)O)C(C(O)=O)O)=O,,,5,1,1,0,1
58278_0,,,,2,2,1,3
58280_0,,,,2,2,1,3
C(C(CCCO)C(C(O)=O)O)=O,,,5,1,1,0,1
58282_0,,,,2,2,1,3
C(C(CC(C)O)C(C(O)=O)O)=O,,,5,1,1,0,1
58283_0,,,,2,2,1,3
58285_0,,,,2,2,1,3
C(C(CC(C=O)C(C(O)=O)O)O)=O,,,5,1,1,0,1
58286_0,,,,2,2,1,3
58288_0,,,,2,2,1,3
C(C(CCO)C(C=O)(C)O)(O)=O,,,5,1,1,0,1
58290_0,,,,2,2,1,3
C(C(CCCO)C(C=O)(C)O)(O)=O,,,5,1,1,0,1
58292_0,,,,2,2,1,3
C(C(CC(C)O)C(C=O)(C)O)(O)=O,,,5,1,1,0,1
58293_0,,,,2,2,1,3
58295_0,,,,2,2,1,3
C(C(CCO)C(C(C)=O)O)(O)=O,,,5,1,1,0,1
58297_0,,,,2,2,1,3
C(C(CCCO)C(C(C)=O)O)(O)=O,,,5,1,1,0,1
58299_0,,,,2,2,1,3
C(C(CC(C)O)C(C(C)=O)O)(O)=O,,,5,1,1,0,1
58300_0,,,,2,2,1,3
58301_0,,,,2,2,1,3
58302_0,,,,2,2,1,3
58304_0,,,,2,2,1,3
C(C(CO)CC(C=C)(CO)O)(O)=O,,,5,1,1,0,1
58306_0,,,,2,2,1,3
C(C(CO)CC(C(C=C)O)O)(O)=O,,,5,1,1,0,1
58308_0,,,,2,2,1,3
C(C(CO)CC(C=O)(CC)O)(O)=O,,,5,1,1,0,1
58310_0,,,,2,2,1,3
C(C(CO)CCCC(C=O)O)(O)=O,,,5,1,1,0,1
58312_0,,,,2,2,1,3
C(C(CO)CC(C)C(C=O)O)(O)=O,,,5,1,1,0,1
58314_0,,,,2,2,1,3
C(C(CC(C=O)CCO)CO)(O)=O,,,5,1,1,0,1
58316_0,,,,2,2,1,3
C(C(CO)CC(CCC=O)O)(O)=O,,,5,1,1,0,1
58318_0,,,,2,2,1,3
C(C(CO)CC(CO)CC=O)(O)=O,,,5,1,1,0,1
58319_0,,,,2,2,1,3
58321_0,,,,2,2,1,3
C(C(CO)CC(C=O)(O)O)(O)=O,,,5,1,1,0,1
58322_0,,,,2,2,1,3
58324_0,,,,2,2,1,3
C(C(CC[C](C(O)=O)O)CO)(O)=O,,,5,1,1,0,1
58326_0,,,,2,2,1,3
C(C(CO)CCC(C(O)=O)O)(O)=O,,,5,1,1,0,1
58328_0,,,,2,2,1,3
C(C(CO)CC(C(O)=O)(C)O)(O)=O,,,5,1,1,0,1
58329_0,,,,2,2,1,3
58331_0,,,,2,2,1,3
C(C(CO)CCC(CC=O)O)(O)=O,,,5,1,1,0,1
58333_0,,,,2,2,1,3
C(C(CO)CC(C)(CC=O)O)(O)=O,,,5,1,1,0,1
58334_0,,,,2,2,1,3
58336_0,,,,2,2,1,3
C(C(CO)CC(C(C=O)=O)O)(O)=O,,,5,1,1,0,1
58337_0,,,,2,2,1,3
58338_0,,,,2,2,1,3
58340_0,,,,2,2,1,3
C(C(CO)CC(CO)O)(O)=O,,,5,1,1,0,1
58342_0,,,,2,2,1,3
C(C(CC(C=O)CO)CO)(O)=O,,,5,1,1,0,1
58343_0,,,,2,2,1,3
58345_0,,,,2,2,1,3
C(C(C=O)(CC(C(O)=O)CO)O)=O,,,5,1,1,0,1
58347_0,,,,2,2,1,3
C(C(CO)CC(CO)C(C)O)(O)=O,,,5,1,1,0,1
58349_0,,,,2,2,1,3
C(C(CO)CC(CC(C)O)O)(O)=O,,,5,1,1,0,1
58351_0,,,,2,2,1,3
C(C(CO)CCC(CCO)O)(O)=O,,,5,1,1,0,1
58353_0,,,,2,2,1,3
C(C(CO)CC(C)(CCO)O)(O)=O,,,5,1,1,0,1
58355_0,,,,2,2,1,3
C(C(CC(C(O)=O)CO)CO)(O)=O,,,5,1,1,0,1
58357_0,,,,2,2,1,3
C(C(CO)CC(CC(O)=O)O)(O)=O,,,5,1,1,0,1
58359_0,,,,2,2,1,3
C(C(CO)CC(C(CO)=O)O)(O)=O,,,5,1,1,0,1
58361_0,,,,2,2,1,3
C(C(CO)CCC(CO)=O)(O)=O,,,5,1,1,0,1
58363_0,,,,2,2,1,3
C(C(CO)CC(C(C)=O)O)(O)=O,,,5,1,1,0,1
58364_0,,,,2,2,1,3
58366_0,,,,2,2,1,3
C(C(CO)CCCO)(O)=O,,,5,1,1,0,1
58368_0,,,,2,2,1,3
C(C(CO)CC(C)O)(O)=O,,,5,1,1,0,1
58369_0,,,,2,2,1,3
58371_0,,,,2,2,1,3
C(C(CCC=CC=O)CO)(O)=O,,,5,1,1,0,1
58373_0,,,,2,2,1,3
C(C(C=C)CC(C(O)=O)CO)=O,,,5,1,1,0,1
58374_0,,,,2,2,1,3
58376_0,,,,2,2,1,3
C(C(CO)CC(C=O)(CO)O)(O)=O,,,5,1,1,0,1
58378_0,,,,2,2,1,3
C(C(CO)CC([CH]C(O)=O)O)(O)=O,,,5,1,1,0,1
58380_0,,,,2,2,1,3
C(C(CO)C[C](C(O)=O)CO)(O)=O,,,5,1,1,0,1
58382_0,,,,2,2,1,3
C(C(CO)CC(C=O)O)(O)=O,,,5,1,1,0,1
58384_0,,,,2,2,1,3
C(C(CO)CCC(C=O)O)(O)=O,,,5,1,1,0,1
58386_0,,,,2,2,1,3
C(C(CO)CC(C=O)(C)O)(O)=O,,,5,1,1,0,1
58387_0,,,,2,2,1,3
58389_0,,,,2,2,1,3
C=C(C(O)=O)C(CC[CH]C(O)=O)=O,,,5,1,1,0,1
58391_0,,,,2,2,1,3
C(CCCC(C(C(O)=O)=C)=O)(O)=O,,,5,1,1,0,1
58393_0,,,,2,2,1,3
C(CC(C)CC(C(C(O)=O)=C)=O)=O,,,5,1,1,0,1
58394_0,,,,2,2,1,3
58396_0,,,,2,2,1,3
C(C(CC(C(O)=O)C(C)=O)(O)O)=O,,,5,1,1,0,1
58397_0,,,,2,2,1,3
58398_0,,,,2,2,1,3
58400_0,,,,2,2,1,3
C(C(CC(C(O)=O)C(C)=O)O)(O)=O,,,5,1,1,0,1
58402_0,,,,2,2,1,3
C(C(C(C)=O)CC(CO)O)(O)=O,,,5,1,1,0,1
58404_0,,,,2,2,1,3
C(C(CC(C(O)=O)C(C)=O)CO)=O,,,5,1,1,0,1
58406_0,,,,2,2,1,3
C(CC(CC(C(O)=O)C(C)=O)O)=O,,,5,1,1,0,1
58408_0,,,,2,2,1,3
C(C)(C(C(O)=O)CCC(CO)=O)=O,,,5,1,1,0,1
58410_0,,,,2,2,1,3
C(C(C(C)=O)CC(C(C)=O)O)(O)=O,,,5,1,1,0,1
58412_0,,,,2,2,1,3
C(C(C(C)=O)CCO)(O)=O,,,5,1,1,0,1
58414_0,,,,2,2,1,3
C(C(C(C)=O)CCCO)(O)=O,,,5,1,1,0,1
58415_0,,,,2,2,1,3
58416_0,,,,2,2,1,3
58418_0,,,,2,2,1,3
C(C)(C(C(O)=O)CCC=CC=O)=O,,,5,1,1,0,1
58420_0,,,,2,2,1,3
C(C(C=C)CC(C(C)=O)C(O)=O)=O,,,5,1,1,0,1
58422_0,,,,2,2,1,3
C(C(CC(C(O)=O)C(C)=O)O)=O,,,5,1,1,0,1
58424_0,,,,2,2,1,3
C(C(CCC(C(O)=O)C(C)=O)O)=O,,,5,1,1,0,1
58426_0,,,,2,2,1,3
C(C(C)(CC(C(O)=O)C(C)=O)O)=O,,,5,1,1,0,1
58428_0,,,,2,2,1,3
C(C(C=C)CC(C=C)(CO)O)(O)=O,,,5,1,1,0,1
58430_0,,,,2,2,1,3
C(C(C=C)CC(C(C=C)O)O)(O)=O,,,5,1,1,0,1
58432_0,,,,2,2,1,3
C(C(C=C)CC(C=O)(CC)O)(O)=O,,,5,1,1,0,1
58434_0,,,,2,2,1,3
C(C(C=C)CCCC(C=O)O)(O)=O,,,5,1,1,0,1
58436_0,,,,2,2,1,3
C(C(C=C)CC(C)C(C=O)O)(O)=O,,,5,1,1,0,1
58438_0,,,,2,2,1,3
C(C(C=C)CC(C=O)CCO)(O)=O,,,5,1,1,0,1
58440_0,,,,2,2,1,3
C(C(C=C)CC(CCC=O)O)(O)=O,,,5,1,1,0,1
58442_0,,,,2,2,1,3
C(C(C=C)CC(CO)CC=O)(O)=O,,,5,1,1,0,1
58444_0,,,,2,2,1,3
C(C(C=C)CC1C(C(OC1)=O)=O)(O)=O,,,5,1,1,0,1
58446_0,,,,2,2,1,3
C(C(C=C)CC1CC(C(O1)=O)=O)(O)=O,,,5,1,1,0,1
58447_0,,,,2,2,1,3
58449_0,,,,2,2,1,3
C(C(C=C)CC(C=O)(O)O)(O)=O,,,5,1,1,0,1
58450_0,,,,2,2,1,3
58452_0,,,,2,2,1,3
C(C(C=C)CC[C](C(O)=O)O)(O)=O,,,5,1,1,0,1
58454_0,,,,2,2,1,3
C(C(C=C)CCC(C(O)=O)O)(O)=O,,,5,1,1,0,1
58456_0,,,,2,2,1,3
C(C(C=C)CC(C(O)=O)(C)O)(O)=O,,,5,1,1,0,1
58457_0,,,,2,2,1,3
58459_0,,,,2,2,1,3
C(C(C=C)CCC(CC=O)O)(O)=O,,,5,1,1,0,1
58461_0,,,,2,2,1,3
C(C(C=C)CC(C)(CC=O)O)(O)=O,,,5,1,1,0,1
58462_0,,,,2,2,1,3
58464_0,,,,2,2,1,3
C(C(C=C)CC(C(C=O)=O)O)(O)=O,,,5,1,1,0,1
58465_0,,,,2,2,1,3
58466_0,,,,2,2,1,3
58467_0,,,,2,2,1,3
58468_0,,,,2,2,1,3
58469_0,,,,2,2,1,3
58471_0,,,,2,2,1,3
C(C(C=C)CC(C=O)(C=O)O)(O)=O,,,5,1,1,0,1
58473_0,,,,2,2,1,3
C(C(C=C)CC(CO)C(C)O)(O)=O,,,5,1,1,0,1
58475_0,,,,2,2,1,3
C(C(C=C)CC(CC(C)O)O)(O)=O,,,5,1,1,0,1
58477_0,,,,2,2,1,3
C(C(C=C)CCC(CCO)O)(O)=O,,,5,1,1,0,1
58479_0,,,,2,2,1,3
C(C(C=C)CC(C)(CCO)O)(O)=O,,,5,1,1,0,1
58480_0,,,,2,2,1,3
58482_0,,,,2,2,1,3
C(C(C=C)CC(CC(O)=O)O)(O)=O,,,5,1,1,0,1
58484_0,,,,2,2,1,3
C(C(C=C)CC(C(CO)=O)O)(O)=O,,,5,1,1,0,1
58485_0,,,,2,2,1,3
58486_0,,,,2,2,1,3
58487_0,,,,2,2,1,3
58488_0,,,,2,2,1,3
58489_0,,,,2,2,1,3
58490_0,,,,2,2,1,3
58491_0,,,,2,2,1,3
58492_0,,,,2,2,1,3
58494_0,,,,2,2,1,3
C(C(C=C)CC(C(C=O)O)O)(O)=O,,,5,1,1,0,1
58496_0,,,,2,2,1,3
C(C(C=C)CC(C=O)(CO)O)(O)=O,,,5,1,1,0,1
58498_0,,,,2,2,1,3
C(C(C=C)CC([CH]C(O)=O)O)(O)=O,,,5,1,1,0,1
58500_0,,,,2,2,1,3
C(C(C=C)C[C](C(O)=O)CO)(O)=O,,,5,1,1,0,1
58501_0,,,,2,2,1,3
58502_0,,,,2,2,1,3
58503_0,,,,2,2,1,3
58504_0,,,,2,2,1,3
58505_0,,,,2,2,1,3
58506_0,,,,2,2,1,3
58508_0,,,,2,2,1,3
C(C(C(C(O)=O)=C)CCCO)(O)=O,,,5,1,1,0,1
58510_0,,,,2,2,1,3
C(C(C(C(O)=O)=C)CC(C)O)(O)=O,,,5,1,1,0,1
58512_0,,,,2,2,1,3
C1(C(C=C(C(O)=O)O1)C[CH]C(O)=O)=O,,,5,1,1,0,1
58514_0,,,,2,2,1,3
C1(C(C=C(C(O)=O)O1)CCC=O)=O,,,5,1,1,0,1
58515_0,,,,2,2,1,3
58517_0,,,,2,2,1,3
C1(C(C=C(C(O)=O)O1)CCCO)=O,,,5,1,1,0,1
58519_0,,,,2,2,1,3
C1(C(C=C(C(O)=O)O1)CC(C)O)=O,,,5,1,1,0,1
58521_0,,,,2,2,1,3
C(CC([CH]C(O)=O)C(C(O)=O)=C)=O,,,5,1,1,0,1
58522_0,,,,2,2,1,3
58524_0,,,,2,2,1,3
C=C(C(O)=O)C([CH]C(O)=O)CCO,,,5,1,1,0,1
58526_0,,,,2,2,1,3
C=C(C(O)=O)C([CH]C(O)=O)C(C)O,,,5,1,1,0,1
58528_0,,,,2,2,1,3
[C](C(O)=O)=CC(C(O)=O)CCC=O,,,5,1,1,0,1
58529_0,,,,2,2,1,3
58531_0,,,,2,2,1,3
[C](C(O)=O)=CC(C(O)=O)CCCO,,,5,1,1,0,1
58533_0,,,,2,2,1,3
[C](C(O)=O)=CC(C(O)=O)CC(C)O,,,5,1,1,0,1
58535_0,,,,2,2,1,3
C(CC(C(C(O)=O)=C)CC(O)=O)=O,,,5,1,1,0,1
58536_0,,,,2,2,1,3
58538_0,,,,2,2,1,3
C(CC(C(C(O)=O)=C)CCO)(O)=O,,,5,1,1,0,1
58540_0,,,,2,2,1,3
C(CC(C(C(O)=O)=C)C(C)O)(O)=O,,,5,1,1,0,1
58541_0,,,,2,2,1,3
58542_0,,,,2,2,1,3
58544_0,,,,2,2,1,3
C(C(C=CC(O)=O)CCCO)(O)=O,,,5,1,1,0,1
58546_0,,,,2,2,1,3
C(C(C=CC(O)=O)CC(C)O)(O)=O,,,5,1,1,0,1
58547_0,,,,2,2,1,3
58548_0,,,,2,2,1,3
58549_0,,,,2,2,1,3
58550_0,,,,2,2,1,3
58551_0,,,,2,2,1,3
58552_0,,,,2,2,1,3
58553_0,,,,2,2,1,3
58554_0,,,,2,2,1,3
58555_0,,,,2,2,1,3
58556_0,,,,2,2,1,3
58557_0,,,,2,2,1,3
58558_0,,,,2,2,1,3
58559_0,,,,2,2,1,3
58560_0,,,,2,2,1,3
58561_0,,,,2,2,1,3
58562_0,,,,2,2,1,3
58563_0,,,,2,2,1,3
58564_0,,,,2,2,1,3
58566_0,,,,2,2,1,3
C=C1C(OC(C[CH]C(O)=O)(C1)O)=O,,,5,1,1,0,1
58568_0,,,,2,2,1,3
C(CCC1(CC(C(O1)=O)=C)O)(O)=O,,,5,1,1,0,1
58570_0,,,,2,2,1,3
C(CC(C)C1(CC(C(O1)=O)=C)O)=O,,,5,1,1,0,1
58572_0,,,,2,2,1,3
C1(C(CC(O)O1)C[CH]C(O)=O)=O,,,5,1,1,0,1
58574_0,,,,2,2,1,3
C1(C(CC(C=O)(O)O)CC(O)O1)=O,,,5,1,1,0,1
58575_0,,,,2,2,1,3
58576_0,,,,2,2,1,3
58577_0,,,,2,2,1,3
58578_0,,,,2,2,1,3
58579_0,,,,2,2,1,3
58580_0,,,,2,2,1,3
58581_0,,,,2,2,1,3
58582_0,,,,2,2,1,3
58583_0,,,,2,2,1,3
58584_0,,,,2,2,1,3
58585_0,,,,2,2,1,3
58586_0,,,,2,2,1,3
58587_0,,,,2,2,1,3
58588_0,,,,2,2,1,3
58589_0,,,,2,2,1,3
58590_0,,,,2,2,1,3
58591_0,,,,2,2,1,3
58593_0,,,,2,2,1,3
C1C(O)OC(C=1CC[CH]C(O)=O)=O,,,5,1,1,0,1
58595_0,,,,2,2,1,3
C(CCCC1C(OC(C=1)O)=O)(O)=O,,,5,1,1,0,1
58597_0,,,,2,2,1,3
C(CC(C)CC1C(OC(C=1)O)=O)=O,,,5,1,1,0,1
58599_0,,,,2,2,1,3
C1C(C[CH]C(O)=O)(O)OC(C=1C)=O,,,5,1,1,0,1
58601_0,,,,2,2,1,3
C(CCC1(C=C(C(O1)=O)C)O)(O)=O,,,5,1,1,0,1
58603_0,,,,2,2,1,3
C(CC(C)C1(C=C(C(O1)=O)C)O)=O,,,5,1,1,0,1
58605_0,,,,2,2,1,3
C1(C(C)C([CH]C(O)=O)C(O)O1)=O,,,5,1,1,0,1
58607_0,,,,2,2,1,3
C1(C(C)C(C(O)O1)C(C=O)(O)O)=O,,,5,1,1,0,1
58608_0,,,,2,2,1,3
58609_0,,,,2,2,1,3
58610_0,,,,2,2,1,3
58611_0,,,,2,2,1,3
58612_0,,,,2,2,1,3
58613_0,,,,2,2,1,3
58614_0,,,,2,2,1,3
58615_0,,,,2,2,1,3
58616_0,,,,2,2,1,3
58617_0,,,,2,2,1,3
58618_0,,,,2,2,1,3
58619_0,,,,2,2,1,3
58620_0,,,,2,2,1,3
58621_0,,,,2,2,1,3
58622_0,,,,2,2,1,3
58623_0,,,,2,2,1,3
58624_0,,,,2,2,1,3
58626_0,,,,2,2,1,3
C1(C(C=CO1)(CC[CH]C(O)=O)O)=O,,,5,1,1,0,1
58628_0,,,,2,2,1,3
C1(C(C=CO1)(CCCC(O)=O)O)=O,,,5,1,1,0,1
58630_0,,,,2,2,1,3
C1(C(C=CO1)(CC(C)CC=O)O)=O,,,5,1,1,0,1
58632_0,,,,2,2,1,3
C1(C(CCO)C(C(O)=O)(CO1)O)=O,,,5,1,1,0,1
58634_0,,,,2,2,1,3
C1(C(CCO)C(C(O1)=O)(CO)O)=O,,,5,1,1,0,1
58635_0,,,,2,2,1,3
58636_0,,,,2,2,1,3
58638_0,,,,2,2,1,3
C1(C(CCCO)C(C(O1)=O)(C)O)=O,,,5,1,1,0,1
58640_0,,,,2,2,1,3
C1(C(CC(C)O)C(C(O1)=O)(C)O)=O,,,5,1,1,0,1
58642_0,,,,2,2,1,3
C1(C(C(C(C(O)=O)O1)O)CCO)=O,,,5,1,1,0,1
58644_0,,,,2,2,1,3
C(C1(C)C([CH]C(O1)=O)CC=O)(O)=O,,,5,1,1,0,1
58645_0,,,,2,2,1,3
58647_0,,,,2,2,1,3
C(C1(C)C([CH]C(O1)=O)CCO)(O)=O,,,5,1,1,0,1
58649_0,,,,2,2,1,3
C(C1(C)C([CH]C(O1)=O)C(C)O)(O)=O,,,5,1,1,0,1
58651_0,,,,2,2,1,3
C1(C(C)C([C](C(O)=O)O1)CC=O)=O,,,5,1,1,0,1
58652_0,,,,2,2,1,3
58654_0,,,,2,2,1,3
C1(C(C)C([C](C(O)=O)O1)CCO)=O,,,5,1,1,0,1
58656_0,,,,2,2,1,3
C1(C(C)C([C](C(O)=O)O1)C(C)O)=O,,,5,1,1,0,1
58658_0,,,,2,2,1,3
C1(C(CCC=O)C[C](C(O)=O)O1)=O,,,5,1,1,0,1
58659_0,,,,2,2,1,3
58661_0,,,,2,2,1,3
C1(C(CCCO)C[C](C(O)=O)O1)=O,,,5,1,1,0,1
58663_0,,,,2,2,1,3
C1(C(CC(C)O)C[C](C(O)=O)O1)=O,,,5,1,1,0,1
58665_0,,,,2,2,1,3
C(C1(C)C(CC=O)CC(O1)=O)(O)=O,,,5,1,1,0,1
58666_0,,,,2,2,1,3
58668_0,,,,2,2,1,3
C(C1(C)C(CCO)CC(O1)=O)(O)=O,,,5,1,1,0,1
58670_0,,,,2,2,1,3
C(C1(C)C(C(C)O)CC(O1)=O)(O)=O,,,5,1,1,0,1
58672_0,,,,2,2,1,3
C(CC1C(C(O)=O)OC(C1C)=O)=O,,,5,1,1,0,1
58673_0,,,,2,2,1,3
58675_0,,,,2,2,1,3
C1(C(C)C(CCO)C(C(O)=O)O1)=O,,,5,1,1,0,1
58677_0,,,,2,2,1,3
C1(C(C)C(C(C)O)C(C(O)=O)O1)=O,,,5,1,1,0,1
58678_0,,,,2,2,1,3
58679_0,,,,2,2,1,3
58681_0,,,,2,2,1,3
C1(C(CC(C(O)=O)O1)CCCO)=O,,,5,1,1,0,1
58683_0,,,,2,2,1,3
C1(C(CC(C(O)=O)O1)CC(C)O)=O,,,5,1,1,0,1
58685_0,,,,2,2,1,3
C1(C(C)(C([CH]C(O1)=O)CC=O)O)=O,,,5,1,1,0,1
58686_0,,,,2,2,1,3
58688_0,,,,2,2,1,3
C1(C(C)(C([CH]C(O1)=O)CCO)O)=O,,,5,1,1,0,1
58690_0,,,,2,2,1,3
C1(C(C)(C([CH]C(O1)=O)C(C)O)O)=O,,,5,1,1,0,1
58692_0,,,,2,2,1,3
C1(C(C)C([C](C(O1)=O)O)CC=O)=O,,,5,1,1,0,1
58693_0,,,,2,2,1,3
58695_0,,,,2,2,1,3
C1(C(C)C([C](C(O1)=O)O)CCO)=O,,,5,1,1,0,1
58697_0,,,,2,2,1,3
C1(C(C)C([C](C(O1)=O)O)C(C)O)=O,,,5,1,1,0,1
58699_0,,,,2,2,1,3
C1(C(CCC=O)C[C](C(O1)=O)O)=O,,,5,1,1,0,1
58700_0,,,,2,2,1,3
58702_0,,,,2,2,1,3
C1(C(CCCO)C[C](C(O1)=O)O)=O,,,5,1,1,0,1
58704_0,,,,2,2,1,3
C1(C(CC(C)O)C[C](C(O1)=O)O)=O,,,5,1,1,0,1
58706_0,,,,2,2,1,3
C1(C(C)(C(CC(O1)=O)CC=O)O)=O,,,5,1,1,0,1
58707_0,,,,2,2,1,3
58709_0,,,,2,2,1,3
C1(C(C)(C(CCO)CC(O1)=O)O)=O,,,5,1,1,0,1
58711_0,,,,2,2,1,3
C1(C(C)(C(C(C)O)CC(O1)=O)O)=O,,,5,1,1,0,1
58713_0,,,,2,2,1,3
C1(C(C)C(C(C(O1)=O)O)CC=O)=O,,,5,1,1,0,1
58714_0,,,,2,2,1,3
58716_0,,,,2,2,1,3
C1(C(C)C(CCO)C(C(O1)=O)O)=O,,,5,1,1,0,1
58718_0,,,,2,2,1,3
C1(C(C)C(C(C)O)C(C(O1)=O)O)=O,,,5,1,1,0,1
58719_0,,,,2,2,1,3
58720_0,,,,2,2,1,3
58722_0,,,,2,2,1,3
C1(C(CC(C(O1)=O)O)CCCO)=O,,,5,1,1,0,1
58724_0,,,,2,2,1,3
C1(C(CC(C(O1)=O)O)CC(C)O)=O,,,5,1,1,0,1
58725_0,,,,2,2,1,3
58727_0,,,,2,2,1,3
C(C(C(C)CO)C[CH]C(O)=O)=O,,,5,1,2,0,2
58728_0,,,,2,2,1,3
58730_0,,,,2,2,1,3
C(C(C(C)C(C)O)C[CH]C(O)=O)=O,,,5,1,2,0,2
58731_0,,,,2,2,1,3
58733_0,,,,2,2,1,3
C(C(CCC(O)=O)C(C)CO)=O,,,5,1,2,0,2
58734_0,,,,2,2,1,3
58736_0,,,,2,2,1,3
C(C(CCC(O)=O)C(C)C(C)O)=O,,,5,1,2,0,2
58738_0,,,,2,2,1,3
C(CC(CC[CH]C(O)=O)CC=O)=O,,,5,1,2,0,2
58740_0,,,,2,2,1,3
C(CC(CC[CH]C(O)=O)CO)=O,,,5,1,2,0,2
58742_0,,,,2,2,1,3
C(CC(CC[CH]C(O)=O)CCO)=O,,,5,1,2,0,2
58744_0,,,,2,2,1,3
C(CC(CC[CH]C(O)=O)C(C)O)=O,,,5,1,2,0,2
58746_0,,,,2,2,1,3
C(CC(CCCC(O)=O)CC=O)=O,,,5,1,2,0,2
58748_0,,,,2,2,1,3
C(CCCC(CO)CC=O)(O)=O,,,5,1,2,0,2
58750_0,,,,2,2,1,3
C(CCCC(CCO)CC=O)(O)=O,,,5,1,2,0,2
58752_0,,,,2,2,1,3
C(CCCC(C(C)O)CC=O)(O)=O,,,5,1,2,0,2
58754_0,,,,2,2,1,3
C(CC(C)(CC=O)C[CH]C(O)=O)=O,,,5,1,2,0,2
58756_0,,,,2,2,1,3
C(CC(C)(CO)C[CH]C(O)=O)=O,,,5,1,2,0,2
58758_0,,,,2,2,1,3
C(CC(C)(CCO)C[CH]C(O)=O)=O,,,5,1,2,0,2
58760_0,,,,2,2,1,3
C(CC(C)(C(C)O)C[CH]C(O)=O)=O,,,5,1,2,0,2
58762_0,,,,2,2,1,3
C(CC(C)(CCC(O)=O)CC=O)=O,,,5,1,2,0,2
58764_0,,,,2,2,1,3
C(CCC(C)(CO)CC=O)(O)=O,,,5,1,2,0,2
58766_0,,,,2,2,1,3
C(CCC(C)(CCO)CC=O)(O)=O,,,5,1,2,0,2
58768_0,,,,2,2,1,3
C(CCC(C)(C(C)O)CC=O)(O)=O,,,5,1,2,0,2
58770_0,,,,2,2,1,3
C(CC([CH]C(O)=O)CC(C=O)=O)=O,,,5,1,1,0,1
58772_0,,,,2,2,1,3
[CH](C(O)=O)C(CO)CC(C=O)=O,,,5,1,1,0,1
58774_0,,,,2,2,1,3
[CH](C(O)=O)C(CCO)CC(C=O)=O,,,5,1,1,0,1
58776_0,,,,2,2,1,3
[CH](C(O)=O)C(C(C)O)CC(C=O)=O,,,5,1,2,0,2
58778_0,,,,2,2,1,3
C(CC([C](C(O)=O)C=CC(O)=O)C)=O,,,5,1,1,0,1
58780_0,,,,2,2,1,3
C(CC([CH]C(O)=O)[CH]C(O)=O)(O)=O,,,5,1,1,0,1
58781_0,,,,2,2,1,3
58783_0,,,,2,2,1,3
C(CC([CH]C(O)=O)C(CO)O)(O)=O,,,5,1,1,0,1
58785_0,,,,2,2,1,3
C(CC([CH]C(O)=O)CO)(O)=O,,,5,1,1,0,1
58787_0,,,,2,2,1,3
C(CC([CH]C(O)=O)CCO)(O)=O,,,5,1,1,0,1
58789_0,,,,2,2,1,3
C(CC([CH]C(O)=O)C(C)O)(O)=O,,,5,1,3,0,3
58791_0,,,,2,2,1,3
C(CC([CH]C(O)=O)CC(O)=O)(O)=O,,,5,1,2,0,2
58793_0,,,,2,2,1,3
C(CC([CH]C(O)=O)CC=CC=O)(O)=O,,,5,1,1,0,1
58795_0,,,,2,2,1,3
C(C(C=C)C([CH]C(O)=O)CC(O)=O)=O,,,5,1,1,0,1
58797_0,,,,2,2,1,3
C(CC([CH]C(O)=O)C(C=O)O)(O)=O,,,5,1,1,0,1
58798_0,,,,2,2,1,3
58799_0,,,,2,2,1,3
58801_0,,,,2,2,1,3
C(CC(C(CO)O)CC(O)=O)(O)=O,,,5,1,1,0,1
58803_0,,,,2,2,1,3
C(CC(CO)CC(O)=O)(O)=O,,,5,1,1,0,1
58805_0,,,,2,2,1,3
C(CC(CCO)CC(O)=O)(O)=O,,,5,1,1,0,1
58807_0,,,,2,2,1,3
C(CC(C(C)O)CC(O)=O)(O)=O,,,5,1,2,0,2
58809_0,,,,2,2,1,3
C(CC(CC(O)=O)CC(O)=O)(O)=O,,,5,1,1,0,1
58811_0,,,,2,2,1,3
C(CC(C(C=O)O)CC(O)=O)(O)=O,,,5,1,1,0,1
58813_0,,,,2,2,1,3
C(C(C[CH]C(O)=O)O)=C[CH]C(O)=O,,,5,1,1,0,1
58815_0,,,,2,2,1,3
C(CCC(C=C[CH]C(O)=O)O)(O)=O,,,5,1,1,0,1
58817_0,,,,2,2,1,3
C(CC(C)C(C=C[CH]C(O)=O)O)=O,,,5,1,1,0,1
58819_0,,,,2,2,1,3
C(CO)=C[C](C(O)=O)C[CH]C(O)=O,,,5,1,1,0,1
58821_0,,,,2,2,1,3
C(CC[C](C(O)=O)C=CCO)(O)=O,,,5,1,1,0,1
58823_0,,,,2,2,1,3
C(CC([C](C(O)=O)C=CCO)C)=O,,,5,1,1,0,1
58825_0,,,,2,2,1,3
[CH](C(O)=O)C(CO)CC(C(O)=O)=O,,,5,1,1,0,1
58827_0,,,,2,2,1,3
C(C(CO)C([CH]C(O)=O)CO)(O)=O,,,5,1,1,0,1
58828_0,,,,2,2,1,3
58830_0,,,,2,2,1,3
[CH](C(O)=O)C(CO)C[CH]C(O)=O,,,5,1,2,0,2
58831_0,,,,2,2,1,3
58833_0,,,,2,2,1,3
[CH](C(O)=O)C(C(C)O)C[CH]C(O)=O,,,5,1,2,0,2
58834_0,,,,2,2,1,3
58836_0,,,,2,2,1,3
C(CC(CO)C[CH]C(O)=O)(O)=O,,,5,1,2,0,2
58837_0,,,,2,2,1,3
58839_0,,,,2,2,1,3
C(CC(C(C)O)C[CH]C(O)=O)(O)=O,,,5,1,2,0,2
58840_0,,,,2,2,1,3
58841_0,,,,2,2,1,3
58842_0,,,,2,2,1,3
58844_0,,,,2,2,1,3
C(C(CC(C)O)C[CH]C(O)=O)(O)=O,,,5,1,2,0,2
58846_0,,,,2,2,1,3
C(CC([CH]C(O)=O)C(C(O)=O)C)=O,,,5,1,1,0,1
58847_0,,,,2,2,1,3
58849_0,,,,2,2,1,3
C(C(C)C([CH]C(O)=O)CCO)(O)=O,,,5,1,1,0,1
58851_0,,,,2,2,1,3
C(C(C)C([CH]C(O)=O)C(C)O)(O)=O,,,5,1,1,0,1
58853_0,,,,2,2,1,3
C(CC=CC(C[CH]C(O)=O)O)(O)=O,,,5,1,1,0,1
58855_0,,,,2,2,1,3
C(CCC(C=CCC(O)=O)O)(O)=O,,,5,1,1,0,1
58857_0,,,,2,2,1,3
C(CC(C)C(C=CCC(O)=O)O)=O,,,5,1,1,0,1
58859_0,,,,2,2,1,3
C(C(C=CCO)C[CH]C(O)=O)(O)=O,,,5,1,1,0,1
58861_0,,,,2,2,1,3
C(CCC(C(O)=O)C=CCO)(O)=O,,,5,1,1,0,1
58863_0,,,,2,2,1,3
C(CC(C)C(C(O)=O)C=CCO)=O,,,5,1,1,0,1
58865_0,,,,2,2,1,3
C(C(CO)C(CO)CC(O)=O)(O)=O,,,5,1,1,0,1
58866_0,,,,2,2,1,3
58868_0,,,,2,2,1,3
C(CCC([CH]C(O)=O)CO)(O)=O,,,5,1,2,0,2
58869_0,,,,2,2,1,3
58871_0,,,,2,2,1,3
C(CCC([CH]C(O)=O)C(C)O)(O)=O,,,5,1,2,0,2
58872_0,,,,2,2,1,3
58874_0,,,,2,2,1,3
C(CCC(CO)CC(O)=O)(O)=O,,,5,1,2,0,2
58875_0,,,,2,2,1,3
58877_0,,,,2,2,1,3
C(CCC(C(C)O)CC(O)=O)(O)=O,,,5,1,2,0,2
58878_0,,,,2,2,1,3
58879_0,,,,2,2,1,3
58880_0,,,,2,2,1,3
58882_0,,,,2,2,1,3
C(C(CCC(O)=O)CC(C)O)(O)=O,,,5,1,2,0,2
58884_0,,,,2,2,1,3
C(CC(CC(O)=O)C(C(O)=O)C)=O,,,5,1,1,0,1
58885_0,,,,2,2,1,3
58887_0,,,,2,2,1,3
C(C(C)C(CCO)CC(O)=O)(O)=O,,,5,1,1,0,1
58889_0,,,,2,2,1,3
C(C(C)C(C(C)O)CC(O)=O)(O)=O,,,5,1,1,0,1
58891_0,,,,2,2,1,3
[C](C(O)=O)=CC(CC[CH]C(O)=O)O,,,5,1,1,0,1
58893_0,,,,2,2,1,3
[C](C(O)=O)=CC(CCCC(O)=O)O,,,5,1,1,0,1
58895_0,,,,2,2,1,3
[C](C(O)=O)=CC(CC(C)CC=O)O,,,5,1,1,0,1
58897_0,,,,2,2,1,3
[C](C(O)=O)=CC(C)(C[CH]C(O)=O)O,,,5,1,1,0,1
58899_0,,,,2,2,1,3
[C](C(O)=O)=CC(C)(CCC(O)=O)O,,,5,1,1,0,1
58901_0,,,,2,2,1,3
[C](C(O)=O)=CC(C)(C(C)CC=O)O,,,5,1,1,0,1
58903_0,,,,2,2,1,3
[CH](C(O)=O)C([CH]C(O)=O)C(C)O,,,5,1,1,0,1
58905_0,,,,2,2,1,3
C(C(C([CH]C(O)=O)C(C)O)(O)O)=O,,,5,1,1,0,1
58907_0,,,,2,2,1,3
C(CC([CH]C(O)=O)C(C)O)=O,,,5,1,1,0,1
58908_0,,,,2,2,1,3
58910_0,,,,2,2,1,3
C(C(C([CH]C(O)=O)C(C)O)O)(O)=O,,,5,1,1,0,1
58912_0,,,,2,2,1,3
[CH](C(O)=O)C(C(CO)O)C(C)O,,,5,1,1,0,1
58914_0,,,,2,2,1,3
C(C(CO)C([CH]C(O)=O)C(C)O)=O,,,5,1,1,0,1
58916_0,,,,2,2,1,3
C(CC(C([CH]C(O)=O)C(C)O)O)=O,,,5,1,1,0,1
58918_0,,,,2,2,1,3
C(CC([CH]C(O)=O)C(C)O)(CO)=O,,,5,1,1,0,1
58920_0,,,,2,2,1,3
C(C(C([CH]C(O)=O)C(C)O)O)(C)=O,,,5,1,1,0,1
58922_0,,,,2,2,1,3
[CH](C(O)=O)C(CO)C(C)O,,,5,1,1,0,1
58924_0,,,,2,2,1,3
[CH](C(O)=O)C(CCO)C(C)O,,,5,1,1,0,1
58926_0,,,,2,2,1,3
[CH](C(O)=O)C(C(C)O)C(C)O,,,5,1,1,0,1
58927_0,,,,2,2,1,3
58929_0,,,,2,2,1,3
C(CC([CH]C(O)=O)C(C)O)=CC=O,,,5,1,1,0,1
58931_0,,,,2,2,1,3
C(C(C=C)C([CH]C(O)=O)C(C)O)=O,,,5,1,1,0,1
58933_0,,,,2,2,1,3
C(C(C([CH]C(O)=O)C(C)O)O)=O,,,5,1,1,0,1
58935_0,,,,2,2,1,3
C(C(CC([CH]C(O)=O)C(C)O)O)=O,,,5,1,1,0,1
58937_0,,,,2,2,1,3
C(C(C)(C([CH]C(O)=O)C(C)O)O)=O,,,5,1,1,0,1
58939_0,,,,2,2,1,3
C(CC[CH]C(O)=O)=C[C](C(O)=O)O,,,5,1,2,0,2
58941_0,,,,2,2,1,3
C(CCCC=C[C](C(O)=O)O)(O)=O,,,5,1,2,0,2
58943_0,,,,2,2,1,3
C(CC(C)CC=C[C](C(O)=O)O)=O,,,5,1,2,0,2
58945_0,,,,2,2,1,3
C=CC([C](C(O)=O)O)C[CH]C(O)=O,,,5,1,2,0,2
58947_0,,,,2,2,1,3
C(CCC(C=C)[C](C(O)=O)O)(O)=O,,,5,1,2,0,2
58949_0,,,,2,2,1,3
C(CC(C)C(C=C)[C](C(O)=O)O)=O,,,5,1,2,0,2
58951_0,,,,2,2,1,3
C(C([CH]C(O)=O)[CH]C(O)=O)(O)=O,,,5,1,1,0,1
58953_0,,,,2,2,1,3
C(C([CH]C(O)=O)C(C=O)(O)O)(O)=O,,,5,1,1,0,1
58955_0,,,,2,2,1,3
C(C([CH]C(O)=O)CC=O)(O)=O,,,5,1,1,0,1
58957_0,,,,2,2,1,3
C(C([CH]C(O)=O)CC(C=O)=O)(O)=O,,,5,1,1,0,1
58959_0,,,,2,2,1,3
C(C([CH]C(O)=O)C(C(O)=O)O)(O)=O,,,5,1,1,0,1
58961_0,,,,2,2,1,3
C(C([CH]C(O)=O)C(CO)O)(O)=O,,,5,1,1,0,1
58963_0,,,,2,2,1,3
C(C([CH]C(O)=O)C(C=O)CO)(O)=O,,,5,1,1,0,1
58965_0,,,,2,2,1,3
C(C([CH]C(O)=O)C(CC=O)O)(O)=O,,,5,1,1,0,1
58967_0,,,,2,2,1,3
C(C([CH]C(O)=O)CC(CO)=O)(O)=O,,,5,1,1,0,1
58969_0,,,,2,2,1,3
C(C([CH]C(O)=O)C(C(C)=O)O)(O)=O,,,5,1,1,0,1
58971_0,,,,2,2,1,3
C(C([CH]C(O)=O)CO)(O)=O,,,5,1,1,0,1
58973_0,,,,2,2,1,3
C(C([CH]C(O)=O)CCO)(O)=O,,,5,1,1,0,1
58975_0,,,,2,2,1,3
C(C([CH]C(O)=O)C(C)O)(O)=O,,,5,1,1,0,1
58977_0,,,,2,2,1,3
C(C([CH]C(O)=O)CC(O)=O)(O)=O,,,5,1,2,0,2
58979_0,,,,2,2,1,3
C(C([CH]C(O)=O)CC=CC=O)(O)=O,,,5,1,1,0,1
58981_0,,,,2,2,1,3
C(C(C=C)C(C(O)=O)[CH]C(O)=O)=O,,,5,1,1,0,1
58983_0,,,,2,2,1,3
C(C([CH]C(O)=O)C(C=O)O)(O)=O,,,5,1,1,0,1
58985_0,,,,2,2,1,3
C(C([CH]C(O)=O)CC(C=O)O)(O)=O,,,5,1,1,0,1
58987_0,,,,2,2,1,3
C(C([CH]C(O)=O)C(C=O)(C)O)(O)=O,,,5,1,1,0,1
58989_0,,,,2,2,1,3
C(C[C](C(O)=O)[CH]C(O)=O)(O)=O,,,5,1,1,0,1
58991_0,,,,2,2,1,3
C(C[C](C(O)=O)C(C=O)(O)O)(O)=O,,,5,1,1,0,1
58993_0,,,,2,2,1,3
C(C[C](C(O)=O)CC(O)=O)=O,,,5,1,1,0,1
58995_0,,,,2,2,1,3
C(C[C](C(O)=O)CC(C=O)=O)(O)=O,,,5,1,1,0,1
58997_0,,,,2,2,1,3
C(C[C](C(O)=O)C(C(O)=O)O)(O)=O,,,5,1,1,0,1
58999_0,,,,2,2,1,3
C(C[C](C(O)=O)C(CO)O)(O)=O,,,5,1,1,0,1
59001_0,,,,2,2,1,3
C(C([C](C(O)=O)CC(O)=O)CO)=O,,,5,1,1,0,1
59003_0,,,,2,2,1,3
C(C[C](C(O)=O)C(CC=O)O)(O)=O,,,5,1,1,0,1
59005_0,,,,2,2,1,3
C(C[C](C(O)=O)CC(CO)=O)(O)=O,,,5,1,1,0,1
59007_0,,,,2,2,1,3
C(C[C](C(O)=O)C(C(C)=O)O)(O)=O,,,5,1,1,0,1
59009_0,,,,2,2,1,3
C(C[C](C(O)=O)CO)(O)=O,,,5,1,1,0,1
59011_0,,,,2,2,1,3
C(C[C](C(O)=O)CCO)(O)=O,,,5,1,1,0,1
59013_0,,,,2,2,1,3
C(C[C](C(O)=O)C(C)O)(O)=O,,,5,1,1,0,1
59015_0,,,,2,2,1,3
C(C[C](C(O)=O)CC(O)=O)(O)=O,,,5,1,1,0,1
59017_0,,,,2,2,1,3
C(C[C](C(O)=O)CC=CC=O)(O)=O,,,5,1,1,0,1
59019_0,,,,2,2,1,3
C(C(C=C)[C](C(O)=O)CC(O)=O)=O,,,5,1,1,0,1
59021_0,,,,2,2,1,3
C(C[C](C(O)=O)C(C=O)O)(O)=O,,,5,1,1,0,1
59023_0,,,,2,2,1,3
C(C[C](C(O)=O)CC(C=O)O)(O)=O,,,5,1,1,0,1
59025_0,,,,2,2,1,3
C(C([C](C(O)=O)CC(O)=O)(C)O)=O,,,5,1,1,0,1
59027_0,,,,2,2,1,3
C(C(CC[CH]C(O)=O)O)=CC(O)=O,,,5,1,1,0,1
59029_0,,,,2,2,1,3
C(CCCC(C=CC(O)=O)O)(O)=O,,,5,1,1,0,1
59031_0,,,,2,2,1,3
C(CC(C)CC(C=CC(O)=O)O)=O,,,5,1,1,0,1
59033_0,,,,2,2,1,3
C(C(C)(C[CH]C(O)=O)O)=CC(O)=O,,,5,1,1,0,1
59035_0,,,,2,2,1,3
C(CCC(C=CC(O)=O)(C)O)(O)=O,,,5,1,1,0,1
59037_0,,,,2,2,1,3
C(CC(C)C(C=CC(O)=O)(C)O)=O,,,5,1,1,0,1
59038_0,,,,2,2,1,3
59040_0,,,,2,2,1,3
C(CC(C(C)O)C(C=O)(O)O)(O)=O,,,5,1,1,0,1
59041_0,,,,2,2,1,3
59042_0,,,,2,2,1,3
59043_0,,,,2,2,1,3
59045_0,,,,2,2,1,3
C(CC(C(CO)O)C(C)O)(O)=O,,,5,1,1,0,1
59047_0,,,,2,2,1,3
C(C(CO)C(C(C)O)CC(O)=O)=O,,,5,1,1,0,1
59049_0,,,,2,2,1,3
C(CC(C(CC=O)O)C(C)O)(O)=O,,,5,1,1,0,1
59051_0,,,,2,2,1,3
C(CC(C(C)O)CC(CO)=O)(O)=O,,,5,1,1,0,1
59053_0,,,,2,2,1,3
C(CC(C(C)O)C(C(C)=O)O)(O)=O,,,5,1,1,0,1
59055_0,,,,2,2,1,3
C(CC(CO)C(C)O)(O)=O,,,5,1,1,0,1
59057_0,,,,2,2,1,3
C(CC(CCO)C(C)O)(O)=O,,,5,1,1,0,1
59059_0,,,,2,2,1,3
C(CC(C(C)O)C(C)O)(O)=O,,,5,1,1,0,1
59060_0,,,,2,2,1,3
59062_0,,,,2,2,1,3
C(CC(C(C)O)CC=CC=O)(O)=O,,,5,1,1,0,1
59064_0,,,,2,2,1,3
C(C(C=C)C(C(C)O)CC(O)=O)=O,,,5,1,1,0,1
59066_0,,,,2,2,1,3
C(CC(C(C)O)C(C=O)O)(O)=O,,,5,1,1,0,1
59068_0,,,,2,2,1,3
C(CC(CC(C=O)O)C(C)O)(O)=O,,,5,1,1,0,1
59070_0,,,,2,2,1,3
C(C(C)(C(C(C)O)CC(O)=O)O)=O,,,5,1,1,0,1
59072_0,,,,2,2,1,3
C(C(C=CC)(C[CH]C(O)=O)O)(O)=O,,,5,1,1,0,1
59074_0,,,,2,2,1,3
C(CCC(C(O)=O)(C=CC)O)(O)=O,,,5,1,1,0,1
59076_0,,,,2,2,1,3
C(CC(C)C(C(O)=O)(C=CC)O)=O,,,5,1,1,0,1
59078_0,,,,2,2,1,3
C(C(C=CCC[CH]C(O)=O)O)(O)=O,,,5,1,2,0,2
59080_0,,,,2,2,1,3
C(C(C=CCCCC(O)=O)O)(O)=O,,,5,1,2,0,2
59082_0,,,,2,2,1,3
C(C(C=CCC(C)CC=O)O)(O)=O,,,5,1,2,0,2
59084_0,,,,2,2,1,3
C(C(C(C=C)C[CH]C(O)=O)O)(O)=O,,,5,1,2,0,2
59086_0,,,,2,2,1,3
C(CCC(C=C)C(C(O)=O)O)(O)=O,,,5,1,2,0,2
59088_0,,,,2,2,1,3
C(CC(C)C(C=C)C(C(O)=O)O)=O,,,5,1,2,0,2
59090_0,,,,2,2,1,3
C(C(C[CH]C(O)=O)(CC=C)O)(O)=O,,,5,1,1,0,1
59092_0,,,,2,2,1,3
C(CCC(C(O)=O)(CC=C)O)(O)=O,,,5,1,1,0,1
59094_0,,,,2,2,1,3
C(C(C(C)CC=O)(CC=C)O)(O)=O,,,5,1,1,0,1
59095_0,,,,2,2,1,3
59097_0,,,,2,2,1,3
C(CC(C(O)=O)C(C=O)(O)O)(O)=O,,,5,1,1,0,1
59099_0,,,,2,2,1,3
C(CC(C(O)=O)CC(O)=O)=O,,,5,1,1,0,1
59101_0,,,,2,2,1,3
C(CC(C(O)=O)CC(C=O)=O)(O)=O,,,5,1,1,0,1
59103_0,,,,2,2,1,3
C(CC(C(O)=O)C(C(O)=O)O)(O)=O,,,5,1,1,0,1
59105_0,,,,2,2,1,3
C(C(C(CO)O)CC(O)=O)(O)=O,,,5,1,1,0,1
59106_0,,,,2,2,1,3
59108_0,,,,2,2,1,3
C(C(C(CC=O)O)CC(O)=O)(O)=O,,,5,1,1,0,1
59110_0,,,,2,2,1,3
C(CC(C(O)=O)CC(CO)=O)(O)=O,,,5,1,1,0,1
59112_0,,,,2,2,1,3
C(CC(C(O)=O)C(C(C)=O)O)(O)=O,,,5,1,1,0,1
59113_0,,,,2,2,1,3
59114_0,,,,2,2,1,3
59116_0,,,,2,2,1,3
C(C(C(C)O)CC(O)=O)(O)=O,,,5,1,1,0,1
59118_0,,,,2,2,1,3
C(CC(C(O)=O)CC(O)=O)(O)=O,,,5,1,1,0,1
59120_0,,,,2,2,1,3
C(CC(C(O)=O)CC=CC=O)(O)=O,,,5,1,1,0,1
59122_0,,,,2,2,1,3
C(C(C=C)C(C(O)=O)CC(O)=O)=O,,,5,1,1,0,1
59123_0,,,,2,2,1,3
59124_0,,,,2,2,1,3
59126_0,,,,2,2,1,3
C(CC(C(O)=O)C(C=O)(C)O)(O)=O,,,5,1,1,0,1
59127_0,,,,2,2,1,3
59128_0,,,,2,2,1,3
59130_0,,,,2,2,1,3
C(C(CC)(C(C)CC=O)O)=O,,,5,1,1,0,1
59131_0,,,,2,2,1,3
59132_0,,,,2,2,1,3
59133_0,,,,2,2,1,3
59134_0,,,,2,2,1,3
59135_0,,,,2,2,1,3
59137_0,,,,2,2,1,3
C(CC(C)C(C)C(C=O)O)=O,,,5,1,1,0,1
59138_0,,,,2,2,1,3
59139_0,,,,2,2,1,3
59140_0,,,,2,2,1,3
59141_0,,,,2,2,1,3
59142_0,,,,2,2,1,3
59143_0,,,,2,2,1,3
59144_0,,,,2,2,1,3
59145_0,,,,2,2,1,3
59147_0,,,,2,2,1,3
C(CC(C)C(CO)CC=O)=O,,,5,1,1,0,1
59148_0,,,,2,2,1,3
59149_0,,,,2,2,1,3
59150_0,,,,2,2,1,3
59151_0,,,,2,2,1,3
59152_0,,,,2,2,1,3
59153_0,,,,2,2,1,3
59155_0,,,,2,2,1,3
C1(C(C[CH]C(O)=O)(O)OCC1O)=O,,,5,1,1,0,1
59157_0,,,,2,2,1,3
C(CCC1(C(C(CO1)O)=O)O)(O)=O,,,5,1,1,0,1
59159_0,,,,2,2,1,3
C(CC(C)C1(C(C(CO1)O)=O)O)=O,,,5,1,1,0,1
59160_0,,,,2,2,1,3
59161_0,,,,2,2,1,3
59162_0,,,,2,2,1,3
59163_0,,,,2,2,1,3
59164_0,,,,2,2,1,3
59165_0,,,,2,2,1,3
59167_0,,,,2,2,1,3
C1(C(C[CH]C(O)=O)(O)OCC1)=O,,,5,1,1,0,1
59169_0,,,,2,2,1,3
C(CCC1(C(CCO1)=O)O)(O)=O,,,5,1,1,0,1
59171_0,,,,2,2,1,3
C(CC(C)C1(C(CCO1)=O)O)=O,,,5,1,1,0,1
59172_0,,,,2,2,1,3
59173_0,,,,2,2,1,3
59174_0,,,,2,2,1,3
59175_0,,,,2,2,1,3
59176_0,,,,2,2,1,3
59177_0,,,,2,2,1,3
59178_0,,,,2,2,1,3
59179_0,,,,2,2,1,3
59180_0,,,,2,2,1,3
59182_0,,,,2,2,1,3
C1(C(C[CH]C(O)=O)(O)OC(C)C1)=O,,,5,1,1,0,1
59184_0,,,,2,2,1,3
C(CCC1(C(CC(C)O1)=O)O)(O)=O,,,5,1,1,0,1
59186_0,,,,2,2,1,3
C(CC(C)C1(C(CC(C)O1)=O)O)=O,,,5,1,1,0,1
59187_0,,,,2,2,1,3
59188_0,,,,2,2,1,3
59189_0,,,,2,2,1,3
59191_0,,,,2,2,1,3
C1(CC(C(C[CH]C(O)=O)(O)O1)=O)=O,,,5,1,1,0,1
59193_0,,,,2,2,1,3
C(CCC1(C(CC(O1)=O)=O)O)(O)=O,,,5,1,1,0,1
59195_0,,,,2,2,1,3
C(CC(C)C1(C(CC(O1)=O)=O)O)=O,,,5,1,1,0,1
59196_0,,,,2,2,1,3
59197_0,,,,2,2,1,3
59198_0,,,,2,2,1,3
59200_0,,,,2,2,1,3
[CH](C(O)=O)CC1(CC[CH]C(O1)=O)O,,,5,1,1,0,1
59202_0,,,,2,2,1,3
C(CCC1(CC[CH]C(O1)=O)O)(O)=O,,,5,1,1,0,1
59204_0,,,,2,2,1,3
C(CC(C)C1(CC[CH]C(O1)=O)O)=O,,,5,1,1,0,1
59205_0,,,,2,2,1,3
59206_0,,,,2,2,1,3
59207_0,,,,2,2,1,3
59208_0,,,,2,2,1,3
59209_0,,,,2,2,1,3
59210_0,,,,2,2,1,3
59211_0,,,,2,2,1,3
59212_0,,,,2,2,1,3
59213_0,,,,2,2,1,3
59215_0,,,,2,2,1,3
C1(CCCC(C[CH]C(O)=O)(O)O1)=O,,,5,1,1,0,1
59217_0,,,,2,2,1,3
C1(CCCC(CCC(O)=O)(O)O1)=O,,,5,1,1,0,1
59219_0,,,,2,2,1,3
C1(CCCC(C(C)CC=O)(O)O1)=O,,,5,1,1,0,1
59220_0,,,,2,2,1,3
59221_0,,,,2,2,1,3
59222_0,,,,2,2,1,3
59223_0,,,,2,2,1,3
59224_0,,,,2,2,1,3
59225_0,,,,2,2,1,3
59227_0,,,,2,2,1,3
[CH](C(O)=O)CC1(C(C(OC1)=O)=O)O,,,5,1,1,0,1
59229_0,,,,2,2,1,3
C(CCC1(C(C(OC1)=O)=O)O)(O)=O,,,5,1,1,0,1
59231_0,,,,2,2,1,3
C(CC(C)C1(C(C(OC1)=O)=O)O)=O,,,5,1,1,0,1
59233_0,,,,2,2,1,3
[CH](C(O)=O)CC1C(C(C(O1)=O)=O)O,,,5,1,1,0,1
59235_0,,,,2,2,1,3
C(CCC1C(C(C(O1)=O)=O)O)(O)=O,,,5,1,1,0,1
59237_0,,,,2,2,1,3
C(CC(C)C1C(C(C(O1)=O)=O)O)=O,,,5,1,1,0,1
59238_0,,,,2,2,1,3
59239_0,,,,2,2,1,3
59240_0,,,,2,2,1,3
59241_0,,,,2,2,1,3
59242_0,,,,2,2,1,3
59243_0,,,,2,2,1,3
59245_0,,,,2,2,1,3
C1(C(C(C(C[CH]C(O)=O)O1)=O)=O)=O,,,5,1,1,0,1
59247_0,,,,2,2,1,3
C(CCC1C(C(C(O1)=O)=O)=O)(O)=O,,,5,1,1,0,1
59249_0,,,,2,2,1,3
C(CC(C)C1C(C(C(O1)=O)=O)=O)=O,,,5,1,1,0,1
59251_0,,,,2,2,1,3
C1(C(CC[CH]C(O)=O)(CCO1)O)=O,,,5,1,1,0,1
59253_0,,,,2,2,1,3
C1(C(CCO1)(CCCC(O)=O)O)=O,,,5,1,1,0,1
59255_0,,,,2,2,1,3
C1(C(CCO1)(CC(C)CC=O)O)=O,,,5,1,1,0,1
59257_0,,,,2,2,1,3
C1(C(C)(C(CO1)C[CH]C(O)=O)O)=O,,,5,1,1,0,1
59259_0,,,,2,2,1,3
C1(C(C)(C(CO1)CCC(O)=O)O)=O,,,5,1,1,0,1
59261_0,,,,2,2,1,3
C1(C(C)(C(CO1)C(C)CC=O)O)=O,,,5,1,1,0,1
59263_0,,,,2,2,1,3
C1(C(C)(CC(C[CH]C(O)=O)O1)O)=O,,,5,1,1,0,1
59265_0,,,,2,2,1,3
C1(C(C)(CC(CCC(O)=O)O1)O)=O,,,5,1,1,0,1
59267_0,,,,2,2,1,3
C1(C(C)(CC(C(C)CC=O)O1)O)=O,,,5,1,1,0,1
59269_0,,,,2,2,1,3
C(CC(C)C1[CH]C(OC1C(O)=O)=O)=O,,,5,1,1,0,1
59271_0,,,,2,2,1,3
C(CC([C]1C(OC(C(O)=O)C1)=O)C)=O,,,5,1,1,0,1
59273_0,,,,2,2,1,3
C(C1(C(C)CC=O)C[CH]C(O1)=O)(O)=O,,,5,1,1,0,1
59275_0,,,,2,2,1,3
[CH](C(O)=O)CC1(CO)C[CH]C(O1)=O,,,5,1,1,0,1
59277_0,,,,2,2,1,3
C(CCC1(CO)C[CH]C(O1)=O)(O)=O,,,5,1,1,0,1
59279_0,,,,2,2,1,3
C(CC(C)C1(CO)C[CH]C(O1)=O)=O,,,5,1,1,0,1
59281_0,,,,2,2,1,3
[CH](C(O)=O)CC(C1C[CH]C(O1)=O)O,,,5,1,1,0,1
59283_0,,,,2,2,1,3
C(CCC(C1C[CH]C(O1)=O)O)(O)=O,,,5,1,1,0,1
59285_0,,,,2,2,1,3
C(CC(C)C(C1C[CH]C(O1)=O)O)=O,,,5,1,1,0,1
59287_0,,,,2,2,1,3
[CH]1C(OC(CO)C1C[CH]C(O)=O)=O,,,5,1,1,0,1
59289_0,,,,2,2,1,3
C(CCC1[CH]C(OC1CO)=O)(O)=O,,,5,1,1,0,1
59291_0,,,,2,2,1,3
C(CC(C)C1[CH]C(OC1CO)=O)=O,,,5,1,1,0,1
59293_0,,,,2,2,1,3
[CH](C(O)=O)C[C]1C(OC(CO)C1)=O,,,5,1,1,0,1
59295_0,,,,2,2,1,3
C(CC[C]1C(OC(CO)C1)=O)(O)=O,,,5,1,1,0,1
59297_0,,,,2,2,1,3
C(CC([C]1C(OC(CO)C1)=O)C)=O,,,5,1,1,0,1
59299_0,,,,2,2,1,3
C1(CCC(CO)(C[CH]C(O)=O)O1)=O,,,5,1,1,0,1
59301_0,,,,2,2,1,3
C1(CCC(CCC(O)=O)(CO)O1)=O,,,5,1,1,0,1
59303_0,,,,2,2,1,3
C1(CCC(CO)(C(C)CC=O)O1)=O,,,5,1,1,0,1
59305_0,,,,2,2,1,3
C1(CCC(C(C[CH]C(O)=O)O)O1)=O,,,5,1,1,0,1
59307_0,,,,2,2,1,3
C1(CCC(C(CCC(O)=O)O)O1)=O,,,5,1,1,0,1
59309_0,,,,2,2,1,3
C1(CCC(C(C(C)CC=O)O)O1)=O,,,5,1,1,0,1
59311_0,,,,2,2,1,3
C1(CC(C(CO)O1)C[CH]C(O)=O)=O,,,5,1,1,0,1
59313_0,,,,2,2,1,3
C1(CC(CCC(O)=O)C(CO)O1)=O,,,5,1,1,0,1
59315_0,,,,2,2,1,3
C1(CC(C(CO)O1)C(C)CC=O)=O,,,5,1,1,0,1
59317_0,,,,2,2,1,3
C1(C(CC(CO)O1)C[CH]C(O)=O)=O,,,5,1,1,0,1
59319_0,,,,2,2,1,3
C1(C(CCC(O)=O)CC(CO)O1)=O,,,5,1,1,0,1
59321_0,,,,2,2,1,3
C1(C(CC(CO)O1)C(C)CC=O)=O,,,5,1,1,0,1
59323_0,,,,2,2,1,3
[CH](C(O)=O)CC1[C](C(OC1C)=O)O,,,5,1,1,0,1
59325_0,,,,2,2,1,3
C(CCC1[C](C(OC1C)=O)O)(O)=O,,,5,1,1,0,1
59327_0,,,,2,2,1,3
C(CC(C)C1[C](C(OC1C)=O)O)=O,,,5,1,1,0,1
59329_0,,,,2,2,1,3
[CH](C(O)=O)CCC1C[C](C(O1)=O)O,,,5,1,1,0,1
59331_0,,,,2,2,1,3
C(CCCC1C[C](C(O1)=O)O)(O)=O,,,5,1,1,0,1
59333_0,,,,2,2,1,3
C(CC(C)CC1C[C](C(O1)=O)O)=O,,,5,1,1,0,1
59335_0,,,,2,2,1,3
[CH](C(O)=O)CC1(C)C[C](C(O1)=O)O,,,5,1,1,0,1
59337_0,,,,2,2,1,3
C(CCC1(C)C[C](C(O1)=O)O)(O)=O,,,5,1,1,0,1
59339_0,,,,2,2,1,3
C(CC(C)C1(C)C[C](C(O1)=O)O)=O,,,5,1,1,0,1
59341_0,,,,2,2,1,3
C1(C([C](C(O1)=O)O)C[CH]C(O)=O)=O,,,5,1,1,0,1
59343_0,,,,2,2,1,3
C1(C([C](C(O1)=O)O)CCC(O)=O)=O,,,5,1,1,0,1
59345_0,,,,2,2,1,3
C1(C([C](C(O1)=O)O)C(C)CC=O)=O,,,5,1,1,0,1
59347_0,,,,2,2,1,3
C1(C(C(C(C)O1)C[CH]C(O)=O)O)=O,,,5,1,1,0,1
59349_0,,,,2,2,1,3
C(CCC1C(C)OC(C1O)=O)(O)=O,,,5,1,1,0,1
59351_0,,,,2,2,1,3
C(CC(C)C1C(C)OC(C1O)=O)=O,,,5,1,1,0,1
59353_0,,,,2,2,1,3
C1(C(CC(C)O1)(C[CH]C(O)=O)O)=O,,,5,1,1,0,1
59355_0,,,,2,2,1,3
C1(C(CCC(O)=O)(CC(C)O1)O)=O,,,5,1,1,0,1
59357_0,,,,2,2,1,3
C1(C(CC(C)O1)(C(C)CC=O)O)=O,,,5,1,1,0,1
59359_0,,,,2,2,1,3
C1(C(CC(CC[CH]C(O)=O)O1)O)=O,,,5,1,1,0,1
59361_0,,,,2,2,1,3
C(CCCC1CC(C(O1)=O)O)(O)=O,,,5,1,1,0,1
59363_0,,,,2,2,1,3
C(CC(C)CC1CC(C(O1)=O)O)=O,,,5,1,1,0,1
59365_0,,,,2,2,1,3
C1(C(CC(C)(C[CH]C(O)=O)O1)O)=O,,,5,1,1,0,1
59367_0,,,,2,2,1,3
C(CCC1(C)CC(C(O1)=O)O)(O)=O,,,5,1,1,0,1
59369_0,,,,2,2,1,3
C(CC(C)C1(C)CC(C(O1)=O)O)=O,,,5,1,1,0,1
59371_0,,,,2,2,1,3
C1(C(C(C(O1)=O)C[CH]C(O)=O)O)=O,,,5,1,1,0,1
59373_0,,,,2,2,1,3
C1(C(CCC(O)=O)C(C(O1)=O)O)=O,,,5,1,1,0,1
59375_0,,,,2,2,1,3
C1(C(C(C)CC=O)C(C(O1)=O)O)=O,,,5,1,1,0,1
59377_0,,,,2,2,1,3
C1(CC(C(O1)=O)(C[CH]C(O)=O)O)=O,,,5,1,1,0,1
59379_0,,,,2,2,1,3
C1(C(CCC(O)=O)(CC(O1)=O)O)=O,,,5,1,1,0,1
59381_0,,,,2,2,1,3
C1(C(C(C)CC=O)(CC(O1)=O)O)=O,,,5,1,1,0,1
59383_0,,,,2,2,1,3
C(CC(C)C1[CH]C(OC(C1O)=O)=O)=O,,,5,1,1,0,1
59385_0,,,,2,2,1,3
C(CC([C]1C(OC(C(C1)O)=O)=O)C)=O,,,5,1,1,0,1
59387_0,,,,2,2,1,3
C1(C(C(C)CC=O)(C[CH]C(O1)=O)O)=O,,,5,1,1,0,1
59389_0,,,,2,2,1,3
[CH](C(O)=O)CC1(COC([CH]C1)=O)O,,,5,1,1,0,1
59391_0,,,,2,2,1,3
C(CCC1(COC([CH]C1)=O)O)(O)=O,,,5,1,1,0,1
59393_0,,,,2,2,1,3
C(CC(C)C1(COC([CH]C1)=O)O)=O,,,5,1,1,0,1
59395_0,,,,2,2,1,3
[CH](C(O)=O)CC1C(C[CH]C(O1)=O)O,,,5,1,1,0,1
59397_0,,,,2,2,1,3
C(CCC1C(C[CH]C(O1)=O)O)(O)=O,,,5,1,1,0,1
59399_0,,,,2,2,1,3
C(CC(C)C1C(C[CH]C(O1)=O)O)=O,,,5,1,1,0,1
59401_0,,,,2,2,1,3
[CH]1C(OCC(C1C[CH]C(O)=O)O)=O,,,5,1,1,0,1
59403_0,,,,2,2,1,3
C(CCC1[CH]C(OCC1O)=O)(O)=O,,,5,1,1,0,1
59405_0,,,,2,2,1,3
C(CC(C)C1[CH]C(OCC1O)=O)=O,,,5,1,1,0,1
59407_0,,,,2,2,1,3
[CH](C(O)=O)C[C]1C(OCC(C1)O)=O,,,5,1,1,0,1
59409_0,,,,2,2,1,3
C(CC[C]1C(OCC(C1)O)=O)(O)=O,,,5,1,1,0,1
59411_0,,,,2,2,1,3
C(CC([C]1C(OCC(C1)O)=O)C)=O,,,5,1,1,0,1
59413_0,,,,2,2,1,3
C1(CCC(CO1)(C[CH]C(O)=O)O)=O,,,5,1,1,0,1
59415_0,,,,2,2,1,3
C1(CCC(CO1)(CCC(O)=O)O)=O,,,5,1,1,0,1
59417_0,,,,2,2,1,3
C1(CCC(CO1)(C(C)CC=O)O)=O,,,5,1,1,0,1
59419_0,,,,2,2,1,3
C1(CCC(C(C[CH]C(O)=O)O1)O)=O,,,5,1,1,0,1
59421_0,,,,2,2,1,3
C1(CCC(C(CCC(O)=O)O1)O)=O,,,5,1,1,0,1
59423_0,,,,2,2,1,3
C1(CCC(C(C(C)CC=O)O1)O)=O,,,5,1,1,0,1
59425_0,,,,2,2,1,3
C1(CC(C(CO1)O)C[CH]C(O)=O)=O,,,5,1,1,0,1
59427_0,,,,2,2,1,3
C1(CC(CCC(O)=O)C(CO1)O)=O,,,5,1,1,0,1
59429_0,,,,2,2,1,3
C1(CC(C(C)CC=O)C(CO1)O)=O,,,5,1,1,0,1
59431_0,,,,2,2,1,3
C1(C(CC(CO1)O)C[CH]C(O)=O)=O,,,5,1,1,0,1
59433_0,,,,2,2,1,3
C1(C(CCC(O)=O)CC(CO1)O)=O,,,5,1,1,0,1
59435_0,,,,2,2,1,3
C1(C(CC(CO1)O)C(C)CC=O)=O,,,5,1,1,0,1
59436_0,,,,2,2,1,3
59437_0,,,,2,2,1,3
59439_0,,,,2,2,1,3
C(C(C(C)CC=O)C(C)CO)=O,,,5,1,1,0,1
59440_0,,,,2,2,1,3
59441_0,,,,2,2,1,3
59443_0,,,,2,2,1,3
C(CC(CO)CC(C)CC=O)=O,,,5,1,2,0,2
59444_0,,,,2,2,1,3
59445_0,,,,2,2,1,3
59447_0,,,,2,2,1,3
C(CC(C)(CO)C(C)CC=O)=O,,,5,1,1,0,1
59449_0,,,,2,2,1,3
C(CC(C)C(C[CH]C(O)=O)O)=O,,,5,1,2,0,2
59451_0,,,,2,2,1,3
C(CCC(C(C)CC=O)O)(O)=O,,,5,1,2,0,2
59453_0,,,,2,2,1,3
C(CC(C)C(C(C)CC=O)O)=O,,,5,1,1,0,1
59454_0,,,,2,2,1,3
59455_0,,,,2,2,1,3
59457_0,,,,2,2,1,3
C(CC(C)C([CH]C(O)=O)CO)=O,,,5,1,1,0,1
59459_0,,,,2,2,1,3
[CH](C(O)=O)C[C](C(O)=O)CCO,,,5,1,1,0,1
59461_0,,,,2,2,1,3
C(CC[C](C(O)=O)CCO)(O)=O,,,5,1,1,0,1
59463_0,,,,2,2,1,3
C(CC([C](C(O)=O)CCO)C)=O,,,5,1,1,0,1
59465_0,,,,2,2,1,3
[CH](C(O)=O)CC(C[CH]C(O)=O)O,,,5,1,1,0,1
59467_0,,,,2,2,1,3
C(CCC(C[CH]C(O)=O)O)(O)=O,,,5,1,2,0,2
59468_0,,,,2,2,1,3
59469_0,,,,2,2,1,3
59470_0,,,,2,2,1,3
59472_0,,,,2,2,1,3
C(CC(CO)C(C)CC=O)(O)=O,,,5,1,1,0,1
59473_0,,,,2,2,1,3
59474_0,,,,2,2,1,3
59476_0,,,,2,2,1,3
C(C(CCO)C(C)CC=O)(O)=O,,,5,1,1,0,1
59477_0,,,,2,2,1,3
59479_0,,,,2,2,1,3
C(CCC(CCC(O)=O)O)(O)=O,,,5,1,1,0,1
59480_0,,,,2,2,1,3
59481_0,,,,2,2,1,3
59482_0,,,,2,2,1,3
59484_0,,,,2,2,1,3
C(C(C(C)CC=O)C(C)CCO)=O,,,5,1,1,0,1
59485_0,,,,2,2,1,3
59486_0,,,,2,2,1,3
59488_0,,,,2,2,1,3
C(CC(C)CC(CCO)CC=O)=O,,,5,1,2,0,2
59489_0,,,,2,2,1,3
59490_0,,,,2,2,1,3
59492_0,,,,2,2,1,3
C(CC(C)C(C)(CCO)CC=O)=O,,,5,1,1,0,1
59493_0,,,,2,2,1,3
59494_0,,,,2,2,1,3
59496_0,,,,2,2,1,3
C(CC(C)C(CO)C(C)CC=O)=O,,,5,1,1,0,1
59498_0,,,,2,2,1,3
C(CC(C)CC(C[CH]C(O)=O)O)=O,,,5,1,2,0,2
59500_0,,,,2,2,1,3
C(CCC(CC(C)CC=O)O)(O)=O,,,5,1,2,0,2
59502_0,,,,2,2,1,3
C(CC(C)CC(C(C)CC=O)O)=O,,,5,1,2,0,2
59503_0,,,,2,2,1,3
59504_0,,,,2,2,1,3
59506_0,,,,2,2,1,3
C(C(C(C)CC=O)C(C)C(C)O)=O,,,5,1,1,0,1
59507_0,,,,2,2,1,3
59508_0,,,,2,2,1,3
59510_0,,,,2,2,1,3
C(CC(CC(C)CC=O)C(C)O)=O,,,5,1,2,0,2
59511_0,,,,2,2,1,3
59512_0,,,,2,2,1,3
59514_0,,,,2,2,1,3
C(CC(C)(C(C)CC=O)C(C)O)=O,,,5,1,1,0,1
59515_0,,,,2,2,1,3
59516_0,,,,2,2,1,3
59517_0,,,,2,2,1,3
59519_0,,,,2,2,1,3
C(CC(C)C(C)(C[CH]C(O)=O)O)=O,,,5,1,2,0,2
59521_0,,,,2,2,1,3
C(CCC(C)(C(C)CC=O)O)(O)=O,,,5,1,2,0,2
59523_0,,,,2,2,1,3
C(CC(C)C(C)(C(C)CC=O)O)=O,,,5,1,1,0,1
59524_0,,,,2,2,1,3
59525_0,,,,2,2,1,3
59527_0,,,,2,2,1,3
C(CC(C)C([CH]C(O)=O)C(C)O)=O,,,5,1,1,0,1
59529_0,,,,2,2,1,3
[CH](C(O)=O)C[C](C(O)=O)CC(C)O,,,5,1,1,0,1
59531_0,,,,2,2,1,3
C(CC[C](C(O)=O)CC(C)O)(O)=O,,,5,1,1,0,1
59533_0,,,,2,2,1,3
C(CC([C](C(O)=O)CC(C)O)C)=O,,,5,1,1,0,1
59534_0,,,,2,2,1,3
59535_0,,,,2,2,1,3
59536_0,,,,2,2,1,3
59538_0,,,,2,2,1,3
[CH](C(O)=O)CC(C)(C[CH]C(O)=O)O,,,5,1,1,0,1
59540_0,,,,2,2,1,3
C(CCC(C)(C[CH]C(O)=O)O)(O)=O,,,5,1,2,0,2
59541_0,,,,2,2,1,3
59542_0,,,,2,2,1,3
59543_0,,,,2,2,1,3
59545_0,,,,2,2,1,3
C(CC(C(C)CC=O)C(C)O)(O)=O,,,5,1,1,0,1
59546_0,,,,2,2,1,3
59547_0,,,,2,2,1,3
59549_0,,,,2,2,1,3
C(C(CC(C)O)C(C)CC=O)(O)=O,,,5,1,1,0,1
59550_0,,,,2,2,1,3
59551_0,,,,2,2,1,3
59552_0,,,,2,2,1,3
59553_0,,,,2,2,1,3
59555_0,,,,2,2,1,3
C(CCC(C)(CCC(O)=O)O)(O)=O,,,5,1,1,0,1
59556_0,,,,2,2,1,3
59558_0,,,,2,2,1,3
C(CC(C)CC([CH]C(O)=O)CC=O)=O,,,5,1,1,0,1
59560_0,,,,2,2,1,3
C(CC(CC(C)CC=O)CC=O)=O,,,5,1,2,0,2
59561_0,,,,2,2,1,3
59562_0,,,,2,2,1,3
59563_0,,,,2,2,1,3
59564_0,,,,2,2,1,3
59565_0,,,,2,2,1,3
59567_0,,,,2,2,1,3
C(C(C(C)CC=O)C(C)CC=O)=O,,,5,1,1,0,1
59568_0,,,,2,2,1,3
59569_0,,,,2,2,1,3
59570_0,,,,2,2,1,3
59571_0,,,,2,2,1,3
59572_0,,,,2,2,1,3
59574_0,,,,2,2,1,3
C(CC(C)(C(C)CC=O)CC=O)=O,,,5,1,1,0,1
59576_0,,,,2,2,1,3
C(CC(C(C(O)=O)=O)CC(O)=O)=O,,,5,1,1,0,1
59577_0,,,,2,2,1,3
59579_0,,,,2,2,1,3
C(CC(C(C(O)=O)=O)CCO)(O)=O,,,5,1,1,0,1
59580_0,,,,2,2,1,3
59582_0,,,,2,2,1,3
C(CC(C(O)=O)CC(C(O)=O)=O)=O,,,5,1,2,0,2
59583_0,,,,2,2,1,3
59584_0,,,,2,2,1,3
59586_0,,,,2,2,1,3
C(C(C(C)O)CC(C(O)=O)=O)(O)=O,,,5,1,2,0,2
59588_0,,,,2,2,1,3
C([CH]C[CH]C(O)=O)(O)=O,,,5,1,2,0,2
59589_0,,,,2,2,1,3
59591_0,,,,2,2,1,3
C(CC([CH]C(O)=O)C)=O,,,5,1,2,0,2
59593_0,,,,2,2,1,3
[CH](C(O)=O)C(C)CC(C(O)=O)=O,,,5,1,1,0,1
59594_0,,,,2,2,1,3
59596_0,,,,2,2,1,3
C(CC(C(O)=O)([CH]C(O)=O)C)=O,,,5,1,1,0,1
59598_0,,,,2,2,1,3
C(C([CH]C(O)=O)C(C(O)=O)C)=O,,,5,1,1,0,1
59599_0,,,,2,2,1,3
59600_0,,,,2,2,1,3
59602_0,,,,2,2,1,3
C1(C(C)C([CH]C(O)=O)C(C(O1)=O)=O)=O,,,5,1,1,0,1
59604_0,,,,2,2,1,3
C1(C([CH]C(O)=O)(C)CC(C(O1)=O)=O)=O,,,5,1,1,0,1
59606_0,,,,2,2,1,3
C1(C(CC(C(O1)=O)=O)C[CH]C(O)=O)=O,,,5,1,1,0,1
59608_0,,,,2,2,1,3
[C](C(O)=O)(C(CO)C[CH]C(O)=O)O,,,5,1,2,0,2
59610_0,,,,2,2,1,3
C(CCC([C](C(O)=O)O)CO)(O)=O,,,5,1,2,0,2
59612_0,,,,2,2,1,3
C(CC(C)C([C](C(O)=O)O)CO)=O,,,5,1,2,0,2
59614_0,,,,2,2,1,3
[C](C(O)=O)(CC(C[CH]C(O)=O)O)O,,,5,1,2,0,2
59616_0,,,,2,2,1,3
C(CCC(C[C](C(O)=O)O)O)(O)=O,,,5,1,2,0,2
59618_0,,,,2,2,1,3
C(CC(C)C(C[C](C(O)=O)O)O)=O,,,5,1,2,0,2
59620_0,,,,2,2,1,3
C([CH]CCC([C](C(O)=O)O)=O)(O)=O,,,5,1,2,0,2
59622_0,,,,2,2,1,3
C(CCCC([C](C(O)=O)O)=O)(O)=O,,,5,1,2,0,2
59624_0,,,,2,2,1,3
C(CC(C)CC([C](C(O)=O)O)=O)=O,,,5,1,2,0,2
59626_0,,,,2,2,1,3
C(C(CC(C[CH]C(O)=O)O)O)=O,,,5,1,2,0,2
59628_0,,,,2,2,1,3
C(CCC(CC(C=O)O)O)(O)=O,,,5,1,2,0,2
59630_0,,,,2,2,1,3
C(CC(C)C(CC(C=O)O)O)=O,,,5,1,2,0,2
59631_0,,,,2,2,1,3
59632_0,,,,2,2,1,3
59634_0,,,,2,2,1,3
C(CC(C)C(CO)C(C=O)O)=O,,,5,1,2,0,2
59636_0,,,,2,2,1,3
C(C(CCO)(C[CH]C(O)=O)O)=O,,,5,1,1,0,1
59638_0,,,,2,2,1,3
C(C(CCC(O)=O)(CCO)O)=O,,,5,1,1,0,1
59640_0,,,,2,2,1,3
C(C(CCO)(C(C)CC=O)O)=O,,,5,1,1,0,1
59642_0,,,,2,2,1,3
C(C(C[CH]C(O)=O)(O)O)=O,,,5,1,1,0,1
59644_0,,,,2,2,1,3
C(CCC(C=O)(O)O)(O)=O,,,5,1,1,0,1
59646_0,,,,2,2,1,3
C(CC(C)C(C=O)(O)O)=O,,,5,1,1,0,1
59648_0,,,,2,2,1,3
C(C(C(C)CC(C(O)=O)=O)(O)O)=O,,,5,1,1,0,1
59650_0,,,,2,2,1,3
C(C(CC(C=O)(O)O)CC=O)(O)=O,,,5,1,1,0,1
59652_0,,,,2,2,1,3
C(C(C)(C(C=O)(O)O)CC=O)(O)=O,,,5,1,1,0,1
59654_0,,,,2,2,1,3
C(C(C)C(C=O)C(C=O)(O)O)(O)=O,,,5,1,1,0,1
59656_0,,,,2,2,1,3
C(C(CC(C=O)(O)O)C(C)O)(O)=O,,,5,1,1,0,1
59658_0,,,,2,2,1,3
C(C(C(O)=O)CC(C=O)(O)O)(O)=O,,,5,1,1,0,1
59660_0,,,,2,2,1,3
[CH](C(O)=O)CCC(C(C(O)=O)=O)O,,,5,1,2,0,2
59662_0,,,,2,2,1,3
C(CCCC(C(C(O)=O)=O)O)(O)=O,,,5,1,2,0,2
59664_0,,,,2,2,1,3
C(CC(C)CC(C(C(O)=O)=O)O)=O,,,5,1,2,0,2
59666_0,,,,2,2,1,3
[CH](C(O)=O)CC(C(C(O)=O)=O)(C)O,,,5,1,2,0,2
59668_0,,,,2,2,1,3
C(CCC(C(C(O)=O)=O)(C)O)(O)=O,,,5,1,2,0,2
59670_0,,,,2,2,1,3
C(CC(C)C(C(C(O)=O)=O)(C)O)=O,,,5,1,2,0,2
59671_0,,,,2,1,2,3
59672_0,,,,2,1,2,3
59673_0,,,,2,1,2,3
59674_0,,,,2,1,2,3
59675_0,,,,2,1,2,3
59676_0,,,,2,1,2,3
59677_0,,,,2,1,2,3
59678_0,,,,2,1,2,3
59679_0,,,,2,1,2,3
59680_0,,,,2,1,2,3
59681_0,,,,2,1,2,3
59682_0,,,,2,1,2,3
59683_0,,,,2,1,2,3
59684_0,,,,2,1,2,3
59685_0,,,,2,1,2,3
59686_0,,,,2,1,2,3
59687_0,,,,2,1,2,3
59688_0,,,,2,1,2,3
59689_0,,,,2,1,2,3
59690_0,,,,2,1,2,3
59691_0,,,,2,1,2,3
59692_0,,,,2,1,2,3
59693_0,,,,2,1,2,3
59694_0,,,,2,1,2,3
59695_0,,,,2,1,2,3
59696_0,,,,2,1,2,3
59697_0,,,,2,1,2,3
59698_0,,,,2,1,2,3
59699_0,,,,2,1,2,3
59700_0,,,,2,1,2,3
59701_0,,,,2,1,2,3
59702_0,,,,2,1,2,3
59703_0,,,,2,1,2,3
59704_0,,,,2,1,2,3
59705_0,,,,2,1,2,3
59706_0,,,,2,1,2,3
59707_0,,,,2,1,2,3
59708_0,,,,2,1,2,3
59709_0,,,,2,1,2,3
59710_0,,,,2,1,2,3
59711_0,,,,2,1,2,3
59712_0,,,,2,1,2,3
59713_0,,,,2,1,2,3
59714_0,,,,2,1,2,3
59715_0,,,,2,1,2,3
59716_0,,,,2,1,2,3
59717_0,,,,2,1,2,3
59718_0,,,,2,1,2,3
59719_0,,,,2,1,2,3
59720_0,,,,2,1,2,3
59721_0,,,,2,1,2,3
59722_0,,,,2,1,2,3
59723_0,,,,2,1,2,3
59724_0,,,,2,1,2,3
59725_0,,,,2,1,2,3
59726_0,,,,2,1,2,3
59727_0,,,,2,1,2,3
59728_0,,,,2,1,2,3
59729_0,,,,2,1,2,3
59730_0,,,,2,1,2,3
59731_0,,,,2,1,2,3
59732_0,,,,2,1,2,3
59733_0,,,,2,1,2,3
59734_0,,,,2,1,2,3
59735_0,,,,2,1,2,3
59736_0,,,,2,1,2,3
59737_0,,,,2,1,2,3
59738_0,,,,2,1,2,3
59739_0,,,,2,1,2,3
59740_0,,,,2,1,2,3
59741_0,,,,2,1,2,3
59742_0,,,,2,1,2,3
59743_0,,,,2,1,2,3
59744_0,,,,2,1,2,3
59745_0,,,,2,1,2,3
59746_0,,,,2,1,2,3
59747_0,,,,2,1,2,3
59748_0,,,,2,1,2,3
59749_0,,,,2,1,2,3
59750_0,,,,2,1,2,3
59751_0,,,,2,1,2,3
59752_0,,,,2,1,2,3
59753_0,,,,2,1,2,3
59754_0,,,,2,1,2,3
59755_0,,,,2,1,2,3
59756_0,,,,2,1,2,3
59757_0,,,,2,1,2,3
59758_0,,,,2,1,2,3
59759_0,,,,2,1,2,3
59760_0,,,,2,1,2,3
59761_0,,,,2,1,2,3
59762_0,,,,2,1,2,3
59763_0,,,,2,1,2,3
59764_0,,,,2,1,2,3
59765_0,,,,2,1,2,3
59766_0,,,,2,1,2,3
59767_0,,,,2,1,2,3
59768_0,,,,2,1,2,3
59769_0,,,,2,1,2,3
59770_0,,,,2,1,2,3
59771_0,,,,2,1,2,3
59772_0,,,,2,1,2,3
59773_0,,,,2,1,2,3
59774_0,,,,2,1,2,3
59775_0,,,,2,1,2,3
59776_0,,,,2,1,2,3
59777_0,,,,2,1,2,3
59778_0,,,,2,1,2,3
59779_0,,,,2,1,2,3
59780_0,,,,2,1,2,3
59781_0,,,,2,1,2,3
59782_0,,,,2,1,2,3
59783_0,,,,2,1,2,3
59784_0,,,,2,1,2,3
59785_0,,,,2,1,2,3
59786_0,,,,2,1,2,3
59787_0,,,,2,1,2,3
59788_0,,,,2,1,2,3
59789_0,,,,2,1,2,3
59790_0,,,,2,1,2,3
59791_0,,,,2,1,2,3
59792_0,,,,2,1,2,3
59793_0,,,,2,1,2,3
59794_0,,,,2,1,2,3
59795_0,,,,2,1,2,3
59796_0,,,,2,1,2,3
59797_0,,,,2,1,2,3
59798_0,,,,2,1,2,3
59799_0,,,,2,1,2,3
59801_0,,,,2,1,2,3
C=CC(C(C=O)=O)=O,,,5,1,1,0,1
59802_0,,,,2,1,2,3
59804_0,,,,2,1,2,3
C(C(C=O)=CC=O)=O,,,5,1,1,0,1
59805_0,,,,2,1,2,3
59806_0,,,,2,1,2,3
59807_0,,,,2,1,2,3
59808_0,,,,2,1,2,3
59809_0,,,,2,1,2,3
59810_0,,,,2,1,2,3
59811_0,,,,2,1,2,3
59812_0,,,,2,1,2,3
59813_0,,,,2,1,2,3
59814_0,,,,2,1,2,3
59815_0,,,,2,1,2,3
59816_0,,,,2,1,2,3
59817_0,,,,2,1,2,3
59818_0,,,,2,1,2,3
59819_0,,,,2,1,2,3
59820_0,,,,2,1,2,3
59821_0,,,,2,1,2,3
59822_0,,,,2,1,2,3
59823_0,,,,2,1,2,3
59825_0,,,,2,1,1,2
C(C(O)OC(C(CO)=C)=O)(O)=O,,,5,1,1,0,1
59827_0,,,,2,1,2,3
C1(C(C=CC(O1)=O)=O)=O,,,5,1,5,0,5
59828_0,,,,2,1,2,3
59829_0,,,,2,1,2,3
59831_0,,,,2,1,1,2
C(C(O)OCC(C(O)=O)=C)(O)=O,,,5,1,1,0,1
59833_0,,,,2,1,1,2
[C](C(OC(CC(C)O)O)=O)=C,,,5,1,2,0,2
59835_0,,,,2,1,1,2
C=CC(OC(CC(C)O)O)=O,,,5,1,2,0,2
59837_0,,,,2,1,1,2
[C](C(OC(CC(O)=O)O)=O)=C,,,5,1,1,0,1
59839_0,,,,2,1,1,2
C=C(C(O)=O)C(O)OC([CH2])=O,,,5,1,1,0,1
59841_0,,,,2,1,1,2
C(CC(O)OC(C=C)=O)(O)=O,,,5,1,1,0,1
59843_0,,,,2,1,1,2
C(C)(OC(C(C(O)=O)=C)O)=O,,,5,1,1,0,1
59845_0,,,,2,1,1,2
[C](C(OC(C=O)(CO)O)=O)=C,,,5,1,1,0,1
59847_0,,,,2,1,1,2
C(C(CO)(O)OC(C=C)=O)=O,,,5,1,1,0,1
59849_0,,,,2,1,1,2
[C](C(OC(C=O)(C)O)=O)=C,,,5,1,1,0,1
59851_0,,,,2,1,1,2
C(C(C)(O)OC(C=C)=O)=O,,,5,1,1,0,1
59853_0,,,,2,1,1,2
[C](C(OC(C(O)=O)(CO)O)=O)=C,,,5,1,1,0,1
59855_0,,,,2,1,1,2
[C](C(OC(C)O)=O)=C,,,5,1,1,0,1
59857_0,,,,2,1,1,2
[C](C(OC(C(O)=O)(C)O)=O)=C,,,5,1,1,0,1
59859_0,,,,2,1,1,2
C(C(CO)(O)OC(C=C)=O)(O)=O,,,5,1,1,0,1
59861_0,,,,2,1,1,2
C=CC(OC(C)O)=O,,,5,1,1,0,1
59863_0,,,,2,1,1,2
C(C(C)(O)OC(C=C)=O)(O)=O,,,5,1,1,0,1
59864_0,,,,2,1,1,2
59865_0,,,,2,1,1,2
59867_0,,,,2,1,1,2
[C](C(OC(C(CO)=O)O)=O)=C,,,5,1,1,0,1
59869_0,,,,2,1,1,2
C(CO)(C(O)OC(C=C)=O)=O,,,5,1,1,0,1
59871_0,,,,2,1,1,2
[C](C(OC(C(C)=O)O)=O)=C,,,5,1,1,0,1
59873_0,,,,2,1,1,2
C=CC(C(O)OC([CH2])=O)=O,,,5,1,1,0,1
59875_0,,,,2,1,1,2
C(C)(C(O)OC(C=C)=O)=O,,,5,1,1,0,1
59877_0,,,,2,1,1,2
C(C)(OC(C(C=C)=O)O)=O,,,5,1,1,0,1
59878_0,,,,2,1,2,3
59879_0,,,,2,1,2,3
59881_0,,,,2,1,1,2
[C](C(OC(C)CC=O)=O)=C,,,5,1,3,0,3
59883_0,,,,2,1,1,2
C(CC(C)OC(C=C)=O)=O,,,5,1,3,0,3
59885_0,,,,2,1,1,2
[C](C(OCC(C=O)=O)=O)=C,,,5,1,1,0,1
59887_0,,,,2,1,1,2
C=CC(OCC(C=O)=O)=O,,,5,1,1,0,1
59889_0,,,,2,1,1,2
[C](C(OCC(O)=O)=O)=C,,,5,1,1,0,1
59891_0,,,,2,1,1,2
C(COC(C=C)=O)(O)=O,,,5,1,1,0,1
59893_0,,,,2,1,1,2
[C](C(OCCO)=O)=C,,,5,1,2,0,2
59895_0,,,,2,1,1,2
[C](C(OCC(C(O)=O)=O)=O)=C,,,5,1,1,0,1
59897_0,,,,2,1,1,2
[C](C(OCC(C(O)=O)O)=O)=C,,,5,1,2,0,2
59899_0,,,,2,1,1,2
[C](C(OC(C(O)=O)CO)=O)=C,,,5,1,2,0,2
59901_0,,,,2,1,1,2
[C](C(OC(C(O)=O)C)=O)=C,,,5,1,2,0,2
59903_0,,,,2,1,1,2
C=CC(OCCO)=O,,,5,1,2,0,2
59904_0,,,,2,1,1,2
59906_0,,,,2,1,1,2
C(C(COC(C=C)=O)O)(O)=O,,,5,1,2,0,2
59908_0,,,,2,1,1,2
C(C(CO)OC(C=C)=O)(O)=O,,,5,1,2,0,2
59910_0,,,,2,1,1,2
C(C(C)OC(C=C)=O)(O)=O,,,5,1,2,0,2
59912_0,,,,2,1,1,2
C(C(C=CC(O)=O)=O)(OC)=O,,,5,1,1,0,1
59913_0,,,,2,1,1,2
59915_0,,,,2,1,1,2
C=C(C=O)C(C)OC([CH2])=O,,,5,1,1,0,1
59916_0,,,,2,1,1,2
59918_0,,,,2,1,1,2
C(C)(OC(C(C=O)=C)C)=O,,,5,1,1,0,1
59919_0,,,,2,1,1,2
59920_0,,,,2,1,1,2
59922_0,,,,2,1,1,2
[C](C(OC(CC=O)=O)=O)=C,,,5,1,1,0,1
59924_0,,,,2,1,1,2
C=C(C(OC([CH2])=O)=O)C=O,,,5,1,1,0,1
59926_0,,,,2,1,1,2
C(CC(OC(C=C)=O)=O)=O,,,5,1,1,0,1
59928_0,,,,2,1,1,2
C(C)(OC(C(C=O)=C)=O)=O,,,5,1,1,0,1
59930_0,,,,2,1,1,2
[C](C(OC(CO)=O)=O)=C,,,5,1,1,0,1
59932_0,,,,2,1,1,2
C(CO)(OC(C=C)=O)=O,,,5,1,1,0,1
59933_0,,,,2,1,1,2
59934_0,,,,2,1,1,2
59936_0,,,,2,1,1,2
[C](C(OC(C(CO)O)=O)=O)=C,,,5,1,2,0,2
59937_0,,,,2,1,1,2
59939_0,,,,2,1,1,2
[C](C(O[C](C(O)=O)C)=O)=C,,,5,1,1,0,1
59940_0,,,,2,1,1,2
59942_0,,,,2,1,1,2
[C](C(OC(C(C)O)=O)=O)=C,,,5,1,2,0,2
59943_0,,,,2,1,1,2
59944_0,,,,2,1,1,2
59946_0,,,,2,1,1,2
C(C(CO)O)(OC(C=C)=O)=O,,,5,1,2,0,2
59947_0,,,,2,1,1,2
59949_0,,,,2,1,1,2
C=CC(O[C](C(O)=O)C)=O,,,5,1,1,0,1
59950_0,,,,2,1,1,2
59952_0,,,,2,1,1,2
C(C(C)O)(OC(C=C)=O)=O,,,5,1,2,0,2
59954_0,,,,2,1,1,2
[C](C(OC(C(CO)=O)=O)=O)=C,,,5,1,1,0,1
59955_0,,,,2,1,1,2
59957_0,,,,2,1,1,2
[C](C(OC([C](C)O)=O)=O)=C,,,5,1,1,0,1
59958_0,,,,2,1,1,2
59960_0,,,,2,1,1,2
C=CC(C(OC([CH2])=O)=O)=O,,,5,1,1,0,1
59962_0,,,,2,1,1,2
[C](C(OC(C(C)=O)=O)=O)=C,,,5,1,1,0,1
59963_0,,,,2,1,1,2
59964_0,,,,2,1,1,2
59966_0,,,,2,1,1,2
C=CC(OC([C](C)O)=O)=O,,,5,1,1,0,1
59967_0,,,,2,1,1,2
59969_0,,,,2,1,1,2
C(C)(OC(C(C=C)=O)=O)=O,,,5,1,1,0,1
59970_0,,,,2,1,1,2
59973_0,,,,2,1,2,3
C(C(C(C)O)C(C=CC=O)O)=O,,,5,1,1,0,1
C,,,5,1,206,0,206
59974_0,,,,2,1,2,3
59975_0,,,,2,1,2,3
59976_0,,,,2,1,2,3
59978_0,,,,2,1,2,3
C(C(C=CC=O)(CO)C(C)O)=O,,,5,1,1,0,1
59979_0,,,,2,1,2,3
59981_0,,,,2,1,2,3
C(C(CO)C(CC=CC=O)O)=O,,,5,1,1,0,1
59982_0,,,,2,1,2,3
59983_0,,,,2,1,2,3
59984_0,,,,2,1,2,3
59986_0,,,,2,1,2,3
C(C(C=O)C(C=CC=O)O)(O)=O,,,5,1,1,0,1
59987_0,,,,2,1,2,3
59988_0,,,,2,1,2,3
59989_0,,,,2,1,2,3
59991_0,,,,2,1,2,3
C(C(C=O)(C=CC=O)CO)(O)=O,,,5,1,1,0,1
59992_0,,,,2,1,2,3
59994_0,,,,2,1,2,3
C(C(C(C(C=O)=O)O)O)=CC=O,,,5,1,1,0,1
59995_0,,,,2,1,2,3
59996_0,,,,2,1,2,3
59997_0,,,,2,1,2,3
59999_0,,,,2,1,2,3
C(C(C(C=O)=O)(CO)O)=CC=O,,,5,1,1,0,1
60000_0,,,,2,1,2,3
60002_0,,,,2,1,2,3
C(C(C=CC=O)C(C=O)(C)O)=O,,,5,1,1,0,1
60003_0,,,,2,1,2,3
60004_0,,,,2,1,2,3
60006_0,,,,2,1,2,3
C(C(C(C=O)=CCC=O)(C)O)=O,,,5,1,1,0,1
60008_0,,,,2,1,2,3
C(CC(C=O)(CC=CC=O)O)=O,,,5,1,1,0,1
60009_0,,,,2,1,2,3
60011_0,,,,2,1,2,3
C(C(C=CC=O)C(C(C)=O)O)=O,,,5,1,1,0,1
60012_0,,,,2,1,2,3
60013_0,,,,2,1,2,3
60015_0,,,,2,1,2,3
C(CC=C(C=O)C(C(C)=O)O)=O,,,5,1,1,0,1
60017_0,,,,2,1,2,3
C(CC(C(CC=CC=O)=O)O)=O,,,5,1,1,0,1
60018_0,,,,2,1,2,3
60019_0,,,,2,1,2,3
60021_0,,,,2,1,2,3
C(CC=CC(C(CC=O)O)=O)=O,,,5,1,1,0,1
60023_0,,,,2,1,2,3
C(CC(C(C)=O)(C=CC=O)O)=O,,,5,1,1,0,1
60024_0,,,,2,1,2,3
60025_0,,,,2,1,2,3
60026_0,,,,2,1,2,3
60028_0,,,,2,1,2,3
C(C(CC(C=O)=O)O)=CC=O,,,5,1,1,0,1
60029_0,,,,2,1,2,3
60030_0,,,,2,1,2,3
60031_0,,,,2,1,2,3
60033_0,,,,2,1,2,3
C(C(C(C=O)=O)CO)=CC=O,,,5,1,1,0,1
60034_0,,,,2,1,2,3
60035_0,,,,2,1,2,3
60037_0,,,,2,1,2,3
C(CC=C(C(C=O)=O)CO)=O,,,5,1,1,0,1
60039_0,,,,2,1,2,3
C(CC(CC(C=O)=O)O)=CC=O,,,5,1,1,0,1
60040_0,,,,2,1,2,3
60041_0,,,,2,1,2,3
60042_0,,,,2,1,2,3
60043_0,,,,2,1,2,3
60044_0,,,,2,1,2,3
60046_0,,,,2,1,2,3
C(C(C(C=O)=O)C(C)O)=CC=O,,,5,1,1,0,1
60047_0,,,,2,1,2,3
60048_0,,,,2,1,2,3
60050_0,,,,2,1,2,3
C(CC=C(C(C=O)=O)C(C)O)=O,,,5,1,1,0,1
60052_0,,,,2,1,2,3
C(C(C=CC=O)C(C=O)=O)(O)=O,,,5,1,1,0,1
60053_0,,,,2,1,2,3
60054_0,,,,2,1,2,3
60056_0,,,,2,1,2,3
C(CC=C(C(O)=O)C(C=O)=O)=O,,,5,1,1,0,1
60058_0,,,,2,1,2,3
C(C(C=CC=O)CO)=O,,,5,1,1,0,1
60059_0,,,,2,1,2,3
60060_0,,,,2,1,2,3
60062_0,,,,2,1,2,3
C(CC=C(C=O)CO)=O,,,5,1,1,0,1
60064_0,,,,2,1,2,3
C(C(C=CC(C(O)=O)=O)CO)=O,,,5,1,1,0,1
60065_0,,,,2,1,2,3
60066_0,,,,2,1,2,3
60068_0,,,,2,1,2,3
C(CC(C(O)=O)=O)=C(C=O)CO,,,5,1,1,0,1
60069_0,,,,2,1,2,3
60070_0,,,,2,1,2,3
60072_0,,,,2,1,2,3
C(C(C)CO)=O,,,5,1,1,0,1
60074_0,,,,2,1,2,3
C(C(C(C(O)=O)=CC=O)CO)=O,,,5,1,1,0,1
60075_0,,,,2,1,2,3
60077_0,,,,2,1,2,3
C(CC(C(O)=O)=C(C=O)CO)=O,,,5,1,1,0,1
60078_0,,,,2,1,2,3
60079_0,,,,2,1,2,3
60080_0,,,,2,1,2,3
60082_0,,,,2,1,2,3
C(CC)(O)=O,,,5,1,12,0,12
60083_0,,,,2,1,2,3
60084_0,,,,2,1,2,3
60085_0,,,,2,1,2,3
60086_0,,,,2,1,2,3
60087_0,,,,2,1,2,3
60089_0,,,,2,1,2,3
C(CC(C=CC=O)O)=O,,,5,1,1,0,1
60090_0,,,,2,1,2,3
60092_0,,,,2,1,2,3
C(CC(C=CC(C(O)=O)=O)O)=O,,,5,1,1,0,1
60093_0,,,,2,1,2,3
60094_0,,,,2,1,2,3
60095_0,,,,2,1,2,3
60096_0,,,,2,1,2,3
60097_0,,,,2,1,2,3
60099_0,,,,2,1,2,3
C(CC(C(C=O)=CC(O)=O)O)=O,,,5,1,1,0,1
60100_0,,,,2,1,2,3
60101_0,,,,2,1,2,3
60102_0,,,,2,1,2,3
60103_0,,,,2,1,2,3
60104_0,,,,2,1,2,3
60106_0,,,,2,1,2,3
C(C(C(C(O)=O)=O)CO)=CC=O,,,5,1,1,0,1
60107_0,,,,2,1,2,3
60108_0,,,,2,1,2,3
60110_0,,,,2,1,2,3
C(CC=C(C(C(O)=O)=O)CO)=O,,,5,1,1,0,1
60112_0,,,,2,1,2,3
C(C(CC(C(O)=O)=O)O)=CC=O,,,5,1,1,0,1
60113_0,,,,2,1,2,3
60114_0,,,,2,1,2,3
60115_0,,,,2,1,2,3
60117_0,,,,2,1,2,3
C(CC(C(CC=CC=O)=O)=O)=O,,,5,1,1,0,1
60118_0,,,,2,1,2,3
60119_0,,,,2,1,2,3
60121_0,,,,2,1,2,3
C(CC(C(C=CCC=O)=O)=O)=O,,,5,1,1,0,1
60122_0,,,,2,1,2,3
60123_0,,,,2,1,2,3
60124_0,,,,2,1,2,3
60125_0,,,,2,1,2,3
60127_0,,,,2,1,2,3
C(C(C=CC=O)C(C(C)=O)=O)=O,,,5,1,1,0,1
60128_0,,,,2,1,2,3
60129_0,,,,2,1,2,3
60131_0,,,,2,1,2,3
C(CC=C(C=O)C(C(C)=O)=O)=O,,,5,1,1,0,1
60132_0,,,,2,1,2,3
60133_0,,,,2,1,2,3
60134_0,,,,2,1,2,3
60135_0,,,,2,1,2,3
60137_0,,,,2,1,2,3
C(CC(C(C(C)O)=O)=O)=CC=O,,,5,1,1,0,1
60138_0,,,,2,1,2,3
60139_0,,,,2,1,2,3
60141_0,,,,2,1,2,3
C(CC=CC(C(C(C)O)=O)=O)=O,,,5,1,1,0,1
60142_0,,,,2,1,2,3
60143_0,,,,2,1,2,3
60144_0,,,,2,1,2,3
60145_0,,,,2,1,2,3
60147_0,,,,2,1,2,3
C(CC(C(C(C)=O)=O)O)=CC=O,,,5,1,1,0,1
60148_0,,,,2,1,2,3
60149_0,,,,2,1,2,3
60150_0,,,,2,1,2,3
60152_0,,,,2,1,2,3
C(C(C(C(C)=O)=O)(C)O)=CC=O,,,5,1,1,0,1
60153_0,,,,2,1,2,3
60154_0,,,,2,1,2,3
60155_0,,,,2,1,2,3
60157_0,,,,2,1,2,3
C(CC(C(C(O)=O)=O)=O)=CC=O,,,5,1,1,0,1
60158_0,,,,2,1,2,3
60159_0,,,,2,1,2,3
60161_0,,,,2,1,2,3
C(CC=CC(C(C(O)=O)=O)=O)=O,,,5,1,1,0,1
60162_0,,,,2,1,2,3
60163_0,,,,2,1,2,3
60164_0,,,,2,1,2,3
60165_0,,,,2,1,2,3
60167_0,,,,2,1,2,3
C(C(C=O)(C=CC=O)O)=O,,,5,1,1,0,1
60168_0,,,,2,1,2,3
60169_0,,,,2,1,2,3
60170_0,,,,2,1,2,3
60172_0,,,,2,1,2,3
C(C(C=O)(C=CC=O)O)(O)=O,,,5,1,1,0,1
60173_0,,,,2,1,2,3
60174_0,,,,2,1,2,3
60175_0,,,,2,1,2,3
60176_0,,,,2,1,2,3
60177_0,,,,2,1,2,3
60178_0,,,,2,1,2,3
60179_0,,,,2,1,2,3
60180_0,,,,2,1,2,3
60181_0,,,,2,1,2,3
60183_0,,,,2,1,2,3
C(CC(CCO)O)=CC=O,,,5,1,1,0,1
60184_0,,,,2,1,2,3
60186_0,,,,2,1,2,3
C(C(C)(CCO)O)=CC=O,,,5,1,1,0,1
60187_0,,,,2,1,2,3
60188_0,,,,2,1,2,3
60189_0,,,,2,1,2,3
60190_0,,,,2,1,2,3
60191_0,,,,2,1,2,3
60192_0,,,,2,1,2,3
60193_0,,,,2,1,2,3
60194_0,,,,2,1,2,3
60195_0,,,,2,1,2,3
60196_0,,,,2,1,2,3
60197_0,,,,2,1,2,3
60199_0,,,,2,1,2,3
C(CO)(CC=CC=O)=O,,,5,1,1,0,1
60200_0,,,,2,1,2,3
60201_0,,,,2,1,2,3
60203_0,,,,2,1,2,3
C(CC=CC(CO)=O)=O,,,5,1,1,0,1
60205_0,,,,2,1,2,3
C(CO)(CC=CC(C(O)=O)=O)=O,,,5,1,1,0,1
60206_0,,,,2,1,2,3
60207_0,,,,2,1,2,3
60209_0,,,,2,1,2,3
C(CC(C(O)=O)=O)=CC(CO)=O,,,5,1,1,0,1
60210_0,,,,2,1,2,3
60211_0,,,,2,1,2,3
60212_0,,,,2,1,2,3
60214_0,,,,2,1,2,3
C(CO)(CC(C(O)=O)=CC=O)=O,,,5,1,1,0,1
60215_0,,,,2,1,2,3
60217_0,,,,2,1,2,3
C(CC(C(O)=O)=CC(CO)=O)=O,,,5,1,1,0,1
60218_0,,,,2,1,2,3
60219_0,,,,2,1,2,3
60220_0,,,,2,1,2,3
60221_0,,,,2,1,2,3
60222_0,,,,2,1,2,3
60223_0,,,,2,1,2,3
60224_0,,,,2,1,2,3
60225_0,,,,2,1,2,3
60226_0,,,,2,1,2,3
60227_0,,,,2,1,2,3
60229_0,,,,2,1,2,3
C(C)(C(C=CC(C(O)=O)=O)O)=O,,,5,1,1,0,1
60230_0,,,,2,1,2,3
60231_0,,,,2,1,2,3
60232_0,,,,2,1,2,3
60234_0,,,,2,1,2,3
C(C)(C(C(C(O)=O)=CC=O)O)=O,,,5,1,1,0,1
60235_0,,,,2,1,2,3
60236_0,,,,2,1,2,3
60237_0,,,,2,1,2,3
60238_0,,,,2,1,2,3
60239_0,,,,2,1,2,3
60240_0,,,,2,1,2,3
60241_0,,,,2,1,2,3
60242_0,,,,2,1,2,3
60243_0,,,,2,1,2,3
60244_0,,,,2,1,2,3
60245_0,,,,2,1,2,3
60246_0,,,,2,1,2,3
60247_0,,,,2,1,2,3
60248_0,,,,2,1,2,3
60249_0,,,,2,1,2,3
60250_0,,,,2,1,2,3
60251_0,,,,2,1,2,3
60252_0,,,,2,1,2,3
60253_0,,,,2,1,2,3
60254_0,,,,2,1,2,3
60256_0,,,,2,1,1,2
C(C(O)OC(C(C)=CCO)=O)(O)=O,,,5,1,1,0,1
60257_0,,,,2,1,2,3
60259_0,,,,2,1,1,2
C(C(O)OC(C(CCO)=C)=O)(O)=O,,,5,1,1,0,1
60260_0,,,,2,1,2,3
60261_0,,,,2,1,2,3
60263_0,,,,2,1,2,3
C1(C(C(CO)=CC(O1)=O)=O)=O,,,5,1,1,0,1
60264_0,,,,2,1,2,3
60265_0,,,,2,1,2,3
60266_0,,,,2,1,2,3
60267_0,,,,2,1,2,3
60268_0,,,,2,1,2,3
60269_0,,,,2,1,2,3
60270_0,,,,2,1,2,3
60271_0,,,,2,1,2,3
60272_0,,,,2,1,2,3
60273_0,,,,2,1,2,3
60274_0,,,,2,1,2,3
60275_0,,,,2,1,2,3
60276_0,,,,2,1,2,3
60277_0,,,,2,1,2,3
60278_0,,,,2,1,2,3
60279_0,,,,2,1,2,3
60280_0,,,,2,1,2,3
60281_0,,,,2,1,2,3
60282_0,,,,2,1,2,3
60283_0,,,,2,1,2,3
60284_0,,,,2,1,2,3
60285_0,,,,2,1,2,3
60286_0,,,,2,1,2,3
60287_0,,,,2,1,2,3
60288_0,,,,2,1,2,3
60289_0,,,,2,1,2,3
60290_0,,,,2,1,2,3
60291_0,,,,2,1,2,3
60292_0,,,,2,1,2,3
60294_0,,,,2,1,2,3
CCCO,,,5,1,2,0,2
60295_0,,,,2,1,2,3
60296_0,,,,2,1,2,3
60298_0,,,,2,1,2,3
C(C=C(C=O)CCO)(O)=O,,,5,1,1,0,1
60299_0,,,,2,1,2,3
60300_0,,,,2,1,2,3
60301_0,,,,2,1,2,3
60302_0,,,,2,1,2,3
60303_0,,,,2,1,2,3
60305_0,,,,2,1,2,3
C1(C(C(CCO)=CC(O1)=O)=O)=O,,,5,1,1,0,1
60306_0,,,,2,1,2,3
60308_0,,,,2,1,2,3
C1(C(C=C(C(O1)=O)CCO)=O)=O,,,5,1,1,0,1
60309_0,,,,2,1,2,3
60310_0,,,,2,1,2,3
60311_0,,,,2,1,2,3
60312_0,,,,2,1,2,3
60313_0,,,,2,1,2,3
60314_0,,,,2,1,2,3
60315_0,,,,2,1,2,3
60316_0,,,,2,1,2,3
60318_0,,,,2,1,2,3
CC(C)O,,,5,1,2,0,2
60319_0,,,,2,1,2,3
60320_0,,,,2,1,2,3
60321_0,,,,2,1,2,3
60322_0,,,,2,1,2,3
60323_0,,,,2,1,2,3
60324_0,,,,2,1,2,3
60325_0,,,,2,1,2,3
60327_0,,,,2,1,2,3
C1(C(C(C(C)O)=CC(O1)=O)=O)=O,,,5,1,1,0,1
60329_0,,,,2,1,2,3
C1(C(C=C(C(O1)=O)C(C)O)=O)=O,,,5,1,1,0,1
60330_0,,,,2,1,2,3
60331_0,,,,2,1,2,3
60332_0,,,,2,1,2,3
60333_0,,,,2,1,2,3
60334_0,,,,2,1,2,3
60335_0,,,,2,1,2,3
60336_0,,,,2,1,2,3
60337_0,,,,2,1,2,3
60338_0,,,,2,1,2,3
60339_0,,,,2,1,2,3
60340_0,,,,2,1,2,3
60342_0,,,,2,1,2,3
C(CC(C=CC=O)(C)O)(O)=O,,,5,1,1,0,1
60343_0,,,,2,1,2,3
60344_0,,,,2,1,2,3
60345_0,,,,2,1,2,3
60346_0,,,,2,1,2,3
60347_0,,,,2,1,2,3
60348_0,,,,2,1,2,3
60349_0,,,,2,1,2,3
60350_0,,,,2,1,2,3
60351_0,,,,2,1,2,3
60352_0,,,,2,1,2,3
60353_0,,,,2,1,2,3
60354_0,,,,2,1,2,3
60355_0,,,,2,1,2,3
60356_0,,,,2,1,2,3
60357_0,,,,2,1,2,3
60358_0,,,,2,1,2,3
60359_0,,,,2,1,2,3
60360_0,,,,2,1,2,3
60361_0,,,,2,1,2,3
60362_0,,,,2,1,2,3
60364_0,,,,2,1,2,3
C(CC(C=O)=CC(O)=O)(O)=O,,,5,1,1,0,1
60365_0,,,,2,1,2,3
60366_0,,,,2,1,2,3
60367_0,,,,2,1,2,3
60368_0,,,,2,1,2,3
60370_0,,,,2,1,2,3
C(C(C)(C(C=CC=O)O)O)(O)=O,,,5,1,1,0,1
60371_0,,,,2,1,2,3
60372_0,,,,2,1,2,3
60373_0,,,,2,1,2,3
60375_0,,,,2,1,2,3
C(C(C(CC=CC=O)O)O)(O)=O,,,5,1,1,0,1
60376_0,,,,2,1,2,3
60377_0,,,,2,1,2,3
60378_0,,,,2,1,2,3
60379_0,,,,2,1,2,3
60380_0,,,,2,1,2,3
60382_0,,,,2,1,2,3
C(C(C=CC=O)(C(C)O)O)(O)=O,,,5,1,1,0,1
60383_0,,,,2,1,2,3
60385_0,,,,2,1,2,3
C(C(C(O)=O)(C=CC=O)O)(O)=O,,,5,1,1,0,1
60386_0,,,,2,1,2,3
60388_0,,,,2,1,2,3
C(C(C=O)(CC=CC=O)O)(O)=O,,,5,1,1,0,1
60389_0,,,,2,1,2,3
60390_0,,,,2,1,2,3
60391_0,,,,2,1,2,3
60393_0,,,,2,1,2,3
C(C(C(C)=O)CC=CC=O)(O)=O,,,5,1,1,0,1
60394_0,,,,2,1,2,3
60396_0,,,,2,1,2,3
C(CCC)=O,,,5,1,5,0,5
60397_0,,,,2,1,2,3
60399_0,,,,2,1,2,3
C([CH]C)(O)=O,,,5,1,5,0,5
60400_0,,,,2,1,2,3
60401_0,,,,2,1,2,3
60403_0,,,,2,1,2,3
C(C)(C(C(O)=O)(C=CC=O)C)=O,,,5,1,1,0,1
60404_0,,,,2,1,2,3
60405_0,,,,2,1,2,3
60406_0,,,,2,1,2,3
60408_0,,,,2,1,2,3
C(CC=CC=O)(C(C(O)=O)C)=O,,,5,1,1,0,1
60409_0,,,,2,1,2,3
60410_0,,,,2,1,2,3
60412_0,,,,2,1,2,3
C(CC=CC(C(C(O)=O)C)=O)=O,,,5,1,1,0,1
60413_0,,,,2,1,2,3
60414_0,,,,2,1,2,3
60415_0,,,,2,1,2,3
60416_0,,,,2,1,2,3
60418_0,,,,2,1,2,3
C(CC=CC=O)=CC=O,,,5,1,1,0,1
60419_0,,,,2,1,2,3
60421_0,,,,2,1,2,3
C(CC=CC(C(O)=O)=O)=CC=O,,,5,1,2,0,2
60422_0,,,,2,1,2,3
60423_0,,,,2,1,2,3
60425_0,,,,2,1,2,3
C(CC)=CC=O,,,5,1,1,0,1
60427_0,,,,2,1,2,3
C(CC(C(O)=O)=CC=O)=CC=O,,,5,1,2,0,2
60428_0,,,,2,1,2,3
60430_0,,,,2,1,2,3
C(CC(C=O)=CC(O)=O)=CC=O,,,5,1,1,0,1
60431_0,,,,2,1,2,3
60432_0,,,,2,1,2,3
60433_0,,,,2,1,2,3
60434_0,,,,2,1,2,3
60436_0,,,,2,1,2,3
C(CC=C(C=O)C=C)=O,,,5,1,1,0,1
60437_0,,,,2,1,2,3
60439_0,,,,2,1,2,3
C(C(C=C)C=CC=O)=O,,,5,1,1,0,1
60440_0,,,,2,1,2,3
60441_0,,,,2,1,2,3
60442_0,,,,2,1,2,3
60444_0,,,,2,1,2,3
C(CC=C(C=C)C(C(O)=O)=O)=O,,,5,1,1,0,1
60445_0,,,,2,1,2,3
60447_0,,,,2,1,2,3
C=CC(C=CC=O)C(C(O)=O)=O,,,5,1,1,0,1
60448_0,,,,2,1,2,3
60450_0,,,,2,1,2,3
C(CC=C(C=O)C(C(O)=O)=C)=O,,,5,1,1,0,1
60451_0,,,,2,1,2,3
60453_0,,,,2,1,2,3
C(C(C=CC=O)C(C(O)=O)=C)=O,,,5,1,1,0,1
60454_0,,,,2,1,2,3
60455_0,,,,2,1,2,3
60456_0,,,,2,1,2,3
60458_0,,,,2,1,2,3
C=C(C(O)=O)C(CC=CC=O)O,,,5,1,1,0,1
60459_0,,,,2,1,2,3
60461_0,,,,2,1,2,3
C=C(C(O)=O)C(C=CC=O)(C)O,,,5,1,1,0,1
60462_0,,,,2,1,2,3
60464_0,,,,2,1,2,3
C(C(C=C)(CC=CC=O)O)(O)=O,,,5,1,1,0,1
60465_0,,,,2,1,2,3
60467_0,,,,2,1,2,3
C(C(CO)(C(C)O)O)=CC=O,,,5,1,1,0,1
60468_0,,,,2,1,2,3
60470_0,,,,2,1,2,3
C(C(C(C(C)O)O)O)=CC=O,,,5,1,1,0,1
60471_0,,,,2,1,2,3
60473_0,,,,2,1,2,3
C(CC(C(CO)O)O)=CC=O,,,5,1,1,0,1
60474_0,,,,2,1,2,3
60476_0,,,,2,1,2,3
C(C(C)(C(CO)O)O)=CC=O,,,5,1,1,0,1
60477_0,,,,2,1,2,3
60479_0,,,,2,1,2,3
C(C(C(C=CC=O)O)O)=O,,,5,1,1,0,1
60480_0,,,,2,1,2,3
60481_0,,,,2,1,2,3
60482_0,,,,2,1,2,3
60484_0,,,,2,1,2,3
C(C([CH]C(O)=O)O)=CC=O,,,5,1,1,0,1
60485_0,,,,2,1,2,3
60487_0,,,,2,1,2,3
C([C](C=CC=O)CO)(O)=O,,,5,1,1,0,1
60488_0,,,,2,1,2,3
60489_0,,,,2,1,2,3
60490_0,,,,2,1,2,3
60492_0,,,,2,1,2,3
C(CC=C1C(C(OC1C)=O)=O)=O,,,5,1,1,0,1
60493_0,,,,2,1,2,3
60495_0,,,,2,1,2,3
C(C1C(C(OC1C)=O)=O)=CC=O,,,5,1,1,0,1
60496_0,,,,2,1,2,3
60498_0,,,,2,1,2,3
C(CC1CC(C(O1)=O)=O)=CC=O,,,5,1,1,0,1
60499_0,,,,2,1,2,3
60501_0,,,,2,1,2,3
C(C1(C)CC(C(O1)=O)=O)=CC=O,,,5,1,1,0,1
60502_0,,,,2,1,2,3
60504_0,,,,2,1,2,3
C(CC=C1C(OC(C1=O)=O)=O)=O,,,5,1,1,0,1
60505_0,,,,2,1,2,3
60507_0,,,,2,1,2,3
C1(C(C=CC=O)C(C(O1)=O)=O)=O,,,5,1,1,0,1
60508_0,,,,2,1,2,3
60509_0,,,,2,1,2,3
60510_0,,,,2,1,2,3
60512_0,,,,2,1,2,3
C(CC=C(C=O)C[CH]C(O)=O)=O,,,5,1,1,0,1
60513_0,,,,2,1,2,3
60515_0,,,,2,1,2,3
C(C(C=CC=O)C[CH]C(O)=O)=O,,,5,1,1,0,1
60516_0,,,,2,1,2,3
60517_0,,,,2,1,2,3
60518_0,,,,2,1,2,3
60520_0,,,,2,1,2,3
[C](C(O)=O)=CCC=O,,,5,1,3,0,3
60521_0,,,,2,1,2,3
60523_0,,,,2,1,2,3
C(CC(C=CC=O)[CH]C(O)=O)=O,,,5,1,1,0,1
60524_0,,,,2,1,2,3
60525_0,,,,2,1,2,3
60527_0,,,,2,1,2,3
C(CC[C](C(O)=O)C=CC=O)=O,,,5,1,1,0,1
60528_0,,,,2,1,2,3
60529_0,,,,2,1,2,3
60530_0,,,,2,1,2,3
60532_0,,,,2,1,2,3
C(CC=C(C=O)CCC(O)=O)=O,,,5,1,1,0,1
60533_0,,,,2,1,2,3
60535_0,,,,2,1,2,3
C(C(C=CC=O)CCC(O)=O)=O,,,5,1,1,0,1
60536_0,,,,2,1,2,3
60537_0,,,,2,1,2,3
60538_0,,,,2,1,2,3
60539_0,,,,2,1,2,3
60540_0,,,,2,1,2,3
60542_0,,,,2,1,2,3
C(CC(C=CC=O)CC(O)=O)=O,,,5,1,1,0,1
60543_0,,,,2,1,2,3
60544_0,,,,2,1,2,3
60545_0,,,,2,1,2,3
60547_0,,,,2,1,2,3
C(CC=C(C(O)=O)CCC=O)=O,,,5,1,1,0,1
60548_0,,,,2,1,2,3
60549_0,,,,2,1,2,3
60550_0,,,,2,1,2,3
60552_0,,,,2,1,2,3
C(C([C](C(O)=O)O)O)=CC=O,,,5,1,1,0,1
60553_0,,,,2,1,2,3
60555_0,,,,2,1,2,3
C(C(CC=CC=O)O)=O,,,5,1,1,0,1
60556_0,,,,2,1,2,3
60557_0,,,,2,1,2,3
60558_0,,,,2,1,2,3
60560_0,,,,2,1,2,3
C(C(C(C=CC=O)O)O)(O)=O,,,5,1,1,0,1
60561_0,,,,2,1,2,3
60562_0,,,,2,1,2,3
60563_0,,,,2,1,2,3
60565_0,,,,2,1,2,3
C(CC=CC=O)=O,,,5,1,1,0,1
60566_0,,,,2,1,2,3
60568_0,,,,2,1,2,3
C(C[C](C(O)=O)O)=CC=O,,,5,1,1,0,1
60569_0,,,,2,1,2,3
60571_0,,,,2,1,2,3
C(C(CC=CC=O)O)(O)=O,,,5,1,1,0,1
60572_0,,,,2,1,2,3
60573_0,,,,2,1,2,3
60574_0,,,,2,1,2,3
60576_0,,,,2,1,2,3
C(CC=C(C=O)C(C)O)=O,,,5,1,1,0,1
60577_0,,,,2,1,2,3
60579_0,,,,2,1,2,3
C(C(C=CC=O)C(C)O)=O,,,5,1,1,0,1
60580_0,,,,2,1,2,3
60582_0,,,,2,1,2,3
C(CC(CC=CC=O)O)=O,,,5,1,1,0,1
60583_0,,,,2,1,2,3
60584_0,,,,2,1,2,3
60585_0,,,,2,1,2,3
60587_0,,,,2,1,2,3
C(CC=C(C=O)C(O)=O)=O,,,5,1,1,0,1
60588_0,,,,2,1,2,3
60590_0,,,,2,1,2,3
C(C(C(O)=O)C=CC=O)=O,,,5,1,1,0,1
60591_0,,,,2,1,2,3
60593_0,,,,2,1,2,3
C(C(C(C=O)=O)O)=CC=O,,,5,1,1,0,1
60594_0,,,,2,1,2,3
60596_0,,,,2,1,2,3
C(CC=CC(C=O)=O)=O,,,5,1,1,0,1
60597_0,,,,2,1,2,3
60599_0,,,,2,1,2,3
C(CC(C=O)=O)=CC=O,,,5,1,1,0,1
60600_0,,,,2,1,2,3
60601_0,,,,2,1,2,3
60602_0,,,,2,1,2,3
60603_0,,,,2,1,2,3
60604_0,,,,2,1,2,3
60606_0,,,,2,1,2,3
C(C(C(C(O)=O)=O)O)=CC=O,,,5,1,1,0,1
60607_0,,,,2,1,2,3
60609_0,,,,2,1,2,3
C(CC=CC(C(O)=O)=O)=O,,,5,1,1,0,1
60610_0,,,,2,1,2,3
60612_0,,,,2,1,2,3
C(CC(C(O)=O)=O)=CC=O,,,5,1,1,0,1
60614_0,,,,2,1,2,3
C(C(C=C)C=CC(C(O)=O)=O)=O,,,5,1,1,0,1
60615_0,,,,2,1,2,3
60616_0,,,,2,1,2,3
60618_0,,,,2,1,2,3
C=CC(C=O)=CCC(C(O)=O)=O,,,5,1,1,0,1
60619_0,,,,2,1,2,3
60620_0,,,,2,1,2,3
60622_0,,,,2,1,2,3
C(C(C=C)C)=O,,,5,1,1,0,1
60624_0,,,,2,1,2,3
C(C(C=C)C(C(O)=O)=CC=O)=O,,,5,1,1,0,1
60625_0,,,,2,1,2,3
60627_0,,,,2,1,2,3
C(CC(C(O)=O)=C(C=O)C=C)=O,,,5,1,1,0,1
60628_0,,,,2,1,2,3
60629_0,,,,2,1,2,3
60630_0,,,,2,1,2,3
60631_0,,,,2,1,2,3
60632_0,,,,2,1,2,3
60633_0,,,,2,1,2,3
60634_0,,,,2,1,2,3
60635_0,,,,2,1,2,3
60636_0,,,,2,1,2,3
60637_0,,,,2,1,2,3
60638_0,,,,2,1,2,3
60639_0,,,,2,1,2,3
60640_0,,,,2,1,2,3
60642_0,,,,2,1,2,3
C(C(CC=CC(C(O)=O)=O)O)=O,,,5,1,1,0,1
60643_0,,,,2,1,2,3
60645_0,,,,2,1,2,3
C(C(C=CC(C(O)=O)=O)(C)O)=O,,,5,1,1,0,1
60646_0,,,,2,1,2,3
60648_0,,,,2,1,2,3
C(CC(C(O)=O)=O)=CC(C=O)=O,,,5,1,1,0,1
60649_0,,,,2,1,2,3
60651_0,,,,2,1,2,3
C(CC(C=O)=O)=CC(C(O)=O)=O,,,5,1,1,0,1
60652_0,,,,2,1,2,3
60653_0,,,,2,1,2,3
60654_0,,,,2,1,2,3
60655_0,,,,2,1,2,3
60656_0,,,,2,1,2,3
60657_0,,,,2,1,2,3
60658_0,,,,2,1,2,3
60659_0,,,,2,1,2,3
60660_0,,,,2,1,2,3
60661_0,,,,2,1,2,3
60662_0,,,,2,1,2,3
60663_0,,,,2,1,2,3
60664_0,,,,2,1,2,3
60665_0,,,,2,1,2,3
60666_0,,,,2,1,2,3
60667_0,,,,2,1,2,3
60668_0,,,,2,1,2,3
60670_0,,,,2,1,2,3
C(C(C)(C)O)=O,,,5,1,1,0,1
60671_0,,,,2,1,2,3
60672_0,,,,2,1,2,3
60673_0,,,,2,1,2,3
60674_0,,,,2,1,2,3
60675_0,,,,2,1,2,3
60676_0,,,,2,1,2,3
60677_0,,,,2,1,2,3
60678_0,,,,2,1,2,3
60679_0,,,,2,1,2,3
60680_0,,,,2,1,2,3
60681_0,,,,2,1,2,3
60682_0,,,,2,1,2,3
60683_0,,,,2,1,2,3
60685_0,,,,2,1,2,3
C(C(C(C(O)=O)=CC=O)O)=O,,,5,1,1,0,1
60686_0,,,,2,1,2,3
60688_0,,,,2,1,2,3
C(C(CC(C(O)=O)=CC=O)O)=O,,,5,1,1,0,1
60689_0,,,,2,1,2,3
60691_0,,,,2,1,2,3
C(C(C(C(O)=O)=CC=O)(C)O)=O,,,5,1,1,0,1
60693_0,,,,2,1,2,3
C(CC(C(O)=O)=CC=O)=O,,,5,1,1,0,1
60694_0,,,,2,1,2,3
60696_0,,,,2,1,2,3
C(CC(C(O)=O)=CC(C=O)=O)=O,,,5,1,1,0,1
60697_0,,,,2,1,2,3
60698_0,,,,2,1,2,3
60700_0,,,,2,1,2,3
C(C(CC(C(O)=O)=CC=O)=O)=O,,,5,1,1,0,1
60701_0,,,,2,1,2,3
60702_0,,,,2,1,2,3
60703_0,,,,2,1,2,3
60704_0,,,,2,1,2,3
60705_0,,,,2,1,2,3
60706_0,,,,2,1,2,3
60707_0,,,,2,1,2,3
60709_0,,,,2,1,2,3
C(C(CC(C=O)=CC(O)=O)O)=O,,,5,1,1,0,1
60710_0,,,,2,1,2,3
60711_0,,,,2,1,2,3
60712_0,,,,2,1,2,3
60713_0,,,,2,1,2,3
60714_0,,,,2,1,2,3
60715_0,,,,2,1,2,3
60716_0,,,,2,1,2,3
60717_0,,,,2,1,2,3
60718_0,,,,2,1,2,3
60719_0,,,,2,1,2,3
60720_0,,,,2,1,2,3
60722_0,,,,2,1,2,3
C(C=C(C=O)C(CO)O)(O)=O,,,5,1,1,0,1
60723_0,,,,2,1,2,3
60724_0,,,,2,1,2,3
60725_0,,,,2,1,2,3
60726_0,,,,2,1,2,3
60727_0,,,,2,1,2,3
60728_0,,,,2,1,2,3
60729_0,,,,2,1,2,3
60730_0,,,,2,1,2,3
60731_0,,,,2,1,2,3
60732_0,,,,2,1,2,3
60733_0,,,,2,1,2,3
60734_0,,,,2,1,2,3
60735_0,,,,2,1,2,3
60736_0,,,,2,1,2,3
60737_0,,,,2,1,2,3
60738_0,,,,2,1,2,3
60739_0,,,,2,1,2,3
60740_0,,,,2,1,2,3
60741_0,,,,2,1,2,3
60742_0,,,,2,1,2,3
60743_0,,,,2,1,2,3
60744_0,,,,2,1,2,3
60745_0,,,,2,1,2,3
60746_0,,,,2,1,2,3
60747_0,,,,2,1,2,3
60749_0,,,,2,1,1,2
C(CC)(OC(C(C=CC=O)=O)=O)=O,,,5,1,1,0,1
60750_0,,,,2,1,2,3
60752_0,,,,2,1,2,3
C(CC1C(C(OC(C=1)=O)=O)=O)=O,,,5,1,1,0,1
60754_0,,,,2,1,1,2
C(C=C(C(OC(C(C)=O)=O)=O)C)=O,,,5,1,1,0,1
60756_0,,,,2,1,2,3
C(C=C1C(OC(C(C1)=O)=O)=O)=O,,,5,1,1,0,1
60757_0,,,,2,1,2,3
60759_0,,,,2,1,2,3
C(CC1C(OC(C(C=1)=O)=O)=O)=O,,,5,1,1,0,1
60760_0,,,,2,1,2,3
60761_0,,,,2,1,2,3
60762_0,,,,2,1,2,3
60763_0,,,,2,1,2,3
60764_0,,,,2,1,2,3
60765_0,,,,2,1,2,3
60766_0,,,,2,1,2,3
60767_0,,,,2,1,2,3
60768_0,,,,2,1,2,3
60769_0,,,,2,1,2,3
60770_0,,,,2,1,2,3
60771_0,,,,2,1,2,3
60772_0,,,,2,1,2,3
60773_0,,,,2,1,2,3
60774_0,,,,2,1,2,3
60775_0,,,,2,1,2,3
60776_0,,,,2,1,2,3
60777_0,,,,2,1,2,3
60778_0,,,,2,1,2,3
60779_0,,,,2,1,2,3
60780_0,,,,2,1,2,3
60781_0,,,,2,1,2,3
60782_0,,,,2,1,2,3
60783_0,,,,2,1,2,3
60784_0,,,,2,1,2,3
60785_0,,,,2,1,2,3
60786_0,,,,2,1,2,3
60787_0,,,,2,1,2,3
60788_0,,,,2,1,2,3
60789_0,,,,2,1,2,3
60790_0,,,,2,1,2,3
60791_0,,,,2,1,2,3
60792_0,,,,2,1,2,3
60793_0,,,,2,1,2,3
60794_0,,,,2,1,2,3
60795_0,,,,2,1,2,3
60796_0,,,,2,1,2,3
60797_0,,,,2,1,2,3
60798_0,,,,2,1,2,3
60799_0,,,,2,1,2,3
60800_0,,,,2,1,2,3
60801_0,,,,2,1,2,3
60802_0,,,,2,1,2,3
60803_0,,,,2,1,2,3
60804_0,,,,2,1,2,3
60805_0,,,,2,1,2,3
60806_0,,,,2,1,2,3
60807_0,,,,2,1,2,3
60808_0,,,,2,1,2,3
60809_0,,,,2,1,2,3
60810_0,,,,2,1,2,3
60811_0,,,,2,1,2,3
60812_0,,,,2,1,2,3
60813_0,,,,2,1,2,3
60814_0,,,,2,1,2,3
60815_0,,,,2,1,2,3
60817_0,,,,2,1,2,3
C(CCC(C(O)=O)=C)=O,,,5,1,2,0,2
60818_0,,,,2,1,2,3
60819_0,,,,2,1,2,3
60820_0,,,,2,1,2,3
60821_0,,,,2,1,2,3
60822_0,,,,2,1,2,3
60823_0,,,,2,1,2,3
60824_0,,,,2,1,2,3
60825_0,,,,2,1,2,3
60826_0,,,,2,1,2,3
60827_0,,,,2,1,2,3
60828_0,,,,2,1,2,3
60829_0,,,,2,1,2,3
60831_0,,,,2,4,3,7
C(C(C)(C([C](C(O)=O)O)CO)O)=O,,,5,1,1,0,1
60833_0,,,,2,4,3,7
C(C(C([C](C(O)=O)O)CO)O)(C)=O,,,5,1,1,0,1
60834_0,,,,2,4,3,7
60836_0,,,,2,4,3,7
C(C(CCO)(C[C](C(O)=O)O)O)=O,,,5,1,1,0,1
60838_0,,,,2,4,3,7
[C](C(O)=O)(C(CO)C(CCO)O)O,,,5,1,1,0,1
60839_0,,,,2,4,3,7
60841_0,,,,2,4,3,7
C=CC([C](C(O)=O)O)C(CCO)O,,,5,1,1,0,1
60842_0,,,,2,4,3,7
60844_0,,,,2,4,3,7
[C](C(O)=O)(CC(CCO)O)O,,,5,1,1,0,1
60845_0,,,,2,4,3,7
60847_0,,,,2,4,3,7
C(C(C([C](C(O)=O)O)CO)O)=O,,,5,1,1,0,1
60849_0,,,,2,4,3,7
[C](C(O)=O)(C(CO)C(C)(CO)O)O,,,5,1,1,0,1
60851_0,,,,2,4,3,7
C(C)=CC(C([C](C(O)=O)O)CO)O,,,5,1,1,0,1
60853_0,,,,2,4,3,7
C=CCC(C([C](C(O)=O)O)CO)O,,,5,1,1,0,1
60855_0,,,,2,4,3,7
[C](C(O)=O)(C(CO)C(CO)O)O,,,5,1,1,0,1
60857_0,,,,2,4,3,7
[C](C(O)=O)(C(CO)C(C(C)O)O)O,,,5,1,1,0,1
60859_0,,,,2,4,3,7
C(C(C([C](C(O)=O)O)CO)O)(O)=O,,,5,1,1,0,1
60861_0,,,,2,4,3,7
[C](C(O)=O)(C(CO)CO)O,,,5,1,1,0,1
60862_0,,,,2,4,3,7
60863_0,,,,2,4,3,7
60864_0,,,,2,4,3,7
60865_0,,,,2,4,3,7
60866_0,,,,2,4,3,7
60867_0,,,,2,4,3,7
60868_0,,,,2,4,3,7
60869_0,,,,2,4,3,7
60870_0,,,,2,4,3,7
60871_0,,,,2,4,3,7
60872_0,,,,2,4,3,7
60873_0,,,,2,4,3,7
60874_0,,,,2,4,3,7
60875_0,,,,2,4,3,7
60876_0,,,,2,4,3,7
60877_0,,,,2,4,3,7
60878_0,,,,2,4,3,7
60879_0,,,,2,4,3,7
60880_0,,,,2,4,3,7
60881_0,,,,2,4,3,7
60882_0,,,,2,4,3,7
60883_0,,,,2,4,3,7
60884_0,,,,2,4,3,7
60885_0,,,,2,4,3,7
60886_0,,,,2,4,3,7
60888_0,,,,2,4,3,7
C(C(C(C=C)[C](C(O)=O)O)O)=O,,,5,1,1,0,1
60890_0,,,,2,4,3,7
C(C(C([C](C(O)=O)O)C(C)O)O)=O,,,5,1,1,0,1
60891_0,,,,2,4,3,7
60892_0,,,,2,4,3,7
60893_0,,,,2,4,3,7
60894_0,,,,2,4,3,7
60895_0,,,,2,4,3,7
60897_0,,,,2,4,3,7
C(C(C(C[C](C(O)=O)O)O)O)(O)=O,,,5,1,1,0,1
60898_0,,,,2,4,3,7
60899_0,,,,2,4,3,7
60901_0,,,,2,4,3,7
C=CC([C](C(O)=O)O)C(C)(CO)O,,,5,1,1,0,1
60902_0,,,,2,4,3,7
60903_0,,,,2,4,3,7
60905_0,,,,2,4,3,7
C=CC([C](C(O)=O)O)C(C=CC)O,,,5,1,1,0,1
60906_0,,,,2,4,3,7
60907_0,,,,2,4,3,7
60909_0,,,,2,4,3,7
C=CC([C](C(O)=O)O)C(CC=C)O,,,5,1,1,0,1
60910_0,,,,2,4,3,7
60911_0,,,,2,4,3,7
60913_0,,,,2,4,3,7
C=CC([C](C(O)=O)O)C(CO)O,,,5,1,1,0,1
60915_0,,,,2,4,3,7
C=CC([C](C(O)=O)O)C(C(C)O)O,,,5,1,1,0,1
60917_0,,,,2,4,3,7
C(C(C(C=C)[C](C(O)=O)O)O)(O)=O,,,5,1,1,0,1
60918_0,,,,2,4,3,7
60919_0,,,,2,4,3,7
60921_0,,,,2,4,3,7
C(C(C)(C(C=C)[C](C(O)=O)O)O)=O,,,5,1,1,0,1
60923_0,,,,2,4,3,7
C(C)(C(C(C=C)[C](C(O)=O)O)O)=O,,,5,1,1,0,1
60924_0,,,,2,4,3,7
60925_0,,,,2,4,3,7
60926_0,,,,2,4,3,7
60928_0,,,,2,4,3,7
[C](C(O)=O)(C(C(CO)O)C(C)O)O,,,5,1,1,0,1
60929_0,,,,2,4,3,7
60930_0,,,,2,4,3,7
60932_0,,,,2,4,3,7
[C](C(O)=O)(CC(CO)O)O,,,5,1,1,0,1
60933_0,,,,2,4,3,7
60934_0,,,,2,4,3,7
60935_0,,,,2,4,3,7
60937_0,,,,2,4,3,7
[C](C(O)=O)(CC(C(C)O)O)O,,,5,1,1,0,1
60938_0,,,,2,4,3,7
60939_0,,,,2,4,3,7
60940_0,,,,2,4,3,7
60941_0,,,,2,4,3,7
60942_0,,,,2,4,3,7
60943_0,,,,2,4,3,7
60944_0,,,,2,4,3,7
60945_0,,,,2,4,3,7
60946_0,,,,2,4,3,7
60947_0,,,,2,4,3,7
60948_0,,,,2,4,3,7
60950_0,,,,2,4,3,7
[C](C(O)=O)(O)O,,,5,1,1,0,1
60952_0,,,,2,4,3,7
[C](C(O)=O)(C(CO)(CO)C(C)O)O,,,5,1,1,0,1
60953_0,,,,2,4,3,7
60954_0,,,,2,4,3,7
60956_0,,,,2,4,3,7
[C](C(O)=O)(C(CO)(C(C)O)O)O,,,5,1,1,0,1
60957_0,,,,2,4,3,7
60958_0,,,,2,4,3,7
60960_0,,,,2,4,3,7
[C](C(O)=O)(C(C(C)O)(C(C)O)O)O,,,5,1,1,0,1
60961_0,,,,2,4,3,7
60962_0,,,,2,4,3,7
60963_0,,,,2,4,3,7
60964_0,,,,2,4,3,7
60965_0,,,,2,4,3,7
60967_0,,,,2,4,3,7
C(C(C)O)(OC[C](C(O)=O)O)=O,,,5,1,1,0,1
60968_0,,,,2,4,3,7
60969_0,,,,2,4,3,7
60970_0,,,,2,4,3,7
60971_0,,,,2,4,3,7
60972_0,,,,2,4,3,7
60973_0,,,,2,4,3,7
60974_0,,,,2,4,3,7
60975_0,,,,2,4,3,7
60976_0,,,,2,4,3,7
60977_0,,,,2,4,3,7
60978_0,,,,2,4,3,7
60979_0,,,,2,4,3,7
60980_0,,,,2,4,3,7
60981_0,,,,2,4,3,7
60982_0,,,,2,4,3,7
60984_0,,,,2,4,3,7
[C](C(O)=O)(CCC(C)O)O,,,5,1,1,0,1
60985_0,,,,2,4,3,7
60986_0,,,,2,4,3,7
60988_0,,,,2,4,3,7
C(C([C](C(O)=O)O)C)=O,,,5,1,1,0,1
60990_0,,,,2,4,3,7
[C](C(O)=O)(CC)O,,,5,1,1,0,1
60992_0,,,,2,4,3,7
C(C([C](C(O)=O)O)C)(O)=O,,,5,1,1,0,1
60993_0,,,,2,4,3,7
60994_0,,,,2,4,3,7
60995_0,,,,2,4,3,7
60996_0,,,,2,4,3,7
60997_0,,,,2,4,3,7
60998_0,,,,2,4,3,7
60999_0,,,,2,4,3,7
61000_0,,,,2,4,3,7
61001_0,,,,2,4,3,7
61002_0,,,,2,4,3,7
61003_0,,,,2,4,3,7
61004_0,,,,2,4,3,7
61005_0,,,,2,4,3,7
61006_0,,,,2,4,3,7
61007_0,,,,2,4,3,7
61008_0,,,,2,4,3,7
61009_0,,,,2,4,3,7
61010_0,,,,2,4,3,7
61011_0,,,,2,4,3,7
61012_0,,,,2,4,3,7
61013_0,,,,2,4,3,7
61014_0,,,,2,4,3,7
61015_0,,,,2,4,3,7
61016_0,,,,2,4,3,7
61017_0,,,,2,4,3,7
61018_0,,,,2,4,3,7
61019_0,,,,2,4,3,7
61020_0,,,,2,4,3,7
61021_0,,,,2,4,3,7
61022_0,,,,2,4,3,7
61023_0,,,,2,4,3,7
61024_0,,,,2,4,3,7
61026_0,,,,2,4,3,7
C1(C(C)(C([C](C(O)=O)O)CO1)O)=O,,,5,1,1,0,1
61027_0,,,,2,4,3,7
61028_0,,,,2,4,3,7
61029_0,,,,2,4,3,7
61031_0,,,,2,4,3,7
C(CC(C(C)C[C](C(O)=O)O)O)=O,,,5,1,1,0,1
61032_0,,,,2,4,3,7
61033_0,,,,2,4,3,7
61034_0,,,,2,4,3,7
61035_0,,,,2,4,3,7
61036_0,,,,2,4,3,7
61037_0,,,,2,4,3,7
61038_0,,,,2,4,3,7
61040_0,,,,2,4,3,7
C(CO)(CC(C)C[C](C(O)=O)O)=O,,,5,1,1,0,1
61042_0,,,,2,4,3,7
C(C)(C(C(C)C[C](C(O)=O)O)O)=O,,,5,1,1,0,1
61044_0,,,,2,4,3,7
[C](C(O)=O)(CC(C)CO)O,,,5,1,1,0,1
61045_0,,,,2,4,3,7
61047_0,,,,2,4,3,7
C(C(C)(CO)C[C](C(O)=O)O)(O)=O,,,5,1,1,0,1
61048_0,,,,2,4,3,7
61049_0,,,,2,4,3,7
61051_0,,,,2,4,3,7
[C](C(O)=O)(CC(C)C(C)O)O,,,5,1,1,0,1
61052_0,,,,2,4,3,7
61054_0,,,,2,4,3,7
C(CC(C)C[C](C(O)=O)O)=CC=O,,,5,1,1,0,1
61055_0,,,,2,4,3,7
61056_0,,,,2,4,3,7
61057_0,,,,2,4,3,7
61058_0,,,,2,4,3,7
61060_0,,,,2,4,3,7
C(C(C=C)C(C)C[C](C(O)=O)O)=O,,,5,1,1,0,1
61061_0,,,,2,4,3,7
61062_0,,,,2,4,3,7
61064_0,,,,2,4,3,7
C(C(C(C)C[C](C(O)=O)O)O)=O,,,5,1,1,0,1
61066_0,,,,2,4,3,7
C(C(CC(C)C[C](C(O)=O)O)O)=O,,,5,1,1,0,1
61068_0,,,,2,4,3,7
C(C(C)(C(C)C[C](C(O)=O)O)O)=O,,,5,1,1,0,1
61069_0,,,,2,4,3,7
61071_0,,,,2,4,3,7
C(C(C(C)C[C](C(O)=O)O)O)(O)=O,,,5,1,1,0,1
61072_0,,,,2,4,3,7
61073_0,,,,2,4,3,7
61074_0,,,,2,4,3,7
61076_0,,,,2,4,3,7
C([C](C=CC(O)=O)O)(O)=O,,,5,1,1,0,1
61077_0,,,,2,4,3,7
61078_0,,,,2,4,3,7
61079_0,,,,2,4,3,7
61080_0,,,,2,4,3,7
61081_0,,,,2,4,3,7
61082_0,,,,2,4,3,7
61083_0,,,,2,4,3,7
61084_0,,,,2,4,3,7
61085_0,,,,2,4,3,7
61086_0,,,,2,4,4,8
61087_0,,,,2,4,4,8
61088_0,,,,2,4,4,8
61089_0,,,,2,4,4,8
61090_0,,,,2,4,4,8
61091_0,,,,2,4,4,8
61092_0,,,,2,4,4,8
61093_0,,,,2,4,4,8
61094_0,,,,2,4,4,8
61095_0,,,,2,4,4,8
61096_0,,,,2,4,4,8
61097_0,,,,2,4,4,8
61098_0,,,,2,4,4,8
61099_0,,,,2,4,4,8
61100_0,,,,2,4,4,8
61101_0,,,,2,4,4,8
61102_0,,,,2,4,4,8
61103_0,,,,2,4,4,8
61104_0,,,,2,4,4,8
61105_0,,,,2,4,4,8
61106_0,,,,2,4,4,8
61107_0,,,,2,4,4,8
61108_0,,,,2,4,4,8
61109_0,,,,2,4,4,8
61110_0,,,,2,4,4,8
61111_0,,,,2,4,4,8
61112_0,,,,2,4,4,8
61113_0,,,,2,4,4,8
61114_0,,,,2,4,4,8
61115_0,,,,2,4,4,8
61116_0,,,,2,4,4,8
61117_0,,,,2,4,4,8
61118_0,,,,2,4,4,8
61119_0,,,,2,4,4,8
61120_0,,,,2,4,4,8
61121_0,,,,2,4,4,8
61122_0,,,,2,4,4,8
61123_0,,,,2,4,4,8
61124_0,,,,2,4,4,8
61125_0,,,,2,4,4,8
61126_0,,,,2,4,4,8
61127_0,,,,2,4,4,8
61128_0,,,,2,4,4,8
61129_0,,,,2,4,4,8
61130_0,,,,2,4,4,8
61131_0,,,,2,4,4,8
61132_0,,,,2,4,4,8
61133_0,,,,2,4,4,8
61134_0,,,,2,4,4,8
61135_0,,,,2,4,4,8
61136_0,,,,2,4,4,8
61137_0,,,,2,4,4,8
61138_0,,,,2,4,4,8
61139_0,,,,2,4,4,8
61140_0,,,,2,4,4,8
61141_0,,,,2,4,4,8
61142_0,,,,2,4,4,8
61143_0,,,,2,4,4,8
61144_0,,,,2,4,4,8
61145_0,,,,2,4,4,8
61146_0,,,,2,4,4,8
61147_0,,,,2,4,4,8
61148_0,,,,2,4,4,8
61149_0,,,,2,4,4,8
61150_0,,,,2,4,4,8
61151_0,,,,2,4,4,8
61152_0,,,,2,4,4,8
61153_0,,,,2,4,4,8
61154_0,,,,2,4,4,8
61155_0,,,,2,4,4,8
61156_0,,,,2,4,4,8
61157_0,,,,2,4,4,8
61158_0,,,,2,4,4,8
61159_0,,,,2,4,4,8
61160_0,,,,2,4,4,8
61161_0,,,,2,4,4,8
61162_0,,,,2,4,4,8
61163_0,,,,2,4,4,8
61164_0,,,,2,4,4,8
61165_0,,,,2,4,4,8
61166_0,,,,2,4,4,8
61167_0,,,,2,4,4,8
61168_0,,,,2,4,4,8
61169_0,,,,2,4,4,8
61170_0,,,,2,4,4,8
61171_0,,,,2,4,4,8
61172_0,,,,2,4,4,8
61173_0,,,,2,4,4,8
61174_0,,,,2,4,4,8
61175_0,,,,2,4,4,8
61176_0,,,,2,4,4,8
61177_0,,,,2,4,4,8
61178_0,,,,2,4,4,8
61179_0,,,,2,4,4,8
61180_0,,,,2,4,4,8
61181_0,,,,2,4,4,8
61182_0,,,,2,4,4,8
61183_0,,,,2,4,4,8
61184_0,,,,2,4,4,8
61185_0,,,,2,4,4,8
61186_0,,,,2,4,4,8
61187_0,,,,2,4,4,8
61188_0,,,,2,4,4,8
61189_0,,,,2,4,4,8
61190_0,,,,2,4,4,8
61191_0,,,,2,4,4,8
61192_0,,,,2,4,4,8
61193_0,,,,2,4,4,8
61194_0,,,,2,4,4,8
61195_0,,,,2,4,4,8
61196_0,,,,2,4,4,8
61197_0,,,,2,4,4,8
61198_0,,,,2,4,4,8
61199_0,,,,2,4,4,8
61200_0,,,,2,4,4,8
61201_0,,,,2,4,4,8
61202_0,,,,2,4,4,8
61203_0,,,,2,4,4,8
61204_0,,,,2,4,4,8
61205_0,,,,2,4,4,8
61206_0,,,,2,4,4,8
61207_0,,,,2,4,4,8
61208_0,,,,2,4,4,8
61209_0,,,,2,4,4,8
61210_0,,,,2,4,4,8
61211_0,,,,2,4,4,8
61212_0,,,,2,4,4,8
61213_0,,,,2,4,4,8
61214_0,,,,2,4,4,8
61215_0,,,,2,4,4,8
61216_0,,,,2,4,4,8
61217_0,,,,2,4,4,8
61218_0,,,,2,4,4,8
61219_0,,,,2,4,4,8
61220_0,,,,2,4,4,8
61221_0,,,,2,4,4,8
61222_0,,,,2,4,4,8
61223_0,,,,2,4,4,8
61224_0,,,,2,4,4,8
61225_0,,,,2,4,4,8
61226_0,,,,2,4,4,8
61227_0,,,,2,4,4,8
61228_0,,,,2,4,4,8
61229_0,,,,2,4,4,8
61230_0,,,,2,4,4,8
61231_0,,,,2,4,4,8
61232_0,,,,2,4,4,8
61233_0,,,,2,4,4,8
61234_0,,,,2,4,4,8
61235_0,,,,2,4,4,8
61236_0,,,,2,4,4,8
61237_0,,,,2,4,4,8
61238_0,,,,2,4,4,8
61240_0,,,,2,2,2,4
C(C(CCC(CC(C)O)O)O)(O)=O,,,5,1,1,0,1
61242_0,,,,2,2,2,4
C(C(CC(CO)C(C)O)O)(O)=O,,,5,1,1,0,1
61244_0,,,,2,2,2,4
C(C(CC(C(C)O)C(C)O)O)(O)=O,,,5,1,1,0,1
61245_0,,,,2,2,2,4
61247_0,,,,2,2,2,4
C(CC(CCC(C(O)=O)O)O)(O)=O,,,5,1,1,0,1
61248_0,,,,2,2,2,4
61249_0,,,,2,2,2,4
61251_0,,,,2,2,2,4
C(C(CCC(C(CO)=O)O)O)(O)=O,,,5,1,1,0,1
61252_0,,,,2,2,2,4
61254_0,,,,2,2,2,4
C(C(CO)(CCC(C(O)=O)O)O)=O,,,5,1,1,0,1
61255_0,,,,2,2,2,4
61256_0,,,,2,2,2,4
61257_0,,,,2,2,2,4
61258_0,,,,2,2,2,4
61260_0,,,,2,2,2,4
C(C(C)(CCC(C(O)=O)O)O)=O,,,5,1,1,0,1
61261_0,,,,2,2,2,4
61263_0,,,,2,2,2,4
C(C(CCC(C(C)=O)O)O)(O)=O,,,5,1,1,0,1
61264_0,,,,2,2,2,4
61266_0,,,,2,2,2,4
C(C(CC(C(C=O)=O)CO)O)(O)=O,,,5,1,1,0,1
61267_0,,,,2,2,2,4
61268_0,,,,2,2,2,4
61269_0,,,,2,2,2,4
61271_0,,,,2,2,2,4
C(C(CO)CC(C(O)=O)O)=O,,,5,1,1,0,1
61272_0,,,,2,2,2,4
61273_0,,,,2,2,2,4
61274_0,,,,2,2,2,4
61275_0,,,,2,2,2,4
61276_0,,,,2,2,2,4
61277_0,,,,2,2,2,4
61278_0,,,,2,2,2,4
61279_0,,,,2,2,2,4
61280_0,,,,2,2,2,4
61282_0,,,,2,2,2,4
C(C(CCC(CO)=O)O)(O)=O,,,5,1,1,0,1
61283_0,,,,2,2,2,4
61285_0,,,,2,2,2,4
C(C(C=C)CC(C(O)=O)O)=O,,,5,1,1,0,1
61286_0,,,,2,2,2,4
61287_0,,,,2,2,2,4
61288_0,,,,2,2,2,4
61289_0,,,,2,2,2,4
61290_0,,,,2,2,2,4
61291_0,,,,2,2,2,4
61292_0,,,,2,2,2,4
61293_0,,,,2,2,2,4
61294_0,,,,2,2,2,4
61295_0,,,,2,2,2,4
61297_0,,,,2,2,2,4
C(C(CC=CC)O)(O)=O,,,5,1,1,0,1
61299_0,,,,2,2,2,4
C(C(CCC=C)O)(O)=O,,,5,1,1,0,1
61301_0,,,,2,2,2,4
C(C(CCC(C(O)=O)=C)O)(O)=O,,,5,1,1,0,1
61303_0,,,,2,2,2,4
C(C(CC=C(C(O)=O)C)O)(O)=O,,,5,1,1,0,1
61304_0,,,,2,2,2,4
61305_0,,,,2,2,2,4
61307_0,,,,2,2,2,4
C(C(CCC[CH]C(O)=O)O)(O)=O,,,5,1,1,0,1
61309_0,,,,2,2,2,4
C(CCCCC(C(O)=O)O)(O)=O,,,5,1,1,0,1
61310_0,,,,2,2,2,4
61311_0,,,,2,2,2,4
61312_0,,,,2,2,2,4
61314_0,,,,2,2,2,4
C(C(CCC(C)O)O)(O)=O,,,5,1,2,0,2
61315_0,,,,2,2,2,4
61317_0,,,,2,2,2,4
C(C(C)(CCC(C(O)=O)O)O)(O)=O,,,5,1,1,0,1
61318_0,,,,2,2,2,4
61320_0,,,,2,2,2,4
C(C(C=O)(CC(C(O)=O)O)O)=O,,,5,1,1,0,1
61322_0,,,,2,2,2,4
C(C(C=O)(CC(C(O)=O)O)O)(O)=O,,,5,1,1,0,1
61323_0,,,,2,2,2,4
61324_0,,,,2,2,2,4
61325_0,,,,2,2,2,4
61326_0,,,,2,2,2,4
61327_0,,,,2,2,2,4
61328_0,,,,2,2,2,4
61329_0,,,,2,2,2,4
61331_0,,,,2,3,5,8
C(C(C(CC(CC(C)O)O)O)=O)=O,,,5,1,1,0,1
61332_0,,,,2,3,5,8
61333_0,,,,2,3,5,8
61335_0,,,,2,3,5,8
C(C(C(C(C(C)O)C(C)O)O)=O)=O,,,5,1,1,0,1
61336_0,,,,2,3,5,8
61338_0,,,,2,3,5,8
C(CC(CC(C(C=O)=O)O)O)(O)=O,,,5,1,1,0,1
61339_0,,,,2,3,5,8
61340_0,,,,2,3,5,8
61341_0,,,,2,3,5,8
61343_0,,,,2,3,5,8
C(CO)(C(CC(C(C=O)=O)O)O)=O,,,5,1,1,0,1
61344_0,,,,2,3,5,8
61345_0,,,,2,3,5,8
61347_0,,,,2,3,5,8
C(CC(C(C(C(C=O)=O)O)=O)O)=O,,,5,1,1,0,1
61349_0,,,,2,3,5,8
C(C(CO)(CC(C(C=O)=O)O)O)=O,,,5,1,1,0,1
61350_0,,,,2,3,5,8
61351_0,,,,2,3,5,8
61352_0,,,,2,3,5,8
61353_0,,,,2,3,5,8
61354_0,,,,2,3,5,8
61356_0,,,,2,3,5,8
C(C(C(C=O)=O)(C(C(C)O)O)O)=O,,,5,1,1,0,1
61357_0,,,,2,3,5,8
61358_0,,,,2,3,5,8
61359_0,,,,2,3,5,8
61360_0,,,,2,3,5,8
61361_0,,,,2,3,5,8
61362_0,,,,2,3,5,8
61363_0,,,,2,3,5,8
61364_0,,,,2,3,5,8
61365_0,,,,2,3,5,8
61366_0,,,,2,3,5,8
61367_0,,,,2,3,5,8
61368_0,,,,2,3,5,8
61369_0,,,,2,3,5,8
61370_0,,,,2,3,5,8
61371_0,,,,2,3,5,8
61372_0,,,,2,3,5,8
61373_0,,,,2,3,5,8
61374_0,,,,2,3,5,8
61375_0,,,,2,3,5,8
61376_0,,,,2,3,5,8
61377_0,,,,2,3,5,8
61378_0,,,,2,3,5,8
61379_0,,,,2,3,5,8
61380_0,,,,2,3,5,8
61381_0,,,,2,3,5,8
61382_0,,,,2,3,5,8
61383_0,,,,2,3,5,8
61384_0,,,,2,3,5,8
61385_0,,,,2,3,5,8
61386_0,,,,2,3,5,8
61387_0,,,,2,3,5,8
61388_0,,,,2,3,5,8
61390_0,,,,2,3,5,8
C(C(C(C(C(C(C)O)=O)=O)O)=O)=O,,,5,1,1,0,1
61392_0,,,,2,3,5,8
C(C(C(C(C=O)=O)(CO)O)=O)(O)=O,,,5,1,2,0,2
61393_0,,,,2,3,5,8
61395_0,,,,2,3,5,8
C(C(C(C(C(C(O)=O)=O)=O)O)=O)=O,,,5,1,1,0,1
61396_0,,,,2,3,5,8
61397_0,,,,2,3,5,8
61398_0,,,,2,3,5,8
61399_0,,,,2,3,5,8
61400_0,,,,2,3,5,8
61401_0,,,,2,3,5,8
61402_0,,,,2,3,5,8
61403_0,,,,2,3,5,8
61404_0,,,,2,3,5,8
61405_0,,,,2,3,5,8
61406_0,,,,2,3,5,8
61407_0,,,,2,3,5,8
61408_0,,,,2,3,5,8
61409_0,,,,2,3,5,8
61411_0,,,,2,3,5,8
C=C1C(OC(C(C1C(C=O)=O)=O)=O)=O,,,5,1,1,0,1
61412_0,,,,2,3,5,8
61413_0,,,,2,3,5,8
61414_0,,,,2,3,5,8
61415_0,,,,2,3,5,8
61416_0,,,,2,3,5,8
61417_0,,,,2,3,5,8
61418_0,,,,2,3,5,8
61420_0,,,,2,3,5,8
C(C(C(C(C=O)=O)C(C)O)=O)(O)=O,,,5,1,2,0,2
61421_0,,,,2,3,5,8
61422_0,,,,2,3,5,8
61424_0,,,,2,3,5,8
C(C(C(C=O)=O)C(C(O)=O)=O)(O)=O,,,5,1,2,0,2
61425_0,,,,2,3,5,8
61426_0,,,,2,3,5,8
61427_0,,,,2,3,5,8
61428_0,,,,2,3,5,8
61429_0,,,,2,3,5,8
61430_0,,,,2,3,5,8
61431_0,,,,2,3,5,8
61432_0,,,,2,3,5,8
61433_0,,,,2,3,5,8
61434_0,,,,2,3,5,8
61435_0,,,,2,3,5,8
61436_0,,,,2,3,5,8
61437_0,,,,2,3,5,8
61438_0,,,,2,3,5,8
61439_0,,,,2,3,5,8
61440_0,,,,2,3,5,8
61441_0,,,,2,3,5,8
61442_0,,,,2,3,5,8
61443_0,,,,2,3,5,8
61444_0,,,,2,3,5,8
61445_0,,,,2,3,5,8
61446_0,,,,2,3,5,8
61447_0,,,,2,3,5,8
61448_0,,,,2,3,5,8
61449_0,,,,2,3,5,8
61450_0,,,,2,3,5,8
61451_0,,,,2,3,5,8
61452_0,,,,2,3,5,8
61453_0,,,,2,3,5,8
61454_0,,,,2,3,5,8
61455_0,,,,2,3,5,8
61456_0,,,,2,3,5,8
61457_0,,,,2,3,5,8
61458_0,,,,2,3,5,8
61459_0,,,,2,3,5,8
61460_0,,,,2,3,5,8
61461_0,,,,2,3,5,8
61462_0,,,,2,3,5,8
61463_0,,,,2,3,5,8
61464_0,,,,2,3,5,8
61466_0,,,,2,3,5,8
C(C(C)(CC(C(C=O)=O)O)O)(O)=O,,,5,1,1,0,1
61467_0,,,,2,3,5,8
61468_0,,,,2,3,5,8
61469_0,,,,2,3,5,8
61470_0,,,,2,3,5,8
61471_0,,,,2,3,5,8
61472_0,,,,2,3,5,8
61473_0,,,,2,3,5,8
61474_0,,,,2,3,5,8
61475_0,,,,2,3,5,8
61477_0,,,,2,3,5,8
C(C(C(C=O)=O)(C(C)O)C(C)O)=O,,,5,1,1,0,1
61479_0,,,,2,3,5,8
C(C(C=O)(C(C=O)=O)C(C)O)(O)=O,,,5,1,1,0,1
61480_0,,,,2,3,5,8
61481_0,,,,2,3,5,8
61483_0,,,,2,3,5,8
C(C(C(O)=O)(C(O)=O)C(C=O)=O)=O,,,5,1,1,0,1
61484_0,,,,2,3,5,8
61486_0,,,,2,3,5,8
C(C(C(C(C=O)=O)(C(C)O)O)=O)=O,,,5,1,1,0,1
61488_0,,,,2,3,5,8
C(C(C(C=O)=O)(C(C=O)=O)O)(O)=O,,,5,1,1,0,1
61489_0,,,,2,3,5,8
61490_0,,,,2,3,5,8
61491_0,,,,2,3,5,8
61492_0,,,,2,3,5,8
61493_0,,,,2,3,5,8
61494_0,,,,2,3,5,8
61495_0,,,,2,3,5,8
61497_0,,,,2,3,5,8
C(C(C(C)=O)(C(C=O)=O)CO)(O)=O,,,5,1,1,0,1
61498_0,,,,2,3,5,8
61499_0,,,,2,3,5,8
61500_0,,,,2,3,5,8
61501_0,,,,2,3,5,8
61502_0,,,,2,3,5,8
61503_0,,,,2,3,5,8
61505_0,,,,2,3,5,8
C(CC(C(CO)=O)(C(C=O)=O)O)=O,,,5,1,1,0,1
61507_0,,,,2,3,5,8
C(C(C(C(C(CO)=O)=O)(C)O)=O)=O,,,5,1,1,0,1
61508_0,,,,2,3,5,8
61509_0,,,,2,3,5,8
61510_0,,,,2,3,5,8
61511_0,,,,2,3,5,8
61512_0,,,,2,3,5,8
61513_0,,,,2,3,5,8
61514_0,,,,2,3,5,8
61515_0,,,,2,3,5,8
61516_0,,,,2,3,5,8
61517_0,,,,2,3,5,8
61518_0,,,,2,3,5,8
61519_0,,,,2,3,5,8
61520_0,,,,2,3,5,8
61521_0,,,,2,3,5,8
61522_0,,,,2,3,5,8
61523_0,,,,2,3,5,8
61524_0,,,,2,3,5,8
61525_0,,,,2,3,5,8
61526_0,,,,2,3,5,8
61527_0,,,,2,3,5,8
61528_0,,,,2,3,5,8
61529_0,,,,2,3,5,8
61530_0,,,,2,3,5,8
61531_0,,,,2,3,5,8
61532_0,,,,2,3,5,8
61533_0,,,,2,3,5,8
61534_0,,,,2,3,5,8
61535_0,,,,2,3,5,8
61536_0,,,,2,3,5,8
61537_0,,,,2,3,5,8
61538_0,,,,2,3,5,8
61539_0,,,,2,3,5,8
61540_0,,,,2,3,5,8
61541_0,,,,2,3,5,8
61542_0,,,,2,3,5,8
61543_0,,,,2,3,5,8
61544_0,,,,2,3,5,8
61545_0,,,,2,5,3,8
61546_0,,,,2,5,3,8
61547_0,,,,2,5,3,8
61548_0,,,,2,5,3,8
61549_0,,,,2,5,3,8
61550_0,,,,2,5,3,8
61551_0,,,,2,5,3,8
61552_0,,,,2,5,3,8
61553_0,,,,2,5,3,8
61554_0,,,,2,5,3,8
61556_0,,,,2,5,3,8
C(C(C)(C(C(C)O)C(C=O)O)O)=O,,,5,1,1,0,1
61557_0,,,,2,5,3,8
61558_0,,,,2,5,3,8
61559_0,,,,2,5,3,8
61560_0,,,,2,5,3,8
61562_0,,,,2,5,3,8
C(C(C(C(C)O)C(C(C)=O)O)O)=O,,,5,1,1,0,1
61563_0,,,,2,5,3,8
61564_0,,,,2,5,3,8
61565_0,,,,2,5,3,8
61566_0,,,,2,5,3,8
61567_0,,,,2,5,3,8
61568_0,,,,2,5,3,8
61569_0,,,,2,5,3,8
61570_0,,,,2,5,3,8
61572_0,,,,2,5,3,8
C(C(C(CO)C(CCO)O)O)=O,,,5,1,1,0,1
61574_0,,,,2,5,3,8
C(C(C(CO)C(C=O)O)O)=O,,,5,1,1,0,1
61575_0,,,,2,5,3,8
61577_0,,,,2,5,3,8
C(C(C(CO)C(CO)(CO)O)O)=O,,,5,1,1,0,1
61579_0,,,,2,5,3,8
C(C(C(CO)C(CO)(C)O)O)=O,,,5,1,1,0,1
61581_0,,,,2,5,3,8
C(C(C(CO)C(C=CC)O)O)=O,,,5,1,1,0,1
61583_0,,,,2,5,3,8
C(C(C(C(CC=C)O)CO)O)=O,,,5,1,1,0,1
61585_0,,,,2,5,3,8
C(C(C(CO)C(C(CO)O)O)O)=O,,,5,1,1,0,1
61587_0,,,,2,5,3,8
C(C(C(CO)C(CO)O)O)=O,,,5,1,1,0,1
61589_0,,,,2,5,3,8
C(C(C(CO)C(C(C)O)O)O)=O,,,5,1,1,0,1
61590_0,,,,2,5,3,8
61591_0,,,,2,5,3,8
61592_0,,,,2,5,3,8
61593_0,,,,2,5,3,8
61594_0,,,,2,5,3,8
61595_0,,,,2,5,3,8
61597_0,,,,2,5,3,8
C(C(C(C(CCO)O)C(C)O)O)=O,,,5,1,1,0,1
61599_0,,,,2,5,3,8
C(C(C(C(C)O)C(C=O)O)O)=O,,,5,1,1,0,1
61601_0,,,,2,5,3,8
C(C(C(C(C)O)C(CO)(C)O)O)=O,,,5,1,1,0,1
61603_0,,,,2,5,3,8
C(C(C(C(C)O)C(C=CC)O)O)=O,,,5,1,1,0,1
61605_0,,,,2,5,3,8
C(C(C(C(CC=C)O)C(C)O)O)=O,,,5,1,1,0,1
61607_0,,,,2,5,3,8
C(C(C(C(CO)O)C(C)O)O)=O,,,5,1,1,0,1
61609_0,,,,2,5,3,8
C(C(C(C(C(C)O)O)C(C)O)O)=O,,,5,1,1,0,1
61610_0,,,,2,5,3,8
61612_0,,,,2,5,3,8
C(C(C(C(C)O)C(C)O)O)=O,,,5,1,1,0,1
61613_0,,,,2,5,3,8
61614_0,,,,2,5,3,8
61615_0,,,,2,5,3,8
61616_0,,,,2,5,3,8
61617_0,,,,2,5,3,8
61618_0,,,,2,5,3,8
61619_0,,,,2,5,3,8
61620_0,,,,2,5,3,8
61621_0,,,,2,5,3,8
61622_0,,,,2,5,3,8
61623_0,,,,2,5,3,8
61624_0,,,,2,5,3,8
61625_0,,,,2,5,3,8
61626_0,,,,2,5,3,8
61627_0,,,,2,5,3,8
61628_0,,,,2,5,3,8
61629_0,,,,2,5,3,8
61630_0,,,,2,5,3,8
61631_0,,,,2,5,3,8
61632_0,,,,2,5,3,8
61633_0,,,,2,5,3,8
61634_0,,,,2,5,3,8
61635_0,,,,2,5,3,8
61636_0,,,,2,5,3,8
61637_0,,,,2,5,3,8
61638_0,,,,2,5,3,8
61639_0,,,,2,5,3,8
61640_0,,,,2,5,3,8
61641_0,,,,2,5,3,8
61642_0,,,,2,5,3,8
61643_0,,,,2,5,3,8
61644_0,,,,2,5,3,8
61645_0,,,,2,5,3,8
61646_0,,,,2,5,3,8
61647_0,,,,2,5,3,8
61648_0,,,,2,5,3,8
61649_0,,,,2,5,3,8
61650_0,,,,2,5,3,8
61651_0,,,,2,5,3,8
61652_0,,,,2,5,3,8
61653_0,,,,2,5,3,8
61654_0,,,,2,5,3,8
61655_0,,,,2,5,3,8
61656_0,,,,2,5,3,8
61657_0,,,,2,5,3,8
61658_0,,,,2,5,3,8
61659_0,,,,2,5,3,8
61660_0,,,,2,5,3,8
61661_0,,,,2,5,3,8
61662_0,,,,2,5,3,8
61663_0,,,,2,5,3,8
61664_0,,,,2,5,3,8
61665_0,,,,2,5,3,8
61666_0,,,,2,5,3,8
61667_0,,,,2,5,3,8
61668_0,,,,2,5,3,8
61669_0,,,,2,5,3,8
61670_0,,,,2,5,3,8
61671_0,,,,2,5,3,8
61672_0,,,,2,5,3,8
61673_0,,,,2,5,3,8
61674_0,,,,2,5,3,8
61675_0,,,,2,5,3,8
61676_0,,,,2,5,3,8
61677_0,,,,2,5,3,8
61678_0,,,,2,5,3,8
61679_0,,,,2,5,3,8
61680_0,,,,2,5,3,8
61681_0,,,,2,5,3,8
61682_0,,,,2,5,3,8
61683_0,,,,2,5,3,8
61684_0,,,,2,5,3,8
61685_0,,,,2,5,3,8
61686_0,,,,2,5,3,8
61687_0,,,,2,5,3,8
61688_0,,,,2,5,3,8
61689_0,,,,2,5,3,8
61690_0,,,,2,5,3,8
61691_0,,,,2,5,3,8
61692_0,,,,2,5,3,8
61693_0,,,,2,5,3,8
61694_0,,,,2,5,3,8
61695_0,,,,2,5,3,8
61696_0,,,,2,5,3,8
61697_0,,,,2,5,3,8
61698_0,,,,2,5,3,8
61699_0,,,,2,5,3,8
61700_0,,,,2,5,3,8
61701_0,,,,2,5,3,8
61702_0,,,,2,5,3,8
61703_0,,,,2,5,3,8
61704_0,,,,2,5,3,8
61705_0,,,,2,5,3,8
61706_0,,,,2,5,3,8
61707_0,,,,2,5,3,8
61708_0,,,,2,5,3,8
61709_0,,,,2,5,3,8
61710_0,,,,2,5,3,8
61711_0,,,,2,5,3,8
61712_0,,,,2,5,3,8
61713_0,,,,2,5,3,8
61714_0,,,,2,5,3,8
61715_0,,,,2,5,3,8
61716_0,,,,2,5,3,8
61717_0,,,,2,5,3,8
61718_0,,,,2,5,3,8
61719_0,,,,2,5,3,8
61720_0,,,,2,5,3,8
61721_0,,,,2,5,3,8
61722_0,,,,2,5,3,8
61723_0,,,,2,5,3,8
61724_0,,,,2,5,3,8
61725_0,,,,2,5,3,8
61726_0,,,,2,5,3,8
61727_0,,,,2,5,3,8
61728_0,,,,2,5,3,8
61729_0,,,,2,5,3,8
61730_0,,,,2,5,3,8
61731_0,,,,2,5,3,8
61732_0,,,,2,5,3,8
61733_0,,,,2,5,3,8
61734_0,,,,2,5,3,8
61735_0,,,,2,5,3,8
61736_0,,,,2,5,3,8
61737_0,,,,2,5,3,8
61738_0,,,,2,5,3,8
61739_0,,,,2,5,3,8
61740_0,,,,2,5,3,8
61741_0,,,,2,5,3,8
61742_0,,,,2,5,3,8
61743_0,,,,2,5,3,8
61744_0,,,,2,5,3,8
61745_0,,,,2,5,3,8
61746_0,,,,2,5,3,8
61747_0,,,,2,5,3,8
61748_0,,,,2,5,3,8
61749_0,,,,2,5,3,8
61750_0,,,,2,5,3,8
61751_0,,,,2,5,3,8
61752_0,,,,2,5,3,8
61753_0,,,,2,5,3,8
61754_0,,,,2,5,3,8
61755_0,,,,2,5,3,8
61756_0,,,,2,5,3,8
61757_0,,,,2,5,3,8
61758_0,,,,2,5,3,8
61759_0,,,,2,5,3,8
61760_0,,,,2,5,3,8
61761_0,,,,2,5,3,8
61762_0,,,,2,5,3,8
61763_0,,,,2,5,3,8
61764_0,,,,2,5,3,8
61765_0,,,,2,5,3,8
61766_0,,,,2,5,3,8
61767_0,,,,2,5,3,8
61768_0,,,,2,5,3,8
61769_0,,,,2,3,5,8
61770_0,,,,2,3,5,8
61771_0,,,,2,3,5,8
61772_0,,,,2,3,5,8
61774_0,,,,2,3,5,8
C(CC(C(CC(C(O)=O)=O)=O)O)=O,,,5,1,1,0,1
61775_0,,,,2,3,5,8
61776_0,,,,2,3,5,8
61777_0,,,,2,3,5,8
61778_0,,,,2,3,5,8
61779_0,,,,2,3,5,8
61781_0,,,,2,3,5,8
C(C(C(C(C(O)=O)=O)CO)=O)(O)=O,,,5,1,1,0,1
61783_0,,,,2,3,5,8
C(C(C(C(O)=O)=O)(CC=O)O)(O)=O,,,5,1,1,0,1
61785_0,,,,2,3,5,8
C(C(C(C(O)=O)=O)C(C(C)=O)=O)=O,,,5,1,1,0,1
61787_0,,,,2,3,5,8
C(CC(C(CC(C(O)=O)=O)=O)=O)=O,,,5,1,1,0,1
61788_0,,,,2,3,5,8
61790_0,,,,2,3,5,8
C(C(CC(C(C(O)=O)=O)=O)=O)(O)=O,,,5,1,1,0,1
61791_0,,,,2,3,5,8
61792_0,,,,2,3,5,8
61793_0,,,,2,3,5,8
61794_0,,,,2,3,5,8
61795_0,,,,2,3,5,8
61796_0,,,,2,3,5,8
61797_0,,,,2,3,5,8
61798_0,,,,2,3,5,8
61799_0,,,,2,3,5,8
61800_0,,,,2,3,5,8
61801_0,,,,2,3,5,8
61802_0,,,,2,3,5,8
61803_0,,,,2,3,5,8
61804_0,,,,2,3,5,8
61805_0,,,,2,3,5,8
61806_0,,,,2,3,5,8
61807_0,,,,2,3,5,8
61808_0,,,,2,3,5,8
61809_0,,,,2,3,5,8
61810_0,,,,2,3,5,8
61812_0,,,,2,3,5,8
C(CC(C(O)=O)=O)(C(C(O)=O)C)=O,,,5,1,1,0,1
61814_0,,,,2,3,5,8
C(C(C=C)C(C(O)=O)=O)=O,,,5,1,1,0,1
61816_0,,,,2,3,5,8
C=CC(C(C(O)=O)=O)C(C(O)=O)=O,,,5,1,1,0,1
61818_0,,,,2,3,5,8
C(C(C(C(O)=O)=O)C(C(O)=O)=C)=O,,,5,1,1,0,1
61819_0,,,,2,3,5,8
61821_0,,,,2,3,5,8
C1(C(C(C(C(O)=O)=O)C(C)O1)=O)=O,,,5,1,1,0,1
61823_0,,,,2,3,5,8
C1(C(C(C(O1)=O)=O)C(C(O)=O)=O)=O,,,5,1,1,0,1
61824_0,,,,2,3,5,8
61825_0,,,,2,3,5,8
61826_0,,,,2,3,5,8
61827_0,,,,2,3,5,8
61828_0,,,,2,3,5,8
61829_0,,,,2,3,5,8
61830_0,,,,2,3,5,8
61831_0,,,,2,3,5,8
61832_0,,,,2,3,5,8
61833_0,,,,2,3,5,8
61834_0,,,,2,3,5,8
61835_0,,,,2,3,5,8
61836_0,,,,2,3,5,8
61837_0,,,,2,3,5,8
61838_0,,,,2,3,5,8
61839_0,,,,2,3,5,8
61840_0,,,,2,3,5,8
61841_0,,,,2,3,5,8
61842_0,,,,2,3,5,8
61843_0,,,,2,3,5,8
61844_0,,,,2,3,5,8
61845_0,,,,2,3,5,8
61846_0,,,,2,3,5,8
61847_0,,,,2,3,5,8
61848_0,,,,2,3,5,8
61849_0,,,,2,3,5,8
61850_0,,,,2,3,5,8
61851_0,,,,2,3,5,8
61852_0,,,,2,3,5,8
61854_0,,,,2,3,5,8
C(C(C=O)(C(C(O)=O)=O)O)=O,,,5,1,1,0,1
61855_0,,,,2,3,5,8
61856_0,,,,2,3,5,8
61857_0,,,,2,3,5,8
61858_0,,,,2,3,5,8
61859_0,,,,2,3,5,8
61860_0,,,,2,3,5,8
61861_0,,,,2,3,5,8
61862_0,,,,2,3,5,8
61863_0,,,,2,3,5,8
61864_0,,,,2,3,5,8
61865_0,,,,2,3,5,8
61867_0,,,,2,3,5,8
C(C)(C(C(O)=O)(C(C(O)=O)=O)C)=O,,,5,1,1,0,1
61868_0,,,,2,3,5,8
61870_0,,,,2,3,5,8
C(C(C(C(CO)C(C)O)O)=O)(O)=O,,,5,1,1,0,1
61871_0,,,,2,3,5,8
61873_0,,,,2,3,5,8
C(C(C)(CC(C(C(O)=O)=O)O)O)=O,,,5,1,1,0,1
61875_0,,,,2,3,5,8
C(CC(C(C)=O)(C(C(O)=O)=O)O)=O,,,5,1,1,0,1
61877_0,,,,2,3,5,8
C(C)(C(CC(C(C(O)=O)=O)O)O)=O,,,5,1,1,0,1
61879_0,,,,2,3,5,8
C(C(C(C(O)=O)=O)(CCO)O)=O,,,5,1,1,0,1
61881_0,,,,2,3,5,8
C(C(C(C(O)=O)=O)(CC(C)O)O)=O,,,5,1,1,0,1
61883_0,,,,2,3,5,8
C(C(C(C(O)=O)=O)(CC(O)=O)O)=O,,,5,1,1,0,1
61884_0,,,,2,3,5,8
61886_0,,,,2,3,5,8
C(C(C(C(O)=O)=O)(CCO)O)(O)=O,,,5,1,1,0,1
61888_0,,,,2,3,5,8
C(CC=O)(C(C(C(O)=O)=O)(C)O)=O,,,5,1,1,0,1
61889_0,,,,2,3,5,8
61890_0,,,,2,3,5,8
61891_0,,,,2,3,5,8
61893_0,,,,2,3,5,8
C(C(C(C(C(O)=O)=O)(C)O)=O)(O)=O,,,5,1,1,0,1
61894_0,,,,2,3,5,8
61896_0,,,,2,3,5,8
C(C(C)C(C(C(O)=O)=O)(C)O)(O)=O,,,5,1,1,0,1
61897_0,,,,2,3,5,8
61898_0,,,,2,3,5,8
61900_0,,,,2,3,5,8
C(C(C=CC)(C(C(O)=O)=O)O)(O)=O,,,5,1,1,0,1
61902_0,,,,2,3,5,8
C(C(C(C(O)=O)=O)(CC=C)O)(O)=O,,,5,1,1,0,1
61904_0,,,,2,3,5,8
C=C(C(O)=O)CC(C(C(O)=O)=O)O,,,5,1,1,0,1
61906_0,,,,2,3,5,8
C(C(C(C(O)=O)=O)O)=C(C(O)=O)C,,,5,1,1,0,1
61907_0,,,,2,3,5,8
61909_0,,,,2,3,5,8
C1(C(C(C(O)=O)=O)(CC(C)O1)O)=O,,,5,1,1,0,1
61911_0,,,,2,3,5,8
C1(C(C(C(O)=O)=O)(CC(O1)=O)O)=O,,,5,1,1,0,1
61912_0,,,,2,3,5,8
61913_0,,,,2,3,5,8
61914_0,,,,2,3,5,8
61915_0,,,,2,3,5,8
61916_0,,,,2,3,5,8
61917_0,,,,2,3,5,8
61918_0,,,,2,3,5,8
61919_0,,,,2,3,5,8
61920_0,,,,2,3,5,8
61921_0,,,,2,3,5,8
61922_0,,,,2,3,5,8
61923_0,,,,2,3,5,8
61924_0,,,,2,3,5,8
61925_0,,,,2,3,5,8
61926_0,,,,2,3,5,8
61927_0,,,,2,3,5,8
61928_0,,,,2,3,5,8
61929_0,,,,2,3,5,8
61930_0,,,,2,3,5,8
61931_0,,,,2,3,5,8
61932_0,,,,2,3,5,8
61933_0,,,,2,3,5,8
61934_0,,,,2,3,5,8
61935_0,,,,2,3,5,8
61936_0,,,,2,3,5,8
61937_0,,,,2,3,5,8
61938_0,,,,2,3,5,8
61939_0,,,,2,3,5,8
61940_0,,,,2,3,5,8
61941_0,,,,2,3,5,8
61943_0,,,,2,3,5,8
C(CC(C(C(O)=O)=O)C)=O,,,5,1,1,0,1
61945_0,,,,2,3,5,8
C(C(O)=O)(C(C)CC(C(O)=O)=O)=O,,,5,1,1,0,1
61946_0,,,,2,3,5,8
61948_0,,,,2,3,5,8
C(CC(C(O)=O)(C(C(O)=O)=O)C)=O,,,5,1,1,0,1
61950_0,,,,2,3,5,8
C(C(C(C(O)=O)=O)C(C(O)=O)C)=O,,,5,1,1,0,1
61951_0,,,,2,3,5,8
61952_0,,,,2,3,5,8
61954_0,,,,2,3,5,8
C(C([C](C(O)=O)O)=O)(O)=O,,,5,1,1,0,1
61955_0,,,,2,3,5,8
61956_0,,,,2,3,5,8
61957_0,,,,2,3,5,8
61958_0,,,,2,5,3,8
61959_0,,,,2,5,3,8
61960_0,,,,2,5,3,8
61961_0,,,,2,5,3,8
61962_0,,,,2,5,3,8
61964_0,,,,2,5,3,8
C(C(C(C=C)C(CCO)O)O)(O)=O,,,5,1,1,0,1
61965_0,,,,2,5,3,8
61966_0,,,,2,5,3,8
61967_0,,,,2,5,3,8
61968_0,,,,2,5,3,8
61969_0,,,,2,5,3,8
61970_0,,,,2,5,3,8
61971_0,,,,2,5,3,8
61972_0,,,,2,5,3,8
61973_0,,,,2,5,3,8
61974_0,,,,2,5,3,8
61975_0,,,,2,5,3,8
61976_0,,,,2,5,3,8
61977_0,,,,2,5,3,8
61978_0,,,,2,5,3,8
61979_0,,,,2,5,3,8
61980_0,,,,2,5,3,8
61981_0,,,,2,5,3,8
61982_0,,,,2,5,3,8
61983_0,,,,2,5,3,8
61985_0,,,,2,5,3,8
C(C(C(C=C)C(C=O)O)O)(O)=O,,,5,1,1,0,1
61986_0,,,,2,5,3,8
61987_0,,,,2,5,3,8
61988_0,,,,2,5,3,8
61989_0,,,,2,5,3,8
61990_0,,,,2,5,3,8
61991_0,,,,2,5,3,8
61992_0,,,,2,5,3,8
61993_0,,,,2,5,3,8
61994_0,,,,2,5,3,8
61996_0,,,,2,5,3,8
C(C(C(C=C)C(CO)(C)O)O)(O)=O,,,5,1,1,0,1
61997_0,,,,2,5,3,8
61998_0,,,,2,5,3,8
62000_0,,,,2,5,3,8
C(C(C(C=C)C(C=CC)O)O)(O)=O,,,5,1,1,0,1
62001_0,,,,2,5,3,8
62002_0,,,,2,5,3,8
62004_0,,,,2,5,3,8
C(C(C(C=C)C(CC=C)O)O)(O)=O,,,5,1,1,0,1
62005_0,,,,2,5,3,8
62006_0,,,,2,5,3,8
62008_0,,,,2,5,3,8
C(C(C(C=C)C(CO)O)O)(O)=O,,,5,1,1,0,1
62010_0,,,,2,5,3,8
C(C(C(C=C)C(C(C)O)O)O)(O)=O,,,5,1,1,0,1
62012_0,,,,2,5,3,8
C(C(C(C=C)C(C(O)=O)O)O)(O)=O,,,5,1,1,0,1
62013_0,,,,2,5,3,8
62014_0,,,,2,5,3,8
62016_0,,,,2,5,3,8
C(C(C(C=C)C(C=O)(C)O)O)(O)=O,,,5,1,1,0,1
62018_0,,,,2,5,3,8
C(C(C(C=C)C(C(C)=O)O)O)(O)=O,,,5,1,1,0,1
62019_0,,,,2,5,3,8
62020_0,,,,2,5,3,8
62021_0,,,,2,5,3,8
62022_0,,,,2,5,3,8
62023_0,,,,2,5,3,8
62024_0,,,,2,5,3,8
62025_0,,,,2,5,3,8
62026_0,,,,2,5,3,8
62027_0,,,,2,5,3,8
62028_0,,,,2,5,3,8
62029_0,,,,2,5,3,8
62030_0,,,,2,5,3,8
62031_0,,,,2,5,3,8
62032_0,,,,2,5,3,8
62033_0,,,,2,5,3,8
62034_0,,,,2,5,3,8
62035_0,,,,2,5,3,8
62036_0,,,,2,5,3,8
62037_0,,,,2,5,3,8
62038_0,,,,2,5,3,8
62039_0,,,,2,5,3,8
62040_0,,,,2,5,3,8
62041_0,,,,2,5,3,8
62042_0,,,,2,5,3,8
62043_0,,,,2,5,3,8
62044_0,,,,2,5,3,8
62045_0,,,,2,5,3,8
62046_0,,,,2,5,3,8
62047_0,,,,2,5,3,8
62048_0,,,,2,5,3,8
62049_0,,,,2,5,3,8
62050_0,,,,2,5,3,8
62051_0,,,,2,5,3,8
62053_0,,,,2,5,3,8
C(C(C)O)(OCC(C(O)=O)O)=O,,,5,1,1,0,1
62054_0,,,,2,5,3,8
62055_0,,,,2,5,3,8
62056_0,,,,2,5,3,8
62057_0,,,,2,5,3,8
62058_0,,,,2,5,3,8
62059_0,,,,2,5,3,8
62060_0,,,,2,5,3,8
62061_0,,,,2,5,3,8
62062_0,,,,2,5,3,8
62063_0,,,,2,5,3,8
62064_0,,,,2,5,3,8
62065_0,,,,2,5,3,8
62066_0,,,,2,5,3,8
62067_0,,,,2,5,3,8
62068_0,,,,2,5,3,8
62069_0,,,,2,5,3,8
62070_0,,,,2,5,3,8
62071_0,,,,2,5,3,8
62072_0,,,,2,5,3,8
62073_0,,,,2,5,3,8
62074_0,,,,2,5,3,8
62075_0,,,,2,5,3,8
62076_0,,,,2,5,3,8
62077_0,,,,2,5,3,8
62078_0,,,,2,5,3,8
62079_0,,,,2,5,3,8
62080_0,,,,2,5,3,8
62081_0,,,,2,5,3,8
62082_0,,,,2,5,3,8
62083_0,,,,2,5,3,8
62084_0,,,,2,5,3,8
62085_0,,,,2,5,3,8
62086_0,,,,2,5,3,8
62087_0,,,,2,5,3,8
62088_0,,,,2,5,3,8
62089_0,,,,2,5,3,8
62090_0,,,,2,5,3,8
62091_0,,,,2,5,3,8
62092_0,,,,2,5,3,8
62093_0,,,,2,5,3,8
62094_0,,,,2,5,3,8
62095_0,,,,2,5,3,8
62096_0,,,,2,5,3,8
62097_0,,,,2,5,3,8
62098_0,,,,2,5,3,8
62100_0,,,,2,5,3,8
C1(C(C)(C(CO1)C(C(O)=O)O)O)=O,,,5,1,1,0,1
62101_0,,,,2,5,3,8
62102_0,,,,2,5,3,8
62103_0,,,,2,5,3,8
62105_0,,,,2,5,3,8
C(CC(C(C)CC(C(O)=O)O)O)=O,,,5,1,1,0,1
62106_0,,,,2,5,3,8
62107_0,,,,2,5,3,8
62108_0,,,,2,5,3,8
62109_0,,,,2,5,3,8
62111_0,,,,2,5,3,8
C(C(CC(C)CC(CO)=O)O)(O)=O,,,5,1,1,0,1
62113_0,,,,2,5,3,8
C(C(CC(C)C(C(C)=O)O)O)(O)=O,,,5,1,1,0,1
62115_0,,,,2,5,3,8
C(C(CC(CO)C)O)(O)=O,,,5,1,1,0,1
62116_0,,,,2,5,3,8
62118_0,,,,2,5,3,8
C(C(CO)(C)CC(C(O)=O)O)(O)=O,,,5,1,1,0,1
62119_0,,,,2,5,3,8
62120_0,,,,2,5,3,8
62122_0,,,,2,5,3,8
C(C(CC(C)C(C)O)O)(O)=O,,,5,1,1,0,1
62123_0,,,,2,5,3,8
62125_0,,,,2,5,3,8
C(C(CC(C)CC=CC=O)O)(O)=O,,,5,1,1,0,1
62126_0,,,,2,5,3,8
62127_0,,,,2,5,3,8
62128_0,,,,2,5,3,8
62129_0,,,,2,5,3,8
62131_0,,,,2,5,3,8
C(C(C=C)C(C)CC(C(O)=O)O)=O,,,5,1,1,0,1
62132_0,,,,2,5,3,8
62133_0,,,,2,5,3,8
62135_0,,,,2,5,3,8
C(C(CC(C)C(C=O)O)O)(O)=O,,,5,1,1,0,1
62137_0,,,,2,5,3,8
C(C(CC(C)CC(C=O)O)O)(O)=O,,,5,1,1,0,1
62139_0,,,,2,5,3,8
C(C(C)(C(C)CC(C(O)=O)O)O)=O,,,5,1,1,0,1
62140_0,,,,2,5,3,8
62142_0,,,,2,5,3,8
C(C(CC(C)C(C(O)=O)O)O)(O)=O,,,5,1,1,0,1
62143_0,,,,2,5,3,8
62144_0,,,,2,5,3,8
62145_0,,,,2,5,3,8
62146_0,,,,2,5,3,8
62147_0,,,,2,5,3,8
62148_0,,,,2,5,3,8
62149_0,,,,2,5,3,8
62150_0,,,,2,5,3,8
62151_0,,,,2,5,3,8
62152_0,,,,2,5,3,8
62153_0,,,,2,5,3,8
62154_0,,,,2,5,3,8
62155_0,,,,2,5,3,8
[OH-],,,0,1,0,158,158
